sample,station,tx_total_pkts,tx_total_bytes,tx_ucast_pkts,tx_ucast_bytes,tx_mcast_bcast_pkts,tx_mcast_bcast_bytes,tx_failures,rx_data_pkts,rx_data_bytes,rx_ucast_pkts,rx_ucast_bytes,rx_mcast_bcast_pkts,rx_mcast_bcast_bytes,rx_decrypt_succeeds,tx_data_pkts_retried,tx_total_pkts_sent,tx_pkts_retries,tx_pkts_retry_exhausted,rx_total_pkts_retried,rate_last_tx_pkt_min,rate_last_tx_pkt_max,per_antenna_rssi_last_rx_data_frame_1,per_antenna_rssi_last_rx_data_frame_2,per_antenna_rssi_last_rx_data_frame_3,per_antenna_rssi_last_rx_data_frame_4,per_antenna_avg_rssi_rx_data_frames_1,per_antenna_avg_rssi_rx_data_frames_2,per_antenna_avg_rssi_rx_data_frames_3,per_antenna_avg_rssi_rx_data_frames_4,per_antenna_noise_floor_1,per_antenna_noise_floor_2,per_antenna_noise_floor_3,per_antenna_noise_floor_4,sinr_per_antenna_1,sinr_per_antenna_2,sinr_per_antenna_3,sinr_per_antenna_4,attack
1,F8:59:71:5A:E0:3D,2211371,362424639,58836,89343786,2152535,273080853,337,40181,55636972,40109,55625539,72,11433,39917,33,58832,7636,337,31,144444.0,43333.0,-68.0,-74.0,-66.0,-70.0,-68.0,-74.0,-66.0,-70.0,-90.0,-93.0,-90.0,-93.0,22.0,19.0,24.0,23.0,1
2,CC:2F:71:3E:C5:1F,2152609,273089763,74,8910,2152535,273080853,0,339,28752,287,22418,52,6334,83,1,124,7,0,17,144444.0,39000.0,-69.0,-70.0,-66.0,-60.0,-71.0,-70.0,-66.0,-60.0,-90.0,-93.0,-90.0,-93.0,21.0,23.0,24.0,33.0,1
3,CC:2F:71:3F:1F:24,2325099,500183232,172564,227102379,2152535,273080853,6,122279,145496484,122185,145485134,94,11350,118415,560,172609,30239,6,150,144444.0,43333.0,-79.0,-70.0,-79.0,-76.0,-79.0,-70.0,-79.0,-76.0,-90.0,-93.0,-90.0,-93.0,11.0,23.0,11.0,17.0,1
4,F8:59:71:5A:E0:3D,2211439,362523033,58902,89441978,2152537,273081055,337,40248,55736393,40176,55724960,72,11433,39984,33,58898,7636,337,32,144444.0,43333.0,-69.0,-74.0,-66.0,-70.0,-68.0,-74.0,-66.0,-70.0,-90.0,-93.0,-90.0,-93.0,21.0,19.0,24.0,23.0,1
5,CC:2F:71:3E:C5:1F,2152611,273089965,74,8910,2152537,273081055,0,339,28752,287,22418,52,6334,83,1,124,7,0,17,144444.0,39000.0,-69.0,-70.0,-66.0,-60.0,-71.0,-70.0,-66.0,-60.0,-90.0,-93.0,-90.0,-93.0,21.0,23.0,24.0,33.0,1
6,CC:2F:71:3F:1F:24,2325264,500388593,172727,227307538,2152537,273081055,6,122428,145691908,122334,145680558,94,11350,118564,560,172772,30239,6,150,144444.0,43333.0,-79.0,-70.0,-79.0,-77.0,-79.0,-70.0,-79.0,-76.0,-90.0,-93.0,-90.0,-93.0,11.0,23.0,11.0,16.0,1
7,F8:59:71:5A:E0:3D,2211505,362618291,58963,89536772,2152542,273081519,337,40310,55831873,40238,55820440,72,11433,40046,33,58959,7636,337,32,144444.0,43333.0,-69.0,-74.0,-66.0,-70.0,-68.0,-74.0,-66.0,-70.0,-90.0,-93.0,-90.0,-93.0,21.0,19.0,24.0,23.0,1
8,CC:2F:71:3E:C5:1F,2152616,273090429,74,8910,2152542,273081519,0,339,28752,287,22418,52,6334,83,1,124,7,0,17,144444.0,39000.0,-69.0,-70.0,-66.0,-60.0,-71.0,-70.0,-66.0,-60.0,-90.0,-93.0,-90.0,-93.0,21.0,23.0,24.0,33.0,1
9,CC:2F:71:3F:1F:24,2325427,500592371,172883,227510650,2152544,273081721,6,122569,145885912,122475,145874562,94,11350,118705,560,172928,30239,6,150,144444.0,43333.0,-80.0,-70.0,-79.0,-77.0,-79.0,-70.0,-79.0,-77.0,-90.0,-93.0,-90.0,-93.0,10.0,23.0,11.0,16.0,1
10,F8:59:71:5A:E0:3D,2211571,362715043,59025,89633120,2152546,273081923,337,40372,55927353,40300,55915920,72,11433,40108,33,59021,7636,337,32,144444.0,43333.0,-68.0,-74.0,-66.0,-70.0,-68.0,-74.0,-66.0,-70.0,-90.0,-93.0,-90.0,-93.0,22.0,19.0,24.0,23.0,1
11,CC:2F:71:3E:C5:1F,2152620,273090833,74,8910,2152546,273081923,0,339,28752,287,22418,52,6334,83,1,124,7,0,17,144444.0,39000.0,-69.0,-70.0,-66.0,-60.0,-71.0,-70.0,-66.0,-60.0,-90.0,-93.0,-90.0,-93.0,21.0,23.0,24.0,33.0,1
12,CC:2F:71:3F:1F:24,2325585,500795685,173039,227713762,2152546,273081923,6,122710,146079916,122616,146068566,94,11350,118846,560,173084,30240,6,150,144444.0,43333.0,-80.0,-70.0,-79.0,-78.0,-80.0,-70.0,-78.0,-77.0,-90.0,-93.0,-90.0,-93.0,10.0,23.0,11.0,15.0,1
13,F8:59:71:5A:E0:3D,2211639,362813465,59089,89731138,2152550,273082327,337,40435,56022939,40363,56011506,72,11433,40171,33,59085,7636,337,32,144444.0,43333.0,-68.0,-74.0,-66.0,-70.0,-68.0,-74.0,-66.0,-70.0,-90.0,-93.0,-90.0,-93.0,22.0,19.0,24.0,23.0,1
14,CC:2F:71:3E:C5:1F,2152624,273091237,74,8910,2152550,273082327,0,339,28752,287,22418,52,6334,83,1,124,7,0,17,144444.0,39000.0,-69.0,-70.0,-66.0,-60.0,-71.0,-70.0,-66.0,-60.0,-90.0,-93.0,-90.0,-93.0,21.0,23.0,24.0,33.0,1
15,CC:2F:71:3F:1F:24,2325745,500999187,173195,227916860,2152550,273082327,6,122851,146273938,122757,146262588,94,11350,118987,560,173240,30240,6,152,144444.0,43333.0,-80.0,-70.0,-79.0,-78.0,-79.0,-70.0,-78.0,-77.0,-90.0,-93.0,-90.0,-93.0,10.0,23.0,11.0,15.0,1
16,F8:59:71:5A:E0:3D,2211703,362908521,59150,89825932,2152553,273082589,337,40497,56118419,40425,56106986,72,11433,40233,33,59146,7636,337,32,144444.0,43333.0,-68.0,-74.0,-66.0,-70.0,-68.0,-74.0,-66.0,-70.0,-90.0,-93.0,-90.0,-93.0,22.0,19.0,24.0,23.0,1
17,CC:2F:71:3E:C5:1F,2152627,273091499,74,8910,2152553,273082589,0,341,28892,289,22558,52,6334,83,1,125,7,0,17,144444.0,39000.0,-71.0,-70.0,-66.0,-60.0,-70.0,-70.0,-66.0,-60.0,-90.0,-93.0,-90.0,-93.0,19.0,23.0,24.0,33.0,1
18,CC:2F:71:3F:1F:24,2325903,501201007,173350,228118418,2152553,273082589,6,122991,146466402,122897,146455052,94,11350,119127,560,173395,30240,6,152,144444.0,43333.0,-82.0,-73.0,-81.0,-79.0,-81.0,-71.0,-80.0,-78.0,-90.0,-93.0,-90.0,-93.0,8.0,20.0,9.0,14.0,1
19,F8:59:71:5A:E0:3D,2211769,363005273,59212,89922280,2152557,273082993,337,40558,56212359,40486,56200926,72,11433,40294,33,59208,7636,337,32,144444.0,43333.0,-68.0,-74.0,-66.0,-70.0,-68.0,-74.0,-66.0,-70.0,-90.0,-93.0,-90.0,-93.0,22.0,19.0,24.0,23.0,1
20,CC:2F:71:3E:C5:1F,2152631,273091903,74,8910,2152557,273082993,0,341,28892,289,22558,52,6334,83,1,125,7,0,17,144444.0,39000.0,-71.0,-70.0,-66.0,-60.0,-70.0,-70.0,-66.0,-60.0,-90.0,-93.0,-90.0,-93.0,19.0,23.0,24.0,33.0,1
21,CC:2F:71:3F:1F:24,2326489,501990230,173930,228907035,2152559,273083195,6,123190,146679136,123096,146667786,94,11350,119326,560,173974,30264,6,153,144444.0,43333.0,-79.0,-70.0,-78.0,-77.0,-79.0,-70.0,-78.0,-77.0,-90.0,-93.0,-90.0,-93.0,11.0,23.0,12.0,16.0,1
22,F8:59:71:5A:E0:3D,2211839,363104028,59276,90020298,2152563,273083730,337,40622,56310919,40550,56299486,72,11433,40358,33,59272,7637,337,32,144444.0,43333.0,-68.0,-74.0,-66.0,-70.0,-68.0,-74.0,-66.0,-70.0,-90.0,-93.0,-90.0,-93.0,22.0,19.0,24.0,23.0,1
23,CC:2F:71:3E:C5:1F,2152639,273092762,75,8970,2152564,273083792,0,343,29032,291,22698,52,6334,83,1,126,7,0,17,144444.0,39000.0,-70.0,-70.0,-66.0,-60.0,-70.0,-70.0,-66.0,-60.0,-90.0,-93.0,-90.0,-93.0,20.0,23.0,24.0,33.0,1
24,CC:2F:71:3F:1F:24,2326668,502200490,174103,229116612,2152565,273083878,6,123351,146876668,123254,146864944,97,11724,119487,560,174148,30289,6,153,130000.0,43333.0,-80.0,-71.0,-82.0,-77.0,-79.0,-70.0,-82.0,-76.0,-90.0,-93.0,-90.0,-93.0,10.0,22.0,8.0,16.0,1
25,F8:59:71:5A:E0:3D,2212035,363397397,59465,90313057,2152570,273084340,337,40699,56409963,40627,56398530,72,11433,40435,33,59461,7638,337,32,144444.0,43333.0,-68.0,-74.0,-66.0,-70.0,-68.0,-74.0,-66.0,-70.0,-90.0,-93.0,-90.0,-93.0,22.0,19.0,24.0,23.0,1
26,CC:2F:71:3E:C5:1F,2152647,273093512,75,8970,2152572,273084542,0,343,29032,291,22698,52,6334,83,1,126,7,0,17,144444.0,39000.0,-70.0,-70.0,-66.0,-60.0,-70.0,-70.0,-66.0,-60.0,-90.0,-93.0,-90.0,-93.0,20.0,23.0,24.0,33.0,1
27,CC:2F:71:3F:1F:24,2326832,502405820,174260,229321278,2152572,273084542,6,123494,147072422,123395,147060386,99,12036,119629,560,174305,30289,6,153,130000.0,43333.0,-81.0,-71.0,-81.0,-78.0,-78.0,-68.0,-79.0,-75.0,-90.0,-93.0,-90.0,-93.0,9.0,22.0,9.0,15.0,1
28,F8:59:71:5A:E0:3D,2212297,363796436,59721,90711490,2152576,273084946,337,40803,56515246,40731,56503813,72,11433,40539,33,59717,7638,337,32,144444.0,43333.0,-68.0,-74.0,-66.0,-70.0,-68.0,-74.0,-66.0,-70.0,-90.0,-93.0,-90.0,-93.0,22.0,19.0,24.0,23.0,1
29,CC:2F:71:3E:C5:1F,2152651,273093916,75,8970,2152576,273084946,0,343,29032,291,22698,52,6334,83,1,126,7,0,17,144444.0,39000.0,-70.0,-70.0,-66.0,-60.0,-70.0,-70.0,-66.0,-60.0,-90.0,-93.0,-90.0,-93.0,20.0,23.0,24.0,33.0,1
30,CC:2F:71:3F:1F:24,2326992,502609112,174416,229524166,2152576,273084946,6,123635,147267864,123536,147255828,99,12036,119769,560,174461,30294,6,153,130000.0,43333.0,-74.0,-64.0,-77.0,-70.0,-74.0,-64.0,-76.0,-70.0,-90.0,-93.0,-90.0,-93.0,16.0,29.0,13.0,23.0,1
31,F8:59:71:5A:E0:3D,2212361,363892986,59783,90807838,2152578,273085148,337,40865,56610726,40793,56599293,72,11433,40601,33,59779,7638,337,32,144444.0,43333.0,-68.0,-74.0,-66.0,-70.0,-68.0,-74.0,-66.0,-70.0,-90.0,-93.0,-90.0,-93.0,22.0,19.0,24.0,23.0,1
32,CC:2F:71:3E:C5:1F,2152653,273094118,75,8970,2152578,273085148,0,343,29032,291,22698,52,6334,83,1,126,7,0,17,144444.0,39000.0,-70.0,-70.0,-66.0,-60.0,-70.0,-70.0,-66.0,-60.0,-90.0,-93.0,-90.0,-93.0,20.0,23.0,24.0,33.0,1
33,CC:2F:71:3F:1F:24,2327169,502816682,174591,229731534,2152578,273085148,6,123794,147471517,123695,147459481,99,12036,119928,560,174636,30297,6,153,130000.0,43333.0,-74.0,-65.0,-74.0,-69.0,-74.0,-65.0,-75.0,-69.0,-90.0,-93.0,-90.0,-93.0,16.0,28.0,16.0,24.0,1
34,F8:59:71:5A:E0:3D,2212429,363989928,59846,90904316,2152583,273085612,337,40928,56706364,40856,56694931,72,11433,40664,33,59841,7638,337,32,144444.0,43333.0,-68.0,-74.0,-66.0,-70.0,-68.0,-74.0,-66.0,-70.0,-90.0,-93.0,-90.0,-93.0,22.0,19.0,24.0,23.0,1
35,CC:2F:71:3E:C5:1F,2152660,273094784,75,8970,2152585,273085814,0,343,29032,291,22698,52,6334,83,1,126,7,0,17,144444.0,39000.0,-70.0,-70.0,-66.0,-60.0,-70.0,-70.0,-66.0,-60.0,-90.0,-93.0,-90.0,-93.0,20.0,23.0,24.0,33.0,1
36,CC:2F:71:3F:1F:24,2327333,503023438,174748,229937624,2152585,273085814,6,123937,147670123,123838,147658087,99,12036,120068,560,174793,30297,6,153,130000.0,43333.0,-74.0,-65.0,-76.0,-69.0,-73.0,-65.0,-75.0,-68.0,-90.0,-93.0,-90.0,-93.0,16.0,28.0,14.0,24.0,1
37,F8:59:71:5A:E0:3D,2212497,364086804,59908,91000664,2152589,273086140,337,40992,56803516,40919,56791965,73,11551,40727,33,59904,7639,337,32,144444.0,43333.0,-68.0,-74.0,-67.0,-70.0,-68.0,-74.0,-66.0,-70.0,-90.0,-93.0,-90.0,-93.0,22.0,19.0,23.0,23.0,1
38,CC:2F:71:3E:C5:1F,2152664,273095110,75,8970,2152589,273086140,0,345,29220,292,22768,53,6452,84,1,126,7,0,17,144444.0,39000.0,-70.0,-70.0,-66.0,-60.0,-70.0,-70.0,-66.0,-60.0,-90.0,-93.0,-90.0,-93.0,20.0,23.0,24.0,33.0,1
39,CC:2F:71:3F:1F:24,2327932,503852625,175343,230766485,2152589,273086140,6,124122,147873317,124023,147861281,99,12036,120253,560,175388,30302,6,153,130000.0,43333.0,-74.0,-65.0,-76.0,-69.0,-73.0,-65.0,-76.0,-69.0,-90.0,-93.0,-90.0,-93.0,16.0,28.0,14.0,24.0,1
40,F8:59:71:5A:E0:3D,2212563,364183556,59970,91097012,2152593,273086544,337,41055,56900690,40982,56889139,73,11551,40790,33,59966,7639,337,35,144444.0,43333.0,-67.0,-73.0,-64.0,-69.0,-66.0,-72.0,-64.0,-69.0,-90.0,-93.0,-90.0,-93.0,23.0,20.0,26.0,24.0,1
41,CC:2F:71:3E:C5:1F,2152668,273095514,75,8970,2152593,273086544,0,345,29220,292,22768,53,6452,84,1,126,7,0,17,144444.0,39000.0,-70.0,-70.0,-66.0,-60.0,-70.0,-70.0,-66.0,-60.0,-90.0,-93.0,-90.0,-93.0,20.0,23.0,24.0,33.0,1
42,CC:2F:71:3F:1F:24,2328100,504061166,175507,230974622,2152593,273086544,6,124276,148075240,124177,148063204,99,12036,120405,560,175552,30302,6,153,130000.0,43333.0,-68.0,-64.0,-69.0,-69.0,-67.0,-64.0,-68.0,-68.0,-90.0,-93.0,-90.0,-93.0,22.0,29.0,21.0,24.0,1
43,F8:59:71:5A:E0:3D,2212629,364281720,60033,91194914,2152596,273086806,337,41117,56996170,41044,56984619,73,11551,40852,33,60029,7645,337,35,144444.0,43333.0,-65.0,-72.0,-65.0,-69.0,-65.0,-72.0,-64.0,-69.0,-89.0,-92.0,-89.0,-92.0,24.0,20.0,24.0,23.0,1
44,CC:2F:71:3E:C5:1F,2152671,273095776,75,8970,2152596,273086806,0,345,29220,292,22768,53,6452,84,1,126,7,0,17,144444.0,39000.0,-70.0,-70.0,-66.0,-60.0,-70.0,-70.0,-66.0,-60.0,-89.0,-92.0,-89.0,-92.0,19.0,22.0,23.0,32.0,1
45,CC:2F:71:3F:1F:24,2328262,504266296,175664,231179288,2152598,273087008,6,124425,148281648,124326,148269612,99,12036,120548,560,175709,30304,6,153,130000.0,43333.0,-69.0,-64.0,-69.0,-68.0,-68.0,-64.0,-68.0,-68.0,-89.0,-92.0,-89.0,-92.0,20.0,28.0,20.0,24.0,1
46,F8:59:71:5A:E0:3D,2212733,364431611,60131,91344199,2152602,273087412,337,41188,57098698,41115,57087147,73,11551,40921,33,60127,7649,337,35,144444.0,43333.0,-66.0,-73.0,-66.0,-69.0,-66.0,-73.0,-64.0,-69.0,-89.0,-92.0,-89.0,-92.0,23.0,19.0,23.0,23.0,1
47,CC:2F:71:3E:C5:1F,2152677,273096382,75,8970,2152602,273087412,0,345,29220,292,22768,53,6452,84,1,126,7,0,17,144444.0,39000.0,-70.0,-70.0,-66.0,-60.0,-70.0,-70.0,-66.0,-60.0,-89.0,-92.0,-89.0,-92.0,19.0,22.0,23.0,32.0,1
48,CC:2F:71:3F:1F:24,2328438,504476674,175836,231389262,2152602,273087412,6,124596,148494307,124497,148482271,99,12036,120709,560,175881,30316,6,153,144444.0,43333.0,-68.0,-64.0,-69.0,-68.0,-67.0,-64.0,-68.0,-68.0,-89.0,-92.0,-89.0,-92.0,21.0,28.0,20.0,24.0,1
49,F8:59:71:5A:E0:3D,2212920,364718533,60316,91630919,2152604,273087614,337,41283,57202657,41210,57191106,73,11551,41014,33,60312,7656,337,35,144444.0,43333.0,-67.0,-74.0,-64.0,-69.0,-65.0,-72.0,-64.0,-69.0,-89.0,-92.0,-89.0,-92.0,22.0,18.0,25.0,23.0,1
50,CC:2F:71:3E:C5:1F,2152679,273096584,75,8970,2152604,273087614,0,345,29220,292,22768,53,6452,84,1,126,7,0,17,144444.0,39000.0,-70.0,-70.0,-66.0,-60.0,-70.0,-70.0,-66.0,-60.0,-89.0,-92.0,-89.0,-92.0,19.0,22.0,23.0,32.0,1
51,CC:2F:71:3F:1F:24,2328599,504686074,175995,231598460,2152604,273087614,6,124742,148697477,124643,148685441,99,12036,120852,560,176040,30328,6,153,144444.0,43333.0,-68.0,-64.0,-67.0,-69.0,-68.0,-64.0,-68.0,-68.0,-89.0,-92.0,-89.0,-92.0,21.0,28.0,22.0,23.0,1
52,F8:59:71:5A:E0:3D,2212996,364826425,60385,91738145,2152611,273088280,337,41352,57308917,41279,57297366,73,11551,41083,33,60381,7661,337,35,144444.0,43333.0,-67.0,-73.0,-65.0,-70.0,-67.0,-73.0,-65.0,-70.0,-89.0,-92.0,-89.0,-92.0,22.0,19.0,24.0,22.0,1
53,CC:2F:71:3E:C5:1F,2152686,273097250,75,8970,2152611,273088280,0,345,29220,292,22768,53,6452,84,1,126,7,0,17,144444.0,39000.0,-70.0,-70.0,-66.0,-60.0,-70.0,-70.0,-66.0,-60.0,-89.0,-92.0,-89.0,-92.0,19.0,22.0,23.0,32.0,1
54,CC:2F:71:3F:1F:24,2329282,505621121,176671,232532841,2152611,273088280,6,124995,148974058,124896,148962022,99,12036,121083,560,176715,30444,6,160,130000.0,43333.0,-68.0,-64.0,-72.0,-68.0,-69.0,-63.0,-73.0,-67.0,-89.0,-92.0,-89.0,-92.0,21.0,28.0,17.0,24.0,1
55,F8:59:71:5A:E0:3D,2213216,365139558,60592,92050006,2152624,273089552,337,41585,57660416,41512,57648865,73,11551,41316,33,60588,7665,337,35,144444.0,43333.0,-67.0,-74.0,-66.0,-70.0,-67.0,-72.0,-65.0,-69.0,-89.0,-92.0,-88.0,-92.0,22.0,18.0,22.0,22.0,1
56,CC:2F:71:3E:C5:1F,2152699,273098522,75,8970,2152624,273089552,0,345,29220,292,22768,53,6452,84,1,126,7,0,17,144444.0,39000.0,-70.0,-70.0,-66.0,-60.0,-70.0,-70.0,-66.0,-60.0,-89.0,-92.0,-88.0,-92.0,19.0,22.0,22.0,32.0,1
57,CC:2F:71:3F:1F:24,2329774,506295074,177150,233205522,2152624,273089552,6,125486,149668140,125387,149656104,99,12036,121496,560,177195,30455,6,194,130000.0,43333.0,-71.0,-63.0,-74.0,-67.0,-71.0,-62.0,-73.0,-67.0,-89.0,-92.0,-88.0,-92.0,18.0,29.0,14.0,25.0,1
58,F8:59:71:5A:E0:3D,2213285,365239691,60656,92149462,2152629,273090229,337,41651,57762056,41578,57750505,73,11551,41382,33,60652,7665,337,35,144444.0,43333.0,-67.0,-73.0,-65.0,-70.0,-67.0,-73.0,-65.0,-70.0,-89.0,-92.0,-88.0,-92.0,22.0,19.0,23.0,22.0,1
59,CC:2F:71:3E:C5:1F,2152704,273099199,75,8970,2152629,273090229,0,345,29220,292,22768,53,6452,84,1,126,7,0,17,144444.0,39000.0,-70.0,-70.0,-66.0,-60.0,-70.0,-70.0,-66.0,-60.0,-89.0,-92.0,-88.0,-92.0,19.0,22.0,22.0,32.0,1
60,CC:2F:71:3F:1F:24,2329933,506497195,177304,233406966,2152629,273090229,6,125630,149866806,125531,149854770,99,12036,121637,560,177349,30455,6,194,130000.0,43333.0,-71.0,-63.0,-74.0,-67.0,-70.0,-62.0,-73.0,-66.0,-89.0,-92.0,-88.0,-92.0,18.0,29.0,14.0,25.0,1
61,F8:59:71:5A:E0:3D,2213350,365336301,60718,92245810,2152632,273090491,337,41712,57855996,41639,57844445,73,11551,41443,33,60714,7666,337,35,144444.0,43333.0,-67.0,-73.0,-66.0,-70.0,-67.0,-73.0,-65.0,-70.0,-89.0,-92.0,-88.0,-92.0,22.0,19.0,22.0,22.0,1
62,CC:2F:71:3E:C5:1F,2152707,273099461,75,8970,2152632,273090491,0,345,29220,292,22768,53,6452,84,1,126,7,0,17,144444.0,39000.0,-70.0,-70.0,-66.0,-60.0,-70.0,-70.0,-66.0,-60.0,-89.0,-92.0,-88.0,-92.0,19.0,22.0,22.0,32.0,1
63,CC:2F:71:3F:1F:24,2330090,506698453,177458,233607962,2152632,273090491,6,125775,150062854,125676,150050818,99,12036,121780,560,177503,30463,6,194,130000.0,43333.0,-71.0,-62.0,-73.0,-67.0,-71.0,-62.0,-73.0,-67.0,-89.0,-92.0,-88.0,-92.0,18.0,30.0,15.0,25.0,1
64,F8:59:71:5A:E0:3D,2213419,365434697,60781,92343600,2152638,273091097,337,41775,57953016,41702,57941465,73,11551,41506,33,60777,7667,337,35,144444.0,39000.0,-67.0,-73.0,-65.0,-70.0,-67.0,-73.0,-65.0,-69.0,-88.0,-91.0,-88.0,-92.0,21.0,18.0,23.0,22.0,1
65,CC:2F:71:3E:C5:1F,2152713,273100067,75,8970,2152638,273091097,0,345,29220,292,22768,53,6452,84,1,126,7,0,17,144444.0,39000.0,-70.0,-70.0,-66.0,-60.0,-70.0,-70.0,-66.0,-60.0,-88.0,-91.0,-88.0,-92.0,18.0,21.0,22.0,32.0,1
66,CC:2F:71:3F:1F:24,2330254,506905295,177616,233814198,2152638,273091097,6,125917,150259920,125818,150247884,99,12036,121920,560,177661,30463,6,195,130000.0,43333.0,-72.0,-63.0,-74.0,-67.0,-71.0,-62.0,-73.0,-67.0,-88.0,-91.0,-88.0,-92.0,16.0,28.0,14.0,25.0,1
67,F8:59:71:5A:E0:3D,2213483,365531191,60843,92439892,2152640,273091299,337,41837,58048496,41764,58036945,73,11551,41568,33,60839,7667,337,35,144444.0,43333.0,-68.0,-74.0,-66.0,-70.0,-67.0,-73.0,-65.0,-70.0,-88.0,-91.0,-88.0,-92.0,20.0,17.0,22.0,22.0,1
68,CC:2F:71:3E:C5:1F,2152715,273100269,75,8970,2152640,273091299,0,345,29220,292,22768,53,6452,84,1,126,7,0,17,144444.0,39000.0,-70.0,-70.0,-66.0,-60.0,-70.0,-70.0,-66.0,-60.0,-88.0,-91.0,-88.0,-92.0,18.0,21.0,22.0,32.0,1
69,CC:2F:71:3F:1F:24,2330422,507116702,177782,234025403,2152640,273091299,6,126075,150467898,125976,150455862,99,12036,122073,560,177827,30463,6,195,130000.0,39000.0,-72.0,-62.0,-75.0,-67.0,-71.0,-62.0,-74.0,-67.0,-88.0,-91.0,-88.0,-92.0,16.0,29.0,13.0,25.0,1
70,F8:59:71:5A:E0:3D,2213717,365890129,61074,92798568,2152643,273091561,337,41924,58151829,41851,58140278,73,11551,41655,33,61049,7667,337,35,144444.0,43333.0,-68.0,-74.0,-66.0,-70.0,-67.0,-73.0,-66.0,-70.0,-88.0,-91.0,-88.0,-92.0,20.0,17.0,22.0,22.0,1
71,CC:2F:71:3E:C5:1F,2152722,273100935,75,8970,2152647,273091965,0,345,29220,292,22768,53,6452,84,1,126,7,0,17,144444.0,39000.0,-70.0,-70.0,-66.0,-60.0,-70.0,-70.0,-66.0,-60.0,-88.0,-91.0,-88.0,-92.0,18.0,21.0,22.0,32.0,1
72,CC:2F:71:3F:1F:24,2330898,507741140,178251,234649175,2152647,273091965,6,126281,150697204,126182,150685168,99,12036,122278,560,178296,30519,6,195,130000.0,39000.0,-71.0,-62.0,-74.0,-67.0,-71.0,-62.0,-73.0,-67.0,-88.0,-91.0,-88.0,-92.0,17.0,29.0,14.0,25.0,1
73,F8:59:71:5A:E0:3D,2213931,366213085,61282,93120918,2152649,273092167,337,42029,58277013,41956,58265462,73,11551,41760,33,61278,7730,337,35,144444.0,43333.0,-67.0,-74.0,-66.0,-70.0,-67.0,-73.0,-65.0,-70.0,-87.0,-91.0,-87.0,-91.0,20.0,17.0,21.0,21.0,1
74,CC:2F:71:3E:C5:1F,2152724,273101137,75,8970,2152649,273092167,0,345,29220,292,22768,53,6452,84,1,126,7,0,17,144444.0,39000.0,-70.0,-70.0,-66.0,-60.0,-70.0,-70.0,-66.0,-60.0,-87.0,-91.0,-87.0,-91.0,17.0,21.0,21.0,31.0,1
75,CC:2F:71:3F:1F:24,2331356,508384111,178707,235291944,2152649,273092167,6,126467,150919517,126368,150907481,99,12036,122464,560,178752,30567,6,195,130000.0,43333.0,-72.0,-62.0,-75.0,-67.0,-71.0,-62.0,-74.0,-67.0,-87.0,-91.0,-87.0,-91.0,15.0,29.0,12.0,24.0,1
76,F8:59:71:5A:E0:3D,2213997,366309837,61344,93217266,2152653,273092571,337,42092,58374033,42019,58362482,73,11551,41823,33,61340,7730,337,35,144444.0,43333.0,-68.0,-74.0,-66.0,-70.0,-67.0,-73.0,-66.0,-70.0,-87.0,-91.0,-87.0,-91.0,19.0,17.0,21.0,21.0,1
77,CC:2F:71:3E:C5:1F,2152731,273101803,75,8970,2152656,273092833,0,345,29220,292,22768,53,6452,84,1,126,7,0,17,144444.0,39000.0,-70.0,-70.0,-66.0,-60.0,-70.0,-70.0,-66.0,-60.0,-87.0,-91.0,-87.0,-91.0,17.0,21.0,21.0,31.0,1
78,CC:2F:71:3F:1F:24,2331552,508599122,178896,235506289,2152656,273092833,6,126630,151130244,126531,151118208,99,12036,122627,560,178941,30574,6,195,144444.0,43333.0,-71.0,-62.0,-74.0,-67.0,-70.0,-62.0,-74.0,-67.0,-87.0,-91.0,-87.0,-91.0,16.0,29.0,13.0,24.0,1
79,F8:59:71:5A:E0:3D,2214071,366413326,61413,93320291,2152658,273093035,337,42161,58477845,42088,58466294,73,11551,41892,33,61409,7732,337,35,144444.0,43333.0,-67.0,-73.0,-66.0,-70.0,-67.0,-73.0,-65.0,-70.0,-87.0,-91.0,-87.0,-91.0,20.0,18.0,21.0,21.0,1
80,CC:2F:71:3E:C5:1F,2152733,273102005,75,8970,2152658,273093035,0,345,29220,292,22768,53,6452,84,1,126,7,0,17,144444.0,39000.0,-70.0,-70.0,-66.0,-60.0,-70.0,-70.0,-66.0,-60.0,-87.0,-91.0,-87.0,-91.0,17.0,21.0,21.0,31.0,1
81,CC:2F:71:3F:1F:24,2331727,508815936,179069,235722901,2152658,273093035,6,126784,151332079,126685,151320043,99,12036,122781,560,179113,30578,6,195,130000.0,43333.0,-71.0,-62.0,-74.0,-67.0,-71.0,-62.0,-73.0,-67.0,-87.0,-91.0,-87.0,-91.0,16.0,29.0,13.0,24.0,1
82,F8:59:71:5A:E0:3D,2214643,367307633,61983,94214396,2152660,273093237,337,42314,58588698,42241,58577147,73,11551,42044,33,61979,7733,337,35,144444.0,43333.0,-68.0,-74.0,-66.0,-70.0,-67.0,-73.0,-66.0,-70.0,-87.0,-91.0,-87.0,-91.0,19.0,17.0,21.0,21.0,1
83,CC:2F:71:3E:C5:1F,2152735,273102207,75,8970,2152660,273093237,0,345,29220,292,22768,53,6452,84,1,126,7,0,17,144444.0,39000.0,-70.0,-70.0,-66.0,-60.0,-70.0,-70.0,-66.0,-60.0,-87.0,-91.0,-87.0,-91.0,17.0,21.0,21.0,31.0,1
84,CC:2F:71:3F:1F:24,2331889,509019686,179225,235926045,2152664,273093641,6,126930,151530949,126831,151518913,99,12036,122926,560,179270,30578,6,195,130000.0,43333.0,-71.0,-62.0,-74.0,-67.0,-71.0,-62.0,-74.0,-67.0,-87.0,-91.0,-87.0,-91.0,16.0,29.0,13.0,24.0,1
85,F8:59:71:5A:E0:3D,2214713,367406201,62046,94312298,2152667,273093903,337,42377,58685718,42304,58674167,73,11551,42107,33,62042,7734,337,35,144444.0,43333.0,-67.0,-73.0,-66.0,-70.0,-67.0,-73.0,-65.0,-70.0,-87.0,-91.0,-87.0,-91.0,20.0,18.0,21.0,21.0,1
86,CC:2F:71:3E:C5:1F,2152742,273102873,75,8970,2152667,273093903,0,345,29220,292,22768,53,6452,84,1,126,7,0,17,144444.0,39000.0,-70.0,-70.0,-66.0,-60.0,-70.0,-70.0,-66.0,-60.0,-87.0,-91.0,-87.0,-91.0,17.0,21.0,21.0,31.0,1
87,CC:2F:71:3F:1F:24,2332050,509226032,179383,236132129,2152667,273093903,6,127076,151734147,126977,151722111,99,12036,123067,560,179428,30583,6,195,144444.0,43333.0,-71.0,-62.0,-74.0,-67.0,-71.0,-62.0,-73.0,-67.0,-87.0,-91.0,-87.0,-91.0,16.0,29.0,13.0,24.0,1
88,F8:59:71:5A:E0:3D,2214777,367502751,62108,94408646,2152669,273094105,337,42439,58781198,42366,58769647,73,11551,42169,33,62104,7734,337,35,144444.0,43333.0,-68.0,-74.0,-66.0,-70.0,-67.0,-73.0,-66.0,-70.0,-87.0,-91.0,-87.0,-91.0,19.0,17.0,21.0,21.0,1
89,CC:2F:71:3E:C5:1F,2152744,273103075,75,8970,2152669,273094105,0,345,29220,292,22768,53,6452,84,1,126,7,0,17,144444.0,39000.0,-70.0,-70.0,-66.0,-60.0,-70.0,-70.0,-66.0,-60.0,-87.0,-91.0,-87.0,-91.0,17.0,21.0,21.0,31.0,1
90,CC:2F:71:3F:1F:24,2332208,509429322,179539,236335217,2152669,273094105,6,127224,151936311,127125,151924275,99,12036,123209,560,179584,30592,6,195,130000.0,43333.0,-71.0,-62.0,-73.0,-69.0,-71.0,-62.0,-72.0,-68.0,-87.0,-91.0,-87.0,-91.0,16.0,29.0,14.0,22.0,1
91,F8:59:71:5A:E0:3D,2214849,367601747,62176,94507238,2152673,273094509,337,42508,58880789,42435,58869238,73,11551,42238,33,62172,7734,337,35,144444.0,43333.0,-68.0,-74.0,-66.0,-70.0,-67.0,-73.0,-65.0,-70.0,-87.0,-91.0,-87.0,-91.0,19.0,17.0,21.0,21.0,1
92,CC:2F:71:3E:C5:1F,2152748,273103479,75,8970,2152673,273094509,0,345,29220,292,22768,53,6452,84,1,126,7,0,17,144444.0,39000.0,-70.0,-70.0,-66.0,-60.0,-70.0,-70.0,-66.0,-60.0,-87.0,-91.0,-87.0,-91.0,17.0,21.0,21.0,31.0,1
93,CC:2F:71:3F:1F:24,2332801,510188723,180128,237094214,2152673,273094509,6,127579,152162973,127480,152150937,99,12036,123559,560,180173,30594,6,195,130000.0,43333.0,-72.0,-62.0,-73.0,-70.0,-71.0,-62.0,-73.0,-69.0,-87.0,-91.0,-87.0,-91.0,15.0,29.0,14.0,21.0,1
94,F8:59:71:5A:E0:3D,2214915,367699911,62239,94605140,2152676,273094771,337,42573,58980903,42500,58969352,73,11551,42302,33,62235,7734,337,35,144444.0,43333.0,-67.0,-74.0,-66.0,-70.0,-67.0,-73.0,-65.0,-70.0,-86.0,-90.0,-86.0,-91.0,19.0,16.0,20.0,21.0,1
95,CC:2F:71:3E:C5:1F,2152751,273103741,75,8970,2152676,273094771,0,347,29360,294,22908,53,6452,84,1,127,7,0,17,144444.0,39000.0,-70.0,-71.0,-66.0,-60.0,-70.0,-70.0,-66.0,-60.0,-86.0,-90.0,-86.0,-91.0,16.0,19.0,20.0,31.0,1
96,CC:2F:71:3F:1F:24,2333151,510642827,180473,237547854,2152678,273094973,6,127811,152380121,127712,152368085,99,12036,123788,560,180518,30594,6,195,144444.0,43333.0,-71.0,-62.0,-73.0,-70.0,-71.0,-62.0,-73.0,-70.0,-86.0,-90.0,-86.0,-91.0,15.0,28.0,13.0,21.0,1
97,F8:59:71:5A:E0:3D,2214985,367799973,62303,94704596,2152682,273095377,337,42636,59077923,42563,59066372,73,11551,42365,33,62299,7736,337,35,144444.0,43333.0,-67.0,-74.0,-66.0,-71.0,-67.0,-73.0,-65.0,-70.0,-86.0,-90.0,-86.0,-91.0,19.0,16.0,20.0,20.0,1
98,CC:2F:71:3E:C5:1F,2152757,273104347,75,8970,2152682,273095377,0,347,29360,294,22908,53,6452,84,1,127,7,0,17,144444.0,39000.0,-70.0,-71.0,-66.0,-60.0,-70.0,-70.0,-66.0,-60.0,-86.0,-90.0,-86.0,-90.0,16.0,19.0,20.0,30.0,1
99,CC:2F:71:3F:1F:24,2333504,511094567,180822,237999190,2152682,273095377,6,128043,152590109,127944,152578073,99,12036,124019,560,180867,30594,6,195,144444.0,43333.0,-72.0,-62.0,-74.0,-71.0,-71.0,-62.0,-73.0,-71.0,-86.0,-90.0,-86.0,-90.0,14.0,28.0,12.0,19.0,1
100,F8:59:71:5A:E0:3D,2215056,367896277,62371,94800425,2152685,273095852,337,42703,59176548,42630,59164997,73,11551,42432,33,62367,7736,337,35,144444.0,43333.0,-67.0,-74.0,-66.0,-70.0,-67.0,-73.0,-66.0,-70.0,-86.0,-90.0,-86.0,-90.0,19.0,16.0,20.0,20.0,1
101,CC:2F:71:3E:C5:1F,2152763,273105140,76,9086,2152687,273096054,0,349,29500,296,23048,53,6452,84,1,128,7,0,17,144444.0,39000.0,-70.0,-71.0,-71.0,-69.0,-70.0,-70.0,-66.0,-61.0,-85.0,-90.0,-85.0,-90.0,15.0,19.0,14.0,21.0,1
102,CC:2F:71:3F:1F:24,2334562,512515210,181870,239418692,2152692,273096518,6,128476,152971954,128377,152959918,99,12036,124443,560,181915,30595,6,217,144444.0,43333.0,-70.0,-62.0,-73.0,-71.0,-70.0,-62.0,-73.0,-71.0,-85.0,-90.0,-85.0,-90.0,15.0,28.0,12.0,19.0,1
103,F8:59:71:5A:E0:3D,2215304,368264569,62608,95167481,2152696,273097088,337,42827,59350938,42754,59339387,73,11551,42556,33,62604,7736,337,35,144444.0,43333.0,-68.0,-74.0,-66.0,-70.0,-67.0,-73.0,-65.0,-70.0,-85.0,-90.0,-85.0,-90.0,17.0,16.0,19.0,20.0,1
104,CC:2F:71:3E:C5:1F,2152772,273106174,76,9086,2152696,273097088,0,349,29500,296,23048,53,6452,84,1,128,7,0,17,144444.0,39000.0,-70.0,-71.0,-71.0,-69.0,-70.0,-70.0,-66.0,-61.0,-85.0,-90.0,-85.0,-90.0,15.0,19.0,14.0,21.0,1
105,CC:2F:71:3F:1F:24,2335037,513150116,182341,240053028,2152696,273097088,6,128755,153213742,128656,153201706,99,12036,124716,560,182386,30596,6,217,144444.0,43333.0,-71.0,-62.0,-72.0,-71.0,-71.0,-62.0,-72.0,-71.0,-85.0,-90.0,-85.0,-90.0,14.0,28.0,13.0,19.0,1
106,F8:59:71:5A:E0:3D,2215374,368367537,62674,95270045,2152700,273097492,337,42894,59454118,42821,59442567,73,11551,42623,33,62670,7736,337,35,144444.0,43333.0,-68.0,-74.0,-66.0,-70.0,-67.0,-73.0,-65.0,-70.0,-85.0,-90.0,-85.0,-90.0,17.0,16.0,19.0,20.0,1
107,CC:2F:71:3E:C5:1F,2152776,273106578,76,9086,2152700,273097492,0,349,29500,296,23048,53,6452,84,1,128,7,0,17,144444.0,39000.0,-70.0,-71.0,-71.0,-69.0,-70.0,-70.0,-66.0,-61.0,-85.0,-90.0,-85.0,-90.0,15.0,19.0,14.0,21.0,1
108,CC:2F:71:3F:1F:24,2335429,513614087,182727,240516385,2152702,273097702,6,129031,153440208,128932,153428172,99,12036,124988,560,182772,30596,6,217,144444.0,43333.0,-70.0,-62.0,-72.0,-69.0,-69.0,-62.0,-72.0,-68.0,-85.0,-90.0,-85.0,-90.0,15.0,28.0,13.0,21.0,1
109,F8:59:71:5A:E0:3D,2215448,368470905,62741,95372739,2152707,273098166,337,42963,59556196,42888,59544323,75,11873,42692,33,62737,7737,337,35,144444.0,43333.0,-68.0,-74.0,-65.0,-70.0,-67.0,-74.0,-65.0,-70.0,-85.0,-90.0,-85.0,-90.0,17.0,16.0,20.0,20.0,1
110,CC:2F:71:3E:C5:1F,2152783,273107252,76,9086,2152707,273098166,0,349,29500,296,23048,53,6452,84,1,128,7,0,17,144444.0,39000.0,-70.0,-71.0,-71.0,-69.0,-70.0,-70.0,-66.0,-61.0,-85.0,-90.0,-85.0,-90.0,15.0,19.0,14.0,21.0,1
111,CC:2F:71:3F:1F:24,2335626,513861663,182919,240763497,2152707,273098166,6,129198,153648650,129099,153636614,99,12036,125153,560,182964,30599,6,217,144444.0,43333.0,-70.0,-62.0,-72.0,-70.0,-70.0,-62.0,-72.0,-69.0,-85.0,-90.0,-85.0,-90.0,15.0,28.0,13.0,20.0,1
112,F8:59:71:5A:E0:3D,2215513,368567517,62803,95469087,2152710,273098430,337,43025,59651676,42950,59639803,75,11873,42754,33,62799,7737,337,35,144444.0,43333.0,-67.0,-73.0,-66.0,-70.0,-67.0,-73.0,-65.0,-70.0,-85.0,-90.0,-85.0,-90.0,18.0,17.0,19.0,20.0,1
113,CC:2F:71:3E:C5:1F,2152786,273107516,76,9086,2152710,273098430,0,351,29688,297,23118,54,6570,85,1,128,7,0,18,144444.0,39000.0,-70.0,-70.0,-66.0,-60.0,-70.0,-72.0,-67.0,-62.0,-85.0,-90.0,-85.0,-90.0,15.0,20.0,19.0,30.0,1
114,CC:2F:71:3F:1F:24,2335786,514065127,183074,240966495,2152712,273098632,6,129343,153848870,129244,153836834,99,12036,125294,560,183119,30599,6,217,144444.0,43333.0,-70.0,-62.0,-72.0,-71.0,-70.0,-62.0,-72.0,-70.0,-85.0,-90.0,-85.0,-90.0,15.0,28.0,13.0,19.0,1
115,F8:59:71:5A:E0:3D,2215937,369224328,63222,96125432,2152715,273098896,337,43146,59757867,43071,59745994,75,11873,42875,33,63218,7737,337,35,144444.0,43333.0,-67.0,-74.0,-65.0,-70.0,-67.0,-74.0,-65.0,-69.0,-85.0,-90.0,-85.0,-90.0,18.0,16.0,20.0,20.0,1
116,CC:2F:71:3E:C5:1F,2152791,273107982,76,9086,2152715,273098896,0,351,29688,297,23118,54,6570,85,1,128,7,0,18,144444.0,39000.0,-70.0,-70.0,-66.0,-60.0,-70.0,-72.0,-67.0,-62.0,-85.0,-90.0,-85.0,-90.0,15.0,20.0,19.0,30.0,1
117,CC:2F:71:3F:1F:24,2335952,514268156,183235,241169058,2152717,273099098,6,129489,154040781,129389,154028627,100,12154,125440,560,183280,30602,6,218,144444.0,43333.0,-70.0,-62.0,-72.0,-70.0,-70.0,-62.0,-72.0,-70.0,-85.0,-90.0,-85.0,-90.0,15.0,28.0,13.0,20.0,1
118,F8:59:71:5A:E0:3D,2216019,369334553,63298,96235131,2152721,273099422,337,43220,59865876,43144,59853885,76,11991,42949,33,63294,7737,337,35,144444.0,43333.0,-67.0,-74.0,-66.0,-70.0,-67.0,-73.0,-65.0,-70.0,-84.0,-89.0,-84.0,-90.0,17.0,15.0,18.0,20.0,1
119,CC:2F:71:3E:C5:1F,2152797,273108508,76,9086,2152721,273099422,0,351,29688,297,23118,54,6570,85,1,128,7,0,18,144444.0,39000.0,-70.0,-70.0,-66.0,-60.0,-70.0,-72.0,-67.0,-62.0,-84.0,-89.0,-84.0,-90.0,14.0,19.0,18.0,30.0,1
120,CC:2F:71:3F:1F:24,2336144,514502084,183423,241402662,2152721,273099422,6,129660,154269136,129560,154256982,100,12154,125610,560,183468,30610,6,223,144444.0,43333.0,-70.0,-62.0,-73.0,-71.0,-70.0,-62.0,-72.0,-71.0,-84.0,-89.0,-84.0,-90.0,14.0,27.0,11.0,19.0,1
121,F8:59:71:5A:E0:3D,2216126,369483929,63401,96384103,2152725,273099826,337,43297,59974335,43221,59962344,76,11991,43026,33,63397,7737,337,35,144444.0,43333.0,-67.0,-73.0,-65.0,-70.0,-67.0,-73.0,-65.0,-70.0,-84.0,-89.0,-84.0,-90.0,17.0,16.0,19.0,20.0,1
122,CC:2F:71:3E:C5:1F,2152801,273108912,76,9086,2152725,273099826,0,351,29688,297,23118,54,6570,85,1,128,7,0,18,144444.0,39000.0,-70.0,-70.0,-66.0,-60.0,-70.0,-72.0,-67.0,-62.0,-84.0,-89.0,-84.0,-90.0,14.0,19.0,18.0,30.0,1
123,CC:2F:71:3F:1F:24,2336500,514807790,183775,241707964,2152725,273099826,6,129954,154515278,129854,154503124,100,12154,125904,560,183820,30621,6,223,144444.0,43333.0,-70.0,-62.0,-73.0,-72.0,-70.0,-62.0,-72.0,-71.0,-84.0,-89.0,-84.0,-90.0,14.0,27.0,11.0,18.0,1
124,F8:59:71:5A:E0:3D,2216191,369580595,63464,96480567,2152727,273100028,337,43361,60071461,43285,60059470,76,11991,43090,33,63460,7739,337,35,144444.0,43333.0,-67.0,-73.0,-66.0,-70.0,-67.0,-73.0,-65.0,-70.0,-84.0,-89.0,-84.0,-90.0,17.0,16.0,18.0,20.0,1
125,CC:2F:71:3E:C5:1F,2152803,273109114,76,9086,2152727,273100028,0,351,29688,297,23118,54,6570,85,1,128,7,0,18,144444.0,39000.0,-70.0,-70.0,-66.0,-60.0,-70.0,-72.0,-67.0,-62.0,-84.0,-89.0,-84.0,-90.0,14.0,19.0,18.0,30.0,1
126,CC:2F:71:3F:1F:24,2336956,515230986,184227,242130756,2152729,273100230,6,130288,154786080,130188,154773926,100,12154,126234,560,184271,30628,6,226,144444.0,43333.0,-71.0,-62.0,-73.0,-72.0,-70.0,-62.0,-73.0,-71.0,-83.0,-89.0,-84.0,-90.0,12.0,27.0,11.0,18.0,1
127,F8:59:71:5A:E0:3D,2216261,369679163,63527,96578469,2152734,273100694,337,43423,60166941,43347,60154950,76,11991,43152,33,63523,7739,337,35,144444.0,43333.0,-68.0,-73.0,-66.0,-70.0,-67.0,-73.0,-65.0,-70.0,-83.0,-89.0,-84.0,-90.0,15.0,16.0,18.0,20.0,1
128,CC:2F:71:3E:C5:1F,2152810,273109780,76,9086,2152734,273100694,0,351,29688,297,23118,54,6570,85,1,128,7,0,18,144444.0,39000.0,-70.0,-70.0,-66.0,-60.0,-70.0,-72.0,-67.0,-62.0,-83.0,-89.0,-84.0,-90.0,13.0,19.0,18.0,30.0,1
129,CC:2F:71:3F:1F:24,2337117,515434578,184383,242333884,2152734,273100694,6,130435,154983550,130335,154971396,100,12154,126378,560,184428,30632,6,226,144444.0,43333.0,-70.0,-62.0,-72.0,-72.0,-70.0,-62.0,-72.0,-71.0,-83.0,-89.0,-84.0,-90.0,13.0,27.0,12.0,18.0,1
130,F8:59:71:5A:E0:3D,2216331,369777942,63595,96677046,2152736,273100896,337,43489,60265096,43413,60253105,76,11991,43218,33,63591,7739,337,35,144444.0,39000.0,-68.0,-73.0,-65.0,-70.0,-67.0,-73.0,-65.0,-70.0,-83.0,-89.0,-83.0,-89.0,15.0,16.0,18.0,19.0,1
131,CC:2F:71:3E:C5:1F,2152812,273109982,76,9086,2152736,273100896,0,351,29688,297,23118,54,6570,85,1,128,7,0,18,144444.0,39000.0,-70.0,-70.0,-66.0,-60.0,-70.0,-72.0,-67.0,-62.0,-83.0,-89.0,-83.0,-89.0,13.0,19.0,17.0,29.0,1
132,CC:2F:71:3F:1F:24,2337291,515642753,184555,242541857,2152736,273100896,6,130592,155183004,130492,155170850,100,12154,126535,560,184600,30637,6,226,144444.0,43333.0,-71.0,-62.0,-73.0,-72.0,-70.0,-62.0,-73.0,-72.0,-83.0,-89.0,-83.0,-89.0,12.0,27.0,10.0,17.0,1
133,F8:59:71:5A:E0:3D,2216541,370094895,63801,96993595,2152740,273101300,337,43586,60367983,43510,60355992,76,11991,43315,33,63797,7782,337,35,144444.0,43333.0,-68.0,-73.0,-66.0,-70.0,-67.0,-73.0,-65.0,-70.0,-83.0,-89.0,-83.0,-89.0,15.0,16.0,17.0,19.0,1
134,CC:2F:71:3E:C5:1F,2152818,273110588,76,9086,2152742,273101502,0,351,29688,297,23118,54,6570,85,1,128,7,0,18,144444.0,39000.0,-70.0,-70.0,-66.0,-60.0,-70.0,-72.0,-67.0,-62.0,-83.0,-89.0,-83.0,-89.0,13.0,19.0,17.0,29.0,1
135,CC:2F:71:3F:1F:24,2337455,515848175,184713,242746673,2152742,273101502,6,130738,155379229,130638,155367075,100,12154,126679,560,184758,30638,6,227,144444.0,43333.0,-71.0,-62.0,-74.0,-72.0,-70.0,-62.0,-73.0,-71.0,-83.0,-89.0,-83.0,-89.0,12.0,27.0,9.0,17.0,1
136,F8:59:71:5A:E0:3D,2216615,370194019,63867,97091955,2152748,273102064,337,43656,60469056,43580,60457065,76,11991,43382,33,63863,7782,337,35,144444.0,43333.0,-67.0,-73.0,-66.0,-70.0,-67.0,-73.0,-65.0,-69.0,-83.0,-89.0,-83.0,-89.0,16.0,16.0,17.0,19.0,1
137,CC:2F:71:3E:C5:1F,2152824,273111150,76,9086,2152748,273102064,0,351,29688,297,23118,54,6570,85,1,128,7,0,18,144444.0,39000.0,-70.0,-70.0,-66.0,-60.0,-70.0,-72.0,-67.0,-62.0,-83.0,-89.0,-83.0,-89.0,13.0,19.0,17.0,29.0,1
138,CC:2F:71:3F:1F:24,2337632,516055953,184884,242953889,2152748,273102064,6,130894,155578629,130791,155566007,103,12622,126835,560,184929,30639,6,228,144444.0,43333.0,-71.0,-63.0,-72.0,-69.0,-71.0,-62.0,-72.0,-69.0,-83.0,-89.0,-83.0,-89.0,12.0,26.0,11.0,20.0,1
139,F8:59:71:5A:E0:3D,2216805,370479966,64051,97377142,2152754,273102824,337,43735,60574042,43659,60562051,76,11991,43460,33,64047,7783,337,35,144444.0,43333.0,-68.0,-74.0,-67.0,-70.0,-68.0,-73.0,-66.0,-70.0,-83.0,-89.0,-83.0,-89.0,15.0,15.0,16.0,19.0,1
140,CC:2F:71:3E:C5:1F,2152830,273111910,76,9086,2152754,273102824,0,351,29688,297,23118,54,6570,85,1,128,7,0,18,144444.0,39000.0,-70.0,-70.0,-66.0,-60.0,-70.0,-72.0,-67.0,-62.0,-83.0,-89.0,-83.0,-89.0,13.0,19.0,17.0,29.0,1
141,CC:2F:71:3F:1F:24,2337806,516267492,185052,243164668,2152754,273102824,6,131048,155785329,130943,155772239,105,13090,126988,560,185097,30666,6,228,130000.0,43333.0,-70.0,-62.0,-73.0,-68.0,-69.0,-62.0,-73.0,-68.0,-83.0,-89.0,-83.0,-89.0,13.0,27.0,10.0,21.0,1
142,F8:59:71:5A:E0:3D,2216876,370580455,64115,97476598,2152761,273103857,337,43802,60674296,43726,60662305,76,11991,43524,33,64111,7784,337,35,144444.0,43333.0,-68.0,-74.0,-66.0,-70.0,-67.0,-73.0,-66.0,-70.0,-82.0,-89.0,-83.0,-89.0,14.0,15.0,17.0,19.0,1
143,CC:2F:71:3E:C5:1F,2152837,273112943,76,9086,2152761,273103857,0,351,29688,297,23118,54,6570,85,1,128,7,0,18,144444.0,39000.0,-70.0,-70.0,-66.0,-60.0,-70.0,-72.0,-67.0,-62.0,-82.0,-89.0,-83.0,-89.0,12.0,19.0,17.0,29.0,1
144,CC:2F:71:3F:1F:24,2337974,516476619,185212,243372702,2152762,273103917,6,131202,155988213,131095,155974655,107,13558,127141,560,185257,30666,6,228,130000.0,43333.0,-70.0,-63.0,-75.0,-68.0,-70.0,-62.0,-74.0,-68.0,-82.0,-89.0,-83.0,-89.0,12.0,26.0,8.0,21.0,1
145,F8:59:71:5A:E0:3D,2216949,370679608,64183,97575287,2152766,273104321,337,43869,60771047,43793,60759056,76,11991,43589,33,64179,7784,337,35,144444.0,43333.0,-67.0,-73.0,-65.0,-70.0,-67.0,-73.0,-65.0,-70.0,-82.0,-89.0,-83.0,-89.0,15.0,16.0,18.0,19.0,1
146,CC:2F:71:3E:C5:1F,2152842,273113407,76,9086,2152766,273104321,0,351,29688,297,23118,54,6570,85,1,128,7,0,18,144444.0,39000.0,-70.0,-70.0,-66.0,-60.0,-70.0,-72.0,-67.0,-62.0,-82.0,-89.0,-83.0,-89.0,12.0,19.0,17.0,29.0,1
147,CC:2F:71:3F:1F:24,2338152,516687911,185386,243583590,2152766,273104321,6,131361,156189130,131254,156175572,107,13558,127299,560,185431,30668,6,228,130000.0,43333.0,-70.0,-63.0,-74.0,-68.0,-70.0,-63.0,-74.0,-68.0,-82.0,-89.0,-83.0,-89.0,12.0,26.0,9.0,21.0,1
148,F8:59:71:5A:E0:3D,2217092,370878724,64311,97772775,2152781,273105949,337,44066,61073017,43990,61061026,76,11991,43785,33,64307,7784,337,35,144444.0,43333.0,-68.0,-74.0,-67.0,-70.0,-67.0,-73.0,-66.0,-70.0,-81.0,-87.0,-81.0,-88.0,13.0,13.0,14.0,18.0,1
149,CC:2F:71:3E:C5:1F,2152872,273116509,76,9086,2152796,273107423,0,351,29688,297,23118,54,6570,85,1,128,7,0,18,144444.0,39000.0,-70.0,-70.0,-66.0,-60.0,-70.0,-72.0,-67.0,-62.0,-80.0,-85.0,-80.0,-86.0,10.0,15.0,14.0,26.0,1
150,CC:2F:71:3F:1F:24,2339461,518337856,186659,245229689,2152802,273108167,6,132614,157898580,132503,157884086,111,14494,128440,560,186704,30701,6,332,115556.0,28889.0,-70.0,-62.0,-73.0,-71.0,-70.0,-62.0,-73.0,-71.0,-80.0,-84.0,-81.0,-86.0,10.0,22.0,8.0,15.0,1
151,F8:59:71:5A:E0:3D,2217787,371901104,64979,98792331,2152808,273108773,337,44519,61691160,44443,61679169,76,11991,44236,33,64974,7809,337,37,144444.0,43333.0,-68.0,-74.0,-66.0,-70.0,-67.0,-73.0,-66.0,-70.0,-80.0,-84.0,-81.0,-86.0,12.0,10.0,15.0,16.0,1
152,CC:2F:71:3E:C5:1F,2152884,273117859,76,9086,2152808,273108773,0,351,29688,297,23118,54,6570,85,1,128,7,0,18,144444.0,39000.0,-70.0,-70.0,-66.0,-60.0,-70.0,-72.0,-67.0,-62.0,-80.0,-84.0,-81.0,-86.0,10.0,14.0,15.0,26.0,1
153,CC:2F:71:3F:1F:24,2340145,518752326,187335,245643351,2152810,273108975,6,133425,159103240,133314,159088746,111,14494,129250,560,187379,30734,6,344,115556.0,28889.0,-69.0,-65.0,-72.0,-72.0,-69.0,-64.0,-71.0,-71.0,-80.0,-84.0,-81.0,-86.0,11.0,19.0,9.0,14.0,1
154,F8:59:71:5A:E0:3D,2217893,372053730,65078,98944291,2152815,273109439,337,44625,61852966,44549,61840975,76,11991,44342,33,65074,7818,337,37,144444.0,43333.0,-67.0,-73.0,-66.0,-70.0,-67.0,-73.0,-66.0,-70.0,-80.0,-84.0,-81.0,-86.0,13.0,11.0,15.0,16.0,1
155,CC:2F:71:3E:C5:1F,2152891,273118525,76,9086,2152815,273109439,0,353,29828,299,23258,54,6570,85,1,129,7,0,18,144444.0,39000.0,-70.0,-70.0,-66.0,-60.0,-70.0,-72.0,-67.0,-62.0,-80.0,-84.0,-81.0,-86.0,10.0,14.0,15.0,26.0,1
156,CC:2F:71:3F:1F:24,2340465,519029396,187650,245919957,2152815,273109439,6,133806,159647241,133695,159632747,111,14494,129631,560,187695,30749,6,359,130000.0,43333.0,-78.0,-78.0,-79.0,-81.0,-69.0,-65.0,-72.0,-72.0,-80.0,-84.0,-81.0,-86.0,2.0,6.0,2.0,5.0,1
157,F8:59:71:5A:E0:3D,2217972,372169246,65153,99059403,2152819,273109843,337,44699,61966926,44623,61954935,76,11991,44416,33,65149,7818,337,37,144444.0,43333.0,-68.0,-74.0,-66.0,-70.0,-67.0,-73.0,-66.0,-70.0,-80.0,-84.0,-81.0,-86.0,12.0,10.0,15.0,16.0,1
158,CC:2F:71:3E:C5:1F,2152896,273119045,77,9202,2152819,273109843,0,355,29968,301,23398,54,6570,85,1,130,7,0,18,144444.0,39000.0,-70.0,-70.0,-66.0,-60.0,-70.0,-72.0,-67.0,-62.0,-80.0,-84.0,-81.0,-86.0,10.0,14.0,15.0,26.0,1
159,CC:2F:71:3F:1F:24,2340760,519404455,187935,246293873,2152825,273110582,6,134084,160026460,133972,160011848,112,14612,129897,560,187979,30759,6,381,104000.0,26000.0,-71.0,-64.0,-71.0,-71.0,-69.0,-63.0,-71.0,-70.0,-80.0,-84.0,-81.0,-86.0,9.0,20.0,10.0,15.0,1
160,F8:59:71:5A:E0:3D,2218524,372989558,65678,99872622,2152846,273116936,337,44980,62316439,44904,62304448,76,11991,44697,33,65674,7825,337,38,144444.0,43333.0,-68.0,-74.0,-67.0,-71.0,-67.0,-73.0,-66.0,-70.0,-80.0,-84.0,-81.0,-86.0,12.0,10.0,14.0,15.0,1
161,CC:2F:71:3E:C5:1F,2152923,273126138,77,9202,2152846,273116936,0,357,30156,302,23468,55,6688,86,1,130,7,0,18,144444.0,39000.0,-70.0,-70.0,-66.0,-60.0,-70.0,-71.0,-67.0,-61.0,-80.0,-84.0,-81.0,-86.0,10.0,14.0,15.0,26.0,1
162,CC:2F:71:3F:1F:24,2341269,520014445,188423,246897509,2152846,273116936,6,134569,160663303,134457,160648691,112,14612,130330,561,188469,30792,6,414,130000.0,43333.0,-71.0,-63.0,-74.0,-70.0,-70.0,-63.0,-73.0,-70.0,-80.0,-84.0,-81.0,-86.0,9.0,21.0,7.0,16.0,1
163,F8:59:71:5A:E0:3D,2218609,373102672,65747,99979848,2152862,273122824,337,45050,62424239,44974,62412248,76,11991,44767,33,65743,7825,337,38,144444.0,43333.0,-68.0,-74.0,-67.0,-71.0,-67.0,-73.0,-66.0,-70.0,-80.0,-84.0,-81.0,-86.0,12.0,10.0,14.0,15.0,1
164,CC:2F:71:3E:C5:1F,2152939,273132026,77,9202,2152862,273122824,0,357,30156,302,23468,55,6688,86,1,130,7,0,18,144444.0,39000.0,-70.0,-70.0,-66.0,-60.0,-70.0,-71.0,-67.0,-61.0,-80.0,-84.0,-81.0,-86.0,10.0,14.0,15.0,26.0,1
165,CC:2F:71:3F:1F:24,2341569,520311630,188707,247188806,2152862,273122824,6,134794,160902209,134682,160887597,112,14612,130553,561,188753,30792,6,414,130000.0,43333.0,-70.0,-63.0,-74.0,-70.0,-70.0,-63.0,-74.0,-70.0,-80.0,-84.0,-81.0,-86.0,10.0,21.0,7.0,16.0,1
166,F8:59:71:5A:E0:3D,2218677,373201108,65811,100077880,2152866,273123228,337,45114,62521375,45038,62509384,76,11991,44831,33,65807,7825,337,38,144444.0,43333.0,-67.0,-74.0,-66.0,-71.0,-67.0,-74.0,-66.0,-70.0,-80.0,-84.0,-81.0,-86.0,13.0,10.0,15.0,15.0,1
167,CC:2F:71:3E:C5:1F,2152943,273132430,77,9202,2152866,273123228,0,357,30156,302,23468,55,6688,86,1,130,7,0,18,144444.0,39000.0,-70.0,-70.0,-66.0,-60.0,-70.0,-71.0,-67.0,-61.0,-80.0,-84.0,-81.0,-86.0,10.0,14.0,15.0,26.0,1
168,CC:2F:71:3F:1F:24,2341879,520673454,189013,247550226,2152866,273123228,6,134989,161122181,134877,161107569,112,14612,130748,561,189058,30812,6,414,117000.0,39000.0,-70.0,-63.0,-74.0,-70.0,-70.0,-62.0,-73.0,-69.0,-80.0,-84.0,-81.0,-86.0,10.0,21.0,7.0,16.0,1
169,F8:59:71:5A:E0:3D,2218742,373299044,65874,100175614,2152868,273123430,337,45178,62619949,45102,62607958,76,11991,44894,33,65870,7825,337,38,144444.0,43333.0,-68.0,-74.0,-67.0,-71.0,-67.0,-74.0,-66.0,-70.0,-80.0,-84.0,-81.0,-86.0,12.0,10.0,14.0,15.0,1
170,CC:2F:71:3E:C5:1F,2152946,273132766,77,9202,2152869,273123564,0,357,30156,302,23468,55,6688,86,1,130,7,0,18,144444.0,39000.0,-70.0,-70.0,-66.0,-60.0,-70.0,-71.0,-67.0,-61.0,-80.0,-84.0,-81.0,-86.0,10.0,14.0,15.0,26.0,1
171,CC:2F:71:3F:1F:24,2342133,520952562,189263,247828930,2152870,273123632,6,135194,161351123,135082,161336511,112,14612,130948,561,189309,30813,6,414,130000.0,43333.0,-71.0,-64.0,-75.0,-71.0,-70.0,-63.0,-74.0,-70.0,-80.0,-84.0,-81.0,-86.0,9.0,20.0,6.0,15.0,1
172,F8:59:71:5A:E0:3D,2218818,373404184,65941,100279732,2152877,273124452,337,45245,62723143,45169,62711152,76,11991,44960,33,65937,7825,337,38,144444.0,43333.0,-68.0,-74.0,-66.0,-70.0,-68.0,-74.0,-66.0,-70.0,-80.0,-84.0,-81.0,-86.0,12.0,10.0,15.0,16.0,1
173,CC:2F:71:3E:C5:1F,2152954,273133654,77,9202,2152877,273124452,0,357,30156,302,23468,55,6688,86,1,130,7,0,18,144444.0,39000.0,-70.0,-70.0,-66.0,-60.0,-70.0,-71.0,-67.0,-61.0,-80.0,-84.0,-81.0,-86.0,10.0,14.0,15.0,26.0,1
174,CC:2F:71:3F:1F:24,2342384,521195876,189507,248071424,2152877,273124452,6,135402,161583701,135288,161568621,114,15080,131153,561,189553,30814,6,417,130000.0,43333.0,-71.0,-64.0,-75.0,-71.0,-70.0,-63.0,-74.0,-70.0,-80.0,-84.0,-81.0,-86.0,9.0,20.0,6.0,15.0,1
175,F8:59:71:5A:E0:3D,2218911,373542837,66032,100418183,2152879,273124654,337,45315,62825703,45239,62813712,76,11991,45030,33,66028,7825,337,38,144444.0,43333.0,-68.0,-74.0,-67.0,-71.0,-68.0,-74.0,-66.0,-70.0,-80.0,-84.0,-81.0,-86.0,12.0,10.0,14.0,15.0,1
176,CC:2F:71:3E:C5:1F,2152956,273133856,77,9202,2152879,273124654,0,357,30156,302,23468,55,6688,86,1,130,7,0,18,144444.0,39000.0,-70.0,-70.0,-66.0,-60.0,-70.0,-71.0,-67.0,-61.0,-80.0,-84.0,-81.0,-86.0,10.0,14.0,15.0,26.0,1
177,CC:2F:71:3F:1F:24,2342541,521400164,189662,248275510,2152879,273124654,6,135551,161788699,135437,161773619,114,15080,131295,561,189707,30822,6,417,117000.0,39000.0,-71.0,-64.0,-75.0,-71.0,-70.0,-63.0,-74.0,-70.0,-80.0,-84.0,-81.0,-86.0,9.0,20.0,6.0,15.0,1
178,F8:59:71:5A:E0:3D,2219103,373832497,66220,100707439,2152883,273125058,337,45407,62929668,45331,62917677,76,11991,45122,33,66216,7825,337,38,144444.0,43333.0,-68.0,-74.0,-66.0,-71.0,-67.0,-74.0,-66.0,-70.0,-80.0,-84.0,-81.0,-86.0,12.0,10.0,15.0,15.0,1
179,CC:2F:71:3E:C5:1F,2152960,273134260,77,9202,2152883,273125058,0,357,30156,302,23468,55,6688,86,1,130,7,0,18,144444.0,39000.0,-70.0,-70.0,-66.0,-60.0,-70.0,-71.0,-67.0,-61.0,-80.0,-84.0,-81.0,-86.0,10.0,14.0,15.0,26.0,1
180,CC:2F:71:3F:1F:24,2342740,521615189,189855,248489929,2152885,273125260,6,135727,162012505,135613,161997425,114,15080,131464,561,189901,30825,6,417,130000.0,43333.0,-70.0,-63.0,-74.0,-70.0,-70.0,-63.0,-74.0,-70.0,-80.0,-84.0,-81.0,-86.0,10.0,21.0,7.0,16.0,1
181,F8:59:71:5A:E0:3D,2219168,373929107,66282,100803787,2152886,273125320,337,45469,63025148,45393,63013157,76,11991,45184,33,66278,7825,337,38,144444.0,43333.0,-68.0,-74.0,-67.0,-71.0,-67.0,-74.0,-67.0,-70.0,-80.0,-84.0,-81.0,-86.0,12.0,10.0,14.0,15.0,1
182,CC:2F:71:3E:C5:1F,2152963,273134522,77,9202,2152886,273125320,0,357,30156,302,23468,55,6688,86,1,130,7,0,18,144444.0,39000.0,-70.0,-70.0,-66.0,-60.0,-70.0,-71.0,-67.0,-61.0,-80.0,-84.0,-81.0,-86.0,10.0,14.0,15.0,26.0,1
183,CC:2F:71:3F:1F:24,2342919,521827063,190031,248701541,2152888,273125522,6,135883,162214842,135769,162199762,114,15080,131619,561,190077,30827,6,417,130000.0,43333.0,-71.0,-63.0,-74.0,-70.0,-70.0,-62.0,-73.0,-69.0,-80.0,-84.0,-81.0,-86.0,9.0,21.0,7.0,16.0,1
184,F8:59:71:5A:E0:3D,2219239,374027936,66348,100902150,2152891,273125786,337,45537,63124574,45460,63112465,77,12109,45252,33,66344,7825,337,38,144444.0,43333.0,-68.0,-74.0,-67.0,-71.0,-67.0,-74.0,-66.0,-70.0,-80.0,-84.0,-81.0,-86.0,12.0,10.0,14.0,15.0,1
185,CC:2F:71:3E:C5:1F,2152970,273135190,77,9202,2152893,273125988,0,357,30156,302,23468,55,6688,86,1,130,7,0,18,144444.0,39000.0,-70.0,-70.0,-66.0,-60.0,-70.0,-71.0,-67.0,-61.0,-80.0,-84.0,-81.0,-86.0,10.0,14.0,15.0,26.0,1
186,CC:2F:71:3F:1F:24,2343108,522043178,190215,248917190,2152893,273125988,6,136054,162421362,135940,162406282,114,15080,131788,561,190261,30839,6,417,130000.0,43333.0,-70.0,-62.0,-74.0,-70.0,-70.0,-62.0,-73.0,-69.0,-80.0,-84.0,-81.0,-86.0,10.0,22.0,7.0,16.0,1
187,F8:59:71:5A:E0:3D,2219310,374128254,66415,101002064,2152895,273126190,337,45605,63225493,45528,63213384,77,12109,45320,33,66411,7825,337,38,144444.0,43333.0,-68.0,-74.0,-67.0,-71.0,-68.0,-74.0,-66.0,-70.0,-80.0,-84.0,-81.0,-86.0,12.0,10.0,14.0,15.0,1
188,CC:2F:71:3E:C5:1F,2152972,273135392,77,9202,2152895,273126190,0,357,30156,302,23468,55,6688,86,1,130,7,0,18,144444.0,39000.0,-70.0,-70.0,-66.0,-60.0,-70.0,-71.0,-67.0,-61.0,-80.0,-84.0,-81.0,-86.0,10.0,14.0,15.0,26.0,1
189,CC:2F:71:3F:1F:24,2343275,522249718,190380,249123528,2152895,273126190,6,136204,162622691,136090,162607611,114,15080,131937,561,190424,30839,6,419,130000.0,43333.0,-70.0,-63.0,-73.0,-70.0,-70.0,-62.0,-74.0,-70.0,-80.0,-84.0,-81.0,-86.0,10.0,21.0,8.0,16.0,1
190,F8:59:71:5A:E0:3D,2219391,374245437,66491,101118783,2152900,273126654,337,45684,63344428,45607,63332319,77,12109,45398,33,66486,7826,337,38,144444.0,43333.0,-68.0,-74.0,-66.0,-71.0,-68.0,-74.0,-66.0,-70.0,-80.0,-84.0,-81.0,-86.0,12.0,10.0,15.0,15.0,1
191,CC:2F:71:3E:C5:1F,2152979,273136058,77,9202,2152902,273126856,0,357,30156,302,23468,55,6688,86,1,130,7,0,18,144444.0,39000.0,-70.0,-70.0,-66.0,-60.0,-70.0,-71.0,-67.0,-61.0,-80.0,-84.0,-81.0,-86.0,10.0,14.0,15.0,26.0,1
192,CC:2F:71:3F:1F:24,2343702,522607774,190800,249480918,2152902,273126856,6,136709,163319811,136595,163304731,114,15080,132442,561,190845,30858,6,426,130000.0,43333.0,-71.0,-63.0,-73.0,-68.0,-71.0,-63.0,-73.0,-68.0,-80.0,-84.0,-81.0,-86.0,9.0,21.0,8.0,18.0,1
193,F8:59:71:5A:E0:3D,2219471,374363945,66567,101236887,2152904,273127058,337,45759,63459984,45682,63447875,77,12109,45473,33,66563,7829,337,38,144444.0,43333.0,-68.0,-73.0,-66.0,-70.0,-67.0,-73.0,-66.0,-70.0,-80.0,-84.0,-81.0,-86.0,12.0,11.0,15.0,16.0,1
194,CC:2F:71:3E:C5:1F,2152981,273136260,77,9202,2152904,273127058,0,357,30156,302,23468,55,6688,86,1,130,7,0,18,144444.0,39000.0,-70.0,-70.0,-66.0,-60.0,-70.0,-71.0,-67.0,-61.0,-80.0,-84.0,-81.0,-86.0,10.0,14.0,15.0,26.0,1
195,CC:2F:71:3F:1F:24,2344108,522910183,191204,249783125,2152904,273127058,6,137183,163952714,137069,163937634,114,15080,132912,561,191249,30862,6,431,130000.0,43333.0,-72.0,-63.0,-75.0,-68.0,-71.0,-63.0,-74.0,-68.0,-80.0,-84.0,-81.0,-86.0,8.0,21.0,6.0,18.0,1
196,F8:59:71:5A:E0:3D,2219682,374660407,66770,101532410,2152912,273127997,337,45857,63564920,45780,63552811,77,12109,45571,33,66766,7908,337,38,144444.0,43333.0,-68.0,-73.0,-66.0,-70.0,-67.0,-73.0,-66.0,-70.0,-80.0,-84.0,-81.0,-86.0,12.0,11.0,15.0,16.0,1
197,CC:2F:71:3E:C5:1F,2152989,273137199,77,9202,2152912,273127997,0,357,30156,302,23468,55,6688,86,1,130,7,0,18,144444.0,39000.0,-70.0,-70.0,-66.0,-60.0,-70.0,-71.0,-67.0,-61.0,-80.0,-84.0,-81.0,-86.0,10.0,14.0,15.0,26.0,1
198,CC:2F:71:3F:1F:24,2344355,523182519,191443,250054522,2152912,273127997,6,137366,164164645,137252,164149565,114,15080,133095,561,191489,30867,6,431,130000.0,43333.0,-72.0,-63.0,-74.0,-68.0,-71.0,-63.0,-74.0,-68.0,-80.0,-84.0,-81.0,-86.0,8.0,21.0,7.0,18.0,1
199,F8:59:71:5A:E0:3D,2219750,374760433,66834,101631866,2152916,273128567,337,45921,63663480,45844,63651371,77,12109,45635,33,66830,7909,337,38,144444.0,43333.0,-67.0,-73.0,-66.0,-70.0,-67.0,-73.0,-66.0,-69.0,-80.0,-84.0,-81.0,-86.0,13.0,11.0,15.0,16.0,1
200,CC:2F:71:3E:C5:1F,2152993,273137769,77,9202,2152916,273128567,0,357,30156,302,23468,55,6688,86,1,130,7,0,18,144444.0,39000.0,-70.0,-70.0,-66.0,-60.0,-70.0,-71.0,-67.0,-61.0,-80.0,-84.0,-81.0,-86.0,10.0,14.0,15.0,26.0,1
201,CC:2F:71:3F:1F:24,2344540,523404114,191624,250275547,2152916,273128567,6,137528,164370060,137414,164354980,114,15080,133255,561,191670,30897,6,431,86667.0,14444.0,-69.0,-62.0,-72.0,-70.0,-68.0,-62.0,-71.0,-69.0,-80.0,-84.0,-81.0,-86.0,11.0,22.0,9.0,16.0,1
202,F8:59:71:5A:E0:3D,2219815,374855631,66895,101726660,2152920,273128971,337,45982,63757420,45905,63745311,77,12109,45696,33,66891,7910,337,38,144444.0,43333.0,-66.0,-73.0,-65.0,-70.0,-66.0,-72.0,-65.0,-70.0,-80.0,-84.0,-81.0,-86.0,14.0,11.0,16.0,16.0,1
203,CC:2F:71:3E:C5:1F,2152997,273138173,77,9202,2152920,273128971,0,357,30156,302,23468,55,6688,86,1,130,7,0,18,144444.0,39000.0,-70.0,-70.0,-66.0,-60.0,-70.0,-71.0,-67.0,-61.0,-80.0,-84.0,-81.0,-86.0,10.0,14.0,15.0,26.0,1
204,CC:2F:71:3F:1F:24,2344754,523639947,191834,250510976,2152920,273128971,6,137705,164575483,137591,164560403,114,15080,133432,561,191880,30909,6,431,130000.0,39000.0,-69.0,-61.0,-74.0,-69.0,-68.0,-61.0,-73.0,-69.0,-80.0,-84.0,-81.0,-86.0,11.0,23.0,7.0,17.0,1
205,F8:59:71:5A:E0:3D,2219883,374953997,66958,101824562,2152925,273129435,337,46046,63855994,45969,63843885,77,12109,45759,33,66954,7910,337,38,144444.0,43333.0,-68.0,-72.0,-66.0,-69.0,-67.0,-72.0,-65.0,-69.0,-80.0,-84.0,-81.0,-86.0,12.0,12.0,15.0,17.0,1
206,CC:2F:71:3E:C5:1F,2153002,273138637,77,9202,2152925,273129435,0,357,30156,302,23468,55,6688,86,1,130,7,0,18,144444.0,39000.0,-70.0,-70.0,-66.0,-60.0,-70.0,-71.0,-67.0,-61.0,-80.0,-84.0,-81.0,-86.0,10.0,14.0,15.0,26.0,1
207,CC:2F:71:3F:1F:24,2344961,523880800,192036,250751365,2152925,273129435,6,137877,164779992,137763,164764912,114,15080,133603,561,192082,30910,6,432,144444.0,43333.0,-70.0,-64.0,-70.0,-70.0,-69.0,-63.0,-69.0,-70.0,-80.0,-84.0,-81.0,-86.0,10.0,20.0,11.0,16.0,1
208,F8:59:71:5A:E0:3D,2219946,375048993,67019,101919356,2152927,273129637,337,46108,63951474,46031,63939365,77,12109,45821,33,67015,7910,337,38,144444.0,43333.0,-68.0,-72.0,-65.0,-69.0,-67.0,-72.0,-65.0,-69.0,-80.0,-84.0,-81.0,-86.0,12.0,12.0,16.0,17.0,1
209,CC:2F:71:3E:C5:1F,2153004,273138839,77,9202,2152927,273129637,0,357,30156,302,23468,55,6688,86,1,130,7,0,18,144444.0,39000.0,-70.0,-70.0,-66.0,-60.0,-70.0,-71.0,-67.0,-61.0,-80.0,-84.0,-81.0,-86.0,10.0,14.0,15.0,26.0,1
210,CC:2F:71:3F:1F:24,2345170,524098911,192241,250969072,2152929,273129839,6,138066,164996377,137952,164981297,114,15080,133792,561,192287,30910,6,432,144444.0,43333.0,-70.0,-64.0,-69.0,-69.0,-69.0,-63.0,-69.0,-69.0,-80.0,-84.0,-81.0,-86.0,10.0,20.0,12.0,17.0,1
211,F8:59:71:5A:E0:3D,2220216,375464232,67285,102334191,2152931,273130041,337,46210,64056351,46133,64044242,77,12109,45922,33,67281,7910,337,38,144444.0,43333.0,-67.0,-72.0,-65.0,-70.0,-67.0,-72.0,-65.0,-69.0,-80.0,-84.0,-81.0,-86.0,13.0,12.0,16.0,16.0,1
212,CC:2F:71:3E:C5:1F,2153008,273139243,77,9202,2152931,273130041,0,357,30156,302,23468,55,6688,86,1,130,7,0,18,144444.0,39000.0,-70.0,-70.0,-66.0,-60.0,-70.0,-71.0,-67.0,-61.0,-80.0,-84.0,-81.0,-86.0,10.0,14.0,15.0,26.0,1
213,CC:2F:71:3F:1F:24,2345374,524321985,192441,251191742,2152933,273130243,6,138243,165199745,138129,165184665,114,15080,133969,561,192487,30911,6,432,144444.0,43333.0,-70.0,-64.0,-68.0,-70.0,-70.0,-63.0,-68.0,-70.0,-80.0,-84.0,-81.0,-86.0,10.0,20.0,13.0,16.0,1
214,F8:59:71:5A:E0:3D,2220319,375610077,67383,102479572,2152936,273130505,337,46285,64161273,46208,64149164,77,12109,45996,33,67379,7910,337,38,144444.0,43333.0,-68.0,-73.0,-66.0,-71.0,-67.0,-72.0,-65.0,-70.0,-80.0,-84.0,-81.0,-86.0,12.0,11.0,15.0,15.0,1
215,CC:2F:71:3E:C5:1F,2153013,273139707,77,9202,2152936,273130505,0,357,30156,302,23468,55,6688,86,1,130,7,0,18,144444.0,39000.0,-70.0,-70.0,-66.0,-60.0,-70.0,-71.0,-67.0,-61.0,-80.0,-84.0,-81.0,-86.0,10.0,14.0,15.0,26.0,1
216,CC:2F:71:3F:1F:24,2345546,524528436,192610,251397931,2152936,273130505,6,138398,165396309,138284,165381229,114,15080,134124,561,192656,30912,6,432,144444.0,43333.0,-69.0,-64.0,-71.0,-70.0,-69.0,-64.0,-69.0,-70.0,-80.0,-84.0,-81.0,-86.0,11.0,20.0,10.0,16.0,1
217,F8:59:71:5A:E0:3D,2220388,375710053,67448,102579144,2152940,273130909,337,46351,64261479,46274,64249370,77,12109,46062,33,67444,7910,337,38,144444.0,43333.0,-66.0,-74.0,-65.0,-69.0,-66.0,-73.0,-65.0,-69.0,-80.0,-84.0,-81.0,-86.0,14.0,10.0,16.0,17.0,1
218,CC:2F:71:3E:C5:1F,2153017,273140111,77,9202,2152940,273130909,0,357,30156,302,23468,55,6688,86,1,130,7,0,18,144444.0,39000.0,-70.0,-70.0,-66.0,-60.0,-70.0,-71.0,-67.0,-61.0,-80.0,-84.0,-81.0,-86.0,10.0,14.0,15.0,26.0,1
219,CC:2F:71:3F:1F:24,2345713,524742846,192773,251611937,2152940,273130909,6,138548,165603085,138434,165588005,114,15080,134273,561,192818,30919,6,436,144444.0,43333.0,-70.0,-64.0,-71.0,-71.0,-69.0,-64.0,-69.0,-70.0,-80.0,-84.0,-81.0,-86.0,10.0,20.0,10.0,15.0,1
220,F8:59:71:5A:E0:3D,2220456,375808615,67514,102677504,2152942,273131111,337,46418,64360858,46341,64348749,77,12109,46129,33,67510,7911,337,38,144444.0,43333.0,-66.0,-73.0,-64.0,-70.0,-66.0,-72.0,-64.0,-70.0,-80.0,-84.0,-81.0,-86.0,14.0,11.0,17.0,16.0,1
221,CC:2F:71:3E:C5:1F,2153021,273140515,77,9202,2152944,273131313,0,357,30156,302,23468,55,6688,86,1,130,7,0,18,144444.0,39000.0,-70.0,-70.0,-66.0,-60.0,-70.0,-71.0,-67.0,-61.0,-80.0,-84.0,-81.0,-86.0,10.0,14.0,15.0,26.0,1
222,CC:2F:71:3F:1F:24,2345887,524949082,192943,251817769,2152944,273131313,6,138703,165802081,138589,165787001,114,15080,134428,561,192989,30919,6,436,144444.0,43333.0,-70.0,-64.0,-70.0,-69.0,-70.0,-64.0,-70.0,-69.0,-80.0,-84.0,-81.0,-86.0,10.0,20.0,11.0,17.0,1
223,F8:59:71:5A:E0:3D,2220529,375911845,67580,102780068,2152949,273131777,337,46484,64462512,46407,64450403,77,12109,46194,33,67576,7911,337,38,144444.0,43333.0,-67.0,-72.0,-65.0,-70.0,-66.0,-72.0,-64.0,-70.0,-80.0,-84.0,-81.0,-86.0,13.0,12.0,16.0,16.0,1
224,CC:2F:71:3E:C5:1F,2153026,273140979,77,9202,2152949,273131777,0,357,30156,302,23468,55,6688,86,1,130,7,0,18,144444.0,39000.0,-70.0,-70.0,-66.0,-60.0,-70.0,-71.0,-67.0,-61.0,-80.0,-84.0,-81.0,-86.0,10.0,14.0,15.0,26.0,1
225,CC:2F:71:3F:1F:24,2346072,525179715,193123,252047938,2152949,273131777,6,138867,166019376,138753,166004296,114,15080,134592,561,193169,30920,6,438,144444.0,43333.0,-67.0,-64.0,-67.0,-70.0,-69.0,-64.0,-69.0,-69.0,-80.0,-84.0,-81.0,-86.0,13.0,20.0,14.0,16.0,1
226,F8:59:71:5A:E0:3D,2220596,376013057,67645,102881078,2152951,273131979,337,46550,64564152,46473,64552043,77,12109,46260,33,67641,7911,337,38,144444.0,43333.0,-67.0,-73.0,-65.0,-70.0,-66.0,-72.0,-64.0,-70.0,-80.0,-84.0,-81.0,-86.0,13.0,11.0,16.0,16.0,1
227,CC:2F:71:3E:C5:1F,2153028,273141181,77,9202,2152951,273131979,0,357,30156,302,23468,55,6688,86,1,130,7,0,18,144444.0,39000.0,-70.0,-70.0,-66.0,-60.0,-70.0,-71.0,-67.0,-61.0,-80.0,-84.0,-81.0,-86.0,10.0,14.0,15.0,26.0,1
228,CC:2F:71:3F:1F:24,2346233,525384801,193280,252252620,2152953,273132181,6,139007,166213264,138893,166198184,114,15080,134732,561,193326,30920,6,438,144444.0,43333.0,-70.0,-64.0,-70.0,-70.0,-70.0,-64.0,-70.0,-69.0,-80.0,-84.0,-81.0,-86.0,10.0,20.0,11.0,16.0,1
229,F8:59:71:5A:E0:3D,2220666,376111681,67709,102979096,2152957,273132585,337,46614,64661278,46537,64649169,77,12109,46324,33,67705,7911,337,38,144444.0,43333.0,-67.0,-73.0,-64.0,-70.0,-67.0,-73.0,-64.0,-70.0,-80.0,-84.0,-81.0,-86.0,13.0,11.0,17.0,16.0,1
230,CC:2F:71:3E:C5:1F,2153034,273141787,77,9202,2152957,273132585,0,357,30156,302,23468,55,6688,86,1,130,7,0,18,144444.0,39000.0,-70.0,-70.0,-66.0,-60.0,-70.0,-71.0,-67.0,-61.0,-80.0,-84.0,-81.0,-86.0,10.0,14.0,15.0,26.0,1
231,CC:2F:71:3F:1F:24,2346425,525607350,193468,252474765,2152957,273132585,6,139182,166430749,139068,166415669,114,15080,134907,561,193514,30922,6,438,144444.0,43333.0,-71.0,-64.0,-70.0,-70.0,-70.0,-63.0,-70.0,-70.0,-80.0,-84.0,-81.0,-86.0,9.0,20.0,11.0,16.0,1
232,F8:59:71:5A:E0:3D,2220929,376514949,67969,103382102,2152960,273132847,337,46716,64773265,46639,64761156,77,12109,46425,33,67965,7911,337,38,144444.0,43333.0,-67.0,-72.0,-64.0,-70.0,-66.0,-72.0,-64.0,-70.0,-80.0,-84.0,-81.0,-86.0,13.0,12.0,17.0,16.0,1
233,CC:2F:71:3E:C5:1F,2153037,273142049,77,9202,2152960,273132847,0,359,30296,304,23608,55,6688,86,1,131,7,0,18,144444.0,39000.0,-71.0,-69.0,-66.0,-60.0,-70.0,-69.0,-66.0,-60.0,-80.0,-84.0,-81.0,-86.0,9.0,15.0,15.0,26.0,1
234,CC:2F:71:3F:1F:24,2346599,525832612,193639,252699765,2152960,273132847,6,139340,166648229,139226,166633149,114,15080,135065,561,193685,30922,6,438,144444.0,43333.0,-68.0,-64.0,-70.0,-69.0,-69.0,-64.0,-69.0,-69.0,-80.0,-84.0,-81.0,-86.0,12.0,20.0,11.0,17.0,1
235,F8:59:71:5A:E0:3D,2221006,376624283,68040,103490830,2152966,273133453,337,46785,64879525,46708,64867416,77,12109,46494,33,68035,7911,337,38,144444.0,43333.0,-67.0,-72.0,-65.0,-70.0,-66.0,-72.0,-64.0,-70.0,-80.0,-84.0,-81.0,-86.0,13.0,12.0,16.0,16.0,1
236,CC:2F:71:3E:C5:1F,2153044,273142771,78,9318,2152966,273133453,0,361,30436,306,23748,55,6688,86,1,132,7,0,18,144444.0,39000.0,-70.0,-68.0,-66.0,-60.0,-70.0,-68.0,-66.0,-60.0,-80.0,-84.0,-81.0,-86.0,10.0,16.0,15.0,26.0,1
237,CC:2F:71:3F:1F:24,2346765,526040070,193799,252906617,2152966,273133453,6,139484,166845463,139370,166830383,114,15080,135209,561,193845,30922,6,438,144444.0,43333.0,-71.0,-64.0,-70.0,-70.0,-70.0,-64.0,-68.0,-69.0,-80.0,-84.0,-81.0,-86.0,9.0,20.0,11.0,16.0,1
238,F8:59:71:5A:E0:3D,2221073,376721462,68102,103587178,2152971,273134284,337,46850,64976685,46773,64964576,77,12109,46557,33,68098,7912,337,38,144444.0,43333.0,-66.0,-72.0,-64.0,-70.0,-66.0,-71.0,-64.0,-70.0,-80.0,-84.0,-81.0,-86.0,14.0,12.0,17.0,16.0,1
239,CC:2F:71:3E:C5:1F,2153050,273143662,78,9318,2152972,273134344,0,361,30436,306,23748,55,6688,86,1,132,7,0,18,144444.0,39000.0,-70.0,-68.0,-66.0,-60.0,-70.0,-68.0,-66.0,-60.0,-80.0,-84.0,-81.0,-86.0,10.0,16.0,15.0,26.0,1
240,CC:2F:71:3F:1F:24,2346930,526248751,193958,253114407,2152972,273134344,6,139629,167043015,139513,167027467,116,15548,135354,561,194004,30922,6,438,144444.0,43333.0,-71.0,-64.0,-70.0,-70.0,-68.0,-64.0,-69.0,-69.0,-80.0,-84.0,-81.0,-86.0,9.0,20.0,11.0,16.0,1
241,F8:59:71:5A:E0:3D,2221265,377009237,68287,103874287,2152978,273134950,337,46931,65078963,46854,65066854,77,12109,46635,33,68283,7912,337,38,144444.0,43333.0,-66.0,-72.0,-65.0,-70.0,-66.0,-71.0,-64.0,-70.0,-80.0,-84.0,-81.0,-86.0,14.0,12.0,16.0,16.0,1
242,CC:2F:71:3E:C5:1F,2153056,273144268,78,9318,2152978,273134950,0,361,30436,306,23748,55,6688,86,1,132,7,0,18,144444.0,39000.0,-70.0,-68.0,-66.0,-60.0,-70.0,-68.0,-66.0,-60.0,-80.0,-84.0,-81.0,-86.0,10.0,16.0,15.0,26.0,1
243,CC:2F:71:3F:1F:24,2347099,526454532,194121,253319582,2152978,273134950,6,139781,167240308,139665,167224760,116,15548,135505,561,194167,30923,6,438,144444.0,43333.0,-71.0,-64.0,-70.0,-69.0,-69.0,-64.0,-69.0,-69.0,-80.0,-84.0,-81.0,-86.0,9.0,20.0,11.0,17.0,1
244,F8:59:71:5A:E0:3D,2221329,377108693,68351,103973743,2152978,273134950,337,46994,65175983,46917,65163874,77,12109,46698,33,68346,7912,337,38,144444.0,43333.0,-67.0,-72.0,-65.0,-71.0,-66.0,-71.0,-64.0,-70.0,-80.0,-84.0,-81.0,-86.0,13.0,12.0,16.0,15.0,1
245,CC:2F:71:3E:C5:1F,2153058,273144470,78,9318,2152980,273135152,0,361,30436,306,23748,55,6688,86,1,132,7,0,18,144444.0,39000.0,-70.0,-68.0,-66.0,-60.0,-70.0,-68.0,-66.0,-60.0,-80.0,-84.0,-81.0,-86.0,10.0,16.0,15.0,26.0,1
246,CC:2F:71:3F:1F:24,2347272,526665111,194292,253529959,2152980,273135152,6,139930,167441480,139814,167425932,116,15548,135654,561,194338,30923,6,438,144444.0,43333.0,-67.0,-64.0,-70.0,-69.0,-68.0,-63.0,-70.0,-69.0,-80.0,-84.0,-81.0,-86.0,13.0,20.0,11.0,17.0,1
247,F8:59:71:5A:E0:3D,2221403,377211985,68417,104076307,2152986,273135678,337,47061,65279163,46984,65267054,77,12109,46765,33,68413,7912,337,38,144444.0,43333.0,-66.0,-71.0,-65.0,-71.0,-66.0,-71.0,-64.0,-70.0,-80.0,-84.0,-81.0,-86.0,14.0,13.0,16.0,15.0,1
248,CC:2F:71:3E:C5:1F,2153066,273145198,78,9318,2152988,273135880,0,363,30624,307,23818,56,6806,87,1,132,7,0,19,144444.0,39000.0,-75.0,-84.0,-75.0,-72.0,-71.0,-72.0,-68.0,-63.0,-80.0,-84.0,-81.0,-86.0,5.0,0.0,6.0,14.0,1
249,CC:2F:71:3F:1F:24,2347449,526889169,194461,253753289,2152988,273135880,6,140087,167658798,139971,167643250,116,15548,135811,561,194507,30925,6,440,144444.0,43333.0,-67.0,-64.0,-70.0,-69.0,-69.0,-63.0,-69.0,-69.0,-80.0,-84.0,-81.0,-86.0,13.0,20.0,11.0,17.0,1
250,F8:59:71:5A:E0:3D,2221474,377317921,68485,104181979,2152989,273135942,337,47130,65385437,47053,65373328,77,12109,46833,33,68481,7912,337,38,144444.0,43333.0,-66.0,-72.0,-65.0,-71.0,-66.0,-72.0,-64.0,-70.0,-80.0,-84.0,-81.0,-86.0,14.0,12.0,16.0,15.0,1
251,CC:2F:71:3E:C5:1F,2153067,273145260,78,9318,2152989,273135942,0,363,30624,307,23818,56,6806,87,1,132,7,0,19,144444.0,39000.0,-75.0,-84.0,-75.0,-72.0,-71.0,-72.0,-68.0,-63.0,-80.0,-84.0,-81.0,-86.0,5.0,0.0,6.0,14.0,1
252,CC:2F:71:3F:1F:24,2347624,527107069,194633,253970925,2152991,273136144,6,140249,167870668,140132,167855002,117,15666,135972,561,194679,30925,6,441,144444.0,43333.0,-71.0,-64.0,-69.0,-69.0,-70.0,-64.0,-69.0,-69.0,-80.0,-84.0,-81.0,-86.0,9.0,20.0,12.0,17.0,1
253,F8:59:71:5A:E0:3D,2221541,377416227,68548,104279881,2152993,273136346,337,47192,65480917,47115,65468808,77,12109,46895,33,68543,7912,337,38,144444.0,43333.0,-67.0,-72.0,-65.0,-70.0,-66.0,-72.0,-64.0,-70.0,-80.0,-84.0,-81.0,-86.0,13.0,12.0,16.0,16.0,1
254,CC:2F:71:3E:C5:1F,2153071,273145664,78,9318,2152993,273136346,0,363,30624,307,23818,56,6806,87,1,132,7,0,19,144444.0,39000.0,-75.0,-84.0,-75.0,-72.0,-71.0,-72.0,-68.0,-63.0,-80.0,-84.0,-81.0,-86.0,5.0,0.0,6.0,14.0,1
255,CC:2F:71:3F:1F:24,2347834,527324951,194837,254188201,2152997,273136750,6,140442,168134591,140325,168118925,117,15666,136165,561,194882,30925,6,442,144444.0,43333.0,-72.0,-64.0,-70.0,-69.0,-70.0,-64.0,-70.0,-69.0,-80.0,-84.0,-81.0,-86.0,8.0,20.0,11.0,17.0,1
256,F8:59:71:5A:E0:3D,2221618,377520174,68620,104383364,2152998,273136810,337,47263,65585729,47186,65573620,77,12109,46966,33,68616,7912,337,38,144444.0,43333.0,-67.0,-72.0,-65.0,-71.0,-66.0,-72.0,-64.0,-70.0,-80.0,-84.0,-81.0,-86.0,13.0,12.0,16.0,15.0,1
257,CC:2F:71:3E:C5:1F,2153076,273146128,78,9318,2152998,273136810,0,363,30624,307,23818,56,6806,87,1,132,7,0,19,144444.0,39000.0,-75.0,-84.0,-75.0,-72.0,-71.0,-72.0,-68.0,-63.0,-80.0,-84.0,-81.0,-86.0,5.0,0.0,6.0,14.0,1
258,CC:2F:71:3F:1F:24,2348011,527550822,195013,254414012,2152998,273136810,6,140609,168352204,140492,168336538,117,15666,136332,561,195059,30927,6,443,144444.0,43333.0,-66.0,-64.0,-69.0,-70.0,-68.0,-64.0,-70.0,-69.0,-80.0,-84.0,-81.0,-86.0,14.0,20.0,12.0,16.0,1
259,F8:59:71:5A:E0:3D,2221824,377824477,68824,104687465,2153000,273137012,337,47365,65706115,47288,65694006,77,12109,47068,33,68820,7912,337,38,144444.0,43333.0,-66.0,-72.0,-65.0,-71.0,-66.0,-72.0,-65.0,-70.0,-80.0,-84.0,-81.0,-86.0,14.0,12.0,16.0,15.0,1
260,CC:2F:71:3E:C5:1F,2153079,273146464,78,9318,2153001,273137146,0,363,30624,307,23818,56,6806,87,1,132,7,0,19,144444.0,39000.0,-75.0,-84.0,-75.0,-72.0,-71.0,-72.0,-68.0,-63.0,-80.0,-84.0,-81.0,-86.0,5.0,0.0,6.0,14.0,1
261,CC:2F:71:3F:1F:24,2348209,527773386,195206,254636110,2153003,273137276,6,140785,168565303,140668,168549637,117,15666,136508,561,195252,30931,6,444,144444.0,43333.0,-70.0,-64.0,-70.0,-69.0,-69.0,-64.0,-70.0,-69.0,-80.0,-84.0,-81.0,-86.0,10.0,20.0,11.0,17.0,1
262,F8:59:71:5A:E0:3D,2221898,377929263,68891,104791583,2153007,273137680,337,47433,65809427,47355,65797200,78,12227,47135,33,68887,7912,337,38,144444.0,43333.0,-67.0,-72.0,-65.0,-71.0,-66.0,-72.0,-64.0,-70.0,-80.0,-84.0,-81.0,-86.0,13.0,12.0,16.0,15.0,1
263,CC:2F:71:3E:C5:1F,2153085,273146998,78,9318,2153007,273137680,0,363,30624,307,23818,56,6806,87,1,132,7,0,19,144444.0,39000.0,-75.0,-84.0,-75.0,-72.0,-71.0,-72.0,-68.0,-63.0,-80.0,-84.0,-81.0,-86.0,5.0,0.0,6.0,14.0,1
264,CC:2F:71:3F:1F:24,2348395,527996824,195388,254859144,2153007,273137680,6,140957,168781011,140840,168765345,117,15666,136680,561,195434,30933,6,447,144444.0,43333.0,-68.0,-64.0,-70.0,-69.0,-68.0,-64.0,-70.0,-69.0,-80.0,-84.0,-81.0,-86.0,12.0,20.0,11.0,17.0,1
265,F8:59:71:5A:E0:3D,2221965,378028981,68955,104891039,2153010,273137942,337,47497,65907987,47419,65895760,78,12227,47199,33,68951,7912,337,38,144444.0,43333.0,-66.0,-72.0,-65.0,-70.0,-66.0,-72.0,-64.0,-70.0,-80.0,-84.0,-81.0,-86.0,14.0,12.0,16.0,16.0,1
266,CC:2F:71:3E:C5:1F,2153088,273147260,78,9318,2153010,273137942,0,363,30624,307,23818,56,6806,87,1,132,7,0,19,144444.0,39000.0,-75.0,-84.0,-75.0,-72.0,-71.0,-72.0,-68.0,-63.0,-80.0,-84.0,-81.0,-86.0,5.0,0.0,6.0,14.0,1
267,CC:2F:71:3F:1F:24,2348560,528206690,195550,255068748,2153010,273137942,6,141104,168979983,140987,168964317,117,15666,136827,561,195595,30934,6,447,144444.0,43333.0,-71.0,-64.0,-70.0,-69.0,-68.0,-64.0,-69.0,-69.0,-80.0,-84.0,-81.0,-86.0,9.0,20.0,11.0,17.0,1
268,F8:59:71:5A:E0:3D,2222044,378136046,69028,104997498,2153016,273138548,337,47569,66015382,47491,66003155,78,12227,47271,33,69024,7912,337,38,144444.0,43333.0,-66.0,-72.0,-65.0,-71.0,-66.0,-72.0,-64.0,-70.0,-80.0,-85.0,-81.0,-87.0,14.0,13.0,16.0,16.0,1
269,CC:2F:71:3E:C5:1F,2153094,273147866,78,9318,2153016,273138548,0,363,30624,307,23818,56,6806,87,1,132,7,0,19,144444.0,39000.0,-75.0,-84.0,-75.0,-72.0,-71.0,-72.0,-68.0,-63.0,-80.0,-85.0,-81.0,-87.0,5.0,1.0,6.0,15.0,1
270,CC:2F:71:3F:1F:24,2348745,528436172,195729,255297624,2153016,273138548,6,141267,169203932,141150,169188266,117,15666,136989,561,195774,30934,6,447,144444.0,43333.0,-70.0,-64.0,-69.0,-69.0,-69.0,-63.0,-69.0,-69.0,-80.0,-85.0,-81.0,-87.0,10.0,21.0,12.0,18.0,1
271,F8:59:71:5A:E0:3D,2222113,378240366,69095,105101616,2153018,273138750,337,47636,66118562,47558,66106335,78,12227,47338,33,69090,7912,337,38,144444.0,43333.0,-66.0,-72.0,-65.0,-71.0,-66.0,-72.0,-65.0,-70.0,-80.0,-85.0,-81.0,-87.0,14.0,13.0,16.0,16.0,1
272,CC:2F:71:3E:C5:1F,2153097,273148128,78,9318,2153019,273138810,0,363,30624,307,23818,56,6806,87,1,132,7,0,19,144444.0,39000.0,-75.0,-84.0,-75.0,-72.0,-71.0,-72.0,-68.0,-63.0,-80.0,-85.0,-81.0,-87.0,5.0,1.0,6.0,15.0,1
273,CC:2F:71:3F:1F:24,2348915,528655236,195896,255516426,2153019,273138810,6,141418,169413397,141301,169397731,117,15666,137140,561,195942,30934,6,447,144444.0,43333.0,-66.0,-64.0,-71.0,-69.0,-69.0,-63.0,-69.0,-68.0,-80.0,-85.0,-81.0,-87.0,14.0,21.0,10.0,18.0,1
274,F8:59:71:5A:E0:3D,2222186,378343596,69161,105204180,2153025,273139416,337,47701,66218690,47623,66206463,78,12227,47403,33,69157,7912,337,38,144444.0,43333.0,-67.0,-72.0,-65.0,-70.0,-66.0,-72.0,-65.0,-70.0,-80.0,-85.0,-81.0,-87.0,13.0,13.0,16.0,17.0,1
275,CC:2F:71:3E:C5:1F,2153103,273148734,78,9318,2153025,273139416,0,363,30624,307,23818,56,6806,87,1,132,7,0,19,144444.0,39000.0,-75.0,-84.0,-75.0,-72.0,-71.0,-72.0,-68.0,-63.0,-80.0,-85.0,-81.0,-87.0,5.0,1.0,6.0,15.0,1
276,CC:2F:71:3F:1F:24,2349084,528865289,196059,255725873,2153025,273139416,6,141565,169610012,141448,169594346,117,15666,137287,561,196105,30935,6,447,144444.0,43333.0,-70.0,-63.0,-70.0,-69.0,-68.0,-63.0,-70.0,-69.0,-80.0,-85.0,-81.0,-87.0,10.0,22.0,11.0,18.0,1
277,F8:59:71:5A:E0:3D,2222361,378611503,69334,105471885,2153027,273139618,337,47772,66318522,47694,66306295,78,12227,47474,33,69330,7912,337,38,144444.0,43333.0,-67.0,-72.0,-65.0,-70.0,-67.0,-72.0,-65.0,-70.0,-81.0,-87.0,-81.0,-88.0,14.0,15.0,16.0,18.0,1
278,CC:2F:71:3E:C5:1F,2153105,273148936,78,9318,2153027,273139618,0,363,30624,307,23818,56,6806,87,1,132,7,0,19,144444.0,39000.0,-75.0,-84.0,-75.0,-72.0,-71.0,-72.0,-68.0,-63.0,-81.0,-87.0,-81.0,-88.0,6.0,3.0,6.0,16.0,1
279,CC:2F:71:3F:1F:24,2349244,529071727,196217,255932109,2153027,273139618,6,141713,169810580,141596,169794914,117,15666,137435,561,196263,30936,6,447,144444.0,43333.0,-71.0,-64.0,-70.0,-70.0,-69.0,-63.0,-67.0,-70.0,-81.0,-87.0,-81.0,-88.0,10.0,23.0,11.0,18.0,1
280,F8:59:71:5A:E0:3D,2222433,378711898,69398,105571341,2153035,273140557,337,47837,66418636,47759,66406409,78,12227,47538,33,69394,7912,337,38,144444.0,43333.0,-67.0,-72.0,-65.0,-70.0,-67.0,-72.0,-65.0,-70.0,-81.0,-87.0,-81.0,-88.0,14.0,15.0,16.0,18.0,1
281,CC:2F:71:3E:C5:1F,2153113,273149875,78,9318,2153035,273140557,0,363,30624,307,23818,56,6806,87,1,132,7,0,19,144444.0,39000.0,-75.0,-84.0,-75.0,-72.0,-71.0,-72.0,-68.0,-63.0,-81.0,-87.0,-81.0,-88.0,6.0,3.0,6.0,16.0,1
282,CC:2F:71:3F:1F:24,2349430,529291301,196395,256150744,2153035,273140557,6,141875,170017292,141758,170001626,117,15666,137597,561,196441,30938,6,448,144444.0,43333.0,-69.0,-63.0,-68.0,-69.0,-68.0,-62.0,-69.0,-69.0,-81.0,-87.0,-81.0,-88.0,12.0,24.0,13.0,19.0,1
283,F8:59:71:5A:E0:3D,2222643,379027679,69606,105886920,2153037,273140759,337,47933,66526587,47855,66514360,78,12227,47634,33,69602,7913,337,38,144444.0,43333.0,-67.0,-72.0,-65.0,-71.0,-67.0,-72.0,-65.0,-70.0,-81.0,-87.0,-81.0,-88.0,14.0,15.0,16.0,17.0,1
284,CC:2F:71:3E:C5:1F,2153115,273150077,78,9318,2153037,273140759,0,363,30624,307,23818,56,6806,87,1,132,7,0,19,144444.0,39000.0,-75.0,-84.0,-75.0,-72.0,-71.0,-72.0,-68.0,-63.0,-81.0,-87.0,-81.0,-88.0,6.0,3.0,6.0,16.0,1
285,CC:2F:71:3F:1F:24,2349587,529491639,196550,256350880,2153037,273140759,6,142018,170211518,141901,170195852,117,15666,137740,561,196596,30938,6,448,144444.0,43333.0,-71.0,-64.0,-69.0,-70.0,-69.0,-64.0,-69.0,-70.0,-81.0,-87.0,-81.0,-88.0,10.0,23.0,12.0,18.0,1
286,F8:59:71:5A:E0:3D,2222712,379126187,69669,105984822,2153043,273141365,337,47995,66622067,47917,66609840,78,12227,47696,33,69665,7914,337,38,144444.0,43333.0,-67.0,-72.0,-65.0,-70.0,-66.0,-71.0,-64.0,-70.0,-81.0,-87.0,-81.0,-88.0,14.0,15.0,16.0,18.0,1
287,CC:2F:71:3E:C5:1F,2153121,273150683,78,9318,2153043,273141365,0,363,30624,307,23818,56,6806,87,1,132,7,0,19,144444.0,39000.0,-75.0,-84.0,-75.0,-72.0,-71.0,-72.0,-68.0,-63.0,-81.0,-87.0,-81.0,-88.0,6.0,3.0,6.0,16.0,1
288,CC:2F:71:3F:1F:24,2349750,529696927,196707,256555562,2153043,273141365,6,142159,170405522,142042,170389856,117,15666,137881,561,196753,30938,6,448,144444.0,43333.0,-66.0,-64.0,-70.0,-71.0,-69.0,-64.0,-69.0,-70.0,-81.0,-87.0,-81.0,-88.0,15.0,23.0,11.0,17.0,1
289,F8:59:71:5A:E0:3D,2222775,379222595,69731,106081170,2153044,273141425,337,48057,66717547,47979,66705320,78,12227,47758,33,69727,7914,337,38,144444.0,43333.0,-67.0,-72.0,-65.0,-70.0,-67.0,-72.0,-65.0,-70.0,-81.0,-88.0,-82.0,-89.0,14.0,16.0,17.0,19.0,1
290,CC:2F:71:3E:C5:1F,2153124,273150945,78,9318,2153046,273141627,0,363,30624,307,23818,56,6806,87,1,132,7,0,19,144444.0,39000.0,-75.0,-84.0,-75.0,-72.0,-71.0,-72.0,-68.0,-63.0,-81.0,-88.0,-82.0,-89.0,6.0,4.0,7.0,17.0,1
291,CC:2F:71:3F:1F:24,2349925,529916478,196879,256774851,2153046,273141627,6,142318,170610774,142201,170595108,117,15666,138040,561,196925,30939,6,449,144444.0,43333.0,-71.0,-64.0,-70.0,-71.0,-70.0,-64.0,-69.0,-70.0,-81.0,-88.0,-82.0,-89.0,10.0,24.0,12.0,18.0,1
292,F8:59:71:5A:E0:3D,2222847,379324279,69796,106182180,2153051,273142099,337,48122,66817647,48044,66805420,78,12227,47823,33,69792,7914,337,38,144444.0,43333.0,-67.0,-72.0,-65.0,-70.0,-67.0,-72.0,-65.0,-70.0,-81.0,-88.0,-82.0,-89.0,14.0,16.0,17.0,19.0,1
293,CC:2F:71:3E:C5:1F,2153130,273151551,78,9318,2153052,273142233,0,363,30624,307,23818,56,6806,87,1,132,7,0,19,144444.0,39000.0,-75.0,-84.0,-75.0,-72.0,-71.0,-72.0,-68.0,-63.0,-81.0,-88.0,-82.0,-89.0,6.0,4.0,7.0,17.0,1
294,CC:2F:71:3F:1F:24,2350086,530118658,197034,256976425,2153052,273142233,6,142460,170804964,142343,170789298,117,15666,138182,561,197080,30939,6,449,144444.0,43333.0,-67.0,-64.0,-70.0,-71.0,-68.0,-64.0,-69.0,-70.0,-82.0,-88.0,-82.0,-89.0,15.0,24.0,12.0,18.0,1
295,F8:59:71:5A:E0:3D,2222910,379420761,69858,106278528,2153052,273142233,337,48184,66913127,48106,66900900,78,12227,47885,33,69854,7914,337,38,144444.0,43333.0,-67.0,-72.0,-65.0,-70.0,-67.0,-72.0,-65.0,-70.0,-82.0,-88.0,-82.0,-89.0,15.0,16.0,17.0,19.0,1
296,CC:2F:71:3E:C5:1F,2153130,273151551,78,9318,2153052,273142233,0,363,30624,307,23818,56,6806,87,1,132,7,0,19,144444.0,39000.0,-75.0,-84.0,-75.0,-72.0,-71.0,-72.0,-68.0,-63.0,-82.0,-88.0,-82.0,-89.0,7.0,4.0,7.0,17.0,1
297,CC:2F:71:3F:1F:24,2350245,530323542,197191,257181107,2153054,273142435,6,142601,170998968,142484,170983302,117,15666,138323,561,197237,30940,6,449,144444.0,43333.0,-71.0,-64.0,-69.0,-71.0,-69.0,-64.0,-69.0,-70.0,-82.0,-88.0,-82.0,-89.0,11.0,24.0,13.0,18.0,1
298,F8:59:71:5A:E0:3D,2223094,379686639,70033,106543384,2153061,273143255,337,48277,67021849,48199,67009622,78,12227,47978,33,70029,7927,337,38,144444.0,43333.0,-67.0,-72.0,-65.0,-71.0,-67.0,-72.0,-65.0,-70.0,-82.0,-88.0,-82.0,-89.0,15.0,16.0,17.0,18.0,1
299,CC:2F:71:3E:C5:1F,2153139,273152573,78,9318,2153061,273143255,0,363,30624,307,23818,56,6806,87,1,132,7,0,19,144444.0,39000.0,-75.0,-84.0,-75.0,-72.0,-71.0,-72.0,-68.0,-63.0,-82.0,-88.0,-82.0,-89.0,7.0,4.0,7.0,17.0,1
300,CC:2F:71:3F:1F:24,2350435,530536067,197374,257392812,2153061,273143255,6,142766,171204912,142649,171189246,117,15666,138488,561,197420,30940,6,449,144444.0,43333.0,-67.0,-64.0,-70.0,-71.0,-69.0,-64.0,-70.0,-70.0,-82.0,-88.0,-82.0,-89.0,15.0,24.0,12.0,18.0,1
301,F8:59:71:5A:E0:3D,2223197,379836203,70134,106692746,2153063,273143457,337,48348,67124869,48270,67112642,78,12227,48049,33,70130,7962,337,38,144444.0,43333.0,-67.0,-72.0,-65.0,-71.0,-67.0,-72.0,-65.0,-70.0,-82.0,-88.0,-82.0,-89.0,15.0,16.0,17.0,18.0,1
302,CC:2F:71:3E:C5:1F,2153141,273152775,78,9318,2153063,273143457,0,363,30624,307,23818,56,6806,87,1,132,7,0,19,144444.0,39000.0,-75.0,-84.0,-75.0,-72.0,-71.0,-72.0,-68.0,-63.0,-82.0,-88.0,-82.0,-89.0,7.0,4.0,7.0,17.0,1
303,CC:2F:71:3F:1F:24,2350604,530742512,197541,257599055,2153063,273143457,6,142921,171405271,142804,171389605,117,15666,138643,561,197587,30940,6,449,144444.0,43333.0,-71.0,-64.0,-70.0,-71.0,-69.0,-64.0,-69.0,-70.0,-82.0,-88.0,-82.0,-89.0,11.0,24.0,12.0,18.0,1
304,F8:59:71:5A:E0:3D,2223261,379932585,70196,106788926,2153065,273143659,337,48409,67218809,48331,67206582,78,12227,48110,33,70192,7962,337,38,144444.0,43333.0,-67.0,-72.0,-65.0,-71.0,-66.0,-71.0,-65.0,-70.0,-82.0,-88.0,-82.0,-89.0,15.0,16.0,17.0,18.0,1
305,CC:2F:71:3E:C5:1F,2153143,273152977,78,9318,2153065,273143659,0,363,30624,307,23818,56,6806,87,1,132,7,0,19,144444.0,39000.0,-75.0,-84.0,-75.0,-72.0,-71.0,-72.0,-68.0,-63.0,-82.0,-88.0,-82.0,-89.0,7.0,4.0,7.0,17.0,1
306,CC:2F:71:3F:1F:24,2350780,530950176,197713,257806315,2153067,273143861,6,143074,171609669,142957,171594003,117,15666,138796,561,197759,30940,6,449,144444.0,43333.0,-67.0,-64.0,-70.0,-71.0,-68.0,-64.0,-70.0,-70.0,-82.0,-88.0,-82.0,-89.0,15.0,24.0,12.0,18.0,1
307,F8:59:71:5A:E0:3D,2223334,380031611,70262,106887286,2153072,273144325,337,48478,67321282,48400,67309055,78,12227,48178,33,70258,7962,337,38,144444.0,43333.0,-67.0,-72.0,-65.0,-70.0,-67.0,-72.0,-65.0,-70.0,-82.0,-88.0,-82.0,-89.0,15.0,16.0,17.0,19.0,1
308,CC:2F:71:3E:C5:1F,2153150,273153643,78,9318,2153072,273144325,0,363,30624,307,23818,56,6806,87,1,132,7,0,19,144444.0,39000.0,-75.0,-84.0,-75.0,-72.0,-71.0,-72.0,-68.0,-63.0,-82.0,-88.0,-82.0,-89.0,7.0,4.0,7.0,17.0,1
309,CC:2F:71:3F:1F:24,2350948,531157239,197876,258012914,2153072,273144325,6,143222,171803553,143105,171787887,117,15666,138944,561,197922,30940,6,449,144444.0,43333.0,-70.0,-64.0,-69.0,-71.0,-70.0,-64.0,-69.0,-70.0,-82.0,-88.0,-82.0,-89.0,12.0,24.0,13.0,18.0,1
310,F8:59:71:5A:E0:3D,2223398,380128161,70324,106983634,2153074,273144527,337,48540,67416762,48462,67404535,78,12227,48240,33,70320,7962,337,38,144444.0,43333.0,-67.0,-72.0,-65.0,-70.0,-66.0,-71.0,-65.0,-70.0,-82.0,-88.0,-82.0,-89.0,15.0,16.0,17.0,19.0,1
311,CC:2F:71:3E:C5:1F,2153152,273153845,78,9318,2153074,273144527,0,363,30624,307,23818,56,6806,87,1,132,7,0,19,144444.0,39000.0,-75.0,-84.0,-75.0,-72.0,-71.0,-72.0,-68.0,-63.0,-82.0,-88.0,-82.0,-89.0,7.0,4.0,7.0,17.0,1
312,CC:2F:71:3F:1F:24,2351150,531374693,198076,258230166,2153074,273144527,6,143411,172015656,143294,171999990,117,15666,139133,561,198122,30940,6,449,144444.0,43333.0,-71.0,-64.0,-69.0,-71.0,-69.0,-64.0,-69.0,-70.0,-82.0,-88.0,-82.0,-89.0,11.0,24.0,13.0,18.0,1
313,F8:59:71:5A:E0:3D,2223467,380226669,70387,107081536,2153080,273145133,337,48602,67512242,48524,67500015,78,12227,48302,33,70383,7962,337,38,144444.0,43333.0,-67.0,-71.0,-65.0,-70.0,-67.0,-71.0,-65.0,-70.0,-82.0,-88.0,-82.0,-89.0,15.0,17.0,17.0,19.0,1
314,CC:2F:71:3E:C5:1F,2153158,273154451,78,9318,2153080,273145133,0,363,30624,307,23818,56,6806,87,1,132,7,0,19,144444.0,39000.0,-75.0,-84.0,-75.0,-72.0,-71.0,-72.0,-68.0,-63.0,-82.0,-88.0,-82.0,-89.0,7.0,4.0,7.0,17.0,1
315,CC:2F:71:3F:1F:24,2351312,531578427,198232,258433294,2153080,273145133,6,143551,172209544,143434,172193878,117,15666,139273,561,198278,30941,6,449,144444.0,43333.0,-70.0,-64.0,-69.0,-71.0,-69.0,-64.0,-69.0,-70.0,-82.0,-88.0,-82.0,-89.0,12.0,24.0,13.0,18.0,1
316,F8:59:71:5A:E0:3D,2223532,380321841,70449,107176446,2153083,273145395,337,48666,67609382,48588,67597155,78,12227,48365,33,70445,7963,337,38,144444.0,43333.0,-67.0,-72.0,-65.0,-70.0,-66.0,-71.0,-65.0,-70.0,-82.0,-88.0,-82.0,-89.0,15.0,16.0,17.0,19.0,1
317,CC:2F:71:3E:C5:1F,2153161,273154713,78,9318,2153083,273145395,0,365,30764,309,23958,56,6806,87,1,133,7,0,19,144444.0,39000.0,-71.0,-69.0,-66.0,-60.0,-71.0,-72.0,-68.0,-63.0,-82.0,-88.0,-82.0,-89.0,11.0,19.0,16.0,29.0,1
318,CC:2F:71:3F:1F:24,2351478,531782931,198395,258637536,2153083,273145395,6,143695,172402632,143578,172386966,117,15666,139417,561,198441,30942,6,449,144444.0,43333.0,-67.0,-64.0,-70.0,-70.0,-69.0,-64.0,-69.0,-70.0,-82.0,-88.0,-82.0,-89.0,15.0,24.0,12.0,19.0,1
319,F8:59:71:5A:E0:3D,2223599,380418709,70512,107272910,2153087,273145799,337,48727,67703322,48649,67691095,78,12227,48426,33,70508,7963,337,38,144444.0,43333.0,-67.0,-71.0,-65.0,-70.0,-66.0,-71.0,-64.0,-70.0,-82.0,-89.0,-82.0,-89.0,15.0,18.0,17.0,19.0,1
320,CC:2F:71:3E:C5:1F,2153166,273155233,79,9434,2153087,273145799,0,366,30834,310,24028,56,6806,87,1,134,7,0,19,144444.0,39000.0,-71.0,-69.0,-66.0,-60.0,-71.0,-72.0,-68.0,-63.0,-82.0,-89.0,-82.0,-89.0,11.0,20.0,16.0,29.0,1
321,CC:2F:71:3F:1F:24,2351640,531985211,198551,258839210,2153089,273146001,6,143836,172595464,143719,172579798,117,15666,139558,561,198597,30943,6,450,144444.0,43333.0,-70.0,-64.0,-69.0,-71.0,-69.0,-64.0,-69.0,-70.0,-82.0,-89.0,-82.0,-89.0,12.0,25.0,13.0,18.0,1
322,F8:59:71:5A:E0:3D,2223854,380802625,70764,107656351,2153090,273146274,337,48826,67809211,48748,67796984,78,12227,48525,33,70760,7963,337,38,144444.0,43333.0,-67.0,-71.0,-65.0,-70.0,-66.0,-71.0,-65.0,-70.0,-82.0,-89.0,-82.0,-89.0,15.0,18.0,17.0,19.0,1
323,CC:2F:71:3E:C5:1F,2153169,273155708,79,9434,2153090,273146274,0,367,30904,311,24098,56,6806,87,1,134,7,0,19,144444.0,39000.0,-72.0,-69.0,-66.0,-60.0,-72.0,-72.0,-68.0,-63.0,-82.0,-89.0,-82.0,-89.0,10.0,20.0,16.0,29.0,1
324,CC:2F:71:3F:1F:24,2351816,532195991,198724,259049515,2153092,273146476,6,143988,172797154,143871,172781488,117,15666,139710,561,198770,30943,6,450,144444.0,43333.0,-71.0,-64.0,-69.0,-71.0,-70.0,-64.0,-69.0,-70.0,-82.0,-89.0,-82.0,-89.0,11.0,25.0,13.0,18.0,1
325,F8:59:71:5A:E0:3D,2223922,380900991,70827,107754253,2153095,273146738,337,48888,67904691,48810,67892464,78,12227,48587,33,70823,7963,337,38,144444.0,43333.0,-67.0,-72.0,-65.0,-70.0,-66.0,-71.0,-64.0,-70.0,-82.0,-89.0,-82.0,-89.0,15.0,17.0,17.0,19.0,1
326,CC:2F:71:3E:C5:1F,2153175,273156234,79,9434,2153096,273146800,0,367,30904,311,24098,56,6806,87,1,134,7,0,19,144444.0,39000.0,-72.0,-69.0,-66.0,-60.0,-72.0,-72.0,-68.0,-63.0,-82.0,-89.0,-82.0,-89.0,10.0,20.0,16.0,29.0,1
327,CC:2F:71:3F:1F:24,2351984,532401562,198886,259254560,2153098,273147002,6,144134,172989454,144016,172973670,118,15784,139856,561,198931,30943,6,450,144444.0,43333.0,-71.0,-64.0,-69.0,-71.0,-69.0,-64.0,-69.0,-71.0,-82.0,-89.0,-82.0,-89.0,11.0,25.0,13.0,18.0,1
328,F8:59:71:5A:E0:3D,2223990,380996619,70888,107849047,2153102,273147572,337,48950,68000171,48872,67987944,78,12227,48649,33,70884,7963,337,38,144444.0,43333.0,-67.0,-72.0,-65.0,-71.0,-66.0,-71.0,-65.0,-70.0,-82.0,-89.0,-82.0,-89.0,15.0,17.0,17.0,18.0,1
329,CC:2F:71:3E:C5:1F,2153181,273157006,79,9434,2153102,273147572,0,367,30904,311,24098,56,6806,87,1,134,7,0,19,144444.0,39000.0,-72.0,-69.0,-66.0,-60.0,-72.0,-72.0,-68.0,-63.0,-82.0,-89.0,-82.0,-89.0,10.0,20.0,16.0,29.0,1
330,CC:2F:71:3F:1F:24,2352144,532605260,199042,259457688,2153102,273147572,6,144280,173186942,144162,173171158,118,15784,140002,561,199088,30944,6,450,144444.0,43333.0,-71.0,-64.0,-70.0,-71.0,-69.0,-64.0,-69.0,-70.0,-82.0,-89.0,-82.0,-89.0,11.0,25.0,12.0,18.0,1
331,F8:59:71:5A:E0:3D,2224185,381292566,71079,108144590,2153106,273147976,337,49029,68100919,48951,68088692,78,12227,48728,33,71075,7963,337,38,144444.0,43333.0,-67.0,-72.0,-65.0,-70.0,-67.0,-71.0,-65.0,-70.0,-82.0,-89.0,-82.0,-89.0,15.0,17.0,17.0,19.0,1
332,CC:2F:71:3E:C5:1F,2153185,273157410,79,9434,2153106,273147976,0,367,30904,311,24098,56,6806,87,1,134,7,0,19,144444.0,39000.0,-72.0,-69.0,-66.0,-60.0,-72.0,-72.0,-68.0,-63.0,-82.0,-89.0,-82.0,-89.0,10.0,20.0,16.0,29.0,1
333,CC:2F:71:3F:1F:24,2352303,532808662,199197,259660686,2153106,273147976,6,144421,173380946,144303,173365162,118,15784,140143,561,199243,30944,6,450,144444.0,43333.0,-71.0,-64.0,-70.0,-71.0,-69.0,-64.0,-69.0,-70.0,-82.0,-89.0,-82.0,-89.0,11.0,25.0,12.0,18.0,1
334,F8:59:71:5A:E0:3D,2224253,381387948,71140,108239384,2153113,273148564,337,49092,68196517,49013,68184172,79,12345,48791,33,71136,7963,337,38,144444.0,43333.0,-66.0,-72.0,-65.0,-70.0,-66.0,-71.0,-65.0,-70.0,-82.0,-89.0,-82.0,-89.0,16.0,17.0,17.0,19.0,1
335,CC:2F:71:3E:C5:1F,2153192,273157998,79,9434,2153113,273148564,0,369,31092,312,24168,57,6924,88,1,134,7,0,19,144444.0,39000.0,-71.0,-69.0,-67.0,-60.0,-71.0,-72.0,-67.0,-62.0,-82.0,-89.0,-82.0,-89.0,11.0,20.0,15.0,29.0,1
336,CC:2F:71:3F:1F:24,2352466,533012378,199353,259863814,2153113,273148564,6,144561,173574834,144443,173559050,118,15784,140283,561,199399,30944,6,450,144444.0,43333.0,-67.0,-64.0,-69.0,-71.0,-69.0,-64.0,-69.0,-70.0,-82.0,-89.0,-82.0,-89.0,15.0,25.0,13.0,18.0,1
337,F8:59:71:5A:E0:3D,2224318,381486052,71203,108337286,2153115,273148766,337,49154,68291997,49075,68279652,79,12345,48853,33,71199,7963,337,38,144444.0,43333.0,-66.0,-71.0,-65.0,-70.0,-66.0,-71.0,-64.0,-70.0,-82.0,-89.0,-82.0,-89.0,16.0,18.0,17.0,19.0,1
338,CC:2F:71:3E:C5:1F,2153194,273158200,79,9434,2153115,273148766,0,369,31092,312,24168,57,6924,88,1,134,7,0,19,144444.0,39000.0,-71.0,-69.0,-67.0,-60.0,-71.0,-72.0,-67.0,-62.0,-82.0,-89.0,-82.0,-89.0,11.0,20.0,15.0,29.0,1
339,CC:2F:71:3F:1F:24,2352637,533217540,199520,260068572,2153117,273148968,6,144709,173769943,144591,173754159,118,15784,140431,561,199566,30944,6,450,144444.0,43333.0,-71.0,-64.0,-69.0,-71.0,-69.0,-64.0,-69.0,-71.0,-82.0,-89.0,-82.0,-89.0,11.0,25.0,13.0,18.0,1
340,F8:59:71:5A:E0:3D,2224386,381583006,71265,108433634,2153121,273149372,337,49216,68387477,49137,68375132,79,12345,48915,33,71261,7963,337,38,144444.0,43333.0,-66.0,-71.0,-65.0,-70.0,-66.0,-71.0,-65.0,-70.0,-82.0,-89.0,-82.0,-89.0,16.0,18.0,17.0,19.0,1
341,CC:2F:71:3E:C5:1F,2153200,273158806,79,9434,2153121,273149372,0,369,31092,312,24168,57,6924,88,1,134,7,0,19,144444.0,39000.0,-71.0,-69.0,-67.0,-60.0,-71.0,-72.0,-67.0,-62.0,-82.0,-89.0,-82.0,-89.0,11.0,20.0,15.0,29.0,1
342,CC:2F:71:3F:1F:24,2352798,533421202,199677,260271830,2153121,273149372,6,144855,173964527,144737,173948743,118,15784,140577,561,199723,30944,6,450,144444.0,43333.0,-70.0,-64.0,-69.0,-71.0,-69.0,-64.0,-69.0,-70.0,-82.0,-89.0,-82.0,-89.0,12.0,25.0,13.0,18.0,1
343,F8:59:71:5A:E0:3D,2224551,381831770,71429,108682338,2153122,273149432,337,49305,68494175,49226,68481830,79,12345,49004,33,71425,7963,337,38,144444.0,43333.0,-67.0,-71.0,-65.0,-71.0,-66.0,-71.0,-65.0,-70.0,-82.0,-89.0,-82.0,-89.0,15.0,18.0,17.0,18.0,1
344,CC:2F:71:3E:C5:1F,2153201,273158866,79,9434,2153122,273149432,0,369,31092,312,24168,57,6924,88,1,134,7,0,19,144444.0,39000.0,-71.0,-69.0,-67.0,-60.0,-71.0,-72.0,-67.0,-62.0,-82.0,-89.0,-82.0,-89.0,11.0,20.0,15.0,29.0,1
345,CC:2F:71:3F:1F:24,2352969,533628792,199845,260479158,2153124,273149634,6,145007,174158994,144889,174143210,118,15784,140728,561,199891,30944,6,450,144444.0,43333.0,-71.0,-64.0,-71.0,-71.0,-70.0,-64.0,-70.0,-70.0,-82.0,-89.0,-82.0,-89.0,11.0,25.0,11.0,18.0,1
346,F8:59:71:5A:E0:3D,2224623,381930739,71495,108780701,2153128,273150038,337,49372,68593483,49293,68581138,79,12345,49071,33,71491,7964,337,38,144444.0,43333.0,-66.0,-71.0,-65.0,-71.0,-66.0,-71.0,-65.0,-70.0,-82.0,-89.0,-82.0,-89.0,16.0,18.0,17.0,18.0,1
347,CC:2F:71:3E:C5:1F,2153207,273159472,79,9434,2153128,273150038,0,369,31092,312,24168,57,6924,88,1,134,7,0,19,144444.0,39000.0,-71.0,-69.0,-67.0,-60.0,-71.0,-72.0,-67.0,-62.0,-82.0,-89.0,-82.0,-89.0,11.0,20.0,15.0,29.0,1
348,CC:2F:71:3F:1F:24,2353133,533837244,200005,260687206,2153128,273150038,6,145153,174359286,145035,174343502,118,15784,140874,561,200051,30945,6,450,144444.0,43333.0,-70.0,-64.0,-70.0,-70.0,-69.0,-64.0,-69.0,-70.0,-82.0,-89.0,-82.0,-89.0,12.0,25.0,12.0,19.0,1
349,F8:59:71:5A:E0:3D,2224689,382030397,71559,108880157,2153130,273150240,337,49435,68690503,49356,68678158,79,12345,49134,33,71555,7965,337,38,144444.0,43333.0,-66.0,-71.0,-65.0,-71.0,-66.0,-71.0,-65.0,-70.0,-82.0,-89.0,-82.0,-89.0,16.0,18.0,17.0,18.0,1
350,CC:2F:71:3E:C5:1F,2153209,273159674,79,9434,2153130,273150240,0,369,31092,312,24168,57,6924,88,1,134,7,0,19,144444.0,39000.0,-71.0,-69.0,-67.0,-60.0,-71.0,-72.0,-67.0,-62.0,-82.0,-89.0,-82.0,-89.0,11.0,20.0,15.0,29.0,1
351,CC:2F:71:3F:1F:24,2353292,534040634,200161,260890334,2153131,273150300,6,145294,174553318,145176,174537534,118,15784,141015,561,200207,30945,6,451,144444.0,43333.0,-72.0,-64.0,-71.0,-71.0,-69.0,-64.0,-69.0,-70.0,-82.0,-89.0,-82.0,-89.0,10.0,25.0,11.0,18.0,1
352,F8:59:71:5A:E0:3D,2224758,382128831,71622,108978059,2153136,273150772,337,49499,68789063,49420,68776718,79,12345,49198,33,71618,7965,337,38,144444.0,43333.0,-67.0,-72.0,-65.0,-70.0,-67.0,-71.0,-65.0,-70.0,-82.0,-89.0,-82.0,-89.0,15.0,17.0,17.0,19.0,1
353,CC:2F:71:3E:C5:1F,2153216,273160340,79,9434,2153137,273150906,0,369,31092,312,24168,57,6924,88,1,134,7,0,19,144444.0,39000.0,-71.0,-69.0,-67.0,-60.0,-71.0,-72.0,-67.0,-62.0,-82.0,-89.0,-82.0,-89.0,11.0,20.0,15.0,29.0,1
354,CC:2F:71:3F:1F:24,2353458,534250584,200321,261099678,2153137,273150906,6,145439,174753482,145321,174737698,118,15784,141160,561,200367,30945,6,451,144444.0,43333.0,-71.0,-64.0,-71.0,-70.0,-70.0,-64.0,-70.0,-70.0,-82.0,-89.0,-82.0,-89.0,11.0,25.0,11.0,19.0,1
355,F8:59:71:5A:E0:3D,2224824,382227069,71685,109075961,2153139,273151108,337,49561,68884543,49482,68872198,79,12345,49260,33,71681,7965,337,38,144444.0,43333.0,-67.0,-72.0,-65.0,-70.0,-67.0,-72.0,-65.0,-70.0,-82.0,-89.0,-82.0,-89.0,15.0,17.0,17.0,19.0,1
356,CC:2F:71:3E:C5:1F,2153218,273160542,79,9434,2153139,273151108,0,369,31092,312,24168,57,6924,88,1,134,7,0,19,144444.0,39000.0,-71.0,-69.0,-67.0,-60.0,-71.0,-72.0,-67.0,-62.0,-82.0,-89.0,-82.0,-89.0,11.0,20.0,15.0,29.0,1
357,CC:2F:71:3F:1F:24,2353617,534452620,200478,261301512,2153139,273151108,6,145581,174944754,145463,174928970,118,15784,141302,561,200524,30945,6,451,144444.0,43333.0,-71.0,-64.0,-71.0,-70.0,-68.0,-64.0,-70.0,-70.0,-82.0,-89.0,-82.0,-89.0,11.0,25.0,11.0,19.0,1
358,F8:59:71:5A:E0:3D,2224889,382322267,71746,109170755,2153143,273151512,337,49622,68978483,49543,68966138,79,12345,49321,33,71742,7966,337,38,144444.0,43333.0,-67.0,-72.0,-65.0,-71.0,-67.0,-71.0,-65.0,-70.0,-82.0,-89.0,-82.0,-90.0,15.0,17.0,17.0,19.0,1
359,CC:2F:71:3E:C5:1F,2153223,273161006,79,9434,2153144,273151572,0,369,31092,312,24168,57,6924,88,1,134,7,0,19,144444.0,39000.0,-71.0,-69.0,-67.0,-60.0,-71.0,-72.0,-67.0,-62.0,-82.0,-89.0,-82.0,-90.0,11.0,20.0,15.0,30.0,1
360,CC:2F:71:3F:1F:24,2353778,534656212,200634,261504640,2153144,273151572,6,145724,175141838,145606,175126054,118,15784,141445,561,200680,30946,6,451,144444.0,43333.0,-70.0,-64.0,-70.0,-70.0,-69.0,-64.0,-69.0,-70.0,-82.0,-89.0,-82.0,-90.0,12.0,25.0,12.0,20.0,1
361,F8:59:71:5A:E0:3D,2225100,382638752,71952,109486776,2153148,273151976,337,49710,69085165,49631,69072820,79,12345,49409,33,71948,7966,337,38,144444.0,43333.0,-67.0,-72.0,-65.0,-70.0,-67.0,-72.0,-65.0,-70.0,-82.0,-89.0,-82.0,-90.0,15.0,17.0,17.0,20.0,1
362,CC:2F:71:3E:C5:1F,2153227,273161410,79,9434,2153148,273151976,0,369,31092,312,24168,57,6924,88,1,134,7,0,19,144444.0,39000.0,-71.0,-69.0,-67.0,-60.0,-71.0,-72.0,-67.0,-62.0,-82.0,-89.0,-82.0,-90.0,11.0,20.0,15.0,30.0,1
363,CC:2F:71:3F:1F:24,2353955,534866332,200807,261714356,2153148,273151976,6,145884,175339270,145766,175323486,118,15784,141605,561,200853,30947,6,451,144444.0,43333.0,-70.0,-64.0,-67.0,-71.0,-69.0,-64.0,-68.0,-70.0,-82.0,-89.0,-82.0,-90.0,12.0,25.0,15.0,19.0,1
364,F8:59:71:5A:E0:3D,2225166,382735504,72014,109583124,2153152,273152380,337,49772,69180645,49693,69168300,79,12345,49471,33,72010,7967,337,38,144444.0,43333.0,-68.0,-72.0,-65.0,-70.0,-67.0,-72.0,-65.0,-70.0,-82.0,-89.0,-82.0,-90.0,14.0,17.0,17.0,20.0,1
365,CC:2F:71:3E:C5:1F,2153231,273161814,79,9434,2153152,273152380,0,369,31092,312,24168,57,6924,88,1,134,7,0,19,144444.0,39000.0,-71.0,-69.0,-67.0,-60.0,-71.0,-72.0,-67.0,-62.0,-82.0,-89.0,-82.0,-90.0,11.0,20.0,15.0,30.0,1
366,CC:2F:71:3F:1F:24,2354115,535068444,200963,261916064,2153152,273152380,6,146026,175530547,145908,175514763,118,15784,141747,561,201009,30948,6,451,144444.0,43333.0,-71.0,-64.0,-71.0,-70.0,-69.0,-64.0,-69.0,-70.0,-82.0,-89.0,-82.0,-90.0,11.0,25.0,11.0,20.0,1
367,F8:59:71:5A:E0:3D,2225235,382834143,72077,109681026,2153158,273153117,337,49836,69276265,49757,69263920,79,12345,49533,33,72073,7967,337,38,144444.0,43333.0,-68.0,-72.0,-65.0,-70.0,-67.0,-72.0,-65.0,-70.0,-82.0,-89.0,-82.0,-90.0,14.0,17.0,17.0,20.0,1
368,CC:2F:71:3E:C5:1F,2153237,273162551,79,9434,2153158,273153117,0,369,31092,312,24168,57,6924,88,1,134,7,0,19,144444.0,39000.0,-71.0,-69.0,-67.0,-60.0,-71.0,-72.0,-67.0,-62.0,-82.0,-89.0,-82.0,-90.0,11.0,20.0,15.0,30.0,1
369,CC:2F:71:3F:1F:24,2354278,535273751,201120,262120634,2153158,273153117,6,146169,175727631,146051,175711847,118,15784,141890,561,201166,30952,6,451,144444.0,43333.0,-71.0,-64.0,-71.0,-71.0,-69.0,-64.0,-70.0,-70.0,-82.0,-89.0,-82.0,-90.0,11.0,25.0,11.0,19.0,1
370,F8:59:71:5A:E0:3D,2225475,383206276,72317,110053159,2153158,273153117,337,49932,69379593,49853,69367248,79,12345,49627,33,72313,7967,337,38,144444.0,43333.0,-68.0,-72.0,-65.0,-71.0,-67.0,-72.0,-65.0,-70.0,-82.0,-89.0,-82.0,-90.0,14.0,17.0,17.0,19.0,1
371,CC:2F:71:3E:C5:1F,2153239,273162753,79,9434,2153160,273153319,0,369,31092,312,24168,57,6924,88,1,134,7,0,19,144444.0,39000.0,-71.0,-69.0,-67.0,-60.0,-71.0,-72.0,-67.0,-62.0,-82.0,-89.0,-82.0,-90.0,11.0,20.0,15.0,30.0,1
372,CC:2F:71:3F:1F:24,2354437,535477153,201275,262323632,2153162,273153521,6,146309,175918671,146191,175902887,118,15784,142030,561,201321,30952,6,451,144444.0,43333.0,-70.0,-64.0,-70.0,-70.0,-70.0,-64.0,-70.0,-70.0,-82.0,-89.0,-82.0,-90.0,12.0,25.0,12.0,20.0,1
373,F8:59:71:5A:E0:3D,2225543,383303062,72379,110149339,2153164,273153723,337,49994,69475073,49915,69462728,79,12345,49689,33,72375,7967,337,38,144444.0,43333.0,-67.0,-72.0,-65.0,-71.0,-67.0,-72.0,-65.0,-70.0,-82.0,-89.0,-82.0,-90.0,15.0,17.0,17.0,19.0,1
374,CC:2F:71:3E:C5:1F,2153243,273163157,79,9434,2153164,273153723,0,369,31092,312,24168,57,6924,88,1,134,7,0,19,144444.0,39000.0,-71.0,-69.0,-67.0,-60.0,-71.0,-72.0,-67.0,-62.0,-82.0,-89.0,-82.0,-90.0,11.0,20.0,15.0,30.0,1
375,CC:2F:71:3F:1F:24,2354595,535680483,201431,262526760,2153164,273153723,6,146453,176115871,146335,176100087,118,15784,142174,561,201477,30955,6,451,144444.0,43333.0,-70.0,-64.0,-70.0,-70.0,-70.0,-64.0,-69.0,-70.0,-82.0,-89.0,-82.0,-90.0,12.0,25.0,12.0,20.0,1
376,F8:59:71:5A:E0:3D,2225610,383400028,72441,110245687,2153169,273154341,337,50056,69570553,49977,69558208,79,12345,49751,33,72437,7967,337,38,144444.0,43333.0,-67.0,-72.0,-66.0,-71.0,-67.0,-72.0,-65.0,-70.0,-82.0,-89.0,-82.0,-90.0,15.0,17.0,16.0,19.0,1
377,CC:2F:71:3E:C5:1F,2153248,273163775,79,9434,2153169,273154341,0,369,31092,312,24168,57,6924,88,1,134,7,0,19,144444.0,39000.0,-71.0,-69.0,-67.0,-60.0,-71.0,-72.0,-67.0,-62.0,-82.0,-89.0,-82.0,-90.0,11.0,20.0,15.0,30.0,1
378,CC:2F:71:3F:1F:24,2354755,535882675,201586,262728334,2153169,273154341,6,146594,176307263,146474,176291011,120,16252,142315,561,201632,30956,6,451,144444.0,43333.0,-66.0,-64.0,-70.0,-70.0,-68.0,-64.0,-70.0,-70.0,-82.0,-89.0,-82.0,-90.0,16.0,25.0,12.0,20.0,1
379,F8:59:71:5A:E0:3D,2225678,383496982,72503,110342035,2153175,273154947,337,50117,69664493,50038,69652148,79,12345,49812,33,72499,7967,337,38,144444.0,43333.0,-68.0,-72.0,-65.0,-71.0,-67.0,-72.0,-65.0,-70.0,-82.0,-89.0,-82.0,-90.0,14.0,17.0,17.0,19.0,1
380,CC:2F:71:3E:C5:1F,2153254,273164381,79,9434,2153175,273154947,0,369,31092,312,24168,57,6924,88,1,134,7,0,19,144444.0,39000.0,-71.0,-69.0,-67.0,-60.0,-71.0,-72.0,-67.0,-62.0,-82.0,-89.0,-82.0,-90.0,11.0,20.0,15.0,30.0,1
381,CC:2F:71:3F:1F:24,2354924,536089880,201749,262934933,2153175,273154947,6,146743,176502687,146623,176486435,120,16252,142464,561,201795,30956,6,451,144444.0,43333.0,-71.0,-64.0,-70.0,-70.0,-70.0,-63.0,-70.0,-70.0,-82.0,-89.0,-82.0,-90.0,11.0,25.0,12.0,20.0,1
382,F8:59:71:5A:E0:3D,2225742,383593532,72565,110438383,2153177,273155149,337,50179,69759973,50100,69747628,79,12345,49874,33,72561,7967,337,38,144444.0,43333.0,-67.0,-72.0,-65.0,-71.0,-67.0,-71.0,-65.0,-70.0,-82.0,-89.0,-82.0,-90.0,15.0,17.0,17.0,19.0,1
383,CC:2F:71:3E:C5:1F,2153256,273164583,79,9434,2153177,273155149,0,369,31092,312,24168,57,6924,88,1,134,7,0,19,144444.0,39000.0,-71.0,-69.0,-67.0,-60.0,-71.0,-72.0,-67.0,-62.0,-82.0,-89.0,-82.0,-90.0,11.0,20.0,15.0,30.0,1
384,CC:2F:71:3F:1F:24,2355080,536291526,201903,263136377,2153177,273155149,6,146884,176696691,146764,176680439,120,16252,142605,561,201949,30956,6,451,144444.0,43333.0,-70.0,-64.0,-71.0,-70.0,-70.0,-64.0,-70.0,-70.0,-82.0,-89.0,-82.0,-90.0,12.0,25.0,11.0,20.0,1
385,F8:59:71:5A:E0:3D,2225814,383689709,72632,110534096,2153182,273155613,337,50245,69857113,50166,69844768,79,12345,49940,33,72628,7971,337,39,144444.0,43333.0,-67.0,-72.0,-64.0,-71.0,-67.0,-71.0,-64.0,-70.0,-82.0,-89.0,-82.0,-90.0,15.0,17.0,18.0,19.0,1
386,CC:2F:71:3E:C5:1F,2153263,273165249,79,9434,2153184,273155815,0,369,31092,312,24168,57,6924,88,1,134,7,0,19,144444.0,39000.0,-71.0,-69.0,-67.0,-60.0,-71.0,-72.0,-67.0,-62.0,-82.0,-89.0,-82.0,-90.0,11.0,20.0,15.0,30.0,1
387,CC:2F:71:3F:1F:24,2355258,536500728,202074,263344913,2153184,273155815,6,147037,176894623,146917,176878371,120,16252,142757,561,202120,30957,6,451,144444.0,43333.0,-71.0,-64.0,-71.0,-71.0,-70.0,-64.0,-70.0,-70.0,-82.0,-89.0,-82.0,-90.0,11.0,25.0,11.0,19.0,1
388,F8:59:71:5A:E0:3D,2225915,383833025,72729,110677008,2153186,273156017,337,50318,69961813,50239,69949468,79,12345,50013,33,72725,7972,337,39,144444.0,43333.0,-66.0,-72.0,-65.0,-70.0,-66.0,-71.0,-65.0,-70.0,-82.0,-89.0,-82.0,-90.0,16.0,17.0,17.0,20.0,1
389,CC:2F:71:3E:C5:1F,2153265,273165451,79,9434,2153186,273156017,0,369,31092,312,24168,57,6924,88,1,134,7,0,19,144444.0,39000.0,-71.0,-69.0,-67.0,-60.0,-71.0,-72.0,-67.0,-62.0,-82.0,-89.0,-82.0,-90.0,11.0,20.0,15.0,30.0,1
390,CC:2F:71:3F:1F:24,2355437,536711691,202251,263555674,2153186,273156017,6,147192,177095173,147072,177078921,120,16252,142912,561,202297,30958,6,451,144444.0,43333.0,-68.0,-64.0,-68.0,-70.0,-69.0,-64.0,-70.0,-70.0,-82.0,-89.0,-82.0,-90.0,14.0,25.0,14.0,20.0,1
391,F8:59:71:5A:E0:3D,2226065,384059377,72875,110902956,2153190,273156421,337,50402,70064589,50323,70052244,79,12345,50097,33,72871,7972,337,39,144444.0,43333.0,-67.0,-71.0,-65.0,-70.0,-66.0,-71.0,-65.0,-70.0,-82.0,-89.0,-82.0,-90.0,15.0,18.0,17.0,20.0,1
392,CC:2F:71:3E:C5:1F,2153269,273165855,79,9434,2153190,273156421,0,369,31092,312,24168,57,6924,88,1,134,7,0,19,144444.0,39000.0,-71.0,-69.0,-67.0,-60.0,-71.0,-72.0,-67.0,-62.0,-82.0,-89.0,-82.0,-90.0,11.0,20.0,15.0,30.0,1
393,CC:2F:71:3F:1F:24,2355608,536920095,202418,263763674,2153190,273156421,6,147340,177295561,147220,177279309,120,16252,143060,561,202464,30958,6,451,144444.0,43333.0,-71.0,-64.0,-71.0,-71.0,-70.0,-64.0,-70.0,-70.0,-82.0,-89.0,-82.0,-90.0,11.0,25.0,11.0,19.0,1
394,F8:59:71:5A:E0:3D,2226132,384156189,72937,110999304,2153195,273156885,337,50464,70160069,50385,70147724,79,12345,50159,33,72933,7973,337,39,144444.0,43333.0,-67.0,-71.0,-65.0,-70.0,-67.0,-71.0,-65.0,-70.0,-82.0,-89.0,-82.0,-90.0,15.0,18.0,17.0,20.0,1
395,CC:2F:71:3E:C5:1F,2153274,273166319,79,9434,2153195,273156885,0,369,31092,312,24168,57,6924,88,1,134,7,0,19,144444.0,39000.0,-71.0,-69.0,-67.0,-60.0,-71.0,-72.0,-67.0,-62.0,-82.0,-89.0,-82.0,-90.0,11.0,20.0,15.0,30.0,1
396,CC:2F:71:3F:1F:24,2355769,537123687,202574,263966802,2153195,273156885,6,147483,177488373,147363,177472121,120,16252,143203,561,202619,30958,6,451,144444.0,43333.0,-70.0,-64.0,-71.0,-70.0,-70.0,-63.0,-70.0,-70.0,-82.0,-89.0,-82.0,-90.0,12.0,25.0,11.0,20.0,1
397,F8:59:71:5A:E0:3D,2226197,384252865,72999,111095652,2153198,273157213,337,50527,70257089,50448,70244744,79,12345,50222,33,72995,7974,337,39,144444.0,43333.0,-67.0,-72.0,-65.0,-70.0,-66.0,-71.0,-64.0,-70.0,-82.0,-89.0,-82.0,-90.0,15.0,17.0,17.0,20.0,1
398,CC:2F:71:3E:C5:1F,2153277,273166647,79,9434,2153198,273157213,0,369,31092,312,24168,57,6924,88,1,134,7,0,19,144444.0,39000.0,-71.0,-69.0,-67.0,-60.0,-71.0,-72.0,-67.0,-62.0,-82.0,-89.0,-82.0,-90.0,11.0,20.0,15.0,30.0,1
399,CC:2F:71:3F:1F:24,2355937,537333761,202739,264176548,2153198,273157213,6,147636,177687131,147516,177670879,120,16252,143356,561,202784,30958,6,451,144444.0,43333.0,-68.0,-64.0,-70.0,-71.0,-69.0,-64.0,-70.0,-70.0,-82.0,-89.0,-82.0,-90.0,14.0,25.0,12.0,19.0,1
400,F8:59:71:5A:E0:3D,2226268,384353183,73066,111195566,2153202,273157617,337,50595,70358009,50516,70345664,79,12345,50290,33,73062,7974,337,39,144444.0,43333.0,-67.0,-71.0,-65.0,-70.0,-67.0,-71.0,-64.0,-70.0,-82.0,-89.0,-82.0,-90.0,15.0,18.0,17.0,20.0,1
401,CC:2F:71:3E:C5:1F,2153283,273167253,79,9434,2153204,273157819,0,369,31092,312,24168,57,6924,88,1,134,7,0,19,144444.0,39000.0,-71.0,-69.0,-67.0,-60.0,-71.0,-72.0,-67.0,-62.0,-82.0,-89.0,-82.0,-90.0,11.0,20.0,15.0,30.0,1
402,CC:2F:71:3F:1F:24,2356100,537537625,202896,264379806,2153204,273157819,6,147780,177884387,147660,177868135,120,16252,143500,561,202942,30958,6,452,144444.0,43333.0,-71.0,-64.0,-71.0,-71.0,-69.0,-63.0,-70.0,-70.0,-82.0,-89.0,-82.0,-90.0,11.0,25.0,11.0,19.0,1
403,F8:59:71:5A:E0:3D,2226337,384451665,73130,111293584,2153207,273158081,337,50659,70455149,50580,70442804,79,12345,50353,33,73126,7974,337,39,144444.0,43333.0,-67.0,-71.0,-65.0,-70.0,-66.0,-71.0,-64.0,-70.0,-82.0,-89.0,-82.0,-90.0,15.0,18.0,17.0,20.0,1
404,CC:2F:71:3E:C5:1F,2153286,273167515,79,9434,2153207,273158081,0,371,31232,314,24308,57,6924,88,1,135,7,0,19,144444.0,39000.0,-70.0,-68.0,-66.0,-60.0,-70.0,-68.0,-65.0,-59.0,-82.0,-89.0,-82.0,-90.0,12.0,21.0,16.0,30.0,1
405,CC:2F:71:3F:1F:24,2356260,537741131,203053,264583050,2153207,273158081,6,147923,178078641,147803,178062389,120,16252,143643,561,203099,30958,6,453,144444.0,43333.0,-71.0,-64.0,-70.0,-71.0,-70.0,-64.0,-70.0,-70.0,-82.0,-89.0,-82.0,-90.0,11.0,25.0,12.0,19.0,1
406,F8:59:71:5A:E0:3D,2226404,384548533,73193,111390048,2153211,273158485,337,50721,70550629,50642,70538284,79,12345,50415,33,73189,7974,337,39,144444.0,43333.0,-66.0,-71.0,-65.0,-70.0,-66.0,-71.0,-65.0,-70.0,-82.0,-89.0,-82.0,-90.0,16.0,18.0,17.0,20.0,1
407,CC:2F:71:3E:C5:1F,2153291,273168035,80,9550,2153211,273158485,0,372,31302,315,24378,57,6924,88,1,136,7,0,19,144444.0,39000.0,-72.0,-69.0,-66.0,-60.0,-70.0,-68.0,-65.0,-59.0,-82.0,-89.0,-82.0,-90.0,10.0,20.0,16.0,30.0,1
408,CC:2F:71:3F:1F:24,2356422,537947629,203211,264789144,2153211,273158485,6,148066,178275725,147946,178259473,120,16252,143786,561,203257,30960,6,453,144444.0,43333.0,-71.0,-64.0,-71.0,-71.0,-70.0,-64.0,-69.0,-70.0,-82.0,-89.0,-82.0,-90.0,11.0,25.0,11.0,19.0,1
409,F8:59:71:5A:E0:3D,2226470,384645472,73256,111486512,2153214,273158960,337,50785,70647755,50706,70635410,79,12345,50479,33,73252,7974,337,39,144444.0,43333.0,-67.0,-71.0,-65.0,-70.0,-67.0,-71.0,-65.0,-70.0,-82.0,-89.0,-82.0,-90.0,15.0,18.0,17.0,20.0,1
410,CC:2F:71:3E:C5:1F,2153294,273168510,80,9550,2153214,273158960,0,373,31372,316,24448,57,6924,88,1,136,7,0,19,144444.0,39000.0,-71.0,-69.0,-66.0,-60.0,-70.0,-68.0,-65.0,-59.0,-82.0,-89.0,-82.0,-90.0,11.0,20.0,16.0,30.0,1
411,CC:2F:71:3F:1F:24,2356585,538153092,203371,264994132,2153214,273158960,6,148213,178470496,148093,178454244,120,16252,143933,561,203417,30960,6,454,144444.0,43333.0,-71.0,-64.0,-71.0,-71.0,-69.0,-64.0,-70.0,-70.0,-82.0,-89.0,-82.0,-90.0,11.0,25.0,11.0,19.0,1
412,F8:59:71:5A:E0:3D,2226659,384930956,73440,111771532,2153219,273159424,337,50863,70748409,50784,70736064,79,12345,50557,33,73436,7975,337,39,144444.0,43333.0,-67.0,-71.0,-65.0,-71.0,-66.0,-71.0,-65.0,-70.0,-82.0,-89.0,-82.0,-90.0,15.0,18.0,17.0,19.0,1
413,CC:2F:71:3E:C5:1F,2153299,273168974,80,9550,2153219,273159424,0,373,31372,316,24448,57,6924,88,1,136,7,0,19,144444.0,39000.0,-71.0,-69.0,-66.0,-60.0,-70.0,-68.0,-65.0,-59.0,-82.0,-89.0,-82.0,-90.0,11.0,20.0,16.0,30.0,1
414,CC:2F:71:3F:1F:24,2356772,538362608,203551,265202982,2153221,273159626,6,148384,178670326,148264,178654074,120,16252,144103,561,203597,30960,6,454,144444.0,43333.0,-69.0,-64.0,-69.0,-71.0,-70.0,-64.0,-69.0,-70.0,-82.0,-89.0,-82.0,-90.0,13.0,25.0,13.0,19.0,1
415,F8:59:71:5A:E0:3D,2226725,385027708,73502,111867880,2153223,273159828,337,50925,70843889,50846,70831544,79,12345,50619,33,73498,7976,337,39,144444.0,43333.0,-67.0,-71.0,-65.0,-70.0,-67.0,-70.0,-65.0,-70.0,-82.0,-89.0,-82.0,-90.0,15.0,18.0,17.0,20.0,1
416,CC:2F:71:3E:C5:1F,2153303,273169378,80,9550,2153223,273159828,0,373,31372,316,24448,57,6924,88,1,136,7,0,19,144444.0,39000.0,-71.0,-69.0,-66.0,-60.0,-70.0,-68.0,-65.0,-59.0,-82.0,-89.0,-82.0,-90.0,11.0,20.0,16.0,30.0,1
417,CC:2F:71:3F:1F:24,2356929,538564384,203706,265404556,2153223,273159828,6,148526,178864474,148406,178848222,120,16252,144245,561,203752,30960,6,454,144444.0,43333.0,-71.0,-64.0,-70.0,-71.0,-69.0,-64.0,-69.0,-70.0,-82.0,-89.0,-82.0,-90.0,11.0,25.0,12.0,19.0,1
418,F8:59:71:5A:E0:3D,2226812,385133754,73563,111962674,2153249,273171080,337,50987,70939369,50908,70927024,79,12345,50681,33,73559,7976,337,39,144444.0,43333.0,-67.0,-71.0,-65.0,-70.0,-67.0,-71.0,-65.0,-70.0,-82.0,-89.0,-82.0,-90.0,15.0,18.0,17.0,20.0,1
419,CC:2F:71:3E:C5:1F,2153329,273180630,80,9550,2153249,273171080,0,373,31372,316,24448,57,6924,88,1,136,7,0,19,144444.0,39000.0,-71.0,-69.0,-66.0,-60.0,-70.0,-68.0,-65.0,-59.0,-82.0,-89.0,-82.0,-90.0,11.0,20.0,16.0,30.0,1
420,CC:2F:71:3F:1F:24,2357117,538788088,203868,265617008,2153249,273171080,6,148673,179064946,148553,179048694,120,16252,144390,561,203914,30961,6,454,144444.0,43333.0,-71.0,-64.0,-70.0,-70.0,-69.0,-64.0,-70.0,-70.0,-82.0,-89.0,-82.0,-90.0,11.0,25.0,12.0,20.0,1
421,F8:59:71:5A:E0:3D,2227038,385476974,73783,112305368,2153255,273171606,337,51076,71045755,50996,71033292,80,12463,50770,33,73738,7976,337,39,144444.0,43333.0,-67.0,-72.0,-65.0,-71.0,-66.0,-71.0,-65.0,-70.0,-82.0,-89.0,-82.0,-90.0,15.0,17.0,17.0,19.0,1
422,CC:2F:71:3E:C5:1F,2153335,273181156,80,9550,2153255,273171606,0,373,31372,316,24448,57,6924,88,1,136,7,0,19,144444.0,39000.0,-71.0,-69.0,-66.0,-60.0,-70.0,-68.0,-65.0,-59.0,-82.0,-89.0,-82.0,-90.0,11.0,20.0,16.0,30.0,1
423,CC:2F:71:3F:1F:24,2357286,538998515,204031,265826909,2153255,273171606,6,148827,179267565,148707,179251313,120,16252,144542,561,204077,30961,6,454,144444.0,43333.0,-70.0,-64.0,-70.0,-70.0,-69.0,-64.0,-69.0,-70.0,-82.0,-89.0,-82.0,-90.0,12.0,25.0,12.0,20.0,1
424,F8:59:71:5A:E0:3D,2227134,385621540,73876,112449670,2153258,273171870,337,51150,71144063,51070,71131600,80,12463,50844,33,73872,7976,337,39,144444.0,43333.0,-67.0,-72.0,-65.0,-70.0,-66.0,-71.0,-65.0,-70.0,-82.0,-89.0,-82.0,-90.0,15.0,17.0,17.0,20.0,1
425,CC:2F:71:3E:C5:1F,2153338,273181420,80,9550,2153258,273171870,0,376,31678,317,24518,59,7160,89,1,136,7,0,21,144444.0,39000.0,-71.0,-69.0,-66.0,-60.0,-71.0,-70.0,-67.0,-61.0,-82.0,-89.0,-82.0,-90.0,11.0,20.0,16.0,30.0,1
426,CC:2F:71:3F:1F:24,2357444,539201777,204186,266029907,2153258,273171870,6,148970,179463225,148850,179446973,120,16252,144685,561,204232,30962,6,454,144444.0,43333.0,-71.0,-64.0,-70.0,-70.0,-69.0,-64.0,-70.0,-70.0,-82.0,-89.0,-82.0,-90.0,11.0,25.0,12.0,20.0,1
427,F8:59:71:5A:E0:3D,2227204,385720110,73939,112547572,2153265,273172538,337,51214,71242623,51134,71230160,80,12463,50908,33,73935,7976,337,39,144444.0,43333.0,-67.0,-72.0,-65.0,-70.0,-67.0,-72.0,-65.0,-70.0,-82.0,-89.0,-82.0,-90.0,15.0,17.0,17.0,20.0,1
428,CC:2F:71:3E:C5:1F,2153345,273182088,80,9550,2153265,273172538,0,376,31678,317,24518,59,7160,89,1,136,7,0,21,144444.0,39000.0,-71.0,-69.0,-66.0,-60.0,-71.0,-70.0,-67.0,-61.0,-82.0,-89.0,-82.0,-90.0,11.0,20.0,16.0,30.0,1
429,CC:2F:71:3F:1F:24,2357623,539412326,204358,266239788,2153265,273172538,6,149125,179665818,149004,179649448,121,16370,144840,561,204404,30962,6,456,144444.0,43333.0,-70.0,-64.0,-70.0,-70.0,-69.0,-63.0,-69.0,-70.0,-82.0,-89.0,-82.0,-90.0,12.0,25.0,12.0,20.0,1
430,F8:59:71:5A:E0:3D,2227295,385854858,74027,112682058,2153268,273172800,337,51280,71340391,51200,71327928,80,12463,50974,33,74023,7977,337,39,144444.0,43333.0,-67.0,-72.0,-65.0,-70.0,-67.0,-72.0,-65.0,-70.0,-82.0,-89.0,-82.0,-90.0,15.0,17.0,17.0,20.0,1
431,CC:2F:71:3E:C5:1F,2153348,273182350,80,9550,2153268,273172800,0,376,31678,317,24518,59,7160,89,1,136,7,0,21,144444.0,39000.0,-71.0,-69.0,-66.0,-60.0,-71.0,-70.0,-67.0,-61.0,-82.0,-89.0,-82.0,-90.0,11.0,20.0,16.0,30.0,1
432,CC:2F:71:3F:1F:24,2357788,539616248,204520,266443448,2153268,273172800,6,149273,179858358,149152,179841988,121,16370,144988,561,204566,30962,6,456,144444.0,43333.0,-71.0,-64.0,-70.0,-71.0,-69.0,-63.0,-69.0,-70.0,-82.0,-89.0,-82.0,-90.0,11.0,25.0,12.0,19.0,1
433,F8:59:71:5A:E0:3D,2227363,385951812,74089,112778406,2153274,273173406,337,51342,71435871,51262,71423408,80,12463,51036,33,74085,7977,337,39,144444.0,43333.0,-67.0,-72.0,-65.0,-70.0,-67.0,-72.0,-65.0,-70.0,-82.0,-89.0,-82.0,-90.0,15.0,17.0,17.0,20.0,1
434,CC:2F:71:3E:C5:1F,2153354,273182956,80,9550,2153274,273173406,0,376,31678,317,24518,59,7160,89,1,136,7,0,21,144444.0,39000.0,-71.0,-69.0,-66.0,-60.0,-71.0,-70.0,-67.0,-61.0,-82.0,-89.0,-82.0,-90.0,11.0,20.0,16.0,30.0,1
435,CC:2F:71:3F:1F:24,2357952,539823090,204678,266649684,2153274,273173406,6,149418,180055702,149297,180039332,121,16370,145133,561,204724,30962,6,457,144444.0,43333.0,-71.0,-63.0,-70.0,-70.0,-69.0,-63.0,-69.0,-70.0,-82.0,-89.0,-82.0,-90.0,11.0,26.0,12.0,20.0,1
436,F8:59:71:5A:E0:3D,2227432,386051928,74156,112878320,2153276,273173608,337,51410,71536791,51330,71524328,80,12463,51104,33,74152,7977,337,39,144444.0,43333.0,-67.0,-72.0,-65.0,-71.0,-67.0,-72.0,-64.0,-70.0,-82.0,-89.0,-82.0,-90.0,15.0,17.0,17.0,19.0,1
437,CC:2F:71:3E:C5:1F,2153356,273183158,80,9550,2153276,273173608,0,376,31678,317,24518,59,7160,89,1,136,7,0,21,144444.0,39000.0,-71.0,-69.0,-66.0,-60.0,-71.0,-70.0,-67.0,-61.0,-82.0,-89.0,-82.0,-90.0,11.0,20.0,16.0,30.0,1
438,CC:2F:71:3F:1F:24,2358112,540028034,204835,266854366,2153277,273173668,6,149562,180250110,149441,180233740,121,16370,145277,561,204881,30963,6,457,144444.0,43333.0,-59.0,-64.0,-66.0,-70.0,-69.0,-64.0,-69.0,-70.0,-82.0,-89.0,-82.0,-90.0,23.0,25.0,16.0,20.0,1
439,F8:59:71:5A:E0:3D,2227499,386148740,74218,112974668,2153281,273174072,337,51472,71632271,51392,71619808,80,12463,51166,33,74214,7977,337,39,144444.0,43333.0,-67.0,-72.0,-65.0,-70.0,-67.0,-72.0,-65.0,-70.0,-82.0,-89.0,-82.0,-90.0,15.0,17.0,17.0,20.0,1
440,CC:2F:71:3E:C5:1F,2153361,273183622,80,9550,2153281,273174072,0,376,31678,317,24518,59,7160,89,1,136,7,0,21,144444.0,39000.0,-71.0,-69.0,-66.0,-60.0,-71.0,-70.0,-67.0,-61.0,-82.0,-89.0,-82.0,-90.0,11.0,20.0,16.0,30.0,1
441,CC:2F:71:3F:1F:24,2358277,540233640,204996,267059568,2153281,273174072,6,149712,180448174,149591,180431804,121,16370,145427,561,205042,30963,6,457,144444.0,43333.0,-71.0,-64.0,-70.0,-70.0,-70.0,-63.0,-70.0,-70.0,-82.0,-89.0,-82.0,-90.0,11.0,25.0,12.0,20.0,1
442,F8:59:71:5A:E0:3D,2227572,386252181,74289,113077907,2153283,273174274,337,51541,71735049,51461,71722586,80,12463,51235,33,74285,7977,337,39,144444.0,43333.0,-67.0,-72.0,-65.0,-70.0,-67.0,-72.0,-65.0,-70.0,-82.0,-89.0,-82.0,-90.0,15.0,17.0,17.0,20.0,1
443,CC:2F:71:3E:C5:1F,2153365,273184026,80,9550,2153285,273174476,0,376,31678,317,24518,59,7160,89,1,136,7,0,21,144444.0,39000.0,-71.0,-69.0,-66.0,-60.0,-71.0,-70.0,-67.0,-61.0,-82.0,-89.0,-82.0,-90.0,11.0,20.0,16.0,30.0,1
444,CC:2F:71:3F:1F:24,2358469,540456920,205184,267282444,2153285,273174476,6,149879,180661146,149758,180644776,121,16370,145594,561,205230,30963,6,457,144444.0,43333.0,-70.0,-64.0,-69.0,-71.0,-69.0,-64.0,-69.0,-70.0,-82.0,-89.0,-82.0,-90.0,12.0,25.0,13.0,19.0,1
445,F8:59:71:5A:E0:3D,2227641,386350660,74353,113175922,2153288,273174738,337,51607,71833894,51527,71821431,80,12463,51300,33,74349,7977,337,39,144444.0,43333.0,-67.0,-72.0,-65.0,-70.0,-67.0,-72.0,-65.0,-70.0,-82.0,-89.0,-82.0,-90.0,15.0,17.0,17.0,20.0,1
446,CC:2F:71:3E:C5:1F,2153368,273184288,80,9550,2153288,273174738,0,376,31678,317,24518,59,7160,89,1,136,7,0,21,144444.0,39000.0,-71.0,-69.0,-66.0,-60.0,-71.0,-70.0,-67.0,-61.0,-82.0,-89.0,-82.0,-90.0,11.0,20.0,16.0,30.0,1
447,CC:2F:71:3F:1F:24,2358628,540660310,205340,267485572,2153288,273174738,6,150019,180855034,149898,180838664,121,16370,145734,561,205386,30964,6,457,144444.0,43333.0,-71.0,-64.0,-69.0,-71.0,-70.0,-63.0,-69.0,-70.0,-82.0,-89.0,-82.0,-90.0,11.0,25.0,13.0,19.0,1
448,F8:59:71:5A:E0:3D,2227706,386445858,74414,113270716,2153292,273175142,337,51669,71929374,51589,71916911,80,12463,51362,33,74410,7978,337,39,144444.0,43333.0,-67.0,-72.0,-65.0,-70.0,-67.0,-72.0,-65.0,-70.0,-82.0,-89.0,-82.0,-90.0,15.0,17.0,17.0,20.0,1
449,CC:2F:71:3E:C5:1F,2153372,273184692,80,9550,2153292,273175142,0,376,31678,317,24518,59,7160,89,1,136,7,0,21,144444.0,39000.0,-71.0,-69.0,-66.0,-60.0,-71.0,-70.0,-67.0,-61.0,-82.0,-89.0,-82.0,-90.0,11.0,20.0,16.0,30.0,1
450,CC:2F:71:3F:1F:24,2358796,540868867,205504,267693725,2153292,273175142,6,150169,181050573,150048,181034203,121,16370,145884,561,205550,30964,6,457,144444.0,43333.0,-70.0,-64.0,-70.0,-70.0,-70.0,-63.0,-69.0,-70.0,-82.0,-89.0,-82.0,-90.0,12.0,25.0,12.0,20.0,1
451,F8:59:71:5A:E0:3D,2228243,387281147,74949,114105803,2153294,273175344,337,51818,72042974,51738,72030511,80,12463,51511,33,74945,7978,337,39,144444.0,43333.0,-67.0,-72.0,-65.0,-70.0,-66.0,-71.0,-65.0,-70.0,-82.0,-89.0,-82.0,-90.0,15.0,17.0,17.0,20.0,1
452,CC:2F:71:3E:C5:1F,2153374,273184894,80,9550,2153294,273175344,0,376,31678,317,24518,59,7160,89,1,136,7,0,21,144444.0,39000.0,-71.0,-69.0,-66.0,-60.0,-71.0,-70.0,-67.0,-61.0,-82.0,-89.0,-82.0,-90.0,11.0,20.0,16.0,30.0,1
453,CC:2F:71:3F:1F:24,2358957,541073957,205661,267898411,2153296,273175546,6,150313,181247778,150192,181231408,121,16370,146028,561,205707,30964,6,457,144444.0,43333.0,-68.0,-64.0,-70.0,-70.0,-69.0,-64.0,-69.0,-70.0,-82.0,-89.0,-82.0,-90.0,14.0,25.0,12.0,20.0,1
454,F8:59:71:5A:E0:3D,2228320,387380907,75018,114204624,2153302,273176283,337,51886,72142462,51806,72129999,80,12463,51579,33,75014,7979,337,39,144444.0,43333.0,-67.0,-72.0,-65.0,-70.0,-67.0,-72.0,-65.0,-70.0,-82.0,-89.0,-82.0,-90.0,15.0,17.0,17.0,20.0,1
455,CC:2F:71:3E:C5:1F,2153382,273185833,80,9550,2153302,273176283,0,376,31678,317,24518,59,7160,89,1,136,7,0,21,144444.0,39000.0,-71.0,-69.0,-66.0,-60.0,-71.0,-70.0,-67.0,-61.0,-82.0,-89.0,-82.0,-90.0,11.0,20.0,16.0,30.0,1
456,CC:2F:71:3F:1F:24,2359133,541283287,205831,268107004,2153302,273176283,6,150467,181449701,150346,181433331,121,16370,146182,561,205877,30964,6,457,144444.0,43333.0,-71.0,-64.0,-70.0,-71.0,-70.0,-64.0,-69.0,-70.0,-82.0,-89.0,-82.0,-90.0,11.0,25.0,12.0,19.0,1
457,F8:59:71:5A:E0:3D,2228396,387479856,75090,114303003,2153306,273176853,337,51955,72237498,51875,72225035,80,12463,51648,33,75086,7979,337,39,144444.0,43333.0,-66.0,-71.0,-65.0,-70.0,-66.0,-71.0,-65.0,-70.0,-82.0,-89.0,-82.0,-90.0,16.0,18.0,17.0,20.0,1
458,CC:2F:71:3E:C5:1F,2153386,273186403,80,9550,2153306,273176853,0,376,31678,317,24518,59,7160,89,1,136,7,0,21,144444.0,39000.0,-71.0,-69.0,-66.0,-60.0,-71.0,-70.0,-67.0,-61.0,-82.0,-89.0,-82.0,-90.0,11.0,20.0,16.0,30.0,1
459,CC:2F:71:3F:1F:24,2359292,541486855,205986,268310002,2153306,273176853,6,150608,181643705,150487,181627335,121,16370,146323,561,206032,30964,6,457,144444.0,43333.0,-68.0,-64.0,-70.0,-70.0,-68.0,-63.0,-69.0,-70.0,-82.0,-89.0,-82.0,-90.0,14.0,25.0,12.0,20.0,1
460,F8:59:71:5A:E0:3D,2228591,387773115,75279,114595656,2153312,273177459,337,52043,72340738,51963,72328275,80,12463,51736,33,75275,7979,337,39,144444.0,43333.0,-68.0,-72.0,-65.0,-70.0,-67.0,-72.0,-65.0,-70.0,-82.0,-89.0,-82.0,-90.0,14.0,17.0,17.0,20.0,1
461,CC:2F:71:3E:C5:1F,2153392,273187009,80,9550,2153312,273177459,0,376,31678,317,24518,59,7160,89,1,136,7,0,21,144444.0,39000.0,-71.0,-69.0,-66.0,-60.0,-71.0,-70.0,-67.0,-61.0,-82.0,-89.0,-82.0,-90.0,11.0,20.0,16.0,30.0,1
462,CC:2F:71:3F:1F:24,2359457,541692428,206145,268514969,2153312,273177459,6,150751,181838068,150630,181821698,121,16370,146466,561,206191,30964,6,457,144444.0,43333.0,-71.0,-64.0,-70.0,-71.0,-69.0,-64.0,-69.0,-70.0,-82.0,-89.0,-82.0,-90.0,11.0,25.0,12.0,19.0,1
463,F8:59:71:5A:E0:3D,2228657,387871279,75342,114693558,2153315,273177721,337,52106,72437758,52026,72425295,80,12463,51799,33,75338,7979,337,39,144444.0,43333.0,-67.0,-72.0,-65.0,-70.0,-66.0,-72.0,-65.0,-70.0,-82.0,-89.0,-82.0,-90.0,15.0,17.0,17.0,20.0,1
464,CC:2F:71:3E:C5:1F,2153395,273187271,80,9550,2153315,273177721,0,376,31678,317,24518,59,7160,89,1,136,7,0,21,144444.0,39000.0,-71.0,-69.0,-66.0,-60.0,-71.0,-70.0,-67.0,-61.0,-82.0,-89.0,-82.0,-90.0,11.0,20.0,16.0,30.0,1
465,CC:2F:71:3F:1F:24,2359619,541900480,206304,268722759,2153315,273177721,6,150898,182038548,150777,182022178,121,16370,146613,561,206350,30964,6,457,144444.0,43333.0,-67.0,-64.0,-70.0,-70.0,-70.0,-63.0,-69.0,-70.0,-82.0,-89.0,-82.0,-90.0,15.0,25.0,12.0,20.0,1
466,F8:59:71:5A:E0:3D,2228731,387973353,75410,114795026,2153321,273178327,337,52174,72538720,52094,72526257,80,12463,51867,33,75406,7979,337,39,144444.0,43333.0,-67.0,-72.0,-65.0,-70.0,-66.0,-71.0,-65.0,-70.0,-82.0,-89.0,-82.0,-90.0,15.0,17.0,17.0,20.0,1
467,CC:2F:71:3E:C5:1F,2153401,273187877,80,9550,2153321,273178327,0,376,31678,317,24518,59,7160,89,1,136,7,0,21,144444.0,39000.0,-71.0,-69.0,-66.0,-60.0,-71.0,-70.0,-67.0,-61.0,-82.0,-89.0,-82.0,-90.0,11.0,20.0,16.0,30.0,1
468,CC:2F:71:3F:1F:24,2359791,542110923,206470,268932596,2153321,273178327,6,151052,182237400,150931,182221030,121,16370,146767,561,206516,30965,6,457,144444.0,43333.0,-71.0,-64.0,-70.0,-70.0,-68.0,-64.0,-69.0,-70.0,-82.0,-89.0,-82.0,-90.0,11.0,25.0,12.0,20.0,1
469,F8:59:71:5A:E0:3D,2228796,388071457,75473,114892928,2153323,273178529,337,52237,72635740,52157,72623277,80,12463,51930,33,75469,7979,337,39,144444.0,43333.0,-67.0,-72.0,-65.0,-70.0,-66.0,-72.0,-65.0,-70.0,-82.0,-89.0,-82.0,-90.0,15.0,17.0,17.0,20.0,1
470,CC:2F:71:3E:C5:1F,2153403,273188079,80,9550,2153323,273178529,0,376,31678,317,24518,59,7160,89,1,136,7,0,21,144444.0,39000.0,-71.0,-69.0,-66.0,-60.0,-71.0,-70.0,-67.0,-61.0,-82.0,-89.0,-82.0,-90.0,11.0,20.0,16.0,30.0,1
471,CC:2F:71:3F:1F:24,2359959,542319191,206636,269140662,2153323,273178529,6,151203,182435764,151082,182419394,121,16370,146918,561,206682,30965,6,457,144444.0,43333.0,-70.0,-64.0,-70.0,-70.0,-70.0,-63.0,-69.0,-70.0,-82.0,-89.0,-82.0,-90.0,12.0,25.0,12.0,20.0,1
472,F8:59:71:5A:E0:3D,2228895,388210966,75567,115031973,2153328,273178993,337,52309,72740300,52229,72727837,80,12463,52002,33,75563,7979,337,39,144444.0,43333.0,-67.0,-72.0,-65.0,-70.0,-67.0,-71.0,-65.0,-70.0,-82.0,-89.0,-82.0,-90.0,15.0,17.0,17.0,20.0,1
473,CC:2F:71:3E:C5:1F,2153408,273188543,80,9550,2153328,273178993,0,376,31678,317,24518,59,7160,89,1,136,7,0,21,144444.0,39000.0,-71.0,-69.0,-66.0,-60.0,-71.0,-70.0,-67.0,-61.0,-82.0,-89.0,-82.0,-90.0,11.0,20.0,16.0,30.0,1
474,CC:2F:71:3F:1F:24,2360121,542522855,206791,269343660,2153330,273179195,6,151345,182629940,151224,182613570,121,16370,147060,561,206837,30965,6,457,144444.0,43333.0,-68.0,-64.0,-70.0,-70.0,-69.0,-64.0,-69.0,-70.0,-82.0,-89.0,-82.0,-90.0,14.0,25.0,12.0,20.0,1
475,F8:59:71:5A:E0:3D,2228960,388306164,75628,115126767,2153332,273179397,337,52371,72835780,52291,72823317,80,12463,52064,33,75624,7980,337,39,144444.0,43333.0,-66.0,-72.0,-65.0,-70.0,-66.0,-72.0,-64.0,-70.0,-82.0,-89.0,-82.0,-90.0,16.0,17.0,17.0,20.0,1
476,CC:2F:71:3E:C5:1F,2153412,273188947,80,9550,2153332,273179397,0,376,31678,317,24518,59,7160,89,1,136,7,0,21,144444.0,39000.0,-71.0,-69.0,-66.0,-60.0,-71.0,-70.0,-67.0,-61.0,-82.0,-89.0,-82.0,-90.0,11.0,20.0,16.0,30.0,1
477,CC:2F:71:3F:1F:24,2360280,542726397,206948,269547000,2153332,273179397,6,151487,182824068,151366,182807698,121,16370,147202,561,206994,30965,6,457,130000.0,39000.0,-66.0,-64.0,-70.0,-70.0,-69.0,-64.0,-69.0,-70.0,-82.0,-89.0,-82.0,-90.0,16.0,25.0,12.0,20.0,1
478,F8:59:71:5A:E0:3D,2229031,388409388,75697,115229789,2153334,273179599,337,52440,72938240,52360,72925777,80,12463,52133,33,75693,7981,337,39,144444.0,43333.0,-66.0,-72.0,-64.0,-70.0,-66.0,-71.0,-64.0,-70.0,-82.0,-89.0,-82.0,-90.0,16.0,17.0,18.0,20.0,1
479,CC:2F:71:3E:C5:1F,2153414,273189149,80,9550,2153334,273179599,0,376,31678,317,24518,59,7160,89,1,136,7,0,21,144444.0,39000.0,-71.0,-69.0,-66.0,-60.0,-71.0,-70.0,-67.0,-61.0,-82.0,-89.0,-82.0,-90.0,11.0,20.0,16.0,30.0,1
480,CC:2F:71:3F:1F:24,2360445,542939011,207109,269759210,2153336,273179801,6,151634,183027340,151513,183010970,121,16370,147349,561,207155,30965,6,457,144444.0,43333.0,-71.0,-64.0,-70.0,-71.0,-70.0,-64.0,-70.0,-70.0,-82.0,-89.0,-82.0,-90.0,11.0,25.0,12.0,19.0,1
481,F8:59:71:5A:E0:3D,2229100,388507870,75761,115327807,2153339,273180063,337,52504,73035366,52424,73022903,80,12463,52197,33,75757,7981,337,39,144444.0,43333.0,-66.0,-72.0,-64.0,-70.0,-66.0,-71.0,-64.0,-70.0,-82.0,-89.0,-82.0,-90.0,16.0,17.0,18.0,20.0,1
482,CC:2F:71:3E:C5:1F,2153421,273189815,80,9550,2153341,273180265,0,376,31678,317,24518,59,7160,89,1,136,7,0,21,144444.0,39000.0,-71.0,-69.0,-66.0,-60.0,-71.0,-70.0,-67.0,-61.0,-82.0,-89.0,-82.0,-90.0,11.0,20.0,16.0,30.0,1
483,CC:2F:71:3F:1F:24,2360614,543149052,207273,269968787,2153341,273180265,6,151782,183222676,151661,183206306,121,16370,147497,561,207319,30966,6,457,144444.0,43333.0,-70.0,-64.0,-70.0,-71.0,-70.0,-64.0,-70.0,-70.0,-82.0,-89.0,-82.0,-90.0,12.0,25.0,12.0,19.0,1
484,F8:59:71:5A:E0:3D,2229164,388604420,75823,115424155,2153341,273180265,337,52567,73132386,52487,73119923,80,12463,52260,33,75819,7981,337,39,144444.0,43333.0,-67.0,-72.0,-65.0,-70.0,-66.0,-71.0,-65.0,-70.0,-82.0,-89.0,-82.0,-90.0,15.0,17.0,17.0,20.0,1
485,CC:2F:71:3E:C5:1F,2153421,273189815,80,9550,2153341,273180265,0,376,31678,317,24518,59,7160,89,1,136,7,0,21,144444.0,39000.0,-71.0,-69.0,-66.0,-60.0,-71.0,-70.0,-67.0,-61.0,-82.0,-89.0,-82.0,-90.0,11.0,20.0,16.0,30.0,1
486,CC:2F:71:3F:1F:24,2360772,543352382,207429,270171915,2153343,273180467,6,151927,183419992,151806,183403622,121,16370,147642,561,207475,30966,6,457,144444.0,43333.0,-71.0,-64.0,-70.0,-70.0,-70.0,-64.0,-69.0,-70.0,-82.0,-89.0,-82.0,-90.0,11.0,25.0,12.0,20.0,1
487,F8:59:71:5A:E0:3D,2229232,388701374,75885,115520503,2153347,273180871,337,52629,73227866,52549,73215403,80,12463,52322,33,75881,7981,337,39,144444.0,43333.0,-66.0,-71.0,-65.0,-70.0,-66.0,-71.0,-65.0,-70.0,-82.0,-89.0,-82.0,-90.0,16.0,18.0,17.0,20.0,1
488,CC:2F:71:3E:C5:1F,2153427,273190421,80,9550,2153347,273180871,0,376,31678,317,24518,59,7160,89,1,136,7,0,21,144444.0,39000.0,-71.0,-69.0,-66.0,-60.0,-71.0,-70.0,-67.0,-61.0,-82.0,-89.0,-82.0,-90.0,11.0,20.0,16.0,30.0,1
489,CC:2F:71:3F:1F:24,2360935,543559152,207588,270378281,2153347,273180871,6,152073,183616090,151952,183599720,121,16370,147787,561,207634,30968,6,458,144444.0,43333.0,-67.0,-64.0,-70.0,-71.0,-69.0,-64.0,-70.0,-70.0,-82.0,-89.0,-82.0,-90.0,15.0,25.0,12.0,19.0,1
490,F8:59:71:5A:E0:3D,2229302,388804316,75952,115623183,2153350,273181133,337,52695,73328072,52615,73315609,80,12463,52388,33,75947,7981,337,39,144444.0,43333.0,-67.0,-72.0,-65.0,-71.0,-66.0,-71.0,-64.0,-70.0,-82.0,-89.0,-82.0,-90.0,15.0,17.0,17.0,19.0,1
491,CC:2F:71:3E:C5:1F,2153430,273190683,80,9550,2153350,273181133,0,378,31818,319,24658,59,7160,89,1,137,7,0,21,144444.0,39000.0,-70.0,-68.0,-66.0,-60.0,-71.0,-70.0,-67.0,-61.0,-82.0,-89.0,-82.0,-90.0,12.0,21.0,16.0,30.0,1
492,CC:2F:71:3F:1F:24,2361100,543770428,207750,270589295,2153350,273181133,6,152222,183818188,152101,183801818,121,16370,147936,561,207795,30968,6,458,144444.0,43333.0,-70.0,-64.0,-69.0,-71.0,-70.0,-64.0,-69.0,-70.0,-82.0,-89.0,-82.0,-90.0,12.0,25.0,13.0,19.0,1
493,F8:59:71:5A:E0:3D,2229561,389198231,76205,116016492,2153356,273181739,337,52792,73430932,52712,73418469,80,12463,52485,33,76201,7982,337,39,144444.0,43333.0,-67.0,-72.0,-65.0,-71.0,-66.0,-71.0,-64.0,-70.0,-82.0,-89.0,-82.0,-90.0,15.0,17.0,17.0,19.0,1
494,CC:2F:71:3E:C5:1F,2153437,273191405,81,9666,2153356,273181739,0,380,31958,321,24798,59,7160,89,1,138,7,0,21,144444.0,39000.0,-71.0,-69.0,-66.0,-60.0,-71.0,-70.0,-67.0,-61.0,-82.0,-89.0,-82.0,-90.0,11.0,20.0,16.0,30.0,1
495,CC:2F:71:3F:1F:24,2361264,543975832,207908,270794093,2153356,273181739,6,152367,184015504,152246,183999134,121,16370,148081,561,207954,30968,6,458,144444.0,43333.0,-67.0,-64.0,-70.0,-71.0,-68.0,-64.0,-70.0,-70.0,-82.0,-89.0,-82.0,-90.0,15.0,25.0,12.0,19.0,1
496,F8:59:71:5A:E0:3D,2229749,389485941,76390,116303727,2153359,273182214,337,52869,73534310,52789,73521847,80,12463,52561,33,76386,7982,337,39,144444.0,43333.0,-67.0,-72.0,-65.0,-71.0,-66.0,-72.0,-65.0,-70.0,-82.0,-89.0,-82.0,-90.0,15.0,17.0,17.0,19.0,1
497,CC:2F:71:3E:C5:1F,2153440,273191880,81,9666,2153359,273182214,0,380,31958,321,24798,59,7160,89,1,138,7,0,21,144444.0,39000.0,-71.0,-69.0,-66.0,-60.0,-71.0,-70.0,-67.0,-61.0,-82.0,-89.0,-82.0,-90.0,11.0,20.0,16.0,30.0,1
498,CC:2F:71:3F:1F:24,2361422,544180729,208063,270998515,2153359,273182214,6,152508,184209536,152387,184193166,121,16370,148222,561,208109,30968,6,459,144444.0,43333.0,-71.0,-64.0,-70.0,-70.0,-69.0,-64.0,-70.0,-70.0,-82.0,-89.0,-82.0,-90.0,11.0,25.0,12.0,20.0,1
499,F8:59:71:5A:E0:3D,2229818,389582955,76452,116400075,2153366,273182880,337,52931,73629790,52851,73617327,80,12463,52623,33,76448,7982,337,39,144444.0,43333.0,-67.0,-72.0,-65.0,-71.0,-66.0,-71.0,-65.0,-70.0,-82.0,-89.0,-82.0,-90.0,15.0,17.0,17.0,19.0,1
500,CC:2F:71:3E:C5:1F,2153447,273192546,81,9666,2153366,273182880,0,380,31958,321,24798,59,7160,89,1,138,7,0,21,144444.0,39000.0,-71.0,-69.0,-66.0,-60.0,-71.0,-70.0,-67.0,-61.0,-82.0,-89.0,-82.0,-90.0,11.0,20.0,16.0,30.0,1
501,CC:2F:71:3F:1F:24,2361593,544389548,208227,271206668,2153366,273182880,6,152657,184404958,152536,184388588,121,16370,148371,561,208273,30968,6,459,144444.0,43333.0,-71.0,-64.0,-70.0,-70.0,-69.0,-64.0,-69.0,-70.0,-82.0,-89.0,-82.0,-90.0,11.0,25.0,12.0,20.0,1
502,F8:59:71:5A:E0:3D,2229883,389679567,76514,116496423,2153369,273183144,337,52995,73726928,52914,73714347,81,12581,52687,33,76510,7982,337,39,144444.0,43333.0,-66.0,-72.0,-65.0,-70.0,-66.0,-71.0,-64.0,-70.0,-82.0,-89.0,-82.0,-90.0,16.0,17.0,17.0,20.0,1
503,CC:2F:71:3E:C5:1F,2153451,273192872,81,9666,2153370,273183206,0,381,32076,321,24798,60,7278,90,1,138,7,0,22,144444.0,39000.0,-76.0,-85.0,-75.0,-72.0,-72.0,-72.0,-68.0,-63.0,-82.0,-89.0,-82.0,-90.0,6.0,4.0,7.0,18.0,1
504,CC:2F:71:3F:1F:24,2361754,544594540,208384,271411334,2153370,273183206,6,152800,184602042,152679,184585672,121,16370,148514,561,208430,30968,6,459,144444.0,43333.0,-71.0,-64.0,-70.0,-70.0,-68.0,-64.0,-69.0,-70.0,-82.0,-89.0,-82.0,-90.0,11.0,25.0,12.0,20.0,1
505,F8:59:71:5A:E0:3D,2229949,389776241,76576,116592771,2153373,273183470,337,53057,73822408,52976,73809827,81,12581,52749,33,76572,7982,337,39,144444.0,43333.0,-66.0,-71.0,-65.0,-71.0,-66.0,-71.0,-64.0,-70.0,-82.0,-89.0,-82.0,-90.0,16.0,18.0,17.0,19.0,1
506,CC:2F:71:3E:C5:1F,2153458,273193540,81,9666,2153377,273183874,0,382,32146,322,24868,60,7278,90,1,138,7,0,22,144444.0,39000.0,-71.0,-69.0,-66.0,-60.0,-72.0,-72.0,-68.0,-63.0,-82.0,-89.0,-82.0,-90.0,11.0,20.0,16.0,30.0,1
507,CC:2F:71:3F:1F:24,2361915,544798076,208538,271614202,2153377,273183874,6,152942,184797602,152820,184781114,122,16488,148655,561,208584,30969,6,459,144444.0,43333.0,-67.0,-64.0,-70.0,-70.0,-68.0,-64.0,-70.0,-70.0,-82.0,-89.0,-82.0,-90.0,15.0,25.0,12.0,20.0,1
508,F8:59:71:5A:E0:3D,2230022,389879471,76642,116695335,2153380,273184136,337,53122,73922508,53041,73909927,81,12581,52814,33,76638,7982,337,39,144444.0,43333.0,-66.0,-71.0,-65.0,-70.0,-66.0,-71.0,-64.0,-70.0,-82.0,-89.0,-82.0,-90.0,16.0,18.0,17.0,20.0,1
509,CC:2F:71:3E:C5:1F,2153461,273193802,81,9666,2153380,273184136,0,382,32146,322,24868,60,7278,90,1,138,7,0,22,144444.0,39000.0,-71.0,-69.0,-66.0,-60.0,-72.0,-72.0,-68.0,-63.0,-82.0,-89.0,-82.0,-90.0,11.0,20.0,16.0,30.0,1
510,CC:2F:71:3F:1F:24,2362081,545012472,208701,271828336,2153380,273184136,6,153093,185004394,152971,184987906,122,16488,148806,561,208747,30969,6,459,144444.0,43333.0,-66.0,-64.0,-69.0,-70.0,-68.0,-64.0,-69.0,-70.0,-82.0,-89.0,-82.0,-90.0,16.0,25.0,13.0,20.0,1
511,F8:59:71:5A:E0:3D,2230088,389981923,76708,116797787,2153380,273184136,337,53187,74022608,53106,74010027,81,12581,52879,33,76704,7982,337,39,144444.0,43333.0,-66.0,-71.0,-65.0,-70.0,-66.0,-71.0,-65.0,-70.0,-82.0,-89.0,-82.0,-90.0,16.0,18.0,17.0,20.0,1
512,CC:2F:71:3E:C5:1F,2153463,273194004,81,9666,2153382,273184338,0,382,32146,322,24868,60,7278,90,1,138,7,0,22,144444.0,39000.0,-71.0,-69.0,-66.0,-60.0,-72.0,-72.0,-68.0,-63.0,-82.0,-89.0,-82.0,-90.0,11.0,20.0,16.0,30.0,1
513,CC:2F:71:3F:1F:24,2362247,545228234,208865,272043896,2153382,273184338,6,153239,185207578,153117,185191090,122,16488,148952,561,208910,30970,6,459,144444.0,43333.0,-71.0,-64.0,-70.0,-71.0,-69.0,-63.0,-69.0,-70.0,-82.0,-89.0,-82.0,-90.0,11.0,25.0,12.0,19.0,1
514,F8:59:71:5A:E0:3D,2230161,390079343,76772,116894339,2153389,273185004,337,53254,74124083,53173,74111502,81,12581,52945,33,76768,7982,337,39,144444.0,43333.0,-66.0,-71.0,-65.0,-70.0,-66.0,-71.0,-64.0,-70.0,-82.0,-89.0,-82.0,-90.0,16.0,18.0,17.0,20.0,1
515,CC:2F:71:3E:C5:1F,2153470,273194670,81,9666,2153389,273185004,0,382,32146,322,24868,60,7278,90,1,138,7,0,22,144444.0,39000.0,-71.0,-69.0,-66.0,-60.0,-72.0,-72.0,-68.0,-63.0,-82.0,-89.0,-82.0,-90.0,11.0,20.0,16.0,30.0,1
516,CC:2F:71:3F:1F:24,2362413,545433881,209024,272248877,2153389,273185004,6,153385,185405049,153263,185388561,122,16488,149098,561,209070,30970,6,459,144444.0,43333.0,-71.0,-64.0,-70.0,-70.0,-70.0,-64.0,-69.0,-70.0,-82.0,-89.0,-82.0,-90.0,11.0,25.0,12.0,20.0,1
517,F8:59:71:5A:E0:3D,2230369,390387561,76980,117202557,2153389,273185004,337,53351,74233478,53270,74220897,81,12581,53042,33,76976,7982,337,39,144444.0,43333.0,-66.0,-71.0,-65.0,-70.0,-66.0,-71.0,-65.0,-70.0,-82.0,-89.0,-82.0,-90.0,16.0,18.0,17.0,20.0,1
518,CC:2F:71:3E:C5:1F,2153470,273194670,81,9666,2153389,273185004,0,382,32146,322,24868,60,7278,90,1,138,7,0,22,144444.0,39000.0,-71.0,-69.0,-66.0,-60.0,-72.0,-72.0,-68.0,-63.0,-82.0,-89.0,-82.0,-90.0,11.0,20.0,16.0,30.0,1
519,CC:2F:71:3F:1F:24,2362592,545647511,209203,272462507,2153389,273185004,6,153548,185609976,153426,185593488,122,16488,149260,561,209248,30971,6,459,144444.0,43333.0,-71.0,-64.0,-70.0,-70.0,-69.0,-64.0,-70.0,-70.0,-82.0,-89.0,-82.0,-90.0,11.0,25.0,12.0,20.0,1
520,F8:59:71:5A:E0:3D,2230440,390486271,77043,117300459,2153397,273185812,337,53416,74332154,53335,74319573,81,12581,53107,33,77039,7982,337,39,144444.0,43333.0,-66.0,-71.0,-65.0,-70.0,-66.0,-71.0,-64.0,-70.0,-82.0,-89.0,-82.0,-90.0,16.0,18.0,17.0,20.0,1
521,CC:2F:71:3E:C5:1F,2153478,273195478,81,9666,2153397,273185812,0,382,32146,322,24868,60,7278,90,1,138,7,0,22,144444.0,39000.0,-71.0,-69.0,-66.0,-60.0,-72.0,-72.0,-68.0,-63.0,-82.0,-89.0,-82.0,-90.0,11.0,20.0,16.0,30.0,1
522,CC:2F:71:3F:1F:24,2362759,545854915,209362,272669103,2153397,273185812,6,153691,185807060,153569,185790572,122,16488,149403,561,209408,30972,6,459,144444.0,43333.0,-70.0,-64.0,-70.0,-71.0,-69.0,-64.0,-69.0,-70.0,-82.0,-89.0,-82.0,-90.0,12.0,25.0,12.0,19.0,1
523,F8:59:71:5A:E0:3D,2230508,390586245,77110,117400373,2153398,273185872,337,53483,74431534,53402,74418953,81,12581,53174,33,77106,7982,337,39,144444.0,43333.0,-66.0,-71.0,-65.0,-70.0,-66.0,-71.0,-65.0,-70.0,-82.0,-89.0,-82.0,-90.0,16.0,18.0,17.0,20.0,1
524,CC:2F:71:3E:C5:1F,2153479,273195538,81,9666,2153398,273185872,0,382,32146,322,24868,60,7278,90,1,138,7,0,22,144444.0,39000.0,-71.0,-69.0,-66.0,-60.0,-72.0,-72.0,-68.0,-63.0,-82.0,-89.0,-82.0,-90.0,11.0,20.0,16.0,30.0,1
525,CC:2F:71:3F:1F:24,2362916,546058103,209518,272872231,2153398,273185872,6,153833,186001180,153711,185984692,122,16488,149545,561,209564,30972,6,459,144444.0,43333.0,-71.0,-64.0,-70.0,-71.0,-69.0,-64.0,-69.0,-70.0,-82.0,-89.0,-82.0,-90.0,11.0,25.0,12.0,19.0,1
526,F8:59:71:5A:E0:3D,2230576,390683199,77172,117496721,2153404,273186478,337,53546,74528554,53465,74515973,81,12581,53237,33,77168,7983,337,39,144444.0,43333.0,-66.0,-71.0,-65.0,-70.0,-66.0,-71.0,-65.0,-70.0,-82.0,-89.0,-82.0,-90.0,16.0,18.0,17.0,20.0,1
527,CC:2F:71:3E:C5:1F,2153485,273196144,81,9666,2153404,273186478,0,382,32146,322,24868,60,7278,90,1,138,7,0,22,144444.0,39000.0,-71.0,-69.0,-66.0,-60.0,-72.0,-72.0,-68.0,-63.0,-82.0,-89.0,-82.0,-90.0,11.0,20.0,16.0,30.0,1
528,CC:2F:71:3F:1F:24,2363079,546263391,209675,273076913,2153404,273186478,6,153974,186196608,153852,186180120,122,16488,149686,561,209721,30972,6,459,144444.0,43333.0,-67.0,-64.0,-70.0,-70.0,-68.0,-64.0,-69.0,-70.0,-82.0,-89.0,-82.0,-90.0,15.0,25.0,12.0,20.0,1
529,F8:59:71:5A:E0:3D,2230640,390779749,77234,117593069,2153406,273186680,337,53608,74624034,53527,74611453,81,12581,53299,33,77230,7983,337,39,144444.0,43333.0,-66.0,-71.0,-65.0,-71.0,-66.0,-71.0,-65.0,-70.0,-82.0,-89.0,-82.0,-90.0,16.0,18.0,17.0,19.0,1
530,CC:2F:71:3E:C5:1F,2153487,273196346,81,9666,2153406,273186680,0,382,32146,322,24868,60,7278,90,1,138,7,0,22,144444.0,39000.0,-71.0,-69.0,-66.0,-60.0,-72.0,-72.0,-68.0,-63.0,-82.0,-89.0,-82.0,-90.0,11.0,20.0,16.0,30.0,1
531,CC:2F:71:3F:1F:24,2363253,546474729,209847,273288049,2153406,273186680,6,154129,186396174,154007,186379686,122,16488,149841,561,209893,30972,6,459,144444.0,43333.0,-71.0,-64.0,-70.0,-70.0,-70.0,-64.0,-70.0,-70.0,-82.0,-89.0,-82.0,-90.0,11.0,25.0,12.0,20.0,1
532,F8:59:71:5A:E0:3D,2230710,390878317,77297,117690971,2153413,273187346,337,53671,74721054,53590,74708473,81,12581,53362,33,77293,7983,337,39,144444.0,43333.0,-66.0,-71.0,-65.0,-71.0,-66.0,-71.0,-64.0,-70.0,-82.0,-89.0,-82.0,-90.0,16.0,18.0,17.0,19.0,1
533,CC:2F:71:3E:C5:1F,2153494,273197012,81,9666,2153413,273187346,0,382,32146,322,24868,60,7278,90,1,138,7,0,22,144444.0,39000.0,-71.0,-69.0,-66.0,-60.0,-72.0,-72.0,-68.0,-63.0,-82.0,-89.0,-82.0,-90.0,11.0,20.0,16.0,30.0,1
534,CC:2F:71:3F:1F:24,2363417,546678653,210004,273491307,2153413,273187346,6,154274,186592066,154152,186575578,122,16488,149986,561,210050,30973,6,459,144444.0,43333.0,-67.0,-64.0,-70.0,-70.0,-70.0,-64.0,-69.0,-70.0,-82.0,-89.0,-82.0,-90.0,15.0,25.0,12.0,20.0,1
535,F8:59:71:5A:E0:3D,2230775,390976421,77360,117788873,2153415,273187548,337,53733,74816534,53652,74803953,81,12581,53424,33,77356,7983,337,39,144444.0,43333.0,-67.0,-71.0,-65.0,-70.0,-66.0,-71.0,-64.0,-70.0,-82.0,-89.0,-82.0,-90.0,15.0,18.0,17.0,20.0,1
536,CC:2F:71:3E:C5:1F,2153496,273197214,81,9666,2153415,273187548,0,382,32146,322,24868,60,7278,90,1,138,7,0,22,144444.0,39000.0,-71.0,-69.0,-66.0,-60.0,-72.0,-72.0,-68.0,-63.0,-82.0,-89.0,-82.0,-90.0,11.0,20.0,16.0,30.0,1
537,CC:2F:71:3F:1F:24,2363606,546891965,210191,273704417,2153415,273187548,6,154438,186796356,154316,186779868,122,16488,150150,561,210237,30973,6,459,144444.0,43333.0,-67.0,-64.0,-70.0,-71.0,-68.0,-64.0,-70.0,-70.0,-82.0,-89.0,-82.0,-90.0,15.0,25.0,12.0,19.0,1
538,F8:59:71:5A:E0:3D,2230841,391073173,77422,117885221,2153419,273187952,337,53797,74915108,53716,74902527,81,12581,53487,33,77418,7983,337,39,144444.0,43333.0,-66.0,-71.0,-65.0,-70.0,-66.0,-71.0,-65.0,-70.0,-82.0,-89.0,-82.0,-90.0,16.0,18.0,17.0,20.0,1
539,CC:2F:71:3E:C5:1F,2153501,273197891,81,9666,2153420,273188225,0,382,32146,322,24868,60,7278,90,1,138,7,0,22,144444.0,39000.0,-71.0,-69.0,-66.0,-60.0,-72.0,-72.0,-68.0,-63.0,-82.0,-89.0,-82.0,-90.0,11.0,20.0,16.0,30.0,1
540,CC:2F:71:3F:1F:24,2363780,547101678,210358,273913251,2153422,273188427,6,154589,187004229,154467,186987741,122,16488,150301,561,210404,30973,6,459,144444.0,43333.0,-71.0,-64.0,-70.0,-70.0,-70.0,-64.0,-69.0,-70.0,-82.0,-89.0,-82.0,-90.0,11.0,25.0,12.0,20.0,1
541,F8:59:71:5A:E0:3D,2231030,391358033,77605,118169344,2153425,273188689,337,53878,75017506,53797,75004925,81,12581,53568,33,77601,7989,337,39,144444.0,43333.0,-67.0,-71.0,-65.0,-70.0,-66.0,-71.0,-64.0,-70.0,-82.0,-89.0,-82.0,-90.0,15.0,18.0,17.0,20.0,1
542,CC:2F:71:3E:C5:1F,2153506,273198355,81,9666,2153425,273188689,0,382,32146,322,24868,60,7278,90,1,138,7,0,22,144444.0,39000.0,-71.0,-69.0,-66.0,-60.0,-72.0,-72.0,-68.0,-63.0,-82.0,-89.0,-82.0,-90.0,11.0,20.0,16.0,30.0,1
543,CC:2F:71:3F:1F:24,2364604,548148358,211179,274959669,2153425,273188689,6,154878,187260468,154756,187243980,122,16488,150590,561,211225,30973,6,461,144444.0,43333.0,-68.0,-64.0,-70.0,-70.0,-69.0,-64.0,-69.0,-70.0,-82.0,-89.0,-82.0,-90.0,14.0,25.0,12.0,20.0,1
544,F8:59:71:5A:E0:3D,2231093,391455935,77668,118267246,2153425,273188689,337,53940,75112986,53859,75100405,81,12581,53630,33,77664,7989,337,39,144444.0,43333.0,-66.0,-71.0,-65.0,-70.0,-66.0,-71.0,-64.0,-70.0,-82.0,-89.0,-82.0,-90.0,16.0,18.0,17.0,20.0,1
545,CC:2F:71:3E:C5:1F,2153508,273198557,81,9666,2153427,273188891,0,382,32146,322,24868,60,7278,90,1,138,7,0,22,144444.0,39000.0,-71.0,-69.0,-66.0,-60.0,-72.0,-72.0,-68.0,-63.0,-82.0,-89.0,-82.0,-90.0,11.0,20.0,16.0,30.0,1
546,CC:2F:71:3F:1F:24,2364857,548460910,211428,275271817,2153429,273189093,6,155059,187464553,154937,187448065,122,16488,150771,561,211473,30974,6,461,130000.0,39000.0,-71.0,-64.0,-70.0,-70.0,-70.0,-64.0,-69.0,-70.0,-82.0,-89.0,-82.0,-90.0,11.0,25.0,12.0,20.0,1
547,F8:59:71:5A:E0:3D,2231306,391775577,77873,118586080,2153433,273189497,337,54040,75219236,53959,75206655,81,12581,53729,33,77869,7989,337,39,144444.0,43333.0,-67.0,-71.0,-64.0,-70.0,-67.0,-71.0,-64.0,-70.0,-82.0,-89.0,-82.0,-90.0,15.0,18.0,18.0,20.0,1
548,CC:2F:71:3E:C5:1F,2153514,273199163,81,9666,2153433,273189497,0,382,32146,322,24868,60,7278,90,1,138,7,0,22,144444.0,39000.0,-71.0,-69.0,-66.0,-60.0,-72.0,-72.0,-68.0,-63.0,-82.0,-89.0,-82.0,-90.0,11.0,20.0,16.0,30.0,1
549,CC:2F:71:3F:1F:24,2365036,548669150,211603,275479653,2153433,273189497,6,155213,187669353,155091,187652865,122,16488,150925,561,211649,30975,6,461,144444.0,43333.0,-70.0,-64.0,-70.0,-70.0,-69.0,-64.0,-69.0,-70.0,-82.0,-89.0,-82.0,-90.0,12.0,25.0,12.0,20.0,1
550,F8:59:71:5A:E0:3D,2231369,391871985,77935,118682428,2153434,273189557,337,54102,75314716,54021,75302135,81,12581,53791,33,77931,7989,337,39,144444.0,43333.0,-67.0,-71.0,-65.0,-71.0,-66.0,-71.0,-64.0,-70.0,-82.0,-89.0,-82.0,-90.0,15.0,18.0,17.0,19.0,1
551,CC:2F:71:3E:C5:1F,2153515,273199223,81,9666,2153434,273189557,0,382,32146,322,24868,60,7278,90,1,138,7,0,22,144444.0,39000.0,-71.0,-69.0,-66.0,-60.0,-72.0,-72.0,-68.0,-63.0,-82.0,-89.0,-82.0,-90.0,11.0,20.0,16.0,30.0,1
552,CC:2F:71:3F:1F:24,2365193,548873762,211759,275684205,2153434,273189557,6,155356,187865013,155234,187848525,122,16488,151068,561,211805,30975,6,461,144444.0,43333.0,-71.0,-64.0,-70.0,-70.0,-69.0,-64.0,-69.0,-70.0,-82.0,-89.0,-82.0,-90.0,11.0,25.0,12.0,20.0,1
553,F8:59:71:5A:E0:3D,2231440,391970695,77998,118780330,2153442,273190365,337,54165,75411736,54084,75399155,81,12581,53854,33,77994,7989,337,39,144444.0,43333.0,-67.0,-72.0,-65.0,-70.0,-67.0,-71.0,-65.0,-70.0,-82.0,-89.0,-82.0,-90.0,15.0,17.0,17.0,20.0,1
554,CC:2F:71:3E:C5:1F,2153523,273200031,81,9666,2153442,273190365,0,382,32146,322,24868,60,7278,90,1,138,7,0,22,144444.0,39000.0,-71.0,-69.0,-66.0,-60.0,-72.0,-72.0,-68.0,-63.0,-82.0,-89.0,-82.0,-90.0,11.0,20.0,16.0,30.0,1
555,CC:2F:71:3F:1F:24,2365367,549087255,211925,275896890,2153442,273190365,6,155506,188064908,155384,188048420,122,16488,151218,561,211971,30975,6,461,144444.0,43333.0,-71.0,-64.0,-70.0,-70.0,-67.0,-64.0,-69.0,-70.0,-82.0,-89.0,-82.0,-90.0,11.0,25.0,12.0,20.0,1
556,F8:59:71:5A:E0:3D,2231505,392071705,78063,118881340,2153442,273190365,337,54230,75511836,54149,75499255,81,12581,53919,33,78059,7989,337,39,144444.0,43333.0,-67.0,-72.0,-65.0,-70.0,-66.0,-71.0,-65.0,-70.0,-82.0,-89.0,-82.0,-90.0,15.0,17.0,17.0,20.0,1
557,CC:2F:71:3E:C5:1F,2153523,273200031,81,9666,2153442,273190365,0,382,32146,322,24868,60,7278,90,1,138,7,0,22,144444.0,39000.0,-71.0,-69.0,-66.0,-60.0,-72.0,-72.0,-68.0,-63.0,-82.0,-89.0,-82.0,-90.0,11.0,20.0,16.0,30.0,1
558,CC:2F:71:3F:1F:24,2365527,549296599,212085,276106234,2153442,273190365,6,155654,188268268,155532,188251780,122,16488,151366,561,212131,30975,6,461,144444.0,43333.0,-68.0,-64.0,-70.0,-70.0,-68.0,-64.0,-69.0,-70.0,-82.0,-89.0,-82.0,-90.0,14.0,25.0,12.0,20.0,1
559,F8:59:71:5A:E0:3D,2231607,392213501,78158,119022470,2153449,273191031,337,54303,75616512,54222,75603931,81,12581,53992,33,78154,7989,337,39,144444.0,43333.0,-67.0,-71.0,-65.0,-70.0,-67.0,-71.0,-64.0,-70.0,-82.0,-89.0,-82.0,-90.0,15.0,18.0,17.0,20.0,1
560,CC:2F:71:3E:C5:1F,2153532,273200899,81,9666,2153451,273191233,0,382,32146,322,24868,60,7278,90,1,138,7,0,22,144444.0,39000.0,-71.0,-69.0,-66.0,-60.0,-72.0,-72.0,-68.0,-63.0,-82.0,-89.0,-82.0,-90.0,11.0,20.0,16.0,30.0,1
561,CC:2F:71:3F:1F:24,2366267,550325761,212816,277134528,2153451,273191233,6,155856,188483499,155734,188467011,122,16488,151568,561,212854,31020,6,461,144444.0,43333.0,-70.0,-64.0,-70.0,-70.0,-69.0,-64.0,-70.0,-70.0,-82.0,-89.0,-82.0,-90.0,12.0,25.0,12.0,20.0,1
562,F8:59:71:5A:E0:3D,2231761,392444431,78310,119253198,2153451,273191233,337,54398,75728534,54317,75715953,81,12581,54087,33,78306,7989,337,39,144444.0,43333.0,-67.0,-71.0,-65.0,-71.0,-67.0,-71.0,-65.0,-70.0,-82.0,-89.0,-82.0,-90.0,15.0,18.0,17.0,19.0,1
563,CC:2F:71:3E:C5:1F,2153532,273200899,81,9666,2153451,273191233,0,382,32146,322,24868,60,7278,90,1,138,7,0,22,144444.0,39000.0,-71.0,-69.0,-66.0,-60.0,-72.0,-72.0,-68.0,-63.0,-82.0,-89.0,-82.0,-90.0,11.0,20.0,16.0,30.0,1
564,CC:2F:71:3F:1F:24,2366509,550604400,213058,277413167,2153451,273191233,6,156046,188711048,155924,188694560,122,16488,151758,561,213104,31022,6,461,144444.0,43333.0,-70.0,-64.0,-70.0,-70.0,-69.0,-64.0,-69.0,-70.0,-82.0,-89.0,-82.0,-90.0,12.0,25.0,12.0,20.0,1
565,F8:59:71:5A:E0:3D,2231832,392548953,78377,119357316,2153455,273191637,337,54465,75831714,54384,75819133,81,12581,54154,33,78373,7989,337,39,144444.0,43333.0,-66.0,-71.0,-64.0,-70.0,-66.0,-71.0,-64.0,-70.0,-82.0,-89.0,-82.0,-90.0,16.0,18.0,18.0,20.0,1
566,CC:2F:71:3E:C5:1F,2153540,273201707,81,9666,2153459,273192041,0,382,32146,322,24868,60,7278,90,1,138,7,0,22,144444.0,39000.0,-71.0,-69.0,-66.0,-60.0,-72.0,-72.0,-68.0,-63.0,-82.0,-89.0,-82.0,-90.0,11.0,20.0,16.0,30.0,1
567,CC:2F:71:3F:1F:24,2366677,550811743,213218,277619702,2153459,273192041,6,156190,188906863,156068,188890375,122,16488,151902,561,213264,31022,6,461,144444.0,43333.0,-68.0,-64.0,-71.0,-70.0,-69.0,-64.0,-70.0,-70.0,-82.0,-89.0,-82.0,-90.0,14.0,25.0,11.0,20.0,1
568,F8:59:71:5A:E0:3D,2231899,392645765,78439,119453664,2153460,273192101,337,54527,75927194,54446,75914613,81,12581,54216,33,78435,7989,337,39,144444.0,43333.0,-67.0,-72.0,-65.0,-70.0,-66.0,-71.0,-65.0,-70.0,-82.0,-89.0,-82.0,-90.0,15.0,17.0,17.0,20.0,1
569,CC:2F:71:3E:C5:1F,2153541,273201767,81,9666,2153460,273192101,0,382,32146,322,24868,60,7278,90,1,138,7,0,22,144444.0,39000.0,-71.0,-69.0,-66.0,-60.0,-72.0,-72.0,-68.0,-63.0,-82.0,-89.0,-82.0,-90.0,11.0,20.0,16.0,30.0,1
570,CC:2F:71:3F:1F:24,2366841,551018402,213381,277826301,2153460,273192101,6,156338,189102213,156216,189085725,122,16488,152050,561,213427,31022,6,461,144444.0,43333.0,-70.0,-64.0,-70.0,-71.0,-70.0,-64.0,-69.0,-70.0,-82.0,-89.0,-82.0,-90.0,12.0,25.0,12.0,19.0,1
571,F8:59:71:5A:E0:3D,2231966,392744071,78502,119551566,2153464,273192505,337,54590,76024214,54509,76011633,81,12581,54279,33,78498,7989,337,39,144444.0,43333.0,-67.0,-71.0,-65.0,-71.0,-66.0,-71.0,-64.0,-70.0,-82.0,-89.0,-82.0,-90.0,15.0,18.0,17.0,19.0,1
572,CC:2F:71:3E:C5:1F,2153545,273202171,81,9666,2153464,273192505,0,382,32146,322,24868,60,7278,90,1,138,7,0,22,144444.0,39000.0,-71.0,-69.0,-66.0,-60.0,-72.0,-72.0,-68.0,-63.0,-82.0,-89.0,-82.0,-90.0,11.0,20.0,16.0,30.0,1
573,CC:2F:71:3F:1F:24,2367003,551225042,213539,278032537,2153464,273192505,6,156480,189297757,156358,189281269,122,16488,152192,561,213585,31022,6,461,144444.0,43333.0,-70.0,-64.0,-69.0,-70.0,-70.0,-64.0,-69.0,-70.0,-82.0,-89.0,-82.0,-90.0,12.0,25.0,13.0,20.0,1
574,F8:59:71:5A:E0:3D,2232032,392839347,78563,119646360,2153469,273192987,337,54653,76121248,54572,76108667,81,12581,54341,33,78559,7990,337,39,144444.0,43333.0,-67.0,-72.0,-65.0,-71.0,-66.0,-71.0,-65.0,-70.0,-82.0,-89.0,-82.0,-90.0,15.0,17.0,17.0,19.0,1
575,CC:2F:71:3E:C5:1F,2153551,273202713,81,9666,2153470,273193047,0,382,32146,322,24868,60,7278,90,1,138,7,0,22,144444.0,39000.0,-71.0,-69.0,-66.0,-60.0,-72.0,-72.0,-68.0,-63.0,-82.0,-89.0,-82.0,-90.0,11.0,20.0,16.0,30.0,1
576,CC:2F:71:3F:1F:24,2367164,551428582,213694,278235535,2153470,273193047,6,156623,189494869,156501,189478381,122,16488,152335,561,213740,31022,6,462,144444.0,43333.0,-71.0,-64.0,-70.0,-71.0,-70.0,-64.0,-69.0,-70.0,-82.0,-89.0,-82.0,-90.0,11.0,25.0,12.0,19.0,1
577,F8:59:71:5A:E0:3D,2232103,392940937,78629,119747486,2153474,273193451,337,54720,76223008,54639,76210427,81,12581,54407,33,78625,7990,337,39,144444.0,43333.0,-67.0,-71.0,-64.0,-70.0,-66.0,-71.0,-64.0,-70.0,-82.0,-89.0,-82.0,-90.0,15.0,18.0,18.0,20.0,1
578,CC:2F:71:3E:C5:1F,2153555,273203117,81,9666,2153474,273193451,0,384,32286,324,25008,60,7278,90,1,139,7,0,22,144444.0,39000.0,-70.0,-68.0,-66.0,-60.0,-71.0,-70.0,-67.0,-61.0,-82.0,-89.0,-82.0,-90.0,12.0,21.0,16.0,30.0,1
579,CC:2F:71:3F:1F:24,2367333,551640376,213859,278446925,2153474,273193451,6,156772,189695505,156650,189679017,122,16488,152484,561,213905,31022,6,462,144444.0,43333.0,-71.0,-64.0,-70.0,-70.0,-70.0,-63.0,-69.0,-70.0,-82.0,-89.0,-82.0,-90.0,11.0,25.0,12.0,20.0,1
580,F8:59:71:5A:E0:3D,2232171,393039191,78693,119845336,2153478,273193855,337,54783,76320028,54702,76307447,81,12581,54470,33,78689,7990,337,39,144444.0,43333.0,-67.0,-71.0,-65.0,-70.0,-66.0,-71.0,-65.0,-70.0,-82.0,-89.0,-82.0,-90.0,15.0,18.0,17.0,20.0,1
581,CC:2F:71:3E:C5:1F,2153560,273203637,82,9782,2153478,273193855,0,386,32426,326,25148,60,7278,90,1,140,7,0,22,144444.0,39000.0,-71.0,-69.0,-66.0,-60.0,-71.0,-70.0,-67.0,-61.0,-82.0,-89.0,-82.0,-90.0,11.0,20.0,16.0,30.0,1
582,CC:2F:71:3F:1F:24,2367496,551845836,214018,278651981,2153478,273193855,6,156917,189892833,156795,189876345,122,16488,152629,561,214064,31023,6,462,144444.0,43333.0,-70.0,-64.0,-68.0,-70.0,-70.0,-63.0,-69.0,-70.0,-82.0,-89.0,-82.0,-90.0,12.0,25.0,14.0,20.0,1
583,F8:59:71:5A:E0:3D,2232242,393138345,78762,119944157,2153480,273194188,337,54849,76417112,54768,76404531,81,12581,54536,33,78758,7990,337,39,144444.0,43333.0,-66.0,-71.0,-65.0,-71.0,-66.0,-71.0,-64.0,-70.0,-82.0,-89.0,-82.0,-90.0,16.0,18.0,17.0,19.0,1
584,CC:2F:71:3E:C5:1F,2153563,273204104,82,9782,2153481,273194322,0,386,32426,326,25148,60,7278,90,1,140,7,0,22,144444.0,39000.0,-71.0,-69.0,-66.0,-60.0,-71.0,-70.0,-67.0,-61.0,-82.0,-89.0,-82.0,-90.0,11.0,20.0,16.0,30.0,1
585,CC:2F:71:3F:1F:24,2367690,552060504,214206,278865912,2153484,273194592,6,157079,190098121,156957,190081633,122,16488,152791,561,214252,31025,6,462,144444.0,43333.0,-71.0,-64.0,-70.0,-70.0,-70.0,-63.0,-69.0,-70.0,-82.0,-89.0,-82.0,-90.0,11.0,25.0,12.0,20.0,1
586,F8:59:71:5A:E0:3D,2232598,393678387,79110,120483225,2153488,273195162,337,54957,76526006,54876,76513425,81,12581,54644,33,79106,7990,337,39,144444.0,43333.0,-66.0,-71.0,-65.0,-71.0,-66.0,-71.0,-64.0,-70.0,-82.0,-89.0,-82.0,-90.0,16.0,18.0,17.0,19.0,1
587,CC:2F:71:3E:C5:1F,2153570,273204944,82,9782,2153488,273195162,0,386,32426,326,25148,60,7278,90,1,140,7,0,22,144444.0,39000.0,-71.0,-69.0,-66.0,-60.0,-71.0,-70.0,-67.0,-61.0,-82.0,-89.0,-82.0,-90.0,11.0,20.0,16.0,30.0,1
588,CC:2F:71:3F:1F:24,2367860,552268007,214370,279072643,2153490,273195364,6,157231,190295373,157109,190278885,122,16488,152943,561,214416,31025,6,462,144444.0,43333.0,-70.0,-64.0,-70.0,-70.0,-68.0,-64.0,-70.0,-70.0,-82.0,-89.0,-82.0,-90.0,12.0,25.0,12.0,20.0,1
589,F8:59:71:5A:E0:3D,2232663,393776491,79173,120581127,2153490,273195364,337,55019,76621486,54938,76608905,81,12581,54706,33,79169,7991,337,39,144444.0,43333.0,-66.0,-71.0,-65.0,-70.0,-66.0,-71.0,-64.0,-70.0,-82.0,-89.0,-82.0,-90.0,16.0,18.0,17.0,20.0,1
590,CC:2F:71:3E:C5:1F,2153572,273205146,82,9782,2153490,273195364,0,386,32426,326,25148,60,7278,90,1,140,7,0,22,144444.0,39000.0,-71.0,-69.0,-66.0,-60.0,-71.0,-70.0,-67.0,-61.0,-82.0,-89.0,-82.0,-90.0,11.0,20.0,16.0,30.0,1
591,CC:2F:71:3F:1F:24,2368563,553241460,215073,280046096,2153490,273195364,6,157448,190505741,157326,190489253,122,16488,153160,561,215119,31084,6,462,144444.0,43333.0,-72.0,-64.0,-70.0,-70.0,-70.0,-64.0,-69.0,-70.0,-82.0,-89.0,-82.0,-90.0,10.0,25.0,12.0,20.0,1
592,F8:59:71:5A:E0:3D,2232733,393873567,79235,120677475,2153498,273196092,337,55082,76718506,55001,76705925,81,12581,54769,33,79231,7991,337,39,144444.0,43333.0,-66.0,-71.0,-65.0,-70.0,-66.0,-71.0,-65.0,-70.0,-82.0,-89.0,-82.0,-90.0,16.0,18.0,17.0,20.0,1
593,CC:2F:71:3E:C5:1F,2153581,273205936,82,9782,2153499,273196154,0,388,32614,327,25218,61,7396,91,1,140,7,0,23,144444.0,39000.0,-71.0,-69.0,-66.0,-60.0,-72.0,-72.0,-68.0,-63.0,-82.0,-89.0,-82.0,-90.0,11.0,20.0,16.0,30.0,1
594,CC:2F:71:3F:1F:24,2368730,553449910,215231,280253756,2153499,273196154,6,157594,190706021,157472,190689533,122,16488,153306,561,215277,31085,6,462,144444.0,43333.0,-67.0,-64.0,-70.0,-70.0,-69.0,-64.0,-69.0,-70.0,-82.0,-89.0,-82.0,-90.0,15.0,25.0,12.0,20.0,1
595,F8:59:71:5A:E0:3D,2232800,393973287,79299,120776931,2153501,273196356,337,55146,76815644,55064,76802945,82,12699,54833,33,79295,7991,337,39,144444.0,43333.0,-66.0,-71.0,-64.0,-70.0,-66.0,-71.0,-64.0,-70.0,-82.0,-89.0,-82.0,-90.0,16.0,18.0,18.0,20.0,1
596,CC:2F:71:3E:C5:1F,2153583,273206138,82,9782,2153501,273196356,0,388,32614,327,25218,61,7396,91,1,140,7,0,23,144444.0,39000.0,-71.0,-69.0,-66.0,-60.0,-72.0,-72.0,-68.0,-63.0,-82.0,-89.0,-82.0,-90.0,11.0,20.0,16.0,30.0,1
597,CC:2F:71:3F:1F:24,2368892,553656686,215391,280460330,2153501,273196356,6,157740,190902163,157618,190885675,122,16488,153452,561,215437,31086,6,463,144444.0,43333.0,-71.0,-64.0,-70.0,-71.0,-70.0,-64.0,-69.0,-70.0,-82.0,-89.0,-82.0,-90.0,11.0,25.0,12.0,19.0,1
598,F8:59:71:5A:E0:3D,2232869,394071795,79362,120874833,2153507,273196962,337,55209,76912664,55127,76899965,82,12699,54896,33,79358,7991,337,39,144444.0,43333.0,-67.0,-72.0,-65.0,-70.0,-67.0,-72.0,-64.0,-70.0,-82.0,-89.0,-82.0,-90.0,15.0,17.0,17.0,20.0,1
599,CC:2F:71:3E:C5:1F,2153589,273206744,82,9782,2153507,273196962,0,388,32614,327,25218,61,7396,91,1,140,7,0,23,144444.0,39000.0,-71.0,-69.0,-66.0,-60.0,-72.0,-72.0,-68.0,-63.0,-82.0,-89.0,-82.0,-90.0,11.0,20.0,16.0,30.0,1
600,CC:2F:71:3F:1F:24,2369061,553864392,215554,280667430,2153507,273196962,6,157887,191101356,157765,191084868,122,16488,153599,561,215600,31087,6,464,144444.0,43333.0,-71.0,-64.0,-70.0,-70.0,-69.0,-64.0,-70.0,-69.0,-82.0,-89.0,-82.0,-90.0,11.0,25.0,12.0,20.0,1
601,F8:59:71:5A:E0:3D,2232939,394176063,79429,120978839,2153510,273197224,337,55277,77017384,55195,77004685,82,12699,54964,33,79425,7996,337,39,144444.0,43333.0,-67.0,-73.0,-64.0,-70.0,-67.0,-73.0,-64.0,-70.0,-81.0,-87.0,-81.0,-88.0,14.0,14.0,17.0,18.0,1
602,CC:2F:71:3E:C5:1F,2153592,273207006,82,9782,2153510,273197224,0,388,32614,327,25218,61,7396,91,1,140,7,0,23,144444.0,39000.0,-71.0,-69.0,-66.0,-60.0,-72.0,-72.0,-68.0,-63.0,-81.0,-87.0,-81.0,-88.0,10.0,18.0,15.0,28.0,1
603,CC:2F:71:3F:1F:24,2369230,554083322,215720,280886098,2153510,273197224,6,158038,191310970,157916,191294482,122,16488,153750,561,215766,31087,6,465,144444.0,43333.0,-71.0,-64.0,-71.0,-70.0,-69.0,-64.0,-70.0,-70.0,-81.0,-87.0,-81.0,-88.0,10.0,23.0,10.0,18.0,1
604,F8:59:71:5A:E0:3D,2233043,394322384,79527,121124554,2153516,273197830,337,55350,77123484,55268,77110785,82,12699,55037,33,79523,7996,337,39,144444.0,43333.0,-67.0,-73.0,-64.0,-70.0,-66.0,-73.0,-64.0,-70.0,-81.0,-87.0,-81.0,-88.0,14.0,14.0,17.0,18.0,1
605,CC:2F:71:3E:C5:1F,2153598,273207612,82,9782,2153516,273197830,0,388,32614,327,25218,61,7396,91,1,140,7,0,23,144444.0,39000.0,-71.0,-69.0,-66.0,-60.0,-72.0,-72.0,-68.0,-63.0,-81.0,-88.0,-81.0,-89.0,10.0,19.0,15.0,29.0,1
606,CC:2F:71:3F:1F:24,2369414,554316685,215898,281118855,2153516,273197830,6,158204,191531303,158082,191514815,122,16488,153916,561,215944,31087,6,467,144444.0,43333.0,-70.0,-63.0,-71.0,-69.0,-70.0,-63.0,-70.0,-69.0,-81.0,-88.0,-81.0,-89.0,11.0,25.0,10.0,20.0,1
607,F8:59:71:5A:E0:3D,2233229,394601792,79710,121403698,2153519,273198094,337,55451,77244368,55369,77231669,82,12699,55138,33,79706,7996,337,39,144444.0,43333.0,-66.0,-73.0,-64.0,-70.0,-66.0,-73.0,-64.0,-70.0,-81.0,-88.0,-81.0,-89.0,15.0,15.0,17.0,19.0,1
608,CC:2F:71:3E:C5:1F,2153601,273207876,82,9782,2153519,273198094,0,388,32614,327,25218,61,7396,91,1,140,7,0,23,144444.0,39000.0,-71.0,-69.0,-66.0,-60.0,-72.0,-72.0,-68.0,-63.0,-81.0,-88.0,-81.0,-89.0,10.0,19.0,15.0,29.0,1
609,CC:2F:71:3F:1F:24,2369582,554534063,216063,281335969,2153519,273198094,6,158357,191740941,158234,191724335,123,16606,154069,561,216109,31087,6,467,144444.0,43333.0,-71.0,-64.0,-70.0,-69.0,-70.0,-63.0,-69.0,-69.0,-81.0,-88.0,-81.0,-89.0,10.0,24.0,11.0,20.0,1
610,F8:59:71:5A:E0:3D,2233301,394703468,79775,121504708,2153526,273198760,337,55515,77342928,55433,77330229,82,12699,55202,33,79771,7996,337,39,144444.0,43333.0,-67.0,-74.0,-65.0,-69.0,-67.0,-72.0,-65.0,-70.0,-81.0,-88.0,-81.0,-89.0,14.0,14.0,16.0,20.0,1
611,CC:2F:71:3E:C5:1F,2153608,273208542,82,9782,2153526,273198760,0,388,32614,327,25218,61,7396,91,1,140,7,0,23,144444.0,39000.0,-71.0,-69.0,-66.0,-60.0,-72.0,-72.0,-68.0,-63.0,-81.0,-88.0,-81.0,-89.0,10.0,19.0,15.0,29.0,1
612,CC:2F:71:3F:1F:24,2369753,554750289,216227,281551529,2153526,273198760,6,158506,191945911,158383,191929305,123,16606,154218,561,216273,31087,6,470,144444.0,43333.0,-70.0,-64.0,-70.0,-69.0,-69.0,-63.0,-69.0,-68.0,-81.0,-88.0,-81.0,-89.0,11.0,24.0,11.0,20.0,1
613,F8:59:71:5A:E0:3D,2233376,394810129,79848,121611167,2153528,273198962,337,55587,77450592,55505,77437893,82,12699,55274,33,79844,8007,337,39,144444.0,43333.0,-68.0,-72.0,-66.0,-71.0,-67.0,-72.0,-65.0,-70.0,-81.0,-86.0,-81.0,-88.0,13.0,14.0,15.0,17.0,1
614,CC:2F:71:3E:C5:1F,2153610,273208744,82,9782,2153528,273198962,0,388,32614,327,25218,61,7396,91,1,140,7,0,23,144444.0,39000.0,-71.0,-69.0,-66.0,-60.0,-72.0,-72.0,-68.0,-63.0,-81.0,-86.0,-81.0,-88.0,10.0,17.0,15.0,28.0,1
615,CC:2F:71:3F:1F:24,2370328,555546468,216800,282347506,2153528,273198962,6,158725,192176146,158602,192159540,123,16606,154437,561,216846,31350,6,482,144444.0,43333.0,-70.0,-62.0,-71.0,-70.0,-69.0,-62.0,-69.0,-69.0,-81.0,-86.0,-81.0,-88.0,11.0,24.0,10.0,18.0,1
616,F8:59:71:5A:E0:3D,2233676,395261601,80139,122061771,2153537,273199830,337,55785,77737892,55703,77725193,82,12699,55472,33,80135,8007,337,39,144444.0,43333.0,-67.0,-72.0,-66.0,-71.0,-67.0,-72.0,-65.0,-71.0,-81.0,-86.0,-81.0,-88.0,14.0,14.0,15.0,17.0,1
617,CC:2F:71:3E:C5:1F,2153619,273209612,82,9782,2153537,273199830,0,388,32614,327,25218,61,7396,91,1,140,7,0,23,144444.0,39000.0,-71.0,-69.0,-66.0,-60.0,-72.0,-72.0,-68.0,-63.0,-81.0,-86.0,-81.0,-88.0,10.0,17.0,15.0,28.0,1
618,CC:2F:71:3F:1F:24,2370759,556130109,217220,282930077,2153539,273200032,6,159139,192746348,159016,192729742,123,16606,154823,561,217266,31381,6,516,130000.0,43333.0,-73.0,-62.0,-75.0,-69.0,-72.0,-62.0,-75.0,-69.0,-81.0,-86.0,-81.0,-88.0,8.0,24.0,6.0,19.0,1
619,F8:59:71:5A:E0:3D,2233751,395368152,80207,122167443,2153544,273200709,337,55849,77836452,55767,77823753,82,12699,55536,33,80202,8008,337,39,144444.0,43333.0,-67.0,-73.0,-66.0,-71.0,-66.0,-73.0,-65.0,-70.0,-81.0,-86.0,-81.0,-88.0,14.0,13.0,15.0,17.0,1
620,CC:2F:71:3E:C5:1F,2153627,273210551,82,9782,2153545,273200769,0,388,32614,327,25218,61,7396,91,1,140,7,0,23,144444.0,39000.0,-71.0,-69.0,-66.0,-60.0,-72.0,-72.0,-68.0,-63.0,-81.0,-86.0,-81.0,-88.0,10.0,17.0,15.0,28.0,1
621,CC:2F:71:3F:1F:24,2370920,556332440,217375,283131671,2153545,273200769,6,159281,192938957,159158,192922351,123,16606,154963,561,217421,31381,6,516,130000.0,43333.0,-73.0,-63.0,-75.0,-70.0,-73.0,-62.0,-74.0,-69.0,-81.0,-86.0,-81.0,-87.0,8.0,23.0,6.0,17.0,1
622,F8:59:71:5A:E0:3D,2233820,395463995,80273,122263024,2153547,273200971,337,55914,77933220,55832,77920521,82,12699,55601,33,80269,8009,337,39,144444.0,43333.0,-66.0,-73.0,-64.0,-71.0,-66.0,-73.0,-65.0,-71.0,-81.0,-86.0,-81.0,-87.0,15.0,13.0,17.0,16.0,1
623,CC:2F:71:3E:C5:1F,2153629,273210753,82,9782,2153547,273200971,0,388,32614,327,25218,61,7396,91,1,140,7,0,23,144444.0,39000.0,-71.0,-69.0,-66.0,-60.0,-72.0,-72.0,-68.0,-63.0,-81.0,-86.0,-81.0,-87.0,10.0,17.0,15.0,27.0,1
624,CC:2F:71:3F:1F:24,2371491,557124148,217944,283923177,2153547,273200971,6,159487,193156198,159364,193139592,123,16606,155169,561,217990,31401,6,517,130000.0,43333.0,-73.0,-62.0,-73.0,-70.0,-72.0,-62.0,-73.0,-69.0,-81.0,-86.0,-81.0,-87.0,8.0,24.0,8.0,17.0,1
625,F8:59:71:5A:E0:3D,2233892,395567165,80339,122365588,2153553,273201577,337,55979,78033320,55897,78020621,82,12699,55666,33,80335,8009,337,39,144444.0,43333.0,-67.0,-74.0,-65.0,-71.0,-66.0,-73.0,-65.0,-71.0,-81.0,-86.0,-81.0,-87.0,14.0,12.0,16.0,16.0,1
626,CC:2F:71:3E:C5:1F,2153635,273211359,82,9782,2153553,273201577,0,388,32614,327,25218,61,7396,91,1,140,7,0,23,144444.0,39000.0,-71.0,-69.0,-66.0,-60.0,-72.0,-72.0,-68.0,-63.0,-81.0,-86.0,-81.0,-87.0,10.0,17.0,15.0,27.0,1
627,CC:2F:71:3F:1F:24,2371661,557330280,218108,284128703,2153553,273201577,6,159634,193353964,159511,193337358,123,16606,155316,561,218154,31412,6,517,130000.0,43333.0,-73.0,-62.0,-73.0,-69.0,-72.0,-62.0,-73.0,-69.0,-81.0,-86.0,-81.0,-87.0,8.0,24.0,8.0,18.0,1
628,F8:59:71:5A:E0:3D,2233957,395663775,80401,122461936,2153556,273201839,337,56041,78128800,55959,78116101,82,12699,55728,33,80397,8009,337,39,144444.0,43333.0,-67.0,-73.0,-66.0,-71.0,-66.0,-73.0,-65.0,-70.0,-81.0,-86.0,-81.0,-87.0,14.0,13.0,15.0,16.0,1
629,CC:2F:71:3E:C5:1F,2153638,273211621,82,9782,2153556,273201839,0,388,32614,327,25218,61,7396,91,1,140,7,0,23,144444.0,39000.0,-71.0,-69.0,-66.0,-60.0,-72.0,-72.0,-68.0,-63.0,-81.0,-86.0,-81.0,-87.0,10.0,17.0,15.0,27.0,1
630,CC:2F:71:3F:1F:24,2371820,557535110,218264,284333271,2153556,273201839,6,159778,193551164,159655,193534558,123,16606,155460,561,218310,31413,6,517,130000.0,43333.0,-73.0,-62.0,-74.0,-69.0,-72.0,-62.0,-73.0,-69.0,-81.0,-86.0,-81.0,-87.0,8.0,24.0,7.0,18.0,1
631,F8:59:71:5A:E0:3D,2234338,396251271,80776,123048826,2153562,273202445,337,56170,78238640,56088,78225941,82,12699,55857,33,80772,8022,337,39,144444.0,43333.0,-66.0,-73.0,-65.0,-70.0,-66.0,-73.0,-65.0,-70.0,-81.0,-86.0,-81.0,-87.0,15.0,13.0,16.0,17.0,1
632,CC:2F:71:3E:C5:1F,2153644,273212227,82,9782,2153562,273202445,0,388,32614,327,25218,61,7396,91,1,140,7,0,23,144444.0,39000.0,-71.0,-69.0,-66.0,-60.0,-72.0,-72.0,-68.0,-63.0,-81.0,-86.0,-81.0,-87.0,10.0,17.0,15.0,27.0,1
633,CC:2F:71:3F:1F:24,2371984,557741954,218422,284539509,2153562,273202445,6,159920,193745274,159797,193728668,123,16606,155602,561,218468,31413,6,517,130000.0,43333.0,-72.0,-62.0,-73.0,-69.0,-72.0,-62.0,-73.0,-69.0,-81.0,-86.0,-81.0,-87.0,9.0,24.0,8.0,18.0,1
634,F8:59:71:5A:E0:3D,2234425,396355635,80861,123152988,2153564,273202647,337,56256,78340573,56174,78327874,82,12699,55943,33,80857,8023,337,39,144444.0,43333.0,-66.0,-73.0,-66.0,-71.0,-66.0,-73.0,-65.0,-70.0,-80.0,-85.0,-80.0,-86.0,14.0,12.0,14.0,15.0,1
635,CC:2F:71:3E:C5:1F,2153646,273212429,82,9782,2153564,273202647,0,388,32614,327,25218,61,7396,91,1,140,7,0,23,144444.0,39000.0,-71.0,-69.0,-66.0,-60.0,-72.0,-72.0,-68.0,-63.0,-80.0,-85.0,-80.0,-86.0,9.0,16.0,14.0,26.0,1
636,CC:2F:71:3F:1F:24,2372150,557950093,218586,284747446,2153564,273202647,6,160072,193945449,159949,193928843,123,16606,155753,561,218631,31422,6,519,130000.0,43333.0,-72.0,-62.0,-74.0,-69.0,-71.0,-61.0,-73.0,-69.0,-80.0,-85.0,-80.0,-86.0,8.0,23.0,6.0,17.0,1
637,F8:59:71:5A:E0:3D,2234539,396505397,80968,123302084,2153571,273203313,337,56330,78444052,56248,78431353,82,12699,56017,33,80964,8023,337,39,144444.0,43333.0,-66.0,-73.0,-65.0,-71.0,-66.0,-73.0,-65.0,-71.0,-80.0,-85.0,-80.0,-86.0,14.0,12.0,15.0,15.0,1
638,CC:2F:71:3E:C5:1F,2153653,273213095,82,9782,2153571,273203313,0,388,32614,327,25218,61,7396,91,1,140,7,0,23,144444.0,39000.0,-71.0,-69.0,-66.0,-60.0,-72.0,-72.0,-68.0,-63.0,-80.0,-85.0,-80.0,-86.0,9.0,16.0,14.0,26.0,1
639,CC:2F:71:3F:1F:24,2372314,558152463,218743,284949150,2153571,273203313,6,160219,194141665,160096,194125059,123,16606,155899,561,218789,31432,6,519,130000.0,43333.0,-72.0,-61.0,-74.0,-67.0,-72.0,-61.0,-74.0,-67.0,-80.0,-85.0,-80.0,-86.0,8.0,24.0,6.0,19.0,1
640,F8:59:71:5A:E0:3D,2234604,396603501,81031,123399986,2153573,273203515,337,56393,78541114,56311,78528415,82,12699,56080,33,81027,8023,337,39,144444.0,43333.0,-68.0,-73.0,-66.0,-71.0,-67.0,-72.0,-65.0,-71.0,-80.0,-85.0,-80.0,-86.0,12.0,12.0,14.0,15.0,1
641,CC:2F:71:3E:C5:1F,2153655,273213297,82,9782,2153573,273203515,0,388,32614,327,25218,61,7396,91,1,140,7,0,23,144444.0,39000.0,-71.0,-69.0,-66.0,-60.0,-72.0,-72.0,-68.0,-63.0,-80.0,-85.0,-80.0,-86.0,9.0,16.0,14.0,26.0,1
642,CC:2F:71:3F:1F:24,2372489,558362703,218916,285159188,2153573,273203515,6,160375,194343804,160252,194327198,123,16606,156054,561,218962,31447,6,519,130000.0,43333.0,-71.0,-61.0,-75.0,-68.0,-72.0,-60.0,-76.0,-68.0,-80.0,-85.0,-80.0,-86.0,9.0,24.0,5.0,18.0,1
643,F8:59:71:5A:E0:3D,2234669,396701437,81094,123497720,2153575,273203717,337,56456,78638134,56374,78625435,82,12699,56143,33,81090,8023,337,39,144444.0,43333.0,-67.0,-73.0,-67.0,-71.0,-67.0,-73.0,-66.0,-71.0,-80.0,-84.0,-80.0,-86.0,13.0,11.0,13.0,15.0,1
644,CC:2F:71:3E:C5:1F,2153659,273213701,82,9782,2153577,273203919,0,388,32614,327,25218,61,7396,91,1,140,7,0,23,144444.0,39000.0,-71.0,-69.0,-66.0,-60.0,-72.0,-72.0,-68.0,-63.0,-80.0,-84.0,-80.0,-86.0,9.0,15.0,14.0,26.0,1
645,CC:2F:71:3F:1F:24,2372695,558587291,219118,285383372,2153577,273203919,6,160559,194574009,160436,194557403,123,16606,156235,561,219164,31466,6,524,130000.0,43333.0,-71.0,-61.0,-74.0,-68.0,-70.0,-61.0,-74.0,-68.0,-80.0,-84.0,-80.0,-86.0,9.0,23.0,6.0,18.0,1
646,F8:59:71:5A:E0:3D,2234935,397105642,81353,123901105,2153582,273204537,337,56560,78747674,56478,78734975,82,12699,56247,33,81349,8024,337,39,144444.0,43333.0,-67.0,-74.0,-66.0,-71.0,-66.0,-73.0,-65.0,-70.0,-80.0,-84.0,-80.0,-86.0,13.0,10.0,14.0,15.0,1
647,CC:2F:71:3E:C5:1F,2153664,273214319,82,9782,2153582,273204537,0,388,32614,327,25218,61,7396,91,1,140,7,0,23,144444.0,39000.0,-71.0,-69.0,-66.0,-60.0,-72.0,-72.0,-68.0,-63.0,-80.0,-84.0,-80.0,-86.0,9.0,15.0,14.0,26.0,1
648,CC:2F:71:3F:1F:24,2373341,559475395,219757,286270656,2153584,273204739,6,160781,194792682,160656,194775608,125,17074,156448,561,219803,31537,6,524,130000.0,43333.0,-71.0,-62.0,-74.0,-69.0,-71.0,-61.0,-74.0,-68.0,-80.0,-84.0,-80.0,-86.0,9.0,22.0,6.0,17.0,1
649,F8:59:71:5A:E0:3D,2235001,397203872,81416,123999007,2153585,273204865,337,56622,78843154,56540,78830455,82,12699,56309,33,81412,8024,337,39,144444.0,43333.0,-67.0,-74.0,-65.0,-71.0,-66.0,-73.0,-65.0,-70.0,-80.0,-84.0,-80.0,-86.0,13.0,10.0,15.0,15.0,1
650,CC:2F:71:3E:C5:1F,2153671,273215051,82,9782,2153589,273205269,0,388,32614,327,25218,61,7396,91,1,140,7,0,23,144444.0,39000.0,-71.0,-69.0,-66.0,-60.0,-72.0,-72.0,-68.0,-63.0,-80.0,-84.0,-80.0,-86.0,9.0,15.0,14.0,26.0,1
651,CC:2F:71:3F:1F:24,2373524,559714513,219935,286509244,2153589,273205269,6,160953,195034860,160828,195017786,125,17074,156612,561,219981,31543,6,530,130000.0,39000.0,-72.0,-61.0,-75.0,-68.0,-72.0,-61.0,-75.0,-68.0,-80.0,-84.0,-80.0,-86.0,8.0,23.0,5.0,18.0,1
652,F8:59:71:5A:E0:3D,2235083,397318378,81492,124112907,2153591,273205471,337,56700,78959474,56618,78946775,82,12699,56387,33,81488,8024,337,39,144444.0,43333.0,-67.0,-73.0,-65.0,-71.0,-67.0,-73.0,-65.0,-71.0,-80.0,-84.0,-80.0,-86.0,13.0,11.0,15.0,15.0,1
653,CC:2F:71:3E:C5:1F,2153673,273215253,82,9782,2153591,273205471,0,388,32614,327,25218,61,7396,91,1,140,7,0,23,144444.0,39000.0,-71.0,-69.0,-66.0,-60.0,-72.0,-72.0,-68.0,-63.0,-80.0,-84.0,-80.0,-86.0,9.0,15.0,14.0,26.0,1
654,CC:2F:71:3F:1F:24,2373681,559917673,220090,286712202,2153591,273205471,6,161099,195233928,160974,195216854,125,17074,156752,561,220136,31543,6,530,130000.0,43333.0,-71.0,-61.0,-74.0,-68.0,-71.0,-61.0,-74.0,-68.0,-80.0,-84.0,-80.0,-86.0,9.0,23.0,6.0,18.0,1
655,F8:59:71:5A:E0:3D,2235150,397416658,81556,124210925,2153594,273205733,337,56764,79056600,56682,79043901,82,12699,56451,33,81552,8025,337,39,144444.0,43333.0,-67.0,-74.0,-66.0,-71.0,-67.0,-73.0,-66.0,-70.0,-80.0,-84.0,-80.0,-86.0,13.0,10.0,14.0,15.0,1
656,CC:2F:71:3E:C5:1F,2153676,273215515,82,9782,2153594,273205733,0,390,32754,329,25358,61,7396,91,1,141,7,0,23,144444.0,39000.0,-71.0,-68.0,-66.0,-60.0,-71.0,-70.0,-67.0,-61.0,-80.0,-84.0,-80.0,-86.0,9.0,16.0,14.0,26.0,1
657,CC:2F:71:3F:1F:24,2373842,560121281,220246,286915346,2153596,273205935,6,161252,195440862,161127,195423788,125,17074,156898,561,220292,31543,6,530,130000.0,43333.0,-72.0,-62.0,-75.0,-69.0,-71.0,-61.0,-74.0,-68.0,-80.0,-84.0,-80.0,-86.0,8.0,22.0,5.0,17.0,1
658,F8:59:71:5A:E0:3D,2235221,397515398,81621,124309059,2153600,273206339,337,56828,79153726,56746,79141027,82,12699,56515,33,81617,8025,337,39,144444.0,43333.0,-67.0,-74.0,-65.0,-70.0,-66.0,-73.0,-65.0,-70.0,-80.0,-84.0,-80.0,-86.0,13.0,10.0,15.0,16.0,1
659,CC:2F:71:3E:C5:1F,2153683,273216237,83,9898,2153600,273206339,0,392,32894,331,25498,61,7396,91,1,142,7,0,23,144444.0,39000.0,-72.0,-69.0,-66.0,-60.0,-71.0,-70.0,-67.0,-61.0,-80.0,-84.0,-80.0,-86.0,8.0,15.0,14.0,26.0,1
660,CC:2F:71:3F:1F:24,2374451,560893469,220851,287687130,2153600,273206339,6,161608,195677800,161483,195660726,125,17074,157250,561,220897,31553,6,537,130000.0,43333.0,-72.0,-62.0,-74.0,-69.0,-72.0,-61.0,-74.0,-68.0,-80.0,-84.0,-80.0,-86.0,8.0,22.0,6.0,17.0,1
661,F8:59:71:5A:E0:3D,2235288,397615329,81685,124408515,2153603,273206814,337,56892,79252286,56810,79239587,82,12699,56579,33,81681,8025,337,39,144444.0,43333.0,-67.0,-74.0,-66.0,-71.0,-66.0,-73.0,-65.0,-70.0,-80.0,-84.0,-80.0,-86.0,13.0,10.0,14.0,15.0,1
662,CC:2F:71:3E:C5:1F,2153686,273216712,83,9898,2153603,273206814,0,392,32894,331,25498,61,7396,91,1,142,7,0,23,144444.0,39000.0,-72.0,-69.0,-66.0,-60.0,-71.0,-70.0,-67.0,-61.0,-80.0,-84.0,-80.0,-86.0,8.0,15.0,14.0,26.0,1
663,CC:2F:71:3F:1F:24,2374779,561343873,221173,288136797,2153606,273207076,6,161828,195924849,161703,195907775,125,17074,157467,561,221218,31560,6,537,130000.0,43333.0,-72.0,-62.0,-75.0,-68.0,-72.0,-62.0,-75.0,-68.0,-80.0,-84.0,-80.0,-86.0,8.0,22.0,5.0,18.0,1
664,F8:59:71:5A:E0:3D,2235493,397922413,81883,124714933,2153610,273207480,337,56989,79382172,56907,79369473,82,12699,56675,33,81879,8025,337,39,144444.0,43333.0,-67.0,-73.0,-66.0,-71.0,-66.0,-73.0,-65.0,-70.0,-80.0,-84.0,-80.0,-86.0,13.0,11.0,14.0,15.0,1
665,CC:2F:71:3E:C5:1F,2153693,273217378,83,9898,2153610,273207480,0,392,32894,331,25498,61,7396,91,1,142,7,0,23,144444.0,39000.0,-72.0,-69.0,-66.0,-60.0,-71.0,-70.0,-67.0,-61.0,-80.0,-84.0,-80.0,-86.0,8.0,15.0,14.0,26.0,1
666,CC:2F:71:3F:1F:24,2375138,561810241,221528,288602761,2153610,273207480,6,162076,196156998,161951,196139924,125,17074,157708,561,221574,31588,6,539,115556.0,28889.0,-72.0,-61.0,-72.0,-67.0,-71.0,-61.0,-72.0,-67.0,-80.0,-84.0,-80.0,-86.0,8.0,23.0,8.0,19.0,1
667,F8:59:71:5A:E0:3D,2235570,398027495,81947,124814389,2153623,273213106,337,57052,79479192,56970,79466493,82,12699,56738,33,81943,8025,337,39,144444.0,43333.0,-67.0,-73.0,-65.0,-69.0,-65.0,-72.0,-65.0,-69.0,-79.0,-84.0,-80.0,-85.0,12.0,11.0,15.0,16.0,1
668,CC:2F:71:3E:C5:1F,2153708,273223206,83,9898,2153625,273213308,0,392,32894,331,25498,61,7396,91,1,142,7,0,23,144444.0,39000.0,-72.0,-69.0,-66.0,-60.0,-71.0,-70.0,-67.0,-61.0,-79.0,-84.0,-80.0,-85.0,7.0,15.0,14.0,25.0,1
669,CC:2F:71:3F:1F:24,2375577,562333217,221952,289119909,2153625,273213308,6,162390,196409695,162265,196392621,125,17074,158011,561,221998,31599,6,539,115556.0,28889.0,-71.0,-62.0,-73.0,-69.0,-70.0,-62.0,-72.0,-69.0,-79.0,-84.0,-80.0,-85.0,8.0,22.0,7.0,16.0,1
670,F8:59:71:5A:E0:3D,2235659,398142427,82017,124923169,2153642,273219258,337,57123,79588588,57041,79575889,82,12699,56809,33,82013,8026,337,39,144444.0,43333.0,-66.0,-74.0,-66.0,-69.0,-65.0,-73.0,-65.0,-69.0,-79.0,-84.0,-80.0,-85.0,13.0,10.0,14.0,16.0,1
671,CC:2F:71:3E:C5:1F,2153725,273229156,83,9898,2153642,273219258,0,394,33082,332,25568,62,7514,92,1,142,7,0,23,144444.0,39000.0,-72.0,-69.0,-67.0,-60.0,-71.0,-70.0,-67.0,-61.0,-79.0,-84.0,-80.0,-85.0,7.0,15.0,13.0,25.0,1
672,CC:2F:71:3F:1F:24,2375951,562795574,222309,289576316,2153642,273219258,6,162638,196629544,162513,196612470,125,17074,158251,561,222355,31600,6,542,144444.0,43333.0,-72.0,-62.0,-73.0,-71.0,-71.0,-62.0,-72.0,-71.0,-79.0,-84.0,-80.0,-85.0,7.0,22.0,7.0,14.0,1
673,F8:59:71:5A:E0:3D,2235724,398240531,82080,125021071,2153644,273219460,337,57185,79684068,57103,79671369,82,12699,56871,33,82076,8027,337,39,144444.0,43333.0,-66.0,-74.0,-66.0,-70.0,-65.0,-74.0,-64.0,-70.0,-79.0,-84.0,-80.0,-85.0,13.0,10.0,14.0,15.0,1
674,CC:2F:71:3E:C5:1F,2153727,273229358,83,9898,2153644,273219460,0,394,33082,332,25568,62,7514,92,1,142,7,0,23,144444.0,39000.0,-72.0,-69.0,-67.0,-60.0,-71.0,-70.0,-67.0,-61.0,-79.0,-84.0,-80.0,-85.0,7.0,15.0,13.0,25.0,1
675,CC:2F:71:3F:1F:24,2376607,563651462,222961,290431800,2153646,273219662,6,163021,196876015,162896,196858941,125,17074,158625,561,223006,31610,6,544,144444.0,43333.0,-71.0,-63.0,-74.0,-69.0,-71.0,-63.0,-72.0,-69.0,-79.0,-84.0,-80.0,-85.0,8.0,21.0,6.0,16.0,1
676,F8:59:71:5A:E0:3D,2235799,398346871,82148,125126743,2153651,273220128,337,57254,79788906,57171,79776089,83,12817,56940,33,82144,8031,337,39,144444.0,43333.0,-66.0,-75.0,-66.0,-70.0,-65.0,-74.0,-65.0,-69.0,-79.0,-84.0,-80.0,-85.0,13.0,9.0,14.0,15.0,1
677,CC:2F:71:3E:C5:1F,2153734,273230026,83,9898,2153651,273220128,0,394,33082,332,25568,62,7514,92,1,142,7,0,23,144444.0,39000.0,-72.0,-69.0,-67.0,-60.0,-71.0,-70.0,-67.0,-61.0,-79.0,-84.0,-80.0,-85.0,7.0,15.0,13.0,25.0,1
678,CC:2F:71:3F:1F:24,2376862,563956788,223211,290736660,2153651,273220128,6,163225,197087412,163100,197070338,125,17074,158826,561,223256,31625,6,544,130000.0,43333.0,-72.0,-63.0,-72.0,-69.0,-72.0,-62.0,-72.0,-68.0,-79.0,-84.0,-80.0,-85.0,7.0,21.0,8.0,16.0,1
679,F8:59:71:5A:E0:3D,2236048,398726336,82394,125505946,2153654,273220390,337,57355,79896902,57272,79884085,83,12817,57041,33,82390,8031,337,39,144444.0,43333.0,-66.0,-74.0,-64.0,-69.0,-66.0,-74.0,-65.0,-69.0,-79.0,-84.0,-80.0,-85.0,13.0,10.0,16.0,16.0,1
680,CC:2F:71:3E:C5:1F,2153737,273230288,83,9898,2153654,273220390,0,394,33082,332,25568,62,7514,92,1,142,7,0,23,144444.0,39000.0,-72.0,-69.0,-67.0,-60.0,-71.0,-70.0,-67.0,-61.0,-79.0,-84.0,-80.0,-85.0,7.0,15.0,13.0,25.0,1
681,CC:2F:71:3F:1F:24,2377020,564159896,223366,290939506,2153654,273220390,6,163369,197287516,163244,197270442,125,17074,158966,561,223412,31627,6,544,144444.0,43333.0,-72.0,-62.0,-72.0,-69.0,-72.0,-62.0,-72.0,-69.0,-79.0,-84.0,-80.0,-85.0,7.0,22.0,8.0,16.0,1
682,F8:59:71:5A:E0:3D,2236115,398824642,82457,125603848,2153658,273220794,337,57417,79992382,57334,79979565,83,12817,57103,33,82453,8031,337,39,144444.0,43333.0,-66.0,-74.0,-66.0,-70.0,-65.0,-73.0,-65.0,-69.0,-79.0,-84.0,-80.0,-85.0,13.0,10.0,14.0,15.0,1
683,CC:2F:71:3E:C5:1F,2153743,273230894,83,9898,2153660,273220996,0,394,33082,332,25568,62,7514,92,1,142,7,0,23,144444.0,39000.0,-72.0,-69.0,-67.0,-60.0,-71.0,-70.0,-67.0,-61.0,-79.0,-84.0,-80.0,-85.0,7.0,15.0,13.0,25.0,1
684,CC:2F:71:3F:1F:24,2378018,565550234,224358,292329238,2153660,273220996,6,163621,197509010,163496,197491936,125,17074,159211,561,224404,31723,6,549,144444.0,43333.0,-72.0,-63.0,-72.0,-69.0,-72.0,-62.0,-72.0,-69.0,-79.0,-84.0,-80.0,-85.0,7.0,21.0,8.0,16.0,1
685,F8:59:71:5A:E0:3D,2236196,398934807,82533,125713547,2153663,273221260,337,57498,80109464,57415,80096647,83,12817,57183,33,82529,8031,337,39,144444.0,43333.0,-67.0,-75.0,-63.0,-69.0,-65.0,-74.0,-65.0,-69.0,-79.0,-84.0,-80.0,-85.0,12.0,9.0,17.0,16.0,1
686,CC:2F:71:3E:C5:1F,2153746,273231158,83,9898,2153663,273221260,0,394,33082,332,25568,62,7514,92,1,142,7,0,23,144444.0,39000.0,-72.0,-69.0,-67.0,-60.0,-71.0,-70.0,-67.0,-61.0,-79.0,-84.0,-80.0,-85.0,7.0,15.0,13.0,25.0,1
687,CC:2F:71:3F:1F:24,2378229,565787523,224566,292566263,2153663,273221260,6,163806,197742130,163680,197724938,126,17192,159394,561,224612,31727,6,551,144444.0,43333.0,-72.0,-62.0,-72.0,-69.0,-72.0,-62.0,-72.0,-69.0,-79.0,-84.0,-80.0,-85.0,7.0,22.0,8.0,16.0,1
688,F8:59:71:5A:E0:3D,2236265,399034727,82597,125813003,2153668,273221724,337,57560,80204944,57477,80192127,83,12817,57245,33,82593,8031,337,39,144444.0,43333.0,-66.0,-74.0,-66.0,-69.0,-66.0,-74.0,-65.0,-69.0,-79.0,-83.0,-79.0,-85.0,13.0,9.0,13.0,16.0,1
689,CC:2F:71:3E:C5:1F,2153751,273231622,83,9898,2153668,273221724,0,394,33082,332,25568,62,7514,92,1,142,7,0,23,144444.0,39000.0,-72.0,-69.0,-67.0,-60.0,-71.0,-70.0,-67.0,-61.0,-79.0,-83.0,-79.0,-85.0,7.0,14.0,12.0,25.0,1
690,CC:2F:71:3F:1F:24,2378407,565996914,224739,292775190,2153668,273221724,6,163963,197946021,163837,197928829,126,17192,159549,561,224785,31736,6,551,144444.0,43333.0,-72.0,-62.0,-72.0,-69.0,-72.0,-62.0,-71.0,-69.0,-79.0,-83.0,-79.0,-85.0,7.0,21.0,7.0,16.0,1
691,F8:59:71:5A:E0:3D,2236330,399129925,82658,125907797,2153672,273222128,337,57622,80300424,57539,80287607,83,12817,57307,33,82654,8031,337,39,144444.0,43333.0,-66.0,-75.0,-65.0,-69.0,-66.0,-74.0,-65.0,-69.0,-79.0,-83.0,-79.0,-85.0,13.0,8.0,14.0,16.0,1
692,CC:2F:71:3E:C5:1F,2153755,273232026,83,9898,2153672,273222128,0,394,33082,332,25568,62,7514,92,1,142,7,0,23,144444.0,39000.0,-72.0,-69.0,-67.0,-60.0,-71.0,-70.0,-67.0,-61.0,-79.0,-83.0,-79.0,-85.0,7.0,14.0,12.0,25.0,1
693,CC:2F:71:3F:1F:24,2378576,566214576,224904,292992448,2153672,273222128,6,164116,198154259,163990,198137067,126,17192,159701,561,224949,31739,6,551,144444.0,43333.0,-72.0,-63.0,-72.0,-69.0,-72.0,-63.0,-72.0,-69.0,-79.0,-83.0,-79.0,-85.0,7.0,20.0,7.0,16.0,1
694,F8:59:71:5A:E0:3D,2236401,399234447,82725,126011915,2153676,273222532,337,57689,80403604,57606,80390787,83,12817,57374,33,82721,8034,337,39,144444.0,43333.0,-63.0,-73.0,-65.0,-70.0,-65.0,-74.0,-65.0,-69.0,-79.0,-83.0,-79.0,-85.0,16.0,10.0,14.0,15.0,1
695,CC:2F:71:3E:C5:1F,2153759,273232430,83,9898,2153676,273222532,0,394,33082,332,25568,62,7514,92,1,142,7,0,23,144444.0,39000.0,-72.0,-69.0,-67.0,-60.0,-71.0,-70.0,-67.0,-61.0,-79.0,-83.0,-79.0,-85.0,7.0,14.0,12.0,25.0,1
696,CC:2F:71:3F:1F:24,2378739,566422716,225062,293200124,2153677,273222592,6,164259,198352879,164133,198335687,126,17192,159844,561,225108,31740,6,555,144444.0,43333.0,-72.0,-63.0,-72.0,-70.0,-72.0,-62.0,-72.0,-69.0,-79.0,-83.0,-79.0,-85.0,7.0,20.0,7.0,15.0,1
697,F8:59:71:5A:E0:3D,2236467,399332611,82788,126109817,2153679,273222794,337,57753,80502178,57670,80489361,83,12817,57437,33,82784,8034,337,39,144444.0,43333.0,-66.0,-75.0,-66.0,-69.0,-66.0,-74.0,-65.0,-69.0,-79.0,-83.0,-79.0,-85.0,13.0,8.0,13.0,16.0,1
698,CC:2F:71:3E:C5:1F,2153764,273232894,83,9898,2153681,273222996,0,394,33082,332,25568,62,7514,92,1,142,7,0,23,144444.0,39000.0,-72.0,-69.0,-67.0,-60.0,-71.0,-70.0,-67.0,-61.0,-79.0,-83.0,-79.0,-85.0,7.0,14.0,12.0,25.0,1
699,CC:2F:71:3F:1F:24,2378900,566627818,225219,293404822,2153681,273222996,6,164400,198548307,164274,198531115,126,17192,159985,561,225265,31741,6,555,144444.0,43333.0,-72.0,-62.0,-72.0,-69.0,-71.0,-62.0,-72.0,-69.0,-79.0,-83.0,-79.0,-85.0,7.0,21.0,7.0,16.0,1
700,F8:59:71:5A:E0:3D,2236534,399430917,82851,126207719,2153683,273223198,337,57815,80597658,57732,80584841,83,12817,57499,33,82847,8034,337,39,144444.0,43333.0,-66.0,-73.0,-66.0,-69.0,-66.0,-74.0,-65.0,-69.0,-79.0,-83.0,-79.0,-85.0,13.0,10.0,13.0,16.0,1
701,CC:2F:71:3E:C5:1F,2153766,273233096,83,9898,2153683,273223198,0,394,33082,332,25568,62,7514,92,1,142,7,0,23,144444.0,39000.0,-72.0,-69.0,-67.0,-60.0,-71.0,-70.0,-67.0,-61.0,-79.0,-83.0,-79.0,-85.0,7.0,14.0,12.0,25.0,1
702,CC:2F:71:3F:1F:24,2379058,566831164,225375,293607966,2153683,273223198,6,164541,198742311,164415,198725119,126,17192,160126,561,225421,31742,6,555,144444.0,43333.0,-72.0,-63.0,-72.0,-69.0,-72.0,-63.0,-72.0,-69.0,-79.0,-83.0,-79.0,-85.0,7.0,20.0,7.0,16.0,1
703,F8:59:71:5A:E0:3D,2236767,399773249,83078,126549314,2153689,273223935,337,57924,80720545,57841,80707728,83,12817,57608,33,83074,8055,337,39,144444.0,43333.0,-66.0,-74.0,-65.0,-70.0,-66.0,-74.0,-65.0,-69.0,-79.0,-83.0,-79.0,-85.0,13.0,9.0,14.0,15.0,1
704,CC:2F:71:3E:C5:1F,2153772,273233833,83,9898,2153689,273223935,0,394,33082,332,25568,62,7514,92,1,142,7,0,23,144444.0,39000.0,-72.0,-69.0,-67.0,-60.0,-71.0,-70.0,-67.0,-61.0,-79.0,-83.0,-79.0,-85.0,7.0,14.0,12.0,25.0,1
705,CC:2F:71:3F:1F:24,2379267,567078390,225578,293854455,2153689,273223935,6,164727,198977838,164601,198960646,126,17192,160312,561,225624,31745,6,563,144444.0,43333.0,-72.0,-62.0,-73.0,-69.0,-72.0,-62.0,-72.0,-69.0,-79.0,-83.0,-79.0,-85.0,7.0,21.0,6.0,16.0,1
706,F8:59:71:5A:E0:3D,2236835,399870369,83140,126645662,2153695,273224707,337,57986,80816025,57903,80803208,83,12817,57670,33,83136,8055,337,39,144444.0,43333.0,-65.0,-74.0,-66.0,-69.0,-65.0,-74.0,-65.0,-69.0,-79.0,-83.0,-79.0,-85.0,14.0,9.0,13.0,16.0,1
707,CC:2F:71:3E:C5:1F,2153778,273234605,83,9898,2153695,273224707,0,394,33082,332,25568,62,7514,92,1,142,7,0,23,144444.0,39000.0,-72.0,-69.0,-67.0,-60.0,-71.0,-70.0,-67.0,-61.0,-79.0,-83.0,-79.0,-85.0,7.0,14.0,12.0,25.0,1
708,CC:2F:71:3F:1F:24,2379446,567286824,225751,294062117,2153695,273224707,6,164882,199176847,164756,199159655,126,17192,160467,561,225797,31748,6,563,144444.0,43333.0,-71.0,-63.0,-72.0,-69.0,-71.0,-62.0,-72.0,-68.0,-79.0,-83.0,-79.0,-85.0,8.0,20.0,7.0,16.0,1
709,F8:59:71:5A:E0:3D,2237016,400144621,83317,126919510,2153699,273225111,337,58064,80915185,57981,80902368,83,12817,57748,33,83313,8055,337,39,144444.0,43333.0,-66.0,-74.0,-65.0,-69.0,-65.0,-74.0,-65.0,-69.0,-79.0,-83.0,-79.0,-85.0,13.0,9.0,14.0,16.0,1
710,CC:2F:71:3E:C5:1F,2153782,273235009,83,9898,2153699,273225111,0,394,33082,332,25568,62,7514,92,1,142,7,0,23,144444.0,39000.0,-72.0,-69.0,-67.0,-60.0,-71.0,-70.0,-67.0,-61.0,-79.0,-83.0,-79.0,-85.0,7.0,14.0,12.0,25.0,1
711,CC:2F:71:3F:1F:24,2379605,567488818,225906,294263707,2153699,273225111,6,165025,199371083,164899,199353891,126,17192,160610,561,225952,31757,6,563,144444.0,43333.0,-71.0,-63.0,-72.0,-68.0,-71.0,-62.0,-72.0,-68.0,-79.0,-83.0,-79.0,-85.0,8.0,20.0,7.0,17.0,1
712,F8:59:71:5A:E0:3D,2237111,400284945,83407,127059370,2153704,273225575,337,58154,81053785,58071,81040968,83,12817,57838,33,83403,8056,337,39,144444.0,43333.0,-66.0,-73.0,-65.0,-70.0,-65.0,-73.0,-65.0,-70.0,-79.0,-83.0,-79.0,-85.0,13.0,10.0,14.0,15.0,1
713,CC:2F:71:3E:C5:1F,2153789,273235675,83,9898,2153706,273225777,0,394,33082,332,25568,62,7514,92,1,142,7,0,23,144444.0,39000.0,-72.0,-69.0,-67.0,-60.0,-71.0,-70.0,-67.0,-61.0,-79.0,-83.0,-79.0,-85.0,7.0,14.0,12.0,25.0,1
714,CC:2F:71:3F:1F:24,2380359,568538045,226653,295312268,2153706,273225777,6,165305,199666482,165179,199649290,126,17192,160889,561,226699,31795,6,593,130000.0,43333.0,-71.0,-61.0,-71.0,-68.0,-71.0,-61.0,-71.0,-68.0,-79.0,-83.0,-79.0,-85.0,8.0,22.0,8.0,17.0,1
715,F8:59:71:5A:E0:3D,2237291,400550851,83581,127323748,2153710,273227103,337,58246,81159845,58163,81147028,83,12817,57930,33,83577,8057,337,39,144444.0,43333.0,-67.0,-73.0,-64.0,-71.0,-66.0,-72.0,-64.0,-70.0,-79.0,-83.0,-79.0,-85.0,12.0,10.0,15.0,14.0,1
716,CC:2F:71:3E:C5:1F,2153793,273237001,83,9898,2153710,273227103,0,394,33082,332,25568,62,7514,92,1,142,7,0,23,144444.0,39000.0,-72.0,-69.0,-67.0,-60.0,-71.0,-70.0,-67.0,-61.0,-79.0,-83.0,-79.0,-85.0,7.0,14.0,12.0,25.0,1
717,CC:2F:71:3F:1F:24,2380520,568744069,226810,295516966,2153710,273227103,6,165446,199860486,165320,199843294,126,17192,161030,561,226856,31795,6,593,130000.0,43333.0,-70.0,-62.0,-71.0,-69.0,-69.0,-62.0,-70.0,-68.0,-79.0,-83.0,-79.0,-85.0,9.0,21.0,8.0,16.0,1
718,F8:59:71:5A:E0:3D,2237357,400647603,83643,127420096,2153714,273227507,337,58308,81255325,58225,81242508,83,12817,57992,33,83639,8058,337,39,144444.0,43333.0,-66.0,-72.0,-64.0,-70.0,-66.0,-72.0,-64.0,-70.0,-79.0,-83.0,-79.0,-85.0,13.0,11.0,15.0,15.0,1
719,CC:2F:71:3E:C5:1F,2153797,273237405,83,9898,2153714,273227507,0,394,33082,332,25568,62,7514,92,1,142,7,0,23,144444.0,39000.0,-72.0,-69.0,-67.0,-60.0,-71.0,-70.0,-67.0,-61.0,-79.0,-83.0,-79.0,-85.0,7.0,14.0,12.0,25.0,1
720,CC:2F:71:3F:1F:24,2380684,568948352,226970,295720845,2153714,273227507,6,165590,200054975,165464,200037783,126,17192,161174,561,227016,31795,6,593,130000.0,43333.0,-71.0,-61.0,-73.0,-69.0,-70.0,-61.0,-73.0,-69.0,-79.0,-83.0,-79.0,-85.0,8.0,22.0,6.0,16.0,1
721,F8:59:71:5A:E0:3D,2237426,400745539,83705,127516444,2153721,273229095,337,58370,81350805,58287,81337988,83,12817,58054,33,83701,8058,337,39,144444.0,43333.0,-66.0,-72.0,-65.0,-69.0,-65.0,-72.0,-64.0,-69.0,-78.0,-82.0,-79.0,-84.0,12.0,10.0,14.0,15.0,1
722,CC:2F:71:3E:C5:1F,2153804,273238993,83,9898,2153721,273229095,0,394,33082,332,25568,62,7514,92,1,142,7,0,23,144444.0,39000.0,-72.0,-69.0,-67.0,-60.0,-71.0,-70.0,-67.0,-61.0,-78.0,-82.0,-79.0,-84.0,6.0,13.0,12.0,24.0,1
723,CC:2F:71:3F:1F:24,2380847,569154340,227126,295925245,2153721,273229095,6,165733,200252059,165607,200234867,126,17192,161317,561,227172,31798,6,593,144444.0,43333.0,-69.0,-62.0,-70.0,-68.0,-68.0,-62.0,-69.0,-67.0,-78.0,-82.0,-79.0,-84.0,9.0,20.0,9.0,16.0,1
724,F8:59:71:5A:E0:3D,2237542,400909018,83817,127679519,2153725,273229499,337,58451,81461167,58368,81448350,83,12817,58134,33,83813,8059,337,39,144444.0,43333.0,-66.0,-71.0,-65.0,-70.0,-65.0,-72.0,-64.0,-69.0,-78.0,-82.0,-79.0,-84.0,12.0,11.0,14.0,14.0,1
725,CC:2F:71:3E:C5:1F,2153808,273239397,83,9898,2153725,273229499,0,394,33082,332,25568,62,7514,92,1,142,7,0,23,144444.0,39000.0,-72.0,-69.0,-67.0,-60.0,-71.0,-70.0,-67.0,-61.0,-78.0,-82.0,-79.0,-84.0,6.0,13.0,12.0,24.0,1
726,CC:2F:71:3F:1F:24,2381007,569357888,227282,296128389,2153725,273229499,6,165874,200446063,165748,200428871,126,17192,161458,561,227328,31798,6,593,144444.0,43333.0,-70.0,-61.0,-70.0,-69.0,-70.0,-61.0,-70.0,-68.0,-78.0,-82.0,-79.0,-84.0,8.0,21.0,9.0,15.0,1
727,F8:59:71:5A:E0:3D,2237610,401006894,83879,127775867,2153731,273231027,337,58513,81556675,58430,81543858,83,12817,58196,33,83875,8059,337,39,144444.0,43333.0,-66.0,-72.0,-65.0,-70.0,-66.0,-72.0,-64.0,-69.0,-78.0,-82.0,-79.0,-84.0,12.0,10.0,14.0,14.0,1
728,CC:2F:71:3E:C5:1F,2153814,273240925,83,9898,2153731,273231027,0,394,33082,332,25568,62,7514,92,1,142,7,0,23,144444.0,39000.0,-72.0,-69.0,-67.0,-60.0,-71.0,-70.0,-67.0,-61.0,-78.0,-82.0,-79.0,-84.0,6.0,13.0,12.0,24.0,1
729,CC:2F:71:3F:1F:24,2381181,569571093,227450,296340066,2153731,273231027,6,166027,200644806,165901,200627614,126,17192,161611,561,227496,31798,6,593,144444.0,43333.0,-69.0,-61.0,-68.0,-68.0,-69.0,-61.0,-69.0,-68.0,-78.0,-82.0,-79.0,-84.0,9.0,21.0,11.0,16.0,1
730,F8:59:71:5A:E0:3D,2237683,401111554,83946,127879985,2153737,273231569,337,58581,81661395,58498,81648578,83,12817,58264,33,83942,8059,337,39,144444.0,43333.0,-66.0,-72.0,-65.0,-70.0,-66.0,-71.0,-64.0,-70.0,-79.0,-84.0,-79.0,-85.0,13.0,12.0,14.0,15.0,1
731,CC:2F:71:3E:C5:1F,2153820,273241467,83,9898,2153737,273231569,0,394,33082,332,25568,62,7514,92,1,142,7,0,23,144444.0,39000.0,-72.0,-69.0,-67.0,-60.0,-71.0,-70.0,-67.0,-61.0,-79.0,-84.0,-79.0,-85.0,7.0,15.0,12.0,25.0,1
732,CC:2F:71:3F:1F:24,2381354,569791873,227617,296560304,2153737,273231569,6,166180,200857360,166054,200840168,126,17192,161764,561,227663,31798,6,595,144444.0,43333.0,-70.0,-61.0,-69.0,-69.0,-70.0,-61.0,-69.0,-69.0,-79.0,-84.0,-79.0,-85.0,9.0,23.0,10.0,16.0,1
733,F8:59:71:5A:E0:3D,2237751,401211414,84010,127979441,2153741,273231973,337,58644,81758415,58561,81745598,83,12817,58327,33,84006,8059,337,39,144444.0,43333.0,-66.0,-71.0,-65.0,-70.0,-65.0,-70.0,-64.0,-69.0,-79.0,-84.0,-79.0,-85.0,13.0,13.0,14.0,15.0,1
734,CC:2F:71:3E:C5:1F,2153824,273241871,83,9898,2153741,273231973,0,394,33082,332,25568,62,7514,92,1,142,7,0,23,144444.0,39000.0,-72.0,-69.0,-67.0,-60.0,-71.0,-70.0,-67.0,-61.0,-79.0,-84.0,-79.0,-85.0,7.0,15.0,12.0,25.0,1
735,CC:2F:71:3F:1F:24,2382017,570715606,228276,297483633,2153741,273231973,6,166404,201082321,166278,201065129,126,17192,161988,561,228322,31812,6,595,144444.0,43333.0,-71.0,-61.0,-70.0,-69.0,-70.0,-61.0,-69.0,-68.0,-79.0,-84.0,-79.0,-85.0,8.0,23.0,9.0,16.0,1
736,F8:59:71:5A:E0:3D,2237821,401315794,84077,128083559,2153744,273232235,337,58712,81863135,58629,81850318,83,12817,58395,33,84073,8059,337,39,144444.0,43333.0,-66.0,-71.0,-65.0,-70.0,-66.0,-71.0,-64.0,-70.0,-79.0,-84.0,-79.0,-85.0,13.0,13.0,14.0,15.0,1
737,CC:2F:71:3E:C5:1F,2153829,273242335,83,9898,2153746,273232437,0,395,33152,333,25638,62,7514,92,1,143,7,0,23,144444.0,39000.0,-71.0,-69.0,-66.0,-60.0,-71.0,-68.0,-66.0,-60.0,-79.0,-84.0,-79.0,-85.0,8.0,15.0,13.0,25.0,1
738,CC:2F:71:3F:1F:24,2382180,570920868,228434,297688431,2153746,273232437,6,166548,201276663,166422,201259471,126,17192,162132,561,228480,31812,6,595,144444.0,43333.0,-70.0,-62.0,-69.0,-68.0,-70.0,-61.0,-69.0,-67.0,-79.0,-84.0,-79.0,-85.0,9.0,22.0,10.0,17.0,1
739,F8:59:71:5A:E0:3D,2238039,401648299,84291,128415660,2153748,273232639,337,58809,81967591,58726,81954774,83,12817,58491,33,84287,8059,337,39,144444.0,43333.0,-67.0,-72.0,-65.0,-70.0,-66.0,-71.0,-64.0,-69.0,-79.0,-84.0,-79.0,-85.0,12.0,12.0,14.0,15.0,1
740,CC:2F:71:3E:C5:1F,2153833,273242739,83,9898,2153750,273232841,0,396,33222,334,25708,62,7514,92,1,143,7,0,23,144444.0,39000.0,-70.0,-68.0,-66.0,-60.0,-71.0,-68.0,-66.0,-60.0,-79.0,-84.0,-79.0,-85.0,9.0,16.0,13.0,25.0,1
741,CC:2F:71:3F:1F:24,2382361,571148335,228611,297915494,2153750,273232841,6,166714,201492491,166588,201475299,126,17192,162296,561,228657,31812,6,595,144444.0,43333.0,-69.0,-61.0,-69.0,-68.0,-70.0,-61.0,-70.0,-68.0,-79.0,-84.0,-79.0,-85.0,10.0,23.0,10.0,17.0,1
742,F8:59:71:5A:E0:3D,2238113,401756045,84361,128523002,2153752,273233043,337,58878,82073893,58795,82061076,83,12817,58560,33,84357,8059,337,39,144444.0,43333.0,-66.0,-72.0,-65.0,-70.0,-66.0,-71.0,-64.0,-70.0,-79.0,-85.0,-79.0,-86.0,13.0,13.0,14.0,16.0,1
743,CC:2F:71:3E:C5:1F,2153836,273243057,84,10014,2153752,273233043,0,398,33362,336,25848,62,7514,92,1,144,7,0,23,144444.0,43333.0,-72.0,-69.0,-66.0,-60.0,-71.0,-68.0,-66.0,-60.0,-79.0,-85.0,-79.0,-86.0,7.0,16.0,13.0,26.0,1
744,CC:2F:71:3F:1F:24,2382523,571353710,228768,298120192,2153755,273233518,6,166857,201688059,166731,201670867,126,17192,162437,561,228813,31812,6,595,144444.0,43333.0,-71.0,-62.0,-70.0,-69.0,-70.0,-62.0,-70.0,-68.0,-79.0,-85.0,-79.0,-86.0,8.0,23.0,9.0,17.0,1
745,F8:59:71:5A:E0:3D,2238181,401854612,84425,128621034,2153756,273233578,337,58944,82174509,58861,82161692,83,12817,58626,33,84419,8059,337,39,144444.0,43333.0,-66.0,-72.0,-64.0,-70.0,-65.0,-71.0,-64.0,-70.0,-79.0,-85.0,-79.0,-86.0,13.0,13.0,15.0,16.0,1
746,CC:2F:71:3E:C5:1F,2153840,273243592,84,10014,2153756,273233578,0,398,33362,336,25848,62,7514,92,1,144,7,0,23,144444.0,43333.0,-72.0,-69.0,-66.0,-60.0,-71.0,-68.0,-66.0,-60.0,-79.0,-85.0,-79.0,-86.0,7.0,16.0,13.0,26.0,1
747,CC:2F:71:3F:1F:24,2382696,571575966,228936,298341984,2153760,273233982,6,167014,201906857,166888,201889665,126,17192,162594,561,228982,31813,6,598,144444.0,43333.0,-70.0,-61.0,-70.0,-68.0,-70.0,-61.0,-69.0,-68.0,-79.0,-85.0,-79.0,-86.0,9.0,24.0,9.0,18.0,1
748,F8:59:71:5A:E0:3D,2238371,402144940,84611,128910958,2153760,273233982,337,59026,82282277,58943,82269460,83,12817,58708,33,84607,8059,337,39,144444.0,43333.0,-66.0,-71.0,-64.0,-70.0,-66.0,-71.0,-64.0,-70.0,-79.0,-85.0,-79.0,-86.0,13.0,14.0,15.0,16.0,1
749,CC:2F:71:3E:C5:1F,2153846,273244198,84,10014,2153762,273234184,0,398,33362,336,25848,62,7514,92,1,144,7,0,23,144444.0,43333.0,-72.0,-69.0,-66.0,-60.0,-71.0,-68.0,-66.0,-60.0,-79.0,-85.0,-79.0,-86.0,7.0,16.0,13.0,26.0,1
750,CC:2F:71:3F:1F:24,2382861,571787284,229097,298552898,2153764,273234386,6,167159,202101233,167033,202084041,126,17192,162737,561,229143,31813,6,598,144444.0,43333.0,-71.0,-62.0,-70.0,-69.0,-70.0,-62.0,-69.0,-68.0,-79.0,-85.0,-79.0,-86.0,8.0,23.0,9.0,17.0,1
751,F8:59:71:5A:E0:3D,2238439,402243362,84675,129008976,2153764,273234386,337,59091,82380957,59008,82368140,83,12817,58772,33,84671,8059,337,39,144444.0,43333.0,-66.0,-72.0,-65.0,-70.0,-65.0,-71.0,-64.0,-70.0,-79.0,-85.0,-79.0,-86.0,13.0,13.0,14.0,16.0,1
752,CC:2F:71:3E:C5:1F,2153848,273244400,84,10014,2153764,273234386,0,398,33362,336,25848,62,7514,92,1,144,7,0,23,144444.0,43333.0,-72.0,-69.0,-66.0,-60.0,-71.0,-68.0,-66.0,-60.0,-79.0,-85.0,-79.0,-86.0,7.0,16.0,13.0,26.0,1
753,CC:2F:71:3F:1F:24,2383607,572822811,229838,299587961,2153769,273234850,6,167421,202367340,167295,202350148,126,17192,162999,561,229884,31813,6,611,144444.0,43333.0,-70.0,-62.0,-71.0,-69.0,-70.0,-61.0,-70.0,-68.0,-79.0,-85.0,-79.0,-86.0,9.0,23.0,8.0,17.0,1
754,F8:59:71:5A:E0:3D,2238525,402369700,84756,129134850,2153769,273234850,337,59174,82508791,59091,82495974,83,12817,58854,33,84752,8059,337,39,144444.0,43333.0,-66.0,-72.0,-65.0,-70.0,-65.0,-71.0,-64.0,-70.0,-79.0,-85.0,-79.0,-86.0,13.0,13.0,14.0,16.0,1
755,CC:2F:71:3E:C5:1F,2153857,273245268,84,10014,2153773,273235254,0,398,33362,336,25848,62,7514,92,1,144,7,0,23,144444.0,43333.0,-72.0,-69.0,-66.0,-60.0,-71.0,-68.0,-66.0,-60.0,-79.0,-85.0,-79.0,-86.0,7.0,16.0,13.0,26.0,1
756,CC:2F:71:3F:1F:24,2383768,573029337,229995,299794083,2153773,273235254,6,167564,202565848,167438,202548656,126,17192,163142,561,230040,31814,6,611,144444.0,43333.0,-70.0,-62.0,-70.0,-69.0,-70.0,-61.0,-70.0,-68.0,-79.0,-85.0,-79.0,-86.0,9.0,23.0,9.0,17.0,1
757,F8:59:71:5A:E0:3D,2238591,402466452,84818,129231198,2153773,273235254,337,59236,82604271,59153,82591454,83,12817,58916,33,84814,8059,337,39,144444.0,43333.0,-66.0,-71.0,-65.0,-70.0,-66.0,-71.0,-64.0,-69.0,-79.0,-85.0,-79.0,-86.0,13.0,14.0,14.0,16.0,1
758,CC:2F:71:3E:C5:1F,2153857,273245268,84,10014,2153773,273235254,0,398,33362,336,25848,62,7514,92,1,144,7,0,23,144444.0,43333.0,-72.0,-69.0,-66.0,-60.0,-71.0,-68.0,-66.0,-60.0,-79.0,-85.0,-79.0,-86.0,7.0,16.0,13.0,26.0,1
759,CC:2F:71:3F:1F:24,2383930,573234608,230153,299998950,2153777,273235658,6,167713,202763667,167587,202746475,126,17192,163291,561,230199,31814,6,611,144444.0,43333.0,-69.0,-62.0,-69.0,-69.0,-69.0,-61.0,-69.0,-69.0,-79.0,-85.0,-79.0,-86.0,10.0,23.0,10.0,17.0,1
760,F8:59:71:5A:E0:3D,2238658,402564758,84881,129329100,2153777,273235658,337,59298,82699751,59215,82686934,83,12817,58978,33,84877,8059,337,39,144444.0,43333.0,-66.0,-72.0,-65.0,-70.0,-65.0,-71.0,-64.0,-70.0,-79.0,-85.0,-79.0,-86.0,13.0,13.0,14.0,16.0,1
761,CC:2F:71:3E:C5:1F,2153862,273245732,84,10014,2153778,273235718,0,398,33362,336,25848,62,7514,92,1,144,7,0,23,144444.0,43333.0,-72.0,-69.0,-66.0,-60.0,-71.0,-68.0,-66.0,-60.0,-79.0,-85.0,-79.0,-86.0,7.0,16.0,13.0,26.0,1
762,CC:2F:71:3F:1F:24,2384085,573436128,230307,300200410,2153778,273235718,6,167856,202957903,167730,202940711,126,17192,163434,561,230353,31815,6,611,144444.0,43333.0,-71.0,-62.0,-71.0,-69.0,-70.0,-61.0,-70.0,-69.0,-79.0,-85.0,-79.0,-86.0,8.0,23.0,8.0,17.0,1
763,F8:59:71:5A:E0:3D,2238735,402662716,84953,129426594,2153782,273236122,337,59371,82798105,59288,82785288,83,12817,59051,33,84949,8059,337,39,144444.0,43333.0,-63.0,-72.0,-64.0,-70.0,-65.0,-71.0,-64.0,-70.0,-79.0,-85.0,-79.0,-86.0,16.0,13.0,15.0,16.0,1
764,CC:2F:71:3E:C5:1F,2153866,273246136,84,10014,2153782,273236122,0,398,33362,336,25848,62,7514,92,1,144,7,0,23,144444.0,43333.0,-72.0,-69.0,-66.0,-60.0,-71.0,-68.0,-66.0,-60.0,-79.0,-85.0,-79.0,-86.0,7.0,16.0,13.0,26.0,1
765,CC:2F:71:3F:1F:24,2384266,573649243,230484,300413121,2153782,273236122,6,168013,203155859,167887,203138667,126,17192,163591,561,230530,31815,6,611,144444.0,43333.0,-70.0,-61.0,-70.0,-68.0,-69.0,-61.0,-70.0,-68.0,-79.0,-85.0,-79.0,-86.0,9.0,24.0,9.0,18.0,1
766,F8:59:71:5A:E0:3D,2238837,402807267,85051,129570741,2153786,273236526,337,59445,82904793,59362,82891976,83,12817,59125,33,85047,8060,337,39,144444.0,43333.0,-66.0,-72.0,-65.0,-71.0,-65.0,-71.0,-64.0,-70.0,-79.0,-86.0,-79.0,-87.0,13.0,14.0,14.0,16.0,1
767,CC:2F:71:3E:C5:1F,2153870,273246540,84,10014,2153786,273236526,0,398,33362,336,25848,62,7514,92,1,144,7,0,23,144444.0,43333.0,-72.0,-69.0,-66.0,-60.0,-71.0,-68.0,-66.0,-60.0,-79.0,-86.0,-79.0,-87.0,7.0,17.0,13.0,27.0,1
768,CC:2F:71:3F:1F:24,2384439,573859124,230653,300622598,2153786,273236526,6,168166,203357598,168040,203340406,126,17192,163744,561,230699,31815,6,611,144444.0,43333.0,-70.0,-61.0,-70.0,-69.0,-70.0,-62.0,-70.0,-69.0,-79.0,-86.0,-79.0,-87.0,9.0,25.0,9.0,18.0,1
769,F8:59:71:5A:E0:3D,2239221,403360074,85413,130121486,2153808,273238588,337,59778,83378030,59694,83365095,84,12935,59458,33,85409,8060,337,40,144444.0,43333.0,-66.0,-70.0,-64.0,-70.0,-65.0,-71.0,-64.0,-69.0,-79.0,-86.0,-79.0,-87.0,13.0,16.0,15.0,17.0,1
770,CC:2F:71:3E:C5:1F,2153895,273248866,84,10014,2153811,273238852,0,400,33550,337,25918,63,7632,93,1,144,7,0,24,144444.0,43333.0,-69.0,-69.0,-69.0,-67.0,-71.0,-70.0,-67.0,-62.0,-79.0,-86.0,-79.0,-87.0,10.0,17.0,10.0,20.0,1
771,CC:2F:71:3F:1F:24,2385685,575603600,231874,302364748,2153811,273238852,6,168943,204379750,168816,204362440,127,17310,164443,561,231920,31817,6,648,144444.0,43333.0,-70.0,-61.0,-69.0,-69.0,-70.0,-61.0,-69.0,-69.0,-79.0,-86.0,-79.0,-87.0,9.0,25.0,10.0,18.0,1
772,F8:59:71:5A:E0:3D,2239452,403711226,85639,130472172,2153813,273239054,337,59874,83509182,59790,83496247,84,12935,59554,33,85635,8060,337,40,144444.0,43333.0,-66.0,-72.0,-65.0,-70.0,-65.0,-71.0,-64.0,-70.0,-79.0,-86.0,-80.0,-87.0,13.0,14.0,15.0,17.0,1
773,CC:2F:71:3E:C5:1F,2153900,273249543,84,10014,2153816,273239529,0,400,33550,337,25918,63,7632,93,1,144,7,0,24,144444.0,43333.0,-69.0,-69.0,-69.0,-67.0,-71.0,-70.0,-67.0,-62.0,-79.0,-86.0,-80.0,-87.0,10.0,17.0,11.0,20.0,1
774,CC:2F:71:3F:1F:24,2385850,575810828,232034,302571299,2153816,273239529,6,169086,204575449,168959,204558139,127,17310,164586,561,232080,31817,6,648,144444.0,43333.0,-69.0,-61.0,-70.0,-68.0,-69.0,-61.0,-69.0,-68.0,-79.0,-86.0,-80.0,-87.0,10.0,25.0,10.0,19.0,1
775,F8:59:71:5A:E0:3D,2239526,403810652,85707,130570861,2153819,273239791,337,59941,83608875,59857,83595940,84,12935,59621,33,85703,8060,337,40,144444.0,43333.0,-65.0,-71.0,-65.0,-70.0,-65.0,-71.0,-64.0,-70.0,-79.0,-86.0,-80.0,-87.0,14.0,15.0,15.0,17.0,1
776,CC:2F:71:3E:C5:1F,2153903,273249805,84,10014,2153819,273239791,0,400,33550,337,25918,63,7632,93,1,144,7,0,24,144444.0,43333.0,-69.0,-69.0,-69.0,-67.0,-71.0,-70.0,-67.0,-62.0,-79.0,-86.0,-80.0,-87.0,10.0,17.0,11.0,20.0,1
777,CC:2F:71:3F:1F:24,2386009,576015490,232190,302775699,2153819,273239791,6,169230,204771225,169103,204753915,127,17310,164730,561,232236,31817,6,648,144444.0,43333.0,-70.0,-61.0,-69.0,-68.0,-69.0,-61.0,-69.0,-68.0,-79.0,-86.0,-80.0,-87.0,9.0,25.0,11.0,19.0,1
778,F8:59:71:5A:E0:3D,2239591,403908756,85770,130668763,2153821,273239993,337,60003,83704355,59919,83691420,84,12935,59683,33,85766,8060,337,40,144444.0,43333.0,-66.0,-72.0,-65.0,-70.0,-65.0,-71.0,-64.0,-70.0,-79.0,-86.0,-80.0,-87.0,13.0,14.0,15.0,17.0,1
779,CC:2F:71:3E:C5:1F,2153907,273250209,84,10014,2153823,273240195,0,400,33550,337,25918,63,7632,93,1,144,7,0,24,144444.0,43333.0,-69.0,-69.0,-69.0,-67.0,-71.0,-70.0,-67.0,-62.0,-79.0,-86.0,-80.0,-87.0,10.0,17.0,11.0,20.0,1
780,CC:2F:71:3F:1F:24,2386170,576220592,232347,302980397,2153823,273240195,6,169373,204966885,169246,204949575,127,17310,164873,561,232393,31818,6,648,144444.0,43333.0,-69.0,-61.0,-70.0,-69.0,-69.0,-61.0,-69.0,-69.0,-79.0,-86.0,-80.0,-87.0,10.0,25.0,10.0,18.0,1
781,F8:59:71:5A:E0:3D,2239659,404005710,85832,130765111,2153827,273240599,337,60066,83801375,59982,83788440,84,12935,59746,33,85828,8060,337,40,144444.0,43333.0,-66.0,-71.0,-64.0,-71.0,-65.0,-71.0,-64.0,-70.0,-79.0,-86.0,-80.0,-87.0,13.0,15.0,16.0,16.0,1
782,CC:2F:71:3E:C5:1F,2153911,273250613,84,10014,2153827,273240599,0,400,33550,337,25918,63,7632,93,1,144,7,0,24,144444.0,43333.0,-69.0,-69.0,-69.0,-67.0,-71.0,-70.0,-67.0,-62.0,-79.0,-86.0,-80.0,-87.0,10.0,17.0,11.0,20.0,1
783,CC:2F:71:3F:1F:24,2386343,576438357,232516,303197758,2153827,273240599,6,169527,205172853,169400,205155543,127,17310,165027,561,232562,31818,6,648,144444.0,43333.0,-70.0,-61.0,-70.0,-69.0,-69.0,-61.0,-70.0,-68.0,-79.0,-86.0,-80.0,-87.0,9.0,25.0,10.0,18.0,1
784,F8:59:71:5A:E0:3D,2239729,404110090,85899,130869229,2153830,273240861,337,60132,83903015,60048,83890080,84,12935,59812,33,85895,8060,337,40,144444.0,43333.0,-66.0,-71.0,-65.0,-70.0,-65.0,-71.0,-64.0,-70.0,-79.0,-86.0,-80.0,-87.0,13.0,15.0,15.0,17.0,1
785,CC:2F:71:3E:C5:1F,2153914,273250875,84,10014,2153830,273240861,0,400,33550,337,25918,63,7632,93,1,144,7,0,24,144444.0,43333.0,-69.0,-69.0,-69.0,-67.0,-71.0,-70.0,-67.0,-62.0,-79.0,-86.0,-80.0,-87.0,10.0,17.0,11.0,20.0,1
786,CC:2F:71:3F:1F:24,2386931,577234966,233101,303994105,2153830,273240861,6,169745,205393779,169618,205376469,127,17310,165244,561,233147,31835,6,648,144444.0,43333.0,-70.0,-61.0,-70.0,-68.0,-69.0,-61.0,-69.0,-68.0,-79.0,-86.0,-80.0,-87.0,9.0,25.0,10.0,19.0,1
787,F8:59:71:5A:E0:3D,2240073,404641829,86239,131400564,2153834,273241265,337,60261,84018131,60177,84005196,84,12935,59941,33,86235,8060,337,40,144444.0,43333.0,-66.0,-71.0,-65.0,-70.0,-65.0,-71.0,-64.0,-70.0,-79.0,-86.0,-80.0,-87.0,13.0,15.0,15.0,17.0,1
788,CC:2F:71:3E:C5:1F,2153920,273251481,84,10014,2153836,273241467,0,400,33550,337,25918,63,7632,93,1,144,7,0,24,144444.0,43333.0,-69.0,-69.0,-69.0,-67.0,-71.0,-70.0,-67.0,-62.0,-79.0,-86.0,-80.0,-87.0,10.0,17.0,11.0,20.0,1
789,CC:2F:71:3F:1F:24,2387100,577449722,233264,304208255,2153836,273241467,6,169897,205600561,169770,205583251,127,17310,165396,561,233310,31835,6,649,144444.0,43333.0,-69.0,-61.0,-69.0,-69.0,-69.0,-61.0,-69.0,-68.0,-79.0,-86.0,-80.0,-87.0,10.0,25.0,11.0,18.0,1
790,F8:59:71:5A:E0:3D,2240140,404740135,86302,131498466,2153838,273241669,337,60324,84115151,60240,84102216,84,12935,60004,33,86298,8061,337,40,144444.0,43333.0,-62.0,-72.0,-64.0,-71.0,-65.0,-71.0,-64.0,-70.0,-79.0,-86.0,-80.0,-87.0,17.0,14.0,16.0,16.0,1
791,CC:2F:71:3E:C5:1F,2153922,273251683,84,10014,2153838,273241669,0,400,33550,337,25918,63,7632,93,1,144,7,0,24,144444.0,43333.0,-69.0,-69.0,-69.0,-67.0,-71.0,-70.0,-67.0,-62.0,-79.0,-86.0,-80.0,-87.0,10.0,17.0,11.0,20.0,1
792,CC:2F:71:3F:1F:24,2387263,577657962,233425,304416293,2153838,273241669,6,170042,205797857,169915,205780547,127,17310,165541,561,233471,31835,6,649,144444.0,43333.0,-70.0,-62.0,-70.0,-69.0,-70.0,-61.0,-70.0,-69.0,-79.0,-86.0,-80.0,-87.0,9.0,24.0,10.0,18.0,1
793,F8:59:71:5A:E0:3D,2240238,404876185,86395,131634052,2153843,273242133,337,60396,84218277,60312,84205342,84,12935,60076,33,86391,8061,337,40,144444.0,43333.0,-66.0,-72.0,-65.0,-70.0,-65.0,-71.0,-64.0,-70.0,-79.0,-86.0,-80.0,-87.0,13.0,14.0,15.0,17.0,1
794,CC:2F:71:3E:C5:1F,2153927,273252147,84,10014,2153843,273242133,0,400,33550,337,25918,63,7632,93,1,144,7,0,24,144444.0,43333.0,-69.0,-69.0,-69.0,-67.0,-71.0,-70.0,-67.0,-62.0,-79.0,-86.0,-80.0,-87.0,10.0,17.0,11.0,20.0,1
795,CC:2F:71:3F:1F:24,2387430,577863526,233587,304621393,2153843,273242133,6,170196,205993900,170069,205976590,127,17310,165695,561,233633,31836,6,649,144444.0,43333.0,-70.0,-62.0,-70.0,-69.0,-70.0,-61.0,-70.0,-69.0,-79.0,-86.0,-80.0,-87.0,9.0,24.0,10.0,18.0,1
796,F8:59:71:5A:E0:3D,2240458,405212424,86611,131969887,2153847,273242537,337,60491,84321133,60407,84308198,84,12935,60171,33,86607,8061,337,40,144444.0,43333.0,-65.0,-72.0,-64.0,-70.0,-65.0,-71.0,-64.0,-70.0,-79.0,-86.0,-80.0,-87.0,14.0,14.0,16.0,17.0,1
797,CC:2F:71:3E:C5:1F,2153931,273252551,84,10014,2153847,273242537,0,400,33550,337,25918,63,7632,93,1,144,7,0,24,144444.0,43333.0,-69.0,-69.0,-69.0,-67.0,-71.0,-70.0,-67.0,-62.0,-79.0,-86.0,-80.0,-87.0,10.0,17.0,11.0,20.0,1
798,CC:2F:71:3F:1F:24,2387590,578067074,233743,304824537,2153847,273242537,6,170337,206185056,170210,206167746,127,17310,165836,561,233789,31836,6,649,144444.0,43333.0,-70.0,-62.0,-69.0,-69.0,-69.0,-61.0,-69.0,-68.0,-79.0,-86.0,-80.0,-87.0,9.0,24.0,11.0,18.0,1
799,F8:59:71:5A:E0:3D,2240523,405310528,86674,132067789,2153849,273242739,337,60554,84418153,60470,84405218,84,12935,60234,33,86670,8061,337,40,144444.0,43333.0,-66.0,-72.0,-65.0,-70.0,-65.0,-72.0,-64.0,-70.0,-79.0,-86.0,-80.0,-87.0,13.0,14.0,15.0,17.0,1
800,CC:2F:71:3E:C5:1F,2153933,273252753,84,10014,2153849,273242739,0,400,33550,337,25918,63,7632,93,1,144,7,0,24,144444.0,43333.0,-69.0,-69.0,-69.0,-67.0,-71.0,-70.0,-67.0,-62.0,-79.0,-86.0,-80.0,-87.0,10.0,17.0,11.0,20.0,1
801,CC:2F:71:3F:1F:24,2387777,578278595,233925,305035594,2153852,273243001,6,170510,206391119,170383,206373809,127,17310,166009,561,233971,31838,6,649,144444.0,43333.0,-70.0,-62.0,-69.0,-69.0,-70.0,-61.0,-69.0,-68.0,-79.0,-86.0,-80.0,-87.0,9.0,24.0,11.0,18.0,1
802,F8:59:71:5A:E0:3D,2240591,405408894,86737,132165691,2153854,273243203,337,60617,84515173,60533,84502238,84,12935,60297,33,86733,8061,337,40,144444.0,43333.0,-67.0,-72.0,-64.0,-70.0,-66.0,-71.0,-64.0,-70.0,-79.0,-86.0,-80.0,-87.0,12.0,14.0,16.0,17.0,1
803,CC:2F:71:3E:C5:1F,2153940,273253419,84,10014,2153856,273243405,0,400,33550,337,25918,63,7632,93,1,144,7,0,24,144444.0,43333.0,-69.0,-69.0,-69.0,-67.0,-71.0,-70.0,-67.0,-62.0,-79.0,-86.0,-80.0,-87.0,10.0,17.0,11.0,20.0,1
804,CC:2F:71:3F:1F:24,2387959,578504602,234103,305261197,2153856,273243405,6,170668,206598986,170541,206581676,127,17310,166167,561,234149,31839,6,649,144444.0,43333.0,-69.0,-61.0,-69.0,-69.0,-69.0,-61.0,-69.0,-68.0,-79.0,-86.0,-80.0,-87.0,10.0,25.0,11.0,18.0,1
805,F8:59:71:5A:E0:3D,2240660,405510308,86802,132266701,2153858,273243607,337,60681,84613733,60597,84600798,84,12935,60361,33,86798,8062,337,40,144444.0,43333.0,-65.0,-71.0,-65.0,-70.0,-66.0,-71.0,-64.0,-70.0,-79.0,-86.0,-80.0,-87.0,14.0,15.0,15.0,17.0,1
806,CC:2F:71:3E:C5:1F,2153942,273253621,84,10014,2153858,273243607,0,400,33550,337,25918,63,7632,93,1,144,7,0,24,144444.0,43333.0,-69.0,-69.0,-69.0,-67.0,-71.0,-70.0,-67.0,-62.0,-79.0,-86.0,-80.0,-87.0,10.0,17.0,11.0,20.0,1
807,CC:2F:71:3F:1F:24,2388437,579161309,234579,305917702,2153858,273243607,6,170854,206802262,170727,206784952,127,17310,166353,561,234625,31839,6,649,144444.0,43333.0,-70.0,-62.0,-70.0,-69.0,-69.0,-61.0,-69.0,-68.0,-79.0,-86.0,-80.0,-87.0,9.0,24.0,10.0,18.0,1
808,F8:59:71:5A:E0:3D,2240731,405609132,86868,132365061,2153863,273244071,337,60749,84714653,60665,84701718,84,12935,60429,33,86864,8062,337,40,144444.0,43333.0,-66.0,-71.0,-64.0,-70.0,-65.0,-71.0,-64.0,-69.0,-79.0,-86.0,-80.0,-87.0,13.0,15.0,16.0,17.0,1
809,CC:2F:71:3E:C5:1F,2153947,273254085,84,10014,2153863,273244071,0,400,33550,337,25918,63,7632,93,1,144,7,0,24,144444.0,43333.0,-69.0,-69.0,-69.0,-67.0,-71.0,-70.0,-67.0,-62.0,-79.0,-86.0,-80.0,-87.0,10.0,17.0,11.0,20.0,1
810,CC:2F:71:3F:1F:24,2388612,579375365,234747,306131092,2153865,273244273,6,171007,207009272,170880,206991962,127,17310,166506,561,234793,31840,6,649,144444.0,43333.0,-70.0,-61.0,-70.0,-68.0,-69.0,-61.0,-69.0,-68.0,-79.0,-86.0,-80.0,-87.0,9.0,25.0,10.0,19.0,1
811,F8:59:71:5A:E0:3D,2240929,405912883,87064,132668610,2153865,273244273,337,60832,84822965,60748,84810030,84,12935,60510,33,87060,8062,337,40,144444.0,43333.0,-67.0,-72.0,-64.0,-70.0,-65.0,-71.0,-64.0,-69.0,-79.0,-86.0,-80.0,-87.0,12.0,14.0,16.0,17.0,1
812,CC:2F:71:3E:C5:1F,2153951,273254489,84,10014,2153867,273244475,0,402,33690,339,26058,63,7632,93,1,145,7,0,24,144444.0,43333.0,-70.0,-69.0,-66.0,-60.0,-70.0,-70.0,-67.0,-62.0,-79.0,-86.0,-80.0,-87.0,9.0,17.0,14.0,27.0,1
813,CC:2F:71:3F:1F:24,2388777,579581152,234910,306336677,2153867,273244475,6,171152,207203966,171025,207186656,127,17310,166651,561,234956,31846,6,653,144444.0,43333.0,-70.0,-61.0,-70.0,-69.0,-69.0,-61.0,-69.0,-68.0,-79.0,-86.0,-80.0,-87.0,9.0,25.0,10.0,18.0,1
814,F8:59:71:5A:E0:3D,2240999,406011507,87128,132766628,2153871,273244879,337,60894,84918445,60810,84905510,84,12935,60572,33,87124,8062,337,40,144444.0,43333.0,-66.0,-71.0,-65.0,-70.0,-66.0,-71.0,-64.0,-70.0,-79.0,-86.0,-80.0,-87.0,13.0,15.0,15.0,17.0,1
815,CC:2F:71:3E:C5:1F,2153956,273254953,85,10074,2153871,273244879,0,404,33830,341,26198,63,7632,93,1,146,7,0,24,130000.0,39000.0,-75.0,-83.0,-74.0,-72.0,-71.0,-72.0,-68.0,-63.0,-79.0,-86.0,-80.0,-87.0,4.0,3.0,6.0,15.0,1
816,CC:2F:71:3F:1F:24,2388941,579789478,235070,306544599,2153871,273244879,6,171300,207404492,171173,207387182,127,17310,166798,561,235116,31846,6,653,144444.0,43333.0,-70.0,-61.0,-69.0,-68.0,-69.0,-61.0,-69.0,-68.0,-79.0,-86.0,-80.0,-87.0,9.0,25.0,11.0,19.0,1
817,F8:59:71:5A:E0:3D,2241074,406113971,87199,132868557,2153875,273245414,337,60963,85020149,60879,85007214,84,12935,60641,33,87194,8062,337,40,144444.0,43333.0,-66.0,-71.0,-64.0,-70.0,-66.0,-71.0,-64.0,-70.0,-79.0,-86.0,-80.0,-87.0,13.0,15.0,16.0,17.0,1
818,CC:2F:71:3E:C5:1F,2153960,273255488,85,10074,2153875,273245414,0,404,33830,341,26198,63,7632,93,1,146,7,0,24,130000.0,39000.0,-75.0,-83.0,-74.0,-72.0,-71.0,-72.0,-68.0,-63.0,-79.0,-87.0,-80.0,-87.0,4.0,4.0,6.0,15.0,1
819,CC:2F:71:3F:1F:24,2389119,580001629,235244,306756215,2153875,273245414,6,171455,207608439,171328,207591129,127,17310,166953,561,235290,31846,6,653,144444.0,43333.0,-70.0,-62.0,-70.0,-69.0,-69.0,-61.0,-69.0,-68.0,-79.0,-87.0,-80.0,-87.0,9.0,25.0,10.0,18.0,1
820,F8:59:71:5A:E0:3D,2241145,406212847,87262,132966459,2153883,273246388,337,61026,85117169,60942,85104234,84,12935,60704,33,87258,8062,337,40,144444.0,43333.0,-65.0,-71.0,-64.0,-70.0,-66.0,-71.0,-64.0,-70.0,-79.0,-87.0,-80.0,-87.0,14.0,16.0,16.0,17.0,1
821,CC:2F:71:3E:C5:1F,2153968,273256462,85,10074,2153883,273246388,0,404,33830,341,26198,63,7632,93,1,146,7,0,24,130000.0,39000.0,-75.0,-83.0,-74.0,-72.0,-71.0,-72.0,-68.0,-63.0,-79.0,-87.0,-80.0,-87.0,4.0,4.0,6.0,15.0,1
822,CC:2F:71:3F:1F:24,2389307,580217978,235424,306971590,2153883,273246388,6,171620,207814788,171493,207797478,127,17310,167118,561,235470,31846,6,653,144444.0,43333.0,-69.0,-61.0,-70.0,-68.0,-69.0,-61.0,-69.0,-68.0,-79.0,-87.0,-80.0,-87.0,10.0,26.0,10.0,19.0,1
823,F8:59:71:5A:E0:3D,2241210,406310951,87325,133064361,2153885,273246590,337,61089,85214189,61005,85201254,84,12935,60767,33,87321,8062,337,40,144444.0,43333.0,-66.0,-71.0,-65.0,-70.0,-66.0,-71.0,-64.0,-70.0,-79.0,-87.0,-80.0,-87.0,13.0,16.0,15.0,17.0,1
824,CC:2F:71:3E:C5:1F,2153970,273256664,85,10074,2153885,273246590,0,404,33830,341,26198,63,7632,93,1,146,7,0,24,130000.0,39000.0,-75.0,-83.0,-74.0,-72.0,-71.0,-72.0,-68.0,-63.0,-79.0,-87.0,-80.0,-87.0,4.0,4.0,6.0,15.0,1
825,CC:2F:71:3F:1F:24,2389927,581080904,236042,307834314,2153885,273246590,6,171828,208020821,171701,208003511,127,17310,167326,561,236088,31847,6,653,144444.0,43333.0,-70.0,-62.0,-70.0,-69.0,-70.0,-61.0,-70.0,-68.0,-79.0,-87.0,-80.0,-87.0,9.0,25.0,10.0,18.0,1
826,F8:59:71:5A:E0:3D,2241278,406406411,87386,133159155,2153892,273247256,337,61151,85309669,61067,85296734,84,12935,60829,33,87382,8062,337,40,144444.0,43333.0,-66.0,-71.0,-65.0,-70.0,-65.0,-71.0,-64.0,-70.0,-79.0,-87.0,-80.0,-87.0,13.0,16.0,15.0,17.0,1
827,CC:2F:71:3E:C5:1F,2153977,273257330,85,10074,2153892,273247256,0,404,33830,341,26198,63,7632,93,1,146,7,0,24,130000.0,39000.0,-75.0,-83.0,-74.0,-72.0,-71.0,-72.0,-68.0,-63.0,-79.0,-87.0,-80.0,-87.0,4.0,4.0,6.0,15.0,1
828,CC:2F:71:3F:1F:24,2390091,581286268,236199,308039012,2153892,273247256,6,171969,208214825,171842,208197515,127,17310,167467,561,236245,31848,6,653,144444.0,43333.0,-70.0,-61.0,-70.0,-68.0,-70.0,-61.0,-69.0,-68.0,-79.0,-87.0,-80.0,-87.0,9.0,26.0,10.0,19.0,1
829,F8:59:71:5A:E0:3D,2241343,406503023,87448,133255503,2153895,273247520,337,61214,85405267,61129,85392214,85,13053,60892,33,87444,8062,337,40,144444.0,43333.0,-67.0,-72.0,-64.0,-70.0,-66.0,-71.0,-64.0,-70.0,-79.0,-87.0,-80.0,-87.0,12.0,15.0,16.0,17.0,1
830,CC:2F:71:3E:C5:1F,2153981,273257656,85,10074,2153896,273247582,0,405,33948,341,26198,64,7750,94,1,146,7,0,24,130000.0,39000.0,-72.0,-69.0,-66.0,-60.0,-71.0,-72.0,-68.0,-63.0,-79.0,-87.0,-80.0,-87.0,7.0,18.0,14.0,27.0,1
831,CC:2F:71:3F:1F:24,2390249,581488038,236353,308240456,2153896,273247582,6,172107,208405633,171980,208388323,127,17310,167605,561,236398,31848,6,653,144444.0,43333.0,-69.0,-61.0,-69.0,-68.0,-69.0,-61.0,-69.0,-68.0,-79.0,-87.0,-80.0,-87.0,10.0,26.0,11.0,19.0,1
832,F8:59:71:5A:E0:3D,2241599,406898100,87701,133650316,2153898,273247784,337,61307,85509183,61222,85496130,85,13053,60985,33,87697,8062,337,40,144444.0,43333.0,-66.0,-71.0,-64.0,-70.0,-65.0,-71.0,-64.0,-70.0,-79.0,-87.0,-80.0,-87.0,13.0,16.0,16.0,17.0,1
833,CC:2F:71:3E:C5:1F,2153985,273258060,85,10074,2153900,273247986,0,406,34018,342,26268,64,7750,94,1,146,7,0,24,130000.0,39000.0,-71.0,-69.0,-66.0,-60.0,-71.0,-72.0,-68.0,-63.0,-79.0,-87.0,-80.0,-87.0,8.0,18.0,14.0,27.0,1
834,CC:2F:71:3F:1F:24,2390428,581701111,236526,308452923,2153902,273248188,6,172266,208608062,172139,208590752,127,17310,167764,561,236572,31848,6,653,144444.0,43333.0,-70.0,-61.0,-70.0,-68.0,-70.0,-61.0,-70.0,-68.0,-79.0,-87.0,-80.0,-87.0,9.0,26.0,10.0,19.0,1
835,F8:59:71:5A:E0:3D,2241703,407045113,87800,133796865,2153903,273248248,337,61381,85614003,61296,85600950,85,13053,61059,33,87796,8062,337,40,144444.0,39000.0,-66.0,-72.0,-64.0,-70.0,-65.0,-71.0,-64.0,-70.0,-79.0,-87.0,-80.0,-87.0,13.0,15.0,16.0,17.0,1
836,CC:2F:71:3E:C5:1F,2153990,273258524,85,10074,2153905,273248450,0,406,34018,342,26268,64,7750,94,1,146,7,0,24,130000.0,39000.0,-71.0,-69.0,-66.0,-60.0,-71.0,-72.0,-68.0,-63.0,-79.0,-87.0,-80.0,-87.0,8.0,18.0,14.0,27.0,1
837,CC:2F:71:3F:1F:24,2390590,581909179,236685,308660729,2153905,273248450,6,172410,208806686,172283,208789376,127,17310,167908,561,236731,31850,6,653,144444.0,43333.0,-70.0,-62.0,-70.0,-68.0,-70.0,-61.0,-70.0,-68.0,-79.0,-87.0,-80.0,-87.0,9.0,25.0,10.0,19.0,1
838,F8:59:71:5A:E0:3D,2241769,407141809,87862,133893157,2153907,273248652,337,61444,85711023,61359,85697970,85,13053,61122,33,87858,8063,337,40,144444.0,43333.0,-66.0,-71.0,-65.0,-70.0,-66.0,-71.0,-64.0,-70.0,-79.0,-87.0,-80.0,-87.0,13.0,16.0,15.0,17.0,1
839,CC:2F:71:3E:C5:1F,2153992,273258726,85,10074,2153907,273248652,0,406,34018,342,26268,64,7750,94,1,146,7,0,24,130000.0,39000.0,-71.0,-69.0,-66.0,-60.0,-71.0,-72.0,-68.0,-63.0,-79.0,-87.0,-80.0,-87.0,8.0,18.0,14.0,27.0,1
840,CC:2F:71:3F:1F:24,2390764,582117925,236857,308869273,2153907,273248652,6,172561,209004642,172434,208987332,127,17310,168059,561,236903,31850,6,654,144444.0,43333.0,-70.0,-61.0,-70.0,-68.0,-69.0,-61.0,-69.0,-68.0,-79.0,-87.0,-80.0,-87.0,9.0,26.0,10.0,19.0,1
841,F8:59:71:5A:E0:3D,2241839,407240573,87928,133991517,2153911,273249056,337,61511,85810403,61426,85797350,85,13053,61189,33,87924,8063,337,40,144444.0,43333.0,-66.0,-72.0,-65.0,-70.0,-66.0,-71.0,-64.0,-70.0,-79.0,-87.0,-80.0,-87.0,13.0,15.0,15.0,17.0,1
842,CC:2F:71:3E:C5:1F,2153996,273259130,85,10074,2153911,273249056,0,406,34018,342,26268,64,7750,94,1,146,7,0,24,130000.0,39000.0,-71.0,-69.0,-66.0,-60.0,-71.0,-72.0,-68.0,-63.0,-79.0,-87.0,-80.0,-87.0,8.0,18.0,14.0,27.0,1
843,CC:2F:71:3F:1F:24,2390927,582323287,237016,309074231,2153911,273249056,6,172707,209199289,172580,209181979,127,17310,168205,561,237062,31850,6,654,144444.0,43333.0,-70.0,-61.0,-70.0,-68.0,-69.0,-61.0,-69.0,-68.0,-79.0,-87.0,-80.0,-87.0,9.0,26.0,10.0,19.0,1
844,F8:59:71:5A:E0:3D,2241906,407338799,87991,134089419,2153915,273249380,337,61573,85905883,61488,85892830,85,13053,61251,33,87987,8063,337,40,144444.0,43333.0,-66.0,-72.0,-65.0,-70.0,-66.0,-71.0,-64.0,-70.0,-79.0,-87.0,-80.0,-87.0,13.0,15.0,15.0,17.0,1
845,CC:2F:71:3E:C5:1F,2154002,273259656,85,10074,2153917,273249582,0,406,34018,342,26268,64,7750,94,1,146,7,0,24,130000.0,39000.0,-71.0,-69.0,-66.0,-60.0,-71.0,-72.0,-68.0,-63.0,-79.0,-87.0,-80.0,-87.0,8.0,18.0,14.0,27.0,1
846,CC:2F:71:3F:1F:24,2391098,582533368,237181,309283786,2153917,273249582,6,172860,209398026,172732,209380598,128,17428,168358,561,237227,31850,6,654,144444.0,43333.0,-70.0,-61.0,-70.0,-68.0,-69.0,-61.0,-69.0,-68.0,-79.0,-87.0,-80.0,-87.0,9.0,26.0,10.0,19.0,1
847,F8:59:71:5A:E0:3D,2241976,407438861,88055,134188875,2153921,273249986,337,61638,86005983,61553,85992930,85,13053,61316,33,88051,8063,337,40,144444.0,43333.0,-66.0,-72.0,-65.0,-70.0,-65.0,-71.0,-64.0,-70.0,-79.0,-87.0,-80.0,-87.0,13.0,15.0,15.0,17.0,1
848,CC:2F:71:3E:C5:1F,2154006,273260060,85,10074,2153921,273249986,0,406,34018,342,26268,64,7750,94,1,146,7,0,24,130000.0,39000.0,-71.0,-69.0,-66.0,-60.0,-71.0,-72.0,-68.0,-63.0,-79.0,-87.0,-80.0,-87.0,8.0,18.0,14.0,27.0,1
849,CC:2F:71:3F:1F:24,2391261,582741578,237340,309491592,2153921,273249986,6,173005,209598190,172877,209580762,128,17428,168503,561,237386,31850,6,654,144444.0,43333.0,-70.0,-61.0,-69.0,-68.0,-69.0,-61.0,-69.0,-68.0,-79.0,-87.0,-80.0,-87.0,9.0,26.0,11.0,19.0,1
850,F8:59:71:5A:E0:3D,2242040,407535411,88117,134285223,2153923,273250188,337,61700,86101463,61615,86088410,85,13053,61378,33,88113,8063,337,40,144444.0,43333.0,-66.0,-72.0,-65.0,-70.0,-66.0,-71.0,-64.0,-70.0,-79.0,-87.0,-80.0,-87.0,13.0,15.0,15.0,17.0,1
851,CC:2F:71:3E:C5:1F,2154008,273260262,85,10074,2153923,273250188,0,406,34018,342,26268,64,7750,94,1,146,7,0,24,130000.0,39000.0,-71.0,-69.0,-66.0,-60.0,-71.0,-72.0,-68.0,-63.0,-79.0,-87.0,-80.0,-87.0,8.0,18.0,14.0,27.0,1
852,CC:2F:71:3F:1F:24,2391419,582944924,237496,309694736,2153923,273250188,6,173145,209792078,173017,209774650,128,17428,168643,561,237542,31850,6,654,144444.0,43333.0,-70.0,-61.0,-70.0,-69.0,-69.0,-61.0,-69.0,-68.0,-79.0,-87.0,-80.0,-87.0,9.0,26.0,10.0,18.0,1
853,F8:59:71:5A:E0:3D,2242329,407976463,88399,134725609,2153930,273250854,337,61805,86208295,61720,86195242,85,13053,61483,33,88395,8063,337,40,144444.0,43333.0,-66.0,-72.0,-65.0,-70.0,-66.0,-71.0,-64.0,-69.0,-79.0,-87.0,-80.0,-87.0,13.0,15.0,15.0,17.0,1
854,CC:2F:71:3E:C5:1F,2154015,273260928,85,10074,2153930,273250854,0,406,34018,342,26268,64,7750,94,1,146,7,0,24,130000.0,39000.0,-71.0,-69.0,-66.0,-60.0,-71.0,-72.0,-68.0,-63.0,-79.0,-87.0,-80.0,-87.0,8.0,18.0,14.0,27.0,1
855,CC:2F:71:3F:1F:24,2391586,583154950,237656,309904096,2153930,273250854,6,173291,209990934,173163,209973506,128,17428,168789,561,237702,31850,6,654,144444.0,43333.0,-70.0,-61.0,-69.0,-68.0,-70.0,-61.0,-69.0,-68.0,-79.0,-87.0,-80.0,-87.0,9.0,26.0,11.0,19.0,1
856,F8:59:71:5A:E0:3D,2242393,408073013,88461,134821957,2153932,273251056,337,61866,86302235,61781,86289182,85,13053,61544,33,88457,8063,337,40,144444.0,43333.0,-66.0,-72.0,-64.0,-70.0,-64.0,-71.0,-64.0,-70.0,-79.0,-87.0,-80.0,-87.0,13.0,15.0,16.0,17.0,1
857,CC:2F:71:3E:C5:1F,2154017,273261130,85,10074,2153932,273251056,0,406,34018,342,26268,64,7750,94,1,146,7,0,24,130000.0,39000.0,-71.0,-69.0,-66.0,-60.0,-71.0,-72.0,-68.0,-63.0,-79.0,-87.0,-80.0,-87.0,8.0,18.0,14.0,27.0,1
858,CC:2F:71:3F:1F:24,2391741,583355058,237809,310104002,2153932,273251056,6,173430,210183282,173302,210165854,128,17428,168928,561,237855,31850,6,654,144444.0,43333.0,-70.0,-61.0,-70.0,-68.0,-70.0,-61.0,-69.0,-68.0,-79.0,-87.0,-80.0,-87.0,9.0,26.0,10.0,19.0,1
859,F8:59:71:5A:E0:3D,2242593,408376225,88656,135124492,2153937,273251733,337,61951,86413507,61866,86400454,85,13053,61627,33,88652,8064,337,40,144444.0,43333.0,-66.0,-72.0,-64.0,-71.0,-66.0,-71.0,-64.0,-70.0,-79.0,-87.0,-80.0,-87.0,13.0,15.0,16.0,16.0,1
860,CC:2F:71:3E:C5:1F,2154023,273261867,85,10074,2153938,273251793,0,406,34018,342,26268,64,7750,94,1,146,7,0,24,130000.0,39000.0,-71.0,-69.0,-66.0,-60.0,-71.0,-72.0,-68.0,-63.0,-79.0,-87.0,-80.0,-87.0,8.0,18.0,14.0,27.0,1
861,CC:2F:71:3F:1F:24,2392623,584567140,238683,311315145,2153940,273251995,6,173702,210440989,173574,210423561,128,17428,169200,561,238729,31851,6,654,144444.0,43333.0,-69.0,-61.0,-69.0,-68.0,-69.0,-61.0,-69.0,-68.0,-79.0,-87.0,-80.0,-87.0,10.0,26.0,11.0,19.0,1
862,F8:59:71:5A:E0:3D,2242666,408482361,88724,135230164,2153942,273252197,337,62022,86519907,61937,86506854,85,13053,61696,33,88720,8064,337,40,144444.0,43333.0,-67.0,-72.0,-64.0,-70.0,-66.0,-71.0,-64.0,-70.0,-79.0,-87.0,-80.0,-87.0,12.0,15.0,16.0,17.0,1
863,CC:2F:71:3E:C5:1F,2154027,273262271,85,10074,2153942,273252197,0,406,34018,342,26268,64,7750,94,1,146,7,0,24,130000.0,39000.0,-71.0,-69.0,-66.0,-60.0,-71.0,-72.0,-68.0,-63.0,-79.0,-87.0,-80.0,-87.0,8.0,18.0,14.0,27.0,1
864,CC:2F:71:3F:1F:24,2392780,584768932,238838,311516735,2153942,273252197,6,173843,210634993,173715,210617565,128,17428,169341,561,238884,31852,6,654,144444.0,43333.0,-70.0,-61.0,-70.0,-68.0,-69.0,-61.0,-69.0,-68.0,-79.0,-87.0,-80.0,-87.0,9.0,26.0,10.0,19.0,1
865,F8:59:71:5A:E0:3D,2242733,408580667,88787,135328066,2153946,273252601,337,62086,86618467,62001,86605414,85,13053,61760,33,88783,8064,337,40,144444.0,43333.0,-66.0,-71.0,-65.0,-70.0,-66.0,-71.0,-64.0,-70.0,-79.0,-87.0,-80.0,-87.0,13.0,16.0,15.0,17.0,1
866,CC:2F:71:3E:C5:1F,2154031,273262675,85,10074,2153946,273252601,0,406,34018,342,26268,64,7750,94,1,146,7,0,24,130000.0,39000.0,-71.0,-69.0,-66.0,-60.0,-71.0,-72.0,-68.0,-63.0,-79.0,-87.0,-80.0,-87.0,8.0,18.0,14.0,27.0,1
867,CC:2F:71:3F:1F:24,2392943,584975850,238997,311723249,2153946,273252601,6,173990,210832558,173862,210815130,128,17428,169488,561,239043,31853,6,654,144444.0,43333.0,-69.0,-61.0,-69.0,-68.0,-69.0,-61.0,-69.0,-68.0,-79.0,-87.0,-80.0,-87.0,10.0,26.0,11.0,19.0,1
868,F8:59:71:5A:E0:3D,2242802,408677778,88851,135424713,2153951,273253065,337,62149,86712678,62064,86699625,85,13053,61823,33,88846,8064,337,40,144444.0,43333.0,-67.0,-72.0,-64.0,-70.0,-65.0,-71.0,-64.0,-70.0,-79.0,-87.0,-80.0,-87.0,12.0,15.0,16.0,17.0,1
869,CC:2F:71:3E:C5:1F,2154036,273263139,85,10074,2153951,273253065,0,406,34018,342,26268,64,7750,94,1,146,7,0,24,130000.0,39000.0,-71.0,-69.0,-66.0,-60.0,-71.0,-72.0,-68.0,-63.0,-79.0,-87.0,-80.0,-87.0,8.0,18.0,14.0,27.0,1
870,CC:2F:71:3F:1F:24,2393104,585179458,239153,311926393,2153951,273253065,6,174131,211026562,174003,211009134,128,17428,169629,561,239199,31853,6,654,144444.0,43333.0,-70.0,-62.0,-70.0,-69.0,-70.0,-61.0,-70.0,-68.0,-79.0,-87.0,-80.0,-87.0,9.0,25.0,10.0,18.0,1
871,F8:59:71:5A:E0:3D,2243099,409091782,89133,135837243,2153966,273254539,337,62455,87135357,62370,87122304,85,13053,62128,33,89129,8064,337,41,144444.0,43333.0,-66.0,-72.0,-64.0,-70.0,-66.0,-71.0,-64.0,-70.0,-79.0,-87.0,-80.0,-88.0,13.0,15.0,16.0,18.0,1
872,CC:2F:71:3E:C5:1F,2154053,273264815,85,10074,2153968,273254741,0,406,34018,342,26268,64,7750,94,1,146,7,0,24,130000.0,39000.0,-71.0,-69.0,-66.0,-60.0,-71.0,-72.0,-68.0,-63.0,-79.0,-87.0,-80.0,-88.0,8.0,18.0,14.0,28.0,1
873,CC:2F:71:3F:1F:24,2394448,587051439,240478,313796496,2153970,273254943,6,174933,212034531,174805,212017103,128,17428,170348,561,240524,31859,6,699,144444.0,43333.0,-69.0,-61.0,-69.0,-68.0,-69.0,-61.0,-68.0,-67.0,-79.0,-87.0,-80.0,-88.0,10.0,26.0,11.0,20.0,1
874,F8:59:71:5A:E0:3D,2243288,409375276,89315,136120071,2153973,273255205,337,62566,87306297,62481,87293244,85,13053,62239,33,89311,8065,337,41,144444.0,43333.0,-67.0,-72.0,-64.0,-70.0,-66.0,-71.0,-64.0,-70.0,-79.0,-87.0,-80.0,-88.0,12.0,15.0,16.0,18.0,1
875,CC:2F:71:3E:C5:1F,2154060,273265481,85,10074,2153975,273255407,0,406,34018,342,26268,64,7750,94,1,146,7,0,24,130000.0,39000.0,-71.0,-69.0,-66.0,-60.0,-71.0,-72.0,-68.0,-63.0,-79.0,-87.0,-80.0,-88.0,8.0,18.0,14.0,28.0,1
876,CC:2F:71:3F:1F:24,2394619,587265365,240644,314009958,2153975,273255407,6,175085,212236970,174957,212219542,128,17428,170500,561,240690,31859,6,699,144444.0,43333.0,-70.0,-61.0,-69.0,-68.0,-69.0,-61.0,-69.0,-68.0,-79.0,-87.0,-80.0,-88.0,9.0,26.0,11.0,20.0,1
877,F8:59:71:5A:E0:3D,2243358,409476816,89380,136221081,2153978,273255735,337,62630,87404857,62545,87391804,85,13053,62303,33,89376,8065,337,41,144444.0,43333.0,-66.0,-71.0,-64.0,-70.0,-66.0,-71.0,-64.0,-70.0,-79.0,-87.0,-80.0,-88.0,13.0,16.0,16.0,18.0,1
878,CC:2F:71:3E:C5:1F,2154063,273265809,85,10074,2153978,273255735,0,406,34018,342,26268,64,7750,94,1,146,7,0,24,130000.0,39000.0,-71.0,-69.0,-66.0,-60.0,-71.0,-72.0,-68.0,-63.0,-79.0,-87.0,-80.0,-88.0,8.0,18.0,14.0,28.0,1
879,CC:2F:71:3F:1F:24,2394783,587470922,240805,314215187,2153978,273255735,6,175234,212433388,175106,212415960,128,17428,170649,561,240850,31859,6,699,144444.0,43333.0,-69.0,-61.0,-69.0,-68.0,-69.0,-61.0,-69.0,-68.0,-79.0,-87.0,-80.0,-88.0,10.0,26.0,11.0,20.0,1
880,F8:59:71:5A:E0:3D,2243424,409573568,89442,136317429,2153982,273256139,337,62693,87501877,62608,87488824,85,13053,62366,33,89438,8065,337,41,144444.0,43333.0,-66.0,-72.0,-65.0,-70.0,-65.0,-71.0,-64.0,-70.0,-79.0,-87.0,-80.0,-88.0,13.0,15.0,15.0,18.0,1
881,CC:2F:71:3E:C5:1F,2154067,273266213,85,10074,2153982,273256139,0,406,34018,342,26268,64,7750,94,1,146,7,0,24,130000.0,39000.0,-71.0,-69.0,-66.0,-60.0,-71.0,-72.0,-68.0,-63.0,-79.0,-87.0,-80.0,-88.0,8.0,18.0,14.0,28.0,1
882,CC:2F:71:3F:1F:24,2394950,587677941,240968,314421802,2153982,273256139,6,175383,212628812,175255,212611384,128,17428,170798,561,241014,31859,6,699,144444.0,43333.0,-70.0,-61.0,-70.0,-68.0,-69.0,-61.0,-69.0,-68.0,-79.0,-87.0,-80.0,-88.0,9.0,26.0,10.0,20.0,1
883,F8:59:71:5A:E0:3D,2243490,409671732,89505,136415331,2153985,273256401,337,62755,87597357,62670,87584304,85,13053,62428,33,89501,8065,337,41,144444.0,43333.0,-66.0,-72.0,-64.0,-70.0,-65.0,-71.0,-64.0,-70.0,-79.0,-87.0,-80.0,-88.0,13.0,15.0,16.0,18.0,1
884,CC:2F:71:3E:C5:1F,2154071,273266609,85,10074,2153986,273256535,0,407,34088,343,26338,64,7750,94,1,147,7,0,24,130000.0,39000.0,-70.0,-68.0,-66.0,-60.0,-71.0,-70.0,-67.0,-62.0,-79.0,-87.0,-80.0,-88.0,9.0,19.0,14.0,28.0,1
885,CC:2F:71:3F:1F:24,2395114,587886195,241127,314629592,2153987,273256603,6,175530,212829208,175402,212811780,128,17428,170945,561,241173,31859,6,699,144444.0,43333.0,-70.0,-61.0,-70.0,-69.0,-69.0,-61.0,-69.0,-68.0,-79.0,-87.0,-80.0,-88.0,9.0,26.0,10.0,19.0,1
886,F8:59:71:5A:E0:3D,2243739,410047882,89748,136790875,2153991,273257007,337,62861,87705533,62776,87692480,85,13053,62534,33,89744,8065,337,41,144444.0,43333.0,-66.0,-71.0,-65.0,-70.0,-65.0,-71.0,-64.0,-70.0,-79.0,-87.0,-80.0,-88.0,13.0,16.0,15.0,18.0,1
887,CC:2F:71:3E:C5:1F,2154077,273267141,86,10134,2153991,273257007,0,409,34228,345,26478,64,7750,94,1,148,7,0,24,130000.0,39000.0,-72.0,-69.0,-66.0,-60.0,-71.0,-71.0,-67.0,-62.0,-79.0,-87.0,-80.0,-88.0,7.0,18.0,14.0,28.0,1
888,CC:2F:71:3F:1F:24,2395287,588108491,241296,314851484,2153991,273257007,6,175685,213043572,175557,213026144,128,17428,171100,561,241342,31859,6,713,144444.0,43333.0,-68.0,-63.0,-68.0,-69.0,-69.0,-61.0,-69.0,-68.0,-79.0,-87.0,-80.0,-88.0,11.0,24.0,12.0,19.0,1
889,F8:59:71:5A:E0:3D,2243936,410348237,89942,137090755,2153994,273257482,337,62943,87815125,62858,87802072,85,13053,62616,33,89938,8114,337,41,144444.0,43333.0,-66.0,-71.0,-65.0,-70.0,-66.0,-71.0,-64.0,-70.0,-79.0,-87.0,-80.0,-88.0,13.0,16.0,15.0,18.0,1
890,CC:2F:71:3E:C5:1F,2154080,273267616,86,10134,2153994,273257482,0,410,34298,346,26548,64,7750,94,1,148,7,0,24,130000.0,39000.0,-72.0,-69.0,-66.0,-60.0,-72.0,-71.0,-67.0,-62.0,-79.0,-87.0,-80.0,-88.0,7.0,18.0,14.0,28.0,1
891,CC:2F:71:3F:1F:24,2395449,588316688,241454,315059144,2153995,273257544,6,175829,213239348,175701,213221920,128,17428,171244,561,241500,31859,6,713,144444.0,43333.0,-70.0,-61.0,-70.0,-68.0,-70.0,-61.0,-70.0,-68.0,-79.0,-87.0,-80.0,-88.0,9.0,26.0,10.0,20.0,1
892,F8:59:71:5A:E0:3D,2244007,410446755,90005,137188545,2154002,273258210,337,63007,87912263,62921,87899092,86,13171,62680,33,90001,8114,337,41,144444.0,39000.0,-65.0,-71.0,-65.0,-70.0,-65.0,-71.0,-64.0,-69.0,-79.0,-87.0,-80.0,-88.0,14.0,16.0,15.0,18.0,1
893,CC:2F:71:3E:C5:1F,2154088,273268344,86,10134,2154002,273258210,0,410,34298,346,26548,64,7750,94,1,148,7,0,24,130000.0,39000.0,-72.0,-69.0,-66.0,-60.0,-72.0,-71.0,-67.0,-62.0,-79.0,-87.0,-80.0,-88.0,7.0,18.0,14.0,28.0,1
894,CC:2F:71:3F:1F:24,2395647,588534656,241645,315276446,2154002,273258210,6,176004,213446904,175876,213429476,128,17428,171419,561,241691,31859,6,713,144444.0,43333.0,-70.0,-61.0,-70.0,-68.0,-69.0,-61.0,-69.0,-68.0,-79.0,-87.0,-80.0,-88.0,9.0,26.0,10.0,20.0,1
895,F8:59:71:5A:E0:3D,2244072,410544803,90068,137286391,2154004,273258412,337,63069,88007743,62983,87994572,86,13171,62742,33,90064,8114,337,41,144444.0,43333.0,-67.0,-71.0,-64.0,-70.0,-66.0,-71.0,-64.0,-70.0,-79.0,-87.0,-80.0,-88.0,12.0,16.0,16.0,18.0,1
896,CC:2F:71:3E:C5:1F,2154090,273268546,86,10134,2154004,273258412,0,410,34298,346,26548,64,7750,94,1,148,7,0,24,130000.0,39000.0,-72.0,-69.0,-66.0,-60.0,-72.0,-71.0,-67.0,-62.0,-79.0,-87.0,-80.0,-88.0,7.0,18.0,14.0,28.0,1
897,CC:2F:71:3F:1F:24,2395805,588739426,241801,315481014,2154004,273258412,6,176147,213643988,176019,213626560,128,17428,171562,561,241847,31859,6,713,144444.0,43333.0,-70.0,-61.0,-70.0,-68.0,-70.0,-61.0,-69.0,-68.0,-79.0,-87.0,-80.0,-88.0,9.0,26.0,10.0,20.0,1
898,F8:59:71:5A:E0:3D,2244170,410663545,90137,137393617,2154033,273269928,337,63141,88118693,63055,88105522,86,13171,62814,33,90133,8114,337,41,144444.0,43333.0,-67.0,-71.0,-65.0,-70.0,-66.0,-71.0,-64.0,-70.0,-79.0,-87.0,-80.0,-88.0,12.0,16.0,15.0,18.0,1
899,CC:2F:71:3E:C5:1F,2154120,273280122,86,10134,2154034,273269988,0,412,34486,347,26618,65,7868,95,1,148,7,0,24,130000.0,39000.0,-71.0,-69.0,-66.0,-60.0,-71.0,-69.0,-66.0,-61.0,-79.0,-87.0,-80.0,-88.0,8.0,18.0,14.0,28.0,1
900,CC:2F:71:3F:1F:24,2396066,589066368,242030,315796178,2154036,273270190,6,176362,213946370,176234,213928942,128,17428,171777,561,242076,31860,6,721,144444.0,39000.0,-70.0,-61.0,-70.0,-68.0,-69.0,-61.0,-69.0,-68.0,-79.0,-87.0,-80.0,-88.0,9.0,26.0,10.0,20.0,1
901,F8:59:71:5A:E0:3D,2244265,410805337,90229,137535147,2154036,273270190,337,63233,88258967,63147,88245796,86,13171,62904,33,90225,8115,337,41,144444.0,43333.0,-66.0,-71.0,-65.0,-70.0,-65.0,-70.0,-64.0,-69.0,-79.0,-87.0,-80.0,-88.0,13.0,16.0,15.0,18.0,1
902,CC:2F:71:3E:C5:1F,2154122,273280324,86,10134,2154036,273270190,0,412,34486,347,26618,65,7868,95,1,148,7,0,24,130000.0,39000.0,-71.0,-69.0,-66.0,-60.0,-71.0,-69.0,-66.0,-61.0,-79.0,-87.0,-80.0,-88.0,8.0,18.0,14.0,28.0,1
903,CC:2F:71:3F:1F:24,2396680,589900868,242642,316630476,2154038,273270392,6,176575,214156665,176447,214139237,128,17428,171990,561,242688,31876,6,721,144444.0,43333.0,-70.0,-61.0,-70.0,-69.0,-69.0,-61.0,-69.0,-69.0,-79.0,-87.0,-80.0,-88.0,9.0,26.0,10.0,19.0,1
904,F8:59:71:5A:E0:3D,2244333,410902291,90291,137631495,2154042,273270796,337,63294,88352907,63208,88339736,86,13171,62965,33,90287,8115,337,41,144444.0,43333.0,-63.0,-71.0,-64.0,-70.0,-65.0,-70.0,-64.0,-69.0,-79.0,-87.0,-80.0,-88.0,16.0,16.0,16.0,18.0,1
905,CC:2F:71:3E:C5:1F,2154128,273280930,86,10134,2154042,273270796,0,412,34486,347,26618,65,7868,95,1,148,7,0,24,130000.0,39000.0,-71.0,-69.0,-66.0,-60.0,-71.0,-69.0,-66.0,-61.0,-79.0,-87.0,-80.0,-88.0,8.0,18.0,14.0,28.0,1
906,CC:2F:71:3F:1F:24,2396850,590109703,242808,316838907,2154042,273270796,6,176729,214355580,176601,214338152,128,17428,172144,561,242854,31876,6,721,144444.0,43333.0,-70.0,-61.0,-69.0,-69.0,-69.0,-61.0,-69.0,-69.0,-79.0,-87.0,-80.0,-88.0,9.0,26.0,11.0,19.0,1
907,F8:59:71:5A:E0:3D,2244398,410998901,90353,137727843,2154045,273271058,337,63358,88451481,63272,88438310,86,13171,63028,33,90349,8115,337,41,144444.0,43333.0,-66.0,-71.0,-64.0,-70.0,-65.0,-71.0,-64.0,-70.0,-79.0,-87.0,-80.0,-88.0,13.0,16.0,16.0,18.0,1
908,CC:2F:71:3E:C5:1F,2154131,273281192,86,10134,2154045,273271058,0,412,34486,347,26618,65,7868,95,1,148,7,0,24,130000.0,39000.0,-71.0,-69.0,-66.0,-60.0,-71.0,-69.0,-66.0,-61.0,-79.0,-87.0,-80.0,-88.0,8.0,18.0,14.0,28.0,1
909,CC:2F:71:3F:1F:24,2397023,590319347,242978,317048289,2154045,273271058,6,176887,214552745,176759,214535317,128,17428,172302,561,243024,31876,6,721,144444.0,43333.0,-69.0,-61.0,-69.0,-69.0,-69.0,-61.0,-68.0,-69.0,-79.0,-87.0,-80.0,-88.0,10.0,26.0,11.0,19.0,1
910,F8:59:71:5A:E0:3D,2244577,411257088,90527,137985564,2154050,273271524,337,63452,88564005,63366,88550834,86,13171,63122,33,90523,8138,337,41,144444.0,43333.0,-66.0,-71.0,-65.0,-70.0,-65.0,-71.0,-64.0,-70.0,-79.0,-87.0,-80.0,-88.0,13.0,16.0,15.0,18.0,1
911,CC:2F:71:3E:C5:1F,2154138,273281860,86,10134,2154052,273271726,0,412,34486,347,26618,65,7868,95,1,148,7,0,24,130000.0,39000.0,-71.0,-69.0,-66.0,-60.0,-71.0,-69.0,-66.0,-61.0,-79.0,-87.0,-80.0,-88.0,8.0,18.0,14.0,28.0,1
912,CC:2F:71:3F:1F:24,2397187,590524713,243135,317252987,2154052,273271726,6,177032,214750063,176903,214732517,129,17546,172447,561,243181,31876,6,721,144444.0,43333.0,-70.0,-61.0,-70.0,-69.0,-69.0,-61.0,-69.0,-69.0,-79.0,-87.0,-80.0,-88.0,9.0,26.0,10.0,19.0,1
913,F8:59:71:5A:E0:3D,2244643,411353840,90589,138081912,2154054,273271928,337,63515,88661025,63429,88647854,86,13171,63185,33,90585,8138,337,41,144444.0,43333.0,-66.0,-71.0,-65.0,-70.0,-65.0,-71.0,-64.0,-70.0,-79.0,-87.0,-79.0,-87.0,13.0,16.0,14.0,17.0,1
914,CC:2F:71:3E:C5:1F,2154140,273282062,86,10134,2154054,273271928,0,412,34486,347,26618,65,7868,95,1,148,7,0,24,130000.0,39000.0,-71.0,-69.0,-66.0,-60.0,-71.0,-69.0,-66.0,-61.0,-79.0,-87.0,-79.0,-87.0,8.0,18.0,13.0,27.0,1
915,CC:2F:71:3F:1F:24,2397344,590726505,243290,317454577,2154054,273271928,6,177170,214940941,177041,214923395,129,17546,172585,561,243336,31876,6,722,144444.0,43333.0,-70.0,-61.0,-69.0,-69.0,-69.0,-61.0,-69.0,-68.0,-79.0,-87.0,-79.0,-87.0,9.0,26.0,10.0,18.0,1
916,F8:59:71:5A:E0:3D,2244710,411450652,90651,138178260,2154059,273272392,337,63577,88756505,63491,88743334,86,13171,63247,33,90647,8138,337,41,144444.0,43333.0,-62.0,-71.0,-64.0,-70.0,-65.0,-71.0,-64.0,-70.0,-79.0,-87.0,-79.0,-87.0,17.0,16.0,15.0,17.0,1
917,CC:2F:71:3E:C5:1F,2154145,273282526,86,10134,2154059,273272392,0,412,34486,347,26618,65,7868,95,1,148,7,0,24,130000.0,39000.0,-71.0,-69.0,-66.0,-60.0,-71.0,-69.0,-66.0,-61.0,-79.0,-87.0,-79.0,-87.0,8.0,18.0,13.0,27.0,1
918,CC:2F:71:3F:1F:24,2397507,590933221,243448,317660829,2154059,273272392,6,177312,215137909,177183,215120363,129,17546,172727,561,243494,31876,6,722,144444.0,43333.0,-70.0,-61.0,-69.0,-69.0,-69.0,-61.0,-69.0,-69.0,-79.0,-87.0,-79.0,-87.0,9.0,26.0,10.0,18.0,1
919,F8:59:71:5A:E0:3D,2244782,411549745,90719,138276949,2154063,273272796,337,63644,88853355,63558,88840184,86,13171,63314,33,90715,8138,337,41,144444.0,43333.0,-66.0,-70.0,-64.0,-70.0,-65.0,-70.0,-64.0,-70.0,-79.0,-87.0,-79.0,-87.0,13.0,17.0,15.0,17.0,1
920,CC:2F:71:3E:C5:1F,2154149,273282930,86,10134,2154063,273272796,0,412,34486,347,26618,65,7868,95,1,148,7,0,24,130000.0,39000.0,-71.0,-69.0,-66.0,-60.0,-71.0,-69.0,-66.0,-61.0,-79.0,-87.0,-79.0,-87.0,8.0,18.0,13.0,27.0,1
921,CC:2F:71:3F:1F:24,2397673,591138686,243610,317865890,2154063,273272796,6,177460,215333217,177331,215315671,129,17546,172875,561,243656,31877,6,722,144444.0,43333.0,-70.0,-61.0,-69.0,-69.0,-69.0,-61.0,-69.0,-68.0,-79.0,-87.0,-79.0,-87.0,9.0,26.0,10.0,18.0,1
922,F8:59:71:5A:E0:3D,2244849,411650957,90784,138377959,2154065,273272998,337,63711,88956549,63625,88943378,86,13171,63380,33,90780,8138,337,41,144444.0,43333.0,-66.0,-71.0,-64.0,-70.0,-65.0,-70.0,-64.0,-70.0,-79.0,-87.0,-80.0,-88.0,13.0,16.0,16.0,18.0,1
923,CC:2F:71:3E:C5:1F,2154151,273283132,86,10134,2154065,273272998,0,412,34486,347,26618,65,7868,95,1,148,7,0,24,130000.0,39000.0,-71.0,-69.0,-66.0,-60.0,-71.0,-69.0,-66.0,-61.0,-79.0,-87.0,-80.0,-88.0,8.0,18.0,14.0,28.0,1
924,CC:2F:71:3F:1F:24,2397854,591357113,243787,318083913,2154067,273273200,6,177623,215541966,177494,215524420,129,17546,173038,561,243833,31877,6,725,144444.0,43333.0,-70.0,-61.0,-70.0,-69.0,-69.0,-61.0,-69.0,-69.0,-79.0,-87.0,-80.0,-88.0,9.0,26.0,10.0,19.0,1
925,F8:59:71:5A:E0:3D,2244917,411746417,90845,138472753,2154072,273273664,337,63772,89050489,63686,89037318,86,13171,63441,33,90841,8138,337,41,144444.0,43333.0,-66.0,-72.0,-65.0,-71.0,-65.0,-71.0,-65.0,-70.0,-79.0,-87.0,-80.0,-88.0,13.0,15.0,15.0,17.0,1
926,CC:2F:71:3E:C5:1F,2154158,273283798,86,10134,2154072,273273664,0,412,34486,347,26618,65,7868,95,1,148,7,0,24,130000.0,39000.0,-71.0,-69.0,-66.0,-60.0,-71.0,-69.0,-66.0,-61.0,-79.0,-87.0,-80.0,-88.0,8.0,18.0,14.0,28.0,1
927,CC:2F:71:3F:1F:24,2398015,591560721,243943,318287057,2154072,273273664,6,177766,215736202,177637,215718656,129,17546,173181,561,243989,31878,6,725,144444.0,43333.0,-70.0,-61.0,-69.0,-69.0,-69.0,-61.0,-69.0,-69.0,-79.0,-87.0,-80.0,-88.0,9.0,26.0,11.0,19.0,1
928,F8:59:71:5A:E0:3D,2245160,412122655,91088,138848991,2154072,273273664,337,63866,89153075,63780,89139904,86,13171,63535,33,91084,8138,337,41,144444.0,43333.0,-66.0,-71.0,-65.0,-70.0,-65.0,-71.0,-64.0,-70.0,-79.0,-87.0,-80.0,-88.0,13.0,16.0,15.0,18.0,1
929,CC:2F:71:3E:C5:1F,2154160,273284000,86,10134,2154074,273273866,0,412,34486,347,26618,65,7868,95,1,148,7,0,24,130000.0,39000.0,-71.0,-69.0,-66.0,-60.0,-71.0,-69.0,-66.0,-61.0,-79.0,-87.0,-80.0,-88.0,8.0,18.0,14.0,28.0,1
930,CC:2F:71:3F:1F:24,2398230,591831677,244156,318557811,2154074,273273866,6,177926,215936298,177797,215918752,129,17546,173341,561,244202,31878,6,726,144444.0,43333.0,-69.0,-61.0,-69.0,-69.0,-69.0,-61.0,-69.0,-68.0,-79.0,-87.0,-80.0,-88.0,10.0,26.0,11.0,19.0,1
931,F8:59:71:5A:E0:3D,2245235,412220801,91156,138946258,2154079,273274543,337,63932,89250159,63846,89236988,86,13171,63601,33,91152,8138,337,41,144444.0,43333.0,-66.0,-71.0,-64.0,-70.0,-66.0,-71.0,-64.0,-70.0,-79.0,-87.0,-80.0,-88.0,13.0,16.0,16.0,18.0,1
932,CC:2F:71:3E:C5:1F,2154165,273284677,86,10134,2154079,273274543,0,412,34486,347,26618,65,7868,95,1,148,7,0,24,130000.0,39000.0,-71.0,-69.0,-66.0,-60.0,-71.0,-69.0,-66.0,-61.0,-79.0,-87.0,-80.0,-88.0,8.0,18.0,14.0,28.0,1
933,CC:2F:71:3F:1F:24,2398400,592039291,244321,318764748,2154079,273274543,6,178078,216134964,177949,216117418,129,17546,173493,561,244367,31878,6,726,144444.0,43333.0,-69.0,-61.0,-69.0,-69.0,-69.0,-61.0,-69.0,-68.0,-79.0,-87.0,-80.0,-88.0,10.0,26.0,11.0,19.0,1
934,F8:59:71:5A:E0:3D,2245418,412492724,91336,139217919,2154082,273274805,337,64014,89353416,63928,89340245,86,13171,63683,33,91332,8180,337,41,144444.0,43333.0,-66.0,-71.0,-65.0,-70.0,-65.0,-71.0,-64.0,-70.0,-79.0,-87.0,-80.0,-88.0,13.0,16.0,15.0,18.0,1
935,CC:2F:71:3E:C5:1F,2154168,273284939,86,10134,2154082,273274805,0,412,34486,347,26618,65,7868,95,1,148,7,0,24,130000.0,39000.0,-71.0,-69.0,-66.0,-60.0,-71.0,-69.0,-66.0,-61.0,-79.0,-87.0,-80.0,-88.0,8.0,18.0,14.0,28.0,1
936,CC:2F:71:3F:1F:24,2398581,592249080,244499,318974275,2154082,273274805,6,178232,216332318,178103,216314772,129,17546,173647,561,244545,31878,6,726,144444.0,43333.0,-69.0,-61.0,-69.0,-69.0,-69.0,-61.0,-69.0,-68.0,-79.0,-87.0,-80.0,-88.0,10.0,26.0,11.0,19.0,1
937,F8:59:71:5A:E0:3D,2245489,412591600,91399,139315821,2154090,273275779,337,64076,89448896,63990,89435725,86,13171,63745,33,91395,8181,337,41,144444.0,43333.0,-66.0,-71.0,-64.0,-70.0,-65.0,-71.0,-64.0,-70.0,-79.0,-87.0,-80.0,-88.0,13.0,16.0,16.0,18.0,1
938,CC:2F:71:3E:C5:1F,2154176,273285913,86,10134,2154090,273275779,0,412,34486,347,26618,65,7868,95,1,148,7,0,24,130000.0,39000.0,-71.0,-69.0,-66.0,-60.0,-71.0,-69.0,-66.0,-61.0,-79.0,-87.0,-80.0,-88.0,8.0,18.0,14.0,28.0,1
939,CC:2F:71:3F:1F:24,2398757,592462486,244667,319186707,2154090,273275779,6,178384,216537651,178255,216520105,129,17546,173799,561,244712,31879,6,729,144444.0,43333.0,-69.0,-61.0,-69.0,-69.0,-70.0,-63.0,-70.0,-70.0,-79.0,-87.0,-80.0,-88.0,10.0,26.0,11.0,19.0,1
940,F8:59:71:5A:E0:3D,2245569,412713014,91477,139437033,2154092,273275981,337,64155,89570556,64069,89557385,86,13171,63824,33,91473,8181,337,41,144444.0,43333.0,-66.0,-71.0,-65.0,-70.0,-65.0,-71.0,-64.0,-70.0,-79.0,-87.0,-80.0,-88.0,13.0,16.0,15.0,18.0,1
941,CC:2F:71:3E:C5:1F,2154179,273286175,86,10134,2154093,273276041,0,412,34486,347,26618,65,7868,95,1,148,7,0,24,130000.0,39000.0,-71.0,-69.0,-66.0,-60.0,-71.0,-69.0,-66.0,-61.0,-79.0,-87.0,-80.0,-88.0,8.0,18.0,14.0,28.0,1
942,CC:2F:71:3F:1F:24,2398947,592711238,244854,319435197,2154093,273276041,6,178559,216778336,178430,216760790,129,17546,173974,561,244900,31883,6,729,144444.0,43333.0,-70.0,-62.0,-69.0,-69.0,-69.0,-61.0,-69.0,-69.0,-79.0,-87.0,-80.0,-88.0,9.0,25.0,11.0,19.0,1
943,F8:59:71:5A:E0:3D,2245638,412810028,91539,139533381,2154099,273276647,337,64217,89666036,64131,89652865,86,13171,63886,33,91535,8181,337,41,144444.0,43333.0,-66.0,-71.0,-65.0,-70.0,-65.0,-71.0,-64.0,-70.0,-79.0,-87.0,-80.0,-88.0,13.0,16.0,15.0,18.0,1
944,CC:2F:71:3E:C5:1F,2154185,273286781,86,10134,2154099,273276647,0,412,34486,347,26618,65,7868,95,1,148,7,0,24,130000.0,39000.0,-71.0,-69.0,-66.0,-60.0,-71.0,-69.0,-66.0,-61.0,-79.0,-87.0,-80.0,-88.0,8.0,18.0,14.0,28.0,1
945,CC:2F:71:3F:1F:24,2399115,592918329,245016,319641682,2154099,273276647,6,178709,216973974,178580,216956428,129,17546,174124,561,245062,31883,6,734,144444.0,43333.0,-69.0,-61.0,-69.0,-69.0,-69.0,-61.0,-69.0,-68.0,-79.0,-87.0,-80.0,-88.0,10.0,26.0,11.0,19.0,1
946,F8:59:71:5A:E0:3D,2245702,412906578,91601,139629729,2154101,273276849,337,64279,89761516,64193,89748345,86,13171,63948,33,91597,8181,337,41,144444.0,43333.0,-66.0,-71.0,-64.0,-70.0,-65.0,-71.0,-64.0,-70.0,-79.0,-87.0,-80.0,-87.0,13.0,16.0,16.0,17.0,1
947,CC:2F:71:3E:C5:1F,2154187,273286983,86,10134,2154101,273276849,0,412,34486,347,26618,65,7868,95,1,148,7,0,24,130000.0,39000.0,-71.0,-69.0,-66.0,-60.0,-71.0,-69.0,-66.0,-61.0,-79.0,-87.0,-80.0,-87.0,8.0,18.0,14.0,27.0,1
948,CC:2F:71:3F:1F:24,2399274,593123229,245173,319846380,2154101,273276849,6,178850,217169402,178721,217151856,129,17546,174265,561,245219,31884,6,734,144444.0,43333.0,-70.0,-61.0,-69.0,-69.0,-69.0,-61.0,-69.0,-69.0,-79.0,-87.0,-80.0,-87.0,9.0,26.0,11.0,18.0,1
949,F8:59:71:5A:E0:3D,2245769,413003390,91663,139726077,2154106,273277313,337,64341,89856996,64255,89843825,86,13171,64010,33,91659,8181,337,41,144444.0,43333.0,-66.0,-71.0,-65.0,-70.0,-65.0,-71.0,-64.0,-70.0,-79.0,-87.0,-80.0,-87.0,13.0,16.0,15.0,17.0,1
950,CC:2F:71:3E:C5:1F,2154192,273287447,86,10134,2154106,273277313,0,412,34486,347,26618,65,7868,95,1,148,7,0,24,130000.0,39000.0,-71.0,-69.0,-66.0,-60.0,-71.0,-69.0,-66.0,-61.0,-79.0,-87.0,-80.0,-87.0,8.0,18.0,14.0,27.0,1
951,CC:2F:71:3F:1F:24,2399457,593331064,245349,320053549,2154108,273277515,6,179005,217371499,178876,217353953,129,17546,174419,561,245395,31885,6,734,144444.0,43333.0,-70.0,-61.0,-70.0,-69.0,-69.0,-61.0,-69.0,-69.0,-79.0,-87.0,-80.0,-87.0,9.0,26.0,10.0,18.0,1
952,F8:59:71:5A:E0:3D,2245955,413276293,91845,139998576,2154110,273277717,337,64431,89964244,64345,89951073,86,13171,64100,33,91837,8182,337,41,144444.0,43333.0,-65.0,-71.0,-65.0,-70.0,-65.0,-71.0,-64.0,-70.0,-79.0,-87.0,-80.0,-87.0,14.0,16.0,15.0,17.0,1
953,CC:2F:71:3E:C5:1F,2154196,273287851,86,10134,2154110,273277717,0,412,34486,347,26618,65,7868,95,1,148,7,0,24,130000.0,39000.0,-71.0,-69.0,-66.0,-60.0,-71.0,-69.0,-66.0,-61.0,-79.0,-87.0,-80.0,-87.0,8.0,18.0,14.0,27.0,1
954,CC:2F:71:3F:1F:24,2399627,593535518,245517,320257801,2154110,273277717,6,179153,217570772,179024,217553226,129,17546,174567,561,245563,31885,6,734,144444.0,43333.0,-69.0,-61.0,-69.0,-69.0,-69.0,-61.0,-69.0,-69.0,-79.0,-87.0,-80.0,-87.0,10.0,26.0,11.0,18.0,1
955,F8:59:71:5A:E0:3D,2246026,413376614,91912,140098493,2154114,273278121,337,64502,90065440,64416,90052269,86,13171,64171,33,91908,8183,337,41,144444.0,43333.0,-66.0,-71.0,-65.0,-70.0,-65.0,-71.0,-64.0,-69.0,-79.0,-87.0,-80.0,-88.0,13.0,16.0,15.0,18.0,1
956,CC:2F:71:3E:C5:1F,2154200,273288255,86,10134,2154114,273278121,0,412,34486,347,26618,65,7868,95,1,148,7,0,24,130000.0,39000.0,-71.0,-69.0,-66.0,-60.0,-71.0,-69.0,-66.0,-61.0,-79.0,-87.0,-80.0,-88.0,8.0,18.0,14.0,28.0,1
957,CC:2F:71:3F:1F:24,2399788,593740620,245674,320462499,2154114,273278121,6,179296,217767856,179167,217750310,129,17546,174710,561,245720,31886,6,734,144444.0,43333.0,-70.0,-61.0,-69.0,-69.0,-69.0,-61.0,-69.0,-69.0,-79.0,-87.0,-80.0,-88.0,9.0,26.0,11.0,19.0,1
958,F8:59:71:5A:E0:3D,2246090,413471670,91973,140193287,2154117,273278383,337,64563,90159380,64477,90146209,86,13171,64232,33,91969,8183,337,41,144444.0,43333.0,-66.0,-71.0,-65.0,-70.0,-65.0,-70.0,-64.0,-70.0,-79.0,-87.0,-80.0,-88.0,13.0,16.0,15.0,18.0,1
959,CC:2F:71:3E:C5:1F,2154205,273288719,86,10134,2154119,273278585,0,412,34486,347,26618,65,7868,95,1,148,7,0,24,130000.0,39000.0,-71.0,-69.0,-66.0,-60.0,-71.0,-69.0,-66.0,-61.0,-79.0,-87.0,-80.0,-88.0,8.0,18.0,14.0,28.0,1
960,CC:2F:71:3F:1F:24,2399954,593946015,245835,320667430,2154119,273278585,6,179441,217959968,179312,217942422,129,17546,174855,561,245881,31886,6,734,144444.0,43333.0,-70.0,-61.0,-69.0,-69.0,-69.0,-61.0,-69.0,-68.0,-79.0,-87.0,-80.0,-88.0,9.0,26.0,11.0,19.0,1
961,F8:59:71:5A:E0:3D,2246156,413568254,92035,140289467,2154121,273278787,337,64623,90251808,64537,90238637,86,13171,64292,33,92031,8183,337,42,144444.0,43333.0,-66.0,-71.0,-64.0,-70.0,-65.0,-71.0,-64.0,-70.0,-79.0,-87.0,-80.0,-88.0,13.0,16.0,16.0,18.0,1
962,CC:2F:71:3E:C5:1F,2154209,273289123,86,10134,2154123,273278989,0,412,34486,347,26618,65,7868,95,1,148,7,0,24,130000.0,39000.0,-71.0,-69.0,-66.0,-60.0,-71.0,-69.0,-66.0,-61.0,-79.0,-87.0,-80.0,-88.0,8.0,18.0,14.0,28.0,1
963,CC:2F:71:3F:1F:24,2400117,594154113,245994,320875124,2154123,273278989,6,179586,218160132,179457,218142586,129,17546,175000,561,246040,31889,6,734,144444.0,43333.0,-69.0,-61.0,-69.0,-69.0,-69.0,-61.0,-69.0,-68.0,-79.0,-87.0,-80.0,-88.0,10.0,26.0,11.0,19.0,1
964,F8:59:71:5A:E0:3D,2246223,413666560,92098,140387369,2154125,273279191,337,64689,90353448,64603,90340277,86,13171,64358,33,92094,8183,337,42,144444.0,43333.0,-65.0,-71.0,-65.0,-69.0,-66.0,-71.0,-64.0,-69.0,-79.0,-87.0,-80.0,-88.0,14.0,16.0,15.0,19.0,1
965,CC:2F:71:3E:C5:1F,2154211,273289325,86,10134,2154125,273279191,0,412,34486,347,26618,65,7868,95,1,148,7,0,24,130000.0,39000.0,-71.0,-69.0,-66.0,-60.0,-71.0,-69.0,-66.0,-61.0,-79.0,-87.0,-80.0,-88.0,8.0,18.0,14.0,28.0,1
966,CC:2F:71:3F:1F:24,2400276,594359151,246151,321079960,2154125,273279191,6,179729,218354377,179600,218336831,129,17546,175143,561,246197,31889,6,734,144444.0,43333.0,-70.0,-61.0,-69.0,-69.0,-69.0,-61.0,-69.0,-68.0,-79.0,-87.0,-80.0,-88.0,9.0,26.0,11.0,19.0,1
967,F8:59:71:5A:E0:3D,2246289,413764724,92161,140485271,2154128,273279453,337,64751,90448928,64665,90435757,86,13171,64420,33,92157,8183,337,42,144444.0,43333.0,-66.0,-71.0,-64.0,-70.0,-65.0,-71.0,-64.0,-70.0,-79.0,-87.0,-80.0,-88.0,13.0,16.0,16.0,18.0,1
968,CC:2F:71:3E:C5:1F,2154214,273289587,86,10134,2154128,273279453,0,413,34556,348,26688,65,7868,95,1,149,7,0,24,130000.0,39000.0,-71.0,-69.0,-66.0,-60.0,-71.0,-69.0,-66.0,-61.0,-79.0,-87.0,-80.0,-88.0,8.0,18.0,14.0,28.0,1
969,CC:2F:71:3F:1F:24,2400443,594565035,246315,321285582,2154128,273279453,6,179878,218555224,179749,218537678,129,17546,175292,561,246361,31891,6,734,144444.0,39000.0,-69.0,-61.0,-69.0,-68.0,-69.0,-61.0,-69.0,-68.0,-79.0,-87.0,-80.0,-88.0,10.0,26.0,11.0,20.0,1
970,F8:59:71:5A:E0:3D,2246358,413863232,92224,140583173,2154134,273280059,337,64814,90545948,64728,90532777,86,13171,64483,33,92220,8183,337,42,144444.0,43333.0,-65.0,-71.0,-65.0,-70.0,-65.0,-70.0,-65.0,-70.0,-79.0,-87.0,-80.0,-88.0,14.0,16.0,15.0,18.0,1
971,CC:2F:71:3E:C5:1F,2154220,273290193,86,10134,2154134,273280059,0,414,34626,349,26758,65,7868,95,1,149,7,0,24,130000.0,39000.0,-70.0,-69.0,-67.0,-60.0,-71.0,-69.0,-67.0,-61.0,-79.0,-87.0,-80.0,-88.0,9.0,18.0,13.0,28.0,1
972,CC:2F:71:3F:1F:24,2400615,594775424,246481,321495365,2154134,273280059,6,180028,218752187,179899,218734641,129,17546,175442,561,246527,31891,6,734,144444.0,43333.0,-70.0,-61.0,-69.0,-69.0,-69.0,-61.0,-69.0,-69.0,-79.0,-87.0,-80.0,-88.0,9.0,26.0,11.0,19.0,1
973,F8:59:71:5A:E0:3D,2246540,414140134,92404,140859873,2154136,273280261,337,64890,90646300,64804,90633129,86,13171,64559,33,92400,8183,337,42,144444.0,43333.0,-66.0,-71.0,-65.0,-70.0,-65.0,-70.0,-65.0,-69.0,-79.0,-87.0,-80.0,-88.0,13.0,16.0,15.0,18.0,1
974,CC:2F:71:3E:C5:1F,2154223,273290511,87,10250,2154136,273280261,0,416,34766,351,26898,65,7868,95,1,150,7,0,24,130000.0,39000.0,-71.0,-69.0,-66.0,-60.0,-71.0,-69.0,-66.0,-60.0,-79.0,-87.0,-80.0,-88.0,8.0,18.0,14.0,28.0,1
975,CC:2F:71:3F:1F:24,2400778,594985259,246641,321704725,2154137,273280534,6,180173,218950927,180044,218933381,129,17546,175587,561,246687,31891,6,734,144444.0,43333.0,-70.0,-61.0,-69.0,-68.0,-69.0,-61.0,-69.0,-68.0,-79.0,-87.0,-80.0,-88.0,9.0,26.0,11.0,20.0,1
976,F8:59:71:5A:E0:3D,2246613,414242083,92469,140960883,2154144,273281200,337,64955,90746414,64869,90733243,86,13171,64623,33,92465,8183,337,42,144444.0,43333.0,-65.0,-71.0,-65.0,-70.0,-65.0,-71.0,-64.0,-70.0,-80.0,-87.0,-80.0,-88.0,15.0,16.0,15.0,18.0,1
977,CC:2F:71:3E:C5:1F,2154231,273291450,87,10250,2154144,273281200,0,416,34766,351,26898,65,7868,95,1,150,7,0,24,130000.0,39000.0,-71.0,-69.0,-66.0,-60.0,-71.0,-69.0,-66.0,-60.0,-80.0,-87.0,-80.0,-88.0,9.0,18.0,14.0,28.0,1
978,CC:2F:71:3F:1F:24,2400940,595188939,246796,321907739,2154144,273281200,6,180316,219148011,180187,219130465,129,17546,175730,561,246842,31891,6,734,144444.0,43333.0,-69.0,-61.0,-69.0,-69.0,-69.0,-61.0,-69.0,-68.0,-80.0,-87.0,-80.0,-88.0,11.0,26.0,11.0,19.0,1
979,F8:59:71:5A:E0:3D,2246850,414608117,92704,141326715,2154146,273281402,337,65053,90850814,64967,90837643,86,13171,64721,33,92700,8183,337,42,144444.0,43333.0,-66.0,-71.0,-64.0,-70.0,-65.0,-71.0,-64.0,-70.0,-80.0,-87.0,-80.0,-88.0,14.0,16.0,16.0,18.0,1
980,CC:2F:71:3E:C5:1F,2154233,273291652,87,10250,2154146,273281402,0,416,34766,351,26898,65,7868,95,1,150,7,0,24,130000.0,39000.0,-71.0,-69.0,-66.0,-60.0,-71.0,-69.0,-66.0,-60.0,-80.0,-87.0,-80.0,-88.0,9.0,18.0,14.0,28.0,1
981,CC:2F:71:3F:1F:24,2401098,595392285,246952,322110883,2154146,273281402,6,180459,219342247,180330,219324701,129,17546,175873,561,246998,31891,6,734,144444.0,43333.0,-70.0,-61.0,-70.0,-69.0,-70.0,-61.0,-69.0,-69.0,-80.0,-87.0,-80.0,-88.0,10.0,26.0,10.0,19.0,1
982,F8:59:71:5A:E0:3D,2246915,414703315,92765,141421509,2154150,273281806,337,65115,90946294,65029,90933123,86,13171,64783,33,92761,8184,337,42,144444.0,43333.0,-63.0,-72.0,-65.0,-70.0,-65.0,-71.0,-64.0,-70.0,-80.0,-87.0,-80.0,-88.0,17.0,15.0,15.0,18.0,1
983,CC:2F:71:3E:C5:1F,2154237,273292056,87,10250,2154150,273281806,0,416,34766,351,26898,65,7868,95,1,150,7,0,24,130000.0,39000.0,-71.0,-69.0,-66.0,-60.0,-71.0,-69.0,-66.0,-60.0,-80.0,-87.0,-80.0,-88.0,9.0,18.0,14.0,28.0,1
984,CC:2F:71:3F:1F:24,2401257,595595703,247107,322313897,2154150,273281806,6,180600,219536251,180471,219518705,129,17546,176014,561,247153,31891,6,734,144444.0,43333.0,-69.0,-61.0,-69.0,-69.0,-69.0,-61.0,-69.0,-69.0,-80.0,-87.0,-80.0,-88.0,11.0,26.0,11.0,19.0,1
985,F8:59:71:5A:E0:3D,2246981,414801479,92828,141519411,2154153,273282068,337,65177,91041774,65091,91028603,86,13171,64845,33,92824,8186,337,42,144444.0,43333.0,-65.0,-71.0,-65.0,-70.0,-64.0,-71.0,-64.0,-70.0,-80.0,-87.0,-80.0,-88.0,15.0,16.0,15.0,18.0,1
986,CC:2F:71:3E:C5:1F,2154240,273292318,87,10250,2154153,273282068,0,416,34766,351,26898,65,7868,95,1,150,7,0,24,130000.0,39000.0,-71.0,-69.0,-66.0,-60.0,-71.0,-69.0,-66.0,-60.0,-80.0,-87.0,-80.0,-88.0,9.0,18.0,14.0,28.0,1
987,CC:2F:71:3F:1F:24,2401432,595813660,247277,322531390,2154155,273282270,6,180755,219740914,180626,219723368,129,17546,176169,561,247323,31891,6,734,144444.0,43333.0,-70.0,-61.0,-69.0,-69.0,-69.0,-61.0,-69.0,-68.0,-80.0,-87.0,-80.0,-88.0,10.0,26.0,11.0,19.0,1
988,F8:59:71:5A:E0:3D,2247053,414903264,92894,141620590,2154159,273282674,337,65244,91142145,65158,91128974,86,13171,64912,33,92890,8186,337,42,144444.0,43333.0,-65.0,-71.0,-65.0,-70.0,-65.0,-71.0,-64.0,-70.0,-80.0,-87.0,-80.0,-88.0,15.0,16.0,15.0,18.0,1
989,CC:2F:71:3E:C5:1F,2154246,273292924,87,10250,2154159,273282674,0,416,34766,351,26898,65,7868,95,1,150,7,0,24,130000.0,39000.0,-71.0,-69.0,-66.0,-60.0,-71.0,-69.0,-66.0,-60.0,-80.0,-87.0,-80.0,-88.0,9.0,18.0,14.0,28.0,1
990,CC:2F:71:3F:1F:24,2401598,596027956,247439,322745282,2154159,273282674,6,180905,219947636,180776,219930090,129,17546,176318,561,247485,31891,6,737,144444.0,43333.0,-70.0,-61.0,-69.0,-68.0,-69.0,-61.0,-69.0,-68.0,-80.0,-87.0,-80.0,-88.0,10.0,26.0,11.0,20.0,1
991,F8:59:71:5A:E0:3D,2247121,415006030,92960,141723154,2154161,273282876,337,65310,91243785,65224,91230614,86,13171,64978,33,92956,8186,337,42,144444.0,43333.0,-66.0,-71.0,-65.0,-70.0,-65.0,-71.0,-64.0,-70.0,-79.0,-87.0,-80.0,-87.0,13.0,16.0,15.0,17.0,1
992,CC:2F:71:3E:C5:1F,2154248,273293126,87,10250,2154161,273282876,0,416,34766,351,26898,65,7868,95,1,150,7,0,24,130000.0,39000.0,-71.0,-69.0,-66.0,-60.0,-71.0,-69.0,-66.0,-60.0,-79.0,-87.0,-80.0,-87.0,8.0,18.0,14.0,27.0,1
993,CC:2F:71:3F:1F:24,2401756,596231302,247595,322948426,2154161,273282876,6,181047,220140332,180918,220122786,129,17546,176460,561,247641,31892,6,737,144444.0,43333.0,-69.0,-61.0,-69.0,-69.0,-69.0,-61.0,-69.0,-68.0,-79.0,-87.0,-80.0,-87.0,10.0,26.0,11.0,18.0,1
994,F8:59:71:5A:E0:3D,2247230,415149362,93062,141865820,2154168,273283542,337,65387,91348753,65301,91335582,86,13171,65054,33,93058,8186,337,43,144444.0,43333.0,-66.0,-71.0,-65.0,-70.0,-65.0,-71.0,-64.0,-70.0,-79.0,-87.0,-80.0,-87.0,13.0,16.0,15.0,17.0,1
995,CC:2F:71:3E:C5:1F,2154255,273293792,87,10250,2154168,273283542,0,416,34766,351,26898,65,7868,95,1,150,7,0,24,130000.0,39000.0,-71.0,-69.0,-66.0,-60.0,-71.0,-69.0,-66.0,-60.0,-79.0,-87.0,-80.0,-87.0,8.0,18.0,14.0,27.0,1
996,CC:2F:71:3F:1F:24,2401916,596431874,247748,323148332,2154168,273283542,6,181187,220332796,181058,220315250,129,17546,176600,561,247794,31892,6,737,144444.0,43333.0,-70.0,-61.0,-69.0,-68.0,-69.0,-61.0,-69.0,-68.0,-79.0,-87.0,-80.0,-87.0,9.0,26.0,11.0,19.0,1
997,F8:59:71:5A:E0:3D,2247295,415247466,93125,141963722,2154170,273283744,337,65451,91447313,65365,91434142,86,13171,65118,33,93121,8186,337,43,144444.0,43333.0,-66.0,-72.0,-65.0,-70.0,-66.0,-72.0,-64.0,-70.0,-79.0,-87.0,-80.0,-87.0,13.0,15.0,15.0,17.0,1
998,CC:2F:71:3E:C5:1F,2154257,273293994,87,10250,2154170,273283744,0,416,34766,351,26898,65,7868,95,1,150,7,0,24,130000.0,39000.0,-71.0,-69.0,-66.0,-60.0,-71.0,-69.0,-66.0,-60.0,-79.0,-87.0,-80.0,-87.0,8.0,18.0,14.0,27.0,1
999,CC:2F:71:3F:1F:24,2402114,596665930,247944,323382186,2154170,273283744,6,181358,220549575,181229,220532029,129,17546,176770,561,247990,31894,6,737,144444.0,43333.0,-69.0,-61.0,-70.0,-67.0,-69.0,-61.0,-70.0,-67.0,-79.0,-87.0,-80.0,-87.0,10.0,26.0,10.0,20.0,1
1000,F8:59:71:5A:E0:3D,2247454,415486697,93280,142202549,2154174,273284148,337,65539,91554825,65453,91541654,86,13171,65206,33,93276,8187,337,43,144444.0,43333.0,-65.0,-72.0,-64.0,-70.0,-66.0,-72.0,-64.0,-70.0,-79.0,-87.0,-80.0,-87.0,14.0,15.0,16.0,17.0,1
1001,CC:2F:71:3E:C5:1F,2154261,273294398,87,10250,2154174,273284148,0,416,34766,351,26898,65,7868,95,1,150,7,0,24,130000.0,39000.0,-71.0,-69.0,-66.0,-60.0,-71.0,-69.0,-66.0,-60.0,-79.0,-87.0,-80.0,-87.0,8.0,18.0,14.0,27.0,1
1002,CC:2F:71:3F:1F:24,2402290,596873728,248115,323589520,2154175,273284208,6,181512,220749625,181383,220732079,129,17546,176924,561,248161,31894,6,737,144444.0,43333.0,-68.0,-62.0,-70.0,-68.0,-68.0,-62.0,-69.0,-68.0,-79.0,-87.0,-80.0,-87.0,11.0,25.0,10.0,19.0,1
1003,F8:59:71:5A:E0:3D,2247521,415583509,93342,142298897,2154179,273284612,337,65603,91653399,65517,91640228,86,13171,65269,33,93338,8187,337,43,144444.0,43333.0,-66.0,-73.0,-64.0,-69.0,-66.0,-72.0,-64.0,-68.0,-79.0,-87.0,-80.0,-87.0,13.0,14.0,16.0,18.0,1
1004,CC:2F:71:3E:C5:1F,2154266,273294862,87,10250,2154179,273284612,0,416,34766,351,26898,65,7868,95,1,150,7,0,24,130000.0,39000.0,-71.0,-69.0,-66.0,-60.0,-71.0,-69.0,-66.0,-60.0,-79.0,-87.0,-80.0,-87.0,8.0,18.0,14.0,27.0,1
1005,CC:2F:71:3F:1F:24,2402449,597078570,248270,323793958,2154179,273284612,6,181656,220946825,181527,220929279,129,17546,177068,561,248316,31894,6,737,144444.0,43333.0,-69.0,-62.0,-69.0,-68.0,-69.0,-62.0,-68.0,-68.0,-79.0,-87.0,-80.0,-87.0,10.0,25.0,11.0,19.0,1
1006,F8:59:71:5A:E0:3D,2247585,415680059,93404,142395245,2154181,273284814,337,65664,91747339,65578,91734168,86,13171,65330,33,93400,8187,337,43,144444.0,43333.0,-66.0,-73.0,-64.0,-69.0,-65.0,-72.0,-64.0,-69.0,-79.0,-87.0,-80.0,-87.0,13.0,14.0,16.0,18.0,1
1007,CC:2F:71:3E:C5:1F,2154268,273295064,87,10250,2154181,273284814,0,416,34766,351,26898,65,7868,95,1,150,7,0,24,130000.0,39000.0,-71.0,-69.0,-66.0,-60.0,-71.0,-69.0,-66.0,-60.0,-79.0,-87.0,-80.0,-87.0,8.0,18.0,14.0,27.0,1
1008,CC:2F:71:3F:1F:24,2402611,597283841,248428,323998825,2154183,273285016,6,181799,221141100,181670,221123554,129,17546,177211,561,248474,31896,6,737,144444.0,43333.0,-70.0,-62.0,-68.0,-70.0,-70.0,-62.0,-68.0,-69.0,-79.0,-87.0,-80.0,-87.0,9.0,25.0,12.0,17.0,1
1009,F8:59:71:5A:E0:3D,2247669,415794687,93480,142509145,2154189,273285542,337,65743,91865199,65657,91852028,86,13171,65409,33,93476,8187,337,43,144444.0,43333.0,-66.0,-72.0,-65.0,-69.0,-65.0,-71.0,-64.0,-69.0,-79.0,-87.0,-80.0,-87.0,13.0,15.0,15.0,18.0,1
1010,CC:2F:71:3E:C5:1F,2154276,273295792,87,10250,2154189,273285542,0,416,34766,351,26898,65,7868,95,1,150,7,0,24,130000.0,39000.0,-71.0,-69.0,-66.0,-60.0,-71.0,-69.0,-66.0,-60.0,-79.0,-87.0,-80.0,-87.0,8.0,18.0,14.0,27.0,1
1011,CC:2F:71:3F:1F:24,2402811,597534983,248621,324249379,2154190,273285604,6,181982,221380667,181852,221363003,130,17664,177394,561,248667,31896,6,751,144444.0,43333.0,-69.0,-62.0,-69.0,-67.0,-69.0,-62.0,-69.0,-67.0,-79.0,-87.0,-80.0,-87.0,10.0,25.0,11.0,20.0,1
1012,F8:59:71:5A:E0:3D,2247749,415905087,93549,142616371,2154200,273288716,337,65811,91969919,65725,91956748,86,13171,65477,33,93545,8187,337,43,144444.0,43333.0,-66.0,-72.0,-65.0,-70.0,-65.0,-72.0,-64.0,-69.0,-79.0,-87.0,-80.0,-87.0,13.0,15.0,15.0,17.0,1
1013,CC:2F:71:3E:C5:1F,2154289,273299168,87,10250,2154202,273288918,0,418,34954,352,26968,66,7986,96,1,150,7,0,24,130000.0,39000.0,-72.0,-69.0,-65.0,-60.0,-70.0,-68.0,-66.0,-60.0,-79.0,-87.0,-80.0,-87.0,7.0,18.0,15.0,27.0,1
1014,CC:2F:71:3F:1F:24,2402985,597749273,248782,324460293,2154203,273288980,6,182130,221585479,182000,221567815,130,17664,177540,561,248828,31896,6,751,144444.0,43333.0,-69.0,-62.0,-68.0,-68.0,-69.0,-61.0,-68.0,-68.0,-79.0,-87.0,-80.0,-87.0,10.0,25.0,12.0,19.0,1
1015,F8:59:71:5A:E0:3D,2247818,416002103,93611,142712719,2154207,273289384,337,65874,92065517,65787,92052228,87,13289,65540,33,93607,8187,337,43,144444.0,43333.0,-67.0,-71.0,-65.0,-70.0,-66.0,-70.0,-64.0,-69.0,-79.0,-87.0,-80.0,-87.0,12.0,16.0,15.0,17.0,1
1016,CC:2F:71:3E:C5:1F,2154294,273299634,87,10250,2154207,273289384,0,418,34954,352,26968,66,7986,96,1,150,7,0,24,130000.0,39000.0,-72.0,-69.0,-65.0,-60.0,-70.0,-68.0,-66.0,-60.0,-79.0,-87.0,-80.0,-87.0,7.0,18.0,15.0,27.0,1
1017,CC:2F:71:3F:1F:24,2403145,597952821,248938,324663437,2154207,273289384,6,182271,221779483,182141,221761819,130,17664,177681,561,248984,31896,6,751,144444.0,43333.0,-71.0,-62.0,-69.0,-67.0,-70.0,-62.0,-69.0,-67.0,-79.0,-87.0,-80.0,-87.0,8.0,25.0,11.0,20.0,1
1018,F8:59:71:5A:E0:3D,2247884,416098986,93673,142809067,2154211,273289919,337,65936,92160997,65849,92147708,87,13289,65602,33,93669,8187,337,43,144444.0,43333.0,-66.0,-71.0,-65.0,-70.0,-66.0,-71.0,-64.0,-70.0,-79.0,-87.0,-80.0,-87.0,13.0,16.0,15.0,17.0,1
1019,CC:2F:71:3E:C5:1F,2154298,273300169,87,10250,2154211,273289919,0,418,34954,352,26968,66,7986,96,1,150,7,0,24,130000.0,39000.0,-72.0,-69.0,-65.0,-60.0,-70.0,-68.0,-66.0,-60.0,-79.0,-87.0,-80.0,-87.0,7.0,18.0,15.0,27.0,1
1020,CC:2F:71:3F:1F:24,2403303,598153392,249092,324863473,2154211,273289919,6,182415,221975259,182285,221957595,130,17664,177825,561,249138,31896,6,751,144444.0,43333.0,-70.0,-62.0,-69.0,-68.0,-70.0,-61.0,-69.0,-67.0,-79.0,-87.0,-80.0,-87.0,9.0,25.0,11.0,19.0,1
1021,F8:59:71:5A:E0:3D,2248042,416337818,93827,143047495,2154215,273290323,337,66009,92261029,65922,92247740,87,13289,65675,33,93823,8187,337,43,144444.0,43333.0,-66.0,-72.0,-65.0,-69.0,-66.0,-72.0,-64.0,-69.0,-79.0,-87.0,-80.0,-87.0,13.0,15.0,15.0,18.0,1
1022,CC:2F:71:3E:C5:1F,2154304,273300775,87,10250,2154217,273290525,0,418,34954,352,26968,66,7986,96,1,150,7,0,24,130000.0,39000.0,-72.0,-69.0,-65.0,-60.0,-70.0,-68.0,-66.0,-60.0,-79.0,-87.0,-80.0,-87.0,7.0,18.0,15.0,27.0,1
1023,CC:2F:71:3F:1F:24,2403482,598373433,249265,325082908,2154217,273290525,6,182572,222177319,182442,222159655,130,17664,177982,561,249311,31896,6,751,144444.0,43333.0,-70.0,-62.0,-68.0,-69.0,-70.0,-62.0,-68.0,-68.0,-79.0,-87.0,-80.0,-87.0,9.0,25.0,12.0,18.0,1
1024,F8:59:71:5A:E0:3D,2248109,416439030,93892,143148505,2154217,273290525,337,66073,92359589,65986,92346300,87,13289,65739,33,93888,8187,337,43,144444.0,43333.0,-66.0,-71.0,-64.0,-69.0,-66.0,-71.0,-64.0,-69.0,-79.0,-87.0,-80.0,-87.0,13.0,16.0,16.0,18.0,1
1025,CC:2F:71:3E:C5:1F,2154305,273300843,87,10250,2154218,273290593,0,418,34954,352,26968,66,7986,96,1,150,7,0,24,130000.0,39000.0,-72.0,-69.0,-65.0,-60.0,-70.0,-68.0,-66.0,-60.0,-79.0,-87.0,-80.0,-87.0,7.0,18.0,15.0,27.0,1
1026,CC:2F:71:3F:1F:24,2403638,598576515,249420,325285922,2154218,273290593,6,182716,222374519,182586,222356855,130,17664,178126,561,249466,31897,6,751,144444.0,43333.0,-70.0,-62.0,-71.0,-71.0,-69.0,-62.0,-71.0,-70.0,-79.0,-87.0,-80.0,-87.0,9.0,25.0,9.0,16.0,1
1027,F8:59:71:5A:E0:3D,2248182,416542204,93958,143251013,2154224,273291191,337,66140,92462769,66053,92449480,87,13289,65806,33,93954,8187,337,43,130000.0,39000.0,-66.0,-72.0,-65.0,-70.0,-66.0,-72.0,-64.0,-70.0,-79.0,-87.0,-80.0,-87.0,13.0,15.0,15.0,17.0,1
1028,CC:2F:71:3E:C5:1F,2154311,273301441,87,10250,2154224,273291191,0,418,34954,352,26968,66,7986,96,1,150,7,0,24,130000.0,39000.0,-72.0,-69.0,-65.0,-60.0,-70.0,-68.0,-66.0,-60.0,-79.0,-87.0,-80.0,-87.0,7.0,18.0,15.0,27.0,1
1029,CC:2F:71:3F:1F:24,2403809,598792761,249583,325501368,2154226,273291393,6,182866,222579591,182736,222561927,130,17664,178276,561,249629,31898,6,754,144444.0,43333.0,-69.0,-62.0,-70.0,-68.0,-69.0,-61.0,-70.0,-69.0,-79.0,-87.0,-80.0,-87.0,10.0,25.0,10.0,19.0,1
1030,F8:59:71:5A:E0:3D,2248439,416939867,94213,143648474,2154226,273291393,337,66239,92565903,66152,92552614,87,13289,65905,33,94209,8187,337,43,144444.0,43333.0,-65.0,-72.0,-64.0,-69.0,-66.0,-72.0,-63.0,-69.0,-79.0,-87.0,-80.0,-87.0,14.0,15.0,16.0,18.0,1
1031,CC:2F:71:3E:C5:1F,2154313,273301643,87,10250,2154226,273291393,0,418,34954,352,26968,66,7986,96,1,150,7,0,24,130000.0,39000.0,-72.0,-69.0,-65.0,-60.0,-70.0,-68.0,-66.0,-60.0,-79.0,-87.0,-80.0,-87.0,7.0,18.0,15.0,27.0,1
1032,CC:2F:71:3F:1F:24,2403967,598997886,249741,325706493,2154226,273291393,6,183012,222775604,182882,222757940,130,17664,178422,561,249787,31898,6,754,144444.0,43333.0,-68.0,-61.0,-72.0,-66.0,-68.0,-61.0,-72.0,-66.0,-79.0,-87.0,-80.0,-87.0,11.0,26.0,8.0,21.0,1
1033,F8:59:71:5A:E0:3D,2248506,417038173,94276,143746376,2154230,273291797,337,66302,92662951,66215,92649662,87,13289,65968,33,94272,8188,337,43,144444.0,43333.0,-68.0,-72.0,-66.0,-70.0,-67.0,-73.0,-65.0,-69.0,-79.0,-87.0,-80.0,-87.0,11.0,15.0,14.0,17.0,1
1034,CC:2F:71:3E:C5:1F,2154319,273302249,87,10250,2154232,273291999,0,418,34954,352,26968,66,7986,96,1,150,7,0,24,130000.0,39000.0,-72.0,-69.0,-65.0,-60.0,-70.0,-68.0,-66.0,-60.0,-79.0,-87.0,-80.0,-87.0,7.0,18.0,15.0,27.0,1
1035,CC:2F:71:3F:1F:24,2404133,599209276,249901,325917277,2154232,273291999,6,183156,222972804,183026,222955140,130,17664,178566,561,249947,31921,6,754,144444.0,43333.0,-70.0,-62.0,-75.0,-77.0,-69.0,-61.0,-73.0,-75.0,-79.0,-87.0,-80.0,-87.0,9.0,25.0,5.0,10.0,1
1036,F8:59:71:5A:E0:3D,2248573,417134985,94338,143842724,2154235,273292261,337,66365,92759971,66278,92746682,87,13289,66031,33,94334,8189,337,43,144444.0,43333.0,-67.0,-72.0,-65.0,-70.0,-67.0,-72.0,-65.0,-69.0,-79.0,-87.0,-80.0,-87.0,12.0,15.0,15.0,17.0,1
1037,CC:2F:71:3E:C5:1F,2154322,273302511,87,10250,2154235,273292261,0,418,34954,352,26968,66,7986,96,1,150,7,0,24,130000.0,39000.0,-72.0,-69.0,-65.0,-60.0,-70.0,-68.0,-66.0,-60.0,-79.0,-87.0,-80.0,-87.0,7.0,18.0,15.0,27.0,1
1038,CC:2F:71:3F:1F:24,2404296,599414299,250061,326122038,2154235,273292261,6,183308,223173293,183178,223155629,130,17664,178717,561,250107,31932,6,781,144444.0,43333.0,-71.0,-61.0,-76.0,-68.0,-71.0,-61.0,-75.0,-68.0,-79.0,-87.0,-80.0,-87.0,8.0,26.0,4.0,19.0,1
1039,F8:59:71:5A:E0:3D,2248669,417270961,94430,143978296,2154239,273292665,337,66436,92862991,66349,92849702,87,13289,66102,33,94426,8189,337,43,144444.0,43333.0,-67.0,-74.0,-62.0,-70.0,-66.0,-73.0,-65.0,-70.0,-79.0,-87.0,-80.0,-87.0,12.0,13.0,18.0,17.0,1
1040,CC:2F:71:3E:C5:1F,2154326,273302915,87,10250,2154239,273292665,0,418,34954,352,26968,66,7986,96,1,150,7,0,24,130000.0,39000.0,-72.0,-69.0,-65.0,-60.0,-70.0,-68.0,-66.0,-60.0,-79.0,-87.0,-80.0,-87.0,7.0,18.0,15.0,27.0,1
1041,CC:2F:71:3F:1F:24,2404499,599649776,250260,326357111,2154239,273292665,6,183477,223375017,183347,223357353,130,17664,178886,561,250306,31934,6,781,144444.0,43333.0,-70.0,-62.0,-72.0,-71.0,-70.0,-62.0,-72.0,-71.0,-79.0,-87.0,-80.0,-87.0,9.0,25.0,8.0,16.0,1
1042,F8:59:71:5A:E0:3D,2248740,417371279,94497,144078210,2154243,273293069,337,66504,92963911,66417,92950622,87,13289,66170,33,94493,8190,337,43,144444.0,43333.0,-62.0,-74.0,-66.0,-70.0,-66.0,-74.0,-65.0,-70.0,-79.0,-86.0,-80.0,-87.0,17.0,12.0,14.0,17.0,1
1043,CC:2F:71:3E:C5:1F,2154330,273303319,87,10250,2154243,273293069,0,418,34954,352,26968,66,7986,96,1,150,7,0,24,130000.0,39000.0,-72.0,-69.0,-65.0,-60.0,-70.0,-68.0,-66.0,-60.0,-79.0,-86.0,-80.0,-87.0,7.0,17.0,15.0,27.0,1
1044,CC:2F:71:3F:1F:24,2404663,599856646,250420,326563577,2154243,273293069,6,183622,223572351,183492,223554687,130,17664,179031,561,250466,31966,6,781,130000.0,43333.0,-70.0,-62.0,-73.0,-69.0,-70.0,-62.0,-73.0,-68.0,-79.0,-86.0,-80.0,-87.0,9.0,24.0,7.0,18.0,1
1045,F8:59:71:5A:E0:3D,2248807,417468091,94559,144174558,2154248,273293533,337,66566,93059391,66479,93046102,87,13289,66232,33,94555,8190,337,43,144444.0,43333.0,-67.0,-74.0,-66.0,-70.0,-66.0,-73.0,-66.0,-70.0,-79.0,-86.0,-80.0,-87.0,12.0,12.0,14.0,17.0,1
1046,CC:2F:71:3E:C5:1F,2154335,273303783,87,10250,2154248,273293533,0,418,34954,352,26968,66,7986,96,1,150,7,0,24,130000.0,39000.0,-72.0,-69.0,-65.0,-60.0,-70.0,-68.0,-66.0,-60.0,-79.0,-86.0,-80.0,-87.0,7.0,17.0,15.0,27.0,1
1047,CC:2F:71:3F:1F:24,2404826,600066210,250578,326772677,2154248,273293533,6,183764,223769319,183634,223751655,130,17664,179173,561,250623,31967,6,781,130000.0,43333.0,-71.0,-62.0,-73.0,-69.0,-71.0,-62.0,-73.0,-69.0,-79.0,-86.0,-80.0,-87.0,8.0,24.0,7.0,18.0,1
1048,F8:59:71:5A:E0:3D,2248874,417566397,94622,144272460,2154252,273293937,337,66629,93156411,66542,93143122,87,13289,66295,33,94618,8190,337,43,144444.0,43333.0,-66.0,-74.0,-67.0,-71.0,-66.0,-74.0,-66.0,-70.0,-79.0,-86.0,-80.0,-87.0,13.0,12.0,13.0,16.0,1
1049,CC:2F:71:3E:C5:1F,2154339,273304187,87,10250,2154252,273293937,0,418,34954,352,26968,66,7986,96,1,150,7,0,24,130000.0,39000.0,-72.0,-69.0,-65.0,-60.0,-70.0,-68.0,-66.0,-60.0,-79.0,-86.0,-80.0,-87.0,7.0,17.0,15.0,27.0,1
1050,CC:2F:71:3F:1F:24,2404993,600273117,250741,326979180,2154252,273293937,6,183915,223967822,183785,223950158,130,17664,179324,561,250787,31971,6,781,117000.0,39000.0,-71.0,-63.0,-73.0,-69.0,-70.0,-62.0,-72.0,-69.0,-79.0,-86.0,-80.0,-87.0,8.0,23.0,7.0,18.0,1
1051,F8:59:71:5A:E0:3D,2248938,417662947,94684,144368808,2154254,273294139,337,66692,93253459,66605,93240170,87,13289,66358,33,94680,8190,337,44,144444.0,43333.0,-67.0,-74.0,-66.0,-70.0,-67.0,-74.0,-66.0,-70.0,-79.0,-86.0,-80.0,-87.0,12.0,12.0,14.0,17.0,1
1052,CC:2F:71:3E:C5:1F,2154343,273304591,87,10250,2154256,273294341,0,418,34954,352,26968,66,7986,96,1,150,7,0,24,130000.0,39000.0,-72.0,-69.0,-65.0,-60.0,-70.0,-68.0,-66.0,-60.0,-79.0,-86.0,-80.0,-87.0,7.0,17.0,15.0,27.0,1
1053,CC:2F:71:3F:1F:24,2405167,600479804,250911,327185463,2154256,273294341,6,184064,224162603,183934,224144939,130,17664,179473,561,250957,31971,6,781,130000.0,43333.0,-69.0,-62.0,-71.0,-68.0,-70.0,-62.0,-72.0,-68.0,-79.0,-86.0,-80.0,-87.0,10.0,24.0,9.0,19.0,1
1054,F8:59:71:5A:E0:3D,2249005,417759759,94746,144465156,2154259,273294603,337,66754,93348939,66667,93335650,87,13289,66420,33,94742,8190,337,44,144444.0,43333.0,-67.0,-74.0,-65.0,-70.0,-66.0,-73.0,-65.0,-70.0,-79.0,-86.0,-80.0,-87.0,12.0,12.0,15.0,17.0,1
1055,CC:2F:71:3E:C5:1F,2154348,273305055,87,10250,2154261,273294805,0,420,35094,354,27108,66,7986,96,1,151,7,0,24,130000.0,39000.0,-72.0,-71.0,-66.0,-60.0,-70.0,-68.0,-66.0,-59.0,-79.0,-86.0,-80.0,-87.0,7.0,15.0,14.0,27.0,1
1056,CC:2F:71:3F:1F:24,2405331,600689498,251070,327394693,2154261,273294805,6,184211,224364423,184081,224346759,130,17664,179620,561,251116,31971,6,781,130000.0,43333.0,-71.0,-62.0,-73.0,-69.0,-70.0,-62.0,-72.0,-69.0,-79.0,-86.0,-80.0,-87.0,8.0,24.0,7.0,18.0,1
1057,F8:59:71:5A:E0:3D,2249261,418153925,95000,144859120,2154261,273294805,337,66855,93455239,66768,93441950,87,13289,66521,33,94996,8192,337,44,144444.0,43333.0,-67.0,-74.0,-66.0,-70.0,-67.0,-73.0,-66.0,-70.0,-79.0,-86.0,-80.0,-87.0,12.0,12.0,14.0,17.0,1
1058,CC:2F:71:3E:C5:1F,2154349,273305171,88,10366,2154261,273294805,0,422,35234,356,27248,66,7986,96,1,152,7,0,24,130000.0,39000.0,-71.0,-71.0,-67.0,-60.0,-70.0,-67.0,-66.0,-59.0,-79.0,-86.0,-80.0,-87.0,8.0,15.0,13.0,27.0,1
1059,CC:2F:71:3F:1F:24,2405490,600895642,251229,327600837,2154261,273294805,6,184355,224563047,184225,224545383,130,17664,179764,561,251275,31976,6,781,130000.0,43333.0,-71.0,-63.0,-73.0,-69.0,-71.0,-62.0,-73.0,-69.0,-79.0,-86.0,-80.0,-87.0,8.0,23.0,7.0,18.0,1
1060,F8:59:71:5A:E0:3D,2249439,418412560,95172,145117018,2154267,273295542,337,66937,93565971,66850,93552682,87,13289,66603,33,95168,8192,337,44,144444.0,43333.0,-67.0,-74.0,-66.0,-70.0,-67.0,-74.0,-65.0,-70.0,-79.0,-86.0,-80.0,-87.0,12.0,12.0,14.0,17.0,1
1061,CC:2F:71:3E:C5:1F,2154357,273306110,88,10366,2154269,273295744,0,422,35234,356,27248,66,7986,96,1,152,7,0,24,130000.0,39000.0,-71.0,-71.0,-67.0,-60.0,-70.0,-67.0,-66.0,-59.0,-79.0,-86.0,-80.0,-87.0,8.0,15.0,13.0,27.0,1
1062,CC:2F:71:3F:1F:24,2405668,601119999,251397,327824053,2154271,273295946,6,184508,224775531,184378,224757867,130,17664,179917,561,251442,31976,6,781,130000.0,43333.0,-71.0,-62.0,-73.0,-69.0,-71.0,-62.0,-73.0,-69.0,-79.0,-86.0,-80.0,-87.0,8.0,24.0,7.0,18.0,1
1063,F8:59:71:5A:E0:3D,2249507,418512420,95236,145216474,2154271,273295946,337,67001,93664531,66914,93651242,87,13289,66667,33,95232,8192,337,44,144444.0,43333.0,-67.0,-74.0,-66.0,-70.0,-67.0,-73.0,-66.0,-70.0,-79.0,-86.0,-80.0,-87.0,12.0,12.0,14.0,17.0,1
1064,CC:2F:71:3E:C5:1F,2154361,273306680,88,10366,2154273,273296314,0,422,35234,356,27248,66,7986,96,1,152,7,0,24,130000.0,39000.0,-71.0,-71.0,-67.0,-60.0,-70.0,-67.0,-66.0,-59.0,-79.0,-86.0,-80.0,-87.0,8.0,15.0,13.0,27.0,1
1065,CC:2F:71:3F:1F:24,2405850,601335354,251577,328039040,2154273,273296314,6,184675,224981553,184545,224963889,130,17664,180084,561,251623,31991,6,781,144444.0,43333.0,-71.0,-62.0,-72.0,-70.0,-71.0,-63.0,-72.0,-70.0,-79.0,-86.0,-80.0,-87.0,8.0,24.0,8.0,17.0,1
1066,F8:59:71:5A:E0:3D,2249578,418612710,95300,145315930,2154278,273296780,337,67064,93761551,66977,93748262,87,13289,66730,33,95296,8193,337,44,144444.0,43333.0,-67.0,-74.0,-66.0,-71.0,-67.0,-74.0,-66.0,-70.0,-79.0,-86.0,-80.0,-87.0,12.0,12.0,14.0,16.0,1
1067,CC:2F:71:3E:C5:1F,2154366,273307146,88,10366,2154278,273296780,0,424,35422,357,27318,67,8104,97,1,152,7,0,24,130000.0,39000.0,-71.0,-70.0,-66.0,-60.0,-70.0,-68.0,-66.0,-59.0,-79.0,-86.0,-80.0,-87.0,8.0,16.0,14.0,27.0,1
1068,CC:2F:71:3F:1F:24,2406012,601540504,251734,328243724,2154278,273296780,6,184816,225175547,184686,225157883,130,17664,180225,561,251780,31999,6,781,144444.0,43333.0,-71.0,-62.0,-73.0,-70.0,-71.0,-62.0,-73.0,-70.0,-79.0,-86.0,-80.0,-87.0,8.0,24.0,7.0,17.0,1
1069,F8:59:71:5A:E0:3D,2249645,418709522,95362,145412278,2154283,273297244,337,67126,93857031,67039,93843742,87,13289,66792,33,95358,8194,337,44,144444.0,43333.0,-68.0,-75.0,-67.0,-71.0,-67.0,-74.0,-66.0,-70.0,-79.0,-86.0,-80.0,-87.0,11.0,11.0,13.0,16.0,1
1070,CC:2F:71:3E:C5:1F,2154371,273307610,88,10366,2154283,273297244,0,424,35422,357,27318,67,8104,97,1,152,7,0,24,130000.0,39000.0,-71.0,-70.0,-66.0,-60.0,-70.0,-68.0,-66.0,-59.0,-79.0,-86.0,-80.0,-87.0,8.0,16.0,14.0,27.0,1
1071,CC:2F:71:3F:1F:24,2406173,601744112,251890,328446868,2154283,273297244,6,184958,225371105,184828,225353441,130,17664,180366,561,251936,32002,6,781,144444.0,43333.0,-72.0,-62.0,-73.0,-70.0,-71.0,-62.0,-72.0,-70.0,-79.0,-86.0,-80.0,-87.0,7.0,24.0,7.0,17.0,1
1072,F8:59:71:5A:E0:3D,2249711,418806274,95424,145508626,2154287,273297648,337,67188,93952511,67101,93939222,87,13289,66854,33,95420,8194,337,44,144444.0,43333.0,-67.0,-74.0,-65.0,-70.0,-67.0,-74.0,-65.0,-70.0,-79.0,-86.0,-80.0,-87.0,12.0,12.0,15.0,17.0,1
1073,CC:2F:71:3E:C5:1F,2154375,273308014,88,10366,2154287,273297648,0,424,35422,357,27318,67,8104,97,1,152,7,0,24,130000.0,39000.0,-71.0,-70.0,-66.0,-60.0,-70.0,-68.0,-66.0,-59.0,-79.0,-86.0,-80.0,-87.0,8.0,16.0,14.0,27.0,1
1074,CC:2F:71:3F:1F:24,2406333,601949084,252046,328651436,2154287,273297648,6,185100,225565225,184970,225547561,130,17664,180508,561,252091,32003,6,781,144444.0,43333.0,-71.0,-63.0,-73.0,-71.0,-71.0,-62.0,-73.0,-71.0,-79.0,-86.0,-80.0,-87.0,8.0,23.0,7.0,16.0,1
1075,F8:59:71:5A:E0:3D,2249779,418903204,95487,145605090,2154292,273298114,337,67252,94049637,67165,94036348,87,13289,66918,33,95483,8195,337,44,144444.0,43333.0,-67.0,-74.0,-66.0,-70.0,-67.0,-74.0,-66.0,-70.0,-79.0,-86.0,-80.0,-87.0,12.0,12.0,14.0,17.0,1
1076,CC:2F:71:3E:C5:1F,2154380,273308480,88,10366,2154292,273298114,0,424,35422,357,27318,67,8104,97,1,152,7,0,24,130000.0,39000.0,-71.0,-70.0,-66.0,-60.0,-70.0,-68.0,-66.0,-59.0,-79.0,-86.0,-80.0,-87.0,8.0,16.0,14.0,27.0,1
1077,CC:2F:71:3F:1F:24,2406502,602156281,252210,328858167,2154292,273298114,6,185254,225764067,185123,225746285,131,17782,180662,561,252256,32011,6,781,144444.0,43333.0,-71.0,-63.0,-74.0,-71.0,-71.0,-63.0,-73.0,-71.0,-79.0,-86.0,-80.0,-87.0,8.0,23.0,6.0,16.0,1
1078,F8:59:71:5A:E0:3D,2249848,419003124,95551,145704546,2154297,273298578,337,67315,94146657,67228,94133368,87,13289,66981,33,95547,8195,337,44,144444.0,43333.0,-67.0,-74.0,-67.0,-70.0,-66.0,-73.0,-66.0,-70.0,-79.0,-86.0,-80.0,-87.0,12.0,12.0,13.0,17.0,1
1079,CC:2F:71:3E:C5:1F,2154385,273308944,88,10366,2154297,273298578,0,424,35422,357,27318,67,8104,97,1,152,7,0,24,130000.0,39000.0,-71.0,-70.0,-66.0,-60.0,-70.0,-68.0,-66.0,-59.0,-79.0,-86.0,-80.0,-87.0,8.0,16.0,14.0,27.0,1
1080,CC:2F:71:3F:1F:24,2406679,602369603,252382,329071025,2154297,273298578,6,185411,225966413,185280,225948631,131,17782,180819,561,252428,32014,6,781,144444.0,43333.0,-71.0,-62.0,-73.0,-71.0,-70.0,-62.0,-72.0,-70.0,-79.0,-86.0,-80.0,-87.0,8.0,24.0,7.0,16.0,1
1081,F8:59:71:5A:E0:3D,2250028,419266318,95726,145967274,2154302,273299044,337,67409,94258581,67321,94245174,88,13407,67075,33,95722,8195,337,44,144444.0,43333.0,-68.0,-74.0,-66.0,-70.0,-67.0,-74.0,-65.0,-70.0,-79.0,-86.0,-80.0,-87.0,11.0,12.0,14.0,17.0,1
1082,CC:2F:71:3E:C5:1F,2154390,273309410,88,10366,2154302,273299044,0,424,35422,357,27318,67,8104,97,1,152,7,0,24,130000.0,39000.0,-71.0,-70.0,-66.0,-60.0,-70.0,-68.0,-66.0,-59.0,-79.0,-86.0,-80.0,-87.0,8.0,16.0,14.0,27.0,1
1083,CC:2F:71:3F:1F:24,2406893,602590099,252591,329291055,2154302,273299044,6,185595,226172797,185464,226155015,131,17782,181003,561,252639,32017,6,782,144444.0,43333.0,-71.0,-63.0,-73.0,-71.0,-70.0,-63.0,-72.0,-70.0,-79.0,-86.0,-80.0,-87.0,8.0,23.0,7.0,16.0,1
1084,F8:59:71:5A:E0:3D,2250096,419363442,95792,146064196,2154304,273299246,337,67476,94356527,67388,94343120,88,13407,67142,33,95788,8196,337,44,144444.0,43333.0,-68.0,-74.0,-66.0,-71.0,-67.0,-74.0,-66.0,-70.0,-79.0,-86.0,-80.0,-87.0,11.0,12.0,14.0,16.0,1
1085,CC:2F:71:3E:C5:1F,2154394,273309814,88,10366,2154306,273299448,0,424,35422,357,27318,67,8104,97,1,152,7,0,24,130000.0,39000.0,-71.0,-70.0,-66.0,-60.0,-70.0,-68.0,-66.0,-59.0,-79.0,-86.0,-80.0,-87.0,8.0,16.0,14.0,27.0,1
1086,CC:2F:71:3F:1F:24,2407054,602793763,252748,329494315,2154306,273299448,6,185738,226367023,185607,226349241,131,17782,181146,561,252796,32019,6,783,144444.0,43333.0,-71.0,-63.0,-73.0,-71.0,-70.0,-62.0,-72.0,-71.0,-79.0,-86.0,-80.0,-87.0,8.0,23.0,7.0,16.0,1
1087,F8:59:71:5A:E0:3D,2250166,419462010,95855,146162098,2154311,273299912,337,67539,94453547,67451,94440140,88,13407,67205,33,95851,8196,337,44,144444.0,43333.0,-67.0,-74.0,-66.0,-70.0,-67.0,-74.0,-65.0,-70.0,-79.0,-86.0,-80.0,-87.0,12.0,12.0,14.0,17.0,1
1088,CC:2F:71:3E:C5:1F,2154399,273310278,88,10366,2154311,273299912,0,424,35422,357,27318,67,8104,97,1,152,7,0,24,130000.0,39000.0,-71.0,-70.0,-66.0,-60.0,-70.0,-68.0,-66.0,-59.0,-79.0,-86.0,-80.0,-87.0,8.0,16.0,14.0,27.0,1
1089,CC:2F:71:3F:1F:24,2407240,603012261,252929,329712349,2154311,273299912,6,185899,226569439,185768,226551657,131,17782,181307,561,252977,32020,6,783,144444.0,43333.0,-70.0,-63.0,-73.0,-72.0,-71.0,-63.0,-73.0,-71.0,-79.0,-86.0,-80.0,-87.0,9.0,23.0,7.0,15.0,1
1090,F8:59:71:5A:E0:3D,2250239,419562482,95928,146262570,2154311,273299912,337,67613,94554486,67525,94541079,88,13407,67279,33,95924,8196,337,44,144444.0,43333.0,-67.0,-74.0,-67.0,-70.0,-67.0,-74.0,-66.0,-70.0,-79.0,-86.0,-80.0,-87.0,12.0,12.0,13.0,17.0,1
1091,CC:2F:71:3E:C5:1F,2154401,273310480,88,10366,2154313,273300114,0,424,35422,357,27318,67,8104,97,1,152,7,0,24,130000.0,39000.0,-71.0,-70.0,-66.0,-60.0,-70.0,-68.0,-66.0,-59.0,-79.0,-86.0,-80.0,-87.0,8.0,16.0,14.0,27.0,1
1092,CC:2F:71:3F:1F:24,2407399,603218585,253086,329918471,2154313,273300114,6,186043,226768063,185912,226750281,131,17782,181451,561,253134,32022,6,783,144444.0,43333.0,-71.0,-63.0,-73.0,-71.0,-71.0,-62.0,-72.0,-70.0,-79.0,-86.0,-80.0,-87.0,8.0,23.0,7.0,16.0,1
1093,F8:59:71:5A:E0:3D,2250306,419660788,95991,146360472,2154315,273300316,337,67675,94649966,67587,94636559,88,13407,67341,33,95987,8196,337,44,144444.0,43333.0,-67.0,-74.0,-66.0,-70.0,-67.0,-74.0,-66.0,-70.0,-79.0,-86.0,-80.0,-87.0,12.0,12.0,14.0,17.0,1
1094,CC:2F:71:3E:C5:1F,2154403,273310682,88,10366,2154315,273300316,0,424,35422,357,27318,67,8104,97,1,152,7,0,24,130000.0,39000.0,-71.0,-70.0,-66.0,-60.0,-70.0,-68.0,-66.0,-59.0,-79.0,-86.0,-80.0,-87.0,8.0,16.0,14.0,27.0,1
1095,CC:2F:71:3F:1F:24,2407559,603422133,253242,330121615,2154317,273300518,6,186184,226960643,186053,226942861,131,17782,181592,561,253290,32024,6,783,144444.0,43333.0,-71.0,-63.0,-73.0,-71.0,-71.0,-63.0,-72.0,-71.0,-79.0,-86.0,-80.0,-87.0,8.0,23.0,7.0,16.0,1
1096,F8:59:71:5A:E0:3D,2250373,419757544,96053,146456764,2154320,273300780,337,67738,94746986,67650,94733579,88,13407,67404,33,96049,8196,337,44,130000.0,39000.0,-67.0,-74.0,-66.0,-70.0,-67.0,-74.0,-66.0,-70.0,-80.0,-86.0,-80.0,-87.0,13.0,12.0,14.0,17.0,1
1097,CC:2F:71:3E:C5:1F,2154408,273311146,88,10366,2154320,273300780,0,424,35422,357,27318,67,8104,97,1,152,7,0,24,130000.0,39000.0,-71.0,-70.0,-66.0,-60.0,-70.0,-68.0,-66.0,-59.0,-80.0,-86.0,-80.0,-87.0,9.0,16.0,14.0,27.0,1
1098,CC:2F:71:3F:1F:24,2407858,603804613,253536,330503631,2154322,273300982,6,186379,227185779,186248,227167997,131,17782,181783,561,253584,32064,6,787,144444.0,43333.0,-73.0,-65.0,-75.0,-73.0,-72.0,-64.0,-74.0,-72.0,-80.0,-86.0,-80.0,-87.0,7.0,21.0,5.0,14.0,1
1099,F8:59:71:5A:E0:3D,2250444,419861954,96120,146560770,2154324,273301184,337,67806,94851720,67718,94838313,88,13407,67471,33,96116,8196,337,44,144444.0,43333.0,-68.0,-75.0,-66.0,-70.0,-67.0,-74.0,-66.0,-70.0,-80.0,-86.0,-80.0,-87.0,12.0,11.0,14.0,17.0,1
1100,CC:2F:71:3E:C5:1F,2154412,273311550,88,10366,2154324,273301184,0,424,35422,357,27318,67,8104,97,1,152,7,0,24,130000.0,39000.0,-71.0,-70.0,-66.0,-60.0,-70.0,-68.0,-66.0,-59.0,-80.0,-86.0,-80.0,-87.0,9.0,16.0,14.0,27.0,1
1101,CC:2F:71:3F:1F:24,2408030,604012137,253706,330710953,2154324,273301184,6,186537,227390570,186406,227372788,131,17782,181939,561,253754,32087,6,787,144444.0,43333.0,-71.0,-63.0,-73.0,-71.0,-70.0,-63.0,-73.0,-71.0,-80.0,-86.0,-80.0,-87.0,9.0,23.0,7.0,16.0,1
1102,F8:59:71:5A:E0:3D,2250515,419965195,96186,146663334,2154329,273301861,337,67871,94951820,67783,94938413,88,13407,67536,33,96182,8197,337,44,144444.0,43333.0,-67.0,-74.0,-66.0,-70.0,-67.0,-73.0,-66.0,-70.0,-80.0,-86.0,-80.0,-87.0,13.0,12.0,14.0,17.0,1
1103,CC:2F:71:3E:C5:1F,2154417,273312227,88,10366,2154329,273301861,0,424,35422,357,27318,67,8104,97,1,152,7,0,24,130000.0,39000.0,-71.0,-70.0,-66.0,-60.0,-70.0,-68.0,-66.0,-59.0,-80.0,-86.0,-80.0,-87.0,9.0,16.0,14.0,27.0,1
1104,CC:2F:71:3F:1F:24,2408641,604786730,254312,331484869,2154329,273301861,6,186911,227633694,186780,227615912,131,17782,182309,561,254360,32236,6,787,144444.0,43333.0,-71.0,-63.0,-74.0,-71.0,-71.0,-63.0,-73.0,-71.0,-80.0,-86.0,-80.0,-87.0,9.0,23.0,6.0,16.0,1
1105,F8:59:71:5A:E0:3D,2250589,420065902,96255,146763577,2154334,273302325,337,67939,95053131,67851,95039724,88,13407,67604,33,96251,8197,337,44,144444.0,43333.0,-68.0,-75.0,-66.0,-70.0,-67.0,-74.0,-65.0,-70.0,-80.0,-87.0,-80.0,-88.0,12.0,12.0,14.0,18.0,1
1106,CC:2F:71:3E:C5:1F,2154422,273312691,88,10366,2154334,273302325,0,424,35422,357,27318,67,8104,97,1,152,7,0,24,130000.0,39000.0,-71.0,-70.0,-66.0,-60.0,-70.0,-68.0,-66.0,-59.0,-80.0,-87.0,-80.0,-88.0,9.0,17.0,14.0,28.0,1
1107,CC:2F:71:3F:1F:24,2408973,605218944,254639,331916619,2154334,273302325,6,187141,227859336,187010,227841554,131,17782,182531,561,254687,32315,6,787,144444.0,43333.0,-72.0,-63.0,-73.0,-71.0,-71.0,-63.0,-73.0,-71.0,-80.0,-87.0,-80.0,-88.0,8.0,24.0,7.0,17.0,1
1108,F8:59:71:5A:E0:3D,2250663,420173701,96325,146870972,2154338,273302729,337,68011,95161216,67923,95147809,88,13407,67675,33,96321,8197,337,44,144444.0,43333.0,-67.0,-74.0,-66.0,-70.0,-67.0,-74.0,-66.0,-70.0,-80.0,-87.0,-80.0,-88.0,13.0,13.0,14.0,18.0,1
1109,CC:2F:71:3E:C5:1F,2154426,273313095,88,10366,2154338,273302729,0,424,35422,357,27318,67,8104,97,1,152,7,0,24,130000.0,39000.0,-71.0,-70.0,-66.0,-60.0,-70.0,-68.0,-66.0,-59.0,-80.0,-87.0,-80.0,-88.0,9.0,17.0,14.0,28.0,1
1110,CC:2F:71:3F:1F:24,2409339,605686654,255001,332383925,2154338,273302729,6,187386,228083656,187255,228065874,131,17782,182775,561,255049,32398,6,787,144444.0,43333.0,-71.0,-63.0,-74.0,-71.0,-71.0,-63.0,-73.0,-71.0,-80.0,-87.0,-80.0,-88.0,9.0,24.0,6.0,17.0,1
1111,F8:59:71:5A:E0:3D,2251017,420716750,96675,147413617,2154342,273303133,337,68121,95270504,68033,95257097,88,13407,67785,33,96671,8197,337,44,144444.0,43333.0,-67.0,-74.0,-66.0,-70.0,-67.0,-74.0,-65.0,-70.0,-80.0,-87.0,-80.0,-88.0,13.0,13.0,14.0,18.0,1
1112,CC:2F:71:3E:C5:1F,2154430,273313499,88,10366,2154342,273303133,0,424,35422,357,27318,67,8104,97,1,152,7,0,24,130000.0,39000.0,-71.0,-70.0,-66.0,-60.0,-70.0,-68.0,-66.0,-59.0,-80.0,-87.0,-80.0,-88.0,9.0,17.0,14.0,28.0,1
1113,CC:2F:71:3F:1F:24,2409548,605931947,255205,332628754,2154343,273303193,6,187573,228291765,187442,228273983,131,17782,182959,561,255253,32412,6,787,144444.0,43333.0,-72.0,-63.0,-73.0,-71.0,-71.0,-63.0,-72.0,-70.0,-80.0,-87.0,-80.0,-88.0,8.0,24.0,7.0,17.0,1
1114,F8:59:71:5A:E0:3D,2251085,420815116,96738,147511519,2154347,273303597,337,68185,95366124,68097,95352717,88,13407,67847,33,96734,8197,337,44,144444.0,43333.0,-67.0,-74.0,-66.0,-70.0,-67.0,-74.0,-66.0,-70.0,-80.0,-87.0,-80.0,-88.0,13.0,13.0,14.0,18.0,1
1115,CC:2F:71:3E:C5:1F,2154435,273313963,88,10366,2154347,273303597,0,424,35422,357,27318,67,8104,97,1,152,7,0,24,130000.0,39000.0,-71.0,-70.0,-66.0,-60.0,-70.0,-68.0,-66.0,-59.0,-80.0,-87.0,-80.0,-88.0,9.0,17.0,14.0,28.0,1
1116,CC:2F:71:3F:1F:24,2409709,606137049,255362,332833452,2154347,273303597,6,187721,228493757,187590,228475975,131,17782,183103,561,255410,32418,6,787,144444.0,43333.0,-71.0,-63.0,-73.0,-71.0,-71.0,-63.0,-73.0,-70.0,-80.0,-87.0,-80.0,-88.0,9.0,24.0,7.0,17.0,1
1117,F8:59:71:5A:E0:3D,2251152,420913422,96801,147609421,2154351,273304001,337,68248,95463144,68160,95449737,88,13407,67910,33,96797,8197,337,44,144444.0,43333.0,-67.0,-74.0,-66.0,-70.0,-67.0,-74.0,-66.0,-70.0,-80.0,-87.0,-80.0,-88.0,13.0,13.0,14.0,18.0,1
1118,CC:2F:71:3E:C5:1F,2154439,273314367,88,10366,2154351,273304001,0,424,35422,357,27318,67,8104,97,1,152,7,0,24,130000.0,39000.0,-71.0,-70.0,-66.0,-60.0,-70.0,-68.0,-66.0,-59.0,-80.0,-87.0,-80.0,-88.0,9.0,17.0,14.0,28.0,1
1119,CC:2F:71:3F:1F:24,2409882,606359414,255531,333055413,2154351,273304001,6,187876,228706540,187745,228688758,131,17782,183256,561,255579,32422,6,787,144444.0,43333.0,-71.0,-63.0,-73.0,-71.0,-71.0,-62.0,-72.0,-70.0,-80.0,-87.0,-80.0,-88.0,9.0,24.0,7.0,17.0,1
1120,F8:59:71:5A:E0:3D,2251230,421021829,96876,147717566,2154354,273304263,337,68321,95571036,68233,95557629,88,13407,67983,33,96872,8197,337,44,144444.0,43333.0,-67.0,-74.0,-66.0,-70.0,-67.0,-74.0,-66.0,-70.0,-80.0,-87.0,-80.0,-88.0,13.0,13.0,14.0,18.0,1
1121,CC:2F:71:3E:C5:1F,2154444,273314831,88,10366,2154356,273304465,0,424,35422,357,27318,67,8104,97,1,152,7,0,24,130000.0,39000.0,-71.0,-70.0,-66.0,-60.0,-70.0,-68.0,-66.0,-59.0,-80.0,-87.0,-80.0,-88.0,9.0,17.0,14.0,28.0,1
1122,CC:2F:71:3F:1F:24,2410045,606567554,255689,333263089,2154356,273304465,6,188023,228906978,187892,228889196,131,17782,183403,561,255737,32425,6,788,144444.0,43333.0,-72.0,-63.0,-73.0,-73.0,-72.0,-62.0,-72.0,-72.0,-80.0,-87.0,-80.0,-88.0,8.0,24.0,7.0,15.0,1
1123,F8:59:71:5A:E0:3D,2251333,421165445,96973,147860576,2154360,273304869,337,68393,95675638,68305,95662231,88,13407,68055,33,96969,8197,337,44,144444.0,43333.0,-67.0,-74.0,-66.0,-69.0,-66.0,-73.0,-65.0,-69.0,-80.0,-87.0,-80.0,-88.0,13.0,13.0,14.0,19.0,1
1124,CC:2F:71:3E:C5:1F,2154448,273315235,88,10366,2154360,273304869,0,424,35422,357,27318,67,8104,97,1,152,7,0,24,130000.0,39000.0,-71.0,-70.0,-66.0,-60.0,-70.0,-68.0,-66.0,-59.0,-80.0,-87.0,-80.0,-88.0,9.0,17.0,14.0,28.0,1
1125,CC:2F:71:3F:1F:24,2410223,606781289,255863,333476420,2154360,273304869,6,188181,229107081,188050,229089299,131,17782,183561,561,255911,32430,6,788,144444.0,43333.0,-72.0,-62.0,-73.0,-71.0,-71.0,-62.0,-72.0,-70.0,-80.0,-87.0,-80.0,-88.0,8.0,25.0,7.0,17.0,1
1126,F8:59:71:5A:E0:3D,2251399,421263805,97039,147958936,2154360,273304869,337,68460,95775018,68372,95761611,88,13407,68122,33,97035,8198,337,44,144444.0,43333.0,-68.0,-74.0,-64.0,-70.0,-67.0,-74.0,-64.0,-70.0,-80.0,-87.0,-80.0,-88.0,12.0,13.0,16.0,18.0,1
1127,CC:2F:71:3E:C5:1F,2154450,273315437,88,10366,2154362,273305071,0,424,35422,357,27318,67,8104,97,1,152,7,0,24,130000.0,39000.0,-71.0,-70.0,-66.0,-60.0,-70.0,-68.0,-66.0,-59.0,-80.0,-87.0,-80.0,-88.0,9.0,17.0,14.0,28.0,1
1128,CC:2F:71:3F:1F:24,2410404,606989616,256042,333684545,2154362,273305071,6,188344,229318126,188213,229300344,131,17782,183724,561,256090,32456,6,788,130000.0,43333.0,-68.0,-62.0,-72.0,-71.0,-68.0,-62.0,-71.0,-70.0,-80.0,-87.0,-80.0,-88.0,12.0,25.0,8.0,17.0,1
1129,F8:59:71:5A:E0:3D,2251469,421362373,97102,148056838,2154367,273305535,337,68523,95872038,68435,95858631,88,13407,68185,33,97098,8198,337,44,144444.0,43333.0,-65.0,-72.0,-64.0,-70.0,-65.0,-72.0,-64.0,-70.0,-80.0,-87.0,-80.0,-88.0,15.0,15.0,16.0,18.0,1
1130,CC:2F:71:3E:C5:1F,2154455,273315901,88,10366,2154367,273305535,0,424,35422,357,27318,67,8104,97,1,152,7,0,24,130000.0,39000.0,-71.0,-70.0,-66.0,-60.0,-70.0,-68.0,-66.0,-59.0,-80.0,-87.0,-80.0,-88.0,9.0,17.0,14.0,28.0,1
1131,CC:2F:71:3F:1F:24,2410581,607198742,256212,333893005,2154369,273305737,6,188497,229518037,188366,229500255,131,17782,183877,561,256260,32456,6,788,117000.0,39000.0,-68.0,-62.0,-71.0,-68.0,-68.0,-62.0,-70.0,-68.0,-80.0,-87.0,-80.0,-88.0,12.0,25.0,9.0,20.0,1
1132,F8:59:71:5A:E0:3D,2251534,421459049,97164,148153186,2154370,273305863,337,68586,95969058,68498,95955651,88,13407,68248,33,97160,8198,337,44,144444.0,43333.0,-66.0,-73.0,-64.0,-70.0,-66.0,-73.0,-64.0,-69.0,-80.0,-87.0,-80.0,-88.0,14.0,14.0,16.0,18.0,1
1133,CC:2F:71:3E:C5:1F,2154458,273316229,88,10366,2154370,273305863,0,424,35422,357,27318,67,8104,97,1,152,7,0,24,130000.0,39000.0,-71.0,-70.0,-66.0,-60.0,-70.0,-68.0,-66.0,-59.0,-80.0,-87.0,-80.0,-88.0,9.0,17.0,14.0,28.0,1
1134,CC:2F:71:3F:1F:24,2410741,607406394,256371,334100531,2154370,273305863,6,188641,229715237,188510,229697455,131,17782,184021,561,256418,32456,6,788,144444.0,43333.0,-70.0,-62.0,-69.0,-70.0,-70.0,-62.0,-69.0,-69.0,-80.0,-87.0,-80.0,-88.0,10.0,25.0,11.0,18.0,1
1135,F8:59:71:5A:E0:3D,2251603,421557557,97227,148251088,2154376,273306469,337,68649,96066078,68561,96052671,88,13407,68311,33,97223,8198,337,44,144444.0,43333.0,-66.0,-73.0,-65.0,-69.0,-66.0,-72.0,-64.0,-69.0,-80.0,-87.0,-80.0,-88.0,14.0,14.0,15.0,19.0,1
1136,CC:2F:71:3E:C5:1F,2154464,273316835,88,10366,2154376,273306469,0,424,35422,357,27318,67,8104,97,1,152,7,0,24,130000.0,39000.0,-71.0,-70.0,-66.0,-60.0,-70.0,-68.0,-66.0,-59.0,-80.0,-87.0,-80.0,-88.0,9.0,17.0,14.0,28.0,1
1137,CC:2F:71:3F:1F:24,2410908,607613355,256532,334306886,2154376,273306469,6,188788,229910428,188657,229892646,131,17782,184168,561,256580,32457,6,788,144444.0,43333.0,-71.0,-62.0,-71.0,-68.0,-70.0,-61.0,-70.0,-67.0,-80.0,-87.0,-80.0,-88.0,9.0,25.0,9.0,20.0,1
1138,F8:59:71:5A:E0:3D,2251668,421654167,97289,148347436,2154379,273306731,337,68710,96160018,68622,96146611,88,13407,68372,33,97285,8198,337,44,144444.0,43333.0,-67.0,-73.0,-66.0,-70.0,-66.0,-72.0,-65.0,-69.0,-80.0,-87.0,-80.0,-88.0,13.0,14.0,14.0,18.0,1
1139,CC:2F:71:3E:C5:1F,2154467,273317097,88,10366,2154379,273306731,0,424,35422,357,27318,67,8104,97,1,152,7,0,24,130000.0,39000.0,-71.0,-70.0,-66.0,-60.0,-70.0,-68.0,-66.0,-59.0,-80.0,-87.0,-80.0,-88.0,9.0,17.0,14.0,28.0,1
1140,CC:2F:71:3F:1F:24,2411076,607819634,256697,334512903,2154379,273306731,6,188936,230108144,188805,230090362,131,17782,184316,561,256745,32457,6,788,144444.0,43333.0,-70.0,-63.0,-65.0,-69.0,-70.0,-62.0,-70.0,-68.0,-80.0,-87.0,-80.0,-88.0,10.0,24.0,15.0,19.0,1
1141,F8:59:71:5A:E0:3D,2251879,421975575,97496,148668440,2154383,273307135,337,68803,96263880,68715,96250473,88,13407,68465,33,97492,8198,337,44,144444.0,43333.0,-66.0,-73.0,-66.0,-70.0,-66.0,-72.0,-65.0,-70.0,-80.0,-87.0,-80.0,-88.0,14.0,14.0,14.0,18.0,1
1142,CC:2F:71:3E:C5:1F,2154474,273317819,89,10482,2154385,273307337,0,427,35632,360,27528,67,8104,97,1,154,7,0,24,130000.0,39000.0,-67.0,-61.0,-64.0,-59.0,-70.0,-68.0,-65.0,-59.0,-80.0,-87.0,-80.0,-88.0,13.0,26.0,16.0,29.0,1
1143,CC:2F:71:3F:1F:24,2411250,608028023,256865,334720686,2154385,273307337,6,189089,230309562,188958,230291780,131,17782,184469,561,256913,32457,6,793,144444.0,43333.0,-71.0,-62.0,-72.0,-68.0,-70.0,-62.0,-72.0,-68.0,-80.0,-87.0,-80.0,-88.0,9.0,25.0,8.0,20.0,1
1144,F8:59:71:5A:E0:3D,2252068,422260986,97681,148953447,2154387,273307539,337,68880,96365942,68792,96352535,88,13407,68542,33,97677,8199,337,44,144444.0,43333.0,-67.0,-72.0,-65.0,-70.0,-66.0,-72.0,-65.0,-70.0,-80.0,-87.0,-80.0,-88.0,13.0,15.0,15.0,18.0,1
1145,CC:2F:71:3E:C5:1F,2154477,273318294,89,10482,2154388,273307812,0,428,35702,361,27598,67,8104,97,1,154,7,0,24,130000.0,39000.0,-71.0,-69.0,-66.0,-60.0,-70.0,-67.0,-65.0,-59.0,-80.0,-87.0,-80.0,-88.0,9.0,18.0,14.0,28.0,1
1146,CC:2F:71:3F:1F:24,2411420,608237282,257032,334929470,2154388,273307812,6,189235,230507033,189104,230489251,131,17782,184615,561,257080,32458,6,793,144444.0,43333.0,-72.0,-62.0,-70.0,-69.0,-71.0,-61.0,-69.0,-69.0,-80.0,-87.0,-80.0,-88.0,8.0,25.0,10.0,19.0,1
1147,F8:59:71:5A:E0:3D,2252137,422359625,97744,149051349,2154393,273308276,337,68943,96462962,68855,96449555,88,13407,68605,33,97740,8199,337,44,144444.0,43333.0,-67.0,-72.0,-65.0,-69.0,-67.0,-72.0,-65.0,-69.0,-80.0,-87.0,-80.0,-88.0,13.0,15.0,15.0,19.0,1
1148,CC:2F:71:3E:C5:1F,2154482,273318758,89,10482,2154393,273308276,0,428,35702,361,27598,67,8104,97,1,154,7,0,24,130000.0,39000.0,-71.0,-69.0,-66.0,-60.0,-70.0,-67.0,-65.0,-59.0,-80.0,-87.0,-80.0,-88.0,9.0,18.0,14.0,28.0,1
1149,CC:2F:71:3F:1F:24,2411584,608446976,257191,335138700,2154393,273308276,6,189382,230707429,189251,230689647,131,17782,184762,561,257239,32458,6,793,144444.0,43333.0,-71.0,-63.0,-71.0,-70.0,-70.0,-62.0,-70.0,-69.0,-80.0,-87.0,-80.0,-88.0,9.0,24.0,9.0,18.0,1
1150,F8:59:71:5A:E0:3D,2252204,422457931,97807,149149251,2154397,273308680,337,69006,96559982,68918,96546575,88,13407,68668,33,97803,8199,337,44,144444.0,43333.0,-66.0,-71.0,-65.0,-70.0,-67.0,-71.0,-64.0,-70.0,-80.0,-87.0,-80.0,-88.0,14.0,16.0,15.0,18.0,1
1151,CC:2F:71:3E:C5:1F,2154486,273319162,89,10482,2154397,273308680,0,428,35702,361,27598,67,8104,97,1,154,7,0,24,130000.0,39000.0,-71.0,-69.0,-66.0,-60.0,-70.0,-67.0,-65.0,-59.0,-80.0,-87.0,-80.0,-88.0,9.0,18.0,14.0,28.0,1
1152,CC:2F:71:3F:1F:24,2411772,608663161,257375,335354481,2154397,273308680,6,189549,230907793,189418,230890011,131,17782,184929,561,257423,32459,6,793,144444.0,43333.0,-70.0,-62.0,-69.0,-68.0,-70.0,-62.0,-68.0,-68.0,-80.0,-87.0,-80.0,-88.0,10.0,25.0,11.0,20.0,1
1153,F8:59:71:5A:E0:3D,2252282,422564567,97872,149250261,2154410,273314306,337,69070,96658542,68982,96645135,88,13407,68732,33,97868,8199,337,44,144444.0,43333.0,-66.0,-72.0,-65.0,-70.0,-66.0,-71.0,-64.0,-69.0,-80.0,-87.0,-80.0,-88.0,14.0,15.0,15.0,18.0,1
1154,CC:2F:71:3E:C5:1F,2154510,273330212,89,10482,2154421,273319730,0,428,35702,361,27598,67,8104,97,1,154,7,0,24,130000.0,39000.0,-71.0,-69.0,-66.0,-60.0,-70.0,-67.0,-65.0,-59.0,-80.0,-87.0,-80.0,-88.0,9.0,18.0,14.0,28.0,1
1155,CC:2F:71:3F:1F:24,2411971,608903975,257548,335584043,2154423,273319932,6,189707,231129415,189576,231111633,131,17782,185086,561,257596,32459,6,793,144444.0,43333.0,-71.0,-62.0,-71.0,-69.0,-71.0,-62.0,-70.0,-68.0,-80.0,-87.0,-80.0,-88.0,9.0,25.0,9.0,19.0,1
1156,F8:59:71:5A:E0:3D,2252369,422677883,97941,149357487,2154428,273320396,337,69139,96764802,69051,96751395,88,13407,68801,33,97937,8199,337,44,144444.0,43333.0,-66.0,-72.0,-65.0,-70.0,-66.0,-71.0,-64.0,-70.0,-80.0,-87.0,-80.0,-88.0,14.0,15.0,15.0,18.0,1
1157,CC:2F:71:3E:C5:1F,2154517,273330878,89,10482,2154428,273320396,0,428,35702,361,27598,67,8104,97,1,154,7,0,24,130000.0,39000.0,-71.0,-69.0,-66.0,-60.0,-70.0,-67.0,-65.0,-59.0,-80.0,-87.0,-80.0,-88.0,9.0,18.0,14.0,28.0,1
1158,CC:2F:71:3F:1F:24,2412132,609107583,257704,335787187,2154428,273320396,6,189847,231323303,189716,231305521,131,17782,185226,561,257752,32459,6,793,144444.0,43333.0,-71.0,-62.0,-70.0,-69.0,-71.0,-62.0,-69.0,-68.0,-80.0,-87.0,-80.0,-88.0,9.0,25.0,10.0,19.0,1
1159,F8:59:71:5A:E0:3D,2252432,422772879,98002,149452281,2154430,273320598,337,69201,96860282,69113,96846875,88,13407,68863,33,97998,8199,337,44,144444.0,43333.0,-66.0,-72.0,-65.0,-69.0,-66.0,-72.0,-64.0,-69.0,-80.0,-87.0,-80.0,-88.0,14.0,15.0,15.0,19.0,1
1160,CC:2F:71:3E:C5:1F,2154519,273331080,89,10482,2154430,273320598,0,428,35702,361,27598,67,8104,97,1,154,7,0,24,130000.0,39000.0,-71.0,-69.0,-66.0,-60.0,-70.0,-67.0,-65.0,-59.0,-80.0,-87.0,-80.0,-88.0,9.0,18.0,14.0,28.0,1
1161,CC:2F:71:3F:1F:24,2412295,609318699,257865,335998101,2154430,273320598,6,189992,231523467,189861,231505685,131,17782,185371,561,257912,32459,6,793,144444.0,43333.0,-70.0,-61.0,-69.0,-68.0,-71.0,-63.0,-70.0,-69.0,-80.0,-87.0,-80.0,-88.0,10.0,26.0,11.0,20.0,1
1162,F8:59:71:5A:E0:3D,2252586,422999979,98152,149678977,2154434,273321002,337,69292,96971994,69204,96958587,88,13407,68951,33,98148,8200,337,44,144444.0,43333.0,-67.0,-72.0,-65.0,-70.0,-66.0,-72.0,-65.0,-70.0,-80.0,-87.0,-80.0,-88.0,13.0,15.0,15.0,18.0,1
1163,CC:2F:71:3E:C5:1F,2154527,273332042,89,10482,2154438,273321560,0,428,35702,361,27598,67,8104,97,1,154,7,0,24,130000.0,39000.0,-71.0,-69.0,-66.0,-60.0,-70.0,-67.0,-65.0,-59.0,-80.0,-87.0,-80.0,-88.0,9.0,18.0,14.0,28.0,1
1164,CC:2F:71:3F:1F:24,2412467,609529184,258028,336207564,2154439,273321620,6,190147,231725518,190014,231707268,133,18250,185526,561,258076,32460,6,793,144444.0,43333.0,-71.0,-61.0,-69.0,-68.0,-70.0,-61.0,-69.0,-67.0,-80.0,-87.0,-80.0,-88.0,9.0,26.0,11.0,20.0,1
1165,F8:59:71:5A:E0:3D,2252692,423149889,98253,149828269,2154439,273321620,337,69365,97078122,69277,97064715,88,13407,69024,33,98249,8200,337,44,144444.0,43333.0,-66.0,-71.0,-65.0,-70.0,-66.0,-71.0,-64.0,-70.0,-80.0,-87.0,-80.0,-88.0,14.0,16.0,15.0,18.0,1
1166,CC:2F:71:3E:C5:1F,2154528,273332102,89,10482,2154439,273321620,0,428,35702,361,27598,67,8104,97,1,154,7,0,24,130000.0,39000.0,-71.0,-69.0,-66.0,-60.0,-70.0,-67.0,-65.0,-59.0,-80.0,-87.0,-80.0,-88.0,9.0,18.0,14.0,28.0,1
1167,CC:2F:71:3F:1F:24,2412624,609733886,258184,336412132,2154440,273321754,6,190287,231919406,190154,231901156,133,18250,185666,561,258232,32460,6,793,144444.0,43333.0,-71.0,-62.0,-70.0,-68.0,-71.0,-62.0,-69.0,-68.0,-80.0,-87.0,-80.0,-88.0,9.0,25.0,10.0,20.0,1
1168,F8:59:71:5A:E0:3D,2252762,423248459,98316,149926171,2154446,273322288,337,69429,97175260,69340,97161735,89,13525,69088,33,98312,8200,337,44,144444.0,43333.0,-66.0,-71.0,-65.0,-70.0,-66.0,-71.0,-64.0,-69.0,-80.0,-87.0,-80.0,-88.0,14.0,16.0,15.0,18.0,1
1169,CC:2F:71:3E:C5:1F,2154536,273332832,89,10482,2154447,273322350,0,429,35820,361,27598,68,8222,98,1,154,7,0,24,130000.0,39000.0,-70.0,-69.0,-66.0,-60.0,-70.0,-68.0,-65.0,-59.0,-80.0,-87.0,-80.0,-88.0,10.0,18.0,14.0,28.0,1
1170,CC:2F:71:3F:1F:24,2412789,609940718,258342,336618368,2154447,273322350,6,190429,232113526,190296,232095276,133,18250,185808,561,258389,32460,6,793,144444.0,43333.0,-71.0,-62.0,-70.0,-68.0,-70.0,-61.0,-69.0,-68.0,-80.0,-87.0,-80.0,-88.0,9.0,25.0,10.0,20.0,1
1171,F8:59:71:5A:E0:3D,2252833,423348697,98383,150026085,2154450,273322612,337,69497,97276180,69408,97262655,89,13525,69156,33,98379,8200,337,44,144444.0,43333.0,-66.0,-71.0,-65.0,-70.0,-65.0,-71.0,-64.0,-69.0,-80.0,-87.0,-80.0,-88.0,14.0,16.0,15.0,18.0,1
1172,CC:2F:71:3E:C5:1F,2154539,273333094,89,10482,2154450,273322612,0,430,35890,362,27668,68,8222,98,1,154,7,0,24,130000.0,39000.0,-69.0,-62.0,-63.0,-60.0,-70.0,-67.0,-65.0,-59.0,-80.0,-87.0,-80.0,-88.0,11.0,25.0,17.0,28.0,1
1173,CC:2F:71:3F:1F:24,2412950,610147360,258500,336824748,2154450,273322612,6,190575,232313818,190442,232295568,133,18250,185954,561,258548,32460,6,793,144444.0,43333.0,-71.0,-62.0,-70.0,-68.0,-70.0,-62.0,-69.0,-68.0,-80.0,-87.0,-80.0,-88.0,9.0,25.0,10.0,20.0,1
1174,F8:59:71:5A:E0:3D,2252902,423447205,98446,150123987,2154456,273323218,337,69559,97371660,69470,97358135,89,13525,69218,33,98442,8200,337,44,144444.0,43333.0,-67.0,-72.0,-65.0,-70.0,-66.0,-71.0,-65.0,-70.0,-80.0,-87.0,-81.0,-88.0,13.0,15.0,16.0,18.0,1
1175,CC:2F:71:3E:C5:1F,2154545,273333700,89,10482,2154456,273323218,0,430,35890,362,27668,68,8222,98,1,154,7,0,24,130000.0,39000.0,-69.0,-62.0,-63.0,-60.0,-70.0,-67.0,-65.0,-59.0,-80.0,-87.0,-81.0,-88.0,11.0,25.0,18.0,28.0,1
1176,CC:2F:71:3F:1F:24,2413119,610353159,258663,337029941,2154456,273323218,6,190726,232509473,190593,232491223,133,18250,186105,561,258711,32464,6,793,144444.0,43333.0,-71.0,-62.0,-70.0,-69.0,-70.0,-62.0,-70.0,-68.0,-80.0,-87.0,-81.0,-88.0,9.0,25.0,11.0,19.0,1
1177,F8:59:71:5A:E0:3D,2252966,423543755,98508,150220335,2154458,273323420,337,69622,97468680,69533,97455155,89,13525,69281,33,98504,8200,337,44,144444.0,43333.0,-66.0,-71.0,-65.0,-69.0,-66.0,-71.0,-64.0,-69.0,-80.0,-87.0,-81.0,-88.0,14.0,16.0,16.0,19.0,1
1178,CC:2F:71:3E:C5:1F,2154551,273334615,93,11195,2154458,273323420,0,436,36705,368,28483,68,8222,103,1,158,7,0,25,130000.0,39000.0,-70.0,-69.0,-66.0,-60.0,-70.0,-67.0,-65.0,-59.0,-80.0,-87.0,-81.0,-88.0,10.0,18.0,15.0,28.0,1
1179,CC:2F:71:3F:1F:24,2413279,610561037,258821,337237617,2154458,273323420,6,190869,232706557,190736,232688307,133,18250,186248,561,258868,32464,6,793,144444.0,43333.0,-70.0,-61.0,-69.0,-68.0,-70.0,-61.0,-69.0,-68.0,-80.0,-87.0,-81.0,-88.0,10.0,26.0,12.0,20.0,1
1180,F8:59:71:5A:E0:3D,2253039,423646985,98574,150322899,2154465,273324086,337,69688,97570390,69599,97556865,89,13525,69346,33,98570,8200,337,44,144444.0,43333.0,-67.0,-72.0,-65.0,-70.0,-66.0,-71.0,-64.0,-69.0,-80.0,-87.0,-81.0,-88.0,13.0,15.0,16.0,18.0,1
1181,CC:2F:71:3E:C5:1F,2154559,273335343,93,11195,2154466,273324148,0,436,36705,368,28483,68,8222,103,1,158,7,0,25,130000.0,39000.0,-70.0,-69.0,-66.0,-60.0,-70.0,-67.0,-65.0,-59.0,-80.0,-87.0,-81.0,-88.0,10.0,18.0,15.0,28.0,1
1182,CC:2F:71:3F:1F:24,2413452,610778881,258986,337454733,2154466,273324148,6,191019,232912989,190885,232894621,134,18368,186398,561,259034,32465,6,793,144444.0,43333.0,-71.0,-62.0,-70.0,-68.0,-70.0,-62.0,-70.0,-68.0,-80.0,-87.0,-81.0,-88.0,9.0,25.0,11.0,20.0,1
1183,F8:59:71:5A:E0:3D,2253105,423745151,98637,150420801,2154468,273324350,337,69752,97668950,69663,97655425,89,13525,69410,33,98633,8200,337,44,144444.0,43333.0,-67.0,-72.0,-65.0,-69.0,-66.0,-72.0,-64.0,-69.0,-80.0,-87.0,-81.0,-88.0,13.0,15.0,16.0,19.0,1
1184,CC:2F:71:3E:C5:1F,2154561,273335545,93,11195,2154468,273324350,0,436,36705,368,28483,68,8222,103,1,158,7,0,25,130000.0,39000.0,-70.0,-69.0,-66.0,-60.0,-70.0,-67.0,-65.0,-59.0,-80.0,-87.0,-81.0,-88.0,10.0,18.0,15.0,28.0,1
1185,CC:2F:71:3F:1F:24,2413615,610990125,259147,337665775,2154468,273324350,6,191167,233116361,191033,233097993,134,18368,186546,561,259195,32466,6,793,144444.0,43333.0,-71.0,-62.0,-70.0,-68.0,-70.0,-61.0,-70.0,-68.0,-80.0,-87.0,-81.0,-88.0,9.0,25.0,11.0,20.0,1
1186,F8:59:71:5A:E0:3D,2253431,424247881,98961,150923329,2154470,273324552,337,69860,97780606,69771,97767081,89,13525,69518,33,98957,8200,337,44,144444.0,43333.0,-67.0,-72.0,-64.0,-70.0,-66.0,-71.0,-64.0,-69.0,-80.0,-87.0,-81.0,-88.0,13.0,15.0,17.0,18.0,1
1187,CC:2F:71:3E:C5:1F,2154565,273335949,93,11195,2154472,273324754,0,436,36705,368,28483,68,8222,103,1,158,7,0,25,130000.0,39000.0,-70.0,-69.0,-66.0,-60.0,-70.0,-67.0,-65.0,-59.0,-80.0,-87.0,-81.0,-88.0,10.0,18.0,15.0,28.0,1
1188,CC:2F:71:3F:1F:24,2413777,611192459,259303,337867503,2154474,273324956,6,191309,233309562,191175,233291194,134,18368,186687,561,259351,32466,6,793,144444.0,43333.0,-71.0,-62.0,-70.0,-69.0,-70.0,-62.0,-70.0,-68.0,-80.0,-87.0,-81.0,-88.0,9.0,25.0,11.0,19.0,1
1189,F8:59:71:5A:E0:3D,2253506,424346001,99030,151020712,2154476,273325289,337,69925,97875296,69836,97861771,89,13525,69583,33,99026,8200,337,44,144444.0,43333.0,-67.0,-72.0,-65.0,-70.0,-66.0,-71.0,-65.0,-70.0,-80.0,-87.0,-81.0,-88.0,13.0,15.0,16.0,18.0,1
1190,CC:2F:71:3E:C5:1F,2154571,273336686,93,11195,2154478,273325491,0,436,36705,368,28483,68,8222,103,1,158,7,0,25,130000.0,39000.0,-70.0,-69.0,-66.0,-60.0,-70.0,-67.0,-65.0,-59.0,-80.0,-87.0,-81.0,-88.0,10.0,18.0,15.0,28.0,1
1191,CC:2F:71:3F:1F:24,2413941,611397773,259463,338072282,2154478,273325491,6,191454,233504020,191320,233485652,134,18368,186832,561,259511,32466,6,793,144444.0,43333.0,-71.0,-62.0,-70.0,-69.0,-70.0,-62.0,-69.0,-68.0,-80.0,-87.0,-81.0,-88.0,9.0,25.0,11.0,19.0,1
1192,F8:59:71:5A:E0:3D,2253573,424441567,99091,151115506,2154482,273326061,337,69987,97970776,69898,97957251,89,13525,69645,33,99087,8201,337,44,144444.0,43333.0,-66.0,-72.0,-65.0,-70.0,-66.0,-71.0,-64.0,-69.0,-80.0,-87.0,-81.0,-88.0,14.0,15.0,16.0,18.0,1
1193,CC:2F:71:3E:C5:1F,2154575,273337256,93,11195,2154482,273326061,0,436,36705,368,28483,68,8222,103,1,158,7,0,25,130000.0,39000.0,-70.0,-69.0,-66.0,-60.0,-70.0,-67.0,-65.0,-59.0,-80.0,-87.0,-81.0,-88.0,10.0,18.0,15.0,28.0,1
1194,CC:2F:71:3F:1F:24,2414106,611609257,259624,338283196,2154482,273326061,6,191601,233705840,191467,233687472,134,18368,186979,561,259672,32466,6,793,144444.0,43333.0,-71.0,-62.0,-70.0,-68.0,-71.0,-62.0,-70.0,-68.0,-80.0,-87.0,-81.0,-88.0,9.0,25.0,11.0,20.0,1
1195,F8:59:71:5A:E0:3D,2253642,424542981,99156,151216516,2154486,273326465,337,70051,98069336,69962,98055811,89,13525,69709,33,99152,8202,337,44,144444.0,43333.0,-66.0,-71.0,-65.0,-70.0,-66.0,-71.0,-65.0,-69.0,-80.0,-87.0,-81.0,-88.0,14.0,16.0,16.0,18.0,1
1196,CC:2F:71:3E:C5:1F,2154579,273337660,93,11195,2154486,273326465,0,436,36705,368,28483,68,8222,103,1,158,7,0,25,130000.0,39000.0,-70.0,-69.0,-66.0,-60.0,-70.0,-67.0,-65.0,-59.0,-80.0,-87.0,-81.0,-88.0,10.0,18.0,15.0,28.0,1
1197,CC:2F:71:3F:1F:24,2414280,611816810,259794,338490345,2154486,273326465,6,191751,233904001,191617,233885633,134,18368,187129,561,259842,32466,6,793,144444.0,43333.0,-71.0,-62.0,-70.0,-68.0,-71.0,-62.0,-70.0,-68.0,-80.0,-87.0,-81.0,-88.0,9.0,25.0,11.0,20.0,1
1198,F8:59:71:5A:E0:3D,2253707,424639591,99218,151312864,2154489,273326727,337,70113,98164858,70024,98151333,89,13525,69771,33,99214,8203,337,44,144444.0,43333.0,-66.0,-72.0,-66.0,-70.0,-66.0,-72.0,-65.0,-70.0,-80.0,-87.0,-81.0,-88.0,14.0,15.0,15.0,18.0,1
1199,CC:2F:71:3E:C5:1F,2154582,273337922,93,11195,2154489,273326727,0,436,36705,368,28483,68,8222,103,1,158,7,0,25,130000.0,39000.0,-70.0,-69.0,-66.0,-60.0,-70.0,-67.0,-65.0,-59.0,-81.0,-88.0,-81.0,-88.0,11.0,19.0,15.0,28.0,1
1200,CC:2F:71:3F:1F:24,2414437,612018420,259948,338691693,2154489,273326727,6,191889,234094809,191755,234076441,134,18368,187267,561,259996,32467,6,793,144444.0,39000.0,-71.0,-62.0,-70.0,-68.0,-70.0,-62.0,-70.0,-68.0,-81.0,-88.0,-81.0,-88.0,10.0,26.0,11.0,20.0,1
1201,F8:59:71:5A:E0:3D,2253774,424734991,99279,151407658,2154495,273327333,337,70175,98260338,70086,98246813,89,13525,69833,33,99275,8204,337,44,144444.0,43333.0,-67.0,-72.0,-65.0,-70.0,-66.0,-72.0,-65.0,-70.0,-81.0,-88.0,-81.0,-88.0,14.0,16.0,16.0,18.0,1
1202,CC:2F:71:3E:C5:1F,2154590,273338760,95,11427,2154495,273327333,0,440,37057,372,28835,68,8222,105,1,160,7,0,25,130000.0,39000.0,-70.0,-69.0,-66.0,-60.0,-69.0,-67.0,-65.0,-59.0,-81.0,-88.0,-81.0,-88.0,11.0,19.0,15.0,28.0,1
1203,CC:2F:71:3F:1F:24,2414606,612224165,260111,338896832,2154495,273327333,6,192040,234290470,191906,234272102,134,18368,187418,561,260159,32468,6,793,144444.0,43333.0,-71.0,-62.0,-69.0,-68.0,-70.0,-62.0,-69.0,-68.0,-81.0,-88.0,-81.0,-88.0,10.0,26.0,12.0,20.0,1
1204,F8:59:71:5A:E0:3D,2253838,424831541,99341,151504006,2154497,273327535,337,70237,98355818,70148,98342293,89,13525,69895,33,99337,8204,337,44,144444.0,43333.0,-66.0,-71.0,-66.0,-70.0,-66.0,-72.0,-65.0,-70.0,-81.0,-88.0,-81.0,-88.0,15.0,17.0,15.0,18.0,1
1205,CC:2F:71:3E:C5:1F,2154592,273338962,95,11427,2154497,273327535,0,440,37057,372,28835,68,8222,105,1,160,7,0,25,130000.0,39000.0,-70.0,-69.0,-66.0,-60.0,-69.0,-67.0,-65.0,-59.0,-81.0,-88.0,-81.0,-88.0,11.0,19.0,15.0,28.0,1
1206,CC:2F:71:3F:1F:24,2414763,612427381,260266,339099846,2154497,273327535,6,192181,234484474,192047,234466106,134,18368,187559,561,260314,32468,6,793,144444.0,43333.0,-71.0,-62.0,-70.0,-68.0,-70.0,-62.0,-69.0,-68.0,-81.0,-88.0,-81.0,-88.0,10.0,26.0,11.0,20.0,1
1207,F8:59:71:5A:E0:3D,2253908,424930109,99404,151601908,2154504,273328201,337,70299,98451298,70210,98437773,89,13525,69957,33,99399,8204,337,44,144444.0,43333.0,-66.0,-71.0,-65.0,-70.0,-66.0,-71.0,-65.0,-70.0,-81.0,-88.0,-81.0,-88.0,15.0,17.0,16.0,18.0,1
1208,CC:2F:71:3E:C5:1F,2154599,273339628,95,11427,2154504,273328201,0,440,37057,372,28835,68,8222,105,1,160,7,0,25,130000.0,39000.0,-70.0,-69.0,-66.0,-60.0,-69.0,-67.0,-65.0,-59.0,-81.0,-88.0,-81.0,-88.0,11.0,19.0,15.0,28.0,1
1209,CC:2F:71:3F:1F:24,2414929,612631800,260425,339303599,2154504,273328201,6,192325,234678964,192191,234660596,134,18368,187703,561,260473,32470,6,793,144444.0,43333.0,-71.0,-62.0,-70.0,-69.0,-71.0,-62.0,-69.0,-68.0,-81.0,-88.0,-81.0,-88.0,10.0,26.0,11.0,19.0,1
1210,F8:59:71:5A:E0:3D,2254144,425286124,99640,151957923,2154504,273328201,337,70405,98563804,70316,98550279,89,13525,70063,33,99635,8205,337,44,144444.0,43333.0,-66.0,-71.0,-64.0,-70.0,-66.0,-71.0,-64.0,-69.0,-81.0,-88.0,-81.0,-88.0,15.0,17.0,17.0,18.0,1
1211,CC:2F:71:3E:C5:1F,2154601,273339830,95,11427,2154506,273328403,0,440,37057,372,28835,68,8222,105,1,160,7,0,25,130000.0,39000.0,-70.0,-69.0,-66.0,-60.0,-69.0,-67.0,-65.0,-59.0,-81.0,-88.0,-81.0,-88.0,11.0,19.0,15.0,28.0,1
1212,CC:2F:71:3F:1F:24,2415087,612833996,260581,339505593,2154506,273328403,6,192465,234870004,192331,234851636,134,18368,187843,561,260628,32470,6,793,144444.0,43333.0,-71.0,-62.0,-69.0,-68.0,-70.0,-62.0,-69.0,-68.0,-81.0,-88.0,-81.0,-88.0,10.0,26.0,12.0,20.0,1
1213,F8:59:71:5A:E0:3D,2254212,425383078,99702,152054271,2154510,273328807,337,70467,98659284,70378,98645759,89,13525,70125,33,99698,8205,337,44,144444.0,43333.0,-66.0,-72.0,-65.0,-70.0,-66.0,-72.0,-64.0,-69.0,-81.0,-88.0,-81.0,-88.0,15.0,16.0,16.0,18.0,1
1214,CC:2F:71:3E:C5:1F,2154605,273340234,95,11427,2154510,273328807,0,440,37057,372,28835,68,8222,105,1,160,7,0,25,130000.0,39000.0,-70.0,-69.0,-66.0,-60.0,-69.0,-67.0,-65.0,-59.0,-81.0,-88.0,-81.0,-88.0,11.0,19.0,15.0,28.0,1
1215,CC:2F:71:3F:1F:24,2415247,613038968,260737,339710161,2154510,273328807,6,192610,235070196,192476,235051828,134,18368,187986,561,260785,32470,6,793,144444.0,43333.0,-71.0,-62.0,-70.0,-68.0,-70.0,-61.0,-69.0,-68.0,-81.0,-88.0,-81.0,-88.0,10.0,26.0,11.0,20.0,1
1216,F8:59:71:5A:E0:3D,2254279,425482796,99766,152153727,2154513,273329069,337,70532,98759384,70443,98745859,89,13525,70190,33,99762,8205,337,44,144444.0,43333.0,-67.0,-71.0,-65.0,-70.0,-66.0,-71.0,-65.0,-70.0,-80.0,-86.0,-80.0,-87.0,13.0,15.0,15.0,17.0,1
1217,CC:2F:71:3E:C5:1F,2154608,273340496,95,11427,2154513,273329069,0,440,37057,372,28835,68,8222,105,1,160,7,0,25,130000.0,39000.0,-70.0,-69.0,-66.0,-60.0,-69.0,-67.0,-65.0,-59.0,-80.0,-86.0,-80.0,-87.0,10.0,17.0,14.0,27.0,1
1218,CC:2F:71:3F:1F:24,2415427,613269025,260914,339939956,2154513,273329069,6,192772,235287064,192638,235268696,134,18368,188148,561,260962,32471,6,793,144444.0,43333.0,-71.0,-61.0,-69.0,-68.0,-70.0,-61.0,-69.0,-68.0,-80.0,-86.0,-80.0,-87.0,9.0,25.0,11.0,19.0,1
1219,F8:59:71:5A:E0:3D,2254353,425589074,99834,152259399,2154519,273329675,337,70599,98862620,70510,98849095,89,13525,70257,33,99830,8205,337,44,144444.0,43333.0,-66.0,-72.0,-65.0,-70.0,-65.0,-71.0,-64.0,-69.0,-80.0,-86.0,-80.0,-87.0,14.0,14.0,15.0,17.0,1
1220,CC:2F:71:3E:C5:1F,2154614,273341102,95,11427,2154519,273329675,0,440,37057,372,28835,68,8222,105,1,160,7,0,25,130000.0,39000.0,-70.0,-69.0,-66.0,-60.0,-69.0,-67.0,-65.0,-59.0,-80.0,-86.0,-80.0,-87.0,10.0,17.0,14.0,27.0,1
1221,CC:2F:71:3F:1F:24,2415587,613471091,261068,340141416,2154519,273329675,6,192913,235481068,192779,235462700,134,18368,188289,561,261116,32471,6,793,144444.0,43333.0,-71.0,-62.0,-69.0,-68.0,-71.0,-62.0,-69.0,-68.0,-80.0,-86.0,-80.0,-87.0,9.0,24.0,11.0,19.0,1
1222,F8:59:71:5A:E0:3D,2254416,425684070,99895,152354193,2154521,273329877,337,70661,98958100,70572,98944575,89,13525,70319,33,99891,8205,337,44,144444.0,43333.0,-66.0,-72.0,-65.0,-70.0,-66.0,-71.0,-64.0,-69.0,-80.0,-86.0,-80.0,-87.0,14.0,14.0,15.0,17.0,1
1223,CC:2F:71:3E:C5:1F,2154616,273341304,95,11427,2154521,273329877,0,440,37057,372,28835,68,8222,105,1,160,7,0,25,130000.0,39000.0,-70.0,-69.0,-66.0,-60.0,-69.0,-67.0,-65.0,-59.0,-80.0,-86.0,-80.0,-87.0,10.0,17.0,14.0,27.0,1
1224,CC:2F:71:3F:1F:24,2415744,613674307,261223,340344430,2154521,273329877,6,193054,235675072,192920,235656704,134,18368,188430,561,261271,32471,6,793,144444.0,43333.0,-71.0,-62.0,-70.0,-68.0,-70.0,-62.0,-70.0,-68.0,-80.0,-86.0,-80.0,-87.0,9.0,24.0,10.0,19.0,1
1225,F8:59:71:5A:E0:3D,2254482,425782234,99958,152452095,2154524,273330139,337,70723,99053580,70634,99040055,89,13525,70381,33,99954,8205,337,44,144444.0,43333.0,-67.0,-71.0,-64.0,-70.0,-66.0,-71.0,-64.0,-70.0,-80.0,-86.0,-80.0,-87.0,13.0,15.0,16.0,17.0,1
1226,CC:2F:71:3E:C5:1F,2154623,273341970,95,11427,2154528,273330543,0,442,37197,374,28975,68,8222,105,1,161,7,0,25,130000.0,39000.0,-77.0,-83.0,-73.0,-71.0,-70.0,-69.0,-66.0,-61.0,-80.0,-86.0,-80.0,-87.0,3.0,3.0,7.0,16.0,1
1227,CC:2F:71:3F:1F:24,2415912,613883163,261384,340552620,2154528,273330543,6,193199,235872387,193065,235854019,134,18368,188575,561,261432,32472,6,793,144444.0,43333.0,-71.0,-62.0,-70.0,-69.0,-71.0,-62.0,-70.0,-69.0,-80.0,-86.0,-80.0,-87.0,9.0,24.0,10.0,18.0,1
1228,F8:59:71:5A:E0:3D,2254552,425880858,100022,152550113,2154530,273330745,337,70786,99150600,70697,99137075,89,13525,70444,33,100018,8206,337,44,144444.0,43333.0,-67.0,-72.0,-65.0,-70.0,-66.0,-72.0,-65.0,-70.0,-80.0,-86.0,-80.0,-87.0,13.0,14.0,15.0,17.0,1
1229,CC:2F:71:3E:C5:1F,2154626,273342288,96,11543,2154530,273330745,0,444,37337,376,29115,68,8222,105,1,162,7,0,25,130000.0,39000.0,-70.0,-69.0,-66.0,-60.0,-70.0,-70.0,-66.0,-61.0,-80.0,-86.0,-80.0,-87.0,10.0,17.0,14.0,27.0,1
1230,CC:2F:71:3F:1F:24,2416079,614093074,261549,340762329,2154530,273330745,6,193351,236071007,193217,236052639,134,18368,188727,561,261597,32472,6,793,144444.0,43333.0,-70.0,-62.0,-71.0,-69.0,-70.0,-61.0,-70.0,-68.0,-80.0,-86.0,-80.0,-87.0,10.0,24.0,9.0,18.0,1
1231,F8:59:71:5A:E0:3D,2254745,426176500,100212,152845280,2154533,273331220,337,70864,99252734,70775,99239209,89,13525,70522,33,100208,8206,337,44,144444.0,43333.0,-67.0,-72.0,-65.0,-70.0,-67.0,-72.0,-64.0,-70.0,-80.0,-86.0,-80.0,-87.0,13.0,14.0,15.0,17.0,1
1232,CC:2F:71:3E:C5:1F,2154629,273342763,96,11543,2154533,273331220,0,444,37337,376,29115,68,8222,105,1,162,7,0,25,130000.0,39000.0,-70.0,-69.0,-66.0,-60.0,-70.0,-70.0,-66.0,-61.0,-80.0,-86.0,-80.0,-87.0,10.0,17.0,14.0,27.0,1
1233,CC:2F:71:3F:1F:24,2416253,614298907,261718,340967565,2154535,273331342,6,193504,236269008,193369,236250522,135,18486,188880,561,261766,32475,6,793,144444.0,43333.0,-70.0,-62.0,-71.0,-69.0,-70.0,-62.0,-71.0,-69.0,-80.0,-86.0,-80.0,-87.0,10.0,24.0,9.0,18.0,1
1234,F8:59:71:5A:E0:3D,2254941,426466466,100400,153134518,2154541,273331948,337,70953,99354656,70864,99341131,89,13525,70611,33,100395,8220,337,44,144444.0,43333.0,-67.0,-72.0,-65.0,-70.0,-67.0,-72.0,-64.0,-70.0,-80.0,-86.0,-80.0,-87.0,13.0,14.0,15.0,17.0,1
1235,CC:2F:71:3E:C5:1F,2154637,273343491,96,11543,2154541,273331948,0,444,37337,376,29115,68,8222,105,1,162,7,0,25,130000.0,39000.0,-70.0,-69.0,-66.0,-60.0,-70.0,-70.0,-66.0,-61.0,-80.0,-86.0,-80.0,-87.0,10.0,17.0,14.0,27.0,1
1236,CC:2F:71:3F:1F:24,2416415,614502643,261874,341170695,2154541,273331948,6,193648,236464774,193513,236446288,135,18486,189024,561,261922,32476,6,794,144444.0,43333.0,-71.0,-62.0,-71.0,-69.0,-70.0,-62.0,-70.0,-69.0,-80.0,-86.0,-80.0,-87.0,9.0,24.0,9.0,18.0,1
1237,F8:59:71:5A:E0:3D,2255004,426561462,100461,153229312,2154543,273332150,337,71015,99450136,70926,99436611,89,13525,70673,33,100457,8220,337,44,144444.0,43333.0,-67.0,-72.0,-65.0,-70.0,-67.0,-72.0,-64.0,-70.0,-80.0,-86.0,-80.0,-87.0,13.0,14.0,15.0,17.0,1
1238,CC:2F:71:3E:C5:1F,2154639,273343693,96,11543,2154543,273332150,0,444,37337,376,29115,68,8222,105,1,162,7,0,25,130000.0,39000.0,-70.0,-69.0,-66.0,-60.0,-70.0,-70.0,-66.0,-61.0,-80.0,-86.0,-80.0,-87.0,10.0,17.0,14.0,27.0,1
1239,CC:2F:71:3F:1F:24,2416573,614705989,262030,341373839,2154543,273332150,6,193791,236659073,193656,236640587,135,18486,189167,561,262078,32477,6,794,144444.0,43333.0,-71.0,-62.0,-71.0,-68.0,-70.0,-62.0,-70.0,-68.0,-80.0,-86.0,-80.0,-87.0,9.0,24.0,9.0,19.0,1
1240,F8:59:71:5A:E0:3D,2255070,426658214,100523,153325660,2154547,273332554,337,71077,99545616,70988,99532091,89,13525,70735,33,100519,8220,337,44,144444.0,43333.0,-67.0,-72.0,-64.0,-70.0,-66.0,-71.0,-64.0,-69.0,-80.0,-86.0,-80.0,-87.0,13.0,14.0,16.0,17.0,1
1241,CC:2F:71:3E:C5:1F,2154644,273344157,96,11543,2154548,273332614,0,444,37337,376,29115,68,8222,105,1,162,7,0,25,130000.0,39000.0,-70.0,-69.0,-66.0,-60.0,-70.0,-70.0,-66.0,-61.0,-80.0,-86.0,-80.0,-87.0,10.0,17.0,14.0,27.0,1
1242,CC:2F:71:3F:1F:24,2416758,614932436,262208,341599620,2154550,273332816,6,193957,236873631,193822,236855145,135,18486,189333,561,262256,32486,6,794,144444.0,43333.0,-70.0,-62.0,-70.0,-69.0,-70.0,-61.0,-70.0,-68.0,-80.0,-86.0,-80.0,-87.0,10.0,24.0,10.0,18.0,1
1243,F8:59:71:5A:E0:3D,2255141,426764148,100591,153431332,2154550,273332816,337,71145,99650336,71056,99636811,89,13525,70803,33,100587,8220,337,44,144444.0,43333.0,-67.0,-72.0,-64.0,-70.0,-66.0,-72.0,-64.0,-70.0,-80.0,-87.0,-80.0,-87.0,13.0,15.0,16.0,17.0,1
1244,CC:2F:71:3E:C5:1F,2154646,273344359,96,11543,2154550,273332816,0,444,37337,376,29115,68,8222,105,1,162,7,0,25,130000.0,39000.0,-70.0,-69.0,-66.0,-60.0,-70.0,-70.0,-66.0,-61.0,-80.0,-87.0,-80.0,-87.0,10.0,18.0,14.0,27.0,1
1245,CC:2F:71:3F:1F:24,2416913,615135450,262363,341802634,2154550,273332816,6,194098,237067635,193963,237049149,135,18486,189474,561,262411,32486,6,794,144444.0,43333.0,-70.0,-62.0,-70.0,-69.0,-70.0,-62.0,-70.0,-68.0,-80.0,-87.0,-80.0,-87.0,10.0,25.0,10.0,18.0,1
1246,F8:59:71:5A:E0:3D,2255209,426861102,100653,153527680,2154556,273333422,337,71208,99747370,71119,99733845,89,13525,70865,33,100649,8220,337,44,144444.0,43333.0,-67.0,-72.0,-65.0,-70.0,-66.0,-72.0,-64.0,-70.0,-80.0,-87.0,-80.0,-87.0,13.0,15.0,15.0,17.0,1
1247,CC:2F:71:3E:C5:1F,2154652,273344965,96,11543,2154556,273333422,0,444,37337,376,29115,68,8222,105,1,162,7,0,25,130000.0,39000.0,-70.0,-69.0,-66.0,-60.0,-70.0,-70.0,-66.0,-61.0,-80.0,-87.0,-80.0,-87.0,10.0,18.0,14.0,27.0,1
1248,CC:2F:71:3F:1F:24,2417076,615340754,262520,342007332,2154556,273333422,6,194242,237261987,194107,237243501,135,18486,189618,561,262568,32486,6,794,144444.0,43333.0,-70.0,-62.0,-70.0,-69.0,-70.0,-62.0,-70.0,-68.0,-80.0,-87.0,-80.0,-87.0,10.0,25.0,10.0,18.0,1
1249,F8:59:71:5A:E0:3D,2255281,426960185,100722,153626501,2154559,273333684,337,71274,99844481,71185,99830956,89,13525,70931,33,100718,8221,337,44,144444.0,43333.0,-67.0,-71.0,-65.0,-69.0,-66.0,-71.0,-64.0,-69.0,-80.0,-87.0,-80.0,-87.0,13.0,16.0,15.0,18.0,1
1250,CC:2F:71:3E:C5:1F,2154655,273345227,96,11543,2154559,273333684,0,444,37337,376,29115,68,8222,105,1,162,7,0,25,130000.0,39000.0,-70.0,-69.0,-66.0,-60.0,-70.0,-70.0,-66.0,-61.0,-80.0,-87.0,-80.0,-87.0,10.0,18.0,14.0,27.0,1
1251,CC:2F:71:3F:1F:24,2417235,615545584,262676,342211900,2154559,273333684,6,194384,237458955,194249,237440469,135,18486,189760,561,262724,32486,6,794,144444.0,43333.0,-71.0,-62.0,-70.0,-68.0,-70.0,-62.0,-70.0,-68.0,-80.0,-87.0,-80.0,-87.0,9.0,25.0,10.0,19.0,1
1252,F8:59:71:5A:E0:3D,2255386,427108085,100821,153773795,2154565,273334290,337,71348,99952121,71259,99938596,89,13525,71005,33,100817,8221,337,44,144444.0,43333.0,-67.0,-72.0,-65.0,-70.0,-67.0,-72.0,-65.0,-70.0,-80.0,-86.0,-80.0,-87.0,13.0,14.0,15.0,17.0,1
1253,CC:2F:71:3E:C5:1F,2154661,273345833,96,11543,2154565,273334290,0,444,37337,376,29115,68,8222,105,1,162,7,0,25,130000.0,39000.0,-70.0,-69.0,-66.0,-60.0,-70.0,-70.0,-66.0,-61.0,-80.0,-86.0,-80.0,-87.0,10.0,17.0,14.0,27.0,1
1254,CC:2F:71:3F:1F:24,2417407,615760501,262842,342426211,2154565,273334290,6,194534,237661614,194399,237643128,135,18486,189910,561,262890,32486,6,794,144444.0,43333.0,-70.0,-62.0,-70.0,-69.0,-70.0,-62.0,-70.0,-68.0,-80.0,-86.0,-80.0,-87.0,10.0,24.0,10.0,18.0,1
1255,F8:59:71:5A:E0:3D,2255486,427256673,100918,153922119,2154568,273334554,337,71422,100053767,71332,100040124,90,13643,71079,33,100913,8221,337,44,144444.0,43333.0,-67.0,-72.0,-64.0,-70.0,-66.0,-72.0,-64.0,-70.0,-80.0,-86.0,-80.0,-87.0,13.0,14.0,16.0,17.0,1
1256,CC:2F:71:3E:C5:1F,2154665,273346159,96,11543,2154569,273334616,0,445,37455,376,29115,69,8340,106,1,162,7,0,25,130000.0,39000.0,-71.0,-69.0,-66.0,-60.0,-70.0,-70.0,-66.0,-61.0,-80.0,-86.0,-80.0,-87.0,9.0,17.0,14.0,27.0,1
1257,CC:2F:71:3F:1F:24,2417570,615965585,263001,342630969,2154569,273334616,6,194680,237857622,194545,237839136,135,18486,190056,561,263049,32488,6,794,144444.0,43333.0,-70.0,-62.0,-70.0,-68.0,-70.0,-62.0,-70.0,-68.0,-80.0,-86.0,-80.0,-87.0,10.0,24.0,10.0,19.0,1
1258,F8:59:71:5A:E0:3D,2255553,427351993,100979,154016913,2154574,273335080,337,71485,100150801,71395,100137158,90,13643,71141,33,100975,8221,337,44,144444.0,43333.0,-67.0,-72.0,-64.0,-70.0,-66.0,-71.0,-64.0,-70.0,-80.0,-86.0,-80.0,-87.0,13.0,14.0,16.0,17.0,1
1259,CC:2F:71:3E:C5:1F,2154670,273346623,96,11543,2154574,273335080,0,446,37525,377,29185,69,8340,106,1,162,7,0,25,130000.0,39000.0,-71.0,-69.0,-66.0,-60.0,-71.0,-70.0,-66.0,-61.0,-80.0,-86.0,-80.0,-87.0,9.0,17.0,14.0,27.0,1
1260,CC:2F:71:3F:1F:24,2417748,616175076,263172,342839794,2154576,273335282,6,194834,238055949,194699,238037463,135,18486,190210,561,263220,32488,6,794,144444.0,43333.0,-70.0,-61.0,-70.0,-68.0,-70.0,-61.0,-70.0,-68.0,-80.0,-86.0,-80.0,-87.0,10.0,25.0,10.0,19.0,1
1261,F8:59:71:5A:E0:3D,2255625,427451086,101047,154115602,2154578,273335484,337,71550,100247417,71460,100233774,90,13643,71206,33,101043,8221,337,44,144444.0,43333.0,-67.0,-72.0,-65.0,-70.0,-67.0,-72.0,-64.0,-69.0,-80.0,-86.0,-80.0,-87.0,13.0,14.0,15.0,17.0,1
1262,CC:2F:71:3E:C5:1F,2154674,273347027,96,11543,2154578,273335484,0,446,37525,377,29185,69,8340,106,1,162,7,0,25,130000.0,39000.0,-71.0,-69.0,-66.0,-60.0,-71.0,-70.0,-66.0,-61.0,-80.0,-86.0,-80.0,-87.0,9.0,17.0,14.0,27.0,1
1263,CC:2F:71:3F:1F:24,2417904,616376738,263326,343041254,2154578,273335484,6,194975,238249953,194840,238231467,135,18486,190351,561,263374,32488,6,794,144444.0,43333.0,-70.0,-62.0,-71.0,-68.0,-69.0,-61.0,-70.0,-68.0,-80.0,-86.0,-80.0,-87.0,10.0,24.0,9.0,19.0,1
1264,F8:59:71:5A:E0:3D,2255692,427548094,101112,154212408,2154580,273335686,337,71615,100346565,71525,100332922,90,13643,71271,33,101108,8222,337,44,144444.0,43333.0,-67.0,-72.0,-65.0,-70.0,-67.0,-71.0,-65.0,-70.0,-80.0,-86.0,-80.0,-87.0,13.0,14.0,15.0,17.0,1
1265,CC:2F:71:3E:C5:1F,2154678,273347431,96,11543,2154582,273335888,0,446,37525,377,29185,69,8340,106,1,162,7,0,25,130000.0,39000.0,-71.0,-69.0,-66.0,-60.0,-71.0,-70.0,-66.0,-61.0,-80.0,-86.0,-80.0,-87.0,9.0,17.0,14.0,27.0,1
1266,CC:2F:71:3F:1F:24,2418081,616605296,263499,343269408,2154582,273335888,6,195134,238465993,194999,238447507,135,18486,190510,561,263546,32503,6,794,144444.0,43333.0,-70.0,-61.0,-71.0,-68.0,-70.0,-60.0,-71.0,-68.0,-80.0,-86.0,-80.0,-87.0,10.0,25.0,9.0,19.0,1
1267,F8:59:71:5A:E0:3D,2255770,427657697,101183,154321345,2154587,273336352,337,71687,100453353,71597,100439710,90,13643,71343,33,101179,8222,337,45,144444.0,43333.0,-67.0,-72.0,-65.0,-70.0,-66.0,-72.0,-64.0,-70.0,-80.0,-86.0,-80.0,-87.0,13.0,14.0,15.0,17.0,1
1268,CC:2F:71:3E:C5:1F,2154683,273347895,96,11543,2154587,273336352,0,446,37525,377,29185,69,8340,106,1,162,7,0,25,130000.0,39000.0,-71.0,-69.0,-66.0,-60.0,-71.0,-70.0,-66.0,-61.0,-80.0,-86.0,-80.0,-87.0,9.0,17.0,14.0,27.0,1
1269,CC:2F:71:3F:1F:24,2418248,616810709,263661,343474357,2154587,273336352,6,195284,238661532,195149,238643046,135,18486,190660,561,263709,32503,6,794,144444.0,39000.0,-71.0,-62.0,-72.0,-69.0,-70.0,-62.0,-71.0,-68.0,-80.0,-86.0,-80.0,-87.0,9.0,24.0,8.0,18.0,1
1270,F8:59:71:5A:E0:3D,2255834,427754247,101245,154417693,2154589,273336554,337,71749,100548833,71659,100535190,90,13643,71405,33,101241,8222,337,45,144444.0,43333.0,-67.0,-72.0,-65.0,-70.0,-66.0,-72.0,-64.0,-70.0,-80.0,-86.0,-80.0,-87.0,13.0,14.0,15.0,17.0,1
1271,CC:2F:71:3E:C5:1F,2154685,273348097,96,11543,2154589,273336554,0,446,37525,377,29185,69,8340,106,1,162,7,0,25,130000.0,39000.0,-71.0,-69.0,-66.0,-60.0,-71.0,-70.0,-66.0,-61.0,-80.0,-86.0,-80.0,-87.0,9.0,17.0,14.0,27.0,1
1272,CC:2F:71:3F:1F:24,2418406,617015423,263817,343678869,2154589,273336554,6,195427,238858616,195292,238840130,135,18486,190803,561,263865,32503,6,794,144444.0,43333.0,-70.0,-62.0,-71.0,-69.0,-70.0,-62.0,-70.0,-68.0,-80.0,-86.0,-80.0,-87.0,10.0,24.0,9.0,18.0,1
1273,F8:59:71:5A:E0:3D,2256022,428040381,101429,154703423,2154593,273336958,337,71827,100652279,71737,100638636,90,13643,71482,33,101425,8223,337,45,144444.0,43333.0,-67.0,-72.0,-65.0,-70.0,-67.0,-72.0,-64.0,-70.0,-80.0,-86.0,-80.0,-87.0,13.0,14.0,15.0,17.0,1
1274,CC:2F:71:3E:C5:1F,2154690,273348774,96,11543,2154594,273337231,0,446,37525,377,29185,69,8340,106,1,162,7,0,25,130000.0,39000.0,-71.0,-69.0,-66.0,-60.0,-71.0,-70.0,-66.0,-61.0,-80.0,-86.0,-80.0,-87.0,9.0,17.0,14.0,27.0,1
1275,CC:2F:71:3F:1F:24,2418568,617219316,263972,343881883,2154596,273337433,6,195567,239049656,195432,239031170,135,18486,190943,561,264020,32503,6,794,144444.0,43333.0,-71.0,-63.0,-71.0,-70.0,-70.0,-62.0,-71.0,-69.0,-80.0,-86.0,-80.0,-87.0,9.0,23.0,9.0,17.0,1
1276,F8:59:71:5A:E0:3D,2256093,428138051,101496,154800558,2154597,273337493,337,71892,100748893,71802,100735250,90,13643,71547,33,101492,8224,337,45,144444.0,43333.0,-67.0,-72.0,-65.0,-70.0,-67.0,-72.0,-65.0,-70.0,-80.0,-86.0,-80.0,-87.0,13.0,14.0,15.0,17.0,1
1277,CC:2F:71:3E:C5:1F,2154693,273349036,96,11543,2154597,273337493,0,446,37525,377,29185,69,8340,106,1,162,7,0,25,130000.0,39000.0,-71.0,-69.0,-66.0,-60.0,-71.0,-70.0,-66.0,-61.0,-80.0,-86.0,-80.0,-87.0,9.0,17.0,14.0,27.0,1
1278,CC:2F:71:3F:1F:24,2418728,617424276,264129,344086581,2154599,273337695,6,195714,239248642,195579,239230156,135,18486,191089,561,264176,32503,6,794,144444.0,43333.0,-70.0,-62.0,-71.0,-69.0,-70.0,-62.0,-71.0,-69.0,-80.0,-86.0,-80.0,-87.0,10.0,24.0,9.0,18.0,1
1279,F8:59:71:5A:E0:3D,2256162,428236559,101559,154898460,2154603,273338099,337,71956,100844513,71866,100830870,90,13643,71609,33,101555,8224,337,45,144444.0,43333.0,-67.0,-72.0,-64.0,-69.0,-67.0,-72.0,-64.0,-69.0,-80.0,-86.0,-80.0,-87.0,13.0,14.0,16.0,18.0,1
1280,CC:2F:71:3E:C5:1F,2154699,273349642,96,11543,2154603,273338099,0,446,37525,377,29185,69,8340,106,1,162,7,0,25,130000.0,39000.0,-71.0,-69.0,-66.0,-60.0,-71.0,-70.0,-66.0,-61.0,-80.0,-86.0,-80.0,-87.0,9.0,17.0,14.0,27.0,1
1281,CC:2F:71:3F:1F:24,2418899,617637511,264296,344299412,2154603,273338099,6,195866,239450110,195731,239431624,135,18486,191241,561,264344,32504,6,794,144444.0,43333.0,-68.0,-63.0,-68.0,-69.0,-70.0,-64.0,-71.0,-70.0,-80.0,-86.0,-80.0,-87.0,12.0,23.0,12.0,18.0,1
1282,F8:59:71:5A:E0:3D,2256228,428336217,101623,154997916,2154605,273338301,337,72023,100944753,71933,100931110,90,13643,71674,33,101619,8224,337,45,144444.0,43333.0,-67.0,-72.0,-65.0,-70.0,-67.0,-72.0,-64.0,-70.0,-80.0,-86.0,-80.0,-87.0,13.0,14.0,15.0,17.0,1
1283,CC:2F:71:3E:C5:1F,2154701,273349844,96,11543,2154605,273338301,0,446,37525,377,29185,69,8340,106,1,162,7,0,25,130000.0,39000.0,-71.0,-69.0,-66.0,-60.0,-71.0,-70.0,-66.0,-61.0,-80.0,-86.0,-80.0,-87.0,9.0,17.0,14.0,27.0,1
1284,CC:2F:71:3F:1F:24,2419058,617842395,264453,344504094,2154605,273338301,6,196011,239647426,195876,239628940,135,18486,191386,561,264501,32504,6,794,144444.0,43333.0,-70.0,-62.0,-71.0,-69.0,-69.0,-61.0,-70.0,-68.0,-80.0,-86.0,-80.0,-87.0,10.0,24.0,9.0,18.0,1
1285,F8:59:71:5A:E0:3D,2256297,428433231,101685,155094264,2154612,273338967,337,72084,101038693,71994,101025050,90,13643,71735,33,101681,8224,337,45,144444.0,43333.0,-67.0,-72.0,-65.0,-70.0,-67.0,-71.0,-64.0,-70.0,-80.0,-86.0,-80.0,-87.0,13.0,14.0,15.0,17.0,1
1286,CC:2F:71:3E:C5:1F,2154708,273350510,96,11543,2154612,273338967,0,446,37525,377,29185,69,8340,106,1,162,7,0,25,130000.0,39000.0,-71.0,-69.0,-66.0,-60.0,-71.0,-70.0,-66.0,-61.0,-80.0,-86.0,-80.0,-87.0,9.0,17.0,14.0,27.0,1
1287,CC:2F:71:3F:1F:24,2419221,618046205,264609,344707238,2154612,273338967,6,196149,239838234,196014,239819748,135,18486,191524,561,264657,32505,6,794,144444.0,43333.0,-70.0,-62.0,-71.0,-69.0,-70.0,-61.0,-70.0,-68.0,-80.0,-86.0,-80.0,-87.0,10.0,24.0,9.0,18.0,1
1288,F8:59:71:5A:E0:3D,2256494,428735634,101880,155396465,2154614,273339169,337,72179,101147017,72089,101133374,90,13643,71830,33,101876,8246,337,45,144444.0,43333.0,-66.0,-71.0,-64.0,-70.0,-66.0,-71.0,-64.0,-69.0,-80.0,-86.0,-80.0,-87.0,14.0,15.0,16.0,17.0,1
1289,CC:2F:71:3E:C5:1F,2154710,273350712,96,11543,2154614,273339169,0,446,37525,377,29185,69,8340,106,1,162,7,0,25,130000.0,39000.0,-71.0,-69.0,-66.0,-60.0,-71.0,-70.0,-66.0,-61.0,-80.0,-86.0,-80.0,-87.0,9.0,17.0,14.0,27.0,1
1290,CC:2F:71:3F:1F:24,2419386,618260557,264772,344921388,2154614,273339169,6,196300,240044802,196165,240026316,135,18486,191675,561,264820,32506,6,794,144444.0,43333.0,-70.0,-62.0,-70.0,-69.0,-70.0,-61.0,-70.0,-69.0,-80.0,-86.0,-80.0,-87.0,10.0,24.0,10.0,18.0,1
1291,F8:59:71:5A:E0:3D,2256561,428833940,101943,155494367,2154618,273339573,337,72241,101242497,72151,101228854,90,13643,71892,33,101939,8247,337,45,144444.0,43333.0,-66.0,-72.0,-65.0,-70.0,-66.0,-72.0,-64.0,-70.0,-81.0,-87.0,-80.0,-88.0,15.0,15.0,15.0,18.0,1
1292,CC:2F:71:3E:C5:1F,2154716,273351318,96,11543,2154620,273339775,0,446,37525,377,29185,69,8340,106,1,162,7,0,25,130000.0,39000.0,-71.0,-69.0,-66.0,-60.0,-71.0,-70.0,-66.0,-61.0,-81.0,-87.0,-80.0,-88.0,10.0,18.0,14.0,28.0,1
1293,CC:2F:71:3F:1F:24,2419559,618472613,264939,345132838,2154620,273339775,6,196455,240245252,196320,240226766,135,18486,191829,561,264987,32506,6,794,144444.0,43333.0,-70.0,-62.0,-70.0,-69.0,-69.0,-61.0,-70.0,-68.0,-81.0,-87.0,-80.0,-88.0,11.0,25.0,10.0,19.0,1
1294,F8:59:71:5A:E0:3D,2256665,428980758,102042,155640721,2154623,273340037,337,72313,101347057,72223,101333414,90,13643,71964,33,102038,8247,337,45,144444.0,43333.0,-65.0,-71.0,-65.0,-70.0,-66.0,-71.0,-64.0,-70.0,-81.0,-87.0,-80.0,-88.0,16.0,16.0,15.0,18.0,1
1295,CC:2F:71:3E:C5:1F,2154719,273351580,96,11543,2154623,273340037,0,446,37525,377,29185,69,8340,106,1,162,7,0,25,130000.0,39000.0,-71.0,-69.0,-66.0,-60.0,-71.0,-70.0,-66.0,-61.0,-81.0,-87.0,-80.0,-88.0,10.0,18.0,14.0,28.0,1
1296,CC:2F:71:3F:1F:24,2419720,618679113,265097,345339076,2154623,273340037,6,196598,240442326,196463,240423840,135,18486,191972,561,265145,32506,6,794,144444.0,43333.0,-70.0,-62.0,-71.0,-68.0,-70.0,-61.0,-71.0,-68.0,-81.0,-87.0,-80.0,-88.0,11.0,25.0,9.0,20.0,1
1297,F8:59:71:5A:E0:3D,2256733,429080618,102106,155740177,2154627,273340441,337,72378,101447157,72288,101433514,90,13643,72029,33,102102,8247,337,45,144444.0,43333.0,-67.0,-72.0,-64.0,-70.0,-66.0,-71.0,-64.0,-70.0,-81.0,-87.0,-80.0,-88.0,14.0,15.0,16.0,18.0,1
1298,CC:2F:71:3E:C5:1F,2154723,273351984,96,11543,2154627,273340441,0,446,37525,377,29185,69,8340,106,1,162,7,0,25,130000.0,39000.0,-71.0,-69.0,-66.0,-60.0,-71.0,-70.0,-66.0,-61.0,-80.0,-86.0,-80.0,-87.0,9.0,17.0,14.0,27.0,1
1299,CC:2F:71:3F:1F:24,2419890,618895295,265261,345554652,2154629,273340643,6,196749,240651730,196614,240633244,135,18486,192123,561,265309,32506,6,794,144444.0,43333.0,-71.0,-62.0,-70.0,-69.0,-70.0,-62.0,-70.0,-69.0,-80.0,-86.0,-80.0,-87.0,9.0,24.0,10.0,18.0,1
1300,F8:59:71:5A:E0:3D,2256806,429184044,102175,155843199,2154631,273340845,337,72448,101551157,72358,101537514,90,13643,72099,33,102171,8247,337,45,144444.0,43333.0,-67.0,-72.0,-65.0,-71.0,-66.0,-72.0,-64.0,-70.0,-80.0,-86.0,-80.0,-87.0,13.0,14.0,15.0,16.0,1
1301,CC:2F:71:3E:C5:1F,2154728,273352448,96,11543,2154632,273340905,0,446,37525,377,29185,69,8340,106,1,162,7,0,25,130000.0,39000.0,-71.0,-69.0,-66.0,-60.0,-71.0,-70.0,-66.0,-61.0,-80.0,-86.0,-80.0,-87.0,9.0,17.0,14.0,27.0,1
1302,CC:2F:71:3F:1F:24,2420049,619098701,265417,345757796,2154632,273340905,6,196890,240844310,196755,240825824,135,18486,192264,561,265465,32508,6,794,144444.0,43333.0,-71.0,-62.0,-70.0,-69.0,-70.0,-62.0,-69.0,-69.0,-80.0,-86.0,-80.0,-87.0,9.0,24.0,10.0,18.0,1
1303,F8:59:71:5A:E0:3D,2256874,429280804,102238,155939495,2154636,273341309,337,72511,101646743,72421,101633100,90,13643,72162,33,102234,8247,337,45,144444.0,43333.0,-65.0,-71.0,-64.0,-69.0,-66.0,-71.0,-64.0,-69.0,-80.0,-86.0,-80.0,-87.0,15.0,15.0,16.0,18.0,1
1304,CC:2F:71:3E:C5:1F,2154732,273352852,96,11543,2154636,273341309,0,446,37525,377,29185,69,8340,106,1,162,7,0,25,130000.0,39000.0,-71.0,-69.0,-66.0,-60.0,-71.0,-70.0,-66.0,-61.0,-80.0,-86.0,-80.0,-87.0,9.0,17.0,14.0,27.0,1
1305,CC:2F:71:3F:1F:24,2420226,619327357,265590,345986048,2154636,273341309,6,197052,241064960,196917,241046474,135,18486,192426,561,265638,32508,6,794,144444.0,43333.0,-71.0,-62.0,-70.0,-69.0,-71.0,-62.0,-70.0,-69.0,-80.0,-86.0,-80.0,-87.0,9.0,24.0,10.0,18.0,1
1306,F8:59:71:5A:E0:3D,2256949,429391542,102309,156049829,2154640,273341713,337,72582,101756083,72492,101742440,90,13643,72233,33,102305,8247,337,45,144444.0,43333.0,-67.0,-71.0,-65.0,-70.0,-66.0,-71.0,-64.0,-70.0,-80.0,-86.0,-80.0,-87.0,13.0,15.0,15.0,17.0,1
1307,CC:2F:71:3E:C5:1F,2154736,273353256,96,11543,2154640,273341713,0,446,37525,377,29185,69,8340,106,1,162,7,0,25,130000.0,39000.0,-71.0,-69.0,-66.0,-60.0,-71.0,-70.0,-66.0,-61.0,-80.0,-86.0,-80.0,-87.0,9.0,17.0,14.0,27.0,1
1308,CC:2F:71:3F:1F:24,2420424,619557371,265784,346215658,2154640,273341713,6,197222,241275369,197087,241256883,135,18486,192596,561,265832,32508,6,798,144444.0,43333.0,-71.0,-62.0,-70.0,-69.0,-70.0,-61.0,-69.0,-68.0,-80.0,-86.0,-80.0,-87.0,9.0,24.0,10.0,18.0,1
1309,F8:59:71:5A:E0:3D,2257020,429494570,102375,156152393,2154645,273342177,337,72648,101857737,72558,101844094,90,13643,72298,33,102371,8247,337,45,144444.0,43333.0,-66.0,-71.0,-65.0,-70.0,-66.0,-71.0,-65.0,-69.0,-80.0,-86.0,-80.0,-87.0,14.0,15.0,15.0,17.0,1
1310,CC:2F:71:3E:C5:1F,2154741,273353720,96,11543,2154645,273342177,0,446,37525,377,29185,69,8340,106,1,162,7,0,25,130000.0,39000.0,-71.0,-69.0,-66.0,-60.0,-71.0,-70.0,-66.0,-61.0,-80.0,-86.0,-80.0,-87.0,9.0,17.0,14.0,27.0,1
1311,CC:2F:71:3F:1F:24,2420590,619758923,265945,346416746,2154645,273342177,6,197367,241472899,197232,241454413,135,18486,192741,561,265993,32512,6,798,144444.0,43333.0,-72.0,-63.0,-71.0,-70.0,-71.0,-62.0,-70.0,-69.0,-80.0,-86.0,-80.0,-87.0,8.0,23.0,9.0,17.0,1
1312,F8:59:71:5A:E0:3D,2257083,429589566,102436,156247187,2154647,273342379,337,72713,101956885,72623,101943242,90,13643,72363,33,102432,8247,337,45,144444.0,43333.0,-66.0,-71.0,-65.0,-70.0,-66.0,-71.0,-64.0,-70.0,-80.0,-86.0,-80.0,-87.0,14.0,15.0,15.0,17.0,1
1313,CC:2F:71:3E:C5:1F,2154743,273353922,96,11543,2154647,273342379,0,448,37665,379,29325,69,8340,106,1,163,7,0,25,130000.0,39000.0,-70.0,-69.0,-66.0,-60.0,-71.0,-70.0,-66.0,-61.0,-80.0,-86.0,-80.0,-87.0,10.0,17.0,14.0,27.0,1
1314,CC:2F:71:3F:1F:24,2420770,619969016,266121,346626435,2154649,273342581,6,197524,241672816,197389,241654330,135,18486,192898,561,266169,32512,6,798,144444.0,43333.0,-71.0,-62.0,-69.0,-69.0,-70.0,-62.0,-69.0,-69.0,-80.0,-86.0,-80.0,-87.0,9.0,24.0,11.0,18.0,1
1315,F8:59:71:5A:E0:3D,2257412,430087936,102763,156745355,2154649,273342581,337,72817,102063049,72727,102049406,90,13643,72467,33,102759,8247,337,45,144444.0,43333.0,-67.0,-72.0,-65.0,-70.0,-66.0,-71.0,-64.0,-69.0,-80.0,-86.0,-80.0,-87.0,13.0,14.0,15.0,17.0,1
1316,CC:2F:71:3E:C5:1F,2154747,273354374,97,11659,2154650,273342715,0,450,37805,381,29465,69,8340,106,1,164,7,0,25,130000.0,39000.0,-71.0,-69.0,-65.0,-60.0,-70.0,-68.0,-65.0,-60.0,-80.0,-86.0,-80.0,-87.0,9.0,17.0,15.0,27.0,1
1317,CC:2F:71:3F:1F:24,2420930,620172564,266277,346829579,2154653,273342985,6,197666,241865512,197531,241847026,135,18486,193040,561,266325,32512,6,798,144444.0,43333.0,-71.0,-62.0,-70.0,-69.0,-71.0,-61.0,-69.0,-68.0,-80.0,-86.0,-80.0,-87.0,9.0,24.0,10.0,18.0,1
1318,F8:59:71:5A:E0:3D,2257482,430185223,102825,156841703,2154657,273343520,337,72878,102156989,72788,102143346,90,13643,72528,33,102821,8247,337,45,144444.0,43333.0,-67.0,-72.0,-65.0,-70.0,-67.0,-71.0,-64.0,-69.0,-80.0,-86.0,-80.0,-87.0,13.0,14.0,15.0,17.0,1
1319,CC:2F:71:3E:C5:1F,2154754,273355179,97,11659,2154657,273343520,0,450,37805,381,29465,69,8340,106,1,164,7,0,25,130000.0,39000.0,-71.0,-69.0,-65.0,-60.0,-70.0,-68.0,-65.0,-60.0,-80.0,-86.0,-80.0,-87.0,9.0,17.0,15.0,27.0,1
1320,CC:2F:71:3F:1F:24,2421102,620387484,266445,347043964,2154657,273343520,6,197820,242070130,197685,242051644,135,18486,193194,561,266493,32512,6,799,144444.0,43333.0,-71.0,-62.0,-70.0,-69.0,-70.0,-62.0,-69.0,-69.0,-80.0,-86.0,-80.0,-87.0,9.0,24.0,10.0,18.0,1
1321,F8:59:71:5A:E0:3D,2257552,430287474,102891,156943384,2154661,273344090,337,72944,102257239,72854,102243596,90,13643,72594,33,102887,8248,337,45,144444.0,43333.0,-66.0,-71.0,-65.0,-70.0,-66.0,-71.0,-64.0,-70.0,-80.0,-86.0,-80.0,-87.0,14.0,15.0,15.0,17.0,1
1322,CC:2F:71:3E:C5:1F,2154758,273355749,97,11659,2154661,273344090,0,450,37805,381,29465,69,8340,106,1,164,7,0,25,130000.0,39000.0,-71.0,-69.0,-65.0,-60.0,-70.0,-68.0,-65.0,-60.0,-80.0,-86.0,-80.0,-87.0,9.0,17.0,15.0,27.0,1
1323,CC:2F:71:3F:1F:24,2421269,620590980,266608,347246890,2154661,273344090,6,197964,242263340,197829,242244854,135,18486,193338,561,266650,32512,6,802,144444.0,43333.0,-71.0,-61.0,-69.0,-68.0,-70.0,-61.0,-69.0,-68.0,-80.0,-86.0,-80.0,-87.0,9.0,25.0,11.0,19.0,1
1324,F8:59:71:5A:E0:3D,2257619,430382874,102952,157038178,2154667,273344696,337,73006,102352719,72916,102339076,90,13643,72656,33,102948,8248,337,45,144444.0,43333.0,-66.0,-72.0,-65.0,-70.0,-66.0,-71.0,-64.0,-69.0,-80.0,-86.0,-80.0,-87.0,14.0,14.0,15.0,17.0,1
1325,CC:2F:71:3E:C5:1F,2154764,273356355,97,11659,2154667,273344696,0,450,37805,381,29465,69,8340,106,1,164,7,0,25,130000.0,39000.0,-71.0,-69.0,-65.0,-60.0,-70.0,-68.0,-65.0,-60.0,-80.0,-86.0,-80.0,-87.0,9.0,17.0,15.0,27.0,1
1326,CC:2F:71:3F:1F:24,2421437,620797368,266770,347452672,2154667,273344696,6,198112,242461043,197977,242442557,135,18486,193486,561,266818,32512,6,802,144444.0,43333.0,-71.0,-62.0,-70.0,-69.0,-70.0,-61.0,-69.0,-68.0,-80.0,-86.0,-80.0,-87.0,9.0,24.0,10.0,18.0,1
1327,F8:59:71:5A:E0:3D,2257685,430479546,103014,157134526,2154671,273345020,337,73068,102448199,72978,102434556,90,13643,72718,33,103010,8248,337,45,144444.0,43333.0,-66.0,-71.0,-65.0,-70.0,-66.0,-71.0,-65.0,-70.0,-80.0,-86.0,-80.0,-87.0,14.0,15.0,15.0,17.0,1
1328,CC:2F:71:3E:C5:1F,2154768,273356679,97,11659,2154671,273345020,0,452,37993,382,29535,70,8458,107,1,164,7,0,26,130000.0,39000.0,-71.0,-69.0,-66.0,-60.0,-71.0,-70.0,-66.0,-61.0,-80.0,-86.0,-80.0,-87.0,9.0,17.0,14.0,27.0,1
1329,CC:2F:71:3F:1F:24,2421596,621000706,266925,347655686,2154671,273345020,6,198250,242651851,198115,242633365,135,18486,193624,561,266973,32512,6,802,144444.0,43333.0,-71.0,-62.0,-70.0,-69.0,-70.0,-62.0,-69.0,-68.0,-80.0,-86.0,-80.0,-87.0,9.0,24.0,10.0,18.0,1
1330,F8:59:71:5A:E0:3D,2257751,430576298,103076,157230874,2154675,273345424,337,73129,102542139,73039,102528496,90,13643,72779,33,103072,8248,337,45,144444.0,43333.0,-67.0,-72.0,-65.0,-70.0,-66.0,-71.0,-64.0,-70.0,-80.0,-86.0,-80.0,-87.0,13.0,14.0,15.0,17.0,1
1331,CC:2F:71:3E:C5:1F,2154774,273357285,97,11659,2154677,273345626,0,452,37993,382,29535,70,8458,107,1,164,7,0,26,130000.0,39000.0,-71.0,-69.0,-66.0,-60.0,-71.0,-70.0,-66.0,-61.0,-80.0,-86.0,-80.0,-87.0,9.0,17.0,14.0,27.0,1
1332,CC:2F:71:3F:1F:24,2421755,621201218,267078,347855592,2154677,273345626,6,198389,242844199,198254,242825713,135,18486,193763,561,267126,32512,6,802,144444.0,43333.0,-71.0,-62.0,-70.0,-69.0,-70.0,-62.0,-69.0,-68.0,-80.0,-86.0,-80.0,-87.0,9.0,24.0,10.0,18.0,1
1333,F8:59:71:5A:E0:3D,2257879,430760750,103200,157414922,2154679,273345828,337,73213,102646874,73123,102633231,90,13643,72863,33,103196,8248,337,45,144444.0,43333.0,-66.0,-71.0,-64.0,-70.0,-66.0,-71.0,-64.0,-70.0,-80.0,-86.0,-80.0,-87.0,14.0,15.0,16.0,17.0,1
1334,CC:2F:71:3E:C5:1F,2154776,273357487,97,11659,2154679,273345828,0,452,37993,382,29535,70,8458,107,1,164,7,0,26,130000.0,39000.0,-71.0,-69.0,-66.0,-60.0,-71.0,-70.0,-66.0,-61.0,-80.0,-86.0,-80.0,-87.0,9.0,17.0,14.0,27.0,1
1335,CC:2F:71:3F:1F:24,2421929,621412499,267242,348063761,2154687,273348738,6,198540,243041278,198405,243022792,135,18486,193914,561,267290,32513,6,802,144444.0,43333.0,-71.0,-62.0,-70.0,-69.0,-71.0,-61.0,-70.0,-68.0,-80.0,-86.0,-80.0,-87.0,9.0,24.0,10.0,18.0,1
1336,F8:59:71:5A:E0:3D,2257984,430902390,103291,157553126,2154693,273349264,337,73282,102747854,73191,102734093,91,13761,72931,33,103287,8248,337,45,144444.0,43333.0,-67.0,-71.0,-65.0,-69.0,-66.0,-71.0,-64.0,-69.0,-80.0,-86.0,-80.0,-87.0,13.0,15.0,15.0,18.0,1
1337,CC:2F:71:3E:C5:1F,2154790,273360923,97,11659,2154693,273349264,0,452,37993,382,29535,70,8458,107,1,164,7,0,26,130000.0,39000.0,-71.0,-69.0,-66.0,-60.0,-71.0,-70.0,-66.0,-61.0,-80.0,-86.0,-80.0,-87.0,9.0,17.0,14.0,27.0,1
1338,CC:2F:71:3F:1F:24,2422099,621618724,267406,348269460,2154693,273349264,6,198686,243236038,198551,243217552,135,18486,194060,561,267453,32514,6,802,144444.0,43333.0,-71.0,-63.0,-71.0,-70.0,-70.0,-62.0,-70.0,-69.0,-80.0,-86.0,-80.0,-87.0,9.0,23.0,9.0,17.0,1
1339,F8:59:71:5A:E0:3D,2258055,431001219,103357,157651489,2154698,273349730,337,73348,102847046,73257,102833285,91,13761,72997,33,103352,8248,337,45,144444.0,43333.0,-67.0,-71.0,-65.0,-70.0,-66.0,-70.0,-65.0,-69.0,-80.0,-86.0,-80.0,-87.0,13.0,15.0,15.0,17.0,1
1340,CC:2F:71:3E:C5:1F,2154795,273361389,97,11659,2154698,273349730,0,452,37993,382,29535,70,8458,107,1,164,7,0,26,130000.0,39000.0,-71.0,-69.0,-66.0,-60.0,-71.0,-70.0,-66.0,-61.0,-80.0,-86.0,-80.0,-87.0,9.0,17.0,14.0,27.0,1
1341,CC:2F:71:3F:1F:24,2422267,621822791,267569,348473061,2154698,273349730,6,198832,243432657,198696,243414053,136,18604,194206,561,267617,32515,6,802,144444.0,43333.0,-71.0,-62.0,-70.0,-69.0,-70.0,-62.0,-70.0,-69.0,-80.0,-86.0,-80.0,-87.0,9.0,24.0,10.0,18.0,1
1342,F8:59:71:5A:E0:3D,2258127,431100268,103425,157750134,2154702,273350134,337,73418,102946803,73327,102933042,91,13761,73067,33,103421,8248,337,45,144444.0,43333.0,-66.0,-71.0,-65.0,-70.0,-66.0,-70.0,-64.0,-70.0,-80.0,-86.0,-81.0,-87.0,14.0,15.0,16.0,17.0,1
1343,CC:2F:71:3E:C5:1F,2154799,273361793,97,11659,2154702,273350134,0,452,37993,382,29535,70,8458,107,1,164,7,0,26,130000.0,39000.0,-71.0,-69.0,-66.0,-60.0,-71.0,-70.0,-66.0,-61.0,-80.0,-86.0,-81.0,-87.0,9.0,17.0,15.0,27.0,1
1344,CC:2F:71:3F:1F:24,2422427,622026339,267725,348676205,2154702,273350134,6,198973,243626661,198837,243608057,136,18604,194347,561,267772,32516,6,802,144444.0,43333.0,-71.0,-62.0,-70.0,-69.0,-70.0,-62.0,-70.0,-68.0,-80.0,-86.0,-81.0,-87.0,9.0,24.0,11.0,18.0,1
1345,F8:59:71:5A:E0:3D,2258192,431196878,103487,157846482,2154705,273350396,337,73480,103042283,73389,103028522,91,13761,73129,33,103482,8248,337,45,144444.0,43333.0,-67.0,-71.0,-65.0,-70.0,-66.0,-71.0,-64.0,-70.0,-80.0,-86.0,-81.0,-87.0,13.0,15.0,16.0,17.0,1
1346,CC:2F:71:3E:C5:1F,2154802,273362055,97,11659,2154705,273350396,0,452,37993,382,29535,70,8458,107,1,164,7,0,26,130000.0,39000.0,-71.0,-69.0,-66.0,-60.0,-71.0,-70.0,-66.0,-61.0,-80.0,-86.0,-81.0,-87.0,9.0,17.0,15.0,27.0,1
1347,CC:2F:71:3F:1F:24,2422596,622232124,267889,348881526,2154707,273350598,6,199126,243821187,198990,243802583,136,18604,194500,561,267937,32516,6,802,144444.0,43333.0,-70.0,-62.0,-69.0,-68.0,-70.0,-61.0,-69.0,-68.0,-80.0,-86.0,-81.0,-87.0,10.0,24.0,12.0,19.0,1
1348,F8:59:71:5A:E0:3D,2258255,431291874,103548,157941276,2154707,273350598,337,73541,103136223,73450,103122462,91,13761,73190,33,103544,8248,337,45,144444.0,43333.0,-67.0,-71.0,-64.0,-70.0,-66.0,-71.0,-64.0,-70.0,-80.0,-86.0,-81.0,-87.0,13.0,15.0,17.0,17.0,1
1349,CC:2F:71:3E:C5:1F,2154804,273362257,97,11659,2154707,273350598,0,452,37993,382,29535,70,8458,107,1,164,7,0,26,130000.0,39000.0,-71.0,-69.0,-66.0,-60.0,-71.0,-70.0,-66.0,-61.0,-80.0,-86.0,-81.0,-87.0,9.0,17.0,15.0,27.0,1
1350,CC:2F:71:3F:1F:24,2422761,622443442,268050,349092440,2154711,273351002,6,199272,244024329,199136,244005725,136,18604,194645,561,268098,32517,6,802,144444.0,43333.0,-70.0,-62.0,-69.0,-68.0,-70.0,-61.0,-69.0,-68.0,-80.0,-86.0,-81.0,-87.0,10.0,24.0,12.0,19.0,1
1351,F8:59:71:5A:E0:3D,2258327,431392220,103614,158041016,2154713,273351204,337,73607,103236467,73516,103222706,91,13761,73256,33,103610,8248,337,45,144444.0,43333.0,-67.0,-71.0,-65.0,-70.0,-66.0,-71.0,-65.0,-70.0,-80.0,-86.0,-81.0,-87.0,13.0,15.0,16.0,17.0,1
1352,CC:2F:71:3E:C5:1F,2154810,273362863,97,11659,2154713,273351204,0,452,37993,382,29535,70,8458,107,1,164,7,0,26,130000.0,39000.0,-71.0,-69.0,-66.0,-60.0,-71.0,-70.0,-66.0,-61.0,-80.0,-86.0,-81.0,-87.0,9.0,17.0,15.0,27.0,1
1353,CC:2F:71:3F:1F:24,2422922,622650065,268209,349298861,2154713,273351204,6,199418,244221800,199282,244203196,136,18604,194791,561,268257,32517,6,802,144444.0,43333.0,-71.0,-62.0,-70.0,-69.0,-70.0,-61.0,-69.0,-68.0,-80.0,-86.0,-81.0,-87.0,9.0,24.0,11.0,18.0,1
1354,F8:59:71:5A:E0:3D,2258394,431491938,103678,158140472,2154716,273351466,337,73671,103335027,73580,103321266,91,13761,73320,33,103674,8249,337,45,144444.0,43333.0,-67.0,-71.0,-65.0,-70.0,-66.0,-71.0,-65.0,-70.0,-81.0,-86.0,-81.0,-87.0,14.0,15.0,16.0,17.0,1
1355,CC:2F:71:3E:C5:1F,2154813,273363125,97,11659,2154716,273351466,0,452,37993,382,29535,70,8458,107,1,164,7,0,26,130000.0,39000.0,-71.0,-69.0,-66.0,-60.0,-71.0,-70.0,-66.0,-61.0,-81.0,-86.0,-81.0,-87.0,10.0,17.0,15.0,27.0,1
1356,CC:2F:71:3F:1F:24,2423083,622856579,268367,349505113,2154716,273351466,6,199562,244419000,199426,244400396,136,18604,194935,561,268415,32517,6,802,144444.0,43333.0,-71.0,-62.0,-70.0,-69.0,-70.0,-61.0,-69.0,-68.0,-81.0,-86.0,-81.0,-87.0,10.0,24.0,11.0,18.0,1
1357,F8:59:71:5A:E0:3D,2258593,431791333,103871,158439261,2154722,273352072,337,73761,103439983,73670,103426222,91,13761,73410,33,103867,8264,337,45,144444.0,43333.0,-67.0,-72.0,-65.0,-70.0,-66.0,-71.0,-65.0,-70.0,-81.0,-86.0,-81.0,-87.0,14.0,14.0,16.0,17.0,1
1358,CC:2F:71:3E:C5:1F,2154819,273363731,97,11659,2154722,273352072,0,452,37993,382,29535,70,8458,107,1,164,7,0,26,130000.0,39000.0,-71.0,-69.0,-66.0,-60.0,-71.0,-70.0,-66.0,-61.0,-81.0,-86.0,-81.0,-87.0,10.0,17.0,15.0,27.0,1
1359,CC:2F:71:3F:1F:24,2423277,623080839,268555,349728767,2154722,273352072,6,199733,244632728,199597,244614124,136,18604,195104,561,268603,32521,6,811,144444.0,43333.0,-72.0,-63.0,-71.0,-70.0,-71.0,-62.0,-70.0,-69.0,-81.0,-86.0,-81.0,-87.0,9.0,23.0,10.0,17.0,1
1360,F8:59:71:5A:E0:3D,2258871,432206087,104137,158852672,2154734,273353415,337,73952,103719265,73861,103705504,91,13761,73600,33,104133,8296,337,46,144444.0,43333.0,-66.0,-69.0,-65.0,-70.0,-66.0,-70.0,-65.0,-69.0,-81.0,-86.0,-81.0,-87.0,15.0,17.0,16.0,17.0,1
1361,CC:2F:71:3E:C5:1F,2154836,273365538,97,11659,2154739,273353879,0,452,37993,382,29535,70,8458,107,1,164,7,0,26,130000.0,39000.0,-71.0,-69.0,-66.0,-60.0,-71.0,-70.0,-66.0,-61.0,-81.0,-86.0,-81.0,-87.0,10.0,17.0,15.0,27.0,1
1362,CC:2F:71:3F:1F:24,2423902,623953362,269161,350599281,2154741,273354081,6,200345,245507664,200209,245489060,136,18604,195664,561,269208,32525,6,870,144444.0,43333.0,-67.0,-63.0,-67.0,-70.0,-69.0,-64.0,-70.0,-70.0,-80.0,-85.0,-80.0,-86.0,13.0,22.0,13.0,16.0,1
1363,F8:59:71:5A:E0:3D,2259084,432518047,104337,159163360,2154747,273354687,337,74147,104020363,74056,104006602,91,13761,73795,33,104333,8296,337,46,144444.0,39000.0,-66.0,-71.0,-65.0,-70.0,-66.0,-70.0,-65.0,-69.0,-80.0,-85.0,-80.0,-86.0,14.0,14.0,15.0,16.0,1
1364,CC:2F:71:3E:C5:1F,2154844,273366346,97,11659,2154747,273354687,0,452,37993,382,29535,70,8458,107,1,164,7,0,26,130000.0,39000.0,-71.0,-69.0,-66.0,-60.0,-71.0,-70.0,-66.0,-61.0,-80.0,-85.0,-80.0,-86.0,9.0,16.0,14.0,26.0,1
1365,CC:2F:71:3F:1F:24,2424134,624262548,269387,350907861,2154747,273354687,6,200560,245805356,200424,245786752,136,18604,195853,561,269435,32528,6,883,144444.0,43333.0,-71.0,-62.0,-69.0,-69.0,-70.0,-62.0,-69.0,-69.0,-80.0,-85.0,-80.0,-86.0,9.0,23.0,11.0,17.0,1
1366,F8:59:71:5A:E0:3D,2259219,432714831,104469,159359882,2154750,273354949,337,74232,104126280,74141,104112519,91,13761,73880,33,104465,8312,337,46,144444.0,43333.0,-67.0,-71.0,-65.0,-70.0,-66.0,-71.0,-65.0,-70.0,-80.0,-85.0,-80.0,-86.0,13.0,14.0,15.0,16.0,1
1367,CC:2F:71:3E:C5:1F,2154847,273366608,97,11659,2154750,273354949,0,452,37993,382,29535,70,8458,107,1,164,7,0,26,130000.0,39000.0,-71.0,-69.0,-66.0,-60.0,-71.0,-70.0,-66.0,-61.0,-80.0,-85.0,-80.0,-86.0,9.0,16.0,14.0,26.0,1
1368,CC:2F:71:3F:1F:24,2424296,624467710,269544,351112559,2154752,273355151,6,200700,245999244,200564,245980640,136,18604,195993,561,269592,32528,6,883,144444.0,43333.0,-70.0,-62.0,-70.0,-69.0,-70.0,-62.0,-69.0,-69.0,-80.0,-85.0,-80.0,-86.0,10.0,23.0,10.0,17.0,1
1369,F8:59:71:5A:E0:3D,2259315,432849960,104561,159494607,2154754,273355353,337,74302,104227399,74211,104213638,91,13761,73950,33,104557,8312,337,46,144444.0,43333.0,-66.0,-71.0,-65.0,-70.0,-66.0,-71.0,-65.0,-70.0,-80.0,-85.0,-80.0,-86.0,14.0,14.0,15.0,16.0,1
1370,CC:2F:71:3E:C5:1F,2154853,273367214,97,11659,2154756,273355555,0,452,37993,382,29535,70,8458,107,1,164,7,0,26,130000.0,39000.0,-71.0,-69.0,-66.0,-60.0,-71.0,-70.0,-66.0,-61.0,-80.0,-85.0,-80.0,-86.0,9.0,16.0,14.0,26.0,1
1371,CC:2F:71:3F:1F:24,2424457,624671393,269701,351315838,2154756,273355555,6,200845,246196565,200709,246177961,136,18604,196138,561,269749,32529,6,883,144444.0,43333.0,-71.0,-62.0,-69.0,-69.0,-70.0,-62.0,-69.0,-68.0,-80.0,-85.0,-80.0,-86.0,9.0,23.0,11.0,17.0,1
1372,F8:59:71:5A:E0:3D,2259386,432948843,104628,159593086,2154758,273355757,337,74368,104325157,74277,104311396,91,13761,74016,33,104624,8312,337,46,144444.0,43333.0,-67.0,-71.0,-65.0,-70.0,-66.0,-70.0,-65.0,-70.0,-80.0,-85.0,-80.0,-86.0,13.0,14.0,15.0,16.0,1
1373,CC:2F:71:3E:C5:1F,2154855,273367416,97,11659,2154758,273355757,0,452,37993,382,29535,70,8458,107,1,164,7,0,26,130000.0,39000.0,-71.0,-69.0,-66.0,-60.0,-71.0,-70.0,-66.0,-61.0,-80.0,-85.0,-80.0,-86.0,9.0,16.0,14.0,26.0,1
1374,CC:2F:71:3F:1F:24,2424638,624903190,269880,351547433,2154758,273355757,6,201009,246413694,200873,246395090,136,18604,196302,561,269928,32529,6,885,144444.0,43333.0,-72.0,-63.0,-71.0,-70.0,-71.0,-62.0,-70.0,-69.0,-80.0,-85.0,-80.0,-86.0,8.0,22.0,9.0,16.0,1
1375,F8:59:71:5A:E0:3D,2259479,433078949,104714,159722526,2154765,273356423,337,74459,104461511,74368,104447750,91,13761,74106,33,104710,8317,337,46,144444.0,43333.0,-67.0,-71.0,-65.0,-70.0,-66.0,-71.0,-65.0,-70.0,-80.0,-85.0,-80.0,-86.0,13.0,14.0,15.0,16.0,1
1376,CC:2F:71:3E:C5:1F,2154862,273368082,97,11659,2154765,273356423,0,452,37993,382,29535,70,8458,107,1,164,7,0,26,130000.0,39000.0,-71.0,-69.0,-66.0,-60.0,-71.0,-70.0,-66.0,-61.0,-80.0,-85.0,-80.0,-87.0,9.0,16.0,14.0,27.0,1
1377,CC:2F:71:3F:1F:24,2424897,625234473,270132,351878050,2154765,273356423,6,201243,246735649,201107,246717045,136,18604,196536,561,270180,32530,6,899,144444.0,43333.0,-71.0,-63.0,-70.0,-70.0,-70.0,-64.0,-70.0,-70.0,-80.0,-85.0,-80.0,-87.0,9.0,22.0,10.0,17.0,1
1378,F8:59:71:5A:E0:3D,2259596,433253527,104826,159896574,2154770,273356953,337,74569,104630911,74478,104617150,91,13761,74216,33,104822,8317,337,46,144444.0,43333.0,-67.0,-72.0,-65.0,-70.0,-66.0,-71.0,-64.0,-70.0,-81.0,-87.0,-81.0,-88.0,14.0,15.0,16.0,18.0,1
1379,CC:2F:71:3E:C5:1F,2154867,273368612,97,11659,2154770,273356953,0,452,37993,382,29535,70,8458,107,1,164,7,0,26,130000.0,39000.0,-71.0,-69.0,-66.0,-60.0,-71.0,-70.0,-66.0,-61.0,-81.0,-87.0,-81.0,-88.0,10.0,18.0,15.0,28.0,1
1380,CC:2F:71:3F:1F:24,2425126,625540897,270354,352183742,2154772,273357155,6,201448,247030103,201312,247011499,136,18604,196741,561,270400,32530,6,910,144444.0,43333.0,-68.0,-63.0,-68.0,-69.0,-71.0,-66.0,-70.0,-71.0,-81.0,-87.0,-81.0,-88.0,13.0,24.0,13.0,19.0,1
1381,F8:59:71:5A:E0:3D,2259676,433370541,104901,160013124,2154775,273357417,337,74647,104751073,74556,104737312,91,13761,74291,33,104897,8318,337,46,144444.0,43333.0,-67.0,-71.0,-65.0,-70.0,-66.0,-71.0,-65.0,-70.0,-81.0,-87.0,-81.0,-88.0,14.0,16.0,16.0,18.0,1
1382,CC:2F:71:3E:C5:1F,2154874,273369278,97,11659,2154777,273357619,0,453,38063,383,29605,70,8458,107,1,165,7,0,26,130000.0,39000.0,-71.0,-69.0,-66.0,-60.0,-71.0,-70.0,-66.0,-61.0,-81.0,-87.0,-81.0,-88.0,10.0,18.0,15.0,28.0,1
1383,CC:2F:71:3F:1F:24,2425293,625753797,270516,352396178,2154777,273357619,6,201598,247237061,201462,247218457,136,18604,196891,561,270564,32530,6,916,144444.0,43333.0,-70.0,-62.0,-70.0,-69.0,-70.0,-62.0,-70.0,-69.0,-81.0,-87.0,-81.0,-88.0,11.0,25.0,11.0,19.0,1
1384,F8:59:71:5A:E0:3D,2259744,433468963,104965,160111142,2154779,273357821,337,74710,104848093,74619,104834332,91,13761,74354,33,104961,8319,337,46,144444.0,43333.0,-66.0,-71.0,-65.0,-70.0,-65.0,-71.0,-64.0,-70.0,-81.0,-87.0,-81.0,-88.0,15.0,16.0,16.0,18.0,1
1385,CC:2F:71:3E:C5:1F,2154877,273369596,98,11775,2154779,273357821,0,456,38273,386,29815,70,8458,107,1,166,7,0,26,130000.0,39000.0,-70.0,-69.0,-66.0,-60.0,-71.0,-72.0,-67.0,-63.0,-81.0,-87.0,-81.0,-88.0,11.0,18.0,15.0,28.0,1
1386,CC:2F:71:3F:1F:24,2425470,625975114,270691,352617293,2154779,273357821,6,201759,247448127,201623,247429523,136,18604,197052,561,270739,32530,6,916,144444.0,43333.0,-71.0,-62.0,-69.0,-69.0,-70.0,-61.0,-69.0,-68.0,-81.0,-87.0,-81.0,-88.0,10.0,25.0,12.0,19.0,1
1387,F8:59:71:5A:E0:3D,2260129,434061607,105345,160703109,2154784,273358498,337,74821,104961521,74730,104947760,91,13761,74465,33,105341,8362,337,46,144444.0,43333.0,-67.0,-72.0,-65.0,-70.0,-66.0,-72.0,-65.0,-70.0,-80.0,-86.0,-81.0,-87.0,13.0,14.0,16.0,17.0,1
1388,CC:2F:71:3E:C5:1F,2154882,273370273,98,11775,2154784,273358498,0,456,38273,386,29815,70,8458,107,1,166,7,0,26,130000.0,39000.0,-70.0,-69.0,-66.0,-60.0,-71.0,-72.0,-67.0,-63.0,-80.0,-86.0,-81.0,-87.0,10.0,17.0,15.0,27.0,1
1389,CC:2F:71:3F:1F:24,2425633,626182043,270849,352823545,2154784,273358498,6,201899,247640591,201763,247621987,136,18604,197192,561,270897,32530,6,916,144444.0,43333.0,-70.0,-62.0,-69.0,-68.0,-70.0,-62.0,-69.0,-68.0,-80.0,-86.0,-81.0,-87.0,10.0,24.0,12.0,19.0,1
1390,F8:59:71:5A:E0:3D,2260198,434161527,105409,160802565,2154789,273358962,337,74885,105060081,74794,105046320,91,13761,74529,33,105405,8362,337,46,144444.0,43333.0,-67.0,-72.0,-66.0,-69.0,-67.0,-72.0,-65.0,-69.0,-80.0,-86.0,-81.0,-87.0,13.0,14.0,15.0,18.0,1
1391,CC:2F:71:3E:C5:1F,2154887,273370737,98,11775,2154789,273358962,0,456,38273,386,29815,70,8458,107,1,166,7,0,26,130000.0,39000.0,-70.0,-69.0,-66.0,-60.0,-71.0,-72.0,-67.0,-63.0,-80.0,-86.0,-81.0,-87.0,10.0,17.0,15.0,27.0,1
1392,CC:2F:71:3F:1F:24,2425797,626390145,271008,353031183,2154789,273358962,6,202045,247842295,201909,247823691,136,18604,197338,561,271056,32531,6,916,144444.0,43333.0,-70.0,-63.0,-70.0,-70.0,-69.0,-62.0,-69.0,-69.0,-80.0,-86.0,-81.0,-87.0,10.0,23.0,11.0,17.0,1
1393,F8:59:71:5A:E0:3D,2260266,434261387,105473,160902021,2154793,273359366,337,74949,105158641,74858,105144880,91,13761,74593,33,105469,8362,337,46,144444.0,43333.0,-66.0,-72.0,-65.0,-70.0,-66.0,-71.0,-64.0,-69.0,-80.0,-86.0,-81.0,-87.0,14.0,14.0,16.0,17.0,1
1394,CC:2F:71:3E:C5:1F,2154891,273371141,98,11775,2154793,273359366,0,456,38273,386,29815,70,8458,107,1,166,7,0,26,130000.0,39000.0,-70.0,-69.0,-66.0,-60.0,-71.0,-72.0,-67.0,-63.0,-80.0,-86.0,-81.0,-87.0,10.0,17.0,15.0,27.0,1
1395,CC:2F:71:3F:1F:24,2425960,626598341,271167,353238975,2154793,273359366,6,202190,248041025,202054,248022421,136,18604,197483,561,271215,32533,6,916,144444.0,43333.0,-71.0,-62.0,-70.0,-68.0,-70.0,-62.0,-69.0,-68.0,-80.0,-86.0,-81.0,-87.0,9.0,24.0,11.0,19.0,1
1396,F8:59:71:5A:E0:3D,2260358,434375203,105539,161004585,2154819,273370618,337,75015,105260281,74924,105246520,91,13761,74659,33,105535,8362,337,46,144444.0,43333.0,-67.0,-72.0,-65.0,-71.0,-66.0,-72.0,-64.0,-70.0,-80.0,-86.0,-81.0,-87.0,13.0,14.0,16.0,16.0,1
1397,CC:2F:71:3E:C5:1F,2154918,273382453,98,11775,2154820,273370678,0,456,38273,386,29815,70,8458,107,1,166,7,0,26,130000.0,39000.0,-70.0,-69.0,-66.0,-60.0,-71.0,-72.0,-67.0,-63.0,-80.0,-86.0,-81.0,-87.0,10.0,17.0,15.0,27.0,1
1398,CC:2F:71:3F:1F:24,2426201,626839775,271381,353469097,2154820,273370678,6,202385,248261632,202249,248243028,136,18604,197678,561,271429,32535,6,916,144444.0,43333.0,-71.0,-62.0,-69.0,-67.0,-71.0,-62.0,-69.0,-67.0,-80.0,-86.0,-81.0,-87.0,9.0,24.0,12.0,20.0,1
1399,F8:59:71:5A:E0:3D,2260425,434472015,105601,161100933,2154824,273371082,337,75077,105355761,74986,105342000,91,13761,74721,33,105597,8362,337,46,144444.0,43333.0,-66.0,-73.0,-65.0,-71.0,-66.0,-72.0,-64.0,-70.0,-80.0,-86.0,-81.0,-87.0,14.0,13.0,16.0,16.0,1
1400,CC:2F:71:3E:C5:1F,2154923,273382919,98,11775,2154825,273371144,0,457,38391,386,29815,71,8576,108,1,166,7,0,26,130000.0,39000.0,-71.0,-69.0,-66.0,-60.0,-71.0,-72.0,-67.0,-63.0,-80.0,-86.0,-81.0,-87.0,9.0,17.0,15.0,27.0,1
1401,CC:2F:71:3F:1F:24,2426370,627045833,271545,353674689,2154825,273371144,6,202537,248468197,202401,248449593,136,18604,197830,561,271593,32535,6,916,144444.0,43333.0,-70.0,-61.0,-68.0,-69.0,-70.0,-61.0,-68.0,-69.0,-80.0,-86.0,-81.0,-87.0,10.0,25.0,13.0,18.0,1
1402,F8:59:71:5A:E0:3D,2260501,434581377,105672,161209829,2154829,273371548,337,75150,105466747,75059,105452986,91,13761,74794,33,105668,8362,337,46,144444.0,43333.0,-66.0,-73.0,-66.0,-70.0,-66.0,-72.0,-65.0,-70.0,-80.0,-85.0,-80.0,-86.0,14.0,12.0,14.0,16.0,1
1403,CC:2F:71:3E:C5:1F,2154927,273383323,98,11775,2154829,273371548,0,458,38461,387,29885,71,8576,108,1,166,7,0,26,130000.0,39000.0,-71.0,-69.0,-66.0,-60.0,-71.0,-72.0,-68.0,-63.0,-80.0,-85.0,-80.0,-86.0,9.0,16.0,14.0,26.0,1
1404,CC:2F:71:3F:1F:24,2427751,628796959,272922,355425411,2154829,273371548,6,203039,248817568,202903,248798964,136,18604,198332,561,272970,32547,6,916,144444.0,43333.0,-72.0,-63.0,-69.0,-69.0,-72.0,-62.0,-69.0,-68.0,-80.0,-85.0,-80.0,-86.0,8.0,22.0,11.0,17.0,1
1405,F8:59:71:5A:E0:3D,2260579,434695283,105745,161323271,2154834,273372012,337,75221,105576087,75130,105562326,91,13761,74865,33,105741,8362,337,46,144444.0,43333.0,-65.0,-73.0,-65.0,-70.0,-65.0,-72.0,-65.0,-70.0,-80.0,-85.0,-80.0,-86.0,15.0,12.0,15.0,16.0,1
1406,CC:2F:71:3E:C5:1F,2154932,273383787,98,11775,2154834,273372012,0,458,38461,387,29885,71,8576,108,1,166,7,0,26,130000.0,39000.0,-71.0,-69.0,-66.0,-60.0,-71.0,-72.0,-68.0,-63.0,-80.0,-85.0,-80.0,-86.0,9.0,16.0,14.0,26.0,1
1407,CC:2F:71:3F:1F:24,2428108,629254670,273274,355882658,2154834,273372012,6,203259,249035279,203123,249016675,136,18604,198552,561,273321,32547,6,923,144444.0,43333.0,-70.0,-62.0,-69.0,-68.0,-70.0,-62.0,-68.0,-68.0,-80.0,-85.0,-80.0,-86.0,10.0,23.0,11.0,18.0,1
1408,F8:59:71:5A:E0:3D,2260920,435213364,106082,161840948,2154838,273372416,337,75350,105696733,75259,105682972,91,13761,74994,33,106078,8400,337,46,144444.0,43333.0,-66.0,-73.0,-65.0,-71.0,-65.0,-72.0,-65.0,-70.0,-80.0,-85.0,-80.0,-86.0,14.0,12.0,15.0,15.0,1
1409,CC:2F:71:3E:C5:1F,2154936,273384191,98,11775,2154838,273372416,0,458,38461,387,29885,71,8576,108,1,166,7,0,26,130000.0,39000.0,-71.0,-69.0,-66.0,-60.0,-71.0,-72.0,-68.0,-63.0,-80.0,-85.0,-80.0,-86.0,9.0,16.0,14.0,26.0,1
1410,CC:2F:71:3F:1F:24,2428311,629483229,273473,356110813,2154838,273372416,6,203435,249256419,203299,249237815,136,18604,198728,561,273521,32547,6,923,144444.0,43333.0,-71.0,-62.0,-69.0,-68.0,-70.0,-62.0,-69.0,-68.0,-80.0,-85.0,-80.0,-86.0,9.0,23.0,11.0,18.0,1
1411,F8:59:71:5A:E0:3D,2260992,435319440,106150,161946620,2154842,273372820,337,75419,105803063,75328,105789302,91,13761,75063,33,106145,8400,337,46,144444.0,43333.0,-67.0,-73.0,-64.0,-69.0,-67.0,-72.0,-64.0,-70.0,-80.0,-85.0,-80.0,-86.0,13.0,12.0,16.0,17.0,1
1412,CC:2F:71:3E:C5:1F,2154940,273384595,98,11775,2154842,273372820,0,458,38461,387,29885,71,8576,108,1,166,7,0,26,130000.0,39000.0,-71.0,-69.0,-66.0,-60.0,-71.0,-72.0,-68.0,-63.0,-80.0,-85.0,-80.0,-86.0,9.0,16.0,14.0,26.0,1
1413,CC:2F:71:3F:1F:24,2428487,629711641,273645,356338821,2154842,273372820,6,203592,249473695,203456,249455091,136,18604,198885,561,273693,32548,6,926,144444.0,43333.0,-71.0,-63.0,-70.0,-70.0,-70.0,-62.0,-69.0,-69.0,-80.0,-85.0,-80.0,-86.0,9.0,22.0,10.0,16.0,1
1414,F8:59:71:5A:E0:3D,2261065,435421372,106218,162048088,2154847,273373284,337,75487,105903983,75396,105890222,91,13761,75131,33,106214,8400,337,46,144444.0,43333.0,-66.0,-72.0,-66.0,-70.0,-66.0,-72.0,-65.0,-70.0,-80.0,-85.0,-80.0,-86.0,14.0,13.0,14.0,16.0,1
1415,CC:2F:71:3E:C5:1F,2154945,273385059,98,11775,2154847,273373284,0,458,38461,387,29885,71,8576,108,1,166,7,0,26,130000.0,39000.0,-71.0,-69.0,-66.0,-60.0,-71.0,-72.0,-68.0,-63.0,-80.0,-85.0,-80.0,-86.0,9.0,16.0,14.0,26.0,1
1416,CC:2F:71:3F:1F:24,2428647,629915119,273800,356541835,2154847,273373284,6,203736,249670965,203600,249652361,136,18604,199029,561,273848,32548,6,928,144444.0,43333.0,-70.0,-62.0,-71.0,-69.0,-69.0,-61.0,-70.0,-69.0,-80.0,-85.0,-80.0,-86.0,10.0,23.0,9.0,17.0,1
1417,F8:59:71:5A:E0:3D,2261136,435518911,106285,162145223,2154851,273373688,337,75551,105999299,75460,105985538,91,13761,75195,33,106281,8400,337,46,144444.0,43333.0,-67.0,-72.0,-64.0,-71.0,-67.0,-72.0,-65.0,-71.0,-80.0,-85.0,-80.0,-86.0,13.0,13.0,16.0,15.0,1
1418,CC:2F:71:3E:C5:1F,2154949,273385463,98,11775,2154851,273373688,0,458,38461,387,29885,71,8576,108,1,166,7,0,26,130000.0,39000.0,-71.0,-69.0,-66.0,-60.0,-71.0,-72.0,-68.0,-63.0,-80.0,-85.0,-80.0,-86.0,9.0,16.0,14.0,26.0,1
1419,CC:2F:71:3F:1F:24,2428808,630120221,273957,356746533,2154851,273373688,6,203878,249865085,203742,249846481,136,18604,199171,561,274005,32549,6,928,144444.0,43333.0,-71.0,-62.0,-71.0,-70.0,-70.0,-62.0,-70.0,-69.0,-80.0,-85.0,-80.0,-86.0,9.0,23.0,9.0,16.0,1
1420,F8:59:71:5A:E0:3D,2261332,435815460,106479,162441570,2154853,273373890,337,75631,106105011,75540,106091250,91,13761,75275,33,106475,8401,337,47,144444.0,43333.0,-67.0,-72.0,-65.0,-70.0,-67.0,-73.0,-64.0,-70.0,-80.0,-85.0,-80.0,-86.0,13.0,13.0,15.0,16.0,1
1421,CC:2F:71:3E:C5:1F,2154951,273385665,98,11775,2154853,273373890,0,458,38461,387,29885,71,8576,108,1,166,7,0,26,130000.0,39000.0,-71.0,-69.0,-66.0,-60.0,-71.0,-72.0,-68.0,-63.0,-80.0,-85.0,-80.0,-86.0,9.0,16.0,14.0,26.0,1
1422,CC:2F:71:3F:1F:24,2428987,630328204,274132,356954112,2154855,273374092,6,204037,250064870,203901,250046266,136,18604,199330,561,274180,32549,6,928,144444.0,43333.0,-70.0,-61.0,-72.0,-68.0,-69.0,-61.0,-71.0,-68.0,-80.0,-85.0,-80.0,-86.0,10.0,24.0,8.0,18.0,1
1423,F8:59:71:5A:E0:3D,2261401,435913832,106542,162539416,2154859,273374416,337,75693,106200491,75602,106186730,91,13761,75337,33,106538,8401,337,47,130000.0,39000.0,-67.0,-74.0,-66.0,-71.0,-66.0,-73.0,-65.0,-70.0,-80.0,-85.0,-80.0,-86.0,13.0,11.0,14.0,15.0,1
1424,CC:2F:71:3E:C5:1F,2154957,273386191,98,11775,2154859,273374416,0,458,38461,387,29885,71,8576,108,1,166,7,0,26,130000.0,39000.0,-71.0,-69.0,-66.0,-60.0,-71.0,-72.0,-68.0,-63.0,-80.0,-85.0,-80.0,-86.0,9.0,16.0,14.0,26.0,1
1425,CC:2F:71:3F:1F:24,2429167,630538892,274306,357164274,2154861,273374618,6,204193,250271043,204056,250252321,137,18722,199486,561,274354,32595,6,928,144444.0,43333.0,-69.0,-61.0,-70.0,-68.0,-69.0,-61.0,-70.0,-68.0,-80.0,-85.0,-80.0,-86.0,11.0,24.0,10.0,18.0,1
1426,F8:59:71:5A:E0:3D,2261466,436010332,106604,162635652,2154862,273374680,337,75757,106297629,75665,106283750,92,13879,75401,33,106600,8401,337,47,144444.0,43333.0,-68.0,-73.0,-66.0,-71.0,-67.0,-72.0,-66.0,-70.0,-80.0,-85.0,-80.0,-86.0,12.0,12.0,14.0,15.0,1
1427,CC:2F:71:3E:C5:1F,2154960,273386455,98,11775,2154862,273374680,0,458,38461,387,29885,71,8576,108,1,166,7,0,26,130000.0,39000.0,-71.0,-69.0,-66.0,-60.0,-71.0,-72.0,-68.0,-63.0,-80.0,-85.0,-80.0,-86.0,9.0,16.0,14.0,26.0,1
1428,CC:2F:71:3F:1F:24,2429331,630748718,274467,357373836,2154864,273374882,6,204341,250471567,204204,250452845,137,18722,199634,561,274515,32625,6,928,130000.0,43333.0,-70.0,-61.0,-73.0,-70.0,-69.0,-61.0,-73.0,-70.0,-80.0,-85.0,-80.0,-86.0,10.0,24.0,7.0,16.0,1
1429,F8:59:71:5A:E0:3D,2261543,436111586,106674,162736027,2154869,273375559,337,75825,106397793,75733,106383914,92,13879,75469,33,106670,8401,337,47,144444.0,43333.0,-67.0,-73.0,-66.0,-70.0,-67.0,-72.0,-65.0,-70.0,-80.0,-85.0,-80.0,-86.0,13.0,12.0,14.0,16.0,1
1430,CC:2F:71:3E:C5:1F,2154967,273387334,98,11775,2154869,273375559,0,458,38461,387,29885,71,8576,108,1,166,7,0,26,130000.0,39000.0,-71.0,-69.0,-66.0,-60.0,-71.0,-72.0,-68.0,-63.0,-80.0,-85.0,-80.0,-86.0,9.0,16.0,14.0,26.0,1
1431,CC:2F:71:3F:1F:24,2429491,630952409,274622,357576850,2154869,273375559,6,204482,250665571,204345,250646849,137,18722,199775,561,274670,32625,6,928,130000.0,43333.0,-70.0,-62.0,-71.0,-73.0,-70.0,-62.0,-71.0,-72.0,-80.0,-85.0,-80.0,-86.0,10.0,23.0,9.0,13.0,1
1432,F8:59:71:5A:E0:3D,2261613,436208983,106741,162833162,2154872,273375821,337,75890,106494562,75798,106480683,92,13879,75534,33,106737,8401,337,47,144444.0,43333.0,-68.0,-73.0,-66.0,-70.0,-67.0,-72.0,-66.0,-70.0,-80.0,-85.0,-80.0,-86.0,12.0,12.0,14.0,16.0,1
1433,CC:2F:71:3E:C5:1F,2154970,273387596,98,11775,2154872,273375821,0,458,38461,387,29885,71,8576,108,1,166,7,0,26,130000.0,39000.0,-71.0,-69.0,-66.0,-60.0,-71.0,-72.0,-68.0,-63.0,-80.0,-85.0,-80.0,-86.0,9.0,16.0,14.0,26.0,1
1434,CC:2F:71:3F:1F:24,2429658,631161102,274786,357785281,2154872,273375821,6,204628,250864396,204491,250845674,137,18722,199921,561,274834,32625,6,928,144444.0,43333.0,-72.0,-62.0,-73.0,-72.0,-72.0,-61.0,-72.0,-71.0,-80.0,-85.0,-80.0,-86.0,8.0,23.0,7.0,14.0,1
1435,F8:59:71:5A:E0:3D,2261861,436582070,106983,163205477,2154878,273376593,337,75992,106604332,75900,106590453,92,13879,75636,33,106979,8427,337,47,144444.0,43333.0,-67.0,-72.0,-66.0,-69.0,-67.0,-73.0,-65.0,-69.0,-80.0,-85.0,-80.0,-86.0,13.0,13.0,14.0,17.0,1
1436,CC:2F:71:3E:C5:1F,2154978,273388570,98,11775,2154880,273376795,0,458,38461,387,29885,71,8576,108,1,166,7,0,26,130000.0,39000.0,-71.0,-69.0,-66.0,-60.0,-71.0,-72.0,-68.0,-63.0,-80.0,-85.0,-80.0,-86.0,9.0,16.0,14.0,26.0,1
1437,CC:2F:71:3F:1F:24,2429860,631379929,274980,358003134,2154880,273376795,6,204801,251072668,204664,251053946,137,18722,200094,561,275027,32625,6,928,144444.0,43333.0,-70.0,-62.0,-71.0,-71.0,-70.0,-61.0,-70.0,-71.0,-80.0,-85.0,-80.0,-86.0,10.0,23.0,9.0,15.0,1
1438,F8:59:71:5A:E0:3D,2261930,436683484,107048,163306487,2154882,273376997,337,76056,106702892,75964,106689013,92,13879,75700,33,107044,8430,337,47,144444.0,43333.0,-67.0,-73.0,-66.0,-71.0,-67.0,-73.0,-66.0,-71.0,-80.0,-85.0,-80.0,-86.0,13.0,12.0,14.0,15.0,1
1439,CC:2F:71:3E:C5:1F,2154980,273388772,98,11775,2154882,273376997,0,458,38461,387,29885,71,8576,108,1,166,7,0,26,130000.0,39000.0,-71.0,-69.0,-66.0,-60.0,-71.0,-72.0,-68.0,-63.0,-80.0,-85.0,-80.0,-86.0,9.0,16.0,14.0,26.0,1
1440,CC:2F:71:3F:1F:24,2430023,631589495,275140,358212438,2154883,273377057,6,204950,251277582,204813,251258860,137,18722,200242,561,275188,32635,6,928,130000.0,43333.0,-69.0,-62.0,-71.0,-70.0,-69.0,-62.0,-71.0,-70.0,-80.0,-85.0,-80.0,-86.0,11.0,23.0,9.0,16.0,1
1441,F8:59:71:5A:E0:3D,2261997,436780296,107110,163402835,2154887,273377461,337,76119,106799912,76027,106786033,92,13879,75763,33,107106,8430,337,47,144444.0,43333.0,-67.0,-73.0,-66.0,-70.0,-67.0,-73.0,-65.0,-70.0,-80.0,-85.0,-80.0,-86.0,13.0,12.0,14.0,16.0,1
1442,CC:2F:71:3E:C5:1F,2154985,273389236,98,11775,2154887,273377461,0,458,38461,387,29885,71,8576,108,1,166,7,0,26,130000.0,39000.0,-71.0,-69.0,-66.0,-60.0,-71.0,-72.0,-68.0,-63.0,-80.0,-85.0,-80.0,-86.0,9.0,16.0,14.0,26.0,1
1443,CC:2F:71:3F:1F:24,2430190,631799719,275301,358422056,2154889,273377663,6,205099,251478222,204962,251459500,137,18722,200391,561,275349,32635,6,928,130000.0,43333.0,-72.0,-62.0,-73.0,-70.0,-72.0,-61.0,-73.0,-70.0,-80.0,-85.0,-80.0,-86.0,8.0,23.0,7.0,16.0,1
1444,F8:59:71:5A:E0:3D,2262065,436880156,107174,163502291,2154891,273377865,337,76183,106898472,76091,106884593,92,13879,75827,33,107170,8430,337,47,144444.0,43333.0,-67.0,-74.0,-66.0,-70.0,-67.0,-73.0,-65.0,-70.0,-80.0,-85.0,-80.0,-86.0,13.0,11.0,14.0,16.0,1
1445,CC:2F:71:3E:C5:1F,2154989,273389640,98,11775,2154891,273377865,0,458,38461,387,29885,71,8576,108,1,166,7,0,26,130000.0,39000.0,-71.0,-69.0,-66.0,-60.0,-71.0,-72.0,-68.0,-63.0,-80.0,-85.0,-80.0,-86.0,9.0,16.0,14.0,26.0,1
1446,CC:2F:71:3F:1F:24,2430377,632013185,275486,358635320,2154891,273377865,6,205261,251679717,205124,251660995,137,18722,200553,561,275534,32635,6,928,144444.0,39000.0,-74.0,-62.0,-72.0,-70.0,-73.0,-61.0,-71.0,-70.0,-80.0,-85.0,-80.0,-86.0,6.0,23.0,8.0,16.0,1
1447,F8:59:71:5A:E0:3D,2262132,436976968,107236,163598639,2154896,273378329,337,76245,106993952,76153,106980073,92,13879,75889,33,107232,8430,337,47,144444.0,43333.0,-68.0,-73.0,-65.0,-70.0,-67.0,-73.0,-65.0,-69.0,-80.0,-85.0,-80.0,-86.0,12.0,12.0,15.0,16.0,1
1448,CC:2F:71:3E:C5:1F,2154994,273390104,98,11775,2154896,273378329,0,458,38461,387,29885,71,8576,108,1,166,7,0,26,130000.0,39000.0,-71.0,-69.0,-66.0,-60.0,-71.0,-72.0,-68.0,-63.0,-80.0,-85.0,-80.0,-86.0,9.0,16.0,14.0,26.0,1
1449,CC:2F:71:3F:1F:24,2430550,632222894,275654,358844565,2154896,273378329,6,205412,251875587,205275,251856865,137,18722,200704,561,275702,32639,6,928,144444.0,43333.0,-67.0,-63.0,-70.0,-72.0,-70.0,-62.0,-70.0,-70.0,-80.0,-85.0,-80.0,-86.0,13.0,22.0,10.0,14.0,1
1450,F8:59:71:5A:E0:3D,2262234,437122747,107334,163744014,2154900,273378733,337,76317,107098512,76225,107084633,92,13879,75961,33,107330,8430,337,47,144444.0,43333.0,-68.0,-74.0,-65.0,-70.0,-67.0,-73.0,-65.0,-69.0,-80.0,-85.0,-80.0,-86.0,12.0,11.0,15.0,16.0,1
1451,CC:2F:71:3E:C5:1F,2154998,273390508,98,11775,2154900,273378733,0,458,38461,387,29885,71,8576,108,1,166,7,0,26,130000.0,39000.0,-71.0,-69.0,-66.0,-60.0,-71.0,-72.0,-68.0,-63.0,-80.0,-85.0,-80.0,-86.0,9.0,16.0,14.0,26.0,1
1452,CC:2F:71:3F:1F:24,2430723,632427744,275823,359049011,2154900,273378733,6,205566,252075262,205429,252056540,137,18722,200858,561,275871,32649,6,928,130000.0,43333.0,-71.0,-64.0,-73.0,-68.0,-70.0,-63.0,-72.0,-68.0,-80.0,-85.0,-80.0,-86.0,9.0,21.0,7.0,18.0,1
1453,F8:59:71:5A:E0:3D,2262298,437219297,107396,163840362,2154902,273378935,337,76379,107193992,76287,107180113,92,13879,76023,33,107392,8430,337,47,144444.0,43333.0,-66.0,-73.0,-66.0,-70.0,-66.0,-73.0,-66.0,-70.0,-80.0,-85.0,-80.0,-86.0,14.0,12.0,14.0,16.0,1
1454,CC:2F:71:3E:C5:1F,2155000,273390710,98,11775,2154902,273378935,0,458,38461,387,29885,71,8576,108,1,166,7,0,26,130000.0,39000.0,-71.0,-69.0,-66.0,-60.0,-71.0,-72.0,-68.0,-63.0,-80.0,-85.0,-80.0,-86.0,9.0,16.0,14.0,26.0,1
1455,CC:2F:71:3F:1F:24,2430893,632635403,275989,359256266,2154904,273379137,6,205720,252272765,205583,252254043,137,18722,201012,561,276037,32649,6,928,130000.0,43333.0,-70.0,-62.0,-70.0,-68.0,-69.0,-62.0,-69.0,-68.0,-80.0,-85.0,-80.0,-86.0,10.0,23.0,10.0,18.0,1
1456,F8:59:71:5A:E0:3D,2262433,437416230,107524,164036629,2154909,273379601,337,76457,107294648,76365,107280769,92,13879,76101,33,107519,8430,337,47,144444.0,43333.0,-67.0,-74.0,-66.0,-70.0,-66.0,-73.0,-65.0,-70.0,-80.0,-85.0,-80.0,-86.0,13.0,11.0,14.0,16.0,1
1457,CC:2F:71:3E:C5:1F,2155007,273391376,98,11775,2154909,273379601,0,458,38461,387,29885,71,8576,108,1,166,7,0,26,130000.0,39000.0,-71.0,-69.0,-66.0,-60.0,-71.0,-72.0,-68.0,-63.0,-80.0,-85.0,-80.0,-86.0,9.0,16.0,14.0,26.0,1
1458,CC:2F:71:3F:1F:24,2431054,632839011,276145,359459410,2154909,273379601,6,205862,252466885,205725,252448163,137,18722,201154,561,276193,32649,6,928,130000.0,43333.0,-70.0,-61.0,-71.0,-71.0,-69.0,-61.0,-71.0,-70.0,-80.0,-85.0,-80.0,-86.0,10.0,24.0,9.0,15.0,1
1459,F8:59:71:5A:E0:3D,2262493,437509470,107584,164129869,2154909,273379601,337,76518,107388588,76426,107374709,92,13879,76162,33,107580,8430,337,47,144444.0,43333.0,-66.0,-74.0,-66.0,-70.0,-66.0,-74.0,-65.0,-70.0,-80.0,-85.0,-80.0,-86.0,14.0,11.0,14.0,16.0,1
1460,CC:2F:71:3E:C5:1F,2155007,273391376,98,11775,2154909,273379601,0,458,38461,387,29885,71,8576,108,1,166,7,0,26,130000.0,39000.0,-71.0,-69.0,-66.0,-60.0,-71.0,-72.0,-68.0,-63.0,-80.0,-85.0,-80.0,-86.0,9.0,16.0,14.0,26.0,1
1461,CC:2F:71:3F:1F:24,2431219,633047028,276308,359667225,2154911,273379803,6,206008,252660816,205871,252642094,137,18722,201300,561,276356,32658,6,936,130000.0,43333.0,-75.0,-63.0,-73.0,-71.0,-74.0,-63.0,-72.0,-70.0,-80.0,-85.0,-80.0,-86.0,5.0,22.0,7.0,15.0,1
1462,F8:59:71:5A:E0:3D,2262567,437611544,107652,164231337,2154915,273380207,337,76586,107489550,76494,107475671,92,13879,76230,33,107648,8430,337,47,144444.0,43333.0,-66.0,-74.0,-65.0,-70.0,-66.0,-74.0,-65.0,-70.0,-80.0,-84.0,-80.0,-86.0,14.0,10.0,15.0,16.0,1
1463,CC:2F:71:3E:C5:1F,2155013,273391982,98,11775,2154915,273380207,0,458,38461,387,29885,71,8576,108,1,166,7,0,26,130000.0,39000.0,-71.0,-69.0,-66.0,-60.0,-71.0,-72.0,-68.0,-63.0,-80.0,-84.0,-80.0,-86.0,9.0,15.0,14.0,26.0,1
1464,CC:2F:71:3F:1F:24,2431380,633252258,276465,359872051,2154915,273380207,6,206152,252856604,206015,252837882,137,18722,201444,561,276513,32658,6,936,130000.0,43333.0,-73.0,-62.0,-73.0,-69.0,-72.0,-62.0,-72.0,-69.0,-80.0,-84.0,-80.0,-86.0,7.0,22.0,7.0,17.0,1
1465,F8:59:71:5A:E0:3D,2262632,437708154,107714,164327685,2154918,273380469,337,76648,107585030,76556,107571151,92,13879,76292,33,107710,8431,337,47,144444.0,43333.0,-67.0,-73.0,-66.0,-70.0,-67.0,-73.0,-65.0,-70.0,-80.0,-84.0,-80.0,-86.0,13.0,11.0,14.0,16.0,1
1466,CC:2F:71:3E:C5:1F,2155016,273392244,98,11775,2154918,273380469,0,458,38461,387,29885,71,8576,108,1,166,7,0,26,130000.0,39000.0,-71.0,-69.0,-66.0,-60.0,-71.0,-72.0,-68.0,-63.0,-80.0,-84.0,-80.0,-86.0,9.0,15.0,14.0,26.0,1
1467,CC:2F:71:3F:1F:24,2431538,633454050,276619,360073511,2154919,273380539,6,206292,253050492,206155,253031770,137,18722,201584,561,276667,32658,6,936,130000.0,43333.0,-73.0,-61.0,-73.0,-73.0,-73.0,-61.0,-72.0,-72.0,-80.0,-84.0,-80.0,-86.0,7.0,23.0,7.0,13.0,1
1468,F8:59:71:5A:E0:3D,2262704,437809840,107779,164428695,2154925,273381145,337,76714,107685256,76621,107671251,93,14005,76358,33,107775,8432,337,47,144444.0,43333.0,-66.0,-73.0,-66.0,-71.0,-66.0,-73.0,-66.0,-70.0,-80.0,-84.0,-80.0,-86.0,14.0,11.0,14.0,15.0,1
1469,CC:2F:71:3E:C5:1F,2155023,273392920,98,11775,2154925,273381145,0,460,38601,389,30025,71,8576,108,1,167,7,0,26,130000.0,39000.0,-71.0,-69.0,-67.0,-60.0,-71.0,-70.0,-67.0,-61.0,-80.0,-84.0,-80.0,-86.0,9.0,15.0,13.0,26.0,1
1470,CC:2F:71:3F:1F:24,2431818,633719062,276893,360337917,2154925,273381145,6,206534,253318486,206397,253299764,137,18722,201826,561,276941,32741,6,947,86667.0,14444.0,-72.0,-62.0,-73.0,-70.0,-71.0,-62.0,-73.0,-70.0,-80.0,-84.0,-80.0,-86.0,8.0,22.0,7.0,16.0,1
1471,F8:59:71:5A:E0:3D,2262904,438115170,107977,164733823,2154927,273381347,337,76802,107799816,76709,107785811,93,14005,76446,33,107973,8433,337,47,144444.0,43333.0,-67.0,-74.0,-66.0,-70.0,-67.0,-73.0,-65.0,-69.0,-80.0,-84.0,-80.0,-86.0,13.0,10.0,14.0,16.0,1
1472,CC:2F:71:3E:C5:1F,2155027,273393511,99,11891,2154928,273381620,0,462,38741,391,30165,71,8576,108,1,168,7,0,26,130000.0,39000.0,-71.0,-69.0,-67.0,-60.0,-70.0,-68.0,-66.0,-60.0,-80.0,-84.0,-80.0,-86.0,9.0,15.0,13.0,26.0,1
1473,CC:2F:71:3F:1F:24,2432008,633946281,277080,360564661,2154928,273381620,6,206702,253533341,206565,253514619,137,18722,201992,561,277128,32742,6,947,86667.0,14444.0,-71.0,-63.0,-73.0,-70.0,-71.0,-62.0,-73.0,-69.0,-80.0,-84.0,-80.0,-86.0,9.0,21.0,7.0,16.0,1
1474,F8:59:71:5A:E0:3D,2262980,438221781,108045,164839495,2154935,273382286,337,76871,107906076,76778,107892071,93,14005,76515,33,108041,8433,337,47,144444.0,43333.0,-67.0,-73.0,-65.0,-69.0,-66.0,-73.0,-65.0,-69.0,-80.0,-84.0,-80.0,-86.0,13.0,11.0,15.0,17.0,1
1475,CC:2F:71:3E:C5:1F,2155034,273394177,99,11891,2154935,273382286,0,462,38741,391,30165,71,8576,108,1,168,7,0,26,130000.0,39000.0,-71.0,-69.0,-67.0,-60.0,-70.0,-68.0,-66.0,-60.0,-80.0,-84.0,-80.0,-86.0,9.0,15.0,13.0,26.0,1
1476,CC:2F:71:3F:1F:24,2432175,634152044,277240,360769758,2154935,273382286,6,206848,253730773,206711,253712051,137,18722,202138,561,277288,32742,6,947,117000.0,39000.0,-68.0,-62.0,-72.0,-67.0,-68.0,-62.0,-72.0,-67.0,-80.0,-84.0,-80.0,-86.0,12.0,22.0,8.0,19.0,1
1477,F8:59:71:5A:E0:3D,2263046,438321439,108109,164938951,2154937,273382488,337,76935,108004636,76842,107990631,93,14005,76579,33,108105,8434,337,47,144444.0,43333.0,-67.0,-73.0,-66.0,-69.0,-67.0,-73.0,-65.0,-69.0,-80.0,-84.0,-80.0,-86.0,13.0,11.0,14.0,17.0,1
1478,CC:2F:71:3E:C5:1F,2155036,273394379,99,11891,2154937,273382488,0,462,38741,391,30165,71,8576,108,1,168,7,0,26,130000.0,39000.0,-71.0,-69.0,-67.0,-60.0,-70.0,-68.0,-66.0,-60.0,-80.0,-84.0,-80.0,-86.0,9.0,15.0,13.0,26.0,1
1479,CC:2F:71:3F:1F:24,2432351,634366264,277414,360983776,2154937,273382488,6,207008,253933868,206871,253915146,137,18722,202298,561,277462,32753,6,947,130000.0,43333.0,-69.0,-63.0,-73.0,-67.0,-69.0,-63.0,-72.0,-67.0,-80.0,-84.0,-80.0,-86.0,11.0,21.0,7.0,19.0,1
1480,F8:59:71:5A:E0:3D,2263304,438713885,108361,165330791,2154943,273383094,337,77035,108112452,76942,108098447,93,14005,76679,33,108357,8434,337,47,144444.0,43333.0,-66.0,-73.0,-67.0,-70.0,-66.0,-73.0,-66.0,-70.0,-80.0,-84.0,-80.0,-86.0,14.0,11.0,13.0,16.0,1
1481,CC:2F:71:3E:C5:1F,2155042,273394985,99,11891,2154943,273383094,0,462,38741,391,30165,71,8576,108,1,168,7,0,26,130000.0,39000.0,-71.0,-69.0,-67.0,-60.0,-70.0,-68.0,-66.0,-60.0,-80.0,-84.0,-80.0,-86.0,9.0,15.0,13.0,26.0,1
1482,CC:2F:71:3F:1F:24,2432783,634927566,277840,361544472,2154943,273383094,6,207222,254159980,207085,254141258,137,18722,202511,561,277887,32820,6,947,130000.0,43333.0,-67.0,-62.0,-71.0,-67.0,-67.0,-62.0,-71.0,-67.0,-80.0,-84.0,-80.0,-86.0,13.0,22.0,9.0,19.0,1
1483,F8:59:71:5A:E0:3D,2263375,438819819,108429,165436463,2154946,273383356,337,77102,108215632,77009,108201627,93,14005,76746,33,108425,8435,337,47,144444.0,43333.0,-66.0,-74.0,-66.0,-70.0,-65.0,-73.0,-65.0,-70.0,-80.0,-84.0,-80.0,-86.0,14.0,10.0,14.0,16.0,1
1484,CC:2F:71:3E:C5:1F,2155045,273395247,99,11891,2154946,273383356,0,462,38741,391,30165,71,8576,108,1,168,7,0,26,130000.0,39000.0,-71.0,-69.0,-67.0,-60.0,-70.0,-68.0,-66.0,-60.0,-80.0,-84.0,-80.0,-86.0,9.0,15.0,13.0,26.0,1
1485,CC:2F:71:3F:1F:24,2432971,635148937,278025,361765581,2154946,273383356,6,207392,254374913,207255,254356191,137,18722,202681,561,278073,32820,6,947,130000.0,43333.0,-69.0,-62.0,-71.0,-69.0,-68.0,-62.0,-71.0,-68.0,-80.0,-84.0,-80.0,-86.0,11.0,22.0,9.0,17.0,1
1486,F8:59:71:5A:E0:3D,2263440,438916431,108491,165532811,2154949,273383620,337,77164,108311112,77071,108297107,93,14005,76808,33,108487,8435,337,47,144444.0,43333.0,-67.0,-74.0,-66.0,-70.0,-66.0,-73.0,-65.0,-70.0,-80.0,-84.0,-80.0,-86.0,13.0,10.0,14.0,16.0,1
1487,CC:2F:71:3E:C5:1F,2155050,273395713,99,11891,2154951,273383822,0,462,38741,391,30165,71,8576,108,1,168,7,0,26,130000.0,39000.0,-71.0,-69.0,-67.0,-60.0,-70.0,-68.0,-66.0,-60.0,-80.0,-84.0,-80.0,-86.0,9.0,15.0,13.0,26.0,1
1488,CC:2F:71:3F:1F:24,2433158,635364565,278205,361980541,2154953,273384024,6,207557,254580558,207419,254561718,138,18840,202845,561,278252,32820,6,947,130000.0,43333.0,-69.0,-62.0,-72.0,-67.0,-69.0,-62.0,-71.0,-66.0,-80.0,-84.0,-80.0,-86.0,11.0,22.0,8.0,19.0,1
1489,F8:59:71:5A:E0:3D,2263510,439016493,108555,165632267,2154955,273384226,337,77228,108409672,77135,108395667,93,14005,76872,33,108551,8436,337,47,144444.0,43333.0,-67.0,-73.0,-66.0,-70.0,-67.0,-73.0,-65.0,-69.0,-80.0,-84.0,-80.0,-86.0,13.0,11.0,14.0,16.0,1
1490,CC:2F:71:3E:C5:1F,2155055,273396177,99,11891,2154956,273384286,0,462,38741,391,30165,71,8576,108,1,168,7,0,26,130000.0,39000.0,-71.0,-69.0,-67.0,-60.0,-70.0,-68.0,-66.0,-60.0,-80.0,-84.0,-80.0,-86.0,9.0,15.0,13.0,26.0,1
1491,CC:2F:71:3F:1F:24,2433332,635571538,278376,362187252,2154956,273384286,6,207709,254781947,207571,254763107,138,18840,202997,561,278424,32826,6,947,130000.0,43333.0,-70.0,-63.0,-71.0,-68.0,-69.0,-62.0,-71.0,-67.0,-80.0,-84.0,-80.0,-86.0,10.0,21.0,9.0,18.0,1
1492,F8:59:71:5A:E0:3D,2263615,439156749,108657,165772261,2154958,273384488,337,77307,108512368,77214,108498363,93,14005,76951,33,108653,8436,337,47,144444.0,39000.0,-67.0,-74.0,-66.0,-69.0,-67.0,-73.0,-65.0,-69.0,-80.0,-86.0,-80.0,-87.0,13.0,12.0,14.0,18.0,1
1493,CC:2F:71:3E:C5:1F,2155057,273396379,99,11891,2154958,273384488,0,462,38741,391,30165,71,8576,108,1,168,7,0,26,130000.0,39000.0,-71.0,-69.0,-67.0,-60.0,-70.0,-68.0,-66.0,-60.0,-80.0,-86.0,-80.0,-87.0,9.0,17.0,13.0,27.0,1
1494,CC:2F:71:3F:1F:24,2433491,635776438,278533,362391950,2154958,273384488,6,207850,254976007,207712,254957167,138,18840,203138,561,278580,32827,6,948,130000.0,43333.0,-70.0,-63.0,-71.0,-68.0,-69.0,-62.0,-70.0,-67.0,-80.0,-86.0,-80.0,-87.0,10.0,23.0,9.0,19.0,1
1495,F8:59:71:5A:E0:3D,2263688,439257216,108724,165872122,2154964,273385094,337,77375,108614640,77282,108600635,93,14005,77019,33,108720,8436,337,47,144444.0,43333.0,-66.0,-73.0,-66.0,-70.0,-66.0,-73.0,-65.0,-69.0,-80.0,-86.0,-80.0,-87.0,14.0,13.0,14.0,17.0,1
1496,CC:2F:71:3E:C5:1F,2155063,273396985,99,11891,2154964,273385094,0,462,38741,391,30165,71,8576,108,1,168,7,0,26,130000.0,39000.0,-71.0,-69.0,-67.0,-60.0,-70.0,-68.0,-66.0,-60.0,-80.0,-86.0,-80.0,-87.0,9.0,17.0,13.0,27.0,1
1497,CC:2F:71:3F:1F:24,2433655,635983184,278691,362598090,2154964,273385094,6,207996,255176287,207858,255157447,138,18840,203284,561,278739,32827,6,948,144444.0,39000.0,-69.0,-63.0,-71.0,-68.0,-69.0,-63.0,-70.0,-67.0,-80.0,-86.0,-80.0,-87.0,11.0,23.0,9.0,19.0,1
1498,F8:59:71:5A:E0:3D,2263798,439423782,108833,166038628,2154965,273385154,337,77452,108715180,77359,108701175,93,14005,77096,33,108829,8436,337,47,144444.0,43333.0,-66.0,-73.0,-65.0,-70.0,-66.0,-73.0,-65.0,-70.0,-80.0,-86.0,-80.0,-87.0,14.0,13.0,15.0,17.0,1
1499,CC:2F:71:3E:C5:1F,2155066,273397247,99,11891,2154967,273385356,0,462,38741,391,30165,71,8576,108,1,168,7,0,26,130000.0,39000.0,-71.0,-69.0,-67.0,-60.0,-70.0,-68.0,-66.0,-60.0,-80.0,-86.0,-80.0,-87.0,9.0,17.0,13.0,27.0,1
1500,CC:2F:71:3F:1F:24,2434053,636498344,279086,363112988,2154967,273385356,6,208203,255387046,208065,255368206,138,18840,203491,561,279134,32836,6,948,130000.0,43333.0,-70.0,-62.0,-71.0,-67.0,-69.0,-62.0,-71.0,-67.0,-80.0,-86.0,-80.0,-87.0,10.0,24.0,9.0,20.0,1
1501,F8:59:71:5A:E0:3D,2263868,439522352,108896,166136530,2154972,273385822,337,77516,108812318,77422,108798195,94,14123,77160,33,108892,8436,337,47,144444.0,43333.0,-67.0,-73.0,-65.0,-70.0,-66.0,-73.0,-65.0,-70.0,-80.0,-86.0,-80.0,-87.0,13.0,13.0,15.0,17.0,1
1502,CC:2F:71:3E:C5:1F,2155071,273397713,99,11891,2154972,273385822,0,462,38741,391,30165,71,8576,108,1,168,7,0,26,130000.0,39000.0,-71.0,-69.0,-67.0,-60.0,-70.0,-68.0,-66.0,-60.0,-80.0,-86.0,-80.0,-87.0,9.0,17.0,13.0,27.0,1
1503,CC:2F:71:3F:1F:24,2434458,637056419,279486,363670597,2154972,273385822,6,208380,255588363,208242,255569523,138,18840,203668,561,279534,32836,6,948,130000.0,43333.0,-70.0,-63.0,-71.0,-68.0,-69.0,-62.0,-71.0,-67.0,-80.0,-86.0,-80.0,-87.0,10.0,23.0,9.0,19.0,1
1504,F8:59:71:5A:E0:3D,2263933,439618964,108958,166232878,2154975,273386086,337,77579,108909338,77485,108895215,94,14123,77223,33,108954,8436,337,47,144444.0,43333.0,-67.0,-74.0,-66.0,-70.0,-66.0,-73.0,-65.0,-69.0,-80.0,-86.0,-80.0,-87.0,13.0,12.0,14.0,17.0,1
1505,CC:2F:71:3E:C5:1F,2155074,273397977,99,11891,2154975,273386086,0,464,38929,392,30235,72,8694,109,1,168,7,0,26,130000.0,39000.0,-72.0,-70.0,-67.0,-60.0,-71.0,-69.0,-66.0,-60.0,-80.0,-86.0,-80.0,-87.0,8.0,16.0,13.0,27.0,1
1506,CC:2F:71:3F:1F:24,2434623,637267673,279648,363881587,2154975,273386086,6,208529,255788993,208391,255770153,138,18840,203817,561,279696,32840,6,948,130000.0,39000.0,-70.0,-62.0,-71.0,-67.0,-69.0,-62.0,-71.0,-67.0,-80.0,-86.0,-80.0,-87.0,10.0,24.0,9.0,20.0,1
1507,F8:59:71:5A:E0:3D,2264010,439724206,109028,166337454,2154982,273386752,337,77649,109013338,77555,108999215,94,14123,77293,33,109023,8436,337,47,144444.0,43333.0,-66.0,-73.0,-66.0,-69.0,-66.0,-73.0,-65.0,-69.0,-80.0,-86.0,-80.0,-87.0,14.0,13.0,14.0,18.0,1
1508,CC:2F:71:3E:C5:1F,2155081,273398643,99,11891,2154982,273386752,0,464,38929,392,30235,72,8694,109,1,168,7,0,26,130000.0,39000.0,-72.0,-70.0,-67.0,-60.0,-71.0,-69.0,-66.0,-60.0,-80.0,-86.0,-80.0,-87.0,8.0,16.0,13.0,27.0,1
1509,CC:2F:71:3F:1F:24,2434792,637474978,279810,364088226,2154982,273386752,6,208676,255987904,208538,255969064,138,18840,203964,561,279858,32842,6,948,130000.0,43333.0,-69.0,-63.0,-71.0,-68.0,-69.0,-62.0,-71.0,-67.0,-80.0,-86.0,-80.0,-87.0,11.0,23.0,9.0,19.0,1
1510,F8:59:71:5A:E0:3D,2264074,439820756,109090,166433802,2154984,273386954,337,77712,109110358,77618,109096235,94,14123,77356,33,109086,8436,337,47,144444.0,43333.0,-67.0,-74.0,-65.0,-70.0,-66.0,-73.0,-65.0,-69.0,-80.0,-86.0,-80.0,-87.0,13.0,12.0,15.0,17.0,1
1511,CC:2F:71:3E:C5:1F,2155083,273398845,99,11891,2154984,273386954,0,464,38929,392,30235,72,8694,109,1,168,7,0,26,130000.0,39000.0,-72.0,-70.0,-67.0,-60.0,-71.0,-69.0,-66.0,-60.0,-80.0,-86.0,-80.0,-87.0,8.0,16.0,13.0,27.0,1
1512,CC:2F:71:3F:1F:24,2434958,637683349,279974,364296395,2154984,273386954,6,208825,256183328,208687,256164488,138,18840,204113,561,280021,32842,6,948,130000.0,43333.0,-69.0,-63.0,-72.0,-67.0,-69.0,-62.0,-71.0,-67.0,-80.0,-86.0,-80.0,-87.0,11.0,23.0,8.0,20.0,1
1513,F8:59:71:5A:E0:3D,2264268,440109774,109278,166722214,2154990,273387560,337,77792,109211154,77698,109197031,94,14123,77436,33,109274,8436,337,47,144444.0,43333.0,-67.0,-74.0,-65.0,-70.0,-66.0,-74.0,-65.0,-70.0,-80.0,-86.0,-80.0,-87.0,13.0,12.0,15.0,17.0,1
1514,CC:2F:71:3E:C5:1F,2155089,273399451,99,11891,2154990,273387560,0,464,38929,392,30235,72,8694,109,1,168,7,0,26,130000.0,39000.0,-72.0,-70.0,-67.0,-60.0,-71.0,-69.0,-66.0,-60.0,-80.0,-86.0,-80.0,-87.0,8.0,16.0,13.0,27.0,1
1515,CC:2F:71:3F:1F:24,2435121,637888247,280131,364500687,2154990,273387560,6,208970,256380634,208832,256361794,138,18840,204258,561,280179,32871,6,948,104000.0,26000.0,-69.0,-62.0,-72.0,-68.0,-69.0,-62.0,-71.0,-67.0,-80.0,-86.0,-80.0,-87.0,11.0,24.0,8.0,19.0,1
1516,F8:59:71:5A:E0:3D,2264336,440208327,109342,166820232,2154994,273388095,337,77855,109306740,77761,109292617,94,14123,77499,33,109338,8437,337,47,144444.0,43333.0,-67.0,-74.0,-66.0,-70.0,-66.0,-73.0,-65.0,-69.0,-80.0,-86.0,-80.0,-87.0,13.0,12.0,14.0,17.0,1
1517,CC:2F:71:3E:C5:1F,2155093,273399986,99,11891,2154994,273388095,0,464,38929,392,30235,72,8694,109,1,168,7,0,26,130000.0,39000.0,-72.0,-70.0,-67.0,-60.0,-71.0,-69.0,-66.0,-60.0,-80.0,-86.0,-80.0,-87.0,8.0,16.0,13.0,27.0,1
1518,CC:2F:71:3F:1F:24,2435283,638093484,280289,364705389,2154994,273388095,6,209113,256577708,208975,256558868,138,18840,204401,561,280337,32871,6,948,115556.0,28889.0,-69.0,-64.0,-72.0,-68.0,-68.0,-63.0,-71.0,-67.0,-80.0,-86.0,-80.0,-87.0,11.0,22.0,8.0,19.0,1
1519,F8:59:71:5A:E0:3D,2264546,440528334,109548,167139835,2154998,273388499,337,77948,109410728,77854,109396605,94,14123,77592,33,109544,8437,337,47,144444.0,43333.0,-66.0,-74.0,-65.0,-70.0,-66.0,-73.0,-65.0,-69.0,-80.0,-86.0,-80.0,-87.0,14.0,12.0,15.0,17.0,1
1520,CC:2F:71:3E:C5:1F,2155097,273400390,99,11891,2154998,273388499,0,464,38929,392,30235,72,8694,109,1,168,7,0,26,130000.0,39000.0,-72.0,-70.0,-67.0,-60.0,-71.0,-69.0,-66.0,-60.0,-80.0,-86.0,-80.0,-87.0,8.0,16.0,13.0,27.0,1
1521,CC:2F:71:3F:1F:24,2435444,638300010,280446,364911511,2154998,273388499,6,209260,256775256,209122,256756416,138,18840,204548,561,280494,32871,6,948,115556.0,28889.0,-69.0,-62.0,-71.0,-67.0,-68.0,-62.0,-71.0,-67.0,-80.0,-86.0,-80.0,-87.0,11.0,24.0,9.0,20.0,1
1522,F8:59:71:5A:E0:3D,2264615,440629748,109613,167240845,2155002,273388903,337,78013,109510828,77919,109496705,94,14123,77657,33,109609,8437,337,47,144444.0,43333.0,-67.0,-74.0,-65.0,-70.0,-66.0,-73.0,-65.0,-70.0,-80.0,-86.0,-80.0,-87.0,13.0,12.0,15.0,17.0,1
1523,CC:2F:71:3E:C5:1F,2155101,273400794,99,11891,2155002,273388903,0,464,38929,392,30235,72,8694,109,1,168,7,0,26,130000.0,39000.0,-72.0,-70.0,-67.0,-60.0,-71.0,-69.0,-66.0,-60.0,-80.0,-86.0,-80.0,-87.0,8.0,16.0,13.0,27.0,1
1524,CC:2F:71:3F:1F:24,2435943,638982738,280941,365593835,2155002,273388903,6,209464,256989248,209326,256970408,138,18840,204752,561,280989,32887,6,948,130000.0,43333.0,-68.0,-63.0,-71.0,-69.0,-68.0,-62.0,-70.0,-68.0,-80.0,-86.0,-80.0,-87.0,12.0,23.0,9.0,18.0,1
1525,F8:59:71:5A:E0:3D,2264680,440726358,109675,167337193,2155005,273389165,337,78076,109607848,77982,109593725,94,14123,77720,33,109671,8437,337,47,144444.0,43333.0,-67.0,-73.0,-66.0,-70.0,-66.0,-73.0,-65.0,-70.0,-80.0,-86.0,-80.0,-87.0,13.0,13.0,14.0,17.0,1
1526,CC:2F:71:3E:C5:1F,2155106,273401258,99,11891,2155007,273389367,0,464,38929,392,30235,72,8694,109,1,168,7,0,26,130000.0,39000.0,-72.0,-70.0,-67.0,-60.0,-71.0,-69.0,-66.0,-60.0,-80.0,-86.0,-80.0,-87.0,8.0,16.0,13.0,27.0,1
1527,CC:2F:71:3F:1F:24,2436136,639208413,281129,365819046,2155007,273389367,6,209630,257198308,209492,257179468,138,18840,204917,561,281171,32890,6,948,130000.0,43333.0,-67.0,-62.0,-70.0,-68.0,-67.0,-62.0,-70.0,-67.0,-80.0,-86.0,-81.0,-88.0,13.0,24.0,11.0,20.0,1
1528,F8:59:71:5A:E0:3D,2264753,440831082,109742,167441311,2155011,273389771,337,78143,109711028,78049,109696905,94,14123,77787,33,109738,8437,337,47,144444.0,43333.0,-67.0,-74.0,-66.0,-70.0,-66.0,-73.0,-65.0,-70.0,-80.0,-86.0,-81.0,-88.0,13.0,12.0,15.0,18.0,1
1529,CC:2F:71:3E:C5:1F,2155110,273401662,99,11891,2155011,273389771,0,464,38929,392,30235,72,8694,109,1,168,7,0,26,130000.0,39000.0,-72.0,-70.0,-67.0,-60.0,-71.0,-69.0,-66.0,-60.0,-80.0,-86.0,-81.0,-88.0,8.0,16.0,14.0,28.0,1
1530,CC:2F:71:3F:1F:24,2436316,639425579,281305,366035808,2155011,273389771,6,209797,257424251,209659,257405411,138,18840,205078,561,281353,32891,6,948,130000.0,43333.0,-69.0,-63.0,-70.0,-70.0,-68.0,-62.0,-70.0,-69.0,-80.0,-86.0,-81.0,-88.0,11.0,23.0,11.0,18.0,1
1531,F8:59:71:5A:E0:3D,2264824,440938510,109811,167548537,2155013,273389973,337,78212,109817288,78118,109803165,94,14123,77856,33,109807,8437,337,47,144444.0,43333.0,-67.0,-73.0,-66.0,-71.0,-66.0,-72.0,-65.0,-70.0,-80.0,-86.0,-81.0,-88.0,13.0,13.0,15.0,17.0,1
1532,CC:2F:71:3E:C5:1F,2155114,273402066,99,11891,2155015,273390175,0,464,38929,392,30235,72,8694,109,1,168,7,0,26,130000.0,39000.0,-72.0,-70.0,-67.0,-60.0,-71.0,-69.0,-66.0,-60.0,-80.0,-86.0,-81.0,-88.0,8.0,16.0,14.0,28.0,1
1533,CC:2F:71:3F:1F:24,2436498,639660469,281482,366270234,2155016,273390235,6,209965,257654191,209827,257635351,138,18840,205244,561,281530,32893,6,948,144444.0,43333.0,-69.0,-63.0,-71.0,-69.0,-68.0,-62.0,-70.0,-68.0,-80.0,-86.0,-81.0,-88.0,11.0,23.0,10.0,19.0,1
1534,F8:59:71:5A:E0:3D,2264957,441126589,109937,167735950,2155020,273390639,337,78301,109943888,78207,109929765,94,14123,77944,33,109933,8437,337,47,144444.0,43333.0,-66.0,-74.0,-65.0,-71.0,-66.0,-73.0,-65.0,-70.0,-81.0,-87.0,-81.0,-89.0,15.0,13.0,16.0,18.0,1
1535,CC:2F:71:3E:C5:1F,2155119,273402530,99,11891,2155020,273390639,0,464,38929,392,30235,72,8694,109,1,168,7,0,26,130000.0,39000.0,-72.0,-70.0,-67.0,-60.0,-71.0,-69.0,-66.0,-60.0,-81.0,-87.0,-81.0,-89.0,9.0,17.0,14.0,29.0,1
1536,CC:2F:71:3F:1F:24,2437122,640472202,282102,367081563,2155020,273390639,6,210351,257934117,210213,257915277,138,18840,205624,561,282150,32919,6,953,144444.0,43333.0,-68.0,-64.0,-70.0,-69.0,-68.0,-65.0,-70.0,-71.0,-81.0,-87.0,-81.0,-89.0,13.0,23.0,11.0,20.0,1
1537,F8:59:71:5A:E0:3D,2265126,441358663,110102,167967620,2155024,273391043,337,78415,110066014,78321,110051891,94,14123,78058,33,110098,8438,337,47,144444.0,43333.0,-67.0,-73.0,-66.0,-70.0,-66.0,-73.0,-65.0,-70.0,-81.0,-87.0,-81.0,-89.0,14.0,14.0,15.0,19.0,1
1538,CC:2F:71:3E:C5:1F,2155123,273402934,99,11891,2155024,273391043,0,464,38929,392,30235,72,8694,109,1,168,7,0,26,130000.0,39000.0,-72.0,-70.0,-67.0,-60.0,-71.0,-69.0,-66.0,-60.0,-81.0,-87.0,-81.0,-89.0,9.0,17.0,14.0,29.0,1
1539,CC:2F:71:3F:1F:24,2437493,640964716,282469,367573673,2155024,273391043,6,210611,258191297,210473,258172457,138,18840,205876,561,282516,32926,6,957,144444.0,43333.0,-69.0,-63.0,-70.0,-69.0,-68.0,-63.0,-70.0,-68.0,-81.0,-87.0,-81.0,-89.0,12.0,24.0,11.0,20.0,1
1540,F8:59:71:5A:E0:3D,2265247,441495406,110218,168103899,2155029,273391507,337,78517,110193330,78423,110179207,94,14123,78160,33,110214,8438,337,47,144444.0,43333.0,-67.0,-73.0,-65.0,-70.0,-66.0,-73.0,-65.0,-70.0,-81.0,-87.0,-81.0,-89.0,14.0,14.0,16.0,19.0,1
1541,CC:2F:71:3E:C5:1F,2155128,273403398,99,11891,2155029,273391507,0,464,38929,392,30235,72,8694,109,1,168,7,0,26,130000.0,39000.0,-72.0,-70.0,-67.0,-60.0,-71.0,-69.0,-66.0,-60.0,-81.0,-87.0,-81.0,-89.0,9.0,17.0,14.0,29.0,1
1542,CC:2F:71:3F:1F:24,2437960,641599991,282931,368208484,2155029,273391507,6,210821,258421205,210683,258402365,138,18840,206083,561,282979,32929,6,959,144444.0,43333.0,-64.0,-63.0,-69.0,-69.0,-67.0,-63.0,-68.0,-69.0,-81.0,-87.0,-81.0,-89.0,17.0,24.0,12.0,20.0,1
1543,F8:59:71:5A:E0:3D,2265322,441606144,110289,168214233,2155033,273391911,337,78588,110302726,78494,110288603,94,14123,78231,33,110285,8438,337,48,144444.0,43333.0,-66.0,-73.0,-66.0,-71.0,-66.0,-73.0,-65.0,-70.0,-81.0,-87.0,-81.0,-89.0,15.0,14.0,15.0,18.0,1
1544,CC:2F:71:3E:C5:1F,2155132,273403802,99,11891,2155033,273391911,0,464,38929,392,30235,72,8694,109,1,168,7,0,26,130000.0,39000.0,-72.0,-70.0,-67.0,-60.0,-71.0,-69.0,-66.0,-60.0,-81.0,-87.0,-81.0,-89.0,9.0,17.0,14.0,29.0,1
1545,CC:2F:71:3F:1F:24,2438204,641863636,283171,368471725,2155033,273391911,6,211038,258674196,210900,258655356,138,18840,206299,561,283219,32930,6,961,144444.0,43333.0,-68.0,-62.0,-70.0,-68.0,-68.0,-62.0,-70.0,-68.0,-81.0,-87.0,-81.0,-89.0,13.0,25.0,11.0,21.0,1
1546,F8:59:71:5A:E0:3D,2265399,441715786,110362,168323471,2155037,273392315,337,78661,110411346,78567,110397223,94,14123,78304,33,110358,8438,337,48,144444.0,43333.0,-66.0,-73.0,-66.0,-71.0,-66.0,-73.0,-65.0,-70.0,-81.0,-87.0,-81.0,-89.0,15.0,14.0,15.0,18.0,1
1547,CC:2F:71:3E:C5:1F,2155136,273404206,99,11891,2155037,273392315,0,464,38929,392,30235,72,8694,109,1,168,7,0,26,130000.0,39000.0,-72.0,-70.0,-67.0,-60.0,-71.0,-69.0,-66.0,-60.0,-81.0,-87.0,-81.0,-89.0,9.0,17.0,14.0,29.0,1
1548,CC:2F:71:3F:1F:24,2438364,642067184,283327,368674869,2155037,273392315,6,211184,258875970,211046,258857130,138,18840,206440,561,283375,32930,6,961,144444.0,43333.0,-68.0,-63.0,-70.0,-69.0,-68.0,-62.0,-70.0,-68.0,-81.0,-87.0,-81.0,-89.0,13.0,24.0,11.0,20.0,1
1549,F8:59:71:5A:E0:3D,2265466,441812598,110424,168419819,2155042,273392779,337,78724,110508366,78630,110494243,94,14123,78367,33,110420,8438,337,48,144444.0,43333.0,-66.0,-73.0,-66.0,-70.0,-66.0,-73.0,-65.0,-70.0,-81.0,-87.0,-81.0,-89.0,15.0,14.0,15.0,19.0,1
1550,CC:2F:71:3E:C5:1F,2155141,273404670,99,11891,2155042,273392779,0,466,39069,394,30375,72,8694,109,1,169,7,0,26,130000.0,39000.0,-72.0,-70.0,-67.0,-60.0,-71.0,-69.0,-67.0,-60.0,-81.0,-87.0,-81.0,-89.0,9.0,17.0,14.0,29.0,1
1551,CC:2F:71:3F:1F:24,2438548,642292154,283506,368899375,2155042,273392779,6,211350,259095868,211212,259077028,138,18840,206604,561,283554,32932,6,961,144444.0,43333.0,-68.0,-62.0,-71.0,-69.0,-68.0,-62.0,-70.0,-68.0,-81.0,-87.0,-81.0,-89.0,13.0,25.0,10.0,20.0,1
1552,F8:59:71:5A:E0:3D,2265540,441920344,110494,168527161,2155046,273393183,337,78796,110618264,78702,110604141,94,14123,78439,33,110490,8438,337,48,144444.0,43333.0,-67.0,-74.0,-66.0,-70.0,-66.0,-73.0,-65.0,-70.0,-81.0,-87.0,-81.0,-89.0,14.0,13.0,15.0,19.0,1
1553,CC:2F:71:3E:C5:1F,2155146,273405190,100,12007,2155046,273393183,0,468,39209,396,30515,72,8694,109,1,170,7,0,26,130000.0,39000.0,-73.0,-70.0,-67.0,-60.0,-72.0,-71.0,-67.0,-61.0,-81.0,-87.0,-81.0,-89.0,8.0,17.0,14.0,29.0,1
1554,CC:2F:71:3F:1F:24,2438717,642508250,283671,369115067,2155046,273393183,6,211509,259314856,211371,259296016,138,18840,206755,561,283719,32932,6,961,144444.0,43333.0,-69.0,-62.0,-71.0,-69.0,-68.0,-62.0,-70.0,-68.0,-81.0,-87.0,-81.0,-89.0,12.0,25.0,10.0,20.0,1
1555,F8:59:71:5A:E0:3D,2265792,442270719,110739,168876737,2155053,273393982,337,78895,110726098,78800,110711857,95,14241,78538,33,110735,8438,337,48,144444.0,43333.0,-63.0,-73.0,-65.0,-70.0,-65.0,-73.0,-65.0,-70.0,-81.0,-87.0,-81.0,-89.0,18.0,14.0,16.0,19.0,1
1556,CC:2F:71:3E:C5:1F,2155153,273405989,100,12007,2155053,273393982,0,468,39209,396,30515,72,8694,109,1,170,7,0,26,130000.0,39000.0,-73.0,-70.0,-67.0,-60.0,-72.0,-71.0,-67.0,-61.0,-81.0,-87.0,-81.0,-89.0,8.0,17.0,14.0,29.0,1
1557,CC:2F:71:3F:1F:24,2438895,642717012,283842,369323030,2155053,273393982,6,211669,259523807,211531,259504967,138,18840,206910,561,283890,32933,6,961,144444.0,43333.0,-68.0,-62.0,-70.0,-68.0,-68.0,-62.0,-70.0,-68.0,-81.0,-87.0,-81.0,-89.0,13.0,25.0,11.0,21.0,1
1558,F8:59:71:5A:E0:3D,2265862,442373519,110805,168979133,2155057,273394386,337,78960,110826226,78865,110811985,95,14241,78603,33,110801,8438,337,48,144444.0,43333.0,-65.0,-73.0,-64.0,-70.0,-65.0,-72.0,-64.0,-70.0,-81.0,-87.0,-81.0,-89.0,16.0,14.0,17.0,19.0,1
1559,CC:2F:71:3E:C5:1F,2155159,273406761,100,12007,2155059,273394754,0,468,39209,396,30515,72,8694,109,1,170,7,0,26,130000.0,39000.0,-73.0,-70.0,-67.0,-60.0,-72.0,-71.0,-67.0,-61.0,-81.0,-87.0,-81.0,-89.0,8.0,17.0,14.0,29.0,1
1560,CC:2F:71:3F:1F:24,2439478,643522996,284419,370128242,2155059,273394754,6,211896,259751437,211758,259732597,138,18840,207130,561,284467,32936,6,965,144444.0,43333.0,-68.0,-62.0,-70.0,-68.0,-67.0,-62.0,-70.0,-67.0,-81.0,-87.0,-81.0,-89.0,13.0,25.0,11.0,21.0,1
1561,F8:59:71:5A:E0:3D,2266100,442737973,111039,169343017,2155061,273394956,337,79063,110935758,78968,110921517,95,14241,78706,33,111035,8476,337,48,144444.0,43333.0,-67.0,-73.0,-65.0,-70.0,-65.0,-72.0,-64.0,-70.0,-81.0,-87.0,-81.0,-89.0,14.0,14.0,16.0,19.0,1
1562,CC:2F:71:3E:C5:1F,2155163,273407165,100,12007,2155063,273395158,0,468,39209,396,30515,72,8694,109,1,170,7,0,26,130000.0,39000.0,-73.0,-70.0,-67.0,-60.0,-72.0,-71.0,-67.0,-61.0,-81.0,-87.0,-81.0,-89.0,8.0,17.0,14.0,29.0,1
1563,CC:2F:71:3F:1F:24,2439662,643744553,284598,370349333,2155064,273395220,6,212063,259967379,211924,259948421,139,18958,207292,561,284646,32940,6,965,144444.0,43333.0,-68.0,-62.0,-71.0,-68.0,-68.0,-62.0,-70.0,-68.0,-81.0,-87.0,-81.0,-89.0,13.0,25.0,10.0,21.0,1
1564,F8:59:71:5A:E0:3D,2266172,442841063,111105,169445581,2155067,273395482,337,79129,111037426,79034,111023185,95,14241,78772,33,111101,8476,337,48,144444.0,43333.0,-65.0,-73.0,-65.0,-70.0,-63.0,-72.0,-64.0,-69.0,-81.0,-87.0,-81.0,-89.0,16.0,14.0,16.0,19.0,1
1565,CC:2F:71:3E:C5:1F,2155169,273407691,100,12007,2155069,273395684,0,468,39209,396,30515,72,8694,109,1,170,7,0,26,130000.0,39000.0,-73.0,-70.0,-67.0,-60.0,-72.0,-71.0,-67.0,-61.0,-81.0,-87.0,-81.0,-89.0,8.0,17.0,14.0,29.0,1
1566,CC:2F:71:3F:1F:24,2439857,643963252,284788,370567568,2155069,273395684,6,212251,260180203,212112,260161245,139,18958,207475,561,284836,32944,6,969,144444.0,43333.0,-68.0,-62.0,-71.0,-68.0,-67.0,-62.0,-70.0,-67.0,-81.0,-87.0,-81.0,-89.0,13.0,25.0,10.0,21.0,1
1567,F8:59:71:5A:E0:3D,2266238,442937815,111167,169541929,2155071,273395886,337,79192,111134446,79097,111120205,95,14241,78835,33,111163,8476,337,48,144444.0,43333.0,-65.0,-73.0,-64.0,-70.0,-65.0,-72.0,-64.0,-70.0,-81.0,-87.0,-81.0,-89.0,16.0,14.0,17.0,19.0,1
1568,CC:2F:71:3E:C5:1F,2155171,273407893,100,12007,2155071,273395886,0,468,39209,396,30515,72,8694,109,1,170,7,0,26,130000.0,39000.0,-73.0,-70.0,-67.0,-60.0,-72.0,-71.0,-67.0,-61.0,-81.0,-87.0,-81.0,-89.0,8.0,17.0,14.0,29.0,1
1569,CC:2F:71:3F:1F:24,2440022,644177476,284951,370781590,2155071,273395886,6,212406,260393017,212267,260374059,139,18958,207626,561,284999,32946,6,970,144444.0,43333.0,-68.0,-63.0,-70.0,-68.0,-68.0,-62.0,-70.0,-68.0,-81.0,-87.0,-81.0,-89.0,13.0,24.0,11.0,21.0,1
1570,F8:59:71:5A:E0:3D,2266308,443040783,111233,169644493,2155075,273396290,337,79257,111234546,79162,111220305,95,14241,78900,33,111229,8476,337,48,144444.0,43333.0,-65.0,-73.0,-65.0,-70.0,-64.0,-72.0,-64.0,-69.0,-81.0,-87.0,-81.0,-89.0,16.0,14.0,16.0,19.0,1
1571,CC:2F:71:3E:C5:1F,2155175,273408297,100,12007,2155075,273396290,0,468,39209,396,30515,72,8694,109,1,170,7,0,26,130000.0,39000.0,-73.0,-70.0,-67.0,-60.0,-72.0,-71.0,-67.0,-61.0,-81.0,-87.0,-81.0,-89.0,8.0,17.0,14.0,29.0,1
1572,CC:2F:71:3F:1F:24,2440184,644384132,285109,370987842,2155075,273396290,6,212552,260590525,212413,260571567,139,18958,207770,561,285157,32947,6,970,144444.0,43333.0,-68.0,-63.0,-71.0,-68.0,-68.0,-63.0,-70.0,-68.0,-81.0,-87.0,-81.0,-89.0,13.0,24.0,10.0,21.0,1
1573,F8:59:71:5A:E0:3D,2266440,443240047,111362,169843495,2155078,273396552,337,79332,111343382,79237,111329141,95,14241,78975,33,111358,8476,337,48,144444.0,43333.0,-61.0,-73.0,-65.0,-70.0,-63.0,-72.0,-64.0,-69.0,-81.0,-87.0,-81.0,-89.0,20.0,14.0,16.0,19.0,1
1574,CC:2F:71:3E:C5:1F,2155180,273408761,100,12007,2155080,273396754,0,468,39209,396,30515,72,8694,109,1,170,7,0,26,130000.0,39000.0,-73.0,-70.0,-67.0,-60.0,-72.0,-71.0,-67.0,-61.0,-80.0,-87.0,-81.0,-88.0,7.0,17.0,14.0,28.0,1
1575,CC:2F:71:3F:1F:24,2440364,644617380,285284,371220626,2155080,273396754,6,212721,260819259,212582,260800301,139,18958,207935,561,285332,32950,6,971,144444.0,43333.0,-68.0,-62.0,-70.0,-68.0,-68.0,-62.0,-70.0,-68.0,-80.0,-87.0,-81.0,-88.0,12.0,25.0,11.0,20.0,1
1576,F8:59:71:5A:E0:3D,2266554,443405839,111470,170008681,2155084,273397158,337,79413,111452930,79318,111438689,95,14241,79056,33,111466,8477,337,48,144444.0,43333.0,-66.0,-73.0,-65.0,-70.0,-65.0,-72.0,-65.0,-69.0,-80.0,-87.0,-81.0,-88.0,14.0,14.0,16.0,18.0,1
1577,CC:2F:71:3E:C5:1F,2155184,273409165,100,12007,2155084,273397158,0,468,39209,396,30515,72,8694,109,1,170,7,0,26,130000.0,39000.0,-73.0,-70.0,-67.0,-60.0,-72.0,-71.0,-67.0,-61.0,-80.0,-87.0,-81.0,-88.0,7.0,17.0,14.0,28.0,1
1578,CC:2F:71:3F:1F:24,2440546,644835244,285462,371438086,2155084,273397158,6,212884,261027040,212745,261008082,139,18958,208097,561,285510,32955,6,972,144444.0,43333.0,-67.0,-62.0,-70.0,-67.0,-66.0,-62.0,-69.0,-67.0,-80.0,-87.0,-81.0,-88.0,13.0,25.0,11.0,21.0,1
1579,F8:59:71:5A:E0:3D,2266621,443505559,111534,170108137,2155087,273397422,337,79477,111551490,79382,111537249,95,14241,79120,33,111530,8477,337,48,144444.0,43333.0,-66.0,-74.0,-65.0,-70.0,-64.0,-73.0,-64.0,-69.0,-80.0,-87.0,-81.0,-88.0,14.0,13.0,16.0,18.0,1
1580,CC:2F:71:3E:C5:1F,2155187,273409429,100,12007,2155087,273397422,0,470,39397,397,30585,73,8812,110,1,170,7,0,27,130000.0,39000.0,-72.0,-70.0,-66.0,-60.0,-72.0,-73.0,-68.0,-62.0,-80.0,-87.0,-81.0,-88.0,8.0,17.0,15.0,28.0,1
1581,CC:2F:71:3F:1F:24,2440729,645048008,285640,371650384,2155089,273397624,6,213050,261237046,212911,261218088,139,18958,208255,561,285688,32961,6,972,144444.0,43333.0,-67.0,-62.0,-70.0,-68.0,-66.0,-62.0,-69.0,-67.0,-80.0,-87.0,-81.0,-88.0,13.0,25.0,11.0,20.0,1
1582,F8:59:71:5A:E0:3D,2266696,443607696,111602,170209608,2155094,273398088,337,79546,111655302,79451,111641061,95,14241,79189,33,111598,8477,337,48,144444.0,43333.0,-62.0,-73.0,-65.0,-70.0,-65.0,-73.0,-65.0,-69.0,-80.0,-87.0,-81.0,-88.0,18.0,14.0,16.0,18.0,1
1583,CC:2F:71:3E:C5:1F,2155194,273410095,100,12007,2155094,273398088,0,470,39397,397,30585,73,8812,110,1,170,7,0,27,130000.0,39000.0,-72.0,-70.0,-66.0,-60.0,-72.0,-73.0,-68.0,-62.0,-80.0,-87.0,-81.0,-88.0,8.0,17.0,15.0,28.0,1
1584,CC:2F:71:3F:1F:24,2441414,645951804,286320,372553716,2155094,273398088,6,213332,261483669,213193,261464711,139,18958,208537,561,286368,32981,6,972,144444.0,43333.0,-67.0,-62.0,-70.0,-67.0,-67.0,-62.0,-69.0,-67.0,-80.0,-87.0,-81.0,-88.0,13.0,25.0,11.0,21.0,1
1585,F8:59:71:5A:E0:3D,2266775,443716369,111679,170318079,2155096,273398290,337,79620,111762227,79525,111747986,95,14241,79263,33,111675,8477,337,48,144444.0,43333.0,-65.0,-71.0,-65.0,-70.0,-65.0,-72.0,-64.0,-69.0,-80.0,-87.0,-81.0,-88.0,15.0,16.0,16.0,18.0,1
1586,CC:2F:71:3E:C5:1F,2155196,273410297,100,12007,2155096,273398290,0,470,39397,397,30585,73,8812,110,1,170,7,0,27,130000.0,39000.0,-72.0,-70.0,-66.0,-60.0,-72.0,-73.0,-68.0,-62.0,-80.0,-87.0,-81.0,-88.0,8.0,17.0,15.0,28.0,1
1587,CC:2F:71:3F:1F:24,2441571,646155020,286475,372756730,2155096,273398290,6,213472,261677613,213333,261658655,139,18958,208676,561,286523,32985,6,973,144444.0,43333.0,-66.0,-62.0,-69.0,-67.0,-66.0,-62.0,-69.0,-67.0,-80.0,-87.0,-81.0,-88.0,14.0,25.0,12.0,21.0,1
1588,F8:59:71:5A:E0:3D,2266841,443813121,111741,170414427,2155100,273398694,337,79683,111859247,79588,111845006,95,14241,79326,33,111737,8478,337,48,144444.0,43333.0,-65.0,-73.0,-65.0,-69.0,-64.0,-73.0,-65.0,-69.0,-80.0,-87.0,-81.0,-88.0,15.0,14.0,16.0,19.0,1
1589,CC:2F:71:3E:C5:1F,2155201,273410761,100,12007,2155101,273398754,0,470,39397,397,30585,73,8812,110,1,170,7,0,27,130000.0,39000.0,-72.0,-70.0,-66.0,-60.0,-72.0,-73.0,-68.0,-62.0,-80.0,-87.0,-81.0,-88.0,8.0,17.0,15.0,28.0,1
1590,CC:2F:71:3F:1F:24,2441737,646364916,286634,372965960,2155103,273398956,6,213618,261877801,213479,261858843,139,18958,208820,561,286682,32989,6,973,144444.0,43333.0,-67.0,-62.0,-70.0,-68.0,-67.0,-62.0,-70.0,-67.0,-80.0,-87.0,-81.0,-88.0,13.0,25.0,11.0,20.0,1
1591,F8:59:71:5A:E0:3D,2266914,443919257,111809,170520099,2155105,273399158,337,79751,111964023,79656,111949782,95,14241,79394,33,111805,8478,337,49,144444.0,43333.0,-65.0,-73.0,-64.0,-70.0,-64.0,-72.0,-64.0,-69.0,-80.0,-87.0,-81.0,-88.0,15.0,14.0,17.0,18.0,1
1592,CC:2F:71:3E:C5:1F,2155205,273411165,100,12007,2155105,273399158,0,470,39397,397,30585,73,8812,110,1,170,7,0,27,130000.0,39000.0,-72.0,-70.0,-66.0,-60.0,-72.0,-73.0,-68.0,-62.0,-80.0,-87.0,-81.0,-88.0,8.0,17.0,15.0,28.0,1
1593,CC:2F:71:3F:1F:24,2441915,646584962,286810,373185804,2155105,273399158,6,213781,262092047,213642,262073089,139,18958,208981,561,286858,32991,6,973,144444.0,43333.0,-67.0,-62.0,-70.0,-68.0,-66.0,-62.0,-69.0,-67.0,-80.0,-87.0,-81.0,-88.0,13.0,25.0,11.0,20.0,1
1594,F8:59:71:5A:E0:3D,2266981,444017563,111872,170618001,2155109,273399562,337,79813,112059503,79718,112045262,95,14241,79456,33,111867,8478,337,49,144444.0,43333.0,-66.0,-73.0,-64.0,-70.0,-64.0,-73.0,-64.0,-70.0,-80.0,-87.0,-81.0,-88.0,14.0,14.0,17.0,18.0,1
1595,CC:2F:71:3E:C5:1F,2155209,273411569,100,12007,2155109,273399562,0,470,39397,397,30585,73,8812,110,1,170,7,0,27,130000.0,39000.0,-72.0,-70.0,-66.0,-60.0,-72.0,-73.0,-68.0,-62.0,-80.0,-87.0,-81.0,-88.0,8.0,17.0,15.0,28.0,1
1596,CC:2F:71:3F:1F:24,2442154,646830146,287045,373430584,2155109,273399562,6,213986,262302889,213847,262283931,139,18958,209185,561,287093,32991,6,973,144444.0,39000.0,-67.0,-62.0,-70.0,-68.0,-67.0,-62.0,-70.0,-67.0,-80.0,-87.0,-81.0,-88.0,13.0,25.0,11.0,20.0,1
1597,F8:59:71:5A:E0:3D,2267060,444124759,111945,170724460,2155115,273400299,337,79884,112165353,79789,112151112,95,14241,79527,33,111941,8478,337,49,144444.0,43333.0,-65.0,-73.0,-65.0,-70.0,-65.0,-72.0,-64.0,-70.0,-80.0,-87.0,-81.0,-88.0,15.0,14.0,16.0,18.0,1
1598,CC:2F:71:3E:C5:1F,2155215,273412306,100,12007,2155115,273400299,0,470,39397,397,30585,73,8812,110,1,170,7,0,27,130000.0,39000.0,-72.0,-70.0,-66.0,-60.0,-72.0,-73.0,-68.0,-62.0,-80.0,-87.0,-81.0,-88.0,8.0,17.0,15.0,28.0,1
1599,CC:2F:71:3F:1F:24,2442328,647052619,287213,373652320,2155115,273400299,6,214140,262515601,214001,262496643,139,18958,209337,561,287261,32992,6,975,144444.0,43333.0,-67.0,-62.0,-70.0,-67.0,-67.0,-62.0,-70.0,-67.0,-80.0,-87.0,-81.0,-88.0,13.0,25.0,11.0,21.0,1
1600,F8:59:71:5A:E0:3D,2267313,444512031,112194,171111328,2155119,273400703,337,79986,112269115,79891,112254874,95,14241,79629,33,112190,8478,337,49,144444.0,43333.0,-65.0,-73.0,-62.0,-70.0,-64.0,-72.0,-64.0,-69.0,-80.0,-87.0,-81.0,-88.0,15.0,14.0,19.0,18.0,1
1601,CC:2F:71:3E:C5:1F,2155219,273412710,100,12007,2155119,273400703,0,470,39397,397,30585,73,8812,110,1,170,7,0,27,130000.0,39000.0,-72.0,-70.0,-66.0,-60.0,-72.0,-73.0,-68.0,-62.0,-80.0,-87.0,-81.0,-88.0,8.0,17.0,15.0,28.0,1
1602,CC:2F:71:3F:1F:24,2442493,647262641,287374,373861938,2155119,273400703,6,214289,262719117,214150,262700159,139,18958,209484,561,287422,32995,6,975,144444.0,43333.0,-67.0,-62.0,-70.0,-68.0,-67.0,-62.0,-70.0,-67.0,-80.0,-87.0,-81.0,-88.0,13.0,25.0,11.0,20.0,1
1603,F8:59:71:5A:E0:3D,2267382,444613445,112259,171212338,2155123,273401107,337,80051,112369215,79956,112354974,95,14241,79694,33,112255,8478,337,49,144444.0,43333.0,-62.0,-73.0,-65.0,-70.0,-64.0,-72.0,-64.0,-70.0,-80.0,-87.0,-80.0,-88.0,18.0,14.0,15.0,18.0,1
1604,CC:2F:71:3E:C5:1F,2155223,273413114,100,12007,2155123,273401107,0,470,39397,397,30585,73,8812,110,1,170,7,0,27,130000.0,39000.0,-72.0,-70.0,-66.0,-60.0,-72.0,-73.0,-68.0,-62.0,-80.0,-87.0,-80.0,-88.0,8.0,17.0,14.0,28.0,1
1605,CC:2F:71:3F:1F:24,2443192,648216806,288066,374815437,2155126,273401369,6,214611,263044932,214472,263025974,139,18958,209802,561,288114,33038,6,987,144444.0,43333.0,-67.0,-62.0,-70.0,-67.0,-67.0,-62.0,-70.0,-67.0,-80.0,-87.0,-80.0,-88.0,13.0,25.0,10.0,21.0,1
1606,F8:59:71:5A:E0:3D,2267607,444954848,112479,171553277,2155128,273401571,337,80159,112520299,80064,112506058,95,14241,79802,33,112474,8506,337,50,144444.0,43333.0,-62.0,-74.0,-65.0,-70.0,-63.0,-72.0,-64.0,-69.0,-80.0,-87.0,-80.0,-88.0,18.0,13.0,15.0,18.0,1
1607,CC:2F:71:3E:C5:1F,2155230,273413780,100,12007,2155130,273401773,0,470,39397,397,30585,73,8812,110,1,170,7,0,27,130000.0,39000.0,-72.0,-70.0,-66.0,-60.0,-72.0,-73.0,-68.0,-62.0,-80.0,-87.0,-80.0,-88.0,8.0,17.0,14.0,28.0,1
1608,CC:2F:71:3F:1F:24,2443375,648428859,288245,375027086,2155130,273401773,6,214769,263247979,214630,263229021,139,18958,209955,561,288293,33046,6,990,144444.0,43333.0,-67.0,-62.0,-70.0,-67.0,-67.0,-62.0,-70.0,-67.0,-80.0,-87.0,-80.0,-88.0,13.0,25.0,10.0,21.0,1
1609,F8:59:71:5A:E0:3D,2267673,445051600,112541,171649625,2155132,273401975,337,80221,112615779,80126,112601538,95,14241,79864,33,112536,8506,337,50,144444.0,43333.0,-65.0,-72.0,-65.0,-70.0,-64.0,-72.0,-64.0,-69.0,-80.0,-87.0,-80.0,-88.0,15.0,15.0,15.0,18.0,1
1610,CC:2F:71:3E:C5:1F,2155232,273413982,100,12007,2155132,273401975,0,470,39397,397,30585,73,8812,110,1,170,7,0,27,130000.0,39000.0,-72.0,-70.0,-66.0,-60.0,-72.0,-73.0,-68.0,-62.0,-80.0,-87.0,-80.0,-88.0,8.0,17.0,14.0,28.0,1
1611,CC:2F:71:3F:1F:24,2443551,648639264,288419,375237289,2155132,273401975,6,214929,263454047,214790,263435089,139,18958,210111,561,288467,33048,6,990,144444.0,43333.0,-67.0,-62.0,-70.0,-68.0,-67.0,-62.0,-70.0,-67.0,-80.0,-87.0,-80.0,-88.0,13.0,25.0,10.0,20.0,1
1612,F8:59:71:5A:E0:3D,2267739,445148352,112603,171745973,2155136,273402379,337,80283,112711259,80188,112697018,95,14241,79926,33,112599,8507,337,50,144444.0,43333.0,-66.0,-73.0,-65.0,-70.0,-65.0,-72.0,-63.0,-69.0,-80.0,-87.0,-80.0,-88.0,14.0,14.0,15.0,18.0,1
1613,CC:2F:71:3E:C5:1F,2155237,273414446,100,12007,2155137,273402439,0,470,39397,397,30585,73,8812,110,1,170,7,0,27,130000.0,39000.0,-72.0,-70.0,-66.0,-60.0,-72.0,-73.0,-68.0,-62.0,-80.0,-87.0,-80.0,-88.0,8.0,17.0,14.0,28.0,1
1614,CC:2F:71:3F:1F:24,2443897,649086219,288760,375683780,2155137,273402439,6,215152,263660371,215013,263641413,139,18958,210333,561,288808,33069,6,996,144444.0,43333.0,-68.0,-62.0,-71.0,-67.0,-67.0,-62.0,-70.0,-67.0,-80.0,-87.0,-80.0,-88.0,12.0,25.0,9.0,21.0,1
1615,F8:59:71:5A:E0:3D,2267831,445271408,112690,171868565,2155141,273402843,337,80368,112835446,80273,112821205,95,14241,80011,33,112686,8508,337,50,144444.0,43333.0,-66.0,-73.0,-65.0,-70.0,-65.0,-72.0,-64.0,-70.0,-80.0,-87.0,-80.0,-88.0,14.0,14.0,15.0,18.0,1
1616,CC:2F:71:3E:C5:1F,2155241,273414850,100,12007,2155141,273402843,0,470,39397,397,30585,73,8812,110,1,170,7,0,27,130000.0,39000.0,-72.0,-70.0,-66.0,-60.0,-72.0,-73.0,-68.0,-62.0,-80.0,-87.0,-80.0,-88.0,8.0,17.0,14.0,28.0,1
1617,CC:2F:71:3F:1F:24,2444269,649584631,289126,376181586,2155143,273403045,6,215414,263919929,215275,263900971,139,18958,210592,561,289174,33080,6,1002,144444.0,43333.0,-67.0,-62.0,-69.0,-68.0,-67.0,-62.0,-69.0,-67.0,-80.0,-87.0,-80.0,-88.0,13.0,25.0,11.0,20.0,1
1618,F8:59:71:5A:E0:3D,2267965,445471428,112820,172068181,2155145,273403247,337,80453,112939762,80358,112925521,95,14241,80096,33,112816,8509,337,50,144444.0,43333.0,-66.0,-74.0,-65.0,-71.0,-64.0,-72.0,-64.0,-70.0,-80.0,-86.0,-80.0,-88.0,14.0,12.0,15.0,17.0,1
1619,CC:2F:71:3E:C5:1F,2155245,273415254,100,12007,2155145,273403247,0,470,39397,397,30585,73,8812,110,1,170,7,0,27,130000.0,39000.0,-72.0,-70.0,-66.0,-60.0,-72.0,-73.0,-68.0,-62.0,-80.0,-86.0,-80.0,-88.0,8.0,16.0,14.0,28.0,1
1620,CC:2F:71:3F:1F:24,2444638,650042305,289493,376639058,2155145,273403247,6,215665,264139436,215526,264120478,139,18958,210840,561,289541,33134,6,1002,130000.0,43333.0,-69.0,-62.0,-72.0,-69.0,-68.0,-61.0,-71.0,-68.0,-80.0,-86.0,-80.0,-88.0,11.0,24.0,8.0,19.0,1
1621,F8:59:71:5A:E0:3D,2268044,445579834,112894,172176123,2155150,273403711,337,80529,113050750,80434,113036509,95,14241,80171,33,112890,8509,337,50,144444.0,43333.0,-62.0,-73.0,-62.0,-70.0,-64.0,-73.0,-64.0,-70.0,-80.0,-86.0,-80.0,-88.0,18.0,13.0,18.0,18.0,1
1622,CC:2F:71:3E:C5:1F,2155250,273415718,100,12007,2155150,273403711,0,470,39397,397,30585,73,8812,110,1,170,7,0,27,130000.0,39000.0,-72.0,-70.0,-66.0,-60.0,-72.0,-73.0,-68.0,-62.0,-80.0,-86.0,-80.0,-88.0,8.0,16.0,14.0,28.0,1
1623,CC:2F:71:3F:1F:24,2445006,650510160,289856,377106449,2155150,273403711,6,215916,264376813,215777,264357855,139,18958,211089,561,289904,33134,6,1007,130000.0,43333.0,-68.0,-61.0,-72.0,-67.0,-68.0,-61.0,-71.0,-67.0,-80.0,-86.0,-80.0,-88.0,12.0,25.0,8.0,21.0,1
1624,F8:59:71:5A:E0:3D,2268114,445682634,112960,172278519,2155154,273404115,337,80595,113152390,80500,113138149,95,14241,80237,33,112956,8509,337,50,144444.0,43333.0,-66.0,-73.0,-65.0,-70.0,-64.0,-72.0,-64.0,-69.0,-80.0,-86.0,-80.0,-88.0,14.0,13.0,15.0,18.0,1
1625,CC:2F:71:3E:C5:1F,2155254,273416122,100,12007,2155154,273404115,0,470,39397,397,30585,73,8812,110,1,170,7,0,27,130000.0,39000.0,-72.0,-70.0,-66.0,-60.0,-72.0,-73.0,-68.0,-62.0,-80.0,-86.0,-80.0,-88.0,8.0,16.0,14.0,28.0,1
1626,CC:2F:71:3F:1F:24,2445364,650971876,290210,377567761,2155154,273404115,6,216163,264606899,216024,264587941,139,18958,211331,561,290257,33140,6,1008,144444.0,43333.0,-69.0,-61.0,-68.0,-68.0,-69.0,-61.0,-67.0,-67.0,-80.0,-86.0,-80.0,-88.0,11.0,25.0,12.0,20.0,1
1627,F8:59:71:5A:E0:3D,2268184,445784174,113025,172379529,2155159,273404645,337,80660,113252490,80565,113238249,95,14241,80302,33,113021,8509,337,50,144444.0,43333.0,-66.0,-73.0,-65.0,-70.0,-65.0,-72.0,-65.0,-69.0,-79.0,-86.0,-80.0,-88.0,13.0,13.0,15.0,18.0,1
1628,CC:2F:71:3E:C5:1F,2155259,273416652,100,12007,2155159,273404645,0,470,39397,397,30585,73,8812,110,1,170,7,0,27,130000.0,39000.0,-72.0,-70.0,-66.0,-60.0,-72.0,-73.0,-68.0,-62.0,-79.0,-86.0,-80.0,-88.0,7.0,16.0,14.0,28.0,1
1629,CC:2F:71:3F:1F:24,2445877,651647610,290718,378242965,2155159,273404645,6,216468,264845606,216329,264826648,139,18958,211629,561,290766,33151,6,1008,130000.0,43333.0,-69.0,-62.0,-71.0,-67.0,-68.0,-61.0,-70.0,-66.0,-79.0,-86.0,-80.0,-88.0,10.0,24.0,9.0,21.0,1
1630,F8:59:71:5A:E0:3D,2268404,446116916,113240,172711807,2155164,273405109,337,80759,113382622,80664,113368381,95,14241,80401,33,113236,8509,337,50,144444.0,43333.0,-67.0,-74.0,-65.0,-69.0,-65.0,-73.0,-64.0,-69.0,-79.0,-86.0,-80.0,-88.0,12.0,12.0,15.0,19.0,1
1631,CC:2F:71:3E:C5:1F,2155266,273417318,100,12007,2155166,273405311,0,472,39537,399,30725,73,8812,110,1,171,7,0,27,130000.0,39000.0,-70.0,-69.0,-66.0,-60.0,-72.0,-72.0,-68.0,-62.0,-79.0,-86.0,-80.0,-88.0,9.0,17.0,14.0,28.0,1
1632,CC:2F:71:3F:1F:24,2446978,653140529,291812,379735218,2155166,273405311,6,216930,265184478,216791,265165520,139,18958,212083,561,291860,33174,6,1026,130000.0,43333.0,-68.0,-61.0,-68.0,-67.0,-67.0,-60.0,-68.0,-67.0,-79.0,-86.0,-80.0,-88.0,11.0,25.0,12.0,21.0,1
1633,F8:59:71:5A:E0:3D,2268490,446238912,113319,172833135,2155171,273405777,337,80835,113499662,80740,113485421,95,14241,80477,33,113315,8509,337,50,144444.0,43333.0,-62.0,-74.0,-65.0,-69.0,-64.0,-73.0,-64.0,-68.0,-79.0,-86.0,-80.0,-88.0,17.0,12.0,15.0,19.0,1
1634,CC:2F:71:3E:C5:1F,2155272,273417900,101,12123,2155171,273405777,0,476,39865,402,30935,74,8930,111,1,172,7,0,27,144444.0,39000.0,-70.0,-69.0,-65.0,-60.0,-70.0,-70.0,-66.0,-61.0,-79.0,-86.0,-80.0,-88.0,9.0,17.0,15.0,28.0,1
1635,CC:2F:71:3F:1F:24,2447192,653384619,292021,379978842,2155171,273405777,6,217121,265391662,216982,265372704,139,18958,212269,561,292069,33174,6,1026,130000.0,43333.0,-70.0,-61.0,-69.0,-68.0,-69.0,-61.0,-68.0,-68.0,-79.0,-86.0,-80.0,-88.0,9.0,25.0,11.0,20.0,1
1636,F8:59:71:5A:E0:3D,2268559,446340457,113384,172934145,2155175,273406312,337,80899,113598222,80804,113583981,95,14241,80541,33,113380,8510,337,50,144444.0,43333.0,-66.0,-73.0,-65.0,-69.0,-64.0,-72.0,-65.0,-69.0,-79.0,-86.0,-80.0,-88.0,13.0,13.0,15.0,19.0,1
1637,CC:2F:71:3E:C5:1F,2155278,273418637,101,12123,2155177,273406514,0,476,39865,402,30935,74,8930,111,1,172,7,0,27,144444.0,39000.0,-70.0,-69.0,-65.0,-60.0,-70.0,-70.0,-66.0,-61.0,-79.0,-86.0,-80.0,-88.0,9.0,17.0,15.0,28.0,1
1638,CC:2F:71:3F:1F:24,2447359,653596408,292182,380189894,2155177,273406514,6,217275,265604439,217136,265585481,139,18958,212415,561,292230,33174,6,1027,130000.0,43333.0,-68.0,-62.0,-69.0,-66.0,-68.0,-62.0,-69.0,-66.0,-79.0,-86.0,-80.0,-88.0,11.0,24.0,11.0,22.0,1
1639,F8:59:71:5A:E0:3D,2268626,446437271,113446,173030493,2155180,273406778,337,80961,113693702,80866,113679461,95,14241,80603,33,113442,8510,337,50,144444.0,43333.0,-64.0,-72.0,-65.0,-69.0,-65.0,-72.0,-64.0,-69.0,-79.0,-86.0,-79.0,-87.0,15.0,14.0,14.0,18.0,1
1640,CC:2F:71:3E:C5:1F,2155283,273419103,101,12123,2155182,273406980,0,476,39865,402,30935,74,8930,111,1,172,7,0,27,144444.0,39000.0,-70.0,-69.0,-65.0,-60.0,-70.0,-70.0,-66.0,-61.0,-79.0,-86.0,-79.0,-87.0,9.0,17.0,14.0,27.0,1
1641,CC:2F:71:3F:1F:24,2447541,653833908,292359,380426928,2155182,273406980,6,217448,265843845,217308,265824769,140,19076,212581,561,292407,33175,6,1029,144444.0,43333.0,-69.0,-62.0,-69.0,-67.0,-69.0,-62.0,-69.0,-67.0,-79.0,-86.0,-79.0,-87.0,10.0,24.0,10.0,20.0,1
1642,F8:59:71:5A:E0:3D,2268721,446564513,113524,173151705,2155197,273412808,337,81040,113815362,80945,113801121,95,14241,80682,33,113520,8515,337,50,144444.0,43333.0,-65.0,-71.0,-66.0,-69.0,-65.0,-71.0,-65.0,-68.0,-79.0,-86.0,-79.0,-87.0,14.0,15.0,13.0,18.0,1
1643,CC:2F:71:3E:C5:1F,2155298,273424931,101,12123,2155197,273412808,0,476,39865,402,30935,74,8930,111,1,172,7,0,27,144444.0,39000.0,-70.0,-69.0,-65.0,-60.0,-70.0,-70.0,-66.0,-61.0,-79.0,-86.0,-79.0,-87.0,9.0,17.0,14.0,27.0,1
1644,CC:2F:71:3F:1F:24,2447734,654066710,292526,380648478,2155208,273418232,6,217606,266064099,217466,266045023,140,19076,212734,561,292574,33176,6,1029,144444.0,43333.0,-69.0,-62.0,-70.0,-66.0,-69.0,-62.0,-69.0,-66.0,-79.0,-86.0,-79.0,-87.0,10.0,24.0,9.0,21.0,1
1645,F8:59:71:5A:E0:3D,2268804,446674519,113591,173255823,2155213,273418696,337,81106,113917002,81011,113902761,95,14241,80748,33,113587,8515,337,50,144444.0,43333.0,-65.0,-71.0,-65.0,-69.0,-64.0,-71.0,-64.0,-69.0,-79.0,-86.0,-79.0,-87.0,14.0,15.0,14.0,18.0,1
1646,CC:2F:71:3E:C5:1F,2155315,273430881,101,12123,2155214,273418758,0,476,39865,402,30935,74,8930,111,1,172,7,0,27,144444.0,39000.0,-70.0,-69.0,-65.0,-60.0,-70.0,-70.0,-66.0,-61.0,-79.0,-86.0,-79.0,-87.0,9.0,17.0,14.0,27.0,1
1647,CC:2F:71:3F:1F:24,2447948,654314895,292734,380896137,2155214,273418758,6,217816,266309515,217676,266290439,140,19076,212936,561,292782,33218,6,1029,130000.0,43333.0,-68.0,-62.0,-71.0,-67.0,-68.0,-61.0,-71.0,-67.0,-79.0,-86.0,-79.0,-87.0,11.0,24.0,8.0,20.0,1
1648,F8:59:71:5A:E0:3D,2269080,447096897,113862,173677735,2155218,273419162,337,81214,114038446,81118,114024087,96,14359,80856,33,113858,8515,337,50,144444.0,43333.0,-65.0,-74.0,-64.0,-69.0,-64.0,-73.0,-64.0,-68.0,-79.0,-86.0,-79.0,-87.0,14.0,12.0,15.0,18.0,1
1649,CC:2F:71:3E:C5:1F,2155319,273431285,101,12123,2155218,273419162,0,476,39865,402,30935,74,8930,111,1,172,7,0,27,144444.0,39000.0,-70.0,-69.0,-65.0,-60.0,-70.0,-70.0,-66.0,-61.0,-79.0,-86.0,-79.0,-87.0,9.0,17.0,14.0,27.0,1
1650,CC:2F:71:3F:1F:24,2448118,654535407,292900,381116245,2155218,273419162,6,217981,266540689,217841,266521613,140,19076,213089,561,292948,33218,6,1031,130000.0,43333.0,-70.0,-61.0,-71.0,-68.0,-69.0,-61.0,-71.0,-68.0,-79.0,-86.0,-79.0,-87.0,9.0,25.0,8.0,19.0,1
1651,F8:59:71:5A:E0:3D,2269146,447193649,113924,173774083,2155222,273419566,337,81277,114135466,81181,114121107,96,14359,80919,33,113920,8515,337,50,144444.0,43333.0,-66.0,-74.0,-65.0,-69.0,-64.0,-73.0,-63.0,-69.0,-79.0,-86.0,-79.0,-87.0,13.0,12.0,14.0,18.0,1
1652,CC:2F:71:3E:C5:1F,2155324,273431749,101,12123,2155223,273419626,0,476,39865,402,30935,74,8930,111,1,172,7,0,27,144444.0,39000.0,-70.0,-69.0,-65.0,-60.0,-70.0,-70.0,-66.0,-61.0,-79.0,-86.0,-79.0,-87.0,9.0,17.0,14.0,27.0,1
1653,CC:2F:71:3F:1F:24,2448279,654740439,293056,381320813,2155223,273419626,6,218125,266737917,217985,266718841,140,19076,213231,561,293104,33218,6,1031,130000.0,43333.0,-70.0,-61.0,-72.0,-66.0,-70.0,-61.0,-72.0,-66.0,-79.0,-86.0,-79.0,-87.0,9.0,25.0,7.0,21.0,1
1654,F8:59:71:5A:E0:3D,2269211,447290259,113986,173870431,2155225,273419828,337,81338,114229406,81242,114215047,96,14359,80980,33,113982,8515,337,50,144444.0,43333.0,-65.0,-71.0,-65.0,-70.0,-65.0,-71.0,-64.0,-70.0,-79.0,-86.0,-79.0,-87.0,14.0,15.0,14.0,17.0,1
1655,CC:2F:71:3E:C5:1F,2155326,273431951,101,12123,2155225,273419828,0,476,39865,402,30935,74,8930,111,1,172,7,0,27,144444.0,39000.0,-70.0,-69.0,-65.0,-60.0,-70.0,-70.0,-66.0,-61.0,-79.0,-86.0,-79.0,-87.0,9.0,17.0,14.0,27.0,1
1656,CC:2F:71:3F:1F:24,2448438,654945171,293213,381525343,2155225,273419828,6,218273,266939895,218133,266920819,140,19076,213376,561,293261,33221,6,1031,144444.0,43333.0,-69.0,-62.0,-70.0,-68.0,-70.0,-62.0,-71.0,-68.0,-79.0,-86.0,-79.0,-87.0,10.0,24.0,9.0,19.0,1
1657,F8:59:71:5A:E0:3D,2269322,447448666,114093,174028434,2155229,273420232,337,81413,114335800,81317,114321441,96,14359,81055,33,114089,8515,337,50,144444.0,43333.0,-66.0,-72.0,-64.0,-69.0,-64.0,-71.0,-64.0,-69.0,-79.0,-86.0,-79.0,-87.0,13.0,14.0,15.0,18.0,1
1658,CC:2F:71:3E:C5:1F,2155330,273432355,101,12123,2155229,273420232,0,476,39865,402,30935,74,8930,111,1,172,7,0,27,144444.0,39000.0,-70.0,-69.0,-65.0,-60.0,-70.0,-70.0,-66.0,-61.0,-79.0,-86.0,-79.0,-87.0,9.0,17.0,14.0,27.0,1
1659,CC:2F:71:3F:1F:24,2448608,655155356,293377,381734922,2155231,273420434,6,218430,267147869,218290,267128793,140,19076,213525,561,293425,33221,6,1031,144444.0,43333.0,-69.0,-61.0,-71.0,-69.0,-69.0,-61.0,-70.0,-68.0,-79.0,-86.0,-79.0,-87.0,10.0,25.0,8.0,18.0,1
1660,F8:59:71:5A:E0:3D,2269406,447551907,114172,174131211,2155234,273420696,337,81490,114441949,81394,114427590,96,14359,81132,33,114168,8515,337,50,144444.0,43333.0,-66.0,-72.0,-65.0,-69.0,-64.0,-71.0,-64.0,-69.0,-79.0,-86.0,-79.0,-87.0,13.0,14.0,14.0,18.0,1
1661,CC:2F:71:3E:C5:1F,2155335,273432819,101,12123,2155234,273420696,0,476,39865,402,30935,74,8930,111,1,172,7,0,27,144444.0,39000.0,-70.0,-69.0,-65.0,-60.0,-70.0,-70.0,-66.0,-61.0,-79.0,-86.0,-79.0,-87.0,9.0,17.0,14.0,27.0,1
1662,CC:2F:71:3F:1F:24,2448769,655361870,293535,381941174,2155234,273420696,6,218582,267357557,218442,267338481,140,19076,213669,561,293583,33221,6,1034,144444.0,43333.0,-71.0,-61.0,-70.0,-69.0,-71.0,-61.0,-70.0,-68.0,-79.0,-86.0,-79.0,-87.0,8.0,25.0,9.0,18.0,1
1663,F8:59:71:5A:E0:3D,2269595,447820103,114350,174398337,2155245,273421766,337,81688,114742025,81592,114727666,96,14359,81330,33,114346,8520,337,50,144444.0,43333.0,-65.0,-71.0,-66.0,-71.0,-64.0,-71.0,-64.0,-70.0,-78.0,-86.0,-79.0,-87.0,13.0,15.0,13.0,16.0,1
1664,CC:2F:71:3E:C5:1F,2155348,273434091,101,12123,2155247,273421968,0,476,39865,402,30935,74,8930,111,1,172,7,0,27,144444.0,39000.0,-70.0,-69.0,-65.0,-60.0,-70.0,-70.0,-66.0,-61.0,-78.0,-86.0,-79.0,-87.0,8.0,17.0,14.0,27.0,1
1665,CC:2F:71:3F:1F:24,2449741,656715332,294494,383293364,2155247,273421968,6,219180,268038572,219040,268019496,140,19076,214249,561,294542,33223,6,1094,144444.0,43333.0,-70.0,-61.0,-71.0,-69.0,-70.0,-60.0,-70.0,-68.0,-78.0,-86.0,-79.0,-87.0,8.0,25.0,8.0,18.0,1
1666,F8:59:71:5A:E0:3D,2269859,448224743,114610,174802573,2155249,273422170,337,81794,114861593,81698,114847234,96,14359,81436,33,114606,8520,337,50,144444.0,43333.0,-62.0,-71.0,-65.0,-70.0,-64.0,-71.0,-65.0,-70.0,-78.0,-86.0,-79.0,-87.0,16.0,15.0,14.0,17.0,1
1667,CC:2F:71:3E:C5:1F,2155352,273434495,101,12123,2155251,273422372,0,476,39865,402,30935,74,8930,111,1,172,7,0,27,144444.0,39000.0,-70.0,-69.0,-65.0,-60.0,-70.0,-70.0,-66.0,-61.0,-78.0,-86.0,-79.0,-87.0,8.0,17.0,14.0,27.0,1
1668,CC:2F:71:3F:1F:24,2449903,656921988,294652,383499616,2155251,273422372,6,219336,268251452,219196,268232376,140,19076,214393,561,294700,33223,6,1094,144444.0,43333.0,-69.0,-61.0,-70.0,-69.0,-69.0,-61.0,-70.0,-69.0,-78.0,-86.0,-79.0,-87.0,9.0,25.0,9.0,18.0,1
1669,F8:59:71:5A:E0:3D,2269937,448330457,114683,174907610,2155254,273422847,337,81868,114968304,81772,114953945,96,14359,81507,33,114679,8520,337,50,144444.0,43333.0,-66.0,-72.0,-65.0,-70.0,-65.0,-71.0,-65.0,-70.0,-78.0,-86.0,-79.0,-87.0,12.0,14.0,14.0,17.0,1
1670,CC:2F:71:3E:C5:1F,2155355,273434970,101,12123,2155254,273422847,0,476,39865,402,30935,74,8930,111,1,172,7,0,27,144444.0,39000.0,-70.0,-69.0,-65.0,-60.0,-70.0,-70.0,-66.0,-61.0,-78.0,-86.0,-79.0,-87.0,8.0,17.0,14.0,27.0,1
1671,CC:2F:71:3F:1F:24,2450069,657134891,294813,383711842,2155256,273423049,6,219495,268470738,219355,268451662,140,19076,214540,561,294861,33223,6,1098,144444.0,43333.0,-70.0,-61.0,-71.0,-70.0,-70.0,-61.0,-71.0,-69.0,-78.0,-86.0,-79.0,-87.0,8.0,25.0,8.0,17.0,1
1672,F8:59:71:5A:E0:3D,2270007,448426829,114748,175003518,2155259,273423311,337,81936,115064609,81840,115050250,96,14359,81575,33,114744,8521,337,50,144444.0,43333.0,-65.0,-71.0,-65.0,-70.0,-64.0,-71.0,-64.0,-70.0,-78.0,-86.0,-79.0,-87.0,13.0,15.0,14.0,17.0,1
1673,CC:2F:71:3E:C5:1F,2155360,273435434,101,12123,2155259,273423311,0,476,39865,402,30935,74,8930,111,1,172,7,0,27,144444.0,39000.0,-70.0,-69.0,-65.0,-60.0,-70.0,-70.0,-66.0,-61.0,-78.0,-86.0,-79.0,-87.0,8.0,17.0,14.0,27.0,1
1674,CC:2F:71:3F:1F:24,2450231,657342959,294972,383919648,2155259,273423311,6,219646,268676002,219506,268656926,140,19076,214685,561,295020,33225,6,1098,144444.0,43333.0,-70.0,-61.0,-70.0,-70.0,-69.0,-61.0,-70.0,-70.0,-78.0,-86.0,-79.0,-87.0,8.0,25.0,9.0,17.0,1
1675,F8:59:71:5A:E0:3D,2270078,448527187,114813,175103104,2155265,273424083,337,82002,115163309,81906,115148950,96,14359,81639,33,114809,8521,337,50,144444.0,43333.0,-62.0,-69.0,-65.0,-70.0,-64.0,-70.0,-64.0,-70.0,-78.0,-86.0,-79.0,-87.0,16.0,17.0,14.0,17.0,1
1676,CC:2F:71:3E:C5:1F,2155366,273436206,101,12123,2155265,273424083,0,476,39865,402,30935,74,8930,111,1,172,7,0,27,144444.0,39000.0,-70.0,-69.0,-65.0,-60.0,-70.0,-70.0,-66.0,-61.0,-78.0,-86.0,-79.0,-87.0,8.0,17.0,14.0,27.0,1
1677,CC:2F:71:3F:1F:24,2450540,657747710,295275,384323627,2155265,273424083,6,219830,268883363,219690,268864287,140,19076,214866,561,295314,33226,6,1098,144444.0,43333.0,-70.0,-61.0,-70.0,-70.0,-69.0,-61.0,-70.0,-69.0,-78.0,-86.0,-79.0,-87.0,8.0,25.0,9.0,17.0,1
1678,F8:59:71:5A:E0:3D,2270152,448636371,114883,175211884,2155269,273424487,337,82067,115263409,81971,115249050,96,14359,81704,33,114878,8521,337,50,144444.0,43333.0,-66.0,-71.0,-65.0,-69.0,-64.0,-71.0,-64.0,-69.0,-78.0,-86.0,-79.0,-87.0,12.0,15.0,14.0,18.0,1
1679,CC:2F:71:3E:C5:1F,2155373,273436872,101,12123,2155272,273424749,0,476,39865,402,30935,74,8930,111,1,172,7,0,27,144444.0,39000.0,-70.0,-69.0,-65.0,-60.0,-70.0,-70.0,-66.0,-61.0,-78.0,-86.0,-79.0,-87.0,8.0,17.0,14.0,27.0,1
1680,CC:2F:71:3F:1F:24,2451064,658462012,295792,385037263,2155272,273424749,6,220114,269175139,219974,269156063,140,19076,215136,561,295840,33236,6,1114,144444.0,43333.0,-70.0,-61.0,-70.0,-70.0,-69.0,-61.0,-70.0,-69.0,-78.0,-86.0,-79.0,-87.0,8.0,25.0,9.0,17.0,1
1681,F8:59:71:5A:E0:3D,2270387,448994264,115113,175569313,2155274,273424951,337,82168,115399439,82072,115385080,96,14359,81804,33,115108,8564,337,50,144444.0,43333.0,-62.0,-72.0,-65.0,-70.0,-64.0,-71.0,-65.0,-70.0,-78.0,-85.0,-79.0,-87.0,16.0,13.0,14.0,17.0,1
1682,CC:2F:71:3E:C5:1F,2155375,273437074,101,12123,2155274,273424951,0,476,39865,402,30935,74,8930,111,1,172,7,0,27,144444.0,39000.0,-70.0,-69.0,-65.0,-60.0,-70.0,-70.0,-66.0,-61.0,-78.0,-85.0,-79.0,-87.0,8.0,16.0,14.0,27.0,1
1683,CC:2F:71:3F:1F:24,2451241,658677089,295967,385252138,2155274,273424951,6,220271,269384523,220131,269365447,140,19076,215291,561,296015,33236,6,1114,144444.0,43333.0,-68.0,-61.0,-69.0,-69.0,-69.0,-61.0,-70.0,-69.0,-78.0,-85.0,-79.0,-87.0,10.0,24.0,10.0,18.0,1
1684,F8:59:71:5A:E0:3D,2270453,449091016,115175,175665661,2155278,273425355,337,82230,115494919,82134,115480560,96,14359,81866,33,115171,8564,337,50,144444.0,43333.0,-66.0,-71.0,-65.0,-70.0,-64.0,-71.0,-64.0,-70.0,-78.0,-85.0,-78.0,-86.0,12.0,14.0,13.0,16.0,1
1685,CC:2F:71:3E:C5:1F,2155379,273437478,101,12123,2155278,273425355,0,476,39865,402,30935,74,8930,111,1,172,7,0,27,144444.0,39000.0,-70.0,-69.0,-65.0,-60.0,-70.0,-70.0,-66.0,-61.0,-78.0,-85.0,-78.0,-86.0,8.0,16.0,13.0,26.0,1
1686,CC:2F:71:3F:1F:24,2451402,658883615,296124,385458260,2155278,273425355,6,220423,269595579,220283,269576503,140,19076,215435,561,296172,33236,6,1114,144444.0,43333.0,-69.0,-61.0,-69.0,-70.0,-69.0,-60.0,-70.0,-70.0,-78.0,-85.0,-78.0,-86.0,9.0,24.0,9.0,16.0,1
1687,F8:59:71:5A:E0:3D,2270520,449187828,115237,175762009,2155283,273425819,337,82293,115591939,82197,115577580,96,14359,81929,33,115233,8564,337,50,144444.0,43333.0,-65.0,-69.0,-65.0,-70.0,-64.0,-71.0,-65.0,-70.0,-78.0,-85.0,-78.0,-86.0,13.0,16.0,13.0,16.0,1
1688,CC:2F:71:3E:C5:1F,2155384,273437942,101,12123,2155283,273425819,0,476,39865,402,30935,74,8930,111,1,172,7,0,27,144444.0,39000.0,-70.0,-69.0,-65.0,-60.0,-70.0,-70.0,-66.0,-61.0,-78.0,-85.0,-78.0,-86.0,8.0,16.0,13.0,26.0,1
1689,CC:2F:71:3F:1F:24,2451562,659087093,296279,385661274,2155283,273425819,6,220571,269800545,220431,269781469,140,19076,215576,561,296327,33236,6,1118,144444.0,43333.0,-70.0,-61.0,-70.0,-70.0,-69.0,-61.0,-70.0,-70.0,-78.0,-85.0,-78.0,-86.0,8.0,24.0,8.0,16.0,1
1690,F8:59:71:5A:E0:3D,2270664,449396115,115377,175969892,2155287,273426223,337,82383,115700737,82287,115686378,96,14359,82019,33,115373,8577,337,52,144444.0,43333.0,-65.0,-72.0,-65.0,-70.0,-65.0,-71.0,-64.0,-70.0,-78.0,-85.0,-78.0,-86.0,13.0,13.0,13.0,16.0,1
1691,CC:2F:71:3E:C5:1F,2155388,273438346,101,12123,2155287,273426223,0,476,39865,402,30935,74,8930,111,1,172,7,0,27,144444.0,39000.0,-70.0,-69.0,-65.0,-60.0,-70.0,-70.0,-66.0,-61.0,-78.0,-85.0,-78.0,-86.0,8.0,16.0,13.0,26.0,1
1692,CC:2F:71:3F:1F:24,2451729,659294325,296442,385868102,2155287,273426223,6,220727,270008285,220587,269989209,140,19076,215724,561,296490,33237,6,1118,144444.0,43333.0,-70.0,-61.0,-71.0,-70.0,-70.0,-61.0,-70.0,-69.0,-78.0,-85.0,-78.0,-86.0,8.0,24.0,7.0,16.0,1
1693,F8:59:71:5A:E0:3D,2270731,449494421,115440,176067794,2155291,273426627,337,82445,115796217,82349,115781858,96,14359,82081,33,115436,8577,337,52,144444.0,43333.0,-61.0,-71.0,-65.0,-70.0,-64.0,-71.0,-64.0,-70.0,-78.0,-85.0,-78.0,-86.0,17.0,14.0,13.0,16.0,1
1694,CC:2F:71:3E:C5:1F,2155392,273438750,101,12123,2155291,273426627,0,476,39865,402,30935,74,8930,111,1,172,7,0,27,144444.0,39000.0,-70.0,-69.0,-65.0,-60.0,-70.0,-70.0,-66.0,-61.0,-78.0,-85.0,-78.0,-86.0,8.0,16.0,13.0,26.0,1
1695,CC:2F:71:3F:1F:24,2451890,659499432,296599,386072805,2155291,273426627,6,220877,270214884,220737,270195808,140,19076,215868,561,296647,33237,6,1121,144444.0,43333.0,-70.0,-61.0,-70.0,-70.0,-69.0,-60.0,-70.0,-69.0,-78.0,-85.0,-78.0,-86.0,8.0,24.0,8.0,16.0,1
1696,F8:59:71:5A:E0:3D,2270799,449591349,115503,176164258,2155296,273427091,337,82509,115893343,82413,115878984,96,14359,82145,33,115499,8577,337,52,144444.0,43333.0,-65.0,-71.0,-65.0,-70.0,-65.0,-71.0,-65.0,-70.0,-78.0,-85.0,-78.0,-86.0,13.0,14.0,13.0,16.0,1
1697,CC:2F:71:3E:C5:1F,2155397,273439214,101,12123,2155296,273427091,0,476,39865,402,30935,74,8930,111,1,172,7,0,27,144444.0,39000.0,-70.0,-69.0,-65.0,-60.0,-70.0,-70.0,-66.0,-61.0,-78.0,-85.0,-78.0,-86.0,8.0,16.0,13.0,26.0,1
1698,CC:2F:71:3F:1F:24,2452051,659704464,296755,386277373,2155296,273427091,6,221028,270417566,220888,270398490,140,19076,216010,561,296803,33237,6,1121,144444.0,43333.0,-70.0,-61.0,-71.0,-70.0,-70.0,-60.0,-70.0,-70.0,-78.0,-85.0,-78.0,-86.0,8.0,24.0,7.0,16.0,1
1699,F8:59:71:5A:E0:3D,2270863,449687899,115565,176260606,2155298,273427293,337,82571,115988823,82475,115974464,96,14359,82207,33,115561,8577,337,52,144444.0,43333.0,-65.0,-72.0,-65.0,-70.0,-64.0,-71.0,-64.0,-70.0,-78.0,-85.0,-78.0,-86.0,13.0,13.0,13.0,16.0,1
1700,CC:2F:71:3E:C5:1F,2155399,273439416,101,12123,2155298,273427293,0,476,39865,402,30935,74,8930,111,1,172,7,0,27,144444.0,39000.0,-70.0,-69.0,-65.0,-60.0,-70.0,-70.0,-66.0,-61.0,-78.0,-85.0,-78.0,-86.0,8.0,16.0,13.0,26.0,1
1701,CC:2F:71:3F:1F:24,2452219,659911311,296919,386483816,2155300,273427495,6,221177,270615726,221037,270596650,140,19076,216157,561,296967,33238,6,1121,144444.0,43333.0,-71.0,-61.0,-70.0,-71.0,-70.0,-61.0,-70.0,-70.0,-78.0,-85.0,-78.0,-86.0,7.0,24.0,8.0,15.0,1
1702,F8:59:71:5A:E0:3D,2271004,449889441,115699,176461482,2155305,273427959,337,82682,116149199,82586,116134840,96,14359,82318,33,115695,8578,337,53,144444.0,43333.0,-65.0,-71.0,-65.0,-70.0,-64.0,-71.0,-64.0,-69.0,-78.0,-85.0,-78.0,-86.0,13.0,14.0,13.0,16.0,1
1703,CC:2F:71:3E:C5:1F,2155406,273440082,101,12123,2155305,273427959,0,476,39865,402,30935,74,8930,111,1,172,7,0,27,144444.0,39000.0,-70.0,-69.0,-65.0,-60.0,-70.0,-70.0,-66.0,-61.0,-78.0,-85.0,-78.0,-86.0,8.0,16.0,13.0,26.0,1
1704,CC:2F:71:3F:1F:24,2452490,660265830,297183,386837669,2155307,273428161,6,221431,270959811,221291,270940735,140,19076,216407,561,297231,33239,6,1173,144444.0,43333.0,-70.0,-61.0,-70.0,-70.0,-69.0,-60.0,-70.0,-70.0,-78.0,-85.0,-78.0,-86.0,8.0,24.0,8.0,16.0,1
1705,F8:59:71:5A:E0:3D,2271081,450003287,115772,176574924,2155309,273428363,337,82755,116261619,82659,116247260,96,14359,82391,33,115768,8578,337,53,144444.0,43333.0,-62.0,-68.0,-65.0,-70.0,-64.0,-71.0,-64.0,-70.0,-78.0,-85.0,-78.0,-86.0,16.0,17.0,13.0,16.0,1
1706,CC:2F:71:3E:C5:1F,2155410,273440486,101,12123,2155309,273428363,0,478,40005,404,31075,74,8930,111,1,173,7,0,27,144444.0,39000.0,-71.0,-69.0,-67.0,-60.0,-69.0,-68.0,-65.0,-60.0,-78.0,-85.0,-78.0,-86.0,7.0,16.0,11.0,26.0,1
1707,CC:2F:71:3F:1F:24,2452651,660471029,297342,387042666,2155309,273428363,6,221584,271168322,221444,271149246,140,19076,216554,561,297390,33240,6,1173,144444.0,43333.0,-69.0,-61.0,-70.0,-70.0,-69.0,-61.0,-70.0,-70.0,-78.0,-85.0,-78.0,-86.0,9.0,24.0,8.0,16.0,1
1708,F8:59:71:5A:E0:3D,2271148,450100155,115835,176671388,2155313,273428767,337,82818,116358653,82722,116344294,96,14359,82453,33,115831,8578,337,53,144444.0,43333.0,-66.0,-72.0,-62.0,-71.0,-65.0,-71.0,-64.0,-70.0,-78.0,-85.0,-78.0,-86.0,12.0,13.0,16.0,15.0,1
1709,CC:2F:71:3E:C5:1F,2155415,273440950,102,12183,2155313,273428767,0,480,40145,406,31215,74,8930,111,1,174,7,0,27,144444.0,39000.0,-70.0,-68.0,-67.0,-60.0,-69.0,-68.0,-66.0,-60.0,-78.0,-85.0,-78.0,-86.0,8.0,17.0,11.0,26.0,1
1710,CC:2F:71:3F:1F:24,2452813,660676247,297500,387247480,2155313,273428767,6,221737,271380974,221597,271361898,140,19076,216695,561,297548,33240,6,1173,144444.0,43333.0,-70.0,-61.0,-71.0,-70.0,-69.0,-61.0,-70.0,-70.0,-78.0,-85.0,-78.0,-86.0,8.0,24.0,7.0,16.0,1
1711,F8:59:71:5A:E0:3D,2271216,450197240,115897,176767736,2155319,273429504,337,82880,116454133,82784,116439774,96,14359,82515,33,115893,8578,337,53,144444.0,43333.0,-65.0,-71.0,-65.0,-70.0,-64.0,-71.0,-64.0,-70.0,-78.0,-85.0,-78.0,-86.0,13.0,14.0,13.0,16.0,1
1712,CC:2F:71:3E:C5:1F,2155421,273441687,102,12183,2155319,273429504,0,480,40145,406,31215,74,8930,111,1,174,7,0,27,144444.0,39000.0,-70.0,-68.0,-67.0,-60.0,-69.0,-68.0,-66.0,-60.0,-78.0,-85.0,-78.0,-86.0,8.0,17.0,11.0,26.0,1
1713,CC:2F:71:3F:1F:24,2453005,660926568,297685,387497002,2155320,273429566,6,221917,271628372,221777,271609296,140,19076,216863,561,297733,33240,6,1184,144444.0,43333.0,-70.0,-61.0,-70.0,-70.0,-69.0,-60.0,-70.0,-69.0,-78.0,-85.0,-78.0,-86.0,8.0,24.0,8.0,16.0,1
1714,F8:59:71:5A:E0:3D,2271462,450572239,116138,177142269,2155324,273429970,337,82997,116613355,82900,116598878,97,14477,82632,33,116134,8578,337,53,144444.0,43333.0,-66.0,-72.0,-65.0,-71.0,-65.0,-71.0,-64.0,-70.0,-78.0,-85.0,-78.0,-86.0,12.0,13.0,13.0,15.0,1
1715,CC:2F:71:3E:C5:1F,2155428,273442355,102,12183,2155326,273430172,0,480,40145,406,31215,74,8930,111,1,174,7,0,27,144444.0,39000.0,-70.0,-68.0,-67.0,-60.0,-69.0,-68.0,-66.0,-60.0,-78.0,-85.0,-78.0,-86.0,8.0,17.0,11.0,26.0,1
1716,CC:2F:71:3F:1F:24,2453861,662128246,298533,388697872,2155328,273430374,6,222303,272041012,222163,272021936,140,19076,217235,561,298580,33241,6,1225,144444.0,43333.0,-70.0,-61.0,-70.0,-70.0,-69.0,-60.0,-70.0,-70.0,-78.0,-85.0,-78.0,-86.0,8.0,24.0,8.0,16.0,1
1717,F8:59:71:5A:E0:3D,2271739,450989955,116406,177559117,2155333,273430838,337,83139,116789801,83042,116775324,97,14477,82773,33,116402,8578,337,53,144444.0,43333.0,-61.0,-72.0,-65.0,-70.0,-64.0,-71.0,-64.0,-70.0,-78.0,-85.0,-78.0,-86.0,17.0,13.0,13.0,16.0,1
1718,CC:2F:71:3E:C5:1F,2155435,273443021,102,12183,2155333,273430838,0,480,40145,406,31215,74,8930,111,1,174,7,0,27,144444.0,39000.0,-70.0,-68.0,-67.0,-60.0,-69.0,-68.0,-66.0,-60.0,-78.0,-85.0,-78.0,-86.0,8.0,17.0,11.0,26.0,1
1719,CC:2F:71:3F:1F:24,2454029,662344156,298696,388913318,2155333,273430838,6,222480,272289172,222340,272270096,140,19076,217402,561,298744,33241,6,1225,144444.0,43333.0,-70.0,-61.0,-70.0,-71.0,-70.0,-61.0,-70.0,-70.0,-78.0,-85.0,-78.0,-86.0,8.0,24.0,8.0,15.0,1
1720,F8:59:71:5A:E0:3D,2271807,451088377,116470,177657135,2155337,273431242,337,83203,116886927,83106,116872450,97,14477,82837,33,116466,8578,337,53,144444.0,43333.0,-66.0,-72.0,-62.0,-70.0,-64.0,-71.0,-64.0,-70.0,-78.0,-85.0,-78.0,-86.0,12.0,13.0,16.0,16.0,1
1721,CC:2F:71:3E:C5:1F,2155439,273443425,102,12183,2155337,273431242,0,480,40145,406,31215,74,8930,111,1,174,7,0,27,144444.0,39000.0,-70.0,-68.0,-67.0,-60.0,-69.0,-68.0,-66.0,-60.0,-78.0,-85.0,-78.0,-86.0,8.0,17.0,11.0,26.0,1
1722,CC:2F:71:3F:1F:24,2454499,662945569,299162,389514327,2155337,273431242,6,222725,272529378,222585,272510302,140,19076,217633,561,299210,33254,6,1232,144444.0,43333.0,-70.0,-61.0,-71.0,-71.0,-70.0,-61.0,-70.0,-70.0,-78.0,-85.0,-78.0,-86.0,8.0,24.0,7.0,15.0,1
1723,F8:59:71:5A:E0:3D,2271880,451196007,116539,177764361,2155341,273431646,337,83271,116991647,83174,116977170,97,14477,82905,33,116535,8578,337,53,144444.0,43333.0,-65.0,-69.0,-65.0,-71.0,-64.0,-70.0,-64.0,-70.0,-78.0,-85.0,-78.0,-86.0,13.0,16.0,13.0,15.0,1
1724,CC:2F:71:3E:C5:1F,2155443,273443829,102,12183,2155341,273431646,0,480,40145,406,31215,74,8930,111,1,174,7,0,27,144444.0,39000.0,-70.0,-68.0,-67.0,-60.0,-69.0,-68.0,-66.0,-60.0,-78.0,-85.0,-78.0,-86.0,8.0,17.0,11.0,26.0,1
1725,CC:2F:71:3F:1F:24,2454679,663171296,299337,389739590,2155342,273431706,6,222891,272746989,222751,272727913,140,19076,217796,561,299385,33257,6,1235,144444.0,43333.0,-70.0,-61.0,-71.0,-70.0,-70.0,-60.0,-70.0,-70.0,-78.0,-85.0,-78.0,-86.0,8.0,24.0,7.0,16.0,1
1726,F8:59:71:5A:E0:3D,2271961,451306170,116615,177874060,2155346,273432110,337,83345,117101079,83248,117086602,97,14477,82979,33,116611,8578,337,53,144444.0,43333.0,-62.0,-72.0,-65.0,-70.0,-64.0,-71.0,-65.0,-70.0,-78.0,-85.0,-78.0,-86.0,16.0,13.0,13.0,16.0,1
1727,CC:2F:71:3E:C5:1F,2155448,273444293,102,12183,2155346,273432110,0,480,40145,406,31215,74,8930,111,1,174,7,0,27,144444.0,39000.0,-70.0,-68.0,-67.0,-60.0,-69.0,-68.0,-66.0,-60.0,-78.0,-85.0,-78.0,-86.0,8.0,17.0,11.0,26.0,1
1728,CC:2F:71:3F:1F:24,2454854,663399578,299508,389967468,2155346,273432110,6,223054,272976395,222914,272957319,140,19076,217952,561,299556,33257,6,1235,144444.0,43333.0,-71.0,-61.0,-71.0,-70.0,-70.0,-61.0,-71.0,-70.0,-78.0,-85.0,-78.0,-86.0,7.0,24.0,7.0,16.0,1
1729,F8:59:71:5A:E0:3D,2272197,451655250,116847,178222736,2155350,273432514,337,83452,117220653,83355,117206176,97,14477,83086,33,116843,8578,337,53,144444.0,43333.0,-66.0,-72.0,-65.0,-70.0,-65.0,-71.0,-64.0,-70.0,-78.0,-85.0,-78.0,-86.0,12.0,13.0,13.0,16.0,1
1730,CC:2F:71:3E:C5:1F,2155452,273444697,102,12183,2155350,273432514,0,480,40145,406,31215,74,8930,111,1,174,7,0,27,144444.0,39000.0,-70.0,-68.0,-67.0,-60.0,-69.0,-68.0,-66.0,-60.0,-78.0,-85.0,-78.0,-86.0,8.0,17.0,11.0,26.0,1
1731,CC:2F:71:3F:1F:24,2455025,663620348,299675,390187834,2155350,273432514,6,223217,273198924,223077,273179848,140,19076,218107,561,299723,33257,6,1241,144444.0,43333.0,-70.0,-61.0,-70.0,-70.0,-69.0,-60.0,-70.0,-70.0,-78.0,-85.0,-78.0,-86.0,8.0,24.0,8.0,16.0,1
1732,F8:59:71:5A:E0:3D,2272267,451756724,116912,178323746,2155355,273432978,337,83516,117319213,83419,117304736,97,14477,83150,33,116908,8578,337,53,144444.0,43333.0,-65.0,-72.0,-65.0,-70.0,-65.0,-71.0,-64.0,-70.0,-78.0,-85.0,-78.0,-86.0,13.0,13.0,13.0,16.0,1
1733,CC:2F:71:3E:C5:1F,2155457,273445161,102,12183,2155355,273432978,0,480,40145,406,31215,74,8930,111,1,174,7,0,27,144444.0,39000.0,-70.0,-68.0,-67.0,-60.0,-69.0,-68.0,-66.0,-60.0,-78.0,-85.0,-78.0,-86.0,8.0,17.0,11.0,26.0,1
1734,CC:2F:71:3F:1F:24,2455189,663827194,299834,390394216,2155355,273432978,6,223373,273410694,223233,273391618,140,19076,218252,561,299882,33263,6,1241,144444.0,43333.0,-70.0,-61.0,-71.0,-70.0,-70.0,-61.0,-70.0,-70.0,-78.0,-85.0,-78.0,-86.0,8.0,24.0,7.0,16.0,1
1735,F8:59:71:5A:E0:3D,2272339,451855817,116980,178422435,2155359,273433382,337,83582,117417610,83485,117403133,97,14477,83216,33,116976,8579,337,53,144444.0,43333.0,-66.0,-71.0,-65.0,-70.0,-63.0,-71.0,-65.0,-70.0,-78.0,-85.0,-78.0,-86.0,12.0,14.0,13.0,16.0,1
1736,CC:2F:71:3E:C5:1F,2155461,273445565,102,12183,2155359,273433382,0,480,40145,406,31215,74,8930,111,1,174,7,0,27,144444.0,39000.0,-70.0,-68.0,-67.0,-60.0,-69.0,-68.0,-66.0,-60.0,-78.0,-85.0,-78.0,-86.0,8.0,17.0,11.0,26.0,1
1737,CC:2F:71:3F:1F:24,2455356,664035637,299997,390602255,2155359,273433382,6,223528,273611398,223388,273592322,140,19076,218403,561,300045,33263,6,1241,144444.0,43333.0,-70.0,-61.0,-70.0,-70.0,-69.0,-60.0,-70.0,-70.0,-78.0,-85.0,-78.0,-86.0,8.0,24.0,8.0,16.0,1
1738,F8:59:71:5A:E0:3D,2272403,451953781,117043,178520337,2155360,273433444,337,83646,117516184,83549,117501707,97,14477,83279,33,117039,8579,337,53,144444.0,43333.0,-65.0,-71.0,-65.0,-70.0,-64.0,-71.0,-64.0,-70.0,-78.0,-85.0,-78.0,-86.0,13.0,14.0,13.0,16.0,1
1739,CC:2F:71:3E:C5:1F,2155462,273445627,102,12183,2155360,273433444,0,480,40145,406,31215,74,8930,111,1,174,7,0,27,144444.0,39000.0,-70.0,-68.0,-67.0,-60.0,-69.0,-68.0,-66.0,-60.0,-78.0,-85.0,-78.0,-86.0,8.0,17.0,11.0,26.0,1
1740,CC:2F:71:3F:1F:24,2455520,664243885,300157,390810177,2155363,273433708,6,223679,273815248,223538,273796054,141,19194,218549,561,300205,33268,6,1241,144444.0,43333.0,-70.0,-61.0,-70.0,-70.0,-69.0,-61.0,-70.0,-70.0,-78.0,-85.0,-78.0,-86.0,8.0,24.0,8.0,16.0,1
1741,F8:59:71:5A:E0:3D,2272476,452052613,117106,178618239,2155370,273434374,337,83710,117614758,83613,117600281,97,14477,83342,33,117102,8579,337,53,144444.0,43333.0,-65.0,-72.0,-65.0,-70.0,-64.0,-71.0,-64.0,-70.0,-78.0,-85.0,-78.0,-86.0,13.0,13.0,13.0,16.0,1
1742,CC:2F:71:3E:C5:1F,2155472,273446557,102,12183,2155370,273434374,0,482,40333,407,31285,75,9048,112,1,174,7,0,27,144444.0,39000.0,-70.0,-68.0,-67.0,-60.0,-70.0,-68.0,-66.0,-60.0,-78.0,-85.0,-78.0,-86.0,8.0,17.0,11.0,26.0,1
1743,CC:2F:71:3F:1F:24,2455715,664478428,300345,391044054,2155370,273434374,6,223845,274028570,223704,274009376,141,19194,218712,561,300393,33268,6,1241,144444.0,43333.0,-70.0,-61.0,-71.0,-69.0,-70.0,-60.0,-70.0,-69.0,-78.0,-85.0,-78.0,-86.0,8.0,24.0,7.0,17.0,1
1744,F8:59:71:5A:E0:3D,2272547,452162779,117177,178728405,2155370,273434374,337,83781,117724098,83684,117709621,97,14477,83413,33,117173,8580,337,53,144444.0,43333.0,-66.0,-71.0,-65.0,-70.0,-65.0,-71.0,-64.0,-70.0,-78.0,-85.0,-78.0,-86.0,12.0,14.0,13.0,16.0,1
1745,CC:2F:71:3E:C5:1F,2155472,273446557,102,12183,2155370,273434374,0,482,40333,407,31285,75,9048,112,1,174,7,0,27,144444.0,39000.0,-70.0,-68.0,-67.0,-60.0,-70.0,-68.0,-66.0,-60.0,-78.0,-85.0,-78.0,-86.0,8.0,17.0,11.0,26.0,1
1746,CC:2F:71:3F:1F:24,2455872,664684550,300502,391250176,2155370,273434374,6,224008,274258060,223867,274238866,141,19194,218866,561,300550,33268,6,1242,144444.0,43333.0,-70.0,-61.0,-71.0,-70.0,-70.0,-60.0,-70.0,-70.0,-78.0,-85.0,-78.0,-86.0,8.0,24.0,7.0,16.0,1
1747,F8:59:71:5A:E0:3D,2272741,452454843,117365,179019863,2155376,273434980,337,83860,117824840,83763,117810363,97,14477,83492,33,117361,8580,337,53,144444.0,43333.0,-64.0,-71.0,-65.0,-71.0,-64.0,-71.0,-64.0,-70.0,-78.0,-85.0,-78.0,-86.0,14.0,14.0,13.0,15.0,1
1748,CC:2F:71:3E:C5:1F,2155481,273447638,102,12183,2155379,273435455,0,482,40333,407,31285,75,9048,112,1,174,7,0,27,144444.0,39000.0,-70.0,-68.0,-67.0,-60.0,-70.0,-68.0,-66.0,-60.0,-78.0,-85.0,-78.0,-86.0,8.0,17.0,11.0,26.0,1
1749,CC:2F:71:3F:1F:24,2456036,664888645,300657,391453190,2155379,273435455,6,224150,274455238,224009,274436044,141,19194,219006,561,300705,33268,6,1246,144444.0,43333.0,-70.0,-61.0,-70.0,-70.0,-70.0,-61.0,-70.0,-70.0,-78.0,-85.0,-78.0,-86.0,8.0,24.0,8.0,16.0,1
1750,F8:59:71:5A:E0:3D,2272815,452557175,117435,179121660,2155380,273435515,337,83929,117927769,83832,117913292,97,14477,83561,33,117431,8580,337,53,144444.0,43333.0,-65.0,-71.0,-65.0,-70.0,-65.0,-70.0,-64.0,-70.0,-78.0,-85.0,-78.0,-86.0,13.0,14.0,13.0,16.0,1
1751,CC:2F:71:3E:C5:1F,2155482,273447698,102,12183,2155380,273435515,0,482,40333,407,31285,75,9048,112,1,174,7,0,27,144444.0,39000.0,-70.0,-68.0,-67.0,-60.0,-70.0,-68.0,-66.0,-60.0,-78.0,-85.0,-78.0,-86.0,8.0,17.0,11.0,26.0,1
1752,CC:2F:71:3F:1F:24,2456310,665241638,300930,391806123,2155380,273435515,6,224331,274678261,224190,274659067,141,19194,219180,561,300969,33268,6,1246,144444.0,43333.0,-70.0,-61.0,-70.0,-70.0,-70.0,-60.0,-70.0,-70.0,-78.0,-85.0,-78.0,-86.0,8.0,24.0,8.0,16.0,1
1753,F8:59:71:5A:E0:3D,2272886,452658791,117500,179222670,2155386,273436121,337,83994,118027869,83897,118013392,97,14477,83626,33,117496,8580,337,53,144444.0,43333.0,-61.0,-71.0,-65.0,-70.0,-64.0,-71.0,-64.0,-69.0,-78.0,-85.0,-78.0,-86.0,17.0,14.0,13.0,16.0,1
1754,CC:2F:71:3E:C5:1F,2155488,273448304,102,12183,2155386,273436121,0,482,40333,407,31285,75,9048,112,1,174,7,0,27,144444.0,39000.0,-70.0,-68.0,-67.0,-60.0,-70.0,-68.0,-66.0,-60.0,-78.0,-85.0,-78.0,-86.0,8.0,17.0,11.0,26.0,1
1755,CC:2F:71:3F:1F:24,2456959,666137453,301571,392701130,2155388,273436323,6,224596,274912381,224455,274893187,141,19194,219437,561,301619,33268,6,1266,144444.0,43333.0,-69.0,-60.0,-70.0,-70.0,-69.0,-60.0,-70.0,-70.0,-78.0,-85.0,-78.0,-86.0,9.0,25.0,8.0,16.0,1
1756,F8:59:71:5A:E0:3D,2273144,453056867,117756,179620544,2155388,273436323,337,84108,118152817,84011,118138340,97,14477,83740,33,117752,8592,337,53,144444.0,43333.0,-66.0,-72.0,-65.0,-70.0,-65.0,-71.0,-64.0,-69.0,-78.0,-85.0,-78.0,-86.0,12.0,13.0,13.0,16.0,1
1757,CC:2F:71:3E:C5:1F,2155491,273448566,102,12183,2155389,273436383,0,482,40333,407,31285,75,9048,112,1,174,7,0,27,144444.0,39000.0,-70.0,-68.0,-67.0,-60.0,-70.0,-68.0,-66.0,-60.0,-78.0,-85.0,-78.0,-86.0,8.0,17.0,11.0,26.0,1
1758,CC:2F:71:3F:1F:24,2457138,666376269,301749,392939886,2155389,273436383,6,224772,275154923,224631,275135729,141,19194,219603,561,301797,33269,6,1281,144444.0,43333.0,-70.0,-61.0,-71.0,-69.0,-70.0,-60.0,-70.0,-69.0,-78.0,-85.0,-78.0,-86.0,8.0,24.0,7.0,17.0,1
1759,F8:59:71:5A:E0:3D,2273213,453153881,117818,179716892,2155395,273436989,337,84170,118248297,84073,118233820,97,14477,83802,33,117814,8592,337,53,144444.0,43333.0,-65.0,-71.0,-65.0,-70.0,-65.0,-71.0,-64.0,-70.0,-78.0,-85.0,-78.0,-86.0,13.0,14.0,13.0,16.0,1
1760,CC:2F:71:3E:C5:1F,2155497,273449172,102,12183,2155395,273436989,0,482,40333,407,31285,75,9048,112,1,174,7,0,27,144444.0,39000.0,-70.0,-68.0,-67.0,-60.0,-70.0,-68.0,-66.0,-60.0,-78.0,-85.0,-78.0,-86.0,8.0,17.0,11.0,26.0,1
1761,CC:2F:71:3F:1F:24,2457303,666583199,301906,393146008,2155397,273437191,6,224922,275358479,224781,275339285,141,19194,219747,561,301954,33269,6,1281,144444.0,43333.0,-69.0,-61.0,-70.0,-70.0,-69.0,-61.0,-70.0,-70.0,-78.0,-85.0,-78.0,-86.0,9.0,24.0,8.0,16.0,1
1762,F8:59:71:5A:E0:3D,2273277,453250431,117880,179813240,2155397,273437191,337,84233,118345317,84136,118330840,97,14477,83865,33,117876,8592,337,53,144444.0,43333.0,-65.0,-71.0,-65.0,-70.0,-64.0,-71.0,-64.0,-70.0,-78.0,-85.0,-78.0,-86.0,13.0,14.0,13.0,16.0,1
1763,CC:2F:71:3E:C5:1F,2155499,273449374,102,12183,2155397,273437191,0,482,40333,407,31285,75,9048,112,1,174,7,0,27,144444.0,39000.0,-70.0,-68.0,-67.0,-60.0,-70.0,-68.0,-66.0,-60.0,-78.0,-85.0,-78.0,-86.0,8.0,17.0,11.0,26.0,1
1764,CC:2F:71:3F:1F:24,2457480,666811572,302083,393374381,2155397,273437191,6,225092,275587835,224951,275568641,141,19194,219909,561,302131,33270,6,1284,144444.0,43333.0,-68.0,-61.0,-69.0,-71.0,-69.0,-61.0,-70.0,-70.0,-78.0,-85.0,-78.0,-86.0,10.0,24.0,9.0,15.0,1
1765,F8:59:71:5A:E0:3D,2273354,453358492,117950,179920635,2155404,273437857,337,84304,118451848,84207,118437371,97,14477,83936,33,117946,8592,337,53,144444.0,43333.0,-66.0,-72.0,-65.0,-70.0,-64.0,-71.0,-65.0,-70.0,-78.0,-85.0,-78.0,-86.0,12.0,13.0,13.0,16.0,1
1766,CC:2F:71:3E:C5:1F,2155506,273450040,102,12183,2155404,273437857,0,482,40333,407,31285,75,9048,112,1,174,7,0,27,144444.0,39000.0,-70.0,-68.0,-67.0,-60.0,-70.0,-68.0,-66.0,-60.0,-78.0,-85.0,-78.0,-86.0,8.0,17.0,11.0,26.0,1
1767,CC:2F:71:3F:1F:24,2458051,667595163,302647,394157306,2155404,273437857,6,225328,275810084,225187,275790890,141,19194,220134,561,302695,33270,6,1284,144444.0,43333.0,-70.0,-61.0,-71.0,-71.0,-69.0,-61.0,-70.0,-70.0,-78.0,-85.0,-78.0,-86.0,8.0,24.0,7.0,15.0,1
1768,F8:59:71:5A:E0:3D,2273455,453507355,118049,180069296,2155406,273438059,337,84375,118553083,84278,118538606,97,14477,84007,33,118044,8592,337,53,144444.0,43333.0,-61.0,-71.0,-65.0,-70.0,-63.0,-71.0,-64.0,-69.0,-78.0,-85.0,-78.0,-86.0,17.0,14.0,13.0,16.0,1
1769,CC:2F:71:3E:C5:1F,2155508,273450242,102,12183,2155406,273438059,0,482,40333,407,31285,75,9048,112,1,174,7,0,27,144444.0,39000.0,-70.0,-68.0,-67.0,-60.0,-70.0,-68.0,-66.0,-60.0,-78.0,-85.0,-78.0,-86.0,8.0,17.0,11.0,26.0,1
1770,CC:2F:71:3F:1F:24,2458210,667800063,302804,394362004,2155406,273438059,6,225475,276011988,225334,275992794,141,19194,220275,561,302852,33271,6,1284,144444.0,43333.0,-70.0,-61.0,-71.0,-70.0,-70.0,-61.0,-71.0,-70.0,-78.0,-85.0,-78.0,-86.0,8.0,24.0,7.0,16.0,1
1771,F8:59:71:5A:E0:3D,2273525,453606119,118115,180167656,2155410,273438463,337,84442,118652463,84345,118637986,97,14477,84074,33,118110,8592,337,53,144444.0,43333.0,-66.0,-71.0,-65.0,-70.0,-65.0,-71.0,-64.0,-70.0,-78.0,-85.0,-78.0,-86.0,12.0,14.0,13.0,16.0,1
1772,CC:2F:71:3E:C5:1F,2155514,273450848,102,12183,2155412,273438665,0,482,40333,407,31285,75,9048,112,1,174,7,0,27,144444.0,39000.0,-70.0,-68.0,-67.0,-60.0,-70.0,-68.0,-66.0,-60.0,-78.0,-85.0,-78.0,-86.0,8.0,17.0,11.0,26.0,1
1773,CC:2F:71:3F:1F:24,2458375,668008475,302963,394569810,2155412,273438665,6,225630,276223534,225489,276204340,141,19194,220421,561,303011,33274,6,1284,144444.0,43333.0,-71.0,-61.0,-71.0,-70.0,-69.0,-60.0,-70.0,-69.0,-78.0,-85.0,-78.0,-86.0,7.0,24.0,7.0,16.0,1
1774,F8:59:71:5A:E0:3D,2273593,453704485,118178,180265558,2155415,273438927,337,84505,118749483,84408,118735006,97,14477,84137,33,118174,8592,337,53,144444.0,43333.0,-66.0,-72.0,-65.0,-70.0,-65.0,-71.0,-64.0,-70.0,-78.0,-85.0,-78.0,-86.0,12.0,13.0,13.0,16.0,1
1775,CC:2F:71:3E:C5:1F,2155517,273451110,102,12183,2155415,273438927,0,482,40333,407,31285,75,9048,112,1,174,7,0,27,144444.0,39000.0,-70.0,-68.0,-67.0,-60.0,-70.0,-68.0,-66.0,-60.0,-78.0,-85.0,-78.0,-86.0,8.0,17.0,11.0,26.0,1
1776,CC:2F:71:3F:1F:24,2458571,668224485,303156,394785558,2155415,273438927,6,225804,276429154,225663,276409960,141,19194,220591,561,303204,33275,6,1286,144444.0,43333.0,-70.0,-61.0,-70.0,-70.0,-69.0,-61.0,-70.0,-70.0,-78.0,-85.0,-78.0,-86.0,8.0,24.0,8.0,16.0,1
1777,F8:59:71:5A:E0:3D,2273662,453804604,118245,180365475,2155417,273439129,337,84573,118850331,84476,118835854,97,14477,84205,33,118241,8592,337,53,144444.0,43333.0,-66.0,-72.0,-65.0,-70.0,-65.0,-71.0,-64.0,-70.0,-78.0,-85.0,-78.0,-86.0,12.0,13.0,13.0,16.0,1
1778,CC:2F:71:3E:C5:1F,2155521,273451514,102,12183,2155419,273439331,0,482,40333,407,31285,75,9048,112,1,174,7,0,27,144444.0,39000.0,-70.0,-68.0,-67.0,-60.0,-70.0,-68.0,-66.0,-60.0,-78.0,-85.0,-78.0,-86.0,8.0,17.0,11.0,26.0,1
1779,CC:2F:71:3F:1F:24,2458733,668430973,303314,394991642,2155419,273439331,6,225956,276637504,225815,276618310,141,19194,220734,561,303362,33275,6,1286,144444.0,43333.0,-70.0,-61.0,-71.0,-70.0,-69.0,-61.0,-70.0,-70.0,-78.0,-85.0,-78.0,-86.0,8.0,24.0,7.0,16.0,1
1780,F8:59:71:5A:E0:3D,2273730,453901558,118307,180461823,2155423,273439735,337,84636,118947351,84539,118932874,97,14477,84268,33,118303,8592,337,53,144444.0,43333.0,-65.0,-71.0,-65.0,-70.0,-65.0,-71.0,-64.0,-70.0,-78.0,-85.0,-78.0,-86.0,13.0,14.0,13.0,16.0,1
1781,CC:2F:71:3E:C5:1F,2155525,273451918,102,12183,2155423,273439735,0,482,40333,407,31285,75,9048,112,1,174,7,0,27,144444.0,39000.0,-70.0,-68.0,-67.0,-60.0,-70.0,-68.0,-66.0,-60.0,-78.0,-85.0,-78.0,-86.0,8.0,17.0,11.0,26.0,1
1782,CC:2F:71:3F:1F:24,2458892,668634391,303469,395194656,2155423,273439735,6,226101,276837752,225960,276818558,141,19194,220873,561,303516,33275,6,1286,144444.0,43333.0,-70.0,-61.0,-70.0,-70.0,-70.0,-61.0,-70.0,-70.0,-78.0,-85.0,-78.0,-86.0,8.0,24.0,8.0,16.0,1
1783,F8:59:71:5A:E0:3D,2273805,454002516,118379,180562519,2155426,273439997,337,84717,119067362,84620,119052885,97,14477,84349,33,118375,8593,337,53,144444.0,43333.0,-65.0,-71.0,-65.0,-69.0,-65.0,-71.0,-64.0,-69.0,-78.0,-85.0,-78.0,-86.0,13.0,14.0,13.0,17.0,1
1784,CC:2F:71:3E:C5:1F,2155530,273452382,102,12183,2155428,273440199,0,482,40333,407,31285,75,9048,112,1,174,7,0,27,144444.0,39000.0,-70.0,-68.0,-67.0,-60.0,-70.0,-68.0,-66.0,-60.0,-78.0,-85.0,-78.0,-86.0,8.0,17.0,11.0,26.0,1
1785,CC:2F:71:3F:1F:24,2459098,668905039,303668,395464638,2155430,273440401,6,226299,277117204,226158,277098010,141,19194,221060,561,303716,33275,6,1305,144444.0,43333.0,-70.0,-61.0,-71.0,-69.0,-70.0,-60.0,-70.0,-69.0,-78.0,-85.0,-78.0,-86.0,8.0,24.0,7.0,17.0,1
1786,F8:59:71:5A:E0:3D,2274071,454407019,118639,180966416,2155432,273440603,337,84824,119182830,84727,119168353,97,14477,84456,33,118635,8593,337,53,144444.0,43333.0,-62.0,-71.0,-64.0,-70.0,-63.0,-71.0,-64.0,-69.0,-78.0,-85.0,-78.0,-86.0,16.0,14.0,14.0,16.0,1
1787,CC:2F:71:3E:C5:1F,2155535,273452902,103,12299,2155432,273440603,0,486,40613,411,31565,75,9048,112,1,176,7,0,27,144444.0,39000.0,-70.0,-69.0,-67.0,-60.0,-69.0,-67.0,-66.0,-60.0,-78.0,-85.0,-78.0,-86.0,8.0,16.0,11.0,26.0,1
1788,CC:2F:71:3F:1F:24,2459280,669125668,303848,395685065,2155432,273440603,6,226472,277337249,226331,277318055,141,19194,221224,561,303895,33276,6,1307,144444.0,43333.0,-70.0,-61.0,-70.0,-70.0,-69.0,-60.0,-70.0,-69.0,-78.0,-85.0,-78.0,-86.0,8.0,24.0,8.0,16.0,1
1789,F8:59:71:5A:E0:3D,2274143,454509221,118710,181068345,2155433,273440876,337,84893,119284562,84796,119270085,97,14477,84525,33,118706,8593,337,53,144444.0,43333.0,-65.0,-71.0,-61.0,-70.0,-65.0,-71.0,-64.0,-69.0,-78.0,-85.0,-78.0,-86.0,13.0,14.0,17.0,16.0,1
1790,CC:2F:71:3E:C5:1F,2155536,273453175,103,12299,2155433,273440876,0,486,40613,411,31565,75,9048,112,1,176,7,0,27,144444.0,39000.0,-70.0,-69.0,-67.0,-60.0,-69.0,-67.0,-66.0,-60.0,-78.0,-85.0,-78.0,-86.0,8.0,16.0,11.0,26.0,1
1791,CC:2F:71:3F:1F:24,2459445,669331402,304007,395890062,2155438,273441340,6,226619,277536430,226478,277517236,141,19194,221368,561,304054,33277,6,1307,144444.0,43333.0,-70.0,-61.0,-71.0,-70.0,-69.0,-60.0,-70.0,-69.0,-78.0,-85.0,-78.0,-86.0,8.0,24.0,7.0,16.0,1
1792,F8:59:71:5A:E0:3D,2274215,454607991,118773,181166247,2155442,273441744,337,84955,119380042,84858,119365565,97,14477,84587,33,118769,8593,337,53,144444.0,43333.0,-66.0,-72.0,-65.0,-70.0,-65.0,-71.0,-64.0,-69.0,-78.0,-85.0,-78.0,-86.0,12.0,13.0,13.0,16.0,1
1793,CC:2F:71:3E:C5:1F,2155545,273454043,103,12299,2155442,273441744,0,486,40613,411,31565,75,9048,112,1,176,7,0,27,144444.0,39000.0,-70.0,-69.0,-67.0,-60.0,-69.0,-67.0,-66.0,-60.0,-78.0,-85.0,-78.0,-86.0,8.0,16.0,11.0,26.0,1
1794,CC:2F:71:3F:1F:24,2459603,669531842,304161,396090098,2155442,273441744,6,226766,277738444,226625,277719250,141,19194,221508,561,304209,33278,6,1307,144444.0,43333.0,-69.0,-61.0,-71.0,-69.0,-70.0,-61.0,-70.0,-69.0,-78.0,-85.0,-78.0,-86.0,9.0,24.0,7.0,17.0,1
1795,F8:59:71:5A:E0:3D,2274280,454704769,118835,181262595,2155445,273442174,337,85017,119475522,84920,119461045,97,14477,84649,33,118831,8593,337,53,144444.0,43333.0,-61.0,-72.0,-64.0,-70.0,-64.0,-71.0,-64.0,-70.0,-78.0,-85.0,-78.0,-86.0,17.0,13.0,14.0,16.0,1
1796,CC:2F:71:3E:C5:1F,2155548,273454473,103,12299,2155445,273442174,0,486,40613,411,31565,75,9048,112,1,176,7,0,27,144444.0,39000.0,-70.0,-69.0,-67.0,-60.0,-69.0,-67.0,-66.0,-60.0,-78.0,-85.0,-78.0,-86.0,8.0,16.0,11.0,26.0,1
1797,CC:2F:71:3F:1F:24,2459772,669739843,304327,396297669,2155445,273442174,6,226923,277948056,226781,277928744,142,19312,221659,561,304375,33278,6,1307,144444.0,43333.0,-70.0,-61.0,-71.0,-70.0,-70.0,-61.0,-70.0,-70.0,-78.0,-85.0,-78.0,-86.0,8.0,24.0,7.0,16.0,1
1798,F8:59:71:5A:E0:3D,2274352,454802101,118898,181359059,2155454,273443042,337,85080,119571108,84983,119556631,97,14477,84712,33,118894,8593,337,53,144444.0,43333.0,-66.0,-72.0,-65.0,-70.0,-64.0,-71.0,-65.0,-70.0,-78.0,-85.0,-78.0,-86.0,12.0,13.0,13.0,16.0,1
1799,CC:2F:71:3E:C5:1F,2155557,273455341,103,12299,2155454,273443042,0,486,40613,411,31565,75,9048,112,1,176,7,0,27,144444.0,39000.0,-70.0,-69.0,-67.0,-60.0,-69.0,-67.0,-66.0,-60.0,-78.0,-85.0,-78.0,-86.0,8.0,16.0,11.0,26.0,1
1800,CC:2F:71:3F:1F:24,2459938,669943971,304484,396500929,2155454,273443042,6,227069,278147208,226927,278127896,142,19312,221801,561,304532,33278,6,1311,144444.0,43333.0,-70.0,-61.0,-70.0,-70.0,-70.0,-60.0,-70.0,-69.0,-78.0,-85.0,-78.0,-86.0,8.0,24.0,8.0,16.0,1
1801,F8:59:71:5A:E0:3D,2274635,455228795,119172,181784883,2155463,273443912,337,85250,119810566,85153,119796089,97,14477,84882,33,119168,8594,337,54,144444.0,43333.0,-66.0,-72.0,-66.0,-70.0,-64.0,-71.0,-65.0,-70.0,-78.0,-85.0,-78.0,-86.0,12.0,13.0,12.0,16.0,1
1802,CC:2F:71:3E:C5:1F,2155566,273456211,103,12299,2155463,273443912,0,488,40801,412,31635,76,9166,113,1,176,7,0,27,144444.0,39000.0,-70.0,-69.0,-67.0,-60.0,-69.0,-67.0,-66.0,-60.0,-78.0,-85.0,-78.0,-86.0,8.0,16.0,11.0,26.0,1
1803,CC:2F:71:3F:1F:24,2460743,671036029,305280,397592117,2155463,273443912,6,227574,278717734,227432,278698422,142,19312,222281,561,305327,33278,6,1378,144444.0,43333.0,-70.0,-61.0,-70.0,-70.0,-70.0,-61.0,-70.0,-69.0,-78.0,-85.0,-78.0,-86.0,8.0,24.0,8.0,16.0,1
1804,F8:59:71:5A:E0:3D,2274717,455350528,119253,181906556,2155464,273443972,337,85330,119929964,85233,119915487,97,14477,84962,33,119249,8594,337,54,144444.0,43333.0,-67.0,-72.0,-65.0,-70.0,-64.0,-71.0,-64.0,-70.0,-78.0,-85.0,-78.0,-86.0,11.0,13.0,13.0,16.0,1
1805,CC:2F:71:3E:C5:1F,2155569,273456473,103,12299,2155466,273444174,0,488,40801,412,31635,76,9166,113,1,176,7,0,27,144444.0,39000.0,-70.0,-69.0,-67.0,-60.0,-69.0,-67.0,-66.0,-60.0,-78.0,-85.0,-78.0,-86.0,8.0,16.0,11.0,26.0,1
1806,CC:2F:71:3F:1F:24,2460922,671248404,305452,397803826,2155470,273444578,6,227736,278931377,227594,278912065,142,19312,222434,561,305500,33279,6,1378,144444.0,43333.0,-70.0,-61.0,-70.0,-70.0,-69.0,-60.0,-70.0,-70.0,-78.0,-85.0,-78.0,-86.0,8.0,24.0,8.0,16.0,1
1807,F8:59:71:5A:E0:3D,2274795,455459948,119323,182015168,2155472,273444780,337,85398,120034698,85301,120020221,97,14477,85029,33,119319,8595,337,54,144444.0,43333.0,-65.0,-72.0,-65.0,-70.0,-65.0,-71.0,-64.0,-70.0,-78.0,-85.0,-78.0,-86.0,13.0,13.0,13.0,16.0,1
1808,CC:2F:71:3E:C5:1F,2155575,273457079,103,12299,2155472,273444780,0,488,40801,412,31635,76,9166,113,1,176,7,0,27,144444.0,39000.0,-70.0,-69.0,-67.0,-60.0,-69.0,-67.0,-66.0,-60.0,-78.0,-85.0,-78.0,-86.0,8.0,16.0,11.0,26.0,1
1809,CC:2F:71:3F:1F:24,2461095,671475060,305623,398030280,2155472,273444780,6,227904,279164225,227762,279144913,142,19312,222594,561,305671,33279,6,1378,144444.0,43333.0,-70.0,-60.0,-71.0,-70.0,-69.0,-60.0,-70.0,-69.0,-78.0,-85.0,-78.0,-86.0,8.0,25.0,7.0,16.0,1
1810,F8:59:71:5A:E0:3D,2274941,455677285,119468,182232445,2155473,273444840,337,85489,120150220,85392,120135743,97,14477,85120,33,119464,8595,337,54,144444.0,43333.0,-62.0,-71.0,-65.0,-70.0,-64.0,-70.0,-64.0,-70.0,-77.0,-84.0,-77.0,-85.0,15.0,13.0,12.0,15.0,1
1811,CC:2F:71:3E:C5:1F,2155578,273457341,103,12299,2155475,273445042,0,488,40801,412,31635,76,9166,113,1,176,7,0,27,144444.0,39000.0,-70.0,-69.0,-67.0,-60.0,-69.0,-67.0,-66.0,-60.0,-77.0,-84.0,-77.0,-85.0,7.0,15.0,10.0,25.0,1
1812,CC:2F:71:3F:1F:24,2461279,671701311,305800,398255865,2155479,273445446,6,228075,279388072,227933,279368760,142,19312,222758,561,305848,33280,6,1378,144444.0,43333.0,-68.0,-60.0,-67.0,-70.0,-69.0,-60.0,-70.0,-70.0,-77.0,-84.0,-77.0,-85.0,9.0,24.0,10.0,15.0,1
1813,F8:59:71:5A:E0:3D,2275018,455785319,119537,182339671,2155481,273445648,337,85558,120256480,85461,120242003,97,14477,85189,33,119533,8595,337,54,144444.0,43333.0,-65.0,-71.0,-65.0,-70.0,-64.0,-71.0,-65.0,-70.0,-77.0,-84.0,-77.0,-85.0,12.0,13.0,12.0,15.0,1
1814,CC:2F:71:3E:C5:1F,2155585,273458009,103,12299,2155482,273445710,0,488,40801,412,31635,76,9166,113,1,176,7,0,27,144444.0,39000.0,-70.0,-69.0,-67.0,-60.0,-69.0,-67.0,-66.0,-60.0,-77.0,-84.0,-77.0,-85.0,7.0,15.0,10.0,25.0,1
1815,CC:2F:71:3F:1F:24,2461847,672457600,306365,399011890,2155482,273445710,6,228338,279623832,228196,279604520,142,19312,223006,561,306413,33283,6,1388,144444.0,43333.0,-70.0,-61.0,-71.0,-70.0,-69.0,-61.0,-70.0,-70.0,-77.0,-84.0,-77.0,-85.0,7.0,23.0,6.0,15.0,1
1816,F8:59:71:5A:E0:3D,2275082,455883283,119600,182437573,2155482,273445710,337,85621,120352078,85523,120337483,98,14595,85252,33,119596,8596,337,54,144444.0,43333.0,-65.0,-71.0,-65.0,-70.0,-64.0,-70.0,-64.0,-70.0,-77.0,-84.0,-77.0,-85.0,12.0,13.0,12.0,15.0,1
1817,CC:2F:71:3E:C5:1F,2155585,273458009,103,12299,2155482,273445710,0,488,40801,412,31635,76,9166,113,1,176,7,0,27,144444.0,39000.0,-70.0,-69.0,-67.0,-60.0,-69.0,-67.0,-66.0,-60.0,-77.0,-84.0,-77.0,-85.0,7.0,15.0,10.0,25.0,1
1818,CC:2F:71:3F:1F:24,2462005,672663838,306523,399218128,2155482,273445710,6,228490,279833538,228348,279814226,142,19312,223150,561,306571,33284,6,1389,144444.0,43333.0,-70.0,-61.0,-70.0,-70.0,-69.0,-60.0,-70.0,-70.0,-77.0,-84.0,-77.0,-85.0,7.0,23.0,7.0,15.0,1
1819,F8:59:71:5A:E0:3D,2275153,455980499,119662,182533921,2155491,273446578,337,85684,120449126,85586,120434531,98,14595,85315,33,119658,8596,337,55,144444.0,43333.0,-65.0,-70.0,-65.0,-70.0,-65.0,-71.0,-65.0,-70.0,-77.0,-84.0,-77.0,-85.0,12.0,14.0,12.0,15.0,1
1820,CC:2F:71:3E:C5:1F,2155594,273458877,103,12299,2155491,273446578,0,488,40801,412,31635,76,9166,113,1,176,7,0,27,144444.0,39000.0,-70.0,-69.0,-67.0,-60.0,-69.0,-67.0,-66.0,-60.0,-77.0,-84.0,-77.0,-85.0,7.0,15.0,10.0,25.0,1
1821,CC:2F:71:3F:1F:24,2462178,672869046,306687,399422468,2155491,273446578,6,228644,280036396,228502,280017084,142,19312,223299,561,306735,33284,6,1389,144444.0,43333.0,-70.0,-61.0,-70.0,-70.0,-70.0,-61.0,-70.0,-70.0,-77.0,-84.0,-77.0,-85.0,7.0,23.0,7.0,15.0,1
1822,F8:59:71:5A:E0:3D,2275215,456076847,119724,182630269,2155491,273446578,337,85745,120543066,85647,120528471,98,14595,85376,33,119720,8597,337,55,144444.0,43333.0,-66.0,-70.0,-65.0,-70.0,-65.0,-71.0,-65.0,-70.0,-77.0,-84.0,-77.0,-85.0,11.0,14.0,12.0,15.0,1
1823,CC:2F:71:3E:C5:1F,2155594,273458877,103,12299,2155491,273446578,0,488,40801,412,31635,76,9166,113,1,176,7,0,27,144444.0,39000.0,-70.0,-69.0,-67.0,-60.0,-69.0,-67.0,-66.0,-60.0,-77.0,-84.0,-77.0,-85.0,7.0,15.0,10.0,25.0,1
1824,CC:2F:71:3F:1F:24,2462342,673077215,306851,399630637,2155491,273446578,6,228801,280240103,228659,280220791,142,19312,223449,561,306899,33284,6,1389,144444.0,43333.0,-70.0,-61.0,-71.0,-70.0,-69.0,-61.0,-70.0,-70.0,-77.0,-84.0,-77.0,-85.0,7.0,23.0,6.0,15.0,1
1825,F8:59:71:5A:E0:3D,2275296,456189659,119797,182742273,2155499,273447386,337,85820,120657188,85722,120642593,98,14595,85450,33,119793,8597,337,55,144444.0,43333.0,-61.0,-71.0,-64.0,-70.0,-63.0,-70.0,-64.0,-70.0,-77.0,-84.0,-77.0,-84.0,16.0,13.0,13.0,14.0,1
1826,CC:2F:71:3E:C5:1F,2155602,273459685,103,12299,2155499,273447386,0,488,40801,412,31635,76,9166,113,1,176,7,0,27,144444.0,39000.0,-70.0,-69.0,-67.0,-60.0,-69.0,-67.0,-66.0,-60.0,-77.0,-84.0,-77.0,-84.0,7.0,15.0,10.0,24.0,1
1827,CC:2F:71:3F:1F:24,2462547,673317147,307047,399869488,2155500,273447659,6,228985,280484292,228843,280464980,142,19312,223626,561,307095,33284,6,1397,144444.0,43333.0,-70.0,-61.0,-71.0,-69.0,-69.0,-61.0,-70.0,-69.0,-77.0,-84.0,-77.0,-84.0,7.0,23.0,6.0,15.0,1
1828,F8:59:71:5A:E0:3D,2275486,456481307,119985,183033588,2155501,273447719,337,85900,120756916,85802,120742321,98,14595,85530,33,119981,8629,337,56,144444.0,43333.0,-62.0,-72.0,-65.0,-70.0,-65.0,-71.0,-64.0,-70.0,-77.0,-84.0,-77.0,-84.0,15.0,12.0,12.0,14.0,1
1829,CC:2F:71:3E:C5:1F,2155604,273460018,103,12299,2155501,273447719,0,488,40801,412,31635,76,9166,113,1,176,7,0,27,144444.0,39000.0,-70.0,-69.0,-67.0,-60.0,-69.0,-67.0,-66.0,-60.0,-77.0,-84.0,-77.0,-84.0,7.0,15.0,10.0,24.0,1
1830,CC:2F:71:3F:1F:24,2462701,673517113,307200,400069394,2155501,273447719,6,229129,280684438,228987,280665126,142,19312,223763,561,307248,33284,6,1397,144444.0,43333.0,-70.0,-61.0,-71.0,-70.0,-70.0,-61.0,-70.0,-70.0,-77.0,-84.0,-77.0,-84.0,7.0,23.0,6.0,14.0,1
1831,F8:59:71:5A:E0:3D,2275730,456848954,120221,183400427,2155509,273448527,337,86001,120858816,85903,120844221,98,14595,85631,33,120217,8672,337,56,144444.0,43333.0,-65.0,-72.0,-65.0,-70.0,-64.0,-71.0,-65.0,-69.0,-77.0,-84.0,-77.0,-84.0,12.0,12.0,12.0,14.0,1
1832,CC:2F:71:3E:C5:1F,2155612,273460826,103,12299,2155509,273448527,0,488,40801,412,31635,76,9166,113,1,176,7,0,27,144444.0,39000.0,-70.0,-69.0,-67.0,-60.0,-69.0,-67.0,-66.0,-60.0,-77.0,-84.0,-77.0,-84.0,7.0,15.0,10.0,24.0,1
1833,CC:2F:71:3F:1F:24,2462928,673817559,307419,400369032,2155509,273448527,6,229348,280991818,229206,280972506,142,19312,223975,561,307465,33284,6,1415,144444.0,43333.0,-69.0,-61.0,-70.0,-70.0,-69.0,-60.0,-70.0,-70.0,-77.0,-84.0,-77.0,-84.0,8.0,23.0,7.0,14.0,1
1834,F8:59:71:5A:E0:3D,2275829,457001306,120319,183552719,2155510,273448587,337,86103,121013124,86005,120998529,98,14595,85729,33,120315,8674,337,56,144444.0,43333.0,-65.0,-72.0,-65.0,-70.0,-65.0,-71.0,-63.0,-70.0,-77.0,-84.0,-77.0,-84.0,12.0,12.0,12.0,14.0,1
1835,CC:2F:71:3E:C5:1F,2155613,273460886,103,12299,2155510,273448587,0,488,40801,412,31635,76,9166,113,1,176,7,0,27,144444.0,39000.0,-70.0,-69.0,-67.0,-60.0,-69.0,-67.0,-66.0,-60.0,-77.0,-84.0,-77.0,-84.0,7.0,15.0,10.0,24.0,1
1836,CC:2F:71:3F:1F:24,2463101,674036628,307589,400587839,2155512,273448789,6,229516,281214050,229374,281194738,142,19312,224130,561,307637,33284,6,1416,144444.0,43333.0,-70.0,-61.0,-71.0,-70.0,-69.0,-61.0,-70.0,-70.0,-77.0,-84.0,-77.0,-84.0,7.0,23.0,6.0,14.0,1
1837,F8:59:71:5A:E0:3D,2275905,457107786,120387,183658391,2155518,273449395,337,86201,121164072,86103,121149477,98,14595,85827,33,120383,8674,337,57,144444.0,43333.0,-65.0,-72.0,-64.0,-69.0,-65.0,-71.0,-64.0,-69.0,-77.0,-84.0,-77.0,-84.0,12.0,12.0,13.0,15.0,1
1838,CC:2F:71:3E:C5:1F,2155627,273462300,103,12299,2155524,273450001,0,488,40801,412,31635,76,9166,113,1,176,7,0,27,144444.0,39000.0,-70.0,-69.0,-67.0,-60.0,-69.0,-67.0,-66.0,-60.0,-77.0,-84.0,-77.0,-84.0,7.0,15.0,10.0,24.0,1
1839,CC:2F:71:3F:1F:24,2464019,675293821,308492,401843558,2155527,273450263,6,230028,281786847,229886,281767535,142,19312,224616,561,308540,33285,6,1437,144444.0,43333.0,-70.0,-61.0,-71.0,-70.0,-70.0,-60.0,-70.0,-70.0,-77.0,-84.0,-77.0,-84.0,7.0,23.0,6.0,14.0,1
1840,F8:59:71:5A:E0:3D,2276132,457436738,120605,183986475,2155527,273450263,337,86350,121376923,86252,121362328,98,14595,85975,33,120600,8675,337,57,144444.0,43333.0,-65.0,-71.0,-65.0,-70.0,-65.0,-71.0,-64.0,-70.0,-77.0,-84.0,-77.0,-84.0,12.0,13.0,12.0,14.0,1
1841,CC:2F:71:3E:C5:1F,2155630,273462562,103,12299,2155527,273450263,0,488,40801,412,31635,76,9166,113,1,176,7,0,27,144444.0,39000.0,-70.0,-69.0,-67.0,-60.0,-69.0,-67.0,-66.0,-60.0,-77.0,-84.0,-77.0,-84.0,7.0,15.0,10.0,24.0,1
1842,CC:2F:71:3F:1F:24,2464176,675499870,308649,402049607,2155527,273450263,6,230183,281989573,230041,281970261,142,19312,224761,561,308697,33287,6,1437,144444.0,43333.0,-70.0,-61.0,-70.0,-70.0,-69.0,-61.0,-70.0,-70.0,-77.0,-84.0,-77.0,-84.0,7.0,23.0,7.0,14.0,1
1843,F8:59:71:5A:E0:3D,2276201,457535433,120672,184084968,2155529,273450465,337,86418,121479209,86320,121464614,98,14595,86042,33,120668,8675,337,57,144444.0,43333.0,-65.0,-72.0,-65.0,-70.0,-64.0,-71.0,-64.0,-70.0,-77.0,-84.0,-77.0,-84.0,12.0,12.0,12.0,14.0,1
1844,CC:2F:71:3E:C5:1F,2155634,273462966,103,12299,2155531,273450667,0,488,40801,412,31635,76,9166,113,1,176,7,0,27,144444.0,39000.0,-70.0,-69.0,-67.0,-60.0,-69.0,-67.0,-66.0,-60.0,-77.0,-84.0,-77.0,-84.0,7.0,15.0,10.0,24.0,1
1845,CC:2F:71:3F:1F:24,2464343,675707865,308812,402257198,2155531,273450667,6,230338,282194514,230196,282175202,142,19312,224911,561,308860,33288,6,1440,144444.0,43333.0,-70.0,-61.0,-71.0,-70.0,-69.0,-60.0,-70.0,-70.0,-77.0,-84.0,-77.0,-84.0,7.0,23.0,6.0,14.0,1
1846,F8:59:71:5A:E0:3D,2276346,457750108,120811,184299037,2155535,273451071,337,86501,121580445,86403,121565850,98,14595,86125,33,120807,8675,337,57,144444.0,43333.0,-65.0,-72.0,-64.0,-70.0,-65.0,-70.0,-64.0,-70.0,-77.0,-84.0,-77.0,-84.0,12.0,12.0,13.0,14.0,1
1847,CC:2F:71:3E:C5:1F,2155639,273463430,103,12299,2155536,273451131,0,488,40801,412,31635,76,9166,113,1,176,7,0,27,144444.0,39000.0,-70.0,-69.0,-67.0,-60.0,-69.0,-67.0,-66.0,-60.0,-77.0,-84.0,-77.0,-84.0,7.0,15.0,10.0,24.0,1
1848,CC:2F:71:3F:1F:24,2464505,675911608,308969,402460477,2155536,273451131,6,230484,282392117,230342,282372805,142,19312,225052,561,309017,33288,6,1440,144444.0,43333.0,-69.0,-61.0,-70.0,-70.0,-69.0,-60.0,-70.0,-69.0,-77.0,-84.0,-77.0,-84.0,8.0,23.0,7.0,14.0,1
1849,F8:59:71:5A:E0:3D,2276411,457846718,120873,184395385,2155538,273451333,337,86564,121677479,86466,121662884,98,14595,86187,33,120869,8676,337,57,144444.0,43333.0,-63.0,-72.0,-64.0,-71.0,-64.0,-71.0,-64.0,-70.0,-77.0,-84.0,-77.0,-84.0,14.0,12.0,13.0,13.0,1
1850,CC:2F:71:3E:C5:1F,2155641,273463632,103,12299,2155538,273451333,0,488,40801,412,31635,76,9166,113,1,176,7,0,27,144444.0,39000.0,-70.0,-69.0,-67.0,-60.0,-69.0,-67.0,-66.0,-60.0,-77.0,-84.0,-77.0,-84.0,7.0,15.0,10.0,24.0,1
1851,CC:2F:71:3F:1F:24,2464666,676118231,309128,402666898,2155538,273451333,6,230637,282601890,230495,282582578,142,19312,225198,561,309176,33288,6,1440,144444.0,43333.0,-70.0,-61.0,-71.0,-70.0,-69.0,-60.0,-70.0,-69.0,-77.0,-84.0,-77.0,-84.0,7.0,23.0,6.0,14.0,1
1852,F8:59:71:5A:E0:3D,2276481,457945352,120936,184493287,2155545,273452065,337,86627,121774499,86529,121759904,98,14595,86250,33,120932,8676,337,57,144444.0,43333.0,-63.0,-72.0,-65.0,-70.0,-64.0,-71.0,-64.0,-70.0,-77.0,-84.0,-77.0,-84.0,14.0,12.0,12.0,14.0,1
1853,CC:2F:71:3E:C5:1F,2155648,273464364,103,12299,2155545,273452065,0,488,40801,412,31635,76,9166,113,1,176,7,0,27,144444.0,39000.0,-70.0,-69.0,-67.0,-60.0,-69.0,-67.0,-66.0,-60.0,-77.0,-84.0,-77.0,-84.0,7.0,15.0,10.0,24.0,1
1854,CC:2F:71:3F:1F:24,2464828,676321977,309283,402869912,2155545,273452065,6,230785,282803882,230643,282784570,142,19312,225342,561,309331,33288,6,1440,144444.0,43333.0,-70.0,-61.0,-71.0,-70.0,-69.0,-61.0,-70.0,-70.0,-77.0,-84.0,-77.0,-84.0,7.0,23.0,6.0,14.0,1
1855,F8:59:71:5A:E0:3D,2276551,458048434,121005,184596309,2155546,273452125,337,86697,121878541,86599,121863946,98,14595,86320,33,121001,8676,337,57,144444.0,43333.0,-66.0,-72.0,-65.0,-70.0,-64.0,-71.0,-64.0,-70.0,-77.0,-84.0,-77.0,-84.0,11.0,12.0,12.0,14.0,1
1856,CC:2F:71:3E:C5:1F,2155649,273464424,103,12299,2155546,273452125,0,488,40801,412,31635,76,9166,113,1,176,7,0,27,144444.0,39000.0,-70.0,-69.0,-67.0,-60.0,-69.0,-67.0,-66.0,-60.0,-77.0,-84.0,-77.0,-84.0,7.0,15.0,10.0,24.0,1
1857,CC:2F:71:3F:1F:24,2465521,677269014,309973,403816687,2155548,273452327,6,231054,283036994,230912,283017682,142,19312,225602,561,310021,33288,6,1440,144444.0,43333.0,-70.0,-61.0,-71.0,-70.0,-69.0,-60.0,-70.0,-70.0,-77.0,-84.0,-77.0,-84.0,7.0,23.0,6.0,14.0,1
1858,F8:59:71:5A:E0:3D,2276624,458150252,121070,184697319,2155554,273452933,337,86762,121978641,86664,121964046,98,14595,86385,33,121066,8676,337,57,144444.0,43333.0,-65.0,-72.0,-62.0,-70.0,-64.0,-71.0,-64.0,-70.0,-77.0,-84.0,-77.0,-84.0,12.0,12.0,15.0,14.0,1
1859,CC:2F:71:3E:C5:1F,2155657,273465232,103,12299,2155554,273452933,0,490,40941,414,31775,76,9166,113,1,177,7,0,27,144444.0,39000.0,-69.0,-68.0,-67.0,-60.0,-69.0,-67.0,-66.0,-60.0,-77.0,-84.0,-77.0,-84.0,8.0,16.0,10.0,24.0,1
1860,CC:2F:71:3F:1F:24,2465711,677491062,310157,404038129,2155554,273452933,6,231227,283257418,231085,283238106,142,19312,225768,561,310205,33292,6,1441,144444.0,43333.0,-70.0,-61.0,-71.0,-70.0,-69.0,-61.0,-70.0,-70.0,-77.0,-84.0,-77.0,-84.0,7.0,23.0,6.0,14.0,1
1861,F8:59:71:5A:E0:3D,2276689,458249824,121135,184796891,2155554,273452933,337,86825,122075661,86727,122061066,98,14595,86448,33,121131,8676,337,57,144444.0,43333.0,-62.0,-72.0,-65.0,-70.0,-64.0,-71.0,-64.0,-69.0,-77.0,-84.0,-77.0,-84.0,15.0,12.0,12.0,14.0,1
1862,CC:2F:71:3E:C5:1F,2155658,273465348,104,12415,2155554,273452933,0,492,41081,416,31915,76,9166,113,1,178,7,0,27,144444.0,39000.0,-71.0,-69.0,-67.0,-60.0,-70.0,-68.0,-66.0,-60.0,-77.0,-84.0,-77.0,-84.0,6.0,15.0,10.0,24.0,1
1863,CC:2F:71:3F:1F:24,2465870,677697318,310316,404244385,2155554,273452933,6,231372,283455124,231230,283435812,142,19312,225911,561,310364,33292,6,1446,144444.0,43333.0,-69.0,-61.0,-71.0,-70.0,-69.0,-61.0,-70.0,-69.0,-77.0,-84.0,-77.0,-84.0,8.0,23.0,6.0,14.0,1
1864,F8:59:71:5A:E0:3D,2276934,458616307,121370,185162233,2155564,273454074,337,86935,122228433,86837,122213838,98,14595,86558,33,121366,8676,337,57,130000.0,39000.0,-66.0,-72.0,-66.0,-70.0,-65.0,-70.0,-64.0,-70.0,-77.0,-84.0,-77.0,-84.0,11.0,12.0,11.0,14.0,1
1865,CC:2F:71:3E:C5:1F,2155668,273466489,104,12415,2155564,273454074,0,492,41081,416,31915,76,9166,113,1,178,7,0,27,144444.0,39000.0,-71.0,-69.0,-67.0,-60.0,-70.0,-68.0,-66.0,-60.0,-77.0,-84.0,-77.0,-84.0,6.0,15.0,10.0,24.0,1
1866,CC:2F:71:3F:1F:24,2466108,678010737,310544,404556663,2155564,273454074,6,231603,283775630,231461,283756318,142,19312,226132,561,310592,33292,6,1465,144444.0,43333.0,-70.0,-61.0,-71.0,-70.0,-70.0,-61.0,-71.0,-70.0,-77.0,-84.0,-77.0,-84.0,7.0,23.0,6.0,14.0,1
1867,F8:59:71:5A:E0:3D,2277079,458806561,121485,185340831,2155594,273465730,337,87060,122420933,86962,122406338,98,14595,86683,33,121481,8677,337,57,144444.0,43333.0,-66.0,-71.0,-65.0,-71.0,-64.0,-71.0,-64.0,-70.0,-77.0,-84.0,-77.0,-84.0,11.0,13.0,12.0,13.0,1
1868,CC:2F:71:3E:C5:1F,2155699,273478205,104,12415,2155595,273465790,0,492,41081,416,31915,76,9166,113,1,178,7,0,27,144444.0,39000.0,-71.0,-69.0,-67.0,-60.0,-70.0,-68.0,-66.0,-60.0,-77.0,-84.0,-77.0,-84.0,6.0,15.0,10.0,24.0,1
1869,CC:2F:71:3F:1F:24,2466448,678453636,310853,404987846,2155595,273465790,6,231915,284214509,231773,284195197,142,19312,226429,561,310901,33292,6,1494,144444.0,43333.0,-69.0,-61.0,-70.0,-70.0,-69.0,-60.0,-70.0,-69.0,-77.0,-84.0,-77.0,-84.0,8.0,23.0,7.0,14.0,1
1870,F8:59:71:5A:E0:3D,2277168,458940467,121571,185474475,2155597,273465992,337,87134,122534921,87036,122520326,98,14595,86757,33,121567,8679,337,57,144444.0,43333.0,-66.0,-71.0,-65.0,-70.0,-65.0,-71.0,-65.0,-70.0,-77.0,-84.0,-77.0,-84.0,11.0,13.0,12.0,14.0,1
1871,CC:2F:71:3E:C5:1F,2155701,273478407,104,12415,2155597,273465992,0,492,41081,416,31915,76,9166,113,1,178,7,0,27,144444.0,39000.0,-71.0,-69.0,-67.0,-60.0,-70.0,-68.0,-66.0,-60.0,-77.0,-84.0,-77.0,-84.0,6.0,15.0,10.0,24.0,1
1872,CC:2F:71:3F:1F:24,2466608,678661514,311011,405195522,2155597,273465992,6,232069,284423401,231927,284404089,142,19312,226572,561,311058,33292,6,1499,144444.0,43333.0,-70.0,-61.0,-71.0,-70.0,-69.0,-60.0,-70.0,-69.0,-77.0,-84.0,-77.0,-84.0,7.0,23.0,6.0,14.0,1
1873,F8:59:71:5A:E0:3D,2277294,459117663,121691,185651065,2155603,273466598,337,87210,122640351,87112,122625756,98,14595,86833,33,121687,8679,337,58,144444.0,43333.0,-65.0,-71.0,-65.0,-71.0,-64.0,-71.0,-64.0,-70.0,-77.0,-84.0,-77.0,-84.0,12.0,13.0,12.0,13.0,1
1874,CC:2F:71:3E:C5:1F,2155707,273479013,104,12415,2155603,273466598,0,492,41081,416,31915,76,9166,113,1,178,7,0,27,144444.0,39000.0,-71.0,-69.0,-67.0,-60.0,-70.0,-68.0,-66.0,-60.0,-77.0,-84.0,-77.0,-84.0,6.0,15.0,10.0,24.0,1
1875,CC:2F:71:3F:1F:24,2466772,678868372,311169,405401774,2155603,273466598,6,232220,284627227,232078,284607915,142,19312,226718,561,311217,33292,6,1499,144444.0,43333.0,-70.0,-61.0,-71.0,-70.0,-69.0,-60.0,-70.0,-69.0,-77.0,-84.0,-77.0,-84.0,7.0,23.0,6.0,14.0,1
1876,F8:59:71:5A:E0:3D,2277359,459217179,121755,185750521,2155604,273466658,337,87274,122738981,87176,122724386,98,14595,86897,33,121751,8679,337,60,144444.0,43333.0,-65.0,-72.0,-66.0,-70.0,-64.0,-71.0,-65.0,-70.0,-77.0,-84.0,-77.0,-84.0,12.0,12.0,11.0,14.0,1
1877,CC:2F:71:3E:C5:1F,2155710,273479275,104,12415,2155606,273466860,0,492,41081,416,31915,76,9166,113,1,178,7,0,27,144444.0,39000.0,-71.0,-69.0,-67.0,-60.0,-70.0,-68.0,-66.0,-60.0,-77.0,-84.0,-77.0,-84.0,6.0,15.0,10.0,24.0,1
1878,CC:2F:71:3F:1F:24,2466957,679110886,311351,405644026,2155606,273466860,6,232390,284863405,232248,284844093,142,19312,226884,561,311399,33292,6,1505,144444.0,43333.0,-70.0,-61.0,-71.0,-70.0,-69.0,-61.0,-70.0,-70.0,-77.0,-84.0,-77.0,-84.0,7.0,23.0,6.0,14.0,1
1879,F8:59:71:5A:E0:3D,2277617,459605303,122004,186137775,2155613,273467528,337,87389,122861383,87290,122846670,99,14713,87011,33,122000,8680,337,60,144444.0,43333.0,-66.0,-71.0,-65.0,-70.0,-65.0,-71.0,-64.0,-70.0,-77.0,-84.0,-77.0,-84.0,11.0,13.0,12.0,14.0,1
1880,CC:2F:71:3E:C5:1F,2155717,273479943,104,12415,2155613,273467528,0,492,41081,416,31915,76,9166,113,1,178,7,0,27,144444.0,39000.0,-71.0,-69.0,-67.0,-60.0,-70.0,-68.0,-66.0,-60.0,-77.0,-84.0,-77.0,-84.0,6.0,15.0,10.0,24.0,1
1881,CC:2F:71:3F:1F:24,2467775,680241699,312162,406774171,2155613,273467528,6,232687,285116572,232545,285097260,142,19312,227171,561,312210,33292,6,1513,144444.0,43333.0,-69.0,-61.0,-71.0,-70.0,-69.0,-61.0,-70.0,-70.0,-77.0,-84.0,-77.0,-84.0,8.0,23.0,6.0,14.0,1
1882,F8:59:71:5A:E0:3D,2277694,459719246,122079,186251516,2155615,273467730,337,87463,122972590,87364,122957877,99,14713,87085,33,122075,8682,337,60,144444.0,43333.0,-66.0,-72.0,-65.0,-70.0,-65.0,-71.0,-64.0,-70.0,-77.0,-84.0,-77.0,-84.0,11.0,12.0,12.0,14.0,1
1883,CC:2F:71:3E:C5:1F,2155719,273480145,104,12415,2155615,273467730,0,492,41081,416,31915,76,9166,113,1,178,7,0,27,144444.0,39000.0,-71.0,-69.0,-67.0,-60.0,-70.0,-68.0,-66.0,-60.0,-77.0,-84.0,-77.0,-84.0,6.0,15.0,10.0,24.0,1
1884,CC:2F:71:3F:1F:24,2467935,680449577,312320,406981847,2155615,273467730,6,232836,285323076,232694,285303764,142,19312,227314,561,312368,33292,6,1513,144444.0,43333.0,-70.0,-61.0,-71.0,-70.0,-69.0,-60.0,-70.0,-70.0,-77.0,-84.0,-77.0,-84.0,7.0,23.0,6.0,14.0,1
1885,F8:59:71:5A:E0:3D,2277767,459818272,122145,186349876,2155622,273468396,337,87530,123071970,87431,123057257,99,14713,87152,33,122141,8682,337,60,144444.0,43333.0,-64.0,-71.0,-64.0,-70.0,-64.0,-71.0,-63.0,-70.0,-77.0,-84.0,-77.0,-84.0,13.0,13.0,13.0,14.0,1
1886,CC:2F:71:3E:C5:1F,2155726,273480811,104,12415,2155622,273468396,0,492,41081,416,31915,76,9166,113,1,178,7,0,27,144444.0,39000.0,-71.0,-69.0,-67.0,-60.0,-70.0,-68.0,-66.0,-60.0,-77.0,-84.0,-77.0,-84.0,6.0,15.0,10.0,24.0,1
1887,CC:2F:71:3F:1F:24,2468098,680654811,312476,407186415,2155622,273468396,6,232986,285528176,232844,285508864,142,19312,227458,561,312524,33292,6,1513,144444.0,43333.0,-70.0,-60.0,-70.0,-70.0,-69.0,-60.0,-70.0,-69.0,-77.0,-84.0,-77.0,-84.0,7.0,24.0,7.0,14.0,1
1888,F8:59:71:5A:E0:3D,2277834,459915407,122212,186447011,2155622,273468396,337,87596,123170275,87497,123155562,99,14713,87218,33,122208,8682,337,60,144444.0,43333.0,-60.0,-71.0,-65.0,-70.0,-64.0,-70.0,-64.0,-70.0,-77.0,-84.0,-77.0,-84.0,17.0,13.0,12.0,14.0,1
1889,CC:2F:71:3E:C5:1F,2155728,273481013,104,12415,2155624,273468598,0,492,41081,416,31915,76,9166,113,1,178,7,0,27,144444.0,39000.0,-71.0,-69.0,-67.0,-60.0,-70.0,-68.0,-66.0,-60.0,-77.0,-84.0,-77.0,-84.0,6.0,15.0,10.0,24.0,1
1890,CC:2F:71:3F:1F:24,2468271,680863200,312647,407394602,2155624,273468598,6,233152,285737511,233010,285718199,142,19312,227619,561,312695,33292,6,1513,144444.0,43333.0,-70.0,-61.0,-71.0,-70.0,-69.0,-60.0,-70.0,-69.0,-77.0,-84.0,-77.0,-84.0,7.0,23.0,6.0,14.0,1
1891,F8:59:71:5A:E0:3D,2277903,460012423,122274,186543359,2155629,273469064,337,87658,123265755,87559,123251042,99,14713,87280,33,122270,8683,337,60,144444.0,43333.0,-65.0,-71.0,-65.0,-70.0,-64.0,-71.0,-64.0,-70.0,-77.0,-84.0,-77.0,-84.0,12.0,13.0,12.0,14.0,1
1892,CC:2F:71:3E:C5:1F,2155733,273481479,104,12415,2155629,273469064,0,492,41081,416,31915,76,9166,113,1,178,7,0,27,144444.0,39000.0,-71.0,-69.0,-67.0,-60.0,-70.0,-68.0,-66.0,-60.0,-77.0,-84.0,-77.0,-84.0,6.0,15.0,10.0,24.0,1
1893,CC:2F:71:3F:1F:24,2468444,681075145,312813,407605879,2155631,273469266,6,233304,285937570,233161,285918140,143,19430,227770,561,312861,33292,6,1513,144444.0,43333.0,-70.0,-61.0,-70.0,-70.0,-69.0,-60.0,-70.0,-69.0,-77.0,-84.0,-77.0,-84.0,7.0,23.0,7.0,14.0,1
1894,F8:59:71:5A:E0:3D,2277971,460112203,122338,186642815,2155633,273469388,337,87721,123362775,87622,123348062,99,14713,87343,33,122334,8683,337,60,144444.0,43333.0,-66.0,-72.0,-65.0,-71.0,-65.0,-71.0,-64.0,-70.0,-77.0,-84.0,-77.0,-84.0,11.0,12.0,12.0,13.0,1
1895,CC:2F:71:3E:C5:1F,2155737,273481803,104,12415,2155633,273469388,0,494,41269,417,31985,77,9284,114,1,178,7,0,27,144444.0,39000.0,-71.0,-69.0,-66.0,-60.0,-70.0,-68.0,-66.0,-60.0,-77.0,-84.0,-77.0,-84.0,6.0,15.0,11.0,24.0,1
1896,CC:2F:71:3F:1F:24,2468603,681281277,312970,407811889,2155633,273469388,6,233453,286145416,233310,286125986,143,19430,227912,561,313018,33293,6,1513,144444.0,43333.0,-69.0,-60.0,-69.0,-69.0,-69.0,-60.0,-69.0,-69.0,-77.0,-84.0,-77.0,-84.0,8.0,24.0,8.0,15.0,1
1897,F8:59:71:5A:E0:3D,2278037,460208955,122400,186739163,2155637,273469792,337,87784,123459795,87685,123445082,99,14713,87406,33,122396,8683,337,60,144444.0,43333.0,-65.0,-72.0,-65.0,-70.0,-64.0,-70.0,-63.0,-70.0,-77.0,-84.0,-77.0,-84.0,12.0,12.0,12.0,14.0,1
1898,CC:2F:71:3E:C5:1F,2155741,273482207,104,12415,2155637,273469792,0,494,41269,417,31985,77,9284,114,1,178,7,0,27,144444.0,39000.0,-71.0,-69.0,-66.0,-60.0,-70.0,-68.0,-66.0,-60.0,-77.0,-84.0,-77.0,-84.0,6.0,15.0,11.0,24.0,1
1899,CC:2F:71:3F:1F:24,2468777,681492847,313140,408023055,2155637,273469792,6,233615,286358213,233472,286338783,143,19430,228067,561,313187,33294,6,1513,144444.0,43333.0,-70.0,-61.0,-71.0,-69.0,-69.0,-60.0,-70.0,-69.0,-77.0,-84.0,-77.0,-84.0,7.0,23.0,6.0,15.0,1
1900,F8:59:71:5A:E0:3D,2278241,460510296,122599,187039827,2155642,273470469,337,87869,123565178,87770,123550465,99,14713,87491,33,122595,8683,337,60,144444.0,43333.0,-66.0,-73.0,-65.0,-70.0,-65.0,-72.0,-64.0,-70.0,-77.0,-84.0,-77.0,-84.0,11.0,11.0,12.0,14.0,1
1901,CC:2F:71:3E:C5:1F,2155747,273482944,104,12415,2155643,273470529,0,494,41269,417,31985,77,9284,114,1,178,7,0,27,144444.0,39000.0,-71.0,-69.0,-66.0,-60.0,-70.0,-68.0,-66.0,-60.0,-77.0,-84.0,-77.0,-84.0,6.0,15.0,11.0,24.0,1
1902,CC:2F:71:3F:1F:24,2468946,681701629,313303,408231100,2155643,273470529,6,233767,286566865,233624,286547435,143,19430,228214,561,313351,33295,6,1516,144444.0,43333.0,-68.0,-61.0,-69.0,-68.0,-68.0,-60.0,-69.0,-67.0,-77.0,-84.0,-77.0,-84.0,9.0,23.0,8.0,16.0,1
1903,F8:59:71:5A:E0:3D,2278311,460607693,122666,187136962,2155645,273470731,337,87935,123663332,87836,123648619,99,14713,87557,33,122662,8683,337,60,144444.0,43333.0,-65.0,-72.0,-66.0,-70.0,-65.0,-72.0,-64.0,-70.0,-77.0,-84.0,-77.0,-84.0,12.0,12.0,11.0,14.0,1
1904,CC:2F:71:3E:C5:1F,2155751,273483348,104,12415,2155647,273470933,0,494,41269,417,31985,77,9284,114,1,178,7,0,27,144444.0,39000.0,-71.0,-69.0,-66.0,-60.0,-70.0,-68.0,-66.0,-60.0,-77.0,-84.0,-77.0,-84.0,6.0,15.0,11.0,24.0,1
1905,CC:2F:71:3F:1F:24,2469115,681908894,313468,408437961,2155647,273470933,6,233926,286774005,233783,286754575,143,19430,228363,561,313516,33297,6,1516,144444.0,43333.0,-69.0,-60.0,-69.0,-69.0,-69.0,-60.0,-69.0,-68.0,-77.0,-84.0,-77.0,-84.0,8.0,24.0,8.0,15.0,1
1906,F8:59:71:5A:E0:3D,2278420,460763651,122767,187291946,2155653,273471705,337,88003,123762870,87904,123748157,99,14713,87625,33,122749,8683,337,60,144444.0,43333.0,-66.0,-73.0,-65.0,-69.0,-63.0,-72.0,-64.0,-69.0,-77.0,-84.0,-77.0,-84.0,11.0,11.0,12.0,15.0,1
1907,CC:2F:71:3E:C5:1F,2155757,273484120,104,12415,2155653,273471705,0,494,41269,417,31985,77,9284,114,1,178,7,0,27,144444.0,39000.0,-71.0,-69.0,-66.0,-60.0,-70.0,-68.0,-66.0,-60.0,-77.0,-84.0,-77.0,-84.0,6.0,15.0,11.0,24.0,1
1908,CC:2F:71:3F:1F:24,2469282,682122076,313629,408650371,2155653,273471705,6,234078,286980921,233935,286961491,143,19430,228511,561,313677,33322,6,1516,130000.0,43333.0,-69.0,-61.0,-71.0,-70.0,-69.0,-61.0,-70.0,-69.0,-77.0,-84.0,-77.0,-84.0,8.0,23.0,6.0,14.0,1
1909,F8:59:71:5A:E0:3D,2278653,461118238,122993,187645867,2155660,273472371,337,88134,123924864,88035,123910151,99,14713,87756,33,122988,8683,337,60,144444.0,43333.0,-65.0,-73.0,-65.0,-69.0,-64.0,-72.0,-65.0,-69.0,-77.0,-84.0,-77.0,-84.0,12.0,11.0,12.0,15.0,1
1910,CC:2F:71:3E:C5:1F,2155764,273484786,104,12415,2155660,273472371,0,494,41269,417,31985,77,9284,114,1,178,7,0,27,144444.0,39000.0,-71.0,-69.0,-66.0,-60.0,-70.0,-68.0,-66.0,-60.0,-77.0,-84.0,-77.0,-84.0,6.0,15.0,11.0,24.0,1
1911,CC:2F:71:3F:1F:24,2469542,682473398,313880,409000825,2155662,273472573,6,234320,287328259,234177,287308829,143,19430,228744,561,313928,33323,6,1541,144444.0,39000.0,-69.0,-60.0,-70.0,-70.0,-69.0,-60.0,-70.0,-69.0,-77.0,-84.0,-77.0,-84.0,8.0,24.0,7.0,14.0,1
1912,F8:59:71:5A:E0:3D,2278730,461232084,123066,187759309,2155664,273472775,337,88202,124029724,88103,124015011,99,14713,87824,33,123062,8683,337,63,144444.0,43333.0,-61.0,-73.0,-65.0,-70.0,-64.0,-73.0,-65.0,-69.0,-77.0,-84.0,-77.0,-84.0,16.0,11.0,12.0,14.0,1
1913,CC:2F:71:3E:C5:1F,2155768,273485190,104,12415,2155664,273472775,0,494,41269,417,31985,77,9284,114,1,178,7,0,27,144444.0,39000.0,-71.0,-69.0,-66.0,-60.0,-70.0,-68.0,-66.0,-60.0,-77.0,-84.0,-77.0,-84.0,6.0,15.0,11.0,24.0,1
1914,CC:2F:71:3F:1F:24,2469996,683092849,314332,409620074,2155664,273472775,6,234588,287631646,234445,287612216,143,19430,229001,561,314379,33334,6,1550,144444.0,43333.0,-68.0,-60.0,-71.0,-69.0,-68.0,-60.0,-71.0,-69.0,-77.0,-83.0,-77.0,-84.0,9.0,23.0,6.0,15.0,1
1915,F8:59:71:5A:E0:3D,2278826,461369072,123153,187894507,2155673,273474565,337,88294,124171404,88195,124156691,99,14713,87916,33,123148,8683,337,63,144444.0,43333.0,-66.0,-73.0,-66.0,-70.0,-65.0,-72.0,-65.0,-70.0,-77.0,-83.0,-77.0,-84.0,11.0,10.0,11.0,14.0,1
1916,CC:2F:71:3E:C5:1F,2155777,273486980,104,12415,2155673,273474565,0,494,41269,417,31985,77,9284,114,1,178,7,0,27,144444.0,39000.0,-71.0,-69.0,-66.0,-60.0,-70.0,-68.0,-66.0,-60.0,-77.0,-83.0,-77.0,-84.0,6.0,14.0,11.0,24.0,1
1917,CC:2F:71:3F:1F:24,2470189,683316134,314516,409841569,2155673,273474565,6,234764,287853736,234621,287834306,143,19430,229174,561,314564,33334,6,1550,144444.0,43333.0,-69.0,-61.0,-69.0,-67.0,-68.0,-61.0,-68.0,-66.0,-77.0,-83.0,-77.0,-84.0,8.0,22.0,8.0,17.0,1
1918,F8:59:71:5A:E0:3D,2278986,461605589,123311,188130822,2155675,273474767,337,88386,124286158,88287,124271445,99,14713,88007,33,123307,8684,337,65,144444.0,43333.0,-63.0,-72.0,-64.0,-70.0,-64.0,-72.0,-64.0,-69.0,-77.0,-83.0,-77.0,-84.0,14.0,11.0,13.0,14.0,1
1919,CC:2F:71:3E:C5:1F,2155779,273487182,104,12415,2155675,273474767,0,494,41269,417,31985,77,9284,114,1,178,7,0,27,144444.0,39000.0,-71.0,-69.0,-66.0,-60.0,-70.0,-68.0,-66.0,-60.0,-77.0,-83.0,-77.0,-84.0,6.0,14.0,11.0,24.0,1
1920,CC:2F:71:3F:1F:24,2470363,683524636,314688,410049869,2155675,273474767,6,234930,288061928,234787,288042498,143,19430,229328,561,314736,33358,6,1552,117000.0,39000.0,-68.0,-61.0,-71.0,-66.0,-68.0,-61.0,-70.0,-67.0,-77.0,-83.0,-77.0,-84.0,9.0,22.0,6.0,18.0,1
1921,F8:59:71:5A:E0:3D,2279061,461707236,123378,188230739,2155683,273476497,337,88453,124386890,88354,124372177,99,14713,88074,33,123374,8685,337,65,144444.0,43333.0,-66.0,-73.0,-65.0,-70.0,-65.0,-72.0,-65.0,-69.0,-77.0,-83.0,-77.0,-84.0,11.0,10.0,12.0,14.0,1
1922,CC:2F:71:3E:C5:1F,2155787,273488912,104,12415,2155683,273476497,0,494,41269,417,31985,77,9284,114,1,178,7,0,27,144444.0,39000.0,-71.0,-69.0,-66.0,-60.0,-70.0,-68.0,-66.0,-60.0,-77.0,-83.0,-77.0,-84.0,6.0,14.0,11.0,24.0,1
1923,CC:2F:71:3F:1F:24,2470529,683729775,314846,410253278,2155683,273476497,6,235086,288270675,234943,288251245,143,19430,229479,561,314894,33359,6,1552,130000.0,43333.0,-71.0,-62.0,-72.0,-68.0,-70.0,-61.0,-71.0,-68.0,-77.0,-83.0,-77.0,-84.0,6.0,21.0,5.0,16.0,1
1924,F8:59:71:5A:E0:3D,2279140,461824164,123454,188347405,2155686,273476759,337,88528,124501026,88429,124486313,99,14713,88149,33,123450,8685,337,65,144444.0,43333.0,-66.0,-73.0,-65.0,-70.0,-65.0,-72.0,-64.0,-69.0,-77.0,-83.0,-77.0,-84.0,11.0,10.0,12.0,14.0,1
1925,CC:2F:71:3E:C5:1F,2155790,273489174,104,12415,2155686,273476759,0,494,41269,417,31985,77,9284,114,1,178,7,0,27,144444.0,39000.0,-71.0,-69.0,-66.0,-60.0,-70.0,-68.0,-66.0,-60.0,-77.0,-83.0,-77.0,-84.0,6.0,14.0,11.0,24.0,1
1926,CC:2F:71:3F:1F:24,2471159,684541743,315473,411064984,2155686,273476759,6,235493,288553164,235350,288533734,143,19430,229880,561,315521,33366,6,1564,117000.0,39000.0,-72.0,-62.0,-70.0,-68.0,-71.0,-62.0,-69.0,-68.0,-77.0,-83.0,-77.0,-84.0,5.0,21.0,7.0,16.0,1
1927,F8:59:71:5A:E0:3D,2279219,461936060,123525,188457571,2155694,273478489,337,88599,124610436,88500,124595723,99,14713,88220,33,123521,8686,337,65,144444.0,43333.0,-65.0,-73.0,-62.0,-70.0,-65.0,-72.0,-63.0,-70.0,-77.0,-83.0,-77.0,-84.0,12.0,10.0,15.0,14.0,1
1928,CC:2F:71:3E:C5:1F,2155798,273490904,104,12415,2155694,273478489,0,494,41269,417,31985,77,9284,114,1,178,7,0,27,144444.0,39000.0,-71.0,-69.0,-66.0,-60.0,-70.0,-68.0,-66.0,-60.0,-77.0,-83.0,-77.0,-84.0,6.0,14.0,11.0,24.0,1
1929,CC:2F:71:3F:1F:24,2471723,685261914,316029,411783425,2155694,273478489,6,235821,288818483,235678,288799053,143,19430,230202,561,316077,33487,6,1580,130000.0,39000.0,-70.0,-63.0,-70.0,-68.0,-70.0,-63.0,-69.0,-68.0,-77.0,-83.0,-77.0,-84.0,7.0,20.0,7.0,16.0,1
1930,F8:59:71:5A:E0:3D,2279292,462045102,123595,188566351,2155697,273478751,337,88669,124718236,88570,124703523,99,14713,88290,33,123591,8686,337,65,144444.0,43333.0,-66.0,-73.0,-64.0,-70.0,-64.0,-71.0,-64.0,-69.0,-77.0,-83.0,-77.0,-84.0,11.0,10.0,13.0,14.0,1
1931,CC:2F:71:3E:C5:1F,2155801,273491166,104,12415,2155697,273478751,0,494,41269,417,31985,77,9284,114,1,178,7,0,27,144444.0,39000.0,-71.0,-69.0,-66.0,-60.0,-70.0,-68.0,-66.0,-60.0,-77.0,-83.0,-77.0,-84.0,6.0,14.0,11.0,24.0,1
1932,CC:2F:71:3F:1F:24,2472079,685713620,316382,412234869,2155697,273478751,6,236065,289033337,235922,289013907,143,19430,230445,561,316430,33523,6,1586,130000.0,43333.0,-71.0,-62.0,-71.0,-68.0,-70.0,-62.0,-70.0,-68.0,-77.0,-83.0,-77.0,-84.0,6.0,21.0,6.0,16.0,1
1933,F8:59:71:5A:E0:3D,2279362,462145164,123659,188665807,2155703,273479357,337,88733,124816796,88634,124802083,99,14713,88354,33,123655,8686,337,65,144444.0,43333.0,-66.0,-73.0,-65.0,-70.0,-65.0,-72.0,-63.0,-70.0,-77.0,-83.0,-77.0,-84.0,11.0,10.0,12.0,14.0,1
1934,CC:2F:71:3E:C5:1F,2155807,273491772,104,12415,2155703,273479357,0,496,41409,419,32125,77,9284,114,1,179,7,0,27,144444.0,39000.0,-71.0,-76.0,-72.0,-70.0,-70.0,-71.0,-68.0,-62.0,-77.0,-83.0,-77.0,-84.0,6.0,7.0,5.0,14.0,1
1935,CC:2F:71:3F:1F:24,2472246,685925140,316543,412445783,2155703,273479357,6,236216,289242825,236073,289223395,143,19430,230590,561,316590,33524,6,1586,130000.0,43333.0,-69.0,-61.0,-69.0,-70.0,-68.0,-61.0,-68.0,-69.0,-77.0,-83.0,-77.0,-84.0,8.0,22.0,8.0,14.0,1
1936,F8:59:71:5A:E0:3D,2279589,462493187,123884,189013628,2155705,273479559,337,88832,124922862,88733,124908149,99,14713,88453,33,123880,8700,337,65,144444.0,43333.0,-66.0,-73.0,-65.0,-70.0,-64.0,-72.0,-64.0,-69.0,-77.0,-83.0,-77.0,-84.0,11.0,10.0,12.0,14.0,1
1937,CC:2F:71:3E:C5:1F,2155810,273492090,105,12531,2155705,273479559,0,498,41549,421,32265,77,9284,114,1,180,7,0,27,144444.0,39000.0,-66.0,-69.0,-63.0,-60.0,-70.0,-71.0,-67.0,-62.0,-77.0,-83.0,-77.0,-84.0,11.0,14.0,14.0,24.0,1
1938,CC:2F:71:3F:1F:24,2472420,686150504,316715,412670945,2155705,273479559,6,236377,289460703,236234,289441273,143,19430,230750,561,316763,33528,6,1588,117000.0,39000.0,-71.0,-62.0,-73.0,-67.0,-70.0,-62.0,-72.0,-66.0,-77.0,-83.0,-77.0,-84.0,6.0,21.0,4.0,17.0,1
1939,F8:59:71:5A:E0:3D,2279786,462790052,124075,189309756,2155711,273480296,337,88920,125038986,88821,125024273,99,14713,88541,33,124071,8700,337,67,144444.0,43333.0,-63.0,-73.0,-65.0,-69.0,-65.0,-72.0,-64.0,-69.0,-77.0,-83.0,-77.0,-84.0,14.0,10.0,12.0,15.0,1
1940,CC:2F:71:3E:C5:1F,2155818,273493029,105,12531,2155713,273480498,0,498,41549,421,32265,77,9284,114,1,180,7,0,27,144444.0,39000.0,-66.0,-69.0,-63.0,-60.0,-70.0,-71.0,-67.0,-62.0,-77.0,-83.0,-77.0,-84.0,11.0,14.0,14.0,24.0,1
1941,CC:2F:71:3F:1F:24,2472709,686518833,316996,413038335,2155713,273480498,6,236569,289687462,236426,289668032,143,19430,230936,561,317043,33550,6,1588,130000.0,43333.0,-69.0,-62.0,-70.0,-69.0,-69.0,-62.0,-69.0,-68.0,-77.0,-83.0,-77.0,-84.0,8.0,21.0,7.0,15.0,1
1942,F8:59:71:5A:E0:3D,2279853,462888358,124138,189407658,2155715,273480700,337,88983,125136062,88884,125121349,99,14713,88604,33,124134,8700,337,68,144444.0,43333.0,-65.0,-73.0,-64.0,-69.0,-64.0,-73.0,-64.0,-69.0,-77.0,-83.0,-77.0,-84.0,12.0,10.0,13.0,15.0,1
1943,CC:2F:71:3E:C5:1F,2155820,273493231,105,12531,2155715,273480700,0,498,41549,421,32265,77,9284,114,1,180,7,0,27,144444.0,39000.0,-66.0,-69.0,-63.0,-60.0,-70.0,-71.0,-67.0,-62.0,-77.0,-83.0,-77.0,-84.0,11.0,14.0,14.0,24.0,1
1944,CC:2F:71:3F:1F:24,2472891,686730983,317176,413250283,2155715,273480700,6,236740,289898021,236597,289878591,143,19430,231102,561,317224,33557,6,1591,130000.0,43333.0,-71.0,-62.0,-69.0,-67.0,-70.0,-62.0,-69.0,-67.0,-77.0,-83.0,-77.0,-84.0,6.0,21.0,8.0,17.0,1
1945,F8:59:71:5A:E0:3D,2279920,462985366,124203,189504464,2155717,273480902,337,89050,125235442,88951,125220729,99,14713,88671,33,124199,8700,337,68,144444.0,43333.0,-67.0,-74.0,-65.0,-69.0,-66.0,-74.0,-65.0,-69.0,-77.0,-83.0,-77.0,-84.0,10.0,9.0,12.0,15.0,1
1946,CC:2F:71:3E:C5:1F,2155824,273493635,105,12531,2155719,273481104,0,498,41549,421,32265,77,9284,114,1,180,7,0,27,144444.0,39000.0,-66.0,-69.0,-63.0,-60.0,-70.0,-71.0,-67.0,-62.0,-77.0,-83.0,-77.0,-84.0,11.0,14.0,14.0,24.0,1
1947,CC:2F:71:3F:1F:24,2473052,686935917,317333,413454813,2155719,273481104,6,236887,290098473,236744,290079043,143,19430,231245,561,317381,33562,6,1591,130000.0,39000.0,-71.0,-63.0,-70.0,-69.0,-70.0,-63.0,-70.0,-68.0,-77.0,-83.0,-77.0,-84.0,6.0,20.0,7.0,15.0,1
1948,F8:59:71:5A:E0:3D,2279990,463083934,124266,189602366,2155724,273481568,337,89113,125332462,89014,125317749,99,14713,88734,33,124262,8700,337,68,144444.0,43333.0,-66.0,-73.0,-65.0,-69.0,-66.0,-72.0,-65.0,-68.0,-77.0,-83.0,-77.0,-84.0,11.0,10.0,12.0,15.0,1
1949,CC:2F:71:3E:C5:1F,2155829,273494099,105,12531,2155724,273481568,0,498,41549,421,32265,77,9284,114,1,180,7,0,27,144444.0,39000.0,-66.0,-69.0,-63.0,-60.0,-70.0,-71.0,-67.0,-62.0,-77.0,-83.0,-77.0,-84.0,11.0,14.0,14.0,24.0,1
1950,CC:2F:71:3F:1F:24,2473219,687149163,317495,413667595,2155724,273481568,6,237040,290306809,236897,290287379,143,19430,231395,561,317543,33562,6,1591,130000.0,43333.0,-71.0,-62.0,-70.0,-69.0,-71.0,-62.0,-70.0,-69.0,-77.0,-83.0,-77.0,-84.0,6.0,21.0,7.0,15.0,1
1951,F8:59:71:5A:E0:3D,2280058,463186700,124332,189704930,2155726,273481770,337,89179,125434102,89080,125419389,99,14713,88800,33,124328,8701,337,68,144444.0,43333.0,-66.0,-73.0,-66.0,-70.0,-66.0,-72.0,-65.0,-69.0,-77.0,-83.0,-77.0,-84.0,11.0,10.0,11.0,14.0,1
1952,CC:2F:71:3E:C5:1F,2155831,273494301,105,12531,2155726,273481770,0,498,41549,421,32265,77,9284,114,1,180,7,0,27,144444.0,39000.0,-66.0,-69.0,-63.0,-60.0,-70.0,-71.0,-67.0,-62.0,-77.0,-83.0,-77.0,-84.0,11.0,14.0,14.0,24.0,1
1953,CC:2F:71:3F:1F:24,2473381,687355958,317653,413873986,2155728,273481972,6,237186,290505939,237043,290486509,143,19430,231538,561,317701,33562,6,1591,130000.0,43333.0,-72.0,-62.0,-72.0,-69.0,-71.0,-62.0,-72.0,-69.0,-77.0,-83.0,-77.0,-84.0,5.0,21.0,5.0,15.0,1
1954,F8:59:71:5A:E0:3D,2280126,463283630,124395,189801394,2155731,273482236,337,89242,125529688,89143,125514975,99,14713,88863,33,124391,8701,337,68,144444.0,43333.0,-67.0,-73.0,-66.0,-70.0,-66.0,-72.0,-65.0,-70.0,-77.0,-83.0,-77.0,-84.0,10.0,10.0,11.0,14.0,1
1955,CC:2F:71:3E:C5:1F,2155838,273494969,105,12531,2155733,273482438,0,498,41549,421,32265,77,9284,114,1,180,7,0,27,144444.0,39000.0,-66.0,-69.0,-63.0,-60.0,-70.0,-71.0,-67.0,-62.0,-77.0,-83.0,-77.0,-84.0,11.0,14.0,14.0,24.0,1
1956,CC:2F:71:3F:1F:24,2473545,687563992,317812,414081554,2155733,273482438,6,237335,290709463,237191,290689915,144,19548,231683,561,317860,33567,6,1591,130000.0,43333.0,-70.0,-63.0,-71.0,-69.0,-69.0,-63.0,-71.0,-69.0,-77.0,-83.0,-77.0,-84.0,7.0,20.0,6.0,15.0,1
1957,F8:59:71:5A:E0:3D,2280235,463431266,124500,189948706,2155735,273482560,337,89321,125636493,89221,125621662,100,14831,88942,33,124496,8701,337,68,144444.0,43333.0,-66.0,-72.0,-65.0,-70.0,-65.0,-72.0,-65.0,-69.0,-77.0,-83.0,-77.0,-84.0,11.0,11.0,12.0,14.0,1
1958,CC:2F:71:3E:C5:1F,2155840,273495091,105,12531,2155735,273482560,0,498,41549,421,32265,77,9284,114,1,180,7,0,27,144444.0,39000.0,-66.0,-69.0,-63.0,-60.0,-70.0,-71.0,-67.0,-62.0,-77.0,-83.0,-77.0,-84.0,11.0,14.0,14.0,24.0,1
1959,CC:2F:71:3F:1F:24,2473714,687772169,317977,414289407,2155737,273482762,6,237492,290917305,237348,290897757,144,19548,231833,561,318025,33590,6,1591,130000.0,43333.0,-70.0,-62.0,-73.0,-69.0,-69.0,-62.0,-72.0,-69.0,-77.0,-83.0,-77.0,-84.0,7.0,21.0,4.0,15.0,1
1960,F8:59:71:5A:E0:3D,2280376,463635332,124635,190152166,2155741,273483166,337,89404,125741181,89304,125726350,100,14831,89025,33,124631,8701,337,68,144444.0,43333.0,-66.0,-72.0,-65.0,-70.0,-66.0,-72.0,-65.0,-69.0,-77.0,-84.0,-77.0,-84.0,11.0,12.0,12.0,14.0,1
1961,CC:2F:71:3E:C5:1F,2155846,273495697,105,12531,2155741,273483166,0,498,41549,421,32265,77,9284,114,1,180,7,0,27,144444.0,39000.0,-66.0,-69.0,-63.0,-60.0,-70.0,-71.0,-67.0,-62.0,-77.0,-84.0,-77.0,-84.0,11.0,15.0,14.0,24.0,1
1962,CC:2F:71:3F:1F:24,2473877,687980379,318136,414497213,2155741,273483166,6,237640,291114969,237496,291095421,144,19548,231981,561,318184,33591,6,1591,130000.0,43333.0,-69.0,-62.0,-71.0,-69.0,-69.0,-62.0,-71.0,-69.0,-77.0,-84.0,-77.0,-84.0,8.0,22.0,6.0,15.0,1
1963,F8:59:71:5A:E0:3D,2280441,463733436,124698,190250068,2155743,273483368,337,89468,125839741,89368,125824910,100,14831,89089,33,124694,8701,337,68,144444.0,43333.0,-68.0,-74.0,-66.0,-70.0,-67.0,-74.0,-65.0,-70.0,-77.0,-84.0,-77.0,-84.0,9.0,10.0,11.0,14.0,1
1964,CC:2F:71:3E:C5:1F,2155848,273495899,105,12531,2155743,273483368,0,498,41549,421,32265,77,9284,114,1,180,7,0,27,144444.0,39000.0,-66.0,-69.0,-63.0,-60.0,-70.0,-71.0,-67.0,-62.0,-77.0,-84.0,-77.0,-84.0,11.0,15.0,14.0,24.0,1
1965,CC:2F:71:3F:1F:24,2474301,688556400,318558,415073032,2155743,273483368,6,237846,291329766,237702,291310218,144,19548,232181,561,318606,33592,6,1591,144444.0,43333.0,-70.0,-62.0,-70.0,-70.0,-69.0,-62.0,-69.0,-70.0,-77.0,-84.0,-77.0,-84.0,7.0,22.0,7.0,14.0,1
1966,F8:59:71:5A:E0:3D,2280520,463844498,124769,190360402,2155751,273484096,337,89540,125950621,89440,125935790,100,14831,89161,33,124765,8702,337,68,144444.0,43333.0,-66.0,-71.0,-67.0,-70.0,-66.0,-71.0,-66.0,-70.0,-78.0,-84.0,-78.0,-85.0,12.0,13.0,11.0,15.0,1
1967,CC:2F:71:3E:C5:1F,2155856,273496627,105,12531,2155751,273484096,0,500,41737,422,32335,78,9402,115,1,180,7,0,27,144444.0,39000.0,-71.0,-70.0,-67.0,-60.0,-70.0,-70.0,-67.0,-62.0,-78.0,-84.0,-78.0,-85.0,7.0,14.0,11.0,25.0,1
1968,CC:2F:71:3F:1F:24,2474499,688810202,318746,415325904,2155753,273484298,6,238026,291584390,237882,291564842,144,19548,232354,561,318794,33600,6,1594,144444.0,43333.0,-68.0,-63.0,-68.0,-70.0,-67.0,-62.0,-69.0,-69.0,-78.0,-84.0,-78.0,-85.0,10.0,21.0,10.0,15.0,1
1969,F8:59:71:5A:E0:3D,2280595,463958142,124842,190473844,2155753,273484298,337,89611,126060003,89511,126045172,100,14831,89232,33,124838,8702,337,68,144444.0,43333.0,-66.0,-73.0,-66.0,-70.0,-66.0,-73.0,-66.0,-69.0,-78.0,-84.0,-78.0,-85.0,12.0,11.0,12.0,15.0,1
1970,CC:2F:71:3E:C5:1F,2155858,273496829,105,12531,2155753,273484298,0,500,41737,422,32335,78,9402,115,1,180,7,0,27,144444.0,39000.0,-71.0,-70.0,-67.0,-60.0,-70.0,-70.0,-67.0,-62.0,-78.0,-84.0,-78.0,-85.0,7.0,14.0,11.0,25.0,1
1971,CC:2F:71:3F:1F:24,2474674,689035449,318921,415551151,2155753,273484298,6,238187,291797262,238043,291777714,144,19548,232514,561,318969,33601,6,1596,144444.0,43333.0,-69.0,-63.0,-68.0,-69.0,-67.0,-62.0,-68.0,-68.0,-78.0,-84.0,-78.0,-85.0,9.0,21.0,10.0,16.0,1
1972,F8:59:71:5A:E0:3D,2280750,464182988,124986,190697620,2155764,273485368,337,89775,126312703,89675,126297872,100,14831,89393,33,124981,8703,337,68,144444.0,43333.0,-67.0,-73.0,-66.0,-70.0,-66.0,-73.0,-66.0,-69.0,-78.0,-84.0,-78.0,-85.0,11.0,11.0,12.0,15.0,1
1973,CC:2F:71:3E:C5:1F,2155871,273498101,105,12531,2155766,273485570,0,500,41737,422,32335,78,9402,115,1,180,7,0,27,144444.0,39000.0,-71.0,-70.0,-67.0,-60.0,-70.0,-70.0,-67.0,-62.0,-78.0,-84.0,-78.0,-85.0,7.0,14.0,11.0,25.0,1
1974,CC:2F:71:3F:1F:24,2475046,689554207,319280,416068637,2155766,273485570,6,238546,292320496,238402,292300948,144,19548,232844,561,319328,33640,6,1620,130000.0,43333.0,-71.0,-62.0,-72.0,-70.0,-71.0,-62.0,-72.0,-69.0,-78.0,-84.0,-78.0,-85.0,7.0,22.0,6.0,15.0,1
1975,F8:59:71:5A:E0:3D,2280829,464295755,125058,190809508,2155771,273486247,337,89841,126414343,89741,126399512,100,14831,89459,33,125054,8703,337,68,144444.0,43333.0,-66.0,-74.0,-67.0,-70.0,-66.0,-73.0,-67.0,-69.0,-78.0,-84.0,-78.0,-85.0,12.0,10.0,11.0,15.0,1
1976,CC:2F:71:3E:C5:1F,2155876,273498778,105,12531,2155771,273486247,0,500,41737,422,32335,78,9402,115,1,180,7,0,27,144444.0,39000.0,-71.0,-70.0,-67.0,-60.0,-70.0,-70.0,-67.0,-62.0,-78.0,-84.0,-78.0,-85.0,7.0,14.0,11.0,25.0,1
1977,CC:2F:71:3F:1F:24,2475323,689870618,319551,416384311,2155772,273486307,6,238741,292533646,238597,292514098,144,19548,233037,561,319599,33644,6,1620,130000.0,43333.0,-71.0,-62.0,-73.0,-69.0,-71.0,-62.0,-72.0,-69.0,-78.0,-84.0,-78.0,-85.0,7.0,22.0,5.0,16.0,1
1978,F8:59:71:5A:E0:3D,2281171,464826196,125399,191339889,2155772,273486307,337,89960,126527275,89860,126512444,100,14831,89578,33,125394,8704,337,68,144444.0,43333.0,-67.0,-74.0,-66.0,-70.0,-66.0,-73.0,-66.0,-69.0,-78.0,-84.0,-78.0,-85.0,11.0,10.0,12.0,15.0,1
1979,CC:2F:71:3E:C5:1F,2155879,273499040,105,12531,2155774,273486509,0,500,41737,422,32335,78,9402,115,1,180,7,0,27,144444.0,39000.0,-71.0,-70.0,-67.0,-60.0,-70.0,-70.0,-67.0,-62.0,-78.0,-84.0,-78.0,-85.0,7.0,14.0,11.0,25.0,1
1980,CC:2F:71:3F:1F:24,2475495,690086663,319719,416599952,2155776,273486711,6,238899,292743423,238755,292723875,144,19548,233189,561,319767,33644,6,1629,144444.0,43333.0,-72.0,-62.0,-72.0,-69.0,-72.0,-62.0,-72.0,-69.0,-78.0,-84.0,-78.0,-85.0,6.0,22.0,6.0,16.0,1
1981,F8:59:71:5A:E0:3D,2281242,464924906,125462,191437791,2155780,273487115,337,90025,126627389,89925,126612558,100,14831,89642,33,125458,8704,337,68,144444.0,43333.0,-67.0,-73.0,-67.0,-69.0,-66.0,-73.0,-66.0,-69.0,-78.0,-84.0,-78.0,-85.0,11.0,11.0,11.0,16.0,1
1982,CC:2F:71:3E:C5:1F,2155885,273499646,105,12531,2155780,273487115,0,500,41737,422,32335,78,9402,115,1,180,7,0,27,144444.0,39000.0,-71.0,-70.0,-67.0,-60.0,-70.0,-70.0,-67.0,-62.0,-78.0,-84.0,-78.0,-85.0,7.0,14.0,11.0,25.0,1
1983,CC:2F:71:3F:1F:24,2475662,690301089,319882,416813974,2155780,273487115,6,239050,292953065,238906,292933517,144,19548,233338,561,319929,33644,6,1640,144444.0,43333.0,-71.0,-62.0,-71.0,-69.0,-70.0,-62.0,-71.0,-69.0,-78.0,-84.0,-78.0,-85.0,7.0,22.0,7.0,16.0,1
1984,F8:59:71:5A:E0:3D,2281309,465026145,125528,191538970,2155781,273487175,337,90091,126726220,89991,126711389,100,14831,89708,33,125524,8705,337,68,144444.0,43333.0,-67.0,-74.0,-67.0,-70.0,-66.0,-73.0,-66.0,-70.0,-78.0,-84.0,-78.0,-85.0,11.0,10.0,11.0,15.0,1
1985,CC:2F:71:3E:C5:1F,2155886,273499706,105,12531,2155781,273487175,0,500,41737,422,32335,78,9402,115,1,180,7,0,27,144444.0,39000.0,-71.0,-70.0,-67.0,-60.0,-70.0,-70.0,-67.0,-62.0,-78.0,-84.0,-78.0,-85.0,7.0,14.0,11.0,25.0,1
1986,CC:2F:71:3F:1F:24,2475819,690505717,320038,417018542,2155781,273487175,6,239199,293156597,239055,293137049,144,19548,233483,561,320086,33645,6,1640,144444.0,43333.0,-71.0,-62.0,-72.0,-70.0,-71.0,-62.0,-71.0,-69.0,-78.0,-84.0,-78.0,-85.0,7.0,22.0,6.0,15.0,1
1987,F8:59:71:5A:E0:3D,2281378,465124597,125591,191636816,2155787,273487781,337,90154,126823240,90054,126808409,100,14831,89771,33,125587,8705,337,68,130000.0,39000.0,-66.0,-74.0,-66.0,-70.0,-66.0,-73.0,-66.0,-69.0,-78.0,-84.0,-78.0,-85.0,12.0,10.0,12.0,15.0,1
1988,CC:2F:71:3E:C5:1F,2155892,273500312,105,12531,2155787,273487781,0,500,41737,422,32335,78,9402,115,1,180,7,0,27,144444.0,39000.0,-71.0,-70.0,-67.0,-60.0,-70.0,-70.0,-67.0,-62.0,-78.0,-84.0,-78.0,-85.0,7.0,14.0,11.0,25.0,1
1989,CC:2F:71:3F:1F:24,2475984,690712647,320195,417224664,2155789,273487983,6,239346,293359897,239202,293340349,144,19548,233626,561,320243,33645,6,1640,144444.0,43333.0,-71.0,-62.0,-71.0,-69.0,-70.0,-62.0,-71.0,-69.0,-78.0,-84.0,-78.0,-85.0,7.0,22.0,7.0,16.0,1
1990,F8:59:71:5A:E0:3D,2281443,465221204,125654,191733221,2155789,273487983,337,90219,126920573,90119,126905742,100,14831,89836,33,125650,8706,337,69,144444.0,43333.0,-66.0,-73.0,-67.0,-70.0,-66.0,-73.0,-66.0,-70.0,-78.0,-84.0,-78.0,-85.0,12.0,11.0,11.0,15.0,1
1991,CC:2F:71:3E:C5:1F,2155894,273500514,105,12531,2155789,273487983,0,500,41737,422,32335,78,9402,115,1,180,7,0,27,144444.0,39000.0,-71.0,-70.0,-67.0,-60.0,-70.0,-70.0,-67.0,-62.0,-78.0,-84.0,-78.0,-85.0,7.0,14.0,11.0,25.0,1
1992,CC:2F:71:3F:1F:24,2476326,691147768,320537,417659785,2155789,273487983,6,239544,293574837,239400,293555289,144,19548,233822,561,320585,33645,6,1641,144444.0,43333.0,-71.0,-62.0,-71.0,-69.0,-71.0,-62.0,-71.0,-69.0,-78.0,-84.0,-78.0,-85.0,7.0,22.0,7.0,16.0,1
1993,F8:59:71:5A:E0:3D,2281512,465321124,125718,191832677,2155794,273488447,337,90282,127017593,90182,127002762,100,14831,89899,33,125714,8707,337,69,144444.0,43333.0,-67.0,-74.0,-67.0,-70.0,-66.0,-73.0,-66.0,-70.0,-78.0,-84.0,-78.0,-85.0,11.0,10.0,11.0,15.0,1
1994,CC:2F:71:3E:C5:1F,2155899,273500978,105,12531,2155794,273488447,0,500,41737,422,32335,78,9402,115,1,180,7,0,27,144444.0,39000.0,-71.0,-70.0,-67.0,-60.0,-70.0,-70.0,-67.0,-62.0,-78.0,-84.0,-78.0,-85.0,7.0,14.0,11.0,25.0,1
1995,CC:2F:71:3F:1F:24,2476490,691353171,320694,417864522,2155796,273488649,6,239689,293773630,239545,293754082,144,19548,233966,561,320742,33645,6,1641,144444.0,43333.0,-72.0,-62.0,-71.0,-69.0,-70.0,-62.0,-71.0,-69.0,-78.0,-84.0,-78.0,-85.0,6.0,22.0,7.0,16.0,1
1996,F8:59:71:5A:E0:3D,2281615,465467783,125817,191978932,2155798,273488851,337,90355,127122269,90255,127107438,100,14831,89972,33,125813,8708,337,69,144444.0,43333.0,-67.0,-74.0,-67.0,-70.0,-66.0,-73.0,-66.0,-69.0,-78.0,-84.0,-78.0,-85.0,11.0,10.0,11.0,15.0,1
1997,CC:2F:71:3E:C5:1F,2155903,273501382,105,12531,2155798,273488851,0,500,41737,422,32335,78,9402,115,1,180,7,0,27,144444.0,39000.0,-71.0,-70.0,-67.0,-60.0,-70.0,-70.0,-67.0,-62.0,-78.0,-84.0,-78.0,-85.0,7.0,14.0,11.0,25.0,1
1998,CC:2F:71:3F:1F:24,2476648,691556517,320850,418067666,2155798,273488851,6,239836,293974214,239692,293954666,144,19548,234108,561,320898,33646,6,1641,144444.0,43333.0,-71.0,-62.0,-71.0,-69.0,-71.0,-62.0,-71.0,-69.0,-78.0,-84.0,-78.0,-85.0,7.0,22.0,7.0,16.0,1
1999,F8:59:71:5A:E0:3D,2281741,465655720,125939,192166465,2155802,273489255,337,90434,127223041,90334,127208210,100,14831,90051,33,125935,8708,337,69,144444.0,43333.0,-67.0,-74.0,-66.0,-70.0,-66.0,-73.0,-66.0,-69.0,-78.0,-84.0,-78.0,-85.0,11.0,10.0,12.0,15.0,1
2000,CC:2F:71:3E:C5:1F,2155907,273501786,105,12531,2155802,273489255,0,500,41737,422,32335,78,9402,115,1,180,7,0,27,144444.0,39000.0,-71.0,-70.0,-67.0,-60.0,-70.0,-70.0,-67.0,-62.0,-78.0,-84.0,-78.0,-85.0,7.0,14.0,11.0,25.0,1
2001,CC:2F:71:3F:1F:24,2476807,691759935,321005,418270680,2155802,273489255,6,239980,294171504,239836,294151956,144,19548,234249,561,321053,33646,6,1641,144444.0,43333.0,-71.0,-62.0,-70.0,-69.0,-70.0,-62.0,-70.0,-68.0,-78.0,-84.0,-78.0,-85.0,7.0,22.0,8.0,16.0,1
2002,F8:59:71:5A:E0:3D,2281809,465754086,126002,192264367,2155807,273489719,337,90496,127318521,90396,127303690,100,14831,90113,33,125998,8708,337,69,144444.0,43333.0,-67.0,-74.0,-67.0,-70.0,-66.0,-74.0,-66.0,-70.0,-78.0,-84.0,-78.0,-85.0,11.0,10.0,11.0,15.0,1
2003,CC:2F:71:3E:C5:1F,2155912,273502250,105,12531,2155807,273489719,0,500,41737,422,32335,78,9402,115,1,180,7,0,27,144444.0,39000.0,-71.0,-70.0,-67.0,-60.0,-70.0,-70.0,-67.0,-62.0,-78.0,-84.0,-78.0,-85.0,7.0,14.0,11.0,25.0,1
2004,CC:2F:71:3F:1F:24,2476976,691969994,321169,418480275,2155807,273489719,6,240132,294373062,239988,294353514,144,19548,234398,561,321217,33648,6,1641,144444.0,43333.0,-70.0,-62.0,-71.0,-68.0,-70.0,-62.0,-71.0,-68.0,-78.0,-84.0,-78.0,-85.0,8.0,22.0,7.0,17.0,1
2005,F8:59:71:5A:E0:3D,2281874,465852190,126065,192362269,2155809,273489921,337,90559,127415541,90459,127400710,100,14831,90176,33,126061,8708,337,69,144444.0,43333.0,-67.0,-74.0,-67.0,-70.0,-66.0,-73.0,-66.0,-69.0,-78.0,-85.0,-78.0,-86.0,11.0,11.0,11.0,16.0,1
2006,CC:2F:71:3E:C5:1F,2155916,273502654,105,12531,2155811,273490123,0,500,41737,422,32335,78,9402,115,1,180,7,0,27,144444.0,39000.0,-71.0,-70.0,-67.0,-60.0,-70.0,-70.0,-67.0,-62.0,-78.0,-85.0,-78.0,-86.0,7.0,15.0,11.0,26.0,1
2007,CC:2F:71:3F:1F:24,2477139,692179628,321328,418689505,2155811,273490123,6,240280,294575012,240136,294555464,144,19548,234545,561,321376,33648,6,1641,144444.0,43333.0,-71.0,-62.0,-71.0,-69.0,-70.0,-62.0,-71.0,-68.0,-78.0,-85.0,-78.0,-86.0,7.0,23.0,7.0,17.0,1
2008,F8:59:71:5A:E0:3D,2281947,465952710,126132,192462183,2155815,273490527,337,90627,127516461,90527,127501630,100,14831,90244,33,126128,8708,337,69,144444.0,43333.0,-67.0,-74.0,-66.0,-69.0,-66.0,-74.0,-66.0,-69.0,-78.0,-85.0,-78.0,-86.0,11.0,11.0,12.0,17.0,1
2009,CC:2F:71:3E:C5:1F,2155920,273503058,105,12531,2155815,273490527,0,500,41737,422,32335,78,9402,115,1,180,7,0,27,144444.0,39000.0,-71.0,-70.0,-67.0,-60.0,-70.0,-70.0,-67.0,-62.0,-78.0,-85.0,-78.0,-86.0,7.0,15.0,11.0,26.0,1
2010,CC:2F:71:3F:1F:24,2477301,692386284,321486,418895757,2155815,273490527,6,240431,294784556,240287,294765008,144,19548,234686,561,321534,33649,6,1641,144444.0,43333.0,-70.0,-62.0,-70.0,-68.0,-70.0,-62.0,-70.0,-68.0,-78.0,-85.0,-78.0,-86.0,8.0,23.0,8.0,18.0,1
2011,F8:59:71:5A:E0:3D,2282011,466050672,126195,192560085,2155816,273490587,337,90691,127615021,90591,127600190,100,14831,90308,33,126191,8708,337,69,144444.0,43333.0,-66.0,-74.0,-66.0,-69.0,-66.0,-73.0,-66.0,-69.0,-78.0,-85.0,-78.0,-86.0,12.0,11.0,12.0,17.0,1
2012,CC:2F:71:3E:C5:1F,2155921,273503118,105,12531,2155816,273490587,0,500,41737,422,32335,78,9402,115,1,180,7,0,27,144444.0,39000.0,-71.0,-70.0,-67.0,-60.0,-70.0,-70.0,-67.0,-62.0,-78.0,-85.0,-78.0,-86.0,7.0,15.0,11.0,26.0,1
2013,CC:2F:71:3F:1F:24,2477462,692589994,321644,419099205,2155818,273490789,6,240582,294988364,240438,294968816,144,19548,234833,561,321692,33663,6,1641,144444.0,43333.0,-70.0,-62.0,-72.0,-71.0,-70.0,-62.0,-71.0,-70.0,-78.0,-85.0,-78.0,-86.0,8.0,23.0,6.0,15.0,1
2014,F8:59:71:5A:E0:3D,2282082,466147944,126258,192656549,2155824,273491395,337,90752,127708961,90652,127694130,100,14831,90369,33,126254,8708,337,69,144444.0,43333.0,-67.0,-74.0,-67.0,-70.0,-67.0,-73.0,-66.0,-69.0,-78.0,-85.0,-78.0,-86.0,11.0,11.0,11.0,16.0,1
2015,CC:2F:71:3E:C5:1F,2155929,273503926,105,12531,2155824,273491395,0,502,41877,424,32475,78,9402,115,1,181,7,0,27,144444.0,39000.0,-71.0,-69.0,-67.0,-60.0,-70.0,-70.0,-67.0,-62.0,-78.0,-85.0,-78.0,-86.0,7.0,16.0,11.0,26.0,1
2016,CC:2F:71:3F:1F:24,2477654,692820527,321830,419329132,2155824,273491395,6,240743,295191392,240599,295171844,144,19548,234992,561,321878,33747,6,1641,130000.0,43333.0,-70.0,-62.0,-72.0,-74.0,-70.0,-61.0,-72.0,-74.0,-78.0,-85.0,-78.0,-86.0,8.0,23.0,6.0,12.0,1
2017,F8:59:71:5A:E0:3D,2282310,466494383,126486,193002988,2155824,273491395,337,90837,127814577,90737,127799746,100,14831,90454,33,126482,8708,337,69,144444.0,43333.0,-66.0,-74.0,-66.0,-69.0,-66.0,-73.0,-66.0,-69.0,-78.0,-85.0,-78.0,-86.0,12.0,11.0,12.0,17.0,1
2018,CC:2F:71:3E:C5:1F,2155930,273504042,106,12647,2155824,273491395,0,504,42017,426,32615,78,9402,115,1,182,7,0,27,144444.0,39000.0,-70.0,-69.0,-67.0,-60.0,-70.0,-68.0,-67.0,-61.0,-78.0,-85.0,-78.0,-86.0,8.0,16.0,11.0,26.0,1
2019,CC:2F:71:3F:1F:24,2477822,693032335,321997,419540667,2155825,273491668,6,240902,295398025,240758,295378477,144,19548,235146,561,322045,33748,6,1641,130000.0,43333.0,-71.0,-62.0,-71.0,-74.0,-70.0,-61.0,-71.0,-74.0,-78.0,-85.0,-78.0,-86.0,7.0,23.0,7.0,12.0,1
2020,F8:59:71:5A:E0:3D,2282382,466593286,126549,193100890,2155833,273492396,337,90901,127913137,90801,127898306,100,14831,90518,33,126545,8708,337,69,144444.0,43333.0,-67.0,-74.0,-66.0,-70.0,-66.0,-73.0,-66.0,-69.0,-78.0,-85.0,-78.0,-86.0,11.0,11.0,12.0,16.0,1
2021,CC:2F:71:3E:C5:1F,2155939,273505043,106,12647,2155833,273492396,0,504,42017,426,32615,78,9402,115,1,182,7,0,27,144444.0,39000.0,-70.0,-69.0,-67.0,-60.0,-70.0,-68.0,-67.0,-61.0,-78.0,-85.0,-78.0,-86.0,8.0,16.0,11.0,26.0,1
2022,CC:2F:71:3F:1F:24,2477993,693247085,322160,419754689,2155833,273492396,6,241053,295604723,240908,295585057,145,19666,235295,561,322208,33750,6,1646,130000.0,43333.0,-72.0,-63.0,-72.0,-75.0,-71.0,-62.0,-72.0,-74.0,-78.0,-85.0,-78.0,-86.0,6.0,22.0,6.0,11.0,1
2023,F8:59:71:5A:E0:3D,2282654,467009350,126816,193516250,2155838,273493100,337,91036,128074517,90936,128059686,100,14831,90653,33,126812,8709,337,69,144444.0,43333.0,-66.0,-74.0,-67.0,-70.0,-66.0,-73.0,-66.0,-69.0,-78.0,-85.0,-78.0,-86.0,12.0,11.0,11.0,16.0,1
2024,CC:2F:71:3E:C5:1F,2155947,273506017,106,12647,2155841,273493370,0,504,42017,426,32615,78,9402,115,1,182,7,0,27,144444.0,39000.0,-70.0,-69.0,-67.0,-60.0,-70.0,-68.0,-67.0,-61.0,-78.0,-85.0,-78.0,-86.0,8.0,16.0,11.0,26.0,1
2025,CC:2F:71:3F:1F:24,2478349,693738019,322503,420244185,2155846,273493834,6,241353,296038137,241208,296018471,145,19666,235582,561,322550,33755,6,1668,144444.0,43333.0,-68.0,-63.0,-68.0,-70.0,-69.0,-64.0,-69.0,-71.0,-78.0,-85.0,-78.0,-86.0,10.0,22.0,10.0,16.0,1
2026,F8:59:71:5A:E0:3D,2282850,467287346,126995,193792642,2155855,273494704,337,91235,128378513,91134,128363564,101,14949,90850,33,126991,8709,337,72,144444.0,43333.0,-67.0,-74.0,-67.0,-70.0,-66.0,-73.0,-67.0,-69.0,-78.0,-85.0,-78.0,-86.0,11.0,11.0,11.0,16.0,1
2027,CC:2F:71:3E:C5:1F,2155962,273507411,106,12647,2155856,273494764,0,504,42017,426,32615,78,9402,115,1,182,7,0,27,144444.0,39000.0,-70.0,-69.0,-67.0,-60.0,-70.0,-68.0,-67.0,-61.0,-78.0,-85.0,-78.0,-86.0,8.0,16.0,11.0,26.0,1
2028,CC:2F:71:3F:1F:24,2478832,694400847,322976,420906083,2155856,273494764,6,241891,296790495,241746,296770829,145,19666,236050,561,323024,33767,6,1700,144444.0,43333.0,-70.0,-64.0,-71.0,-70.0,-72.0,-67.0,-72.0,-72.0,-78.0,-85.0,-78.0,-86.0,8.0,21.0,7.0,16.0,1
2029,F8:59:71:5A:E0:3D,2283168,467756849,127303,194261215,2155865,273495634,337,91462,128693027,91361,128678078,101,14949,91075,33,127299,8747,337,72,144444.0,43333.0,-66.0,-74.0,-67.0,-69.0,-66.0,-73.0,-66.0,-69.0,-79.0,-85.0,-79.0,-86.0,13.0,11.0,12.0,17.0,1
2030,CC:2F:71:3E:C5:1F,2155971,273508281,106,12647,2155865,273495634,0,506,42205,427,32685,79,9520,116,1,182,7,0,27,144444.0,39000.0,-72.0,-70.0,-67.0,-60.0,-70.0,-68.0,-67.0,-61.0,-79.0,-85.0,-79.0,-86.0,7.0,15.0,12.0,26.0,1
2031,CC:2F:71:3F:1F:24,2479159,694809350,323294,421313716,2155865,273495634,6,242203,297203261,242058,297183595,145,19666,236352,561,323342,33770,6,1725,144444.0,43333.0,-69.0,-62.0,-71.0,-70.0,-69.0,-62.0,-70.0,-70.0,-79.0,-85.0,-79.0,-86.0,10.0,23.0,8.0,16.0,1
2032,F8:59:71:5A:E0:3D,2283237,467853863,127365,194357563,2155872,273496300,337,91524,128788507,91423,128773558,101,14949,91137,33,127361,8747,337,72,144444.0,43333.0,-66.0,-74.0,-67.0,-70.0,-66.0,-73.0,-66.0,-70.0,-79.0,-85.0,-79.0,-86.0,13.0,11.0,12.0,16.0,1
2033,CC:2F:71:3E:C5:1F,2155978,273508947,106,12647,2155872,273496300,0,506,42205,427,32685,79,9520,116,1,182,7,0,27,144444.0,39000.0,-72.0,-70.0,-67.0,-60.0,-70.0,-68.0,-67.0,-61.0,-79.0,-85.0,-79.0,-86.0,7.0,15.0,12.0,26.0,1
2034,CC:2F:71:3F:1F:24,2479323,695014714,323451,421518414,2155872,273496300,6,242350,297406561,242205,297386895,145,19666,236495,561,323499,33771,6,1725,144444.0,43333.0,-70.0,-62.0,-71.0,-70.0,-69.0,-62.0,-70.0,-69.0,-79.0,-85.0,-79.0,-86.0,9.0,23.0,8.0,16.0,1
2035,F8:59:71:5A:E0:3D,2283311,467954766,127437,194458264,2155874,273496502,337,91595,128890804,91494,128875855,101,14949,91208,33,127433,8747,337,72,144444.0,43333.0,-66.0,-74.0,-67.0,-70.0,-66.0,-73.0,-67.0,-69.0,-79.0,-86.0,-79.0,-86.0,13.0,12.0,12.0,16.0,1
2036,CC:2F:71:3E:C5:1F,2155980,273509149,106,12647,2155874,273496502,0,506,42205,427,32685,79,9520,116,1,182,7,0,27,144444.0,39000.0,-72.0,-70.0,-67.0,-60.0,-70.0,-68.0,-67.0,-61.0,-79.0,-86.0,-79.0,-86.0,7.0,16.0,12.0,26.0,1
2037,CC:2F:71:3F:1F:24,2479484,695218606,323610,421722104,2155874,273496502,6,242501,297603347,242356,297583681,145,19666,236643,561,323658,33773,6,1725,144444.0,43333.0,-69.0,-62.0,-71.0,-69.0,-69.0,-62.0,-70.0,-69.0,-79.0,-86.0,-79.0,-86.0,10.0,24.0,8.0,17.0,1
2038,F8:59:71:5A:E0:3D,2283376,468049964,127498,194553058,2155878,273496906,337,91657,128986284,91556,128971335,101,14949,91270,33,127494,8747,337,72,144444.0,43333.0,-66.0,-73.0,-67.0,-70.0,-66.0,-73.0,-66.0,-69.0,-79.0,-86.0,-79.0,-86.0,13.0,13.0,12.0,16.0,1
2039,CC:2F:71:3E:C5:1F,2155986,273509755,106,12647,2155880,273497108,0,506,42205,427,32685,79,9520,116,1,182,7,0,27,144444.0,39000.0,-72.0,-70.0,-67.0,-60.0,-70.0,-68.0,-67.0,-61.0,-79.0,-86.0,-79.0,-86.0,7.0,16.0,12.0,26.0,1
2040,CC:2F:71:3F:1F:24,2479646,695423780,323766,421926672,2155880,273497108,6,242647,297806559,242502,297786893,145,19666,236783,561,323814,33774,6,1725,144444.0,43333.0,-70.0,-62.0,-71.0,-70.0,-69.0,-62.0,-70.0,-70.0,-79.0,-86.0,-79.0,-86.0,9.0,24.0,8.0,16.0,1
2041,F8:59:71:5A:E0:3D,2283444,468148330,127561,194650960,2155883,273497370,337,91720,129083304,91619,129068355,101,14949,91333,33,127557,8747,337,72,144444.0,43333.0,-66.0,-74.0,-66.0,-70.0,-66.0,-73.0,-66.0,-69.0,-79.0,-86.0,-79.0,-86.0,13.0,12.0,13.0,16.0,1
2042,CC:2F:71:3E:C5:1F,2155989,273510017,106,12647,2155883,273497370,0,506,42205,427,32685,79,9520,116,1,182,7,0,27,144444.0,39000.0,-72.0,-70.0,-67.0,-60.0,-70.0,-68.0,-67.0,-61.0,-79.0,-86.0,-79.0,-86.0,7.0,16.0,12.0,26.0,1
2043,CC:2F:71:3F:1F:24,2479806,695630164,323923,422132794,2155883,273497370,6,242792,298005423,242647,297985757,145,19666,236926,561,323971,33775,6,1725,144444.0,43333.0,-69.0,-62.0,-71.0,-70.0,-69.0,-62.0,-70.0,-70.0,-79.0,-86.0,-79.0,-87.0,10.0,24.0,8.0,17.0,1
2044,F8:59:71:5A:E0:3D,2283509,468246266,127624,194748694,2155885,273497572,337,91783,129180324,91682,129165375,101,14949,91396,33,127620,8747,337,72,144444.0,43333.0,-66.0,-74.0,-67.0,-70.0,-66.0,-73.0,-66.0,-69.0,-79.0,-86.0,-79.0,-87.0,13.0,12.0,12.0,17.0,1
2045,CC:2F:71:3E:C5:1F,2155993,273510421,106,12647,2155887,273497774,0,506,42205,427,32685,79,9520,116,1,182,7,0,27,144444.0,39000.0,-72.0,-70.0,-67.0,-60.0,-70.0,-68.0,-67.0,-61.0,-79.0,-86.0,-79.0,-87.0,7.0,16.0,12.0,27.0,1
2046,CC:2F:71:3F:1F:24,2480001,695869597,324112,422371621,2155889,273497976,6,242965,298229719,242820,298210053,145,19666,237098,561,324159,33778,6,1726,144444.0,43333.0,-68.0,-63.0,-68.0,-70.0,-69.0,-65.0,-69.0,-71.0,-79.0,-86.0,-79.0,-87.0,11.0,23.0,11.0,17.0,1
2047,F8:59:71:5A:E0:3D,2283934,468865276,128026,195365291,2155908,273499985,337,92111,129661209,92010,129646260,101,14949,91722,33,128022,8767,337,72,144444.0,43333.0,-66.0,-74.0,-67.0,-70.0,-66.0,-74.0,-67.0,-70.0,-79.0,-86.0,-79.0,-87.0,13.0,12.0,12.0,17.0,1
2048,CC:2F:71:3E:C5:1F,2156014,273512632,106,12647,2155908,273499985,0,506,42205,427,32685,79,9520,116,1,182,7,0,27,144444.0,39000.0,-72.0,-70.0,-67.0,-60.0,-70.0,-68.0,-67.0,-61.0,-79.0,-86.0,-79.0,-87.0,7.0,16.0,12.0,27.0,1
2049,CC:2F:71:3F:1F:24,2480680,696827635,324772,423327650,2155908,273499985,6,243651,299213389,243506,299193723,145,19666,237681,561,324819,33786,6,1774,144444.0,43333.0,-69.0,-62.0,-71.0,-70.0,-69.0,-62.0,-71.0,-70.0,-79.0,-86.0,-79.0,-87.0,10.0,24.0,8.0,17.0,1
2050,F8:59:71:5A:E0:3D,2284188,469257919,128278,195757732,2155910,273500187,337,92209,129770325,92108,129755376,101,14949,91820,33,128274,8768,337,72,144444.0,43333.0,-66.0,-74.0,-67.0,-70.0,-66.0,-73.0,-66.0,-69.0,-79.0,-86.0,-79.0,-87.0,13.0,12.0,12.0,17.0,1
2051,CC:2F:71:3E:C5:1F,2156016,273512834,106,12647,2155910,273500187,0,506,42205,427,32685,79,9520,116,1,182,7,0,27,144444.0,39000.0,-72.0,-70.0,-67.0,-60.0,-70.0,-68.0,-67.0,-61.0,-79.0,-86.0,-79.0,-87.0,7.0,16.0,12.0,27.0,1
2052,CC:2F:71:3F:1F:24,2480839,697032560,324929,423532373,2155910,273500187,6,243799,299413958,243654,299394292,145,19666,237827,561,324977,33786,6,1774,144444.0,43333.0,-70.0,-62.0,-71.0,-71.0,-69.0,-62.0,-71.0,-70.0,-79.0,-86.0,-79.0,-87.0,9.0,24.0,8.0,16.0,1
2053,F8:59:71:5A:E0:3D,2284260,469356747,128343,195855894,2155917,273500853,337,92276,129868954,92175,129854005,101,14949,91885,33,128339,8768,337,72,144444.0,43333.0,-67.0,-74.0,-67.0,-70.0,-66.0,-73.0,-66.0,-69.0,-79.0,-86.0,-79.0,-87.0,12.0,12.0,12.0,17.0,1
2054,CC:2F:71:3E:C5:1F,2156023,273513500,106,12647,2155917,273500853,0,506,42205,427,32685,79,9520,116,1,182,7,0,27,144444.0,39000.0,-72.0,-70.0,-67.0,-60.0,-70.0,-68.0,-67.0,-61.0,-79.0,-86.0,-79.0,-87.0,7.0,16.0,12.0,27.0,1
2055,CC:2F:71:3F:1F:24,2481003,697239348,325086,423738495,2155917,273500853,6,243945,299617142,243800,299597476,145,19666,237969,561,325134,33787,6,1774,144444.0,43333.0,-70.0,-62.0,-71.0,-70.0,-70.0,-62.0,-71.0,-70.0,-79.0,-86.0,-79.0,-87.0,9.0,24.0,8.0,17.0,1
2056,F8:59:71:5A:E0:3D,2284388,469538201,128469,196037146,2155919,273501055,337,92381,130018731,92280,130003782,101,14949,91990,33,128465,8802,337,72,144444.0,43333.0,-67.0,-74.0,-67.0,-70.0,-66.0,-73.0,-66.0,-70.0,-79.0,-86.0,-80.0,-87.0,12.0,12.0,13.0,17.0,1
2057,CC:2F:71:3E:C5:1F,2156025,273513702,106,12647,2155919,273501055,0,506,42205,427,32685,79,9520,116,1,182,7,0,27,144444.0,39000.0,-72.0,-70.0,-67.0,-60.0,-70.0,-68.0,-67.0,-61.0,-79.0,-86.0,-80.0,-87.0,7.0,16.0,13.0,27.0,1
2058,CC:2F:71:3F:1F:24,2481294,697635129,325369,424133468,2155925,273501661,6,244206,299979446,244061,299959780,145,19666,238224,561,325417,33789,6,1797,144444.0,43333.0,-70.0,-64.0,-70.0,-72.0,-68.0,-63.0,-69.0,-71.0,-79.0,-86.0,-80.0,-87.0,9.0,22.0,10.0,15.0,1
2059,F8:59:71:5A:E0:3D,2285513,471185631,129526,197669049,2155987,273516582,337,93179,131139945,93078,131124996,101,14949,92786,33,129522,8809,337,72,144444.0,43333.0,-67.0,-74.0,-66.0,-69.0,-66.0,-74.0,-66.0,-69.0,-79.0,-85.0,-79.0,-86.0,12.0,11.0,13.0,17.0,1
2060,CC:2F:71:3E:C5:1F,2156096,273529547,107,12763,2155989,273516784,0,510,42485,431,32965,79,9520,116,1,184,7,0,27,144444.0,39000.0,-71.0,-69.0,-67.0,-60.0,-70.0,-68.0,-67.0,-61.0,-79.0,-85.0,-79.0,-86.0,8.0,16.0,12.0,26.0,1
2061,CC:2F:71:3F:1F:24,2482792,699770591,326803,426253807,2155989,273516784,6,245678,302149368,245531,302129380,147,19988,239561,561,326851,33846,6,1890,130000.0,43333.0,-69.0,-62.0,-71.0,-70.0,-68.0,-61.0,-71.0,-70.0,-79.0,-85.0,-79.0,-86.0,10.0,23.0,8.0,16.0,1
2062,F8:59:71:5A:E0:3D,2285582,471284139,129589,197766951,2155993,273517188,337,93241,131235425,93140,131220476,101,14949,92848,33,129585,8810,337,72,144444.0,43333.0,-67.0,-73.0,-67.0,-70.0,-67.0,-73.0,-66.0,-69.0,-79.0,-85.0,-79.0,-86.0,12.0,12.0,12.0,16.0,1
2063,CC:2F:71:3E:C5:1F,2156100,273529951,107,12763,2155993,273517188,0,510,42485,431,32965,79,9520,116,1,184,7,0,27,144444.0,39000.0,-71.0,-69.0,-67.0,-60.0,-70.0,-68.0,-67.0,-61.0,-79.0,-85.0,-79.0,-86.0,8.0,16.0,12.0,26.0,1
2064,CC:2F:71:3F:1F:24,2482969,699980723,326974,426463333,2155995,273517390,6,245831,302350234,245684,302330246,147,19988,239714,561,327022,33874,6,1890,115556.0,28889.0,-70.0,-62.0,-71.0,-70.0,-70.0,-62.0,-71.0,-70.0,-79.0,-85.0,-79.0,-86.0,9.0,23.0,8.0,16.0,1
2065,F8:59:71:5A:E0:3D,2285649,471380980,129652,197863468,2155997,273517512,337,93306,131332716,93205,131317767,101,14949,92913,33,129648,8811,337,72,144444.0,43333.0,-67.0,-74.0,-67.0,-70.0,-66.0,-73.0,-66.0,-69.0,-79.0,-85.0,-79.0,-86.0,12.0,11.0,12.0,16.0,1
2066,CC:2F:71:3E:C5:1F,2156104,273530275,107,12763,2155997,273517512,0,512,42673,432,33035,80,9638,117,1,184,7,0,27,144444.0,39000.0,-68.0,-61.0,-65.0,-59.0,-69.0,-66.0,-66.0,-59.0,-79.0,-85.0,-79.0,-86.0,11.0,24.0,14.0,27.0,1
2067,CC:2F:71:3F:1F:24,2483134,700187592,327137,426670080,2155997,273517512,6,245978,302546850,245831,302526862,147,19988,239861,561,327185,33875,6,1890,115556.0,28889.0,-70.0,-63.0,-71.0,-69.0,-70.0,-62.0,-71.0,-69.0,-79.0,-85.0,-79.0,-86.0,9.0,22.0,8.0,17.0,1
2068,F8:59:71:5A:E0:3D,2285754,471526248,129750,198008068,2156004,273518180,337,93382,131437814,93280,131422747,102,15067,92989,33,129746,8812,337,72,144444.0,43333.0,-67.0,-73.0,-66.0,-70.0,-66.0,-73.0,-66.0,-70.0,-79.0,-86.0,-80.0,-87.0,12.0,13.0,14.0,17.0,1
2069,CC:2F:71:3E:C5:1F,2156111,273530943,107,12763,2156004,273518180,0,512,42673,432,33035,80,9638,117,1,184,7,0,27,144444.0,39000.0,-68.0,-61.0,-65.0,-59.0,-69.0,-66.0,-66.0,-59.0,-79.0,-86.0,-80.0,-87.0,11.0,25.0,15.0,28.0,1
2070,CC:2F:71:3F:1F:24,2483298,700393990,327294,426875810,2156004,273518180,6,246122,302744050,245975,302724062,147,19988,240005,561,327342,33884,6,1890,130000.0,43333.0,-68.0,-63.0,-72.0,-72.0,-68.0,-62.0,-72.0,-71.0,-79.0,-86.0,-80.0,-87.0,11.0,23.0,8.0,15.0,1
2071,F8:59:71:5A:E0:3D,2285819,471622914,129813,198104532,2156006,273518382,337,93445,131533456,93343,131518389,102,15067,93052,33,129809,8812,337,72,144444.0,43333.0,-67.0,-74.0,-67.0,-70.0,-66.0,-73.0,-66.0,-69.0,-79.0,-86.0,-80.0,-87.0,12.0,12.0,13.0,17.0,1
2072,CC:2F:71:3E:C5:1F,2156113,273531145,107,12763,2156006,273518382,0,512,42673,432,33035,80,9638,117,1,184,7,0,27,144444.0,39000.0,-68.0,-61.0,-65.0,-59.0,-69.0,-66.0,-66.0,-59.0,-79.0,-85.0,-80.0,-86.0,11.0,24.0,15.0,27.0,1
2073,CC:2F:71:3F:1F:24,2483457,700597452,327451,427079070,2156006,273518382,6,246265,302939714,246118,302919726,147,19988,240147,561,327499,33884,6,1890,130000.0,43333.0,-70.0,-63.0,-72.0,-71.0,-69.0,-62.0,-72.0,-71.0,-79.0,-85.0,-80.0,-86.0,9.0,22.0,8.0,15.0,1
2074,F8:59:71:5A:E0:3D,2285893,471723497,129880,198204449,2156013,273519048,337,93512,131632764,93410,131617697,102,15067,93119,33,129876,8812,337,72,144444.0,43333.0,-66.0,-73.0,-67.0,-70.0,-66.0,-73.0,-66.0,-69.0,-79.0,-85.0,-80.0,-86.0,13.0,12.0,13.0,16.0,1
2075,CC:2F:71:3E:C5:1F,2156120,273531811,107,12763,2156013,273519048,0,512,42673,432,33035,80,9638,117,1,184,7,0,27,144444.0,39000.0,-68.0,-61.0,-65.0,-59.0,-69.0,-66.0,-66.0,-59.0,-79.0,-85.0,-80.0,-86.0,11.0,24.0,15.0,27.0,1
2076,CC:2F:71:3F:1F:24,2483622,700804370,327609,427285322,2156013,273519048,6,246410,303137030,246263,303117042,147,19988,240292,561,327657,33884,6,1890,130000.0,43333.0,-70.0,-62.0,-72.0,-72.0,-69.0,-62.0,-71.0,-72.0,-79.0,-85.0,-80.0,-86.0,9.0,23.0,8.0,14.0,1
2077,F8:59:71:5A:E0:3D,2285957,471820047,129942,198300797,2156015,273519250,337,93575,131729784,93473,131714717,102,15067,93182,33,129938,8812,337,72,144444.0,43333.0,-66.0,-73.0,-67.0,-69.0,-66.0,-73.0,-66.0,-69.0,-79.0,-85.0,-80.0,-86.0,13.0,12.0,13.0,17.0,1
2078,CC:2F:71:3E:C5:1F,2156122,273532013,107,12763,2156015,273519250,0,512,42673,432,33035,80,9638,117,1,184,7,0,27,144444.0,39000.0,-68.0,-61.0,-65.0,-59.0,-69.0,-66.0,-66.0,-59.0,-79.0,-85.0,-80.0,-86.0,11.0,24.0,15.0,27.0,1
2079,CC:2F:71:3F:1F:24,2483797,701014092,327782,427494842,2156015,273519250,6,246570,303334453,246423,303314465,147,19988,240452,561,327830,33895,6,1891,130000.0,43333.0,-69.0,-62.0,-71.0,-73.0,-69.0,-62.0,-71.0,-73.0,-79.0,-85.0,-80.0,-86.0,10.0,23.0,9.0,13.0,1
2080,F8:59:71:5A:E0:3D,2286021,471916597,130004,198397145,2156017,273519452,337,93637,131825264,93535,131810197,102,15067,93244,33,130000,8812,337,72,144444.0,43333.0,-67.0,-74.0,-67.0,-70.0,-67.0,-73.0,-66.0,-69.0,-80.0,-85.0,-80.0,-87.0,13.0,11.0,13.0,17.0,1
2081,CC:2F:71:3E:C5:1F,2156127,273532479,107,12763,2156020,273519716,0,512,42673,432,33035,80,9638,117,1,184,7,0,27,144444.0,39000.0,-68.0,-61.0,-65.0,-59.0,-69.0,-66.0,-66.0,-59.0,-80.0,-85.0,-80.0,-87.0,12.0,24.0,15.0,28.0,1
2082,CC:2F:71:3F:1F:24,2483960,701217952,327939,427698102,2156021,273519850,6,246716,303532019,246568,303511913,148,20106,240597,561,327987,33895,6,1893,130000.0,43333.0,-70.0,-62.0,-72.0,-73.0,-69.0,-62.0,-70.0,-72.0,-80.0,-85.0,-80.0,-87.0,10.0,23.0,8.0,14.0,1
2083,F8:59:71:5A:E0:3D,2286093,472016781,130068,198496601,2156025,273520180,337,93700,131922284,93598,131907217,102,15067,93307,33,130064,8812,337,72,144444.0,43333.0,-66.0,-74.0,-66.0,-70.0,-66.0,-73.0,-66.0,-69.0,-80.0,-85.0,-80.0,-87.0,14.0,11.0,14.0,17.0,1
2084,CC:2F:71:3E:C5:1F,2156132,273532943,107,12763,2156025,273520180,0,512,42673,432,33035,80,9638,117,1,184,7,0,27,144444.0,39000.0,-68.0,-61.0,-65.0,-59.0,-69.0,-66.0,-66.0,-59.0,-80.0,-85.0,-80.0,-87.0,12.0,24.0,15.0,28.0,1
2085,CC:2F:71:3F:1F:24,2484121,701425604,328096,427905424,2156025,273520180,6,246856,303725907,246708,303705801,148,20106,240737,561,328144,33902,6,1893,130000.0,43333.0,-69.0,-62.0,-69.0,-69.0,-69.0,-62.0,-69.0,-69.0,-80.0,-85.0,-80.0,-87.0,11.0,23.0,11.0,18.0,1
2086,F8:59:71:5A:E0:3D,2286323,472372283,130296,198851901,2156027,273520382,337,93793,132027672,93691,132012605,102,15067,93400,33,130292,8822,337,72,144444.0,43333.0,-67.0,-74.0,-67.0,-70.0,-66.0,-73.0,-66.0,-69.0,-80.0,-85.0,-80.0,-87.0,13.0,11.0,13.0,17.0,1
2087,CC:2F:71:3E:C5:1F,2156134,273533145,107,12763,2156027,273520382,0,512,42673,432,33035,80,9638,117,1,184,7,0,27,144444.0,39000.0,-68.0,-61.0,-65.0,-59.0,-69.0,-66.0,-66.0,-59.0,-80.0,-85.0,-80.0,-87.0,12.0,24.0,15.0,28.0,1
2088,CC:2F:71:3F:1F:24,2484289,701634522,328262,428114140,2156027,273520382,6,247011,303927420,246863,303907314,148,20106,240892,561,328310,33902,6,1893,130000.0,43333.0,-71.0,-63.0,-71.0,-70.0,-70.0,-63.0,-70.0,-70.0,-80.0,-85.0,-80.0,-87.0,9.0,22.0,9.0,17.0,1
2089,F8:59:71:5A:E0:3D,2286535,472673164,130501,199151903,2156034,273521261,337,93887,132131734,93785,132116667,102,15067,93494,33,130497,8882,337,72,144444.0,43333.0,-67.0,-74.0,-67.0,-69.0,-66.0,-73.0,-66.0,-69.0,-80.0,-85.0,-80.0,-87.0,13.0,11.0,13.0,18.0,1
2090,CC:2F:71:3E:C5:1F,2156141,273534024,107,12763,2156034,273521261,0,512,42673,432,33035,80,9638,117,1,184,7,0,27,144444.0,39000.0,-68.0,-61.0,-65.0,-59.0,-69.0,-66.0,-66.0,-59.0,-80.0,-85.0,-80.0,-87.0,12.0,24.0,15.0,28.0,1
2091,CC:2F:71:3F:1F:24,2484454,701841471,328420,428320210,2156034,273521261,6,247156,304124726,247008,304104620,148,20106,241037,561,328468,33903,6,1893,144444.0,43333.0,-70.0,-62.0,-69.0,-70.0,-69.0,-62.0,-69.0,-70.0,-80.0,-85.0,-80.0,-87.0,10.0,23.0,11.0,17.0,1
2092,F8:59:71:5A:E0:3D,2286600,472769774,130563,199248251,2156037,273521523,337,93950,132228754,93848,132213687,102,15067,93557,33,130559,8882,337,72,144444.0,43333.0,-67.0,-74.0,-67.0,-70.0,-66.0,-73.0,-66.0,-69.0,-80.0,-85.0,-80.0,-87.0,13.0,11.0,13.0,17.0,1
2093,CC:2F:71:3E:C5:1F,2156144,273534286,107,12763,2156037,273521523,0,512,42673,432,33035,80,9638,117,1,184,7,0,27,144444.0,39000.0,-68.0,-61.0,-65.0,-59.0,-69.0,-66.0,-66.0,-59.0,-80.0,-85.0,-80.0,-87.0,12.0,24.0,15.0,28.0,1
2094,CC:2F:71:3F:1F:24,2484622,702048608,328585,428527085,2156037,273521523,6,247308,304320560,247160,304300454,148,20106,241189,561,328632,33910,6,1893,144444.0,43333.0,-70.0,-64.0,-70.0,-71.0,-69.0,-63.0,-69.0,-70.0,-80.0,-85.0,-80.0,-87.0,10.0,21.0,10.0,16.0,1
2095,F8:59:71:5A:E0:3D,2286668,472866894,130625,199344599,2156043,273522295,337,94012,132324234,93910,132309167,102,15067,93619,33,130621,8882,337,72,144444.0,43333.0,-67.0,-74.0,-67.0,-70.0,-66.0,-73.0,-66.0,-69.0,-80.0,-85.0,-80.0,-87.0,13.0,11.0,13.0,17.0,1
2096,CC:2F:71:3E:C5:1F,2156150,273535058,107,12763,2156043,273522295,0,512,42673,432,33035,80,9638,117,1,184,7,0,27,144444.0,39000.0,-68.0,-61.0,-65.0,-59.0,-69.0,-66.0,-66.0,-59.0,-80.0,-85.0,-80.0,-87.0,12.0,24.0,15.0,28.0,1
2097,CC:2F:71:3F:1F:24,2484787,702257114,328744,428734819,2156043,273522295,6,247451,304517644,247303,304497538,148,20106,241332,561,328792,33929,6,1893,130000.0,43333.0,-70.0,-63.0,-70.0,-71.0,-69.0,-62.0,-70.0,-70.0,-80.0,-85.0,-80.0,-87.0,10.0,22.0,10.0,16.0,1
2098,F8:59:71:5A:E0:3D,2286940,473265267,130886,199741902,2156054,273523365,337,94195,132570178,94093,132555111,102,15067,93802,33,130882,8897,337,75,144444.0,43333.0,-67.0,-73.0,-66.0,-70.0,-66.0,-73.0,-66.0,-69.0,-80.0,-86.0,-80.0,-87.0,13.0,13.0,14.0,17.0,1
2099,CC:2F:71:3E:C5:1F,2156161,273536128,107,12763,2156054,273523365,0,512,42673,432,33035,80,9638,117,1,184,7,0,27,144444.0,39000.0,-68.0,-61.0,-65.0,-59.0,-69.0,-66.0,-66.0,-59.0,-80.0,-86.0,-80.0,-87.0,12.0,25.0,15.0,28.0,1
2100,CC:2F:71:3F:1F:24,2485149,702761306,329095,429237941,2156054,273523365,6,247795,305016548,247647,304996442,148,20106,241676,561,329143,33937,6,1919,130000.0,43333.0,-70.0,-64.0,-67.0,-72.0,-69.0,-63.0,-69.0,-72.0,-80.0,-86.0,-80.0,-87.0,10.0,22.0,13.0,15.0,1
2101,F8:59:71:5A:E0:3D,2287171,473600266,131104,200075621,2156067,273524645,337,94405,132882804,94301,132867415,104,15389,94010,33,131099,8901,337,75,144444.0,43333.0,-66.0,-73.0,-66.0,-69.0,-66.0,-73.0,-66.0,-69.0,-80.0,-86.0,-80.0,-87.0,14.0,13.0,14.0,18.0,1
2102,CC:2F:71:3E:C5:1F,2156174,273537408,107,12763,2156067,273524645,0,512,42673,432,33035,80,9638,117,1,184,7,0,27,144444.0,39000.0,-68.0,-61.0,-65.0,-59.0,-69.0,-66.0,-66.0,-59.0,-80.0,-86.0,-80.0,-87.0,12.0,25.0,15.0,28.0,1
2103,CC:2F:71:3F:1F:24,2485602,703377109,329535,429852464,2156067,273524645,6,248223,305615161,248075,305595055,148,20106,242085,561,329583,33956,6,1945,144444.0,43333.0,-70.0,-62.0,-72.0,-72.0,-69.0,-62.0,-71.0,-72.0,-80.0,-86.0,-80.0,-87.0,10.0,24.0,8.0,15.0,1
2104,F8:59:71:5A:E0:3D,2287251,473714573,131180,200189524,2156071,273525049,337,94475,132986732,94371,132971343,104,15389,94080,33,131175,8902,337,75,144444.0,43333.0,-67.0,-74.0,-66.0,-70.0,-66.0,-73.0,-66.0,-69.0,-80.0,-86.0,-80.0,-87.0,13.0,12.0,14.0,17.0,1
2105,CC:2F:71:3E:C5:1F,2156178,273537812,107,12763,2156071,273525049,0,512,42673,432,33035,80,9638,117,1,184,7,0,27,144444.0,39000.0,-68.0,-61.0,-65.0,-59.0,-69.0,-66.0,-66.0,-59.0,-80.0,-86.0,-80.0,-87.0,12.0,25.0,15.0,28.0,1
2106,CC:2F:71:3F:1F:24,2485763,703583635,329692,430058586,2156071,273525049,6,248370,305815557,248222,305795451,148,20106,242232,561,329740,33970,6,1945,144444.0,43333.0,-70.0,-62.0,-72.0,-73.0,-69.0,-62.0,-72.0,-72.0,-80.0,-86.0,-80.0,-87.0,10.0,24.0,8.0,14.0,1
2107,F8:59:71:5A:E0:3D,2287320,473813195,131246,200287884,2156074,273525311,337,94542,133086112,94438,133070723,104,15389,94147,33,131241,8902,337,75,144444.0,43333.0,-66.0,-73.0,-67.0,-70.0,-66.0,-73.0,-66.0,-69.0,-80.0,-86.0,-80.0,-87.0,14.0,13.0,13.0,17.0,1
2108,CC:2F:71:3E:C5:1F,2156183,273538276,107,12763,2156076,273525513,0,512,42673,432,33035,80,9638,117,1,184,7,0,27,144444.0,39000.0,-68.0,-61.0,-65.0,-59.0,-69.0,-66.0,-66.0,-59.0,-80.0,-86.0,-80.0,-87.0,12.0,25.0,15.0,28.0,1
2109,CC:2F:71:3F:1F:24,2485957,703831118,329881,430305605,2156076,273525513,6,248544,306052552,248396,306032446,148,20106,242405,561,329929,33991,6,1954,144444.0,43333.0,-70.0,-62.0,-72.0,-73.0,-69.0,-62.0,-71.0,-72.0,-80.0,-86.0,-80.0,-87.0,10.0,24.0,8.0,14.0,1
2110,F8:59:71:5A:E0:3D,2287400,473928797,131320,200402880,2156080,273525917,337,94617,133201612,94513,133186223,104,15389,94222,33,131316,8902,337,75,144444.0,43333.0,-67.0,-73.0,-67.0,-70.0,-66.0,-73.0,-66.0,-69.0,-80.0,-86.0,-80.0,-87.0,13.0,13.0,13.0,17.0,1
2111,CC:2F:71:3E:C5:1F,2156187,273538680,107,12763,2156080,273525917,0,512,42673,432,33035,80,9638,117,1,184,7,0,27,144444.0,39000.0,-68.0,-61.0,-65.0,-59.0,-69.0,-66.0,-66.0,-59.0,-80.0,-86.0,-80.0,-87.0,12.0,25.0,15.0,28.0,1
2112,CC:2F:71:3F:1F:24,2486116,704034536,330036,430508619,2156080,273525917,6,248685,306246556,248537,306226450,148,20106,242546,561,330084,34007,6,1954,144444.0,43333.0,-70.0,-62.0,-72.0,-73.0,-69.0,-62.0,-71.0,-73.0,-80.0,-86.0,-80.0,-87.0,10.0,24.0,8.0,14.0,1
2113,F8:59:71:5A:E0:3D,2287465,474026901,131383,200500782,2156082,273526119,337,94679,133297092,94575,133281703,104,15389,94284,33,131379,8902,337,75,144444.0,43333.0,-67.0,-74.0,-67.0,-70.0,-67.0,-74.0,-66.0,-70.0,-80.0,-86.0,-80.0,-87.0,13.0,12.0,13.0,17.0,1
2114,CC:2F:71:3E:C5:1F,2156192,273539144,107,12763,2156085,273526381,0,512,42673,432,33035,80,9638,117,1,184,7,0,27,144444.0,39000.0,-68.0,-61.0,-65.0,-59.0,-69.0,-66.0,-66.0,-59.0,-80.0,-86.0,-80.0,-87.0,12.0,25.0,15.0,28.0,1
2115,CC:2F:71:3F:1F:24,2486277,704238144,330192,430711763,2156085,273526381,6,248827,306440676,248679,306420570,148,20106,242688,561,330239,34040,6,1954,144444.0,43333.0,-70.0,-63.0,-72.0,-73.0,-69.0,-62.0,-71.0,-72.0,-80.0,-86.0,-80.0,-87.0,10.0,23.0,8.0,14.0,1
2116,F8:59:71:5A:E0:3D,2287531,474122159,131444,200595576,2156087,273526583,337,94741,133392572,94637,133377183,104,15389,94346,33,131440,8902,337,75,144444.0,43333.0,-65.0,-73.0,-67.0,-69.0,-66.0,-73.0,-66.0,-69.0,-80.0,-86.0,-80.0,-87.0,15.0,13.0,13.0,18.0,1
2117,CC:2F:71:3E:C5:1F,2156194,273539346,107,12763,2156087,273526583,0,512,42673,432,33035,80,9638,117,1,184,7,0,27,144444.0,39000.0,-68.0,-61.0,-65.0,-59.0,-69.0,-66.0,-66.0,-59.0,-80.0,-86.0,-80.0,-87.0,12.0,25.0,15.0,28.0,1
2118,CC:2F:71:3F:1F:24,2486447,704450367,330358,430923582,2156089,273526785,6,248974,306641265,248826,306621159,148,20106,242835,561,330406,34058,6,1954,144444.0,43333.0,-70.0,-62.0,-72.0,-72.0,-69.0,-62.0,-71.0,-72.0,-80.0,-86.0,-80.0,-87.0,10.0,24.0,8.0,15.0,1
2119,F8:59:71:5A:E0:3D,2287816,474559551,131725,201032564,2156091,273526987,337,94852,133500364,94748,133484975,104,15389,94457,33,131721,8905,337,75,144444.0,43333.0,-67.0,-74.0,-66.0,-70.0,-66.0,-74.0,-66.0,-69.0,-80.0,-86.0,-80.0,-87.0,13.0,12.0,14.0,17.0,1
2120,CC:2F:71:3E:C5:1F,2156200,273539928,108,12879,2156092,273527049,0,517,43071,436,33315,81,9756,118,1,186,7,0,27,144444.0,39000.0,-71.0,-69.0,-66.0,-60.0,-71.0,-69.0,-67.0,-61.0,-80.0,-86.0,-80.0,-87.0,9.0,17.0,14.0,27.0,1
2121,CC:2F:71:3F:1F:24,2486616,704659051,330524,431132002,2156092,273527049,6,249124,306839657,248976,306819551,148,20106,242985,561,330572,34078,6,1954,144444.0,43333.0,-70.0,-62.0,-72.0,-73.0,-69.0,-62.0,-71.0,-72.0,-80.0,-86.0,-80.0,-87.0,10.0,24.0,8.0,14.0,1
2122,F8:59:71:5A:E0:3D,2288006,474840880,131906,201312738,2156100,273528142,337,94933,133605568,94829,133590179,104,15389,94538,33,131902,8905,337,75,144444.0,43333.0,-67.0,-74.0,-67.0,-69.0,-66.0,-73.0,-66.0,-69.0,-80.0,-86.0,-80.0,-87.0,13.0,12.0,13.0,18.0,1
2123,CC:2F:71:3E:C5:1F,2156208,273541021,108,12879,2156100,273528142,0,518,43141,437,33385,81,9756,118,1,186,7,0,27,144444.0,39000.0,-68.0,-62.0,-65.0,-60.0,-70.0,-69.0,-67.0,-61.0,-80.0,-86.0,-80.0,-87.0,12.0,24.0,15.0,27.0,1
2124,CC:2F:71:3F:1F:24,2486804,704899288,330704,431371146,2156100,273528142,6,249293,307068793,249143,307048219,150,20574,243154,561,330751,34123,6,1958,144444.0,43333.0,-69.0,-62.0,-71.0,-72.0,-68.0,-61.0,-70.0,-72.0,-80.0,-86.0,-80.0,-87.0,11.0,24.0,9.0,15.0,1
2125,F8:59:71:5A:E0:3D,2288083,474954670,131979,201426124,2156104,273528546,337,95007,133716588,94903,133701199,104,15389,94610,33,131975,8905,337,75,144444.0,39000.0,-67.0,-74.0,-67.0,-69.0,-66.0,-74.0,-66.0,-69.0,-80.0,-86.0,-80.0,-87.0,13.0,12.0,13.0,18.0,1
2126,CC:2F:71:3E:C5:1F,2156212,273541425,108,12879,2156104,273528546,0,518,43141,437,33385,81,9756,118,1,186,7,0,27,144444.0,39000.0,-68.0,-62.0,-65.0,-60.0,-70.0,-69.0,-67.0,-61.0,-80.0,-86.0,-80.0,-87.0,12.0,24.0,15.0,27.0,1
2127,CC:2F:71:3F:1F:24,2486967,705107626,330863,431579080,2156104,273528546,6,249440,307267777,249290,307247203,150,20574,243301,561,330911,34146,6,1958,144444.0,43333.0,-69.0,-62.0,-71.0,-72.0,-69.0,-62.0,-70.0,-72.0,-80.0,-86.0,-80.0,-87.0,11.0,24.0,9.0,15.0,1
2128,F8:59:71:5A:E0:3D,2288149,475051310,132041,201522360,2156108,273528950,337,95069,133812068,94965,133796679,104,15389,94672,33,132037,8905,337,75,144444.0,43333.0,-66.0,-73.0,-66.0,-70.0,-66.0,-73.0,-66.0,-69.0,-80.0,-86.0,-80.0,-87.0,14.0,13.0,14.0,17.0,1
2129,CC:2F:71:3E:C5:1F,2156216,273541829,108,12879,2156108,273528950,0,518,43141,437,33385,81,9756,118,1,186,7,0,27,144444.0,39000.0,-68.0,-62.0,-65.0,-60.0,-70.0,-69.0,-67.0,-61.0,-80.0,-86.0,-80.0,-87.0,12.0,24.0,15.0,27.0,1
2130,CC:2F:71:3F:1F:24,2487126,705311044,331018,431782094,2156108,273528950,6,249581,307461781,249431,307441207,150,20574,243442,561,331065,34160,6,1958,144444.0,43333.0,-69.0,-62.0,-71.0,-72.0,-69.0,-62.0,-70.0,-72.0,-80.0,-86.0,-80.0,-87.0,11.0,24.0,9.0,15.0,1
2131,F8:59:71:5A:E0:3D,2288216,475148122,132103,201618708,2156113,273529414,337,95132,133906148,95028,133890759,104,15389,94733,33,132098,8905,337,75,144444.0,43333.0,-67.0,-74.0,-66.0,-70.0,-66.0,-73.0,-66.0,-69.0,-80.0,-86.0,-80.0,-87.0,13.0,12.0,14.0,17.0,1
2132,CC:2F:71:3E:C5:1F,2156221,273542293,108,12879,2156113,273529414,0,518,43141,437,33385,81,9756,118,1,186,7,0,27,144444.0,39000.0,-68.0,-62.0,-65.0,-60.0,-70.0,-69.0,-67.0,-61.0,-80.0,-86.0,-80.0,-87.0,12.0,24.0,15.0,27.0,1
2133,CC:2F:71:3F:1F:24,2487292,705515015,331179,431985601,2156113,273529414,6,249730,307655781,249580,307635207,150,20574,243591,561,331227,34177,6,1958,144444.0,43333.0,-69.0,-62.0,-71.0,-72.0,-69.0,-62.0,-71.0,-72.0,-80.0,-86.0,-80.0,-87.0,11.0,24.0,9.0,15.0,1
2134,F8:59:71:5A:E0:3D,2288292,475247027,132177,201717411,2156115,273529616,337,95211,134006692,95107,133991303,104,15389,94812,33,132173,8906,337,75,144444.0,43333.0,-67.0,-74.0,-67.0,-70.0,-66.0,-73.0,-66.0,-70.0,-80.0,-86.0,-80.0,-87.0,13.0,12.0,13.0,17.0,1
2135,CC:2F:71:3E:C5:1F,2156223,273542495,108,12879,2156115,273529616,0,518,43141,437,33385,81,9756,118,1,186,7,0,27,144444.0,39000.0,-68.0,-62.0,-65.0,-60.0,-70.0,-69.0,-67.0,-61.0,-80.0,-86.0,-80.0,-87.0,12.0,24.0,15.0,27.0,1
2136,CC:2F:71:3F:1F:24,2487452,705718563,331335,432188745,2156117,273529818,6,249871,307849785,249721,307829211,150,20574,243732,561,331383,34192,6,1958,144444.0,43333.0,-69.0,-62.0,-71.0,-72.0,-69.0,-62.0,-71.0,-72.0,-80.0,-86.0,-80.0,-87.0,11.0,24.0,9.0,15.0,1
2137,F8:59:71:5A:E0:3D,2288356,475343577,132239,201813759,2156117,273529818,337,95274,134103726,95170,134088337,104,15389,94874,33,132235,8906,337,75,144444.0,43333.0,-66.0,-74.0,-66.0,-70.0,-66.0,-73.0,-66.0,-69.0,-80.0,-86.0,-80.0,-87.0,14.0,12.0,14.0,17.0,1
2138,CC:2F:71:3E:C5:1F,2156225,273542697,108,12879,2156117,273529818,0,518,43141,437,33385,81,9756,118,1,186,7,0,27,144444.0,39000.0,-68.0,-62.0,-65.0,-60.0,-70.0,-69.0,-67.0,-61.0,-80.0,-86.0,-80.0,-87.0,12.0,24.0,15.0,27.0,1
2139,CC:2F:71:3F:1F:24,2487613,705925089,331492,432394867,2156121,273530222,6,250013,308045329,249863,308024755,150,20574,243874,561,331540,34209,6,1958,144444.0,43333.0,-69.0,-62.0,-72.0,-72.0,-69.0,-62.0,-71.0,-72.0,-80.0,-86.0,-80.0,-87.0,11.0,24.0,8.0,15.0,1
2140,F8:59:71:5A:E0:3D,2288470,475492199,132345,201961653,2156125,273530546,337,95350,134208495,95246,134193106,104,15389,94950,33,132341,8906,337,75,144444.0,43333.0,-67.0,-74.0,-66.0,-70.0,-66.0,-73.0,-66.0,-69.0,-80.0,-86.0,-80.0,-87.0,13.0,12.0,14.0,17.0,1
2141,CC:2F:71:3E:C5:1F,2156233,273543425,108,12879,2156125,273530546,0,518,43141,437,33385,81,9756,118,1,186,7,0,27,144444.0,39000.0,-68.0,-62.0,-65.0,-60.0,-70.0,-69.0,-67.0,-61.0,-80.0,-86.0,-80.0,-87.0,12.0,24.0,15.0,27.0,1
2142,CC:2F:71:3F:1F:24,2487775,706131665,331650,432601119,2156125,273530546,6,250157,308242531,250006,308221839,151,20692,244018,561,331697,34223,6,1958,144444.0,43333.0,-69.0,-62.0,-71.0,-72.0,-69.0,-62.0,-71.0,-72.0,-80.0,-86.0,-80.0,-87.0,11.0,24.0,9.0,15.0,1
2143,F8:59:71:5A:E0:3D,2288543,475591988,132416,202061240,2156127,273530748,337,95418,134308118,95314,134292729,104,15389,95018,33,132412,8908,337,75,144444.0,43333.0,-67.0,-74.0,-67.0,-70.0,-66.0,-73.0,-66.0,-69.0,-80.0,-86.0,-80.0,-87.0,13.0,12.0,13.0,17.0,1
2144,CC:2F:71:3E:C5:1F,2156235,273543627,108,12879,2156127,273530748,0,518,43141,437,33385,81,9756,118,1,186,7,0,27,144444.0,39000.0,-68.0,-62.0,-65.0,-60.0,-70.0,-69.0,-67.0,-61.0,-80.0,-86.0,-80.0,-87.0,12.0,24.0,15.0,27.0,1
2145,CC:2F:71:3F:1F:24,2487932,706332172,331805,432801424,2156127,273530748,6,250298,308435119,250147,308414427,151,20692,244159,561,331853,34246,6,1958,144444.0,43333.0,-69.0,-62.0,-72.0,-73.0,-69.0,-62.0,-71.0,-73.0,-80.0,-86.0,-80.0,-87.0,11.0,24.0,8.0,14.0,1
2146,F8:59:71:5A:E0:3D,2288743,475889108,132610,202357754,2156133,273531354,337,95513,134415602,95409,134400213,104,15389,95113,33,132606,8943,337,75,144444.0,43333.0,-67.0,-73.0,-66.0,-70.0,-66.0,-73.0,-66.0,-69.0,-80.0,-86.0,-80.0,-87.0,13.0,13.0,14.0,17.0,1
2147,CC:2F:71:3E:C5:1F,2156241,273544233,108,12879,2156133,273531354,0,518,43141,437,33385,81,9756,118,1,186,7,0,27,144444.0,39000.0,-68.0,-62.0,-65.0,-60.0,-70.0,-69.0,-67.0,-61.0,-80.0,-86.0,-80.0,-87.0,12.0,24.0,15.0,27.0,1
2148,CC:2F:71:3F:1F:24,2488102,706542371,331969,433011017,2156133,273531354,6,250449,308633622,250298,308612930,151,20692,244310,561,332017,34274,6,1958,144444.0,43333.0,-69.0,-62.0,-71.0,-72.0,-69.0,-62.0,-70.0,-72.0,-80.0,-86.0,-80.0,-87.0,11.0,24.0,9.0,15.0,1
2149,F8:59:71:5A:E0:3D,2288811,475987532,132675,202455916,2156136,273531616,337,95581,134514689,95477,134499300,104,15389,95181,33,132671,8944,337,75,144444.0,43333.0,-67.0,-74.0,-67.0,-70.0,-66.0,-73.0,-66.0,-69.0,-80.0,-86.0,-80.0,-87.0,13.0,12.0,13.0,17.0,1
2150,CC:2F:71:3E:C5:1F,2156244,273544495,108,12879,2156136,273531616,0,518,43141,437,33385,81,9756,118,1,186,7,0,27,144444.0,39000.0,-68.0,-62.0,-65.0,-60.0,-70.0,-69.0,-67.0,-61.0,-80.0,-86.0,-80.0,-87.0,12.0,24.0,15.0,27.0,1
2151,CC:2F:71:3F:1F:24,2488277,706770641,332141,433239025,2156136,273531616,6,250606,308852448,250455,308831756,151,20692,244467,561,332189,34298,6,1962,144444.0,43333.0,-69.0,-62.0,-71.0,-73.0,-69.0,-62.0,-71.0,-72.0,-80.0,-86.0,-80.0,-87.0,11.0,24.0,9.0,14.0,1
2152,F8:59:71:5A:E0:3D,2288898,476101040,132756,202568818,2156142,273532222,337,95662,134626421,95558,134611032,104,15389,95261,33,132752,8944,337,75,144444.0,43333.0,-67.0,-74.0,-66.0,-70.0,-67.0,-74.0,-66.0,-69.0,-80.0,-86.0,-80.0,-87.0,13.0,12.0,14.0,17.0,1
2153,CC:2F:71:3E:C5:1F,2156250,273545101,108,12879,2156142,273532222,0,518,43141,437,33385,81,9756,118,1,186,7,0,27,144444.0,39000.0,-68.0,-62.0,-65.0,-60.0,-70.0,-69.0,-67.0,-61.0,-80.0,-86.0,-80.0,-87.0,12.0,24.0,15.0,27.0,1
2154,CC:2F:71:3F:1F:24,2488446,706983845,332304,433451623,2156142,273532222,6,250758,309057915,250607,309037223,151,20692,244617,561,332352,34332,6,1962,144444.0,43333.0,-69.0,-62.0,-71.0,-72.0,-69.0,-61.0,-70.0,-72.0,-80.0,-86.0,-80.0,-87.0,11.0,24.0,9.0,15.0,1
2155,F8:59:71:5A:E0:3D,2288963,476197652,132818,202665166,2156145,273532486,337,95726,134723643,95621,134708136,105,15507,95324,33,132814,8944,337,75,144444.0,43333.0,-67.0,-74.0,-66.0,-70.0,-66.0,-73.0,-66.0,-69.0,-80.0,-86.0,-80.0,-87.0,13.0,12.0,14.0,17.0,1
2156,CC:2F:71:3E:C5:1F,2156253,273545365,108,12879,2156145,273532486,0,518,43141,437,33385,81,9756,118,1,186,7,0,27,144444.0,39000.0,-68.0,-62.0,-65.0,-60.0,-70.0,-69.0,-67.0,-61.0,-80.0,-86.0,-80.0,-87.0,12.0,24.0,15.0,27.0,1
2157,CC:2F:71:3F:1F:24,2488604,707185699,332459,433653213,2156145,273532486,6,250896,309248723,250745,309228031,151,20692,244755,561,332507,34348,6,1962,144444.0,43333.0,-69.0,-62.0,-71.0,-73.0,-69.0,-62.0,-71.0,-72.0,-80.0,-86.0,-80.0,-87.0,11.0,24.0,9.0,14.0,1
2158,F8:59:71:5A:E0:3D,2289032,476294666,132880,202761514,2156152,273533152,337,95789,134820677,95684,134805170,105,15507,95386,33,132876,8944,337,75,144444.0,43333.0,-67.0,-74.0,-67.0,-70.0,-66.0,-73.0,-66.0,-69.0,-80.0,-86.0,-80.0,-87.0,13.0,12.0,13.0,17.0,1
2159,CC:2F:71:3E:C5:1F,2156260,273546031,108,12879,2156152,273533152,0,518,43141,437,33385,81,9756,118,1,186,7,0,27,144444.0,39000.0,-68.0,-62.0,-65.0,-60.0,-70.0,-69.0,-67.0,-61.0,-80.0,-86.0,-80.0,-87.0,12.0,24.0,15.0,27.0,1
2160,CC:2F:71:3F:1F:24,2488780,707399777,332628,433866625,2156152,273533152,6,251050,309450435,250899,309429743,151,20692,244909,561,332676,34364,6,1962,144444.0,43333.0,-69.0,-62.0,-71.0,-72.0,-69.0,-62.0,-70.0,-72.0,-80.0,-86.0,-80.0,-87.0,11.0,24.0,9.0,15.0,1
2161,F8:59:71:5A:E0:3D,2289306,476718707,133152,203185353,2156154,273533354,337,95899,134928061,95794,134912554,105,15507,95496,33,133148,8944,337,75,144444.0,43333.0,-66.0,-73.0,-66.0,-70.0,-66.0,-73.0,-66.0,-70.0,-80.0,-86.0,-80.0,-87.0,14.0,13.0,14.0,17.0,1
2162,CC:2F:71:3E:C5:1F,2156262,273546233,108,12879,2156154,273533354,0,518,43141,437,33385,81,9756,118,1,186,7,0,27,144444.0,39000.0,-68.0,-62.0,-65.0,-60.0,-70.0,-69.0,-67.0,-61.0,-80.0,-86.0,-80.0,-87.0,12.0,24.0,15.0,27.0,1
2163,CC:2F:71:3F:1F:24,2488937,707602993,332783,434069639,2156154,273533354,6,251191,309644439,251040,309623747,151,20692,245050,561,332831,34372,6,1962,144444.0,43333.0,-69.0,-62.0,-70.0,-73.0,-69.0,-61.0,-71.0,-72.0,-80.0,-86.0,-80.0,-87.0,11.0,24.0,10.0,14.0,1
2164,F8:59:71:5A:E0:3D,2289499,477011286,133340,203477255,2156159,273534031,337,95976,135029953,95871,135014446,105,15507,95573,33,133336,8978,337,75,144444.0,43333.0,-66.0,-74.0,-66.0,-70.0,-67.0,-73.0,-66.0,-69.0,-80.0,-86.0,-80.0,-87.0,14.0,12.0,14.0,17.0,1
2165,CC:2F:71:3E:C5:1F,2156268,273546970,108,12879,2156160,273534091,0,518,43141,437,33385,81,9756,118,1,186,7,0,27,144444.0,39000.0,-68.0,-62.0,-65.0,-60.0,-70.0,-69.0,-67.0,-61.0,-80.0,-86.0,-80.0,-87.0,12.0,24.0,15.0,27.0,1
2166,CC:2F:71:3F:1F:24,2489116,707813923,332954,434279630,2156162,273534293,6,251348,309846678,251197,309825986,151,20692,245207,561,333002,34381,6,1962,144444.0,43333.0,-69.0,-62.0,-71.0,-72.0,-68.0,-62.0,-70.0,-72.0,-80.0,-86.0,-80.0,-87.0,11.0,24.0,9.0,15.0,1
2167,F8:59:71:5A:E0:3D,2289569,477108683,133407,203574390,2156162,273534293,337,96041,135126563,95936,135111056,105,15507,95638,33,133403,8979,337,75,144444.0,43333.0,-67.0,-73.0,-66.0,-70.0,-66.0,-73.0,-66.0,-69.0,-80.0,-86.0,-80.0,-87.0,13.0,13.0,14.0,17.0,1
2168,CC:2F:71:3E:C5:1F,2156270,273547172,108,12879,2156162,273534293,0,518,43141,437,33385,81,9756,118,1,186,7,0,27,144444.0,39000.0,-68.0,-62.0,-65.0,-60.0,-70.0,-69.0,-67.0,-61.0,-80.0,-86.0,-80.0,-87.0,12.0,24.0,15.0,27.0,1
2169,CC:2F:71:3F:1F:24,2489274,708017213,333110,434482718,2156164,273534495,6,251489,310040682,251338,310019990,151,20692,245348,561,333158,34390,6,1962,130000.0,39000.0,-69.0,-62.0,-71.0,-72.0,-68.0,-62.0,-70.0,-72.0,-80.0,-86.0,-80.0,-87.0,11.0,24.0,9.0,15.0,1
2170,F8:59:71:5A:E0:3D,2289632,477203679,133468,203669184,2156164,273534495,337,96102,135220503,95997,135204996,105,15507,95699,33,133464,8979,337,75,144444.0,43333.0,-66.0,-73.0,-67.0,-69.0,-66.0,-73.0,-66.0,-69.0,-80.0,-86.0,-80.0,-87.0,14.0,13.0,13.0,18.0,1
2171,CC:2F:71:3E:C5:1F,2156274,273547576,108,12879,2156166,273534697,0,518,43141,437,33385,81,9756,118,1,186,7,0,27,144444.0,39000.0,-68.0,-62.0,-65.0,-60.0,-70.0,-69.0,-67.0,-61.0,-80.0,-86.0,-80.0,-87.0,12.0,24.0,15.0,27.0,1
2172,CC:2F:71:3F:1F:24,2489441,708225602,333275,434690905,2156166,273534697,6,251637,310235989,251486,310215297,151,20692,245496,561,333323,34399,6,1962,144444.0,43333.0,-69.0,-62.0,-71.0,-72.0,-69.0,-62.0,-71.0,-72.0,-80.0,-86.0,-80.0,-87.0,11.0,24.0,9.0,15.0,1
2173,F8:59:71:5A:E0:3D,2289701,477302187,133531,203767086,2156170,273535101,337,96165,135317523,96060,135302016,105,15507,95762,33,133527,8979,337,75,144444.0,43333.0,-67.0,-74.0,-66.0,-70.0,-67.0,-74.0,-66.0,-70.0,-80.0,-86.0,-80.0,-87.0,13.0,12.0,14.0,17.0,1
2174,CC:2F:71:3E:C5:1F,2156279,273548040,108,12879,2156171,273535161,0,518,43141,437,33385,81,9756,118,1,186,7,0,27,144444.0,39000.0,-68.0,-62.0,-65.0,-60.0,-70.0,-69.0,-67.0,-61.0,-80.0,-86.0,-80.0,-87.0,12.0,24.0,15.0,27.0,1
2175,CC:2F:71:3F:1F:24,2489600,708426102,333429,434890941,2156171,273535161,6,251777,310429877,251626,310409185,151,20692,245636,561,333477,34405,6,1962,144444.0,43333.0,-69.0,-62.0,-71.0,-72.0,-69.0,-62.0,-71.0,-72.0,-80.0,-86.0,-80.0,-87.0,11.0,24.0,9.0,15.0,1
2176,F8:59:71:5A:E0:3D,2289766,477398797,133593,203863434,2156173,273535363,337,96227,135413003,96122,135397496,105,15507,95824,33,133589,8979,337,75,144444.0,43333.0,-67.0,-74.0,-66.0,-70.0,-66.0,-73.0,-66.0,-69.0,-80.0,-86.0,-80.0,-87.0,13.0,12.0,14.0,17.0,1
2177,CC:2F:71:3E:C5:1F,2156281,273548242,108,12879,2156173,273535363,0,518,43141,437,33385,81,9756,118,1,186,7,0,27,144444.0,39000.0,-68.0,-62.0,-65.0,-60.0,-70.0,-69.0,-67.0,-61.0,-80.0,-86.0,-80.0,-87.0,12.0,24.0,15.0,27.0,1
2178,CC:2F:71:3F:1F:24,2489761,708631262,333588,435095899,2156173,273535363,6,251922,310624408,251771,310603716,151,20692,245781,561,333636,34422,6,1962,144444.0,43333.0,-69.0,-62.0,-71.0,-73.0,-70.0,-64.0,-72.0,-73.0,-80.0,-86.0,-80.0,-87.0,11.0,24.0,9.0,14.0,1
2179,F8:59:71:5A:E0:3D,2289834,477495751,133655,203959782,2156179,273535969,337,96290,135510037,96185,135494530,105,15507,95886,33,133651,8979,337,75,144444.0,43333.0,-65.0,-73.0,-67.0,-70.0,-66.0,-73.0,-66.0,-70.0,-80.0,-86.0,-80.0,-87.0,15.0,13.0,13.0,17.0,1
2180,CC:2F:71:3E:C5:1F,2156287,273548848,108,12879,2156179,273535969,0,518,43141,437,33385,81,9756,118,1,186,7,0,27,144444.0,39000.0,-68.0,-62.0,-65.0,-60.0,-70.0,-69.0,-67.0,-61.0,-80.0,-86.0,-80.0,-87.0,12.0,24.0,15.0,27.0,1
2181,CC:2F:71:3F:1F:24,2489949,708855920,333770,435319951,2156179,273535969,6,252089,310842544,251938,310821852,151,20692,245948,561,333818,34430,6,1962,144444.0,43333.0,-69.0,-62.0,-72.0,-73.0,-69.0,-62.0,-71.0,-72.0,-80.0,-86.0,-80.0,-87.0,11.0,24.0,8.0,14.0,1
2182,F8:59:71:5A:E0:3D,2290163,477963901,133966,204426196,2156197,273537705,337,96585,135919733,96480,135904226,105,15507,96178,33,133962,8980,337,76,144444.0,43333.0,-67.0,-74.0,-66.0,-70.0,-66.0,-73.0,-66.0,-69.0,-80.0,-86.0,-80.0,-87.0,13.0,12.0,14.0,17.0,1
2183,CC:2F:71:3E:C5:1F,2156316,273551654,108,12879,2156208,273538775,0,518,43141,437,33385,81,9756,118,1,186,7,0,27,144444.0,39000.0,-68.0,-62.0,-65.0,-60.0,-70.0,-69.0,-67.0,-61.0,-80.0,-84.0,-80.0,-86.0,12.0,22.0,15.0,26.0,1
2184,CC:2F:71:3F:1F:24,2491687,711236756,335458,437695602,2156229,273541154,6,253711,313102134,253560,313081442,151,20692,247386,561,335500,34669,6,2096,144444.0,43333.0,-68.0,-63.0,-70.0,-73.0,-69.0,-66.0,-70.0,-74.0,-80.0,-84.0,-80.0,-86.0,12.0,21.0,10.0,13.0,1
2185,F8:59:71:5A:E0:3D,2291311,479657985,135066,206115297,2156245,273542688,337,97431,137116884,97325,137101259,106,15625,97017,35,135064,9016,337,77,130000.0,43333.0,-67.0,-74.0,-66.0,-70.0,-66.0,-73.0,-66.0,-69.0,-79.0,-83.0,-80.0,-86.0,12.0,9.0,14.0,16.0,1
2186,CC:2F:71:3E:C5:1F,2156354,273555683,109,12995,2156245,273542688,0,522,43421,441,33665,81,9756,118,1,188,7,0,27,144444.0,39000.0,-71.0,-69.0,-67.0,-60.0,-70.0,-69.0,-67.0,-61.0,-79.0,-83.0,-80.0,-86.0,8.0,14.0,13.0,26.0,1
2187,CC:2F:71:3F:1F:24,2492280,712070358,336033,438527468,2156247,273542890,6,254343,314045760,254192,314025068,151,20692,247956,562,336081,34739,6,2149,144444.0,43333.0,-69.0,-62.0,-71.0,-72.0,-69.0,-64.0,-71.0,-74.0,-79.0,-83.0,-80.0,-86.0,10.0,21.0,9.0,14.0,1
2188,F8:59:71:5A:E0:3D,2291468,479890520,135216,206347164,2156252,273543356,337,97520,137225936,97414,137210311,106,15625,97106,35,135214,9017,337,77,130000.0,43333.0,-67.0,-74.0,-66.0,-70.0,-66.0,-73.0,-66.0,-70.0,-79.0,-83.0,-80.0,-86.0,12.0,9.0,14.0,16.0,1
2189,CC:2F:71:3E:C5:1F,2156363,273556553,109,12995,2156254,273543558,0,524,43609,442,33735,82,9874,119,1,188,7,0,27,144444.0,39000.0,-70.0,-69.0,-67.0,-60.0,-70.0,-67.0,-66.0,-60.0,-79.0,-83.0,-80.0,-86.0,9.0,14.0,13.0,26.0,1
2190,CC:2F:71:3F:1F:24,2492464,712288855,336209,438745235,2156255,273543620,6,254506,314255819,254354,314235009,152,20810,248119,562,336259,34743,6,2150,144444.0,43333.0,-69.0,-62.0,-71.0,-74.0,-68.0,-62.0,-70.0,-73.0,-79.0,-83.0,-80.0,-86.0,10.0,21.0,9.0,12.0,1
2191,F8:59:71:5A:E0:3D,2291541,479993813,135286,206450193,2156255,273543620,337,97591,137329970,97485,137314345,106,15625,97177,35,135284,9017,337,77,144444.0,39000.0,-66.0,-74.0,-66.0,-70.0,-66.0,-73.0,-66.0,-70.0,-79.0,-83.0,-80.0,-86.0,13.0,9.0,14.0,16.0,1
2192,CC:2F:71:3E:C5:1F,2156365,273556675,109,12995,2156256,273543680,0,524,43609,442,33735,82,9874,119,1,188,7,0,27,144444.0,39000.0,-70.0,-69.0,-67.0,-60.0,-70.0,-67.0,-66.0,-60.0,-79.0,-83.0,-80.0,-86.0,9.0,14.0,13.0,26.0,1
2193,CC:2F:71:3F:1F:24,2492641,712500390,336385,438956710,2156256,273543680,6,254666,314457667,254514,314436857,152,20810,248279,562,336435,34747,6,2150,144444.0,43333.0,-70.0,-62.0,-72.0,-74.0,-69.0,-62.0,-72.0,-74.0,-79.0,-83.0,-80.0,-86.0,9.0,21.0,8.0,12.0,1
2194,F8:59:71:5A:E0:3D,2291607,480089015,135347,206544931,2156260,273544084,337,97652,137423910,97546,137408285,106,15625,97238,35,135345,9017,337,77,144444.0,43333.0,-67.0,-74.0,-67.0,-70.0,-67.0,-74.0,-66.0,-69.0,-79.0,-83.0,-80.0,-86.0,12.0,9.0,13.0,16.0,1
2195,CC:2F:71:3E:C5:1F,2156371,273557281,109,12995,2156262,273544286,0,524,43609,442,33735,82,9874,119,1,188,7,0,27,144444.0,39000.0,-70.0,-69.0,-67.0,-60.0,-70.0,-67.0,-66.0,-60.0,-79.0,-83.0,-80.0,-86.0,9.0,14.0,13.0,26.0,1
2196,CC:2F:71:3F:1F:24,2492805,712704400,336543,439160114,2156262,273544286,6,254811,314653636,254659,314632826,152,20810,248423,562,336593,34759,6,2150,144444.0,43333.0,-69.0,-62.0,-72.0,-74.0,-69.0,-62.0,-72.0,-74.0,-79.0,-83.0,-80.0,-86.0,10.0,21.0,8.0,12.0,1
2197,F8:59:71:5A:E0:3D,2291677,480187779,135413,206643291,2156264,273544488,337,97720,137524872,97614,137509247,106,15625,97306,35,135411,9017,337,77,144444.0,43333.0,-66.0,-73.0,-65.0,-69.0,-66.0,-73.0,-66.0,-69.0,-79.0,-83.0,-80.0,-86.0,13.0,10.0,15.0,17.0,1
2198,CC:2F:71:3E:C5:1F,2156373,273557483,109,12995,2156264,273544488,0,524,43609,442,33735,82,9874,119,1,188,7,0,27,144444.0,39000.0,-70.0,-69.0,-67.0,-60.0,-70.0,-67.0,-66.0,-60.0,-79.0,-83.0,-80.0,-86.0,9.0,14.0,13.0,26.0,1
2199,CC:2F:71:3F:1F:24,2492965,712910854,336701,439366366,2156264,273544488,6,254952,314847738,254800,314826928,152,20810,248564,562,336751,34765,6,2152,144444.0,43333.0,-69.0,-62.0,-72.0,-74.0,-69.0,-62.0,-71.0,-73.0,-79.0,-83.0,-80.0,-86.0,10.0,21.0,8.0,12.0,1
2200,F8:59:71:5A:E0:3D,2291743,480285943,135476,206741193,2156267,273544750,337,97783,137621906,97677,137606281,106,15625,97368,35,135474,9017,337,77,144444.0,43333.0,-66.0,-74.0,-66.0,-69.0,-66.0,-73.0,-66.0,-69.0,-79.0,-84.0,-80.0,-87.0,13.0,10.0,14.0,18.0,1
2201,CC:2F:71:3E:C5:1F,2156376,273557745,109,12995,2156267,273544750,0,524,43609,442,33735,82,9874,119,1,188,7,0,27,144444.0,39000.0,-70.0,-69.0,-67.0,-60.0,-70.0,-67.0,-66.0,-60.0,-79.0,-84.0,-80.0,-87.0,9.0,15.0,13.0,27.0,1
2202,CC:2F:71:3F:1F:24,2493123,713112648,336854,439567696,2156269,273544952,6,255093,315041742,254941,315020932,152,20810,248705,562,336904,34775,6,2152,144444.0,43333.0,-69.0,-62.0,-71.0,-74.0,-69.0,-62.0,-71.0,-74.0,-79.0,-84.0,-80.0,-87.0,10.0,22.0,9.0,13.0,1
2203,F8:59:71:5A:E0:3D,2291817,480390783,135544,206845427,2156273,273545356,337,97851,137725192,97745,137709567,106,15625,97436,35,135542,9017,337,77,144444.0,43333.0,-67.0,-74.0,-65.0,-69.0,-66.0,-73.0,-66.0,-69.0,-79.0,-84.0,-80.0,-87.0,12.0,10.0,15.0,18.0,1
2204,CC:2F:71:3E:C5:1F,2156382,273558351,109,12995,2156273,273545356,0,524,43609,442,33735,82,9874,119,1,188,7,0,27,144444.0,39000.0,-70.0,-69.0,-67.0,-60.0,-70.0,-67.0,-66.0,-60.0,-79.0,-84.0,-80.0,-87.0,9.0,15.0,13.0,27.0,1
2205,CC:2F:71:3F:1F:24,2493297,713333666,337024,439788310,2156273,273545356,6,255252,315254975,255100,315234165,152,20810,248864,562,337074,34790,6,2153,144444.0,43333.0,-69.0,-62.0,-72.0,-74.0,-69.0,-61.0,-71.0,-73.0,-79.0,-84.0,-80.0,-87.0,10.0,22.0,8.0,13.0,1
2206,F8:59:71:5A:E0:3D,2291881,480487333,135606,206941775,2156275,273545558,337,97913,137820672,97807,137805047,106,15625,97498,35,135604,9018,337,77,144444.0,43333.0,-67.0,-74.0,-66.0,-70.0,-66.0,-73.0,-66.0,-70.0,-79.0,-84.0,-80.0,-87.0,12.0,10.0,14.0,17.0,1
2207,CC:2F:71:3E:C5:1F,2156384,273558553,109,12995,2156275,273545558,0,524,43609,442,33735,82,9874,119,1,188,7,0,27,144444.0,39000.0,-70.0,-69.0,-67.0,-60.0,-70.0,-67.0,-66.0,-60.0,-79.0,-84.0,-80.0,-87.0,9.0,15.0,13.0,27.0,1
2208,CC:2F:71:3F:1F:24,2493461,713538929,337186,439993371,2156275,273545558,6,255400,315447449,255248,315426639,152,20810,249011,562,337236,34794,6,2153,144444.0,43333.0,-70.0,-62.0,-72.0,-75.0,-69.0,-62.0,-71.0,-74.0,-79.0,-84.0,-80.0,-87.0,9.0,22.0,8.0,12.0,1
2209,F8:59:71:5A:E0:3D,2291950,480583066,135667,207036569,2156283,273546497,337,97975,137916194,97869,137900569,106,15625,97560,35,135665,9018,337,77,144444.0,43333.0,-67.0,-74.0,-66.0,-70.0,-66.0,-73.0,-66.0,-70.0,-79.0,-84.0,-80.0,-87.0,12.0,10.0,14.0,17.0,1
2210,CC:2F:71:3E:C5:1F,2156392,273559492,109,12995,2156283,273546497,0,524,43609,442,33735,82,9874,119,1,188,7,0,27,144444.0,39000.0,-70.0,-69.0,-67.0,-60.0,-70.0,-67.0,-66.0,-60.0,-79.0,-84.0,-80.0,-87.0,9.0,15.0,13.0,27.0,1
2211,CC:2F:71:3F:1F:24,2493628,713742202,337345,440195705,2156283,273546497,6,255547,315642285,255395,315621475,152,20810,249158,562,337395,34809,6,2153,144444.0,43333.0,-70.0,-57.0,-74.0,-75.0,-69.0,-61.0,-72.0,-73.0,-79.0,-84.0,-80.0,-87.0,9.0,27.0,6.0,12.0,1
2212,F8:59:71:5A:E0:3D,2292014,480679616,135729,207132917,2156285,273546699,337,98038,138013228,97932,137997603,106,15625,97622,35,135727,9018,337,77,144444.0,43333.0,-67.0,-74.0,-66.0,-70.0,-67.0,-73.0,-66.0,-70.0,-79.0,-84.0,-80.0,-87.0,12.0,10.0,14.0,17.0,1
2213,CC:2F:71:3E:C5:1F,2156394,273559694,109,12995,2156285,273546699,0,524,43609,442,33735,82,9874,119,1,188,7,0,27,144444.0,39000.0,-70.0,-69.0,-67.0,-60.0,-70.0,-67.0,-66.0,-60.0,-79.0,-84.0,-80.0,-87.0,9.0,15.0,13.0,27.0,1
2214,CC:2F:71:3F:1F:24,2493788,713948656,337503,440401957,2156285,273546699,6,255691,315839485,255539,315818675,152,20810,249302,562,337553,34815,6,2153,144444.0,43333.0,-69.0,-62.0,-72.0,-74.0,-68.0,-61.0,-71.0,-73.0,-79.0,-84.0,-80.0,-87.0,10.0,22.0,8.0,13.0,1
2215,F8:59:71:5A:E0:3D,2292083,480778124,135792,207230819,2156291,273547305,337,98102,138111802,97996,138096177,106,15625,97685,35,135790,9018,337,77,144444.0,43333.0,-67.0,-74.0,-66.0,-70.0,-66.0,-73.0,-66.0,-69.0,-79.0,-84.0,-80.0,-87.0,12.0,10.0,14.0,17.0,1
2216,CC:2F:71:3E:C5:1F,2156400,273560300,109,12995,2156291,273547305,0,524,43609,442,33735,82,9874,119,1,188,7,0,27,144444.0,39000.0,-70.0,-69.0,-67.0,-60.0,-70.0,-67.0,-66.0,-60.0,-79.0,-84.0,-80.0,-87.0,9.0,15.0,13.0,27.0,1
2217,CC:2F:71:3F:1F:24,2493953,714157068,337662,440609763,2156291,273547305,6,255836,316036801,255684,316015991,152,20810,249447,562,337712,34828,6,2153,144444.0,43333.0,-70.0,-63.0,-73.0,-75.0,-69.0,-62.0,-72.0,-74.0,-79.0,-84.0,-80.0,-87.0,9.0,21.0,7.0,12.0,1
2218,F8:59:71:5A:E0:3D,2292269,481064758,135977,207517393,2156292,273547365,337,98182,138214238,98076,138198613,106,15625,97765,35,135975,9018,337,77,144444.0,43333.0,-67.0,-74.0,-67.0,-70.0,-66.0,-74.0,-66.0,-69.0,-79.0,-84.0,-80.0,-87.0,12.0,10.0,13.0,17.0,1
2219,CC:2F:71:3E:C5:1F,2156403,273560562,109,12995,2156294,273547567,0,524,43609,442,33735,82,9874,119,1,188,7,0,27,144444.0,39000.0,-70.0,-69.0,-67.0,-60.0,-70.0,-67.0,-66.0,-60.0,-79.0,-84.0,-80.0,-87.0,9.0,15.0,13.0,27.0,1
2220,CC:2F:71:3F:1F:24,2494124,714364846,337830,440817279,2156294,273547567,6,255991,316233049,255839,316212239,152,20810,249602,562,337880,34832,6,2153,144444.0,43333.0,-68.0,-62.0,-71.0,-73.0,-68.0,-62.0,-71.0,-72.0,-79.0,-84.0,-80.0,-87.0,11.0,22.0,9.0,14.0,1
2221,F8:59:71:5A:E0:3D,2292506,481420835,136206,207872662,2156300,273548173,337,98286,138318030,98180,138302405,106,15625,97869,35,136204,9018,337,77,144444.0,43333.0,-67.0,-74.0,-66.0,-70.0,-67.0,-73.0,-66.0,-70.0,-80.0,-84.0,-80.0,-87.0,13.0,10.0,14.0,17.0,1
2222,CC:2F:71:3E:C5:1F,2156409,273561168,109,12995,2156300,273548173,0,524,43609,442,33735,82,9874,119,1,188,7,0,27,144444.0,39000.0,-70.0,-69.0,-67.0,-60.0,-70.0,-67.0,-66.0,-60.0,-80.0,-84.0,-80.0,-87.0,10.0,15.0,13.0,27.0,1
2223,CC:2F:71:3F:1F:24,2494284,714566912,337984,441018739,2156300,273548173,6,256131,316426937,255979,316406127,152,20810,249742,562,338034,34838,6,2153,144444.0,43333.0,-70.0,-62.0,-72.0,-74.0,-69.0,-61.0,-71.0,-73.0,-80.0,-84.0,-80.0,-87.0,10.0,22.0,8.0,13.0,1
2224,F8:59:71:5A:E0:3D,2292569,481518737,136269,207970564,2156300,273548173,337,98349,138415064,98243,138399439,106,15625,97931,35,136267,9019,337,77,144444.0,43333.0,-67.0,-73.0,-67.0,-70.0,-66.0,-73.0,-66.0,-69.0,-80.0,-84.0,-80.0,-87.0,13.0,11.0,13.0,17.0,1
2225,CC:2F:71:3E:C5:1F,2156409,273561168,109,12995,2156300,273548173,0,524,43609,442,33735,82,9874,119,1,188,7,0,27,144444.0,39000.0,-70.0,-69.0,-67.0,-60.0,-70.0,-67.0,-66.0,-60.0,-80.0,-84.0,-80.0,-87.0,10.0,15.0,13.0,27.0,1
2226,CC:2F:71:3F:1F:24,2494441,714773034,338141,441224861,2156300,273548173,6,256273,316623905,256121,316603095,152,20810,249884,562,338191,34841,6,2153,144444.0,43333.0,-69.0,-62.0,-72.0,-73.0,-68.0,-62.0,-71.0,-73.0,-80.0,-84.0,-80.0,-87.0,11.0,22.0,8.0,14.0,1
2227,F8:59:71:5A:E0:3D,2292642,481616468,136337,208067831,2156305,273548637,337,98418,138514026,98312,138498401,106,15625,98000,35,136335,9019,337,77,144444.0,43333.0,-67.0,-74.0,-66.0,-70.0,-66.0,-73.0,-66.0,-70.0,-80.0,-84.0,-80.0,-87.0,13.0,10.0,14.0,17.0,1
2228,CC:2F:71:3E:C5:1F,2156414,273561632,109,12995,2156305,273548637,0,524,43609,442,33735,82,9874,119,1,188,7,0,27,144444.0,39000.0,-70.0,-69.0,-67.0,-60.0,-70.0,-67.0,-66.0,-60.0,-80.0,-84.0,-80.0,-87.0,10.0,15.0,13.0,27.0,1
2229,CC:2F:71:3F:1F:24,2494605,714978398,338298,441429559,2156307,273548839,6,256418,316821221,256266,316800411,152,20810,250029,562,338348,34847,6,2153,144444.0,43333.0,-69.0,-62.0,-72.0,-73.0,-69.0,-61.0,-71.0,-73.0,-80.0,-84.0,-80.0,-87.0,11.0,22.0,8.0,14.0,1
2230,F8:59:71:5A:E0:3D,2292755,481777789,136446,208228748,2156309,273549041,337,98498,138626658,98392,138611033,106,15625,98080,35,136444,9020,337,77,144444.0,43333.0,-67.0,-74.0,-66.0,-70.0,-66.0,-73.0,-66.0,-70.0,-80.0,-84.0,-80.0,-87.0,13.0,10.0,14.0,17.0,1
2231,CC:2F:71:3E:C5:1F,2156418,273562036,109,12995,2156309,273549041,0,524,43609,442,33735,82,9874,119,1,188,7,0,27,144444.0,39000.0,-70.0,-69.0,-67.0,-60.0,-70.0,-67.0,-66.0,-60.0,-80.0,-84.0,-80.0,-87.0,10.0,15.0,13.0,27.0,1
2232,CC:2F:71:3F:1F:24,2494788,715213188,338479,441664147,2156309,273549041,6,256583,317042806,256431,317021996,152,20810,250194,562,338529,34851,6,2156,144444.0,43333.0,-69.0,-62.0,-72.0,-73.0,-69.0,-62.0,-72.0,-73.0,-80.0,-84.0,-80.0,-87.0,11.0,22.0,8.0,14.0,1
2233,F8:59:71:5A:E0:3D,2292828,481881215,136515,208331770,2156313,273549445,337,98571,138735348,98465,138719723,106,15625,98151,35,136513,9020,337,77,144444.0,43333.0,-67.0,-72.0,-66.0,-70.0,-66.0,-73.0,-66.0,-69.0,-80.0,-84.0,-80.0,-87.0,13.0,12.0,14.0,17.0,1
2234,CC:2F:71:3E:C5:1F,2156422,273562440,109,12995,2156313,273549445,0,524,43609,442,33735,82,9874,119,1,188,7,0,27,144444.0,39000.0,-70.0,-69.0,-67.0,-60.0,-70.0,-67.0,-66.0,-60.0,-80.0,-84.0,-80.0,-87.0,10.0,15.0,13.0,27.0,1
2235,CC:2F:71:3F:1F:24,2494950,715416938,338635,441867291,2156315,273549647,6,256723,317235368,256571,317214558,152,20810,250334,562,338685,34855,6,2158,144444.0,43333.0,-69.0,-61.0,-71.0,-73.0,-68.0,-61.0,-71.0,-72.0,-80.0,-84.0,-80.0,-87.0,11.0,23.0,9.0,14.0,1
2236,F8:59:71:5A:E0:3D,2292895,481978027,136577,208428118,2156318,273549909,337,98635,138833936,98529,138818311,106,15625,98213,35,136575,9020,337,77,144444.0,43333.0,-67.0,-74.0,-67.0,-70.0,-66.0,-73.0,-66.0,-70.0,-80.0,-84.0,-80.0,-87.0,13.0,10.0,13.0,17.0,1
2237,CC:2F:71:3E:C5:1F,2156427,273562904,109,12995,2156318,273549909,0,524,43609,442,33735,82,9874,119,1,188,7,0,27,144444.0,39000.0,-70.0,-69.0,-67.0,-60.0,-70.0,-67.0,-66.0,-60.0,-80.0,-84.0,-80.0,-87.0,10.0,15.0,13.0,27.0,1
2238,CC:2F:71:3F:1F:24,2495112,715626430,338794,442076521,2156318,273549909,6,256867,317435416,256715,317414606,152,20810,250478,562,338844,34858,6,2158,144444.0,43333.0,-70.0,-62.0,-73.0,-74.0,-68.0,-61.0,-71.0,-73.0,-80.0,-84.0,-80.0,-87.0,10.0,22.0,7.0,13.0,1
2239,F8:59:71:5A:E0:3D,2292962,482076333,136640,208526020,2156322,273550313,337,98701,138935604,98595,138919979,106,15625,98277,35,136638,9020,337,77,144444.0,43333.0,-67.0,-74.0,-66.0,-70.0,-66.0,-73.0,-66.0,-70.0,-80.0,-84.0,-80.0,-87.0,13.0,10.0,14.0,17.0,1
2240,CC:2F:71:3E:C5:1F,2156431,273563308,109,12995,2156322,273550313,0,524,43609,442,33735,82,9874,119,1,188,7,0,27,144444.0,39000.0,-70.0,-69.0,-67.0,-60.0,-70.0,-67.0,-66.0,-60.0,-80.0,-84.0,-80.0,-87.0,10.0,15.0,13.0,27.0,1
2241,CC:2F:71:3F:1F:24,2495270,715828294,338948,442277981,2156322,273550313,6,257008,317629420,256856,317608610,152,20810,250619,562,338998,34860,6,2158,144444.0,43333.0,-69.0,-63.0,-72.0,-75.0,-69.0,-62.0,-71.0,-74.0,-80.0,-84.0,-80.0,-87.0,11.0,21.0,8.0,12.0,1
2242,F8:59:71:5A:E0:3D,2293029,482173211,136702,208622368,2156327,273550843,337,98764,139032638,98658,139017013,106,15625,98339,35,136700,9020,337,77,144444.0,43333.0,-67.0,-74.0,-67.0,-70.0,-66.0,-74.0,-66.0,-69.0,-79.0,-84.0,-80.0,-87.0,12.0,10.0,13.0,17.0,1
2243,CC:2F:71:3E:C5:1F,2156436,273563838,109,12995,2156327,273550843,0,524,43609,442,33735,82,9874,119,1,188,7,0,27,144444.0,39000.0,-70.0,-69.0,-67.0,-60.0,-70.0,-67.0,-66.0,-60.0,-79.0,-84.0,-80.0,-87.0,9.0,15.0,13.0,27.0,1
2244,CC:2F:71:3F:1F:24,2495431,716031968,339104,442481125,2156327,273550843,6,257147,317820400,256995,317799590,152,20810,250758,562,339154,34862,6,2160,144444.0,43333.0,-70.0,-62.0,-72.0,-74.0,-69.0,-62.0,-72.0,-73.0,-79.0,-84.0,-80.0,-87.0,9.0,22.0,8.0,13.0,1
2245,F8:59:71:5A:E0:3D,2293094,482269821,136764,208718716,2156330,273551105,337,98825,139126578,98719,139110953,106,15625,98400,35,136762,9020,337,77,144444.0,43333.0,-67.0,-74.0,-66.0,-70.0,-66.0,-73.0,-66.0,-69.0,-79.0,-84.0,-80.0,-87.0,12.0,10.0,14.0,17.0,1
2246,CC:2F:71:3E:C5:1F,2156439,273564100,109,12995,2156330,273551105,0,524,43609,442,33735,82,9874,119,1,188,7,0,27,144444.0,39000.0,-70.0,-69.0,-67.0,-60.0,-70.0,-67.0,-66.0,-60.0,-79.0,-84.0,-80.0,-87.0,9.0,15.0,13.0,27.0,1
2247,CC:2F:71:3F:1F:24,2495597,716238845,339267,442687740,2156330,273551105,6,257296,318017248,257144,317996438,152,20810,250907,562,339317,34864,6,2160,144444.0,43333.0,-69.0,-62.0,-71.0,-73.0,-69.0,-62.0,-72.0,-73.0,-79.0,-84.0,-80.0,-87.0,10.0,22.0,9.0,14.0,1
2248,F8:59:71:5A:E0:3D,2293163,482366891,136827,208815180,2156336,273551711,337,98890,139226706,98784,139211081,106,15625,98463,35,136825,9020,337,77,144444.0,43333.0,-67.0,-74.0,-67.0,-70.0,-66.0,-73.0,-66.0,-70.0,-79.0,-84.0,-80.0,-87.0,12.0,10.0,13.0,17.0,1
2249,CC:2F:71:3E:C5:1F,2156446,273564822,110,13111,2156336,273551711,0,528,43889,446,34015,82,9874,119,1,190,7,0,27,144444.0,39000.0,-71.0,-69.0,-66.0,-60.0,-70.0,-68.0,-66.0,-60.0,-79.0,-84.0,-80.0,-87.0,8.0,15.0,14.0,27.0,1
2250,CC:2F:71:3F:1F:24,2495760,716442839,339424,442891128,2156336,273551711,6,257439,318212920,257287,318192110,152,20810,251050,562,339474,34866,6,2160,144444.0,43333.0,-69.0,-62.0,-72.0,-74.0,-69.0,-62.0,-71.0,-73.0,-79.0,-84.0,-80.0,-87.0,10.0,22.0,8.0,13.0,1
2251,F8:59:71:5A:E0:3D,2293403,482734896,137063,209182648,2156340,273552248,337,98991,139330184,98885,139314559,106,15625,98564,35,137061,9022,337,77,144444.0,43333.0,-66.0,-73.0,-66.0,-70.0,-66.0,-73.0,-66.0,-69.0,-79.0,-84.0,-80.0,-87.0,13.0,11.0,14.0,17.0,1
2252,CC:2F:71:3E:C5:1F,2156451,273565419,110,13111,2156341,273552308,0,528,43889,446,34015,82,9874,119,1,190,7,0,27,144444.0,39000.0,-71.0,-69.0,-66.0,-60.0,-70.0,-68.0,-66.0,-60.0,-79.0,-84.0,-80.0,-87.0,8.0,15.0,14.0,27.0,1
2253,CC:2F:71:3F:1F:24,2495940,716677530,339599,443125222,2156341,273552308,6,257601,318439546,257448,318418618,153,20928,251211,562,339648,34868,6,2166,144444.0,43333.0,-69.0,-62.0,-72.0,-74.0,-69.0,-62.0,-72.0,-73.0,-79.0,-84.0,-80.0,-87.0,10.0,22.0,8.0,13.0,1
2254,F8:59:71:5A:E0:3D,2293485,482847758,137135,209294536,2156350,273553222,337,99064,139441210,98957,139425467,107,15743,98637,35,137133,9023,337,77,144444.0,43333.0,-67.0,-73.0,-67.0,-70.0,-66.0,-73.0,-66.0,-70.0,-79.0,-84.0,-80.0,-87.0,12.0,11.0,13.0,17.0,1
2255,CC:2F:71:3E:C5:1F,2156460,273566333,110,13111,2156350,273553222,0,528,43889,446,34015,82,9874,119,1,190,7,0,27,144444.0,39000.0,-71.0,-69.0,-66.0,-60.0,-70.0,-68.0,-66.0,-60.0,-79.0,-84.0,-80.0,-87.0,8.0,15.0,14.0,27.0,1
2256,CC:2F:71:3F:1F:24,2496116,716886132,339766,443332910,2156350,273553222,6,257757,318638788,257604,318617860,153,20928,251367,562,339816,34870,6,2166,144444.0,43333.0,-69.0,-62.0,-72.0,-73.0,-68.0,-61.0,-71.0,-73.0,-79.0,-84.0,-80.0,-87.0,10.0,22.0,8.0,14.0,1
2257,F8:59:71:5A:E0:3D,2293695,483173751,137345,209620529,2156350,273553222,337,99140,139541562,99033,139525819,107,15743,98713,35,137343,9023,337,77,144444.0,43333.0,-67.0,-74.0,-66.0,-70.0,-66.0,-73.0,-66.0,-69.0,-79.0,-84.0,-80.0,-87.0,12.0,10.0,14.0,17.0,1
2258,CC:2F:71:3E:C5:1F,2156462,273566535,110,13111,2156352,273553424,0,528,43889,446,34015,82,9874,119,1,190,7,0,27,144444.0,39000.0,-71.0,-69.0,-66.0,-60.0,-70.0,-68.0,-66.0,-60.0,-79.0,-84.0,-80.0,-87.0,8.0,15.0,14.0,27.0,1
2259,CC:2F:71:3F:1F:24,2496282,717095159,339930,443541735,2156352,273553424,6,257905,318839339,257752,318818411,153,20928,251515,562,339980,34872,6,2166,144444.0,43333.0,-69.0,-62.0,-72.0,-74.0,-69.0,-62.0,-72.0,-73.0,-79.0,-84.0,-80.0,-87.0,10.0,22.0,8.0,13.0,1
2260,F8:59:71:5A:E0:3D,2293794,483290971,137413,209726033,2156381,273564938,337,99210,139649376,99103,139633633,107,15743,98782,35,137411,9023,337,77,144444.0,43333.0,-67.0,-73.0,-66.0,-70.0,-66.0,-73.0,-66.0,-69.0,-79.0,-84.0,-80.0,-87.0,12.0,11.0,14.0,17.0,1
2261,CC:2F:71:3E:C5:1F,2156491,273578049,110,13111,2156381,273564938,0,528,43889,446,34015,82,9874,119,1,190,7,0,27,144444.0,39000.0,-71.0,-69.0,-66.0,-60.0,-70.0,-68.0,-66.0,-60.0,-79.0,-84.0,-80.0,-87.0,8.0,15.0,14.0,27.0,1
2262,CC:2F:71:3F:1F:24,2496485,717328958,340104,443764020,2156381,273564938,6,258064,319048738,257911,319027810,153,20928,251674,562,340154,34877,6,2166,144444.0,43333.0,-69.0,-63.0,-73.0,-74.0,-68.0,-62.0,-72.0,-73.0,-79.0,-84.0,-80.0,-87.0,10.0,21.0,7.0,13.0,1
2263,F8:59:71:5A:E0:3D,2293856,483387319,137475,209822381,2156381,273564938,337,99271,139743316,99164,139727573,107,15743,98843,35,137473,9023,337,77,144444.0,43333.0,-66.0,-73.0,-67.0,-70.0,-66.0,-73.0,-66.0,-69.0,-79.0,-84.0,-80.0,-87.0,13.0,11.0,13.0,17.0,1
2264,CC:2F:71:3E:C5:1F,2156491,273578049,110,13111,2156381,273564938,0,528,43889,446,34015,82,9874,119,1,190,7,0,27,144444.0,39000.0,-71.0,-69.0,-66.0,-60.0,-70.0,-68.0,-66.0,-60.0,-79.0,-84.0,-80.0,-87.0,8.0,15.0,14.0,27.0,1
2265,CC:2F:71:3F:1F:24,2496642,717533656,340261,443968718,2156381,273564938,6,258206,319244282,258053,319223354,153,20928,251816,562,340311,34878,6,2166,144444.0,43333.0,-70.0,-63.0,-73.0,-73.0,-70.0,-62.0,-72.0,-72.0,-79.0,-84.0,-80.0,-87.0,9.0,21.0,7.0,14.0,1
2266,F8:59:71:5A:E0:3D,2293923,483485625,137538,209920283,2156385,273565342,337,99336,139843430,99229,139827687,107,15743,98907,35,137536,9023,337,77,144444.0,43333.0,-67.0,-74.0,-67.0,-70.0,-66.0,-73.0,-66.0,-70.0,-79.0,-84.0,-80.0,-87.0,12.0,10.0,13.0,17.0,1
2267,CC:2F:71:3E:C5:1F,2156499,273578857,110,13111,2156389,273565746,0,528,43889,446,34015,82,9874,119,1,190,7,0,27,144444.0,39000.0,-71.0,-69.0,-66.0,-60.0,-70.0,-68.0,-66.0,-60.0,-79.0,-84.0,-80.0,-87.0,8.0,15.0,14.0,27.0,1
2268,CC:2F:71:3F:1F:24,2496828,717752244,340439,444186498,2156389,273565746,6,258372,319453828,258219,319432900,153,20928,251982,562,340489,34914,6,2166,130000.0,43333.0,-70.0,-61.0,-72.0,-70.0,-69.0,-61.0,-72.0,-70.0,-79.0,-84.0,-80.0,-87.0,9.0,23.0,8.0,17.0,1
2269,F8:59:71:5A:E0:3D,2293994,483588653,137604,210022847,2156390,273565806,337,99403,139946638,99296,139930895,107,15743,98972,35,137602,9023,337,77,144444.0,43333.0,-66.0,-74.0,-66.0,-70.0,-66.0,-73.0,-66.0,-70.0,-79.0,-84.0,-80.0,-87.0,13.0,10.0,14.0,17.0,1
2270,CC:2F:71:3E:C5:1F,2156500,273578917,110,13111,2156390,273565806,0,528,43889,446,34015,82,9874,119,1,190,7,0,27,144444.0,39000.0,-71.0,-69.0,-66.0,-60.0,-70.0,-68.0,-66.0,-60.0,-79.0,-84.0,-80.0,-87.0,8.0,15.0,14.0,27.0,1
2271,CC:2F:71:3F:1F:24,2496985,717956872,340595,444391066,2156390,273565806,6,258514,319650796,258361,319629868,153,20928,252124,562,340644,34914,6,2166,130000.0,43333.0,-72.0,-63.0,-72.0,-71.0,-72.0,-63.0,-71.0,-71.0,-79.0,-84.0,-80.0,-87.0,7.0,21.0,8.0,16.0,1
2272,F8:59:71:5A:E0:3D,2294180,483858494,137786,210292284,2156394,273566210,337,99501,140059490,99394,140043747,107,15743,99070,35,137784,9023,337,77,144444.0,43333.0,-66.0,-73.0,-65.0,-70.0,-66.0,-72.0,-65.0,-70.0,-79.0,-84.0,-80.0,-87.0,13.0,11.0,15.0,17.0,1
2273,CC:2F:71:3E:C5:1F,2156504,273579321,110,13111,2156394,273566210,0,528,43889,446,34015,82,9874,119,1,190,7,0,27,144444.0,39000.0,-71.0,-69.0,-66.0,-60.0,-70.0,-68.0,-66.0,-60.0,-79.0,-84.0,-80.0,-87.0,8.0,15.0,14.0,27.0,1
2274,CC:2F:71:3F:1F:24,2497151,718162169,340757,444595959,2156394,273566210,6,258664,319847773,258511,319826845,153,20928,252273,562,340807,34918,6,2166,144444.0,43333.0,-69.0,-64.0,-73.0,-71.0,-69.0,-63.0,-72.0,-70.0,-79.0,-84.0,-80.0,-87.0,10.0,20.0,7.0,16.0,1
2275,F8:59:71:5A:E0:3D,2294246,483955134,137848,210388520,2156398,273566614,337,99564,140156524,99457,140140781,107,15743,99132,35,137846,9023,337,77,144444.0,43333.0,-66.0,-73.0,-65.0,-69.0,-66.0,-73.0,-64.0,-69.0,-79.0,-84.0,-80.0,-87.0,13.0,11.0,15.0,18.0,1
2276,CC:2F:71:3E:C5:1F,2156508,273579725,110,13111,2156398,273566614,0,528,43889,446,34015,82,9874,119,1,190,7,0,27,144444.0,39000.0,-71.0,-69.0,-66.0,-60.0,-70.0,-68.0,-66.0,-60.0,-79.0,-84.0,-80.0,-87.0,8.0,15.0,14.0,27.0,1
2277,CC:2F:71:3F:1F:24,2497311,718365661,340913,444799047,2156398,273566614,6,258807,320042093,258654,320021165,153,20928,252416,562,340963,34929,6,2169,130000.0,43333.0,-68.0,-63.0,-71.0,-69.0,-68.0,-62.0,-70.0,-68.0,-79.0,-84.0,-80.0,-87.0,11.0,21.0,9.0,18.0,1
2278,F8:59:71:5A:E0:3D,2294313,484051946,137910,210484868,2156403,273567078,337,99626,140252032,99519,140236289,107,15743,99194,35,137908,9023,337,77,144444.0,43333.0,-67.0,-74.0,-64.0,-70.0,-66.0,-74.0,-64.0,-70.0,-79.0,-84.0,-80.0,-87.0,12.0,10.0,16.0,17.0,1
2279,CC:2F:71:3E:C5:1F,2156513,273580189,110,13111,2156403,273567078,0,528,43889,446,34015,82,9874,119,1,190,7,0,27,144444.0,39000.0,-71.0,-69.0,-66.0,-60.0,-70.0,-68.0,-66.0,-60.0,-79.0,-84.0,-80.0,-87.0,8.0,15.0,14.0,27.0,1
2280,CC:2F:71:3F:1F:24,2497474,718573491,341071,445006413,2156403,273567078,6,258953,320239533,258800,320218605,153,20928,252562,562,341121,34941,6,2169,130000.0,43333.0,-68.0,-62.0,-71.0,-69.0,-68.0,-61.0,-71.0,-69.0,-79.0,-84.0,-80.0,-87.0,11.0,22.0,9.0,18.0,1
2281,F8:59:71:5A:E0:3D,2294393,484163471,137986,210595989,2156407,273567482,337,99700,140362657,99593,140346914,107,15743,99268,35,137984,9023,337,77,144444.0,43333.0,-67.0,-74.0,-65.0,-70.0,-66.0,-74.0,-64.0,-70.0,-79.0,-84.0,-80.0,-87.0,12.0,10.0,15.0,17.0,1
2282,CC:2F:71:3E:C5:1F,2156517,273580593,110,13111,2156407,273567482,0,528,43889,446,34015,82,9874,119,1,190,7,0,27,144444.0,39000.0,-71.0,-69.0,-66.0,-60.0,-70.0,-68.0,-66.0,-60.0,-79.0,-84.0,-80.0,-87.0,8.0,15.0,14.0,27.0,1
2283,CC:2F:71:3F:1F:24,2497654,718806823,341247,445239341,2156407,273567482,6,259114,320463177,258961,320442249,153,20928,252723,562,341297,34942,6,2172,130000.0,43333.0,-69.0,-62.0,-72.0,-70.0,-68.0,-61.0,-72.0,-69.0,-79.0,-84.0,-80.0,-87.0,10.0,22.0,8.0,17.0,1
2284,F8:59:71:5A:E0:3D,2294461,484263331,138050,210695445,2156411,273567886,337,99766,140464325,99659,140448582,107,15743,99332,35,138048,9024,337,77,144444.0,43333.0,-67.0,-74.0,-66.0,-70.0,-67.0,-74.0,-65.0,-70.0,-79.0,-84.0,-80.0,-87.0,12.0,10.0,14.0,17.0,1
2285,CC:2F:71:3E:C5:1F,2156525,273581658,114,13772,2156411,273567886,0,534,44704,452,34830,82,9874,124,1,194,9,0,27,144444.0,43333.0,-72.0,-69.0,-67.0,-60.0,-70.0,-68.0,-66.0,-60.0,-79.0,-84.0,-80.0,-87.0,7.0,15.0,13.0,27.0,1
2286,CC:2F:71:3F:1F:24,2497833,719019934,341422,445452048,2156411,273567886,6,259276,320662201,259123,320641273,153,20928,252885,562,341471,34942,6,2172,144444.0,39000.0,-68.0,-62.0,-71.0,-70.0,-68.0,-61.0,-71.0,-70.0,-79.0,-84.0,-80.0,-87.0,11.0,22.0,9.0,17.0,1
2287,F8:59:71:5A:E0:3D,2294529,484360205,138112,210791793,2156417,273568412,337,99829,140561345,99722,140545602,107,15743,99395,35,138110,9024,337,77,144444.0,43333.0,-68.0,-74.0,-65.0,-71.0,-67.0,-74.0,-65.0,-70.0,-79.0,-84.0,-80.0,-87.0,11.0,10.0,15.0,16.0,1
2288,CC:2F:71:3E:C5:1F,2156531,273582184,114,13772,2156417,273568412,0,536,44892,453,34900,83,9992,125,1,194,9,0,27,144444.0,43333.0,-72.0,-69.0,-66.0,-60.0,-71.0,-69.0,-66.0,-60.0,-79.0,-84.0,-80.0,-87.0,7.0,15.0,14.0,27.0,1
2289,CC:2F:71:3F:1F:24,2498004,719237534,341587,445669122,2156417,273568412,6,259428,320873159,259275,320852231,153,20928,253036,562,341637,34944,6,2172,144444.0,43333.0,-68.0,-61.0,-71.0,-69.0,-67.0,-61.0,-71.0,-69.0,-79.0,-84.0,-80.0,-87.0,11.0,23.0,9.0,18.0,1
2290,F8:59:71:5A:E0:3D,2294789,484758919,138368,211190103,2156421,273568816,337,99941,140674727,99834,140658984,107,15743,99506,35,138366,9024,337,77,144444.0,43333.0,-68.0,-74.0,-65.0,-71.0,-67.0,-73.0,-65.0,-70.0,-79.0,-84.0,-80.0,-87.0,11.0,10.0,15.0,16.0,1
2291,CC:2F:71:3E:C5:1F,2156535,273582588,114,13772,2156421,273568816,0,536,44892,453,34900,83,9992,125,1,194,9,0,27,144444.0,43333.0,-72.0,-69.0,-66.0,-60.0,-71.0,-69.0,-66.0,-60.0,-79.0,-84.0,-80.0,-87.0,7.0,15.0,14.0,27.0,1
2292,CC:2F:71:3F:1F:24,2498182,719451110,341761,445882294,2156421,273568816,6,259586,321077359,259433,321056431,153,20928,253193,562,341811,34945,6,2172,144444.0,43333.0,-68.0,-62.0,-71.0,-70.0,-68.0,-62.0,-71.0,-70.0,-79.0,-84.0,-80.0,-87.0,11.0,22.0,9.0,17.0,1
2293,F8:59:71:5A:E0:3D,2294859,484860606,138433,211291113,2156426,273569493,337,99970,140719485,99863,140703742,107,15743,99535,35,138431,9024,337,82,144444.0,43333.0,-67.0,-72.0,-64.0,-71.0,-66.0,-72.0,-64.0,-70.0,-79.0,-84.0,-80.0,-87.0,12.0,12.0,16.0,16.0,1
2294,CC:2F:71:3E:C5:1F,2156541,273583325,114,13772,2156427,273569553,0,536,44892,453,34900,83,9992,125,1,194,9,0,27,144444.0,43333.0,-72.0,-69.0,-66.0,-60.0,-71.0,-69.0,-66.0,-60.0,-79.0,-84.0,-80.0,-87.0,7.0,15.0,14.0,27.0,1
2295,CC:2F:71:3F:1F:24,2498346,719658243,341919,446088690,2156427,273569553,6,259798,321381205,259645,321360277,153,20928,253400,562,341969,34949,6,2184,144444.0,43333.0,-65.0,-61.0,-67.0,-68.0,-66.0,-61.0,-68.0,-68.0,-79.0,-84.0,-80.0,-87.0,14.0,23.0,13.0,19.0,1
2296,F8:59:71:5A:E0:3D,2295683,485943560,139192,212367410,2156491,273576150,337,101145,142335806,101038,142320063,107,15743,100629,36,139191,9041,337,153,144444.0,43333.0,-65.0,-70.0,-63.0,-70.0,-66.0,-70.0,-64.0,-70.0,-77.0,-82.0,-78.0,-84.0,12.0,12.0,15.0,14.0,1
2297,CC:2F:71:3E:C5:1F,2156640,273593284,117,14064,2156523,273579220,0,543,45502,459,35392,84,10110,128,1,198,9,0,28,130000.0,39000.0,-66.0,-62.0,-66.0,-60.0,-68.0,-67.0,-65.0,-60.0,-77.0,-84.0,-78.0,-85.0,11.0,22.0,12.0,25.0,1
2298,CC:2F:71:3F:1F:24,2501995,724948681,345466,451368855,2156529,273579826,8,261153,323098019,261000,323077091,153,20928,254648,565,345521,35588,8,2338,130000.0,43333.0,-68.0,-62.0,-71.0,-70.0,-67.0,-62.0,-70.0,-69.0,-77.0,-83.0,-77.0,-84.0,9.0,21.0,6.0,14.0,1
2299,F8:59:71:5A:E0:3D,2296931,487734438,140364,214150803,2156567,273583635,345,102467,144133150,102359,144117289,108,15861,101888,40,140367,9162,345,202,144444.0,43333.0,-65.0,-67.0,-63.0,-69.0,-65.0,-70.0,-63.0,-70.0,-77.0,-84.0,-77.0,-85.0,12.0,17.0,14.0,16.0,1
2300,CC:2F:71:3E:C5:1F,2156693,273598567,117,14064,2156576,273584503,0,543,45502,459,35392,84,10110,128,1,198,9,0,28,130000.0,39000.0,-66.0,-62.0,-66.0,-60.0,-68.0,-67.0,-65.0,-60.0,-77.0,-84.0,-77.0,-84.0,11.0,22.0,11.0,24.0,1
2301,CC:2F:71:3F:1F:24,2503770,727437879,347187,453852710,2156583,273585169,8,262643,325163003,262489,325141957,154,21046,256116,565,347243,35690,8,2470,130000.0,39000.0,-69.0,-62.0,-72.0,-69.0,-68.0,-62.0,-71.0,-69.0,-76.0,-83.0,-76.0,-83.0,7.0,21.0,4.0,14.0,1
2302,F8:59:71:5A:E0:3D,2297839,489075480,141239,215488635,2156600,273586845,354,103044,144947452,102936,144931591,108,15861,102465,42,141245,9238,354,215,144444.0,43333.0,-66.0,-71.0,-63.0,-70.0,-65.0,-70.0,-63.0,-69.0,-76.0,-83.0,-76.0,-83.0,10.0,12.0,13.0,13.0,1
2303,CC:2F:71:3E:C5:1F,2156721,273601289,118,14180,2156603,273587109,0,545,45642,461,35532,84,10110,128,1,200,9,0,28,130000.0,39000.0,-71.0,-69.0,-67.0,-60.0,-69.0,-67.0,-66.0,-60.0,-76.0,-83.0,-76.0,-83.0,5.0,14.0,9.0,23.0,1
2304,CC:2F:71:3F:1F:24,2504621,728670912,348012,455083066,2156609,273587846,8,264002,327220761,263848,327199715,154,21046,257469,565,348068,35705,8,2537,144444.0,43333.0,-69.0,-62.0,-72.0,-70.0,-68.0,-61.0,-72.0,-70.0,-76.0,-83.0,-76.0,-83.0,7.0,21.0,4.0,13.0,1
2305,F8:59:71:5A:E0:3D,2298683,490339455,142059,216749969,2156624,273589486,354,103380,145420577,103271,145404598,109,15979,102801,42,142065,9305,354,217,144444.0,43333.0,-65.0,-71.0,-64.0,-69.0,-65.0,-70.0,-63.0,-69.0,-76.0,-83.0,-76.0,-83.0,11.0,12.0,12.0,14.0,1
2306,CC:2F:71:3E:C5:1F,2156742,273603666,118,14180,2156624,273589486,0,545,45642,461,35532,84,10110,128,1,200,9,0,28,130000.0,39000.0,-71.0,-69.0,-67.0,-60.0,-69.0,-67.0,-66.0,-60.0,-76.0,-83.0,-76.0,-83.0,5.0,14.0,9.0,23.0,1
2307,CC:2F:71:3F:1F:24,2505287,729616320,348657,456026228,2156630,273590092,8,265400,329332247,265246,329311201,154,21046,258863,565,348713,35709,8,2596,144444.0,43333.0,-68.0,-62.0,-72.0,-70.0,-68.0,-61.0,-72.0,-69.0,-76.0,-83.0,-76.0,-83.0,8.0,21.0,4.0,13.0,1
2308,F8:59:71:5A:E0:3D,2299489,491548879,142847,217957655,2156642,273591224,354,103726,145907062,103617,145891083,109,15979,103145,42,142852,9319,354,217,144444.0,43333.0,-66.0,-69.0,-64.0,-69.0,-65.0,-70.0,-63.0,-69.0,-75.0,-82.0,-76.0,-82.0,9.0,13.0,12.0,13.0,1
2309,CC:2F:71:3E:C5:1F,2156761,273605464,118,14180,2156643,273591284,0,545,45642,461,35532,84,10110,128,1,200,9,0,28,130000.0,39000.0,-71.0,-69.0,-67.0,-60.0,-69.0,-67.0,-66.0,-60.0,-75.0,-82.0,-76.0,-82.0,4.0,13.0,9.0,22.0,1
2310,CC:2F:71:3F:1F:24,2505974,730553006,349323,456960914,2156651,273592092,8,266789,331408872,266634,331387708,155,21164,260249,565,349378,35714,8,2642,144444.0,43333.0,-68.0,-62.0,-72.0,-70.0,-67.0,-61.0,-71.0,-69.0,-75.0,-82.0,-75.0,-82.0,7.0,20.0,3.0,12.0,1
2311,F8:59:71:5A:E0:3D,2300009,492332430,143357,218740276,2156652,273592154,354,103925,146209317,103816,146193338,109,15979,103343,42,143363,9323,354,218,144444.0,43333.0,-66.0,-70.0,-63.0,-70.0,-65.0,-70.0,-63.0,-69.0,-75.0,-82.0,-75.0,-82.0,9.0,12.0,12.0,12.0,1
2312,CC:2F:71:3E:C5:1F,2156772,273606536,118,14180,2156654,273592356,0,547,45830,462,35602,85,10228,129,1,200,9,0,28,130000.0,39000.0,-72.0,-69.0,-67.0,-60.0,-70.0,-68.0,-66.0,-60.0,-75.0,-82.0,-75.0,-82.0,3.0,13.0,8.0,22.0,1
2313,CC:2F:71:3F:1F:24,2506793,731572590,350136,457979972,2156657,273592618,8,267395,332129926,267240,332108762,155,21164,260854,565,350192,35725,8,2650,144444.0,43333.0,-68.0,-62.0,-72.0,-70.0,-67.0,-61.0,-71.0,-70.0,-75.0,-82.0,-75.0,-82.0,7.0,20.0,3.0,12.0,1
2314,F8:59:71:5A:E0:3D,2300259,492708058,143598,219115036,2156661,273593022,354,104052,146341639,103943,146325660,109,15979,103470,42,143604,9331,354,218,144444.0,43333.0,-62.0,-72.0,-64.0,-70.0,-64.0,-71.0,-64.0,-69.0,-75.0,-82.0,-75.0,-82.0,13.0,10.0,11.0,12.0,1
2315,CC:2F:71:3E:C5:1F,2156779,273607202,118,14180,2156661,273593022,0,547,45830,462,35602,85,10228,129,1,200,9,0,28,130000.0,39000.0,-72.0,-69.0,-67.0,-60.0,-70.0,-68.0,-66.0,-60.0,-75.0,-82.0,-75.0,-82.0,3.0,13.0,8.0,22.0,1
2316,CC:2F:71:3F:1F:24,2507056,731907056,350395,458314034,2156661,273593022,8,267584,332365438,267429,332344274,155,21164,261043,565,350451,35725,8,2654,144444.0,43333.0,-68.0,-62.0,-72.0,-70.0,-68.0,-61.0,-72.0,-70.0,-75.0,-82.0,-75.0,-82.0,7.0,20.0,3.0,12.0,1
2317,F8:59:71:5A:E0:3D,2300450,493000560,143787,219407336,2156663,273593224,354,104150,146460237,104041,146444258,109,15979,103568,42,143793,9331,354,218,144444.0,43333.0,-66.0,-68.0,-64.0,-70.0,-64.0,-69.0,-63.0,-69.0,-75.0,-82.0,-75.0,-82.0,9.0,14.0,11.0,12.0,1
2318,CC:2F:71:3E:C5:1F,2156781,273607404,118,14180,2156663,273593224,0,547,45830,462,35602,85,10228,129,1,200,9,0,28,130000.0,39000.0,-72.0,-69.0,-67.0,-60.0,-70.0,-68.0,-66.0,-60.0,-75.0,-82.0,-75.0,-82.0,3.0,13.0,8.0,22.0,1
2319,CC:2F:71:3F:1F:24,2507277,732154333,350612,458560907,2156665,273593426,8,267781,332609940,267626,332588776,155,21164,261239,565,350668,35729,8,2660,144444.0,43333.0,-68.0,-62.0,-72.0,-70.0,-68.0,-61.0,-72.0,-70.0,-75.0,-82.0,-75.0,-82.0,7.0,20.0,3.0,12.0,1
2320,F8:59:71:5A:E0:3D,2300528,493103296,143857,219509133,2156671,273594163,354,104219,146563234,104110,146547255,109,15979,103636,42,143863,9331,354,218,144444.0,43333.0,-66.0,-72.0,-64.0,-70.0,-64.0,-71.0,-63.0,-69.0,-75.0,-82.0,-75.0,-82.0,9.0,10.0,11.0,12.0,1
2321,CC:2F:71:3E:C5:1F,2156789,273608343,118,14180,2156671,273594163,0,547,45830,462,35602,85,10228,129,1,200,9,0,28,130000.0,39000.0,-72.0,-69.0,-67.0,-60.0,-70.0,-68.0,-66.0,-60.0,-75.0,-82.0,-75.0,-82.0,3.0,13.0,8.0,22.0,1
2322,CC:2F:71:3F:1F:24,2507463,732391142,350792,458796979,2156671,273594163,8,267945,332839352,267790,332818188,155,21164,261403,565,350848,35731,8,2666,144444.0,43333.0,-67.0,-61.0,-71.0,-70.0,-68.0,-61.0,-71.0,-70.0,-75.0,-82.0,-75.0,-82.0,8.0,21.0,4.0,12.0,1
2323,F8:59:71:5A:E0:3D,2300601,493213890,143930,219619727,2156671,273594163,354,104292,146672806,104183,146656827,109,15979,103709,42,143936,9331,354,218,144444.0,43333.0,-65.0,-70.0,-64.0,-70.0,-64.0,-70.0,-63.0,-69.0,-75.0,-82.0,-75.0,-82.0,10.0,12.0,11.0,12.0,1
2324,CC:2F:71:3E:C5:1F,2156791,273608545,118,14180,2156673,273594365,0,547,45830,462,35602,85,10228,129,1,200,9,0,28,130000.0,39000.0,-72.0,-69.0,-67.0,-60.0,-70.0,-68.0,-66.0,-60.0,-75.0,-82.0,-75.0,-82.0,3.0,13.0,8.0,22.0,1
2325,CC:2F:71:3F:1F:24,2507631,732601589,350956,459007022,2156675,273594567,8,268094,333040019,267939,333018855,155,21164,261552,565,351008,35736,8,2666,144444.0,43333.0,-67.0,-61.0,-70.0,-70.0,-67.0,-61.0,-71.0,-70.0,-75.0,-82.0,-75.0,-82.0,8.0,21.0,5.0,12.0,1
2326,F8:59:71:5A:E0:3D,2300673,493314154,143994,219719183,2156679,273594971,354,104356,146771366,104247,146755387,109,15979,103773,42,144000,9331,354,218,144444.0,43333.0,-65.0,-67.0,-62.0,-68.0,-65.0,-70.0,-62.0,-69.0,-75.0,-82.0,-75.0,-82.0,10.0,15.0,13.0,14.0,1
2327,CC:2F:71:3E:C5:1F,2156797,273609151,118,14180,2156679,273594971,0,547,45830,462,35602,85,10228,129,1,200,9,0,28,130000.0,39000.0,-72.0,-69.0,-67.0,-60.0,-70.0,-68.0,-66.0,-60.0,-75.0,-82.0,-75.0,-82.0,3.0,13.0,8.0,22.0,1
2328,CC:2F:71:3F:1F:24,2507807,732817138,351128,459222167,2156679,273594971,8,268252,333242321,268097,333221157,155,21164,261710,565,351184,35737,8,2666,144444.0,43333.0,-67.0,-61.0,-70.0,-70.0,-67.0,-61.0,-70.0,-70.0,-75.0,-82.0,-75.0,-82.0,8.0,21.0,5.0,12.0,1
2329,F8:59:71:5A:E0:3D,2300739,493415056,144059,219820025,2156680,273595031,354,104423,146874574,104314,146858595,109,15979,103838,42,144065,9332,354,218,144444.0,43333.0,-66.0,-72.0,-64.0,-70.0,-65.0,-69.0,-63.0,-69.0,-75.0,-81.0,-75.0,-82.0,9.0,9.0,11.0,12.0,1
2330,CC:2F:71:3E:C5:1F,2156798,273609211,118,14180,2156680,273595031,0,547,45830,462,35602,85,10228,129,1,200,9,0,28,130000.0,39000.0,-72.0,-69.0,-67.0,-60.0,-70.0,-68.0,-66.0,-60.0,-75.0,-81.0,-75.0,-82.0,3.0,12.0,8.0,22.0,1
2331,CC:2F:71:3F:1F:24,2507973,733034472,351293,459439441,2156680,273595031,8,268408,333453755,268253,333432591,155,21164,261865,565,351349,35739,8,2666,144444.0,43333.0,-68.0,-62.0,-71.0,-70.0,-68.0,-61.0,-71.0,-69.0,-75.0,-81.0,-75.0,-82.0,7.0,19.0,4.0,12.0,1
2332,F8:59:71:5A:E0:3D,2300853,493572462,144165,219976623,2156688,273595839,354,104501,146982693,104392,146966714,109,15979,103916,42,144171,9332,354,218,144444.0,43333.0,-66.0,-69.0,-64.0,-70.0,-64.0,-69.0,-63.0,-69.0,-75.0,-81.0,-75.0,-82.0,9.0,12.0,11.0,12.0,1
2333,CC:2F:71:3E:C5:1F,2156806,273610019,118,14180,2156688,273595839,0,547,45830,462,35602,85,10228,129,1,200,9,0,28,130000.0,39000.0,-72.0,-69.0,-67.0,-60.0,-70.0,-68.0,-66.0,-60.0,-75.0,-81.0,-75.0,-82.0,3.0,12.0,8.0,22.0,1
2334,CC:2F:71:3F:1F:24,2508158,733241612,351470,459645773,2156688,273595839,8,268567,333656226,268412,333635062,155,21164,262024,565,351526,35741,8,2670,144444.0,43333.0,-68.0,-62.0,-72.0,-70.0,-68.0,-61.0,-71.0,-69.0,-75.0,-81.0,-75.0,-82.0,7.0,19.0,3.0,12.0,1
2335,F8:59:71:5A:E0:3D,2300918,493673472,144230,220077633,2156688,273595839,354,104567,147084571,104458,147068592,109,15979,103982,42,144236,9332,354,218,144444.0,43333.0,-65.0,-69.0,-64.0,-69.0,-65.0,-69.0,-63.0,-69.0,-75.0,-81.0,-75.0,-82.0,10.0,12.0,11.0,13.0,1
2336,CC:2F:71:3E:C5:1F,2156806,273610019,118,14180,2156688,273595839,0,547,45830,462,35602,85,10228,129,1,200,9,0,28,130000.0,39000.0,-72.0,-69.0,-67.0,-60.0,-70.0,-68.0,-66.0,-60.0,-75.0,-81.0,-75.0,-82.0,3.0,12.0,8.0,22.0,1
2337,CC:2F:71:3F:1F:24,2508738,734029277,352049,460433378,2156689,273595899,8,268805,333889470,268650,333868306,155,21164,262262,565,352105,35753,8,2670,144444.0,43333.0,-68.0,-62.0,-71.0,-70.0,-67.0,-61.0,-71.0,-70.0,-75.0,-81.0,-75.0,-82.0,7.0,19.0,4.0,12.0,1
2338,F8:59:71:5A:E0:3D,2300998,493776269,144301,220179562,2156697,273596707,354,104635,147184870,104526,147168891,109,15979,104050,42,144307,9333,354,218,144444.0,43333.0,-65.0,-70.0,-63.0,-70.0,-65.0,-70.0,-63.0,-69.0,-75.0,-81.0,-75.0,-82.0,10.0,11.0,12.0,12.0,1
2339,CC:2F:71:3E:C5:1F,2156815,273610887,118,14180,2156697,273596707,0,547,45830,462,35602,85,10228,129,1,200,9,0,28,130000.0,39000.0,-72.0,-69.0,-67.0,-60.0,-70.0,-68.0,-66.0,-60.0,-75.0,-81.0,-75.0,-82.0,3.0,12.0,8.0,22.0,1
2340,CC:2F:71:3F:1F:24,2508914,734247334,352217,460650627,2156697,273596707,8,268958,334093958,268803,334072794,155,21164,262415,565,352272,35753,8,2673,144444.0,43333.0,-68.0,-61.0,-71.0,-70.0,-67.0,-61.0,-70.0,-69.0,-75.0,-81.0,-75.0,-82.0,7.0,20.0,4.0,12.0,1
2341,F8:59:71:5A:E0:3D,2301148,494002915,144451,220406208,2156697,273596707,354,104729,147299540,104620,147283561,109,15979,104144,42,144457,9334,354,219,144444.0,43333.0,-64.0,-71.0,-64.0,-69.0,-65.0,-69.0,-63.0,-68.0,-75.0,-81.0,-75.0,-82.0,11.0,10.0,11.0,13.0,1
2342,CC:2F:71:3E:C5:1F,2156815,273610887,118,14180,2156697,273596707,0,547,45830,462,35602,85,10228,129,1,200,9,0,28,130000.0,39000.0,-72.0,-69.0,-67.0,-60.0,-70.0,-68.0,-66.0,-60.0,-75.0,-81.0,-75.0,-82.0,3.0,12.0,8.0,22.0,1
2343,CC:2F:71:3F:1F:24,2509094,734487790,352397,460891083,2156697,273596707,8,269127,334329924,268972,334308760,155,21164,262583,565,352453,35754,8,2679,144444.0,43333.0,-68.0,-62.0,-72.0,-70.0,-68.0,-61.0,-71.0,-70.0,-75.0,-81.0,-75.0,-82.0,7.0,19.0,3.0,12.0,1
2344,F8:59:71:5A:E0:3D,2301229,494115671,144523,220518096,2156706,273597575,354,104803,147413570,104694,147397591,109,15979,104217,42,144529,9334,354,220,144444.0,43333.0,-64.0,-70.0,-63.0,-69.0,-65.0,-71.0,-64.0,-69.0,-75.0,-81.0,-75.0,-82.0,11.0,11.0,12.0,13.0,1
2345,CC:2F:71:3E:C5:1F,2156824,273611755,118,14180,2156706,273597575,0,547,45830,462,35602,85,10228,129,1,200,9,0,28,130000.0,39000.0,-72.0,-69.0,-67.0,-60.0,-70.0,-68.0,-66.0,-60.0,-75.0,-81.0,-75.0,-82.0,3.0,12.0,8.0,22.0,1
2346,CC:2F:71:3F:1F:24,2509258,734690264,352552,461092689,2156706,273597575,8,269267,334520964,269112,334499800,155,21164,262723,565,352608,35757,8,2679,144444.0,43333.0,-68.0,-62.0,-71.0,-70.0,-67.0,-61.0,-70.0,-70.0,-75.0,-81.0,-75.0,-82.0,7.0,19.0,4.0,12.0,1
2347,F8:59:71:5A:E0:3D,2301324,494263077,144618,220665502,2156706,273597575,354,104895,147555572,104786,147539593,109,15979,104309,42,144624,9334,354,222,144444.0,43333.0,-71.0,-80.0,-72.0,-73.0,-66.0,-72.0,-64.0,-70.0,-74.0,-81.0,-74.0,-81.0,3.0,1.0,2.0,8.0,1
2348,CC:2F:71:3E:C5:1F,2156824,273611755,118,14180,2156706,273597575,0,547,45830,462,35602,85,10228,129,1,200,9,0,28,130000.0,39000.0,-72.0,-69.0,-67.0,-60.0,-70.0,-68.0,-66.0,-60.0,-74.0,-81.0,-74.0,-81.0,2.0,12.0,7.0,21.0,1
2349,CC:2F:71:3F:1F:24,2509482,734997614,352774,461399837,2156708,273597777,8,269479,334823080,269324,334801916,155,21164,262935,565,352830,35761,8,2693,144444.0,43333.0,-67.0,-61.0,-71.0,-70.0,-67.0,-61.0,-71.0,-70.0,-74.0,-81.0,-74.0,-81.0,7.0,20.0,3.0,11.0,1
2350,F8:59:71:5A:E0:3D,2301485,494495483,144767,220896712,2156718,273598771,354,105048,147791472,104939,147775493,109,15979,104462,42,144773,9334,354,225,144444.0,43333.0,-65.0,-71.0,-63.0,-70.0,-65.0,-71.0,-63.0,-70.0,-74.0,-81.0,-74.0,-82.0,9.0,10.0,11.0,12.0,1
2351,CC:2F:71:3E:C5:1F,2156849,273614410,119,14296,2156730,273600114,0,549,45970,464,35742,85,10228,129,1,202,9,0,28,130000.0,39000.0,-71.0,-69.0,-66.0,-60.0,-70.0,-68.0,-66.0,-60.0,-75.0,-81.0,-75.0,-82.0,4.0,12.0,9.0,22.0,1
2352,CC:2F:71:3F:1F:24,2510566,736510667,353831,462910087,2156735,273600580,8,270246,335866979,270091,335845815,155,21164,263686,565,353887,35782,8,2776,144444.0,43333.0,-68.0,-62.0,-69.0,-68.0,-68.0,-62.0,-69.0,-69.0,-75.0,-81.0,-75.0,-82.0,7.0,19.0,6.0,14.0,1
2353,F8:59:71:5A:E0:3D,2302123,495418895,145357,221806599,2156766,273612296,354,105424,148283253,105314,148267156,110,16097,104837,42,145363,9336,354,228,144444.0,43333.0,-64.0,-68.0,-64.0,-70.0,-64.0,-70.0,-64.0,-70.0,-75.0,-80.0,-75.0,-82.0,11.0,12.0,11.0,12.0,1
2354,CC:2F:71:3E:C5:1F,2156885,273626592,119,14296,2156766,273612296,0,549,45970,464,35742,85,10228,129,1,202,9,0,28,130000.0,39000.0,-71.0,-69.0,-66.0,-60.0,-70.0,-68.0,-66.0,-60.0,-75.0,-80.0,-75.0,-82.0,4.0,11.0,9.0,22.0,1
2355,CC:2F:71:3F:1F:24,2510836,736830686,354070,463218390,2156766,273612296,8,270551,336290826,270396,336269662,155,21164,263990,565,354126,35788,8,2783,144444.0,43333.0,-68.0,-63.0,-71.0,-71.0,-68.0,-62.0,-70.0,-70.0,-75.0,-80.0,-75.0,-82.0,7.0,17.0,4.0,11.0,1
2356,F8:59:71:5A:E0:3D,2302193,495527675,145427,221915379,2156766,273612296,354,105496,148394133,105386,148378036,110,16097,104909,42,145433,9336,354,228,144444.0,43333.0,-64.0,-71.0,-65.0,-70.0,-65.0,-70.0,-64.0,-69.0,-75.0,-80.0,-75.0,-82.0,11.0,9.0,10.0,12.0,1
2357,CC:2F:71:3E:C5:1F,2156885,273626592,119,14296,2156766,273612296,0,549,45970,464,35742,85,10228,129,1,202,9,0,28,130000.0,39000.0,-71.0,-69.0,-66.0,-60.0,-70.0,-68.0,-66.0,-60.0,-75.0,-80.0,-75.0,-82.0,4.0,11.0,9.0,22.0,1
2358,CC:2F:71:3F:1F:24,2511004,737053923,354238,463441627,2156766,273612296,8,270705,336503557,270550,336482393,155,21164,264144,565,354294,35793,8,2784,144444.0,43333.0,-69.0,-62.0,-70.0,-69.0,-68.0,-62.0,-70.0,-69.0,-75.0,-80.0,-75.0,-82.0,6.0,18.0,5.0,13.0,1
2359,F8:59:71:5A:E0:3D,2302265,495627939,145491,222014835,2156774,273613104,354,105560,148492693,105450,148476596,110,16097,104973,42,145497,9336,354,228,144444.0,43333.0,-65.0,-70.0,-64.0,-69.0,-64.0,-70.0,-63.0,-69.0,-75.0,-80.0,-75.0,-82.0,10.0,10.0,11.0,13.0,1
2360,CC:2F:71:3E:C5:1F,2156893,273627400,119,14296,2156774,273613104,0,549,45970,464,35742,85,10228,129,1,202,9,0,28,130000.0,39000.0,-71.0,-69.0,-66.0,-60.0,-70.0,-68.0,-66.0,-60.0,-75.0,-80.0,-75.0,-82.0,4.0,11.0,9.0,22.0,1
2361,CC:2F:71:3F:1F:24,2511438,737636679,354664,464023575,2156774,273613104,8,270901,336716666,270746,336695502,155,21164,264339,565,354720,35812,8,2784,144444.0,43333.0,-68.0,-62.0,-71.0,-69.0,-68.0,-62.0,-70.0,-69.0,-75.0,-80.0,-75.0,-82.0,7.0,18.0,4.0,13.0,1
2362,F8:59:71:5A:E0:3D,2302332,495727633,145556,222114407,2156776,273613226,354,105626,148592913,105516,148576816,110,16097,105038,42,145562,9337,354,229,144444.0,43333.0,-65.0,-71.0,-64.0,-69.0,-64.0,-71.0,-64.0,-69.0,-75.0,-81.0,-75.0,-82.0,10.0,10.0,11.0,13.0,1
2363,CC:2F:71:3E:C5:1F,2156895,273627522,119,14296,2156776,273613226,0,549,45970,464,35742,85,10228,129,1,202,9,0,28,130000.0,39000.0,-71.0,-69.0,-66.0,-60.0,-70.0,-68.0,-66.0,-60.0,-75.0,-81.0,-75.0,-82.0,4.0,12.0,9.0,22.0,1
2364,CC:2F:71:3F:1F:24,2511636,737860440,354860,464247214,2156776,273613226,8,271079,336939046,270923,336917764,156,21282,264516,565,354916,35827,8,2785,144444.0,43333.0,-68.0,-62.0,-71.0,-69.0,-67.0,-62.0,-70.0,-69.0,-75.0,-81.0,-75.0,-82.0,7.0,19.0,4.0,13.0,1
2365,F8:59:71:5A:E0:3D,2302588,496103704,145803,222489608,2156785,273614096,354,105784,148793407,105674,148777310,110,16097,105196,42,145808,9339,354,229,144444.0,43333.0,-65.0,-71.0,-64.0,-70.0,-65.0,-71.0,-63.0,-69.0,-75.0,-81.0,-75.0,-82.0,10.0,10.0,11.0,12.0,1
2366,CC:2F:71:3E:C5:1F,2156904,273628392,119,14296,2156785,273614096,0,551,46158,465,35812,86,10346,130,1,202,9,0,29,130000.0,39000.0,-72.0,-76.0,-72.0,-71.0,-71.0,-69.0,-67.0,-61.0,-75.0,-81.0,-75.0,-82.0,3.0,5.0,3.0,11.0,1
2367,CC:2F:71:3F:1F:24,2511941,738265322,355155,464651166,2156786,273614156,8,271359,337329813,271203,337308531,156,21282,264794,565,355211,35861,8,2812,144444.0,43333.0,-68.0,-62.0,-71.0,-69.0,-67.0,-62.0,-70.0,-68.0,-75.0,-81.0,-75.0,-82.0,7.0,19.0,4.0,13.0,1
2368,F8:59:71:5A:E0:3D,2302670,496219622,145880,222605062,2156790,273614560,354,105856,148900487,105746,148884390,110,16097,105268,42,145886,9341,354,229,144444.0,43333.0,-64.0,-71.0,-64.0,-69.0,-65.0,-69.0,-64.0,-69.0,-75.0,-81.0,-75.0,-82.0,11.0,10.0,11.0,13.0,1
2369,CC:2F:71:3E:C5:1F,2156911,273629058,119,14296,2156792,273614762,0,551,46158,465,35812,86,10346,130,1,202,9,0,29,130000.0,39000.0,-72.0,-76.0,-72.0,-71.0,-71.0,-69.0,-67.0,-61.0,-75.0,-81.0,-75.0,-82.0,3.0,5.0,3.0,11.0,1
2370,CC:2F:71:3F:1F:24,2512111,738478614,355317,464863650,2156794,273614964,8,271508,337533289,271352,337512007,156,21282,264943,565,355373,35886,8,2812,144444.0,43333.0,-68.0,-62.0,-71.0,-69.0,-67.0,-62.0,-70.0,-68.0,-75.0,-81.0,-75.0,-82.0,7.0,19.0,4.0,13.0,1
2371,F8:59:71:5A:E0:3D,2302738,496319482,145944,222704518,2156794,273614964,354,105922,149002155,105812,148986058,110,16097,105334,42,145950,9343,354,229,144444.0,43333.0,-66.0,-71.0,-64.0,-71.0,-65.0,-70.0,-64.0,-70.0,-75.0,-80.0,-75.0,-82.0,9.0,9.0,11.0,11.0,1
2372,CC:2F:71:3E:C5:1F,2156913,273629260,119,14296,2156794,273614964,0,551,46158,465,35812,86,10346,130,1,202,9,0,29,130000.0,39000.0,-72.0,-76.0,-72.0,-71.0,-71.0,-69.0,-67.0,-61.0,-75.0,-80.0,-75.0,-82.0,3.0,4.0,3.0,11.0,1
2373,CC:2F:71:3F:1F:24,2512273,738689940,355479,465074976,2156794,273614964,8,271659,337737185,271503,337715903,156,21282,265094,565,355535,35911,8,2815,144444.0,43333.0,-68.0,-62.0,-71.0,-69.0,-67.0,-62.0,-71.0,-68.0,-75.0,-80.0,-75.0,-82.0,7.0,18.0,4.0,13.0,1
2374,F8:59:71:5A:E0:3D,2302824,496442690,146023,222827060,2156801,273615630,354,106005,149130003,105895,149113906,110,16097,105415,42,146029,9344,354,229,144444.0,39000.0,-66.0,-71.0,-64.0,-70.0,-65.0,-70.0,-64.0,-70.0,-75.0,-80.0,-75.0,-82.0,9.0,9.0,11.0,12.0,1
2375,CC:2F:71:3E:C5:1F,2156920,273629926,119,14296,2156801,273615630,0,551,46158,465,35812,86,10346,130,1,202,9,0,29,130000.0,39000.0,-72.0,-76.0,-72.0,-71.0,-71.0,-69.0,-67.0,-61.0,-75.0,-80.0,-75.0,-82.0,3.0,4.0,3.0,11.0,1
2376,CC:2F:71:3F:1F:24,2512493,738960988,355692,465345358,2156801,273615630,8,271865,338001452,271709,337980170,156,21282,265297,565,355748,35959,8,2819,144444.0,43333.0,-67.0,-62.0,-71.0,-69.0,-67.0,-62.0,-71.0,-68.0,-75.0,-80.0,-75.0,-82.0,8.0,18.0,4.0,13.0,1
2377,F8:59:71:5A:E0:3D,2302893,496546954,146090,222931122,2156803,273615832,354,106075,149237845,105965,149221748,110,16097,105482,42,146096,9344,354,229,144444.0,43333.0,-65.0,-71.0,-64.0,-70.0,-65.0,-71.0,-64.0,-70.0,-75.0,-80.0,-75.0,-82.0,10.0,9.0,11.0,12.0,1
2378,CC:2F:71:3E:C5:1F,2156922,273630128,119,14296,2156803,273615832,0,551,46158,465,35812,86,10346,130,1,202,9,0,29,130000.0,39000.0,-72.0,-76.0,-72.0,-71.0,-71.0,-69.0,-67.0,-61.0,-75.0,-80.0,-75.0,-82.0,3.0,4.0,3.0,11.0,1
2379,CC:2F:71:3F:1F:24,2512672,739175147,355869,465559315,2156803,273615832,8,272023,338205979,271867,338184697,156,21282,265455,565,355925,35990,8,2819,144444.0,43333.0,-68.0,-62.0,-71.0,-69.0,-67.0,-62.0,-71.0,-68.0,-75.0,-80.0,-75.0,-82.0,7.0,18.0,4.0,13.0,1
2380,F8:59:71:5A:E0:3D,2302973,496654151,146164,223037713,2156809,273616438,354,106148,149345709,106038,149329612,110,16097,105555,42,146170,9344,354,229,144444.0,43333.0,-65.0,-71.0,-63.0,-69.0,-65.0,-70.0,-63.0,-69.0,-75.0,-80.0,-75.0,-82.0,10.0,9.0,12.0,13.0,1
2381,CC:2F:71:3E:C5:1F,2156932,273631269,119,14296,2156813,273616973,0,551,46158,465,35812,86,10346,130,1,202,9,0,29,130000.0,39000.0,-72.0,-76.0,-72.0,-71.0,-71.0,-69.0,-67.0,-61.0,-75.0,-80.0,-75.0,-82.0,3.0,4.0,3.0,11.0,1
2382,CC:2F:71:3F:1F:24,2513210,739909744,356397,466292771,2156813,273616973,8,272289,338516081,272133,338494799,156,21282,265721,565,356453,36131,8,2831,144444.0,43333.0,-68.0,-62.0,-71.0,-69.0,-67.0,-62.0,-70.0,-69.0,-75.0,-80.0,-75.0,-82.0,7.0,18.0,4.0,13.0,1
2383,F8:59:71:5A:E0:3D,2303184,496974764,146371,223357791,2156813,273616973,354,106263,149497677,106153,149481580,110,16097,105670,42,146377,9345,354,230,144444.0,43333.0,-66.0,-71.0,-64.0,-70.0,-65.0,-70.0,-64.0,-69.0,-75.0,-80.0,-75.0,-82.0,9.0,9.0,11.0,12.0,1
2384,CC:2F:71:3E:C5:1F,2156932,273631269,119,14296,2156813,273616973,0,551,46158,465,35812,86,10346,130,1,202,9,0,29,130000.0,39000.0,-72.0,-76.0,-72.0,-71.0,-71.0,-69.0,-67.0,-61.0,-75.0,-80.0,-75.0,-82.0,3.0,4.0,3.0,11.0,1
2385,CC:2F:71:3F:1F:24,2513404,740152006,356589,466534665,2156815,273617341,8,272465,338747701,272309,338726419,156,21282,265897,565,356645,36133,8,2832,144444.0,43333.0,-68.0,-62.0,-71.0,-69.0,-68.0,-62.0,-70.0,-68.0,-75.0,-80.0,-75.0,-82.0,7.0,18.0,4.0,13.0,1
2386,F8:59:71:5A:E0:3D,2303266,497087886,146445,223469939,2156821,273617947,354,106334,149604589,106224,149588492,110,16097,105741,42,146451,9347,354,231,144444.0,43333.0,-62.0,-72.0,-64.0,-70.0,-64.0,-71.0,-64.0,-69.0,-75.0,-80.0,-75.0,-82.0,13.0,8.0,11.0,12.0,1
2387,CC:2F:71:3E:C5:1F,2156942,273632445,119,14296,2156823,273618149,0,551,46158,465,35812,86,10346,130,1,202,9,0,29,130000.0,39000.0,-72.0,-76.0,-72.0,-71.0,-71.0,-69.0,-67.0,-61.0,-75.0,-80.0,-75.0,-82.0,3.0,4.0,3.0,11.0,1
2388,CC:2F:71:3F:1F:24,2513575,740368276,356752,466750127,2156823,273618149,8,272618,338956007,272462,338934725,156,21282,266049,565,356807,36134,8,2832,144444.0,43333.0,-67.0,-62.0,-69.0,-69.0,-68.0,-62.0,-70.0,-69.0,-75.0,-80.0,-75.0,-82.0,8.0,18.0,6.0,13.0,1
2389,F8:59:71:5A:E0:3D,2303372,497245136,146546,223626725,2156826,273618411,354,106427,149747977,106317,149731880,110,16097,105834,42,146552,9353,354,231,144444.0,43333.0,-66.0,-72.0,-64.0,-70.0,-66.0,-71.0,-64.0,-69.0,-75.0,-80.0,-75.0,-82.0,9.0,8.0,11.0,12.0,1
2390,CC:2F:71:3E:C5:1F,2156951,273633313,119,14296,2156832,273619017,0,551,46158,465,35812,86,10346,130,1,202,9,0,29,130000.0,39000.0,-72.0,-76.0,-72.0,-71.0,-71.0,-69.0,-67.0,-61.0,-75.0,-80.0,-75.0,-82.0,3.0,4.0,3.0,11.0,1
2391,CC:2F:71:3F:1F:24,2514219,741269673,357387,467650656,2156832,273619017,8,273007,339440041,272851,339418759,156,21282,266437,565,357442,36228,8,2856,130000.0,43333.0,-68.0,-62.0,-71.0,-68.0,-68.0,-62.0,-70.0,-68.0,-75.0,-80.0,-75.0,-82.0,7.0,18.0,4.0,14.0,1
2392,F8:59:71:5A:E0:3D,2303706,497755821,146874,224136804,2156832,273619017,354,106597,149949591,106487,149933494,110,16097,106004,42,146880,9354,354,231,144444.0,43333.0,-65.0,-73.0,-64.0,-70.0,-64.0,-71.0,-63.0,-69.0,-75.0,-80.0,-75.0,-82.0,10.0,7.0,11.0,12.0,1
2393,CC:2F:71:3E:C5:1F,2156954,273633575,119,14296,2156835,273619279,0,551,46158,465,35812,86,10346,130,1,202,9,0,29,130000.0,39000.0,-72.0,-76.0,-72.0,-71.0,-71.0,-69.0,-67.0,-61.0,-75.0,-80.0,-75.0,-82.0,3.0,4.0,3.0,11.0,1
2394,CC:2F:71:3F:1F:24,2514394,741491889,357559,467872610,2156835,273619279,8,273165,339645433,273009,339624151,156,21282,266595,565,357615,36230,8,2863,144444.0,39000.0,-68.0,-63.0,-70.0,-70.0,-68.0,-63.0,-70.0,-69.0,-75.0,-80.0,-75.0,-82.0,7.0,17.0,5.0,12.0,1
2395,F8:59:71:5A:E0:3D,2303815,497904781,146974,224284896,2156841,273619885,354,106677,150063683,106567,150047586,110,16097,106084,42,146980,9354,354,231,144444.0,43333.0,-66.0,-72.0,-61.0,-70.0,-64.0,-71.0,-63.0,-69.0,-75.0,-80.0,-75.0,-82.0,9.0,8.0,14.0,12.0,1
2396,CC:2F:71:3E:C5:1F,2156960,273634181,119,14296,2156841,273619885,0,551,46158,465,35812,86,10346,130,1,202,9,0,29,130000.0,39000.0,-72.0,-76.0,-72.0,-71.0,-71.0,-69.0,-67.0,-61.0,-75.0,-80.0,-75.0,-82.0,3.0,4.0,3.0,11.0,1
2397,CC:2F:71:3F:1F:24,2514581,741730755,357740,468110870,2156841,273619885,8,273333,339876745,273177,339855463,156,21282,266763,565,357796,36231,8,2863,144444.0,43333.0,-68.0,-63.0,-71.0,-69.0,-68.0,-63.0,-70.0,-69.0,-75.0,-80.0,-75.0,-82.0,7.0,17.0,4.0,13.0,1
2398,F8:59:71:5A:E0:3D,2303891,498018457,147050,224398572,2156841,273619885,354,106753,150176923,106643,150160826,110,16097,106160,42,147056,9354,354,231,144444.0,43333.0,-66.0,-72.0,-63.0,-70.0,-66.0,-71.0,-63.0,-70.0,-75.0,-80.0,-75.0,-82.0,9.0,8.0,12.0,12.0,1
2399,CC:2F:71:3E:C5:1F,2156962,273634383,119,14296,2156843,273620087,0,551,46158,465,35812,86,10346,130,1,202,9,0,29,130000.0,39000.0,-72.0,-76.0,-72.0,-71.0,-71.0,-69.0,-67.0,-61.0,-75.0,-80.0,-75.0,-82.0,3.0,4.0,3.0,11.0,1
2400,CC:2F:71:3F:1F:24,2514747,741946549,357904,468326462,2156843,273620087,8,273482,340080263,273326,340058981,156,21282,266912,565,357960,36236,8,2864,144444.0,43333.0,-68.0,-63.0,-71.0,-68.0,-67.0,-62.0,-70.0,-68.0,-75.0,-80.0,-75.0,-82.0,7.0,17.0,4.0,14.0,1
2401,F8:59:71:5A:E0:3D,2303962,498115673,147112,224494920,2156850,273620753,354,106815,150272403,106705,150256306,110,16097,106222,42,147118,9355,354,231,144444.0,43333.0,-67.0,-72.0,-64.0,-71.0,-66.0,-71.0,-63.0,-70.0,-75.0,-81.0,-75.0,-82.0,8.0,9.0,11.0,11.0,1
2402,CC:2F:71:3E:C5:1F,2156969,273635049,119,14296,2156850,273620753,0,551,46158,465,35812,86,10346,130,1,202,9,0,29,130000.0,39000.0,-72.0,-76.0,-72.0,-71.0,-71.0,-69.0,-67.0,-61.0,-75.0,-81.0,-75.0,-82.0,3.0,5.0,3.0,11.0,1
2403,CC:2F:71:3F:1F:24,2514923,742169281,358073,468548528,2156850,273620753,8,273637,340293019,273481,340271737,156,21282,267065,565,358129,36237,8,2864,144444.0,43333.0,-68.0,-63.0,-70.0,-69.0,-68.0,-63.0,-70.0,-68.0,-75.0,-81.0,-75.0,-82.0,7.0,18.0,5.0,13.0,1
2404,F8:59:71:5A:E0:3D,2304061,498263790,147209,224642835,2156852,273620955,354,106911,150416238,106801,150400141,110,16097,106318,42,147215,9358,354,231,144444.0,43333.0,-65.0,-72.0,-64.0,-70.0,-65.0,-71.0,-63.0,-69.0,-75.0,-81.0,-75.0,-82.0,10.0,9.0,11.0,12.0,1
2405,CC:2F:71:3E:C5:1F,2156975,273635655,119,14296,2156856,273621359,0,551,46158,465,35812,86,10346,130,1,202,9,0,29,130000.0,39000.0,-72.0,-76.0,-72.0,-71.0,-71.0,-69.0,-67.0,-61.0,-75.0,-81.0,-75.0,-82.0,3.0,5.0,3.0,11.0,1
2406,CC:2F:71:3F:1F:24,2515168,742494496,358312,468873137,2156856,273621359,8,273871,340622741,273715,340601459,156,21282,267290,565,358368,36244,8,2880,144444.0,43333.0,-69.0,-62.0,-70.0,-68.0,-69.0,-62.0,-70.0,-68.0,-75.0,-81.0,-75.0,-82.0,6.0,19.0,5.0,14.0,1
2407,F8:59:71:5A:E0:3D,2304142,498379452,147283,224757831,2156859,273621621,354,106988,150534818,106878,150518721,110,16097,106395,42,147289,9358,354,231,144444.0,43333.0,-65.0,-72.0,-61.0,-69.0,-65.0,-71.0,-64.0,-69.0,-75.0,-81.0,-75.0,-83.0,10.0,9.0,14.0,14.0,1
2408,CC:2F:71:3E:C5:1F,2156978,273635917,119,14296,2156859,273621621,0,551,46158,465,35812,86,10346,130,1,202,9,0,29,130000.0,39000.0,-72.0,-76.0,-72.0,-71.0,-71.0,-69.0,-67.0,-61.0,-75.0,-81.0,-75.0,-83.0,3.0,5.0,3.0,12.0,1
2409,CC:2F:71:3F:1F:24,2515357,742718046,358498,469096425,2156859,273621621,8,274051,340846695,273895,340825413,156,21282,267462,565,358554,36294,8,2880,144444.0,43333.0,-71.0,-61.0,-72.0,-69.0,-70.0,-61.0,-72.0,-69.0,-75.0,-81.0,-75.0,-83.0,4.0,20.0,3.0,14.0,1
2410,F8:59:71:5A:E0:3D,2304698,499218936,147823,225595568,2156875,273623368,354,107259,150873834,107149,150857737,110,16097,106666,42,147829,9358,354,237,144444.0,43333.0,-64.0,-72.0,-63.0,-69.0,-64.0,-72.0,-63.0,-69.0,-75.0,-81.0,-76.0,-83.0,11.0,9.0,13.0,14.0,1
2411,CC:2F:71:3E:C5:1F,2156997,273637982,120,14412,2156877,273623570,0,553,46298,467,35952,86,10346,130,1,204,9,0,29,130000.0,39000.0,-71.0,-76.0,-72.0,-70.0,-71.0,-70.0,-68.0,-62.0,-75.0,-81.0,-76.0,-83.0,4.0,5.0,4.0,13.0,1
2412,CC:2F:71:3F:1F:24,2516373,744130209,359496,470506639,2156877,273623570,8,274717,341677898,274561,341656616,156,21282,268095,565,359552,36508,8,2936,130000.0,43333.0,-67.0,-60.0,-72.0,-68.0,-67.0,-60.0,-72.0,-68.0,-75.0,-81.0,-76.0,-83.0,8.0,21.0,4.0,15.0,1
2413,F8:59:71:5A:E0:3D,2304806,499378108,147927,225754336,2156879,273623772,354,107373,151047078,107263,151030981,110,16097,106773,42,147933,9359,354,239,144444.0,43333.0,-64.0,-71.0,-63.0,-69.0,-64.0,-69.0,-63.0,-69.0,-75.0,-81.0,-76.0,-83.0,11.0,10.0,13.0,14.0,1
2414,CC:2F:71:3E:C5:1F,2156999,273638184,120,14412,2156879,273623772,0,553,46298,467,35952,86,10346,130,1,204,9,0,29,130000.0,39000.0,-71.0,-76.0,-72.0,-70.0,-71.0,-70.0,-68.0,-62.0,-75.0,-81.0,-76.0,-83.0,4.0,5.0,4.0,13.0,1
2415,CC:2F:71:3F:1F:24,2516814,744734501,359935,471110729,2156879,273623772,8,274979,341929056,274823,341907774,156,21282,268354,565,359991,36585,8,2940,115556.0,28889.0,-70.0,-61.0,-72.0,-70.0,-69.0,-61.0,-72.0,-70.0,-75.0,-81.0,-76.0,-83.0,5.0,20.0,4.0,13.0,1
2416,F8:59:71:5A:E0:3D,2304885,499489277,147999,225864839,2156886,273624438,354,107443,151152111,107333,151136014,110,16097,106843,42,148005,9359,354,240,144444.0,43333.0,-66.0,-67.0,-65.0,-68.0,-65.0,-71.0,-64.0,-68.0,-75.0,-81.0,-76.0,-83.0,9.0,14.0,11.0,15.0,1
2417,CC:2F:71:3E:C5:1F,2157006,273638850,120,14412,2156886,273624438,0,553,46298,467,35952,86,10346,130,1,204,9,0,29,130000.0,39000.0,-71.0,-76.0,-72.0,-70.0,-71.0,-70.0,-68.0,-62.0,-75.0,-81.0,-76.0,-83.0,4.0,5.0,4.0,13.0,1
2418,CC:2F:71:3F:1F:24,2516987,744945384,360101,471320946,2156886,273624438,8,275136,342136534,274980,342115252,156,21282,268511,565,360156,36586,8,2942,115556.0,28889.0,-68.0,-63.0,-72.0,-70.0,-67.0,-62.0,-71.0,-69.0,-75.0,-81.0,-76.0,-83.0,7.0,18.0,4.0,13.0,1
2419,F8:59:71:5A:E0:3D,2304953,499592043,148065,225967403,2156888,273624640,354,107509,151254213,107399,151238116,110,16097,106908,42,148071,9359,354,243,144444.0,43333.0,-65.0,-68.0,-64.0,-69.0,-65.0,-70.0,-63.0,-68.0,-76.0,-81.0,-76.0,-83.0,11.0,13.0,12.0,14.0,1
2420,CC:2F:71:3E:C5:1F,2157008,273639052,120,14412,2156888,273624640,0,553,46298,467,35952,86,10346,130,1,204,9,0,29,130000.0,39000.0,-71.0,-76.0,-72.0,-70.0,-71.0,-70.0,-68.0,-62.0,-76.0,-81.0,-76.0,-83.0,5.0,5.0,4.0,13.0,1
2421,CC:2F:71:3F:1F:24,2517238,745266427,360350,471641787,2156888,273624640,8,275324,342349241,275168,342327959,156,21282,268699,565,360406,36591,8,2942,130000.0,43333.0,-67.0,-63.0,-71.0,-68.0,-67.0,-63.0,-70.0,-68.0,-76.0,-81.0,-76.0,-83.0,9.0,18.0,5.0,15.0,1
2422,F8:59:71:5A:E0:3D,2305062,499745771,148170,226120727,2156892,273625044,354,107586,151362273,107476,151346176,110,16097,106985,42,148176,9359,354,243,144444.0,43333.0,-65.0,-72.0,-64.0,-70.0,-65.0,-71.0,-64.0,-69.0,-76.0,-81.0,-76.0,-83.0,11.0,9.0,12.0,13.0,1
2423,CC:2F:71:3E:C5:1F,2157014,273639658,120,14412,2156894,273625246,0,553,46298,467,35952,86,10346,130,1,204,9,0,29,130000.0,39000.0,-71.0,-76.0,-72.0,-70.0,-71.0,-70.0,-68.0,-62.0,-76.0,-81.0,-76.0,-83.0,5.0,5.0,4.0,13.0,1
2424,CC:2F:71:3F:1F:24,2517411,745477186,360517,471851940,2156894,273625246,8,275472,342549798,275316,342528516,156,21282,268847,565,360572,36595,8,2942,130000.0,43333.0,-70.0,-62.0,-72.0,-70.0,-70.0,-61.0,-72.0,-69.0,-76.0,-81.0,-76.0,-83.0,6.0,19.0,4.0,13.0,1
2425,F8:59:71:5A:E0:3D,2305304,500104733,148407,226479225,2156897,273625508,354,107702,151485733,107592,151469636,110,16097,107101,42,148413,9371,354,243,144444.0,43333.0,-66.0,-73.0,-65.0,-70.0,-65.0,-71.0,-63.0,-69.0,-76.0,-81.0,-76.0,-83.0,10.0,8.0,11.0,13.0,1
2426,CC:2F:71:3E:C5:1F,2157017,273639920,120,14412,2156897,273625508,0,553,46298,467,35952,86,10346,130,1,204,9,0,29,130000.0,39000.0,-71.0,-76.0,-72.0,-70.0,-71.0,-70.0,-68.0,-62.0,-76.0,-81.0,-76.0,-83.0,5.0,5.0,4.0,13.0,1
2427,CC:2F:71:3F:1F:24,2517737,745894160,360840,472268652,2156897,273625508,8,275695,342805987,275539,342784705,156,21282,269069,565,360896,36603,8,2945,130000.0,43333.0,-69.0,-63.0,-72.0,-71.0,-68.0,-63.0,-71.0,-71.0,-76.0,-81.0,-76.0,-83.0,7.0,18.0,4.0,12.0,1
2428,F8:59:71:5A:E0:3D,2305409,500250585,148504,226624347,2156905,273626238,354,107802,151633553,107691,151617338,111,16215,107201,42,148510,9371,354,243,144444.0,43333.0,-65.0,-72.0,-65.0,-70.0,-64.0,-70.0,-64.0,-69.0,-76.0,-81.0,-76.0,-83.0,11.0,9.0,11.0,13.0,1
2429,CC:2F:71:3E:C5:1F,2157025,273640650,120,14412,2156905,273626238,0,553,46298,467,35952,86,10346,130,1,204,9,0,29,130000.0,39000.0,-71.0,-76.0,-72.0,-70.0,-71.0,-70.0,-68.0,-62.0,-76.0,-81.0,-76.0,-83.0,5.0,5.0,4.0,13.0,1
2430,CC:2F:71:3F:1F:24,2519614,748571731,362709,474945493,2156905,273626238,8,276221,343162424,276064,343141024,157,21400,269594,565,362757,37003,8,2955,78000.0,13000.0,-68.0,-62.0,-72.0,-68.0,-67.0,-61.0,-71.0,-68.0,-76.0,-81.0,-76.0,-83.0,8.0,19.0,4.0,15.0,1
2431,F8:59:71:5A:E0:3D,2305499,500381719,148588,226754883,2156911,273626836,354,107885,151761373,107774,151745158,111,16215,107284,42,148594,9371,354,243,144444.0,43333.0,-65.0,-72.0,-65.0,-70.0,-64.0,-70.0,-64.0,-69.0,-76.0,-81.0,-76.0,-83.0,11.0,9.0,11.0,13.0,1
2432,CC:2F:71:3E:C5:1F,2157033,273641378,120,14412,2156913,273626966,0,555,46486,468,36022,87,10464,131,1,204,9,0,29,130000.0,39000.0,-68.0,-70.0,-66.0,-60.0,-70.0,-70.0,-67.0,-62.0,-76.0,-81.0,-76.0,-83.0,8.0,11.0,10.0,23.0,1
2433,CC:2F:71:3F:1F:24,2520929,750463761,364014,476836593,2156915,273627168,8,276628,343510385,276471,343488985,157,21400,270000,565,364070,37106,8,2987,130000.0,39000.0,-69.0,-62.0,-71.0,-69.0,-68.0,-62.0,-71.0,-69.0,-76.0,-81.0,-76.0,-83.0,7.0,19.0,5.0,14.0,1
2434,F8:59:71:5A:E0:3D,2305639,500580600,148720,226953028,2156919,273627572,354,108015,151958087,107904,151941872,111,16215,107414,42,148726,9374,354,243,144444.0,43333.0,-65.0,-71.0,-65.0,-69.0,-64.0,-71.0,-64.0,-69.0,-76.0,-81.0,-76.0,-83.0,11.0,10.0,11.0,14.0,1
2435,CC:2F:71:3E:C5:1F,2157040,273642044,120,14412,2156920,273627632,0,555,46486,468,36022,87,10464,131,1,204,9,0,29,130000.0,39000.0,-68.0,-70.0,-66.0,-60.0,-70.0,-70.0,-67.0,-62.0,-76.0,-82.0,-76.0,-84.0,8.0,12.0,10.0,24.0,1
2436,CC:2F:71:3F:1F:24,2522049,752031598,365127,478403764,2156922,273627834,8,277025,343840006,276868,343818606,157,21400,270397,565,365182,37295,8,3016,130000.0,43333.0,-69.0,-62.0,-72.0,-69.0,-68.0,-61.0,-71.0,-68.0,-76.0,-82.0,-76.0,-84.0,7.0,20.0,4.0,15.0,1
2437,F8:59:71:5A:E0:3D,2305707,500678966,148783,227050930,2156924,273628036,354,108078,152055107,107967,152038892,111,16215,107477,42,148789,9374,354,243,144444.0,43333.0,-64.0,-72.0,-65.0,-69.0,-65.0,-71.0,-64.0,-69.0,-76.0,-82.0,-76.0,-84.0,12.0,10.0,11.0,15.0,1
2438,CC:2F:71:3E:C5:1F,2157044,273642448,120,14412,2156924,273628036,0,555,46486,468,36022,87,10464,131,1,204,9,0,29,130000.0,39000.0,-68.0,-70.0,-66.0,-60.0,-70.0,-70.0,-67.0,-62.0,-76.0,-82.0,-76.0,-84.0,8.0,12.0,10.0,24.0,1
2439,CC:2F:71:3F:1F:24,2522259,752293450,365335,478665414,2156924,273628036,8,277220,344099241,277063,344077841,157,21400,270592,565,365391,37348,8,3020,130000.0,39000.0,-69.0,-62.0,-72.0,-69.0,-68.0,-62.0,-70.0,-69.0,-76.0,-82.0,-76.0,-84.0,7.0,20.0,4.0,15.0,1
2440,F8:59:71:5A:E0:3D,2306264,501524884,149330,227895707,2156934,273629177,354,108289,152287688,108178,152271473,111,16215,107687,42,149336,9446,354,245,144444.0,43333.0,-62.0,-71.0,-65.0,-69.0,-64.0,-70.0,-64.0,-69.0,-76.0,-82.0,-76.0,-84.0,14.0,11.0,11.0,15.0,1
2441,CC:2F:71:3E:C5:1F,2157056,273643791,120,14412,2156936,273629379,0,555,46486,468,36022,87,10464,131,1,204,9,0,29,130000.0,39000.0,-68.0,-70.0,-66.0,-60.0,-70.0,-70.0,-67.0,-62.0,-76.0,-82.0,-76.0,-84.0,8.0,12.0,10.0,24.0,1
2442,CC:2F:71:3F:1F:24,2524093,754678668,367155,481049087,2156938,273629581,8,278076,344812614,277919,344791214,157,21400,271447,565,367191,37733,8,3064,115556.0,28889.0,-69.0,-62.0,-72.0,-69.0,-68.0,-61.0,-71.0,-68.0,-76.0,-82.0,-76.0,-84.0,7.0,20.0,4.0,15.0,1
2443,F8:59:71:5A:E0:3D,2306460,501810596,149515,228180349,2156945,273630247,354,108465,152555922,108354,152539707,111,16215,107863,42,149521,9447,354,245,144444.0,43333.0,-61.0,-71.0,-64.0,-69.0,-63.0,-70.0,-64.0,-69.0,-76.0,-82.0,-76.0,-84.0,15.0,11.0,12.0,15.0,1
2444,CC:2F:71:3E:C5:1F,2157065,273644659,120,14412,2156945,273630247,0,555,46486,468,36022,87,10464,131,1,204,9,0,29,130000.0,39000.0,-68.0,-70.0,-66.0,-60.0,-70.0,-70.0,-67.0,-62.0,-76.0,-82.0,-76.0,-84.0,8.0,12.0,10.0,24.0,1
2445,CC:2F:71:3F:1F:24,2526196,757684037,369251,484053790,2156945,273630247,8,278767,345304764,278610,345283364,157,21400,272137,565,369303,37857,8,3095,115556.0,28889.0,-69.0,-62.0,-72.0,-69.0,-68.0,-62.0,-71.0,-69.0,-76.0,-82.0,-76.0,-84.0,7.0,20.0,4.0,15.0,1
2446,F8:59:71:5A:E0:3D,2306550,501944644,149601,228313993,2156949,273630651,354,108549,152685282,108438,152669067,111,16215,107947,42,149607,9447,354,245,144444.0,43333.0,-64.0,-71.0,-65.0,-70.0,-65.0,-71.0,-64.0,-69.0,-76.0,-82.0,-76.0,-84.0,12.0,11.0,11.0,14.0,1
2447,CC:2F:71:3E:C5:1F,2157069,273645063,120,14412,2156949,273630651,0,555,46486,468,36022,87,10464,131,1,204,9,0,29,130000.0,39000.0,-68.0,-70.0,-66.0,-60.0,-70.0,-70.0,-67.0,-62.0,-76.0,-82.0,-76.0,-84.0,8.0,12.0,10.0,24.0,1
2448,CC:2F:71:3F:1F:24,2526491,758018899,369540,484388046,2156951,273630853,8,278982,345526560,278825,345505160,157,21400,272352,565,369595,37865,8,3095,115556.0,28889.0,-69.0,-62.0,-72.0,-69.0,-68.0,-61.0,-71.0,-69.0,-76.0,-82.0,-76.0,-84.0,7.0,20.0,4.0,15.0,1
2449,F8:59:71:5A:E0:3D,2306619,502046058,149666,228415003,2156953,273631055,354,108614,152785382,108503,152769167,111,16215,108012,42,149672,9447,354,245,144444.0,43333.0,-65.0,-72.0,-64.0,-69.0,-64.0,-71.0,-64.0,-69.0,-76.0,-82.0,-76.0,-84.0,11.0,10.0,12.0,15.0,1
2450,CC:2F:71:3E:C5:1F,2157073,273645467,120,14412,2156953,273631055,0,555,46486,468,36022,87,10464,131,1,204,9,0,29,130000.0,39000.0,-68.0,-70.0,-66.0,-60.0,-70.0,-70.0,-67.0,-62.0,-76.0,-82.0,-76.0,-84.0,8.0,12.0,10.0,24.0,1
2451,CC:2F:71:3F:1F:24,2526651,758225369,369698,484594314,2156953,273631055,8,279127,345723876,278970,345702476,157,21400,272497,565,369754,37870,8,3095,115556.0,28889.0,-68.0,-62.0,-71.0,-69.0,-68.0,-61.0,-71.0,-68.0,-76.0,-82.0,-76.0,-84.0,8.0,20.0,5.0,15.0,1
2452,F8:59:71:5A:E0:3D,2306688,502144780,149730,228513261,2156958,273631519,354,108678,152882552,108567,152866337,111,16215,108076,42,149736,9447,354,245,144444.0,43333.0,-66.0,-68.0,-65.0,-69.0,-65.0,-71.0,-64.0,-68.0,-76.0,-82.0,-76.0,-84.0,10.0,14.0,11.0,15.0,1
2453,CC:2F:71:3E:C5:1F,2157078,273645931,120,14412,2156958,273631519,0,555,46486,468,36022,87,10464,131,1,204,9,0,29,130000.0,39000.0,-68.0,-70.0,-66.0,-60.0,-70.0,-70.0,-67.0,-62.0,-76.0,-82.0,-76.0,-84.0,8.0,12.0,10.0,24.0,1
2454,CC:2F:71:3F:1F:24,2526813,758430323,369855,484798804,2156958,273631519,8,279270,345918112,279113,345896712,157,21400,272640,565,369911,37878,8,3095,115556.0,28889.0,-69.0,-62.0,-72.0,-69.0,-68.0,-61.0,-71.0,-68.0,-76.0,-82.0,-76.0,-84.0,7.0,20.0,4.0,15.0,1
2455,F8:59:71:5A:E0:3D,2306932,502509255,149970,228877332,2156962,273631923,354,108790,153002628,108679,152986413,111,16215,108188,42,149976,9454,354,245,144444.0,43333.0,-66.0,-71.0,-64.0,-70.0,-64.0,-71.0,-64.0,-69.0,-76.0,-82.0,-76.0,-84.0,10.0,11.0,12.0,14.0,1
2456,CC:2F:71:3E:C5:1F,2157082,273646335,120,14412,2156962,273631923,0,555,46486,468,36022,87,10464,131,1,204,9,0,29,130000.0,39000.0,-68.0,-70.0,-66.0,-60.0,-70.0,-70.0,-67.0,-62.0,-76.0,-82.0,-76.0,-84.0,8.0,12.0,10.0,24.0,1
2457,CC:2F:71:3F:1F:24,2526999,758654574,370037,485022651,2156962,273631923,8,279442,346141812,279285,346120412,157,21400,272812,565,370093,37890,8,3095,115556.0,28889.0,-68.0,-62.0,-72.0,-70.0,-67.0,-61.0,-71.0,-69.0,-76.0,-82.0,-76.0,-84.0,8.0,20.0,4.0,14.0,1
2458,F8:59:71:5A:E0:3D,2307003,502613777,150037,228981450,2156966,273632327,354,108853,153099648,108742,153083433,111,16215,108251,42,150043,9456,354,245,144444.0,43333.0,-66.0,-71.0,-66.0,-69.0,-64.0,-71.0,-64.0,-69.0,-76.0,-82.0,-76.0,-84.0,10.0,11.0,10.0,15.0,1
2459,CC:2F:71:3E:C5:1F,2157087,273646799,120,14412,2156967,273632387,0,555,46486,468,36022,87,10464,131,1,204,9,0,29,130000.0,39000.0,-68.0,-70.0,-66.0,-60.0,-70.0,-70.0,-67.0,-62.0,-76.0,-82.0,-76.0,-84.0,8.0,12.0,10.0,24.0,1
2460,CC:2F:71:3F:1F:24,2527714,759561588,370745,485928999,2156969,273632589,8,279801,346476606,279644,346455206,157,21400,273170,565,370800,37995,8,3107,115556.0,28889.0,-68.0,-62.0,-72.0,-70.0,-67.0,-62.0,-71.0,-69.0,-76.0,-82.0,-76.0,-84.0,8.0,20.0,4.0,14.0,1
2461,F8:59:71:5A:E0:3D,2307104,502759221,150133,229126430,2156971,273632791,354,108953,153249848,108842,153233633,111,16215,108351,42,150139,9458,354,245,144444.0,43333.0,-62.0,-72.0,-65.0,-69.0,-64.0,-71.0,-64.0,-69.0,-76.0,-82.0,-76.0,-84.0,14.0,10.0,11.0,15.0,1
2462,CC:2F:71:3E:C5:1F,2157091,273647203,120,14412,2156971,273632791,0,555,46486,468,36022,87,10464,131,1,204,9,0,29,130000.0,39000.0,-68.0,-70.0,-66.0,-60.0,-70.0,-70.0,-67.0,-62.0,-76.0,-82.0,-76.0,-83.0,8.0,12.0,10.0,23.0,1
2463,CC:2F:71:3F:1F:24,2527896,759790409,370925,486157618,2156971,273632791,8,279962,346687708,279805,346666308,157,21400,273331,565,370981,38025,8,3107,115556.0,28889.0,-66.0,-62.0,-71.0,-70.0,-67.0,-62.0,-71.0,-70.0,-76.0,-82.0,-76.0,-83.0,10.0,20.0,5.0,13.0,1
2464,F8:59:71:5A:E0:3D,2307196,502893471,150219,229260074,2156977,273633397,354,109039,153382344,108928,153366129,111,16215,108437,42,150225,9459,354,246,144444.0,43333.0,-65.0,-71.0,-64.0,-69.0,-64.0,-71.0,-64.0,-69.0,-76.0,-82.0,-76.0,-83.0,11.0,11.0,12.0,14.0,1
2465,CC:2F:71:3E:C5:1F,2157097,273647809,120,14412,2156977,273633397,0,555,46486,468,36022,87,10464,131,1,204,9,0,29,130000.0,39000.0,-68.0,-70.0,-66.0,-60.0,-70.0,-70.0,-67.0,-62.0,-76.0,-82.0,-76.0,-83.0,8.0,12.0,10.0,23.0,1
2466,CC:2F:71:3F:1F:24,2528147,760083495,371169,486450038,2156978,273633457,8,280198,346973806,280041,346952406,157,21400,273567,565,371225,38070,8,3114,115556.0,28889.0,-67.0,-62.0,-72.0,-70.0,-67.0,-62.0,-72.0,-70.0,-76.0,-82.0,-76.0,-83.0,9.0,20.0,4.0,13.0,1
2467,F8:59:71:5A:E0:3D,2307264,502994743,150284,229361084,2156980,273633659,354,109104,153482444,108993,153466229,111,16215,108502,42,150290,9460,354,246,144444.0,43333.0,-66.0,-71.0,-65.0,-69.0,-63.0,-70.0,-64.0,-69.0,-76.0,-82.0,-76.0,-83.0,10.0,11.0,11.0,14.0,1
2468,CC:2F:71:3E:C5:1F,2157102,273648273,120,14412,2156982,273633861,0,555,46486,468,36022,87,10464,131,1,204,9,0,29,130000.0,39000.0,-68.0,-70.0,-66.0,-60.0,-70.0,-70.0,-67.0,-62.0,-76.0,-82.0,-76.0,-83.0,8.0,12.0,10.0,23.0,1
2469,CC:2F:71:3F:1F:24,2528328,760302688,371344,486668625,2156984,273634063,8,280355,347183881,280198,347162481,157,21400,273724,565,371399,38127,8,3114,115556.0,28889.0,-67.0,-62.0,-72.0,-70.0,-67.0,-62.0,-72.0,-70.0,-76.0,-82.0,-76.0,-83.0,9.0,20.0,4.0,13.0,1
2470,F8:59:71:5A:E0:3D,2307474,503309445,150488,229675180,2156986,273634265,354,109199,153603504,109088,153587289,111,16215,108597,42,150494,9494,354,246,144444.0,43333.0,-66.0,-68.0,-65.0,-69.0,-65.0,-70.0,-64.0,-69.0,-76.0,-82.0,-76.0,-83.0,10.0,14.0,11.0,14.0,1
2471,CC:2F:71:3E:C5:1F,2157107,273648793,121,14528,2156986,273634265,0,557,46626,470,36162,87,10464,131,1,206,9,0,29,130000.0,39000.0,-69.0,-70.0,-67.0,-60.0,-70.0,-71.0,-68.0,-62.0,-76.0,-82.0,-76.0,-83.0,7.0,12.0,9.0,23.0,1
2472,CC:2F:71:3F:1F:24,2528525,760540373,371537,486905906,2156988,273634467,8,280534,347422190,280377,347400790,157,21400,273902,565,371593,38167,8,3128,86667.0,14444.0,-67.0,-62.0,-72.0,-70.0,-66.0,-62.0,-71.0,-70.0,-76.0,-82.0,-76.0,-83.0,9.0,20.0,4.0,13.0,1
2473,F8:59:71:5A:E0:3D,2307793,503802316,150803,230167516,2156990,273634800,354,109317,153711684,109206,153695469,111,16215,108715,42,150809,9494,354,246,130000.0,39000.0,-65.0,-72.0,-65.0,-70.0,-64.0,-71.0,-64.0,-69.0,-76.0,-82.0,-76.0,-83.0,11.0,10.0,11.0,13.0,1
2474,CC:2F:71:3E:C5:1F,2157113,273649530,121,14528,2156992,273635002,0,557,46626,470,36162,87,10464,131,1,206,9,0,29,130000.0,39000.0,-69.0,-70.0,-67.0,-60.0,-70.0,-71.0,-68.0,-62.0,-76.0,-82.0,-76.0,-83.0,7.0,12.0,9.0,23.0,1
2475,CC:2F:71:3F:1F:24,2528697,760750819,371703,487115615,2156994,273635204,8,280681,347618554,280524,347597154,157,21400,274048,565,371759,38170,8,3129,86667.0,14444.0,-67.0,-62.0,-72.0,-70.0,-67.0,-62.0,-71.0,-70.0,-76.0,-82.0,-76.0,-83.0,9.0,20.0,4.0,13.0,1
2476,F8:59:71:5A:E0:3D,2307860,503899072,150866,230263868,2156994,273635204,354,109381,153808810,109270,153792595,111,16215,108779,42,150872,9494,354,246,144444.0,43333.0,-65.0,-69.0,-64.0,-70.0,-64.0,-71.0,-63.0,-69.0,-76.0,-82.0,-76.0,-83.0,11.0,13.0,12.0,13.0,1
2477,CC:2F:71:3E:C5:1F,2157115,273649732,121,14528,2156994,273635204,0,557,46626,470,36162,87,10464,131,1,206,9,0,29,130000.0,39000.0,-69.0,-70.0,-67.0,-60.0,-70.0,-71.0,-68.0,-62.0,-76.0,-82.0,-76.0,-83.0,7.0,12.0,9.0,23.0,1
2478,CC:2F:71:3F:1F:24,2528880,760964300,371884,487328728,2156996,273635572,8,280854,347827117,280697,347805717,157,21400,274220,565,371940,38170,8,3129,65000.0,13000.0,-67.0,-62.0,-72.0,-70.0,-67.0,-62.0,-72.0,-70.0,-76.0,-82.0,-76.0,-83.0,9.0,20.0,4.0,13.0,1
2479,F8:59:71:5A:E0:3D,2307959,504034214,150954,230397772,2157005,273636442,354,109473,153946220,109361,153929887,112,16333,108871,42,150960,9495,354,247,144444.0,43333.0,-66.0,-71.0,-65.0,-69.0,-65.0,-71.0,-64.0,-69.0,-76.0,-82.0,-76.0,-83.0,10.0,11.0,11.0,14.0,1
2480,CC:2F:71:3E:C5:1F,2157126,273650970,121,14528,2157005,273636442,0,557,46626,470,36162,87,10464,131,1,206,9,0,29,130000.0,39000.0,-69.0,-70.0,-67.0,-60.0,-70.0,-71.0,-68.0,-62.0,-76.0,-82.0,-76.0,-83.0,7.0,12.0,9.0,23.0,1
2481,CC:2F:71:3F:1F:24,2529603,761971605,372597,488335103,2157006,273636502,8,281196,348149564,281039,348128164,157,21400,274562,565,372643,38282,8,3136,86667.0,14444.0,-66.0,-62.0,-71.0,-69.0,-66.0,-62.0,-71.0,-69.0,-76.0,-82.0,-76.0,-83.0,10.0,20.0,5.0,14.0,1
2482,F8:59:71:5A:E0:3D,2308280,504512536,151266,230875226,2157014,273637310,354,109659,154178702,109547,154162369,112,16333,109057,42,151272,9510,354,247,144444.0,43333.0,-65.0,-72.0,-64.0,-69.0,-64.0,-71.0,-63.0,-69.0,-76.0,-82.0,-76.0,-84.0,11.0,10.0,12.0,15.0,1
2483,CC:2F:71:3E:C5:1F,2157135,273651838,121,14528,2157014,273637310,0,557,46626,470,36162,87,10464,131,1,206,9,0,29,130000.0,39000.0,-69.0,-70.0,-67.0,-60.0,-70.0,-71.0,-68.0,-62.0,-76.0,-82.0,-76.0,-84.0,7.0,12.0,9.0,24.0,1
2484,CC:2F:71:3F:1F:24,2530572,763338106,373558,489700796,2157014,273637310,8,281632,348598716,281475,348577316,157,21400,274995,565,373613,38495,8,3163,115556.0,28889.0,-67.0,-62.0,-72.0,-70.0,-66.0,-62.0,-71.0,-70.0,-76.0,-82.0,-76.0,-84.0,9.0,20.0,4.0,14.0,1
2485,F8:59:71:5A:E0:3D,2308353,504618672,151334,230980898,2157019,273637774,354,109723,154277262,109611,154260929,112,16333,109121,42,151339,9510,354,247,144444.0,43333.0,-65.0,-72.0,-65.0,-70.0,-65.0,-70.0,-64.0,-69.0,-76.0,-82.0,-76.0,-84.0,11.0,10.0,11.0,14.0,1
2486,CC:2F:71:3E:C5:1F,2157140,273652302,121,14528,2157019,273637774,0,557,46626,470,36162,87,10464,131,1,206,9,0,29,130000.0,39000.0,-69.0,-70.0,-67.0,-60.0,-70.0,-71.0,-68.0,-62.0,-76.0,-82.0,-76.0,-84.0,7.0,12.0,9.0,24.0,1
2487,CC:2F:71:3F:1F:24,2530747,763564798,373728,489927024,2157019,273637774,8,281793,348819310,281636,348797910,157,21400,275153,565,373783,38509,8,3168,115556.0,28889.0,-67.0,-62.0,-72.0,-70.0,-66.0,-62.0,-71.0,-70.0,-76.0,-82.0,-76.0,-84.0,9.0,20.0,4.0,14.0,1
2488,F8:59:71:5A:E0:3D,2308457,504770339,151433,231132099,2157024,273638240,354,109799,154389008,109687,154372675,112,16333,109197,42,151439,9510,354,247,144444.0,43333.0,-66.0,-72.0,-65.0,-70.0,-65.0,-70.0,-64.0,-69.0,-76.0,-82.0,-76.0,-84.0,10.0,10.0,11.0,14.0,1
2489,CC:2F:71:3E:C5:1F,2157145,273652768,121,14528,2157024,273638240,0,557,46626,470,36162,87,10464,131,1,206,9,0,29,130000.0,39000.0,-69.0,-70.0,-67.0,-60.0,-70.0,-71.0,-68.0,-62.0,-76.0,-82.0,-76.0,-84.0,7.0,12.0,9.0,24.0,1
2490,CC:2F:71:3F:1F:24,2530926,763778613,373902,490140373,2157024,273638240,8,281950,349021231,281792,348999713,158,21518,275310,565,373958,38518,8,3168,117000.0,39000.0,-67.0,-62.0,-72.0,-70.0,-66.0,-62.0,-72.0,-70.0,-76.0,-82.0,-76.0,-84.0,9.0,20.0,4.0,14.0,1
2491,F8:59:71:5A:E0:3D,2308534,504874356,151506,231235712,2157028,273638644,354,109873,154495298,109761,154478965,112,16333,109271,42,151512,9510,354,247,144444.0,43333.0,-65.0,-72.0,-61.0,-69.0,-65.0,-71.0,-64.0,-69.0,-76.0,-82.0,-76.0,-84.0,11.0,10.0,15.0,15.0,1
2492,CC:2F:71:3E:C5:1F,2157149,273653172,121,14528,2157028,273638644,0,557,46626,470,36162,87,10464,131,1,206,9,0,29,130000.0,39000.0,-69.0,-70.0,-67.0,-60.0,-70.0,-71.0,-68.0,-62.0,-76.0,-82.0,-76.0,-84.0,7.0,12.0,9.0,24.0,1
2493,CC:2F:71:3F:1F:24,2531087,763983563,374059,490344919,2157028,273638644,8,282093,349218315,281935,349196797,158,21518,275453,565,374115,38523,8,3168,115556.0,28889.0,-70.0,-61.0,-72.0,-72.0,-69.0,-61.0,-71.0,-72.0,-76.0,-82.0,-76.0,-84.0,6.0,21.0,4.0,12.0,1
2494,F8:59:71:5A:E0:3D,2308614,504991370,151581,231352262,2157033,273639108,354,109952,154616958,109840,154600625,112,16333,109350,42,151587,9511,354,247,144444.0,43333.0,-66.0,-72.0,-64.0,-70.0,-65.0,-70.0,-64.0,-69.0,-76.0,-82.0,-76.0,-84.0,10.0,10.0,12.0,14.0,1
2495,CC:2F:71:3E:C5:1F,2157154,273653636,121,14528,2157033,273639108,0,557,46626,470,36162,87,10464,131,1,206,9,0,29,130000.0,39000.0,-69.0,-70.0,-67.0,-60.0,-70.0,-71.0,-68.0,-62.0,-76.0,-82.0,-76.0,-84.0,7.0,12.0,9.0,24.0,1
2496,CC:2F:71:3F:1F:24,2532119,765447331,375086,491808223,2157033,273639108,8,282425,349495248,282267,349473730,158,21518,275784,565,375142,38544,8,3172,144444.0,43333.0,-67.0,-61.0,-73.0,-69.0,-67.0,-61.0,-72.0,-69.0,-76.0,-82.0,-76.0,-84.0,9.0,21.0,3.0,15.0,1
2497,F8:59:71:5A:E0:3D,2308688,505100554,151651,231461042,2157037,273639512,354,110015,154713978,109903,154697645,112,16333,109413,42,151656,9512,354,247,144444.0,43333.0,-65.0,-72.0,-61.0,-70.0,-64.0,-70.0,-63.0,-69.0,-76.0,-82.0,-76.0,-84.0,11.0,10.0,15.0,14.0,1
2498,CC:2F:71:3E:C5:1F,2157158,273654040,121,14528,2157037,273639512,0,557,46626,470,36162,87,10464,131,1,206,9,0,29,130000.0,39000.0,-69.0,-70.0,-67.0,-60.0,-70.0,-71.0,-68.0,-62.0,-76.0,-82.0,-76.0,-84.0,7.0,12.0,9.0,24.0,1
2499,CC:2F:71:3F:1F:24,2532281,765655371,375244,492015859,2157037,273639512,8,282571,349695528,282413,349674010,158,21518,275930,565,375300,38553,8,3172,130000.0,43333.0,-68.0,-61.0,-71.0,-70.0,-68.0,-61.0,-71.0,-69.0,-76.0,-82.0,-76.0,-84.0,8.0,21.0,5.0,14.0,1
2500,F8:59:71:5A:E0:3D,2308752,505195612,151712,231555836,2157040,273639776,354,110080,154814078,109968,154797745,112,16333,109478,42,151718,9512,354,247,144444.0,43333.0,-66.0,-72.0,-65.0,-70.0,-64.0,-71.0,-64.0,-69.0,-76.0,-82.0,-76.0,-84.0,10.0,10.0,11.0,14.0,1
2501,CC:2F:71:3E:C5:1F,2157161,273654304,121,14528,2157040,273639776,0,559,46814,471,36232,88,10582,132,1,206,9,0,29,130000.0,39000.0,-70.0,-70.0,-66.0,-60.0,-69.0,-70.0,-67.0,-61.0,-76.0,-82.0,-76.0,-84.0,6.0,12.0,10.0,24.0,1
2502,CC:2F:71:3F:1F:24,2532468,765873175,375427,492233265,2157041,273639910,8,282734,349905010,282576,349883492,158,21518,276092,565,375483,38554,8,3172,130000.0,39000.0,-68.0,-61.0,-72.0,-69.0,-68.0,-61.0,-72.0,-69.0,-76.0,-84.0,-77.0,-85.0,8.0,23.0,5.0,16.0,1
2503,F8:59:71:5A:E0:3D,2308822,505297086,151777,231656846,2157045,273640240,354,110145,154914178,110033,154897845,112,16333,109543,42,151783,9512,354,247,144444.0,43333.0,-66.0,-73.0,-65.0,-70.0,-66.0,-73.0,-65.0,-69.0,-76.0,-84.0,-77.0,-85.0,10.0,11.0,12.0,15.0,1
2504,CC:2F:71:3E:C5:1F,2157168,273654970,121,14528,2157047,273640442,0,559,46814,471,36232,88,10582,132,1,206,9,0,29,130000.0,39000.0,-70.0,-70.0,-66.0,-60.0,-69.0,-70.0,-67.0,-61.0,-76.0,-84.0,-77.0,-85.0,6.0,14.0,11.0,25.0,1
2505,CC:2F:71:3F:1F:24,2532639,766080864,375592,492440422,2157047,273640442,8,282885,350108905,282727,350087387,158,21518,276243,565,375648,38558,8,3172,130000.0,43333.0,-69.0,-61.0,-74.0,-69.0,-68.0,-61.0,-73.0,-69.0,-76.0,-84.0,-77.0,-85.0,7.0,23.0,3.0,16.0,1
2506,F8:59:71:5A:E0:3D,2309130,505772677,152081,232132033,2157049,273640644,354,110257,155020202,110145,155003869,112,16333,109655,42,152086,9528,354,247,144444.0,43333.0,-67.0,-73.0,-66.0,-70.0,-66.0,-73.0,-65.0,-69.0,-77.0,-84.0,-77.0,-85.0,10.0,11.0,11.0,15.0,1
2507,CC:2F:71:3E:C5:1F,2157170,273655172,121,14528,2157049,273640644,0,559,46814,471,36232,88,10582,132,1,206,9,0,29,130000.0,39000.0,-70.0,-70.0,-66.0,-60.0,-69.0,-70.0,-67.0,-61.0,-77.0,-84.0,-77.0,-85.0,7.0,14.0,11.0,25.0,1
2508,CC:2F:71:3F:1F:24,2532804,766287699,375755,492647055,2157049,273640644,8,283031,350301132,282873,350279614,158,21518,276389,565,375810,38558,8,3172,130000.0,43333.0,-69.0,-61.0,-74.0,-70.0,-69.0,-61.0,-73.0,-69.0,-77.0,-84.0,-77.0,-85.0,8.0,23.0,3.0,15.0,1
2509,F8:59:71:5A:E0:3D,2309323,506058937,152271,232417818,2157052,273641119,354,110339,155120968,110227,155104635,112,16333,109737,42,152277,9528,354,247,144444.0,43333.0,-66.0,-72.0,-65.0,-69.0,-66.0,-73.0,-65.0,-69.0,-77.0,-84.0,-77.0,-85.0,11.0,12.0,12.0,16.0,1
2510,CC:2F:71:3E:C5:1F,2157174,273655707,121,14528,2157053,273641179,0,559,46814,471,36232,88,10582,132,1,206,9,0,29,130000.0,39000.0,-70.0,-70.0,-66.0,-60.0,-69.0,-70.0,-67.0,-61.0,-77.0,-84.0,-77.0,-85.0,7.0,14.0,11.0,25.0,1
2511,CC:2F:71:3F:1F:24,2532965,766492836,375912,492851657,2157053,273641179,8,283173,350498100,283015,350476582,158,21518,276531,565,375968,38558,8,3172,144444.0,39000.0,-69.0,-61.0,-73.0,-70.0,-69.0,-61.0,-73.0,-69.0,-77.0,-84.0,-77.0,-85.0,8.0,23.0,4.0,15.0,1
2512,F8:59:71:5A:E0:3D,2309392,506158857,152335,232517274,2157057,273641583,354,110406,155221208,110294,155204875,112,16333,109802,42,152341,9528,354,247,144444.0,43333.0,-66.0,-73.0,-65.0,-70.0,-66.0,-72.0,-65.0,-69.0,-77.0,-84.0,-77.0,-85.0,11.0,11.0,12.0,15.0,1
2513,CC:2F:71:3E:C5:1F,2157178,273656111,121,14528,2157057,273641583,0,559,46814,471,36232,88,10582,132,1,206,9,0,29,130000.0,39000.0,-70.0,-70.0,-66.0,-60.0,-69.0,-70.0,-67.0,-61.0,-77.0,-84.0,-77.0,-85.0,7.0,14.0,11.0,25.0,1
2514,CC:2F:71:3F:1F:24,2533129,766701208,376072,493059625,2157057,273641583,8,283321,350698624,283163,350677106,158,21518,276679,565,376128,38568,8,3172,130000.0,43333.0,-72.0,-61.0,-73.0,-71.0,-70.0,-61.0,-73.0,-71.0,-77.0,-84.0,-77.0,-85.0,5.0,23.0,4.0,14.0,1
2515,F8:59:71:5A:E0:3D,2309458,506255609,152397,232613622,2157061,273641987,354,110470,155316828,110358,155300495,112,16333,109864,42,152403,9528,354,247,144444.0,43333.0,-67.0,-72.0,-65.0,-71.0,-66.0,-71.0,-65.0,-70.0,-77.0,-84.0,-77.0,-85.0,10.0,12.0,12.0,14.0,1
2516,CC:2F:71:3E:C5:1F,2157182,273656515,121,14528,2157061,273641987,0,559,46814,471,36232,88,10582,132,1,206,9,0,29,130000.0,39000.0,-70.0,-70.0,-66.0,-60.0,-69.0,-70.0,-67.0,-61.0,-77.0,-84.0,-77.0,-85.0,7.0,14.0,11.0,25.0,1
2517,CC:2F:71:3F:1F:24,2533289,766904548,376228,493262561,2157061,273641987,8,283464,350892860,283306,350871342,158,21518,276822,565,376284,38575,8,3172,130000.0,43333.0,-70.0,-62.0,-73.0,-70.0,-69.0,-62.0,-72.0,-68.0,-77.0,-84.0,-77.0,-85.0,7.0,22.0,4.0,15.0,1
2518,F8:59:71:5A:E0:3D,2309540,506372883,152474,232730432,2157066,273642451,354,110547,155432574,110435,155416241,112,16333,109940,42,152480,9528,354,247,144444.0,43333.0,-67.0,-72.0,-64.0,-70.0,-67.0,-73.0,-64.0,-70.0,-77.0,-83.0,-77.0,-84.0,10.0,11.0,13.0,14.0,1
2519,CC:2F:71:3E:C5:1F,2157187,273656979,121,14528,2157066,273642451,0,559,46814,471,36232,88,10582,132,1,206,9,0,29,130000.0,39000.0,-70.0,-70.0,-66.0,-60.0,-69.0,-70.0,-67.0,-61.0,-77.0,-83.0,-77.0,-84.0,7.0,13.0,11.0,24.0,1
2520,CC:2F:71:3F:1F:24,2533493,767168072,376425,493525419,2157068,273642653,8,283647,351144952,283489,351123434,158,21518,277005,565,376481,38576,8,3180,130000.0,43333.0,-71.0,-61.0,-66.0,-70.0,-70.0,-61.0,-68.0,-71.0,-77.0,-83.0,-77.0,-84.0,6.0,22.0,11.0,14.0,1
2521,F8:59:71:5A:E0:3D,2309647,506527537,152573,232884278,2157074,273643259,354,110645,155583606,110533,155567273,112,16333,110037,42,152579,9528,354,247,144444.0,43333.0,-67.0,-73.0,-65.0,-70.0,-67.0,-73.0,-65.0,-70.0,-77.0,-83.0,-77.0,-84.0,10.0,10.0,12.0,14.0,1
2522,CC:2F:71:3E:C5:1F,2157197,273657989,121,14528,2157076,273643461,0,559,46814,471,36232,88,10582,132,1,206,9,0,29,130000.0,39000.0,-70.0,-70.0,-66.0,-60.0,-69.0,-70.0,-67.0,-61.0,-77.0,-83.0,-77.0,-84.0,7.0,13.0,11.0,24.0,1
2523,CC:2F:71:3F:1F:24,2534157,768094003,377078,494450280,2157079,273643723,8,284090,351731941,283932,351710423,158,21518,277426,565,377126,38633,8,3224,86667.0,14444.0,-70.0,-62.0,-67.0,-69.0,-70.0,-63.0,-71.0,-69.0,-77.0,-83.0,-77.0,-84.0,7.0,21.0,10.0,15.0,1
2524,F8:59:71:5A:E0:3D,2310015,507062452,152932,233418325,2157083,273644127,354,110892,155896802,110780,155880469,112,16333,110283,42,152938,9528,354,247,144444.0,43333.0,-68.0,-72.0,-65.0,-69.0,-67.0,-72.0,-64.0,-69.0,-77.0,-83.0,-77.0,-84.0,9.0,11.0,12.0,15.0,1
2525,CC:2F:71:3E:C5:1F,2157204,273658655,121,14528,2157083,273644127,0,559,46814,471,36232,88,10582,132,1,206,9,0,29,130000.0,39000.0,-70.0,-70.0,-66.0,-60.0,-69.0,-70.0,-67.0,-61.0,-77.0,-83.0,-77.0,-84.0,7.0,13.0,11.0,24.0,1
2526,CC:2F:71:3F:1F:24,2535204,769588095,378121,495943968,2157083,273644127,8,284445,352050666,284287,352029148,158,21518,277764,565,378177,38650,8,3231,144444.0,43333.0,-69.0,-62.0,-71.0,-70.0,-68.0,-62.0,-68.0,-70.0,-77.0,-83.0,-77.0,-84.0,8.0,21.0,6.0,14.0,1
2527,F8:59:71:5A:E0:3D,2310081,507159204,152994,233514673,2157087,273644531,354,110956,155995376,110844,155979043,112,16333,110346,42,153000,9528,354,247,130000.0,39000.0,-67.0,-72.0,-66.0,-70.0,-67.0,-72.0,-66.0,-70.0,-77.0,-84.0,-77.0,-85.0,10.0,12.0,11.0,15.0,1
2528,CC:2F:71:3E:C5:1F,2157209,273659119,121,14528,2157088,273644591,0,559,46814,471,36232,88,10582,132,1,206,9,0,29,130000.0,39000.0,-70.0,-70.0,-66.0,-60.0,-69.0,-70.0,-67.0,-61.0,-77.0,-84.0,-77.0,-85.0,7.0,14.0,11.0,25.0,1
2529,CC:2F:71:3F:1F:24,2535368,769793459,378278,496148666,2157090,273644793,8,284589,352247866,284431,352226348,158,21518,277908,565,378334,38650,8,3231,144444.0,43333.0,-64.0,-62.0,-68.0,-69.0,-67.0,-62.0,-68.0,-69.0,-77.0,-84.0,-77.0,-85.0,13.0,22.0,9.0,16.0,1
2530,F8:59:71:5A:E0:3D,2310149,507257402,153057,233612407,2157092,273644995,354,111021,156095518,110909,156079185,112,16333,110408,42,153062,9529,354,247,144444.0,43333.0,-68.0,-73.0,-66.0,-70.0,-67.0,-73.0,-66.0,-70.0,-77.0,-84.0,-77.0,-85.0,9.0,11.0,11.0,15.0,1
2531,CC:2F:71:3E:C5:1F,2157213,273659523,121,14528,2157092,273644995,0,559,46814,471,36232,88,10582,132,1,206,9,0,29,130000.0,39000.0,-70.0,-70.0,-66.0,-60.0,-69.0,-70.0,-67.0,-61.0,-77.0,-84.0,-77.0,-85.0,7.0,14.0,11.0,25.0,1
2532,CC:2F:71:3F:1F:24,2536160,770911070,379068,497266075,2157092,273644995,8,284820,352456999,284662,352435481,158,21518,278139,565,379124,38653,8,3231,144444.0,43333.0,-68.0,-63.0,-65.0,-69.0,-67.0,-63.0,-68.0,-69.0,-77.0,-84.0,-77.0,-85.0,9.0,21.0,12.0,16.0,1
2533,F8:59:71:5A:E0:3D,2310214,507352600,153118,233707201,2157096,273645399,354,111087,156197214,110975,156180881,112,16333,110470,42,153124,9529,354,247,144444.0,43333.0,-68.0,-74.0,-65.0,-70.0,-67.0,-73.0,-65.0,-70.0,-77.0,-84.0,-77.0,-85.0,9.0,10.0,12.0,15.0,1
2534,CC:2F:71:3E:C5:1F,2157217,273659927,121,14528,2157096,273645399,0,559,46814,471,36232,88,10582,132,1,206,9,0,29,130000.0,39000.0,-70.0,-70.0,-66.0,-60.0,-69.0,-70.0,-67.0,-61.0,-77.0,-84.0,-77.0,-85.0,7.0,14.0,11.0,25.0,1
2535,CC:2F:71:3F:1F:24,2536336,771132075,379240,497486676,2157096,273645399,8,284979,352666496,284821,352644978,158,21518,278298,565,379296,38653,8,3231,144444.0,43333.0,-69.0,-63.0,-68.0,-69.0,-68.0,-62.0,-68.0,-68.0,-77.0,-84.0,-77.0,-85.0,8.0,21.0,9.0,16.0,1
2536,F8:59:71:5A:E0:3D,2310301,507479064,153199,233833075,2157102,273645989,354,111167,156320414,111055,156304081,112,16333,110550,42,153205,9531,354,247,144444.0,43333.0,-68.0,-73.0,-66.0,-70.0,-67.0,-73.0,-66.0,-69.0,-77.0,-84.0,-77.0,-85.0,9.0,11.0,11.0,15.0,1
2537,CC:2F:71:3E:C5:1F,2157227,273660921,121,14528,2157106,273646393,0,559,46814,471,36232,88,10582,132,1,206,9,0,29,130000.0,39000.0,-70.0,-70.0,-66.0,-60.0,-69.0,-70.0,-67.0,-61.0,-77.0,-84.0,-77.0,-85.0,7.0,14.0,11.0,25.0,1
2538,CC:2F:71:3F:1F:24,2536658,771564417,379552,497918024,2157106,273646393,8,285277,353093667,285119,353072149,158,21518,278574,565,379608,38702,8,3252,130000.0,43333.0,-68.0,-62.0,-74.0,-67.0,-68.0,-61.0,-74.0,-66.0,-77.0,-84.0,-78.0,-84.0,9.0,22.0,4.0,17.0,1
2539,F8:59:71:5A:E0:3D,2310423,507654098,153312,234007239,2157111,273646859,354,111291,156511402,111179,156495069,112,16333,110672,42,153318,9531,354,247,144444.0,43333.0,-66.0,-74.0,-66.0,-69.0,-66.0,-73.0,-66.0,-69.0,-77.0,-84.0,-78.0,-84.0,11.0,10.0,12.0,15.0,1
2540,CC:2F:71:3E:C5:1F,2157233,273661503,122,14644,2157111,273646859,0,562,47072,473,36372,89,10700,133,1,208,9,0,30,130000.0,39000.0,-67.0,-61.0,-66.0,-59.0,-70.0,-70.0,-67.0,-61.0,-77.0,-84.0,-78.0,-84.0,10.0,23.0,12.0,25.0,1
2541,CC:2F:71:3F:1F:24,2536824,771774375,379713,498127516,2157111,273646859,8,285424,353294053,285266,353272535,158,21518,278721,565,379769,38702,8,3252,130000.0,43333.0,-68.0,-62.0,-76.0,-68.0,-69.0,-62.0,-76.0,-67.0,-77.0,-84.0,-78.0,-84.0,9.0,22.0,2.0,16.0,1
2542,F8:59:71:5A:E0:3D,2310491,507752651,153376,234105257,2157115,273647394,354,111355,156608528,111243,156592195,112,16333,110736,42,153382,9531,354,247,144444.0,43333.0,-66.0,-73.0,-66.0,-70.0,-66.0,-73.0,-66.0,-69.0,-77.0,-84.0,-78.0,-84.0,11.0,11.0,12.0,14.0,1
2543,CC:2F:71:3E:C5:1F,2157239,273662240,122,14644,2157117,273647596,0,562,47072,473,36372,89,10700,133,1,208,9,0,30,130000.0,39000.0,-67.0,-61.0,-66.0,-59.0,-70.0,-70.0,-67.0,-61.0,-77.0,-84.0,-78.0,-84.0,10.0,23.0,12.0,25.0,1
2544,CC:2F:71:3F:1F:24,2537002,771983408,379885,498335812,2157117,273647596,8,285580,353492371,285422,353470853,158,21518,278876,565,379941,38707,8,3252,130000.0,43333.0,-68.0,-62.0,-75.0,-68.0,-67.0,-60.0,-75.0,-67.0,-77.0,-84.0,-78.0,-84.0,9.0,22.0,3.0,16.0,1
2545,F8:59:71:5A:E0:3D,2310918,508407894,153797,234759894,2157121,273648000,354,111494,156739538,111382,156723205,112,16333,110873,42,153803,9531,354,247,144444.0,43333.0,-66.0,-74.0,-66.0,-69.0,-66.0,-73.0,-65.0,-69.0,-77.0,-84.0,-78.0,-85.0,11.0,10.0,12.0,16.0,1
2546,CC:2F:71:3E:C5:1F,2157243,273662644,122,14644,2157121,273648000,0,562,47072,473,36372,89,10700,133,1,208,9,0,30,130000.0,39000.0,-67.0,-61.0,-66.0,-59.0,-70.0,-70.0,-67.0,-61.0,-77.0,-84.0,-78.0,-85.0,10.0,23.0,12.0,26.0,1
2547,CC:2F:71:3F:1F:24,2537807,773115176,380686,499467176,2157121,273648000,8,285851,353775659,285693,353754141,158,21518,279147,565,380740,38732,8,3254,117000.0,39000.0,-68.0,-63.0,-71.0,-69.0,-69.0,-64.0,-72.0,-70.0,-77.0,-84.0,-78.0,-85.0,9.0,21.0,7.0,16.0,1
2548,F8:59:71:5A:E0:3D,2311060,508592162,153910,234932648,2157150,273659514,354,111609,156913804,111497,156897471,112,16333,110987,42,153916,9535,354,247,144444.0,43333.0,-66.0,-74.0,-66.0,-69.0,-66.0,-74.0,-65.0,-69.0,-77.0,-84.0,-78.0,-85.0,11.0,10.0,12.0,16.0,1
2549,CC:2F:71:3E:C5:1F,2157274,273674360,122,14644,2157152,273659716,0,562,47072,473,36372,89,10700,133,1,208,9,0,30,130000.0,39000.0,-67.0,-61.0,-66.0,-59.0,-70.0,-70.0,-67.0,-61.0,-77.0,-84.0,-78.0,-85.0,10.0,23.0,12.0,26.0,1
2550,CC:2F:71:3F:1F:24,2538084,773466210,380932,499806494,2157152,273659716,8,286088,354106463,285930,354084945,158,21518,279384,565,380988,38745,8,3265,130000.0,43333.0,-68.0,-64.0,-71.0,-69.0,-67.0,-63.0,-71.0,-69.0,-77.0,-84.0,-78.0,-85.0,9.0,20.0,7.0,16.0,1
2551,F8:59:71:5A:E0:3D,2311166,508746676,154009,235086494,2157157,273660182,354,111720,157083364,111607,157066913,113,16451,111095,42,154015,9538,354,247,144444.0,43333.0,-66.0,-73.0,-64.0,-70.0,-66.0,-73.0,-64.0,-69.0,-77.0,-84.0,-78.0,-85.0,11.0,11.0,14.0,15.0,1
2552,CC:2F:71:3E:C5:1F,2157281,273675028,122,14644,2157159,273660384,0,562,47072,473,36372,89,10700,133,1,208,9,0,30,130000.0,39000.0,-67.0,-61.0,-66.0,-59.0,-70.0,-70.0,-67.0,-61.0,-77.0,-84.0,-78.0,-85.0,10.0,23.0,12.0,26.0,1
2553,CC:2F:71:3F:1F:24,2538349,773804094,381190,500143710,2157159,273660384,8,286329,354435521,286171,354414003,158,21518,279625,565,381246,38745,8,3280,144444.0,43333.0,-67.0,-62.0,-74.0,-68.0,-67.0,-62.0,-74.0,-67.0,-77.0,-84.0,-78.0,-85.0,10.0,22.0,4.0,17.0,1
2554,F8:59:71:5A:E0:3D,2311246,508863690,154084,235203044,2157162,273660646,354,111785,157183464,111672,157167013,113,16451,111160,42,154090,9538,354,247,144444.0,43333.0,-66.0,-73.0,-65.0,-69.0,-66.0,-73.0,-64.0,-69.0,-77.0,-84.0,-78.0,-85.0,11.0,11.0,13.0,16.0,1
2555,CC:2F:71:3E:C5:1F,2157284,273675290,122,14644,2157162,273660646,0,562,47072,473,36372,89,10700,133,1,208,9,0,30,130000.0,39000.0,-67.0,-61.0,-66.0,-59.0,-70.0,-70.0,-67.0,-61.0,-77.0,-84.0,-78.0,-85.0,10.0,23.0,12.0,26.0,1
2556,CC:2F:71:3F:1F:24,2538507,774005962,381345,500345316,2157162,273660646,8,286473,354629781,286315,354608263,158,21518,279767,565,381401,38745,8,3280,144444.0,43333.0,-67.0,-62.0,-73.0,-68.0,-67.0,-62.0,-73.0,-67.0,-77.0,-84.0,-78.0,-85.0,10.0,22.0,5.0,17.0,1
2557,F8:59:71:5A:E0:3D,2311315,508960903,154149,235299853,2157166,273661050,354,111851,157281234,111738,157264783,113,16451,111226,42,154155,9539,354,247,144444.0,43333.0,-66.0,-73.0,-64.0,-69.0,-66.0,-73.0,-64.0,-69.0,-77.0,-84.0,-78.0,-85.0,11.0,11.0,14.0,16.0,1
2558,CC:2F:71:3E:C5:1F,2157288,273675694,122,14644,2157166,273661050,0,562,47072,473,36372,89,10700,133,1,208,9,0,30,130000.0,39000.0,-67.0,-61.0,-66.0,-59.0,-70.0,-70.0,-67.0,-61.0,-78.0,-84.0,-78.0,-85.0,11.0,23.0,12.0,26.0,1
2559,CC:2F:71:3F:1F:24,2538669,774214186,381503,500553136,2157166,273661050,8,286619,354830073,286461,354808555,158,21518,279913,565,381559,38745,8,3280,144444.0,43333.0,-68.0,-62.0,-73.0,-67.0,-67.0,-61.0,-73.0,-67.0,-78.0,-84.0,-78.0,-85.0,10.0,22.0,5.0,18.0,1
2560,F8:59:71:5A:E0:3D,2311384,509062317,154214,235400863,2157170,273661454,354,111918,157384428,111805,157367977,113,16451,111292,42,154220,9539,354,247,144444.0,43333.0,-67.0,-73.0,-65.0,-70.0,-66.0,-73.0,-64.0,-69.0,-78.0,-84.0,-78.0,-85.0,11.0,11.0,13.0,15.0,1
2561,CC:2F:71:3E:C5:1F,2157292,273676098,122,14644,2157170,273661454,0,562,47072,473,36372,89,10700,133,1,208,9,0,30,130000.0,39000.0,-67.0,-61.0,-66.0,-59.0,-70.0,-70.0,-67.0,-61.0,-78.0,-84.0,-78.0,-85.0,11.0,23.0,12.0,26.0,1
2562,CC:2F:71:3F:1F:24,2539452,775307851,382282,501646397,2157170,273661454,8,286863,355048157,286705,355026639,158,21518,280156,565,382338,38761,8,3280,144444.0,43333.0,-69.0,-63.0,-75.0,-70.0,-68.0,-62.0,-74.0,-69.0,-78.0,-84.0,-78.0,-85.0,9.0,21.0,3.0,15.0,1
2563,F8:59:71:5A:E0:3D,2311561,509330666,154387,235668888,2157174,273661778,354,112006,157487782,111893,157471331,113,16451,111380,42,154393,9539,354,247,144444.0,43333.0,-67.0,-74.0,-65.0,-70.0,-66.0,-73.0,-64.0,-70.0,-78.0,-84.0,-78.0,-85.0,11.0,10.0,13.0,15.0,1
2564,CC:2F:71:3E:C5:1F,2157298,273676624,122,14644,2157176,273661980,0,562,47072,473,36372,89,10700,133,1,208,9,0,30,130000.0,39000.0,-67.0,-61.0,-66.0,-59.0,-70.0,-70.0,-67.0,-61.0,-78.0,-84.0,-78.0,-85.0,11.0,23.0,12.0,26.0,1
2565,CC:2F:71:3F:1F:24,2539616,775514645,382440,501852665,2157176,273661980,8,287009,355245619,286850,355223983,159,21636,280300,565,382495,38762,8,3280,144444.0,43333.0,-68.0,-62.0,-73.0,-68.0,-67.0,-62.0,-73.0,-68.0,-78.0,-84.0,-78.0,-85.0,10.0,22.0,5.0,17.0,1
2566,F8:59:71:5A:E0:3D,2311640,509433527,154460,235771143,2157180,273662384,354,112077,157589840,111964,157573389,113,16451,111451,42,154466,9540,354,247,144444.0,43333.0,-66.0,-73.0,-64.0,-70.0,-66.0,-73.0,-64.0,-69.0,-78.0,-84.0,-78.0,-85.0,12.0,11.0,14.0,15.0,1
2567,CC:2F:71:3E:C5:1F,2157302,273677028,122,14644,2157180,273662384,0,562,47072,473,36372,89,10700,133,1,208,9,0,30,130000.0,39000.0,-67.0,-61.0,-66.0,-59.0,-70.0,-70.0,-67.0,-61.0,-78.0,-84.0,-78.0,-85.0,11.0,23.0,12.0,26.0,1
2568,CC:2F:71:3F:1F:24,2539785,775732323,382605,502069939,2157180,273662384,8,287163,355458231,287004,355436595,159,21636,280454,565,382661,38764,8,3280,144444.0,43333.0,-68.0,-62.0,-74.0,-68.0,-68.0,-62.0,-74.0,-68.0,-78.0,-84.0,-78.0,-85.0,10.0,22.0,4.0,17.0,1
2569,F8:59:71:5A:E0:3D,2311708,509536293,154526,235873707,2157182,273662586,354,112144,157693020,112031,157676569,113,16451,111518,42,154532,9540,354,247,144444.0,43333.0,-66.0,-73.0,-65.0,-69.0,-66.0,-73.0,-64.0,-69.0,-78.0,-84.0,-78.0,-85.0,12.0,11.0,13.0,16.0,1
2570,CC:2F:71:3E:C5:1F,2157304,273677230,122,14644,2157182,273662586,0,562,47072,473,36372,89,10700,133,1,208,9,0,30,130000.0,39000.0,-67.0,-61.0,-66.0,-59.0,-70.0,-70.0,-67.0,-61.0,-78.0,-84.0,-78.0,-85.0,11.0,23.0,12.0,26.0,1
2571,CC:2F:71:3F:1F:24,2539947,775937709,382763,502274921,2157184,273662788,8,287304,355652243,287145,355630607,159,21636,280595,565,382819,38765,8,3280,144444.0,43333.0,-68.0,-62.0,-73.0,-68.0,-68.0,-62.0,-73.0,-67.0,-78.0,-84.0,-78.0,-85.0,10.0,22.0,5.0,17.0,1
2572,F8:59:71:5A:E0:3D,2311899,509824653,154712,236161603,2157187,273663050,354,112223,157793722,112110,157777271,113,16451,111597,42,154718,9541,354,247,144444.0,43333.0,-66.0,-73.0,-65.0,-69.0,-66.0,-73.0,-64.0,-69.0,-78.0,-84.0,-78.0,-85.0,12.0,11.0,13.0,16.0,1
2573,CC:2F:71:3E:C5:1F,2157309,273677694,122,14644,2157187,273663050,0,562,47072,473,36372,89,10700,133,1,208,9,0,30,130000.0,39000.0,-67.0,-61.0,-66.0,-59.0,-70.0,-70.0,-67.0,-61.0,-78.0,-84.0,-78.0,-85.0,11.0,23.0,12.0,26.0,1
2574,CC:2F:71:3F:1F:24,2540107,776141203,382918,502477951,2157189,273663252,8,287446,355846363,287287,355824727,159,21636,280737,565,382974,38765,8,3280,144444.0,43333.0,-68.0,-62.0,-74.0,-67.0,-67.0,-62.0,-74.0,-67.0,-78.0,-84.0,-78.0,-85.0,10.0,22.0,4.0,18.0,1
2575,F8:59:71:5A:E0:3D,2311963,509921203,154774,236257951,2157189,273663252,354,112285,157889202,112172,157872751,113,16451,111659,42,154780,9541,354,247,144444.0,43333.0,-67.0,-73.0,-65.0,-70.0,-66.0,-73.0,-64.0,-69.0,-78.0,-84.0,-78.0,-85.0,11.0,11.0,13.0,15.0,1
2576,CC:2F:71:3E:C5:1F,2157311,273677896,122,14644,2157189,273663252,0,562,47072,473,36372,89,10700,133,1,208,9,0,30,130000.0,39000.0,-67.0,-61.0,-66.0,-59.0,-70.0,-70.0,-67.0,-61.0,-78.0,-84.0,-78.0,-85.0,11.0,23.0,12.0,26.0,1
2577,CC:2F:71:3F:1F:24,2540277,776349234,383086,502685780,2157191,273663454,8,287596,356046852,287437,356025216,159,21636,280886,565,383138,38766,8,3280,144444.0,43333.0,-67.0,-62.0,-73.0,-68.0,-67.0,-62.0,-73.0,-68.0,-78.0,-84.0,-78.0,-85.0,11.0,22.0,5.0,17.0,1
2578,F8:59:71:5A:E0:3D,2312032,510018430,154836,236354299,2157196,273664131,354,112347,157984682,112234,157968231,113,16451,111721,42,154842,9541,354,247,144444.0,43333.0,-66.0,-73.0,-65.0,-70.0,-66.0,-73.0,-64.0,-69.0,-78.0,-84.0,-78.0,-85.0,12.0,11.0,13.0,15.0,1
2579,CC:2F:71:3E:C5:1F,2157318,273678775,122,14644,2157196,273664131,0,562,47072,473,36372,89,10700,133,1,208,9,0,30,130000.0,39000.0,-67.0,-61.0,-66.0,-59.0,-70.0,-70.0,-67.0,-61.0,-78.0,-84.0,-78.0,-85.0,11.0,23.0,12.0,26.0,1
2580,CC:2F:71:3F:1F:24,2540832,777069728,383635,503405537,2157197,273664191,8,287835,356263022,287676,356241386,159,21636,281125,565,383691,38766,8,3280,144444.0,43333.0,-68.0,-62.0,-75.0,-67.0,-67.0,-62.0,-73.0,-67.0,-78.0,-84.0,-78.0,-85.0,10.0,22.0,3.0,18.0,1
2581,F8:59:71:5A:E0:3D,2312108,510118621,154909,236454228,2157199,273664393,354,112420,158085215,112307,158068764,113,16451,111793,42,154915,9541,354,247,144444.0,43333.0,-67.0,-74.0,-64.0,-70.0,-66.0,-73.0,-64.0,-69.0,-78.0,-84.0,-78.0,-85.0,11.0,10.0,14.0,15.0,1
2582,CC:2F:71:3E:C5:1F,2157321,273679037,122,14644,2157199,273664393,0,562,47072,473,36372,89,10700,133,1,208,9,0,30,130000.0,39000.0,-67.0,-61.0,-66.0,-59.0,-70.0,-70.0,-67.0,-61.0,-78.0,-84.0,-78.0,-85.0,11.0,23.0,12.0,26.0,1
2583,CC:2F:71:3F:1F:24,2540993,777277752,383794,503613359,2157199,273664393,8,287979,356461646,287820,356440010,159,21636,281269,565,383850,38767,8,3280,144444.0,43333.0,-69.0,-64.0,-76.0,-70.0,-68.0,-63.0,-74.0,-68.0,-78.0,-84.0,-78.0,-85.0,9.0,20.0,2.0,15.0,1
2584,F8:59:71:5A:E0:3D,2312355,510492241,155148,236826874,2157207,273665367,354,112517,158189611,112404,158173160,113,16451,111890,42,155154,9541,354,248,144444.0,43333.0,-66.0,-74.0,-64.0,-69.0,-66.0,-73.0,-64.0,-69.0,-78.0,-84.0,-78.0,-85.0,12.0,10.0,14.0,16.0,1
2585,CC:2F:71:3E:C5:1F,2157329,273680011,122,14644,2157207,273665367,0,562,47072,473,36372,89,10700,133,1,208,9,0,30,130000.0,39000.0,-67.0,-61.0,-66.0,-59.0,-70.0,-70.0,-67.0,-61.0,-78.0,-84.0,-78.0,-85.0,11.0,23.0,12.0,26.0,1
2586,CC:2F:71:3F:1F:24,2541156,777481756,383949,503816389,2157207,273665367,8,288120,356655650,287961,356634014,159,21636,281410,565,384005,38767,8,3280,144444.0,43333.0,-68.0,-62.0,-74.0,-67.0,-67.0,-62.0,-73.0,-67.0,-78.0,-84.0,-78.0,-85.0,10.0,22.0,4.0,18.0,1
2587,F8:59:71:5A:E0:3D,2312420,510590345,155211,236924776,2157209,273665569,354,112580,158286631,112467,158270180,113,16451,111953,42,155217,9541,354,248,144444.0,43333.0,-67.0,-73.0,-64.0,-70.0,-66.0,-73.0,-64.0,-69.0,-78.0,-84.0,-78.0,-85.0,11.0,11.0,14.0,15.0,1
2588,CC:2F:71:3E:C5:1F,2157331,273680213,122,14644,2157209,273665569,0,562,47072,473,36372,89,10700,133,1,208,9,0,30,130000.0,39000.0,-67.0,-61.0,-66.0,-59.0,-70.0,-70.0,-67.0,-61.0,-78.0,-84.0,-78.0,-85.0,11.0,23.0,12.0,26.0,1
2589,CC:2F:71:3F:1F:24,2541317,777688286,384107,504022657,2157210,273665629,8,288264,356851468,288105,356829832,159,21636,281554,565,384163,38768,8,3281,144444.0,43333.0,-67.0,-62.0,-74.0,-67.0,-68.0,-62.0,-74.0,-68.0,-78.0,-84.0,-78.0,-85.0,11.0,22.0,4.0,18.0,1
2590,F8:59:71:5A:E0:3D,2312505,510698460,155289,237032225,2157216,273666235,354,112655,158394367,112542,158377916,113,16451,112028,42,155295,9541,354,248,144444.0,43333.0,-66.0,-73.0,-64.0,-70.0,-66.0,-73.0,-64.0,-69.0,-78.0,-84.0,-78.0,-85.0,12.0,11.0,14.0,15.0,1
2591,CC:2F:71:3E:C5:1F,2157338,273680879,122,14644,2157216,273666235,0,562,47072,473,36372,89,10700,133,1,208,9,0,30,130000.0,39000.0,-67.0,-61.0,-66.0,-59.0,-70.0,-70.0,-67.0,-61.0,-78.0,-84.0,-78.0,-85.0,11.0,23.0,12.0,26.0,1
2592,CC:2F:71:3F:1F:24,2542224,778945991,385008,505279756,2157216,273666235,8,288509,357084613,288350,357062977,159,21636,281799,565,385064,38775,8,3281,144444.0,43333.0,-68.0,-62.0,-75.0,-67.0,-67.0,-62.0,-74.0,-67.0,-78.0,-84.0,-78.0,-85.0,10.0,22.0,3.0,18.0,1
2593,F8:59:71:5A:E0:3D,2312573,510798378,155355,237131941,2157218,273666437,354,112721,158491798,112608,158475347,113,16451,112094,42,155361,9541,354,248,144444.0,43333.0,-67.0,-74.0,-65.0,-69.0,-66.0,-73.0,-65.0,-69.0,-78.0,-85.0,-79.0,-86.0,11.0,11.0,14.0,17.0,1
2594,CC:2F:71:3E:C5:1F,2157340,273681081,122,14644,2157218,273666437,0,562,47072,473,36372,89,10700,133,1,208,9,0,30,130000.0,39000.0,-67.0,-61.0,-66.0,-59.0,-70.0,-70.0,-67.0,-61.0,-78.0,-85.0,-79.0,-86.0,11.0,24.0,13.0,27.0,1
2595,CC:2F:71:3F:1F:24,2542384,779152461,385166,505486024,2157218,273666437,8,288652,357281697,288493,357260061,159,21636,281942,565,385222,38806,8,3281,144444.0,43333.0,-69.0,-62.0,-74.0,-67.0,-69.0,-62.0,-75.0,-67.0,-78.0,-85.0,-79.0,-86.0,9.0,23.0,5.0,19.0,1
2596,F8:59:71:5A:E0:3D,2312639,510893636,155416,237226735,2157223,273666901,354,112782,158585738,112669,158569287,113,16451,112155,42,155422,9541,354,248,144444.0,43333.0,-66.0,-74.0,-65.0,-70.0,-66.0,-73.0,-64.0,-70.0,-78.0,-85.0,-79.0,-86.0,12.0,11.0,14.0,16.0,1
2597,CC:2F:71:3E:C5:1F,2157345,273681545,122,14644,2157223,273666901,0,562,47072,473,36372,89,10700,133,1,208,9,0,30,130000.0,39000.0,-67.0,-61.0,-66.0,-59.0,-70.0,-70.0,-67.0,-61.0,-78.0,-85.0,-79.0,-86.0,11.0,24.0,13.0,27.0,1
2598,CC:2F:71:3F:1F:24,2542560,779367602,385335,505700499,2157225,273667103,8,288812,357491353,288653,357469717,159,21636,282099,565,385391,38826,8,3283,130000.0,43333.0,-70.0,-63.0,-74.0,-69.0,-69.0,-62.0,-73.0,-68.0,-78.0,-85.0,-79.0,-86.0,8.0,22.0,5.0,17.0,1
2599,F8:59:71:5A:E0:3D,2312746,511040768,155519,237373463,2157227,273667305,354,112865,158695912,112752,158679461,113,16451,112237,42,155525,9545,354,248,144444.0,43333.0,-67.0,-74.0,-64.0,-70.0,-66.0,-73.0,-64.0,-70.0,-78.0,-85.0,-79.0,-86.0,11.0,11.0,15.0,16.0,1
2600,CC:2F:71:3E:C5:1F,2157349,273681949,122,14644,2157227,273667305,0,562,47072,473,36372,89,10700,133,1,208,9,0,30,130000.0,39000.0,-67.0,-61.0,-66.0,-59.0,-70.0,-70.0,-67.0,-61.0,-78.0,-85.0,-79.0,-86.0,11.0,24.0,13.0,27.0,1
2601,CC:2F:71:3F:1F:24,2542721,779574280,385494,505906975,2157227,273667305,8,288959,357691791,288800,357670155,159,21636,282243,565,385550,38826,8,3283,130000.0,43333.0,-69.0,-62.0,-74.0,-68.0,-68.0,-62.0,-73.0,-68.0,-78.0,-85.0,-79.0,-86.0,9.0,23.0,5.0,18.0,1
2602,F8:59:71:5A:E0:3D,2312811,511138872,155582,237471365,2157229,273667507,354,112928,158792932,112815,158776481,113,16451,112300,42,155588,9545,354,248,144444.0,43333.0,-65.0,-73.0,-65.0,-70.0,-66.0,-73.0,-64.0,-70.0,-78.0,-85.0,-79.0,-86.0,13.0,12.0,14.0,16.0,1
2603,CC:2F:71:3E:C5:1F,2157351,273682151,122,14644,2157229,273667507,0,562,47072,473,36372,89,10700,133,1,208,9,0,30,130000.0,39000.0,-67.0,-61.0,-66.0,-59.0,-70.0,-70.0,-67.0,-61.0,-78.0,-85.0,-79.0,-86.0,11.0,24.0,13.0,27.0,1
2604,CC:2F:71:3F:1F:24,2542883,779783576,385652,506115867,2157231,273667709,8,289105,357892099,288946,357870463,159,21636,282387,565,385708,38831,8,3283,130000.0,43333.0,-68.0,-62.0,-74.0,-68.0,-68.0,-61.0,-73.0,-67.0,-78.0,-85.0,-79.0,-86.0,10.0,23.0,5.0,18.0,1
2605,F8:59:71:5A:E0:3D,2312981,511391720,155747,237723749,2157234,273667971,354,113022,158901183,112909,158884732,113,16451,112393,42,155753,9545,354,248,144444.0,43333.0,-66.0,-74.0,-65.0,-70.0,-66.0,-73.0,-64.0,-70.0,-79.0,-85.0,-79.0,-86.0,13.0,11.0,14.0,16.0,1
2606,CC:2F:71:3E:C5:1F,2157358,273682817,122,14644,2157236,273668173,0,562,47072,473,36372,89,10700,133,1,208,9,0,30,130000.0,39000.0,-67.0,-61.0,-66.0,-59.0,-70.0,-70.0,-67.0,-61.0,-79.0,-85.0,-79.0,-86.0,12.0,24.0,13.0,27.0,1
2607,CC:2F:71:3F:1F:24,2543045,779987316,385809,506319143,2157236,273668173,8,289250,358090871,289091,358069235,159,21636,282532,565,385865,38831,8,3283,130000.0,43333.0,-68.0,-62.0,-73.0,-68.0,-68.0,-62.0,-74.0,-67.0,-79.0,-85.0,-79.0,-86.0,11.0,23.0,6.0,18.0,1
2608,F8:59:71:5A:E0:3D,2313050,511491836,155814,237823663,2157236,273668173,354,113089,159000563,112976,158984112,113,16451,112460,42,155820,9545,354,248,144444.0,43333.0,-66.0,-72.0,-64.0,-70.0,-66.0,-73.0,-64.0,-70.0,-79.0,-85.0,-79.0,-86.0,13.0,13.0,15.0,16.0,1
2609,CC:2F:71:3E:C5:1F,2157360,273683019,122,14644,2157238,273668375,0,562,47072,473,36372,89,10700,133,1,208,9,0,30,130000.0,39000.0,-67.0,-61.0,-66.0,-59.0,-70.0,-70.0,-67.0,-61.0,-79.0,-85.0,-79.0,-86.0,12.0,24.0,13.0,27.0,1
2610,CC:2F:71:3F:1F:24,2543805,781053238,386565,507384661,2157240,273668577,8,289481,358322492,289322,358300856,159,21636,282763,565,386621,38861,8,3283,117000.0,39000.0,-69.0,-62.0,-75.0,-68.0,-68.0,-61.0,-74.0,-67.0,-79.0,-85.0,-79.0,-86.0,10.0,23.0,4.0,18.0,1
2611,F8:59:71:5A:E0:3D,2313127,511602776,155885,237933997,2157242,273668779,354,113161,159111443,113048,159094992,113,16451,112532,42,155891,9546,354,248,144444.0,43333.0,-66.0,-74.0,-64.0,-70.0,-66.0,-73.0,-64.0,-70.0,-79.0,-85.0,-79.0,-86.0,13.0,11.0,15.0,16.0,1
2612,CC:2F:71:3E:C5:1F,2157364,273683423,122,14644,2157242,273668779,0,562,47072,473,36372,89,10700,133,1,208,9,0,30,130000.0,39000.0,-67.0,-61.0,-66.0,-59.0,-70.0,-70.0,-67.0,-61.0,-79.0,-85.0,-79.0,-86.0,12.0,24.0,13.0,27.0,1
2613,CC:2F:71:3F:1F:24,2543976,781267849,386733,507598936,2157243,273668913,8,289635,358524390,289476,358502754,159,21636,282917,565,386789,38861,8,3290,130000.0,43333.0,-68.0,-62.0,-74.0,-67.0,-68.0,-62.0,-74.0,-67.0,-79.0,-85.0,-79.0,-86.0,11.0,23.0,5.0,19.0,1
2614,F8:59:71:5A:E0:3D,2313193,511699502,155948,238030461,2157245,273669041,354,113224,159207029,113111,159190578,113,16451,112595,42,155954,9546,354,248,144444.0,43333.0,-66.0,-74.0,-64.0,-70.0,-65.0,-73.0,-64.0,-70.0,-79.0,-85.0,-79.0,-86.0,13.0,11.0,15.0,16.0,1
2615,CC:2F:71:3E:C5:1F,2157371,273684089,122,14644,2157249,273669445,0,562,47072,473,36372,89,10700,133,1,208,9,0,30,130000.0,39000.0,-67.0,-61.0,-66.0,-59.0,-70.0,-70.0,-67.0,-61.0,-79.0,-85.0,-79.0,-86.0,12.0,24.0,13.0,27.0,1
2616,CC:2F:71:3F:1F:24,2544229,781587247,386978,507917600,2157251,273669647,8,289873,358837678,289714,358816042,159,21636,283154,565,387033,38861,8,3305,130000.0,43333.0,-69.0,-62.0,-74.0,-68.0,-68.0,-62.0,-74.0,-67.0,-79.0,-85.0,-79.0,-86.0,10.0,23.0,5.0,18.0,1
2617,F8:59:71:5A:E0:3D,2313300,511852718,156047,238182869,2157253,273669849,354,113323,159359503,113210,159343052,113,16451,112693,42,156053,9547,354,248,144444.0,43333.0,-67.0,-72.0,-64.0,-70.0,-66.0,-73.0,-64.0,-69.0,-79.0,-85.0,-79.0,-86.0,12.0,13.0,15.0,16.0,1
2618,CC:2F:71:3E:C5:1F,2157376,273684609,123,14760,2157253,273669849,0,564,47212,475,36512,89,10700,133,1,209,9,0,30,130000.0,39000.0,-77.0,-84.0,-75.0,-72.0,-71.0,-72.0,-68.0,-62.0,-79.0,-85.0,-79.0,-86.0,2.0,1.0,4.0,14.0,1
2619,CC:2F:71:3F:1F:24,2544387,781790371,387134,508120522,2157253,273669849,8,290018,359035064,289859,359013428,159,21636,283297,565,387190,38865,8,3307,130000.0,43333.0,-68.0,-62.0,-73.0,-68.0,-68.0,-62.0,-73.0,-67.0,-79.0,-85.0,-79.0,-86.0,11.0,23.0,6.0,18.0,1
2620,F8:59:71:5A:E0:3D,2313511,512158824,156250,238488036,2157261,273670788,354,113421,159486388,113308,159469937,113,16451,112791,42,156256,9547,354,248,144444.0,43333.0,-66.0,-74.0,-65.0,-71.0,-66.0,-73.0,-64.0,-70.0,-79.0,-84.0,-79.0,-85.0,13.0,10.0,14.0,14.0,1
2621,CC:2F:71:3E:C5:1F,2157384,273685548,123,14760,2157261,273670788,0,564,47212,475,36512,89,10700,133,1,209,9,0,30,130000.0,39000.0,-77.0,-84.0,-75.0,-72.0,-71.0,-72.0,-68.0,-62.0,-79.0,-84.0,-79.0,-85.0,2.0,0.0,4.0,13.0,1
2622,CC:2F:71:3F:1F:24,2545223,782944553,387962,509273765,2157261,273670788,8,290294,359308036,290135,359286400,159,21636,283573,565,388017,38940,8,3311,130000.0,43333.0,-70.0,-63.0,-71.0,-69.0,-69.0,-62.0,-72.0,-68.0,-79.0,-84.0,-79.0,-85.0,9.0,21.0,8.0,16.0,1
2623,F8:59:71:5A:E0:3D,2313588,512275576,156325,238604586,2157263,273670990,354,113495,159600348,113382,159583897,113,16451,112865,42,156331,9547,354,248,144444.0,43333.0,-66.0,-74.0,-64.0,-71.0,-66.0,-73.0,-64.0,-70.0,-79.0,-84.0,-79.0,-85.0,13.0,10.0,15.0,14.0,1
2624,CC:2F:71:3E:C5:1F,2157386,273685750,123,14760,2157263,273670990,0,564,47212,475,36512,89,10700,133,1,209,9,0,30,130000.0,39000.0,-77.0,-84.0,-75.0,-72.0,-71.0,-72.0,-68.0,-62.0,-79.0,-84.0,-79.0,-85.0,2.0,0.0,4.0,13.0,1
2625,CC:2F:71:3F:1F:24,2545424,783211688,388161,509540698,2157263,273670990,8,290480,359566299,290321,359544663,159,21636,283759,565,388217,38949,8,3315,130000.0,43333.0,-69.0,-63.0,-71.0,-69.0,-69.0,-63.0,-71.0,-68.0,-79.0,-84.0,-79.0,-85.0,10.0,21.0,8.0,16.0,1
2626,F8:59:71:5A:E0:3D,2313725,512475356,156453,238803498,2157272,273671858,354,113623,159797482,113510,159781031,113,16451,112992,42,156459,9547,354,248,144444.0,43333.0,-67.0,-74.0,-64.0,-70.0,-66.0,-73.0,-64.0,-69.0,-79.0,-84.0,-79.0,-85.0,12.0,10.0,15.0,15.0,1
2627,CC:2F:71:3E:C5:1F,2157395,273686618,123,14760,2157272,273671858,0,564,47212,475,36512,89,10700,133,1,209,9,0,30,130000.0,39000.0,-77.0,-84.0,-75.0,-72.0,-71.0,-72.0,-68.0,-62.0,-79.0,-84.0,-79.0,-85.0,2.0,0.0,4.0,13.0,1
2628,CC:2F:71:3F:1F:24,2545775,783695702,388503,510023844,2157272,273671858,8,290816,360046600,290657,360024964,159,21636,284077,565,388559,38965,8,3353,130000.0,43333.0,-69.0,-63.0,-71.0,-68.0,-68.0,-62.0,-71.0,-67.0,-79.0,-84.0,-79.0,-85.0,10.0,21.0,8.0,17.0,1
2629,F8:59:71:5A:E0:3D,2314042,512960497,156764,239288033,2157278,273672464,354,113782,159981672,113669,159965221,113,16451,113150,42,156770,9579,354,248,144444.0,43333.0,-66.0,-73.0,-65.0,-70.0,-66.0,-73.0,-65.0,-70.0,-79.0,-84.0,-79.0,-85.0,13.0,11.0,14.0,15.0,1
2630,CC:2F:71:3E:C5:1F,2157405,273687548,123,14760,2157282,273672788,0,566,47400,476,36582,90,10818,134,1,209,9,0,31,130000.0,39000.0,-72.0,-69.0,-65.0,-60.0,-71.0,-71.0,-68.0,-62.0,-79.0,-83.0,-79.0,-85.0,7.0,14.0,14.0,25.0,1
2631,CC:2F:71:3F:1F:24,2546122,784158827,388838,510485837,2157284,273672990,8,291135,360500419,290976,360478783,159,21636,284396,565,388892,38979,8,3381,130000.0,43333.0,-69.0,-63.0,-67.0,-68.0,-67.0,-63.0,-71.0,-67.0,-79.0,-83.0,-79.0,-85.0,10.0,20.0,12.0,17.0,1
2632,F8:59:71:5A:E0:3D,2314299,513315177,157004,239641117,2157295,273674060,354,114024,160337358,113911,160320907,113,16451,113391,42,157004,9579,354,249,144444.0,43333.0,-67.0,-74.0,-66.0,-70.0,-66.0,-73.0,-65.0,-70.0,-79.0,-83.0,-80.0,-85.0,12.0,9.0,14.0,15.0,1
2633,CC:2F:71:3E:C5:1F,2157420,273689022,123,14760,2157297,273674262,0,566,47400,476,36582,90,10818,134,1,209,9,0,31,130000.0,39000.0,-72.0,-69.0,-65.0,-60.0,-71.0,-71.0,-68.0,-62.0,-79.0,-83.0,-80.0,-85.0,7.0,14.0,15.0,25.0,1
2634,CC:2F:71:3F:1F:24,2547472,786065153,390175,512390891,2157297,273674262,8,291654,361038381,291495,361016745,159,21636,284896,565,390231,39020,8,3400,117000.0,39000.0,-69.0,-64.0,-71.0,-68.0,-67.0,-63.0,-72.0,-68.0,-79.0,-83.0,-80.0,-85.0,10.0,19.0,9.0,17.0,1
2635,F8:59:71:5A:E0:3D,2314389,513449113,157090,239774649,2157299,273674464,354,114099,160452858,113986,160436407,113,16451,113466,42,157096,9580,354,249,144444.0,43333.0,-67.0,-74.0,-65.0,-70.0,-66.0,-73.0,-65.0,-70.0,-79.0,-83.0,-80.0,-85.0,12.0,9.0,15.0,15.0,1
2636,CC:2F:71:3E:C5:1F,2157422,273689224,123,14760,2157299,273674464,0,566,47400,476,36582,90,10818,134,1,209,9,0,31,130000.0,39000.0,-72.0,-69.0,-65.0,-60.0,-71.0,-71.0,-68.0,-62.0,-79.0,-83.0,-80.0,-85.0,7.0,14.0,15.0,25.0,1
2637,CC:2F:71:3F:1F:24,2547647,786294693,390348,512620229,2157299,273674464,8,291815,361257565,291656,361235929,159,21636,285055,565,390402,39024,8,3403,130000.0,43333.0,-68.0,-64.0,-71.0,-69.0,-68.0,-63.0,-72.0,-68.0,-79.0,-83.0,-80.0,-85.0,11.0,19.0,9.0,16.0,1
2638,F8:59:71:5A:E0:3D,2314465,513558499,157160,239883429,2157305,273675070,354,114170,160562198,114057,160545747,113,16451,113537,42,157166,9583,354,249,144444.0,43333.0,-66.0,-74.0,-65.0,-70.0,-66.0,-73.0,-65.0,-70.0,-79.0,-83.0,-80.0,-85.0,13.0,9.0,15.0,15.0,1
2639,CC:2F:71:3E:C5:1F,2157429,273689892,123,14760,2157306,273675132,0,566,47400,476,36582,90,10818,134,1,209,9,0,31,130000.0,39000.0,-72.0,-69.0,-65.0,-60.0,-71.0,-71.0,-68.0,-62.0,-79.0,-83.0,-80.0,-85.0,7.0,14.0,15.0,25.0,1
2640,CC:2F:71:3F:1F:24,2547829,786529455,390523,512854323,2157306,273675132,8,291981,361484781,291821,361463027,160,21754,285220,565,390579,39024,8,3405,130000.0,43333.0,-70.0,-64.0,-73.0,-69.0,-68.0,-64.0,-71.0,-69.0,-79.0,-83.0,-80.0,-85.0,9.0,19.0,7.0,16.0,1
2641,F8:59:71:5A:E0:3D,2314537,513662835,157227,239987379,2157310,273675456,354,114239,160667036,114125,160650467,114,16569,113606,42,157233,9584,354,249,144444.0,43333.0,-66.0,-74.0,-65.0,-70.0,-66.0,-73.0,-65.0,-70.0,-79.0,-84.0,-80.0,-85.0,13.0,10.0,15.0,15.0,1
2642,CC:2F:71:3E:C5:1F,2157433,273690216,123,14760,2157310,273675456,0,566,47400,476,36582,90,10818,134,1,209,9,0,31,130000.0,39000.0,-72.0,-69.0,-65.0,-60.0,-71.0,-71.0,-68.0,-62.0,-79.0,-84.0,-80.0,-85.0,7.0,15.0,15.0,25.0,1
2643,CC:2F:71:3F:1F:24,2548024,786782788,390714,513107332,2157310,273675456,8,292157,361729156,291997,361707402,160,21754,285396,565,390770,39028,8,3408,130000.0,43333.0,-69.0,-64.0,-72.0,-68.0,-68.0,-64.0,-71.0,-68.0,-79.0,-84.0,-80.0,-85.0,10.0,20.0,8.0,17.0,1
2644,F8:59:71:5A:E0:3D,2315066,514463250,157740,240786047,2157326,273677203,354,114542,161063428,114428,161046859,114,16569,113908,42,157746,9584,354,249,144444.0,43333.0,-66.0,-74.0,-65.0,-70.0,-66.0,-73.0,-64.0,-70.0,-79.0,-83.0,-80.0,-84.0,13.0,9.0,15.0,14.0,1
2645,CC:2F:71:3E:C5:1F,2157449,273691963,123,14760,2157326,273677203,0,566,47400,476,36582,90,10818,134,1,209,9,0,31,130000.0,39000.0,-72.0,-69.0,-65.0,-60.0,-71.0,-71.0,-68.0,-62.0,-79.0,-83.0,-80.0,-84.0,7.0,14.0,15.0,24.0,1
2646,CC:2F:71:3F:1F:24,2549396,788697212,392070,515020009,2157326,273677203,8,292848,362560855,292688,362539101,160,21754,286055,565,392125,39078,8,3447,130000.0,43333.0,-68.0,-64.0,-72.0,-68.0,-68.0,-63.0,-71.0,-68.0,-79.0,-83.0,-80.0,-84.0,11.0,19.0,8.0,16.0,1
2647,F8:59:71:5A:E0:3D,2315203,514663030,157868,240984959,2157335,273678071,354,114637,161209728,114523,161193159,114,16569,114003,42,157874,9585,354,249,144444.0,43333.0,-66.0,-73.0,-64.0,-70.0,-66.0,-73.0,-64.0,-69.0,-79.0,-83.0,-80.0,-84.0,13.0,10.0,16.0,14.0,1
2648,CC:2F:71:3E:C5:1F,2157458,273692831,123,14760,2157335,273678071,0,566,47400,476,36582,90,10818,134,1,209,9,0,31,130000.0,39000.0,-72.0,-69.0,-65.0,-60.0,-71.0,-71.0,-68.0,-62.0,-79.0,-83.0,-80.0,-84.0,7.0,14.0,15.0,24.0,1
2649,CC:2F:71:3F:1F:24,2549640,789015257,392305,515337186,2157335,273678071,8,293070,362873038,292910,362851284,160,21754,286277,565,392361,39088,8,3464,117000.0,39000.0,-67.0,-63.0,-71.0,-68.0,-68.0,-63.0,-71.0,-67.0,-79.0,-83.0,-80.0,-84.0,12.0,20.0,9.0,16.0,1
2650,F8:59:71:5A:E0:3D,2315405,514965712,158068,241287439,2157337,273678273,354,114759,161357282,114645,161340713,114,16569,114124,42,158074,9586,354,249,144444.0,43333.0,-66.0,-74.0,-65.0,-70.0,-66.0,-73.0,-65.0,-70.0,-79.0,-83.0,-80.0,-84.0,13.0,9.0,15.0,14.0,1
2651,CC:2F:71:3E:C5:1F,2157460,273693033,123,14760,2157337,273678273,0,566,47400,476,36582,90,10818,134,1,209,9,0,31,130000.0,39000.0,-72.0,-69.0,-65.0,-60.0,-71.0,-71.0,-68.0,-62.0,-79.0,-83.0,-80.0,-84.0,7.0,14.0,15.0,24.0,1
2652,CC:2F:71:3F:1F:24,2549798,789219691,392461,515541418,2157337,273678273,8,293215,363070942,293055,363049188,160,21754,286414,565,392517,39088,8,3466,130000.0,43333.0,-68.0,-62.0,-74.0,-67.0,-68.0,-62.0,-74.0,-67.0,-79.0,-83.0,-80.0,-84.0,11.0,21.0,6.0,17.0,1
2653,F8:59:71:5A:E0:3D,2315474,515062726,158130,241383787,2157344,273678939,354,114822,161454302,114708,161437733,114,16569,114187,42,158136,9587,354,249,144444.0,43333.0,-66.0,-74.0,-65.0,-70.0,-66.0,-73.0,-64.0,-70.0,-79.0,-83.0,-80.0,-84.0,13.0,9.0,15.0,14.0,1
2654,CC:2F:71:3E:C5:1F,2157467,273693699,123,14760,2157344,273678939,0,566,47400,476,36582,90,10818,134,1,209,9,0,31,130000.0,39000.0,-72.0,-69.0,-65.0,-60.0,-71.0,-71.0,-68.0,-62.0,-79.0,-83.0,-80.0,-84.0,7.0,14.0,15.0,24.0,1
2655,CC:2F:71:3F:1F:24,2549980,789430965,392636,515752026,2157344,273678939,8,293375,363273595,293215,363251841,160,21754,286574,565,392692,39100,8,3466,117000.0,39000.0,-69.0,-62.0,-75.0,-67.0,-68.0,-62.0,-74.0,-67.0,-79.0,-83.0,-80.0,-84.0,10.0,21.0,5.0,17.0,1
2656,F8:59:71:5A:E0:3D,2315572,515207626,158228,241528687,2157344,273678939,354,114897,161559214,114783,161542645,114,16569,114262,42,158234,9588,354,249,144444.0,43333.0,-67.0,-74.0,-65.0,-70.0,-66.0,-73.0,-64.0,-70.0,-79.0,-83.0,-80.0,-84.0,12.0,9.0,15.0,14.0,1
2657,CC:2F:71:3E:C5:1F,2157467,273693699,123,14760,2157344,273678939,0,566,47400,476,36582,90,10818,134,1,209,9,0,31,130000.0,39000.0,-72.0,-69.0,-65.0,-60.0,-71.0,-71.0,-68.0,-62.0,-79.0,-83.0,-80.0,-84.0,7.0,14.0,15.0,24.0,1
2658,CC:2F:71:3F:1F:24,2550139,789637193,392793,515958052,2157346,273679141,8,293519,363467947,293359,363446193,160,21754,286718,565,392848,39100,8,3466,130000.0,43333.0,-69.0,-64.0,-76.0,-68.0,-69.0,-63.0,-75.0,-67.0,-79.0,-83.0,-80.0,-84.0,10.0,19.0,4.0,16.0,1
2659,F8:59:71:5A:E0:3D,2315645,515311052,158297,241631709,2157348,273679343,354,114968,161664754,114854,161648185,114,16569,114333,42,158303,9588,354,249,144444.0,43333.0,-66.0,-74.0,-65.0,-70.0,-66.0,-73.0,-65.0,-70.0,-79.0,-83.0,-80.0,-84.0,13.0,9.0,15.0,14.0,1
2660,CC:2F:71:3E:C5:1F,2157471,273694103,123,14760,2157348,273679343,0,566,47400,476,36582,90,10818,134,1,209,9,0,31,130000.0,39000.0,-72.0,-69.0,-65.0,-60.0,-71.0,-71.0,-68.0,-62.0,-79.0,-83.0,-80.0,-84.0,7.0,14.0,15.0,24.0,1
2661,CC:2F:71:3F:1F:24,2550311,789853414,392961,516173869,2157350,273679545,8,293673,363675348,293513,363653594,160,21754,286871,565,393017,39100,8,3466,130000.0,43333.0,-69.0,-63.0,-75.0,-68.0,-68.0,-62.0,-75.0,-67.0,-79.0,-83.0,-80.0,-84.0,10.0,20.0,5.0,16.0,1
2662,F8:59:71:5A:E0:3D,2315716,515414080,158363,241734273,2157353,273679807,354,115031,161761788,114917,161745219,114,16569,114395,42,158369,9588,354,249,144444.0,43333.0,-66.0,-74.0,-65.0,-70.0,-66.0,-74.0,-64.0,-69.0,-79.0,-83.0,-80.0,-84.0,13.0,9.0,15.0,14.0,1
2663,CC:2F:71:3E:C5:1F,2157476,273694567,123,14760,2157353,273679807,0,566,47400,476,36582,90,10818,134,1,209,9,0,31,130000.0,39000.0,-72.0,-69.0,-65.0,-60.0,-71.0,-71.0,-68.0,-62.0,-79.0,-83.0,-80.0,-84.0,7.0,14.0,15.0,24.0,1
2664,CC:2F:71:3F:1F:24,2551702,791820867,394345,518140656,2157357,273680211,8,294061,364030597,293901,364008843,160,21754,287259,565,394401,39124,8,3478,130000.0,43333.0,-68.0,-62.0,-74.0,-67.0,-68.0,-62.0,-73.0,-67.0,-79.0,-83.0,-80.0,-84.0,11.0,21.0,6.0,17.0,1
2665,F8:59:71:5A:E0:3D,2315901,515685546,158537,242004669,2157364,273680877,354,115216,162046940,115102,162030371,114,16569,114579,42,158543,9596,354,249,144444.0,43333.0,-66.0,-74.0,-65.0,-70.0,-66.0,-73.0,-65.0,-70.0,-79.0,-83.0,-80.0,-84.0,13.0,9.0,15.0,14.0,1
2666,CC:2F:71:3E:C5:1F,2157489,273695839,123,14760,2157366,273681079,0,566,47400,476,36582,90,10818,134,1,209,9,0,31,130000.0,39000.0,-72.0,-69.0,-65.0,-60.0,-71.0,-71.0,-68.0,-62.0,-79.0,-83.0,-80.0,-84.0,7.0,14.0,15.0,24.0,1
2667,CC:2F:71:3F:1F:24,2552010,792246797,394644,518565718,2157366,273681079,8,294384,364504373,294224,364482619,160,21754,287566,565,394700,39128,8,3496,130000.0,43333.0,-69.0,-64.0,-73.0,-69.0,-69.0,-64.0,-72.0,-68.0,-79.0,-83.0,-80.0,-84.0,10.0,19.0,7.0,15.0,1
2668,F8:59:71:5A:E0:3D,2316186,516117314,158816,242435831,2157370,273681483,354,115330,162170396,115216,162153827,114,16569,114693,42,158822,9596,354,249,144444.0,43333.0,-66.0,-74.0,-65.0,-70.0,-66.0,-74.0,-65.0,-69.0,-79.0,-83.0,-80.0,-84.0,13.0,9.0,15.0,14.0,1
2669,CC:2F:71:3E:C5:1F,2157494,273696359,124,14876,2157370,273681483,0,568,47540,478,36722,90,10818,134,1,210,9,0,31,130000.0,39000.0,-72.0,-70.0,-65.0,-60.0,-72.0,-71.0,-67.0,-62.0,-79.0,-83.0,-80.0,-84.0,7.0,13.0,15.0,24.0,1
2670,CC:2F:71:3F:1F:24,2552206,792498889,394836,518817406,2157370,273681483,8,294570,364756413,294410,364734659,160,21754,287744,565,394892,39129,8,3497,130000.0,43333.0,-69.0,-64.0,-71.0,-69.0,-69.0,-63.0,-72.0,-68.0,-79.0,-83.0,-80.0,-84.0,10.0,19.0,9.0,15.0,1
2671,F8:59:71:5A:E0:3D,2316264,516232714,158890,242550827,2157374,273681887,354,115404,162284356,115290,162267787,114,16569,114767,42,158896,9596,354,249,144444.0,43333.0,-66.0,-73.0,-65.0,-70.0,-66.0,-73.0,-65.0,-70.0,-79.0,-83.0,-80.0,-84.0,13.0,10.0,15.0,14.0,1
2672,CC:2F:71:3E:C5:1F,2157498,273696763,124,14876,2157374,273681887,0,568,47540,478,36722,90,10818,134,1,210,9,0,31,130000.0,39000.0,-72.0,-70.0,-65.0,-60.0,-72.0,-71.0,-67.0,-62.0,-79.0,-83.0,-80.0,-84.0,7.0,13.0,15.0,24.0,1
2673,CC:2F:71:3F:1F:24,2552390,792716153,395015,519033993,2157375,273682160,8,294740,364968006,294580,364946252,160,21754,287913,565,395071,39129,8,3500,130000.0,43333.0,-69.0,-62.0,-75.0,-67.0,-68.0,-62.0,-74.0,-67.0,-79.0,-83.0,-80.0,-84.0,10.0,21.0,5.0,17.0,1
2674,F8:59:71:5A:E0:3D,2316455,516520488,159075,242837864,2157380,273682624,354,115486,162388254,115372,162371685,114,16569,114849,42,159081,9597,354,249,144444.0,43333.0,-67.0,-74.0,-65.0,-70.0,-66.0,-73.0,-64.0,-69.0,-79.0,-83.0,-80.0,-84.0,12.0,9.0,15.0,14.0,1
2675,CC:2F:71:3E:C5:1F,2157504,273697500,124,14876,2157380,273682624,0,568,47540,478,36722,90,10818,134,1,210,9,0,31,130000.0,39000.0,-72.0,-70.0,-65.0,-60.0,-72.0,-71.0,-67.0,-62.0,-79.0,-83.0,-80.0,-84.0,7.0,13.0,15.0,24.0,1
2676,CC:2F:71:3F:1F:24,2552552,792922531,395172,519239907,2157380,273682624,8,294883,365165090,294723,365143336,160,21754,288056,565,395228,39138,8,3500,130000.0,43333.0,-68.0,-62.0,-75.0,-67.0,-68.0,-62.0,-74.0,-67.0,-79.0,-83.0,-80.0,-84.0,11.0,21.0,5.0,17.0,1
2677,F8:59:71:5A:E0:3D,2316523,516619022,159138,242935766,2157385,273683256,354,115551,162485414,115437,162468845,114,16569,114912,42,159144,9597,354,249,144444.0,43333.0,-67.0,-74.0,-65.0,-70.0,-66.0,-73.0,-65.0,-70.0,-79.0,-83.0,-80.0,-84.0,12.0,9.0,15.0,14.0,1
2678,CC:2F:71:3E:C5:1F,2157509,273698132,124,14876,2157385,273683256,0,568,47540,478,36722,90,10818,134,1,210,9,0,31,130000.0,39000.0,-72.0,-70.0,-65.0,-60.0,-72.0,-71.0,-67.0,-62.0,-79.0,-83.0,-80.0,-84.0,7.0,13.0,15.0,24.0,1
2679,CC:2F:71:3F:1F:24,2552713,793124617,395326,519441159,2157387,273683458,8,295024,365356248,294863,365334376,161,21872,288197,565,395382,39149,8,3500,130000.0,43333.0,-70.0,-64.0,-76.0,-69.0,-69.0,-62.0,-75.0,-67.0,-79.0,-83.0,-80.0,-84.0,9.0,19.0,4.0,15.0,1
2680,F8:59:71:5A:E0:3D,2316589,516715774,159200,243032114,2157389,273683660,354,115614,162582448,115500,162565879,114,16569,114974,42,159206,9597,354,249,144444.0,43333.0,-66.0,-74.0,-65.0,-70.0,-66.0,-73.0,-65.0,-69.0,-79.0,-83.0,-80.0,-84.0,13.0,9.0,15.0,14.0,1
2681,CC:2F:71:3E:C5:1F,2157515,273698738,124,14876,2157391,273683862,0,568,47540,478,36722,90,10818,134,1,210,9,0,31,130000.0,39000.0,-72.0,-70.0,-65.0,-60.0,-72.0,-71.0,-67.0,-62.0,-79.0,-83.0,-80.0,-84.0,7.0,13.0,15.0,24.0,1
2682,CC:2F:71:3F:1F:24,2552875,793329795,395483,519645873,2157392,273683922,8,295167,365553332,295006,365531460,161,21872,288340,565,395539,39149,8,3500,130000.0,43333.0,-69.0,-63.0,-75.0,-68.0,-69.0,-62.0,-75.0,-67.0,-79.0,-83.0,-80.0,-84.0,10.0,20.0,5.0,16.0,1
2683,F8:59:71:5A:E0:3D,2316655,516813938,159263,243130016,2157392,273683922,354,115677,162679468,115563,162662899,114,16569,115037,42,159269,9598,354,249,144444.0,43333.0,-67.0,-74.0,-65.0,-70.0,-66.0,-73.0,-64.0,-70.0,-79.0,-83.0,-80.0,-84.0,12.0,9.0,15.0,14.0,1
2684,CC:2F:71:3E:C5:1F,2157518,273699000,124,14876,2157394,273684124,0,568,47540,478,36722,90,10818,134,1,210,9,0,31,130000.0,39000.0,-72.0,-70.0,-65.0,-60.0,-72.0,-71.0,-67.0,-62.0,-79.0,-83.0,-80.0,-84.0,7.0,13.0,15.0,24.0,1
2685,CC:2F:71:3F:1F:24,2553036,793536381,395642,519852257,2157394,273684124,8,295310,365750406,295149,365728534,161,21872,288483,565,395698,39149,8,3500,130000.0,43333.0,-69.0,-63.0,-75.0,-68.0,-68.0,-62.0,-75.0,-67.0,-79.0,-83.0,-80.0,-84.0,10.0,20.0,5.0,16.0,1
2686,F8:59:71:5A:E0:3D,2316725,516911070,159326,243226480,2157399,273684590,354,115741,162775172,115626,162758485,115,16687,115101,42,159332,9598,354,249,144444.0,43333.0,-67.0,-74.0,-65.0,-70.0,-66.0,-73.0,-65.0,-70.0,-79.0,-84.0,-81.0,-86.0,12.0,10.0,16.0,16.0,1
2687,CC:2F:71:3E:C5:1F,2157523,273699466,124,14876,2157399,273684590,0,568,47540,478,36722,90,10818,134,1,210,9,0,31,130000.0,39000.0,-72.0,-70.0,-65.0,-60.0,-72.0,-71.0,-67.0,-62.0,-79.0,-84.0,-81.0,-86.0,7.0,14.0,16.0,26.0,1
2688,CC:2F:71:3F:1F:24,2553205,793743165,395806,520058575,2157399,273684590,8,295460,365945950,295299,365924078,161,21872,288633,565,395862,39165,8,3500,130000.0,43333.0,-69.0,-63.0,-76.0,-67.0,-69.0,-62.0,-75.0,-67.0,-79.0,-84.0,-81.0,-86.0,10.0,21.0,5.0,19.0,1
2689,F8:59:71:5A:E0:3D,2316793,517012342,159391,243327490,2157402,273684852,354,115807,162876812,115692,162860125,115,16687,115167,42,159397,9598,354,249,144444.0,43333.0,-66.0,-74.0,-65.0,-70.0,-66.0,-73.0,-64.0,-69.0,-79.0,-84.0,-81.0,-86.0,13.0,10.0,16.0,16.0,1
2690,CC:2F:71:3E:C5:1F,2157528,273699930,124,14876,2157404,273685054,0,568,47540,478,36722,90,10818,134,1,210,9,0,31,130000.0,39000.0,-72.0,-70.0,-65.0,-60.0,-72.0,-71.0,-67.0,-62.0,-79.0,-84.0,-81.0,-86.0,7.0,14.0,16.0,26.0,1
2691,CC:2F:71:3F:1F:24,2554137,795035682,396733,521350628,2157404,273685054,8,295759,366208155,295598,366186283,161,21872,288931,565,396789,39165,8,3500,130000.0,43333.0,-69.0,-62.0,-75.0,-67.0,-68.0,-62.0,-75.0,-67.0,-79.0,-84.0,-81.0,-86.0,10.0,22.0,6.0,19.0,1
2692,F8:59:71:5A:E0:3D,2317078,517435084,159670,243749626,2157408,273685458,354,115929,163008056,115814,162991369,115,16687,115289,42,159676,9598,354,249,144444.0,43333.0,-67.0,-74.0,-65.0,-70.0,-66.0,-73.0,-65.0,-70.0,-79.0,-84.0,-81.0,-86.0,12.0,10.0,16.0,16.0,1
2693,CC:2F:71:3E:C5:1F,2157532,273700334,124,14876,2157408,273685458,0,568,47540,478,36722,90,10818,134,1,210,9,0,31,130000.0,39000.0,-72.0,-70.0,-65.0,-60.0,-72.0,-71.0,-67.0,-62.0,-79.0,-84.0,-81.0,-86.0,7.0,14.0,16.0,26.0,1
2694,CC:2F:71:3F:1F:24,2554315,795250746,396905,521565086,2157410,273685660,8,295916,366418220,295755,366396348,161,21872,289088,565,396961,39175,8,3500,117000.0,39000.0,-68.0,-62.0,-74.0,-67.0,-68.0,-62.0,-74.0,-67.0,-79.0,-84.0,-81.0,-86.0,11.0,22.0,7.0,19.0,1
2695,F8:59:71:5A:E0:3D,2317146,517536358,159735,243850636,2157411,273685722,354,115994,163108156,115879,163091469,115,16687,115354,42,159741,9598,354,249,144444.0,43333.0,-66.0,-73.0,-65.0,-70.0,-66.0,-73.0,-64.0,-69.0,-79.0,-84.0,-81.0,-86.0,13.0,11.0,16.0,16.0,1
2696,CC:2F:71:3E:C5:1F,2157535,273700598,124,14876,2157411,273685722,0,570,47728,479,36792,91,10936,135,1,210,9,0,31,130000.0,39000.0,-76.0,-85.0,-75.0,-71.0,-73.0,-72.0,-67.0,-62.0,-79.0,-84.0,-81.0,-86.0,3.0,-1.0,6.0,15.0,1
2697,CC:2F:71:3F:1F:24,2554475,795457036,397062,521771112,2157413,273685924,8,296057,366612224,295896,366590352,161,21872,289229,565,397118,39175,8,3500,130000.0,43333.0,-68.0,-62.0,-75.0,-67.0,-68.0,-62.0,-74.0,-67.0,-79.0,-84.0,-81.0,-86.0,11.0,22.0,6.0,19.0,1
2698,F8:59:71:5A:E0:3D,2317216,517634926,159798,243948538,2157418,273686388,354,116057,163205176,115942,163188489,115,16687,115417,42,159804,9599,354,249,144444.0,43333.0,-66.0,-74.0,-65.0,-70.0,-66.0,-73.0,-65.0,-70.0,-79.0,-84.0,-81.0,-86.0,13.0,10.0,16.0,16.0,1
2699,CC:2F:71:3E:C5:1F,2157542,273701264,124,14876,2157418,273686388,0,570,47728,479,36792,91,10936,135,1,210,9,0,31,130000.0,39000.0,-76.0,-85.0,-75.0,-71.0,-73.0,-72.0,-67.0,-62.0,-79.0,-84.0,-81.0,-86.0,3.0,-1.0,6.0,15.0,1
2700,CC:2F:71:3F:1F:24,2554658,795678026,397240,521991638,2157418,273686388,8,296220,366821274,296059,366799402,161,21872,289392,565,397296,39188,8,3500,130000.0,43333.0,-68.0,-63.0,-74.0,-68.0,-68.0,-62.0,-74.0,-67.0,-79.0,-84.0,-81.0,-86.0,11.0,21.0,7.0,18.0,1
2701,F8:59:71:5A:E0:3D,2317304,517747127,159884,244060537,2157420,273686590,354,116145,163315687,116030,163299000,115,16687,115505,42,159890,9600,354,249,144444.0,43333.0,-67.0,-74.0,-65.0,-70.0,-66.0,-73.0,-65.0,-70.0,-79.0,-84.0,-81.0,-86.0,12.0,10.0,16.0,16.0,1
2702,CC:2F:71:3E:C5:1F,2157544,273701466,124,14876,2157420,273686590,0,570,47728,479,36792,91,10936,135,1,210,9,0,31,130000.0,39000.0,-76.0,-85.0,-75.0,-71.0,-73.0,-72.0,-67.0,-62.0,-79.0,-84.0,-81.0,-86.0,3.0,-1.0,6.0,15.0,1
2703,CC:2F:71:3F:1F:24,2555209,796438323,397789,522751733,2157420,273686590,8,296430,367037594,296269,367015722,161,21872,289602,565,397845,39189,8,3500,130000.0,43333.0,-69.0,-63.0,-75.0,-69.0,-69.0,-63.0,-75.0,-68.0,-79.0,-84.0,-81.0,-86.0,10.0,21.0,6.0,17.0,1
2704,F8:59:71:5A:E0:3D,2317372,517844081,159946,244156885,2157426,273687196,354,116207,163411167,116092,163394480,115,16687,115567,42,159952,9600,354,249,144444.0,43333.0,-67.0,-74.0,-65.0,-70.0,-66.0,-73.0,-65.0,-70.0,-79.0,-84.0,-81.0,-86.0,12.0,10.0,16.0,16.0,1
2705,CC:2F:71:3E:C5:1F,2157550,273702072,124,14876,2157426,273687196,0,570,47728,479,36792,91,10936,135,1,210,9,0,31,130000.0,39000.0,-76.0,-85.0,-75.0,-71.0,-73.0,-72.0,-67.0,-62.0,-79.0,-84.0,-81.0,-86.0,3.0,-1.0,6.0,15.0,1
2706,CC:2F:71:3F:1F:24,2555380,796650884,397954,522963688,2157426,273687196,8,296583,367239204,296422,367217332,161,21872,289754,565,398010,39189,8,3500,130000.0,43333.0,-70.0,-63.0,-75.0,-69.0,-69.0,-62.0,-75.0,-68.0,-79.0,-84.0,-81.0,-86.0,9.0,21.0,6.0,17.0,1
2707,F8:59:71:5A:E0:3D,2317439,517943799,160010,244256341,2157429,273687458,354,116270,163508187,116155,163491500,115,16687,115630,42,160016,9600,354,249,144444.0,43333.0,-66.0,-74.0,-65.0,-70.0,-66.0,-73.0,-65.0,-70.0,-80.0,-84.0,-81.0,-86.0,14.0,10.0,16.0,16.0,1
2708,CC:2F:71:3E:C5:1F,2157553,273702334,124,14876,2157429,273687458,0,570,47728,479,36792,91,10936,135,1,210,9,0,31,130000.0,39000.0,-76.0,-85.0,-75.0,-71.0,-73.0,-72.0,-67.0,-62.0,-80.0,-84.0,-81.0,-86.0,4.0,-1.0,6.0,15.0,1
2709,CC:2F:71:3F:1F:24,2555549,796857085,398120,523169627,2157429,273687458,8,296736,367439572,296575,367417700,161,21872,289904,565,398176,39194,8,3500,130000.0,43333.0,-68.0,-63.0,-75.0,-68.0,-68.0,-62.0,-75.0,-67.0,-80.0,-84.0,-81.0,-86.0,12.0,21.0,6.0,18.0,1
2710,F8:59:71:5A:E0:3D,2317509,518045343,160076,244357481,2157433,273687862,354,116339,163613425,116224,163596738,115,16687,115699,42,160082,9600,354,249,144444.0,43333.0,-66.0,-74.0,-65.0,-70.0,-66.0,-74.0,-65.0,-69.0,-80.0,-84.0,-81.0,-86.0,14.0,10.0,16.0,16.0,1
2711,CC:2F:71:3E:C5:1F,2157559,273702940,124,14876,2157435,273688064,0,570,47728,479,36792,91,10936,135,1,210,9,0,31,130000.0,39000.0,-76.0,-85.0,-75.0,-71.0,-73.0,-72.0,-67.0,-62.0,-80.0,-84.0,-81.0,-86.0,4.0,-1.0,6.0,15.0,1
2712,CC:2F:71:3F:1F:24,2555739,797085397,398304,523397333,2157435,273688064,8,296907,367661780,296746,367639908,161,21872,290072,565,398360,39194,8,3501,130000.0,43333.0,-69.0,-63.0,-75.0,-68.0,-68.0,-62.0,-74.0,-67.0,-80.0,-84.0,-81.0,-86.0,11.0,21.0,6.0,18.0,1
2713,F8:59:71:5A:E0:3D,2317921,518667965,160483,244979426,2157438,273688539,354,116463,163735635,116348,163718948,115,16687,115823,42,160489,9676,354,249,144444.0,43333.0,-66.0,-74.0,-65.0,-70.0,-66.0,-73.0,-65.0,-69.0,-80.0,-84.0,-81.0,-86.0,14.0,10.0,16.0,16.0,1
2714,CC:2F:71:3E:C5:1F,2157562,273703415,124,14876,2157438,273688539,0,570,47728,479,36792,91,10936,135,1,210,9,0,31,130000.0,39000.0,-76.0,-85.0,-75.0,-71.0,-73.0,-72.0,-67.0,-62.0,-80.0,-84.0,-81.0,-86.0,4.0,-1.0,6.0,15.0,1
2715,CC:2F:71:3F:1F:24,2555915,797315380,398476,523626781,2157439,273688599,8,297064,367880424,296903,367858552,161,21872,290229,565,398532,39194,8,3501,130000.0,43333.0,-69.0,-63.0,-76.0,-69.0,-69.0,-62.0,-75.0,-68.0,-80.0,-84.0,-81.0,-86.0,11.0,21.0,5.0,17.0,1
2716,F8:59:71:5A:E0:3D,2317996,518770226,160553,245081223,2157443,273689003,354,116531,163837361,116416,163820674,115,16687,115891,42,160559,9676,354,249,144444.0,43333.0,-66.0,-74.0,-65.0,-70.0,-66.0,-74.0,-64.0,-70.0,-80.0,-84.0,-81.0,-86.0,14.0,10.0,16.0,16.0,1
2717,CC:2F:71:3E:C5:1F,2157569,273704081,124,14876,2157445,273689205,0,570,47728,479,36792,91,10936,135,1,210,9,0,31,130000.0,39000.0,-76.0,-85.0,-75.0,-71.0,-73.0,-72.0,-67.0,-62.0,-80.0,-84.0,-81.0,-86.0,4.0,-1.0,6.0,15.0,1
2718,CC:2F:71:3F:1F:24,2556076,797517368,398631,523828163,2157445,273689205,8,297205,368074428,297044,368052556,161,21872,290370,565,398687,39198,8,3501,130000.0,43333.0,-68.0,-62.0,-75.0,-67.0,-68.0,-62.0,-74.0,-67.0,-80.0,-84.0,-81.0,-86.0,12.0,22.0,6.0,19.0,1
2719,F8:59:71:5A:E0:3D,2318068,518872101,160621,245182694,2157447,273689407,354,116600,163939751,116485,163923064,115,16687,115960,42,160627,9676,354,249,144444.0,43333.0,-67.0,-74.0,-65.0,-70.0,-66.0,-74.0,-65.0,-70.0,-80.0,-84.0,-81.0,-86.0,13.0,10.0,16.0,16.0,1
2720,CC:2F:71:3E:C5:1F,2157571,273704283,124,14876,2157447,273689407,0,570,47728,479,36792,91,10936,135,1,210,9,0,31,130000.0,39000.0,-76.0,-85.0,-75.0,-71.0,-73.0,-72.0,-67.0,-62.0,-80.0,-84.0,-81.0,-86.0,4.0,-1.0,6.0,15.0,1
2721,CC:2F:71:3F:1F:24,2556244,797728863,398797,524039456,2157447,273689407,8,297359,368276160,297198,368254288,161,21872,290524,565,398853,39198,8,3501,130000.0,43333.0,-70.0,-64.0,-76.0,-69.0,-69.0,-63.0,-76.0,-69.0,-80.0,-84.0,-81.0,-86.0,10.0,20.0,5.0,17.0,1
2722,F8:59:71:5A:E0:3D,2318139,518975129,160687,245285258,2157452,273689871,354,116666,164041391,116551,164024704,115,16687,116026,42,160693,9677,354,249,144444.0,43333.0,-66.0,-74.0,-65.0,-70.0,-66.0,-74.0,-65.0,-70.0,-80.0,-84.0,-81.0,-86.0,14.0,10.0,16.0,16.0,1
2723,CC:2F:71:3E:C5:1F,2157578,273704949,124,14876,2157454,273690073,0,570,47728,479,36792,91,10936,135,1,210,9,0,31,130000.0,39000.0,-76.0,-85.0,-75.0,-71.0,-73.0,-72.0,-67.0,-62.0,-80.0,-84.0,-81.0,-86.0,4.0,-1.0,6.0,15.0,1
2724,CC:2F:71:3F:1F:24,2557534,799570975,400078,525880700,2157456,273690275,8,297775,368721111,297614,368699239,161,21872,290923,565,400134,39250,8,3518,130000.0,43333.0,-69.0,-64.0,-72.0,-69.0,-68.0,-64.0,-71.0,-68.0,-80.0,-84.0,-81.0,-86.0,11.0,20.0,9.0,17.0,1
2725,F8:59:71:5A:E0:3D,2318280,519181181,160820,245490502,2157460,273690679,354,116806,164255571,116691,164238884,115,16687,116165,42,160825,9678,354,249,144444.0,43333.0,-67.0,-74.0,-64.0,-70.0,-66.0,-73.0,-64.0,-70.0,-80.0,-84.0,-81.0,-86.0,13.0,10.0,17.0,16.0,1
2726,CC:2F:71:3E:C5:1F,2157584,273705555,124,14876,2157460,273690679,0,570,47728,479,36792,91,10936,135,1,210,9,0,31,130000.0,39000.0,-76.0,-85.0,-75.0,-71.0,-73.0,-72.0,-67.0,-62.0,-80.0,-84.0,-81.0,-86.0,4.0,-1.0,6.0,15.0,1
2727,CC:2F:71:3F:1F:24,2557712,799801013,400250,526110132,2157462,273690881,8,297938,368946399,297777,368924527,161,21872,291083,565,400306,39250,8,3518,130000.0,43333.0,-68.0,-62.0,-75.0,-67.0,-67.0,-62.0,-74.0,-67.0,-80.0,-84.0,-81.0,-86.0,12.0,22.0,6.0,19.0,1
2728,F8:59:71:5A:E0:3D,2318357,519285128,160892,245593985,2157465,273691143,354,116876,164358844,116761,164342157,115,16687,116235,42,160898,9678,354,249,144444.0,43333.0,-66.0,-74.0,-65.0,-70.0,-66.0,-73.0,-65.0,-70.0,-80.0,-84.0,-81.0,-86.0,14.0,10.0,16.0,16.0,1
2729,CC:2F:71:3E:C5:1F,2157589,273706019,124,14876,2157465,273691143,0,570,47728,479,36792,91,10936,135,1,210,9,0,31,130000.0,39000.0,-76.0,-85.0,-75.0,-71.0,-73.0,-72.0,-67.0,-62.0,-80.0,-84.0,-81.0,-86.0,4.0,-1.0,6.0,15.0,1
2730,CC:2F:71:3F:1F:24,2557891,800022441,400426,526331298,2157465,273691143,8,298101,369160624,297940,369138752,161,21872,291245,565,400482,39256,8,3518,130000.0,43333.0,-68.0,-62.0,-73.0,-68.0,-68.0,-62.0,-74.0,-68.0,-80.0,-84.0,-81.0,-86.0,12.0,22.0,8.0,18.0,1
2731,F8:59:71:5A:E0:3D,2318555,519572252,161086,245880705,2157469,273691547,354,116981,164480986,116866,164464299,115,16687,116340,42,161092,9678,354,249,144444.0,43333.0,-66.0,-73.0,-65.0,-70.0,-66.0,-73.0,-65.0,-69.0,-80.0,-84.0,-81.0,-86.0,14.0,11.0,16.0,16.0,1
2732,CC:2F:71:3E:C5:1F,2157593,273706423,124,14876,2157469,273691547,0,570,47728,479,36792,91,10936,135,1,210,9,0,31,130000.0,39000.0,-76.0,-85.0,-75.0,-71.0,-73.0,-72.0,-67.0,-62.0,-80.0,-84.0,-81.0,-86.0,4.0,-1.0,6.0,15.0,1
2733,CC:2F:71:3F:1F:24,2558062,800241661,400593,526550114,2157469,273691547,8,298256,369372032,298095,369350160,161,21872,291399,565,400649,39256,8,3525,130000.0,43333.0,-70.0,-63.0,-76.0,-69.0,-69.0,-62.0,-75.0,-68.0,-80.0,-84.0,-81.0,-86.0,10.0,21.0,5.0,17.0,1
2734,F8:59:71:5A:E0:3D,2318626,519676774,161153,245984823,2157473,273691951,354,117047,164582626,116932,164565939,115,16687,116406,42,161159,9678,354,249,144444.0,43333.0,-66.0,-73.0,-65.0,-70.0,-66.0,-73.0,-65.0,-70.0,-80.0,-84.0,-81.0,-86.0,14.0,11.0,16.0,16.0,1
2735,CC:2F:71:3E:C5:1F,2157597,273706827,124,14876,2157473,273691951,0,570,47728,479,36792,91,10936,135,1,210,9,0,31,130000.0,39000.0,-76.0,-85.0,-75.0,-71.0,-73.0,-72.0,-67.0,-62.0,-80.0,-84.0,-81.0,-86.0,4.0,-1.0,6.0,15.0,1
2736,CC:2F:71:3F:1F:24,2558230,800451674,400757,526759723,2157473,273691951,8,298404,369568764,298243,369546892,161,21872,291547,565,400813,39256,8,3525,130000.0,43333.0,-68.0,-62.0,-75.0,-67.0,-68.0,-62.0,-75.0,-67.0,-80.0,-84.0,-81.0,-86.0,12.0,22.0,6.0,19.0,1
2737,F8:59:71:5A:E0:3D,2318696,519778248,161218,246085833,2157478,273692415,354,117114,164685820,116999,164669133,115,16687,116472,42,161224,9678,354,249,144444.0,43333.0,-67.0,-74.0,-65.0,-70.0,-66.0,-73.0,-65.0,-69.0,-80.0,-84.0,-81.0,-86.0,13.0,10.0,16.0,16.0,1
2738,CC:2F:71:3E:C5:1F,2157602,273707291,124,14876,2157478,273692415,0,570,47728,479,36792,91,10936,135,1,210,9,0,31,130000.0,39000.0,-76.0,-85.0,-75.0,-71.0,-73.0,-72.0,-67.0,-62.0,-80.0,-84.0,-81.0,-86.0,4.0,-1.0,6.0,15.0,1
2739,CC:2F:71:3F:1F:24,2559385,802093319,401907,528400904,2157478,273692415,8,298673,369796953,298512,369775081,161,21872,291815,565,401963,39286,8,3527,130000.0,43333.0,-68.0,-62.0,-75.0,-67.0,-68.0,-62.0,-74.0,-67.0,-80.0,-84.0,-81.0,-86.0,12.0,22.0,6.0,19.0,1
2740,F8:59:71:5A:E0:3D,2318763,519876554,161281,246183735,2157482,273692819,354,117176,164781300,117061,164764613,115,16687,116534,42,161287,9678,354,249,144444.0,43333.0,-66.0,-74.0,-65.0,-70.0,-66.0,-73.0,-65.0,-70.0,-80.0,-84.0,-81.0,-86.0,14.0,10.0,16.0,16.0,1
2741,CC:2F:71:3E:C5:1F,2157606,273707695,124,14876,2157482,273692819,0,570,47728,479,36792,91,10936,135,1,210,9,0,31,130000.0,39000.0,-76.0,-85.0,-75.0,-71.0,-73.0,-72.0,-67.0,-62.0,-80.0,-84.0,-81.0,-86.0,4.0,-1.0,6.0,15.0,1
2742,CC:2F:71:3F:1F:24,2559547,802299991,402065,528607172,2157482,273692819,8,298817,369994153,298656,369972281,161,21872,291959,565,402121,39286,8,3527,130000.0,43333.0,-68.0,-62.0,-74.0,-68.0,-68.0,-62.0,-75.0,-67.0,-80.0,-84.0,-81.0,-86.0,12.0,22.0,7.0,18.0,1
2743,F8:59:71:5A:E0:3D,2318834,519981076,161348,246287853,2157486,273693223,354,117243,164884480,117128,164867793,115,16687,116601,42,161354,9678,354,249,144444.0,43333.0,-66.0,-74.0,-65.0,-70.0,-66.0,-73.0,-65.0,-70.0,-80.0,-84.0,-81.0,-86.0,14.0,10.0,16.0,16.0,1
2744,CC:2F:71:3E:C5:1F,2157611,273708159,124,14876,2157487,273693283,0,570,47728,479,36792,91,10936,135,1,210,9,0,31,130000.0,39000.0,-76.0,-85.0,-75.0,-71.0,-73.0,-72.0,-67.0,-62.0,-80.0,-84.0,-81.0,-86.0,4.0,-1.0,6.0,15.0,1
2745,CC:2F:71:3F:1F:24,2559717,802517597,402229,528824188,2157488,273693409,8,298968,370202147,298807,370180275,161,21872,292109,565,402285,39286,8,3527,130000.0,43333.0,-70.0,-64.0,-76.0,-69.0,-69.0,-62.0,-75.0,-67.0,-80.0,-84.0,-81.0,-86.0,10.0,20.0,5.0,17.0,1
2746,F8:59:71:5A:E0:3D,2318901,520079366,161411,246385755,2157490,273693611,354,117307,164983054,117192,164966367,115,16687,116664,42,161417,9678,354,249,144444.0,43333.0,-66.0,-74.0,-65.0,-70.0,-66.0,-73.0,-65.0,-70.0,-80.0,-84.0,-81.0,-86.0,14.0,10.0,16.0,16.0,1
2747,CC:2F:71:3E:C5:1F,2157616,273708689,124,14876,2157492,273693813,0,570,47728,479,36792,91,10936,135,1,210,9,0,31,130000.0,39000.0,-76.0,-85.0,-75.0,-71.0,-73.0,-72.0,-67.0,-62.0,-80.0,-84.0,-81.0,-86.0,4.0,-1.0,6.0,15.0,1
2748,CC:2F:71:3F:1F:24,2559876,802719383,402384,529025570,2157492,273693813,8,299109,370396151,298948,370374279,161,21872,292250,565,402440,39290,8,3527,130000.0,43333.0,-69.0,-62.0,-75.0,-67.0,-68.0,-62.0,-75.0,-67.0,-80.0,-84.0,-81.0,-86.0,11.0,22.0,6.0,19.0,1
2749,F8:59:71:5A:E0:3D,2318966,520176032,161474,246482219,2157492,273693813,354,117369,165078534,117254,165061847,115,16687,116726,42,161480,9678,354,249,144444.0,43333.0,-67.0,-74.0,-65.0,-70.0,-66.0,-73.0,-65.0,-70.0,-80.0,-84.0,-81.0,-86.0,13.0,10.0,16.0,16.0,1
2750,CC:2F:71:3E:C5:1F,2157620,273709075,125,14992,2157495,273694083,0,572,47868,481,36932,91,10936,135,1,211,9,0,31,130000.0,39000.0,-73.0,-70.0,-65.0,-60.0,-72.0,-70.0,-66.0,-61.0,-80.0,-84.0,-81.0,-86.0,7.0,14.0,16.0,26.0,1
2751,CC:2F:71:3F:1F:24,2560049,802935728,402553,529241511,2157496,273694217,8,299264,370600856,299103,370578984,161,21872,292405,565,402609,39292,8,3527,130000.0,43333.0,-69.0,-63.0,-75.0,-68.0,-69.0,-63.0,-75.0,-68.0,-80.0,-84.0,-81.0,-86.0,11.0,21.0,6.0,18.0,1
2752,F8:59:71:5A:E0:3D,2319205,520533053,161703,246838099,2157502,273694954,354,117463,165182890,117348,165166203,115,16687,116820,42,161709,9696,354,250,130000.0,39000.0,-68.0,-74.0,-65.0,-71.0,-66.0,-74.0,-65.0,-70.0,-80.0,-84.0,-81.0,-86.0,12.0,10.0,16.0,15.0,1
2753,CC:2F:71:3E:C5:1F,2157631,273710350,125,14992,2157506,273695358,0,572,47868,481,36932,91,10936,135,1,211,9,0,31,130000.0,39000.0,-73.0,-70.0,-65.0,-60.0,-72.0,-70.0,-66.0,-61.0,-80.0,-84.0,-81.0,-86.0,7.0,14.0,16.0,26.0,1
2754,CC:2F:71:3F:1F:24,2560722,803885423,403185,530178349,2157537,273707074,8,299854,371470696,299693,371448824,161,21872,292969,565,403240,39306,8,3571,130000.0,43333.0,-66.0,-63.0,-72.0,-69.0,-68.0,-63.0,-71.0,-68.0,-79.0,-84.0,-81.0,-85.0,13.0,21.0,9.0,16.0,1
2755,F8:59:71:5A:E0:3D,2319892,521521815,162341,247813407,2157551,273708408,354,117980,165909024,117864,165892219,116,16805,117336,42,162347,9698,354,251,144444.0,43333.0,-66.0,-74.0,-66.0,-70.0,-66.0,-73.0,-66.0,-69.0,-79.0,-84.0,-81.0,-85.0,13.0,10.0,15.0,15.0,1
2756,CC:2F:71:3E:C5:1F,2157676,273723400,125,14992,2157551,273708408,0,572,47868,481,36932,91,10936,135,1,211,9,0,31,130000.0,39000.0,-73.0,-70.0,-65.0,-60.0,-72.0,-70.0,-66.0,-61.0,-79.0,-84.0,-81.0,-85.0,6.0,14.0,16.0,25.0,1
2757,CC:2F:71:3F:1F:24,2561873,805495506,404322,531787098,2157551,273708408,8,300460,372244741,300299,372222869,161,21872,293481,565,404378,39385,8,3610,144444.0,43333.0,-70.0,-62.0,-66.0,-70.0,-70.0,-62.0,-68.0,-69.0,-79.0,-84.0,-81.0,-85.0,9.0,22.0,15.0,15.0,1
2758,F8:59:71:5A:E0:3D,2319963,521626337,162408,247917525,2157555,273708812,354,118052,166018462,117936,166001657,116,16805,117405,42,162414,9698,354,251,144444.0,43333.0,-67.0,-74.0,-67.0,-70.0,-67.0,-73.0,-66.0,-70.0,-79.0,-84.0,-81.0,-85.0,12.0,10.0,14.0,15.0,1
2759,CC:2F:71:3E:C5:1F,2157680,273723804,125,14992,2157555,273708812,0,572,47868,481,36932,91,10936,135,1,211,9,0,31,130000.0,39000.0,-73.0,-70.0,-65.0,-60.0,-72.0,-70.0,-66.0,-61.0,-79.0,-84.0,-81.0,-85.0,6.0,14.0,16.0,25.0,1
2760,CC:2F:71:3F:1F:24,2562045,805710251,404490,532001439,2157555,273708812,8,300612,372451088,300451,372429216,161,21872,293624,566,404546,39431,8,3614,86667.0,14444.0,-70.0,-62.0,-70.0,-66.0,-70.0,-62.0,-71.0,-66.0,-79.0,-84.0,-81.0,-85.0,9.0,22.0,11.0,19.0,1
2761,F8:59:71:5A:E0:3D,2320081,521793250,162516,248083508,2157565,273709742,354,118197,166240539,118081,166223734,116,16805,117547,43,162522,9703,354,251,144444.0,43333.0,-67.0,-74.0,-66.0,-70.0,-67.0,-74.0,-66.0,-70.0,-80.0,-85.0,-81.0,-86.0,13.0,11.0,15.0,16.0,1
2762,CC:2F:71:3E:C5:1F,2157693,273725089,126,15145,2157567,273709944,0,577,48373,485,37319,92,11054,136,1,212,9,0,31,1000.0,39000.0,-69.0,-62.0,-67.0,-60.0,-71.0,-68.0,-67.0,-61.0,-80.0,-85.0,-81.0,-86.0,11.0,23.0,14.0,26.0,1
2763,CC:2F:71:3F:1F:24,2562885,806893512,405318,533183568,2157567,273709944,8,301037,372998380,300876,372976508,161,21872,294020,566,405375,39459,8,3637,115556.0,28889.0,-67.0,-63.0,-71.0,-70.0,-71.0,-64.0,-71.0,-70.0,-80.0,-85.0,-81.0,-86.0,13.0,22.0,10.0,16.0,1
2764,F8:59:71:5A:E0:3D,2320642,522625473,163051,248912888,2157591,273712585,354,118614,166805283,118498,166788478,116,16805,117955,43,163057,9761,354,252,144444.0,43333.0,-67.0,-73.0,-66.0,-70.0,-67.0,-72.0,-65.0,-69.0,-81.0,-87.0,-81.0,-88.0,14.0,14.0,15.0,18.0,1
2765,CC:2F:71:3E:C5:1F,2157724,273728396,126,15145,2157598,273713251,0,577,48373,485,37319,92,11054,136,1,212,9,0,31,1000.0,39000.0,-69.0,-62.0,-67.0,-60.0,-71.0,-68.0,-67.0,-61.0,-81.0,-87.0,-81.0,-88.0,12.0,25.0,14.0,28.0,1
2766,CC:2F:71:3F:1F:24,2564641,809365445,407041,535651992,2157600,273713453,9,302138,374475448,301976,374453458,162,21990,295093,566,407098,39491,9,3654,144444.0,43333.0,-70.0,-63.0,-66.0,-70.0,-68.0,-63.0,-67.0,-70.0,-81.0,-87.0,-81.0,-88.0,11.0,24.0,15.0,18.0,1
2767,F8:59:71:5A:E0:3D,2321052,523243683,163448,249529826,2157604,273713857,354,118814,167113843,118698,167097038,116,16805,118153,43,163454,9761,354,252,144444.0,43333.0,-67.0,-73.0,-66.0,-70.0,-67.0,-73.0,-65.0,-70.0,-81.0,-87.0,-81.0,-88.0,14.0,14.0,15.0,18.0,1
2768,CC:2F:71:3E:C5:1F,2157730,273729002,126,15145,2157604,273713857,0,577,48373,485,37319,92,11054,136,1,212,9,0,31,1000.0,39000.0,-69.0,-62.0,-67.0,-60.0,-71.0,-68.0,-67.0,-61.0,-81.0,-87.0,-81.0,-88.0,12.0,25.0,14.0,28.0,1
2769,CC:2F:71:3F:1F:24,2564838,809587966,407234,535874109,2157604,273713857,9,302340,374699312,302178,374677322,162,21990,295293,566,407292,39491,9,3654,144444.0,43333.0,-71.0,-63.0,-71.0,-70.0,-69.0,-63.0,-70.0,-70.0,-81.0,-87.0,-81.0,-88.0,10.0,24.0,10.0,18.0,1
2770,F8:59:71:5A:E0:3D,2321118,523341847,163511,249627728,2157607,273714119,354,118877,167210863,118761,167194058,116,16805,118216,43,163517,9761,354,252,144444.0,43333.0,-68.0,-73.0,-66.0,-70.0,-67.0,-73.0,-65.0,-70.0,-81.0,-87.0,-81.0,-88.0,13.0,14.0,15.0,18.0,1
2771,CC:2F:71:3E:C5:1F,2157733,273729264,126,15145,2157607,273714119,0,577,48373,485,37319,92,11054,136,1,212,9,0,31,1000.0,39000.0,-69.0,-62.0,-67.0,-60.0,-71.0,-68.0,-67.0,-61.0,-81.0,-87.0,-81.0,-88.0,12.0,25.0,14.0,28.0,1
2772,CC:2F:71:3F:1F:24,2564998,809794350,407391,536080231,2157607,273714119,9,302489,374902844,302327,374880854,162,21990,295438,566,407449,39491,9,3654,144444.0,43333.0,-66.0,-63.0,-65.0,-70.0,-68.0,-63.0,-68.0,-70.0,-81.0,-87.0,-81.0,-88.0,15.0,24.0,16.0,18.0,1
2773,F8:59:71:5A:E0:3D,2321221,523485760,163608,249770113,2157613,273715647,354,118953,167317317,118837,167300512,116,16805,118292,43,163614,9761,354,252,144444.0,43333.0,-67.0,-73.0,-66.0,-70.0,-67.0,-73.0,-65.0,-70.0,-81.0,-87.0,-81.0,-88.0,14.0,14.0,15.0,18.0,1
2774,CC:2F:71:3E:C5:1F,2157741,273730994,126,15145,2157615,273715849,0,577,48373,485,37319,92,11054,136,1,212,9,0,31,1000.0,39000.0,-69.0,-62.0,-67.0,-60.0,-71.0,-68.0,-67.0,-61.0,-81.0,-87.0,-81.0,-88.0,12.0,25.0,14.0,28.0,1
2775,CC:2F:71:3F:1F:24,2565167,810007156,407552,536291307,2157615,273715849,9,302637,375106232,302475,375084242,162,21990,295584,566,407608,39491,9,3654,144444.0,43333.0,-67.0,-63.0,-67.0,-70.0,-68.0,-63.0,-69.0,-70.0,-81.0,-87.0,-81.0,-88.0,14.0,24.0,14.0,18.0,1
2776,F8:59:71:5A:E0:3D,2321288,523584066,163671,249868015,2157617,273716051,354,119016,167414337,118900,167397532,116,16805,118355,43,163677,9761,354,252,144444.0,43333.0,-67.0,-73.0,-66.0,-70.0,-67.0,-73.0,-66.0,-70.0,-81.0,-87.0,-81.0,-88.0,14.0,14.0,15.0,18.0,1
2777,CC:2F:71:3E:C5:1F,2157743,273731196,126,15145,2157617,273716051,0,577,48373,485,37319,92,11054,136,1,212,9,0,31,1000.0,39000.0,-69.0,-62.0,-67.0,-60.0,-71.0,-68.0,-67.0,-61.0,-81.0,-87.0,-81.0,-88.0,12.0,25.0,14.0,28.0,1
2778,CC:2F:71:3F:1F:24,2565327,810212186,407710,536496135,2157617,273716051,9,302783,375307978,302621,375285988,162,21990,295727,566,407768,39492,9,3654,144444.0,43333.0,-68.0,-63.0,-71.0,-70.0,-69.0,-63.0,-69.0,-70.0,-81.0,-87.0,-81.0,-88.0,13.0,24.0,10.0,18.0,1
2779,F8:59:71:5A:E0:3D,2321409,523762261,163787,250045746,2157622,273716515,354,119096,167520963,118980,167504158,116,16805,118432,43,163793,9761,354,252,144444.0,43333.0,-67.0,-73.0,-66.0,-70.0,-67.0,-73.0,-65.0,-70.0,-81.0,-87.0,-81.0,-88.0,14.0,14.0,15.0,18.0,1
2780,CC:2F:71:3E:C5:1F,2157750,273732784,126,15145,2157624,273717639,0,577,48373,485,37319,92,11054,136,1,212,9,0,31,1000.0,39000.0,-69.0,-62.0,-67.0,-60.0,-71.0,-68.0,-67.0,-61.0,-81.0,-87.0,-81.0,-88.0,12.0,25.0,14.0,28.0,1
2781,CC:2F:71:3F:1F:24,2565493,810423004,407869,536705365,2157624,273717639,9,302934,375516056,302772,375494066,162,21990,295873,566,407926,39493,9,3655,144444.0,43333.0,-71.0,-64.0,-67.0,-70.0,-70.0,-63.0,-69.0,-70.0,-81.0,-87.0,-81.0,-88.0,10.0,23.0,14.0,18.0,1
2782,F8:59:71:5A:E0:3D,2321482,523863703,163854,250145660,2157628,273718043,354,119164,167621883,119048,167605078,116,16805,118500,43,163860,9761,354,252,144444.0,43333.0,-67.0,-73.0,-66.0,-70.0,-67.0,-72.0,-65.0,-70.0,-81.0,-87.0,-81.0,-88.0,14.0,14.0,15.0,18.0,1
2783,CC:2F:71:3E:C5:1F,2157754,273733188,126,15145,2157628,273718043,0,577,48373,485,37319,92,11054,136,1,212,9,0,31,1000.0,39000.0,-69.0,-62.0,-67.0,-60.0,-71.0,-68.0,-67.0,-61.0,-81.0,-87.0,-81.0,-88.0,12.0,25.0,14.0,28.0,1
2784,CC:2F:71:3F:1F:24,2565661,810630153,408033,536912110,2157628,273718043,9,303089,375716490,302927,375694500,162,21990,296025,566,408091,39498,9,3655,144444.0,43333.0,-67.0,-63.0,-71.0,-70.0,-68.0,-63.0,-68.0,-70.0,-81.0,-87.0,-81.0,-88.0,14.0,24.0,10.0,18.0,1
2785,F8:59:71:5A:E0:3D,2321550,523963395,163918,250244948,2157632,273718447,354,119228,167720443,119112,167703638,116,16805,118564,43,163924,9761,354,252,144444.0,43333.0,-67.0,-73.0,-66.0,-70.0,-67.0,-73.0,-65.0,-70.0,-81.0,-87.0,-81.0,-88.0,14.0,14.0,15.0,18.0,1
2786,CC:2F:71:3E:C5:1F,2157758,273733592,126,15145,2157632,273718447,0,577,48373,485,37319,92,11054,136,1,212,9,0,31,1000.0,39000.0,-69.0,-62.0,-67.0,-60.0,-71.0,-68.0,-67.0,-61.0,-81.0,-87.0,-81.0,-88.0,12.0,25.0,14.0,28.0,1
2787,CC:2F:71:3F:1F:24,2566273,811477469,408639,537757898,2157634,273719571,9,303292,375927758,303130,375905768,162,21990,296228,566,408697,39515,9,3655,144444.0,43333.0,-69.0,-63.0,-70.0,-70.0,-69.0,-63.0,-69.0,-70.0,-81.0,-87.0,-81.0,-88.0,12.0,24.0,11.0,18.0,1
2788,F8:59:71:5A:E0:3D,2321620,524062885,163981,250342850,2157639,273720035,354,119292,167819017,119176,167802212,116,16805,118627,43,163987,9761,354,252,144444.0,43333.0,-67.0,-73.0,-65.0,-70.0,-67.0,-73.0,-65.0,-70.0,-81.0,-87.0,-81.0,-88.0,14.0,14.0,16.0,18.0,1
2789,CC:2F:71:3E:C5:1F,2157765,273735180,126,15145,2157639,273720035,0,577,48373,485,37319,92,11054,136,1,212,9,0,31,1000.0,39000.0,-69.0,-62.0,-67.0,-60.0,-71.0,-68.0,-67.0,-61.0,-81.0,-87.0,-81.0,-88.0,12.0,25.0,14.0,28.0,1
2790,CC:2F:71:3F:1F:24,2566436,811684185,408797,537964150,2157639,273720035,9,303436,376124958,303274,376102968,162,21990,296372,566,408855,39515,9,3655,144444.0,43333.0,-71.0,-63.0,-71.0,-70.0,-70.0,-63.0,-68.0,-70.0,-81.0,-87.0,-81.0,-88.0,10.0,24.0,10.0,18.0,1
2791,F8:59:71:5A:E0:3D,2321688,524161307,164045,250440868,2157643,273720439,354,119355,167916037,119239,167899232,116,16805,118690,43,164051,9761,354,252,144444.0,43333.0,-67.0,-73.0,-66.0,-70.0,-67.0,-73.0,-65.0,-70.0,-81.0,-87.0,-81.0,-88.0,14.0,14.0,15.0,18.0,1
2792,CC:2F:71:3E:C5:1F,2157770,273735700,127,15261,2157643,273720439,0,579,48513,487,37459,92,11054,136,1,213,9,0,31,130000.0,39000.0,-70.0,-70.0,-67.0,-60.0,-70.0,-66.0,-66.0,-59.0,-81.0,-87.0,-81.0,-88.0,11.0,17.0,14.0,28.0,1
2793,CC:2F:71:3F:1F:24,2566614,811893773,408971,538173334,2157643,273720439,9,303595,376324675,303433,376302685,162,21990,296531,566,409029,39515,9,3655,144444.0,43333.0,-71.0,-64.0,-70.0,-71.0,-69.0,-63.0,-69.0,-70.0,-81.0,-88.0,-82.0,-89.0,10.0,24.0,12.0,18.0,1
2794,F8:59:71:5A:E0:3D,2321881,524452564,164238,250732125,2157643,273720439,354,119439,168018460,119323,168001655,116,16805,118774,43,164244,9762,354,252,144444.0,43333.0,-67.0,-73.0,-66.0,-70.0,-67.0,-73.0,-66.0,-70.0,-81.0,-88.0,-82.0,-89.0,14.0,15.0,16.0,19.0,1
2795,CC:2F:71:3E:C5:1F,2157770,273735700,127,15261,2157643,273720439,0,579,48513,487,37459,92,11054,136,1,213,9,0,31,130000.0,39000.0,-70.0,-70.0,-67.0,-60.0,-70.0,-66.0,-66.0,-59.0,-81.0,-88.0,-82.0,-89.0,11.0,18.0,15.0,29.0,1
2796,CC:2F:71:3F:1F:24,2566771,812098471,409128,538378032,2157643,273720439,9,303740,376523429,303578,376501439,162,21990,296675,566,409186,39515,9,3655,144444.0,43333.0,-66.0,-63.0,-70.0,-71.0,-67.0,-63.0,-69.0,-70.0,-81.0,-88.0,-82.0,-89.0,15.0,25.0,12.0,18.0,1
2797,F8:59:71:5A:E0:3D,2321952,524551405,164301,250830027,2157651,273721378,354,119502,168115480,119386,168098675,116,16805,118837,43,164307,9762,354,252,144444.0,43333.0,-67.0,-74.0,-66.0,-71.0,-67.0,-73.0,-65.0,-70.0,-81.0,-88.0,-82.0,-89.0,14.0,14.0,16.0,18.0,1
2798,CC:2F:71:3E:C5:1F,2157778,273736639,127,15261,2157651,273721378,0,579,48513,487,37459,92,11054,136,1,213,9,0,31,130000.0,39000.0,-70.0,-70.0,-67.0,-60.0,-70.0,-66.0,-66.0,-59.0,-81.0,-88.0,-82.0,-89.0,11.0,18.0,15.0,29.0,1
2799,CC:2F:71:3F:1F:24,2566937,812302756,409284,538581176,2157653,273721580,9,303880,376717317,303718,376695327,162,21990,296815,566,409341,39516,9,3655,144444.0,43333.0,-71.0,-63.0,-70.0,-71.0,-69.0,-63.0,-69.0,-70.0,-81.0,-88.0,-82.0,-89.0,10.0,25.0,12.0,18.0,1
2800,F8:59:71:5A:E0:3D,2322144,524844352,164490,251122710,2157654,273721642,354,119591,168217662,119474,168200739,117,16923,118926,43,164496,9762,354,252,144444.0,43333.0,-67.0,-74.0,-66.0,-71.0,-67.0,-73.0,-66.0,-70.0,-81.0,-88.0,-82.0,-89.0,14.0,14.0,16.0,18.0,1
2801,CC:2F:71:3E:C5:1F,2157781,273736903,127,15261,2157654,273721642,0,579,48513,487,37459,92,11054,136,1,213,9,0,31,130000.0,39000.0,-70.0,-70.0,-67.0,-60.0,-70.0,-66.0,-66.0,-59.0,-81.0,-88.0,-82.0,-89.0,11.0,18.0,15.0,29.0,1
2802,CC:2F:71:3F:1F:24,2567099,812507749,409445,538786107,2157654,273721642,9,304026,376910968,303864,376888978,162,21990,296961,566,409503,39516,9,3655,144444.0,43333.0,-71.0,-63.0,-70.0,-71.0,-68.0,-63.0,-69.0,-70.0,-81.0,-88.0,-82.0,-89.0,10.0,25.0,12.0,18.0,1
2803,F8:59:71:5A:E0:3D,2322210,524941104,164552,251219058,2157658,273722046,354,119652,168311602,119535,168294679,117,16923,118987,43,164558,9762,354,252,144444.0,43333.0,-66.0,-73.0,-65.0,-71.0,-67.0,-73.0,-65.0,-70.0,-81.0,-88.0,-82.0,-89.0,15.0,15.0,17.0,18.0,1
2804,CC:2F:71:3E:C5:1F,2157785,273737307,127,15261,2157658,273722046,0,579,48513,487,37459,92,11054,136,1,213,9,0,31,130000.0,39000.0,-70.0,-70.0,-67.0,-60.0,-70.0,-66.0,-66.0,-59.0,-81.0,-88.0,-82.0,-89.0,11.0,18.0,15.0,29.0,1
2805,CC:2F:71:3F:1F:24,2567261,812714775,409603,538992729,2157658,273722046,9,304169,377108086,304007,377086096,162,21990,297104,566,409661,39516,9,3655,144444.0,43333.0,-71.0,-63.0,-70.0,-70.0,-69.0,-63.0,-70.0,-70.0,-81.0,-88.0,-82.0,-89.0,10.0,25.0,12.0,19.0,1
2806,F8:59:71:5A:E0:3D,2322278,525039470,164615,251316960,2157663,273722510,354,119719,168414838,119602,168397915,117,16923,119050,43,164621,9762,354,252,144444.0,43333.0,-66.0,-74.0,-66.0,-70.0,-66.0,-74.0,-65.0,-70.0,-81.0,-88.0,-82.0,-89.0,15.0,14.0,16.0,19.0,1
2807,CC:2F:71:3E:C5:1F,2157790,273737771,127,15261,2157663,273722510,0,579,48513,487,37459,92,11054,136,1,213,9,0,31,130000.0,39000.0,-70.0,-70.0,-67.0,-60.0,-70.0,-66.0,-66.0,-59.0,-81.0,-88.0,-82.0,-89.0,11.0,18.0,15.0,29.0,1
2808,CC:2F:71:3F:1F:24,2567419,812916465,409756,539193955,2157663,273722510,9,304309,377300592,304147,377278602,162,21990,297244,566,409813,39564,9,3655,130000.0,43333.0,-70.0,-63.0,-70.0,-70.0,-69.0,-63.0,-70.0,-70.0,-81.0,-88.0,-82.0,-89.0,11.0,25.0,12.0,19.0,1
2809,F8:59:71:5A:E0:3D,2322430,525261068,164757,251537628,2157673,273723440,354,119840,168601374,119723,168584451,117,16923,119170,43,164752,9769,354,252,144444.0,43333.0,-66.0,-72.0,-64.0,-70.0,-66.0,-74.0,-65.0,-70.0,-81.0,-88.0,-82.0,-89.0,15.0,16.0,18.0,19.0,1
2810,CC:2F:71:3E:C5:1F,2157800,273738701,127,15261,2157673,273723440,0,579,48513,487,37459,92,11054,136,1,213,9,0,31,130000.0,39000.0,-70.0,-70.0,-67.0,-60.0,-70.0,-66.0,-66.0,-59.0,-81.0,-88.0,-82.0,-89.0,11.0,18.0,15.0,29.0,1
2811,CC:2F:71:3F:1F:24,2568031,813794342,410350,540070094,2157681,273724248,9,304804,378028453,304641,378006345,163,22108,297708,566,410407,39622,9,3692,130000.0,43333.0,-71.0,-63.0,-72.0,-70.0,-72.0,-64.0,-73.0,-70.0,-81.0,-88.0,-82.0,-89.0,10.0,25.0,10.0,19.0,1
2812,F8:59:71:5A:E0:3D,2322955,526002969,165255,252276923,2157700,273726046,354,120316,169282327,120199,169265404,117,16923,119645,43,165261,9803,354,253,144444.0,43333.0,-67.0,-73.0,-66.0,-70.0,-66.0,-72.0,-65.0,-70.0,-81.0,-88.0,-82.0,-89.0,14.0,15.0,16.0,19.0,1
2813,CC:2F:71:3E:C5:1F,2157827,273741307,127,15261,2157700,273726046,0,581,48701,488,37529,93,11172,137,1,213,9,0,32,130000.0,39000.0,-76.0,-84.0,-74.0,-71.0,-71.0,-71.0,-68.0,-62.0,-81.0,-88.0,-82.0,-89.0,5.0,4.0,8.0,18.0,1
2814,CC:2F:71:3F:1F:24,2568658,814652813,410958,540926767,2157700,273726046,9,305499,379019924,305336,378997816,163,22108,298359,566,411016,39646,9,3745,130000.0,43333.0,-67.0,-64.0,-67.0,-70.0,-69.0,-64.0,-69.0,-70.0,-81.0,-88.0,-82.0,-89.0,14.0,24.0,15.0,19.0,1
2815,F8:59:71:5A:E0:3D,2323146,526293860,165442,252567410,2157704,273726450,354,120398,169381953,120281,169365030,117,16923,119727,43,165448,9822,354,253,144444.0,43333.0,-66.0,-74.0,-66.0,-69.0,-66.0,-74.0,-65.0,-69.0,-81.0,-88.0,-82.0,-89.0,15.0,14.0,16.0,20.0,1
2816,CC:2F:71:3E:C5:1F,2157831,273741711,127,15261,2157704,273726450,0,581,48701,488,37529,93,11172,137,1,213,9,0,32,130000.0,39000.0,-76.0,-84.0,-74.0,-71.0,-71.0,-71.0,-68.0,-62.0,-81.0,-88.0,-82.0,-89.0,5.0,4.0,8.0,18.0,1
2817,CC:2F:71:3F:1F:24,2568817,814854622,411113,541128172,2157704,273726450,9,305642,379215637,305479,379193529,163,22108,298501,566,411171,39652,9,3745,130000.0,43333.0,-71.0,-63.0,-70.0,-70.0,-68.0,-63.0,-69.0,-70.0,-81.0,-88.0,-82.0,-89.0,10.0,25.0,12.0,19.0,1
2818,F8:59:71:5A:E0:3D,2323213,526390885,165504,252663758,2157709,273727127,354,120461,169478973,120344,169462050,117,16923,119790,43,165510,9822,354,253,144444.0,43333.0,-67.0,-73.0,-66.0,-70.0,-66.0,-73.0,-65.0,-69.0,-81.0,-88.0,-82.0,-89.0,14.0,15.0,16.0,19.0,1
2819,CC:2F:71:3E:C5:1F,2157836,273742388,127,15261,2157709,273727127,0,581,48701,488,37529,93,11172,137,1,213,9,0,32,130000.0,39000.0,-76.0,-84.0,-74.0,-71.0,-71.0,-71.0,-68.0,-62.0,-81.0,-88.0,-82.0,-89.0,5.0,4.0,8.0,18.0,1
2820,CC:2F:71:3F:1F:24,2568992,815063466,411282,541336279,2157710,273727187,9,305798,379412469,305635,379390361,163,22108,298657,566,411340,39652,9,3745,130000.0,43333.0,-71.0,-64.0,-70.0,-70.0,-69.0,-64.0,-69.0,-70.0,-81.0,-88.0,-82.0,-89.0,10.0,24.0,12.0,19.0,1
2821,F8:59:71:5A:E0:3D,2323281,526488080,165571,252760893,2157710,273727187,354,120528,169575833,120411,169558910,117,16923,119856,43,165577,9822,354,253,144444.0,43333.0,-66.0,-73.0,-66.0,-69.0,-66.0,-73.0,-65.0,-69.0,-81.0,-88.0,-82.0,-89.0,15.0,15.0,16.0,20.0,1
2822,CC:2F:71:3E:C5:1F,2157839,273742650,127,15261,2157712,273727389,0,581,48701,488,37529,93,11172,137,1,213,9,0,32,130000.0,39000.0,-76.0,-84.0,-74.0,-71.0,-71.0,-71.0,-68.0,-62.0,-81.0,-88.0,-82.0,-89.0,5.0,4.0,8.0,18.0,1
2823,CC:2F:71:3F:1F:24,2569231,815375070,411515,541647277,2157716,273727793,9,305991,379676272,305828,379654164,163,22108,298850,566,411573,39655,9,3751,144444.0,43333.0,-71.0,-63.0,-69.0,-69.0,-71.0,-62.0,-69.0,-69.0,-81.0,-88.0,-82.0,-89.0,10.0,25.0,13.0,20.0,1
2824,F8:59:71:5A:E0:3D,2323558,526905630,165840,253177635,2157718,273727995,354,120668,169749773,120551,169732850,117,16923,119992,43,165845,9822,354,254,144444.0,43333.0,-67.0,-74.0,-66.0,-70.0,-67.0,-74.0,-66.0,-70.0,-81.0,-88.0,-82.0,-89.0,14.0,14.0,16.0,19.0,1
2825,CC:2F:71:3E:C5:1F,2157845,273743256,127,15261,2157718,273727995,0,581,48701,488,37529,93,11172,137,1,213,9,0,32,130000.0,39000.0,-76.0,-84.0,-74.0,-71.0,-71.0,-71.0,-68.0,-62.0,-81.0,-88.0,-82.0,-89.0,5.0,4.0,8.0,18.0,1
2826,CC:2F:71:3F:1F:24,2569419,815620861,411700,541892806,2157719,273728055,9,306220,379996878,306057,379974770,163,22108,299069,566,411758,39657,9,3770,144444.0,43333.0,-72.0,-62.0,-70.0,-68.0,-72.0,-61.0,-69.0,-68.0,-81.0,-88.0,-82.0,-89.0,9.0,26.0,12.0,21.0,1
2827,F8:59:71:5A:E0:3D,2323633,527011408,165908,253282747,2157725,273728661,354,120753,169879897,120636,169862974,117,16923,120065,43,165914,9822,354,259,144444.0,43333.0,-65.0,-73.0,-66.0,-69.0,-64.0,-72.0,-65.0,-69.0,-81.0,-88.0,-82.0,-89.0,16.0,15.0,16.0,20.0,1
2828,CC:2F:71:3E:C5:1F,2157854,273744124,127,15261,2157727,273728863,0,581,48701,488,37529,93,11172,137,1,213,9,0,32,130000.0,39000.0,-76.0,-84.0,-74.0,-71.0,-71.0,-71.0,-68.0,-62.0,-81.0,-88.0,-82.0,-89.0,5.0,4.0,8.0,18.0,1
2829,CC:2F:71:3F:1F:24,2569612,815868233,411885,542139370,2157727,273728863,9,306373,380205012,306210,380182904,163,22108,299219,566,411943,39657,9,3770,144444.0,43333.0,-71.0,-62.0,-69.0,-69.0,-70.0,-61.0,-68.0,-68.0,-81.0,-88.0,-82.0,-89.0,10.0,26.0,13.0,20.0,1
2830,F8:59:71:5A:E0:3D,2323717,527138926,165990,253410063,2157727,273728863,354,120842,170014493,120725,169997570,117,16923,120151,43,165996,9823,354,259,144444.0,43333.0,-65.0,-72.0,-64.0,-70.0,-64.0,-71.0,-64.0,-69.0,-81.0,-87.0,-81.0,-88.0,16.0,15.0,17.0,18.0,1
2831,CC:2F:71:3E:C5:1F,2157861,273744790,127,15261,2157734,273729529,0,581,48701,488,37529,93,11172,137,1,213,9,0,32,130000.0,39000.0,-76.0,-84.0,-74.0,-71.0,-71.0,-71.0,-68.0,-62.0,-81.0,-87.0,-81.0,-88.0,5.0,3.0,7.0,17.0,1
2832,CC:2F:71:3F:1F:24,2569998,816388032,412262,542658301,2157736,273729731,9,306747,380723628,306584,380701520,163,22108,299591,566,412320,39661,9,3808,144444.0,43333.0,-69.0,-61.0,-68.0,-68.0,-70.0,-61.0,-68.0,-68.0,-81.0,-87.0,-81.0,-88.0,12.0,26.0,13.0,20.0,1
2833,F8:59:71:5A:E0:3D,2323915,527422182,166177,253692249,2157738,273729933,354,121005,170254951,120888,170238028,117,16923,120313,43,166183,9824,354,259,144444.0,43333.0,-65.0,-72.0,-66.0,-69.0,-64.0,-71.0,-65.0,-69.0,-81.0,-87.0,-81.0,-88.0,16.0,15.0,15.0,19.0,1
2834,CC:2F:71:3E:C5:1F,2157872,273745860,127,15261,2157745,273730599,0,581,48701,488,37529,93,11172,137,1,213,9,0,32,130000.0,39000.0,-76.0,-84.0,-74.0,-71.0,-71.0,-71.0,-68.0,-62.0,-81.0,-87.0,-81.0,-88.0,5.0,3.0,7.0,17.0,1
2835,CC:2F:71:3F:1F:24,2571040,817891104,413270,544157890,2157770,273733214,9,307203,381369795,307040,381347687,163,22108,300025,566,413327,39728,9,3877,144444.0,43333.0,-68.0,-61.0,-71.0,-68.0,-67.0,-61.0,-70.0,-68.0,-80.0,-87.0,-80.0,-87.0,12.0,26.0,9.0,19.0,1
2836,F8:59:71:5A:E0:3D,2324967,528953306,167168,255217118,2157799,273736188,354,121945,171591088,121828,171574165,117,16923,121119,43,167174,9835,354,319,144444.0,43333.0,-64.0,-67.0,-64.0,-69.0,-64.0,-70.0,-65.0,-69.0,-79.0,-86.0,-79.0,-86.0,15.0,19.0,15.0,17.0,1
2837,CC:2F:71:3E:C5:1F,2157937,273752495,128,15377,2157809,273737118,0,583,48841,490,37669,93,11172,137,1,214,9,0,32,130000.0,39000.0,-70.0,-70.0,-65.0,-60.0,-70.0,-71.0,-68.0,-62.0,-79.0,-86.0,-79.0,-86.0,9.0,16.0,14.0,26.0,1
2838,CC:2F:71:3F:1F:24,2572237,819605940,414426,545868620,2157811,273737320,9,308482,383264938,308318,383242712,164,22226,301292,566,414483,39806,9,3910,130000.0,43333.0,-69.0,-61.0,-70.0,-69.0,-68.0,-61.0,-70.0,-68.0,-79.0,-85.0,-79.0,-86.0,10.0,24.0,9.0,17.0,1
2839,F8:59:71:5A:E0:3D,2325687,530013399,167862,256274745,2157825,273738654,354,122396,172233571,122278,172216530,118,17041,121552,43,167868,9841,354,345,144444.0,43333.0,-65.0,-72.0,-64.0,-69.0,-64.0,-69.0,-64.0,-68.0,-79.0,-85.0,-79.0,-86.0,14.0,13.0,15.0,17.0,1
2840,CC:2F:71:3E:C5:1F,2157959,273754768,128,15377,2157831,273739391,0,585,49029,491,37739,94,11290,138,1,214,9,0,32,130000.0,39000.0,-70.0,-70.0,-66.0,-61.0,-71.0,-73.0,-68.0,-62.0,-78.0,-84.0,-78.0,-85.0,8.0,14.0,12.0,24.0,1
2841,CC:2F:71:3F:1F:24,2573020,820703686,415187,546964093,2157833,273739593,9,309775,385191997,309611,385169771,164,22226,302582,566,415245,39857,9,3952,130000.0,43333.0,-68.0,-62.0,-70.0,-66.0,-68.0,-61.0,-70.0,-66.0,-78.0,-84.0,-78.0,-85.0,10.0,22.0,8.0,19.0,1
2842,F8:59:71:5A:E0:3D,2326132,530678465,168295,256938468,2157837,273739997,354,122597,172517141,122479,172500100,118,17041,121753,43,168300,9849,354,347,144444.0,43333.0,-65.0,-71.0,-64.0,-69.0,-64.0,-71.0,-64.0,-69.0,-78.0,-84.0,-78.0,-85.0,13.0,13.0,14.0,16.0,1
2843,CC:2F:71:3E:C5:1F,2157967,273755576,128,15377,2157839,273740199,0,585,49029,491,37739,94,11290,138,1,214,9,0,32,130000.0,39000.0,-70.0,-70.0,-66.0,-61.0,-71.0,-73.0,-68.0,-62.0,-78.0,-84.0,-78.0,-85.0,8.0,14.0,12.0,24.0,1
2844,CC:2F:71:3F:1F:24,2573213,820948520,415374,547208321,2157839,273740199,9,309952,385434809,309788,385412583,164,22226,302756,566,415432,39857,9,3952,144444.0,39000.0,-68.0,-62.0,-71.0,-68.0,-68.0,-62.0,-71.0,-68.0,-78.0,-84.0,-78.0,-85.0,10.0,22.0,7.0,17.0,1
2845,F8:59:71:5A:E0:3D,2326213,530801433,168374,257061234,2157839,273740199,354,122680,172645129,122562,172628088,118,17041,121836,43,168380,9849,354,348,144444.0,43333.0,-65.0,-72.0,-65.0,-69.0,-64.0,-71.0,-64.0,-69.0,-78.0,-84.0,-78.0,-85.0,13.0,12.0,13.0,16.0,1
2846,CC:2F:71:3E:C5:1F,2157970,273755838,128,15377,2157842,273740461,0,585,49029,491,37739,94,11290,138,1,214,9,0,32,130000.0,39000.0,-70.0,-70.0,-66.0,-61.0,-71.0,-73.0,-68.0,-62.0,-78.0,-84.0,-78.0,-85.0,8.0,14.0,12.0,24.0,1
2847,CC:2F:71:3F:1F:24,2573375,821160820,415533,547420359,2157842,273740461,9,310102,385644125,309938,385621899,164,22226,302904,566,415591,39858,9,3952,144444.0,43333.0,-68.0,-61.0,-70.0,-69.0,-69.0,-61.0,-71.0,-69.0,-78.0,-84.0,-78.0,-85.0,10.0,23.0,8.0,16.0,1
2848,F8:59:71:5A:E0:3D,2326292,530911081,168444,257170014,2157848,273741067,354,122748,172749989,122630,172732948,118,17041,121904,43,168450,9849,354,348,144444.0,43333.0,-65.0,-72.0,-65.0,-69.0,-64.0,-71.0,-64.0,-69.0,-78.0,-84.0,-78.0,-85.0,13.0,12.0,13.0,16.0,1
2849,CC:2F:71:3E:C5:1F,2157976,273756444,128,15377,2157848,273741067,0,585,49029,491,37739,94,11290,138,1,214,9,0,32,130000.0,39000.0,-70.0,-70.0,-66.0,-61.0,-71.0,-73.0,-68.0,-62.0,-78.0,-84.0,-78.0,-85.0,8.0,14.0,12.0,24.0,1
2850,CC:2F:71:3F:1F:24,2573602,821451245,415754,547710178,2157848,273741067,9,310302,385909957,310138,385887731,164,22226,303103,566,415812,39865,9,3955,144444.0,43333.0,-69.0,-61.0,-71.0,-67.0,-69.0,-61.0,-71.0,-67.0,-78.0,-84.0,-78.0,-85.0,9.0,23.0,7.0,18.0,1
2851,F8:59:71:5A:E0:3D,2326539,531285949,168687,257544478,2157852,273741471,354,122868,172888618,122750,172871577,118,17041,122016,43,168693,9851,354,352,144444.0,43333.0,-65.0,-72.0,-66.0,-69.0,-65.0,-72.0,-65.0,-69.0,-78.0,-84.0,-78.0,-85.0,13.0,12.0,12.0,16.0,1
2852,CC:2F:71:3E:C5:1F,2157980,273756848,128,15377,2157852,273741471,0,585,49029,491,37739,94,11290,138,1,214,9,0,32,130000.0,39000.0,-70.0,-70.0,-66.0,-61.0,-71.0,-73.0,-68.0,-62.0,-78.0,-84.0,-78.0,-85.0,8.0,14.0,12.0,24.0,1
2853,CC:2F:71:3F:1F:24,2573765,821659471,415913,547918000,2157852,273741471,9,310467,386132377,310303,386110151,164,22226,303268,566,415971,39867,9,3955,144444.0,43333.0,-68.0,-61.0,-71.0,-68.0,-68.0,-61.0,-71.0,-67.0,-78.0,-84.0,-78.0,-85.0,10.0,23.0,7.0,17.0,1
2854,F8:59:71:5A:E0:3D,2326647,531430408,168790,257688473,2157857,273741935,354,122948,172998126,122830,172981085,118,17041,122096,43,168796,9855,354,352,144444.0,43333.0,-66.0,-72.0,-65.0,-69.0,-65.0,-71.0,-65.0,-68.0,-78.0,-84.0,-78.0,-84.0,12.0,12.0,13.0,15.0,1
2855,CC:2F:71:3E:C5:1F,2157985,273757312,128,15377,2157857,273741935,0,585,49029,491,37739,94,11290,138,1,214,9,0,32,130000.0,39000.0,-70.0,-70.0,-66.0,-61.0,-71.0,-73.0,-68.0,-62.0,-78.0,-84.0,-78.0,-84.0,8.0,14.0,12.0,23.0,1
2856,CC:2F:71:3F:1F:24,2573939,821873412,416082,548131477,2157857,273741935,9,310619,386331009,310455,386308783,164,22226,303420,566,416140,39867,9,3955,144444.0,43333.0,-69.0,-61.0,-71.0,-67.0,-68.0,-61.0,-70.0,-66.0,-78.0,-84.0,-78.0,-84.0,9.0,23.0,7.0,17.0,1
2857,F8:59:71:5A:E0:3D,2326711,531526958,168852,257784821,2157859,273742137,354,123010,173093606,122892,173076565,118,17041,122158,43,168858,9855,354,352,144444.0,43333.0,-66.0,-72.0,-65.0,-69.0,-66.0,-72.0,-65.0,-69.0,-78.0,-84.0,-78.0,-84.0,12.0,12.0,13.0,15.0,1
2858,CC:2F:71:3E:C5:1F,2157987,273757514,128,15377,2157859,273742137,0,585,49029,491,37739,94,11290,138,1,214,9,0,32,130000.0,39000.0,-70.0,-70.0,-66.0,-61.0,-71.0,-73.0,-68.0,-62.0,-78.0,-84.0,-78.0,-84.0,8.0,14.0,12.0,23.0,1
2859,CC:2F:71:3F:1F:24,2574113,822094588,416252,548352249,2157861,273742339,9,310774,386538188,310610,386515962,164,22226,303575,566,416310,39869,9,3958,144444.0,43333.0,-69.0,-62.0,-71.0,-67.0,-68.0,-61.0,-70.0,-66.0,-78.0,-84.0,-78.0,-84.0,9.0,22.0,7.0,17.0,1
2860,F8:59:71:5A:E0:3D,2326819,531680374,168953,257937571,2157866,273742803,354,123105,173236583,122987,173219542,118,17041,122253,43,168958,9855,354,360,144444.0,43333.0,-66.0,-73.0,-65.0,-69.0,-65.0,-70.0,-65.0,-68.0,-78.0,-84.0,-78.0,-84.0,12.0,11.0,13.0,15.0,1
2861,CC:2F:71:3E:C5:1F,2157994,273758180,128,15377,2157866,273742803,0,585,49029,491,37739,94,11290,138,1,214,9,0,32,130000.0,39000.0,-70.0,-70.0,-66.0,-61.0,-71.0,-73.0,-68.0,-62.0,-78.0,-84.0,-78.0,-84.0,8.0,14.0,12.0,23.0,1
2862,CC:2F:71:3F:1F:24,2574383,822468910,416517,548726107,2157866,273742803,9,311031,386911196,310867,386888970,164,22226,303832,566,416573,39872,9,3979,144444.0,43333.0,-68.0,-61.0,-70.0,-67.0,-68.0,-61.0,-70.0,-67.0,-78.0,-84.0,-78.0,-84.0,10.0,23.0,8.0,17.0,1
2863,F8:59:71:5A:E0:3D,2326925,531836156,169053,258092747,2157872,273743409,354,123210,173399333,123092,173382292,118,17041,122356,43,169059,9855,354,365,144444.0,43333.0,-65.0,-72.0,-65.0,-68.0,-65.0,-70.0,-64.0,-68.0,-78.0,-84.0,-78.0,-84.0,13.0,12.0,13.0,16.0,1
2864,CC:2F:71:3E:C5:1F,2158002,273758988,128,15377,2157874,273743611,0,585,49029,491,37739,94,11290,138,1,214,9,0,32,130000.0,39000.0,-70.0,-70.0,-66.0,-61.0,-71.0,-73.0,-68.0,-62.0,-78.0,-84.0,-78.0,-84.0,8.0,14.0,12.0,23.0,1
2865,CC:2F:71:3F:1F:24,2574596,822743440,416722,548999829,2157874,273743611,9,311221,387172659,311057,387150433,164,22226,304021,566,416779,39875,9,3986,144444.0,43333.0,-69.0,-61.0,-71.0,-67.0,-68.0,-61.0,-70.0,-67.0,-78.0,-84.0,-78.0,-84.0,9.0,23.0,7.0,17.0,1
2866,F8:59:71:5A:E0:3D,2327009,531959162,169132,258215289,2157877,273743873,354,123290,173522981,123172,173505940,118,17041,122436,43,169138,9855,354,367,144444.0,43333.0,-65.0,-68.0,-65.0,-68.0,-64.0,-69.0,-64.0,-68.0,-78.0,-84.0,-78.0,-84.0,13.0,16.0,13.0,16.0,1
2867,CC:2F:71:3E:C5:1F,2158007,273759452,128,15377,2157879,273744075,0,585,49029,491,37739,94,11290,138,1,214,9,0,32,130000.0,39000.0,-70.0,-70.0,-66.0,-61.0,-71.0,-73.0,-68.0,-62.0,-78.0,-84.0,-78.0,-84.0,8.0,14.0,12.0,23.0,1
2868,CC:2F:71:3F:1F:24,2574793,822994301,416913,549250100,2157880,273744201,9,311403,387417896,311239,387395670,164,22226,304203,566,416971,39876,9,3989,144444.0,43333.0,-68.0,-61.0,-71.0,-66.0,-68.0,-61.0,-70.0,-66.0,-77.0,-84.0,-78.0,-85.0,9.0,23.0,7.0,19.0,1
2869,F8:59:71:5A:E0:3D,2327271,532355388,169387,258610783,2157884,273744605,354,123408,173658910,123290,173641869,118,17041,122554,43,169392,9855,354,368,144444.0,43333.0,-64.0,-70.0,-64.0,-68.0,-65.0,-71.0,-65.0,-69.0,-77.0,-84.0,-78.0,-85.0,13.0,14.0,14.0,17.0,1
2870,CC:2F:71:3E:C5:1F,2158013,273760098,129,15493,2157884,273744605,0,586,49099,492,37809,94,11290,138,1,215,9,0,32,130000.0,39000.0,-70.0,-70.0,-67.0,-60.0,-71.0,-73.0,-68.0,-62.0,-77.0,-84.0,-78.0,-85.0,7.0,14.0,11.0,25.0,1
2871,CC:2F:71:3F:1F:24,2574983,823241751,417099,549497146,2157884,273744605,9,311579,387660258,311415,387638032,164,22226,304378,566,417156,39876,9,3989,144444.0,43333.0,-68.0,-61.0,-70.0,-67.0,-67.0,-61.0,-70.0,-66.0,-77.0,-84.0,-78.0,-85.0,9.0,23.0,8.0,18.0,1
2872,F8:59:71:5A:E0:3D,2327496,532693036,169606,258947694,2157890,273745342,354,123522,173812817,123404,173795776,118,17041,122668,43,169611,9855,354,375,144444.0,43333.0,-65.0,-71.0,-64.0,-68.0,-65.0,-71.0,-65.0,-69.0,-77.0,-84.0,-78.0,-85.0,12.0,13.0,14.0,17.0,1
2873,CC:2F:71:3E:C5:1F,2158021,273761037,129,15493,2157892,273745544,0,587,49169,493,37879,94,11290,138,1,215,9,0,32,130000.0,39000.0,-65.0,-67.0,-64.0,-59.0,-70.0,-73.0,-67.0,-62.0,-77.0,-84.0,-78.0,-85.0,12.0,17.0,14.0,26.0,1
2874,CC:2F:71:3F:1F:24,2575220,823560268,417328,549814724,2157892,273745544,9,311795,387965700,311631,387943474,164,22226,304593,566,417385,39879,9,3991,144444.0,43333.0,-68.0,-61.0,-70.0,-67.0,-68.0,-61.0,-70.0,-66.0,-77.0,-84.0,-78.0,-85.0,9.0,23.0,8.0,18.0,1
2875,F8:59:71:5A:E0:3D,2327572,532805328,169678,259059582,2157894,273745746,354,123592,173920729,123474,173903688,118,17041,122738,43,169684,9856,354,377,144444.0,43333.0,-65.0,-68.0,-64.0,-69.0,-64.0,-69.0,-64.0,-68.0,-77.0,-83.0,-77.0,-84.0,12.0,15.0,13.0,15.0,1
2876,CC:2F:71:3E:C5:1F,2158023,273761239,129,15493,2157894,273745746,0,587,49169,493,37879,94,11290,138,1,215,9,0,32,130000.0,39000.0,-65.0,-67.0,-64.0,-59.0,-70.0,-73.0,-67.0,-62.0,-77.0,-83.0,-77.0,-84.0,12.0,16.0,13.0,25.0,1
2877,CC:2F:71:3F:1F:24,2575415,823818222,417519,550072274,2157896,273745948,9,311973,388215568,311809,388193342,164,22226,304769,566,417575,39880,9,3997,144444.0,43333.0,-68.0,-61.0,-70.0,-67.0,-68.0,-61.0,-69.0,-66.0,-77.0,-83.0,-77.0,-84.0,9.0,22.0,7.0,17.0,1
2878,F8:59:71:5A:E0:3D,2327661,532934916,169761,259188564,2157900,273746352,354,123674,174047107,123556,174030066,118,17041,122820,43,169767,9856,354,378,144444.0,43333.0,-63.0,-69.0,-64.0,-69.0,-64.0,-70.0,-64.0,-68.0,-77.0,-83.0,-77.0,-84.0,14.0,14.0,13.0,15.0,1
2879,CC:2F:71:3E:C5:1F,2158029,273761845,129,15493,2157900,273746352,0,587,49169,493,37879,94,11290,138,1,215,9,0,32,130000.0,39000.0,-65.0,-67.0,-64.0,-59.0,-70.0,-73.0,-67.0,-62.0,-77.0,-83.0,-77.0,-84.0,12.0,16.0,13.0,25.0,1
2880,CC:2F:71:3F:1F:24,2575663,824132222,417738,550374760,2157925,273757462,9,312156,388473010,311992,388450784,164,22226,304952,566,417795,39884,9,3999,144444.0,43333.0,-69.0,-62.0,-70.0,-66.0,-69.0,-61.0,-69.0,-66.0,-77.0,-83.0,-77.0,-84.0,8.0,21.0,7.0,18.0,1
2881,F8:59:71:5A:E0:3D,2327788,533098610,169859,259340744,2157929,273757866,354,123769,174193771,123651,174176730,118,17041,122915,43,169865,9857,354,381,144444.0,43333.0,-64.0,-68.0,-65.0,-69.0,-65.0,-71.0,-64.0,-69.0,-77.0,-83.0,-77.0,-84.0,13.0,15.0,12.0,15.0,1
2882,CC:2F:71:3E:C5:1F,2158058,273773359,129,15493,2157929,273757866,0,587,49169,493,37879,94,11290,138,1,215,9,0,32,130000.0,39000.0,-65.0,-67.0,-64.0,-59.0,-70.0,-73.0,-67.0,-62.0,-77.0,-83.0,-77.0,-84.0,12.0,16.0,13.0,25.0,1
2883,CC:2F:71:3F:1F:24,2575849,824373183,417920,550615317,2157929,273757866,9,312353,388742617,312189,388720391,164,22226,305146,566,417978,39896,9,4003,144444.0,43333.0,-69.0,-61.0,-69.0,-66.0,-69.0,-61.0,-69.0,-66.0,-77.0,-83.0,-77.0,-84.0,8.0,22.0,8.0,18.0,1
2884,F8:59:71:5A:E0:3D,2327971,533370122,170038,259611852,2157933,273758270,354,123875,174327188,123757,174310147,118,17041,123021,43,170044,9886,354,384,144444.0,43333.0,-65.0,-71.0,-65.0,-69.0,-65.0,-71.0,-65.0,-68.0,-77.0,-83.0,-77.0,-84.0,12.0,12.0,12.0,15.0,1
2885,CC:2F:71:3E:C5:1F,2158062,273773763,129,15493,2157933,273758270,0,587,49169,493,37879,94,11290,138,1,215,9,0,32,130000.0,39000.0,-65.0,-67.0,-64.0,-59.0,-70.0,-73.0,-67.0,-62.0,-77.0,-83.0,-77.0,-84.0,12.0,16.0,13.0,25.0,1
2886,CC:2F:71:3F:1F:24,2576045,824632355,418112,550874085,2157933,273758270,9,312531,388992505,312367,388970279,164,22226,305321,566,418170,39934,9,4018,144444.0,43333.0,-68.0,-61.0,-69.0,-67.0,-68.0,-61.0,-69.0,-67.0,-77.0,-83.0,-77.0,-84.0,9.0,22.0,8.0,17.0,1
2887,F8:59:71:5A:E0:3D,2328155,533634045,170213,259874907,2157942,273759138,354,124027,174553239,123909,174536198,118,17041,123173,43,170219,9887,354,395,144444.0,43333.0,-64.0,-71.0,-64.0,-69.0,-64.0,-71.0,-64.0,-68.0,-77.0,-83.0,-77.0,-84.0,13.0,12.0,13.0,15.0,1
2888,CC:2F:71:3E:C5:1F,2158071,273774631,129,15493,2157942,273759138,0,587,49169,493,37879,94,11290,138,1,215,9,0,32,130000.0,39000.0,-65.0,-67.0,-64.0,-59.0,-70.0,-73.0,-67.0,-62.0,-76.0,-83.0,-77.0,-84.0,11.0,16.0,13.0,25.0,1
2889,CC:2F:71:3F:1F:24,2576381,825079597,418439,551320459,2157942,273759138,9,312847,389431470,312683,389409244,164,22226,305637,566,418497,39992,9,4035,144444.0,43333.0,-69.0,-62.0,-69.0,-67.0,-68.0,-62.0,-69.0,-67.0,-76.0,-83.0,-77.0,-84.0,7.0,21.0,8.0,17.0,1
2890,F8:59:71:5A:E0:3D,2328348,533921023,170398,260161157,2157950,273759866,354,124165,174731099,124047,174714058,118,17041,123309,43,170404,9888,354,399,144444.0,43333.0,-64.0,-71.0,-64.0,-68.0,-64.0,-70.0,-64.0,-68.0,-76.0,-83.0,-77.0,-84.0,12.0,12.0,13.0,16.0,1
2891,CC:2F:71:3E:C5:1F,2158081,273775561,129,15493,2157952,273760068,0,587,49169,493,37879,94,11290,138,1,215,9,0,32,130000.0,39000.0,-65.0,-67.0,-64.0,-59.0,-70.0,-73.0,-67.0,-62.0,-76.0,-83.0,-77.0,-84.0,11.0,16.0,13.0,25.0,1
2892,CC:2F:71:3F:1F:24,2576722,825528365,418770,551768297,2157952,273760068,9,313155,389856911,312990,389834567,165,22344,305937,566,418828,40108,9,4049,130000.0,43333.0,-69.0,-62.0,-70.0,-67.0,-69.0,-62.0,-70.0,-67.0,-76.0,-83.0,-77.0,-84.0,7.0,21.0,7.0,17.0,1
2893,F8:59:71:5A:E0:3D,2328494,534127890,170538,260367418,2157956,273760472,354,124278,174898730,124160,174881689,118,17041,123422,43,170544,9891,354,403,144444.0,43333.0,-64.0,-70.0,-64.0,-69.0,-64.0,-69.0,-64.0,-68.0,-76.0,-83.0,-77.0,-84.0,12.0,13.0,13.0,15.0,1
2894,CC:2F:71:3E:C5:1F,2158085,273775965,129,15493,2157956,273760472,0,587,49169,493,37879,94,11290,138,1,215,9,0,32,130000.0,39000.0,-65.0,-67.0,-64.0,-59.0,-70.0,-73.0,-67.0,-62.0,-76.0,-83.0,-77.0,-84.0,11.0,16.0,13.0,25.0,1
2895,CC:2F:71:3F:1F:24,2576917,825779158,418961,552018686,2157956,273760472,9,313342,390112134,313177,390089790,165,22344,306124,566,419019,40109,9,4052,130000.0,43333.0,-68.0,-61.0,-70.0,-67.0,-68.0,-61.0,-70.0,-67.0,-76.0,-83.0,-77.0,-84.0,8.0,22.0,7.0,17.0,1
2896,F8:59:71:5A:E0:3D,2328901,534721654,170925,260959111,2157976,273762543,354,124577,175334531,124459,175317490,118,17041,123721,43,170931,9928,354,412,144444.0,43333.0,-65.0,-66.0,-64.0,-69.0,-65.0,-71.0,-65.0,-69.0,-76.0,-83.0,-77.0,-84.0,11.0,17.0,13.0,15.0,1
2897,CC:2F:71:3E:C5:1F,2158107,273778238,129,15493,2157978,273762745,0,589,49357,494,37949,95,11408,139,1,215,9,0,32,130000.0,39000.0,-70.0,-70.0,-66.0,-60.0,-68.0,-69.0,-65.0,-59.0,-76.0,-83.0,-77.0,-84.0,6.0,13.0,11.0,24.0,1
2898,CC:2F:71:3F:1F:24,2577568,826701848,419588,552938735,2157980,273763113,9,313963,391025635,313798,391003291,165,22344,306738,566,419646,40149,9,4093,130000.0,43333.0,-68.0,-62.0,-69.0,-67.0,-68.0,-61.0,-69.0,-67.0,-76.0,-83.0,-77.0,-84.0,8.0,21.0,8.0,17.0,1
2899,F8:59:71:5A:E0:3D,2329247,535237954,171256,261473771,2157991,273764183,354,124774,175635449,124656,175618408,118,17041,123905,43,171262,9985,354,422,144444.0,43333.0,-65.0,-70.0,-63.0,-69.0,-66.0,-72.0,-66.0,-69.0,-76.0,-83.0,-76.0,-83.0,11.0,13.0,13.0,14.0,1
2900,CC:2F:71:3E:C5:1F,2158126,273780282,129,15493,2157997,273764789,0,589,49357,494,37949,95,11408,139,1,215,9,0,32,130000.0,39000.0,-70.0,-70.0,-66.0,-60.0,-68.0,-69.0,-65.0,-59.0,-76.0,-83.0,-76.0,-83.0,6.0,13.0,10.0,23.0,1
2901,CC:2F:71:3F:1F:24,2578316,827759744,420314,553994491,2158002,273765253,9,314669,392050476,314504,392028132,165,22344,307431,566,420372,40190,9,4114,130000.0,43333.0,-69.0,-62.0,-70.0,-67.0,-68.0,-61.0,-70.0,-67.0,-76.0,-83.0,-76.0,-83.0,7.0,21.0,6.0,16.0,1
2902,F8:59:71:5A:E0:3D,2329595,535731083,171591,261965628,2158004,273765455,354,125073,176017232,124955,176000191,118,17041,124184,43,171597,9987,354,430,144444.0,43333.0,-65.0,-72.0,-66.0,-69.0,-64.0,-70.0,-65.0,-69.0,-75.0,-82.0,-75.0,-82.0,10.0,10.0,9.0,13.0,1
2903,CC:2F:71:3E:C5:1F,2158133,273780948,129,15493,2158004,273765455,0,589,49357,494,37949,95,11408,139,1,215,9,0,32,130000.0,39000.0,-70.0,-70.0,-66.0,-60.0,-68.0,-69.0,-65.0,-59.0,-75.0,-82.0,-75.0,-82.0,5.0,12.0,9.0,22.0,1
2904,CC:2F:71:3F:1F:24,2578511,827976298,420505,554210641,2158006,273765657,9,314900,392330287,314735,392307943,165,22344,307661,566,420563,40194,9,4114,130000.0,43333.0,-68.0,-62.0,-70.0,-67.0,-68.0,-62.0,-70.0,-67.0,-75.0,-82.0,-75.0,-82.0,7.0,20.0,5.0,15.0,1
2905,F8:59:71:5A:E0:3D,2329829,536079709,171816,262313386,2158013,273766323,354,125227,176232613,125109,176215572,118,17041,124338,43,171822,9987,354,436,144444.0,43333.0,-64.0,-71.0,-64.0,-69.0,-64.0,-70.0,-64.0,-69.0,-75.0,-82.0,-75.0,-82.0,11.0,11.0,11.0,13.0,1
2906,CC:2F:71:3E:C5:1F,2158146,273782220,129,15493,2158017,273766727,0,589,49357,494,37949,95,11408,139,1,215,9,0,32,130000.0,39000.0,-70.0,-70.0,-66.0,-60.0,-68.0,-69.0,-65.0,-59.0,-75.0,-81.0,-75.0,-82.0,5.0,11.0,9.0,22.0,1
2907,CC:2F:71:3F:1F:24,2578958,828590197,420939,554823268,2158019,273766929,9,315338,392950202,315173,392927858,165,22344,308098,566,420997,40212,9,4152,144444.0,43333.0,-68.0,-62.0,-70.0,-67.0,-68.0,-62.0,-70.0,-67.0,-75.0,-81.0,-75.0,-82.0,7.0,19.0,5.0,15.0,1
2908,F8:59:71:5A:E0:3D,2329965,536273619,171943,262506428,2158022,273767191,354,125358,176431491,125240,176414450,118,17041,124469,43,171949,9987,354,444,144444.0,43333.0,-64.0,-66.0,-64.0,-69.0,-65.0,-70.0,-64.0,-69.0,-75.0,-81.0,-75.0,-82.0,11.0,15.0,11.0,13.0,1
2909,CC:2F:71:3E:C5:1F,2158151,273782684,129,15493,2158022,273767191,0,589,49357,494,37949,95,11408,139,1,215,9,0,32,130000.0,39000.0,-70.0,-70.0,-66.0,-60.0,-68.0,-69.0,-65.0,-59.0,-75.0,-81.0,-75.0,-82.0,5.0,11.0,9.0,22.0,1
2910,CC:2F:71:3F:1F:24,2579159,828858719,421137,555091528,2158022,273767191,9,315515,393196798,315350,393174454,165,22344,308275,566,421195,40216,9,4152,130000.0,43333.0,-69.0,-62.0,-70.0,-67.0,-68.0,-62.0,-70.0,-67.0,-75.0,-81.0,-75.0,-82.0,6.0,19.0,5.0,15.0,1
2911,F8:59:71:5A:E0:3D,2330070,536425141,172041,262657282,2158029,273767859,354,125458,176586219,125340,176569178,118,17041,124569,43,172047,9987,354,451,144444.0,43333.0,-64.0,-71.0,-64.0,-69.0,-64.0,-71.0,-64.0,-69.0,-75.0,-81.0,-75.0,-82.0,11.0,10.0,11.0,13.0,1
2912,CC:2F:71:3E:C5:1F,2158161,273783670,130,15609,2158031,273768061,0,591,49497,496,38089,95,11408,139,1,216,9,0,32,130000.0,39000.0,-65.0,-69.0,-63.0,-60.0,-68.0,-69.0,-65.0,-59.0,-75.0,-81.0,-75.0,-82.0,10.0,12.0,12.0,22.0,1
2913,CC:2F:71:3F:1F:24,2579420,829184404,421389,555416343,2158031,273768061,9,315762,393523114,315596,393500652,166,22462,308522,566,421447,40230,9,4154,130000.0,39000.0,-68.0,-61.0,-70.0,-67.0,-67.0,-61.0,-70.0,-67.0,-75.0,-81.0,-75.0,-82.0,7.0,20.0,5.0,15.0,1
2914,F8:59:71:5A:E0:3D,2330169,536554569,172134,262785973,2158035,273768596,354,125551,176714122,125433,176697081,118,17041,124662,43,172140,9987,354,454,144444.0,43333.0,-66.0,-73.0,-65.0,-70.0,-65.0,-72.0,-65.0,-70.0,-75.0,-81.0,-75.0,-81.0,9.0,8.0,10.0,11.0,1
2915,CC:2F:71:3E:C5:1F,2158167,273784407,130,15609,2158037,273768798,0,591,49497,496,38089,95,11408,139,1,216,9,0,32,130000.0,39000.0,-65.0,-69.0,-63.0,-60.0,-68.0,-69.0,-65.0,-59.0,-75.0,-81.0,-75.0,-81.0,10.0,12.0,12.0,21.0,1
2916,CC:2F:71:3F:1F:24,2579650,829475717,421613,555706919,2158037,273768798,9,315967,393795257,315801,393772795,166,22462,308727,566,421671,40231,9,4157,130000.0,43333.0,-67.0,-62.0,-69.0,-69.0,-67.0,-61.0,-69.0,-68.0,-75.0,-81.0,-75.0,-81.0,8.0,19.0,6.0,12.0,1
2917,F8:59:71:5A:E0:3D,2330263,536690435,172221,262921171,2158042,273769264,354,125639,176848220,125520,176831061,119,17159,124750,43,172227,9989,354,454,144444.0,43333.0,-65.0,-72.0,-65.0,-70.0,-65.0,-71.0,-64.0,-70.0,-75.0,-81.0,-75.0,-81.0,10.0,9.0,10.0,11.0,1
2918,CC:2F:71:3E:C5:1F,2158172,273784873,130,15609,2158042,273769264,0,591,49497,496,38089,95,11408,139,1,216,9,0,32,130000.0,39000.0,-65.0,-69.0,-63.0,-60.0,-68.0,-69.0,-65.0,-59.0,-75.0,-81.0,-75.0,-81.0,10.0,12.0,12.0,21.0,1
2919,CC:2F:71:3F:1F:24,2579835,829699792,421793,555930528,2158042,273769264,9,316132,394003655,315966,393981193,166,22462,308892,566,421851,40237,9,4157,144444.0,39000.0,-67.0,-62.0,-70.0,-69.0,-67.0,-61.0,-70.0,-68.0,-75.0,-81.0,-75.0,-81.0,8.0,19.0,5.0,12.0,1
2920,F8:59:71:5A:E0:3D,2330329,536789925,172285,263020459,2158044,273769466,354,125699,176940620,125580,176923461,119,17159,124810,43,172291,9989,354,454,144444.0,43333.0,-65.0,-72.0,-65.0,-70.0,-65.0,-72.0,-65.0,-70.0,-75.0,-81.0,-75.0,-81.0,10.0,9.0,10.0,11.0,1
2921,CC:2F:71:3E:C5:1F,2158177,273785337,130,15609,2158047,273769728,0,591,49497,496,38089,95,11408,139,1,216,9,0,32,130000.0,39000.0,-65.0,-69.0,-63.0,-60.0,-68.0,-69.0,-65.0,-59.0,-75.0,-81.0,-75.0,-81.0,10.0,12.0,12.0,21.0,1
2922,CC:2F:71:3F:1F:24,2580023,829940892,421974,556170962,2158049,273769930,9,316302,394235407,316136,394212945,166,22462,309062,566,422032,40258,9,4161,144444.0,43333.0,-67.0,-62.0,-70.0,-69.0,-67.0,-61.0,-70.0,-68.0,-75.0,-81.0,-75.0,-81.0,8.0,19.0,5.0,12.0,1
2923,F8:59:71:5A:E0:3D,2330537,537102099,172486,263331967,2158051,273770132,354,125794,177064538,125675,177047379,119,17159,124905,43,172492,10007,354,454,144444.0,43333.0,-65.0,-72.0,-65.0,-70.0,-65.0,-72.0,-64.0,-70.0,-75.0,-81.0,-75.0,-81.0,10.0,9.0,10.0,11.0,1
2924,CC:2F:71:3E:C5:1F,2158181,273785741,130,15609,2158051,273770132,0,591,49497,496,38089,95,11408,139,1,216,9,0,32,130000.0,39000.0,-65.0,-69.0,-63.0,-60.0,-68.0,-69.0,-65.0,-59.0,-75.0,-81.0,-75.0,-81.0,10.0,12.0,12.0,21.0,1
2925,CC:2F:71:3F:1F:24,2580184,830148860,422133,556378728,2158051,273770132,9,316445,394432491,316279,394410029,166,22462,309205,566,422190,40271,9,4161,130000.0,43333.0,-67.0,-62.0,-70.0,-69.0,-66.0,-61.0,-69.0,-68.0,-75.0,-81.0,-75.0,-81.0,8.0,19.0,5.0,12.0,1
2926,F8:59:71:5A:E0:3D,2330601,537198649,172548,263428315,2158053,273770334,354,125856,177160018,125737,177142859,119,17159,124967,43,172554,10008,354,454,144444.0,43333.0,-65.0,-72.0,-65.0,-70.0,-65.0,-72.0,-65.0,-70.0,-74.0,-81.0,-74.0,-82.0,9.0,9.0,9.0,12.0,1
2927,CC:2F:71:3E:C5:1F,2158183,273785943,130,15609,2158053,273770334,0,591,49497,496,38089,95,11408,139,1,216,9,0,32,130000.0,39000.0,-65.0,-69.0,-63.0,-60.0,-68.0,-69.0,-65.0,-59.0,-74.0,-81.0,-74.0,-82.0,9.0,12.0,11.0,22.0,1
2928,CC:2F:71:3F:1F:24,2580351,830353047,422296,556582511,2158055,273770536,9,316595,394625246,316429,394602784,166,22462,309355,566,422354,40271,9,4161,130000.0,43333.0,-68.0,-62.0,-70.0,-69.0,-67.0,-61.0,-69.0,-69.0,-74.0,-81.0,-74.0,-82.0,6.0,19.0,4.0,13.0,1
2929,F8:59:71:5A:E0:3D,2330677,537296644,172616,263525582,2158061,273771062,354,125921,177255590,125802,177238431,119,17159,125032,43,172622,10008,354,454,144444.0,43333.0,-64.0,-71.0,-64.0,-70.0,-64.0,-70.0,-64.0,-69.0,-74.0,-81.0,-74.0,-82.0,10.0,10.0,10.0,12.0,1
2930,CC:2F:71:3E:C5:1F,2158191,273786671,130,15609,2158061,273771062,0,592,49615,496,38089,96,11526,140,1,216,9,0,32,130000.0,39000.0,-70.0,-70.0,-66.0,-60.0,-68.0,-69.0,-65.0,-59.0,-74.0,-81.0,-74.0,-82.0,4.0,11.0,8.0,22.0,1
2931,CC:2F:71:3F:1F:24,2580515,830561265,422454,556790203,2158061,273771062,9,316738,394823838,316572,394801376,166,22462,309498,566,422512,40271,9,4165,130000.0,43333.0,-67.0,-62.0,-70.0,-70.0,-67.0,-62.0,-70.0,-69.0,-74.0,-81.0,-74.0,-82.0,7.0,19.0,4.0,12.0,1
2932,F8:59:71:5A:E0:3D,2330890,537620437,172827,263849173,2158063,273771264,354,126017,177363008,125898,177345849,119,17159,125128,43,172833,10008,354,454,144444.0,43333.0,-65.0,-72.0,-65.0,-70.0,-65.0,-71.0,-64.0,-70.0,-74.0,-81.0,-74.0,-82.0,9.0,9.0,9.0,12.0,1
2933,CC:2F:71:3E:C5:1F,2158193,273786873,130,15609,2158063,273771264,0,593,49685,497,38159,96,11526,140,1,216,9,0,32,130000.0,39000.0,-70.0,-70.0,-67.0,-60.0,-68.0,-69.0,-65.0,-59.0,-74.0,-81.0,-74.0,-82.0,4.0,11.0,7.0,22.0,1
2934,CC:2F:71:3F:1F:24,2580672,830764273,422609,556993009,2158063,273771264,9,316881,395019498,316715,394997036,166,22462,309641,566,422667,40276,9,4165,130000.0,43333.0,-68.0,-62.0,-70.0,-70.0,-68.0,-62.0,-69.0,-70.0,-74.0,-81.0,-74.0,-82.0,6.0,19.0,4.0,12.0,1
2935,F8:59:71:5A:E0:3D,2330967,537731451,172899,263959649,2158068,273771802,354,126090,177474500,125971,177457341,119,17159,125201,43,172905,10008,354,454,144444.0,43333.0,-66.0,-73.0,-65.0,-70.0,-65.0,-71.0,-65.0,-69.0,-74.0,-81.0,-74.0,-82.0,8.0,8.0,9.0,12.0,1
2936,CC:2F:71:3E:C5:1F,2158199,273787479,130,15609,2158069,273771870,0,593,49685,497,38159,96,11526,140,1,216,9,0,32,130000.0,39000.0,-70.0,-70.0,-67.0,-60.0,-68.0,-69.0,-65.0,-59.0,-74.0,-81.0,-74.0,-82.0,4.0,11.0,7.0,22.0,1
2937,CC:2F:71:3F:1F:24,2580859,831006665,422790,557234795,2158069,273771870,9,317045,395250528,316879,395228066,166,22462,309805,566,422848,40281,9,4171,130000.0,43333.0,-68.0,-62.0,-70.0,-70.0,-67.0,-62.0,-69.0,-69.0,-74.0,-81.0,-74.0,-82.0,6.0,19.0,4.0,12.0,1
2938,F8:59:71:5A:E0:3D,2331041,537836357,172969,264064225,2158072,273772132,354,126161,177581034,126042,177563875,119,17159,125272,43,172975,10008,354,454,144444.0,43333.0,-64.0,-71.0,-64.0,-69.0,-64.0,-70.0,-64.0,-69.0,-74.0,-81.0,-74.0,-82.0,10.0,10.0,10.0,13.0,1
2939,CC:2F:71:3E:C5:1F,2158202,273787741,130,15609,2158072,273772132,0,593,49685,497,38159,96,11526,140,1,216,9,0,32,130000.0,39000.0,-70.0,-70.0,-67.0,-60.0,-68.0,-69.0,-65.0,-59.0,-74.0,-81.0,-74.0,-82.0,4.0,11.0,7.0,22.0,1
2940,CC:2F:71:3F:1F:24,2581018,831208439,422946,557436307,2158072,273772132,9,317197,395450171,317031,395427709,166,22462,309955,566,423004,40285,9,4171,130000.0,43333.0,-68.0,-62.0,-70.0,-70.0,-67.0,-61.0,-69.0,-69.0,-74.0,-81.0,-74.0,-82.0,6.0,19.0,4.0,12.0,1
2941,F8:59:71:5A:E0:3D,2331108,537934663,173032,264162127,2158076,273772536,354,126223,177676514,126104,177659355,119,17159,125334,43,173038,10008,354,454,144444.0,43333.0,-63.0,-67.0,-64.0,-65.0,-64.0,-70.0,-64.0,-68.0,-74.0,-81.0,-74.0,-82.0,11.0,14.0,10.0,17.0,1
2942,CC:2F:71:3E:C5:1F,2158206,273788145,130,15609,2158076,273772536,0,593,49685,497,38159,96,11526,140,1,216,9,0,32,130000.0,39000.0,-70.0,-70.0,-67.0,-60.0,-68.0,-69.0,-65.0,-59.0,-74.0,-81.0,-74.0,-82.0,4.0,11.0,7.0,22.0,1
2943,CC:2F:71:3F:1F:24,2581179,831413557,423103,557641021,2158076,273772536,9,317337,395642635,317171,395620173,166,22462,310095,566,423161,40285,9,4171,130000.0,43333.0,-67.0,-62.0,-70.0,-69.0,-67.0,-62.0,-69.0,-69.0,-74.0,-81.0,-74.0,-82.0,7.0,19.0,4.0,13.0,1
2944,F8:59:71:5A:E0:3D,2331180,538043645,173102,264270907,2158078,273772738,354,126293,177784552,126174,177767393,119,17159,125404,43,173108,10009,354,454,144444.0,43333.0,-65.0,-72.0,-65.0,-69.0,-64.0,-71.0,-64.0,-69.0,-74.0,-81.0,-74.0,-82.0,9.0,9.0,9.0,13.0,1
2945,CC:2F:71:3E:C5:1F,2158208,273788347,130,15609,2158078,273772738,0,593,49685,497,38159,96,11526,140,1,216,9,0,32,130000.0,39000.0,-70.0,-70.0,-67.0,-60.0,-68.0,-69.0,-65.0,-59.0,-74.0,-81.0,-74.0,-82.0,4.0,11.0,7.0,22.0,1
2946,CC:2F:71:3F:1F:24,2581370,831648952,423290,557876012,2158080,273772940,9,317508,395866533,317342,395844071,166,22462,310266,566,423348,40301,9,4174,130000.0,43333.0,-69.0,-62.0,-70.0,-71.0,-68.0,-61.0,-70.0,-70.0,-74.0,-81.0,-74.0,-82.0,5.0,19.0,4.0,11.0,1
2947,F8:59:71:5A:E0:3D,2331378,538340433,173293,264567029,2158085,273773404,354,126377,177888794,126258,177871635,119,17159,125488,43,173299,10041,354,454,144444.0,43333.0,-64.0,-72.0,-64.0,-70.0,-64.0,-70.0,-64.0,-69.0,-74.0,-81.0,-74.0,-82.0,10.0,9.0,10.0,12.0,1
2948,CC:2F:71:3E:C5:1F,2158215,273789013,130,15609,2158085,273773404,0,593,49685,497,38159,96,11526,140,1,216,9,0,32,130000.0,39000.0,-70.0,-70.0,-67.0,-60.0,-68.0,-69.0,-65.0,-59.0,-74.0,-81.0,-74.0,-82.0,4.0,11.0,7.0,22.0,1
2949,CC:2F:71:3F:1F:24,2581537,831856092,423452,558082688,2158085,273773404,9,317658,396064639,317492,396042177,166,22462,310416,566,423510,40303,9,4177,130000.0,43333.0,-68.0,-61.0,-70.0,-70.0,-68.0,-61.0,-70.0,-70.0,-74.0,-81.0,-74.0,-82.0,6.0,20.0,4.0,12.0,1
2950,F8:59:71:5A:E0:3D,2331716,538865820,173629,265092214,2158087,273773606,354,126482,177991572,126363,177974413,119,17159,125593,43,173635,10043,354,454,144444.0,43333.0,-64.0,-67.0,-65.0,-70.0,-64.0,-68.0,-65.0,-68.0,-74.0,-81.0,-74.0,-82.0,10.0,14.0,9.0,12.0,1
2951,CC:2F:71:3E:C5:1F,2158217,273789215,130,15609,2158087,273773606,0,593,49685,497,38159,96,11526,140,1,216,9,0,32,130000.0,39000.0,-70.0,-70.0,-67.0,-60.0,-68.0,-69.0,-65.0,-59.0,-74.0,-81.0,-74.0,-82.0,4.0,11.0,7.0,22.0,1
2952,CC:2F:71:3F:1F:24,2581698,832064060,423611,558290454,2158087,273773606,9,317806,396265151,317640,396242689,166,22462,310564,566,423669,40304,9,4177,130000.0,39000.0,-68.0,-62.0,-71.0,-71.0,-67.0,-61.0,-70.0,-70.0,-74.0,-81.0,-74.0,-81.0,6.0,19.0,3.0,10.0,1
2953,F8:59:71:5A:E0:3D,2331787,538966155,173693,265191670,2158094,273774485,354,126547,178091672,126428,178074513,119,17159,125658,43,173698,10043,354,454,144444.0,43333.0,-65.0,-67.0,-65.0,-69.0,-65.0,-71.0,-65.0,-69.0,-74.0,-81.0,-74.0,-81.0,9.0,14.0,9.0,12.0,1
2954,CC:2F:71:3E:C5:1F,2158224,273790094,130,15609,2158094,273774485,0,593,49685,497,38159,96,11526,140,1,216,9,0,32,130000.0,39000.0,-70.0,-70.0,-67.0,-60.0,-68.0,-69.0,-65.0,-59.0,-74.0,-81.0,-74.0,-81.0,4.0,11.0,7.0,21.0,1
2955,CC:2F:71:3F:1F:24,2581870,832280607,423775,558506062,2158095,273774545,9,317957,396470309,317791,396447847,166,22462,310714,566,423833,40306,9,4177,144444.0,43333.0,-70.0,-62.0,-69.0,-69.0,-70.0,-62.0,-69.0,-68.0,-74.0,-81.0,-74.0,-81.0,4.0,19.0,5.0,12.0,1
2956,F8:59:71:5A:E0:3D,2331856,539068981,173759,265294234,2158097,273774747,354,126616,178195076,126497,178177917,119,17159,125724,43,173765,10045,354,454,144444.0,43333.0,-65.0,-68.0,-64.0,-69.0,-65.0,-70.0,-64.0,-68.0,-74.0,-81.0,-74.0,-81.0,9.0,13.0,10.0,12.0,1
2957,CC:2F:71:3E:C5:1F,2158227,273790356,130,15609,2158097,273774747,0,593,49685,497,38159,96,11526,140,1,216,9,0,32,130000.0,39000.0,-70.0,-70.0,-67.0,-60.0,-68.0,-69.0,-65.0,-59.0,-74.0,-81.0,-74.0,-81.0,4.0,11.0,7.0,21.0,1
2958,CC:2F:71:3F:1F:24,2582028,832483974,423931,558709227,2158097,273774747,9,318100,396664718,317934,396642256,166,22462,310857,566,423989,40306,9,4180,144444.0,43333.0,-71.0,-61.0,-69.0,-68.0,-70.0,-61.0,-69.0,-68.0,-74.0,-81.0,-74.0,-81.0,3.0,20.0,5.0,13.0,1
2959,F8:59:71:5A:E0:3D,2331925,539167489,173822,265392136,2158103,273775353,354,126680,178290752,126561,178273593,119,17159,125786,43,173828,10045,354,454,144444.0,43333.0,-64.0,-71.0,-65.0,-69.0,-64.0,-70.0,-65.0,-68.0,-74.0,-81.0,-74.0,-82.0,10.0,10.0,9.0,13.0,1
2960,CC:2F:71:3E:C5:1F,2158233,273790962,130,15609,2158103,273775353,0,593,49685,497,38159,96,11526,140,1,216,9,0,32,130000.0,39000.0,-70.0,-70.0,-67.0,-60.0,-68.0,-69.0,-65.0,-59.0,-74.0,-81.0,-74.0,-82.0,4.0,11.0,7.0,22.0,1
2961,CC:2F:71:3F:1F:24,2582202,832697557,424099,558922204,2158103,273775353,9,318257,396866766,318091,396844304,166,22462,311014,566,424157,40306,9,4180,144444.0,43333.0,-70.0,-61.0,-69.0,-68.0,-70.0,-61.0,-69.0,-68.0,-74.0,-81.0,-74.0,-82.0,4.0,20.0,5.0,14.0,1
2962,F8:59:71:5A:E0:3D,2331994,539270315,173888,265494700,2158106,273775615,354,126747,178393932,126628,178376773,119,17159,125853,43,173894,10045,354,454,144444.0,43333.0,-64.0,-71.0,-66.0,-69.0,-64.0,-69.0,-64.0,-68.0,-74.0,-81.0,-74.0,-82.0,10.0,10.0,8.0,13.0,1
2963,CC:2F:71:3E:C5:1F,2158236,273791224,130,15609,2158106,273775615,0,593,49685,497,38159,96,11526,140,1,216,9,0,32,130000.0,39000.0,-70.0,-70.0,-67.0,-60.0,-68.0,-69.0,-65.0,-59.0,-74.0,-81.0,-74.0,-82.0,4.0,11.0,7.0,22.0,1
2964,CC:2F:71:3F:1F:24,2582372,832918073,424266,559142458,2158106,273775615,9,318410,397079348,318244,397056886,166,22462,311167,566,424324,40306,9,4181,144444.0,43333.0,-71.0,-61.0,-69.0,-68.0,-70.0,-61.0,-69.0,-67.0,-74.0,-81.0,-74.0,-82.0,3.0,20.0,5.0,14.0,1
2965,F8:59:71:5A:E0:3D,2332065,539371931,173953,265595710,2158112,273776221,354,126810,178491134,126691,178473975,119,17159,125916,43,173959,10045,354,455,144444.0,43333.0,-64.0,-72.0,-66.0,-69.0,-64.0,-69.0,-65.0,-68.0,-74.0,-81.0,-74.0,-82.0,10.0,9.0,8.0,13.0,1
2966,CC:2F:71:3E:C5:1F,2158242,273791830,130,15609,2158112,273776221,0,593,49685,497,38159,96,11526,140,1,216,9,0,32,130000.0,39000.0,-70.0,-70.0,-67.0,-60.0,-68.0,-69.0,-65.0,-59.0,-74.0,-81.0,-74.0,-82.0,4.0,11.0,7.0,22.0,1
2967,CC:2F:71:3F:1F:24,2582555,833138826,424443,559362605,2158112,273776221,9,318575,397293860,318409,397271398,166,22462,311332,566,424501,40306,9,4181,144444.0,43333.0,-71.0,-62.0,-69.0,-69.0,-70.0,-61.0,-69.0,-68.0,-74.0,-81.0,-74.0,-82.0,3.0,19.0,5.0,13.0,1
2968,F8:59:71:5A:E0:3D,2332185,539546915,174071,265770492,2158114,273776423,354,126890,178602406,126771,178585247,119,17159,125996,43,174077,10045,354,455,144444.0,43333.0,-65.0,-72.0,-65.0,-69.0,-64.0,-70.0,-64.0,-68.0,-74.0,-81.0,-74.0,-82.0,9.0,9.0,9.0,13.0,1
2969,CC:2F:71:3E:C5:1F,2158244,273792032,130,15609,2158114,273776423,0,593,49685,497,38159,96,11526,140,1,216,9,0,32,130000.0,39000.0,-70.0,-70.0,-67.0,-60.0,-68.0,-69.0,-65.0,-59.0,-74.0,-81.0,-74.0,-82.0,4.0,11.0,7.0,22.0,1
2970,CC:2F:71:3F:1F:24,2582716,833346850,424602,559570427,2158114,273776423,9,318719,397492498,318553,397470036,166,22462,311475,566,424660,40307,9,4181,144444.0,43333.0,-71.0,-61.0,-69.0,-68.0,-70.0,-61.0,-69.0,-68.0,-74.0,-81.0,-74.0,-82.0,3.0,20.0,5.0,14.0,1
2971,F8:59:71:5A:E0:3D,2332251,539644967,174134,265868282,2158117,273776685,354,126953,178699426,126834,178682267,119,17159,126059,43,174140,10046,354,455,144444.0,43333.0,-64.0,-72.0,-65.0,-69.0,-64.0,-70.0,-64.0,-68.0,-74.0,-81.0,-74.0,-82.0,10.0,9.0,9.0,13.0,1
2972,CC:2F:71:3E:C5:1F,2158251,273792698,130,15609,2158121,273777089,0,593,49685,497,38159,96,11526,140,1,216,9,0,32,130000.0,39000.0,-70.0,-70.0,-67.0,-60.0,-68.0,-69.0,-65.0,-59.0,-74.0,-81.0,-74.0,-82.0,4.0,11.0,7.0,22.0,1
2973,CC:2F:71:3F:1F:24,2582889,833566216,424768,559789127,2158121,273777089,9,318873,397703688,318707,397681226,166,22462,311628,566,424826,40307,9,4181,144444.0,43333.0,-71.0,-61.0,-69.0,-68.0,-70.0,-61.0,-69.0,-67.0,-74.0,-81.0,-74.0,-82.0,3.0,20.0,5.0,14.0,1
2974,F8:59:71:5A:E0:3D,2332409,539874889,174286,266097598,2158123,273777291,354,127052,178814926,126933,178797767,119,17159,126158,43,174292,10046,354,455,144444.0,43333.0,-65.0,-72.0,-64.0,-69.0,-64.0,-70.0,-64.0,-68.0,-74.0,-81.0,-74.0,-82.0,9.0,9.0,10.0,13.0,1
2975,CC:2F:71:3E:C5:1F,2158253,273792900,130,15609,2158123,273777291,0,593,49685,497,38159,96,11526,140,1,216,9,0,32,130000.0,39000.0,-70.0,-70.0,-67.0,-60.0,-68.0,-69.0,-65.0,-59.0,-74.0,-81.0,-74.0,-82.0,4.0,11.0,7.0,22.0,1
2976,CC:2F:71:3F:1F:24,2583050,833772954,424927,559995663,2158123,273777291,9,319018,397901012,318852,397878550,166,22462,311773,566,424985,40312,9,4181,144444.0,43333.0,-71.0,-61.0,-69.0,-68.0,-70.0,-61.0,-68.0,-68.0,-74.0,-81.0,-74.0,-82.0,3.0,20.0,5.0,14.0,1
2977,F8:59:71:5A:E0:3D,2332481,539983871,174356,266206378,2158125,273777493,354,127122,178922726,127003,178905567,119,17159,126228,43,174362,10048,354,455,144444.0,43333.0,-64.0,-68.0,-64.0,-69.0,-64.0,-68.0,-64.0,-68.0,-74.0,-81.0,-74.0,-82.0,10.0,13.0,10.0,13.0,1
2978,CC:2F:71:3E:C5:1F,2158257,273793304,130,15609,2158127,273777695,0,593,49685,497,38159,96,11526,140,1,216,9,0,32,130000.0,39000.0,-70.0,-70.0,-67.0,-60.0,-68.0,-69.0,-65.0,-59.0,-74.0,-81.0,-74.0,-82.0,4.0,11.0,7.0,22.0,1
2979,CC:2F:71:3F:1F:24,2583235,834005209,425106,560227312,2158129,273777897,9,319186,398122881,319020,398100419,166,22462,311940,566,425164,40314,9,4181,144444.0,43333.0,-71.0,-61.0,-69.0,-68.0,-70.0,-61.0,-69.0,-67.0,-74.0,-81.0,-74.0,-82.0,3.0,20.0,5.0,14.0,1
2980,F8:59:71:5A:E0:3D,2332553,540088453,174423,266310496,2158130,273777957,354,127191,179028986,127072,179011827,119,17159,126297,43,174429,10048,354,455,144444.0,43333.0,-65.0,-71.0,-65.0,-69.0,-64.0,-69.0,-64.0,-68.0,-74.0,-82.0,-75.0,-82.0,9.0,11.0,10.0,13.0,1
2981,CC:2F:71:3E:C5:1F,2158262,273793768,130,15609,2158132,273778159,0,593,49685,497,38159,96,11526,140,1,216,9,0,32,130000.0,39000.0,-70.0,-70.0,-67.0,-60.0,-68.0,-69.0,-65.0,-59.0,-74.0,-82.0,-75.0,-82.0,4.0,12.0,8.0,22.0,1
2982,CC:2F:71:3F:1F:24,2583424,834233407,425292,560455248,2158132,273778159,9,319360,398344432,319194,398321970,166,22462,312114,566,425350,40317,9,4187,144444.0,43333.0,-70.0,-61.0,-69.0,-68.0,-70.0,-61.0,-69.0,-67.0,-74.0,-82.0,-75.0,-82.0,4.0,21.0,6.0,14.0,1
2983,F8:59:71:5A:E0:3D,2332619,540188111,174487,266409952,2158132,273778159,354,127254,179126006,127135,179108847,119,17159,126360,43,174493,10048,354,455,144444.0,43333.0,-65.0,-72.0,-65.0,-69.0,-64.0,-70.0,-64.0,-68.0,-74.0,-82.0,-75.0,-82.0,9.0,10.0,10.0,13.0,1
2984,CC:2F:71:3E:C5:1F,2158264,273793970,130,15609,2158134,273778361,0,593,49685,497,38159,96,11526,140,1,216,9,0,32,130000.0,39000.0,-70.0,-70.0,-67.0,-60.0,-68.0,-69.0,-65.0,-59.0,-74.0,-82.0,-75.0,-82.0,4.0,12.0,8.0,22.0,1
2985,CC:2F:71:3F:1F:24,2583589,834446165,425453,560667602,2158136,273778563,9,319508,398546368,319342,398523906,166,22462,312262,566,425511,40318,9,4187,144444.0,43333.0,-71.0,-61.0,-69.0,-68.0,-70.0,-61.0,-69.0,-67.0,-74.0,-82.0,-75.0,-82.0,3.0,21.0,6.0,14.0,1
2986,F8:59:71:5A:E0:3D,2332691,540291001,174553,266512236,2158138,273778765,354,127318,179224608,127199,179207449,119,17159,126424,43,174559,10049,354,455,144444.0,43333.0,-64.0,-68.0,-64.0,-69.0,-64.0,-70.0,-64.0,-69.0,-74.0,-82.0,-75.0,-82.0,10.0,14.0,11.0,13.0,1
2987,CC:2F:71:3E:C5:1F,2158268,273794374,130,15609,2158138,273778765,0,593,49685,497,38159,96,11526,140,1,216,9,0,32,130000.0,39000.0,-70.0,-70.0,-67.0,-60.0,-68.0,-69.0,-65.0,-59.0,-74.0,-82.0,-75.0,-82.0,4.0,12.0,8.0,22.0,1
2988,CC:2F:71:3F:1F:24,2583752,834652897,425611,560873870,2158141,273779027,9,319649,398741796,319483,398719334,166,22462,312403,566,425669,40318,9,4187,144444.0,43333.0,-70.0,-61.0,-69.0,-68.0,-70.0,-61.0,-69.0,-67.0,-74.0,-82.0,-75.0,-82.0,4.0,21.0,6.0,14.0,1
2989,F8:59:71:5A:E0:3D,2332757,540389165,174616,266610138,2158141,273779027,354,127376,179313998,127257,179296839,119,17159,126482,43,174622,10049,354,455,144444.0,43333.0,-65.0,-71.0,-65.0,-69.0,-64.0,-69.0,-64.0,-68.0,-74.0,-82.0,-75.0,-82.0,9.0,11.0,10.0,13.0,1
2990,CC:2F:71:3E:C5:1F,2158271,273794636,130,15609,2158141,273779027,0,593,49685,497,38159,96,11526,140,1,216,9,0,32,130000.0,39000.0,-70.0,-70.0,-67.0,-60.0,-68.0,-69.0,-65.0,-59.0,-74.0,-82.0,-75.0,-82.0,4.0,12.0,8.0,22.0,1
2991,CC:2F:71:3F:1F:24,2583927,834881509,425784,561102280,2158143,273779229,9,319815,398965794,319649,398943332,166,22462,312568,566,425842,40318,9,4187,144444.0,43333.0,-70.0,-61.0,-69.0,-68.0,-70.0,-61.0,-69.0,-67.0,-74.0,-82.0,-75.0,-82.0,4.0,21.0,6.0,14.0,1
2992,F8:59:71:5A:E0:3D,2332955,540686110,174808,266906477,2158147,273779633,354,127471,179435404,127352,179418245,119,17159,126577,43,174814,10091,354,457,144444.0,43333.0,-64.0,-70.0,-65.0,-68.0,-64.0,-70.0,-65.0,-68.0,-74.0,-82.0,-75.0,-82.0,10.0,12.0,10.0,14.0,1
2993,CC:2F:71:3E:C5:1F,2158278,273795358,131,15725,2158147,273779633,0,595,49825,499,38299,96,11526,140,1,217,9,0,32,130000.0,39000.0,-73.0,-76.0,-72.0,-70.0,-69.0,-71.0,-67.0,-62.0,-74.0,-82.0,-75.0,-82.0,1.0,6.0,3.0,12.0,1
2994,CC:2F:71:3F:1F:24,2584089,835086675,425941,561306980,2158148,273779695,9,319959,399160146,319793,399137684,166,22462,312712,566,425999,40319,9,4187,144444.0,43333.0,-71.0,-61.0,-69.0,-67.0,-70.0,-61.0,-69.0,-67.0,-74.0,-82.0,-75.0,-82.0,3.0,21.0,6.0,15.0,1
2995,F8:59:71:5A:E0:3D,2333023,540784609,174871,267004379,2158152,273780230,354,127535,179532542,127415,179515265,120,17277,126641,43,174876,10092,354,457,144444.0,43333.0,-64.0,-72.0,-64.0,-69.0,-64.0,-71.0,-64.0,-69.0,-74.0,-82.0,-75.0,-82.0,10.0,10.0,11.0,13.0,1
2996,CC:2F:71:3E:C5:1F,2158283,273795955,131,15725,2158152,273780230,0,595,49825,499,38299,96,11526,140,1,217,9,0,32,130000.0,39000.0,-73.0,-76.0,-72.0,-70.0,-69.0,-71.0,-67.0,-62.0,-74.0,-82.0,-75.0,-82.0,1.0,6.0,3.0,12.0,1
2997,CC:2F:71:3F:1F:24,2584270,835316963,426116,561536531,2158154,273780432,9,320128,399389469,319962,399367007,166,22462,312880,566,426174,40322,9,4190,144444.0,43333.0,-71.0,-61.0,-69.0,-67.0,-70.0,-61.0,-69.0,-67.0,-74.0,-82.0,-75.0,-82.0,3.0,21.0,6.0,15.0,1
2998,F8:59:71:5A:E0:3D,2333281,541177173,175123,267396337,2158158,273780836,354,127653,179656826,127533,179639549,120,17277,126759,43,175129,10155,354,458,144444.0,43333.0,-64.0,-71.0,-66.0,-69.0,-64.0,-69.0,-64.0,-69.0,-74.0,-82.0,-75.0,-82.0,10.0,11.0,9.0,13.0,1
2999,CC:2F:71:3E:C5:1F,2158291,273796929,131,15725,2158160,273781204,0,595,49825,499,38299,96,11526,140,1,217,9,0,32,130000.0,39000.0,-73.0,-76.0,-72.0,-70.0,-69.0,-71.0,-67.0,-62.0,-74.0,-82.0,-75.0,-82.0,1.0,6.0,3.0,12.0,1
3000,CC:2F:71:3F:1F:24,2584449,835544407,426287,561763001,2158162,273781406,9,320276,399594253,320110,399571791,166,22462,313028,566,426344,40323,9,4190,144444.0,43333.0,-70.0,-61.0,-69.0,-67.0,-70.0,-61.0,-69.0,-67.0,-74.0,-82.0,-75.0,-82.0,4.0,21.0,6.0,15.0,1
3001,F8:59:71:5A:E0:3D,2333415,541369551,175246,267587479,2158169,273782072,354,127795,179875842,127675,179858565,120,17277,126901,43,175252,10155,354,460,144444.0,43333.0,-64.0,-69.0,-64.0,-69.0,-64.0,-70.0,-64.0,-68.0,-75.0,-82.0,-75.0,-82.0,11.0,13.0,11.0,13.0,1
3002,CC:2F:71:3E:C5:1F,2158302,273797999,131,15725,2158171,273782274,0,595,49825,499,38299,96,11526,140,1,217,9,0,32,130000.0,39000.0,-73.0,-76.0,-72.0,-70.0,-69.0,-71.0,-67.0,-62.0,-75.0,-82.0,-75.0,-82.0,2.0,6.0,3.0,12.0,1
3003,CC:2F:71:3F:1F:24,2584849,836110697,426678,562328423,2158171,273782274,9,320658,400152889,320492,400130427,166,22462,313410,566,426736,40325,9,4220,144444.0,43333.0,-70.0,-61.0,-69.0,-67.0,-70.0,-61.0,-69.0,-67.0,-75.0,-82.0,-75.0,-82.0,5.0,21.0,6.0,15.0,1
3004,F8:59:71:5A:E0:3D,2333543,541556839,175366,267773959,2158177,273782880,354,127897,180033104,127777,180015827,120,17277,127003,43,175372,10156,354,460,144444.0,43333.0,-65.0,-68.0,-65.0,-69.0,-64.0,-69.0,-64.0,-69.0,-75.0,-82.0,-75.0,-82.0,10.0,14.0,10.0,13.0,1
3005,CC:2F:71:3E:C5:1F,2158308,273798605,131,15725,2158177,273782880,0,595,49825,499,38299,96,11526,140,1,217,9,0,32,130000.0,39000.0,-73.0,-76.0,-72.0,-70.0,-69.0,-71.0,-67.0,-62.0,-75.0,-82.0,-75.0,-82.0,2.0,6.0,3.0,12.0,1
3006,CC:2F:71:3F:1F:24,2585025,836325838,426848,562542958,2158177,273782880,9,320815,400355003,320649,400332541,166,22462,313565,566,426906,40396,9,4225,115556.0,28889.0,-69.0,-61.0,-70.0,-67.0,-68.0,-61.0,-69.0,-67.0,-75.0,-82.0,-75.0,-82.0,6.0,21.0,5.0,15.0,1
3007,F8:59:71:5A:E0:3D,2333610,541656557,175430,267873415,2158180,273783142,354,127961,180131664,127841,180114387,120,17277,127067,43,175436,10156,354,460,144444.0,43333.0,-64.0,-67.0,-65.0,-69.0,-64.0,-69.0,-64.0,-68.0,-75.0,-82.0,-75.0,-82.0,11.0,15.0,10.0,13.0,1
3008,CC:2F:71:3E:C5:1F,2158312,273798929,131,15725,2158181,273783204,0,596,49943,499,38299,97,11644,141,1,217,9,0,32,130000.0,39000.0,-70.0,-70.0,-67.0,-60.0,-70.0,-71.0,-67.0,-62.0,-75.0,-82.0,-75.0,-82.0,5.0,12.0,8.0,22.0,1
3009,CC:2F:71:3F:1F:24,2585189,836536010,427008,562752806,2158181,273783204,9,320962,400558247,320796,400535785,166,22462,313712,566,427066,40408,9,4225,86667.0,14444.0,-69.0,-61.0,-70.0,-68.0,-68.0,-61.0,-70.0,-68.0,-75.0,-82.0,-75.0,-82.0,6.0,21.0,5.0,14.0,1
3010,F8:59:71:5A:E0:3D,2333802,541944461,175618,268160993,2158184,273783468,354,128056,180240474,127936,180223197,120,17277,127162,43,175624,10179,354,460,144444.0,43333.0,-64.0,-71.0,-64.0,-69.0,-64.0,-70.0,-64.0,-69.0,-75.0,-82.0,-75.0,-82.0,11.0,11.0,11.0,13.0,1
3011,CC:2F:71:3E:C5:1F,2158315,273799193,131,15725,2158184,273783468,0,597,50013,500,38369,97,11644,141,1,217,9,0,32,130000.0,39000.0,-71.0,-70.0,-66.0,-60.0,-70.0,-71.0,-67.0,-62.0,-75.0,-82.0,-75.0,-82.0,4.0,12.0,9.0,22.0,1
3012,CC:2F:71:3F:1F:24,2585362,836744021,427174,562960149,2158188,273783872,9,321111,400758749,320944,400736169,167,22580,313861,566,427232,40408,9,4225,86667.0,14444.0,-68.0,-61.0,-70.0,-68.0,-68.0,-61.0,-69.0,-68.0,-75.0,-82.0,-75.0,-82.0,7.0,21.0,5.0,14.0,1
3013,F8:59:71:5A:E0:3D,2333871,542042969,175681,268258895,2158190,273784074,354,128119,180337494,127999,180320217,120,17277,127225,43,175687,10179,354,460,144444.0,43333.0,-65.0,-71.0,-64.0,-70.0,-64.0,-69.0,-64.0,-69.0,-75.0,-82.0,-75.0,-82.0,10.0,11.0,11.0,12.0,1
3014,CC:2F:71:3E:C5:1F,2158321,273799799,131,15725,2158190,273784074,0,597,50013,500,38369,97,11644,141,1,217,9,0,32,130000.0,39000.0,-71.0,-70.0,-66.0,-60.0,-70.0,-71.0,-67.0,-62.0,-75.0,-82.0,-75.0,-82.0,4.0,12.0,9.0,22.0,1
3015,CC:2F:71:3F:1F:24,2585520,836949615,427330,563165541,2158190,273784074,9,321258,400956381,321091,400933801,167,22580,314008,566,427388,40424,9,4226,115556.0,28889.0,-68.0,-61.0,-70.0,-69.0,-68.0,-61.0,-69.0,-69.0,-75.0,-82.0,-75.0,-82.0,7.0,21.0,5.0,13.0,1
3016,F8:59:71:5A:E0:3D,2333939,542144241,175746,268359905,2158193,273784336,354,128184,180437594,128064,180420317,120,17277,127290,43,175752,10179,354,460,144444.0,43333.0,-64.0,-70.0,-65.0,-68.0,-64.0,-70.0,-64.0,-68.0,-75.0,-82.0,-75.0,-82.0,11.0,12.0,10.0,14.0,1
3017,CC:2F:71:3E:C5:1F,2158324,273800061,131,15725,2158193,273784336,0,597,50013,500,38369,97,11644,141,1,217,9,0,32,130000.0,39000.0,-71.0,-70.0,-66.0,-60.0,-70.0,-71.0,-67.0,-62.0,-75.0,-82.0,-75.0,-82.0,4.0,12.0,9.0,22.0,1
3018,CC:2F:71:3F:1F:24,2585682,837157531,427489,563373195,2158193,273784336,9,321403,401156545,321236,401133965,167,22580,314153,566,427545,40431,9,4226,115556.0,28889.0,-68.0,-61.0,-70.0,-68.0,-67.0,-61.0,-69.0,-67.0,-75.0,-82.0,-75.0,-82.0,7.0,21.0,5.0,14.0,1
3019,F8:59:71:5A:E0:3D,2334015,542245346,175818,268460606,2158197,273784740,354,128255,180539652,128135,180522375,120,17277,127361,43,175824,10180,354,460,144444.0,43333.0,-64.0,-72.0,-64.0,-69.0,-63.0,-70.0,-64.0,-69.0,-75.0,-82.0,-75.0,-82.0,11.0,10.0,11.0,13.0,1
3020,CC:2F:71:3E:C5:1F,2158328,273800465,131,15725,2158197,273784740,0,597,50013,500,38369,97,11644,141,1,217,9,0,32,130000.0,39000.0,-71.0,-70.0,-66.0,-60.0,-70.0,-71.0,-67.0,-62.0,-75.0,-82.0,-75.0,-82.0,4.0,12.0,9.0,22.0,1
3021,CC:2F:71:3F:1F:24,2585853,837372549,427654,563587607,2158199,273784942,9,321555,401360371,321388,401337791,167,22580,314305,566,427712,40431,9,4226,115556.0,28889.0,-68.0,-62.0,-69.0,-68.0,-67.0,-61.0,-69.0,-68.0,-75.0,-82.0,-75.0,-82.0,7.0,20.0,6.0,14.0,1
3022,F8:59:71:5A:E0:3D,2334205,542532730,176004,268747586,2158201,273785144,354,128339,180648310,128219,180631033,120,17277,127444,43,176010,10180,354,460,144444.0,43333.0,-65.0,-71.0,-64.0,-70.0,-64.0,-69.0,-64.0,-69.0,-75.0,-82.0,-75.0,-82.0,10.0,11.0,11.0,12.0,1
3023,CC:2F:71:3E:C5:1F,2158332,273800869,131,15725,2158201,273785144,0,597,50013,500,38369,97,11644,141,1,217,9,0,32,130000.0,39000.0,-71.0,-70.0,-66.0,-60.0,-70.0,-71.0,-67.0,-62.0,-75.0,-82.0,-75.0,-82.0,4.0,12.0,9.0,22.0,1
3024,CC:2F:71:3F:1F:24,2586074,837657010,427868,563871402,2158206,273785608,9,321746,401617938,321579,401595358,167,22580,314496,566,427926,40446,9,4245,115556.0,28889.0,-67.0,-62.0,-69.0,-69.0,-67.0,-61.0,-69.0,-68.0,-75.0,-82.0,-75.0,-82.0,8.0,20.0,6.0,13.0,1
3025,F8:59:71:5A:E0:3D,2334297,542665486,176089,268879676,2158208,273785810,354,128424,180779210,128304,180761933,120,17277,127529,43,176095,10180,354,460,144444.0,43333.0,-65.0,-71.0,-64.0,-69.0,-64.0,-69.0,-64.0,-69.0,-75.0,-82.0,-75.0,-82.0,10.0,11.0,11.0,13.0,1
3026,CC:2F:71:3E:C5:1F,2158339,273801535,131,15725,2158208,273785810,0,597,50013,500,38369,97,11644,141,1,217,9,0,32,130000.0,39000.0,-71.0,-70.0,-66.0,-60.0,-70.0,-71.0,-67.0,-62.0,-75.0,-82.0,-75.0,-82.0,4.0,12.0,9.0,22.0,1
3027,CC:2F:71:3F:1F:24,2586236,837866588,428028,564080778,2158208,273785810,9,321905,401835404,321738,401812824,167,22580,314654,566,428086,40446,9,4245,115556.0,28889.0,-67.0,-61.0,-70.0,-69.0,-67.0,-61.0,-69.0,-69.0,-75.0,-82.0,-75.0,-82.0,8.0,21.0,5.0,13.0,1
3028,F8:59:71:5A:E0:3D,2334377,542775718,176167,268989706,2158210,273786012,354,128502,180890905,128382,180873628,120,17277,127607,43,176173,10180,354,460,144444.0,43333.0,-65.0,-71.0,-65.0,-69.0,-64.0,-68.0,-64.0,-69.0,-75.0,-82.0,-75.0,-82.0,10.0,11.0,10.0,13.0,1
3029,CC:2F:71:3E:C5:1F,2158341,273801737,131,15725,2158210,273786012,0,597,50013,500,38369,97,11644,141,1,217,9,0,32,130000.0,39000.0,-71.0,-70.0,-66.0,-60.0,-70.0,-71.0,-67.0,-62.0,-75.0,-82.0,-75.0,-82.0,4.0,12.0,9.0,22.0,1
3030,CC:2F:71:3F:1F:24,2586427,838094112,428213,564307696,2158214,273786416,9,322077,402054243,321910,402031663,167,22580,314826,566,428271,40453,9,4249,130000.0,39000.0,-67.0,-62.0,-69.0,-69.0,-67.0,-61.0,-70.0,-68.0,-75.0,-82.0,-75.0,-82.0,8.0,20.0,6.0,13.0,1
3031,F8:59:71:5A:E0:3D,2334454,542875476,176236,269088525,2158218,273786951,354,128568,180989059,128448,180971782,120,17277,127673,43,176242,10180,354,460,144444.0,43333.0,-64.0,-71.0,-64.0,-69.0,-64.0,-70.0,-64.0,-69.0,-75.0,-82.0,-75.0,-82.0,11.0,11.0,11.0,13.0,1
3032,CC:2F:71:3E:C5:1F,2158349,273802676,131,15725,2158218,273786951,0,597,50013,500,38369,97,11644,141,1,217,9,0,32,130000.0,39000.0,-71.0,-70.0,-66.0,-60.0,-70.0,-71.0,-67.0,-62.0,-75.0,-82.0,-75.0,-82.0,4.0,12.0,9.0,22.0,1
3033,CC:2F:71:3F:1F:24,2586589,838300752,428371,564513801,2158218,273786951,9,322224,402253234,322057,402230654,167,22580,314972,566,428429,40464,9,4249,130000.0,43333.0,-68.0,-61.0,-70.0,-70.0,-68.0,-61.0,-70.0,-69.0,-75.0,-82.0,-75.0,-82.0,7.0,21.0,5.0,12.0,1
3034,F8:59:71:5A:E0:3D,2334518,542972026,176298,269184873,2158220,273787153,354,128631,181086079,128511,181068802,120,17277,127736,43,176304,10180,354,460,144444.0,43333.0,-64.0,-70.0,-64.0,-69.0,-64.0,-69.0,-64.0,-69.0,-75.0,-82.0,-75.0,-82.0,11.0,12.0,11.0,13.0,1
3035,CC:2F:71:3E:C5:1F,2158351,273802878,131,15725,2158220,273787153,0,597,50013,500,38369,97,11644,141,1,217,9,0,32,130000.0,39000.0,-71.0,-70.0,-66.0,-60.0,-70.0,-71.0,-67.0,-62.0,-75.0,-82.0,-75.0,-82.0,4.0,12.0,9.0,22.0,1
3036,CC:2F:71:3F:1F:24,2586761,838513350,428541,564726197,2158220,273787153,9,322387,402461854,322220,402439274,167,22580,315133,566,428598,40465,9,4249,130000.0,43333.0,-69.0,-62.0,-70.0,-70.0,-68.0,-61.0,-70.0,-69.0,-75.0,-82.0,-75.0,-82.0,6.0,20.0,5.0,12.0,1
3037,F8:59:71:5A:E0:3D,2334591,543079656,176367,269292099,2158224,273787557,354,128699,181190799,128579,181173522,120,17277,127804,43,176373,10180,354,460,144444.0,43333.0,-64.0,-71.0,-64.0,-69.0,-64.0,-70.0,-64.0,-69.0,-75.0,-82.0,-75.0,-82.0,11.0,11.0,11.0,13.0,1
3038,CC:2F:71:3E:C5:1F,2158357,273803484,131,15725,2158226,273787759,0,597,50013,500,38369,97,11644,141,1,217,9,0,32,130000.0,39000.0,-71.0,-70.0,-66.0,-60.0,-70.0,-71.0,-67.0,-62.0,-75.0,-82.0,-75.0,-82.0,4.0,12.0,9.0,22.0,1
3039,CC:2F:71:3F:1F:24,2586962,838762349,428736,564974590,2158226,273787759,9,322570,402704202,322403,402681622,167,22580,315316,566,428794,40474,9,4254,117000.0,39000.0,-68.0,-61.0,-70.0,-70.0,-67.0,-61.0,-69.0,-69.0,-75.0,-82.0,-75.0,-82.0,7.0,21.0,5.0,12.0,1
3040,F8:59:71:5A:E0:3D,2334669,543193562,176440,269405541,2158229,273788021,354,128769,181298641,128649,181281364,120,17277,127874,43,176446,10180,354,460,144444.0,43333.0,-64.0,-72.0,-65.0,-70.0,-64.0,-71.0,-64.0,-69.0,-75.0,-82.0,-75.0,-83.0,11.0,10.0,10.0,13.0,1
3041,CC:2F:71:3E:C5:1F,2158362,273803948,131,15725,2158231,273788223,0,597,50013,500,38369,97,11644,141,1,217,9,0,32,130000.0,39000.0,-71.0,-70.0,-66.0,-60.0,-70.0,-71.0,-67.0,-62.0,-75.0,-82.0,-75.0,-83.0,4.0,12.0,9.0,23.0,1
3042,CC:2F:71:3F:1F:24,2587184,839050954,428951,565262529,2158233,273788425,9,322771,402983599,322604,402961019,167,22580,315516,566,429009,40481,9,4254,130000.0,43333.0,-68.0,-61.0,-70.0,-69.0,-67.0,-61.0,-69.0,-68.0,-75.0,-82.0,-75.0,-83.0,7.0,21.0,5.0,14.0,1
3043,F8:59:71:5A:E0:3D,2334948,543617046,176713,269828419,2158235,273788627,354,128909,181450515,128789,181433238,120,17277,128014,43,176719,10182,354,460,130000.0,39000.0,-65.0,-71.0,-65.0,-69.0,-64.0,-70.0,-64.0,-69.0,-75.0,-82.0,-75.0,-83.0,10.0,11.0,10.0,14.0,1
3044,CC:2F:71:3E:C5:1F,2158366,273804352,131,15725,2158235,273788627,0,597,50013,500,38369,97,11644,141,1,217,9,0,32,130000.0,39000.0,-71.0,-70.0,-66.0,-60.0,-70.0,-71.0,-67.0,-62.0,-75.0,-82.0,-75.0,-83.0,4.0,12.0,9.0,23.0,1
3045,CC:2F:71:3F:1F:24,2587346,839261620,429111,565472993,2158235,273788627,9,322911,403177487,322744,403154907,167,22580,315656,566,429169,40518,9,4254,117000.0,39000.0,-68.0,-62.0,-69.0,-68.0,-67.0,-61.0,-69.0,-68.0,-75.0,-82.0,-75.0,-83.0,7.0,20.0,6.0,15.0,1
3046,F8:59:71:5A:E0:3D,2335022,543716219,176782,269927128,2158240,273789091,354,128976,181549167,128856,181531890,120,17277,128081,43,176788,10183,354,460,144444.0,43333.0,-65.0,-67.0,-63.0,-69.0,-66.0,-70.0,-65.0,-69.0,-75.0,-82.0,-75.0,-83.0,10.0,15.0,12.0,14.0,1
3047,CC:2F:71:3E:C5:1F,2158373,273805018,131,15725,2158242,273789293,0,597,50013,500,38369,97,11644,141,1,217,9,0,32,130000.0,39000.0,-71.0,-70.0,-66.0,-60.0,-70.0,-71.0,-67.0,-62.0,-75.0,-82.0,-75.0,-83.0,4.0,12.0,9.0,23.0,1
3048,CC:2F:71:3F:1F:24,2587515,839475746,429273,565686453,2158242,273789293,9,323070,403399239,322903,403376659,167,22580,315813,566,429331,40544,9,4254,117000.0,39000.0,-68.0,-61.0,-71.0,-68.0,-68.0,-61.0,-70.0,-68.0,-75.0,-82.0,-75.0,-83.0,7.0,21.0,4.0,15.0,1
3049,F8:59:71:5A:E0:3D,2335244,544047903,177000,270258408,2158244,273789495,354,129081,181669133,128961,181651856,120,17277,128186,43,177006,10202,354,460,144444.0,43333.0,-65.0,-71.0,-64.0,-69.0,-64.0,-69.0,-64.0,-68.0,-75.0,-82.0,-75.0,-83.0,10.0,11.0,11.0,14.0,1
3050,CC:2F:71:3E:C5:1F,2158375,273805220,131,15725,2158244,273789495,0,597,50013,500,38369,97,11644,141,1,217,9,0,32,130000.0,39000.0,-71.0,-70.0,-66.0,-60.0,-70.0,-71.0,-67.0,-62.0,-75.0,-82.0,-75.0,-83.0,4.0,12.0,9.0,23.0,1
3051,CC:2F:71:3F:1F:24,2587686,839700566,429442,565911071,2158244,273789495,9,323216,403602521,323049,403579941,167,22580,315959,566,429500,40544,9,4256,130000.0,43333.0,-69.0,-61.0,-70.0,-67.0,-68.0,-61.0,-69.0,-67.0,-75.0,-82.0,-75.0,-83.0,6.0,21.0,5.0,16.0,1
3052,F8:59:71:5A:E0:3D,2335308,544144453,177062,270354756,2158246,273789697,354,129144,181766153,129024,181748876,120,17277,128249,43,177068,10203,354,460,144444.0,43333.0,-65.0,-72.0,-64.0,-69.0,-64.0,-70.0,-64.0,-68.0,-75.0,-82.0,-75.0,-83.0,10.0,10.0,11.0,14.0,1
3053,CC:2F:71:3E:C5:1F,2158379,273805624,131,15725,2158248,273789899,0,597,50013,500,38369,97,11644,141,1,217,9,0,32,130000.0,39000.0,-71.0,-70.0,-66.0,-60.0,-70.0,-71.0,-67.0,-62.0,-75.0,-82.0,-75.0,-83.0,4.0,12.0,9.0,23.0,1
3054,CC:2F:71:3F:1F:24,2587852,839912000,429604,566122101,2158248,273789899,9,323363,403804363,323196,403781783,167,22580,316105,566,429661,40547,9,4256,144444.0,43333.0,-69.0,-61.0,-70.0,-68.0,-68.0,-61.0,-70.0,-68.0,-75.0,-82.0,-75.0,-83.0,6.0,21.0,5.0,15.0,1
3055,F8:59:71:5A:E0:3D,2335392,544260576,177139,270470213,2158253,273790363,354,129222,181882445,129102,181865168,120,17277,128326,43,177145,10203,354,460,144444.0,43333.0,-65.0,-71.0,-64.0,-70.0,-64.0,-69.0,-64.0,-68.0,-75.0,-82.0,-75.0,-83.0,10.0,11.0,11.0,13.0,1
3056,CC:2F:71:3E:C5:1F,2158384,273806088,131,15725,2158253,273790363,0,597,50013,500,38369,97,11644,141,1,217,9,0,32,130000.0,39000.0,-71.0,-70.0,-66.0,-60.0,-70.0,-71.0,-67.0,-62.0,-75.0,-82.0,-75.0,-83.0,4.0,12.0,9.0,23.0,1
3057,CC:2F:71:3F:1F:24,2588044,840156463,429791,566366100,2158253,273790363,9,323540,404040238,323373,404017658,167,22580,316282,566,429849,40556,9,4260,130000.0,43333.0,-68.0,-61.0,-70.0,-67.0,-68.0,-61.0,-70.0,-67.0,-75.0,-82.0,-75.0,-83.0,7.0,21.0,5.0,16.0,1
3058,F8:59:71:5A:E0:3D,2335427,544298301,177172,270507736,2158255,273790565,354,129257,181921618,129137,181904341,120,17277,128360,43,177178,10203,354,460,144444.0,43333.0,-66.0,-68.0,-65.0,-70.0,-65.0,-71.0,-65.0,-69.0,-75.0,-82.0,-75.0,-83.0,9.0,14.0,10.0,13.0,1
3059,CC:2F:71:3E:C5:1F,2158388,273806492,131,15725,2158257,273790767,0,597,50013,500,38369,97,11644,141,1,217,9,0,32,130000.0,39000.0,-71.0,-70.0,-66.0,-60.0,-70.0,-71.0,-67.0,-62.0,-75.0,-82.0,-75.0,-83.0,4.0,12.0,9.0,23.0,1
3060,CC:2F:71:3F:1F:24,2588157,840277532,429900,566486765,2158257,273790767,9,323636,404151115,323469,404128535,167,22580,316378,566,429958,40556,9,4260,130000.0,43333.0,-69.0,-61.0,-71.0,-67.0,-68.0,-61.0,-70.0,-67.0,-75.0,-82.0,-75.0,-83.0,6.0,21.0,4.0,16.0,1
3061,F8:59:71:5A:E0:3D,2335431,544298705,177172,270507736,2158259,273790969,354,129258,181921688,129138,181904411,120,17277,128360,43,177178,10203,354,460,144444.0,43333.0,-66.0,-72.0,-65.0,-70.0,-65.0,-71.0,-65.0,-69.0,-75.0,-82.0,-75.0,-83.0,9.0,10.0,10.0,13.0,1
3062,CC:2F:71:3E:C5:1F,2158392,273806896,131,15725,2158261,273791171,0,597,50013,500,38369,97,11644,141,1,217,9,0,32,130000.0,39000.0,-71.0,-70.0,-66.0,-60.0,-70.0,-71.0,-67.0,-62.0,-75.0,-82.0,-75.0,-83.0,4.0,12.0,9.0,23.0,1
3063,CC:2F:71:3F:1F:24,2588256,840384472,429994,566593241,2158262,273791231,9,323716,404249755,323549,404227175,167,22580,316458,566,430052,40576,9,4260,130000.0,43333.0,-69.0,-61.0,-70.0,-68.0,-68.0,-61.0,-70.0,-67.0,-75.0,-82.0,-75.0,-83.0,6.0,21.0,5.0,15.0,1
3064,F8:59:71:5A:E0:3D,2335437,544299295,177172,270507736,2158265,273791559,354,129258,181921688,129138,181904411,120,17277,128360,43,177178,10203,354,460,144444.0,43333.0,-66.0,-72.0,-65.0,-70.0,-65.0,-71.0,-65.0,-69.0,-75.0,-82.0,-75.0,-83.0,9.0,10.0,10.0,13.0,1
3065,CC:2F:71:3E:C5:1F,2158396,273807284,131,15725,2158265,273791559,0,597,50013,500,38369,97,11644,141,1,217,9,0,32,130000.0,39000.0,-71.0,-70.0,-66.0,-60.0,-70.0,-71.0,-67.0,-62.0,-75.0,-82.0,-75.0,-83.0,4.0,12.0,9.0,23.0,1
3066,CC:2F:71:3F:1F:24,2588358,840492318,430093,566700759,2158265,273791559,9,323798,404348764,323631,404326184,167,22580,316540,566,430151,40576,9,4260,130000.0,43333.0,-69.0,-61.0,-70.0,-67.0,-68.0,-61.0,-70.0,-67.0,-75.0,-82.0,-75.0,-83.0,6.0,21.0,5.0,16.0,1
3067,F8:59:71:5A:E0:3D,2335442,544299815,177173,270507852,2158269,273791963,354,129260,181921828,129140,181904551,120,17277,128360,43,177179,10203,354,460,144444.0,43333.0,-66.0,-71.0,-64.0,-70.0,-66.0,-71.0,-65.0,-70.0,-75.0,-82.0,-75.0,-83.0,9.0,11.0,11.0,13.0,1
3068,CC:2F:71:3E:C5:1F,2158401,273807804,132,15841,2158269,273791963,0,600,50223,503,38579,97,11644,141,1,218,9,0,32,144444.0,39000.0,-69.0,-70.0,-65.0,-60.0,-70.0,-71.0,-67.0,-62.0,-75.0,-82.0,-75.0,-83.0,6.0,12.0,10.0,23.0,1
3069,CC:2F:71:3F:1F:24,2588479,840607316,430210,566815353,2158269,273791963,9,323895,404450674,323728,404428094,167,22580,316637,566,430268,40576,9,4260,130000.0,43333.0,-69.0,-61.0,-70.0,-67.0,-68.0,-61.0,-70.0,-67.0,-75.0,-82.0,-75.0,-83.0,6.0,21.0,5.0,16.0,1
3070,F8:59:71:5A:E0:3D,2335446,544300219,177173,270507852,2158273,273792367,354,129260,181921828,129140,181904551,120,17277,128360,43,177179,10203,354,460,144444.0,43333.0,-66.0,-71.0,-64.0,-70.0,-66.0,-71.0,-65.0,-70.0,-75.0,-82.0,-75.0,-83.0,9.0,11.0,11.0,13.0,1
3071,CC:2F:71:3E:C5:1F,2158406,273808481,132,15841,2158274,273792640,0,600,50223,503,38579,97,11644,141,1,218,9,0,32,144444.0,39000.0,-69.0,-70.0,-65.0,-60.0,-70.0,-71.0,-67.0,-62.0,-75.0,-82.0,-75.0,-83.0,6.0,12.0,10.0,23.0,1
3072,CC:2F:71:3F:1F:24,2588589,840722606,430314,566929906,2158275,273792700,9,323985,404555238,323818,404532658,167,22580,316727,566,430372,40580,9,4260,130000.0,43333.0,-69.0,-61.0,-70.0,-67.0,-68.0,-61.0,-69.0,-67.0,-75.0,-82.0,-75.0,-83.0,6.0,21.0,5.0,16.0,1
3073,F8:59:71:5A:E0:3D,2335452,544300956,177173,270507852,2158279,273793104,354,129260,181921828,129140,181904551,120,17277,128360,43,177179,10203,354,460,144444.0,43333.0,-66.0,-71.0,-64.0,-70.0,-66.0,-71.0,-65.0,-70.0,-75.0,-82.0,-75.0,-83.0,9.0,11.0,11.0,13.0,1
3074,CC:2F:71:3E:C5:1F,2158411,273808945,132,15841,2158279,273793104,0,600,50223,503,38579,97,11644,141,1,218,9,0,32,144444.0,39000.0,-69.0,-70.0,-65.0,-60.0,-70.0,-71.0,-67.0,-62.0,-75.0,-82.0,-75.0,-83.0,6.0,12.0,10.0,23.0,1
3075,CC:2F:71:3F:1F:24,2588687,840829822,430408,567036718,2158279,273793104,9,324065,404653878,323898,404631298,167,22580,316807,566,430466,40580,9,4260,130000.0,43333.0,-68.0,-61.0,-70.0,-67.0,-68.0,-61.0,-70.0,-67.0,-75.0,-82.0,-75.0,-83.0,7.0,21.0,5.0,16.0,1
3076,F8:59:71:5A:E0:3D,2335455,544301220,177173,270507852,2158282,273793368,354,129262,181922016,129141,181904621,121,17395,128361,43,177179,10203,354,461,144444.0,43333.0,-66.0,-72.0,-65.0,-70.0,-65.0,-70.0,-64.0,-69.0,-75.0,-82.0,-75.0,-83.0,9.0,10.0,10.0,13.0,1
3077,CC:2F:71:3E:C5:1F,2158416,273809411,132,15841,2158284,273793570,0,600,50223,503,38579,97,11644,141,1,218,9,0,32,144444.0,39000.0,-69.0,-70.0,-65.0,-60.0,-70.0,-71.0,-67.0,-62.0,-75.0,-82.0,-75.0,-83.0,6.0,12.0,10.0,23.0,1
3078,CC:2F:71:3F:1F:24,2588785,840936858,430501,567143288,2158284,273793570,9,324146,404754072,323979,404731492,167,22580,316887,566,430559,40586,9,4260,117000.0,39000.0,-69.0,-61.0,-70.0,-67.0,-68.0,-61.0,-70.0,-67.0,-75.0,-82.0,-75.0,-83.0,6.0,21.0,5.0,16.0,1
3079,F8:59:71:5A:E0:3D,2335473,544307310,177173,270507852,2158300,273799458,354,129262,181922016,129141,181904621,121,17395,128361,43,177179,10203,354,461,144444.0,43333.0,-66.0,-72.0,-65.0,-70.0,-65.0,-70.0,-64.0,-69.0,-75.0,-82.0,-75.0,-83.0,9.0,10.0,10.0,13.0,1
3080,CC:2F:71:3E:C5:1F,2158432,273815299,132,15841,2158300,273799458,0,600,50223,503,38579,97,11644,141,1,218,9,0,32,144444.0,39000.0,-69.0,-70.0,-65.0,-60.0,-70.0,-71.0,-67.0,-62.0,-75.0,-82.0,-75.0,-83.0,6.0,12.0,10.0,23.0,1
3081,CC:2F:71:3F:1F:24,2588910,841062510,430599,567257628,2158311,273804882,9,324229,404860180,324062,404837600,167,22580,316970,566,430657,40586,9,4260,130000.0,43333.0,-69.0,-61.0,-70.0,-67.0,-68.0,-61.0,-70.0,-67.0,-75.0,-82.0,-75.0,-83.0,6.0,21.0,5.0,16.0,1
3082,F8:59:71:5A:E0:3D,2335486,544312936,177173,270507852,2158313,273805084,354,129262,181922016,129141,181904621,121,17395,128361,43,177179,10203,354,461,144444.0,43333.0,-66.0,-72.0,-65.0,-70.0,-65.0,-70.0,-64.0,-69.0,-75.0,-82.0,-75.0,-83.0,9.0,10.0,10.0,13.0,1
3083,CC:2F:71:3E:C5:1F,2158446,273820987,132,15841,2158314,273805146,0,600,50223,503,38579,97,11644,141,1,218,9,0,32,144444.0,39000.0,-69.0,-70.0,-65.0,-60.0,-70.0,-71.0,-67.0,-62.0,-75.0,-82.0,-75.0,-83.0,6.0,12.0,10.0,23.0,1
3084,CC:2F:71:3F:1F:24,2589009,841171212,430693,567365864,2158316,273805348,9,324311,404960478,324143,404937780,168,22698,317052,566,430751,40587,9,4260,130000.0,43333.0,-66.0,-62.0,-71.0,-68.0,-66.0,-62.0,-70.0,-68.0,-75.0,-82.0,-75.0,-83.0,9.0,20.0,4.0,15.0,1
3085,F8:59:71:5A:E0:3D,2335779,544760642,177461,270955092,2158318,273805550,354,129317,181935196,129196,181917801,121,17395,128414,43,177467,10245,354,461,144444.0,43333.0,-66.0,-72.0,-65.0,-69.0,-65.0,-70.0,-65.0,-69.0,-75.0,-82.0,-75.0,-83.0,9.0,10.0,10.0,14.0,1
3086,CC:2F:71:3E:C5:1F,2158452,273821593,132,15841,2158320,273805752,0,600,50223,503,38579,97,11644,141,1,218,9,0,32,144444.0,39000.0,-69.0,-70.0,-65.0,-60.0,-70.0,-71.0,-67.0,-62.0,-75.0,-82.0,-75.0,-83.0,6.0,12.0,10.0,23.0,1
3087,CC:2F:71:3F:1F:24,2589094,841247133,430774,567441381,2158320,273805752,9,324375,405027790,324207,405005092,168,22698,317116,566,430832,40592,9,4260,144444.0,39000.0,-67.0,-61.0,-71.0,-70.0,-67.0,-61.0,-70.0,-70.0,-75.0,-82.0,-75.0,-83.0,8.0,21.0,4.0,13.0,1
3088,F8:59:71:5A:E0:3D,2335784,544761106,177461,270955092,2158323,273806014,354,129317,181935196,129196,181917801,121,17395,128414,43,177467,10245,354,461,144444.0,43333.0,-66.0,-72.0,-65.0,-69.0,-65.0,-70.0,-65.0,-69.0,-75.0,-82.0,-75.0,-83.0,9.0,10.0,10.0,14.0,1
3089,CC:2F:71:3E:C5:1F,2158455,273821855,132,15841,2158323,273806014,0,600,50223,503,38579,97,11644,141,1,218,9,0,32,144444.0,39000.0,-69.0,-70.0,-65.0,-60.0,-70.0,-71.0,-67.0,-62.0,-75.0,-82.0,-75.0,-83.0,6.0,12.0,10.0,23.0,1
3090,CC:2F:71:3F:1F:24,2589135,841261088,430812,567455074,2158323,273806014,9,324401,405032277,324233,405009579,168,22698,317140,566,430870,40601,9,4260,130000.0,43333.0,-68.0,-62.0,-71.0,-69.0,-67.0,-61.0,-71.0,-68.0,-75.0,-82.0,-75.0,-83.0,7.0,20.0,4.0,14.0,1
3091,F8:59:71:5A:E0:3D,2335790,544763323,177465,270957107,2158325,273806216,354,129322,181939026,129201,181921631,121,17395,128419,43,177471,10245,354,461,144444.0,43333.0,-65.0,-72.0,-65.0,-70.0,-65.0,-70.0,-65.0,-69.0,-75.0,-82.0,-75.0,-83.0,10.0,10.0,10.0,13.0,1
3092,CC:2F:71:3E:C5:1F,2158457,273822057,132,15841,2158325,273806216,0,600,50223,503,38579,97,11644,141,1,218,9,0,32,144444.0,39000.0,-69.0,-70.0,-65.0,-60.0,-70.0,-71.0,-67.0,-62.0,-75.0,-82.0,-75.0,-83.0,6.0,12.0,10.0,23.0,1
3093,CC:2F:71:3F:1F:24,2589170,841271826,430843,567465408,2158327,273806418,9,324418,405035275,324250,405012577,168,22698,317156,566,430901,40601,9,4260,130000.0,43333.0,-67.0,-61.0,-71.0,-69.0,-67.0,-61.0,-70.0,-68.0,-75.0,-82.0,-75.0,-83.0,8.0,21.0,4.0,14.0,1
3094,F8:59:71:5A:E0:3D,2335798,544765739,177469,270959119,2158329,273806620,354,129329,181943066,129208,181925671,121,17395,128424,43,177475,10245,354,461,144444.0,43333.0,-65.0,-71.0,-65.0,-70.0,-65.0,-70.0,-64.0,-69.0,-75.0,-82.0,-75.0,-83.0,10.0,11.0,10.0,13.0,1
3095,CC:2F:71:3E:C5:1F,2158461,273822461,132,15841,2158329,273806620,0,600,50223,503,38579,97,11644,141,1,218,9,0,32,144444.0,39000.0,-69.0,-70.0,-65.0,-60.0,-70.0,-71.0,-67.0,-62.0,-75.0,-82.0,-75.0,-83.0,6.0,12.0,10.0,23.0,1
3096,CC:2F:71:3F:1F:24,2589206,841282582,430875,567475760,2158331,273806822,9,324436,405038389,324268,405015691,168,22698,317173,566,430933,40605,9,4260,117000.0,39000.0,-67.0,-62.0,-71.0,-69.0,-67.0,-62.0,-71.0,-68.0,-75.0,-82.0,-75.0,-83.0,8.0,20.0,4.0,14.0,1
