sample,station,tx_total_pkts,tx_total_bytes,tx_ucast_pkts,tx_ucast_bytes,tx_mcast_bcast_pkts,tx_mcast_bcast_bytes,tx_failures,rx_data_pkts,rx_data_bytes,rx_ucast_pkts,rx_ucast_bytes,rx_mcast_bcast_pkts,rx_mcast_bcast_bytes,rx_decrypt_succeeds,tx_data_pkts_retried,tx_total_pkts_sent,tx_pkts_retries,tx_pkts_retry_exhausted,rx_total_pkts_retried,rate_last_tx_pkt_min,rate_last_tx_pkt_max,per_antenna_rssi_last_rx_data_frame_1,per_antenna_rssi_last_rx_data_frame_2,per_antenna_rssi_last_rx_data_frame_3,per_antenna_rssi_last_rx_data_frame_4,per_antenna_avg_rssi_rx_data_frames_1,per_antenna_avg_rssi_rx_data_frames_2,per_antenna_avg_rssi_rx_data_frames_3,per_antenna_avg_rssi_rx_data_frames_4,per_antenna_noise_floor_1,per_antenna_noise_floor_2,per_antenna_noise_floor_3,per_antenna_noise_floor_4,sinr_per_antenna_1,sinr_per_antenna_2,sinr_per_antenna_3,sinr_per_antenna_4,attack
1,F8:59:71:5A:E0:3D,3204588,1918500385,1099081,1651110777,2105507,267389608,1,630850,795603471,630447,795551960,403,51511,626398,4,1099110,57596,1,379,115556.0,28889.0,-66.0,-69.0,-61.0,-67.0,-65.0,-69.0,-61.0,-67.0,-83.0,-88.0,-81.0,-86.0,17.0,19.0,20.0,19.0,1
2,CC:2F:71:3F:1F:24,3643021,2276943977,1537508,2009553763,2105513,267390214,484,1280802,1641218216,1280386,1641167932,416,50284,1268102,164,1537097,54524,484,989,13000.0,1000.0,-68.0,-64.0,-66.0,-70.0,-68.0,-63.0,-66.0,-69.0,-83.0,-87.0,-80.0,-85.0,15.0,23.0,14.0,15.0,1
3,CC:2F:71:3E:C5:1F,5503121,4435895358,3397603,4168504514,2105518,267390844,502,92350,7928428,77868,6211912,14482,1716516,21313,205,3404925,869124,502,2900,130000.0,1000.0,-65.0,-70.0,-65.0,-61.0,-69.0,-72.0,-68.0,-61.0,-83.0,-87.0,-80.0,-85.0,18.0,17.0,15.0,24.0,1
4,F8:59:71:5A:E0:3D,3205247,1919398346,1099700,1652004636,2105547,267393710,1,631299,796138816,630895,796087187,404,51629,626771,4,1099723,58509,1,383,104000.0,1000.0,-66.0,-71.0,-63.0,-68.0,-66.0,-70.0,-62.0,-68.0,-83.0,-87.0,-80.0,-85.0,17.0,16.0,17.0,17.0,1
5,CC:2F:71:3F:1F:24,3644140,2278452790,1538582,2011058082,2105558,267394708,484,1282287,1643390617,1281871,1643340333,416,50284,1269571,248,1538174,54665,484,993,5500.0,1000.0,-69.0,-64.0,-66.0,-70.0,-68.0,-63.0,-66.0,-69.0,-83.0,-87.0,-80.0,-85.0,14.0,23.0,14.0,15.0,1
6,CC:2F:71:3E:C5:1F,5503179,4435901091,3397604,4168504574,2105575,267396517,502,92354,7928756,77871,6212122,14483,1716634,21314,205,3404926,869125,502,2900,130000.0,1000.0,-67.0,-72.0,-66.0,-61.0,-66.0,-69.0,-64.0,-60.0,-82.0,-87.0,-80.0,-85.0,15.0,15.0,14.0,24.0,1
7,F8:59:71:5A:E0:3D,3208032,1923338588,1102336,1655921458,2105696,267417130,1,633304,798287224,632899,798235477,405,51747,628531,5,1102365,61232,1,410,57778.0,13000.0,-66.0,-71.0,-62.0,-69.0,-65.0,-69.0,-62.0,-68.0,-82.0,-86.0,-79.0,-84.0,16.0,15.0,17.0,15.0,1
8,CC:2F:71:3F:1F:24,3647271,2282887119,1541572,2015469809,2105699,267417310,484,1283707,1645487558,1283287,1645436826,420,50732,1270903,400,1541168,55034,484,1000,5500.0,1000.0,-69.0,-63.0,-65.0,-67.0,-68.0,-63.0,-65.0,-67.0,-82.0,-86.0,-79.0,-84.0,13.0,23.0,14.0,17.0,1
9,CC:2F:71:3E:C5:1F,5503314,4435922930,3397605,4168504690,2105709,267418240,502,92359,7929154,77875,6212402,14484,1716752,21315,205,3404928,869125,502,2900,130000.0,1000.0,-67.0,-70.0,-64.0,-61.0,-67.0,-69.0,-64.0,-60.0,-82.0,-86.0,-79.0,-84.0,15.0,16.0,15.0,23.0,1
10,F8:59:71:5A:E0:3D,3209533,1925479279,1103753,1658053563,2105780,267425716,1,634669,799954646,634264,799902899,405,51747,629768,5,1103782,62536,1,417,65000.0,1000.0,-66.0,-69.0,-61.0,-68.0,-66.0,-70.0,-61.0,-68.0,-82.0,-86.0,-79.0,-84.0,16.0,17.0,18.0,16.0,1
11,CC:2F:71:3F:1F:24,3650355,2287259855,1544545,2019831271,2105810,267428584,484,1285169,1647655905,1284748,1647605055,421,50850,1272244,601,1544138,55347,484,1002,5500.0,1000.0,-69.0,-62.0,-66.0,-67.0,-68.0,-61.0,-65.0,-66.0,-82.0,-86.0,-79.0,-84.0,13.0,24.0,13.0,17.0,1
12,CC:2F:71:3E:C5:1F,5503425,4435934258,3397606,4168504806,2105819,267429452,502,92361,7929294,77877,6212542,14484,1716752,21315,205,3404929,869125,502,2900,130000.0,1000.0,-68.0,-72.0,-65.0,-61.0,-68.0,-69.0,-65.0,-60.0,-82.0,-86.0,-79.0,-84.0,14.0,14.0,14.0,23.0,1
13,F8:59:71:5A:E0:3D,3211282,1928050266,1105443,1660618741,2105839,267431525,1,635728,801326443,635322,801274578,406,51865,630712,5,1105475,64255,1,419,72222.0,21667.0,-66.0,-70.0,-63.0,-68.0,-66.0,-70.0,-62.0,-68.0,-82.0,-86.0,-79.0,-84.0,16.0,16.0,16.0,16.0,1
14,CC:2F:71:3F:1F:24,3652122,2289700068,1546248,2022265131,2105874,267434937,484,1286773,1650004449,1286352,1649953599,421,50850,1273797,723,1545846,55579,484,1003,5500.0,1000.0,-69.0,-63.0,-67.0,-69.0,-68.0,-63.0,-66.0,-67.0,-82.0,-86.0,-79.0,-84.0,13.0,23.0,12.0,15.0,1
15,CC:2F:71:3E:C5:1F,5503519,4435943856,3397607,4168504866,2105912,267438990,502,92367,7929762,77882,6212892,14485,1716870,21316,205,3404931,869125,502,2901,130000.0,1000.0,-68.0,-71.0,-64.0,-60.0,-68.0,-70.0,-65.0,-60.0,-82.0,-86.0,-79.0,-84.0,14.0,15.0,15.0,24.0,1
16,F8:59:71:5A:E0:3D,3213214,1930736006,1107253,1663292135,2105961,267443871,7,637141,802999397,636734,802947414,407,51983,631998,8,1107289,66289,7,429,72222.0,21667.0,-66.0,-70.0,-63.0,-68.0,-66.0,-70.0,-62.0,-68.0,-81.0,-86.0,-79.0,-84.0,15.0,16.0,16.0,16.0,1
17,CC:2F:71:3F:1F:24,3654663,2293259202,1548684,2025813593,2105979,267445609,484,1288901,1653194823,1288479,1653143855,422,50968,1275853,905,1548283,55879,484,1011,5500.0,1000.0,-69.0,-63.0,-67.0,-68.0,-68.0,-62.0,-66.0,-67.0,-81.0,-86.0,-79.0,-84.0,12.0,23.0,12.0,16.0,1
18,CC:2F:71:3E:C5:1F,5503613,4435953079,3397607,4168504866,2106006,267448213,502,92371,7930090,77885,6213102,14486,1716988,21317,205,3404932,869125,502,2901,130000.0,1000.0,-68.0,-72.0,-67.0,-61.0,-68.0,-71.0,-65.0,-60.0,-81.0,-86.0,-79.0,-84.0,13.0,14.0,12.0,23.0,1
19,F8:59:71:5A:E0:3D,3221453,1942233310,1115202,1674752009,2106251,267481301,36,643461,809798903,643052,809746684,409,52219,637916,11,1115202,73939,36,450,72222.0,21667.0,-66.0,-70.0,-63.0,-68.0,-66.0,-70.0,-63.0,-68.0,-81.0,-85.0,-78.0,-83.0,15.0,15.0,15.0,15.0,1
20,F8:59:71:5A:E0:3D,3324411,2075821672,1205433,1806889931,2118978,268931741,255,675634,822545371,674976,822466082,658,79289,666739,1587,1205502,117910,255,817,144444.0,43333.0,-68.0,-73.0,-64.0,-70.0,-67.0,-72.0,-63.0,-70.0,-76.0,-84.0,-75.0,-80.0,8.0,11.0,11.0,10.0,1
21,CC:2F:71:3F:1F:24,3805707,2485181078,1686729,2216249337,2118978,268931741,2432,1400836,1793054914,1399761,1792933480,1075,121434,1385068,5515,1686464,99024,2432,1452,144444.0,43333.0,-70.0,-63.0,-69.0,-71.0,-69.0,-63.0,-68.0,-71.0,-76.0,-84.0,-75.0,-80.0,6.0,21.0,6.0,9.0,1
22,CC:2F:71:3E:C5:1F,5525508,4450685949,3406530,4181754208,2118978,268931741,502,93135,7992854,78570,6266544,14565,1726310,21494,517,3413906,870544,502,2921,7222.0,1000.0,-71.0,-72.0,-64.0,-61.0,-69.0,-71.0,-66.0,-62.0,-76.0,-84.0,-75.0,-80.0,5.0,12.0,11.0,19.0,1
23,F8:59:71:5A:E0:3D,3324481,2075920553,1205502,1806988752,2118979,268931801,255,675701,822644030,675043,822564741,658,79289,666806,1587,1205571,117911,255,817,144444.0,43333.0,-68.0,-73.0,-64.0,-70.0,-67.0,-72.0,-64.0,-70.0,-76.0,-84.0,-75.0,-80.0,8.0,11.0,11.0,10.0,1
24,CC:2F:71:3F:1F:24,3805866,2485387454,1686887,2216455653,2118979,268931801,2432,1400980,1793252114,1399905,1793130680,1075,121434,1385212,5515,1686622,99031,2432,1452,144444.0,43333.0,-70.0,-63.0,-69.0,-71.0,-70.0,-63.0,-68.0,-71.0,-76.0,-84.0,-75.0,-80.0,6.0,21.0,6.0,9.0,1
25,CC:2F:71:3E:C5:1F,5525509,4450686009,3406530,4181754208,2118979,268931801,502,93135,7992854,78570,6266544,14565,1726310,21494,517,3413906,870544,502,2921,7222.0,1000.0,-71.0,-72.0,-64.0,-61.0,-69.0,-71.0,-66.0,-62.0,-76.0,-84.0,-75.0,-80.0,5.0,12.0,11.0,19.0,1
26,F8:59:71:5A:E0:3D,3324554,2076018193,1205565,1807085216,2118989,268932977,255,675763,822739510,675105,822660221,658,79289,666868,1587,1205634,117911,255,817,144444.0,43333.0,-68.0,-72.0,-64.0,-70.0,-67.0,-72.0,-63.0,-70.0,-76.0,-84.0,-75.0,-80.0,8.0,12.0,11.0,10.0,1
27,CC:2F:71:3F:1F:24,3806047,2485595813,1687058,2216662836,2118989,268932977,2432,1401130,1793451708,1400055,1793330274,1075,121434,1385361,5515,1686793,99053,2432,1453,144444.0,43333.0,-70.0,-63.0,-70.0,-72.0,-69.0,-63.0,-69.0,-71.0,-76.0,-84.0,-74.0,-80.0,6.0,21.0,4.0,8.0,1
28,CC:2F:71:3E:C5:1F,5525520,4450687301,3406531,4181754324,2118989,268932977,502,93135,7992854,78570,6266544,14565,1726310,21494,517,3413907,870544,502,2921,7222.0,1000.0,-71.0,-72.0,-64.0,-61.0,-69.0,-71.0,-66.0,-62.0,-76.0,-84.0,-74.0,-80.0,5.0,12.0,10.0,19.0,1
29,F8:59:71:5A:E0:3D,3324829,2076434860,1205840,1807501883,2118989,268932977,255,675887,822846900,675229,822767611,658,79289,666992,1587,1205909,117912,255,817,144444.0,43333.0,-68.0,-72.0,-64.0,-70.0,-67.0,-72.0,-64.0,-70.0,-76.0,-84.0,-74.0,-80.0,8.0,12.0,10.0,10.0,1
30,CC:2F:71:3F:1F:24,3806205,2485802129,1687216,2216869152,2118989,268932977,2432,1401274,1793650346,1400199,1793528912,1075,121434,1385504,5515,1686951,99079,2432,1453,144444.0,43333.0,-70.0,-63.0,-69.0,-71.0,-69.0,-63.0,-68.0,-71.0,-76.0,-84.0,-74.0,-80.0,6.0,21.0,5.0,9.0,1
31,CC:2F:71:3E:C5:1F,5525520,4450687301,3406531,4181754324,2118989,268932977,502,93135,7992854,78570,6266544,14565,1726310,21494,517,3413907,870544,502,2921,7222.0,1000.0,-71.0,-72.0,-64.0,-61.0,-69.0,-71.0,-66.0,-62.0,-76.0,-84.0,-74.0,-80.0,5.0,12.0,10.0,19.0,1
32,F8:59:71:5A:E0:3D,3324899,2076531936,1205902,1807598231,2118997,268933705,255,675949,822942380,675291,822863091,658,79289,667054,1587,1205971,117912,255,817,144444.0,43333.0,-67.0,-72.0,-65.0,-71.0,-67.0,-72.0,-64.0,-70.0,-76.0,-84.0,-74.0,-80.0,9.0,12.0,9.0,9.0,1
33,CC:2F:71:3F:1F:24,3806368,2486004511,1687371,2217070806,2118997,268933705,2432,1401414,1793844234,1400339,1793722800,1075,121434,1385644,5515,1687106,99095,2432,1453,144444.0,43333.0,-69.0,-64.0,-69.0,-72.0,-69.0,-63.0,-69.0,-71.0,-76.0,-84.0,-74.0,-80.0,7.0,20.0,5.0,8.0,1
34,CC:2F:71:3E:C5:1F,5525530,4450688231,3406531,4181754324,2118999,268933907,502,93136,7992972,78570,6266544,14566,1726428,21495,517,3413907,870544,502,2922,7222.0,1000.0,-75.0,-76.0,-75.0,-71.0,-70.0,-72.0,-68.0,-63.0,-76.0,-84.0,-74.0,-80.0,1.0,8.0,-1.0,9.0,1
35,F8:59:71:5A:E0:3D,3325129,2076886093,1206130,1807952186,2118999,268933907,255,676062,823062764,675404,822983475,658,79289,667166,1587,1206199,117912,255,817,144444.0,43333.0,-69.0,-73.0,-65.0,-71.0,-67.0,-72.0,-64.0,-70.0,-76.0,-84.0,-74.0,-80.0,7.0,11.0,9.0,9.0,1
36,CC:2F:71:3F:1F:24,3807682,2487883082,1688683,2218949175,2118999,268933907,2432,1401656,1794085167,1400581,1793963733,1075,121434,1385886,5515,1688418,99345,2432,1453,144444.0,43333.0,-71.0,-64.0,-70.0,-73.0,-70.0,-64.0,-70.0,-72.0,-76.0,-84.0,-74.0,-80.0,5.0,20.0,4.0,7.0,1
37,CC:2F:71:3E:C5:1F,5525530,4450688231,3406531,4181754324,2118999,268933907,502,93136,7992972,78570,6266544,14566,1726428,21495,517,3413907,870544,502,2922,7222.0,1000.0,-75.0,-76.0,-75.0,-71.0,-70.0,-72.0,-68.0,-63.0,-76.0,-84.0,-74.0,-80.0,1.0,8.0,-1.0,9.0,1
38,F8:59:71:5A:E0:3D,3325204,2076985520,1206199,1808051007,2119005,268934513,255,676130,823162913,675472,823083624,658,79289,667234,1587,1206268,117912,255,817,144444.0,43333.0,-68.0,-73.0,-64.0,-70.0,-67.0,-72.0,-64.0,-69.0,-76.0,-84.0,-74.0,-80.0,8.0,11.0,10.0,10.0,1
39,CC:2F:71:3F:1F:24,3807847,2488091597,1688842,2219157084,2119005,268934513,2432,1401802,1794284076,1400727,1794162642,1075,121434,1386031,5515,1688576,99359,2432,1453,144444.0,43333.0,-71.0,-65.0,-71.0,-73.0,-70.0,-64.0,-70.0,-72.0,-76.0,-84.0,-74.0,-80.0,5.0,19.0,3.0,7.0,1
40,CC:2F:71:3E:C5:1F,5525538,4450689039,3406531,4181754324,2119007,268934715,502,93136,7992972,78570,6266544,14566,1726428,21495,517,3413907,870544,502,2922,7222.0,1000.0,-75.0,-76.0,-75.0,-71.0,-70.0,-72.0,-68.0,-63.0,-76.0,-84.0,-74.0,-80.0,1.0,8.0,-1.0,9.0,1
41,F8:59:71:5A:E0:3D,3325273,2077086854,1206264,1808152017,2119009,268934837,255,676196,823263131,675537,823183724,659,79407,667300,1587,1206333,117913,255,817,144444.0,43333.0,-67.0,-74.0,-63.0,-70.0,-67.0,-74.0,-63.0,-70.0,-76.0,-84.0,-74.0,-80.0,9.0,10.0,11.0,10.0,1
42,CC:2F:71:3F:1F:24,3808012,2488303931,1689003,2219369094,2119009,268934837,2432,1401950,1794488860,1400875,1794367426,1075,121434,1386179,5515,1688738,99446,2432,1453,78000.0,13000.0,-70.0,-65.0,-68.0,-72.0,-70.0,-65.0,-68.0,-71.0,-76.0,-84.0,-74.0,-80.0,6.0,19.0,6.0,8.0,1
43,CC:2F:71:3E:C5:1F,5525540,4450689161,3406531,4181754324,2119009,268934837,502,93136,7992972,78570,6266544,14566,1726428,21495,517,3413907,870544,502,2922,7222.0,1000.0,-75.0,-76.0,-75.0,-71.0,-70.0,-72.0,-68.0,-63.0,-76.0,-84.0,-74.0,-80.0,1.0,8.0,-1.0,9.0,1
44,F8:59:71:5A:E0:3D,3325494,2077418341,1206481,1808483100,2119013,268935241,255,676287,823370082,675628,823290675,659,79407,667391,1587,1206550,117914,255,817,144444.0,43333.0,-67.0,-73.0,-63.0,-69.0,-66.0,-73.0,-63.0,-69.0,-76.0,-84.0,-74.0,-80.0,9.0,11.0,11.0,11.0,1
45,CC:2F:71:3F:1F:24,3808188,2488512752,1689175,2219577511,2119013,268935241,2432,1402102,1794689206,1401027,1794567772,1075,121434,1386330,5515,1688910,99446,2432,1453,86667.0,14444.0,-70.0,-64.0,-68.0,-70.0,-69.0,-64.0,-68.0,-70.0,-76.0,-84.0,-74.0,-80.0,6.0,20.0,6.0,10.0,1
46,CC:2F:71:3E:C5:1F,5525544,4450689565,3406531,4181754324,2119013,268935241,502,93136,7992972,78570,6266544,14566,1726428,21495,517,3413907,870544,502,2922,7222.0,1000.0,-75.0,-76.0,-75.0,-71.0,-70.0,-72.0,-68.0,-63.0,-76.0,-84.0,-74.0,-80.0,1.0,8.0,-1.0,9.0,1
47,F8:59:71:5A:E0:3D,3325563,2077516833,1206544,1808581002,2119019,268935831,255,676350,823467102,675691,823387695,659,79407,667454,1587,1206613,117920,255,817,144444.0,43333.0,-66.0,-73.0,-64.0,-70.0,-66.0,-73.0,-63.0,-69.0,-76.0,-84.0,-74.0,-80.0,10.0,11.0,10.0,10.0,1
48,CC:2F:71:3F:1F:24,3808353,2488720484,1689334,2219784653,2119019,268935831,2432,1402247,1794889398,1401172,1794767964,1075,121434,1386475,5515,1689068,99479,2432,1453,104000.0,26000.0,-70.0,-64.0,-68.0,-71.0,-69.0,-64.0,-67.0,-71.0,-76.0,-84.0,-74.0,-80.0,6.0,20.0,6.0,9.0,1
49,CC:2F:71:3E:C5:1F,5525550,4450690155,3406531,4181754324,2119019,268935831,502,93136,7992972,78570,6266544,14566,1726428,21495,517,3413907,870544,502,2922,7222.0,1000.0,-75.0,-76.0,-75.0,-71.0,-70.0,-72.0,-68.0,-63.0,-76.0,-84.0,-74.0,-80.0,1.0,8.0,-1.0,9.0,1
50,F8:59:71:5A:E0:3D,3325848,2077915352,1206799,1808976432,2119049,268938920,255,676417,823570562,675758,823491155,659,79407,667509,1587,1206870,118722,255,817,39000.0,5500.0,-68.0,-75.0,-64.0,-71.0,-66.0,-73.0,-62.0,-69.0,-76.0,-84.0,-74.0,-80.0,8.0,9.0,10.0,9.0,1
51,CC:2F:71:3F:1F:24,3809941,2490802018,1690866,2221860554,2119075,268941464,2432,1403488,1796317006,1402412,1796195454,1076,121552,1387641,5600,1690605,100032,2432,1454,5500.0,1000.0,-67.0,-64.0,-65.0,-69.0,-67.0,-64.0,-66.0,-69.0,-77.0,-84.0,-75.0,-80.0,10.0,20.0,10.0,11.0,1
52,CC:2F:71:3E:C5:1F,5525615,4450696656,3406531,4181754324,2119084,268942332,502,93136,7992972,78570,6266544,14566,1726428,21495,517,3413908,870544,502,2922,7222.0,1000.0,-75.0,-76.0,-75.0,-71.0,-70.0,-72.0,-68.0,-63.0,-76.0,-84.0,-75.0,-80.0,1.0,8.0,0.0,9.0,1
53,F8:59:71:5A:E0:3D,3326722,2079141852,1207616,1810195323,2119106,268946529,255,676592,823792382,675933,823712975,659,79407,667609,1587,1207680,119416,255,823,58500.0,1000.0,-66.0,-73.0,-63.0,-68.0,-67.0,-73.0,-63.0,-69.0,-77.0,-84.0,-75.0,-81.0,11.0,11.0,12.0,13.0,1
54,CC:2F:71:3F:1F:24,3814086,2496673622,1694947,2227714253,2119139,268959369,2432,1405881,1798887122,1404805,1798765570,1076,121552,1390003,5604,1694684,100630,2432,1455,52000.0,6500.0,-70.0,-65.0,-71.0,-72.0,-68.0,-64.0,-68.0,-71.0,-77.0,-84.0,-75.0,-81.0,7.0,19.0,4.0,9.0,1
55,CC:2F:71:3E:C5:1F,5525680,4450714677,3406532,4181754440,2119148,268960237,502,93136,7992972,78570,6266544,14566,1726428,21495,517,3413909,870544,502,2922,7222.0,1000.0,-75.0,-76.0,-75.0,-71.0,-70.0,-72.0,-68.0,-63.0,-77.0,-84.0,-75.0,-81.0,2.0,8.0,0.0,10.0,1
56,F8:59:71:5A:E0:3D,3327355,2080038994,1208205,1811078555,2119150,268960439,255,676743,823952188,676084,823872781,659,79407,667708,1587,1208279,119847,255,826,78000.0,19500.0,-68.0,-74.0,-65.0,-70.0,-68.0,-74.0,-65.0,-70.0,-77.0,-84.0,-75.0,-80.0,9.0,10.0,10.0,10.0,1
57,CC:2F:71:3F:1F:24,3815009,2497983112,1695859,2229022673,2119150,268960439,2432,1406706,1799964036,1405630,1799842484,1076,121552,1390819,5604,1695599,100674,2432,1457,57778.0,7222.0,-70.0,-65.0,-71.0,-73.0,-69.0,-64.0,-69.0,-71.0,-77.0,-84.0,-75.0,-80.0,7.0,19.0,4.0,7.0,1
58,CC:2F:71:3E:C5:1F,5525682,4450714879,3406532,4181754440,2119150,268960439,502,93136,7992972,78570,6266544,14566,1726428,21495,517,3413909,870544,502,2922,7222.0,1000.0,-75.0,-76.0,-75.0,-71.0,-70.0,-72.0,-68.0,-63.0,-77.0,-84.0,-75.0,-80.0,2.0,8.0,0.0,9.0,1
59,F8:59:71:5A:E0:3D,3327481,2080206614,1208325,1811245647,2119156,268960967,255,676804,824026181,676144,823946656,660,79525,667739,1587,1208399,119961,255,830,57778.0,13000.0,-65.0,-72.0,-63.0,-69.0,-67.0,-74.0,-64.0,-69.0,-77.0,-84.0,-75.0,-80.0,12.0,12.0,12.0,11.0,1
60,CC:2F:71:3F:1F:24,3815148,2498147738,1695989,2229186509,2119159,268961229,2432,1406867,1800188896,1405791,1800067344,1076,121552,1390980,5604,1695728,100733,2432,1457,43333.0,5500.0,-71.0,-65.0,-71.0,-73.0,-68.0,-64.0,-68.0,-71.0,-77.0,-84.0,-75.0,-80.0,6.0,19.0,4.0,7.0,1
61,CC:2F:71:3E:C5:1F,5525691,4450715669,3406532,4181754440,2119159,268961229,502,93137,7993090,78570,6266544,14567,1726546,21496,517,3413909,870544,502,2922,7222.0,1000.0,-71.0,-74.0,-70.0,-61.0,-70.0,-73.0,-68.0,-63.0,-77.0,-84.0,-75.0,-80.0,6.0,10.0,5.0,19.0,1
62,F8:59:71:5A:E0:3D,3327574,2080339621,1208413,1811378190,2119161,268961431,255,676854,824096249,676194,824016724,660,79525,667768,1587,1208487,120051,255,832,58500.0,1000.0,-68.0,-74.0,-64.0,-70.0,-66.0,-73.0,-62.0,-69.0,-77.0,-84.0,-75.0,-80.0,9.0,10.0,11.0,10.0,1
63,CC:2F:71:3F:1F:24,3815273,2498299306,1696112,2229337875,2119161,268961431,2432,1407029,1800412574,1405953,1800291022,1076,121552,1391142,5604,1695852,100740,2432,1457,43333.0,5500.0,-71.0,-65.0,-70.0,-73.0,-68.0,-64.0,-66.0,-70.0,-77.0,-84.0,-75.0,-80.0,6.0,19.0,5.0,7.0,1
64,CC:2F:71:3E:C5:1F,5525693,4450715871,3406532,4181754440,2119161,268961431,502,93137,7993090,78570,6266544,14567,1726546,21496,517,3413909,870544,502,2922,7222.0,1000.0,-71.0,-74.0,-70.0,-61.0,-70.0,-73.0,-68.0,-63.0,-77.0,-84.0,-75.0,-80.0,6.0,10.0,5.0,19.0,1
65,F8:59:71:5A:E0:3D,3327733,2080562294,1208566,1811600257,2119167,268962037,255,676972,824227593,676312,824148068,660,79525,667849,1587,1208637,120202,255,836,43333.0,7222.0,-68.0,-74.0,-64.0,-70.0,-66.0,-72.0,-63.0,-69.0,-77.0,-83.0,-75.0,-80.0,9.0,9.0,11.0,10.0,1
66,CC:2F:71:3F:1F:24,3815476,2498567594,1696309,2229605557,2119167,268962037,2432,1407246,1800721176,1406170,1800599624,1076,121552,1391359,5604,1696038,100793,2432,1457,57778.0,7222.0,-70.0,-65.0,-70.0,-73.0,-68.0,-65.0,-67.0,-71.0,-77.0,-83.0,-75.0,-80.0,7.0,18.0,5.0,7.0,1
67,CC:2F:71:3E:C5:1F,5525702,4450716739,3406532,4181754440,2119170,268962299,502,93137,7993090,78570,6266544,14567,1726546,21496,517,3413909,870544,502,2922,7222.0,1000.0,-71.0,-74.0,-70.0,-61.0,-70.0,-73.0,-68.0,-63.0,-77.0,-83.0,-75.0,-80.0,6.0,9.0,5.0,19.0,1
68,F8:59:71:5A:E0:3D,3328046,2081022783,1208869,1812059816,2119177,268962967,255,677034,824311190,676374,824231665,660,79525,667902,1587,1208943,120414,255,840,52000.0,13000.0,-68.0,-74.0,-64.0,-70.0,-67.0,-73.0,-63.0,-69.0,-77.0,-84.0,-76.0,-81.0,9.0,10.0,12.0,11.0,1
69,CC:2F:71:3F:1F:24,3817128,2500931457,1697949,2231968288,2119179,268963169,2432,1407841,1801250978,1406764,1801129308,1077,121670,1391954,5604,1697689,100965,2432,1458,43333.0,5500.0,-67.0,-65.0,-65.0,-70.0,-67.0,-64.0,-66.0,-70.0,-77.0,-84.0,-76.0,-81.0,10.0,19.0,11.0,11.0,1
70,CC:2F:71:3E:C5:1F,5525711,4450717609,3406532,4181754440,2119179,268963169,502,93137,7993090,78570,6266544,14567,1726546,21496,517,3413909,870544,502,2922,7222.0,1000.0,-71.0,-74.0,-70.0,-61.0,-70.0,-73.0,-68.0,-63.0,-77.0,-84.0,-76.0,-81.0,6.0,10.0,6.0,20.0,1
71,F8:59:71:5A:E0:3D,3328222,2081266870,1209036,1812303035,2119186,268963835,255,677160,824425159,676500,824345634,660,79525,667999,1587,1209112,120542,255,848,43333.0,7222.0,-68.0,-74.0,-64.0,-70.0,-67.0,-73.0,-63.0,-69.0,-77.0,-84.0,-76.0,-81.0,9.0,10.0,12.0,11.0,1
72,CC:2F:71:3F:1F:24,3817298,2501142727,1698112,2232178892,2119186,268963835,2432,1408047,1801540104,1406970,1801418434,1077,121670,1392160,5604,1697852,100979,2432,1461,43333.0,5500.0,-70.0,-65.0,-71.0,-73.0,-68.0,-65.0,-68.0,-71.0,-77.0,-84.0,-76.0,-81.0,7.0,19.0,5.0,8.0,1
73,CC:2F:71:3E:C5:1F,5525718,4450718275,3406532,4181754440,2119186,268963835,502,93137,7993090,78570,6266544,14567,1726546,21496,517,3413909,870544,502,2922,7222.0,1000.0,-71.0,-74.0,-70.0,-61.0,-70.0,-73.0,-68.0,-63.0,-77.0,-84.0,-76.0,-81.0,6.0,10.0,6.0,20.0,1
74,F8:59:71:5A:E0:3D,3328318,2081399817,1209129,1812435507,2119189,268964310,255,677253,824535293,676593,824455768,660,79525,668060,1587,1209205,120600,255,852,43333.0,6500.0,-65.0,-72.0,-63.0,-68.0,-66.0,-73.0,-63.0,-69.0,-77.0,-83.0,-75.0,-80.0,12.0,11.0,12.0,12.0,1
75,CC:2F:71:3F:1F:24,3817476,2501360014,1698287,2232395704,2119189,268964310,2432,1408249,1801804582,1407172,1801682912,1077,121670,1392361,5604,1698026,100981,2432,1461,43333.0,5500.0,-70.0,-65.0,-70.0,-72.0,-68.0,-64.0,-68.0,-70.0,-77.0,-83.0,-75.0,-80.0,7.0,18.0,5.0,8.0,1
76,CC:2F:71:3E:C5:1F,5525723,4450718952,3406532,4181754440,2119191,268964512,502,93137,7993090,78570,6266544,14567,1726546,21496,517,3413909,870544,502,2922,7222.0,1000.0,-71.0,-74.0,-70.0,-61.0,-70.0,-73.0,-68.0,-63.0,-77.0,-83.0,-75.0,-80.0,6.0,9.0,5.0,19.0,1
77,F8:59:71:5A:E0:3D,3328508,2081672326,1209312,1812707350,2119196,268964976,255,677327,824640205,676667,824560680,660,79525,668121,1587,1209388,120749,255,854,52000.0,13000.0,-65.0,-64.0,-64.0,-68.0,-67.0,-72.0,-64.0,-69.0,-77.0,-83.0,-75.0,-80.0,12.0,19.0,11.0,12.0,1
78,CC:2F:71:3F:1F:24,3817638,2501561774,1698442,2232596798,2119196,268964976,2432,1408414,1802034794,1407337,1801913124,1077,121670,1392523,5604,1698182,101007,2432,1462,78000.0,13000.0,-67.0,-65.0,-66.0,-70.0,-68.0,-64.0,-67.0,-70.0,-77.0,-83.0,-75.0,-80.0,10.0,18.0,9.0,10.0,1
79,CC:2F:71:3E:C5:1F,5525728,4450719416,3406532,4181754440,2119196,268964976,502,93137,7993090,78570,6266544,14567,1726546,21496,517,3413909,870544,502,2922,7222.0,1000.0,-71.0,-74.0,-70.0,-61.0,-70.0,-73.0,-68.0,-63.0,-77.0,-83.0,-75.0,-80.0,6.0,9.0,5.0,19.0,1
80,F8:59:71:5A:E0:3D,3328771,2082070103,1209571,1813104557,2119200,268965546,255,677455,824759519,676795,824679994,660,79525,668233,1587,1209647,120976,255,855,57778.0,13000.0,-67.0,-74.0,-64.0,-70.0,-66.0,-73.0,-63.0,-69.0,-77.0,-83.0,-75.0,-80.0,10.0,9.0,11.0,10.0,1
81,CC:2F:71:3F:1F:24,3817828,2501793392,1698628,2232827846,2119200,268965546,2432,1408589,1802265861,1407512,1802144191,1077,121670,1392697,5604,1698367,101126,2432,1462,130000.0,39000.0,-67.0,-65.0,-65.0,-69.0,-67.0,-64.0,-66.0,-69.0,-77.0,-83.0,-75.0,-80.0,10.0,18.0,10.0,11.0,1
82,CC:2F:71:3E:C5:1F,5525734,4450720188,3406532,4181754440,2119202,268965748,502,93137,7993090,78570,6266544,14567,1726546,21496,517,3413910,870544,502,2922,7222.0,1000.0,-71.0,-74.0,-70.0,-61.0,-70.0,-73.0,-68.0,-63.0,-77.0,-83.0,-75.0,-80.0,6.0,9.0,5.0,19.0,1
83,F8:59:71:5A:E0:3D,3329000,2082393123,1209791,1813426709,2119209,268966414,255,677573,824889532,676913,824810007,660,79525,668351,1587,1209869,121247,255,855,52000.0,13000.0,-66.0,-72.0,-63.0,-69.0,-67.0,-73.0,-63.0,-69.0,-76.0,-83.0,-74.0,-79.0,10.0,11.0,11.0,10.0,1
84,CC:2F:71:3F:1F:24,3818032,2502058474,1698823,2233092060,2119209,268966414,2432,1408789,1802541285,1407712,1802419615,1077,121670,1392897,5604,1698562,101302,2432,1463,115556.0,26000.0,-68.0,-65.0,-67.0,-70.0,-68.0,-64.0,-67.0,-71.0,-76.0,-83.0,-74.0,-79.0,8.0,18.0,7.0,9.0,1
85,CC:2F:71:3E:C5:1F,5525741,4450720854,3406532,4181754440,2119209,268966414,502,93137,7993090,78570,6266544,14567,1726546,21496,517,3413910,870544,502,2922,7222.0,1000.0,-71.0,-74.0,-70.0,-61.0,-70.0,-73.0,-68.0,-63.0,-76.0,-83.0,-74.0,-79.0,5.0,9.0,4.0,18.0,1
86,F8:59:71:5A:E0:3D,3329933,2083727390,1210700,1814758626,2119233,268968764,255,678068,825310188,677408,825230663,660,79525,668760,1587,1210751,122084,255,859,28889.0,5500.0,-68.0,-74.0,-65.0,-71.0,-68.0,-74.0,-64.0,-70.0,-75.0,-82.0,-73.0,-79.0,7.0,8.0,8.0,8.0,1
87,CC:2F:71:3F:1F:24,3820331,2505377878,1701094,2236408710,2119237,268969168,2432,1409888,1803977013,1408811,1803855343,1077,121670,1393950,5604,1700834,103236,2432,1468,117000.0,1000.0,-71.0,-65.0,-71.0,-73.0,-68.0,-64.0,-67.0,-70.0,-75.0,-82.0,-73.0,-79.0,4.0,17.0,2.0,6.0,1
88,CC:2F:71:3E:C5:1F,5525776,4450724274,3406532,4181754440,2119244,268969834,502,93137,7993090,78570,6266544,14567,1726546,21496,517,3413910,870544,502,2922,7222.0,1000.0,-71.0,-74.0,-70.0,-61.0,-70.0,-73.0,-68.0,-63.0,-75.0,-82.0,-73.0,-79.0,4.0,8.0,3.0,18.0,1
89,F8:59:71:5A:E0:3D,3330647,2084745526,1211389,1815774147,2119258,268971379,255,678472,825692608,677812,825613083,660,79525,669127,1587,1211452,122931,255,863,39000.0,1000.0,-66.0,-73.0,-63.0,-69.0,-65.0,-73.0,-63.0,-69.0,-75.0,-82.0,-73.0,-78.0,9.0,9.0,10.0,9.0,1
90,CC:2F:71:3F:1F:24,3823662,2510198363,1704398,2241226378,2119264,268971985,2432,1410902,1805166538,1409825,1805044868,1077,121670,1394937,5604,1704136,106368,2432,1470,130000.0,39000.0,-71.0,-65.0,-70.0,-74.0,-70.0,-64.0,-69.0,-73.0,-75.0,-82.0,-73.0,-78.0,4.0,17.0,3.0,4.0,1
91,CC:2F:71:3E:C5:1F,5525797,4450726541,3406533,4181754556,2119264,268971985,502,93137,7993090,78570,6266544,14567,1726546,21496,517,3413911,870545,502,2922,7222.0,1000.0,-71.0,-74.0,-70.0,-61.0,-70.0,-73.0,-68.0,-63.0,-75.0,-82.0,-73.0,-78.0,4.0,8.0,3.0,17.0,1
92,F8:59:71:5A:E0:3D,3331222,2085610706,1211955,1816638459,2119267,268972247,255,678644,825877509,677984,825797984,660,79525,669295,1587,1212033,123465,255,864,39000.0,1000.0,-65.0,-72.0,-62.0,-68.0,-66.0,-73.0,-63.0,-69.0,-75.0,-82.0,-73.0,-78.0,10.0,10.0,11.0,10.0,1
93,CC:2F:71:3F:1F:24,3823882,2510482868,1704611,2241510217,2119271,268972651,2432,1411156,1805528858,1410079,1805407188,1077,121670,1395186,5604,1704351,106596,2432,1472,104000.0,26000.0,-70.0,-65.0,-71.0,-72.0,-68.0,-64.0,-67.0,-70.0,-75.0,-82.0,-73.0,-78.0,5.0,17.0,2.0,6.0,1
94,CC:2F:71:3E:C5:1F,5525806,4450727409,3406533,4181754556,2119273,268972853,502,93137,7993090,78570,6266544,14567,1726546,21496,517,3413911,870545,502,2922,7222.0,1000.0,-71.0,-74.0,-70.0,-61.0,-70.0,-73.0,-68.0,-63.0,-75.0,-82.0,-73.0,-78.0,4.0,8.0,3.0,17.0,1
95,F8:59:71:5A:E0:3D,3331590,2086161071,1212317,1817188218,2119273,268972853,255,678815,825976466,678155,825896941,660,79525,669404,1587,1212396,123882,255,864,39000.0,6500.0,-66.0,-73.0,-62.0,-68.0,-65.0,-72.0,-62.0,-68.0,-75.0,-82.0,-73.0,-78.0,9.0,9.0,11.0,10.0,1
96,CC:2F:71:3F:1F:24,3824040,2510682636,1704765,2241709581,2119275,268973055,2432,1411361,1805820768,1410284,1805699098,1077,121670,1395391,5604,1704504,106744,2432,1472,86667.0,13000.0,-70.0,-65.0,-71.0,-73.0,-69.0,-64.0,-68.0,-71.0,-75.0,-82.0,-73.0,-78.0,5.0,17.0,2.0,5.0,1
97,CC:2F:71:3E:C5:1F,5525808,4450727611,3406533,4181754556,2119275,268973055,502,93137,7993090,78570,6266544,14567,1726546,21496,517,3413911,870545,502,2922,7222.0,1000.0,-71.0,-74.0,-70.0,-61.0,-70.0,-73.0,-68.0,-63.0,-75.0,-82.0,-73.0,-78.0,4.0,8.0,3.0,17.0,1
98,F8:59:71:5A:E0:3D,3331693,2086300269,1212411,1817326548,2119282,268973721,255,678931,826054351,678271,825974826,660,79525,669510,1587,1212481,123984,255,866,57778.0,1000.0,-65.0,-72.0,-63.0,-69.0,-66.0,-73.0,-63.0,-69.0,-75.0,-82.0,-73.0,-78.0,10.0,10.0,10.0,9.0,1
99,CC:2F:71:3F:1F:24,3824254,2510961530,1704970,2241987607,2119284,268973923,2432,1411574,1806126450,1410497,1806004780,1077,121670,1395600,5604,1704709,106966,2432,1472,115556.0,1000.0,-66.0,-65.0,-65.0,-70.0,-67.0,-64.0,-65.0,-70.0,-75.0,-82.0,-73.0,-78.0,9.0,17.0,8.0,8.0,1
100,CC:2F:71:3E:C5:1F,5525824,4450729145,3406533,4181754556,2119291,268974589,502,93137,7993090,78570,6266544,14567,1726546,21496,517,3413911,870545,502,2922,7222.0,1000.0,-71.0,-74.0,-70.0,-61.0,-70.0,-73.0,-68.0,-63.0,-74.0,-81.0,-71.0,-77.0,3.0,7.0,1.0,16.0,1
101,F8:59:71:5A:E0:3D,3332233,2087094641,1212926,1818118516,2119307,268976125,255,679012,826133019,678352,826053494,660,79525,669582,1595,1213005,124717,255,867,5500.0,1000.0,-66.0,-73.0,-63.0,-69.0,-65.0,-72.0,-62.0,-68.0,-74.0,-81.0,-71.0,-77.0,8.0,8.0,8.0,8.0,1
102,CC:2F:71:3F:1F:24,3824727,2511583354,1705418,2242607027,2119309,268976327,2432,1412407,1807345096,1411329,1807223308,1078,121788,1396404,5604,1705153,107512,2432,1474,78000.0,13000.0,-67.0,-65.0,-66.0,-70.0,-67.0,-64.0,-66.0,-70.0,-74.0,-81.0,-71.0,-77.0,7.0,16.0,5.0,7.0,1
103,CC:2F:71:3E:C5:1F,5525843,4450731156,3406533,4181754556,2119310,268976600,502,93138,7993160,78571,6266614,14567,1726546,21496,517,3413911,870545,502,2922,7222.0,1000.0,-68.0,-73.0,-65.0,-61.0,-70.0,-73.0,-68.0,-63.0,-74.0,-81.0,-71.0,-77.0,6.0,8.0,6.0,16.0,1
104,F8:59:71:5A:E0:3D,3332434,2087374049,1213114,1818396519,2119320,268977530,255,679120,826200793,678459,826121150,661,79643,669642,1633,1213193,124767,255,869,5500.0,1000.0,-64.0,-63.0,-60.0,-66.0,-65.0,-71.0,-62.0,-68.0,-74.0,-81.0,-71.0,-77.0,10.0,18.0,11.0,11.0,1
105,CC:2F:71:3F:1F:24,3824907,2511807182,1705587,2242829652,2119320,268977530,2432,1412672,1807725499,1411594,1807603711,1078,121788,1396661,5604,1705326,107580,2432,1474,39000.0,5500.0,-67.0,-65.0,-65.0,-70.0,-66.0,-64.0,-65.0,-69.0,-74.0,-81.0,-71.0,-77.0,7.0,16.0,6.0,7.0,1
106,CC:2F:71:3E:C5:1F,5525854,4450732148,3406533,4181754556,2119321,268977592,502,93139,7993278,78571,6266614,14568,1726664,21497,517,3413911,870545,502,2922,7222.0,1000.0,-68.0,-73.0,-66.0,-61.0,-71.0,-74.0,-69.0,-63.0,-74.0,-81.0,-71.0,-77.0,6.0,8.0,5.0,16.0,1
107,F8:59:71:5A:E0:3D,3332566,2087562631,1213239,1818584433,2119327,268978198,255,679149,826235905,678488,826156262,661,79643,669664,1659,1213318,124822,255,871,5500.0,1000.0,-65.0,-72.0,-62.0,-68.0,-65.0,-72.0,-62.0,-68.0,-72.0,-80.0,-70.0,-75.0,7.0,8.0,8.0,7.0,1
108,CC:2F:71:3F:1F:24,3825106,2512046437,1705777,2243068037,2119329,268978400,2432,1412969,1808140532,1411891,1808018744,1078,121788,1396942,5604,1705517,107634,2432,1490,43333.0,5500.0,-71.0,-65.0,-71.0,-73.0,-67.0,-64.0,-66.0,-70.0,-72.0,-80.0,-70.0,-75.0,1.0,15.0,-1.0,2.0,1
109,CC:2F:71:3E:C5:1F,5525862,4450732956,3406533,4181754556,2119329,268978400,502,93139,7993278,78571,6266614,14568,1726664,21497,517,3413911,870545,502,2922,7222.0,1000.0,-68.0,-73.0,-66.0,-61.0,-71.0,-74.0,-69.0,-63.0,-72.0,-80.0,-70.0,-75.0,4.0,7.0,4.0,14.0,1
110,F8:59:71:5A:E0:3D,3332742,2087810968,1213412,1818832508,2119330,268978460,255,679217,826310287,678556,826230644,661,79643,669718,1673,1213480,124876,255,872,13000.0,2000.0,-68.0,-74.0,-64.0,-70.0,-67.0,-73.0,-63.0,-69.0,-74.0,-80.0,-71.0,-76.0,6.0,6.0,7.0,6.0,1
111,CC:2F:71:3F:1F:24,3825391,2512433329,1706053,2243454061,2119338,268979268,2432,1413317,1808651368,1412239,1808529580,1078,121788,1397278,5604,1705792,107693,2432,1490,43333.0,5500.0,-71.0,-65.0,-70.0,-74.0,-69.0,-64.0,-68.0,-71.0,-74.0,-80.0,-71.0,-76.0,3.0,15.0,1.0,2.0,1
112,CC:2F:71:3E:C5:1F,5525874,4450734086,3406533,4181754556,2119341,268979530,502,93139,7993278,78571,6266614,14568,1726664,21497,517,3413911,870545,502,2922,7222.0,1000.0,-68.0,-73.0,-66.0,-61.0,-71.0,-74.0,-69.0,-63.0,-74.0,-81.0,-71.0,-76.0,6.0,8.0,5.0,15.0,1
113,F8:59:71:5A:E0:3D,3333688,2089242342,1214341,1820262206,2119347,268980136,255,679534,826501545,678873,826421902,661,79643,669999,1673,1214421,125720,255,874,43333.0,7222.0,-68.0,-75.0,-65.0,-71.0,-66.0,-72.0,-63.0,-69.0,-74.0,-81.0,-71.0,-76.0,6.0,6.0,6.0,5.0,1
114,CC:2F:71:3F:1F:24,3825675,2512821563,1706328,2243841427,2119347,268980136,2432,1413703,1809214422,1412625,1809092634,1078,121788,1397663,5604,1706067,107722,2432,1490,43333.0,5500.0,-70.0,-64.0,-70.0,-73.0,-68.0,-64.0,-67.0,-71.0,-74.0,-81.0,-71.0,-76.0,4.0,17.0,1.0,3.0,1
115,CC:2F:71:3E:C5:1F,5525880,4450734692,3406533,4181754556,2119347,268980136,502,93139,7993278,78571,6266614,14568,1726664,21497,517,3413911,870545,502,2922,7222.0,1000.0,-68.0,-73.0,-66.0,-61.0,-71.0,-74.0,-69.0,-63.0,-74.0,-81.0,-71.0,-76.0,6.0,8.0,5.0,15.0,1
116,F8:59:71:5A:E0:3D,3334074,2089821562,1214718,1820840558,2119356,268981004,255,679782,826726860,679121,826647217,661,79643,670233,1673,1214797,126072,255,876,52000.0,1000.0,-68.0,-75.0,-64.0,-70.0,-65.0,-72.0,-62.0,-68.0,-74.0,-81.0,-71.0,-76.0,6.0,6.0,7.0,6.0,1
117,CC:2F:71:3F:1F:24,3825945,2513188101,1706589,2244207097,2119356,268981004,2432,1413960,1809583664,1412882,1809461876,1078,121788,1397917,5604,1706329,107737,2432,1492,43333.0,5500.0,-67.0,-64.0,-65.0,-70.0,-69.0,-64.0,-68.0,-72.0,-74.0,-81.0,-71.0,-76.0,7.0,17.0,6.0,6.0,1
118,CC:2F:71:3E:C5:1F,5525889,4450735560,3406533,4181754556,2119356,268981004,502,93139,7993278,78571,6266614,14568,1726664,21497,517,3413911,870545,502,2922,7222.0,1000.0,-68.0,-73.0,-66.0,-61.0,-71.0,-74.0,-69.0,-63.0,-74.0,-81.0,-71.0,-76.0,6.0,8.0,5.0,15.0,1
119,F8:59:71:5A:E0:3D,3334362,2090259924,1215002,1821278516,2119360,268981408,255,679930,826879700,679269,826800057,661,79643,670376,1673,1215083,126316,255,876,43333.0,6500.0,-67.0,-74.0,-64.0,-70.0,-66.0,-73.0,-63.0,-69.0,-74.0,-81.0,-71.0,-76.0,7.0,7.0,7.0,6.0,1
120,CC:2F:71:3F:1F:24,3826144,2513444571,1706780,2244462759,2119364,268981812,2432,1414140,1809832234,1413062,1809710446,1078,121788,1398095,5604,1706519,107748,2432,1493,43333.0,5500.0,-71.0,-65.0,-71.0,-74.0,-69.0,-64.0,-68.0,-72.0,-74.0,-81.0,-71.0,-76.0,3.0,16.0,0.0,2.0,1
121,CC:2F:71:3E:C5:1F,5525897,4450736368,3406533,4181754556,2119364,268981812,502,93139,7993278,78571,6266614,14568,1726664,21497,517,3413911,870545,502,2922,7222.0,1000.0,-68.0,-73.0,-66.0,-61.0,-71.0,-74.0,-69.0,-63.0,-74.0,-81.0,-71.0,-76.0,6.0,8.0,5.0,15.0,1
122,F8:59:71:5A:E0:3D,3334557,2090552634,1215192,1821570762,2119365,268981872,255,680025,826972872,679364,826893229,661,79643,670455,1673,1215272,126464,255,881,52000.0,1000.0,-67.0,-73.0,-63.0,-70.0,-66.0,-73.0,-62.0,-68.0,-74.0,-81.0,-71.0,-77.0,7.0,8.0,8.0,7.0,1
123,CC:2F:71:3F:1F:24,3826304,2513646315,1706939,2244664443,2119365,268981872,2432,1414316,1810072503,1413238,1809950715,1078,121788,1398271,5604,1706679,107807,2432,1493,39000.0,5500.0,-67.0,-64.0,-65.0,-70.0,-67.0,-64.0,-66.0,-70.0,-74.0,-81.0,-71.0,-77.0,7.0,17.0,6.0,7.0,1
124,CC:2F:71:3E:C5:1F,5525898,4450736428,3406533,4181754556,2119365,268981872,502,93139,7993278,78571,6266614,14568,1726664,21497,517,3413911,870545,502,2922,7222.0,1000.0,-68.0,-73.0,-66.0,-61.0,-71.0,-74.0,-69.0,-63.0,-74.0,-81.0,-71.0,-77.0,6.0,8.0,5.0,16.0,1
125,F8:59:71:5A:E0:3D,3334906,2091072060,1215532,1822089107,2119374,268982953,255,680215,827101900,679554,827022257,661,79643,670629,1673,1215603,126883,255,882,28889.0,5500.0,-68.0,-74.0,-64.0,-71.0,-66.0,-73.0,-63.0,-69.0,-74.0,-81.0,-71.0,-77.0,6.0,7.0,7.0,6.0,1
126,CC:2F:71:3F:1F:24,3826558,2513986702,1707184,2245003749,2119374,268982953,2432,1414588,1810463963,1413510,1810342175,1078,121788,1398543,5604,1706923,107815,2432,1495,43333.0,5500.0,-66.0,-65.0,-65.0,-70.0,-67.0,-64.0,-66.0,-70.0,-74.0,-81.0,-71.0,-77.0,8.0,16.0,6.0,7.0,1
127,CC:2F:71:3E:C5:1F,5525908,4450737569,3406533,4181754556,2119375,268983013,502,93139,7993278,78571,6266614,14568,1726664,21497,517,3413911,870545,502,2922,7222.0,1000.0,-68.0,-73.0,-66.0,-61.0,-71.0,-74.0,-69.0,-63.0,-74.0,-81.0,-71.0,-77.0,6.0,8.0,5.0,16.0,1
128,F8:59:71:5A:E0:3D,3335087,2091332108,1215708,1822348691,2119379,268983417,255,680375,827302389,679714,827222746,661,79643,670784,1673,1215791,127066,255,883,39000.0,6500.0,-66.0,-73.0,-63.0,-69.0,-67.0,-73.0,-63.0,-69.0,-74.0,-80.0,-71.0,-77.0,8.0,7.0,8.0,8.0,1
129,CC:2F:71:3F:1F:24,3826781,2514281334,1707398,2245297513,2119383,268983821,2432,1414766,1810713887,1413688,1810592099,1078,121788,1398717,5604,1707134,107873,2432,1495,52000.0,6500.0,-71.0,-65.0,-70.0,-74.0,-69.0,-64.0,-69.0,-72.0,-74.0,-80.0,-71.0,-77.0,3.0,15.0,1.0,3.0,1
130,CC:2F:71:3E:C5:1F,5525919,4450738861,3406534,4181754672,2119385,268984189,502,93139,7993278,78571,6266614,14568,1726664,21497,517,3413912,870546,502,2922,7222.0,1000.0,-68.0,-73.0,-66.0,-61.0,-71.0,-74.0,-69.0,-63.0,-74.0,-80.0,-71.0,-77.0,6.0,7.0,5.0,16.0,1
131,F8:59:71:5A:E0:3D,3335517,2091954308,1216114,1822968383,2119403,268985925,255,680492,827451586,679831,827371943,661,79643,670870,1673,1216195,127517,255,885,13000.0,2000.0,-65.0,-73.0,-62.0,-68.0,-65.0,-72.0,-62.0,-68.0,-74.0,-80.0,-71.0,-77.0,9.0,7.0,9.0,9.0,1
132,CC:2F:71:3F:1F:24,3827841,2515674652,1708398,2246684730,2119443,268989922,2460,1416764,1813643369,1415685,1813521463,1079,121906,1400674,5604,1708086,108292,2460,1511,52000.0,6500.0,-66.0,-64.0,-64.0,-69.0,-66.0,-64.0,-64.0,-68.0,-73.0,-80.0,-71.0,-76.0,7.0,16.0,7.0,7.0,1
133,CC:2F:71:3E:C5:1F,5526008,4450747602,3406534,4181754672,2119474,268992930,502,93140,7993396,78571,6266614,14569,1726782,21498,517,3413913,870546,502,2922,7222.0,1000.0,-68.0,-73.0,-65.0,-61.0,-70.0,-73.0,-67.0,-62.0,-73.0,-81.0,-71.0,-76.0,5.0,8.0,6.0,15.0,1
134,F8:59:71:5A:E0:3D,3336988,2094042674,1217501,1825048472,2119487,268994202,267,680842,827841737,680180,827761976,662,79761,671119,1773,1217571,128263,267,895,21667.0,2000.0,-65.0,-73.0,-63.0,-68.0,-65.0,-72.0,-62.0,-68.0,-73.0,-81.0,-71.0,-76.0,8.0,8.0,8.0,8.0,1
135,CC:2F:71:3F:1F:24,3828917,2517202994,1709430,2248208792,2119487,268994202,2460,1418145,1815708062,1417066,1815586156,1079,121906,1402018,5604,1709143,109144,2460,1513,117000.0,39000.0,-68.0,-64.0,-66.0,-70.0,-68.0,-64.0,-65.0,-70.0,-73.0,-81.0,-71.0,-76.0,5.0,17.0,5.0,6.0,1
136,CC:2F:71:3E:C5:1F,5526023,4450749076,3406534,4181754672,2119489,268994404,502,93140,7993396,78571,6266614,14569,1726782,21498,517,3413913,870546,502,2922,7222.0,1000.0,-68.0,-73.0,-65.0,-61.0,-70.0,-73.0,-67.0,-62.0,-73.0,-81.0,-71.0,-76.0,5.0,8.0,6.0,15.0,1
137,F8:59:71:5A:E0:3D,3337253,2094396974,1217757,1825401691,2119496,268995283,267,681156,828220001,680494,828140240,662,79761,671405,1773,1217830,128399,267,897,39000.0,6500.0,-64.0,-72.0,-61.0,-68.0,-65.0,-72.0,-62.0,-68.0,-73.0,-81.0,-71.0,-76.0,9.0,9.0,10.0,8.0,1
138,CC:2F:71:3F:1F:24,3829282,2517716955,1709786,2248721672,2119496,268995283,2460,1418374,1816034328,1417295,1815912422,1079,121906,1402244,5604,1709500,109329,2460,1513,104000.0,26000.0,-68.0,-64.0,-66.0,-71.0,-68.0,-64.0,-66.0,-71.0,-73.0,-81.0,-71.0,-76.0,5.0,17.0,5.0,5.0,1
139,CC:2F:71:3E:C5:1F,5526030,4450749955,3406534,4181754672,2119496,268995283,502,93140,7993396,78571,6266614,14569,1726782,21498,517,3413913,870546,502,2922,7222.0,1000.0,-68.0,-73.0,-65.0,-61.0,-70.0,-73.0,-67.0,-62.0,-73.0,-81.0,-71.0,-76.0,5.0,8.0,6.0,15.0,1
140,F8:59:71:5A:E0:3D,3337415,2094626126,1217905,1825625157,2119510,269000969,267,681306,828436891,680644,828357130,662,79761,671550,1773,1217969,128522,267,898,52000.0,1000.0,-65.0,-73.0,-61.0,-69.0,-65.0,-72.0,-62.0,-68.0,-73.0,-81.0,-71.0,-76.0,8.0,8.0,10.0,7.0,1
141,CC:2F:71:3F:1F:24,3829549,2518061973,1710026,2249055378,2119523,269006595,2460,1418574,1816319294,1417495,1816197388,1079,121906,1402444,5604,1709729,109580,2460,1513,130000.0,39000.0,-67.0,-64.0,-65.0,-70.0,-67.0,-64.0,-65.0,-70.0,-73.0,-81.0,-71.0,-76.0,6.0,17.0,6.0,6.0,1
142,CC:2F:71:3E:C5:1F,5526062,4450761787,3406535,4181754788,2119527,269006999,502,93140,7993396,78571,6266614,14569,1726782,21498,517,3413914,870546,502,2922,7222.0,1000.0,-68.0,-73.0,-65.0,-61.0,-70.0,-73.0,-67.0,-62.0,-73.0,-81.0,-71.0,-76.0,5.0,8.0,6.0,15.0,1
143,F8:59:71:5A:E0:3D,3338018,2095514180,1218489,1826506979,2119529,269007201,267,681600,828728891,680938,828649130,662,79761,671820,1773,1218514,128922,267,899,52000.0,13000.0,-68.0,-75.0,-64.0,-71.0,-66.0,-73.0,-63.0,-69.0,-73.0,-81.0,-71.0,-76.0,5.0,6.0,7.0,5.0,1
144,CC:2F:71:3F:1F:24,3829888,2518534295,1710356,2249526832,2119532,269007463,2460,1418863,1816739264,1417784,1816617358,1079,121906,1402733,5604,1710052,109760,2460,1513,115556.0,28889.0,-68.0,-64.0,-66.0,-70.0,-69.0,-64.0,-67.0,-72.0,-73.0,-81.0,-71.0,-76.0,5.0,17.0,5.0,6.0,1
145,CC:2F:71:3E:C5:1F,5526067,4450762251,3406535,4181754788,2119532,269007463,502,93140,7993396,78571,6266614,14569,1726782,21498,517,3413914,870546,502,2922,7222.0,1000.0,-68.0,-73.0,-65.0,-61.0,-70.0,-73.0,-67.0,-62.0,-73.0,-81.0,-71.0,-76.0,5.0,8.0,6.0,15.0,1
146,F8:59:71:5A:E0:3D,3338692,2096522761,1219156,1827514894,2119536,269007867,267,681915,829012576,681253,828932815,662,79761,672122,1773,1219229,129510,267,899,65000.0,19500.0,-67.0,-73.0,-62.0,-68.0,-65.0,-72.0,-62.0,-68.0,-75.0,-82.0,-73.0,-78.0,8.0,9.0,11.0,10.0,1
147,CC:2F:71:3F:1F:24,3830162,2518914327,1710626,2249906460,2119536,269007867,2460,1419062,1817015584,1417983,1816893678,1079,121906,1402931,5604,1710339,109914,2460,1515,130000.0,39000.0,-68.0,-65.0,-66.0,-71.0,-68.0,-64.0,-66.0,-70.0,-75.0,-82.0,-73.0,-78.0,7.0,17.0,7.0,7.0,1
148,CC:2F:71:3E:C5:1F,5526073,4450762857,3406535,4181754788,2119538,269008069,502,93140,7993396,78571,6266614,14569,1726782,21498,517,3413914,870546,502,2922,7222.0,1000.0,-68.0,-73.0,-65.0,-61.0,-70.0,-73.0,-67.0,-62.0,-75.0,-82.0,-73.0,-78.0,7.0,9.0,8.0,17.0,1
149,F8:59:71:5A:E0:3D,3339276,2097409471,1219731,1828400736,2119545,269008735,267,682320,829332827,681658,829253066,662,79761,672513,1773,1219791,129975,267,899,78000.0,19500.0,-66.0,-73.0,-63.0,-69.0,-65.0,-72.0,-62.0,-68.0,-75.0,-82.0,-73.0,-78.0,9.0,9.0,10.0,9.0,1
150,CC:2F:71:3F:1F:24,3830731,2519714663,1711171,2250704532,2119560,269010131,2460,1419516,1817687098,1418436,1817565074,1080,122024,1403340,5604,1710884,110578,2460,1539,78000.0,13000.0,-66.0,-64.0,-64.0,-69.0,-66.0,-63.0,-64.0,-69.0,-74.0,-81.0,-72.0,-77.0,8.0,17.0,8.0,8.0,1
151,CC:2F:71:3E:C5:1F,5526113,4450766868,3406535,4181754788,2119578,269012080,502,93141,7993514,78571,6266614,14570,1726900,21499,517,3413914,870546,502,2922,7222.0,1000.0,-66.0,-71.0,-63.0,-60.0,-69.0,-73.0,-67.0,-62.0,-74.0,-81.0,-71.0,-77.0,8.0,10.0,8.0,17.0,1
152,F8:59:71:5A:E0:3D,3340117,2098559414,1220483,1829541756,2119634,269017658,267,682537,829526754,681874,829446875,663,79879,672646,1798,1220563,131313,267,922,5500.0,1000.0,-65.0,-72.0,-62.0,-68.0,-65.0,-72.0,-62.0,-68.0,-73.0,-81.0,-71.0,-76.0,8.0,9.0,9.0,8.0,1
153,CC:2F:71:3F:1F:24,3832205,2521741910,1712561,2252723111,2119644,269018799,2460,1421030,1819882733,1419950,1819760709,1080,122024,1404716,5605,1712276,112038,2460,1618,117000.0,39000.0,-69.0,-65.0,-68.0,-72.0,-69.0,-64.0,-68.0,-72.0,-74.0,-81.0,-71.0,-77.0,5.0,16.0,3.0,5.0,1
154,CC:2F:71:3E:C5:1F,5526187,4450774369,3406536,4181754904,2119651,269019465,502,93141,7993514,78571,6266614,14570,1726900,21499,517,3413916,870546,502,2922,7222.0,1000.0,-66.0,-71.0,-63.0,-60.0,-69.0,-73.0,-67.0,-62.0,-74.0,-81.0,-71.0,-77.0,8.0,10.0,8.0,17.0,1
155,F8:59:71:5A:E0:3D,3341794,2100970425,1222134,1831950092,2119660,269020333,278,683702,830769670,683039,830689791,663,79879,673799,1815,1222203,131559,278,923,72222.0,19500.0,-67.0,-74.0,-64.0,-70.0,-66.0,-73.0,-63.0,-69.0,-74.0,-81.0,-72.0,-77.0,7.0,7.0,8.0,7.0,1
156,CC:2F:71:3F:1F:24,3833541,2523708373,1713876,2254687576,2119665,269020797,2460,1422730,1822418041,1421650,1822296017,1080,122024,1406388,5605,1713590,112333,2460,1620,130000.0,43333.0,-69.0,-65.0,-67.0,-73.0,-69.0,-64.0,-68.0,-72.0,-74.0,-81.0,-72.0,-77.0,5.0,16.0,5.0,4.0,1
157,CC:2F:71:3E:C5:1F,5526206,4450776167,3406536,4181754904,2119670,269021263,502,93141,7993514,78571,6266614,14570,1726900,21499,517,3413916,870546,502,2922,7222.0,1000.0,-66.0,-71.0,-63.0,-60.0,-69.0,-73.0,-67.0,-62.0,-74.0,-82.0,-72.0,-77.0,8.0,11.0,9.0,17.0,1
158,F8:59:71:5A:E0:3D,3343272,2103214955,1223597,1834193226,2119675,269021729,278,684861,832214045,684197,832134048,664,79997,674958,1815,1223691,131707,278,923,144444.0,43333.0,-66.0,-73.0,-63.0,-70.0,-66.0,-73.0,-63.0,-69.0,-75.0,-82.0,-73.0,-78.0,9.0,9.0,10.0,8.0,1
159,CC:2F:71:3F:1F:24,3834661,2525390276,1714984,2256368345,2119677,269021931,2460,1423398,1823423322,1422317,1823301180,1081,122142,1407056,5605,1714677,112471,2460,1621,130000.0,43333.0,-70.0,-65.0,-68.0,-73.0,-69.0,-64.0,-68.0,-72.0,-75.0,-82.0,-73.0,-78.0,5.0,17.0,5.0,5.0,1
160,CC:2F:71:3E:C5:1F,5526215,4450777037,3406536,4181754904,2119679,269022133,502,93141,7993514,78571,6266614,14570,1726900,21499,517,3413916,870546,502,2922,7222.0,1000.0,-66.0,-71.0,-63.0,-60.0,-69.0,-73.0,-67.0,-62.0,-75.0,-82.0,-73.0,-78.0,9.0,11.0,10.0,18.0,1
161,F8:59:71:5A:E0:3D,3343699,2103848527,1224015,1834825930,2119684,269022597,278,686248,834234001,685584,834154004,664,79997,676345,1815,1224109,131738,278,923,144444.0,43333.0,-67.0,-74.0,-63.0,-70.0,-66.0,-74.0,-63.0,-70.0,-75.0,-82.0,-73.0,-78.0,8.0,8.0,10.0,8.0,1
162,CC:2F:71:3F:1F:24,3836055,2527492116,1716371,2258469519,2119684,269022597,2460,1423652,1823771576,1422571,1823649434,1081,122142,1407310,5605,1716083,112736,2460,1622,130000.0,43333.0,-70.0,-65.0,-68.0,-73.0,-69.0,-65.0,-68.0,-73.0,-75.0,-82.0,-73.0,-78.0,5.0,17.0,5.0,5.0,1
163,CC:2F:71:3E:C5:1F,5526220,4450777501,3406536,4181754904,2119684,269022597,502,93141,7993514,78571,6266614,14570,1726900,21499,517,3413916,870546,502,2922,7222.0,1000.0,-66.0,-71.0,-63.0,-60.0,-69.0,-73.0,-67.0,-62.0,-75.0,-82.0,-73.0,-78.0,9.0,11.0,10.0,18.0,1
164,F8:59:71:5A:E0:3D,3344084,2104439827,1224396,1835416826,2119688,269023001,278,687326,835785020,686662,835705023,664,79997,677423,1815,1224490,131748,278,923,144444.0,43333.0,-67.0,-74.0,-63.0,-70.0,-67.0,-74.0,-63.0,-70.0,-75.0,-82.0,-73.0,-78.0,8.0,8.0,10.0,8.0,1
165,CC:2F:71:3F:1F:24,3837096,2529064564,1717408,2260041563,2119688,269023001,2460,1423842,1824040096,1422761,1823917954,1081,122142,1407500,5605,1717104,113011,2460,1622,130000.0,43333.0,-70.0,-65.0,-68.0,-73.0,-69.0,-64.0,-68.0,-72.0,-75.0,-82.0,-73.0,-78.0,5.0,17.0,5.0,5.0,1
166,CC:2F:71:3E:C5:1F,5526225,4450777965,3406536,4181754904,2119689,269023061,502,93141,7993514,78571,6266614,14570,1726900,21499,517,3413916,870546,502,2922,7222.0,1000.0,-66.0,-71.0,-63.0,-60.0,-69.0,-73.0,-67.0,-62.0,-75.0,-82.0,-73.0,-78.0,9.0,11.0,10.0,18.0,1
167,F8:59:71:5A:E0:3D,3344297,2104762779,1224602,1835739112,2119695,269023667,278,688575,837660950,687911,837580953,664,79997,678672,1815,1224696,131748,278,923,144444.0,43333.0,-67.0,-74.0,-63.0,-70.0,-66.0,-74.0,-63.0,-70.0,-75.0,-82.0,-73.0,-78.0,8.0,8.0,10.0,8.0,1
168,CC:2F:71:3F:1F:24,3838467,2531141507,1718770,2262117638,2119697,269023869,2460,1424054,1824339975,1422973,1824217833,1081,122142,1407712,5605,1718485,113146,2460,1622,130000.0,43333.0,-70.0,-65.0,-69.0,-73.0,-69.0,-64.0,-68.0,-72.0,-75.0,-82.0,-73.0,-78.0,5.0,17.0,4.0,5.0,1
169,CC:2F:71:3E:C5:1F,5526234,4450779046,3406536,4181754904,2119698,269024142,502,93141,7993514,78571,6266614,14570,1726900,21499,517,3413916,870546,502,2922,7222.0,1000.0,-66.0,-71.0,-63.0,-60.0,-69.0,-73.0,-67.0,-62.0,-75.0,-82.0,-73.0,-78.0,9.0,11.0,10.0,18.0,1
170,F8:59:71:5A:E0:3D,3344580,2105176427,1224878,1836151881,2119702,269024546,278,689291,838704428,688627,838624431,664,79997,679388,1815,1224972,131792,278,923,144444.0,43333.0,-67.0,-74.0,-64.0,-70.0,-66.0,-74.0,-63.0,-70.0,-75.0,-82.0,-73.0,-78.0,8.0,8.0,9.0,8.0,1
171,CC:2F:71:3F:1F:24,3839202,2532214805,1719500,2263190259,2119702,269024546,2460,1424275,1824633168,1423194,1824511026,1081,122142,1407932,5605,1719216,113375,2460,1622,130000.0,43333.0,-72.0,-65.0,-71.0,-75.0,-70.0,-64.0,-68.0,-72.0,-75.0,-82.0,-73.0,-78.0,3.0,17.0,2.0,3.0,1
172,CC:2F:71:3E:C5:1F,5526240,4450779572,3406536,4181754904,2119704,269024668,502,93143,7993702,78572,6266684,14571,1727018,21500,517,3413916,870546,502,2922,7222.0,1000.0,-69.0,-73.0,-67.0,-62.0,-68.0,-73.0,-66.0,-62.0,-75.0,-82.0,-73.0,-78.0,6.0,9.0,6.0,16.0,1
173,F8:59:71:5A:E0:3D,3344648,2105273301,1224940,1836248229,2119708,269025072,278,689354,838801448,688690,838721451,664,79997,679451,1815,1225034,131792,278,923,144444.0,43333.0,-68.0,-73.0,-64.0,-71.0,-67.0,-74.0,-64.0,-70.0,-75.0,-83.0,-73.0,-78.0,7.0,10.0,9.0,7.0,1
174,CC:2F:71:3F:1F:24,3839363,2532418409,1719655,2263393337,2119708,269025072,2460,1424416,1824827214,1423335,1824705072,1081,122142,1408072,5605,1719371,113391,2460,1622,130000.0,43333.0,-69.0,-65.0,-68.0,-72.0,-69.0,-65.0,-68.0,-72.0,-75.0,-83.0,-73.0,-78.0,6.0,18.0,5.0,6.0,1
175,CC:2F:71:3E:C5:1F,5526244,4450779976,3406536,4181754904,2119708,269025072,502,93143,7993702,78572,6266684,14571,1727018,21500,517,3413916,870546,502,2922,7222.0,1000.0,-69.0,-73.0,-67.0,-62.0,-68.0,-73.0,-66.0,-62.0,-75.0,-83.0,-73.0,-78.0,6.0,10.0,6.0,16.0,1
176,F8:59:71:5A:E0:3D,3344737,2105377345,1225027,1836352071,2119710,269025274,278,689428,838902386,688764,838822389,664,79997,679525,1815,1225121,131792,278,923,144444.0,43333.0,-67.0,-73.0,-63.0,-70.0,-67.0,-73.0,-63.0,-69.0,-75.0,-83.0,-73.0,-78.0,8.0,10.0,10.0,8.0,1
177,CC:2F:71:3F:1F:24,3839524,2532624999,1719812,2263599523,2119712,269025476,2460,1424558,1825024238,1423477,1824902096,1081,122142,1408214,5605,1719528,113396,2460,1622,130000.0,43333.0,-71.0,-64.0,-69.0,-71.0,-70.0,-64.0,-68.0,-71.0,-75.0,-83.0,-73.0,-78.0,4.0,19.0,4.0,7.0,1
178,CC:2F:71:3E:C5:1F,5526248,4450780380,3406536,4181754904,2119712,269025476,502,93143,7993702,78572,6266684,14571,1727018,21500,517,3413916,870546,502,2922,7222.0,1000.0,-69.0,-73.0,-67.0,-62.0,-68.0,-73.0,-66.0,-62.0,-75.0,-83.0,-73.0,-78.0,6.0,10.0,6.0,16.0,1
179,F8:59:71:5A:E0:3D,3344806,2105474359,1225089,1836448419,2119717,269025940,278,689492,839000960,688828,838920963,664,79997,679588,1815,1225183,131793,278,923,144444.0,43333.0,-67.0,-74.0,-64.0,-70.0,-67.0,-73.0,-63.0,-69.0,-75.0,-83.0,-73.0,-78.0,8.0,9.0,9.0,8.0,1
180,CC:2F:71:3F:1F:24,3839684,2532827813,1719967,2263801873,2119717,269025940,2460,1424701,1825219898,1423620,1825097756,1081,122142,1408357,5605,1719683,113465,2460,1622,86667.0,13000.0,-70.0,-63.0,-69.0,-71.0,-70.0,-63.0,-69.0,-71.0,-75.0,-83.0,-73.0,-78.0,5.0,20.0,4.0,7.0,1
181,CC:2F:71:3E:C5:1F,5526253,4450780844,3406536,4181754904,2119717,269025940,502,93143,7993702,78572,6266684,14571,1727018,21500,517,3413916,870546,502,2922,7222.0,1000.0,-69.0,-73.0,-67.0,-62.0,-68.0,-73.0,-66.0,-62.0,-75.0,-83.0,-73.0,-78.0,6.0,10.0,6.0,16.0,1
182,F8:59:71:5A:E0:3D,3344869,2105572261,1225152,1836546321,2119717,269025940,278,689554,839096440,688890,839016443,664,79997,679650,1815,1225246,131794,278,923,144444.0,43333.0,-67.0,-73.0,-63.0,-71.0,-67.0,-73.0,-63.0,-70.0,-75.0,-83.0,-73.0,-78.0,8.0,10.0,10.0,7.0,1
183,CC:2F:71:3F:1F:24,3839857,2533036012,1720138,2264009870,2119719,269026142,2460,1424865,1825422474,1423784,1825300332,1081,122142,1408521,5605,1719854,113465,2460,1622,86667.0,14444.0,-70.0,-63.0,-68.0,-70.0,-70.0,-63.0,-69.0,-70.0,-75.0,-83.0,-73.0,-78.0,5.0,20.0,5.0,8.0,1
184,CC:2F:71:3E:C5:1F,5526255,4450781046,3406536,4181754904,2119719,269026142,502,93143,7993702,78572,6266684,14571,1727018,21500,517,3413916,870546,502,2922,7222.0,1000.0,-69.0,-73.0,-67.0,-62.0,-68.0,-73.0,-66.0,-62.0,-75.0,-83.0,-73.0,-78.0,6.0,10.0,6.0,16.0,1
185,F8:59:71:5A:E0:3D,3345082,2105894276,1225359,1836867730,2119723,269026546,278,689662,839200603,688998,839120606,664,79997,679758,1815,1225453,131794,278,923,144444.0,43333.0,-67.0,-74.0,-64.0,-71.0,-67.0,-74.0,-64.0,-71.0,-75.0,-83.0,-73.0,-78.0,8.0,9.0,9.0,7.0,1
186,CC:2F:71:3F:1F:24,3840019,2533239322,1720294,2264212574,2119725,269026748,2460,1425007,1825618032,1423926,1825495890,1081,122142,1408662,5605,1720010,113465,2460,1622,104000.0,26000.0,-69.0,-64.0,-68.0,-72.0,-69.0,-64.0,-68.0,-72.0,-75.0,-83.0,-73.0,-78.0,6.0,19.0,5.0,6.0,1
187,CC:2F:71:3E:C5:1F,5526261,4450781652,3406536,4181754904,2119725,269026748,502,93143,7993702,78572,6266684,14571,1727018,21500,517,3413916,870546,502,2922,7222.0,1000.0,-69.0,-73.0,-67.0,-62.0,-68.0,-73.0,-66.0,-62.0,-75.0,-83.0,-73.0,-78.0,6.0,10.0,6.0,16.0,1
188,F8:59:71:5A:E0:3D,3345148,2105992440,1225422,1836965632,2119726,269026808,278,689725,839297623,689061,839217626,664,79997,679821,1815,1225516,131795,278,923,144444.0,43333.0,-68.0,-74.0,-63.0,-71.0,-67.0,-73.0,-63.0,-70.0,-75.0,-83.0,-73.0,-78.0,7.0,9.0,10.0,7.0,1
189,CC:2F:71:3F:1F:24,3840180,2533448078,1720454,2264421270,2119726,269026808,2460,1425150,1825816540,1424069,1825694398,1081,122142,1408805,5605,1720170,113499,2460,1622,65000.0,13000.0,-70.0,-64.0,-69.0,-71.0,-70.0,-63.0,-69.0,-71.0,-75.0,-83.0,-73.0,-78.0,5.0,19.0,4.0,7.0,1
190,CC:2F:71:3E:C5:1F,5526262,4450781712,3406536,4181754904,2119726,269026808,502,93143,7993702,78572,6266684,14571,1727018,21500,517,3413916,870546,502,2922,7222.0,1000.0,-69.0,-73.0,-67.0,-62.0,-68.0,-73.0,-66.0,-62.0,-75.0,-83.0,-73.0,-78.0,6.0,10.0,6.0,16.0,1
191,F8:59:71:5A:E0:3D,3345423,2106394310,1225691,1837366896,2119732,269027414,278,689819,839401558,689155,839321561,664,79997,679915,1815,1225785,131795,278,923,144444.0,43333.0,-68.0,-72.0,-64.0,-71.0,-68.0,-72.0,-64.0,-71.0,-74.0,-82.0,-72.0,-78.0,6.0,10.0,8.0,7.0,1
192,CC:2F:71:3F:1F:24,3840340,2533649536,1720608,2264622122,2119732,269027414,2460,1425293,1826010776,1424212,1825888634,1081,122142,1408948,5605,1720324,113499,2460,1622,86667.0,14444.0,-73.0,-64.0,-72.0,-71.0,-71.0,-64.0,-70.0,-70.0,-74.0,-82.0,-72.0,-78.0,1.0,18.0,0.0,7.0,1
193,CC:2F:71:3E:C5:1F,5526268,4450782318,3406536,4181754904,2119732,269027414,502,93143,7993702,78572,6266684,14571,1727018,21500,517,3413916,870546,502,2922,7222.0,1000.0,-69.0,-73.0,-67.0,-62.0,-68.0,-73.0,-66.0,-62.0,-74.0,-82.0,-72.0,-78.0,5.0,9.0,5.0,16.0,1
194,F8:59:71:5A:E0:3D,3345493,2106495980,1225759,1837468364,2119734,269027616,278,689887,839502469,689223,839422472,664,79997,679983,1815,1225853,131795,278,923,144444.0,43333.0,-67.0,-73.0,-64.0,-71.0,-67.0,-72.0,-64.0,-71.0,-75.0,-82.0,-73.0,-78.0,8.0,9.0,9.0,7.0,1
195,CC:2F:71:3F:1F:24,3840503,2533860100,1720769,2264832484,2119734,269027616,2460,1425442,1826212870,1424361,1826090728,1081,122142,1409096,5605,1720485,113509,2460,1622,86667.0,13000.0,-70.0,-63.0,-73.0,-72.0,-69.0,-63.0,-70.0,-71.0,-75.0,-82.0,-73.0,-78.0,5.0,19.0,0.0,6.0,1
196,CC:2F:71:3E:C5:1F,5526270,4450782520,3406536,4181754904,2119734,269027616,502,93143,7993702,78572,6266684,14571,1727018,21500,517,3413916,870546,502,2922,7222.0,1000.0,-69.0,-73.0,-67.0,-62.0,-68.0,-73.0,-66.0,-62.0,-75.0,-82.0,-73.0,-78.0,6.0,9.0,6.0,16.0,1
197,F8:59:71:5A:E0:3D,3345713,2106829707,1225974,1837801627,2119739,269028080,278,689977,839604561,689313,839524564,664,79997,680073,1815,1226068,131795,278,923,144444.0,43333.0,-69.0,-74.0,-65.0,-72.0,-67.0,-73.0,-64.0,-71.0,-75.0,-82.0,-73.0,-78.0,6.0,8.0,8.0,6.0,1
198,CC:2F:71:3F:1F:24,3840663,2534061588,1720924,2265033508,2119739,269028080,2460,1425584,1826406980,1424503,1826284838,1081,122142,1409238,5605,1720640,113509,2460,1622,86667.0,14444.0,-69.0,-64.0,-69.0,-68.0,-69.0,-63.0,-69.0,-68.0,-75.0,-82.0,-73.0,-78.0,6.0,18.0,4.0,10.0,1
199,CC:2F:71:3E:C5:1F,5526277,4450783186,3406536,4181754904,2119741,269028282,502,93143,7993702,78572,6266684,14571,1727018,21500,517,3413916,870546,502,2922,7222.0,1000.0,-69.0,-73.0,-67.0,-62.0,-68.0,-73.0,-66.0,-62.0,-75.0,-82.0,-73.0,-78.0,6.0,9.0,6.0,16.0,1
200,F8:59:71:5A:E0:3D,3345780,2106928013,1226037,1837899529,2119743,269028484,278,690041,839703121,689377,839623124,664,79997,680137,1815,1226131,131795,278,923,144444.0,43333.0,-69.0,-73.0,-66.0,-73.0,-67.0,-73.0,-65.0,-71.0,-75.0,-82.0,-73.0,-78.0,6.0,9.0,7.0,5.0,1
201,CC:2F:71:3F:1F:24,3840825,2534269172,1721082,2265240688,2119743,269028484,2460,1425729,1826604296,1424648,1826482154,1081,122142,1409383,5605,1720798,113509,2460,1622,86667.0,14444.0,-70.0,-63.0,-73.0,-70.0,-68.0,-63.0,-70.0,-69.0,-75.0,-82.0,-73.0,-78.0,5.0,19.0,0.0,8.0,1
202,CC:2F:71:3E:C5:1F,5526279,4450783388,3406536,4181754904,2119743,269028484,502,93143,7993702,78572,6266684,14571,1727018,21500,517,3413916,870546,502,2922,7222.0,1000.0,-69.0,-73.0,-67.0,-62.0,-68.0,-73.0,-66.0,-62.0,-75.0,-82.0,-73.0,-78.0,6.0,9.0,6.0,16.0,1
203,F8:59:71:5A:E0:3D,3345845,2107026117,1226100,1837997431,2119745,269028686,278,690103,839798601,689439,839718604,664,79997,680199,1815,1226194,131795,278,923,144444.0,43333.0,-69.0,-73.0,-65.0,-73.0,-68.0,-73.0,-64.0,-72.0,-75.0,-82.0,-73.0,-78.0,6.0,9.0,8.0,5.0,1
204,CC:2F:71:3F:1F:24,3840985,2534475018,1721240,2265446332,2119745,269028686,2460,1425875,1826801728,1424794,1826679586,1081,122142,1409529,5605,1720955,113525,2460,1622,86667.0,14444.0,-68.0,-63.0,-69.0,-70.0,-68.0,-63.0,-69.0,-70.0,-75.0,-82.0,-73.0,-78.0,7.0,19.0,4.0,8.0,1
205,CC:2F:71:3E:C5:1F,5526282,4450783724,3406536,4181754904,2119746,269028820,502,93143,7993702,78572,6266684,14571,1727018,21500,517,3413916,870546,502,2922,7222.0,1000.0,-69.0,-73.0,-67.0,-62.0,-68.0,-73.0,-66.0,-62.0,-75.0,-82.0,-73.0,-78.0,6.0,9.0,6.0,16.0,1
206,F8:59:71:5A:E0:3D,3346095,2107397400,1226343,1838368048,2119752,269029352,278,690227,839909370,689563,839829373,664,79997,680323,1815,1226437,131799,278,923,144444.0,43333.0,-68.0,-73.0,-65.0,-71.0,-67.0,-73.0,-65.0,-71.0,-75.0,-82.0,-73.0,-78.0,7.0,9.0,8.0,7.0,1
207,CC:2F:71:3F:1F:24,3841153,2534684664,1721401,2265655312,2119752,269029352,2460,1426020,1827001910,1424939,1826879768,1081,122142,1409674,5605,1721117,113525,2460,1622,86667.0,14444.0,-68.0,-63.0,-69.0,-70.0,-69.0,-63.0,-70.0,-69.0,-75.0,-82.0,-73.0,-78.0,7.0,19.0,4.0,8.0,1
208,CC:2F:71:3E:C5:1F,5526288,4450784256,3406536,4181754904,2119752,269029352,502,93143,7993702,78572,6266684,14571,1727018,21500,517,3413916,870546,502,2922,7222.0,1000.0,-69.0,-73.0,-67.0,-62.0,-68.0,-73.0,-66.0,-62.0,-75.0,-82.0,-73.0,-78.0,6.0,9.0,6.0,16.0,1
209,F8:59:71:5A:E0:3D,3346161,2107497058,1226407,1838467504,2119754,269029554,278,690290,840006390,689626,839926393,664,79997,680386,1815,1226501,131799,278,923,144444.0,43333.0,-67.0,-73.0,-64.0,-71.0,-67.0,-72.0,-65.0,-71.0,-75.0,-82.0,-73.0,-78.0,8.0,9.0,9.0,7.0,1
210,CC:2F:71:3F:1F:24,3841315,2534893730,1721561,2265864176,2119754,269029554,2460,1426165,1827202074,1425084,1827079932,1081,122142,1409819,5605,1721277,113525,2460,1622,86667.0,14444.0,-70.0,-63.0,-72.0,-70.0,-69.0,-63.0,-71.0,-69.0,-75.0,-82.0,-73.0,-78.0,5.0,19.0,1.0,8.0,1
211,CC:2F:71:3E:C5:1F,5526290,4450784458,3406536,4181754904,2119754,269029554,502,93143,7993702,78572,6266684,14571,1727018,21500,517,3413916,870546,502,2922,7222.0,1000.0,-69.0,-73.0,-67.0,-62.0,-68.0,-73.0,-66.0,-62.0,-75.0,-82.0,-73.0,-78.0,6.0,9.0,6.0,16.0,1
212,F8:59:71:5A:E0:3D,3346235,2107597851,1226474,1838567418,2119761,269030433,278,690357,840107185,689693,840027188,664,79997,680453,1815,1226568,131799,278,923,144444.0,43333.0,-68.0,-74.0,-66.0,-71.0,-67.0,-73.0,-64.0,-71.0,-75.0,-83.0,-73.0,-78.0,7.0,9.0,7.0,7.0,1
213,CC:2F:71:3F:1F:24,3841478,2535097145,1721717,2266066712,2119761,269030433,2460,1426307,1827397632,1425226,1827275490,1081,122142,1409960,5605,1721433,113529,2460,1622,115556.0,26000.0,-69.0,-63.0,-70.0,-69.0,-69.0,-63.0,-69.0,-69.0,-75.0,-83.0,-73.0,-78.0,6.0,20.0,3.0,9.0,1
214,CC:2F:71:3E:C5:1F,5526297,4450785337,3406536,4181754904,2119761,269030433,502,93143,7993702,78572,6266684,14571,1727018,21500,517,3413916,870546,502,2922,7222.0,1000.0,-69.0,-73.0,-67.0,-62.0,-68.0,-73.0,-66.0,-62.0,-75.0,-83.0,-73.0,-78.0,6.0,10.0,6.0,16.0,1
215,F8:59:71:5A:E0:3D,3346361,2107782059,1226597,1838751364,2119764,269030695,278,690438,840213041,689774,840133044,664,79997,680534,1815,1226691,131799,278,923,144444.0,43333.0,-67.0,-73.0,-65.0,-71.0,-67.0,-73.0,-64.0,-71.0,-75.0,-83.0,-73.0,-78.0,8.0,10.0,8.0,7.0,1
216,CC:2F:71:3F:1F:24,3841637,2535300335,1721873,2266269640,2119764,269030695,2460,1426451,1827594846,1425370,1827472704,1081,122142,1410103,5605,1721589,113536,2460,1622,115556.0,28889.0,-68.0,-63.0,-69.0,-69.0,-69.0,-63.0,-70.0,-69.0,-75.0,-83.0,-73.0,-78.0,7.0,20.0,4.0,9.0,1
217,CC:2F:71:3E:C5:1F,5526300,4450785599,3406536,4181754904,2119764,269030695,502,93143,7993702,78572,6266684,14571,1727018,21500,517,3413916,870546,502,2922,7222.0,1000.0,-69.0,-73.0,-67.0,-62.0,-68.0,-73.0,-66.0,-62.0,-76.0,-84.0,-74.0,-80.0,7.0,11.0,7.0,18.0,1
218,F8:59:71:5A:E0:3D,3346980,2108641256,1227181,1839604879,2119799,269036377,278,690705,840591705,690041,840511708,664,79997,680783,1815,1227274,131998,278,925,144444.0,43333.0,-68.0,-73.0,-64.0,-70.0,-67.0,-72.0,-64.0,-70.0,-77.0,-84.0,-75.0,-80.0,9.0,11.0,11.0,10.0,1
219,CC:2F:71:3F:1F:24,3842596,2536631320,1722795,2267594741,2119801,269036579,2507,1427390,1828936807,1426308,1828814547,1082,122260,1411000,5605,1722464,113861,2507,1628,58500.0,19500.0,-69.0,-63.0,-69.0,-69.0,-68.0,-62.0,-68.0,-68.0,-77.0,-84.0,-75.0,-80.0,8.0,21.0,6.0,11.0,1
220,CC:2F:71:3E:C5:1F,5526338,4450791599,3406537,4181755020,2119801,269036579,502,93143,7993702,78572,6266684,14571,1727018,21500,517,3413917,870548,502,2922,7222.0,1000.0,-69.0,-73.0,-67.0,-62.0,-68.0,-73.0,-66.0,-62.0,-77.0,-84.0,-75.0,-80.0,8.0,11.0,8.0,18.0,1
221,F8:59:71:5A:E0:3D,3347340,2109178353,1227533,1840141168,2119807,269037185,278,691021,841003103,690357,840923106,664,79997,681096,1815,1227628,132052,278,925,144444.0,43333.0,-67.0,-73.0,-64.0,-71.0,-67.0,-73.0,-64.0,-70.0,-77.0,-84.0,-75.0,-80.0,10.0,11.0,11.0,9.0,1
222,CC:2F:71:3F:1F:24,3842770,2536848718,1722963,2267811533,2119807,269037185,2507,1427543,1829145082,1426461,1829022822,1082,122260,1411153,5605,1722633,113863,2507,1628,72222.0,21667.0,-68.0,-63.0,-68.0,-69.0,-68.0,-62.0,-68.0,-68.0,-77.0,-84.0,-75.0,-80.0,9.0,21.0,7.0,11.0,1
223,CC:2F:71:3E:C5:1F,5526344,4450792205,3406537,4181755020,2119807,269037185,502,93143,7993702,78572,6266684,14571,1727018,21500,517,3413917,870548,502,2922,7222.0,1000.0,-69.0,-73.0,-67.0,-62.0,-68.0,-73.0,-66.0,-62.0,-77.0,-84.0,-75.0,-80.0,8.0,11.0,8.0,18.0,1
224,F8:59:71:5A:E0:3D,3347406,2109275033,1227595,1840237460,2119811,269037573,278,691084,841100123,690420,841020126,664,79997,681159,1815,1227690,132052,278,925,130000.0,39000.0,-67.0,-72.0,-65.0,-71.0,-67.0,-72.0,-64.0,-70.0,-77.0,-84.0,-75.0,-80.0,10.0,12.0,10.0,9.0,1
225,CC:2F:71:3F:1F:24,3842931,2537053140,1723120,2268015567,2119811,269037573,2507,1427683,1829338970,1426601,1829216710,1082,122260,1411293,5605,1722789,113877,2507,1628,115556.0,28889.0,-69.0,-63.0,-68.0,-68.0,-68.0,-63.0,-68.0,-68.0,-77.0,-84.0,-75.0,-80.0,8.0,21.0,7.0,12.0,1
226,CC:2F:71:3E:C5:1F,5526348,4450792593,3406537,4181755020,2119811,269037573,502,93143,7993702,78572,6266684,14571,1727018,21500,517,3413917,870548,502,2922,7222.0,1000.0,-69.0,-73.0,-67.0,-62.0,-68.0,-73.0,-66.0,-62.0,-77.0,-84.0,-75.0,-80.0,8.0,11.0,8.0,18.0,1
227,F8:59:71:5A:E0:3D,3347618,2109561257,1227801,1840523078,2119817,269038179,278,691178,841204384,690514,841124387,664,79997,681253,1815,1227896,132053,278,925,144444.0,43333.0,-68.0,-73.0,-64.0,-70.0,-67.0,-73.0,-64.0,-70.0,-77.0,-84.0,-75.0,-80.0,9.0,11.0,11.0,10.0,1
228,CC:2F:71:3F:1F:24,3843096,2537261616,1723279,2268223437,2119817,269038179,2507,1427828,1829537710,1426746,1829415450,1082,122260,1411438,5605,1722948,113888,2507,1628,115556.0,28889.0,-69.0,-63.0,-69.0,-69.0,-68.0,-63.0,-68.0,-69.0,-77.0,-84.0,-75.0,-80.0,8.0,21.0,6.0,11.0,1
229,CC:2F:71:3E:C5:1F,5526354,4450793199,3406537,4181755020,2119817,269038179,502,93143,7993702,78572,6266684,14571,1727018,21500,517,3413917,870548,502,2922,7222.0,1000.0,-69.0,-73.0,-67.0,-62.0,-68.0,-73.0,-66.0,-62.0,-77.0,-84.0,-75.0,-80.0,8.0,11.0,8.0,18.0,1
230,F8:59:71:5A:E0:3D,3347683,2109657757,1227863,1840619314,2119820,269038443,278,691242,841301522,690577,841221407,665,80115,681317,1815,1227958,132054,278,925,144444.0,43333.0,-67.0,-72.0,-64.0,-71.0,-67.0,-72.0,-64.0,-70.0,-77.0,-84.0,-75.0,-80.0,10.0,12.0,11.0,9.0,1
231,CC:2F:71:3F:1F:24,3843257,2537468196,1723437,2268429753,2119820,269038443,2507,1427974,1829736566,1426892,1829614306,1082,122260,1411584,5605,1723107,113899,2507,1628,115556.0,28889.0,-69.0,-63.0,-68.0,-68.0,-69.0,-63.0,-68.0,-68.0,-77.0,-84.0,-75.0,-80.0,8.0,21.0,7.0,12.0,1
232,CC:2F:71:3E:C5:1F,5526358,4450793523,3406537,4181755020,2119821,269038503,502,93143,7993702,78572,6266684,14571,1727018,21500,517,3413917,870548,502,2922,7222.0,1000.0,-69.0,-73.0,-67.0,-62.0,-68.0,-73.0,-66.0,-62.0,-77.0,-84.0,-75.0,-80.0,8.0,11.0,8.0,18.0,1
233,F8:59:71:5A:E0:3D,3347752,2109754771,1227925,1840715662,2119827,269039109,278,691304,841397002,690639,841316887,665,80115,681379,1815,1228020,132056,278,925,144444.0,43333.0,-67.0,-73.0,-64.0,-70.0,-67.0,-72.0,-64.0,-70.0,-77.0,-84.0,-75.0,-80.0,10.0,11.0,11.0,10.0,1
234,CC:2F:71:3F:1F:24,3843430,2537674245,1723603,2268635136,2119827,269039109,2507,1428127,1829936616,1427045,1829814356,1082,122260,1411737,5605,1723273,113918,2507,1628,115556.0,28889.0,-69.0,-63.0,-69.0,-69.0,-68.0,-63.0,-68.0,-69.0,-77.0,-84.0,-75.0,-80.0,8.0,21.0,6.0,11.0,1
235,CC:2F:71:3E:C5:1F,5526364,4450794129,3406537,4181755020,2119827,269039109,502,93143,7993702,78572,6266684,14571,1727018,21500,517,3413917,870548,502,2922,7222.0,1000.0,-69.0,-73.0,-67.0,-62.0,-68.0,-73.0,-66.0,-62.0,-77.0,-84.0,-75.0,-80.0,8.0,11.0,8.0,18.0,1
236,F8:59:71:5A:E0:3D,3347881,2109935701,1228052,1840896257,2119829,269039444,278,691396,841505306,690731,841425191,665,80115,681471,1815,1228147,132057,278,928,144444.0,43333.0,-67.0,-73.0,-64.0,-71.0,-66.0,-71.0,-63.0,-70.0,-77.0,-84.0,-75.0,-80.0,10.0,11.0,11.0,9.0,1
237,CC:2F:71:3F:1F:24,3843594,2537884206,1723763,2268844560,2119831,269039646,2507,1428271,1830136664,1427189,1830014404,1082,122260,1411881,5605,1723433,113928,2507,1628,115556.0,28889.0,-68.0,-63.0,-68.0,-69.0,-68.0,-63.0,-68.0,-69.0,-77.0,-84.0,-75.0,-80.0,9.0,21.0,7.0,11.0,1
238,CC:2F:71:3E:C5:1F,5526368,4450794666,3406537,4181755020,2119831,269039646,502,93144,7993820,78572,6266684,14572,1727136,21501,517,3413917,870548,502,2923,7222.0,1000.0,-69.0,-71.0,-66.0,-61.0,-68.0,-72.0,-65.0,-61.0,-77.0,-84.0,-75.0,-80.0,8.0,13.0,9.0,19.0,1
239,F8:59:71:5A:E0:3D,3348142,2110318081,1228305,1841277829,2119837,269040252,278,691506,841611485,690841,841531370,665,80115,681581,1815,1228400,132059,278,928,144444.0,43333.0,-67.0,-73.0,-64.0,-70.0,-67.0,-73.0,-63.0,-70.0,-77.0,-84.0,-75.0,-80.0,10.0,11.0,11.0,10.0,1
240,CC:2F:71:3F:1F:24,3843765,2538093097,1723927,2269052785,2119838,269040312,2507,1428418,1830334349,1427336,1830212089,1082,122260,1412028,5605,1723595,113967,2507,1628,104000.0,1000.0,-67.0,-63.0,-66.0,-68.0,-67.0,-63.0,-67.0,-68.0,-77.0,-84.0,-75.0,-80.0,10.0,21.0,9.0,12.0,1
241,CC:2F:71:3E:C5:1F,5526384,4450796200,3406537,4181755020,2119847,269041180,502,93144,7993820,78572,6266684,14572,1727136,21501,517,3413917,870548,502,2923,7222.0,1000.0,-69.0,-71.0,-66.0,-61.0,-68.0,-72.0,-65.0,-61.0,-76.0,-83.0,-74.0,-80.0,7.0,12.0,8.0,19.0,1
242,F8:59:71:5A:E0:3D,3348691,2111107014,1228836,1842065026,2119855,269041988,283,691799,842022109,691134,841941994,665,80115,681862,1815,1228926,132143,283,931,144444.0,43333.0,-66.0,-72.0,-63.0,-70.0,-66.0,-71.0,-63.0,-70.0,-76.0,-83.0,-74.0,-80.0,10.0,11.0,11.0,10.0,1
243,CC:2F:71:3F:1F:24,3844454,2539071374,1724599,2270029386,2119855,269041988,2525,1429090,1831322339,1428008,1831200079,1082,122260,1412667,5605,1724253,114380,2525,1636,115556.0,28889.0,-67.0,-63.0,-67.0,-69.0,-67.0,-63.0,-67.0,-68.0,-76.0,-83.0,-74.0,-79.0,9.0,20.0,7.0,10.0,1
244,CC:2F:71:3E:C5:1F,5526392,4450797008,3406537,4181755020,2119855,269041988,502,93144,7993820,78572,6266684,14572,1727136,21501,517,3413917,870548,502,2923,7222.0,1000.0,-69.0,-71.0,-66.0,-61.0,-68.0,-72.0,-65.0,-61.0,-76.0,-83.0,-74.0,-79.0,7.0,12.0,8.0,18.0,1
245,F8:59:71:5A:E0:3D,3348807,2111274473,1228949,1842232223,2119858,269042250,283,691924,842210781,691259,842130666,665,80115,681987,1815,1229040,132152,283,932,144444.0,43333.0,-66.0,-72.0,-63.0,-69.0,-66.0,-71.0,-63.0,-69.0,-76.0,-83.0,-74.0,-79.0,10.0,11.0,11.0,10.0,1
246,CC:2F:71:3F:1F:24,3844617,2539279436,1724759,2270237186,2119858,269042250,2525,1429237,1831524187,1428155,1831401927,1082,122260,1412814,5605,1724413,114516,2525,1636,104000.0,26000.0,-68.0,-63.0,-67.0,-68.0,-67.0,-63.0,-66.0,-68.0,-76.0,-83.0,-74.0,-79.0,8.0,20.0,7.0,11.0,1
247,CC:2F:71:3E:C5:1F,5526395,4450797270,3406537,4181755020,2119858,269042250,502,93144,7993820,78572,6266684,14572,1727136,21501,517,3413917,870548,502,2923,7222.0,1000.0,-69.0,-71.0,-66.0,-61.0,-68.0,-72.0,-65.0,-61.0,-76.0,-83.0,-74.0,-79.0,7.0,12.0,8.0,18.0,1
248,F8:59:71:5A:E0:3D,3349031,2111612233,1229167,1842569377,2119864,269042856,283,692024,842318696,691359,842238581,665,80115,682087,1815,1229258,132253,283,933,144444.0,43333.0,-66.0,-73.0,-63.0,-70.0,-66.0,-72.0,-63.0,-69.0,-76.0,-83.0,-74.0,-79.0,10.0,10.0,11.0,9.0,1
249,CC:2F:71:3F:1F:24,3844786,2539491346,1724922,2270448490,2119864,269042856,2525,1429387,1831727867,1428305,1831605607,1082,122260,1412964,5605,1724574,114653,2525,1637,115556.0,28889.0,-68.0,-63.0,-67.0,-68.0,-67.0,-63.0,-66.0,-68.0,-76.0,-83.0,-74.0,-79.0,8.0,20.0,7.0,11.0,1
250,CC:2F:71:3E:C5:1F,5526401,4450797876,3406537,4181755020,2119864,269042856,502,93144,7993820,78572,6266684,14572,1727136,21501,517,3413917,870548,502,2923,7222.0,1000.0,-69.0,-71.0,-66.0,-61.0,-68.0,-72.0,-65.0,-61.0,-76.0,-83.0,-74.0,-79.0,7.0,12.0,8.0,18.0,1
251,F8:59:71:5A:E0:3D,3349145,2111783485,1229279,1842740427,2119866,269043058,283,692103,842422306,691438,842342191,665,80115,682166,1815,1229370,132276,283,933,144444.0,43333.0,-66.0,-72.0,-63.0,-70.0,-66.0,-72.0,-63.0,-70.0,-75.0,-83.0,-73.0,-79.0,9.0,11.0,10.0,9.0,1
252,CC:2F:71:3F:1F:24,3844946,2539696240,1725080,2270653182,2119866,269043058,2525,1429531,1831925067,1428449,1831802807,1082,122260,1413108,5605,1724734,114791,2525,1637,65000.0,13000.0,-68.0,-63.0,-66.0,-69.0,-68.0,-63.0,-67.0,-68.0,-75.0,-83.0,-73.0,-79.0,7.0,20.0,7.0,10.0,1
253,CC:2F:71:3E:C5:1F,5526403,4450798078,3406537,4181755020,2119866,269043058,502,93144,7993820,78572,6266684,14572,1727136,21501,517,3413917,870548,502,2923,7222.0,1000.0,-69.0,-71.0,-66.0,-61.0,-68.0,-72.0,-65.0,-61.0,-75.0,-83.0,-73.0,-79.0,6.0,12.0,7.0,18.0,1
254,F8:59:71:5A:E0:3D,3349216,2111883495,1229343,1842839771,2119873,269043724,283,692168,842522406,691503,842442291,665,80115,682231,1815,1229434,132295,283,933,144444.0,43333.0,-66.0,-70.0,-64.0,-70.0,-66.0,-71.0,-63.0,-69.0,-75.0,-83.0,-73.0,-79.0,9.0,13.0,9.0,9.0,1
255,CC:2F:71:3F:1F:24,3845119,2539914478,1725246,2270870754,2119873,269043724,2525,1429682,1832134555,1428600,1832012295,1082,122260,1413259,5605,1724900,114860,2525,1637,86667.0,14444.0,-69.0,-63.0,-69.0,-68.0,-68.0,-63.0,-67.0,-68.0,-75.0,-83.0,-73.0,-79.0,6.0,20.0,4.0,11.0,1
256,CC:2F:71:3E:C5:1F,5526410,4450798744,3406537,4181755020,2119873,269043724,502,93144,7993820,78572,6266684,14572,1727136,21501,517,3413917,870548,502,2923,7222.0,1000.0,-69.0,-71.0,-66.0,-61.0,-68.0,-72.0,-65.0,-61.0,-74.0,-82.0,-72.0,-78.0,5.0,11.0,6.0,17.0,1
257,F8:59:71:5A:E0:3D,3349282,2111986059,1229409,1842942335,2119873,269043724,283,692235,842625600,691570,842545485,665,80115,682297,1815,1229500,132304,283,933,144444.0,43333.0,-68.0,-73.0,-65.0,-72.0,-67.0,-72.0,-64.0,-70.0,-74.0,-82.0,-72.0,-78.0,6.0,9.0,7.0,6.0,1
258,CC:2F:71:3F:1F:24,3845298,2540126995,1725423,2271083069,2119875,269043926,2525,1429845,1832340540,1428763,1832218280,1082,122260,1413421,5605,1725077,115002,2525,1639,115556.0,1000.0,-68.0,-63.0,-68.0,-69.0,-69.0,-63.0,-69.0,-68.0,-74.0,-82.0,-72.0,-78.0,6.0,19.0,4.0,9.0,1
259,CC:2F:71:3E:C5:1F,5526412,4450798946,3406537,4181755020,2119875,269043926,502,93144,7993820,78572,6266684,14572,1727136,21501,517,3413917,870548,502,2923,7222.0,1000.0,-69.0,-71.0,-66.0,-61.0,-68.0,-72.0,-65.0,-61.0,-74.0,-82.0,-72.0,-78.0,5.0,11.0,6.0,17.0,1
260,F8:59:71:5A:E0:3D,3349382,2112095502,1229501,1843050970,2119881,269044532,283,692329,842734591,691664,842654476,665,80115,682391,1815,1229592,132312,283,933,144444.0,43333.0,-68.0,-73.0,-65.0,-72.0,-66.0,-72.0,-63.0,-70.0,-74.0,-82.0,-72.0,-78.0,6.0,9.0,7.0,6.0,1
261,CC:2F:71:3F:1F:24,3845466,2540338341,1725585,2271293809,2119881,269044532,2525,1429992,1832545222,1428910,1832422962,1082,122260,1413567,5605,1725239,115140,2525,1639,78000.0,13000.0,-69.0,-63.0,-67.0,-68.0,-68.0,-63.0,-67.0,-68.0,-74.0,-82.0,-72.0,-78.0,5.0,19.0,5.0,10.0,1
262,CC:2F:71:3E:C5:1F,5526418,4450799552,3406537,4181755020,2119881,269044532,502,93144,7993820,78572,6266684,14572,1727136,21501,517,3413917,870548,502,2923,7222.0,1000.0,-69.0,-71.0,-66.0,-61.0,-68.0,-72.0,-65.0,-61.0,-74.0,-82.0,-72.0,-78.0,5.0,11.0,6.0,17.0,1
263,F8:59:71:5A:E0:3D,3349452,2112202788,1229570,1843158196,2119882,269044592,283,692399,842842391,691734,842762276,665,80115,682461,1815,1229661,132324,283,933,144444.0,43333.0,-66.0,-72.0,-64.0,-70.0,-66.0,-72.0,-63.0,-70.0,-74.0,-82.0,-72.0,-78.0,8.0,10.0,8.0,8.0,1
264,CC:2F:71:3F:1F:24,3845650,2540577319,1725766,2271532525,2119884,269044794,2525,1430158,1832777870,1429076,1832655610,1082,122260,1413733,5605,1725420,115367,2525,1640,115556.0,26000.0,-69.0,-63.0,-68.0,-68.0,-68.0,-63.0,-67.0,-68.0,-74.0,-82.0,-72.0,-78.0,5.0,19.0,4.0,10.0,1
265,CC:2F:71:3E:C5:1F,5526421,4450799814,3406537,4181755020,2119884,269044794,502,93144,7993820,78572,6266684,14572,1727136,21501,517,3413917,870548,502,2923,7222.0,1000.0,-69.0,-71.0,-66.0,-61.0,-68.0,-72.0,-65.0,-61.0,-74.0,-82.0,-72.0,-78.0,5.0,11.0,6.0,17.0,1
266,F8:59:71:5A:E0:3D,3349588,2112398200,1229697,1843352527,2119891,269045673,283,692489,842955884,691824,842875769,665,80115,682551,1815,1229788,132339,283,933,144444.0,43333.0,-67.0,-72.0,-64.0,-69.0,-66.0,-72.0,-63.0,-69.0,-74.0,-82.0,-72.0,-78.0,7.0,10.0,8.0,9.0,1
267,CC:2F:71:3F:1F:24,3845820,2540790212,1725929,2271744539,2119891,269045673,2525,1430306,1832982820,1429224,1832860560,1082,122260,1413880,5605,1725583,115527,2525,1641,104000.0,26000.0,-69.0,-63.0,-68.0,-68.0,-68.0,-63.0,-67.0,-68.0,-74.0,-82.0,-72.0,-78.0,5.0,19.0,4.0,10.0,1
268,CC:2F:71:3E:C5:1F,5526428,4450800693,3406537,4181755020,2119891,269045673,502,93144,7993820,78572,6266684,14572,1727136,21501,517,3413917,870548,502,2923,7222.0,1000.0,-69.0,-71.0,-66.0,-61.0,-68.0,-72.0,-65.0,-61.0,-74.0,-82.0,-72.0,-78.0,5.0,11.0,6.0,17.0,1
269,F8:59:71:5A:E0:3D,3349664,2112511624,1229770,1843465689,2119894,269045935,283,692561,843066764,691896,842986649,665,80115,682623,1815,1229861,132364,283,933,144444.0,43333.0,-66.0,-72.0,-64.0,-70.0,-66.0,-72.0,-63.0,-69.0,-74.0,-82.0,-72.0,-78.0,8.0,10.0,8.0,8.0,1
270,CC:2F:71:3F:1F:24,3845999,2541023082,1726105,2271977147,2119894,269045935,2525,1430470,1833210890,1429388,1833088630,1082,122260,1414042,5605,1725758,115710,2525,1641,57778.0,1000.0,-68.0,-64.0,-67.0,-68.0,-67.0,-63.0,-67.0,-68.0,-74.0,-82.0,-72.0,-78.0,6.0,18.0,5.0,10.0,1
271,CC:2F:71:3E:C5:1F,5526431,4450800955,3406537,4181755020,2119894,269045935,502,93144,7993820,78572,6266684,14572,1727136,21501,517,3413917,870548,502,2923,7222.0,1000.0,-69.0,-71.0,-66.0,-61.0,-68.0,-72.0,-65.0,-61.0,-74.0,-82.0,-72.0,-78.0,5.0,11.0,6.0,17.0,1
272,F8:59:71:5A:E0:3D,3349763,2112628871,1229841,1843571482,2119922,269057389,283,692633,843174149,691968,843094034,665,80115,682695,1815,1229931,132392,283,934,144444.0,43333.0,-69.0,-74.0,-65.0,-72.0,-67.0,-73.0,-63.0,-70.0,-74.0,-82.0,-72.0,-77.0,5.0,8.0,7.0,5.0,1
273,CC:2F:71:3F:1F:24,3846193,2541250222,1726271,2272192833,2119922,269057389,2525,1430620,1833417330,1429538,1833295070,1082,122260,1414192,5605,1725925,115806,2525,1641,78000.0,13000.0,-67.0,-64.0,-66.0,-69.0,-67.0,-64.0,-66.0,-69.0,-74.0,-82.0,-72.0,-77.0,7.0,18.0,6.0,8.0,1
274,CC:2F:71:3E:C5:1F,5526460,4450812469,3406538,4181755080,2119922,269057389,502,93144,7993820,78572,6266684,14572,1727136,21501,517,3413918,870548,502,2923,6500.0,1000.0,-69.0,-71.0,-66.0,-61.0,-68.0,-72.0,-65.0,-61.0,-74.0,-82.0,-72.0,-77.0,5.0,11.0,6.0,16.0,1
275,F8:59:71:5A:E0:3D,3349964,2112939130,1230042,1843881741,2119922,269057389,283,692724,843279151,692059,843199036,665,80115,682786,1815,1230133,132448,283,934,144444.0,43333.0,-67.0,-72.0,-64.0,-69.0,-66.0,-72.0,-63.0,-69.0,-74.0,-82.0,-72.0,-77.0,7.0,10.0,8.0,8.0,1
276,CC:2F:71:3F:1F:24,3846361,2541468276,1726437,2272410685,2119924,269057591,2525,1430775,1833630060,1429693,1833507800,1082,122260,1414346,5605,1726091,115867,2525,1641,86667.0,14444.0,-67.0,-63.0,-67.0,-68.0,-68.0,-62.0,-68.0,-68.0,-74.0,-82.0,-72.0,-77.0,7.0,19.0,5.0,9.0,1
277,CC:2F:71:3E:C5:1F,5526462,4450812671,3406538,4181755080,2119924,269057591,502,93144,7993820,78572,6266684,14572,1727136,21501,517,3413918,870548,502,2923,6500.0,1000.0,-69.0,-71.0,-66.0,-61.0,-68.0,-72.0,-65.0,-61.0,-74.0,-82.0,-72.0,-77.0,5.0,11.0,6.0,16.0,1
278,F8:59:71:5A:E0:3D,3350040,2113043892,1230109,1843985635,2119931,269058257,283,692790,843380791,692125,843300676,665,80115,682852,1815,1230200,132473,283,934,144444.0,43333.0,-66.0,-72.0,-63.0,-69.0,-66.0,-72.0,-64.0,-70.0,-74.0,-82.0,-72.0,-77.0,8.0,10.0,9.0,8.0,1
279,CC:2F:71:3F:1F:24,3846528,2541677582,1726597,2272619325,2119931,269058257,2525,1430918,1833828596,1429836,1833706336,1082,122260,1414489,5605,1726251,115921,2525,1641,86667.0,14444.0,-68.0,-64.0,-67.0,-69.0,-68.0,-63.0,-67.0,-68.0,-74.0,-82.0,-72.0,-77.0,6.0,18.0,5.0,8.0,1
280,CC:2F:71:3E:C5:1F,5526469,4450813337,3406538,4181755080,2119931,269058257,502,93144,7993820,78572,6266684,14572,1727136,21501,517,3413918,870548,502,2923,6500.0,1000.0,-69.0,-71.0,-66.0,-61.0,-68.0,-72.0,-65.0,-61.0,-74.0,-82.0,-72.0,-77.0,5.0,11.0,6.0,16.0,1
281,F8:59:71:5A:E0:3D,3350102,2113140240,1230171,1844081983,2119931,269058257,283,692853,843477811,692188,843397696,665,80115,682915,1815,1230262,132484,283,934,144444.0,43333.0,-66.0,-73.0,-63.0,-70.0,-66.0,-72.0,-63.0,-70.0,-74.0,-81.0,-71.0,-77.0,8.0,8.0,8.0,7.0,1
282,CC:2F:71:3F:1F:24,3846686,2541882274,1726755,2272824017,2119931,269058257,2525,1431061,1834025694,1429979,1833903434,1082,122260,1414631,5605,1726409,116018,2525,1641,86667.0,14444.0,-70.0,-63.0,-72.0,-70.0,-68.0,-63.0,-68.0,-69.0,-74.0,-81.0,-71.0,-77.0,4.0,18.0,-1.0,7.0,1
283,CC:2F:71:3E:C5:1F,5526469,4450813337,3406538,4181755080,2119931,269058257,502,93144,7993820,78572,6266684,14572,1727136,21501,517,3413918,870548,502,2923,6500.0,1000.0,-69.0,-71.0,-66.0,-61.0,-68.0,-72.0,-65.0,-61.0,-74.0,-81.0,-71.0,-77.0,5.0,10.0,5.0,16.0,1
284,F8:59:71:5A:E0:3D,3350171,2113241654,1230236,1844182993,2119935,269058661,283,692917,843576371,692252,843496256,665,80115,682979,1815,1230327,132494,283,934,144444.0,43333.0,-68.0,-74.0,-64.0,-71.0,-66.0,-72.0,-63.0,-70.0,-74.0,-81.0,-71.0,-77.0,6.0,7.0,7.0,6.0,1
285,CC:2F:71:3F:1F:24,3846848,2542087594,1726913,2273028933,2119935,269058661,2525,1431210,1834229198,1430128,1834106938,1082,122260,1414778,5605,1726567,116119,2525,1641,86667.0,14444.0,-70.0,-63.0,-72.0,-70.0,-69.0,-63.0,-71.0,-70.0,-74.0,-81.0,-71.0,-77.0,4.0,18.0,-1.0,7.0,1
286,CC:2F:71:3E:C5:1F,5526475,4450813943,3406538,4181755080,2119937,269058863,502,93144,7993820,78572,6266684,14572,1727136,21501,517,3413918,870548,502,2923,6500.0,1000.0,-69.0,-71.0,-66.0,-61.0,-68.0,-72.0,-65.0,-61.0,-74.0,-81.0,-71.0,-77.0,5.0,10.0,5.0,16.0,1
287,F8:59:71:5A:E0:3D,3350245,2113342361,1230305,1844283236,2119940,269059125,283,692984,843676256,692319,843596141,665,80115,683046,1815,1230395,132506,283,934,144444.0,43333.0,-66.0,-72.0,-64.0,-70.0,-66.0,-72.0,-63.0,-69.0,-74.0,-81.0,-71.0,-77.0,8.0,9.0,7.0,7.0,1
288,CC:2F:71:3F:1F:24,3847023,2542303238,1727083,2273244113,2119940,269059125,2525,1431365,1834433735,1430283,1834311475,1082,122260,1414933,5605,1726733,116224,2525,1641,86667.0,14444.0,-68.0,-63.0,-68.0,-69.0,-68.0,-63.0,-68.0,-69.0,-74.0,-81.0,-71.0,-77.0,6.0,18.0,3.0,8.0,1
289,CC:2F:71:3E:C5:1F,5526478,4450814205,3406538,4181755080,2119940,269059125,502,93144,7993820,78572,6266684,14572,1727136,21501,517,3413918,870548,502,2923,6500.0,1000.0,-69.0,-71.0,-66.0,-61.0,-68.0,-72.0,-65.0,-61.0,-72.0,-81.0,-70.0,-76.0,3.0,10.0,4.0,15.0,1
290,F8:59:71:5A:E0:3D,3350908,2114320330,1230963,1845260739,2119945,269059591,283,693165,843807356,692500,843727241,665,80115,683227,1815,1231054,132779,283,934,144444.0,43333.0,-67.0,-72.0,-63.0,-70.0,-66.0,-72.0,-63.0,-70.0,-72.0,-81.0,-70.0,-76.0,5.0,9.0,7.0,6.0,1
291,CC:2F:71:3F:1F:24,3847195,2542521254,1727250,2273461663,2119945,269059591,2525,1431521,1834646637,1430438,1834524259,1083,122378,1415088,5605,1726905,116380,2525,1641,78000.0,13000.0,-70.0,-63.0,-72.0,-70.0,-68.0,-63.0,-68.0,-69.0,-72.0,-81.0,-70.0,-76.0,2.0,18.0,-2.0,6.0,1
292,CC:2F:71:3E:C5:1F,5526483,4450814671,3406538,4181755080,2119945,269059591,502,93144,7993820,78572,6266684,14572,1727136,21501,517,3413918,870548,502,2923,6500.0,1000.0,-69.0,-71.0,-66.0,-61.0,-68.0,-72.0,-65.0,-61.0,-72.0,-81.0,-70.0,-76.0,3.0,10.0,4.0,15.0,1
293,F8:59:71:5A:E0:3D,3350982,2114428954,1231033,1845368959,2119949,269059995,283,693226,843901506,692561,843821391,665,80115,683288,1815,1231124,132832,283,935,144444.0,43333.0,-65.0,-72.0,-63.0,-69.0,-67.0,-73.0,-64.0,-70.0,-72.0,-81.0,-70.0,-76.0,7.0,9.0,7.0,7.0,1
294,CC:2F:71:3F:1F:24,3847367,2542739212,1727417,2273679157,2119950,269060055,2525,1431696,1834889063,1430613,1834766685,1083,122378,1415263,5605,1727074,116595,2525,1641,52000.0,1000.0,-70.0,-63.0,-72.0,-70.0,-68.0,-63.0,-67.0,-68.0,-72.0,-81.0,-70.0,-76.0,2.0,18.0,-2.0,6.0,1
295,CC:2F:71:3E:C5:1F,5526496,4450815943,3406538,4181755080,2119958,269060863,502,93144,7993820,78572,6266684,14572,1727136,21501,517,3413918,870548,502,2923,6500.0,1000.0,-69.0,-71.0,-66.0,-61.0,-68.0,-72.0,-65.0,-61.0,-72.0,-81.0,-70.0,-76.0,3.0,10.0,4.0,15.0,1
296,F8:59:71:5A:E0:3D,3351620,2115355355,1231639,1846292157,2119981,269063198,283,693740,844621519,693074,844541286,666,80233,683774,1815,1231730,133213,283,940,144444.0,43333.0,-68.0,-73.0,-65.0,-71.0,-67.0,-72.0,-64.0,-70.0,-72.0,-81.0,-70.0,-76.0,4.0,8.0,5.0,5.0,1
297,CC:2F:71:3F:1F:24,3848360,2544115734,1728377,2275052168,2119983,269063566,2525,1432653,1836261941,1431570,1836139563,1083,122378,1416162,5625,1728033,117171,2525,1643,39000.0,5500.0,-69.0,-63.0,-69.0,-70.0,-69.0,-63.0,-70.0,-69.0,-72.0,-81.0,-70.0,-76.0,3.0,18.0,1.0,6.0,1
298,CC:2F:71:3E:C5:1F,5526521,4450818646,3406538,4181755080,2119983,269063566,502,93145,7993938,78572,6266684,14573,1727254,21502,517,3413918,870548,502,2923,6500.0,1000.0,-68.0,-72.0,-65.0,-61.0,-67.0,-72.0,-64.0,-61.0,-72.0,-81.0,-70.0,-76.0,4.0,9.0,5.0,15.0,1
299,F8:59:71:5A:E0:3D,3351700,2115456729,1231713,1846392759,2119987,269063970,283,693816,844721806,693150,844641573,666,80233,683848,1815,1231804,133213,283,940,144444.0,43333.0,-67.0,-73.0,-64.0,-70.0,-67.0,-72.0,-64.0,-70.0,-73.0,-81.0,-70.0,-76.0,6.0,8.0,6.0,6.0,1
300,CC:2F:71:3F:1F:24,3848536,2544322922,1728549,2275258952,2119987,269063970,2525,1432810,1836461216,1431727,1836338838,1083,122378,1416319,5625,1728207,117171,2525,1643,78000.0,13000.0,-70.0,-64.0,-72.0,-71.0,-69.0,-63.0,-70.0,-70.0,-73.0,-81.0,-70.0,-76.0,3.0,17.0,-2.0,5.0,1
301,CC:2F:71:3E:C5:1F,5526526,4450819184,3406538,4181755080,2119988,269064104,502,93145,7993938,78572,6266684,14573,1727254,21502,517,3413918,870548,502,2923,6500.0,1000.0,-68.0,-72.0,-65.0,-61.0,-67.0,-72.0,-64.0,-61.0,-73.0,-81.0,-70.0,-76.0,5.0,9.0,5.0,15.0,1
302,F8:59:71:5A:E0:3D,3352085,2116004789,1232095,1846940557,2119990,269064232,283,693942,844836091,693276,844755858,666,80233,683974,1815,1232186,133253,283,940,144444.0,43333.0,-67.0,-73.0,-64.0,-70.0,-67.0,-73.0,-64.0,-70.0,-73.0,-81.0,-70.0,-76.0,6.0,8.0,6.0,6.0,1
303,CC:2F:71:3F:1F:24,3848701,2544531858,1728709,2275467424,2119992,269064434,2525,1432955,1836661394,1431872,1836539016,1083,122378,1416463,5625,1728365,117221,2525,1643,86667.0,13000.0,-69.0,-64.0,-69.0,-70.0,-69.0,-63.0,-69.0,-69.0,-73.0,-81.0,-70.0,-76.0,4.0,17.0,1.0,6.0,1
304,CC:2F:71:3E:C5:1F,5526530,4450819514,3406538,4181755080,2119992,269064434,502,93145,7993938,78572,6266684,14573,1727254,21502,517,3413918,870548,502,2923,6500.0,1000.0,-68.0,-72.0,-65.0,-61.0,-67.0,-72.0,-64.0,-61.0,-73.0,-81.0,-70.0,-76.0,5.0,9.0,5.0,15.0,1
305,F8:59:71:5A:E0:3D,3352153,2116104649,1232159,1847040013,2119994,269064636,283,694006,844934651,693340,844854418,666,80233,684038,1815,1232250,133255,283,940,144444.0,43333.0,-67.0,-73.0,-64.0,-70.0,-67.0,-73.0,-64.0,-70.0,-73.0,-81.0,-70.0,-76.0,6.0,8.0,6.0,6.0,1
306,CC:2F:71:3F:1F:24,3848863,2544737962,1728867,2275673124,2119996,269064838,2525,1433100,1836862996,1432017,1836740618,1083,122378,1416607,5625,1728525,117223,2525,1643,86667.0,14444.0,-69.0,-63.0,-69.0,-69.0,-68.0,-63.0,-68.0,-69.0,-73.0,-81.0,-70.0,-76.0,4.0,18.0,1.0,7.0,1
307,CC:2F:71:3E:C5:1F,5526534,4450819918,3406538,4181755080,2119996,269064838,502,93145,7993938,78572,6266684,14573,1727254,21502,517,3413918,870548,502,2923,6500.0,1000.0,-68.0,-72.0,-65.0,-61.0,-67.0,-72.0,-64.0,-61.0,-73.0,-81.0,-70.0,-76.0,5.0,9.0,5.0,15.0,1
308,F8:59:71:5A:E0:3D,3352221,2116204509,1232223,1847139469,2119998,269065040,283,694070,845033225,693404,844952992,666,80233,684101,1815,1232314,133256,283,940,144444.0,43333.0,-67.0,-73.0,-64.0,-70.0,-67.0,-73.0,-64.0,-70.0,-73.0,-81.0,-70.0,-76.0,6.0,8.0,6.0,6.0,1
309,CC:2F:71:3F:1F:24,3849031,2544948013,1729033,2275882973,2119998,269065040,2525,1433253,1837064789,1432170,1836942411,1083,122378,1416759,5625,1728691,117238,2525,1643,86667.0,14444.0,-69.0,-63.0,-69.0,-70.0,-68.0,-63.0,-68.0,-69.0,-73.0,-81.0,-70.0,-76.0,4.0,18.0,1.0,6.0,1
310,CC:2F:71:3E:C5:1F,5526536,4450820120,3406538,4181755080,2119998,269065040,502,93145,7993938,78572,6266684,14573,1727254,21502,517,3413918,870548,502,2923,6500.0,1000.0,-68.0,-72.0,-65.0,-61.0,-67.0,-72.0,-64.0,-61.0,-73.0,-81.0,-70.0,-76.0,5.0,9.0,5.0,15.0,1
311,F8:59:71:5A:E0:3D,3352288,2116301321,1232285,1847235817,2120003,269065504,283,694134,845131785,693468,845051552,666,80233,684165,1815,1232376,133256,283,940,144444.0,43333.0,-67.0,-73.0,-64.0,-70.0,-66.0,-73.0,-64.0,-70.0,-73.0,-81.0,-70.0,-76.0,6.0,8.0,6.0,6.0,1
312,CC:2F:71:3F:1F:24,3849195,2545155507,1729192,2276090003,2120003,269065504,2525,1433399,1837263645,1432316,1837141267,1083,122378,1416905,5625,1728850,117275,2525,1643,104000.0,26000.0,-69.0,-63.0,-69.0,-69.0,-68.0,-63.0,-68.0,-69.0,-73.0,-81.0,-70.0,-76.0,4.0,18.0,1.0,7.0,1
313,CC:2F:71:3E:C5:1F,5526541,4450820584,3406538,4181755080,2120003,269065504,502,93145,7993938,78572,6266684,14573,1727254,21502,517,3413918,870548,502,2923,6500.0,1000.0,-68.0,-72.0,-65.0,-61.0,-67.0,-72.0,-64.0,-61.0,-73.0,-81.0,-70.0,-76.0,5.0,9.0,5.0,15.0,1
314,F8:59:71:5A:E0:3D,3352640,2116838886,1232633,1847772978,2120007,269065908,283,694264,845246572,693598,845166339,666,80233,684295,1815,1232724,133257,283,940,144444.0,43333.0,-68.0,-73.0,-64.0,-71.0,-67.0,-73.0,-64.0,-70.0,-73.0,-81.0,-71.0,-76.0,5.0,8.0,7.0,5.0,1
315,CC:2F:71:3F:1F:24,3849358,2545362127,1729351,2276296219,2120007,269065908,2525,1433543,1837460859,1432460,1837338481,1083,122378,1417048,5625,1729009,117345,2525,1643,115556.0,28889.0,-69.0,-64.0,-70.0,-70.0,-68.0,-63.0,-69.0,-69.0,-73.0,-81.0,-71.0,-76.0,4.0,17.0,1.0,6.0,1
316,CC:2F:71:3E:C5:1F,5526545,4450820988,3406538,4181755080,2120007,269065908,502,93145,7993938,78572,6266684,14573,1727254,21502,517,3413918,870548,502,2923,6500.0,1000.0,-68.0,-72.0,-65.0,-61.0,-67.0,-72.0,-64.0,-61.0,-73.0,-81.0,-71.0,-76.0,5.0,9.0,6.0,15.0,1
317,F8:59:71:5A:E0:3D,3352971,2117300209,1232951,1848233029,2120020,269067180,283,694493,845578751,693827,845498518,666,80233,684517,1815,1233042,133304,283,941,144444.0,43333.0,-67.0,-73.0,-64.0,-70.0,-67.0,-73.0,-64.0,-70.0,-73.0,-80.0,-71.0,-76.0,6.0,7.0,7.0,6.0,1
318,CC:2F:71:3F:1F:24,3849824,2546021533,1729804,2276954353,2120020,269067180,2525,1433992,1838119603,1432909,1837997225,1083,122378,1417493,5625,1729463,117649,2525,1648,57778.0,6500.0,-68.0,-63.0,-69.0,-70.0,-68.0,-63.0,-69.0,-69.0,-73.0,-80.0,-71.0,-76.0,5.0,17.0,2.0,6.0,1
319,CC:2F:71:3E:C5:1F,5526558,4450822260,3406538,4181755080,2120020,269067180,502,93145,7993938,78572,6266684,14573,1727254,21502,517,3413918,870548,502,2923,6500.0,1000.0,-68.0,-72.0,-65.0,-61.0,-67.0,-72.0,-64.0,-61.0,-73.0,-80.0,-71.0,-76.0,5.0,8.0,6.0,15.0,1
320,F8:59:71:5A:E0:3D,3353039,2117398575,1233014,1848330931,2120025,269067644,283,694556,845675771,693890,845595538,666,80233,684580,1815,1233105,133304,283,941,144444.0,43333.0,-68.0,-73.0,-64.0,-70.0,-67.0,-73.0,-63.0,-70.0,-73.0,-80.0,-71.0,-76.0,5.0,7.0,7.0,6.0,1
321,CC:2F:71:3F:1F:24,3849989,2546227677,1729964,2277160033,2120025,269067644,2525,1434138,1838317098,1433055,1838194720,1083,122378,1417639,5625,1729623,117672,2525,1648,115556.0,28889.0,-68.0,-63.0,-69.0,-69.0,-68.0,-63.0,-69.0,-69.0,-73.0,-80.0,-71.0,-76.0,5.0,17.0,2.0,7.0,1
322,CC:2F:71:3E:C5:1F,5526563,4450822724,3406538,4181755080,2120025,269067644,502,93145,7993938,78572,6266684,14573,1727254,21502,517,3413918,870548,502,2923,6500.0,1000.0,-68.0,-72.0,-65.0,-61.0,-67.0,-72.0,-64.0,-61.0,-73.0,-80.0,-71.0,-76.0,5.0,8.0,6.0,15.0,1
323,F8:59:71:5A:E0:3D,3353106,2117496881,1233077,1848428833,2120029,269068048,283,694619,845772791,693953,845692558,666,80233,684643,1815,1233168,133304,283,941,144444.0,43333.0,-67.0,-73.0,-64.0,-71.0,-67.0,-73.0,-64.0,-70.0,-73.0,-80.0,-71.0,-77.0,6.0,7.0,7.0,6.0,1
324,CC:2F:71:3F:1F:24,3850153,2546434472,1730124,2277366424,2120029,269068048,2525,1434284,1838514569,1433201,1838392191,1083,122378,1417785,5625,1729783,117699,2525,1648,115556.0,28889.0,-68.0,-63.0,-69.0,-70.0,-68.0,-63.0,-68.0,-69.0,-73.0,-80.0,-71.0,-77.0,5.0,17.0,2.0,7.0,1
325,CC:2F:71:3E:C5:1F,5526567,4450823128,3406538,4181755080,2120029,269068048,502,93145,7993938,78572,6266684,14573,1727254,21502,517,3413918,870548,502,2923,6500.0,1000.0,-68.0,-72.0,-65.0,-61.0,-67.0,-72.0,-64.0,-61.0,-73.0,-80.0,-71.0,-77.0,5.0,8.0,6.0,16.0,1
326,F8:59:71:5A:E0:3D,3353176,2117597269,1233144,1848528746,2120032,269068523,283,694687,845873764,694021,845793531,666,80233,684711,1815,1233235,133304,283,941,144444.0,43333.0,-67.0,-73.0,-64.0,-71.0,-67.0,-73.0,-64.0,-70.0,-73.0,-80.0,-71.0,-77.0,6.0,7.0,7.0,6.0,1
327,CC:2F:71:3F:1F:24,3850316,2546640961,1730282,2277572236,2120034,269068725,2525,1434428,1838713193,1433345,1838590815,1083,122378,1417929,5625,1729941,117750,2525,1648,86667.0,14444.0,-69.0,-63.0,-70.0,-69.0,-68.0,-63.0,-68.0,-69.0,-73.0,-80.0,-71.0,-77.0,4.0,17.0,1.0,8.0,1
328,CC:2F:71:3E:C5:1F,5526572,4450823805,3406538,4181755080,2120034,269068725,502,93145,7993938,78572,6266684,14573,1727254,21502,517,3413918,870548,502,2923,6500.0,1000.0,-68.0,-72.0,-65.0,-61.0,-67.0,-72.0,-64.0,-61.0,-73.0,-80.0,-71.0,-77.0,5.0,8.0,6.0,16.0,1
329,F8:59:71:5A:E0:3D,3353253,2117698310,1233214,1848629121,2120039,269069189,283,694754,845972482,694088,845892249,666,80233,684778,1815,1233305,133304,283,941,144444.0,43333.0,-67.0,-73.0,-64.0,-71.0,-67.0,-73.0,-63.0,-70.0,-73.0,-80.0,-71.0,-77.0,6.0,7.0,7.0,6.0,1
330,CC:2F:71:3F:1F:24,3850484,2546848041,1730445,2277778852,2120039,269069189,2525,1434572,1838909107,1433489,1838786729,1083,122378,1418073,5625,1730104,117750,2525,1648,86667.0,14444.0,-69.0,-63.0,-69.0,-70.0,-68.0,-63.0,-68.0,-70.0,-73.0,-80.0,-71.0,-77.0,4.0,17.0,2.0,7.0,1
331,CC:2F:71:3E:C5:1F,5526577,4450824269,3406538,4181755080,2120039,269069189,502,93145,7993938,78572,6266684,14573,1727254,21502,517,3413918,870548,502,2923,6500.0,1000.0,-68.0,-72.0,-65.0,-61.0,-67.0,-72.0,-64.0,-61.0,-73.0,-80.0,-71.0,-77.0,5.0,8.0,6.0,16.0,1
332,F8:59:71:5A:E0:3D,3353317,2117794860,1233276,1848725469,2120041,269069391,283,694817,846069502,694151,845989269,666,80233,684841,1815,1233367,133304,283,941,144444.0,43333.0,-67.0,-73.0,-63.0,-70.0,-66.0,-73.0,-63.0,-70.0,-73.0,-81.0,-71.0,-77.0,6.0,8.0,8.0,7.0,1
333,CC:2F:71:3F:1F:24,3850648,2547054474,1730607,2277985083,2120041,269069391,2525,1434717,1839106452,1433634,1838984074,1083,122378,1418218,5625,1730266,117792,2525,1648,115556.0,28889.0,-69.0,-63.0,-69.0,-70.0,-68.0,-63.0,-68.0,-69.0,-73.0,-81.0,-71.0,-77.0,4.0,18.0,2.0,7.0,1
334,CC:2F:71:3E:C5:1F,5526580,4450824531,3406539,4181755140,2120041,269069391,502,93145,7993938,78572,6266684,14573,1727254,21502,517,3413919,870548,502,2923,6500.0,1000.0,-68.0,-72.0,-65.0,-61.0,-67.0,-72.0,-64.0,-61.0,-73.0,-81.0,-71.0,-77.0,5.0,9.0,6.0,16.0,1
335,F8:59:71:5A:E0:3D,3353391,2117894043,1233345,1848824186,2120046,269069857,283,694889,846170836,694222,846090485,667,80351,684913,1815,1233436,133305,283,941,144444.0,43333.0,-66.0,-73.0,-64.0,-70.0,-66.0,-73.0,-63.0,-70.0,-73.0,-81.0,-71.0,-77.0,7.0,8.0,7.0,7.0,1
336,CC:2F:71:3F:1F:24,3850823,2547274040,1730775,2278203981,2120048,269070059,2525,1434872,1839316434,1433789,1839194056,1083,122378,1418373,5625,1730434,117833,2525,1649,115556.0,28889.0,-68.0,-63.0,-68.0,-70.0,-68.0,-63.0,-68.0,-69.0,-73.0,-81.0,-71.0,-77.0,5.0,18.0,3.0,7.0,1
337,CC:2F:71:3E:C5:1F,5526587,4450825199,3406539,4181755140,2120048,269070059,502,93145,7993938,78572,6266684,14573,1727254,21502,517,3413919,870548,502,2923,6500.0,1000.0,-68.0,-72.0,-65.0,-61.0,-67.0,-72.0,-64.0,-61.0,-73.0,-81.0,-71.0,-77.0,5.0,9.0,6.0,16.0,1
338,F8:59:71:5A:E0:3D,3353891,2118619868,1233840,1849549547,2120051,269070321,283,695046,846297711,694379,846217360,667,80351,685070,1815,1233931,133308,283,941,144444.0,43333.0,-67.0,-74.0,-63.0,-70.0,-66.0,-72.0,-63.0,-70.0,-73.0,-81.0,-71.0,-77.0,6.0,7.0,8.0,7.0,1
339,CC:2F:71:3F:1F:24,3850988,2547486834,1730937,2278416513,2120051,269070321,2525,1435019,1839519678,1433936,1839397300,1083,122378,1418520,5625,1730596,117858,2525,1649,115556.0,28889.0,-69.0,-64.0,-69.0,-70.0,-68.0,-63.0,-68.0,-70.0,-73.0,-81.0,-71.0,-77.0,4.0,17.0,2.0,7.0,1
340,CC:2F:71:3E:C5:1F,5526590,4450825461,3406539,4181755140,2120051,269070321,502,93145,7993938,78572,6266684,14573,1727254,21502,517,3413919,870548,502,2923,6500.0,1000.0,-68.0,-72.0,-65.0,-61.0,-67.0,-72.0,-64.0,-61.0,-73.0,-81.0,-71.0,-77.0,5.0,9.0,6.0,16.0,1
341,F8:59:71:5A:E0:3D,3353956,2118717972,1233903,1849647449,2120053,269070523,283,695108,846393191,694441,846312840,667,80351,685132,1815,1233994,133308,283,941,144444.0,43333.0,-67.0,-73.0,-64.0,-71.0,-66.0,-72.0,-63.0,-70.0,-73.0,-81.0,-71.0,-77.0,6.0,8.0,7.0,6.0,1
342,CC:2F:71:3F:1F:24,3851149,2547691776,1731094,2278621051,2120055,269070725,2525,1435160,1839715106,1434077,1839592728,1083,122378,1418661,5625,1730752,117907,2525,1649,115556.0,28889.0,-68.0,-63.0,-68.0,-69.0,-68.0,-63.0,-67.0,-69.0,-73.0,-81.0,-71.0,-77.0,5.0,18.0,3.0,8.0,1
343,CC:2F:71:3E:C5:1F,5526596,4450826067,3406539,4181755140,2120057,269070927,502,93145,7993938,78572,6266684,14573,1727254,21502,517,3413919,870548,502,2923,6500.0,1000.0,-68.0,-72.0,-65.0,-61.0,-67.0,-72.0,-64.0,-61.0,-73.0,-81.0,-71.0,-77.0,5.0,9.0,6.0,16.0,1
344,F8:59:71:5A:E0:3D,3354034,2118819252,1233975,1849748123,2120059,269071129,283,695179,846495227,694512,846414876,667,80351,685203,1815,1234066,133313,283,941,144444.0,43333.0,-66.0,-72.0,-63.0,-69.0,-66.0,-72.0,-63.0,-69.0,-73.0,-81.0,-71.0,-77.0,7.0,9.0,8.0,8.0,1
345,CC:2F:71:3F:1F:24,3851316,2547905314,1731257,2278834185,2120059,269071129,2525,1435307,1839918476,1434224,1839796098,1083,122378,1418808,5625,1730914,117964,2525,1649,117000.0,39000.0,-67.0,-63.0,-67.0,-69.0,-67.0,-63.0,-67.0,-69.0,-73.0,-81.0,-71.0,-77.0,6.0,18.0,4.0,8.0,1
346,CC:2F:71:3E:C5:1F,5526598,4450826269,3406539,4181755140,2120059,269071129,502,93145,7993938,78572,6266684,14573,1727254,21502,517,3413919,870548,502,2923,6500.0,1000.0,-68.0,-72.0,-65.0,-61.0,-67.0,-72.0,-64.0,-61.0,-73.0,-81.0,-71.0,-77.0,5.0,9.0,6.0,16.0,1
347,F8:59:71:5A:E0:3D,3354100,2118917416,1234038,1849846025,2120062,269071391,283,695242,846592247,694575,846511896,667,80351,685266,1815,1234129,133314,283,941,144444.0,43333.0,-66.0,-72.0,-63.0,-70.0,-66.0,-72.0,-63.0,-70.0,-73.0,-81.0,-71.0,-77.0,7.0,9.0,8.0,7.0,1
348,CC:2F:71:3F:1F:24,3851475,2548108112,1731413,2279036721,2120062,269071391,2525,1435449,1840115444,1434366,1839993066,1083,122378,1418950,5625,1731072,118028,2525,1649,115556.0,28889.0,-68.0,-63.0,-68.0,-69.0,-68.0,-63.0,-67.0,-69.0,-73.0,-81.0,-71.0,-77.0,5.0,18.0,3.0,8.0,1
349,CC:2F:71:3E:C5:1F,5526601,4450826531,3406539,4181755140,2120062,269071391,502,93145,7993938,78572,6266684,14573,1727254,21502,517,3413919,870548,502,2923,6500.0,1000.0,-68.0,-72.0,-65.0,-61.0,-67.0,-72.0,-64.0,-61.0,-73.0,-81.0,-71.0,-77.0,5.0,9.0,6.0,16.0,1
350,F8:59:71:5A:E0:3D,3354246,2119134695,1234179,1850062838,2120067,269071857,283,695328,846695246,694661,846614895,667,80351,685352,1815,1234270,133315,283,941,144444.0,43333.0,-66.0,-73.0,-63.0,-69.0,-66.0,-72.0,-63.0,-69.0,-73.0,-81.0,-71.0,-77.0,7.0,8.0,8.0,8.0,1
351,CC:2F:71:3F:1F:24,3851638,2548314670,1731571,2279242813,2120067,269071857,2525,1435591,1840310990,1434507,1840188494,1084,122496,1419092,5625,1731230,118083,2525,1649,115556.0,28889.0,-68.0,-63.0,-68.0,-69.0,-68.0,-63.0,-67.0,-69.0,-73.0,-81.0,-71.0,-77.0,5.0,18.0,3.0,8.0,1
352,CC:2F:71:3E:C5:1F,5526608,4450827199,3406539,4181755140,2120069,269072059,502,93145,7993938,78572,6266684,14573,1727254,21502,517,3413919,870548,502,2923,6500.0,1000.0,-68.0,-72.0,-65.0,-61.0,-67.0,-72.0,-64.0,-61.0,-73.0,-81.0,-71.0,-77.0,5.0,9.0,6.0,16.0,1
353,F8:59:71:5A:E0:3D,3354313,2119233001,1234242,1850160740,2120071,269072261,283,695391,846792266,694724,846711915,667,80351,685415,1815,1234333,133316,283,941,144444.0,43333.0,-66.0,-72.0,-64.0,-70.0,-66.0,-72.0,-63.0,-70.0,-73.0,-81.0,-71.0,-77.0,7.0,9.0,7.0,7.0,1
354,CC:2F:71:3F:1F:24,3851802,2548523826,1731731,2279451565,2120071,269072261,2525,1435735,1840509614,1434651,1840387118,1084,122496,1419236,5625,1731388,118151,2525,1649,86667.0,13000.0,-68.0,-63.0,-67.0,-70.0,-68.0,-63.0,-67.0,-70.0,-73.0,-81.0,-71.0,-77.0,5.0,18.0,4.0,7.0,1
355,CC:2F:71:3E:C5:1F,5526610,4450827401,3406539,4181755140,2120071,269072261,502,93145,7993938,78572,6266684,14573,1727254,21502,517,3413919,870548,502,2923,6500.0,1000.0,-68.0,-72.0,-65.0,-61.0,-67.0,-72.0,-64.0,-61.0,-73.0,-81.0,-71.0,-77.0,5.0,9.0,6.0,16.0,1
356,F8:59:71:5A:E0:3D,3354387,2119336487,1234311,1850263762,2120076,269072725,283,695461,846897723,694794,846817372,667,80351,685485,1815,1234402,133321,283,942,144444.0,43333.0,-66.0,-73.0,-63.0,-69.0,-66.0,-72.0,-63.0,-69.0,-73.0,-81.0,-71.0,-77.0,7.0,8.0,8.0,8.0,1
357,CC:2F:71:3F:1F:24,3851969,2548735366,1731893,2279662641,2120076,269072725,2525,1435887,1840720586,1434803,1840598090,1084,122496,1419386,5625,1731551,118285,2525,1649,78000.0,13000.0,-67.0,-63.0,-67.0,-69.0,-67.0,-63.0,-67.0,-69.0,-73.0,-81.0,-71.0,-77.0,6.0,18.0,4.0,8.0,1
358,CC:2F:71:3E:C5:1F,5526615,4450827865,3406539,4181755140,2120076,269072725,502,93145,7993938,78572,6266684,14573,1727254,21502,517,3413919,870548,502,2923,6500.0,1000.0,-68.0,-72.0,-65.0,-61.0,-67.0,-72.0,-64.0,-61.0,-73.0,-81.0,-71.0,-77.0,5.0,9.0,6.0,16.0,1
359,F8:59:71:5A:E0:3D,3354462,2119444295,1234381,1850371104,2120081,269073191,283,695530,847002577,694863,846922226,667,80351,685554,1815,1234472,133332,283,943,144444.0,43333.0,-66.0,-73.0,-63.0,-69.0,-65.0,-72.0,-63.0,-69.0,-73.0,-81.0,-71.0,-77.0,7.0,8.0,8.0,8.0,1
360,CC:2F:71:3F:1F:24,3852160,2548965105,1732079,2279891914,2120081,269073191,2525,1436059,1840939853,1434975,1840817357,1084,122496,1419558,5625,1731737,118422,2525,1653,104000.0,26000.0,-68.0,-63.0,-68.0,-69.0,-67.0,-63.0,-67.0,-69.0,-73.0,-81.0,-71.0,-77.0,5.0,18.0,3.0,8.0,1
361,CC:2F:71:3E:C5:1F,5526620,4450828331,3406539,4181755140,2120081,269073191,502,93146,7994056,78572,6266684,14574,1727372,21503,517,3413919,870548,502,2923,6500.0,1000.0,-70.0,-72.0,-66.0,-61.0,-67.0,-72.0,-65.0,-61.0,-73.0,-81.0,-71.0,-77.0,3.0,9.0,5.0,16.0,1
362,F8:59:71:5A:E0:3D,3354724,2119844420,1234638,1850770765,2120086,269073655,283,695625,847111308,694958,847030957,667,80351,685649,1815,1234729,133380,283,943,144444.0,43333.0,-66.0,-73.0,-63.0,-70.0,-66.0,-72.0,-63.0,-69.0,-73.0,-81.0,-71.0,-77.0,7.0,8.0,8.0,7.0,1
363,CC:2F:71:3F:1F:24,3852337,2549192265,1732251,2280118610,2120086,269073655,2525,1436223,1841165129,1435139,1841042633,1084,122496,1419721,5625,1731910,118693,2525,1653,104000.0,1000.0,-67.0,-63.0,-67.0,-70.0,-67.0,-63.0,-67.0,-69.0,-73.0,-81.0,-71.0,-77.0,6.0,18.0,4.0,7.0,1
364,CC:2F:71:3E:C5:1F,5526627,4450828997,3406539,4181755140,2120088,269073857,502,93146,7994056,78572,6266684,14574,1727372,21503,517,3413919,870548,502,2923,6500.0,1000.0,-70.0,-72.0,-66.0,-61.0,-67.0,-72.0,-65.0,-61.0,-73.0,-81.0,-71.0,-77.0,3.0,9.0,5.0,16.0,1
365,F8:59:71:5A:E0:3D,3354852,2120006220,1234762,1850932161,2120090,269074059,283,695722,847232571,695055,847152220,667,80351,685746,1815,1234853,133389,283,943,144444.0,43333.0,-66.0,-72.0,-63.0,-70.0,-66.0,-72.0,-62.0,-69.0,-73.0,-81.0,-71.0,-77.0,7.0,9.0,8.0,7.0,1
366,CC:2F:71:3F:1F:24,3852513,2549417405,1732423,2280343346,2120090,269074059,2525,1436379,1841377961,1435295,1841255465,1084,122496,1419877,5625,1732084,118911,2525,1653,65000.0,13000.0,-68.0,-64.0,-67.0,-70.0,-67.0,-63.0,-67.0,-69.0,-73.0,-81.0,-71.0,-77.0,5.0,17.0,4.0,7.0,1
367,CC:2F:71:3E:C5:1F,5526629,4450829199,3406539,4181755140,2120090,269074059,502,93146,7994056,78572,6266684,14574,1727372,21503,517,3413919,870548,502,2923,6500.0,1000.0,-70.0,-72.0,-66.0,-61.0,-67.0,-72.0,-65.0,-61.0,-73.0,-81.0,-71.0,-77.0,3.0,9.0,5.0,16.0,1
368,F8:59:71:5A:E0:3D,3354927,2120108582,1234832,1851033846,2120095,269074736,283,695780,847318557,695113,847238206,667,80351,685804,1815,1234923,133401,283,943,144444.0,43333.0,-67.0,-73.0,-63.0,-70.0,-66.0,-72.0,-63.0,-69.0,-73.0,-81.0,-71.0,-77.0,6.0,8.0,8.0,7.0,1
369,CC:2F:71:3F:1F:24,3852693,2549647280,1732598,2280572544,2120095,269074736,2525,1436545,1841603349,1435461,1841480853,1084,122496,1420041,5625,1732257,119113,2525,1653,78000.0,1000.0,-67.0,-63.0,-66.0,-69.0,-67.0,-63.0,-67.0,-69.0,-73.0,-81.0,-71.0,-77.0,6.0,18.0,5.0,8.0,1
370,CC:2F:71:3E:C5:1F,5526634,4450829876,3406539,4181755140,2120095,269074736,502,93146,7994056,78572,6266684,14574,1727372,21503,517,3413919,870548,502,2923,6500.0,1000.0,-70.0,-72.0,-66.0,-61.0,-67.0,-72.0,-65.0,-61.0,-73.0,-81.0,-71.0,-77.0,3.0,9.0,5.0,16.0,1
371,F8:59:71:5A:E0:3D,3355199,2120516877,1235097,1851441467,2120102,269075410,283,695906,847461133,695239,847380782,667,80351,685930,1815,1235188,133446,283,943,144444.0,43333.0,-65.0,-72.0,-63.0,-69.0,-65.0,-72.0,-62.0,-69.0,-73.0,-81.0,-71.0,-77.0,8.0,9.0,8.0,8.0,1
372,CC:2F:71:3F:1F:24,3852870,2549871126,1732768,2280795716,2120102,269075410,2525,1436704,1841816793,1435618,1841693975,1086,122818,1420198,5625,1732429,119273,2525,1654,78000.0,13000.0,-67.0,-63.0,-67.0,-69.0,-67.0,-63.0,-66.0,-69.0,-73.0,-81.0,-71.0,-77.0,6.0,18.0,4.0,8.0,1
373,CC:2F:71:3E:C5:1F,5526641,4450830550,3406539,4181755140,2120102,269075410,502,93146,7994056,78572,6266684,14574,1727372,21503,517,3413919,870548,502,2923,6500.0,1000.0,-70.0,-72.0,-66.0,-61.0,-67.0,-72.0,-65.0,-61.0,-73.0,-81.0,-71.0,-77.0,3.0,9.0,5.0,16.0,1
374,F8:59:71:5A:E0:3D,3355267,2120616737,1235161,1851540923,2120106,269075814,283,695969,847558153,695302,847477802,667,80351,685993,1815,1235252,133454,283,943,144444.0,43333.0,-67.0,-73.0,-62.0,-70.0,-65.0,-72.0,-62.0,-69.0,-73.0,-81.0,-71.0,-77.0,6.0,8.0,9.0,7.0,1
375,CC:2F:71:3F:1F:24,3853037,2550079409,1732931,2281003595,2120106,269075814,2525,1436852,1842017334,1435766,1841894516,1086,122818,1420346,5625,1732592,119431,2525,1654,117000.0,1000.0,-68.0,-63.0,-68.0,-70.0,-67.0,-63.0,-67.0,-69.0,-73.0,-81.0,-71.0,-77.0,5.0,18.0,3.0,7.0,1
376,CC:2F:71:3E:C5:1F,5526645,4450830954,3406539,4181755140,2120106,269075814,502,93146,7994056,78572,6266684,14574,1727372,21503,517,3413919,870548,502,2923,6500.0,1000.0,-70.0,-72.0,-66.0,-61.0,-67.0,-72.0,-65.0,-61.0,-73.0,-81.0,-71.0,-77.0,3.0,9.0,5.0,16.0,1
377,F8:59:71:5A:E0:3D,3355342,2120727475,1235232,1851651257,2120110,269076218,283,696041,847669033,695374,847588682,667,80351,686065,1815,1235323,133464,283,943,144444.0,43333.0,-65.0,-72.0,-62.0,-69.0,-65.0,-72.0,-62.0,-69.0,-73.0,-81.0,-71.0,-77.0,8.0,9.0,9.0,8.0,1
378,CC:2F:71:3F:1F:24,3853219,2550312805,1733109,2281236587,2120110,269076218,2525,1437016,1842241340,1435930,1842118522,1086,122818,1420510,5625,1732774,119664,2525,1654,39000.0,5500.0,-67.0,-63.0,-67.0,-69.0,-67.0,-63.0,-67.0,-69.0,-73.0,-81.0,-71.0,-77.0,6.0,18.0,4.0,8.0,1
379,CC:2F:71:3E:C5:1F,5526650,4450831418,3406539,4181755140,2120111,269076278,502,93146,7994056,78572,6266684,14574,1727372,21503,518,3413920,870549,502,2923,6500.0,1000.0,-70.0,-72.0,-66.0,-61.0,-67.0,-72.0,-65.0,-61.0,-73.0,-81.0,-71.0,-77.0,3.0,9.0,5.0,16.0,1
380,F8:59:71:5A:E0:3D,3355426,2120850593,1235311,1851773911,2120115,269076682,283,696119,847789153,695452,847708802,667,80351,686143,1815,1235402,133475,283,943,144444.0,39000.0,-66.0,-72.0,-63.0,-70.0,-66.0,-72.0,-62.0,-69.0,-73.0,-81.0,-71.0,-77.0,7.0,9.0,8.0,7.0,1
381,CC:2F:71:3F:1F:24,3853413,2550564895,1733298,2281488213,2120115,269076682,2525,1437193,1842487014,1436107,1842364196,1086,122818,1420687,5625,1732963,119780,2525,1657,78000.0,13000.0,-67.0,-63.0,-67.0,-70.0,-67.0,-63.0,-67.0,-69.0,-73.0,-81.0,-71.0,-77.0,6.0,18.0,4.0,7.0,1
382,CC:2F:71:3E:C5:1F,5526654,4450831822,3406539,4181755140,2120115,269076682,502,93146,7994056,78572,6266684,14574,1727372,21503,518,3413920,870549,502,2923,6500.0,1000.0,-70.0,-72.0,-66.0,-61.0,-67.0,-72.0,-65.0,-61.0,-73.0,-81.0,-71.0,-77.0,3.0,9.0,5.0,16.0,1
383,F8:59:71:5A:E0:3D,3355696,2121228250,1235577,1852151164,2120119,269077086,283,696228,847907536,695561,847827185,667,80351,686252,1815,1235664,133538,283,943,144444.0,43333.0,-66.0,-73.0,-63.0,-69.0,-65.0,-72.0,-63.0,-69.0,-73.0,-81.0,-71.0,-77.0,7.0,8.0,8.0,8.0,1
384,CC:2F:71:3F:1F:24,3853600,2550807191,1733479,2281729903,2120121,269077288,2525,1437364,1842721602,1436278,1842598784,1086,122818,1420856,5625,1733145,119986,2525,1657,78000.0,13000.0,-67.0,-63.0,-67.0,-69.0,-67.0,-63.0,-67.0,-69.0,-74.0,-81.0,-71.0,-77.0,7.0,18.0,4.0,8.0,1
385,CC:2F:71:3E:C5:1F,5526660,4450832428,3406539,4181755140,2120121,269077288,502,93146,7994056,78572,6266684,14574,1727372,21503,518,3413920,870549,502,2923,6500.0,1000.0,-70.0,-72.0,-66.0,-61.0,-67.0,-72.0,-65.0,-61.0,-74.0,-81.0,-71.0,-77.0,4.0,9.0,5.0,16.0,1
386,F8:59:71:5A:E0:3D,3355772,2121339048,1235648,1852261498,2120124,269077550,283,696296,848012256,695629,847931905,667,80351,686320,1815,1235739,133544,283,943,144444.0,43333.0,-65.0,-73.0,-63.0,-70.0,-65.0,-72.0,-63.0,-69.0,-74.0,-81.0,-71.0,-77.0,9.0,8.0,8.0,7.0,1
387,CC:2F:71:3F:1F:24,3853763,2551015533,1733639,2281937983,2120124,269077550,2525,1437511,1842924944,1436425,1842802126,1086,122818,1421002,5625,1733307,120165,2525,1657,115556.0,26000.0,-68.0,-63.0,-67.0,-69.0,-67.0,-63.0,-66.0,-69.0,-74.0,-81.0,-71.0,-77.0,6.0,18.0,4.0,8.0,1
388,CC:2F:71:3E:C5:1F,5526663,4450832690,3406539,4181755140,2120124,269077550,502,93146,7994056,78572,6266684,14574,1727372,21503,518,3413920,870549,502,2923,6500.0,1000.0,-70.0,-72.0,-66.0,-61.0,-67.0,-72.0,-65.0,-61.0,-74.0,-81.0,-71.0,-77.0,4.0,9.0,5.0,16.0,1
389,F8:59:71:5A:E0:3D,3356133,2121893354,1236005,1852815400,2120128,269077954,283,696420,848123035,695753,848042684,667,80351,686444,1815,1236096,133684,283,943,144444.0,43333.0,-66.0,-72.0,-63.0,-69.0,-65.0,-72.0,-63.0,-69.0,-74.0,-81.0,-71.0,-77.0,8.0,9.0,8.0,8.0,1
390,CC:2F:71:3F:1F:24,3853927,2551223625,1733799,2282145671,2120128,269077954,2525,1437656,1843123712,1436570,1843000894,1086,122818,1421147,5625,1733467,120318,2525,1657,86667.0,14444.0,-67.0,-63.0,-67.0,-69.0,-67.0,-63.0,-67.0,-69.0,-74.0,-81.0,-71.0,-77.0,7.0,18.0,4.0,8.0,1
391,CC:2F:71:3E:C5:1F,5526667,4450833094,3406539,4181755140,2120128,269077954,502,93146,7994056,78572,6266684,14574,1727372,21503,518,3413920,870549,502,2923,6500.0,1000.0,-70.0,-72.0,-66.0,-61.0,-67.0,-72.0,-65.0,-61.0,-74.0,-81.0,-71.0,-77.0,4.0,9.0,5.0,16.0,1
392,F8:59:71:5A:E0:3D,3356202,2121994768,1236070,1852916410,2120132,269078358,283,696484,848221595,695817,848141244,667,80351,686508,1815,1236161,133698,283,943,144444.0,43333.0,-67.0,-73.0,-63.0,-70.0,-66.0,-73.0,-63.0,-70.0,-74.0,-81.0,-72.0,-77.0,7.0,8.0,9.0,7.0,1
393,CC:2F:71:3F:1F:24,3854092,2551435983,1733960,2282357625,2120132,269078358,2525,1437806,1843328784,1436720,1843205966,1086,122818,1421297,5625,1733626,120374,2525,1657,86667.0,14444.0,-67.0,-63.0,-67.0,-69.0,-67.0,-63.0,-67.0,-69.0,-74.0,-81.0,-72.0,-77.0,7.0,18.0,5.0,8.0,1
394,CC:2F:71:3E:C5:1F,5526671,4450833498,3406539,4181755140,2120132,269078358,502,93146,7994056,78572,6266684,14574,1727372,21503,518,3413920,870549,502,2923,6500.0,1000.0,-70.0,-72.0,-66.0,-61.0,-67.0,-72.0,-65.0,-61.0,-74.0,-81.0,-72.0,-77.0,4.0,9.0,6.0,16.0,1
395,F8:59:71:5A:E0:3D,3356269,2122094486,1236134,1853015866,2120135,269078620,283,696549,848321709,695882,848241358,667,80351,686572,1815,1236225,133705,283,943,144444.0,43333.0,-68.0,-74.0,-64.0,-71.0,-67.0,-73.0,-63.0,-70.0,-74.0,-81.0,-72.0,-77.0,6.0,7.0,8.0,6.0,1
396,CC:2F:71:3F:1F:24,3854255,2551642203,1734118,2282563381,2120137,269078822,2525,1437953,1843527826,1436867,1843405008,1086,122818,1421443,5625,1733786,120414,2525,1657,86667.0,14444.0,-70.0,-63.0,-72.0,-70.0,-69.0,-63.0,-71.0,-70.0,-74.0,-81.0,-72.0,-77.0,4.0,18.0,0.0,7.0,1
397,CC:2F:71:3E:C5:1F,5526676,4450833962,3406539,4181755140,2120137,269078822,502,93146,7994056,78572,6266684,14574,1727372,21503,518,3413920,870549,502,2923,6500.0,1000.0,-70.0,-72.0,-66.0,-61.0,-67.0,-72.0,-65.0,-61.0,-74.0,-81.0,-72.0,-77.0,4.0,9.0,6.0,16.0,1
398,F8:59:71:5A:E0:3D,3356421,2122284420,1236280,1853205194,2120141,269079226,283,696646,848430618,695979,848350267,667,80351,686669,1815,1236371,133714,283,943,144444.0,43333.0,-66.0,-73.0,-62.0,-69.0,-66.0,-72.0,-63.0,-70.0,-73.0,-81.0,-71.0,-77.0,7.0,8.0,9.0,8.0,1
399,CC:2F:71:3F:1F:24,3854418,2551849469,1734277,2282770243,2120141,269079226,2525,1438099,1843726808,1437013,1843603990,1086,122818,1421589,5625,1733944,120466,2525,1657,65000.0,13000.0,-67.0,-63.0,-66.0,-70.0,-68.0,-63.0,-68.0,-69.0,-73.0,-81.0,-71.0,-77.0,6.0,18.0,5.0,7.0,1
400,CC:2F:71:3E:C5:1F,5526680,4450834366,3406539,4181755140,2120141,269079226,502,93146,7994056,78572,6266684,14574,1727372,21503,518,3413920,870549,502,2923,6500.0,1000.0,-70.0,-72.0,-66.0,-61.0,-67.0,-72.0,-65.0,-61.0,-73.0,-81.0,-71.0,-77.0,3.0,9.0,5.0,16.0,1
401,F8:59:71:5A:E0:3D,3356488,2122385632,1236345,1853306204,2120143,269079428,283,696711,848530718,696044,848450367,667,80351,686734,1815,1236436,133722,283,943,144444.0,43333.0,-68.0,-74.0,-65.0,-72.0,-67.0,-72.0,-64.0,-70.0,-73.0,-81.0,-71.0,-77.0,5.0,7.0,6.0,5.0,1
402,CC:2F:71:3F:1F:24,3854582,2552061139,1734439,2282981711,2120143,269079428,2525,1438248,1843931974,1437162,1843809156,1086,122818,1421738,5625,1734107,120525,2525,1657,86667.0,14444.0,-70.0,-64.0,-71.0,-72.0,-69.0,-63.0,-70.0,-71.0,-73.0,-81.0,-71.0,-77.0,3.0,17.0,0.0,5.0,1
403,CC:2F:71:3E:C5:1F,5526684,4450834770,3406539,4181755140,2120145,269079630,502,93146,7994056,78572,6266684,14574,1727372,21503,518,3413920,870549,502,2923,6500.0,1000.0,-70.0,-72.0,-66.0,-61.0,-67.0,-72.0,-65.0,-61.0,-73.0,-81.0,-71.0,-77.0,3.0,9.0,5.0,16.0,1
404,F8:59:71:5A:E0:3D,3356559,2122485642,1236409,1853405548,2120150,269080094,283,696776,848630818,696109,848550467,667,80351,686799,1815,1236500,133731,283,943,144444.0,43333.0,-68.0,-74.0,-65.0,-71.0,-67.0,-73.0,-63.0,-70.0,-73.0,-81.0,-71.0,-77.0,5.0,7.0,6.0,6.0,1
405,CC:2F:71:3F:1F:24,3854750,2552271775,1734600,2283191681,2120150,269080094,2525,1438394,1844132254,1437308,1844009436,1086,122818,1421884,5625,1734268,120653,2525,1657,115556.0,26000.0,-70.0,-63.0,-73.0,-71.0,-68.0,-63.0,-70.0,-70.0,-74.0,-81.0,-72.0,-78.0,4.0,18.0,-1.0,7.0,1
406,CC:2F:71:3E:C5:1F,5526689,4450835234,3406539,4181755140,2120150,269080094,502,93146,7994056,78572,6266684,14574,1727372,21503,518,3413920,870549,502,2923,6500.0,1000.0,-70.0,-72.0,-66.0,-61.0,-67.0,-72.0,-65.0,-61.0,-74.0,-81.0,-72.0,-78.0,4.0,9.0,6.0,17.0,1
407,F8:59:71:5A:E0:3D,3356706,2122708846,1236553,1853628277,2120153,269080569,283,696861,848735187,696194,848654836,667,80351,686884,1815,1236644,133743,283,943,144444.0,43333.0,-66.0,-73.0,-64.0,-70.0,-67.0,-73.0,-63.0,-70.0,-74.0,-81.0,-72.0,-78.0,8.0,8.0,8.0,8.0,1
408,CC:2F:71:3F:1F:24,3854916,2552483976,1734763,2283403407,2120153,269080569,2525,1438543,1844335770,1437457,1844212952,1086,122818,1422033,5625,1734430,120790,2525,1657,78000.0,1000.0,-70.0,-63.0,-73.0,-71.0,-68.0,-63.0,-69.0,-69.0,-74.0,-81.0,-72.0,-78.0,4.0,18.0,-1.0,7.0,1
409,CC:2F:71:3E:C5:1F,5526692,4450835709,3406539,4181755140,2120153,269080569,502,93146,7994056,78572,6266684,14574,1727372,21503,518,3413920,870549,502,2923,6500.0,1000.0,-70.0,-72.0,-66.0,-61.0,-67.0,-72.0,-65.0,-61.0,-74.0,-81.0,-72.0,-78.0,4.0,9.0,6.0,17.0,1
410,F8:59:71:5A:E0:3D,3356775,2122810148,1236618,1853729175,2120157,269080973,283,696927,848836841,696260,848756490,667,80351,686949,1815,1236709,133754,283,943,144444.0,43333.0,-68.0,-74.0,-64.0,-71.0,-67.0,-73.0,-63.0,-70.0,-74.0,-81.0,-72.0,-78.0,6.0,7.0,8.0,7.0,1
411,CC:2F:71:3F:1F:24,3855085,2552695718,1734925,2283614483,2120160,269081235,2525,1438693,1844542294,1437607,1844419476,1086,122818,1422181,5625,1734592,120959,2525,1657,78000.0,1000.0,-67.0,-63.0,-67.0,-69.0,-68.0,-63.0,-69.0,-69.0,-74.0,-81.0,-72.0,-78.0,7.0,18.0,5.0,9.0,1
412,CC:2F:71:3E:C5:1F,5526699,4450836375,3406539,4181755140,2120160,269081235,502,93146,7994056,78572,6266684,14574,1727372,21503,518,3413920,870549,502,2923,6500.0,1000.0,-70.0,-72.0,-66.0,-61.0,-67.0,-72.0,-65.0,-61.0,-74.0,-81.0,-72.0,-78.0,4.0,9.0,6.0,17.0,1
413,F8:59:71:5A:E0:3D,3356849,2122913633,1236687,1853832196,2120162,269081437,283,696997,848940894,696330,848860543,667,80351,687019,1815,1236777,133764,283,943,144444.0,43333.0,-67.0,-73.0,-63.0,-69.0,-67.0,-72.0,-63.0,-70.0,-75.0,-82.0,-73.0,-78.0,8.0,9.0,10.0,9.0,1
414,CC:2F:71:3F:1F:24,3855247,2552903618,1735085,2283822181,2120162,269081437,2525,1438841,1844744334,1437755,1844621516,1086,122818,1422328,5625,1734753,121019,2525,1657,78000.0,13000.0,-68.0,-63.0,-68.0,-68.0,-68.0,-63.0,-70.0,-69.0,-75.0,-82.0,-73.0,-78.0,7.0,19.0,5.0,10.0,1
415,CC:2F:71:3E:C5:1F,5526701,4450836577,3406539,4181755140,2120162,269081437,502,93146,7994056,78572,6266684,14574,1727372,21503,518,3413920,870549,502,2923,6500.0,1000.0,-70.0,-72.0,-66.0,-61.0,-67.0,-72.0,-65.0,-61.0,-75.0,-82.0,-73.0,-78.0,5.0,10.0,7.0,17.0,1
416,F8:59:71:5A:E0:3D,3357117,2123318606,1236949,1854236397,2120168,269082209,283,697108,849052855,696441,848972504,667,80351,687129,1815,1237040,133805,283,947,144444.0,43333.0,-67.0,-73.0,-63.0,-70.0,-66.0,-72.0,-63.0,-70.0,-75.0,-82.0,-73.0,-78.0,8.0,9.0,10.0,8.0,1
417,CC:2F:71:3F:1F:24,3855500,2553191118,1735332,2284108909,2120168,269082209,2525,1439041,1844967646,1437955,1844844828,1086,122818,1422526,5625,1734984,121122,2525,1657,78000.0,13000.0,-70.0,-63.0,-73.0,-70.0,-68.0,-63.0,-70.0,-69.0,-75.0,-82.0,-73.0,-78.0,5.0,19.0,0.0,8.0,1
418,CC:2F:71:3E:C5:1F,5526710,4450837667,3406540,4181755256,2120170,269082411,502,93146,7994056,78572,6266684,14574,1727372,21503,518,3413921,870549,502,2923,6500.0,1000.0,-70.0,-72.0,-66.0,-61.0,-67.0,-72.0,-65.0,-61.0,-75.0,-82.0,-73.0,-78.0,5.0,10.0,7.0,17.0,1
419,F8:59:71:5A:E0:3D,3357206,2123442611,1237033,1854359938,2120173,269082673,283,697194,849178350,696527,849097999,667,80351,687213,1815,1237124,133812,283,947,144444.0,43333.0,-67.0,-73.0,-63.0,-70.0,-67.0,-73.0,-64.0,-70.0,-75.0,-82.0,-73.0,-78.0,8.0,9.0,10.0,8.0,1
420,CC:2F:71:3F:1F:24,3857714,2556383007,1737541,2287300334,2120173,269082673,2525,1439534,1845307752,1438448,1845184934,1086,122818,1423019,5625,1737185,122363,2525,1657,78000.0,13000.0,-67.0,-64.0,-66.0,-69.0,-68.0,-63.0,-70.0,-70.0,-75.0,-82.0,-73.0,-78.0,8.0,18.0,7.0,9.0,1
421,CC:2F:71:3E:C5:1F,5526718,4450838395,3406540,4181755256,2120178,269083139,502,93147,7994174,78572,6266684,14575,1727490,21504,518,3413921,870549,502,2923,6500.0,1000.0,-65.0,-69.0,-61.0,-61.0,-67.0,-71.0,-64.0,-61.0,-75.0,-83.0,-73.0,-79.0,10.0,14.0,12.0,18.0,1
422,F8:59:71:5A:E0:3D,3357505,2123859396,1237323,1854775853,2120182,269083543,283,697353,849374394,696686,849294043,667,80351,687370,1815,1237414,133832,283,947,144444.0,43333.0,-67.0,-73.0,-64.0,-71.0,-67.0,-73.0,-63.0,-70.0,-75.0,-83.0,-73.0,-79.0,8.0,10.0,9.0,8.0,1
423,CC:2F:71:3F:1F:24,3859298,2558659825,1739116,2289576282,2120182,269083543,2525,1439989,1845693166,1438903,1845570348,1086,122818,1423453,5625,1738754,123643,2525,1667,86667.0,14444.0,-68.0,-63.0,-68.0,-70.0,-68.0,-63.0,-69.0,-69.0,-75.0,-83.0,-73.0,-79.0,7.0,20.0,5.0,9.0,1
424,CC:2F:71:3E:C5:1F,5526722,4450838799,3406540,4181755256,2120182,269083543,502,93147,7994174,78572,6266684,14575,1727490,21504,518,3413921,870549,502,2923,6500.0,1000.0,-65.0,-69.0,-61.0,-61.0,-67.0,-71.0,-64.0,-61.0,-75.0,-83.0,-73.0,-79.0,10.0,14.0,12.0,18.0,1
425,F8:59:71:5A:E0:3D,3357606,2123999155,1237417,1854914946,2120189,269084209,283,697445,849509854,696778,849429503,667,80351,687460,1815,1237507,133846,283,947,144444.0,43333.0,-68.0,-73.0,-64.0,-71.0,-67.0,-73.0,-63.0,-70.0,-76.0,-83.0,-74.0,-80.0,8.0,10.0,10.0,9.0,1
426,CC:2F:71:3F:1F:24,3861322,2561570836,1741133,2292486627,2120189,269084209,2525,1440475,1846022068,1439389,1845899250,1086,122818,1423939,5625,1740762,124692,2525,1667,86667.0,13000.0,-67.0,-63.0,-67.0,-68.0,-68.0,-63.0,-69.0,-69.0,-76.0,-83.0,-74.0,-80.0,9.0,20.0,7.0,12.0,1
427,CC:2F:71:3E:C5:1F,5526729,4450839465,3406540,4181755256,2120189,269084209,502,93147,7994174,78572,6266684,14575,1727490,21504,518,3413921,870549,502,2923,6500.0,1000.0,-65.0,-69.0,-61.0,-61.0,-67.0,-71.0,-64.0,-61.0,-76.0,-83.0,-74.0,-80.0,11.0,14.0,13.0,19.0,1
428,F8:59:71:5A:E0:3D,3357911,2124461728,1237714,1855376791,2120197,269084937,283,697614,849716757,696946,849636288,668,80469,687628,1815,1237805,133876,283,947,144444.0,43333.0,-66.0,-72.0,-63.0,-70.0,-66.0,-72.0,-63.0,-70.0,-76.0,-83.0,-74.0,-80.0,10.0,11.0,11.0,10.0,1
429,CC:2F:71:3F:1F:24,3864218,2565760944,1744018,2296675679,2120200,269085265,2525,1441143,1846524338,1440057,1846401520,1086,122818,1424606,5625,1743682,127067,2525,1667,86667.0,14444.0,-71.0,-63.0,-72.0,-70.0,-69.0,-63.0,-68.0,-69.0,-76.0,-83.0,-74.0,-80.0,5.0,20.0,2.0,10.0,1
430,CC:2F:71:3E:C5:1F,5526740,4450840521,3406540,4181755256,2120200,269085265,502,93147,7994174,78572,6266684,14575,1727490,21504,518,3413921,870549,502,2923,6500.0,1000.0,-65.0,-69.0,-61.0,-61.0,-67.0,-71.0,-64.0,-61.0,-76.0,-83.0,-74.0,-79.0,11.0,14.0,13.0,18.0,1
431,F8:59:71:5A:E0:3D,3358210,2124899762,1238004,1855813891,2120206,269085871,283,697782,849917479,697114,849837010,668,80469,687792,1815,1238094,133904,283,948,144444.0,43333.0,-68.0,-73.0,-64.0,-71.0,-67.0,-72.0,-63.0,-70.0,-76.0,-83.0,-74.0,-79.0,8.0,10.0,10.0,8.0,1
432,CC:2F:71:3F:1F:24,3866947,2569699836,1746739,2300613763,2120208,269086073,2525,1441692,1846924875,1440606,1846802057,1086,122818,1425155,5625,1746354,128790,2525,1667,104000.0,26000.0,-68.0,-63.0,-67.0,-69.0,-69.0,-63.0,-69.0,-69.0,-76.0,-83.0,-74.0,-79.0,8.0,20.0,7.0,10.0,1
433,CC:2F:71:3E:C5:1F,5526748,4450841329,3406540,4181755256,2120208,269086073,502,93147,7994174,78572,6266684,14575,1727490,21504,518,3413921,870549,502,2923,6500.0,1000.0,-65.0,-69.0,-61.0,-61.0,-67.0,-71.0,-64.0,-61.0,-76.0,-83.0,-74.0,-79.0,11.0,14.0,13.0,18.0,1
434,F8:59:71:5A:E0:3D,3358460,2125242331,1238247,1856155794,2120213,269086537,283,697935,850111017,697267,850030548,668,80469,687942,1815,1238338,133906,283,948,130000.0,39000.0,-66.0,-73.0,-62.0,-70.0,-66.0,-72.0,-62.0,-69.0,-76.0,-83.0,-74.0,-79.0,10.0,10.0,12.0,9.0,1
435,CC:2F:71:3F:1F:24,3869193,2572960330,1748980,2303873793,2120213,269086537,2525,1442184,1847294479,1441098,1847171661,1086,122818,1425647,5625,1748649,130790,2525,1667,86667.0,14444.0,-67.0,-63.0,-67.0,-69.0,-67.0,-63.0,-67.0,-69.0,-76.0,-83.0,-74.0,-79.0,9.0,20.0,7.0,10.0,1
436,CC:2F:71:3E:C5:1F,5526755,4450841995,3406540,4181755256,2120215,269086739,502,93147,7994174,78572,6266684,14575,1727490,21504,518,3413921,870549,502,2923,6500.0,1000.0,-65.0,-69.0,-61.0,-61.0,-67.0,-71.0,-64.0,-61.0,-76.0,-83.0,-74.0,-79.0,11.0,14.0,13.0,18.0,1
437,F8:59:71:5A:E0:3D,3358550,2125374986,1238332,1856287772,2120218,269087214,283,698020,850240503,697352,850160034,668,80469,688026,1815,1238423,133916,283,948,144444.0,43333.0,-65.0,-72.0,-64.0,-70.0,-66.0,-72.0,-63.0,-70.0,-76.0,-83.0,-74.0,-79.0,11.0,11.0,10.0,9.0,1
438,CC:2F:71:3F:1F:24,3870234,2574431621,1750016,2305344407,2120218,269087214,2525,1442474,1847554010,1441388,1847431192,1086,122818,1425937,5625,1749684,132474,2525,1667,115556.0,28889.0,-70.0,-63.0,-73.0,-70.0,-69.0,-63.0,-70.0,-69.0,-76.0,-83.0,-74.0,-79.0,6.0,20.0,1.0,9.0,1
439,CC:2F:71:3E:C5:1F,5526758,4450842470,3406540,4181755256,2120218,269087214,502,93147,7994174,78572,6266684,14575,1727490,21504,518,3413921,870549,502,2923,6500.0,1000.0,-65.0,-69.0,-61.0,-61.0,-67.0,-71.0,-64.0,-61.0,-76.0,-83.0,-74.0,-79.0,11.0,14.0,13.0,18.0,1
440,F8:59:71:5A:E0:3D,3358692,2125574213,1238469,1856486535,2120223,269087678,283,698118,850354293,697450,850273824,668,80469,688122,1815,1238560,133921,283,948,144444.0,43333.0,-66.0,-73.0,-62.0,-69.0,-66.0,-72.0,-63.0,-69.0,-76.0,-83.0,-74.0,-79.0,10.0,10.0,12.0,10.0,1
441,CC:2F:71:3F:1F:24,3870406,2574651379,1750183,2305563701,2120223,269087678,2525,1442627,1847763638,1441541,1847640820,1086,122818,1426088,5625,1749849,132605,2525,1667,115556.0,28889.0,-67.0,-63.0,-67.0,-69.0,-67.0,-63.0,-67.0,-69.0,-76.0,-83.0,-74.0,-79.0,9.0,20.0,7.0,10.0,1
442,CC:2F:71:3E:C5:1F,5526765,4450843136,3406540,4181755256,2120225,269087880,502,93147,7994174,78572,6266684,14575,1727490,21504,518,3413921,870549,502,2923,6500.0,1000.0,-65.0,-69.0,-61.0,-61.0,-67.0,-71.0,-64.0,-61.0,-76.0,-83.0,-74.0,-79.0,11.0,14.0,13.0,18.0,1
443,F8:59:71:5A:E0:3D,3359099,2126143092,1238871,1857054948,2120228,269088144,283,698243,850467710,697575,850387241,668,80469,688247,1815,1238962,133950,283,948,144444.0,43333.0,-67.0,-74.0,-64.0,-71.0,-67.0,-73.0,-63.0,-70.0,-76.0,-83.0,-74.0,-79.0,9.0,9.0,10.0,8.0,1
444,CC:2F:71:3F:1F:24,3870570,2574859627,1750342,2305771483,2120228,269088144,2525,1442774,1847964148,1441687,1847841212,1087,122936,1426235,5625,1750012,132767,2525,1667,78000.0,1000.0,-67.0,-63.0,-67.0,-70.0,-68.0,-63.0,-69.0,-69.0,-76.0,-83.0,-74.0,-79.0,9.0,20.0,7.0,9.0,1
445,CC:2F:71:3E:C5:1F,5526768,4450843400,3406540,4181755256,2120228,269088144,502,93147,7994174,78572,6266684,14575,1727490,21504,518,3413921,870549,502,2923,6500.0,1000.0,-65.0,-69.0,-61.0,-61.0,-67.0,-71.0,-64.0,-61.0,-76.0,-83.0,-74.0,-79.0,11.0,14.0,13.0,18.0,1
446,F8:59:71:5A:E0:3D,3359283,2126425030,1239051,1857336482,2120232,269088548,283,698322,850566682,697654,850486213,668,80469,688326,1815,1239142,133971,283,948,144444.0,43333.0,-66.0,-73.0,-63.0,-70.0,-65.0,-72.0,-62.0,-69.0,-76.0,-83.0,-74.0,-79.0,10.0,10.0,11.0,9.0,1
447,CC:2F:71:3F:1F:24,3870756,2575079426,1750524,2305990878,2120232,269088548,2525,1442943,1848177518,1441856,1848054582,1087,122936,1426403,5625,1750193,132920,2525,1667,78000.0,1000.0,-68.0,-63.0,-68.0,-69.0,-67.0,-63.0,-67.0,-69.0,-76.0,-83.0,-74.0,-79.0,8.0,20.0,6.0,10.0,1
448,CC:2F:71:3E:C5:1F,5526772,4450843804,3406540,4181755256,2120232,269088548,502,93147,7994174,78572,6266684,14575,1727490,21504,518,3413922,870549,502,2923,6500.0,1000.0,-65.0,-69.0,-61.0,-61.0,-67.0,-71.0,-64.0,-61.0,-76.0,-83.0,-74.0,-79.0,11.0,14.0,13.0,18.0,1
449,F8:59:71:5A:E0:3D,3359352,2126524950,1239115,1857435938,2120237,269089012,283,698388,850668364,697720,850587895,668,80469,688392,1815,1239206,133972,283,948,144444.0,43333.0,-66.0,-73.0,-62.0,-70.0,-66.0,-73.0,-63.0,-70.0,-76.0,-83.0,-74.0,-79.0,10.0,10.0,12.0,9.0,1
450,CC:2F:71:3F:1F:24,3870933,2575289851,1750696,2306200839,2120237,269089012,2525,1443098,1848379494,1442011,1848256558,1087,122936,1426558,5625,1750366,133059,2525,1667,52000.0,6500.0,-70.0,-63.0,-73.0,-71.0,-68.0,-63.0,-69.0,-70.0,-76.0,-83.0,-74.0,-79.0,6.0,20.0,1.0,8.0,1
451,CC:2F:71:3E:C5:1F,5526777,4450844268,3406540,4181755256,2120237,269089012,502,93147,7994174,78572,6266684,14575,1727490,21504,518,3413922,870549,502,2923,6500.0,1000.0,-65.0,-69.0,-61.0,-61.0,-67.0,-71.0,-64.0,-61.0,-76.0,-83.0,-74.0,-79.0,11.0,14.0,13.0,18.0,1
452,F8:59:71:5A:E0:3D,3359423,2126629472,1239182,1857540056,2120241,269089416,283,698456,850773182,697788,850692713,668,80469,688459,1815,1239273,133979,283,948,144444.0,43333.0,-66.0,-72.0,-62.0,-69.0,-66.0,-72.0,-62.0,-69.0,-76.0,-83.0,-74.0,-79.0,10.0,11.0,12.0,10.0,1
453,CC:2F:71:3F:1F:24,3871101,2575504159,1750860,2306414743,2120241,269089416,2525,1443253,1848592280,1442166,1848469344,1087,122936,1426713,5625,1750529,133221,2525,1667,117000.0,1000.0,-70.0,-63.0,-73.0,-71.0,-68.0,-63.0,-70.0,-69.0,-76.0,-83.0,-74.0,-79.0,6.0,20.0,1.0,8.0,1
454,CC:2F:71:3E:C5:1F,5526781,4450844672,3406540,4181755256,2120241,269089416,502,93147,7994174,78572,6266684,14575,1727490,21504,518,3413922,870549,502,2923,6500.0,1000.0,-65.0,-69.0,-61.0,-61.0,-67.0,-71.0,-64.0,-61.0,-76.0,-83.0,-74.0,-79.0,11.0,14.0,13.0,18.0,1
455,F8:59:71:5A:E0:3D,3359584,2126858479,1239338,1857768599,2120246,269089880,283,698556,850894000,697888,850813531,668,80469,688558,1815,1239429,133992,283,948,144444.0,43333.0,-67.0,-73.0,-63.0,-70.0,-66.0,-73.0,-63.0,-69.0,-77.0,-84.0,-75.0,-80.0,10.0,11.0,12.0,10.0,1
456,CC:2F:71:3F:1F:24,3871279,2575734161,1751033,2306644281,2120246,269089880,2525,1443408,1848807984,1442321,1848685048,1087,122936,1426867,5625,1750704,133351,2525,1667,86667.0,14444.0,-70.0,-63.0,-73.0,-71.0,-68.0,-63.0,-69.0,-70.0,-77.0,-84.0,-75.0,-80.0,7.0,21.0,2.0,9.0,1
457,CC:2F:71:3E:C5:1F,5526786,4450845136,3406540,4181755256,2120246,269089880,502,93147,7994174,78572,6266684,14575,1727490,21504,518,3413922,870549,502,2923,6500.0,1000.0,-65.0,-69.0,-61.0,-61.0,-67.0,-71.0,-64.0,-61.0,-77.0,-84.0,-75.0,-80.0,12.0,15.0,14.0,19.0,1
458,F8:59:71:5A:E0:3D,3359814,2127210136,1239564,1858119852,2120250,269090284,283,698648,850999255,697980,850918786,668,80469,688649,1815,1239654,134028,283,948,144444.0,43333.0,-66.0,-73.0,-62.0,-70.0,-66.0,-72.0,-63.0,-70.0,-77.0,-84.0,-75.0,-80.0,11.0,11.0,13.0,10.0,1
459,CC:2F:71:3F:1F:24,3871441,2575939873,1751191,2306849589,2120250,269090284,2525,1443557,1849010050,1442470,1848887114,1087,122936,1427015,5625,1750862,133408,2525,1667,86667.0,14444.0,-67.0,-63.0,-67.0,-69.0,-67.0,-63.0,-68.0,-69.0,-77.0,-84.0,-75.0,-80.0,10.0,21.0,8.0,11.0,1
460,CC:2F:71:3E:C5:1F,5526790,4450845540,3406540,4181755256,2120250,269090284,502,93147,7994174,78572,6266684,14575,1727490,21504,518,3413922,870549,502,2923,6500.0,1000.0,-65.0,-69.0,-61.0,-61.0,-67.0,-71.0,-64.0,-61.0,-77.0,-84.0,-75.0,-80.0,12.0,15.0,14.0,19.0,1
461,F8:59:71:5A:E0:3D,3360019,2127489083,1239767,1858398597,2120252,269090486,283,698744,851106309,698076,851025840,668,80469,688745,1815,1239858,134039,283,949,144444.0,43333.0,-67.0,-73.0,-64.0,-71.0,-65.0,-72.0,-62.0,-69.0,-77.0,-84.0,-75.0,-80.0,10.0,11.0,11.0,9.0,1
462,CC:2F:71:3F:1F:24,3871607,2576151409,1751353,2307060721,2120254,269090688,2525,1443703,1849211754,1442616,1849088818,1087,122936,1427161,5625,1751023,133517,2525,1667,57778.0,1000.0,-68.0,-63.0,-67.0,-69.0,-67.0,-63.0,-67.0,-68.0,-77.0,-84.0,-75.0,-80.0,9.0,21.0,8.0,11.0,1
463,CC:2F:71:3E:C5:1F,5526794,4450845944,3406540,4181755256,2120254,269090688,502,93147,7994174,78572,6266684,14575,1727490,21504,518,3413922,870549,502,2923,6500.0,1000.0,-65.0,-69.0,-61.0,-61.0,-67.0,-71.0,-64.0,-61.0,-77.0,-84.0,-75.0,-80.0,12.0,15.0,14.0,19.0,1
464,F8:59:71:5A:E0:3D,3360089,2127590557,1239832,1858499607,2120257,269090950,283,698809,851206409,698141,851125940,668,80469,688810,1815,1239923,134040,283,949,144444.0,43333.0,-68.0,-74.0,-64.0,-71.0,-67.0,-73.0,-63.0,-70.0,-77.0,-84.0,-75.0,-80.0,9.0,10.0,11.0,9.0,1
465,CC:2F:71:3F:1F:24,3871775,2576365999,1751516,2307274847,2120259,269091152,2525,1443854,1849419928,1442767,1849296992,1087,122936,1427311,5625,1751187,133638,2525,1667,104000.0,26000.0,-70.0,-63.0,-73.0,-70.0,-68.0,-63.0,-69.0,-69.0,-77.0,-84.0,-75.0,-80.0,7.0,21.0,2.0,10.0,1
466,CC:2F:71:3E:C5:1F,5526799,4450846408,3406540,4181755256,2120259,269091152,502,93147,7994174,78572,6266684,14575,1727490,21504,518,3413922,870549,502,2923,6500.0,1000.0,-65.0,-69.0,-61.0,-61.0,-67.0,-71.0,-64.0,-61.0,-77.0,-84.0,-75.0,-80.0,12.0,15.0,14.0,19.0,1
467,F8:59:71:5A:E0:3D,3360156,2127688863,1239895,1858597509,2120261,269091354,283,698873,851304969,698205,851224500,668,80469,688874,1815,1239986,134047,283,949,144444.0,43333.0,-66.0,-72.0,-63.0,-69.0,-67.0,-73.0,-63.0,-70.0,-77.0,-84.0,-75.0,-80.0,11.0,12.0,12.0,11.0,1
468,CC:2F:71:3F:1F:24,3871950,2576575386,1751689,2307484032,2120261,269091354,2525,1444016,1849619791,1442929,1849496855,1087,122936,1427473,5625,1751358,133767,2525,1667,104000.0,26000.0,-68.0,-63.0,-67.0,-69.0,-68.0,-63.0,-69.0,-69.0,-77.0,-84.0,-75.0,-80.0,9.0,21.0,8.0,11.0,1
469,CC:2F:71:3E:C5:1F,5526801,4450846610,3406540,4181755256,2120261,269091354,502,93147,7994174,78572,6266684,14575,1727490,21504,518,3413922,870549,502,2923,6500.0,1000.0,-65.0,-69.0,-61.0,-61.0,-67.0,-71.0,-64.0,-61.0,-77.0,-84.0,-75.0,-80.0,12.0,15.0,14.0,19.0,1
470,F8:59:71:5A:E0:3D,3360225,2127790277,1239960,1858698519,2120265,269091758,283,698938,851405111,698270,851324642,668,80469,688938,1815,1240050,134057,283,949,144444.0,43333.0,-66.0,-73.0,-63.0,-70.0,-66.0,-72.0,-63.0,-70.0,-77.0,-84.0,-75.0,-80.0,11.0,11.0,12.0,10.0,1
471,CC:2F:71:3F:1F:24,3872110,2576777766,1751845,2307686008,2120265,269091758,2525,1444160,1849818443,1443073,1849695507,1087,122936,1427617,5625,1751515,133904,2525,1667,86667.0,14444.0,-67.0,-63.0,-67.0,-69.0,-68.0,-63.0,-68.0,-69.0,-77.0,-84.0,-75.0,-80.0,10.0,21.0,8.0,11.0,1
472,CC:2F:71:3E:C5:1F,5526805,4450847014,3406540,4181755256,2120265,269091758,502,93147,7994174,78572,6266684,14575,1727490,21504,518,3413922,870549,502,2923,6500.0,1000.0,-65.0,-69.0,-61.0,-61.0,-67.0,-71.0,-64.0,-61.0,-77.0,-84.0,-75.0,-80.0,12.0,15.0,14.0,19.0,1
473,F8:59:71:5A:E0:3D,3360466,2128158153,1240196,1859065931,2120270,269092222,283,699030,851511794,698362,851431325,668,80469,689029,1815,1240286,134063,283,949,144444.0,43333.0,-67.0,-74.0,-64.0,-71.0,-66.0,-72.0,-63.0,-70.0,-77.0,-84.0,-75.0,-80.0,10.0,10.0,11.0,9.0,1
474,CC:2F:71:3F:1F:24,3872276,2576989904,1752006,2307897682,2120270,269092222,2525,1444304,1850018491,1443217,1849895555,1087,122936,1427761,5625,1751677,133977,2525,1667,86667.0,14444.0,-69.0,-63.0,-67.0,-68.0,-68.0,-63.0,-68.0,-69.0,-77.0,-84.0,-75.0,-80.0,8.0,21.0,8.0,12.0,1
475,CC:2F:71:3E:C5:1F,5526810,4450847478,3406540,4181755256,2120270,269092222,502,93147,7994174,78572,6266684,14575,1727490,21504,518,3413922,870549,502,2923,6500.0,1000.0,-65.0,-69.0,-61.0,-61.0,-67.0,-71.0,-64.0,-61.0,-77.0,-84.0,-75.0,-80.0,12.0,15.0,14.0,19.0,1
476,F8:59:71:5A:E0:3D,3360533,2128256459,1240259,1859163833,2120274,269092626,283,699093,851608842,698425,851528373,668,80469,689092,1815,1240350,134068,283,950,144444.0,43333.0,-65.0,-71.0,-62.0,-70.0,-65.0,-71.0,-62.0,-69.0,-77.0,-84.0,-75.0,-80.0,12.0,13.0,13.0,10.0,1
477,CC:2F:71:3F:1F:24,3872439,2577198258,1752165,2308105632,2120274,269092626,2525,1444451,1850221763,1443364,1850098827,1087,122936,1427906,5625,1751836,134097,2525,1667,78000.0,13000.0,-68.0,-63.0,-67.0,-69.0,-67.0,-63.0,-67.0,-69.0,-77.0,-84.0,-75.0,-80.0,9.0,21.0,8.0,11.0,1
478,CC:2F:71:3E:C5:1F,5526814,4450847882,3406540,4181755256,2120274,269092626,502,93147,7994174,78572,6266684,14575,1727490,21504,518,3413922,870549,502,2923,6500.0,1000.0,-65.0,-69.0,-61.0,-61.0,-67.0,-71.0,-64.0,-61.0,-77.0,-84.0,-75.0,-80.0,12.0,15.0,14.0,19.0,1
479,F8:59:71:5A:E0:3D,3360653,2128432072,1240376,1859338971,2120277,269093101,283,699173,851717905,698505,851637436,668,80469,689172,1815,1240467,134085,283,950,144444.0,43333.0,-67.0,-73.0,-64.0,-71.0,-66.0,-72.0,-63.0,-70.0,-77.0,-84.0,-75.0,-80.0,10.0,11.0,11.0,9.0,1
480,CC:2F:71:3F:1F:24,3872606,2577410235,1752327,2308316932,2120279,269093303,2525,1444599,1850426561,1443512,1850303625,1087,122936,1428053,5625,1751999,134180,2525,1667,72222.0,21667.0,-68.0,-63.0,-67.0,-70.0,-69.0,-63.0,-71.0,-69.0,-77.0,-84.0,-75.0,-80.0,9.0,21.0,8.0,10.0,1
481,CC:2F:71:3E:C5:1F,5526819,4450848559,3406540,4181755256,2120279,269093303,502,93147,7994174,78572,6266684,14575,1727490,21504,518,3413922,870549,502,2923,6500.0,1000.0,-65.0,-69.0,-61.0,-61.0,-67.0,-71.0,-64.0,-61.0,-77.0,-84.0,-75.0,-80.0,12.0,15.0,14.0,19.0,1
482,F8:59:71:5A:E0:3D,3360721,2128530438,1240439,1859436873,2120282,269093565,283,699237,851816465,698569,851735996,668,80469,689236,1815,1240530,134089,283,950,144444.0,43333.0,-67.0,-73.0,-64.0,-71.0,-66.0,-72.0,-63.0,-70.0,-77.0,-84.0,-75.0,-80.0,10.0,11.0,11.0,9.0,1
483,CC:2F:71:3F:1F:24,3872792,2577640191,1752497,2308541000,2120295,269099191,2525,1444755,1850642241,1443668,1850519305,1087,122936,1428209,5625,1752169,134254,2525,1667,72222.0,21667.0,-70.0,-63.0,-73.0,-70.0,-69.0,-63.0,-70.0,-69.0,-77.0,-84.0,-75.0,-80.0,7.0,21.0,2.0,10.0,1
484,CC:2F:71:3E:C5:1F,5526835,4450854447,3406540,4181755256,2120295,269099191,502,93147,7994174,78572,6266684,14575,1727490,21504,518,3413922,870549,502,2923,6500.0,1000.0,-65.0,-69.0,-61.0,-61.0,-67.0,-71.0,-64.0,-61.0,-77.0,-84.0,-75.0,-80.0,12.0,15.0,14.0,19.0,1
485,F8:59:71:5A:E0:3D,3360818,2128648982,1240509,1859544103,2120309,269104879,283,699307,851924279,698639,851843810,668,80469,689305,1815,1240600,134095,283,950,144444.0,43333.0,-66.0,-73.0,-63.0,-70.0,-65.0,-72.0,-63.0,-70.0,-77.0,-84.0,-75.0,-80.0,11.0,11.0,12.0,10.0,1
486,CC:2F:71:3F:1F:24,3872968,2577854479,1752658,2308749532,2120310,269104947,2525,1444904,1850845747,1443816,1850722693,1088,123054,1428356,5625,1752329,134319,2525,1667,72222.0,21667.0,-70.0,-63.0,-73.0,-70.0,-68.0,-63.0,-70.0,-69.0,-77.0,-84.0,-75.0,-80.0,7.0,21.0,2.0,10.0,1
487,CC:2F:71:3E:C5:1F,5526852,4450860453,3406541,4181755372,2120311,269105081,502,93147,7994174,78572,6266684,14575,1727490,21504,518,3413923,870549,502,2923,6500.0,1000.0,-65.0,-69.0,-61.0,-61.0,-67.0,-71.0,-64.0,-61.0,-77.0,-84.0,-75.0,-80.0,12.0,15.0,14.0,19.0,1
488,F8:59:71:5A:E0:3D,3361179,2129165384,1240866,1860060101,2120313,269105283,283,699424,852032239,698756,851951770,668,80469,689422,1815,1240957,134118,283,950,144444.0,43333.0,-65.0,-72.0,-63.0,-69.0,-66.0,-72.0,-62.0,-69.0,-77.0,-84.0,-75.0,-80.0,12.0,12.0,12.0,11.0,1
489,CC:2F:71:3F:1F:24,3873129,2578060875,1752816,2308955592,2120313,269105283,2525,1445048,1851044427,1443960,1850921373,1088,123054,1428500,5625,1752489,134446,2525,1667,104000.0,26000.0,-67.0,-63.0,-66.0,-69.0,-68.0,-63.0,-69.0,-69.0,-77.0,-84.0,-75.0,-80.0,10.0,21.0,9.0,11.0,1
490,CC:2F:71:3E:C5:1F,5526857,4450860917,3406541,4181755372,2120316,269105545,502,93147,7994174,78572,6266684,14575,1727490,21504,518,3413923,870549,502,2923,6500.0,1000.0,-65.0,-69.0,-61.0,-61.0,-67.0,-71.0,-64.0,-61.0,-77.0,-84.0,-75.0,-80.0,12.0,15.0,14.0,19.0,1
491,F8:59:71:5A:E0:3D,3361249,2129266858,1240931,1860161111,2120318,269105747,283,699489,852132339,698821,852051870,668,80469,689487,1815,1241022,134120,283,950,144444.0,43333.0,-67.0,-73.0,-64.0,-71.0,-66.0,-73.0,-63.0,-70.0,-77.0,-84.0,-75.0,-80.0,10.0,11.0,11.0,9.0,1
492,CC:2F:71:3F:1F:24,3873295,2578271157,1752977,2309165410,2120318,269105747,2525,1445197,1851249367,1444109,1851126313,1088,123054,1428647,5625,1752651,134598,2525,1667,104000.0,1000.0,-68.0,-63.0,-67.0,-70.0,-69.0,-63.0,-70.0,-69.0,-77.0,-84.0,-75.0,-80.0,9.0,21.0,8.0,10.0,1
493,CC:2F:71:3E:C5:1F,5526859,4450861119,3406541,4181755372,2120318,269105747,502,93147,7994174,78572,6266684,14575,1727490,21504,518,3413923,870549,502,2923,6500.0,1000.0,-65.0,-69.0,-61.0,-61.0,-67.0,-71.0,-64.0,-61.0,-77.0,-84.0,-75.0,-80.0,12.0,15.0,14.0,19.0,1
494,F8:59:71:5A:E0:3D,3361318,2129368272,1240996,1860262121,2120322,269106151,283,699555,852234035,698887,852153566,668,80469,689553,1815,1241087,134127,283,950,144444.0,43333.0,-66.0,-73.0,-62.0,-70.0,-66.0,-72.0,-63.0,-70.0,-77.0,-84.0,-75.0,-80.0,11.0,11.0,13.0,10.0,1
495,CC:2F:71:3F:1F:24,3873464,2578484378,1753142,2309378227,2120322,269106151,2525,1445348,1851455976,1444260,1851332922,1088,123054,1428797,5625,1752817,134763,2525,1667,115556.0,26000.0,-70.0,-63.0,-73.0,-70.0,-68.0,-63.0,-68.0,-69.0,-77.0,-84.0,-75.0,-80.0,7.0,21.0,2.0,10.0,1
496,CC:2F:71:3E:C5:1F,5526863,4450861523,3406541,4181755372,2120322,269106151,502,93147,7994174,78572,6266684,14575,1727490,21504,518,3413923,870549,502,2923,6500.0,1000.0,-65.0,-69.0,-61.0,-61.0,-67.0,-71.0,-64.0,-61.0,-77.0,-84.0,-75.0,-80.0,12.0,15.0,14.0,19.0,1
497,F8:59:71:5A:E0:3D,3361452,2129566340,1241124,1860459663,2120328,269106677,283,699633,852344652,698964,852264065,669,80587,689631,1815,1241215,134136,283,950,144444.0,43333.0,-68.0,-74.0,-64.0,-71.0,-66.0,-72.0,-63.0,-69.0,-77.0,-84.0,-75.0,-80.0,9.0,10.0,11.0,9.0,1
498,CC:2F:71:3F:1F:24,3873649,2578719634,1753321,2309612957,2120328,269106677,2525,1445514,1851687190,1444426,1851564136,1088,123054,1428962,5625,1752995,134992,2525,1668,78000.0,13000.0,-69.0,-63.0,-68.0,-69.0,-68.0,-63.0,-68.0,-69.0,-77.0,-84.0,-75.0,-80.0,8.0,21.0,7.0,11.0,1
499,CC:2F:71:3E:C5:1F,5526869,4450862049,3406541,4181755372,2120328,269106677,502,93147,7994174,78572,6266684,14575,1727490,21504,518,3413923,870549,502,2923,6500.0,1000.0,-65.0,-69.0,-61.0,-61.0,-67.0,-71.0,-64.0,-61.0,-77.0,-84.0,-75.0,-80.0,12.0,15.0,14.0,19.0,1
500,F8:59:71:5A:E0:3D,3361581,2129754618,1241249,1860647537,2120332,269107081,283,699718,852455320,699049,852374733,669,80587,689716,1815,1241339,134143,283,950,144444.0,39000.0,-65.0,-72.0,-62.0,-69.0,-66.0,-72.0,-63.0,-70.0,-77.0,-84.0,-75.0,-80.0,12.0,12.0,13.0,11.0,1
501,CC:2F:71:3F:1F:24,3873815,2578931058,1753483,2309823977,2120332,269107081,2525,1445661,1851887628,1444573,1851764574,1088,123054,1429109,5625,1753158,135143,2525,1668,104000.0,26000.0,-67.0,-63.0,-67.0,-69.0,-68.0,-63.0,-68.0,-68.0,-77.0,-84.0,-75.0,-80.0,10.0,21.0,8.0,11.0,1
502,CC:2F:71:3E:C5:1F,5526873,4450862453,3406541,4181755372,2120332,269107081,502,93147,7994174,78572,6266684,14575,1727490,21504,518,3413923,870549,502,2923,6500.0,1000.0,-65.0,-69.0,-61.0,-61.0,-67.0,-71.0,-64.0,-61.0,-77.0,-84.0,-75.0,-80.0,12.0,15.0,14.0,19.0,1
503,F8:59:71:5A:E0:3D,3361802,2130092631,1241466,1860985146,2120336,269107485,283,699816,852562649,699147,852482062,669,80587,689814,1815,1241557,134208,283,951,144444.0,43333.0,-66.0,-72.0,-63.0,-69.0,-65.0,-72.0,-62.0,-69.0,-77.0,-84.0,-75.0,-80.0,11.0,12.0,12.0,11.0,1
504,CC:2F:71:3F:1F:24,3873979,2579141246,1753643,2310033761,2120336,269107485,2525,1445808,1852092296,1444720,1851969242,1088,123054,1429256,5625,1753318,135269,2525,1668,115556.0,26000.0,-70.0,-63.0,-73.0,-70.0,-67.0,-63.0,-67.0,-68.0,-77.0,-84.0,-75.0,-80.0,7.0,21.0,2.0,10.0,1
505,CC:2F:71:3E:C5:1F,5526877,4450862857,3406541,4181755372,2120336,269107485,502,93147,7994174,78572,6266684,14575,1727490,21504,518,3413923,870549,502,2923,6500.0,1000.0,-65.0,-69.0,-61.0,-61.0,-67.0,-71.0,-64.0,-61.0,-77.0,-84.0,-75.0,-80.0,12.0,15.0,14.0,19.0,1
506,F8:59:71:5A:E0:3D,3361871,2130192551,1241530,1861084602,2120341,269107949,283,699881,852662833,699212,852582246,669,80587,689879,1815,1241621,134212,283,951,144444.0,43333.0,-67.0,-73.0,-62.0,-69.0,-66.0,-72.0,-63.0,-69.0,-77.0,-84.0,-75.0,-80.0,10.0,11.0,13.0,11.0,1
507,CC:2F:71:3F:1F:24,3874143,2579351596,1753802,2310243647,2120341,269107949,2525,1445955,1852295554,1444867,1852172500,1088,123054,1429402,5625,1753476,135378,2525,1668,104000.0,1000.0,-69.0,-63.0,-67.0,-68.0,-69.0,-63.0,-69.0,-69.0,-77.0,-84.0,-75.0,-80.0,8.0,21.0,8.0,12.0,1
508,CC:2F:71:3E:C5:1F,5526882,4450863321,3406541,4181755372,2120341,269107949,502,93147,7994174,78572,6266684,14575,1727490,21504,518,3413923,870549,502,2923,6500.0,1000.0,-65.0,-69.0,-61.0,-61.0,-67.0,-71.0,-64.0,-61.0,-77.0,-84.0,-75.0,-80.0,12.0,15.0,14.0,19.0,1
509,F8:59:71:5A:E0:3D,3361940,2130293965,1241595,1861185612,2120345,269108353,283,699946,852762933,699277,852682346,669,80587,689944,1815,1241686,134224,283,951,144444.0,43333.0,-65.0,-72.0,-64.0,-69.0,-66.0,-72.0,-63.0,-69.0,-77.0,-84.0,-75.0,-80.0,12.0,12.0,11.0,11.0,1
510,CC:2F:71:3F:1F:24,3874327,2579589624,1753982,2310481271,2120345,269108353,2525,1446120,1852522272,1445032,1852399218,1088,123054,1429566,5625,1753659,135559,2525,1668,78000.0,13000.0,-67.0,-63.0,-67.0,-69.0,-67.0,-63.0,-67.0,-68.0,-77.0,-84.0,-75.0,-80.0,10.0,21.0,8.0,11.0,1
511,CC:2F:71:3E:C5:1F,5526886,4450863725,3406541,4181755372,2120345,269108353,502,93147,7994174,78572,6266684,14575,1727490,21504,518,3413923,870549,502,2923,6500.0,1000.0,-65.0,-69.0,-61.0,-61.0,-67.0,-71.0,-64.0,-61.0,-77.0,-84.0,-75.0,-80.0,12.0,15.0,14.0,19.0,1
512,F8:59:71:5A:E0:3D,3362157,2130588602,1241808,1861479845,2120349,269108757,283,700052,852884163,699383,852803576,669,80587,690050,1815,1241899,134397,283,951,144444.0,43333.0,-65.0,-72.0,-64.0,-69.0,-67.0,-72.0,-64.0,-70.0,-76.0,-83.0,-74.0,-79.0,11.0,11.0,10.0,10.0,1
513,CC:2F:71:3F:1F:24,3876163,2582220923,1755809,2313111702,2120354,269109221,2525,1446582,1852887439,1445494,1852764385,1088,123054,1430027,5625,1755483,136507,2525,1668,86667.0,14444.0,-70.0,-63.0,-71.0,-70.0,-69.0,-63.0,-69.0,-69.0,-76.0,-83.0,-74.0,-79.0,6.0,20.0,3.0,9.0,1
514,CC:2F:71:3E:C5:1F,5526895,4450864593,3406541,4181755372,2120354,269109221,502,93148,7994244,78573,6266754,14575,1727490,21504,518,3413923,870549,502,2923,6500.0,1000.0,-69.0,-72.0,-66.0,-61.0,-67.0,-71.0,-64.0,-61.0,-76.0,-83.0,-74.0,-79.0,7.0,11.0,8.0,18.0,1
515,F8:59:71:5A:E0:3D,3362262,2130744466,1241908,1861635245,2120354,269109221,283,700162,853053913,699493,852973326,669,80587,690159,1815,1241999,134414,283,951,144444.0,43333.0,-68.0,-73.0,-64.0,-71.0,-66.0,-72.0,-63.0,-69.0,-76.0,-83.0,-74.0,-79.0,8.0,10.0,10.0,8.0,1
516,CC:2F:71:3F:1F:24,3876332,2582441682,1755978,2313332461,2120354,269109221,2525,1446756,1853113974,1445668,1852990920,1088,123054,1430200,5625,1755654,136645,2525,1668,72222.0,1000.0,-68.0,-63.0,-67.0,-69.0,-68.0,-63.0,-68.0,-69.0,-76.0,-83.0,-74.0,-79.0,8.0,20.0,7.0,10.0,1
517,CC:2F:71:3E:C5:1F,5526897,4450864795,3406541,4181755372,2120356,269109423,502,93148,7994244,78573,6266754,14575,1727490,21504,518,3413923,870549,502,2923,6500.0,1000.0,-69.0,-72.0,-66.0,-61.0,-67.0,-71.0,-64.0,-61.0,-76.0,-83.0,-74.0,-79.0,7.0,11.0,8.0,18.0,1
518,F8:59:71:5A:E0:3D,3362404,2130941851,1242043,1861831751,2120361,269110100,283,700247,853162440,699578,853081853,669,80587,690244,1815,1242133,134448,283,951,144444.0,43333.0,-68.0,-71.0,-64.0,-70.0,-66.0,-72.0,-63.0,-70.0,-75.0,-82.0,-72.0,-78.0,7.0,11.0,8.0,8.0,1
519,CC:2F:71:3F:1F:24,3876503,2582650958,1756140,2313540656,2120363,269110302,2525,1446905,1853316093,1445817,1853193039,1088,123054,1430349,5625,1755816,136758,2525,1668,72222.0,1000.0,-68.0,-63.0,-67.0,-69.0,-69.0,-63.0,-70.0,-69.0,-75.0,-82.0,-72.0,-78.0,7.0,19.0,5.0,9.0,1
520,CC:2F:71:3E:C5:1F,5526904,4450865674,3406541,4181755372,2120363,269110302,502,93148,7994244,78573,6266754,14575,1727490,21504,518,3413923,870549,502,2923,6500.0,1000.0,-69.0,-72.0,-66.0,-61.0,-67.0,-71.0,-64.0,-61.0,-75.0,-82.0,-72.0,-78.0,6.0,10.0,6.0,17.0,1
521,F8:59:71:5A:E0:3D,3362676,2131358372,1242312,1862248010,2120364,269110362,283,700355,853269751,699686,853189164,669,80587,690352,1815,1242403,134453,283,951,144444.0,43333.0,-67.0,-72.0,-63.0,-70.0,-66.0,-72.0,-63.0,-70.0,-75.0,-82.0,-72.0,-78.0,8.0,10.0,9.0,8.0,1
522,CC:2F:71:3F:1F:24,3876667,2582863464,1756303,2313753102,2120364,269110362,2525,1447052,1853516489,1445964,1853393435,1088,123054,1430496,5625,1755979,136862,2525,1668,115556.0,26000.0,-68.0,-63.0,-67.0,-69.0,-68.0,-63.0,-69.0,-69.0,-75.0,-82.0,-72.0,-78.0,7.0,19.0,5.0,9.0,1
523,CC:2F:71:3E:C5:1F,5526905,4450865734,3406541,4181755372,2120364,269110362,502,93148,7994244,78573,6266754,14575,1727490,21504,518,3413923,870549,502,2923,6500.0,1000.0,-69.0,-72.0,-66.0,-61.0,-67.0,-71.0,-64.0,-61.0,-75.0,-82.0,-72.0,-78.0,6.0,10.0,6.0,17.0,1
524,F8:59:71:5A:E0:3D,3362749,2131458752,1242376,1862347354,2120373,269111398,283,700419,853368311,699750,853287724,669,80587,690416,1815,1242467,134474,283,951,144444.0,43333.0,-68.0,-73.0,-65.0,-72.0,-67.0,-72.0,-64.0,-70.0,-76.0,-83.0,-74.0,-79.0,8.0,10.0,9.0,7.0,1
525,CC:2F:71:3F:1F:24,3876853,2583073149,1756480,2313961751,2120373,269111398,2525,1447214,1853723078,1446126,1853600024,1088,123054,1430658,5625,1756157,137039,2525,1668,86667.0,13000.0,-70.0,-63.0,-72.0,-70.0,-70.0,-63.0,-71.0,-69.0,-76.0,-83.0,-74.0,-79.0,6.0,20.0,2.0,9.0,1
526,CC:2F:71:3E:C5:1F,5526916,4450866972,3406541,4181755372,2120375,269111600,502,93149,7994362,78573,6266754,14576,1727608,21505,518,3413923,870549,502,2923,6500.0,1000.0,-73.0,-72.0,-70.0,-62.0,-68.0,-71.0,-65.0,-61.0,-76.0,-83.0,-74.0,-79.0,3.0,11.0,4.0,17.0,1
527,F8:59:71:5A:E0:3D,3362821,2131559329,1242446,1862447729,2120375,269111600,283,700490,853468711,699821,853388124,669,80587,690484,1815,1242537,134486,283,952,144444.0,43333.0,-68.0,-73.0,-65.0,-71.0,-67.0,-72.0,-64.0,-70.0,-76.0,-83.0,-74.0,-79.0,8.0,10.0,9.0,8.0,1
528,CC:2F:71:3F:1F:24,3877029,2583284227,1756654,2314172627,2120375,269111600,2525,1447369,1853924111,1446281,1853801057,1088,123054,1430813,5625,1756332,137139,2525,1668,86667.0,14444.0,-68.0,-63.0,-67.0,-70.0,-69.0,-63.0,-70.0,-69.0,-76.0,-83.0,-74.0,-79.0,8.0,20.0,7.0,9.0,1
529,CC:2F:71:3E:C5:1F,5526916,4450866972,3406541,4181755372,2120375,269111600,502,93149,7994362,78573,6266754,14576,1727608,21505,518,3413923,870549,502,2923,6500.0,1000.0,-73.0,-72.0,-70.0,-62.0,-68.0,-71.0,-65.0,-61.0,-76.0,-83.0,-74.0,-79.0,3.0,11.0,4.0,17.0,1
530,F8:59:71:5A:E0:3D,3362889,2131657695,1242509,1862545631,2120380,269112064,283,700555,853565871,699886,853485284,669,80587,690547,1815,1242600,134493,283,952,144444.0,43333.0,-68.0,-73.0,-64.0,-71.0,-67.0,-72.0,-63.0,-70.0,-76.0,-83.0,-74.0,-79.0,8.0,10.0,10.0,8.0,1
531,CC:2F:71:3F:1F:24,3877193,2583489957,1756813,2314377893,2120380,269112064,2525,1447517,1854124623,1446429,1854001569,1088,123054,1430961,5625,1756491,137215,2525,1668,104000.0,26000.0,-69.0,-63.0,-68.0,-69.0,-69.0,-63.0,-70.0,-69.0,-76.0,-83.0,-74.0,-79.0,7.0,20.0,6.0,10.0,1
532,CC:2F:71:3E:C5:1F,5526922,4450867570,3406541,4181755372,2120381,269112198,502,93149,7994362,78573,6266754,14576,1727608,21505,518,3413923,870549,502,2923,6500.0,1000.0,-73.0,-72.0,-70.0,-62.0,-68.0,-71.0,-65.0,-61.0,-76.0,-83.0,-74.0,-79.0,3.0,11.0,4.0,17.0,1
533,F8:59:71:5A:E0:3D,3362957,2131757555,1242573,1862645087,2120384,269112468,283,700619,853664431,699950,853583844,669,80587,690611,1815,1242664,134504,283,952,144444.0,43333.0,-66.0,-72.0,-63.0,-69.0,-66.0,-72.0,-63.0,-69.0,-76.0,-83.0,-74.0,-79.0,10.0,11.0,11.0,10.0,1
534,CC:2F:71:3F:1F:24,3877359,2583701493,1756975,2314589025,2120384,269112468,2525,1447665,1854325205,1446577,1854202151,1088,123054,1431109,5625,1756653,137323,2525,1668,115556.0,28889.0,-71.0,-63.0,-74.0,-70.0,-69.0,-63.0,-71.0,-69.0,-76.0,-83.0,-74.0,-79.0,5.0,20.0,0.0,9.0,1
535,CC:2F:71:3E:C5:1F,5526925,4450867840,3406541,4181755372,2120384,269112468,502,93149,7994362,78573,6266754,14576,1727608,21505,518,3413923,870549,502,2923,6500.0,1000.0,-73.0,-72.0,-70.0,-62.0,-68.0,-71.0,-65.0,-61.0,-76.0,-83.0,-74.0,-79.0,3.0,11.0,4.0,17.0,1
536,F8:59:71:5A:E0:3D,3363029,2131860587,1242640,1862747655,2120389,269112932,283,700686,853766205,700017,853685618,669,80587,690678,1815,1242731,134514,283,952,144444.0,43333.0,-68.0,-73.0,-64.0,-71.0,-66.0,-72.0,-63.0,-70.0,-75.0,-82.0,-72.0,-78.0,7.0,9.0,8.0,7.0,1
537,CC:2F:71:3F:1F:24,3877529,2583917153,1757140,2314804221,2120389,269112932,2525,1447819,1854533537,1446731,1854410483,1088,123054,1431262,5625,1756817,137412,2525,1668,86667.0,13000.0,-68.0,-63.0,-67.0,-69.0,-67.0,-63.0,-67.0,-69.0,-75.0,-82.0,-72.0,-78.0,7.0,19.0,5.0,9.0,1
538,CC:2F:71:3E:C5:1F,5526930,4450868304,3406541,4181755372,2120389,269112932,502,93149,7994362,78573,6266754,14576,1727608,21505,518,3413923,870549,502,2923,6500.0,1000.0,-73.0,-72.0,-70.0,-62.0,-68.0,-71.0,-65.0,-61.0,-75.0,-82.0,-72.0,-78.0,2.0,10.0,2.0,16.0,1
539,F8:59:71:5A:E0:3D,3363286,2132216346,1242893,1863103010,2120393,269113336,283,700792,853872837,700123,853792250,669,80587,690784,1815,1242984,134519,283,953,144444.0,43333.0,-67.0,-73.0,-63.0,-69.0,-66.0,-72.0,-64.0,-70.0,-75.0,-82.0,-72.0,-78.0,8.0,9.0,9.0,9.0,1
540,CC:2F:71:3F:1F:24,3877691,2584122459,1757298,2315009123,2120393,269113336,2525,1447964,1854730843,1446876,1854607789,1088,123054,1431407,5625,1756976,137528,2525,1668,104000.0,26000.0,-71.0,-63.0,-74.0,-70.0,-69.0,-63.0,-70.0,-69.0,-75.0,-82.0,-72.0,-78.0,4.0,19.0,-2.0,8.0,1
541,CC:2F:71:3E:C5:1F,5526934,4450868708,3406541,4181755372,2120393,269113336,502,93149,7994362,78573,6266754,14576,1727608,21505,518,3413923,870549,502,2923,6500.0,1000.0,-73.0,-72.0,-70.0,-62.0,-68.0,-71.0,-65.0,-61.0,-75.0,-82.0,-72.0,-78.0,2.0,10.0,2.0,16.0,1
542,F8:59:71:5A:E0:3D,3363555,2132626871,1243158,1863513123,2120397,269113748,283,700895,853972637,700226,853892050,669,80587,690887,1815,1243249,134566,283,953,144444.0,43333.0,-66.0,-73.0,-64.0,-70.0,-67.0,-72.0,-64.0,-70.0,-75.0,-82.0,-72.0,-78.0,9.0,9.0,8.0,8.0,1
543,CC:2F:71:3F:1F:24,3877872,2584354576,1757473,2315240626,2120399,269113950,2525,1448129,1854959113,1447041,1854836059,1088,123054,1431572,5625,1757152,137648,2525,1669,104000.0,26000.0,-71.0,-63.0,-73.0,-70.0,-69.0,-63.0,-71.0,-69.0,-75.0,-82.0,-72.0,-78.0,4.0,19.0,-1.0,8.0,1
544,CC:2F:71:3E:C5:1F,5526940,4450869322,3406541,4181755372,2120399,269113950,502,93149,7994362,78573,6266754,14576,1727608,21505,518,3413923,870549,502,2923,6500.0,1000.0,-73.0,-72.0,-70.0,-62.0,-68.0,-71.0,-65.0,-61.0,-75.0,-82.0,-72.0,-78.0,2.0,10.0,2.0,16.0,1
545,F8:59:71:5A:E0:3D,3363658,2132776329,1243254,1863661915,2120404,269114414,283,700994,854125349,700325,854044762,669,80587,690986,1815,1243346,134624,283,953,144444.0,43333.0,-68.0,-73.0,-65.0,-71.0,-68.0,-73.0,-64.0,-71.0,-75.0,-82.0,-72.0,-78.0,7.0,9.0,7.0,7.0,1
546,CC:2F:71:3F:1F:24,3878081,2584624185,1757677,2315509771,2120404,269114414,2525,1448325,1855234188,1447237,1855111134,1088,123054,1431768,5625,1757354,137875,2525,1669,78000.0,13000.0,-70.0,-63.0,-73.0,-70.0,-69.0,-63.0,-71.0,-69.0,-75.0,-82.0,-72.0,-78.0,5.0,19.0,-1.0,8.0,1
547,CC:2F:71:3E:C5:1F,5526945,4450869786,3406541,4181755372,2120404,269114414,502,93149,7994362,78573,6266754,14576,1727608,21505,518,3413923,870549,502,2923,6500.0,1000.0,-73.0,-72.0,-70.0,-62.0,-68.0,-71.0,-65.0,-61.0,-75.0,-82.0,-72.0,-78.0,2.0,10.0,2.0,16.0,1
548,F8:59:71:5A:E0:3D,3363740,2132890036,1243332,1863775218,2120408,269114818,283,701074,854242923,700405,854162336,669,80587,691066,1815,1243424,134694,283,953,130000.0,39000.0,-68.0,-73.0,-65.0,-71.0,-66.0,-72.0,-63.0,-69.0,-74.0,-82.0,-72.0,-78.0,6.0,9.0,7.0,7.0,1
549,CC:2F:71:3F:1F:24,3878280,2584882055,1757868,2315766833,2120412,269115222,2525,1448506,1855484290,1447418,1855361236,1088,123054,1431945,5625,1757549,138058,2525,1669,52000.0,1000.0,-66.0,-63.0,-65.0,-68.0,-67.0,-62.0,-66.0,-68.0,-74.0,-82.0,-72.0,-78.0,8.0,19.0,7.0,10.0,1
550,CC:2F:71:3E:C5:1F,5526953,4450870594,3406541,4181755372,2120412,269115222,502,93149,7994362,78573,6266754,14576,1727608,21505,518,3413923,870549,502,2923,6500.0,1000.0,-73.0,-72.0,-70.0,-62.0,-68.0,-71.0,-65.0,-61.0,-74.0,-82.0,-72.0,-78.0,1.0,10.0,2.0,16.0,1
551,F8:59:71:5A:E0:3D,3363894,2133105339,1243470,1863988774,2120424,269116565,283,701177,854402789,700508,854322202,669,80587,691124,1815,1243563,134831,283,954,117000.0,39000.0,-68.0,-73.0,-65.0,-71.0,-66.0,-72.0,-63.0,-69.0,-75.0,-83.0,-73.0,-79.0,7.0,10.0,8.0,8.0,1
552,CC:2F:71:3F:1F:24,3878904,2585738625,1758464,2316620526,2120440,269118099,2525,1449134,1856407151,1448046,1856284097,1088,123054,1432507,5633,1758145,138504,2525,1679,5500.0,1000.0,-67.0,-63.0,-65.0,-67.0,-66.0,-62.0,-65.0,-68.0,-74.0,-82.0,-72.0,-78.0,7.0,19.0,7.0,11.0,1
553,CC:2F:71:3E:C5:1F,5527009,4450876193,3406542,4181755488,2120467,269120705,502,93149,7994362,78573,6266754,14576,1727608,21505,518,3413924,870550,502,2923,6500.0,1000.0,-73.0,-72.0,-70.0,-62.0,-68.0,-71.0,-65.0,-61.0,-74.0,-81.0,-71.0,-77.0,1.0,9.0,1.0,15.0,1
554,F8:59:71:5A:E0:3D,3366029,2136114578,1245524,1866990064,2120505,269124514,283,702267,855503527,701597,855422822,670,80705,692109,1815,1245613,135818,283,960,72222.0,21667.0,-66.0,-73.0,-63.0,-69.0,-67.0,-73.0,-64.0,-70.0,-74.0,-81.0,-72.0,-77.0,8.0,8.0,9.0,8.0,1
555,CC:2F:71:3F:1F:24,3881854,2589900232,1761342,2320775052,2120512,269125180,2525,1451866,1859894302,1450777,1859771130,1089,123172,1435141,5700,1761018,139548,2525,1682,52000.0,6500.0,-68.0,-64.0,-68.0,-70.0,-68.0,-63.0,-69.0,-69.0,-74.0,-81.0,-72.0,-77.0,6.0,17.0,4.0,7.0,1
556,CC:2F:71:3E:C5:1F,5527056,4450880870,3406542,4181755488,2120514,269125382,502,93150,7994480,78573,6266754,14577,1727726,21506,518,3413924,870550,502,2923,6500.0,1000.0,-73.0,-72.0,-70.0,-62.0,-69.0,-71.0,-66.0,-61.0,-74.0,-81.0,-72.0,-77.0,1.0,9.0,2.0,15.0,1
557,F8:59:71:5A:E0:3D,3367005,2137559638,1246485,1868433650,2120520,269125988,283,703154,856677999,702484,856597294,670,80705,692986,1815,1246575,135906,283,960,130000.0,39000.0,-67.0,-73.0,-64.0,-70.0,-66.0,-72.0,-63.0,-70.0,-74.0,-81.0,-72.0,-77.0,7.0,8.0,8.0,7.0,1
558,CC:2F:71:3F:1F:24,3883865,2592872919,1763345,2323746931,2120520,269125988,2525,1452587,1860804464,1451498,1860681292,1089,123172,1435861,5700,1763018,141267,2525,1683,115556.0,28889.0,-68.0,-63.0,-67.0,-69.0,-69.0,-63.0,-69.0,-69.0,-74.0,-81.0,-72.0,-77.0,6.0,18.0,5.0,8.0,1
559,CC:2F:71:3E:C5:1F,5527065,4450881738,3406542,4181755488,2120523,269126250,502,93150,7994480,78573,6266754,14577,1727726,21506,518,3413924,870550,502,2923,6500.0,1000.0,-73.0,-72.0,-70.0,-62.0,-69.0,-71.0,-66.0,-61.0,-74.0,-81.0,-72.0,-77.0,1.0,9.0,2.0,15.0,1
560,F8:59:71:5A:E0:3D,3367114,2137719525,1246589,1868593073,2120525,269126452,283,703429,857096199,702759,857015494,670,80705,693259,1815,1246682,135906,283,960,144444.0,43333.0,-67.0,-73.0,-63.0,-70.0,-66.0,-72.0,-63.0,-70.0,-74.0,-81.0,-72.0,-77.0,7.0,8.0,9.0,7.0,1
561,CC:2F:71:3F:1F:24,3885454,2595162220,1764929,2326035768,2120525,269126452,2525,1452939,1861087400,1451850,1860964228,1089,123172,1436211,5700,1764611,142075,2525,1683,115556.0,26000.0,-69.0,-63.0,-68.0,-68.0,-69.0,-63.0,-69.0,-68.0,-74.0,-81.0,-72.0,-77.0,5.0,18.0,4.0,9.0,1
562,CC:2F:71:3E:C5:1F,5527067,4450881940,3406542,4181755488,2120525,269126452,502,93150,7994480,78573,6266754,14577,1727726,21506,518,3413924,870550,502,2923,6500.0,1000.0,-73.0,-72.0,-70.0,-62.0,-69.0,-71.0,-66.0,-61.0,-74.0,-81.0,-72.0,-77.0,1.0,9.0,2.0,15.0,1
563,F8:59:71:5A:E0:3D,3367181,2137817831,1246652,1868690975,2120529,269126856,283,703494,857193359,702824,857112654,670,80705,693322,1815,1246745,135910,283,960,144444.0,43333.0,-67.0,-72.0,-64.0,-70.0,-67.0,-72.0,-63.0,-70.0,-74.0,-81.0,-72.0,-77.0,7.0,9.0,8.0,7.0,1
564,CC:2F:71:3F:1F:24,3885616,2595368826,1765085,2326241768,2120531,269127058,2525,1453084,1861286140,1451995,1861162968,1089,123172,1436356,5700,1764767,142101,2525,1683,115556.0,28889.0,-68.0,-63.0,-68.0,-69.0,-69.0,-63.0,-69.0,-69.0,-74.0,-81.0,-72.0,-77.0,6.0,18.0,4.0,8.0,1
565,CC:2F:71:3E:C5:1F,5527077,4450883147,3406546,4181756089,2120531,269127058,502,93156,7995271,78579,6267545,14577,1727726,21512,518,3413928,870552,502,2923,6500.0,1000.0,-70.0,-72.0,-68.0,-62.0,-71.0,-71.0,-68.0,-61.0,-74.0,-81.0,-72.0,-77.0,4.0,9.0,4.0,15.0,1
566,F8:59:71:5A:E0:3D,3367247,2137915995,1246715,1868788877,2120532,269127118,283,703558,857291919,702888,857211214,670,80705,693386,1815,1246808,135912,283,960,144444.0,43333.0,-67.0,-73.0,-63.0,-70.0,-67.0,-72.0,-63.0,-70.0,-74.0,-81.0,-72.0,-77.0,7.0,8.0,9.0,7.0,1
567,CC:2F:71:3F:1F:24,3885780,2595578588,1765248,2326451470,2120532,269127118,2525,1453232,1861486690,1452143,1861363518,1089,123172,1436503,5700,1764930,142127,2525,1683,115556.0,28889.0,-69.0,-63.0,-68.0,-69.0,-69.0,-63.0,-69.0,-69.0,-74.0,-81.0,-72.0,-77.0,5.0,18.0,4.0,8.0,1
568,CC:2F:71:3E:C5:1F,5527080,4450883409,3406546,4181756089,2120534,269127320,502,93156,7995271,78579,6267545,14577,1727726,21512,518,3413928,870552,502,2923,6500.0,1000.0,-70.0,-72.0,-68.0,-62.0,-71.0,-71.0,-68.0,-61.0,-74.0,-81.0,-72.0,-77.0,4.0,9.0,4.0,15.0,1
569,F8:59:71:5A:E0:3D,3367474,2138256605,1246936,1869128881,2120538,269127724,283,703661,857396891,702991,857316186,670,80705,693489,1815,1247029,135927,283,960,144444.0,43333.0,-67.0,-72.0,-64.0,-70.0,-66.0,-72.0,-63.0,-70.0,-74.0,-81.0,-72.0,-77.0,7.0,9.0,8.0,7.0,1
570,CC:2F:71:3F:1F:24,3885943,2595785100,1765405,2326657376,2120538,269127724,2525,1453376,1861685370,1452287,1861562198,1089,123172,1436646,5700,1765087,142177,2525,1683,115556.0,28889.0,-68.0,-63.0,-68.0,-68.0,-69.0,-63.0,-70.0,-69.0,-74.0,-81.0,-72.0,-77.0,6.0,18.0,4.0,9.0,1
571,CC:2F:71:3E:C5:1F,5527084,4450883813,3406546,4181756089,2120538,269127724,502,93156,7995271,78579,6267545,14577,1727726,21512,518,3413928,870552,502,2923,6500.0,1000.0,-70.0,-72.0,-68.0,-62.0,-71.0,-71.0,-68.0,-61.0,-74.0,-81.0,-72.0,-77.0,4.0,9.0,4.0,15.0,1
572,F8:59:71:5A:E0:3D,3367544,2138354078,1247003,1869225879,2120541,269128199,283,703728,857497912,703058,857417207,670,80705,693556,1815,1247096,135928,283,960,144444.0,43333.0,-66.0,-73.0,-63.0,-70.0,-66.0,-72.0,-63.0,-69.0,-74.0,-81.0,-72.0,-77.0,8.0,8.0,9.0,7.0,1
573,CC:2F:71:3F:1F:24,3886100,2595987099,1765559,2326858900,2120541,269128199,2525,1453520,1861879722,1452431,1861756550,1089,123172,1436790,5700,1765241,142214,2525,1683,115556.0,28889.0,-68.0,-63.0,-67.0,-69.0,-68.0,-63.0,-68.0,-68.0,-74.0,-81.0,-72.0,-77.0,6.0,18.0,5.0,8.0,1
574,CC:2F:71:3E:C5:1F,5527087,4450884288,3406546,4181756089,2120541,269128199,502,93156,7995271,78579,6267545,14577,1727726,21512,518,3413928,870552,502,2923,6500.0,1000.0,-70.0,-72.0,-68.0,-62.0,-71.0,-71.0,-68.0,-61.0,-74.0,-81.0,-72.0,-77.0,4.0,9.0,4.0,15.0,1
575,F8:59:71:5A:E0:3D,3367767,2138672347,1247219,1869543482,2120548,269128865,283,703842,857609059,703172,857528354,670,80705,693670,1815,1247312,135937,283,960,144444.0,43333.0,-67.0,-73.0,-64.0,-70.0,-67.0,-72.0,-64.0,-70.0,-74.0,-81.0,-72.0,-77.0,7.0,8.0,8.0,7.0,1
576,CC:2F:71:3F:1F:24,3886268,2596198519,1765720,2327069654,2120548,269128865,2525,1453665,1862078504,1452576,1861955332,1089,123172,1436935,5700,1765402,142266,2525,1683,115556.0,28889.0,-68.0,-63.0,-68.0,-69.0,-69.0,-63.0,-69.0,-69.0,-74.0,-81.0,-72.0,-77.0,6.0,18.0,4.0,8.0,1
577,CC:2F:71:3E:C5:1F,5527094,4450884954,3406546,4181756089,2120548,269128865,502,93156,7995271,78579,6267545,14577,1727726,21512,518,3413928,870552,502,2923,6500.0,1000.0,-70.0,-72.0,-68.0,-62.0,-71.0,-71.0,-68.0,-61.0,-74.0,-81.0,-72.0,-77.0,4.0,9.0,4.0,15.0,1
578,F8:59:71:5A:E0:3D,3368101,2139134943,1247549,1870005508,2120552,269129435,283,703937,857711628,703267,857630923,670,80705,693765,1815,1247642,135939,283,960,144444.0,43333.0,-67.0,-73.0,-63.0,-70.0,-66.0,-72.0,-64.0,-70.0,-75.0,-82.0,-73.0,-79.0,8.0,9.0,10.0,9.0,1
579,CC:2F:71:3F:1F:24,3886432,2596405637,1765880,2327276202,2120552,269129435,2525,1453813,1862279020,1452724,1862155848,1089,123172,1437082,5700,1765562,142305,2525,1683,115556.0,28889.0,-71.0,-63.0,-73.0,-70.0,-69.0,-63.0,-69.0,-69.0,-75.0,-82.0,-73.0,-79.0,4.0,19.0,0.0,9.0,1
580,CC:2F:71:3E:C5:1F,5527099,4450885640,3406547,4181756205,2120552,269129435,502,93156,7995271,78579,6267545,14577,1727726,21512,518,3413929,870552,502,2923,6500.0,1000.0,-70.0,-72.0,-68.0,-62.0,-71.0,-71.0,-68.0,-61.0,-75.0,-82.0,-73.0,-79.0,5.0,10.0,5.0,17.0,1
581,F8:59:71:5A:E0:3D,3368176,2139234370,1247618,1870104329,2120558,269130041,283,704004,857810640,703334,857729935,670,80705,693832,1815,1247711,135940,283,960,144444.0,43333.0,-67.0,-73.0,-63.0,-69.0,-66.0,-72.0,-63.0,-70.0,-75.0,-82.0,-73.0,-79.0,8.0,9.0,10.0,10.0,1
582,CC:2F:71:3F:1F:24,3886592,2596607767,1766034,2327477726,2120558,269130041,2525,1453957,1862474810,1452868,1862351638,1089,123172,1437225,5700,1765716,142349,2525,1683,115556.0,28889.0,-71.0,-63.0,-73.0,-70.0,-70.0,-63.0,-72.0,-69.0,-75.0,-82.0,-73.0,-79.0,4.0,19.0,0.0,9.0,1
583,CC:2F:71:3E:C5:1F,5527105,4450886246,3406547,4181756205,2120558,269130041,502,93156,7995271,78579,6267545,14577,1727726,21512,518,3413929,870552,502,2923,6500.0,1000.0,-70.0,-72.0,-68.0,-62.0,-71.0,-71.0,-68.0,-61.0,-75.0,-82.0,-73.0,-79.0,5.0,10.0,5.0,17.0,1
584,F8:59:71:5A:E0:3D,3368242,2139332534,1247681,1870202231,2120561,269130303,283,704067,857907660,703397,857826955,670,80705,693895,1815,1247774,135942,283,960,144444.0,43333.0,-67.0,-72.0,-63.0,-70.0,-67.0,-72.0,-63.0,-70.0,-75.0,-82.0,-73.0,-79.0,8.0,10.0,10.0,9.0,1
585,CC:2F:71:3F:1F:24,3886765,2596817770,1766204,2327687467,2120561,269130303,2525,1454114,1862676167,1453025,1862552995,1089,123172,1437382,5700,1765886,142398,2525,1683,115556.0,28889.0,-69.0,-63.0,-67.0,-68.0,-69.0,-63.0,-69.0,-69.0,-75.0,-82.0,-73.0,-79.0,6.0,19.0,6.0,11.0,1
586,CC:2F:71:3E:C5:1F,5527110,4450886740,3406549,4181756437,2120561,269130303,502,93158,7995483,78581,6267757,14577,1727726,21514,518,3413931,870552,502,2923,6500.0,1000.0,-73.0,-72.0,-69.0,-62.0,-70.0,-71.0,-67.0,-61.0,-75.0,-82.0,-73.0,-79.0,2.0,10.0,4.0,17.0,1
587,F8:59:71:5A:E0:3D,3368310,2139430902,1247744,1870300133,2120566,269130769,283,704132,858006352,703461,857925529,671,80823,693959,1815,1247837,135944,283,960,144444.0,43333.0,-66.0,-72.0,-64.0,-70.0,-66.0,-72.0,-63.0,-70.0,-75.0,-82.0,-73.0,-79.0,9.0,10.0,9.0,9.0,1
588,CC:2F:71:3F:1F:24,3886930,2597024530,1766362,2327893559,2120568,269130971,2525,1454261,1862876619,1453172,1862753447,1089,123172,1437527,5700,1766044,142430,2525,1683,115556.0,28889.0,-71.0,-63.0,-73.0,-70.0,-69.0,-63.0,-69.0,-69.0,-75.0,-82.0,-73.0,-79.0,4.0,19.0,0.0,9.0,1
589,CC:2F:71:3E:C5:1F,5527117,4450887408,3406549,4181756437,2120568,269130971,502,93158,7995483,78581,6267757,14577,1727726,21514,518,3413931,870552,502,2923,6500.0,1000.0,-73.0,-72.0,-69.0,-62.0,-70.0,-71.0,-67.0,-61.0,-75.0,-82.0,-73.0,-79.0,2.0,10.0,4.0,17.0,1
590,F8:59:71:5A:E0:3D,3368377,2139529208,1247807,1870398035,2120570,269131173,283,704196,858104912,703525,858024089,671,80823,694023,1815,1247900,135947,283,960,144444.0,43333.0,-68.0,-73.0,-65.0,-71.0,-67.0,-72.0,-64.0,-70.0,-74.0,-81.0,-72.0,-78.0,6.0,8.0,7.0,7.0,1
591,CC:2F:71:3F:1F:24,3887091,2597233858,1766521,2328102685,2120570,269131173,2525,1454404,1863073703,1453315,1862950531,1089,123172,1437670,5700,1766203,142452,2525,1683,130000.0,39000.0,-71.0,-64.0,-71.0,-70.0,-69.0,-63.0,-69.0,-70.0,-74.0,-81.0,-72.0,-78.0,3.0,17.0,1.0,8.0,1
592,CC:2F:71:3E:C5:1F,5527119,4450887610,3406549,4181756437,2120570,269131173,502,93158,7995483,78581,6267757,14577,1727726,21514,518,3413931,870552,502,2923,6500.0,1000.0,-73.0,-72.0,-69.0,-62.0,-70.0,-71.0,-67.0,-61.0,-74.0,-81.0,-72.0,-78.0,1.0,9.0,3.0,16.0,1
593,F8:59:71:5A:E0:3D,3368445,2139627574,1247870,1870495937,2120575,269131637,283,704260,858203500,703589,858122677,671,80823,694085,1815,1247963,135953,283,960,144444.0,43333.0,-68.0,-74.0,-65.0,-71.0,-67.0,-73.0,-64.0,-70.0,-74.0,-81.0,-72.0,-78.0,6.0,7.0,7.0,7.0,1
594,CC:2F:71:3F:1F:24,3887340,2597550161,1766765,2328418524,2120575,269131637,2525,1454580,1863281850,1453491,1863158678,1089,123172,1437846,5700,1766445,142511,2525,1683,130000.0,39000.0,-68.0,-63.0,-68.0,-69.0,-69.0,-63.0,-69.0,-69.0,-74.0,-81.0,-72.0,-78.0,6.0,18.0,4.0,9.0,1
595,CC:2F:71:3E:C5:1F,5527124,4450888074,3406549,4181756437,2120575,269131637,502,93158,7995483,78581,6267757,14577,1727726,21514,518,3413931,870552,502,2923,6500.0,1000.0,-73.0,-72.0,-69.0,-62.0,-70.0,-71.0,-67.0,-61.0,-74.0,-81.0,-72.0,-78.0,1.0,9.0,3.0,16.0,1
596,F8:59:71:5A:E0:3D,3368835,2140219561,1248255,1871087458,2120580,269132103,283,704395,858333341,703724,858252518,671,80823,694220,1815,1248348,135984,283,960,144444.0,43333.0,-67.0,-74.0,-63.0,-70.0,-67.0,-73.0,-64.0,-70.0,-74.0,-81.0,-72.0,-78.0,7.0,7.0,9.0,8.0,1
597,CC:2F:71:3F:1F:24,3889285,2600350894,1768705,2331218791,2120580,269132103,2525,1454969,1863540262,1453880,1863417090,1089,123172,1438235,5700,1768387,143091,2525,1683,115556.0,28889.0,-68.0,-64.0,-67.0,-69.0,-69.0,-63.0,-68.0,-69.0,-74.0,-81.0,-72.0,-78.0,6.0,17.0,5.0,9.0,1
598,CC:2F:71:3E:C5:1F,5527129,4450888540,3406549,4181756437,2120580,269132103,502,93159,7995601,78581,6267757,14578,1727844,21515,518,3413931,870552,502,2923,6500.0,1000.0,-69.0,-72.0,-66.0,-61.0,-70.0,-71.0,-67.0,-61.0,-74.0,-81.0,-72.0,-78.0,5.0,9.0,6.0,17.0,1
599,F8:59:71:5A:E0:3D,3368901,2140317727,1248318,1871185360,2120583,269132367,283,704459,858431901,703788,858351078,671,80823,694284,1815,1248411,135986,283,960,144444.0,43333.0,-67.0,-73.0,-64.0,-71.0,-67.0,-73.0,-64.0,-70.0,-74.0,-81.0,-72.0,-78.0,7.0,8.0,8.0,7.0,1
600,CC:2F:71:3F:1F:24,3889448,2600557676,1768863,2331425107,2120585,269132569,2525,1455113,1863737464,1454023,1863614174,1090,123290,1438379,5700,1768545,143100,2525,1683,115556.0,28889.0,-71.0,-64.0,-71.0,-71.0,-69.0,-63.0,-68.0,-70.0,-74.0,-81.0,-72.0,-78.0,3.0,17.0,1.0,7.0,1
601,CC:2F:71:3E:C5:1F,5527135,4450889066,3406549,4181756437,2120586,269132629,502,93159,7995601,78581,6267757,14578,1727844,21515,518,3413931,870552,502,2923,6500.0,1000.0,-69.0,-72.0,-66.0,-61.0,-70.0,-71.0,-67.0,-61.0,-74.0,-81.0,-72.0,-78.0,5.0,9.0,6.0,17.0,1
602,F8:59:71:5A:E0:3D,3369070,2140538511,1248481,1871405554,2120589,269132957,283,704535,858533654,703864,858452831,671,80823,694359,1815,1248574,135987,283,960,144444.0,43333.0,-68.0,-74.0,-65.0,-71.0,-67.0,-73.0,-64.0,-70.0,-74.0,-81.0,-72.0,-78.0,6.0,7.0,7.0,7.0,1
603,CC:2F:71:3F:1F:24,3889612,2600763183,1769021,2331630024,2120591,269133159,2525,1455262,1863936711,1454172,1863813421,1090,123290,1438527,5700,1768703,143110,2525,1683,115556.0,28889.0,-71.0,-64.0,-71.0,-71.0,-69.0,-63.0,-68.0,-69.0,-74.0,-81.0,-72.0,-78.0,3.0,17.0,1.0,7.0,1
604,CC:2F:71:3E:C5:1F,5527140,4450889596,3406549,4181756437,2120591,269133159,502,93159,7995601,78581,6267757,14578,1727844,21515,518,3413931,870552,502,2923,6500.0,1000.0,-69.0,-72.0,-66.0,-61.0,-70.0,-71.0,-67.0,-61.0,-74.0,-81.0,-72.0,-78.0,5.0,9.0,6.0,17.0,1
605,F8:59:71:5A:E0:3D,3369136,2140636731,1248545,1871503572,2120591,269133159,283,704599,858630780,703928,858549957,671,80823,694423,1815,1248638,135988,283,960,144444.0,43333.0,-67.0,-73.0,-64.0,-70.0,-67.0,-73.0,-64.0,-70.0,-74.0,-81.0,-72.0,-78.0,7.0,8.0,8.0,8.0,1
606,CC:2F:71:3F:1F:24,3889769,2600967147,1769178,2331833988,2120591,269133159,2525,1455404,1864130821,1454314,1864007531,1090,123290,1438669,5700,1768860,143161,2525,1683,115556.0,28889.0,-69.0,-64.0,-68.0,-70.0,-69.0,-63.0,-68.0,-69.0,-74.0,-81.0,-72.0,-78.0,5.0,17.0,4.0,8.0,1
607,CC:2F:71:3E:C5:1F,5527142,4450889798,3406549,4181756437,2120593,269133361,502,93159,7995601,78581,6267757,14578,1727844,21515,518,3413931,870552,502,2923,6500.0,1000.0,-69.0,-72.0,-66.0,-61.0,-70.0,-71.0,-67.0,-61.0,-74.0,-81.0,-72.0,-78.0,5.0,9.0,6.0,17.0,1
608,F8:59:71:5A:E0:3D,3369206,2140735299,1248608,1871601474,2120598,269133825,283,704662,858727800,703991,858646977,671,80823,694486,1815,1248701,135992,283,960,144444.0,43333.0,-68.0,-74.0,-65.0,-71.0,-67.0,-73.0,-63.0,-70.0,-75.0,-82.0,-73.0,-78.0,7.0,8.0,8.0,7.0,1
609,CC:2F:71:3F:1F:24,3889934,2601174129,1769336,2332040304,2120598,269133825,2525,1455549,1864328137,1454459,1864204847,1090,123290,1438814,5700,1769018,143177,2525,1683,115556.0,28889.0,-67.0,-64.0,-67.0,-69.0,-67.0,-63.0,-67.0,-69.0,-75.0,-82.0,-73.0,-78.0,8.0,18.0,6.0,9.0,1
610,CC:2F:71:3E:C5:1F,5527147,4450890262,3406549,4181756437,2120598,269133825,502,93159,7995601,78581,6267757,14578,1727844,21515,518,3413931,870552,502,2923,6500.0,1000.0,-69.0,-72.0,-66.0,-61.0,-70.0,-71.0,-67.0,-61.0,-75.0,-82.0,-73.0,-78.0,6.0,10.0,7.0,17.0,1
611,F8:59:71:5A:E0:3D,3369280,2140834665,1248680,1871700638,2120600,269134027,283,704733,858831016,704062,858750193,671,80823,694557,1815,1248773,135994,283,960,144444.0,43333.0,-68.0,-74.0,-65.0,-71.0,-67.0,-73.0,-64.0,-70.0,-75.0,-82.0,-73.0,-78.0,7.0,8.0,8.0,7.0,1
612,CC:2F:71:3F:1F:24,3890094,2601380591,1769494,2332246564,2120600,269134027,2525,1455693,1864526775,1454603,1864403485,1090,123290,1438957,5700,1769176,143180,2525,1683,117000.0,39000.0,-71.0,-64.0,-71.0,-71.0,-70.0,-63.0,-69.0,-70.0,-75.0,-82.0,-73.0,-78.0,4.0,18.0,2.0,7.0,1
613,CC:2F:71:3E:C5:1F,5527149,4450890464,3406549,4181756437,2120600,269134027,502,93159,7995601,78581,6267757,14578,1727844,21515,518,3413931,870552,502,2923,6500.0,1000.0,-69.0,-72.0,-66.0,-61.0,-70.0,-71.0,-67.0,-61.0,-75.0,-82.0,-73.0,-78.0,6.0,10.0,7.0,17.0,1
614,F8:59:71:5A:E0:3D,3369416,2141023969,1248811,1871889265,2120605,269134704,283,704812,858937623,704141,858856800,671,80823,694636,1815,1248904,136004,283,960,144444.0,43333.0,-68.0,-74.0,-65.0,-71.0,-67.0,-73.0,-64.0,-71.0,-75.0,-82.0,-73.0,-78.0,7.0,8.0,8.0,7.0,1
615,CC:2F:71:3F:1F:24,3890260,2601588780,1769653,2332453874,2120607,269134906,2525,1455838,1864726953,1454748,1864603663,1090,123290,1439101,5700,1769334,143213,2525,1683,130000.0,43333.0,-69.0,-64.0,-67.0,-69.0,-69.0,-63.0,-68.0,-69.0,-75.0,-82.0,-73.0,-78.0,6.0,18.0,6.0,9.0,1
616,CC:2F:71:3E:C5:1F,5527156,4450891343,3406549,4181756437,2120607,269134906,502,93159,7995601,78581,6267757,14578,1727844,21515,518,3413931,870552,502,2923,6500.0,1000.0,-69.0,-72.0,-66.0,-61.0,-70.0,-71.0,-67.0,-61.0,-75.0,-82.0,-73.0,-78.0,6.0,10.0,7.0,17.0,1
617,F8:59:71:5A:E0:3D,3372400,2145567609,1251790,1876432441,2120610,269135168,283,705484,859136991,704813,859056168,671,80823,695308,1815,1251883,136194,283,960,144444.0,43333.0,-68.0,-74.0,-65.0,-71.0,-67.0,-73.0,-64.0,-70.0,-75.0,-82.0,-73.0,-78.0,7.0,8.0,8.0,7.0,1
618,CC:2F:71:3F:1F:24,3890430,2601808784,1769820,2332673616,2120610,269135168,2525,1455997,1864947393,1454907,1864824103,1090,123290,1439257,5700,1769502,143306,2525,1683,130000.0,43333.0,-71.0,-64.0,-71.0,-70.0,-70.0,-63.0,-69.0,-69.0,-75.0,-82.0,-73.0,-78.0,4.0,18.0,2.0,8.0,1
619,CC:2F:71:3E:C5:1F,5527159,4450891605,3406549,4181756437,2120610,269135168,502,93159,7995601,78581,6267757,14578,1727844,21515,518,3413931,870552,502,2923,6500.0,1000.0,-69.0,-72.0,-66.0,-61.0,-70.0,-71.0,-67.0,-61.0,-75.0,-82.0,-73.0,-78.0,6.0,10.0,7.0,17.0,1
620,F8:59:71:5A:E0:3D,3373096,2146657386,1252482,1877521814,2120614,269135572,283,705736,859260613,705065,859179790,671,80823,695560,1815,1252575,136218,283,960,144444.0,43333.0,-68.0,-74.0,-65.0,-72.0,-67.0,-73.0,-64.0,-70.0,-74.0,-81.0,-72.0,-78.0,6.0,7.0,7.0,6.0,1
621,CC:2F:71:3F:1F:24,3890596,2602021720,1769982,2332886148,2120614,269135572,2525,1456143,1865147870,1455053,1865024580,1090,123290,1439402,5700,1769664,143331,2525,1683,130000.0,43333.0,-71.0,-64.0,-71.0,-71.0,-68.0,-63.0,-68.0,-69.0,-74.0,-81.0,-72.0,-78.0,3.0,17.0,1.0,7.0,1
622,CC:2F:71:3E:C5:1F,5527163,4450892009,3406549,4181756437,2120614,269135572,502,93159,7995601,78581,6267757,14578,1727844,21515,518,3413931,870552,502,2923,6500.0,1000.0,-69.0,-72.0,-66.0,-61.0,-70.0,-71.0,-67.0,-61.0,-74.0,-81.0,-72.0,-78.0,5.0,9.0,6.0,17.0,1
623,F8:59:71:5A:E0:3D,3373167,2146753503,1252549,1877617527,2120618,269135976,283,705803,859359441,705132,859278618,671,80823,695626,1815,1252642,136219,283,960,144444.0,43333.0,-68.0,-74.0,-65.0,-72.0,-68.0,-73.0,-64.0,-71.0,-74.0,-81.0,-72.0,-78.0,6.0,7.0,7.0,6.0,1
624,CC:2F:71:3F:1F:24,3890761,2602226135,1770143,2333090159,2120618,269135976,2525,1456289,1865343987,1455199,1865220697,1090,123290,1439547,5700,1769825,143346,2525,1683,130000.0,43333.0,-68.0,-64.0,-68.0,-69.0,-69.0,-64.0,-69.0,-70.0,-74.0,-81.0,-72.0,-78.0,6.0,17.0,4.0,9.0,1
625,CC:2F:71:3E:C5:1F,5527167,4450892413,3406549,4181756437,2120618,269135976,502,93159,7995601,78581,6267757,14578,1727844,21515,518,3413931,870552,502,2923,6500.0,1000.0,-69.0,-72.0,-66.0,-61.0,-70.0,-71.0,-67.0,-61.0,-74.0,-81.0,-72.0,-78.0,5.0,9.0,6.0,17.0,1
626,F8:59:71:5A:E0:3D,3373240,2146851141,1252617,1877714701,2120623,269136440,283,705868,859456244,705197,859375421,671,80823,695691,1815,1252710,136219,283,960,144444.0,43333.0,-67.0,-73.0,-64.0,-70.0,-67.0,-73.0,-64.0,-70.0,-74.0,-81.0,-72.0,-78.0,7.0,8.0,8.0,8.0,1
627,CC:2F:71:3F:1F:24,3890921,2602429229,1770298,2333292789,2120623,269136440,2525,1456431,1865539545,1455341,1865416255,1090,123290,1439688,5700,1769980,143366,2525,1683,130000.0,43333.0,-70.0,-64.0,-70.0,-70.0,-69.0,-63.0,-69.0,-69.0,-74.0,-81.0,-72.0,-78.0,4.0,17.0,2.0,8.0,1
628,CC:2F:71:3E:C5:1F,5527172,4450892877,3406549,4181756437,2120623,269136440,502,93159,7995601,78581,6267757,14578,1727844,21515,518,3413932,870552,502,2923,6500.0,1000.0,-69.0,-72.0,-66.0,-61.0,-70.0,-71.0,-67.0,-61.0,-74.0,-81.0,-72.0,-78.0,5.0,9.0,6.0,17.0,1
629,F8:59:71:5A:E0:3D,3373553,2147292831,1252926,1878155987,2120627,269136844,283,705961,859560361,705290,859479538,671,80823,695784,1815,1253019,136298,283,960,144444.0,43333.0,-66.0,-72.0,-63.0,-70.0,-67.0,-73.0,-63.0,-70.0,-75.0,-82.0,-73.0,-79.0,9.0,10.0,10.0,9.0,1
630,CC:2F:71:3F:1F:24,3891082,2602635819,1770455,2333498975,2120627,269136844,2525,1456574,1865736657,1455484,1865613367,1090,123290,1439831,5700,1770137,143375,2525,1683,130000.0,43333.0,-68.0,-64.0,-67.0,-69.0,-69.0,-63.0,-68.0,-69.0,-75.0,-82.0,-73.0,-79.0,7.0,18.0,6.0,10.0,1
631,CC:2F:71:3E:C5:1F,5527176,4450893281,3406549,4181756437,2120627,269136844,502,93159,7995601,78581,6267757,14578,1727844,21515,518,3413932,870552,502,2923,6500.0,1000.0,-69.0,-72.0,-66.0,-61.0,-70.0,-71.0,-67.0,-61.0,-75.0,-82.0,-73.0,-79.0,6.0,10.0,7.0,18.0,1
632,F8:59:71:5A:E0:3D,3373626,2147392056,1252995,1878254808,2120631,269137248,283,706028,859659225,705357,859578402,671,80823,695850,1815,1253087,136300,283,960,144444.0,43333.0,-66.0,-73.0,-63.0,-70.0,-66.0,-73.0,-63.0,-70.0,-75.0,-82.0,-73.0,-79.0,9.0,9.0,10.0,9.0,1
633,CC:2F:71:3F:1F:24,3891252,2602842426,1770621,2333705178,2120631,269137248,2525,1456729,1865939631,1455639,1865816341,1090,123290,1439986,5700,1770303,143396,2525,1683,130000.0,43333.0,-71.0,-64.0,-71.0,-70.0,-69.0,-64.0,-69.0,-70.0,-75.0,-82.0,-73.0,-79.0,4.0,18.0,2.0,9.0,1
634,CC:2F:71:3E:C5:1F,5527180,4450893685,3406549,4181756437,2120631,269137248,502,93159,7995601,78581,6267757,14578,1727844,21515,518,3413932,870552,502,2923,6500.0,1000.0,-69.0,-72.0,-66.0,-61.0,-70.0,-71.0,-67.0,-61.0,-77.0,-83.0,-75.0,-80.0,8.0,11.0,9.0,19.0,1
635,F8:59:71:5A:E0:3D,3373874,2147761968,1253240,1878624458,2120634,269137510,283,706125,859768680,705454,859687857,671,80823,695947,1815,1253333,136300,283,960,144444.0,43333.0,-67.0,-73.0,-65.0,-71.0,-66.0,-73.0,-64.0,-70.0,-77.0,-83.0,-75.0,-80.0,10.0,10.0,10.0,9.0,1
636,CC:2F:71:3F:1F:24,3891515,2603181901,1770879,2334044189,2120636,269137712,2525,1456904,1866145685,1455814,1866022395,1090,123290,1440161,5700,1770559,143435,2525,1683,130000.0,43333.0,-68.0,-64.0,-68.0,-70.0,-68.0,-63.0,-68.0,-69.0,-77.0,-83.0,-75.0,-80.0,9.0,19.0,7.0,10.0,1
637,CC:2F:71:3E:C5:1F,5527185,4450894149,3406549,4181756437,2120636,269137712,502,93159,7995601,78581,6267757,14578,1727844,21515,518,3413932,870552,502,2923,6500.0,1000.0,-69.0,-72.0,-66.0,-61.0,-70.0,-71.0,-67.0,-61.0,-77.0,-83.0,-75.0,-80.0,8.0,11.0,9.0,19.0,1
638,F8:59:71:5A:E0:3D,3373948,2147861727,1253308,1878723611,2120640,269138116,283,706194,859867859,705523,859787036,671,80823,696016,1815,1253401,136307,283,960,144444.0,43333.0,-67.0,-73.0,-64.0,-70.0,-66.0,-73.0,-64.0,-70.0,-77.0,-83.0,-75.0,-80.0,10.0,10.0,11.0,10.0,1
639,CC:2F:71:3F:1F:24,3891677,2603388621,1771037,2334250505,2120640,269138116,2525,1457051,1866346095,1455961,1866222805,1090,123290,1440307,5700,1770719,143451,2525,1683,130000.0,43333.0,-68.0,-64.0,-67.0,-69.0,-68.0,-63.0,-67.0,-69.0,-77.0,-83.0,-75.0,-80.0,9.0,19.0,8.0,11.0,1
640,CC:2F:71:3E:C5:1F,5527189,4450894553,3406549,4181756437,2120640,269138116,502,93159,7995601,78581,6267757,14578,1727844,21515,518,3413932,870552,502,2923,6500.0,1000.0,-69.0,-72.0,-66.0,-61.0,-70.0,-71.0,-67.0,-61.0,-77.0,-83.0,-75.0,-80.0,8.0,11.0,9.0,19.0,1
641,F8:59:71:5A:E0:3D,3374710,2149054018,1254068,1879915700,2120642,269138318,283,706393,859985497,705722,859904674,671,80823,696215,1815,1254161,136388,283,960,144444.0,43333.0,-67.0,-74.0,-63.0,-71.0,-67.0,-73.0,-64.0,-70.0,-77.0,-83.0,-75.0,-80.0,10.0,9.0,12.0,9.0,1
642,CC:2F:71:3F:1F:24,3891840,2603600553,1771198,2334462235,2120642,269138318,2525,1457197,1866549265,1456107,1866425975,1090,123290,1440453,5700,1770880,143516,2525,1684,130000.0,43333.0,-68.0,-64.0,-67.0,-70.0,-68.0,-64.0,-67.0,-69.0,-77.0,-83.0,-75.0,-80.0,9.0,19.0,8.0,10.0,1
643,CC:2F:71:3E:C5:1F,5527193,4450894957,3406549,4181756437,2120644,269138520,502,93159,7995601,78581,6267757,14578,1727844,21515,518,3413932,870552,502,2923,6500.0,1000.0,-69.0,-72.0,-66.0,-61.0,-70.0,-71.0,-67.0,-61.0,-77.0,-83.0,-75.0,-80.0,8.0,11.0,9.0,19.0,1
644,F8:59:71:5A:E0:3D,3374777,2149153736,1254132,1880015156,2120645,269138580,283,706460,860085751,705789,860004928,671,80823,696279,1815,1254225,136394,283,960,144444.0,43333.0,-67.0,-73.0,-64.0,-69.0,-67.0,-73.0,-63.0,-69.0,-77.0,-83.0,-75.0,-80.0,10.0,10.0,11.0,11.0,1
645,CC:2F:71:3F:1F:24,3892017,2603810251,1771368,2334671267,2120649,269138984,2525,1457352,1866751163,1456262,1866627873,1090,123290,1440608,5700,1771050,143564,2525,1684,130000.0,43333.0,-71.0,-63.0,-71.0,-70.0,-69.0,-63.0,-68.0,-69.0,-77.0,-83.0,-75.0,-80.0,6.0,20.0,4.0,10.0,1
646,CC:2F:71:3E:C5:1F,5527198,4450895421,3406549,4181756437,2120649,269138984,502,93159,7995601,78581,6267757,14578,1727844,21515,518,3413932,870552,502,2923,6500.0,1000.0,-69.0,-72.0,-66.0,-61.0,-70.0,-71.0,-67.0,-61.0,-77.0,-83.0,-75.0,-80.0,8.0,11.0,9.0,19.0,1
647,F8:59:71:5A:E0:3D,3374843,2149250376,1254194,1880111392,2120649,269138984,283,706522,860181231,705851,860100408,671,80823,696341,1815,1254287,136398,283,960,144444.0,43333.0,-67.0,-73.0,-64.0,-70.0,-67.0,-73.0,-64.0,-70.0,-77.0,-83.0,-75.0,-80.0,10.0,10.0,11.0,10.0,1
648,CC:2F:71:3F:1F:24,3892186,2604015647,1771535,2334876461,2120651,269139186,2525,1457504,1866950557,1456414,1866827267,1090,123290,1440760,5700,1771217,143612,2525,1684,115556.0,28889.0,-69.0,-63.0,-68.0,-69.0,-68.0,-63.0,-67.0,-69.0,-77.0,-83.0,-75.0,-80.0,8.0,20.0,7.0,11.0,1
649,CC:2F:71:3E:C5:1F,5527200,4450895623,3406549,4181756437,2120651,269139186,502,93159,7995601,78581,6267757,14578,1727844,21515,518,3413932,870552,502,2923,6500.0,1000.0,-69.0,-72.0,-66.0,-61.0,-70.0,-71.0,-67.0,-61.0,-77.0,-83.0,-75.0,-80.0,8.0,11.0,9.0,19.0,1
650,F8:59:71:5A:E0:3D,3375031,2149494237,1254378,1880354849,2120653,269139388,283,706603,860284463,705932,860203640,671,80823,696420,1815,1254471,136400,283,960,144444.0,43333.0,-67.0,-73.0,-64.0,-70.0,-67.0,-73.0,-64.0,-70.0,-77.0,-84.0,-75.0,-81.0,10.0,11.0,11.0,11.0,1
651,CC:2F:71:3F:1F:24,3892347,2604225143,1771694,2335085755,2120653,269139388,2525,1457649,1867149297,1456559,1867026007,1090,123290,1440905,5700,1771376,143633,2525,1684,115556.0,28889.0,-67.0,-64.0,-67.0,-69.0,-69.0,-63.0,-69.0,-69.0,-77.0,-84.0,-75.0,-81.0,10.0,20.0,8.0,12.0,1
652,CC:2F:71:3E:C5:1F,5527202,4450895825,3406549,4181756437,2120653,269139388,502,93159,7995601,78581,6267757,14578,1727844,21515,518,3413932,870552,502,2923,6500.0,1000.0,-69.0,-72.0,-66.0,-61.0,-70.0,-71.0,-67.0,-61.0,-77.0,-84.0,-75.0,-81.0,8.0,12.0,9.0,20.0,1
653,F8:59:71:5A:E0:3D,3375103,2149598819,1254445,1880458967,2120658,269139852,283,706670,860387643,705999,860306820,671,80823,696487,1815,1254538,136404,283,960,144444.0,43333.0,-67.0,-73.0,-64.0,-70.0,-67.0,-72.0,-63.0,-70.0,-77.0,-84.0,-75.0,-81.0,10.0,11.0,11.0,11.0,1
654,CC:2F:71:3F:1F:24,3892514,2604439563,1771856,2335299711,2120658,269139852,2525,1457807,1867356297,1456717,1867233007,1090,123290,1441055,5700,1771538,143665,2525,1684,115556.0,28889.0,-68.0,-64.0,-67.0,-69.0,-68.0,-63.0,-67.0,-69.0,-77.0,-84.0,-75.0,-81.0,9.0,20.0,8.0,12.0,1
655,CC:2F:71:3E:C5:1F,5527209,4450896491,3406549,4181756437,2120660,269140054,502,93159,7995601,78581,6267757,14578,1727844,21515,518,3413932,870552,502,2923,6500.0,1000.0,-69.0,-72.0,-66.0,-61.0,-70.0,-71.0,-67.0,-61.0,-77.0,-84.0,-75.0,-81.0,8.0,12.0,9.0,20.0,1
656,F8:59:71:5A:E0:3D,3375183,2149716046,1254520,1880575517,2120663,269140529,283,706745,860503143,706074,860422320,671,80823,696562,1815,1254613,136410,283,960,144444.0,43333.0,-67.0,-73.0,-63.0,-70.0,-66.0,-72.0,-63.0,-69.0,-77.0,-84.0,-75.0,-81.0,10.0,11.0,12.0,11.0,1
657,CC:2F:71:3F:1F:24,3892701,2604684604,1772038,2335544075,2120663,269140529,2525,1457985,1867591065,1456895,1867467775,1090,123290,1441221,5700,1771720,143710,2525,1684,130000.0,39000.0,-69.0,-64.0,-68.0,-70.0,-68.0,-63.0,-67.0,-69.0,-77.0,-84.0,-75.0,-81.0,8.0,20.0,7.0,11.0,1
658,CC:2F:71:3E:C5:1F,5527214,4450897168,3406549,4181756437,2120665,269140731,502,93159,7995601,78581,6267757,14578,1727844,21515,518,3413932,870552,502,2923,6500.0,1000.0,-69.0,-72.0,-66.0,-61.0,-70.0,-71.0,-67.0,-61.0,-77.0,-84.0,-75.0,-81.0,8.0,12.0,9.0,20.0,1
659,F8:59:71:5A:E0:3D,3375321,2149899511,1254653,1880758518,2120668,269140993,283,706829,860613370,706158,860532547,671,80823,696646,1815,1254746,136421,283,960,144444.0,43333.0,-67.0,-73.0,-64.0,-70.0,-67.0,-73.0,-64.0,-70.0,-77.0,-84.0,-76.0,-81.0,10.0,11.0,12.0,11.0,1
660,CC:2F:71:3F:1F:24,3892878,2604911602,1772208,2335770407,2120670,269141195,2525,1458154,1867812033,1457064,1867688743,1090,123290,1441378,5700,1771890,143732,2525,1684,130000.0,43333.0,-68.0,-63.0,-67.0,-70.0,-68.0,-62.0,-67.0,-69.0,-77.0,-84.0,-76.0,-81.0,9.0,21.0,9.0,11.0,1
661,CC:2F:71:3E:C5:1F,5527219,4450897632,3406549,4181756437,2120670,269141195,502,93159,7995601,78581,6267757,14578,1727844,21515,518,3413932,870552,502,2923,6500.0,1000.0,-69.0,-72.0,-66.0,-61.0,-70.0,-71.0,-67.0,-61.0,-77.0,-84.0,-76.0,-81.0,8.0,12.0,10.0,20.0,1
662,F8:59:71:5A:E0:3D,3375470,2150086192,1254772,1880933543,2120698,269152649,283,706945,860787541,706274,860706718,671,80823,696762,1815,1254865,136431,283,961,144444.0,43333.0,-67.0,-73.0,-64.0,-70.0,-66.0,-72.0,-63.0,-70.0,-77.0,-84.0,-76.0,-81.0,10.0,11.0,12.0,11.0,1
663,CC:2F:71:3F:1F:24,3894744,2607558213,1774046,2338405564,2120698,269152649,2531,1458549,1868187275,1457459,1868063985,1090,123290,1441758,5701,1773729,144478,2531,1684,115556.0,26000.0,-68.0,-63.0,-67.0,-69.0,-67.0,-62.0,-67.0,-69.0,-77.0,-84.0,-76.0,-81.0,9.0,21.0,9.0,12.0,1
664,CC:2F:71:3E:C5:1F,5527248,4450909202,3406550,4181756553,2120698,269152649,502,93159,7995601,78581,6267757,14578,1727844,21515,518,3413933,870552,502,2923,6500.0,1000.0,-69.0,-72.0,-66.0,-61.0,-70.0,-71.0,-67.0,-61.0,-77.0,-84.0,-76.0,-81.0,8.0,12.0,10.0,20.0,1
665,F8:59:71:5A:E0:3D,3375553,2150199463,1254850,1881046350,2120703,269153113,283,707021,860900121,706350,860819298,671,80823,696838,1815,1254942,136436,283,961,144444.0,43333.0,-67.0,-73.0,-63.0,-70.0,-67.0,-73.0,-64.0,-70.0,-77.0,-84.0,-76.0,-81.0,10.0,11.0,13.0,11.0,1
666,CC:2F:71:3F:1F:24,3894914,2607777239,1774211,2338624126,2120703,269153113,2531,1458711,1868397597,1457621,1868274307,1090,123290,1441911,5701,1773894,144502,2531,1684,115556.0,28889.0,-68.0,-63.0,-67.0,-69.0,-69.0,-63.0,-68.0,-70.0,-77.0,-84.0,-76.0,-81.0,9.0,21.0,9.0,12.0,1
667,CC:2F:71:3E:C5:1F,5527253,4450909666,3406550,4181756553,2120703,269153113,502,93159,7995601,78581,6267757,14578,1727844,21515,518,3413933,870552,502,2923,6500.0,1000.0,-69.0,-72.0,-66.0,-61.0,-70.0,-71.0,-67.0,-61.0,-77.0,-84.0,-76.0,-81.0,8.0,12.0,10.0,20.0,1
668,F8:59:71:5A:E0:3D,3375625,2150305539,1254918,1881152022,2120707,269153517,283,707089,861004841,706418,860924018,671,80823,696906,1815,1255011,136439,283,961,144444.0,43333.0,-68.0,-74.0,-65.0,-72.0,-67.0,-73.0,-64.0,-70.0,-77.0,-84.0,-76.0,-81.0,9.0,10.0,11.0,9.0,1
669,CC:2F:71:3F:1F:24,3895089,2608002501,1774381,2338848922,2120708,269153579,2531,1458880,1868614187,1457790,1868490897,1090,123290,1442067,5701,1774064,144514,2531,1684,115556.0,26000.0,-71.0,-63.0,-71.0,-70.0,-69.0,-63.0,-69.0,-69.0,-77.0,-84.0,-76.0,-81.0,6.0,21.0,5.0,11.0,1
670,CC:2F:71:3E:C5:1F,5527258,4450910132,3406550,4181756553,2120708,269153579,502,93159,7995601,78581,6267757,14578,1727844,21515,518,3413933,870552,502,2923,6500.0,1000.0,-69.0,-72.0,-66.0,-61.0,-70.0,-71.0,-67.0,-61.0,-77.0,-84.0,-76.0,-81.0,8.0,12.0,10.0,20.0,1
671,F8:59:71:5A:E0:3D,3375928,2150732765,1255216,1881578782,2120712,269153983,283,707191,861128263,706519,861047322,672,80941,697008,1815,1255309,136521,283,961,144444.0,43333.0,-67.0,-73.0,-64.0,-70.0,-66.0,-73.0,-64.0,-70.0,-77.0,-84.0,-76.0,-81.0,10.0,11.0,12.0,11.0,1
672,CC:2F:71:3F:1F:24,3895745,2608856227,1775033,2339702244,2120712,269153983,2533,1459248,1868926220,1458158,1868802930,1090,123290,1442423,5701,1774708,144620,2533,1684,117000.0,39000.0,-68.0,-63.0,-67.0,-70.0,-68.0,-63.0,-67.0,-69.0,-78.0,-84.0,-76.0,-81.0,10.0,21.0,9.0,11.0,1
673,CC:2F:71:3E:C5:1F,5527265,4450910798,3406550,4181756553,2120715,269154245,502,93159,7995601,78581,6267757,14578,1727844,21515,518,3413933,870552,502,2923,6500.0,1000.0,-69.0,-72.0,-66.0,-61.0,-70.0,-71.0,-67.0,-61.0,-78.0,-84.0,-76.0,-81.0,9.0,12.0,10.0,20.0,1
674,F8:59:71:5A:E0:3D,3376036,2150883402,1255317,1881728753,2120719,269154649,283,707291,861279082,706619,861198141,672,80941,697108,1815,1255410,136529,283,961,144444.0,43333.0,-68.0,-74.0,-65.0,-71.0,-67.0,-73.0,-63.0,-70.0,-78.0,-84.0,-76.0,-81.0,10.0,10.0,11.0,10.0,1
675,CC:2F:71:3F:1F:24,3897562,2611557380,1776843,2342402731,2120719,269154649,2533,1459802,1869272490,1458712,1869149200,1090,123290,1442963,5701,1776526,144906,2533,1684,115556.0,28889.0,-71.0,-64.0,-71.0,-71.0,-68.0,-64.0,-68.0,-70.0,-78.0,-84.0,-76.0,-81.0,7.0,20.0,5.0,10.0,1
676,CC:2F:71:3E:C5:1F,5527269,4450911202,3406550,4181756553,2120719,269154649,502,93159,7995601,78581,6267757,14578,1727844,21515,518,3413933,870552,502,2923,6500.0,1000.0,-69.0,-72.0,-66.0,-61.0,-70.0,-71.0,-67.0,-61.0,-78.0,-84.0,-76.0,-81.0,9.0,12.0,10.0,20.0,1
677,F8:59:71:5A:E0:3D,3377662,2153261999,1256936,1884106682,2120726,269155317,283,707781,861478068,707109,861397127,672,80941,697598,1815,1257029,136612,283,965,144444.0,43333.0,-68.0,-74.0,-65.0,-72.0,-67.0,-73.0,-64.0,-71.0,-78.0,-84.0,-76.0,-81.0,10.0,10.0,11.0,9.0,1
678,CC:2F:71:3F:1F:24,3897758,2611800026,1777032,2342644709,2120726,269155317,2533,1459991,1869510167,1458900,1869386759,1091,123408,1443140,5701,1776715,144917,2533,1684,115556.0,28889.0,-69.0,-62.0,-69.0,-69.0,-69.0,-63.0,-69.0,-70.0,-78.0,-84.0,-76.0,-81.0,9.0,22.0,7.0,12.0,1
679,CC:2F:71:3E:C5:1F,5527276,4450911870,3406550,4181756553,2120726,269155317,502,93159,7995601,78581,6267757,14578,1727844,21515,518,3413933,870552,502,2923,6500.0,1000.0,-69.0,-72.0,-66.0,-61.0,-70.0,-71.0,-67.0,-61.0,-78.0,-84.0,-76.0,-81.0,9.0,12.0,10.0,20.0,1
680,F8:59:71:5A:E0:3D,3377743,2153376490,1257014,1884220911,2120729,269155579,283,707858,861593479,707186,861512538,672,80941,697675,1815,1257107,136619,283,965,144444.0,43333.0,-67.0,-73.0,-63.0,-70.0,-67.0,-73.0,-64.0,-70.0,-78.0,-84.0,-76.0,-81.0,11.0,11.0,13.0,11.0,1
681,CC:2F:71:3F:1F:24,3897947,2612040250,1777218,2342884671,2120729,269155579,2533,1460173,1869742804,1459082,1869619396,1091,123408,1443312,5701,1776900,144938,2533,1684,104000.0,26000.0,-68.0,-63.0,-68.0,-69.0,-68.0,-63.0,-67.0,-69.0,-78.0,-84.0,-76.0,-81.0,10.0,21.0,8.0,12.0,1
682,CC:2F:71:3E:C5:1F,5527281,4450912334,3406550,4181756553,2120731,269155781,502,93159,7995601,78581,6267757,14578,1727844,21515,518,3413933,870552,502,2923,6500.0,1000.0,-69.0,-72.0,-66.0,-61.0,-70.0,-71.0,-67.0,-61.0,-78.0,-84.0,-76.0,-81.0,9.0,12.0,10.0,20.0,1
683,F8:59:71:5A:E0:3D,3377816,2153484120,1257083,1884328137,2120733,269155983,283,707920,861689071,707248,861608130,672,80941,697737,1815,1257176,136624,283,967,144444.0,43333.0,-66.0,-73.0,-63.0,-70.0,-67.0,-73.0,-64.0,-70.0,-78.0,-84.0,-76.0,-81.0,12.0,11.0,13.0,11.0,1
684,CC:2F:71:3F:1F:24,3898126,2612270498,1777391,2343114313,2120735,269156185,2533,1460344,1869964140,1459253,1869840732,1091,123408,1443475,5701,1777074,144955,2533,1684,115556.0,28889.0,-70.0,-64.0,-70.0,-71.0,-68.0,-63.0,-67.0,-69.0,-78.0,-84.0,-76.0,-81.0,8.0,20.0,6.0,10.0,1
685,CC:2F:71:3E:C5:1F,5527285,4450912738,3406550,4181756553,2120735,269156185,502,93159,7995601,78581,6267757,14578,1727844,21515,518,3413933,870552,502,2923,6500.0,1000.0,-69.0,-72.0,-66.0,-61.0,-70.0,-71.0,-67.0,-61.0,-78.0,-84.0,-76.0,-81.0,9.0,12.0,10.0,20.0,1
686,F8:59:71:5A:E0:3D,3377891,2153585034,1257154,1884428647,2120737,269156387,283,707997,861803220,707325,861722279,672,80941,697814,1815,1257247,136625,283,970,130000.0,39000.0,-67.0,-72.0,-64.0,-70.0,-66.0,-72.0,-63.0,-70.0,-78.0,-84.0,-76.0,-81.0,11.0,12.0,12.0,11.0,1
687,CC:2F:71:3F:1F:24,3898290,2612477918,1777553,2343321531,2120737,269156387,2533,1460498,1870166344,1459407,1870042936,1091,123408,1443627,5701,1777236,144964,2533,1684,115556.0,28889.0,-71.0,-64.0,-71.0,-70.0,-69.0,-63.0,-68.0,-70.0,-78.0,-84.0,-76.0,-81.0,7.0,20.0,5.0,11.0,1
688,CC:2F:71:3E:C5:1F,5527288,4450913000,3406550,4181756553,2120738,269156447,502,93159,7995601,78581,6267757,14578,1727844,21515,518,3413933,870552,502,2923,6500.0,1000.0,-69.0,-72.0,-66.0,-61.0,-70.0,-71.0,-67.0,-61.0,-78.0,-84.0,-76.0,-81.0,9.0,12.0,10.0,20.0,1
689,F8:59:71:5A:E0:3D,3378047,2153786674,1257305,1884629823,2120742,269156851,283,708069,861905933,707397,861824992,672,80941,697885,1815,1257372,136626,283,970,144444.0,43333.0,-67.0,-73.0,-64.0,-70.0,-66.0,-72.0,-63.0,-70.0,-78.0,-84.0,-76.0,-81.0,11.0,11.0,12.0,11.0,1
690,CC:2F:71:3F:1F:24,3898472,2612688779,1777730,2343531928,2120742,269156851,2533,1460659,1870369588,1459568,1870246180,1091,123408,1443788,5701,1777413,144990,2533,1684,104000.0,26000.0,-71.0,-63.0,-73.0,-70.0,-69.0,-63.0,-69.0,-69.0,-78.0,-84.0,-76.0,-81.0,7.0,21.0,3.0,11.0,1
691,CC:2F:71:3E:C5:1F,5527292,4450913404,3406550,4181756553,2120742,269156851,502,93159,7995601,78581,6267757,14578,1727844,21515,518,3413933,870552,502,2923,6500.0,1000.0,-69.0,-72.0,-66.0,-61.0,-70.0,-71.0,-67.0,-61.0,-78.0,-84.0,-76.0,-81.0,9.0,12.0,10.0,20.0,1
692,F8:59:71:5A:E0:3D,3378126,2153895364,1257379,1884737836,2120747,269157528,283,708149,862021369,707477,861940428,672,80941,697965,1815,1257472,136628,283,970,144444.0,43333.0,-67.0,-72.0,-63.0,-69.0,-67.0,-72.0,-63.0,-69.0,-79.0,-85.0,-77.0,-82.0,12.0,13.0,14.0,13.0,1
693,CC:2F:71:3F:1F:24,3899699,2614360426,1778950,2345202696,2120749,269157730,2533,1461062,1870705768,1459971,1870582360,1091,123408,1444189,5701,1778625,145101,2533,1695,86667.0,14444.0,-68.0,-64.0,-68.0,-70.0,-69.0,-64.0,-69.0,-69.0,-79.0,-85.0,-77.0,-82.0,11.0,21.0,9.0,12.0,1
694,CC:2F:71:3E:C5:1F,5527299,4450914283,3406550,4181756553,2120749,269157730,502,93159,7995601,78581,6267757,14578,1727844,21515,518,3413933,870552,502,2923,6500.0,1000.0,-69.0,-72.0,-66.0,-61.0,-70.0,-71.0,-67.0,-61.0,-79.0,-85.0,-77.0,-82.0,10.0,13.0,11.0,21.0,1
695,F8:59:71:5A:E0:3D,3378316,2154147317,1257562,1884989123,2120754,269158194,283,708266,862174396,707594,862093455,672,80941,698082,1815,1257655,136632,283,970,144444.0,43333.0,-65.0,-64.0,-64.0,-68.0,-66.0,-71.0,-63.0,-69.0,-79.0,-85.0,-77.0,-82.0,14.0,21.0,13.0,14.0,1
696,CC:2F:71:3F:1F:24,3902740,2618760932,1781985,2349602676,2120755,269158256,2533,1461615,1871012148,1460524,1870888740,1091,123408,1444742,5701,1781662,145141,2533,1695,86667.0,14444.0,-71.0,-64.0,-73.0,-70.0,-70.0,-64.0,-72.0,-70.0,-79.0,-85.0,-77.0,-82.0,8.0,21.0,4.0,12.0,1
697,CC:2F:71:3E:C5:1F,5527305,4450914809,3406550,4181756553,2120755,269158256,502,93161,7995789,78582,6267827,14579,1727962,21516,518,3413933,870552,502,2923,6500.0,1000.0,-70.0,-71.0,-68.0,-61.0,-70.0,-70.0,-67.0,-61.0,-79.0,-85.0,-77.0,-82.0,9.0,14.0,9.0,21.0,1
698,F8:59:71:5A:E0:3D,3378396,2154261593,1257635,1885102565,2120761,269159028,283,708338,862285276,707666,862204335,672,80941,698154,1815,1257728,136638,283,970,144444.0,43333.0,-67.0,-72.0,-63.0,-70.0,-66.0,-72.0,-63.0,-70.0,-79.0,-85.0,-77.0,-82.0,12.0,13.0,14.0,12.0,1
699,CC:2F:71:3F:1F:24,3902923,2618979823,1782162,2349820795,2120761,269159028,2533,1461772,1871215772,1460681,1871092364,1091,123408,1444899,5701,1781845,145167,2533,1695,86667.0,14444.0,-69.0,-64.0,-67.0,-69.0,-69.0,-63.0,-67.0,-69.0,-79.0,-85.0,-77.0,-82.0,10.0,21.0,10.0,13.0,1
700,CC:2F:71:3E:C5:1F,5527311,4450915581,3406550,4181756553,2120761,269159028,502,93161,7995789,78582,6267827,14579,1727962,21516,518,3413933,870552,502,2923,6500.0,1000.0,-70.0,-71.0,-68.0,-61.0,-70.0,-70.0,-67.0,-61.0,-79.0,-85.0,-77.0,-82.0,9.0,14.0,9.0,21.0,1
701,F8:59:71:5A:E0:3D,3378470,2154362372,1257705,1885202940,2120765,269159432,283,708409,862387344,707737,862306403,672,80941,698224,1815,1257798,136639,283,970,144444.0,43333.0,-66.0,-73.0,-63.0,-70.0,-66.0,-73.0,-63.0,-70.0,-79.0,-85.0,-77.0,-82.0,13.0,12.0,14.0,12.0,1
702,CC:2F:71:3F:1F:24,3903095,2619190501,1782329,2350031009,2120766,269159492,2533,1461926,1871421071,1460835,1871297663,1091,123408,1445053,5701,1782012,145191,2533,1695,86667.0,14444.0,-70.0,-64.0,-72.0,-70.0,-68.0,-63.0,-69.0,-69.0,-79.0,-85.0,-77.0,-82.0,9.0,21.0,5.0,12.0,1
703,CC:2F:71:3E:C5:1F,5527316,4450916045,3406550,4181756553,2120766,269159492,502,93161,7995789,78582,6267827,14579,1727962,21516,518,3413933,870552,502,2923,6500.0,1000.0,-70.0,-71.0,-68.0,-61.0,-70.0,-70.0,-67.0,-61.0,-79.0,-85.0,-77.0,-82.0,9.0,14.0,9.0,21.0,1
704,F8:59:71:5A:E0:3D,3378538,2154460738,1257768,1885300842,2120770,269159896,283,708473,862485904,707801,862404963,672,80941,698288,1815,1257861,136640,283,970,144444.0,43333.0,-68.0,-74.0,-65.0,-71.0,-67.0,-73.0,-64.0,-70.0,-79.0,-85.0,-77.0,-82.0,11.0,11.0,12.0,11.0,1
705,CC:2F:71:3F:1F:24,3903261,2619397718,1782491,2350237822,2120770,269159896,2533,1462070,1871618310,1460979,1871494902,1091,123408,1445197,5701,1782174,145200,2533,1695,86667.0,14444.0,-68.0,-64.0,-67.0,-69.0,-68.0,-63.0,-68.0,-69.0,-79.0,-85.0,-77.0,-82.0,11.0,21.0,10.0,13.0,1
706,CC:2F:71:3E:C5:1F,5527320,4450916449,3406550,4181756553,2120770,269159896,502,93161,7995789,78582,6267827,14579,1727962,21516,518,3413933,870552,502,2923,6500.0,1000.0,-70.0,-71.0,-68.0,-61.0,-70.0,-70.0,-67.0,-61.0,-79.0,-85.0,-77.0,-82.0,9.0,14.0,9.0,21.0,1
707,F8:59:71:5A:E0:3D,3378612,2154561592,1257838,1885401292,2120774,269160300,283,708539,862584274,707867,862503333,672,80941,698354,1815,1257931,136643,283,970,144444.0,43333.0,-68.0,-74.0,-65.0,-71.0,-67.0,-73.0,-64.0,-70.0,-79.0,-85.0,-77.0,-82.0,11.0,11.0,12.0,11.0,1
708,CC:2F:71:3F:1F:24,3903423,2619603654,1782649,2350443354,2120774,269160300,2533,1462213,1871815394,1461122,1871691986,1091,123408,1445340,5701,1782332,145231,2533,1695,86667.0,14444.0,-70.0,-64.0,-71.0,-71.0,-68.0,-63.0,-69.0,-69.0,-79.0,-85.0,-77.0,-82.0,9.0,21.0,6.0,11.0,1
709,CC:2F:71:3E:C5:1F,5527324,4450916853,3406550,4181756553,2120774,269160300,502,93161,7995789,78582,6267827,14579,1727962,21516,518,3413933,870552,502,2923,6500.0,1000.0,-70.0,-71.0,-68.0,-61.0,-70.0,-70.0,-67.0,-61.0,-79.0,-85.0,-77.0,-82.0,9.0,14.0,9.0,21.0,1
710,F8:59:71:5A:E0:3D,3378744,2154727977,1257967,1885567415,2120777,269160562,283,708609,862686818,707937,862605877,672,80941,698423,1815,1258021,136653,283,970,144444.0,43333.0,-66.0,-73.0,-63.0,-69.0,-66.0,-73.0,-64.0,-70.0,-78.0,-85.0,-77.0,-82.0,12.0,12.0,14.0,13.0,1
711,CC:2F:71:3F:1F:24,3903589,2619817442,1782812,2350656880,2120777,269160562,2533,1462363,1872020438,1461272,1871897030,1091,123408,1445490,5701,1782494,145244,2533,1695,86667.0,14444.0,-67.0,-64.0,-67.0,-69.0,-69.0,-63.0,-70.0,-69.0,-78.0,-85.0,-77.0,-82.0,11.0,21.0,10.0,13.0,1
712,CC:2F:71:3E:C5:1F,5527329,4450917317,3406550,4181756553,2120779,269160764,502,93161,7995789,78582,6267827,14579,1727962,21516,518,3413933,870552,502,2923,6500.0,1000.0,-70.0,-71.0,-68.0,-61.0,-70.0,-70.0,-67.0,-61.0,-78.0,-85.0,-77.0,-82.0,8.0,14.0,9.0,21.0,1
713,F8:59:71:5A:E0:3D,3379004,2155108695,1258223,1885947729,2120781,269160966,283,708702,862791604,708030,862710663,672,80941,698515,1815,1258316,136676,283,970,144444.0,43333.0,-68.0,-74.0,-65.0,-71.0,-67.0,-73.0,-64.0,-70.0,-78.0,-85.0,-77.0,-82.0,10.0,11.0,12.0,11.0,1
714,CC:2F:71:3F:1F:24,3903753,2620025450,1782972,2350864484,2120781,269160966,2533,1462510,1872219410,1461419,1872096002,1091,123408,1445637,5701,1782654,145260,2533,1695,78000.0,13000.0,-68.0,-64.0,-68.0,-70.0,-68.0,-63.0,-68.0,-69.0,-78.0,-85.0,-77.0,-82.0,10.0,21.0,9.0,12.0,1
715,CC:2F:71:3E:C5:1F,5527331,4450917519,3406550,4181756553,2120781,269160966,502,93161,7995789,78582,6267827,14579,1727962,21516,518,3413933,870552,502,2923,6500.0,1000.0,-70.0,-71.0,-68.0,-61.0,-70.0,-70.0,-67.0,-61.0,-78.0,-85.0,-77.0,-82.0,8.0,14.0,9.0,21.0,1
716,F8:59:71:5A:E0:3D,3379089,2155213125,1258306,1886051957,2120783,269161168,283,708783,862896264,708111,862815323,672,80941,698596,1815,1258399,136677,283,970,144444.0,43333.0,-66.0,-73.0,-64.0,-70.0,-67.0,-73.0,-64.0,-70.0,-78.0,-85.0,-77.0,-82.0,12.0,12.0,13.0,12.0,1
717,CC:2F:71:3F:1F:24,3903916,2620231408,1783131,2351070038,2120785,269161370,2533,1462656,1872416898,1461565,1872293490,1091,123408,1445783,5701,1782814,145267,2533,1695,65000.0,14444.0,-68.0,-63.0,-68.0,-69.0,-69.0,-63.0,-69.0,-69.0,-78.0,-85.0,-77.0,-82.0,10.0,22.0,9.0,13.0,1
718,CC:2F:71:3E:C5:1F,5527335,4450917923,3406550,4181756553,2120785,269161370,502,93161,7995789,78582,6267827,14579,1727962,21516,518,3413933,870552,502,2923,6500.0,1000.0,-70.0,-71.0,-68.0,-61.0,-70.0,-70.0,-67.0,-61.0,-78.0,-85.0,-77.0,-82.0,8.0,14.0,9.0,21.0,1
719,F8:59:71:5A:E0:3D,3379316,2155554489,1258526,1886392655,2120790,269161834,283,708869,862999325,708197,862918384,672,80941,698682,1815,1258619,136700,283,970,144444.0,43333.0,-68.0,-74.0,-65.0,-71.0,-67.0,-73.0,-63.0,-70.0,-79.0,-86.0,-78.0,-83.0,11.0,12.0,13.0,12.0,1
720,CC:2F:71:3F:1F:24,3904077,2620435888,1783287,2351274054,2120790,269161834,2533,1462801,1872612790,1461710,1872489382,1091,123408,1445928,5701,1782970,145275,2533,1695,86667.0,14444.0,-70.0,-64.0,-72.0,-71.0,-69.0,-63.0,-70.0,-70.0,-79.0,-86.0,-78.0,-83.0,9.0,22.0,6.0,12.0,1
721,CC:2F:71:3E:C5:1F,5527340,4450918387,3406550,4181756553,2120790,269161834,502,93161,7995789,78582,6267827,14579,1727962,21516,518,3413933,870552,502,2923,6500.0,1000.0,-70.0,-71.0,-68.0,-61.0,-70.0,-70.0,-67.0,-61.0,-79.0,-86.0,-78.0,-83.0,9.0,15.0,10.0,22.0,1
722,F8:59:71:5A:E0:3D,3379381,2155652593,1258589,1886490557,2120792,269162036,283,708932,863096345,708260,863015404,672,80941,698745,1815,1258682,136701,283,970,144444.0,43333.0,-68.0,-74.0,-65.0,-71.0,-67.0,-73.0,-64.0,-70.0,-80.0,-86.0,-79.0,-84.0,12.0,12.0,14.0,13.0,1
723,CC:2F:71:3F:1F:24,3904238,2620643176,1783446,2351481140,2120792,269162036,2533,1462943,1872808376,1461852,1872684968,1091,123408,1446070,5701,1783129,145300,2533,1695,86667.0,13000.0,-70.0,-64.0,-71.0,-70.0,-69.0,-64.0,-70.0,-70.0,-80.0,-86.0,-79.0,-84.0,10.0,22.0,8.0,14.0,1
724,CC:2F:71:3E:C5:1F,5527342,4450918589,3406550,4181756553,2120792,269162036,502,93161,7995789,78582,6267827,14579,1727962,21516,518,3413933,870552,502,2923,6500.0,1000.0,-70.0,-71.0,-68.0,-61.0,-70.0,-70.0,-67.0,-61.0,-80.0,-86.0,-79.0,-84.0,10.0,15.0,11.0,23.0,1
725,F8:59:71:5A:E0:3D,3379449,2155751029,1258653,1886588589,2120796,269162440,283,708996,863193481,708324,863112540,672,80941,698809,1815,1258746,136701,283,970,144444.0,43333.0,-68.0,-74.0,-64.0,-71.0,-67.0,-73.0,-64.0,-70.0,-80.0,-86.0,-79.0,-84.0,12.0,12.0,15.0,13.0,1
726,CC:2F:71:3F:1F:24,3904406,2620855698,1783608,2351693056,2120798,269162642,2533,1463093,1873014816,1462002,1872891408,1091,123408,1446220,5701,1783291,145310,2533,1695,86667.0,14444.0,-68.0,-64.0,-68.0,-69.0,-68.0,-63.0,-69.0,-70.0,-80.0,-86.0,-79.0,-84.0,12.0,22.0,11.0,15.0,1
727,CC:2F:71:3E:C5:1F,5527348,4450919195,3406550,4181756553,2120798,269162642,502,93161,7995789,78582,6267827,14579,1727962,21516,518,3413933,870552,502,2923,6500.0,1000.0,-70.0,-71.0,-68.0,-61.0,-70.0,-70.0,-67.0,-61.0,-80.0,-86.0,-79.0,-84.0,10.0,15.0,11.0,23.0,1
728,F8:59:71:5A:E0:3D,3379520,2155854057,1258719,1886691153,2120801,269162904,283,709063,863296675,708391,863215734,672,80941,698875,1815,1258812,136701,283,970,144444.0,43333.0,-67.0,-73.0,-64.0,-70.0,-67.0,-73.0,-64.0,-70.0,-80.0,-86.0,-79.0,-84.0,13.0,13.0,15.0,14.0,1
729,CC:2F:71:3F:1F:24,3904567,2621061716,1783766,2351898812,2120801,269162904,2533,1463236,1873211900,1462145,1873088492,1091,123408,1446363,5701,1783449,145326,2533,1695,86667.0,14444.0,-69.0,-64.0,-68.0,-69.0,-69.0,-63.0,-70.0,-70.0,-80.0,-86.0,-79.0,-84.0,11.0,22.0,11.0,15.0,1
730,CC:2F:71:3E:C5:1F,5527351,4450919457,3406550,4181756553,2120801,269162904,502,93161,7995789,78582,6267827,14579,1727962,21516,518,3413933,870552,502,2923,6500.0,1000.0,-70.0,-71.0,-68.0,-61.0,-70.0,-70.0,-67.0,-61.0,-80.0,-86.0,-79.0,-84.0,10.0,15.0,11.0,23.0,1
731,F8:59:71:5A:E0:3D,3379599,2155954349,1258794,1886791041,2120805,269163308,283,709130,863391989,708458,863311048,672,80941,698942,1815,1258887,136702,283,970,144444.0,43333.0,-68.0,-74.0,-65.0,-71.0,-67.0,-73.0,-64.0,-70.0,-80.0,-86.0,-79.0,-84.0,12.0,12.0,14.0,13.0,1
732,CC:2F:71:3F:1F:24,3904730,2621270406,1783925,2352107098,2120805,269163308,2533,1463380,1873410720,1462289,1873287312,1091,123408,1446507,5701,1783607,145352,2533,1695,78000.0,13000.0,-70.0,-63.0,-71.0,-71.0,-68.0,-63.0,-69.0,-70.0,-80.0,-86.0,-79.0,-84.0,10.0,23.0,8.0,13.0,1
733,CC:2F:71:3E:C5:1F,5527355,4450919861,3406550,4181756553,2120805,269163308,502,93161,7995789,78582,6267827,14579,1727962,21516,518,3413933,870552,502,2923,6500.0,1000.0,-70.0,-71.0,-68.0,-61.0,-70.0,-70.0,-67.0,-61.0,-80.0,-86.0,-79.0,-84.0,10.0,15.0,11.0,23.0,1
734,F8:59:71:5A:E0:3D,3379776,2156180005,1258966,1887016020,2120810,269163985,283,709212,863498439,708540,863417498,672,80941,699024,1815,1259059,136716,283,970,144444.0,43333.0,-67.0,-73.0,-63.0,-69.0,-66.0,-72.0,-63.0,-69.0,-80.0,-86.0,-79.0,-84.0,13.0,13.0,16.0,15.0,1
735,CC:2F:71:3F:1F:24,3904893,2621475289,1784083,2352311304,2120810,269163985,2533,1463525,1873608068,1462434,1873484660,1091,123408,1446651,5701,1783765,145364,2533,1695,86667.0,14444.0,-67.0,-64.0,-67.0,-70.0,-68.0,-63.0,-68.0,-69.0,-80.0,-86.0,-79.0,-84.0,13.0,22.0,12.0,14.0,1
736,CC:2F:71:3E:C5:1F,5527360,4450920538,3406550,4181756553,2120810,269163985,502,93161,7995789,78582,6267827,14579,1727962,21516,518,3413933,870552,502,2923,6500.0,1000.0,-70.0,-71.0,-68.0,-61.0,-70.0,-70.0,-67.0,-61.0,-80.0,-86.0,-79.0,-84.0,10.0,15.0,11.0,23.0,1
737,F8:59:71:5A:E0:3D,3379925,2156364269,1259111,1887199888,2120814,269164381,283,709307,863617523,708635,863536582,672,80941,699118,1815,1259204,136719,283,970,144444.0,43333.0,-66.0,-73.0,-64.0,-70.0,-66.0,-73.0,-64.0,-70.0,-80.0,-86.0,-79.0,-84.0,14.0,13.0,15.0,14.0,1
738,CC:2F:71:3F:1F:24,3905058,2621686103,1784244,2352521722,2120814,269164381,2533,1463676,1873812056,1462585,1873688648,1091,123408,1446802,5701,1783927,145378,2533,1695,86667.0,14444.0,-68.0,-63.0,-68.0,-69.0,-68.0,-63.0,-69.0,-69.0,-80.0,-86.0,-79.0,-84.0,12.0,23.0,11.0,15.0,1
739,CC:2F:71:3E:C5:1F,5527365,4450921002,3406550,4181756553,2120815,269164449,502,93161,7995789,78582,6267827,14579,1727962,21516,518,3413933,870552,502,2923,6500.0,1000.0,-70.0,-71.0,-68.0,-61.0,-70.0,-70.0,-67.0,-61.0,-80.0,-86.0,-79.0,-84.0,10.0,15.0,11.0,23.0,1
740,F8:59:71:5A:E0:3D,3380014,2156471575,1259195,1887306722,2120819,269164853,283,709383,863720833,708711,863639892,672,80941,699194,1815,1259288,136727,283,970,144444.0,43333.0,-66.0,-73.0,-63.0,-69.0,-66.0,-73.0,-63.0,-70.0,-80.0,-86.0,-79.0,-84.0,14.0,13.0,16.0,15.0,1
741,CC:2F:71:3F:1F:24,3905243,2621899862,1784424,2352735009,2120819,269164853,2533,1463839,1874019343,1462748,1873895935,1091,123408,1446964,5701,1784107,145454,2533,1695,86667.0,14444.0,-67.0,-63.0,-67.0,-70.0,-68.0,-63.0,-68.0,-69.0,-80.0,-86.0,-79.0,-84.0,13.0,23.0,12.0,14.0,1
742,CC:2F:71:3E:C5:1F,5527370,4450921522,3406551,4181756669,2120819,269164853,502,93161,7995789,78582,6267827,14579,1727962,21516,518,3413934,870552,502,2923,6500.0,1000.0,-70.0,-71.0,-68.0,-61.0,-70.0,-70.0,-67.0,-61.0,-80.0,-86.0,-79.0,-84.0,10.0,15.0,11.0,23.0,1
743,F8:59:71:5A:E0:3D,3380086,2156572040,1259265,1887406985,2120821,269165055,283,709454,863825779,708782,863744838,672,80941,699265,1815,1259358,136744,283,970,144444.0,43333.0,-66.0,-73.0,-63.0,-70.0,-67.0,-72.0,-64.0,-70.0,-80.0,-86.0,-79.0,-84.0,14.0,13.0,16.0,14.0,1
744,CC:2F:71:3F:1F:24,3905406,2622111066,1784585,2352946011,2120821,269165055,2533,1463986,1874222587,1462895,1874099179,1091,123408,1447111,5701,1784268,145533,2533,1695,86667.0,14444.0,-67.0,-63.0,-68.0,-69.0,-68.0,-63.0,-69.0,-69.0,-79.0,-85.0,-77.0,-83.0,12.0,22.0,9.0,14.0,1
745,CC:2F:71:3E:C5:1F,5527372,4450921724,3406551,4181756669,2120821,269165055,502,93161,7995789,78582,6267827,14579,1727962,21516,518,3413934,870552,502,2923,6500.0,1000.0,-70.0,-71.0,-68.0,-61.0,-70.0,-70.0,-67.0,-61.0,-79.0,-85.0,-77.0,-83.0,9.0,14.0,9.0,22.0,1
746,F8:59:71:5A:E0:3D,3380156,2156673514,1259330,1887507995,2120826,269165519,283,709518,863924409,708846,863843468,672,80941,699329,1815,1259422,136755,283,970,144444.0,43333.0,-66.0,-72.0,-64.0,-70.0,-66.0,-73.0,-63.0,-70.0,-79.0,-85.0,-77.0,-83.0,13.0,13.0,13.0,13.0,1
747,CC:2F:71:3F:1F:24,3905579,2622323938,1784753,2353158419,2120826,269165519,2533,1464140,1874428461,1463049,1874305053,1091,123408,1447263,5701,1784434,145622,2533,1696,86667.0,14444.0,-68.0,-63.0,-68.0,-69.0,-68.0,-63.0,-68.0,-69.0,-79.0,-85.0,-77.0,-83.0,11.0,22.0,9.0,14.0,1
748,CC:2F:71:3E:C5:1F,5527379,4450922390,3406551,4181756669,2120828,269165721,502,93161,7995789,78582,6267827,14579,1727962,21516,518,3413934,870552,502,2923,6500.0,1000.0,-70.0,-71.0,-68.0,-61.0,-70.0,-70.0,-67.0,-61.0,-79.0,-85.0,-77.0,-83.0,9.0,14.0,9.0,22.0,1
749,F8:59:71:5A:E0:3D,3380223,2156771820,1259393,1887605897,2120830,269165923,283,709582,864022969,708910,863942028,672,80941,699393,1815,1259486,136773,283,970,144444.0,43333.0,-68.0,-74.0,-65.0,-71.0,-66.0,-72.0,-63.0,-70.0,-79.0,-85.0,-77.0,-83.0,11.0,11.0,12.0,12.0,1
750,CC:2F:71:3F:1F:24,3905744,2622532888,1784914,2353366965,2120830,269165923,2533,1464290,1874630692,1463199,1874507284,1091,123408,1447413,5701,1784597,145719,2533,1696,86667.0,13000.0,-68.0,-63.0,-67.0,-69.0,-67.0,-63.0,-67.0,-69.0,-79.0,-85.0,-77.0,-83.0,11.0,22.0,10.0,14.0,1
751,CC:2F:71:3E:C5:1F,5527381,4450922592,3406551,4181756669,2120830,269165923,502,93161,7995789,78582,6267827,14579,1727962,21516,518,3413934,870552,502,2923,6500.0,1000.0,-70.0,-71.0,-68.0,-61.0,-70.0,-70.0,-67.0,-61.0,-79.0,-85.0,-77.0,-83.0,9.0,14.0,9.0,22.0,1
752,F8:59:71:5A:E0:3D,3380299,2156875651,1259465,1887709324,2120834,269166327,283,709651,864124899,708979,864043958,672,80941,699462,1815,1259557,136791,283,970,130000.0,39000.0,-67.0,-73.0,-63.0,-70.0,-66.0,-73.0,-63.0,-69.0,-79.0,-85.0,-77.0,-83.0,12.0,12.0,14.0,13.0,1
753,CC:2F:71:3F:1F:24,3905906,2622738208,1785072,2353571881,2120834,269166327,2533,1464436,1874830972,1463345,1874707564,1091,123408,1447559,5701,1784755,145811,2533,1696,86667.0,14444.0,-69.0,-63.0,-72.0,-70.0,-68.0,-63.0,-69.0,-69.0,-79.0,-85.0,-77.0,-83.0,10.0,22.0,5.0,13.0,1
754,CC:2F:71:3E:C5:1F,5527386,4450923056,3406551,4181756669,2120835,269166387,502,93161,7995789,78582,6267827,14579,1727962,21516,518,3413934,870552,502,2923,6500.0,1000.0,-70.0,-71.0,-68.0,-61.0,-70.0,-70.0,-67.0,-61.0,-79.0,-85.0,-77.0,-83.0,9.0,14.0,9.0,22.0,1
755,F8:59:71:5A:E0:3D,3380366,2156975257,1259529,1887808668,2120837,269166589,283,709715,864223557,709043,864142616,672,80941,699526,1815,1259622,136808,283,970,144444.0,43333.0,-68.0,-73.0,-65.0,-71.0,-66.0,-72.0,-63.0,-70.0,-79.0,-85.0,-77.0,-83.0,11.0,12.0,12.0,12.0,1
756,CC:2F:71:3F:1F:24,3906074,2622953337,1785237,2353786748,2120837,269166589,2533,1464583,1875034244,1463492,1874910836,1091,123408,1447706,5701,1784920,145934,2533,1696,86667.0,1000.0,-70.0,-63.0,-72.0,-70.0,-68.0,-63.0,-68.0,-69.0,-79.0,-85.0,-77.0,-83.0,9.0,22.0,5.0,13.0,1
757,CC:2F:71:3E:C5:1F,5527390,4450923460,3406551,4181756669,2120839,269166791,502,93161,7995789,78582,6267827,14579,1727962,21516,518,3413934,870552,502,2923,6500.0,1000.0,-70.0,-71.0,-68.0,-61.0,-70.0,-70.0,-67.0,-61.0,-79.0,-85.0,-77.0,-83.0,9.0,14.0,9.0,22.0,1
758,F8:59:71:5A:E0:3D,3380683,2157420410,1259839,1888253153,2120844,269167257,283,709812,864336290,709139,864255231,673,81059,699623,1815,1259932,136904,283,970,144444.0,43333.0,-68.0,-74.0,-65.0,-71.0,-66.0,-73.0,-64.0,-70.0,-79.0,-85.0,-77.0,-83.0,11.0,11.0,12.0,12.0,1
759,CC:2F:71:3F:1F:24,3906269,2623183507,1785425,2354016250,2120844,269167257,2533,1464757,1875256310,1463666,1875132902,1091,123408,1447880,5701,1785107,146056,2533,1696,104000.0,26000.0,-68.0,-63.0,-67.0,-69.0,-67.0,-63.0,-67.0,-69.0,-79.0,-85.0,-77.0,-83.0,11.0,22.0,10.0,14.0,1
760,CC:2F:71:3E:C5:1F,5527395,4450923926,3406551,4181756669,2120844,269167257,502,93161,7995789,78582,6267827,14579,1727962,21516,518,3413934,870552,502,2923,6500.0,1000.0,-70.0,-71.0,-68.0,-61.0,-70.0,-70.0,-67.0,-61.0,-79.0,-85.0,-77.0,-83.0,9.0,14.0,9.0,22.0,1
761,F8:59:71:5A:E0:3D,3380752,2157521588,1259905,1888354069,2120847,269167519,283,709879,864438046,709206,864356987,673,81059,699690,1815,1259997,136922,283,970,144444.0,43333.0,-66.0,-72.0,-63.0,-69.0,-66.0,-72.0,-63.0,-69.0,-79.0,-85.0,-77.0,-83.0,13.0,13.0,14.0,14.0,1
762,CC:2F:71:3F:1F:24,3906456,2623410668,1785607,2354242947,2120849,269167721,2533,1464930,1875484458,1463839,1875361050,1091,123408,1448053,5701,1785292,146216,2533,1697,130000.0,43333.0,-69.0,-64.0,-68.0,-70.0,-67.0,-63.0,-67.0,-69.0,-79.0,-85.0,-77.0,-83.0,10.0,21.0,9.0,13.0,1
763,CC:2F:71:3E:C5:1F,5527401,4450924452,3406551,4181756669,2120850,269167783,502,93161,7995789,78582,6267827,14579,1727962,21516,518,3413934,870552,502,2923,6500.0,1000.0,-70.0,-71.0,-68.0,-61.0,-70.0,-70.0,-67.0,-61.0,-79.0,-85.0,-77.0,-83.0,9.0,14.0,9.0,22.0,1
764,F8:59:71:5A:E0:3D,3381128,2158091481,1260273,1888923232,2120855,269168249,283,709992,864557660,709319,864476601,673,81059,699802,1815,1260366,137048,283,971,144444.0,43333.0,-66.0,-73.0,-63.0,-70.0,-66.0,-72.0,-63.0,-69.0,-79.0,-85.0,-77.0,-83.0,13.0,12.0,14.0,13.0,1
765,CC:2F:71:3F:1F:24,3906631,2623631574,1785776,2354463325,2120855,269168249,2533,1465086,1875691726,1463994,1875568200,1092,123526,1448207,5701,1785461,146363,2533,1698,104000.0,26000.0,-68.0,-63.0,-67.0,-69.0,-67.0,-63.0,-67.0,-69.0,-79.0,-85.0,-77.0,-83.0,11.0,22.0,10.0,14.0,1
766,CC:2F:71:3E:C5:1F,5527406,4450924918,3406551,4181756669,2120855,269168249,502,93162,7995907,78582,6267827,14580,1728080,21517,518,3413934,870552,502,2923,6500.0,1000.0,-70.0,-71.0,-68.0,-61.0,-70.0,-70.0,-67.0,-61.0,-79.0,-85.0,-77.0,-83.0,9.0,14.0,9.0,22.0,1
767,F8:59:71:5A:E0:3D,3381196,2158194135,1260339,1889025684,2120857,269168451,283,710062,864662730,709389,864581671,673,81059,699870,1815,1260432,137064,283,971,144444.0,43333.0,-66.0,-73.0,-64.0,-69.0,-66.0,-72.0,-63.0,-69.0,-79.0,-85.0,-77.0,-83.0,13.0,12.0,13.0,14.0,1
768,CC:2F:71:3F:1F:24,3906866,2623867467,1786009,2354699016,2120857,269168451,2533,1465297,1875927384,1464205,1875803858,1092,123526,1448415,5701,1785697,146550,2533,1698,130000.0,39000.0,-70.0,-63.0,-72.0,-70.0,-68.0,-63.0,-69.0,-69.0,-79.0,-85.0,-77.0,-83.0,9.0,22.0,5.0,13.0,1
769,CC:2F:71:3E:C5:1F,5527410,4450925322,3406551,4181756669,2120859,269168653,502,93162,7995907,78582,6267827,14580,1728080,21517,518,3413934,870552,502,2923,6500.0,1000.0,-70.0,-71.0,-68.0,-61.0,-70.0,-70.0,-67.0,-61.0,-79.0,-85.0,-77.0,-83.0,9.0,14.0,9.0,22.0,1
770,F8:59:71:5A:E0:3D,3381270,2158298807,1260406,1889129690,2120864,269169117,283,710133,864766190,709460,864685131,673,81059,699937,1815,1260499,137082,283,971,144444.0,43333.0,-67.0,-73.0,-63.0,-69.0,-67.0,-73.0,-64.0,-69.0,-80.0,-86.0,-78.0,-83.0,13.0,13.0,15.0,14.0,1
771,CC:2F:71:3F:1F:24,3907048,2624084264,1786184,2354915147,2120864,269169117,2533,1465455,1876137833,1464363,1876014307,1092,123526,1448573,5701,1785874,146737,2533,1698,115556.0,26000.0,-70.0,-63.0,-73.0,-71.0,-68.0,-63.0,-68.0,-69.0,-80.0,-86.0,-78.0,-83.0,10.0,23.0,5.0,12.0,1
772,CC:2F:71:3E:C5:1F,5527415,4450925786,3406551,4181756669,2120864,269169117,502,93162,7995907,78582,6267827,14580,1728080,21517,518,3413934,870552,502,2923,6500.0,1000.0,-70.0,-71.0,-68.0,-61.0,-70.0,-70.0,-67.0,-61.0,-80.0,-86.0,-78.0,-83.0,10.0,15.0,10.0,22.0,1
773,F8:59:71:5A:E0:3D,3381490,2158631189,1260624,1889461870,2120866,269169319,283,710229,864882328,709556,864801269,673,81059,700033,1815,1260716,137143,283,971,144444.0,43333.0,-66.0,-73.0,-64.0,-70.0,-66.0,-72.0,-63.0,-69.0,-80.0,-86.0,-78.0,-83.0,14.0,13.0,14.0,13.0,1
774,CC:2F:71:3F:1F:24,3907250,2624348607,1786381,2355178813,2120869,269169794,2533,1465641,1876397549,1464549,1876274023,1092,123526,1448759,5701,1786071,146962,2533,1699,104000.0,26000.0,-68.0,-63.0,-67.0,-70.0,-67.0,-63.0,-67.0,-69.0,-80.0,-86.0,-78.0,-83.0,12.0,23.0,11.0,13.0,1
775,CC:2F:71:3E:C5:1F,5527420,4450926463,3406551,4181756669,2120869,269169794,502,93162,7995907,78582,6267827,14580,1728080,21517,518,3413934,870552,502,2923,6500.0,1000.0,-70.0,-71.0,-68.0,-61.0,-70.0,-70.0,-67.0,-61.0,-80.0,-86.0,-78.0,-83.0,10.0,15.0,10.0,22.0,1
776,F8:59:71:5A:E0:3D,3381587,2158761805,1260713,1889591547,2120874,269170258,283,710315,865007617,709642,864926558,673,81059,700117,1815,1260806,137167,283,971,144444.0,43333.0,-66.0,-73.0,-63.0,-69.0,-65.0,-72.0,-62.0,-69.0,-80.0,-86.0,-78.0,-83.0,14.0,13.0,15.0,14.0,1
777,CC:2F:71:3F:1F:24,3907428,2624575523,1786554,2355405265,2120874,269170258,2533,1465802,1876616717,1464710,1876493191,1092,123526,1448920,5701,1786245,147140,2533,1699,104000.0,26000.0,-67.0,-63.0,-66.0,-69.0,-67.0,-63.0,-66.0,-69.0,-80.0,-86.0,-78.0,-83.0,13.0,23.0,12.0,14.0,1
778,CC:2F:71:3E:C5:1F,5527427,4450927129,3406551,4181756669,2120876,269170460,502,93162,7995907,78582,6267827,14580,1728080,21517,518,3413934,870552,502,2923,6500.0,1000.0,-70.0,-71.0,-68.0,-61.0,-70.0,-70.0,-67.0,-61.0,-80.0,-86.0,-78.0,-83.0,10.0,15.0,10.0,22.0,1
779,F8:59:71:5A:E0:3D,3381659,2158870787,1260783,1889700327,2120876,269170460,283,710390,865120219,709717,865039160,673,81059,700190,1815,1260876,137181,283,971,144444.0,43333.0,-67.0,-73.0,-63.0,-69.0,-66.0,-72.0,-63.0,-69.0,-80.0,-86.0,-78.0,-83.0,13.0,13.0,15.0,14.0,1
780,CC:2F:71:3F:1F:24,3907602,2624802077,1786726,2355631617,2120876,269170460,2533,1465959,1876832651,1464867,1876709125,1092,123526,1449077,5701,1786421,147328,2533,1699,104000.0,26000.0,-68.0,-63.0,-67.0,-69.0,-67.0,-63.0,-67.0,-69.0,-80.0,-86.0,-78.0,-83.0,12.0,23.0,11.0,14.0,1
781,CC:2F:71:3E:C5:1F,5527429,4450927331,3406551,4181756669,2120878,269170662,502,93162,7995907,78582,6267827,14580,1728080,21517,518,3413934,870552,502,2923,6500.0,1000.0,-70.0,-71.0,-68.0,-61.0,-70.0,-70.0,-67.0,-61.0,-80.0,-86.0,-78.0,-83.0,10.0,15.0,10.0,22.0,1
782,F8:59:71:5A:E0:3D,3381980,2159323978,1261098,1890152912,2120882,269171066,283,710496,865243038,709823,865161979,673,81059,700296,1815,1261141,137285,283,972,144444.0,43333.0,-66.0,-73.0,-63.0,-69.0,-65.0,-72.0,-63.0,-69.0,-80.0,-86.0,-78.0,-83.0,14.0,13.0,15.0,14.0,1
783,CC:2F:71:3F:1F:24,3907804,2625060600,1786920,2355889332,2120884,269171268,2533,1466138,1877082408,1465046,1876958882,1092,123526,1449256,5701,1786616,147589,2533,1699,78000.0,13000.0,-68.0,-63.0,-67.0,-69.0,-67.0,-63.0,-67.0,-69.0,-80.0,-86.0,-78.0,-83.0,12.0,23.0,11.0,14.0,1
784,CC:2F:71:3E:C5:1F,5527435,4450927937,3406551,4181756669,2120884,269171268,502,93162,7995907,78582,6267827,14580,1728080,21517,519,3413935,870553,502,2923,6500.0,1000.0,-70.0,-71.0,-68.0,-61.0,-70.0,-70.0,-67.0,-61.0,-79.0,-86.0,-78.0,-83.0,9.0,15.0,10.0,22.0,1
785,F8:59:71:5A:E0:3D,3382391,2159955710,1261504,1890784180,2120887,269171530,283,710638,865371876,709965,865290817,673,81059,700438,1815,1261596,137462,283,972,144444.0,43333.0,-66.0,-73.0,-63.0,-70.0,-66.0,-72.0,-63.0,-69.0,-79.0,-86.0,-78.0,-83.0,13.0,13.0,15.0,13.0,1
786,CC:2F:71:3F:1F:24,3907980,2625288824,1787093,2356117294,2120887,269171530,2533,1466299,1877304488,1465207,1877180962,1092,123526,1449417,5701,1786787,147797,2533,1699,117000.0,1000.0,-68.0,-63.0,-67.0,-69.0,-67.0,-63.0,-67.0,-69.0,-79.0,-86.0,-78.0,-83.0,11.0,23.0,11.0,14.0,1
787,CC:2F:71:3E:C5:1F,5527440,4450928401,3406551,4181756669,2120889,269171732,502,93162,7995907,78582,6267827,14580,1728080,21517,519,3413935,870553,502,2923,6500.0,1000.0,-70.0,-71.0,-68.0,-61.0,-70.0,-70.0,-67.0,-61.0,-79.0,-86.0,-78.0,-83.0,9.0,15.0,10.0,22.0,1
788,F8:59:71:5A:E0:3D,3382569,2160223884,1261676,1891051748,2120893,269172136,283,710736,865493438,710063,865412379,673,81059,700536,1815,1261767,137481,283,973,144444.0,43333.0,-66.0,-73.0,-63.0,-70.0,-66.0,-72.0,-63.0,-69.0,-79.0,-86.0,-78.0,-83.0,13.0,13.0,15.0,13.0,1
789,CC:2F:71:3F:1F:24,3908213,2625573766,1787320,2356401630,2120893,269172136,2533,1466502,1877548623,1465410,1877425097,1092,123526,1449620,5702,1787018,148107,2533,1699,86667.0,1000.0,-67.0,-63.0,-66.0,-69.0,-67.0,-63.0,-66.0,-69.0,-79.0,-86.0,-78.0,-83.0,12.0,23.0,12.0,14.0,1
790,CC:2F:71:3E:C5:1F,5527444,4450928805,3406551,4181756669,2120893,269172136,502,93162,7995907,78582,6267827,14580,1728080,21517,519,3413935,870553,502,2923,6500.0,1000.0,-70.0,-71.0,-68.0,-61.0,-70.0,-70.0,-67.0,-61.0,-79.0,-86.0,-78.0,-83.0,9.0,15.0,10.0,22.0,1
791,F8:59:71:5A:E0:3D,3382649,2160339460,1261751,1891166860,2120898,269172600,283,710805,865598264,710132,865517205,673,81059,700605,1815,1261844,137503,283,973,144444.0,43333.0,-65.0,-72.0,-63.0,-69.0,-66.0,-72.0,-63.0,-69.0,-79.0,-86.0,-78.0,-83.0,14.0,14.0,15.0,14.0,1
792,CC:2F:71:3F:1F:24,3908388,2625797860,1787490,2356625260,2120898,269172600,2533,1466673,1877786025,1465581,1877662499,1092,123526,1449791,5702,1787193,148301,2533,1699,78000.0,13000.0,-68.0,-63.0,-67.0,-69.0,-68.0,-63.0,-67.0,-69.0,-79.0,-86.0,-78.0,-83.0,11.0,23.0,11.0,14.0,1
793,CC:2F:71:3E:C5:1F,5527449,4450929269,3406551,4181756669,2120898,269172600,502,93162,7995907,78582,6267827,14580,1728080,21517,519,3413935,870553,502,2923,6500.0,1000.0,-70.0,-71.0,-68.0,-61.0,-70.0,-70.0,-67.0,-61.0,-79.0,-86.0,-78.0,-83.0,9.0,15.0,10.0,22.0,1
794,F8:59:71:5A:E0:3D,3382729,2160456492,1261826,1891283410,2120903,269173082,283,710885,865721730,710212,865640671,673,81059,700685,1815,1261919,137521,283,973,144444.0,43333.0,-66.0,-73.0,-63.0,-70.0,-65.0,-71.0,-63.0,-69.0,-78.0,-85.0,-77.0,-82.0,12.0,12.0,14.0,12.0,1
795,CC:2F:71:3F:1F:24,3908587,2626056998,1787684,2356883916,2120903,269173082,2533,1466848,1878028649,1465756,1877905123,1092,123526,1449965,5702,1787387,148536,2533,1699,86667.0,1000.0,-68.0,-64.0,-66.0,-69.0,-68.0,-63.0,-66.0,-68.0,-78.0,-85.0,-77.0,-82.0,10.0,21.0,11.0,13.0,1
796,CC:2F:71:3E:C5:1F,5527454,4450929751,3406551,4181756669,2120903,269173082,502,93162,7995907,78582,6267827,14580,1728080,21517,519,3413935,870553,502,2923,6500.0,1000.0,-70.0,-71.0,-68.0,-61.0,-70.0,-70.0,-67.0,-61.0,-78.0,-85.0,-77.0,-82.0,8.0,14.0,9.0,21.0,1
797,F8:59:71:5A:E0:3D,3382986,2160844049,1262076,1891670301,2120910,269173748,283,711014,865895813,710341,865814754,673,81059,700814,1815,1262168,137627,283,973,144444.0,43333.0,-67.0,-73.0,-63.0,-69.0,-66.0,-72.0,-63.0,-69.0,-78.0,-85.0,-77.0,-82.0,11.0,12.0,14.0,13.0,1
798,CC:2F:71:3F:1F:24,3908882,2626437229,1787970,2357263279,2120912,269173950,2533,1467121,1878407390,1466029,1878283864,1092,123526,1450237,5702,1787679,148910,2533,1699,52000.0,6500.0,-68.0,-63.0,-67.0,-69.0,-68.0,-63.0,-66.0,-69.0,-78.0,-85.0,-77.0,-82.0,10.0,22.0,10.0,13.0,1
799,CC:2F:71:3E:C5:1F,5527463,4450930619,3406551,4181756669,2120912,269173950,502,93162,7995907,78582,6267827,14580,1728080,21517,519,3413935,870553,502,2923,6500.0,1000.0,-70.0,-71.0,-68.0,-61.0,-70.0,-70.0,-67.0,-61.0,-78.0,-85.0,-77.0,-82.0,8.0,14.0,9.0,21.0,1
800,F8:59:71:5A:E0:3D,3383071,2160964951,1262159,1891791001,2120912,269173950,283,711108,866027090,710435,865946031,673,81059,700908,1815,1262252,137645,283,973,144444.0,43333.0,-67.0,-73.0,-63.0,-69.0,-66.0,-72.0,-63.0,-69.0,-78.0,-85.0,-77.0,-82.0,11.0,12.0,14.0,13.0,1
801,CC:2F:71:3F:1F:24,3909065,2626677529,1788151,2357503377,2120914,269174152,2533,1467280,1878626266,1466188,1878502740,1092,123526,1450396,5702,1787860,149067,2533,1699,57778.0,6500.0,-67.0,-63.0,-67.0,-70.0,-67.0,-63.0,-67.0,-69.0,-78.0,-85.0,-77.0,-82.0,11.0,22.0,10.0,12.0,1
802,CC:2F:71:3E:C5:1F,5527467,4450931023,3406551,4181756669,2120916,269174354,502,93162,7995907,78582,6267827,14580,1728080,21517,519,3413935,870553,502,2923,6500.0,1000.0,-70.0,-71.0,-68.0,-61.0,-70.0,-70.0,-67.0,-61.0,-78.0,-85.0,-77.0,-82.0,8.0,14.0,9.0,21.0,1
803,F8:59:71:5A:E0:3D,3383252,2161201154,1262332,1892026396,2120920,269174758,283,711208,866147375,710535,866066316,673,81059,701008,1815,1262425,137671,283,973,144444.0,43333.0,-66.0,-72.0,-64.0,-70.0,-66.0,-72.0,-63.0,-69.0,-78.0,-85.0,-77.0,-82.0,12.0,13.0,13.0,12.0,1
804,CC:2F:71:3F:1F:24,3909273,2626924410,1788353,2357749652,2120920,269174758,2533,1467460,1878867294,1466368,1878743768,1092,123526,1450576,5702,1788065,149269,2533,1699,52000.0,6500.0,-67.0,-63.0,-67.0,-69.0,-67.0,-63.0,-67.0,-69.0,-78.0,-85.0,-77.0,-82.0,11.0,22.0,10.0,13.0,1
805,CC:2F:71:3E:C5:1F,5527472,4450931487,3406551,4181756669,2120921,269174818,502,93162,7995907,78582,6267827,14580,1728080,21517,519,3413935,870553,502,2923,6500.0,1000.0,-70.0,-71.0,-68.0,-61.0,-70.0,-70.0,-67.0,-61.0,-78.0,-85.0,-77.0,-82.0,8.0,14.0,9.0,21.0,1
806,F8:59:71:5A:E0:3D,3383328,2161314746,1262405,1892139726,2120923,269175020,283,711282,866261335,710609,866180276,673,81059,701082,1815,1262498,137695,283,973,144444.0,43333.0,-66.0,-72.0,-63.0,-70.0,-65.0,-71.0,-63.0,-69.0,-78.0,-85.0,-77.0,-82.0,12.0,13.0,14.0,12.0,1
807,CC:2F:71:3F:1F:24,3909456,2627160422,1788531,2357985200,2120925,269175222,2533,1467629,1879102994,1466537,1878979468,1092,123526,1450745,5702,1788242,149445,2533,1699,78000.0,13000.0,-67.0,-63.0,-67.0,-70.0,-67.0,-63.0,-67.0,-69.0,-78.0,-85.0,-77.0,-82.0,11.0,22.0,10.0,12.0,1
808,CC:2F:71:3E:C5:1F,5527478,4450932093,3406551,4181756669,2120927,269175424,502,93162,7995907,78582,6267827,14580,1728080,21517,519,3413935,870553,502,2923,6500.0,1000.0,-70.0,-71.0,-68.0,-61.0,-70.0,-70.0,-67.0,-61.0,-77.0,-84.0,-76.0,-81.0,7.0,13.0,8.0,20.0,1
809,F8:59:71:5A:E0:3D,3383450,2161490608,1262520,1892314709,2120930,269175899,283,711375,866397960,710702,866316901,673,81059,701175,1815,1262612,137744,283,973,144444.0,43333.0,-67.0,-72.0,-63.0,-69.0,-66.0,-72.0,-62.0,-69.0,-77.0,-84.0,-76.0,-81.0,10.0,12.0,13.0,12.0,1
810,CC:2F:71:3F:1F:24,3909664,2627434369,1788734,2358258470,2120930,269175899,2533,1467818,1879366784,1466726,1879243258,1092,123526,1450934,5702,1788446,149677,2533,1699,52000.0,6500.0,-67.0,-63.0,-66.0,-68.0,-67.0,-62.0,-67.0,-68.0,-77.0,-84.0,-76.0,-81.0,10.0,21.0,10.0,13.0,1
811,CC:2F:71:3E:C5:1F,5527481,4450932568,3406551,4181756669,2120930,269175899,502,93162,7995907,78582,6267827,14580,1728080,21517,519,3413935,870553,502,2923,6500.0,1000.0,-70.0,-71.0,-68.0,-61.0,-70.0,-70.0,-67.0,-61.0,-77.0,-84.0,-75.0,-81.0,7.0,13.0,7.0,20.0,1
812,F8:59:71:5A:E0:3D,3384062,2162431468,1263125,1893254903,2120937,269176565,283,711539,866527713,710866,866446654,673,81059,701339,1815,1263217,137934,283,973,144444.0,43333.0,-66.0,-72.0,-64.0,-69.0,-66.0,-72.0,-63.0,-69.0,-77.0,-84.0,-75.0,-81.0,11.0,12.0,11.0,12.0,1
813,CC:2F:71:3F:1F:24,3909846,2627667857,1788909,2358491292,2120937,269176565,2533,1467980,1879591774,1466888,1879468248,1092,123526,1451096,5702,1788620,149813,2533,1699,26000.0,5500.0,-67.0,-63.0,-67.0,-70.0,-67.0,-63.0,-67.0,-69.0,-77.0,-84.0,-75.0,-81.0,10.0,21.0,8.0,11.0,1
814,CC:2F:71:3E:C5:1F,5527488,4450933234,3406551,4181756669,2120937,269176565,502,93162,7995907,78582,6267827,14580,1728080,21517,519,3413935,870553,502,2923,6500.0,1000.0,-70.0,-71.0,-68.0,-61.0,-70.0,-70.0,-67.0,-61.0,-77.0,-84.0,-75.0,-81.0,7.0,13.0,7.0,20.0,1
815,F8:59:71:5A:E0:3D,3384133,2162534606,1263192,1893357471,2120941,269177135,283,711603,866626343,710930,866545284,673,81059,701403,1815,1263285,137947,283,974,144444.0,43333.0,-68.0,-72.0,-65.0,-71.0,-67.0,-72.0,-64.0,-70.0,-77.0,-84.0,-75.0,-81.0,9.0,12.0,10.0,10.0,1
816,CC:2F:71:3F:1F:24,3910020,2627887809,1789079,2358710674,2120941,269177135,2533,1468138,1879809276,1467046,1879685750,1092,123526,1451254,5702,1788792,149947,2533,1699,78000.0,13000.0,-69.0,-63.0,-68.0,-69.0,-68.0,-63.0,-69.0,-69.0,-77.0,-84.0,-75.0,-81.0,8.0,21.0,7.0,12.0,1
817,CC:2F:71:3E:C5:1F,5527493,4450933920,3406552,4181756785,2120941,269177135,502,93162,7995907,78582,6267827,14580,1728080,21517,519,3413936,870555,502,2923,6500.0,1000.0,-70.0,-71.0,-68.0,-61.0,-70.0,-70.0,-67.0,-61.0,-77.0,-84.0,-75.0,-81.0,7.0,13.0,7.0,20.0,1
818,F8:59:71:5A:E0:3D,3384212,2162644449,1263265,1893466708,2120947,269177741,283,711680,866741232,711007,866660173,673,81059,701480,1815,1263358,137971,283,974,144444.0,43333.0,-66.0,-72.0,-63.0,-70.0,-66.0,-72.0,-63.0,-70.0,-77.0,-84.0,-75.0,-81.0,11.0,12.0,12.0,11.0,1
819,CC:2F:71:3F:1F:24,3910217,2628137941,1789268,2358960078,2120949,269177863,2533,1468311,1880042974,1467218,1879919330,1093,123644,1451427,5702,1788980,150213,2533,1699,86667.0,13000.0,-68.0,-63.0,-67.0,-68.0,-67.0,-63.0,-67.0,-68.0,-77.0,-84.0,-75.0,-81.0,9.0,21.0,8.0,13.0,1
820,CC:2F:71:3E:C5:1F,5527501,4450934648,3406552,4181756785,2120949,269177863,502,93162,7995907,78582,6267827,14580,1728080,21517,519,3413936,870555,502,2923,6500.0,1000.0,-70.0,-71.0,-68.0,-61.0,-70.0,-70.0,-67.0,-61.0,-77.0,-84.0,-75.0,-81.0,7.0,13.0,7.0,20.0,1
821,F8:59:71:5A:E0:3D,3384304,2162781525,1263353,1893603460,2120951,269178065,283,711763,866869080,711090,866788021,673,81059,701563,1815,1263446,137990,283,974,144444.0,43333.0,-66.0,-72.0,-63.0,-70.0,-66.0,-72.0,-63.0,-69.0,-77.0,-84.0,-75.0,-80.0,11.0,12.0,12.0,10.0,1
822,CC:2F:71:3F:1F:24,3910430,2628406175,1789479,2359228110,2120951,269178065,2533,1468514,1880308836,1467421,1880185192,1093,123644,1451630,5702,1789194,150621,2533,1699,28889.0,1000.0,-68.0,-63.0,-68.0,-70.0,-67.0,-63.0,-67.0,-68.0,-77.0,-84.0,-75.0,-80.0,9.0,21.0,7.0,10.0,1
823,CC:2F:71:3E:C5:1F,5527503,4450934850,3406552,4181756785,2120951,269178065,502,93162,7995907,78582,6267827,14580,1728080,21517,519,3413936,870555,502,2923,6500.0,1000.0,-70.0,-71.0,-68.0,-61.0,-70.0,-70.0,-67.0,-61.0,-77.0,-84.0,-75.0,-80.0,7.0,13.0,7.0,19.0,1
824,F8:59:71:5A:E0:3D,3384535,2163131437,1263578,1893952766,2120957,269178671,283,711867,867000441,711194,866919382,673,81059,701667,1815,1263670,138037,283,975,144444.0,43333.0,-66.0,-72.0,-64.0,-70.0,-66.0,-72.0,-63.0,-69.0,-77.0,-84.0,-75.0,-80.0,11.0,12.0,11.0,10.0,1
825,CC:2F:71:3F:1F:24,3910627,2628662683,1789670,2359484012,2120957,269178671,2533,1468687,1880549356,1467594,1880425712,1093,123644,1451803,5702,1789381,150811,2533,1699,52000.0,1000.0,-68.0,-63.0,-68.0,-68.0,-67.0,-63.0,-67.0,-69.0,-77.0,-84.0,-75.0,-80.0,9.0,21.0,7.0,12.0,1
826,CC:2F:71:3E:C5:1F,5527510,4450935516,3406552,4181756785,2120958,269178731,502,93162,7995907,78582,6267827,14580,1728080,21517,519,3413936,870555,502,2923,6500.0,1000.0,-70.0,-71.0,-68.0,-61.0,-70.0,-70.0,-67.0,-61.0,-77.0,-84.0,-75.0,-80.0,7.0,13.0,7.0,19.0,1
827,F8:59:71:5A:E0:3D,3384822,2163525197,1263862,1894346264,2120960,269178933,283,711988,867130464,711315,867049405,673,81059,701788,1815,1263955,138100,283,975,144444.0,43333.0,-67.0,-72.0,-64.0,-70.0,-66.0,-72.0,-63.0,-69.0,-77.0,-84.0,-75.0,-80.0,10.0,12.0,11.0,10.0,1
828,CC:2F:71:3F:1F:24,3910809,2628897365,1789847,2359718230,2120962,269179135,2533,1468849,1880777124,1467756,1880653480,1093,123644,1451965,5702,1789565,150993,2533,1699,78000.0,13000.0,-67.0,-64.0,-67.0,-69.0,-67.0,-63.0,-67.0,-68.0,-77.0,-84.0,-75.0,-80.0,10.0,20.0,8.0,11.0,1
829,CC:2F:71:3E:C5:1F,5527514,4450935920,3406552,4181756785,2120962,269179135,502,93162,7995907,78582,6267827,14580,1728080,21517,519,3413936,870555,502,2923,6500.0,1000.0,-70.0,-71.0,-68.0,-61.0,-70.0,-70.0,-67.0,-61.0,-77.0,-84.0,-75.0,-80.0,7.0,13.0,7.0,19.0,1
830,F8:59:71:5A:E0:3D,3384893,2163626813,1263927,1894447274,2120966,269179539,283,712053,867230564,711380,867149505,673,81059,701853,1815,1264020,138121,283,975,144444.0,43333.0,-67.0,-73.0,-63.0,-69.0,-66.0,-72.0,-63.0,-69.0,-76.0,-83.0,-74.0,-79.0,9.0,10.0,11.0,10.0,1
831,CC:2F:71:3F:1F:24,3910976,2629108639,1790010,2359929100,2120966,269179539,2533,1468998,1880980600,1467905,1880856956,1093,123644,1452114,5702,1789728,151143,2533,1699,78000.0,13000.0,-70.0,-63.0,-71.0,-70.0,-67.0,-63.0,-67.0,-69.0,-76.0,-83.0,-74.0,-79.0,6.0,20.0,3.0,9.0,1
832,CC:2F:71:3E:C5:1F,5527518,4450936324,3406552,4181756785,2120966,269179539,502,93162,7995907,78582,6267827,14580,1728080,21517,519,3413936,870555,502,2923,6500.0,1000.0,-70.0,-71.0,-68.0,-61.0,-70.0,-70.0,-67.0,-61.0,-76.0,-83.0,-74.0,-79.0,6.0,12.0,6.0,18.0,1
833,F8:59:71:5A:E0:3D,3384995,2163769496,1264024,1894589493,2120971,269180003,283,712148,867369750,711475,867288691,673,81059,701948,1815,1264117,138170,283,975,144444.0,43333.0,-68.0,-73.0,-65.0,-71.0,-67.0,-72.0,-64.0,-70.0,-75.0,-83.0,-73.0,-78.0,7.0,10.0,8.0,7.0,1
834,CC:2F:71:3F:1F:24,3911196,2629401021,1790225,2360221018,2120971,269180003,2533,1469200,1881264774,1468107,1881141130,1093,123644,1452316,5702,1789945,151293,2533,1699,86667.0,14444.0,-68.0,-63.0,-67.0,-69.0,-68.0,-62.0,-69.0,-69.0,-75.0,-83.0,-73.0,-78.0,7.0,20.0,6.0,9.0,1
835,CC:2F:71:3E:C5:1F,5527523,4450936788,3406552,4181756785,2120971,269180003,502,93162,7995907,78582,6267827,14580,1728080,21517,519,3413936,870555,502,2923,6500.0,1000.0,-70.0,-71.0,-68.0,-61.0,-70.0,-70.0,-67.0,-61.0,-75.0,-83.0,-73.0,-78.0,5.0,12.0,5.0,17.0,1
836,F8:59:71:5A:E0:3D,3385307,2164248082,1264331,1895067549,2120976,269180533,283,712251,867499458,711578,867418399,673,81059,702049,1815,1264350,138232,283,979,144444.0,43333.0,-67.0,-72.0,-63.0,-69.0,-67.0,-72.0,-64.0,-70.0,-75.0,-83.0,-73.0,-78.0,8.0,11.0,10.0,9.0,1
837,CC:2F:71:3F:1F:24,3911389,2629651997,1790411,2360471262,2120978,269180735,2533,1469379,1881517620,1468286,1881393976,1093,123644,1452495,5702,1790131,151374,2533,1699,117000.0,39000.0,-68.0,-63.0,-68.0,-69.0,-67.0,-62.0,-67.0,-69.0,-75.0,-83.0,-73.0,-78.0,7.0,20.0,5.0,9.0,1
838,CC:2F:71:3E:C5:1F,5527530,4450937520,3406552,4181756785,2120978,269180735,502,93162,7995907,78582,6267827,14580,1728080,21517,519,3413936,870555,502,2923,6500.0,1000.0,-70.0,-71.0,-68.0,-61.0,-70.0,-70.0,-67.0,-61.0,-75.0,-83.0,-73.0,-78.0,5.0,12.0,5.0,17.0,1
839,F8:59:71:5A:E0:3D,3385584,2164662392,1264599,1895480991,2120985,269181401,283,712384,867641618,711711,867560559,673,81059,702182,1815,1264691,138330,283,980,144444.0,43333.0,-66.0,-72.0,-64.0,-69.0,-67.0,-73.0,-64.0,-70.0,-75.0,-82.0,-73.0,-78.0,9.0,10.0,9.0,9.0,1
840,CC:2F:71:3F:1F:24,3911604,2629936367,1790619,2360754966,2120985,269181401,2533,1469567,1881783014,1468474,1881659370,1093,123644,1452683,5702,1790338,151501,2533,1699,78000.0,13000.0,-68.0,-63.0,-66.0,-68.0,-69.0,-62.0,-67.0,-68.0,-75.0,-82.0,-73.0,-78.0,7.0,19.0,7.0,10.0,1
841,CC:2F:71:3E:C5:1F,5527537,4450938186,3406552,4181756785,2120985,269181401,502,93162,7995907,78582,6267827,14580,1728080,21517,519,3413936,870555,502,2923,6500.0,1000.0,-70.0,-71.0,-68.0,-61.0,-70.0,-70.0,-67.0,-61.0,-75.0,-82.0,-73.0,-78.0,5.0,11.0,5.0,17.0,1
842,F8:59:71:5A:E0:3D,3386022,2165266135,1265017,1896082661,2121005,269183474,283,712739,868127370,712065,868046193,674,81177,702537,1815,1265110,138396,283,981,144444.0,43333.0,-67.0,-72.0,-64.0,-69.0,-66.0,-72.0,-64.0,-69.0,-73.0,-82.0,-72.0,-77.0,6.0,10.0,8.0,8.0,1
843,CC:2F:71:3F:1F:24,3912543,2631255641,1791529,2362071299,2121014,269184342,2533,1470326,1882874535,1469233,1882750891,1093,123644,1453398,5702,1791252,152262,2533,1710,52000.0,13000.0,-67.0,-61.0,-73.0,-70.0,-66.0,-61.0,-70.0,-70.0,-73.0,-82.0,-72.0,-77.0,6.0,21.0,-1.0,7.0,1
844,CC:2F:71:3E:C5:1F,5527575,4450941995,3406552,4181756785,2121023,269185210,502,93163,7996025,78582,6267827,14581,1728198,21518,519,3413936,870555,502,2923,6500.0,1000.0,-70.0,-73.0,-66.0,-61.0,-70.0,-70.0,-67.0,-61.0,-73.0,-82.0,-72.0,-77.0,3.0,9.0,6.0,16.0,1
845,F8:59:71:5A:E0:3D,3387283,2167135817,1266249,1897949537,2121034,269186280,283,713332,868867322,712658,868786145,674,81177,703125,1815,1266342,138643,283,981,144444.0,43333.0,-66.0,-73.0,-62.0,-69.0,-65.0,-72.0,-62.0,-69.0,-72.0,-80.0,-70.0,-76.0,6.0,7.0,8.0,7.0,1
846,CC:2F:71:3F:1F:24,3913317,2632335779,1792283,2363149499,2121034,269186280,2533,1471213,1884167704,1470120,1884044060,1093,123644,1454281,5702,1792007,152876,2533,1714,43333.0,7222.0,-67.0,-64.0,-67.0,-71.0,-67.0,-64.0,-66.0,-69.0,-72.0,-80.0,-70.0,-76.0,5.0,16.0,3.0,5.0,1
847,CC:2F:71:3E:C5:1F,5527588,4450943267,3406552,4181756785,2121036,269186482,502,93163,7996025,78582,6267827,14581,1728198,21518,519,3413936,870555,502,2923,6500.0,1000.0,-70.0,-73.0,-66.0,-61.0,-70.0,-70.0,-67.0,-61.0,-72.0,-80.0,-70.0,-76.0,2.0,7.0,4.0,15.0,1
848,F8:59:71:5A:E0:3D,3387352,2167234325,1266312,1898047439,2121040,269186886,283,713395,868964342,712721,868883165,674,81177,703188,1815,1266405,138651,283,981,144444.0,43333.0,-66.0,-72.0,-63.0,-70.0,-65.0,-72.0,-63.0,-69.0,-72.0,-80.0,-70.0,-76.0,6.0,8.0,7.0,6.0,1
849,CC:2F:71:3F:1F:24,3913494,2632545426,1792454,2363358540,2121040,269186886,2533,1471375,1884371145,1470282,1884247501,1093,123644,1454442,5702,1792178,152901,2533,1714,65000.0,19500.0,-67.0,-64.0,-66.0,-69.0,-66.0,-64.0,-66.0,-69.0,-72.0,-80.0,-70.0,-76.0,5.0,16.0,4.0,7.0,1
850,CC:2F:71:3E:C5:1F,5527592,4450943671,3406552,4181756785,2121040,269186886,502,93163,7996025,78582,6267827,14581,1728198,21518,519,3413936,870555,502,2923,6500.0,1000.0,-70.0,-73.0,-66.0,-61.0,-70.0,-70.0,-67.0,-61.0,-72.0,-80.0,-70.0,-76.0,2.0,7.0,4.0,15.0,1
851,F8:59:71:5A:E0:3D,3387419,2167334043,1266376,1898146895,2121043,269187148,283,713461,869063042,712787,868981865,674,81177,703252,1815,1266469,138655,283,981,144444.0,43333.0,-67.0,-73.0,-62.0,-68.0,-65.0,-72.0,-62.0,-69.0,-72.0,-80.0,-70.0,-76.0,5.0,7.0,8.0,8.0,1
852,CC:2F:71:3F:1F:24,3913656,2632753974,1792613,2363566826,2121043,269187148,2533,1471521,1884571425,1470428,1884447781,1093,123644,1454588,5702,1792336,152931,2533,1714,104000.0,26000.0,-67.0,-64.0,-67.0,-70.0,-67.0,-63.0,-67.0,-69.0,-72.0,-80.0,-70.0,-76.0,5.0,16.0,3.0,6.0,1
853,CC:2F:71:3E:C5:1F,5527595,4450943933,3406552,4181756785,2121043,269187148,502,93163,7996025,78582,6267827,14581,1728198,21518,519,3413936,870555,502,2923,6500.0,1000.0,-70.0,-73.0,-66.0,-61.0,-70.0,-70.0,-67.0,-61.0,-72.0,-80.0,-70.0,-76.0,2.0,7.0,4.0,15.0,1
854,F8:59:71:5A:E0:3D,3387600,2167558339,1266555,1898370989,2121045,269187350,283,713570,869175848,712896,869094671,674,81177,703361,1815,1266648,138677,283,981,144444.0,43333.0,-65.0,-72.0,-63.0,-70.0,-65.0,-72.0,-63.0,-69.0,-72.0,-80.0,-70.0,-76.0,7.0,8.0,7.0,6.0,1
855,CC:2F:71:3F:1F:24,3913825,2632969668,1792778,2363782116,2121047,269187552,2533,1471669,1884777633,1470576,1884653989,1093,123644,1454736,5702,1792503,153058,2533,1714,86667.0,14444.0,-68.0,-64.0,-67.0,-69.0,-67.0,-64.0,-67.0,-69.0,-72.0,-80.0,-70.0,-76.0,4.0,16.0,3.0,7.0,1
856,CC:2F:71:3E:C5:1F,5527600,4450944471,3406552,4181756785,2121048,269187686,502,93163,7996025,78582,6267827,14581,1728198,21518,519,3413936,870555,502,2923,6500.0,1000.0,-70.0,-73.0,-66.0,-61.0,-70.0,-70.0,-67.0,-61.0,-72.0,-80.0,-70.0,-76.0,2.0,7.0,4.0,15.0,1
857,F8:59:71:5A:E0:3D,3387671,2167659484,1266619,1898470333,2121052,269189151,283,713635,869275948,712961,869194771,674,81177,703426,1815,1266712,138691,283,981,144444.0,43333.0,-66.0,-73.0,-63.0,-70.0,-66.0,-72.0,-62.0,-69.0,-72.0,-80.0,-70.0,-76.0,6.0,7.0,7.0,6.0,1
858,CC:2F:71:3F:1F:24,3913990,2633179739,1792938,2363990588,2121052,269189151,2533,1471816,1884978029,1470723,1884854385,1093,123644,1454883,5702,1792663,153108,2533,1714,86667.0,14444.0,-68.0,-64.0,-67.0,-70.0,-67.0,-64.0,-67.0,-70.0,-72.0,-80.0,-70.0,-76.0,4.0,16.0,3.0,6.0,1
859,CC:2F:71:3E:C5:1F,5527604,4450945936,3406552,4181756785,2121052,269189151,502,93163,7996025,78582,6267827,14581,1728198,21518,519,3413936,870555,502,2923,6500.0,1000.0,-70.0,-73.0,-66.0,-61.0,-70.0,-70.0,-67.0,-61.0,-72.0,-80.0,-70.0,-76.0,2.0,7.0,4.0,15.0,1
860,F8:59:71:5A:E0:3D,3387976,2168115313,1266919,1898925698,2121057,269189615,283,713750,869385654,713076,869304477,674,81177,703541,1815,1267012,138746,283,981,144444.0,43333.0,-66.0,-72.0,-63.0,-69.0,-65.0,-72.0,-63.0,-69.0,-72.0,-80.0,-70.0,-76.0,6.0,8.0,7.0,7.0,1
861,CC:2F:71:3F:1F:24,3914156,2633391205,1793099,2364201590,2121057,269189615,2533,1471961,1885179617,1470868,1885055973,1093,123644,1455028,5702,1792824,153184,2533,1714,86667.0,13000.0,-68.0,-64.0,-68.0,-69.0,-67.0,-64.0,-67.0,-69.0,-72.0,-80.0,-70.0,-76.0,4.0,16.0,2.0,7.0,1
862,CC:2F:71:3E:C5:1F,5527609,4450946400,3406552,4181756785,2121057,269189615,502,93163,7996025,78582,6267827,14581,1728198,21518,519,3413936,870555,502,2923,6500.0,1000.0,-70.0,-73.0,-66.0,-61.0,-70.0,-70.0,-67.0,-61.0,-72.0,-80.0,-70.0,-76.0,2.0,7.0,4.0,15.0,1
863,F8:59:71:5A:E0:3D,3388075,2168236473,1266990,1899034482,2121085,269201991,283,713826,869496998,713152,869415821,674,81177,703617,1815,1267083,138757,283,981,144444.0,43333.0,-66.0,-72.0,-63.0,-70.0,-66.0,-72.0,-63.0,-69.0,-72.0,-80.0,-70.0,-76.0,6.0,8.0,7.0,6.0,1
864,CC:2F:71:3F:1F:24,3914377,2633638813,1793292,2364436822,2121085,269201991,2533,1472148,1885414140,1471055,1885290496,1093,123644,1455215,5702,1793016,153296,2533,1714,86667.0,1000.0,-66.0,-64.0,-67.0,-71.0,-67.0,-63.0,-67.0,-69.0,-72.0,-80.0,-70.0,-76.0,6.0,16.0,3.0,5.0,1
865,CC:2F:71:3E:C5:1F,5527638,4450958892,3406553,4181756901,2121085,269201991,502,93163,7996025,78582,6267827,14581,1728198,21518,519,3413937,870555,502,2923,6500.0,1000.0,-70.0,-73.0,-66.0,-61.0,-70.0,-70.0,-67.0,-61.0,-72.0,-80.0,-70.0,-76.0,2.0,7.0,4.0,15.0,1
866,F8:59:71:5A:E0:3D,3388152,2168341727,1267063,1899139332,2121089,269202395,283,713898,869603328,713224,869522151,674,81177,703689,1815,1267156,138779,283,983,144444.0,43333.0,-66.0,-72.0,-63.0,-69.0,-65.0,-72.0,-63.0,-69.0,-72.0,-80.0,-70.0,-76.0,6.0,8.0,7.0,7.0,1
867,CC:2F:71:3F:1F:24,3914553,2633859196,1793464,2364656801,2121089,269202395,2533,1472304,1885621315,1471211,1885497671,1093,123644,1455371,5702,1793191,153423,2533,1714,86667.0,14444.0,-68.0,-63.0,-67.0,-69.0,-67.0,-63.0,-66.0,-69.0,-72.0,-80.0,-70.0,-76.0,4.0,17.0,3.0,7.0,1
868,CC:2F:71:3E:C5:1F,5527644,4450959498,3406553,4181756901,2121091,269202597,502,93163,7996025,78582,6267827,14581,1728198,21518,519,3413937,870555,502,2923,6500.0,1000.0,-70.0,-73.0,-66.0,-61.0,-70.0,-70.0,-67.0,-61.0,-72.0,-80.0,-70.0,-76.0,2.0,7.0,4.0,15.0,1
869,F8:59:71:5A:E0:3D,3388226,2168447433,1267130,1899243450,2121096,269203983,283,713964,869704968,713290,869623791,674,81177,703755,1815,1267223,138789,283,983,144444.0,43333.0,-66.0,-73.0,-63.0,-69.0,-66.0,-72.0,-63.0,-69.0,-72.0,-80.0,-70.0,-76.0,6.0,7.0,7.0,7.0,1
870,CC:2F:71:3F:1F:24,3914729,2634075959,1793633,2364871976,2121096,269203983,2533,1472459,1885829890,1471366,1885706246,1093,123644,1455525,5702,1793360,153551,2533,1714,86667.0,14444.0,-67.0,-64.0,-67.0,-70.0,-67.0,-64.0,-67.0,-69.0,-72.0,-80.0,-70.0,-76.0,5.0,16.0,3.0,6.0,1
871,CC:2F:71:3E:C5:1F,5527649,4450960884,3406553,4181756901,2121096,269203983,502,93163,7996025,78582,6267827,14581,1728198,21518,519,3413937,870555,502,2923,6500.0,1000.0,-70.0,-73.0,-66.0,-61.0,-70.0,-70.0,-67.0,-61.0,-72.0,-80.0,-70.0,-76.0,2.0,7.0,4.0,15.0,1
872,F8:59:71:5A:E0:3D,3388627,2169027789,1267527,1899823402,2121100,269204387,283,714086,869815416,713412,869734239,674,81177,703877,1815,1267620,138864,283,983,144444.0,43333.0,-66.0,-72.0,-64.0,-70.0,-66.0,-72.0,-63.0,-69.0,-72.0,-80.0,-70.0,-76.0,6.0,8.0,6.0,6.0,1
873,CC:2F:71:3F:1F:24,3914895,2634284966,1793795,2365080579,2121100,269204387,2533,1472605,1886030209,1471512,1885906565,1093,123644,1455671,5702,1793521,153606,2533,1714,86667.0,14444.0,-67.0,-64.0,-67.0,-70.0,-67.0,-63.0,-67.0,-69.0,-72.0,-80.0,-70.0,-76.0,5.0,16.0,3.0,6.0,1
874,CC:2F:71:3E:C5:1F,5527653,4450961288,3406553,4181756901,2121100,269204387,502,93163,7996025,78582,6267827,14581,1728198,21518,519,3413937,870555,502,2923,6500.0,1000.0,-70.0,-73.0,-66.0,-61.0,-70.0,-70.0,-67.0,-61.0,-72.0,-80.0,-70.0,-76.0,2.0,7.0,4.0,15.0,1
875,F8:59:71:5A:E0:3D,3388709,2169133742,1267604,1899928889,2121105,269204853,283,714165,869920175,713490,869838880,675,81295,703956,1815,1267697,138897,283,983,144444.0,43333.0,-66.0,-72.0,-64.0,-69.0,-66.0,-72.0,-63.0,-69.0,-72.0,-80.0,-70.0,-76.0,6.0,8.0,6.0,7.0,1
876,CC:2F:71:3F:1F:24,3915077,2634519068,1793971,2365314155,2121106,269204913,2533,1472768,1886256793,1471675,1886133149,1093,123644,1455833,5702,1793698,153710,2533,1714,78000.0,13000.0,-67.0,-63.0,-67.0,-69.0,-67.0,-63.0,-67.0,-69.0,-72.0,-80.0,-70.0,-76.0,5.0,17.0,3.0,7.0,1
877,CC:2F:71:3E:C5:1F,5527659,4450961814,3406553,4181756901,2121106,269204913,502,93163,7996025,78582,6267827,14581,1728198,21518,519,3413937,870555,502,2923,6500.0,1000.0,-70.0,-73.0,-66.0,-61.0,-70.0,-70.0,-67.0,-61.0,-72.0,-80.0,-70.0,-76.0,2.0,7.0,4.0,15.0,1
878,F8:59:71:5A:E0:3D,3388784,2169242874,1267674,1900037557,2121110,269205317,283,714237,870031125,713562,869949830,675,81295,704027,1815,1267767,138929,283,983,144444.0,43333.0,-66.0,-72.0,-63.0,-70.0,-65.0,-72.0,-63.0,-69.0,-72.0,-80.0,-70.0,-76.0,6.0,8.0,7.0,6.0,1
879,CC:2F:71:3F:1F:24,3915241,2634727496,1794131,2365522179,2121110,269205317,2533,1472913,1886457055,1471820,1886333411,1093,123644,1455978,5702,1793858,153769,2533,1714,86667.0,14444.0,-68.0,-64.0,-68.0,-69.0,-68.0,-64.0,-67.0,-69.0,-72.0,-80.0,-70.0,-76.0,4.0,16.0,2.0,7.0,1
880,CC:2F:71:3E:C5:1F,5527663,4450962218,3406553,4181756901,2121110,269205317,502,93163,7996025,78582,6267827,14581,1728198,21518,519,3413937,870555,502,2923,6500.0,1000.0,-70.0,-73.0,-66.0,-61.0,-70.0,-70.0,-67.0,-61.0,-72.0,-80.0,-70.0,-76.0,2.0,7.0,4.0,15.0,1
881,F8:59:71:5A:E0:3D,3388851,2169341068,1267737,1900135347,2121114,269205721,283,714299,870126633,713624,870045338,675,81295,704089,1815,1267829,138944,283,983,144444.0,43333.0,-67.0,-72.0,-64.0,-69.0,-66.0,-72.0,-63.0,-69.0,-72.0,-80.0,-70.0,-76.0,5.0,8.0,6.0,7.0,1
882,CC:2F:71:3F:1F:24,3915404,2634934874,1794290,2365729153,2121114,269205721,2533,1473057,1886655707,1471964,1886532063,1093,123644,1456122,5702,1794016,153822,2533,1714,86667.0,14444.0,-68.0,-64.0,-67.0,-69.0,-67.0,-63.0,-67.0,-69.0,-72.0,-80.0,-70.0,-76.0,4.0,16.0,3.0,7.0,1
883,CC:2F:71:3E:C5:1F,5527667,4450962622,3406553,4181756901,2121114,269205721,502,93163,7996025,78582,6267827,14581,1728198,21518,519,3413937,870555,502,2923,6500.0,1000.0,-70.0,-73.0,-66.0,-61.0,-70.0,-70.0,-67.0,-61.0,-72.0,-80.0,-70.0,-76.0,2.0,7.0,4.0,15.0,1
884,F8:59:71:5A:E0:3D,3388921,2169442542,1267802,1900236357,2121119,269206185,283,714364,870226733,713689,870145438,675,81295,704154,1815,1267895,138959,283,983,144444.0,43333.0,-66.0,-72.0,-64.0,-70.0,-66.0,-72.0,-63.0,-69.0,-72.0,-80.0,-70.0,-76.0,6.0,8.0,6.0,6.0,1
885,CC:2F:71:3F:1F:24,3915569,2635145178,1794450,2365938993,2121119,269206185,2533,1473202,1886857295,1472109,1886733651,1093,123644,1456267,5702,1794177,153893,2533,1714,86667.0,14444.0,-68.0,-64.0,-67.0,-70.0,-67.0,-64.0,-66.0,-69.0,-72.0,-80.0,-70.0,-76.0,4.0,16.0,3.0,6.0,1
886,CC:2F:71:3E:C5:1F,5527672,4450963086,3406553,4181756901,2121119,269206185,502,93163,7996025,78582,6267827,14581,1728198,21518,519,3413937,870555,502,2923,6500.0,1000.0,-70.0,-73.0,-66.0,-61.0,-70.0,-70.0,-67.0,-61.0,-72.0,-80.0,-70.0,-76.0,2.0,7.0,4.0,15.0,1
887,F8:59:71:5A:E0:3D,3388990,2169540816,1267866,1900334165,2121124,269206651,283,714428,870323897,713753,870242602,675,81295,704218,1815,1267959,138981,283,984,144444.0,43333.0,-66.0,-72.0,-64.0,-70.0,-66.0,-72.0,-63.0,-70.0,-72.0,-80.0,-70.0,-76.0,6.0,8.0,6.0,6.0,1
888,CC:2F:71:3F:1F:24,3915731,2635349510,1794607,2366142859,2121124,269206651,2533,1473346,1887054627,1472253,1886930983,1093,123644,1456409,5702,1794333,153940,2533,1715,86667.0,14444.0,-67.0,-64.0,-66.0,-69.0,-67.0,-64.0,-66.0,-69.0,-72.0,-80.0,-70.0,-76.0,5.0,16.0,4.0,7.0,1
889,CC:2F:71:3E:C5:1F,5527677,4450963552,3406553,4181756901,2121124,269206651,502,93164,7996143,78582,6267827,14582,1728316,21519,519,3413937,870555,502,2923,6500.0,1000.0,-69.0,-72.0,-66.0,-61.0,-70.0,-70.0,-67.0,-61.0,-72.0,-80.0,-70.0,-76.0,3.0,8.0,4.0,15.0,1
890,F8:59:71:5A:E0:3D,3389410,2170187279,1268282,1900980224,2121128,269207055,283,714580,870436563,713905,870355268,675,81295,704369,1815,1268375,139120,283,984,144444.0,43333.0,-66.0,-72.0,-64.0,-70.0,-66.0,-72.0,-63.0,-69.0,-72.0,-80.0,-70.0,-76.0,6.0,8.0,6.0,6.0,1
891,CC:2F:71:3F:1F:24,3915887,2635547322,1794759,2366340267,2121128,269207055,2533,1473496,1887261151,1472403,1887137507,1093,123644,1456558,5702,1794484,153991,2533,1715,86667.0,1000.0,-68.0,-63.0,-66.0,-68.0,-67.0,-63.0,-66.0,-68.0,-72.0,-80.0,-70.0,-76.0,4.0,17.0,4.0,8.0,1
892,CC:2F:71:3E:C5:1F,5527681,4450963956,3406553,4181756901,2121128,269207055,502,93164,7996143,78582,6267827,14582,1728316,21519,519,3413937,870555,502,2923,6500.0,1000.0,-69.0,-72.0,-66.0,-61.0,-70.0,-70.0,-67.0,-61.0,-72.0,-80.0,-70.0,-76.0,3.0,8.0,4.0,15.0,1
893,F8:59:71:5A:E0:3D,3389486,2170297461,1268353,1901089942,2121133,269207519,283,714615,870490897,713940,870409602,675,81295,704395,1815,1268447,139206,283,984,144444.0,43333.0,-65.0,-71.0,-63.0,-69.0,-65.0,-71.0,-63.0,-69.0,-72.0,-79.0,-70.0,-76.0,7.0,8.0,7.0,7.0,1
894,CC:2F:71:3F:1F:24,3916059,2635763775,1794926,2366556256,2121133,269207519,2533,1473667,1887495920,1472574,1887372276,1093,123644,1456729,5702,1794653,154250,2533,1715,57778.0,14444.0,-67.0,-63.0,-66.0,-68.0,-67.0,-63.0,-66.0,-69.0,-72.0,-79.0,-70.0,-76.0,5.0,16.0,4.0,8.0,1
895,CC:2F:71:3E:C5:1F,5527687,4450964482,3406553,4181756901,2121134,269207581,502,93164,7996143,78582,6267827,14582,1728316,21519,519,3413937,870555,502,2923,6500.0,1000.0,-69.0,-72.0,-66.0,-61.0,-70.0,-70.0,-67.0,-61.0,-72.0,-79.0,-70.0,-76.0,3.0,7.0,4.0,15.0,1
896,F8:59:71:5A:E0:3D,3389756,2170661767,1268617,1901453509,2121139,269208258,283,714791,870709432,714116,870628137,675,81295,704561,1815,1268712,139368,283,986,144444.0,43333.0,-65.0,-72.0,-63.0,-68.0,-65.0,-72.0,-63.0,-69.0,-72.0,-79.0,-70.0,-76.0,7.0,7.0,7.0,8.0,1
897,CC:2F:71:3F:1F:24,3916275,2636051942,1795136,2366843684,2121139,269208258,2533,1473861,1887768698,1472767,1887644936,1094,123762,1456923,5702,1794863,154409,2533,1715,65000.0,19500.0,-67.0,-64.0,-66.0,-68.0,-67.0,-63.0,-66.0,-68.0,-72.0,-79.0,-70.0,-76.0,5.0,15.0,4.0,8.0,1
898,CC:2F:71:3E:C5:1F,5527692,4450965159,3406553,4181756901,2121139,269208258,502,93164,7996143,78582,6267827,14582,1728316,21519,519,3413937,870555,502,2923,6500.0,1000.0,-69.0,-72.0,-66.0,-61.0,-70.0,-70.0,-67.0,-61.0,-72.0,-79.0,-70.0,-76.0,3.0,7.0,4.0,15.0,1
899,F8:59:71:5A:E0:3D,3389836,2170777773,1268692,1901569051,2121144,269208722,283,714866,870825394,714191,870744099,675,81295,704633,1815,1268787,139441,283,986,144444.0,43333.0,-66.0,-72.0,-62.0,-69.0,-65.0,-71.0,-62.0,-69.0,-72.0,-79.0,-70.0,-76.0,6.0,7.0,8.0,7.0,1
900,CC:2F:71:3F:1F:24,3916461,2636294208,1795317,2367085486,2121144,269208722,2533,1474027,1888001230,1472933,1887877468,1094,123762,1457089,5702,1795045,154550,2533,1715,78000.0,19500.0,-67.0,-64.0,-66.0,-69.0,-66.0,-64.0,-66.0,-69.0,-72.0,-79.0,-70.0,-76.0,5.0,15.0,4.0,7.0,1
901,CC:2F:71:3E:C5:1F,5527697,4450965623,3406553,4181756901,2121144,269208722,502,93164,7996143,78582,6267827,14582,1728316,21519,519,3413937,870555,502,2923,6500.0,1000.0,-69.0,-72.0,-66.0,-61.0,-70.0,-70.0,-67.0,-61.0,-72.0,-79.0,-70.0,-76.0,3.0,7.0,4.0,15.0,1
902,F8:59:71:5A:E0:3D,3389911,2170887615,1268763,1901678489,2121148,269209126,283,714931,870925662,714256,870844367,675,81295,704698,1815,1268857,139534,283,986,104000.0,1000.0,-66.0,-72.0,-63.0,-69.0,-65.0,-72.0,-63.0,-69.0,-72.0,-79.0,-70.0,-76.0,6.0,7.0,7.0,7.0,1
903,CC:2F:71:3F:1F:24,3916650,2636539154,1795500,2367329660,2121150,269209494,2533,1474199,1888238714,1473105,1888114952,1094,123762,1457261,5702,1795228,154666,2533,1715,78000.0,21667.0,-66.0,-64.0,-65.0,-68.0,-67.0,-64.0,-65.0,-69.0,-72.0,-79.0,-70.0,-76.0,6.0,15.0,5.0,8.0,1
904,CC:2F:71:3E:C5:1F,5527703,4450966395,3406553,4181756901,2121150,269209494,502,93164,7996143,78582,6267827,14582,1728316,21519,519,3413937,870555,502,2923,6500.0,1000.0,-69.0,-72.0,-66.0,-61.0,-70.0,-70.0,-67.0,-61.0,-72.0,-79.0,-70.0,-76.0,3.0,7.0,4.0,15.0,1
905,F8:59:71:5A:E0:3D,3389988,2170997657,1268834,1901787759,2121154,269209898,283,715008,871044410,714333,870963115,675,81295,704775,1815,1268929,139607,283,986,104000.0,26000.0,-67.0,-73.0,-63.0,-70.0,-66.0,-72.0,-63.0,-69.0,-72.0,-79.0,-70.0,-76.0,5.0,6.0,7.0,6.0,1
906,CC:2F:71:3F:1F:24,3916817,2636752524,1795663,2367542626,2121154,269209898,2533,1474346,1888442014,1473252,1888318252,1094,123762,1457408,5702,1795392,154787,2533,1715,65000.0,21667.0,-67.0,-64.0,-67.0,-69.0,-67.0,-64.0,-66.0,-68.0,-72.0,-79.0,-70.0,-76.0,5.0,15.0,3.0,7.0,1
907,CC:2F:71:3E:C5:1F,5527709,4450967001,3406553,4181756901,2121156,269210100,502,93164,7996143,78582,6267827,14582,1728316,21519,519,3413937,870555,502,2923,6500.0,1000.0,-69.0,-72.0,-66.0,-61.0,-70.0,-70.0,-67.0,-61.0,-72.0,-79.0,-70.0,-76.0,3.0,7.0,4.0,15.0,1
908,F8:59:71:5A:E0:3D,3390101,2171159301,1268938,1901948535,2121163,269210766,283,715070,871140450,714395,871059155,675,81295,704833,1815,1269032,139700,283,990,117000.0,1000.0,-65.0,-71.0,-62.0,-70.0,-65.0,-71.0,-62.0,-69.0,-72.0,-79.0,-70.0,-76.0,7.0,8.0,8.0,6.0,1
909,CC:2F:71:3F:1F:24,3917039,2637023353,1795876,2367812587,2121163,269210766,2533,1474601,1888794652,1473507,1888670890,1094,123762,1457655,5702,1795605,155009,2533,1715,28889.0,5500.0,-69.0,-64.0,-71.0,-71.0,-67.0,-63.0,-66.0,-68.0,-72.0,-79.0,-70.0,-76.0,3.0,15.0,-1.0,5.0,1
910,CC:2F:71:3E:C5:1F,5527716,4450967667,3406553,4181756901,2121163,269210766,502,93164,7996143,78582,6267827,14582,1728316,21519,520,3413938,870556,502,2923,6500.0,1000.0,-69.0,-72.0,-66.0,-61.0,-70.0,-70.0,-67.0,-61.0,-72.0,-79.0,-70.0,-76.0,3.0,7.0,4.0,15.0,1
911,F8:59:71:5A:E0:3D,3390412,2171598012,1269245,1902386842,2121167,269211170,283,715135,871239966,714460,871158671,675,81295,704894,1815,1269340,139751,283,990,144444.0,39000.0,-68.0,-73.0,-65.0,-71.0,-67.0,-72.0,-64.0,-70.0,-72.0,-79.0,-70.0,-76.0,4.0,6.0,5.0,5.0,1
912,CC:2F:71:3F:1F:24,3917231,2637273615,1796064,2368062445,2121167,269211170,2533,1474785,1889049162,1473691,1888925400,1094,123762,1457837,5702,1795793,155139,2533,1715,78000.0,13000.0,-70.0,-64.0,-72.0,-71.0,-68.0,-63.0,-68.0,-69.0,-72.0,-79.0,-70.0,-76.0,2.0,15.0,-2.0,5.0,1
913,CC:2F:71:3E:C5:1F,5527721,4450968131,3406553,4181756901,2121168,269211230,502,93164,7996143,78582,6267827,14582,1728316,21519,520,3413938,870556,502,2923,6500.0,1000.0,-69.0,-72.0,-66.0,-61.0,-70.0,-70.0,-67.0,-61.0,-72.0,-79.0,-70.0,-76.0,3.0,7.0,4.0,15.0,1
914,F8:59:71:5A:E0:3D,3390970,2172454518,1269798,1903242884,2121172,269211634,283,715405,871483484,714730,871402189,675,81295,705160,1815,1269893,140037,283,990,144444.0,39000.0,-68.0,-74.0,-65.0,-72.0,-67.0,-72.0,-64.0,-70.0,-72.0,-79.0,-70.0,-76.0,4.0,5.0,5.0,4.0,1
915,CC:2F:71:3F:1F:24,3917473,2637593681,1796301,2368382047,2121172,269211634,2533,1474959,1889276242,1473865,1889152480,1094,123762,1458009,5702,1796030,155245,2533,1715,65000.0,13000.0,-67.0,-63.0,-66.0,-68.0,-67.0,-63.0,-67.0,-69.0,-72.0,-79.0,-70.0,-76.0,5.0,16.0,4.0,8.0,1
916,CC:2F:71:3E:C5:1F,5527725,4450968535,3406553,4181756901,2121172,269211634,502,93164,7996143,78582,6267827,14582,1728316,21519,520,3413938,870556,502,2923,6500.0,1000.0,-69.0,-72.0,-66.0,-61.0,-70.0,-70.0,-67.0,-61.0,-72.0,-79.0,-70.0,-76.0,3.0,7.0,4.0,15.0,1
917,F8:59:71:5A:E0:3D,3391100,2172642972,1269919,1903430470,2121181,269212502,283,715527,871671630,714852,871590335,675,81295,705282,1815,1270013,140077,283,990,130000.0,39000.0,-65.0,-71.0,-63.0,-69.0,-66.0,-72.0,-63.0,-69.0,-72.0,-79.0,-70.0,-76.0,7.0,8.0,7.0,7.0,1
918,CC:2F:71:3F:1F:24,3918927,2639683864,1797744,2370471160,2121183,269212704,2533,1475467,1889787405,1474373,1889663643,1094,123762,1458517,5702,1797370,157009,2533,1715,104000.0,1000.0,-67.0,-63.0,-67.0,-68.0,-67.0,-63.0,-69.0,-69.0,-72.0,-79.0,-70.0,-76.0,5.0,16.0,3.0,8.0,1
919,CC:2F:71:3E:C5:1F,5527738,4450969807,3406553,4181756901,2121185,269212906,502,93164,7996143,78582,6267827,14582,1728316,21519,520,3413938,870556,502,2923,6500.0,1000.0,-69.0,-72.0,-66.0,-61.0,-70.0,-70.0,-67.0,-61.0,-72.0,-79.0,-70.0,-76.0,3.0,7.0,4.0,15.0,1
920,F8:59:71:5A:E0:3D,3391348,2172976739,1270159,1903763429,2121189,269213310,283,715691,871885071,715016,871803776,675,81295,705446,1815,1270254,140202,283,990,130000.0,43333.0,-66.0,-71.0,-62.0,-68.0,-66.0,-71.0,-63.0,-69.0,-72.0,-79.0,-70.0,-76.0,6.0,8.0,8.0,8.0,1
921,CC:2F:71:3F:1F:24,3920514,2641965082,1799325,2372751772,2121189,269213310,2533,1475959,1890200897,1474865,1890077135,1094,123762,1459009,5702,1799053,158314,2533,1715,86667.0,14444.0,-70.0,-64.0,-72.0,-70.0,-69.0,-63.0,-71.0,-70.0,-72.0,-79.0,-70.0,-76.0,2.0,15.0,-2.0,6.0,1
922,CC:2F:71:3E:C5:1F,5527747,4450970675,3406553,4181756901,2121194,269213774,502,93164,7996143,78582,6267827,14582,1728316,21519,520,3413938,870556,502,2923,6500.0,1000.0,-69.0,-72.0,-66.0,-61.0,-70.0,-70.0,-67.0,-61.0,-72.0,-79.0,-70.0,-76.0,3.0,7.0,4.0,15.0,1
923,F8:59:71:5A:E0:3D,3391732,2173560732,1270534,1904346554,2121198,269214178,283,715846,872081829,715171,872000534,675,81295,705601,1815,1270629,140308,283,990,130000.0,39000.0,-68.0,-73.0,-65.0,-72.0,-67.0,-72.0,-64.0,-70.0,-72.0,-79.0,-70.0,-76.0,4.0,6.0,5.0,4.0,1
924,CC:2F:71:3F:1F:24,3922034,2644140530,1800833,2374925877,2121201,269214653,2533,1476511,1890734355,1475417,1890610593,1094,123762,1459561,5702,1800563,159748,2533,1724,72222.0,21667.0,-70.0,-63.0,-72.0,-70.0,-68.0,-63.0,-68.0,-69.0,-72.0,-79.0,-70.0,-76.0,2.0,16.0,-2.0,6.0,1
925,CC:2F:71:3E:C5:1F,5527756,4450971756,3406553,4181756901,2121203,269214855,502,93164,7996143,78582,6267827,14582,1728316,21519,520,3413938,870556,502,2923,6500.0,1000.0,-69.0,-72.0,-66.0,-61.0,-70.0,-70.0,-67.0,-61.0,-72.0,-79.0,-70.0,-76.0,3.0,7.0,4.0,15.0,1
926,F8:59:71:5A:E0:3D,3391951,2173852140,1270740,1904636557,2121211,269215583,283,716070,872405612,715394,872324199,676,81413,705807,1815,1270833,140408,283,991,130000.0,43333.0,-68.0,-73.0,-65.0,-71.0,-66.0,-71.0,-63.0,-69.0,-72.0,-78.0,-70.0,-75.0,4.0,5.0,5.0,4.0,1
927,CC:2F:71:3F:1F:24,3923635,2646417199,1802422,2377201414,2121213,269215785,2533,1477120,1891317193,1476026,1891193431,1094,123762,1460158,5702,1802122,161254,2533,1724,72222.0,21667.0,-67.0,-63.0,-66.0,-68.0,-68.0,-63.0,-69.0,-69.0,-72.0,-78.0,-70.0,-75.0,5.0,15.0,4.0,7.0,1
928,CC:2F:71:3E:C5:1F,5527767,4450972802,3406554,4181757017,2121213,269215785,502,93164,7996143,78582,6267827,14582,1728316,21519,520,3413939,870557,502,2923,6500.0,1000.0,-69.0,-72.0,-66.0,-61.0,-70.0,-70.0,-67.0,-61.0,-72.0,-78.0,-70.0,-75.0,3.0,6.0,4.0,14.0,1
929,F8:59:71:5A:E0:3D,3392427,2174568941,1271207,1905352490,2121220,269216451,283,716282,872626346,715606,872544933,676,81413,706019,1815,1271301,140732,283,992,115556.0,28889.0,-68.0,-74.0,-65.0,-72.0,-67.0,-72.0,-64.0,-70.0,-72.0,-78.0,-70.0,-75.0,4.0,4.0,5.0,3.0,1
930,CC:2F:71:3F:1F:24,3924875,2648196228,1803655,2378979777,2121220,269216451,2533,1477528,1891682288,1476434,1891558526,1094,123762,1460566,5702,1803384,162203,2533,1724,65000.0,19500.0,-67.0,-63.0,-66.0,-69.0,-68.0,-63.0,-69.0,-70.0,-72.0,-78.0,-70.0,-75.0,5.0,15.0,4.0,6.0,1
931,CC:2F:71:3E:C5:1F,5527777,4450973732,3406554,4181757017,2121223,269216715,502,93165,7996261,78582,6267827,14583,1728434,21520,520,3413939,870557,502,2924,6500.0,1000.0,-64.0,-68.0,-62.0,-61.0,-69.0,-70.0,-66.0,-61.0,-72.0,-78.0,-70.0,-75.0,8.0,10.0,8.0,14.0,1
932,F8:59:71:5A:E0:3D,3392935,2175286318,1271698,1906068269,2121237,269218049,283,716574,873002590,715898,872921177,676,81413,706311,1815,1271786,140921,283,997,144444.0,43333.0,-68.0,-73.0,-65.0,-71.0,-67.0,-72.0,-64.0,-70.0,-72.0,-78.0,-70.0,-75.0,4.0,5.0,5.0,4.0,1
933,CC:2F:71:3F:1F:24,3926458,2650483621,1805221,2381265572,2121237,269218049,2533,1478212,1892429517,1477117,1892305637,1095,123880,1461239,5702,1804954,163273,2533,1745,72222.0,21667.0,-70.0,-64.0,-72.0,-71.0,-68.0,-63.0,-68.0,-70.0,-72.0,-78.0,-70.0,-75.0,2.0,14.0,-2.0,4.0,1
934,CC:2F:71:3E:C5:1F,5527791,4450975066,3406554,4181757017,2121237,269218049,502,93165,7996261,78582,6267827,14583,1728434,21520,520,3413939,870557,502,2924,6500.0,1000.0,-64.0,-68.0,-62.0,-61.0,-69.0,-70.0,-66.0,-61.0,-72.0,-78.0,-70.0,-75.0,8.0,10.0,8.0,14.0,1
935,F8:59:71:5A:E0:3D,3393018,2175409376,1271777,1906190923,2121241,269218453,283,716655,873126428,715979,873045015,676,81413,706392,1815,1271870,140966,283,997,144444.0,43333.0,-68.0,-72.0,-63.0,-70.0,-68.0,-72.0,-64.0,-70.0,-72.0,-78.0,-70.0,-75.0,4.0,6.0,7.0,5.0,1
936,CC:2F:71:3F:1F:24,3927772,2652361508,1806530,2383142995,2121242,269218513,2533,1478608,1892727417,1477513,1892603537,1095,123880,1461635,5702,1806264,163861,2533,1747,72222.0,21667.0,-70.0,-63.0,-71.0,-71.0,-68.0,-63.0,-69.0,-70.0,-72.0,-78.0,-70.0,-75.0,2.0,15.0,-1.0,4.0,1
937,CC:2F:71:3E:C5:1F,5527796,4450975530,3406554,4181757017,2121242,269218513,502,93165,7996261,78582,6267827,14583,1728434,21520,520,3413939,870557,502,2924,6500.0,1000.0,-64.0,-68.0,-62.0,-61.0,-69.0,-70.0,-66.0,-61.0,-72.0,-78.0,-70.0,-75.0,8.0,10.0,8.0,14.0,1
938,F8:59:71:5A:E0:3D,3393160,2175604211,1271910,1906384890,2121250,269219321,283,716795,873335069,716119,873253656,676,81413,706532,1815,1272004,141004,283,1000,144444.0,43333.0,-66.0,-72.0,-62.0,-69.0,-67.0,-72.0,-64.0,-70.0,-72.0,-78.0,-70.0,-75.0,6.0,6.0,8.0,6.0,1
939,CC:2F:71:3F:1F:24,3930207,2655857199,1808957,2386637878,2121250,269219321,2533,1479198,1893167757,1478103,1893043877,1095,123880,1462223,5702,1808633,165211,2533,1747,86667.0,14444.0,-71.0,-64.0,-73.0,-71.0,-69.0,-64.0,-70.0,-70.0,-72.0,-78.0,-70.0,-75.0,1.0,14.0,-3.0,4.0,1
940,CC:2F:71:3E:C5:1F,5527804,4450976338,3406554,4181757017,2121250,269219321,502,93165,7996261,78582,6267827,14583,1728434,21520,520,3413939,870557,502,2924,6500.0,1000.0,-64.0,-68.0,-62.0,-61.0,-69.0,-70.0,-66.0,-61.0,-72.0,-78.0,-70.0,-75.0,8.0,10.0,8.0,14.0,1
941,F8:59:71:5A:E0:3D,3393250,2175736205,1271995,1906516420,2121255,269219785,283,716875,873458591,716199,873377178,676,81413,706612,1815,1272090,141048,283,1000,144444.0,43333.0,-67.0,-72.0,-63.0,-69.0,-68.0,-72.0,-64.0,-71.0,-72.0,-78.0,-70.0,-75.0,5.0,6.0,7.0,6.0,1
942,CC:2F:71:3F:1F:24,3930652,2656466501,1809397,2387246716,2121255,269219785,2533,1479410,1893406550,1478315,1893282670,1095,123880,1462435,5702,1809132,165424,2533,1748,86667.0,14444.0,-71.0,-64.0,-72.0,-71.0,-69.0,-64.0,-70.0,-70.0,-72.0,-78.0,-70.0,-75.0,1.0,14.0,-2.0,4.0,1
943,CC:2F:71:3E:C5:1F,5527811,4450977004,3406554,4181757017,2121257,269219987,502,93165,7996261,78582,6267827,14583,1728434,21520,520,3413939,870557,502,2924,6500.0,1000.0,-64.0,-68.0,-62.0,-61.0,-69.0,-70.0,-66.0,-61.0,-72.0,-78.0,-70.0,-75.0,8.0,10.0,8.0,14.0,1
944,F8:59:71:5A:E0:3D,3393652,2176352335,1272393,1907132146,2121259,269220189,283,717017,873594719,716341,873513306,676,81413,706754,1815,1272487,141281,283,1000,144444.0,43333.0,-68.0,-73.0,-65.0,-72.0,-67.0,-72.0,-63.0,-70.0,-72.0,-78.0,-70.0,-75.0,4.0,5.0,5.0,3.0,1
945,CC:2F:71:3F:1F:24,3930855,2656728731,1809596,2387508542,2121259,269220189,2533,1479594,1893661579,1478499,1893537699,1095,123880,1462619,5702,1809327,165584,2533,1750,86667.0,13000.0,-67.0,-64.0,-66.0,-70.0,-68.0,-63.0,-67.0,-69.0,-72.0,-78.0,-70.0,-75.0,5.0,14.0,4.0,5.0,1
946,CC:2F:71:3E:C5:1F,5527814,4450977479,3406554,4181757017,2121260,269220462,502,93165,7996261,78582,6267827,14583,1728434,21520,520,3413939,870557,502,2924,6500.0,1000.0,-64.0,-68.0,-62.0,-61.0,-69.0,-70.0,-66.0,-61.0,-72.0,-78.0,-70.0,-75.0,8.0,10.0,8.0,14.0,1
947,F8:59:71:5A:E0:3D,3393820,2176589900,1272554,1907368832,2121266,269221068,283,717108,873707463,716432,873626050,676,81413,706845,1815,1272649,141432,283,1001,144444.0,43333.0,-66.0,-72.0,-63.0,-70.0,-67.0,-72.0,-63.0,-70.0,-72.0,-78.0,-70.0,-75.0,6.0,6.0,7.0,5.0,1
948,CC:2F:71:3F:1F:24,3931039,2656963430,1809772,2387742302,2121267,269221128,2533,1479760,1893890077,1478665,1893766197,1095,123880,1462785,5703,1809509,165732,2533,1751,86667.0,14444.0,-67.0,-64.0,-67.0,-69.0,-68.0,-62.0,-69.0,-69.0,-73.0,-79.0,-71.0,-76.0,6.0,15.0,4.0,7.0,1
949,CC:2F:71:3E:C5:1F,5527821,4450978145,3406554,4181757017,2121267,269221128,502,93165,7996261,78582,6267827,14583,1728434,21520,520,3413939,870557,502,2924,6500.0,1000.0,-64.0,-68.0,-62.0,-61.0,-69.0,-70.0,-66.0,-61.0,-73.0,-79.0,-71.0,-76.0,9.0,11.0,9.0,15.0,1
950,F8:59:71:5A:E0:3D,3394347,2177360530,1273078,1908139200,2121269,269221330,283,717218,873827778,716542,873746365,676,81413,706955,1815,1273173,141797,283,1001,144444.0,43333.0,-68.0,-73.0,-65.0,-71.0,-67.0,-72.0,-64.0,-70.0,-73.0,-79.0,-71.0,-76.0,5.0,6.0,6.0,5.0,1
951,CC:2F:71:3F:1F:24,3931230,2657208755,1809961,2387987425,2121269,269221330,2533,1479934,1894126517,1478839,1894002637,1095,123880,1462959,5703,1809698,165801,2533,1752,86667.0,14444.0,-70.0,-64.0,-73.0,-71.0,-67.0,-63.0,-67.0,-69.0,-73.0,-79.0,-71.0,-76.0,3.0,15.0,-2.0,5.0,1
952,CC:2F:71:3E:C5:1F,5527825,4450978549,3406554,4181757017,2121271,269221532,502,93165,7996261,78582,6267827,14583,1728434,21520,520,3413939,870557,502,2924,6500.0,1000.0,-64.0,-68.0,-62.0,-61.0,-69.0,-70.0,-66.0,-61.0,-73.0,-79.0,-71.0,-76.0,9.0,11.0,9.0,15.0,1
953,F8:59:71:5A:E0:3D,3394446,2177503898,1273171,1908281962,2121275,269221936,283,717343,873982000,716667,873900587,676,81413,707079,1815,1273266,141896,283,1002,144444.0,43333.0,-68.0,-73.0,-65.0,-71.0,-66.0,-71.0,-63.0,-69.0,-73.0,-80.0,-71.0,-76.0,5.0,7.0,6.0,5.0,1
954,CC:2F:71:3F:1F:24,3931450,2657499603,1810173,2388277465,2121277,269222138,2533,1480141,1894418855,1479046,1894294975,1095,123880,1463166,5703,1809909,166021,2533,1754,72222.0,1000.0,-68.0,-64.0,-67.0,-69.0,-67.0,-63.0,-67.0,-69.0,-73.0,-80.0,-71.0,-76.0,5.0,16.0,4.0,7.0,1
955,CC:2F:71:3E:C5:1F,5527832,4450979215,3406554,4181757017,2121278,269222198,502,93165,7996261,78582,6267827,14583,1728434,21520,520,3413940,870557,502,2924,6500.0,1000.0,-64.0,-68.0,-62.0,-61.0,-69.0,-70.0,-66.0,-61.0,-73.0,-80.0,-71.0,-76.0,9.0,12.0,9.0,15.0,1
956,F8:59:71:5A:E0:3D,3394649,2177799415,1273367,1908576813,2121282,269222602,283,717415,874063008,716739,873981595,676,81413,707143,1815,1273463,142076,283,1008,144444.0,43333.0,-66.0,-71.0,-62.0,-69.0,-65.0,-70.0,-62.0,-69.0,-73.0,-80.0,-71.0,-76.0,7.0,9.0,9.0,7.0,1
957,CC:2F:71:3F:1F:24,3931635,2657730824,1810351,2388508020,2121284,269222804,2533,1480368,1894738468,1479273,1894614588,1095,123880,1463393,5703,1810091,166181,2533,1754,65000.0,19500.0,-66.0,-63.0,-66.0,-68.0,-67.0,-63.0,-67.0,-69.0,-73.0,-80.0,-71.0,-77.0,7.0,17.0,5.0,9.0,1
958,CC:2F:71:3E:C5:1F,5527838,4450979821,3406554,4181757017,2121284,269222804,502,93165,7996261,78582,6267827,14583,1728434,21520,520,3413940,870557,502,2924,6500.0,1000.0,-64.0,-68.0,-62.0,-61.0,-69.0,-70.0,-66.0,-61.0,-73.0,-80.0,-71.0,-77.0,9.0,12.0,9.0,16.0,1
959,F8:59:71:5A:E0:3D,3394742,2177932005,1273456,1908708999,2121286,269223006,283,717558,874282912,716882,874201499,676,81413,707267,1815,1273552,142139,283,1009,144444.0,43333.0,-66.0,-72.0,-63.0,-69.0,-67.0,-72.0,-63.0,-70.0,-73.0,-80.0,-71.0,-77.0,7.0,8.0,8.0,8.0,1
960,CC:2F:71:3F:1F:24,3931860,2658036104,1810574,2388813098,2121286,269223006,2533,1480532,1894963632,1479437,1894839752,1095,123880,1463557,5703,1810313,166354,2533,1754,72222.0,1000.0,-67.0,-64.0,-66.0,-69.0,-66.0,-64.0,-66.0,-69.0,-73.0,-80.0,-71.0,-77.0,6.0,16.0,5.0,8.0,1
961,CC:2F:71:3E:C5:1F,5527842,4450980225,3406554,4181757017,2121288,269223208,502,93165,7996261,78582,6267827,14583,1728434,21520,520,3413940,870557,502,2924,6500.0,1000.0,-64.0,-68.0,-62.0,-61.0,-69.0,-70.0,-66.0,-61.0,-73.0,-80.0,-71.0,-77.0,9.0,12.0,9.0,16.0,1
962,F8:59:71:5A:E0:3D,3395205,2178598000,1273908,1909373924,2121297,269224076,283,717776,874552187,717100,874470774,676,81413,707485,1815,1273956,142366,283,1009,144444.0,1000.0,-67.0,-72.0,-64.0,-71.0,-67.0,-71.0,-63.0,-69.0,-73.0,-80.0,-71.0,-77.0,6.0,8.0,7.0,6.0,1
963,CC:2F:71:3F:1F:24,3933097,2659800391,1811796,2390575911,2121301,269224480,2533,1481085,1895599000,1479990,1895475120,1095,123880,1464108,5703,1811491,167257,2533,1754,72222.0,21667.0,-67.0,-63.0,-66.0,-69.0,-68.0,-63.0,-69.0,-70.0,-73.0,-80.0,-71.0,-77.0,6.0,17.0,5.0,8.0,1
964,CC:2F:71:3E:C5:1F,5527858,4450981759,3406554,4181757017,2121304,269224742,502,93165,7996261,78582,6267827,14583,1728434,21520,520,3413940,870557,502,2924,6500.0,1000.0,-64.0,-68.0,-62.0,-61.0,-69.0,-70.0,-66.0,-61.0,-73.0,-80.0,-71.0,-77.0,9.0,12.0,9.0,16.0,1
965,F8:59:71:5A:E0:3D,3395782,2179423127,1274467,1910197315,2121315,269225812,283,718069,874920806,717393,874839393,676,81413,707706,1815,1274563,142756,283,1010,144444.0,43333.0,-68.0,-72.0,-64.0,-71.0,-67.0,-72.0,-63.0,-70.0,-73.0,-80.0,-71.0,-77.0,5.0,8.0,7.0,6.0,1
966,CC:2F:71:3F:1F:24,3934502,2661801378,1813187,2392575566,2121315,269225812,2533,1481755,1896353552,1480660,1896229672,1095,123880,1464767,5703,1812931,169383,2533,1756,104000.0,1000.0,-67.0,-63.0,-66.0,-69.0,-67.0,-63.0,-67.0,-69.0,-73.0,-80.0,-71.0,-77.0,6.0,17.0,5.0,8.0,1
967,CC:2F:71:3E:C5:1F,5527869,4450982829,3406554,4181757017,2121315,269225812,502,93165,7996261,78582,6267827,14583,1728434,21520,520,3413940,870557,502,2924,6500.0,1000.0,-64.0,-68.0,-62.0,-61.0,-69.0,-70.0,-66.0,-61.0,-73.0,-80.0,-71.0,-77.0,9.0,12.0,9.0,16.0,1
968,F8:59:71:5A:E0:3D,3395869,2179550364,1274549,1910323875,2121320,269226489,283,718187,875100696,717511,875019283,676,81413,707808,1815,1274644,142807,283,1020,144444.0,1000.0,-68.0,-73.0,-63.0,-71.0,-67.0,-72.0,-64.0,-70.0,-73.0,-80.0,-71.0,-77.0,5.0,7.0,8.0,6.0,1
969,CC:2F:71:3F:1F:24,3934715,2662085871,1813395,2392859382,2121320,269226489,2533,1481931,1896598608,1480836,1896474728,1095,123880,1464943,5703,1813141,169667,2533,1756,86667.0,14444.0,-67.0,-64.0,-66.0,-70.0,-67.0,-63.0,-67.0,-69.0,-73.0,-80.0,-71.0,-77.0,6.0,16.0,5.0,7.0,1
970,CC:2F:71:3E:C5:1F,5527876,4450983708,3406554,4181757017,2121322,269226691,502,93165,7996261,78582,6267827,14583,1728434,21520,520,3413940,870557,502,2924,6500.0,1000.0,-64.0,-68.0,-62.0,-61.0,-69.0,-70.0,-66.0,-61.0,-73.0,-80.0,-71.0,-77.0,9.0,12.0,9.0,16.0,1
971,F8:59:71:5A:E0:3D,3396093,2179890259,1274768,1910663306,2121325,269226953,283,718282,875216381,717606,875134968,676,81413,707903,1815,1274864,142968,283,1020,130000.0,39000.0,-68.0,-73.0,-65.0,-72.0,-67.0,-72.0,-64.0,-70.0,-73.0,-80.0,-71.0,-77.0,5.0,7.0,6.0,5.0,1
972,CC:2F:71:3F:1F:24,3934889,2662309937,1813564,2393082984,2121325,269226953,2533,1482086,1896811366,1480991,1896687486,1095,123880,1465097,5703,1813309,169752,2533,1756,86667.0,14444.0,-67.0,-64.0,-66.0,-68.0,-67.0,-63.0,-66.0,-68.0,-73.0,-80.0,-71.0,-77.0,6.0,16.0,5.0,9.0,1
973,CC:2F:71:3E:C5:1F,5527881,4450984172,3406554,4181757017,2121327,269227155,502,93165,7996261,78582,6267827,14583,1728434,21520,520,3413940,870557,502,2924,6500.0,1000.0,-64.0,-68.0,-62.0,-61.0,-69.0,-70.0,-66.0,-61.0,-73.0,-80.0,-71.0,-77.0,9.0,12.0,9.0,16.0,1
974,F8:59:71:5A:E0:3D,3396167,2179992960,1274838,1910765603,2121329,269227357,283,718357,875328176,717681,875246763,676,81413,707978,1815,1274933,143021,283,1020,144444.0,1000.0,-66.0,-71.0,-63.0,-70.0,-67.0,-72.0,-64.0,-70.0,-73.0,-80.0,-71.0,-77.0,7.0,9.0,8.0,7.0,1
975,CC:2F:71:3F:1F:24,3935073,2662544531,1813742,2393316806,2121331,269227725,2533,1482247,1897033530,1481152,1896909650,1095,123880,1465258,5703,1813488,169814,2533,1758,104000.0,26000.0,-67.0,-63.0,-66.0,-69.0,-68.0,-63.0,-69.0,-70.0,-73.0,-80.0,-70.0,-77.0,6.0,17.0,4.0,8.0,1
976,CC:2F:71:3E:C5:1F,5527888,4450985060,3406555,4181757133,2121333,269227927,502,93165,7996261,78582,6267827,14583,1728434,21520,520,3413941,870559,502,2924,6500.0,1000.0,-64.0,-68.0,-62.0,-61.0,-69.0,-70.0,-66.0,-61.0,-73.0,-80.0,-70.0,-77.0,9.0,12.0,8.0,16.0,1
977,F8:59:71:5A:E0:3D,3396268,2180130409,1274931,1910902078,2121337,269228331,283,718444,875459135,717768,875377722,676,81413,708065,1815,1275027,143094,283,1021,144444.0,43333.0,-69.0,-73.0,-65.0,-72.0,-68.0,-72.0,-64.0,-71.0,-73.0,-80.0,-70.0,-77.0,4.0,7.0,5.0,5.0,1
978,CC:2F:71:3F:1F:24,3935268,2662796315,1813931,2393567984,2121337,269228331,2533,1482428,1897283772,1481333,1897159892,1095,123880,1465439,5703,1813681,169969,2533,1759,86667.0,13000.0,-67.0,-63.0,-67.0,-69.0,-67.0,-63.0,-67.0,-70.0,-73.0,-80.0,-70.0,-77.0,6.0,17.0,3.0,8.0,1
979,CC:2F:71:3E:C5:1F,5527894,4450985666,3406555,4181757133,2121339,269228533,502,93165,7996261,78582,6267827,14583,1728434,21520,520,3413941,870559,502,2924,6500.0,1000.0,-64.0,-68.0,-62.0,-61.0,-69.0,-70.0,-66.0,-61.0,-73.0,-80.0,-70.0,-77.0,9.0,12.0,8.0,16.0,1
980,F8:59:71:5A:E0:3D,3397414,2181821926,1276040,1912589995,2121374,269231931,283,718994,876102360,718318,876020947,676,81413,708526,1815,1276126,144284,283,1025,130000.0,1000.0,-66.0,-71.0,-62.0,-70.0,-65.0,-71.0,-62.0,-68.0,-73.0,-80.0,-70.0,-76.0,7.0,9.0,8.0,6.0,1
981,CC:2F:71:3F:1F:24,3938092,2666770380,1816676,2397534318,2121416,269236062,2543,1484916,1900565214,1483819,1900441110,1097,124104,1467847,5785,1816431,172145,2543,1761,6500.0,1000.0,-67.0,-64.0,-66.0,-69.0,-66.0,-63.0,-66.0,-69.0,-73.0,-81.0,-71.0,-77.0,6.0,17.0,5.0,8.0,1
982,CC:2F:71:3E:C5:1F,5528347,4451501866,3406884,4182256695,2121463,269245171,502,93168,7996555,78584,6268003,14584,1728552,21522,527,3414270,870673,502,2925,6500.0,1000.0,-65.0,-63.0,-65.0,-60.0,-67.0,-70.0,-65.0,-60.0,-73.0,-81.0,-71.0,-77.0,8.0,18.0,6.0,17.0,1
983,F8:59:71:5A:E0:3D,3400500,2186254514,1279017,1917003051,2121483,269251463,283,719929,877056295,719252,876974764,677,81531,709252,1815,1279111,146350,283,1039,130000.0,39000.0,-67.0,-72.0,-64.0,-71.0,-66.0,-72.0,-63.0,-70.0,-73.0,-81.0,-71.0,-77.0,6.0,9.0,7.0,6.0,1
984,CC:2F:71:3F:1F:24,3939435,2668561367,1817952,2399309904,2121483,269251463,2543,1486724,1903141313,1485627,1903017209,1097,124104,1469623,5817,1817707,172596,2543,1762,78000.0,13000.0,-67.0,-64.0,-67.0,-70.0,-68.0,-64.0,-68.0,-70.0,-73.0,-81.0,-71.0,-77.0,6.0,17.0,4.0,7.0,1
985,CC:2F:71:3E:C5:1F,5528369,4451508336,3406885,4182256811,2121484,269251525,502,93168,7996555,78584,6268003,14584,1728552,21522,527,3414271,870674,502,2925,6500.0,1000.0,-65.0,-63.0,-65.0,-60.0,-67.0,-70.0,-65.0,-60.0,-73.0,-81.0,-71.0,-77.0,8.0,18.0,6.0,17.0,1
986,F8:59:71:5A:E0:3D,3400977,2186928501,1279485,1917676168,2121492,269252333,283,720527,877748203,719850,877666672,677,81531,709834,1815,1279583,146414,283,1043,144444.0,43333.0,-66.0,-73.0,-64.0,-70.0,-66.0,-73.0,-63.0,-70.0,-73.0,-81.0,-70.0,-76.0,7.0,8.0,6.0,6.0,1
987,CC:2F:71:3F:1F:24,3940041,2669449891,1818549,2400197558,2121492,269252333,2543,1486942,1903451041,1485844,1903326819,1098,124222,1469841,5817,1818298,173075,2543,1762,78000.0,13000.0,-67.0,-64.0,-67.0,-69.0,-67.0,-63.0,-68.0,-69.0,-73.0,-81.0,-70.0,-76.0,6.0,17.0,3.0,7.0,1
988,CC:2F:71:3E:C5:1F,5528377,4451509144,3406885,4182256811,2121492,269252333,502,93168,7996555,78584,6268003,14584,1728552,21522,527,3414271,870674,502,2925,6500.0,1000.0,-65.0,-63.0,-65.0,-60.0,-67.0,-70.0,-65.0,-60.0,-73.0,-81.0,-70.0,-76.0,8.0,18.0,5.0,16.0,1
989,F8:59:71:5A:E0:3D,3401733,2188107562,1280238,1918854967,2121495,269252595,283,721230,878553109,720553,878471578,677,81531,710537,1815,1280336,146552,283,1043,144444.0,43333.0,-66.0,-72.0,-64.0,-70.0,-66.0,-72.0,-63.0,-69.0,-73.0,-81.0,-70.0,-76.0,7.0,9.0,6.0,6.0,1
990,CC:2F:71:3F:1F:24,3940698,2670422361,1819199,2401169362,2121499,269252999,2543,1487132,1903717853,1486034,1903593631,1098,124222,1470031,5817,1818945,173238,2543,1762,86667.0,14444.0,-68.0,-64.0,-68.0,-70.0,-67.0,-63.0,-68.0,-69.0,-73.0,-81.0,-70.0,-76.0,5.0,17.0,2.0,6.0,1
991,CC:2F:71:3E:C5:1F,5528384,4451509810,3406885,4182256811,2121499,269252999,502,93168,7996555,78584,6268003,14584,1728552,21522,527,3414271,870674,502,2925,6500.0,1000.0,-65.0,-63.0,-65.0,-60.0,-67.0,-70.0,-65.0,-60.0,-73.0,-81.0,-70.0,-76.0,8.0,18.0,5.0,16.0,1
992,F8:59:71:5A:E0:3D,3401819,2188225505,1280318,1918972304,2121501,269253201,283,721472,878921509,720795,878839978,677,81531,710779,1815,1280416,146565,283,1043,144444.0,43333.0,-67.0,-72.0,-64.0,-70.0,-66.0,-72.0,-63.0,-69.0,-73.0,-81.0,-70.0,-76.0,6.0,9.0,6.0,6.0,1
993,CC:2F:71:3F:1F:24,3940958,2670783383,1819457,2401530182,2121501,269253201,2543,1487292,1903939693,1486194,1903815471,1098,124222,1470191,5817,1819212,173289,2543,1762,86667.0,14444.0,-67.0,-64.0,-67.0,-69.0,-67.0,-64.0,-68.0,-68.0,-73.0,-81.0,-70.0,-76.0,6.0,17.0,3.0,7.0,1
994,CC:2F:71:3E:C5:1F,5528386,4451510012,3406885,4182256811,2121501,269253201,502,93168,7996555,78584,6268003,14584,1728552,21522,527,3414271,870674,502,2925,6500.0,1000.0,-65.0,-63.0,-65.0,-60.0,-67.0,-70.0,-65.0,-60.0,-73.0,-81.0,-70.0,-76.0,8.0,18.0,5.0,16.0,1
995,F8:59:71:5A:E0:3D,3401893,2188328938,1280389,1919075473,2121504,269253465,283,721544,879024281,720866,878942632,678,81649,710849,1815,1280487,146589,283,1043,144444.0,43333.0,-67.0,-73.0,-63.0,-70.0,-66.0,-72.0,-63.0,-69.0,-73.0,-81.0,-70.0,-76.0,6.0,8.0,7.0,6.0,1
996,CC:2F:71:3F:1F:24,3941124,2670992897,1819616,2401739028,2121508,269253869,2543,1487437,1904139899,1486339,1904015677,1098,124222,1470336,5817,1819371,173305,2543,1762,86667.0,14444.0,-67.0,-64.0,-67.0,-69.0,-67.0,-64.0,-67.0,-69.0,-73.0,-81.0,-70.0,-76.0,6.0,17.0,3.0,7.0,1
997,CC:2F:71:3E:C5:1F,5528394,4451510740,3406885,4182256811,2121509,269253929,502,93168,7996555,78584,6268003,14584,1728552,21522,527,3414271,870674,502,2925,6500.0,1000.0,-65.0,-63.0,-65.0,-60.0,-67.0,-70.0,-65.0,-60.0,-73.0,-81.0,-70.0,-76.0,8.0,18.0,5.0,16.0,1
998,F8:59:71:5A:E0:3D,3402129,2188635885,1280617,1919381692,2121512,269254193,283,721652,879136705,720974,879055056,678,81649,710955,1815,1280715,146664,283,1044,144444.0,43333.0,-66.0,-72.0,-64.0,-71.0,-66.0,-71.0,-63.0,-69.0,-73.0,-81.0,-70.0,-76.0,7.0,9.0,6.0,5.0,1
999,CC:2F:71:3F:1F:24,3941295,2671211578,1819783,2401957385,2121512,269254193,2543,1487592,1904351370,1486494,1904227148,1098,124222,1470490,5817,1819538,173328,2543,1762,86667.0,14444.0,-66.0,-64.0,-67.0,-68.0,-66.0,-64.0,-67.0,-68.0,-73.0,-81.0,-70.0,-76.0,7.0,17.0,3.0,8.0,1
1000,CC:2F:71:3E:C5:1F,5528397,4451511004,3406885,4182256811,2121512,269254193,502,93171,7996813,78586,6268143,14585,1728670,21523,527,3414271,870674,502,2925,6500.0,1000.0,-69.0,-71.0,-67.0,-61.0,-67.0,-69.0,-65.0,-60.0,-73.0,-81.0,-70.0,-76.0,4.0,10.0,3.0,15.0,1
1001,F8:59:71:5A:E0:3D,3402196,2188735656,1280682,1919481261,2121514,269254395,283,721717,879234024,721039,879152375,678,81649,711020,1815,1280779,146682,283,1045,144444.0,1000.0,-66.0,-72.0,-64.0,-70.0,-66.0,-72.0,-63.0,-69.0,-72.0,-80.0,-70.0,-76.0,6.0,8.0,6.0,6.0,1
1002,CC:2F:71:3F:1F:24,3941460,2671424650,1819946,2402170255,2121514,269254395,2543,1487740,1904554784,1486642,1904430562,1098,124222,1470638,5817,1819701,173381,2543,1762,86667.0,14444.0,-67.0,-64.0,-68.0,-69.0,-67.0,-64.0,-69.0,-69.0,-72.0,-80.0,-70.0,-76.0,5.0,16.0,2.0,7.0,1
1003,CC:2F:71:3E:C5:1F,5528403,4451511610,3406885,4182256811,2121518,269254799,502,93171,7996813,78586,6268143,14585,1728670,21523,527,3414271,870674,502,2925,6500.0,1000.0,-69.0,-71.0,-67.0,-61.0,-67.0,-69.0,-65.0,-60.0,-72.0,-80.0,-70.0,-76.0,3.0,9.0,3.0,15.0,1
1004,F8:59:71:5A:E0:3D,3402271,2188837554,1280750,1919582493,2121521,269255061,283,721788,879336176,721110,879254527,678,81649,711089,1815,1280848,146714,283,1045,144444.0,43333.0,-67.0,-72.0,-64.0,-70.0,-66.0,-72.0,-63.0,-70.0,-72.0,-80.0,-70.0,-76.0,5.0,8.0,6.0,6.0,1
1005,CC:2F:71:3F:1F:24,3941626,2671631786,1820105,2402376725,2121521,269255061,2543,1487885,1904754976,1486787,1904630754,1098,124222,1470783,5817,1819859,173445,2543,1763,104000.0,26000.0,-68.0,-64.0,-68.0,-70.0,-67.0,-63.0,-66.0,-69.0,-72.0,-80.0,-70.0,-76.0,4.0,16.0,2.0,6.0,1
1006,CC:2F:71:3E:C5:1F,5528406,4451511872,3406885,4182256811,2121521,269255061,502,93173,7996953,78588,6268283,14585,1728670,21523,527,3414271,870674,502,2925,6500.0,1000.0,-69.0,-71.0,-66.0,-61.0,-67.0,-69.0,-65.0,-60.0,-72.0,-80.0,-70.0,-76.0,3.0,9.0,4.0,15.0,1
1007,F8:59:71:5A:E0:3D,3402341,2188941878,1280818,1919686615,2121523,269255263,283,721856,879436634,721178,879354985,678,81649,711155,1815,1280916,146737,283,1045,144444.0,43333.0,-66.0,-72.0,-63.0,-69.0,-66.0,-72.0,-63.0,-69.0,-72.0,-80.0,-70.0,-76.0,6.0,8.0,7.0,7.0,1
1008,CC:2F:71:3F:1F:24,3941809,2671852973,1820286,2402597710,2121523,269255263,2543,1488056,1904969104,1486958,1904844882,1098,124222,1470954,5817,1820040,173569,2543,1763,86667.0,1000.0,-68.0,-64.0,-67.0,-71.0,-66.0,-63.0,-66.0,-69.0,-72.0,-80.0,-70.0,-76.0,4.0,16.0,3.0,5.0,1
1009,CC:2F:71:3E:C5:1F,5528408,4451512074,3406885,4182256811,2121523,269255263,502,93173,7996953,78588,6268283,14585,1728670,21523,527,3414271,870674,502,2925,6500.0,1000.0,-69.0,-71.0,-66.0,-61.0,-67.0,-69.0,-65.0,-60.0,-72.0,-80.0,-70.0,-76.0,3.0,9.0,4.0,15.0,1
1010,F8:59:71:5A:E0:3D,3402412,2189042213,1280882,1919786071,2121530,269256142,283,721921,879536734,721243,879455085,678,81649,711220,1815,1280980,146751,283,1045,144444.0,43333.0,-66.0,-72.0,-64.0,-70.0,-66.0,-72.0,-63.0,-69.0,-72.0,-80.0,-70.0,-76.0,6.0,8.0,6.0,6.0,1
1011,CC:2F:71:3F:1F:24,3941978,2672064984,1820448,2402808842,2121530,269256142,2543,1488204,1905171054,1487106,1905046832,1098,124222,1471101,5817,1820204,173649,2543,1763,86667.0,14444.0,-67.0,-64.0,-67.0,-71.0,-67.0,-64.0,-67.0,-69.0,-72.0,-80.0,-70.0,-76.0,5.0,16.0,3.0,5.0,1
1012,CC:2F:71:3E:C5:1F,5528415,4451512953,3406885,4182256811,2121530,269256142,502,93173,7996953,78588,6268283,14585,1728670,21523,527,3414271,870674,502,2925,6500.0,1000.0,-69.0,-71.0,-66.0,-61.0,-67.0,-69.0,-65.0,-60.0,-72.0,-80.0,-70.0,-76.0,3.0,9.0,4.0,15.0,1
1013,F8:59:71:5A:E0:3D,3402645,2189381470,1281112,1920125066,2121533,269256404,283,722042,879655396,721364,879573747,678,81649,711341,1815,1281206,146805,283,1045,144444.0,43333.0,-67.0,-73.0,-63.0,-70.0,-66.0,-72.0,-63.0,-69.0,-72.0,-80.0,-70.0,-76.0,5.0,7.0,7.0,6.0,1
1014,CC:2F:71:3F:1F:24,3942142,2672275328,1820609,2403018924,2121533,269256404,2543,1488353,1905374530,1487255,1905250308,1098,124222,1471250,5817,1820365,173681,2543,1763,86667.0,14444.0,-67.0,-64.0,-66.0,-70.0,-66.0,-63.0,-66.0,-69.0,-72.0,-80.0,-70.0,-76.0,5.0,16.0,4.0,6.0,1
1015,CC:2F:71:3E:C5:1F,5528418,4451513215,3406885,4182256811,2121533,269256404,502,93173,7996953,78588,6268283,14585,1728670,21523,527,3414271,870674,502,2925,6500.0,1000.0,-69.0,-71.0,-66.0,-61.0,-67.0,-69.0,-65.0,-60.0,-72.0,-80.0,-70.0,-76.0,3.0,9.0,4.0,15.0,1
1016,F8:59:71:5A:E0:3D,3402970,2189875260,1281429,1920617882,2121541,269257378,283,722181,879768817,721503,879687168,678,81649,711480,1815,1281527,146957,283,1045,144444.0,43333.0,-67.0,-73.0,-64.0,-70.0,-66.0,-72.0,-63.0,-69.0,-72.0,-80.0,-70.0,-76.0,5.0,7.0,6.0,6.0,1
1017,CC:2F:71:3F:1F:24,3942319,2672492997,1820778,2403235619,2121541,269257378,2543,1488509,1905584540,1487411,1905460318,1098,124222,1471406,5817,1820534,173764,2543,1763,65000.0,13000.0,-68.0,-64.0,-67.0,-70.0,-67.0,-63.0,-66.0,-69.0,-72.0,-80.0,-69.0,-75.0,4.0,16.0,2.0,5.0,1
1018,CC:2F:71:3E:C5:1F,5528426,4451514189,3406885,4182256811,2121541,269257378,502,93173,7996953,78588,6268283,14585,1728670,21523,527,3414271,870674,502,2925,6500.0,1000.0,-69.0,-71.0,-66.0,-61.0,-67.0,-69.0,-65.0,-60.0,-72.0,-80.0,-69.0,-75.0,3.0,9.0,3.0,14.0,1
1019,F8:59:71:5A:E0:3D,3403037,2189976472,1281494,1920718892,2121543,269257580,283,722246,879868917,721568,879787268,678,81649,711545,1815,1281592,146976,283,1045,144444.0,43333.0,-67.0,-72.0,-63.0,-69.0,-66.0,-72.0,-63.0,-69.0,-72.0,-80.0,-69.0,-75.0,5.0,8.0,6.0,6.0,1
1020,CC:2F:71:3F:1F:24,3942481,2672701727,1820938,2403444147,2121543,269257580,2543,1488654,1905784704,1487556,1905660482,1098,124222,1471551,5817,1820694,173816,2543,1763,86667.0,14444.0,-67.0,-64.0,-67.0,-69.0,-66.0,-63.0,-66.0,-69.0,-72.0,-80.0,-69.0,-75.0,5.0,16.0,2.0,6.0,1
1021,CC:2F:71:3E:C5:1F,5528428,4451514391,3406885,4182256811,2121543,269257580,502,93173,7996953,78588,6268283,14585,1728670,21523,527,3414271,870674,502,2925,6500.0,1000.0,-69.0,-71.0,-66.0,-61.0,-67.0,-69.0,-65.0,-60.0,-72.0,-80.0,-69.0,-75.0,3.0,9.0,3.0,14.0,1
1022,F8:59:71:5A:E0:3D,3403107,2190074928,1281557,1920816682,2121550,269258246,283,722309,879965937,721631,879884288,678,81649,711608,1815,1281655,146993,283,1045,144444.0,43333.0,-66.0,-72.0,-64.0,-70.0,-66.0,-72.0,-63.0,-69.0,-72.0,-80.0,-69.0,-75.0,6.0,8.0,5.0,5.0,1
1023,CC:2F:71:3F:1F:24,3942647,2672909199,1821097,2403650953,2121550,269258246,2543,1488800,1905984984,1487702,1905860762,1098,124222,1471697,5817,1820853,173880,2543,1763,86667.0,14444.0,-67.0,-63.0,-66.0,-69.0,-67.0,-63.0,-66.0,-69.0,-72.0,-80.0,-69.0,-75.0,5.0,17.0,3.0,6.0,1
1024,CC:2F:71:3E:C5:1F,5528435,4451515057,3406885,4182256811,2121550,269258246,502,93173,7996953,78588,6268283,14585,1728670,21523,528,3414272,870675,502,2925,6500.0,1000.0,-69.0,-71.0,-66.0,-61.0,-67.0,-69.0,-65.0,-60.0,-72.0,-80.0,-69.0,-75.0,3.0,9.0,3.0,14.0,1
1025,F8:59:71:5A:E0:3D,3403173,2190177268,1281623,1920919022,2121550,269258246,283,722374,880066093,721696,879984444,678,81649,711673,1815,1281721,147017,283,1045,144444.0,43333.0,-67.0,-72.0,-63.0,-70.0,-66.0,-72.0,-64.0,-70.0,-72.0,-80.0,-70.0,-75.0,5.0,8.0,7.0,5.0,1
1026,CC:2F:71:3F:1F:24,3942824,2673126496,1821274,2403868250,2121550,269258246,2543,1488960,1906190456,1487862,1906066234,1098,124222,1471857,5817,1821030,173965,2543,1763,86667.0,14444.0,-67.0,-64.0,-66.0,-69.0,-67.0,-63.0,-67.0,-69.0,-72.0,-80.0,-70.0,-75.0,5.0,16.0,4.0,6.0,1
1027,CC:2F:71:3E:C5:1F,5528437,4451515259,3406885,4182256811,2121552,269258448,502,93173,7996953,78588,6268283,14585,1728670,21523,528,3414272,870675,502,2925,6500.0,1000.0,-69.0,-71.0,-66.0,-61.0,-67.0,-69.0,-65.0,-60.0,-72.0,-80.0,-70.0,-75.0,3.0,9.0,4.0,14.0,1
1028,F8:59:71:5A:E0:3D,3403473,2190594086,1281915,1921335032,2121558,269259054,283,722483,880173108,721805,880091459,678,81649,711782,1815,1282013,147192,283,1045,144444.0,43333.0,-67.0,-72.0,-63.0,-69.0,-66.0,-72.0,-63.0,-69.0,-72.0,-80.0,-70.0,-75.0,5.0,8.0,7.0,6.0,1
1029,CC:2F:71:3F:1F:24,3942985,2673325818,1821427,2404066764,2121558,269259054,2543,1489107,1906392276,1488009,1906268054,1098,124222,1472004,5817,1821182,174056,2543,1763,78000.0,13000.0,-68.0,-64.0,-67.0,-70.0,-67.0,-63.0,-67.0,-69.0,-72.0,-80.0,-70.0,-75.0,4.0,16.0,3.0,5.0,1
1030,CC:2F:71:3E:C5:1F,5528443,4451515865,3406885,4182256811,2121558,269259054,502,93173,7996953,78588,6268283,14585,1728670,21523,528,3414272,870675,502,2925,6500.0,1000.0,-69.0,-71.0,-66.0,-61.0,-67.0,-69.0,-65.0,-60.0,-72.0,-80.0,-70.0,-75.0,3.0,9.0,4.0,14.0,1
1031,F8:59:71:5A:E0:3D,3403542,2190699706,1281983,1921440592,2121559,269259114,283,722551,880277926,721873,880196277,678,81649,711849,1815,1282080,147208,283,1045,144444.0,43333.0,-66.0,-72.0,-64.0,-70.0,-66.0,-72.0,-63.0,-69.0,-72.0,-80.0,-70.0,-75.0,6.0,8.0,6.0,5.0,1
1032,CC:2F:71:3F:1F:24,3943158,2673553070,1821599,2404293956,2121559,269259114,2543,1489261,1906600672,1488163,1906476450,1098,124222,1472157,5817,1821355,174116,2543,1763,86667.0,14444.0,-67.0,-64.0,-67.0,-70.0,-67.0,-63.0,-66.0,-69.0,-72.0,-80.0,-70.0,-75.0,5.0,16.0,3.0,5.0,1
1033,CC:2F:71:3E:C5:1F,5528444,4451515925,3406885,4182256811,2121559,269259114,502,93173,7996953,78588,6268283,14585,1728670,21523,528,3414272,870675,502,2925,6500.0,1000.0,-69.0,-71.0,-66.0,-61.0,-67.0,-69.0,-65.0,-60.0,-72.0,-80.0,-70.0,-75.0,3.0,9.0,4.0,14.0,1
1034,F8:59:71:5A:E0:3D,3403613,2190801322,1282048,1921541602,2121565,269259720,283,722614,880374946,721936,880293297,678,81649,711912,1815,1282146,147224,283,1045,144444.0,43333.0,-66.0,-72.0,-64.0,-70.0,-66.0,-72.0,-63.0,-69.0,-72.0,-80.0,-70.0,-76.0,6.0,8.0,6.0,6.0,1
1035,CC:2F:71:3F:1F:24,3943325,2673762164,1821758,2404502242,2121567,269259922,2543,1489411,1906807112,1488313,1906682890,1098,124222,1472307,5817,1821513,174224,2543,1763,78000.0,13000.0,-67.0,-64.0,-67.0,-70.0,-67.0,-63.0,-67.0,-69.0,-72.0,-80.0,-70.0,-76.0,5.0,16.0,3.0,6.0,1
1036,CC:2F:71:3E:C5:1F,5528452,4451516733,3406885,4182256811,2121567,269259922,502,93173,7996953,78588,6268283,14585,1728670,21523,528,3414272,870675,502,2925,6500.0,1000.0,-69.0,-71.0,-66.0,-61.0,-67.0,-69.0,-65.0,-60.0,-72.0,-80.0,-70.0,-76.0,3.0,9.0,4.0,15.0,1
1037,F8:59:71:5A:E0:3D,3403808,2191085922,1282234,1921825334,2121574,269260588,283,722767,880572664,722089,880491015,678,81649,712065,1815,1282326,147283,283,1045,144444.0,43333.0,-67.0,-73.0,-63.0,-70.0,-66.0,-72.0,-63.0,-69.0,-72.0,-80.0,-70.0,-76.0,5.0,7.0,7.0,6.0,1
1038,CC:2F:71:3F:1F:24,3943691,2674270274,1822115,2405009484,2121576,269260790,2552,1489780,1907322556,1488682,1907198334,1098,124222,1472665,5817,1821872,174702,2552,1763,78000.0,13000.0,-67.0,-64.0,-67.0,-70.0,-67.0,-63.0,-66.0,-69.0,-72.0,-80.0,-70.0,-76.0,5.0,16.0,3.0,6.0,1
1039,CC:2F:71:3E:C5:1F,5528461,4451517601,3406885,4182256811,2121576,269260790,502,93173,7996953,78588,6268283,14585,1728670,21523,528,3414272,870675,502,2925,6500.0,1000.0,-69.0,-71.0,-66.0,-61.0,-67.0,-69.0,-65.0,-60.0,-72.0,-80.0,-70.0,-76.0,3.0,9.0,4.0,15.0,1
1040,F8:59:71:5A:E0:3D,3404066,2191480031,1282488,1922219039,2121578,269260992,283,722905,880745982,722227,880664333,678,81649,712203,1815,1282586,147373,283,1045,144444.0,43333.0,-66.0,-72.0,-64.0,-70.0,-66.0,-72.0,-63.0,-69.0,-72.0,-80.0,-70.0,-76.0,6.0,8.0,6.0,6.0,1
1041,CC:2F:71:3F:1F:24,3943869,2674503140,1822291,2405242148,2121578,269260992,2552,1489932,1907530652,1488834,1907406430,1098,124222,1472817,5817,1822048,174821,2552,1763,72222.0,21667.0,-66.0,-64.0,-67.0,-70.0,-67.0,-64.0,-67.0,-69.0,-72.0,-80.0,-70.0,-76.0,6.0,16.0,3.0,6.0,1
1042,CC:2F:71:3E:C5:1F,5528463,4451517803,3406885,4182256811,2121578,269260992,502,93173,7996953,78588,6268283,14585,1728670,21523,528,3414272,870675,502,2925,6500.0,1000.0,-69.0,-71.0,-66.0,-61.0,-67.0,-69.0,-65.0,-60.0,-72.0,-80.0,-70.0,-76.0,3.0,9.0,4.0,15.0,1
1043,F8:59:71:5A:E0:3D,3404143,2191585161,1282558,1922323503,2121585,269261658,283,722977,880853055,722299,880771406,678,81649,712275,1815,1282656,147400,283,1045,144444.0,43333.0,-66.0,-72.0,-64.0,-70.0,-66.0,-72.0,-63.0,-69.0,-72.0,-80.0,-70.0,-76.0,6.0,8.0,6.0,6.0,1
1044,CC:2F:71:3F:1F:24,3944039,2674716660,1822454,2405455002,2121585,269261658,2552,1490079,1907733896,1488981,1907609674,1098,124222,1472964,5817,1822210,174887,2552,1763,72222.0,21667.0,-67.0,-64.0,-68.0,-70.0,-66.0,-64.0,-67.0,-70.0,-72.0,-80.0,-70.0,-76.0,5.0,16.0,2.0,6.0,1
1045,CC:2F:71:3E:C5:1F,5528470,4451518469,3406885,4182256811,2121585,269261658,502,93173,7996953,78588,6268283,14585,1728670,21523,528,3414272,870675,502,2925,6500.0,1000.0,-69.0,-71.0,-66.0,-61.0,-67.0,-69.0,-65.0,-60.0,-72.0,-80.0,-70.0,-76.0,3.0,9.0,4.0,15.0,1
1046,F8:59:71:5A:E0:3D,3404206,2191682895,1282621,1922421237,2121585,269261658,283,723036,880943915,722358,880862266,678,81649,712334,1815,1282719,147426,283,1045,144444.0,39000.0,-67.0,-73.0,-63.0,-69.0,-66.0,-72.0,-63.0,-69.0,-72.0,-80.0,-70.0,-76.0,5.0,7.0,7.0,7.0,1
1047,CC:2F:71:3F:1F:24,3944200,2674925237,1822614,2405663306,2121586,269261931,2552,1490224,1907932636,1489126,1907808414,1098,124222,1473109,5817,1822370,174970,2552,1763,72222.0,21667.0,-67.0,-64.0,-68.0,-70.0,-67.0,-63.0,-67.0,-69.0,-72.0,-80.0,-70.0,-76.0,5.0,16.0,2.0,6.0,1
1048,CC:2F:71:3E:C5:1F,5528473,4451518944,3406885,4182256811,2121588,269262133,502,93173,7996953,78588,6268283,14585,1728670,21523,528,3414272,870675,502,2925,6500.0,1000.0,-69.0,-71.0,-66.0,-61.0,-67.0,-69.0,-65.0,-60.0,-72.0,-80.0,-70.0,-76.0,3.0,9.0,4.0,15.0,1
1049,F8:59:71:5A:E0:3D,3404369,2191888959,1282774,1922626160,2121595,269262799,283,723136,881062678,722458,880981029,678,81649,712434,1815,1282872,147446,283,1045,144444.0,43333.0,-66.0,-73.0,-62.0,-69.0,-66.0,-72.0,-62.0,-69.0,-72.0,-80.0,-70.0,-76.0,6.0,7.0,8.0,7.0,1
1050,CC:2F:71:3F:1F:24,3944376,2675145287,1822781,2405882488,2121595,269262799,2552,1490378,1908146674,1489280,1908022452,1098,124222,1473262,5817,1822535,175032,2552,1763,86667.0,14444.0,-67.0,-63.0,-67.0,-68.0,-67.0,-63.0,-67.0,-69.0,-72.0,-81.0,-70.0,-76.0,5.0,18.0,3.0,8.0,1
1051,CC:2F:71:3E:C5:1F,5528480,4451519610,3406885,4182256811,2121595,269262799,502,93173,7996953,78588,6268283,14585,1728670,21523,528,3414272,870675,502,2925,6500.0,1000.0,-69.0,-71.0,-66.0,-61.0,-67.0,-69.0,-65.0,-60.0,-72.0,-81.0,-70.0,-76.0,3.0,10.0,4.0,15.0,1
1052,F8:59:71:5A:E0:3D,3404547,2192156810,1282950,1922893809,2121597,269263001,283,723220,881167458,722542,881085809,678,81649,712518,1815,1283047,147468,283,1045,144444.0,43333.0,-67.0,-73.0,-63.0,-70.0,-66.0,-72.0,-62.0,-69.0,-72.0,-81.0,-70.0,-76.0,5.0,8.0,7.0,6.0,1
1053,CC:2F:71:3F:1F:24,3944581,2675414599,1822982,2406151396,2121599,269263203,2552,1490592,1908447580,1489494,1908323358,1098,124222,1473476,5817,1822735,175342,2552,1763,65000.0,19500.0,-67.0,-64.0,-67.0,-69.0,-66.0,-63.0,-66.0,-68.0,-72.0,-81.0,-70.0,-76.0,5.0,17.0,3.0,7.0,1
1054,CC:2F:71:3E:C5:1F,5528487,4451520332,3406886,4182256927,2121601,269263405,502,93173,7996953,78588,6268283,14585,1728670,21523,528,3414273,870675,502,2925,6500.0,1000.0,-69.0,-71.0,-66.0,-61.0,-67.0,-69.0,-65.0,-60.0,-72.0,-81.0,-70.0,-76.0,3.0,10.0,4.0,15.0,1
1055,F8:59:71:5A:E0:3D,3404788,2192504170,1283174,1923239571,2121614,269264599,283,723282,881261400,722603,881179633,679,81767,712555,1815,1283272,147699,283,1048,144444.0,43333.0,-65.0,-72.0,-64.0,-70.0,-65.0,-72.0,-62.0,-69.0,-72.0,-81.0,-70.0,-76.0,7.0,9.0,6.0,6.0,1
1056,CC:2F:71:3F:1F:24,3944909,2675846562,1823295,2406581963,2121614,269264599,2552,1491122,1909218907,1490023,1909094567,1099,124340,1474003,5823,1823048,175678,2552,1763,5500.0,1000.0,-67.0,-63.0,-66.0,-68.0,-66.0,-63.0,-66.0,-68.0,-72.0,-81.0,-70.0,-76.0,5.0,18.0,4.0,8.0,1
1057,CC:2F:71:3E:C5:1F,5528505,4451521990,3406886,4182256927,2121619,269265063,502,93173,7996953,78588,6268283,14585,1728670,21523,528,3414273,870675,502,2925,6500.0,1000.0,-69.0,-71.0,-66.0,-61.0,-67.0,-69.0,-65.0,-60.0,-72.0,-81.0,-70.0,-76.0,3.0,10.0,4.0,15.0,1
1058,F8:59:71:5A:E0:3D,3404932,2192712688,1283309,1923447221,2121623,269265467,283,723363,881386117,722684,881304350,679,81767,712624,1815,1283403,147919,283,1050,144444.0,1000.0,-68.0,-73.0,-64.0,-71.0,-65.0,-71.0,-62.0,-68.0,-72.0,-81.0,-70.0,-76.0,4.0,8.0,6.0,5.0,1
1059,CC:2F:71:3F:1F:24,3945120,2676108273,1823497,2406842806,2121623,269265467,2552,1491353,1909544671,1490254,1909420331,1099,124340,1474233,5837,1823255,175692,2552,1763,5500.0,1000.0,-66.0,-64.0,-66.0,-69.0,-66.0,-63.0,-66.0,-68.0,-72.0,-81.0,-70.0,-76.0,6.0,17.0,4.0,7.0,1
1060,CC:2F:71:3E:C5:1F,5528509,4451522394,3406886,4182256927,2121623,269265467,502,93173,7996953,78588,6268283,14585,1728670,21523,528,3414273,870675,502,2925,6500.0,1000.0,-69.0,-71.0,-66.0,-61.0,-67.0,-69.0,-65.0,-60.0,-72.0,-81.0,-70.0,-76.0,3.0,10.0,4.0,15.0,1
1061,F8:59:71:5A:E0:3D,3405033,2192857204,1283404,1923591131,2121629,269266073,283,723388,881424917,722709,881343150,679,81767,712645,1815,1283501,147995,283,1054,130000.0,43333.0,-64.0,-71.0,-62.0,-69.0,-65.0,-71.0,-62.0,-69.0,-72.0,-81.0,-70.0,-76.0,8.0,10.0,8.0,7.0,1
1062,CC:2F:71:3F:1F:24,3945309,2676309903,1823677,2407043568,2121632,269266335,2552,1491607,1909863985,1490508,1909739645,1099,124340,1474487,5859,1823434,175730,2552,1763,5500.0,1000.0,-67.0,-64.0,-67.0,-70.0,-66.0,-63.0,-66.0,-69.0,-72.0,-81.0,-70.0,-76.0,5.0,17.0,3.0,6.0,1
1063,CC:2F:71:3E:C5:1F,5528518,4451523262,3406886,4182256927,2121632,269266335,502,93173,7996953,78588,6268283,14585,1728670,21523,528,3414273,870675,502,2925,6500.0,1000.0,-69.0,-71.0,-66.0,-61.0,-67.0,-69.0,-65.0,-60.0,-72.0,-81.0,-70.0,-76.0,3.0,10.0,4.0,15.0,1
1064,F8:59:71:5A:E0:3D,3405288,2193234840,1283656,1923968505,2121632,269266335,283,723434,881490691,722755,881408924,679,81767,712679,1815,1283752,148150,283,1054,130000.0,1000.0,-65.0,-72.0,-63.0,-68.0,-65.0,-71.0,-62.0,-68.0,-72.0,-81.0,-70.0,-76.0,7.0,9.0,7.0,8.0,1
1065,CC:2F:71:3F:1F:24,3945484,2676526640,1823848,2407259901,2121636,269266739,2552,1491829,1910167328,1490730,1910042988,1099,124340,1474709,5872,1823601,175746,2552,1763,6500.0,1000.0,-69.0,-64.0,-73.0,-71.0,-67.0,-63.0,-67.0,-69.0,-72.0,-81.0,-70.0,-76.0,3.0,17.0,-3.0,5.0,1
1066,CC:2F:71:3E:C5:1F,5528525,4451523930,3406886,4182256927,2121639,269267003,502,93174,7997071,78588,6268283,14586,1728788,21524,528,3414273,870675,502,2925,6500.0,1000.0,-71.0,-72.0,-70.0,-61.0,-68.0,-70.0,-66.0,-60.0,-72.0,-81.0,-70.0,-76.0,1.0,9.0,0.0,15.0,1
1067,F8:59:71:5A:E0:3D,3405901,2194118699,1284250,1924850353,2121651,269268346,283,723714,881746250,723035,881664483,679,81767,712916,1815,1284347,148535,283,1056,130000.0,39000.0,-65.0,-72.0,-62.0,-68.0,-65.0,-70.0,-62.0,-68.0,-73.0,-81.0,-70.0,-76.0,8.0,9.0,8.0,8.0,1
1068,CC:2F:71:3F:1F:24,3945886,2677048220,1824235,2407779874,2121651,269268346,2552,1492314,1910852870,1491215,1910728530,1099,124340,1475185,5900,1823991,175801,2552,1763,5500.0,1000.0,-66.0,-63.0,-65.0,-69.0,-66.0,-63.0,-66.0,-69.0,-73.0,-81.0,-70.0,-76.0,7.0,18.0,5.0,7.0,1
1069,CC:2F:71:3E:C5:1F,5528537,4451525273,3406886,4182256927,2121651,269268346,502,93174,7997071,78588,6268283,14586,1728788,21524,528,3414273,870675,502,2925,6500.0,1000.0,-71.0,-72.0,-70.0,-61.0,-68.0,-70.0,-66.0,-60.0,-73.0,-81.0,-70.0,-76.0,2.0,9.0,0.0,15.0,1
1070,F8:59:71:5A:E0:3D,3406023,2194296675,1284365,1925027663,2121658,269269012,283,723761,881819078,723082,881737311,679,81767,712940,1815,1284468,148703,283,1057,130000.0,39000.0,-65.0,-71.0,-62.0,-68.0,-66.0,-72.0,-62.0,-69.0,-73.0,-81.0,-70.0,-76.0,8.0,10.0,8.0,8.0,1
1071,CC:2F:71:3F:1F:24,3946040,2677231339,1824382,2407962327,2121658,269269012,2552,1492522,1911143407,1491423,1911019067,1099,124340,1475393,5911,1824140,175812,2552,1763,5500.0,1000.0,-66.0,-63.0,-65.0,-68.0,-66.0,-63.0,-66.0,-68.0,-73.0,-81.0,-70.0,-76.0,7.0,18.0,5.0,8.0,1
1072,CC:2F:71:3E:C5:1F,5528546,4451526141,3406886,4182256927,2121660,269269214,502,93174,7997071,78588,6268283,14586,1728788,21524,528,3414273,870675,502,2925,6500.0,1000.0,-71.0,-72.0,-70.0,-61.0,-68.0,-70.0,-66.0,-60.0,-73.0,-81.0,-70.0,-76.0,2.0,9.0,0.0,15.0,1
1073,F8:59:71:5A:E0:3D,3406123,2194442387,1284461,1925172971,2121662,269269416,283,723803,881881895,723124,881800128,679,81767,712958,1815,1284563,148792,283,1058,130000.0,39000.0,-65.0,-72.0,-63.0,-69.0,-65.0,-71.0,-61.0,-68.0,-74.0,-82.0,-71.0,-77.0,9.0,10.0,8.0,8.0,1
1074,CC:2F:71:3F:1F:24,3946189,2677409375,1824525,2408139757,2121664,269269618,2552,1492739,1911446201,1491640,1911321861,1099,124340,1475609,5923,1824282,175843,2552,1763,5500.0,1000.0,-67.0,-64.0,-66.0,-69.0,-66.0,-63.0,-65.0,-68.0,-74.0,-82.0,-71.0,-77.0,7.0,18.0,5.0,8.0,1
1075,CC:2F:71:3E:C5:1F,5528550,4451526545,3406886,4182256927,2121664,269269618,502,93174,7997071,78588,6268283,14586,1728788,21524,528,3414273,870675,502,2925,6500.0,1000.0,-71.0,-72.0,-70.0,-61.0,-68.0,-70.0,-66.0,-60.0,-74.0,-82.0,-71.0,-77.0,3.0,10.0,1.0,16.0,1
1076,F8:59:71:5A:E0:3D,3406217,2194572771,1284548,1925302689,2121669,269270082,283,723840,881937009,723161,881855242,679,81767,712980,1815,1284650,148876,283,1059,130000.0,1000.0,-64.0,-71.0,-62.0,-69.0,-65.0,-71.0,-62.0,-68.0,-73.0,-81.0,-71.0,-77.0,9.0,10.0,9.0,8.0,1
1077,CC:2F:71:3F:1F:24,3946327,2677569857,1824658,2408299775,2121669,269270082,2552,1492922,1911697793,1491823,1911573453,1099,124340,1475792,5933,1824416,175853,2552,1763,5500.0,1000.0,-69.0,-64.0,-72.0,-71.0,-67.0,-63.0,-67.0,-69.0,-73.0,-81.0,-71.0,-77.0,4.0,17.0,-1.0,6.0,1
1078,CC:2F:71:3E:C5:1F,5528555,4451527009,3406886,4182256927,2121669,269270082,502,93174,7997071,78588,6268283,14586,1728788,21524,528,3414274,870675,502,2925,6500.0,1000.0,-71.0,-72.0,-70.0,-61.0,-68.0,-70.0,-66.0,-60.0,-73.0,-81.0,-71.0,-77.0,2.0,9.0,1.0,16.0,1
1079,F8:59:71:5A:E0:3D,3406700,2195296327,1285014,1926024569,2121686,269271758,283,724019,882134819,723340,882053052,679,81767,713098,1815,1285105,149570,283,1061,65000.0,1000.0,-68.0,-73.0,-65.0,-71.0,-66.0,-72.0,-63.0,-70.0,-74.0,-81.0,-72.0,-78.0,6.0,8.0,7.0,7.0,1
1080,CC:2F:71:3F:1F:24,3946897,2678290638,1825202,2409018012,2121695,269272626,2552,1493793,1912946815,1492694,1912822475,1099,124340,1476646,5994,1824956,175945,2552,1764,5500.0,1000.0,-67.0,-64.0,-66.0,-68.0,-66.0,-63.0,-65.0,-67.0,-74.0,-81.0,-72.0,-78.0,7.0,17.0,6.0,10.0,1
1081,CC:2F:71:3E:C5:1F,5528600,4451531562,3406886,4182256927,2121714,269274635,502,93174,7997071,78588,6268283,14586,1728788,21524,528,3414274,870675,502,2925,6500.0,1000.0,-71.0,-72.0,-70.0,-61.0,-68.0,-70.0,-66.0,-60.0,-74.0,-81.0,-72.0,-77.0,3.0,9.0,2.0,16.0,1
1082,F8:59:71:5A:E0:3D,3407238,2196029107,1285504,1926752450,2121734,269276657,294,724148,882316266,723469,882234499,679,81767,713179,1840,1285619,150228,294,1064,7222.0,1000.0,-65.0,-71.0,-62.0,-70.0,-65.0,-71.0,-62.0,-69.0,-74.0,-81.0,-72.0,-77.0,9.0,10.0,10.0,7.0,1
1083,CC:2F:71:3F:1F:24,3947608,2679256127,1825872,2409979268,2121736,269276859,2552,1494608,1914161451,1493506,1914036793,1102,124658,1477453,6046,1825631,176045,2552,1766,5500.0,1000.0,-67.0,-64.0,-66.0,-68.0,-67.0,-64.0,-66.0,-68.0,-74.0,-81.0,-72.0,-77.0,7.0,17.0,6.0,9.0,1
1084,CC:2F:71:3E:C5:1F,5528623,4451533902,3406887,4182257043,2121736,269276859,502,93174,7997071,78588,6268283,14586,1728788,21524,528,3414275,870676,502,2925,6500.0,1000.0,-71.0,-72.0,-70.0,-61.0,-68.0,-70.0,-66.0,-60.0,-74.0,-81.0,-72.0,-77.0,3.0,9.0,2.0,16.0,1
1085,F8:59:71:5A:E0:3D,3409069,2198640683,1287298,1929360426,2121771,269280257,294,725307,883462674,724627,883380789,680,81885,714306,1840,1287409,151158,294,1070,72222.0,21667.0,-66.0,-71.0,-63.0,-70.0,-66.0,-71.0,-62.0,-69.0,-74.0,-81.0,-72.0,-77.0,8.0,10.0,9.0,7.0,1
1086,CC:2F:71:3F:1F:24,3948982,2681193460,1827208,2411912728,2121774,269280732,2565,1496005,1916179918,1494903,1916055260,1102,124658,1478796,6082,1826968,176362,2565,1767,65000.0,19500.0,-67.0,-64.0,-66.0,-68.0,-67.0,-63.0,-66.0,-68.0,-74.0,-81.0,-72.0,-77.0,7.0,17.0,6.0,9.0,1
1087,CC:2F:71:3E:C5:1F,5528663,4451537977,3406887,4182257043,2121776,269280934,502,93174,7997071,78588,6268283,14586,1728788,21524,528,3414275,870676,502,2925,6500.0,1000.0,-71.0,-72.0,-70.0,-61.0,-68.0,-70.0,-66.0,-60.0,-74.0,-81.0,-72.0,-77.0,3.0,9.0,2.0,16.0,1
1088,F8:59:71:5A:E0:3D,3409726,2199614442,1287942,1930332780,2121784,269281662,294,725646,883826858,724966,883744973,680,81885,714637,1840,1288057,151561,294,1072,115556.0,26000.0,-66.0,-73.0,-65.0,-71.0,-66.0,-72.0,-63.0,-70.0,-74.0,-81.0,-72.0,-77.0,8.0,8.0,7.0,6.0,1
1089,CC:2F:71:3F:1F:24,3949447,2681850004,1827662,2412568280,2121785,269281724,2565,1496478,1916871358,1495375,1916746582,1103,124776,1479269,6082,1827423,176589,2565,1767,65000.0,21667.0,-68.0,-64.0,-67.0,-69.0,-67.0,-63.0,-66.0,-69.0,-74.0,-81.0,-72.0,-77.0,6.0,17.0,5.0,8.0,1
1090,CC:2F:71:3E:C5:1F,5528672,4451538767,3406887,4182257043,2121785,269281724,502,93175,7997189,78588,6268283,14587,1728906,21525,528,3414275,870676,502,2926,6500.0,1000.0,-69.0,-72.0,-66.0,-61.0,-68.0,-70.0,-66.0,-60.0,-74.0,-81.0,-72.0,-77.0,5.0,9.0,6.0,16.0,1
1091,F8:59:71:5A:E0:3D,3409873,2199821123,1288081,1930538733,2121792,269282390,294,726459,885081380,725779,884999495,680,81885,715450,1840,1288194,151603,294,1072,130000.0,43333.0,-66.0,-72.0,-64.0,-70.0,-66.0,-72.0,-63.0,-69.0,-74.0,-81.0,-72.0,-77.0,8.0,9.0,8.0,7.0,1
1092,CC:2F:71:3F:1F:24,3950473,2683391225,1828679,2414108633,2121794,269282592,2565,1496773,1917297397,1495670,1917172621,1103,124776,1479564,6082,1828387,177104,2565,1767,65000.0,21667.0,-68.0,-63.0,-67.0,-69.0,-67.0,-63.0,-67.0,-69.0,-74.0,-81.0,-72.0,-77.0,6.0,18.0,5.0,8.0,1
1093,CC:2F:71:3E:C5:1F,5528681,4451539635,3406887,4182257043,2121794,269282592,502,93175,7997189,78588,6268283,14587,1728906,21525,528,3414275,870676,502,2926,6500.0,1000.0,-69.0,-72.0,-66.0,-61.0,-68.0,-70.0,-66.0,-60.0,-74.0,-81.0,-72.0,-77.0,5.0,9.0,6.0,16.0,1
1094,F8:59:71:5A:E0:3D,3410386,2200576296,1288588,1931293300,2121798,269282996,294,727131,885966439,726451,885884554,680,81885,716122,1840,1288703,151721,294,1073,144444.0,43333.0,-66.0,-72.0,-63.0,-70.0,-66.0,-72.0,-62.0,-69.0,-74.0,-81.0,-72.0,-77.0,8.0,9.0,9.0,7.0,1
1095,CC:2F:71:3F:1F:24,3951054,2684244645,1829254,2414961447,2121800,269283198,2565,1496992,1917611773,1495889,1917486997,1103,124776,1479781,6082,1829015,177661,2565,1770,86667.0,13000.0,-68.0,-64.0,-67.0,-69.0,-67.0,-63.0,-67.0,-69.0,-74.0,-81.0,-72.0,-77.0,6.0,17.0,5.0,8.0,1
1096,CC:2F:71:3E:C5:1F,5528687,4451540241,3406887,4182257043,2121800,269283198,502,93175,7997189,78588,6268283,14587,1728906,21525,528,3414275,870676,502,2926,6500.0,1000.0,-69.0,-72.0,-66.0,-61.0,-68.0,-70.0,-66.0,-60.0,-74.0,-81.0,-72.0,-77.0,5.0,9.0,6.0,16.0,1
1097,F8:59:71:5A:E0:3D,3410589,2200882361,1288786,1931598901,2121803,269283460,294,727232,886071241,726552,885989356,680,81885,716223,1840,1288902,151747,294,1073,144444.0,43333.0,-67.0,-73.0,-63.0,-70.0,-66.0,-72.0,-63.0,-69.0,-74.0,-81.0,-72.0,-77.0,7.0,8.0,9.0,7.0,1
1098,CC:2F:71:3F:1F:24,3951235,2684462608,1829430,2415178946,2121805,269283662,2565,1497151,1917819235,1496048,1917694459,1103,124776,1479940,6082,1829189,177730,2565,1770,86667.0,14444.0,-67.0,-64.0,-66.0,-70.0,-67.0,-63.0,-67.0,-69.0,-74.0,-81.0,-72.0,-77.0,7.0,17.0,6.0,7.0,1
1099,CC:2F:71:3E:C5:1F,5528692,4451540705,3406887,4182257043,2121805,269283662,502,93175,7997189,78588,6268283,14587,1728906,21525,528,3414275,870676,502,2926,6500.0,1000.0,-69.0,-72.0,-66.0,-61.0,-68.0,-70.0,-66.0,-60.0,-74.0,-81.0,-72.0,-77.0,5.0,9.0,6.0,16.0,1
1100,F8:59:71:5A:E0:3D,3410657,2200982221,1288850,1931698357,2121807,269283864,294,727297,886171341,726617,886089456,680,81885,716288,1840,1288966,151757,294,1073,144444.0,43333.0,-66.0,-73.0,-63.0,-70.0,-66.0,-72.0,-63.0,-69.0,-74.0,-81.0,-72.0,-77.0,8.0,8.0,9.0,7.0,1
1101,CC:2F:71:3F:1F:24,3951400,2684664143,1829593,2415380279,2121807,269283864,2565,1497308,1918019686,1496205,1917894910,1103,124776,1480097,6082,1829354,177867,2565,1771,86667.0,14444.0,-67.0,-63.0,-67.0,-69.0,-66.0,-63.0,-66.0,-69.0,-74.0,-81.0,-72.0,-77.0,7.0,18.0,5.0,8.0,1
1102,CC:2F:71:3E:C5:1F,5528696,4451541109,3406887,4182257043,2121809,269284066,502,93175,7997189,78588,6268283,14587,1728906,21525,528,3414275,870676,502,2926,6500.0,1000.0,-69.0,-72.0,-66.0,-61.0,-68.0,-70.0,-66.0,-60.0,-74.0,-81.0,-72.0,-77.0,5.0,9.0,6.0,16.0,1
1103,F8:59:71:5A:E0:3D,3410729,2201086747,1288918,1931802479,2121811,269284268,294,727362,886270007,726682,886188122,680,81885,716353,1840,1289034,151783,294,1073,144444.0,43333.0,-66.0,-71.0,-63.0,-70.0,-66.0,-72.0,-63.0,-69.0,-74.0,-81.0,-72.0,-77.0,8.0,10.0,9.0,7.0,1
1104,CC:2F:71:3F:1F:24,3951574,2684886801,1829763,2415602533,2121811,269284268,2565,1497464,1918232564,1496361,1918107788,1103,124776,1480251,6082,1829524,177969,2565,1772,86667.0,1000.0,-67.0,-64.0,-67.0,-69.0,-67.0,-63.0,-66.0,-69.0,-74.0,-81.0,-72.0,-77.0,7.0,17.0,5.0,8.0,1
1105,CC:2F:71:3E:C5:1F,5528700,4451541513,3406887,4182257043,2121813,269284470,502,93175,7997189,78588,6268283,14587,1728906,21525,528,3414275,870676,502,2926,6500.0,1000.0,-69.0,-72.0,-66.0,-61.0,-68.0,-70.0,-66.0,-60.0,-74.0,-81.0,-72.0,-77.0,5.0,9.0,6.0,16.0,1
1106,F8:59:71:5A:E0:3D,3410839,2201235261,1289025,1931950731,2121814,269284530,294,727450,886379251,726770,886297366,680,81885,716441,1840,1289137,151824,294,1073,144444.0,43333.0,-67.0,-73.0,-63.0,-70.0,-67.0,-73.0,-64.0,-70.0,-74.0,-81.0,-72.0,-77.0,7.0,8.0,9.0,7.0,1
1107,CC:2F:71:3F:1F:24,3951739,2685095345,1829923,2415810613,2121816,269284732,2565,1497616,1918442098,1496513,1918317322,1103,124776,1480402,6082,1829685,178115,2565,1772,86667.0,14444.0,-67.0,-63.0,-67.0,-69.0,-67.0,-63.0,-68.0,-69.0,-74.0,-81.0,-72.0,-77.0,7.0,18.0,5.0,8.0,1
1108,CC:2F:71:3E:C5:1F,5528703,4451541775,3406887,4182257043,2121816,269284732,502,93175,7997189,78588,6268283,14587,1728906,21525,528,3414275,870676,502,2926,6500.0,1000.0,-69.0,-72.0,-66.0,-61.0,-68.0,-70.0,-66.0,-60.0,-74.0,-81.0,-72.0,-77.0,5.0,9.0,6.0,16.0,1
1109,F8:59:71:5A:E0:3D,3410965,2201422839,1289145,1932137703,2121820,269285136,294,727538,886483513,726858,886401628,680,81885,716529,1840,1289261,151861,294,1073,144444.0,43333.0,-66.0,-73.0,-63.0,-70.0,-66.0,-73.0,-63.0,-70.0,-74.0,-81.0,-72.0,-77.0,8.0,8.0,9.0,7.0,1
1110,CC:2F:71:3F:1F:24,3951905,2685309033,1830085,2416023897,2121820,269285136,2565,1497759,1918639182,1496656,1918514406,1103,124776,1480545,6082,1829847,178145,2565,1772,86667.0,14444.0,-70.0,-64.0,-71.0,-71.0,-68.0,-63.0,-68.0,-69.0,-74.0,-81.0,-72.0,-77.0,4.0,17.0,1.0,6.0,1
1111,CC:2F:71:3E:C5:1F,5528707,4451542179,3406887,4182257043,2121820,269285136,502,93175,7997189,78588,6268283,14587,1728906,21525,528,3414275,870676,502,2926,6500.0,1000.0,-69.0,-72.0,-66.0,-61.0,-68.0,-70.0,-66.0,-60.0,-74.0,-81.0,-72.0,-77.0,5.0,9.0,6.0,16.0,1
1112,F8:59:71:5A:E0:3D,3411275,2201878592,1289453,1932593254,2121822,269285338,294,727642,886593561,726962,886511676,680,81885,716633,1840,1289569,151947,294,1073,144444.0,43333.0,-66.0,-73.0,-63.0,-70.0,-67.0,-73.0,-63.0,-70.0,-74.0,-81.0,-72.0,-77.0,8.0,8.0,9.0,7.0,1
1113,CC:2F:71:3F:1F:24,3952078,2685519346,1830256,2416234008,2121822,269285338,2565,1497912,1918839769,1496809,1918714993,1103,124776,1480698,6082,1830017,178195,2565,1772,78000.0,13000.0,-68.0,-64.0,-67.0,-69.0,-68.0,-63.0,-67.0,-69.0,-74.0,-81.0,-72.0,-77.0,6.0,17.0,5.0,8.0,1
1114,CC:2F:71:3E:C5:1F,5528709,4451542381,3406887,4182257043,2121822,269285338,502,93175,7997189,78588,6268283,14587,1728906,21525,528,3414275,870676,502,2926,6500.0,1000.0,-69.0,-72.0,-66.0,-61.0,-68.0,-70.0,-66.0,-60.0,-74.0,-81.0,-72.0,-77.0,5.0,9.0,6.0,16.0,1
1115,F8:59:71:5A:E0:3D,3411345,2201977160,1289516,1932691156,2121829,269286004,294,727706,886692121,727026,886610236,680,81885,716697,1840,1289632,151956,294,1073,144444.0,43333.0,-67.0,-73.0,-62.0,-70.0,-66.0,-73.0,-63.0,-70.0,-74.0,-81.0,-72.0,-77.0,7.0,8.0,10.0,7.0,1
1116,CC:2F:71:3F:1F:24,3952244,2685727210,1830415,2416441206,2121829,269286004,2565,1498056,1919039859,1496953,1918915083,1103,124776,1480842,6082,1830177,178215,2565,1772,86667.0,14444.0,-70.0,-64.0,-73.0,-71.0,-68.0,-64.0,-69.0,-69.0,-74.0,-81.0,-72.0,-77.0,4.0,17.0,-1.0,6.0,1
1117,CC:2F:71:3E:C5:1F,5528716,4451543047,3406887,4182257043,2121829,269286004,502,93175,7997189,78588,6268283,14587,1728906,21525,528,3414275,870676,502,2926,6500.0,1000.0,-69.0,-72.0,-66.0,-61.0,-68.0,-70.0,-66.0,-60.0,-74.0,-81.0,-72.0,-77.0,5.0,9.0,6.0,16.0,1
1118,F8:59:71:5A:E0:3D,3411411,2202076818,1289580,1932790612,2121831,269286206,294,727769,886789141,727089,886707256,680,81885,716760,1840,1289696,151959,294,1073,144444.0,43333.0,-66.0,-72.0,-63.0,-70.0,-66.0,-72.0,-63.0,-70.0,-74.0,-81.0,-72.0,-77.0,8.0,9.0,9.0,7.0,1
1119,CC:2F:71:3F:1F:24,3952417,2685935852,1830586,2416649646,2121831,269286206,2565,1498213,1919241063,1497110,1919116287,1103,124776,1480999,6082,1830347,178247,2565,1772,86667.0,14444.0,-68.0,-64.0,-68.0,-69.0,-68.0,-63.0,-68.0,-69.0,-74.0,-81.0,-72.0,-77.0,6.0,17.0,4.0,8.0,1
1120,CC:2F:71:3E:C5:1F,5528718,4451543249,3406887,4182257043,2121831,269286206,502,93175,7997189,78588,6268283,14587,1728906,21525,528,3414275,870676,502,2926,6500.0,1000.0,-69.0,-72.0,-66.0,-61.0,-68.0,-70.0,-66.0,-60.0,-75.0,-82.0,-73.0,-78.0,6.0,10.0,7.0,17.0,1
1121,F8:59:71:5A:E0:3D,3411541,2202264486,1289705,1932977603,2121836,269286883,294,727847,886894705,727167,886812820,680,81885,716838,1840,1289821,151989,294,1073,144444.0,43333.0,-67.0,-73.0,-62.0,-70.0,-67.0,-73.0,-63.0,-70.0,-75.0,-82.0,-73.0,-78.0,8.0,9.0,11.0,8.0,1
1122,CC:2F:71:3F:1F:24,3952582,2686143168,1830746,2416856285,2121836,269286883,2565,1498358,1919438418,1497255,1919313642,1103,124776,1481144,6082,1830508,178312,2565,1772,86667.0,14444.0,-67.0,-64.0,-67.0,-69.0,-68.0,-63.0,-68.0,-69.0,-75.0,-82.0,-73.0,-78.0,8.0,18.0,6.0,9.0,1
1123,CC:2F:71:3E:C5:1F,5528723,4451543926,3406887,4182257043,2121836,269286883,502,93175,7997189,78588,6268283,14587,1728906,21525,528,3414275,870676,502,2926,6500.0,1000.0,-69.0,-72.0,-66.0,-61.0,-68.0,-70.0,-66.0,-60.0,-75.0,-82.0,-73.0,-78.0,6.0,10.0,7.0,17.0,1
1124,F8:59:71:5A:E0:3D,3411610,2202364406,1289769,1933077059,2121841,269287347,294,727911,886993265,727231,886911380,680,81885,716902,1840,1289885,151997,294,1073,144444.0,43333.0,-68.0,-74.0,-64.0,-72.0,-66.0,-73.0,-63.0,-70.0,-76.0,-82.0,-74.0,-79.0,8.0,8.0,10.0,7.0,1
1125,CC:2F:71:3F:1F:24,3952748,2686352626,1830907,2417065279,2121841,269287347,2565,1498510,1919639485,1497407,1919514709,1103,124776,1481296,6082,1830669,178362,2565,1772,86667.0,14444.0,-70.0,-64.0,-72.0,-70.0,-68.0,-63.0,-68.0,-69.0,-76.0,-82.0,-74.0,-79.0,6.0,18.0,2.0,9.0,1
1126,CC:2F:71:3E:C5:1F,5528728,4451544390,3406887,4182257043,2121841,269287347,502,93175,7997189,78588,6268283,14587,1728906,21525,528,3414275,870676,502,2926,6500.0,1000.0,-69.0,-72.0,-66.0,-61.0,-68.0,-70.0,-66.0,-60.0,-76.0,-82.0,-74.0,-79.0,7.0,10.0,8.0,18.0,1
1127,F8:59:71:5A:E0:3D,3411882,2202719379,1290014,1933420718,2121868,269298661,294,728007,887098715,727327,887016830,680,81885,716998,1840,1290130,152060,294,1074,144444.0,43333.0,-68.0,-74.0,-65.0,-72.0,-67.0,-73.0,-64.0,-71.0,-76.0,-82.0,-74.0,-79.0,8.0,8.0,9.0,7.0,1
1128,CC:2F:71:3F:1F:24,3952934,2686569252,1831066,2417270591,2121868,269298661,2565,1498654,1919835261,1497551,1919710485,1103,124776,1481440,6082,1830829,178462,2565,1772,86667.0,14444.0,-70.0,-64.0,-72.0,-71.0,-67.0,-64.0,-68.0,-69.0,-76.0,-82.0,-74.0,-79.0,6.0,18.0,2.0,8.0,1
1129,CC:2F:71:3E:C5:1F,5528756,4451555820,3406888,4182257159,2121868,269298661,502,93176,7997307,78588,6268283,14588,1729024,21526,528,3414276,870678,502,2926,6500.0,1000.0,-72.0,-72.0,-69.0,-61.0,-69.0,-71.0,-66.0,-60.0,-76.0,-82.0,-74.0,-79.0,4.0,10.0,5.0,18.0,1
1130,F8:59:71:5A:E0:3D,3411952,2202820699,1290080,1933521634,2121872,269299065,294,728072,887198815,727392,887116930,680,81885,717063,1840,1290196,152078,294,1074,144444.0,43333.0,-68.0,-74.0,-64.0,-71.0,-67.0,-73.0,-63.0,-70.0,-76.0,-82.0,-74.0,-79.0,8.0,8.0,10.0,8.0,1
1131,CC:2F:71:3F:1F:24,3953101,2686784382,1831229,2417485317,2121872,269299065,2565,1498803,1920041627,1497700,1919916851,1103,124776,1481589,6082,1830992,178531,2565,1772,86667.0,14444.0,-69.0,-64.0,-72.0,-71.0,-68.0,-63.0,-69.0,-69.0,-76.0,-82.0,-74.0,-79.0,7.0,18.0,2.0,8.0,1
1132,CC:2F:71:3E:C5:1F,5528761,4451556284,3406888,4182257159,2121873,269299125,502,93176,7997307,78588,6268283,14588,1729024,21526,528,3414276,870678,502,2926,6500.0,1000.0,-72.0,-72.0,-69.0,-61.0,-69.0,-71.0,-66.0,-60.0,-76.0,-82.0,-74.0,-79.0,4.0,10.0,5.0,18.0,1
1133,F8:59:71:5A:E0:3D,3412021,2202920619,1290144,1933621090,2121877,269299529,294,728136,887297375,727456,887215490,680,81885,717127,1840,1290260,152082,294,1074,144444.0,43333.0,-66.0,-73.0,-63.0,-70.0,-66.0,-73.0,-63.0,-70.0,-76.0,-83.0,-74.0,-79.0,10.0,10.0,11.0,9.0,1
1134,CC:2F:71:3F:1F:24,3953262,2686988302,1831385,2417688773,2121877,269299529,2565,1498948,1920240395,1497845,1920115619,1103,124776,1481734,6082,1831148,178595,2565,1772,86667.0,14444.0,-70.0,-64.0,-72.0,-70.0,-68.0,-64.0,-68.0,-69.0,-76.0,-83.0,-74.0,-79.0,6.0,19.0,2.0,9.0,1
1135,CC:2F:71:3E:C5:1F,5528765,4451556688,3406888,4182257159,2121877,269299529,502,93176,7997307,78588,6268283,14588,1729024,21526,528,3414276,870678,502,2926,6500.0,1000.0,-72.0,-72.0,-69.0,-61.0,-69.0,-71.0,-66.0,-60.0,-76.0,-83.0,-74.0,-79.0,4.0,11.0,5.0,18.0,1
1136,F8:59:71:5A:E0:3D,3412349,2203425973,1290468,1934126040,2121881,269299933,294,728273,887407983,727593,887326098,680,81885,717264,1840,1290584,152107,294,1074,144444.0,43333.0,-66.0,-73.0,-63.0,-70.0,-67.0,-73.0,-63.0,-70.0,-76.0,-83.0,-74.0,-79.0,10.0,10.0,11.0,9.0,1
1137,CC:2F:71:3F:1F:24,3953426,2687198994,1831545,2417899061,2121881,269299933,2565,1499094,1920442113,1497991,1920317337,1103,124776,1481879,6082,1831308,178628,2565,1772,86667.0,1000.0,-69.0,-64.0,-71.0,-71.0,-68.0,-63.0,-68.0,-70.0,-76.0,-83.0,-74.0,-79.0,7.0,19.0,3.0,8.0,1
1138,CC:2F:71:3E:C5:1F,5528769,4451557092,3406888,4182257159,2121881,269299933,502,93176,7997307,78588,6268283,14588,1729024,21526,528,3414276,870678,502,2926,6500.0,1000.0,-72.0,-72.0,-69.0,-61.0,-69.0,-71.0,-66.0,-60.0,-76.0,-83.0,-74.0,-79.0,4.0,11.0,5.0,18.0,1
1139,F8:59:71:5A:E0:3D,3412417,2203522847,1290530,1934222388,2121887,269300459,294,728336,887505003,727656,887423118,680,81885,717327,1840,1290646,152114,294,1074,144444.0,43333.0,-68.0,-74.0,-64.0,-72.0,-66.0,-73.0,-63.0,-70.0,-76.0,-83.0,-74.0,-79.0,8.0,9.0,10.0,7.0,1
1140,CC:2F:71:3F:1F:24,3953590,2687404772,1831703,2418104313,2121887,269300459,2565,1499240,1920640999,1498136,1920516105,1104,124894,1482023,6082,1831466,178680,2565,1772,86667.0,14444.0,-67.0,-63.0,-66.0,-68.0,-67.0,-63.0,-67.0,-69.0,-76.0,-83.0,-74.0,-79.0,9.0,20.0,8.0,11.0,1
1141,CC:2F:71:3E:C5:1F,5528775,4451557618,3406888,4182257159,2121887,269300459,502,93176,7997307,78588,6268283,14588,1729024,21526,528,3414276,870678,502,2926,6500.0,1000.0,-72.0,-72.0,-69.0,-61.0,-69.0,-71.0,-66.0,-60.0,-76.0,-83.0,-74.0,-79.0,4.0,11.0,5.0,18.0,1
1142,F8:59:71:5A:E0:3D,3412485,2203622707,1290594,1934321844,2121891,269300863,294,728399,887602023,727719,887520138,680,81885,717390,1840,1290710,152125,294,1074,144444.0,43333.0,-68.0,-74.0,-64.0,-72.0,-66.0,-73.0,-63.0,-70.0,-76.0,-82.0,-74.0,-79.0,8.0,8.0,10.0,7.0,1
1143,CC:2F:71:3F:1F:24,3953753,2687611534,1831862,2418310671,2121891,269300863,2565,1499385,1920838315,1498281,1920713421,1104,124894,1482168,6082,1831625,178766,2565,1772,86667.0,14444.0,-67.0,-63.0,-67.0,-69.0,-68.0,-63.0,-69.0,-70.0,-76.0,-82.0,-74.0,-79.0,9.0,19.0,7.0,10.0,1
1144,CC:2F:71:3E:C5:1F,5528779,4451558022,3406888,4182257159,2121891,269300863,502,93176,7997307,78588,6268283,14588,1729024,21526,528,3414276,870678,502,2926,6500.0,1000.0,-72.0,-72.0,-69.0,-61.0,-69.0,-71.0,-66.0,-60.0,-76.0,-82.0,-74.0,-79.0,4.0,10.0,5.0,18.0,1
1145,F8:59:71:5A:E0:3D,3412548,2203720609,1290657,1934419746,2121891,269300863,294,728462,887699043,727782,887617158,680,81885,717453,1840,1290773,152129,294,1074,144444.0,43333.0,-66.0,-73.0,-63.0,-70.0,-67.0,-73.0,-63.0,-71.0,-76.0,-82.0,-74.0,-79.0,10.0,9.0,11.0,9.0,1
1146,CC:2F:71:3F:1F:24,3953912,2687818844,1832021,2418517981,2121891,269300863,2565,1499530,1921037055,1498426,1920912161,1104,124894,1482313,6082,1831782,178794,2565,1772,86667.0,14444.0,-69.0,-64.0,-72.0,-71.0,-69.0,-63.0,-72.0,-71.0,-76.0,-82.0,-74.0,-79.0,7.0,18.0,2.0,8.0,1
1147,CC:2F:71:3E:C5:1F,5528783,4451558426,3406888,4182257159,2121895,269301267,502,93176,7997307,78588,6268283,14588,1729024,21526,528,3414276,870678,502,2926,6500.0,1000.0,-72.0,-72.0,-69.0,-61.0,-69.0,-71.0,-66.0,-60.0,-76.0,-82.0,-74.0,-79.0,4.0,10.0,5.0,18.0,1
1148,F8:59:71:5A:E0:3D,3412618,2203819177,1290720,1934517648,2121898,269301529,294,728526,887797631,727846,887715746,680,81885,717517,1840,1290836,152134,294,1075,144444.0,43333.0,-66.0,-72.0,-63.0,-70.0,-66.0,-72.0,-63.0,-70.0,-76.0,-82.0,-74.0,-79.0,10.0,10.0,11.0,9.0,1
1149,CC:2F:71:3F:1F:24,3954077,2688024706,1832179,2418723177,2121898,269301529,2565,1499675,1921235851,1498571,1921110957,1104,124894,1482458,6082,1831943,178906,2565,1772,86667.0,14444.0,-69.0,-64.0,-72.0,-70.0,-68.0,-63.0,-68.0,-69.0,-76.0,-82.0,-74.0,-79.0,7.0,18.0,2.0,9.0,1
1150,CC:2F:71:3E:C5:1F,5528788,4451558890,3406888,4182257159,2121900,269301731,502,93176,7997307,78588,6268283,14588,1729024,21526,528,3414276,870678,502,2926,6500.0,1000.0,-72.0,-72.0,-69.0,-61.0,-69.0,-71.0,-66.0,-60.0,-77.0,-83.0,-76.0,-80.0,5.0,11.0,7.0,19.0,1
1151,F8:59:71:5A:E0:3D,3412687,2203919293,1290787,1934617562,2121900,269301731,294,728594,887898573,727914,887816688,680,81885,717585,1840,1290903,152144,294,1076,144444.0,43333.0,-69.0,-74.0,-64.0,-72.0,-68.0,-73.0,-63.0,-71.0,-77.0,-83.0,-76.0,-80.0,8.0,9.0,12.0,8.0,1
1152,CC:2F:71:3F:1F:24,3954237,2688230328,1832337,2418928597,2121900,269301731,2565,1499820,1921433167,1498716,1921308273,1104,124894,1482603,6082,1832101,178976,2565,1772,86667.0,14444.0,-70.0,-63.0,-71.0,-72.0,-70.0,-63.0,-71.0,-72.0,-77.0,-83.0,-76.0,-80.0,7.0,20.0,5.0,8.0,1
1153,CC:2F:71:3E:C5:1F,5528788,4451558890,3406888,4182257159,2121900,269301731,502,93176,7997307,78588,6268283,14588,1729024,21526,528,3414276,870678,502,2926,6500.0,1000.0,-72.0,-72.0,-69.0,-61.0,-69.0,-71.0,-66.0,-60.0,-77.0,-83.0,-76.0,-80.0,5.0,11.0,7.0,19.0,1
1154,F8:59:71:5A:E0:3D,3412933,2204290476,1291029,1934988341,2121904,269302135,294,728695,888009773,728015,887927888,680,81885,717686,1840,1291145,152157,294,1076,144444.0,43333.0,-67.0,-73.0,-63.0,-71.0,-66.0,-72.0,-62.0,-69.0,-77.0,-83.0,-76.0,-80.0,10.0,10.0,13.0,9.0,1
1155,CC:2F:71:3F:1F:24,3954414,2688453122,1832507,2419150723,2121907,269302399,2565,1499977,1921650765,1498873,1921525871,1104,124894,1482759,6083,1832272,179099,2565,1773,78000.0,1000.0,-67.0,-63.0,-67.0,-69.0,-67.0,-63.0,-68.0,-69.0,-77.0,-83.0,-76.0,-80.0,10.0,20.0,9.0,11.0,1
1156,CC:2F:71:3E:C5:1F,5528797,4451559760,3406888,4182257159,2121909,269302601,502,93176,7997307,78588,6268283,14588,1729024,21526,528,3414276,870678,502,2926,6500.0,1000.0,-72.0,-72.0,-69.0,-61.0,-69.0,-71.0,-66.0,-60.0,-77.0,-83.0,-76.0,-80.0,5.0,11.0,7.0,19.0,1
1157,F8:59:71:5A:E0:3D,3413008,2204396580,1291098,1935093919,2121910,269302661,294,728767,888118226,728086,888036223,681,82003,717758,1840,1291214,152179,294,1077,130000.0,39000.0,-67.0,-73.0,-63.0,-70.0,-67.0,-73.0,-63.0,-70.0,-76.0,-83.0,-75.0,-80.0,9.0,10.0,12.0,10.0,1
1158,CC:2F:71:3F:1F:24,3954581,2688668600,1832671,2419365939,2121910,269302661,2565,1500131,1921859097,1499027,1921734203,1104,124894,1482912,6083,1832436,179181,2565,1773,86667.0,14444.0,-69.0,-64.0,-73.0,-71.0,-67.0,-64.0,-68.0,-69.0,-76.0,-83.0,-75.0,-80.0,7.0,19.0,2.0,9.0,1
1159,CC:2F:71:3E:C5:1F,5528798,4451559820,3406888,4182257159,2121910,269302661,502,93176,7997307,78588,6268283,14588,1729024,21526,528,3414276,870678,502,2926,6500.0,1000.0,-72.0,-72.0,-69.0,-61.0,-69.0,-71.0,-66.0,-60.0,-76.0,-83.0,-75.0,-80.0,4.0,11.0,6.0,19.0,1
1160,F8:59:71:5A:E0:3D,3413082,2204502804,1291168,1935199739,2121914,269303065,294,728836,888220291,728155,888138288,681,82003,717826,1840,1291284,152199,294,1077,144444.0,43333.0,-67.0,-72.0,-64.0,-71.0,-66.0,-72.0,-63.0,-70.0,-76.0,-83.0,-75.0,-80.0,9.0,11.0,11.0,9.0,1
1161,CC:2F:71:3F:1F:24,3954760,2688900622,1832845,2419597423,2121915,269303199,2565,1500295,1922084503,1499191,1921959609,1104,124894,1483072,6083,1832609,179277,2565,1777,104000.0,1000.0,-70.0,-63.0,-73.0,-71.0,-67.0,-63.0,-67.0,-69.0,-76.0,-83.0,-75.0,-80.0,6.0,20.0,2.0,9.0,1
1162,CC:2F:71:3E:C5:1F,5528806,4451560628,3406888,4182257159,2121918,269303469,502,93176,7997307,78588,6268283,14588,1729024,21526,528,3414276,870678,502,2926,6500.0,1000.0,-72.0,-72.0,-69.0,-61.0,-69.0,-71.0,-66.0,-60.0,-76.0,-83.0,-75.0,-80.0,4.0,11.0,6.0,19.0,1
1163,F8:59:71:5A:E0:3D,3413352,2204912224,1291433,1935608482,2121919,269303742,294,728968,888342041,728287,888260038,681,82003,717958,1840,1291549,152259,294,1077,144444.0,43333.0,-66.0,-72.0,-64.0,-70.0,-66.0,-71.0,-63.0,-69.0,-76.0,-83.0,-75.0,-80.0,10.0,11.0,11.0,10.0,1
1164,CC:2F:71:3F:1F:24,3954928,2689116325,1833009,2419812583,2121919,269303742,2565,1500446,1922291261,1499342,1922166367,1104,124894,1483221,6083,1832774,179433,2565,1777,86667.0,13000.0,-70.0,-63.0,-72.0,-71.0,-68.0,-63.0,-68.0,-70.0,-76.0,-83.0,-75.0,-80.0,6.0,20.0,3.0,9.0,1
1165,CC:2F:71:3E:C5:1F,5528807,4451560901,3406888,4182257159,2121919,269303742,502,93176,7997307,78588,6268283,14588,1729024,21526,528,3414276,870678,502,2926,6500.0,1000.0,-72.0,-72.0,-69.0,-61.0,-69.0,-71.0,-66.0,-60.0,-76.0,-83.0,-75.0,-80.0,4.0,11.0,6.0,19.0,1
1166,F8:59:71:5A:E0:3D,3413474,2205074819,1291550,1935770613,2121924,269304206,294,729057,888452534,728376,888370531,681,82003,718045,1840,1291666,152293,294,1077,144444.0,43333.0,-67.0,-72.0,-63.0,-70.0,-67.0,-72.0,-63.0,-70.0,-77.0,-83.0,-75.0,-80.0,10.0,11.0,12.0,10.0,1
1167,CC:2F:71:3F:1F:24,3955097,2689331549,1833173,2420027343,2121924,269304206,2565,1500599,1922499653,1499495,1922374759,1104,124894,1483374,6083,1832938,179517,2565,1777,86667.0,14444.0,-68.0,-63.0,-67.0,-69.0,-68.0,-63.0,-68.0,-69.0,-77.0,-83.0,-75.0,-80.0,9.0,20.0,8.0,11.0,1
1168,CC:2F:71:3E:C5:1F,5528812,4451561365,3406888,4182257159,2121924,269304206,502,93176,7997307,78588,6268283,14588,1729024,21526,528,3414276,870678,502,2926,6500.0,1000.0,-72.0,-72.0,-69.0,-61.0,-69.0,-71.0,-66.0,-60.0,-77.0,-83.0,-75.0,-80.0,5.0,11.0,6.0,19.0,1
1169,F8:59:71:5A:E0:3D,3413762,2205485176,1291832,1936180198,2121930,269304978,294,729167,888580921,728486,888498918,681,82003,718153,1840,1291948,152390,294,1077,144444.0,43333.0,-66.0,-72.0,-63.0,-70.0,-66.0,-72.0,-63.0,-70.0,-77.0,-83.0,-75.0,-80.0,11.0,11.0,12.0,10.0,1
1170,CC:2F:71:3F:1F:24,3956347,2691082030,1834413,2421776648,2121934,269305382,2565,1501020,1922839275,1499916,1922714381,1104,124894,1483795,6083,1834152,180677,2565,1777,78000.0,13000.0,-68.0,-63.0,-67.0,-68.0,-68.0,-63.0,-68.0,-69.0,-77.0,-83.0,-75.0,-80.0,9.0,20.0,8.0,12.0,1
1171,CC:2F:71:3E:C5:1F,5528822,4451562541,3406888,4182257159,2121934,269305382,502,93176,7997307,78588,6268283,14588,1729024,21526,528,3414276,870678,502,2926,6500.0,1000.0,-72.0,-72.0,-69.0,-61.0,-69.0,-71.0,-66.0,-60.0,-77.0,-83.0,-75.0,-80.0,5.0,11.0,6.0,19.0,1
1172,F8:59:71:5A:E0:3D,3413863,2205629012,1291924,1936323166,2121939,269305846,294,729262,888724575,728581,888642572,681,82003,718245,1840,1292040,152402,294,1077,144444.0,43333.0,-66.0,-71.0,-63.0,-69.0,-66.0,-72.0,-62.0,-69.0,-77.0,-84.0,-75.0,-80.0,11.0,13.0,12.0,11.0,1
1173,CC:2F:71:3F:1F:24,3957180,2692254925,1835241,2422949079,2121939,269305846,2565,1501298,1923084112,1500194,1922959218,1104,124894,1484073,6083,1835006,181043,2565,1778,86667.0,14444.0,-69.0,-64.0,-69.0,-69.0,-69.0,-63.0,-70.0,-69.0,-77.0,-84.0,-75.0,-80.0,8.0,20.0,6.0,11.0,1
1174,CC:2F:71:3E:C5:1F,5528827,4451563005,3406888,4182257159,2121939,269305846,502,93176,7997307,78588,6268283,14588,1729024,21526,528,3414277,870678,502,2926,6500.0,1000.0,-72.0,-72.0,-69.0,-61.0,-69.0,-71.0,-66.0,-60.0,-77.0,-84.0,-75.0,-80.0,5.0,12.0,6.0,19.0,1
1175,F8:59:71:5A:E0:3D,3413932,2205730426,1291989,1936424176,2121943,269306250,294,729329,888824843,728648,888742840,681,82003,718310,1840,1292105,152403,294,1077,144444.0,43333.0,-66.0,-72.0,-63.0,-69.0,-66.0,-72.0,-63.0,-69.0,-77.0,-84.0,-75.0,-80.0,11.0,12.0,12.0,11.0,1
1176,CC:2F:71:3F:1F:24,3957350,2692472677,1835407,2423166427,2121943,269306250,2565,1501450,1923292264,1500346,1923167370,1104,124894,1484225,6083,1835173,181172,2565,1778,78000.0,13000.0,-70.0,-64.0,-73.0,-71.0,-69.0,-63.0,-71.0,-70.0,-77.0,-84.0,-75.0,-80.0,7.0,20.0,2.0,9.0,1
1177,CC:2F:71:3E:C5:1F,5528831,4451563409,3406888,4182257159,2121943,269306250,502,93176,7997307,78588,6268283,14588,1729024,21526,528,3414277,870678,502,2926,6500.0,1000.0,-72.0,-72.0,-69.0,-61.0,-69.0,-71.0,-66.0,-60.0,-77.0,-84.0,-75.0,-80.0,5.0,12.0,6.0,19.0,1
1178,F8:59:71:5A:E0:3D,3414216,2206164714,1292269,1936858060,2121947,269306654,294,729437,888944657,728756,888862654,681,82003,718414,1840,1292384,152435,294,1077,144444.0,43333.0,-68.0,-73.0,-64.0,-71.0,-67.0,-72.0,-64.0,-70.0,-77.0,-84.0,-75.0,-80.0,9.0,11.0,11.0,9.0,1
1179,CC:2F:71:3F:1F:24,3957532,2692698226,1835584,2423391512,2121948,269306714,2565,1501617,1923509380,1500513,1923384486,1104,124894,1484392,6083,1835349,181252,2565,1778,86667.0,1000.0,-70.0,-64.0,-73.0,-70.0,-68.0,-63.0,-69.0,-69.0,-77.0,-84.0,-75.0,-80.0,7.0,20.0,2.0,10.0,1
1180,CC:2F:71:3E:C5:1F,5528836,4451563873,3406888,4182257159,2121948,269306714,502,93176,7997307,78588,6268283,14588,1729024,21526,528,3414277,870678,502,2926,6500.0,1000.0,-72.0,-72.0,-69.0,-61.0,-69.0,-71.0,-66.0,-60.0,-77.0,-84.0,-75.0,-80.0,5.0,12.0,6.0,19.0,1
1181,F8:59:71:5A:E0:3D,3414452,2206518862,1292500,1937211744,2121952,269307118,294,729558,889059240,728877,888977237,681,82003,718533,1840,1292616,152447,294,1077,144444.0,43333.0,-68.0,-73.0,-63.0,-71.0,-66.0,-72.0,-62.0,-69.0,-78.0,-85.0,-77.0,-81.0,10.0,12.0,14.0,10.0,1
1182,CC:2F:71:3F:1F:24,3957719,2692918843,1835767,2423611725,2121952,269307118,2565,1501783,1923722654,1500679,1923597760,1104,124894,1484558,6083,1835531,181337,2565,1779,86667.0,14444.0,-70.0,-64.0,-73.0,-70.0,-68.0,-63.0,-69.0,-69.0,-78.0,-85.0,-77.0,-81.0,8.0,21.0,4.0,11.0,1
1183,CC:2F:71:3E:C5:1F,5528840,4451564277,3406888,4182257159,2121952,269307118,502,93176,7997307,78588,6268283,14588,1729024,21526,528,3414277,870678,502,2926,6500.0,1000.0,-72.0,-72.0,-69.0,-61.0,-69.0,-71.0,-66.0,-60.0,-78.0,-85.0,-77.0,-81.0,6.0,13.0,8.0,20.0,1
1184,F8:59:71:5A:E0:3D,3414518,2206615614,1292562,1937308092,2121956,269307522,294,729621,889156274,728940,889074271,681,82003,718595,1840,1292678,152450,294,1077,144444.0,43333.0,-68.0,-73.0,-64.0,-71.0,-67.0,-72.0,-63.0,-70.0,-79.0,-86.0,-78.0,-82.0,11.0,13.0,14.0,11.0,1
1185,CC:2F:71:3F:1F:24,3957895,2693128402,1835939,2423820880,2121956,269307522,2565,1501941,1923925926,1500837,1923801032,1104,124894,1484716,6083,1835705,181420,2565,1779,86667.0,14444.0,-68.0,-64.0,-67.0,-69.0,-68.0,-63.0,-69.0,-69.0,-79.0,-86.0,-78.0,-82.0,11.0,22.0,11.0,13.0,1
1186,CC:2F:71:3E:C5:1F,5528844,4451564681,3406888,4182257159,2121956,269307522,502,93176,7997307,78588,6268283,14588,1729024,21526,528,3414277,870678,502,2926,6500.0,1000.0,-72.0,-72.0,-69.0,-61.0,-69.0,-71.0,-66.0,-60.0,-79.0,-86.0,-78.0,-82.0,7.0,14.0,9.0,21.0,1
1187,F8:59:71:5A:E0:3D,3414587,2206721346,1292630,1937413764,2121957,269307582,294,729689,889260994,729008,889178991,681,82003,718663,1840,1292746,152454,294,1077,144444.0,43333.0,-66.0,-72.0,-63.0,-69.0,-67.0,-72.0,-63.0,-70.0,-79.0,-86.0,-78.0,-82.0,13.0,14.0,15.0,13.0,1
1188,CC:2F:71:3F:1F:24,3958062,2693345004,1836105,2424037422,2121957,269307582,2565,1502095,1924132902,1500991,1924008008,1104,124894,1484870,6083,1835870,181472,2565,1779,78000.0,13000.0,-68.0,-64.0,-68.0,-69.0,-68.0,-63.0,-68.0,-69.0,-79.0,-86.0,-78.0,-82.0,11.0,22.0,10.0,13.0,1
1189,CC:2F:71:3E:C5:1F,5528849,4451565145,3406888,4182257159,2121961,269307986,502,93176,7997307,78588,6268283,14588,1729024,21526,528,3414277,870678,502,2926,6500.0,1000.0,-72.0,-72.0,-69.0,-61.0,-69.0,-71.0,-66.0,-60.0,-79.0,-86.0,-78.0,-82.0,7.0,14.0,9.0,21.0,1
1190,F8:59:71:5A:E0:3D,3414665,2206825306,1292700,1937516916,2121965,269308390,294,729759,889364987,729078,889282984,681,82003,718733,1840,1292816,152459,294,1077,144444.0,43333.0,-68.0,-73.0,-64.0,-72.0,-67.0,-72.0,-63.0,-70.0,-79.0,-86.0,-78.0,-82.0,11.0,13.0,14.0,10.0,1
1191,CC:2F:71:3F:1F:24,3958235,2693561998,1836270,2424253608,2121965,269308390,2565,1502247,1924342562,1501143,1924217668,1104,124894,1485022,6083,1836036,181540,2565,1779,86667.0,14444.0,-71.0,-64.0,-73.0,-70.0,-69.0,-63.0,-70.0,-69.0,-79.0,-86.0,-78.0,-82.0,8.0,22.0,5.0,12.0,1
1192,CC:2F:71:3E:C5:1F,5528853,4451565549,3406888,4182257159,2121965,269308390,502,93176,7997307,78588,6268283,14588,1729024,21526,528,3414277,870678,502,2926,6500.0,1000.0,-72.0,-72.0,-69.0,-61.0,-69.0,-71.0,-66.0,-60.0,-79.0,-86.0,-78.0,-82.0,7.0,14.0,9.0,21.0,1
1193,F8:59:71:5A:E0:3D,3414730,2206926316,1292765,1937617926,2121965,269308390,294,729826,889468195,729145,889386192,681,82003,718798,1840,1292881,152465,294,1077,144444.0,43333.0,-66.0,-72.0,-63.0,-70.0,-66.0,-72.0,-63.0,-70.0,-80.0,-86.0,-79.0,-84.0,14.0,14.0,16.0,14.0,1
1194,CC:2F:71:3F:1F:24,3958396,2693770316,1836431,2424461926,2121965,269308390,2565,1502396,1924544684,1501292,1924419790,1104,124894,1485171,6083,1836196,181630,2565,1780,78000.0,1000.0,-68.0,-63.0,-68.0,-69.0,-68.0,-63.0,-69.0,-69.0,-80.0,-86.0,-79.0,-84.0,12.0,23.0,11.0,15.0,1
1195,CC:2F:71:3E:C5:1F,5528853,4451565549,3406888,4182257159,2121965,269308390,502,93176,7997307,78588,6268283,14588,1729024,21526,528,3414277,870678,502,2926,6500.0,1000.0,-72.0,-72.0,-69.0,-61.0,-69.0,-71.0,-66.0,-60.0,-80.0,-86.0,-79.0,-84.0,8.0,14.0,10.0,23.0,1
1196,F8:59:71:5A:E0:3D,3414904,2207153594,1292932,1937844538,2121972,269309056,294,729922,889576526,729241,889494523,681,82003,718894,1840,1293048,152476,294,1077,144444.0,43333.0,-66.0,-72.0,-63.0,-70.0,-66.0,-72.0,-62.0,-69.0,-81.0,-86.0,-79.0,-84.0,15.0,14.0,16.0,14.0,1
1197,CC:2F:71:3F:1F:24,3958571,2693987332,1836597,2424678074,2121974,269309258,2565,1502552,1924753419,1501448,1924628525,1104,124894,1485327,6083,1836363,181692,2565,1781,86667.0,14444.0,-70.0,-64.0,-73.0,-71.0,-67.0,-63.0,-67.0,-69.0,-81.0,-86.0,-79.0,-84.0,11.0,22.0,6.0,13.0,1
1198,CC:2F:71:3E:C5:1F,5528862,4451566417,3406888,4182257159,2121974,269309258,502,93176,7997307,78588,6268283,14588,1729024,21526,528,3414277,870678,502,2926,6500.0,1000.0,-72.0,-72.0,-69.0,-61.0,-69.0,-71.0,-66.0,-60.0,-81.0,-86.0,-79.0,-84.0,9.0,14.0,10.0,23.0,1
1199,F8:59:71:5A:E0:3D,3414984,2207273584,1293010,1937964326,2121974,269309258,294,730002,889699009,729321,889617006,681,82003,718974,1840,1293126,152492,294,1077,144444.0,43333.0,-67.0,-72.0,-63.0,-70.0,-67.0,-72.0,-63.0,-71.0,-81.0,-86.0,-79.0,-84.0,14.0,14.0,16.0,14.0,1
1200,CC:2F:71:3F:1F:24,3958756,2694234542,1836782,2424925284,2121974,269309258,2565,1502726,1924994039,1501622,1924869145,1104,124894,1485497,6083,1836548,181827,2565,1781,86667.0,14444.0,-67.0,-64.0,-67.0,-69.0,-69.0,-63.0,-70.0,-69.0,-81.0,-86.0,-79.0,-84.0,14.0,22.0,12.0,15.0,1
1201,CC:2F:71:3E:C5:1F,5528867,4451567094,3406888,4182257159,2121979,269309935,502,93176,7997307,78588,6268283,14588,1729024,21526,528,3414277,870678,502,2926,6500.0,1000.0,-72.0,-72.0,-69.0,-61.0,-69.0,-71.0,-66.0,-60.0,-81.0,-86.0,-79.0,-84.0,9.0,14.0,10.0,23.0,1
1202,F8:59:71:5A:E0:3D,3415317,2207764485,1293333,1938454086,2121984,269310399,294,730154,889849975,729473,889767972,681,82003,719126,1840,1293449,152530,294,1077,144444.0,1000.0,-67.0,-72.0,-63.0,-70.0,-66.0,-72.0,-63.0,-70.0,-81.0,-86.0,-79.0,-84.0,14.0,14.0,16.0,14.0,1
1203,CC:2F:71:3F:1F:24,3958979,2694525303,1836995,2425214904,2121984,269310399,2565,1502937,1925274887,1501833,1925149993,1104,124894,1485695,6083,1836761,182124,2565,1782,86667.0,14444.0,-69.0,-64.0,-72.0,-71.0,-67.0,-63.0,-68.0,-70.0,-81.0,-86.0,-79.0,-84.0,12.0,22.0,7.0,13.0,1
1204,CC:2F:71:3E:C5:1F,5528872,4451567558,3406888,4182257159,2121984,269310399,502,93176,7997307,78588,6268283,14588,1729024,21526,528,3414277,870678,502,2926,6500.0,1000.0,-72.0,-72.0,-69.0,-61.0,-69.0,-71.0,-66.0,-60.0,-81.0,-86.0,-79.0,-84.0,9.0,14.0,10.0,23.0,1
1205,F8:59:71:5A:E0:3D,3415388,2207866110,1293401,1938555441,2121987,269310669,294,730224,889954028,729543,889872025,681,82003,719196,1840,1293517,152546,294,1077,144444.0,43333.0,-67.0,-72.0,-63.0,-70.0,-66.0,-72.0,-62.0,-70.0,-81.0,-86.0,-79.0,-84.0,14.0,14.0,16.0,14.0,1
1206,CC:2F:71:3F:1F:24,3959149,2694743545,1837161,2425432742,2121988,269310803,2565,1503091,1925484589,1501987,1925359695,1104,124894,1485847,6083,1836927,182165,2565,1782,86667.0,14444.0,-66.0,-63.0,-66.0,-69.0,-67.0,-63.0,-67.0,-69.0,-81.0,-86.0,-79.0,-84.0,15.0,23.0,13.0,15.0,1
1207,CC:2F:71:3E:C5:1F,5528877,4451568078,3406889,4182257275,2121988,269310803,502,93176,7997307,78588,6268283,14588,1729024,21526,528,3414278,870679,502,2926,13000.0,1000.0,-72.0,-72.0,-69.0,-61.0,-69.0,-71.0,-66.0,-60.0,-81.0,-86.0,-79.0,-84.0,9.0,14.0,10.0,23.0,1
1208,F8:59:71:5A:E0:3D,3415467,2207968977,1293475,1938657770,2121992,269311207,294,730296,890059192,729615,889977189,681,82003,719266,1840,1293591,152559,294,1077,144444.0,43333.0,-67.0,-72.0,-63.0,-70.0,-67.0,-72.0,-62.0,-70.0,-81.0,-87.0,-79.0,-84.0,14.0,15.0,16.0,14.0,1
1209,CC:2F:71:3F:1F:24,3959310,2694947647,1837318,2425636440,2121992,269311207,2565,1503235,1925681789,1502131,1925556895,1104,124894,1485991,6083,1837084,182236,2565,1782,86667.0,14444.0,-68.0,-63.0,-67.0,-69.0,-67.0,-63.0,-66.0,-69.0,-81.0,-87.0,-79.0,-84.0,13.0,24.0,12.0,15.0,1
1210,CC:2F:71:3E:C5:1F,5528881,4451568482,3406889,4182257275,2121992,269311207,502,93176,7997307,78588,6268283,14588,1729024,21526,528,3414278,870679,502,2926,13000.0,1000.0,-72.0,-72.0,-69.0,-61.0,-69.0,-71.0,-66.0,-60.0,-81.0,-87.0,-79.0,-84.0,9.0,15.0,10.0,23.0,1
1211,F8:59:71:5A:E0:3D,3415531,2208066715,1293538,1938755448,2121993,269311267,294,730359,890156324,729678,890074321,681,82003,719329,1840,1293654,152571,294,1077,144444.0,43333.0,-66.0,-72.0,-63.0,-70.0,-66.0,-72.0,-63.0,-70.0,-81.0,-87.0,-79.0,-84.0,15.0,15.0,16.0,14.0,1
1212,CC:2F:71:3F:1F:24,3959472,2695154659,1837477,2425843190,2121995,269311469,2565,1503382,1925882185,1502278,1925757291,1104,124894,1486138,6083,1837241,182324,2565,1782,104000.0,1000.0,-67.0,-63.0,-67.0,-69.0,-66.0,-63.0,-66.0,-69.0,-81.0,-87.0,-79.0,-84.0,14.0,24.0,12.0,15.0,1
1213,CC:2F:71:3E:C5:1F,5528886,4451568946,3406889,4182257275,2121997,269311671,502,93176,7997307,78588,6268283,14588,1729024,21526,528,3414278,870679,502,2926,13000.0,1000.0,-72.0,-72.0,-69.0,-61.0,-69.0,-71.0,-66.0,-60.0,-81.0,-87.0,-79.0,-84.0,9.0,15.0,10.0,23.0,1
1214,F8:59:71:5A:E0:3D,3415800,2208446123,1293799,1939134048,2122001,269312075,294,730440,890260303,729759,890178300,681,82003,719410,1840,1293915,152699,294,1077,144444.0,43333.0,-67.0,-73.0,-63.0,-70.0,-66.0,-72.0,-62.0,-69.0,-81.0,-87.0,-79.0,-84.0,14.0,14.0,16.0,14.0,1
1215,CC:2F:71:3F:1F:24,3959640,2695365365,1837639,2426053290,2122001,269312075,2565,1503529,1926079796,1502425,1925954902,1104,124894,1486285,6083,1837405,182416,2565,1782,86667.0,14444.0,-67.0,-63.0,-67.0,-69.0,-67.0,-63.0,-67.0,-69.0,-81.0,-87.0,-79.0,-84.0,14.0,24.0,12.0,15.0,1
1216,CC:2F:71:3E:C5:1F,5528890,4451569350,3406889,4182257275,2122001,269312075,502,93176,7997307,78588,6268283,14588,1729024,21526,528,3414278,870679,502,2926,13000.0,1000.0,-72.0,-72.0,-69.0,-61.0,-69.0,-71.0,-66.0,-60.0,-81.0,-87.0,-79.0,-84.0,9.0,15.0,10.0,23.0,1
1217,F8:59:71:5A:E0:3D,3415869,2208544608,1293868,1939232533,2122001,269312075,294,730509,890362247,729828,890280244,681,82003,719478,1840,1293984,152719,294,1077,144444.0,43333.0,-67.0,-73.0,-63.0,-70.0,-67.0,-72.0,-63.0,-70.0,-82.0,-87.0,-81.0,-85.0,15.0,14.0,18.0,15.0,1
1218,CC:2F:71:3F:1F:24,3959799,2695572563,1837798,2426260488,2122001,269312075,2565,1503675,1926280076,1502571,1926155182,1104,124894,1486431,6083,1837564,182473,2565,1782,86667.0,14444.0,-70.0,-63.0,-73.0,-70.0,-68.0,-63.0,-68.0,-69.0,-82.0,-87.0,-81.0,-85.0,12.0,24.0,8.0,15.0,1
1219,CC:2F:71:3E:C5:1F,5528891,4451569412,3406889,4182257275,2122002,269312137,502,93177,7997425,78588,6268283,14589,1729142,21527,528,3414278,870679,502,2926,13000.0,1000.0,-69.0,-71.0,-66.0,-61.0,-69.0,-71.0,-66.0,-60.0,-82.0,-87.0,-81.0,-85.0,13.0,16.0,15.0,24.0,1
1220,F8:59:71:5A:E0:3D,3416092,2208864635,1294083,1939551832,2122009,269312803,294,730620,890475883,729939,890393880,681,82003,719589,1840,1294199,152742,294,1077,144444.0,39000.0,-66.0,-73.0,-63.0,-68.0,-66.0,-73.0,-63.0,-69.0,-82.0,-87.0,-81.0,-85.0,16.0,14.0,18.0,17.0,1
1221,CC:2F:71:3F:1F:24,3960002,2695796610,1837991,2426483605,2122011,269313005,2565,1503852,1926491720,1502748,1926366826,1104,124894,1486608,6083,1837757,182586,2565,1782,86667.0,14444.0,-68.0,-64.0,-68.0,-69.0,-68.0,-63.0,-68.0,-69.0,-82.0,-87.0,-81.0,-85.0,14.0,23.0,13.0,16.0,1
1222,CC:2F:71:3E:C5:1F,5528900,4451570280,3406889,4182257275,2122011,269313005,502,93177,7997425,78588,6268283,14589,1729142,21527,528,3414278,870679,502,2926,13000.0,1000.0,-69.0,-71.0,-66.0,-61.0,-69.0,-71.0,-66.0,-60.0,-82.0,-87.0,-81.0,-85.0,13.0,16.0,15.0,24.0,1
1223,F8:59:71:5A:E0:3D,3416308,2209197804,1294297,1939884799,2122011,269313005,294,730715,890591394,730034,890509391,681,82003,719683,1840,1294413,152748,294,1077,144444.0,43333.0,-68.0,-74.0,-64.0,-71.0,-67.0,-73.0,-63.0,-70.0,-82.0,-87.0,-81.0,-85.0,14.0,13.0,17.0,14.0,1
1224,CC:2F:71:3F:1F:24,3960173,2696021160,1838162,2426708155,2122011,269313005,2565,1504009,1926707710,1502905,1926582816,1104,124894,1486765,6083,1837928,182628,2565,1782,86667.0,14444.0,-69.0,-64.0,-73.0,-71.0,-67.0,-64.0,-68.0,-70.0,-82.0,-87.0,-81.0,-85.0,13.0,23.0,8.0,14.0,1
1225,CC:2F:71:3E:C5:1F,5528900,4451570280,3406889,4182257275,2122011,269313005,502,93177,7997425,78588,6268283,14589,1729142,21527,528,3414278,870679,502,2926,13000.0,1000.0,-69.0,-71.0,-66.0,-61.0,-69.0,-71.0,-66.0,-60.0,-83.0,-88.0,-82.0,-86.0,14.0,17.0,16.0,25.0,1
1226,F8:59:71:5A:E0:3D,3416378,2209297866,1294361,1939984255,2122017,269313611,294,730779,890689954,730098,890607951,681,82003,719747,1840,1294477,152755,294,1077,144444.0,43333.0,-67.0,-73.0,-66.0,-71.0,-66.0,-72.0,-64.0,-70.0,-83.0,-88.0,-82.0,-86.0,16.0,15.0,16.0,15.0,1
1227,CC:2F:71:3F:1F:24,3960356,2696235147,1838337,2426921334,2122019,269313813,2565,1504175,1926912595,1503071,1926787701,1104,124894,1486931,6083,1838103,182653,2565,1782,86667.0,14444.0,-70.0,-64.0,-72.0,-72.0,-69.0,-64.0,-70.0,-71.0,-83.0,-88.0,-82.0,-86.0,13.0,24.0,10.0,14.0,1
1228,CC:2F:71:3E:C5:1F,5528908,4451571088,3406889,4182257275,2122019,269313813,502,93177,7997425,78588,6268283,14589,1729142,21527,528,3414278,870679,502,2926,13000.0,1000.0,-69.0,-71.0,-66.0,-61.0,-69.0,-71.0,-66.0,-60.0,-83.0,-88.0,-82.0,-86.0,14.0,17.0,16.0,25.0,1
1229,F8:59:71:5A:E0:3D,3416457,2209403621,1294437,1940089748,2122020,269313873,294,730852,890795398,730171,890713395,681,82003,719820,1840,1294553,152765,294,1077,144444.0,43333.0,-65.0,-72.0,-64.0,-70.0,-66.0,-72.0,-64.0,-70.0,-83.0,-88.0,-82.0,-86.0,18.0,16.0,18.0,16.0,1
1230,CC:2F:71:3F:1F:24,3960519,2696446675,1838499,2427132802,2122020,269313873,2565,1504325,1927116215,1503221,1926991321,1104,124894,1487081,6083,1838265,182714,2565,1782,86667.0,14444.0,-67.0,-64.0,-67.0,-68.0,-67.0,-64.0,-68.0,-68.0,-83.0,-88.0,-82.0,-86.0,16.0,24.0,15.0,18.0,1
1231,CC:2F:71:3E:C5:1F,5528909,4451571148,3406889,4182257275,2122020,269313873,502,93177,7997425,78588,6268283,14589,1729142,21527,528,3414278,870679,502,2926,13000.0,1000.0,-69.0,-71.0,-66.0,-61.0,-69.0,-71.0,-66.0,-60.0,-83.0,-88.0,-82.0,-86.0,14.0,17.0,16.0,25.0,1
1232,F8:59:71:5A:E0:3D,3416529,2209506791,1294503,1940192312,2122026,269314479,294,730919,890898578,730238,890816575,681,82003,719887,1840,1294619,152771,294,1077,144444.0,43333.0,-67.0,-73.0,-65.0,-71.0,-66.0,-72.0,-64.0,-70.0,-82.0,-87.0,-81.0,-85.0,15.0,14.0,16.0,14.0,1
1233,CC:2F:71:3F:1F:24,3962279,2698970251,1840253,2429655772,2122026,269314479,2565,1504708,1927359504,1503604,1927234610,1104,124894,1487463,6083,1840018,182859,2565,1782,86667.0,14444.0,-67.0,-64.0,-67.0,-70.0,-67.0,-64.0,-67.0,-69.0,-82.0,-87.0,-81.0,-85.0,15.0,23.0,14.0,15.0,1
1234,CC:2F:71:3E:C5:1F,5528915,4451571754,3406889,4182257275,2122026,269314479,502,93177,7997425,78588,6268283,14589,1729142,21527,528,3414278,870679,502,2926,13000.0,1000.0,-69.0,-71.0,-66.0,-61.0,-69.0,-71.0,-66.0,-60.0,-82.0,-87.0,-81.0,-85.0,13.0,16.0,15.0,24.0,1
1235,F8:59:71:5A:E0:3D,3416747,2209798670,1294718,1940483929,2122029,269314741,294,731003,891001245,730322,890919242,681,82003,719971,1840,1294834,152777,294,1077,144444.0,43333.0,-68.0,-73.0,-65.0,-71.0,-66.0,-72.0,-63.0,-69.0,-82.0,-87.0,-81.0,-85.0,14.0,14.0,16.0,14.0,1
1236,CC:2F:71:3F:1F:24,3962440,2699176269,1840411,2429861528,2122029,269314741,2565,1504853,1927559724,1503749,1927434830,1104,124894,1487606,6083,1840177,182865,2565,1782,86667.0,14444.0,-68.0,-64.0,-67.0,-70.0,-68.0,-64.0,-69.0,-69.0,-82.0,-87.0,-81.0,-85.0,14.0,23.0,14.0,15.0,1
1237,CC:2F:71:3E:C5:1F,5528918,4451572016,3406889,4182257275,2122029,269314741,502,93177,7997425,78588,6268283,14589,1729142,21527,528,3414278,870679,502,2926,13000.0,1000.0,-69.0,-71.0,-66.0,-61.0,-69.0,-71.0,-66.0,-60.0,-82.0,-87.0,-81.0,-85.0,13.0,16.0,15.0,24.0,1
1238,F8:59:71:5A:E0:3D,3416814,2209895484,1294780,1940580277,2122034,269315207,294,731067,891098383,730385,891016262,682,82121,720035,1840,1294896,152785,294,1078,144444.0,43333.0,-68.0,-73.0,-65.0,-71.0,-67.0,-72.0,-64.0,-70.0,-82.0,-87.0,-81.0,-85.0,14.0,14.0,16.0,14.0,1
1239,CC:2F:71:3F:1F:24,3962601,2699380583,1840567,2430065376,2122034,269315207,2565,1505002,1927757504,1503898,1927632610,1104,124894,1487755,6083,1840333,182878,2565,1782,65000.0,13000.0,-68.0,-64.0,-67.0,-69.0,-68.0,-64.0,-67.0,-69.0,-82.0,-87.0,-81.0,-85.0,14.0,23.0,14.0,16.0,1
1240,CC:2F:71:3E:C5:1F,5528925,4451572684,3406889,4182257275,2122036,269315409,502,93177,7997425,78588,6268283,14589,1729142,21527,528,3414278,870679,502,2926,13000.0,1000.0,-69.0,-71.0,-66.0,-61.0,-69.0,-71.0,-66.0,-60.0,-82.0,-87.0,-81.0,-85.0,13.0,16.0,15.0,24.0,1
1241,F8:59:71:5A:E0:3D,3416932,2210068903,1294893,1940753019,2122039,269315884,294,731144,891204672,730462,891122551,682,82121,720112,1840,1295009,152799,294,1078,144444.0,43333.0,-67.0,-72.0,-64.0,-69.0,-66.0,-72.0,-63.0,-69.0,-82.0,-87.0,-81.0,-85.0,15.0,15.0,17.0,16.0,1
1242,CC:2F:71:3F:1F:24,3962768,2699593176,1840729,2430277292,2122039,269315884,2565,1505152,1927962562,1504048,1927837668,1104,124894,1487905,6083,1840495,182884,2565,1782,104000.0,26000.0,-68.0,-64.0,-66.0,-70.0,-69.0,-63.0,-68.0,-70.0,-82.0,-87.0,-81.0,-85.0,14.0,23.0,15.0,15.0,1
1243,CC:2F:71:3E:C5:1F,5528928,4451573159,3406889,4182257275,2122039,269315884,502,93177,7997425,78588,6268283,14589,1729142,21527,528,3414278,870679,502,2926,13000.0,1000.0,-69.0,-71.0,-66.0,-61.0,-69.0,-71.0,-66.0,-60.0,-82.0,-87.0,-81.0,-85.0,13.0,16.0,15.0,24.0,1
1244,F8:59:71:5A:E0:3D,3417003,2210169140,1294960,1940852932,2122043,269316208,294,731212,891305659,730530,891223538,682,82121,720179,1840,1295076,152806,294,1078,144444.0,43333.0,-68.0,-72.0,-65.0,-72.0,-67.0,-72.0,-64.0,-71.0,-82.0,-87.0,-81.0,-85.0,14.0,15.0,16.0,13.0,1
1245,CC:2F:71:3F:1F:24,3962943,2699806847,1840900,2430490639,2122043,269316208,2565,1505309,1928164396,1504204,1928039384,1105,125012,1488061,6083,1840664,182944,2565,1782,115556.0,28889.0,-69.0,-64.0,-67.0,-70.0,-68.0,-63.0,-67.0,-69.0,-82.0,-87.0,-81.0,-85.0,13.0,23.0,14.0,15.0,1
1246,CC:2F:71:3E:C5:1F,5528934,4451573685,3406889,4182257275,2122045,269316410,502,93177,7997425,78588,6268283,14589,1729142,21527,528,3414278,870679,502,2926,13000.0,1000.0,-69.0,-71.0,-66.0,-61.0,-69.0,-71.0,-66.0,-60.0,-81.0,-87.0,-79.0,-84.0,12.0,16.0,13.0,23.0,1
1247,F8:59:71:5A:E0:3D,3417075,2210272310,1295026,1940955496,2122049,269316814,294,731279,891408839,730597,891326718,682,82121,720246,1840,1295142,152814,294,1078,144444.0,43333.0,-66.0,-71.0,-63.0,-69.0,-66.0,-72.0,-63.0,-70.0,-81.0,-87.0,-79.0,-84.0,15.0,16.0,16.0,15.0,1
1248,CC:2F:71:3F:1F:24,3963119,2700024533,1841070,2430707719,2122049,269316814,2565,1505466,1928374757,1504361,1928249745,1105,125012,1488218,6083,1840836,182959,2565,1782,115556.0,28889.0,-71.0,-64.0,-71.0,-71.0,-70.0,-64.0,-70.0,-70.0,-81.0,-87.0,-79.0,-84.0,10.0,23.0,8.0,13.0,1
1249,CC:2F:71:3E:C5:1F,5528938,4451574089,3406889,4182257275,2122049,269316814,502,93177,7997425,78588,6268283,14589,1729142,21527,528,3414278,870679,502,2926,13000.0,1000.0,-69.0,-71.0,-66.0,-61.0,-69.0,-71.0,-66.0,-60.0,-81.0,-87.0,-79.0,-84.0,12.0,16.0,13.0,23.0,1
1250,F8:59:71:5A:E0:3D,3417342,2210686691,1295292,1941369743,2122050,269316948,294,731403,891516248,730721,891434127,682,82121,720370,1840,1295408,152837,294,1078,144444.0,43333.0,-67.0,-72.0,-65.0,-71.0,-67.0,-72.0,-64.0,-70.0,-81.0,-87.0,-79.0,-84.0,14.0,15.0,14.0,13.0,1
1251,CC:2F:71:3F:1F:24,3963279,2700230715,1841228,2430913699,2122051,269317016,2565,1505611,1928572073,1504506,1928447061,1105,125012,1488363,6083,1840994,182975,2565,1782,115556.0,28889.0,-71.0,-64.0,-71.0,-71.0,-69.0,-64.0,-68.0,-70.0,-81.0,-87.0,-79.0,-84.0,10.0,23.0,8.0,13.0,1
1252,CC:2F:71:3E:C5:1F,5528940,4451574291,3406889,4182257275,2122051,269317016,502,93177,7997425,78588,6268283,14589,1729142,21527,528,3414278,870679,502,2926,13000.0,1000.0,-69.0,-71.0,-66.0,-61.0,-69.0,-71.0,-66.0,-60.0,-81.0,-87.0,-79.0,-84.0,12.0,16.0,13.0,23.0,1
1253,F8:59:71:5A:E0:3D,3417413,2210785327,1295355,1941467645,2122058,269317682,294,731466,891613268,730784,891531147,682,82121,720433,1840,1295471,152848,294,1078,144444.0,43333.0,-66.0,-71.0,-64.0,-70.0,-66.0,-71.0,-63.0,-69.0,-81.0,-87.0,-79.0,-84.0,15.0,16.0,15.0,14.0,1
1254,CC:2F:71:3F:1F:24,3963444,2700437697,1841386,2431120015,2122058,269317682,2565,1505753,1928769069,1504648,1928644057,1105,125012,1488505,6083,1841152,182986,2565,1782,115556.0,28889.0,-68.0,-64.0,-66.0,-70.0,-68.0,-64.0,-67.0,-69.0,-81.0,-87.0,-79.0,-84.0,13.0,23.0,13.0,14.0,1
1255,CC:2F:71:3E:C5:1F,5528947,4451574957,3406889,4182257275,2122058,269317682,502,93177,7997425,78588,6268283,14589,1729142,21527,529,3414279,870680,502,2926,13000.0,1000.0,-69.0,-71.0,-66.0,-61.0,-69.0,-71.0,-66.0,-60.0,-81.0,-87.0,-79.0,-84.0,12.0,16.0,13.0,23.0,1
1256,F8:59:71:5A:E0:3D,3417476,2210883005,1295418,1941565323,2122058,269317682,294,731529,891710288,730847,891628167,682,82121,720496,1840,1295534,152858,294,1078,144444.0,43333.0,-67.0,-72.0,-64.0,-69.0,-67.0,-72.0,-64.0,-70.0,-81.0,-87.0,-79.0,-84.0,14.0,15.0,15.0,15.0,1
1257,CC:2F:71:3F:1F:24,3963601,2700642459,1841543,2431324777,2122058,269317682,2565,1505900,1928966617,1504795,1928841605,1105,125012,1488652,6083,1841309,183009,2565,1782,115556.0,28889.0,-71.0,-64.0,-71.0,-71.0,-70.0,-64.0,-69.0,-70.0,-81.0,-87.0,-79.0,-84.0,10.0,23.0,8.0,13.0,1
1258,CC:2F:71:3E:C5:1F,5528947,4451574957,3406889,4182257275,2122058,269317682,502,93177,7997425,78588,6268283,14589,1729142,21527,529,3414279,870680,502,2926,13000.0,1000.0,-69.0,-71.0,-66.0,-61.0,-69.0,-71.0,-66.0,-60.0,-81.0,-87.0,-79.0,-84.0,12.0,16.0,13.0,23.0,1
1259,F8:59:71:5A:E0:3D,3417773,2211298796,1295709,1941980508,2122064,269318288,294,731635,891815758,730953,891733637,682,82121,720602,1840,1295825,152872,294,1078,144444.0,43333.0,-69.0,-73.0,-66.0,-71.0,-68.0,-72.0,-65.0,-70.0,-81.0,-87.0,-79.0,-84.0,12.0,14.0,13.0,13.0,1
1260,CC:2F:71:3F:1F:24,3963799,2700861454,1841733,2431542964,2122066,269318490,2565,1506076,1929177116,1504971,1929052104,1105,125012,1488827,6083,1841499,183046,2565,1782,104000.0,26000.0,-69.0,-64.0,-67.0,-69.0,-69.0,-64.0,-68.0,-70.0,-81.0,-87.0,-79.0,-84.0,12.0,23.0,12.0,15.0,1
1261,CC:2F:71:3E:C5:1F,5528955,4451575765,3406889,4182257275,2122066,269318490,502,93177,7997425,78588,6268283,14589,1729142,21527,529,3414279,870680,502,2926,13000.0,1000.0,-69.0,-71.0,-66.0,-61.0,-69.0,-71.0,-66.0,-60.0,-81.0,-87.0,-79.0,-84.0,12.0,16.0,13.0,23.0,1
1262,F8:59:71:5A:E0:3D,3417840,2211397090,1295773,1942078540,2122067,269318550,294,731699,891912894,731017,891830773,682,82121,720666,1840,1295889,152884,294,1078,144444.0,43333.0,-69.0,-73.0,-66.0,-72.0,-68.0,-72.0,-65.0,-70.0,-80.0,-86.0,-78.0,-83.0,11.0,13.0,12.0,11.0,1
1263,CC:2F:71:3F:1F:24,3963960,2701068003,1841893,2431749453,2122067,269318550,2565,1506222,1929373153,1505117,1929248141,1105,125012,1488973,6083,1841659,183055,2565,1782,115556.0,28889.0,-71.0,-64.0,-71.0,-71.0,-69.0,-64.0,-68.0,-69.0,-80.0,-86.0,-78.0,-83.0,9.0,22.0,7.0,12.0,1
1264,CC:2F:71:3E:C5:1F,5528956,4451575825,3406889,4182257275,2122067,269318550,502,93177,7997425,78588,6268283,14589,1729142,21527,529,3414279,870680,502,2926,13000.0,1000.0,-69.0,-71.0,-66.0,-61.0,-69.0,-71.0,-66.0,-60.0,-80.0,-86.0,-78.0,-83.0,11.0,15.0,12.0,22.0,1
1265,F8:59:71:5A:E0:3D,3417911,2211495897,1295838,1942176741,2122073,269319156,294,731766,892010325,731084,891928204,682,82121,720731,1840,1295954,152894,294,1078,144444.0,43333.0,-69.0,-73.0,-66.0,-71.0,-68.0,-72.0,-65.0,-70.0,-80.0,-86.0,-78.0,-83.0,11.0,13.0,12.0,12.0,1
1266,CC:2F:71:3F:1F:24,3964123,2701274795,1842050,2431955639,2122073,269319156,2565,1506364,1929570121,1505259,1929445109,1105,125012,1489115,6083,1841815,183065,2565,1782,115556.0,28889.0,-67.0,-64.0,-66.0,-70.0,-68.0,-64.0,-68.0,-69.0,-80.0,-86.0,-78.0,-83.0,13.0,22.0,12.0,13.0,1
1267,CC:2F:71:3E:C5:1F,5528962,4451576431,3406889,4182257275,2122073,269319156,502,93177,7997425,78588,6268283,14589,1729142,21527,529,3414279,870680,502,2926,13000.0,1000.0,-69.0,-71.0,-66.0,-61.0,-69.0,-71.0,-66.0,-60.0,-80.0,-86.0,-78.0,-83.0,11.0,15.0,12.0,22.0,1
1268,F8:59:71:5A:E0:3D,3418129,2211832083,1296054,1942512725,2122075,269319358,294,731857,892118146,731175,892036025,682,82121,720820,1840,1296170,152912,294,1078,144444.0,43333.0,-66.0,-71.0,-64.0,-69.0,-68.0,-73.0,-66.0,-71.0,-80.0,-86.0,-78.0,-83.0,14.0,15.0,14.0,14.0,1
1269,CC:2F:71:3F:1F:24,3964289,2701490189,1842214,2432170831,2122075,269319358,2565,1506512,1929776427,1505407,1929651415,1105,125012,1489263,6083,1841980,183102,2565,1782,115556.0,28889.0,-71.0,-64.0,-71.0,-71.0,-70.0,-64.0,-69.0,-70.0,-80.0,-86.0,-78.0,-83.0,9.0,22.0,7.0,12.0,1
1270,CC:2F:71:3E:C5:1F,5528964,4451576633,3406889,4182257275,2122075,269319358,502,93177,7997425,78588,6268283,14589,1729142,21527,529,3414279,870680,502,2926,13000.0,1000.0,-69.0,-71.0,-66.0,-61.0,-69.0,-71.0,-66.0,-60.0,-80.0,-86.0,-78.0,-83.0,11.0,15.0,12.0,22.0,1
1271,F8:59:71:5A:E0:3D,3418295,2212078753,1296213,1942758729,2122082,269320024,294,731948,892223179,731266,892141058,682,82121,720911,1840,1296329,152923,294,1079,144444.0,43333.0,-68.0,-73.0,-65.0,-71.0,-66.0,-72.0,-64.0,-70.0,-78.0,-85.0,-77.0,-82.0,10.0,12.0,12.0,11.0,1
1272,CC:2F:71:3F:1F:24,3964455,2701699925,1842373,2432379901,2122082,269320024,2565,1506655,1929974935,1505550,1929849923,1105,125012,1489406,6083,1842139,183128,2565,1782,115556.0,28889.0,-71.0,-64.0,-71.0,-70.0,-70.0,-64.0,-69.0,-69.0,-78.0,-85.0,-77.0,-82.0,7.0,21.0,6.0,12.0,1
1273,CC:2F:71:3E:C5:1F,5528971,4451577299,3406889,4182257275,2122082,269320024,502,93177,7997425,78588,6268283,14589,1729142,21527,529,3414279,870680,502,2926,13000.0,1000.0,-69.0,-71.0,-66.0,-61.0,-69.0,-71.0,-66.0,-60.0,-78.0,-85.0,-77.0,-82.0,9.0,14.0,11.0,21.0,1
1274,F8:59:71:5A:E0:3D,3418370,2212179680,1296286,1942859454,2122084,269320226,294,732018,892324671,731336,892242550,682,82121,720981,1840,1296402,152931,294,1079,144444.0,43333.0,-68.0,-73.0,-65.0,-72.0,-67.0,-72.0,-64.0,-70.0,-78.0,-85.0,-77.0,-82.0,10.0,12.0,12.0,10.0,1
1275,CC:2F:71:3F:1F:24,3964614,2701903629,1842530,2432583403,2122084,269320226,2565,1506801,1930172423,1505696,1930047411,1105,125012,1489552,6083,1842296,183143,2565,1782,115556.0,28889.0,-71.0,-64.0,-71.0,-70.0,-69.0,-64.0,-68.0,-69.0,-78.0,-85.0,-77.0,-82.0,7.0,21.0,6.0,12.0,1
1276,CC:2F:71:3E:C5:1F,5528973,4451577501,3406889,4182257275,2122084,269320226,502,93177,7997425,78588,6268283,14589,1729142,21527,529,3414279,870680,502,2926,13000.0,1000.0,-69.0,-71.0,-66.0,-61.0,-69.0,-71.0,-66.0,-60.0,-78.0,-85.0,-77.0,-82.0,9.0,14.0,11.0,21.0,1
1277,F8:59:71:5A:E0:3D,3418443,2212280088,1296353,1942959256,2122090,269320832,294,732087,892427166,731405,892345045,682,82121,721050,1840,1296469,152947,294,1079,144444.0,43333.0,-68.0,-72.0,-65.0,-72.0,-67.0,-71.0,-64.0,-71.0,-78.0,-85.0,-77.0,-82.0,10.0,13.0,12.0,10.0,1
1278,CC:2F:71:3F:1F:24,3964778,2702111751,1842688,2432790919,2122090,269320832,2565,1506944,1930369507,1505839,1930244495,1105,125012,1489695,6083,1842454,183179,2565,1782,115556.0,28889.0,-68.0,-64.0,-66.0,-69.0,-68.0,-64.0,-67.0,-69.0,-78.0,-85.0,-77.0,-82.0,10.0,21.0,11.0,13.0,1
1279,CC:2F:71:3E:C5:1F,5528979,4451578107,3406889,4182257275,2122090,269320832,502,93177,7997425,78588,6268283,14589,1729142,21527,529,3414279,870680,502,2926,13000.0,1000.0,-69.0,-71.0,-66.0,-61.0,-69.0,-71.0,-66.0,-60.0,-78.0,-85.0,-77.0,-82.0,9.0,14.0,11.0,21.0,1
1280,F8:59:71:5A:E0:3D,3418509,2212378252,1296416,1943057158,2122093,269321094,294,732149,892522646,731467,892440525,682,82121,721112,1840,1296532,152963,294,1079,144444.0,43333.0,-67.0,-72.0,-65.0,-69.0,-67.0,-72.0,-65.0,-70.0,-79.0,-86.0,-78.0,-83.0,12.0,14.0,13.0,14.0,1
1281,CC:2F:71:3F:1F:24,3964944,2702321451,1842851,2433000357,2122093,269321094,2565,1507092,1930569601,1505987,1930444589,1105,125012,1489843,6083,1842617,183195,2565,1782,115556.0,28889.0,-68.0,-64.0,-67.0,-69.0,-68.0,-64.0,-67.0,-69.0,-79.0,-86.0,-78.0,-83.0,11.0,22.0,11.0,14.0,1
1282,CC:2F:71:3E:C5:1F,5528982,4451578369,3406889,4182257275,2122093,269321094,502,93177,7997425,78588,6268283,14589,1729142,21527,529,3414279,870680,502,2926,13000.0,1000.0,-69.0,-71.0,-66.0,-61.0,-69.0,-71.0,-66.0,-60.0,-79.0,-86.0,-78.0,-83.0,10.0,15.0,12.0,22.0,1
1283,F8:59:71:5A:E0:3D,3418700,2212646887,1296607,1943325793,2122093,269321094,294,732245,892628128,731563,892546007,682,82121,721208,1840,1296723,153000,294,1079,144444.0,43333.0,-67.0,-71.0,-64.0,-70.0,-67.0,-72.0,-64.0,-70.0,-79.0,-86.0,-78.0,-83.0,12.0,15.0,14.0,13.0,1
1284,CC:2F:71:3F:1F:24,3965108,2702531167,1843011,2433209669,2122097,269321498,2565,1507237,1930767085,1506132,1930642073,1105,125012,1489988,6083,1842777,183214,2565,1782,104000.0,26000.0,-71.0,-64.0,-71.0,-70.0,-68.0,-64.0,-68.0,-69.0,-79.0,-86.0,-78.0,-83.0,8.0,22.0,7.0,13.0,1
1285,CC:2F:71:3E:C5:1F,5528989,4451579248,3406889,4182257275,2122100,269321973,502,93177,7997425,78588,6268283,14589,1729142,21527,529,3414279,870680,502,2926,13000.0,1000.0,-69.0,-71.0,-66.0,-61.0,-69.0,-71.0,-66.0,-60.0,-79.0,-86.0,-78.0,-83.0,10.0,15.0,12.0,22.0,1
1286,F8:59:71:5A:E0:3D,3418858,2212877307,1296756,1943555132,2122102,269322175,294,732323,892730485,731641,892648364,682,82121,721286,1840,1296872,153041,294,1080,144444.0,43333.0,-68.0,-72.0,-65.0,-72.0,-66.0,-71.0,-64.0,-70.0,-79.0,-86.0,-78.0,-83.0,11.0,14.0,13.0,11.0,1
1287,CC:2F:71:3F:1F:24,3965272,2702737660,1843169,2433415425,2122103,269322235,2565,1507383,1930967365,1506278,1930842353,1105,125012,1490134,6083,1842935,183240,2565,1782,115556.0,28889.0,-68.0,-64.0,-66.0,-68.0,-68.0,-64.0,-67.0,-69.0,-79.0,-86.0,-78.0,-83.0,11.0,22.0,12.0,15.0,1
1288,CC:2F:71:3E:C5:1F,5528992,4451579510,3406889,4182257275,2122103,269322235,502,93177,7997425,78588,6268283,14589,1729142,21527,529,3414279,870680,502,2926,13000.0,1000.0,-69.0,-71.0,-66.0,-61.0,-69.0,-71.0,-66.0,-60.0,-79.0,-86.0,-78.0,-83.0,10.0,15.0,12.0,22.0,1
1289,F8:59:71:5A:E0:3D,3418922,2212975101,1296819,1943652866,2122103,269322235,294,732387,892829045,731705,892746924,682,82121,721350,1840,1296935,153054,294,1080,144444.0,43333.0,-67.0,-72.0,-63.0,-70.0,-66.0,-71.0,-63.0,-69.0,-79.0,-86.0,-78.0,-83.0,12.0,14.0,15.0,13.0,1
1290,CC:2F:71:3F:1F:24,3965437,2702953576,1843334,2433631341,2122103,269322235,2565,1507533,1931166719,1506428,1931041707,1105,125012,1490284,6083,1843100,183275,2565,1782,115556.0,28889.0,-67.0,-63.0,-66.0,-69.0,-67.0,-63.0,-66.0,-68.0,-79.0,-86.0,-78.0,-83.0,12.0,23.0,12.0,14.0,1
1291,CC:2F:71:3E:C5:1F,5528996,4451579914,3406889,4182257275,2122107,269322639,502,93177,7997425,78588,6268283,14589,1729142,21527,529,3414279,870680,502,2926,13000.0,1000.0,-69.0,-71.0,-66.0,-61.0,-69.0,-71.0,-66.0,-60.0,-79.0,-86.0,-78.0,-83.0,10.0,15.0,12.0,22.0,1
1292,F8:59:71:5A:E0:3D,3419010,2213084751,1296897,1943761340,2122113,269323411,294,732462,892937352,731780,892855231,682,82121,721425,1840,1297013,153063,294,1080,144444.0,43333.0,-67.0,-72.0,-63.0,-70.0,-66.0,-71.0,-63.0,-69.0,-79.0,-86.0,-78.0,-83.0,12.0,14.0,15.0,13.0,1
1293,CC:2F:71:3F:1F:24,3965628,2703171098,1843515,2433847687,2122113,269323411,2565,1507699,1931380762,1506594,1931255750,1105,125012,1490450,6083,1843281,183311,2565,1782,115556.0,28889.0,-68.0,-64.0,-66.0,-69.0,-67.0,-64.0,-66.0,-69.0,-79.0,-86.0,-78.0,-83.0,11.0,22.0,12.0,14.0,1
1294,CC:2F:71:3E:C5:1F,5529003,4451580746,3406890,4182257335,2122113,269323411,502,93177,7997425,78588,6268283,14589,1729142,21527,529,3414280,870680,502,2926,13000.0,1000.0,-69.0,-71.0,-66.0,-61.0,-69.0,-71.0,-66.0,-60.0,-79.0,-86.0,-78.0,-83.0,10.0,15.0,12.0,22.0,1
1295,F8:59:71:5A:E0:3D,3419074,2213182713,1296960,1943859242,2122114,269323471,294,732525,893034372,731843,892952251,682,82121,721488,1840,1297076,153074,294,1080,144444.0,43333.0,-66.0,-72.0,-63.0,-69.0,-66.0,-71.0,-63.0,-69.0,-79.0,-86.0,-78.0,-83.0,13.0,14.0,15.0,14.0,1
1296,CC:2F:71:3F:1F:24,3965787,2703377474,1843673,2434054003,2122114,269323471,2565,1507845,1931579618,1506740,1931454606,1105,125012,1490596,6083,1843439,183332,2565,1782,115556.0,28889.0,-68.0,-64.0,-67.0,-69.0,-67.0,-64.0,-66.0,-69.0,-79.0,-86.0,-78.0,-83.0,11.0,22.0,11.0,14.0,1
1297,CC:2F:71:3E:C5:1F,5529005,4451580868,3406890,4182257335,2122115,269323533,502,93178,7997543,78588,6268283,14590,1729260,21528,529,3414280,870680,502,2926,13000.0,1000.0,-73.0,-73.0,-69.0,-61.0,-69.0,-71.0,-67.0,-60.0,-79.0,-86.0,-78.0,-83.0,6.0,13.0,9.0,22.0,1
1298,F8:59:71:5A:E0:3D,3419372,2213594493,1297249,1944270152,2122123,269324341,294,732633,893165444,731951,893083323,682,82121,721596,1840,1297365,153100,294,1081,144444.0,43333.0,-67.0,-72.0,-63.0,-69.0,-67.0,-71.0,-64.0,-70.0,-79.0,-85.0,-78.0,-82.0,12.0,13.0,15.0,13.0,1
1299,CC:2F:71:3F:1F:24,3967604,2705980096,1845481,2436655755,2122123,269324341,2565,1508179,1931852935,1507074,1931727923,1105,125012,1490930,6083,1845246,184090,2565,1782,115556.0,28889.0,-68.0,-64.0,-66.0,-69.0,-68.0,-64.0,-66.0,-69.0,-79.0,-85.0,-78.0,-82.0,11.0,21.0,12.0,13.0,1
1300,CC:2F:71:3E:C5:1F,5529013,4451581676,3406890,4182257335,2122123,269324341,502,93178,7997543,78588,6268283,14590,1729260,21528,529,3414280,870680,502,2926,13000.0,1000.0,-73.0,-73.0,-69.0,-61.0,-69.0,-71.0,-67.0,-60.0,-79.0,-85.0,-78.0,-82.0,6.0,12.0,9.0,21.0,1
1301,F8:59:71:5A:E0:3D,3419436,2213692457,1297312,1944368054,2122124,269324403,294,732696,893261042,732013,893178803,683,82239,721659,1840,1297428,153118,294,1081,144444.0,43333.0,-67.0,-72.0,-64.0,-70.0,-67.0,-72.0,-63.0,-70.0,-79.0,-85.0,-78.0,-82.0,12.0,13.0,14.0,12.0,1
1302,CC:2F:71:3F:1F:24,3967767,2706185674,1845643,2436861271,2122124,269324403,2565,1508327,1932047892,1507222,1931922880,1105,125012,1491078,6083,1845408,184111,2565,1782,115556.0,28889.0,-68.0,-64.0,-66.0,-69.0,-68.0,-64.0,-67.0,-69.0,-79.0,-85.0,-78.0,-82.0,11.0,21.0,12.0,13.0,1
1303,CC:2F:71:3E:C5:1F,5529014,4451581738,3406890,4182257335,2122124,269324403,502,93178,7997543,78588,6268283,14590,1729260,21528,529,3414280,870680,502,2926,13000.0,1000.0,-73.0,-73.0,-69.0,-61.0,-69.0,-71.0,-67.0,-60.0,-79.0,-85.0,-78.0,-82.0,6.0,12.0,9.0,21.0,1
1304,F8:59:71:5A:E0:3D,3419732,2214136423,1297599,1944811152,2122133,269325271,294,732821,893368609,732138,893286370,683,82239,721784,1840,1297713,153153,294,1081,144444.0,43333.0,-65.0,-71.0,-64.0,-69.0,-66.0,-71.0,-64.0,-70.0,-79.0,-85.0,-78.0,-82.0,14.0,14.0,14.0,13.0,1
1305,CC:2F:71:3F:1F:24,3967932,2706390782,1845799,2437065511,2122133,269325271,2565,1508472,1932245162,1507367,1932120150,1105,125012,1491222,6083,1845565,184145,2565,1782,115556.0,28889.0,-67.0,-64.0,-66.0,-69.0,-67.0,-64.0,-66.0,-69.0,-79.0,-85.0,-78.0,-82.0,12.0,21.0,12.0,13.0,1
1306,CC:2F:71:3E:C5:1F,5529023,4451582606,3406890,4182257335,2122133,269325271,502,93178,7997543,78588,6268283,14590,1729260,21528,529,3414280,870680,502,2926,13000.0,1000.0,-73.0,-73.0,-69.0,-61.0,-69.0,-71.0,-67.0,-60.0,-79.0,-85.0,-78.0,-82.0,6.0,12.0,9.0,21.0,1
1307,F8:59:71:5A:E0:3D,3419796,2214235879,1297663,1944910608,2122133,269325271,294,732886,893467285,732203,893385046,683,82239,721849,1840,1297779,153164,294,1081,144444.0,43333.0,-65.0,-71.0,-64.0,-70.0,-66.0,-71.0,-63.0,-69.0,-79.0,-85.0,-78.0,-82.0,14.0,14.0,14.0,12.0,1
1308,CC:2F:71:3F:1F:24,3968092,2706601350,1845959,2437276079,2122133,269325271,2565,1508617,1932445382,1507512,1932320370,1105,125012,1491367,6083,1845725,184170,2565,1782,115556.0,28889.0,-69.0,-64.0,-67.0,-69.0,-67.0,-64.0,-66.0,-69.0,-79.0,-85.0,-78.0,-82.0,10.0,21.0,11.0,13.0,1
1309,CC:2F:71:3E:C5:1F,5529023,4451582606,3406890,4182257335,2122133,269325271,502,93178,7997543,78588,6268283,14590,1729260,21528,529,3414280,870680,502,2926,13000.0,1000.0,-73.0,-73.0,-69.0,-61.0,-69.0,-71.0,-67.0,-60.0,-79.0,-85.0,-78.0,-82.0,6.0,12.0,9.0,21.0,1
1310,F8:59:71:5A:E0:3D,3419984,2214517980,1297845,1945192103,2122139,269325877,294,732988,893572534,732305,893490295,683,82239,721951,1840,1297961,153254,294,1081,144444.0,43333.0,-66.0,-72.0,-64.0,-70.0,-66.0,-72.0,-63.0,-69.0,-78.0,-85.0,-77.0,-81.0,12.0,13.0,13.0,11.0,1
1311,CC:2F:71:3F:1F:24,3968278,2706811951,1846137,2437485872,2122141,269326079,2565,1508776,1932650103,1507671,1932525091,1105,125012,1491526,6083,1845903,184188,2565,1782,115556.0,28889.0,-68.0,-64.0,-67.0,-69.0,-67.0,-64.0,-66.0,-68.0,-78.0,-85.0,-77.0,-81.0,10.0,21.0,10.0,12.0,1
1312,CC:2F:71:3E:C5:1F,5529031,4451583414,3406890,4182257335,2122141,269326079,502,93178,7997543,78588,6268283,14590,1729260,21528,529,3414280,870680,502,2926,13000.0,1000.0,-73.0,-73.0,-69.0,-61.0,-69.0,-71.0,-67.0,-60.0,-78.0,-85.0,-77.0,-81.0,5.0,12.0,8.0,20.0,1
1313,F8:59:71:5A:E0:3D,3420055,2214616862,1297913,1945290723,2122142,269326139,294,733055,893671935,732372,893589696,683,82239,722018,1840,1298029,153267,294,1081,144444.0,43333.0,-66.0,-71.0,-64.0,-70.0,-67.0,-72.0,-64.0,-70.0,-77.0,-84.0,-75.0,-80.0,11.0,13.0,11.0,10.0,1
1314,CC:2F:71:3F:1F:24,3968434,2707014865,1846292,2437688726,2122142,269326139,2565,1508918,1932845647,1507813,1932720635,1105,125012,1491668,6083,1846058,184232,2565,1782,115556.0,28889.0,-70.0,-64.0,-71.0,-70.0,-68.0,-64.0,-67.0,-69.0,-77.0,-84.0,-75.0,-80.0,7.0,20.0,4.0,10.0,1
1315,CC:2F:71:3E:C5:1F,5529032,4451583474,3406890,4182257335,2122142,269326139,502,93178,7997543,78588,6268283,14590,1729260,21528,529,3414280,870680,502,2926,13000.0,1000.0,-73.0,-73.0,-69.0,-61.0,-69.0,-71.0,-67.0,-60.0,-77.0,-84.0,-75.0,-80.0,4.0,11.0,6.0,19.0,1
1316,F8:59:71:5A:E0:3D,3420125,2214716924,1297977,1945390179,2122148,269326745,294,733118,893768955,732435,893686716,683,82239,722081,1840,1298093,153278,294,1081,144444.0,43333.0,-67.0,-72.0,-63.0,-69.0,-66.0,-72.0,-63.0,-70.0,-77.0,-84.0,-75.0,-80.0,10.0,12.0,12.0,11.0,1
1317,CC:2F:71:3F:1F:24,3968597,2707221261,1846448,2437894390,2122149,269326871,2565,1509062,1933041423,1507957,1932916411,1105,125012,1491812,6083,1846214,184285,2565,1782,115556.0,28889.0,-69.0,-64.0,-67.0,-68.0,-68.0,-64.0,-67.0,-69.0,-77.0,-84.0,-75.0,-80.0,8.0,20.0,8.0,12.0,1
1318,CC:2F:71:3E:C5:1F,5529039,4451584206,3406890,4182257335,2122149,269326871,502,93178,7997543,78588,6268283,14590,1729260,21528,529,3414280,870680,502,2926,13000.0,1000.0,-73.0,-73.0,-69.0,-61.0,-69.0,-71.0,-67.0,-60.0,-77.0,-84.0,-75.0,-80.0,4.0,11.0,6.0,19.0,1
1319,F8:59:71:5A:E0:3D,3420428,2215149319,1298277,1945822246,2122151,269327073,294,733231,893879830,732548,893797591,683,82239,722194,1840,1298393,153352,294,1081,144444.0,43333.0,-66.0,-71.0,-64.0,-69.0,-66.0,-71.0,-63.0,-70.0,-77.0,-84.0,-75.0,-80.0,11.0,13.0,11.0,11.0,1
1320,CC:2F:71:3F:1F:24,3968758,2707429333,1846607,2438102260,2122151,269327073,2565,1509206,1933240047,1508101,1933115035,1105,125012,1491956,6083,1846373,184318,2565,1782,115556.0,28889.0,-67.0,-64.0,-66.0,-70.0,-68.0,-64.0,-67.0,-69.0,-77.0,-84.0,-75.0,-80.0,10.0,20.0,9.0,10.0,1
1321,CC:2F:71:3E:C5:1F,5529042,4451584468,3406890,4182257335,2122152,269327133,502,93178,7997543,78588,6268283,14590,1729260,21528,529,3414280,870680,502,2926,13000.0,1000.0,-73.0,-73.0,-69.0,-61.0,-69.0,-71.0,-67.0,-60.0,-77.0,-84.0,-75.0,-80.0,4.0,11.0,6.0,19.0,1
1322,F8:59:71:5A:E0:3D,3420498,2215247775,1298340,1945920036,2122158,269327739,294,733292,893973770,732609,893891531,683,82239,722255,1840,1298455,153363,294,1081,144444.0,43333.0,-66.0,-72.0,-63.0,-69.0,-67.0,-72.0,-64.0,-70.0,-77.0,-84.0,-75.0,-80.0,11.0,12.0,12.0,11.0,1
1323,CC:2F:71:3F:1F:24,3968930,2707636659,1846772,2438308920,2122158,269327739,2565,1509360,1933441650,1508255,1933316638,1105,125012,1492110,6083,1846538,184343,2565,1782,115556.0,28889.0,-70.0,-64.0,-71.0,-71.0,-69.0,-64.0,-68.0,-69.0,-77.0,-84.0,-75.0,-80.0,7.0,20.0,4.0,9.0,1
1324,CC:2F:71:3E:C5:1F,5529048,4451585074,3406890,4182257335,2122158,269327739,502,93178,7997543,78588,6268283,14590,1729260,21528,529,3414280,870680,502,2926,13000.0,1000.0,-73.0,-73.0,-69.0,-61.0,-69.0,-71.0,-67.0,-60.0,-77.0,-84.0,-75.0,-80.0,4.0,11.0,6.0,19.0,1
1325,F8:59:71:5A:E0:3D,3420562,2215344325,1298402,1946016384,2122160,269327941,294,733356,894072330,732673,893990091,683,82239,722319,1840,1298518,153371,294,1081,144444.0,43333.0,-66.0,-71.0,-64.0,-70.0,-67.0,-72.0,-64.0,-70.0,-77.0,-84.0,-75.0,-80.0,11.0,13.0,11.0,10.0,1
1326,CC:2F:71:3F:1F:24,3969089,2707843047,1846929,2438515106,2122160,269327941,2565,1509502,1933637194,1508397,1933512182,1105,125012,1492252,6083,1846695,184365,2565,1782,115556.0,28889.0,-70.0,-64.0,-70.0,-70.0,-69.0,-64.0,-68.0,-69.0,-77.0,-84.0,-75.0,-80.0,7.0,20.0,5.0,10.0,1
1327,CC:2F:71:3E:C5:1F,5529051,4451585549,3406890,4182257335,2122161,269328214,502,93178,7997543,78588,6268283,14590,1729260,21528,529,3414280,870680,502,2926,13000.0,1000.0,-73.0,-73.0,-69.0,-61.0,-69.0,-71.0,-67.0,-60.0,-77.0,-84.0,-75.0,-80.0,4.0,11.0,6.0,19.0,1
1328,F8:59:71:5A:E0:3D,3420695,2215529892,1298532,1946201476,2122163,269328416,294,733442,894175886,732759,894093647,683,82239,722405,1840,1298648,153391,294,1081,144444.0,43333.0,-66.0,-72.0,-65.0,-70.0,-66.0,-71.0,-64.0,-70.0,-77.0,-84.0,-75.0,-80.0,11.0,12.0,10.0,10.0,1
1329,CC:2F:71:3F:1F:24,3969247,2708043694,1847082,2438715076,2122165,269328618,2565,1509644,1933832738,1508539,1933707726,1105,125012,1492394,6083,1846848,184382,2565,1782,115556.0,28889.0,-67.0,-64.0,-67.0,-70.0,-68.0,-64.0,-68.0,-69.0,-77.0,-84.0,-75.0,-80.0,10.0,20.0,8.0,10.0,1
1330,CC:2F:71:3E:C5:1F,5529056,4451586013,3406890,4182257335,2122166,269328678,502,93178,7997543,78588,6268283,14590,1729260,21528,529,3414280,870680,502,2926,13000.0,1000.0,-73.0,-73.0,-69.0,-61.0,-69.0,-71.0,-67.0,-60.0,-77.0,-84.0,-75.0,-80.0,4.0,11.0,6.0,19.0,1
1331,F8:59:71:5A:E0:3D,3420780,2215650278,1298609,1946321134,2122171,269329144,294,733519,894294466,732836,894212227,683,82239,722482,1840,1298725,153398,294,1081,144444.0,43333.0,-67.0,-72.0,-64.0,-70.0,-67.0,-72.0,-64.0,-70.0,-77.0,-84.0,-75.0,-80.0,10.0,12.0,11.0,10.0,1
1332,CC:2F:71:3F:1F:24,3969440,2708294762,1847269,2438965618,2122171,269329144,2565,1509823,1934073872,1508717,1933948742,1106,125130,1492566,6083,1847035,184455,2565,1782,104000.0,26000.0,-70.0,-64.0,-71.0,-71.0,-69.0,-63.0,-69.0,-69.0,-77.0,-84.0,-75.0,-80.0,7.0,20.0,4.0,9.0,1
1333,CC:2F:71:3E:C5:1F,5529061,4451586479,3406890,4182257335,2122171,269329144,502,93178,7997543,78588,6268283,14590,1729260,21528,529,3414280,870680,502,2926,13000.0,1000.0,-73.0,-73.0,-69.0,-61.0,-69.0,-71.0,-67.0,-60.0,-77.0,-84.0,-75.0,-80.0,4.0,11.0,6.0,19.0,1
1334,F8:59:71:5A:E0:3D,3420870,2215768810,1298693,1946439060,2122177,269329750,294,733606,894420385,732923,894338146,683,82239,722569,1840,1298809,153405,294,1081,144444.0,43333.0,-67.0,-72.0,-64.0,-70.0,-67.0,-71.0,-65.0,-70.0,-77.0,-84.0,-75.0,-80.0,10.0,12.0,11.0,10.0,1
1335,CC:2F:71:3F:1F:24,3969690,2708609895,1847513,2439280145,2122177,269329750,2565,1510061,1934381771,1508955,1934256641,1106,125130,1492787,6083,1847279,184595,2565,1785,104000.0,26000.0,-67.0,-64.0,-66.0,-70.0,-67.0,-64.0,-66.0,-69.0,-77.0,-84.0,-75.0,-80.0,10.0,20.0,9.0,10.0,1
1336,CC:2F:71:3E:C5:1F,5529070,4451587347,3406890,4182257335,2122180,269330012,502,93178,7997543,78588,6268283,14590,1729260,21528,529,3414280,870680,502,2926,13000.0,1000.0,-73.0,-73.0,-69.0,-61.0,-69.0,-71.0,-67.0,-60.0,-77.0,-84.0,-75.0,-80.0,4.0,11.0,6.0,19.0,1
1337,F8:59:71:5A:E0:3D,3421245,2216307046,1299065,1946977034,2122180,269330012,294,733759,894583785,733076,894501546,683,82239,722722,1840,1299181,153454,294,1081,144444.0,43333.0,-66.0,-71.0,-65.0,-70.0,-66.0,-71.0,-64.0,-69.0,-77.0,-84.0,-75.0,-80.0,11.0,13.0,10.0,10.0,1
1338,CC:2F:71:3F:1F:24,3969916,2708912987,1847734,2439582773,2122182,269330214,2565,1510279,1934675925,1509173,1934550795,1106,125130,1492997,6083,1847499,184697,2565,1785,115556.0,28889.0,-68.0,-64.0,-66.0,-69.0,-68.0,-64.0,-67.0,-69.0,-77.0,-84.0,-75.0,-80.0,9.0,20.0,9.0,11.0,1
1339,CC:2F:71:3E:C5:1F,5529076,4451587953,3406890,4182257335,2122186,269330618,502,93178,7997543,78588,6268283,14590,1729260,21528,530,3414281,870681,502,2926,13000.0,1000.0,-73.0,-73.0,-69.0,-61.0,-69.0,-71.0,-67.0,-60.0,-77.0,-84.0,-75.0,-80.0,4.0,11.0,6.0,19.0,1
1340,F8:59:71:5A:E0:3D,3421366,2216474715,1299178,1947143895,2122188,269330820,294,733858,894731971,733175,894649732,683,82239,722821,1840,1299295,153605,294,1082,144444.0,43333.0,-66.0,-71.0,-64.0,-69.0,-66.0,-71.0,-63.0,-69.0,-77.0,-84.0,-75.0,-80.0,11.0,13.0,11.0,11.0,1
1341,CC:2F:71:3F:1F:24,3970230,2709332791,1848039,2440001709,2122191,269331082,2571,1510586,1935097210,1509480,1934972080,1106,125130,1493296,6084,1847806,185113,2571,1785,86667.0,13000.0,-66.0,-64.0,-65.0,-69.0,-67.0,-63.0,-67.0,-69.0,-78.0,-85.0,-77.0,-81.0,12.0,21.0,12.0,12.0,1
1342,CC:2F:71:3E:C5:1F,5529085,4451588821,3406890,4182257335,2122195,269331486,502,93178,7997543,78588,6268283,14590,1729260,21528,530,3414281,870681,502,2926,13000.0,1000.0,-73.0,-73.0,-69.0,-61.0,-69.0,-71.0,-67.0,-60.0,-78.0,-85.0,-77.0,-81.0,5.0,12.0,8.0,20.0,1
1343,F8:59:71:5A:E0:3D,3421750,2217057782,1299553,1947726094,2122197,269331688,294,734078,894989050,733395,894906811,683,82239,723041,1840,1299669,153772,294,1082,144444.0,43333.0,-65.0,-71.0,-64.0,-69.0,-65.0,-71.0,-63.0,-69.0,-78.0,-85.0,-77.0,-81.0,13.0,14.0,13.0,12.0,1
1344,CC:2F:71:3F:1F:24,3970507,2709707119,1848310,2440375431,2122197,269331688,2571,1510845,1935451274,1509739,1935326144,1106,125130,1493547,6084,1848080,185401,2571,1785,104000.0,26000.0,-68.0,-64.0,-66.0,-68.0,-67.0,-63.0,-66.0,-68.0,-78.0,-85.0,-77.0,-81.0,10.0,21.0,11.0,13.0,1
1345,CC:2F:71:3E:C5:1F,5529087,4451589023,3406890,4182257335,2122197,269331688,502,93178,7997543,78588,6268283,14590,1729260,21528,530,3414281,870681,502,2926,13000.0,1000.0,-73.0,-73.0,-69.0,-61.0,-69.0,-71.0,-67.0,-60.0,-78.0,-85.0,-77.0,-81.0,5.0,12.0,8.0,20.0,1
1346,F8:59:71:5A:E0:3D,3421832,2217169506,1299628,1947837152,2122204,269332354,294,734155,895103893,733472,895021654,683,82239,723118,1840,1299746,153864,294,1082,130000.0,39000.0,-66.0,-71.0,-64.0,-70.0,-67.0,-71.0,-64.0,-70.0,-77.0,-84.0,-75.0,-80.0,11.0,13.0,11.0,10.0,1
1347,CC:2F:71:3F:1F:24,3970678,2709922193,1848474,2440589839,2122204,269332354,2571,1510997,1935660794,1509891,1935535664,1106,125130,1493699,6084,1848243,185492,2571,1785,115556.0,28889.0,-67.0,-64.0,-65.0,-68.0,-67.0,-63.0,-66.0,-68.0,-77.0,-84.0,-75.0,-80.0,10.0,20.0,10.0,12.0,1
1348,CC:2F:71:3E:C5:1F,5529094,4451589689,3406890,4182257335,2122204,269332354,502,93178,7997543,78588,6268283,14590,1729260,21528,530,3414281,870681,502,2926,13000.0,1000.0,-73.0,-73.0,-69.0,-61.0,-69.0,-71.0,-67.0,-60.0,-77.0,-84.0,-75.0,-80.0,4.0,11.0,6.0,19.0,1
1349,F8:59:71:5A:E0:3D,3422035,2217446001,1299829,1948113445,2122206,269332556,294,734252,895212445,733569,895130206,683,82239,723215,1840,1299947,153918,294,1082,144444.0,43333.0,-66.0,-71.0,-63.0,-69.0,-66.0,-71.0,-64.0,-70.0,-77.0,-84.0,-75.0,-80.0,11.0,13.0,12.0,11.0,1
1350,CC:2F:71:3F:1F:24,3970851,2710145907,1848645,2440813351,2122206,269332556,2571,1511150,1935873450,1510044,1935748320,1106,125130,1493852,6084,1848415,185632,2571,1785,115556.0,28889.0,-70.0,-64.0,-71.0,-70.0,-67.0,-63.0,-66.0,-68.0,-77.0,-84.0,-75.0,-80.0,7.0,20.0,4.0,10.0,1
1351,CC:2F:71:3E:C5:1F,5529098,4451590093,3406890,4182257335,2122208,269332758,502,93178,7997543,78588,6268283,14590,1729260,21528,530,3414281,870681,502,2926,13000.0,1000.0,-73.0,-73.0,-69.0,-61.0,-69.0,-71.0,-67.0,-60.0,-76.0,-83.0,-74.0,-79.0,3.0,10.0,5.0,18.0,1
1352,F8:59:71:5A:E0:3D,3422319,2217872018,1300104,1948538594,2122215,269333424,294,734357,895373582,733674,895291343,683,82239,723320,1840,1300219,154104,294,1083,144444.0,43333.0,-65.0,-71.0,-63.0,-69.0,-66.0,-71.0,-63.0,-69.0,-76.0,-83.0,-74.0,-79.0,11.0,12.0,11.0,10.0,1
1353,CC:2F:71:3F:1F:24,3971144,2710530740,1848929,2441197316,2122215,269333424,2571,1511422,1936255536,1510316,1936130406,1106,125130,1494124,6085,1848702,186077,2571,1785,52000.0,6500.0,-67.0,-64.0,-66.0,-69.0,-67.0,-63.0,-65.0,-68.0,-76.0,-83.0,-74.0,-79.0,9.0,19.0,8.0,10.0,1
1354,CC:2F:71:3E:C5:1F,5529105,4451590759,3406890,4182257335,2122215,269333424,502,93178,7997543,78588,6268283,14590,1729260,21528,530,3414281,870681,502,2926,13000.0,1000.0,-73.0,-73.0,-69.0,-61.0,-69.0,-71.0,-67.0,-60.0,-76.0,-83.0,-74.0,-79.0,3.0,10.0,5.0,18.0,1
1355,F8:59:71:5A:E0:3D,3422408,2217996927,1300188,1948662965,2122220,269333962,294,734479,895527285,733796,895445046,683,82239,723442,1840,1300306,154162,294,1083,144444.0,43333.0,-68.0,-72.0,-63.0,-69.0,-67.0,-72.0,-64.0,-70.0,-76.0,-83.0,-74.0,-79.0,8.0,11.0,11.0,10.0,1
1356,CC:2F:71:3F:1F:24,3971334,2710776554,1849113,2441442524,2122221,269334030,2571,1511589,1936486732,1510483,1936361602,1106,125130,1494291,6085,1848886,186184,2571,1785,115556.0,26000.0,-66.0,-64.0,-65.0,-68.0,-68.0,-63.0,-68.0,-69.0,-76.0,-83.0,-74.0,-79.0,10.0,19.0,9.0,11.0,1
1357,CC:2F:71:3E:C5:1F,5529112,4451591638,3406890,4182257335,2122222,269334303,502,93178,7997543,78588,6268283,14590,1729260,21528,530,3414281,870681,502,2926,13000.0,1000.0,-73.0,-73.0,-69.0,-61.0,-69.0,-71.0,-67.0,-60.0,-76.0,-83.0,-74.0,-79.0,3.0,10.0,5.0,18.0,1
1358,F8:59:71:5A:E0:3D,3422478,2218099026,1300254,1948764521,2122224,269334505,294,734545,895628925,733862,895546686,683,82239,723508,1840,1300372,154227,294,1083,144444.0,43333.0,-66.0,-72.0,-63.0,-68.0,-66.0,-71.0,-63.0,-68.0,-76.0,-83.0,-74.0,-79.0,10.0,11.0,11.0,11.0,1
1359,CC:2F:71:3F:1F:24,3971500,2710989173,1849275,2441654608,2122225,269334565,2571,1511738,1936690208,1510632,1936565078,1106,125130,1494440,6085,1849048,186243,2571,1785,115556.0,26000.0,-67.0,-64.0,-66.0,-69.0,-67.0,-63.0,-66.0,-69.0,-76.0,-83.0,-74.0,-79.0,9.0,19.0,8.0,10.0,1
1360,CC:2F:71:3E:C5:1F,5529115,4451591900,3406890,4182257335,2122225,269334565,502,93178,7997543,78588,6268283,14590,1729260,21528,530,3414281,870681,502,2926,13000.0,1000.0,-73.0,-73.0,-69.0,-61.0,-69.0,-71.0,-67.0,-60.0,-76.0,-83.0,-74.0,-79.0,3.0,10.0,5.0,18.0,1
1361,F8:59:71:5A:E0:3D,3422547,2218198722,1300318,1948863753,2122229,269334969,294,734608,895725945,733925,895643706,683,82239,723571,1840,1300436,154252,294,1083,144444.0,43333.0,-67.0,-72.0,-64.0,-69.0,-67.0,-72.0,-64.0,-69.0,-76.0,-83.0,-74.0,-79.0,9.0,11.0,10.0,10.0,1
1362,CC:2F:71:3F:1F:24,3971703,2711228808,1849463,2441888415,2122240,269340393,2571,1511918,1936920023,1510812,1936794893,1106,125130,1494620,6085,1849234,186346,2571,1785,78000.0,13000.0,-68.0,-64.0,-67.0,-69.0,-67.0,-63.0,-66.0,-68.0,-76.0,-83.0,-74.0,-79.0,8.0,19.0,7.0,10.0,1
1363,CC:2F:71:3E:C5:1F,5529131,4451597788,3406891,4182257395,2122240,269340393,502,93178,7997543,78588,6268283,14590,1729260,21528,530,3414282,870682,502,2926,6500.0,1000.0,-73.0,-73.0,-69.0,-61.0,-69.0,-71.0,-67.0,-60.0,-76.0,-83.0,-74.0,-79.0,3.0,10.0,5.0,18.0,1
1364,F8:59:71:5A:E0:3D,3422809,2218574001,1300553,1949227718,2122256,269346283,294,734722,895845178,734038,895762821,684,82357,723685,1840,1300671,154367,294,1083,144444.0,43333.0,-67.0,-70.0,-64.0,-71.0,-67.0,-71.0,-64.0,-70.0,-76.0,-83.0,-74.0,-79.0,9.0,13.0,10.0,8.0,1
1365,CC:2F:71:3F:1F:24,3971885,2711449274,1849629,2442102991,2122256,269346283,2571,1512067,1937123489,1510961,1936998359,1106,125130,1494769,6085,1849402,186461,2571,1785,86667.0,13000.0,-70.0,-64.0,-71.0,-70.0,-67.0,-63.0,-67.0,-69.0,-76.0,-83.0,-74.0,-79.0,6.0,19.0,3.0,9.0,1
1366,CC:2F:71:3E:C5:1F,5529147,4451603678,3406891,4182257395,2122256,269346283,502,93178,7997543,78588,6268283,14590,1729260,21528,530,3414282,870682,502,2926,6500.0,1000.0,-73.0,-73.0,-69.0,-61.0,-69.0,-71.0,-67.0,-60.0,-76.0,-83.0,-74.0,-79.0,3.0,10.0,5.0,18.0,1
1367,F8:59:71:5A:E0:3D,3422880,2218676469,1300619,1949329722,2122261,269346747,294,734787,895945278,734103,895862921,684,82357,723750,1840,1300737,154400,294,1083,144444.0,43333.0,-67.0,-72.0,-63.0,-69.0,-67.0,-71.0,-64.0,-69.0,-76.0,-83.0,-74.0,-79.0,9.0,11.0,11.0,10.0,1
1368,CC:2F:71:3F:1F:24,3972056,2711666918,1849795,2442320171,2122261,269346747,2571,1512220,1937333265,1511114,1937208135,1106,125130,1494922,6085,1849568,186557,2571,1786,115556.0,26000.0,-67.0,-64.0,-66.0,-69.0,-67.0,-63.0,-66.0,-68.0,-76.0,-83.0,-74.0,-79.0,9.0,19.0,8.0,10.0,1
1369,CC:2F:71:3E:C5:1F,5529152,4451604142,3406891,4182257395,2122261,269346747,502,93178,7997543,78588,6268283,14590,1729260,21528,530,3414282,870682,502,2926,6500.0,1000.0,-73.0,-73.0,-69.0,-61.0,-69.0,-71.0,-67.0,-60.0,-76.0,-83.0,-74.0,-79.0,3.0,10.0,5.0,18.0,1
1370,F8:59:71:5A:E0:3D,3422948,2218775769,1300683,1949428618,2122265,269347151,294,734853,896046918,734169,895964561,684,82357,723816,1840,1300801,154433,294,1083,144444.0,43333.0,-66.0,-71.0,-64.0,-69.0,-66.0,-71.0,-64.0,-69.0,-76.0,-83.0,-74.0,-79.0,10.0,12.0,10.0,10.0,1
1371,CC:2F:71:3F:1F:24,3972218,2711873246,1849953,2442526095,2122265,269347151,2571,1512361,1937527269,1511255,1937402139,1106,125130,1495063,6085,1849724,186607,2571,1786,115556.0,28889.0,-67.0,-64.0,-66.0,-68.0,-67.0,-64.0,-67.0,-69.0,-76.0,-83.0,-74.0,-79.0,9.0,19.0,8.0,11.0,1
1372,CC:2F:71:3E:C5:1F,5529156,4451604546,3406891,4182257395,2122265,269347151,502,93178,7997543,78588,6268283,14590,1729260,21528,530,3414282,870682,502,2926,6500.0,1000.0,-73.0,-73.0,-69.0,-61.0,-69.0,-71.0,-67.0,-60.0,-76.0,-83.0,-74.0,-79.0,3.0,10.0,5.0,18.0,1
1373,F8:59:71:5A:E0:3D,3423013,2218873649,1300746,1949526296,2122267,269347353,294,734920,896149036,734236,896066679,684,82357,723883,1840,1300864,154471,294,1083,144444.0,43333.0,-66.0,-72.0,-63.0,-69.0,-67.0,-71.0,-64.0,-70.0,-76.0,-83.0,-74.0,-79.0,10.0,11.0,11.0,10.0,1
1374,CC:2F:71:3F:1F:24,3972385,2712086952,1850116,2442739397,2122269,269347555,2571,1512514,1937738329,1511408,1937613199,1106,125130,1495216,6085,1849888,186683,2571,1786,115556.0,26000.0,-67.0,-64.0,-67.0,-69.0,-67.0,-63.0,-67.0,-69.0,-76.0,-83.0,-74.0,-79.0,9.0,19.0,7.0,10.0,1
1375,CC:2F:71:3E:C5:1F,5529160,4451604950,3406891,4182257395,2122269,269347555,502,93178,7997543,78588,6268283,14590,1729260,21528,530,3414282,870682,502,2926,6500.0,1000.0,-73.0,-73.0,-69.0,-61.0,-69.0,-71.0,-67.0,-60.0,-76.0,-83.0,-74.0,-79.0,3.0,10.0,5.0,18.0,1
1376,F8:59:71:5A:E0:3D,3423339,2219319260,1301065,1949971241,2122274,269348019,294,735037,896257764,734353,896175407,684,82357,724000,1840,1301182,154609,294,1083,144444.0,43333.0,-66.0,-71.0,-64.0,-70.0,-66.0,-71.0,-63.0,-69.0,-77.0,-84.0,-75.0,-80.0,11.0,13.0,11.0,10.0,1
1377,CC:2F:71:3F:1F:24,3972550,2712295832,1850276,2442947813,2122274,269348019,2571,1512658,1937935529,1511552,1937810399,1106,125130,1495360,6085,1850049,186758,2571,1786,115556.0,28889.0,-68.0,-64.0,-66.0,-69.0,-67.0,-63.0,-66.0,-68.0,-77.0,-84.0,-75.0,-80.0,9.0,20.0,9.0,11.0,1
1378,CC:2F:71:3E:C5:1F,5529165,4451605414,3406891,4182257395,2122274,269348019,502,93178,7997543,78588,6268283,14590,1729260,21528,530,3414282,870682,502,2926,6500.0,1000.0,-73.0,-73.0,-69.0,-61.0,-69.0,-71.0,-67.0,-60.0,-77.0,-84.0,-75.0,-80.0,4.0,11.0,6.0,19.0,1
1379,F8:59:71:5A:E0:3D,3423407,2219420378,1301131,1950072157,2122276,269348221,294,735104,896359520,734420,896277163,684,82357,724067,1840,1301249,154654,294,1083,144444.0,43333.0,-68.0,-72.0,-66.0,-71.0,-67.0,-71.0,-64.0,-70.0,-77.0,-84.0,-75.0,-80.0,9.0,12.0,9.0,9.0,1
1380,CC:2F:71:3F:1F:24,3972714,2712507502,1850438,2443159281,2122276,269348221,2571,1512808,1938140545,1511702,1938015415,1106,125130,1495510,6085,1850212,186877,2571,1786,104000.0,26000.0,-67.0,-64.0,-65.0,-69.0,-67.0,-63.0,-67.0,-69.0,-77.0,-84.0,-75.0,-80.0,10.0,20.0,10.0,11.0,1
1381,CC:2F:71:3E:C5:1F,5529169,4451605818,3406891,4182257395,2122278,269348423,502,93178,7997543,78588,6268283,14590,1729260,21528,530,3414282,870682,502,2926,6500.0,1000.0,-73.0,-73.0,-69.0,-61.0,-69.0,-71.0,-67.0,-60.0,-77.0,-84.0,-75.0,-80.0,4.0,11.0,6.0,19.0,1
1382,F8:59:71:5A:E0:3D,3423720,2219886331,1301438,1950537504,2122282,269348827,294,735232,896483124,734548,896400767,684,82357,724195,1840,1301556,154810,294,1083,144444.0,43333.0,-66.0,-71.0,-64.0,-69.0,-67.0,-71.0,-64.0,-70.0,-77.0,-84.0,-75.0,-80.0,11.0,13.0,11.0,11.0,1
1383,CC:2F:71:3F:1F:24,3972891,2712735218,1850609,2443386391,2122282,269348827,2571,1512971,1938365777,1511865,1938240647,1106,125130,1495673,6085,1850382,186962,2571,1787,86667.0,1000.0,-71.0,-63.0,-74.0,-73.0,-69.0,-63.0,-70.0,-71.0,-77.0,-84.0,-75.0,-80.0,6.0,21.0,1.0,7.0,1
1384,CC:2F:71:3E:C5:1F,5529174,4451606282,3406891,4182257395,2122283,269348887,502,93178,7997543,78588,6268283,14590,1729260,21528,530,3414282,870682,502,2926,6500.0,1000.0,-73.0,-73.0,-69.0,-61.0,-69.0,-71.0,-67.0,-60.0,-77.0,-84.0,-75.0,-80.0,4.0,11.0,6.0,19.0,1
1385,F8:59:71:5A:E0:3D,3423803,2220003818,1301518,1950654729,2122285,269349089,294,735310,896599699,734626,896517342,684,82357,724273,1840,1301636,154832,294,1083,144444.0,43333.0,-68.0,-74.0,-65.0,-72.0,-67.0,-73.0,-64.0,-71.0,-77.0,-84.0,-75.0,-80.0,9.0,10.0,10.0,8.0,1
1386,CC:2F:71:3F:1F:24,3973080,2712981292,1850795,2443632203,2122285,269349089,2571,1513140,1938596101,1512034,1938470971,1106,125130,1495841,6085,1850569,187082,2571,1788,86667.0,14444.0,-71.0,-64.0,-72.0,-70.0,-70.0,-63.0,-70.0,-69.0,-77.0,-84.0,-75.0,-80.0,6.0,20.0,3.0,10.0,1
1387,CC:2F:71:3E:C5:1F,5529178,4451606686,3406891,4182257395,2122287,269349291,502,93178,7997543,78588,6268283,14590,1729260,21528,530,3414282,870682,502,2926,6500.0,1000.0,-73.0,-73.0,-69.0,-61.0,-69.0,-71.0,-67.0,-60.0,-77.0,-84.0,-75.0,-80.0,4.0,11.0,6.0,19.0,1
1388,F8:59:71:5A:E0:3D,3423907,2220154328,1301615,1950804571,2122292,269349757,294,735402,896741519,734718,896659162,684,82357,724365,1840,1301733,154895,294,1083,144444.0,43333.0,-69.0,-73.0,-66.0,-72.0,-68.0,-72.0,-65.0,-71.0,-77.0,-84.0,-75.0,-80.0,8.0,11.0,9.0,8.0,1
1389,CC:2F:71:3F:1F:24,3973313,2713292380,1851021,2443942623,2122292,269349757,2571,1513353,1938900597,1512247,1938775467,1106,125130,1496054,6085,1850797,187388,2571,1790,86667.0,14444.0,-66.0,-63.0,-65.0,-68.0,-68.0,-62.0,-68.0,-68.0,-77.0,-84.0,-75.0,-80.0,11.0,21.0,10.0,12.0,1
1390,CC:2F:71:3E:C5:1F,5529183,4451607152,3406891,4182257395,2122292,269349757,502,93180,7997731,78589,6268353,14591,1729378,21529,530,3414282,870682,502,2926,6500.0,1000.0,-69.0,-72.0,-65.0,-61.0,-70.0,-71.0,-67.0,-61.0,-77.0,-84.0,-75.0,-80.0,8.0,12.0,10.0,19.0,1
1391,F8:59:71:5A:E0:3D,3423979,2220258686,1301682,1950908465,2122297,269350221,294,735474,896852483,734790,896770126,684,82357,724437,1840,1301800,154933,294,1083,144444.0,43333.0,-66.0,-71.0,-64.0,-70.0,-67.0,-72.0,-64.0,-70.0,-77.0,-84.0,-75.0,-80.0,11.0,13.0,11.0,10.0,1
1392,CC:2F:71:3F:1F:24,3973494,2713508720,1851197,2444158499,2122297,269350221,2571,1513519,1939109212,1512413,1938984082,1106,125130,1496218,6085,1850974,187515,2571,1790,117000.0,39000.0,-66.0,-64.0,-66.0,-70.0,-69.0,-64.0,-70.0,-71.0,-77.0,-84.0,-75.0,-80.0,11.0,20.0,9.0,10.0,1
1393,CC:2F:71:3E:C5:1F,5529188,4451607616,3406891,4182257395,2122297,269350221,502,93180,7997731,78589,6268353,14591,1729378,21529,530,3414282,870682,502,2926,6500.0,1000.0,-69.0,-72.0,-65.0,-61.0,-70.0,-71.0,-67.0,-61.0,-77.0,-84.0,-75.0,-80.0,8.0,12.0,10.0,19.0,1
1394,F8:59:71:5A:E0:3D,3424048,2220358384,1301746,1951007697,2122302,269350687,294,735537,896949531,734853,896867174,684,82357,724500,1840,1301863,154946,294,1083,144444.0,43333.0,-68.0,-73.0,-65.0,-72.0,-67.0,-72.0,-64.0,-70.0,-77.0,-84.0,-75.0,-80.0,9.0,11.0,10.0,8.0,1
1395,CC:2F:71:3F:1F:24,3973660,2713719156,1851358,2444368469,2122302,269350687,2571,1513667,1939309676,1512560,1939184428,1107,125248,1496364,6085,1851135,187603,2571,1790,86667.0,14444.0,-71.0,-64.0,-73.0,-70.0,-69.0,-64.0,-69.0,-69.0,-77.0,-84.0,-75.0,-80.0,6.0,20.0,2.0,10.0,1
1396,CC:2F:71:3E:C5:1F,5529193,4451608082,3406891,4182257395,2122302,269350687,502,93180,7997731,78589,6268353,14591,1729378,21529,530,3414282,870682,502,2926,6500.0,1000.0,-69.0,-72.0,-65.0,-61.0,-70.0,-71.0,-67.0,-61.0,-77.0,-84.0,-75.0,-80.0,8.0,12.0,10.0,19.0,1
1397,F8:59:71:5A:E0:3D,3424170,2220538565,1301863,1951187201,2122307,269351364,294,735612,897054164,734928,896971807,684,82357,724575,1840,1301982,154988,294,1083,144444.0,43333.0,-69.0,-74.0,-65.0,-72.0,-68.0,-72.0,-64.0,-70.0,-77.0,-84.0,-75.0,-80.0,8.0,10.0,10.0,8.0,1
1398,CC:2F:71:3F:1F:24,3973828,2713931697,1851520,2444580273,2122308,269351424,2571,1513816,1939513152,1512709,1939387904,1107,125248,1496513,6085,1851297,187619,2571,1790,86667.0,14444.0,-70.0,-64.0,-71.0,-70.0,-68.0,-63.0,-67.0,-69.0,-77.0,-84.0,-75.0,-80.0,7.0,20.0,4.0,10.0,1
1399,CC:2F:71:3E:C5:1F,5529199,4451608819,3406891,4182257395,2122308,269351424,502,93180,7997731,78589,6268353,14591,1729378,21529,530,3414282,870682,502,2926,6500.0,1000.0,-69.0,-72.0,-65.0,-61.0,-70.0,-71.0,-67.0,-61.0,-77.0,-84.0,-75.0,-80.0,8.0,12.0,10.0,19.0,1
1400,F8:59:71:5A:E0:3D,3424238,2220636483,1301926,1951284655,2122312,269351828,294,735677,897154264,734993,897071907,684,82357,724640,1840,1302045,155021,294,1083,144444.0,43333.0,-68.0,-73.0,-65.0,-71.0,-67.0,-72.0,-64.0,-70.0,-78.0,-84.0,-76.0,-81.0,10.0,11.0,11.0,10.0,1
1401,CC:2F:71:3F:1F:24,3974004,2714157948,1851692,2444806120,2122312,269351828,2571,1513979,1939739651,1512872,1939614403,1107,125248,1496676,6085,1851468,187665,2571,1790,86667.0,14444.0,-67.0,-64.0,-66.0,-70.0,-67.0,-63.0,-67.0,-69.0,-78.0,-84.0,-76.0,-81.0,11.0,20.0,10.0,11.0,1
1402,CC:2F:71:3E:C5:1F,5529203,4451609223,3406891,4182257395,2122312,269351828,502,93180,7997731,78589,6268353,14591,1729378,21529,530,3414282,870682,502,2926,6500.0,1000.0,-69.0,-72.0,-65.0,-61.0,-70.0,-71.0,-67.0,-61.0,-78.0,-84.0,-76.0,-81.0,9.0,12.0,11.0,20.0,1
1403,F8:59:71:5A:E0:3D,3424550,2221075730,1302232,1951723130,2122318,269352600,294,735789,897273146,735105,897190789,684,82357,724752,1840,1302351,155065,294,1083,144444.0,43333.0,-67.0,-72.0,-63.0,-70.0,-67.0,-72.0,-64.0,-70.0,-78.0,-84.0,-76.0,-81.0,11.0,12.0,13.0,11.0,1
1404,CC:2F:71:3F:1F:24,3974195,2714382254,1851877,2445029654,2122318,269352600,2571,1514145,1939946709,1513038,1939821461,1107,125248,1496842,6085,1851654,187683,2571,1790,65000.0,14444.0,-69.0,-64.0,-71.0,-70.0,-67.0,-64.0,-67.0,-68.0,-78.0,-84.0,-76.0,-81.0,9.0,20.0,5.0,11.0,1
1405,CC:2F:71:3E:C5:1F,5529209,4451609995,3406891,4182257395,2122318,269352600,502,93180,7997731,78589,6268353,14591,1729378,21529,530,3414282,870682,502,2926,6500.0,1000.0,-69.0,-72.0,-65.0,-61.0,-70.0,-71.0,-67.0,-61.0,-78.0,-84.0,-76.0,-81.0,9.0,12.0,11.0,20.0,1
1406,F8:59:71:5A:E0:3D,3424797,2221446438,1302474,1952093374,2122323,269353064,294,735902,897381830,735218,897299473,684,82357,724865,1840,1302593,155136,294,1083,144444.0,43333.0,-68.0,-73.0,-65.0,-71.0,-67.0,-72.0,-64.0,-70.0,-78.0,-84.0,-76.0,-81.0,10.0,11.0,11.0,10.0,1
1407,CC:2F:71:3F:1F:24,3974356,2714586846,1852033,2445233782,2122323,269353064,2571,1514291,1940144141,1513184,1940018893,1107,125248,1496988,6085,1851810,187694,2571,1790,86667.0,14444.0,-67.0,-64.0,-66.0,-68.0,-68.0,-63.0,-68.0,-69.0,-78.0,-84.0,-76.0,-81.0,11.0,20.0,10.0,13.0,1
1408,CC:2F:71:3E:C5:1F,5529214,4451610459,3406891,4182257395,2122323,269353064,502,93180,7997731,78589,6268353,14591,1729378,21529,530,3414282,870682,502,2926,6500.0,1000.0,-69.0,-72.0,-65.0,-61.0,-70.0,-71.0,-67.0,-61.0,-78.0,-84.0,-76.0,-81.0,9.0,12.0,11.0,20.0,1
1409,F8:59:71:5A:E0:3D,3424865,2221548868,1302540,1952195602,2122325,269353266,294,735961,897472690,735277,897390333,684,82357,724924,1840,1302658,155170,294,1083,144444.0,1000.0,-66.0,-72.0,-63.0,-69.0,-66.0,-71.0,-63.0,-69.0,-78.0,-84.0,-76.0,-81.0,12.0,12.0,13.0,12.0,1
1410,CC:2F:71:3F:1F:24,3974541,2714827316,1852214,2445473848,2122327,269353468,2571,1514460,1940377271,1513353,1940252023,1107,125248,1497157,6085,1851991,187866,2571,1791,78000.0,13000.0,-67.0,-63.0,-66.0,-68.0,-66.0,-63.0,-66.0,-68.0,-78.0,-84.0,-76.0,-81.0,11.0,21.0,10.0,13.0,1
1411,CC:2F:71:3E:C5:1F,5529218,4451610863,3406891,4182257395,2122327,269353468,502,93180,7997731,78589,6268353,14591,1729378,21529,531,3414283,870683,502,2926,6500.0,1000.0,-69.0,-72.0,-65.0,-61.0,-70.0,-71.0,-67.0,-61.0,-78.0,-84.0,-76.0,-81.0,9.0,12.0,11.0,20.0,1
1412,F8:59:71:5A:E0:3D,3424946,2221665632,1302615,1952311760,2122331,269353872,294,736045,897602148,735361,897519791,684,82357,725008,1840,1302734,155211,294,1083,144444.0,43333.0,-66.0,-72.0,-63.0,-68.0,-66.0,-72.0,-63.0,-69.0,-78.0,-84.0,-75.0,-81.0,12.0,12.0,12.0,13.0,1
1413,CC:2F:71:3F:1F:24,3974724,2715063782,1852393,2445709910,2122331,269353872,2571,1514627,1940605675,1513520,1940480427,1107,125248,1497324,6085,1852170,188032,2571,1791,86667.0,1000.0,-67.0,-63.0,-66.0,-67.0,-67.0,-62.0,-67.0,-67.0,-78.0,-84.0,-75.0,-81.0,11.0,21.0,9.0,14.0,1
1414,CC:2F:71:3E:C5:1F,5529222,4451611267,3406891,4182257395,2122331,269353872,502,93180,7997731,78589,6268353,14591,1729378,21529,531,3414283,870683,502,2926,6500.0,1000.0,-69.0,-72.0,-65.0,-61.0,-70.0,-71.0,-67.0,-61.0,-78.0,-84.0,-75.0,-81.0,9.0,12.0,10.0,20.0,1
1415,F8:59:71:5A:E0:3D,3425058,2221829020,1302720,1952474482,2122338,269354538,294,736155,897771548,735471,897689191,684,82357,725118,1840,1302833,155280,294,1083,144444.0,43333.0,-68.0,-74.0,-64.0,-72.0,-67.0,-73.0,-64.0,-71.0,-79.0,-85.0,-76.0,-82.0,11.0,11.0,12.0,10.0,1
1416,CC:2F:71:3F:1F:24,3975119,2715598426,1852777,2446243484,2122342,269354942,2571,1515013,1941147982,1513906,1941022734,1107,125248,1497690,6085,1852557,188470,2571,1793,57778.0,1000.0,-67.0,-63.0,-67.0,-69.0,-67.0,-63.0,-67.0,-68.0,-79.0,-85.0,-76.0,-82.0,12.0,22.0,9.0,13.0,1
1417,CC:2F:71:3E:C5:1F,5529236,4451612599,3406891,4182257395,2122345,269355204,502,93180,7997731,78589,6268353,14591,1729378,21529,531,3414283,870683,502,2926,6500.0,1000.0,-69.0,-72.0,-65.0,-61.0,-70.0,-71.0,-67.0,-61.0,-79.0,-85.0,-76.0,-82.0,10.0,13.0,11.0,21.0,1
1418,F8:59:71:5A:E0:3D,3425482,2222424033,1303133,1953068425,2122349,269355608,294,736392,898051445,735708,897969088,684,82357,725351,1840,1303240,155627,294,1085,144444.0,43333.0,-67.0,-72.0,-63.0,-70.0,-65.0,-71.0,-63.0,-69.0,-79.0,-84.0,-76.0,-81.0,12.0,12.0,13.0,11.0,1
1419,CC:2F:71:3F:1F:24,3975451,2716039197,1853100,2446683387,2122351,269355810,2571,1515313,1941570435,1514206,1941445187,1107,125248,1497990,6085,1852879,188861,2571,1794,52000.0,13000.0,-67.0,-64.0,-66.0,-68.0,-68.0,-63.0,-69.0,-70.0,-79.0,-84.0,-76.0,-81.0,12.0,20.0,10.0,13.0,1
1420,CC:2F:71:3E:C5:1F,5529242,4451613205,3406891,4182257395,2122351,269355810,502,93180,7997731,78589,6268353,14591,1729378,21529,531,3414283,870683,502,2926,6500.0,1000.0,-69.0,-72.0,-65.0,-61.0,-70.0,-71.0,-67.0,-61.0,-79.0,-84.0,-76.0,-81.0,10.0,12.0,11.0,20.0,1
1421,F8:59:71:5A:E0:3D,3425613,2222613817,1303255,1953257341,2122358,269356476,294,736514,898238629,735830,898156272,684,82357,725473,1840,1303369,155694,294,1085,144444.0,43333.0,-66.0,-72.0,-63.0,-69.0,-65.0,-71.0,-62.0,-69.0,-79.0,-84.0,-76.0,-81.0,13.0,12.0,13.0,12.0,1
1422,CC:2F:71:3F:1F:24,3975691,2716361273,1853333,2447004797,2122358,269356476,2571,1515538,1941891301,1514431,1941766053,1107,125248,1498215,6085,1853118,189168,2571,1794,57778.0,13000.0,-67.0,-64.0,-66.0,-69.0,-66.0,-63.0,-66.0,-68.0,-77.0,-84.0,-75.0,-80.0,10.0,20.0,9.0,11.0,1
1423,CC:2F:71:3E:C5:1F,5529249,4451613871,3406891,4182257395,2122358,269356476,502,93180,7997731,78589,6268353,14591,1729378,21529,531,3414283,870683,502,2926,6500.0,1000.0,-69.0,-72.0,-65.0,-61.0,-70.0,-71.0,-67.0,-61.0,-77.0,-84.0,-75.0,-80.0,8.0,12.0,10.0,19.0,1
1424,F8:59:71:5A:E0:3D,3425860,2222991850,1303500,1953635172,2122360,269356678,294,736624,898372243,735940,898289886,684,82357,725583,1840,1303620,155809,294,1086,144444.0,1000.0,-66.0,-72.0,-63.0,-70.0,-65.0,-71.0,-62.0,-69.0,-77.0,-84.0,-75.0,-80.0,11.0,12.0,12.0,10.0,1
1425,CC:2F:71:3F:1F:24,3975865,2716584541,1853503,2447227661,2122362,269356880,2571,1515689,1942099281,1514582,1941974033,1107,125248,1498366,6085,1853288,189198,2571,1794,72222.0,21667.0,-67.0,-64.0,-67.0,-67.0,-67.0,-64.0,-66.0,-67.0,-77.0,-84.0,-75.0,-80.0,10.0,20.0,8.0,13.0,1
1426,CC:2F:71:3E:C5:1F,5529253,4451614275,3406891,4182257395,2122362,269356880,502,93180,7997731,78589,6268353,14591,1729378,21529,531,3414283,870683,502,2926,6500.0,1000.0,-69.0,-72.0,-65.0,-61.0,-70.0,-71.0,-67.0,-61.0,-77.0,-84.0,-75.0,-80.0,8.0,12.0,10.0,19.0,1
1427,F8:59:71:5A:E0:3D,3425931,2223091793,1303564,1953734236,2122367,269357557,294,736688,898470901,736004,898388544,684,82357,725647,1840,1303684,155854,294,1086,144444.0,43333.0,-66.0,-72.0,-63.0,-69.0,-66.0,-71.0,-63.0,-70.0,-77.0,-84.0,-75.0,-80.0,11.0,12.0,12.0,11.0,1
1428,CC:2F:71:3F:1F:24,3976030,2716793746,1853663,2447436189,2122367,269357557,2571,1515832,1942297789,1514725,1942172541,1107,125248,1498509,6085,1853447,189243,2571,1794,58500.0,19500.0,-67.0,-64.0,-66.0,-68.0,-67.0,-63.0,-67.0,-67.0,-77.0,-84.0,-75.0,-80.0,10.0,20.0,9.0,12.0,1
1429,CC:2F:71:3E:C5:1F,5529258,4451614952,3406891,4182257395,2122367,269357557,502,93180,7997731,78589,6268353,14591,1729378,21529,531,3414283,870683,502,2926,6500.0,1000.0,-69.0,-72.0,-65.0,-61.0,-70.0,-71.0,-67.0,-61.0,-77.0,-84.0,-75.0,-80.0,8.0,12.0,10.0,19.0,1
1430,F8:59:71:5A:E0:3D,3426010,2223195901,1303640,1953838082,2122370,269357819,294,736763,898578143,736079,898495786,684,82357,725720,1840,1303760,155894,294,1086,144444.0,43333.0,-67.0,-72.0,-65.0,-71.0,-66.0,-71.0,-63.0,-70.0,-77.0,-83.0,-75.0,-80.0,10.0,11.0,10.0,9.0,1
1431,CC:2F:71:3F:1F:24,3976199,2717011188,1853829,2447653369,2122370,269357819,2571,1515985,1942508863,1514878,1942383615,1107,125248,1498661,6085,1853614,189319,2571,1794,72222.0,19500.0,-67.0,-64.0,-66.0,-68.0,-67.0,-63.0,-66.0,-67.0,-77.0,-83.0,-75.0,-80.0,10.0,19.0,9.0,12.0,1
1432,CC:2F:71:3E:C5:1F,5529263,4451615416,3406891,4182257395,2122372,269358021,502,93180,7997731,78589,6268353,14591,1729378,21529,531,3414283,870683,502,2926,6500.0,1000.0,-69.0,-72.0,-65.0,-61.0,-70.0,-71.0,-67.0,-61.0,-77.0,-83.0,-75.0,-80.0,8.0,11.0,10.0,19.0,1
1433,F8:59:71:5A:E0:3D,3426452,2223823337,1304076,1954464912,2122376,269358425,294,736901,898732802,736217,898650445,684,82357,725858,1840,1304133,156108,294,1086,144444.0,43333.0,-68.0,-72.0,-65.0,-72.0,-67.0,-71.0,-64.0,-70.0,-77.0,-83.0,-75.0,-80.0,9.0,11.0,10.0,8.0,1
1434,CC:2F:71:3F:1F:24,3977062,2718194856,1854684,2448836229,2122378,269358627,2571,1516367,1942897932,1515260,1942772684,1107,125248,1499043,6085,1854463,190081,2571,1794,78000.0,13000.0,-68.0,-63.0,-67.0,-68.0,-67.0,-63.0,-66.0,-67.0,-77.0,-83.0,-75.0,-80.0,9.0,20.0,8.0,12.0,1
1435,CC:2F:71:3E:C5:1F,5529273,4451616400,3406892,4182257511,2122381,269358889,502,93180,7997731,78589,6268353,14591,1729378,21529,531,3414284,870683,502,2926,6500.0,1000.0,-69.0,-72.0,-65.0,-61.0,-70.0,-71.0,-67.0,-61.0,-77.0,-83.0,-75.0,-80.0,8.0,11.0,10.0,19.0,1
1436,F8:59:71:5A:E0:3D,3426668,2224135858,1304281,1954776363,2122387,269359495,294,737096,898985889,736412,898903532,684,82357,726053,1840,1304401,156231,294,1087,144444.0,43333.0,-67.0,-72.0,-64.0,-69.0,-66.0,-71.0,-64.0,-69.0,-77.0,-83.0,-75.0,-80.0,10.0,11.0,11.0,11.0,1
1437,CC:2F:71:3F:1F:24,3978312,2719998095,1855922,2450638336,2122390,269359759,2571,1516886,1943466696,1515779,1943341448,1107,125248,1499560,6086,1855701,191487,2571,1794,104000.0,1000.0,-70.0,-63.0,-71.0,-71.0,-68.0,-63.0,-67.0,-69.0,-77.0,-83.0,-75.0,-80.0,7.0,20.0,4.0,9.0,1
1438,CC:2F:71:3E:C5:1F,5529285,4451617532,3406892,4182257511,2122393,269360021,502,93181,7997849,78589,6268353,14592,1729496,21530,531,3414284,870683,502,2926,6500.0,1000.0,-69.0,-72.0,-66.0,-61.0,-70.0,-72.0,-67.0,-61.0,-77.0,-83.0,-75.0,-80.0,8.0,11.0,9.0,19.0,1
1439,F8:59:71:5A:E0:3D,3426828,2224359835,1304431,1954999410,2122397,269360425,294,737247,899213350,736563,899130993,684,82357,726204,1840,1304551,156286,294,1087,144444.0,43333.0,-66.0,-71.0,-63.0,-69.0,-67.0,-71.0,-64.0,-70.0,-77.0,-82.0,-75.0,-80.0,11.0,11.0,12.0,11.0,1
1440,CC:2F:71:3F:1F:24,3979243,2721311804,1856846,2451951379,2122397,269360425,2571,1517261,1943847411,1516154,1943722163,1107,125248,1499935,6086,1856636,192404,2571,1794,86667.0,14444.0,-70.0,-64.0,-70.0,-71.0,-68.0,-63.0,-67.0,-69.0,-77.0,-82.0,-75.0,-80.0,7.0,18.0,5.0,9.0,1
1441,CC:2F:71:3E:C5:1F,5529289,4451617936,3406892,4182257511,2122397,269360425,502,93181,7997849,78589,6268353,14592,1729496,21530,531,3414284,870683,502,2926,6500.0,1000.0,-69.0,-72.0,-66.0,-61.0,-70.0,-72.0,-67.0,-61.0,-77.0,-82.0,-75.0,-80.0,8.0,10.0,9.0,19.0,1
1442,F8:59:71:5A:E0:3D,3427177,2224885739,1304774,1955524708,2122403,269361031,294,737404,899381115,736720,899298758,684,82357,726361,1840,1304894,156363,294,1087,144444.0,43333.0,-69.0,-72.0,-66.0,-72.0,-67.0,-71.0,-64.0,-70.0,-77.0,-82.0,-75.0,-80.0,8.0,10.0,9.0,8.0,1
1443,CC:2F:71:3F:1F:24,3979469,2721589436,1857066,2452228405,2122403,269361031,2580,1517464,1944112796,1516357,1943987548,1107,125248,1500132,6087,1856856,192695,2580,1794,86667.0,1000.0,-71.0,-63.0,-71.0,-70.0,-72.0,-66.0,-71.0,-72.0,-77.0,-82.0,-75.0,-80.0,6.0,19.0,4.0,10.0,1
1444,CC:2F:71:3E:C5:1F,5529296,4451618602,3406892,4182257511,2122404,269361091,502,93181,7997849,78589,6268353,14592,1729496,21530,531,3414284,870683,502,2926,6500.0,1000.0,-69.0,-72.0,-66.0,-61.0,-70.0,-72.0,-67.0,-61.0,-77.0,-82.0,-75.0,-80.0,8.0,10.0,9.0,19.0,1
1445,F8:59:71:5A:E0:3D,3427253,2224996147,1304847,1955634854,2122406,269361293,294,737477,899489326,736793,899406969,684,82357,726434,1840,1304967,156422,294,1087,144444.0,43333.0,-67.0,-71.0,-63.0,-69.0,-67.0,-71.0,-63.0,-70.0,-77.0,-82.0,-75.0,-80.0,10.0,11.0,12.0,11.0,1
1446,CC:2F:71:3F:1F:24,3979648,2721823842,1857242,2452462549,2122406,269361293,2581,1517635,1944339724,1516528,1944214476,1107,125248,1500293,6089,1857036,192874,2581,1794,86667.0,14444.0,-67.0,-64.0,-67.0,-68.0,-66.0,-63.0,-67.0,-67.0,-77.0,-82.0,-75.0,-80.0,10.0,18.0,8.0,12.0,1
1447,CC:2F:71:3E:C5:1F,5529300,4451619006,3406892,4182257511,2122408,269361495,502,93181,7997849,78589,6268353,14592,1729496,21530,531,3414284,870683,502,2926,6500.0,1000.0,-69.0,-72.0,-66.0,-61.0,-70.0,-72.0,-67.0,-61.0,-77.0,-82.0,-75.0,-80.0,8.0,10.0,9.0,19.0,1
1448,F8:59:71:5A:E0:3D,3427332,2225108367,1304919,1955746406,2122413,269361961,294,737551,899601920,736866,899519445,685,82475,726507,1840,1305039,156464,294,1087,144444.0,43333.0,-66.0,-71.0,-64.0,-69.0,-66.0,-71.0,-64.0,-70.0,-77.0,-82.0,-75.0,-80.0,11.0,11.0,11.0,11.0,1
1449,CC:2F:71:3F:1F:24,3979835,2722057832,1857420,2452695669,2122415,269362163,2584,1517807,1944563992,1516700,1944438744,1107,125248,1500457,6090,1857215,193039,2584,1794,86667.0,14444.0,-67.0,-64.0,-67.0,-69.0,-67.0,-63.0,-67.0,-68.0,-77.0,-82.0,-75.0,-80.0,10.0,18.0,8.0,11.0,1
1450,CC:2F:71:3E:C5:1F,5529307,4451619674,3406892,4182257511,2122415,269362163,502,93181,7997849,78589,6268353,14592,1729496,21530,531,3414284,870683,502,2926,6500.0,1000.0,-69.0,-72.0,-66.0,-61.0,-70.0,-72.0,-67.0,-61.0,-77.0,-82.0,-75.0,-80.0,8.0,10.0,9.0,19.0,1
1451,F8:59:71:5A:E0:3D,3427488,2225313073,1305072,1955950850,2122416,269362223,294,737647,899714570,736962,899632095,685,82475,726603,1840,1305192,156542,294,1087,144444.0,43333.0,-66.0,-72.0,-64.0,-70.0,-66.0,-72.0,-63.0,-69.0,-77.0,-82.0,-75.0,-80.0,11.0,10.0,11.0,10.0,1
1452,CC:2F:71:3F:1F:24,3979997,2722269454,1857581,2452907231,2122416,269362223,2584,1517955,1944768776,1516848,1944643528,1107,125248,1500605,6090,1857376,193116,2584,1794,86667.0,14444.0,-66.0,-64.0,-66.0,-68.0,-68.0,-64.0,-69.0,-68.0,-77.0,-82.0,-75.0,-80.0,11.0,18.0,9.0,12.0,1
1453,CC:2F:71:3E:C5:1F,5529308,4451619734,3406892,4182257511,2122416,269362223,502,93181,7997849,78589,6268353,14592,1729496,21530,531,3414284,870683,502,2926,6500.0,1000.0,-69.0,-72.0,-66.0,-61.0,-70.0,-72.0,-67.0,-61.0,-76.0,-82.0,-74.0,-79.0,7.0,10.0,8.0,18.0,1
1454,F8:59:71:5A:E0:3D,3427580,2225443633,1305156,1956080602,2122424,269363031,294,737717,899822412,737032,899739937,685,82475,726673,1840,1305276,156595,294,1087,130000.0,39000.0,-66.0,-71.0,-62.0,-68.0,-66.0,-71.0,-63.0,-69.0,-76.0,-82.0,-74.0,-79.0,10.0,11.0,12.0,11.0,1
1455,CC:2F:71:3F:1F:24,3980211,2722548078,1857787,2453185047,2122424,269363031,2584,1518151,1945037524,1517044,1944912276,1107,125248,1500798,6090,1857584,193235,2584,1794,57778.0,6500.0,-71.0,-64.0,-72.0,-70.0,-68.0,-63.0,-68.0,-68.0,-76.0,-82.0,-74.0,-79.0,5.0,18.0,2.0,9.0,1
1456,CC:2F:71:3E:C5:1F,5529316,4451620542,3406892,4182257511,2122424,269363031,502,93181,7997849,78589,6268353,14592,1729496,21530,531,3414284,870683,502,2926,6500.0,1000.0,-69.0,-72.0,-66.0,-61.0,-70.0,-72.0,-67.0,-61.0,-76.0,-82.0,-74.0,-79.0,7.0,10.0,8.0,18.0,1
1457,F8:59:71:5A:E0:3D,3427698,2225616417,1305270,1956252849,2122428,269363568,294,737806,899957391,737121,899874916,685,82475,726762,1840,1305390,156667,294,1087,144444.0,43333.0,-68.0,-73.0,-65.0,-71.0,-66.0,-72.0,-63.0,-69.0,-77.0,-82.0,-74.0,-79.0,9.0,9.0,9.0,8.0,1
1458,CC:2F:71:3F:1F:24,3980396,2722787101,1857967,2453423473,2122429,269363628,2584,1518328,1945279748,1517220,1945154382,1108,125366,1500973,6090,1857766,193372,2584,1794,52000.0,13000.0,-67.0,-63.0,-67.0,-69.0,-66.0,-63.0,-66.0,-69.0,-77.0,-82.0,-74.0,-79.0,10.0,19.0,7.0,10.0,1
1459,CC:2F:71:3E:C5:1F,5529323,4451621341,3406892,4182257511,2122431,269363830,502,93181,7997849,78589,6268353,14592,1729496,21530,531,3414284,870683,502,2926,6500.0,1000.0,-69.0,-72.0,-66.0,-61.0,-70.0,-72.0,-67.0,-61.0,-77.0,-82.0,-74.0,-79.0,8.0,10.0,8.0,18.0,1
1460,F8:59:71:5A:E0:3D,3427788,2225740024,1305353,1956375790,2122435,269364234,294,737895,900078735,737210,899996260,685,82475,726851,1840,1305475,156722,294,1087,144444.0,1000.0,-66.0,-72.0,-63.0,-69.0,-66.0,-71.0,-63.0,-69.0,-77.0,-82.0,-74.0,-79.0,11.0,10.0,11.0,10.0,1
1461,CC:2F:71:3F:1F:24,3980577,2723017665,1858142,2453653431,2122435,269364234,2584,1518482,1945492348,1517374,1945366982,1108,125366,1501127,6090,1857943,193473,2584,1794,72222.0,21667.0,-67.0,-63.0,-67.0,-69.0,-67.0,-63.0,-67.0,-68.0,-77.0,-82.0,-74.0,-79.0,10.0,19.0,7.0,10.0,1
1462,CC:2F:71:3E:C5:1F,5529327,4451621745,3406892,4182257511,2122435,269364234,502,93181,7997849,78589,6268353,14592,1729496,21530,531,3414284,870683,502,2926,6500.0,1000.0,-69.0,-72.0,-66.0,-61.0,-70.0,-72.0,-67.0,-61.0,-77.0,-82.0,-74.0,-79.0,8.0,10.0,8.0,18.0,1
1463,F8:59:71:5A:E0:3D,3428264,2226437246,1305827,1957072810,2122437,269364436,294,738063,900215015,737378,900132540,685,82475,727018,1840,1305950,157068,294,1087,144444.0,43333.0,-66.0,-71.0,-62.0,-69.0,-66.0,-71.0,-63.0,-70.0,-77.0,-82.0,-74.0,-79.0,11.0,11.0,12.0,10.0,1
1464,CC:2F:71:3F:1F:24,3980776,2723263072,1858338,2453898502,2122438,269364570,2584,1518665,1945728543,1517557,1945603177,1108,125366,1501310,6090,1858140,193569,2584,1794,72222.0,21667.0,-67.0,-63.0,-66.0,-68.0,-67.0,-63.0,-68.0,-69.0,-77.0,-82.0,-74.0,-79.0,10.0,19.0,8.0,11.0,1
1465,CC:2F:71:3E:C5:1F,5529331,4451622149,3406892,4182257511,2122439,269364638,502,93181,7997849,78589,6268353,14592,1729496,21530,531,3414284,870683,502,2926,6500.0,1000.0,-69.0,-72.0,-66.0,-61.0,-70.0,-72.0,-67.0,-61.0,-77.0,-82.0,-74.0,-79.0,8.0,10.0,8.0,18.0,1
1466,F8:59:71:5A:E0:3D,3428336,2226536812,1305892,1957171710,2122444,269365102,294,738128,900313681,737443,900231206,685,82475,727083,1840,1306015,157110,294,1087,144444.0,43333.0,-67.0,-72.0,-64.0,-71.0,-66.0,-72.0,-63.0,-70.0,-77.0,-82.0,-74.0,-79.0,10.0,10.0,10.0,8.0,1
1467,CC:2F:71:3F:1F:24,3980965,2723480281,1858521,2454115179,2122444,269365102,2584,1518837,1945944294,1517729,1945818928,1108,125366,1501482,6090,1858322,193707,2584,1794,65000.0,21667.0,-66.0,-64.0,-66.0,-68.0,-66.0,-63.0,-67.0,-68.0,-77.0,-82.0,-74.0,-79.0,11.0,18.0,8.0,11.0,1
1468,CC:2F:71:3E:C5:1F,5529336,4451622613,3406892,4182257511,2122444,269365102,502,93181,7997849,78589,6268353,14592,1729496,21530,531,3414285,870683,502,2926,6500.0,1000.0,-69.0,-72.0,-66.0,-61.0,-70.0,-72.0,-67.0,-61.0,-77.0,-82.0,-74.0,-79.0,8.0,10.0,8.0,18.0,1
1469,F8:59:71:5A:E0:3D,3428406,2226641902,1305960,1957276598,2122446,269365304,294,738197,900418471,737512,900335996,685,82475,727151,1840,1306084,157175,294,1087,144444.0,43333.0,-68.0,-73.0,-65.0,-71.0,-67.0,-71.0,-63.0,-70.0,-77.0,-82.0,-74.0,-79.0,9.0,9.0,9.0,8.0,1
1470,CC:2F:71:3F:1F:24,3981137,2723703543,1858691,2454338239,2122446,269365304,2584,1518986,1946152042,1517878,1946026676,1108,125366,1501631,6090,1858493,193835,2584,1794,86667.0,14444.0,-69.0,-64.0,-72.0,-70.0,-67.0,-63.0,-69.0,-69.0,-77.0,-82.0,-74.0,-79.0,8.0,18.0,2.0,9.0,1
1471,CC:2F:71:3E:C5:1F,5529340,4451623017,3406892,4182257511,2122448,269365506,502,93181,7997849,78589,6268353,14592,1729496,21530,531,3414285,870683,502,2926,6500.0,1000.0,-69.0,-72.0,-66.0,-61.0,-70.0,-72.0,-67.0,-61.0,-77.0,-82.0,-74.0,-79.0,8.0,10.0,8.0,18.0,1
1472,F8:59:71:5A:E0:3D,3428483,2226752618,1306031,1957386708,2122452,269365910,294,738269,900526607,737584,900444132,685,82475,727221,1840,1306155,157226,294,1088,144444.0,43333.0,-66.0,-71.0,-63.0,-70.0,-66.0,-71.0,-63.0,-70.0,-77.0,-82.0,-74.0,-79.0,11.0,11.0,11.0,9.0,1
1473,CC:2F:71:3F:1F:24,3981324,2723944521,1858871,2454578551,2122453,269365970,2584,1519168,1946407790,1518060,1946282424,1108,125366,1501813,6090,1858678,194025,2584,1794,65000.0,1000.0,-66.0,-63.0,-66.0,-68.0,-66.0,-63.0,-66.0,-68.0,-77.0,-82.0,-74.0,-79.0,11.0,19.0,8.0,11.0,1
1474,CC:2F:71:3E:C5:1F,5529345,4451623481,3406892,4182257511,2122453,269365970,502,93181,7997849,78589,6268353,14592,1729496,21530,531,3414285,870683,502,2926,6500.0,1000.0,-69.0,-72.0,-66.0,-61.0,-70.0,-72.0,-67.0,-61.0,-77.0,-82.0,-74.0,-79.0,8.0,10.0,8.0,18.0,1
1475,F8:59:71:5A:E0:3D,3428729,2227123040,1306272,1957756666,2122457,269366374,294,738394,900687185,737709,900604710,685,82475,727345,1840,1306395,157378,294,1088,144444.0,1000.0,-66.0,-72.0,-63.0,-70.0,-66.0,-71.0,-63.0,-69.0,-77.0,-82.0,-74.0,-79.0,11.0,10.0,11.0,9.0,1
1476,CC:2F:71:3F:1F:24,3981571,2724273431,1859110,2454906653,2122461,269366778,2584,1519387,1946716440,1518279,1946591074,1108,125366,1502031,6090,1858916,194321,2584,1794,52000.0,13000.0,-67.0,-63.0,-66.0,-69.0,-67.0,-63.0,-67.0,-69.0,-77.0,-82.0,-74.0,-79.0,10.0,19.0,8.0,10.0,1
1477,CC:2F:71:3E:C5:1F,5529353,4451624289,3406892,4182257511,2122461,269366778,502,93181,7997849,78589,6268353,14592,1729496,21530,531,3414285,870683,502,2926,6500.0,1000.0,-69.0,-72.0,-66.0,-61.0,-70.0,-72.0,-67.0,-61.0,-77.0,-82.0,-74.0,-79.0,8.0,10.0,8.0,18.0,1
1478,F8:59:71:5A:E0:3D,3428866,2227296284,1306405,1957929506,2122461,269366778,294,738488,900801259,737803,900718784,685,82475,727439,1840,1306530,157440,294,1090,144444.0,43333.0,-66.0,-71.0,-63.0,-69.0,-66.0,-71.0,-63.0,-69.0,-77.0,-82.0,-75.0,-80.0,11.0,11.0,12.0,11.0,1
1479,CC:2F:71:3F:1F:24,3981757,2724520701,1859295,2455153863,2122462,269366838,2584,1519569,1946969354,1518461,1946843988,1108,125366,1502213,6091,1859104,194481,2584,1794,58500.0,19500.0,-67.0,-64.0,-66.0,-69.0,-66.0,-63.0,-66.0,-68.0,-77.0,-82.0,-75.0,-80.0,10.0,18.0,9.0,11.0,1
1480,CC:2F:71:3E:C5:1F,5529356,4451624551,3406892,4182257511,2122464,269367040,502,93181,7997849,78589,6268353,14592,1729496,21530,531,3414285,870683,502,2926,6500.0,1000.0,-69.0,-72.0,-66.0,-61.0,-70.0,-72.0,-67.0,-61.0,-77.0,-82.0,-75.0,-80.0,8.0,10.0,9.0,19.0,1
1481,F8:59:71:5A:E0:3D,3429035,2227541001,1306565,1958173355,2122470,269367646,294,738607,900949915,737922,900867440,685,82475,727558,1840,1306690,157490,294,1091,144444.0,43333.0,-66.0,-71.0,-63.0,-68.0,-66.0,-71.0,-63.0,-70.0,-77.0,-82.0,-75.0,-80.0,11.0,11.0,12.0,12.0,1
1482,CC:2F:71:3F:1F:24,3982124,2725010314,1859654,2455642668,2122470,269367646,2584,1519764,1947203651,1518656,1947078285,1108,125366,1502408,6091,1859432,194608,2584,1794,72222.0,21667.0,-69.0,-64.0,-72.0,-70.0,-68.0,-63.0,-70.0,-69.0,-77.0,-82.0,-75.0,-80.0,8.0,18.0,3.0,10.0,1
1483,CC:2F:71:3E:C5:1F,5529363,4451625295,3406893,4182257649,2122470,269367646,502,93184,7998292,78592,6268796,14592,1729496,21533,531,3414286,870684,502,2926,6500.0,1000.0,-75.0,-73.0,-70.0,-62.0,-70.0,-72.0,-66.0,-61.0,-77.0,-82.0,-75.0,-80.0,2.0,9.0,5.0,18.0,1
1484,F8:59:71:5A:E0:3D,3429184,2227753716,1306705,1958385202,2122479,269368514,294,738752,901168472,738067,901085997,685,82475,727703,1840,1306830,157522,294,1091,144444.0,43333.0,-68.0,-73.0,-65.0,-72.0,-67.0,-71.0,-64.0,-71.0,-77.0,-82.0,-75.0,-80.0,9.0,9.0,10.0,8.0,1
1485,CC:2F:71:3F:1F:24,3984197,2728015279,1861718,2458646765,2122479,269368514,2584,1520334,1947697227,1519226,1947571861,1108,125366,1502976,6091,1861503,196555,2584,1795,86667.0,14444.0,-67.0,-63.0,-66.0,-68.0,-67.0,-63.0,-69.0,-69.0,-77.0,-82.0,-75.0,-80.0,10.0,19.0,9.0,12.0,1
1486,CC:2F:71:3E:C5:1F,5529375,4451626738,3406896,4182258224,2122479,269368514,502,93186,7998524,78594,6269028,14592,1729496,21535,531,3414289,870686,502,2926,6500.0,1000.0,-68.0,-71.0,-66.0,-62.0,-69.0,-72.0,-66.0,-61.0,-77.0,-82.0,-75.0,-80.0,9.0,11.0,9.0,18.0,1
1487,F8:59:71:5A:E0:3D,3429322,2227962590,1306841,1958593874,2122481,269368716,294,738856,901318116,738171,901235641,685,82475,727807,1840,1306966,157574,294,1091,144444.0,43333.0,-68.0,-72.0,-65.0,-72.0,-67.0,-71.0,-64.0,-70.0,-77.0,-82.0,-75.0,-80.0,9.0,10.0,10.0,8.0,1
1488,CC:2F:71:3F:1F:24,3984777,2728837730,1862296,2459469014,2122481,269368716,2584,1520581,1947963204,1519473,1947837838,1108,125366,1503223,6091,1862107,196727,2584,1795,86667.0,14444.0,-69.0,-64.0,-73.0,-70.0,-68.0,-64.0,-71.0,-69.0,-77.0,-82.0,-75.0,-80.0,8.0,18.0,2.0,10.0,1
1489,CC:2F:71:3E:C5:1F,5529378,4451627213,3406896,4182258224,2122482,269368989,502,93186,7998524,78594,6269028,14592,1729496,21535,531,3414289,870686,502,2926,6500.0,1000.0,-68.0,-71.0,-66.0,-62.0,-69.0,-72.0,-66.0,-61.0,-79.0,-83.0,-76.0,-81.0,11.0,12.0,10.0,19.0,1
1490,F8:59:71:5A:E0:3D,3429396,2228065869,1306907,1958696214,2122489,269369655,294,738921,901418216,738236,901335741,685,82475,727872,1840,1307032,157607,294,1091,144444.0,43333.0,-66.0,-72.0,-63.0,-69.0,-66.0,-71.0,-63.0,-69.0,-79.0,-83.0,-76.0,-81.0,13.0,11.0,13.0,12.0,1
1491,CC:2F:71:3F:1F:24,3984950,2729053035,1862461,2459683380,2122489,269369655,2584,1520732,1948169970,1519624,1948044604,1108,125366,1503374,6091,1862272,196817,2584,1795,86667.0,13000.0,-67.0,-64.0,-67.0,-68.0,-67.0,-63.0,-68.0,-69.0,-79.0,-83.0,-76.0,-81.0,12.0,19.0,9.0,13.0,1
1492,CC:2F:71:3E:C5:1F,5529385,4451627879,3406896,4182258224,2122489,269369655,502,93186,7998524,78594,6269028,14592,1729496,21535,531,3414289,870686,502,2926,6500.0,1000.0,-68.0,-71.0,-66.0,-62.0,-69.0,-72.0,-66.0,-61.0,-79.0,-83.0,-76.0,-81.0,11.0,12.0,10.0,19.0,1
1493,F8:59:71:5A:E0:3D,3429468,2228174403,1306977,1958804546,2122491,269369857,294,738992,901527612,738307,901445137,685,82475,727943,1840,1307102,157641,294,1091,144444.0,43333.0,-68.0,-73.0,-65.0,-72.0,-67.0,-71.0,-63.0,-70.0,-79.0,-83.0,-76.0,-81.0,11.0,10.0,11.0,9.0,1
1494,CC:2F:71:3F:1F:24,3985125,2729282999,1862634,2459913142,2122491,269369857,2584,1520891,1948391876,1519783,1948266510,1108,125366,1503533,6091,1862446,196944,2584,1796,86667.0,13000.0,-66.0,-64.0,-66.0,-69.0,-67.0,-63.0,-67.0,-69.0,-79.0,-83.0,-76.0,-81.0,13.0,19.0,10.0,12.0,1
1495,CC:2F:71:3E:C5:1F,5529388,4451628197,3406897,4182258340,2122491,269369857,502,93186,7998524,78594,6269028,14592,1729496,21535,531,3414290,870687,502,2926,6500.0,1000.0,-68.0,-71.0,-66.0,-62.0,-69.0,-72.0,-66.0,-61.0,-79.0,-83.0,-76.0,-81.0,11.0,12.0,10.0,19.0,1
1496,F8:59:71:5A:E0:3D,3429761,2228618178,1307262,1959247347,2122499,269370831,294,739083,901632737,738398,901550262,685,82475,728033,1840,1307387,157827,294,1091,144444.0,1000.0,-67.0,-70.0,-63.0,-71.0,-67.0,-71.0,-64.0,-70.0,-77.0,-82.0,-75.0,-80.0,10.0,12.0,12.0,9.0,1
1497,CC:2F:71:3F:1F:24,3985303,2729504747,1862804,2460133916,2122499,269370831,2584,1521057,1948620512,1519949,1948495146,1108,125366,1503699,6091,1862615,197024,2584,1800,86667.0,14444.0,-67.0,-63.0,-67.0,-68.0,-67.0,-63.0,-67.0,-68.0,-77.0,-82.0,-75.0,-80.0,10.0,19.0,8.0,12.0,1
1498,CC:2F:71:3E:C5:1F,5529396,4451629171,3406897,4182258340,2122499,269370831,502,93186,7998524,78594,6269028,14592,1729496,21535,531,3414290,870687,502,2926,6500.0,1000.0,-68.0,-71.0,-66.0,-62.0,-69.0,-72.0,-66.0,-61.0,-77.0,-82.0,-75.0,-80.0,9.0,11.0,9.0,18.0,1
1499,F8:59:71:5A:E0:3D,3430120,2229126883,1307618,1959755790,2122502,269371093,294,739220,901770920,738535,901688445,685,82475,728170,1840,1307743,158093,294,1091,144444.0,43333.0,-68.0,-73.0,-65.0,-72.0,-66.0,-72.0,-63.0,-70.0,-77.0,-82.0,-75.0,-80.0,9.0,9.0,10.0,8.0,1
1500,CC:2F:71:3F:1F:24,3985519,2729769121,1863015,2460397826,2122504,269371295,2584,1521240,1948860500,1520132,1948735134,1108,125366,1503882,6091,1862829,197174,2584,1800,78000.0,13000.0,-67.0,-63.0,-67.0,-68.0,-67.0,-63.0,-67.0,-68.0,-77.0,-82.0,-75.0,-80.0,10.0,19.0,8.0,12.0,1
1501,CC:2F:71:3E:C5:1F,5529406,4451630155,3406898,4182258456,2122508,269371699,502,93187,7998630,78595,6269134,14592,1729496,21536,531,3414291,870687,502,2926,6500.0,1000.0,-74.0,-73.0,-70.0,-61.0,-70.0,-72.0,-66.0,-61.0,-77.0,-82.0,-75.0,-80.0,3.0,9.0,5.0,19.0,1
1502,F8:59:71:5A:E0:3D,3430197,2229237375,1307689,1959865676,2122508,269371699,294,739294,901884964,738609,901802489,685,82475,728243,1840,1307814,158128,294,1092,144444.0,43333.0,-68.0,-72.0,-65.0,-71.0,-66.0,-71.0,-63.0,-69.0,-77.0,-82.0,-75.0,-80.0,9.0,10.0,10.0,9.0,1
1503,CC:2F:71:3F:1F:24,3985693,2729993593,1863185,2460621894,2122508,269371699,2584,1521396,1949074756,1520288,1948949390,1108,125366,1504038,6091,1862999,197225,2584,1800,86667.0,14444.0,-67.0,-64.0,-67.0,-68.0,-67.0,-63.0,-68.0,-68.0,-77.0,-82.0,-75.0,-80.0,10.0,18.0,8.0,12.0,1
1504,CC:2F:71:3E:C5:1F,5529406,4451630155,3406898,4182258456,2122508,269371699,502,93187,7998630,78595,6269134,14592,1729496,21536,531,3414291,870687,502,2926,6500.0,1000.0,-74.0,-73.0,-70.0,-61.0,-70.0,-72.0,-66.0,-61.0,-77.0,-82.0,-75.0,-80.0,3.0,9.0,5.0,19.0,1
1505,F8:59:71:5A:E0:3D,3430263,2229337033,1307753,1959965132,2122510,269371901,294,739358,901983566,738673,901901091,685,82475,728307,1840,1307878,158156,294,1092,144444.0,43333.0,-68.0,-73.0,-65.0,-71.0,-67.0,-72.0,-64.0,-70.0,-77.0,-82.0,-75.0,-80.0,9.0,9.0,10.0,9.0,1
1506,CC:2F:71:3F:1F:24,3985855,2730202085,1863344,2460830124,2122511,269371961,2584,1521541,1949274920,1520433,1949149554,1108,125366,1504183,6091,1863158,197274,2584,1800,86667.0,14444.0,-69.0,-64.0,-73.0,-70.0,-68.0,-63.0,-69.0,-68.0,-77.0,-82.0,-75.0,-80.0,8.0,18.0,2.0,10.0,1
1507,CC:2F:71:3E:C5:1F,5529411,4451630619,3406898,4182258456,2122513,269372163,502,93187,7998630,78595,6269134,14592,1729496,21536,531,3414291,870687,502,2926,6500.0,1000.0,-74.0,-73.0,-70.0,-61.0,-70.0,-72.0,-66.0,-61.0,-77.0,-82.0,-75.0,-80.0,3.0,9.0,5.0,19.0,1
1508,F8:59:71:5A:E0:3D,3430603,2229812439,1308085,1960439810,2122518,269372629,294,739480,902098284,738795,902015809,685,82475,728429,1840,1308210,158326,294,1092,144444.0,43333.0,-65.0,-71.0,-64.0,-69.0,-67.0,-72.0,-64.0,-70.0,-77.0,-82.0,-75.0,-80.0,12.0,11.0,11.0,11.0,1
1509,CC:2F:71:3F:1F:24,3986029,2730420863,1863511,2461048234,2122518,269372629,2584,1521694,1949481804,1520586,1949356438,1108,125366,1504336,6091,1863325,197311,2584,1800,86667.0,14444.0,-69.0,-64.0,-73.0,-70.0,-68.0,-64.0,-70.0,-69.0,-77.0,-82.0,-75.0,-80.0,8.0,18.0,2.0,10.0,1
1510,CC:2F:71:3E:C5:1F,5529416,4451631085,3406898,4182258456,2122518,269372629,502,93188,7998748,78595,6269134,14593,1729614,21537,531,3414291,870687,502,2926,6500.0,1000.0,-69.0,-72.0,-66.0,-61.0,-70.0,-72.0,-67.0,-61.0,-77.0,-82.0,-75.0,-80.0,8.0,10.0,9.0,19.0,1
1511,F8:59:71:5A:E0:3D,3430675,2229921309,1308155,1960548478,2122520,269372831,294,739549,902204544,738864,902122069,685,82475,728498,1840,1308280,158348,294,1092,144444.0,43333.0,-65.0,-72.0,-63.0,-69.0,-66.0,-71.0,-63.0,-69.0,-77.0,-82.0,-75.0,-80.0,12.0,10.0,12.0,11.0,1
1512,CC:2F:71:3F:1F:24,3986202,2730647103,1863682,2461274272,2122520,269372831,2584,1521853,1949700820,1520745,1949575454,1108,125366,1504495,6091,1863496,197424,2584,1801,78000.0,13000.0,-68.0,-64.0,-66.0,-69.0,-68.0,-63.0,-70.0,-69.0,-77.0,-82.0,-75.0,-80.0,9.0,18.0,9.0,11.0,1
1513,CC:2F:71:3E:C5:1F,5529420,4451631489,3406898,4182258456,2122522,269373033,502,93188,7998748,78595,6269134,14593,1729614,21537,531,3414291,870687,502,2926,6500.0,1000.0,-69.0,-72.0,-66.0,-61.0,-70.0,-72.0,-67.0,-61.0,-77.0,-82.0,-75.0,-80.0,8.0,10.0,9.0,19.0,1
1514,F8:59:71:5A:E0:3D,3430885,2230224685,1308357,1960851126,2122528,269373559,294,739671,902345564,738985,902262971,686,82593,728620,1840,1308482,158460,294,1093,144444.0,43333.0,-68.0,-73.0,-65.0,-72.0,-67.0,-72.0,-64.0,-71.0,-77.0,-82.0,-75.0,-80.0,9.0,9.0,10.0,8.0,1
1515,CC:2F:71:3F:1F:24,3986421,2730918416,1863893,2461544857,2122528,269373559,2584,1522048,1949965028,1520940,1949839662,1108,125366,1504690,6091,1863707,197527,2584,1801,86667.0,14444.0,-67.0,-64.0,-67.0,-69.0,-68.0,-64.0,-70.0,-69.0,-77.0,-82.0,-75.0,-80.0,10.0,18.0,8.0,11.0,1
1516,CC:2F:71:3E:C5:1F,5529426,4451632015,3406898,4182258456,2122528,269373559,502,93188,7998748,78595,6269134,14593,1729614,21537,531,3414291,870687,502,2926,6500.0,1000.0,-69.0,-72.0,-66.0,-61.0,-70.0,-72.0,-67.0,-61.0,-77.0,-82.0,-75.0,-80.0,8.0,10.0,9.0,19.0,1
1517,F8:59:71:5A:E0:3D,3430965,2230329167,1308435,1960955406,2122530,269373761,294,739747,902453053,739061,902370460,686,82593,728696,1840,1308560,158488,294,1094,144444.0,43333.0,-68.0,-73.0,-65.0,-72.0,-68.0,-73.0,-65.0,-72.0,-77.0,-82.0,-75.0,-80.0,9.0,9.0,10.0,8.0,1
1518,CC:2F:71:3F:1F:24,3986584,2731127330,1864052,2461753367,2122532,269373963,2584,1522194,1950166802,1521086,1950041436,1108,125366,1504836,6091,1863866,197579,2584,1801,86667.0,14444.0,-69.0,-64.0,-73.0,-70.0,-67.0,-63.0,-69.0,-69.0,-77.0,-82.0,-75.0,-80.0,8.0,18.0,2.0,10.0,1
1519,CC:2F:71:3E:C5:1F,5529433,4451632755,3406898,4182258456,2122535,269374299,502,93188,7998748,78595,6269134,14593,1729614,21537,531,3414291,870687,502,2926,6500.0,1000.0,-69.0,-72.0,-66.0,-61.0,-70.0,-72.0,-67.0,-61.0,-77.0,-82.0,-75.0,-80.0,8.0,10.0,9.0,19.0,1
1520,F8:59:71:5A:E0:3D,3431039,2230433569,1308502,1961059076,2122537,269374493,294,739814,902556261,739128,902473668,686,82593,728763,1840,1308627,158513,294,1094,144444.0,43333.0,-66.0,-71.0,-63.0,-70.0,-67.0,-71.0,-64.0,-70.0,-78.0,-83.0,-76.0,-81.0,12.0,12.0,13.0,11.0,1
1521,CC:2F:71:3F:1F:24,3986759,2731349007,1864222,2461974514,2122537,269374493,2584,1522350,1950378347,1521242,1950252981,1108,125366,1504992,6091,1864036,197634,2584,1801,86667.0,14444.0,-67.0,-64.0,-67.0,-68.0,-66.0,-64.0,-67.0,-68.0,-78.0,-83.0,-76.0,-81.0,11.0,19.0,9.0,13.0,1
1522,CC:2F:71:3E:C5:1F,5529435,4451632949,3406898,4182258456,2122537,269374493,502,93188,7998748,78595,6269134,14593,1729614,21537,531,3414291,870687,502,2926,6500.0,1000.0,-69.0,-72.0,-66.0,-61.0,-70.0,-72.0,-67.0,-61.0,-78.0,-83.0,-76.0,-81.0,9.0,11.0,10.0,20.0,1
1523,F8:59:71:5A:E0:3D,3431109,2230537557,1308569,1961162802,2122540,269374755,294,739880,902657971,739194,902575378,686,82593,728829,1840,1308693,158548,294,1094,144444.0,1000.0,-66.0,-71.0,-63.0,-69.0,-66.0,-71.0,-63.0,-69.0,-78.0,-83.0,-76.0,-81.0,12.0,12.0,13.0,12.0,1
1524,CC:2F:71:3F:1F:24,3986927,2731565455,1864387,2462190700,2122540,269374755,2584,1522503,1950588067,1521395,1950462701,1108,125366,1505145,6091,1864201,197715,2584,1801,86667.0,13000.0,-69.0,-64.0,-73.0,-70.0,-68.0,-64.0,-72.0,-69.0,-78.0,-83.0,-76.0,-81.0,9.0,19.0,3.0,11.0,1
1525,CC:2F:71:3E:C5:1F,5529440,4451633413,3406898,4182258456,2122542,269374957,502,93188,7998748,78595,6269134,14593,1729614,21537,531,3414291,870687,502,2926,6500.0,1000.0,-69.0,-72.0,-66.0,-61.0,-70.0,-72.0,-67.0,-61.0,-78.0,-83.0,-76.0,-81.0,9.0,11.0,10.0,20.0,1
1526,F8:59:71:5A:E0:3D,3431225,2230703727,1308679,1961328366,2122546,269375361,294,739963,902773651,739277,902691058,686,82593,728912,1840,1308804,158591,294,1094,144444.0,1000.0,-68.0,-73.0,-65.0,-72.0,-67.0,-71.0,-64.0,-70.0,-78.0,-83.0,-76.0,-81.0,10.0,10.0,11.0,9.0,1
1527,CC:2F:71:3F:1F:24,3987111,2731797967,1864564,2462422333,2122547,269375634,2584,1522667,1950814976,1521559,1950689610,1108,125366,1505309,6091,1864379,197793,2584,1802,86667.0,14444.0,-70.0,-64.0,-72.0,-69.0,-68.0,-63.0,-68.0,-68.0,-78.0,-83.0,-76.0,-81.0,8.0,19.0,4.0,12.0,1
1528,CC:2F:71:3E:C5:1F,5529445,4451634090,3406898,4182258456,2122547,269375634,502,93188,7998748,78595,6269134,14593,1729614,21537,531,3414291,870687,502,2926,6500.0,1000.0,-69.0,-72.0,-66.0,-61.0,-70.0,-72.0,-67.0,-61.0,-78.0,-83.0,-76.0,-81.0,9.0,11.0,10.0,20.0,1
1529,F8:59:71:5A:E0:3D,3431303,2230810517,1308753,1961434621,2122550,269375896,294,740032,902875721,739346,902793128,686,82593,728981,1840,1308878,158622,294,1094,144444.0,43333.0,-66.0,-71.0,-64.0,-70.0,-67.0,-72.0,-64.0,-71.0,-78.0,-83.0,-76.0,-81.0,12.0,12.0,12.0,11.0,1
1530,CC:2F:71:3F:1F:24,3987287,2732025925,1864735,2462649827,2122552,269376098,2584,1522817,1951023232,1521709,1950897866,1108,125366,1505459,6091,1864550,197859,2584,1803,86667.0,14444.0,-65.0,-63.0,-66.0,-68.0,-68.0,-63.0,-69.0,-69.0,-78.0,-83.0,-76.0,-81.0,13.0,20.0,10.0,13.0,1
1531,CC:2F:71:3E:C5:1F,5529452,4451634756,3406898,4182258456,2122554,269376300,502,93188,7998748,78595,6269134,14593,1729614,21537,531,3414291,870687,502,2926,6500.0,1000.0,-69.0,-72.0,-66.0,-61.0,-70.0,-72.0,-67.0,-61.0,-78.0,-83.0,-76.0,-81.0,9.0,11.0,10.0,20.0,1
1532,F8:59:71:5A:E0:3D,3431384,2230921640,1308827,1961545076,2122557,269376564,294,740109,902990723,739423,902908130,686,82593,729058,1840,1308952,158653,294,1094,144444.0,43333.0,-68.0,-72.0,-65.0,-71.0,-67.0,-71.0,-64.0,-70.0,-78.0,-83.0,-76.0,-81.0,10.0,11.0,11.0,10.0,1
1533,CC:2F:71:3F:1F:24,3987456,2732240855,1864899,2462864291,2122557,269376564,2584,1522976,1951239659,1521867,1951114175,1109,125484,1505617,6091,1864712,197924,2584,1804,65000.0,13000.0,-70.0,-64.0,-72.0,-70.0,-67.0,-64.0,-68.0,-69.0,-78.0,-83.0,-76.0,-81.0,8.0,19.0,4.0,11.0,1
1534,CC:2F:71:3E:C5:1F,5529455,4451635020,3406898,4182258456,2122557,269376564,502,93188,7998748,78595,6269134,14593,1729614,21537,531,3414291,870687,502,2926,6500.0,1000.0,-69.0,-72.0,-66.0,-61.0,-70.0,-72.0,-67.0,-61.0,-78.0,-83.0,-76.0,-81.0,9.0,11.0,10.0,20.0,1
1535,F8:59:71:5A:E0:3D,3431679,2231332560,1309120,1961955794,2122559,269376766,294,740222,903103910,739536,903021317,686,82593,729171,1840,1309245,158812,294,1094,144444.0,39000.0,-68.0,-72.0,-65.0,-71.0,-66.0,-71.0,-64.0,-70.0,-78.0,-83.0,-76.0,-81.0,10.0,11.0,11.0,10.0,1
1536,CC:2F:71:3F:1F:24,3987654,2732478443,1865093,2463101475,2122561,269376968,2584,1523153,1951470875,1522044,1951345391,1109,125484,1505793,6091,1864908,197990,2584,1804,86667.0,14444.0,-67.0,-64.0,-65.0,-68.0,-67.0,-64.0,-67.0,-68.0,-78.0,-83.0,-76.0,-81.0,11.0,19.0,11.0,13.0,1
1537,CC:2F:71:3E:C5:1F,5529459,4451635424,3406898,4182258456,2122561,269376968,502,93188,7998748,78595,6269134,14593,1729614,21537,531,3414291,870687,502,2926,6500.0,1000.0,-69.0,-72.0,-66.0,-61.0,-70.0,-72.0,-67.0,-61.0,-78.0,-83.0,-76.0,-81.0,9.0,11.0,10.0,20.0,1
1538,F8:59:71:5A:E0:3D,3431755,2231440284,1309189,1962062852,2122566,269377432,294,740289,903207118,739603,903124525,686,82593,729238,1840,1309314,158842,294,1095,144444.0,43333.0,-67.0,-71.0,-64.0,-71.0,-67.0,-72.0,-64.0,-71.0,-78.0,-83.0,-76.0,-81.0,11.0,12.0,12.0,10.0,1
1539,CC:2F:71:3F:1F:24,3987820,2732689285,1865254,2463311853,2122566,269377432,2584,1523302,1951671503,1522193,1951546019,1109,125484,1505942,6091,1865069,198034,2584,1804,104000.0,26000.0,-69.0,-64.0,-70.0,-69.0,-67.0,-64.0,-69.0,-68.0,-78.0,-83.0,-76.0,-81.0,9.0,19.0,6.0,12.0,1
1540,CC:2F:71:3E:C5:1F,5529464,4451635888,3406898,4182258456,2122566,269377432,502,93188,7998748,78595,6269134,14593,1729614,21537,532,3414292,870688,502,2926,6500.0,1000.0,-69.0,-72.0,-66.0,-61.0,-70.0,-72.0,-67.0,-61.0,-78.0,-83.0,-76.0,-81.0,9.0,11.0,10.0,20.0,1
1541,F8:59:71:5A:E0:3D,3431821,2231539382,1309253,1962161748,2122568,269377634,294,740354,903307260,739668,903224667,686,82593,729303,1840,1309377,158876,294,1095,144444.0,43333.0,-66.0,-72.0,-63.0,-69.0,-66.0,-71.0,-63.0,-69.0,-78.0,-83.0,-76.0,-81.0,12.0,11.0,13.0,12.0,1
1542,CC:2F:71:3F:1F:24,3987982,2732898183,1865414,2463520549,2122568,269377634,2584,1523449,1951871899,1522340,1951746415,1109,125484,1506089,6091,1865229,198077,2584,1804,86667.0,14444.0,-69.0,-64.0,-72.0,-70.0,-68.0,-64.0,-71.0,-69.0,-78.0,-83.0,-76.0,-81.0,9.0,19.0,4.0,11.0,1
1543,CC:2F:71:3E:C5:1F,5529468,4451636292,3406898,4182258456,2122570,269377836,502,93188,7998748,78595,6269134,14593,1729614,21537,532,3414292,870688,502,2926,6500.0,1000.0,-69.0,-72.0,-66.0,-61.0,-70.0,-72.0,-67.0,-61.0,-78.0,-83.0,-76.0,-81.0,9.0,11.0,10.0,20.0,1
1544,F8:59:71:5A:E0:3D,3432087,2231934403,1309513,1962556163,2122574,269378240,294,740473,903417287,739787,903334694,686,82593,729422,1840,1309638,158968,294,1095,144444.0,43333.0,-68.0,-72.0,-65.0,-71.0,-66.0,-71.0,-63.0,-69.0,-79.0,-84.0,-77.0,-82.0,11.0,12.0,12.0,11.0,1
1545,CC:2F:71:3F:1F:24,3988151,2733112371,1865577,2463734131,2122574,269378240,2584,1523597,1952078135,1522488,1951952651,1109,125484,1506237,6091,1865392,198109,2584,1804,86667.0,14444.0,-69.0,-64.0,-72.0,-70.0,-68.0,-64.0,-69.0,-69.0,-79.0,-84.0,-77.0,-82.0,10.0,20.0,5.0,12.0,1
1546,CC:2F:71:3E:C5:1F,5529472,4451636696,3406898,4182258456,2122574,269378240,502,93188,7998748,78595,6269134,14593,1729614,21537,532,3414292,870688,502,2926,6500.0,1000.0,-69.0,-72.0,-66.0,-61.0,-70.0,-72.0,-67.0,-61.0,-79.0,-84.0,-77.0,-82.0,10.0,12.0,11.0,21.0,1
1547,F8:59:71:5A:E0:3D,3432423,2232414769,1309844,1963036065,2122579,269378704,294,740617,903572431,739931,903489838,686,82593,729566,1840,1309969,159160,294,1095,144444.0,43333.0,-66.0,-72.0,-63.0,-70.0,-65.0,-71.0,-63.0,-69.0,-79.0,-84.0,-77.0,-82.0,13.0,12.0,14.0,12.0,1
1548,CC:2F:71:3F:1F:24,3988403,2733439811,1865822,2464060905,2122581,269378906,2584,1523829,1952401548,1522720,1952276064,1109,125484,1506467,6091,1865636,198326,2584,1804,78000.0,13000.0,-67.0,-64.0,-66.0,-69.0,-68.0,-63.0,-67.0,-69.0,-79.0,-84.0,-77.0,-82.0,12.0,20.0,11.0,13.0,1
1549,CC:2F:71:3E:C5:1F,5529479,4451637362,3406898,4182258456,2122581,269378906,502,93188,7998748,78595,6269134,14593,1729614,21537,532,3414292,870688,502,2926,6500.0,1000.0,-69.0,-72.0,-66.0,-61.0,-70.0,-72.0,-67.0,-61.0,-79.0,-84.0,-77.0,-82.0,10.0,12.0,11.0,21.0,1
1550,F8:59:71:5A:E0:3D,3432505,2232536049,1309922,1963156941,2122583,269379108,294,740695,903692705,740009,903610112,686,82593,729644,1840,1310047,159203,294,1095,144444.0,43333.0,-68.0,-73.0,-65.0,-71.0,-67.0,-72.0,-64.0,-71.0,-79.0,-84.0,-77.0,-82.0,11.0,11.0,12.0,11.0,1
1551,CC:2F:71:3F:1F:24,3988578,2733661944,1865995,2464282836,2122583,269379108,2584,1523982,1952608473,1522873,1952482989,1109,125484,1506620,6091,1865811,198379,2584,1804,86667.0,14444.0,-69.0,-64.0,-71.0,-70.0,-67.0,-64.0,-67.0,-69.0,-79.0,-84.0,-77.0,-82.0,10.0,20.0,6.0,12.0,1
1552,CC:2F:71:3E:C5:1F,5529481,4451637564,3406898,4182258456,2122583,269379108,502,93188,7998748,78595,6269134,14593,1729614,21537,532,3414292,870688,502,2926,6500.0,1000.0,-69.0,-72.0,-66.0,-61.0,-70.0,-72.0,-67.0,-61.0,-79.0,-84.0,-77.0,-82.0,10.0,12.0,11.0,21.0,1
1553,F8:59:71:5A:E0:3D,3432578,2232637197,1309990,1963257625,2122588,269379572,294,740765,903796698,740079,903714105,686,82593,729714,1840,1310116,159284,294,1095,144444.0,43333.0,-66.0,-72.0,-64.0,-70.0,-66.0,-72.0,-63.0,-69.0,-79.0,-84.0,-77.0,-82.0,13.0,12.0,13.0,12.0,1
1554,CC:2F:71:3F:1F:24,3988751,2733880406,1866161,2464500632,2122590,269379774,2584,1524135,1952819673,1523026,1952694189,1109,125484,1506773,6091,1865975,198450,2584,1805,104000.0,1000.0,-70.0,-64.0,-71.0,-70.0,-67.0,-63.0,-67.0,-69.0,-79.0,-84.0,-77.0,-82.0,9.0,20.0,6.0,12.0,1
1555,CC:2F:71:3E:C5:1F,5529488,4451638230,3406898,4182258456,2122590,269379774,502,93188,7998748,78595,6269134,14593,1729614,21537,532,3414292,870688,502,2926,6500.0,1000.0,-69.0,-72.0,-66.0,-61.0,-70.0,-72.0,-67.0,-61.0,-79.0,-84.0,-77.0,-82.0,10.0,12.0,11.0,21.0,1
1556,F8:59:71:5A:E0:3D,3432653,2232747263,1310061,1963367287,2122592,269379976,294,740835,903904568,740149,903821975,686,82593,729784,1840,1310187,159350,294,1095,144444.0,43333.0,-67.0,-72.0,-63.0,-69.0,-66.0,-72.0,-63.0,-69.0,-79.0,-84.0,-77.0,-82.0,12.0,12.0,14.0,13.0,1
1557,CC:2F:71:3F:1F:24,3988919,2734098012,1866327,2464718036,2122592,269379976,2584,1524287,1953029529,1523178,1952904045,1109,125484,1506925,6091,1866143,198617,2584,1807,78000.0,13000.0,-67.0,-63.0,-65.0,-69.0,-67.0,-63.0,-66.0,-69.0,-79.0,-84.0,-77.0,-82.0,12.0,21.0,12.0,13.0,1
1558,CC:2F:71:3E:C5:1F,5529490,4451638432,3406898,4182258456,2122592,269379976,502,93188,7998748,78595,6269134,14593,1729614,21537,532,3414292,870688,502,2926,6500.0,1000.0,-69.0,-72.0,-66.0,-61.0,-70.0,-72.0,-67.0,-61.0,-79.0,-84.0,-77.0,-82.0,10.0,12.0,11.0,21.0,1
1559,F8:59:71:5A:E0:3D,3432776,2232925175,1310175,1963544331,2122601,269380844,294,740949,904080450,740263,903997857,686,82593,729897,1840,1310295,159388,294,1095,144444.0,43333.0,-67.0,-73.0,-63.0,-69.0,-67.0,-72.0,-64.0,-70.0,-79.0,-84.0,-77.0,-82.0,12.0,11.0,14.0,13.0,1
1560,CC:2F:71:3F:1F:24,3990455,2736307825,1867854,2466926981,2122601,269380844,2590,1524824,1953579559,1523715,1953454075,1109,125484,1507449,6091,1867603,199887,2590,1807,78000.0,13000.0,-67.0,-64.0,-65.0,-69.0,-68.0,-63.0,-67.0,-69.0,-79.0,-84.0,-77.0,-82.0,12.0,20.0,12.0,13.0,1
1561,CC:2F:71:3E:C5:1F,5529506,4451640179,3406898,4182258456,2122608,269381723,502,93188,7998748,78595,6269134,14593,1729614,21537,532,3414292,870688,502,2926,6500.0,1000.0,-69.0,-72.0,-66.0,-61.0,-70.0,-72.0,-67.0,-61.0,-78.0,-84.0,-76.0,-81.0,9.0,12.0,10.0,20.0,1
1562,F8:59:71:5A:E0:3D,3433247,2233596420,1310636,1964214435,2122611,269381985,294,741210,904355146,740524,904272553,686,82593,730157,1840,1310762,159587,294,1095,144444.0,43333.0,-68.0,-73.0,-65.0,-71.0,-68.0,-72.0,-65.0,-71.0,-78.0,-84.0,-76.0,-81.0,10.0,11.0,11.0,10.0,1
1563,CC:2F:71:3F:1F:24,3991461,2737746857,1868850,2468364872,2122611,269381985,2590,1525159,1953911053,1524050,1953785569,1109,125484,1507784,6091,1868670,200423,2590,1810,86667.0,14444.0,-68.0,-64.0,-66.0,-69.0,-68.0,-63.0,-68.0,-69.0,-78.0,-84.0,-76.0,-81.0,10.0,20.0,10.0,12.0,1
1564,CC:2F:71:3E:C5:1F,5529509,4451640441,3406898,4182258456,2122611,269381985,502,93188,7998748,78595,6269134,14593,1729614,21537,532,3414292,870688,502,2926,6500.0,1000.0,-69.0,-72.0,-66.0,-61.0,-70.0,-72.0,-67.0,-61.0,-78.0,-84.0,-76.0,-81.0,9.0,12.0,10.0,20.0,1
1565,F8:59:71:5A:E0:3D,3433338,2233715672,1310710,1964327657,2122628,269388015,294,741276,904453846,740590,904371253,686,82593,730221,1840,1310836,159627,294,1095,144444.0,1000.0,-66.0,-72.0,-63.0,-69.0,-66.0,-71.0,-63.0,-69.0,-78.0,-84.0,-76.0,-81.0,12.0,12.0,13.0,12.0,1
1566,CC:2F:71:3F:1F:24,3991669,2737990544,1869041,2468602529,2122628,269388015,2590,1525333,1954142711,1524224,1954017227,1109,125484,1507958,6091,1868860,200509,2590,1811,86667.0,1000.0,-66.0,-63.0,-67.0,-69.0,-67.0,-63.0,-67.0,-69.0,-78.0,-84.0,-76.0,-81.0,12.0,21.0,9.0,12.0,1
1567,CC:2F:71:3E:C5:1F,5529527,4451646587,3406899,4182258572,2122628,269388015,502,93188,7998748,78595,6269134,14593,1729614,21537,532,3414293,870688,502,2926,6500.0,1000.0,-69.0,-72.0,-66.0,-61.0,-70.0,-72.0,-67.0,-61.0,-78.0,-84.0,-76.0,-81.0,9.0,12.0,10.0,20.0,1
1568,F8:59:71:5A:E0:3D,3433424,2233827197,1310783,1964433556,2122641,269393641,294,741355,904572340,740669,904489747,686,82593,730300,1840,1310909,159656,294,1095,144444.0,43333.0,-66.0,-71.0,-63.0,-70.0,-66.0,-72.0,-64.0,-70.0,-79.0,-85.0,-78.0,-82.0,13.0,14.0,15.0,12.0,1
1569,CC:2F:71:3F:1F:24,3991880,2738245602,1869239,2468851961,2122641,269393641,2590,1525510,1954360489,1524401,1954235005,1109,125484,1508135,6091,1869059,200586,2590,1811,86667.0,14444.0,-70.0,-64.0,-71.0,-71.0,-68.0,-64.0,-69.0,-69.0,-79.0,-85.0,-78.0,-82.0,9.0,21.0,7.0,11.0,1
1570,CC:2F:71:3E:C5:1F,5529540,4451652213,3406899,4182258572,2122641,269393641,502,93188,7998748,78595,6269134,14593,1729614,21537,532,3414293,870688,502,2926,6500.0,1000.0,-69.0,-72.0,-66.0,-61.0,-70.0,-72.0,-67.0,-61.0,-79.0,-85.0,-78.0,-82.0,10.0,13.0,12.0,21.0,1
1571,F8:59:71:5A:E0:3D,3433494,2233928335,1310848,1964534230,2122646,269394105,294,741422,904672790,740736,904590197,686,82593,730365,1840,1310974,159689,294,1095,144444.0,43333.0,-69.0,-73.0,-66.0,-72.0,-67.0,-72.0,-64.0,-70.0,-79.0,-85.0,-78.0,-82.0,10.0,12.0,12.0,10.0,1
1572,CC:2F:71:3F:1F:24,3992050,2738457180,1869402,2469062873,2122648,269394307,2590,1525660,1954565607,1524551,1954440123,1109,125484,1508284,6091,1869223,200750,2590,1811,78000.0,13000.0,-69.0,-64.0,-71.0,-70.0,-68.0,-63.0,-69.0,-69.0,-79.0,-85.0,-78.0,-82.0,10.0,21.0,7.0,12.0,1
1573,CC:2F:71:3E:C5:1F,5529547,4451652879,3406899,4182258572,2122648,269394307,502,93188,7998748,78595,6269134,14593,1729614,21537,532,3414293,870688,502,2926,6500.0,1000.0,-69.0,-72.0,-66.0,-61.0,-70.0,-72.0,-67.0,-61.0,-79.0,-85.0,-78.0,-82.0,10.0,13.0,12.0,21.0,1
1574,F8:59:71:5A:E0:3D,3433563,2234029301,1310913,1964634792,2122650,269394509,294,741486,904768480,740800,904685887,686,82593,730427,1840,1311039,159738,294,1095,144444.0,43333.0,-69.0,-73.0,-66.0,-72.0,-67.0,-72.0,-64.0,-70.0,-79.0,-85.0,-78.0,-82.0,10.0,12.0,12.0,10.0,1
1575,CC:2F:71:3F:1F:24,3992211,2738666372,1869561,2469271863,2122650,269394509,2590,1525809,1954771931,1524700,1954646447,1109,125484,1508433,6091,1869381,200849,2590,1811,78000.0,1000.0,-70.0,-64.0,-71.0,-70.0,-67.0,-63.0,-66.0,-68.0,-79.0,-85.0,-78.0,-82.0,9.0,21.0,7.0,12.0,1
1576,CC:2F:71:3E:C5:1F,5529549,4451653081,3406899,4182258572,2122650,269394509,502,93188,7998748,78595,6269134,14593,1729614,21537,532,3414293,870688,502,2926,6500.0,1000.0,-69.0,-72.0,-66.0,-61.0,-70.0,-72.0,-67.0,-61.0,-79.0,-85.0,-78.0,-82.0,10.0,13.0,12.0,21.0,1
1577,F8:59:71:5A:E0:3D,3433640,2234140046,1310985,1964745071,2122655,269394975,294,741551,904861899,740864,904779188,687,82711,730490,1840,1311111,159811,294,1097,144444.0,43333.0,-66.0,-72.0,-63.0,-69.0,-67.0,-71.0,-64.0,-70.0,-79.0,-85.0,-78.0,-82.0,13.0,13.0,15.0,13.0,1
1578,CC:2F:71:3F:1F:24,3992375,2738869138,1869718,2469473961,2122657,269395177,2590,1525968,1954993963,1524859,1954868479,1109,125484,1508592,6091,1869541,201005,2590,1811,78000.0,13000.0,-70.0,-64.0,-72.0,-70.0,-69.0,-64.0,-69.0,-69.0,-79.0,-85.0,-78.0,-82.0,9.0,21.0,6.0,12.0,1
1579,CC:2F:71:3E:C5:1F,5529557,4451653809,3406899,4182258572,2122658,269395237,502,93188,7998748,78595,6269134,14593,1729614,21537,532,3414293,870688,502,2926,6500.0,1000.0,-69.0,-72.0,-66.0,-61.0,-70.0,-72.0,-67.0,-61.0,-79.0,-85.0,-78.0,-82.0,10.0,13.0,12.0,21.0,1
1580,F8:59:71:5A:E0:3D,3433858,2234467208,1311198,1965071769,2122660,269395439,294,741579,904904257,740892,904821546,687,82711,730518,1840,1311324,159898,294,1100,144444.0,43333.0,-67.0,-71.0,-64.0,-71.0,-65.0,-70.0,-62.0,-70.0,-78.0,-84.0,-77.0,-81.0,11.0,13.0,13.0,10.0,1
1581,CC:2F:71:3F:1F:24,3992514,2739041704,1869854,2469646265,2122660,269395439,2590,1526140,1955231825,1525031,1955106341,1109,125484,1508764,6091,1869680,201179,2590,1811,104000.0,1000.0,-67.0,-64.0,-66.0,-69.0,-67.0,-63.0,-66.0,-68.0,-78.0,-84.0,-77.0,-81.0,11.0,20.0,11.0,12.0,1
1582,CC:2F:71:3E:C5:1F,5529559,4451654011,3406899,4182258572,2122660,269395439,502,93188,7998748,78595,6269134,14593,1729614,21537,532,3414293,870688,502,2926,6500.0,1000.0,-69.0,-72.0,-66.0,-61.0,-70.0,-72.0,-67.0,-61.0,-78.0,-84.0,-77.0,-81.0,9.0,12.0,11.0,20.0,1
1583,F8:59:71:5A:E0:3D,3433968,2234628534,1311302,1965232489,2122666,269396045,294,741618,904924445,740931,904841734,687,82711,730557,1840,1311428,159953,294,1100,144444.0,43333.0,-67.0,-71.0,-63.0,-72.0,-67.0,-72.0,-64.0,-71.0,-78.0,-84.0,-77.0,-81.0,11.0,13.0,14.0,9.0,1
1584,CC:2F:71:3F:1F:24,3992672,2739219462,1870005,2469823355,2122667,269396107,2590,1526361,1955538719,1525251,1955413117,1110,125602,1508984,6091,1869831,201335,2590,1811,57778.0,1000.0,-66.0,-64.0,-66.0,-68.0,-68.0,-63.0,-68.0,-69.0,-78.0,-84.0,-77.0,-81.0,12.0,20.0,11.0,13.0,1
1585,CC:2F:71:3E:C5:1F,5529568,4451654881,3406899,4182258572,2122669,269396309,502,93188,7998748,78595,6269134,14593,1729614,21537,532,3414293,870688,502,2926,6500.0,1000.0,-69.0,-72.0,-66.0,-61.0,-70.0,-72.0,-67.0,-61.0,-78.0,-84.0,-77.0,-81.0,9.0,12.0,11.0,20.0,1
1586,F8:59:71:5A:E0:3D,3434186,2234957563,1311516,1965561194,2122670,269396369,294,741689,905017670,741002,904934959,687,82711,730627,1840,1311641,160273,294,1102,144444.0,43333.0,-68.0,-73.0,-65.0,-71.0,-68.0,-73.0,-65.0,-71.0,-78.0,-84.0,-77.0,-81.0,10.0,11.0,12.0,10.0,1
1587,CC:2F:71:3F:1F:24,3992835,2739427860,1870165,2470031491,2122670,269396369,2590,1526530,1955773237,1525420,1955647635,1110,125602,1509153,6091,1869992,201462,2590,1811,78000.0,13000.0,-70.0,-64.0,-71.0,-70.0,-67.0,-63.0,-66.0,-68.0,-78.0,-84.0,-77.0,-81.0,8.0,20.0,6.0,11.0,1
1588,CC:2F:71:3E:C5:1F,5529573,4451655345,3406899,4182258572,2122674,269396773,502,93188,7998748,78595,6269134,14593,1729614,21537,532,3414293,870688,502,2926,6500.0,1000.0,-69.0,-72.0,-66.0,-61.0,-70.0,-72.0,-67.0,-61.0,-78.0,-84.0,-77.0,-81.0,9.0,12.0,11.0,20.0,1
1589,F8:59:71:5A:E0:3D,3434620,2235569817,1311942,1966172640,2122678,269397177,294,741815,905177400,741128,905094689,687,82711,730731,1840,1312068,160566,294,1104,144444.0,39000.0,-66.0,-71.0,-64.0,-69.0,-66.0,-71.0,-64.0,-69.0,-78.0,-84.0,-77.0,-81.0,12.0,13.0,13.0,12.0,1
1590,CC:2F:71:3F:1F:24,3993071,2739737816,1870393,2470340639,2122678,269397177,2590,1526759,1956096327,1525649,1955970725,1110,125602,1509382,6092,1870221,201686,2590,1812,78000.0,13000.0,-67.0,-63.0,-66.0,-69.0,-67.0,-63.0,-67.0,-68.0,-78.0,-84.0,-77.0,-81.0,11.0,21.0,11.0,12.0,1
1591,CC:2F:71:3E:C5:1F,5529578,4451655809,3406899,4182258572,2122679,269397237,502,93188,7998748,78595,6269134,14593,1729614,21537,532,3414293,870688,502,2926,6500.0,1000.0,-69.0,-72.0,-66.0,-61.0,-70.0,-72.0,-67.0,-61.0,-78.0,-84.0,-77.0,-81.0,9.0,12.0,11.0,20.0,1
1592,F8:59:71:5A:E0:3D,3434768,2235783115,1312083,1966385272,2122685,269397843,294,742146,905600874,741459,905518163,687,82711,731053,1840,1312209,160616,294,1104,144444.0,43333.0,-69.0,-73.0,-66.0,-71.0,-66.0,-72.0,-64.0,-69.0,-78.0,-84.0,-77.0,-81.0,9.0,11.0,11.0,10.0,1
1593,CC:2F:71:3F:1F:24,3993445,2740265284,1870759,2470867379,2122686,269397905,2590,1526951,1956363453,1525841,1956237851,1110,125602,1509574,6092,1870589,202035,2590,1812,86667.0,13000.0,-67.0,-64.0,-66.0,-68.0,-68.0,-64.0,-68.0,-69.0,-78.0,-84.0,-77.0,-81.0,11.0,20.0,11.0,13.0,1
1594,CC:2F:71:3E:C5:1F,5529585,4451656477,3406899,4182258572,2122686,269397905,502,93189,7998866,78595,6269134,14594,1729732,21538,532,3414293,870688,502,2926,6500.0,1000.0,-74.0,-74.0,-70.0,-61.0,-71.0,-72.0,-67.0,-61.0,-78.0,-84.0,-77.0,-81.0,4.0,10.0,7.0,20.0,1
1595,F8:59:71:5A:E0:3D,3434835,2235881106,1312146,1966482726,2122689,269398380,294,742209,905697894,741522,905615183,687,82711,731116,1840,1312272,160662,294,1104,144444.0,1000.0,-68.0,-73.0,-65.0,-71.0,-66.0,-72.0,-63.0,-70.0,-78.0,-84.0,-77.0,-81.0,10.0,11.0,12.0,10.0,1
1596,CC:2F:71:3F:1F:24,3993621,2740495185,1870932,2471096805,2122689,269398380,2590,1527113,1956588457,1526003,1956462855,1110,125602,1509735,6092,1870763,202166,2590,1812,86667.0,13000.0,-67.0,-64.0,-66.0,-70.0,-67.0,-63.0,-66.0,-68.0,-77.0,-84.0,-75.0,-80.0,10.0,20.0,9.0,10.0,1
1597,CC:2F:71:3E:C5:1F,5529588,4451656952,3406899,4182258572,2122689,269398380,502,93189,7998866,78595,6269134,14594,1729732,21538,532,3414293,870688,502,2926,6500.0,1000.0,-74.0,-74.0,-70.0,-61.0,-71.0,-72.0,-67.0,-61.0,-77.0,-84.0,-75.0,-80.0,3.0,10.0,5.0,19.0,1
1598,F8:59:71:5A:E0:3D,3434964,2236062576,1312268,1966663530,2122696,269399046,294,742289,905809526,741602,905726815,687,82711,731196,1840,1312394,160720,294,1104,144444.0,43333.0,-66.0,-72.0,-63.0,-70.0,-67.0,-72.0,-64.0,-70.0,-77.0,-84.0,-75.0,-80.0,11.0,12.0,12.0,10.0,1
1599,CC:2F:71:3F:1F:24,3993802,2740723518,1871106,2471324472,2122696,269399046,2590,1527290,1956836698,1526180,1956711096,1110,125602,1509912,6092,1870937,202392,2590,1812,72222.0,21667.0,-67.0,-64.0,-66.0,-69.0,-66.0,-63.0,-66.0,-68.0,-77.0,-84.0,-75.0,-80.0,10.0,20.0,9.0,11.0,1
1600,CC:2F:71:3E:C5:1F,5529597,4451657820,3406899,4182258572,2122698,269399248,502,93189,7998866,78595,6269134,14594,1729732,21538,532,3414293,870688,502,2926,6500.0,1000.0,-74.0,-74.0,-70.0,-61.0,-71.0,-72.0,-67.0,-61.0,-77.0,-84.0,-75.0,-80.0,3.0,10.0,5.0,19.0,1
1601,F8:59:71:5A:E0:3D,3435221,2236457103,1312521,1967057487,2122700,269399616,294,742430,905959788,741743,905877077,687,82711,731333,1840,1312647,160823,294,1110,144444.0,43333.0,-66.0,-71.0,-63.0,-69.0,-67.0,-72.0,-64.0,-70.0,-77.0,-84.0,-75.0,-80.0,11.0,13.0,12.0,11.0,1
1602,CC:2F:71:3F:1F:24,3993996,2740977642,1871294,2471577824,2122702,269399818,2590,1527450,1957061470,1526340,1956935868,1110,125602,1510070,6092,1871126,202543,2590,1812,65000.0,21667.0,-70.0,-64.0,-71.0,-70.0,-67.0,-63.0,-67.0,-69.0,-77.0,-84.0,-75.0,-80.0,7.0,20.0,4.0,10.0,1
1603,CC:2F:71:3E:C5:1F,5529601,4451658390,3406899,4182258572,2122702,269399818,502,93189,7998866,78595,6269134,14594,1729732,21538,532,3414293,870688,502,2926,6500.0,1000.0,-74.0,-74.0,-70.0,-61.0,-71.0,-72.0,-67.0,-61.0,-77.0,-84.0,-75.0,-80.0,3.0,10.0,5.0,19.0,1
1604,F8:59:71:5A:E0:3D,3435292,2236558159,1312586,1967157937,2122706,269400222,294,742495,906059944,741808,905977233,687,82711,731398,1840,1312712,160853,294,1110,144444.0,43333.0,-65.0,-71.0,-63.0,-69.0,-66.0,-71.0,-63.0,-69.0,-77.0,-84.0,-75.0,-80.0,12.0,13.0,12.0,11.0,1
1605,CC:2F:71:3F:1F:24,3994160,2741187550,1871454,2471787328,2122706,269400222,2590,1527597,1957263332,1526487,1957137730,1110,125602,1510217,6092,1871285,202683,2590,1812,72222.0,21667.0,-68.0,-64.0,-67.0,-69.0,-66.0,-63.0,-66.0,-68.0,-77.0,-84.0,-75.0,-80.0,9.0,20.0,8.0,11.0,1
1606,CC:2F:71:3E:C5:1F,5529608,4451659056,3406899,4182258572,2122709,269400484,502,93189,7998866,78595,6269134,14594,1729732,21538,532,3414293,870688,502,2926,6500.0,1000.0,-74.0,-74.0,-70.0,-61.0,-71.0,-72.0,-67.0,-61.0,-77.0,-84.0,-75.0,-80.0,3.0,10.0,5.0,19.0,1
1607,F8:59:71:5A:E0:3D,3435361,2236660593,1312652,1967260109,2122709,269400484,294,742561,906161710,741874,906078999,687,82711,731464,1840,1312778,160894,294,1110,144444.0,43333.0,-65.0,-71.0,-63.0,-69.0,-66.0,-71.0,-63.0,-70.0,-77.0,-84.0,-75.0,-80.0,12.0,13.0,12.0,11.0,1
1608,CC:2F:71:3F:1F:24,3994326,2741400778,1871617,2472000294,2122709,269400484,2590,1527747,1957468512,1526637,1957342910,1110,125602,1510366,6092,1871449,202749,2590,1812,72222.0,21667.0,-66.0,-64.0,-65.0,-69.0,-67.0,-63.0,-66.0,-68.0,-77.0,-84.0,-75.0,-80.0,11.0,20.0,10.0,11.0,1
1609,CC:2F:71:3E:C5:1F,5529610,4451659258,3406899,4182258572,2122711,269400686,502,93189,7998866,78595,6269134,14594,1729732,21538,532,3414293,870688,502,2926,6500.0,1000.0,-74.0,-74.0,-70.0,-61.0,-71.0,-72.0,-67.0,-61.0,-77.0,-84.0,-75.0,-80.0,3.0,10.0,5.0,19.0,1
1610,F8:59:71:5A:E0:3D,3435432,2236761593,1312717,1967360503,2122715,269401090,294,742626,906261810,741939,906179099,687,82711,731529,1840,1312843,160931,294,1110,144444.0,43333.0,-65.0,-71.0,-64.0,-69.0,-66.0,-71.0,-64.0,-69.0,-77.0,-84.0,-75.0,-80.0,12.0,13.0,11.0,11.0,1
1611,CC:2F:71:3F:1F:24,3994497,2741618490,1871782,2472217400,2122715,269401090,2590,1527899,1957677982,1526789,1957552380,1110,125602,1510516,6092,1871613,202846,2590,1812,86667.0,13000.0,-67.0,-64.0,-67.0,-68.0,-67.0,-63.0,-68.0,-68.0,-77.0,-84.0,-75.0,-80.0,10.0,20.0,8.0,12.0,1
1612,CC:2F:71:3E:C5:1F,5529614,4451659662,3406899,4182258572,2122715,269401090,502,93189,7998866,78595,6269134,14594,1729732,21538,532,3414293,870688,502,2926,6500.0,1000.0,-74.0,-74.0,-70.0,-61.0,-71.0,-72.0,-67.0,-61.0,-77.0,-84.0,-75.0,-80.0,3.0,10.0,5.0,19.0,1
1613,F8:59:71:5A:E0:3D,3435865,2237382757,1313145,1967981203,2122720,269401554,294,742778,906405343,742091,906322632,687,82711,731681,1840,1313271,161110,294,1110,144444.0,43333.0,-69.0,-72.0,-65.0,-71.0,-67.0,-71.0,-64.0,-70.0,-77.0,-84.0,-75.0,-80.0,8.0,12.0,10.0,9.0,1
1614,CC:2F:71:3F:1F:24,3996185,2744042418,1873463,2474640662,2122722,269401756,2590,1528366,1958078994,1527256,1957953392,1110,125602,1510981,6092,1873294,203552,2590,1812,86667.0,14444.0,-67.0,-63.0,-66.0,-68.0,-68.0,-63.0,-69.0,-69.0,-77.0,-84.0,-75.0,-80.0,10.0,21.0,9.0,12.0,1
1615,CC:2F:71:3E:C5:1F,5529621,4451660328,3406899,4182258572,2122722,269401756,502,93189,7998866,78595,6269134,14594,1729732,21538,532,3414293,870688,502,2926,6500.0,1000.0,-74.0,-74.0,-70.0,-61.0,-71.0,-72.0,-67.0,-61.0,-77.0,-84.0,-75.0,-80.0,3.0,10.0,5.0,19.0,1
1616,F8:59:71:5A:E0:3D,3435958,2237516940,1313232,1968114780,2122726,269402160,294,742882,906563073,742195,906480362,687,82711,731780,1840,1313358,161143,294,1110,144444.0,43333.0,-68.0,-72.0,-65.0,-72.0,-67.0,-72.0,-64.0,-71.0,-77.0,-84.0,-75.0,-80.0,9.0,12.0,10.0,8.0,1
1617,CC:2F:71:3F:1F:24,3996349,2744251238,1873623,2474849078,2122726,269402160,2590,1528510,1958276222,1527400,1958150620,1110,125602,1511125,6092,1873455,203608,2590,1812,86667.0,14444.0,-66.0,-63.0,-66.0,-68.0,-67.0,-63.0,-69.0,-69.0,-77.0,-84.0,-75.0,-80.0,11.0,21.0,9.0,12.0,1
1618,CC:2F:71:3E:C5:1F,5529625,4451660732,3406899,4182258572,2122726,269402160,502,93189,7998866,78595,6269134,14594,1729732,21538,532,3414293,870688,502,2926,6500.0,1000.0,-74.0,-74.0,-70.0,-61.0,-71.0,-72.0,-67.0,-61.0,-77.0,-84.0,-75.0,-80.0,3.0,10.0,5.0,19.0,1
1619,F8:59:71:5A:E0:3D,3436027,2237616636,1313296,1968214012,2122731,269402624,294,742946,906661633,742259,906578922,687,82711,731844,1840,1313422,161167,294,1110,144444.0,43333.0,-66.0,-71.0,-63.0,-70.0,-66.0,-71.0,-64.0,-70.0,-77.0,-84.0,-75.0,-80.0,11.0,13.0,12.0,10.0,1
1620,CC:2F:71:3F:1F:24,3996516,2744462946,1873785,2475060322,2122731,269402624,2590,1528657,1958480890,1527547,1958355288,1110,125602,1511272,6092,1873617,203707,2590,1812,86667.0,13000.0,-66.0,-64.0,-66.0,-69.0,-66.0,-62.0,-67.0,-68.0,-77.0,-84.0,-75.0,-80.0,11.0,20.0,9.0,11.0,1
1621,CC:2F:71:3E:C5:1F,5529630,4451661196,3406899,4182258572,2122731,269402624,502,93189,7998866,78595,6269134,14594,1729732,21538,532,3414293,870688,502,2926,6500.0,1000.0,-74.0,-74.0,-70.0,-61.0,-71.0,-72.0,-67.0,-61.0,-77.0,-84.0,-75.0,-80.0,3.0,10.0,5.0,19.0,1
1622,F8:59:71:5A:E0:3D,3436250,2237955157,1313515,1968552129,2122735,269403028,294,743041,906776117,742354,906693406,687,82711,731939,1840,1313641,161254,294,1110,144444.0,43333.0,-65.0,-71.0,-64.0,-70.0,-66.0,-71.0,-63.0,-70.0,-78.0,-85.0,-77.0,-82.0,13.0,14.0,13.0,12.0,1
1623,CC:2F:71:3F:1F:24,3996694,2744688284,1873959,2475285256,2122735,269403028,2590,1528820,1958700381,1527710,1958574779,1110,125602,1511434,6092,1873790,203947,2590,1812,86667.0,1000.0,-66.0,-64.0,-65.0,-68.0,-68.0,-63.0,-69.0,-69.0,-78.0,-85.0,-77.0,-82.0,12.0,21.0,12.0,14.0,1
1624,CC:2F:71:3E:C5:1F,5529634,4451661600,3406899,4182258572,2122735,269403028,502,93189,7998866,78595,6269134,14594,1729732,21538,532,3414293,870688,502,2926,6500.0,1000.0,-74.0,-74.0,-70.0,-61.0,-71.0,-72.0,-67.0,-61.0,-78.0,-85.0,-77.0,-82.0,4.0,11.0,7.0,21.0,1
1625,F8:59:71:5A:E0:3D,3436323,2238062227,1313584,1968658795,2122739,269403432,294,743107,906877855,742420,906795144,687,82711,732005,1840,1313710,161299,294,1110,144444.0,43333.0,-68.0,-73.0,-65.0,-72.0,-67.0,-72.0,-64.0,-71.0,-78.0,-85.0,-77.0,-82.0,10.0,12.0,12.0,10.0,1
1626,CC:2F:71:3F:1F:24,3996891,2744920261,1874152,2475516829,2122739,269403432,2590,1529001,1958934212,1527891,1958808610,1110,125602,1511615,6093,1873981,204139,2590,1813,86667.0,1000.0,-69.0,-64.0,-72.0,-70.0,-67.0,-63.0,-68.0,-68.0,-78.0,-85.0,-77.0,-82.0,9.0,21.0,5.0,12.0,1
1627,CC:2F:71:3E:C5:1F,5529638,4451662004,3406899,4182258572,2122739,269403432,502,93189,7998866,78595,6269134,14594,1729732,21538,532,3414293,870688,502,2926,6500.0,1000.0,-74.0,-74.0,-70.0,-61.0,-71.0,-72.0,-67.0,-61.0,-78.0,-85.0,-77.0,-82.0,4.0,11.0,7.0,21.0,1
1628,F8:59:71:5A:E0:3D,3436401,2238175461,1313657,1968771565,2122744,269403896,294,743140,906928983,742453,906846272,687,82711,732037,1840,1313783,161347,294,1116,144444.0,43333.0,-65.0,-70.0,-62.0,-70.0,-67.0,-72.0,-64.0,-71.0,-78.0,-85.0,-77.0,-82.0,13.0,15.0,15.0,12.0,1
1629,CC:2F:71:3F:1F:24,3997034,2745094649,1874290,2475690753,2122744,269403896,2590,1529175,1959178100,1528065,1959052498,1110,125602,1511789,6093,1874130,204293,2590,1815,78000.0,13000.0,-66.0,-63.0,-66.0,-68.0,-68.0,-63.0,-70.0,-69.0,-78.0,-85.0,-77.0,-82.0,12.0,22.0,11.0,14.0,1
1630,CC:2F:71:3E:C5:1F,5529643,4451662468,3406899,4182258572,2122744,269403896,502,93189,7998866,78595,6269134,14594,1729732,21538,532,3414293,870688,502,2926,6500.0,1000.0,-74.0,-74.0,-70.0,-61.0,-71.0,-72.0,-67.0,-61.0,-78.0,-85.0,-77.0,-82.0,4.0,11.0,7.0,21.0,1
1631,F8:59:71:5A:E0:3D,3436497,2238315404,1313747,1968910697,2122750,269404707,294,743148,906941331,742461,906858620,687,82711,732044,1840,1313872,161411,294,1117,130000.0,39000.0,-66.0,-70.0,-61.0,-69.0,-65.0,-68.0,-62.0,-69.0,-78.0,-85.0,-77.0,-82.0,12.0,15.0,16.0,13.0,1
1632,CC:2F:71:3F:1F:24,3997174,2745260242,1874423,2475855467,2122751,269404775,2590,1529380,1959465540,1528270,1959339938,1110,125602,1511994,6093,1874265,204483,2590,1816,58500.0,19500.0,-69.0,-64.0,-73.0,-70.0,-67.0,-63.0,-69.0,-68.0,-77.0,-84.0,-75.0,-81.0,8.0,20.0,2.0,11.0,1
1633,CC:2F:71:3E:C5:1F,5529650,4451663347,3406899,4182258572,2122751,269404775,502,93189,7998866,78595,6269134,14594,1729732,21538,532,3414293,870688,502,2926,6500.0,1000.0,-74.0,-74.0,-70.0,-61.0,-71.0,-72.0,-67.0,-61.0,-77.0,-84.0,-75.0,-81.0,3.0,10.0,5.0,20.0,1
1634,F8:59:71:5A:E0:3D,3436591,2238452128,1313835,1969046889,2122756,269405239,294,743182,906993985,742495,906911274,687,82711,732066,1840,1313960,161474,294,1120,144444.0,43333.0,-66.0,-71.0,-63.0,-70.0,-67.0,-71.0,-64.0,-71.0,-77.0,-84.0,-75.0,-81.0,11.0,13.0,12.0,11.0,1
1635,CC:2F:71:3F:1F:24,3997365,2745505156,1874607,2476099715,2122758,269405441,2590,1529584,1959749834,1528474,1959624232,1110,125602,1512197,6093,1874450,204606,2590,1817,52000.0,13000.0,-69.0,-63.0,-71.0,-69.0,-68.0,-63.0,-70.0,-69.0,-77.0,-84.0,-75.0,-81.0,8.0,21.0,4.0,12.0,1
1636,CC:2F:71:3E:C5:1F,5529657,4451664013,3406899,4182258572,2122758,269405441,502,93189,7998866,78595,6269134,14594,1729732,21538,532,3414293,870688,502,2926,6500.0,1000.0,-74.0,-74.0,-70.0,-61.0,-71.0,-72.0,-67.0,-61.0,-77.0,-84.0,-75.0,-81.0,3.0,10.0,5.0,20.0,1
1637,F8:59:71:5A:E0:3D,3437128,2239198449,1314355,1969791612,2122773,269406837,294,743526,907391314,742838,907308485,688,82829,732368,1840,1314481,162078,294,1121,144444.0,43333.0,-68.0,-71.0,-65.0,-72.0,-67.0,-71.0,-64.0,-71.0,-77.0,-84.0,-75.0,-81.0,9.0,13.0,10.0,9.0,1
1638,CC:2F:71:3F:1F:24,3998312,2746834383,1875518,2477425546,2122794,269408837,2590,1530606,1961257478,1529495,1961131758,1111,125720,1513113,6099,1875359,205598,2590,1824,5500.0,1000.0,-66.0,-63.0,-66.0,-67.0,-66.0,-63.0,-65.0,-68.0,-77.0,-83.0,-75.0,-80.0,11.0,20.0,9.0,13.0,1
1639,CC:2F:71:3E:C5:1F,5529698,4451667929,3406900,4182258688,2122798,269409241,502,93190,7998984,78595,6269134,14595,1729850,21539,532,3414294,870688,502,2926,6500.0,1000.0,-68.0,-71.0,-65.0,-61.0,-70.0,-72.0,-67.0,-61.0,-77.0,-83.0,-75.0,-80.0,9.0,12.0,10.0,19.0,1
1640,F8:59:71:5A:E0:3D,3439447,2242550601,1316580,1973134465,2122867,269416136,294,744696,908907320,744008,908824491,688,82829,733370,1840,1316708,163977,294,1131,144444.0,43333.0,-68.0,-73.0,-65.0,-72.0,-66.0,-71.0,-63.0,-70.0,-75.0,-82.0,-73.0,-79.0,7.0,9.0,8.0,7.0,1
1641,CC:2F:71:3F:1F:24,4003243,2753871380,1880355,2484452865,2122888,269418515,2596,1534216,1965915699,1533104,1965789861,1112,125838,1516619,6254,1880173,206844,2596,1831,78000.0,13000.0,-68.0,-64.0,-68.0,-69.0,-68.0,-64.0,-68.0,-69.0,-75.0,-82.0,-73.0,-79.0,7.0,18.0,5.0,10.0,1
1642,CC:2F:71:3E:C5:1F,5529790,4451677379,3406901,4182258804,2122889,269418575,502,93190,7998984,78595,6269134,14595,1729850,21539,532,3414296,870690,502,2926,6500.0,1000.0,-68.0,-71.0,-65.0,-61.0,-70.0,-72.0,-67.0,-61.0,-75.0,-82.0,-73.0,-79.0,7.0,11.0,8.0,18.0,1
1643,F8:59:71:5A:E0:3D,3440606,2244246828,1317714,1974827989,2122892,269418839,294,745839,910524344,745150,910441397,689,82947,734502,1840,1317843,164127,294,1132,144444.0,43333.0,-66.0,-72.0,-64.0,-70.0,-66.0,-72.0,-64.0,-70.0,-75.0,-82.0,-73.0,-79.0,9.0,10.0,9.0,9.0,1
1644,CC:2F:71:3F:1F:24,4005217,2756696455,1882321,2487277212,2122896,269419243,2596,1534650,1966209085,1533538,1966083247,1112,125838,1517053,6254,1882171,207397,2596,1832,86667.0,14444.0,-67.0,-64.0,-67.0,-69.0,-67.0,-64.0,-67.0,-69.0,-75.0,-82.0,-73.0,-79.0,8.0,18.0,6.0,10.0,1
1645,CC:2F:71:3E:C5:1F,5529797,4451678047,3406901,4182258804,2122896,269419243,502,93190,7998984,78595,6269134,14595,1729850,21539,532,3414296,870690,502,2926,6500.0,1000.0,-68.0,-71.0,-65.0,-61.0,-70.0,-72.0,-67.0,-61.0,-75.0,-82.0,-73.0,-79.0,7.0,11.0,8.0,18.0,1
1646,F8:59:71:5A:E0:3D,3440851,2244623712,1317955,1975204469,2122896,269419243,294,745981,910656334,745292,910573387,689,82947,734640,1840,1318084,164177,294,1132,144444.0,43333.0,-68.0,-73.0,-65.0,-72.0,-67.0,-72.0,-65.0,-71.0,-76.0,-83.0,-74.0,-79.0,8.0,10.0,9.0,7.0,1
1647,CC:2F:71:3F:1F:24,4005382,2756910585,1882484,2487491140,2122898,269419445,2596,1534802,1966415747,1533690,1966289909,1112,125838,1517205,6254,1882333,207473,2596,1832,65000.0,14444.0,-67.0,-63.0,-67.0,-69.0,-68.0,-63.0,-68.0,-69.0,-76.0,-83.0,-74.0,-79.0,9.0,20.0,7.0,10.0,1
1648,CC:2F:71:3E:C5:1F,5529799,4451678249,3406901,4182258804,2122898,269419445,502,93190,7998984,78595,6269134,14595,1729850,21539,532,3414296,870690,502,2926,6500.0,1000.0,-68.0,-71.0,-65.0,-61.0,-70.0,-72.0,-67.0,-61.0,-76.0,-83.0,-74.0,-79.0,8.0,12.0,9.0,18.0,1
1649,F8:59:71:5A:E0:3D,3440918,2244720524,1318017,1975300817,2122901,269419707,294,746043,910751856,745354,910668909,689,82947,734702,1840,1318146,164188,294,1132,144444.0,43333.0,-68.0,-73.0,-65.0,-72.0,-67.0,-72.0,-64.0,-71.0,-76.0,-83.0,-74.0,-79.0,8.0,10.0,9.0,7.0,1
1650,CC:2F:71:3F:1F:24,4005557,2757122615,1882651,2487702442,2122906,269420173,2596,1534955,1966621365,1533843,1966495527,1112,125838,1517357,6254,1882501,207510,2596,1832,86667.0,14444.0,-68.0,-64.0,-67.0,-69.0,-68.0,-64.0,-69.0,-69.0,-76.0,-83.0,-74.0,-79.0,8.0,19.0,7.0,10.0,1
1651,CC:2F:71:3E:C5:1F,5529807,4451678977,3406901,4182258804,2122906,269420173,502,93191,7999102,78595,6269134,14596,1729968,21540,532,3414296,870690,502,2926,6500.0,1000.0,-74.0,-74.0,-70.0,-61.0,-71.0,-72.0,-67.0,-61.0,-76.0,-83.0,-74.0,-79.0,2.0,9.0,4.0,18.0,1
1652,F8:59:71:5A:E0:3D,3441197,2245090158,1318291,1975669985,2122906,269420173,294,746152,910863932,745463,910780985,689,82947,734811,1840,1318420,164267,294,1132,144444.0,43333.0,-68.0,-73.0,-65.0,-72.0,-67.0,-72.0,-64.0,-71.0,-76.0,-83.0,-74.0,-79.0,8.0,10.0,9.0,7.0,1
1653,CC:2F:71:3F:1F:24,4005713,2757324927,1882807,2487904754,2122906,269420173,2596,1535100,1966818807,1533988,1966692969,1112,125838,1517502,6254,1882656,207556,2596,1832,86667.0,14444.0,-67.0,-64.0,-67.0,-69.0,-68.0,-64.0,-68.0,-69.0,-76.0,-83.0,-74.0,-79.0,9.0,19.0,7.0,10.0,1
1654,CC:2F:71:3E:C5:1F,5529809,4451679179,3406901,4182258804,2122908,269420375,502,93191,7999102,78595,6269134,14596,1729968,21540,532,3414296,870690,502,2926,6500.0,1000.0,-74.0,-74.0,-70.0,-61.0,-71.0,-72.0,-67.0,-61.0,-76.0,-83.0,-74.0,-79.0,2.0,9.0,4.0,18.0,1
1655,F8:59:71:5A:E0:3D,3441561,2245649165,1318653,1976228790,2122908,269420375,294,746279,910980236,745590,910897289,689,82947,734938,1840,1318782,164284,294,1132,144444.0,43333.0,-67.0,-72.0,-65.0,-70.0,-66.0,-72.0,-64.0,-70.0,-75.0,-82.0,-73.0,-78.0,8.0,10.0,8.0,8.0,1
1656,CC:2F:71:3F:1F:24,4005885,2757539702,1882977,2488119327,2122908,269420375,2596,1535254,1967023044,1534142,1966897206,1112,125838,1517656,6254,1882827,207578,2596,1832,86667.0,14444.0,-67.0,-64.0,-66.0,-69.0,-68.0,-63.0,-68.0,-69.0,-75.0,-82.0,-73.0,-78.0,8.0,18.0,7.0,9.0,1
1657,CC:2F:71:3E:C5:1F,5529813,4451679583,3406901,4182258804,2122912,269420779,502,93191,7999102,78595,6269134,14596,1729968,21540,532,3414296,870690,502,2926,6500.0,1000.0,-74.0,-74.0,-70.0,-61.0,-71.0,-72.0,-67.0,-61.0,-75.0,-82.0,-73.0,-78.0,1.0,8.0,3.0,17.0,1
1658,F8:59:71:5A:E0:3D,3441633,2245750841,1318718,1976329800,2122915,269421041,294,746343,911078796,745654,910995849,689,82947,735002,1840,1318847,164295,294,1132,144444.0,43333.0,-67.0,-72.0,-64.0,-69.0,-67.0,-72.0,-65.0,-71.0,-75.0,-82.0,-73.0,-78.0,8.0,10.0,9.0,9.0,1
1659,CC:2F:71:3F:1F:24,4006053,2757750450,1883138,2488329409,2122915,269421041,2596,1535401,1967224864,1534289,1967099026,1112,125838,1517803,6254,1882987,207645,2596,1832,86667.0,13000.0,-70.0,-64.0,-71.0,-70.0,-68.0,-63.0,-67.0,-69.0,-75.0,-82.0,-73.0,-78.0,5.0,18.0,2.0,8.0,1
1660,CC:2F:71:3E:C5:1F,5529816,4451679845,3406901,4182258804,2122915,269421041,502,93191,7999102,78595,6269134,14596,1729968,21540,532,3414296,870690,502,2926,6500.0,1000.0,-74.0,-74.0,-70.0,-61.0,-71.0,-72.0,-67.0,-61.0,-75.0,-82.0,-73.0,-78.0,1.0,8.0,3.0,17.0,1
1661,F8:59:71:5A:E0:3D,3441698,2245848945,1318781,1976427702,2122917,269421243,294,746406,911175816,745717,911092869,689,82947,735065,1840,1318910,164306,294,1132,144444.0,43333.0,-68.0,-73.0,-66.0,-71.0,-67.0,-72.0,-64.0,-70.0,-75.0,-82.0,-73.0,-78.0,7.0,9.0,7.0,7.0,1
1662,CC:2F:71:3F:1F:24,4006212,2757955998,1883295,2488534755,2122917,269421243,2596,1535543,1967421860,1534431,1967296022,1112,125838,1517945,6254,1883144,207685,2596,1832,86667.0,14444.0,-70.0,-64.0,-72.0,-70.0,-68.0,-64.0,-69.0,-69.0,-75.0,-82.0,-73.0,-78.0,5.0,18.0,1.0,8.0,1
1663,CC:2F:71:3E:C5:1F,5529818,4451680047,3406901,4182258804,2122917,269421243,502,93191,7999102,78595,6269134,14596,1729968,21540,532,3414296,870690,502,2926,6500.0,1000.0,-74.0,-74.0,-70.0,-61.0,-71.0,-72.0,-67.0,-61.0,-75.0,-82.0,-73.0,-78.0,1.0,8.0,3.0,17.0,1
1664,F8:59:71:5A:E0:3D,3441768,2245947579,1318844,1976525604,2122924,269421975,294,746469,911272836,745780,911189889,689,82947,735128,1840,1318973,164312,294,1132,144444.0,43333.0,-68.0,-73.0,-65.0,-71.0,-67.0,-72.0,-64.0,-70.0,-76.0,-83.0,-74.0,-79.0,8.0,10.0,9.0,8.0,1
1665,CC:2F:71:3F:1F:24,4006394,2758167987,1883470,2488746012,2122924,269421975,2596,1535698,1967624796,1534586,1967498958,1112,125838,1518100,6254,1883320,207753,2596,1833,86667.0,14444.0,-70.0,-64.0,-71.0,-70.0,-69.0,-63.0,-70.0,-69.0,-76.0,-83.0,-74.0,-79.0,6.0,19.0,3.0,9.0,1
1666,CC:2F:71:3E:C5:1F,5529825,4451680779,3406901,4182258804,2122924,269421975,502,93191,7999102,78595,6269134,14596,1729968,21540,532,3414296,870690,502,2926,6500.0,1000.0,-74.0,-74.0,-70.0,-61.0,-71.0,-72.0,-67.0,-61.0,-76.0,-83.0,-74.0,-79.0,2.0,9.0,4.0,18.0,1
1667,F8:59:71:5A:E0:3D,3441834,2246045743,1318907,1976623506,2122927,269422237,294,746533,911371396,745844,911288449,689,82947,735192,1840,1319036,164320,294,1132,144444.0,43333.0,-68.0,-73.0,-65.0,-72.0,-66.0,-72.0,-64.0,-70.0,-76.0,-83.0,-74.0,-79.0,8.0,10.0,9.0,7.0,1
1668,CC:2F:71:3F:1F:24,4006555,2758373837,1883628,2488951600,2122927,269422237,2596,1535844,1967822256,1534732,1967696418,1112,125838,1518246,6254,1883478,207799,2596,1833,86667.0,14444.0,-70.0,-64.0,-71.0,-70.0,-69.0,-63.0,-69.0,-69.0,-76.0,-83.0,-74.0,-79.0,6.0,19.0,3.0,9.0,1
1669,CC:2F:71:3E:C5:1F,5529828,4451681041,3406901,4182258804,2122927,269422237,502,93191,7999102,78595,6269134,14596,1729968,21540,532,3414296,870690,502,2926,6500.0,1000.0,-74.0,-74.0,-70.0,-61.0,-71.0,-72.0,-67.0,-61.0,-76.0,-83.0,-74.0,-79.0,2.0,9.0,4.0,18.0,1
1670,F8:59:71:5A:E0:3D,3441904,2246145637,1318971,1976722794,2122933,269422843,294,746597,911469970,745908,911387023,689,82947,735255,1840,1319100,164328,294,1132,144444.0,43333.0,-66.0,-72.0,-64.0,-70.0,-67.0,-72.0,-64.0,-70.0,-76.0,-83.0,-74.0,-79.0,10.0,11.0,10.0,9.0,1
1671,CC:2F:71:3F:1F:24,4006720,2758582673,1883787,2489159830,2122933,269422843,2596,1535989,1968022420,1534877,1967896582,1112,125838,1518391,6254,1883637,207872,2596,1833,86667.0,14444.0,-67.0,-64.0,-66.0,-70.0,-68.0,-64.0,-68.0,-69.0,-76.0,-83.0,-74.0,-79.0,9.0,19.0,8.0,9.0,1
1672,CC:2F:71:3E:C5:1F,5529834,4451681647,3406901,4182258804,2122933,269422843,502,93191,7999102,78595,6269134,14596,1729968,21540,532,3414296,870690,502,2926,6500.0,1000.0,-74.0,-74.0,-70.0,-61.0,-71.0,-72.0,-67.0,-61.0,-76.0,-83.0,-74.0,-79.0,2.0,9.0,4.0,18.0,1
1673,F8:59:71:5A:E0:3D,3442033,2246296745,1319097,1976873427,2122936,269423318,294,746680,911582045,745991,911499098,689,82947,735337,1840,1319226,164334,294,1132,144444.0,43333.0,-67.0,-72.0,-65.0,-71.0,-66.0,-71.0,-64.0,-70.0,-76.0,-83.0,-74.0,-79.0,9.0,11.0,9.0,8.0,1
1674,CC:2F:71:3F:1F:24,4006896,2758794106,1883960,2489370788,2122936,269423318,2596,1536143,1968222311,1535031,1968096473,1112,125838,1518545,6254,1883807,207905,2596,1833,86667.0,14444.0,-67.0,-63.0,-67.0,-69.0,-68.0,-63.0,-70.0,-70.0,-76.0,-83.0,-74.0,-79.0,9.0,20.0,7.0,10.0,1
1675,CC:2F:71:3E:C5:1F,5529837,4451682122,3406901,4182258804,2122936,269423318,502,93191,7999102,78595,6269134,14596,1729968,21540,532,3414296,870690,502,2926,6500.0,1000.0,-74.0,-74.0,-70.0,-61.0,-71.0,-72.0,-67.0,-61.0,-76.0,-83.0,-74.0,-79.0,2.0,9.0,4.0,18.0,1
1676,F8:59:71:5A:E0:3D,3442265,2246646853,1319322,1977222869,2122943,269423984,294,746783,911685157,746094,911602210,689,82947,735440,1840,1319451,164354,294,1133,144444.0,43333.0,-66.0,-72.0,-63.0,-70.0,-67.0,-72.0,-64.0,-71.0,-76.0,-83.0,-74.0,-79.0,10.0,11.0,11.0,9.0,1
1677,CC:2F:71:3F:1F:24,4007061,2759000024,1884118,2489576040,2122943,269423984,2596,1536288,1968419627,1535176,1968293789,1112,125838,1518690,6254,1883968,207962,2596,1833,86667.0,13000.0,-69.0,-64.0,-73.0,-71.0,-67.0,-64.0,-69.0,-70.0,-76.0,-83.0,-74.0,-79.0,7.0,19.0,1.0,8.0,1
1678,CC:2F:71:3E:C5:1F,5529844,4451682788,3406901,4182258804,2122943,269423984,502,93191,7999102,78595,6269134,14596,1729968,21540,532,3414296,870690,502,2926,6500.0,1000.0,-74.0,-74.0,-70.0,-61.0,-71.0,-72.0,-67.0,-61.0,-76.0,-83.0,-74.0,-79.0,2.0,9.0,4.0,18.0,1
1679,F8:59:71:5A:E0:3D,3442331,2246746511,1319386,1977322325,2122945,269424186,294,746846,911782177,746157,911699230,689,82947,735503,1840,1319515,164365,294,1133,144444.0,43333.0,-67.0,-72.0,-63.0,-70.0,-67.0,-72.0,-63.0,-70.0,-76.0,-83.0,-74.0,-79.0,9.0,11.0,11.0,9.0,1
1680,CC:2F:71:3F:1F:24,4007248,2759215075,1884303,2489790889,2122945,269424186,2596,1536455,1968627072,1535343,1968501234,1112,125838,1518857,6254,1884153,208022,2596,1833,78000.0,13000.0,-69.0,-64.0,-73.0,-71.0,-67.0,-64.0,-68.0,-69.0,-76.0,-83.0,-74.0,-79.0,7.0,19.0,1.0,8.0,1
1681,CC:2F:71:3E:C5:1F,5529846,4451682990,3406901,4182258804,2122945,269424186,502,93191,7999102,78595,6269134,14596,1729968,21540,532,3414296,870690,502,2926,6500.0,1000.0,-74.0,-74.0,-70.0,-61.0,-71.0,-72.0,-67.0,-61.0,-76.0,-83.0,-74.0,-79.0,2.0,9.0,4.0,18.0,1
1682,F8:59:71:5A:E0:3D,3442463,2246927424,1319512,1977502632,2122951,269424792,294,746931,911891762,746242,911808815,689,82947,735588,1840,1319641,164371,294,1133,144444.0,43333.0,-66.0,-72.0,-63.0,-70.0,-67.0,-72.0,-63.0,-70.0,-76.0,-83.0,-74.0,-79.0,10.0,11.0,11.0,9.0,1
1683,CC:2F:71:3F:1F:24,4007413,2759420881,1884461,2489996029,2122952,269424852,2596,1536599,1968824384,1535487,1968698546,1112,125838,1519001,6254,1884311,208077,2596,1834,86667.0,14444.0,-67.0,-64.0,-67.0,-70.0,-68.0,-64.0,-71.0,-70.0,-76.0,-83.0,-74.0,-79.0,9.0,19.0,7.0,9.0,1
1684,CC:2F:71:3E:C5:1F,5529853,4451683656,3406901,4182258804,2122952,269424852,502,93191,7999102,78595,6269134,14596,1729968,21540,532,3414296,870690,502,2926,6500.0,1000.0,-74.0,-74.0,-70.0,-61.0,-71.0,-72.0,-67.0,-61.0,-76.0,-83.0,-74.0,-79.0,2.0,9.0,4.0,18.0,1
1685,F8:59:71:5A:E0:3D,3442529,2247025588,1319575,1977600534,2122954,269425054,294,746994,911988782,746305,911905835,689,82947,735651,1840,1319704,164374,294,1133,144444.0,43333.0,-67.0,-72.0,-63.0,-70.0,-67.0,-72.0,-64.0,-70.0,-76.0,-83.0,-74.0,-79.0,9.0,11.0,11.0,9.0,1
1686,CC:2F:71:3F:1F:24,4007572,2759626037,1884618,2490200983,2122954,269425054,2596,1536743,1969021584,1535631,1968895746,1112,125838,1519145,6254,1884468,208130,2596,1834,78000.0,13000.0,-69.0,-64.0,-72.0,-71.0,-68.0,-64.0,-70.0,-70.0,-76.0,-83.0,-74.0,-79.0,7.0,19.0,2.0,8.0,1
1687,CC:2F:71:3E:C5:1F,5529855,4451683858,3406901,4182258804,2122954,269425054,502,93191,7999102,78595,6269134,14596,1729968,21540,533,3414297,870691,502,2926,6500.0,1000.0,-74.0,-74.0,-70.0,-61.0,-71.0,-72.0,-67.0,-61.0,-76.0,-83.0,-74.0,-79.0,2.0,9.0,4.0,18.0,1
1688,F8:59:71:5A:E0:3D,3442693,2247260162,1319735,1977834704,2122958,269425458,294,747093,912099486,746404,912016539,689,82947,735749,1840,1319864,164389,294,1133,144444.0,43333.0,-68.0,-72.0,-65.0,-71.0,-67.0,-72.0,-64.0,-70.0,-76.0,-83.0,-74.0,-79.0,8.0,11.0,9.0,8.0,1
1689,CC:2F:71:3F:1F:24,4007738,2759835003,1884778,2490409343,2122960,269425660,2596,1536890,1969222022,1535778,1969096184,1112,125838,1519292,6254,1884627,208177,2596,1834,86667.0,14444.0,-69.0,-64.0,-73.0,-71.0,-67.0,-64.0,-68.0,-69.0,-76.0,-83.0,-74.0,-79.0,7.0,19.0,1.0,8.0,1
1690,CC:2F:71:3E:C5:1F,5529861,4451684464,3406901,4182258804,2122960,269425660,502,93191,7999102,78595,6269134,14596,1729968,21540,533,3414297,870691,502,2926,6500.0,1000.0,-74.0,-74.0,-70.0,-61.0,-71.0,-72.0,-67.0,-61.0,-75.0,-82.0,-73.0,-78.0,1.0,8.0,3.0,17.0,1
1691,F8:59:71:5A:E0:3D,3442762,2247362988,1319801,1977937268,2122961,269425720,294,747162,912204364,746473,912121417,689,82947,735817,1840,1319930,164393,294,1133,144444.0,43333.0,-68.0,-73.0,-65.0,-72.0,-67.0,-72.0,-64.0,-71.0,-75.0,-82.0,-73.0,-78.0,7.0,9.0,8.0,6.0,1
1692,CC:2F:71:3F:1F:24,4007912,2760051524,1884951,2490625804,2122961,269425720,2596,1537044,1969431310,1535932,1969305472,1112,125838,1519446,6254,1884801,208253,2596,1834,86667.0,14444.0,-69.0,-64.0,-73.0,-71.0,-68.0,-64.0,-71.0,-70.0,-75.0,-82.0,-73.0,-78.0,6.0,18.0,0.0,7.0,1
1693,CC:2F:71:3E:C5:1F,5529864,4451684726,3406901,4182258804,2122963,269425922,502,93191,7999102,78595,6269134,14596,1729968,21540,533,3414297,870691,502,2926,6500.0,1000.0,-74.0,-74.0,-70.0,-61.0,-71.0,-72.0,-67.0,-61.0,-75.0,-82.0,-73.0,-78.0,1.0,8.0,3.0,17.0,1
1694,F8:59:71:5A:E0:3D,3442829,2247464200,1319866,1978038278,2122963,269425922,294,747227,912304506,746538,912221559,689,82947,735882,1840,1319995,164404,294,1133,144444.0,43333.0,-68.0,-72.0,-65.0,-72.0,-67.0,-71.0,-64.0,-70.0,-75.0,-82.0,-73.0,-78.0,7.0,10.0,8.0,6.0,1
1695,CC:2F:71:3F:1F:24,4008082,2760266666,1885115,2490840340,2122967,269426326,2596,1537196,1969636850,1536084,1969511012,1112,125838,1519598,6254,1884965,208366,2596,1834,86667.0,14444.0,-69.0,-64.0,-72.0,-71.0,-68.0,-64.0,-72.0,-70.0,-75.0,-82.0,-73.0,-78.0,6.0,18.0,1.0,7.0,1
1696,CC:2F:71:3E:C5:1F,5529870,4451685332,3406901,4182258804,2122969,269426528,502,93191,7999102,78595,6269134,14596,1729968,21540,533,3414297,870691,502,2926,6500.0,1000.0,-74.0,-74.0,-70.0,-61.0,-71.0,-72.0,-67.0,-61.0,-75.0,-82.0,-73.0,-78.0,1.0,8.0,3.0,17.0,1
1697,F8:59:71:5A:E0:3D,3443086,2247828945,1320117,1978402417,2122969,269426528,294,747338,912415969,746649,912333022,689,82947,735993,1840,1320246,164414,294,1133,144444.0,43333.0,-66.0,-71.0,-63.0,-70.0,-66.0,-71.0,-63.0,-70.0,-75.0,-82.0,-73.0,-78.0,9.0,11.0,10.0,8.0,1
1698,CC:2F:71:3F:1F:24,4008243,2760475266,1885274,2491048738,2122969,269426528,2596,1537342,1969837130,1536230,1969711292,1112,125838,1519744,6254,1885123,208422,2596,1834,86667.0,14444.0,-67.0,-64.0,-68.0,-70.0,-67.0,-63.0,-68.0,-70.0,-75.0,-82.0,-73.0,-78.0,8.0,18.0,5.0,8.0,1
1699,CC:2F:71:3E:C5:1F,5529870,4451685332,3406901,4182258804,2122969,269426528,502,93191,7999102,78595,6269134,14596,1729968,21540,533,3414297,870691,502,2926,6500.0,1000.0,-74.0,-74.0,-70.0,-61.0,-71.0,-72.0,-67.0,-61.0,-75.0,-82.0,-73.0,-78.0,1.0,8.0,3.0,17.0,1
1700,F8:59:71:5A:E0:3D,3443343,2248176962,1320371,1978750172,2122972,269426790,294,747445,912528522,746756,912445575,689,82947,736100,1840,1320500,164421,294,1133,144444.0,43333.0,-68.0,-72.0,-65.0,-72.0,-67.0,-72.0,-64.0,-70.0,-75.0,-82.0,-73.0,-78.0,7.0,10.0,8.0,6.0,1
1701,CC:2F:71:3F:1F:24,4008408,2760687388,1885436,2491260598,2122972,269426790,2596,1537491,1970043538,1536379,1969917700,1112,125838,1519892,6254,1885286,208465,2596,1835,86667.0,14444.0,-69.0,-64.0,-73.0,-71.0,-68.0,-63.0,-71.0,-70.0,-75.0,-82.0,-73.0,-78.0,6.0,18.0,0.0,7.0,1
1702,CC:2F:71:3E:C5:1F,5529875,4451685796,3406901,4182258804,2122974,269426992,502,93191,7999102,78595,6269134,14596,1729968,21540,533,3414297,870691,502,2926,6500.0,1000.0,-74.0,-74.0,-70.0,-61.0,-71.0,-72.0,-67.0,-61.0,-75.0,-82.0,-73.0,-78.0,1.0,8.0,3.0,17.0,1
1703,F8:59:71:5A:E0:3D,3443412,2248275246,1320434,1978847850,2122978,269427396,294,747510,912628636,746821,912545689,689,82947,736164,1840,1320563,164434,294,1133,144444.0,43333.0,-67.0,-72.0,-63.0,-70.0,-66.0,-71.0,-63.0,-70.0,-76.0,-83.0,-74.0,-79.0,9.0,11.0,11.0,9.0,1
1704,CC:2F:71:3F:1F:24,4008575,2760899164,1885597,2491471768,2122978,269427396,2596,1537637,1970245270,1536525,1970119432,1112,125838,1520038,6254,1885446,208531,2596,1835,78000.0,13000.0,-67.0,-64.0,-68.0,-70.0,-67.0,-64.0,-67.0,-69.0,-76.0,-83.0,-74.0,-79.0,9.0,19.0,6.0,9.0,1
1705,CC:2F:71:3E:C5:1F,5529879,4451686200,3406901,4182258804,2122978,269427396,502,93191,7999102,78595,6269134,14596,1729968,21540,533,3414297,870691,502,2926,6500.0,1000.0,-74.0,-74.0,-70.0,-61.0,-71.0,-72.0,-67.0,-61.0,-76.0,-83.0,-74.0,-79.0,2.0,9.0,4.0,18.0,1
1706,F8:59:71:5A:E0:3D,3443478,2248374904,1320498,1978947306,2122980,269427598,294,747573,912725656,746884,912642709,689,82947,736227,1840,1320627,164443,294,1133,144444.0,43333.0,-68.0,-73.0,-65.0,-72.0,-67.0,-72.0,-64.0,-70.0,-76.0,-83.0,-74.0,-79.0,8.0,10.0,9.0,7.0,1
1707,CC:2F:71:3F:1F:24,4008739,2761104315,1885759,2491676717,2122980,269427598,2596,1537786,1970441791,1536674,1970315953,1112,125838,1520187,6254,1885609,208554,2596,1835,86667.0,14444.0,-67.0,-64.0,-67.0,-70.0,-68.0,-64.0,-70.0,-69.0,-76.0,-83.0,-74.0,-79.0,9.0,19.0,7.0,9.0,1
1708,CC:2F:71:3E:C5:1F,5529881,4451686402,3406901,4182258804,2122980,269427598,502,93191,7999102,78595,6269134,14596,1729968,21540,533,3414297,870691,502,2926,6500.0,1000.0,-74.0,-74.0,-70.0,-61.0,-71.0,-72.0,-67.0,-61.0,-76.0,-83.0,-74.0,-79.0,2.0,9.0,4.0,18.0,1
1709,F8:59:71:5A:E0:3D,3443556,2248474656,1320569,1979046392,2122987,269428264,294,747641,912825158,746952,912742211,689,82947,736295,1840,1320698,164454,294,1133,144444.0,43333.0,-67.0,-73.0,-63.0,-70.0,-66.0,-71.0,-63.0,-69.0,-76.0,-83.0,-74.0,-79.0,9.0,10.0,11.0,9.0,1
1710,CC:2F:71:3F:1F:24,4008912,2761322849,1885925,2491894585,2122987,269428264,2596,1537941,1970653095,1536829,1970527257,1112,125838,1520342,6254,1885775,208645,2596,1835,78000.0,13000.0,-67.0,-63.0,-67.0,-69.0,-67.0,-63.0,-67.0,-68.0,-76.0,-83.0,-74.0,-79.0,9.0,20.0,7.0,10.0,1
1711,CC:2F:71:3E:C5:1F,5529888,4451687068,3406901,4182258804,2122987,269428264,502,93191,7999102,78595,6269134,14596,1729968,21540,533,3414297,870691,502,2926,6500.0,1000.0,-74.0,-74.0,-70.0,-61.0,-71.0,-72.0,-67.0,-61.0,-76.0,-83.0,-74.0,-79.0,2.0,9.0,4.0,18.0,1
1712,F8:59:71:5A:E0:3D,3443680,2248633580,1320691,1979205114,2122989,269428466,294,747714,912932315,747025,912849368,689,82947,736368,1840,1320820,164482,294,1133,144444.0,43333.0,-67.0,-72.0,-63.0,-69.0,-66.0,-71.0,-63.0,-69.0,-76.0,-83.0,-74.0,-79.0,9.0,11.0,11.0,10.0,1
1713,CC:2F:71:3F:1F:24,4009074,2761531355,1886085,2492102889,2122989,269428466,2596,1538086,1970853259,1536974,1970727421,1112,125838,1520487,6254,1885935,208726,2596,1835,86667.0,14444.0,-67.0,-64.0,-68.0,-70.0,-67.0,-63.0,-67.0,-69.0,-76.0,-83.0,-74.0,-79.0,9.0,19.0,6.0,9.0,1
1714,CC:2F:71:3E:C5:1F,5529890,4451687270,3406901,4182258804,2122989,269428466,502,93191,7999102,78595,6269134,14596,1729968,21540,533,3414297,870691,502,2926,6500.0,1000.0,-74.0,-74.0,-70.0,-61.0,-71.0,-72.0,-67.0,-61.0,-76.0,-83.0,-74.0,-79.0,2.0,9.0,4.0,18.0,1
1715,F8:59:71:5A:E0:3D,3443914,2248978225,1320918,1979548880,2122996,269429345,294,747807,913044508,747118,912961561,689,82947,736461,1840,1321039,164519,294,1133,144444.0,43333.0,-66.0,-71.0,-64.0,-70.0,-66.0,-71.0,-63.0,-70.0,-76.0,-83.0,-74.0,-79.0,10.0,12.0,10.0,9.0,1
1716,CC:2F:71:3F:1F:24,4009241,2761739153,1886245,2492309808,2122996,269429345,2596,1538233,1971052270,1537121,1970926432,1112,125838,1520634,6254,1886096,208792,2596,1835,86667.0,14444.0,-67.0,-64.0,-67.0,-69.0,-66.0,-64.0,-67.0,-69.0,-76.0,-83.0,-74.0,-79.0,9.0,19.0,7.0,10.0,1
1717,CC:2F:71:3E:C5:1F,5529899,4451689273,3406901,4182258804,2122998,269430469,502,93191,7999102,78595,6269134,14596,1729968,21540,533,3414297,870691,502,2926,6500.0,1000.0,-74.0,-74.0,-70.0,-61.0,-71.0,-72.0,-67.0,-61.0,-76.0,-83.0,-74.0,-79.0,2.0,9.0,4.0,18.0,1
1718,F8:59:71:5A:E0:3D,3444087,2249242472,1321086,1979811741,2123001,269430731,294,747908,913149022,747219,913066075,689,82947,736561,1840,1321215,164546,294,1133,144444.0,43333.0,-68.0,-72.0,-63.0,-69.0,-66.0,-72.0,-63.0,-70.0,-76.0,-83.0,-74.0,-79.0,8.0,11.0,11.0,10.0,1
1719,CC:2F:71:3F:1F:24,4009406,2761949067,1886405,2492518336,2123001,269430731,2596,1538380,1971252704,1537268,1971126866,1112,125838,1520780,6254,1886256,208859,2596,1836,78000.0,13000.0,-66.0,-62.0,-68.0,-68.0,-66.0,-63.0,-67.0,-68.0,-76.0,-83.0,-74.0,-79.0,10.0,21.0,6.0,11.0,1
1720,CC:2F:71:3E:C5:1F,5529902,4451689535,3406901,4182258804,2123001,269430731,502,93191,7999102,78595,6269134,14596,1729968,21540,533,3414297,870691,502,2926,6500.0,1000.0,-74.0,-74.0,-70.0,-61.0,-71.0,-72.0,-67.0,-61.0,-76.0,-83.0,-74.0,-79.0,2.0,9.0,4.0,18.0,1
1721,F8:59:71:5A:E0:3D,3444212,2249401242,1321181,1979957933,2123031,269443309,294,748003,913295406,747314,913212459,689,82947,736656,1840,1321310,164571,294,1133,144444.0,43333.0,-67.0,-72.0,-63.0,-70.0,-66.0,-72.0,-63.0,-70.0,-76.0,-83.0,-74.0,-79.0,9.0,11.0,11.0,9.0,1
1722,CC:2F:71:3F:1F:24,4009678,2762294643,1886647,2492851334,2123031,269443309,2596,1538614,1971575220,1537502,1971449382,1112,125838,1521005,6254,1886493,209104,2596,1838,86667.0,14444.0,-69.0,-64.0,-72.0,-70.0,-67.0,-64.0,-67.0,-69.0,-76.0,-83.0,-74.0,-79.0,7.0,19.0,2.0,9.0,1
1723,CC:2F:71:3E:C5:1F,5529933,4451702229,3406902,4182258920,2123031,269443309,502,93191,7999102,78595,6269134,14596,1729968,21540,533,3414298,870692,502,2926,6500.0,1000.0,-74.0,-74.0,-70.0,-61.0,-71.0,-72.0,-67.0,-61.0,-76.0,-83.0,-74.0,-79.0,2.0,9.0,4.0,18.0,1
1724,F8:59:71:5A:E0:3D,3444296,2249524472,1321260,1980080699,2123036,269443773,294,748082,913417122,747393,913334175,689,82947,736735,1840,1321389,164585,294,1133,144444.0,1000.0,-67.0,-72.0,-63.0,-70.0,-66.0,-71.0,-62.0,-70.0,-76.0,-83.0,-74.0,-79.0,9.0,11.0,11.0,9.0,1
1725,CC:2F:71:3F:1F:24,4009888,2762528066,1886850,2493084091,2123038,269443975,2596,1538798,1971800090,1537686,1971674252,1112,125838,1521187,6254,1886701,209186,2596,1839,86667.0,14444.0,-66.0,-64.0,-67.0,-69.0,-66.0,-63.0,-67.0,-68.0,-76.0,-83.0,-74.0,-79.0,10.0,19.0,7.0,10.0,1
1726,CC:2F:71:3E:C5:1F,5529940,4451702895,3406902,4182258920,2123038,269443975,502,93191,7999102,78595,6269134,14596,1729968,21540,533,3414298,870692,502,2926,6500.0,1000.0,-74.0,-74.0,-70.0,-61.0,-71.0,-72.0,-67.0,-61.0,-76.0,-83.0,-74.0,-80.0,2.0,9.0,4.0,19.0,1
1727,F8:59:71:5A:E0:3D,3444576,2249915793,1321534,1980470492,2123042,269445301,294,748168,913524293,747479,913441346,689,82947,736821,1840,1321662,164635,294,1133,144444.0,43333.0,-66.0,-72.0,-63.0,-70.0,-66.0,-71.0,-63.0,-69.0,-76.0,-83.0,-74.0,-80.0,10.0,11.0,11.0,10.0,1
1728,CC:2F:71:3F:1F:24,4010056,2762743704,1887014,2493298403,2123042,269445301,2596,1538951,1972008468,1537839,1971882630,1112,125838,1521340,6254,1886865,209283,2596,1840,78000.0,13000.0,-69.0,-63.0,-73.0,-71.0,-67.0,-63.0,-68.0,-69.0,-76.0,-83.0,-74.0,-80.0,7.0,20.0,1.0,9.0,1
1729,CC:2F:71:3E:C5:1F,5529944,4451704221,3406902,4182258920,2123042,269445301,502,93191,7999102,78595,6269134,14596,1729968,21540,533,3414298,870692,502,2926,6500.0,1000.0,-74.0,-74.0,-70.0,-61.0,-71.0,-72.0,-67.0,-61.0,-76.0,-83.0,-74.0,-80.0,2.0,9.0,4.0,19.0,1
1730,F8:59:71:5A:E0:3D,3444643,2250015567,1321599,1980570064,2123044,269445503,294,748233,913622959,747544,913540012,689,82947,736886,1840,1321728,164641,294,1133,144444.0,43333.0,-66.0,-72.0,-63.0,-70.0,-66.0,-72.0,-64.0,-70.0,-76.0,-84.0,-75.0,-80.0,10.0,12.0,12.0,10.0,1
1731,CC:2F:71:3F:1F:24,4010220,2762952622,1887174,2493506917,2123046,269445705,2596,1539099,1972207454,1537987,1972081616,1112,125838,1521486,6254,1887025,209332,2596,1840,86667.0,14444.0,-69.0,-64.0,-74.0,-71.0,-67.0,-63.0,-69.0,-70.0,-76.0,-84.0,-75.0,-80.0,7.0,20.0,1.0,9.0,1
1732,CC:2F:71:3E:C5:1F,5529949,4451704685,3406902,4182258920,2123047,269445765,502,93191,7999102,78595,6269134,14596,1729968,21540,533,3414298,870692,502,2926,6500.0,1000.0,-74.0,-74.0,-70.0,-61.0,-71.0,-72.0,-67.0,-61.0,-76.0,-84.0,-75.0,-80.0,2.0,10.0,5.0,19.0,1
1733,F8:59:71:5A:E0:3D,3444893,2250383357,1321841,1980937126,2123052,269446231,294,748326,913729599,747637,913646652,689,82947,736978,1840,1321970,164643,294,1133,130000.0,39000.0,-68.0,-73.0,-65.0,-72.0,-67.0,-72.0,-64.0,-71.0,-76.0,-84.0,-75.0,-80.0,8.0,11.0,10.0,8.0,1
1734,CC:2F:71:3F:1F:24,4010385,2763159898,1887333,2493713667,2123052,269446231,2596,1539246,1972409290,1538133,1972283334,1113,125956,1521632,6254,1887184,209441,2596,1840,65000.0,13000.0,-67.0,-63.0,-68.0,-69.0,-67.0,-63.0,-68.0,-69.0,-76.0,-84.0,-75.0,-80.0,9.0,21.0,7.0,11.0,1
1735,CC:2F:71:3E:C5:1F,5529954,4451705151,3406902,4182258920,2123052,269446231,502,93191,7999102,78595,6269134,14596,1729968,21540,533,3414298,870692,502,2926,6500.0,1000.0,-74.0,-74.0,-70.0,-61.0,-71.0,-72.0,-67.0,-61.0,-76.0,-84.0,-75.0,-80.0,2.0,10.0,5.0,19.0,1
1736,F8:59:71:5A:E0:3D,3444960,2250482965,1321905,1981036470,2123055,269446495,294,748392,913829817,747702,913746752,690,83065,737044,1840,1322034,164645,294,1133,144444.0,43333.0,-65.0,-72.0,-62.0,-70.0,-65.0,-71.0,-63.0,-70.0,-76.0,-84.0,-75.0,-80.0,11.0,12.0,13.0,10.0,1
1737,CC:2F:71:3F:1F:24,4010549,2763370548,1887494,2493924053,2123055,269446495,2596,1539395,1972614204,1538282,1972488248,1113,125956,1521780,6254,1887344,209535,2596,1840,86667.0,14444.0,-67.0,-63.0,-67.0,-69.0,-67.0,-63.0,-68.0,-69.0,-76.0,-84.0,-75.0,-80.0,9.0,21.0,8.0,11.0,1
1738,CC:2F:71:3E:C5:1F,5529959,4451705617,3406902,4182258920,2123057,269446697,502,93191,7999102,78595,6269134,14596,1729968,21540,533,3414298,870692,502,2926,6500.0,1000.0,-74.0,-74.0,-70.0,-61.0,-71.0,-72.0,-67.0,-61.0,-76.0,-84.0,-75.0,-80.0,2.0,10.0,5.0,19.0,1
1739,F8:59:71:5A:E0:3D,3445139,2250744976,1322077,1981297815,2123062,269447161,294,748497,913944031,747807,913860966,690,83065,737149,1840,1322206,164665,294,1133,144444.0,43333.0,-67.0,-73.0,-64.0,-72.0,-66.0,-72.0,-63.0,-70.0,-76.0,-84.0,-75.0,-80.0,9.0,11.0,11.0,8.0,1
1740,CC:2F:71:3F:1F:24,4010721,2763586504,1887659,2494139343,2123062,269447161,2596,1539546,1972820760,1538433,1972694804,1113,125956,1521931,6254,1887511,209677,2596,1840,78000.0,13000.0,-67.0,-63.0,-67.0,-70.0,-67.0,-63.0,-68.0,-70.0,-76.0,-84.0,-75.0,-80.0,9.0,21.0,8.0,10.0,1
1741,CC:2F:71:3E:C5:1F,5529964,4451706081,3406902,4182258920,2123062,269447161,502,93191,7999102,78595,6269134,14596,1729968,21540,533,3414298,870692,502,2926,6500.0,1000.0,-74.0,-74.0,-70.0,-61.0,-71.0,-72.0,-67.0,-61.0,-76.0,-84.0,-75.0,-80.0,2.0,10.0,5.0,19.0,1
1742,F8:59:71:5A:E0:3D,3445273,2250909552,1322209,1981462189,2123064,269447363,294,748575,914052444,747885,913969379,690,83065,737226,1840,1322338,164672,294,1133,144444.0,43333.0,-67.0,-73.0,-65.0,-72.0,-66.0,-71.0,-63.0,-70.0,-78.0,-85.0,-76.0,-81.0,11.0,12.0,11.0,9.0,1
1743,CC:2F:71:3F:1F:24,4010889,2763803718,1887825,2494356355,2123064,269447363,2596,1539699,1973031946,1538586,1972905990,1113,125956,1522083,6254,1887677,209813,2596,1840,86667.0,13000.0,-67.0,-63.0,-68.0,-70.0,-67.0,-63.0,-69.0,-70.0,-78.0,-85.0,-76.0,-81.0,11.0,22.0,8.0,11.0,1
1744,CC:2F:71:3E:C5:1F,5529966,4451706283,3406902,4182258920,2123064,269447363,502,93191,7999102,78595,6269134,14596,1729968,21540,533,3414298,870692,502,2926,6500.0,1000.0,-74.0,-74.0,-70.0,-61.0,-71.0,-72.0,-67.0,-61.0,-78.0,-85.0,-76.0,-81.0,4.0,11.0,6.0,20.0,1
1745,F8:59:71:5A:E0:3D,3445343,2251009502,1322273,1981561533,2123070,269447969,294,748639,914151004,747949,914067939,690,83065,737290,1840,1322402,164684,294,1133,144444.0,43333.0,-66.0,-72.0,-63.0,-70.0,-66.0,-72.0,-63.0,-70.0,-78.0,-85.0,-76.0,-81.0,12.0,13.0,13.0,11.0,1
1746,CC:2F:71:3F:1F:24,4011054,2764012162,1887984,2494564193,2123070,269447969,2596,1539843,1973230598,1538730,1973104642,1113,125956,1522227,6254,1887836,209896,2596,1840,86667.0,14444.0,-69.0,-63.0,-73.0,-71.0,-67.0,-63.0,-70.0,-70.0,-78.0,-85.0,-76.0,-81.0,9.0,22.0,3.0,10.0,1
1747,CC:2F:71:3E:C5:1F,5529972,4451706889,3406902,4182258920,2123070,269447969,502,93191,7999102,78595,6269134,14596,1729968,21540,533,3414298,870692,502,2926,6500.0,1000.0,-74.0,-74.0,-70.0,-61.0,-71.0,-72.0,-67.0,-61.0,-78.0,-85.0,-76.0,-81.0,4.0,11.0,6.0,20.0,1
1748,F8:59:71:5A:E0:3D,3445409,2251107666,1322336,1981659435,2123073,269448231,294,748704,914251118,748014,914168053,690,83065,737354,1840,1322465,164690,294,1133,144444.0,43333.0,-66.0,-72.0,-63.0,-70.0,-66.0,-71.0,-63.0,-70.0,-78.0,-85.0,-76.0,-81.0,12.0,13.0,13.0,11.0,1
1749,CC:2F:71:3F:1F:24,4011218,2764222506,1888145,2494774275,2123073,269448231,2596,1539990,1973433842,1538877,1973307886,1113,125956,1522374,6254,1887996,209966,2596,1840,86667.0,14444.0,-69.0,-64.0,-73.0,-71.0,-67.0,-63.0,-69.0,-70.0,-78.0,-85.0,-76.0,-81.0,9.0,21.0,3.0,10.0,1
1750,CC:2F:71:3E:C5:1F,5529975,4451707151,3406902,4182258920,2123073,269448231,502,93191,7999102,78595,6269134,14596,1729968,21540,533,3414298,870692,502,2926,6500.0,1000.0,-74.0,-74.0,-70.0,-61.0,-71.0,-72.0,-67.0,-61.0,-78.0,-85.0,-76.0,-81.0,4.0,11.0,6.0,20.0,1
1751,F8:59:71:5A:E0:3D,3445480,2251209282,1322401,1981760445,2123079,269448837,294,748769,914351232,748079,914268167,690,83065,737418,1840,1322530,164697,294,1133,144444.0,43333.0,-68.0,-72.0,-65.0,-72.0,-66.0,-72.0,-63.0,-70.0,-79.0,-85.0,-77.0,-82.0,11.0,13.0,12.0,10.0,1
1752,CC:2F:71:3F:1F:24,4011382,2764428196,1888303,2494979359,2123079,269448837,2596,1540135,1973632582,1539022,1973506626,1113,125956,1522519,6254,1888155,210054,2596,1840,86667.0,14444.0,-67.0,-64.0,-67.0,-70.0,-67.0,-63.0,-67.0,-69.0,-79.0,-85.0,-77.0,-82.0,12.0,21.0,10.0,12.0,1
1753,CC:2F:71:3E:C5:1F,5529981,4451707757,3406902,4182258920,2123079,269448837,502,93191,7999102,78595,6269134,14596,1729968,21540,533,3414298,870692,502,2926,6500.0,1000.0,-74.0,-74.0,-70.0,-61.0,-71.0,-72.0,-67.0,-61.0,-79.0,-85.0,-77.0,-82.0,5.0,11.0,7.0,21.0,1
1754,F8:59:71:5A:E0:3D,3445636,2251441566,1322554,1981992254,2123082,269449312,294,748854,914461864,748164,914378799,690,83065,737503,1840,1322683,164740,294,1133,144444.0,43333.0,-66.0,-72.0,-63.0,-70.0,-65.0,-72.0,-63.0,-69.0,-79.0,-85.0,-77.0,-82.0,13.0,13.0,14.0,12.0,1
1755,CC:2F:71:3F:1F:24,4011548,2764640925,1888466,2495191613,2123082,269449312,2596,1540285,1973836270,1539172,1973710314,1113,125956,1522669,6254,1888317,210174,2596,1840,104000.0,26000.0,-67.0,-63.0,-67.0,-69.0,-67.0,-63.0,-67.0,-69.0,-79.0,-85.0,-77.0,-82.0,12.0,22.0,10.0,13.0,1
1756,CC:2F:71:3E:C5:1F,5529984,4451708232,3406902,4182258920,2123082,269449312,502,93192,7999172,78596,6269204,14596,1729968,21540,533,3414298,870692,502,2926,6500.0,1000.0,-74.0,-73.0,-70.0,-61.0,-71.0,-72.0,-67.0,-61.0,-79.0,-85.0,-77.0,-82.0,5.0,12.0,7.0,21.0,1
1757,F8:59:71:5A:E0:3D,3445710,2251544858,1322620,1982094818,2123090,269450040,294,748920,914563574,748230,914480509,690,83065,737569,1840,1322749,164748,294,1133,144444.0,43333.0,-67.0,-72.0,-63.0,-70.0,-67.0,-72.0,-64.0,-71.0,-79.0,-85.0,-77.0,-82.0,12.0,13.0,14.0,12.0,1
1758,CC:2F:71:3F:1F:24,4011722,2764858833,1888632,2495408793,2123090,269450040,2596,1540436,1974045814,1539323,1973919858,1113,125956,1522820,6254,1888484,210305,2596,1840,86667.0,14444.0,-67.0,-63.0,-67.0,-69.0,-67.0,-63.0,-68.0,-70.0,-79.0,-85.0,-77.0,-82.0,12.0,22.0,10.0,13.0,1
1759,CC:2F:71:3E:C5:1F,5529992,4451708960,3406902,4182258920,2123090,269450040,502,93193,7999290,78596,6269204,14597,1730086,21541,533,3414298,870692,502,2927,6500.0,1000.0,-70.0,-72.0,-66.0,-61.0,-71.0,-72.0,-67.0,-61.0,-79.0,-85.0,-77.0,-82.0,9.0,13.0,11.0,21.0,1
1760,F8:59:71:5A:E0:3D,3445778,2251647678,1322686,1982197270,2123092,269450408,294,748986,914665326,748296,914582261,690,83065,737634,1840,1322815,164757,294,1134,144444.0,43333.0,-68.0,-72.0,-65.0,-72.0,-66.0,-71.0,-64.0,-70.0,-79.0,-85.0,-77.0,-82.0,11.0,13.0,12.0,10.0,1
1761,CC:2F:71:3F:1F:24,4011884,2765067169,1888792,2495616761,2123092,269450408,2596,1540583,1974249226,1539470,1974123270,1113,125956,1522965,6254,1888645,210472,2596,1840,78000.0,1000.0,-67.0,-63.0,-67.0,-70.0,-67.0,-63.0,-67.0,-69.0,-79.0,-85.0,-77.0,-82.0,12.0,22.0,10.0,12.0,1
1762,CC:2F:71:3E:C5:1F,5529996,4451709530,3406902,4182258920,2123094,269450610,502,93193,7999290,78596,6269204,14597,1730086,21541,533,3414298,870692,502,2927,6500.0,1000.0,-70.0,-72.0,-66.0,-61.0,-71.0,-72.0,-67.0,-61.0,-79.0,-85.0,-77.0,-82.0,9.0,13.0,11.0,21.0,1
1763,F8:59:71:5A:E0:3D,3445853,2251752492,1322753,1982301276,2123100,269451216,294,749055,914771600,748365,914688535,690,83065,737702,1840,1322882,164769,294,1134,144444.0,43333.0,-67.0,-72.0,-63.0,-71.0,-66.0,-72.0,-63.0,-70.0,-79.0,-85.0,-77.0,-82.0,12.0,13.0,14.0,11.0,1
1764,CC:2F:71:3F:1F:24,4012058,2765284373,1888958,2495833157,2123100,269451216,2596,1540734,1974458742,1539621,1974332786,1113,125956,1523116,6254,1888814,210593,2596,1841,72222.0,21667.0,-67.0,-63.0,-67.0,-69.0,-67.0,-63.0,-68.0,-70.0,-79.0,-85.0,-77.0,-82.0,12.0,22.0,10.0,13.0,1
1765,CC:2F:71:3E:C5:1F,5530002,4451710136,3406902,4182258920,2123100,269451216,502,93193,7999290,78596,6269204,14597,1730086,21541,533,3414298,870692,502,2927,6500.0,1000.0,-70.0,-72.0,-66.0,-61.0,-71.0,-72.0,-67.0,-61.0,-79.0,-85.0,-77.0,-82.0,9.0,13.0,11.0,21.0,1
1766,F8:59:71:5A:E0:3D,3446120,2252166604,1323019,1982715328,2123101,269451276,294,749164,914881541,748474,914798476,690,83065,737811,1840,1323148,164794,294,1134,144444.0,43333.0,-66.0,-72.0,-63.0,-70.0,-66.0,-71.0,-63.0,-70.0,-79.0,-85.0,-77.0,-82.0,13.0,13.0,14.0,12.0,1
1767,CC:2F:71:3F:1F:24,4012225,2765501221,1889124,2496049945,2123101,269451276,2596,1540887,1974669900,1539774,1974543944,1113,125956,1523268,6254,1888981,210721,2596,1841,65000.0,1000.0,-67.0,-63.0,-68.0,-70.0,-66.0,-63.0,-66.0,-69.0,-79.0,-86.0,-78.0,-83.0,12.0,23.0,10.0,13.0,1
1768,CC:2F:71:3E:C5:1F,5530003,4451710196,3406902,4182258920,2123101,269451276,502,93193,7999290,78596,6269204,14597,1730086,21541,533,3414298,870692,502,2927,6500.0,1000.0,-70.0,-72.0,-66.0,-61.0,-71.0,-72.0,-67.0,-61.0,-79.0,-86.0,-78.0,-83.0,9.0,14.0,12.0,22.0,1
1769,F8:59:71:5A:E0:3D,3446393,2252543500,1323284,1983091416,2123109,269452084,294,749268,914993900,748578,914910835,690,83065,737915,1840,1323413,164886,294,1134,144444.0,43333.0,-68.0,-73.0,-65.0,-72.0,-67.0,-72.0,-64.0,-71.0,-79.0,-86.0,-78.0,-83.0,11.0,13.0,13.0,11.0,1
1770,CC:2F:71:3F:1F:24,4012403,2765725017,1889294,2496272933,2123109,269452084,2596,1541041,1974883924,1539928,1974757968,1113,125956,1523422,6254,1889149,210868,2596,1841,72222.0,21667.0,-66.0,-63.0,-67.0,-70.0,-68.0,-63.0,-71.0,-70.0,-79.0,-86.0,-78.0,-83.0,13.0,23.0,11.0,13.0,1
1771,CC:2F:71:3E:C5:1F,5530011,4451711004,3406902,4182258920,2123109,269452084,502,93193,7999290,78596,6269204,14597,1730086,21541,533,3414298,870692,502,2927,6500.0,1000.0,-70.0,-72.0,-66.0,-61.0,-71.0,-72.0,-67.0,-61.0,-79.0,-86.0,-78.0,-83.0,9.0,14.0,12.0,22.0,1
1772,F8:59:71:5A:E0:3D,3446463,2252650786,1323353,1983198642,2123110,269452144,294,749337,915100272,748647,915017207,690,83065,737984,1840,1323482,164890,294,1134,144444.0,43333.0,-68.0,-72.0,-65.0,-72.0,-66.0,-71.0,-64.0,-70.0,-79.0,-86.0,-78.0,-83.0,11.0,14.0,13.0,11.0,1
1773,CC:2F:71:3F:1F:24,4012577,2765949131,1889467,2496496987,2123110,269452144,2596,1541202,1975101600,1540089,1974975644,1113,125956,1523583,6254,1889321,210965,2596,1841,86667.0,1000.0,-67.0,-63.0,-68.0,-70.0,-66.0,-63.0,-67.0,-69.0,-79.0,-86.0,-78.0,-83.0,12.0,23.0,10.0,13.0,1
1774,CC:2F:71:3E:C5:1F,5530012,4451711064,3406902,4182258920,2123110,269452144,502,93193,7999290,78596,6269204,14597,1730086,21541,533,3414298,870692,502,2927,6500.0,1000.0,-70.0,-72.0,-66.0,-61.0,-71.0,-72.0,-67.0,-61.0,-79.0,-86.0,-78.0,-83.0,9.0,14.0,12.0,22.0,1
1775,F8:59:71:5A:E0:3D,3446534,2252752402,1323418,1983299652,2123116,269452750,294,749402,915200372,748712,915117307,690,83065,738049,1840,1323547,164899,294,1134,144444.0,43333.0,-68.0,-73.0,-65.0,-72.0,-67.0,-72.0,-64.0,-71.0,-79.0,-86.0,-78.0,-83.0,11.0,13.0,13.0,11.0,1
1776,CC:2F:71:3F:1F:24,4012745,2766157459,1889627,2496704507,2123118,269452952,2596,1541349,1975301996,1540236,1975176040,1113,125956,1523730,6254,1889486,211073,2596,1841,86667.0,14444.0,-66.0,-63.0,-67.0,-69.0,-67.0,-63.0,-69.0,-69.0,-79.0,-86.0,-78.0,-83.0,13.0,23.0,11.0,14.0,1
1777,CC:2F:71:3E:C5:1F,5530020,4451711872,3406902,4182258920,2123118,269452952,502,93193,7999290,78596,6269204,14597,1730086,21541,533,3414298,870692,502,2927,6500.0,1000.0,-70.0,-72.0,-66.0,-61.0,-71.0,-72.0,-67.0,-61.0,-79.0,-86.0,-78.0,-83.0,9.0,14.0,12.0,22.0,1
1778,F8:59:71:5A:E0:3D,3446717,2253032658,1323599,1983579706,2123118,269452952,294,749488,915303461,748798,915220396,690,83065,738135,1840,1323728,164946,294,1135,144444.0,43333.0,-68.0,-73.0,-65.0,-72.0,-67.0,-72.0,-63.0,-70.0,-79.0,-86.0,-78.0,-83.0,11.0,13.0,13.0,11.0,1
1779,CC:2F:71:3F:1F:24,4012907,2766366880,1889789,2496913928,2123118,269452952,2596,1541497,1975502793,1540384,1975376837,1113,125956,1523878,6254,1889650,211131,2596,1841,86667.0,14444.0,-69.0,-64.0,-73.0,-72.0,-67.0,-63.0,-68.0,-70.0,-79.0,-86.0,-78.0,-83.0,10.0,22.0,5.0,11.0,1
1780,CC:2F:71:3E:C5:1F,5530020,4451711872,3406902,4182258920,2123118,269452952,502,93193,7999290,78596,6269204,14597,1730086,21541,533,3414298,870692,502,2927,6500.0,1000.0,-70.0,-72.0,-66.0,-61.0,-71.0,-72.0,-67.0,-61.0,-79.0,-86.0,-78.0,-83.0,9.0,14.0,12.0,22.0,1
1781,F8:59:71:5A:E0:3D,3446801,2253148778,1323676,1983695160,2123125,269453618,294,749569,915424422,748879,915341357,690,83065,738214,1840,1323805,164952,294,1135,144444.0,43333.0,-66.0,-72.0,-63.0,-70.0,-66.0,-72.0,-63.0,-70.0,-79.0,-86.0,-78.0,-83.0,13.0,14.0,15.0,13.0,1
1782,CC:2F:71:3F:1F:24,4013096,2766603588,1889969,2497149768,2123127,269453820,2596,1541662,1975729509,1540549,1975603553,1113,125956,1524043,6254,1889831,211299,2596,1841,86667.0,14444.0,-69.0,-63.0,-73.0,-71.0,-68.0,-63.0,-71.0,-70.0,-79.0,-86.0,-78.0,-83.0,10.0,23.0,5.0,12.0,1
1783,CC:2F:71:3E:C5:1F,5530029,4451712740,3406902,4182258920,2123127,269453820,502,93193,7999290,78596,6269204,14597,1730086,21541,533,3414298,870692,502,2927,6500.0,1000.0,-70.0,-72.0,-66.0,-61.0,-71.0,-72.0,-67.0,-61.0,-79.0,-86.0,-78.0,-83.0,9.0,14.0,12.0,22.0,1
1784,F8:59:71:5A:E0:3D,3446869,2253251544,1323742,1983797724,2123127,269453820,294,749634,915524620,748944,915441555,690,83065,738279,1840,1323871,164961,294,1135,144444.0,43333.0,-65.0,-71.0,-64.0,-70.0,-66.0,-71.0,-63.0,-70.0,-79.0,-86.0,-78.0,-83.0,14.0,15.0,14.0,13.0,1
1785,CC:2F:71:3F:1F:24,4013259,2766817810,1890132,2497363990,2123127,269453820,2596,1541812,1975935991,1540699,1975810035,1113,125956,1524193,6254,1889994,211411,2596,1841,86667.0,1000.0,-67.0,-63.0,-68.0,-70.0,-67.0,-63.0,-67.0,-69.0,-79.0,-86.0,-78.0,-83.0,12.0,23.0,10.0,13.0,1
1786,CC:2F:71:3E:C5:1F,5530029,4451712740,3406902,4182258920,2123127,269453820,502,93193,7999290,78596,6269204,14597,1730086,21541,533,3414298,870692,502,2927,6500.0,1000.0,-70.0,-72.0,-66.0,-61.0,-71.0,-72.0,-67.0,-61.0,-79.0,-86.0,-78.0,-83.0,9.0,14.0,12.0,22.0,1
1787,F8:59:71:5A:E0:3D,3446942,2253356268,1323809,1983901842,2123133,269454426,294,749702,915629340,749012,915546275,690,83065,738347,1840,1323938,164970,294,1135,144444.0,43333.0,-68.0,-72.0,-65.0,-72.0,-67.0,-72.0,-64.0,-71.0,-79.0,-86.0,-78.0,-82.0,11.0,14.0,13.0,10.0,1
1788,CC:2F:71:3F:1F:24,4013460,2767055734,1890325,2497601106,2123135,269454628,2596,1541991,1976168734,1540878,1976042778,1113,125956,1524371,6254,1890189,211566,2596,1841,86667.0,14444.0,-69.0,-64.0,-73.0,-71.0,-68.0,-63.0,-71.0,-70.0,-79.0,-86.0,-78.0,-82.0,10.0,22.0,5.0,11.0,1
1789,CC:2F:71:3E:C5:1F,5530037,4451713548,3406902,4182258920,2123135,269454628,502,93193,7999290,78596,6269204,14597,1730086,21541,533,3414298,870692,502,2927,6500.0,1000.0,-70.0,-72.0,-66.0,-61.0,-71.0,-72.0,-67.0,-61.0,-79.0,-86.0,-78.0,-82.0,9.0,14.0,12.0,21.0,1
1790,F8:59:71:5A:E0:3D,3447017,2253466980,1323881,1984012292,2123136,269454688,294,749774,915738786,749084,915655721,690,83065,738419,1840,1324010,164985,294,1135,144444.0,43333.0,-66.0,-72.0,-64.0,-71.0,-67.0,-71.0,-64.0,-71.0,-79.0,-86.0,-78.0,-82.0,13.0,14.0,14.0,11.0,1
1791,CC:2F:71:3F:1F:24,4013625,2767270034,1890489,2497815346,2123136,269454688,2596,1542141,1976375230,1541028,1976249274,1113,125956,1524521,6254,1890354,211667,2596,1841,86667.0,14444.0,-67.0,-63.0,-67.0,-70.0,-67.0,-63.0,-68.0,-69.0,-79.0,-86.0,-78.0,-82.0,12.0,23.0,11.0,12.0,1
1792,CC:2F:71:3E:C5:1F,5530038,4451713608,3406902,4182258920,2123136,269454688,502,93193,7999290,78596,6269204,14597,1730086,21541,533,3414298,870692,502,2927,6500.0,1000.0,-70.0,-72.0,-66.0,-61.0,-71.0,-72.0,-67.0,-61.0,-79.0,-86.0,-78.0,-82.0,9.0,14.0,12.0,21.0,1
1793,F8:59:71:5A:E0:3D,3447245,2253812432,1324103,1984357138,2123142,269455294,294,749872,915846135,749182,915763070,690,83065,738517,1840,1324232,164996,294,1135,144444.0,43333.0,-66.0,-71.0,-64.0,-70.0,-67.0,-72.0,-64.0,-71.0,-79.0,-86.0,-78.0,-82.0,13.0,15.0,14.0,12.0,1
1794,CC:2F:71:3F:1F:24,4013795,2767484936,1890653,2498029642,2123142,269455294,2596,1542291,1976581698,1541178,1976455742,1113,125956,1524671,6254,1890515,211763,2596,1841,86667.0,1000.0,-67.0,-63.0,-67.0,-70.0,-67.0,-63.0,-68.0,-70.0,-79.0,-86.0,-78.0,-82.0,12.0,23.0,11.0,12.0,1
1795,CC:2F:71:3E:C5:1F,5530046,4451714416,3406902,4182258920,2123144,269455496,502,93193,7999290,78596,6269204,14597,1730086,21541,533,3414298,870692,502,2927,6500.0,1000.0,-70.0,-72.0,-66.0,-61.0,-71.0,-72.0,-67.0,-61.0,-79.0,-86.0,-78.0,-82.0,9.0,14.0,12.0,21.0,1
1796,F8:59:71:5A:E0:3D,3447554,2254245079,1324408,1984789250,2123146,269455829,294,750010,915967673,749320,915884608,690,83065,738654,1840,1324537,165069,294,1135,144444.0,43333.0,-66.0,-71.0,-63.0,-69.0,-66.0,-72.0,-64.0,-70.0,-78.0,-85.0,-77.0,-81.0,12.0,14.0,14.0,12.0,1
1797,CC:2F:71:3F:1F:24,4013963,2767699879,1890817,2498244050,2123146,269455829,2596,1542441,1976788250,1541328,1976662294,1113,125956,1524821,6254,1890680,211879,2596,1841,86667.0,13000.0,-67.0,-63.0,-67.0,-70.0,-67.0,-63.0,-68.0,-69.0,-78.0,-85.0,-77.0,-81.0,11.0,22.0,10.0,11.0,1
1798,CC:2F:71:3E:C5:1F,5530048,4451714749,3406902,4182258920,2123146,269455829,502,93193,7999290,78596,6269204,14597,1730086,21541,533,3414298,870692,502,2927,6500.0,1000.0,-70.0,-72.0,-66.0,-61.0,-71.0,-72.0,-67.0,-61.0,-78.0,-85.0,-77.0,-81.0,8.0,13.0,11.0,20.0,1
1799,F8:59:71:5A:E0:3D,3447622,2254344883,1324472,1984888650,2123150,269456233,294,750072,916063181,749382,915980116,690,83065,738714,1840,1324601,165075,294,1135,130000.0,39000.0,-67.0,-72.0,-63.0,-70.0,-67.0,-72.0,-64.0,-71.0,-78.0,-85.0,-77.0,-81.0,11.0,13.0,14.0,11.0,1
1800,CC:2F:71:3F:1F:24,4014164,2767924270,1891014,2498468037,2123150,269456233,2596,1542615,1976997350,1541502,1976871394,1113,125956,1524995,6254,1890879,211986,2596,1841,86667.0,14444.0,-69.0,-64.0,-71.0,-71.0,-67.0,-63.0,-69.0,-70.0,-78.0,-85.0,-77.0,-81.0,9.0,21.0,6.0,10.0,1
1801,CC:2F:71:3E:C5:1F,5530054,4451715355,3406902,4182258920,2123152,269456435,502,93193,7999290,78596,6269204,14597,1730086,21541,533,3414298,870692,502,2927,6500.0,1000.0,-70.0,-72.0,-66.0,-61.0,-71.0,-72.0,-67.0,-61.0,-78.0,-85.0,-77.0,-81.0,8.0,13.0,11.0,20.0,1
1802,F8:59:71:5A:E0:3D,3447706,2254452669,1324552,1984996032,2123154,269456637,294,750149,916174664,749459,916091599,690,83065,738791,1840,1324681,165088,294,1139,144444.0,43333.0,-65.0,-71.0,-64.0,-70.0,-67.0,-72.0,-64.0,-70.0,-78.0,-85.0,-77.0,-81.0,13.0,14.0,13.0,11.0,1
1803,CC:2F:71:3F:1F:24,4014360,2768152784,1891206,2498696147,2123154,269456637,2596,1542789,1977218144,1541676,1977092188,1113,125956,1525169,6254,1891071,212082,2596,1841,86667.0,14444.0,-66.0,-63.0,-67.0,-69.0,-67.0,-63.0,-69.0,-70.0,-78.0,-85.0,-77.0,-81.0,12.0,22.0,10.0,12.0,1
1804,CC:2F:71:3E:C5:1F,5530057,4451715673,3406903,4182259036,2123154,269456637,502,93193,7999290,78596,6269204,14597,1730086,21541,533,3414299,870692,502,2927,7222.0,1000.0,-70.0,-72.0,-66.0,-61.0,-71.0,-72.0,-67.0,-61.0,-78.0,-85.0,-77.0,-82.0,8.0,13.0,11.0,21.0,1
1805,F8:59:71:5A:E0:3D,3447777,2254554643,1324618,1985097542,2123159,269457101,294,750217,916277994,749527,916194929,690,83065,738859,1840,1324747,165097,294,1139,144444.0,43333.0,-68.0,-73.0,-65.0,-72.0,-67.0,-72.0,-64.0,-71.0,-78.0,-85.0,-77.0,-82.0,10.0,12.0,12.0,10.0,1
1806,CC:2F:71:3F:1F:24,4014526,2768364026,1891367,2498906925,2123159,269457101,2596,1542936,1977421458,1541823,1977295502,1113,125956,1525316,6254,1891232,212182,2596,1841,86667.0,14444.0,-67.0,-63.0,-67.0,-70.0,-67.0,-63.0,-68.0,-70.0,-78.0,-85.0,-77.0,-82.0,11.0,22.0,10.0,12.0,1
1807,CC:2F:71:3E:C5:1F,5530062,4451716137,3406903,4182259036,2123159,269457101,502,93193,7999290,78596,6269204,14597,1730086,21541,533,3414299,870692,502,2927,7222.0,1000.0,-70.0,-72.0,-66.0,-61.0,-71.0,-72.0,-67.0,-61.0,-78.0,-85.0,-77.0,-82.0,8.0,13.0,11.0,21.0,1
1808,F8:59:71:5A:E0:3D,3447847,2254656119,1324683,1985198552,2123164,269457567,294,750283,916379648,749593,916296583,690,83065,738924,1840,1324812,165108,294,1139,144444.0,43333.0,-67.0,-72.0,-63.0,-69.0,-67.0,-71.0,-64.0,-71.0,-78.0,-85.0,-77.0,-82.0,11.0,13.0,14.0,13.0,1
1809,CC:2F:71:3F:1F:24,4014694,2768576254,1891530,2499118687,2123164,269457567,2596,1543083,1977621854,1541970,1977495898,1113,125956,1525463,6254,1891395,212292,2596,1841,86667.0,14444.0,-67.0,-63.0,-69.0,-69.0,-68.0,-63.0,-71.0,-70.0,-78.0,-85.0,-77.0,-82.0,11.0,22.0,8.0,13.0,1
1810,CC:2F:71:3E:C5:1F,5530067,4451716603,3406903,4182259036,2123164,269457567,502,93194,7999408,78596,6269204,14598,1730204,21542,533,3414299,870692,502,2927,7222.0,1000.0,-70.0,-73.0,-66.0,-61.0,-71.0,-72.0,-67.0,-61.0,-78.0,-85.0,-77.0,-82.0,8.0,12.0,11.0,21.0,1
1811,F8:59:71:5A:E0:3D,3447922,2254758452,1324754,1985300481,2123168,269457971,294,750351,916480115,749661,916397050,690,83065,738992,1840,1324883,165119,294,1139,144444.0,43333.0,-67.0,-72.0,-64.0,-70.0,-66.0,-72.0,-64.0,-70.0,-79.0,-86.0,-78.0,-83.0,12.0,14.0,14.0,13.0,1
1812,CC:2F:71:3F:1F:24,4014861,2768786888,1891693,2499328917,2123168,269457971,2596,1543235,1977827319,1542122,1977701363,1113,125956,1525615,6254,1891557,212384,2596,1841,78000.0,13000.0,-66.0,-64.0,-67.0,-70.0,-67.0,-63.0,-69.0,-70.0,-79.0,-86.0,-78.0,-83.0,13.0,22.0,11.0,13.0,1
1813,CC:2F:71:3E:C5:1F,5530071,4451717007,3406903,4182259036,2123168,269457971,502,93194,7999408,78596,6269204,14598,1730204,21542,533,3414299,870692,502,2927,7222.0,1000.0,-70.0,-73.0,-66.0,-61.0,-71.0,-72.0,-67.0,-61.0,-79.0,-86.0,-78.0,-83.0,9.0,13.0,12.0,22.0,1
1814,F8:59:71:5A:E0:3D,3447992,2254859926,1324819,1985401491,2123173,269458435,294,750417,916581755,749727,916498690,690,83065,739058,1840,1324948,165121,294,1139,144444.0,43333.0,-66.0,-72.0,-64.0,-70.0,-66.0,-72.0,-63.0,-70.0,-79.0,-86.0,-78.0,-83.0,13.0,14.0,14.0,13.0,1
1815,CC:2F:71:3F:1F:24,4015030,2769002840,1891857,2499544405,2123173,269458435,2596,1543385,1978033899,1542272,1977907943,1113,125956,1525765,6254,1891722,212481,2596,1841,86667.0,14444.0,-67.0,-63.0,-67.0,-70.0,-67.0,-63.0,-68.0,-70.0,-79.0,-86.0,-78.0,-83.0,12.0,23.0,11.0,13.0,1
1816,CC:2F:71:3E:C5:1F,5530076,4451717471,3406903,4182259036,2123173,269458435,502,93194,7999408,78596,6269204,14598,1730204,21542,533,3414299,870692,502,2927,7222.0,1000.0,-70.0,-73.0,-66.0,-61.0,-71.0,-72.0,-67.0,-61.0,-79.0,-86.0,-78.0,-83.0,9.0,13.0,12.0,22.0,1
1817,F8:59:71:5A:E0:3D,3448145,2255093175,1324970,1985634538,2123175,269458637,294,750510,916688416,749820,916605351,690,83065,739151,1840,1325099,165128,294,1139,144444.0,43333.0,-68.0,-72.0,-65.0,-72.0,-67.0,-72.0,-64.0,-71.0,-79.0,-86.0,-78.0,-83.0,11.0,14.0,13.0,11.0,1
1818,CC:2F:71:3F:1F:24,4015194,2769211716,1892017,2499752877,2123177,269458839,2596,1543532,1978234323,1542419,1978108367,1113,125956,1525912,6254,1891882,212548,2596,1841,86667.0,14444.0,-69.0,-64.0,-73.0,-71.0,-68.0,-64.0,-71.0,-70.0,-79.0,-86.0,-78.0,-83.0,10.0,22.0,5.0,12.0,1
1819,CC:2F:71:3E:C5:1F,5530080,4451717875,3406903,4182259036,2123177,269458839,502,93194,7999408,78596,6269204,14598,1730204,21542,533,3414299,870692,502,2927,7222.0,1000.0,-70.0,-73.0,-66.0,-61.0,-71.0,-72.0,-67.0,-61.0,-79.0,-86.0,-78.0,-83.0,9.0,13.0,12.0,22.0,1
1820,F8:59:71:5A:E0:3D,3448382,2255405576,1325201,1985946333,2123181,269459243,294,750611,916797327,749921,916714262,690,83065,739252,1840,1325330,165193,294,1139,144444.0,43333.0,-66.0,-72.0,-64.0,-70.0,-67.0,-72.0,-64.0,-70.0,-78.0,-85.0,-77.0,-82.0,12.0,13.0,13.0,12.0,1
1821,CC:2F:71:3F:1F:24,4015369,2769428943,1892188,2499969700,2123181,269459243,2596,1543687,1978447173,1542574,1978321217,1113,125956,1526067,6254,1892053,212622,2596,1841,86667.0,14444.0,-67.0,-63.0,-67.0,-70.0,-68.0,-63.0,-68.0,-71.0,-78.0,-85.0,-77.0,-82.0,11.0,22.0,10.0,12.0,1
1822,CC:2F:71:3E:C5:1F,5530084,4451718279,3406903,4182259036,2123181,269459243,502,93194,7999408,78596,6269204,14598,1730204,21542,533,3414299,870692,502,2927,7222.0,1000.0,-70.0,-73.0,-66.0,-61.0,-71.0,-72.0,-67.0,-61.0,-78.0,-85.0,-77.0,-82.0,8.0,12.0,11.0,21.0,1
1823,F8:59:71:5A:E0:3D,3448455,2255510414,1325271,1986050909,2123184,269459505,294,750681,916901320,749991,916818255,690,83065,739322,1840,1325400,165207,294,1139,144444.0,43333.0,-66.0,-73.0,-64.0,-70.0,-67.0,-72.0,-64.0,-70.0,-78.0,-85.0,-77.0,-82.0,12.0,12.0,13.0,12.0,1
1824,CC:2F:71:3F:1F:24,4015534,2769638112,1892350,2500178607,2123184,269459505,2596,1543839,1978651046,1542726,1978525090,1113,125956,1526218,6254,1892217,212754,2596,1841,78000.0,13000.0,-66.0,-63.0,-66.0,-69.0,-65.0,-62.0,-66.0,-68.0,-78.0,-85.0,-77.0,-82.0,12.0,22.0,11.0,13.0,1
1825,CC:2F:71:3E:C5:1F,5530087,4451718541,3406903,4182259036,2123184,269459505,502,93195,7999478,78597,6269274,14598,1730204,21542,533,3414299,870692,502,2927,7222.0,1000.0,-69.0,-72.0,-66.0,-61.0,-71.0,-72.0,-67.0,-61.0,-78.0,-85.0,-77.0,-82.0,9.0,13.0,11.0,21.0,1
1826,F8:59:71:5A:E0:3D,3448525,2255609038,1325335,1986148927,2123190,269460111,294,750746,916999986,750056,916916921,690,83065,739387,1840,1325464,165211,294,1139,144444.0,43333.0,-69.0,-73.0,-66.0,-71.0,-67.0,-72.0,-64.0,-70.0,-78.0,-85.0,-77.0,-82.0,9.0,12.0,11.0,11.0,1
1827,CC:2F:71:3F:1F:24,4015699,2769845916,1892509,2500385805,2123190,269460111,2596,1543984,1978849786,1542871,1978723830,1113,125956,1526363,6254,1892376,212772,2596,1841,86667.0,14444.0,-66.0,-63.0,-67.0,-68.0,-67.0,-63.0,-68.0,-68.0,-78.0,-85.0,-77.0,-82.0,12.0,22.0,10.0,14.0,1
1828,CC:2F:71:3E:C5:1F,5530093,4451719147,3406903,4182259036,2123190,269460111,502,93195,7999478,78597,6269274,14598,1730204,21542,533,3414299,870692,502,2927,7222.0,1000.0,-69.0,-72.0,-66.0,-61.0,-71.0,-72.0,-67.0,-61.0,-78.0,-85.0,-77.0,-82.0,9.0,13.0,11.0,21.0,1
1829,F8:59:71:5A:E0:3D,3448587,2255705274,1325397,1986245163,2123190,269460111,294,750808,917095466,750118,917012401,690,83065,739449,1840,1325526,165222,294,1139,144444.0,43333.0,-68.0,-73.0,-65.0,-72.0,-67.0,-72.0,-64.0,-70.0,-78.0,-85.0,-77.0,-82.0,10.0,12.0,12.0,10.0,1
1830,CC:2F:71:3F:1F:24,4015862,2770053284,1892672,2500593173,2123190,269460111,2596,1544130,1979047355,1543017,1978921399,1113,125956,1526509,6254,1892539,212850,2596,1841,130000.0,39000.0,-68.0,-63.0,-67.0,-69.0,-69.0,-63.0,-68.0,-68.0,-78.0,-85.0,-77.0,-82.0,10.0,22.0,10.0,13.0,1
1831,CC:2F:71:3E:C5:1F,5530096,4451719409,3406903,4182259036,2123193,269460373,502,93195,7999478,78597,6269274,14598,1730204,21542,533,3414299,870692,502,2927,7222.0,1000.0,-69.0,-72.0,-66.0,-61.0,-71.0,-72.0,-67.0,-61.0,-78.0,-85.0,-77.0,-82.0,9.0,13.0,11.0,21.0,1
1832,F8:59:71:5A:E0:3D,3448660,2255806788,1325462,1986345949,2123198,269460839,294,750873,917195580,750183,917112515,690,83065,739513,1840,1325591,165229,294,1139,144444.0,43333.0,-67.0,-72.0,-63.0,-69.0,-67.0,-72.0,-64.0,-70.0,-78.0,-85.0,-77.0,-82.0,11.0,13.0,14.0,13.0,1
1833,CC:2F:71:3F:1F:24,4016030,2770260722,1892830,2500799681,2123200,269461041,2596,1544275,1979247661,1543161,1979121587,1114,126074,1526653,6254,1892696,212957,2596,1841,86667.0,14444.0,-67.0,-63.0,-67.0,-68.0,-69.0,-63.0,-70.0,-69.0,-78.0,-85.0,-77.0,-82.0,11.0,22.0,10.0,14.0,1
1834,CC:2F:71:3E:C5:1F,5530103,4451720077,3406903,4182259036,2123200,269461041,502,93195,7999478,78597,6269274,14598,1730204,21542,533,3414299,870692,502,2927,7222.0,1000.0,-69.0,-72.0,-66.0,-61.0,-71.0,-72.0,-67.0,-61.0,-78.0,-85.0,-77.0,-82.0,9.0,13.0,11.0,21.0,1
1835,F8:59:71:5A:E0:3D,3448934,2256230018,1325734,1986768977,2123200,269461041,294,750992,917303833,750302,917220768,690,83065,739632,1840,1325862,165253,294,1139,144444.0,43333.0,-67.0,-72.0,-64.0,-70.0,-67.0,-72.0,-64.0,-70.0,-78.0,-85.0,-77.0,-82.0,11.0,13.0,13.0,12.0,1
1836,CC:2F:71:3F:1F:24,4016189,2770468448,1892989,2501007407,2123200,269461041,2596,1544420,1979446401,1543306,1979320327,1114,126074,1526798,6254,1892856,213051,2596,1841,86667.0,13000.0,-68.0,-63.0,-68.0,-69.0,-68.0,-63.0,-69.0,-69.0,-78.0,-85.0,-77.0,-82.0,10.0,22.0,9.0,13.0,1
1837,CC:2F:71:3E:C5:1F,5530104,4451720350,3406903,4182259036,2123201,269461314,502,93195,7999478,78597,6269274,14598,1730204,21542,533,3414299,870692,502,2927,7222.0,1000.0,-69.0,-72.0,-66.0,-61.0,-71.0,-72.0,-67.0,-61.0,-78.0,-85.0,-77.0,-82.0,9.0,13.0,11.0,21.0,1
1838,F8:59:71:5A:E0:3D,3449003,2256328659,1325797,1986866879,2123206,269461780,294,751057,917402511,750366,917319328,691,83183,739697,1840,1325926,165256,294,1139,144444.0,43333.0,-65.0,-72.0,-65.0,-70.0,-66.0,-72.0,-64.0,-69.0,-78.0,-85.0,-77.0,-82.0,13.0,13.0,12.0,12.0,1
1839,CC:2F:71:3F:1F:24,4016357,2770676087,1893148,2501214045,2123209,269462042,2596,1544565,1979645141,1543451,1979519067,1114,126074,1526943,6254,1893017,213150,2596,1841,86667.0,14444.0,-68.0,-63.0,-67.0,-68.0,-69.0,-63.0,-69.0,-69.0,-78.0,-85.0,-77.0,-82.0,10.0,22.0,10.0,14.0,1
1840,CC:2F:71:3E:C5:1F,5530112,4451721078,3406903,4182259036,2123209,269462042,502,93195,7999478,78597,6269274,14598,1730204,21542,533,3414299,870692,502,2927,7222.0,1000.0,-69.0,-72.0,-66.0,-61.0,-71.0,-72.0,-67.0,-61.0,-78.0,-85.0,-77.0,-82.0,9.0,13.0,11.0,21.0,1
1841,F8:59:71:5A:E0:3D,3449240,2256639704,1326029,1987177460,2123211,269462244,294,751157,917508470,750466,917425287,691,83183,739797,1840,1326158,165260,294,1139,144444.0,43333.0,-69.0,-73.0,-65.0,-71.0,-67.0,-72.0,-64.0,-70.0,-79.0,-86.0,-78.0,-83.0,10.0,13.0,13.0,12.0,1
1842,CC:2F:71:3F:1F:24,4016521,2770888093,1893310,2501425849,2123211,269462244,2596,1544714,1979850041,1543600,1979723967,1114,126074,1527092,6254,1893179,213203,2596,1841,86667.0,14444.0,-68.0,-64.0,-67.0,-69.0,-69.0,-63.0,-67.0,-68.0,-79.0,-86.0,-78.0,-83.0,11.0,22.0,11.0,14.0,1
1843,CC:2F:71:3E:C5:1F,5530114,4451721280,3406903,4182259036,2123211,269462244,502,93195,7999478,78597,6269274,14598,1730204,21542,533,3414299,870692,502,2927,7222.0,1000.0,-69.0,-72.0,-66.0,-61.0,-71.0,-72.0,-67.0,-61.0,-79.0,-86.0,-78.0,-83.0,10.0,14.0,12.0,22.0,1
1844,F8:59:71:5A:E0:3D,3449307,2256737898,1326092,1987275250,2123215,269462648,294,751221,917607030,750530,917523847,691,83183,739861,1840,1326221,165270,294,1139,144444.0,43333.0,-68.0,-73.0,-65.0,-71.0,-66.0,-72.0,-64.0,-70.0,-79.0,-86.0,-78.0,-83.0,11.0,13.0,13.0,12.0,1
1845,CC:2F:71:3F:1F:24,4016685,2771097137,1893470,2501634489,2123215,269462648,2596,1544861,1980050437,1543747,1979924363,1114,126074,1527239,6254,1893339,213258,2596,1841,86667.0,14444.0,-72.0,-64.0,-71.0,-70.0,-70.0,-63.0,-68.0,-69.0,-79.0,-86.0,-78.0,-83.0,7.0,22.0,7.0,13.0,1
1846,CC:2F:71:3E:C5:1F,5530120,4451721886,3406903,4182259036,2123217,269462850,502,93195,7999478,78597,6269274,14598,1730204,21542,533,3414299,870692,502,2927,7222.0,1000.0,-69.0,-72.0,-66.0,-61.0,-71.0,-72.0,-67.0,-61.0,-79.0,-86.0,-78.0,-83.0,10.0,14.0,12.0,22.0,1
1847,F8:59:71:5A:E0:3D,3449380,2256844034,1326160,1987380922,2123220,269463112,294,751288,917710210,750597,917627027,691,83183,739928,1840,1326289,165279,294,1139,144444.0,43333.0,-66.0,-72.0,-63.0,-70.0,-66.0,-72.0,-63.0,-69.0,-79.0,-86.0,-78.0,-83.0,13.0,14.0,15.0,13.0,1
1848,CC:2F:71:3F:1F:24,4016856,2771315061,1893636,2501851949,2123220,269463112,2596,1545012,1980259841,1543898,1980133767,1114,126074,1527390,6254,1893505,213374,2596,1841,130000.0,39000.0,-69.0,-63.0,-67.0,-68.0,-68.0,-63.0,-66.0,-67.0,-79.0,-86.0,-78.0,-83.0,10.0,23.0,11.0,15.0,1
1849,CC:2F:71:3E:C5:1F,5530123,4451722148,3406903,4182259036,2123220,269463112,502,93195,7999478,78597,6269274,14598,1730204,21542,533,3414299,870692,502,2927,7222.0,1000.0,-69.0,-72.0,-66.0,-61.0,-71.0,-72.0,-67.0,-61.0,-79.0,-86.0,-78.0,-83.0,10.0,14.0,12.0,22.0,1
1850,F8:59:71:5A:E0:3D,3449456,2256956326,1326232,1987492810,2123224,269463516,294,751360,917821090,750669,917737907,691,83183,740000,1840,1326360,165284,294,1139,144444.0,43333.0,-67.0,-72.0,-64.0,-70.0,-66.0,-72.0,-64.0,-69.0,-79.0,-86.0,-78.0,-83.0,12.0,14.0,14.0,13.0,1
1851,CC:2F:71:3F:1F:24,4017053,2771555416,1893829,2502091900,2123224,269463516,2596,1545187,1980492163,1544073,1980366089,1114,126074,1527565,6254,1893699,213594,2596,1841,86667.0,13000.0,-67.0,-63.0,-67.0,-70.0,-67.0,-63.0,-67.0,-69.0,-79.0,-86.0,-78.0,-83.0,12.0,23.0,11.0,13.0,1
1852,CC:2F:71:3E:C5:1F,5530129,4451722754,3406903,4182259036,2123226,269463718,502,93197,7999618,78599,6269414,14598,1730204,21542,533,3414300,870692,502,2927,7222.0,1000.0,-69.0,-73.0,-66.0,-61.0,-70.0,-72.0,-66.0,-61.0,-79.0,-86.0,-78.0,-83.0,10.0,13.0,12.0,22.0,1
1853,F8:59:71:5A:E0:3D,3449526,2257059294,1326298,1987595374,2123228,269463920,294,751427,917924382,750736,917841199,691,83183,740066,1840,1326426,165300,294,1139,144444.0,43333.0,-67.0,-72.0,-63.0,-70.0,-66.0,-71.0,-63.0,-70.0,-79.0,-86.0,-78.0,-83.0,12.0,14.0,15.0,13.0,1
1854,CC:2F:71:3F:1F:24,4017213,2771757628,1893985,2502293708,2123228,269463920,2596,1545334,1980695435,1544220,1980569361,1114,126074,1527712,6254,1893854,213718,2596,1841,86667.0,14444.0,-67.0,-63.0,-68.0,-70.0,-68.0,-63.0,-69.0,-70.0,-79.0,-86.0,-78.0,-83.0,12.0,23.0,10.0,13.0,1
1855,CC:2F:71:3E:C5:1F,5530131,4451722956,3406903,4182259036,2123228,269463920,502,93197,7999618,78599,6269414,14598,1730204,21542,533,3414300,870692,502,2927,7222.0,1000.0,-69.0,-73.0,-66.0,-61.0,-70.0,-72.0,-66.0,-61.0,-79.0,-86.0,-78.0,-83.0,10.0,13.0,12.0,22.0,1
1856,F8:59:71:5A:E0:3D,3449594,2257160566,1326363,1987696384,2123231,269464182,294,751493,918026036,750802,917942853,691,83183,740131,1840,1326492,165316,294,1139,144444.0,43333.0,-67.0,-73.0,-64.0,-69.0,-66.0,-72.0,-63.0,-69.0,-79.0,-86.0,-78.0,-83.0,12.0,13.0,14.0,14.0,1
1857,CC:2F:71:3F:1F:24,4017386,2771979135,1894155,2502514953,2123231,269464182,2596,1545484,1980896144,1544370,1980770070,1114,126074,1527860,6254,1894023,213754,2596,1842,86667.0,14444.0,-67.0,-64.0,-67.0,-68.0,-67.0,-64.0,-67.0,-69.0,-79.0,-86.0,-78.0,-83.0,12.0,22.0,11.0,15.0,1
1858,CC:2F:71:3E:C5:1F,5530136,4451723420,3406903,4182259036,2123233,269464384,502,93197,7999618,78599,6269414,14598,1730204,21542,533,3414300,870692,502,2927,7222.0,1000.0,-69.0,-73.0,-66.0,-61.0,-70.0,-72.0,-66.0,-61.0,-79.0,-86.0,-78.0,-83.0,10.0,13.0,12.0,22.0,1
1859,F8:59:71:5A:E0:3D,3449664,2257259078,1326427,1987794290,2123237,269464788,294,751557,918123162,750866,918039979,691,83183,740195,1840,1326556,165337,294,1139,144444.0,43333.0,-67.0,-73.0,-63.0,-70.0,-66.0,-72.0,-63.0,-69.0,-79.0,-86.0,-78.0,-83.0,12.0,13.0,15.0,13.0,1
1860,CC:2F:71:3F:1F:24,4017549,2772184807,1894312,2502720019,2123237,269464788,2596,1545628,1981094824,1544514,1980968750,1114,126074,1528003,6254,1894182,213788,2596,1842,65000.0,14444.0,-68.0,-64.0,-67.0,-69.0,-67.0,-64.0,-67.0,-69.0,-79.0,-86.0,-78.0,-83.0,11.0,22.0,11.0,14.0,1
1861,CC:2F:71:3E:C5:1F,5530140,4451723824,3406903,4182259036,2123237,269464788,502,93197,7999618,78599,6269414,14598,1730204,21542,533,3414300,870692,502,2927,7222.0,1000.0,-69.0,-73.0,-66.0,-61.0,-70.0,-72.0,-66.0,-61.0,-79.0,-86.0,-78.0,-83.0,10.0,13.0,12.0,22.0,1
1862,F8:59:71:5A:E0:3D,3449926,2257629301,1326687,1988164311,2123239,269464990,294,751673,918233190,750982,918150007,691,83183,740311,1840,1326816,165360,294,1139,144444.0,43333.0,-67.0,-73.0,-63.0,-70.0,-66.0,-72.0,-63.0,-69.0,-79.0,-86.0,-78.0,-83.0,12.0,13.0,15.0,13.0,1
1863,CC:2F:71:3F:1F:24,4017728,2772419941,1894488,2502954891,2123240,269465050,2596,1545798,1981326152,1544684,1981200078,1114,126074,1528167,6254,1894358,213824,2596,1842,86667.0,14444.0,-67.0,-64.0,-66.0,-69.0,-67.0,-63.0,-66.0,-68.0,-79.0,-86.0,-78.0,-83.0,12.0,22.0,12.0,14.0,1
1864,CC:2F:71:3E:C5:1F,5530145,4451724288,3406903,4182259036,2123242,269465252,502,93197,7999618,78599,6269414,14598,1730204,21542,533,3414300,870692,502,2927,7222.0,1000.0,-69.0,-73.0,-66.0,-61.0,-70.0,-72.0,-66.0,-61.0,-79.0,-86.0,-78.0,-83.0,10.0,13.0,12.0,22.0,1
1865,F8:59:71:5A:E0:3D,3450024,2257767121,1326778,1988301465,2123246,269465656,294,751766,918372603,751075,918289420,691,83183,740404,1840,1326907,165394,294,1139,130000.0,39000.0,-66.0,-73.0,-64.0,-70.0,-66.0,-72.0,-63.0,-69.0,-79.0,-86.0,-78.0,-83.0,13.0,13.0,14.0,13.0,1
1866,CC:2F:71:3F:1F:24,4017944,2772705647,1894698,2503239991,2123246,269465656,2596,1546011,1981605000,1544897,1981478926,1114,126074,1528366,6254,1894568,213876,2596,1842,86667.0,13000.0,-67.0,-64.0,-67.0,-69.0,-67.0,-64.0,-68.0,-69.0,-79.0,-86.0,-78.0,-83.0,12.0,22.0,11.0,14.0,1
1867,CC:2F:71:3E:C5:1F,5530149,4451724692,3406903,4182259036,2123246,269465656,502,93197,7999618,78599,6269414,14598,1730204,21542,533,3414300,870692,502,2927,7222.0,1000.0,-69.0,-73.0,-66.0,-61.0,-70.0,-72.0,-66.0,-61.0,-79.0,-86.0,-78.0,-83.0,10.0,13.0,12.0,22.0,1
1868,F8:59:71:5A:E0:3D,3450106,2257885719,1326854,1988419457,2123252,269466262,294,751842,918489853,751151,918406670,691,83183,740479,1840,1326982,165405,294,1140,144444.0,43333.0,-66.0,-73.0,-63.0,-69.0,-66.0,-72.0,-63.0,-69.0,-79.0,-86.0,-78.0,-83.0,13.0,13.0,15.0,14.0,1
1869,CC:2F:71:3F:1F:24,4018128,2772943273,1894876,2503477011,2123252,269466262,2596,1546188,1981840906,1545074,1981714832,1114,126074,1528536,6254,1894745,213901,2596,1842,86667.0,14444.0,-69.0,-64.0,-72.0,-70.0,-67.0,-63.0,-67.0,-68.0,-79.0,-86.0,-78.0,-83.0,10.0,22.0,6.0,13.0,1
1870,CC:2F:71:3E:C5:1F,5530157,4451725500,3406903,4182259036,2123254,269466464,502,93197,7999618,78599,6269414,14598,1730204,21542,533,3414300,870692,502,2927,7222.0,1000.0,-69.0,-73.0,-66.0,-61.0,-70.0,-72.0,-66.0,-61.0,-79.0,-86.0,-78.0,-83.0,10.0,13.0,12.0,22.0,1
1871,F8:59:71:5A:E0:3D,3450184,2258002195,1326929,1988535671,2123255,269466524,294,751917,918605353,751226,918522170,691,83183,740554,1840,1327058,165431,294,1140,144444.0,43333.0,-66.0,-72.0,-64.0,-70.0,-66.0,-72.0,-63.0,-69.0,-79.0,-86.0,-78.0,-83.0,13.0,14.0,14.0,13.0,1
1872,CC:2F:71:3F:1F:24,4018324,2773199423,1895067,2503732697,2123257,269466726,2596,1546371,1982084278,1545257,1981958204,1114,126074,1528713,6254,1894937,213946,2596,1842,104000.0,26000.0,-68.0,-64.0,-67.0,-70.0,-67.0,-64.0,-67.0,-69.0,-78.0,-85.0,-77.0,-81.0,10.0,21.0,10.0,11.0,1
1873,CC:2F:71:3E:C5:1F,5530168,4451728672,3406903,4182259036,2123265,269469636,502,93197,7999618,78599,6269414,14598,1730204,21542,533,3414300,870692,502,2927,7222.0,1000.0,-69.0,-73.0,-66.0,-61.0,-70.0,-72.0,-66.0,-61.0,-78.0,-85.0,-77.0,-81.0,9.0,12.0,11.0,20.0,1
1874,F8:59:71:5A:E0:3D,3450296,2258153704,1327024,1988683189,2123272,269470515,294,752013,918753207,751322,918670024,691,83183,740649,1840,1327152,165446,294,1140,144444.0,43333.0,-66.0,-72.0,-64.0,-70.0,-66.0,-72.0,-63.0,-69.0,-78.0,-85.0,-77.0,-81.0,12.0,13.0,13.0,11.0,1
1875,CC:2F:71:3F:1F:24,4018555,2773495955,1895283,2504025440,2123272,269470515,2596,1546584,1982374093,1545470,1982248019,1114,126074,1528918,6254,1895153,214017,2596,1843,86667.0,14444.0,-67.0,-64.0,-66.0,-69.0,-67.0,-63.0,-66.0,-68.0,-78.0,-85.0,-77.0,-81.0,11.0,21.0,11.0,12.0,1
1876,CC:2F:71:3E:C5:1F,5530175,4451729551,3406903,4182259036,2123272,269470515,502,93197,7999618,78599,6269414,14598,1730204,21542,533,3414300,870692,502,2927,7222.0,1000.0,-69.0,-73.0,-66.0,-61.0,-70.0,-72.0,-66.0,-61.0,-78.0,-85.0,-77.0,-81.0,9.0,12.0,11.0,20.0,1
1877,F8:59:71:5A:E0:3D,3450485,2258413931,1327210,1988943154,2123275,269470777,294,752116,918875180,751425,918791997,691,83183,740751,1840,1327339,165538,294,1140,144444.0,43333.0,-66.0,-72.0,-63.0,-69.0,-67.0,-72.0,-64.0,-70.0,-78.0,-85.0,-77.0,-81.0,12.0,13.0,14.0,12.0,1
1878,CC:2F:71:3F:1F:24,4018744,2773745445,1895469,2504274668,2123275,269470777,2596,1546761,1982610905,1545647,1982484831,1114,126074,1529089,6254,1895339,214086,2596,1843,65000.0,14444.0,-68.0,-64.0,-67.0,-68.0,-68.0,-64.0,-69.0,-69.0,-78.0,-85.0,-77.0,-81.0,10.0,21.0,10.0,13.0,1
1879,CC:2F:71:3E:C5:1F,5530178,4451729813,3406903,4182259036,2123275,269470777,502,93197,7999618,78599,6269414,14598,1730204,21542,533,3414300,870692,502,2927,7222.0,1000.0,-69.0,-73.0,-66.0,-61.0,-70.0,-72.0,-66.0,-61.0,-78.0,-85.0,-77.0,-81.0,9.0,12.0,11.0,20.0,1
1880,F8:59:71:5A:E0:3D,3450571,2258533255,1327288,1989061504,2123283,269471751,294,752193,918992336,751502,918909153,691,83183,740828,1840,1327417,165548,294,1140,144444.0,43333.0,-68.0,-73.0,-65.0,-72.0,-67.0,-72.0,-64.0,-70.0,-78.0,-85.0,-77.0,-81.0,10.0,12.0,12.0,9.0,1
1881,CC:2F:71:3F:1F:24,4018913,2773955553,1895630,2504483802,2123283,269471751,2596,1546915,1982812065,1545801,1982685991,1114,126074,1529237,6254,1895500,214104,2596,1843,86667.0,14444.0,-69.0,-64.0,-72.0,-71.0,-68.0,-64.0,-70.0,-69.0,-78.0,-85.0,-77.0,-81.0,9.0,21.0,5.0,10.0,1
1882,CC:2F:71:3E:C5:1F,5530187,4451730847,3406904,4182259096,2123283,269471751,502,93199,7999758,78601,6269554,14598,1730204,21542,533,3414301,870692,502,2927,7222.0,1000.0,-69.0,-71.0,-67.0,-61.0,-70.0,-72.0,-66.0,-61.0,-78.0,-85.0,-77.0,-81.0,9.0,14.0,10.0,20.0,1
1883,F8:59:71:5A:E0:3D,3450820,2258917278,1327535,1989445325,2123285,269471953,294,752301,919097889,751610,919014706,691,83183,740936,1840,1327664,165629,294,1140,144444.0,43333.0,-66.0,-72.0,-64.0,-70.0,-66.0,-72.0,-63.0,-70.0,-78.0,-85.0,-77.0,-82.0,12.0,13.0,13.0,12.0,1
1884,CC:2F:71:3F:1F:24,4019073,2774162599,1895788,2504690646,2123285,269471953,2596,1547057,1983009033,1545943,1982882959,1114,126074,1529379,6254,1895657,214146,2596,1843,86667.0,14444.0,-68.0,-64.0,-67.0,-69.0,-67.0,-64.0,-67.0,-69.0,-78.0,-85.0,-77.0,-82.0,10.0,21.0,10.0,13.0,1
1885,CC:2F:71:3E:C5:1F,5530189,4451731049,3406904,4182259096,2123285,269471953,502,93199,7999758,78601,6269554,14598,1730204,21542,533,3414301,870692,502,2927,7222.0,1000.0,-69.0,-71.0,-67.0,-61.0,-70.0,-72.0,-66.0,-61.0,-78.0,-85.0,-77.0,-82.0,9.0,14.0,10.0,21.0,1
1886,F8:59:71:5A:E0:3D,3450891,2259015908,1327598,1989543227,2123293,269472681,294,752363,919193369,751672,919110186,691,83183,740998,1840,1327727,165647,294,1140,144444.0,43333.0,-67.0,-73.0,-63.0,-70.0,-66.0,-72.0,-63.0,-70.0,-78.0,-85.0,-77.0,-82.0,11.0,12.0,14.0,12.0,1
1887,CC:2F:71:3F:1F:24,4019240,2774367828,1895947,2504895147,2123293,269472681,2596,1547206,1983211168,1546091,1983084976,1115,126192,1529525,6254,1895816,214163,2596,1843,86667.0,14444.0,-68.0,-64.0,-67.0,-70.0,-67.0,-64.0,-67.0,-69.0,-78.0,-85.0,-77.0,-82.0,10.0,21.0,10.0,12.0,1
1888,CC:2F:71:3E:C5:1F,5530197,4451731777,3406904,4182259096,2123293,269472681,502,93199,7999758,78601,6269554,14598,1730204,21542,533,3414301,870692,502,2927,7222.0,1000.0,-69.0,-71.0,-67.0,-61.0,-70.0,-72.0,-66.0,-61.0,-78.0,-85.0,-77.0,-82.0,9.0,14.0,10.0,21.0,1
1889,F8:59:71:5A:E0:3D,3450971,2259135377,1327676,1989662494,2123295,269472883,294,752440,919311096,751749,919227913,691,83183,741074,1840,1327804,165714,294,1145,144444.0,43333.0,-66.0,-73.0,-63.0,-69.0,-66.0,-72.0,-63.0,-69.0,-78.0,-85.0,-77.0,-82.0,12.0,12.0,14.0,13.0,1
1890,CC:2F:71:3F:1F:24,4019419,2774604344,1896124,2505131461,2123295,269472883,2596,1547379,1983451646,1546264,1983325454,1115,126192,1529698,6254,1895994,214341,2596,1843,65000.0,13000.0,-67.0,-64.0,-66.0,-68.0,-67.0,-64.0,-66.0,-69.0,-78.0,-85.0,-77.0,-82.0,11.0,21.0,11.0,14.0,1
1891,CC:2F:71:3E:C5:1F,5530199,4451731979,3406904,4182259096,2123295,269472883,502,93199,7999758,78601,6269554,14598,1730204,21542,533,3414301,870692,502,2927,7222.0,1000.0,-69.0,-71.0,-67.0,-61.0,-70.0,-72.0,-66.0,-61.0,-78.0,-85.0,-77.0,-82.0,9.0,14.0,10.0,21.0,1
1892,F8:59:71:5A:E0:3D,3451054,2259253139,1327752,1989779590,2123302,269473549,294,752507,919412978,751816,919329795,691,83183,741141,1840,1327880,165779,294,1145,144444.0,1000.0,-66.0,-72.0,-63.0,-69.0,-67.0,-72.0,-64.0,-70.0,-79.0,-86.0,-78.0,-83.0,13.0,14.0,15.0,14.0,1
1893,CC:2F:71:3F:1F:24,4019622,2774867270,1896320,2505393721,2123302,269473549,2596,1547582,1983738660,1546467,1983612468,1115,126192,1529901,6254,1896185,214475,2596,1844,65000.0,21667.0,-66.0,-64.0,-66.0,-69.0,-66.0,-63.0,-65.0,-68.0,-79.0,-86.0,-78.0,-83.0,13.0,22.0,12.0,14.0,1
1894,CC:2F:71:3E:C5:1F,5530208,4451732847,3406904,4182259096,2123304,269473751,502,93199,7999758,78601,6269554,14598,1730204,21542,533,3414301,870692,502,2927,7222.0,1000.0,-69.0,-71.0,-67.0,-61.0,-70.0,-72.0,-66.0,-61.0,-79.0,-86.0,-78.0,-83.0,10.0,15.0,11.0,22.0,1
1895,F8:59:71:5A:E0:3D,3451153,2259392050,1327847,1989918097,2123306,269473953,294,752614,919574277,751923,919491094,691,83183,741243,1840,1327976,165849,294,1146,144444.0,43333.0,-68.0,-73.0,-65.0,-71.0,-66.0,-72.0,-63.0,-70.0,-78.0,-85.0,-77.0,-82.0,10.0,12.0,12.0,11.0,1
1896,CC:2F:71:3F:1F:24,4019830,2775144538,1896524,2505670585,2123306,269473953,2596,1547751,1983971524,1546636,1983845332,1115,126192,1530070,6254,1896395,214556,2596,1844,72222.0,21667.0,-68.0,-64.0,-66.0,-68.0,-68.0,-63.0,-68.0,-69.0,-78.0,-85.0,-77.0,-82.0,10.0,21.0,11.0,14.0,1
1897,CC:2F:71:3E:C5:1F,5530210,4451733049,3406904,4182259096,2123306,269473953,502,93199,7999758,78601,6269554,14598,1730204,21542,533,3414301,870692,502,2927,7222.0,1000.0,-69.0,-71.0,-67.0,-61.0,-70.0,-72.0,-66.0,-61.0,-78.0,-85.0,-77.0,-82.0,9.0,14.0,10.0,21.0,1
1898,F8:59:71:5A:E0:3D,3451472,2259838834,1328160,1990364355,2123312,269474479,294,752735,919701760,752043,919618459,692,83301,741364,1840,1328289,166229,294,1146,144444.0,43333.0,-66.0,-73.0,-63.0,-69.0,-66.0,-72.0,-63.0,-69.0,-78.0,-85.0,-77.0,-82.0,12.0,12.0,14.0,13.0,1
1899,CC:2F:71:3F:1F:24,4020022,2775392682,1896708,2505918001,2123314,269474681,2596,1547925,1984210750,1546810,1984084558,1115,126192,1530244,6254,1896579,214604,2596,1844,78000.0,19500.0,-67.0,-64.0,-67.0,-69.0,-67.0,-63.0,-67.0,-69.0,-78.0,-85.0,-77.0,-82.0,11.0,21.0,10.0,13.0,1
1900,CC:2F:71:3E:C5:1F,5530218,4451733777,3406904,4182259096,2123314,269474681,502,93199,7999758,78601,6269554,14598,1730204,21542,533,3414301,870692,502,2927,7222.0,1000.0,-69.0,-71.0,-67.0,-61.0,-70.0,-72.0,-66.0,-61.0,-78.0,-85.0,-77.0,-82.0,9.0,14.0,10.0,21.0,1
1901,F8:59:71:5A:E0:3D,3451673,2260134756,1328356,1990659811,2123317,269474945,294,752834,919814483,752142,919731182,692,83301,741463,1840,1328485,166404,294,1146,130000.0,39000.0,-66.0,-72.0,-63.0,-69.0,-66.0,-71.0,-63.0,-69.0,-78.0,-85.0,-77.0,-82.0,12.0,13.0,14.0,13.0,1
1902,CC:2F:71:3F:1F:24,4020196,2775618008,1896879,2506143063,2123317,269474945,2596,1548079,1984424774,1546964,1984298582,1115,126192,1530398,6254,1896748,214717,2596,1844,78000.0,13000.0,-67.0,-64.0,-67.0,-69.0,-67.0,-63.0,-67.0,-68.0,-78.0,-85.0,-77.0,-82.0,11.0,21.0,10.0,13.0,1
1903,CC:2F:71:3E:C5:1F,5530221,4451734041,3406904,4182259096,2123317,269474945,502,93201,7999946,78602,6269624,14599,1730322,21543,533,3414301,870692,502,2928,7222.0,1000.0,-68.0,-72.0,-66.0,-61.0,-69.0,-72.0,-66.0,-61.0,-78.0,-85.0,-77.0,-82.0,10.0,13.0,11.0,21.0,1
1904,F8:59:71:5A:E0:3D,3451746,2260237622,1328425,1990762273,2123321,269475349,294,752905,919919938,752213,919836637,692,83301,741531,1840,1328554,166442,294,1146,144444.0,43333.0,-67.0,-72.0,-63.0,-69.0,-66.0,-72.0,-62.0,-68.0,-78.0,-85.0,-77.0,-82.0,11.0,13.0,14.0,13.0,1
1905,CC:2F:71:3F:1F:24,4020363,2775828416,1897040,2506352865,2123323,269475551,2596,1548227,1984629558,1547112,1984503366,1115,126192,1530546,6254,1896910,214772,2596,1844,78000.0,13000.0,-67.0,-64.0,-67.0,-69.0,-67.0,-63.0,-67.0,-69.0,-78.0,-85.0,-77.0,-82.0,11.0,21.0,10.0,13.0,1
1906,CC:2F:71:3E:C5:1F,5530228,4451734773,3406904,4182259096,2123324,269475677,502,93201,7999946,78602,6269624,14599,1730322,21543,533,3414301,870692,502,2928,7222.0,1000.0,-68.0,-72.0,-66.0,-61.0,-69.0,-72.0,-66.0,-61.0,-78.0,-85.0,-77.0,-82.0,10.0,13.0,11.0,21.0,1
1907,F8:59:71:5A:E0:3D,3451817,2260338718,1328490,1990862779,2123327,269475939,294,752971,920018730,752279,919935429,692,83301,741597,1840,1328619,166486,294,1146,144444.0,43333.0,-67.0,-73.0,-64.0,-71.0,-66.0,-72.0,-62.0,-69.0,-78.0,-85.0,-77.0,-82.0,11.0,12.0,13.0,11.0,1
1908,CC:2F:71:3F:1F:24,4020544,2776046098,1897217,2506570159,2123327,269475939,2596,1548384,1984835478,1547269,1984709286,1115,126192,1530703,6254,1897088,214810,2596,1844,86667.0,14444.0,-67.0,-64.0,-67.0,-68.0,-67.0,-64.0,-67.0,-69.0,-78.0,-85.0,-77.0,-82.0,11.0,21.0,10.0,14.0,1
1909,CC:2F:71:3E:C5:1F,5530231,4451735035,3406904,4182259096,2123327,269475939,502,93201,7999946,78602,6269624,14599,1730322,21543,533,3414301,870692,502,2928,7222.0,1000.0,-68.0,-72.0,-66.0,-61.0,-69.0,-72.0,-66.0,-61.0,-78.0,-85.0,-77.0,-82.0,10.0,13.0,11.0,21.0,1
1910,F8:59:71:5A:E0:3D,3451892,2260448840,1328561,1990972497,2123331,269476343,294,753027,920104970,752335,920021669,692,83301,741653,1840,1328690,166521,294,1146,144444.0,39000.0,-66.0,-72.0,-62.0,-69.0,-67.0,-73.0,-64.0,-70.0,-78.0,-85.0,-77.0,-82.0,12.0,13.0,15.0,13.0,1
1911,CC:2F:71:3F:1F:24,4020724,2776275214,1897391,2506798669,2123333,269476545,2596,1548544,1985057308,1547429,1984931116,1115,126192,1530863,6254,1897263,214896,2596,1844,78000.0,13000.0,-67.0,-64.0,-66.0,-69.0,-67.0,-64.0,-68.0,-69.0,-78.0,-85.0,-77.0,-82.0,11.0,21.0,11.0,13.0,1
1912,CC:2F:71:3E:C5:1F,5530237,4451735641,3406904,4182259096,2123333,269476545,502,93201,7999946,78602,6269624,14599,1730322,21543,533,3414301,870692,502,2928,7222.0,1000.0,-68.0,-72.0,-66.0,-61.0,-69.0,-72.0,-66.0,-61.0,-78.0,-85.0,-77.0,-82.0,10.0,13.0,11.0,21.0,1
1913,F8:59:71:5A:E0:3D,3451988,2260585637,1328651,1991108557,2123337,269477080,294,753132,920265659,752440,920182358,692,83301,741758,1840,1328780,166622,294,1146,130000.0,1000.0,-68.0,-73.0,-65.0,-71.0,-66.0,-72.0,-62.0,-69.0,-78.0,-84.0,-77.0,-81.0,10.0,11.0,12.0,10.0,1
1914,CC:2F:71:3F:1F:24,4020937,2776559863,1897600,2507082783,2123337,269477080,2596,1548738,1985333254,1547623,1985207062,1115,126192,1531056,6254,1897472,214989,2596,1844,86667.0,14444.0,-67.0,-64.0,-67.0,-69.0,-67.0,-64.0,-67.0,-69.0,-78.0,-84.0,-77.0,-81.0,11.0,20.0,10.0,12.0,1
1915,CC:2F:71:3E:C5:1F,5530241,4451736176,3406904,4182259096,2123337,269477080,502,93201,7999946,78602,6269624,14599,1730322,21543,533,3414301,870692,502,2928,7222.0,1000.0,-68.0,-72.0,-66.0,-61.0,-69.0,-72.0,-66.0,-61.0,-78.0,-84.0,-77.0,-81.0,10.0,12.0,11.0,20.0,1
1916,F8:59:71:5A:E0:3D,3452064,2260687034,1328721,1991209348,2123343,269477686,294,753200,920366146,752508,920282845,692,83301,741826,1840,1328851,166682,294,1146,130000.0,39000.0,-68.0,-73.0,-65.0,-71.0,-67.0,-73.0,-64.0,-70.0,-78.0,-84.0,-76.0,-81.0,10.0,11.0,11.0,10.0,1
1917,CC:2F:71:3F:1F:24,4021101,2776767537,1897758,2507289851,2123343,269477686,2596,1548881,1985531804,1547766,1985405612,1115,126192,1531199,6254,1897630,215018,2596,1844,86667.0,14444.0,-70.0,-64.0,-73.0,-71.0,-68.0,-64.0,-69.0,-70.0,-78.0,-84.0,-76.0,-81.0,8.0,20.0,3.0,10.0,1
1918,CC:2F:71:3E:C5:1F,5530247,4451736782,3406904,4182259096,2123343,269477686,502,93201,7999946,78602,6269624,14599,1730322,21543,533,3414301,870692,502,2928,7222.0,1000.0,-68.0,-72.0,-66.0,-61.0,-69.0,-72.0,-66.0,-61.0,-78.0,-84.0,-76.0,-81.0,10.0,12.0,10.0,20.0,1
1919,F8:59:71:5A:E0:3D,3452135,2260785217,1328790,1991307329,2123345,269477888,294,753269,920467889,752577,920384588,692,83301,741894,1840,1328920,166731,294,1147,144444.0,43333.0,-66.0,-72.0,-62.0,-68.0,-67.0,-72.0,-64.0,-69.0,-78.0,-84.0,-76.0,-81.0,12.0,12.0,14.0,13.0,1
1920,CC:2F:71:3F:1F:24,4021261,2776974919,1897916,2507497031,2123345,269477888,2596,1549024,1985730354,1547909,1985604162,1115,126192,1531342,6254,1897789,215045,2596,1844,86667.0,14444.0,-67.0,-64.0,-66.0,-68.0,-67.0,-64.0,-68.0,-69.0,-78.0,-84.0,-76.0,-81.0,11.0,20.0,10.0,13.0,1
1921,CC:2F:71:3E:C5:1F,5530249,4451736984,3406904,4182259096,2123345,269477888,502,93201,7999946,78602,6269624,14599,1730322,21543,533,3414301,870692,502,2928,7222.0,1000.0,-68.0,-72.0,-66.0,-61.0,-69.0,-72.0,-66.0,-61.0,-78.0,-84.0,-76.0,-81.0,10.0,12.0,10.0,20.0,1
1922,F8:59:71:5A:E0:3D,3452205,2260883449,1328853,1991404895,2123352,269478554,294,753331,920563369,752639,920480068,692,83301,741956,1840,1328983,166766,294,1147,144444.0,43333.0,-66.0,-72.0,-63.0,-69.0,-67.0,-73.0,-64.0,-70.0,-78.0,-84.0,-76.0,-81.0,12.0,12.0,13.0,12.0,1
1923,CC:2F:71:3F:1F:24,4021441,2777186099,1898089,2507707545,2123352,269478554,2596,1549179,1985931464,1548064,1985805272,1115,126192,1531497,6254,1897962,215091,2596,1845,86667.0,14444.0,-66.0,-64.0,-66.0,-68.0,-68.0,-63.0,-68.0,-69.0,-78.0,-84.0,-76.0,-81.0,12.0,20.0,10.0,13.0,1
1924,CC:2F:71:3E:C5:1F,5530256,4451737650,3406904,4182259096,2123352,269478554,502,93201,7999946,78602,6269624,14599,1730322,21543,533,3414301,870692,502,2928,7222.0,1000.0,-68.0,-72.0,-66.0,-61.0,-69.0,-72.0,-66.0,-61.0,-78.0,-84.0,-76.0,-81.0,10.0,12.0,10.0,20.0,1
1925,F8:59:71:5A:E0:3D,3452520,2261330837,1329166,1991852081,2123354,269478756,294,753439,920674940,752747,920591639,692,83301,742064,1840,1329296,167030,294,1147,144444.0,39000.0,-66.0,-71.0,-63.0,-69.0,-67.0,-73.0,-64.0,-70.0,-77.0,-83.0,-75.0,-80.0,11.0,12.0,12.0,11.0,1
1926,CC:2F:71:3F:1F:24,4021613,2777409043,1898259,2507930287,2123354,269478756,2596,1549335,1986144286,1548220,1986018094,1115,126192,1531653,6254,1898131,215135,2596,1845,86667.0,14444.0,-67.0,-64.0,-67.0,-69.0,-68.0,-64.0,-69.0,-69.0,-77.0,-83.0,-75.0,-80.0,10.0,19.0,8.0,11.0,1
1927,CC:2F:71:3E:C5:1F,5530258,4451737852,3406904,4182259096,2123354,269478756,502,93203,8000086,78604,6269764,14599,1730322,21543,533,3414302,870692,502,2928,7222.0,1000.0,-69.0,-72.0,-67.0,-61.0,-69.0,-72.0,-66.0,-61.0,-77.0,-83.0,-75.0,-80.0,8.0,11.0,8.0,19.0,1
1928,F8:59:71:5A:E0:3D,3452773,2261708710,1329415,1992229550,2123358,269479160,294,753556,920787144,752864,920703843,692,83301,742181,1840,1329545,167083,294,1147,144444.0,43333.0,-68.0,-74.0,-65.0,-71.0,-67.0,-73.0,-64.0,-70.0,-77.0,-83.0,-75.0,-80.0,9.0,9.0,10.0,9.0,1
1929,CC:2F:71:3F:1F:24,4021778,2777616959,1898418,2508137597,2123360,269479362,2596,1549479,1986344334,1548364,1986218142,1115,126192,1531797,6254,1898291,215157,2596,1845,86667.0,14444.0,-70.0,-64.0,-73.0,-71.0,-68.0,-64.0,-69.0,-70.0,-77.0,-83.0,-75.0,-80.0,7.0,19.0,2.0,9.0,1
1930,CC:2F:71:3E:C5:1F,5530264,4451738458,3406904,4182259096,2123360,269479362,502,93203,8000086,78604,6269764,14599,1730322,21543,533,3414302,870692,502,2928,7222.0,1000.0,-69.0,-72.0,-67.0,-61.0,-69.0,-72.0,-66.0,-61.0,-77.0,-83.0,-75.0,-80.0,8.0,11.0,8.0,19.0,1
1931,F8:59:71:5A:E0:3D,3452842,2261808727,1329481,1992329305,2123361,269479422,294,753621,920884435,752929,920801134,692,83301,742246,1840,1329611,167084,294,1147,144444.0,43333.0,-68.0,-73.0,-64.0,-70.0,-67.0,-73.0,-64.0,-70.0,-77.0,-83.0,-75.0,-80.0,9.0,10.0,11.0,10.0,1
1932,CC:2F:71:3F:1F:24,4021949,2777827501,1898586,2508347877,2123363,269479624,2596,1549627,1986544685,1548512,1986418493,1115,126192,1531945,6254,1898458,215180,2596,1845,86667.0,14444.0,-68.0,-64.0,-70.0,-70.0,-68.0,-64.0,-70.0,-70.0,-77.0,-83.0,-75.0,-80.0,9.0,19.0,5.0,10.0,1
1933,CC:2F:71:3E:C5:1F,5530267,4451738720,3406904,4182259096,2123363,269479624,502,93203,8000086,78604,6269764,14599,1730322,21543,533,3414302,870692,502,2928,7222.0,1000.0,-69.0,-72.0,-67.0,-61.0,-69.0,-72.0,-66.0,-61.0,-77.0,-83.0,-75.0,-80.0,8.0,11.0,8.0,19.0,1
1934,F8:59:71:5A:E0:3D,3452911,2261907235,1329544,1992427207,2123367,269480028,294,753684,920981455,752992,920898154,692,83301,742309,1840,1329674,167084,294,1147,144444.0,43333.0,-67.0,-73.0,-64.0,-70.0,-67.0,-73.0,-64.0,-70.0,-77.0,-83.0,-75.0,-80.0,10.0,10.0,11.0,10.0,1
1935,CC:2F:71:3F:1F:24,4022108,2778030423,1898741,2508550395,2123367,269480028,2596,1549768,1986740169,1548653,1986613977,1115,126192,1532085,6254,1898614,215180,2596,1845,86667.0,14444.0,-70.0,-64.0,-73.0,-71.0,-69.0,-64.0,-71.0,-70.0,-77.0,-83.0,-75.0,-80.0,7.0,19.0,2.0,9.0,1
1936,CC:2F:71:3E:C5:1F,5530271,4451739124,3406904,4182259096,2123367,269480028,502,93203,8000086,78604,6269764,14599,1730322,21543,533,3414302,870692,502,2928,7222.0,1000.0,-69.0,-72.0,-67.0,-61.0,-69.0,-72.0,-66.0,-61.0,-77.0,-83.0,-75.0,-80.0,8.0,11.0,8.0,19.0,1
1937,F8:59:71:5A:E0:3D,3452976,2262005339,1329607,1992525109,2123369,269480230,294,753748,921080015,753056,920996714,692,83301,742373,1840,1329737,167084,294,1147,144444.0,43333.0,-67.0,-73.0,-64.0,-70.0,-67.0,-73.0,-64.0,-70.0,-77.0,-83.0,-75.0,-80.0,10.0,10.0,11.0,10.0,1
1938,CC:2F:71:3F:1F:24,4022269,2778239135,1898900,2508758905,2123369,269480230,2596,1549914,1986941873,1548799,1986815681,1115,126192,1532231,6254,1898773,215199,2596,1845,78000.0,13000.0,-68.0,-64.0,-69.0,-70.0,-68.0,-64.0,-69.0,-70.0,-77.0,-83.0,-75.0,-80.0,9.0,19.0,6.0,10.0,1
1939,CC:2F:71:3E:C5:1F,5530273,4451739326,3406904,4182259096,2123369,269480230,502,93203,8000086,78604,6269764,14599,1730322,21543,533,3414302,870692,502,2928,7222.0,1000.0,-69.0,-72.0,-67.0,-61.0,-69.0,-72.0,-66.0,-61.0,-77.0,-83.0,-75.0,-80.0,8.0,11.0,8.0,19.0,1
1940,F8:59:71:5A:E0:3D,3453044,2262103705,1329670,1992623011,2123374,269480694,294,753811,921177049,753119,921093748,692,83301,742435,1840,1329800,167084,294,1147,144444.0,43333.0,-68.0,-73.0,-65.0,-71.0,-67.0,-72.0,-64.0,-70.0,-77.0,-83.0,-75.0,-80.0,9.0,10.0,10.0,9.0,1
1941,CC:2F:71:3F:1F:24,4022434,2778445445,1899058,2508964549,2123376,269480896,2596,1550057,1987138957,1548942,1987012765,1115,126192,1532374,6254,1898931,215199,2596,1845,86667.0,14444.0,-70.0,-64.0,-73.0,-71.0,-69.0,-64.0,-72.0,-70.0,-77.0,-83.0,-75.0,-80.0,7.0,19.0,2.0,9.0,1
1942,CC:2F:71:3E:C5:1F,5530280,4451739992,3406904,4182259096,2123376,269480896,502,93203,8000086,78604,6269764,14599,1730322,21543,533,3414302,870692,502,2928,7222.0,1000.0,-69.0,-72.0,-67.0,-61.0,-69.0,-72.0,-66.0,-61.0,-77.0,-83.0,-75.0,-80.0,8.0,11.0,8.0,19.0,1
1943,F8:59:71:5A:E0:3D,3453116,2262205409,1329738,1992724311,2123378,269481098,294,753880,921279502,753188,921196201,692,83301,742504,1840,1329868,167084,294,1147,144444.0,43333.0,-67.0,-73.0,-64.0,-71.0,-67.0,-73.0,-64.0,-70.0,-77.0,-84.0,-75.0,-80.0,10.0,11.0,11.0,9.0,1
1944,CC:2F:71:3F:1F:24,4022593,2778651049,1899215,2509169951,2123378,269481098,2596,1550202,1987336273,1549087,1987210081,1115,126192,1532519,6254,1899088,215215,2596,1845,86667.0,14444.0,-68.0,-64.0,-69.0,-71.0,-69.0,-64.0,-71.0,-70.0,-77.0,-84.0,-75.0,-80.0,9.0,20.0,6.0,9.0,1
1945,CC:2F:71:3E:C5:1F,5530282,4451740194,3406904,4182259096,2123378,269481098,502,93203,8000086,78604,6269764,14599,1730322,21543,533,3414302,870692,502,2928,7222.0,1000.0,-69.0,-72.0,-67.0,-61.0,-69.0,-72.0,-66.0,-61.0,-77.0,-84.0,-75.0,-80.0,8.0,12.0,8.0,19.0,1
1946,F8:59:71:5A:E0:3D,3453181,2262303513,1329801,1992822213,2123380,269481300,294,753944,921378076,753252,921294775,692,83301,742567,1840,1329931,167084,294,1147,144444.0,43333.0,-68.0,-73.0,-65.0,-72.0,-67.0,-73.0,-64.0,-70.0,-77.0,-84.0,-75.0,-80.0,9.0,11.0,10.0,8.0,1
1947,CC:2F:71:3F:1F:24,4022753,2778857007,1899373,2509375707,2123380,269481300,2596,1550347,1987535027,1549232,1987408835,1115,126192,1532663,6254,1899246,215215,2596,1845,86667.0,14444.0,-68.0,-64.0,-69.0,-70.0,-68.0,-64.0,-70.0,-70.0,-77.0,-84.0,-75.0,-80.0,9.0,20.0,6.0,10.0,1
1948,CC:2F:71:3E:C5:1F,5530286,4451740598,3406904,4182259096,2123382,269481502,502,93203,8000086,78604,6269764,14599,1730322,21543,533,3414302,870692,502,2928,7222.0,1000.0,-69.0,-72.0,-67.0,-61.0,-69.0,-72.0,-66.0,-61.0,-77.0,-84.0,-75.0,-80.0,8.0,12.0,8.0,19.0,1
1949,F8:59:71:5A:E0:3D,3453250,2262400527,1329863,1992918561,2123387,269481966,294,754008,921476650,753316,921393349,692,83301,742630,1840,1329993,167084,294,1147,144444.0,43333.0,-68.0,-73.0,-64.0,-70.0,-68.0,-73.0,-64.0,-70.0,-77.0,-84.0,-75.0,-80.0,9.0,11.0,11.0,10.0,1
1950,CC:2F:71:3F:1F:24,4022924,2779064457,1899537,2509582491,2123387,269481966,2596,1550498,1987733215,1549383,1987607023,1115,126192,1532814,6254,1899410,215215,2596,1845,86667.0,14444.0,-69.0,-63.0,-69.0,-69.0,-69.0,-63.0,-70.0,-69.0,-77.0,-84.0,-75.0,-80.0,8.0,21.0,6.0,11.0,1
1951,CC:2F:71:3E:C5:1F,5530291,4451741062,3406904,4182259096,2123387,269481966,502,93203,8000086,78604,6269764,14599,1730322,21543,533,3414302,870692,502,2928,7222.0,1000.0,-69.0,-72.0,-67.0,-61.0,-69.0,-72.0,-66.0,-61.0,-77.0,-84.0,-75.0,-80.0,8.0,12.0,8.0,19.0,1
1952,F8:59:71:5A:E0:3D,3453333,2262502463,1329944,1993020295,2123389,269482168,294,754091,921579201,753399,921495900,692,83301,742713,1840,1330074,167084,294,1147,144444.0,43333.0,-67.0,-74.0,-64.0,-72.0,-68.0,-74.0,-64.0,-71.0,-77.0,-84.0,-75.0,-80.0,10.0,10.0,11.0,8.0,1
1953,CC:2F:71:3F:1F:24,4023083,2779268637,1899694,2509786469,2123389,269482168,2596,1550642,1987927567,1549527,1987801375,1115,126192,1532958,6254,1899567,215226,2596,1845,86667.0,14444.0,-69.0,-63.0,-71.0,-74.0,-69.0,-63.0,-73.0,-74.0,-77.0,-84.0,-75.0,-80.0,8.0,21.0,4.0,6.0,1
1954,CC:2F:71:3E:C5:1F,5530293,4451741264,3406904,4182259096,2123389,269482168,502,93203,8000086,78604,6269764,14599,1730322,21543,533,3414302,870692,502,2928,7222.0,1000.0,-69.0,-72.0,-67.0,-61.0,-69.0,-72.0,-66.0,-61.0,-77.0,-84.0,-75.0,-80.0,8.0,12.0,8.0,19.0,1
1955,F8:59:71:5A:E0:3D,3453404,2262602798,1330008,1993119751,2123396,269483047,294,754154,921676221,753462,921592920,692,83301,742776,1840,1330138,167084,294,1147,144444.0,43333.0,-68.0,-73.0,-65.0,-71.0,-68.0,-73.0,-65.0,-71.0,-77.0,-84.0,-75.0,-81.0,9.0,11.0,10.0,10.0,1
1956,CC:2F:71:3F:1F:24,4023249,2779476826,1899853,2509993779,2123396,269483047,2596,1550787,1988129155,1549672,1988002963,1115,126192,1533103,6254,1899726,215226,2596,1845,86667.0,14444.0,-68.0,-64.0,-68.0,-72.0,-68.0,-64.0,-68.0,-72.0,-77.0,-84.0,-75.0,-81.0,9.0,20.0,7.0,9.0,1
1957,CC:2F:71:3E:C5:1F,5530301,4451742203,3406904,4182259096,2123397,269483107,502,93203,8000086,78604,6269764,14599,1730322,21543,533,3414302,870692,502,2928,7222.0,1000.0,-69.0,-72.0,-67.0,-61.0,-69.0,-72.0,-66.0,-61.0,-77.0,-84.0,-75.0,-81.0,8.0,12.0,8.0,20.0,1
1958,F8:59:71:5A:E0:3D,3453631,2262953941,1330234,1993470834,2123397,269483107,294,754259,921781510,753567,921698209,692,83301,742881,1840,1330364,167085,294,1147,144444.0,43333.0,-67.0,-75.0,-65.0,-70.0,-67.0,-75.0,-63.0,-70.0,-77.0,-84.0,-75.0,-81.0,10.0,9.0,10.0,11.0,1
1959,CC:2F:71:3F:1F:24,4023410,2779682844,1900011,2510199535,2123399,269483309,2596,1550931,1988324931,1549816,1988198739,1115,126192,1533247,6254,1899884,215226,2596,1845,86667.0,14444.0,-73.0,-62.0,-74.0,-71.0,-72.0,-62.0,-72.0,-70.0,-77.0,-84.0,-75.0,-81.0,4.0,22.0,1.0,10.0,1
1960,CC:2F:71:3E:C5:1F,5530303,4451742405,3406904,4182259096,2123399,269483309,502,93203,8000086,78604,6269764,14599,1730322,21543,533,3414302,870692,502,2928,7222.0,1000.0,-69.0,-72.0,-67.0,-61.0,-69.0,-72.0,-66.0,-61.0,-76.0,-83.0,-74.0,-80.0,7.0,11.0,7.0,19.0,1
1961,F8:59:71:5A:E0:3D,3453733,2263067640,1330306,1993572877,2123427,269494763,294,754328,921882854,753636,921799553,692,83301,742950,1840,1330436,167085,294,1147,144444.0,43333.0,-68.0,-73.0,-62.0,-70.0,-67.0,-72.0,-63.0,-70.0,-76.0,-83.0,-74.0,-80.0,8.0,10.0,12.0,10.0,1
1962,CC:2F:71:3F:1F:24,4023627,2779914418,1900200,2510419655,2123427,269494763,2596,1551100,1988535777,1549985,1988409585,1115,126192,1533416,6254,1900073,215249,2596,1845,130000.0,43333.0,-70.0,-64.0,-69.0,-68.0,-70.0,-64.0,-70.0,-67.0,-76.0,-83.0,-74.0,-80.0,6.0,19.0,5.0,12.0,1
1963,CC:2F:71:3E:C5:1F,5530332,4451753975,3406905,4182259212,2123427,269494763,502,93205,8000226,78606,6269904,14599,1730322,21543,533,3414303,870692,502,2928,7222.0,1000.0,-71.0,-73.0,-68.0,-61.0,-69.0,-72.0,-67.0,-61.0,-76.0,-83.0,-74.0,-80.0,5.0,10.0,6.0,19.0,1
1964,F8:59:71:5A:E0:3D,3453796,2263165542,1330369,1993670779,2123427,269494763,294,754391,921979874,753699,921896573,692,83301,743013,1840,1330499,167086,294,1147,144444.0,43333.0,-67.0,-74.0,-64.0,-71.0,-68.0,-73.0,-63.0,-71.0,-77.0,-83.0,-75.0,-80.0,10.0,9.0,11.0,9.0,1
1965,CC:2F:71:3F:1F:24,4023786,2780120234,1900358,2510625411,2123428,269494823,2596,1551243,1988732903,1550128,1988606711,1115,126192,1533559,6254,1900231,215294,2596,1845,115556.0,28889.0,-70.0,-65.0,-69.0,-71.0,-71.0,-65.0,-70.0,-70.0,-77.0,-83.0,-75.0,-80.0,7.0,18.0,6.0,9.0,1
1966,CC:2F:71:3E:C5:1F,5530333,4451754035,3406905,4182259212,2123428,269494823,502,93205,8000226,78606,6269904,14599,1730322,21543,533,3414303,870692,502,2928,7222.0,1000.0,-71.0,-73.0,-68.0,-61.0,-69.0,-72.0,-67.0,-61.0,-77.0,-83.0,-75.0,-80.0,6.0,10.0,7.0,19.0,1
1967,F8:59:71:5A:E0:3D,3453868,2263264312,1330432,1993768681,2123436,269495631,294,754455,922078448,753763,921995147,692,83301,743076,1840,1330561,167086,294,1147,144444.0,43333.0,-67.0,-73.0,-64.0,-70.0,-68.0,-73.0,-64.0,-70.0,-77.0,-83.0,-75.0,-80.0,10.0,10.0,11.0,10.0,1
1968,CC:2F:71:3F:1F:24,4023954,2780330410,1900518,2510834779,2123436,269495631,2596,1551389,1988933183,1550274,1988806991,1115,126192,1533705,6254,1900390,215294,2596,1845,104000.0,26000.0,-71.0,-63.0,-70.0,-73.0,-70.0,-63.0,-69.0,-72.0,-77.0,-83.0,-75.0,-80.0,6.0,20.0,5.0,7.0,1
1969,CC:2F:71:3E:C5:1F,5530341,4451754843,3406905,4182259212,2123436,269495631,502,93205,8000226,78606,6269904,14599,1730322,21543,533,3414303,870692,502,2928,7222.0,1000.0,-71.0,-73.0,-68.0,-61.0,-69.0,-72.0,-67.0,-61.0,-77.0,-83.0,-75.0,-80.0,6.0,10.0,7.0,19.0,1
1970,F8:59:71:5A:E0:3D,3453931,2263362214,1330495,1993866583,2123436,269495631,294,754518,922175468,753826,922092167,692,83301,743139,1840,1330624,167086,294,1147,144444.0,43333.0,-68.0,-73.0,-64.0,-70.0,-68.0,-72.0,-64.0,-70.0,-77.0,-83.0,-75.0,-80.0,9.0,10.0,11.0,10.0,1
1971,CC:2F:71:3F:1F:24,4024123,2780535488,1900687,2511039857,2123436,269495631,2596,1551538,1989127767,1550423,1989001575,1115,126192,1533854,6254,1900560,215305,2596,1845,130000.0,43333.0,-70.0,-64.0,-72.0,-73.0,-69.0,-64.0,-70.0,-72.0,-77.0,-83.0,-75.0,-80.0,7.0,19.0,3.0,7.0,1
1972,CC:2F:71:3E:C5:1F,5530341,4451754843,3406905,4182259212,2123436,269495631,502,93205,8000226,78606,6269904,14599,1730322,21543,533,3414303,870692,502,2928,7222.0,1000.0,-71.0,-73.0,-68.0,-61.0,-69.0,-72.0,-67.0,-61.0,-77.0,-83.0,-75.0,-80.0,6.0,10.0,7.0,19.0,1
1973,F8:59:71:5A:E0:3D,3454087,2263591944,1330646,1994095849,2123441,269496095,294,754611,922282702,753919,922199401,692,83301,743232,1840,1330776,167094,294,1147,144444.0,43333.0,-68.0,-73.0,-65.0,-71.0,-67.0,-73.0,-64.0,-70.0,-77.0,-84.0,-75.0,-80.0,9.0,11.0,10.0,9.0,1
1974,CC:2F:71:3F:1F:24,4024291,2780747132,1900848,2511250835,2123443,269496297,2596,1551686,1989331127,1550571,1989204935,1115,126192,1534002,6254,1900721,215305,2596,1845,130000.0,43333.0,-70.0,-64.0,-72.0,-75.0,-69.0,-64.0,-69.0,-73.0,-77.0,-84.0,-75.0,-80.0,7.0,20.0,3.0,5.0,1
1975,CC:2F:71:3E:C5:1F,5530350,4451755711,3406905,4182259212,2123445,269496499,502,93205,8000226,78606,6269904,14599,1730322,21543,533,3414303,870692,502,2928,7222.0,1000.0,-71.0,-73.0,-68.0,-61.0,-69.0,-72.0,-67.0,-61.0,-77.0,-84.0,-75.0,-80.0,6.0,11.0,7.0,19.0,1
1976,F8:59:71:5A:E0:3D,3454155,2263691748,1330710,1994195249,2123445,269496499,294,754675,922381262,753983,922297961,692,83301,743296,1840,1330840,167094,294,1147,130000.0,39000.0,-68.0,-74.0,-65.0,-71.0,-67.0,-73.0,-64.0,-71.0,-77.0,-84.0,-75.0,-80.0,9.0,10.0,10.0,9.0,1
1977,CC:2F:71:3F:1F:24,4024462,2780955345,1901017,2511458846,2123445,269496499,2596,1551838,1989528856,1550723,1989402664,1115,126192,1534154,6254,1900889,215313,2596,1845,130000.0,43333.0,-69.0,-64.0,-68.0,-72.0,-69.0,-64.0,-68.0,-72.0,-77.0,-84.0,-75.0,-80.0,8.0,20.0,7.0,8.0,1
1978,CC:2F:71:3E:C5:1F,5530350,4451755711,3406905,4182259212,2123445,269496499,502,93205,8000226,78606,6269904,14599,1730322,21543,533,3414303,870692,502,2928,7222.0,1000.0,-71.0,-73.0,-68.0,-61.0,-69.0,-72.0,-67.0,-61.0,-77.0,-84.0,-75.0,-80.0,6.0,11.0,7.0,19.0,1
1979,F8:59:71:5A:E0:3D,3454223,2263792964,1330776,1994296263,2123447,269496701,294,754740,922479928,754048,922396627,692,83301,743361,1840,1330906,167094,294,1147,144444.0,43333.0,-69.0,-74.0,-66.0,-72.0,-68.0,-73.0,-65.0,-71.0,-77.0,-84.0,-75.0,-80.0,8.0,10.0,9.0,8.0,1
1980,CC:2F:71:3F:1F:24,4024632,2781166134,1901185,2511669433,2123447,269496701,2596,1551990,1989734234,1550875,1989608042,1115,126192,1534306,6254,1901058,215320,2596,1845,130000.0,43333.0,-70.0,-64.0,-73.0,-73.0,-69.0,-64.0,-70.0,-72.0,-77.0,-84.0,-75.0,-80.0,7.0,20.0,2.0,7.0,1
1981,CC:2F:71:3E:C5:1F,5530352,4451755913,3406905,4182259212,2123447,269496701,502,93205,8000226,78606,6269904,14599,1730322,21543,533,3414303,870692,502,2928,7222.0,1000.0,-71.0,-73.0,-68.0,-61.0,-69.0,-72.0,-67.0,-61.0,-77.0,-84.0,-75.0,-80.0,6.0,11.0,7.0,19.0,1
1982,F8:59:71:5A:E0:3D,3454527,2264212164,1331072,1994714735,2123455,269497429,294,754849,922588832,754157,922505531,692,83301,743470,1840,1331202,167095,294,1147,144444.0,43333.0,-68.0,-73.0,-65.0,-71.0,-68.0,-73.0,-65.0,-71.0,-77.0,-84.0,-75.0,-80.0,9.0,11.0,10.0,9.0,1
1983,CC:2F:71:3F:1F:24,4024797,2781371400,1901342,2511873971,2123455,269497429,2596,1552132,1989929778,1551017,1989803586,1115,126192,1534448,6254,1901215,215334,2596,1845,130000.0,43333.0,-70.0,-64.0,-72.0,-73.0,-69.0,-64.0,-70.0,-73.0,-77.0,-84.0,-75.0,-80.0,7.0,20.0,3.0,7.0,1
1984,CC:2F:71:3E:C5:1F,5530360,4451756641,3406905,4182259212,2123455,269497429,502,93207,8000414,78607,6269974,14600,1730440,21544,533,3414303,870692,502,2928,7222.0,1000.0,-70.0,-74.0,-67.0,-62.0,-70.0,-72.0,-67.0,-61.0,-77.0,-84.0,-75.0,-80.0,7.0,10.0,8.0,18.0,1
1985,F8:59:71:5A:E0:3D,3454593,2264310330,1331135,1994812637,2123458,269497693,294,754911,922684312,754219,922601011,692,83301,743532,1840,1331264,167096,294,1147,144444.0,43333.0,-67.0,-73.0,-65.0,-72.0,-68.0,-73.0,-64.0,-71.0,-77.0,-84.0,-75.0,-81.0,10.0,11.0,10.0,9.0,1
1986,CC:2F:71:3F:1F:24,4024956,2781576072,1901498,2512078379,2123458,269497693,2596,1552274,1990125324,1551158,1989999014,1116,126310,1534590,6254,1901371,215341,2596,1845,130000.0,43333.0,-68.0,-64.0,-68.0,-71.0,-68.0,-64.0,-68.0,-72.0,-77.0,-84.0,-75.0,-81.0,9.0,20.0,7.0,10.0,1
1987,CC:2F:71:3E:C5:1F,5530364,4451756967,3406905,4182259212,2123459,269497755,502,93207,8000414,78607,6269974,14600,1730440,21544,533,3414303,870692,502,2928,7222.0,1000.0,-70.0,-74.0,-67.0,-62.0,-70.0,-72.0,-67.0,-61.0,-77.0,-84.0,-75.0,-81.0,7.0,10.0,8.0,19.0,1
1988,F8:59:71:5A:E0:3D,3454662,2264407346,1331197,1994908985,2123465,269498361,294,754974,922779910,754281,922696491,693,83419,743595,1840,1331326,167096,294,1147,144444.0,43333.0,-69.0,-74.0,-66.0,-72.0,-68.0,-73.0,-64.0,-71.0,-77.0,-84.0,-75.0,-81.0,8.0,10.0,9.0,9.0,1
1989,CC:2F:71:3F:1F:24,4025119,2781779934,1901654,2512281573,2123465,269498361,2596,1552418,1990319708,1551302,1990193398,1116,126310,1534734,6254,1901527,215344,2596,1845,130000.0,43333.0,-68.0,-64.0,-69.0,-73.0,-69.0,-64.0,-69.0,-73.0,-77.0,-84.0,-75.0,-81.0,9.0,20.0,6.0,8.0,1
1990,CC:2F:71:3E:C5:1F,5530370,4451757573,3406905,4182259212,2123465,269498361,502,93207,8000414,78607,6269974,14600,1730440,21544,533,3414303,870692,502,2928,7222.0,1000.0,-70.0,-74.0,-67.0,-62.0,-70.0,-72.0,-67.0,-61.0,-77.0,-84.0,-75.0,-81.0,7.0,10.0,8.0,19.0,1
1991,F8:59:71:5A:E0:3D,3454727,2264503956,1331259,1995005333,2123468,269498623,294,755037,922876930,754344,922793511,693,83419,743658,1840,1331389,167097,294,1147,144444.0,43333.0,-69.0,-74.0,-64.0,-71.0,-68.0,-73.0,-64.0,-71.0,-77.0,-84.0,-75.0,-81.0,8.0,10.0,11.0,10.0,1
1992,CC:2F:71:3F:1F:24,4025279,2781986382,1901811,2512487759,2123468,269498623,2596,1552561,1990516792,1551445,1990390482,1116,126310,1534877,6254,1901683,215348,2596,1845,130000.0,43333.0,-68.0,-64.0,-68.0,-72.0,-68.0,-64.0,-68.0,-72.0,-77.0,-84.0,-75.0,-81.0,9.0,20.0,7.0,9.0,1
1993,CC:2F:71:3E:C5:1F,5530373,4451757835,3406905,4182259212,2123468,269498623,502,93207,8000414,78607,6269974,14600,1730440,21544,533,3414303,870692,502,2928,7222.0,1000.0,-70.0,-74.0,-67.0,-62.0,-70.0,-72.0,-67.0,-61.0,-77.0,-84.0,-75.0,-81.0,7.0,10.0,8.0,19.0,1
1994,F8:59:71:5A:E0:3D,3454795,2264600910,1331321,1995101681,2123474,269499229,294,755098,922970870,754405,922887451,693,83419,743719,1840,1331451,167097,294,1147,144444.0,43333.0,-69.0,-74.0,-66.0,-72.0,-68.0,-73.0,-65.0,-71.0,-77.0,-84.0,-75.0,-81.0,8.0,10.0,9.0,9.0,1
1995,CC:2F:71:3F:1F:24,4025441,2782189972,1901967,2512690743,2123474,269499229,2596,1552702,1990709372,1551586,1990583062,1116,126310,1535018,6254,1901839,215362,2596,1845,130000.0,43333.0,-68.0,-64.0,-69.0,-73.0,-68.0,-64.0,-68.0,-72.0,-77.0,-84.0,-75.0,-81.0,9.0,20.0,6.0,8.0,1
1996,CC:2F:71:3E:C5:1F,5530379,4451758441,3406905,4182259212,2123474,269499229,502,93207,8000414,78607,6269974,14600,1730440,21544,533,3414303,870692,502,2928,7222.0,1000.0,-70.0,-74.0,-67.0,-62.0,-70.0,-72.0,-67.0,-61.0,-77.0,-84.0,-75.0,-81.0,7.0,10.0,8.0,19.0,1
1997,F8:59:71:5A:E0:3D,3454858,2264697531,1331383,1995198029,2123475,269499502,294,755161,923067890,754468,922984471,693,83419,743782,1840,1331513,167097,294,1147,144444.0,43333.0,-68.0,-73.0,-65.0,-71.0,-67.0,-73.0,-64.0,-70.0,-77.0,-84.0,-75.0,-81.0,9.0,11.0,10.0,10.0,1
1998,CC:2F:71:3F:1F:24,4025598,2782393453,1902123,2512893951,2123475,269499502,2596,1552847,1990905264,1551731,1990778954,1116,126310,1535163,6254,1901995,215372,2596,1845,130000.0,43333.0,-69.0,-64.0,-70.0,-72.0,-68.0,-64.0,-68.0,-72.0,-77.0,-84.0,-75.0,-81.0,8.0,20.0,5.0,9.0,1
1999,CC:2F:71:3E:C5:1F,5530380,4451758714,3406905,4182259212,2123475,269499502,502,93207,8000414,78607,6269974,14600,1730440,21544,533,3414303,870692,502,2928,7222.0,1000.0,-70.0,-74.0,-67.0,-62.0,-70.0,-72.0,-67.0,-61.0,-77.0,-84.0,-75.0,-81.0,7.0,10.0,8.0,19.0,1
2000,F8:59:71:5A:E0:3D,3455192,2265208748,1331710,1995708580,2123482,269500168,294,755278,923177445,754585,923094026,693,83419,743898,1840,1331840,167109,294,1147,144444.0,43333.0,-68.0,-74.0,-65.0,-72.0,-68.0,-73.0,-64.0,-71.0,-77.0,-84.0,-75.0,-81.0,9.0,10.0,10.0,9.0,1
2001,CC:2F:71:3F:1F:24,4025768,2782604003,1902284,2513103633,2123484,269500370,2596,1552995,1991105788,1551879,1990979478,1116,126310,1535311,6254,1902157,215380,2596,1845,130000.0,43333.0,-70.0,-64.0,-69.0,-72.0,-69.0,-64.0,-68.0,-72.0,-77.0,-84.0,-75.0,-81.0,7.0,20.0,6.0,9.0,1
2002,CC:2F:71:3E:C5:1F,5530389,4451759582,3406905,4182259212,2123484,269500370,502,93207,8000414,78607,6269974,14600,1730440,21544,533,3414303,870692,502,2928,7222.0,1000.0,-70.0,-74.0,-67.0,-62.0,-70.0,-72.0,-67.0,-61.0,-77.0,-84.0,-75.0,-81.0,7.0,10.0,8.0,19.0,1
2003,F8:59:71:5A:E0:3D,3455477,2265611412,1331993,1996111042,2123484,269500370,294,755371,923278662,754678,923195243,693,83419,743991,1840,1332123,167109,294,1147,144444.0,43333.0,-69.0,-74.0,-65.0,-72.0,-68.0,-73.0,-64.0,-71.0,-77.0,-84.0,-75.0,-81.0,8.0,10.0,10.0,9.0,1
2004,CC:2F:71:3F:1F:24,4025924,2782806987,1902440,2513306617,2123484,269500370,2596,1553140,1991301722,1552024,1991175412,1116,126310,1535455,6254,1902312,215388,2596,1845,130000.0,43333.0,-68.0,-64.0,-68.0,-73.0,-69.0,-64.0,-69.0,-73.0,-77.0,-84.0,-75.0,-81.0,9.0,20.0,7.0,8.0,1
2005,CC:2F:71:3E:C5:1F,5530391,4451759950,3406905,4182259212,2123486,269500738,502,93207,8000414,78607,6269974,14600,1730440,21544,533,3414303,870692,502,2928,7222.0,1000.0,-70.0,-74.0,-67.0,-62.0,-70.0,-72.0,-67.0,-61.0,-77.0,-84.0,-75.0,-81.0,7.0,10.0,8.0,19.0,1
2006,F8:59:71:5A:E0:3D,3455549,2265710418,1332057,1996209074,2123492,269501344,294,755437,923378892,754744,923295473,693,83419,744056,1840,1332187,167109,294,1147,144444.0,43333.0,-69.0,-74.0,-66.0,-72.0,-68.0,-73.0,-64.0,-71.0,-77.0,-84.0,-75.0,-81.0,8.0,10.0,9.0,9.0,1
2007,CC:2F:71:3F:1F:24,4026090,2783014053,1902598,2513512709,2123492,269501344,2596,1553284,1991498922,1552168,1991372612,1116,126310,1535599,6254,1902471,215396,2596,1845,130000.0,43333.0,-68.0,-64.0,-68.0,-74.0,-68.0,-64.0,-69.0,-73.0,-77.0,-84.0,-75.0,-81.0,9.0,20.0,7.0,7.0,1
2008,CC:2F:71:3E:C5:1F,5530397,4451760556,3406905,4182259212,2123492,269501344,502,93207,8000414,78607,6269974,14600,1730440,21544,533,3414303,870692,502,2928,7222.0,1000.0,-70.0,-74.0,-67.0,-62.0,-70.0,-72.0,-67.0,-61.0,-77.0,-84.0,-75.0,-81.0,7.0,10.0,8.0,19.0,1
2009,F8:59:71:5A:E0:3D,3455615,2265808582,1332120,1996306976,2123495,269501606,294,755499,923474372,754806,923390953,693,83419,744118,1840,1332250,167110,294,1147,144444.0,43333.0,-67.0,-73.0,-65.0,-71.0,-67.0,-73.0,-64.0,-71.0,-77.0,-84.0,-75.0,-81.0,10.0,11.0,10.0,10.0,1
2010,CC:2F:71:3F:1F:24,4026249,2783217523,1902754,2513715917,2123495,269501606,2596,1553426,1991693042,1552310,1991566732,1116,126310,1535741,6254,1902627,215401,2596,1845,130000.0,43333.0,-69.0,-64.0,-69.0,-72.0,-68.0,-64.0,-69.0,-72.0,-77.0,-84.0,-75.0,-81.0,8.0,20.0,6.0,9.0,1
2011,CC:2F:71:3E:C5:1F,5530400,4451760818,3406905,4182259212,2123495,269501606,502,93207,8000414,78607,6269974,14600,1730440,21544,533,3414303,870692,502,2928,7222.0,1000.0,-70.0,-74.0,-67.0,-62.0,-70.0,-72.0,-67.0,-61.0,-77.0,-84.0,-75.0,-81.0,7.0,10.0,8.0,19.0,1
2012,F8:59:71:5A:E0:3D,3455679,2265905132,1332182,1996403324,2123497,269501808,294,755561,923569852,754868,923486433,693,83419,744180,1840,1332312,167110,294,1147,144444.0,43333.0,-68.0,-74.0,-64.0,-71.0,-68.0,-73.0,-65.0,-71.0,-77.0,-84.0,-75.0,-80.0,9.0,10.0,11.0,9.0,1
2013,CC:2F:71:3F:1F:24,4026410,2783423709,1902913,2513921901,2123497,269501808,2596,1553573,1991890580,1552457,1991764270,1116,126310,1535888,6254,1902786,215415,2596,1845,130000.0,43333.0,-69.0,-64.0,-69.0,-72.0,-69.0,-64.0,-69.0,-72.0,-77.0,-84.0,-75.0,-80.0,8.0,20.0,6.0,8.0,1
2014,CC:2F:71:3E:C5:1F,5530402,4451761020,3406905,4182259212,2123497,269501808,502,93209,8000554,78609,6270114,14600,1730440,21544,533,3414304,870692,502,2928,7222.0,1000.0,-70.0,-74.0,-67.0,-62.0,-70.0,-73.0,-67.0,-61.0,-77.0,-84.0,-75.0,-80.0,7.0,10.0,8.0,18.0,1
2015,F8:59:71:5A:E0:3D,3455747,2266002086,1332244,1996499672,2123503,269502414,294,755624,923666872,754931,923583453,693,83419,744243,1840,1332374,167110,294,1147,144444.0,43333.0,-68.0,-73.0,-65.0,-71.0,-67.0,-73.0,-65.0,-71.0,-76.0,-83.0,-74.0,-79.0,8.0,10.0,9.0,8.0,1
2016,CC:2F:71:3F:1F:24,4026574,2783630631,1903071,2514128217,2123503,269502414,2596,1553718,1992087938,1552602,1991961628,1116,126310,1536033,6254,1902943,215416,2596,1845,130000.0,43333.0,-70.0,-64.0,-72.0,-75.0,-69.0,-64.0,-71.0,-74.0,-76.0,-83.0,-74.0,-79.0,6.0,19.0,2.0,4.0,1
2017,CC:2F:71:3E:C5:1F,5530408,4451761626,3406905,4182259212,2123503,269502414,502,93209,8000554,78609,6270114,14600,1730440,21544,533,3414304,870692,502,2928,7222.0,1000.0,-70.0,-74.0,-67.0,-62.0,-70.0,-73.0,-67.0,-61.0,-76.0,-83.0,-74.0,-79.0,6.0,9.0,7.0,17.0,1
2018,F8:59:71:5A:E0:3D,3455913,2266218125,1332407,1996715449,2123506,269502676,294,755713,923771543,755020,923688124,693,83419,744332,1840,1332537,167111,294,1147,144444.0,43333.0,-68.0,-73.0,-64.0,-70.0,-67.0,-73.0,-64.0,-70.0,-76.0,-83.0,-74.0,-79.0,8.0,10.0,10.0,9.0,1
2019,CC:2F:71:3F:1F:24,4026736,2783837467,1903230,2514334791,2123506,269502676,2596,1553864,1992285382,1552748,1992159072,1116,126310,1536179,6254,1903103,215418,2596,1845,130000.0,43333.0,-69.0,-64.0,-69.0,-72.0,-68.0,-64.0,-68.0,-72.0,-76.0,-83.0,-74.0,-79.0,7.0,19.0,5.0,7.0,1
2020,CC:2F:71:3E:C5:1F,5530411,4451761888,3406905,4182259212,2123506,269502676,502,93209,8000554,78609,6270114,14600,1730440,21544,533,3414304,870692,502,2928,7222.0,1000.0,-70.0,-74.0,-67.0,-62.0,-70.0,-73.0,-67.0,-61.0,-76.0,-83.0,-74.0,-79.0,6.0,9.0,7.0,17.0,1
2021,F8:59:71:5A:E0:3D,3455980,2266313525,1332468,1996810243,2123512,269503282,294,755775,923867023,755082,923783604,693,83419,744394,1840,1332598,167111,294,1147,144444.0,43333.0,-67.0,-73.0,-64.0,-71.0,-67.0,-73.0,-64.0,-71.0,-76.0,-83.0,-74.0,-79.0,9.0,10.0,10.0,8.0,1
2022,CC:2F:71:3F:1F:24,4026928,2784049749,1903416,2514546467,2123512,269503282,2596,1554028,1992491996,1552912,1992365686,1116,126310,1536343,6254,1903289,215431,2596,1845,130000.0,43333.0,-68.0,-64.0,-68.0,-73.0,-68.0,-64.0,-68.0,-72.0,-76.0,-83.0,-74.0,-79.0,8.0,19.0,6.0,6.0,1
2023,CC:2F:71:3E:C5:1F,5530417,4451762494,3406905,4182259212,2123512,269503282,502,93209,8000554,78609,6270114,14600,1730440,21544,533,3414304,870692,502,2928,7222.0,1000.0,-70.0,-74.0,-67.0,-62.0,-70.0,-73.0,-67.0,-61.0,-76.0,-83.0,-74.0,-79.0,6.0,9.0,7.0,17.0,1
2024,F8:59:71:5A:E0:3D,3456130,2266542313,1332616,1997038829,2123514,269503484,294,755861,923968600,755168,923885181,693,83419,744480,1840,1332746,167111,294,1147,144444.0,43333.0,-67.0,-73.0,-64.0,-70.0,-67.0,-73.0,-63.0,-70.0,-76.0,-83.0,-74.0,-79.0,9.0,10.0,10.0,9.0,1
2025,CC:2F:71:3F:1F:24,4027091,2784254724,1903577,2514751240,2123514,269503484,2596,1554176,1992686851,1553060,1992560541,1116,126310,1536491,6254,1903450,215436,2596,1845,130000.0,43333.0,-69.0,-64.0,-68.0,-72.0,-69.0,-64.0,-69.0,-72.0,-76.0,-83.0,-74.0,-79.0,7.0,19.0,6.0,7.0,1
2026,CC:2F:71:3E:C5:1F,5530419,4451762696,3406905,4182259212,2123514,269503484,502,93209,8000554,78609,6270114,14600,1730440,21544,533,3414304,870692,502,2928,7222.0,1000.0,-70.0,-74.0,-67.0,-62.0,-70.0,-73.0,-67.0,-61.0,-76.0,-83.0,-74.0,-79.0,6.0,9.0,7.0,17.0,1
2027,F8:59:71:5A:E0:3D,3456199,2266639327,1332678,1997135177,2123521,269504150,294,755924,924065620,755231,923982201,693,83419,744543,1840,1332808,167112,294,1147,144444.0,43333.0,-67.0,-74.0,-64.0,-71.0,-67.0,-73.0,-64.0,-70.0,-76.0,-83.0,-74.0,-79.0,9.0,9.0,10.0,8.0,1
2028,CC:2F:71:3F:1F:24,4027255,2784461576,1903734,2514957426,2123521,269504150,2596,1554318,1992882395,1553202,1992756085,1116,126310,1536633,6254,1903607,215439,2596,1845,130000.0,43333.0,-68.0,-64.0,-68.0,-72.0,-68.0,-64.0,-68.0,-72.0,-76.0,-83.0,-74.0,-79.0,8.0,19.0,6.0,7.0,1
2029,CC:2F:71:3E:C5:1F,5530426,4451763362,3406905,4182259212,2123521,269504150,502,93209,8000554,78609,6270114,14600,1730440,21544,533,3414304,870692,502,2928,7222.0,1000.0,-70.0,-74.0,-67.0,-62.0,-70.0,-73.0,-67.0,-61.0,-76.0,-83.0,-74.0,-79.0,6.0,9.0,7.0,17.0,1
2030,F8:59:71:5A:E0:3D,3456266,2266737803,1332745,1997233653,2123521,269504150,294,755992,924165100,755299,924081681,693,83419,744611,1840,1332875,167112,294,1147,144444.0,43333.0,-67.0,-73.0,-64.0,-71.0,-67.0,-73.0,-64.0,-71.0,-76.0,-84.0,-74.0,-80.0,9.0,11.0,10.0,9.0,1
2031,CC:2F:71:3F:1F:24,4027410,2784664416,1903889,2515160266,2123521,269504150,2596,1554462,1993078161,1553346,1992951851,1116,126310,1536777,6254,1903762,215447,2596,1845,130000.0,43333.0,-69.0,-64.0,-69.0,-73.0,-69.0,-64.0,-70.0,-73.0,-76.0,-84.0,-74.0,-80.0,7.0,20.0,5.0,7.0,1
2032,CC:2F:71:3E:C5:1F,5530428,4451763564,3406905,4182259212,2123523,269504352,502,93209,8000554,78609,6270114,14600,1730440,21544,533,3414304,870692,502,2928,7222.0,1000.0,-70.0,-74.0,-67.0,-62.0,-70.0,-73.0,-67.0,-61.0,-76.0,-84.0,-74.0,-80.0,6.0,10.0,7.0,18.0,1
2033,F8:59:71:5A:E0:3D,3456332,2266834555,1332807,1997330001,2123525,269504554,294,756054,924260580,755361,924177161,693,83419,744673,1840,1332937,167112,294,1147,144444.0,43333.0,-67.0,-73.0,-64.0,-70.0,-68.0,-73.0,-64.0,-71.0,-76.0,-84.0,-74.0,-80.0,9.0,11.0,10.0,10.0,1
2034,CC:2F:71:3F:1F:24,4027571,2784866676,1904044,2515361920,2123527,269504756,2596,1554602,1993270625,1553486,1993144315,1116,126310,1536917,6254,1903917,215449,2596,1845,130000.0,43333.0,-69.0,-64.0,-68.0,-73.0,-69.0,-64.0,-69.0,-73.0,-76.0,-84.0,-74.0,-80.0,7.0,20.0,6.0,7.0,1
2035,CC:2F:71:3E:C5:1F,5530434,4451764170,3406905,4182259212,2123529,269504958,502,93209,8000554,78609,6270114,14600,1730440,21544,533,3414304,870692,502,2928,7222.0,1000.0,-70.0,-74.0,-67.0,-62.0,-70.0,-73.0,-67.0,-61.0,-76.0,-84.0,-74.0,-80.0,6.0,10.0,7.0,18.0,1
2036,F8:59:71:5A:E0:3D,3456400,2266932921,1332870,1997427903,2123530,269505018,294,756117,924357614,755424,924274195,693,83419,744735,1840,1333000,167113,294,1147,144444.0,43333.0,-68.0,-72.0,-65.0,-71.0,-67.0,-72.0,-64.0,-70.0,-76.0,-84.0,-74.0,-80.0,8.0,12.0,9.0,9.0,1
2037,CC:2F:71:3F:1F:24,4027745,2785075613,1904215,2515570595,2123530,269505018,2596,1554755,1993469463,1553639,1993343153,1116,126310,1537070,6254,1904088,215451,2596,1845,130000.0,43333.0,-70.0,-64.0,-69.0,-71.0,-70.0,-64.0,-68.0,-71.0,-76.0,-84.0,-74.0,-80.0,6.0,20.0,5.0,9.0,1
2038,CC:2F:71:3E:C5:1F,5530435,4451764230,3406905,4182259212,2123530,269505018,502,93209,8000554,78609,6270114,14600,1730440,21544,533,3414304,870692,502,2928,7222.0,1000.0,-70.0,-74.0,-67.0,-62.0,-70.0,-73.0,-67.0,-61.0,-76.0,-84.0,-74.0,-80.0,6.0,10.0,7.0,18.0,1
2039,F8:59:71:5A:E0:3D,3456467,2267031227,1332933,1997525805,2123534,269505422,294,756180,924454634,755487,924371215,693,83419,744798,1840,1333063,167113,294,1147,144444.0,43333.0,-68.0,-73.0,-64.0,-71.0,-67.0,-72.0,-63.0,-71.0,-76.0,-84.0,-74.0,-80.0,8.0,11.0,10.0,9.0,1
2040,CC:2F:71:3F:1F:24,4028547,2786196766,1905013,2516691344,2123534,269505422,2596,1554972,1993686683,1553856,1993560373,1116,126310,1537287,6254,1904870,215535,2596,1845,117000.0,39000.0,-71.0,-63.0,-73.0,-72.0,-70.0,-63.0,-70.0,-71.0,-76.0,-84.0,-74.0,-80.0,5.0,21.0,1.0,8.0,1
2041,CC:2F:71:3E:C5:1F,5530442,4451765109,3406905,4182259212,2123537,269505897,502,93209,8000554,78609,6270114,14600,1730440,21544,533,3414304,870692,502,2928,7222.0,1000.0,-70.0,-74.0,-67.0,-62.0,-70.0,-73.0,-67.0,-61.0,-76.0,-84.0,-74.0,-80.0,6.0,10.0,7.0,18.0,1
2042,F8:59:71:5A:E0:3D,3456953,2267735918,1333413,1998229759,2123540,269506159,294,756355,924611351,755662,924527932,693,83419,744973,1840,1333543,167113,294,1147,144444.0,43333.0,-67.0,-73.0,-63.0,-70.0,-67.0,-72.0,-63.0,-70.0,-77.0,-84.0,-74.0,-80.0,10.0,11.0,11.0,10.0,1
2043,CC:2F:71:3F:1F:24,4032798,2792372701,1909258,2522866542,2123540,269506159,2596,1555509,1994022543,1554393,1993896233,1116,126310,1537823,6254,1909106,216168,2596,1845,130000.0,43333.0,-69.0,-63.0,-69.0,-72.0,-69.0,-62.0,-69.0,-71.0,-77.0,-84.0,-74.0,-80.0,8.0,21.0,5.0,8.0,1
2044,CC:2F:71:3E:C5:1F,5530447,4451765573,3406905,4182259212,2123542,269506361,502,93209,8000554,78609,6270114,14600,1730440,21544,533,3414304,870692,502,2928,7222.0,1000.0,-70.0,-74.0,-67.0,-62.0,-70.0,-73.0,-67.0,-61.0,-77.0,-84.0,-74.0,-80.0,7.0,10.0,7.0,18.0,1
2045,F8:59:71:5A:E0:3D,3457038,2267854834,1333490,1998347867,2123548,269506967,294,756432,924729931,755739,924646512,693,83419,745050,1840,1333620,167118,294,1147,144444.0,39000.0,-68.0,-73.0,-64.0,-70.0,-68.0,-72.0,-64.0,-69.0,-77.0,-84.0,-74.0,-80.0,9.0,11.0,10.0,10.0,1
2046,CC:2F:71:3F:1F:24,4036400,2797586626,1912852,2528079659,2123548,269506967,2596,1555924,1994287407,1554808,1994161097,1116,126310,1538238,6254,1912725,216758,2596,1846,130000.0,43333.0,-68.0,-63.0,-68.0,-72.0,-68.0,-63.0,-68.0,-72.0,-77.0,-84.0,-74.0,-80.0,9.0,21.0,6.0,8.0,1
2047,CC:2F:71:3E:C5:1F,5530454,4451766295,3406906,4182259328,2123548,269506967,502,93211,8000694,78611,6270254,14600,1730440,21544,533,3414305,870692,502,2928,7222.0,1000.0,-70.0,-74.0,-68.0,-62.0,-71.0,-74.0,-68.0,-61.0,-77.0,-84.0,-74.0,-80.0,7.0,10.0,6.0,18.0,1
2048,F8:59:71:5A:E0:3D,3457104,2267955918,1333556,1998448951,2123548,269506967,294,756497,924828607,755804,924745188,693,83419,745115,1840,1333686,167118,294,1147,144444.0,43333.0,-68.0,-74.0,-63.0,-70.0,-67.0,-73.0,-64.0,-70.0,-77.0,-85.0,-75.0,-80.0,9.0,11.0,12.0,10.0,1
2049,CC:2F:71:3F:1F:24,4036561,2797797324,1913013,2528290357,2123548,269506967,2596,1556073,1994489367,1554957,1994363057,1116,126310,1538385,6254,1912886,216798,2596,1846,115556.0,28889.0,-71.0,-64.0,-72.0,-72.0,-70.0,-64.0,-71.0,-71.0,-77.0,-85.0,-75.0,-80.0,6.0,21.0,3.0,8.0,1
2050,CC:2F:71:3E:C5:1F,5530454,4451766295,3406906,4182259328,2123548,269506967,502,93211,8000694,78611,6270254,14600,1730440,21544,533,3414305,870692,502,2928,7222.0,1000.0,-70.0,-74.0,-68.0,-62.0,-71.0,-74.0,-68.0,-61.0,-77.0,-85.0,-75.0,-80.0,7.0,11.0,7.0,18.0,1
2051,F8:59:71:5A:E0:3D,3457175,2268054548,1333619,1998546853,2123556,269507695,294,756560,924925627,755867,924842208,693,83419,745178,1840,1333749,167118,294,1147,144444.0,43333.0,-68.0,-73.0,-64.0,-70.0,-68.0,-73.0,-63.0,-70.0,-77.0,-85.0,-75.0,-80.0,9.0,12.0,11.0,10.0,1
2052,CC:2F:71:3F:1F:24,4036730,2798005284,1913172,2528497387,2123558,269507897,2596,1556220,1994688249,1555103,1994561821,1117,126428,1538530,6254,1913045,216811,2596,1846,86667.0,14444.0,-70.0,-64.0,-70.0,-71.0,-70.0,-64.0,-71.0,-71.0,-77.0,-85.0,-75.0,-80.0,7.0,21.0,5.0,9.0,1
2053,CC:2F:71:3E:C5:1F,5530464,4451767225,3406906,4182259328,2123558,269507897,502,93211,8000694,78611,6270254,14600,1730440,21544,533,3414305,870692,502,2928,7222.0,1000.0,-70.0,-74.0,-68.0,-62.0,-71.0,-74.0,-68.0,-61.0,-77.0,-85.0,-75.0,-80.0,7.0,11.0,7.0,18.0,1
2054,F8:59:71:5A:E0:3D,3457240,2268151160,1333681,1998643201,2123559,269507959,294,756624,925022765,755930,924939228,694,83537,745242,1840,1333811,167118,294,1147,144444.0,43333.0,-69.0,-74.0,-65.0,-71.0,-68.0,-73.0,-64.0,-70.0,-77.0,-85.0,-75.0,-80.0,8.0,11.0,10.0,9.0,1
2055,CC:2F:71:3F:1F:24,4036886,2798207752,1913327,2528699793,2123559,269507959,2596,1556360,1994880713,1555243,1994754285,1117,126428,1538670,6254,1913200,216811,2596,1846,86667.0,14444.0,-71.0,-63.0,-71.0,-70.0,-69.0,-63.0,-69.0,-69.0,-77.0,-85.0,-75.0,-80.0,6.0,22.0,4.0,10.0,1
2056,CC:2F:71:3E:C5:1F,5530465,4451767287,3406906,4182259328,2123559,269507959,502,93211,8000694,78611,6270254,14600,1730440,21544,533,3414305,870692,502,2928,7222.0,1000.0,-70.0,-74.0,-68.0,-62.0,-71.0,-74.0,-68.0,-61.0,-77.0,-85.0,-75.0,-80.0,7.0,11.0,7.0,18.0,1
2057,F8:59:71:5A:E0:3D,3457317,2268250612,1333754,1998742249,2123563,269508363,294,756697,925121078,756003,925037541,694,83537,745315,1840,1333884,167119,294,1147,144444.0,43333.0,-69.0,-73.0,-65.0,-71.0,-68.0,-73.0,-64.0,-70.0,-77.0,-85.0,-75.0,-81.0,8.0,12.0,10.0,10.0,1
2058,CC:2F:71:3F:1F:24,4037048,2798410782,1913483,2528902217,2123565,269508565,2596,1556501,1995074717,1555384,1994948289,1117,126428,1538811,6254,1913355,216821,2596,1846,86667.0,14444.0,-69.0,-63.0,-68.0,-70.0,-70.0,-63.0,-70.0,-70.0,-77.0,-85.0,-75.0,-81.0,8.0,22.0,7.0,11.0,1
2059,CC:2F:71:3E:C5:1F,5530472,4451767953,3406906,4182259328,2123566,269508625,502,93211,8000694,78611,6270254,14600,1730440,21544,533,3414305,870692,502,2928,7222.0,1000.0,-70.0,-74.0,-68.0,-62.0,-71.0,-74.0,-68.0,-61.0,-77.0,-85.0,-75.0,-81.0,7.0,11.0,7.0,19.0,1
2060,F8:59:71:5A:E0:3D,3457636,2268694502,1334068,1999185675,2123568,269508827,294,756806,925227635,756112,925144098,694,83537,745424,1840,1334198,167121,294,1147,144444.0,43333.0,-68.0,-73.0,-64.0,-70.0,-68.0,-73.0,-64.0,-69.0,-77.0,-85.0,-75.0,-81.0,9.0,12.0,11.0,11.0,1
2061,CC:2F:71:3F:1F:24,4037262,2798682782,1913694,2529173955,2123568,269508827,2596,1556664,1995278085,1555547,1995151657,1117,126428,1538974,6254,1913545,216821,2596,1846,65000.0,13000.0,-72.0,-64.0,-72.0,-71.0,-70.0,-63.0,-71.0,-70.0,-77.0,-85.0,-75.0,-81.0,5.0,21.0,3.0,10.0,1
2062,CC:2F:71:3E:C5:1F,5530474,4451768155,3406906,4182259328,2123568,269508827,502,93211,8000694,78611,6270254,14600,1730440,21544,533,3414305,870692,502,2928,7222.0,1000.0,-70.0,-74.0,-68.0,-62.0,-71.0,-74.0,-68.0,-61.0,-77.0,-85.0,-75.0,-81.0,7.0,11.0,7.0,19.0,1
2063,F8:59:71:5A:E0:3D,3457816,2268963142,1334244,1999453911,2123572,269509231,294,756914,925356439,756220,925272902,694,83537,745532,1840,1334374,167122,294,1147,144444.0,43333.0,-69.0,-73.0,-65.0,-70.0,-68.0,-73.0,-64.0,-70.0,-77.0,-85.0,-75.0,-81.0,8.0,12.0,10.0,11.0,1
2064,CC:2F:71:3F:1F:24,4038688,2800733303,1915114,2531223870,2123574,269509433,2596,1556992,1995542318,1555875,1995415890,1117,126428,1539302,6254,1914987,216821,2596,1846,86667.0,14444.0,-71.0,-64.0,-71.0,-71.0,-69.0,-63.0,-69.0,-70.0,-77.0,-85.0,-75.0,-81.0,6.0,21.0,4.0,10.0,1
2065,CC:2F:71:3E:C5:1F,5530480,4451768761,3406906,4182259328,2123574,269509433,502,93211,8000694,78611,6270254,14600,1730440,21544,533,3414305,870692,502,2928,7222.0,1000.0,-70.0,-74.0,-68.0,-62.0,-71.0,-74.0,-68.0,-61.0,-77.0,-85.0,-75.0,-81.0,7.0,11.0,7.0,19.0,1
2066,F8:59:71:5A:E0:3D,3457894,2269064327,1334317,1999554632,2123577,269509695,294,756985,925459520,756291,925375983,694,83537,745603,1840,1334447,167123,294,1147,144444.0,43333.0,-67.0,-72.0,-64.0,-69.0,-68.0,-72.0,-63.0,-69.0,-78.0,-85.0,-76.0,-81.0,11.0,13.0,12.0,12.0,1
2067,CC:2F:71:3F:1F:24,4038850,2800939279,1915273,2531429584,2123577,269509695,2596,1557134,1995737862,1556017,1995611434,1117,126428,1539444,6254,1915146,216831,2596,1846,86667.0,14444.0,-69.0,-64.0,-68.0,-69.0,-69.0,-63.0,-69.0,-70.0,-78.0,-85.0,-76.0,-81.0,9.0,21.0,8.0,12.0,1
2068,CC:2F:71:3E:C5:1F,5530483,4451769023,3406906,4182259328,2123577,269509695,502,93211,8000694,78611,6270254,14600,1730440,21544,533,3414305,870692,502,2928,7222.0,1000.0,-70.0,-74.0,-68.0,-62.0,-71.0,-74.0,-68.0,-61.0,-78.0,-85.0,-76.0,-81.0,8.0,11.0,8.0,19.0,1
2069,F8:59:71:5A:E0:3D,3457966,2269163420,1334385,1999653321,2123581,269510099,294,757052,925559487,756358,925475950,694,83537,745670,1840,1334515,167124,294,1147,144444.0,43333.0,-67.0,-72.0,-64.0,-69.0,-68.0,-72.0,-63.0,-69.0,-78.0,-85.0,-76.0,-81.0,11.0,13.0,12.0,12.0,1
2070,CC:2F:71:3F:1F:24,4039011,2801143325,1915430,2531633226,2123581,269510099,2596,1557279,1995935178,1556162,1995808750,1117,126428,1539589,6254,1915303,216850,2596,1846,86667.0,14444.0,-68.0,-63.0,-68.0,-69.0,-68.0,-63.0,-68.0,-69.0,-78.0,-85.0,-76.0,-81.0,10.0,22.0,8.0,12.0,1
2071,CC:2F:71:3E:C5:1F,5530487,4451769427,3406906,4182259328,2123581,269510099,502,93211,8000694,78611,6270254,14600,1730440,21544,533,3414305,870692,502,2928,7222.0,1000.0,-70.0,-74.0,-68.0,-62.0,-71.0,-74.0,-68.0,-61.0,-78.0,-85.0,-76.0,-81.0,8.0,11.0,8.0,19.0,1
2072,F8:59:71:5A:E0:3D,3458033,2269261726,1334448,1999751223,2123585,269510503,294,757114,925654967,756420,925571430,694,83537,745732,1840,1334578,167131,294,1147,144444.0,43333.0,-69.0,-73.0,-65.0,-71.0,-67.0,-72.0,-64.0,-70.0,-78.0,-85.0,-76.0,-81.0,9.0,12.0,11.0,10.0,1
2073,CC:2F:71:3F:1F:24,4039171,2801347801,1915586,2531837298,2123585,269510503,2596,1557422,1996130838,1556305,1996004410,1117,126428,1539732,6254,1915459,216858,2596,1846,86667.0,14444.0,-69.0,-63.0,-69.0,-70.0,-69.0,-63.0,-68.0,-70.0,-78.0,-85.0,-76.0,-81.0,9.0,22.0,7.0,11.0,1
2074,CC:2F:71:3E:C5:1F,5530491,4451769831,3406906,4182259328,2123585,269510503,502,93211,8000694,78611,6270254,14600,1730440,21544,533,3414305,870692,502,2928,7222.0,1000.0,-70.0,-74.0,-68.0,-62.0,-71.0,-74.0,-68.0,-61.0,-78.0,-85.0,-76.0,-81.0,8.0,11.0,8.0,19.0,1
2075,F8:59:71:5A:E0:3D,3458099,2269359890,1334511,1999849125,2123588,269510765,294,757177,925751987,756483,925668450,694,83537,745795,1840,1334641,167135,294,1147,144444.0,43333.0,-69.0,-73.0,-65.0,-71.0,-68.0,-72.0,-64.0,-70.0,-78.0,-85.0,-76.0,-81.0,9.0,12.0,11.0,10.0,1
2076,CC:2F:71:3F:1F:24,4039334,2801553461,1915744,2532042494,2123590,269510967,2596,1557564,1996327806,1556447,1996201378,1117,126428,1539874,6254,1915616,216888,2596,1846,86667.0,14444.0,-68.0,-63.0,-69.0,-70.0,-68.0,-63.0,-70.0,-69.0,-78.0,-85.0,-76.0,-81.0,10.0,22.0,7.0,11.0,1
2077,CC:2F:71:3E:C5:1F,5530496,4451770295,3406906,4182259328,2123590,269510967,502,93211,8000694,78611,6270254,14600,1730440,21544,533,3414305,870692,502,2928,7222.0,1000.0,-70.0,-74.0,-68.0,-62.0,-71.0,-74.0,-68.0,-61.0,-78.0,-85.0,-76.0,-81.0,8.0,11.0,8.0,19.0,1
2078,F8:59:71:5A:E0:3D,3458166,2269455290,1334572,1999943919,2123594,269511371,294,757239,925847467,756545,925763930,694,83537,745857,1840,1334702,167138,294,1147,144444.0,43333.0,-69.0,-73.0,-65.0,-71.0,-68.0,-72.0,-64.0,-70.0,-77.0,-84.0,-75.0,-80.0,8.0,11.0,10.0,9.0,1
2079,CC:2F:71:3F:1F:24,4039499,2801757373,1915905,2532246002,2123594,269511371,2596,1557710,1996522611,1556593,1996396183,1117,126428,1540020,6254,1915778,216889,2596,1846,86667.0,14444.0,-69.0,-63.0,-72.0,-71.0,-68.0,-63.0,-69.0,-70.0,-77.0,-84.0,-75.0,-80.0,8.0,21.0,3.0,9.0,1
2080,CC:2F:71:3E:C5:1F,5530500,4451770699,3406906,4182259328,2123594,269511371,502,93211,8000694,78611,6270254,14600,1730440,21544,533,3414305,870692,502,2928,7222.0,1000.0,-70.0,-74.0,-68.0,-62.0,-71.0,-74.0,-68.0,-61.0,-77.0,-84.0,-75.0,-80.0,7.0,10.0,7.0,18.0,1
2081,F8:59:71:5A:E0:3D,3458230,2269553465,1334635,2000041821,2123595,269511644,294,757301,925942947,756607,925859410,694,83537,745919,1840,1334765,167140,294,1147,144444.0,43333.0,-67.0,-72.0,-64.0,-70.0,-67.0,-72.0,-64.0,-70.0,-77.0,-84.0,-75.0,-80.0,10.0,12.0,11.0,10.0,1
2082,CC:2F:71:3F:1F:24,4039657,2801960366,1916060,2532448520,2123597,269511846,2596,1557851,1996716615,1556734,1996590187,1117,126428,1540161,6254,1915933,216892,2596,1846,86667.0,14444.0,-67.0,-63.0,-67.0,-70.0,-68.0,-63.0,-69.0,-69.0,-77.0,-84.0,-75.0,-80.0,10.0,21.0,8.0,10.0,1
2083,CC:2F:71:3E:C5:1F,5530503,4451771174,3406906,4182259328,2123597,269511846,502,93211,8000694,78611,6270254,14600,1730440,21544,533,3414305,870692,502,2928,7222.0,1000.0,-70.0,-74.0,-68.0,-62.0,-71.0,-74.0,-68.0,-61.0,-77.0,-84.0,-75.0,-80.0,7.0,10.0,7.0,18.0,1
2084,F8:59:71:5A:E0:3D,3458303,2269652297,1334698,2000139723,2123605,269512574,294,757364,926039967,756670,925956430,694,83537,745982,1840,1334827,167142,294,1147,144444.0,43333.0,-67.0,-72.0,-64.0,-69.0,-67.0,-72.0,-64.0,-70.0,-77.0,-84.0,-75.0,-80.0,10.0,12.0,11.0,11.0,1
2085,CC:2F:71:3F:1F:24,4039822,2802166608,1916217,2532654034,2123605,269512574,2596,1557994,1996913727,1556877,1996787299,1117,126428,1540304,6254,1916090,216907,2596,1846,86667.0,14444.0,-68.0,-63.0,-69.0,-69.0,-68.0,-63.0,-69.0,-69.0,-77.0,-84.0,-75.0,-80.0,9.0,21.0,6.0,11.0,1
2086,CC:2F:71:3E:C5:1F,5530511,4451771902,3406906,4182259328,2123605,269512574,502,93213,8000882,78612,6270324,14601,1730558,21545,533,3414305,870692,502,2928,7222.0,1000.0,-73.0,-75.0,-70.0,-61.0,-71.0,-74.0,-68.0,-61.0,-77.0,-84.0,-75.0,-80.0,4.0,9.0,5.0,19.0,1
2087,F8:59:71:5A:E0:3D,3458365,2269748645,1334760,2000236071,2123605,269512574,294,757426,926135447,756732,926051910,694,83537,746044,1840,1334890,167144,294,1147,144444.0,43333.0,-69.0,-73.0,-65.0,-71.0,-67.0,-72.0,-64.0,-69.0,-77.0,-84.0,-75.0,-80.0,8.0,11.0,10.0,9.0,1
2088,CC:2F:71:3F:1F:24,4039997,2802374581,1916392,2532862007,2123605,269512574,2596,1558152,1997114131,1557035,1996987703,1117,126428,1540462,6254,1916265,216915,2596,1846,86667.0,14444.0,-67.0,-63.0,-66.0,-69.0,-68.0,-63.0,-69.0,-69.0,-77.0,-84.0,-75.0,-80.0,10.0,21.0,9.0,11.0,1
2089,CC:2F:71:3E:C5:1F,5530511,4451771902,3406906,4182259328,2123605,269512574,502,93213,8000882,78612,6270324,14601,1730558,21545,533,3414305,870692,502,2928,7222.0,1000.0,-73.0,-75.0,-70.0,-61.0,-71.0,-74.0,-68.0,-61.0,-77.0,-84.0,-75.0,-80.0,4.0,9.0,5.0,19.0,1
2090,F8:59:71:5A:E0:3D,3458640,2270123121,1335030,2000610009,2123610,269513112,294,757529,926241907,756835,926158370,694,83537,746147,1840,1335160,167225,294,1147,144444.0,43333.0,-67.0,-72.0,-63.0,-70.0,-67.0,-72.0,-64.0,-70.0,-77.0,-84.0,-75.0,-80.0,10.0,12.0,12.0,10.0,1
2091,CC:2F:71:3F:1F:24,4040163,2802581201,1916550,2533067819,2123613,269513382,2596,1558296,1997311331,1557179,1997184903,1117,126428,1540606,6254,1916423,216918,2596,1846,104000.0,26000.0,-69.0,-63.0,-72.0,-70.0,-67.0,-63.0,-69.0,-69.0,-77.0,-84.0,-75.0,-80.0,8.0,21.0,3.0,10.0,1
2092,CC:2F:71:3E:C5:1F,5530519,4451772710,3406906,4182259328,2123613,269513382,502,93213,8000882,78612,6270324,14601,1730558,21545,533,3414305,870692,502,2928,7222.0,1000.0,-73.0,-75.0,-70.0,-61.0,-71.0,-74.0,-68.0,-61.0,-77.0,-84.0,-75.0,-80.0,4.0,9.0,5.0,19.0,1
2093,F8:59:71:5A:E0:3D,3458782,2270336797,1335168,2000823355,2123614,269513442,294,757603,926342149,756909,926258612,694,83537,746221,1840,1335286,167238,294,1147,144444.0,43333.0,-68.0,-72.0,-64.0,-70.0,-68.0,-72.0,-63.0,-70.0,-77.0,-84.0,-75.0,-80.0,9.0,12.0,11.0,10.0,1
2094,CC:2F:71:3F:1F:24,4040326,2802793345,1916712,2533279903,2123614,269513442,2596,1558440,1997511379,1557323,1997384951,1117,126428,1540750,6254,1916584,216940,2596,1846,115556.0,28889.0,-69.0,-63.0,-72.0,-70.0,-68.0,-63.0,-69.0,-69.0,-77.0,-84.0,-75.0,-80.0,8.0,21.0,3.0,10.0,1
2095,CC:2F:71:3E:C5:1F,5530520,4451772770,3406906,4182259328,2123614,269513442,502,93213,8000882,78612,6270324,14601,1730558,21545,533,3414305,870692,502,2928,7222.0,1000.0,-73.0,-75.0,-70.0,-61.0,-71.0,-74.0,-68.0,-61.0,-77.0,-84.0,-75.0,-80.0,4.0,9.0,5.0,19.0,1
2096,F8:59:71:5A:E0:3D,3458944,2270584042,1335326,2001070196,2123618,269513846,294,757691,926448059,756997,926364522,694,83537,746309,1840,1335456,167249,294,1149,144444.0,43333.0,-69.0,-73.0,-65.0,-71.0,-67.0,-72.0,-64.0,-70.0,-77.0,-84.0,-75.0,-80.0,8.0,11.0,10.0,9.0,1
2097,CC:2F:71:3F:1F:24,4040494,2803009388,1916876,2533495542,2123618,269513846,2596,1558596,1997721540,1557479,1997595112,1117,126428,1540906,6254,1916749,216943,2596,1846,115556.0,28889.0,-68.0,-63.0,-68.0,-69.0,-67.0,-63.0,-68.0,-69.0,-77.0,-84.0,-75.0,-80.0,9.0,21.0,7.0,11.0,1
2098,CC:2F:71:3E:C5:1F,5530528,4451773578,3406906,4182259328,2123622,269514250,502,93213,8000882,78612,6270324,14601,1730558,21545,533,3414305,870692,502,2928,7222.0,1000.0,-73.0,-75.0,-70.0,-61.0,-71.0,-74.0,-68.0,-61.0,-77.0,-84.0,-75.0,-80.0,4.0,9.0,5.0,19.0,1
2099,F8:59:71:5A:E0:3D,3459013,2270685456,1335391,2001171206,2123622,269514250,294,757756,926548159,757062,926464622,694,83537,746374,1840,1335521,167252,294,1149,144444.0,43333.0,-66.0,-73.0,-63.0,-70.0,-67.0,-73.0,-63.0,-70.0,-77.0,-84.0,-75.0,-80.0,11.0,11.0,12.0,10.0,1
2100,CC:2F:71:3F:1F:24,4040671,2803219776,1917049,2533705526,2123622,269514250,2596,1558753,1997922748,1557636,1997796320,1117,126428,1541063,6254,1916922,216976,2596,1846,86667.0,14444.0,-69.0,-63.0,-68.0,-69.0,-70.0,-63.0,-69.0,-69.0,-77.0,-84.0,-75.0,-80.0,8.0,21.0,7.0,11.0,1
2101,CC:2F:71:3E:C5:1F,5530528,4451773578,3406906,4182259328,2123622,269514250,502,93213,8000882,78612,6270324,14601,1730558,21545,533,3414305,870692,502,2928,7222.0,1000.0,-73.0,-75.0,-70.0,-61.0,-71.0,-74.0,-68.0,-61.0,-77.0,-84.0,-75.0,-80.0,4.0,9.0,5.0,19.0,1
2102,F8:59:71:5A:E0:3D,3459095,2270805578,1335468,2001290864,2123627,269514714,294,757832,926665199,757138,926581662,694,83537,746450,1840,1335597,167260,294,1149,144444.0,43333.0,-69.0,-74.0,-64.0,-71.0,-67.0,-73.0,-63.0,-70.0,-77.0,-84.0,-75.0,-80.0,8.0,10.0,11.0,9.0,1
2103,CC:2F:71:3F:1F:24,4042803,2806289030,1919174,2536774114,2123629,269514916,2596,1559061,1998181399,1557944,1998054971,1117,126428,1541371,6254,1919047,217652,2596,1846,117000.0,39000.0,-68.0,-63.0,-68.0,-70.0,-68.0,-63.0,-69.0,-71.0,-76.0,-84.0,-74.0,-80.0,8.0,21.0,6.0,10.0,1
2104,CC:2F:71:3E:C5:1F,5530535,4451774244,3406906,4182259328,2123629,269514916,502,93213,8000882,78612,6270324,14601,1730558,21545,533,3414305,870692,502,2928,7222.0,1000.0,-73.0,-75.0,-70.0,-61.0,-71.0,-74.0,-68.0,-61.0,-76.0,-84.0,-74.0,-80.0,3.0,9.0,4.0,19.0,1
2105,F8:59:71:5A:E0:3D,3459161,2270902330,1335530,2001387212,2123631,269515118,294,757894,926760679,757200,926677142,694,83537,746512,1840,1335660,167262,294,1149,144444.0,43333.0,-67.0,-73.0,-62.0,-69.0,-68.0,-73.0,-63.0,-69.0,-76.0,-84.0,-74.0,-80.0,9.0,11.0,12.0,11.0,1
2106,CC:2F:71:3F:1F:24,4042975,2806497437,1919344,2536982319,2123631,269515118,2596,1559213,1998379754,1558096,1998253326,1117,126428,1541522,6254,1919217,217678,2596,1846,130000.0,43333.0,-68.0,-63.0,-69.0,-71.0,-68.0,-62.0,-69.0,-70.0,-76.0,-84.0,-74.0,-80.0,8.0,21.0,5.0,9.0,1
2107,CC:2F:71:3E:C5:1F,5530537,4451774446,3406906,4182259328,2123631,269515118,502,93213,8000882,78612,6270324,14601,1730558,21545,533,3414305,870692,502,2928,7222.0,1000.0,-73.0,-75.0,-70.0,-61.0,-71.0,-74.0,-68.0,-61.0,-76.0,-84.0,-74.0,-80.0,3.0,9.0,4.0,19.0,1
2108,F8:59:71:5A:E0:3D,3459308,2271120022,1335672,2001604440,2123636,269515582,294,757973,926862859,757279,926779322,694,83537,746591,1840,1335802,167279,294,1150,144444.0,43333.0,-67.0,-73.0,-63.0,-69.0,-67.0,-72.0,-62.0,-69.0,-76.0,-84.0,-74.0,-80.0,9.0,11.0,11.0,11.0,1
2109,CC:2F:71:3F:1F:24,4043139,2806703997,1919503,2537188415,2123636,269515582,2596,1559359,1998577286,1558242,1998450858,1117,126428,1541667,6254,1919376,217706,2596,1846,130000.0,43333.0,-70.0,-63.0,-69.0,-69.0,-69.0,-63.0,-69.0,-68.0,-76.0,-84.0,-74.0,-80.0,6.0,21.0,5.0,11.0,1
2110,CC:2F:71:3E:C5:1F,5530542,4451774910,3406906,4182259328,2123636,269515582,502,93213,8000882,78612,6270324,14601,1730558,21545,533,3414305,870692,502,2928,7222.0,1000.0,-73.0,-75.0,-70.0,-61.0,-71.0,-74.0,-68.0,-61.0,-76.0,-84.0,-74.0,-80.0,3.0,9.0,4.0,19.0,1
2111,F8:59:71:5A:E0:3D,3459385,2271233644,1335745,2001717658,2123640,269515986,294,758039,926960227,757345,926876690,694,83537,746657,1840,1335875,167280,294,1150,130000.0,39000.0,-67.0,-73.0,-63.0,-69.0,-67.0,-73.0,-62.0,-68.0,-76.0,-84.0,-74.0,-80.0,9.0,11.0,11.0,11.0,1
2112,CC:2F:71:3F:1F:24,4043300,2806909971,1919660,2537393985,2123640,269515986,2596,1559501,1998774254,1558384,1998647826,1117,126428,1541809,6254,1919531,217752,2596,1846,115556.0,28889.0,-68.0,-64.0,-67.0,-68.0,-68.0,-64.0,-67.0,-67.0,-76.0,-84.0,-74.0,-80.0,8.0,20.0,7.0,12.0,1
2113,CC:2F:71:3E:C5:1F,5530546,4451775314,3406906,4182259328,2123640,269515986,502,93213,8000882,78612,6270324,14601,1730558,21545,533,3414305,870692,502,2928,7222.0,1000.0,-73.0,-75.0,-70.0,-61.0,-71.0,-74.0,-68.0,-61.0,-76.0,-84.0,-74.0,-80.0,3.0,9.0,4.0,19.0,1
2114,F8:59:71:5A:E0:3D,3459452,2271331838,1335808,2001815448,2123644,269516390,294,758101,927055707,757407,926972170,694,83537,746719,1840,1335938,167286,294,1150,144444.0,43333.0,-68.0,-74.0,-62.0,-69.0,-67.0,-73.0,-62.0,-69.0,-76.0,-84.0,-74.0,-80.0,8.0,10.0,12.0,11.0,1
2115,CC:2F:71:3F:1F:24,4043461,2807115721,1919817,2537599331,2123644,269516390,2596,1559643,1998969798,1558526,1998843370,1117,126428,1541951,6254,1919688,217819,2596,1846,86667.0,14444.0,-69.0,-64.0,-68.0,-68.0,-68.0,-64.0,-68.0,-68.0,-76.0,-84.0,-74.0,-80.0,7.0,20.0,6.0,12.0,1
2116,CC:2F:71:3E:C5:1F,5530550,4451775718,3406906,4182259328,2123644,269516390,502,93213,8000882,78612,6270324,14601,1730558,21545,533,3414305,870692,502,2928,7222.0,1000.0,-73.0,-75.0,-70.0,-61.0,-71.0,-74.0,-68.0,-61.0,-76.0,-84.0,-74.0,-80.0,3.0,9.0,4.0,19.0,1
2117,F8:59:71:5A:E0:3D,3459585,2271493443,1335936,2001976589,2123649,269516854,294,758192,927162500,757498,927078963,694,83537,746810,1840,1336066,167288,294,1150,144444.0,43333.0,-67.0,-73.0,-63.0,-69.0,-67.0,-73.0,-62.0,-69.0,-76.0,-84.0,-74.0,-80.0,9.0,11.0,11.0,11.0,1
2118,CC:2F:71:3F:1F:24,4043625,2807322057,1919976,2537805203,2123649,269516854,2596,1559790,1999167336,1558673,1999040908,1117,126428,1542098,6254,1919849,217830,2596,1846,86667.0,14444.0,-69.0,-63.0,-68.0,-67.0,-68.0,-63.0,-68.0,-67.0,-76.0,-84.0,-74.0,-80.0,7.0,21.0,6.0,13.0,1
2119,CC:2F:71:3E:C5:1F,5530555,4451776182,3406906,4182259328,2123649,269516854,502,93213,8000882,78612,6270324,14601,1730558,21545,533,3414305,870692,502,2928,7222.0,1000.0,-73.0,-75.0,-70.0,-61.0,-71.0,-74.0,-68.0,-61.0,-76.0,-84.0,-74.0,-80.0,3.0,9.0,4.0,19.0,1
2120,F8:59:71:5A:E0:3D,3459651,2271593101,1336000,2002076045,2123651,269517056,294,758256,927261060,757562,927177523,694,83537,746874,1840,1336130,167290,294,1150,144444.0,43333.0,-66.0,-73.0,-63.0,-69.0,-66.0,-73.0,-62.0,-69.0,-76.0,-84.0,-74.0,-80.0,10.0,11.0,11.0,11.0,1
2121,CC:2F:71:3F:1F:24,4043787,2807528144,1920134,2538010886,2123653,269517258,2596,1559938,1999366463,1558821,1999240035,1117,126428,1542246,6254,1920007,217856,2596,1846,117000.0,39000.0,-70.0,-63.0,-70.0,-69.0,-69.0,-63.0,-69.0,-69.0,-76.0,-84.0,-74.0,-80.0,6.0,21.0,4.0,11.0,1
2122,CC:2F:71:3E:C5:1F,5530559,4451776586,3406906,4182259328,2123653,269517258,502,93213,8000882,78612,6270324,14601,1730558,21545,533,3414305,870692,502,2928,7222.0,1000.0,-73.0,-75.0,-70.0,-61.0,-71.0,-74.0,-68.0,-61.0,-76.0,-84.0,-74.0,-80.0,3.0,9.0,4.0,19.0,1
2123,F8:59:71:5A:E0:3D,3459721,2271691882,1336063,2002173947,2123658,269517935,294,758318,927356540,757624,927273003,694,83537,746936,1840,1336193,167291,294,1150,144444.0,43333.0,-67.0,-73.0,-62.0,-69.0,-67.0,-73.0,-62.0,-69.0,-76.0,-84.0,-74.0,-80.0,9.0,11.0,12.0,11.0,1
2124,CC:2F:71:3F:1F:24,4043947,2807731395,1920289,2538213460,2123658,269517935,2596,1560080,1999560583,1558963,1999434155,1117,126428,1542388,6254,1920162,217910,2596,1846,144444.0,43333.0,-68.0,-63.0,-69.0,-69.0,-68.0,-63.0,-69.0,-70.0,-76.0,-84.0,-74.0,-80.0,8.0,21.0,5.0,11.0,1
2125,CC:2F:71:3E:C5:1F,5530564,4451777263,3406906,4182259328,2123658,269517935,502,93213,8000882,78612,6270324,14601,1730558,21545,533,3414305,870692,502,2928,7222.0,1000.0,-73.0,-75.0,-70.0,-61.0,-71.0,-74.0,-68.0,-61.0,-76.0,-84.0,-74.0,-80.0,3.0,9.0,4.0,19.0,1
2126,F8:59:71:5A:E0:3D,3459783,2271786736,1336124,2002268741,2123659,269517995,294,758380,927452020,757686,927368483,694,83537,746998,1840,1336254,167291,294,1150,144444.0,43333.0,-67.0,-72.0,-63.0,-69.0,-66.0,-73.0,-62.0,-69.0,-76.0,-84.0,-74.0,-80.0,9.0,12.0,11.0,11.0,1
2127,CC:2F:71:3F:1F:24,4044103,2807934253,1920444,2538416258,2123659,269517995,2596,1560221,1999754587,1559104,1999628159,1117,126428,1542529,6254,1920317,217956,2596,1846,144444.0,39000.0,-68.0,-63.0,-68.0,-71.0,-67.0,-63.0,-68.0,-70.0,-76.0,-84.0,-74.0,-80.0,8.0,21.0,6.0,9.0,1
2128,CC:2F:71:3E:C5:1F,5530567,4451777525,3406906,4182259328,2123661,269518197,502,93213,8000882,78612,6270324,14601,1730558,21545,533,3414305,870692,502,2928,7222.0,1000.0,-73.0,-75.0,-70.0,-61.0,-71.0,-74.0,-68.0,-61.0,-76.0,-84.0,-74.0,-80.0,3.0,9.0,4.0,19.0,1
2129,F8:59:71:5A:E0:3D,3459854,2271886914,1336189,2002368313,2123665,269518601,294,758443,927549040,757749,927465503,694,83537,747061,1840,1336319,167292,294,1150,144444.0,43333.0,-67.0,-73.0,-63.0,-70.0,-66.0,-73.0,-63.0,-69.0,-76.0,-83.0,-74.0,-79.0,9.0,10.0,11.0,9.0,1
2130,CC:2F:71:3F:1F:24,4044270,2808140933,1920603,2538622130,2123667,269518803,2596,1560365,1999951843,1559248,1999825415,1117,126428,1542673,6254,1920476,218005,2596,1846,130000.0,1000.0,-68.0,-63.0,-68.0,-70.0,-68.0,-63.0,-68.0,-70.0,-76.0,-83.0,-74.0,-79.0,8.0,20.0,6.0,9.0,1
2131,CC:2F:71:3E:C5:1F,5530574,4451778247,3406907,4182259444,2123667,269518803,502,93214,8000952,78613,6270394,14601,1730558,21545,533,3414306,870692,502,2928,7222.0,1000.0,-66.0,-63.0,-65.0,-60.0,-70.0,-73.0,-68.0,-61.0,-76.0,-83.0,-74.0,-79.0,10.0,20.0,9.0,19.0,1
2132,F8:59:71:5A:E0:3D,3460132,2272268675,1336463,2002749504,2123669,269519171,294,758548,927656519,757854,927572982,694,83537,747166,1840,1336593,167293,294,1150,144444.0,43333.0,-66.0,-73.0,-63.0,-70.0,-66.0,-73.0,-62.0,-69.0,-76.0,-83.0,-74.0,-79.0,10.0,10.0,11.0,9.0,1
2133,CC:2F:71:3F:1F:24,4044435,2808353722,1920766,2538834551,2123669,269519171,2596,1560515,2000155474,1559398,2000029046,1117,126428,1542823,6254,1920638,218044,2596,1846,130000.0,39000.0,-66.0,-63.0,-67.0,-68.0,-67.0,-63.0,-67.0,-68.0,-76.0,-83.0,-74.0,-79.0,10.0,20.0,7.0,11.0,1
2134,CC:2F:71:3E:C5:1F,5530576,4451778615,3406907,4182259444,2123669,269519171,502,93215,8001022,78614,6270464,14601,1730558,21545,533,3414306,870692,502,2928,7222.0,1000.0,-68.0,-73.0,-67.0,-61.0,-70.0,-72.0,-68.0,-61.0,-76.0,-83.0,-74.0,-79.0,8.0,10.0,7.0,18.0,1
2135,F8:59:71:5A:E0:3D,3460212,2272371932,1336536,2002852173,2123676,269519759,294,758623,927756515,757928,927672860,695,83655,747241,1840,1336666,167295,294,1150,144444.0,43333.0,-67.0,-72.0,-63.0,-69.0,-67.0,-72.0,-63.0,-70.0,-76.0,-83.0,-74.0,-79.0,9.0,11.0,11.0,10.0,1
2136,CC:2F:71:3F:1F:24,4044604,2808564440,1920927,2539044619,2123677,269519821,2596,1560661,2000355746,1559543,2000229200,1118,126546,1542969,6254,1920800,218096,2596,1846,104000.0,26000.0,-68.0,-62.0,-68.0,-70.0,-67.0,-62.0,-68.0,-70.0,-76.0,-83.0,-74.0,-79.0,8.0,21.0,6.0,9.0,1
2137,CC:2F:71:3E:C5:1F,5530588,4451779669,3406907,4182259444,2123681,269520225,502,93217,8001210,78615,6270534,14602,1730676,21546,533,3414306,870692,502,2929,7222.0,1000.0,-70.0,-74.0,-66.0,-61.0,-70.0,-72.0,-67.0,-61.0,-76.0,-83.0,-74.0,-79.0,6.0,9.0,8.0,18.0,1
2138,F8:59:71:5A:E0:3D,3460286,2272479624,1336605,2002959399,2123681,269520225,294,758693,927864315,757998,927780660,695,83655,747311,1840,1336735,167298,294,1150,144444.0,43333.0,-68.0,-73.0,-63.0,-70.0,-67.0,-72.0,-63.0,-69.0,-76.0,-83.0,-74.0,-79.0,8.0,10.0,11.0,9.0,1
2139,CC:2F:71:3F:1F:24,4044775,2808783802,1921094,2539263577,2123681,269520225,2596,1560816,2000571464,1559698,2000444918,1118,126546,1543124,6254,1920967,218172,2596,1846,86667.0,14444.0,-67.0,-63.0,-67.0,-70.0,-67.0,-62.0,-67.0,-70.0,-76.0,-83.0,-74.0,-79.0,9.0,20.0,7.0,9.0,1
2140,CC:2F:71:3E:C5:1F,5530588,4451779669,3406907,4182259444,2123681,269520225,502,93217,8001210,78615,6270534,14602,1730676,21546,533,3414306,870692,502,2929,7222.0,1000.0,-70.0,-74.0,-66.0,-61.0,-70.0,-72.0,-67.0,-61.0,-76.0,-83.0,-74.0,-79.0,6.0,9.0,8.0,18.0,1
2141,F8:59:71:5A:E0:3D,3460536,2272862942,1336851,2003342313,2123685,269520629,294,758797,927969405,758102,927885750,695,83655,747415,1840,1336981,167307,294,1150,144444.0,43333.0,-68.0,-73.0,-64.0,-71.0,-67.0,-72.0,-63.0,-70.0,-76.0,-83.0,-74.0,-79.0,8.0,10.0,10.0,8.0,1
2142,CC:2F:71:3F:1F:24,4044939,2808992790,1921254,2539472161,2123685,269520629,2596,1560961,2000770218,1559843,2000643672,1118,126546,1543268,6254,1921127,218196,2596,1846,86667.0,13000.0,-69.0,-64.0,-74.0,-71.0,-67.0,-63.0,-68.0,-69.0,-76.0,-83.0,-74.0,-79.0,7.0,19.0,0.0,8.0,1
2143,CC:2F:71:3E:C5:1F,5530592,4451780073,3406907,4182259444,2123685,269520629,502,93217,8001210,78615,6270534,14602,1730676,21546,533,3414306,870692,502,2929,7222.0,1000.0,-70.0,-74.0,-66.0,-61.0,-70.0,-72.0,-67.0,-61.0,-76.0,-83.0,-74.0,-79.0,6.0,9.0,8.0,18.0,1
2144,F8:59:71:5A:E0:3D,3460714,2273098816,1337024,2003577723,2123690,269521093,294,758889,928074626,758194,927990971,695,83655,747507,1840,1337154,167314,294,1151,144444.0,43333.0,-67.0,-72.0,-64.0,-70.0,-67.0,-72.0,-63.0,-70.0,-76.0,-83.0,-74.0,-79.0,9.0,11.0,10.0,9.0,1
2145,CC:2F:71:3F:1F:24,4045113,2809206282,1921423,2539685189,2123690,269521093,2596,1561115,2000974406,1559997,2000847860,1118,126546,1543422,6254,1921296,218200,2596,1846,86667.0,14444.0,-67.0,-64.0,-70.0,-70.0,-66.0,-63.0,-68.0,-68.0,-76.0,-83.0,-74.0,-79.0,9.0,19.0,4.0,9.0,1
2146,CC:2F:71:3E:C5:1F,5530597,4451780537,3406907,4182259444,2123690,269521093,502,93217,8001210,78615,6270534,14602,1730676,21546,533,3414306,870692,502,2929,7222.0,1000.0,-70.0,-74.0,-66.0,-61.0,-70.0,-72.0,-67.0,-61.0,-76.0,-83.0,-74.0,-79.0,6.0,9.0,8.0,18.0,1
2147,F8:59:71:5A:E0:3D,3460782,2273198648,1337088,2003677151,2123694,269521497,294,758953,928171762,758258,928088107,695,83655,747571,1840,1337218,167329,294,1151,144444.0,43333.0,-68.0,-73.0,-64.0,-70.0,-67.0,-72.0,-63.0,-70.0,-75.0,-83.0,-73.0,-79.0,7.0,10.0,9.0,9.0,1
2148,CC:2F:71:3F:1F:24,4045274,2809412312,1921580,2539890815,2123694,269521497,2596,1561260,2001170298,1560142,2001043752,1118,126546,1543567,6254,1921452,218204,2596,1846,86667.0,14444.0,-68.0,-63.0,-72.0,-70.0,-67.0,-63.0,-69.0,-69.0,-75.0,-83.0,-73.0,-79.0,7.0,20.0,1.0,9.0,1
2149,CC:2F:71:3E:C5:1F,5530601,4451780941,3406907,4182259444,2123694,269521497,502,93217,8001210,78615,6270534,14602,1730676,21546,533,3414306,870692,502,2929,7222.0,1000.0,-70.0,-74.0,-66.0,-61.0,-70.0,-72.0,-67.0,-61.0,-75.0,-83.0,-73.0,-79.0,5.0,9.0,7.0,18.0,1
2150,F8:59:71:5A:E0:3D,3460854,2273300520,1337156,2003778619,2123698,269521901,294,759023,928275770,758328,928192115,695,83655,747640,1840,1337286,167340,294,1151,144444.0,43333.0,-67.0,-73.0,-63.0,-70.0,-67.0,-72.0,-63.0,-70.0,-75.0,-83.0,-73.0,-79.0,8.0,10.0,10.0,9.0,1
2151,CC:2F:71:3F:1F:24,4045446,2809622585,1921748,2540100684,2123698,269521901,2596,1561412,2001375661,1560294,2001249115,1118,126546,1543719,6254,1921621,218216,2596,1846,86667.0,14444.0,-67.0,-63.0,-68.0,-69.0,-66.0,-63.0,-67.0,-69.0,-75.0,-83.0,-73.0,-79.0,8.0,20.0,5.0,10.0,1
2152,CC:2F:71:3E:C5:1F,5530606,4451781405,3406907,4182259444,2123699,269521961,502,93217,8001210,78615,6270534,14602,1730676,21546,533,3414306,870692,502,2929,7222.0,1000.0,-70.0,-74.0,-66.0,-61.0,-70.0,-72.0,-67.0,-61.0,-75.0,-83.0,-73.0,-79.0,5.0,9.0,7.0,18.0,1
2153,F8:59:71:5A:E0:3D,3460920,2273398572,1337219,2003876409,2123701,269522163,294,759086,928372790,758391,928289135,695,83655,747703,1840,1337349,167346,294,1151,144444.0,43333.0,-67.0,-72.0,-63.0,-70.0,-67.0,-72.0,-63.0,-70.0,-75.0,-83.0,-73.0,-79.0,8.0,11.0,10.0,9.0,1
2154,CC:2F:71:3F:1F:24,4045607,2809825697,1921904,2540303332,2123703,269522365,2596,1561555,2001569897,1560437,2001443351,1118,126546,1543862,6254,1921777,218217,2596,1846,86667.0,14444.0,-66.0,-63.0,-67.0,-69.0,-66.0,-63.0,-67.0,-69.0,-75.0,-83.0,-73.0,-79.0,9.0,20.0,6.0,10.0,1
2155,CC:2F:71:3E:C5:1F,5530610,4451781809,3406907,4182259444,2123703,269522365,502,93217,8001210,78615,6270534,14602,1730676,21546,533,3414306,870692,502,2929,7222.0,1000.0,-70.0,-74.0,-66.0,-61.0,-70.0,-72.0,-67.0,-61.0,-75.0,-83.0,-73.0,-79.0,5.0,9.0,7.0,18.0,1
2156,F8:59:71:5A:E0:3D,3460990,2273497196,1337283,2003974427,2123707,269522769,294,759150,928469916,758455,928386261,695,83655,747767,1840,1337413,167353,294,1151,144444.0,43333.0,-67.0,-72.0,-63.0,-70.0,-67.0,-72.0,-63.0,-69.0,-75.0,-83.0,-73.0,-79.0,8.0,11.0,10.0,9.0,1
2157,CC:2F:71:3F:1F:24,4045768,2810031727,1922061,2540508958,2123707,269522769,2596,1561702,2001768883,1560584,2001642337,1118,126546,1544008,6254,1921934,218220,2596,1846,86667.0,14444.0,-66.0,-63.0,-67.0,-69.0,-66.0,-63.0,-68.0,-69.0,-75.0,-83.0,-73.0,-79.0,9.0,20.0,6.0,10.0,1
2158,CC:2F:71:3E:C5:1F,5530614,4451782213,3406907,4182259444,2123707,269522769,502,93217,8001210,78615,6270534,14602,1730676,21546,533,3414306,870692,502,2929,7222.0,1000.0,-70.0,-74.0,-66.0,-61.0,-70.0,-72.0,-67.0,-61.0,-75.0,-83.0,-73.0,-79.0,5.0,9.0,7.0,18.0,1
2159,F8:59:71:5A:E0:3D,3461054,2273592318,1337344,2004069221,2123710,269523097,294,759212,928565396,758517,928481741,695,83655,747829,1840,1337474,167359,294,1151,144444.0,43333.0,-67.0,-72.0,-63.0,-70.0,-67.0,-72.0,-63.0,-69.0,-75.0,-83.0,-73.0,-79.0,8.0,11.0,10.0,9.0,1
2160,CC:2F:71:3F:1F:24,4045928,2810234539,1922217,2540711382,2123711,269523157,2596,1561845,2001963119,1560727,2001836573,1118,126546,1544151,6254,1922090,218236,2596,1846,86667.0,14444.0,-67.0,-63.0,-68.0,-69.0,-66.0,-63.0,-67.0,-69.0,-75.0,-83.0,-73.0,-79.0,8.0,20.0,5.0,10.0,1
2161,CC:2F:71:3E:C5:1F,5530618,4451782601,3406907,4182259444,2123711,269523157,502,93217,8001210,78615,6270534,14602,1730676,21546,533,3414306,870692,502,2929,7222.0,1000.0,-70.0,-74.0,-66.0,-61.0,-70.0,-72.0,-67.0,-61.0,-75.0,-83.0,-73.0,-79.0,5.0,9.0,7.0,18.0,1
2162,F8:59:71:5A:E0:3D,3461124,2273690886,1337407,2004167123,2123717,269523763,294,759275,928662416,758580,928578761,695,83655,747892,1840,1337537,167367,294,1151,144444.0,43333.0,-68.0,-73.0,-63.0,-70.0,-68.0,-72.0,-63.0,-70.0,-75.0,-83.0,-73.0,-79.0,7.0,10.0,10.0,9.0,1
2163,CC:2F:71:3F:1F:24,4046091,2810439347,1922374,2540915584,2123717,269523763,2596,1561990,2002160435,1560872,2002033889,1118,126546,1544296,6254,1922247,218237,2596,1846,86667.0,14444.0,-68.0,-63.0,-72.0,-70.0,-66.0,-63.0,-69.0,-69.0,-75.0,-83.0,-73.0,-79.0,7.0,20.0,1.0,9.0,1
2164,CC:2F:71:3E:C5:1F,5530624,4451783207,3406907,4182259444,2123717,269523763,502,93217,8001210,78615,6270534,14602,1730676,21546,533,3414306,870692,502,2929,7222.0,1000.0,-70.0,-74.0,-66.0,-61.0,-70.0,-72.0,-67.0,-61.0,-75.0,-82.0,-73.0,-79.0,5.0,8.0,7.0,18.0,1
2165,F8:59:71:5A:E0:3D,3461338,2274020832,1337619,2004496867,2123719,269523965,294,759372,928766778,758677,928683123,695,83655,747989,1840,1337749,167383,294,1151,144444.0,43333.0,-67.0,-72.0,-63.0,-70.0,-67.0,-71.0,-63.0,-70.0,-75.0,-82.0,-73.0,-79.0,8.0,10.0,10.0,9.0,1
2166,CC:2F:71:3F:1F:24,4046269,2810654228,1922550,2541130263,2123719,269523965,2596,1562147,2002365016,1561029,2002238470,1118,126546,1544453,6254,1922423,218238,2596,1846,86667.0,14444.0,-67.0,-63.0,-68.0,-69.0,-66.0,-63.0,-67.0,-69.0,-75.0,-82.0,-73.0,-79.0,8.0,19.0,5.0,10.0,1
2167,CC:2F:71:3E:C5:1F,5530627,4451783682,3406907,4182259444,2123720,269524238,502,93217,8001210,78615,6270534,14602,1730676,21546,533,3414306,870692,502,2929,7222.0,1000.0,-70.0,-74.0,-66.0,-61.0,-70.0,-72.0,-67.0,-61.0,-75.0,-82.0,-73.0,-79.0,5.0,8.0,7.0,18.0,1
2168,F8:59:71:5A:E0:3D,3461414,2274121944,1337689,2004597242,2123725,269524702,294,759441,928867300,758746,928783645,695,83655,748057,1840,1337819,167391,294,1151,144444.0,43333.0,-68.0,-73.0,-63.0,-70.0,-68.0,-72.0,-63.0,-70.0,-75.0,-82.0,-73.0,-79.0,7.0,9.0,10.0,9.0,1
2169,CC:2F:71:3F:1F:24,4046432,2810860367,1922707,2541335665,2123725,269524702,2596,1562291,2002562326,1561173,2002435780,1118,126546,1544596,6254,1922580,218248,2596,1846,86667.0,14444.0,-67.0,-64.0,-68.0,-69.0,-67.0,-63.0,-69.0,-69.0,-75.0,-82.0,-73.0,-79.0,8.0,18.0,5.0,10.0,1
2170,CC:2F:71:3E:C5:1F,5530632,4451784146,3406907,4182259444,2123725,269524702,502,93217,8001210,78615,6270534,14602,1730676,21546,533,3414306,870692,502,2929,7222.0,1000.0,-70.0,-74.0,-66.0,-61.0,-70.0,-72.0,-67.0,-61.0,-75.0,-82.0,-73.0,-79.0,5.0,8.0,7.0,18.0,1
2171,F8:59:71:5A:E0:3D,3461698,2274524355,1337971,2004999451,2123727,269524904,294,759546,928972643,758851,928888988,695,83655,748162,1840,1338101,167392,294,1151,144444.0,43333.0,-67.0,-72.0,-63.0,-69.0,-67.0,-72.0,-63.0,-70.0,-75.0,-82.0,-73.0,-79.0,8.0,10.0,10.0,10.0,1
2172,CC:2F:71:3F:1F:24,4048413,2813711804,1924686,2544186900,2123727,269524904,2596,1562674,2002796328,1561556,2002669782,1118,126546,1544979,6254,1924557,218251,2596,1846,86667.0,14444.0,-68.0,-64.0,-72.0,-70.0,-67.0,-63.0,-69.0,-69.0,-75.0,-82.0,-73.0,-79.0,7.0,18.0,1.0,9.0,1
2173,CC:2F:71:3E:C5:1F,5530636,4451784550,3406907,4182259444,2123729,269525106,502,93217,8001210,78615,6270534,14602,1730676,21546,533,3414306,870692,502,2929,7222.0,1000.0,-70.0,-74.0,-66.0,-61.0,-70.0,-72.0,-67.0,-61.0,-75.0,-82.0,-73.0,-79.0,5.0,8.0,7.0,18.0,1
2174,F8:59:71:5A:E0:3D,3461762,2274620905,1338033,2005095799,2123729,269525106,294,759610,929071217,758915,928987562,695,83655,748225,1840,1338163,167395,294,1151,144444.0,43333.0,-67.0,-73.0,-63.0,-70.0,-67.0,-72.0,-63.0,-70.0,-75.0,-82.0,-73.0,-79.0,8.0,9.0,10.0,9.0,1
2175,CC:2F:71:3F:1F:24,4048579,2813915378,1924848,2544390070,2123731,269525308,2596,1562826,2002990799,1561708,2002864253,1118,126546,1545130,6254,1924720,218251,2596,1846,86667.0,14444.0,-68.0,-64.0,-72.0,-71.0,-67.0,-63.0,-69.0,-70.0,-75.0,-82.0,-73.0,-79.0,7.0,18.0,1.0,8.0,1
2176,CC:2F:71:3E:C5:1F,5530640,4451784954,3406907,4182259444,2123733,269525510,502,93217,8001210,78615,6270534,14602,1730676,21546,533,3414306,870692,502,2929,7222.0,1000.0,-70.0,-74.0,-66.0,-61.0,-70.0,-72.0,-67.0,-61.0,-75.0,-82.0,-73.0,-79.0,5.0,8.0,7.0,18.0,1
2177,F8:59:71:5A:E0:3D,3461833,2274719603,1338097,2005193831,2123736,269525772,294,759674,929168367,758979,929084712,695,83655,748288,1840,1338227,167399,294,1151,144444.0,43333.0,-67.0,-73.0,-64.0,-70.0,-67.0,-73.0,-64.0,-70.0,-76.0,-83.0,-74.0,-80.0,9.0,10.0,10.0,10.0,1
2178,CC:2F:71:3F:1F:24,4048742,2814122910,1925006,2544597138,2123736,269525772,2596,1562972,2003191107,1561854,2003064561,1118,126546,1545276,6254,1924879,218276,2596,1846,117000.0,39000.0,-66.0,-62.0,-72.0,-72.0,-67.0,-62.0,-71.0,-72.0,-76.0,-83.0,-74.0,-80.0,10.0,21.0,2.0,8.0,1
2179,CC:2F:71:3E:C5:1F,5530643,4451785216,3406907,4182259444,2123736,269525772,502,93217,8001210,78615,6270534,14602,1730676,21546,533,3414306,870692,502,2929,7222.0,1000.0,-70.0,-74.0,-66.0,-61.0,-70.0,-72.0,-67.0,-61.0,-76.0,-83.0,-74.0,-80.0,6.0,9.0,8.0,19.0,1
2180,F8:59:71:5A:E0:3D,3462006,2274982653,1338268,2005456679,2123738,269525974,294,759765,929273412,759070,929189757,695,83655,748379,1840,1338398,167405,294,1151,130000.0,39000.0,-69.0,-74.0,-64.0,-72.0,-68.0,-72.0,-63.0,-70.0,-76.0,-83.0,-74.0,-80.0,7.0,9.0,10.0,8.0,1
2181,CC:2F:71:3F:1F:24,4048903,2814329222,1925165,2544803248,2123738,269525974,2596,1563121,2003388858,1562003,2003262312,1118,126546,1545423,6254,1925038,218285,2596,1846,130000.0,43333.0,-66.0,-63.0,-68.0,-72.0,-66.0,-63.0,-69.0,-72.0,-76.0,-83.0,-74.0,-80.0,10.0,20.0,6.0,8.0,1
2182,CC:2F:71:3E:C5:1F,5530645,4451785418,3406907,4182259444,2123738,269525974,502,93219,8001350,78617,6270674,14602,1730676,21546,533,3414307,870692,502,2929,7222.0,1000.0,-73.0,-74.0,-70.0,-62.0,-70.0,-72.0,-68.0,-61.0,-76.0,-83.0,-74.0,-80.0,3.0,9.0,4.0,18.0,1
2183,F8:59:71:5A:E0:3D,3462080,2275080414,1338336,2005553834,2123744,269526580,294,759833,929373894,759138,929290239,695,83655,748446,1840,1338466,167408,294,1151,144444.0,43333.0,-67.0,-73.0,-63.0,-70.0,-67.0,-72.0,-63.0,-70.0,-76.0,-83.0,-74.0,-80.0,9.0,10.0,11.0,10.0,1
2184,CC:2F:71:3F:1F:24,4049067,2814536144,1925323,2545009564,2123744,269526580,2596,1563266,2003587520,1562148,2003460974,1118,126546,1545565,6254,1925196,218290,2596,1846,130000.0,43333.0,-67.0,-63.0,-67.0,-71.0,-67.0,-63.0,-68.0,-70.0,-76.0,-83.0,-74.0,-80.0,9.0,20.0,7.0,9.0,1
2185,CC:2F:71:3E:C5:1F,5530651,4451786024,3406907,4182259444,2123744,269526580,502,93219,8001350,78617,6270674,14602,1730676,21546,533,3414307,870692,502,2929,7222.0,1000.0,-73.0,-74.0,-70.0,-62.0,-70.0,-72.0,-68.0,-61.0,-76.0,-83.0,-74.0,-80.0,3.0,9.0,4.0,18.0,1
2186,F8:59:71:5A:E0:3D,3462146,2275178578,1338399,2005651736,2123747,269526842,294,759896,929470914,759201,929387259,695,83655,748509,1840,1338529,167414,294,1151,144444.0,43333.0,-68.0,-73.0,-63.0,-70.0,-67.0,-72.0,-63.0,-70.0,-76.0,-83.0,-74.0,-80.0,8.0,10.0,11.0,10.0,1
2187,CC:2F:71:3F:1F:24,4049237,2814745510,1925490,2545218668,2123747,269526842,2596,1563416,2003787589,1562298,2003661043,1118,126546,1545714,6254,1925363,218316,2596,1846,130000.0,43333.0,-67.0,-63.0,-67.0,-70.0,-67.0,-63.0,-67.0,-70.0,-76.0,-83.0,-74.0,-80.0,9.0,20.0,7.0,10.0,1
2188,CC:2F:71:3E:C5:1F,5530654,4451786286,3406907,4182259444,2123747,269526842,502,93219,8001350,78617,6270674,14602,1730676,21546,533,3414307,870692,502,2929,7222.0,1000.0,-73.0,-74.0,-70.0,-62.0,-70.0,-72.0,-68.0,-61.0,-76.0,-83.0,-74.0,-80.0,3.0,9.0,4.0,18.0,1
2189,F8:59:71:5A:E0:3D,3462217,2275280194,1338464,2005752746,2123753,269527448,294,759960,929569474,759265,929485819,695,83655,748573,1840,1338594,167419,294,1151,144444.0,43333.0,-69.0,-73.0,-64.0,-71.0,-68.0,-73.0,-63.0,-70.0,-76.0,-83.0,-74.0,-80.0,7.0,10.0,10.0,9.0,1
2190,CC:2F:71:3F:1F:24,4049402,2814953762,1925649,2545426314,2123753,269527448,2596,1563563,2003987985,1562445,2003861439,1118,126546,1545861,6254,1925522,218365,2596,1846,130000.0,43333.0,-67.0,-63.0,-68.0,-70.0,-67.0,-63.0,-68.0,-70.0,-76.0,-83.0,-74.0,-80.0,9.0,20.0,6.0,10.0,1
2191,CC:2F:71:3E:C5:1F,5530660,4451786892,3406907,4182259444,2123753,269527448,502,93219,8001350,78617,6270674,14602,1730676,21546,533,3414307,870692,502,2929,7222.0,1000.0,-73.0,-74.0,-70.0,-62.0,-70.0,-72.0,-68.0,-61.0,-76.0,-83.0,-74.0,-80.0,3.0,9.0,4.0,18.0,1
2192,F8:59:71:5A:E0:3D,3462281,2275376744,1338526,2005849094,2123755,269527650,294,760023,929666494,759328,929582839,695,83655,748636,1840,1338656,167423,294,1151,144444.0,43333.0,-67.0,-72.0,-64.0,-70.0,-67.0,-72.0,-63.0,-70.0,-76.0,-83.0,-74.0,-80.0,9.0,11.0,10.0,10.0,1
2193,CC:2F:71:3F:1F:24,4049562,2815159664,1925807,2545632014,2123755,269527650,2596,1563707,2004185185,1562589,2004058639,1118,126546,1546005,6254,1925680,218423,2596,1846,115556.0,28889.0,-69.0,-63.0,-72.0,-71.0,-68.0,-63.0,-70.0,-70.0,-76.0,-83.0,-74.0,-80.0,7.0,20.0,2.0,9.0,1
2194,CC:2F:71:3E:C5:1F,5530662,4451787094,3406907,4182259444,2123755,269527650,502,93219,8001350,78617,6270674,14602,1730676,21546,533,3414307,870692,502,2929,7222.0,1000.0,-73.0,-74.0,-70.0,-62.0,-70.0,-72.0,-68.0,-61.0,-76.0,-83.0,-74.0,-80.0,3.0,9.0,4.0,18.0,1
2195,F8:59:71:5A:E0:3D,3462554,2275750800,1338792,2006222484,2123762,269528316,294,760144,929780081,759449,929696426,695,83655,748757,1840,1338922,167432,294,1151,144444.0,43333.0,-69.0,-73.0,-65.0,-71.0,-67.0,-72.0,-64.0,-70.0,-76.0,-83.0,-74.0,-80.0,7.0,10.0,9.0,9.0,1
2196,CC:2F:71:3F:1F:24,4049735,2815378310,1925973,2545849994,2123762,269528316,2596,1563859,2004394759,1562741,2004268213,1118,126546,1546157,6254,1925846,218492,2596,1846,78000.0,13000.0,-67.0,-63.0,-67.0,-70.0,-67.0,-63.0,-68.0,-70.0,-76.0,-83.0,-74.0,-80.0,9.0,20.0,7.0,10.0,1
2197,CC:2F:71:3E:C5:1F,5530669,4451787760,3406907,4182259444,2123762,269528316,502,93219,8001350,78617,6270674,14602,1730676,21546,533,3414307,870692,502,2929,7222.0,1000.0,-73.0,-74.0,-70.0,-62.0,-70.0,-72.0,-68.0,-61.0,-76.0,-83.0,-74.0,-80.0,3.0,9.0,4.0,18.0,1
2198,F8:59:71:5A:E0:3D,3462622,2275853566,1338858,2006325048,2123764,269528518,294,760211,929883261,759516,929799606,695,83655,748824,1840,1338988,167435,294,1151,144444.0,43333.0,-67.0,-73.0,-63.0,-70.0,-67.0,-72.0,-63.0,-69.0,-76.0,-83.0,-74.0,-80.0,9.0,10.0,11.0,10.0,1
2199,CC:2F:71:3F:1F:24,4049893,2815581160,1926129,2546052642,2123764,269528518,2596,1564002,2004590489,1562884,2004463943,1118,126546,1546300,6254,1926001,218496,2596,1846,86667.0,14444.0,-68.0,-63.0,-71.0,-70.0,-67.0,-63.0,-68.0,-69.0,-76.0,-83.0,-74.0,-80.0,8.0,20.0,3.0,10.0,1
2200,CC:2F:71:3E:C5:1F,5530671,4451787962,3406907,4182259444,2123764,269528518,502,93219,8001350,78617,6270674,14602,1730676,21546,533,3414307,870692,502,2929,7222.0,1000.0,-73.0,-74.0,-70.0,-62.0,-70.0,-72.0,-68.0,-61.0,-76.0,-83.0,-74.0,-80.0,3.0,9.0,4.0,18.0,1
2201,F8:59:71:5A:E0:3D,3462692,2275956534,1338924,2006427612,2123768,269528922,294,760278,929986455,759583,929902800,695,83655,748890,1840,1339054,167440,294,1151,144444.0,43333.0,-67.0,-72.0,-63.0,-70.0,-68.0,-73.0,-64.0,-70.0,-75.0,-83.0,-73.0,-79.0,8.0,11.0,10.0,9.0,1
2202,CC:2F:71:3F:1F:24,4050066,2815802894,1926298,2546273972,2123768,269528922,2596,1564155,2004801561,1563037,2004675015,1118,126546,1546453,6254,1926171,218523,2596,1846,115556.0,28889.0,-69.0,-63.0,-72.0,-71.0,-67.0,-63.0,-69.0,-70.0,-75.0,-83.0,-73.0,-79.0,6.0,20.0,1.0,8.0,1
2203,CC:2F:71:3E:C5:1F,5530677,4451788568,3406907,4182259444,2123770,269529124,502,93219,8001350,78617,6270674,14602,1730676,21546,533,3414307,870692,502,2929,7222.0,1000.0,-73.0,-74.0,-70.0,-62.0,-70.0,-72.0,-68.0,-61.0,-75.0,-83.0,-73.0,-79.0,2.0,9.0,3.0,17.0,1
2204,F8:59:71:5A:E0:3D,3462761,2276056454,1338988,2006527068,2123773,269529386,294,760341,930083475,759646,929999820,695,83655,748953,1840,1339118,167445,294,1151,144444.0,43333.0,-68.0,-73.0,-63.0,-70.0,-67.0,-72.0,-63.0,-69.0,-75.0,-83.0,-73.0,-79.0,7.0,10.0,10.0,9.0,1
2205,CC:2F:71:3F:1F:24,4050242,2816011058,1926469,2546481672,2123773,269529386,2596,1564315,2005001756,1563197,2004875210,1118,126546,1546613,6254,1926342,218575,2596,1846,115556.0,28889.0,-69.0,-63.0,-71.0,-71.0,-67.0,-63.0,-68.0,-70.0,-75.0,-83.0,-73.0,-79.0,6.0,20.0,2.0,8.0,1
2206,CC:2F:71:3E:C5:1F,5530680,4451788830,3406907,4182259444,2123773,269529386,502,93219,8001350,78617,6270674,14602,1730676,21546,533,3414307,870692,502,2929,7222.0,1000.0,-73.0,-74.0,-70.0,-62.0,-70.0,-72.0,-68.0,-61.0,-75.0,-83.0,-73.0,-79.0,2.0,9.0,3.0,17.0,1
2207,F8:59:71:5A:E0:3D,3462826,2276154558,1339051,2006624970,2123775,269529588,294,760407,930185157,759712,930101502,695,83655,749016,1840,1339181,167445,294,1151,144444.0,43333.0,-67.0,-72.0,-63.0,-70.0,-67.0,-72.0,-63.0,-70.0,-75.0,-83.0,-73.0,-79.0,8.0,11.0,10.0,9.0,1
2208,CC:2F:71:3F:1F:24,4050410,2816221219,1926634,2546691563,2123776,269529656,2596,1564462,2005200865,1563344,2005074319,1118,126546,1546760,6254,1926506,218630,2596,1846,78000.0,13000.0,-69.0,-64.0,-71.0,-71.0,-67.0,-63.0,-68.0,-69.0,-75.0,-83.0,-73.0,-79.0,6.0,19.0,2.0,8.0,1
2209,CC:2F:71:3E:C5:1F,5530684,4451789234,3406907,4182259444,2123777,269529790,502,93219,8001350,78617,6270674,14602,1730676,21546,533,3414307,870692,502,2929,7222.0,1000.0,-73.0,-74.0,-70.0,-62.0,-70.0,-72.0,-68.0,-61.0,-75.0,-83.0,-73.0,-79.0,2.0,9.0,3.0,17.0,1
2210,F8:59:71:5A:E0:3D,3462896,2276253339,1339114,2006722872,2123782,269530467,294,760471,930283731,759776,930200076,695,83655,749079,1840,1339244,167449,294,1151,144444.0,43333.0,-69.0,-73.0,-64.0,-71.0,-67.0,-72.0,-63.0,-70.0,-75.0,-83.0,-73.0,-79.0,6.0,10.0,9.0,8.0,1
2211,CC:2F:71:3F:1F:24,4050572,2816424510,1926790,2546894043,2123782,269530467,2596,1564605,2005396525,1563487,2005269979,1118,126546,1546903,6254,1926663,218638,2596,1846,130000.0,39000.0,-68.0,-63.0,-72.0,-74.0,-67.0,-63.0,-70.0,-72.0,-75.0,-83.0,-73.0,-79.0,7.0,20.0,1.0,5.0,1
2212,CC:2F:71:3E:C5:1F,5530690,4451789971,3406907,4182259444,2123783,269530527,502,93219,8001350,78617,6270674,14602,1730676,21546,533,3414307,870692,502,2929,7222.0,1000.0,-73.0,-74.0,-70.0,-62.0,-70.0,-72.0,-68.0,-61.0,-75.0,-83.0,-73.0,-79.0,2.0,9.0,3.0,17.0,1
2213,F8:59:71:5A:E0:3D,3462959,2276349747,1339176,2006819220,2123783,269530527,294,760534,930380751,759839,930297096,695,83655,749142,1840,1339306,167451,294,1151,144444.0,43333.0,-67.0,-73.0,-63.0,-70.0,-67.0,-73.0,-63.0,-70.0,-75.0,-83.0,-73.0,-79.0,8.0,10.0,10.0,9.0,1
2214,CC:2F:71:3F:1F:24,4050734,2816631058,1926949,2547100329,2123785,269530729,2596,1564753,2005594213,1563635,2005467667,1118,126546,1547051,6254,1926822,218649,2596,1846,130000.0,43333.0,-68.0,-63.0,-73.0,-73.0,-67.0,-63.0,-70.0,-72.0,-75.0,-83.0,-73.0,-79.0,7.0,20.0,0.0,6.0,1
2215,CC:2F:71:3E:C5:1F,5530692,4451790173,3406907,4182259444,2123785,269530729,502,93219,8001350,78617,6270674,14602,1730676,21546,533,3414307,870692,502,2929,7222.0,1000.0,-73.0,-74.0,-70.0,-62.0,-70.0,-72.0,-68.0,-61.0,-75.0,-83.0,-73.0,-79.0,2.0,9.0,3.0,17.0,1
2216,F8:59:71:5A:E0:3D,3463058,2276470097,1339247,2006928116,2123811,269541981,294,760603,930487095,759908,930403440,695,83655,749211,1840,1339377,167455,294,1151,144444.0,43333.0,-69.0,-73.0,-64.0,-71.0,-68.0,-73.0,-63.0,-71.0,-75.0,-83.0,-73.0,-79.0,6.0,10.0,9.0,8.0,1
2217,CC:2F:71:3F:1F:24,4050956,2816875105,1927143,2547332922,2123813,269542183,2596,1564932,2005819977,1563814,2005693431,1118,126546,1547230,6254,1927015,218657,2596,1846,130000.0,43333.0,-67.0,-63.0,-68.0,-72.0,-68.0,-63.0,-70.0,-73.0,-75.0,-83.0,-73.0,-79.0,8.0,20.0,5.0,7.0,1
2218,CC:2F:71:3E:C5:1F,5530721,4451801743,3406908,4182259560,2123813,269542183,502,93221,8001490,78619,6270814,14602,1730676,21546,533,3414308,870692,502,2929,7222.0,1000.0,-69.0,-72.0,-67.0,-61.0,-70.0,-72.0,-67.0,-61.0,-75.0,-83.0,-73.0,-79.0,6.0,11.0,6.0,18.0,1
2219,F8:59:71:5A:E0:3D,3463313,2276853988,1339499,2007311745,2123814,269542243,294,760711,930593894,760016,930510239,695,83655,749319,1840,1339629,167468,294,1151,144444.0,43333.0,-69.0,-74.0,-64.0,-71.0,-68.0,-73.0,-63.0,-70.0,-75.0,-83.0,-73.0,-79.0,6.0,9.0,9.0,8.0,1
2220,CC:2F:71:3F:1F:24,4051115,2817081257,1927301,2547539014,2123814,269542243,2596,1565077,2006015869,1563959,2005889323,1118,126546,1547375,6254,1927174,218675,2596,1846,130000.0,43333.0,-69.0,-63.0,-71.0,-72.0,-68.0,-63.0,-70.0,-71.0,-75.0,-83.0,-73.0,-79.0,6.0,20.0,2.0,7.0,1
2221,CC:2F:71:3E:C5:1F,5530724,4451802005,3406908,4182259560,2123816,269542445,502,93221,8001490,78619,6270814,14602,1730676,21546,533,3414308,870692,502,2929,7222.0,1000.0,-69.0,-72.0,-67.0,-61.0,-70.0,-72.0,-67.0,-61.0,-75.0,-83.0,-73.0,-79.0,6.0,11.0,6.0,18.0,1
2222,F8:59:71:5A:E0:3D,3463580,2277222611,1339760,2007679762,2123820,269542849,294,760813,930700073,760118,930616418,695,83655,749421,1840,1339890,167471,294,1151,144444.0,43333.0,-69.0,-73.0,-64.0,-72.0,-67.0,-72.0,-63.0,-70.0,-75.0,-83.0,-73.0,-79.0,6.0,10.0,9.0,7.0,1
2223,CC:2F:71:3F:1F:24,4051281,2817291161,1927461,2547748312,2123820,269542849,2596,1565223,2006214715,1564105,2006088169,1118,126546,1547521,6254,1927333,218694,2596,1846,117000.0,39000.0,-69.0,-63.0,-72.0,-72.0,-68.0,-63.0,-71.0,-72.0,-76.0,-83.0,-74.0,-80.0,7.0,20.0,2.0,8.0,1
2224,CC:2F:71:3E:C5:1F,5530728,4451802409,3406908,4182259560,2123820,269542849,502,93221,8001490,78619,6270814,14602,1730676,21546,533,3414308,870692,502,2929,7222.0,1000.0,-69.0,-72.0,-67.0,-61.0,-70.0,-72.0,-67.0,-61.0,-76.0,-83.0,-74.0,-80.0,7.0,11.0,7.0,19.0,1
2225,F8:59:71:5A:E0:3D,3463646,2277322269,1339824,2007779218,2123822,269543051,294,760876,930797093,760181,930713438,695,83655,749484,1840,1339954,167476,294,1151,144444.0,43333.0,-67.0,-73.0,-63.0,-70.0,-67.0,-73.0,-63.0,-70.0,-76.0,-83.0,-74.0,-80.0,9.0,10.0,11.0,10.0,1
2226,CC:2F:71:3F:1F:24,4051440,2817496013,1927618,2547952962,2123822,269543051,2596,1565368,2006412031,1564250,2006285485,1118,126546,1547666,6254,1927491,218698,2596,1846,130000.0,43333.0,-67.0,-63.0,-66.0,-70.0,-68.0,-63.0,-69.0,-71.0,-76.0,-83.0,-74.0,-80.0,9.0,20.0,8.0,10.0,1
2227,CC:2F:71:3E:C5:1F,5530730,4451802611,3406908,4182259560,2123822,269543051,502,93221,8001490,78619,6270814,14602,1730676,21546,533,3414308,870692,502,2929,7222.0,1000.0,-69.0,-72.0,-67.0,-61.0,-70.0,-72.0,-67.0,-61.0,-76.0,-83.0,-74.0,-80.0,7.0,11.0,7.0,19.0,1
2228,F8:59:71:5A:E0:3D,3463715,2277419283,1339886,2007875566,2123829,269543717,294,760939,930894113,760244,930810458,695,83655,749547,1840,1340016,167477,294,1151,144444.0,43333.0,-67.0,-71.0,-63.0,-70.0,-67.0,-72.0,-63.0,-70.0,-76.0,-83.0,-74.0,-80.0,9.0,12.0,11.0,10.0,1
2229,CC:2F:71:3F:1F:24,4051618,2817706839,1927789,2548163122,2123829,269543717,2596,1565523,2006613530,1564405,2006486984,1118,126546,1547821,6254,1927662,218704,2596,1846,130000.0,43333.0,-68.0,-63.0,-67.0,-71.0,-68.0,-63.0,-68.0,-70.0,-76.0,-83.0,-74.0,-80.0,8.0,20.0,7.0,9.0,1
2230,CC:2F:71:3E:C5:1F,5530737,4451803277,3406908,4182259560,2123829,269543717,502,93221,8001490,78619,6270814,14602,1730676,21546,533,3414308,870692,502,2929,7222.0,1000.0,-69.0,-72.0,-67.0,-61.0,-70.0,-72.0,-67.0,-61.0,-76.0,-83.0,-74.0,-80.0,7.0,11.0,7.0,19.0,1
2231,F8:59:71:5A:E0:3D,3463785,2277518174,1339954,2007974255,2123831,269543919,294,761004,930990760,760309,930907105,695,83655,749612,1840,1340084,167479,294,1151,144444.0,43333.0,-68.0,-73.0,-64.0,-71.0,-67.0,-72.0,-63.0,-70.0,-76.0,-83.0,-74.0,-80.0,8.0,10.0,10.0,9.0,1
2232,CC:2F:71:3F:1F:24,4051776,2817909801,1927945,2548365882,2123831,269543919,2596,1565665,2006807706,1564547,2006681160,1118,126546,1547963,6254,1927818,218737,2596,1846,130000.0,43333.0,-69.0,-63.0,-71.0,-71.0,-68.0,-63.0,-69.0,-70.0,-76.0,-83.0,-74.0,-80.0,7.0,20.0,3.0,9.0,1
2233,CC:2F:71:3E:C5:1F,5530739,4451803479,3406908,4182259560,2123831,269543919,502,93221,8001490,78619,6270814,14602,1730676,21546,533,3414308,870692,502,2929,7222.0,1000.0,-69.0,-72.0,-67.0,-61.0,-70.0,-72.0,-67.0,-61.0,-76.0,-83.0,-74.0,-80.0,7.0,11.0,7.0,19.0,1
2234,F8:59:71:5A:E0:3D,3463853,2277616542,1340017,2008072157,2123836,269544385,294,761068,931087898,760372,931004125,696,83773,749676,1840,1340147,167483,294,1151,144444.0,43333.0,-68.0,-73.0,-63.0,-70.0,-67.0,-72.0,-63.0,-69.0,-76.0,-83.0,-74.0,-80.0,8.0,10.0,11.0,10.0,1
2235,CC:2F:71:3F:1F:24,4051940,2818119561,1928104,2548575176,2123836,269544385,2596,1565809,2007006358,1564691,2006879812,1118,126546,1548107,6254,1927977,218754,2596,1846,130000.0,43333.0,-67.0,-63.0,-68.0,-70.0,-67.0,-63.0,-68.0,-70.0,-76.0,-83.0,-74.0,-80.0,9.0,20.0,6.0,10.0,1
2236,CC:2F:71:3E:C5:1F,5530746,4451804147,3406908,4182259560,2123838,269544587,502,93221,8001490,78619,6270814,14602,1730676,21546,533,3414308,870692,502,2929,7222.0,1000.0,-69.0,-72.0,-67.0,-61.0,-70.0,-72.0,-67.0,-61.0,-76.0,-83.0,-74.0,-80.0,7.0,11.0,7.0,19.0,1
2237,F8:59:71:5A:E0:3D,3464018,2277863200,1340177,2008318351,2123841,269544849,294,761157,931192558,760461,931108785,696,83773,749765,1840,1340307,167508,294,1151,144444.0,43333.0,-69.0,-73.0,-64.0,-71.0,-68.0,-73.0,-63.0,-70.0,-77.0,-84.0,-75.0,-81.0,8.0,11.0,11.0,10.0,1
2238,CC:2F:71:3F:1F:24,4052113,2818326482,1928272,2548781633,2123841,269544849,2596,1565964,2007205651,1564846,2007079105,1118,126546,1548262,6254,1928144,218772,2596,1846,130000.0,43333.0,-69.0,-63.0,-71.0,-71.0,-68.0,-63.0,-69.0,-70.0,-77.0,-84.0,-75.0,-81.0,8.0,21.0,4.0,10.0,1
2239,CC:2F:71:3E:C5:1F,5530749,4451804409,3406908,4182259560,2123841,269544849,502,93221,8001490,78619,6270814,14602,1730676,21546,533,3414308,870692,502,2929,7222.0,1000.0,-69.0,-72.0,-67.0,-61.0,-70.0,-72.0,-67.0,-61.0,-77.0,-84.0,-75.0,-81.0,8.0,12.0,8.0,20.0,1
2240,F8:59:71:5A:E0:3D,3464090,2277962255,1340246,2008417142,2123844,269545113,294,761224,931290061,760528,931206288,696,83773,749832,1840,1340376,167512,294,1151,144444.0,43333.0,-69.0,-73.0,-64.0,-71.0,-67.0,-72.0,-63.0,-70.0,-77.0,-84.0,-75.0,-81.0,8.0,11.0,11.0,10.0,1
2241,CC:2F:71:3F:1F:24,4052275,2818531740,1928431,2548986627,2123844,269545113,2596,1566111,2007403179,1564993,2007276633,1118,126546,1548409,6254,1928304,218782,2596,1846,130000.0,43333.0,-67.0,-63.0,-67.0,-69.0,-67.0,-63.0,-68.0,-70.0,-77.0,-84.0,-75.0,-81.0,10.0,21.0,8.0,12.0,1
2242,CC:2F:71:3E:C5:1F,5530754,4451804875,3406908,4182259560,2123846,269545315,502,93223,8001678,78620,6270884,14603,1730794,21547,533,3414308,870692,502,2930,7222.0,1000.0,-69.0,-72.0,-67.0,-61.0,-70.0,-73.0,-67.0,-61.0,-77.0,-84.0,-75.0,-81.0,8.0,12.0,8.0,20.0,1
2243,F8:59:71:5A:E0:3D,3464163,2278061251,1340313,2008515532,2123850,269545719,294,761293,931392553,760597,931308780,696,83773,749900,1840,1340443,167522,294,1151,144444.0,43333.0,-69.0,-73.0,-64.0,-71.0,-68.0,-73.0,-64.0,-71.0,-77.0,-84.0,-75.0,-81.0,8.0,11.0,11.0,10.0,1
2244,CC:2F:71:3F:1F:24,4052438,2818738532,1928588,2549192813,2123850,269545719,2596,1566253,2007600147,1565135,2007473601,1118,126546,1548551,6254,1928461,218795,2596,1846,130000.0,43333.0,-69.0,-63.0,-71.0,-71.0,-68.0,-63.0,-69.0,-70.0,-77.0,-84.0,-75.0,-81.0,8.0,21.0,4.0,10.0,1
2245,CC:2F:71:3E:C5:1F,5530758,4451805279,3406908,4182259560,2123850,269545719,502,93223,8001678,78620,6270884,14603,1730794,21547,533,3414308,870692,502,2930,7222.0,1000.0,-69.0,-72.0,-67.0,-61.0,-70.0,-73.0,-67.0,-61.0,-77.0,-84.0,-75.0,-81.0,8.0,12.0,8.0,20.0,1
2246,F8:59:71:5A:E0:3D,3464295,2278229543,1340442,2008683562,2123853,269545981,294,761380,931496992,760684,931413219,696,83773,749987,1840,1340572,167525,294,1151,144444.0,43333.0,-69.0,-73.0,-64.0,-71.0,-68.0,-73.0,-63.0,-70.0,-77.0,-84.0,-75.0,-81.0,8.0,11.0,11.0,10.0,1
2247,CC:2F:71:3F:1F:24,4052622,2818955255,1928769,2549409274,2123853,269545981,2596,1566411,2007803705,1565293,2007677159,1118,126546,1548709,6254,1928642,218823,2596,1846,130000.0,43333.0,-68.0,-63.0,-68.0,-70.0,-67.0,-63.0,-67.0,-69.0,-77.0,-84.0,-75.0,-81.0,9.0,21.0,7.0,11.0,1
2248,CC:2F:71:3E:C5:1F,5530761,4451805541,3406908,4182259560,2123853,269545981,502,93223,8001678,78620,6270884,14603,1730794,21547,533,3414308,870692,502,2930,7222.0,1000.0,-69.0,-72.0,-67.0,-61.0,-70.0,-73.0,-67.0,-61.0,-77.0,-84.0,-75.0,-81.0,8.0,12.0,8.0,20.0,1
2249,F8:59:71:5A:E0:3D,3464369,2278335709,1340510,2008789122,2123859,269546587,294,761450,931604820,760754,931521047,696,83773,750055,1840,1340640,167529,294,1151,144444.0,39000.0,-67.0,-73.0,-63.0,-71.0,-67.0,-72.0,-63.0,-70.0,-78.0,-84.0,-76.0,-82.0,11.0,11.0,13.0,11.0,1
2250,CC:2F:71:3F:1F:24,4052796,2819177493,1928937,2549630906,2123859,269546587,2596,1566567,2008018143,1565449,2007891597,1118,126546,1548865,6254,1928810,218877,2596,1846,115556.0,26000.0,-69.0,-64.0,-70.0,-70.0,-68.0,-63.0,-68.0,-69.0,-78.0,-84.0,-76.0,-82.0,9.0,20.0,6.0,12.0,1
2251,CC:2F:71:3E:C5:1F,5530767,4451806147,3406908,4182259560,2123859,269546587,502,93223,8001678,78620,6270884,14603,1730794,21547,533,3414308,870692,502,2930,7222.0,1000.0,-69.0,-72.0,-67.0,-61.0,-70.0,-73.0,-67.0,-61.0,-78.0,-84.0,-76.0,-82.0,9.0,12.0,9.0,21.0,1
2252,F8:59:71:5A:E0:3D,3464441,2278443354,1340579,2008896292,2123862,269547062,294,761521,931714188,760825,931630415,696,83773,750124,1840,1340709,167529,294,1151,144444.0,43333.0,-68.0,-73.0,-64.0,-71.0,-67.0,-72.0,-63.0,-70.0,-78.0,-84.0,-76.0,-82.0,10.0,11.0,12.0,11.0,1
2253,CC:2F:71:3F:1F:24,4052970,2819403134,1929108,2549856072,2123862,269547062,2596,1566723,2008233891,1565605,2008107345,1118,126546,1549021,6254,1928981,218878,2596,1846,115556.0,28889.0,-67.0,-63.0,-67.0,-70.0,-68.0,-63.0,-69.0,-69.0,-78.0,-84.0,-76.0,-82.0,11.0,21.0,9.0,12.0,1
2254,CC:2F:71:3E:C5:1F,5530770,4451806622,3406908,4182259560,2123862,269547062,502,93223,8001678,78620,6270884,14603,1730794,21547,533,3414308,870692,502,2930,7222.0,1000.0,-69.0,-72.0,-67.0,-61.0,-70.0,-73.0,-67.0,-61.0,-78.0,-84.0,-76.0,-82.0,9.0,12.0,9.0,21.0,1
2255,F8:59:71:5A:E0:3D,3464512,2278541984,1340642,2008994194,2123870,269547790,294,761585,931812748,760889,931728975,696,83773,750188,1840,1340772,167534,294,1151,144444.0,43333.0,-69.0,-73.0,-64.0,-71.0,-67.0,-72.0,-63.0,-70.0,-78.0,-84.0,-76.0,-82.0,9.0,11.0,12.0,11.0,1
2256,CC:2F:71:3F:1F:24,4053136,2819610178,1929266,2550062388,2123870,269547790,2596,1566868,2008431209,1565749,2008304545,1119,126664,1549166,6254,1929139,218886,2596,1846,115556.0,28889.0,-68.0,-63.0,-68.0,-69.0,-68.0,-63.0,-68.0,-69.0,-78.0,-84.0,-76.0,-82.0,10.0,21.0,8.0,13.0,1
2257,CC:2F:71:3E:C5:1F,5530778,4451807350,3406908,4182259560,2123870,269547790,502,93223,8001678,78620,6270884,14603,1730794,21547,533,3414308,870692,502,2930,7222.0,1000.0,-69.0,-72.0,-67.0,-61.0,-70.0,-73.0,-67.0,-61.0,-78.0,-84.0,-76.0,-82.0,9.0,12.0,9.0,21.0,1
2258,F8:59:71:5A:E0:3D,3464589,2278655996,1340715,2009107636,2123874,269548360,294,761657,931923628,760961,931839855,696,83773,750260,1840,1340845,167536,294,1151,144444.0,43333.0,-68.0,-73.0,-64.0,-71.0,-67.0,-72.0,-63.0,-70.0,-79.0,-85.0,-77.0,-82.0,11.0,12.0,13.0,11.0,1
2259,CC:2F:71:3F:1F:24,4053336,2819853080,1929462,2550304720,2123874,269548360,2596,1567050,2008666274,1565931,2008539610,1119,126664,1549346,6254,1929335,218900,2596,1846,104000.0,26000.0,-69.0,-64.0,-71.0,-70.0,-68.0,-63.0,-69.0,-69.0,-79.0,-85.0,-77.0,-82.0,10.0,21.0,6.0,12.0,1
2260,CC:2F:71:3E:C5:1F,5530784,4451808276,3406908,4182259560,2123876,269548716,502,93223,8001678,78620,6270884,14603,1730794,21547,533,3414308,870692,502,2930,7222.0,1000.0,-69.0,-72.0,-67.0,-61.0,-70.0,-73.0,-67.0,-61.0,-79.0,-85.0,-77.0,-82.0,10.0,13.0,10.0,21.0,1
2261,F8:59:71:5A:E0:3D,3464670,2278768906,1340787,2009219524,2123883,269549382,294,761730,932036048,761034,931952275,696,83773,750333,1840,1340917,167553,294,1151,144444.0,43333.0,-69.0,-74.0,-64.0,-71.0,-68.0,-72.0,-63.0,-70.0,-79.0,-85.0,-77.0,-82.0,10.0,11.0,13.0,11.0,1
2262,CC:2F:71:3F:1F:24,4053562,2820120330,1929679,2550570948,2123883,269549382,2596,1567270,2008925220,1566149,2008798088,1121,127132,1549553,6254,1929552,218921,2596,1847,115556.0,28889.0,-68.0,-63.0,-67.0,-69.0,-68.0,-63.0,-69.0,-69.0,-79.0,-85.0,-77.0,-82.0,11.0,22.0,10.0,13.0,1
2263,CC:2F:71:3E:C5:1F,5530791,4451808942,3406908,4182259560,2123883,269549382,502,93223,8001678,78620,6270884,14603,1730794,21547,533,3414308,870692,502,2930,7222.0,1000.0,-69.0,-72.0,-67.0,-61.0,-70.0,-73.0,-67.0,-61.0,-79.0,-85.0,-77.0,-82.0,10.0,13.0,10.0,21.0,1
2264,F8:59:71:5A:E0:3D,3464746,2278882568,1340861,2009332984,2123885,269549584,294,761803,932147044,761107,932063271,696,83773,750406,1840,1340991,167575,294,1151,144444.0,43333.0,-67.0,-72.0,-62.0,-69.0,-67.0,-72.0,-63.0,-69.0,-79.0,-85.0,-78.0,-83.0,12.0,13.0,16.0,14.0,1
2265,CC:2F:71:3F:1F:24,4053727,2820334170,1929842,2550784586,2123885,269549584,2596,1567416,2009125528,1566295,2008998396,1121,127132,1549699,6254,1929715,218966,2596,1848,115556.0,28889.0,-69.0,-63.0,-71.0,-71.0,-67.0,-63.0,-67.0,-69.0,-79.0,-85.0,-78.0,-83.0,10.0,22.0,7.0,12.0,1
2266,CC:2F:71:3E:C5:1F,5530793,4451809144,3406908,4182259560,2123885,269549584,502,93225,8001818,78622,6271024,14603,1730794,21547,533,3414309,870692,502,2930,7222.0,1000.0,-73.0,-74.0,-69.0,-62.0,-71.0,-73.0,-68.0,-61.0,-79.0,-85.0,-78.0,-83.0,6.0,11.0,9.0,21.0,1
2267,F8:59:71:5A:E0:3D,3465191,2279529482,1341300,2009979292,2123891,269550190,294,761942,932262785,761246,932179012,696,83773,750545,1840,1341430,167731,294,1151,144444.0,43333.0,-66.0,-72.0,-63.0,-69.0,-66.0,-72.0,-62.0,-69.0,-79.0,-85.0,-78.0,-83.0,13.0,13.0,15.0,14.0,1
2268,CC:2F:71:3F:1F:24,4053895,2820546563,1930004,2550996373,2123891,269550190,2596,1567568,2009332449,1566447,2009205317,1121,127132,1549851,6254,1929877,219031,2596,1848,115556.0,28889.0,-69.0,-63.0,-71.0,-70.0,-67.0,-63.0,-67.0,-69.0,-79.0,-85.0,-78.0,-83.0,10.0,22.0,7.0,13.0,1
2269,CC:2F:71:3E:C5:1F,5530799,4451809750,3406908,4182259560,2123891,269550190,502,93225,8001818,78622,6271024,14603,1730794,21547,533,3414309,870692,502,2930,7222.0,1000.0,-73.0,-74.0,-69.0,-62.0,-71.0,-73.0,-68.0,-61.0,-79.0,-85.0,-78.0,-83.0,6.0,11.0,9.0,21.0,1
2270,F8:59:71:5A:E0:3D,3465275,2279633755,1341381,2010083303,2123894,269550452,294,762022,932369999,761326,932286226,696,83773,750625,1840,1341511,167758,294,1151,144444.0,43333.0,-69.0,-73.0,-64.0,-71.0,-67.0,-72.0,-63.0,-70.0,-79.0,-85.0,-78.0,-83.0,10.0,12.0,14.0,12.0,1
2271,CC:2F:71:3F:1F:24,4054060,2820760109,1930166,2551209657,2123894,269550452,2596,1567716,2009537681,1566595,2009410549,1121,127132,1549999,6254,1930038,219128,2596,1850,115556.0,28889.0,-67.0,-63.0,-67.0,-69.0,-67.0,-63.0,-68.0,-69.0,-79.0,-85.0,-78.0,-83.0,12.0,22.0,11.0,14.0,1
2272,CC:2F:71:3E:C5:1F,5530802,4451810012,3406908,4182259560,2123894,269550452,502,93225,8001818,78622,6271024,14603,1730794,21547,533,3414309,870692,502,2930,7222.0,1000.0,-73.0,-74.0,-69.0,-62.0,-71.0,-73.0,-68.0,-61.0,-79.0,-85.0,-78.0,-83.0,6.0,11.0,9.0,21.0,1
2273,F8:59:71:5A:E0:3D,3465346,2279735259,1341446,2010184201,2123900,269551058,294,762088,932471681,761392,932387908,696,83773,750691,1840,1341576,167787,294,1151,144444.0,43333.0,-68.0,-73.0,-64.0,-71.0,-67.0,-72.0,-63.0,-70.0,-80.0,-86.0,-79.0,-84.0,12.0,13.0,15.0,13.0,1
2274,CC:2F:71:3F:1F:24,4054225,2820968249,1930325,2551417191,2123900,269551058,2596,1567860,2009736333,1566739,2009609201,1121,127132,1550143,6254,1930198,219174,2596,1850,115556.0,28889.0,-68.0,-63.0,-67.0,-69.0,-67.0,-63.0,-67.0,-69.0,-80.0,-86.0,-79.0,-84.0,12.0,23.0,12.0,15.0,1
2275,CC:2F:71:3E:C5:1F,5530808,4451810618,3406908,4182259560,2123900,269551058,502,93225,8001818,78622,6271024,14603,1730794,21547,533,3414309,870692,502,2930,7222.0,1000.0,-73.0,-74.0,-69.0,-62.0,-71.0,-73.0,-68.0,-61.0,-80.0,-86.0,-79.0,-84.0,7.0,12.0,10.0,22.0,1
2276,F8:59:71:5A:E0:3D,3465412,2279833327,1341512,2010282269,2123900,269551058,294,762153,932567589,761457,932483816,696,83773,750756,1840,1341642,167812,294,1151,144444.0,43333.0,-67.0,-73.0,-62.0,-69.0,-66.0,-72.0,-62.0,-69.0,-80.0,-86.0,-79.0,-84.0,13.0,13.0,17.0,15.0,1
2277,CC:2F:71:3F:1F:24,4054381,2821168327,1930479,2551617067,2123902,269551260,2596,1568004,2009934957,1566883,2009807825,1121,127132,1550287,6254,1930352,219210,2596,1850,104000.0,26000.0,-69.0,-63.0,-71.0,-70.0,-67.0,-63.0,-67.0,-69.0,-80.0,-86.0,-79.0,-84.0,11.0,23.0,8.0,14.0,1
2278,CC:2F:71:3E:C5:1F,5530810,4451810820,3406908,4182259560,2123902,269551260,502,93225,8001818,78622,6271024,14603,1730794,21547,533,3414309,870692,502,2930,7222.0,1000.0,-73.0,-74.0,-69.0,-62.0,-71.0,-73.0,-68.0,-61.0,-80.0,-86.0,-79.0,-84.0,7.0,12.0,10.0,22.0,1
2279,F8:59:71:5A:E0:3D,3465489,2279935327,1341580,2010383401,2123909,269551926,294,762223,932671695,761527,932587922,696,83773,750826,1840,1341710,167843,294,1151,144444.0,43333.0,-69.0,-73.0,-64.0,-71.0,-67.0,-73.0,-63.0,-70.0,-80.0,-86.0,-79.0,-84.0,11.0,13.0,15.0,13.0,1
2280,CC:2F:71:3F:1F:24,4054554,2821387293,1930645,2551835367,2123909,269551926,2596,1568155,2010137297,1567034,2010010165,1121,127132,1550438,6254,1930517,219252,2596,1850,115556.0,1000.0,-68.0,-63.0,-66.0,-70.0,-68.0,-63.0,-67.0,-69.0,-80.0,-86.0,-79.0,-84.0,12.0,23.0,13.0,14.0,1
2281,CC:2F:71:3E:C5:1F,5530817,4451811486,3406908,4182259560,2123909,269551926,502,93225,8001818,78622,6271024,14603,1730794,21547,533,3414309,870692,502,2930,7222.0,1000.0,-73.0,-74.0,-69.0,-62.0,-71.0,-73.0,-68.0,-61.0,-80.0,-86.0,-79.0,-84.0,7.0,12.0,10.0,22.0,1
2282,F8:59:71:5A:E0:3D,3465559,2280043995,1341650,2010492069,2123909,269551926,294,762293,932779495,761597,932695722,696,83773,750896,1840,1341780,167875,294,1151,144444.0,43333.0,-69.0,-73.0,-64.0,-71.0,-68.0,-72.0,-63.0,-70.0,-80.0,-86.0,-79.0,-84.0,11.0,13.0,15.0,13.0,1
2283,CC:2F:71:3F:1F:24,4054727,2821613819,1930817,2552061759,2123910,269552060,2596,1568313,2010354731,1567192,2010227599,1121,127132,1550596,6254,1930690,219372,2596,1850,104000.0,26000.0,-70.0,-63.0,-71.0,-70.0,-69.0,-63.0,-70.0,-69.0,-80.0,-86.0,-79.0,-84.0,10.0,23.0,8.0,14.0,1
2284,CC:2F:71:3E:C5:1F,5530818,4451811620,3406908,4182259560,2123910,269552060,502,93225,8001818,78622,6271024,14603,1730794,21547,533,3414309,870692,502,2930,7222.0,1000.0,-73.0,-74.0,-69.0,-62.0,-71.0,-73.0,-68.0,-61.0,-80.0,-86.0,-79.0,-84.0,7.0,12.0,10.0,22.0,1
2285,F8:59:71:5A:E0:3D,3465724,2280254845,1341807,2010702111,2123917,269552734,294,762383,932882900,761687,932799127,696,83773,750986,1840,1341937,167892,294,1151,144444.0,43333.0,-67.0,-73.0,-62.0,-69.0,-67.0,-72.0,-62.0,-69.0,-80.0,-86.0,-79.0,-84.0,13.0,13.0,17.0,15.0,1
2286,CC:2F:71:3F:1F:24,4054893,2821819525,1930975,2552266731,2123918,269552794,2596,1568458,2010553471,1567337,2010426339,1121,127132,1550741,6254,1930849,219472,2596,1850,104000.0,26000.0,-67.0,-63.0,-65.0,-69.0,-68.0,-63.0,-67.0,-69.0,-80.0,-86.0,-79.0,-84.0,13.0,23.0,14.0,15.0,1
2287,CC:2F:71:3E:C5:1F,5530826,4451812354,3406908,4182259560,2123918,269552794,502,93225,8001818,78622,6271024,14603,1730794,21547,533,3414309,870692,502,2930,7222.0,1000.0,-73.0,-74.0,-69.0,-62.0,-71.0,-73.0,-68.0,-61.0,-80.0,-86.0,-79.0,-84.0,7.0,12.0,10.0,22.0,1
2288,F8:59:71:5A:E0:3D,3465788,2280352807,1341870,2010800013,2123918,269552794,294,762448,932983000,761752,932899227,696,83773,751051,1840,1342000,167905,294,1151,144444.0,43333.0,-68.0,-73.0,-64.0,-71.0,-66.0,-72.0,-63.0,-69.0,-80.0,-86.0,-79.0,-84.0,12.0,13.0,15.0,13.0,1
2289,CC:2F:71:3F:1F:24,4055053,2822027829,1931135,2552475035,2123918,269552794,2596,1568604,2010753793,1567483,2010626661,1121,127132,1550887,6254,1931009,219521,2596,1851,86667.0,14444.0,-70.0,-64.0,-70.0,-70.0,-68.0,-63.0,-67.0,-69.0,-80.0,-86.0,-79.0,-84.0,10.0,22.0,9.0,14.0,1
2290,CC:2F:71:3E:C5:1F,5530826,4451812354,3406908,4182259560,2123918,269552794,502,93225,8001818,78622,6271024,14603,1730794,21547,533,3414309,870692,502,2930,7222.0,1000.0,-73.0,-74.0,-69.0,-62.0,-71.0,-73.0,-68.0,-61.0,-81.0,-86.0,-79.0,-84.0,8.0,12.0,10.0,22.0,1
2291,F8:59:71:5A:E0:3D,3466052,2280756872,1342130,2011203674,2123922,269553198,294,762550,933090092,761854,933006319,696,83773,751153,1840,1342260,167926,294,1151,144444.0,43333.0,-66.0,-72.0,-63.0,-69.0,-66.0,-72.0,-62.0,-69.0,-81.0,-86.0,-79.0,-84.0,15.0,14.0,16.0,15.0,1
2292,CC:2F:71:3F:1F:24,4055235,2822243811,1931311,2552690411,2123924,269553400,2596,1568759,2010957220,1567638,2010830088,1121,127132,1551042,6254,1931186,219593,2596,1851,130000.0,39000.0,-70.0,-64.0,-68.0,-71.0,-70.0,-64.0,-69.0,-70.0,-81.0,-86.0,-79.0,-84.0,11.0,22.0,11.0,13.0,1
2293,CC:2F:71:3E:C5:1F,5530835,4451813435,3406908,4182259560,2123927,269553875,502,93225,8001818,78622,6271024,14603,1730794,21547,533,3414309,870692,502,2930,7222.0,1000.0,-73.0,-74.0,-69.0,-62.0,-71.0,-73.0,-68.0,-61.0,-81.0,-86.0,-79.0,-84.0,8.0,12.0,10.0,22.0,1
2294,F8:59:71:5A:E0:3D,3466131,2280862086,1342203,2011308151,2123928,269553935,294,762621,933195086,761925,933111313,696,83773,751224,1840,1342333,167952,294,1151,144444.0,43333.0,-66.0,-72.0,-63.0,-70.0,-66.0,-72.0,-63.0,-69.0,-81.0,-86.0,-79.0,-84.0,15.0,14.0,16.0,14.0,1
2295,CC:2F:71:3F:1F:24,4055406,2822463360,1931478,2552909425,2123928,269553935,2596,1568916,2011171592,1567795,2011044460,1121,127132,1551199,6254,1931352,219694,2596,1851,115556.0,1000.0,-69.0,-63.0,-67.0,-69.0,-69.0,-63.0,-68.0,-68.0,-81.0,-86.0,-79.0,-84.0,12.0,23.0,12.0,15.0,1
2296,CC:2F:71:3E:C5:1F,5530836,4451813495,3406908,4182259560,2123928,269553935,502,93225,8001818,78622,6271024,14603,1730794,21547,533,3414309,870692,502,2930,7222.0,1000.0,-73.0,-74.0,-69.0,-62.0,-71.0,-73.0,-68.0,-61.0,-81.0,-86.0,-79.0,-84.0,8.0,12.0,10.0,22.0,1
2297,F8:59:71:5A:E0:3D,3466393,2281227642,1342461,2011673303,2123932,269554339,294,762719,933304261,762023,933220488,696,83773,751322,1840,1342591,168091,294,1151,144444.0,43333.0,-67.0,-73.0,-62.0,-70.0,-67.0,-73.0,-63.0,-69.0,-80.0,-85.0,-79.0,-84.0,13.0,12.0,17.0,14.0,1
2298,CC:2F:71:3F:1F:24,4055572,2822673346,1931640,2553119007,2123932,269554339,2596,1569065,2011375018,1567944,2011247886,1121,127132,1551346,6254,1931515,219746,2596,1851,117000.0,39000.0,-68.0,-64.0,-67.0,-69.0,-68.0,-64.0,-67.0,-68.0,-80.0,-85.0,-79.0,-84.0,12.0,21.0,12.0,15.0,1
2299,CC:2F:71:3E:C5:1F,5530845,4451814419,3406909,4182259676,2123936,269554743,502,93226,8001888,78623,6271094,14603,1730794,21547,533,3414310,870692,502,2930,7222.0,1000.0,-77.0,-84.0,-77.0,-72.0,-71.0,-74.0,-69.0,-62.0,-80.0,-85.0,-79.0,-84.0,3.0,1.0,2.0,12.0,1
2300,F8:59:71:5A:E0:3D,3466470,2281328751,1342533,2011773946,2123937,269554805,294,762788,933404596,762091,933320705,697,83891,751391,1840,1342663,168111,294,1151,144444.0,43333.0,-67.0,-73.0,-63.0,-71.0,-67.0,-72.0,-63.0,-70.0,-80.0,-85.0,-79.0,-84.0,13.0,12.0,16.0,13.0,1
2301,CC:2F:71:3F:1F:24,4055736,2822880940,1931799,2553326135,2123937,269554805,2596,1569211,2011572348,1568090,2011445216,1121,127132,1551490,6254,1931673,219776,2596,1851,130000.0,43333.0,-71.0,-64.0,-72.0,-70.0,-69.0,-64.0,-69.0,-69.0,-80.0,-85.0,-79.0,-84.0,9.0,21.0,7.0,14.0,1
2302,CC:2F:71:3E:C5:1F,5530846,4451814481,3406909,4182259676,2123937,269554805,502,93227,8001958,78624,6271164,14603,1730794,21547,533,3414310,870692,502,2930,7222.0,1000.0,-68.0,-73.0,-66.0,-61.0,-71.0,-74.0,-69.0,-62.0,-80.0,-85.0,-79.0,-84.0,12.0,12.0,13.0,23.0,1
2303,F8:59:71:5A:E0:3D,3466539,2281428447,1342597,2011873178,2123942,269555269,294,762851,933501658,762154,933417767,697,83891,751454,1840,1342727,168137,294,1151,144444.0,43333.0,-67.0,-72.0,-63.0,-70.0,-67.0,-73.0,-63.0,-70.0,-80.0,-85.0,-79.0,-84.0,13.0,13.0,16.0,14.0,1
2304,CC:2F:71:3F:1F:24,4055901,2823092252,1931959,2553536983,2123942,269555269,2596,1569358,2011774378,1568237,2011647246,1121,127132,1551637,6254,1931834,219782,2596,1851,130000.0,43333.0,-68.0,-65.0,-67.0,-70.0,-69.0,-64.0,-70.0,-71.0,-80.0,-85.0,-79.0,-84.0,12.0,20.0,12.0,14.0,1
2305,CC:2F:71:3E:C5:1F,5530851,4451814945,3406909,4182259676,2123942,269555269,502,93227,8001958,78624,6271164,14603,1730794,21547,533,3414310,870692,502,2930,7222.0,1000.0,-68.0,-73.0,-66.0,-61.0,-71.0,-74.0,-69.0,-62.0,-80.0,-85.0,-79.0,-84.0,12.0,12.0,13.0,23.0,1
2306,F8:59:71:5A:E0:3D,3466607,2281527691,1342661,2011972018,2123946,269555673,294,762916,933601758,762219,933517867,697,83891,751519,1840,1342791,168175,294,1151,144444.0,43333.0,-69.0,-74.0,-64.0,-72.0,-67.0,-72.0,-63.0,-69.0,-80.0,-85.0,-79.0,-84.0,11.0,11.0,15.0,12.0,1
2307,CC:2F:71:3F:1F:24,4056064,2823301670,1932118,2553745997,2123946,269555673,2596,1569502,2011974426,1568381,2011847294,1121,127132,1551781,6254,1931993,219795,2596,1851,144444.0,43333.0,-68.0,-65.0,-68.0,-71.0,-67.0,-65.0,-67.0,-70.0,-80.0,-85.0,-79.0,-84.0,12.0,20.0,11.0,13.0,1
2308,CC:2F:71:3E:C5:1F,5530855,4451815349,3406909,4182259676,2123946,269555673,502,93227,8001958,78624,6271164,14603,1730794,21547,533,3414310,870692,502,2930,7222.0,1000.0,-68.0,-73.0,-66.0,-61.0,-71.0,-74.0,-69.0,-62.0,-80.0,-85.0,-79.0,-84.0,12.0,12.0,13.0,23.0,1
2309,F8:59:71:5A:E0:3D,3466678,2281627696,1342731,2012071889,2123947,269555807,294,762984,933701940,762287,933618049,697,83891,751587,1840,1342861,168221,294,1151,144444.0,43333.0,-66.0,-72.0,-63.0,-69.0,-67.0,-72.0,-63.0,-69.0,-80.0,-85.0,-79.0,-84.0,14.0,13.0,16.0,15.0,1
2310,CC:2F:71:3F:1F:24,4056226,2823511016,1932278,2553955141,2123948,269555875,2596,1569647,2012174646,1568526,2012047514,1121,127132,1551926,6254,1932153,219814,2596,1851,130000.0,43333.0,-68.0,-65.0,-68.0,-71.0,-67.0,-64.0,-68.0,-71.0,-80.0,-85.0,-79.0,-84.0,12.0,20.0,11.0,13.0,1
2311,CC:2F:71:3E:C5:1F,5530859,4451815753,3406909,4182259676,2123950,269556077,502,93227,8001958,78624,6271164,14603,1730794,21547,533,3414310,870692,502,2930,7222.0,1000.0,-68.0,-73.0,-66.0,-61.0,-71.0,-74.0,-69.0,-62.0,-80.0,-85.0,-79.0,-84.0,12.0,12.0,13.0,23.0,1
2312,F8:59:71:5A:E0:3D,3466751,2281728880,1342796,2012172339,2123955,269556541,294,763048,933800542,762351,933716651,697,83891,751651,1840,1342926,168256,294,1152,144444.0,43333.0,-67.0,-72.0,-64.0,-70.0,-67.0,-73.0,-63.0,-70.0,-80.0,-85.0,-79.0,-84.0,13.0,13.0,15.0,14.0,1
2313,CC:2F:71:3F:1F:24,4056396,2823724329,1932441,2554167788,2123955,269556541,2596,1569795,2012376624,1568674,2012249492,1121,127132,1552074,6254,1932316,219824,2596,1851,130000.0,43333.0,-67.0,-65.0,-67.0,-71.0,-67.0,-64.0,-67.0,-70.0,-80.0,-85.0,-79.0,-84.0,13.0,20.0,12.0,13.0,1
2314,CC:2F:71:3E:C5:1F,5530864,4451816217,3406909,4182259676,2123955,269556541,502,93227,8001958,78624,6271164,14603,1730794,21547,533,3414310,870692,502,2930,7222.0,1000.0,-68.0,-73.0,-66.0,-61.0,-71.0,-74.0,-69.0,-62.0,-80.0,-85.0,-79.0,-84.0,12.0,12.0,13.0,23.0,1
2315,F8:59:71:5A:E0:3D,3466839,2281835577,1342884,2012279036,2123955,269556541,294,763135,933907829,762438,933823938,697,83891,751738,1840,1343014,168291,294,1152,144444.0,43333.0,-67.0,-73.0,-63.0,-70.0,-67.0,-73.0,-63.0,-70.0,-80.0,-85.0,-79.0,-83.0,13.0,12.0,16.0,13.0,1
2316,CC:2F:71:3F:1F:24,4056558,2823936693,1932603,2554380152,2123955,269556541,2596,1569942,2012581292,1568821,2012454160,1121,127132,1552221,6254,1932478,219842,2596,1851,144444.0,43333.0,-67.0,-64.0,-67.0,-70.0,-68.0,-64.0,-70.0,-71.0,-80.0,-85.0,-79.0,-83.0,13.0,21.0,12.0,13.0,1
2317,CC:2F:71:3E:C5:1F,5530866,4451816419,3406909,4182259676,2123957,269556743,502,93227,8001958,78624,6271164,14603,1730794,21547,533,3414310,870692,502,2930,7222.0,1000.0,-68.0,-73.0,-66.0,-61.0,-71.0,-74.0,-69.0,-62.0,-80.0,-85.0,-79.0,-83.0,12.0,12.0,13.0,22.0,1
2318,F8:59:71:5A:E0:3D,3467069,2282129487,1343106,2012572138,2123963,269557349,294,763260,934034106,762563,933950215,697,83891,751863,1840,1343234,168431,294,1152,144444.0,43333.0,-69.0,-73.0,-65.0,-72.0,-67.0,-72.0,-63.0,-70.0,-79.0,-84.0,-77.0,-82.0,10.0,11.0,12.0,10.0,1
2319,CC:2F:71:3F:1F:24,4056734,2824149526,1932771,2554592177,2123963,269557349,2596,1570094,2012788144,1568973,2012661012,1121,127132,1552373,6254,1932644,219866,2596,1851,144444.0,43333.0,-68.0,-65.0,-67.0,-70.0,-67.0,-64.0,-67.0,-70.0,-79.0,-84.0,-77.0,-82.0,11.0,19.0,10.0,12.0,1
2320,CC:2F:71:3E:C5:1F,5530872,4451817025,3406909,4182259676,2123963,269557349,502,93227,8001958,78624,6271164,14603,1730794,21547,533,3414310,870692,502,2930,7222.0,1000.0,-68.0,-73.0,-66.0,-61.0,-71.0,-74.0,-69.0,-62.0,-79.0,-84.0,-77.0,-82.0,11.0,11.0,11.0,21.0,1
2321,F8:59:71:5A:E0:3D,3467720,2282969951,1343756,2013412542,2123964,269557409,294,763526,934190351,762829,934106460,697,83891,752129,1840,1343886,168732,294,1153,144444.0,43333.0,-69.0,-74.0,-65.0,-72.0,-68.0,-73.0,-64.0,-71.0,-79.0,-84.0,-77.0,-82.0,10.0,10.0,12.0,10.0,1
2322,CC:2F:71:3F:1F:24,4056908,2824376472,1932944,2554819063,2123964,269557409,2596,1570254,2013007199,1569133,2012880067,1121,127132,1552533,6254,1932819,219894,2596,1851,130000.0,43333.0,-70.0,-65.0,-73.0,-73.0,-69.0,-65.0,-70.0,-72.0,-79.0,-84.0,-77.0,-82.0,9.0,19.0,4.0,9.0,1
2323,CC:2F:71:3E:C5:1F,5530875,4451817287,3406909,4182259676,2123966,269557611,502,93227,8001958,78624,6271164,14603,1730794,21547,533,3414310,870692,502,2930,7222.0,1000.0,-68.0,-73.0,-66.0,-61.0,-71.0,-74.0,-69.0,-62.0,-79.0,-84.0,-77.0,-82.0,11.0,11.0,11.0,21.0,1
2324,F8:59:71:5A:E0:3D,3467971,2283201815,1343999,2013643598,2123972,269558217,294,763732,934329896,763035,934246005,697,83891,752333,1840,1344129,168863,294,1159,144444.0,43333.0,-67.0,-73.0,-64.0,-70.0,-66.0,-72.0,-63.0,-70.0,-79.0,-84.0,-77.0,-82.0,12.0,11.0,13.0,12.0,1
2325,CC:2F:71:3F:1F:24,4057078,2824589574,1933106,2555031357,2123972,269558217,2596,1570402,2013207701,1569281,2013080569,1121,127132,1552681,6254,1932981,219917,2596,1851,130000.0,43333.0,-70.0,-65.0,-73.0,-72.0,-68.0,-65.0,-68.0,-70.0,-79.0,-84.0,-77.0,-82.0,9.0,19.0,4.0,10.0,1
2326,CC:2F:71:3E:C5:1F,5530881,4451817893,3406909,4182259676,2123972,269558217,502,93227,8001958,78624,6271164,14603,1730794,21547,533,3414310,870692,502,2930,7222.0,1000.0,-68.0,-73.0,-66.0,-61.0,-71.0,-74.0,-69.0,-62.0,-79.0,-84.0,-77.0,-82.0,11.0,11.0,11.0,21.0,1
2327,F8:59:71:5A:E0:3D,3468099,2283340756,1344125,2013782417,2123974,269558339,294,763832,934438584,763135,934354693,697,83891,752433,1840,1344255,168952,294,1159,144444.0,1000.0,-69.0,-74.0,-65.0,-72.0,-68.0,-73.0,-64.0,-71.0,-79.0,-84.0,-77.0,-82.0,10.0,10.0,12.0,10.0,1
2328,CC:2F:71:3F:1F:24,4057239,2824798766,1933265,2555240427,2123974,269558339,2596,1570548,2013407983,1569426,2013280733,1122,127250,1552827,6254,1933140,219931,2596,1851,130000.0,43333.0,-68.0,-65.0,-68.0,-71.0,-68.0,-65.0,-69.0,-71.0,-79.0,-84.0,-77.0,-82.0,11.0,19.0,9.0,11.0,1
2329,CC:2F:71:3E:C5:1F,5530883,4451818015,3406909,4182259676,2123974,269558339,502,93227,8001958,78624,6271164,14603,1730794,21547,533,3414310,870692,502,2930,7222.0,1000.0,-68.0,-73.0,-66.0,-61.0,-71.0,-74.0,-69.0,-62.0,-79.0,-84.0,-77.0,-82.0,11.0,11.0,11.0,21.0,1
2330,F8:59:71:5A:E0:3D,3468170,2283439186,1344188,2013880039,2123982,269559147,294,763895,934535604,763198,934451713,697,83891,752496,1840,1344318,168983,294,1159,144444.0,43333.0,-69.0,-74.0,-65.0,-72.0,-67.0,-73.0,-63.0,-70.0,-79.0,-84.0,-77.0,-82.0,10.0,10.0,12.0,10.0,1
2331,CC:2F:71:3F:1F:24,4057403,2825002782,1933421,2555443635,2123982,269559147,2596,1570690,2013602103,1569568,2013474853,1122,127250,1552969,6254,1933296,219938,2596,1851,130000.0,43333.0,-70.0,-65.0,-73.0,-74.0,-68.0,-65.0,-70.0,-71.0,-79.0,-84.0,-77.0,-82.0,9.0,19.0,4.0,8.0,1
2332,CC:2F:71:3E:C5:1F,5530891,4451818823,3406909,4182259676,2123982,269559147,502,93227,8001958,78624,6271164,14603,1730794,21547,533,3414310,870692,502,2930,7222.0,1000.0,-68.0,-73.0,-66.0,-61.0,-71.0,-74.0,-69.0,-62.0,-79.0,-84.0,-77.0,-82.0,11.0,11.0,11.0,21.0,1
2333,F8:59:71:5A:E0:3D,3468232,2283535254,1344250,2013976107,2123982,269559147,294,763958,934632624,763261,934548733,697,83891,752559,1840,1344380,169010,294,1159,144444.0,1000.0,-69.0,-74.0,-65.0,-72.0,-68.0,-73.0,-64.0,-71.0,-79.0,-84.0,-77.0,-82.0,10.0,10.0,12.0,10.0,1
2334,CC:2F:71:3F:1F:24,4057569,2825211255,1933587,2555652108,2123982,269559147,2596,1570841,2013802120,1569719,2013674870,1122,127250,1553119,6254,1933462,219960,2596,1851,130000.0,43333.0,-68.0,-65.0,-66.0,-71.0,-68.0,-64.0,-68.0,-71.0,-79.0,-84.0,-77.0,-82.0,11.0,19.0,11.0,11.0,1
2335,CC:2F:71:3E:C5:1F,5530892,4451819096,3406909,4182259676,2123983,269559420,502,93227,8001958,78624,6271164,14603,1730794,21547,533,3414310,870692,502,2930,7222.0,1000.0,-68.0,-73.0,-66.0,-61.0,-71.0,-74.0,-69.0,-62.0,-79.0,-84.0,-77.0,-82.0,11.0,11.0,11.0,21.0,1
2336,F8:59:71:5A:E0:3D,3468303,2283633703,1344313,2014073617,2123990,269560086,294,764021,934729644,763324,934645753,697,83891,752622,1840,1344443,169045,294,1159,144444.0,43333.0,-69.0,-74.0,-65.0,-72.0,-67.0,-73.0,-63.0,-70.0,-79.0,-84.0,-77.0,-82.0,10.0,10.0,12.0,10.0,1
2337,CC:2F:71:3F:1F:24,4057737,2825418488,1933745,2555858200,2123992,269560288,2596,1570984,2013999204,1569862,2013871954,1122,127250,1553262,6254,1933620,219968,2596,1851,130000.0,43333.0,-68.0,-65.0,-67.0,-71.0,-68.0,-64.0,-67.0,-71.0,-79.0,-84.0,-77.0,-82.0,11.0,19.0,10.0,11.0,1
2338,CC:2F:71:3E:C5:1F,5530901,4451819964,3406909,4182259676,2123992,269560288,502,93227,8001958,78624,6271164,14603,1730794,21547,533,3414310,870692,502,2930,7222.0,1000.0,-68.0,-73.0,-66.0,-61.0,-71.0,-74.0,-69.0,-62.0,-79.0,-84.0,-77.0,-82.0,11.0,11.0,11.0,21.0,1
2339,F8:59:71:5A:E0:3D,3468397,2283741236,1344404,2014180886,2123993,269560350,294,764106,934834258,763409,934750367,697,83891,752707,1840,1344534,169091,294,1159,144444.0,43333.0,-67.0,-73.0,-63.0,-70.0,-66.0,-72.0,-63.0,-70.0,-79.0,-84.0,-77.0,-82.0,12.0,11.0,14.0,12.0,1
2340,CC:2F:71:3F:1F:24,4057900,2825630802,1933907,2556070452,2123993,269560350,2596,1571133,2014202680,1570011,2014075430,1122,127250,1553411,6254,1933782,219987,2596,1851,144444.0,43333.0,-68.0,-65.0,-68.0,-72.0,-68.0,-65.0,-68.0,-71.0,-79.0,-84.0,-77.0,-82.0,11.0,19.0,9.0,10.0,1
2341,CC:2F:71:3E:C5:1F,5530902,4451820026,3406909,4182259676,2123993,269560350,502,93229,8002146,78625,6271234,14604,1730912,21548,533,3414310,870692,502,2930,7222.0,1000.0,-74.0,-74.0,-69.0,-61.0,-71.0,-74.0,-68.0,-62.0,-79.0,-84.0,-77.0,-82.0,5.0,10.0,8.0,21.0,1
2342,F8:59:71:5A:E0:3D,3468960,2284589632,1344961,2015028676,2123999,269560956,294,764291,934964032,763594,934880141,697,83891,752892,1840,1345090,169148,294,1159,144444.0,43333.0,-69.0,-74.0,-65.0,-72.0,-68.0,-73.0,-64.0,-70.0,-79.0,-84.0,-77.0,-82.0,10.0,10.0,12.0,10.0,1
2343,CC:2F:71:3F:1F:24,4058068,2825843926,1934069,2556282970,2123999,269560956,2596,1571283,2014406262,1570161,2014279012,1122,127250,1553561,6254,1933944,219997,2596,1851,144444.0,43333.0,-69.0,-65.0,-69.0,-72.0,-69.0,-65.0,-70.0,-72.0,-79.0,-84.0,-77.0,-82.0,10.0,19.0,8.0,10.0,1
2344,CC:2F:71:3E:C5:1F,5530910,4451820834,3406909,4182259676,2124001,269561158,502,93229,8002146,78625,6271234,14604,1730912,21548,533,3414310,870692,502,2930,7222.0,1000.0,-74.0,-74.0,-69.0,-61.0,-71.0,-74.0,-68.0,-62.0,-79.0,-84.0,-77.0,-82.0,5.0,10.0,8.0,21.0,1
2345,F8:59:71:5A:E0:3D,3469259,2285010431,1345257,2015449213,2124002,269561218,294,764395,935069019,763698,934985128,697,83891,752996,1840,1345387,169183,294,1159,144444.0,43333.0,-68.0,-73.0,-64.0,-71.0,-67.0,-73.0,-64.0,-70.0,-79.0,-84.0,-77.0,-82.0,11.0,11.0,13.0,11.0,1
2346,CC:2F:71:3F:1F:24,4058230,2826050634,1934228,2556489416,2124002,269561218,2596,1571430,2014603873,1570308,2014476623,1122,127250,1553708,6254,1934101,220013,2596,1851,144444.0,43333.0,-69.0,-65.0,-70.0,-72.0,-69.0,-64.0,-69.0,-72.0,-79.0,-84.0,-77.0,-82.0,10.0,19.0,7.0,10.0,1
2347,CC:2F:71:3E:C5:1F,5530911,4451820894,3406909,4182259676,2124002,269561218,502,93229,8002146,78625,6271234,14604,1730912,21548,533,3414310,870692,502,2930,7222.0,1000.0,-74.0,-74.0,-69.0,-61.0,-71.0,-74.0,-68.0,-62.0,-79.0,-84.0,-77.0,-82.0,5.0,10.0,8.0,21.0,1
2348,F8:59:71:5A:E0:3D,3469324,2285108535,1345320,2015547115,2124004,269561420,294,764457,935164499,763760,935080608,697,83891,753058,1840,1345450,169184,294,1159,144444.0,43333.0,-68.0,-73.0,-64.0,-71.0,-68.0,-73.0,-64.0,-71.0,-79.0,-84.0,-77.0,-82.0,11.0,11.0,13.0,11.0,1
2349,CC:2F:71:3F:1F:24,4058390,2826254246,1934384,2556692624,2124006,269561622,2596,1571572,2014797993,1570450,2014670743,1122,127250,1553850,6254,1934259,220028,2596,1851,144444.0,43333.0,-69.0,-65.0,-69.0,-72.0,-69.0,-65.0,-69.0,-72.0,-79.0,-84.0,-77.0,-82.0,10.0,19.0,8.0,10.0,1
2350,CC:2F:71:3E:C5:1F,5530917,4451821500,3406909,4182259676,2124008,269561824,502,93229,8002146,78625,6271234,14604,1730912,21548,533,3414310,870692,502,2930,7222.0,1000.0,-74.0,-74.0,-69.0,-61.0,-71.0,-74.0,-68.0,-62.0,-79.0,-84.0,-77.0,-82.0,5.0,10.0,8.0,21.0,1
2351,F8:59:71:5A:E0:3D,3469393,2285207043,1345383,2015645017,2124010,269562026,294,764520,935261519,763823,935177628,697,83891,753121,1840,1345513,169185,294,1159,144444.0,43333.0,-67.0,-74.0,-64.0,-71.0,-68.0,-73.0,-64.0,-71.0,-79.0,-84.0,-77.0,-82.0,12.0,10.0,13.0,11.0,1
2352,CC:2F:71:3F:1F:24,4058552,2826460966,1934542,2556898940,2124010,269562026,2596,1571714,2014994961,1570592,2014867711,1122,127250,1553992,6254,1934417,220044,2596,1851,144444.0,43333.0,-69.0,-65.0,-69.0,-72.0,-69.0,-65.0,-69.0,-72.0,-79.0,-84.0,-77.0,-82.0,10.0,19.0,8.0,10.0,1
2353,CC:2F:71:3E:C5:1F,5530919,4451821702,3406909,4182259676,2124010,269562026,502,93229,8002146,78625,6271234,14604,1730912,21548,533,3414310,870692,502,2930,7222.0,1000.0,-74.0,-74.0,-69.0,-61.0,-71.0,-74.0,-68.0,-62.0,-79.0,-84.0,-77.0,-82.0,5.0,10.0,8.0,21.0,1
2354,F8:59:71:5A:E0:3D,3469457,2285305005,1345446,2015742919,2124011,269562086,294,764583,935358539,763886,935274648,697,83891,753184,1840,1345576,169185,294,1159,144444.0,43333.0,-68.0,-74.0,-64.0,-71.0,-68.0,-73.0,-63.0,-70.0,-79.0,-84.0,-77.0,-82.0,11.0,10.0,13.0,11.0,1
2355,CC:2F:71:3F:1F:24,4058752,2826682930,1934741,2557120844,2124011,269562086,2596,1571895,2015208003,1570773,2015080753,1122,127250,1554173,6254,1934616,220060,2596,1851,144444.0,43333.0,-71.0,-64.0,-72.0,-70.0,-70.0,-64.0,-70.0,-70.0,-79.0,-84.0,-77.0,-82.0,8.0,20.0,5.0,12.0,1
2356,CC:2F:71:3E:C5:1F,5530922,4451821964,3406909,4182259676,2124013,269562288,502,93229,8002146,78625,6271234,14604,1730912,21548,533,3414310,870692,502,2930,7222.0,1000.0,-74.0,-74.0,-69.0,-61.0,-71.0,-74.0,-68.0,-62.0,-79.0,-84.0,-77.0,-82.0,5.0,10.0,8.0,21.0,1
2357,F8:59:71:5A:E0:3D,3469528,2285403715,1345509,2015840821,2124019,269562894,294,764647,935457099,763950,935373208,697,83891,753248,1840,1345639,169185,294,1159,144444.0,43333.0,-68.0,-73.0,-64.0,-70.0,-67.0,-72.0,-63.0,-69.0,-79.0,-84.0,-78.0,-82.0,11.0,11.0,14.0,12.0,1
2358,CC:2F:71:3F:1F:24,4058920,2826893050,1934901,2557330156,2124019,269562894,2596,1572041,2015408283,1570919,2015281033,1122,127250,1554319,6254,1934776,220076,2596,1851,144444.0,43333.0,-72.0,-63.0,-72.0,-73.0,-70.0,-62.0,-69.0,-71.0,-79.0,-84.0,-78.0,-82.0,7.0,21.0,6.0,9.0,1
2359,CC:2F:71:3E:C5:1F,5530928,4451822570,3406909,4182259676,2124019,269562894,502,93229,8002146,78625,6271234,14604,1730912,21548,533,3414310,870692,502,2930,7222.0,1000.0,-74.0,-74.0,-69.0,-61.0,-71.0,-74.0,-68.0,-62.0,-79.0,-84.0,-78.0,-82.0,5.0,10.0,9.0,21.0,1
2360,F8:59:71:5A:E0:3D,3469703,2285657599,1345684,2016094705,2124019,269562894,294,764742,935570124,764045,935486233,697,83891,753343,1840,1345814,169185,294,1159,144444.0,43333.0,-67.0,-74.0,-64.0,-70.0,-67.0,-73.0,-64.0,-70.0,-79.0,-84.0,-78.0,-82.0,12.0,10.0,14.0,12.0,1
2361,CC:2F:71:3F:1F:24,4059088,2827103218,1935069,2557540324,2124019,269562894,2596,1572196,2015610224,1571074,2015482974,1122,127250,1554474,6254,1934944,220136,2596,1851,86667.0,14444.0,-69.0,-64.0,-68.0,-71.0,-70.0,-63.0,-69.0,-70.0,-79.0,-84.0,-78.0,-82.0,10.0,20.0,10.0,11.0,1
2362,CC:2F:71:3E:C5:1F,5530928,4451822570,3406909,4182259676,2124019,269562894,502,93229,8002146,78625,6271234,14604,1730912,21548,533,3414310,870692,502,2930,7222.0,1000.0,-74.0,-74.0,-69.0,-61.0,-71.0,-74.0,-68.0,-62.0,-78.0,-84.0,-77.0,-82.0,4.0,10.0,8.0,21.0,1
2363,F8:59:71:5A:E0:3D,3469924,2285974751,1345896,2016410989,2124028,269563762,294,764849,935676487,764152,935592596,697,83891,753450,1840,1346026,169190,294,1159,144444.0,43333.0,-70.0,-74.0,-64.0,-71.0,-69.0,-73.0,-63.0,-70.0,-78.0,-84.0,-77.0,-82.0,8.0,10.0,13.0,11.0,1
2364,CC:2F:71:3F:1F:24,4059267,2827312834,1935239,2557749072,2124028,269563762,2596,1572347,2015807984,1571225,2015680734,1122,127250,1554625,6254,1935114,220136,2596,1851,86667.0,14444.0,-71.0,-63.0,-73.0,-70.0,-70.0,-63.0,-70.0,-69.0,-78.0,-84.0,-77.0,-82.0,7.0,21.0,4.0,12.0,1
2365,CC:2F:71:3E:C5:1F,5530937,4451823438,3406909,4182259676,2124028,269563762,502,93229,8002146,78625,6271234,14604,1730912,21548,533,3414310,870692,502,2930,7222.0,1000.0,-74.0,-74.0,-69.0,-61.0,-71.0,-74.0,-68.0,-62.0,-78.0,-84.0,-77.0,-82.0,4.0,10.0,8.0,21.0,1
2366,F8:59:71:5A:E0:3D,3469986,2286071099,1345958,2016507337,2124028,269563762,294,764912,935773507,764215,935689616,697,83891,753513,1840,1346088,169191,294,1159,144444.0,43333.0,-69.0,-74.0,-64.0,-71.0,-69.0,-73.0,-64.0,-70.0,-78.0,-84.0,-77.0,-82.0,9.0,10.0,13.0,11.0,1
2367,CC:2F:71:3F:1F:24,4059423,2827516794,1935395,2557953032,2124028,269563762,2596,1572491,2016003760,1571369,2015876510,1122,127250,1554769,6254,1935270,220149,2596,1851,86667.0,14444.0,-69.0,-63.0,-69.0,-71.0,-69.0,-63.0,-70.0,-71.0,-78.0,-84.0,-77.0,-82.0,9.0,21.0,8.0,11.0,1
2368,CC:2F:71:3E:C5:1F,5530937,4451823438,3406909,4182259676,2124028,269563762,502,93229,8002146,78625,6271234,14604,1730912,21548,533,3414310,870692,502,2930,7222.0,1000.0,-74.0,-74.0,-69.0,-61.0,-71.0,-74.0,-68.0,-62.0,-78.0,-84.0,-77.0,-82.0,4.0,10.0,8.0,21.0,1
2369,F8:59:71:5A:E0:3D,3470153,2286287134,1346119,2016722766,2124034,269564368,294,765005,935878632,764308,935794741,697,83891,753606,1840,1346249,169191,294,1160,144444.0,43333.0,-70.0,-74.0,-64.0,-72.0,-69.0,-73.0,-63.0,-71.0,-78.0,-84.0,-77.0,-82.0,8.0,10.0,13.0,10.0,1
2370,CC:2F:71:3F:1F:24,4059639,2827739090,1935605,2558174722,2124034,269564368,2596,1572675,2016219641,1571553,2016092391,1122,127250,1554953,6254,1935480,220149,2596,1851,65000.0,13000.0,-71.0,-63.0,-72.0,-72.0,-69.0,-63.0,-70.0,-71.0,-77.0,-84.0,-76.0,-81.0,6.0,21.0,4.0,9.0,1
2371,CC:2F:71:3E:C5:1F,5530945,4451824246,3406909,4182259676,2124036,269564570,502,93229,8002146,78625,6271234,14604,1730912,21548,533,3414310,870692,502,2930,7222.0,1000.0,-74.0,-74.0,-69.0,-61.0,-71.0,-74.0,-68.0,-62.0,-77.0,-84.0,-76.0,-81.0,3.0,10.0,7.0,20.0,1
2372,F8:59:71:5A:E0:3D,3470219,2286385298,1346182,2016820668,2124037,269564630,294,765068,935975652,764371,935891761,697,83891,753669,1840,1346312,169191,294,1160,144444.0,43333.0,-68.0,-73.0,-63.0,-70.0,-68.0,-73.0,-63.0,-70.0,-77.0,-84.0,-76.0,-81.0,9.0,11.0,13.0,11.0,1
2373,CC:2F:71:3F:1F:24,4059800,2827945108,1935763,2558380478,2124037,269564630,2596,1572820,2016416957,1571698,2016289707,1122,127250,1555098,6254,1935638,220149,2596,1851,86667.0,14444.0,-69.0,-63.0,-69.0,-71.0,-69.0,-63.0,-69.0,-71.0,-77.0,-84.0,-76.0,-81.0,8.0,21.0,7.0,10.0,1
2374,CC:2F:71:3E:C5:1F,5530946,4451824306,3406909,4182259676,2124037,269564630,502,93229,8002146,78625,6271234,14604,1730912,21548,533,3414310,870692,502,2930,7222.0,1000.0,-74.0,-74.0,-69.0,-61.0,-71.0,-74.0,-68.0,-62.0,-77.0,-84.0,-76.0,-81.0,3.0,10.0,7.0,20.0,1
2375,F8:59:71:5A:E0:3D,3470288,2286483806,1346245,2016918570,2124043,269565236,294,765131,936072672,764434,935988781,697,83891,753732,1840,1346375,169192,294,1160,144444.0,43333.0,-68.0,-73.0,-64.0,-70.0,-69.0,-73.0,-64.0,-71.0,-77.0,-84.0,-76.0,-81.0,9.0,11.0,12.0,11.0,1
2376,CC:2F:71:3F:1F:24,4060099,2828277825,1936056,2558712589,2124043,269565236,2596,1573046,2016638153,1571924,2016510903,1122,127250,1555324,6254,1935931,220218,2596,1851,115556.0,26000.0,-71.0,-63.0,-72.0,-72.0,-70.0,-63.0,-70.0,-71.0,-77.0,-84.0,-76.0,-81.0,6.0,21.0,4.0,9.0,1
2377,CC:2F:71:3E:C5:1F,5530952,4451824912,3406909,4182259676,2124043,269565236,502,93229,8002146,78625,6271234,14604,1730912,21548,533,3414310,870692,502,2930,7222.0,1000.0,-74.0,-74.0,-69.0,-61.0,-71.0,-74.0,-68.0,-62.0,-77.0,-84.0,-76.0,-81.0,3.0,10.0,7.0,20.0,1
2378,F8:59:71:5A:E0:3D,3470354,2286582183,1346308,2017016472,2124046,269565711,294,765194,936169692,764497,936085801,697,83891,753795,1840,1346438,169192,294,1160,144444.0,43333.0,-70.0,-74.0,-64.0,-72.0,-69.0,-73.0,-63.0,-71.0,-78.0,-84.0,-77.0,-82.0,8.0,10.0,13.0,10.0,1
2379,CC:2F:71:3F:1F:24,4060264,2828490552,1936218,2558924841,2124046,269565711,2596,1573193,2016841397,1572071,2016714147,1122,127250,1555471,6254,1936093,220267,2596,1851,115556.0,28889.0,-71.0,-63.0,-72.0,-72.0,-69.0,-63.0,-69.0,-71.0,-78.0,-84.0,-77.0,-82.0,7.0,21.0,5.0,10.0,1
2380,CC:2F:71:3E:C5:1F,5530956,4451825447,3406909,4182259676,2124047,269565771,502,93229,8002146,78625,6271234,14604,1730912,21548,533,3414310,870692,502,2930,7222.0,1000.0,-74.0,-74.0,-69.0,-61.0,-71.0,-74.0,-68.0,-62.0,-78.0,-84.0,-77.0,-82.0,4.0,10.0,8.0,21.0,1
2381,F8:59:71:5A:E0:3D,3470427,2286685413,1346374,2017119036,2124053,269566377,294,765260,936271332,764563,936187441,697,83891,753861,1840,1346504,169192,294,1160,144444.0,43333.0,-70.0,-74.0,-64.0,-72.0,-69.0,-73.0,-64.0,-71.0,-78.0,-84.0,-77.0,-82.0,8.0,10.0,13.0,10.0,1
2382,CC:2F:71:3F:1F:24,4061139,2829586423,1937086,2560020046,2124053,269566377,2596,1573605,2017115800,1572483,2016988550,1122,127250,1555883,6254,1936961,220939,2596,1851,115556.0,28889.0,-71.0,-63.0,-71.0,-73.0,-70.0,-63.0,-70.0,-71.0,-78.0,-84.0,-77.0,-82.0,7.0,21.0,6.0,9.0,1
2383,CC:2F:71:3E:C5:1F,5530962,4451826053,3406909,4182259676,2124053,269566377,502,93229,8002146,78625,6271234,14604,1730912,21548,533,3414310,870692,502,2930,7222.0,1000.0,-74.0,-74.0,-69.0,-61.0,-71.0,-74.0,-68.0,-62.0,-78.0,-84.0,-77.0,-82.0,4.0,10.0,8.0,21.0,1
2384,F8:59:71:5A:E0:3D,3470497,2286785449,1346439,2017218440,2124058,269567009,294,765324,936369892,764627,936286001,697,83891,753925,1840,1346569,169192,294,1160,144444.0,43333.0,-68.0,-73.0,-64.0,-70.0,-68.0,-73.0,-63.0,-71.0,-78.0,-84.0,-77.0,-82.0,10.0,11.0,13.0,12.0,1
2385,CC:2F:71:3F:1F:24,4062040,2830733502,1937982,2561166493,2124058,269567009,2596,1573913,2017384746,1572790,2017257378,1123,127368,1556190,6254,1937857,221254,2596,1851,115556.0,28889.0,-70.0,-63.0,-70.0,-72.0,-70.0,-63.0,-70.0,-71.0,-78.0,-84.0,-77.0,-82.0,8.0,21.0,7.0,10.0,1
2386,CC:2F:71:3E:C5:1F,5530968,4451826801,3406910,4182259792,2124058,269567009,502,93231,8002286,78627,6271374,14604,1730912,21548,533,3414311,870692,502,2930,7222.0,1000.0,-77.0,-84.0,-76.0,-72.0,-72.0,-76.0,-70.0,-64.0,-78.0,-84.0,-77.0,-82.0,1.0,0.0,1.0,10.0,1
2387,F8:59:71:5A:E0:3D,3470706,2287106030,1346645,2017538759,2124061,269567271,294,765427,936474784,764730,936390893,697,83891,754028,1840,1346775,169192,294,1160,144444.0,43333.0,-69.0,-73.0,-63.0,-71.0,-69.0,-73.0,-63.0,-71.0,-77.0,-83.0,-76.0,-81.0,8.0,10.0,13.0,10.0,1
2388,CC:2F:71:3F:1F:24,4062890,2831861248,1938827,2562293775,2124063,269567473,2596,1574191,2017615231,1573068,2017487863,1123,127368,1556468,6254,1938701,221313,2596,1851,86667.0,14444.0,-69.0,-63.0,-69.0,-71.0,-69.0,-63.0,-69.0,-71.0,-77.0,-83.0,-76.0,-81.0,8.0,20.0,7.0,10.0,1
2389,CC:2F:71:3E:C5:1F,5530975,4451827467,3406910,4182259792,2124065,269567675,502,93231,8002286,78627,6271374,14604,1730912,21548,533,3414311,870692,502,2930,7222.0,1000.0,-77.0,-84.0,-76.0,-72.0,-72.0,-76.0,-70.0,-64.0,-77.0,-83.0,-76.0,-81.0,0.0,-1.0,0.0,9.0,1
2390,F8:59:71:5A:E0:3D,3470957,2287487556,1346890,2017919679,2124067,269567877,294,765522,936578830,764825,936494939,697,83891,754123,1840,1347020,169192,294,1160,144444.0,43333.0,-70.0,-74.0,-64.0,-72.0,-69.0,-73.0,-63.0,-71.0,-77.0,-83.0,-76.0,-81.0,7.0,9.0,12.0,9.0,1
2391,CC:2F:71:3F:1F:24,4063156,2832143168,1939089,2562575291,2124067,269567877,2596,1574405,2017848026,1573282,2017720658,1123,127368,1556682,6254,1938963,221313,2596,1851,65000.0,13000.0,-71.0,-63.0,-71.0,-72.0,-70.0,-63.0,-70.0,-71.0,-77.0,-83.0,-76.0,-81.0,6.0,20.0,5.0,9.0,1
2392,CC:2F:71:3E:C5:1F,5530977,4451827669,3406910,4182259792,2124067,269567877,502,93231,8002286,78627,6271374,14604,1730912,21548,533,3414311,870692,502,2930,7222.0,1000.0,-77.0,-84.0,-76.0,-72.0,-72.0,-76.0,-70.0,-64.0,-77.0,-83.0,-76.0,-81.0,0.0,-1.0,0.0,9.0,1
2393,F8:59:71:5A:E0:3D,3471021,2287587012,1346954,2018019135,2124067,269567877,294,765585,936675850,764888,936591959,697,83891,754186,1840,1347084,169193,294,1160,144444.0,43333.0,-69.0,-74.0,-64.0,-72.0,-69.0,-73.0,-63.0,-71.0,-77.0,-83.0,-76.0,-81.0,8.0,9.0,12.0,9.0,1
2394,CC:2F:71:3F:1F:24,4064032,2833297239,1939965,2563729362,2124067,269567877,2596,1574694,2018086389,1573571,2017959021,1123,127368,1556971,6254,1939840,221334,2596,1851,86667.0,14444.0,-71.0,-63.0,-71.0,-72.0,-69.0,-63.0,-69.0,-71.0,-77.0,-83.0,-76.0,-81.0,6.0,20.0,5.0,9.0,1
2395,CC:2F:71:3E:C5:1F,5530979,4451827871,3406910,4182259792,2124069,269568079,502,93231,8002286,78627,6271374,14604,1730912,21548,533,3414311,870692,502,2930,7222.0,1000.0,-77.0,-84.0,-76.0,-72.0,-72.0,-76.0,-70.0,-64.0,-77.0,-83.0,-76.0,-81.0,0.0,-1.0,0.0,9.0,1
2396,F8:59:71:5A:E0:3D,3471332,2288019978,1347256,2018451233,2124076,269568745,294,765689,936780837,764992,936696946,697,83891,754290,1840,1347386,169193,294,1160,144444.0,43333.0,-69.0,-74.0,-63.0,-71.0,-69.0,-73.0,-63.0,-71.0,-77.0,-83.0,-75.0,-80.0,8.0,9.0,12.0,9.0,1
2397,CC:2F:71:3F:1F:24,4064198,2833502309,1940122,2563933564,2124076,269568745,2596,1574838,2018282165,1573715,2018154797,1123,127368,1557115,6254,1939997,221334,2596,1851,86667.0,14444.0,-71.0,-63.0,-71.0,-73.0,-70.0,-63.0,-70.0,-71.0,-77.0,-83.0,-75.0,-80.0,6.0,20.0,4.0,7.0,1
2398,CC:2F:71:3E:C5:1F,5530986,4451828537,3406910,4182259792,2124076,269568745,502,93231,8002286,78627,6271374,14604,1730912,21548,533,3414311,870692,502,2930,7222.0,1000.0,-77.0,-84.0,-76.0,-72.0,-72.0,-76.0,-70.0,-64.0,-77.0,-83.0,-75.0,-80.0,0.0,-1.0,-1.0,8.0,1
2399,F8:59:71:5A:E0:3D,3471395,2288117880,1347319,2018549135,2124076,269568745,294,765751,936876317,765054,936792426,697,83891,754352,1840,1347449,169193,294,1160,144444.0,43333.0,-69.0,-74.0,-64.0,-72.0,-68.0,-73.0,-63.0,-71.0,-77.0,-83.0,-75.0,-80.0,8.0,9.0,11.0,8.0,1
2400,CC:2F:71:3F:1F:24,4064386,2833715111,1940310,2564146366,2124076,269568745,2596,1575004,2018491656,1573881,2018364288,1123,127368,1557281,6254,1940185,221345,2596,1851,104000.0,26000.0,-69.0,-63.0,-68.0,-71.0,-69.0,-63.0,-68.0,-71.0,-77.0,-83.0,-75.0,-80.0,8.0,20.0,7.0,9.0,1
2401,CC:2F:71:3E:C5:1F,5530986,4451828537,3406910,4182259792,2124076,269568745,502,93231,8002286,78627,6271374,14604,1730912,21548,533,3414311,870692,502,2930,7222.0,1000.0,-77.0,-84.0,-76.0,-72.0,-72.0,-76.0,-70.0,-64.0,-77.0,-83.0,-75.0,-80.0,0.0,-1.0,-1.0,8.0,1
2402,F8:59:71:5A:E0:3D,3471466,2288216590,1347382,2018647037,2124084,269569553,294,765815,936974877,765118,936890986,697,83891,754416,1840,1347512,169193,294,1160,144444.0,43333.0,-69.0,-73.0,-64.0,-72.0,-68.0,-73.0,-63.0,-70.0,-77.0,-83.0,-75.0,-80.0,8.0,10.0,11.0,8.0,1
2403,CC:2F:71:3F:1F:24,4064564,2833921555,1940480,2564352002,2124084,269569553,2596,1575160,2018701849,1574037,2018574481,1123,127368,1557437,6254,1940354,221349,2596,1851,86667.0,14444.0,-68.0,-63.0,-68.0,-72.0,-69.0,-63.0,-69.0,-71.0,-77.0,-83.0,-75.0,-80.0,9.0,20.0,7.0,8.0,1
2404,CC:2F:71:3E:C5:1F,5530994,4451829345,3406910,4182259792,2124084,269569553,502,93231,8002286,78627,6271374,14604,1730912,21548,533,3414311,870692,502,2930,7222.0,1000.0,-77.0,-84.0,-76.0,-72.0,-72.0,-76.0,-70.0,-64.0,-77.0,-83.0,-75.0,-80.0,0.0,-1.0,-1.0,8.0,1
2405,F8:59:71:5A:E0:3D,3471799,2288714788,1347714,2019145175,2124085,269569613,294,765970,937122268,765273,937038377,697,83891,754571,1840,1347844,169198,294,1160,144444.0,43333.0,-70.0,-74.0,-64.0,-72.0,-69.0,-72.0,-63.0,-71.0,-77.0,-83.0,-75.0,-80.0,7.0,9.0,11.0,8.0,1
2406,CC:2F:71:3F:1F:24,4066834,2836971319,1942749,2567401706,2124085,269569613,2596,1575778,2019079179,1574655,2018951811,1123,127368,1558048,6254,1942625,221712,2596,1851,86667.0,14444.0,-71.0,-63.0,-72.0,-72.0,-69.0,-63.0,-69.0,-71.0,-77.0,-83.0,-75.0,-80.0,6.0,20.0,3.0,8.0,1
2407,CC:2F:71:3E:C5:1F,5530999,4451829809,3406910,4182259792,2124089,269570017,502,93231,8002286,78627,6271374,14604,1730912,21548,533,3414311,870692,502,2930,7222.0,1000.0,-77.0,-84.0,-76.0,-72.0,-72.0,-76.0,-70.0,-64.0,-77.0,-83.0,-75.0,-80.0,0.0,-1.0,-1.0,8.0,1
2408,F8:59:71:5A:E0:3D,3471877,2288820172,1347784,2019249751,2124093,269570421,294,766040,937227686,765343,937143795,697,83891,754641,1840,1347914,169199,294,1160,144444.0,43333.0,-68.0,-73.0,-63.0,-71.0,-68.0,-73.0,-63.0,-71.0,-77.0,-83.0,-76.0,-81.0,9.0,10.0,13.0,10.0,1
2409,CC:2F:71:3F:1F:24,4067349,2837627425,1943256,2568057004,2124093,269570421,2596,1576044,2019324917,1574921,2019197549,1123,127368,1558299,6254,1943132,221713,2596,1851,86667.0,14444.0,-71.0,-63.0,-71.0,-73.0,-71.0,-65.0,-72.0,-73.0,-77.0,-83.0,-76.0,-81.0,6.0,20.0,5.0,8.0,1
2410,CC:2F:71:3E:C5:1F,5531003,4451830213,3406910,4182259792,2124093,269570421,502,93231,8002286,78627,6271374,14604,1730912,21548,533,3414311,870692,502,2930,7222.0,1000.0,-77.0,-84.0,-76.0,-72.0,-72.0,-76.0,-70.0,-64.0,-77.0,-83.0,-76.0,-81.0,0.0,-1.0,0.0,9.0,1
2411,F8:59:71:5A:E0:3D,3472051,2289052194,1347954,2019481385,2124097,269570809,294,766145,937355811,765448,937271920,697,83891,754746,1840,1348084,169200,294,1160,144444.0,43333.0,-68.0,-73.0,-63.0,-71.0,-68.0,-73.0,-63.0,-71.0,-77.0,-83.0,-76.0,-81.0,9.0,10.0,13.0,10.0,1
2412,CC:2F:71:3F:1F:24,4067745,2838128802,1943646,2568557791,2124099,269571011,2596,1576314,2019577074,1575191,2019449706,1123,127368,1558555,6254,1943522,221756,2596,1851,86667.0,14444.0,-70.0,-63.0,-68.0,-71.0,-69.0,-63.0,-69.0,-71.0,-77.0,-83.0,-76.0,-81.0,7.0,20.0,8.0,10.0,1
2413,CC:2F:71:3E:C5:1F,5531009,4451830803,3406910,4182259792,2124099,269571011,502,93231,8002286,78627,6271374,14604,1730912,21548,533,3414311,870692,502,2930,7222.0,1000.0,-77.0,-84.0,-76.0,-72.0,-72.0,-76.0,-70.0,-64.0,-77.0,-83.0,-76.0,-81.0,0.0,-1.0,0.0,9.0,1
2414,F8:59:71:5A:E0:3D,3472124,2289156918,1348021,2019585503,2124103,269571415,294,766212,937458991,765515,937375100,697,83891,754813,1840,1348151,169200,294,1160,144444.0,43333.0,-69.0,-74.0,-63.0,-71.0,-68.0,-73.0,-63.0,-70.0,-77.0,-83.0,-76.0,-81.0,8.0,9.0,13.0,10.0,1
2415,CC:2F:71:3F:1F:24,4067963,2838371809,1943859,2568800332,2124104,269571477,2596,1576526,2019826092,1575403,2019698724,1123,127368,1558754,6254,1943735,221756,2596,1851,86667.0,14444.0,-70.0,-63.0,-69.0,-70.0,-70.0,-63.0,-70.0,-70.0,-76.0,-83.0,-75.0,-80.0,6.0,20.0,6.0,10.0,1
2416,CC:2F:71:3E:C5:1F,5531014,4451831269,3406910,4182259792,2124104,269571477,502,93231,8002286,78627,6271374,14604,1730912,21548,533,3414311,870692,502,2930,7222.0,1000.0,-77.0,-84.0,-76.0,-72.0,-72.0,-76.0,-70.0,-64.0,-76.0,-83.0,-75.0,-80.0,-1.0,-1.0,-1.0,8.0,1
2417,F8:59:71:5A:E0:3D,3472200,2289267851,1348092,2019695837,2124108,269572014,294,766284,937568449,765586,937484440,698,84009,754885,1840,1348222,169202,294,1160,144444.0,43333.0,-68.0,-74.0,-63.0,-70.0,-67.0,-73.0,-63.0,-70.0,-76.0,-83.0,-75.0,-80.0,8.0,9.0,12.0,10.0,1
2418,CC:2F:71:3F:1F:24,4068178,2838607402,1944068,2569035186,2124110,269572216,2596,1576722,2020058921,1575599,2019931553,1123,127368,1558939,6254,1943944,221756,2596,1851,86667.0,14444.0,-69.0,-63.0,-69.0,-70.0,-70.0,-62.0,-70.0,-70.0,-76.0,-83.0,-75.0,-80.0,7.0,20.0,6.0,10.0,1
2419,CC:2F:71:3E:C5:1F,5531020,4451832008,3406910,4182259792,2124110,269572216,502,93233,8002474,78628,6271444,14605,1731030,21549,533,3414311,870692,502,2930,7222.0,1000.0,-70.0,-72.0,-67.0,-61.0,-72.0,-75.0,-69.0,-63.0,-76.0,-83.0,-75.0,-80.0,6.0,11.0,8.0,19.0,1
2420,F8:59:71:5A:E0:3D,3472278,2289378851,1348163,2019806171,2124115,269572680,294,766354,937676249,765656,937592240,698,84009,754955,1840,1348293,169203,294,1160,144444.0,43333.0,-68.0,-74.0,-63.0,-71.0,-68.0,-73.0,-62.0,-70.0,-76.0,-83.0,-75.0,-80.0,8.0,9.0,12.0,9.0,1
2421,CC:2F:71:3F:1F:24,4068351,2838830474,1944236,2569257794,2124115,269572680,2596,1576886,2020275293,1575763,2020147925,1123,127368,1559093,6254,1944112,221771,2596,1852,86667.0,14444.0,-69.0,-63.0,-68.0,-71.0,-69.0,-62.0,-68.0,-70.0,-76.0,-83.0,-75.0,-80.0,7.0,20.0,7.0,9.0,1
2422,CC:2F:71:3E:C5:1F,5531025,4451832472,3406910,4182259792,2124115,269572680,502,93233,8002474,78628,6271444,14605,1731030,21549,533,3414311,870692,502,2930,7222.0,1000.0,-70.0,-72.0,-67.0,-61.0,-72.0,-75.0,-69.0,-63.0,-76.0,-83.0,-75.0,-80.0,6.0,11.0,8.0,19.0,1
2423,F8:59:71:5A:E0:3D,3472348,2289484725,1348231,2019911843,2124117,269572882,294,766423,937782509,765725,937698500,698,84009,755024,1840,1348361,169204,294,1160,144444.0,43333.0,-67.0,-73.0,-63.0,-71.0,-68.0,-73.0,-62.0,-70.0,-77.0,-84.0,-75.0,-80.0,10.0,11.0,12.0,9.0,1
2424,CC:2F:71:3F:1F:24,4068542,2839054875,1944423,2569481791,2124119,269573084,2596,1577064,2020493992,1575941,2020366624,1123,127368,1559262,6254,1944298,221771,2596,1852,86667.0,14444.0,-71.0,-63.0,-72.0,-71.0,-69.0,-63.0,-69.0,-70.0,-77.0,-84.0,-75.0,-80.0,6.0,21.0,3.0,9.0,1
2425,CC:2F:71:3E:C5:1F,5531029,4451832876,3406910,4182259792,2124119,269573084,502,93233,8002474,78628,6271444,14605,1731030,21549,533,3414311,870692,502,2930,7222.0,1000.0,-70.0,-72.0,-67.0,-61.0,-72.0,-75.0,-69.0,-63.0,-77.0,-84.0,-75.0,-80.0,7.0,12.0,8.0,19.0,1
2426,F8:59:71:5A:E0:3D,3472575,2289828991,1348452,2020255503,2124123,269573488,294,766535,937896993,765837,937812984,698,84009,755136,1840,1348582,169204,294,1160,144444.0,43333.0,-68.0,-73.0,-63.0,-70.0,-67.0,-73.0,-62.0,-70.0,-77.0,-84.0,-76.0,-81.0,9.0,11.0,13.0,11.0,1
2427,CC:2F:71:3F:1F:24,4068717,2839279799,1944594,2569706311,2124123,269573488,2596,1577230,2020710628,1576107,2020583260,1123,127368,1559418,6254,1944470,221779,2596,1852,115556.0,26000.0,-69.0,-63.0,-69.0,-71.0,-69.0,-63.0,-69.0,-70.0,-77.0,-84.0,-76.0,-81.0,8.0,21.0,7.0,10.0,1
2428,CC:2F:71:3E:C5:1F,5531034,4451833340,3406910,4182259792,2124124,269573548,502,93233,8002474,78628,6271444,14605,1731030,21549,533,3414311,870692,502,2930,7222.0,1000.0,-70.0,-72.0,-67.0,-61.0,-72.0,-75.0,-69.0,-63.0,-77.0,-84.0,-76.0,-81.0,7.0,12.0,9.0,20.0,1
2429,F8:59:71:5A:E0:3D,3472644,2289931817,1348518,2020358067,2124126,269573750,294,766600,937997093,765902,937913084,698,84009,755201,1840,1348648,169204,294,1160,144444.0,43333.0,-68.0,-73.0,-63.0,-70.0,-68.0,-73.0,-63.0,-70.0,-77.0,-84.0,-76.0,-81.0,9.0,11.0,13.0,11.0,1
2430,CC:2F:71:3F:1F:24,4068900,2839503691,1944774,2569929941,2124126,269573750,2596,1577406,2020930482,1576283,2020803114,1123,127368,1559583,6254,1944650,221812,2596,1852,86667.0,14444.0,-70.0,-63.0,-69.0,-70.0,-69.0,-62.0,-69.0,-69.0,-77.0,-84.0,-76.0,-81.0,7.0,21.0,7.0,11.0,1
2431,CC:2F:71:3E:C5:1F,5531038,4451833744,3406910,4182259792,2124128,269573952,502,93233,8002474,78628,6271444,14605,1731030,21549,533,3414311,870692,502,2930,7222.0,1000.0,-70.0,-72.0,-67.0,-61.0,-72.0,-75.0,-69.0,-63.0,-77.0,-84.0,-76.0,-81.0,7.0,12.0,9.0,20.0,1
2432,F8:59:71:5A:E0:3D,3472728,2290045230,1348596,2020470874,2124132,269574356,294,766676,938109943,765978,938025934,698,84009,755277,1840,1348726,169204,294,1160,144444.0,43333.0,-69.0,-74.0,-63.0,-71.0,-68.0,-73.0,-63.0,-70.0,-77.0,-84.0,-76.0,-81.0,8.0,10.0,13.0,10.0,1
2433,CC:2F:71:3F:1F:24,4069290,2839934388,1945158,2570360032,2124132,269574356,2596,1577692,2021205933,1576569,2021078565,1123,127368,1559858,6254,1945034,221812,2596,1852,86667.0,14444.0,-71.0,-63.0,-72.0,-71.0,-70.0,-63.0,-70.0,-70.0,-77.0,-84.0,-76.0,-81.0,6.0,21.0,4.0,10.0,1
2434,CC:2F:71:3E:C5:1F,5531042,4451834148,3406910,4182259792,2124132,269574356,502,93233,8002474,78628,6271444,14605,1731030,21549,533,3414311,870692,502,2930,7222.0,1000.0,-70.0,-72.0,-67.0,-61.0,-72.0,-75.0,-69.0,-63.0,-77.0,-84.0,-76.0,-81.0,7.0,12.0,9.0,20.0,1
2435,F8:59:71:5A:E0:3D,3473081,2290588692,1348944,2021013872,2124137,269574820,294,766805,938240731,766107,938156722,698,84009,755405,1840,1349074,169204,294,1160,144444.0,43333.0,-68.0,-73.0,-63.0,-70.0,-68.0,-73.0,-63.0,-70.0,-78.0,-84.0,-76.0,-81.0,10.0,11.0,13.0,11.0,1
2436,CC:2F:71:3F:1F:24,4069531,2840197715,1945394,2570622895,2124137,269574820,2596,1577909,2021444280,1576786,2021316912,1123,127368,1560064,6254,1945270,221826,2596,1852,86667.0,14444.0,-69.0,-63.0,-68.0,-70.0,-70.0,-63.0,-70.0,-69.0,-78.0,-84.0,-76.0,-81.0,9.0,21.0,8.0,11.0,1
2437,CC:2F:71:3E:C5:1F,5531047,4451834612,3406910,4182259792,2124137,269574820,502,93233,8002474,78628,6271444,14605,1731030,21549,533,3414311,870692,502,2930,7222.0,1000.0,-70.0,-72.0,-67.0,-61.0,-72.0,-75.0,-69.0,-63.0,-78.0,-84.0,-76.0,-81.0,8.0,12.0,9.0,20.0,1
2438,F8:59:71:5A:E0:3D,3473345,2290956661,1349204,2021381437,2124141,269575224,294,766917,938360866,766219,938276857,698,84009,755515,1840,1349334,169204,294,1160,144444.0,43333.0,-69.0,-74.0,-63.0,-71.0,-68.0,-73.0,-63.0,-70.0,-78.0,-84.0,-76.0,-81.0,9.0,10.0,13.0,10.0,1
2439,CC:2F:71:3F:1F:24,4069717,2840439987,1945576,2570864763,2124141,269575224,2596,1578091,2021678192,1576968,2021550824,1123,127368,1560236,6254,1945452,221827,2596,1852,86667.0,14444.0,-69.0,-61.0,-71.0,-69.0,-70.0,-62.0,-70.0,-70.0,-78.0,-84.0,-76.0,-81.0,9.0,23.0,5.0,12.0,1
2440,CC:2F:71:3E:C5:1F,5531051,4451835016,3406910,4182259792,2124141,269575224,502,93233,8002474,78628,6271444,14605,1731030,21549,533,3414311,870692,502,2930,7222.0,1000.0,-70.0,-72.0,-67.0,-61.0,-72.0,-75.0,-69.0,-63.0,-78.0,-84.0,-76.0,-81.0,8.0,12.0,9.0,20.0,1
2441,F8:59:71:5A:E0:3D,3473417,2291061299,1349272,2021485671,2124145,269575628,294,766985,938463683,766287,938379674,698,84009,755583,1840,1349402,169204,294,1160,144444.0,43333.0,-69.0,-74.0,-63.0,-71.0,-68.0,-73.0,-62.0,-70.0,-78.0,-84.0,-76.0,-81.0,9.0,10.0,13.0,10.0,1
2442,CC:2F:71:3F:1F:24,4069905,2840659475,1945760,2571083847,2124145,269575628,2596,1578256,2021888033,1577133,2021760665,1123,127368,1560400,6254,1945634,221827,2596,1852,104000.0,26000.0,-71.0,-63.0,-72.0,-70.0,-70.0,-63.0,-70.0,-70.0,-78.0,-85.0,-76.0,-81.0,7.0,22.0,4.0,11.0,1
2443,CC:2F:71:3E:C5:1F,5531055,4451835420,3406910,4182259792,2124145,269575628,502,93233,8002474,78628,6271444,14605,1731030,21549,533,3414311,870692,502,2930,7222.0,1000.0,-70.0,-72.0,-67.0,-61.0,-72.0,-75.0,-69.0,-63.0,-78.0,-85.0,-76.0,-81.0,8.0,13.0,9.0,20.0,1
2444,F8:59:71:5A:E0:3D,3473496,2291165572,1349346,2021589480,2124150,269576092,294,767059,938569512,766361,938485503,698,84009,755655,1840,1349476,169204,294,1160,144444.0,43333.0,-68.0,-74.0,-63.0,-71.0,-68.0,-73.0,-62.0,-70.0,-78.0,-85.0,-76.0,-81.0,10.0,11.0,13.0,10.0,1
2445,CC:2F:71:3F:1F:24,4070418,2841358708,1946268,2571782616,2124150,269576092,2596,1578459,2022103656,1577336,2021976288,1123,127368,1560603,6254,1946144,221849,2596,1852,86667.0,14444.0,-69.0,-63.0,-70.0,-70.0,-69.0,-63.0,-70.0,-69.0,-78.0,-85.0,-76.0,-81.0,9.0,22.0,6.0,11.0,1
2446,CC:2F:71:3E:C5:1F,5531060,4451835884,3406910,4182259792,2124150,269576092,502,93233,8002474,78628,6271444,14605,1731030,21549,533,3414311,870692,502,2930,7222.0,1000.0,-70.0,-72.0,-67.0,-61.0,-72.0,-75.0,-69.0,-63.0,-78.0,-85.0,-76.0,-81.0,8.0,13.0,9.0,20.0,1
2447,F8:59:71:5A:E0:3D,3473562,2291265062,1349410,2021688768,2124152,269576294,294,767122,938666532,766424,938582523,698,84009,755718,1840,1349539,169204,294,1160,144444.0,43333.0,-68.0,-74.0,-63.0,-70.0,-68.0,-73.0,-63.0,-70.0,-78.0,-85.0,-76.0,-81.0,10.0,11.0,13.0,11.0,1
2448,CC:2F:71:3F:1F:24,4070577,2841563275,1946425,2571986981,2124152,269576294,2596,1578601,2022297776,1577478,2022170408,1123,127368,1560745,6254,1946300,221849,2596,1852,86667.0,14444.0,-69.0,-63.0,-69.0,-70.0,-70.0,-63.0,-70.0,-70.0,-78.0,-85.0,-76.0,-81.0,9.0,22.0,7.0,11.0,1
2449,CC:2F:71:3E:C5:1F,5531064,4451836288,3406910,4182259792,2124154,269576496,502,93233,8002474,78628,6271444,14605,1731030,21549,533,3414311,870692,502,2930,7222.0,1000.0,-70.0,-72.0,-67.0,-61.0,-72.0,-75.0,-69.0,-63.0,-78.0,-85.0,-76.0,-81.0,8.0,13.0,9.0,20.0,1
2450,F8:59:71:5A:E0:3D,3473639,2291365479,1349481,2021788579,2124158,269576900,294,767197,938769070,766499,938685061,698,84009,755793,1840,1349611,169204,294,1160,144444.0,43333.0,-67.0,-74.0,-62.0,-70.0,-67.0,-73.0,-62.0,-70.0,-78.0,-85.0,-76.0,-81.0,11.0,11.0,14.0,11.0,1
2451,CC:2F:71:3F:1F:24,4070745,2841774247,1946587,2572197347,2124158,269576900,2596,1578748,2022501010,1577625,2022373642,1123,127368,1560892,6254,1946463,221865,2596,1852,86667.0,13000.0,-69.0,-63.0,-68.0,-70.0,-70.0,-63.0,-70.0,-69.0,-78.0,-85.0,-76.0,-81.0,9.0,22.0,8.0,11.0,1
2452,CC:2F:71:3E:C5:1F,5531069,4451836752,3406910,4182259792,2124159,269576960,502,93233,8002474,78628,6271444,14605,1731030,21549,533,3414311,870692,502,2930,7222.0,1000.0,-70.0,-72.0,-67.0,-61.0,-72.0,-75.0,-69.0,-63.0,-78.0,-85.0,-76.0,-81.0,8.0,13.0,9.0,20.0,1
2453,F8:59:71:5A:E0:3D,3473823,2291640425,1349662,2022063263,2124161,269577162,294,767297,938875541,766599,938791532,698,84009,755893,1840,1349786,169213,294,1160,144444.0,43333.0,-66.0,-73.0,-63.0,-70.0,-67.0,-73.0,-62.0,-70.0,-78.0,-85.0,-76.0,-81.0,12.0,12.0,13.0,11.0,1
2454,CC:2F:71:3F:1F:24,4070935,2841997743,1946774,2572420581,2124161,269577162,2596,1578914,2022718729,1577791,2022591361,1123,127368,1561058,6254,1946650,221905,2596,1854,86667.0,13000.0,-68.0,-63.0,-67.0,-70.0,-69.0,-63.0,-68.0,-69.0,-78.0,-85.0,-76.0,-81.0,10.0,22.0,9.0,11.0,1
2455,CC:2F:71:3E:C5:1F,5531071,4451836954,3406910,4182259792,2124161,269577162,502,93233,8002474,78628,6271444,14605,1731030,21549,533,3414311,870692,502,2930,7222.0,1000.0,-70.0,-72.0,-67.0,-61.0,-72.0,-75.0,-69.0,-63.0,-78.0,-85.0,-76.0,-81.0,8.0,13.0,9.0,20.0,1
2456,F8:59:71:5A:E0:3D,3473939,2291808747,1349774,2022231181,2124165,269577566,294,767381,938981491,766683,938897482,698,84009,755977,1840,1349904,169242,294,1160,144444.0,43333.0,-67.0,-73.0,-61.0,-69.0,-67.0,-73.0,-62.0,-69.0,-78.0,-85.0,-76.0,-81.0,11.0,12.0,15.0,12.0,1
2457,CC:2F:71:3F:1F:24,4071105,2842206878,1946938,2572629110,2124167,269577768,2596,1579061,2022919276,1577938,2022791908,1123,127368,1561204,6254,1946812,221995,2596,1854,86667.0,14444.0,-68.0,-63.0,-67.0,-69.0,-68.0,-63.0,-67.0,-69.0,-78.0,-85.0,-76.0,-81.0,10.0,22.0,9.0,12.0,1
2458,CC:2F:71:3E:C5:1F,5531078,4451837833,3406910,4182259792,2124168,269578041,502,93233,8002474,78628,6271444,14605,1731030,21549,533,3414311,870692,502,2930,7222.0,1000.0,-70.0,-72.0,-67.0,-61.0,-72.0,-75.0,-69.0,-63.0,-78.0,-85.0,-76.0,-81.0,8.0,13.0,9.0,20.0,1
2459,F8:59:71:5A:E0:3D,3474518,2292615567,1350319,2023025810,2124199,269589757,294,767630,939264030,766932,939180021,698,84009,756220,1840,1350449,169354,294,1160,144444.0,43333.0,-69.0,-74.0,-63.0,-71.0,-69.0,-74.0,-63.0,-71.0,-78.0,-85.0,-76.0,-81.0,9.0,11.0,13.0,10.0,1
2460,CC:2F:71:3F:1F:24,4071833,2843204879,1947634,2573615122,2124199,269589757,2596,1579498,2023466732,1578375,2023339364,1123,127368,1561618,6255,1947515,222362,2596,1858,65000.0,21667.0,-71.0,-63.0,-73.0,-70.0,-71.0,-63.0,-72.0,-70.0,-78.0,-85.0,-76.0,-81.0,7.0,22.0,3.0,11.0,1
2461,CC:2F:71:3E:C5:1F,5531110,4451849665,3406911,4182259908,2124199,269589757,502,93235,8002614,78630,6271584,14605,1731030,21549,533,3414312,870692,502,2930,7222.0,1000.0,-70.0,-63.0,-68.0,-62.0,-71.0,-71.0,-68.0,-62.0,-78.0,-85.0,-76.0,-81.0,8.0,22.0,8.0,19.0,1
2462,F8:59:71:5A:E0:3D,3474600,2292725794,1350395,2023135509,2124205,269590285,294,767705,939373811,767006,939289684,699,84127,756295,1840,1350525,169354,294,1160,144444.0,43333.0,-69.0,-73.0,-63.0,-70.0,-69.0,-73.0,-63.0,-70.0,-78.0,-85.0,-76.0,-81.0,9.0,12.0,13.0,11.0,1
2463,CC:2F:71:3F:1F:24,4072013,2843424590,1947807,2573834245,2124206,269590345,2596,1579655,2023679819,1578531,2023552333,1124,127486,1561775,6255,1947687,222362,2596,1858,65000.0,19500.0,-71.0,-63.0,-72.0,-70.0,-71.0,-63.0,-72.0,-70.0,-78.0,-85.0,-76.0,-81.0,7.0,22.0,4.0,11.0,1
2464,CC:2F:71:3E:C5:1F,5531119,4451850455,3406911,4182259908,2124208,269590547,502,93235,8002614,78630,6271584,14605,1731030,21549,533,3414312,870692,502,2930,7222.0,1000.0,-70.0,-63.0,-68.0,-62.0,-71.0,-71.0,-68.0,-62.0,-78.0,-85.0,-76.0,-81.0,8.0,22.0,8.0,19.0,1
2465,F8:59:71:5A:E0:3D,3474667,2292822606,1350457,2023231857,2124210,269590749,294,767768,939470831,767069,939386704,699,84127,756358,1840,1350587,169354,294,1160,144444.0,43333.0,-69.0,-74.0,-63.0,-71.0,-69.0,-74.0,-63.0,-71.0,-78.0,-85.0,-76.0,-81.0,9.0,11.0,13.0,10.0,1
2466,CC:2F:71:3F:1F:24,4072174,2843629084,1947964,2574038335,2124210,269590749,2596,1579799,2023875595,1578675,2023748109,1124,127486,1561919,6255,1947845,222365,2596,1858,72222.0,21667.0,-71.0,-63.0,-72.0,-70.0,-71.0,-63.0,-72.0,-70.0,-78.0,-85.0,-76.0,-81.0,7.0,22.0,4.0,11.0,1
2467,CC:2F:71:3E:C5:1F,5531121,4451850657,3406911,4182259908,2124210,269590749,502,93235,8002614,78630,6271584,14605,1731030,21549,533,3414312,870692,502,2930,7222.0,1000.0,-70.0,-63.0,-68.0,-62.0,-71.0,-71.0,-68.0,-62.0,-78.0,-85.0,-76.0,-81.0,8.0,22.0,8.0,19.0,1
2468,F8:59:71:5A:E0:3D,3474948,2293255555,1350736,2023664604,2124212,269590951,294,767869,939574140,767170,939490013,699,84127,756459,1840,1350866,169354,294,1160,144444.0,43333.0,-69.0,-74.0,-63.0,-71.0,-68.0,-74.0,-63.0,-71.0,-79.0,-85.0,-77.0,-82.0,10.0,11.0,14.0,11.0,1
2469,CC:2F:71:3F:1F:24,4072385,2843896270,1948171,2574305117,2124214,269591153,2596,1579956,2024078135,1578832,2023950649,1124,127486,1562075,6255,1948030,222379,2596,1858,86667.0,14444.0,-71.0,-63.0,-70.0,-70.0,-70.0,-63.0,-70.0,-70.0,-79.0,-85.0,-77.0,-82.0,8.0,22.0,7.0,12.0,1
2470,CC:2F:71:3E:C5:1F,5531125,4451851061,3406911,4182259908,2124214,269591153,502,93235,8002614,78630,6271584,14605,1731030,21549,533,3414312,870692,502,2930,7222.0,1000.0,-70.0,-63.0,-68.0,-62.0,-71.0,-71.0,-68.0,-62.0,-79.0,-85.0,-77.0,-82.0,9.0,22.0,9.0,20.0,1
2471,F8:59:71:5A:E0:3D,3475026,2293362351,1350807,2023770734,2124219,269591617,294,767941,939681215,767242,939597088,699,84127,756531,1840,1350937,169354,294,1160,144444.0,43333.0,-69.0,-73.0,-64.0,-72.0,-68.0,-73.0,-64.0,-71.0,-79.0,-85.0,-77.0,-82.0,10.0,12.0,13.0,10.0,1
2472,CC:2F:71:3F:1F:24,4072946,2844671566,1948727,2575079949,2124219,269591617,2596,1580174,2024298634,1579050,2024171148,1124,127486,1562293,6255,1948605,222379,2596,1858,65000.0,13000.0,-70.0,-63.0,-72.0,-70.0,-69.0,-63.0,-72.0,-70.0,-79.0,-85.0,-77.0,-82.0,9.0,22.0,5.0,12.0,1
2473,CC:2F:71:3E:C5:1F,5531130,4451851525,3406911,4182259908,2124219,269591617,502,93235,8002614,78630,6271584,14605,1731030,21549,533,3414312,870692,502,2930,7222.0,1000.0,-70.0,-63.0,-68.0,-62.0,-71.0,-71.0,-68.0,-62.0,-79.0,-85.0,-77.0,-82.0,9.0,22.0,9.0,20.0,1
2474,F8:59:71:5A:E0:3D,3475298,2293743695,1351077,2024151876,2124221,269591819,294,768070,939794192,767371,939710065,699,84127,756660,1840,1351207,169409,294,1160,144444.0,43333.0,-68.0,-74.0,-64.0,-71.0,-68.0,-74.0,-64.0,-71.0,-79.0,-85.0,-77.0,-82.0,11.0,11.0,13.0,11.0,1
2475,CC:2F:71:3F:1F:24,4073110,2844875443,1948889,2575283624,2124221,269591819,2596,1580319,2024493141,1579195,2024365655,1124,127486,1562438,6255,1948770,222379,2596,1858,86667.0,14444.0,-70.0,-64.0,-72.0,-72.0,-69.0,-64.0,-72.0,-71.0,-79.0,-85.0,-77.0,-82.0,9.0,21.0,5.0,10.0,1
2476,CC:2F:71:3E:C5:1F,5531132,4451851727,3406911,4182259908,2124221,269591819,502,93235,8002614,78630,6271584,14605,1731030,21549,533,3414312,870692,502,2930,7222.0,1000.0,-70.0,-63.0,-68.0,-62.0,-71.0,-71.0,-68.0,-62.0,-80.0,-86.0,-78.0,-83.0,10.0,23.0,10.0,21.0,1
2477,F8:59:71:5A:E0:3D,3475365,2293842001,1351140,2024249778,2124225,269592223,294,768133,939891226,767434,939807099,699,84127,756722,1840,1351270,169409,294,1160,144444.0,43333.0,-68.0,-75.0,-64.0,-72.0,-68.0,-74.0,-64.0,-71.0,-80.0,-86.0,-78.0,-83.0,12.0,11.0,14.0,11.0,1
2478,CC:2F:71:3F:1F:24,4073271,2845081249,1949046,2575489026,2124225,269592223,2596,1580463,2024690341,1579339,2024562855,1124,127486,1562582,6255,1948927,222421,2596,1858,86667.0,14444.0,-71.0,-64.0,-72.0,-70.0,-70.0,-63.0,-72.0,-69.0,-80.0,-86.0,-78.0,-83.0,9.0,22.0,6.0,13.0,1
2479,CC:2F:71:3E:C5:1F,5531136,4451852131,3406911,4182259908,2124225,269592223,502,93235,8002614,78630,6271584,14605,1731030,21549,533,3414312,870692,502,2930,7222.0,1000.0,-70.0,-63.0,-68.0,-62.0,-71.0,-71.0,-68.0,-62.0,-80.0,-86.0,-78.0,-83.0,10.0,23.0,10.0,21.0,1
2480,F8:59:71:5A:E0:3D,3475442,2293941744,1351212,2024349057,2124230,269592687,294,768206,939995569,767507,939911442,699,84127,756793,1840,1351342,169410,294,1160,144444.0,43333.0,-69.0,-74.0,-65.0,-72.0,-69.0,-74.0,-65.0,-71.0,-80.0,-86.0,-78.0,-83.0,11.0,12.0,13.0,11.0,1
2481,CC:2F:71:3F:1F:24,4073431,2845282583,1949201,2575689896,2124230,269592687,2596,1580601,2024881149,1579477,2024753663,1124,127486,1562720,6255,1949082,222440,2596,1858,86667.0,14444.0,-76.0,-68.0,-77.0,-76.0,-76.0,-67.0,-76.0,-75.0,-80.0,-86.0,-78.0,-83.0,4.0,18.0,1.0,7.0,1
2482,CC:2F:71:3E:C5:1F,5531141,4451852595,3406911,4182259908,2124230,269592687,502,93235,8002614,78630,6271584,14605,1731030,21549,533,3414312,870692,502,2930,7222.0,1000.0,-70.0,-63.0,-68.0,-62.0,-71.0,-71.0,-68.0,-62.0,-80.0,-86.0,-78.0,-83.0,10.0,23.0,10.0,21.0,1
2483,F8:59:71:5A:E0:3D,3475510,2294041604,1351276,2024448513,2124234,269593091,294,768272,940097223,767573,940013096,699,84127,756858,1840,1351406,169410,294,1160,144444.0,43333.0,-69.0,-73.0,-65.0,-71.0,-68.0,-73.0,-65.0,-71.0,-80.0,-86.0,-79.0,-83.0,11.0,13.0,14.0,12.0,1
2484,CC:2F:71:3F:1F:24,4073856,2845840718,1949622,2576247627,2124234,269593091,2596,1580811,2025099541,1579687,2024972055,1124,127486,1562930,6255,1949502,222440,2596,1858,86667.0,14444.0,-76.0,-68.0,-76.0,-77.0,-76.0,-68.0,-75.0,-77.0,-80.0,-86.0,-79.0,-83.0,4.0,18.0,3.0,6.0,1
2485,CC:2F:71:3E:C5:1F,5531145,4451852999,3406911,4182259908,2124234,269593091,502,93235,8002614,78630,6271584,14605,1731030,21549,533,3414312,870692,502,2930,7222.0,1000.0,-70.0,-63.0,-68.0,-62.0,-71.0,-71.0,-68.0,-62.0,-80.0,-86.0,-79.0,-83.0,10.0,23.0,11.0,21.0,1
2486,F8:59:71:5A:E0:3D,3475575,2294139708,1351339,2024546415,2124236,269593293,294,768334,940192703,767635,940108576,699,84127,756920,1840,1351469,169412,294,1160,144444.0,43333.0,-69.0,-74.0,-65.0,-72.0,-69.0,-74.0,-65.0,-72.0,-80.0,-86.0,-79.0,-83.0,11.0,12.0,14.0,11.0,1
2487,CC:2F:71:3F:1F:24,4074016,2846043770,1949778,2576450275,2124238,269593495,2596,1580955,2025295401,1579831,2025167915,1124,127486,1563074,6255,1949659,222442,2596,1860,86667.0,14444.0,-79.0,-70.0,-78.0,-79.0,-78.0,-69.0,-77.0,-78.0,-80.0,-86.0,-79.0,-83.0,1.0,16.0,1.0,4.0,1
2488,CC:2F:71:3E:C5:1F,5531149,4451853403,3406911,4182259908,2124238,269593495,502,93235,8002614,78630,6271584,14605,1731030,21549,533,3414312,870692,502,2930,7222.0,1000.0,-70.0,-63.0,-68.0,-62.0,-71.0,-71.0,-68.0,-62.0,-80.0,-86.0,-79.0,-83.0,10.0,23.0,11.0,21.0,1
2489,F8:59:71:5A:E0:3D,3475796,2294470522,1351555,2024876765,2124241,269593757,294,768440,940301562,767741,940217435,699,84127,757026,1840,1351685,169412,294,1160,144444.0,43333.0,-68.0,-73.0,-65.0,-70.0,-68.0,-73.0,-65.0,-70.0,-80.0,-86.0,-79.0,-83.0,12.0,13.0,14.0,13.0,1
2490,CC:2F:71:3F:1F:24,4074179,2846249808,1949936,2576655849,2124243,269593959,2596,1581098,2025491093,1579974,2025363607,1124,127486,1563217,6255,1949817,222447,2596,1861,130000.0,39000.0,-79.0,-70.0,-80.0,-77.0,-77.0,-69.0,-78.0,-76.0,-80.0,-86.0,-79.0,-83.0,1.0,16.0,-1.0,6.0,1
2491,CC:2F:71:3E:C5:1F,5531154,4451853867,3406911,4182259908,2124243,269593959,502,93235,8002614,78630,6271584,14605,1731030,21549,533,3414312,870692,502,2930,7222.0,1000.0,-70.0,-63.0,-68.0,-62.0,-71.0,-71.0,-68.0,-62.0,-80.0,-86.0,-79.0,-83.0,10.0,23.0,11.0,21.0,1
2492,F8:59:71:5A:E0:3D,3475957,2294675068,1351712,2025080907,2124245,269594161,294,768529,940404851,767830,940320724,699,84127,757114,1840,1351842,169413,294,1160,144444.0,43333.0,-69.0,-73.0,-64.0,-71.0,-68.0,-73.0,-64.0,-71.0,-81.0,-86.0,-80.0,-84.0,12.0,13.0,16.0,13.0,1
2493,CC:2F:71:3F:1F:24,4074337,2846452938,1950092,2576858777,2124245,269594161,2596,1581243,2025685673,1580119,2025558187,1124,127486,1563362,6255,1949973,222453,2596,1861,130000.0,43333.0,-78.0,-70.0,-79.0,-78.0,-76.0,-69.0,-78.0,-77.0,-81.0,-86.0,-80.0,-84.0,3.0,16.0,1.0,6.0,1
2494,CC:2F:71:3E:C5:1F,5531156,4451854069,3406911,4182259908,2124245,269594161,502,93235,8002614,78630,6271584,14605,1731030,21549,533,3414312,870692,502,2930,7222.0,1000.0,-70.0,-63.0,-68.0,-62.0,-71.0,-71.0,-68.0,-62.0,-81.0,-86.0,-80.0,-84.0,11.0,23.0,12.0,22.0,1
2495,F8:59:71:5A:E0:3D,3476024,2294772093,1351774,2025177255,2124250,269594838,294,768591,940500331,767892,940416204,699,84127,757176,1840,1351904,169414,294,1160,144444.0,43333.0,-68.0,-74.0,-64.0,-71.0,-68.0,-73.0,-64.0,-71.0,-81.0,-86.0,-80.0,-84.0,13.0,12.0,16.0,13.0,1
2496,CC:2F:71:3F:1F:24,4074498,2846656207,1950248,2577061369,2124250,269594838,2596,1581387,2025880025,1580263,2025752539,1124,127486,1563506,6255,1950129,222510,2596,1861,86667.0,13000.0,-74.0,-68.0,-75.0,-74.0,-74.0,-68.0,-75.0,-74.0,-81.0,-86.0,-80.0,-84.0,7.0,18.0,5.0,10.0,1
2497,CC:2F:71:3E:C5:1F,5531161,4451854746,3406911,4182259908,2124250,269594838,502,93235,8002614,78630,6271584,14605,1731030,21549,533,3414312,870692,502,2930,7222.0,1000.0,-70.0,-63.0,-68.0,-62.0,-71.0,-71.0,-68.0,-62.0,-81.0,-86.0,-80.0,-84.0,11.0,23.0,12.0,22.0,1
2498,F8:59:71:5A:E0:3D,3476091,2294868905,1351836,2025273603,2124255,269595302,294,768653,940595811,767954,940511684,699,84127,757238,1840,1351966,169414,294,1160,144444.0,43333.0,-68.0,-73.0,-64.0,-71.0,-68.0,-73.0,-64.0,-71.0,-81.0,-86.0,-80.0,-84.0,13.0,13.0,16.0,13.0,1
2499,CC:2F:71:3F:1F:24,4074661,2846859562,1950406,2577264260,2124255,269595302,2596,1581531,2026074416,1580407,2025946930,1124,127486,1563650,6255,1950287,222510,2596,1861,86667.0,14444.0,-73.0,-68.0,-75.0,-76.0,-73.0,-68.0,-75.0,-75.0,-81.0,-86.0,-80.0,-84.0,8.0,18.0,5.0,8.0,1
2500,CC:2F:71:3E:C5:1F,5531166,4451855210,3406911,4182259908,2124255,269595302,502,93235,8002614,78630,6271584,14605,1731030,21549,533,3414312,870692,502,2930,7222.0,1000.0,-70.0,-63.0,-68.0,-62.0,-71.0,-71.0,-68.0,-62.0,-81.0,-86.0,-80.0,-84.0,11.0,23.0,12.0,22.0,1
2501,F8:59:71:5A:E0:3D,3476364,2295287246,1352104,2025691478,2124260,269595768,294,768763,940703465,768064,940619338,699,84127,757348,1840,1352234,169443,294,1160,144444.0,43333.0,-68.0,-72.0,-64.0,-72.0,-67.0,-72.0,-64.0,-71.0,-82.0,-87.0,-81.0,-85.0,14.0,15.0,17.0,13.0,1
2502,CC:2F:71:3F:1F:24,4074827,2847068982,1950567,2577473214,2124260,269595768,2596,1581678,2026274824,1580554,2026147338,1124,127486,1563797,6255,1950448,222510,2596,1861,130000.0,39000.0,-74.0,-68.0,-76.0,-76.0,-72.0,-66.0,-75.0,-74.0,-82.0,-87.0,-81.0,-85.0,8.0,19.0,5.0,9.0,1
2503,CC:2F:71:3E:C5:1F,5531173,4451856044,3406911,4182259908,2124262,269596136,502,93237,8002802,78631,6271654,14606,1731148,21550,533,3414312,870692,502,2930,7222.0,1000.0,-74.0,-73.0,-70.0,-61.0,-72.0,-71.0,-69.0,-62.0,-82.0,-87.0,-81.0,-85.0,8.0,14.0,11.0,24.0,1
2504,F8:59:71:5A:E0:3D,3476430,2295384164,1352166,2025787826,2124264,269596338,294,768829,940804044,768130,940719917,699,84127,757414,1840,1352296,169443,294,1160,144444.0,43333.0,-68.0,-73.0,-64.0,-71.0,-68.0,-73.0,-64.0,-71.0,-82.0,-87.0,-81.0,-85.0,14.0,14.0,17.0,14.0,1
2505,CC:2F:71:3F:1F:24,4074996,2847275153,1950730,2577678613,2124266,269596540,2596,1581826,2026474052,1580702,2026346566,1124,127486,1563945,6255,1950610,222523,2596,1861,130000.0,43333.0,-71.0,-64.0,-73.0,-71.0,-71.0,-64.0,-73.0,-71.0,-82.0,-87.0,-81.0,-85.0,11.0,23.0,8.0,14.0,1
2506,CC:2F:71:3E:C5:1F,5531177,4451856448,3406911,4182259908,2124266,269596540,502,93237,8002802,78631,6271654,14606,1731148,21550,533,3414312,870692,502,2930,7222.0,1000.0,-74.0,-73.0,-70.0,-61.0,-72.0,-71.0,-69.0,-62.0,-82.0,-87.0,-81.0,-85.0,8.0,14.0,11.0,24.0,1
2507,F8:59:71:5A:E0:3D,3476723,2295794943,1352454,2026198141,2124269,269596802,294,768927,940903728,768228,940819601,699,84127,757512,1840,1352584,169443,294,1161,144444.0,43333.0,-68.0,-73.0,-64.0,-72.0,-68.0,-73.0,-64.0,-71.0,-82.0,-87.0,-81.0,-85.0,14.0,14.0,17.0,13.0,1
2508,CC:2F:71:3F:1F:24,4075156,2847480177,1950887,2577883375,2124269,269596802,2596,1581970,2026669870,1580846,2026542384,1124,127486,1564089,6255,1950768,222523,2596,1861,130000.0,43333.0,-71.0,-63.0,-73.0,-71.0,-71.0,-63.0,-73.0,-71.0,-82.0,-87.0,-81.0,-85.0,11.0,24.0,8.0,14.0,1
2509,CC:2F:71:3E:C5:1F,5531180,4451856710,3406911,4182259908,2124269,269596802,502,93237,8002802,78631,6271654,14606,1731148,21550,533,3414312,870692,502,2930,7222.0,1000.0,-74.0,-73.0,-70.0,-61.0,-72.0,-71.0,-69.0,-62.0,-82.0,-87.0,-81.0,-85.0,8.0,14.0,11.0,24.0,1
2510,F8:59:71:5A:E0:3D,3476789,2295891583,1352516,2026294377,2124273,269597206,294,768990,941000762,768291,940916635,699,84127,757574,1840,1352646,169444,294,1161,144444.0,39000.0,-68.0,-73.0,-65.0,-72.0,-68.0,-73.0,-64.0,-72.0,-82.0,-86.0,-81.0,-85.0,14.0,13.0,16.0,13.0,1
2511,CC:2F:71:3F:1F:24,4075767,2848310928,1951494,2578713722,2124273,269597206,2596,1582187,2026882398,1581063,2026754912,1124,127486,1564306,6255,1951375,222533,2596,1862,144444.0,43333.0,-71.0,-64.0,-74.0,-72.0,-71.0,-63.0,-73.0,-71.0,-82.0,-86.0,-81.0,-85.0,11.0,22.0,7.0,13.0,1
2512,CC:2F:71:3E:C5:1F,5531184,4451857114,3406911,4182259908,2124273,269597206,502,93237,8002802,78631,6271654,14606,1731148,21550,533,3414312,870692,502,2930,7222.0,1000.0,-74.0,-73.0,-70.0,-61.0,-72.0,-71.0,-69.0,-62.0,-82.0,-86.0,-81.0,-85.0,8.0,13.0,11.0,24.0,1
2513,F8:59:71:5A:E0:3D,3476970,2296166723,1352693,2026569113,2124277,269597610,294,769058,941104582,768359,941020455,699,84127,757642,1840,1352821,169444,294,1162,144444.0,43333.0,-67.0,-72.0,-64.0,-71.0,-67.0,-72.0,-64.0,-71.0,-82.0,-86.0,-81.0,-85.0,15.0,14.0,17.0,14.0,1
2514,CC:2F:71:3F:1F:24,4075945,2848542456,1951668,2578944846,2124277,269597610,2596,1582351,2027107704,1581227,2026980218,1124,127486,1564470,6255,1951549,222547,2596,1862,130000.0,43333.0,-71.0,-64.0,-73.0,-72.0,-71.0,-64.0,-74.0,-72.0,-82.0,-86.0,-81.0,-85.0,11.0,22.0,8.0,13.0,1
2515,CC:2F:71:3E:C5:1F,5531189,4451857578,3406911,4182259908,2124278,269597670,502,93237,8002802,78631,6271654,14606,1731148,21550,533,3414312,870692,502,2930,7222.0,1000.0,-74.0,-73.0,-70.0,-61.0,-72.0,-71.0,-69.0,-62.0,-82.0,-86.0,-81.0,-85.0,8.0,13.0,11.0,24.0,1
2516,F8:59:71:5A:E0:3D,3477282,2296641545,1353000,2027043471,2124282,269598074,294,769213,941228716,768514,941144589,699,84127,757797,1840,1353130,169444,294,1162,144444.0,43333.0,-68.0,-72.0,-65.0,-72.0,-68.0,-72.0,-65.0,-72.0,-82.0,-86.0,-81.0,-85.0,14.0,14.0,16.0,13.0,1
2517,CC:2F:71:3F:1F:24,4076108,2848749012,1951826,2579150938,2124282,269598074,2596,1582493,2027303248,1581369,2027175762,1124,127486,1564612,6255,1951707,222562,2596,1862,130000.0,43333.0,-72.0,-64.0,-73.0,-71.0,-72.0,-64.0,-73.0,-71.0,-82.0,-86.0,-81.0,-85.0,10.0,22.0,8.0,14.0,1
2518,CC:2F:71:3E:C5:1F,5531193,4451857982,3406911,4182259908,2124282,269598074,502,93237,8002802,78631,6271654,14606,1731148,21550,533,3414312,870692,502,2930,7222.0,1000.0,-74.0,-73.0,-70.0,-61.0,-72.0,-71.0,-69.0,-62.0,-82.0,-86.0,-81.0,-85.0,8.0,13.0,11.0,24.0,1
2519,F8:59:71:5A:E0:3D,3477350,2296741405,1353064,2027142927,2124286,269598478,294,769277,941327276,768578,941243149,699,84127,757861,1840,1353194,169444,294,1162,144444.0,43333.0,-69.0,-73.0,-64.0,-72.0,-68.0,-72.0,-64.0,-71.0,-83.0,-87.0,-82.0,-86.0,14.0,14.0,18.0,14.0,1
2520,CC:2F:71:3F:1F:24,4076272,2848958840,1951986,2579360362,2124286,269598478,2596,1582639,2027505134,1581515,2027377648,1124,127486,1564757,6255,1951866,222562,2596,1862,130000.0,43333.0,-72.0,-64.0,-73.0,-73.0,-71.0,-64.0,-72.0,-73.0,-83.0,-87.0,-82.0,-86.0,11.0,23.0,9.0,13.0,1
2521,CC:2F:71:3E:C5:1F,5531197,4451858386,3406911,4182259908,2124286,269598478,502,93237,8002802,78631,6271654,14606,1731148,21550,533,3414312,870692,502,2930,7222.0,1000.0,-74.0,-73.0,-70.0,-61.0,-72.0,-71.0,-69.0,-62.0,-83.0,-87.0,-82.0,-86.0,9.0,14.0,12.0,25.0,1
2522,F8:59:71:5A:E0:3D,3477417,2296838217,1353126,2027239275,2124291,269598942,294,769339,941422756,768640,941338629,699,84127,757923,1840,1353256,169444,294,1162,144444.0,43333.0,-69.0,-74.0,-65.0,-72.0,-68.0,-73.0,-65.0,-72.0,-83.0,-87.0,-82.0,-86.0,14.0,13.0,17.0,14.0,1
2523,CC:2F:71:3F:1F:24,4076561,2849313985,1952270,2579715043,2124291,269598942,2596,1582826,2027713586,1581702,2027586100,1124,127486,1564943,6255,1952151,222617,2596,1862,86667.0,14444.0,-71.0,-64.0,-73.0,-72.0,-71.0,-64.0,-73.0,-72.0,-83.0,-87.0,-82.0,-86.0,12.0,23.0,9.0,14.0,1
2524,CC:2F:71:3E:C5:1F,5531202,4451858850,3406911,4182259908,2124291,269598942,502,93237,8002802,78631,6271654,14606,1731148,21550,533,3414312,870692,502,2930,7222.0,1000.0,-74.0,-73.0,-70.0,-61.0,-72.0,-71.0,-69.0,-62.0,-83.0,-87.0,-82.0,-86.0,9.0,14.0,12.0,25.0,1
2525,F8:59:71:5A:E0:3D,3477488,2296938535,1353193,2027339189,2124295,269599346,294,769406,941522132,768707,941438005,699,84127,757990,1840,1353323,169444,294,1162,144444.0,43333.0,-69.0,-73.0,-65.0,-72.0,-68.0,-73.0,-65.0,-72.0,-83.0,-87.0,-82.0,-86.0,14.0,14.0,17.0,14.0,1
2526,CC:2F:71:3F:1F:24,4076720,2849516907,1952425,2579917561,2124295,269599346,2596,1582968,2027907706,1581844,2027780220,1124,127486,1565085,6255,1952306,222617,2596,1862,86667.0,14444.0,-70.0,-63.0,-72.0,-70.0,-70.0,-63.0,-71.0,-70.0,-83.0,-87.0,-82.0,-86.0,13.0,24.0,10.0,16.0,1
2527,CC:2F:71:3E:C5:1F,5531206,4451859254,3406911,4182259908,2124295,269599346,502,93237,8002802,78631,6271654,14606,1731148,21550,533,3414312,870692,502,2930,7222.0,1000.0,-74.0,-73.0,-70.0,-61.0,-72.0,-71.0,-69.0,-62.0,-83.0,-87.0,-82.0,-86.0,9.0,14.0,12.0,25.0,1
2528,F8:59:71:5A:E0:3D,3477552,2297035085,1353255,2027435537,2124297,269599548,294,769468,941617640,768769,941533513,699,84127,758052,1840,1353385,169444,294,1163,144444.0,43333.0,-69.0,-73.0,-65.0,-72.0,-69.0,-73.0,-65.0,-72.0,-83.0,-87.0,-82.0,-86.0,14.0,14.0,17.0,14.0,1
2529,CC:2F:71:3F:1F:24,4076878,2849719640,1952581,2580120092,2124297,269599548,2596,1583111,2028101942,1581987,2027974456,1124,127486,1565228,6255,1952462,222629,2596,1862,86667.0,14444.0,-70.0,-63.0,-71.0,-70.0,-70.0,-63.0,-71.0,-69.0,-83.0,-87.0,-82.0,-86.0,13.0,24.0,11.0,16.0,1
2530,CC:2F:71:3E:C5:1F,5531210,4451859658,3406911,4182259908,2124299,269599750,502,93237,8002802,78631,6271654,14606,1731148,21550,533,3414312,870692,502,2930,7222.0,1000.0,-74.0,-73.0,-70.0,-61.0,-72.0,-71.0,-69.0,-62.0,-83.0,-87.0,-82.0,-86.0,9.0,14.0,12.0,25.0,1
2531,F8:59:71:5A:E0:3D,3477834,2297430009,1353532,2027829997,2124302,269600012,294,769585,941729437,768886,941645310,699,84127,758169,1840,1353662,169444,294,1163,144444.0,43333.0,-68.0,-74.0,-65.0,-72.0,-68.0,-74.0,-65.0,-72.0,-84.0,-88.0,-83.0,-87.0,16.0,14.0,18.0,15.0,1
2532,CC:2F:71:3F:1F:24,4077040,2849923045,1952738,2580323033,2124302,269600012,2596,1583254,2028296178,1582130,2028168692,1124,127486,1565371,6255,1952619,222630,2596,1862,86667.0,14444.0,-70.0,-63.0,-72.0,-70.0,-69.0,-63.0,-72.0,-70.0,-84.0,-88.0,-83.0,-87.0,14.0,25.0,11.0,17.0,1
2533,CC:2F:71:3E:C5:1F,5531213,4451859920,3406911,4182259908,2124302,269600012,502,93237,8002802,78631,6271654,14606,1731148,21550,533,3414312,870692,502,2930,7222.0,1000.0,-74.0,-73.0,-70.0,-61.0,-72.0,-71.0,-69.0,-62.0,-84.0,-88.0,-83.0,-87.0,10.0,15.0,13.0,26.0,1
2534,F8:59:71:5A:E0:3D,3477898,2297526559,1353594,2027926345,2124304,269600214,294,769649,941828011,768950,941743884,699,84127,758232,1840,1353724,169444,294,1163,144444.0,43333.0,-68.0,-74.0,-65.0,-72.0,-68.0,-74.0,-65.0,-72.0,-84.0,-88.0,-83.0,-87.0,16.0,14.0,18.0,15.0,1
2535,CC:2F:71:3F:1F:24,4077199,2850128873,1952895,2580528659,2124304,269600214,2596,1583397,2028493262,1582273,2028365776,1124,127486,1565514,6255,1952776,222630,2596,1862,86667.0,14444.0,-70.0,-63.0,-72.0,-70.0,-69.0,-63.0,-71.0,-70.0,-84.0,-88.0,-83.0,-87.0,14.0,25.0,11.0,17.0,1
2536,CC:2F:71:3E:C5:1F,5531217,4451860324,3406911,4182259908,2124306,269600416,502,93237,8002802,78631,6271654,14606,1731148,21550,533,3414312,870692,502,2930,7222.0,1000.0,-74.0,-73.0,-70.0,-61.0,-72.0,-71.0,-69.0,-62.0,-84.0,-88.0,-83.0,-87.0,10.0,15.0,13.0,26.0,1
2537,F8:59:71:5A:E0:3D,3478167,2297940678,1353859,2028340060,2124308,269600618,294,769757,941937789,769058,941853662,699,84127,758335,1840,1353989,169460,294,1163,144444.0,43333.0,-69.0,-74.0,-65.0,-72.0,-68.0,-74.0,-65.0,-72.0,-84.0,-88.0,-83.0,-87.0,15.0,14.0,18.0,15.0,1
2538,CC:2F:71:3F:1F:24,4077610,2850656425,1953302,2581055807,2124308,269600618,2596,1583592,2028703866,1582468,2028576380,1124,127486,1565709,6255,1953182,222637,2596,1862,130000.0,43333.0,-70.0,-63.0,-73.0,-70.0,-69.0,-63.0,-72.0,-70.0,-84.0,-88.0,-83.0,-87.0,14.0,25.0,10.0,17.0,1
2539,CC:2F:71:3E:C5:1F,5531222,4451861001,3406911,4182259908,2124311,269601093,502,93237,8002802,78631,6271654,14606,1731148,21550,533,3414312,870692,502,2930,7222.0,1000.0,-74.0,-73.0,-70.0,-61.0,-72.0,-71.0,-69.0,-62.0,-84.0,-88.0,-83.0,-87.0,10.0,15.0,13.0,26.0,1
2540,F8:59:71:5A:E0:3D,3478236,2298037879,1353922,2028436524,2124314,269601355,294,769822,942033515,769123,941949388,699,84127,758398,1840,1354052,169460,294,1163,144444.0,43333.0,-69.0,-74.0,-65.0,-72.0,-68.0,-74.0,-65.0,-72.0,-83.0,-87.0,-83.0,-86.0,14.0,13.0,18.0,14.0,1
2541,CC:2F:71:3F:1F:24,4077772,2850858932,1953458,2581257577,2124314,269601355,2596,1583737,2028899762,1582613,2028772276,1124,127486,1565853,6255,1953339,222637,2596,1862,130000.0,43333.0,-70.0,-63.0,-73.0,-71.0,-70.0,-63.0,-73.0,-70.0,-83.0,-87.0,-83.0,-86.0,13.0,24.0,10.0,15.0,1
2542,CC:2F:71:3E:C5:1F,5531225,4451861263,3406911,4182259908,2124314,269601355,502,93237,8002802,78631,6271654,14606,1731148,21550,533,3414312,870692,502,2930,7222.0,1000.0,-74.0,-73.0,-70.0,-61.0,-72.0,-71.0,-69.0,-62.0,-83.0,-87.0,-83.0,-86.0,9.0,14.0,13.0,25.0,1
2543,F8:59:71:5A:E0:3D,3478303,2298134709,1353984,2028532872,2124319,269601837,294,769885,942130535,769186,942046408,699,84127,758461,1840,1354114,169460,294,1163,144444.0,43333.0,-69.0,-73.0,-64.0,-71.0,-68.0,-73.0,-64.0,-71.0,-83.0,-87.0,-83.0,-86.0,14.0,14.0,19.0,15.0,1
2544,CC:2F:71:3F:1F:24,4077935,2851065058,1953616,2581463221,2124319,269601837,2596,1583881,2029096962,1582757,2028969476,1124,127486,1565997,6255,1953497,222691,2596,1862,115556.0,28889.0,-71.0,-64.0,-72.0,-74.0,-71.0,-64.0,-72.0,-74.0,-83.0,-87.0,-83.0,-86.0,12.0,23.0,11.0,12.0,1
2545,CC:2F:71:3E:C5:1F,5531231,4451861861,3406912,4182260024,2124319,269601837,502,93238,8002872,78632,6271724,14606,1731148,21550,533,3414313,870692,502,2930,7222.0,1000.0,-73.0,-73.0,-70.0,-61.0,-72.0,-71.0,-69.0,-62.0,-84.0,-88.0,-84.0,-87.0,11.0,15.0,14.0,26.0,1
2546,F8:59:71:5A:E0:3D,3478373,2298234747,1354049,2028632444,2124324,269602303,294,769950,942227695,769251,942143568,699,84127,758524,1840,1354179,169460,294,1163,144444.0,43333.0,-67.0,-74.0,-64.0,-72.0,-67.0,-74.0,-64.0,-72.0,-84.0,-88.0,-84.0,-87.0,17.0,14.0,20.0,15.0,1
2547,CC:2F:71:3F:1F:24,4078290,2851517897,1953966,2581915594,2124324,269602303,2596,1584072,2029307446,1582947,2029179842,1125,127604,1566188,6255,1953847,222722,2596,1862,86667.0,14444.0,-70.0,-64.0,-74.0,-74.0,-71.0,-65.0,-74.0,-75.0,-84.0,-88.0,-84.0,-87.0,14.0,24.0,10.0,13.0,1
2548,CC:2F:71:3E:C5:1F,5531236,4451862327,3406912,4182260024,2124324,269602303,502,93239,8002942,78633,6271794,14606,1731148,21550,533,3414313,870692,502,2930,7222.0,1000.0,-72.0,-73.0,-70.0,-61.0,-71.0,-70.0,-68.0,-61.0,-84.0,-88.0,-84.0,-87.0,12.0,15.0,14.0,26.0,1
2549,F8:59:71:5A:E0:3D,3478440,2298331559,1354111,2028728792,2124329,269602767,294,770014,942326269,769315,942242142,699,84127,758587,1840,1354241,169461,294,1163,144444.0,43333.0,-68.0,-74.0,-64.0,-71.0,-67.0,-74.0,-64.0,-71.0,-84.0,-88.0,-84.0,-87.0,16.0,14.0,20.0,16.0,1
2550,CC:2F:71:3F:1F:24,4078459,2851723610,1954130,2582120843,2124329,269602767,2596,1584222,2029508347,1583097,2029380743,1125,127604,1566337,6255,1954011,222723,2596,1862,86667.0,14444.0,-71.0,-65.0,-73.0,-72.0,-71.0,-65.0,-72.0,-72.0,-84.0,-88.0,-84.0,-87.0,13.0,23.0,11.0,15.0,1
2551,CC:2F:71:3E:C5:1F,5531241,4451862791,3406912,4182260024,2124329,269602767,502,93239,8002942,78633,6271794,14606,1731148,21550,533,3414313,870692,502,2930,7222.0,1000.0,-72.0,-73.0,-70.0,-61.0,-71.0,-70.0,-68.0,-61.0,-84.0,-88.0,-84.0,-87.0,12.0,15.0,14.0,26.0,1
2552,F8:59:71:5A:E0:3D,3478697,2298688341,1354364,2029085170,2124333,269603171,294,770116,942434138,769417,942350011,699,84127,758686,1840,1354494,169461,294,1163,144444.0,43333.0,-68.0,-74.0,-64.0,-71.0,-67.0,-74.0,-64.0,-71.0,-84.0,-88.0,-84.0,-87.0,16.0,14.0,20.0,16.0,1
2553,CC:2F:71:3F:1F:24,4078620,2851928104,1954287,2582324933,2124333,269603171,2596,1584367,2029705719,1583242,2029578115,1125,127604,1566481,6255,1954168,222733,2596,1863,65000.0,13000.0,-71.0,-65.0,-73.0,-73.0,-71.0,-64.0,-72.0,-72.0,-84.0,-88.0,-84.0,-87.0,13.0,23.0,11.0,14.0,1
2554,CC:2F:71:3E:C5:1F,5531245,4451863195,3406912,4182260024,2124333,269603171,502,93239,8002942,78633,6271794,14606,1731148,21550,533,3414313,870692,502,2930,7222.0,1000.0,-72.0,-73.0,-70.0,-61.0,-71.0,-70.0,-68.0,-61.0,-84.0,-88.0,-84.0,-87.0,12.0,15.0,14.0,26.0,1
2555,F8:59:71:5A:E0:3D,3478768,2298785878,1354432,2029182437,2124336,269603441,294,770183,942532839,769484,942448712,699,84127,758752,1840,1354562,169461,294,1163,144444.0,43333.0,-68.0,-74.0,-64.0,-71.0,-67.0,-74.0,-64.0,-71.0,-84.0,-88.0,-84.0,-87.0,16.0,14.0,20.0,16.0,1
2556,CC:2F:71:3F:1F:24,4078780,2852131044,1954443,2582527469,2124337,269603575,2596,1584507,2029899607,1583382,2029772003,1125,127604,1566621,6255,1954324,222734,2596,1863,86667.0,14444.0,-71.0,-65.0,-72.0,-73.0,-71.0,-65.0,-72.0,-73.0,-84.0,-88.0,-84.0,-87.0,13.0,23.0,12.0,14.0,1
2557,CC:2F:71:3E:C5:1F,5531249,4451863599,3406912,4182260024,2124337,269603575,502,93239,8002942,78633,6271794,14606,1731148,21550,533,3414313,870692,502,2930,7222.0,1000.0,-72.0,-73.0,-70.0,-61.0,-71.0,-70.0,-68.0,-61.0,-84.0,-88.0,-84.0,-87.0,12.0,15.0,14.0,26.0,1
2558,F8:59:71:5A:E0:3D,3478838,2298885932,1354496,2029281893,2124342,269604039,294,770249,942634493,769550,942550366,699,84127,758817,1840,1354626,169462,294,1163,144444.0,43333.0,-67.0,-74.0,-64.0,-71.0,-67.0,-74.0,-64.0,-71.0,-84.0,-88.0,-84.0,-87.0,17.0,14.0,20.0,16.0,1
2559,CC:2F:71:3F:1F:24,4078947,2852343492,1954605,2582739453,2124342,269604039,2596,1584656,2030103333,1583531,2029975729,1125,127604,1566769,6255,1954486,222734,2596,1863,86667.0,14444.0,-71.0,-65.0,-72.0,-73.0,-71.0,-65.0,-72.0,-72.0,-84.0,-88.0,-84.0,-87.0,13.0,23.0,12.0,14.0,1
2560,CC:2F:71:3E:C5:1F,5531254,4451864063,3406912,4182260024,2124342,269604039,502,93239,8002942,78633,6271794,14606,1731148,21550,533,3414313,870692,502,2930,7222.0,1000.0,-72.0,-73.0,-70.0,-61.0,-71.0,-70.0,-68.0,-61.0,-84.0,-88.0,-84.0,-87.0,12.0,15.0,14.0,26.0,1
2561,F8:59:71:5A:E0:3D,3479061,2299217000,1354719,2029612961,2124342,269604039,294,770352,942742960,769653,942658833,699,84127,758919,1840,1354849,169462,294,1163,144444.0,43333.0,-67.0,-74.0,-64.0,-71.0,-67.0,-74.0,-64.0,-71.0,-85.0,-88.0,-85.0,-88.0,18.0,14.0,21.0,17.0,1
2562,CC:2F:71:3F:1F:24,4079117,2852562124,1954771,2582957681,2124346,269604443,2596,1584812,2030313563,1583687,2030185959,1125,127604,1566925,6255,1954652,222748,2596,1863,117000.0,39000.0,-71.0,-64.0,-73.0,-72.0,-71.0,-64.0,-72.0,-72.0,-85.0,-88.0,-85.0,-88.0,14.0,24.0,12.0,16.0,1
2563,CC:2F:71:3E:C5:1F,5531258,4451864467,3406912,4182260024,2124346,269604443,502,93239,8002942,78633,6271794,14606,1731148,21550,533,3414313,870692,502,2930,7222.0,1000.0,-72.0,-73.0,-70.0,-61.0,-71.0,-70.0,-68.0,-61.0,-85.0,-88.0,-85.0,-88.0,13.0,15.0,15.0,27.0,1
2564,F8:59:71:5A:E0:3D,3479158,2299336451,1354808,2029731604,2124350,269604847,294,770442,942861911,769743,942777784,699,84127,759008,1840,1354938,169462,294,1163,144444.0,43333.0,-68.0,-74.0,-64.0,-71.0,-67.0,-74.0,-64.0,-71.0,-85.0,-88.0,-85.0,-88.0,17.0,14.0,21.0,17.0,1
2565,CC:2F:71:3F:1F:24,4079337,2852828633,1954987,2583223786,2124350,269604847,2596,1585032,2030571942,1583907,2030444338,1125,127604,1567133,6255,1954868,222827,2596,1863,115556.0,28889.0,-71.0,-64.0,-72.0,-73.0,-70.0,-63.0,-70.0,-71.0,-85.0,-88.0,-85.0,-88.0,14.0,24.0,13.0,15.0,1
2566,CC:2F:71:3E:C5:1F,5531263,4451864931,3406912,4182260024,2124351,269604907,502,93239,8002942,78633,6271794,14606,1731148,21550,533,3414313,870692,502,2930,7222.0,1000.0,-72.0,-73.0,-70.0,-61.0,-71.0,-70.0,-68.0,-61.0,-85.0,-88.0,-85.0,-88.0,13.0,15.0,15.0,27.0,1
2567,F8:59:71:5A:E0:3D,3479355,2299614560,1355000,2030009249,2124355,269605311,294,770554,942995702,769855,942911575,699,84127,759119,1840,1355130,169462,294,1163,144444.0,43333.0,-68.0,-74.0,-64.0,-71.0,-67.0,-74.0,-64.0,-71.0,-85.0,-88.0,-85.0,-88.0,17.0,14.0,21.0,17.0,1
2568,CC:2F:71:3F:1F:24,4079508,2853047845,1955153,2583442534,2124355,269605311,2596,1585187,2030781764,1584062,2030654160,1125,127604,1567287,6255,1955034,222848,2596,1863,115556.0,28889.0,-72.0,-65.0,-73.0,-73.0,-73.0,-67.0,-75.0,-75.0,-85.0,-88.0,-85.0,-88.0,13.0,23.0,12.0,15.0,1
2569,CC:2F:71:3E:C5:1F,5531267,4451865335,3406912,4182260024,2124355,269605311,502,93239,8002942,78633,6271794,14606,1731148,21550,533,3414313,870692,502,2930,7222.0,1000.0,-72.0,-73.0,-70.0,-61.0,-71.0,-70.0,-68.0,-61.0,-85.0,-88.0,-85.0,-88.0,13.0,15.0,15.0,27.0,1
2570,F8:59:71:5A:E0:3D,3479579,2299920950,1355219,2030315173,2124360,269605777,294,770650,943098367,769950,943014122,700,84245,759215,1840,1355349,169462,294,1163,144444.0,43333.0,-68.0,-74.0,-64.0,-72.0,-68.0,-74.0,-64.0,-71.0,-85.0,-88.0,-85.0,-88.0,17.0,14.0,21.0,16.0,1
2571,CC:2F:71:3F:1F:24,4079669,2853251295,1955309,2583645518,2124360,269605777,2596,1585328,2030974344,1584203,2030846740,1125,127604,1567428,6255,1955190,222858,2596,1863,115556.0,28889.0,-71.0,-65.0,-72.0,-73.0,-76.0,-70.0,-77.0,-78.0,-85.0,-88.0,-85.0,-88.0,14.0,23.0,13.0,15.0,1
2572,CC:2F:71:3E:C5:1F,5531272,4451865801,3406912,4182260024,2124360,269605777,502,93239,8002942,78633,6271794,14606,1731148,21550,533,3414313,870692,502,2930,7222.0,1000.0,-72.0,-73.0,-70.0,-61.0,-71.0,-70.0,-68.0,-61.0,-85.0,-88.0,-85.0,-88.0,13.0,15.0,15.0,27.0,1
2573,F8:59:71:5A:E0:3D,3479643,2300017420,1355281,2030411521,2124362,269605899,294,770712,943193847,770012,943109602,700,84245,759277,1840,1355411,169463,294,1163,144444.0,43333.0,-68.0,-74.0,-64.0,-71.0,-68.0,-74.0,-64.0,-71.0,-85.0,-88.0,-85.0,-88.0,17.0,14.0,21.0,17.0,1
2574,CC:2F:71:3F:1F:24,4080297,2854105010,1955933,2584498909,2124364,269606101,2596,1585550,2031190032,1584425,2031062428,1125,127604,1567647,6255,1955814,223146,2596,1863,115556.0,28889.0,-77.0,-71.0,-78.0,-79.0,-76.0,-69.0,-76.0,-77.0,-85.0,-88.0,-85.0,-88.0,8.0,17.0,7.0,9.0,1
2575,CC:2F:71:3E:C5:1F,5531278,4451866327,3406912,4182260024,2124366,269606303,502,93241,8003130,78634,6271864,14607,1731266,21551,533,3414313,870692,502,2930,7222.0,1000.0,-72.0,-68.0,-69.0,-61.0,-72.0,-69.0,-69.0,-61.0,-85.0,-88.0,-85.0,-88.0,13.0,20.0,16.0,27.0,1
2576,F8:59:71:5A:E0:3D,3479861,2300341371,1355493,2030734866,2124368,269606505,294,770805,943302245,770105,943218000,700,84245,759370,1840,1355623,169463,294,1163,144444.0,43333.0,-67.0,-74.0,-64.0,-71.0,-67.0,-74.0,-64.0,-71.0,-85.0,-88.0,-85.0,-88.0,18.0,14.0,21.0,17.0,1
2577,CC:2F:71:3F:1F:24,4080460,2854313284,1956092,2584706779,2124368,269606505,2596,1585692,2031385576,1584567,2031257972,1125,127604,1567789,6255,1955972,223162,2596,1863,115556.0,28889.0,-77.0,-71.0,-78.0,-79.0,-76.0,-70.0,-77.0,-78.0,-85.0,-88.0,-85.0,-88.0,8.0,17.0,7.0,9.0,1
2578,CC:2F:71:3E:C5:1F,5531282,4451866731,3406912,4182260024,2124370,269606707,502,93241,8003130,78634,6271864,14607,1731266,21551,533,3414313,870692,502,2930,7222.0,1000.0,-72.0,-68.0,-69.0,-61.0,-72.0,-69.0,-69.0,-61.0,-85.0,-88.0,-85.0,-88.0,13.0,20.0,16.0,27.0,1
2579,F8:59:71:5A:E0:3D,3479934,2300440562,1355564,2030833855,2124370,269606707,294,770874,943399826,770174,943315581,700,84245,759439,1840,1355694,169463,294,1163,144444.0,43333.0,-68.0,-74.0,-64.0,-71.0,-67.0,-74.0,-64.0,-71.0,-86.0,-89.0,-86.0,-89.0,18.0,15.0,22.0,18.0,1
2580,CC:2F:71:3F:1F:24,4080630,2854534061,1956259,2584927081,2124371,269606980,2596,1585844,2031598140,1584719,2031470536,1125,127604,1567941,6255,1956140,223181,2596,1863,115556.0,28889.0,-70.0,-64.0,-71.0,-72.0,-72.0,-66.0,-73.0,-74.0,-86.0,-89.0,-86.0,-89.0,16.0,25.0,15.0,17.0,1
2581,CC:2F:71:3E:C5:1F,5531285,4451867206,3406912,4182260024,2124373,269607182,502,93241,8003130,78634,6271864,14607,1731266,21551,533,3414313,870692,502,2930,7222.0,1000.0,-72.0,-68.0,-69.0,-61.0,-72.0,-69.0,-69.0,-61.0,-86.0,-89.0,-86.0,-89.0,14.0,21.0,17.0,28.0,1
2582,F8:59:71:5A:E0:3D,3480008,2300546971,1355632,2030939527,2124376,269607444,294,770943,943506100,770243,943421855,700,84245,759507,1840,1355762,169464,294,1163,144444.0,43333.0,-68.0,-74.0,-64.0,-71.0,-67.0,-74.0,-64.0,-71.0,-86.0,-89.0,-86.0,-89.0,18.0,15.0,22.0,18.0,1
2583,CC:2F:71:3F:1F:24,4080800,2854741679,1956422,2585134033,2124378,269607646,2596,1585993,2031796141,1584868,2031668537,1125,127604,1568090,6255,1956303,223215,2596,1863,115556.0,28889.0,-70.0,-64.0,-72.0,-72.0,-70.0,-64.0,-71.0,-72.0,-86.0,-89.0,-86.0,-89.0,16.0,25.0,14.0,17.0,1
2584,CC:2F:71:3E:C5:1F,5531290,4451867670,3406912,4182260024,2124378,269607646,502,93241,8003130,78634,6271864,14607,1731266,21551,533,3414313,870692,502,2930,7222.0,1000.0,-72.0,-68.0,-69.0,-61.0,-72.0,-69.0,-69.0,-61.0,-86.0,-89.0,-86.0,-89.0,14.0,21.0,17.0,28.0,1
2585,F8:59:71:5A:E0:3D,3480074,2300643723,1355694,2031035875,2124380,269607848,294,771006,943603134,770306,943518889,700,84245,759569,1840,1355824,169464,294,1163,144444.0,43333.0,-68.0,-74.0,-64.0,-71.0,-67.0,-74.0,-64.0,-71.0,-86.0,-89.0,-86.0,-89.0,18.0,15.0,22.0,18.0,1
2586,CC:2F:71:3F:1F:24,4081168,2855217207,1956788,2585609359,2124380,269607848,2596,1586185,2032003850,1585060,2031876246,1125,127604,1568282,6255,1956669,223233,2596,1863,115556.0,28889.0,-71.0,-65.0,-72.0,-72.0,-71.0,-64.0,-72.0,-72.0,-87.0,-90.0,-87.0,-90.0,16.0,25.0,15.0,18.0,1
2587,CC:2F:71:3E:C5:1F,5531292,4451867872,3406912,4182260024,2124380,269607848,502,93241,8003130,78634,6271864,14607,1731266,21551,533,3414313,870692,502,2930,7222.0,1000.0,-72.0,-68.0,-69.0,-61.0,-72.0,-69.0,-69.0,-61.0,-87.0,-90.0,-87.0,-90.0,15.0,22.0,18.0,29.0,1
2588,F8:59:71:5A:E0:3D,3480145,2300739840,1355761,2031131588,2124384,269608252,294,771072,943700454,770372,943616209,700,84245,759635,1840,1355891,169464,294,1163,144444.0,43333.0,-67.0,-74.0,-64.0,-71.0,-67.0,-74.0,-64.0,-71.0,-87.0,-90.0,-87.0,-90.0,20.0,16.0,23.0,19.0,1
2589,CC:2F:71:3F:1F:24,4081327,2855419265,1956943,2585811013,2124384,269608252,2596,1586326,2032196430,1585201,2032068826,1125,127604,1568423,6255,1956824,223236,2596,1863,115556.0,28889.0,-72.0,-65.0,-73.0,-73.0,-71.0,-64.0,-72.0,-72.0,-87.0,-90.0,-87.0,-90.0,15.0,25.0,14.0,17.0,1
2590,CC:2F:71:3E:C5:1F,5531296,4451868276,3406912,4182260024,2124384,269608252,502,93241,8003130,78634,6271864,14607,1731266,21551,533,3414313,870692,502,2930,7222.0,1000.0,-72.0,-68.0,-69.0,-61.0,-72.0,-69.0,-69.0,-61.0,-87.0,-90.0,-87.0,-90.0,15.0,22.0,18.0,29.0,1
2591,F8:59:71:5A:E0:3D,3480212,2300836652,1355823,2031227936,2124389,269608716,294,771134,943795934,770434,943711689,700,84245,759697,1840,1355953,169464,294,1163,144444.0,43333.0,-68.0,-73.0,-64.0,-71.0,-68.0,-73.0,-64.0,-71.0,-88.0,-90.0,-88.0,-91.0,20.0,17.0,24.0,20.0,1
2592,CC:2F:71:3F:1F:24,4081488,2855623745,1957099,2586015029,2124389,269608716,2596,1586468,2032391974,1585343,2032264370,1125,127604,1568565,6255,1956980,223263,2596,1863,86667.0,14444.0,-74.0,-68.0,-75.0,-76.0,-74.0,-67.0,-74.0,-75.0,-88.0,-90.0,-88.0,-91.0,14.0,22.0,13.0,15.0,1
2593,CC:2F:71:3E:C5:1F,5531301,4451868740,3406912,4182260024,2124389,269608716,502,93241,8003130,78634,6271864,14607,1731266,21551,533,3414313,870692,502,2930,7222.0,1000.0,-72.0,-68.0,-69.0,-61.0,-72.0,-69.0,-69.0,-61.0,-88.0,-90.0,-88.0,-91.0,16.0,22.0,19.0,30.0,1
2594,F8:59:71:5A:E0:3D,3480278,2300933404,1355885,2031324284,2124393,269609120,294,771198,943894522,770498,943810277,700,84245,759759,1840,1356015,169464,294,1163,144444.0,43333.0,-68.0,-73.0,-64.0,-71.0,-68.0,-73.0,-64.0,-71.0,-88.0,-90.0,-88.0,-91.0,20.0,17.0,24.0,20.0,1
2595,CC:2F:71:3F:1F:24,4081650,2855827096,1957257,2586217976,2124393,269609120,2596,1586611,2032586249,1585486,2032458645,1125,127604,1568708,6255,1957138,223263,2596,1863,86667.0,14444.0,-73.0,-67.0,-77.0,-75.0,-72.0,-66.0,-75.0,-75.0,-88.0,-90.0,-88.0,-91.0,15.0,23.0,11.0,16.0,1
2596,CC:2F:71:3E:C5:1F,5531305,4451869144,3406912,4182260024,2124393,269609120,502,93242,8003200,78635,6271934,14607,1731266,21551,533,3414314,870692,502,2930,7222.0,1000.0,-74.0,-74.0,-69.0,-61.0,-73.0,-71.0,-69.0,-61.0,-88.0,-90.0,-88.0,-91.0,14.0,16.0,19.0,30.0,1
2597,F8:59:71:5A:E0:3D,3480737,2301604124,1356340,2031994600,2124397,269609524,294,771338,944005758,770638,943921513,700,84245,759899,1840,1356470,169464,294,1163,144444.0,43333.0,-68.0,-73.0,-64.0,-71.0,-67.0,-73.0,-63.0,-71.0,-88.0,-90.0,-88.0,-91.0,20.0,17.0,24.0,20.0,1
2598,CC:2F:71:3F:1F:24,4081881,2856119857,1957484,2586510333,2124397,269609524,2596,1586770,2032789173,1585645,2032661569,1125,127604,1568867,6255,1957346,223264,2596,1863,86667.0,14444.0,-69.0,-64.0,-72.0,-72.0,-69.0,-64.0,-72.0,-71.0,-88.0,-90.0,-88.0,-91.0,19.0,26.0,16.0,19.0,1
2599,CC:2F:71:3E:C5:1F,5531309,4451869548,3406912,4182260024,2124397,269609524,502,93243,8003270,78636,6272004,14607,1731266,21551,533,3414314,870692,502,2930,7222.0,1000.0,-74.0,-74.0,-69.0,-61.0,-73.0,-72.0,-69.0,-61.0,-88.0,-90.0,-88.0,-91.0,14.0,16.0,19.0,30.0,1
2600,F8:59:71:5A:E0:3D,3480806,2301706950,1356406,2032097164,2124400,269609786,294,771406,944110492,770706,944026247,700,84245,759966,1840,1356536,169464,294,1163,144444.0,43333.0,-68.0,-73.0,-64.0,-71.0,-68.0,-73.0,-64.0,-71.0,-89.0,-91.0,-89.0,-92.0,21.0,18.0,25.0,21.0,1
2601,CC:2F:71:3F:1F:24,4082334,2856754494,1957934,2587144708,2124400,269609786,2596,1586964,2033001365,1585839,2032873761,1125,127604,1569061,6255,1957815,223281,2596,1863,65000.0,14444.0,-70.0,-64.0,-72.0,-71.0,-69.0,-63.0,-71.0,-71.0,-89.0,-91.0,-89.0,-92.0,19.0,27.0,17.0,21.0,1
2602,CC:2F:71:3E:C5:1F,5531312,4451869810,3406912,4182260024,2124400,269609786,502,93243,8003270,78636,6272004,14607,1731266,21551,533,3414314,870692,502,2930,7222.0,1000.0,-74.0,-74.0,-69.0,-61.0,-73.0,-72.0,-69.0,-61.0,-89.0,-91.0,-89.0,-92.0,15.0,17.0,20.0,31.0,1
2603,F8:59:71:5A:E0:3D,3481033,2302045259,1356627,2032434867,2124406,269610392,294,771501,944223394,770801,944139149,700,84245,760061,1840,1356757,169464,294,1163,144444.0,43333.0,-68.0,-73.0,-64.0,-71.0,-68.0,-73.0,-64.0,-71.0,-89.0,-91.0,-89.0,-92.0,21.0,18.0,25.0,21.0,1
2604,CC:2F:71:3F:1F:24,4082520,2856977003,1958114,2587366611,2124406,269610392,2596,1587128,2033215754,1586003,2033088150,1125,127604,1569224,6255,1957995,223289,2596,1863,104000.0,26000.0,-69.0,-64.0,-72.0,-72.0,-69.0,-64.0,-71.0,-71.0,-89.0,-91.0,-89.0,-92.0,20.0,27.0,17.0,20.0,1
2605,CC:2F:71:3E:C5:1F,5531318,4451870416,3406912,4182260024,2124406,269610392,502,93243,8003270,78636,6272004,14607,1731266,21551,533,3414314,870692,502,2930,7222.0,1000.0,-74.0,-74.0,-69.0,-61.0,-73.0,-72.0,-69.0,-61.0,-89.0,-91.0,-89.0,-92.0,15.0,17.0,20.0,31.0,1
2606,F8:59:71:5A:E0:3D,3481100,2302146471,1356692,2032535877,2124408,269610594,294,771565,944321954,770865,944237709,700,84245,760125,1840,1356822,169464,294,1163,144444.0,43333.0,-68.0,-73.0,-64.0,-71.0,-67.0,-73.0,-64.0,-71.0,-89.0,-91.0,-89.0,-92.0,21.0,18.0,25.0,21.0,1
2607,CC:2F:71:3F:1F:24,4082681,2857185659,1958273,2587575065,2124408,269610594,2596,1587273,2033415918,1586148,2033288314,1125,127604,1569369,6255,1958154,223328,2596,1863,78000.0,13000.0,-70.0,-64.0,-72.0,-72.0,-70.0,-64.0,-71.0,-72.0,-89.0,-91.0,-89.0,-92.0,19.0,27.0,17.0,20.0,1
2608,CC:2F:71:3E:C5:1F,5531320,4451870618,3406912,4182260024,2124408,269610594,502,93243,8003270,78636,6272004,14607,1731266,21551,533,3414314,870692,502,2930,7222.0,1000.0,-74.0,-74.0,-69.0,-61.0,-73.0,-72.0,-69.0,-61.0,-89.0,-91.0,-89.0,-92.0,15.0,17.0,20.0,31.0,1
2609,F8:59:71:5A:E0:3D,3481183,2302250551,1356768,2032639291,2124415,269611260,294,771640,944426330,770940,944342085,700,84245,760200,1840,1356898,169464,294,1163,144444.0,43333.0,-67.0,-73.0,-64.0,-71.0,-67.0,-73.0,-64.0,-71.0,-89.0,-91.0,-89.0,-92.0,22.0,18.0,25.0,21.0,1
2610,CC:2F:71:3F:1F:24,4082848,2857395149,1958433,2587783889,2124415,269611260,2596,1587422,2033618066,1586297,2033490462,1125,127604,1569517,6255,1958314,223328,2596,1863,86667.0,14444.0,-70.0,-64.0,-73.0,-73.0,-70.0,-64.0,-73.0,-72.0,-89.0,-91.0,-89.0,-92.0,19.0,27.0,16.0,19.0,1
2611,CC:2F:71:3E:C5:1F,5531327,4451871284,3406912,4182260024,2124415,269611260,502,93243,8003270,78636,6272004,14607,1731266,21551,533,3414314,870692,502,2930,7222.0,1000.0,-74.0,-74.0,-69.0,-61.0,-73.0,-72.0,-69.0,-61.0,-89.0,-91.0,-89.0,-92.0,15.0,17.0,20.0,31.0,1
2612,F8:59:71:5A:E0:3D,3481247,2302347101,1356830,2032735639,2124417,269611462,294,771703,944523350,771003,944439105,700,84245,760263,1840,1356960,169464,294,1163,144444.0,43333.0,-67.0,-74.0,-64.0,-71.0,-67.0,-73.0,-64.0,-71.0,-89.0,-91.0,-89.0,-92.0,22.0,17.0,25.0,21.0,1
2613,CC:2F:71:3F:1F:24,4083008,2857600939,1958591,2587989477,2124417,269611462,2596,1587568,2033815498,1586443,2033687894,1125,127604,1569663,6255,1958472,223328,2596,1863,117000.0,39000.0,-75.0,-68.0,-76.0,-76.0,-74.0,-68.0,-76.0,-76.0,-89.0,-91.0,-89.0,-92.0,14.0,23.0,13.0,16.0,1
2614,CC:2F:71:3E:C5:1F,5531333,4451872091,3406916,4182260629,2124417,269611462,502,93249,8004015,78642,6272749,14607,1731266,21556,533,3414318,870692,502,2930,6500.0,1000.0,-75.0,-73.0,-70.0,-61.0,-74.0,-73.0,-69.0,-61.0,-89.0,-91.0,-89.0,-92.0,14.0,18.0,19.0,31.0,1
2615,F8:59:71:5A:E0:3D,3481313,2302443853,1356892,2032831987,2124421,269611866,294,771766,944620384,771066,944536139,700,84245,760325,1840,1357022,169465,294,1163,144444.0,43333.0,-67.0,-74.0,-64.0,-71.0,-67.0,-73.0,-64.0,-71.0,-89.0,-91.0,-89.0,-92.0,22.0,17.0,25.0,21.0,1
2616,CC:2F:71:3F:1F:24,4083171,2857804586,1958748,2588192518,2124423,269612068,2596,1587712,2034009889,1586587,2033882285,1125,127604,1569807,6255,1958629,223333,2596,1863,130000.0,43333.0,-71.0,-65.0,-73.0,-73.0,-71.0,-65.0,-72.0,-72.0,-89.0,-91.0,-89.0,-92.0,18.0,26.0,16.0,19.0,1
2617,CC:2F:71:3E:C5:1F,5531340,4451872757,3406916,4182260629,2124424,269612128,502,93249,8004015,78642,6272749,14607,1731266,21556,533,3414318,870692,502,2930,6500.0,1000.0,-75.0,-73.0,-70.0,-61.0,-74.0,-73.0,-69.0,-61.0,-89.0,-91.0,-89.0,-92.0,14.0,18.0,19.0,31.0,1
2618,F8:59:71:5A:E0:3D,3481536,2302782386,1357112,2033170258,2124424,269612128,294,771857,944728578,771157,944644333,700,84245,760414,1840,1357242,169467,294,1163,144444.0,43333.0,-67.0,-74.0,-64.0,-71.0,-67.0,-74.0,-64.0,-71.0,-89.0,-91.0,-89.0,-92.0,22.0,17.0,25.0,21.0,1
2619,CC:2F:71:3F:1F:24,4083338,2858009641,1958914,2588397513,2124424,269612128,2596,1587861,2034205665,1586736,2034078061,1125,127604,1569956,6255,1958795,223334,2596,1863,130000.0,43333.0,-71.0,-65.0,-73.0,-72.0,-71.0,-64.0,-72.0,-72.0,-89.0,-91.0,-89.0,-92.0,18.0,26.0,16.0,20.0,1
2620,CC:2F:71:3E:C5:1F,5531340,4451872757,3406916,4182260629,2124424,269612128,502,93249,8004015,78642,6272749,14607,1731266,21556,533,3414318,870692,502,2930,6500.0,1000.0,-75.0,-73.0,-70.0,-61.0,-74.0,-73.0,-69.0,-61.0,-89.0,-91.0,-89.0,-92.0,14.0,18.0,19.0,31.0,1
2621,F8:59:71:5A:E0:3D,3481622,2302884640,1357194,2033272108,2124428,269612532,294,771939,944829579,771239,944745334,700,84245,760496,1840,1357324,169468,294,1163,144444.0,43333.0,-67.0,-74.0,-64.0,-71.0,-67.0,-73.0,-64.0,-71.0,-89.0,-91.0,-89.0,-92.0,22.0,17.0,25.0,21.0,1
2622,CC:2F:71:3F:1F:24,4083508,2858214189,1959078,2588601455,2124430,269612734,2596,1588013,2034401091,1586888,2034273487,1125,127604,1570108,6255,1958959,223373,2596,1863,130000.0,43333.0,-71.0,-64.0,-72.0,-72.0,-71.0,-64.0,-72.0,-72.0,-89.0,-91.0,-89.0,-92.0,18.0,27.0,17.0,20.0,1
2623,CC:2F:71:3E:C5:1F,5531346,4451873363,3406916,4182260629,2124430,269612734,502,93249,8004015,78642,6272749,14607,1731266,21556,533,3414318,870692,502,2930,6500.0,1000.0,-75.0,-73.0,-70.0,-61.0,-74.0,-73.0,-69.0,-61.0,-89.0,-91.0,-89.0,-92.0,14.0,18.0,19.0,31.0,1
2624,F8:59:71:5A:E0:3D,3481867,2303258800,1357434,2033645591,2124433,269613209,294,772039,944934220,771339,944849975,700,84245,760595,1840,1357564,169486,294,1163,144444.0,43333.0,-67.0,-74.0,-64.0,-71.0,-67.0,-74.0,-64.0,-71.0,-89.0,-91.0,-89.0,-92.0,22.0,17.0,25.0,21.0,1
2625,CC:2F:71:3F:1F:24,4083667,2858417578,1959233,2588804309,2124434,269613269,2596,1588154,2034595095,1587029,2034467491,1125,127604,1570249,6255,1959114,223411,2596,1863,130000.0,43333.0,-71.0,-65.0,-73.0,-72.0,-71.0,-64.0,-72.0,-72.0,-90.0,-92.0,-90.0,-92.0,19.0,27.0,17.0,20.0,1
2626,CC:2F:71:3E:C5:1F,5531350,4451873898,3406916,4182260629,2124434,269613269,502,93249,8004015,78642,6272749,14607,1731266,21556,533,3414318,870692,502,2930,6500.0,1000.0,-75.0,-73.0,-70.0,-61.0,-74.0,-73.0,-69.0,-61.0,-90.0,-92.0,-90.0,-92.0,15.0,19.0,20.0,31.0,1
2627,F8:59:71:5A:E0:3D,3481936,2303358720,1357498,2033745047,2124438,269613673,294,772102,945031240,771402,944946995,700,84245,760658,1840,1357628,169486,294,1163,144444.0,43333.0,-67.0,-74.0,-64.0,-71.0,-67.0,-74.0,-64.0,-71.0,-90.0,-92.0,-90.0,-92.0,23.0,18.0,26.0,21.0,1
2628,CC:2F:71:3F:1F:24,4083830,2858623854,1959392,2589010181,2124438,269613673,2596,1588300,2034792587,1587175,2034664983,1125,127604,1570395,6255,1959273,223485,2596,1864,130000.0,39000.0,-71.0,-65.0,-73.0,-73.0,-71.0,-64.0,-72.0,-72.0,-90.0,-92.0,-90.0,-92.0,19.0,27.0,17.0,19.0,1
2629,CC:2F:71:3E:C5:1F,5531354,4451874302,3406916,4182260629,2124438,269613673,502,93249,8004015,78642,6272749,14607,1731266,21556,533,3414318,870692,502,2930,6500.0,1000.0,-75.0,-73.0,-70.0,-61.0,-74.0,-73.0,-69.0,-61.0,-90.0,-92.0,-90.0,-92.0,15.0,19.0,20.0,31.0,1
2630,F8:59:71:5A:E0:3D,3482016,2303458717,1357572,2033844272,2124444,269614445,294,772175,945129440,771475,945045195,700,84245,760731,1840,1357702,169486,294,1163,144444.0,43333.0,-68.0,-74.0,-64.0,-71.0,-67.0,-73.0,-64.0,-71.0,-90.0,-92.0,-90.0,-92.0,22.0,18.0,26.0,21.0,1
2631,CC:2F:71:3F:1F:24,4083996,2858830723,1959552,2589216278,2124444,269614445,2596,1588446,2034990058,1587321,2034862454,1125,127604,1570541,6255,1959433,223527,2596,1864,130000.0,43333.0,-74.0,-68.0,-76.0,-76.0,-74.0,-68.0,-76.0,-76.0,-90.0,-92.0,-90.0,-92.0,16.0,24.0,14.0,16.0,1
2632,CC:2F:71:3E:C5:1F,5531361,4451875190,3406917,4182260745,2124444,269614445,502,93251,8004155,78644,6272889,14607,1731266,21556,533,3414319,870692,502,2930,6500.0,1000.0,-75.0,-73.0,-70.0,-61.0,-74.0,-73.0,-69.0,-61.0,-90.0,-92.0,-90.0,-92.0,15.0,19.0,20.0,31.0,1
2633,F8:59:71:5A:E0:3D,3482082,2303556937,1357636,2033942290,2124446,269614647,294,772239,945226566,771539,945142321,700,84245,760795,1840,1357766,169486,294,1163,144444.0,43333.0,-68.0,-74.0,-64.0,-71.0,-67.0,-73.0,-64.0,-71.0,-90.0,-92.0,-90.0,-92.0,22.0,18.0,26.0,21.0,1
2634,CC:2F:71:3F:1F:24,4084615,2859673094,1960168,2590058387,2124447,269614707,2596,1588654,2035201339,1587529,2035073735,1125,127604,1570749,6255,1960049,223623,2596,1864,130000.0,39000.0,-70.0,-64.0,-72.0,-72.0,-70.0,-64.0,-71.0,-72.0,-90.0,-92.0,-90.0,-92.0,20.0,28.0,18.0,20.0,1
2635,CC:2F:71:3E:C5:1F,5531366,4451875654,3406917,4182260745,2124449,269614909,502,93251,8004155,78644,6272889,14607,1731266,21556,533,3414319,870692,502,2930,6500.0,1000.0,-75.0,-73.0,-70.0,-61.0,-74.0,-73.0,-69.0,-61.0,-90.0,-92.0,-90.0,-92.0,15.0,19.0,20.0,31.0,1
2636,F8:59:71:5A:E0:3D,3482153,2303655567,1357699,2034040192,2124454,269615375,294,772303,945323704,771602,945239341,701,84363,760859,1840,1357828,169486,294,1163,144444.0,43333.0,-67.0,-74.0,-64.0,-71.0,-67.0,-73.0,-64.0,-71.0,-90.0,-92.0,-90.0,-92.0,23.0,18.0,26.0,21.0,1
2637,CC:2F:71:3F:1F:24,4084780,2859879518,1960326,2590264143,2124454,269615375,2596,1588796,2035397065,1587671,2035269461,1125,127604,1570891,6255,1960207,223661,2596,1865,115556.0,28889.0,-71.0,-64.0,-73.0,-72.0,-70.0,-64.0,-72.0,-72.0,-90.0,-92.0,-90.0,-92.0,19.0,28.0,17.0,20.0,1
2638,CC:2F:71:3E:C5:1F,5531373,4451876352,3406919,4182260977,2124454,269615375,502,93256,8004577,78649,6273311,14607,1731266,21558,533,3414321,870692,502,2930,6500.0,1000.0,-75.0,-73.0,-70.0,-62.0,-74.0,-73.0,-70.0,-61.0,-90.0,-92.0,-90.0,-92.0,15.0,19.0,20.0,30.0,1
2639,F8:59:71:5A:E0:3D,3482214,2303750361,1357760,2034134986,2124454,269615375,294,772364,945417644,771663,945333281,701,84363,760920,1840,1357890,169486,294,1163,144444.0,43333.0,-67.0,-74.0,-64.0,-71.0,-67.0,-73.0,-64.0,-71.0,-90.0,-92.0,-90.0,-92.0,23.0,18.0,26.0,21.0,1
2640,CC:2F:71:3F:1F:24,4084938,2860082928,1960482,2590467351,2124456,269615577,2596,1588938,2035591185,1587813,2035463581,1125,127604,1571033,6255,1960363,223662,2596,1865,115556.0,28889.0,-71.0,-64.0,-73.0,-73.0,-71.0,-64.0,-72.0,-72.0,-90.0,-92.0,-90.0,-92.0,19.0,28.0,17.0,19.0,1
2641,CC:2F:71:3E:C5:1F,5531375,4451876554,3406919,4182260977,2124456,269615577,502,93256,8004577,78649,6273311,14607,1731266,21558,533,3414321,870692,502,2930,6500.0,1000.0,-75.0,-73.0,-70.0,-62.0,-74.0,-73.0,-70.0,-61.0,-90.0,-92.0,-90.0,-92.0,15.0,19.0,20.0,30.0,1
2642,F8:59:71:5A:E0:3D,3482286,2303849131,1357823,2034232888,2124463,269616243,294,772427,945514664,771726,945430301,701,84363,760983,1840,1357953,169486,294,1163,144444.0,43333.0,-68.0,-74.0,-64.0,-71.0,-67.0,-74.0,-64.0,-71.0,-90.0,-92.0,-90.0,-92.0,22.0,18.0,26.0,21.0,1
2643,CC:2F:71:3F:1F:24,4085101,2860286522,1960638,2590670279,2124463,269616243,2596,1589081,2035785421,1587956,2035657817,1125,127604,1571176,6255,1960519,223669,2596,1865,104000.0,26000.0,-71.0,-64.0,-72.0,-73.0,-71.0,-64.0,-72.0,-72.0,-90.0,-92.0,-90.0,-92.0,19.0,28.0,18.0,19.0,1
2644,CC:2F:71:3E:C5:1F,5531382,4451877220,3406919,4182260977,2124463,269616243,502,93256,8004577,78649,6273311,14607,1731266,21558,533,3414321,870692,502,2930,6500.0,1000.0,-75.0,-73.0,-70.0,-62.0,-74.0,-73.0,-70.0,-61.0,-90.0,-92.0,-90.0,-92.0,15.0,19.0,20.0,30.0,1
2645,F8:59:71:5A:E0:3D,3482508,2304187766,1358045,2034571523,2124463,269616243,294,772522,945623761,771821,945539398,701,84363,761077,1840,1358175,169486,294,1163,144444.0,43333.0,-68.0,-74.0,-64.0,-71.0,-67.0,-74.0,-64.0,-71.0,-90.0,-92.0,-90.0,-92.0,22.0,18.0,26.0,21.0,1
2646,CC:2F:71:3F:1F:24,4085266,2860491068,1960803,2590874825,2124463,269616243,2596,1589237,2035984361,1588112,2035856757,1125,127604,1571329,6255,1960684,223670,2596,1865,115556.0,28889.0,-71.0,-64.0,-72.0,-73.0,-70.0,-64.0,-72.0,-72.0,-90.0,-92.0,-90.0,-92.0,19.0,28.0,18.0,19.0,1
2647,CC:2F:71:3E:C5:1F,5531382,4451877220,3406919,4182260977,2124463,269616243,502,93256,8004577,78649,6273311,14607,1731266,21558,533,3414321,870692,502,2930,6500.0,1000.0,-75.0,-73.0,-70.0,-62.0,-74.0,-73.0,-70.0,-61.0,-90.0,-92.0,-90.0,-92.0,15.0,19.0,20.0,30.0,1
2648,F8:59:71:5A:E0:3D,3482698,2304468264,1358228,2034851353,2124470,269616911,294,772618,945734115,771917,945649752,701,84363,761171,1840,1358358,169486,294,1163,144444.0,43333.0,-67.0,-74.0,-64.0,-71.0,-67.0,-74.0,-64.0,-71.0,-90.0,-92.0,-90.0,-92.0,23.0,18.0,26.0,21.0,1
2649,CC:2F:71:3F:1F:24,4085725,2861108389,1961253,2591491276,2124472,269617113,2596,1589424,2036190565,1588298,2036062843,1126,127722,1571516,6255,1961134,223670,2596,1865,115556.0,28889.0,-71.0,-65.0,-72.0,-73.0,-71.0,-64.0,-72.0,-72.0,-90.0,-92.0,-90.0,-92.0,19.0,27.0,18.0,19.0,1
2650,CC:2F:71:3E:C5:1F,5531391,4451878090,3406919,4182260977,2124472,269617113,502,93256,8004577,78649,6273311,14607,1731266,21558,533,3414321,870692,502,2930,6500.0,1000.0,-75.0,-73.0,-70.0,-62.0,-74.0,-73.0,-70.0,-61.0,-90.0,-92.0,-90.0,-92.0,15.0,19.0,20.0,30.0,1
2651,F8:59:71:5A:E0:3D,3483047,2304968134,1358574,2035350961,2124473,269617173,294,772733,945843330,772032,945758967,701,84363,761286,1840,1358704,169487,294,1163,144444.0,43333.0,-67.0,-74.0,-64.0,-71.0,-67.0,-74.0,-64.0,-71.0,-90.0,-92.0,-90.0,-93.0,23.0,18.0,26.0,22.0,1
2652,CC:2F:71:3F:1F:24,4085887,2861319203,1961414,2591702030,2124473,269617173,2596,1589571,2036392385,1588445,2036264663,1126,127722,1571663,6255,1961295,223677,2596,1865,115556.0,28889.0,-71.0,-64.0,-72.0,-73.0,-71.0,-64.0,-72.0,-72.0,-90.0,-92.0,-90.0,-93.0,19.0,28.0,18.0,20.0,1
2653,CC:2F:71:3E:C5:1F,5531392,4451878150,3406919,4182260977,2124473,269617173,502,93256,8004577,78649,6273311,14607,1731266,21558,533,3414321,870692,502,2930,6500.0,1000.0,-75.0,-73.0,-70.0,-62.0,-74.0,-73.0,-70.0,-61.0,-90.0,-92.0,-90.0,-93.0,15.0,19.0,20.0,31.0,1
2654,F8:59:71:5A:E0:3D,3483115,2305065088,1358636,2035447309,2124479,269617779,294,772795,945938810,772094,945854447,701,84363,761348,1840,1358766,169487,294,1163,144444.0,43333.0,-68.0,-74.0,-64.0,-71.0,-67.0,-74.0,-64.0,-71.0,-90.0,-92.0,-90.0,-93.0,22.0,18.0,26.0,22.0,1
2655,CC:2F:71:3F:1F:24,4086050,2861524571,1961571,2591906792,2124479,269617779,2596,1589716,2036588277,1588590,2036460555,1126,127722,1571808,6255,1961452,223677,2596,1865,115556.0,28889.0,-70.0,-64.0,-72.0,-73.0,-70.0,-64.0,-72.0,-72.0,-90.0,-92.0,-90.0,-93.0,20.0,28.0,18.0,20.0,1
2656,CC:2F:71:3E:C5:1F,5531398,4451878756,3406919,4182260977,2124479,269617779,502,93256,8004577,78649,6273311,14607,1731266,21558,533,3414321,870692,502,2930,6500.0,1000.0,-75.0,-73.0,-70.0,-62.0,-74.0,-73.0,-70.0,-61.0,-90.0,-92.0,-90.0,-93.0,15.0,19.0,20.0,31.0,1
2657,F8:59:71:5A:E0:3D,3483183,2305164134,1358702,2035546153,2124481,269617981,294,772860,946034700,772159,945950337,701,84363,761413,1840,1358832,169487,294,1163,144444.0,43333.0,-67.0,-74.0,-64.0,-71.0,-67.0,-74.0,-64.0,-71.0,-90.0,-92.0,-90.0,-93.0,23.0,18.0,26.0,22.0,1
2658,CC:2F:71:3F:1F:24,4086206,2861727721,1961725,2592109740,2124481,269617981,2596,1589859,2036782513,1588733,2036654791,1126,127722,1571951,6255,1961606,223677,2596,1865,115556.0,28889.0,-71.0,-65.0,-72.0,-72.0,-70.0,-64.0,-72.0,-72.0,-90.0,-92.0,-90.0,-93.0,19.0,27.0,18.0,21.0,1
2659,CC:2F:71:3E:C5:1F,5531400,4451878958,3406919,4182260977,2124481,269617981,502,93256,8004577,78649,6273311,14607,1731266,21558,533,3414321,870692,502,2930,6500.0,1000.0,-75.0,-73.0,-70.0,-62.0,-74.0,-73.0,-70.0,-61.0,-90.0,-92.0,-90.0,-93.0,15.0,19.0,20.0,31.0,1
2660,F8:59:71:5A:E0:3D,3483249,2305260870,1358764,2035642501,2124485,269618369,294,772922,946130180,772221,946045817,701,84363,761475,1840,1358894,169487,294,1163,144444.0,43333.0,-67.0,-74.0,-64.0,-71.0,-67.0,-74.0,-64.0,-71.0,-90.0,-92.0,-90.0,-93.0,23.0,18.0,26.0,22.0,1
2661,CC:2F:71:3F:1F:24,4086372,2861931893,1961885,2592313322,2124487,269618571,2596,1590004,2036977059,1588878,2036849337,1126,127722,1572096,6255,1961766,223688,2596,1865,115556.0,28889.0,-75.0,-68.0,-76.0,-76.0,-74.0,-67.0,-75.0,-75.0,-90.0,-92.0,-90.0,-93.0,15.0,24.0,14.0,17.0,1
2662,CC:2F:71:3E:C5:1F,5531408,4451879750,3406919,4182260977,2124489,269618773,502,93256,8004577,78649,6273311,14607,1731266,21558,533,3414321,870692,502,2930,6500.0,1000.0,-75.0,-73.0,-70.0,-62.0,-74.0,-73.0,-70.0,-61.0,-90.0,-92.0,-90.0,-93.0,15.0,19.0,20.0,31.0,1
2663,F8:59:71:5A:E0:3D,3483473,2305594483,1358982,2035975508,2124491,269618975,294,773017,946240290,772316,946155927,701,84363,761569,1840,1359112,169487,294,1163,144444.0,43333.0,-68.0,-74.0,-64.0,-71.0,-67.0,-74.0,-64.0,-71.0,-90.0,-92.0,-90.0,-93.0,22.0,18.0,26.0,22.0,1
2664,CC:2F:71:3F:1F:24,4086535,2862141087,1962044,2592522112,2124491,269618975,2596,1590151,2037181811,1589025,2037054089,1126,127722,1572240,6255,1961925,223700,2596,1865,115556.0,28889.0,-71.0,-65.0,-73.0,-73.0,-71.0,-65.0,-73.0,-73.0,-90.0,-92.0,-90.0,-93.0,19.0,27.0,17.0,20.0,1
2665,CC:2F:71:3E:C5:1F,5531410,4451879952,3406919,4182260977,2124491,269618975,502,93256,8004577,78649,6273311,14607,1731266,21558,533,3414321,870692,502,2930,6500.0,1000.0,-75.0,-73.0,-70.0,-62.0,-74.0,-73.0,-70.0,-61.0,-90.0,-92.0,-90.0,-93.0,15.0,19.0,20.0,31.0,1
2666,F8:59:71:5A:E0:3D,3483539,2305692860,1359045,2036073410,2124494,269619450,294,773079,946335770,772378,946251407,701,84363,761631,1840,1359175,169487,294,1163,144444.0,43333.0,-67.0,-73.0,-64.0,-71.0,-67.0,-73.0,-64.0,-71.0,-90.0,-92.0,-90.0,-93.0,23.0,19.0,26.0,22.0,1
2667,CC:2F:71:3F:1F:24,4086694,2862344770,1962200,2592725320,2124494,269619450,2596,1590298,2037380839,1589172,2037253117,1126,127722,1572383,6255,1962081,223700,2596,1865,115556.0,28889.0,-77.0,-71.0,-78.0,-79.0,-77.0,-71.0,-78.0,-79.0,-90.0,-92.0,-90.0,-93.0,13.0,21.0,12.0,14.0,1
2668,CC:2F:71:3E:C5:1F,5531413,4451880427,3406919,4182260977,2124494,269619450,502,93256,8004577,78649,6273311,14607,1731266,21558,533,3414321,870692,502,2930,6500.0,1000.0,-75.0,-73.0,-70.0,-62.0,-74.0,-73.0,-70.0,-61.0,-90.0,-92.0,-90.0,-93.0,15.0,19.0,20.0,31.0,1
2669,F8:59:71:5A:E0:3D,3483608,2305789874,1359107,2036169758,2124501,269620116,294,773141,946431292,772440,946346929,701,84363,761693,1840,1359237,169487,294,1163,144444.0,43333.0,-68.0,-74.0,-64.0,-71.0,-67.0,-74.0,-64.0,-71.0,-90.0,-92.0,-90.0,-93.0,22.0,18.0,26.0,22.0,1
2670,CC:2F:71:3F:1F:24,4086872,2862552532,1962371,2592932416,2124501,269620116,2596,1590451,2037580145,1589325,2037452423,1126,127722,1572535,6255,1962252,223707,2596,1865,115556.0,28889.0,-74.0,-68.0,-76.0,-76.0,-73.0,-67.0,-75.0,-75.0,-90.0,-92.0,-90.0,-93.0,16.0,24.0,14.0,17.0,1
2671,CC:2F:71:3E:C5:1F,5531420,4451881093,3406919,4182260977,2124501,269620116,502,93256,8004577,78649,6273311,14607,1731266,21558,533,3414321,870692,502,2930,6500.0,1000.0,-75.0,-73.0,-70.0,-62.0,-74.0,-73.0,-70.0,-61.0,-90.0,-92.0,-90.0,-93.0,15.0,19.0,20.0,31.0,1
2672,F8:59:71:5A:E0:3D,3483673,2305886486,1359169,2036266106,2124504,269620380,294,773205,946529894,772504,946445531,701,84363,761756,1840,1359299,169488,294,1163,144444.0,43333.0,-67.0,-74.0,-64.0,-71.0,-67.0,-73.0,-64.0,-71.0,-90.0,-92.0,-90.0,-93.0,23.0,18.0,26.0,22.0,1
2673,CC:2F:71:3F:1F:24,4087506,2863434499,1963002,2593814119,2124504,269620380,2596,1590648,2037787894,1589522,2037660172,1126,127722,1572732,6255,1962883,223731,2596,1865,115556.0,28889.0,-71.0,-65.0,-73.0,-73.0,-71.0,-65.0,-72.0,-73.0,-90.0,-92.0,-90.0,-93.0,19.0,27.0,17.0,20.0,1
2674,CC:2F:71:3E:C5:1F,5531423,4451881357,3406919,4182260977,2124504,269620380,502,93258,8004765,78650,6273381,14608,1731384,21559,533,3414321,870692,502,2930,6500.0,1000.0,-75.0,-73.0,-70.0,-61.0,-74.0,-73.0,-70.0,-61.0,-90.0,-92.0,-90.0,-93.0,15.0,19.0,20.0,32.0,1
2675,F8:59:71:5A:E0:3D,3483925,2306270044,1359415,2036649058,2124510,269620986,294,773309,946635377,772608,946551014,701,84363,761860,1840,1359545,169488,294,1163,144444.0,43333.0,-67.0,-74.0,-64.0,-71.0,-67.0,-73.0,-64.0,-71.0,-90.0,-92.0,-90.0,-93.0,23.0,18.0,26.0,22.0,1
2676,CC:2F:71:3F:1F:24,4087673,2863643313,1963163,2594022327,2124510,269620986,2596,1590795,2037985674,1589669,2037857952,1126,127722,1572879,6255,1963044,223731,2596,1865,115556.0,28889.0,-71.0,-64.0,-72.0,-72.0,-70.0,-64.0,-72.0,-72.0,-90.0,-92.0,-90.0,-93.0,19.0,28.0,18.0,21.0,1
2677,CC:2F:71:3E:C5:1F,5531429,4451881963,3406919,4182260977,2124510,269620986,502,93258,8004765,78650,6273381,14608,1731384,21559,533,3414321,870692,502,2930,6500.0,1000.0,-75.0,-73.0,-70.0,-61.0,-74.0,-73.0,-70.0,-61.0,-90.0,-92.0,-90.0,-93.0,15.0,19.0,20.0,32.0,1
2678,F8:59:71:5A:E0:3D,3483988,2306366452,1359477,2036745406,2124511,269621046,294,773371,946730857,772670,946646494,701,84363,761922,1840,1359607,169488,294,1163,144444.0,43333.0,-67.0,-74.0,-64.0,-71.0,-67.0,-74.0,-64.0,-71.0,-90.0,-92.0,-90.0,-93.0,23.0,18.0,26.0,22.0,1
2679,CC:2F:71:3F:1F:24,4087830,2863846357,1963319,2594225311,2124511,269621046,2596,1590938,2038179910,1589812,2038052188,1126,127722,1573022,6255,1963200,223737,2596,1865,115556.0,28889.0,-71.0,-65.0,-72.0,-72.0,-70.0,-64.0,-72.0,-72.0,-90.0,-92.0,-90.0,-93.0,19.0,27.0,18.0,21.0,1
2680,CC:2F:71:3E:C5:1F,5531432,4451882225,3406919,4182260977,2124513,269621248,502,93258,8004765,78650,6273381,14608,1731384,21559,533,3414321,870692,502,2930,6500.0,1000.0,-75.0,-73.0,-70.0,-61.0,-74.0,-73.0,-70.0,-61.0,-90.0,-92.0,-90.0,-93.0,15.0,19.0,20.0,32.0,1
2681,F8:59:71:5A:E0:3D,3484281,2306776848,1359764,2037155196,2124517,269621652,294,773474,946835728,772773,946751365,701,84363,762025,1840,1359894,169488,294,1163,144444.0,43333.0,-67.0,-74.0,-64.0,-71.0,-67.0,-74.0,-64.0,-71.0,-90.0,-92.0,-90.0,-93.0,23.0,18.0,26.0,22.0,1
2682,CC:2F:71:3F:1F:24,4087997,2864053747,1963480,2594432095,2124517,269621652,2596,1591085,2038377536,1589959,2038249814,1126,127722,1573169,6255,1963361,223739,2596,1865,115556.0,28889.0,-71.0,-64.0,-72.0,-73.0,-70.0,-64.0,-72.0,-72.0,-90.0,-92.0,-90.0,-93.0,19.0,28.0,18.0,20.0,1
2683,CC:2F:71:3E:C5:1F,5531438,4451882831,3406919,4182260977,2124519,269621854,502,93258,8004765,78650,6273381,14608,1731384,21559,533,3414321,870692,502,2930,6500.0,1000.0,-75.0,-73.0,-70.0,-61.0,-74.0,-73.0,-70.0,-61.0,-90.0,-92.0,-90.0,-93.0,15.0,19.0,20.0,32.0,1
2684,F8:59:71:5A:E0:3D,3484352,2306875871,1359833,2037254017,2124519,269621854,294,773540,946933068,772839,946848705,701,84363,762091,1840,1359963,169488,294,1163,144444.0,43333.0,-68.0,-74.0,-64.0,-71.0,-67.0,-74.0,-64.0,-71.0,-90.0,-92.0,-90.0,-93.0,22.0,18.0,26.0,22.0,1
2685,CC:2F:71:3F:1F:24,4088155,2864257157,1963636,2594635303,2124519,269621854,2596,1591228,2038573210,1590102,2038445488,1126,127722,1573311,6255,1963517,223739,2596,1865,115556.0,28889.0,-70.0,-64.0,-72.0,-73.0,-70.0,-64.0,-72.0,-72.0,-90.0,-92.0,-90.0,-93.0,20.0,28.0,18.0,20.0,1
2686,CC:2F:71:3E:C5:1F,5531438,4451882831,3406919,4182260977,2124519,269621854,502,93258,8004765,78650,6273381,14608,1731384,21559,533,3414321,870692,502,2930,6500.0,1000.0,-75.0,-73.0,-70.0,-61.0,-74.0,-73.0,-70.0,-61.0,-90.0,-92.0,-90.0,-93.0,15.0,19.0,20.0,32.0,1
2687,F8:59:71:5A:E0:3D,3484577,2307211034,1360051,2037588514,2124526,269622520,294,773630,947039694,772929,946955331,701,84363,762181,1840,1360181,169488,294,1163,144444.0,43333.0,-67.0,-73.0,-64.0,-71.0,-67.0,-73.0,-64.0,-71.0,-90.0,-92.0,-90.0,-93.0,23.0,19.0,26.0,22.0,1
2688,CC:2F:71:3F:1F:24,4088328,2864465240,1963802,2594842720,2124526,269622520,2596,1591379,2038772483,1590253,2038644761,1126,127722,1573462,6255,1963683,223805,2596,1865,117000.0,39000.0,-70.0,-64.0,-72.0,-72.0,-70.0,-64.0,-72.0,-72.0,-90.0,-92.0,-90.0,-93.0,20.0,28.0,18.0,21.0,1
2689,CC:2F:71:3E:C5:1F,5531445,4451883497,3406919,4182260977,2124526,269622520,502,93258,8004765,78650,6273381,14608,1731384,21559,533,3414321,870692,502,2930,6500.0,1000.0,-75.0,-73.0,-70.0,-61.0,-74.0,-73.0,-70.0,-61.0,-90.0,-92.0,-90.0,-93.0,15.0,19.0,20.0,32.0,1
2690,F8:59:71:5A:E0:3D,3484642,2307309138,1360114,2037686416,2124528,269622722,294,773693,947136714,772992,947052351,701,84363,762244,1840,1360244,169490,294,1163,144444.0,43333.0,-67.0,-73.0,-64.0,-71.0,-67.0,-73.0,-64.0,-71.0,-90.0,-92.0,-90.0,-93.0,23.0,19.0,26.0,22.0,1
2691,CC:2F:71:3F:1F:24,4088785,2865086796,1964257,2595464074,2124528,269622722,2596,1591561,2038976731,1590435,2038849009,1126,127722,1573644,6255,1964137,223847,2596,1865,115556.0,28889.0,-70.0,-64.0,-72.0,-72.0,-70.0,-64.0,-71.0,-72.0,-90.0,-92.0,-90.0,-93.0,20.0,28.0,18.0,21.0,1
2692,CC:2F:71:3E:C5:1F,5531447,4451883699,3406919,4182260977,2124528,269622722,502,93258,8004765,78650,6273381,14608,1731384,21559,533,3414321,870692,502,2930,6500.0,1000.0,-75.0,-73.0,-70.0,-61.0,-74.0,-73.0,-70.0,-61.0,-90.0,-92.0,-90.0,-93.0,15.0,19.0,20.0,32.0,1
2693,F8:59:71:5A:E0:3D,3484717,2307407260,1360185,2037784134,2124532,269623126,294,773761,947235331,773060,947150968,701,84363,762312,1840,1360315,169490,294,1163,144444.0,43333.0,-67.0,-73.0,-64.0,-71.0,-67.0,-73.0,-64.0,-71.0,-90.0,-92.0,-90.0,-93.0,23.0,19.0,26.0,22.0,1
2694,CC:2F:71:3F:1F:24,4088972,2865296999,1964440,2595673873,2124532,269623126,2596,1591727,2039182489,1590601,2039054767,1126,127722,1573810,6255,1964321,223849,2596,1865,115556.0,28889.0,-71.0,-64.0,-72.0,-73.0,-70.0,-64.0,-72.0,-72.0,-90.0,-92.0,-90.0,-93.0,19.0,28.0,18.0,20.0,1
2695,CC:2F:71:3E:C5:1F,5531451,4451884103,3406919,4182260977,2124532,269623126,502,93258,8004765,78650,6273381,14608,1731384,21559,533,3414321,870692,502,2930,6500.0,1000.0,-75.0,-73.0,-70.0,-61.0,-74.0,-73.0,-70.0,-61.0,-90.0,-92.0,-90.0,-93.0,15.0,19.0,20.0,32.0,1
2696,F8:59:71:5A:E0:3D,3484904,2307668778,1360367,2038045188,2124537,269623590,294,773880,947360692,773179,947276329,701,84363,762431,1840,1360497,169506,294,1164,144444.0,43333.0,-68.0,-73.0,-64.0,-71.0,-67.0,-73.0,-64.0,-71.0,-90.0,-93.0,-90.0,-93.0,22.0,20.0,26.0,22.0,1
2697,CC:2F:71:3F:1F:24,4089186,2865550617,1964649,2595927027,2124537,269623590,2604,1591933,2039431407,1590807,2039303685,1126,127722,1574003,6255,1964530,223903,2604,1865,115556.0,28889.0,-71.0,-64.0,-72.0,-73.0,-73.0,-67.0,-74.0,-75.0,-90.0,-93.0,-90.0,-93.0,19.0,29.0,18.0,20.0,1
2698,CC:2F:71:3E:C5:1F,5531456,4451884567,3406919,4182260977,2124537,269623590,502,93258,8004765,78650,6273381,14608,1731384,21559,533,3414321,870692,502,2930,6500.0,1000.0,-75.0,-73.0,-70.0,-61.0,-74.0,-73.0,-70.0,-61.0,-90.0,-93.0,-90.0,-93.0,15.0,20.0,20.0,32.0,1
2699,F8:59:71:5A:E0:3D,3485051,2307851178,1360510,2038227184,2124541,269623994,294,773977,947471125,773276,947386762,701,84363,762528,1840,1360640,169506,294,1164,144444.0,43333.0,-67.0,-74.0,-64.0,-71.0,-67.0,-74.0,-64.0,-71.0,-90.0,-93.0,-90.0,-93.0,23.0,19.0,26.0,22.0,1
2700,CC:2F:71:3F:1F:24,4089348,2865757337,1964807,2596133343,2124541,269623994,2604,1592083,2039629307,1590957,2039501585,1126,127722,1574147,6255,1964688,223903,2604,1865,115556.0,28889.0,-71.0,-65.0,-72.0,-73.0,-76.0,-69.0,-77.0,-77.0,-90.0,-93.0,-90.0,-93.0,19.0,28.0,18.0,20.0,1
2701,CC:2F:71:3E:C5:1F,5531460,4451884971,3406919,4182260977,2124541,269623994,502,93258,8004765,78650,6273381,14608,1731384,21559,533,3414321,870692,502,2930,6500.0,1000.0,-75.0,-73.0,-70.0,-61.0,-74.0,-73.0,-70.0,-61.0,-90.0,-93.0,-90.0,-93.0,15.0,20.0,20.0,32.0,1
2702,F8:59:71:5A:E0:3D,3485118,2307947990,1360572,2038323532,2124546,269624458,294,774041,947569699,773340,947485336,701,84363,762591,1840,1360702,169507,294,1164,144444.0,43333.0,-67.0,-74.0,-64.0,-71.0,-67.0,-73.0,-64.0,-71.0,-90.0,-93.0,-90.0,-93.0,23.0,19.0,26.0,22.0,1
2703,CC:2F:71:3F:1F:24,4089527,2865970093,1964981,2596345635,2124546,269624458,2604,1592238,2039831511,1591112,2039703789,1126,127722,1574300,6255,1964862,223944,2604,1865,117000.0,39000.0,-77.0,-70.0,-78.0,-79.0,-74.0,-68.0,-76.0,-76.0,-90.0,-93.0,-90.0,-93.0,13.0,23.0,12.0,14.0,1
2704,CC:2F:71:3E:C5:1F,5531465,4451885435,3406919,4182260977,2124546,269624458,502,93258,8004765,78650,6273381,14608,1731384,21559,533,3414321,870692,502,2930,6500.0,1000.0,-75.0,-73.0,-70.0,-61.0,-74.0,-73.0,-70.0,-61.0,-90.0,-93.0,-90.0,-93.0,15.0,20.0,20.0,32.0,1
2705,F8:59:71:5A:E0:3D,3485340,2308284721,1360792,2038660061,2124548,269624660,294,774129,947676093,773428,947591730,701,84363,762679,1840,1360922,169507,294,1164,144444.0,43333.0,-67.0,-74.0,-64.0,-71.0,-67.0,-74.0,-64.0,-71.0,-90.0,-93.0,-90.0,-93.0,23.0,19.0,26.0,22.0,1
2706,CC:2F:71:3F:1F:24,4089687,2866174510,1965139,2596549850,2124548,269624660,2604,1592384,2040027381,1591258,2039899659,1126,127722,1574443,6255,1965020,224019,2604,1865,130000.0,39000.0,-77.0,-71.0,-78.0,-79.0,-77.0,-70.0,-78.0,-78.0,-90.0,-93.0,-90.0,-93.0,13.0,22.0,12.0,14.0,1
2707,CC:2F:71:3E:C5:1F,5531469,4451885839,3406919,4182260977,2124550,269624862,502,93258,8004765,78650,6273381,14608,1731384,21559,533,3414321,870692,502,2930,6500.0,1000.0,-75.0,-73.0,-70.0,-61.0,-74.0,-73.0,-70.0,-61.0,-90.0,-93.0,-90.0,-93.0,15.0,20.0,20.0,32.0,1
2708,F8:59:71:5A:E0:3D,3485408,2308381675,1360854,2038756409,2124554,269625266,294,774191,947771573,773490,947687210,701,84363,762741,1840,1360984,169507,294,1164,144444.0,43333.0,-68.0,-73.0,-64.0,-71.0,-68.0,-73.0,-64.0,-71.0,-90.0,-93.0,-90.0,-93.0,22.0,20.0,26.0,22.0,1
2709,CC:2F:71:3F:1F:24,4089849,2866377596,1965295,2596752330,2124554,269625266,2604,1592528,2040221733,1591402,2040094011,1126,127722,1574587,6255,1965176,224071,2604,1865,65000.0,14444.0,-78.0,-70.0,-77.0,-79.0,-77.0,-70.0,-77.0,-78.0,-90.0,-93.0,-90.0,-93.0,12.0,23.0,13.0,14.0,1
2710,CC:2F:71:3E:C5:1F,5531474,4451886516,3406919,4182260977,2124555,269625539,502,93258,8004765,78650,6273381,14608,1731384,21559,533,3414321,870692,502,2930,6500.0,1000.0,-75.0,-73.0,-70.0,-61.0,-74.0,-73.0,-70.0,-61.0,-90.0,-93.0,-90.0,-93.0,15.0,20.0,20.0,32.0,1
2711,F8:59:71:5A:E0:3D,3485475,2308480112,1360917,2038854311,2124558,269625801,294,774254,947868593,773553,947784230,701,84363,762804,1840,1361047,169507,294,1164,144444.0,43333.0,-68.0,-74.0,-64.0,-72.0,-68.0,-73.0,-64.0,-71.0,-90.0,-93.0,-90.0,-93.0,22.0,19.0,26.0,21.0,1
2712,CC:2F:71:3F:1F:24,4090354,2867064277,1965796,2597438476,2124558,269625801,2604,1592735,2040437835,1591609,2040310113,1126,127722,1574793,6255,1965677,224071,2604,1865,86667.0,14444.0,-77.0,-70.0,-78.0,-79.0,-76.0,-70.0,-77.0,-79.0,-90.0,-93.0,-90.0,-93.0,13.0,23.0,12.0,14.0,1
2713,CC:2F:71:3E:C5:1F,5531477,4451886778,3406919,4182260977,2124558,269625801,502,93258,8004765,78650,6273381,14608,1731384,21559,533,3414321,870692,502,2930,6500.0,1000.0,-75.0,-73.0,-70.0,-61.0,-74.0,-73.0,-70.0,-61.0,-90.0,-93.0,-90.0,-93.0,15.0,20.0,20.0,32.0,1
2714,F8:59:71:5A:E0:3D,3485549,2308582054,1360983,2038955437,2124566,269626617,294,774320,947970233,773619,947885870,701,84363,762870,1840,1361113,169508,294,1164,144444.0,43333.0,-68.0,-74.0,-64.0,-71.0,-68.0,-74.0,-64.0,-71.0,-90.0,-93.0,-90.0,-93.0,22.0,19.0,26.0,22.0,1
2715,CC:2F:71:3F:1F:24,4090525,2867277181,1965959,2597650564,2124566,269626617,2604,1592885,2040641511,1591759,2040513789,1126,127722,1574943,6255,1965840,224071,2604,1865,86667.0,14444.0,-76.0,-70.0,-77.0,-79.0,-76.0,-70.0,-77.0,-79.0,-90.0,-93.0,-90.0,-93.0,14.0,23.0,13.0,14.0,1
2716,CC:2F:71:3E:C5:1F,5531486,4451887710,3406920,4182261093,2124566,269626617,502,93259,8004835,78651,6273451,14608,1731384,21559,533,3414322,870692,502,2930,13000.0,1000.0,-74.0,-74.0,-69.0,-61.0,-74.0,-73.0,-69.0,-61.0,-90.0,-93.0,-90.0,-93.0,16.0,19.0,21.0,32.0,1
2717,F8:59:71:5A:E0:3D,3485830,2308984766,1361240,2039347099,2124590,269637667,294,774429,948078699,773728,947994336,701,84363,762979,1840,1361370,169509,294,1164,144444.0,43333.0,-68.0,-74.0,-64.0,-71.0,-68.0,-73.0,-64.0,-71.0,-90.0,-93.0,-90.0,-93.0,22.0,19.0,26.0,22.0,1
2718,CC:2F:71:3F:1F:24,4090716,2867506565,1966126,2597868898,2124590,269637667,2604,1593040,2040851559,1591914,2040723837,1126,127722,1575098,6255,1966007,224086,2604,1865,115556.0,28889.0,-76.0,-70.0,-78.0,-80.0,-74.0,-68.0,-76.0,-78.0,-90.0,-93.0,-90.0,-93.0,14.0,23.0,12.0,13.0,1
2719,CC:2F:71:3E:C5:1F,5531510,4451898760,3406920,4182261093,2124590,269637667,502,93260,8004905,78652,6273521,14608,1731384,21559,533,3414322,870692,502,2930,13000.0,1000.0,-74.0,-74.0,-69.0,-61.0,-74.0,-73.0,-69.0,-61.0,-90.0,-93.0,-90.0,-93.0,16.0,19.0,21.0,32.0,1
2720,F8:59:71:5A:E0:3D,3485904,2309089550,1361307,2039451217,2124597,269638333,294,774496,948181907,773795,948097544,701,84363,763046,1840,1361437,169509,294,1164,144444.0,43333.0,-68.0,-74.0,-64.0,-71.0,-68.0,-74.0,-64.0,-71.0,-90.0,-93.0,-90.0,-93.0,22.0,19.0,26.0,22.0,1
2721,CC:2F:71:3F:1F:24,4090881,2867713547,1966284,2598075214,2124597,269638333,2604,1593186,2041049117,1592060,2040921395,1126,127722,1575244,6255,1966165,224086,2604,1865,115556.0,28889.0,-76.0,-70.0,-78.0,-80.0,-75.0,-69.0,-77.0,-79.0,-90.0,-93.0,-90.0,-93.0,14.0,23.0,12.0,13.0,1
2722,CC:2F:71:3E:C5:1F,5531517,4451899426,3406920,4182261093,2124597,269638333,502,93260,8004905,78652,6273521,14608,1731384,21559,533,3414322,870692,502,2930,13000.0,1000.0,-74.0,-74.0,-69.0,-61.0,-74.0,-73.0,-69.0,-61.0,-90.0,-93.0,-90.0,-93.0,16.0,19.0,21.0,32.0,1
2723,F8:59:71:5A:E0:3D,3486162,2309444889,1361565,2039806556,2124597,269638333,294,774596,948286444,773895,948202081,701,84363,763145,1840,1361695,169509,294,1164,144444.0,43333.0,-68.0,-74.0,-64.0,-71.0,-68.0,-73.0,-64.0,-71.0,-90.0,-93.0,-90.0,-93.0,22.0,19.0,26.0,22.0,1
2724,CC:2F:71:3F:1F:24,4091036,2867916513,1966439,2598278180,2124597,269638333,2604,1593327,2041243121,1592201,2041115399,1126,127722,1575385,6255,1966320,224087,2604,1865,130000.0,39000.0,-70.0,-64.0,-71.0,-73.0,-70.0,-64.0,-71.0,-73.0,-90.0,-93.0,-90.0,-93.0,20.0,29.0,19.0,20.0,1
2725,CC:2F:71:3E:C5:1F,5531519,4451899628,3406920,4182261093,2124599,269638535,502,93260,8004905,78652,6273521,14608,1731384,21559,533,3414322,870692,502,2930,13000.0,1000.0,-74.0,-74.0,-69.0,-61.0,-74.0,-73.0,-69.0,-61.0,-90.0,-93.0,-90.0,-93.0,16.0,19.0,21.0,32.0,1
2726,F8:59:71:5A:E0:3D,3486229,2309543195,1361628,2039904458,2124601,269638737,294,774658,948381924,773957,948297561,701,84363,763207,1840,1361758,169509,294,1164,144444.0,43333.0,-68.0,-74.0,-64.0,-71.0,-68.0,-73.0,-64.0,-71.0,-90.0,-93.0,-90.0,-93.0,22.0,19.0,26.0,22.0,1
2727,CC:2F:71:3F:1F:24,4091197,2868119301,1966594,2598480362,2124603,269638939,2604,1593469,2041440117,1592343,2041312395,1126,127722,1575525,6255,1966475,224128,2604,1865,130000.0,39000.0,-70.0,-64.0,-72.0,-73.0,-70.0,-64.0,-71.0,-73.0,-90.0,-93.0,-90.0,-93.0,20.0,29.0,18.0,20.0,1
2728,CC:2F:71:3E:C5:1F,5531525,4451900234,3406920,4182261093,2124605,269639141,502,93260,8004905,78652,6273521,14608,1731384,21559,533,3414322,870692,502,2930,13000.0,1000.0,-74.0,-74.0,-69.0,-61.0,-74.0,-73.0,-69.0,-61.0,-90.0,-93.0,-90.0,-93.0,16.0,19.0,21.0,32.0,1
2729,F8:59:71:5A:E0:3D,3486448,2309868668,1361841,2040229405,2124607,269639263,294,774756,948494177,774054,948409696,702,84481,763304,1840,1361971,169509,294,1165,144444.0,43333.0,-68.0,-73.0,-64.0,-71.0,-68.0,-73.0,-64.0,-71.0,-90.0,-93.0,-90.0,-93.0,22.0,20.0,26.0,22.0,1
2730,CC:2F:71:3F:1F:24,4091364,2868333655,1966757,2598694392,2124607,269639263,2604,1593620,2041646799,1592494,2041519077,1126,127722,1575675,6255,1966638,224145,2604,1865,130000.0,43333.0,-70.0,-64.0,-72.0,-73.0,-69.0,-64.0,-71.0,-73.0,-90.0,-93.0,-90.0,-93.0,20.0,29.0,18.0,20.0,1
2731,CC:2F:71:3E:C5:1F,5531527,4451900356,3406920,4182261093,2124607,269639263,502,93260,8004905,78652,6273521,14608,1731384,21559,533,3414322,870692,502,2930,13000.0,1000.0,-74.0,-74.0,-69.0,-61.0,-74.0,-73.0,-69.0,-61.0,-90.0,-93.0,-90.0,-93.0,16.0,19.0,21.0,32.0,1
2732,F8:59:71:5A:E0:3D,3486515,2309966750,1361904,2040327083,2124611,269639667,294,774820,948592751,774118,948508270,702,84481,763367,1840,1362034,169515,294,1165,144444.0,43333.0,-68.0,-73.0,-64.0,-72.0,-68.0,-73.0,-64.0,-71.0,-90.0,-93.0,-90.0,-93.0,22.0,20.0,26.0,21.0,1
2733,CC:2F:71:3F:1F:24,4091540,2868542591,1966929,2598902924,2124611,269639667,2604,1593773,2041848535,1592647,2041720813,1126,127722,1575826,6255,1966810,224195,2604,1865,130000.0,43333.0,-74.0,-68.0,-76.0,-77.0,-73.0,-67.0,-75.0,-77.0,-90.0,-93.0,-90.0,-93.0,16.0,25.0,14.0,16.0,1
2734,CC:2F:71:3E:C5:1F,5531533,4451900962,3406920,4182261093,2124613,269639869,502,93260,8004905,78652,6273521,14608,1731384,21559,533,3414322,870692,502,2930,13000.0,1000.0,-74.0,-74.0,-69.0,-61.0,-74.0,-73.0,-69.0,-61.0,-90.0,-93.0,-90.0,-93.0,16.0,19.0,21.0,32.0,1
2735,F8:59:71:5A:E0:3D,3486581,2310063502,1361966,2040423431,2124615,269640071,294,774883,948689785,774181,948605304,702,84481,763429,1840,1362096,169515,294,1165,144444.0,43333.0,-68.0,-74.0,-64.0,-71.0,-68.0,-73.0,-64.0,-71.0,-90.0,-93.0,-90.0,-93.0,22.0,19.0,26.0,22.0,1
2736,CC:2F:71:3F:1F:24,4091700,2868746203,1967085,2599106132,2124615,269640071,2604,1593915,2042042655,1592789,2041914933,1126,127722,1575968,6255,1966966,224207,2604,1865,130000.0,43333.0,-73.0,-68.0,-75.0,-77.0,-73.0,-67.0,-75.0,-77.0,-90.0,-93.0,-90.0,-93.0,17.0,25.0,15.0,16.0,1
2737,CC:2F:71:3E:C5:1F,5531535,4451901164,3406920,4182261093,2124615,269640071,502,93260,8004905,78652,6273521,14608,1731384,21559,533,3414322,870692,502,2930,13000.0,1000.0,-74.0,-74.0,-69.0,-61.0,-74.0,-73.0,-69.0,-61.0,-90.0,-93.0,-90.0,-93.0,16.0,19.0,21.0,32.0,1
2738,F8:59:71:5A:E0:3D,3486796,2310351515,1362176,2040710980,2124620,269640535,294,774998,948801307,774296,948716826,702,84481,763544,1840,1362306,169515,294,1165,144444.0,43333.0,-68.0,-74.0,-64.0,-71.0,-68.0,-73.0,-64.0,-71.0,-90.0,-93.0,-90.0,-93.0,22.0,19.0,26.0,22.0,1
2739,CC:2F:71:3F:1F:24,4091869,2868962083,1967249,2599321548,2124620,269640535,2604,1594065,2042249151,1592939,2042121429,1126,127722,1576118,6255,1967130,224257,2604,1866,115556.0,28889.0,-79.0,-73.0,-80.0,-82.0,-75.0,-69.0,-76.0,-78.0,-90.0,-93.0,-90.0,-93.0,11.0,20.0,10.0,11.0,1
2740,CC:2F:71:3E:C5:1F,5531540,4451901628,3406920,4182261093,2124620,269640535,502,93260,8004905,78652,6273521,14608,1731384,21559,533,3414322,870692,502,2930,13000.0,1000.0,-74.0,-74.0,-69.0,-61.0,-74.0,-73.0,-69.0,-61.0,-90.0,-93.0,-90.0,-93.0,16.0,19.0,21.0,32.0,1
2741,F8:59:71:5A:E0:3D,3486931,2310520916,1362306,2040879915,2124625,269641001,294,775088,948908942,774386,948824461,702,84481,763634,1840,1362436,169515,294,1165,144444.0,43333.0,-68.0,-74.0,-64.0,-71.0,-68.0,-73.0,-64.0,-71.0,-90.0,-93.0,-90.0,-93.0,22.0,19.0,26.0,22.0,1
2742,CC:2F:71:3F:1F:24,4092426,2869712108,1967801,2600071107,2124625,269641001,2604,1594273,2042461677,1593147,2042333955,1126,127722,1576326,6255,1967682,224261,2604,1866,115556.0,28889.0,-70.0,-64.0,-71.0,-73.0,-69.0,-64.0,-71.0,-73.0,-90.0,-93.0,-90.0,-93.0,20.0,29.0,19.0,20.0,1
2743,CC:2F:71:3E:C5:1F,5531545,4451902094,3406920,4182261093,2124625,269641001,502,93262,8005093,78653,6273591,14609,1731502,21560,533,3414322,870692,502,2930,13000.0,1000.0,-77.0,-83.0,-76.0,-72.0,-74.0,-74.0,-70.0,-62.0,-90.0,-93.0,-90.0,-93.0,13.0,10.0,14.0,21.0,1
2744,F8:59:71:5A:E0:3D,3486998,2310619222,1362369,2040977817,2124629,269641405,294,775152,949007502,774450,948923021,702,84481,763698,1840,1362499,169515,294,1165,144444.0,43333.0,-68.0,-74.0,-64.0,-71.0,-68.0,-73.0,-64.0,-71.0,-90.0,-93.0,-90.0,-93.0,22.0,19.0,26.0,22.0,1
2745,CC:2F:71:3F:1F:24,4092590,2869921919,1967961,2600280514,2124629,269641405,2604,1594422,2042662344,1593296,2042534622,1126,127722,1576475,6255,1967842,224261,2604,1866,117000.0,39000.0,-70.0,-64.0,-71.0,-73.0,-69.0,-64.0,-71.0,-73.0,-90.0,-93.0,-90.0,-93.0,20.0,29.0,19.0,20.0,1
2746,CC:2F:71:3E:C5:1F,5531550,4451902558,3406920,4182261093,2124630,269641465,502,93262,8005093,78653,6273591,14609,1731502,21560,533,3414322,870692,502,2930,13000.0,1000.0,-77.0,-83.0,-76.0,-72.0,-74.0,-74.0,-70.0,-62.0,-90.0,-93.0,-90.0,-93.0,13.0,10.0,14.0,21.0,1
2747,F8:59:71:5A:E0:3D,3487226,2310956678,1362592,2041314809,2124634,269641869,294,775251,949119985,774549,949035504,702,84481,763796,1840,1362722,169515,294,1165,144444.0,43333.0,-68.0,-74.0,-64.0,-72.0,-68.0,-74.0,-64.0,-72.0,-90.0,-93.0,-90.0,-93.0,22.0,19.0,26.0,21.0,1
2748,CC:2F:71:3F:1F:24,4092755,2870130911,1968121,2600489042,2124634,269641869,2604,1594570,2042864294,1593444,2042736572,1126,127722,1576622,6255,1968002,224308,2604,1866,86667.0,14444.0,-73.0,-64.0,-72.0,-74.0,-75.0,-65.0,-73.0,-75.0,-90.0,-93.0,-90.0,-93.0,17.0,29.0,18.0,19.0,1
2749,CC:2F:71:3E:C5:1F,5531554,4451902962,3406920,4182261093,2124634,269641869,502,93262,8005093,78653,6273591,14609,1731502,21560,533,3414322,870692,502,2930,13000.0,1000.0,-77.0,-83.0,-76.0,-72.0,-74.0,-74.0,-70.0,-62.0,-90.0,-93.0,-90.0,-93.0,13.0,10.0,14.0,21.0,1
2750,F8:59:71:5A:E0:3D,3487297,2311054193,1362660,2041412060,2124637,269642133,294,775318,949218674,774616,949134193,702,84481,763863,1840,1362790,169517,294,1165,144444.0,43333.0,-68.0,-73.0,-64.0,-72.0,-68.0,-73.0,-64.0,-72.0,-90.0,-93.0,-90.0,-93.0,22.0,20.0,26.0,21.0,1
2751,CC:2F:71:3F:1F:24,4092915,2870333939,1968278,2600691806,2124637,269642133,2604,1594713,2043057098,1593586,2042929258,1127,127840,1576765,6255,1968159,224308,2604,1866,86667.0,14444.0,-70.0,-63.0,-72.0,-70.0,-70.0,-63.0,-72.0,-70.0,-90.0,-93.0,-90.0,-93.0,20.0,30.0,18.0,23.0,1
2752,CC:2F:71:3E:C5:1F,5531559,4451903428,3406920,4182261093,2124639,269642335,502,93262,8005093,78653,6273591,14609,1731502,21560,533,3414322,870692,502,2930,13000.0,1000.0,-77.0,-83.0,-76.0,-72.0,-74.0,-74.0,-70.0,-62.0,-90.0,-93.0,-90.0,-93.0,13.0,10.0,14.0,21.0,1
2753,F8:59:71:5A:E0:3D,3487367,2311152948,1362724,2041510078,2124643,269642870,294,775384,949318922,774682,949234441,702,84481,763926,1840,1362854,169518,294,1165,144444.0,43333.0,-68.0,-74.0,-64.0,-72.0,-68.0,-74.0,-64.0,-72.0,-90.0,-93.0,-90.0,-93.0,22.0,19.0,26.0,21.0,1
2754,CC:2F:71:3F:1F:24,4093080,2870540324,1968437,2600897454,2124643,269642870,2604,1594860,2043256060,1593733,2043128220,1127,127840,1576912,6255,1968318,224321,2604,1866,78000.0,13000.0,-70.0,-64.0,-72.0,-69.0,-70.0,-63.0,-72.0,-69.0,-90.0,-93.0,-90.0,-93.0,20.0,29.0,18.0,24.0,1
2755,CC:2F:71:3E:C5:1F,5531563,4451903963,3406920,4182261093,2124643,269642870,502,93262,8005093,78653,6273591,14609,1731502,21560,533,3414322,870692,502,2930,13000.0,1000.0,-77.0,-83.0,-76.0,-72.0,-74.0,-74.0,-70.0,-62.0,-90.0,-93.0,-90.0,-93.0,13.0,10.0,14.0,21.0,1
2756,F8:59:71:5A:E0:3D,3487606,2311479938,1362959,2041836664,2124647,269643274,294,775480,949422981,774778,949338500,702,84481,764022,1840,1363089,169518,294,1165,144444.0,43333.0,-68.0,-73.0,-64.0,-71.0,-68.0,-73.0,-64.0,-71.0,-90.0,-93.0,-90.0,-93.0,22.0,20.0,26.0,22.0,1
2757,CC:2F:71:3F:1F:24,4093239,2870743134,1968592,2601099860,2124647,269643274,2604,1595003,2043451734,1593876,2043323894,1127,127840,1577054,6255,1968473,224321,2604,1866,86667.0,14444.0,-71.0,-64.0,-75.0,-71.0,-70.0,-64.0,-75.0,-71.0,-90.0,-93.0,-90.0,-93.0,19.0,29.0,15.0,22.0,1
2758,CC:2F:71:3E:C5:1F,5531567,4451904367,3406920,4182261093,2124647,269643274,502,93262,8005093,78653,6273591,14609,1731502,21560,533,3414322,870692,502,2930,13000.0,1000.0,-77.0,-83.0,-76.0,-72.0,-74.0,-74.0,-70.0,-62.0,-90.0,-93.0,-90.0,-93.0,13.0,10.0,14.0,21.0,1
2759,F8:59:71:5A:E0:3D,3487675,2311578612,1363022,2041934566,2124653,269644046,294,775543,949520001,774841,949435520,702,84481,764085,1840,1363152,169518,294,1165,144444.0,43333.0,-68.0,-74.0,-64.0,-72.0,-67.0,-73.0,-64.0,-72.0,-90.0,-93.0,-90.0,-93.0,22.0,19.0,26.0,21.0,1
2760,CC:2F:71:3F:1F:24,4093403,2870949662,1968750,2601305616,2124653,269644046,2604,1595148,2043649050,1594021,2043521210,1127,127840,1577199,6255,1968631,224321,2604,1866,86667.0,14444.0,-71.0,-64.0,-73.0,-70.0,-70.0,-64.0,-73.0,-70.0,-90.0,-93.0,-90.0,-93.0,19.0,29.0,17.0,23.0,1
2761,CC:2F:71:3E:C5:1F,5531573,4451905139,3406920,4182261093,2124653,269644046,502,93262,8005093,78653,6273591,14609,1731502,21560,533,3414322,870692,502,2930,13000.0,1000.0,-77.0,-83.0,-76.0,-72.0,-74.0,-74.0,-70.0,-62.0,-90.0,-93.0,-90.0,-93.0,13.0,10.0,14.0,21.0,1
2762,F8:59:71:5A:E0:3D,3487742,2311678330,1363086,2042034022,2124656,269644308,294,775606,949617021,774904,949532540,702,84481,764148,1840,1363216,169518,294,1165,144444.0,43333.0,-68.0,-73.0,-64.0,-71.0,-68.0,-73.0,-64.0,-71.0,-90.0,-93.0,-90.0,-93.0,22.0,20.0,26.0,22.0,1
2763,CC:2F:71:3F:1F:24,4093565,2871155516,1968909,2601511208,2124656,269644308,2604,1595293,2043846356,1594166,2043718516,1127,127840,1577344,6255,1968790,224331,2604,1866,65000.0,14444.0,-70.0,-63.0,-73.0,-71.0,-73.0,-66.0,-76.0,-74.0,-90.0,-93.0,-90.0,-93.0,20.0,30.0,17.0,22.0,1
2764,CC:2F:71:3E:C5:1F,5531578,4451905603,3406920,4182261093,2124658,269644510,502,93262,8005093,78653,6273591,14609,1731502,21560,533,3414322,870692,502,2930,13000.0,1000.0,-77.0,-83.0,-76.0,-72.0,-74.0,-74.0,-70.0,-62.0,-90.0,-93.0,-90.0,-93.0,13.0,10.0,14.0,21.0,1
2765,F8:59:71:5A:E0:3D,3487809,2311776636,1363149,2042131924,2124660,269644712,294,775671,949717135,774969,949632654,702,84481,764212,1840,1363279,169518,294,1165,144444.0,43333.0,-68.0,-73.0,-64.0,-72.0,-68.0,-73.0,-64.0,-71.0,-90.0,-93.0,-90.0,-93.0,22.0,20.0,26.0,21.0,1
2766,CC:2F:71:3F:1F:24,4093728,2871363174,1969068,2601718462,2124660,269644712,2604,1595439,2044045240,1594312,2043917400,1127,127840,1577490,6255,1968949,224332,2604,1867,86667.0,14444.0,-79.0,-73.0,-82.0,-80.0,-77.0,-70.0,-79.0,-77.0,-90.0,-93.0,-90.0,-93.0,11.0,20.0,8.0,13.0,1
2767,CC:2F:71:3E:C5:1F,5531582,4451906007,3406920,4182261093,2124662,269644914,502,93262,8005093,78653,6273591,14609,1731502,21560,533,3414322,870692,502,2930,13000.0,1000.0,-77.0,-83.0,-76.0,-72.0,-74.0,-74.0,-70.0,-62.0,-90.0,-93.0,-90.0,-93.0,13.0,10.0,14.0,21.0,1
2768,F8:59:71:5A:E0:3D,3488193,2312364646,1363529,2042719530,2124664,269645116,294,775797,949836699,775095,949752218,702,84481,764337,1840,1363659,169518,294,1165,144444.0,43333.0,-68.0,-73.0,-64.0,-71.0,-68.0,-73.0,-64.0,-71.0,-90.0,-93.0,-90.0,-93.0,22.0,20.0,26.0,22.0,1
2769,CC:2F:71:3F:1F:24,4093903,2871589536,1969239,2601944420,2124664,269645116,2604,1595596,2044264010,1594469,2044136170,1127,127840,1577646,6255,1969120,224334,2604,1867,86667.0,14444.0,-71.0,-64.0,-74.0,-71.0,-71.0,-64.0,-74.0,-71.0,-90.0,-93.0,-90.0,-93.0,19.0,29.0,16.0,22.0,1
2770,CC:2F:71:3E:C5:1F,5531584,4451906209,3406920,4182261093,2124664,269645116,502,93264,8005233,78655,6273731,14609,1731502,21560,533,3414323,870692,502,2930,13000.0,1000.0,-74.0,-72.0,-69.0,-62.0,-74.0,-74.0,-70.0,-62.0,-90.0,-93.0,-90.0,-93.0,16.0,21.0,21.0,31.0,1
2771,F8:59:71:5A:E0:3D,3488261,2312463012,1363592,2042817432,2124669,269645580,294,775862,949935485,775160,949851004,702,84481,764401,1840,1363722,169518,294,1165,144444.0,43333.0,-68.0,-73.0,-64.0,-71.0,-68.0,-73.0,-64.0,-71.0,-90.0,-93.0,-90.0,-93.0,22.0,20.0,26.0,22.0,1
2772,CC:2F:71:3F:1F:24,4094647,2872609797,1969978,2602964217,2124669,269645580,2604,1595844,2044479443,1594717,2044351603,1127,127840,1577894,6255,1969859,224469,2604,1868,86667.0,14444.0,-71.0,-64.0,-74.0,-71.0,-70.0,-63.0,-73.0,-71.0,-90.0,-93.0,-90.0,-93.0,19.0,29.0,16.0,22.0,1
2773,CC:2F:71:3E:C5:1F,5531589,4451906673,3406920,4182261093,2124669,269645580,502,93264,8005233,78655,6273731,14609,1731502,21560,533,3414323,870692,502,2930,13000.0,1000.0,-74.0,-72.0,-69.0,-62.0,-74.0,-74.0,-70.0,-62.0,-90.0,-93.0,-90.0,-93.0,16.0,21.0,21.0,31.0,1
2774,F8:59:71:5A:E0:3D,3488439,2312698735,1363766,2043052751,2124673,269645984,294,775952,950039142,775250,949954661,702,84481,764491,1840,1363896,169518,294,1165,144444.0,43333.0,-68.0,-73.0,-64.0,-71.0,-68.0,-73.0,-63.0,-71.0,-90.0,-93.0,-90.0,-93.0,22.0,20.0,26.0,22.0,1
2775,CC:2F:71:3F:1F:24,4094809,2872815957,1970136,2603169973,2124673,269645984,2604,1595989,2044679635,1594862,2044551795,1127,127840,1578037,6255,1970017,224469,2604,1868,86667.0,14444.0,-71.0,-64.0,-74.0,-71.0,-71.0,-64.0,-74.0,-71.0,-90.0,-93.0,-90.0,-93.0,19.0,29.0,16.0,22.0,1
2776,CC:2F:71:3E:C5:1F,5531593,4451907077,3406920,4182261093,2124673,269645984,502,93264,8005233,78655,6273731,14609,1731502,21560,533,3414323,870692,502,2930,13000.0,1000.0,-74.0,-72.0,-69.0,-62.0,-74.0,-74.0,-70.0,-62.0,-90.0,-93.0,-90.0,-93.0,16.0,21.0,21.0,31.0,1
2777,F8:59:71:5A:E0:3D,3488506,2312797041,1363829,2043150653,2124677,269646388,294,776014,950134622,775312,950050141,702,84481,764553,1840,1363959,169518,294,1165,144444.0,43333.0,-68.0,-73.0,-64.0,-71.0,-68.0,-73.0,-64.0,-71.0,-90.0,-93.0,-90.0,-93.0,22.0,20.0,26.0,22.0,1
2778,CC:2F:71:3F:1F:24,4094969,2873020433,1970292,2603374045,2124677,269646388,2604,1596131,2044876631,1595004,2044748791,1127,127840,1578177,6255,1970172,224470,2604,1868,86667.0,14444.0,-71.0,-64.0,-74.0,-71.0,-70.0,-63.0,-73.0,-70.0,-90.0,-93.0,-90.0,-93.0,19.0,29.0,16.0,22.0,1
2779,CC:2F:71:3E:C5:1F,5531597,4451907481,3406920,4182261093,2124677,269646388,502,93264,8005233,78655,6273731,14609,1731502,21560,533,3414323,870692,502,2930,13000.0,1000.0,-74.0,-72.0,-69.0,-62.0,-74.0,-74.0,-70.0,-62.0,-90.0,-93.0,-90.0,-93.0,16.0,21.0,21.0,31.0,1
2780,F8:59:71:5A:E0:3D,3488657,2313026308,1363977,2043379658,2124680,269646650,294,776100,950239063,775398,950154582,702,84481,764638,1840,1364107,169518,294,1165,144444.0,43333.0,-68.0,-73.0,-64.0,-71.0,-68.0,-73.0,-64.0,-71.0,-90.0,-92.0,-90.0,-93.0,22.0,19.0,26.0,22.0,1
2781,CC:2F:71:3F:1F:24,4095128,2873223007,1970448,2603576357,2124680,269646650,2604,1596272,2045070635,1595145,2044942795,1127,127840,1578318,6255,1970329,224481,2604,1868,86667.0,14444.0,-71.0,-64.0,-74.0,-71.0,-71.0,-64.0,-74.0,-71.0,-90.0,-92.0,-90.0,-93.0,19.0,28.0,16.0,22.0,1
2782,CC:2F:71:3E:C5:1F,5531600,4451907743,3406920,4182261093,2124680,269646650,502,93264,8005233,78655,6273731,14609,1731502,21560,533,3414323,870692,502,2930,13000.0,1000.0,-74.0,-72.0,-69.0,-62.0,-74.0,-74.0,-70.0,-62.0,-90.0,-92.0,-90.0,-93.0,16.0,20.0,21.0,31.0,1
2783,F8:59:71:5A:E0:3D,3488760,2313169036,1364074,2043521780,2124686,269647256,294,776176,950344065,775474,950259584,702,84481,764714,1840,1364204,169523,294,1165,130000.0,39000.0,-68.0,-73.0,-64.0,-71.0,-67.0,-73.0,-64.0,-71.0,-90.0,-92.0,-90.0,-93.0,22.0,19.0,26.0,22.0,1
2784,CC:2F:71:3F:1F:24,4095293,2873430923,1970607,2603783667,2124686,269647256,2604,1596419,2045272469,1595292,2045144629,1127,127840,1578464,6255,1970488,224482,2604,1868,86667.0,14444.0,-71.0,-64.0,-75.0,-71.0,-70.0,-63.0,-74.0,-70.0,-90.0,-92.0,-90.0,-93.0,19.0,28.0,15.0,22.0,1
2785,CC:2F:71:3E:C5:1F,5531606,4451908349,3406920,4182261093,2124686,269647256,502,93264,8005233,78655,6273731,14609,1731502,21560,533,3414323,870692,502,2930,13000.0,1000.0,-74.0,-72.0,-69.0,-62.0,-74.0,-74.0,-70.0,-62.0,-90.0,-92.0,-90.0,-93.0,16.0,20.0,21.0,31.0,1
2786,F8:59:71:5A:E0:3D,3488829,2313269040,1364141,2043621582,2124688,269647458,294,776243,950443440,775541,950358959,702,84481,764781,1840,1364271,169523,294,1165,144444.0,43333.0,-68.0,-73.0,-64.0,-71.0,-68.0,-73.0,-63.0,-71.0,-90.0,-92.0,-90.0,-93.0,22.0,19.0,26.0,22.0,1
2787,CC:2F:71:3F:1F:24,4095452,2873635327,1970764,2603987869,2124688,269647458,2604,1596561,2045468013,1595434,2045340173,1127,127840,1578606,6255,1970645,224482,2604,1868,86667.0,14444.0,-71.0,-64.0,-74.0,-71.0,-70.0,-64.0,-74.0,-71.0,-90.0,-92.0,-90.0,-93.0,19.0,28.0,16.0,22.0,1
2788,CC:2F:71:3E:C5:1F,5531608,4451908551,3406920,4182261093,2124688,269647458,502,93264,8005233,78655,6273731,14609,1731502,21560,533,3414323,870692,502,2930,13000.0,1000.0,-74.0,-72.0,-69.0,-62.0,-74.0,-74.0,-70.0,-62.0,-90.0,-92.0,-90.0,-93.0,16.0,20.0,21.0,31.0,1
2789,F8:59:71:5A:E0:3D,3488969,2313446422,1364276,2043798500,2124693,269647922,294,776328,950546223,775626,950461742,702,84481,764866,1840,1364406,169549,294,1165,144444.0,43333.0,-68.0,-74.0,-64.0,-72.0,-68.0,-73.0,-64.0,-71.0,-90.0,-92.0,-90.0,-93.0,22.0,18.0,26.0,21.0,1
2790,CC:2F:71:3F:1F:24,4095620,2873846131,1970925,2604198007,2124695,269648124,2604,1596708,2045669861,1595581,2045542021,1127,127840,1578753,6255,1970806,224501,2604,1869,78000.0,13000.0,-77.0,-70.0,-79.0,-77.0,-77.0,-70.0,-79.0,-77.0,-90.0,-92.0,-90.0,-93.0,13.0,22.0,11.0,16.0,1
2791,CC:2F:71:3E:C5:1F,5531615,4451909217,3406920,4182261093,2124695,269648124,502,93264,8005233,78655,6273731,14609,1731502,21560,533,3414323,870692,502,2930,13000.0,1000.0,-74.0,-72.0,-69.0,-62.0,-74.0,-74.0,-70.0,-62.0,-90.0,-92.0,-90.0,-93.0,16.0,20.0,21.0,31.0,1
2792,F8:59:71:5A:E0:3D,3489037,2313546282,1364340,2043897956,2124697,269648326,294,776393,950646323,775691,950561842,702,84481,764931,1840,1364470,169549,294,1165,144444.0,43333.0,-68.0,-73.0,-64.0,-71.0,-68.0,-73.0,-64.0,-71.0,-90.0,-92.0,-90.0,-93.0,22.0,19.0,26.0,22.0,1
2793,CC:2F:71:3F:1F:24,4096032,2874404206,1971335,2604755880,2124697,269648326,2604,1596900,2045875333,1595773,2045747493,1127,127840,1578944,6255,1971215,224501,2604,1869,86667.0,14444.0,-77.0,-70.0,-80.0,-77.0,-76.0,-69.0,-78.0,-76.0,-90.0,-92.0,-90.0,-93.0,13.0,22.0,10.0,16.0,1
2794,CC:2F:71:3E:C5:1F,5531617,4451909419,3406920,4182261093,2124697,269648326,502,93264,8005233,78655,6273731,14609,1731502,21560,533,3414323,870692,502,2930,13000.0,1000.0,-74.0,-72.0,-69.0,-62.0,-74.0,-74.0,-70.0,-62.0,-90.0,-92.0,-90.0,-93.0,16.0,20.0,21.0,31.0,1
2795,F8:59:71:5A:E0:3D,3489103,2313644659,1364403,2043995858,2124700,269648801,294,776455,950741803,775753,950657322,702,84481,764993,1840,1364533,169549,294,1165,144444.0,43333.0,-68.0,-73.0,-64.0,-71.0,-68.0,-73.0,-64.0,-71.0,-90.0,-92.0,-90.0,-93.0,22.0,19.0,26.0,22.0,1
2796,CC:2F:71:3F:1F:24,4096193,2874607531,1971491,2604958528,2124702,269649003,2604,1597043,2046072431,1595916,2045944591,1127,127840,1579086,6255,1971372,224501,2604,1869,86667.0,14444.0,-71.0,-64.0,-74.0,-71.0,-76.0,-69.0,-79.0,-76.0,-90.0,-92.0,-90.0,-93.0,19.0,28.0,16.0,22.0,1
2797,CC:2F:71:3E:C5:1F,5531624,4451910298,3406920,4182261093,2124704,269649205,502,93264,8005233,78655,6273731,14609,1731502,21560,533,3414323,870692,502,2930,13000.0,1000.0,-74.0,-72.0,-69.0,-62.0,-74.0,-74.0,-70.0,-62.0,-90.0,-92.0,-90.0,-93.0,16.0,20.0,21.0,31.0,1
2798,F8:59:71:5A:E0:3D,3489172,2313741673,1364465,2044092206,2124707,269649467,294,776518,950838823,775816,950754342,702,84481,765056,1840,1364595,169549,294,1165,144444.0,43333.0,-68.0,-73.0,-64.0,-71.0,-68.0,-73.0,-64.0,-71.0,-90.0,-92.0,-90.0,-93.0,22.0,19.0,26.0,22.0,1
2799,CC:2F:71:3F:1F:24,4096356,2874813527,1971649,2605164060,2124707,269649467,2604,1597187,2046269631,1596060,2046141791,1127,127840,1579230,6255,1971530,224515,2604,1869,86667.0,14444.0,-77.0,-70.0,-80.0,-77.0,-77.0,-70.0,-79.0,-77.0,-90.0,-92.0,-90.0,-93.0,13.0,22.0,10.0,16.0,1
2800,CC:2F:71:3E:C5:1F,5531627,4451910560,3406920,4182261093,2124707,269649467,502,93264,8005233,78655,6273731,14609,1731502,21560,533,3414323,870692,502,2930,13000.0,1000.0,-74.0,-72.0,-69.0,-62.0,-74.0,-74.0,-70.0,-62.0,-90.0,-92.0,-90.0,-93.0,16.0,20.0,21.0,31.0,1
2801,F8:59:71:5A:E0:3D,3489242,2313840550,1364533,2044190881,2124709,269649669,294,776583,950935902,775881,950851421,702,84481,765121,1840,1364663,169551,294,1165,144444.0,43333.0,-68.0,-73.0,-64.0,-71.0,-68.0,-73.0,-64.0,-71.0,-90.0,-92.0,-90.0,-93.0,22.0,19.0,26.0,22.0,1
2802,CC:2F:71:3F:1F:24,4096531,2875020848,1971822,2605371179,2124709,269649669,2604,1597342,2046469284,1596215,2046341444,1127,127840,1579384,6255,1971703,224515,2604,1870,86667.0,14444.0,-71.0,-64.0,-74.0,-71.0,-71.0,-64.0,-74.0,-71.0,-90.0,-92.0,-90.0,-93.0,19.0,28.0,16.0,22.0,1
2803,CC:2F:71:3E:C5:1F,5531630,4451910822,3406921,4182261153,2124709,269649669,502,93266,8005373,78657,6273871,14609,1731502,21560,533,3414324,870692,502,2930,13000.0,1000.0,-73.0,-72.0,-69.0,-62.0,-74.0,-74.0,-69.0,-62.0,-90.0,-92.0,-90.0,-93.0,17.0,20.0,21.0,31.0,1
2804,F8:59:71:5A:E0:3D,3489425,2314116663,1364712,2044466590,2124713,269650073,294,776661,951037927,775959,950953446,702,84481,765199,1840,1364841,169551,294,1165,144444.0,43333.0,-68.0,-73.0,-64.0,-71.0,-68.0,-73.0,-63.0,-71.0,-90.0,-92.0,-90.0,-93.0,22.0,19.0,26.0,22.0,1
2805,CC:2F:71:3F:1F:24,4096693,2875227008,1971980,2605576935,2124713,269650073,2604,1597488,2046668154,1596361,2046540314,1127,127840,1579529,6255,1971860,224515,2604,1870,86667.0,14444.0,-71.0,-64.0,-74.0,-71.0,-70.0,-64.0,-73.0,-71.0,-90.0,-92.0,-90.0,-93.0,19.0,28.0,16.0,22.0,1
2806,CC:2F:71:3E:C5:1F,5531634,4451911226,3406921,4182261153,2124713,269650073,502,93266,8005373,78657,6273871,14609,1731502,21560,533,3414324,870692,502,2930,13000.0,1000.0,-73.0,-72.0,-69.0,-62.0,-74.0,-74.0,-69.0,-62.0,-90.0,-92.0,-90.0,-93.0,17.0,20.0,21.0,31.0,1
2807,F8:59:71:5A:E0:3D,3489490,2314213273,1364774,2044562938,2124716,269650335,294,776724,951134947,776022,951050466,702,84481,765262,1840,1364904,169551,294,1165,144444.0,43333.0,-68.0,-73.0,-64.0,-71.0,-68.0,-73.0,-63.0,-71.0,-90.0,-92.0,-90.0,-93.0,22.0,19.0,26.0,22.0,1
2808,CC:2F:71:3F:1F:24,4096856,2875433116,1972138,2605782579,2124718,269650537,2604,1597632,2046865354,1596505,2046737514,1127,127840,1579673,6255,1972019,224551,2604,1870,86667.0,14444.0,-71.0,-64.0,-74.0,-71.0,-71.0,-64.0,-74.0,-71.0,-90.0,-92.0,-90.0,-93.0,19.0,28.0,16.0,22.0,1
2809,CC:2F:71:3E:C5:1F,5531639,4451911690,3406921,4182261153,2124718,269650537,502,93266,8005373,78657,6273871,14609,1731502,21560,533,3414324,870692,502,2930,13000.0,1000.0,-73.0,-72.0,-69.0,-62.0,-74.0,-74.0,-69.0,-62.0,-90.0,-92.0,-90.0,-93.0,17.0,20.0,21.0,31.0,1
2810,F8:59:71:5A:E0:3D,3489559,2314311781,1364837,2044660840,2124722,269650941,294,776787,951231967,776085,951147486,702,84481,765325,1840,1364967,169551,294,1165,144444.0,43333.0,-68.0,-73.0,-64.0,-71.0,-68.0,-73.0,-64.0,-71.0,-90.0,-92.0,-90.0,-93.0,22.0,19.0,26.0,22.0,1
2811,CC:2F:71:3F:1F:24,4097062,2875689337,1972340,2606038396,2124722,269650941,2604,1597797,2047068824,1596670,2046940984,1127,127840,1579838,6255,1972221,224551,2604,1870,86667.0,14444.0,-71.0,-63.0,-74.0,-70.0,-70.0,-63.0,-73.0,-70.0,-90.0,-92.0,-90.0,-93.0,19.0,29.0,16.0,23.0,1
2812,CC:2F:71:3E:C5:1F,5531643,4451912094,3406921,4182261153,2124722,269650941,502,93266,8005373,78657,6273871,14609,1731502,21560,533,3414324,870692,502,2930,13000.0,1000.0,-73.0,-72.0,-69.0,-62.0,-74.0,-74.0,-69.0,-62.0,-90.0,-92.0,-90.0,-93.0,17.0,20.0,21.0,31.0,1
2813,F8:59:71:5A:E0:3D,3489812,2314686844,1365088,2045035701,2124724,269651143,294,776903,951342926,776201,951258445,702,84481,765440,1840,1365218,169594,294,1165,144444.0,43333.0,-69.0,-74.0,-65.0,-72.0,-69.0,-74.0,-65.0,-72.0,-90.0,-92.0,-90.0,-93.0,21.0,18.0,25.0,21.0,1
2814,CC:2F:71:3F:1F:24,4097193,2875836387,1972468,2606185184,2124725,269651203,2604,1597909,2047208634,1596782,2047080794,1127,127840,1579950,6255,1972349,224554,2604,1870,104000.0,26000.0,-70.0,-64.0,-74.0,-71.0,-72.0,-65.0,-75.0,-72.0,-90.0,-92.0,-90.0,-93.0,20.0,28.0,16.0,22.0,1
2815,CC:2F:71:3E:C5:1F,5531646,4451912356,3406921,4182261153,2124725,269651203,502,93266,8005373,78657,6273871,14609,1731502,21560,533,3414324,870692,502,2930,13000.0,1000.0,-73.0,-72.0,-69.0,-62.0,-74.0,-74.0,-69.0,-62.0,-90.0,-92.0,-90.0,-93.0,17.0,20.0,21.0,31.0,1
2816,F8:59:71:5A:E0:3D,3489890,2314785165,1365157,2045133232,2124733,269651933,294,776980,951441843,776278,951357362,702,84481,765517,1840,1365287,169594,294,1165,144444.0,43333.0,-69.0,-74.0,-65.0,-72.0,-68.0,-74.0,-64.0,-71.0,-90.0,-92.0,-90.0,-93.0,21.0,18.0,25.0,21.0,1
2817,CC:2F:71:3F:1F:24,4097297,2875945486,1972564,2606293553,2124733,269651933,2604,1597994,2047309280,1596866,2047181322,1128,127958,1580035,6255,1972445,224582,2604,1870,86667.0,14444.0,-70.0,-63.0,-73.0,-70.0,-70.0,-63.0,-73.0,-70.0,-90.0,-92.0,-90.0,-93.0,20.0,29.0,17.0,23.0,1
2818,CC:2F:71:3E:C5:1F,5531654,4451913086,3406921,4182261153,2124733,269651933,502,93268,8005561,78658,6273941,14610,1731620,21561,533,3414324,870692,502,2930,13000.0,1000.0,-74.0,-73.0,-69.0,-61.0,-73.0,-73.0,-69.0,-62.0,-90.0,-92.0,-90.0,-93.0,16.0,19.0,21.0,32.0,1
2819,F8:59:71:5A:E0:3D,3490141,2315136602,1365406,2045484467,2124735,269652135,294,777076,951546010,776374,951461529,702,84481,765613,1840,1365536,169594,294,1165,144444.0,43333.0,-72.0,-77.0,-68.0,-75.0,-72.0,-77.0,-68.0,-75.0,-90.0,-92.0,-90.0,-93.0,18.0,15.0,22.0,18.0,1
2820,CC:2F:71:3F:1F:24,4097394,2876053766,1972659,2606401631,2124735,269652135,2604,1598077,2047409692,1596949,2047281734,1128,127958,1580118,6255,1972540,224582,2604,1870,86667.0,14444.0,-74.0,-67.0,-77.0,-74.0,-73.0,-67.0,-77.0,-74.0,-90.0,-92.0,-90.0,-93.0,16.0,25.0,13.0,19.0,1
2821,CC:2F:71:3E:C5:1F,5531656,4451913288,3406921,4182261153,2124735,269652135,502,93268,8005561,78658,6273941,14610,1731620,21561,533,3414324,870692,502,2930,13000.0,1000.0,-74.0,-73.0,-69.0,-61.0,-73.0,-73.0,-69.0,-62.0,-90.0,-92.0,-90.0,-93.0,16.0,19.0,21.0,32.0,1
2822,F8:59:71:5A:E0:3D,3490213,2315236980,1365473,2045584381,2124740,269652599,294,777144,951646925,776442,951562444,702,84481,765681,1840,1365603,169594,294,1165,144444.0,43333.0,-72.0,-78.0,-68.0,-76.0,-72.0,-77.0,-68.0,-75.0,-90.0,-92.0,-90.0,-93.0,18.0,14.0,22.0,17.0,1
2823,CC:2F:71:3F:1F:24,4097516,2876167930,1972774,2606515129,2124742,269652801,2604,1598172,2047515940,1597044,2047387982,1128,127958,1580213,6255,1972655,224587,2604,1870,115556.0,26000.0,-74.0,-67.0,-77.0,-74.0,-74.0,-67.0,-77.0,-74.0,-90.0,-92.0,-90.0,-93.0,16.0,25.0,13.0,19.0,1
2824,CC:2F:71:3E:C5:1F,5531663,4451913954,3406921,4182261153,2124742,269652801,502,93268,8005561,78658,6273941,14610,1731620,21561,533,3414324,870692,502,2930,13000.0,1000.0,-74.0,-73.0,-69.0,-61.0,-73.0,-73.0,-69.0,-62.0,-90.0,-92.0,-90.0,-93.0,16.0,19.0,21.0,32.0,1
2825,F8:59:71:5A:E0:3D,3490310,2315375106,1365566,2045722103,2124744,269653003,294,777218,951751695,776516,951667214,702,84481,765755,1840,1365696,169594,294,1165,144444.0,43333.0,-72.0,-77.0,-68.0,-75.0,-71.0,-76.0,-67.0,-74.0,-90.0,-92.0,-90.0,-93.0,18.0,15.0,22.0,18.0,1
2826,CC:2F:71:3F:1F:24,4097613,2876275986,1972869,2606622983,2124744,269653003,2604,1598256,2047616468,1597128,2047488510,1128,127958,1580297,6255,1972750,224614,2604,1870,86667.0,14444.0,-74.0,-67.0,-77.0,-74.0,-74.0,-67.0,-76.0,-74.0,-90.0,-92.0,-90.0,-93.0,16.0,25.0,13.0,19.0,1
2827,CC:2F:71:3E:C5:1F,5531665,4451914156,3406921,4182261153,2124744,269653003,502,93268,8005561,78658,6273941,14610,1731620,21561,533,3414324,870692,502,2930,13000.0,1000.0,-74.0,-73.0,-69.0,-61.0,-73.0,-73.0,-69.0,-62.0,-90.0,-92.0,-90.0,-93.0,16.0,19.0,21.0,32.0,1
2828,F8:59:71:5A:E0:3D,3490387,2315488952,1365639,2045835545,2124748,269653407,294,777291,951864115,776589,951779634,702,84481,765828,1840,1365769,169594,294,1165,144444.0,43333.0,-72.0,-77.0,-68.0,-75.0,-71.0,-76.0,-67.0,-74.0,-90.0,-92.0,-90.0,-93.0,18.0,15.0,22.0,18.0,1
2829,CC:2F:71:3F:1F:24,4097739,2876422156,1972988,2606768485,2124751,269653671,2604,1598376,2047754854,1597248,2047626896,1128,127958,1580406,6255,1972869,224614,2604,1870,86667.0,14444.0,-81.0,-77.0,-83.0,-82.0,-76.0,-70.0,-78.0,-76.0,-90.0,-92.0,-90.0,-93.0,9.0,15.0,7.0,11.0,1
2830,CC:2F:71:3E:C5:1F,5531672,4451914824,3406921,4182261153,2124751,269653671,502,93268,8005561,78658,6273941,14610,1731620,21561,533,3414324,870692,502,2930,13000.0,1000.0,-74.0,-73.0,-69.0,-61.0,-73.0,-73.0,-69.0,-62.0,-90.0,-92.0,-90.0,-93.0,16.0,19.0,21.0,32.0,1
2831,F8:59:71:5A:E0:3D,3490474,2315613967,1365720,2045960034,2124754,269653933,294,777373,951986164,776670,951901565,703,84599,765910,1840,1365850,169594,294,1165,144444.0,43333.0,-72.0,-77.0,-68.0,-75.0,-72.0,-77.0,-68.0,-75.0,-90.0,-92.0,-90.0,-93.0,18.0,15.0,22.0,18.0,1
2832,CC:2F:71:3F:1F:24,4097839,2876534972,1973085,2606881039,2124754,269653933,2604,1598468,2047858744,1597340,2047730786,1128,127958,1580489,6255,1972966,224626,2604,1870,104000.0,26000.0,-71.0,-64.0,-74.0,-71.0,-78.0,-72.0,-81.0,-79.0,-90.0,-92.0,-90.0,-93.0,19.0,28.0,16.0,22.0,1
2833,CC:2F:71:3E:C5:1F,5531675,4451915086,3406921,4182261153,2124754,269653933,502,93268,8005561,78658,6273941,14610,1731620,21561,533,3414324,870692,502,2930,13000.0,1000.0,-74.0,-73.0,-69.0,-61.0,-73.0,-73.0,-69.0,-62.0,-90.0,-92.0,-90.0,-93.0,16.0,19.0,21.0,32.0,1
2834,F8:59:71:5A:E0:3D,3490540,2315710719,1365782,2046056382,2124758,269654337,294,777436,952083184,776733,951998585,703,84599,765973,1840,1365912,169594,294,1165,144444.0,43333.0,-72.0,-77.0,-68.0,-75.0,-72.0,-77.0,-67.0,-75.0,-90.0,-92.0,-90.0,-93.0,18.0,15.0,22.0,18.0,1
2835,CC:2F:71:3F:1F:24,4097993,2876662349,1973233,2607007810,2124760,269654539,2604,1598601,2047977492,1597473,2047849534,1128,127958,1580622,6255,1973112,224636,2604,1870,115556.0,28889.0,-70.0,-63.0,-73.0,-70.0,-70.0,-63.0,-73.0,-70.0,-90.0,-92.0,-90.0,-93.0,20.0,29.0,17.0,23.0,1
2836,CC:2F:71:3E:C5:1F,5531681,4451915692,3406921,4182261153,2124760,269654539,502,93268,8005561,78658,6273941,14610,1731620,21561,533,3414324,870692,502,2930,13000.0,1000.0,-74.0,-73.0,-69.0,-61.0,-73.0,-73.0,-69.0,-62.0,-90.0,-92.0,-90.0,-93.0,16.0,19.0,21.0,32.0,1
2837,F8:59:71:5A:E0:3D,3490832,2316158892,1366069,2046503878,2124763,269655014,294,777543,952194319,776840,952109720,703,84599,766080,1840,1366199,169612,294,1165,144444.0,43333.0,-68.0,-73.0,-64.0,-71.0,-68.0,-73.0,-64.0,-71.0,-90.0,-92.0,-90.0,-93.0,22.0,19.0,26.0,22.0,1
2838,CC:2F:71:3F:1F:24,4098093,2876775322,1973330,2607120308,2124763,269655014,2604,1598687,2048082524,1597559,2047954566,1128,127958,1580708,6255,1973211,224665,2604,1870,115556.0,28889.0,-73.0,-67.0,-77.0,-74.0,-71.0,-64.0,-74.0,-71.0,-90.0,-92.0,-90.0,-93.0,17.0,25.0,13.0,19.0,1
2839,CC:2F:71:3E:C5:1F,5531684,4451916167,3406921,4182261153,2124763,269655014,502,93268,8005561,78658,6273941,14610,1731620,21561,533,3414324,870692,502,2930,13000.0,1000.0,-74.0,-73.0,-69.0,-61.0,-73.0,-73.0,-69.0,-62.0,-90.0,-92.0,-90.0,-93.0,16.0,19.0,21.0,32.0,1
2840,F8:59:71:5A:E0:3D,3491204,2316689583,1366436,2047034105,2124768,269655478,294,777654,952301542,776951,952216943,703,84599,766191,1840,1366566,169612,294,1165,144444.0,43333.0,-68.0,-74.0,-64.0,-71.0,-68.0,-73.0,-63.0,-71.0,-90.0,-92.0,-90.0,-93.0,22.0,18.0,26.0,22.0,1
2841,CC:2F:71:3F:1F:24,4098204,2876889304,1973436,2607233826,2124768,269655478,2604,1598778,2048187103,1597650,2048059145,1128,127958,1580799,6255,1973317,224677,2604,1870,115556.0,28889.0,-74.0,-67.0,-76.0,-74.0,-74.0,-67.0,-76.0,-74.0,-90.0,-92.0,-90.0,-93.0,16.0,25.0,14.0,19.0,1
2842,CC:2F:71:3E:C5:1F,5531691,4451916833,3406921,4182261153,2124770,269655680,502,93268,8005561,78658,6273941,14610,1731620,21561,533,3414324,870692,502,2930,13000.0,1000.0,-74.0,-73.0,-69.0,-61.0,-73.0,-73.0,-69.0,-62.0,-90.0,-92.0,-90.0,-93.0,16.0,19.0,21.0,32.0,1
2843,F8:59:71:5A:E0:3D,3491388,2316972467,1366618,2047316787,2124770,269655680,294,777734,952403771,777031,952319172,703,84599,766271,1840,1366748,169612,294,1165,144444.0,43333.0,-68.0,-73.0,-64.0,-71.0,-68.0,-73.0,-64.0,-71.0,-90.0,-92.0,-90.0,-93.0,22.0,19.0,26.0,22.0,1
2844,CC:2F:71:3F:1F:24,4098299,2876997324,1973529,2607341644,2124770,269655680,2604,1598857,2048285627,1597729,2048157669,1128,127958,1580878,6255,1973409,224711,2604,1870,104000.0,26000.0,-74.0,-67.0,-77.0,-74.0,-74.0,-67.0,-76.0,-74.0,-90.0,-92.0,-90.0,-93.0,16.0,25.0,13.0,19.0,1
2845,CC:2F:71:3E:C5:1F,5531693,4451917035,3406921,4182261153,2124772,269655882,502,93268,8005561,78658,6273941,14610,1731620,21561,533,3414324,870692,502,2930,13000.0,1000.0,-74.0,-73.0,-69.0,-61.0,-73.0,-73.0,-69.0,-62.0,-90.0,-92.0,-90.0,-93.0,16.0,19.0,21.0,32.0,1
2846,F8:59:71:5A:E0:3D,3491462,2317070340,1366686,2047414054,2124776,269656286,294,777801,952501242,777098,952416643,703,84599,766338,1840,1366816,169612,294,1165,144444.0,43333.0,-68.0,-73.0,-64.0,-71.0,-68.0,-73.0,-64.0,-71.0,-90.0,-92.0,-90.0,-93.0,22.0,19.0,26.0,22.0,1
2847,CC:2F:71:3F:1F:24,4098399,2877104608,1973622,2607448262,2124777,269656346,2604,1598937,2048387129,1597809,2048259171,1128,127958,1580957,6255,1973503,224717,2604,1870,115556.0,28889.0,-73.0,-67.0,-74.0,-73.0,-73.0,-67.0,-75.0,-73.0,-90.0,-92.0,-90.0,-93.0,17.0,25.0,16.0,20.0,1
2848,CC:2F:71:3E:C5:1F,5531698,4451917499,3406921,4182261153,2124777,269656346,502,93268,8005561,78658,6273941,14610,1731620,21561,533,3414324,870692,502,2930,13000.0,1000.0,-74.0,-73.0,-69.0,-61.0,-73.0,-73.0,-69.0,-62.0,-90.0,-92.0,-90.0,-93.0,16.0,19.0,21.0,32.0,1
2849,F8:59:71:5A:E0:3D,3491499,2317112459,1366720,2047455911,2124779,269656548,294,777835,952542676,777132,952458077,703,84599,766371,1840,1366850,169612,294,1165,144444.0,43333.0,-67.0,-72.0,-62.0,-71.0,-67.0,-72.0,-63.0,-71.0,-90.0,-92.0,-90.0,-93.0,23.0,20.0,28.0,22.0,1
2850,CC:2F:71:3F:1F:24,4098460,2877147840,1973681,2607491292,2124779,269656548,2604,1598983,2048422384,1597855,2048294426,1128,127958,1581002,6255,1973562,224735,2604,1870,115556.0,28889.0,-74.0,-67.0,-77.0,-74.0,-73.0,-67.0,-77.0,-74.0,-90.0,-92.0,-90.0,-93.0,16.0,25.0,13.0,19.0,1
2851,CC:2F:71:3E:C5:1F,5531700,4451917701,3406921,4182261153,2124779,269656548,502,93268,8005561,78658,6273941,14610,1731620,21561,533,3414324,870692,502,2930,13000.0,1000.0,-74.0,-73.0,-69.0,-61.0,-73.0,-73.0,-69.0,-62.0,-90.0,-92.0,-90.0,-93.0,16.0,19.0,21.0,32.0,1
2852,F8:59:71:5A:E0:3D,3491501,2317112661,1366720,2047455911,2124781,269656750,294,777835,952542676,777132,952458077,703,84599,766371,1840,1366850,169612,294,1165,144444.0,43333.0,-67.0,-72.0,-62.0,-71.0,-67.0,-72.0,-63.0,-71.0,-90.0,-92.0,-90.0,-93.0,23.0,20.0,28.0,22.0,1
2853,CC:2F:71:3F:1F:24,4098493,2877158328,1973712,2607501578,2124781,269656750,2604,1599003,2048425730,1597875,2048297772,1128,127958,1581021,6255,1973593,224761,2604,1870,104000.0,26000.0,-73.0,-67.0,-74.0,-76.0,-73.0,-66.0,-74.0,-75.0,-90.0,-92.0,-90.0,-93.0,17.0,25.0,16.0,17.0,1
2854,CC:2F:71:3E:C5:1F,5531705,4451918239,3406921,4182261153,2124784,269657086,502,93270,8005701,78660,6274081,14610,1731620,21561,533,3414325,870692,502,2930,13000.0,1000.0,-74.0,-73.0,-69.0,-61.0,-73.0,-72.0,-69.0,-61.0,-90.0,-92.0,-90.0,-93.0,16.0,19.0,21.0,32.0,1
2855,F8:59:71:5A:E0:3D,3491508,2317113327,1366720,2047455911,2124788,269657416,294,777835,952542676,777132,952458077,703,84599,766371,1840,1366850,169612,294,1165,144444.0,43333.0,-67.0,-72.0,-62.0,-71.0,-67.0,-72.0,-63.0,-71.0,-90.0,-92.0,-90.0,-93.0,23.0,20.0,28.0,22.0,1
2856,CC:2F:71:3F:1F:24,4098532,2877169466,1973744,2607512050,2124788,269657416,2604,1599022,2048428960,1597894,2048301002,1128,127958,1581039,6255,1973625,224800,2604,1870,115556.0,26000.0,-77.0,-70.0,-78.0,-79.0,-76.0,-69.0,-77.0,-78.0,-90.0,-92.0,-90.0,-93.0,13.0,22.0,12.0,14.0,1
2857,CC:2F:71:3E:C5:1F,5531709,4451918569,3406921,4182261153,2124788,269657416,502,93270,8005701,78660,6274081,14610,1731620,21561,533,3414325,870692,502,2930,13000.0,1000.0,-74.0,-73.0,-69.0,-61.0,-73.0,-72.0,-69.0,-61.0,-90.0,-92.0,-90.0,-93.0,16.0,19.0,21.0,32.0,1
