sample,station,tx_total_pkts,tx_total_bytes,tx_ucast_pkts,tx_ucast_bytes,tx_mcast_bcast_pkts,tx_mcast_bcast_bytes,tx_failures,rx_data_pkts,rx_data_bytes,rx_ucast_pkts,rx_ucast_bytes,rx_mcast_bcast_pkts,rx_mcast_bcast_bytes,rx_decrypt_succeeds,tx_data_pkts_retried,tx_total_pkts_sent,tx_pkts_retries,tx_pkts_retry_exhausted,rx_total_pkts_retried,rate_last_tx_pkt_min,rate_last_tx_pkt_max,per_antenna_rssi_last_rx_data_frame_1,per_antenna_rssi_last_rx_data_frame_2,per_antenna_rssi_last_rx_data_frame_3,per_antenna_rssi_last_rx_data_frame_4,per_antenna_avg_rssi_rx_data_frames_1,per_antenna_avg_rssi_rx_data_frames_2,per_antenna_avg_rssi_rx_data_frames_3,per_antenna_avg_rssi_rx_data_frames_4,per_antenna_noise_floor_1,per_antenna_noise_floor_2,per_antenna_noise_floor_3,per_antenna_noise_floor_4,sinr_per_antenna_1,sinr_per_antenna_2,sinr_per_antenna_3,sinr_per_antenna_4,attack
1,F8:59:71:5A:E0:3D,2151965,276129447,2436,3428265,2149529,272701182,0,1532,1726311,1494,1719254,38,7057,1512,2,2447,599,0,4,144444.0,43333.0,-69.0,-73.0,-65.0,-69.0,-68.0,-73.0,-65.0,-69.0,-90.0,-92.0,-90.0,-93.0,21.0,19.0,25.0,24.0,1
2,CC:2F:71:3E:C5:1F,2149570,272706210,41,5028,2149529,272701182,0,181,15460,155,12280,26,3180,45,1,68,2,0,7,130000.0,39000.0,-71.0,-69.0,-68.0,-60.0,-71.0,-69.0,-67.0,-60.0,-90.0,-92.0,-90.0,-93.0,19.0,23.0,22.0,33.0,1
3,CC:2F:71:3F:1F:24,2209029,352516503,59500,79815321,2149529,272701182,3,34219,35184582,34172,35178490,47,6092,33186,138,59521,14752,3,42,144444.0,43333.0,-71.0,-64.0,-75.0,-71.0,-72.0,-65.0,-76.0,-72.0,-90.0,-92.0,-90.0,-93.0,19.0,28.0,15.0,22.0,1
4,F8:59:71:5A:E0:3D,2152038,276233446,2503,3531500,2149535,272701946,0,1588,1811161,1550,1804104,38,7057,1568,2,2514,600,0,4,144444.0,43333.0,-66.0,-71.0,-63.0,-69.0,-68.0,-72.0,-65.0,-69.0,-90.0,-92.0,-90.0,-93.0,24.0,21.0,27.0,24.0,1
5,CC:2F:71:3E:C5:1F,2149576,272706974,41,5028,2149535,272701946,0,181,15460,155,12280,26,3180,45,1,68,2,0,7,130000.0,39000.0,-71.0,-69.0,-68.0,-60.0,-71.0,-69.0,-67.0,-60.0,-90.0,-92.0,-90.0,-93.0,19.0,23.0,22.0,33.0,1
6,CC:2F:71:3F:1F:24,2209638,353340407,60102,80638393,2149536,272702014,3,34429,35416251,34382,35410159,47,6092,33396,138,60123,15046,3,43,144444.0,43333.0,-68.0,-64.0,-69.0,-71.0,-67.0,-63.0,-68.0,-70.0,-90.0,-92.0,-90.0,-93.0,22.0,28.0,21.0,22.0,1
7,F8:59:71:5A:E0:3D,2152109,276336482,2569,3634064,2149540,272702418,0,1666,1931519,1628,1924462,38,7057,1646,2,2580,607,0,5,144444.0,43333.0,-65.0,-71.0,-65.0,-69.0,-65.0,-71.0,-64.0,-68.0,-89.0,-92.0,-89.0,-93.0,24.0,21.0,24.0,24.0,1
8,CC:2F:71:3E:C5:1F,2149583,272707656,41,5028,2149542,272702628,0,181,15460,155,12280,26,3180,45,1,68,2,0,7,130000.0,39000.0,-71.0,-69.0,-68.0,-60.0,-71.0,-69.0,-67.0,-60.0,-89.0,-92.0,-89.0,-93.0,18.0,23.0,21.0,33.0,1
9,CC:2F:71:3F:1F:24,2209810,353550770,60268,80848142,2149542,272702628,3,34580,35614754,34533,35608662,47,6092,33547,138,60289,15072,3,43,130000.0,43333.0,-67.0,-63.0,-68.0,-69.0,-66.0,-63.0,-68.0,-69.0,-89.0,-92.0,-89.0,-93.0,22.0,29.0,21.0,24.0,1
10,F8:59:71:5A:E0:3D,2152177,276437762,2634,3735074,2149543,272702688,0,1732,2030401,1692,2023022,40,7379,1712,2,2645,610,0,5,144444.0,43333.0,-67.0,-73.0,-64.0,-68.0,-66.0,-71.0,-63.0,-68.0,-89.0,-92.0,-89.0,-93.0,22.0,19.0,25.0,25.0,1
11,CC:2F:71:3E:C5:1F,2149586,272707918,41,5028,2149545,272702890,0,181,15460,155,12280,26,3180,45,1,68,2,0,7,130000.0,39000.0,-71.0,-69.0,-68.0,-60.0,-71.0,-69.0,-67.0,-60.0,-89.0,-92.0,-89.0,-93.0,18.0,23.0,21.0,33.0,1
12,CC:2F:71:3F:1F:24,2209975,353763300,60430,81060410,2149545,272702890,3,34728,35818126,34681,35812034,47,6092,33695,138,60451,15133,3,43,130000.0,39000.0,-66.0,-63.0,-67.0,-69.0,-66.0,-63.0,-68.0,-69.0,-89.0,-92.0,-89.0,-93.0,23.0,29.0,22.0,24.0,1
13,F8:59:71:5A:E0:3D,2152255,276537771,2704,3834275,2149551,272703496,0,1800,2130044,1760,2122665,40,7379,1780,2,2715,618,0,5,144444.0,43333.0,-65.0,-72.0,-65.0,-68.0,-65.0,-71.0,-64.0,-68.0,-89.0,-92.0,-89.0,-93.0,24.0,20.0,24.0,25.0,1
14,CC:2F:71:3E:C5:1F,2149592,272708524,41,5028,2149551,272703496,0,181,15460,155,12280,26,3180,45,1,68,2,0,7,130000.0,39000.0,-71.0,-69.0,-68.0,-60.0,-71.0,-69.0,-67.0,-60.0,-89.0,-92.0,-89.0,-93.0,18.0,23.0,21.0,33.0,1
15,CC:2F:71:3F:1F:24,2210139,353969942,60588,81266446,2149551,272703496,3,34871,36015210,34824,36009118,47,6092,33838,138,60609,15167,3,43,130000.0,43333.0,-66.0,-63.0,-68.0,-70.0,-66.0,-63.0,-68.0,-70.0,-89.0,-92.0,-89.0,-93.0,23.0,29.0,21.0,23.0,1
16,F8:59:71:5A:E0:3D,2152532,276965212,2980,4261654,2149552,272703558,0,1888,2231860,1847,2224363,41,7497,1868,2,2991,646,0,5,144444.0,43333.0,-67.0,-72.0,-63.0,-69.0,-65.0,-71.0,-63.0,-68.0,-88.0,-91.0,-88.0,-92.0,21.0,19.0,25.0,23.0,1
17,CC:2F:71:3E:C5:1F,2149593,272708586,41,5028,2149552,272703558,0,181,15460,155,12280,26,3180,45,1,68,2,0,7,130000.0,39000.0,-71.0,-69.0,-68.0,-60.0,-71.0,-69.0,-67.0,-60.0,-88.0,-91.0,-88.0,-92.0,17.0,22.0,20.0,32.0,1
18,CC:2F:71:3F:1F:24,2210302,354176657,60750,81473099,2149552,272703558,3,35015,36211123,34968,36205031,47,6092,33982,138,60769,15223,3,43,130000.0,43333.0,-68.0,-64.0,-69.0,-71.0,-66.0,-63.0,-68.0,-70.0,-88.0,-91.0,-88.0,-92.0,20.0,27.0,19.0,21.0,1
19,F8:59:71:5A:E0:3D,2152601,277062226,3042,4358002,2149559,272704224,0,1951,2328880,1910,2321383,41,7497,1931,2,3053,658,0,5,144444.0,43333.0,-65.0,-71.0,-64.0,-68.0,-66.0,-71.0,-63.0,-68.0,-88.0,-91.0,-88.0,-92.0,23.0,20.0,24.0,24.0,1
20,CC:2F:71:3E:C5:1F,2149602,272709454,41,5028,2149561,272704426,0,181,15460,155,12280,26,3180,45,1,68,2,0,7,130000.0,39000.0,-71.0,-69.0,-68.0,-60.0,-71.0,-69.0,-67.0,-60.0,-88.0,-91.0,-88.0,-92.0,17.0,22.0,20.0,32.0,1
21,CC:2F:71:3F:1F:24,2210469,354383281,60908,81678855,2149561,272704426,3,35160,36411301,35113,36405209,47,6092,34126,138,60929,15254,3,43,130000.0,43333.0,-66.0,-63.0,-67.0,-69.0,-66.0,-63.0,-68.0,-69.0,-88.0,-91.0,-88.0,-92.0,22.0,28.0,21.0,23.0,1
22,F8:59:71:5A:E0:3D,2152700,277204909,3138,4500421,2149562,272704488,0,2023,2433482,1982,2425985,41,7497,2003,2,3149,675,0,5,144444.0,43333.0,-67.0,-71.0,-63.0,-69.0,-66.0,-71.0,-64.0,-68.0,-88.0,-91.0,-88.0,-92.0,21.0,20.0,25.0,23.0,1
23,CC:2F:71:3E:C5:1F,2149603,272709516,41,5028,2149562,272704488,0,181,15460,155,12280,26,3180,45,1,68,2,0,7,130000.0,39000.0,-71.0,-69.0,-68.0,-60.0,-71.0,-69.0,-67.0,-60.0,-88.0,-91.0,-88.0,-92.0,17.0,22.0,20.0,32.0,1
24,CC:2F:71:3F:1F:24,2210628,354588875,61066,81884387,2149562,272704488,3,35305,36610043,35257,36603833,48,6210,34271,138,61087,15367,3,43,117000.0,39000.0,-66.0,-63.0,-68.0,-70.0,-66.0,-63.0,-68.0,-70.0,-88.0,-91.0,-88.0,-92.0,22.0,28.0,20.0,22.0,1
25,F8:59:71:5A:E0:3D,2152869,277458038,3301,4752944,2149568,272705094,0,2100,2536868,2059,2529371,41,7497,2080,2,3312,677,0,5,144444.0,43333.0,-67.0,-74.0,-65.0,-69.0,-67.0,-73.0,-64.0,-69.0,-87.0,-90.0,-87.0,-91.0,20.0,16.0,22.0,22.0,1
26,CC:2F:71:3E:C5:1F,2149609,272710122,41,5028,2149568,272705094,0,181,15460,155,12280,26,3180,45,1,68,2,0,7,130000.0,39000.0,-71.0,-69.0,-68.0,-60.0,-71.0,-69.0,-67.0,-60.0,-87.0,-90.0,-87.0,-91.0,16.0,21.0,19.0,31.0,1
27,CC:2F:71:3F:1F:24,2211080,355192375,61512,82487281,2149568,272705094,3,35490,36815137,35442,36808927,48,6210,34456,138,61534,15377,3,43,130000.0,43333.0,-68.0,-64.0,-71.0,-70.0,-68.0,-64.0,-71.0,-70.0,-87.0,-90.0,-87.0,-91.0,19.0,26.0,16.0,21.0,1
28,F8:59:71:5A:E0:3D,2152935,277556202,3364,4850846,2149571,272705356,0,2162,2632348,2121,2624851,41,7497,2142,2,3375,677,0,5,144444.0,43333.0,-68.0,-73.0,-65.0,-69.0,-67.0,-72.0,-65.0,-68.0,-86.0,-90.0,-86.0,-91.0,18.0,17.0,21.0,22.0,1
29,CC:2F:71:3E:C5:1F,2149612,272710384,41,5028,2149571,272705356,0,181,15460,155,12280,26,3180,45,1,68,2,0,7,130000.0,39000.0,-71.0,-69.0,-68.0,-60.0,-71.0,-69.0,-67.0,-60.0,-86.0,-90.0,-86.0,-91.0,15.0,21.0,18.0,31.0,1
30,CC:2F:71:3F:1F:24,2211239,355395441,61667,82690023,2149572,272705418,3,35630,37009025,35582,37002815,48,6210,34596,138,61689,15420,3,43,130000.0,43333.0,-63.0,-64.0,-66.0,-70.0,-68.0,-64.0,-70.0,-70.0,-86.0,-90.0,-86.0,-91.0,23.0,26.0,20.0,21.0,1
31,F8:59:71:5A:E0:3D,2153010,277654261,3434,4948439,2149576,272705822,0,2232,2733125,2191,2725628,41,7497,2212,2,3445,677,0,5,144444.0,43333.0,-67.0,-73.0,-65.0,-69.0,-67.0,-72.0,-64.0,-69.0,-86.0,-90.0,-86.0,-91.0,19.0,17.0,21.0,22.0,1
32,CC:2F:71:3E:C5:1F,2149617,272710850,41,5028,2149576,272705822,0,183,15648,156,12350,27,3298,46,1,68,2,0,7,130000.0,39000.0,-70.0,-70.0,-67.0,-60.0,-70.0,-69.0,-67.0,-60.0,-86.0,-90.0,-86.0,-91.0,16.0,20.0,19.0,31.0,1
33,CC:2F:71:3F:1F:24,2211400,355599013,61822,82892989,2149578,272706024,3,35771,37203029,35723,37196819,48,6210,34737,138,61844,15420,3,43,130000.0,43333.0,-69.0,-64.0,-71.0,-68.0,-69.0,-64.0,-71.0,-68.0,-86.0,-90.0,-86.0,-91.0,17.0,26.0,15.0,23.0,1
34,F8:59:71:5A:E0:3D,2153077,277752567,3497,5046341,2149580,272706226,0,2294,2828605,2253,2821108,41,7497,2274,2,3508,677,0,5,144444.0,43333.0,-67.0,-73.0,-65.0,-69.0,-67.0,-72.0,-64.0,-69.0,-85.0,-89.0,-85.0,-90.0,18.0,16.0,20.0,21.0,1
35,CC:2F:71:3E:C5:1F,2149621,272711254,41,5028,2149580,272706226,0,183,15648,156,12350,27,3298,46,1,68,2,0,7,130000.0,39000.0,-70.0,-70.0,-67.0,-60.0,-70.0,-69.0,-67.0,-60.0,-85.0,-89.0,-85.0,-90.0,15.0,19.0,18.0,30.0,1
36,CC:2F:71:3F:1F:24,2211557,355802181,61977,83095955,2149580,272706226,3,35912,37397033,35864,37390823,48,6210,34878,138,61999,15420,3,43,130000.0,43333.0,-70.0,-64.0,-72.0,-70.0,-69.0,-64.0,-70.0,-70.0,-85.0,-89.0,-85.0,-90.0,15.0,25.0,13.0,20.0,1
37,F8:59:71:5A:E0:3D,2153142,277849177,3559,5142689,2149583,272706488,0,2356,2924085,2315,2916588,41,7497,2336,2,3570,677,0,5,144444.0,43333.0,-68.0,-73.0,-65.0,-70.0,-67.0,-72.0,-65.0,-69.0,-85.0,-89.0,-85.0,-90.0,17.0,16.0,20.0,20.0,1
38,CC:2F:71:3E:C5:1F,2149624,272711516,41,5028,2149583,272706488,0,183,15648,156,12350,27,3298,46,1,68,2,0,7,130000.0,39000.0,-70.0,-70.0,-67.0,-60.0,-70.0,-69.0,-67.0,-60.0,-85.0,-89.0,-85.0,-90.0,15.0,19.0,18.0,30.0,1
39,CC:2F:71:3F:1F:24,2211719,356008480,62136,83301992,2149583,272706488,3,36056,37594272,36008,37588062,48,6210,35022,138,62156,15422,3,43,144444.0,43333.0,-70.0,-64.0,-70.0,-70.0,-69.0,-64.0,-70.0,-69.0,-85.0,-89.0,-85.0,-90.0,15.0,25.0,15.0,20.0,1
40,F8:59:71:5A:E0:3D,2153210,277946131,3621,5239037,2149589,272707094,0,2419,3021105,2378,3013608,41,7497,2399,2,3632,678,0,5,144444.0,43333.0,-68.0,-73.0,-65.0,-70.0,-67.0,-72.0,-65.0,-70.0,-85.0,-89.0,-85.0,-90.0,17.0,16.0,20.0,20.0,1
41,CC:2F:71:3E:C5:1F,2149630,272712122,41,5028,2149589,272707094,0,183,15648,156,12350,27,3298,46,1,68,2,0,7,130000.0,39000.0,-70.0,-70.0,-67.0,-60.0,-70.0,-69.0,-67.0,-60.0,-85.0,-89.0,-85.0,-90.0,15.0,19.0,18.0,30.0,1
42,CC:2F:71:3F:1F:24,2211887,356213640,62298,83506546,2149589,272707094,3,36210,37793183,36162,37786973,48,6210,35175,138,62320,15425,3,43,144444.0,43333.0,-70.0,-64.0,-71.0,-70.0,-69.0,-64.0,-70.0,-70.0,-84.0,-89.0,-85.0,-90.0,14.0,25.0,14.0,20.0,1
43,F8:59:71:5A:E0:3D,2153274,278044306,3684,5336939,2149590,272707367,0,2481,3116585,2440,3109088,41,7497,2461,2,3695,679,0,5,144444.0,43333.0,-67.0,-73.0,-65.0,-69.0,-67.0,-73.0,-65.0,-69.0,-84.0,-89.0,-85.0,-90.0,17.0,16.0,20.0,21.0,1
44,CC:2F:71:3E:C5:1F,2149633,272712597,41,5028,2149592,272707569,0,183,15648,156,12350,27,3298,46,1,68,2,0,7,130000.0,39000.0,-70.0,-70.0,-67.0,-60.0,-70.0,-69.0,-67.0,-60.0,-84.0,-89.0,-85.0,-90.0,14.0,19.0,18.0,30.0,1
45,CC:2F:71:3F:1F:24,2212067,356426886,62475,83719317,2149592,272707569,3,36367,37995437,36319,37989227,48,6210,35331,138,62495,15437,3,43,144444.0,43333.0,-69.0,-64.0,-71.0,-70.0,-69.0,-64.0,-70.0,-70.0,-84.0,-89.0,-85.0,-90.0,15.0,25.0,14.0,20.0,1
46,F8:59:71:5A:E0:3D,2153482,278346831,3883,5638596,2149599,272708235,0,2560,3219646,2519,3212149,41,7497,2540,2,3893,679,0,5,144444.0,43333.0,-67.0,-72.0,-66.0,-70.0,-67.0,-72.0,-65.0,-69.0,-84.0,-89.0,-84.0,-90.0,17.0,17.0,18.0,20.0,1
47,CC:2F:71:3E:C5:1F,2149640,272713263,41,5028,2149599,272708235,0,183,15648,156,12350,27,3298,46,1,68,2,0,7,130000.0,39000.0,-70.0,-70.0,-67.0,-60.0,-70.0,-69.0,-67.0,-60.0,-84.0,-89.0,-84.0,-90.0,14.0,19.0,17.0,30.0,1
48,CC:2F:71:3F:1F:24,2212229,356630518,62630,83922283,2149599,272708235,3,36509,38192405,36461,38186195,48,6210,35473,138,62650,15443,3,43,144444.0,43333.0,-69.0,-64.0,-70.0,-70.0,-69.0,-64.0,-69.0,-70.0,-84.0,-89.0,-84.0,-90.0,15.0,25.0,14.0,20.0,1
49,F8:59:71:5A:E0:3D,2153545,278443309,3946,5735074,2149599,272708235,0,2626,3320360,2585,3312863,41,7497,2606,2,3957,680,0,6,144444.0,43333.0,-68.0,-72.0,-65.0,-69.0,-67.0,-72.0,-65.0,-69.0,-84.0,-89.0,-84.0,-90.0,16.0,17.0,19.0,21.0,1
50,CC:2F:71:3E:C5:1F,2149640,272713263,41,5028,2149599,272708235,0,183,15648,156,12350,27,3298,46,1,68,2,0,7,130000.0,39000.0,-70.0,-70.0,-67.0,-60.0,-70.0,-69.0,-67.0,-60.0,-84.0,-89.0,-84.0,-90.0,14.0,19.0,17.0,30.0,1
51,CC:2F:71:3F:1F:24,2212394,356846304,62795,84138069,2149599,272708235,3,36659,38396009,36611,38389799,48,6210,35623,138,62817,15444,3,43,144444.0,43333.0,-70.0,-64.0,-71.0,-70.0,-69.0,-64.0,-70.0,-70.0,-84.0,-89.0,-84.0,-90.0,14.0,25.0,13.0,20.0,1
52,F8:59:71:5A:E0:3D,2153900,278987427,4293,6278384,2149607,272709043,0,2718,3425120,2677,3417623,41,7497,2698,2,4304,719,0,6,144444.0,43333.0,-67.0,-73.0,-66.0,-69.0,-67.0,-72.0,-65.0,-69.0,-84.0,-89.0,-84.0,-90.0,17.0,16.0,18.0,21.0,1
53,CC:2F:71:3E:C5:1F,2149648,272714071,41,5028,2149607,272709043,0,183,15648,156,12350,27,3298,46,1,68,2,0,7,130000.0,39000.0,-70.0,-70.0,-67.0,-60.0,-70.0,-69.0,-67.0,-60.0,-84.0,-89.0,-84.0,-90.0,14.0,19.0,17.0,30.0,1
54,CC:2F:71:3F:1F:24,2212560,357053316,62953,84344273,2149607,272709043,3,36804,38596201,36756,38589991,48,6210,35766,138,62975,15444,3,43,144444.0,43333.0,-69.0,-64.0,-70.0,-71.0,-69.0,-64.0,-70.0,-70.0,-84.0,-89.0,-84.0,-90.0,15.0,25.0,14.0,19.0,1
55,F8:59:71:5A:E0:3D,2153964,279085389,4356,6376286,2149608,272709103,0,2780,3520600,2739,3513103,41,7497,2760,2,4367,719,0,6,144444.0,43333.0,-68.0,-72.0,-65.0,-70.0,-67.0,-72.0,-64.0,-70.0,-83.0,-88.0,-83.0,-89.0,15.0,16.0,18.0,19.0,1
56,CC:2F:71:3E:C5:1F,2149649,272714131,41,5028,2149608,272709103,0,183,15648,156,12350,27,3298,46,1,68,2,0,7,130000.0,39000.0,-70.0,-70.0,-67.0,-60.0,-70.0,-69.0,-67.0,-60.0,-83.0,-88.0,-83.0,-89.0,13.0,18.0,16.0,29.0,1
57,CC:2F:71:3F:1F:24,2212736,357262780,63128,84553677,2149608,272709103,3,36975,38814921,36927,38808711,48,6210,35926,138,63150,15483,3,43,144444.0,43333.0,-69.0,-64.0,-70.0,-70.0,-68.0,-64.0,-70.0,-70.0,-83.0,-88.0,-83.0,-89.0,14.0,24.0,13.0,19.0,1
58,F8:59:71:5A:E0:3D,2154036,279184849,4418,6472634,2149618,272712215,0,2842,3616080,2801,3608583,41,7497,2822,2,4429,719,0,6,144444.0,43333.0,-68.0,-73.0,-65.0,-69.0,-67.0,-72.0,-65.0,-69.0,-82.0,-87.0,-82.0,-89.0,14.0,14.0,17.0,20.0,1
59,CC:2F:71:3E:C5:1F,2149663,272717647,41,5028,2149622,272712619,0,183,15648,156,12350,27,3298,46,1,68,2,0,7,130000.0,39000.0,-70.0,-70.0,-67.0,-60.0,-70.0,-69.0,-67.0,-60.0,-82.0,-87.0,-82.0,-89.0,12.0,17.0,15.0,29.0,1
60,CC:2F:71:3F:1F:24,2212909,357472516,63285,84759695,2149624,272712821,3,37123,39019789,37075,39013579,48,6210,36068,138,63307,15524,3,43,130000.0,43333.0,-69.0,-64.0,-70.0,-69.0,-69.0,-64.0,-69.0,-69.0,-82.0,-87.0,-82.0,-89.0,13.0,23.0,12.0,20.0,1
61,F8:59:71:5A:E0:3D,2154106,279282063,4482,6569242,2149624,272712821,0,2906,3711792,2865,3704295,41,7497,2886,2,4493,719,0,6,144444.0,43333.0,-67.0,-72.0,-65.0,-70.0,-67.0,-72.0,-65.0,-69.0,-82.0,-87.0,-82.0,-89.0,15.0,15.0,17.0,19.0,1
62,CC:2F:71:3E:C5:1F,2149665,272717849,41,5028,2149624,272712821,0,183,15648,156,12350,27,3298,46,1,68,2,0,7,130000.0,39000.0,-70.0,-70.0,-67.0,-60.0,-70.0,-69.0,-67.0,-60.0,-82.0,-87.0,-82.0,-89.0,12.0,17.0,15.0,29.0,1
63,CC:2F:71:3F:1F:24,2213349,358081176,63725,85368355,2149624,272712821,3,37360,39233753,37312,39227543,48,6210,36302,138,63725,15537,3,43,130000.0,43333.0,-69.0,-64.0,-71.0,-70.0,-68.0,-64.0,-70.0,-69.0,-82.0,-87.0,-82.0,-89.0,13.0,23.0,11.0,19.0,1
64,F8:59:71:5A:E0:3D,2154206,279420033,4579,6706950,2149627,272713083,0,2980,3815940,2939,3808443,41,7497,2960,2,4590,722,0,6,144444.0,43333.0,-67.0,-72.0,-66.0,-70.0,-67.0,-72.0,-65.0,-69.0,-82.0,-87.0,-82.0,-89.0,15.0,15.0,16.0,19.0,1
65,CC:2F:71:3E:C5:1F,2149668,272718111,41,5028,2149627,272713083,0,183,15648,156,12350,27,3298,46,1,68,2,0,7,130000.0,39000.0,-70.0,-70.0,-67.0,-60.0,-70.0,-69.0,-67.0,-60.0,-82.0,-87.0,-82.0,-89.0,12.0,17.0,15.0,29.0,1
66,CC:2F:71:3F:1F:24,2213683,358447297,64056,85734214,2149627,272713083,3,37632,39464798,37584,39458588,48,6210,36556,138,64078,15537,3,43,130000.0,43333.0,-69.0,-64.0,-70.0,-69.0,-69.0,-64.0,-70.0,-69.0,-82.0,-87.0,-82.0,-89.0,13.0,23.0,12.0,20.0,1
67,F8:59:71:5A:E0:3D,2154280,279520679,4646,6806864,2149634,272713815,0,3048,3916858,3007,3909361,41,7497,3028,2,4657,722,0,6,144444.0,43333.0,-67.0,-72.0,-66.0,-70.0,-67.0,-72.0,-65.0,-69.0,-81.0,-87.0,-81.0,-88.0,14.0,15.0,15.0,18.0,1
68,CC:2F:71:3E:C5:1F,2149675,272718843,41,5028,2149634,272713815,0,183,15648,156,12350,27,3298,46,1,68,2,0,7,130000.0,39000.0,-70.0,-70.0,-67.0,-60.0,-70.0,-69.0,-67.0,-60.0,-81.0,-87.0,-81.0,-88.0,11.0,17.0,14.0,28.0,1
69,CC:2F:71:3F:1F:24,2214050,358900670,64416,86186855,2149634,272713815,3,37894,39689930,37846,39683720,48,6210,36806,138,64438,15562,3,43,130000.0,43333.0,-70.0,-64.0,-72.0,-70.0,-69.0,-64.0,-70.0,-69.0,-81.0,-87.0,-81.0,-88.0,11.0,23.0,9.0,18.0,1
70,F8:59:71:5A:E0:3D,2154348,279619244,4712,6905227,2149636,272714017,0,3114,4016078,3073,4008581,41,7497,3094,2,4723,724,0,6,144444.0,43333.0,-67.0,-73.0,-66.0,-70.0,-67.0,-72.0,-65.0,-69.0,-81.0,-87.0,-81.0,-88.0,14.0,14.0,15.0,18.0,1
71,CC:2F:71:3E:C5:1F,2149677,272719045,41,5028,2149636,272714017,0,183,15648,156,12350,27,3298,46,1,68,2,0,7,130000.0,39000.0,-70.0,-70.0,-67.0,-60.0,-70.0,-69.0,-67.0,-60.0,-81.0,-87.0,-81.0,-88.0,11.0,17.0,14.0,28.0,1
72,CC:2F:71:3F:1F:24,2214401,359350696,64764,86636619,2149637,272714077,3,38138,39904335,38090,39898125,48,6210,37047,138,64786,15570,3,43,130000.0,43333.0,-69.0,-64.0,-70.0,-69.0,-69.0,-64.0,-70.0,-69.0,-81.0,-87.0,-81.0,-88.0,12.0,23.0,11.0,19.0,1
73,F8:59:71:5A:E0:3D,2154418,279717812,4775,7003129,2149643,272714683,0,3177,4113098,3136,4105601,41,7497,3157,2,4786,725,0,6,144444.0,43333.0,-67.0,-73.0,-66.0,-70.0,-67.0,-73.0,-65.0,-69.0,-81.0,-87.0,-81.0,-88.0,14.0,14.0,15.0,18.0,1
74,CC:2F:71:3E:C5:1F,2149684,272719711,41,5028,2149643,272714683,0,183,15648,156,12350,27,3298,46,1,68,2,0,7,130000.0,39000.0,-70.0,-70.0,-67.0,-60.0,-70.0,-69.0,-67.0,-60.0,-81.0,-87.0,-81.0,-88.0,11.0,17.0,14.0,28.0,1
75,CC:2F:71:3F:1F:24,2214760,359804564,65117,87089881,2149643,272714683,3,38376,40117909,38328,40111699,48,6210,37281,138,65139,15591,3,43,130000.0,43333.0,-70.0,-64.0,-71.0,-69.0,-69.0,-64.0,-71.0,-68.0,-81.0,-87.0,-81.0,-88.0,11.0,23.0,10.0,19.0,1
76,F8:59:71:5A:E0:3D,2154483,279815916,4838,7101031,2149645,272714885,0,3241,4211672,3200,4204175,41,7497,3220,2,4849,725,0,6,144444.0,43333.0,-68.0,-75.0,-64.0,-71.0,-67.0,-73.0,-64.0,-70.0,-80.0,-86.0,-81.0,-88.0,12.0,11.0,17.0,17.0,1
77,CC:2F:71:3E:C5:1F,2149686,272719913,41,5028,2149645,272714885,0,185,15788,158,12490,27,3298,46,1,69,2,0,7,130000.0,39000.0,-68.0,-62.0,-66.0,-59.0,-70.0,-68.0,-68.0,-59.0,-80.0,-86.0,-81.0,-88.0,12.0,24.0,15.0,29.0,1
78,CC:2F:71:3F:1F:24,2215112,360256250,65467,87541365,2149645,272714885,3,38624,40342631,38576,40336421,48,6210,37515,138,65489,15610,3,43,144444.0,43333.0,-70.0,-64.0,-71.0,-70.0,-69.0,-64.0,-69.0,-70.0,-80.0,-86.0,-81.0,-88.0,10.0,22.0,10.0,18.0,1
79,F8:59:71:5A:E0:3D,2154780,280265109,5129,7549618,2149651,272715491,0,3337,4319264,3296,4311767,41,7497,3316,2,5140,729,0,6,144444.0,43333.0,-67.0,-73.0,-64.0,-70.0,-67.0,-73.0,-64.0,-70.0,-80.0,-86.0,-81.0,-88.0,13.0,13.0,17.0,18.0,1
80,CC:2F:71:3E:C5:1F,2149693,272720579,41,5028,2149652,272715551,0,185,15788,158,12490,27,3298,46,1,69,2,0,7,130000.0,39000.0,-68.0,-62.0,-66.0,-59.0,-70.0,-68.0,-68.0,-59.0,-80.0,-86.0,-81.0,-88.0,12.0,24.0,15.0,29.0,1
81,CC:2F:71:3F:1F:24,2215277,360463258,65625,87747707,2149652,272715551,3,38779,40555509,38731,40549299,48,6210,37659,138,65647,15621,3,43,144444.0,43333.0,-69.0,-63.0,-69.0,-70.0,-69.0,-63.0,-68.0,-70.0,-80.0,-86.0,-81.0,-88.0,11.0,23.0,12.0,18.0,1
82,F8:59:71:5A:E0:3D,2154844,280361633,5192,7646082,2149652,272715551,0,3401,4416404,3360,4408907,41,7497,3379,2,5203,729,0,6,144444.0,43333.0,-67.0,-73.0,-64.0,-69.0,-66.0,-72.0,-64.0,-69.0,-80.0,-86.0,-81.0,-88.0,13.0,13.0,17.0,19.0,1
83,CC:2F:71:3E:C5:1F,2149693,272720579,41,5028,2149652,272715551,0,185,15788,158,12490,27,3298,46,1,69,2,0,7,130000.0,39000.0,-68.0,-62.0,-66.0,-59.0,-70.0,-68.0,-68.0,-59.0,-80.0,-86.0,-81.0,-88.0,12.0,24.0,15.0,29.0,1
84,CC:2F:71:3F:1F:24,2215431,360663232,65779,87947681,2149652,272715551,3,38937,40773139,38889,40766929,48,6210,37801,138,65801,15621,3,43,144444.0,43333.0,-71.0,-63.0,-72.0,-69.0,-70.0,-63.0,-70.0,-68.0,-80.0,-86.0,-81.0,-88.0,9.0,23.0,9.0,19.0,1
85,F8:59:71:5A:E0:3D,2154915,280460530,5256,7744100,2149659,272716430,0,3464,4513424,3423,4505927,41,7497,3442,2,5267,729,0,6,144444.0,43333.0,-66.0,-72.0,-66.0,-68.0,-66.0,-72.0,-65.0,-68.0,-80.0,-87.0,-80.0,-88.0,14.0,15.0,14.0,20.0,1
86,CC:2F:71:3E:C5:1F,2149701,272721574,42,5144,2149659,272716430,0,187,15928,160,12630,27,3298,46,1,70,2,0,7,130000.0,39000.0,-72.0,-70.0,-66.0,-60.0,-70.0,-68.0,-67.0,-59.0,-80.0,-87.0,-80.0,-88.0,8.0,17.0,14.0,28.0,1
87,CC:2F:71:3F:1F:24,2215599,360870633,65938,88154001,2149661,272716632,3,39081,40970353,39033,40964143,48,6210,37944,138,65960,15626,3,43,144444.0,43333.0,-67.0,-64.0,-67.0,-70.0,-69.0,-64.0,-69.0,-69.0,-80.0,-87.0,-80.0,-88.0,13.0,23.0,13.0,18.0,1
88,F8:59:71:5A:E0:3D,2155114,280765029,5452,8048337,2149662,272716692,0,3542,4615628,3501,4608131,41,7497,3520,2,5463,729,0,6,144444.0,43333.0,-67.0,-72.0,-65.0,-70.0,-67.0,-72.0,-64.0,-69.0,-79.0,-86.0,-79.0,-87.0,12.0,14.0,14.0,17.0,1
89,CC:2F:71:3E:C5:1F,2149704,272721836,42,5144,2149662,272716692,0,187,15928,160,12630,27,3298,46,1,70,2,0,7,130000.0,39000.0,-72.0,-70.0,-66.0,-60.0,-70.0,-68.0,-67.0,-59.0,-79.0,-86.0,-79.0,-87.0,7.0,16.0,13.0,27.0,1
90,CC:2F:71:3F:1F:24,2215759,361079875,66097,88363183,2149662,272716692,3,39230,41176857,39182,41170647,48,6210,38087,138,66119,15643,3,43,144444.0,43333.0,-71.0,-64.0,-70.0,-77.0,-69.0,-63.0,-69.0,-76.0,-79.0,-86.0,-79.0,-87.0,8.0,22.0,9.0,10.0,1
91,F8:59:71:5A:E0:3D,2155181,280863335,5515,8146239,2149666,272717096,0,3605,4712648,3564,4705151,41,7497,3583,2,5526,730,0,6,144444.0,43333.0,-67.0,-74.0,-66.0,-70.0,-66.0,-73.0,-65.0,-70.0,-79.0,-86.0,-79.0,-87.0,12.0,12.0,13.0,17.0,1
92,CC:2F:71:3E:C5:1F,2149709,272722308,42,5144,2149667,272717164,0,187,15928,160,12630,27,3298,46,1,70,2,0,7,130000.0,39000.0,-72.0,-70.0,-66.0,-60.0,-70.0,-68.0,-67.0,-59.0,-79.0,-86.0,-79.0,-87.0,7.0,16.0,13.0,27.0,1
93,CC:2F:71:3F:1F:24,2215930,361287425,66262,88570127,2149668,272717298,3,39391,41382619,39343,41376409,48,6210,38240,138,66284,15664,3,43,144444.0,43333.0,-69.0,-63.0,-68.0,-70.0,-68.0,-63.0,-68.0,-69.0,-79.0,-86.0,-79.0,-87.0,10.0,23.0,11.0,17.0,1
94,F8:59:71:5A:E0:3D,2155276,280978661,5582,8250189,2149694,272728472,0,3675,4816170,3633,4808555,42,7615,3650,2,5593,730,0,6,144444.0,43333.0,-67.0,-74.0,-65.0,-70.0,-66.0,-73.0,-65.0,-70.0,-79.0,-86.0,-79.0,-87.0,12.0,12.0,14.0,17.0,1
95,CC:2F:71:3E:C5:1F,2149736,272733616,42,5144,2149694,272728472,0,187,15928,160,12630,27,3298,46,1,70,2,0,7,130000.0,39000.0,-72.0,-70.0,-66.0,-60.0,-70.0,-68.0,-67.0,-59.0,-79.0,-86.0,-79.0,-87.0,7.0,16.0,13.0,27.0,1
96,CC:2F:71:3F:1F:24,2216123,361517351,66429,88788879,2149694,272728472,3,39551,41600263,39502,41593935,49,6328,38396,138,66450,15712,3,43,144444.0,43333.0,-70.0,-63.0,-69.0,-68.0,-70.0,-63.0,-69.0,-68.0,-79.0,-86.0,-79.0,-87.0,9.0,23.0,10.0,19.0,1
97,F8:59:71:5A:E0:3D,2155342,281076825,5645,8348091,2149697,272728734,0,3740,4913330,3698,4905715,42,7615,3713,2,5656,732,0,6,144444.0,43333.0,-66.0,-74.0,-65.0,-70.0,-66.0,-73.0,-65.0,-70.0,-78.0,-85.0,-78.0,-86.0,12.0,11.0,13.0,16.0,1
98,CC:2F:71:3E:C5:1F,2149741,272734080,42,5144,2149699,272728936,0,187,15928,160,12630,27,3298,46,1,70,2,0,7,130000.0,39000.0,-72.0,-70.0,-66.0,-60.0,-70.0,-68.0,-67.0,-59.0,-78.0,-85.0,-78.0,-86.0,6.0,15.0,12.0,26.0,1
99,CC:2F:71:3F:1F:24,2216283,361720725,66584,88991789,2149699,272728936,3,39698,41800825,39649,41794497,49,6328,38538,138,66606,15759,3,43,130000.0,43333.0,-68.0,-63.0,-68.0,-69.0,-68.0,-63.0,-69.0,-69.0,-78.0,-85.0,-78.0,-86.0,10.0,22.0,10.0,17.0,1
100,F8:59:71:5A:E0:3D,2155411,281175333,5708,8445993,2149703,272729340,0,3803,5010350,3761,5002735,42,7615,3776,2,5719,732,0,6,144444.0,43333.0,-66.0,-74.0,-64.0,-70.0,-65.0,-73.0,-64.0,-70.0,-78.0,-85.0,-78.0,-86.0,12.0,11.0,14.0,16.0,1
101,CC:2F:71:3E:C5:1F,2149745,272734484,42,5144,2149703,272729340,0,187,15928,160,12630,27,3298,46,1,70,2,0,7,130000.0,39000.0,-72.0,-70.0,-66.0,-60.0,-70.0,-68.0,-67.0,-59.0,-78.0,-85.0,-78.0,-86.0,6.0,15.0,12.0,26.0,1
102,CC:2F:71:3F:1F:24,2216445,361927333,66742,89197993,2149703,272729340,3,39854,42014063,39805,42007735,49,6328,38681,138,66764,15760,3,43,130000.0,43333.0,-70.0,-63.0,-71.0,-68.0,-70.0,-63.0,-69.0,-68.0,-78.0,-85.0,-78.0,-86.0,8.0,22.0,7.0,18.0,1
103,F8:59:71:5A:E0:3D,2155477,281272143,5772,8542601,2149705,272729542,0,3867,5106062,3825,5098447,42,7615,3840,2,5783,732,0,6,144444.0,43333.0,-66.0,-74.0,-65.0,-71.0,-66.0,-74.0,-65.0,-70.0,-77.0,-84.0,-77.0,-86.0,11.0,10.0,12.0,15.0,1
104,CC:2F:71:3E:C5:1F,2149747,272734686,42,5144,2149705,272729542,0,187,15928,160,12630,27,3298,46,1,70,2,0,7,130000.0,39000.0,-72.0,-70.0,-66.0,-60.0,-70.0,-68.0,-67.0,-59.0,-77.0,-84.0,-77.0,-86.0,5.0,14.0,11.0,26.0,1
105,CC:2F:71:3F:1F:24,2216615,362137662,66910,89408120,2149705,272729542,3,40020,42227353,39971,42221025,49,6328,38836,138,66932,15761,3,43,130000.0,43333.0,-68.0,-63.0,-70.0,-69.0,-68.0,-63.0,-69.0,-68.0,-77.0,-84.0,-77.0,-86.0,9.0,21.0,7.0,17.0,1
106,F8:59:71:5A:E0:3D,2155946,281996394,6234,9266186,2149712,272730208,0,3971,5214186,3929,5206571,42,7615,3944,2,6245,758,0,6,144444.0,43333.0,-67.0,-75.0,-66.0,-70.0,-66.0,-74.0,-65.0,-70.0,-77.0,-84.0,-77.0,-86.0,10.0,9.0,11.0,16.0,1
107,CC:2F:71:3E:C5:1F,2149754,272735352,42,5144,2149712,272730208,0,187,15928,160,12630,27,3298,46,1,70,2,0,7,130000.0,39000.0,-72.0,-70.0,-66.0,-60.0,-70.0,-68.0,-67.0,-59.0,-77.0,-84.0,-77.0,-86.0,5.0,14.0,11.0,26.0,1
108,CC:2F:71:3F:1F:24,2216801,362357785,67089,89627577,2149712,272730208,3,40190,42448182,40141,42441854,49,6328,38998,138,67111,15803,3,43,104000.0,26000.0,-68.0,-63.0,-69.0,-69.0,-68.0,-63.0,-69.0,-68.0,-77.0,-84.0,-77.0,-86.0,9.0,21.0,8.0,17.0,1
109,F8:59:71:5A:E0:3D,2156043,282140971,6329,9410561,2149714,272730410,0,4041,5318198,3999,5310583,42,7615,4014,2,6340,758,0,6,144444.0,43333.0,-67.0,-75.0,-66.0,-70.0,-66.0,-74.0,-65.0,-70.0,-77.0,-84.0,-77.0,-86.0,10.0,9.0,11.0,16.0,1
110,CC:2F:71:3E:C5:1F,2149756,272735554,42,5144,2149714,272730410,0,187,15928,160,12630,27,3298,46,1,70,2,0,7,130000.0,39000.0,-72.0,-70.0,-66.0,-60.0,-70.0,-68.0,-67.0,-59.0,-76.0,-84.0,-77.0,-85.0,4.0,14.0,11.0,25.0,1
111,CC:2F:71:3F:1F:24,2216963,362567187,67249,89836777,2149714,272730410,3,40343,42660778,40294,42654450,49,6328,39143,138,67271,15825,3,43,115556.0,28889.0,-69.0,-63.0,-71.0,-70.0,-69.0,-63.0,-70.0,-69.0,-76.0,-84.0,-77.0,-85.0,7.0,21.0,6.0,15.0,1
112,F8:59:71:5A:E0:3D,2156116,282240007,6395,9508921,2149721,272731086,0,4109,5417702,4066,5409961,43,7741,4082,2,6406,758,0,6,144444.0,43333.0,-66.0,-74.0,-66.0,-71.0,-66.0,-74.0,-65.0,-70.0,-76.0,-84.0,-77.0,-85.0,10.0,10.0,11.0,14.0,1
113,CC:2F:71:3E:C5:1F,2149764,272736292,42,5144,2149722,272731148,0,188,16046,160,12630,28,3416,47,1,70,2,0,7,130000.0,39000.0,-71.0,-71.0,-67.0,-60.0,-70.0,-69.0,-67.0,-59.0,-76.0,-84.0,-77.0,-85.0,5.0,13.0,10.0,25.0,1
114,CC:2F:71:3F:1F:24,2217126,362770891,67404,90039743,2149722,272731148,3,40496,42869192,40447,42862864,49,6328,39287,138,67426,15827,3,43,115556.0,28889.0,-70.0,-63.0,-72.0,-69.0,-69.0,-63.0,-70.0,-69.0,-76.0,-84.0,-77.0,-85.0,6.0,21.0,5.0,16.0,1
115,F8:59:71:5A:E0:3D,2156185,282340046,6462,9608838,2149723,272731208,0,4177,5519974,4134,5512233,43,7741,4150,2,6473,758,0,6,144444.0,43333.0,-66.0,-74.0,-66.0,-70.0,-66.0,-74.0,-65.0,-69.0,-77.0,-84.0,-77.0,-86.0,11.0,10.0,11.0,16.0,1
116,CC:2F:71:3E:C5:1F,2149765,272736352,42,5144,2149723,272731208,0,189,16116,161,12700,28,3416,47,1,70,2,0,7,130000.0,39000.0,-70.0,-70.0,-66.0,-60.0,-70.0,-69.0,-66.0,-59.0,-77.0,-84.0,-77.0,-86.0,7.0,14.0,11.0,26.0,1
117,CC:2F:71:3F:1F:24,2217285,362976931,67562,90245723,2149723,272731208,3,40646,43077282,40597,43070954,49,6328,39430,138,67584,15843,3,43,115556.0,28889.0,-69.0,-63.0,-70.0,-68.0,-69.0,-63.0,-70.0,-68.0,-77.0,-84.0,-77.0,-86.0,8.0,21.0,7.0,18.0,1
118,F8:59:71:5A:E0:3D,2156255,282440108,6526,9708294,2149729,272731814,0,4246,5626318,4203,5618577,43,7741,4213,2,6537,758,0,6,144444.0,43333.0,-65.0,-73.0,-67.0,-70.0,-66.0,-73.0,-65.0,-70.0,-77.0,-84.0,-77.0,-86.0,12.0,11.0,10.0,16.0,1
119,CC:2F:71:3E:C5:1F,2149773,272737160,42,5144,2149731,272732016,0,189,16116,161,12700,28,3416,47,1,70,2,0,7,130000.0,39000.0,-70.0,-70.0,-66.0,-60.0,-70.0,-69.0,-66.0,-59.0,-77.0,-84.0,-77.0,-86.0,7.0,14.0,11.0,26.0,1
120,CC:2F:71:3F:1F:24,2217459,363190394,67728,90458378,2149731,272732016,3,40801,43280564,40752,43274236,49,6328,39582,138,67750,15845,3,43,115556.0,28889.0,-70.0,-63.0,-70.0,-66.0,-69.0,-63.0,-69.0,-66.0,-77.0,-84.0,-77.0,-86.0,7.0,21.0,7.0,20.0,1
121,F8:59:71:5A:E0:3D,2156320,282538212,6589,9806196,2149731,272732016,0,4309,5723338,4266,5715597,43,7741,4276,2,6600,759,0,6,144444.0,43333.0,-66.0,-74.0,-65.0,-70.0,-66.0,-74.0,-65.0,-70.0,-77.0,-84.0,-77.0,-86.0,11.0,10.0,12.0,16.0,1
122,CC:2F:71:3E:C5:1F,2149773,272737160,42,5144,2149731,272732016,0,189,16116,161,12700,28,3416,47,1,70,2,0,7,130000.0,39000.0,-70.0,-70.0,-66.0,-60.0,-70.0,-69.0,-66.0,-59.0,-77.0,-84.0,-77.0,-86.0,7.0,14.0,11.0,26.0,1
123,CC:2F:71:3F:1F:24,2217615,363393490,67884,90661474,2149731,272732016,3,40950,43484218,40901,43477890,49,6328,39724,138,67906,15845,3,43,115556.0,28889.0,-68.0,-62.0,-69.0,-67.0,-69.0,-62.0,-69.0,-67.0,-77.0,-84.0,-77.0,-86.0,9.0,22.0,8.0,19.0,1
124,F8:59:71:5A:E0:3D,2156387,282635024,6651,9902544,2149736,272732480,0,4371,5818818,4328,5811077,43,7741,4338,2,6662,759,0,6,144444.0,43333.0,-66.0,-74.0,-65.0,-70.0,-66.0,-73.0,-65.0,-70.0,-77.0,-84.0,-78.0,-86.0,11.0,10.0,13.0,16.0,1
125,CC:2F:71:3E:C5:1F,2149778,272737624,42,5144,2149736,272732480,0,189,16116,161,12700,28,3416,47,1,70,2,0,7,130000.0,39000.0,-70.0,-70.0,-66.0,-60.0,-70.0,-69.0,-66.0,-59.0,-77.0,-84.0,-78.0,-86.0,7.0,14.0,12.0,26.0,1
126,CC:2F:71:3F:1F:24,2217778,363599598,68042,90867118,2149736,272732480,3,41099,43685158,41050,43678830,49,6328,39869,138,68064,15860,3,43,130000.0,39000.0,-70.0,-63.0,-70.0,-66.0,-69.0,-62.0,-69.0,-66.0,-77.0,-84.0,-78.0,-86.0,7.0,21.0,8.0,20.0,1
127,F8:59:71:5A:E0:3D,2156458,282735342,6718,10002458,2149740,272732884,0,4439,5919736,4396,5911995,43,7741,4406,2,6729,759,0,6,144444.0,43333.0,-66.0,-73.0,-67.0,-70.0,-66.0,-73.0,-65.0,-70.0,-77.0,-84.0,-78.0,-86.0,11.0,11.0,11.0,16.0,1
128,CC:2F:71:3E:C5:1F,2149782,272738028,42,5144,2149740,272732884,0,189,16116,161,12700,28,3416,47,1,70,2,0,7,130000.0,39000.0,-70.0,-70.0,-66.0,-60.0,-70.0,-69.0,-66.0,-59.0,-77.0,-84.0,-78.0,-86.0,7.0,14.0,12.0,26.0,1
129,CC:2F:71:3F:1F:24,2217939,363803158,68199,91070274,2149740,272732884,3,41247,43888592,41198,43882264,49,6328,40011,138,68221,15860,3,43,130000.0,43333.0,-70.0,-64.0,-69.0,-68.0,-69.0,-64.0,-69.0,-67.0,-77.0,-84.0,-78.0,-86.0,7.0,20.0,9.0,18.0,1
130,F8:59:71:5A:E0:3D,2156655,283022312,6910,10288751,2149745,272733561,0,4524,6022273,4481,6014532,43,7741,4491,2,6921,759,0,6,144444.0,43333.0,-67.0,-74.0,-66.0,-70.0,-67.0,-74.0,-65.0,-70.0,-77.0,-84.0,-78.0,-86.0,10.0,10.0,12.0,16.0,1
131,CC:2F:71:3E:C5:1F,2149787,272738705,42,5144,2149745,272733561,0,189,16116,161,12700,28,3416,47,1,70,2,0,7,130000.0,39000.0,-70.0,-70.0,-66.0,-60.0,-70.0,-69.0,-66.0,-59.0,-77.0,-84.0,-78.0,-86.0,7.0,14.0,12.0,26.0,1
132,CC:2F:71:3F:1F:24,2218106,364010272,68361,91276711,2149745,272733561,3,41397,44087191,41348,44080863,49,6328,40158,138,68383,15860,3,43,130000.0,43333.0,-69.0,-62.0,-70.0,-68.0,-68.0,-62.0,-69.0,-68.0,-77.0,-84.0,-78.0,-86.0,8.0,22.0,8.0,18.0,1
133,F8:59:71:5A:E0:3D,2156724,283119492,6972,10385099,2149752,272734393,0,4586,6117753,4543,6110012,43,7741,4553,2,6983,760,0,6,144444.0,43333.0,-66.0,-74.0,-67.0,-70.0,-66.0,-74.0,-66.0,-70.0,-77.0,-84.0,-78.0,-86.0,11.0,10.0,11.0,16.0,1
134,CC:2F:71:3E:C5:1F,2149794,272739537,42,5144,2149752,272734393,0,189,16116,161,12700,28,3416,47,1,70,2,0,7,130000.0,39000.0,-70.0,-70.0,-66.0,-60.0,-70.0,-69.0,-66.0,-59.0,-77.0,-84.0,-78.0,-86.0,7.0,14.0,12.0,26.0,1
135,CC:2F:71:3F:1F:24,2218271,364217140,68519,91482747,2149752,272734393,3,41548,44293953,41499,44287625,49,6328,40300,138,68541,15869,3,43,144444.0,43333.0,-69.0,-62.0,-72.0,-68.0,-68.0,-62.0,-69.0,-68.0,-77.0,-84.0,-78.0,-86.0,8.0,22.0,6.0,18.0,1
136,F8:59:71:5A:E0:3D,2156790,283217166,7034,10481447,2149756,272735719,0,4648,6213247,4605,6205506,43,7741,4614,2,7045,760,0,6,144444.0,43333.0,-66.0,-74.0,-67.0,-70.0,-66.0,-74.0,-66.0,-69.0,-77.0,-85.0,-78.0,-86.0,11.0,11.0,11.0,16.0,1
137,CC:2F:71:3E:C5:1F,2149800,272741065,42,5144,2149758,272735921,0,189,16116,161,12700,28,3416,47,1,70,2,0,7,130000.0,39000.0,-70.0,-70.0,-66.0,-60.0,-70.0,-69.0,-66.0,-59.0,-77.0,-85.0,-78.0,-86.0,7.0,15.0,12.0,26.0,1
138,CC:2F:71:3F:1F:24,2218439,364431088,68681,91695167,2149758,272735921,3,41705,44511327,41656,44504999,49,6328,40449,138,68703,15885,3,43,144444.0,43333.0,-70.0,-63.0,-68.0,-67.0,-69.0,-63.0,-69.0,-67.0,-77.0,-85.0,-78.0,-86.0,7.0,22.0,10.0,19.0,1
139,F8:59:71:5A:E0:3D,2157086,283668578,7323,10932193,2149763,272736385,0,4744,6333077,4701,6325336,43,7741,4710,2,7334,760,0,6,144444.0,43333.0,-66.0,-73.0,-66.0,-70.0,-66.0,-72.0,-66.0,-69.0,-77.0,-85.0,-78.0,-86.0,11.0,12.0,12.0,16.0,1
140,CC:2F:71:3E:C5:1F,2149805,272741529,42,5144,2149763,272736385,0,189,16116,161,12700,28,3416,47,1,70,2,0,7,130000.0,39000.0,-70.0,-70.0,-66.0,-60.0,-70.0,-69.0,-66.0,-59.0,-77.0,-85.0,-78.0,-86.0,7.0,15.0,12.0,26.0,1
141,CC:2F:71:3F:1F:24,2218617,364659714,68854,91923329,2149763,272736385,3,41867,44733939,41818,44727611,49,6328,40607,138,68876,15891,3,43,130000.0,43333.0,-68.0,-63.0,-70.0,-68.0,-68.0,-63.0,-70.0,-67.0,-77.0,-85.0,-78.0,-86.0,9.0,22.0,8.0,18.0,1
142,F8:59:71:5A:E0:3D,2157153,283767806,7386,11030095,2149767,272737711,0,4807,6430097,4764,6422356,43,7741,4773,2,7397,760,0,6,144444.0,43333.0,-67.0,-74.0,-65.0,-70.0,-66.0,-73.0,-65.0,-69.0,-77.0,-85.0,-78.0,-86.0,10.0,11.0,13.0,16.0,1
143,CC:2F:71:3E:C5:1F,2149811,272743057,42,5144,2149769,272737913,0,189,16116,161,12700,28,3416,47,1,70,2,0,7,130000.0,39000.0,-70.0,-70.0,-66.0,-60.0,-70.0,-69.0,-66.0,-59.0,-77.0,-85.0,-78.0,-86.0,7.0,15.0,12.0,26.0,1
144,CC:2F:71:3F:1F:24,2218788,364870917,69019,92133004,2149769,272737913,3,42024,44941905,41975,44935577,49,6328,40758,138,69041,15891,3,43,130000.0,43333.0,-68.0,-63.0,-69.0,-68.0,-68.0,-63.0,-69.0,-68.0,-77.0,-85.0,-78.0,-86.0,9.0,22.0,9.0,18.0,1
145,F8:59:71:5A:E0:3D,2157224,283866524,7449,11127997,2149775,272738527,0,4872,6527439,4827,6519376,45,8063,4838,2,7460,760,0,6,144444.0,43333.0,-67.0,-74.0,-65.0,-70.0,-66.0,-73.0,-65.0,-69.0,-77.0,-85.0,-78.0,-86.0,10.0,11.0,13.0,16.0,1
146,CC:2F:71:3E:C5:1F,2149817,272743671,42,5144,2149775,272738527,0,189,16116,161,12700,28,3416,47,1,70,2,0,7,130000.0,39000.0,-70.0,-70.0,-66.0,-60.0,-70.0,-69.0,-66.0,-59.0,-77.0,-85.0,-78.0,-86.0,7.0,15.0,12.0,26.0,1
147,CC:2F:71:3F:1F:24,2218958,365078560,69183,92340033,2149775,272738527,3,42172,45141163,42123,45134835,49,6328,40904,138,69205,15892,3,43,144444.0,43333.0,-69.0,-63.0,-70.0,-67.0,-68.0,-63.0,-69.0,-67.0,-77.0,-85.0,-78.0,-86.0,8.0,22.0,8.0,19.0,1
148,F8:59:71:5A:E0:3D,2157291,283964316,7513,11224605,2149778,272739711,0,4937,6624691,4892,6616628,45,8063,4903,2,7524,761,0,6,144444.0,43333.0,-66.0,-74.0,-66.0,-70.0,-66.0,-73.0,-65.0,-69.0,-77.0,-85.0,-78.0,-86.0,11.0,11.0,12.0,16.0,1
149,CC:2F:71:3E:C5:1F,2149820,272744855,42,5144,2149778,272739711,0,189,16116,161,12700,28,3416,47,1,70,2,0,7,130000.0,39000.0,-70.0,-70.0,-66.0,-60.0,-70.0,-69.0,-66.0,-59.0,-77.0,-85.0,-78.0,-86.0,7.0,15.0,12.0,26.0,1
150,CC:2F:71:3F:1F:24,2219118,365282912,69338,92542999,2149780,272739913,3,42319,45345929,42270,45339601,49,6328,41044,138,69360,15892,3,43,144444.0,43333.0,-69.0,-63.0,-70.0,-67.0,-68.0,-63.0,-69.0,-67.0,-77.0,-85.0,-78.0,-86.0,8.0,22.0,8.0,19.0,1
151,F8:59:71:5A:E0:3D,2157552,284350299,7768,11609982,2149784,272740317,0,5031,6737029,4986,6728966,45,8063,4996,2,7779,761,0,6,144444.0,43333.0,-67.0,-74.0,-65.0,-70.0,-66.0,-73.0,-65.0,-69.0,-77.0,-85.0,-78.0,-86.0,10.0,11.0,13.0,16.0,1
152,CC:2F:71:3E:C5:1F,2149826,272745461,42,5144,2149784,272740317,0,189,16116,161,12700,28,3416,47,1,70,2,0,7,130000.0,39000.0,-70.0,-70.0,-66.0,-60.0,-70.0,-69.0,-66.0,-59.0,-77.0,-85.0,-78.0,-86.0,7.0,15.0,12.0,26.0,1
153,CC:2F:71:3F:1F:24,2219279,365486484,69493,92745965,2149786,272740519,3,42466,45547819,42417,45541491,49,6328,41186,138,69515,15894,3,43,144444.0,43333.0,-68.0,-63.0,-70.0,-68.0,-68.0,-63.0,-69.0,-67.0,-77.0,-85.0,-78.0,-86.0,9.0,22.0,8.0,18.0,1
154,F8:59:71:5A:E0:3D,2157617,284448403,7831,11707884,2149786,272740519,0,5094,6834049,5049,6825986,45,8063,5059,2,7842,761,0,6,144444.0,43333.0,-66.0,-73.0,-65.0,-70.0,-66.0,-73.0,-65.0,-69.0,-77.0,-85.0,-78.0,-86.0,11.0,12.0,13.0,16.0,1
155,CC:2F:71:3E:C5:1F,2149828,272745663,42,5144,2149786,272740519,0,189,16116,161,12700,28,3416,47,1,70,2,0,7,130000.0,39000.0,-70.0,-70.0,-66.0,-60.0,-70.0,-69.0,-66.0,-59.0,-77.0,-85.0,-78.0,-86.0,7.0,15.0,12.0,26.0,1
156,CC:2F:71:3F:1F:24,2219434,365689450,69648,92948931,2149786,272740519,3,42609,45742111,42560,45735783,49,6328,41329,138,69670,15894,3,43,144444.0,43333.0,-68.0,-63.0,-69.0,-68.0,-68.0,-63.0,-69.0,-67.0,-77.0,-85.0,-78.0,-86.0,9.0,22.0,9.0,18.0,1
157,F8:59:71:5A:E0:3D,2157685,284546769,7894,11805786,2149791,272740983,0,5158,6932623,5113,6924560,45,8063,5122,2,7905,761,0,6,144444.0,43333.0,-67.0,-74.0,-65.0,-69.0,-66.0,-73.0,-65.0,-69.0,-77.0,-84.0,-77.0,-86.0,10.0,10.0,12.0,17.0,1
158,CC:2F:71:3E:C5:1F,2149833,272746127,42,5144,2149791,272740983,0,189,16116,161,12700,28,3416,47,1,70,2,0,7,130000.0,39000.0,-70.0,-70.0,-66.0,-60.0,-70.0,-69.0,-66.0,-59.0,-77.0,-84.0,-77.0,-86.0,7.0,14.0,11.0,26.0,1
159,CC:2F:71:3F:1F:24,2219616,365905715,69825,93164732,2149791,272740983,3,42781,45961756,42732,45955428,49,6328,41490,138,69847,15894,3,43,144444.0,43333.0,-69.0,-64.0,-70.0,-68.0,-69.0,-63.0,-70.0,-67.0,-77.0,-84.0,-77.0,-86.0,8.0,20.0,7.0,18.0,1
160,F8:59:71:5A:E0:3D,2157752,284645075,7957,11903688,2149795,272741387,0,5221,7029643,5176,7021580,45,8063,5185,2,7968,761,0,6,144444.0,43333.0,-65.0,-73.0,-67.0,-70.0,-66.0,-73.0,-65.0,-69.0,-77.0,-84.0,-77.0,-86.0,12.0,11.0,10.0,16.0,1
161,CC:2F:71:3E:C5:1F,2149837,272746531,42,5144,2149795,272741387,0,189,16116,161,12700,28,3416,47,1,70,2,0,7,130000.0,39000.0,-70.0,-70.0,-66.0,-60.0,-70.0,-69.0,-66.0,-59.0,-77.0,-84.0,-77.0,-86.0,7.0,14.0,11.0,26.0,1
162,CC:2F:71:3F:1F:24,2219780,366109874,69985,93368487,2149795,272741387,3,42931,46164169,42882,46157841,49,6328,41634,138,70007,15898,3,43,144444.0,43333.0,-68.0,-63.0,-70.0,-68.0,-68.0,-63.0,-69.0,-68.0,-77.0,-84.0,-77.0,-86.0,9.0,21.0,7.0,18.0,1
163,F8:59:71:5A:E0:3D,2157818,284741659,8019,11999868,2149799,272741791,0,5283,7125123,5238,7117060,45,8063,5247,2,8030,761,0,6,144444.0,43333.0,-67.0,-74.0,-65.0,-69.0,-66.0,-74.0,-65.0,-69.0,-77.0,-84.0,-77.0,-86.0,10.0,10.0,12.0,17.0,1
164,CC:2F:71:3E:C5:1F,2149841,272746935,42,5144,2149799,272741791,0,191,16256,163,12840,28,3416,47,1,71,2,0,7,130000.0,39000.0,-70.0,-70.0,-67.0,-60.0,-70.0,-69.0,-66.0,-59.0,-77.0,-84.0,-77.0,-86.0,7.0,14.0,10.0,26.0,1
165,CC:2F:71:3F:1F:24,2219939,366313244,70140,93571453,2149799,272741791,3,43080,46367809,43031,46361481,49,6328,41777,138,70162,15898,3,43,144444.0,43333.0,-69.0,-63.0,-71.0,-67.0,-68.0,-63.0,-69.0,-67.0,-77.0,-84.0,-77.0,-86.0,8.0,21.0,6.0,19.0,1
166,F8:59:71:5A:E0:3D,2157886,284840025,8082,12097770,2149804,272742255,0,5346,7222143,5301,7214080,45,8063,5310,2,8093,761,0,6,144444.0,43333.0,-66.0,-74.0,-67.0,-70.0,-66.0,-73.0,-65.0,-69.0,-77.0,-84.0,-77.0,-86.0,11.0,10.0,10.0,16.0,1
167,CC:2F:71:3E:C5:1F,2149846,272747399,42,5144,2149804,272742255,0,191,16256,163,12840,28,3416,47,1,71,2,0,7,130000.0,39000.0,-70.0,-70.0,-67.0,-60.0,-70.0,-69.0,-66.0,-59.0,-77.0,-84.0,-77.0,-86.0,7.0,14.0,10.0,26.0,1
168,CC:2F:71:3F:1F:24,2220111,366524176,70307,93781921,2149804,272742255,3,43241,46578080,43192,46571752,49,6328,41931,138,70329,15899,3,43,144444.0,43333.0,-69.0,-63.0,-69.0,-68.0,-68.0,-63.0,-69.0,-67.0,-77.0,-84.0,-77.0,-86.0,8.0,21.0,8.0,18.0,1
169,F8:59:71:5A:E0:3D,2157955,284940001,8147,12197342,2149808,272742659,0,5410,7320703,5365,7312640,45,8063,5374,2,8158,761,0,6,144444.0,43333.0,-66.0,-74.0,-67.0,-69.0,-66.0,-73.0,-65.0,-69.0,-77.0,-84.0,-77.0,-86.0,11.0,10.0,10.0,17.0,1
170,CC:2F:71:3E:C5:1F,2149851,272747919,43,5260,2149808,272742659,0,192,16326,164,12910,28,3416,47,1,72,2,0,7,130000.0,39000.0,-70.0,-69.0,-67.0,-60.0,-70.0,-68.0,-66.0,-59.0,-77.0,-84.0,-77.0,-86.0,7.0,15.0,10.0,26.0,1
171,CC:2F:71:3F:1F:24,2220281,366737219,70473,93994560,2149808,272742659,3,43402,46794986,43353,46788658,49,6328,42081,138,70495,15899,3,43,144444.0,43333.0,-68.0,-63.0,-70.0,-68.0,-68.0,-63.0,-70.0,-67.0,-77.0,-84.0,-77.0,-86.0,9.0,21.0,7.0,18.0,1
172,F8:59:71:5A:E0:3D,2158023,285038580,8210,12295244,2149813,272743336,0,5473,7417723,5428,7409660,45,8063,5437,2,8221,761,0,6,144444.0,43333.0,-67.0,-74.0,-65.0,-70.0,-66.0,-73.0,-65.0,-69.0,-77.0,-84.0,-77.0,-86.0,10.0,10.0,12.0,16.0,1
173,CC:2F:71:3E:C5:1F,2149856,272748596,43,5260,2149813,272743336,0,193,16396,165,12980,28,3416,47,1,72,2,0,7,130000.0,39000.0,-70.0,-70.0,-67.0,-60.0,-70.0,-69.0,-66.0,-60.0,-77.0,-84.0,-77.0,-86.0,7.0,14.0,10.0,26.0,1
174,CC:2F:71:3F:1F:24,2220459,366948049,70646,94204713,2149813,272743336,3,43561,47006083,43512,46999755,49,6328,42234,138,70668,15900,3,43,144444.0,43333.0,-68.0,-64.0,-70.0,-68.0,-69.0,-63.0,-70.0,-67.0,-77.0,-84.0,-77.0,-86.0,9.0,20.0,7.0,18.0,1
175,F8:59:71:5A:E0:3D,2158219,285335775,8401,12591975,2149818,272743800,0,5550,7519615,5505,7511552,45,8063,5514,2,8412,761,0,6,144444.0,43333.0,-67.0,-74.0,-65.0,-70.0,-66.0,-74.0,-65.0,-69.0,-77.0,-84.0,-77.0,-86.0,10.0,10.0,12.0,16.0,1
176,CC:2F:71:3E:C5:1F,2149861,272749060,43,5260,2149818,272743800,0,193,16396,165,12980,28,3416,47,1,72,2,0,7,130000.0,39000.0,-70.0,-70.0,-67.0,-60.0,-70.0,-69.0,-66.0,-60.0,-77.0,-84.0,-77.0,-86.0,7.0,14.0,10.0,26.0,1
177,CC:2F:71:3F:1F:24,2220619,367151479,70801,94407679,2149818,272743800,3,43711,47214285,43662,47207957,49,6328,42374,138,70823,15900,3,44,144444.0,43333.0,-69.0,-63.0,-69.0,-68.0,-69.0,-63.0,-69.0,-68.0,-77.0,-84.0,-77.0,-86.0,8.0,21.0,8.0,18.0,1
178,F8:59:71:5A:E0:3D,2158285,285432527,8463,12688323,2149822,272744204,0,5612,7615095,5567,7607032,45,8063,5576,2,8474,761,0,6,144444.0,43333.0,-66.0,-74.0,-66.0,-69.0,-66.0,-73.0,-65.0,-69.0,-77.0,-84.0,-77.0,-86.0,11.0,10.0,11.0,17.0,1
179,CC:2F:71:3E:C5:1F,2149865,272749464,43,5260,2149822,272744204,0,193,16396,165,12980,28,3416,47,1,72,2,0,7,130000.0,39000.0,-70.0,-70.0,-67.0,-60.0,-70.0,-69.0,-66.0,-60.0,-77.0,-84.0,-77.0,-86.0,7.0,14.0,10.0,26.0,1
180,CC:2F:71:3F:1F:24,2220779,367354979,70957,94610775,2149822,272744204,3,43860,47416407,43811,47410079,49,6328,42518,138,70979,15900,3,44,144444.0,43333.0,-69.0,-63.0,-69.0,-68.0,-69.0,-63.0,-69.0,-68.0,-77.0,-84.0,-77.0,-86.0,8.0,21.0,8.0,18.0,1
181,F8:59:71:5A:E0:3D,2158551,285846774,8729,13102570,2149822,272744204,0,5696,7716445,5651,7708382,45,8063,5660,2,8740,761,0,6,144444.0,43333.0,-66.0,-73.0,-66.0,-70.0,-66.0,-73.0,-65.0,-69.0,-77.0,-84.0,-77.0,-86.0,11.0,11.0,11.0,16.0,1
182,CC:2F:71:3E:C5:1F,2149865,272749464,43,5260,2149822,272744204,0,193,16396,165,12980,28,3416,47,1,72,2,0,7,130000.0,39000.0,-70.0,-70.0,-67.0,-60.0,-70.0,-69.0,-66.0,-60.0,-77.0,-84.0,-77.0,-86.0,7.0,14.0,10.0,26.0,1
183,CC:2F:71:3F:1F:24,2220946,367563434,71122,94819028,2149824,272744406,3,44020,47624920,43971,47618592,49,6328,42670,138,71143,15901,3,44,144444.0,43333.0,-68.0,-63.0,-69.0,-68.0,-69.0,-63.0,-69.0,-68.0,-77.0,-84.0,-77.0,-86.0,9.0,21.0,8.0,18.0,1
184,F8:59:71:5A:E0:3D,2158620,285943788,8791,13198918,2149829,272744870,0,5760,7815019,5715,7806956,45,8063,5723,2,8802,761,0,6,144444.0,43333.0,-68.0,-74.0,-65.0,-69.0,-66.0,-73.0,-65.0,-69.0,-77.0,-84.0,-77.0,-86.0,9.0,10.0,12.0,17.0,1
185,CC:2F:71:3E:C5:1F,2149874,272750332,43,5260,2149831,272745072,0,193,16396,165,12980,28,3416,47,1,72,2,0,7,130000.0,39000.0,-70.0,-70.0,-67.0,-60.0,-70.0,-69.0,-66.0,-60.0,-77.0,-84.0,-77.0,-86.0,7.0,14.0,10.0,26.0,1
186,CC:2F:71:3F:1F:24,2221111,367769250,71280,95024178,2149831,272745072,3,44169,47829966,44120,47823638,49,6328,42813,138,71302,15901,3,45,144444.0,43333.0,-69.0,-64.0,-69.0,-69.0,-68.0,-63.0,-69.0,-68.0,-77.0,-84.0,-77.0,-86.0,8.0,20.0,8.0,17.0,1
187,F8:59:71:5A:E0:3D,2158684,286040338,8853,13295266,2149831,272745072,0,5822,7910499,5777,7902436,45,8063,5785,2,8864,762,0,6,144444.0,43333.0,-66.0,-74.0,-65.0,-70.0,-66.0,-73.0,-65.0,-69.0,-77.0,-85.0,-77.0,-86.0,11.0,11.0,12.0,16.0,1
188,CC:2F:71:3E:C5:1F,2149874,272750332,43,5260,2149831,272745072,0,193,16396,165,12980,28,3416,47,1,72,2,0,7,130000.0,39000.0,-70.0,-70.0,-67.0,-60.0,-70.0,-69.0,-66.0,-60.0,-77.0,-85.0,-77.0,-86.0,7.0,15.0,10.0,26.0,1
189,CC:2F:71:3F:1F:24,2221268,367972462,71437,95227390,2149831,272745072,3,44313,48027274,44264,48020946,49,6328,42955,138,71459,15901,3,45,144444.0,43333.0,-70.0,-64.0,-69.0,-69.0,-69.0,-63.0,-69.0,-68.0,-77.0,-85.0,-77.0,-86.0,7.0,21.0,8.0,17.0,1
190,F8:59:71:5A:E0:3D,2158752,286140198,8917,13394722,2149835,272745476,0,5885,8007519,5840,7999456,45,8063,5848,2,8928,762,0,6,144444.0,43333.0,-66.0,-74.0,-66.0,-69.0,-66.0,-73.0,-65.0,-69.0,-77.0,-85.0,-77.0,-86.0,11.0,11.0,11.0,17.0,1
191,CC:2F:71:3E:C5:1F,2149879,272750798,43,5260,2149836,272745538,0,193,16396,165,12980,28,3416,47,1,72,2,0,7,130000.0,39000.0,-70.0,-70.0,-67.0,-60.0,-70.0,-69.0,-66.0,-60.0,-77.0,-85.0,-77.0,-86.0,7.0,15.0,10.0,26.0,1
192,CC:2F:71:3F:1F:24,2221430,368179002,71594,95433464,2149836,272745538,3,44467,48238604,44418,48232276,49,6328,43100,138,71616,15901,3,45,144444.0,43333.0,-69.0,-63.0,-69.0,-68.0,-69.0,-63.0,-69.0,-68.0,-77.0,-85.0,-77.0,-86.0,8.0,22.0,8.0,18.0,1
193,F8:59:71:5A:E0:3D,2158866,286290021,9025,13544019,2149841,272746002,0,5970,8120453,5924,8112272,46,8181,5933,2,9036,762,0,6,144444.0,43333.0,-66.0,-73.0,-66.0,-70.0,-66.0,-73.0,-65.0,-69.0,-77.0,-85.0,-77.0,-86.0,11.0,12.0,11.0,16.0,1
194,CC:2F:71:3E:C5:1F,2149884,272751262,43,5260,2149841,272746002,0,193,16396,165,12980,28,3416,47,1,72,2,0,7,130000.0,39000.0,-70.0,-70.0,-67.0,-60.0,-70.0,-69.0,-66.0,-60.0,-77.0,-85.0,-77.0,-86.0,7.0,15.0,10.0,26.0,1
195,CC:2F:71:3F:1F:24,2221605,368403022,71764,95657020,2149841,272746002,3,44633,48464174,44584,48457846,49,6328,43257,138,71785,15901,3,45,144444.0,43333.0,-69.0,-64.0,-69.0,-68.0,-69.0,-63.0,-69.0,-68.0,-77.0,-85.0,-77.0,-86.0,8.0,21.0,8.0,18.0,1
196,F8:59:71:5A:E0:3D,2158932,286386773,9087,13640367,2149845,272746406,0,6033,8217473,5987,8209292,46,8181,5996,2,9098,762,0,6,144444.0,43333.0,-67.0,-74.0,-65.0,-70.0,-66.0,-73.0,-66.0,-69.0,-77.0,-85.0,-78.0,-86.0,10.0,11.0,13.0,16.0,1
197,CC:2F:71:3E:C5:1F,2149888,272751666,43,5260,2149845,272746406,0,193,16396,165,12980,28,3416,47,1,72,2,0,7,130000.0,39000.0,-70.0,-70.0,-67.0,-60.0,-70.0,-69.0,-66.0,-60.0,-77.0,-85.0,-78.0,-86.0,7.0,15.0,11.0,26.0,1
198,CC:2F:71:3F:1F:24,2221771,368608439,71926,95862033,2149845,272746406,3,44785,48664273,44736,48657945,49,6328,43405,138,71948,15901,3,45,144444.0,43333.0,-69.0,-63.0,-70.0,-68.0,-69.0,-63.0,-69.0,-68.0,-77.0,-85.0,-78.0,-86.0,8.0,22.0,8.0,18.0,1
199,F8:59:71:5A:E0:3D,2159098,286635943,9249,13889133,2149849,272746810,0,6109,8317895,6063,8309714,46,8181,6072,2,9260,762,0,6,144444.0,43333.0,-66.0,-73.0,-66.0,-70.0,-66.0,-73.0,-65.0,-69.0,-77.0,-85.0,-78.0,-86.0,11.0,12.0,12.0,16.0,1
200,CC:2F:71:3E:C5:1F,2149893,272752132,43,5260,2149850,272746872,0,193,16396,165,12980,28,3416,47,1,72,2,0,7,130000.0,39000.0,-70.0,-70.0,-67.0,-60.0,-70.0,-69.0,-66.0,-60.0,-77.0,-85.0,-78.0,-86.0,7.0,15.0,11.0,26.0,1
201,CC:2F:71:3F:1F:24,2221934,368813615,72083,96066683,2149851,272746932,3,44931,48866035,44881,48859589,50,6446,43547,138,72104,15902,3,45,144444.0,43333.0,-69.0,-64.0,-69.0,-68.0,-68.0,-63.0,-69.0,-68.0,-77.0,-85.0,-78.0,-86.0,8.0,21.0,9.0,18.0,1
202,F8:59:71:5A:E0:3D,2159183,286758733,9328,14011397,2149855,272747336,0,6174,8415147,6128,8406966,46,8181,6137,2,9339,762,0,6,144444.0,43333.0,-66.0,-74.0,-66.0,-70.0,-66.0,-74.0,-65.0,-69.0,-77.0,-85.0,-78.0,-86.0,11.0,11.0,12.0,16.0,1
203,CC:2F:71:3E:C5:1F,2149898,272752596,43,5260,2149855,272747336,0,193,16396,165,12980,28,3416,47,1,72,2,0,7,130000.0,39000.0,-70.0,-70.0,-67.0,-60.0,-70.0,-69.0,-66.0,-60.0,-77.0,-85.0,-78.0,-86.0,7.0,15.0,11.0,26.0,1
204,CC:2F:71:3F:1F:24,2222093,369015561,72238,96268225,2149855,272747336,3,45080,49072457,45030,49066011,50,6446,43689,138,72260,15902,3,45,144444.0,43333.0,-69.0,-64.0,-69.0,-68.0,-69.0,-64.0,-69.0,-68.0,-77.0,-85.0,-78.0,-86.0,8.0,21.0,9.0,18.0,1
205,F8:59:71:5A:E0:3D,2159261,286860016,9401,14112214,2149860,272747802,0,6246,8517320,6200,8509139,46,8181,6209,2,9412,762,0,6,144444.0,43333.0,-65.0,-73.0,-67.0,-70.0,-66.0,-73.0,-66.0,-69.0,-77.0,-85.0,-78.0,-86.0,12.0,12.0,11.0,16.0,1
206,CC:2F:71:3E:C5:1F,2149903,272753062,43,5260,2149860,272747802,0,195,16584,166,13050,29,3534,48,1,72,2,0,7,130000.0,39000.0,-69.0,-70.0,-66.0,-60.0,-70.0,-69.0,-66.0,-60.0,-77.0,-85.0,-78.0,-86.0,8.0,15.0,12.0,26.0,1
207,CC:2F:71:3F:1F:24,2222267,369227201,72407,96479399,2149860,272747802,3,45233,49277973,45183,49271527,50,6446,43836,138,72429,15902,3,45,144444.0,43333.0,-69.0,-64.0,-69.0,-69.0,-69.0,-63.0,-69.0,-68.0,-77.0,-85.0,-78.0,-86.0,8.0,21.0,9.0,17.0,1
208,F8:59:71:5A:E0:3D,2159325,286956566,9463,14208562,2149862,272748004,0,6309,8614354,6263,8606173,46,8181,6271,2,9474,762,0,6,144444.0,43333.0,-66.0,-74.0,-66.0,-70.0,-66.0,-73.0,-65.0,-69.0,-77.0,-85.0,-78.0,-86.0,11.0,11.0,12.0,16.0,1
209,CC:2F:71:3E:C5:1F,2149906,272753324,43,5260,2149863,272748064,0,195,16584,166,13050,29,3534,48,1,72,2,0,7,130000.0,39000.0,-69.0,-70.0,-66.0,-60.0,-70.0,-69.0,-66.0,-60.0,-77.0,-85.0,-78.0,-86.0,8.0,15.0,12.0,26.0,1
210,CC:2F:71:3F:1F:24,2222435,369434232,72570,96685966,2149865,272748266,3,45384,49476614,45334,49470168,50,6446,43984,138,72592,15902,3,45,144444.0,43333.0,-70.0,-64.0,-67.0,-68.0,-69.0,-63.0,-68.0,-68.0,-77.0,-85.0,-78.0,-86.0,7.0,21.0,11.0,18.0,1
211,F8:59:71:5A:E0:3D,2159394,287053580,9525,14304910,2149869,272748670,0,6372,8711388,6326,8703207,46,8181,6333,2,9535,762,0,6,144444.0,43333.0,-66.0,-73.0,-66.0,-70.0,-66.0,-73.0,-65.0,-69.0,-77.0,-85.0,-78.0,-86.0,11.0,12.0,12.0,16.0,1
212,CC:2F:71:3E:C5:1F,2149912,272753930,43,5260,2149869,272748670,0,195,16584,166,13050,29,3534,48,1,72,2,0,7,130000.0,39000.0,-69.0,-70.0,-66.0,-60.0,-70.0,-69.0,-66.0,-60.0,-77.0,-85.0,-78.0,-86.0,8.0,15.0,12.0,26.0,1
213,CC:2F:71:3F:1F:24,2222595,369637732,72726,96889062,2149869,272748670,3,45539,49688202,45489,49681756,50,6446,44127,138,72748,15903,3,45,144444.0,43333.0,-69.0,-64.0,-69.0,-68.0,-68.0,-63.0,-69.0,-68.0,-77.0,-85.0,-78.0,-86.0,8.0,21.0,9.0,18.0,1
214,F8:59:71:5A:E0:3D,2159460,287150572,9588,14401427,2149872,272749145,0,6436,8807139,6390,8798958,46,8181,6397,2,9599,762,0,6,144444.0,43333.0,-66.0,-74.0,-66.0,-70.0,-66.0,-73.0,-66.0,-70.0,-77.0,-85.0,-78.0,-86.0,11.0,11.0,12.0,16.0,1
215,CC:2F:71:3E:C5:1F,2149915,272754405,43,5260,2149872,272749145,0,195,16584,166,13050,29,3534,48,1,72,2,0,7,130000.0,39000.0,-69.0,-70.0,-66.0,-60.0,-70.0,-69.0,-66.0,-60.0,-77.0,-85.0,-78.0,-86.0,8.0,15.0,12.0,26.0,1
216,CC:2F:71:3F:1F:24,2222756,369844243,72884,97095098,2149872,272749145,3,45689,49896164,45639,49889718,50,6446,44270,138,72905,15903,3,45,144444.0,43333.0,-70.0,-64.0,-69.0,-69.0,-69.0,-64.0,-69.0,-68.0,-77.0,-85.0,-78.0,-86.0,7.0,21.0,9.0,17.0,1
217,F8:59:71:5A:E0:3D,2159645,287432797,9770,14683390,2149875,272749407,0,6511,8907375,6465,8899194,46,8181,6472,2,9781,762,0,6,144444.0,43333.0,-66.0,-74.0,-66.0,-70.0,-66.0,-73.0,-65.0,-70.0,-77.0,-85.0,-78.0,-86.0,11.0,11.0,12.0,16.0,1
218,CC:2F:71:3E:C5:1F,2149922,272755071,43,5260,2149879,272749811,0,195,16584,166,13050,29,3534,48,1,72,2,0,7,130000.0,39000.0,-69.0,-70.0,-66.0,-60.0,-70.0,-69.0,-66.0,-60.0,-77.0,-85.0,-78.0,-86.0,8.0,15.0,12.0,26.0,1
219,CC:2F:71:3F:1F:24,2222919,370045157,73040,97295346,2149879,272749811,3,45832,50090477,45782,50084031,50,6446,44412,138,73062,15903,3,45,144444.0,43333.0,-70.0,-64.0,-70.0,-68.0,-69.0,-64.0,-69.0,-68.0,-77.0,-85.0,-78.0,-86.0,7.0,21.0,8.0,18.0,1
220,F8:59:71:5A:E0:3D,2159717,287531890,9838,14782079,2149879,272749811,0,6577,9005525,6531,8997344,46,8181,6538,2,9849,763,0,6,144444.0,43333.0,-66.0,-74.0,-66.0,-70.0,-65.0,-73.0,-65.0,-70.0,-77.0,-85.0,-78.0,-86.0,11.0,11.0,12.0,16.0,1
221,CC:2F:71:3E:C5:1F,2149922,272755071,43,5260,2149879,272749811,0,195,16584,166,13050,29,3534,48,1,72,2,0,7,130000.0,39000.0,-69.0,-70.0,-66.0,-60.0,-70.0,-69.0,-66.0,-60.0,-77.0,-85.0,-78.0,-86.0,8.0,15.0,12.0,26.0,1
222,CC:2F:71:3F:1F:24,2223097,370258246,73216,97508233,2149881,272750013,3,45999,50297366,45949,50290920,50,6446,44574,138,73238,15904,3,45,144444.0,43333.0,-70.0,-64.0,-69.0,-68.0,-69.0,-64.0,-69.0,-68.0,-77.0,-85.0,-78.0,-86.0,7.0,21.0,9.0,18.0,1
223,F8:59:71:5A:E0:3D,2159785,287631750,9902,14881535,2149883,272750215,0,6643,9104225,6597,9096044,46,8181,6602,2,9913,763,0,6,144444.0,43333.0,-66.0,-73.0,-65.0,-69.0,-66.0,-73.0,-65.0,-69.0,-77.0,-85.0,-78.0,-86.0,11.0,12.0,13.0,17.0,1
224,CC:2F:71:3E:C5:1F,2149926,272755475,43,5260,2149883,272750215,0,195,16584,166,13050,29,3534,48,1,72,2,0,7,130000.0,39000.0,-69.0,-70.0,-66.0,-60.0,-70.0,-69.0,-66.0,-60.0,-77.0,-85.0,-78.0,-86.0,8.0,15.0,12.0,26.0,1
225,CC:2F:71:3F:1F:24,2223265,370474178,73380,97723761,2149885,272750417,3,46156,50509102,46106,50502656,50,6446,44727,138,73402,15905,3,45,144444.0,43333.0,-69.0,-63.0,-69.0,-68.0,-69.0,-63.0,-69.0,-68.0,-77.0,-85.0,-78.0,-86.0,8.0,22.0,9.0,18.0,1
226,F8:59:71:5A:E0:3D,2159855,287733224,9967,14982545,2149888,272750679,0,6710,9204465,6664,9196284,46,8181,6667,2,9977,763,0,6,144444.0,43333.0,-67.0,-74.0,-65.0,-70.0,-66.0,-73.0,-65.0,-70.0,-77.0,-85.0,-78.0,-86.0,10.0,11.0,13.0,16.0,1
227,CC:2F:71:3E:C5:1F,2149931,272755939,43,5260,2149888,272750679,0,195,16584,166,13050,29,3534,48,1,72,2,0,7,130000.0,39000.0,-69.0,-70.0,-66.0,-60.0,-70.0,-69.0,-66.0,-60.0,-77.0,-85.0,-78.0,-86.0,8.0,15.0,12.0,26.0,1
228,CC:2F:71:3F:1F:24,2223429,370681034,73541,97930355,2149888,272750679,3,46307,50716117,46257,50709671,50,6446,44871,138,73563,15905,3,45,144444.0,43333.0,-70.0,-64.0,-70.0,-68.0,-69.0,-63.0,-69.0,-68.0,-77.0,-85.0,-78.0,-86.0,7.0,21.0,8.0,18.0,1
229,F8:59:71:5A:E0:3D,2159920,287828422,10028,15077339,2149892,272751083,0,6772,9299959,6726,9291778,46,8181,6728,2,10039,763,0,6,144444.0,43333.0,-66.0,-74.0,-66.0,-70.0,-66.0,-74.0,-65.0,-69.0,-77.0,-85.0,-78.0,-86.0,11.0,11.0,12.0,16.0,1
230,CC:2F:71:3E:C5:1F,2149935,272756343,43,5260,2149892,272751083,0,195,16584,166,13050,29,3534,48,1,72,2,0,7,130000.0,39000.0,-69.0,-70.0,-66.0,-60.0,-70.0,-69.0,-66.0,-60.0,-77.0,-85.0,-78.0,-86.0,8.0,15.0,12.0,26.0,1
231,CC:2F:71:3F:1F:24,2223593,370885196,73701,98134113,2149892,272751083,3,46453,50915054,46403,50908608,50,6446,45014,138,73723,15905,3,45,144444.0,43333.0,-70.0,-64.0,-69.0,-69.0,-69.0,-63.0,-69.0,-68.0,-77.0,-85.0,-78.0,-86.0,7.0,21.0,9.0,17.0,1
232,F8:59:71:5A:E0:3D,2160179,288226225,10283,15474738,2149896,272751487,0,6862,9403409,6816,9395228,46,8181,6816,2,10293,763,0,6,144444.0,43333.0,-67.0,-74.0,-66.0,-70.0,-66.0,-73.0,-65.0,-70.0,-77.0,-85.0,-78.0,-86.0,10.0,11.0,12.0,16.0,1
233,CC:2F:71:3E:C5:1F,2149939,272756747,43,5260,2149896,272751487,0,195,16584,166,13050,29,3534,48,1,72,2,0,7,130000.0,39000.0,-69.0,-70.0,-66.0,-60.0,-70.0,-69.0,-66.0,-60.0,-77.0,-85.0,-78.0,-86.0,8.0,15.0,12.0,26.0,1
234,CC:2F:71:3F:1F:24,2223753,371087276,73857,98335789,2149896,272751487,3,46611,51129867,46561,51123421,50,6446,45156,138,73878,15905,3,45,144444.0,43333.0,-68.0,-64.0,-68.0,-68.0,-69.0,-63.0,-69.0,-68.0,-77.0,-85.0,-78.0,-86.0,9.0,21.0,10.0,18.0,1
235,F8:59:71:5A:E0:3D,2160247,288321743,10346,15569792,2149901,272751951,0,6925,9497581,6879,9489400,46,8181,6879,2,10357,764,0,6,144444.0,43333.0,-66.0,-74.0,-67.0,-70.0,-66.0,-73.0,-65.0,-70.0,-77.0,-85.0,-78.0,-86.0,11.0,11.0,11.0,16.0,1
236,CC:2F:71:3E:C5:1F,2149944,272757211,43,5260,2149901,272751951,0,195,16584,166,13050,29,3534,48,1,72,2,0,7,130000.0,39000.0,-69.0,-70.0,-66.0,-60.0,-70.0,-69.0,-66.0,-60.0,-77.0,-85.0,-78.0,-86.0,8.0,15.0,12.0,26.0,1
237,CC:2F:71:3F:1F:24,2223937,371298612,74036,98546661,2149901,272751951,3,46779,51335444,46729,51328998,50,6446,45319,138,74057,15905,3,45,144444.0,43333.0,-69.0,-64.0,-69.0,-68.0,-69.0,-64.0,-69.0,-68.0,-77.0,-85.0,-78.0,-86.0,8.0,21.0,9.0,18.0,1
238,F8:59:71:5A:E0:3D,2160346,288462622,10441,15710267,2149905,272752355,0,6996,9600601,6950,9592420,46,8181,6950,2,10452,764,0,6,144444.0,43333.0,-67.0,-74.0,-66.0,-70.0,-66.0,-73.0,-65.0,-70.0,-77.0,-85.0,-78.0,-86.0,10.0,11.0,12.0,16.0,1
239,CC:2F:71:3E:C5:1F,2149948,272757615,43,5260,2149905,272752355,0,195,16584,166,13050,29,3534,48,1,72,2,0,7,130000.0,39000.0,-69.0,-70.0,-66.0,-60.0,-70.0,-69.0,-66.0,-60.0,-77.0,-85.0,-78.0,-86.0,8.0,15.0,12.0,26.0,1
240,CC:2F:71:3F:1F:24,2224097,371500727,74192,98748372,2149905,272752355,3,46933,51548265,46883,51541819,50,6446,45460,138,74214,15905,3,45,144444.0,43333.0,-70.0,-64.0,-70.0,-69.0,-69.0,-63.0,-69.0,-68.0,-77.0,-85.0,-78.0,-86.0,7.0,21.0,8.0,17.0,1
241,F8:59:71:5A:E0:3D,2160410,288559172,10503,15806615,2149907,272752557,0,7058,9696081,7012,9687900,46,8181,7012,2,10514,764,0,6,144444.0,43333.0,-66.0,-74.0,-66.0,-69.0,-66.0,-73.0,-65.0,-69.0,-77.0,-85.0,-77.0,-86.0,11.0,11.0,11.0,17.0,1
242,CC:2F:71:3E:C5:1F,2149950,272757817,43,5260,2149907,272752557,0,195,16584,166,13050,29,3534,48,1,72,2,0,7,130000.0,39000.0,-69.0,-70.0,-66.0,-60.0,-70.0,-69.0,-66.0,-60.0,-77.0,-85.0,-77.0,-86.0,8.0,15.0,11.0,26.0,1
243,CC:2F:71:3F:1F:24,2224257,371707133,74350,98954576,2149907,272752557,3,47080,51751579,47030,51745133,50,6446,45602,138,74372,15907,3,45,144444.0,43333.0,-69.0,-64.0,-68.0,-68.0,-69.0,-64.0,-68.0,-68.0,-77.0,-85.0,-77.0,-86.0,8.0,21.0,9.0,18.0,1
244,F8:59:71:5A:E0:3D,2160484,288659752,10570,15906529,2149914,272753223,0,7126,9796999,7080,9788818,46,8181,7080,2,10581,764,0,6,144444.0,43333.0,-66.0,-73.0,-66.0,-70.0,-66.0,-73.0,-65.0,-70.0,-77.0,-85.0,-77.0,-86.0,11.0,12.0,11.0,16.0,1
245,CC:2F:71:3E:C5:1F,2149957,272758483,43,5260,2149914,272753223,0,195,16584,166,13050,29,3534,48,1,72,2,0,7,130000.0,39000.0,-69.0,-70.0,-66.0,-60.0,-70.0,-69.0,-66.0,-60.0,-77.0,-85.0,-77.0,-86.0,8.0,15.0,11.0,26.0,1
246,CC:2F:71:3F:1F:24,2224420,371910895,74506,99157672,2149914,272753223,3,47223,51950129,47173,51943683,50,6446,45742,138,74528,15907,3,45,144444.0,43333.0,-69.0,-64.0,-69.0,-69.0,-69.0,-64.0,-69.0,-68.0,-77.0,-85.0,-77.0,-86.0,8.0,21.0,8.0,17.0,1
247,F8:59:71:5A:E0:3D,2160548,288756302,10632,16002877,2149916,272753425,0,7189,9894033,7143,9885852,46,8181,7142,2,10643,764,0,6,144444.0,43333.0,-66.0,-74.0,-67.0,-70.0,-66.0,-73.0,-66.0,-70.0,-77.0,-85.0,-77.0,-86.0,11.0,11.0,10.0,16.0,1
248,CC:2F:71:3E:C5:1F,2149959,272758685,43,5260,2149916,272753425,0,195,16584,166,13050,29,3534,48,1,72,2,0,7,130000.0,39000.0,-69.0,-70.0,-66.0,-60.0,-70.0,-69.0,-66.0,-60.0,-77.0,-85.0,-77.0,-86.0,8.0,15.0,11.0,26.0,1
249,CC:2F:71:3F:1F:24,2224585,372117664,74669,99364239,2149916,272753425,3,47382,52158311,47332,52151865,50,6446,45893,138,74691,15907,3,45,144444.0,43333.0,-69.0,-64.0,-68.0,-68.0,-69.0,-64.0,-68.0,-68.0,-77.0,-85.0,-77.0,-86.0,8.0,21.0,9.0,18.0,1
250,F8:59:71:5A:E0:3D,2160612,288852852,10694,16099225,2149918,272753627,0,7251,9989513,7205,9981332,46,8181,7204,2,10705,764,0,6,144444.0,43333.0,-66.0,-73.0,-65.0,-71.0,-66.0,-73.0,-65.0,-70.0,-77.0,-85.0,-77.0,-86.0,11.0,12.0,12.0,15.0,1
251,CC:2F:71:3E:C5:1F,2149961,272758887,43,5260,2149918,272753627,0,197,16724,168,13190,29,3534,48,1,73,2,0,7,130000.0,39000.0,-71.0,-70.0,-66.0,-60.0,-69.0,-68.0,-66.0,-60.0,-77.0,-85.0,-77.0,-86.0,6.0,15.0,11.0,26.0,1
252,CC:2F:71:3F:1F:24,2224753,372322362,74831,99568331,2149922,272754031,3,47538,52362824,47488,52356378,50,6446,46043,138,74853,15907,3,45,144444.0,43333.0,-69.0,-64.0,-69.0,-68.0,-69.0,-64.0,-69.0,-68.0,-77.0,-85.0,-77.0,-86.0,8.0,21.0,8.0,18.0,1
253,F8:59:71:5A:E0:3D,2160679,288949664,10756,16195573,2149923,272754091,0,7313,10084993,7267,10076812,46,8181,7266,2,10767,764,0,6,144444.0,43333.0,-66.0,-74.0,-66.0,-70.0,-66.0,-73.0,-65.0,-70.0,-77.0,-85.0,-77.0,-86.0,11.0,11.0,11.0,16.0,1
254,CC:2F:71:3E:C5:1F,2149968,272759553,43,5260,2149925,272754293,0,197,16724,168,13190,29,3534,48,1,73,2,0,7,130000.0,39000.0,-71.0,-70.0,-66.0,-60.0,-69.0,-68.0,-66.0,-60.0,-77.0,-85.0,-77.0,-86.0,6.0,15.0,11.0,26.0,1
255,CC:2F:71:3F:1F:24,2224913,372525836,74988,99771543,2149925,272754293,3,47691,52575466,47641,52569020,50,6446,46184,138,75010,15907,3,45,144444.0,43333.0,-69.0,-64.0,-69.0,-69.0,-69.0,-63.0,-69.0,-68.0,-77.0,-85.0,-77.0,-86.0,8.0,21.0,8.0,17.0,1
256,F8:59:71:5A:E0:3D,2160746,289046532,10819,16292037,2149927,272754495,0,7375,10180473,7329,10172292,46,8181,7328,2,10830,764,0,6,144444.0,43333.0,-67.0,-74.0,-66.0,-70.0,-66.0,-73.0,-66.0,-70.0,-77.0,-85.0,-77.0,-86.0,10.0,11.0,11.0,16.0,1
257,CC:2F:71:3E:C5:1F,2149971,272759871,44,5376,2149927,272754495,0,199,16864,170,13330,29,3534,48,1,74,2,0,7,130000.0,39000.0,-70.0,-69.0,-66.0,-60.0,-69.0,-68.0,-66.0,-60.0,-77.0,-85.0,-77.0,-86.0,7.0,16.0,11.0,26.0,1
258,CC:2F:71:3F:1F:24,2225094,372744141,75167,99989646,2149927,272754495,3,47856,52793442,47806,52786996,50,6446,46338,138,75187,15908,3,45,144444.0,43333.0,-70.0,-64.0,-70.0,-68.0,-69.0,-64.0,-69.0,-68.0,-77.0,-85.0,-77.0,-86.0,7.0,21.0,7.0,18.0,1
259,F8:59:71:5A:E0:3D,2160951,289347412,11019,16592240,2149932,272755172,0,7458,10287244,7412,10279063,46,8181,7411,2,11029,797,0,7,144444.0,43333.0,-67.0,-74.0,-65.0,-70.0,-66.0,-73.0,-66.0,-70.0,-77.0,-85.0,-77.0,-86.0,10.0,11.0,12.0,16.0,1
260,CC:2F:71:3E:C5:1F,2149976,272760548,44,5376,2149932,272755172,0,199,16864,170,13330,29,3534,48,1,74,2,0,7,130000.0,39000.0,-70.0,-69.0,-66.0,-60.0,-69.0,-68.0,-66.0,-60.0,-77.0,-85.0,-77.0,-86.0,7.0,16.0,11.0,26.0,1
261,CC:2F:71:3F:1F:24,2225255,372947914,75323,100192742,2149932,272755172,3,48006,53000088,47956,52993642,50,6446,46479,138,75345,15908,3,45,144444.0,43333.0,-70.0,-64.0,-69.0,-68.0,-69.0,-63.0,-68.0,-68.0,-77.0,-85.0,-77.0,-86.0,7.0,21.0,8.0,18.0,1
262,F8:59:71:5A:E0:3D,2161019,289444340,11082,16688704,2149937,272755636,0,7521,10382830,7475,10374649,46,8181,7474,2,11093,797,0,7,144444.0,43333.0,-66.0,-73.0,-66.0,-70.0,-66.0,-73.0,-66.0,-70.0,-77.0,-85.0,-77.0,-86.0,11.0,12.0,11.0,16.0,1
263,CC:2F:71:3E:C5:1F,2149981,272761012,44,5376,2149937,272755636,0,199,16864,170,13330,29,3534,48,1,74,2,0,7,130000.0,39000.0,-70.0,-69.0,-66.0,-60.0,-69.0,-68.0,-66.0,-60.0,-77.0,-85.0,-77.0,-86.0,7.0,16.0,11.0,26.0,1
264,CC:2F:71:3F:1F:24,2225426,373155373,75487,100399369,2149939,272756004,3,48165,53209603,48115,53203157,50,6446,46629,138,75509,15908,3,45,144444.0,43333.0,-69.0,-64.0,-69.0,-69.0,-69.0,-63.0,-68.0,-68.0,-77.0,-85.0,-77.0,-86.0,8.0,21.0,8.0,17.0,1
265,F8:59:71:5A:E0:3D,2161087,289541460,11144,16785052,2149943,272756408,0,7583,10478310,7537,10470129,46,8181,7536,2,11155,797,0,7,144444.0,43333.0,-66.0,-73.0,-66.0,-70.0,-66.0,-73.0,-66.0,-70.0,-77.0,-85.0,-77.0,-86.0,11.0,12.0,11.0,16.0,1
266,CC:2F:71:3E:C5:1F,2149987,272761784,44,5376,2149943,272756408,0,199,16864,170,13330,29,3534,48,1,74,2,0,7,130000.0,39000.0,-70.0,-69.0,-66.0,-60.0,-69.0,-68.0,-66.0,-60.0,-77.0,-85.0,-77.0,-86.0,7.0,16.0,11.0,26.0,1
267,CC:2F:71:3F:1F:24,2225586,373358873,75643,100602465,2149943,272756408,3,48315,53414889,48265,53408443,50,6446,46770,138,75664,15909,3,45,144444.0,43333.0,-69.0,-64.0,-70.0,-68.0,-69.0,-64.0,-69.0,-68.0,-77.0,-85.0,-77.0,-86.0,8.0,21.0,7.0,18.0,1
268,F8:59:71:5A:E0:3D,2161309,289880348,11364,17123738,2149945,272756610,0,7664,10579407,7618,10571226,46,8181,7617,2,11375,797,0,8,144444.0,43333.0,-66.0,-74.0,-66.0,-70.0,-66.0,-73.0,-65.0,-70.0,-77.0,-85.0,-77.0,-86.0,11.0,11.0,11.0,16.0,1
269,CC:2F:71:3E:C5:1F,2149989,272761986,44,5376,2149945,272756610,0,199,16864,170,13330,29,3534,48,1,74,2,0,7,130000.0,39000.0,-70.0,-69.0,-66.0,-60.0,-69.0,-68.0,-66.0,-60.0,-77.0,-85.0,-77.0,-86.0,7.0,16.0,11.0,26.0,1
270,CC:2F:71:3F:1F:24,2225746,373562373,75799,100805561,2149947,272756812,3,48471,53627965,48421,53621519,50,6446,46912,138,75821,15909,3,45,144444.0,43333.0,-69.0,-64.0,-69.0,-69.0,-69.0,-64.0,-69.0,-68.0,-77.0,-85.0,-77.0,-86.0,8.0,21.0,8.0,17.0,1
271,F8:59:71:5A:E0:3D,2161380,289981884,11429,17224748,2149951,272757136,0,7730,10679653,7683,10671354,47,8299,7683,2,11440,797,0,8,144444.0,43333.0,-66.0,-74.0,-67.0,-70.0,-66.0,-73.0,-66.0,-70.0,-77.0,-85.0,-78.0,-86.0,11.0,11.0,11.0,16.0,1
272,CC:2F:71:3E:C5:1F,2149997,272762714,44,5376,2149953,272757338,0,199,16864,170,13330,29,3534,48,1,74,2,0,7,130000.0,39000.0,-70.0,-69.0,-66.0,-60.0,-69.0,-68.0,-66.0,-60.0,-77.0,-85.0,-78.0,-86.0,7.0,16.0,12.0,26.0,1
273,CC:2F:71:3F:1F:24,2225914,373775319,75961,101017981,2149953,272757338,3,48627,53842473,48577,53836027,50,6446,47061,138,75983,15909,3,45,144444.0,43333.0,-70.0,-64.0,-70.0,-69.0,-69.0,-64.0,-69.0,-68.0,-77.0,-85.0,-78.0,-86.0,7.0,21.0,8.0,17.0,1
274,F8:59:71:5A:E0:3D,2161447,290078698,11491,17321096,2149956,272757602,0,7792,10775133,7745,10766834,47,8299,7745,2,11501,797,0,8,144444.0,43333.0,-66.0,-73.0,-66.0,-71.0,-66.0,-73.0,-65.0,-70.0,-77.0,-85.0,-78.0,-86.0,11.0,12.0,12.0,15.0,1
275,CC:2F:71:3E:C5:1F,2150000,272762978,44,5376,2149956,272757602,0,199,16864,170,13330,29,3534,48,1,74,2,0,7,130000.0,39000.0,-70.0,-69.0,-66.0,-60.0,-69.0,-68.0,-66.0,-60.0,-77.0,-85.0,-78.0,-86.0,7.0,16.0,12.0,26.0,1
276,CC:2F:71:3F:1F:24,2226081,373982280,76125,101224678,2149956,272757602,3,48788,54050855,48737,54044291,51,6564,47213,138,76147,15909,3,45,144444.0,43333.0,-69.0,-64.0,-68.0,-69.0,-69.0,-64.0,-68.0,-68.0,-77.0,-85.0,-78.0,-86.0,8.0,21.0,10.0,17.0,1
277,F8:59:71:5A:E0:3D,2161512,290173896,11552,17415890,2149960,272758006,0,7854,10870613,7807,10862314,47,8299,7807,2,11563,797,0,8,144444.0,43333.0,-67.0,-74.0,-65.0,-70.0,-66.0,-73.0,-65.0,-70.0,-77.0,-85.0,-78.0,-86.0,10.0,11.0,13.0,16.0,1
278,CC:2F:71:3E:C5:1F,2150004,272763382,44,5376,2149960,272758006,0,199,16864,170,13330,29,3534,48,1,74,2,0,7,130000.0,39000.0,-70.0,-69.0,-66.0,-60.0,-69.0,-68.0,-66.0,-60.0,-77.0,-85.0,-78.0,-86.0,7.0,16.0,12.0,26.0,1
279,CC:2F:71:3F:1F:24,2226245,374185085,76285,101427079,2149960,272758006,3,48939,54254906,48888,54248342,51,6564,47355,138,76307,15909,3,45,144444.0,43333.0,-70.0,-64.0,-69.0,-68.0,-69.0,-64.0,-69.0,-68.0,-77.0,-85.0,-78.0,-86.0,7.0,21.0,9.0,18.0,1
280,F8:59:71:5A:E0:3D,2161582,290272522,11617,17514052,2149965,272758470,0,7918,10966325,7871,10958026,47,8299,7871,2,11628,797,0,8,144444.0,43333.0,-66.0,-73.0,-67.0,-71.0,-66.0,-73.0,-66.0,-70.0,-77.0,-85.0,-78.0,-86.0,11.0,12.0,11.0,15.0,1
281,CC:2F:71:3E:C5:1F,2150009,272763846,44,5376,2149965,272758470,0,199,16864,170,13330,29,3534,48,1,74,2,0,7,130000.0,39000.0,-70.0,-69.0,-66.0,-60.0,-69.0,-68.0,-66.0,-60.0,-77.0,-85.0,-78.0,-86.0,7.0,16.0,12.0,26.0,1
282,CC:2F:71:3F:1F:24,2226408,374393177,76443,101634707,2149965,272758470,3,49103,54472294,49052,54465730,51,6564,47501,138,76465,15909,3,45,144444.0,43333.0,-69.0,-64.0,-69.0,-68.0,-69.0,-64.0,-69.0,-68.0,-77.0,-85.0,-78.0,-86.0,8.0,21.0,9.0,18.0,1
283,F8:59:71:5A:E0:3D,2161683,290419546,11716,17660874,2149967,272758672,0,7992,11073965,7945,11065666,47,8299,7945,2,11727,797,0,8,144444.0,43333.0,-66.0,-74.0,-67.0,-70.0,-66.0,-73.0,-66.0,-70.0,-77.0,-85.0,-78.0,-86.0,11.0,11.0,11.0,16.0,1
284,CC:2F:71:3E:C5:1F,2150011,272764048,44,5376,2149967,272758672,0,199,16864,170,13330,29,3534,48,1,74,2,0,7,130000.0,39000.0,-70.0,-69.0,-66.0,-60.0,-69.0,-68.0,-66.0,-60.0,-77.0,-85.0,-78.0,-86.0,7.0,16.0,12.0,26.0,1
285,CC:2F:71:3F:1F:24,2226575,374606091,76606,101847217,2149969,272758874,3,49265,54689140,49214,54682576,51,6564,47652,138,76628,15909,3,45,144444.0,43333.0,-70.0,-64.0,-70.0,-68.0,-69.0,-63.0,-68.0,-68.0,-77.0,-85.0,-78.0,-86.0,7.0,21.0,8.0,18.0,1
286,F8:59:71:5A:E0:3D,2161838,290650336,11865,17891058,2149973,272759278,0,8067,11175695,8020,11167396,47,8299,8020,2,11876,798,0,8,144444.0,43333.0,-67.0,-74.0,-66.0,-70.0,-66.0,-73.0,-66.0,-70.0,-77.0,-85.0,-78.0,-86.0,10.0,11.0,12.0,16.0,1
287,CC:2F:71:3E:C5:1F,2150018,272764714,44,5376,2149974,272759338,0,199,16864,170,13330,29,3534,48,1,74,2,0,7,130000.0,39000.0,-70.0,-69.0,-66.0,-60.0,-69.0,-68.0,-66.0,-60.0,-77.0,-85.0,-78.0,-86.0,7.0,16.0,12.0,26.0,1
288,CC:2F:71:3F:1F:24,2226743,374813122,76769,102053784,2149974,272759338,3,49428,54901991,49377,54895427,51,6564,47805,138,76791,15910,3,45,144444.0,43333.0,-69.0,-64.0,-69.0,-68.0,-69.0,-63.0,-69.0,-68.0,-77.0,-85.0,-78.0,-86.0,8.0,21.0,9.0,18.0,1
289,F8:59:71:5A:E0:3D,2161903,290746946,11927,17987406,2149976,272759540,0,8129,11271175,8082,11262876,47,8299,8082,2,11938,798,0,8,144444.0,43333.0,-66.0,-74.0,-66.0,-70.0,-66.0,-73.0,-66.0,-70.0,-77.0,-85.0,-78.0,-86.0,11.0,11.0,12.0,16.0,1
290,CC:2F:71:3E:C5:1F,2150020,272764916,44,5376,2149976,272759540,0,199,16864,170,13330,29,3534,48,1,74,2,0,7,130000.0,39000.0,-70.0,-69.0,-66.0,-60.0,-69.0,-68.0,-66.0,-60.0,-77.0,-85.0,-78.0,-86.0,7.0,16.0,12.0,26.0,1
291,CC:2F:71:3F:1F:24,2226918,375023302,76942,102263762,2149976,272759540,3,49599,55126988,49548,55120424,51,6564,47958,138,76964,15910,3,45,144444.0,43333.0,-69.0,-64.0,-68.0,-69.0,-69.0,-64.0,-68.0,-68.0,-77.0,-85.0,-78.0,-86.0,8.0,21.0,10.0,17.0,1
292,F8:59:71:5A:E0:3D,2161974,290847264,11994,18087320,2149980,272759944,0,8197,11372093,8150,11363794,47,8299,8150,2,12005,798,0,8,144444.0,43333.0,-66.0,-73.0,-65.0,-70.0,-66.0,-73.0,-66.0,-70.0,-77.0,-85.0,-78.0,-86.0,11.0,12.0,13.0,16.0,1
293,CC:2F:71:3E:C5:1F,2150026,272765522,44,5376,2149982,272760146,0,199,16864,170,13330,29,3534,48,1,74,2,0,7,130000.0,39000.0,-70.0,-69.0,-66.0,-60.0,-69.0,-68.0,-66.0,-60.0,-77.0,-85.0,-78.0,-86.0,7.0,16.0,12.0,26.0,1
294,CC:2F:71:3F:1F:24,2227085,375227693,77103,102467547,2149982,272760146,3,49760,55340775,49709,55334211,51,6564,48107,138,77124,15910,3,45,144444.0,43333.0,-70.0,-64.0,-69.0,-68.0,-69.0,-64.0,-69.0,-68.0,-77.0,-85.0,-78.0,-86.0,7.0,21.0,9.0,18.0,1
295,F8:59:71:5A:E0:3D,2162042,290944138,12056,18183668,2149986,272760470,0,8260,11469113,8213,11460814,47,8299,8213,2,12067,798,0,8,144444.0,43333.0,-66.0,-74.0,-66.0,-71.0,-66.0,-73.0,-66.0,-70.0,-77.0,-85.0,-78.0,-86.0,11.0,11.0,12.0,15.0,1
296,CC:2F:71:3E:C5:1F,2150030,272765846,44,5376,2149986,272760470,0,201,17052,171,13400,30,3652,49,1,74,2,0,8,130000.0,39000.0,-70.0,-69.0,-67.0,-60.0,-69.0,-68.0,-66.0,-60.0,-77.0,-85.0,-78.0,-86.0,7.0,16.0,11.0,26.0,1
297,CC:2F:71:3F:1F:24,2227250,375436035,77264,102675565,2149986,272760470,3,49915,55552284,49864,55545720,51,6564,48255,138,77286,15910,3,45,144444.0,43333.0,-69.0,-63.0,-69.0,-68.0,-69.0,-63.0,-68.0,-68.0,-77.0,-85.0,-78.0,-86.0,8.0,22.0,9.0,18.0,1
298,F8:59:71:5A:E0:3D,2162109,291042444,12119,18281570,2149990,272760874,0,8323,11566133,8276,11557834,47,8299,8276,2,12130,798,0,8,144444.0,43333.0,-67.0,-74.0,-66.0,-70.0,-66.0,-73.0,-66.0,-70.0,-77.0,-85.0,-78.0,-86.0,10.0,11.0,12.0,16.0,1
299,CC:2F:71:3E:C5:1F,2150034,272766250,44,5376,2149990,272760874,0,201,17052,171,13400,30,3652,49,1,74,2,0,8,130000.0,39000.0,-70.0,-69.0,-67.0,-60.0,-69.0,-68.0,-66.0,-60.0,-77.0,-85.0,-78.0,-86.0,7.0,16.0,11.0,26.0,1
300,CC:2F:71:3F:1F:24,2227413,375644141,77423,102883267,2149990,272760874,3,50066,55760424,50015,55753860,51,6564,48398,138,77444,15948,3,45,130000.0,43333.0,-68.0,-62.0,-69.0,-68.0,-68.0,-62.0,-69.0,-68.0,-77.0,-85.0,-78.0,-86.0,9.0,23.0,9.0,18.0,1
301,F8:59:71:5A:E0:3D,2162176,291142207,12183,18380858,2149993,272761349,0,8386,11663153,8339,11654854,47,8299,8339,2,12194,798,0,8,144444.0,43333.0,-67.0,-74.0,-66.0,-70.0,-66.0,-73.0,-65.0,-70.0,-77.0,-85.0,-78.0,-86.0,10.0,11.0,12.0,16.0,1
302,CC:2F:71:3E:C5:1F,2150039,272766927,44,5376,2149995,272761551,0,201,17052,171,13400,30,3652,49,1,74,2,0,8,130000.0,39000.0,-70.0,-69.0,-67.0,-60.0,-69.0,-68.0,-66.0,-60.0,-77.0,-85.0,-78.0,-86.0,7.0,16.0,11.0,26.0,1
303,CC:2F:71:3F:1F:24,2227585,375851625,77590,103090074,2149995,272761551,3,50234,55975529,50183,55968965,51,6564,48553,138,77612,15993,3,45,115556.0,28889.0,-70.0,-63.0,-69.0,-67.0,-69.0,-63.0,-69.0,-67.0,-77.0,-85.0,-78.0,-86.0,7.0,22.0,9.0,19.0,1
304,F8:59:71:5A:E0:3D,2162363,291425375,12365,18663562,2149998,272761813,0,8460,11763329,8413,11755030,47,8299,8412,2,12375,798,0,9,144444.0,43333.0,-67.0,-73.0,-65.0,-70.0,-66.0,-73.0,-66.0,-70.0,-77.0,-85.0,-78.0,-86.0,10.0,12.0,13.0,16.0,1
305,CC:2F:71:3E:C5:1F,2150042,272767189,44,5376,2149998,272761813,0,201,17052,171,13400,30,3652,49,1,74,2,0,8,130000.0,39000.0,-70.0,-69.0,-67.0,-60.0,-69.0,-68.0,-66.0,-60.0,-77.0,-85.0,-78.0,-86.0,7.0,16.0,11.0,26.0,1
306,CC:2F:71:3F:1F:24,2227759,376059208,77761,103297395,2149998,272761813,3,50396,56191109,50345,56184545,51,6564,48705,138,77783,15995,3,45,115556.0,28889.0,-72.0,-64.0,-71.0,-69.0,-70.0,-63.0,-70.0,-69.0,-77.0,-85.0,-78.0,-86.0,5.0,21.0,7.0,17.0,1
307,F8:59:71:5A:E0:3D,2162429,291522127,12427,18759910,2150002,272762217,0,8523,11860349,8476,11852050,47,8299,8475,2,12438,798,0,9,144444.0,43333.0,-67.0,-73.0,-66.0,-70.0,-66.0,-73.0,-66.0,-70.0,-77.0,-85.0,-78.0,-86.0,10.0,12.0,12.0,16.0,1
308,CC:2F:71:3E:C5:1F,2150046,272767593,44,5376,2150002,272762217,0,201,17052,171,13400,30,3652,49,1,74,2,0,8,130000.0,39000.0,-70.0,-69.0,-67.0,-60.0,-69.0,-68.0,-66.0,-60.0,-77.0,-85.0,-78.0,-86.0,7.0,16.0,11.0,26.0,1
309,CC:2F:71:3F:1F:24,2227920,376264262,77918,103502045,2150002,272762217,3,50541,56391315,50490,56384751,51,6564,48847,138,77940,15997,3,45,115556.0,28889.0,-69.0,-63.0,-70.0,-70.0,-69.0,-63.0,-70.0,-69.0,-77.0,-85.0,-78.0,-86.0,8.0,22.0,8.0,16.0,1
310,F8:59:71:5A:E0:3D,2162493,291618677,12489,18856258,2150004,272762419,0,8585,11955829,8538,11947530,47,8299,8537,2,12500,798,0,9,144444.0,43333.0,-68.0,-73.0,-65.0,-71.0,-67.0,-73.0,-65.0,-70.0,-77.0,-85.0,-78.0,-86.0,9.0,12.0,13.0,15.0,1
311,CC:2F:71:3E:C5:1F,2150050,272767997,44,5376,2150006,272762621,0,201,17052,171,13400,30,3652,49,1,74,2,0,8,130000.0,39000.0,-70.0,-69.0,-67.0,-60.0,-69.0,-68.0,-66.0,-60.0,-77.0,-85.0,-78.0,-86.0,7.0,16.0,11.0,26.0,1
312,CC:2F:71:3F:1F:24,2228081,376468980,78075,103706359,2150006,272762621,3,50687,56594527,50636,56587963,51,6564,48987,138,78097,15999,3,45,144444.0,43333.0,-69.0,-63.0,-68.0,-68.0,-69.0,-63.0,-69.0,-68.0,-77.0,-85.0,-78.0,-86.0,8.0,22.0,10.0,18.0,1
313,F8:59:71:5A:E0:3D,2162563,291717245,12552,18954160,2150011,272763085,0,8648,12052849,8601,12044550,47,8299,8600,2,12563,798,0,9,144444.0,43333.0,-66.0,-73.0,-67.0,-70.0,-67.0,-73.0,-66.0,-70.0,-77.0,-85.0,-78.0,-86.0,11.0,12.0,11.0,16.0,1
314,CC:2F:71:3E:C5:1F,2150055,272768461,44,5376,2150011,272763085,0,201,17052,171,13400,30,3652,49,1,74,2,0,8,130000.0,39000.0,-70.0,-69.0,-67.0,-60.0,-69.0,-68.0,-66.0,-60.0,-77.0,-85.0,-78.0,-86.0,7.0,16.0,11.0,26.0,1
315,CC:2F:71:3F:1F:24,2228252,376678732,78241,103915647,2150011,272763085,3,50848,56803030,50797,56796466,51,6564,49141,138,78263,16037,3,45,65000.0,13000.0,-70.0,-63.0,-69.0,-70.0,-69.0,-63.0,-69.0,-69.0,-77.0,-85.0,-78.0,-86.0,7.0,22.0,9.0,16.0,1
316,F8:59:71:5A:E0:3D,2162628,291815349,12615,19052062,2150013,272763287,0,8711,12149869,8664,12141570,47,8299,8663,2,12626,798,0,9,144444.0,43333.0,-67.0,-73.0,-65.0,-70.0,-67.0,-73.0,-65.0,-70.0,-77.0,-85.0,-78.0,-86.0,10.0,12.0,13.0,16.0,1
317,CC:2F:71:3E:C5:1F,2150057,272768663,44,5376,2150013,272763287,0,201,17052,171,13400,30,3652,49,1,74,2,0,8,130000.0,39000.0,-70.0,-69.0,-67.0,-60.0,-69.0,-68.0,-66.0,-60.0,-77.0,-85.0,-78.0,-86.0,7.0,16.0,11.0,26.0,1
318,CC:2F:71:3F:1F:24,2228410,376881470,78397,104118183,2150013,272763287,3,50998,57012458,50947,57005894,51,6564,49281,138,78419,16037,3,45,86667.0,14444.0,-69.0,-63.0,-70.0,-69.0,-69.0,-63.0,-70.0,-69.0,-77.0,-85.0,-78.0,-86.0,8.0,22.0,8.0,17.0,1
319,F8:59:71:5A:E0:3D,2162879,292196955,12860,19433062,2150019,272763893,0,8797,12252887,8750,12244588,47,8299,8749,2,12870,799,0,9,144444.0,43333.0,-67.0,-74.0,-66.0,-70.0,-67.0,-73.0,-66.0,-70.0,-77.0,-85.0,-78.0,-86.0,10.0,11.0,12.0,16.0,1
320,CC:2F:71:3E:C5:1F,2150063,272769269,44,5376,2150019,272763893,0,201,17052,171,13400,30,3652,49,1,74,2,0,8,130000.0,39000.0,-70.0,-69.0,-67.0,-60.0,-69.0,-68.0,-66.0,-60.0,-77.0,-85.0,-78.0,-86.0,7.0,16.0,11.0,26.0,1
321,CC:2F:71:3F:1F:24,2228576,377087924,78557,104324031,2150019,272763893,3,51152,57220947,51101,57214383,51,6564,49428,138,78579,16042,3,45,144444.0,43333.0,-69.0,-63.0,-68.0,-70.0,-69.0,-63.0,-70.0,-70.0,-77.0,-85.0,-78.0,-86.0,8.0,22.0,10.0,16.0,1
322,F8:59:71:5A:E0:3D,2162951,292296038,12929,19531883,2150022,272764155,0,8864,12351538,8817,12343239,47,8299,8816,2,12940,799,0,9,144444.0,43333.0,-67.0,-75.0,-68.0,-70.0,-67.0,-74.0,-66.0,-70.0,-77.0,-85.0,-78.0,-86.0,10.0,10.0,10.0,16.0,1
323,CC:2F:71:3E:C5:1F,2150066,272769531,44,5376,2150022,272764155,0,201,17052,171,13400,30,3652,49,1,74,2,0,8,130000.0,39000.0,-70.0,-69.0,-67.0,-60.0,-69.0,-68.0,-66.0,-60.0,-77.0,-85.0,-78.0,-86.0,7.0,16.0,11.0,26.0,1
324,CC:2F:71:3F:1F:24,2228742,377294988,78720,104530833,2150022,272764155,3,51315,57432424,51264,57425860,51,6564,49578,138,78742,16049,3,45,130000.0,43333.0,-70.0,-64.0,-70.0,-72.0,-69.0,-63.0,-70.0,-72.0,-77.0,-85.0,-78.0,-86.0,7.0,21.0,8.0,14.0,1
325,F8:59:71:5A:E0:3D,2163051,292433222,13023,19668461,2150028,272764761,0,8937,12454790,8890,12446491,47,8299,8889,2,13034,799,0,9,144444.0,43333.0,-67.0,-74.0,-67.0,-70.0,-67.0,-74.0,-66.0,-70.0,-77.0,-85.0,-78.0,-86.0,10.0,11.0,11.0,16.0,1
326,CC:2F:71:3E:C5:1F,2150072,272770137,44,5376,2150028,272764761,0,201,17052,171,13400,30,3652,49,1,74,2,0,8,130000.0,39000.0,-70.0,-69.0,-67.0,-60.0,-69.0,-68.0,-66.0,-60.0,-77.0,-85.0,-78.0,-86.0,7.0,16.0,11.0,26.0,1
327,CC:2F:71:3F:1F:24,2228904,377498298,78876,104733537,2150028,272764761,3,51470,57645308,51419,57638744,51,6564,49721,138,78898,16074,3,45,130000.0,39000.0,-70.0,-64.0,-69.0,-71.0,-69.0,-64.0,-69.0,-71.0,-77.0,-85.0,-78.0,-86.0,7.0,21.0,9.0,15.0,1
328,F8:59:71:5A:E0:3D,2163116,292529898,13085,19764809,2150031,272765089,0,8999,12550270,8952,12541971,47,8299,8951,2,13096,799,0,9,144444.0,43333.0,-68.0,-75.0,-66.0,-70.0,-67.0,-75.0,-66.0,-70.0,-77.0,-85.0,-78.0,-86.0,9.0,10.0,12.0,16.0,1
329,CC:2F:71:3E:C5:1F,2150075,272770465,44,5376,2150031,272765089,0,201,17052,171,13400,30,3652,49,1,74,2,0,8,130000.0,39000.0,-70.0,-69.0,-67.0,-60.0,-69.0,-68.0,-66.0,-60.0,-77.0,-85.0,-78.0,-86.0,7.0,16.0,11.0,26.0,1
330,CC:2F:71:3F:1F:24,2229071,377707891,79040,104942802,2150031,272765089,3,51626,57850219,51575,57843655,51,6564,49871,138,79062,16104,3,45,130000.0,43333.0,-69.0,-63.0,-70.0,-72.0,-69.0,-63.0,-69.0,-71.0,-77.0,-85.0,-78.0,-86.0,8.0,22.0,8.0,14.0,1
331,F8:59:71:5A:E0:3D,2163189,292630392,13153,19864839,2150036,272765553,0,9068,12651294,9021,12642995,47,8299,9020,2,13164,799,0,9,144444.0,43333.0,-67.0,-75.0,-66.0,-71.0,-67.0,-75.0,-65.0,-70.0,-77.0,-85.0,-78.0,-86.0,10.0,10.0,12.0,15.0,1
332,CC:2F:71:3E:C5:1F,2150080,272770929,44,5376,2150036,272765553,0,201,17052,171,13400,30,3652,49,1,74,2,0,8,130000.0,39000.0,-70.0,-69.0,-67.0,-60.0,-69.0,-68.0,-66.0,-60.0,-77.0,-85.0,-78.0,-86.0,7.0,16.0,11.0,26.0,1
333,CC:2F:71:3F:1F:24,2229235,377911769,79197,105146014,2150038,272765755,3,51775,58052441,51724,58045877,51,6564,50014,138,79219,16107,3,45,130000.0,43333.0,-70.0,-63.0,-70.0,-69.0,-70.0,-63.0,-69.0,-69.0,-77.0,-85.0,-78.0,-86.0,7.0,22.0,8.0,17.0,1
334,F8:59:71:5A:E0:3D,2163253,292726942,13215,19961187,2150038,272765755,0,9130,12746774,9083,12738475,47,8299,9082,2,13225,799,0,9,144444.0,43333.0,-66.0,-74.0,-66.0,-70.0,-67.0,-74.0,-66.0,-70.0,-77.0,-85.0,-78.0,-86.0,11.0,11.0,12.0,16.0,1
335,CC:2F:71:3E:C5:1F,2150082,272771131,44,5376,2150038,272765755,0,201,17052,171,13400,30,3652,49,1,74,2,0,8,130000.0,39000.0,-70.0,-69.0,-67.0,-60.0,-69.0,-68.0,-66.0,-60.0,-77.0,-85.0,-78.0,-86.0,7.0,16.0,11.0,26.0,1
336,CC:2F:71:3F:1F:24,2229391,378114753,79353,105348998,2150038,272765755,3,51922,58254345,51871,58247781,51,6564,50155,138,79375,16119,3,45,117000.0,39000.0,-70.0,-64.0,-70.0,-72.0,-69.0,-63.0,-69.0,-71.0,-77.0,-85.0,-78.0,-86.0,7.0,21.0,8.0,14.0,1
337,F8:59:71:5A:E0:3D,2163319,292823694,13277,20057535,2150042,272766159,0,9193,12843794,9146,12835495,47,8299,9145,2,13288,799,0,9,144444.0,43333.0,-67.0,-74.0,-66.0,-70.0,-66.0,-74.0,-65.0,-70.0,-77.0,-85.0,-78.0,-86.0,10.0,11.0,12.0,16.0,1
338,CC:2F:71:3E:C5:1F,2150086,272771535,44,5376,2150042,272766159,0,203,17192,173,13540,30,3652,49,1,75,2,0,8,130000.0,39000.0,-71.0,-69.0,-66.0,-60.0,-70.0,-68.0,-66.0,-60.0,-77.0,-85.0,-78.0,-86.0,6.0,16.0,12.0,26.0,1
339,CC:2F:71:3F:1F:24,2229554,378321608,79512,105555449,2150042,272766159,3,52072,58457979,52021,58451415,51,6564,50302,138,79534,16121,3,45,130000.0,43333.0,-70.0,-63.0,-70.0,-70.0,-69.0,-63.0,-69.0,-70.0,-77.0,-85.0,-78.0,-86.0,7.0,22.0,8.0,16.0,1
340,F8:59:71:5A:E0:3D,2163387,292922060,13340,20155437,2150047,272766623,0,9258,12940267,9211,12931968,47,8299,9210,2,13351,799,0,9,144444.0,43333.0,-67.0,-74.0,-65.0,-70.0,-66.0,-74.0,-65.0,-70.0,-77.0,-85.0,-78.0,-86.0,10.0,11.0,13.0,16.0,1
341,CC:2F:71:3E:C5:1F,2150091,272771999,44,5376,2150047,272766623,0,203,17192,173,13540,30,3652,49,1,75,2,0,8,130000.0,39000.0,-71.0,-69.0,-66.0,-60.0,-70.0,-68.0,-66.0,-60.0,-77.0,-85.0,-78.0,-86.0,6.0,16.0,12.0,26.0,1
342,CC:2F:71:3F:1F:24,2229723,378528769,79676,105762146,2150047,272766623,3,52229,58664458,52178,58657894,51,6564,50451,138,79698,16121,3,45,130000.0,43333.0,-70.0,-63.0,-69.0,-69.0,-69.0,-63.0,-68.0,-69.0,-77.0,-85.0,-78.0,-86.0,7.0,22.0,9.0,17.0,1
343,F8:59:71:5A:E0:3D,2163469,293024854,13419,20257959,2150050,272766895,0,9337,13040781,9289,13032356,48,8425,9289,2,13430,799,0,10,144444.0,43333.0,-66.0,-74.0,-66.0,-70.0,-66.0,-74.0,-65.0,-70.0,-77.0,-85.0,-78.0,-86.0,11.0,11.0,12.0,16.0,1
344,CC:2F:71:3E:C5:1F,2150097,272772589,45,5492,2150052,272767097,0,205,17332,175,13680,30,3652,49,1,76,2,0,8,130000.0,39000.0,-70.0,-68.0,-66.0,-60.0,-70.0,-68.0,-66.0,-60.0,-77.0,-85.0,-78.0,-86.0,7.0,17.0,12.0,26.0,1
345,CC:2F:71:3F:1F:24,2229889,378738559,79837,105971462,2150052,272767097,3,52389,58887946,52338,58881382,51,6564,50595,138,79859,16126,3,45,117000.0,39000.0,-70.0,-63.0,-68.0,-70.0,-70.0,-63.0,-68.0,-69.0,-77.0,-85.0,-78.0,-86.0,7.0,22.0,10.0,16.0,1
346,F8:59:71:5A:E0:3D,2163712,293391527,13654,20623691,2150058,272767836,0,9420,13143495,9372,13135070,48,8425,9372,2,13665,799,0,10,144444.0,43333.0,-66.0,-74.0,-67.0,-70.0,-67.0,-74.0,-66.0,-70.0,-77.0,-85.0,-78.0,-86.0,11.0,11.0,11.0,16.0,1
347,CC:2F:71:3E:C5:1F,2150103,272773328,45,5492,2150058,272767836,0,207,17520,176,13750,31,3770,50,1,76,2,0,8,130000.0,39000.0,-70.0,-68.0,-66.0,-60.0,-70.0,-68.0,-66.0,-60.0,-77.0,-85.0,-78.0,-86.0,7.0,17.0,12.0,26.0,1
348,CC:2F:71:3F:1F:24,2230055,378947212,79997,106179376,2150058,272767836,3,52549,59109990,52498,59103426,51,6564,50741,138,80019,16126,3,45,130000.0,43333.0,-69.0,-63.0,-69.0,-70.0,-69.0,-63.0,-68.0,-69.0,-77.0,-85.0,-78.0,-86.0,8.0,22.0,9.0,16.0,1
349,F8:59:71:5A:E0:3D,2163898,293675242,13837,20907144,2150061,272768098,0,9496,13245271,9448,13236846,48,8425,9448,2,13848,799,0,10,144444.0,43333.0,-67.0,-74.0,-65.0,-71.0,-66.0,-74.0,-65.0,-70.0,-77.0,-85.0,-78.0,-86.0,10.0,11.0,13.0,15.0,1
350,CC:2F:71:3E:C5:1F,2150106,272773590,45,5492,2150061,272768098,0,207,17520,176,13750,31,3770,50,1,76,2,0,8,130000.0,39000.0,-70.0,-68.0,-66.0,-60.0,-70.0,-68.0,-66.0,-60.0,-77.0,-85.0,-78.0,-86.0,7.0,17.0,12.0,26.0,1
351,CC:2F:71:3F:1F:24,2230215,379152124,80154,106384026,2150061,272768098,3,52704,59321516,52653,59314952,51,6564,50885,138,80176,16126,3,45,130000.0,43333.0,-67.0,-63.0,-68.0,-70.0,-70.0,-63.0,-68.0,-69.0,-77.0,-85.0,-78.0,-86.0,10.0,22.0,10.0,16.0,1
352,F8:59:71:5A:E0:3D,2163984,293788498,13906,21014370,2150078,272774128,0,9565,13351531,9517,13343106,48,8425,9517,2,13916,799,0,10,144444.0,43333.0,-67.0,-74.0,-65.0,-70.0,-66.0,-73.0,-65.0,-70.0,-77.0,-85.0,-78.0,-86.0,10.0,11.0,13.0,16.0,1
353,CC:2F:71:3E:C5:1F,2150123,272779620,45,5492,2150078,272774128,0,207,17520,176,13750,31,3770,50,1,76,2,0,8,130000.0,39000.0,-70.0,-68.0,-66.0,-60.0,-70.0,-68.0,-66.0,-60.0,-77.0,-85.0,-78.0,-86.0,7.0,17.0,12.0,26.0,1
354,CC:2F:71:3F:1F:24,2230418,379388569,80329,106609017,2150089,272779552,3,52880,59555853,52829,59549289,51,6564,51048,138,80351,16130,3,45,130000.0,43333.0,-68.0,-63.0,-70.0,-69.0,-69.0,-63.0,-69.0,-69.0,-77.0,-85.0,-78.0,-86.0,9.0,22.0,8.0,17.0,1
355,F8:59:71:5A:E0:3D,2164059,293890472,13968,21110718,2150091,272779754,0,9627,13447011,9579,13438586,48,8425,9579,2,13979,799,0,10,144444.0,43333.0,-66.0,-74.0,-66.0,-71.0,-66.0,-73.0,-65.0,-70.0,-77.0,-85.0,-78.0,-86.0,11.0,11.0,12.0,15.0,1
356,CC:2F:71:3E:C5:1F,2150137,272785306,45,5492,2150092,272779814,0,207,17520,176,13750,31,3770,50,1,76,2,0,8,130000.0,39000.0,-70.0,-68.0,-66.0,-60.0,-70.0,-68.0,-66.0,-60.0,-77.0,-85.0,-78.0,-86.0,7.0,17.0,12.0,26.0,1
357,CC:2F:71:3F:1F:24,2230577,379591927,80485,106812113,2150092,272779814,3,53029,59759521,52978,59752957,51,6564,51189,138,80507,16130,3,45,130000.0,43333.0,-71.0,-63.0,-69.0,-69.0,-70.0,-63.0,-69.0,-69.0,-77.0,-85.0,-78.0,-86.0,6.0,22.0,9.0,17.0,1
358,F8:59:71:5A:E0:3D,2164128,293987486,14030,21207066,2150098,272780420,0,9689,13542491,9641,13534066,48,8425,9641,2,14041,799,0,10,144444.0,43333.0,-67.0,-74.0,-65.0,-70.0,-67.0,-74.0,-65.0,-70.0,-77.0,-85.0,-78.0,-86.0,10.0,11.0,13.0,16.0,1
359,CC:2F:71:3E:C5:1F,2150143,272785912,45,5492,2150098,272780420,0,207,17520,176,13750,31,3770,50,1,76,2,0,8,130000.0,39000.0,-70.0,-68.0,-66.0,-60.0,-70.0,-68.0,-66.0,-60.0,-77.0,-85.0,-78.0,-86.0,7.0,17.0,12.0,26.0,1
360,CC:2F:71:3F:1F:24,2230741,379798737,80643,107018317,2150098,272780420,3,53183,59972261,53132,59965697,51,6564,51333,138,80665,16130,3,45,130000.0,43333.0,-70.0,-63.0,-69.0,-69.0,-70.0,-63.0,-68.0,-69.0,-77.0,-85.0,-78.0,-86.0,7.0,22.0,9.0,17.0,1
361,F8:59:71:5A:E0:3D,2164191,294085388,14093,21304968,2150098,272780420,0,9752,13639511,9704,13631086,48,8425,9704,2,14104,799,0,10,144444.0,43333.0,-66.0,-74.0,-66.0,-70.0,-66.0,-73.0,-65.0,-70.0,-77.0,-85.0,-78.0,-87.0,11.0,11.0,12.0,17.0,1
362,CC:2F:71:3E:C5:1F,2150145,272786114,45,5492,2150100,272780622,0,207,17520,176,13750,31,3770,50,1,76,2,0,8,130000.0,39000.0,-70.0,-68.0,-66.0,-60.0,-70.0,-68.0,-66.0,-60.0,-77.0,-85.0,-78.0,-87.0,7.0,17.0,12.0,27.0,1
363,CC:2F:71:3F:1F:24,2230899,380001867,80799,107221245,2150100,272780622,3,53332,60175863,53281,60169299,51,6564,51475,138,80819,16136,3,46,144444.0,43333.0,-70.0,-63.0,-68.0,-70.0,-70.0,-63.0,-68.0,-69.0,-77.0,-85.0,-78.0,-87.0,7.0,22.0,10.0,17.0,1
364,F8:59:71:5A:E0:3D,2164260,294182458,14156,21401432,2150104,272781026,0,9815,13735097,9767,13726672,48,8425,9767,2,14167,799,0,10,144444.0,43333.0,-67.0,-74.0,-66.0,-70.0,-66.0,-73.0,-65.0,-70.0,-77.0,-85.0,-78.0,-87.0,10.0,11.0,12.0,17.0,1
365,CC:2F:71:3E:C5:1F,2150150,272786578,45,5492,2150105,272781086,0,207,17520,176,13750,31,3770,50,1,76,2,0,8,130000.0,39000.0,-70.0,-68.0,-66.0,-60.0,-70.0,-68.0,-66.0,-60.0,-77.0,-85.0,-78.0,-87.0,7.0,17.0,12.0,27.0,1
366,CC:2F:71:3F:1F:24,2231063,380208541,80957,107427393,2150106,272781148,3,53482,60376889,53430,60370207,52,6682,51621,138,80979,16154,3,46,130000.0,43333.0,-70.0,-64.0,-69.0,-70.0,-69.0,-63.0,-69.0,-69.0,-77.0,-85.0,-78.0,-87.0,7.0,21.0,9.0,17.0,1
367,F8:59:71:5A:E0:3D,2164357,294320872,14249,21539522,2150108,272781350,0,9886,13838117,9838,13829692,48,8425,9838,2,14260,799,0,10,144444.0,43333.0,-66.0,-73.0,-67.0,-70.0,-66.0,-73.0,-65.0,-70.0,-77.0,-85.0,-78.0,-87.0,11.0,12.0,11.0,17.0,1
368,CC:2F:71:3E:C5:1F,2150153,272786842,45,5492,2150108,272781350,0,207,17520,176,13750,31,3770,50,1,76,2,0,8,130000.0,39000.0,-70.0,-68.0,-66.0,-60.0,-70.0,-68.0,-66.0,-60.0,-77.0,-85.0,-78.0,-87.0,7.0,17.0,12.0,27.0,1
369,CC:2F:71:3F:1F:24,2231231,380415694,81122,107634282,2150109,272781412,3,53651,60597781,53599,60591099,52,6682,51773,138,81144,16154,3,46,130000.0,43333.0,-69.0,-63.0,-69.0,-70.0,-70.0,-63.0,-69.0,-69.0,-77.0,-85.0,-78.0,-87.0,8.0,22.0,9.0,17.0,1
370,F8:59:71:5A:E0:3D,2164531,294576923,14420,21795309,2150111,272781614,0,9969,13944095,9920,13935552,49,8543,9921,2,14431,799,0,10,144444.0,43333.0,-66.0,-74.0,-66.0,-70.0,-66.0,-73.0,-66.0,-70.0,-77.0,-85.0,-78.0,-87.0,11.0,11.0,12.0,17.0,1
371,CC:2F:71:3E:C5:1F,2150158,272787308,45,5492,2150113,272781816,0,207,17520,176,13750,31,3770,50,1,76,2,0,8,130000.0,39000.0,-70.0,-68.0,-66.0,-60.0,-70.0,-68.0,-66.0,-60.0,-77.0,-85.0,-78.0,-87.0,7.0,17.0,12.0,27.0,1
372,CC:2F:71:3F:1F:24,2231408,380626240,81293,107844222,2150115,272782018,3,53813,60806528,53761,60799846,52,6682,51930,138,81315,16168,3,46,144444.0,43333.0,-70.0,-63.0,-68.0,-70.0,-69.0,-63.0,-68.0,-69.0,-77.0,-85.0,-78.0,-87.0,7.0,22.0,10.0,17.0,1
373,F8:59:71:5A:E0:3D,2164601,294675491,14483,21893211,2150118,272782280,0,10034,14041255,9985,14032712,49,8543,9984,2,14494,800,0,10,144444.0,43333.0,-67.0,-74.0,-66.0,-70.0,-66.0,-73.0,-66.0,-70.0,-77.0,-85.0,-78.0,-87.0,10.0,11.0,12.0,17.0,1
374,CC:2F:71:3E:C5:1F,2150163,272787772,45,5492,2150118,272782280,0,207,17520,176,13750,31,3770,50,1,76,2,0,8,130000.0,39000.0,-70.0,-68.0,-66.0,-60.0,-70.0,-68.0,-66.0,-60.0,-77.0,-85.0,-78.0,-87.0,7.0,17.0,12.0,27.0,1
375,CC:2F:71:3F:1F:24,2231567,380829542,81449,108047262,2150118,272782280,3,53958,61005434,53906,60998752,52,6682,52070,138,81471,16177,3,46,130000.0,43333.0,-67.0,-63.0,-69.0,-69.0,-69.0,-63.0,-68.0,-69.0,-77.0,-85.0,-78.0,-87.0,10.0,22.0,9.0,18.0,1
376,F8:59:71:5A:E0:3D,2164669,294772698,14549,21990216,2150120,272782482,0,10097,14137598,10048,14129055,49,8543,10047,2,14560,800,0,10,144444.0,43333.0,-66.0,-73.0,-66.0,-70.0,-66.0,-73.0,-65.0,-70.0,-77.0,-85.0,-78.0,-87.0,11.0,12.0,12.0,17.0,1
377,CC:2F:71:3E:C5:1F,2150165,272787974,45,5492,2150120,272782482,0,207,17520,176,13750,31,3770,50,1,76,2,0,8,130000.0,39000.0,-70.0,-68.0,-66.0,-60.0,-70.0,-68.0,-66.0,-60.0,-77.0,-85.0,-78.0,-87.0,7.0,17.0,12.0,27.0,1
378,CC:2F:71:3F:1F:24,2231725,381032840,81605,108250358,2150120,272782482,3,54105,61207324,54053,61200642,52,6682,52212,138,81627,16177,3,46,130000.0,43333.0,-70.0,-63.0,-68.0,-69.0,-70.0,-63.0,-69.0,-68.0,-77.0,-85.0,-78.0,-87.0,7.0,22.0,10.0,18.0,1
379,F8:59:71:5A:E0:3D,2164742,294873150,14616,22090062,2150126,272783088,0,10169,14237033,10120,14228490,49,8543,10117,2,14627,800,0,10,144444.0,43333.0,-67.0,-74.0,-65.0,-70.0,-66.0,-73.0,-65.0,-70.0,-77.0,-85.0,-78.0,-87.0,10.0,11.0,13.0,17.0,1
380,CC:2F:71:3E:C5:1F,2150171,272788580,45,5492,2150126,272783088,0,207,17520,176,13750,31,3770,50,1,76,2,0,8,130000.0,39000.0,-70.0,-68.0,-66.0,-60.0,-70.0,-68.0,-66.0,-60.0,-77.0,-85.0,-78.0,-87.0,7.0,17.0,12.0,27.0,1
381,CC:2F:71:3F:1F:24,2231898,381245949,81772,108462861,2150126,272783088,3,54262,61415206,54210,61408524,52,6682,52364,138,81794,16185,3,46,144444.0,43333.0,-70.0,-63.0,-69.0,-69.0,-69.0,-63.0,-68.0,-69.0,-77.0,-85.0,-78.0,-87.0,7.0,22.0,9.0,18.0,1
382,F8:59:71:5A:E0:3D,2164807,294969760,14678,22186410,2150129,272783350,0,10231,14332513,10182,14323970,49,8543,10179,2,14689,800,0,10,144444.0,43333.0,-66.0,-74.0,-65.0,-70.0,-66.0,-73.0,-65.0,-70.0,-77.0,-85.0,-78.0,-87.0,11.0,11.0,13.0,17.0,1
383,CC:2F:71:3E:C5:1F,2150174,272788842,45,5492,2150129,272783350,0,207,17520,176,13750,31,3770,50,1,76,2,0,8,130000.0,39000.0,-70.0,-68.0,-66.0,-60.0,-70.0,-68.0,-66.0,-60.0,-77.0,-85.0,-78.0,-87.0,7.0,17.0,12.0,27.0,1
384,CC:2F:71:3F:1F:24,2232057,381449307,81928,108665957,2150129,272783350,3,54411,61617438,54359,61610756,52,6682,52507,138,81950,16200,3,46,144444.0,43333.0,-70.0,-63.0,-69.0,-69.0,-69.0,-63.0,-69.0,-69.0,-77.0,-85.0,-78.0,-87.0,7.0,22.0,9.0,18.0,1
385,F8:59:71:5A:E0:3D,2164875,295066714,14740,22282758,2150135,272783956,0,10293,14427993,10244,14419450,49,8543,10241,2,14751,800,0,10,144444.0,43333.0,-66.0,-73.0,-66.0,-70.0,-66.0,-73.0,-65.0,-70.0,-77.0,-85.0,-78.0,-87.0,11.0,12.0,12.0,17.0,1
386,CC:2F:71:3E:C5:1F,2150180,272789448,45,5492,2150135,272783956,0,207,17520,176,13750,31,3770,50,1,76,2,0,8,130000.0,39000.0,-70.0,-68.0,-66.0,-60.0,-70.0,-68.0,-66.0,-60.0,-77.0,-85.0,-78.0,-87.0,7.0,17.0,12.0,27.0,1
387,CC:2F:71:3F:1F:24,2232219,381652953,82084,108868997,2150135,272783956,3,54560,61822436,54508,61815754,52,6682,52649,138,82106,16206,3,46,130000.0,43333.0,-71.0,-63.0,-70.0,-69.0,-70.0,-63.0,-69.0,-68.0,-77.0,-85.0,-78.0,-87.0,6.0,22.0,8.0,18.0,1
388,F8:59:71:5A:E0:3D,2164940,295163595,14804,22379366,2150136,272784229,0,10357,14524805,10308,14516262,49,8543,10305,2,14815,800,0,10,144444.0,43333.0,-66.0,-73.0,-66.0,-70.0,-66.0,-73.0,-65.0,-70.0,-78.0,-85.0,-78.0,-87.0,12.0,12.0,12.0,17.0,1
389,CC:2F:71:3E:C5:1F,2150183,272789923,45,5492,2150138,272784431,0,207,17520,176,13750,31,3770,50,1,76,2,0,8,130000.0,39000.0,-70.0,-68.0,-66.0,-60.0,-70.0,-68.0,-66.0,-60.0,-78.0,-85.0,-78.0,-87.0,8.0,17.0,12.0,27.0,1
390,CC:2F:71:3F:1F:24,2232378,381857948,82240,109073517,2150138,272784431,3,54706,62024196,54654,62017514,52,6682,52791,138,82262,16206,3,46,130000.0,43333.0,-70.0,-63.0,-69.0,-69.0,-70.0,-63.0,-68.0,-69.0,-78.0,-85.0,-78.0,-87.0,8.0,22.0,9.0,18.0,1
391,F8:59:71:5A:E0:3D,2165134,295442210,14991,22657315,2150143,272784895,0,10435,14626209,10386,14617666,49,8543,10383,2,15002,800,0,10,144444.0,43333.0,-67.0,-73.0,-65.0,-70.0,-66.0,-73.0,-65.0,-70.0,-78.0,-86.0,-78.0,-87.0,11.0,13.0,13.0,17.0,1
392,CC:2F:71:3E:C5:1F,2150188,272790387,45,5492,2150143,272784895,0,207,17520,176,13750,31,3770,50,1,76,2,0,8,130000.0,39000.0,-70.0,-68.0,-66.0,-60.0,-70.0,-68.0,-66.0,-60.0,-78.0,-86.0,-78.0,-87.0,8.0,18.0,12.0,27.0,1
393,CC:2F:71:3F:1F:24,2232549,382066567,82404,109281470,2150145,272785097,3,54860,62228841,54808,62222159,52,6682,52940,138,82426,16218,3,46,144444.0,43333.0,-70.0,-63.0,-69.0,-69.0,-69.0,-63.0,-69.0,-69.0,-78.0,-86.0,-78.0,-87.0,8.0,23.0,9.0,18.0,1
394,F8:59:71:5A:E0:3D,2165204,295543906,15057,22758441,2150147,272785465,0,10501,14726415,10452,14717872,49,8543,10449,2,15068,801,0,10,144444.0,43333.0,-66.0,-73.0,-67.0,-70.0,-66.0,-73.0,-65.0,-70.0,-78.0,-86.0,-78.0,-87.0,12.0,13.0,11.0,17.0,1
395,CC:2F:71:3E:C5:1F,2150192,272790957,45,5492,2150147,272785465,0,207,17520,176,13750,31,3770,50,1,76,2,0,8,130000.0,39000.0,-70.0,-68.0,-66.0,-60.0,-70.0,-68.0,-66.0,-60.0,-78.0,-86.0,-78.0,-87.0,8.0,18.0,12.0,27.0,1
396,CC:2F:71:3F:1F:24,2232712,382276363,82565,109490898,2150147,272785465,3,55010,62433875,54958,62427193,52,6682,53088,138,82587,16229,3,46,144444.0,43333.0,-69.0,-63.0,-69.0,-69.0,-69.0,-63.0,-68.0,-69.0,-78.0,-86.0,-78.0,-87.0,9.0,23.0,9.0,18.0,1
397,F8:59:71:5A:E0:3D,2165271,295642212,15120,22856343,2150151,272785869,0,10564,14823435,10515,14814892,49,8543,10512,2,15131,801,0,10,144444.0,43333.0,-67.0,-74.0,-65.0,-71.0,-66.0,-73.0,-65.0,-70.0,-78.0,-86.0,-78.0,-87.0,11.0,12.0,13.0,16.0,1
398,CC:2F:71:3E:C5:1F,2150196,272791361,45,5492,2150151,272785869,0,207,17520,176,13750,31,3770,50,1,76,2,0,8,130000.0,39000.0,-70.0,-68.0,-66.0,-60.0,-70.0,-68.0,-66.0,-60.0,-78.0,-86.0,-78.0,-87.0,8.0,18.0,12.0,27.0,1
399,CC:2F:71:3F:1F:24,2232875,382483043,82722,109696972,2150153,272786071,3,55154,62633965,55102,62627283,52,6682,53229,138,82744,16244,3,46,144444.0,43333.0,-70.0,-63.0,-69.0,-69.0,-69.0,-63.0,-69.0,-69.0,-78.0,-86.0,-78.0,-87.0,8.0,23.0,9.0,18.0,1
400,F8:59:71:5A:E0:3D,2165500,295991474,15344,23205141,2150156,272786333,0,10648,14926209,10599,14917666,49,8543,10596,2,15355,801,0,10,144444.0,43333.0,-67.0,-74.0,-66.0,-70.0,-66.0,-73.0,-66.0,-70.0,-78.0,-86.0,-78.0,-87.0,11.0,12.0,12.0,17.0,1
401,CC:2F:71:3E:C5:1F,2150201,272791825,45,5492,2150156,272786333,0,207,17520,176,13750,31,3770,50,1,76,2,0,8,130000.0,39000.0,-70.0,-68.0,-66.0,-60.0,-70.0,-68.0,-66.0,-60.0,-78.0,-86.0,-78.0,-87.0,8.0,18.0,12.0,27.0,1
402,CC:2F:71:3F:1F:24,2233042,382690375,82886,109904042,2150156,272786333,3,55306,62841183,55254,62834501,52,6682,53376,138,82908,16252,3,47,130000.0,43333.0,-70.0,-63.0,-69.0,-69.0,-69.0,-63.0,-68.0,-69.0,-78.0,-86.0,-78.0,-87.0,8.0,23.0,9.0,18.0,1
403,F8:59:71:5A:E0:3D,2165566,296088226,15406,23301489,2150160,272786737,0,10710,15021689,10661,15013146,49,8543,10658,2,15417,801,0,10,144444.0,43333.0,-66.0,-73.0,-67.0,-70.0,-66.0,-73.0,-66.0,-69.0,-78.0,-86.0,-78.0,-87.0,12.0,13.0,11.0,17.0,1
404,CC:2F:71:3E:C5:1F,2150205,272792229,45,5492,2150160,272786737,0,207,17520,176,13750,31,3770,50,1,76,2,0,8,130000.0,39000.0,-70.0,-68.0,-66.0,-60.0,-70.0,-68.0,-66.0,-60.0,-78.0,-86.0,-78.0,-87.0,8.0,18.0,12.0,27.0,1
405,CC:2F:71:3F:1F:24,2233206,382899699,83046,110112962,2150160,272786737,3,55458,63052225,55406,63045543,52,6682,53521,138,83068,16277,3,47,130000.0,39000.0,-69.0,-64.0,-67.0,-68.0,-69.0,-63.0,-68.0,-68.0,-78.0,-85.0,-78.0,-87.0,9.0,21.0,11.0,19.0,1
406,F8:59:71:5A:E0:3D,2165634,296188086,15470,23400945,2150164,272787141,0,10774,15120249,10725,15111706,49,8543,10722,2,15481,801,0,10,144444.0,43333.0,-66.0,-73.0,-65.0,-70.0,-66.0,-73.0,-65.0,-69.0,-78.0,-85.0,-78.0,-87.0,12.0,12.0,13.0,17.0,1
407,CC:2F:71:3E:C5:1F,2150209,272792633,45,5492,2150164,272787141,0,207,17520,176,13750,31,3770,50,1,76,2,0,8,130000.0,39000.0,-70.0,-68.0,-66.0,-60.0,-70.0,-68.0,-66.0,-60.0,-78.0,-85.0,-78.0,-87.0,8.0,17.0,12.0,27.0,1
408,CC:2F:71:3F:1F:24,2233372,383105702,83208,110318561,2150164,272787141,3,55607,63250735,55555,63244053,52,6682,53668,138,83230,16317,3,48,86667.0,14444.0,-68.0,-64.0,-69.0,-71.0,-68.0,-63.0,-69.0,-71.0,-78.0,-85.0,-78.0,-87.0,10.0,21.0,9.0,16.0,1
409,F8:59:71:5A:E0:3D,2165699,296284696,15532,23497293,2150167,272787403,0,10836,15215729,10787,15207186,49,8543,10784,2,15543,802,0,10,144444.0,43333.0,-66.0,-73.0,-66.0,-70.0,-66.0,-73.0,-65.0,-70.0,-78.0,-85.0,-78.0,-87.0,12.0,12.0,12.0,17.0,1
410,CC:2F:71:3E:C5:1F,2150212,272792895,45,5492,2150167,272787403,0,207,17520,176,13750,31,3770,50,1,76,2,0,8,130000.0,39000.0,-70.0,-68.0,-66.0,-60.0,-70.0,-68.0,-66.0,-60.0,-78.0,-85.0,-78.0,-87.0,8.0,17.0,12.0,27.0,1
411,CC:2F:71:3F:1F:24,2233540,383309883,83369,110522068,2150171,272787815,3,55760,63457759,55708,63451077,52,6682,53814,138,83391,16317,3,48,86667.0,14444.0,-70.0,-63.0,-70.0,-69.0,-70.0,-63.0,-69.0,-69.0,-78.0,-85.0,-78.0,-87.0,8.0,22.0,8.0,18.0,1
412,F8:59:71:5A:E0:3D,2165800,296423464,15625,23635245,2150175,272788219,0,10907,15318749,10858,15310206,49,8543,10855,2,15636,802,0,10,144444.0,43333.0,-67.0,-73.0,-66.0,-69.0,-66.0,-73.0,-65.0,-69.0,-78.0,-85.0,-78.0,-87.0,11.0,12.0,12.0,18.0,1
413,CC:2F:71:3E:C5:1F,2150220,272793711,45,5492,2150175,272788219,0,210,17912,177,13820,33,4092,52,1,76,2,0,8,130000.0,39000.0,-71.0,-69.0,-67.0,-60.0,-70.0,-68.0,-66.0,-60.0,-78.0,-85.0,-78.0,-87.0,7.0,16.0,11.0,27.0,1
414,CC:2F:71:3F:1F:24,2233701,383512943,83526,110724724,2150175,272788219,3,55910,63661444,55858,63654762,52,6682,53957,138,83548,16318,3,48,115556.0,26000.0,-70.0,-63.0,-68.0,-69.0,-69.0,-63.0,-68.0,-68.0,-78.0,-85.0,-78.0,-87.0,8.0,22.0,10.0,18.0,1
415,F8:59:71:5A:E0:3D,2165862,296519812,15687,23731593,2150175,272788219,0,10969,15414229,10920,15405686,49,8543,10917,2,15698,802,0,10,144444.0,43333.0,-67.0,-74.0,-65.0,-69.0,-67.0,-73.0,-65.0,-69.0,-78.0,-85.0,-78.0,-87.0,11.0,11.0,13.0,18.0,1
416,CC:2F:71:3E:C5:1F,2150220,272793711,45,5492,2150175,272788219,0,210,17912,177,13820,33,4092,52,1,76,2,0,8,130000.0,39000.0,-71.0,-69.0,-67.0,-60.0,-70.0,-68.0,-66.0,-60.0,-78.0,-85.0,-78.0,-87.0,7.0,16.0,11.0,27.0,1
417,CC:2F:71:3F:1F:24,2233859,383717161,83682,110928740,2150177,272788421,3,56061,63870960,56009,63864278,52,6682,54100,138,83703,16334,3,48,130000.0,39000.0,-71.0,-64.0,-72.0,-71.0,-70.0,-64.0,-69.0,-71.0,-78.0,-85.0,-78.0,-87.0,7.0,21.0,6.0,16.0,1
418,F8:59:71:5A:E0:3D,2165938,296619540,15754,23830453,2150184,272789087,0,11038,15515297,10989,15506754,49,8543,10986,2,15765,802,0,10,144444.0,43333.0,-66.0,-74.0,-66.0,-70.0,-66.0,-73.0,-65.0,-69.0,-78.0,-85.0,-78.0,-87.0,12.0,11.0,12.0,17.0,1
419,CC:2F:71:3E:C5:1F,2150229,272794579,45,5492,2150184,272789087,0,210,17912,177,13820,33,4092,52,1,76,2,0,8,130000.0,39000.0,-71.0,-69.0,-67.0,-60.0,-70.0,-68.0,-66.0,-60.0,-78.0,-85.0,-78.0,-87.0,7.0,16.0,11.0,27.0,1
420,CC:2F:71:3F:1F:24,2234056,383944793,83872,111155706,2150184,272789087,3,56247,64102399,56195,64095717,52,6682,54277,138,83893,16379,3,49,86667.0,14444.0,-69.0,-65.0,-69.0,-71.0,-69.0,-64.0,-68.0,-71.0,-78.0,-85.0,-78.0,-87.0,9.0,20.0,9.0,16.0,1
421,F8:59:71:5A:E0:3D,2166007,296726766,15823,23937679,2150184,272789087,0,11106,15620017,11057,15611474,49,8543,11054,2,15834,802,0,10,144444.0,43333.0,-67.0,-73.0,-65.0,-70.0,-66.0,-73.0,-65.0,-69.0,-78.0,-85.0,-78.0,-87.0,11.0,12.0,13.0,17.0,1
422,CC:2F:71:3E:C5:1F,2150229,272794579,45,5492,2150184,272789087,0,210,17912,177,13820,33,4092,52,1,76,2,0,8,130000.0,39000.0,-71.0,-69.0,-67.0,-60.0,-70.0,-68.0,-66.0,-60.0,-78.0,-85.0,-78.0,-87.0,7.0,16.0,11.0,27.0,1
423,CC:2F:71:3F:1F:24,2234213,384150195,84029,111361108,2150184,272789087,3,56399,64306493,56347,64299811,52,6682,54420,138,84051,16400,3,49,117000.0,39000.0,-70.0,-66.0,-69.0,-69.0,-69.0,-65.0,-70.0,-68.0,-78.0,-85.0,-78.0,-87.0,8.0,19.0,9.0,18.0,1
424,F8:59:71:5A:E0:3D,2166077,296823930,15885,24034027,2150192,272789903,0,11170,15715819,11119,15706954,51,8865,11118,2,15896,802,0,10,144444.0,43333.0,-66.0,-74.0,-65.0,-69.0,-66.0,-73.0,-64.0,-69.0,-78.0,-85.0,-78.0,-87.0,12.0,11.0,13.0,18.0,1
425,CC:2F:71:3E:C5:1F,2150239,272795597,45,5492,2150194,272790105,0,210,17912,177,13820,33,4092,52,1,76,2,0,8,130000.0,39000.0,-71.0,-69.0,-67.0,-60.0,-70.0,-68.0,-66.0,-60.0,-78.0,-85.0,-78.0,-87.0,7.0,16.0,11.0,27.0,1
426,CC:2F:71:3F:1F:24,2234382,384357141,84187,111566976,2150195,272790165,3,56547,64511319,56495,64504637,52,6682,54565,138,84209,16404,3,49,130000.0,43333.0,-68.0,-65.0,-72.0,-69.0,-68.0,-64.0,-70.0,-68.0,-78.0,-85.0,-78.0,-87.0,10.0,20.0,6.0,18.0,1
427,F8:59:71:5A:E0:3D,2166151,296924265,15956,24134100,2150195,272790165,0,11243,15816082,11192,15807217,51,8865,11191,2,15967,802,0,10,144444.0,43333.0,-67.0,-73.0,-66.0,-70.0,-66.0,-73.0,-64.0,-70.0,-78.0,-85.0,-78.0,-87.0,11.0,12.0,12.0,17.0,1
428,CC:2F:71:3E:C5:1F,2150240,272795657,45,5492,2150195,272790165,0,210,17912,177,13820,33,4092,52,1,76,2,0,8,130000.0,39000.0,-71.0,-69.0,-67.0,-60.0,-70.0,-68.0,-66.0,-60.0,-78.0,-85.0,-78.0,-87.0,7.0,16.0,11.0,27.0,1
429,CC:2F:71:3F:1F:24,2234991,385127298,84796,112337133,2150195,272790165,3,56893,64745614,56841,64738932,52,6682,54899,138,84816,16404,3,49,130000.0,43333.0,-70.0,-65.0,-70.0,-68.0,-69.0,-65.0,-69.0,-68.0,-78.0,-85.0,-78.0,-87.0,8.0,20.0,8.0,19.0,1
430,F8:59:71:5A:E0:3D,2166492,297436609,16291,24645838,2150201,272790771,0,11341,15926629,11290,15917764,51,8865,11288,2,16302,802,0,10,144444.0,43333.0,-66.0,-74.0,-66.0,-70.0,-66.0,-73.0,-65.0,-69.0,-77.0,-85.0,-78.0,-87.0,11.0,11.0,12.0,17.0,1
431,CC:2F:71:3E:C5:1F,2150248,272796652,46,5608,2150202,272791044,0,212,18052,179,13960,33,4092,52,1,77,2,0,8,130000.0,39000.0,-71.0,-70.0,-66.0,-60.0,-70.0,-69.0,-66.0,-60.0,-77.0,-85.0,-78.0,-87.0,6.0,15.0,12.0,27.0,1
432,CC:2F:71:3F:1F:24,2235362,385585794,85160,112794750,2150202,272791044,3,57137,64964144,57085,64957462,52,6682,55133,138,85182,16404,3,51,144444.0,43333.0,-70.0,-64.0,-69.0,-68.0,-69.0,-64.0,-69.0,-68.0,-77.0,-85.0,-78.0,-87.0,7.0,21.0,9.0,19.0,1
433,F8:59:71:5A:E0:3D,2166557,297533432,16353,24742186,2150204,272791246,0,11404,16023649,11353,16014784,51,8865,11351,2,16364,802,0,10,144444.0,43333.0,-67.0,-73.0,-65.0,-70.0,-66.0,-73.0,-65.0,-70.0,-77.0,-85.0,-78.0,-87.0,10.0,12.0,13.0,17.0,1
434,CC:2F:71:3E:C5:1F,2150251,272796914,46,5608,2150205,272791306,0,212,18052,179,13960,33,4092,52,1,77,2,0,8,130000.0,39000.0,-71.0,-70.0,-66.0,-60.0,-70.0,-69.0,-66.0,-60.0,-77.0,-85.0,-78.0,-87.0,6.0,15.0,12.0,27.0,1
435,CC:2F:71:3F:1F:24,2235536,385792783,85331,113001477,2150205,272791306,3,57294,65170667,57242,65163985,52,6682,55284,138,85353,16418,3,51,130000.0,43333.0,-69.0,-65.0,-68.0,-68.0,-68.0,-64.0,-69.0,-67.0,-77.0,-85.0,-78.0,-87.0,8.0,20.0,10.0,19.0,1
436,F8:59:71:5A:E0:3D,2166624,297630244,16415,24838534,2150209,272791710,0,11466,16119129,11415,16110264,51,8865,11413,2,16426,802,0,10,144444.0,43333.0,-67.0,-73.0,-65.0,-70.0,-67.0,-73.0,-65.0,-69.0,-77.0,-85.0,-78.0,-87.0,10.0,12.0,13.0,17.0,1
437,CC:2F:71:3E:C5:1F,2150255,272797318,46,5608,2150209,272791710,0,212,18052,179,13960,33,4092,52,1,77,2,0,8,130000.0,39000.0,-71.0,-70.0,-66.0,-60.0,-70.0,-69.0,-66.0,-60.0,-77.0,-85.0,-78.0,-87.0,6.0,15.0,12.0,27.0,1
438,CC:2F:71:3F:1F:24,2235710,386002305,85501,113210595,2150209,272791710,3,57455,65376918,57403,65370236,52,6682,55440,138,85523,16418,3,52,130000.0,43333.0,-69.0,-64.0,-69.0,-68.0,-69.0,-64.0,-69.0,-67.0,-77.0,-85.0,-78.0,-87.0,8.0,21.0,9.0,19.0,1
439,F8:59:71:5A:E0:3D,2166691,297728438,16478,24936324,2150213,272792114,0,11524,16208449,11473,16199584,51,8865,11471,2,16489,802,0,10,144444.0,39000.0,-66.0,-73.0,-67.0,-70.0,-67.0,-73.0,-65.0,-70.0,-77.0,-85.0,-78.0,-87.0,11.0,12.0,11.0,17.0,1
440,CC:2F:71:3E:C5:1F,2150259,272797722,46,5608,2150213,272792114,0,212,18052,179,13960,33,4092,52,1,77,2,0,8,130000.0,39000.0,-71.0,-70.0,-66.0,-60.0,-70.0,-69.0,-66.0,-60.0,-77.0,-85.0,-78.0,-87.0,6.0,15.0,12.0,27.0,1
441,CC:2F:71:3F:1F:24,2235875,386214831,85662,113422717,2150213,272792114,3,57604,65580422,57552,65573740,52,6682,55589,138,85684,16427,3,53,144444.0,43333.0,-69.0,-64.0,-69.0,-68.0,-69.0,-64.0,-69.0,-67.0,-77.0,-85.0,-78.0,-87.0,8.0,21.0,9.0,19.0,1
442,F8:59:71:5A:E0:3D,2166761,297829856,16543,25037278,2150218,272792578,0,11594,16316361,11543,16307496,51,8865,11541,2,16554,802,0,11,144444.0,43333.0,-67.0,-74.0,-66.0,-70.0,-67.0,-73.0,-65.0,-69.0,-77.0,-85.0,-78.0,-87.0,10.0,11.0,12.0,17.0,1
443,CC:2F:71:3E:C5:1F,2150264,272798186,46,5608,2150218,272792578,0,212,18052,179,13960,33,4092,52,1,77,2,0,8,130000.0,39000.0,-71.0,-70.0,-66.0,-60.0,-70.0,-69.0,-66.0,-60.0,-77.0,-85.0,-78.0,-87.0,6.0,15.0,12.0,27.0,1
444,CC:2F:71:3F:1F:24,2236035,386418205,85817,113625627,2150218,272792578,3,57749,65779274,57697,65772592,52,6682,55733,138,85839,16445,3,53,130000.0,43333.0,-69.0,-64.0,-70.0,-68.0,-69.0,-64.0,-70.0,-67.0,-77.0,-85.0,-78.0,-87.0,8.0,21.0,8.0,19.0,1
445,F8:59:71:5A:E0:3D,2166904,298031055,16682,25238073,2150222,272792982,0,11679,16423597,11628,16414732,51,8865,11626,2,16693,802,0,11,144444.0,43333.0,-67.0,-74.0,-65.0,-70.0,-67.0,-74.0,-65.0,-70.0,-77.0,-85.0,-78.0,-87.0,10.0,11.0,13.0,17.0,1
446,CC:2F:71:3E:C5:1F,2150268,272798590,46,5608,2150222,272792982,0,212,18052,179,13960,33,4092,52,1,77,2,0,8,130000.0,39000.0,-71.0,-70.0,-66.0,-60.0,-70.0,-69.0,-66.0,-60.0,-77.0,-85.0,-78.0,-87.0,6.0,15.0,12.0,27.0,1
447,CC:2F:71:3F:1F:24,2236203,386628154,85981,113835172,2150222,272792982,3,57899,65976237,57847,65969555,52,6682,55883,138,86003,16445,3,53,130000.0,43333.0,-69.0,-64.0,-70.0,-68.0,-69.0,-64.0,-70.0,-67.0,-77.0,-85.0,-78.0,-87.0,8.0,21.0,8.0,19.0,1
448,F8:59:71:5A:E0:3D,2166966,298127403,16744,25334421,2150222,272792982,0,11741,16519077,11690,16510212,51,8865,11688,2,16755,802,0,11,144444.0,43333.0,-66.0,-73.0,-66.0,-70.0,-67.0,-73.0,-65.0,-70.0,-77.0,-85.0,-78.0,-87.0,11.0,12.0,12.0,17.0,1
449,CC:2F:71:3E:C5:1F,2150270,272798792,46,5608,2150224,272793184,0,212,18052,179,13960,33,4092,52,1,77,2,0,8,130000.0,39000.0,-71.0,-70.0,-66.0,-60.0,-70.0,-69.0,-66.0,-60.0,-77.0,-85.0,-78.0,-87.0,6.0,15.0,12.0,27.0,1
450,CC:2F:71:3F:1F:24,2236363,386831486,86137,114038100,2150226,272793386,3,58042,66170473,57990,66163791,52,6682,56026,138,86159,16468,3,53,144444.0,43333.0,-70.0,-64.0,-70.0,-67.0,-69.0,-64.0,-69.0,-67.0,-77.0,-85.0,-78.0,-87.0,7.0,21.0,8.0,20.0,1
451,F8:59:71:5A:E0:3D,2167044,298225668,16813,25431818,2150231,272793850,0,11808,16617163,11757,16608298,51,8865,11755,2,16824,802,0,11,144444.0,43333.0,-67.0,-73.0,-65.0,-70.0,-67.0,-73.0,-65.0,-70.0,-77.0,-85.0,-78.0,-86.0,10.0,12.0,13.0,16.0,1
452,CC:2F:71:3E:C5:1F,2150277,272799458,46,5608,2150231,272793850,0,212,18052,179,13960,33,4092,52,1,77,2,0,8,130000.0,39000.0,-71.0,-70.0,-66.0,-60.0,-70.0,-69.0,-66.0,-60.0,-77.0,-85.0,-78.0,-86.0,6.0,15.0,12.0,26.0,1
453,CC:2F:71:3F:1F:24,2236523,387034860,86292,114241010,2150231,272793850,3,58183,66363053,58131,66356371,52,6682,56167,138,86314,16477,3,53,130000.0,43333.0,-68.0,-64.0,-70.0,-67.0,-69.0,-64.0,-69.0,-67.0,-77.0,-85.0,-78.0,-86.0,9.0,21.0,8.0,19.0,1
454,F8:59:71:5A:E0:3D,2167260,298556090,17028,25762178,2150232,272793912,0,11893,16723301,11842,16714436,51,8865,11840,2,17039,814,0,11,144444.0,43333.0,-66.0,-73.0,-66.0,-70.0,-67.0,-73.0,-65.0,-70.0,-77.0,-85.0,-78.0,-86.0,11.0,12.0,12.0,16.0,1
455,CC:2F:71:3E:C5:1F,2150278,272799520,46,5608,2150232,272793912,0,214,18240,180,14030,34,4210,53,1,77,2,0,8,130000.0,39000.0,-70.0,-69.0,-67.0,-60.0,-70.0,-69.0,-66.0,-60.0,-77.0,-85.0,-78.0,-86.0,7.0,16.0,11.0,26.0,1
456,CC:2F:71:3F:1F:24,2236681,387240996,86449,114447084,2150232,272793912,3,58326,66561617,58274,66554935,52,6682,56310,138,86471,16477,3,53,130000.0,43333.0,-69.0,-64.0,-69.0,-68.0,-69.0,-64.0,-69.0,-67.0,-77.0,-85.0,-78.0,-86.0,8.0,21.0,9.0,18.0,1
457,F8:59:71:5A:E0:3D,2167330,298654660,17091,25860080,2150239,272794580,0,11956,16820321,11905,16811456,51,8865,11903,2,17102,814,0,11,144444.0,43333.0,-68.0,-74.0,-64.0,-70.0,-67.0,-73.0,-64.0,-70.0,-77.0,-85.0,-77.0,-86.0,9.0,11.0,13.0,16.0,1
458,CC:2F:71:3E:C5:1F,2150285,272800188,46,5608,2150239,272794580,0,214,18240,180,14030,34,4210,53,1,77,2,0,8,130000.0,39000.0,-70.0,-69.0,-67.0,-60.0,-70.0,-69.0,-66.0,-60.0,-77.0,-85.0,-77.0,-86.0,7.0,16.0,10.0,26.0,1
459,CC:2F:71:3F:1F:24,2236855,387452797,86614,114658015,2150241,272794782,3,58478,66761704,58425,66754904,53,6800,56462,138,86636,16482,3,53,144444.0,43333.0,-68.0,-64.0,-69.0,-67.0,-68.0,-64.0,-69.0,-67.0,-77.0,-85.0,-77.0,-86.0,9.0,21.0,8.0,19.0,1
460,F8:59:71:5A:E0:3D,2167400,298754839,17158,25959997,2150242,272794842,0,12022,16919513,11971,16910648,51,8865,11969,2,17169,814,0,11,144444.0,43333.0,-67.0,-73.0,-65.0,-71.0,-66.0,-73.0,-65.0,-70.0,-77.0,-85.0,-77.0,-86.0,10.0,12.0,12.0,15.0,1
461,CC:2F:71:3E:C5:1F,2150288,272800450,46,5608,2150242,272794842,0,214,18240,180,14030,34,4210,53,1,77,2,0,8,130000.0,39000.0,-70.0,-69.0,-67.0,-60.0,-70.0,-69.0,-66.0,-60.0,-77.0,-85.0,-77.0,-86.0,7.0,16.0,10.0,26.0,1
462,CC:2F:71:3F:1F:24,2237014,387657637,86772,114862795,2150242,272794842,3,58621,66956003,58568,66949203,53,6800,56605,138,86794,16490,3,53,144444.0,43333.0,-68.0,-64.0,-68.0,-68.0,-68.0,-64.0,-68.0,-67.0,-77.0,-85.0,-77.0,-86.0,9.0,21.0,9.0,18.0,1
463,F8:59:71:5A:E0:3D,2167466,298851591,17220,26056345,2150246,272795246,0,12085,17016533,12034,17007668,51,8865,12032,2,17231,814,0,11,144444.0,43333.0,-67.0,-74.0,-65.0,-70.0,-66.0,-73.0,-65.0,-69.0,-77.0,-85.0,-77.0,-86.0,10.0,11.0,12.0,16.0,1
464,CC:2F:71:3E:C5:1F,2150292,272800854,46,5608,2150246,272795246,0,214,18240,180,14030,34,4210,53,1,77,2,0,8,130000.0,39000.0,-70.0,-69.0,-67.0,-60.0,-70.0,-69.0,-66.0,-60.0,-77.0,-85.0,-77.0,-86.0,7.0,16.0,10.0,26.0,1
465,CC:2F:71:3F:1F:24,2237175,387861153,86927,115065705,2150248,272795448,3,58762,67150007,58709,67143207,53,6800,56746,138,86949,16499,3,53,130000.0,43333.0,-68.0,-64.0,-68.0,-68.0,-68.0,-64.0,-68.0,-67.0,-77.0,-85.0,-77.0,-86.0,9.0,21.0,9.0,18.0,1
466,F8:59:71:5A:E0:3D,2167537,298951909,17287,26156259,2150250,272795650,0,12153,17117451,12102,17108586,51,8865,12100,2,17298,814,0,11,144444.0,43333.0,-66.0,-73.0,-64.0,-70.0,-66.0,-73.0,-65.0,-69.0,-77.0,-85.0,-77.0,-86.0,11.0,12.0,13.0,16.0,1
467,CC:2F:71:3E:C5:1F,2150296,272801258,46,5608,2150250,272795650,0,214,18240,180,14030,34,4210,53,1,77,2,0,8,130000.0,39000.0,-70.0,-69.0,-67.0,-60.0,-70.0,-69.0,-66.0,-60.0,-77.0,-85.0,-77.0,-86.0,7.0,16.0,10.0,26.0,1
468,CC:2F:71:3F:1F:24,2237344,388069638,87094,115273988,2150250,272795650,3,58912,67352050,58859,67345250,53,6800,56896,138,87116,16499,3,53,130000.0,43333.0,-69.0,-64.0,-69.0,-67.0,-68.0,-64.0,-68.0,-67.0,-77.0,-85.0,-77.0,-86.0,8.0,21.0,8.0,19.0,1
469,F8:59:71:5A:E0:3D,2167604,299048721,17349,26252607,2150255,272796114,0,12215,17212931,12164,17204066,51,8865,12162,2,17360,814,0,11,144444.0,43333.0,-66.0,-73.0,-65.0,-70.0,-66.0,-73.0,-64.0,-69.0,-77.0,-85.0,-77.0,-86.0,11.0,12.0,12.0,16.0,1
470,CC:2F:71:3E:C5:1F,2150301,272801722,46,5608,2150255,272796114,0,214,18240,180,14030,34,4210,53,1,77,2,0,8,130000.0,39000.0,-70.0,-69.0,-67.0,-60.0,-70.0,-69.0,-66.0,-60.0,-77.0,-85.0,-77.0,-86.0,7.0,16.0,10.0,26.0,1
471,CC:2F:71:3F:1F:24,2237515,388279803,87260,115483689,2150255,272796114,3,59063,67550613,59010,67543813,53,6800,57046,138,87282,16499,3,53,144444.0,43333.0,-69.0,-65.0,-69.0,-67.0,-68.0,-64.0,-69.0,-67.0,-77.0,-85.0,-77.0,-86.0,8.0,20.0,8.0,19.0,1
472,F8:59:71:5A:E0:3D,2167672,299147089,17412,26350509,2150260,272796580,0,12279,17310069,12227,17301086,52,8983,12226,2,17423,814,0,11,144444.0,43333.0,-66.0,-73.0,-64.0,-70.0,-66.0,-73.0,-64.0,-69.0,-77.0,-85.0,-77.0,-86.0,11.0,12.0,13.0,16.0,1
473,CC:2F:71:3E:C5:1F,2150306,272802188,46,5608,2150260,272796580,0,214,18240,180,14030,34,4210,53,1,77,2,0,8,130000.0,39000.0,-70.0,-69.0,-67.0,-60.0,-70.0,-69.0,-66.0,-60.0,-77.0,-85.0,-77.0,-86.0,7.0,16.0,10.0,26.0,1
474,CC:2F:71:3F:1F:24,2237674,388480257,87414,115683677,2150260,272796580,3,59206,67744849,59153,67738049,53,6800,57189,138,87436,16499,3,53,144444.0,43333.0,-69.0,-64.0,-69.0,-67.0,-68.0,-64.0,-69.0,-67.0,-77.0,-85.0,-77.0,-86.0,8.0,21.0,8.0,19.0,1
475,F8:59:71:5A:E0:3D,2167739,299244114,17474,26446857,2150265,272797257,0,12341,17405549,12289,17396566,52,8983,12288,2,17485,814,0,11,144444.0,43333.0,-68.0,-74.0,-64.0,-70.0,-66.0,-73.0,-64.0,-70.0,-77.0,-84.0,-77.0,-86.0,9.0,10.0,13.0,16.0,1
476,CC:2F:71:3E:C5:1F,2150311,272802865,46,5608,2150265,272797257,0,214,18240,180,14030,34,4210,53,1,77,2,0,8,130000.0,39000.0,-70.0,-69.0,-67.0,-60.0,-70.0,-69.0,-66.0,-60.0,-77.0,-84.0,-77.0,-86.0,7.0,15.0,10.0,26.0,1
477,CC:2F:71:3F:1F:24,2237838,388688692,87573,115891435,2150265,272797257,3,59349,67940509,59296,67933709,53,6800,57332,138,87595,16500,3,53,144444.0,43333.0,-68.0,-64.0,-68.0,-67.0,-68.0,-64.0,-68.0,-67.0,-77.0,-84.0,-77.0,-86.0,9.0,20.0,9.0,19.0,1
478,F8:59:71:5A:E0:3D,2167921,299518736,17651,26721015,2150270,272797721,0,12420,17507721,12368,17498738,52,8983,12367,2,17662,815,0,11,144444.0,43333.0,-66.0,-73.0,-65.0,-70.0,-66.0,-73.0,-64.0,-69.0,-77.0,-84.0,-77.0,-86.0,11.0,11.0,12.0,16.0,1
479,CC:2F:71:3E:C5:1F,2150316,272803329,46,5608,2150270,272797721,0,214,18240,180,14030,34,4210,53,1,77,2,0,8,130000.0,39000.0,-70.0,-69.0,-67.0,-60.0,-70.0,-69.0,-66.0,-60.0,-77.0,-84.0,-77.0,-86.0,7.0,15.0,10.0,26.0,1
480,CC:2F:71:3F:1F:24,2238000,388893806,87730,116096085,2150270,272797721,3,59492,68137593,59439,68130793,53,6800,57475,138,87752,16501,3,53,144444.0,43333.0,-68.0,-64.0,-68.0,-67.0,-68.0,-64.0,-68.0,-67.0,-77.0,-84.0,-77.0,-86.0,9.0,20.0,9.0,19.0,1
481,F8:59:71:5A:E0:3D,2167984,299613732,17712,26815809,2150272,272797923,0,12481,17601661,12429,17592678,52,8983,12428,2,17723,816,0,11,144444.0,43333.0,-66.0,-73.0,-64.0,-70.0,-66.0,-73.0,-64.0,-69.0,-77.0,-84.0,-77.0,-86.0,11.0,11.0,13.0,16.0,1
482,CC:2F:71:3E:C5:1F,2150318,272803531,46,5608,2150272,272797923,0,214,18240,180,14030,34,4210,53,1,77,2,0,8,130000.0,39000.0,-70.0,-69.0,-67.0,-60.0,-70.0,-69.0,-66.0,-60.0,-77.0,-84.0,-77.0,-86.0,7.0,15.0,10.0,26.0,1
483,CC:2F:71:3F:1F:24,2238160,389097306,87886,116299181,2150274,272798125,3,59635,68331829,59582,68325029,53,6800,57618,138,87908,16505,3,53,144444.0,43333.0,-68.0,-65.0,-69.0,-68.0,-67.0,-64.0,-68.0,-67.0,-77.0,-84.0,-77.0,-86.0,9.0,19.0,8.0,18.0,1
484,F8:59:71:5A:E0:3D,2168053,299712240,17775,26913711,2150278,272798529,0,12544,17698681,12492,17689698,52,8983,12491,2,17786,816,0,11,144444.0,43333.0,-67.0,-74.0,-64.0,-70.0,-66.0,-73.0,-64.0,-70.0,-77.0,-84.0,-77.0,-86.0,10.0,10.0,13.0,16.0,1
485,CC:2F:71:3E:C5:1F,2150324,272804137,46,5608,2150278,272798529,0,214,18240,180,14030,34,4210,53,1,77,2,0,8,130000.0,39000.0,-70.0,-69.0,-67.0,-60.0,-70.0,-69.0,-66.0,-60.0,-77.0,-84.0,-77.0,-86.0,7.0,15.0,10.0,26.0,1
486,CC:2F:71:3F:1F:24,2238338,389310282,88060,116511753,2150278,272798529,3,59794,68530504,59741,68523704,53,6800,57777,138,88082,16507,3,53,144444.0,43333.0,-69.0,-65.0,-68.0,-68.0,-68.0,-64.0,-68.0,-67.0,-77.0,-84.0,-77.0,-86.0,8.0,19.0,9.0,18.0,1
487,F8:59:71:5A:E0:3D,2168117,299810202,17838,27011613,2150279,272798589,0,12607,17795701,12555,17786718,52,8983,12554,2,17849,816,0,11,144444.0,43333.0,-67.0,-74.0,-64.0,-70.0,-66.0,-73.0,-64.0,-69.0,-77.0,-84.0,-77.0,-86.0,10.0,10.0,13.0,16.0,1
488,CC:2F:71:3E:C5:1F,2150325,272804197,46,5608,2150279,272798589,0,214,18240,180,14030,34,4210,53,1,77,2,0,8,130000.0,39000.0,-70.0,-69.0,-67.0,-60.0,-70.0,-69.0,-66.0,-60.0,-77.0,-84.0,-77.0,-86.0,7.0,15.0,10.0,26.0,1
489,CC:2F:71:3F:1F:24,2238499,389516734,88218,116717943,2150281,272798791,3,59937,68727578,59884,68720778,53,6800,57920,138,88240,16507,3,53,144444.0,43333.0,-69.0,-64.0,-69.0,-67.0,-68.0,-64.0,-69.0,-67.0,-77.0,-84.0,-77.0,-86.0,8.0,20.0,8.0,19.0,1
490,F8:59:71:5A:E0:3D,2168368,300195175,18085,27396182,2150283,272798993,0,12689,17896819,12637,17887836,52,8983,12636,2,18096,858,0,11,144444.0,43333.0,-66.0,-73.0,-64.0,-70.0,-66.0,-73.0,-64.0,-69.0,-77.0,-84.0,-77.0,-85.0,11.0,11.0,13.0,15.0,1
491,CC:2F:71:3E:C5:1F,2150329,272804601,46,5608,2150283,272798993,0,214,18240,180,14030,34,4210,53,1,77,2,0,8,130000.0,39000.0,-70.0,-69.0,-67.0,-60.0,-70.0,-69.0,-66.0,-60.0,-77.0,-84.0,-77.0,-85.0,7.0,15.0,10.0,25.0,1
492,CC:2F:71:3F:1F:24,2238661,389720436,88374,116921039,2150287,272799397,3,60087,68934116,60034,68927316,53,6800,58063,138,88396,16510,3,53,144444.0,43333.0,-69.0,-64.0,-69.0,-67.0,-68.0,-64.0,-68.0,-67.0,-77.0,-84.0,-77.0,-85.0,8.0,20.0,8.0,18.0,1
493,F8:59:71:5A:E0:3D,2168434,300291927,18147,27492530,2150287,272799397,0,12752,17993839,12700,17984856,52,8983,12699,2,18158,859,0,11,144444.0,43333.0,-67.0,-74.0,-65.0,-70.0,-66.0,-73.0,-65.0,-70.0,-77.0,-84.0,-77.0,-85.0,10.0,10.0,12.0,15.0,1
494,CC:2F:71:3E:C5:1F,2150333,272805005,46,5608,2150287,272799397,0,214,18240,180,14030,34,4210,53,1,77,2,0,8,130000.0,39000.0,-70.0,-69.0,-67.0,-60.0,-70.0,-69.0,-66.0,-60.0,-77.0,-84.0,-77.0,-85.0,7.0,15.0,10.0,25.0,1
495,CC:2F:71:3F:1F:24,2238819,389926768,88532,117127371,2150287,272799397,3,60242,69146970,60189,69140170,53,6800,58209,138,88554,16511,3,53,144444.0,43333.0,-68.0,-64.0,-68.0,-67.0,-68.0,-64.0,-68.0,-67.0,-77.0,-84.0,-77.0,-85.0,9.0,20.0,9.0,18.0,1
496,F8:59:71:5A:E0:3D,2168535,300434807,18243,27634946,2150292,272799861,0,12827,18098667,12775,18089684,52,8983,12772,2,18254,859,0,11,144444.0,43333.0,-66.0,-73.0,-65.0,-70.0,-66.0,-73.0,-64.0,-70.0,-77.0,-84.0,-77.0,-85.0,11.0,11.0,12.0,15.0,1
497,CC:2F:71:3E:C5:1F,2150338,272805469,46,5608,2150292,272799861,0,214,18240,180,14030,34,4210,53,1,77,2,0,8,130000.0,39000.0,-70.0,-69.0,-67.0,-60.0,-70.0,-69.0,-66.0,-60.0,-77.0,-84.0,-77.0,-85.0,7.0,15.0,10.0,25.0,1
498,CC:2F:71:3F:1F:24,2238989,390136909,88697,117337048,2150292,272799861,3,60401,69356638,60348,69349838,53,6800,58358,138,88719,16518,3,53,144444.0,43333.0,-70.0,-64.0,-70.0,-67.0,-68.0,-64.0,-68.0,-67.0,-77.0,-84.0,-77.0,-85.0,7.0,20.0,7.0,18.0,1
499,F8:59:71:5A:E0:3D,2168606,300535125,18310,27734860,2150296,272800265,0,12897,18199725,12845,18190742,52,8983,12840,2,18321,859,0,11,144444.0,43333.0,-67.0,-73.0,-64.0,-70.0,-66.0,-73.0,-64.0,-70.0,-77.0,-84.0,-77.0,-85.0,10.0,11.0,13.0,15.0,1
500,CC:2F:71:3E:C5:1F,2150342,272805873,46,5608,2150296,272800265,0,214,18240,180,14030,34,4210,53,1,77,2,0,8,130000.0,39000.0,-70.0,-69.0,-67.0,-60.0,-70.0,-69.0,-66.0,-60.0,-77.0,-84.0,-77.0,-85.0,7.0,15.0,10.0,25.0,1
501,CC:2F:71:3F:1F:24,2239173,390352093,88877,117551828,2150296,272800265,3,60572,69572871,60519,69566071,53,6800,58520,138,88899,16523,3,53,144444.0,43333.0,-69.0,-65.0,-69.0,-67.0,-68.0,-64.0,-68.0,-67.0,-77.0,-84.0,-77.0,-85.0,8.0,19.0,8.0,18.0,1
502,F8:59:71:5A:E0:3D,2168673,300633431,18373,27832762,2150300,272800669,0,12961,18296885,12909,18287902,52,8983,12903,2,18384,859,0,11,144444.0,43333.0,-67.0,-72.0,-64.0,-70.0,-66.0,-73.0,-64.0,-70.0,-77.0,-84.0,-77.0,-85.0,10.0,12.0,13.0,15.0,1
503,CC:2F:71:3E:C5:1F,2150346,272806277,46,5608,2150300,272800669,0,214,18240,180,14030,34,4210,53,1,77,2,0,8,130000.0,39000.0,-70.0,-69.0,-67.0,-60.0,-70.0,-69.0,-66.0,-60.0,-77.0,-84.0,-77.0,-85.0,7.0,15.0,10.0,25.0,1
504,CC:2F:71:3F:1F:24,2239418,390615644,89117,117814915,2150301,272800729,3,60779,69785744,60726,69778944,53,6800,58723,138,89139,16539,3,55,144444.0,43333.0,-67.0,-64.0,-68.0,-68.0,-68.0,-64.0,-68.0,-67.0,-77.0,-84.0,-77.0,-85.0,10.0,20.0,9.0,17.0,1
505,F8:59:71:5A:E0:3D,2168742,300731913,18437,27930780,2150305,272801133,0,13026,18394081,12974,18385098,52,8983,12967,2,18448,859,0,11,144444.0,43333.0,-67.0,-74.0,-65.0,-70.0,-66.0,-73.0,-65.0,-70.0,-77.0,-84.0,-77.0,-85.0,10.0,10.0,12.0,15.0,1
506,CC:2F:71:3E:C5:1F,2150351,272806741,46,5608,2150305,272801133,0,214,18240,180,14030,34,4210,53,1,77,2,0,8,130000.0,39000.0,-70.0,-69.0,-67.0,-60.0,-70.0,-69.0,-66.0,-60.0,-77.0,-84.0,-77.0,-85.0,7.0,15.0,10.0,25.0,1
507,CC:2F:71:3F:1F:24,2239581,390822368,89276,118021235,2150305,272801133,3,60926,69986172,60873,69979372,53,6800,58867,138,89298,16550,3,55,144444.0,43333.0,-68.0,-64.0,-69.0,-67.0,-68.0,-64.0,-68.0,-67.0,-77.0,-84.0,-77.0,-85.0,9.0,20.0,8.0,18.0,1
508,F8:59:71:5A:E0:3D,2168808,300828609,18499,28027072,2150309,272801537,0,13088,18489561,13036,18480578,52,8983,13029,2,18510,859,0,11,130000.0,39000.0,-65.0,-73.0,-66.0,-69.0,-66.0,-73.0,-65.0,-69.0,-76.0,-84.0,-77.0,-85.0,11.0,11.0,11.0,16.0,1
509,CC:2F:71:3E:C5:1F,2150355,272807145,46,5608,2150309,272801537,0,216,18380,182,14170,34,4210,53,1,78,2,0,8,130000.0,39000.0,-70.0,-69.0,-67.0,-60.0,-70.0,-69.0,-66.0,-60.0,-76.0,-84.0,-77.0,-85.0,6.0,15.0,10.0,25.0,1
510,CC:2F:71:3F:1F:24,2239757,391034151,89448,118232614,2150309,272801537,3,61090,70196304,61037,70189504,53,6800,59022,138,89470,16561,3,55,144444.0,43333.0,-69.0,-64.0,-69.0,-67.0,-68.0,-64.0,-68.0,-67.0,-76.0,-84.0,-77.0,-85.0,7.0,20.0,8.0,18.0,1
511,F8:59:71:5A:E0:3D,2168875,300926803,18562,28124862,2150313,272801941,0,13151,18586581,13099,18577598,52,8983,13092,2,18573,859,0,11,144444.0,43333.0,-66.0,-73.0,-65.0,-70.0,-66.0,-73.0,-64.0,-69.0,-76.0,-84.0,-77.0,-85.0,10.0,11.0,12.0,15.0,1
512,CC:2F:71:3E:C5:1F,2150360,272807609,46,5608,2150314,272802001,0,216,18380,182,14170,34,4210,53,1,78,2,0,8,130000.0,39000.0,-70.0,-69.0,-67.0,-60.0,-70.0,-69.0,-66.0,-60.0,-76.0,-84.0,-77.0,-85.0,6.0,15.0,10.0,25.0,1
513,CC:2F:71:3F:1F:24,2239924,391243892,89610,118441891,2150314,272802001,3,61244,70404730,61191,70397930,53,6800,59169,138,89632,16565,3,55,144444.0,43333.0,-68.0,-65.0,-68.0,-68.0,-68.0,-64.0,-68.0,-67.0,-76.0,-84.0,-77.0,-85.0,8.0,19.0,9.0,17.0,1
514,F8:59:71:5A:E0:3D,2169141,301336130,18825,28533927,2150316,272802203,0,13240,18691383,13188,18682400,52,8983,13181,2,18836,901,0,11,144444.0,43333.0,-67.0,-73.0,-64.0,-70.0,-66.0,-73.0,-64.0,-69.0,-76.0,-84.0,-77.0,-85.0,9.0,11.0,13.0,15.0,1
515,CC:2F:71:3E:C5:1F,2150362,272807811,46,5608,2150316,272802203,0,216,18380,182,14170,34,4210,53,1,78,2,0,8,130000.0,39000.0,-70.0,-69.0,-67.0,-60.0,-70.0,-69.0,-66.0,-60.0,-76.0,-84.0,-77.0,-85.0,6.0,15.0,10.0,25.0,1
516,CC:2F:71:3F:1F:24,2240082,391447190,89766,118644987,2150316,272802203,3,61391,70608044,61338,70601244,53,6800,59311,138,89788,16576,3,55,144444.0,43333.0,-68.0,-65.0,-68.0,-68.0,-68.0,-64.0,-68.0,-67.0,-76.0,-84.0,-77.0,-85.0,8.0,19.0,9.0,17.0,1
517,F8:59:71:5A:E0:3D,2169207,301433069,18888,28630391,2150319,272802678,0,13302,18786863,13250,18777880,52,8983,13243,2,18899,901,0,11,144444.0,43333.0,-67.0,-74.0,-65.0,-70.0,-66.0,-73.0,-65.0,-69.0,-76.0,-84.0,-77.0,-85.0,9.0,10.0,12.0,15.0,1
518,CC:2F:71:3E:C5:1F,2150370,272808806,47,5724,2150323,272803082,0,218,18520,184,14310,34,4210,53,1,79,2,0,8,144444.0,39000.0,-70.0,-70.0,-66.0,-60.0,-70.0,-69.0,-66.0,-60.0,-76.0,-84.0,-77.0,-85.0,6.0,14.0,11.0,25.0,1
519,CC:2F:71:3F:1F:24,2240247,391654259,89924,118851177,2150323,272803082,3,61538,70811344,61485,70804544,53,6800,59454,138,89946,16582,3,55,144444.0,43333.0,-68.0,-64.0,-68.0,-68.0,-68.0,-64.0,-68.0,-67.0,-76.0,-84.0,-77.0,-85.0,8.0,20.0,9.0,17.0,1
520,F8:59:71:5A:E0:3D,2169395,301703460,19068,28900054,2150327,272803406,0,13382,18890476,13330,18881493,52,8983,13323,2,19079,901,0,11,144444.0,43333.0,-66.0,-73.0,-64.0,-70.0,-66.0,-73.0,-64.0,-69.0,-76.0,-84.0,-77.0,-85.0,10.0,11.0,13.0,15.0,1
521,CC:2F:71:3E:C5:1F,2150374,272809130,47,5724,2150327,272803406,0,220,18708,185,14380,35,4328,54,1,79,2,0,8,144444.0,39000.0,-70.0,-69.0,-66.0,-60.0,-70.0,-69.0,-66.0,-60.0,-76.0,-84.0,-77.0,-85.0,6.0,15.0,11.0,25.0,1
522,CC:2F:71:3F:1F:24,2240409,391860787,90082,119057381,2150327,272803406,3,61689,71019436,61636,71012636,53,6800,59597,138,90104,16616,3,55,144444.0,43333.0,-68.0,-64.0,-68.0,-67.0,-68.0,-64.0,-68.0,-67.0,-76.0,-84.0,-76.0,-85.0,8.0,20.0,8.0,18.0,1
523,F8:59:71:5A:E0:3D,2169462,301801932,19131,28997956,2150331,272803976,0,13445,18987496,13393,18978513,52,8983,13386,2,19142,902,0,11,144444.0,43333.0,-67.0,-74.0,-65.0,-70.0,-66.0,-73.0,-64.0,-69.0,-76.0,-84.0,-76.0,-85.0,9.0,10.0,11.0,15.0,1
524,CC:2F:71:3E:C5:1F,2150378,272809700,47,5724,2150331,272803976,0,220,18708,185,14380,35,4328,54,1,79,2,0,8,144444.0,39000.0,-70.0,-69.0,-66.0,-60.0,-70.0,-69.0,-66.0,-60.0,-76.0,-84.0,-76.0,-85.0,6.0,15.0,10.0,25.0,1
525,CC:2F:71:3F:1F:24,2240580,392071431,90249,119267455,2150331,272803976,3,61854,71235452,61801,71228652,53,6800,59751,138,90271,16631,3,55,144444.0,43333.0,-68.0,-64.0,-69.0,-67.0,-68.0,-64.0,-69.0,-67.0,-76.0,-84.0,-76.0,-85.0,8.0,20.0,7.0,18.0,1
526,F8:59:71:5A:E0:3D,2169530,301900354,19195,29095974,2150335,272804380,0,13509,19084622,13457,19075639,52,8983,13450,2,19206,902,0,11,144444.0,43333.0,-66.0,-73.0,-65.0,-70.0,-66.0,-73.0,-64.0,-70.0,-76.0,-84.0,-76.0,-85.0,10.0,11.0,11.0,15.0,1
527,CC:2F:71:3E:C5:1F,2150382,272810104,47,5724,2150335,272804380,0,220,18708,185,14380,35,4328,54,1,79,2,0,8,144444.0,39000.0,-70.0,-69.0,-66.0,-60.0,-70.0,-69.0,-66.0,-60.0,-76.0,-84.0,-76.0,-85.0,6.0,15.0,10.0,25.0,1
528,CC:2F:71:3F:1F:24,2240962,392532652,90625,119728070,2150337,272804582,3,62116,71460381,62063,71453581,53,6800,60006,138,90646,16698,3,55,144444.0,43333.0,-69.0,-65.0,-68.0,-67.0,-68.0,-64.0,-68.0,-67.0,-76.0,-84.0,-76.0,-85.0,7.0,19.0,8.0,18.0,1
529,F8:59:71:5A:E0:3D,2169598,301998720,19258,29193876,2150340,272804844,0,13572,19181642,13520,19172659,52,8983,13513,2,19269,902,0,11,144444.0,43333.0,-66.0,-73.0,-65.0,-70.0,-66.0,-73.0,-64.0,-70.0,-76.0,-84.0,-76.0,-85.0,10.0,11.0,11.0,15.0,1
530,CC:2F:71:3E:C5:1F,2150387,272810568,47,5724,2150340,272804844,0,220,18708,185,14380,35,4328,54,1,79,2,0,8,144444.0,39000.0,-70.0,-69.0,-66.0,-60.0,-70.0,-69.0,-66.0,-60.0,-76.0,-84.0,-76.0,-85.0,6.0,15.0,10.0,25.0,1
531,CC:2F:71:3F:1F:24,2241314,392985544,90974,120180700,2150340,272804844,3,62356,71682801,62303,71676001,53,6800,60237,138,90996,16728,3,55,144444.0,43333.0,-68.0,-65.0,-66.0,-67.0,-68.0,-64.0,-67.0,-67.0,-76.0,-84.0,-76.0,-85.0,8.0,19.0,10.0,18.0,1
532,F8:59:71:5A:E0:3D,2169666,302097088,19321,29291778,2150345,272805310,0,13635,19278662,13583,19269679,52,8983,13576,2,19332,902,0,11,144444.0,43333.0,-66.0,-73.0,-65.0,-70.0,-66.0,-73.0,-64.0,-69.0,-76.0,-84.0,-76.0,-85.0,10.0,11.0,11.0,15.0,1
533,CC:2F:71:3E:C5:1F,2150392,272811034,47,5724,2150345,272805310,0,220,18708,185,14380,35,4328,54,1,79,2,0,8,144444.0,39000.0,-70.0,-69.0,-66.0,-60.0,-70.0,-69.0,-66.0,-60.0,-76.0,-84.0,-76.0,-85.0,6.0,15.0,10.0,25.0,1
534,CC:2F:71:3F:1F:24,2241670,393437588,91325,120632278,2150345,272805310,3,62594,71897897,62540,71890979,54,6918,60471,138,91347,16739,3,55,144444.0,43333.0,-68.0,-64.0,-69.0,-69.0,-68.0,-64.0,-68.0,-68.0,-76.0,-84.0,-76.0,-85.0,8.0,20.0,7.0,16.0,1
535,F8:59:71:5A:E0:3D,2169733,302195394,19384,29389680,2150349,272805714,0,13698,19375682,13646,19366699,52,8983,13639,2,19395,902,0,11,144444.0,43333.0,-66.0,-73.0,-65.0,-69.0,-66.0,-72.0,-65.0,-69.0,-76.0,-84.0,-76.0,-85.0,10.0,11.0,11.0,16.0,1
536,CC:2F:71:3E:C5:1F,2150396,272811438,47,5724,2150349,272805714,0,220,18708,185,14380,35,4328,54,1,79,2,0,8,144444.0,39000.0,-70.0,-69.0,-66.0,-60.0,-70.0,-69.0,-66.0,-60.0,-76.0,-84.0,-76.0,-85.0,6.0,15.0,10.0,25.0,1
537,CC:2F:71:3F:1F:24,2242025,393889570,91676,121083856,2150349,272805714,3,62830,72112649,62776,72105731,54,6918,60704,138,91698,16744,3,55,144444.0,43333.0,-69.0,-64.0,-68.0,-67.0,-68.0,-64.0,-67.0,-67.0,-76.0,-84.0,-76.0,-85.0,7.0,20.0,8.0,18.0,1
538,F8:59:71:5A:E0:3D,2169834,302336105,19479,29529865,2150355,272806240,0,13772,19480518,13719,19471417,53,9101,13713,2,19490,903,0,11,144444.0,43333.0,-67.0,-73.0,-64.0,-70.0,-66.0,-73.0,-64.0,-70.0,-76.0,-84.0,-76.0,-85.0,9.0,11.0,12.0,15.0,1
539,CC:2F:71:3E:C5:1F,2150402,272811964,47,5724,2150355,272806240,0,220,18708,185,14380,35,4328,54,1,79,2,0,8,144444.0,39000.0,-70.0,-69.0,-66.0,-60.0,-70.0,-69.0,-66.0,-60.0,-76.0,-84.0,-76.0,-85.0,6.0,15.0,10.0,25.0,1
540,CC:2F:71:3F:1F:24,2242193,394096861,91838,121290621,2150355,272806240,3,62985,72317126,62931,72310208,54,6918,60849,138,91860,16751,3,55,144444.0,43333.0,-68.0,-63.0,-70.0,-68.0,-68.0,-63.0,-69.0,-68.0,-76.0,-84.0,-76.0,-85.0,8.0,21.0,6.0,17.0,1
541,F8:59:71:5A:E0:3D,2169900,302435763,19543,29629321,2150357,272806442,0,13835,19577538,13782,19568437,53,9101,13776,2,19554,903,0,11,144444.0,43333.0,-66.0,-73.0,-64.0,-70.0,-65.0,-73.0,-64.0,-69.0,-76.0,-84.0,-76.0,-85.0,10.0,11.0,12.0,15.0,1
542,CC:2F:71:3E:C5:1F,2150404,272812166,47,5724,2150357,272806442,0,220,18708,185,14380,35,4328,54,1,79,2,0,8,144444.0,39000.0,-70.0,-69.0,-66.0,-60.0,-70.0,-69.0,-66.0,-60.0,-76.0,-84.0,-76.0,-85.0,6.0,15.0,10.0,25.0,1
543,CC:2F:71:3F:1F:24,2242351,394300159,91994,121493717,2150357,272806442,3,63133,72523432,63079,72516514,54,6918,60990,138,92016,16756,3,55,144444.0,43333.0,-68.0,-63.0,-70.0,-68.0,-68.0,-63.0,-69.0,-68.0,-76.0,-84.0,-76.0,-85.0,8.0,21.0,6.0,17.0,1
544,F8:59:71:5A:E0:3D,2170077,302696762,19714,29889714,2150363,272807048,0,13916,19681858,13863,19672757,53,9101,13857,2,19725,905,0,11,144444.0,43333.0,-66.0,-73.0,-64.0,-70.0,-66.0,-73.0,-64.0,-69.0,-76.0,-84.0,-76.0,-85.0,10.0,11.0,12.0,15.0,1
545,CC:2F:71:3E:C5:1F,2150410,272812772,47,5724,2150363,272807048,0,220,18708,185,14380,35,4328,54,1,79,2,0,8,144444.0,39000.0,-70.0,-69.0,-66.0,-60.0,-70.0,-69.0,-66.0,-60.0,-76.0,-84.0,-76.0,-85.0,6.0,15.0,10.0,25.0,1
546,CC:2F:71:3F:1F:24,2242513,394506709,92150,121699661,2150363,272807048,3,63291,72743840,63237,72736922,54,6918,61132,138,92172,16761,3,55,144444.0,43333.0,-68.0,-63.0,-69.0,-69.0,-68.0,-63.0,-69.0,-68.0,-76.0,-84.0,-76.0,-85.0,8.0,21.0,7.0,16.0,1
547,F8:59:71:5A:E0:3D,2170143,302794926,19777,29987616,2150366,272807310,0,13978,19777338,13925,19768237,53,9101,13919,2,19787,906,0,11,144444.0,43333.0,-66.0,-73.0,-64.0,-69.0,-66.0,-73.0,-64.0,-69.0,-76.0,-84.0,-76.0,-85.0,10.0,11.0,12.0,16.0,1
548,CC:2F:71:3E:C5:1F,2150413,272813034,47,5724,2150366,272807310,0,220,18708,185,14380,35,4328,54,1,79,2,0,8,144444.0,39000.0,-70.0,-69.0,-66.0,-60.0,-70.0,-69.0,-66.0,-60.0,-76.0,-84.0,-76.0,-85.0,6.0,15.0,10.0,25.0,1
549,CC:2F:71:3F:1F:24,2242687,394713841,92321,121906531,2150366,272807310,3,63454,72955914,63400,72948996,54,6918,61288,138,92343,16767,3,55,144444.0,43333.0,-69.0,-63.0,-70.0,-68.0,-68.0,-63.0,-69.0,-68.0,-76.0,-84.0,-76.0,-85.0,7.0,21.0,6.0,17.0,1
550,F8:59:71:5A:E0:3D,2170214,302892465,19844,30084751,2150370,272807714,0,14043,19874193,13990,19865092,53,9101,13984,2,19855,906,0,11,144444.0,43333.0,-66.0,-73.0,-65.0,-70.0,-66.0,-73.0,-64.0,-70.0,-76.0,-84.0,-76.0,-85.0,10.0,11.0,11.0,15.0,1
551,CC:2F:71:3E:C5:1F,2150417,272813438,47,5724,2150370,272807714,0,220,18708,185,14380,35,4328,54,1,79,2,0,8,144444.0,39000.0,-70.0,-69.0,-66.0,-60.0,-70.0,-69.0,-66.0,-60.0,-76.0,-84.0,-76.0,-85.0,6.0,15.0,10.0,25.0,1
552,CC:2F:71:3F:1F:24,2242854,394920812,92484,122113098,2150370,272807714,3,63609,73159223,63555,73152305,54,6918,61438,138,92506,16807,3,55,144444.0,43333.0,-69.0,-63.0,-69.0,-68.0,-68.0,-63.0,-68.0,-68.0,-76.0,-84.0,-76.0,-85.0,7.0,21.0,7.0,17.0,1
553,F8:59:71:5A:E0:3D,2170280,302989217,19906,30181099,2150374,272808118,0,14106,19971213,14053,19962112,53,9101,14047,2,19917,906,0,11,144444.0,43333.0,-66.0,-73.0,-65.0,-70.0,-65.0,-72.0,-64.0,-69.0,-76.0,-84.0,-76.0,-85.0,10.0,11.0,11.0,15.0,1
554,CC:2F:71:3E:C5:1F,2150421,272813842,47,5724,2150374,272808118,0,220,18708,185,14380,35,4328,54,1,79,2,0,8,144444.0,39000.0,-70.0,-69.0,-66.0,-60.0,-70.0,-69.0,-66.0,-60.0,-76.0,-84.0,-76.0,-85.0,6.0,15.0,10.0,25.0,1
555,CC:2F:71:3F:1F:24,2243014,395124256,92640,122316138,2150374,272808118,3,63757,73362777,63703,73355859,54,6918,61579,138,92662,16826,3,55,130000.0,43333.0,-68.0,-64.0,-67.0,-68.0,-67.0,-64.0,-68.0,-68.0,-76.0,-84.0,-76.0,-85.0,8.0,20.0,9.0,17.0,1
556,F8:59:71:5A:E0:3D,2170345,303085827,19968,30277447,2150377,272808380,0,14168,20066693,14115,20057592,53,9101,14109,2,19979,906,0,11,144444.0,43333.0,-67.0,-73.0,-63.0,-69.0,-65.0,-72.0,-63.0,-69.0,-76.0,-84.0,-76.0,-85.0,9.0,11.0,13.0,16.0,1
557,CC:2F:71:3E:C5:1F,2150424,272814104,47,5724,2150377,272808380,0,220,18708,185,14380,35,4328,54,1,79,2,0,8,144444.0,39000.0,-70.0,-69.0,-66.0,-60.0,-70.0,-69.0,-66.0,-60.0,-76.0,-84.0,-76.0,-85.0,6.0,15.0,10.0,25.0,1
558,CC:2F:71:3F:1F:24,2243171,395327354,92794,122518974,2150377,272808380,3,63907,73570753,63853,73563835,54,6918,61721,138,92816,16828,3,55,130000.0,43333.0,-69.0,-64.0,-66.0,-68.0,-67.0,-63.0,-66.0,-67.0,-76.0,-84.0,-76.0,-85.0,7.0,20.0,10.0,17.0,1
559,F8:59:71:5A:E0:3D,2170430,303189428,20049,30380644,2150381,272808784,0,14252,20167587,14199,20158486,53,9101,14193,2,20060,907,0,11,144444.0,43333.0,-65.0,-72.0,-65.0,-69.0,-65.0,-72.0,-64.0,-69.0,-76.0,-84.0,-76.0,-85.0,11.0,12.0,11.0,16.0,1
560,CC:2F:71:3E:C5:1F,2150430,272814710,47,5724,2150383,272808986,0,220,18708,185,14380,35,4328,54,1,79,2,0,8,144444.0,39000.0,-70.0,-69.0,-66.0,-60.0,-70.0,-69.0,-66.0,-60.0,-76.0,-84.0,-76.0,-85.0,6.0,15.0,10.0,25.0,1
561,CC:2F:71:3F:1F:24,2243334,395533866,92951,122724880,2150383,272808986,3,64058,73772013,64004,73765095,54,6918,61864,138,92973,16890,3,55,104000.0,26000.0,-67.0,-63.0,-68.0,-69.0,-67.0,-63.0,-67.0,-69.0,-76.0,-84.0,-76.0,-85.0,9.0,21.0,8.0,16.0,1
562,F8:59:71:5A:E0:3D,2170865,303860338,20479,31050877,2150386,272809461,0,14360,20277915,14307,20268814,53,9101,14301,2,20490,965,0,11,144444.0,43333.0,-65.0,-72.0,-65.0,-70.0,-65.0,-72.0,-64.0,-69.0,-76.0,-84.0,-76.0,-85.0,11.0,12.0,11.0,15.0,1
563,CC:2F:71:3E:C5:1F,2150433,272815185,47,5724,2150386,272809461,0,220,18708,185,14380,35,4328,54,1,79,2,0,8,144444.0,39000.0,-70.0,-69.0,-66.0,-60.0,-70.0,-69.0,-66.0,-60.0,-76.0,-84.0,-76.0,-85.0,6.0,15.0,10.0,25.0,1
564,CC:2F:71:3F:1F:24,2243503,395744096,93117,122934635,2150386,272809461,3,64217,73978750,64163,73971832,54,6918,62017,138,93139,16890,3,55,115556.0,28889.0,-68.0,-64.0,-66.0,-67.0,-66.0,-64.0,-67.0,-67.0,-76.0,-84.0,-76.0,-85.0,8.0,20.0,10.0,18.0,1
565,F8:59:71:5A:E0:3D,2170941,303964153,20550,31154228,2150391,272809925,0,14429,20380928,14376,20371827,53,9101,14370,2,20561,965,0,12,144444.0,43333.0,-65.0,-73.0,-65.0,-69.0,-65.0,-72.0,-64.0,-69.0,-75.0,-84.0,-76.0,-84.0,10.0,11.0,11.0,15.0,1
566,CC:2F:71:3E:C5:1F,2150438,272815649,47,5724,2150391,272809925,0,220,18708,185,14380,35,4328,54,1,79,2,0,8,144444.0,39000.0,-70.0,-69.0,-66.0,-60.0,-70.0,-69.0,-66.0,-60.0,-75.0,-84.0,-76.0,-84.0,5.0,15.0,10.0,24.0,1
567,CC:2F:71:3F:1F:24,2243710,395968504,93317,123158377,2150393,272810127,3,64410,74212613,64356,74205695,54,6918,62198,138,93339,16901,3,55,130000.0,43333.0,-68.0,-64.0,-68.0,-68.0,-67.0,-64.0,-67.0,-68.0,-75.0,-84.0,-76.0,-84.0,7.0,20.0,8.0,16.0,1
568,F8:59:71:5A:E0:3D,2171008,304062459,20613,31252130,2150395,272810329,0,14492,20477948,14439,20468847,53,9101,14433,2,20624,967,0,12,144444.0,43333.0,-65.0,-72.0,-65.0,-70.0,-65.0,-72.0,-64.0,-69.0,-75.0,-84.0,-76.0,-84.0,10.0,12.0,11.0,14.0,1
569,CC:2F:71:3E:C5:1F,2150442,272816053,47,5724,2150395,272810329,0,220,18708,185,14380,35,4328,54,1,79,2,0,8,144444.0,39000.0,-70.0,-69.0,-66.0,-60.0,-70.0,-69.0,-66.0,-60.0,-75.0,-84.0,-76.0,-84.0,5.0,15.0,10.0,24.0,1
570,CC:2F:71:3F:1F:24,2244152,396482055,93757,123671726,2150395,272810329,3,64706,74463091,64652,74456173,54,6918,62489,138,93779,16905,3,55,130000.0,43333.0,-67.0,-64.0,-67.0,-68.0,-67.0,-64.0,-67.0,-67.0,-75.0,-84.0,-76.0,-84.0,8.0,20.0,9.0,16.0,1
571,F8:59:71:5A:E0:3D,2171076,304162319,20677,31351586,2150399,272810733,0,14556,20576508,14503,20567407,53,9101,14497,2,20688,967,0,12,144444.0,43333.0,-67.0,-73.0,-65.0,-70.0,-65.0,-72.0,-64.0,-69.0,-75.0,-84.0,-76.0,-84.0,8.0,11.0,11.0,14.0,1
572,CC:2F:71:3E:C5:1F,2150446,272816457,47,5724,2150399,272810733,0,220,18708,185,14380,35,4328,54,1,79,2,0,8,144444.0,39000.0,-70.0,-69.0,-66.0,-60.0,-70.0,-69.0,-66.0,-60.0,-75.0,-84.0,-76.0,-84.0,5.0,15.0,10.0,24.0,1
573,CC:2F:71:3F:1F:24,2245274,397930552,94875,125119819,2150399,272810733,3,65103,74721189,65049,74714271,54,6918,62876,138,94897,16911,3,55,130000.0,43333.0,-67.0,-64.0,-68.0,-68.0,-67.0,-64.0,-67.0,-67.0,-75.0,-84.0,-76.0,-84.0,8.0,20.0,8.0,16.0,1
574,F8:59:71:5A:E0:3D,2171141,304258929,20739,31447934,2150402,272810995,0,14617,20670448,14564,20661347,53,9101,14558,2,20750,968,0,12,144444.0,43333.0,-65.0,-72.0,-64.0,-69.0,-65.0,-72.0,-64.0,-69.0,-75.0,-83.0,-75.0,-84.0,10.0,11.0,11.0,15.0,1
575,CC:2F:71:3E:C5:1F,2150449,272816719,47,5724,2150402,272810995,0,220,18708,185,14380,35,4328,54,1,79,2,0,8,144444.0,39000.0,-70.0,-69.0,-66.0,-60.0,-70.0,-69.0,-66.0,-60.0,-75.0,-83.0,-75.0,-84.0,5.0,14.0,9.0,24.0,1
576,CC:2F:71:3F:1F:24,2245667,398390409,95264,125579280,2150403,272811129,3,65369,74945503,65315,74938585,54,6918,63141,138,95284,16920,3,55,130000.0,43333.0,-67.0,-64.0,-68.0,-67.0,-67.0,-64.0,-66.0,-67.0,-75.0,-83.0,-75.0,-84.0,8.0,19.0,7.0,17.0,1
577,F8:59:71:5A:E0:3D,2171206,304354071,20800,31542672,2150406,272811399,0,14679,20765928,14626,20756827,53,9101,14620,2,20811,968,0,12,130000.0,39000.0,-65.0,-72.0,-65.0,-69.0,-65.0,-72.0,-65.0,-69.0,-75.0,-83.0,-75.0,-84.0,10.0,11.0,10.0,15.0,1
578,CC:2F:71:3E:C5:1F,2150455,272817325,47,5724,2150408,272811601,0,220,18708,185,14380,35,4328,54,1,79,2,0,8,144444.0,39000.0,-70.0,-69.0,-66.0,-60.0,-70.0,-69.0,-66.0,-60.0,-75.0,-83.0,-75.0,-84.0,5.0,14.0,9.0,24.0,1
579,CC:2F:71:3F:1F:24,2246027,398841263,95619,126029662,2150408,272811601,3,65608,75161611,65554,75154693,54,6918,63372,138,95641,16923,3,55,130000.0,43333.0,-67.0,-64.0,-68.0,-68.0,-66.0,-64.0,-66.0,-67.0,-75.0,-83.0,-75.0,-84.0,8.0,19.0,7.0,16.0,1
580,F8:59:71:5A:E0:3D,2171274,304452381,20864,31640578,2150410,272811803,0,14742,20861514,14689,20852413,53,9101,14683,2,20875,968,0,12,144444.0,43333.0,-65.0,-72.0,-65.0,-70.0,-65.0,-72.0,-65.0,-69.0,-75.0,-83.0,-75.0,-84.0,10.0,11.0,10.0,14.0,1
581,CC:2F:71:3E:C5:1F,2150458,272817587,47,5724,2150411,272811863,0,220,18708,185,14380,35,4328,54,1,79,2,0,8,144444.0,39000.0,-70.0,-69.0,-66.0,-60.0,-70.0,-69.0,-66.0,-60.0,-75.0,-83.0,-75.0,-84.0,5.0,14.0,9.0,24.0,1
582,CC:2F:71:3F:1F:24,2246444,399340505,96033,126528642,2150411,272811863,3,65879,75382910,65825,75375992,54,6918,63640,138,96055,16926,3,55,130000.0,43333.0,-68.0,-65.0,-68.0,-68.0,-68.0,-64.0,-68.0,-67.0,-75.0,-83.0,-75.0,-84.0,7.0,18.0,7.0,16.0,1
583,F8:59:71:5A:E0:3D,2171348,304551666,20933,31739399,2150415,272812267,0,14810,20961706,14757,20952605,53,9101,14751,2,20944,968,0,12,144444.0,43333.0,-66.0,-72.0,-65.0,-69.0,-65.0,-72.0,-65.0,-69.0,-75.0,-83.0,-75.0,-84.0,9.0,11.0,10.0,15.0,1
584,CC:2F:71:3E:C5:1F,2150462,272817991,47,5724,2150415,272812267,0,220,18708,185,14380,35,4328,54,1,79,2,0,8,144444.0,39000.0,-70.0,-69.0,-66.0,-60.0,-70.0,-69.0,-66.0,-60.0,-75.0,-83.0,-75.0,-84.0,5.0,14.0,9.0,24.0,1
585,CC:2F:71:3F:1F:24,2246764,399752682,96349,126940415,2150415,272812267,3,66100,75597761,66046,75590843,54,6918,63853,138,96371,16936,3,55,130000.0,43333.0,-64.0,-64.0,-64.0,-68.0,-66.0,-64.0,-66.0,-67.0,-75.0,-83.0,-75.0,-84.0,11.0,19.0,11.0,16.0,1
586,F8:59:71:5A:E0:3D,2171557,304862351,21138,32049680,2150419,272812671,0,14895,21069668,14842,21060567,53,9101,14836,2,21148,970,0,12,144444.0,43333.0,-65.0,-72.0,-65.0,-70.0,-65.0,-72.0,-65.0,-69.0,-75.0,-83.0,-75.0,-84.0,10.0,11.0,10.0,14.0,1
587,CC:2F:71:3E:C5:1F,2150467,272818521,47,5724,2150420,272812797,0,220,18708,185,14380,35,4328,54,1,79,2,0,8,144444.0,39000.0,-70.0,-69.0,-66.0,-60.0,-70.0,-69.0,-66.0,-60.0,-75.0,-83.0,-75.0,-84.0,5.0,14.0,9.0,24.0,1
588,CC:2F:71:3F:1F:24,2246924,399956178,96504,127143381,2150420,272812797,3,66254,75810611,66200,75803693,54,6918,63996,138,96526,16936,3,55,130000.0,43333.0,-68.0,-64.0,-69.0,-67.0,-67.0,-64.0,-67.0,-67.0,-75.0,-83.0,-75.0,-84.0,7.0,19.0,6.0,17.0,1
589,F8:59:71:5A:E0:3D,2171628,304962653,21205,32149594,2150423,272813059,0,14962,21169046,14909,21159945,53,9101,14903,2,21215,970,0,12,144444.0,43333.0,-66.0,-72.0,-65.0,-69.0,-65.0,-72.0,-64.0,-69.0,-75.0,-83.0,-75.0,-84.0,9.0,11.0,10.0,15.0,1
590,CC:2F:71:3E:C5:1F,2150470,272818783,47,5724,2150423,272813059,0,220,18708,185,14380,35,4328,54,1,79,2,0,8,144444.0,39000.0,-70.0,-69.0,-66.0,-60.0,-70.0,-69.0,-66.0,-60.0,-75.0,-83.0,-75.0,-84.0,5.0,14.0,9.0,24.0,1
591,CC:2F:71:3F:1F:24,2247099,400164868,96676,127351809,2150423,272813059,3,66419,76030754,66365,76023836,54,6918,64149,138,96698,16936,3,55,130000.0,43333.0,-68.0,-64.0,-68.0,-68.0,-67.0,-64.0,-67.0,-67.0,-75.0,-83.0,-75.0,-84.0,7.0,19.0,7.0,16.0,1
592,F8:59:71:5A:E0:3D,2171698,305059906,21269,32246241,2150429,272813665,0,15027,21266337,14974,21257236,53,9101,14968,2,21280,970,0,12,144444.0,43333.0,-66.0,-73.0,-65.0,-69.0,-65.0,-72.0,-65.0,-69.0,-75.0,-84.0,-75.0,-84.0,9.0,11.0,10.0,15.0,1
593,CC:2F:71:3E:C5:1F,2150476,272819389,47,5724,2150429,272813665,0,220,18708,185,14380,35,4328,54,1,79,2,0,8,144444.0,39000.0,-70.0,-69.0,-66.0,-60.0,-70.0,-69.0,-66.0,-60.0,-75.0,-84.0,-75.0,-84.0,5.0,15.0,9.0,24.0,1
594,CC:2F:71:3F:1F:24,2247263,400372878,96834,127559213,2150429,272813665,3,66569,76238844,66515,76231926,54,6918,64292,138,96856,16940,3,55,130000.0,43333.0,-68.0,-65.0,-67.0,-69.0,-66.0,-64.0,-66.0,-68.0,-75.0,-84.0,-75.0,-84.0,7.0,19.0,8.0,15.0,1
595,F8:59:71:5A:E0:3D,2171763,305158010,21332,32344143,2150431,272813867,0,15090,21363357,15037,21354256,53,9101,15031,2,21343,972,0,12,144444.0,43333.0,-66.0,-73.0,-64.0,-69.0,-65.0,-72.0,-64.0,-69.0,-75.0,-83.0,-75.0,-84.0,9.0,10.0,11.0,15.0,1
596,CC:2F:71:3E:C5:1F,2150478,272819591,47,5724,2150431,272813867,0,222,18848,187,14520,35,4328,54,1,80,2,0,8,144444.0,39000.0,-69.0,-70.0,-66.0,-60.0,-70.0,-69.0,-66.0,-60.0,-75.0,-83.0,-75.0,-84.0,6.0,13.0,9.0,24.0,1
597,CC:2F:71:3F:1F:24,2247865,401182296,97434,128368429,2150431,272813867,3,66795,76464024,66741,76457106,54,6918,64509,138,97456,16975,3,55,130000.0,43333.0,-68.0,-64.0,-68.0,-67.0,-67.0,-64.0,-67.0,-67.0,-75.0,-83.0,-75.0,-84.0,7.0,19.0,7.0,17.0,1
598,F8:59:71:5A:E0:3D,2171831,305256376,21395,32442045,2150436,272814331,0,15153,21460377,15100,21451276,53,9101,15094,2,21406,972,0,12,144444.0,43333.0,-66.0,-73.0,-64.0,-69.0,-65.0,-72.0,-64.0,-69.0,-75.0,-83.0,-75.0,-84.0,9.0,10.0,11.0,15.0,1
599,CC:2F:71:3E:C5:1F,2150485,272820257,47,5724,2150438,272814533,0,222,18848,187,14520,35,4328,54,1,80,2,0,8,144444.0,39000.0,-69.0,-70.0,-66.0,-60.0,-70.0,-69.0,-66.0,-60.0,-75.0,-83.0,-75.0,-84.0,6.0,13.0,9.0,24.0,1
600,CC:2F:71:3F:1F:24,2248030,401389054,97592,128574521,2150438,272814533,3,66947,76676546,66893,76669628,54,6918,64650,138,97614,16984,3,55,117000.0,39000.0,-68.0,-64.0,-69.0,-67.0,-67.0,-64.0,-67.0,-67.0,-75.0,-83.0,-75.0,-84.0,7.0,19.0,6.0,17.0,1
601,F8:59:71:5A:E0:3D,2171896,305354480,21458,32539947,2150438,272814533,0,15216,21557397,15163,21548296,53,9101,15157,2,21469,972,0,12,144444.0,43333.0,-65.0,-72.0,-65.0,-70.0,-65.0,-72.0,-65.0,-69.0,-75.0,-83.0,-75.0,-84.0,10.0,11.0,10.0,14.0,1
602,CC:2F:71:3E:C5:1F,2150485,272820257,47,5724,2150438,272814533,0,222,18848,187,14520,35,4328,54,1,80,2,0,8,144444.0,39000.0,-69.0,-70.0,-66.0,-60.0,-70.0,-69.0,-66.0,-60.0,-75.0,-83.0,-75.0,-84.0,6.0,13.0,9.0,24.0,1
603,CC:2F:71:3F:1F:24,2248203,401597504,97765,128782971,2150438,272814533,3,67117,76891133,67063,76884215,54,6918,64808,138,97786,16984,3,55,130000.0,43333.0,-67.0,-65.0,-68.0,-68.0,-67.0,-64.0,-67.0,-67.0,-75.0,-83.0,-75.0,-84.0,8.0,18.0,7.0,16.0,1
604,F8:59:71:5A:E0:3D,2172164,305758303,21719,32942891,2150445,272815412,0,15303,21659599,15250,21650498,53,9101,15244,2,21730,1014,0,13,144444.0,43333.0,-66.0,-73.0,-64.0,-69.0,-65.0,-72.0,-65.0,-68.0,-75.0,-83.0,-75.0,-84.0,9.0,10.0,11.0,15.0,1
605,CC:2F:71:3E:C5:1F,2150493,272821196,48,5784,2150445,272815412,0,224,18988,189,14660,35,4328,54,1,81,2,0,8,144444.0,39000.0,-69.0,-70.0,-66.0,-60.0,-69.0,-69.0,-66.0,-60.0,-75.0,-83.0,-75.0,-84.0,6.0,13.0,9.0,24.0,1
606,CC:2F:71:3F:1F:24,2248369,401806127,97924,128990715,2150445,272815412,3,67271,77102483,67217,77095565,54,6918,64953,138,97946,16984,3,55,130000.0,43333.0,-67.0,-64.0,-68.0,-68.0,-67.0,-64.0,-67.0,-68.0,-75.0,-83.0,-75.0,-84.0,8.0,19.0,7.0,16.0,1
607,F8:59:71:5A:E0:3D,2172354,306046339,21905,33230603,2150449,272815736,0,15380,21762915,15327,21753814,53,9101,15321,2,21916,1014,0,13,144444.0,43333.0,-65.0,-72.0,-66.0,-70.0,-65.0,-72.0,-64.0,-69.0,-75.0,-83.0,-75.0,-84.0,10.0,11.0,9.0,14.0,1
608,CC:2F:71:3E:C5:1F,2150497,272821520,48,5784,2150449,272815736,0,224,18988,189,14660,35,4328,54,1,81,2,0,8,144444.0,39000.0,-69.0,-70.0,-66.0,-60.0,-69.0,-69.0,-66.0,-60.0,-75.0,-83.0,-75.0,-84.0,6.0,13.0,9.0,24.0,1
609,CC:2F:71:3F:1F:24,2248531,402012207,98082,129196471,2150449,272815736,3,67423,77307973,67368,77300937,55,7036,65097,138,98104,17011,3,55,130000.0,43333.0,-67.0,-64.0,-68.0,-70.0,-67.0,-64.0,-67.0,-69.0,-75.0,-83.0,-75.0,-84.0,8.0,19.0,7.0,14.0,1
610,F8:59:71:5A:E0:3D,2172420,306143091,21967,33326951,2150453,272816140,0,15442,21858395,15389,21849294,53,9101,15383,2,21978,1015,0,13,144444.0,43333.0,-66.0,-72.0,-65.0,-69.0,-65.0,-72.0,-64.0,-69.0,-75.0,-83.0,-75.0,-84.0,9.0,11.0,10.0,15.0,1
611,CC:2F:71:3E:C5:1F,2150503,272822126,48,5784,2150455,272816342,0,224,18988,189,14660,35,4328,54,1,81,2,0,8,144444.0,39000.0,-69.0,-70.0,-66.0,-60.0,-69.0,-69.0,-66.0,-60.0,-75.0,-83.0,-75.0,-84.0,6.0,13.0,9.0,24.0,1
612,CC:2F:71:3F:1F:24,2248938,402547738,98483,129731396,2150455,272816342,3,67612,77522058,67557,77515022,55,7036,65280,138,98505,17012,3,55,130000.0,43333.0,-65.0,-64.0,-68.0,-69.0,-67.0,-64.0,-67.0,-69.0,-75.0,-83.0,-75.0,-84.0,10.0,19.0,7.0,15.0,1
613,F8:59:71:5A:E0:3D,2172513,306258461,22034,33431069,2150479,272827392,0,15509,21961575,15456,21952474,53,9101,15450,2,22045,1016,0,13,144444.0,43333.0,-67.0,-73.0,-64.0,-70.0,-65.0,-72.0,-64.0,-69.0,-75.0,-83.0,-75.0,-84.0,8.0,10.0,11.0,14.0,1
614,CC:2F:71:3E:C5:1F,2150527,272833176,48,5784,2150479,272827392,0,224,18988,189,14660,35,4328,54,1,81,2,0,8,144444.0,39000.0,-69.0,-70.0,-66.0,-60.0,-69.0,-69.0,-66.0,-60.0,-75.0,-83.0,-75.0,-84.0,6.0,13.0,9.0,24.0,1
615,CC:2F:71:3F:1F:24,2249148,402779143,98669,129951751,2150479,272827392,3,67783,77745425,67728,77738389,55,7036,65447,138,98691,17014,3,55,130000.0,43333.0,-67.0,-64.0,-66.0,-70.0,-67.0,-64.0,-67.0,-69.0,-75.0,-83.0,-75.0,-84.0,8.0,19.0,9.0,14.0,1
616,F8:59:71:5A:E0:3D,2172578,306355071,22096,33527417,2150482,272827654,0,15571,22057055,15518,22047954,53,9101,15512,2,22107,1016,0,13,144444.0,43333.0,-66.0,-72.0,-64.0,-70.0,-65.0,-72.0,-64.0,-69.0,-75.0,-83.0,-75.0,-84.0,9.0,11.0,11.0,14.0,1
617,CC:2F:71:3E:C5:1F,2150530,272833438,48,5784,2150482,272827654,0,224,18988,189,14660,35,4328,54,1,81,2,0,8,144444.0,39000.0,-69.0,-70.0,-66.0,-60.0,-69.0,-69.0,-66.0,-60.0,-75.0,-83.0,-75.0,-84.0,6.0,13.0,9.0,24.0,1
618,CC:2F:71:3F:1F:24,2249309,402982479,98825,130154623,2150484,272827856,3,67931,77947669,67876,77940633,55,7036,65589,138,98847,17021,3,55,130000.0,43333.0,-68.0,-64.0,-68.0,-70.0,-67.0,-64.0,-67.0,-69.0,-75.0,-83.0,-75.0,-84.0,7.0,19.0,7.0,14.0,1
619,F8:59:71:5A:E0:3D,2172647,306453579,22159,33625319,2150488,272828260,0,15634,22154075,15581,22144974,53,9101,15575,2,22170,1016,0,13,144444.0,43333.0,-65.0,-72.0,-65.0,-69.0,-65.0,-72.0,-64.0,-69.0,-75.0,-83.0,-75.0,-84.0,10.0,11.0,10.0,15.0,1
620,CC:2F:71:3E:C5:1F,2150536,272834044,48,5784,2150488,272828260,0,224,18988,189,14660,35,4328,54,1,81,2,0,8,144444.0,39000.0,-69.0,-70.0,-66.0,-60.0,-69.0,-69.0,-66.0,-60.0,-75.0,-83.0,-75.0,-84.0,6.0,13.0,9.0,24.0,1
621,CC:2F:71:3F:1F:24,2249472,403192065,98984,130363805,2150488,272828260,3,68083,78158725,68028,78151689,55,7036,65733,138,99006,17022,3,55,130000.0,43333.0,-68.0,-64.0,-68.0,-70.0,-67.0,-64.0,-66.0,-69.0,-75.0,-83.0,-75.0,-84.0,7.0,19.0,7.0,14.0,1
622,F8:59:71:5A:E0:3D,2172712,306551683,22222,33723221,2150490,272828462,0,15697,22251095,15644,22241994,53,9101,15638,2,22233,1016,0,13,144444.0,43333.0,-66.0,-72.0,-65.0,-70.0,-65.0,-72.0,-64.0,-69.0,-75.0,-83.0,-75.0,-84.0,9.0,11.0,10.0,14.0,1
623,CC:2F:71:3E:C5:1F,2150538,272834246,48,5784,2150490,272828462,0,224,18988,189,14660,35,4328,54,1,81,2,0,8,144444.0,39000.0,-69.0,-70.0,-66.0,-60.0,-69.0,-69.0,-66.0,-60.0,-75.0,-83.0,-75.0,-84.0,6.0,13.0,9.0,24.0,1
624,CC:2F:71:3F:1F:24,2249637,403398834,99147,130570372,2150490,272828462,3,68238,78360733,68183,78353697,55,7036,65883,138,99169,17027,3,55,130000.0,43333.0,-67.0,-64.0,-67.0,-70.0,-67.0,-64.0,-67.0,-69.0,-75.0,-83.0,-75.0,-84.0,8.0,19.0,8.0,14.0,1
625,F8:59:71:5A:E0:3D,2172781,306648697,22284,33819569,2150497,272829128,0,15759,22346575,15706,22337474,53,9101,15700,2,22295,1017,0,13,144444.0,43333.0,-66.0,-72.0,-64.0,-70.0,-65.0,-72.0,-64.0,-69.0,-75.0,-83.0,-75.0,-84.0,9.0,11.0,11.0,14.0,1
626,CC:2F:71:3E:C5:1F,2150545,272834912,48,5784,2150497,272829128,0,224,18988,189,14660,35,4328,54,1,81,2,0,8,144444.0,39000.0,-69.0,-70.0,-66.0,-60.0,-69.0,-69.0,-66.0,-60.0,-75.0,-83.0,-75.0,-84.0,6.0,13.0,9.0,24.0,1
627,CC:2F:71:3F:1F:24,2249799,403602242,99302,130773114,2150497,272829128,3,68389,78564525,68334,78557489,55,7036,66028,138,99324,17041,3,55,130000.0,43333.0,-68.0,-64.0,-68.0,-70.0,-67.0,-64.0,-66.0,-69.0,-75.0,-83.0,-75.0,-84.0,7.0,19.0,7.0,14.0,1
628,F8:59:71:5A:E0:3D,2172974,306929245,22475,34099915,2150499,272829330,0,15848,22459743,15795,22450642,53,9101,15789,2,22486,1018,0,13,144444.0,43333.0,-65.0,-72.0,-65.0,-69.0,-65.0,-72.0,-64.0,-69.0,-75.0,-83.0,-75.0,-84.0,10.0,11.0,10.0,15.0,1
629,CC:2F:71:3E:C5:1F,2150547,272835114,48,5784,2150499,272829330,0,224,18988,189,14660,35,4328,54,1,81,2,0,8,144444.0,39000.0,-69.0,-70.0,-66.0,-60.0,-69.0,-69.0,-66.0,-60.0,-75.0,-83.0,-75.0,-84.0,6.0,13.0,9.0,24.0,1
630,CC:2F:71:3F:1F:24,2249958,403807094,99459,130977764,2150499,272829330,3,68540,78772631,68485,78765595,55,7036,66170,138,99481,17043,3,55,130000.0,43333.0,-68.0,-64.0,-67.0,-70.0,-67.0,-63.0,-67.0,-69.0,-75.0,-83.0,-75.0,-84.0,7.0,19.0,8.0,14.0,1
631,F8:59:71:5A:E0:3D,2173042,307026199,22537,34196263,2150505,272829936,0,15910,22555223,15857,22546122,53,9101,15851,2,22548,1019,0,13,144444.0,43333.0,-65.0,-71.0,-65.0,-70.0,-65.0,-72.0,-64.0,-69.0,-75.0,-83.0,-75.0,-84.0,10.0,12.0,10.0,14.0,1
632,CC:2F:71:3E:C5:1F,2150553,272835720,48,5784,2150505,272829936,0,224,18988,189,14660,35,4328,54,1,81,2,0,8,144444.0,39000.0,-69.0,-70.0,-66.0,-60.0,-69.0,-69.0,-66.0,-60.0,-75.0,-83.0,-75.0,-84.0,6.0,13.0,9.0,24.0,1
633,CC:2F:71:3F:1F:24,2250135,404016002,99630,131186066,2150505,272829936,3,68695,78977361,68640,78970325,55,7036,66320,138,99652,17054,3,55,130000.0,43333.0,-68.0,-64.0,-69.0,-69.0,-67.0,-64.0,-66.0,-69.0,-75.0,-83.0,-75.0,-84.0,7.0,19.0,6.0,15.0,1
634,F8:59:71:5A:E0:3D,2173105,307122607,22599,34292611,2150506,272829996,0,15972,22650703,15919,22641602,53,9101,15913,2,22610,1019,0,13,144444.0,43333.0,-66.0,-72.0,-66.0,-69.0,-66.0,-72.0,-64.0,-69.0,-75.0,-83.0,-75.0,-84.0,9.0,11.0,9.0,15.0,1
635,CC:2F:71:3E:C5:1F,2150554,272835780,48,5784,2150506,272829996,0,224,18988,189,14660,35,4328,54,1,81,2,0,8,144444.0,39000.0,-69.0,-70.0,-66.0,-60.0,-69.0,-69.0,-66.0,-60.0,-75.0,-83.0,-75.0,-84.0,6.0,13.0,9.0,24.0,1
636,CC:2F:71:3F:1F:24,2250894,405054411,100386,132224213,2150508,272830198,3,68921,79195465,68866,79188429,55,7036,66541,138,100408,17083,3,55,130000.0,43333.0,-67.0,-64.0,-63.0,-70.0,-66.0,-64.0,-67.0,-69.0,-75.0,-83.0,-75.0,-84.0,8.0,19.0,12.0,14.0,1
637,F8:59:71:5A:E0:3D,2173174,307221115,22662,34390513,2150512,272830602,0,16034,22746183,15981,22737082,53,9101,15975,2,22673,1019,0,13,144444.0,43333.0,-66.0,-72.0,-63.0,-69.0,-65.0,-72.0,-64.0,-69.0,-75.0,-83.0,-75.0,-84.0,9.0,11.0,12.0,15.0,1
638,CC:2F:71:3E:C5:1F,2150562,272836588,48,5784,2150514,272830804,0,224,18988,189,14660,35,4328,54,1,81,2,0,8,144444.0,39000.0,-69.0,-70.0,-66.0,-60.0,-69.0,-69.0,-66.0,-60.0,-75.0,-83.0,-74.0,-84.0,6.0,13.0,8.0,24.0,1
639,CC:2F:71:3F:1F:24,2251061,405264279,100546,132433413,2150515,272830866,3,69071,79401961,69016,79394925,55,7036,66687,138,100568,17089,3,55,117000.0,39000.0,-68.0,-64.0,-67.0,-69.0,-66.0,-64.0,-67.0,-69.0,-75.0,-83.0,-74.0,-84.0,7.0,19.0,7.0,15.0,1
640,F8:59:71:5A:E0:3D,2173240,307319281,22725,34488415,2150515,272830866,0,16099,22844861,16045,22835642,54,9219,16040,2,22736,1019,0,13,144444.0,43333.0,-65.0,-71.0,-65.0,-69.0,-65.0,-72.0,-64.0,-69.0,-75.0,-83.0,-74.0,-84.0,10.0,12.0,9.0,15.0,1
641,CC:2F:71:3E:C5:1F,2150567,272837363,52,6497,2150515,272830866,0,230,19803,195,15475,35,4328,59,1,85,2,0,11,144444.0,39000.0,-70.0,-70.0,-66.0,-60.0,-69.0,-69.0,-66.0,-60.0,-75.0,-83.0,-74.0,-84.0,5.0,13.0,8.0,24.0,1
642,CC:2F:71:3F:1F:24,2251216,405466909,100701,132636043,2150515,272830866,3,69213,79598971,69158,79591935,55,7036,66826,138,100723,17096,3,55,130000.0,43333.0,-68.0,-64.0,-68.0,-69.0,-66.0,-64.0,-67.0,-69.0,-75.0,-83.0,-74.0,-84.0,7.0,19.0,6.0,15.0,1
643,F8:59:71:5A:E0:3D,2173307,307416093,22787,34584763,2150520,272831330,0,16161,22940341,16107,22931122,54,9219,16102,2,22798,1020,0,13,144444.0,43333.0,-65.0,-72.0,-65.0,-70.0,-65.0,-72.0,-64.0,-69.0,-75.0,-83.0,-74.0,-84.0,10.0,11.0,9.0,14.0,1
644,CC:2F:71:3E:C5:1F,2150573,272837889,52,6497,2150521,272831392,0,231,19921,195,15475,36,4446,60,1,85,2,0,11,144444.0,39000.0,-70.0,-70.0,-67.0,-60.0,-69.0,-70.0,-66.0,-60.0,-75.0,-83.0,-74.0,-84.0,5.0,13.0,7.0,24.0,1
645,CC:2F:71:3F:1F:24,2251386,405680057,100863,132848463,2150523,272831594,3,69365,79808547,69310,79801511,55,7036,66974,138,100885,17098,3,55,130000.0,43333.0,-65.0,-64.0,-69.0,-69.0,-66.0,-64.0,-66.0,-68.0,-75.0,-83.0,-74.0,-84.0,10.0,19.0,5.0,15.0,1
646,F8:59:71:5A:E0:3D,2173377,307517513,22852,34685717,2150525,272831796,0,16226,23040441,16172,23031222,54,9219,16167,2,22863,1020,0,13,130000.0,39000.0,-66.0,-72.0,-64.0,-70.0,-65.0,-72.0,-64.0,-69.0,-74.0,-82.0,-74.0,-84.0,8.0,10.0,10.0,14.0,1
647,CC:2F:71:3E:C5:1F,2150577,272838293,52,6497,2150525,272831796,0,232,19991,196,15545,36,4446,60,1,85,2,0,11,144444.0,39000.0,-69.0,-70.0,-66.0,-60.0,-69.0,-70.0,-66.0,-60.0,-74.0,-82.0,-74.0,-84.0,5.0,12.0,8.0,24.0,1
648,CC:2F:71:3F:1F:24,2251545,405883404,101019,133051335,2150526,272832069,3,69515,80010913,69460,80003877,55,7036,67119,138,101041,17108,3,55,130000.0,43333.0,-67.0,-64.0,-68.0,-69.0,-67.0,-64.0,-67.0,-68.0,-74.0,-82.0,-74.0,-84.0,7.0,18.0,6.0,15.0,1
649,F8:59:71:5A:E0:3D,2173566,307798103,23038,34965832,2150528,272832271,0,16308,23145829,16254,23136610,54,9219,16249,2,23049,1020,0,13,144444.0,43333.0,-67.0,-73.0,-64.0,-69.0,-65.0,-72.0,-64.0,-69.0,-74.0,-82.0,-74.0,-84.0,7.0,9.0,10.0,15.0,1
650,CC:2F:71:3E:C5:1F,2150581,272838828,52,6497,2150529,272832331,0,232,19991,196,15545,36,4446,60,1,85,2,0,11,144444.0,39000.0,-69.0,-70.0,-66.0,-60.0,-69.0,-70.0,-66.0,-60.0,-74.0,-82.0,-74.0,-84.0,5.0,12.0,8.0,24.0,1
651,CC:2F:71:3F:1F:24,2251715,406096387,101185,133263988,2150530,272832399,3,69678,80225284,69623,80218248,55,7036,67272,138,101207,17108,3,55,130000.0,43333.0,-68.0,-64.0,-69.0,-69.0,-67.0,-63.0,-67.0,-69.0,-74.0,-82.0,-74.0,-84.0,6.0,18.0,5.0,15.0,1
652,F8:59:71:5A:E0:3D,2173820,308178683,23283,35345378,2150537,272833305,0,16420,23292053,16366,23282834,54,9219,16359,2,23286,1166,0,13,144444.0,43333.0,-65.0,-71.0,-63.0,-69.0,-64.0,-71.0,-63.0,-69.0,-74.0,-82.0,-74.0,-84.0,9.0,11.0,11.0,15.0,1
653,CC:2F:71:3E:C5:1F,2150591,272840004,52,6497,2150539,272833507,0,232,19991,196,15545,36,4446,60,1,85,2,0,11,144444.0,39000.0,-69.0,-70.0,-66.0,-60.0,-69.0,-70.0,-66.0,-60.0,-74.0,-82.0,-74.0,-84.0,5.0,12.0,8.0,24.0,1
654,CC:2F:71:3F:1F:24,2252374,407005972,101835,134172465,2150539,272833507,3,70014,80639189,69959,80632153,55,7036,67597,138,101860,17631,3,55,43333.0,5500.0,-66.0,-64.0,-63.0,-68.0,-65.0,-63.0,-65.0,-68.0,-74.0,-82.0,-74.0,-83.0,8.0,18.0,11.0,15.0,1
655,F8:59:71:5A:E0:3D,2174488,309119658,23905,36281871,2150583,272837787,0,17147,24381333,17093,24372114,54,9219,17056,2,23905,1479,0,13,144444.0,43333.0,-64.0,-71.0,-64.0,-69.0,-63.0,-71.0,-64.0,-69.0,-74.0,-81.0,-73.0,-83.0,10.0,10.0,9.0,14.0,1
656,CC:2F:71:3E:C5:1F,2150664,272847253,54,6729,2150610,272840524,0,243,20845,206,16281,37,4564,62,1,88,3,0,12,144444.0,39000.0,-69.0,-70.0,-66.0,-60.0,-68.0,-69.0,-65.0,-59.0,-73.0,-81.0,-73.0,-83.0,4.0,11.0,7.0,23.0,1
657,CC:2F:71:3F:1F:24,2255652,411467357,105040,138626631,2150612,272840726,3,72759,84102136,72703,84094994,56,7142,70187,331,105066,18185,3,56,78000.0,19500.0,-67.0,-64.0,-67.0,-67.0,-67.0,-63.0,-67.0,-67.0,-73.0,-81.0,-73.0,-83.0,6.0,17.0,6.0,16.0,1
658,F8:59:71:5A:E0:3D,2175550,310691491,24931,37850099,2150619,272841392,0,17707,25184317,17653,25175098,54,9219,17572,2,24942,1608,0,14,144444.0,43333.0,-65.0,-72.0,-64.0,-69.0,-65.0,-71.0,-64.0,-69.0,-73.0,-81.0,-73.0,-83.0,8.0,9.0,9.0,14.0,1
659,CC:2F:71:3E:C5:1F,2150673,272848121,54,6729,2150619,272841392,0,243,20845,206,16281,37,4564,62,1,88,3,0,12,144444.0,39000.0,-69.0,-70.0,-66.0,-60.0,-68.0,-69.0,-65.0,-59.0,-73.0,-81.0,-73.0,-83.0,4.0,11.0,7.0,23.0,1
660,CC:2F:71:3F:1F:24,2256273,412296201,105654,139454809,2150619,272841392,3,73260,84579232,73204,84572090,56,7142,70671,331,105680,18187,3,56,130000.0,43333.0,-68.0,-64.0,-67.0,-68.0,-67.0,-64.0,-67.0,-67.0,-73.0,-81.0,-73.0,-83.0,5.0,17.0,6.0,15.0,1
661,F8:59:71:5A:E0:3D,2175646,310832877,25025,37991283,2150621,272841594,0,17780,25288594,17726,25279375,54,9219,17645,2,25036,1609,0,14,144444.0,43333.0,-65.0,-72.0,-65.0,-69.0,-65.0,-72.0,-64.0,-69.0,-73.0,-81.0,-73.0,-83.0,8.0,9.0,8.0,14.0,1
662,CC:2F:71:3E:C5:1F,2150675,272848323,54,6729,2150621,272841594,0,243,20845,206,16281,37,4564,62,1,88,3,0,12,144444.0,39000.0,-69.0,-70.0,-66.0,-60.0,-68.0,-69.0,-65.0,-59.0,-73.0,-81.0,-73.0,-83.0,4.0,11.0,7.0,23.0,1
663,CC:2F:71:3F:1F:24,2256488,412549895,105867,139708301,2150621,272841594,3,73454,84788611,73398,84781469,56,7142,70857,331,105892,18205,3,56,130000.0,43333.0,-65.0,-64.0,-67.0,-68.0,-67.0,-64.0,-67.0,-67.0,-73.0,-81.0,-73.0,-83.0,8.0,17.0,6.0,15.0,1
664,F8:59:71:5A:E0:3D,2175717,310931603,25092,38089605,2150625,272841998,0,17847,25387972,17793,25378753,54,9219,17712,2,25103,1609,0,14,144444.0,43333.0,-65.0,-71.0,-65.0,-70.0,-65.0,-71.0,-64.0,-69.0,-74.0,-81.0,-73.0,-83.0,9.0,10.0,8.0,13.0,1
665,CC:2F:71:3E:C5:1F,2150679,272848727,54,6729,2150625,272841998,0,243,20845,206,16281,37,4564,62,1,88,3,0,12,144444.0,39000.0,-69.0,-70.0,-66.0,-60.0,-68.0,-69.0,-65.0,-59.0,-74.0,-81.0,-73.0,-83.0,5.0,11.0,7.0,23.0,1
666,CC:2F:71:3F:1F:24,2256840,413001206,106213,140159006,2150627,272842200,3,73691,85007821,73635,85000679,56,7142,71086,331,106240,18225,3,56,130000.0,43333.0,-66.0,-65.0,-66.0,-68.0,-67.0,-64.0,-67.0,-67.0,-74.0,-81.0,-73.0,-83.0,8.0,16.0,7.0,15.0,1
667,F8:59:71:5A:E0:3D,2175786,311031523,25156,38189061,2150630,272842462,0,17911,25486532,17857,25477313,54,9219,17776,2,25167,1609,0,14,144444.0,43333.0,-65.0,-72.0,-65.0,-69.0,-65.0,-72.0,-64.0,-69.0,-74.0,-81.0,-73.0,-83.0,9.0,9.0,8.0,14.0,1
668,CC:2F:71:3E:C5:1F,2150684,272849191,54,6729,2150630,272842462,0,243,20845,206,16281,37,4564,62,1,88,3,0,12,144444.0,39000.0,-69.0,-70.0,-66.0,-60.0,-68.0,-69.0,-65.0,-59.0,-74.0,-81.0,-73.0,-83.0,5.0,11.0,7.0,23.0,1
669,CC:2F:71:3F:1F:24,2257193,413452916,106563,140610454,2150630,272842462,3,73937,85228877,73881,85221735,56,7142,71319,331,106590,18225,3,56,130000.0,43333.0,-69.0,-64.0,-68.0,-67.0,-67.0,-64.0,-67.0,-67.0,-74.0,-81.0,-73.0,-83.0,5.0,17.0,5.0,16.0,1
670,F8:59:71:5A:E0:3D,2175856,311130414,25224,38287750,2150632,272842664,0,17977,25584686,17923,25575467,54,9219,17842,2,25235,1610,0,14,144444.0,43333.0,-64.0,-71.0,-66.0,-69.0,-64.0,-71.0,-64.0,-69.0,-74.0,-81.0,-73.0,-83.0,10.0,10.0,7.0,14.0,1
671,CC:2F:71:3E:C5:1F,2150686,272849393,54,6729,2150632,272842664,0,243,20845,206,16281,37,4564,62,1,88,3,0,12,144444.0,39000.0,-69.0,-70.0,-66.0,-60.0,-68.0,-69.0,-65.0,-59.0,-74.0,-81.0,-73.0,-83.0,5.0,11.0,7.0,23.0,1
672,CC:2F:71:3F:1F:24,2257357,413662632,106723,140819766,2150634,272842866,3,74087,85436811,74031,85429669,56,7142,71464,331,106750,18226,3,56,130000.0,43333.0,-65.0,-64.0,-64.0,-67.0,-66.0,-63.0,-67.0,-67.0,-74.0,-81.0,-73.0,-83.0,9.0,17.0,9.0,16.0,1
673,F8:59:71:5A:E0:3D,2176007,311350190,25370,38507060,2150637,272843130,0,18055,25690082,18001,25680863,54,9219,17920,2,25381,1611,0,14,144444.0,43333.0,-65.0,-72.0,-66.0,-70.0,-65.0,-72.0,-64.0,-69.0,-74.0,-81.0,-73.0,-83.0,9.0,9.0,7.0,13.0,1
674,CC:2F:71:3E:C5:1F,2150691,272849859,54,6729,2150637,272843130,0,243,20845,206,16281,37,4564,62,1,88,3,0,12,144444.0,39000.0,-69.0,-70.0,-66.0,-60.0,-68.0,-69.0,-65.0,-59.0,-74.0,-81.0,-73.0,-83.0,5.0,11.0,7.0,23.0,1
675,CC:2F:71:3F:1F:24,2257527,413867754,106888,141024422,2150639,272843332,3,74247,85647311,74190,85640051,57,7260,71615,331,106915,18232,3,56,130000.0,43333.0,-65.0,-64.0,-65.0,-68.0,-66.0,-64.0,-67.0,-67.0,-74.0,-81.0,-73.0,-83.0,9.0,17.0,8.0,15.0,1
676,F8:59:71:5A:E0:3D,2176074,311447002,25432,38603408,2150642,272843594,0,18117,25785562,18063,25776343,54,9219,17982,2,25443,1612,0,14,144444.0,43333.0,-66.0,-72.0,-64.0,-69.0,-65.0,-71.0,-65.0,-69.0,-74.0,-81.0,-73.0,-83.0,8.0,9.0,9.0,14.0,1
677,CC:2F:71:3E:C5:1F,2150696,272850323,54,6729,2150642,272843594,0,243,20845,206,16281,37,4564,62,1,88,3,0,12,144444.0,39000.0,-69.0,-70.0,-66.0,-60.0,-68.0,-69.0,-65.0,-59.0,-74.0,-81.0,-73.0,-83.0,5.0,11.0,7.0,23.0,1
678,CC:2F:71:3F:1F:24,2258105,414652313,107462,141808657,2150643,272843656,3,74457,85868540,74400,85861280,57,7260,71811,331,107489,18232,3,56,130000.0,43333.0,-67.0,-64.0,-68.0,-67.0,-66.0,-64.0,-66.0,-67.0,-74.0,-81.0,-73.0,-83.0,7.0,17.0,5.0,16.0,1
679,F8:59:71:5A:E0:3D,2176266,311736969,25619,38892909,2150647,272844060,0,18196,25886265,18141,25876928,55,9337,18061,2,25630,1613,0,14,144444.0,43333.0,-65.0,-71.0,-66.0,-69.0,-65.0,-72.0,-64.0,-69.0,-74.0,-81.0,-73.0,-83.0,9.0,10.0,7.0,14.0,1
680,CC:2F:71:3E:C5:1F,2150701,272850789,54,6729,2150647,272844060,0,243,20845,206,16281,37,4564,62,1,88,3,0,12,144444.0,39000.0,-69.0,-70.0,-66.0,-60.0,-68.0,-69.0,-65.0,-59.0,-74.0,-81.0,-73.0,-83.0,5.0,11.0,7.0,23.0,1
681,CC:2F:71:3F:1F:24,2258265,414855813,107618,142011753,2150647,272844060,3,74609,86074086,74552,86066826,57,7260,71952,331,107645,18232,3,56,130000.0,43333.0,-68.0,-64.0,-68.0,-69.0,-66.0,-64.0,-66.0,-69.0,-74.0,-81.0,-73.0,-83.0,6.0,17.0,5.0,14.0,1
682,F8:59:71:5A:E0:3D,2176336,311834455,25684,38989718,2150652,272844737,0,18263,25985574,18208,25976237,55,9337,18128,2,25695,1614,0,14,144444.0,43333.0,-67.0,-73.0,-64.0,-70.0,-66.0,-72.0,-64.0,-69.0,-74.0,-81.0,-73.0,-83.0,7.0,8.0,9.0,13.0,1
683,CC:2F:71:3E:C5:1F,2150706,272851466,54,6729,2150652,272844737,0,243,20845,206,16281,37,4564,62,1,88,3,0,12,144444.0,39000.0,-69.0,-70.0,-66.0,-60.0,-68.0,-69.0,-65.0,-59.0,-74.0,-81.0,-73.0,-83.0,5.0,11.0,7.0,23.0,1
684,CC:2F:71:3F:1F:24,2258433,415062833,107781,142218096,2150652,272844737,3,74760,86274055,74703,86266795,57,7260,72100,331,107808,18243,3,56,130000.0,43333.0,-68.0,-64.0,-68.0,-69.0,-67.0,-64.0,-67.0,-69.0,-74.0,-81.0,-73.0,-83.0,6.0,17.0,5.0,14.0,1
685,F8:59:71:5A:E0:3D,2176408,311932054,25751,39086853,2150657,272845201,0,18328,26082188,18273,26072851,55,9337,18193,2,25762,1614,0,14,144444.0,43333.0,-65.0,-72.0,-65.0,-70.0,-66.0,-72.0,-64.0,-69.0,-74.0,-81.0,-73.0,-83.0,9.0,9.0,8.0,13.0,1
686,CC:2F:71:3E:C5:1F,2150711,272851930,54,6729,2150657,272845201,0,243,20845,206,16281,37,4564,62,1,88,3,0,12,144444.0,39000.0,-69.0,-70.0,-66.0,-60.0,-68.0,-69.0,-65.0,-59.0,-74.0,-81.0,-73.0,-83.0,5.0,11.0,7.0,23.0,1
687,CC:2F:71:3F:1F:24,2258593,415266263,107936,142421062,2150657,272845201,3,74901,86468059,74844,86460799,57,7260,72241,331,107963,18245,3,56,130000.0,43333.0,-66.0,-64.0,-65.0,-69.0,-66.0,-64.0,-67.0,-69.0,-74.0,-81.0,-73.0,-83.0,8.0,17.0,8.0,14.0,1
688,F8:59:71:5A:E0:3D,2176472,312028604,25813,39183201,2150659,272845403,0,18390,26177668,18335,26168331,55,9337,18255,2,25824,1614,0,14,144444.0,43333.0,-66.0,-73.0,-64.0,-69.0,-65.0,-72.0,-64.0,-69.0,-74.0,-81.0,-73.0,-83.0,8.0,8.0,9.0,14.0,1
689,CC:2F:71:3E:C5:1F,2150713,272852132,54,6729,2150659,272845403,0,243,20845,206,16281,37,4564,62,1,88,3,0,12,144444.0,39000.0,-69.0,-70.0,-66.0,-60.0,-68.0,-69.0,-65.0,-59.0,-74.0,-81.0,-73.0,-83.0,5.0,11.0,7.0,23.0,1
690,CC:2F:71:3F:1F:24,2258752,415469577,108091,142623972,2150661,272845605,3,75039,86658867,74982,86651607,57,7260,72379,331,108116,18250,3,56,130000.0,39000.0,-68.0,-64.0,-68.0,-70.0,-66.0,-63.0,-67.0,-69.0,-74.0,-81.0,-73.0,-83.0,6.0,17.0,5.0,13.0,1
691,F8:59:71:5A:E0:3D,2176539,312126910,25876,39281103,2150663,272845807,0,18453,26274688,18398,26265351,55,9337,18318,2,25887,1614,0,14,144444.0,43333.0,-67.0,-73.0,-64.0,-70.0,-66.0,-72.0,-64.0,-69.0,-74.0,-81.0,-73.0,-83.0,7.0,8.0,9.0,13.0,1
692,CC:2F:71:3E:C5:1F,2150717,272852536,54,6729,2150663,272845807,0,243,20845,206,16281,37,4564,62,1,88,3,0,12,144444.0,39000.0,-69.0,-70.0,-66.0,-60.0,-68.0,-69.0,-65.0,-59.0,-74.0,-81.0,-73.0,-83.0,5.0,11.0,7.0,23.0,1
693,CC:2F:71:3F:1F:24,2259300,416209091,108635,143363082,2150665,272846009,3,75232,86871234,75175,86863974,57,7260,72572,331,108662,18257,3,56,130000.0,43333.0,-66.0,-64.0,-66.0,-69.0,-67.0,-64.0,-66.0,-69.0,-74.0,-81.0,-73.0,-83.0,8.0,17.0,7.0,14.0,1
694,F8:59:71:5A:E0:3D,2176606,312223722,25938,39377451,2150668,272846271,0,18514,26368628,18459,26359291,55,9337,18379,2,25949,1614,0,14,144444.0,43333.0,-67.0,-73.0,-65.0,-69.0,-66.0,-72.0,-64.0,-69.0,-74.0,-81.0,-73.0,-83.0,7.0,8.0,8.0,14.0,1
695,CC:2F:71:3E:C5:1F,2150722,272853000,54,6729,2150668,272846271,0,243,20845,206,16281,37,4564,62,1,88,3,0,12,144444.0,39000.0,-69.0,-70.0,-66.0,-60.0,-68.0,-69.0,-65.0,-59.0,-74.0,-81.0,-73.0,-83.0,5.0,11.0,7.0,23.0,1
696,CC:2F:71:3F:1F:24,2259483,416420456,108815,143574185,2150668,272846271,3,75395,87068206,75338,87060946,57,7260,72735,331,108842,18257,3,56,130000.0,43333.0,-69.0,-64.0,-66.0,-69.0,-67.0,-63.0,-67.0,-69.0,-74.0,-81.0,-73.0,-83.0,5.0,17.0,7.0,14.0,1
697,F8:59:71:5A:E0:3D,2176671,312321826,26001,39475353,2150670,272846473,0,18578,26467188,18523,26457851,55,9337,18443,2,26012,1614,0,14,144444.0,43333.0,-66.0,-72.0,-66.0,-70.0,-65.0,-72.0,-64.0,-69.0,-74.0,-81.0,-73.0,-83.0,8.0,9.0,7.0,13.0,1
698,CC:2F:71:3E:C5:1F,2150726,272853404,54,6729,2150672,272846675,0,243,20845,206,16281,37,4564,62,1,88,3,0,12,144444.0,39000.0,-69.0,-70.0,-66.0,-60.0,-68.0,-69.0,-65.0,-59.0,-74.0,-81.0,-73.0,-83.0,5.0,11.0,7.0,23.0,1
699,CC:2F:71:3F:1F:24,2259675,416650969,109003,143804294,2150672,272846675,3,75561,87285378,75504,87278118,57,7260,72900,331,109030,18262,3,56,130000.0,39000.0,-66.0,-64.0,-66.0,-69.0,-66.0,-64.0,-66.0,-69.0,-74.0,-81.0,-73.0,-83.0,8.0,17.0,7.0,14.0,1
700,F8:59:71:5A:E0:3D,2176744,312426550,26068,39579471,2150676,272847079,0,18645,26570410,18590,26561073,55,9337,18510,2,26079,1614,0,15,144444.0,43333.0,-66.0,-72.0,-64.0,-70.0,-65.0,-72.0,-64.0,-69.0,-74.0,-81.0,-73.0,-83.0,8.0,9.0,9.0,13.0,1
701,CC:2F:71:3E:C5:1F,2150731,272853868,54,6729,2150677,272847139,0,243,20845,206,16281,37,4564,62,1,88,3,0,12,144444.0,39000.0,-69.0,-70.0,-66.0,-60.0,-68.0,-69.0,-65.0,-59.0,-74.0,-81.0,-73.0,-83.0,5.0,11.0,7.0,23.0,1
702,CC:2F:71:3F:1F:24,2259837,416854642,109160,144007503,2150677,272847139,3,75705,87481319,75648,87474059,57,7260,73044,331,109187,18262,3,56,130000.0,43333.0,-68.0,-64.0,-66.0,-69.0,-67.0,-64.0,-67.0,-69.0,-74.0,-81.0,-73.0,-83.0,6.0,17.0,7.0,14.0,1
703,F8:59:71:5A:E0:3D,2176809,312523160,26130,39675819,2150679,272847341,0,18707,26665890,18652,26656553,55,9337,18572,2,26141,1615,0,15,144444.0,43333.0,-65.0,-72.0,-65.0,-70.0,-65.0,-72.0,-64.0,-69.0,-74.0,-81.0,-74.0,-83.0,9.0,9.0,9.0,13.0,1
704,CC:2F:71:3E:C5:1F,2150733,272854070,54,6729,2150679,272847341,0,243,20845,206,16281,37,4564,62,1,88,3,0,12,144444.0,39000.0,-69.0,-70.0,-66.0,-60.0,-68.0,-69.0,-65.0,-59.0,-74.0,-81.0,-74.0,-83.0,5.0,11.0,8.0,23.0,1
705,CC:2F:71:3F:1F:24,2259999,417058552,109320,144211211,2150679,272847341,3,75849,87675763,75792,87668503,57,7260,73188,331,109347,18265,3,56,130000.0,43333.0,-66.0,-64.0,-66.0,-70.0,-66.0,-64.0,-66.0,-69.0,-74.0,-81.0,-74.0,-83.0,8.0,17.0,8.0,13.0,1
706,F8:59:71:5A:E0:3D,2177082,312928371,26399,40080626,2150683,272847745,0,18808,26780463,18753,26771126,55,9337,18673,2,26410,1616,0,15,144444.0,43333.0,-67.0,-73.0,-64.0,-69.0,-65.0,-72.0,-64.0,-69.0,-74.0,-81.0,-74.0,-83.0,7.0,8.0,10.0,14.0,1
707,CC:2F:71:3E:C5:1F,2150737,272854474,54,6729,2150683,272847745,0,243,20845,206,16281,37,4564,62,1,88,3,0,12,144444.0,39000.0,-69.0,-70.0,-66.0,-60.0,-68.0,-69.0,-65.0,-59.0,-74.0,-81.0,-74.0,-83.0,5.0,11.0,8.0,23.0,1
708,CC:2F:71:3F:1F:24,2260433,417623744,109748,144775797,2150685,272847947,3,76038,87889227,75981,87881967,57,7260,73377,331,109772,18385,3,56,130000.0,39000.0,-67.0,-63.0,-68.0,-68.0,-66.0,-63.0,-67.0,-68.0,-74.0,-81.0,-74.0,-83.0,7.0,18.0,6.0,15.0,1
709,F8:59:71:5A:E0:3D,2177151,313028291,26463,40180082,2150688,272848209,0,18871,26877483,18816,26868146,55,9337,18736,2,26474,1632,0,15,144444.0,43333.0,-66.0,-72.0,-64.0,-70.0,-65.0,-71.0,-64.0,-69.0,-74.0,-81.0,-74.0,-83.0,8.0,9.0,10.0,13.0,1
710,CC:2F:71:3E:C5:1F,2150742,272854938,54,6729,2150688,272848209,0,243,20845,206,16281,37,4564,62,1,88,3,0,12,144444.0,39000.0,-69.0,-70.0,-66.0,-60.0,-68.0,-69.0,-65.0,-59.0,-74.0,-81.0,-74.0,-83.0,5.0,11.0,8.0,23.0,1
711,CC:2F:71:3F:1F:24,2260605,417831663,109917,144983454,2150688,272848209,3,76190,88089227,76133,88081967,57,7260,73529,331,109944,18424,3,56,130000.0,43333.0,-67.0,-64.0,-68.0,-69.0,-67.0,-64.0,-66.0,-69.0,-74.0,-81.0,-74.0,-83.0,7.0,17.0,6.0,14.0,1
712,F8:59:71:5A:E0:3D,2177218,313126597,26526,40277984,2150692,272848613,0,18934,26974503,18879,26965166,55,9337,18799,2,26536,1640,0,15,144444.0,43333.0,-66.0,-73.0,-64.0,-70.0,-66.0,-72.0,-63.0,-69.0,-73.0,-81.0,-73.0,-82.0,7.0,8.0,9.0,12.0,1
713,CC:2F:71:3E:C5:1F,2150746,272855342,54,6729,2150692,272848613,0,243,20845,206,16281,37,4564,62,1,88,3,0,12,144444.0,39000.0,-69.0,-70.0,-66.0,-60.0,-68.0,-69.0,-65.0,-59.0,-73.0,-81.0,-73.0,-82.0,4.0,11.0,7.0,22.0,1
714,CC:2F:71:3F:1F:24,2260772,418039265,110080,145190652,2150692,272848613,3,76335,88286582,76278,88279322,57,7260,73674,331,110107,18463,3,56,130000.0,43333.0,-67.0,-64.0,-65.0,-69.0,-67.0,-64.0,-65.0,-69.0,-73.0,-81.0,-73.0,-82.0,6.0,17.0,8.0,13.0,1
715,F8:59:71:5A:E0:3D,2177284,313223237,26588,40374220,2150696,272849017,0,18997,27071523,18942,27062186,55,9337,18862,2,26599,1661,0,15,144444.0,1000.0,-66.0,-72.0,-63.0,-70.0,-65.0,-72.0,-64.0,-69.0,-73.0,-81.0,-73.0,-82.0,7.0,9.0,10.0,12.0,1
716,CC:2F:71:3E:C5:1F,2150750,272855746,54,6729,2150696,272849017,0,245,20985,208,16421,37,4564,62,1,89,3,0,12,144444.0,39000.0,-70.0,-70.0,-66.0,-60.0,-68.0,-69.0,-65.0,-59.0,-73.0,-81.0,-73.0,-82.0,3.0,11.0,7.0,22.0,1
717,CC:2F:71:3F:1F:24,2260932,418242149,110236,145393132,2150696,272849017,3,76478,88480818,76421,88473558,57,7260,73817,331,110263,18508,3,56,130000.0,39000.0,-67.0,-64.0,-68.0,-69.0,-66.0,-64.0,-65.0,-69.0,-73.0,-81.0,-73.0,-82.0,6.0,17.0,5.0,13.0,1
718,F8:59:71:5A:E0:3D,2177349,313319623,26650,40470344,2150699,272849279,0,19059,27167003,19004,27157666,55,9337,18924,2,26661,1678,0,15,144444.0,43333.0,-65.0,-71.0,-65.0,-69.0,-65.0,-71.0,-64.0,-69.0,-73.0,-81.0,-73.0,-82.0,8.0,10.0,8.0,13.0,1
719,CC:2F:71:3E:C5:1F,2150755,272856210,54,6729,2150701,272849481,0,245,20985,208,16421,37,4564,62,1,89,3,0,12,144444.0,39000.0,-70.0,-70.0,-66.0,-60.0,-68.0,-69.0,-65.0,-59.0,-73.0,-81.0,-73.0,-82.0,3.0,11.0,7.0,22.0,1
720,CC:2F:71:3F:1F:24,2261099,418448073,110398,145598592,2150701,272849481,3,76625,88677084,76568,88669824,57,7260,73964,331,110425,18535,3,56,130000.0,43333.0,-67.0,-64.0,-67.0,-69.0,-66.0,-64.0,-65.0,-69.0,-73.0,-81.0,-73.0,-82.0,6.0,17.0,6.0,13.0,1
721,F8:59:71:5A:E0:3D,2177417,313416465,26712,40566580,2150705,272849885,0,19121,27262483,19066,27253146,55,9337,18986,2,26723,1693,0,15,144444.0,43333.0,-65.0,-71.0,-64.0,-70.0,-65.0,-72.0,-63.0,-69.0,-73.0,-81.0,-73.0,-82.0,8.0,10.0,9.0,12.0,1
722,CC:2F:71:3E:C5:1F,2150759,272856614,54,6729,2150705,272849885,0,245,20985,208,16421,37,4564,62,1,89,3,0,12,144444.0,39000.0,-70.0,-70.0,-66.0,-60.0,-68.0,-69.0,-65.0,-59.0,-73.0,-81.0,-73.0,-82.0,3.0,11.0,7.0,22.0,1
723,CC:2F:71:3F:1F:24,2261265,418654452,110560,145804567,2150705,272849885,3,76776,88874175,76719,88866915,57,7260,74114,331,110587,18564,3,56,130000.0,43333.0,-66.0,-64.0,-67.0,-69.0,-66.0,-64.0,-66.0,-69.0,-73.0,-81.0,-73.0,-82.0,7.0,17.0,6.0,13.0,1
724,F8:59:71:5A:E0:3D,2177484,313515016,26778,40664858,2150706,272850158,0,19186,27360835,19131,27351498,55,9337,19051,2,26789,1710,0,15,144444.0,43333.0,-64.0,-72.0,-65.0,-69.0,-65.0,-72.0,-64.0,-69.0,-73.0,-81.0,-73.0,-82.0,9.0,9.0,8.0,13.0,1
725,CC:2F:71:3E:C5:1F,2150763,272857205,55,6845,2150708,272850360,0,247,21125,210,16561,37,4564,62,1,90,6,0,12,144444.0,1000.0,-68.0,-70.0,-67.0,-60.0,-67.0,-69.0,-65.0,-59.0,-73.0,-81.0,-73.0,-82.0,5.0,11.0,6.0,22.0,1
726,CC:2F:71:3F:1F:24,2261426,418859711,110718,146009351,2150708,272850360,3,76922,89073050,76865,89065790,57,7260,74259,331,110745,18587,3,56,130000.0,43333.0,-67.0,-64.0,-65.0,-70.0,-66.0,-64.0,-66.0,-69.0,-73.0,-81.0,-73.0,-82.0,6.0,17.0,8.0,12.0,1
727,F8:59:71:5A:E0:3D,2177684,313809113,26971,40958289,2150713,272850824,0,19266,27463114,19211,27453777,55,9337,19131,2,26982,1732,0,15,144444.0,43333.0,-66.0,-72.0,-65.0,-69.0,-65.0,-72.0,-64.0,-69.0,-73.0,-81.0,-73.0,-82.0,7.0,9.0,8.0,13.0,1
728,CC:2F:71:3E:C5:1F,2150768,272857669,55,6845,2150713,272850824,0,247,21125,210,16561,37,4564,62,1,90,6,0,12,144444.0,1000.0,-68.0,-70.0,-67.0,-60.0,-67.0,-69.0,-65.0,-59.0,-73.0,-81.0,-73.0,-82.0,5.0,11.0,6.0,22.0,1
729,CC:2F:71:3F:1F:24,2262108,419788156,111393,146937130,2150715,272851026,3,77139,89286815,77082,89279555,57,7260,74476,331,111420,18869,3,56,130000.0,39000.0,-67.0,-64.0,-67.0,-69.0,-67.0,-64.0,-66.0,-69.0,-73.0,-81.0,-73.0,-82.0,6.0,17.0,6.0,13.0,1
730,F8:59:71:5A:E0:3D,2177751,313907585,27034,41056191,2150717,272851394,0,19328,27558594,19273,27549257,55,9337,19193,2,27044,1745,0,15,144444.0,43333.0,-65.0,-72.0,-64.0,-70.0,-65.0,-71.0,-63.0,-69.0,-73.0,-81.0,-73.0,-82.0,8.0,9.0,9.0,12.0,1
731,CC:2F:71:3E:C5:1F,2150772,272858239,55,6845,2150717,272851394,0,247,21125,210,16561,37,4564,62,1,90,6,0,12,144444.0,1000.0,-68.0,-70.0,-67.0,-60.0,-67.0,-69.0,-65.0,-59.0,-73.0,-81.0,-73.0,-82.0,5.0,11.0,6.0,22.0,1
732,CC:2F:71:3F:1F:24,2262267,419994542,111550,147143148,2150717,272851394,3,77283,89485453,77226,89478193,57,7260,74619,331,111577,18883,3,56,130000.0,43333.0,-64.0,-64.0,-65.0,-70.0,-66.0,-64.0,-65.0,-69.0,-73.0,-81.0,-73.0,-82.0,9.0,17.0,8.0,12.0,1
733,F8:59:71:5A:E0:3D,2177998,314285878,27277,41434080,2150721,272851798,0,19413,27661484,19358,27652147,55,9337,19278,2,27288,1800,0,15,144444.0,43333.0,-64.0,-72.0,-63.0,-69.0,-65.0,-72.0,-64.0,-69.0,-73.0,-81.0,-73.0,-82.0,9.0,9.0,10.0,13.0,1
734,CC:2F:71:3E:C5:1F,2150776,272858643,55,6845,2150721,272851798,0,247,21125,210,16561,37,4564,62,1,90,6,0,12,144444.0,1000.0,-68.0,-70.0,-67.0,-60.0,-67.0,-69.0,-65.0,-59.0,-73.0,-81.0,-73.0,-82.0,5.0,11.0,6.0,22.0,1
735,CC:2F:71:3F:1F:24,2262435,420204045,111714,147352247,2150721,272851798,3,77435,89682555,77378,89675295,57,7260,74769,331,111741,18936,3,56,130000.0,43333.0,-67.0,-64.0,-67.0,-69.0,-66.0,-64.0,-66.0,-69.0,-73.0,-81.0,-73.0,-82.0,6.0,17.0,6.0,13.0,1
736,F8:59:71:5A:E0:3D,2178066,314382640,27339,41530316,2150727,272852324,0,19476,27758504,19421,27749167,55,9337,19341,2,27350,1814,0,15,144444.0,43333.0,-66.0,-72.0,-64.0,-70.0,-65.0,-71.0,-63.0,-69.0,-73.0,-81.0,-73.0,-82.0,7.0,9.0,9.0,12.0,1
737,CC:2F:71:3E:C5:1F,2150782,272859169,55,6845,2150727,272852324,0,249,21313,211,16631,38,4682,63,1,90,6,0,12,144444.0,1000.0,-69.0,-70.0,-66.0,-60.0,-67.0,-69.0,-65.0,-59.0,-73.0,-81.0,-73.0,-82.0,4.0,11.0,7.0,22.0,1
738,CC:2F:71:3F:1F:24,2262597,420408811,111870,147556487,2150727,272852324,3,77580,89879793,77523,89872533,57,7260,74911,331,111897,18977,3,56,130000.0,43333.0,-66.0,-64.0,-65.0,-70.0,-66.0,-64.0,-66.0,-69.0,-73.0,-81.0,-73.0,-82.0,7.0,17.0,8.0,12.0,1
739,F8:59:71:5A:E0:3D,2178132,314479392,27401,41626664,2150731,272852728,0,19538,27853984,19483,27844647,55,9337,19403,2,27412,1830,0,15,144444.0,43333.0,-66.0,-72.0,-64.0,-69.0,-65.0,-71.0,-64.0,-69.0,-73.0,-81.0,-73.0,-82.0,7.0,9.0,9.0,13.0,1
740,CC:2F:71:3E:C5:1F,2150786,272859573,55,6845,2150731,272852728,0,249,21313,211,16631,38,4682,63,1,90,6,0,12,144444.0,1000.0,-69.0,-70.0,-66.0,-60.0,-67.0,-69.0,-65.0,-59.0,-73.0,-81.0,-73.0,-82.0,4.0,11.0,7.0,22.0,1
741,CC:2F:71:3F:1F:24,2262758,420613753,112027,147761025,2150731,272852728,3,77720,90073681,77663,90066421,57,7260,75051,331,112054,19020,3,56,130000.0,43333.0,-68.0,-64.0,-68.0,-69.0,-66.0,-63.0,-65.0,-69.0,-73.0,-81.0,-73.0,-82.0,5.0,17.0,5.0,13.0,1
742,F8:59:71:5A:E0:3D,2178199,314577586,27464,41724454,2150735,272853132,0,19600,27949464,19545,27940127,55,9337,19465,2,27474,1849,0,15,144444.0,43333.0,-65.0,-71.0,-64.0,-69.0,-65.0,-71.0,-64.0,-69.0,-73.0,-81.0,-73.0,-83.0,8.0,10.0,9.0,14.0,1
743,CC:2F:71:3E:C5:1F,2150790,272859977,55,6845,2150735,272853132,0,249,21313,211,16631,38,4682,63,1,90,6,0,12,144444.0,1000.0,-69.0,-70.0,-66.0,-60.0,-67.0,-69.0,-65.0,-59.0,-73.0,-81.0,-73.0,-83.0,4.0,11.0,7.0,23.0,1
744,CC:2F:71:3F:1F:24,2262916,420813890,112181,147960758,2150735,272853132,3,77865,90268157,77808,90260897,57,7260,75196,331,112207,19052,3,56,130000.0,43333.0,-67.0,-64.0,-67.0,-69.0,-66.0,-64.0,-66.0,-69.0,-73.0,-81.0,-73.0,-83.0,6.0,17.0,6.0,14.0,1
745,F8:59:71:5A:E0:3D,2178266,314674398,27526,41820802,2150740,272853596,0,19663,28046484,19608,28037147,55,9337,19528,2,27537,1861,0,15,144444.0,43333.0,-65.0,-72.0,-63.0,-70.0,-65.0,-71.0,-64.0,-69.0,-73.0,-81.0,-73.0,-83.0,8.0,9.0,10.0,13.0,1
746,CC:2F:71:3E:C5:1F,2150795,272860441,55,6845,2150740,272853596,0,249,21313,211,16631,38,4682,63,1,90,6,0,12,144444.0,1000.0,-69.0,-70.0,-66.0,-60.0,-67.0,-69.0,-65.0,-59.0,-73.0,-81.0,-73.0,-83.0,4.0,11.0,7.0,23.0,1
747,CC:2F:71:3F:1F:24,2263079,421020695,112339,148167099,2150740,272853596,3,78008,90463825,77951,90456565,57,7260,75339,331,112366,19081,3,56,130000.0,43333.0,-67.0,-64.0,-66.0,-69.0,-67.0,-64.0,-66.0,-69.0,-73.0,-81.0,-73.0,-83.0,6.0,17.0,7.0,14.0,1
748,F8:59:71:5A:E0:3D,2178361,314811174,27617,41957174,2150744,272854000,0,19731,28145898,19676,28136561,55,9337,19596,2,27628,1874,0,15,144444.0,43333.0,-65.0,-72.0,-65.0,-70.0,-65.0,-71.0,-64.0,-69.0,-73.0,-81.0,-73.0,-83.0,8.0,9.0,8.0,13.0,1
749,CC:2F:71:3E:C5:1F,2150799,272860845,55,6845,2150744,272854000,0,249,21313,211,16631,38,4682,63,1,90,6,0,12,144444.0,1000.0,-69.0,-70.0,-66.0,-60.0,-67.0,-69.0,-65.0,-59.0,-73.0,-81.0,-73.0,-83.0,4.0,11.0,7.0,23.0,1
750,CC:2F:71:3F:1F:24,2263246,421227428,112502,148373428,2150744,272854000,3,78159,90660895,78102,90653635,57,7260,75490,331,112529,19109,3,56,130000.0,43333.0,-67.0,-64.0,-64.0,-69.0,-67.0,-63.0,-66.0,-69.0,-73.0,-81.0,-73.0,-83.0,6.0,17.0,9.0,14.0,1
751,F8:59:71:5A:E0:3D,2178715,315357068,27969,42502866,2150746,272854202,0,19829,28253629,19774,28244292,55,9337,19694,2,27980,1997,0,15,144444.0,43333.0,-65.0,-71.0,-65.0,-69.0,-65.0,-71.0,-64.0,-69.0,-73.0,-81.0,-73.0,-83.0,8.0,10.0,8.0,14.0,1
752,CC:2F:71:3E:C5:1F,2150803,272861249,55,6845,2150748,272854404,0,249,21313,211,16631,38,4682,63,1,90,6,0,12,144444.0,1000.0,-69.0,-70.0,-66.0,-60.0,-67.0,-69.0,-65.0,-59.0,-73.0,-81.0,-73.0,-83.0,4.0,11.0,7.0,23.0,1
753,CC:2F:71:3F:1F:24,2263410,421436640,112662,148582236,2150748,272854404,3,78303,90859533,78246,90852273,57,7260,75633,331,112687,19138,3,56,130000.0,43333.0,-67.0,-64.0,-65.0,-69.0,-66.0,-64.0,-65.0,-69.0,-73.0,-81.0,-73.0,-83.0,6.0,17.0,8.0,14.0,1
754,F8:59:71:5A:E0:3D,2178785,315455636,28032,42600768,2150753,272854868,0,19891,28349109,19836,28339772,55,9337,19756,2,28043,2019,0,15,144444.0,43333.0,-65.0,-72.0,-65.0,-69.0,-65.0,-72.0,-64.0,-69.0,-73.0,-81.0,-73.0,-83.0,8.0,9.0,8.0,14.0,1
755,CC:2F:71:3E:C5:1F,2150808,272861713,55,6845,2150753,272854868,0,249,21313,211,16631,38,4682,63,1,90,6,0,12,144444.0,1000.0,-69.0,-70.0,-66.0,-60.0,-67.0,-69.0,-65.0,-59.0,-73.0,-81.0,-73.0,-83.0,4.0,11.0,7.0,23.0,1
756,CC:2F:71:3F:1F:24,2263576,421640723,112823,148785855,2150753,272854868,3,78455,91057798,78398,91050538,57,7260,75785,331,112850,19162,3,56,130000.0,43333.0,-64.0,-64.0,-64.0,-69.0,-66.0,-63.0,-66.0,-68.0,-73.0,-81.0,-73.0,-83.0,9.0,17.0,9.0,14.0,1
757,F8:59:71:5A:E0:3D,2178848,315551934,28094,42697004,2150754,272854930,0,19954,28446129,19899,28436792,55,9337,19819,2,28105,2046,0,15,144444.0,43333.0,-65.0,-72.0,-64.0,-70.0,-65.0,-72.0,-64.0,-69.0,-73.0,-81.0,-73.0,-83.0,8.0,9.0,9.0,13.0,1
758,CC:2F:71:3E:C5:1F,2150811,272861977,55,6845,2150756,272855132,0,249,21313,211,16631,38,4682,63,1,90,6,0,12,144444.0,1000.0,-69.0,-70.0,-66.0,-60.0,-67.0,-69.0,-65.0,-59.0,-73.0,-81.0,-73.0,-83.0,4.0,11.0,7.0,23.0,1
759,CC:2F:71:3F:1F:24,2263986,422194703,113230,149339571,2150756,272855132,3,78648,91274783,78590,91267405,58,7378,75978,331,113238,19461,3,56,117000.0,39000.0,-64.0,-64.0,-63.0,-69.0,-66.0,-64.0,-66.0,-69.0,-73.0,-81.0,-73.0,-83.0,9.0,17.0,10.0,14.0,1
760,F8:59:71:5A:E0:3D,2178969,315674924,28206,42819124,2150763,272855800,0,20068,28558883,20012,28549428,56,9455,19933,2,28217,2074,0,16,144444.0,43333.0,-65.0,-72.0,-64.0,-70.0,-65.0,-71.0,-64.0,-69.0,-73.0,-81.0,-73.0,-83.0,8.0,9.0,9.0,13.0,1
761,CC:2F:71:3E:C5:1F,2150818,272862645,55,6845,2150763,272855800,0,249,21313,211,16631,38,4682,63,1,90,6,0,12,144444.0,1000.0,-69.0,-70.0,-66.0,-60.0,-67.0,-69.0,-65.0,-59.0,-73.0,-81.0,-73.0,-83.0,4.0,11.0,7.0,23.0,1
762,CC:2F:71:3F:1F:24,2264696,423176609,113933,150320809,2150763,272855800,3,78874,91501083,78816,91493705,58,7378,76195,331,113960,19655,3,56,130000.0,43333.0,-67.0,-64.0,-65.0,-70.0,-67.0,-64.0,-66.0,-69.0,-73.0,-81.0,-73.0,-83.0,6.0,17.0,8.0,13.0,1
763,F8:59:71:5A:E0:3D,2179036,315775952,28271,42920022,2150765,272855930,0,20134,28659109,20077,28649528,57,9581,19999,2,28282,2092,0,16,144444.0,43333.0,-66.0,-72.0,-64.0,-70.0,-65.0,-71.0,-64.0,-69.0,-73.0,-81.0,-73.0,-83.0,7.0,9.0,9.0,13.0,1
764,CC:2F:71:3E:C5:1F,2150820,272862775,55,6845,2150765,272855930,0,249,21313,211,16631,38,4682,63,1,90,6,0,12,144444.0,1000.0,-69.0,-70.0,-66.0,-60.0,-67.0,-69.0,-65.0,-59.0,-73.0,-81.0,-73.0,-83.0,4.0,11.0,7.0,23.0,1
765,CC:2F:71:3F:1F:24,2264852,423377927,114087,150521997,2150765,272855930,3,79020,91702961,78962,91695583,58,7378,76336,331,114113,19685,3,56,130000.0,43333.0,-67.0,-64.0,-68.0,-69.0,-66.0,-64.0,-66.0,-69.0,-73.0,-81.0,-73.0,-83.0,6.0,17.0,5.0,14.0,1
766,F8:59:71:5A:E0:3D,2179279,316148160,28510,43291826,2150769,272856334,0,20218,28760459,20161,28750878,57,9581,20083,2,28521,2116,0,16,144444.0,43333.0,-65.0,-72.0,-66.0,-69.0,-65.0,-72.0,-64.0,-69.0,-73.0,-81.0,-73.0,-83.0,8.0,9.0,7.0,14.0,1
767,CC:2F:71:3E:C5:1F,2150824,272863179,55,6845,2150769,272856334,0,249,21313,211,16631,38,4682,63,1,90,6,0,12,144444.0,1000.0,-69.0,-70.0,-66.0,-60.0,-67.0,-69.0,-65.0,-59.0,-73.0,-81.0,-73.0,-83.0,4.0,11.0,7.0,23.0,1
768,CC:2F:71:3F:1F:24,2265017,423583528,114243,150726517,2150774,272857011,3,79171,91908177,79113,91900799,58,7378,76481,331,114270,19710,3,56,130000.0,43333.0,-67.0,-64.0,-68.0,-70.0,-66.0,-64.0,-66.0,-69.0,-73.0,-81.0,-73.0,-83.0,6.0,17.0,5.0,13.0,1
769,F8:59:71:5A:E0:3D,2179475,316445629,28701,43588618,2150774,272857011,0,20294,28862295,20237,28852714,57,9581,20159,2,28712,2150,0,16,144444.0,43333.0,-65.0,-71.0,-65.0,-70.0,-65.0,-71.0,-64.0,-69.0,-73.0,-81.0,-73.0,-83.0,8.0,10.0,8.0,13.0,1
770,CC:2F:71:3E:C5:1F,2150830,272863916,55,6845,2150775,272857071,0,249,21313,211,16631,38,4682,63,1,90,6,0,12,144444.0,1000.0,-69.0,-70.0,-66.0,-60.0,-67.0,-69.0,-65.0,-59.0,-73.0,-81.0,-73.0,-83.0,4.0,11.0,7.0,23.0,1
771,CC:2F:71:3F:1F:24,2265388,424047318,114613,151190247,2150775,272857071,3,79431,92135781,79373,92128403,58,7378,76733,331,114640,19806,3,56,130000.0,43333.0,-67.0,-64.0,-68.0,-69.0,-67.0,-64.0,-65.0,-69.0,-73.0,-81.0,-73.0,-83.0,6.0,17.0,5.0,14.0,1
772,F8:59:71:5A:E0:3D,2179545,316547103,28766,43689628,2150779,272857475,0,20362,28964075,20305,28954494,57,9581,20225,2,28777,2164,0,16,144444.0,43333.0,-65.0,-71.0,-65.0,-69.0,-65.0,-71.0,-64.0,-69.0,-73.0,-81.0,-73.0,-83.0,8.0,10.0,8.0,14.0,1
773,CC:2F:71:3E:C5:1F,2150834,272864320,55,6845,2150779,272857475,0,249,21313,211,16631,38,4682,63,1,90,6,0,12,144444.0,1000.0,-69.0,-70.0,-66.0,-60.0,-67.0,-69.0,-65.0,-59.0,-73.0,-81.0,-73.0,-83.0,4.0,11.0,7.0,23.0,1
774,CC:2F:71:3F:1F:24,2265754,424509279,114975,151651804,2150779,272857475,3,79694,92376928,79636,92369550,58,7378,76974,331,115002,19862,3,56,130000.0,43333.0,-66.0,-64.0,-64.0,-69.0,-65.0,-64.0,-65.0,-69.0,-73.0,-81.0,-73.0,-83.0,7.0,17.0,9.0,14.0,1
775,F8:59:71:5A:E0:3D,2179617,316648975,28834,43791096,2150783,272857879,0,20431,29066533,20374,29056952,57,9581,20294,2,28845,2182,0,16,144444.0,43333.0,-66.0,-73.0,-64.0,-70.0,-65.0,-72.0,-64.0,-69.0,-73.0,-81.0,-73.0,-83.0,7.0,8.0,9.0,13.0,1
776,CC:2F:71:3E:C5:1F,2150838,272864724,55,6845,2150783,272857879,0,249,21313,211,16631,38,4682,63,1,90,6,0,12,144444.0,1000.0,-69.0,-70.0,-66.0,-60.0,-67.0,-69.0,-65.0,-59.0,-73.0,-81.0,-73.0,-83.0,4.0,11.0,7.0,23.0,1
777,CC:2F:71:3F:1F:24,2266124,424967838,115341,152109959,2150783,272857879,3,79955,92603892,79897,92596514,58,7378,77226,331,115368,19934,3,56,130000.0,43333.0,-68.0,-64.0,-65.0,-69.0,-66.0,-64.0,-66.0,-69.0,-73.0,-81.0,-73.0,-83.0,5.0,17.0,8.0,14.0,1
778,F8:59:71:5A:E0:3D,2179686,316748895,28898,43890552,2150788,272858343,0,20495,29165093,20438,29155512,57,9581,20358,2,28909,2195,0,16,144444.0,43333.0,-65.0,-71.0,-64.0,-70.0,-65.0,-71.0,-64.0,-69.0,-73.0,-81.0,-73.0,-83.0,8.0,10.0,9.0,13.0,1
779,CC:2F:71:3E:C5:1F,2150843,272865188,55,6845,2150788,272858343,0,249,21313,211,16631,38,4682,63,1,90,6,0,12,144444.0,1000.0,-69.0,-70.0,-66.0,-60.0,-67.0,-69.0,-65.0,-59.0,-73.0,-81.0,-73.0,-83.0,4.0,11.0,7.0,23.0,1
780,CC:2F:71:3F:1F:24,2266483,425423304,115695,152564961,2150788,272858343,3,80191,92821558,80133,92814180,58,7378,77456,331,115722,20045,3,56,117000.0,39000.0,-67.0,-64.0,-65.0,-69.0,-66.0,-64.0,-66.0,-69.0,-73.0,-81.0,-73.0,-83.0,6.0,17.0,8.0,14.0,1
781,F8:59:71:5A:E0:3D,2179754,316847205,28962,43988458,2150792,272858747,0,20559,29262219,20502,29252638,57,9581,20422,2,28973,2211,0,16,144444.0,43333.0,-66.0,-72.0,-64.0,-70.0,-65.0,-72.0,-63.0,-69.0,-73.0,-81.0,-73.0,-83.0,7.0,9.0,9.0,13.0,1
782,CC:2F:71:3E:C5:1F,2150847,272865592,55,6845,2150792,272858747,0,249,21313,211,16631,38,4682,63,1,90,6,0,12,144444.0,1000.0,-69.0,-70.0,-66.0,-60.0,-67.0,-69.0,-65.0,-59.0,-73.0,-81.0,-73.0,-83.0,4.0,11.0,7.0,23.0,1
783,CC:2F:71:3F:1F:24,2266833,425871677,116041,153012930,2150792,272858747,3,80421,93033049,80363,93025671,58,7378,77680,331,116068,20099,3,56,130000.0,43333.0,-66.0,-64.0,-64.0,-70.0,-66.0,-64.0,-66.0,-69.0,-73.0,-81.0,-73.0,-83.0,7.0,17.0,9.0,13.0,1
784,F8:59:71:5A:E0:3D,2179820,316943957,29024,44084806,2150796,272859151,0,20621,29357699,20564,29348118,57,9581,20484,2,29035,2224,0,16,144444.0,43333.0,-64.0,-71.0,-65.0,-69.0,-65.0,-71.0,-64.0,-69.0,-73.0,-81.0,-73.0,-83.0,9.0,10.0,8.0,14.0,1
785,CC:2F:71:3E:C5:1F,2150851,272865996,55,6845,2150796,272859151,0,249,21313,211,16631,38,4682,63,1,90,6,0,12,144444.0,1000.0,-69.0,-70.0,-66.0,-60.0,-67.0,-69.0,-65.0,-59.0,-73.0,-81.0,-73.0,-83.0,4.0,11.0,7.0,23.0,1
786,CC:2F:71:3F:1F:24,2267189,426327853,116393,153468702,2150796,272859151,3,80663,93252823,80605,93245445,58,7378,77916,331,116419,20190,3,56,130000.0,43333.0,-67.0,-64.0,-66.0,-70.0,-65.0,-64.0,-65.0,-69.0,-73.0,-81.0,-73.0,-83.0,6.0,17.0,7.0,13.0,1
787,F8:59:71:5A:E0:3D,2179897,317046407,29096,44186792,2150801,272859615,0,20691,29459559,20634,29449978,57,9581,20554,2,29107,2247,0,16,144444.0,43333.0,-66.0,-72.0,-64.0,-70.0,-65.0,-71.0,-64.0,-69.0,-73.0,-81.0,-73.0,-83.0,7.0,9.0,9.0,13.0,1
788,CC:2F:71:3E:C5:1F,2150856,272866460,55,6845,2150801,272859615,0,249,21313,211,16631,38,4682,63,1,90,6,0,12,144444.0,1000.0,-69.0,-70.0,-66.0,-60.0,-67.0,-69.0,-65.0,-59.0,-73.0,-81.0,-73.0,-83.0,4.0,11.0,7.0,23.0,1
789,CC:2F:71:3F:1F:24,2267358,426544933,116557,153685318,2150801,272859615,3,80821,93471887,80763,93464509,58,7378,78066,331,116584,20232,3,56,130000.0,43333.0,-67.0,-64.0,-67.0,-69.0,-66.0,-63.0,-66.0,-69.0,-73.0,-81.0,-73.0,-83.0,6.0,17.0,6.0,14.0,1
790,F8:59:71:5A:E0:3D,2179994,317190853,29191,44331036,2150803,272859817,0,20762,29565083,20705,29555502,57,9581,20625,2,29202,2270,0,16,144444.0,43333.0,-65.0,-72.0,-63.0,-70.0,-65.0,-71.0,-63.0,-69.0,-73.0,-81.0,-73.0,-83.0,8.0,9.0,10.0,13.0,1
791,CC:2F:71:3E:C5:1F,2150858,272866662,55,6845,2150803,272859817,0,249,21313,211,16631,38,4682,63,1,90,6,0,12,144444.0,1000.0,-69.0,-70.0,-66.0,-60.0,-67.0,-69.0,-65.0,-59.0,-73.0,-81.0,-73.0,-83.0,4.0,11.0,7.0,23.0,1
792,CC:2F:71:3F:1F:24,2267519,426751299,116714,153891280,2150805,272860019,3,80965,93671963,80907,93664585,58,7378,78208,331,116741,20259,3,56,130000.0,43333.0,-67.0,-64.0,-66.0,-70.0,-66.0,-64.0,-66.0,-69.0,-73.0,-81.0,-73.0,-83.0,6.0,17.0,7.0,13.0,1
793,F8:59:71:5A:E0:3D,2180158,317429200,29348,44568651,2150810,272860549,0,20844,29672336,20787,29662755,57,9581,20707,2,29359,2287,0,16,144444.0,43333.0,-66.0,-72.0,-64.0,-70.0,-65.0,-71.0,-64.0,-69.0,-73.0,-81.0,-73.0,-83.0,7.0,9.0,9.0,13.0,1
794,CC:2F:71:3E:C5:1F,2150865,272867394,55,6845,2150810,272860549,0,249,21313,211,16631,38,4682,63,1,90,6,0,12,144444.0,1000.0,-69.0,-70.0,-66.0,-60.0,-67.0,-69.0,-65.0,-59.0,-73.0,-81.0,-73.0,-83.0,4.0,11.0,7.0,23.0,1
795,CC:2F:71:3F:1F:24,2267682,426957809,116872,154097260,2150810,272860549,3,81109,93870743,81051,93863365,58,7378,78350,331,116899,20276,3,56,130000.0,43333.0,-67.0,-64.0,-65.0,-69.0,-66.0,-64.0,-66.0,-69.0,-73.0,-81.0,-73.0,-83.0,6.0,17.0,8.0,14.0,1
796,F8:59:71:5A:E0:3D,2180221,317525496,29410,44664887,2150811,272860609,0,20906,29767816,20849,29758235,57,9581,20769,2,29421,2296,0,16,144444.0,43333.0,-65.0,-72.0,-64.0,-69.0,-64.0,-71.0,-64.0,-69.0,-73.0,-81.0,-73.0,-83.0,8.0,9.0,9.0,14.0,1
797,CC:2F:71:3E:C5:1F,2150866,272867454,55,6845,2150811,272860609,0,249,21313,211,16631,38,4682,63,1,90,6,0,12,144444.0,1000.0,-69.0,-70.0,-66.0,-60.0,-67.0,-69.0,-65.0,-59.0,-73.0,-81.0,-73.0,-83.0,4.0,11.0,7.0,23.0,1
798,CC:2F:71:3F:1F:24,2268503,428085679,117690,155224868,2150813,272860811,3,81358,94096005,81300,94088627,58,7378,78593,331,117717,20563,3,56,115556.0,28889.0,-67.0,-64.0,-67.0,-69.0,-66.0,-64.0,-67.0,-69.0,-73.0,-81.0,-73.0,-83.0,6.0,17.0,6.0,14.0,1
799,F8:59:71:5A:E0:3D,2180297,317627772,29478,44766355,2150819,272861417,0,20974,29868734,20917,29859153,57,9581,20837,2,29489,2298,0,16,144444.0,43333.0,-66.0,-73.0,-63.0,-69.0,-65.0,-72.0,-64.0,-69.0,-73.0,-81.0,-73.0,-83.0,7.0,8.0,10.0,14.0,1
800,CC:2F:71:3E:C5:1F,2150874,272868262,55,6845,2150819,272861417,0,249,21313,211,16631,38,4682,63,1,90,6,0,12,144444.0,1000.0,-69.0,-70.0,-66.0,-60.0,-67.0,-69.0,-65.0,-59.0,-73.0,-81.0,-73.0,-83.0,4.0,11.0,7.0,23.0,1
801,CC:2F:71:3F:1F:24,2268666,428289497,117847,155428080,2150819,272861417,3,81510,94301327,81452,94293949,58,7378,78739,331,117874,20589,3,56,115556.0,28889.0,-67.0,-64.0,-65.0,-70.0,-66.0,-63.0,-65.0,-69.0,-73.0,-81.0,-73.0,-83.0,6.0,17.0,8.0,13.0,1
802,F8:59:71:5A:E0:3D,2180359,317723952,29540,44862535,2150819,272861417,0,21037,29965754,20980,29956173,57,9581,20900,2,29551,2308,0,16,144444.0,43333.0,-64.0,-71.0,-64.0,-69.0,-64.0,-71.0,-64.0,-69.0,-73.0,-81.0,-73.0,-82.0,9.0,10.0,9.0,13.0,1
803,CC:2F:71:3E:C5:1F,2150874,272868262,55,6845,2150819,272861417,0,251,21453,213,16771,38,4682,63,1,91,6,0,12,144444.0,1000.0,-69.0,-70.0,-66.0,-60.0,-68.0,-69.0,-65.0,-60.0,-73.0,-81.0,-73.0,-82.0,4.0,11.0,7.0,22.0,1
804,CC:2F:71:3F:1F:24,2268823,428492607,118004,155631190,2150819,272861417,3,81658,94503319,81600,94495941,58,7378,78883,331,118031,20612,3,56,115556.0,28889.0,-63.0,-65.0,-64.0,-70.0,-66.0,-64.0,-66.0,-69.0,-73.0,-81.0,-73.0,-82.0,10.0,16.0,9.0,12.0,1
805,F8:59:71:5A:E0:3D,2180428,317820742,29602,44958659,2150826,272862083,0,21099,30061234,21042,30051653,57,9581,20962,2,29613,2320,0,16,144444.0,43333.0,-65.0,-71.0,-63.0,-70.0,-64.0,-71.0,-64.0,-69.0,-73.0,-81.0,-73.0,-82.0,8.0,10.0,10.0,12.0,1
806,CC:2F:71:3E:C5:1F,2150881,272868928,55,6845,2150826,272862083,0,251,21453,213,16771,38,4682,63,1,91,6,0,12,144444.0,1000.0,-69.0,-70.0,-66.0,-60.0,-68.0,-69.0,-65.0,-60.0,-73.0,-81.0,-73.0,-82.0,4.0,11.0,7.0,22.0,1
807,CC:2F:71:3F:1F:24,2268986,428697793,118160,155835710,2150826,272862083,3,81807,94706989,81749,94699611,58,7378,79025,331,118186,20631,3,56,115556.0,28889.0,-66.0,-65.0,-65.0,-69.0,-66.0,-64.0,-65.0,-68.0,-73.0,-81.0,-73.0,-82.0,7.0,16.0,8.0,13.0,1
808,F8:59:71:5A:E0:3D,2180495,317920516,29667,45058231,2150828,272862285,0,21163,30159794,21106,30150213,57,9581,21026,2,29678,2327,0,16,144444.0,43333.0,-65.0,-72.0,-64.0,-69.0,-65.0,-72.0,-64.0,-69.0,-73.0,-81.0,-73.0,-82.0,8.0,9.0,9.0,13.0,1
809,CC:2F:71:3E:C5:1F,2150884,272869190,56,6905,2150828,272862285,0,253,21593,215,16911,38,4682,63,1,92,6,0,12,144444.0,1000.0,-69.0,-69.0,-66.0,-60.0,-68.0,-69.0,-65.0,-60.0,-73.0,-81.0,-73.0,-82.0,4.0,12.0,7.0,22.0,1
810,CC:2F:71:3F:1F:24,2269147,428905739,118319,156043454,2150828,272862285,3,81955,94909015,81897,94901637,58,7378,79170,331,118346,20632,3,56,115556.0,28889.0,-66.0,-65.0,-64.0,-69.0,-66.0,-65.0,-66.0,-68.0,-73.0,-81.0,-73.0,-82.0,7.0,16.0,9.0,13.0,1
811,F8:59:71:5A:E0:3D,2180677,318195606,29844,45332644,2150833,272862962,0,21239,30261570,21182,30251989,57,9581,21102,2,29855,2333,0,16,144444.0,43333.0,-66.0,-73.0,-63.0,-69.0,-65.0,-72.0,-64.0,-69.0,-73.0,-81.0,-73.0,-82.0,7.0,8.0,10.0,13.0,1
812,CC:2F:71:3E:C5:1F,2150889,272869867,56,6905,2150833,272862962,0,253,21593,215,16911,38,4682,63,1,92,6,0,12,144444.0,1000.0,-69.0,-69.0,-66.0,-60.0,-68.0,-69.0,-65.0,-60.0,-73.0,-81.0,-73.0,-82.0,4.0,12.0,7.0,22.0,1
813,CC:2F:71:3F:1F:24,2269323,429117473,118488,156254309,2150835,272863164,3,82119,95117720,82061,95110342,58,7378,79328,331,118515,20704,3,56,65000.0,13000.0,-67.0,-64.0,-67.0,-68.0,-66.0,-64.0,-66.0,-69.0,-73.0,-81.0,-73.0,-82.0,6.0,17.0,6.0,14.0,1
814,F8:59:71:5A:E0:3D,2180749,318298696,29910,45435208,2150839,272863488,0,21306,30364750,21249,30355169,57,9581,21169,2,29921,2340,0,16,144444.0,43333.0,-65.0,-73.0,-64.0,-69.0,-64.0,-72.0,-64.0,-69.0,-73.0,-81.0,-73.0,-82.0,8.0,8.0,9.0,13.0,1
815,CC:2F:71:3E:C5:1F,2150895,272870393,56,6905,2150839,272863488,0,253,21593,215,16911,38,4682,63,1,92,6,0,12,144444.0,1000.0,-69.0,-69.0,-66.0,-60.0,-68.0,-69.0,-65.0,-60.0,-73.0,-81.0,-73.0,-82.0,4.0,12.0,7.0,22.0,1
816,CC:2F:71:3F:1F:24,2269514,429366331,118675,156502843,2150839,272863488,3,82299,95366184,82240,95358688,59,7496,79503,331,118701,20868,3,56,104000.0,26000.0,-67.0,-63.0,-68.0,-71.0,-66.0,-63.0,-66.0,-70.0,-73.0,-81.0,-73.0,-82.0,6.0,18.0,5.0,11.0,1
817,F8:59:71:5A:E0:3D,2180863,318443794,29996,45568852,2150867,272874942,0,21392,30497274,21335,30487693,57,9581,21255,2,30007,2342,0,16,144444.0,43333.0,-65.0,-72.0,-64.0,-69.0,-64.0,-72.0,-64.0,-69.0,-73.0,-81.0,-73.0,-82.0,8.0,9.0,9.0,13.0,1
818,CC:2F:71:3E:C5:1F,2150925,272882049,56,6905,2150869,272875144,0,253,21593,215,16911,38,4682,63,1,92,6,0,12,144444.0,1000.0,-69.0,-69.0,-66.0,-60.0,-68.0,-69.0,-65.0,-60.0,-73.0,-81.0,-73.0,-82.0,4.0,12.0,7.0,22.0,1
819,CC:2F:71:3F:1F:24,2270176,430240990,119307,157365846,2150869,272875144,3,82578,95659008,82519,95651512,59,7496,79767,331,119335,21458,3,56,104000.0,26000.0,-66.0,-63.0,-64.0,-71.0,-67.0,-63.0,-66.0,-70.0,-73.0,-81.0,-73.0,-82.0,7.0,18.0,9.0,11.0,1
820,F8:59:71:5A:E0:3D,2180941,318560606,30071,45685402,2150870,272875204,0,21465,30609694,21408,30600113,57,9581,21328,2,30081,2347,0,16,144444.0,43333.0,-66.0,-73.0,-64.0,-69.0,-65.0,-72.0,-64.0,-69.0,-73.0,-81.0,-73.0,-82.0,7.0,8.0,9.0,13.0,1
821,CC:2F:71:3E:C5:1F,2150926,272882109,56,6905,2150870,272875204,0,253,21593,215,16911,38,4682,63,1,92,6,0,12,144444.0,1000.0,-69.0,-69.0,-66.0,-60.0,-68.0,-69.0,-65.0,-60.0,-73.0,-81.0,-73.0,-82.0,4.0,12.0,7.0,22.0,1
822,CC:2F:71:3F:1F:24,2270357,430461574,119487,157586370,2150870,272875204,3,82749,95880918,82690,95873422,59,7496,79933,331,119516,21516,3,56,130000.0,39000.0,-67.0,-63.0,-68.0,-70.0,-65.0,-63.0,-66.0,-69.0,-73.0,-81.0,-73.0,-82.0,6.0,18.0,5.0,12.0,1
823,F8:59:71:5A:E0:3D,2181011,318657738,30134,45781866,2150877,272875872,0,21530,30706938,21472,30697239,58,9699,21393,2,30145,2349,0,16,144444.0,43333.0,-65.0,-73.0,-65.0,-69.0,-65.0,-72.0,-64.0,-69.0,-73.0,-81.0,-73.0,-82.0,8.0,8.0,8.0,13.0,1
824,CC:2F:71:3E:C5:1F,2150933,272882777,56,6905,2150877,272875872,0,253,21593,215,16911,38,4682,63,1,92,6,0,12,144444.0,1000.0,-69.0,-69.0,-66.0,-60.0,-68.0,-69.0,-65.0,-60.0,-73.0,-81.0,-73.0,-82.0,4.0,12.0,7.0,22.0,1
825,CC:2F:71:3F:1F:24,2270535,430677649,119656,157801575,2150879,272876074,3,82916,96097093,82857,96089597,59,7496,80091,331,119685,21595,3,56,130000.0,43333.0,-66.0,-63.0,-67.0,-70.0,-66.0,-63.0,-66.0,-69.0,-73.0,-81.0,-73.0,-82.0,7.0,18.0,6.0,12.0,1
826,F8:59:71:5A:E0:3D,2181264,319043015,30385,46166941,2150879,272876074,0,21623,30818520,21565,30808821,58,9699,21486,2,30396,2354,0,16,144444.0,43333.0,-65.0,-72.0,-66.0,-69.0,-65.0,-71.0,-64.0,-69.0,-73.0,-81.0,-73.0,-82.0,8.0,9.0,7.0,13.0,1
827,CC:2F:71:3E:C5:1F,2150935,272882979,56,6905,2150879,272876074,0,253,21593,215,16911,38,4682,63,1,92,6,0,12,144444.0,1000.0,-69.0,-69.0,-66.0,-60.0,-68.0,-69.0,-65.0,-60.0,-73.0,-81.0,-73.0,-82.0,4.0,12.0,7.0,22.0,1
828,CC:2F:71:3F:1F:24,2270692,430883387,119813,158007313,2150879,272876074,3,83069,96306841,83010,96299345,59,7496,80236,331,119842,21632,3,56,130000.0,43333.0,-66.0,-63.0,-63.0,-68.0,-65.0,-63.0,-65.0,-68.0,-73.0,-81.0,-73.0,-82.0,7.0,18.0,10.0,14.0,1
829,F8:59:71:5A:E0:3D,2181360,319177840,30473,46301038,2150887,272876802,0,21691,30919368,21633,30909669,58,9699,21554,2,30484,2364,0,16,144444.0,43333.0,-65.0,-72.0,-64.0,-69.0,-64.0,-72.0,-64.0,-69.0,-73.0,-81.0,-73.0,-82.0,8.0,9.0,9.0,13.0,1
830,CC:2F:71:3E:C5:1F,2150943,272883707,56,6905,2150887,272876802,0,254,21711,215,16911,39,4800,64,1,92,6,0,12,144444.0,1000.0,-69.0,-70.0,-66.0,-60.0,-68.0,-69.0,-66.0,-60.0,-73.0,-81.0,-73.0,-82.0,4.0,11.0,7.0,22.0,1
831,CC:2F:71:3F:1F:24,2270861,431093526,119974,158216724,2150887,272876802,3,83219,96512015,83160,96504519,59,7496,80381,331,120003,21646,3,56,130000.0,43333.0,-68.0,-63.0,-68.0,-69.0,-66.0,-63.0,-67.0,-68.0,-73.0,-81.0,-73.0,-82.0,5.0,18.0,5.0,13.0,1
832,F8:59:71:5A:E0:3D,2181425,319275944,30536,46398940,2150889,272877004,0,21754,31016388,21696,31006689,58,9699,21617,2,30547,2368,0,16,144444.0,43333.0,-65.0,-72.0,-64.0,-69.0,-65.0,-72.0,-64.0,-69.0,-73.0,-81.0,-73.0,-82.0,8.0,9.0,9.0,13.0,1
833,CC:2F:71:3E:C5:1F,2150945,272883909,56,6905,2150889,272877004,0,255,21781,216,16981,39,4800,64,1,92,6,0,12,144444.0,1000.0,-69.0,-70.0,-66.0,-60.0,-69.0,-69.0,-66.0,-60.0,-73.0,-81.0,-73.0,-82.0,4.0,11.0,7.0,22.0,1
834,CC:2F:71:3F:1F:24,2271018,431296694,120129,158419690,2150889,272877004,3,83369,96720005,83310,96712509,59,7496,80522,331,120158,21662,3,56,130000.0,43333.0,-67.0,-64.0,-65.0,-70.0,-67.0,-63.0,-66.0,-69.0,-73.0,-81.0,-73.0,-82.0,6.0,17.0,8.0,12.0,1
835,F8:59:71:5A:E0:3D,2181495,319374708,30602,46497300,2150893,272877408,0,21820,31115650,21762,31105951,58,9699,21683,2,30613,2370,0,16,144444.0,43333.0,-66.0,-73.0,-64.0,-69.0,-65.0,-72.0,-64.0,-69.0,-73.0,-81.0,-73.0,-82.0,7.0,8.0,9.0,13.0,1
836,CC:2F:71:3E:C5:1F,2150949,272884313,56,6905,2150893,272877408,0,255,21781,216,16981,39,4800,64,1,92,6,0,12,144444.0,1000.0,-69.0,-70.0,-66.0,-60.0,-69.0,-69.0,-66.0,-60.0,-73.0,-81.0,-73.0,-82.0,4.0,11.0,7.0,22.0,1
837,CC:2F:71:3F:1F:24,2271545,432013383,120650,159135773,2150895,272877610,3,83572,96937265,83513,96929769,59,7496,80720,331,120679,21908,3,56,144444.0,43333.0,-66.0,-63.0,-65.0,-70.0,-66.0,-63.0,-66.0,-69.0,-73.0,-81.0,-73.0,-82.0,7.0,18.0,8.0,12.0,1
838,F8:59:71:5A:E0:3D,2181564,319474628,30666,46596756,2150898,272877872,0,21883,31212670,21825,31202971,58,9699,21746,2,30676,2379,0,16,144444.0,43333.0,-65.0,-72.0,-63.0,-69.0,-65.0,-72.0,-64.0,-68.0,-73.0,-81.0,-73.0,-82.0,8.0,9.0,10.0,13.0,1
839,CC:2F:71:3E:C5:1F,2150954,272884777,56,6905,2150898,272877872,0,255,21781,216,16981,39,4800,64,1,92,6,0,12,144444.0,1000.0,-69.0,-70.0,-66.0,-60.0,-69.0,-69.0,-66.0,-60.0,-73.0,-81.0,-73.0,-82.0,4.0,11.0,7.0,22.0,1
840,CC:2F:71:3F:1F:24,2271721,432223659,120823,159345787,2150898,272877872,3,83732,97144168,83673,97136672,59,7496,80877,331,120852,21970,3,56,130000.0,39000.0,-66.0,-63.0,-66.0,-69.0,-66.0,-63.0,-66.0,-69.0,-73.0,-81.0,-73.0,-82.0,7.0,18.0,7.0,13.0,1
841,F8:59:71:5A:E0:3D,2181638,319575534,30738,46697460,2150900,272878074,0,21956,31316313,21898,31306614,58,9699,21819,2,30749,2382,0,16,144444.0,43333.0,-65.0,-72.0,-65.0,-69.0,-64.0,-71.0,-64.0,-68.0,-73.0,-81.0,-73.0,-82.0,8.0,9.0,8.0,13.0,1
842,CC:2F:71:3E:C5:1F,2150958,272885181,56,6905,2150902,272878276,0,255,21781,216,16981,39,4800,64,1,92,6,0,12,144444.0,1000.0,-69.0,-70.0,-66.0,-60.0,-69.0,-69.0,-66.0,-60.0,-73.0,-81.0,-73.0,-82.0,4.0,11.0,7.0,22.0,1
843,CC:2F:71:3F:1F:24,2271884,432431653,120982,159553377,2150902,272878276,3,83882,97349254,83823,97341758,59,7496,81022,331,121010,22001,3,56,130000.0,43333.0,-64.0,-63.0,-63.0,-70.0,-65.0,-63.0,-65.0,-69.0,-73.0,-81.0,-73.0,-82.0,9.0,18.0,10.0,12.0,1
844,F8:59:71:5A:E0:3D,2181708,319675596,30802,46796916,2150906,272878680,0,22020,31414873,21962,31405174,58,9699,21883,2,30813,2387,0,16,144444.0,43333.0,-65.0,-72.0,-64.0,-69.0,-65.0,-71.0,-64.0,-68.0,-73.0,-81.0,-73.0,-82.0,8.0,9.0,9.0,13.0,1
845,CC:2F:71:3E:C5:1F,2150962,272885585,56,6905,2150906,272878680,0,255,21781,216,16981,39,4800,64,1,92,6,0,12,144444.0,1000.0,-69.0,-70.0,-66.0,-60.0,-69.0,-69.0,-66.0,-60.0,-73.0,-81.0,-73.0,-82.0,4.0,11.0,7.0,22.0,1
846,CC:2F:71:3F:1F:24,2272048,432639763,121141,159761023,2150907,272878740,3,84036,97560636,83977,97553140,59,7496,81167,331,121170,22019,3,56,130000.0,43333.0,-67.0,-64.0,-68.0,-70.0,-67.0,-63.0,-66.0,-69.0,-73.0,-81.0,-73.0,-82.0,6.0,17.0,5.0,12.0,1
847,F8:59:71:5A:E0:3D,2181771,319772004,30864,46893264,2150907,272878740,0,22082,31510353,22024,31500654,58,9699,21945,2,30875,2389,0,16,144444.0,43333.0,-65.0,-72.0,-65.0,-69.0,-64.0,-72.0,-64.0,-69.0,-73.0,-81.0,-73.0,-82.0,8.0,9.0,8.0,13.0,1
848,CC:2F:71:3E:C5:1F,2150965,272885847,56,6905,2150909,272878942,0,255,21781,216,16981,39,4800,64,1,92,6,0,12,144444.0,1000.0,-69.0,-70.0,-66.0,-60.0,-69.0,-69.0,-66.0,-60.0,-73.0,-81.0,-73.0,-82.0,4.0,11.0,7.0,22.0,1
849,CC:2F:71:3F:1F:24,2272215,432846885,121306,159967943,2150909,272878942,3,84189,97769123,84130,97761627,59,7496,81315,331,121335,22081,3,56,144444.0,43333.0,-68.0,-63.0,-67.0,-70.0,-66.0,-63.0,-66.0,-69.0,-73.0,-81.0,-73.0,-82.0,5.0,18.0,6.0,12.0,1
850,F8:59:71:5A:E0:3D,2181840,319870512,30927,46991166,2150913,272879346,0,22145,31607373,22087,31597674,58,9699,22008,2,30938,2391,0,16,144444.0,43333.0,-65.0,-72.0,-65.0,-69.0,-65.0,-71.0,-65.0,-69.0,-73.0,-81.0,-73.0,-82.0,8.0,9.0,8.0,13.0,1
851,CC:2F:71:3E:C5:1F,2150971,272886453,56,6905,2150915,272879548,0,255,21781,216,16981,39,4800,64,1,92,6,0,12,144444.0,1000.0,-69.0,-70.0,-66.0,-60.0,-69.0,-69.0,-66.0,-60.0,-73.0,-81.0,-73.0,-82.0,4.0,11.0,7.0,22.0,1
852,CC:2F:71:3F:1F:24,2272391,433061328,121475,160181507,2150916,272879821,3,84348,97975932,84289,97968436,59,7496,81471,331,121504,22115,3,56,130000.0,43333.0,-67.0,-63.0,-66.0,-69.0,-66.0,-63.0,-66.0,-69.0,-73.0,-81.0,-73.0,-82.0,6.0,18.0,7.0,13.0,1
853,F8:59:71:5A:E0:3D,2182343,320638231,31426,47758350,2150917,272879881,0,22262,31733494,22204,31723795,58,9699,22125,2,31437,2438,0,16,144444.0,43333.0,-65.0,-72.0,-64.0,-69.0,-65.0,-72.0,-64.0,-68.0,-73.0,-81.0,-73.0,-82.0,8.0,9.0,9.0,13.0,1
854,CC:2F:71:3E:C5:1F,2150975,272886988,56,6905,2150919,272880083,0,255,21781,216,16981,39,4800,64,1,92,6,0,12,144444.0,1000.0,-69.0,-70.0,-66.0,-60.0,-69.0,-69.0,-66.0,-60.0,-73.0,-81.0,-73.0,-82.0,4.0,11.0,7.0,22.0,1
855,CC:2F:71:3F:1F:24,2273045,433937171,122126,161057088,2150919,272880083,3,84614,98241367,84555,98233871,59,7496,81716,331,122155,22186,3,56,130000.0,39000.0,-67.0,-63.0,-66.0,-69.0,-66.0,-63.0,-66.0,-69.0,-73.0,-81.0,-73.0,-82.0,6.0,18.0,7.0,13.0,1
856,F8:59:71:5A:E0:3D,2182419,320739318,31494,47858463,2150925,272880855,0,22327,31830785,22269,31821086,58,9699,22190,2,31505,2444,0,16,144444.0,43333.0,-65.0,-72.0,-64.0,-69.0,-65.0,-71.0,-64.0,-69.0,-73.0,-81.0,-73.0,-82.0,8.0,9.0,9.0,13.0,1
857,CC:2F:71:3E:C5:1F,2150981,272887760,56,6905,2150925,272880855,0,255,21781,216,16981,39,4800,64,1,92,6,0,12,144444.0,1000.0,-69.0,-70.0,-66.0,-60.0,-69.0,-69.0,-66.0,-60.0,-73.0,-81.0,-73.0,-82.0,4.0,11.0,7.0,22.0,1
858,CC:2F:71:3F:1F:24,2273209,434143867,122284,161263012,2150925,272880855,3,84763,98449213,84704,98441717,59,7496,81858,331,122313,22233,3,56,130000.0,43333.0,-66.0,-63.0,-67.0,-70.0,-65.0,-63.0,-65.0,-69.0,-73.0,-81.0,-73.0,-82.0,7.0,18.0,6.0,12.0,1
859,F8:59:71:5A:E0:3D,2182484,320837422,31557,47956365,2150927,272881057,0,22393,31929485,22335,31919786,58,9699,22254,2,31568,2454,0,16,144444.0,43333.0,-65.0,-72.0,-65.0,-69.0,-65.0,-72.0,-64.0,-69.0,-73.0,-81.0,-73.0,-82.0,8.0,9.0,8.0,13.0,1
860,CC:2F:71:3E:C5:1F,2150983,272887962,56,6905,2150927,272881057,0,255,21781,216,16981,39,4800,64,1,92,6,0,12,144444.0,1000.0,-69.0,-70.0,-66.0,-60.0,-69.0,-69.0,-66.0,-60.0,-73.0,-81.0,-73.0,-82.0,4.0,11.0,7.0,22.0,1
861,CC:2F:71:3F:1F:24,2273370,434350053,122443,161468996,2150927,272881057,3,84915,98657397,84856,98649901,59,7496,82003,331,122472,22293,3,56,130000.0,43333.0,-67.0,-63.0,-67.0,-70.0,-66.0,-63.0,-66.0,-69.0,-73.0,-81.0,-73.0,-82.0,6.0,18.0,6.0,12.0,1
862,F8:59:71:5A:E0:3D,2182555,320937544,31621,48055821,2150934,272881723,0,22459,32028185,22401,32018486,58,9699,22318,2,31632,2468,0,16,144444.0,43333.0,-65.0,-71.0,-64.0,-69.0,-65.0,-71.0,-64.0,-69.0,-73.0,-81.0,-73.0,-82.0,8.0,10.0,9.0,13.0,1
863,CC:2F:71:3E:C5:1F,2150990,272888628,56,6905,2150934,272881723,0,255,21781,216,16981,39,4800,64,1,92,6,0,12,144444.0,1000.0,-69.0,-70.0,-66.0,-60.0,-69.0,-69.0,-66.0,-60.0,-73.0,-81.0,-73.0,-82.0,4.0,11.0,7.0,22.0,1
864,CC:2F:71:3F:1F:24,2273544,434565118,122610,161683395,2150934,272881723,3,85069,98863396,85010,98855900,59,7496,82155,331,122639,22390,3,56,117000.0,39000.0,-67.0,-63.0,-68.0,-69.0,-67.0,-63.0,-67.0,-69.0,-73.0,-81.0,-73.0,-82.0,6.0,18.0,5.0,13.0,1
865,F8:59:71:5A:E0:3D,2182620,321035648,31684,48153723,2150936,272881925,0,22522,32125205,22464,32115506,58,9699,22381,2,31695,2473,0,16,144444.0,43333.0,-66.0,-73.0,-64.0,-69.0,-65.0,-72.0,-64.0,-68.0,-73.0,-81.0,-73.0,-82.0,7.0,8.0,9.0,13.0,1
866,CC:2F:71:3E:C5:1F,2150992,272888830,56,6905,2150936,272881925,0,255,21781,216,16981,39,4800,64,1,92,6,0,12,144444.0,1000.0,-69.0,-70.0,-66.0,-60.0,-69.0,-69.0,-66.0,-60.0,-73.0,-81.0,-73.0,-82.0,4.0,11.0,7.0,22.0,1
867,CC:2F:71:3F:1F:24,2273706,434774240,122770,161892315,2150936,272881925,3,85223,99077546,85164,99070050,59,7496,82300,331,122799,22454,3,56,130000.0,43333.0,-67.0,-63.0,-67.0,-68.0,-66.0,-63.0,-66.0,-68.0,-73.0,-81.0,-73.0,-82.0,6.0,18.0,6.0,14.0,1
868,F8:59:71:5A:E0:3D,2182688,321135396,31748,48253067,2150940,272882329,0,22588,32223905,22530,32214206,58,9699,22445,2,31759,2485,0,16,144444.0,43333.0,-65.0,-72.0,-65.0,-69.0,-65.0,-72.0,-64.0,-69.0,-73.0,-81.0,-73.0,-82.0,8.0,9.0,8.0,13.0,1
869,CC:2F:71:3E:C5:1F,2150998,272889436,56,6905,2150942,272882531,0,255,21781,216,16981,39,4800,64,1,92,6,0,12,144444.0,1000.0,-69.0,-70.0,-66.0,-60.0,-69.0,-69.0,-66.0,-60.0,-73.0,-81.0,-73.0,-82.0,4.0,11.0,7.0,22.0,1
870,CC:2F:71:3F:1F:24,2273877,434983270,122927,162097829,2150950,272885441,3,85375,99287178,85316,99279682,59,7496,82444,331,122956,22491,3,56,130000.0,43333.0,-67.0,-64.0,-64.0,-69.0,-67.0,-63.0,-66.0,-68.0,-73.0,-81.0,-73.0,-82.0,6.0,17.0,9.0,13.0,1
871,F8:59:71:5A:E0:3D,2182995,321598181,32042,48712478,2150953,272885703,0,22673,32328307,22615,32318608,58,9699,22530,2,32053,2490,0,16,144444.0,43333.0,-65.0,-72.0,-66.0,-69.0,-65.0,-71.0,-64.0,-68.0,-73.0,-81.0,-73.0,-82.0,8.0,9.0,7.0,13.0,1
872,CC:2F:71:3E:C5:1F,2151009,272892608,56,6905,2150953,272885703,0,255,21781,216,16981,39,4800,64,1,92,6,0,12,144444.0,1000.0,-69.0,-70.0,-66.0,-60.0,-69.0,-69.0,-66.0,-60.0,-73.0,-81.0,-73.0,-82.0,4.0,11.0,7.0,22.0,1
873,CC:2F:71:3F:1F:24,2274040,435192676,123087,162306973,2150953,272885703,3,85531,99500218,85472,99492722,59,7496,82592,331,123116,22507,3,56,130000.0,43333.0,-68.0,-63.0,-68.0,-69.0,-66.0,-63.0,-66.0,-69.0,-73.0,-81.0,-73.0,-82.0,5.0,18.0,5.0,13.0,1
874,F8:59:71:5A:E0:3D,2183093,321737843,32136,48851736,2150957,272886107,0,22745,32432867,22687,32423168,58,9699,22602,2,32147,2520,0,16,144444.0,43333.0,-64.0,-72.0,-63.0,-69.0,-65.0,-72.0,-64.0,-69.0,-73.0,-81.0,-73.0,-82.0,9.0,9.0,10.0,13.0,1
875,CC:2F:71:3E:C5:1F,2151013,272893012,56,6905,2150957,272886107,0,255,21781,216,16981,39,4800,64,1,92,6,0,12,144444.0,1000.0,-69.0,-70.0,-66.0,-60.0,-69.0,-69.0,-66.0,-60.0,-73.0,-81.0,-73.0,-82.0,4.0,11.0,7.0,22.0,1
876,CC:2F:71:3F:1F:24,2274208,435402627,123251,162516520,2150957,272886107,3,85688,99708073,85629,99700577,59,7496,82741,331,123280,22521,3,56,130000.0,43333.0,-67.0,-64.0,-67.0,-69.0,-66.0,-63.0,-66.0,-68.0,-73.0,-81.0,-73.0,-82.0,6.0,17.0,6.0,13.0,1
877,F8:59:71:5A:E0:3D,2183164,321836723,32203,48950212,2150961,272886511,0,22812,32532235,22754,32522536,58,9699,22669,2,32214,2532,0,16,144444.0,43333.0,-65.0,-72.0,-66.0,-68.0,-65.0,-72.0,-64.0,-68.0,-73.0,-81.0,-73.0,-82.0,8.0,9.0,7.0,14.0,1
878,CC:2F:71:3E:C5:1F,2151017,272893416,56,6905,2150961,272886511,0,255,21781,216,16981,39,4800,64,1,92,6,0,12,144444.0,1000.0,-69.0,-70.0,-66.0,-60.0,-69.0,-69.0,-66.0,-60.0,-73.0,-81.0,-73.0,-82.0,4.0,11.0,7.0,22.0,1
879,CC:2F:71:3F:1F:24,2274369,435606075,123408,162719564,2150961,272886511,3,85840,99914923,85781,99907427,59,7496,82883,331,123436,22547,3,56,144444.0,43333.0,-68.0,-63.0,-68.0,-68.0,-67.0,-63.0,-67.0,-68.0,-73.0,-81.0,-73.0,-82.0,5.0,18.0,5.0,14.0,1
880,F8:59:71:5A:E0:3D,2183229,321933333,32265,49046560,2150964,272886773,0,22875,32629255,22817,32619556,58,9699,22732,2,32276,2540,0,16,144444.0,43333.0,-66.0,-73.0,-64.0,-69.0,-65.0,-71.0,-64.0,-68.0,-73.0,-81.0,-73.0,-82.0,7.0,8.0,9.0,13.0,1
881,CC:2F:71:3E:C5:1F,2151022,272893880,56,6905,2150966,272886975,0,255,21781,216,16981,39,4800,64,1,92,6,0,12,144444.0,1000.0,-69.0,-70.0,-66.0,-60.0,-69.0,-69.0,-66.0,-60.0,-73.0,-81.0,-73.0,-82.0,4.0,11.0,7.0,22.0,1
882,CC:2F:71:3F:1F:24,2274549,435831914,123583,162944939,2150966,272886975,3,86015,100151720,85956,100144224,59,7496,83046,331,123612,22589,3,56,144444.0,43333.0,-67.0,-63.0,-66.0,-68.0,-66.0,-63.0,-65.0,-68.0,-73.0,-81.0,-73.0,-82.0,6.0,18.0,7.0,14.0,1
883,F8:59:71:5A:E0:3D,2183312,322043832,32342,49156453,2150970,272887379,0,22949,32739310,22891,32729611,58,9699,22806,2,32353,2548,0,16,144444.0,43333.0,-65.0,-72.0,-65.0,-69.0,-65.0,-71.0,-64.0,-69.0,-73.0,-81.0,-73.0,-82.0,8.0,9.0,8.0,13.0,1
884,CC:2F:71:3E:C5:1F,2151026,272894284,56,6905,2150970,272887379,0,255,21781,216,16981,39,4800,64,1,92,6,0,12,144444.0,1000.0,-69.0,-70.0,-66.0,-60.0,-69.0,-69.0,-66.0,-60.0,-73.0,-81.0,-73.0,-82.0,4.0,11.0,7.0,22.0,1
885,CC:2F:71:3F:1F:24,2274710,436038112,123740,163150733,2150970,272887379,3,86163,100355150,86104,100347654,59,7496,83189,331,123769,22634,3,56,117000.0,39000.0,-65.0,-64.0,-68.0,-70.0,-66.0,-63.0,-66.0,-69.0,-73.0,-81.0,-73.0,-82.0,8.0,17.0,5.0,12.0,1
886,F8:59:71:5A:E0:3D,2183379,322147950,32409,49260571,2150970,272887379,0,23016,32842490,22958,32832791,58,9699,22873,2,32420,2553,0,16,144444.0,43333.0,-64.0,-71.0,-65.0,-68.0,-64.0,-71.0,-65.0,-68.0,-73.0,-81.0,-73.0,-82.0,9.0,10.0,8.0,14.0,1
887,CC:2F:71:3E:C5:1F,2151030,272894688,56,6905,2150974,272887783,0,257,21921,218,17121,39,4800,64,1,93,6,0,12,144444.0,1000.0,-69.0,-70.0,-65.0,-60.0,-69.0,-69.0,-65.0,-60.0,-73.0,-81.0,-73.0,-82.0,4.0,11.0,8.0,22.0,1
888,CC:2F:71:3F:1F:24,2275603,437288819,124628,164400976,2150975,272887843,3,86416,100588633,86357,100581137,59,7496,83439,331,124657,22828,3,56,144444.0,43333.0,-66.0,-63.0,-66.0,-68.0,-66.0,-63.0,-66.0,-68.0,-73.0,-81.0,-73.0,-82.0,7.0,18.0,7.0,14.0,1
889,F8:59:71:5A:E0:3D,2183451,322246720,32472,49358473,2150979,272888247,0,23079,32939510,23021,32929811,58,9699,22936,2,32483,2556,0,16,144444.0,43333.0,-65.0,-72.0,-66.0,-69.0,-65.0,-71.0,-64.0,-68.0,-73.0,-81.0,-73.0,-82.0,8.0,9.0,7.0,13.0,1
890,CC:2F:71:3E:C5:1F,2151035,272895152,56,6905,2150979,272888247,0,257,21921,218,17121,39,4800,64,1,93,6,0,12,144444.0,1000.0,-69.0,-70.0,-65.0,-60.0,-69.0,-69.0,-65.0,-60.0,-73.0,-81.0,-73.0,-82.0,4.0,11.0,8.0,22.0,1
891,CC:2F:71:3F:1F:24,2275782,437499218,124803,164610971,2150979,272888247,3,86576,100797684,86517,100790188,59,7496,83591,331,124832,22855,3,56,144444.0,43333.0,-65.0,-63.0,-67.0,-69.0,-66.0,-63.0,-66.0,-68.0,-73.0,-81.0,-73.0,-82.0,8.0,18.0,6.0,13.0,1
892,F8:59:71:5A:E0:3D,2183514,322343184,32535,49454937,2150979,272888247,0,23141,33034990,23083,33025291,58,9699,22998,2,32546,2562,0,16,144444.0,43333.0,-65.0,-72.0,-64.0,-69.0,-64.0,-72.0,-64.0,-68.0,-73.0,-81.0,-73.0,-82.0,8.0,9.0,9.0,13.0,1
893,CC:2F:71:3E:C5:1F,2151036,272895268,57,7021,2150979,272888247,0,259,22061,220,17261,39,4800,64,1,94,6,0,12,144444.0,39000.0,-69.0,-70.0,-66.0,-60.0,-69.0,-69.0,-65.0,-60.0,-73.0,-81.0,-73.0,-82.0,4.0,11.0,7.0,22.0,1
894,CC:2F:71:3F:1F:24,2275941,437703203,124961,164814683,2150980,272888520,3,86725,100996983,86666,100989487,59,7496,83736,331,124990,22883,3,56,144444.0,43333.0,-67.0,-63.0,-67.0,-69.0,-67.0,-63.0,-66.0,-68.0,-73.0,-81.0,-73.0,-82.0,6.0,18.0,6.0,13.0,1
895,F8:59:71:5A:E0:3D,2183586,322443649,32600,49554523,2150986,272889126,0,23207,33135606,23149,33125907,58,9699,23064,2,32609,2563,0,16,144444.0,43333.0,-64.0,-72.0,-66.0,-69.0,-65.0,-72.0,-64.0,-69.0,-73.0,-81.0,-73.0,-82.0,9.0,9.0,7.0,13.0,1
896,CC:2F:71:3E:C5:1F,2151046,272896409,57,7021,2150989,272889388,0,259,22061,220,17261,39,4800,64,1,94,6,0,12,144444.0,39000.0,-69.0,-70.0,-66.0,-60.0,-69.0,-69.0,-65.0,-60.0,-73.0,-81.0,-73.0,-82.0,4.0,11.0,7.0,22.0,1
897,CC:2F:71:3F:1F:24,2276113,437916289,125124,165026901,2150989,272889388,3,86880,101208345,86821,101200849,59,7496,83886,331,125152,22928,3,56,144444.0,43333.0,-66.0,-64.0,-66.0,-70.0,-66.0,-63.0,-66.0,-69.0,-73.0,-81.0,-73.0,-82.0,7.0,17.0,7.0,12.0,1
898,F8:59:71:5A:E0:3D,2183772,322729340,32783,49839952,2150989,272889388,0,23282,33235442,23224,33225743,58,9699,23139,2,32794,2566,0,16,144444.0,43333.0,-65.0,-73.0,-64.0,-69.0,-65.0,-72.0,-64.0,-68.0,-73.0,-81.0,-73.0,-82.0,8.0,8.0,9.0,13.0,1
899,CC:2F:71:3E:C5:1F,2151046,272896409,57,7021,2150989,272889388,0,259,22061,220,17261,39,4800,64,1,94,6,0,12,144444.0,39000.0,-69.0,-70.0,-66.0,-60.0,-69.0,-69.0,-65.0,-60.0,-73.0,-81.0,-73.0,-82.0,4.0,11.0,7.0,22.0,1
900,CC:2F:71:3F:1F:24,2276268,438118807,125279,165229419,2150989,272889388,3,87029,101414909,86970,101407413,59,7496,84027,331,125308,23002,3,56,130000.0,43333.0,-67.0,-64.0,-67.0,-69.0,-66.0,-64.0,-65.0,-68.0,-73.0,-81.0,-73.0,-82.0,6.0,17.0,6.0,13.0,1
901,F8:59:71:5A:E0:3D,2184032,323123163,33037,50233169,2150995,272889994,0,23365,33336715,23307,33327016,58,9699,23222,2,33048,2571,0,16,144444.0,43333.0,-65.0,-72.0,-65.0,-69.0,-64.0,-72.0,-64.0,-69.0,-73.0,-81.0,-73.0,-82.0,8.0,9.0,8.0,13.0,1
902,CC:2F:71:3E:C5:1F,2151052,272897015,57,7021,2150995,272889994,0,259,22061,220,17261,39,4800,64,1,94,6,0,12,144444.0,39000.0,-69.0,-70.0,-66.0,-60.0,-69.0,-69.0,-65.0,-60.0,-73.0,-81.0,-73.0,-82.0,4.0,11.0,7.0,22.0,1
903,CC:2F:71:3F:1F:24,2276452,438330091,125457,165440097,2150995,272889994,3,87194,101623253,87135,101615757,59,7496,84185,331,125486,23023,3,56,130000.0,43333.0,-68.0,-64.0,-69.0,-68.0,-66.0,-63.0,-65.0,-68.0,-73.0,-81.0,-73.0,-82.0,5.0,17.0,4.0,14.0,1
904,F8:59:71:5A:E0:3D,2184099,323222881,33101,50332625,2150998,272890256,0,23429,33435275,23371,33425576,58,9699,23286,2,33112,2581,0,16,144444.0,43333.0,-65.0,-72.0,-66.0,-69.0,-64.0,-71.0,-64.0,-68.0,-73.0,-81.0,-73.0,-82.0,8.0,9.0,7.0,13.0,1
905,CC:2F:71:3E:C5:1F,2151055,272897277,57,7021,2150998,272890256,0,259,22061,220,17261,39,4800,64,1,94,6,0,12,144444.0,39000.0,-69.0,-70.0,-66.0,-60.0,-69.0,-69.0,-65.0,-60.0,-73.0,-81.0,-73.0,-82.0,4.0,11.0,7.0,22.0,1
906,CC:2F:71:3F:1F:24,2276621,438546269,125623,165656013,2150998,272890256,3,87358,101841533,87299,101834037,59,7496,84339,331,125650,23073,3,56,130000.0,43333.0,-67.0,-64.0,-68.0,-69.0,-66.0,-64.0,-66.0,-68.0,-73.0,-81.0,-73.0,-82.0,6.0,17.0,5.0,13.0,1
907,F8:59:71:5A:E0:3D,2184167,323322741,33165,50432081,2151002,272890660,0,23492,33532295,23434,33522596,58,9699,23349,2,33175,2586,0,16,144444.0,43333.0,-65.0,-72.0,-66.0,-69.0,-65.0,-72.0,-64.0,-69.0,-73.0,-81.0,-73.0,-82.0,8.0,9.0,7.0,13.0,1
908,CC:2F:71:3E:C5:1F,2151061,272897883,57,7021,2151004,272890862,0,259,22061,220,17261,39,4800,64,1,94,6,0,12,144444.0,39000.0,-69.0,-70.0,-66.0,-60.0,-69.0,-69.0,-65.0,-60.0,-73.0,-81.0,-73.0,-82.0,4.0,11.0,7.0,22.0,1
909,CC:2F:71:3F:1F:24,2276783,438749467,125779,165858605,2151004,272890862,3,87507,102049393,87448,102041897,59,7496,84480,331,125808,23115,3,56,130000.0,39000.0,-68.0,-64.0,-68.0,-68.0,-66.0,-64.0,-66.0,-68.0,-73.0,-81.0,-73.0,-82.0,5.0,17.0,5.0,14.0,1
910,F8:59:71:5A:E0:3D,2184233,323419493,33227,50528429,2151006,272891064,0,23555,33629315,23497,33619616,58,9699,23412,2,33238,2595,0,16,144444.0,43333.0,-65.0,-72.0,-64.0,-69.0,-65.0,-72.0,-64.0,-69.0,-73.0,-81.0,-73.0,-82.0,8.0,9.0,9.0,13.0,1
911,CC:2F:71:3E:C5:1F,2151063,272898085,57,7021,2151006,272891064,0,259,22061,220,17261,39,4800,64,1,94,6,0,12,144444.0,39000.0,-69.0,-70.0,-66.0,-60.0,-69.0,-69.0,-65.0,-60.0,-73.0,-81.0,-73.0,-82.0,4.0,11.0,7.0,22.0,1
912,CC:2F:71:3F:1F:24,2276943,438955817,125937,166064753,2151006,272891064,3,87654,102251283,87595,102243787,59,7496,84622,331,125964,23127,3,56,130000.0,43333.0,-67.0,-64.0,-67.0,-69.0,-66.0,-63.0,-66.0,-68.0,-73.0,-81.0,-73.0,-82.0,6.0,17.0,6.0,13.0,1
913,F8:59:71:5A:E0:3D,2184308,323518908,33297,50627380,2151011,272891528,0,23623,33728939,23565,33719240,58,9699,23480,2,33308,2599,0,16,144444.0,43333.0,-64.0,-71.0,-66.0,-69.0,-65.0,-71.0,-64.0,-69.0,-73.0,-81.0,-73.0,-82.0,9.0,10.0,7.0,13.0,1
914,CC:2F:71:3E:C5:1F,2151068,272898549,57,7021,2151011,272891528,0,259,22061,220,17261,39,4800,64,1,94,6,0,12,144444.0,39000.0,-69.0,-70.0,-66.0,-60.0,-69.0,-69.0,-65.0,-60.0,-73.0,-81.0,-73.0,-82.0,4.0,11.0,7.0,22.0,1
915,CC:2F:71:3F:1F:24,2277623,439877037,126612,166985509,2151011,272891528,3,87905,102486732,87846,102479236,59,7496,84865,331,126641,23301,3,56,130000.0,43333.0,-67.0,-63.0,-67.0,-70.0,-66.0,-63.0,-67.0,-69.0,-73.0,-81.0,-73.0,-82.0,6.0,18.0,6.0,12.0,1
916,F8:59:71:5A:E0:3D,2184508,323812901,33493,50920969,2151015,272891932,0,23708,33841277,23650,33831578,58,9699,23565,2,33504,2638,0,16,144444.0,43333.0,-66.0,-72.0,-64.0,-69.0,-64.0,-71.0,-65.0,-69.0,-73.0,-81.0,-73.0,-82.0,7.0,9.0,9.0,13.0,1
917,CC:2F:71:3E:C5:1F,2151072,272898953,57,7021,2151015,272891932,0,259,22061,220,17261,39,4800,64,1,94,6,0,12,144444.0,39000.0,-69.0,-70.0,-66.0,-60.0,-69.0,-69.0,-65.0,-60.0,-73.0,-81.0,-73.0,-82.0,4.0,11.0,7.0,22.0,1
918,CC:2F:71:3F:1F:24,2277790,440081533,126775,167189601,2151015,272891932,3,88055,102688353,87996,102680857,59,7496,85012,331,126804,23349,3,56,130000.0,43333.0,-67.0,-63.0,-67.0,-69.0,-67.0,-63.0,-66.0,-69.0,-73.0,-81.0,-73.0,-82.0,6.0,18.0,6.0,13.0,1
919,F8:59:71:5A:E0:3D,2184574,323909661,33555,51017317,2151019,272892344,0,23772,33937079,23712,33927058,60,10021,23629,2,33566,2646,0,16,144444.0,43333.0,-65.0,-72.0,-64.0,-69.0,-65.0,-72.0,-64.0,-69.0,-73.0,-81.0,-73.0,-82.0,8.0,9.0,9.0,13.0,1
920,CC:2F:71:3E:C5:1F,2151076,272899365,57,7021,2151019,272892344,0,259,22061,220,17261,39,4800,64,1,94,6,0,12,144444.0,39000.0,-69.0,-70.0,-66.0,-60.0,-69.0,-69.0,-65.0,-60.0,-73.0,-81.0,-73.0,-82.0,4.0,11.0,7.0,22.0,1
921,CC:2F:71:3F:1F:24,2277960,440291762,126939,167399216,2151021,272892546,3,88208,102894271,88149,102886775,59,7496,85159,331,126966,23379,3,56,130000.0,39000.0,-67.0,-64.0,-67.0,-70.0,-66.0,-63.0,-66.0,-69.0,-73.0,-81.0,-73.0,-82.0,6.0,17.0,6.0,12.0,1
922,F8:59:71:5A:E0:3D,2184649,324010306,33622,51117234,2151027,272893072,0,23840,34036505,23779,34026366,61,10139,23697,2,33633,2655,0,16,144444.0,43333.0,-65.0,-72.0,-63.0,-69.0,-64.0,-72.0,-64.0,-69.0,-73.0,-81.0,-73.0,-82.0,8.0,9.0,10.0,13.0,1
923,CC:2F:71:3E:C5:1F,2151084,272900093,57,7021,2151027,272893072,0,259,22061,220,17261,39,4800,64,1,94,6,0,12,144444.0,39000.0,-69.0,-70.0,-66.0,-60.0,-69.0,-69.0,-65.0,-60.0,-73.0,-81.0,-73.0,-82.0,4.0,11.0,7.0,22.0,1
924,CC:2F:71:3F:1F:24,2278121,440494878,127094,167601806,2151027,272893072,3,88358,103100823,88299,103093327,59,7496,85301,331,127123,23429,3,56,130000.0,43333.0,-67.0,-63.0,-67.0,-68.0,-66.0,-63.0,-66.0,-69.0,-73.0,-81.0,-73.0,-82.0,6.0,18.0,6.0,14.0,1
925,F8:59:71:5A:E0:3D,2184713,324108270,33685,51215136,2151028,272893134,0,23903,34133525,23842,34123386,61,10139,23760,2,33696,2661,0,16,144444.0,43333.0,-65.0,-72.0,-65.0,-69.0,-64.0,-72.0,-64.0,-68.0,-73.0,-81.0,-73.0,-82.0,8.0,9.0,8.0,13.0,1
926,CC:2F:71:3E:C5:1F,2151087,272900357,57,7021,2151030,272893336,0,259,22061,220,17261,39,4800,64,1,94,6,0,12,144444.0,39000.0,-69.0,-70.0,-66.0,-60.0,-69.0,-69.0,-65.0,-60.0,-73.0,-81.0,-73.0,-82.0,4.0,11.0,7.0,22.0,1
927,CC:2F:71:3F:1F:24,2278280,440698142,127250,167804806,2151030,272893336,3,88509,103307479,88449,103299865,60,7614,85445,331,127279,23449,3,56,130000.0,43333.0,-67.0,-64.0,-67.0,-70.0,-66.0,-63.0,-67.0,-69.0,-73.0,-81.0,-73.0,-82.0,6.0,17.0,6.0,12.0,1
928,F8:59:71:5A:E0:3D,2184785,324207042,33748,51313038,2151037,272894004,0,23966,34230545,23905,34220406,61,10139,23823,2,33759,2667,0,16,144444.0,43333.0,-65.0,-72.0,-64.0,-69.0,-64.0,-72.0,-64.0,-69.0,-73.0,-81.0,-73.0,-82.0,8.0,9.0,9.0,13.0,1
929,CC:2F:71:3E:C5:1F,2151094,272901025,57,7021,2151037,272894004,0,261,22249,221,17331,40,4918,65,1,94,6,0,12,144444.0,39000.0,-70.0,-70.0,-65.0,-60.0,-69.0,-70.0,-65.0,-60.0,-73.0,-81.0,-73.0,-82.0,3.0,11.0,8.0,22.0,1
930,CC:2F:71:3F:1F:24,2278462,440913391,127425,168019387,2151037,272894004,3,88674,103521674,88614,103514060,60,7614,85602,331,127452,23477,3,56,130000.0,43333.0,-67.0,-63.0,-67.0,-69.0,-66.0,-63.0,-66.0,-69.0,-73.0,-81.0,-73.0,-82.0,6.0,18.0,6.0,13.0,1
931,F8:59:71:5A:E0:3D,2184849,324305004,33811,51410940,2151038,272894064,0,24029,34327565,23968,34317426,61,10139,23886,2,33822,2673,0,16,144444.0,43333.0,-65.0,-72.0,-64.0,-69.0,-64.0,-72.0,-64.0,-69.0,-73.0,-81.0,-73.0,-82.0,8.0,9.0,9.0,13.0,1
932,CC:2F:71:3E:C5:1F,2151095,272901085,57,7021,2151038,272894064,0,261,22249,221,17331,40,4918,65,1,94,6,0,12,144444.0,39000.0,-70.0,-70.0,-65.0,-60.0,-69.0,-70.0,-65.0,-60.0,-73.0,-81.0,-73.0,-82.0,3.0,11.0,8.0,22.0,1
933,CC:2F:71:3F:1F:24,2278620,441118645,127582,168224581,2151038,272894064,3,88823,103726630,88763,103719016,60,7614,85747,331,127611,23568,3,56,130000.0,39000.0,-67.0,-63.0,-67.0,-69.0,-66.0,-63.0,-65.0,-69.0,-73.0,-81.0,-73.0,-82.0,6.0,18.0,6.0,13.0,1
934,F8:59:71:5A:E0:3D,2184918,324403512,33874,51508842,2151044,272894670,0,24092,34424585,24031,34414446,61,10139,23949,2,33885,2677,0,16,144444.0,43333.0,-65.0,-71.0,-64.0,-69.0,-65.0,-72.0,-64.0,-69.0,-73.0,-81.0,-73.0,-82.0,8.0,10.0,9.0,13.0,1
935,CC:2F:71:3E:C5:1F,2151103,272901893,57,7021,2151046,272894872,0,261,22249,221,17331,40,4918,65,1,94,6,0,12,144444.0,39000.0,-70.0,-70.0,-65.0,-60.0,-69.0,-70.0,-65.0,-60.0,-73.0,-81.0,-73.0,-82.0,3.0,11.0,8.0,22.0,1
936,CC:2F:71:3F:1F:24,2279152,441845747,128106,168950875,2151046,272894872,3,89031,103951223,88971,103943609,60,7614,85945,331,128135,23709,3,56,130000.0,43333.0,-67.0,-64.0,-67.0,-68.0,-66.0,-63.0,-66.0,-68.0,-73.0,-81.0,-73.0,-82.0,6.0,17.0,6.0,14.0,1
937,F8:59:71:5A:E0:3D,2184986,324503391,33939,51608246,2151047,272895145,0,24158,34524791,24097,34514652,61,10139,24015,2,33950,2681,0,16,144444.0,43333.0,-64.0,-72.0,-65.0,-69.0,-64.0,-72.0,-65.0,-69.0,-73.0,-81.0,-73.0,-82.0,9.0,9.0,8.0,13.0,1
938,CC:2F:71:3E:C5:1F,2151104,272902166,57,7021,2151047,272895145,0,261,22249,221,17331,40,4918,65,1,94,6,0,12,144444.0,39000.0,-70.0,-70.0,-65.0,-60.0,-69.0,-70.0,-65.0,-60.0,-73.0,-81.0,-73.0,-82.0,3.0,11.0,8.0,22.0,1
939,CC:2F:71:3F:1F:24,2279471,442268542,128424,169373397,2151047,272895145,3,89223,104169544,89163,104161930,60,7614,86129,331,128453,23734,3,56,130000.0,43333.0,-67.0,-63.0,-67.0,-67.0,-66.0,-63.0,-66.0,-67.0,-73.0,-81.0,-73.0,-82.0,6.0,18.0,6.0,15.0,1
940,F8:59:71:5A:E0:3D,2185179,324796126,34127,51900517,2151052,272895609,0,24236,34625375,24175,34615236,61,10139,24093,2,34138,2685,0,16,144444.0,43333.0,-65.0,-72.0,-65.0,-69.0,-64.0,-72.0,-65.0,-69.0,-73.0,-81.0,-73.0,-82.0,8.0,9.0,8.0,13.0,1
941,CC:2F:71:3E:C5:1F,2151111,272902832,57,7021,2151054,272895811,0,261,22249,221,17331,40,4918,65,1,94,6,0,12,144444.0,39000.0,-70.0,-70.0,-65.0,-60.0,-69.0,-70.0,-65.0,-60.0,-73.0,-81.0,-73.0,-82.0,3.0,11.0,8.0,22.0,1
942,CC:2F:71:3F:1F:24,2279665,442483121,128611,169587310,2151054,272895811,3,89402,104383336,89342,104375722,60,7614,86304,331,128640,23755,3,56,144444.0,43333.0,-67.0,-63.0,-68.0,-68.0,-66.0,-63.0,-66.0,-68.0,-73.0,-81.0,-73.0,-82.0,6.0,18.0,5.0,14.0,1
943,F8:59:71:5A:E0:3D,2185245,324892878,34189,51996865,2151056,272896013,0,24298,34720855,24237,34710716,61,10139,24155,2,34200,2687,0,16,144444.0,43333.0,-65.0,-72.0,-64.0,-69.0,-64.0,-71.0,-64.0,-69.0,-73.0,-81.0,-73.0,-82.0,8.0,9.0,9.0,13.0,1
944,CC:2F:71:3E:C5:1F,2151113,272903034,57,7021,2151056,272896013,0,261,22249,221,17331,40,4918,65,1,94,6,0,12,144444.0,39000.0,-70.0,-70.0,-65.0,-60.0,-69.0,-70.0,-65.0,-60.0,-73.0,-81.0,-73.0,-82.0,3.0,11.0,8.0,22.0,1
945,CC:2F:71:3F:1F:24,2279827,442692595,128771,169796582,2151056,272896013,3,89556,104596048,89496,104588434,60,7614,86450,331,128800,23784,3,56,130000.0,43333.0,-65.0,-63.0,-65.0,-68.0,-66.0,-63.0,-66.0,-68.0,-73.0,-81.0,-73.0,-82.0,8.0,18.0,8.0,14.0,1
946,F8:59:71:5A:E0:3D,2185527,325304325,34467,52407908,2151060,272896417,0,24403,34833528,24342,34823389,61,10139,24260,2,34478,2690,0,16,144444.0,43333.0,-66.0,-73.0,-64.0,-69.0,-65.0,-72.0,-64.0,-68.0,-73.0,-81.0,-73.0,-82.0,7.0,8.0,9.0,13.0,1
947,CC:2F:71:3E:C5:1F,2151117,272903438,57,7021,2151060,272896417,0,261,22249,221,17331,40,4918,65,1,94,6,0,12,144444.0,39000.0,-70.0,-70.0,-65.0,-60.0,-69.0,-70.0,-65.0,-60.0,-73.0,-81.0,-73.0,-82.0,3.0,11.0,8.0,22.0,1
948,CC:2F:71:3F:1F:24,2280002,442902600,128942,170006183,2151060,272896417,3,89719,104807314,89659,104799700,60,7614,86603,331,128971,23803,3,56,144444.0,43333.0,-68.0,-63.0,-67.0,-67.0,-67.0,-63.0,-66.0,-68.0,-73.0,-81.0,-73.0,-82.0,5.0,18.0,6.0,15.0,1
949,F8:59:71:5A:E0:3D,2185595,325402691,34530,52505810,2151065,272896881,0,24466,34930548,24405,34920409,61,10139,24323,2,34541,2693,0,16,144444.0,43333.0,-64.0,-71.0,-65.0,-69.0,-64.0,-71.0,-64.0,-69.0,-73.0,-81.0,-73.0,-82.0,9.0,10.0,8.0,13.0,1
950,CC:2F:71:3E:C5:1F,2151122,272903902,57,7021,2151065,272896881,0,261,22249,221,17331,40,4918,65,1,94,6,0,12,144444.0,39000.0,-70.0,-70.0,-65.0,-60.0,-69.0,-70.0,-65.0,-60.0,-73.0,-81.0,-73.0,-82.0,3.0,11.0,8.0,22.0,1
951,CC:2F:71:3F:1F:24,2280164,443109154,129099,170212273,2151065,272896881,3,89866,105012066,89806,105004452,60,7614,86744,331,129126,23818,3,56,144444.0,43333.0,-67.0,-63.0,-67.0,-67.0,-66.0,-63.0,-66.0,-68.0,-73.0,-81.0,-73.0,-82.0,6.0,18.0,6.0,15.0,1
952,F8:59:71:5A:E0:3D,2185660,325500795,34593,52603712,2151067,272897083,0,24528,35026028,24467,35015889,61,10139,24385,2,34604,2696,0,16,144444.0,43333.0,-65.0,-72.0,-65.0,-69.0,-64.0,-72.0,-64.0,-69.0,-73.0,-81.0,-73.0,-82.0,8.0,9.0,8.0,13.0,1
953,CC:2F:71:3E:C5:1F,2151124,272904104,57,7021,2151067,272897083,0,261,22249,221,17331,40,4918,65,1,94,6,0,12,144444.0,39000.0,-70.0,-70.0,-65.0,-60.0,-69.0,-70.0,-65.0,-60.0,-73.0,-81.0,-73.0,-82.0,3.0,11.0,8.0,22.0,1
954,CC:2F:71:3F:1F:24,2280352,443322411,129283,170425126,2151069,272897285,3,90043,105222227,89983,105214613,60,7614,86916,331,129312,23830,3,56,144444.0,43333.0,-64.0,-63.0,-66.0,-68.0,-66.0,-63.0,-66.0,-68.0,-73.0,-81.0,-73.0,-82.0,9.0,18.0,7.0,14.0,1
955,F8:59:71:5A:E0:3D,2185730,325600857,34657,52703168,2151073,272897689,0,24592,35124588,24531,35114449,61,10139,24449,2,34668,2700,0,16,144444.0,43333.0,-64.0,-71.0,-65.0,-69.0,-64.0,-72.0,-64.0,-69.0,-73.0,-81.0,-73.0,-82.0,9.0,10.0,8.0,13.0,1
956,CC:2F:71:3E:C5:1F,2151131,272904770,57,7021,2151074,272897749,0,261,22249,221,17331,40,4918,65,1,94,6,0,12,144444.0,39000.0,-70.0,-70.0,-65.0,-60.0,-69.0,-70.0,-65.0,-60.0,-73.0,-81.0,-73.0,-82.0,3.0,11.0,8.0,22.0,1
957,CC:2F:71:3F:1F:24,2280516,443531961,129442,170634212,2151074,272897749,3,90191,105427123,90131,105419509,60,7614,87060,331,129469,23851,3,57,144444.0,43333.0,-68.0,-63.0,-68.0,-68.0,-66.0,-63.0,-66.0,-68.0,-73.0,-81.0,-73.0,-82.0,5.0,18.0,5.0,14.0,1
958,F8:59:71:5A:E0:3D,2185824,325738368,34748,52840417,2151076,272897951,0,24662,35225702,24601,35215563,61,10139,24519,2,34759,2700,0,16,144444.0,43333.0,-65.0,-72.0,-64.0,-69.0,-64.0,-72.0,-64.0,-69.0,-73.0,-81.0,-73.0,-82.0,8.0,9.0,9.0,13.0,1
959,CC:2F:71:3E:C5:1F,2151133,272904972,57,7021,2151076,272897951,0,261,22249,221,17331,40,4918,65,1,94,6,0,12,144444.0,39000.0,-70.0,-70.0,-65.0,-60.0,-69.0,-70.0,-65.0,-60.0,-73.0,-81.0,-73.0,-82.0,3.0,11.0,8.0,22.0,1
960,CC:2F:71:3F:1F:24,2280676,443738383,129600,170840432,2151076,272897951,3,90339,105629129,90279,105621515,60,7614,87203,331,129629,23885,3,57,144444.0,43333.0,-67.0,-63.0,-65.0,-68.0,-66.0,-63.0,-66.0,-68.0,-73.0,-81.0,-73.0,-82.0,6.0,18.0,8.0,14.0,1
961,F8:59:71:5A:E0:3D,2185968,325951531,34886,53052974,2151082,272898557,0,24737,35330340,24676,35320201,61,10139,24594,2,34897,2706,0,16,144444.0,43333.0,-64.0,-72.0,-65.0,-69.0,-64.0,-72.0,-64.0,-69.0,-73.0,-81.0,-73.0,-82.0,9.0,9.0,8.0,13.0,1
962,CC:2F:71:3E:C5:1F,2151139,272905578,57,7021,2151082,272898557,0,261,22249,221,17331,40,4918,65,1,94,6,0,12,144444.0,39000.0,-70.0,-70.0,-65.0,-60.0,-69.0,-70.0,-65.0,-60.0,-73.0,-81.0,-73.0,-82.0,3.0,11.0,8.0,22.0,1
963,CC:2F:71:3F:1F:24,2281273,444543749,130191,171645192,2151082,272898557,3,90590,105867601,90530,105859987,60,7614,87435,331,130220,23935,3,57,144444.0,43333.0,-67.0,-63.0,-67.0,-68.0,-66.0,-63.0,-67.0,-67.0,-73.0,-81.0,-73.0,-82.0,6.0,18.0,6.0,14.0,1
964,F8:59:71:5A:E0:3D,2186038,326051710,34953,53152891,2151085,272898819,0,24806,35432728,24745,35422589,61,10139,24663,2,34964,2709,0,16,144444.0,43333.0,-65.0,-72.0,-65.0,-69.0,-65.0,-72.0,-64.0,-69.0,-73.0,-81.0,-73.0,-82.0,8.0,9.0,8.0,13.0,1
965,CC:2F:71:3E:C5:1F,2151142,272905840,57,7021,2151085,272898819,0,261,22249,221,17331,40,4918,65,1,94,6,0,12,144444.0,39000.0,-70.0,-70.0,-65.0,-60.0,-69.0,-70.0,-65.0,-60.0,-73.0,-81.0,-73.0,-82.0,3.0,11.0,8.0,22.0,1
966,CC:2F:71:3F:1F:24,2281447,444760279,130362,171861460,2151085,272898819,3,90753,106079071,90693,106071457,60,7614,87594,331,130391,23951,3,57,144444.0,43333.0,-67.0,-63.0,-68.0,-68.0,-67.0,-63.0,-67.0,-68.0,-73.0,-81.0,-73.0,-82.0,6.0,18.0,5.0,14.0,1
967,F8:59:71:5A:E0:3D,2186113,326155338,35022,53255913,2151091,272899425,0,24875,35536610,24814,35526471,61,10139,24732,2,35033,2715,0,16,144444.0,43333.0,-63.0,-72.0,-64.0,-69.0,-64.0,-72.0,-64.0,-69.0,-73.0,-81.0,-73.0,-82.0,10.0,9.0,9.0,13.0,1
968,CC:2F:71:3E:C5:1F,2151148,272906446,57,7021,2151091,272899425,0,261,22249,221,17331,40,4918,65,1,94,6,0,12,144444.0,39000.0,-70.0,-70.0,-65.0,-60.0,-69.0,-70.0,-65.0,-60.0,-73.0,-81.0,-73.0,-82.0,3.0,11.0,8.0,22.0,1
969,CC:2F:71:3F:1F:24,2281670,444990750,130579,172091325,2151091,272899425,3,90963,106307121,90903,106299507,60,7614,87799,331,130608,23978,3,57,144444.0,43333.0,-67.0,-63.0,-67.0,-68.0,-66.0,-63.0,-65.0,-68.0,-73.0,-81.0,-73.0,-82.0,6.0,18.0,6.0,14.0,1
970,F8:59:71:5A:E0:3D,2186177,326254794,35086,53355369,2151091,272899425,0,24939,35635170,24878,35625031,61,10139,24796,2,35097,2719,0,16,144444.0,43333.0,-65.0,-72.0,-65.0,-70.0,-65.0,-72.0,-64.0,-69.0,-73.0,-81.0,-73.0,-82.0,8.0,9.0,8.0,12.0,1
971,CC:2F:71:3E:C5:1F,2151150,272906648,57,7021,2151093,272899627,0,262,22319,222,17401,40,4918,65,1,95,6,0,12,144444.0,39000.0,-69.0,-69.0,-66.0,-60.0,-69.0,-69.0,-65.0,-60.0,-73.0,-81.0,-73.0,-82.0,4.0,12.0,7.0,22.0,1
972,CC:2F:71:3F:1F:24,2281828,445194064,130735,172294437,2151093,272899627,3,91110,106510435,91050,106502821,60,7614,87941,331,130764,24001,3,57,144444.0,43333.0,-67.0,-63.0,-67.0,-68.0,-66.0,-63.0,-66.0,-68.0,-73.0,-81.0,-73.0,-82.0,6.0,18.0,6.0,14.0,1
973,F8:59:71:5A:E0:3D,2186247,326353362,35149,53453271,2151098,272900091,0,25001,35730650,24940,35720511,61,10139,24858,2,35160,2723,0,16,144444.0,43333.0,-66.0,-72.0,-64.0,-69.0,-65.0,-71.0,-65.0,-69.0,-73.0,-81.0,-73.0,-82.0,7.0,9.0,9.0,13.0,1
974,CC:2F:71:3E:C5:1F,2151155,272907112,57,7021,2151098,272900091,0,263,22389,223,17471,40,4918,65,1,95,6,0,12,144444.0,39000.0,-69.0,-70.0,-65.0,-60.0,-69.0,-69.0,-65.0,-60.0,-73.0,-81.0,-73.0,-82.0,4.0,11.0,8.0,22.0,1
975,CC:2F:71:3F:1F:24,2281991,445400734,130893,172500643,2151098,272900091,3,91257,106710849,91197,106703235,60,7614,88086,331,130922,24012,3,57,144444.0,43333.0,-67.0,-63.0,-67.0,-68.0,-66.0,-63.0,-67.0,-68.0,-73.0,-81.0,-73.0,-82.0,6.0,18.0,6.0,14.0,1
976,F8:59:71:5A:E0:3D,2186319,326451601,35219,53551308,2151100,272900293,0,25069,35830165,25008,35820026,61,10139,24926,2,35230,2728,0,16,144444.0,43333.0,-65.0,-72.0,-65.0,-70.0,-65.0,-72.0,-64.0,-69.0,-73.0,-81.0,-73.0,-82.0,8.0,9.0,8.0,12.0,1
977,CC:2F:71:3E:C5:1F,2151157,272907314,57,7021,2151100,272900293,0,263,22389,223,17471,40,4918,65,1,95,6,0,12,144444.0,39000.0,-69.0,-70.0,-65.0,-60.0,-69.0,-69.0,-65.0,-60.0,-73.0,-81.0,-73.0,-82.0,4.0,11.0,8.0,22.0,1
978,CC:2F:71:3F:1F:24,2282151,445607030,131051,172706737,2151100,272900293,3,91409,106920557,91349,106912943,60,7614,88228,331,131080,24034,3,57,144444.0,43333.0,-68.0,-64.0,-69.0,-69.0,-66.0,-63.0,-66.0,-68.0,-73.0,-81.0,-73.0,-82.0,5.0,17.0,4.0,13.0,1
979,F8:59:71:5A:E0:3D,2186395,326552769,35290,53651799,2151105,272900970,0,25137,35930562,25076,35920423,61,10139,24994,2,35301,2731,0,16,144444.0,43333.0,-65.0,-73.0,-65.0,-68.0,-64.0,-72.0,-65.0,-69.0,-73.0,-81.0,-73.0,-82.0,8.0,8.0,8.0,14.0,1
980,CC:2F:71:3E:C5:1F,2151163,272908051,58,7081,2151105,272900970,0,265,22529,225,17611,40,4918,65,1,96,6,0,12,144444.0,39000.0,-69.0,-70.0,-66.0,-60.0,-69.0,-68.0,-65.0,-59.0,-73.0,-81.0,-73.0,-82.0,4.0,11.0,7.0,22.0,1
981,CC:2F:71:3F:1F:24,2282664,446301925,131557,173400753,2151107,272901172,3,91600,107132103,91540,107124489,60,7614,88416,331,131585,24064,3,57,144444.0,43333.0,-66.0,-63.0,-66.0,-70.0,-67.0,-63.0,-67.0,-69.0,-73.0,-81.0,-73.0,-82.0,7.0,18.0,7.0,12.0,1
982,F8:59:71:5A:E0:3D,2186579,326830695,35469,53929261,2151110,272901434,0,25217,36035650,25156,36025511,61,10139,25074,2,35480,2745,0,16,144444.0,43333.0,-65.0,-73.0,-64.0,-70.0,-65.0,-72.0,-64.0,-69.0,-73.0,-81.0,-73.0,-82.0,8.0,8.0,9.0,12.0,1
983,CC:2F:71:3E:C5:1F,2151168,272908515,58,7081,2151110,272901434,0,265,22529,225,17611,40,4918,65,1,96,6,0,12,144444.0,39000.0,-69.0,-70.0,-66.0,-60.0,-69.0,-68.0,-65.0,-59.0,-73.0,-81.0,-73.0,-82.0,4.0,11.0,7.0,22.0,1
984,CC:2F:71:3F:1F:24,2282833,446519999,131723,173618565,2151110,272901434,3,91755,107346393,91695,107338779,60,7614,88566,331,131752,24176,3,57,130000.0,43333.0,-67.0,-63.0,-68.0,-68.0,-66.0,-63.0,-67.0,-67.0,-73.0,-81.0,-73.0,-82.0,6.0,18.0,5.0,14.0,1
985,F8:59:71:5A:E0:3D,2186730,327055883,35614,54153677,2151116,272902206,0,25285,36137992,25224,36127853,61,10139,25142,2,35564,2749,0,16,144444.0,43333.0,-66.0,-73.0,-63.0,-70.0,-65.0,-72.0,-64.0,-68.0,-73.0,-81.0,-73.0,-82.0,7.0,8.0,10.0,12.0,1
986,CC:2F:71:3E:C5:1F,2151174,272909287,58,7081,2151116,272902206,0,265,22529,225,17611,40,4918,65,1,96,6,0,12,144444.0,39000.0,-69.0,-70.0,-66.0,-60.0,-69.0,-68.0,-65.0,-59.0,-73.0,-81.0,-73.0,-82.0,4.0,11.0,7.0,22.0,1
987,CC:2F:71:3F:1F:24,2283002,446733297,131886,173831091,2151116,272902206,3,91913,107561185,91853,107553571,60,7614,88716,331,131915,24241,3,57,115556.0,28889.0,-67.0,-64.0,-68.0,-69.0,-66.0,-63.0,-66.0,-69.0,-73.0,-81.0,-73.0,-82.0,6.0,17.0,5.0,13.0,1
988,F8:59:71:5A:E0:3D,2186920,327348055,35800,54445445,2151120,272902610,0,25367,36240146,25306,36230007,61,10139,25224,2,35811,2853,0,16,144444.0,43333.0,-65.0,-72.0,-64.0,-69.0,-64.0,-72.0,-65.0,-68.0,-73.0,-81.0,-73.0,-82.0,8.0,9.0,9.0,13.0,1
989,CC:2F:71:3E:C5:1F,2151178,272909691,58,7081,2151120,272902610,0,265,22529,225,17611,40,4918,65,1,96,6,0,12,144444.0,39000.0,-69.0,-70.0,-66.0,-60.0,-69.0,-68.0,-65.0,-59.0,-73.0,-81.0,-73.0,-82.0,4.0,11.0,7.0,22.0,1
990,CC:2F:71:3F:1F:24,2283189,446948460,132069,174045850,2151120,272902610,3,92089,107779383,92029,107771769,60,7614,88881,331,132098,24266,3,57,115556.0,28889.0,-67.0,-63.0,-66.0,-69.0,-66.0,-63.0,-67.0,-69.0,-73.0,-81.0,-73.0,-82.0,6.0,18.0,7.0,13.0,1
991,F8:59:71:5A:E0:3D,2186988,327447835,35864,54544901,2151124,272902934,0,25430,36337166,25369,36327027,61,10139,25287,2,35875,2863,0,16,144444.0,43333.0,-65.0,-72.0,-66.0,-69.0,-64.0,-72.0,-64.0,-69.0,-73.0,-81.0,-73.0,-82.0,8.0,9.0,7.0,13.0,1
992,CC:2F:71:3E:C5:1F,2151182,272910015,58,7081,2151124,272902934,0,265,22529,225,17611,40,4918,65,1,96,6,0,12,144444.0,39000.0,-69.0,-70.0,-66.0,-60.0,-69.0,-68.0,-65.0,-59.0,-73.0,-81.0,-73.0,-82.0,4.0,11.0,7.0,22.0,1
993,CC:2F:71:3F:1F:24,2283355,447155071,132231,174252137,2151124,272902934,3,92245,107984234,92184,107976502,61,7732,89032,331,132260,24290,3,57,115556.0,26000.0,-66.0,-63.0,-67.0,-69.0,-66.0,-63.0,-67.0,-69.0,-73.0,-81.0,-73.0,-82.0,7.0,18.0,6.0,13.0,1
994,F8:59:71:5A:E0:3D,2187056,327544789,35926,54641249,2151130,272903540,0,25493,36434186,25432,36424047,61,10139,25350,2,35937,2872,0,16,144444.0,43333.0,-64.0,-72.0,-65.0,-69.0,-64.0,-71.0,-64.0,-69.0,-73.0,-81.0,-73.0,-82.0,9.0,9.0,8.0,13.0,1
995,CC:2F:71:3E:C5:1F,2151188,272910621,58,7081,2151130,272903540,0,265,22529,225,17611,40,4918,65,1,96,6,0,12,144444.0,39000.0,-69.0,-70.0,-66.0,-60.0,-69.0,-68.0,-65.0,-59.0,-73.0,-81.0,-73.0,-82.0,4.0,11.0,7.0,22.0,1
996,CC:2F:71:3F:1F:24,2283701,447611004,132571,174707464,2151130,272903540,3,92429,108203074,92368,108195342,61,7732,89207,331,132600,24315,3,57,115556.0,28889.0,-67.0,-63.0,-67.0,-68.0,-66.0,-63.0,-67.0,-69.0,-73.0,-81.0,-73.0,-82.0,6.0,18.0,6.0,14.0,1
997,F8:59:71:5A:E0:3D,2187122,327644447,35990,54740705,2151132,272903742,0,25556,36531206,25495,36521067,61,10139,25413,2,36001,2880,0,16,144444.0,43333.0,-66.0,-72.0,-64.0,-69.0,-64.0,-71.0,-65.0,-69.0,-73.0,-81.0,-73.0,-82.0,7.0,9.0,9.0,13.0,1
998,CC:2F:71:3E:C5:1F,2151190,272910823,58,7081,2151132,272903742,0,265,22529,225,17611,40,4918,65,1,96,6,0,12,144444.0,39000.0,-69.0,-70.0,-66.0,-60.0,-69.0,-68.0,-65.0,-59.0,-73.0,-81.0,-73.0,-82.0,4.0,11.0,7.0,22.0,1
999,CC:2F:71:3F:1F:24,2283864,447820314,132732,174916572,2151132,272903742,3,92585,108414556,92524,108406824,61,7732,89357,331,132761,24360,3,57,115556.0,28889.0,-68.0,-64.0,-67.0,-69.0,-66.0,-63.0,-66.0,-68.0,-73.0,-81.0,-73.0,-82.0,5.0,17.0,6.0,13.0,1
1000,F8:59:71:5A:E0:3D,2187224,327786393,36087,54882187,2151137,272904206,0,25632,36639068,25571,36628929,61,10139,25489,2,36098,2887,0,16,144444.0,43333.0,-66.0,-72.0,-64.0,-69.0,-65.0,-72.0,-64.0,-69.0,-73.0,-81.0,-73.0,-82.0,7.0,9.0,9.0,13.0,1
1001,CC:2F:71:3E:C5:1F,2151195,272911287,58,7081,2151137,272904206,0,265,22529,225,17611,40,4918,65,1,96,6,0,12,144444.0,39000.0,-69.0,-70.0,-66.0,-60.0,-69.0,-68.0,-65.0,-59.0,-73.0,-81.0,-73.0,-82.0,4.0,11.0,7.0,22.0,1
1002,CC:2F:71:3F:1F:24,2284028,448027070,132889,175122662,2151139,272904408,3,92736,108622776,92675,108615044,61,7732,89500,331,132918,24384,3,57,115556.0,28889.0,-67.0,-64.0,-67.0,-70.0,-66.0,-63.0,-66.0,-69.0,-73.0,-81.0,-73.0,-82.0,6.0,17.0,6.0,12.0,1
1003,F8:59:71:5A:E0:3D,2187291,327884699,36150,54980089,2151141,272904610,0,25694,36734576,25633,36724437,61,10139,25551,2,36161,2896,0,16,144444.0,43333.0,-66.0,-72.0,-64.0,-69.0,-64.0,-72.0,-64.0,-69.0,-73.0,-81.0,-73.0,-82.0,7.0,9.0,9.0,13.0,1
1004,CC:2F:71:3E:C5:1F,2151199,272911691,58,7081,2151141,272904610,0,265,22529,225,17611,40,4918,65,1,96,6,0,12,144444.0,39000.0,-69.0,-70.0,-66.0,-60.0,-69.0,-68.0,-65.0,-59.0,-73.0,-81.0,-73.0,-82.0,4.0,11.0,7.0,22.0,1
1005,CC:2F:71:3F:1F:24,2284239,448252474,133098,175347864,2151141,272904610,3,92941,108849726,92880,108841994,61,7732,89692,331,133126,24402,3,57,115556.0,28889.0,-67.0,-64.0,-67.0,-70.0,-66.0,-63.0,-66.0,-69.0,-73.0,-81.0,-73.0,-82.0,6.0,17.0,6.0,12.0,1
1006,F8:59:71:5A:E0:3D,2187455,328129578,36310,55224564,2151145,272905014,0,25774,36841182,25713,36831043,61,10139,25631,2,36321,2900,0,16,144444.0,43333.0,-65.0,-72.0,-64.0,-69.0,-65.0,-72.0,-64.0,-69.0,-73.0,-81.0,-73.0,-82.0,8.0,9.0,9.0,13.0,1
1007,CC:2F:71:3E:C5:1F,2151203,272912095,58,7081,2151145,272905014,0,265,22529,225,17611,40,4918,65,1,96,6,0,12,144444.0,39000.0,-69.0,-70.0,-66.0,-60.0,-69.0,-68.0,-65.0,-59.0,-73.0,-81.0,-73.0,-82.0,4.0,11.0,7.0,22.0,1
1008,CC:2F:71:3F:1F:24,2284405,448463204,133259,175558130,2151146,272905074,3,93096,109064020,93035,109056288,61,7732,89840,331,133288,24430,3,57,115556.0,28889.0,-64.0,-64.0,-64.0,-70.0,-65.0,-64.0,-65.0,-69.0,-73.0,-81.0,-73.0,-82.0,9.0,17.0,9.0,12.0,1
1009,F8:59:71:5A:E0:3D,2187531,328230457,36380,55324917,2151151,272905540,0,25846,36940793,25784,36930536,62,10257,25703,2,36391,2903,0,16,144444.0,43333.0,-64.0,-71.0,-64.0,-70.0,-64.0,-71.0,-64.0,-69.0,-73.0,-81.0,-73.0,-82.0,9.0,10.0,9.0,12.0,1
1010,CC:2F:71:3E:C5:1F,2151209,272912621,58,7081,2151151,272905540,0,265,22529,225,17611,40,4918,65,1,96,6,0,12,144444.0,39000.0,-69.0,-70.0,-66.0,-60.0,-69.0,-68.0,-65.0,-59.0,-73.0,-81.0,-73.0,-82.0,4.0,11.0,7.0,22.0,1
1011,CC:2F:71:3F:1F:24,2284576,448671669,133425,175766129,2151151,272905540,3,93250,109268474,93189,109260742,61,7732,89990,331,133454,24460,3,57,115556.0,28889.0,-67.0,-63.0,-67.0,-69.0,-66.0,-63.0,-66.0,-68.0,-73.0,-81.0,-73.0,-82.0,6.0,18.0,6.0,13.0,1
1012,F8:59:71:5A:E0:3D,2187604,328329806,36451,55424064,2151153,272905742,0,25916,37041546,25854,37031289,62,10257,25773,2,36462,2906,0,16,144444.0,43333.0,-64.0,-71.0,-66.0,-69.0,-64.0,-71.0,-64.0,-69.0,-73.0,-81.0,-73.0,-82.0,9.0,10.0,7.0,13.0,1
1013,CC:2F:71:3E:C5:1F,2151213,272913025,58,7081,2151155,272905944,0,265,22529,225,17611,40,4918,65,1,96,6,0,12,144444.0,39000.0,-69.0,-70.0,-66.0,-60.0,-69.0,-68.0,-65.0,-59.0,-73.0,-81.0,-73.0,-82.0,4.0,11.0,7.0,22.0,1
1014,CC:2F:71:3F:1F:24,2284739,448879499,133583,175973493,2151156,272906006,3,93399,109467834,93338,109460102,61,7732,90137,331,133612,24479,3,57,117000.0,39000.0,-67.0,-63.0,-67.0,-68.0,-66.0,-63.0,-65.0,-68.0,-73.0,-81.0,-73.0,-82.0,6.0,18.0,6.0,14.0,1
1015,F8:59:71:5A:E0:3D,2187675,328431342,36516,55525074,2151159,272906268,0,25981,37141646,25919,37131389,62,10257,25838,2,36527,2910,0,16,144444.0,43333.0,-65.0,-72.0,-65.0,-69.0,-65.0,-72.0,-64.0,-69.0,-73.0,-81.0,-73.0,-82.0,8.0,9.0,8.0,13.0,1
1016,CC:2F:71:3E:C5:1F,2151219,272913551,58,7081,2151161,272906470,0,267,22717,226,17681,41,5036,66,1,96,6,0,12,144444.0,39000.0,-69.0,-69.0,-66.0,-60.0,-69.0,-68.0,-65.0,-59.0,-73.0,-81.0,-73.0,-82.0,4.0,12.0,7.0,22.0,1
1017,CC:2F:71:3F:1F:24,2284905,449090117,133744,176183647,2151161,272906470,3,93556,109682304,93495,109674572,61,7732,90287,331,133773,24541,3,57,117000.0,39000.0,-68.0,-64.0,-68.0,-68.0,-66.0,-63.0,-66.0,-69.0,-73.0,-81.0,-73.0,-82.0,5.0,17.0,5.0,14.0,1
1018,F8:59:71:5A:E0:3D,2187743,328531202,36580,55624530,2151163,272906672,0,26045,37240206,25983,37229949,62,10257,25902,2,36591,2916,0,16,144444.0,43333.0,-65.0,-72.0,-64.0,-69.0,-65.0,-71.0,-64.0,-69.0,-73.0,-81.0,-73.0,-82.0,8.0,9.0,9.0,13.0,1
1019,CC:2F:71:3E:C5:1F,2151221,272913753,58,7081,2151163,272906672,0,267,22717,226,17681,41,5036,66,1,96,6,0,12,144444.0,39000.0,-69.0,-69.0,-66.0,-60.0,-69.0,-68.0,-65.0,-59.0,-73.0,-81.0,-73.0,-82.0,4.0,12.0,7.0,22.0,1
1020,CC:2F:71:3F:1F:24,2285082,449303908,133919,176397236,2151163,272906672,3,93721,109898416,93660,109890684,61,7732,90444,331,133948,24609,3,57,115556.0,28889.0,-66.0,-64.0,-67.0,-70.0,-66.0,-63.0,-66.0,-69.0,-73.0,-81.0,-73.0,-82.0,7.0,17.0,6.0,12.0,1
1021,F8:59:71:5A:E0:3D,2187814,328631595,36646,55724246,2151168,272907349,0,26112,37339177,26050,37328920,62,10257,25969,2,36657,2920,0,16,144444.0,43333.0,-64.0,-72.0,-65.0,-69.0,-65.0,-71.0,-64.0,-69.0,-73.0,-81.0,-73.0,-82.0,9.0,9.0,8.0,13.0,1
1022,CC:2F:71:3E:C5:1F,2151226,272914430,58,7081,2151168,272907349,0,267,22717,226,17681,41,5036,66,1,96,6,0,12,144444.0,39000.0,-69.0,-69.0,-66.0,-60.0,-69.0,-68.0,-65.0,-59.0,-73.0,-81.0,-73.0,-82.0,4.0,12.0,7.0,22.0,1
1023,CC:2F:71:3F:1F:24,2285277,449535473,134109,176628124,2151168,272907349,3,93886,110103414,93825,110095682,61,7732,90608,331,134138,24636,3,57,115556.0,28889.0,-67.0,-64.0,-68.0,-69.0,-66.0,-63.0,-67.0,-69.0,-73.0,-81.0,-73.0,-82.0,6.0,17.0,5.0,13.0,1
1024,F8:59:71:5A:E0:3D,2188005,328916977,36834,56009366,2151171,272907611,0,26193,37442589,26131,37432332,62,10257,26050,2,36845,2956,0,16,144444.0,43333.0,-64.0,-72.0,-63.0,-69.0,-64.0,-71.0,-64.0,-69.0,-73.0,-81.0,-73.0,-82.0,9.0,9.0,10.0,13.0,1
1025,CC:2F:71:3E:C5:1F,2151231,272914894,58,7081,2151173,272907813,0,267,22717,226,17681,41,5036,66,1,96,6,0,12,144444.0,39000.0,-69.0,-69.0,-66.0,-60.0,-69.0,-68.0,-65.0,-59.0,-73.0,-81.0,-73.0,-82.0,4.0,12.0,7.0,22.0,1
1026,CC:2F:71:3F:1F:24,2285441,449745023,134268,176837210,2151173,272907813,3,94036,110312772,93975,110305040,61,7732,90753,331,134297,24675,3,57,115556.0,28889.0,-67.0,-63.0,-67.0,-69.0,-66.0,-63.0,-66.0,-69.0,-73.0,-81.0,-73.0,-82.0,6.0,18.0,6.0,13.0,1
1027,F8:59:71:5A:E0:3D,2188073,329016837,36898,56108822,2151175,272908015,0,26257,37541149,26195,37530892,62,10257,26114,2,36909,2961,0,16,144444.0,43333.0,-65.0,-71.0,-64.0,-70.0,-65.0,-71.0,-64.0,-69.0,-73.0,-81.0,-73.0,-82.0,8.0,10.0,9.0,12.0,1
1028,CC:2F:71:3E:C5:1F,2151235,272915298,58,7081,2151177,272908217,0,267,22717,226,17681,41,5036,66,1,96,6,0,12,144444.0,39000.0,-69.0,-69.0,-66.0,-60.0,-69.0,-68.0,-65.0,-59.0,-73.0,-81.0,-73.0,-82.0,4.0,12.0,7.0,22.0,1
1029,CC:2F:71:3F:1F:24,2285604,449951091,134427,177042874,2151177,272908217,3,94192,110521406,94131,110513674,61,7732,90903,331,134456,24748,3,57,115556.0,28889.0,-67.0,-64.0,-68.0,-69.0,-66.0,-64.0,-65.0,-69.0,-73.0,-81.0,-73.0,-82.0,6.0,17.0,5.0,13.0,1
1030,F8:59:71:5A:E0:3D,2188141,329116697,36962,56208278,2151179,272908419,0,26320,37638169,26258,37627912,62,10257,26177,2,36973,2968,0,16,144444.0,43333.0,-64.0,-72.0,-65.0,-68.0,-65.0,-72.0,-64.0,-68.0,-73.0,-81.0,-73.0,-82.0,9.0,9.0,8.0,14.0,1
1031,CC:2F:71:3E:C5:1F,2151237,272915500,58,7081,2151179,272908419,0,267,22717,226,17681,41,5036,66,1,96,6,0,12,144444.0,39000.0,-69.0,-69.0,-66.0,-60.0,-69.0,-68.0,-65.0,-59.0,-73.0,-81.0,-73.0,-82.0,4.0,12.0,7.0,22.0,1
1032,CC:2F:71:3F:1F:24,2285769,450160558,134590,177252139,2151179,272908419,3,94349,110727913,94288,110720181,61,7732,91052,331,134619,24764,3,57,115556.0,28889.0,-66.0,-64.0,-67.0,-70.0,-66.0,-63.0,-66.0,-69.0,-73.0,-81.0,-73.0,-82.0,7.0,17.0,6.0,12.0,1
1033,F8:59:71:5A:E0:3D,2188393,329502557,37209,56593674,2151184,272908883,0,26386,37738855,26324,37728598,62,10257,26243,2,37068,2969,0,16,144444.0,43333.0,-64.0,-72.0,-64.0,-69.0,-64.0,-72.0,-65.0,-69.0,-73.0,-81.0,-73.0,-82.0,9.0,9.0,9.0,13.0,1
1034,CC:2F:71:3E:C5:1F,2151242,272915964,58,7081,2151184,272908883,0,267,22717,226,17681,41,5036,66,1,96,6,0,12,144444.0,39000.0,-69.0,-69.0,-66.0,-60.0,-69.0,-68.0,-65.0,-59.0,-73.0,-81.0,-73.0,-82.0,4.0,12.0,7.0,22.0,1
1035,CC:2F:71:3F:1F:24,2285940,450379806,134755,177470789,2151185,272909017,3,94507,110945345,94446,110937613,61,7732,91204,331,134782,24788,3,57,115556.0,28889.0,-64.0,-63.0,-64.0,-70.0,-65.0,-63.0,-65.0,-69.0,-73.0,-81.0,-73.0,-82.0,9.0,18.0,9.0,12.0,1
1036,F8:59:71:5A:E0:3D,2188625,329860256,37437,56950969,2151188,272909287,0,26488,37847807,26426,37837550,62,10257,26345,2,37448,2972,0,16,144444.0,43333.0,-65.0,-72.0,-65.0,-69.0,-65.0,-72.0,-64.0,-69.0,-73.0,-81.0,-73.0,-82.0,8.0,9.0,8.0,13.0,1
1037,CC:2F:71:3E:C5:1F,2151246,272916368,58,7081,2151188,272909287,0,267,22717,226,17681,41,5036,66,1,96,6,0,12,144444.0,39000.0,-69.0,-69.0,-66.0,-60.0,-69.0,-68.0,-65.0,-59.0,-73.0,-81.0,-73.0,-82.0,4.0,12.0,7.0,22.0,1
1038,CC:2F:71:3F:1F:24,2286117,450591923,134929,177682636,2151188,272909287,3,94672,111164276,94611,111156544,61,7732,91362,331,134959,24892,3,57,130000.0,39000.0,-68.0,-64.0,-68.0,-70.0,-66.0,-63.0,-67.0,-70.0,-73.0,-81.0,-73.0,-82.0,5.0,17.0,5.0,12.0,1
1039,F8:59:71:5A:E0:3D,2188693,329960116,37501,57050425,2151192,272909691,0,26553,37947907,26491,37937650,62,10257,26410,2,37512,2976,0,16,144444.0,43333.0,-64.0,-72.0,-65.0,-70.0,-65.0,-72.0,-64.0,-69.0,-73.0,-81.0,-73.0,-82.0,9.0,9.0,8.0,12.0,1
1040,CC:2F:71:3E:C5:1F,2151250,272916772,58,7081,2151192,272909691,0,267,22717,226,17681,41,5036,66,1,96,6,0,12,144444.0,39000.0,-69.0,-69.0,-66.0,-60.0,-69.0,-68.0,-65.0,-59.0,-73.0,-81.0,-73.0,-82.0,4.0,12.0,7.0,22.0,1
1041,CC:2F:71:3F:1F:24,2286287,450808659,135095,177898968,2151192,272909691,3,94828,111378584,94767,111370852,61,7732,91516,331,135125,25055,3,57,78000.0,1000.0,-67.0,-63.0,-68.0,-70.0,-66.0,-63.0,-67.0,-70.0,-73.0,-81.0,-73.0,-82.0,6.0,18.0,5.0,12.0,1
1042,F8:59:71:5A:E0:3D,2188808,330115217,37611,57205062,2151197,272910155,0,26639,38069527,26577,38059270,62,10257,26496,2,37621,2985,0,16,144444.0,43333.0,-64.0,-71.0,-66.0,-69.0,-64.0,-72.0,-64.0,-69.0,-73.0,-81.0,-73.0,-82.0,9.0,10.0,7.0,13.0,1
1043,CC:2F:71:3E:C5:1F,2151255,272917236,58,7081,2151197,272910155,0,267,22717,226,17681,41,5036,66,1,96,6,0,12,144444.0,39000.0,-69.0,-69.0,-66.0,-60.0,-69.0,-68.0,-65.0,-59.0,-73.0,-81.0,-73.0,-82.0,4.0,12.0,7.0,22.0,1
1044,CC:2F:71:3F:1F:24,2286484,451060284,135287,178150129,2151197,272910155,3,95020,111637731,94959,111629999,61,7732,91692,331,135319,25245,3,57,39000.0,5500.0,-66.0,-63.0,-64.0,-71.0,-67.0,-63.0,-67.0,-71.0,-73.0,-81.0,-73.0,-82.0,7.0,18.0,9.0,11.0,1
1045,F8:59:71:5A:E0:3D,2188891,330236949,37690,57326390,2151201,272910559,0,26718,38189753,26656,38179496,62,10257,26575,2,37701,2992,0,16,144444.0,43333.0,-65.0,-73.0,-64.0,-70.0,-65.0,-72.0,-64.0,-69.0,-73.0,-81.0,-73.0,-82.0,8.0,8.0,9.0,12.0,1
1046,CC:2F:71:3E:C5:1F,2151259,272917640,58,7081,2151201,272910559,0,267,22717,226,17681,41,5036,66,1,96,6,0,12,144444.0,39000.0,-69.0,-69.0,-66.0,-60.0,-69.0,-68.0,-65.0,-59.0,-73.0,-81.0,-73.0,-82.0,4.0,12.0,7.0,22.0,1
1047,CC:2F:71:3F:1F:24,2286663,451290612,135460,178379851,2151203,272910761,3,95194,111875805,95133,111868073,61,7732,91854,331,135492,25307,3,57,104000.0,26000.0,-67.0,-64.0,-66.0,-72.0,-66.0,-64.0,-66.0,-70.0,-73.0,-81.0,-73.0,-82.0,6.0,17.0,7.0,10.0,1
1048,F8:59:71:5A:E0:3D,2188964,330337453,37757,57426304,2151207,272911149,0,26786,38290671,26724,38280414,62,10257,26643,2,37768,3000,0,16,144444.0,43333.0,-65.0,-72.0,-64.0,-70.0,-64.0,-71.0,-64.0,-69.0,-73.0,-81.0,-73.0,-82.0,8.0,9.0,9.0,12.0,1
1049,CC:2F:71:3E:C5:1F,2151265,272918230,58,7081,2151207,272911149,0,267,22717,226,17681,41,5036,66,1,96,6,0,12,144444.0,39000.0,-69.0,-69.0,-66.0,-60.0,-69.0,-68.0,-65.0,-59.0,-73.0,-81.0,-73.0,-82.0,4.0,12.0,7.0,22.0,1
1050,CC:2F:71:3F:1F:24,2286826,451499302,135619,178588153,2151207,272911149,3,95342,112077663,95281,112069931,61,7732,91999,331,135651,25405,3,57,115556.0,26000.0,-65.0,-64.0,-68.0,-71.0,-66.0,-63.0,-66.0,-69.0,-73.0,-81.0,-73.0,-82.0,8.0,17.0,5.0,11.0,1
1051,F8:59:71:5A:E0:3D,2189032,330437313,37821,57525760,2151211,272911553,0,26849,38387691,26787,38377434,62,10257,26706,2,37832,3002,0,16,144444.0,43333.0,-65.0,-72.0,-63.0,-69.0,-64.0,-71.0,-64.0,-68.0,-73.0,-81.0,-73.0,-82.0,8.0,9.0,10.0,13.0,1
1052,CC:2F:71:3E:C5:1F,2151269,272918634,58,7081,2151211,272911553,0,267,22717,226,17681,41,5036,66,1,96,6,0,12,144444.0,39000.0,-69.0,-69.0,-66.0,-60.0,-69.0,-68.0,-65.0,-59.0,-73.0,-81.0,-73.0,-82.0,4.0,12.0,7.0,22.0,1
1053,CC:2F:71:3F:1F:24,2286988,451705870,135777,178794317,2151211,272911553,3,95489,112279681,95428,112271949,61,7732,92141,331,135809,25420,3,57,115556.0,28889.0,-68.0,-64.0,-68.0,-67.0,-67.0,-64.0,-66.0,-67.0,-73.0,-81.0,-73.0,-82.0,5.0,17.0,5.0,15.0,1
1054,F8:59:71:5A:E0:3D,2189105,330537268,37890,57625311,2151215,272911957,0,26922,38488825,26860,38478568,62,10257,26779,2,37901,3008,0,16,144444.0,43333.0,-65.0,-72.0,-65.0,-69.0,-65.0,-72.0,-64.0,-69.0,-73.0,-81.0,-73.0,-82.0,8.0,9.0,8.0,13.0,1
1055,CC:2F:71:3E:C5:1F,2151273,272919038,58,7081,2151215,272911957,0,268,22787,227,17751,41,5036,66,1,97,6,0,12,144444.0,39000.0,-69.0,-69.0,-66.0,-60.0,-68.0,-68.0,-65.0,-59.0,-73.0,-81.0,-73.0,-82.0,4.0,12.0,7.0,22.0,1
1056,CC:2F:71:3F:1F:24,2287160,451919160,135945,179007203,2151215,272911957,3,95649,112490690,95588,112482958,61,7732,92296,331,135977,25429,3,57,117000.0,39000.0,-67.0,-64.0,-67.0,-67.0,-66.0,-64.0,-65.0,-67.0,-73.0,-81.0,-73.0,-82.0,6.0,17.0,6.0,15.0,1
1057,F8:59:71:5A:E0:3D,2189174,330637188,37954,57724767,2151220,272912421,0,26986,38587385,26924,38577128,62,10257,26843,2,37965,3013,0,16,144444.0,43333.0,-64.0,-71.0,-65.0,-69.0,-64.0,-71.0,-64.0,-69.0,-73.0,-81.0,-73.0,-82.0,9.0,10.0,8.0,13.0,1
1058,CC:2F:71:3E:C5:1F,2151278,272919502,58,7081,2151220,272912421,0,269,22857,228,17821,41,5036,66,1,97,6,0,12,144444.0,39000.0,-69.0,-70.0,-65.0,-60.0,-68.0,-68.0,-65.0,-59.0,-73.0,-81.0,-73.0,-82.0,4.0,11.0,8.0,22.0,1
1059,CC:2F:71:3F:1F:24,2287322,452125602,136102,179213181,2151220,272912421,3,95795,112688122,95734,112680390,61,7732,92442,331,136134,25434,3,57,130000.0,43333.0,-65.0,-65.0,-67.0,-68.0,-66.0,-64.0,-67.0,-67.0,-73.0,-81.0,-73.0,-82.0,8.0,16.0,6.0,14.0,1
1060,F8:59:71:5A:E0:3D,2189556,331229510,38332,58316685,2151224,272912825,0,27082,38692975,27020,38682718,62,10257,26939,2,38343,3107,0,16,144444.0,43333.0,-65.0,-71.0,-64.0,-69.0,-65.0,-72.0,-63.0,-69.0,-73.0,-81.0,-73.0,-82.0,8.0,10.0,9.0,13.0,1
1061,CC:2F:71:3E:C5:1F,2151282,272919906,58,7081,2151224,272912825,0,269,22857,228,17821,41,5036,66,1,97,6,0,12,144444.0,39000.0,-69.0,-70.0,-65.0,-60.0,-68.0,-68.0,-65.0,-59.0,-73.0,-81.0,-73.0,-82.0,4.0,11.0,8.0,22.0,1
1062,CC:2F:71:3F:1F:24,2287501,452340413,136277,179427588,2151224,272912825,3,95955,112891128,95894,112883396,61,7732,92602,331,136309,25434,3,57,130000.0,43333.0,-67.0,-64.0,-68.0,-67.0,-66.0,-64.0,-66.0,-67.0,-73.0,-81.0,-73.0,-82.0,6.0,17.0,5.0,15.0,1
1063,F8:59:71:5A:E0:3D,2189627,331329821,38397,58416257,2151230,272913564,0,27146,38791535,27084,38781278,62,10257,27003,2,38408,3111,0,16,144444.0,43333.0,-64.0,-72.0,-66.0,-68.0,-64.0,-71.0,-64.0,-68.0,-73.0,-81.0,-73.0,-82.0,9.0,9.0,7.0,14.0,1
1064,CC:2F:71:3E:C5:1F,2151289,272920761,59,7197,2151230,272913564,0,274,23303,231,18031,43,5272,67,1,98,6,0,13,144444.0,43333.0,-69.0,-69.0,-66.0,-60.0,-68.0,-69.0,-65.0,-59.0,-73.0,-81.0,-73.0,-82.0,4.0,12.0,7.0,22.0,1
1065,CC:2F:71:3F:1F:24,2287670,452556342,136440,179642778,2151230,272913564,3,96106,113096260,96045,113088528,61,7732,92753,331,136472,25447,3,57,130000.0,43333.0,-67.0,-64.0,-67.0,-67.0,-65.0,-64.0,-66.0,-67.0,-73.0,-81.0,-73.0,-82.0,6.0,17.0,6.0,15.0,1
1066,F8:59:71:5A:E0:3D,2189819,331620157,38584,58706129,2151235,272914028,0,27227,38895177,27165,38884920,62,10257,27081,2,38595,3115,0,16,144444.0,43333.0,-65.0,-72.0,-64.0,-69.0,-65.0,-72.0,-64.0,-68.0,-73.0,-81.0,-73.0,-82.0,8.0,9.0,9.0,13.0,1
1067,CC:2F:71:3E:C5:1F,2151294,272921225,59,7197,2151235,272914028,0,274,23303,231,18031,43,5272,67,1,98,6,0,13,144444.0,43333.0,-69.0,-69.0,-66.0,-60.0,-68.0,-69.0,-65.0,-59.0,-73.0,-81.0,-73.0,-82.0,4.0,12.0,7.0,22.0,1
1068,CC:2F:71:3F:1F:24,2287830,452759564,136595,179845536,2151235,272914028,3,96249,113291920,96188,113284188,61,7732,92896,331,136627,25452,3,57,130000.0,43333.0,-68.0,-65.0,-67.0,-68.0,-67.0,-64.0,-67.0,-67.0,-73.0,-81.0,-73.0,-82.0,5.0,16.0,6.0,14.0,1
1069,F8:59:71:5A:E0:3D,2189887,331719939,38648,58805585,2151239,272914354,0,27291,38992315,27228,38981940,63,10375,27145,2,38659,3117,0,16,144444.0,43333.0,-64.0,-71.0,-66.0,-69.0,-64.0,-71.0,-64.0,-68.0,-73.0,-81.0,-73.0,-82.0,9.0,10.0,7.0,13.0,1
1070,CC:2F:71:3E:C5:1F,2151300,272921753,59,7197,2151241,272914556,0,274,23303,231,18031,43,5272,67,1,98,6,0,13,144444.0,43333.0,-69.0,-69.0,-66.0,-60.0,-68.0,-69.0,-65.0,-59.0,-73.0,-81.0,-73.0,-82.0,4.0,12.0,7.0,22.0,1
1071,CC:2F:71:3F:1F:24,2288003,452972895,136762,180058339,2151241,272914556,3,96403,113492202,96341,113484352,62,7850,93050,331,136794,25452,3,57,130000.0,43333.0,-66.0,-64.0,-66.0,-67.0,-66.0,-64.0,-65.0,-67.0,-73.0,-81.0,-73.0,-82.0,7.0,17.0,7.0,15.0,1
1072,F8:59:71:5A:E0:3D,2189975,331827427,38710,58901821,2151265,272925606,0,27354,39089335,27291,39078960,63,10375,27208,2,38721,3119,0,16,144444.0,39000.0,-65.0,-72.0,-64.0,-69.0,-64.0,-72.0,-64.0,-69.0,-73.0,-81.0,-73.0,-82.0,8.0,9.0,9.0,13.0,1
1073,CC:2F:71:3E:C5:1F,2151326,272933005,59,7197,2151267,272925808,0,274,23303,231,18031,43,5272,67,1,98,6,0,13,144444.0,43333.0,-69.0,-69.0,-66.0,-60.0,-68.0,-69.0,-65.0,-59.0,-73.0,-81.0,-73.0,-82.0,4.0,12.0,7.0,22.0,1
1074,CC:2F:71:3F:1F:24,2288199,453190679,136932,180264871,2151267,272925808,3,96556,113690221,96494,113682371,62,7850,93203,331,136962,25466,3,57,130000.0,43333.0,-68.0,-65.0,-68.0,-67.0,-66.0,-64.0,-66.0,-67.0,-73.0,-81.0,-73.0,-82.0,5.0,16.0,5.0,15.0,1
1075,F8:59:71:5A:E0:3D,2190040,331923981,38772,58998113,2151268,272925868,0,27415,39183275,27352,39172900,63,10375,27269,2,38783,3132,0,16,144444.0,43333.0,-66.0,-73.0,-63.0,-69.0,-64.0,-72.0,-64.0,-68.0,-73.0,-81.0,-73.0,-82.0,7.0,8.0,10.0,13.0,1
1076,CC:2F:71:3E:C5:1F,2151327,272933065,59,7197,2151268,272925868,0,274,23303,231,18031,43,5272,67,1,98,6,0,13,144444.0,43333.0,-69.0,-69.0,-66.0,-60.0,-68.0,-69.0,-65.0,-59.0,-72.0,-81.0,-72.0,-82.0,3.0,12.0,6.0,22.0,1
1077,CC:2F:71:3F:1F:24,2288358,453394053,137088,180467983,2151270,272926070,3,96700,113887421,96638,113879571,62,7850,93347,331,137120,25469,3,57,130000.0,43333.0,-67.0,-64.0,-67.0,-67.0,-66.0,-64.0,-66.0,-67.0,-72.0,-81.0,-72.0,-82.0,5.0,17.0,5.0,15.0,1
1078,F8:59:71:5A:E0:3D,2190107,332022175,38835,59095903,2151272,272926272,0,27479,39281835,27416,39271460,63,10375,27333,2,38846,3154,0,16,144444.0,43333.0,-65.0,-72.0,-64.0,-69.0,-64.0,-71.0,-64.0,-68.0,-72.0,-81.0,-72.0,-82.0,7.0,9.0,8.0,13.0,1
1079,CC:2F:71:3E:C5:1F,2151333,272933671,59,7197,2151274,272926474,0,274,23303,231,18031,43,5272,67,1,98,6,0,13,144444.0,43333.0,-69.0,-69.0,-66.0,-60.0,-68.0,-69.0,-65.0,-59.0,-72.0,-81.0,-72.0,-82.0,3.0,12.0,6.0,22.0,1
1080,CC:2F:71:3F:1F:24,2288520,453600677,137246,180674203,2151274,272926474,3,96843,114084505,96781,114076655,62,7850,93490,331,137278,25475,3,57,130000.0,43333.0,-66.0,-64.0,-66.0,-67.0,-66.0,-64.0,-66.0,-67.0,-72.0,-81.0,-72.0,-82.0,6.0,17.0,6.0,15.0,1
1081,F8:59:71:5A:E0:3D,2190275,332273828,38999,59347152,2151276,272926676,0,27554,39383565,27491,39373190,63,10375,27408,2,39010,3209,0,16,144444.0,43333.0,-64.0,-72.0,-64.0,-69.0,-65.0,-72.0,-64.0,-68.0,-72.0,-81.0,-72.0,-82.0,8.0,9.0,8.0,13.0,1
1082,CC:2F:71:3E:C5:1F,2151335,272933873,59,7197,2151276,272926676,0,274,23303,231,18031,43,5272,67,1,98,6,0,13,144444.0,43333.0,-69.0,-69.0,-66.0,-60.0,-68.0,-69.0,-65.0,-59.0,-72.0,-81.0,-72.0,-82.0,3.0,12.0,6.0,22.0,1
1083,CC:2F:71:3F:1F:24,2288687,453810292,137411,180883616,2151276,272926676,3,96995,114283125,96933,114275275,62,7850,93642,331,137443,25489,3,57,130000.0,43333.0,-67.0,-64.0,-67.0,-67.0,-66.0,-64.0,-65.0,-67.0,-72.0,-81.0,-72.0,-82.0,5.0,17.0,5.0,15.0,1
1084,F8:59:71:5A:E0:3D,2190374,332413717,39093,59486577,2151281,272927140,0,27626,39486771,27563,39476396,63,10375,27480,2,39104,3227,0,16,144444.0,43333.0,-65.0,-72.0,-65.0,-69.0,-64.0,-71.0,-64.0,-68.0,-72.0,-81.0,-72.0,-82.0,7.0,9.0,7.0,13.0,1
1085,CC:2F:71:3E:C5:1F,2151340,272934337,59,7197,2151281,272927140,0,274,23303,231,18031,43,5272,67,1,98,6,0,13,144444.0,43333.0,-69.0,-69.0,-66.0,-60.0,-68.0,-69.0,-65.0,-59.0,-72.0,-81.0,-72.0,-82.0,3.0,12.0,6.0,22.0,1
1086,CC:2F:71:3F:1F:24,2288850,454016864,137569,181089724,2151281,272927140,3,97139,114480325,97077,114472475,62,7850,93786,331,137601,25516,3,57,144444.0,39000.0,-67.0,-64.0,-66.0,-67.0,-66.0,-64.0,-65.0,-67.0,-72.0,-81.0,-72.0,-82.0,5.0,17.0,6.0,15.0,1
1087,F8:59:71:5A:E0:3D,2190442,332513465,39157,59585921,2151285,272927544,0,27690,39585331,27627,39574956,63,10375,27544,2,39168,3247,0,16,144444.0,43333.0,-64.0,-71.0,-65.0,-68.0,-64.0,-71.0,-64.0,-68.0,-72.0,-81.0,-72.0,-82.0,8.0,10.0,7.0,14.0,1
1088,CC:2F:71:3E:C5:1F,2151344,272934741,59,7197,2151285,272927544,0,274,23303,231,18031,43,5272,67,1,98,6,0,13,144444.0,43333.0,-69.0,-69.0,-66.0,-60.0,-68.0,-69.0,-65.0,-59.0,-72.0,-81.0,-72.0,-82.0,3.0,12.0,6.0,22.0,1
1089,CC:2F:71:3F:1F:24,2289011,454223246,137726,181295702,2151285,272927544,3,97282,114675985,97220,114668135,62,7850,93929,331,137758,25521,3,57,130000.0,43333.0,-63.0,-64.0,-63.0,-67.0,-65.0,-64.0,-64.0,-67.0,-72.0,-81.0,-72.0,-82.0,9.0,17.0,9.0,15.0,1
1090,F8:59:71:5A:E0:3D,2190513,332613674,39224,59685726,2151289,272927948,0,27756,39684523,27693,39674148,63,10375,27610,2,39235,3273,0,16,144444.0,43333.0,-65.0,-71.0,-65.0,-69.0,-64.0,-71.0,-64.0,-69.0,-72.0,-81.0,-72.0,-82.0,7.0,10.0,7.0,13.0,1
1091,CC:2F:71:3E:C5:1F,2151348,272935145,59,7197,2151289,272927948,0,274,23303,231,18031,43,5272,67,1,98,6,0,13,144444.0,43333.0,-69.0,-69.0,-66.0,-60.0,-68.0,-69.0,-65.0,-59.0,-72.0,-81.0,-72.0,-82.0,3.0,12.0,6.0,22.0,1
1092,CC:2F:71:3F:1F:24,2289173,454429870,137884,181501922,2151289,272927948,3,97426,114874609,97364,114866759,62,7850,94073,331,137916,25522,3,57,130000.0,43333.0,-66.0,-65.0,-64.0,-68.0,-66.0,-64.0,-64.0,-67.0,-72.0,-81.0,-72.0,-82.0,6.0,16.0,8.0,14.0,1
1093,F8:59:71:5A:E0:3D,2190581,332711536,39287,59783124,2151294,272928412,0,27813,39772345,27750,39761970,63,10375,27667,2,39298,3308,0,16,144444.0,1000.0,-65.0,-72.0,-63.0,-68.0,-63.0,-71.0,-63.0,-68.0,-72.0,-81.0,-72.0,-82.0,7.0,9.0,9.0,14.0,1
1094,CC:2F:71:3E:C5:1F,2151353,272935609,59,7197,2151294,272928412,0,274,23303,231,18031,43,5272,67,1,98,6,0,13,144444.0,43333.0,-69.0,-69.0,-66.0,-60.0,-68.0,-69.0,-65.0,-59.0,-72.0,-81.0,-72.0,-82.0,3.0,12.0,6.0,22.0,1
1095,CC:2F:71:3F:1F:24,2289407,454735012,138113,181806600,2151294,272928412,3,97628,115145989,97566,115138139,62,7850,94275,331,138144,25586,3,57,130000.0,43333.0,-67.0,-63.0,-67.0,-66.0,-66.0,-63.0,-66.0,-66.0,-72.0,-81.0,-72.0,-82.0,5.0,18.0,5.0,16.0,1
1096,F8:59:71:5A:E0:3D,2190680,332858562,39382,59929746,2151298,272928816,0,27914,39928319,27851,39917944,63,10375,27768,2,39393,3407,0,16,144444.0,43333.0,-64.0,-71.0,-63.0,-68.0,-63.0,-70.0,-63.0,-68.0,-72.0,-81.0,-72.0,-82.0,8.0,10.0,9.0,14.0,1
1097,CC:2F:71:3E:C5:1F,2151359,272936215,59,7197,2151300,272929018,0,274,23303,231,18031,43,5272,67,1,98,6,0,13,144444.0,43333.0,-69.0,-69.0,-66.0,-60.0,-68.0,-69.0,-65.0,-59.0,-72.0,-81.0,-72.0,-82.0,3.0,12.0,6.0,22.0,1
1098,CC:2F:71:3F:1F:24,2289602,454969131,138302,182040113,2151300,272929018,3,97811,115390933,97749,115383083,62,7850,94458,331,138335,25683,3,57,130000.0,43333.0,-64.0,-64.0,-64.0,-67.0,-64.0,-64.0,-65.0,-66.0,-72.0,-81.0,-72.0,-82.0,8.0,17.0,8.0,15.0,1
1099,F8:59:71:5A:E0:3D,2190755,332966406,39452,60037126,2151303,272929280,0,27968,40011479,27905,40001104,63,10375,27822,3,39465,3503,0,16,130000.0,43333.0,-63.0,-70.0,-63.0,-69.0,-63.0,-70.0,-63.0,-68.0,-72.0,-81.0,-72.0,-82.0,9.0,11.0,9.0,13.0,1
1100,CC:2F:71:3E:C5:1F,2151362,272936477,59,7197,2151303,272929280,0,274,23303,231,18031,43,5272,67,1,98,6,0,13,144444.0,43333.0,-69.0,-69.0,-66.0,-60.0,-68.0,-69.0,-65.0,-59.0,-72.0,-81.0,-72.0,-82.0,3.0,12.0,6.0,22.0,1
1101,CC:2F:71:3F:1F:24,2289778,455197403,138475,182268123,2151303,272929280,3,97976,115620499,97914,115612649,62,7850,94622,331,138508,25786,3,57,130000.0,43333.0,-64.0,-64.0,-58.0,-67.0,-64.0,-64.0,-63.0,-66.0,-72.0,-81.0,-72.0,-82.0,8.0,17.0,14.0,15.0,1
1102,F8:59:71:5A:E0:3D,2190860,333115887,39548,60185526,2151312,272930361,0,28070,40169413,28007,40159038,63,10375,27924,4,39563,3614,0,16,104000.0,26000.0,-64.0,-71.0,-62.0,-68.0,-63.0,-69.0,-62.0,-68.0,-72.0,-80.0,-72.0,-81.0,8.0,9.0,10.0,13.0,1
1103,CC:2F:71:3E:C5:1F,2151371,272937558,59,7197,2151312,272930361,0,274,23303,231,18031,43,5272,67,1,98,6,0,13,144444.0,43333.0,-69.0,-69.0,-66.0,-60.0,-68.0,-69.0,-65.0,-59.0,-72.0,-80.0,-72.0,-81.0,3.0,11.0,6.0,21.0,1
1104,CC:2F:71:3F:1F:24,2290002,455491954,138690,182561593,2151312,272930361,3,98209,115949737,98147,115941887,62,7850,94855,331,138724,25979,3,57,86667.0,1000.0,-65.0,-64.0,-65.0,-66.0,-64.0,-64.0,-64.0,-67.0,-72.0,-80.0,-72.0,-81.0,7.0,16.0,7.0,15.0,1
1105,F8:59:71:5A:E0:3D,2191093,333444804,39776,60513979,2151317,272930825,0,28191,40312791,28128,40302416,63,10375,28039,4,39793,3905,0,16,78000.0,13000.0,-63.0,-70.0,-63.0,-68.0,-63.0,-70.0,-63.0,-68.0,-72.0,-80.0,-72.0,-81.0,9.0,10.0,9.0,13.0,1
1106,CC:2F:71:3E:C5:1F,2151376,272938022,59,7197,2151317,272930825,0,274,23303,231,18031,43,5272,67,1,98,6,0,13,144444.0,43333.0,-69.0,-69.0,-66.0,-60.0,-68.0,-69.0,-65.0,-59.0,-72.0,-80.0,-72.0,-81.0,3.0,11.0,6.0,21.0,1
1107,CC:2F:71:3F:1F:24,2290214,455765581,138895,182834388,2151319,272931193,3,98379,116178503,98317,116170653,62,7850,95025,331,138928,26143,3,57,115556.0,26000.0,-64.0,-64.0,-64.0,-66.0,-64.0,-63.0,-64.0,-66.0,-72.0,-80.0,-72.0,-81.0,8.0,16.0,8.0,15.0,1
1108,F8:59:71:5A:E0:3D,2191182,333567132,39859,60635535,2151323,272931597,0,28280,40443372,28217,40432997,63,10375,28128,6,39880,4022,0,16,86667.0,13000.0,-62.0,-70.0,-64.0,-68.0,-63.0,-70.0,-63.0,-67.0,-72.0,-80.0,-72.0,-81.0,10.0,10.0,8.0,13.0,1
1109,CC:2F:71:3E:C5:1F,2151382,272938794,59,7197,2151323,272931597,0,274,23303,231,18031,43,5272,67,1,98,6,0,13,144444.0,43333.0,-69.0,-69.0,-66.0,-60.0,-68.0,-69.0,-65.0,-59.0,-72.0,-80.0,-72.0,-81.0,3.0,11.0,6.0,21.0,1
1110,CC:2F:71:3F:1F:24,2290409,456021111,139086,183089514,2151323,272931597,3,98550,116416333,98488,116408483,62,7850,95196,331,139120,26416,3,57,144444.0,39000.0,-65.0,-64.0,-62.0,-67.0,-64.0,-63.0,-64.0,-66.0,-72.0,-80.0,-72.0,-81.0,7.0,16.0,10.0,14.0,1
1111,F8:59:71:5A:E0:3D,2191276,333701540,39946,60769277,2151330,272932263,0,28362,40569956,28299,40559581,63,10375,28210,6,39966,4115,0,17,78000.0,13000.0,-64.0,-71.0,-62.0,-68.0,-63.0,-70.0,-63.0,-68.0,-72.0,-80.0,-72.0,-81.0,8.0,9.0,10.0,13.0,1
1112,CC:2F:71:3E:C5:1F,2151391,272939662,59,7197,2151332,272932465,0,274,23303,231,18031,43,5272,67,1,98,6,0,13,144444.0,43333.0,-69.0,-69.0,-66.0,-60.0,-68.0,-69.0,-65.0,-59.0,-72.0,-80.0,-72.0,-81.0,3.0,11.0,6.0,21.0,1
1113,CC:2F:71:3F:1F:24,2290720,456443569,139388,183511104,2151332,272932465,3,98874,116876425,98812,116868575,62,7850,95518,331,139421,26619,3,58,130000.0,39000.0,-65.0,-64.0,-65.0,-66.0,-63.0,-64.0,-63.0,-66.0,-72.0,-80.0,-72.0,-81.0,7.0,16.0,7.0,15.0,1
1114,F8:59:71:5A:E0:3D,2191616,334210367,40278,61277296,2151338,272933071,0,28545,40800879,28482,40790504,63,10375,28384,6,40296,4455,0,17,104000.0,26000.0,-65.0,-71.0,-62.0,-68.0,-63.0,-70.0,-62.0,-68.0,-72.0,-80.0,-72.0,-81.0,7.0,9.0,10.0,13.0,1
1115,CC:2F:71:3E:C5:1F,2151397,272940268,59,7197,2151338,272933071,0,274,23303,231,18031,43,5272,67,1,98,6,0,13,144444.0,43333.0,-69.0,-69.0,-66.0,-60.0,-68.0,-69.0,-65.0,-59.0,-72.0,-80.0,-72.0,-81.0,3.0,11.0,6.0,21.0,1
1116,CC:2F:71:3F:1F:24,2291343,457264272,140002,184330939,2151341,272933333,3,99247,117207249,99185,117199399,62,7850,95861,331,140033,26816,3,58,130000.0,43333.0,-65.0,-65.0,-65.0,-68.0,-64.0,-64.0,-64.0,-67.0,-72.0,-80.0,-72.0,-81.0,7.0,15.0,7.0,13.0,1
1117,F8:59:71:5A:E0:3D,2191737,334385226,40396,61451893,2151341,272933333,0,28643,40943191,28580,40932816,63,10375,28482,6,40418,4631,0,20,104000.0,26000.0,-62.0,-70.0,-63.0,-68.0,-62.0,-70.0,-63.0,-68.0,-71.0,-80.0,-71.0,-81.0,9.0,10.0,8.0,13.0,1
1118,CC:2F:71:3E:C5:1F,2151400,272940530,59,7197,2151341,272933333,0,274,23303,231,18031,43,5272,67,1,98,6,0,13,144444.0,43333.0,-69.0,-69.0,-66.0,-60.0,-68.0,-69.0,-65.0,-59.0,-71.0,-80.0,-71.0,-81.0,2.0,11.0,5.0,21.0,1
1119,CC:2F:71:3F:1F:24,2291563,457553794,140222,184620461,2151341,272933333,3,99445,117450339,99383,117442489,62,7850,96049,331,140256,26860,3,58,144444.0,43333.0,-65.0,-64.0,-65.0,-67.0,-64.0,-64.0,-64.0,-67.0,-71.0,-80.0,-71.0,-81.0,6.0,16.0,6.0,14.0,1
1120,F8:59:71:5A:E0:3D,2191808,334485778,40461,61551839,2151347,272933939,0,28708,41043459,28645,41033084,63,10375,28547,8,40485,4715,0,20,117000.0,1000.0,-65.0,-71.0,-62.0,-69.0,-63.0,-70.0,-63.0,-68.0,-71.0,-80.0,-71.0,-81.0,6.0,9.0,9.0,12.0,1
1121,CC:2F:71:3E:C5:1F,2151406,272941136,59,7197,2151347,272933939,0,274,23303,231,18031,43,5272,67,1,98,6,0,13,144444.0,43333.0,-69.0,-69.0,-66.0,-60.0,-68.0,-69.0,-65.0,-59.0,-71.0,-80.0,-71.0,-81.0,2.0,11.0,5.0,21.0,1
1122,CC:2F:71:3F:1F:24,2291921,458025314,140572,185091173,2151349,272934141,3,99681,117692512,99619,117684662,62,7850,96278,331,140607,27001,3,58,130000.0,43333.0,-65.0,-65.0,-65.0,-67.0,-64.0,-64.0,-64.0,-67.0,-71.0,-80.0,-71.0,-81.0,6.0,15.0,6.0,14.0,1
1123,F8:59:71:5A:E0:3D,2191901,334620240,40551,61686039,2151350,272934201,0,28792,41169353,28729,41158978,63,10375,28631,8,40577,4824,0,22,78000.0,13000.0,-64.0,-70.0,-63.0,-68.0,-63.0,-69.0,-63.0,-68.0,-71.0,-80.0,-71.0,-81.0,7.0,10.0,8.0,13.0,1
1124,CC:2F:71:3E:C5:1F,2151413,272941802,59,7197,2151354,272934605,0,274,23303,231,18031,43,5272,67,1,98,6,0,13,144444.0,43333.0,-69.0,-69.0,-66.0,-60.0,-68.0,-69.0,-65.0,-59.0,-71.0,-80.0,-71.0,-81.0,2.0,11.0,5.0,21.0,1
1125,CC:2F:71:3F:1F:24,2292337,458580319,140983,185645714,2151354,272934605,3,99990,118025742,99928,118017892,62,7850,96575,331,141007,27073,3,58,144444.0,39000.0,-63.0,-64.0,-64.0,-66.0,-64.0,-64.0,-64.0,-67.0,-71.0,-80.0,-71.0,-81.0,8.0,16.0,7.0,15.0,1
1126,F8:59:71:5A:E0:3D,2192024,334796640,40666,61861631,2151358,272935009,0,28916,41359831,28853,41349456,63,10375,28749,10,40694,5014,0,25,78000.0,1000.0,-65.0,-72.0,-62.0,-68.0,-63.0,-70.0,-62.0,-68.0,-71.0,-80.0,-71.0,-81.0,6.0,8.0,9.0,13.0,1
1127,CC:2F:71:3E:C5:1F,2151417,272942206,59,7197,2151358,272935009,0,276,23443,233,18171,43,5272,67,1,99,6,0,13,144444.0,43333.0,-66.0,-61.0,-63.0,-59.0,-68.0,-68.0,-64.0,-59.0,-71.0,-80.0,-71.0,-81.0,5.0,19.0,8.0,22.0,1
1128,CC:2F:71:3F:1F:24,2292627,458959155,141267,186023944,2151360,272935211,3,100286,118425148,100224,118417298,62,7850,96853,331,141302,27286,3,58,130000.0,39000.0,-64.0,-64.0,-59.0,-68.0,-64.0,-64.0,-64.0,-66.0,-71.0,-80.0,-71.0,-81.0,7.0,16.0,12.0,13.0,1
1129,F8:59:71:5A:E0:3D,2192117,334927664,40752,61991989,2151365,272935675,0,29001,41489325,28938,41478950,63,10375,28834,10,40784,5108,0,25,130000.0,39000.0,-64.0,-71.0,-62.0,-68.0,-63.0,-70.0,-63.0,-68.0,-71.0,-80.0,-71.0,-80.0,7.0,9.0,9.0,12.0,1
1130,CC:2F:71:3E:C5:1F,2151426,272943074,59,7197,2151367,272935877,0,276,23443,233,18171,43,5272,67,1,99,6,0,13,144444.0,43333.0,-66.0,-61.0,-63.0,-59.0,-68.0,-68.0,-64.0,-59.0,-71.0,-80.0,-71.0,-80.0,5.0,19.0,8.0,21.0,1
1131,CC:2F:71:3F:1F:24,2292802,459179751,141435,186243874,2151367,272935877,3,100448,118650156,100386,118642306,62,7850,97008,331,141470,27337,3,58,130000.0,43333.0,-63.0,-64.0,-61.0,-67.0,-64.0,-64.0,-63.0,-66.0,-71.0,-80.0,-71.0,-80.0,8.0,16.0,10.0,13.0,1
1132,F8:59:71:5A:E0:3D,2192390,335348240,41023,62412363,2151367,272935877,0,29103,41616429,29040,41606054,63,10375,28936,10,41055,5228,0,26,144444.0,43333.0,-64.0,-71.0,-62.0,-69.0,-63.0,-70.0,-63.0,-68.0,-71.0,-80.0,-71.0,-80.0,7.0,9.0,9.0,11.0,1
1133,CC:2F:71:3E:C5:1F,2151430,272943609,60,7257,2151370,272936352,0,278,23583,235,18311,43,5272,67,1,101,6,0,13,130000.0,1000.0,-66.0,-69.0,-64.0,-60.0,-67.0,-68.0,-64.0,-59.0,-71.0,-80.0,-71.0,-80.0,5.0,11.0,7.0,20.0,1
1134,CC:2F:71:3F:1F:24,2292985,459420396,141615,186484044,2151370,272936352,3,100619,118890654,100557,118882804,62,7850,97172,331,141650,27376,3,58,130000.0,39000.0,-65.0,-64.0,-66.0,-66.0,-63.0,-64.0,-63.0,-66.0,-71.0,-80.0,-71.0,-80.0,6.0,16.0,5.0,14.0,1
1135,F8:59:71:5A:E0:3D,2192599,335655201,41222,62718183,2151377,272937018,0,29199,41745239,29136,41734864,63,10375,29031,10,41254,5324,0,28,115556.0,28889.0,-64.0,-71.0,-63.0,-68.0,-63.0,-70.0,-62.0,-68.0,-71.0,-80.0,-71.0,-80.0,7.0,9.0,8.0,12.0,1
1136,CC:2F:71:3E:C5:1F,2151437,272944275,60,7257,2151377,272937018,0,278,23583,235,18311,43,5272,67,1,101,6,0,13,130000.0,1000.0,-66.0,-69.0,-64.0,-60.0,-67.0,-68.0,-64.0,-59.0,-71.0,-80.0,-71.0,-80.0,5.0,11.0,7.0,20.0,1
1137,CC:2F:71:3F:1F:24,2293189,459680913,141812,186743895,2151377,272937018,3,100816,119154656,100754,119146806,62,7850,97355,331,141849,27525,3,58,115556.0,28889.0,-65.0,-64.0,-66.0,-66.0,-64.0,-64.0,-64.0,-66.0,-71.0,-80.0,-71.0,-80.0,6.0,16.0,5.0,14.0,1
1138,F8:59:71:5A:E0:3D,2192662,335752263,41285,62815245,2151377,272937018,0,29262,41842259,29199,41831884,63,10375,29094,10,41318,5368,0,28,130000.0,39000.0,-65.0,-71.0,-62.0,-69.0,-63.0,-70.0,-63.0,-68.0,-71.0,-80.0,-71.0,-80.0,6.0,9.0,9.0,11.0,1
1139,CC:2F:71:3E:C5:1F,2151437,272944275,60,7257,2151377,272937018,0,278,23583,235,18311,43,5272,67,1,101,6,0,13,130000.0,1000.0,-66.0,-69.0,-64.0,-60.0,-67.0,-68.0,-64.0,-59.0,-71.0,-80.0,-71.0,-80.0,5.0,11.0,7.0,20.0,1
1140,CC:2F:71:3F:1F:24,2293350,459888781,141971,186951561,2151379,272937220,3,100964,119359501,100902,119351651,62,7850,97499,331,142007,27564,3,58,115556.0,28889.0,-65.0,-64.0,-61.0,-66.0,-64.0,-64.0,-63.0,-66.0,-71.0,-80.0,-71.0,-80.0,6.0,16.0,10.0,14.0,1
1141,F8:59:71:5A:E0:3D,2192735,335853185,41350,62915359,2151385,272937826,0,29328,41941015,29265,41930640,63,10375,29158,11,41384,5424,0,28,144444.0,39000.0,-65.0,-71.0,-62.0,-69.0,-64.0,-70.0,-63.0,-68.0,-71.0,-79.0,-71.0,-80.0,6.0,8.0,9.0,11.0,1
1142,CC:2F:71:3E:C5:1F,2151445,272945083,60,7257,2151385,272937826,0,278,23583,235,18311,43,5272,67,1,101,6,0,13,130000.0,1000.0,-66.0,-69.0,-64.0,-60.0,-67.0,-68.0,-64.0,-59.0,-71.0,-79.0,-71.0,-80.0,5.0,10.0,7.0,20.0,1
1143,CC:2F:71:3F:1F:24,2293516,460099243,142131,187161417,2151385,272937826,3,101121,119575551,101059,119567701,62,7850,97647,331,142168,27617,3,58,130000.0,39000.0,-65.0,-64.0,-65.0,-66.0,-63.0,-64.0,-64.0,-66.0,-71.0,-79.0,-71.0,-80.0,6.0,15.0,6.0,14.0,1
1144,F8:59:71:5A:E0:3D,2192801,335953527,41415,63015641,2151386,272937886,0,29394,42042655,29331,42032280,63,10375,29224,11,41450,5476,0,28,130000.0,1000.0,-63.0,-70.0,-63.0,-69.0,-63.0,-70.0,-63.0,-68.0,-71.0,-79.0,-71.0,-80.0,8.0,9.0,8.0,11.0,1
1145,CC:2F:71:3E:C5:1F,2151446,272945143,60,7257,2151386,272937886,0,278,23583,235,18311,43,5272,67,1,101,6,0,13,130000.0,1000.0,-66.0,-69.0,-64.0,-60.0,-67.0,-68.0,-64.0,-59.0,-71.0,-79.0,-71.0,-80.0,5.0,10.0,7.0,20.0,1
1146,CC:2F:71:3F:1F:24,2293695,460316958,142309,187379072,2151386,272937886,3,101295,119801309,101233,119793459,62,7850,97810,331,142346,27669,3,58,130000.0,43333.0,-64.0,-64.0,-65.0,-66.0,-64.0,-64.0,-64.0,-66.0,-71.0,-79.0,-71.0,-80.0,7.0,15.0,6.0,14.0,1
1147,F8:59:71:5A:E0:3D,2192871,336052917,41479,63114425,2151392,272938492,0,29458,42141215,29395,42130840,63,10375,29288,12,41515,5530,0,28,144444.0,39000.0,-64.0,-71.0,-63.0,-69.0,-64.0,-71.0,-64.0,-68.0,-71.0,-79.0,-71.0,-80.0,7.0,8.0,8.0,11.0,1
1148,CC:2F:71:3E:C5:1F,2151454,272945951,60,7257,2151394,272938694,0,278,23583,235,18311,43,5272,67,1,101,6,0,13,130000.0,1000.0,-66.0,-69.0,-64.0,-60.0,-67.0,-68.0,-64.0,-59.0,-71.0,-79.0,-71.0,-80.0,5.0,10.0,7.0,20.0,1
1149,CC:2F:71:3F:1F:24,2293866,460525549,142472,187586855,2151394,272938694,3,101447,120001392,101385,119993542,62,7850,97959,331,142509,27702,3,58,130000.0,43333.0,-67.0,-64.0,-67.0,-67.0,-66.0,-64.0,-65.0,-66.0,-71.0,-79.0,-71.0,-80.0,4.0,15.0,4.0,13.0,1
1150,F8:59:71:5A:E0:3D,2192937,336151027,41542,63212271,2151395,272938756,0,29520,42236695,29457,42226320,63,10375,29350,12,41578,5536,0,28,144444.0,43333.0,-66.0,-73.0,-65.0,-69.0,-65.0,-72.0,-65.0,-69.0,-71.0,-79.0,-71.0,-80.0,5.0,6.0,6.0,11.0,1
1151,CC:2F:71:3E:C5:1F,2151455,272946013,60,7257,2151395,272938756,0,279,23701,235,18311,44,5390,68,1,101,6,0,13,130000.0,1000.0,-70.0,-70.0,-65.0,-60.0,-67.0,-68.0,-64.0,-59.0,-71.0,-79.0,-71.0,-80.0,1.0,9.0,6.0,20.0,1
1152,CC:2F:71:3F:1F:24,2294025,460733031,142630,187794275,2151395,272938756,3,101594,120204678,101532,120196828,62,7850,98103,331,142667,27718,3,58,130000.0,43333.0,-69.0,-65.0,-66.0,-67.0,-68.0,-64.0,-67.0,-67.0,-71.0,-79.0,-71.0,-80.0,2.0,14.0,5.0,13.0,1
1153,F8:59:71:5A:E0:3D,2193113,336399608,41711,63460186,2151402,272939422,0,29604,42345380,29541,42335005,63,10375,29434,12,41746,5537,0,28,144444.0,43333.0,-66.0,-73.0,-65.0,-69.0,-65.0,-72.0,-64.0,-69.0,-71.0,-79.0,-71.0,-80.0,5.0,6.0,6.0,11.0,1
1154,CC:2F:71:3E:C5:1F,2151462,272946679,60,7257,2151402,272939422,0,280,23771,236,18381,44,5390,68,1,101,6,0,13,130000.0,1000.0,-70.0,-70.0,-66.0,-60.0,-68.0,-68.0,-64.0,-59.0,-71.0,-79.0,-71.0,-80.0,1.0,9.0,5.0,20.0,1
1155,CC:2F:71:3F:1F:24,2294188,460938233,142786,187998811,2151402,272939422,3,101743,120411228,101681,120403378,62,7850,98245,331,142823,27718,3,58,130000.0,43333.0,-68.0,-64.0,-68.0,-67.0,-67.0,-64.0,-67.0,-67.0,-71.0,-79.0,-71.0,-80.0,3.0,15.0,3.0,13.0,1
1156,F8:59:71:5A:E0:3D,2193222,336556650,41817,63616964,2151405,272939686,0,29678,42448738,29615,42438363,63,10375,29508,12,41853,5537,0,28,144444.0,43333.0,-66.0,-72.0,-64.0,-70.0,-66.0,-72.0,-64.0,-69.0,-71.0,-79.0,-71.0,-80.0,5.0,7.0,7.0,10.0,1
1157,CC:2F:71:3E:C5:1F,2151465,272946943,60,7257,2151405,272939686,0,280,23771,236,18381,44,5390,68,1,101,6,0,13,130000.0,1000.0,-70.0,-70.0,-66.0,-60.0,-68.0,-68.0,-64.0,-59.0,-71.0,-79.0,-71.0,-80.0,1.0,9.0,5.0,20.0,1
1158,CC:2F:71:3F:1F:24,2294349,461144703,142944,188205017,2151405,272939686,3,101896,120618120,101833,120610152,63,7968,98390,331,142981,27720,3,59,130000.0,43333.0,-68.0,-64.0,-68.0,-69.0,-67.0,-64.0,-67.0,-69.0,-71.0,-79.0,-71.0,-80.0,3.0,15.0,3.0,11.0,1
1159,F8:59:71:5A:E0:3D,2193290,336653604,41879,63713312,2151411,272940292,0,29741,42545758,29678,42535383,63,10375,29571,12,41915,5537,0,28,144444.0,43333.0,-67.0,-73.0,-66.0,-70.0,-66.0,-72.0,-65.0,-70.0,-71.0,-79.0,-71.0,-80.0,4.0,6.0,5.0,10.0,1
1160,CC:2F:71:3E:C5:1F,2151471,272947549,60,7257,2151411,272940292,0,280,23771,236,18381,44,5390,68,1,101,6,0,13,130000.0,1000.0,-70.0,-70.0,-66.0,-60.0,-68.0,-68.0,-64.0,-59.0,-71.0,-79.0,-71.0,-80.0,1.0,9.0,5.0,20.0,1
1161,CC:2F:71:3F:1F:24,2294523,461356142,143112,188415850,2151411,272940292,3,102054,120826063,101991,120818095,63,7968,98542,331,143148,27771,3,59,130000.0,43333.0,-68.0,-65.0,-68.0,-69.0,-66.0,-64.0,-67.0,-68.0,-71.0,-79.0,-71.0,-80.0,3.0,14.0,3.0,11.0,1
1162,F8:59:71:5A:E0:3D,2193357,336753322,41943,63812768,2151414,272940554,0,29805,42644318,29742,42633943,63,10375,29635,12,41979,5537,0,28,144444.0,43333.0,-66.0,-73.0,-64.0,-70.0,-65.0,-72.0,-65.0,-69.0,-71.0,-79.0,-71.0,-80.0,5.0,6.0,7.0,10.0,1
1163,CC:2F:71:3E:C5:1F,2151474,272947811,60,7257,2151414,272940554,0,280,23771,236,18381,44,5390,68,1,101,6,0,13,130000.0,1000.0,-70.0,-70.0,-66.0,-60.0,-68.0,-68.0,-64.0,-59.0,-71.0,-79.0,-71.0,-80.0,1.0,9.0,5.0,20.0,1
1164,CC:2F:71:3F:1F:24,2294689,461564530,143275,188623976,2151414,272940554,3,102211,121036401,102148,121028433,63,7968,98693,331,143312,27831,3,59,78000.0,13000.0,-68.0,-63.0,-70.0,-69.0,-67.0,-63.0,-68.0,-69.0,-71.0,-79.0,-71.0,-80.0,3.0,16.0,1.0,11.0,1
1165,F8:59:71:5A:E0:3D,2193433,336854233,42012,63913011,2151421,272941222,0,29873,42744133,29809,42733640,64,10493,29703,12,42048,5537,0,28,144444.0,43333.0,-67.0,-73.0,-64.0,-68.0,-66.0,-72.0,-64.0,-68.0,-71.0,-79.0,-71.0,-80.0,4.0,6.0,7.0,12.0,1
1166,CC:2F:71:3E:C5:1F,2151481,272948479,60,7257,2151421,272941222,0,280,23771,236,18381,44,5390,68,1,101,6,0,13,130000.0,1000.0,-70.0,-70.0,-66.0,-60.0,-68.0,-68.0,-64.0,-59.0,-71.0,-79.0,-71.0,-80.0,1.0,9.0,5.0,20.0,1
1167,CC:2F:71:3F:1F:24,2294871,461773943,143450,188832721,2151421,272941222,3,102375,121252856,102312,121244888,63,7968,98848,331,143487,27832,3,59,86667.0,14444.0,-68.0,-64.0,-68.0,-69.0,-67.0,-63.0,-68.0,-68.0,-71.0,-79.0,-71.0,-80.0,3.0,15.0,3.0,11.0,1
1168,F8:59:71:5A:E0:3D,2193498,336952337,42075,64010913,2151423,272941424,0,29936,42841153,29872,42830660,64,10493,29766,12,42111,5537,0,28,144444.0,43333.0,-67.0,-74.0,-66.0,-70.0,-66.0,-73.0,-65.0,-69.0,-71.0,-79.0,-71.0,-80.0,4.0,5.0,5.0,10.0,1
1169,CC:2F:71:3E:C5:1F,2151484,272948741,60,7257,2151424,272941484,0,280,23771,236,18381,44,5390,68,1,101,6,0,13,130000.0,1000.0,-70.0,-70.0,-66.0,-60.0,-68.0,-68.0,-64.0,-59.0,-71.0,-79.0,-71.0,-80.0,1.0,9.0,5.0,20.0,1
1170,CC:2F:71:3F:1F:24,2295032,461981401,143608,189039917,2151424,272941484,3,102521,121456040,102458,121448072,63,7968,98990,331,143645,27834,3,59,86667.0,14444.0,-68.0,-64.0,-68.0,-69.0,-69.0,-63.0,-67.0,-69.0,-71.0,-79.0,-71.0,-80.0,3.0,15.0,3.0,11.0,1
1171,F8:59:71:5A:E0:3D,2193562,337050299,42138,64108815,2151424,272941484,0,29999,42938173,29935,42927680,64,10493,29829,12,42174,5537,0,28,144444.0,43333.0,-65.0,-73.0,-65.0,-70.0,-65.0,-73.0,-64.0,-69.0,-71.0,-79.0,-71.0,-80.0,6.0,6.0,6.0,10.0,1
1172,CC:2F:71:3E:C5:1F,2151484,272948741,60,7257,2151424,272941484,0,280,23771,236,18381,44,5390,68,1,101,6,0,13,130000.0,1000.0,-70.0,-70.0,-66.0,-60.0,-68.0,-68.0,-64.0,-59.0,-71.0,-79.0,-71.0,-80.0,1.0,9.0,5.0,20.0,1
1173,CC:2F:71:3F:1F:24,2295201,462187091,143771,189245001,2151430,272942090,3,102673,121663145,102610,121655177,63,7968,99137,331,143808,27834,3,59,130000.0,39000.0,-67.0,-64.0,-69.0,-69.0,-67.0,-64.0,-69.0,-69.0,-71.0,-79.0,-71.0,-80.0,4.0,15.0,2.0,11.0,1
1174,F8:59:71:5A:E0:3D,2193633,337149009,42201,64206717,2151432,272942292,0,30062,43035193,29998,43024700,64,10493,29892,12,42237,5537,0,28,144444.0,43333.0,-65.0,-72.0,-65.0,-68.0,-65.0,-72.0,-64.0,-68.0,-71.0,-79.0,-71.0,-80.0,6.0,7.0,6.0,12.0,1
1175,CC:2F:71:3E:C5:1F,2151492,272949549,60,7257,2151432,272942292,0,280,23771,236,18381,44,5390,68,1,101,6,0,13,130000.0,1000.0,-70.0,-70.0,-66.0,-60.0,-68.0,-68.0,-64.0,-59.0,-71.0,-79.0,-71.0,-80.0,1.0,9.0,5.0,20.0,1
1176,CC:2F:71:3F:1F:24,2295371,462397223,143938,189454658,2151433,272942565,3,102834,121871426,102771,121863458,63,7968,99292,331,143975,27845,3,59,130000.0,43333.0,-70.0,-64.0,-70.0,-69.0,-68.0,-63.0,-68.0,-69.0,-71.0,-79.0,-71.0,-80.0,1.0,15.0,1.0,11.0,1
1177,F8:59:71:5A:E0:3D,2193816,337430257,42382,64487632,2151434,272942625,0,30141,43140193,30077,43129700,64,10493,29969,12,42418,5537,0,28,144444.0,43333.0,-66.0,-74.0,-64.0,-70.0,-65.0,-73.0,-65.0,-70.0,-71.0,-79.0,-71.0,-80.0,5.0,5.0,7.0,10.0,1
1178,CC:2F:71:3E:C5:1F,2151494,272949882,60,7257,2151434,272942625,0,280,23771,236,18381,44,5390,68,1,101,6,0,13,130000.0,1000.0,-70.0,-70.0,-66.0,-60.0,-68.0,-68.0,-64.0,-59.0,-71.0,-79.0,-71.0,-80.0,1.0,9.0,5.0,20.0,1
1179,CC:2F:71:3F:1F:24,2295532,462606611,144098,189663986,2151434,272942625,3,102984,122079388,102921,122071420,63,7968,99435,331,144133,27845,3,59,130000.0,43333.0,-65.0,-65.0,-68.0,-69.0,-67.0,-64.0,-68.0,-68.0,-71.0,-79.0,-71.0,-80.0,6.0,14.0,3.0,11.0,1
1180,F8:59:71:5A:E0:3D,2193890,337529552,42450,64586321,2151440,272943231,0,30209,43241576,30145,43231083,64,10493,30034,12,42486,5537,0,28,144444.0,43333.0,-66.0,-75.0,-64.0,-70.0,-65.0,-74.0,-64.0,-70.0,-71.0,-79.0,-71.0,-80.0,5.0,4.0,7.0,10.0,1
1181,CC:2F:71:3E:C5:1F,2151502,272950690,60,7257,2151442,272943433,0,280,23771,236,18381,44,5390,68,1,101,6,0,13,130000.0,1000.0,-70.0,-70.0,-66.0,-60.0,-68.0,-68.0,-64.0,-59.0,-71.0,-79.0,-71.0,-80.0,1.0,9.0,5.0,20.0,1
1182,CC:2F:71:3F:1F:24,2295696,462810363,144254,189866930,2151442,272943433,3,103129,122281046,103066,122273078,63,7968,99577,331,144291,27845,3,59,144444.0,43333.0,-67.0,-65.0,-67.0,-73.0,-68.0,-65.0,-68.0,-71.0,-71.0,-79.0,-71.0,-80.0,4.0,14.0,4.0,7.0,1
1183,F8:59:71:5A:E0:3D,2194157,337943254,42715,64999821,2151442,272943433,0,30295,43344583,30231,43334090,64,10493,30120,12,42751,5579,0,28,144444.0,43333.0,-65.0,-73.0,-65.0,-70.0,-65.0,-73.0,-64.0,-70.0,-71.0,-79.0,-71.0,-80.0,6.0,6.0,6.0,10.0,1
1184,CC:2F:71:3E:C5:1F,2151502,272950690,60,7257,2151442,272943433,0,280,23771,236,18381,44,5390,68,1,101,6,0,13,130000.0,1000.0,-70.0,-70.0,-66.0,-60.0,-68.0,-68.0,-64.0,-59.0,-71.0,-79.0,-71.0,-80.0,1.0,9.0,5.0,20.0,1
1185,CC:2F:71:3F:1F:24,2295868,463018803,144426,190075370,2151442,272943433,3,103286,122480934,103223,122472966,63,7968,99734,331,144462,27849,3,59,144444.0,43333.0,-68.0,-65.0,-69.0,-72.0,-67.0,-65.0,-68.0,-72.0,-71.0,-79.0,-71.0,-80.0,3.0,14.0,2.0,8.0,1
1186,F8:59:71:5A:E0:3D,2194227,338041822,42778,65097723,2151449,272944099,0,30357,43440063,30293,43429570,64,10493,30182,12,42814,5580,0,28,144444.0,43333.0,-66.0,-74.0,-64.0,-71.0,-65.0,-73.0,-64.0,-70.0,-71.0,-79.0,-71.0,-80.0,5.0,5.0,7.0,9.0,1
1187,CC:2F:71:3E:C5:1F,2151509,272951356,60,7257,2151449,272944099,0,280,23771,236,18381,44,5390,68,1,101,6,0,13,130000.0,1000.0,-70.0,-70.0,-66.0,-60.0,-68.0,-68.0,-64.0,-59.0,-71.0,-79.0,-71.0,-80.0,1.0,9.0,5.0,20.0,1
1188,CC:2F:71:3F:1F:24,2296035,463224238,144586,190280139,2151449,272944099,3,103432,122676009,103369,122668041,63,7968,99880,331,144623,27849,3,59,144444.0,43333.0,-69.0,-65.0,-70.0,-72.0,-68.0,-65.0,-68.0,-72.0,-71.0,-79.0,-71.0,-80.0,2.0,14.0,1.0,8.0,1
1189,F8:59:71:5A:E0:3D,2194291,338138372,42840,65194071,2151451,272944301,0,30420,43537083,30356,43526590,64,10493,30245,12,42876,5580,0,28,144444.0,43333.0,-65.0,-73.0,-65.0,-70.0,-65.0,-73.0,-64.0,-70.0,-71.0,-79.0,-71.0,-80.0,6.0,6.0,6.0,10.0,1
1190,CC:2F:71:3E:C5:1F,2151511,272951558,60,7257,2151451,272944301,0,280,23771,236,18381,44,5390,68,1,101,6,0,13,130000.0,1000.0,-70.0,-70.0,-66.0,-60.0,-68.0,-68.0,-64.0,-59.0,-71.0,-79.0,-71.0,-80.0,1.0,9.0,5.0,20.0,1
1191,CC:2F:71:3F:1F:24,2296195,463430660,144744,190486359,2151451,272944301,3,103576,122871785,103513,122863817,63,7968,100024,331,144781,27850,3,59,144444.0,43333.0,-65.0,-65.0,-67.0,-73.0,-67.0,-65.0,-67.0,-72.0,-71.0,-79.0,-71.0,-80.0,6.0,14.0,4.0,7.0,1
1192,F8:59:71:5A:E0:3D,2194360,338236880,42903,65291973,2151457,272944907,0,30483,43634103,30419,43623610,64,10493,30308,12,42939,5580,0,28,144444.0,43333.0,-65.0,-73.0,-65.0,-71.0,-65.0,-73.0,-64.0,-70.0,-71.0,-79.0,-71.0,-80.0,6.0,6.0,6.0,9.0,1
1193,CC:2F:71:3E:C5:1F,2151517,272952164,60,7257,2151457,272944907,0,280,23771,236,18381,44,5390,68,1,101,6,0,13,130000.0,1000.0,-70.0,-70.0,-66.0,-60.0,-68.0,-68.0,-64.0,-59.0,-71.0,-79.0,-71.0,-80.0,1.0,9.0,5.0,20.0,1
1194,CC:2F:71:3F:1F:24,2296378,463647496,144921,190702589,2151457,272944907,3,103735,123073408,103672,123065440,63,7968,100183,331,144958,27850,3,59,144444.0,43333.0,-68.0,-65.0,-68.0,-72.0,-67.0,-65.0,-67.0,-72.0,-71.0,-79.0,-71.0,-80.0,3.0,14.0,3.0,8.0,1
1195,F8:59:71:5A:E0:3D,2194438,338353692,42978,65408523,2151460,272945169,0,30557,43748063,30493,43737570,64,10493,30382,12,43014,5580,0,28,144444.0,43333.0,-65.0,-73.0,-65.0,-70.0,-65.0,-73.0,-64.0,-70.0,-71.0,-79.0,-71.0,-80.0,6.0,6.0,6.0,10.0,1
1196,CC:2F:71:3E:C5:1F,2151520,272952426,60,7257,2151460,272945169,0,280,23771,236,18381,44,5390,68,1,101,6,0,13,130000.0,1000.0,-70.0,-70.0,-66.0,-60.0,-68.0,-68.0,-64.0,-59.0,-71.0,-79.0,-71.0,-80.0,1.0,9.0,5.0,20.0,1
1197,CC:2F:71:3F:1F:24,2296584,463923908,145124,190978739,2151460,272945169,3,103933,123342324,103870,123334356,63,7968,100375,331,145161,27851,3,59,144444.0,43333.0,-68.0,-65.0,-66.0,-72.0,-67.0,-64.0,-67.0,-72.0,-71.0,-79.0,-71.0,-80.0,3.0,14.0,5.0,8.0,1
1198,F8:59:71:5A:E0:3D,2194551,338513886,43085,65568111,2151466,272945775,0,30642,43871219,30578,43860726,64,10493,30467,12,43121,5581,0,28,144444.0,43333.0,-65.0,-73.0,-66.0,-71.0,-65.0,-73.0,-64.0,-70.0,-71.0,-79.0,-71.0,-80.0,6.0,6.0,5.0,9.0,1
1199,CC:2F:71:3E:C5:1F,2151526,272953032,60,7257,2151466,272945775,0,280,23771,236,18381,44,5390,68,1,101,6,0,13,130000.0,1000.0,-70.0,-70.0,-66.0,-60.0,-68.0,-68.0,-64.0,-59.0,-71.0,-79.0,-71.0,-80.0,1.0,9.0,5.0,20.0,1
1200,CC:2F:71:3F:1F:24,2296792,464179315,145326,191233540,2151466,272945775,3,104131,123584992,104068,123577024,63,7968,100564,331,145363,27856,3,59,144444.0,43333.0,-67.0,-65.0,-68.0,-71.0,-67.0,-65.0,-68.0,-71.0,-71.0,-79.0,-71.0,-80.0,4.0,14.0,3.0,9.0,1
1201,F8:59:71:5A:E0:3D,2194727,338781917,43258,65835880,2151469,272946037,0,30734,44000554,30670,43990061,64,10493,30559,12,43294,5581,0,28,144444.0,43333.0,-65.0,-73.0,-65.0,-70.0,-65.0,-73.0,-64.0,-69.0,-71.0,-79.0,-71.0,-80.0,6.0,6.0,6.0,10.0,1
1202,CC:2F:71:3E:C5:1F,2151529,272953294,60,7257,2151469,272946037,0,280,23771,236,18381,44,5390,68,1,101,6,0,13,130000.0,1000.0,-70.0,-70.0,-66.0,-60.0,-68.0,-68.0,-64.0,-59.0,-71.0,-79.0,-71.0,-80.0,1.0,9.0,5.0,20.0,1
1203,CC:2F:71:3F:1F:24,2296968,464402232,145499,191456195,2151469,272946037,3,104296,123800357,104233,123792389,63,7968,100725,331,145536,27859,3,59,144444.0,43333.0,-66.0,-64.0,-67.0,-69.0,-67.0,-64.0,-67.0,-69.0,-71.0,-79.0,-71.0,-80.0,5.0,15.0,4.0,11.0,1
1204,F8:59:71:5A:E0:3D,2194796,338880425,43321,65933782,2151475,272946643,0,30797,44097574,30733,44087081,64,10493,30622,12,43357,5581,0,28,144444.0,43333.0,-66.0,-73.0,-64.0,-71.0,-65.0,-72.0,-65.0,-70.0,-71.0,-80.0,-71.0,-81.0,5.0,7.0,7.0,10.0,1
1205,CC:2F:71:3E:C5:1F,2151535,272953900,60,7257,2151475,272946643,0,280,23771,236,18381,44,5390,68,1,101,6,0,13,130000.0,1000.0,-70.0,-70.0,-66.0,-60.0,-68.0,-68.0,-64.0,-59.0,-71.0,-80.0,-71.0,-81.0,1.0,10.0,5.0,21.0,1
1206,CC:2F:71:3F:1F:24,2297130,464605950,145655,191659307,2151475,272946643,3,104439,123997441,104376,123989473,63,7968,100868,331,145692,27869,3,59,144444.0,43333.0,-68.0,-63.0,-68.0,-73.0,-68.0,-63.0,-68.0,-73.0,-71.0,-80.0,-71.0,-81.0,3.0,17.0,3.0,8.0,1
1207,F8:59:71:5A:E0:3D,2194865,338980541,43388,66033696,2151477,272946845,0,30864,44198376,30800,44187883,64,10493,30689,12,43424,5581,0,28,144444.0,43333.0,-66.0,-73.0,-65.0,-69.0,-65.0,-72.0,-64.0,-69.0,-71.0,-80.0,-71.0,-81.0,5.0,7.0,6.0,12.0,1
1208,CC:2F:71:3E:C5:1F,2151537,272954102,60,7257,2151477,272946845,0,280,23771,236,18381,44,5390,68,1,101,6,0,13,130000.0,1000.0,-70.0,-70.0,-66.0,-60.0,-68.0,-68.0,-64.0,-59.0,-71.0,-80.0,-71.0,-81.0,1.0,10.0,5.0,21.0,1
1209,CC:2F:71:3F:1F:24,2297307,464818231,145830,191871386,2151477,272946845,3,104597,124199743,104534,124191775,63,7968,101025,331,145866,27903,3,59,130000.0,43333.0,-69.0,-63.0,-69.0,-72.0,-68.0,-63.0,-68.0,-72.0,-71.0,-80.0,-71.0,-81.0,2.0,17.0,2.0,9.0,1
1210,F8:59:71:5A:E0:3D,2194935,339079109,43451,66131598,2151484,272947511,0,30927,44295396,30863,44284903,64,10493,30752,12,43487,5581,0,28,144444.0,43333.0,-65.0,-73.0,-66.0,-69.0,-65.0,-72.0,-64.0,-69.0,-71.0,-80.0,-71.0,-81.0,6.0,7.0,5.0,12.0,1
1211,CC:2F:71:3E:C5:1F,2151544,272954768,60,7257,2151484,272947511,0,282,23911,238,18521,44,5390,68,1,102,6,0,13,130000.0,1000.0,-70.0,-70.0,-66.0,-60.0,-68.0,-68.0,-64.0,-59.0,-71.0,-80.0,-71.0,-81.0,1.0,10.0,5.0,21.0,1
1212,CC:2F:71:3F:1F:24,2297486,465027960,146002,192080449,2151484,272947511,3,104755,124399245,104692,124391277,63,7968,101183,331,146039,27987,3,59,86667.0,13000.0,-66.0,-63.0,-67.0,-69.0,-67.0,-63.0,-68.0,-69.0,-71.0,-80.0,-71.0,-81.0,5.0,17.0,4.0,12.0,1
1213,F8:59:71:5A:E0:3D,2195000,339177045,43514,66229332,2151486,272947713,0,30989,44390876,30925,44380383,64,10493,30814,12,43550,5581,0,28,144444.0,43333.0,-65.0,-72.0,-66.0,-70.0,-66.0,-72.0,-65.0,-69.0,-72.0,-80.0,-72.0,-81.0,7.0,8.0,6.0,11.0,1
1214,CC:2F:71:3E:C5:1F,2151546,272954970,60,7257,2151486,272947713,0,282,23911,238,18521,44,5390,68,1,102,6,0,13,130000.0,1000.0,-70.0,-70.0,-66.0,-60.0,-68.0,-68.0,-64.0,-59.0,-72.0,-80.0,-72.0,-81.0,2.0,10.0,6.0,21.0,1
1215,CC:2F:71:3F:1F:24,2297646,465233864,146160,192286151,2151486,272947713,3,104897,124596213,104834,124588245,63,7968,101325,331,146197,27987,3,59,86667.0,14444.0,-69.0,-63.0,-69.0,-69.0,-67.0,-63.0,-67.0,-69.0,-72.0,-80.0,-72.0,-81.0,3.0,17.0,3.0,12.0,1
1216,F8:59:71:5A:E0:3D,2195203,339473828,43710,66525236,2151493,272948592,0,31069,44494516,31005,44484023,64,10493,30894,12,43746,5581,0,28,144444.0,43333.0,-66.0,-72.0,-65.0,-71.0,-65.0,-71.0,-64.0,-70.0,-72.0,-80.0,-72.0,-81.0,6.0,8.0,7.0,10.0,1
1217,CC:2F:71:3E:C5:1F,2151554,272955909,61,7317,2151493,272948592,0,284,24051,240,18661,44,5390,68,1,103,6,0,13,130000.0,39000.0,-70.0,-71.0,-66.0,-60.0,-69.0,-71.0,-66.0,-61.0,-72.0,-80.0,-72.0,-81.0,2.0,9.0,6.0,21.0,1
1218,CC:2F:71:3F:1F:24,2297809,465437407,146316,192488815,2151493,272948592,3,105038,124790217,104975,124782249,63,7968,101466,331,146353,27987,3,59,115556.0,26000.0,-69.0,-64.0,-70.0,-72.0,-67.0,-63.0,-68.0,-71.0,-72.0,-80.0,-72.0,-81.0,3.0,16.0,2.0,9.0,1
1219,F8:59:71:5A:E0:3D,2195270,339572122,43774,66623268,2151496,272948854,0,31131,44589996,31067,44579503,64,10493,30956,12,43810,5581,0,28,144444.0,43333.0,-65.0,-72.0,-66.0,-70.0,-65.0,-71.0,-64.0,-69.0,-72.0,-80.0,-72.0,-81.0,7.0,8.0,6.0,11.0,1
1220,CC:2F:71:3E:C5:1F,2151557,272956171,61,7317,2151496,272948854,0,284,24051,240,18661,44,5390,68,1,103,6,0,13,130000.0,39000.0,-70.0,-71.0,-66.0,-60.0,-69.0,-71.0,-66.0,-61.0,-72.0,-80.0,-72.0,-81.0,2.0,9.0,6.0,21.0,1
1221,CC:2F:71:3F:1F:24,2297971,465643666,146475,192694812,2151496,272948854,3,105181,124984492,105118,124976524,63,7968,101609,331,146512,27988,3,59,144444.0,43333.0,-68.0,-64.0,-69.0,-67.0,-67.0,-64.0,-67.0,-67.0,-72.0,-80.0,-72.0,-81.0,4.0,16.0,3.0,14.0,1
1222,F8:59:71:5A:E0:3D,2195336,339669040,43836,66719616,2151500,272949424,0,31194,44687016,31130,44676523,64,10493,31019,12,43872,5581,0,28,144444.0,43333.0,-66.0,-73.0,-65.0,-69.0,-65.0,-72.0,-64.0,-69.0,-72.0,-80.0,-72.0,-81.0,6.0,7.0,7.0,12.0,1
1223,CC:2F:71:3E:C5:1F,2151561,272956741,61,7317,2151500,272949424,0,284,24051,240,18661,44,5390,68,1,103,6,0,13,130000.0,39000.0,-70.0,-71.0,-66.0,-60.0,-69.0,-71.0,-66.0,-61.0,-72.0,-80.0,-72.0,-81.0,2.0,9.0,6.0,21.0,1
1224,CC:2F:71:3F:1F:24,2298132,465847196,146630,192897570,2151502,272949626,3,105322,125178496,105259,125170528,63,7968,101750,331,146667,28019,3,59,144444.0,43333.0,-69.0,-64.0,-69.0,-69.0,-67.0,-64.0,-68.0,-68.0,-72.0,-80.0,-72.0,-81.0,3.0,16.0,3.0,12.0,1
1225,F8:59:71:5A:E0:3D,2195405,339767548,43899,66817518,2151506,272950030,0,31256,44782496,31192,44772003,64,10493,31081,12,43935,5581,0,28,144444.0,43333.0,-65.0,-72.0,-63.0,-69.0,-65.0,-71.0,-63.0,-69.0,-72.0,-80.0,-72.0,-81.0,7.0,8.0,9.0,12.0,1
1226,CC:2F:71:3E:C5:1F,2151567,272957347,61,7317,2151506,272950030,0,284,24051,240,18661,44,5390,68,1,103,6,0,13,130000.0,39000.0,-70.0,-71.0,-66.0,-60.0,-69.0,-71.0,-66.0,-61.0,-72.0,-80.0,-72.0,-81.0,2.0,9.0,6.0,21.0,1
1227,CC:2F:71:3F:1F:24,2298307,466058077,146801,193108047,2151506,272950030,3,105480,125377983,105417,125370015,63,7968,101908,331,146838,28045,3,59,130000.0,43333.0,-68.0,-63.0,-69.0,-70.0,-67.0,-63.0,-68.0,-69.0,-72.0,-80.0,-72.0,-81.0,4.0,17.0,3.0,11.0,1
1228,F8:59:71:5A:E0:3D,2195468,339863956,43961,66913866,2151507,272950090,0,31319,44879516,31255,44869023,64,10493,31144,12,43997,5581,0,28,144444.0,43333.0,-65.0,-73.0,-63.0,-70.0,-64.0,-71.0,-63.0,-69.0,-72.0,-80.0,-72.0,-81.0,7.0,7.0,9.0,11.0,1
1229,CC:2F:71:3E:C5:1F,2151570,272957609,61,7317,2151509,272950292,0,284,24051,240,18661,44,5390,68,1,103,6,0,13,130000.0,39000.0,-70.0,-71.0,-66.0,-60.0,-69.0,-71.0,-66.0,-61.0,-72.0,-80.0,-72.0,-81.0,2.0,9.0,6.0,21.0,1
1230,CC:2F:71:3F:1F:24,2298468,466264563,146959,193314271,2151509,272950292,3,105625,125576728,105562,125568760,63,7968,102053,331,146996,28045,3,59,130000.0,43333.0,-69.0,-64.0,-69.0,-69.0,-67.0,-63.0,-68.0,-68.0,-72.0,-80.0,-72.0,-81.0,3.0,16.0,3.0,12.0,1
1231,F8:59:71:5A:E0:3D,2195537,339962464,44024,67011768,2151513,272950696,0,31382,44976536,31318,44966043,64,10493,31207,12,44060,5581,0,28,144444.0,43333.0,-67.0,-72.0,-64.0,-70.0,-65.0,-72.0,-64.0,-70.0,-72.0,-81.0,-72.0,-81.0,5.0,9.0,8.0,11.0,1
1232,CC:2F:71:3E:C5:1F,2151574,272958013,61,7317,2151513,272950696,0,284,24051,240,18661,44,5390,68,1,103,6,0,13,130000.0,39000.0,-70.0,-71.0,-66.0,-60.0,-69.0,-71.0,-66.0,-61.0,-72.0,-81.0,-72.0,-81.0,2.0,10.0,6.0,21.0,1
1233,CC:2F:71:3F:1F:24,2298632,466468317,147117,193517419,2151515,272950898,3,105770,125771259,105707,125763291,63,7968,102198,331,147154,28057,3,59,130000.0,43333.0,-69.0,-63.0,-68.0,-68.0,-68.0,-63.0,-67.0,-68.0,-72.0,-81.0,-72.0,-81.0,3.0,18.0,4.0,13.0,1
1234,F8:59:71:5A:E0:3D,2196087,340822102,44572,67871204,2151515,272950898,0,31491,45080786,31427,45070293,64,10493,31316,12,44608,5582,0,28,144444.0,43333.0,-65.0,-72.0,-65.0,-71.0,-65.0,-72.0,-64.0,-71.0,-72.0,-81.0,-72.0,-81.0,7.0,9.0,7.0,10.0,1
1235,CC:2F:71:3E:C5:1F,2151576,272958215,61,7317,2151515,272950898,0,284,24051,240,18661,44,5390,68,1,103,6,0,13,130000.0,39000.0,-70.0,-71.0,-66.0,-60.0,-69.0,-71.0,-66.0,-61.0,-72.0,-81.0,-72.0,-81.0,2.0,10.0,6.0,21.0,1
1236,CC:2F:71:3F:1F:24,2298790,466671728,147275,193720830,2151515,272950898,3,105915,125965766,105852,125957798,63,7968,102343,331,147312,28057,3,59,130000.0,43333.0,-68.0,-64.0,-69.0,-69.0,-68.0,-64.0,-68.0,-68.0,-72.0,-81.0,-72.0,-81.0,4.0,17.0,3.0,12.0,1
1237,F8:59:71:5A:E0:3D,2196156,340919116,44634,67967552,2151522,272951564,0,31552,45174726,31488,45164233,64,10493,31377,12,44670,5582,0,28,144444.0,43333.0,-65.0,-72.0,-64.0,-70.0,-64.0,-72.0,-64.0,-70.0,-72.0,-81.0,-72.0,-81.0,7.0,9.0,8.0,11.0,1
1238,CC:2F:71:3E:C5:1F,2151583,272958881,61,7317,2151522,272951564,0,284,24051,240,18661,44,5390,68,1,103,6,0,13,130000.0,39000.0,-70.0,-71.0,-66.0,-60.0,-69.0,-71.0,-66.0,-61.0,-72.0,-81.0,-72.0,-81.0,2.0,10.0,6.0,21.0,1
1239,CC:2F:71:3F:1F:24,2298960,466878909,147437,193927283,2151523,272951626,3,106065,126161305,106002,126153337,63,7968,102493,331,147474,28058,3,59,130000.0,43333.0,-69.0,-63.0,-70.0,-69.0,-67.0,-63.0,-68.0,-69.0,-72.0,-81.0,-72.0,-81.0,3.0,18.0,2.0,12.0,1
1240,F8:59:71:5A:E0:3D,2196269,341083290,44744,68131462,2151525,272951828,0,31626,45279520,31561,45268909,65,10611,31451,12,44780,5582,0,28,144444.0,43333.0,-65.0,-72.0,-66.0,-69.0,-65.0,-72.0,-65.0,-69.0,-73.0,-81.0,-73.0,-82.0,8.0,9.0,7.0,13.0,1
1241,CC:2F:71:3E:C5:1F,2151586,272959145,61,7317,2151525,272951828,0,284,24051,240,18661,44,5390,68,1,103,6,0,13,130000.0,39000.0,-70.0,-71.0,-66.0,-60.0,-69.0,-71.0,-66.0,-61.0,-73.0,-81.0,-73.0,-82.0,3.0,10.0,7.0,22.0,1
1242,CC:2F:71:3F:1F:24,2299118,467081887,147593,194130059,2151525,272951828,3,106206,126353885,106143,126345917,63,7968,102634,331,147630,28066,3,59,144444.0,39000.0,-68.0,-62.0,-69.0,-71.0,-67.0,-62.0,-68.0,-70.0,-73.0,-81.0,-73.0,-82.0,5.0,19.0,4.0,11.0,1
1243,F8:59:71:5A:E0:3D,2196337,341180394,44808,68228162,2151529,272952232,0,31692,45375556,31627,45364945,65,10611,31517,12,44844,5582,0,28,144444.0,43333.0,-66.0,-72.0,-65.0,-71.0,-66.0,-72.0,-64.0,-70.0,-73.0,-81.0,-73.0,-82.0,7.0,9.0,8.0,11.0,1
1244,CC:2F:71:3E:C5:1F,2151592,272959751,61,7317,2151531,272952434,0,284,24051,240,18661,44,5390,68,1,103,6,0,13,130000.0,39000.0,-70.0,-71.0,-66.0,-60.0,-69.0,-71.0,-66.0,-61.0,-73.0,-81.0,-73.0,-82.0,3.0,10.0,7.0,22.0,1
1245,CC:2F:71:3F:1F:24,2299280,467286973,147749,194334539,2151531,272952434,3,106351,126551201,106288,126543233,63,7968,102779,331,147786,28068,3,59,144444.0,43333.0,-68.0,-63.0,-69.0,-72.0,-67.0,-63.0,-69.0,-72.0,-73.0,-81.0,-73.0,-82.0,5.0,18.0,4.0,10.0,1
1246,F8:59:71:5A:E0:3D,2196408,341279218,44874,68326522,2151534,272952696,0,31758,45474818,31693,45464207,65,10611,31583,12,44910,5582,0,28,144444.0,43333.0,-66.0,-73.0,-65.0,-71.0,-66.0,-72.0,-66.0,-71.0,-73.0,-81.0,-73.0,-82.0,7.0,8.0,8.0,11.0,1
1247,CC:2F:71:3E:C5:1F,2151595,272960013,61,7317,2151534,272952696,0,284,24051,240,18661,44,5390,68,1,103,6,0,13,130000.0,39000.0,-70.0,-71.0,-66.0,-60.0,-69.0,-71.0,-66.0,-61.0,-73.0,-81.0,-73.0,-82.0,3.0,10.0,7.0,22.0,1
1248,CC:2F:71:3F:1F:24,2299439,467488855,147904,194536097,2151535,272952758,3,106491,126745089,106428,126737121,63,7968,102919,331,147941,28072,3,59,144444.0,43333.0,-68.0,-64.0,-68.0,-73.0,-68.0,-63.0,-67.0,-72.0,-73.0,-81.0,-73.0,-82.0,5.0,17.0,5.0,9.0,1
1249,F8:59:71:5A:E0:3D,2196474,341375892,44936,68422870,2151538,272953022,0,31820,45570298,31755,45559687,65,10611,31645,12,44972,5583,0,28,144444.0,43333.0,-66.0,-73.0,-66.0,-71.0,-65.0,-73.0,-65.0,-70.0,-73.0,-81.0,-73.0,-82.0,7.0,8.0,7.0,11.0,1
1250,CC:2F:71:3E:C5:1F,2151601,272960541,61,7317,2151540,272953224,0,286,24239,241,18731,45,5508,69,1,103,6,0,13,130000.0,39000.0,-69.0,-69.0,-67.0,-60.0,-70.0,-71.0,-66.0,-61.0,-73.0,-81.0,-73.0,-82.0,4.0,12.0,6.0,22.0,1
1251,CC:2F:71:3F:1F:24,2299600,467692433,148060,194739209,2151540,272953224,3,106632,126937671,106568,126929585,64,8086,103060,331,148097,28072,3,59,144444.0,43333.0,-68.0,-63.0,-68.0,-72.0,-68.0,-63.0,-68.0,-71.0,-73.0,-81.0,-73.0,-82.0,5.0,18.0,5.0,10.0,1
1252,F8:59:71:5A:E0:3D,2196543,341472962,44999,68519334,2151544,272953628,0,31883,45665884,31818,45655273,65,10611,31708,12,45035,5583,0,28,144444.0,43333.0,-67.0,-74.0,-65.0,-71.0,-66.0,-73.0,-64.0,-71.0,-73.0,-81.0,-73.0,-82.0,6.0,7.0,8.0,11.0,1
1253,CC:2F:71:3E:C5:1F,2151605,272960945,61,7317,2151544,272953628,0,286,24239,241,18731,45,5508,69,1,103,6,0,13,130000.0,39000.0,-69.0,-69.0,-67.0,-60.0,-70.0,-71.0,-66.0,-61.0,-73.0,-81.0,-73.0,-82.0,4.0,12.0,6.0,22.0,1
1254,CC:2F:71:3F:1F:24,2299772,467900265,148228,194946637,2151544,272953628,3,106784,127133569,106720,127125483,64,8086,103212,331,148265,28072,3,59,144444.0,43333.0,-68.0,-63.0,-69.0,-72.0,-68.0,-63.0,-69.0,-72.0,-73.0,-81.0,-73.0,-82.0,5.0,18.0,4.0,10.0,1
1255,F8:59:71:5A:E0:3D,2196608,341569572,45061,68615682,2151547,272953890,0,31945,45761364,31880,45750753,65,10611,31770,12,45097,5583,0,28,144444.0,43333.0,-66.0,-73.0,-64.0,-71.0,-66.0,-72.0,-65.0,-71.0,-73.0,-81.0,-73.0,-82.0,7.0,8.0,9.0,11.0,1
1256,CC:2F:71:3E:C5:1F,2151608,272961207,61,7317,2151547,272953890,0,286,24239,241,18731,45,5508,69,1,103,6,0,13,130000.0,39000.0,-69.0,-69.0,-67.0,-60.0,-70.0,-71.0,-66.0,-61.0,-73.0,-81.0,-73.0,-82.0,4.0,12.0,6.0,22.0,1
1257,CC:2F:71:3F:1F:24,2299931,468103776,148384,195149886,2151547,272953890,3,106927,127329237,106863,127321151,64,8086,103355,331,148421,28072,3,59,144444.0,43333.0,-69.0,-64.0,-70.0,-71.0,-68.0,-63.0,-68.0,-71.0,-73.0,-81.0,-73.0,-82.0,4.0,17.0,3.0,11.0,1
1258,F8:59:71:5A:E0:3D,2197035,342228919,45482,69274423,2151553,272954496,0,32046,45868958,31981,45858347,65,10611,31871,12,45518,5583,0,28,144444.0,43333.0,-66.0,-73.0,-65.0,-71.0,-66.0,-73.0,-65.0,-70.0,-73.0,-81.0,-73.0,-82.0,7.0,8.0,8.0,11.0,1
1259,CC:2F:71:3E:C5:1F,2151614,272961813,61,7317,2151553,272954496,0,286,24239,241,18731,45,5508,69,1,103,6,0,13,130000.0,39000.0,-69.0,-69.0,-67.0,-60.0,-70.0,-71.0,-66.0,-61.0,-73.0,-81.0,-73.0,-82.0,4.0,12.0,6.0,22.0,1
1260,CC:2F:71:3F:1F:24,2300098,468316816,148545,195362320,2151553,272954496,3,107075,127532609,107011,127524523,64,8086,103503,331,148582,28073,3,59,144444.0,43333.0,-69.0,-64.0,-69.0,-71.0,-68.0,-63.0,-68.0,-71.0,-73.0,-81.0,-73.0,-82.0,4.0,17.0,4.0,11.0,1
1261,F8:59:71:5A:E0:3D,2197100,342325742,45544,69370771,2151556,272954971,0,32108,45964438,32043,45953827,65,10611,31933,12,45580,5584,0,28,144444.0,43333.0,-65.0,-73.0,-66.0,-70.0,-65.0,-72.0,-65.0,-70.0,-74.0,-82.0,-74.0,-83.0,9.0,9.0,8.0,13.0,1
1262,CC:2F:71:3E:C5:1F,2151617,272962288,61,7317,2151556,272954971,0,286,24239,241,18731,45,5508,69,1,103,6,0,13,130000.0,39000.0,-69.0,-69.0,-67.0,-60.0,-70.0,-71.0,-66.0,-61.0,-74.0,-82.0,-74.0,-83.0,5.0,13.0,7.0,23.0,1
1263,CC:2F:71:3F:1F:24,2300258,468523381,148702,195568410,2151556,272954971,3,107217,127728153,107153,127720067,64,8086,103645,331,148739,28073,3,59,144444.0,43333.0,-69.0,-63.0,-69.0,-71.0,-67.0,-63.0,-68.0,-71.0,-74.0,-82.0,-74.0,-83.0,5.0,19.0,5.0,12.0,1
1264,F8:59:71:5A:E0:3D,2197168,342424108,45607,69468673,2151561,272955435,0,32171,46061458,32106,46050847,65,10611,31996,12,45643,5584,0,28,144444.0,43333.0,-66.0,-73.0,-65.0,-70.0,-65.0,-72.0,-65.0,-70.0,-74.0,-82.0,-74.0,-83.0,8.0,9.0,9.0,13.0,1
1265,CC:2F:71:3E:C5:1F,2151622,272962752,61,7317,2151561,272955435,0,286,24239,241,18731,45,5508,69,1,103,6,0,13,130000.0,39000.0,-69.0,-69.0,-67.0,-60.0,-70.0,-71.0,-66.0,-61.0,-74.0,-82.0,-74.0,-83.0,5.0,13.0,7.0,23.0,1
1266,CC:2F:71:3F:1F:24,2300426,468730430,148865,195774995,2151561,272955435,3,107364,127923344,107300,127915258,64,8086,103792,331,148902,28073,3,59,144444.0,43333.0,-68.0,-63.0,-64.0,-72.0,-67.0,-63.0,-67.0,-71.0,-74.0,-82.0,-74.0,-83.0,6.0,19.0,10.0,11.0,1
1267,F8:59:71:5A:E0:3D,2197365,342727006,45802,69771369,2151563,272955637,0,32247,46161810,32182,46151199,65,10611,32072,12,45838,5586,0,28,144444.0,43333.0,-65.0,-72.0,-67.0,-70.0,-65.0,-72.0,-65.0,-70.0,-74.0,-82.0,-74.0,-83.0,9.0,10.0,7.0,13.0,1
1268,CC:2F:71:3E:C5:1F,2151624,272962954,61,7317,2151563,272955637,0,286,24239,241,18731,45,5508,69,1,103,6,0,13,130000.0,39000.0,-69.0,-69.0,-67.0,-60.0,-70.0,-71.0,-66.0,-61.0,-74.0,-82.0,-74.0,-83.0,5.0,13.0,7.0,23.0,1
1269,CC:2F:71:3F:1F:24,2300586,468933946,149021,195978107,2151565,272955839,3,107505,128117362,107441,128109276,64,8086,103932,331,149056,28074,3,59,144444.0,43333.0,-68.0,-63.0,-67.0,-73.0,-67.0,-63.0,-68.0,-72.0,-74.0,-82.0,-74.0,-83.0,6.0,19.0,7.0,10.0,1
1270,F8:59:71:5A:E0:3D,2197431,342823758,45864,69867717,2151567,272956041,0,32309,46257290,32244,46246679,65,10611,32134,12,45900,5586,0,28,144444.0,43333.0,-66.0,-73.0,-64.0,-70.0,-65.0,-72.0,-64.0,-70.0,-74.0,-82.0,-74.0,-83.0,8.0,9.0,10.0,13.0,1
1271,CC:2F:71:3E:C5:1F,2151631,272963620,61,7317,2151570,272956303,0,286,24239,241,18731,45,5508,69,1,103,6,0,13,130000.0,39000.0,-69.0,-69.0,-67.0,-60.0,-70.0,-71.0,-66.0,-61.0,-74.0,-82.0,-74.0,-83.0,5.0,13.0,7.0,23.0,1
1272,CC:2F:71:3F:1F:24,2300747,469137522,149177,196181219,2151570,272956303,3,107647,128314330,107583,128306244,64,8086,104074,331,149214,28074,3,59,144444.0,43333.0,-69.0,-63.0,-67.0,-71.0,-67.0,-63.0,-68.0,-71.0,-74.0,-82.0,-74.0,-83.0,5.0,19.0,7.0,12.0,1
1273,F8:59:71:5A:E0:3D,2197498,342920570,45926,69964065,2151572,272956505,0,32373,46352910,32308,46342299,65,10611,32196,12,45962,5587,0,28,144444.0,43333.0,-66.0,-72.0,-65.0,-70.0,-65.0,-72.0,-65.0,-70.0,-74.0,-82.0,-74.0,-83.0,8.0,10.0,9.0,13.0,1
1274,CC:2F:71:3E:C5:1F,2151633,272963822,61,7317,2151572,272956505,0,286,24239,241,18731,45,5508,69,1,103,6,0,13,130000.0,39000.0,-69.0,-69.0,-67.0,-60.0,-70.0,-71.0,-66.0,-61.0,-74.0,-82.0,-74.0,-83.0,5.0,13.0,7.0,23.0,1
1275,CC:2F:71:3F:1F:24,2300918,469344606,149346,196388101,2151572,272956505,3,107798,128513027,107734,128504941,64,8086,104225,331,149383,28076,3,59,144444.0,43333.0,-66.0,-63.0,-69.0,-72.0,-67.0,-63.0,-68.0,-71.0,-74.0,-82.0,-74.0,-83.0,8.0,19.0,5.0,11.0,1
1276,F8:59:71:5A:E0:3D,2197636,343127357,46060,70170448,2151576,272956909,0,32447,46453008,32382,46442397,65,10611,32268,12,46096,5587,0,28,144444.0,43333.0,-67.0,-73.0,-65.0,-70.0,-66.0,-73.0,-65.0,-70.0,-74.0,-82.0,-74.0,-83.0,7.0,9.0,9.0,13.0,1
1277,CC:2F:71:3E:C5:1F,2151637,272964226,61,7317,2151576,272956909,0,286,24239,241,18731,45,5508,69,1,103,6,0,13,130000.0,39000.0,-69.0,-69.0,-67.0,-60.0,-70.0,-71.0,-66.0,-61.0,-74.0,-82.0,-74.0,-83.0,5.0,13.0,7.0,23.0,1
1278,CC:2F:71:3F:1F:24,2301086,469554571,149510,196597662,2151576,272956909,3,107948,128708566,107884,128700480,64,8086,104375,331,149545,28076,3,59,144444.0,43333.0,-67.0,-63.0,-68.0,-71.0,-68.0,-63.0,-68.0,-71.0,-74.0,-82.0,-74.0,-83.0,7.0,19.0,6.0,12.0,1
1279,F8:59:71:5A:E0:3D,2197706,343225983,46125,70268610,2151581,272957373,0,32512,46551876,32447,46541265,65,10611,32333,12,46161,5587,0,28,144444.0,43333.0,-66.0,-73.0,-65.0,-70.0,-66.0,-72.0,-65.0,-70.0,-75.0,-82.0,-75.0,-84.0,9.0,9.0,10.0,14.0,1
1280,CC:2F:71:3E:C5:1F,2151642,272964690,61,7317,2151581,272957373,0,286,24239,241,18731,45,5508,69,1,103,6,0,13,130000.0,39000.0,-69.0,-69.0,-67.0,-60.0,-70.0,-71.0,-66.0,-61.0,-75.0,-82.0,-75.0,-84.0,6.0,13.0,8.0,24.0,1
1281,CC:2F:71:3F:1F:24,2301247,469758147,149666,196800774,2151581,272957373,3,108093,128907320,108029,128899234,64,8086,104519,331,149703,28076,3,59,144444.0,43333.0,-68.0,-63.0,-68.0,-70.0,-68.0,-63.0,-68.0,-70.0,-75.0,-82.0,-75.0,-84.0,7.0,19.0,7.0,14.0,1
1282,F8:59:71:5A:E0:3D,2197774,343323136,46191,70365561,2151583,272957575,0,32579,46651223,32514,46640612,65,10611,32400,12,46227,5589,0,28,130000.0,39000.0,-65.0,-72.0,-66.0,-71.0,-65.0,-72.0,-65.0,-71.0,-75.0,-82.0,-75.0,-84.0,10.0,10.0,9.0,13.0,1
1283,CC:2F:71:3E:C5:1F,2151644,272964892,61,7317,2151583,272957575,0,286,24239,241,18731,45,5508,69,1,103,6,0,13,130000.0,39000.0,-69.0,-69.0,-67.0,-60.0,-70.0,-71.0,-66.0,-61.0,-75.0,-82.0,-75.0,-84.0,6.0,13.0,8.0,24.0,1
1284,CC:2F:71:3F:1F:24,2301407,469963087,149822,197005310,2151585,272957777,3,108235,129101440,108171,129093354,64,8086,104661,331,149859,28091,3,59,144444.0,43333.0,-68.0,-63.0,-70.0,-71.0,-67.0,-63.0,-67.0,-71.0,-75.0,-82.0,-75.0,-84.0,7.0,19.0,5.0,13.0,1
1285,F8:59:71:5A:E0:3D,2197847,343423547,46258,70465366,2151589,272958181,0,32642,46746819,32577,46736208,65,10611,32463,12,46294,5589,0,28,144444.0,43333.0,-66.0,-72.0,-66.0,-71.0,-65.0,-72.0,-65.0,-71.0,-75.0,-82.0,-75.0,-84.0,9.0,10.0,9.0,13.0,1
1286,CC:2F:71:3E:C5:1F,2151650,272965498,61,7317,2151589,272958181,0,286,24239,241,18731,45,5508,69,1,103,6,0,13,130000.0,39000.0,-69.0,-69.0,-67.0,-60.0,-70.0,-71.0,-66.0,-61.0,-75.0,-82.0,-75.0,-84.0,6.0,13.0,8.0,24.0,1
1287,CC:2F:71:3F:1F:24,2301565,470164919,149976,197206738,2151589,272958181,3,108375,129295328,108311,129287242,64,8086,104801,331,150013,28100,3,59,144444.0,43333.0,-69.0,-64.0,-69.0,-71.0,-68.0,-63.0,-68.0,-71.0,-75.0,-82.0,-75.0,-84.0,6.0,18.0,6.0,13.0,1
1288,F8:59:71:5A:E0:3D,2197917,343520910,46324,70562341,2151593,272958569,0,32710,46846352,32645,46835741,65,10611,32531,12,46360,5589,0,28,144444.0,43333.0,-67.0,-73.0,-66.0,-71.0,-66.0,-72.0,-65.0,-71.0,-75.0,-82.0,-75.0,-84.0,8.0,9.0,9.0,13.0,1
1289,CC:2F:71:3E:C5:1F,2151654,272965886,61,7317,2151593,272958569,0,286,24239,241,18731,45,5508,69,1,103,6,0,13,130000.0,39000.0,-69.0,-69.0,-67.0,-60.0,-70.0,-71.0,-66.0,-61.0,-75.0,-82.0,-75.0,-84.0,6.0,13.0,8.0,24.0,1
1290,CC:2F:71:3F:1F:24,2301724,470368289,150131,197409720,2151593,272958569,3,108516,129489332,108452,129481246,64,8086,104942,331,150168,28102,3,59,144444.0,43333.0,-69.0,-63.0,-70.0,-70.0,-68.0,-63.0,-68.0,-70.0,-75.0,-82.0,-75.0,-84.0,6.0,19.0,5.0,14.0,1
1291,F8:59:71:5A:E0:3D,2197984,343619216,46387,70660243,2151597,272958973,0,32772,46941832,32707,46931221,65,10611,32593,12,46423,5589,0,28,144444.0,43333.0,-66.0,-73.0,-66.0,-71.0,-65.0,-72.0,-66.0,-71.0,-75.0,-83.0,-75.0,-84.0,9.0,10.0,9.0,13.0,1
1292,CC:2F:71:3E:C5:1F,2151658,272966290,61,7317,2151597,272958973,0,286,24239,241,18731,45,5508,69,1,103,6,0,13,130000.0,39000.0,-69.0,-69.0,-67.0,-60.0,-70.0,-71.0,-66.0,-61.0,-75.0,-83.0,-75.0,-84.0,6.0,14.0,8.0,24.0,1
1293,CC:2F:71:3F:1F:24,2301892,470578274,150294,197619167,2151598,272959107,3,108666,129689157,108602,129681071,64,8086,105091,331,150331,28106,3,59,144444.0,43333.0,-69.0,-64.0,-68.0,-70.0,-68.0,-63.0,-68.0,-70.0,-75.0,-83.0,-75.0,-84.0,6.0,19.0,7.0,14.0,1
1294,F8:59:71:5A:E0:3D,2198051,343717522,46450,70758145,2151601,272959377,0,32836,47040392,32771,47029781,65,10611,32657,12,46486,5590,0,28,144444.0,43333.0,-66.0,-72.0,-67.0,-71.0,-66.0,-72.0,-65.0,-71.0,-75.0,-83.0,-75.0,-84.0,9.0,11.0,8.0,13.0,1
1295,CC:2F:71:3E:C5:1F,2151662,272966694,61,7317,2151601,272959377,0,286,24239,241,18731,45,5508,69,1,103,6,0,13,130000.0,39000.0,-69.0,-69.0,-67.0,-60.0,-70.0,-71.0,-66.0,-61.0,-75.0,-83.0,-75.0,-84.0,6.0,14.0,8.0,24.0,1
1296,CC:2F:71:3F:1F:24,2302052,470784904,150451,197825527,2151601,272959377,3,108808,129884701,108744,129876615,64,8086,105233,331,150488,28108,3,59,144444.0,43333.0,-69.0,-64.0,-68.0,-71.0,-68.0,-63.0,-68.0,-70.0,-75.0,-83.0,-75.0,-84.0,6.0,19.0,7.0,13.0,1
1297,F8:59:71:5A:E0:3D,2198118,343814334,46512,70854493,2151606,272959841,0,32898,47135872,32833,47125261,65,10611,32719,12,46548,5590,0,28,144444.0,43333.0,-66.0,-71.0,-66.0,-70.0,-65.0,-72.0,-65.0,-70.0,-75.0,-83.0,-75.0,-84.0,9.0,12.0,9.0,14.0,1
1298,CC:2F:71:3E:C5:1F,2151667,272967158,61,7317,2151606,272959841,0,288,24379,243,18871,45,5508,69,1,104,6,0,13,130000.0,39000.0,-70.0,-70.0,-66.0,-60.0,-70.0,-71.0,-66.0,-61.0,-75.0,-83.0,-75.0,-84.0,5.0,13.0,9.0,24.0,1
1299,CC:2F:71:3F:1F:24,2302212,470988350,150606,198028509,2151606,272959841,3,108948,130078589,108884,130070503,64,8086,105373,331,150643,28117,3,59,144444.0,43333.0,-68.0,-64.0,-68.0,-72.0,-68.0,-63.0,-68.0,-70.0,-75.0,-83.0,-75.0,-84.0,7.0,19.0,7.0,12.0,1
1300,F8:59:71:5A:E0:3D,2198306,344103023,46698,71142980,2151608,272960043,0,32973,47234684,32908,47224073,65,10611,32794,12,46734,5591,0,28,144444.0,43333.0,-67.0,-73.0,-65.0,-71.0,-66.0,-72.0,-65.0,-71.0,-75.0,-83.0,-75.0,-84.0,8.0,10.0,10.0,13.0,1
1301,CC:2F:71:3E:C5:1F,2151671,272967562,61,7317,2151610,272960245,0,288,24379,243,18871,45,5508,69,1,104,6,0,13,130000.0,39000.0,-70.0,-70.0,-66.0,-60.0,-70.0,-71.0,-66.0,-61.0,-75.0,-83.0,-75.0,-84.0,5.0,13.0,9.0,24.0,1
1302,CC:2F:71:3F:1F:24,2302371,471191736,150761,198231491,2151610,272960245,3,109087,130270937,109023,130262851,64,8086,105512,331,150798,28125,3,59,144444.0,43333.0,-68.0,-64.0,-68.0,-72.0,-67.0,-63.0,-67.0,-70.0,-75.0,-83.0,-75.0,-84.0,7.0,19.0,7.0,12.0,1
1303,F8:59:71:5A:E0:3D,2198552,344475586,46938,71514804,2151614,272960782,0,33057,47336036,32991,47325307,66,10729,32878,12,46974,5591,0,28,144444.0,43333.0,-65.0,-72.0,-67.0,-71.0,-65.0,-72.0,-65.0,-70.0,-75.0,-83.0,-75.0,-84.0,10.0,11.0,8.0,13.0,1
1304,CC:2F:71:3E:C5:1F,2151678,272968361,62,7377,2151616,272960984,0,290,24519,245,19011,45,5508,69,1,105,6,0,13,130000.0,39000.0,-70.0,-71.0,-66.0,-60.0,-70.0,-71.0,-67.0,-61.0,-75.0,-83.0,-75.0,-84.0,5.0,12.0,9.0,24.0,1
1305,CC:2F:71:3F:1F:24,2302539,471396052,150923,198435068,2151616,272960984,3,109234,130464694,109170,130456608,64,8086,105659,331,150960,28128,3,59,144444.0,43333.0,-68.0,-64.0,-68.0,-71.0,-68.0,-63.0,-67.0,-70.0,-75.0,-83.0,-75.0,-84.0,7.0,19.0,7.0,13.0,1
1306,F8:59:71:5A:E0:3D,2198620,344572460,47000,71611152,2151620,272961308,0,33118,47429976,33052,47419247,66,10729,32939,12,47035,5591,0,28,144444.0,43333.0,-67.0,-73.0,-65.0,-71.0,-66.0,-72.0,-65.0,-71.0,-75.0,-83.0,-75.0,-84.0,8.0,10.0,10.0,13.0,1
1307,CC:2F:71:3E:C5:1F,2151682,272968685,62,7377,2151620,272961308,0,292,24707,246,19081,46,5626,70,1,105,6,0,13,130000.0,39000.0,-70.0,-70.0,-66.0,-60.0,-69.0,-70.0,-66.0,-60.0,-75.0,-83.0,-75.0,-84.0,5.0,13.0,9.0,24.0,1
1308,CC:2F:71:3F:1F:24,2302698,471599358,151078,198638050,2151620,272961308,3,109373,130657042,109309,130648956,64,8086,105798,331,151115,28131,3,59,144444.0,43333.0,-68.0,-63.0,-68.0,-71.0,-67.0,-63.0,-68.0,-70.0,-75.0,-83.0,-75.0,-84.0,7.0,20.0,7.0,13.0,1
1309,F8:59:71:5A:E0:3D,2198684,344669010,47062,71707500,2151622,272961510,0,33180,47525456,33114,47514727,66,10729,33001,12,47098,5591,0,28,144444.0,43333.0,-65.0,-72.0,-67.0,-71.0,-66.0,-72.0,-65.0,-70.0,-75.0,-83.0,-75.0,-84.0,10.0,11.0,8.0,13.0,1
1310,CC:2F:71:3E:C5:1F,2151684,272968887,62,7377,2151622,272961510,0,292,24707,246,19081,46,5626,70,1,105,6,0,13,130000.0,39000.0,-70.0,-70.0,-66.0,-60.0,-69.0,-70.0,-66.0,-60.0,-75.0,-83.0,-75.0,-84.0,5.0,13.0,9.0,24.0,1
1311,CC:2F:71:3F:1F:24,2302857,471802576,151233,198840864,2151624,272961712,3,109515,130852586,109451,130844500,64,8086,105940,331,151270,28138,3,59,144444.0,43333.0,-66.0,-64.0,-69.0,-71.0,-67.0,-63.0,-68.0,-70.0,-75.0,-83.0,-75.0,-84.0,9.0,19.0,6.0,13.0,1
1312,F8:59:71:5A:E0:3D,2198772,344776610,47124,71803848,2151648,272972762,0,33243,47622476,33177,47611747,66,10729,33064,12,47160,5592,0,28,144444.0,43333.0,-66.0,-73.0,-65.0,-71.0,-66.0,-72.0,-65.0,-70.0,-75.0,-83.0,-75.0,-84.0,9.0,10.0,10.0,13.0,1
1313,CC:2F:71:3E:C5:1F,2151712,272980341,62,7377,2151650,272972964,0,292,24707,246,19081,46,5626,70,1,105,6,0,13,130000.0,39000.0,-70.0,-70.0,-66.0,-60.0,-69.0,-70.0,-66.0,-60.0,-75.0,-83.0,-75.0,-84.0,5.0,13.0,9.0,24.0,1
1314,CC:2F:71:3F:1F:24,2303093,472047797,151443,199074833,2151650,272972964,3,109703,131075113,109639,131067027,64,8086,106128,331,151480,28154,3,59,144444.0,43333.0,-68.0,-64.0,-67.0,-72.0,-68.0,-63.0,-68.0,-71.0,-75.0,-83.0,-75.0,-84.0,7.0,19.0,8.0,12.0,1
1315,F8:59:71:5A:E0:3D,2198845,344882746,47192,71909520,2151653,272973226,0,33310,47725656,33244,47714927,66,10729,33131,12,47227,5592,0,28,144444.0,43333.0,-66.0,-73.0,-65.0,-71.0,-65.0,-72.0,-65.0,-70.0,-75.0,-83.0,-75.0,-84.0,9.0,10.0,10.0,13.0,1
1316,CC:2F:71:3E:C5:1F,2151715,272980603,62,7377,2151653,272973226,0,292,24707,246,19081,46,5626,70,1,105,6,0,13,130000.0,39000.0,-70.0,-70.0,-66.0,-60.0,-69.0,-70.0,-66.0,-60.0,-75.0,-83.0,-75.0,-84.0,5.0,13.0,9.0,24.0,1
1317,CC:2F:71:3F:1F:24,2303256,472251404,151603,199278178,2151653,272973226,3,109850,131270305,109786,131262219,64,8086,106275,331,151640,28190,3,59,144444.0,43333.0,-69.0,-63.0,-70.0,-70.0,-67.0,-63.0,-68.0,-70.0,-75.0,-83.0,-75.0,-84.0,6.0,20.0,5.0,14.0,1
1318,F8:59:71:5A:E0:3D,2198911,344979498,47254,72005868,2151657,272973630,0,33372,47821136,33306,47810407,66,10729,33193,12,47290,5592,0,28,144444.0,43333.0,-67.0,-73.0,-65.0,-70.0,-66.0,-72.0,-65.0,-70.0,-75.0,-83.0,-75.0,-84.0,8.0,10.0,10.0,14.0,1
1319,CC:2F:71:3E:C5:1F,2151719,272981007,62,7377,2151657,272973630,0,292,24707,246,19081,46,5626,70,1,105,6,0,13,130000.0,39000.0,-70.0,-70.0,-66.0,-60.0,-69.0,-70.0,-66.0,-60.0,-75.0,-83.0,-75.0,-84.0,5.0,13.0,9.0,24.0,1
1320,CC:2F:71:3F:1F:24,2303418,472458028,151761,199484398,2151657,272973630,3,109993,131465965,109929,131457879,64,8086,106418,331,151798,28202,3,59,144444.0,43333.0,-67.0,-63.0,-67.0,-71.0,-67.0,-63.0,-67.0,-70.0,-75.0,-83.0,-75.0,-84.0,8.0,20.0,8.0,13.0,1
1321,F8:59:71:5A:E0:3D,2199013,345125776,47352,72151742,2151661,272974034,0,33444,47925696,33378,47914967,66,10729,33265,12,47388,5593,0,28,144444.0,43333.0,-65.0,-72.0,-66.0,-70.0,-65.0,-72.0,-66.0,-70.0,-75.0,-83.0,-75.0,-84.0,10.0,11.0,9.0,14.0,1
1322,CC:2F:71:3E:C5:1F,2151723,272981411,62,7377,2151661,272974034,0,292,24707,246,19081,46,5626,70,1,105,6,0,13,130000.0,39000.0,-70.0,-70.0,-66.0,-60.0,-69.0,-70.0,-66.0,-60.0,-75.0,-83.0,-75.0,-84.0,5.0,13.0,9.0,24.0,1
1323,CC:2F:71:3F:1F:24,2303577,472661414,151916,199687380,2151661,272974034,3,110132,131658313,110068,131650227,64,8086,106557,331,151953,28205,3,59,144444.0,43333.0,-66.0,-63.0,-68.0,-71.0,-67.0,-63.0,-67.0,-70.0,-75.0,-83.0,-75.0,-84.0,9.0,20.0,7.0,13.0,1
1324,F8:59:71:5A:E0:3D,2199080,345221096,47413,72246536,2151667,272974560,0,33505,48019636,33439,48008907,66,10729,33326,12,47449,5593,0,28,144444.0,43333.0,-66.0,-72.0,-65.0,-71.0,-65.0,-72.0,-65.0,-70.0,-75.0,-83.0,-75.0,-84.0,9.0,11.0,10.0,13.0,1
1325,CC:2F:71:3E:C5:1F,2151729,272981937,62,7377,2151667,272974560,0,292,24707,246,19081,46,5626,70,1,105,6,0,13,130000.0,39000.0,-70.0,-70.0,-66.0,-60.0,-69.0,-70.0,-66.0,-60.0,-75.0,-83.0,-75.0,-84.0,5.0,13.0,9.0,24.0,1
1326,CC:2F:71:3F:1F:24,2303740,472865186,152073,199890626,2151667,272974560,3,110275,131852556,110210,131844352,65,8204,106700,331,152109,28207,3,59,144444.0,43333.0,-66.0,-63.0,-68.0,-71.0,-67.0,-63.0,-68.0,-71.0,-75.0,-83.0,-75.0,-84.0,9.0,20.0,7.0,13.0,1
1327,F8:59:71:5A:E0:3D,2199229,345440079,47558,72465115,2151671,272974964,0,33579,48123144,33513,48112415,66,10729,33400,12,47594,5593,0,28,144444.0,43333.0,-67.0,-73.0,-65.0,-71.0,-66.0,-72.0,-65.0,-70.0,-75.0,-83.0,-75.0,-84.0,8.0,10.0,10.0,13.0,1
1328,CC:2F:71:3E:C5:1F,2151733,272982341,62,7377,2151671,272974964,0,292,24707,246,19081,46,5626,70,1,105,6,0,13,130000.0,39000.0,-70.0,-70.0,-66.0,-60.0,-69.0,-70.0,-66.0,-60.0,-75.0,-83.0,-75.0,-84.0,5.0,13.0,9.0,24.0,1
1329,CC:2F:71:3F:1F:24,2303913,473072012,152242,200097048,2151671,272974964,3,110429,132049158,110364,132040954,65,8204,106854,331,152279,28207,3,59,144444.0,43333.0,-68.0,-64.0,-68.0,-71.0,-68.0,-63.0,-68.0,-70.0,-75.0,-83.0,-75.0,-84.0,7.0,19.0,7.0,13.0,1
1330,F8:59:71:5A:E0:3D,2199295,345536831,47620,72561463,2151675,272975368,0,33641,48218624,33575,48207895,66,10729,33462,12,47656,5593,0,28,144444.0,43333.0,-65.0,-72.0,-67.0,-71.0,-65.0,-72.0,-65.0,-71.0,-75.0,-83.0,-75.0,-84.0,10.0,11.0,8.0,13.0,1
1331,CC:2F:71:3E:C5:1F,2151737,272982745,62,7377,2151675,272975368,0,292,24707,246,19081,46,5626,70,1,105,6,0,13,130000.0,39000.0,-70.0,-70.0,-66.0,-60.0,-69.0,-70.0,-66.0,-60.0,-75.0,-83.0,-75.0,-84.0,5.0,13.0,9.0,24.0,1
1332,CC:2F:71:3F:1F:24,2304082,473280669,152407,200305301,2151675,272975368,3,110579,132244687,110514,132236483,65,8204,107004,331,152444,28207,3,59,144444.0,43333.0,-67.0,-63.0,-67.0,-71.0,-68.0,-63.0,-68.0,-70.0,-75.0,-83.0,-75.0,-84.0,8.0,20.0,8.0,13.0,1
1333,F8:59:71:5A:E0:3D,2199363,345633759,47683,72657927,2151680,272975832,0,33704,48314210,33638,48303481,66,10729,33525,12,47719,5593,0,28,144444.0,43333.0,-66.0,-72.0,-66.0,-71.0,-66.0,-72.0,-65.0,-70.0,-75.0,-83.0,-75.0,-84.0,9.0,11.0,9.0,13.0,1
1334,CC:2F:71:3E:C5:1F,2151742,272983209,62,7377,2151680,272975832,0,292,24707,246,19081,46,5626,70,1,105,6,0,13,130000.0,39000.0,-70.0,-70.0,-66.0,-60.0,-69.0,-70.0,-66.0,-60.0,-75.0,-83.0,-75.0,-84.0,5.0,13.0,9.0,24.0,1
1335,CC:2F:71:3F:1F:24,2304243,473484245,152563,200508413,2151680,272975832,3,110721,132438807,110656,132430603,65,8204,107146,331,152600,28208,3,59,144444.0,43333.0,-69.0,-64.0,-68.0,-71.0,-68.0,-63.0,-67.0,-70.0,-75.0,-83.0,-75.0,-84.0,6.0,19.0,7.0,13.0,1
1336,F8:59:71:5A:E0:3D,2199432,345731096,47750,72755062,2151682,272976034,0,33770,48412365,33704,48401636,66,10729,33591,12,47786,5594,0,28,144444.0,43333.0,-66.0,-72.0,-65.0,-71.0,-66.0,-72.0,-65.0,-71.0,-75.0,-83.0,-75.0,-84.0,9.0,11.0,10.0,13.0,1
1337,CC:2F:71:3E:C5:1F,2151746,272983613,62,7377,2151684,272976236,0,292,24707,246,19081,46,5626,70,1,105,6,0,13,130000.0,39000.0,-70.0,-70.0,-66.0,-60.0,-69.0,-70.0,-66.0,-60.0,-75.0,-83.0,-75.0,-84.0,5.0,13.0,9.0,24.0,1
1338,CC:2F:71:3F:1F:24,2304402,473687631,152718,200711395,2151684,272976236,3,110864,132634467,110799,132626263,65,8204,107289,331,152755,28211,3,59,144444.0,43333.0,-68.0,-63.0,-68.0,-71.0,-67.0,-63.0,-67.0,-70.0,-75.0,-83.0,-75.0,-84.0,7.0,20.0,7.0,13.0,1
1339,F8:59:71:5A:E0:3D,2199496,345827646,47812,72851410,2151684,272976236,0,33832,48507845,33766,48497116,66,10729,33653,12,47848,5594,0,28,144444.0,43333.0,-66.0,-73.0,-66.0,-71.0,-66.0,-72.0,-65.0,-70.0,-75.0,-83.0,-75.0,-84.0,9.0,10.0,9.0,13.0,1
1340,CC:2F:71:3E:C5:1F,2151746,272983613,62,7377,2151684,272976236,0,292,24707,246,19081,46,5626,70,1,105,6,0,13,130000.0,39000.0,-70.0,-70.0,-66.0,-60.0,-69.0,-70.0,-66.0,-60.0,-75.0,-83.0,-75.0,-84.0,5.0,13.0,9.0,24.0,1
1341,CC:2F:71:3F:1F:24,2304576,473895161,152888,200918521,2151688,272976640,3,111017,132834624,110952,132826420,65,8204,107442,331,152925,28214,3,59,144444.0,43333.0,-68.0,-64.0,-68.0,-71.0,-67.0,-63.0,-68.0,-71.0,-75.0,-83.0,-75.0,-84.0,7.0,19.0,7.0,13.0,1
1342,F8:59:71:5A:E0:3D,2199563,345924458,47874,72947758,2151689,272976700,0,33894,48603325,33828,48592596,66,10729,33715,12,47910,5594,0,28,144444.0,43333.0,-66.0,-73.0,-66.0,-71.0,-65.0,-72.0,-66.0,-70.0,-75.0,-83.0,-75.0,-84.0,9.0,10.0,9.0,13.0,1
1343,CC:2F:71:3E:C5:1F,2151751,272984077,62,7377,2151689,272976700,0,292,24707,246,19081,46,5626,70,1,105,6,0,13,130000.0,39000.0,-70.0,-70.0,-66.0,-60.0,-69.0,-70.0,-66.0,-60.0,-75.0,-83.0,-75.0,-84.0,5.0,13.0,9.0,24.0,1
1344,CC:2F:71:3F:1F:24,2304751,474103442,153060,201126540,2151691,272976902,3,111172,133033798,111107,133025594,65,8204,107597,331,153097,28214,3,59,144444.0,43333.0,-67.0,-64.0,-67.0,-71.0,-67.0,-63.0,-67.0,-70.0,-75.0,-83.0,-75.0,-84.0,8.0,19.0,8.0,13.0,1
1345,F8:59:71:5A:E0:3D,2199631,346021509,47938,73044405,2151693,272977104,0,33958,48699076,33892,48688347,66,10729,33779,12,47974,5595,0,28,144444.0,43333.0,-65.0,-72.0,-66.0,-71.0,-66.0,-72.0,-65.0,-70.0,-75.0,-83.0,-75.0,-84.0,10.0,11.0,9.0,13.0,1
1346,CC:2F:71:3E:C5:1F,2151755,272984481,62,7377,2151693,272977104,0,292,24707,246,19081,46,5626,70,1,105,6,0,13,130000.0,39000.0,-70.0,-70.0,-66.0,-60.0,-69.0,-70.0,-66.0,-60.0,-75.0,-83.0,-75.0,-84.0,5.0,13.0,9.0,24.0,1
1347,CC:2F:71:3F:1F:24,2304908,474306626,153215,201329522,2151693,272977104,3,111314,133227918,111249,133219714,65,8204,107739,331,153252,28218,3,59,144444.0,43333.0,-68.0,-64.0,-68.0,-71.0,-67.0,-63.0,-67.0,-71.0,-75.0,-83.0,-75.0,-84.0,7.0,19.0,7.0,13.0,1
1348,F8:59:71:5A:E0:3D,2200024,346617853,48326,73640072,2151698,272977781,0,34059,48808210,33993,48797481,66,10729,33880,12,48362,5595,0,28,144444.0,43333.0,-66.0,-72.0,-65.0,-71.0,-65.0,-72.0,-65.0,-70.0,-75.0,-83.0,-75.0,-84.0,9.0,11.0,10.0,13.0,1
1349,CC:2F:71:3E:C5:1F,2151760,272985158,62,7377,2151698,272977781,0,292,24707,246,19081,46,5626,70,1,105,6,0,13,130000.0,39000.0,-70.0,-70.0,-66.0,-60.0,-69.0,-70.0,-66.0,-60.0,-75.0,-83.0,-75.0,-84.0,5.0,13.0,9.0,24.0,1
1350,CC:2F:71:3F:1F:24,2305071,474513539,153373,201535758,2151698,272977781,3,111457,133425002,111392,133416798,65,8204,107882,331,153410,28220,3,59,144444.0,43333.0,-68.0,-64.0,-65.0,-71.0,-67.0,-63.0,-66.0,-71.0,-75.0,-83.0,-75.0,-84.0,7.0,19.0,10.0,13.0,1
1351,F8:59:71:5A:E0:3D,2200096,346715452,48393,73737207,2151703,272978245,0,34124,48904821,34058,48894092,66,10729,33945,12,48429,5595,0,28,144444.0,43333.0,-66.0,-73.0,-65.0,-71.0,-65.0,-72.0,-65.0,-70.0,-75.0,-83.0,-75.0,-84.0,9.0,10.0,10.0,13.0,1
1352,CC:2F:71:3E:C5:1F,2151767,272985990,62,7377,2151705,272978613,0,292,24707,246,19081,46,5626,70,1,105,6,0,13,130000.0,39000.0,-70.0,-70.0,-66.0,-60.0,-69.0,-70.0,-66.0,-60.0,-75.0,-83.0,-75.0,-84.0,5.0,13.0,9.0,24.0,1
1353,CC:2F:71:3F:1F:24,2305233,474717369,153528,201738756,2151705,272978613,3,111601,133619354,111536,133611150,65,8204,108026,331,153565,28222,3,59,144444.0,43333.0,-69.0,-64.0,-69.0,-71.0,-68.0,-63.0,-68.0,-70.0,-75.0,-83.0,-75.0,-84.0,6.0,19.0,6.0,13.0,1
1354,F8:59:71:5A:E0:3D,2200164,346812404,48455,73833387,2151709,272979017,0,34186,49000329,34120,48989600,66,10729,34007,12,48491,5596,0,28,144444.0,43333.0,-66.0,-73.0,-66.0,-71.0,-66.0,-72.0,-65.0,-70.0,-75.0,-83.0,-75.0,-84.0,9.0,10.0,9.0,13.0,1
1355,CC:2F:71:3E:C5:1F,2151771,272986394,62,7377,2151709,272979017,0,292,24707,246,19081,46,5626,70,1,105,6,0,13,130000.0,39000.0,-70.0,-70.0,-66.0,-60.0,-69.0,-70.0,-66.0,-60.0,-75.0,-83.0,-75.0,-84.0,5.0,13.0,9.0,24.0,1
1356,CC:2F:71:3F:1F:24,2305392,474920771,153683,201941754,2151709,272979017,3,111742,133811934,111677,133803730,65,8204,108167,331,153720,28224,3,59,144444.0,43333.0,-69.0,-64.0,-69.0,-72.0,-68.0,-63.0,-68.0,-71.0,-75.0,-83.0,-75.0,-84.0,6.0,19.0,6.0,12.0,1
1357,F8:59:71:5A:E0:3D,2200235,346914942,48520,73934397,2151715,272980545,0,34251,49100429,34185,49089700,66,10729,34072,12,48556,5597,0,28,144444.0,43333.0,-65.0,-72.0,-66.0,-71.0,-65.0,-72.0,-65.0,-70.0,-75.0,-83.0,-75.0,-84.0,10.0,11.0,9.0,13.0,1
1358,CC:2F:71:3E:C5:1F,2151777,272987922,62,7377,2151715,272980545,0,292,24707,246,19081,46,5626,70,1,105,6,0,13,130000.0,39000.0,-70.0,-70.0,-66.0,-60.0,-69.0,-70.0,-66.0,-60.0,-75.0,-83.0,-75.0,-84.0,5.0,13.0,9.0,24.0,1
1359,CC:2F:71:3F:1F:24,2305569,475138670,153853,202158065,2151716,272980605,3,111903,134018825,111838,134010621,65,8204,108328,331,153890,28226,3,59,144444.0,43333.0,-68.0,-64.0,-68.0,-71.0,-67.0,-63.0,-67.0,-71.0,-75.0,-83.0,-75.0,-84.0,7.0,19.0,7.0,13.0,1
1360,F8:59:71:5A:E0:3D,2200303,347013308,48583,74032299,2151720,272981009,0,34314,49197449,34248,49186720,66,10729,34135,12,48619,5597,0,28,144444.0,43333.0,-66.0,-72.0,-66.0,-71.0,-66.0,-72.0,-65.0,-70.0,-75.0,-83.0,-75.0,-84.0,9.0,11.0,9.0,13.0,1
1361,CC:2F:71:3E:C5:1F,2151782,272988386,62,7377,2151720,272981009,0,292,24707,246,19081,46,5626,70,1,105,6,0,13,130000.0,39000.0,-70.0,-70.0,-66.0,-60.0,-69.0,-70.0,-66.0,-60.0,-75.0,-83.0,-75.0,-84.0,5.0,13.0,9.0,24.0,1
1362,CC:2F:71:3F:1F:24,2305732,475348288,154012,202367279,2151720,272981009,3,112048,134216141,111983,134207937,65,8204,108473,331,154049,28228,3,59,144444.0,43333.0,-66.0,-63.0,-66.0,-71.0,-67.0,-63.0,-67.0,-71.0,-75.0,-83.0,-75.0,-84.0,9.0,20.0,9.0,13.0,1
1363,F8:59:71:5A:E0:3D,2200373,347114292,48647,74131755,2151726,272982537,0,34377,49294469,34311,49283740,66,10729,34198,12,48683,5597,0,28,144444.0,43333.0,-66.0,-73.0,-66.0,-71.0,-66.0,-72.0,-65.0,-70.0,-75.0,-83.0,-75.0,-84.0,9.0,10.0,9.0,13.0,1
1364,CC:2F:71:3E:C5:1F,2151788,272989914,62,7377,2151726,272982537,0,292,24707,246,19081,46,5626,70,1,105,6,0,13,130000.0,39000.0,-70.0,-70.0,-66.0,-60.0,-69.0,-70.0,-66.0,-60.0,-75.0,-83.0,-75.0,-84.0,5.0,13.0,9.0,24.0,1
1365,CC:2F:71:3F:1F:24,2305900,475562268,154174,202579731,2151726,272982537,3,112198,134421185,112133,134412981,65,8204,108623,331,154211,28228,3,59,144444.0,43333.0,-70.0,-64.0,-69.0,-72.0,-68.0,-63.0,-68.0,-71.0,-75.0,-83.0,-75.0,-84.0,5.0,19.0,6.0,12.0,1
1366,F8:59:71:5A:E0:3D,2200442,347214212,48711,74231211,2151731,272983001,0,34442,49394569,34376,49383840,66,10729,34263,12,48747,5597,0,28,144444.0,43333.0,-67.0,-73.0,-65.0,-72.0,-65.0,-72.0,-65.0,-70.0,-75.0,-83.0,-75.0,-84.0,8.0,10.0,10.0,12.0,1
1367,CC:2F:71:3E:C5:1F,2151793,272990378,62,7377,2151731,272983001,0,292,24707,246,19081,46,5626,70,1,105,6,0,13,130000.0,39000.0,-70.0,-70.0,-66.0,-60.0,-69.0,-70.0,-66.0,-60.0,-75.0,-83.0,-75.0,-84.0,5.0,13.0,9.0,24.0,1
1368,CC:2F:71:3F:1F:24,2306061,475765860,154330,202782859,2151731,272983001,3,112339,134615189,112274,134606985,65,8204,108764,331,154367,28233,3,59,144444.0,43333.0,-68.0,-63.0,-67.0,-71.0,-67.0,-63.0,-67.0,-71.0,-75.0,-83.0,-75.0,-84.0,7.0,20.0,8.0,13.0,1
1369,F8:59:71:5A:E0:3D,2200534,347354685,48803,74371684,2151731,272983001,0,34509,49493877,34443,49483148,66,10729,34330,12,48839,5597,0,28,144444.0,43333.0,-66.0,-73.0,-66.0,-71.0,-66.0,-72.0,-65.0,-70.0,-75.0,-83.0,-75.0,-84.0,9.0,10.0,9.0,13.0,1
1370,CC:2F:71:3E:C5:1F,2151795,272991502,62,7377,2151733,272984125,0,292,24707,246,19081,46,5626,70,1,105,6,0,13,130000.0,39000.0,-70.0,-70.0,-66.0,-60.0,-69.0,-70.0,-66.0,-60.0,-75.0,-83.0,-75.0,-84.0,5.0,13.0,9.0,24.0,1
1371,CC:2F:71:3F:1F:24,2306230,475973987,154493,202989458,2151737,272984529,3,112491,134810960,112426,134802756,65,8204,108916,331,154530,28234,3,59,144444.0,43333.0,-68.0,-63.0,-68.0,-71.0,-68.0,-63.0,-67.0,-71.0,-75.0,-83.0,-75.0,-84.0,7.0,20.0,7.0,13.0,1
1372,F8:59:71:5A:E0:3D,2200712,347621418,48975,74636889,2151737,272984529,0,34583,49595491,34517,49584762,66,10729,34404,12,49011,5597,0,28,144444.0,43333.0,-66.0,-72.0,-65.0,-71.0,-65.0,-72.0,-65.0,-71.0,-75.0,-83.0,-75.0,-84.0,9.0,11.0,10.0,13.0,1
1373,CC:2F:71:3E:C5:1F,2151801,272992108,62,7377,2151739,272984731,0,292,24707,246,19081,46,5626,70,1,105,6,0,13,130000.0,39000.0,-70.0,-70.0,-66.0,-60.0,-69.0,-70.0,-66.0,-60.0,-75.0,-83.0,-75.0,-84.0,5.0,13.0,9.0,24.0,1
1374,CC:2F:71:3F:1F:24,2306391,476177688,154650,203192755,2151741,272984933,3,112636,135006891,112571,134998687,65,8204,109061,331,154687,28236,3,59,144444.0,43333.0,-67.0,-64.0,-67.0,-71.0,-67.0,-63.0,-68.0,-70.0,-75.0,-83.0,-75.0,-84.0,8.0,19.0,8.0,13.0,1
1375,F8:59:71:5A:E0:3D,2200779,347718230,49037,74733237,2151742,272984993,0,34645,49690971,34579,49680242,66,10729,34466,12,49073,5597,0,28,144444.0,43333.0,-65.0,-72.0,-66.0,-71.0,-65.0,-72.0,-65.0,-71.0,-75.0,-83.0,-75.0,-84.0,10.0,11.0,9.0,13.0,1
1376,CC:2F:71:3E:C5:1F,2151804,272992370,62,7377,2151742,272984993,0,292,24707,246,19081,46,5626,70,1,105,6,0,13,130000.0,39000.0,-70.0,-70.0,-66.0,-60.0,-69.0,-70.0,-66.0,-60.0,-75.0,-83.0,-75.0,-84.0,5.0,13.0,9.0,24.0,1
1377,CC:2F:71:3F:1F:24,2306551,476386962,154809,203401969,2151742,272984993,3,112779,135203975,112714,135195771,65,8204,109204,331,154846,28240,3,59,144444.0,43333.0,-69.0,-64.0,-69.0,-71.0,-68.0,-64.0,-67.0,-71.0,-75.0,-83.0,-75.0,-84.0,6.0,19.0,6.0,13.0,1
1378,F8:59:71:5A:E0:3D,2200850,347818551,49104,74833154,2151746,272985397,0,34712,49791703,34646,49780974,66,10729,34533,12,49140,5598,0,28,144444.0,43333.0,-66.0,-73.0,-65.0,-71.0,-65.0,-72.0,-65.0,-70.0,-75.0,-83.0,-75.0,-84.0,9.0,10.0,10.0,13.0,1
1379,CC:2F:71:3E:C5:1F,2151808,272992774,62,7377,2151746,272985397,0,292,24707,246,19081,46,5626,70,1,105,6,0,13,130000.0,39000.0,-70.0,-70.0,-66.0,-60.0,-69.0,-70.0,-66.0,-60.0,-75.0,-83.0,-75.0,-84.0,5.0,13.0,9.0,24.0,1
1380,CC:2F:71:3F:1F:24,2306710,476590196,154964,203604799,2151746,272985397,3,112922,135399635,112857,135391431,65,8204,109347,331,155001,28242,3,59,144444.0,43333.0,-68.0,-64.0,-68.0,-71.0,-68.0,-64.0,-68.0,-71.0,-75.0,-83.0,-75.0,-84.0,7.0,19.0,7.0,13.0,1
1381,F8:59:71:5A:E0:3D,2200916,347915303,49166,74929502,2151750,272985801,0,34774,49887183,34708,49876454,66,10729,34595,12,49202,5598,0,28,144444.0,43333.0,-65.0,-72.0,-67.0,-71.0,-66.0,-72.0,-65.0,-71.0,-75.0,-83.0,-75.0,-84.0,10.0,11.0,8.0,13.0,1
1382,CC:2F:71:3E:C5:1F,2151812,272993178,62,7377,2151750,272985801,0,292,24707,246,19081,46,5626,70,1,105,6,0,13,130000.0,39000.0,-70.0,-70.0,-66.0,-60.0,-69.0,-70.0,-66.0,-60.0,-75.0,-83.0,-75.0,-84.0,5.0,13.0,9.0,24.0,1
1383,CC:2F:71:3F:1F:24,2306882,476800906,155132,203815105,2151750,272985801,3,113076,135597199,113011,135588995,65,8204,109501,331,155169,28244,3,59,144444.0,43333.0,-67.0,-64.0,-67.0,-72.0,-68.0,-64.0,-68.0,-71.0,-75.0,-83.0,-75.0,-84.0,8.0,19.0,8.0,12.0,1
1384,F8:59:71:5A:E0:3D,2200984,348013669,49229,75027404,2151755,272986265,0,34837,49984203,34771,49973474,66,10729,34658,12,49265,5598,0,28,144444.0,43333.0,-66.0,-73.0,-65.0,-71.0,-65.0,-72.0,-65.0,-70.0,-75.0,-83.0,-75.0,-84.0,9.0,10.0,10.0,13.0,1
1385,CC:2F:71:3E:C5:1F,2151817,272993642,62,7377,2151755,272986265,0,294,24847,248,19221,46,5626,70,1,106,6,0,13,130000.0,39000.0,-69.0,-70.0,-67.0,-61.0,-69.0,-70.0,-66.0,-60.0,-75.0,-83.0,-75.0,-84.0,6.0,13.0,8.0,23.0,1
1386,CC:2F:71:3F:1F:24,2307045,477007590,155290,204021325,2151755,272986265,3,113225,135797925,113160,135789721,65,8204,109650,331,155327,28244,3,59,144444.0,43333.0,-68.0,-64.0,-68.0,-70.0,-68.0,-63.0,-68.0,-70.0,-75.0,-83.0,-75.0,-84.0,7.0,19.0,7.0,14.0,1
1387,F8:59:71:5A:E0:3D,2201052,348112091,49293,75125422,2151759,272986669,0,34901,50081329,34835,50070600,66,10729,34722,12,49329,5599,0,28,144444.0,43333.0,-65.0,-72.0,-66.0,-71.0,-66.0,-72.0,-65.0,-70.0,-75.0,-83.0,-75.0,-84.0,10.0,11.0,9.0,13.0,1
1388,CC:2F:71:3E:C5:1F,2151821,272994046,62,7377,2151759,272986669,0,294,24847,248,19221,46,5626,70,1,106,6,0,13,130000.0,39000.0,-69.0,-70.0,-67.0,-61.0,-69.0,-70.0,-66.0,-60.0,-75.0,-83.0,-75.0,-84.0,6.0,13.0,8.0,23.0,1
1389,CC:2F:71:3F:1F:24,2307209,477214446,155450,204227777,2151759,272986669,3,113368,135992151,113303,135983947,65,8204,109793,331,155487,28244,3,59,144444.0,43333.0,-69.0,-63.0,-68.0,-70.0,-68.0,-63.0,-67.0,-70.0,-75.0,-83.0,-75.0,-84.0,6.0,20.0,7.0,14.0,1
1390,F8:59:71:5A:E0:3D,2201365,348590862,49600,75603454,2151765,272987408,0,34989,50183315,34922,50172468,67,10847,34810,12,49636,5600,0,28,144444.0,43333.0,-67.0,-73.0,-65.0,-71.0,-65.0,-72.0,-65.0,-70.0,-75.0,-83.0,-75.0,-84.0,8.0,10.0,10.0,13.0,1
1391,CC:2F:71:3E:C5:1F,2151828,272994901,63,7493,2151765,272987408,0,296,24987,250,19361,46,5626,70,1,107,6,0,13,130000.0,39000.0,-70.0,-70.0,-67.0,-60.0,-69.0,-70.0,-66.0,-60.0,-75.0,-83.0,-75.0,-84.0,5.0,13.0,8.0,24.0,1
1392,CC:2F:71:3F:1F:24,2307370,477418167,155605,204430759,2151765,272987408,3,113512,136186503,113447,136178299,65,8204,109937,331,155642,28248,3,59,144444.0,43333.0,-69.0,-64.0,-68.0,-72.0,-68.0,-64.0,-68.0,-72.0,-75.0,-83.0,-75.0,-84.0,6.0,19.0,7.0,12.0,1
1393,F8:59:71:5A:E0:3D,2201433,348689228,49663,75701356,2151770,272987872,0,35051,50278795,34984,50267948,67,10847,34872,12,49699,5600,0,28,144444.0,43333.0,-65.0,-72.0,-66.0,-70.0,-65.0,-72.0,-66.0,-70.0,-75.0,-83.0,-75.0,-84.0,10.0,11.0,9.0,14.0,1
1394,CC:2F:71:3E:C5:1F,2151833,272995365,63,7493,2151770,272987872,0,296,24987,250,19361,46,5626,70,1,107,6,0,13,130000.0,39000.0,-70.0,-70.0,-67.0,-60.0,-69.0,-70.0,-66.0,-60.0,-75.0,-83.0,-75.0,-84.0,5.0,13.0,8.0,24.0,1
1395,CC:2F:71:3F:1F:24,2307531,477621743,155761,204633871,2151770,272987872,3,113652,136380391,113587,136372187,65,8204,110077,331,155798,28248,3,59,144444.0,43333.0,-67.0,-64.0,-68.0,-71.0,-68.0,-64.0,-68.0,-71.0,-75.0,-83.0,-75.0,-84.0,8.0,19.0,7.0,13.0,1
1396,F8:59:71:5A:E0:3D,2201501,348787790,49729,75799716,2151772,272988074,0,35118,50379597,35051,50368750,67,10847,34939,12,49765,5600,0,28,144444.0,43333.0,-66.0,-72.0,-65.0,-71.0,-65.0,-71.0,-65.0,-70.0,-75.0,-83.0,-75.0,-84.0,9.0,11.0,10.0,13.0,1
1397,CC:2F:71:3E:C5:1F,2151837,272995769,63,7493,2151774,272988276,0,296,24987,250,19361,46,5626,70,1,107,6,0,13,130000.0,39000.0,-70.0,-70.0,-67.0,-60.0,-69.0,-70.0,-66.0,-60.0,-75.0,-83.0,-75.0,-84.0,5.0,13.0,8.0,24.0,1
1398,CC:2F:71:3F:1F:24,2307698,477828730,155924,204840454,2151774,272988276,3,113803,136578908,113738,136570704,65,8204,110227,331,155961,28250,3,59,144444.0,43333.0,-69.0,-64.0,-69.0,-71.0,-68.0,-63.0,-68.0,-71.0,-75.0,-83.0,-75.0,-84.0,6.0,19.0,6.0,13.0,1
1399,F8:59:71:5A:E0:3D,2201570,348886298,49792,75897618,2151778,272988680,0,35180,50475077,35113,50464230,67,10847,35001,12,49828,5600,0,28,144444.0,43333.0,-65.0,-72.0,-67.0,-71.0,-65.0,-72.0,-66.0,-70.0,-75.0,-83.0,-75.0,-84.0,10.0,11.0,8.0,13.0,1
1400,CC:2F:71:3E:C5:1F,2151841,272996173,63,7493,2151778,272988680,0,296,24987,250,19361,46,5626,70,1,107,6,0,13,130000.0,39000.0,-70.0,-70.0,-67.0,-60.0,-69.0,-70.0,-66.0,-60.0,-75.0,-83.0,-75.0,-84.0,5.0,13.0,8.0,24.0,1
1401,CC:2F:71:3F:1F:24,2307860,478035354,156082,205046674,2151778,272988680,3,113947,136774684,113882,136766480,65,8204,110371,331,156117,28252,3,59,144444.0,43333.0,-69.0,-64.0,-68.0,-73.0,-68.0,-64.0,-68.0,-71.0,-75.0,-83.0,-75.0,-84.0,6.0,19.0,7.0,11.0,1
1402,F8:59:71:5A:E0:3D,2201747,349158427,49968,76169687,2151779,272988740,0,35255,50575313,35188,50564466,67,10847,35076,12,50004,5642,0,28,144444.0,43333.0,-66.0,-72.0,-66.0,-71.0,-65.0,-72.0,-65.0,-70.0,-75.0,-83.0,-75.0,-84.0,9.0,11.0,9.0,13.0,1
1403,CC:2F:71:3E:C5:1F,2151842,272996233,63,7493,2151779,272988740,0,296,24987,250,19361,46,5626,70,1,107,6,0,13,130000.0,39000.0,-70.0,-70.0,-67.0,-60.0,-69.0,-70.0,-66.0,-60.0,-75.0,-83.0,-75.0,-84.0,5.0,13.0,8.0,24.0,1
1404,CC:2F:71:3F:1F:24,2308019,478242004,156240,205253264,2151779,272988740,3,114090,136971802,114025,136963598,65,8204,110514,331,156277,28260,3,59,144444.0,43333.0,-68.0,-64.0,-68.0,-71.0,-67.0,-63.0,-67.0,-71.0,-75.0,-83.0,-75.0,-84.0,7.0,19.0,7.0,13.0,1
1405,F8:59:71:5A:E0:3D,2201817,349258489,50032,76269143,2151785,272989346,0,35319,50673873,35252,50663026,67,10847,35140,12,50068,5642,0,28,144444.0,43333.0,-65.0,-72.0,-65.0,-71.0,-65.0,-72.0,-65.0,-71.0,-75.0,-83.0,-75.0,-84.0,10.0,11.0,10.0,13.0,1
1406,CC:2F:71:3E:C5:1F,2151848,272996839,63,7493,2151785,272989346,0,296,24987,250,19361,46,5626,70,1,107,6,0,13,130000.0,39000.0,-70.0,-70.0,-67.0,-60.0,-69.0,-70.0,-66.0,-60.0,-75.0,-83.0,-75.0,-84.0,5.0,13.0,8.0,24.0,1
1407,CC:2F:71:3F:1F:24,2308196,478449704,156411,205460358,2151785,272989346,3,114246,137172504,114181,137164300,65,8204,110670,331,156448,28266,3,59,144444.0,43333.0,-65.0,-64.0,-65.0,-72.0,-67.0,-64.0,-68.0,-71.0,-75.0,-83.0,-75.0,-84.0,10.0,19.0,10.0,12.0,1
1408,F8:59:71:5A:E0:3D,2201881,349355039,50094,76365491,2151787,272989548,0,35381,50769353,35314,50758506,67,10847,35202,12,50130,5643,0,28,144444.0,43333.0,-66.0,-72.0,-67.0,-71.0,-65.0,-72.0,-65.0,-71.0,-75.0,-83.0,-75.0,-84.0,9.0,11.0,8.0,13.0,1
1409,CC:2F:71:3E:C5:1F,2151850,272997041,63,7493,2151787,272989548,0,296,24987,250,19361,46,5626,70,1,107,6,0,13,130000.0,39000.0,-70.0,-70.0,-67.0,-60.0,-69.0,-70.0,-66.0,-60.0,-75.0,-83.0,-75.0,-84.0,5.0,13.0,8.0,24.0,1
1410,CC:2F:71:3F:1F:24,2308362,478656513,156575,205666965,2151787,272989548,3,114397,137368165,114332,137359961,65,8204,110821,331,156612,28270,3,59,144444.0,43333.0,-67.0,-64.0,-67.0,-72.0,-67.0,-64.0,-67.0,-72.0,-75.0,-83.0,-75.0,-84.0,8.0,19.0,8.0,12.0,1
1411,F8:59:71:5A:E0:3D,2201954,349452770,50162,76462758,2151792,272990012,0,35447,50866465,35380,50855618,67,10847,35268,12,50198,5644,0,28,144444.0,43333.0,-66.0,-72.0,-66.0,-71.0,-65.0,-72.0,-65.0,-70.0,-75.0,-83.0,-75.0,-84.0,9.0,11.0,9.0,13.0,1
1412,CC:2F:71:3E:C5:1F,2151856,272997567,63,7493,2151793,272990074,0,296,24987,250,19361,46,5626,70,1,107,6,0,13,130000.0,39000.0,-70.0,-70.0,-67.0,-60.0,-69.0,-70.0,-66.0,-60.0,-75.0,-83.0,-75.0,-84.0,5.0,13.0,8.0,24.0,1
1413,CC:2F:71:3F:1F:24,2308524,478860093,156729,205869817,2151795,272990276,3,114539,137563711,114473,137555389,66,8322,110963,331,156766,28271,3,59,144444.0,43333.0,-68.0,-64.0,-68.0,-71.0,-68.0,-64.0,-68.0,-71.0,-75.0,-83.0,-75.0,-84.0,7.0,19.0,7.0,13.0,1
1414,F8:59:71:5A:E0:3D,2202241,349884585,50444,76894107,2151797,272990478,0,35536,50976385,35469,50965538,67,10847,35357,12,50480,5645,0,28,144444.0,43333.0,-65.0,-72.0,-67.0,-70.0,-66.0,-72.0,-66.0,-70.0,-75.0,-83.0,-75.0,-84.0,10.0,11.0,8.0,14.0,1
1415,CC:2F:71:3E:C5:1F,2151860,272997971,63,7493,2151797,272990478,0,296,24987,250,19361,46,5626,70,1,107,6,0,13,130000.0,39000.0,-70.0,-70.0,-67.0,-60.0,-69.0,-70.0,-66.0,-60.0,-75.0,-83.0,-75.0,-84.0,5.0,13.0,8.0,24.0,1
1416,CC:2F:71:3F:1F:24,2308683,479066385,156886,206075907,2151797,272990478,3,114680,137756291,114614,137747969,66,8322,111104,331,156921,28272,3,59,144444.0,43333.0,-68.0,-64.0,-68.0,-72.0,-68.0,-63.0,-68.0,-71.0,-75.0,-83.0,-75.0,-84.0,7.0,19.0,7.0,12.0,1
1417,F8:59:71:5A:E0:3D,2202311,349983352,50510,76992470,2151801,272990882,0,35601,51074037,35534,51063190,67,10847,35422,12,50546,5645,0,28,144444.0,43333.0,-65.0,-72.0,-66.0,-71.0,-65.0,-72.0,-65.0,-70.0,-75.0,-83.0,-75.0,-84.0,10.0,11.0,9.0,13.0,1
1418,CC:2F:71:3E:C5:1F,2151864,272998375,63,7493,2151801,272990882,0,296,24987,250,19361,46,5626,70,1,107,6,0,13,130000.0,39000.0,-70.0,-70.0,-67.0,-60.0,-69.0,-70.0,-66.0,-60.0,-75.0,-83.0,-75.0,-84.0,5.0,13.0,8.0,24.0,1
1419,CC:2F:71:3F:1F:24,2308843,479270029,157042,206279147,2151801,272990882,3,114825,137953731,114759,137945409,66,8322,111249,331,157079,28274,3,59,144444.0,43333.0,-69.0,-64.0,-70.0,-71.0,-68.0,-64.0,-68.0,-72.0,-75.0,-83.0,-75.0,-84.0,6.0,19.0,5.0,13.0,1
1420,F8:59:71:5A:E0:3D,2202378,350080164,50572,77088818,2151806,272991346,0,35664,51171057,35597,51160210,67,10847,35485,12,50608,5645,0,28,144444.0,43333.0,-66.0,-72.0,-66.0,-70.0,-65.0,-72.0,-66.0,-70.0,-75.0,-83.0,-75.0,-84.0,9.0,11.0,9.0,14.0,1
1421,CC:2F:71:3E:C5:1F,2151869,272998839,63,7493,2151806,272991346,0,296,24987,250,19361,46,5626,70,1,107,6,0,13,130000.0,39000.0,-70.0,-70.0,-67.0,-60.0,-69.0,-70.0,-66.0,-60.0,-75.0,-83.0,-75.0,-84.0,5.0,13.0,8.0,24.0,1
1422,CC:2F:71:3F:1F:24,2309011,479477078,157205,206485732,2151806,272991346,3,114974,138149154,114908,138140832,66,8322,111398,331,157242,28275,3,59,144444.0,43333.0,-68.0,-64.0,-69.0,-72.0,-68.0,-64.0,-68.0,-72.0,-75.0,-83.0,-75.0,-84.0,7.0,19.0,6.0,12.0,1
1423,F8:59:71:5A:E0:3D,2202442,350176546,50634,77184998,2151808,272991548,0,35726,51266537,35659,51255690,67,10847,35547,12,50670,5646,0,28,144444.0,43333.0,-66.0,-72.0,-66.0,-71.0,-65.0,-72.0,-65.0,-70.0,-75.0,-83.0,-75.0,-84.0,9.0,11.0,9.0,13.0,1
1424,CC:2F:71:3E:C5:1F,2151871,272999041,63,7493,2151808,272991548,0,296,24987,250,19361,46,5626,70,1,107,6,0,13,130000.0,39000.0,-70.0,-70.0,-67.0,-60.0,-69.0,-70.0,-66.0,-60.0,-75.0,-83.0,-75.0,-84.0,5.0,13.0,8.0,24.0,1
1425,CC:2F:71:3F:1F:24,2309170,479680464,157360,206688714,2151810,272991750,3,115115,138341734,115049,138333412,66,8322,111539,331,157397,28280,3,59,144444.0,43333.0,-69.0,-64.0,-69.0,-72.0,-68.0,-63.0,-67.0,-71.0,-75.0,-83.0,-75.0,-84.0,6.0,19.0,6.0,12.0,1
1426,F8:59:71:5A:E0:3D,2202510,350273500,50696,77281346,2151814,272992154,0,35788,51362017,35721,51351170,67,10847,35609,12,50732,5646,0,28,144444.0,43333.0,-66.0,-72.0,-66.0,-70.0,-65.0,-72.0,-65.0,-70.0,-75.0,-83.0,-75.0,-84.0,9.0,11.0,9.0,14.0,1
1427,CC:2F:71:3E:C5:1F,2151877,272999647,63,7493,2151814,272992154,0,296,24987,250,19361,46,5626,70,1,107,6,0,13,130000.0,39000.0,-70.0,-70.0,-67.0,-60.0,-69.0,-70.0,-66.0,-60.0,-75.0,-83.0,-75.0,-84.0,5.0,13.0,8.0,24.0,1
1428,CC:2F:71:3F:1F:24,2309337,479885464,157523,206893310,2151814,272992154,3,115261,138540467,115195,138532145,66,8322,111685,331,157560,28282,3,59,144444.0,43333.0,-69.0,-64.0,-68.0,-71.0,-68.0,-63.0,-68.0,-71.0,-75.0,-83.0,-75.0,-84.0,6.0,19.0,7.0,13.0,1
1429,F8:59:71:5A:E0:3D,2202573,350369908,50758,77377694,2151815,272992214,0,35850,51457497,35783,51446650,67,10847,35671,12,50794,5647,0,28,144444.0,43333.0,-65.0,-72.0,-66.0,-70.0,-65.0,-71.0,-66.0,-70.0,-75.0,-83.0,-75.0,-84.0,10.0,11.0,9.0,14.0,1
1430,CC:2F:71:3E:C5:1F,2151878,272999707,63,7493,2151815,272992214,0,296,24987,250,19361,46,5626,70,1,107,6,0,13,130000.0,39000.0,-70.0,-70.0,-67.0,-60.0,-69.0,-70.0,-66.0,-60.0,-75.0,-83.0,-75.0,-84.0,5.0,13.0,8.0,24.0,1
1431,CC:2F:71:3F:1F:24,2309494,480088636,157679,207096422,2151815,272992214,3,115403,138734587,115337,138726265,66,8322,111827,331,157716,28285,3,59,144444.0,43333.0,-69.0,-64.0,-69.0,-69.0,-68.0,-64.0,-68.0,-69.0,-75.0,-83.0,-75.0,-84.0,6.0,19.0,6.0,15.0,1
1432,F8:59:71:5A:E0:3D,2202642,350466924,50820,77474042,2151822,272992882,0,35912,51552977,35845,51542130,67,10847,35733,12,50856,5647,0,28,144444.0,43333.0,-65.0,-71.0,-67.0,-71.0,-65.0,-71.0,-66.0,-70.0,-75.0,-83.0,-75.0,-84.0,10.0,12.0,8.0,13.0,1
1433,CC:2F:71:3E:C5:1F,2151887,273000577,63,7493,2151824,272993084,0,298,25175,251,19431,47,5744,71,1,107,6,0,13,130000.0,39000.0,-73.0,-80.0,-72.0,-71.0,-70.0,-71.0,-67.0,-61.0,-75.0,-83.0,-75.0,-84.0,2.0,3.0,3.0,13.0,1
1434,CC:2F:71:3F:1F:24,2309666,480293789,157842,207300705,2151824,272993084,3,115551,138931669,115485,138923347,66,8322,111975,331,157879,28288,3,59,144444.0,43333.0,-68.0,-64.0,-69.0,-72.0,-67.0,-63.0,-67.0,-71.0,-75.0,-83.0,-75.0,-84.0,7.0,19.0,6.0,12.0,1
1435,F8:59:71:5A:E0:3D,2202707,350563747,50882,77570390,2151825,272993357,0,35974,51648457,35907,51637610,67,10847,35795,12,50918,5647,0,28,144444.0,43333.0,-66.0,-73.0,-65.0,-70.0,-66.0,-72.0,-65.0,-70.0,-75.0,-83.0,-75.0,-84.0,9.0,10.0,10.0,14.0,1
1436,CC:2F:71:3E:C5:1F,2151888,273000850,63,7493,2151825,272993357,0,298,25175,251,19431,47,5744,71,1,107,6,0,13,130000.0,39000.0,-73.0,-80.0,-72.0,-71.0,-70.0,-71.0,-67.0,-61.0,-75.0,-83.0,-75.0,-84.0,2.0,3.0,3.0,13.0,1
1437,CC:2F:71:3F:1F:24,2309829,480500459,158004,207507102,2151825,272993357,3,115701,139128631,115635,139120309,66,8322,112125,331,158041,28345,3,59,130000.0,43333.0,-68.0,-64.0,-65.0,-70.0,-68.0,-63.0,-67.0,-69.0,-75.0,-83.0,-75.0,-84.0,7.0,19.0,10.0,14.0,1
1438,F8:59:71:5A:E0:3D,2202776,350660761,50944,77666738,2151832,272994023,0,36036,51743937,35969,51733090,67,10847,35857,12,50980,5648,0,28,144444.0,43333.0,-66.0,-73.0,-65.0,-70.0,-66.0,-73.0,-64.0,-70.0,-75.0,-83.0,-75.0,-84.0,9.0,10.0,10.0,14.0,1
1439,CC:2F:71:3E:C5:1F,2151895,273001516,63,7493,2151832,272994023,0,298,25175,251,19431,47,5744,71,1,107,6,0,13,130000.0,39000.0,-73.0,-80.0,-72.0,-71.0,-70.0,-71.0,-67.0,-61.0,-75.0,-83.0,-75.0,-84.0,2.0,3.0,3.0,13.0,1
1440,CC:2F:71:3F:1F:24,2309992,480704237,158160,207710214,2151832,272994023,3,115844,139322867,115778,139314545,66,8322,112268,331,158197,28345,3,59,130000.0,43333.0,-69.0,-62.0,-70.0,-69.0,-69.0,-62.0,-69.0,-68.0,-75.0,-83.0,-75.0,-84.0,6.0,21.0,5.0,15.0,1
1441,F8:59:71:5A:E0:3D,2202841,350758865,51007,77764640,2151834,272994225,0,36099,51840957,36032,51830110,67,10847,35920,12,51043,5648,0,28,144444.0,43333.0,-66.0,-73.0,-64.0,-70.0,-66.0,-73.0,-65.0,-69.0,-75.0,-83.0,-75.0,-84.0,9.0,10.0,11.0,14.0,1
1442,CC:2F:71:3E:C5:1F,2151897,273001718,63,7493,2151834,272994225,0,298,25175,251,19431,47,5744,71,1,107,6,0,13,130000.0,39000.0,-73.0,-80.0,-72.0,-71.0,-70.0,-71.0,-67.0,-61.0,-75.0,-83.0,-75.0,-84.0,2.0,3.0,3.0,13.0,1
1443,CC:2F:71:3F:1F:24,2310166,480918436,158332,207924211,2151834,272994225,3,115997,139527948,115931,139519626,66,8322,112421,331,158369,28347,3,59,130000.0,43333.0,-68.0,-63.0,-69.0,-69.0,-68.0,-63.0,-68.0,-69.0,-75.0,-83.0,-75.0,-84.0,7.0,20.0,6.0,15.0,1
1444,F8:59:71:5A:E0:3D,2203100,351156084,51262,78161455,2151838,272994629,0,36184,51945271,36117,51934424,67,10847,36005,12,51298,5666,0,28,144444.0,43333.0,-66.0,-74.0,-64.0,-70.0,-65.0,-73.0,-64.0,-69.0,-75.0,-83.0,-75.0,-84.0,9.0,9.0,11.0,14.0,1
1445,CC:2F:71:3E:C5:1F,2151904,273002384,63,7493,2151841,272994891,0,298,25175,251,19431,47,5744,71,1,107,6,0,13,130000.0,39000.0,-73.0,-80.0,-72.0,-71.0,-70.0,-71.0,-67.0,-61.0,-75.0,-83.0,-75.0,-84.0,2.0,3.0,3.0,13.0,1
1446,CC:2F:71:3F:1F:24,2310340,481133135,158499,208138244,2151841,272994891,3,116145,139731347,116079,139723025,66,8322,112569,331,158536,28389,3,59,104000.0,26000.0,-68.0,-64.0,-68.0,-69.0,-67.0,-64.0,-68.0,-68.0,-75.0,-83.0,-75.0,-84.0,7.0,19.0,7.0,15.0,1
1447,F8:59:71:5A:E0:3D,2203294,351450192,51451,78455099,2151843,272995093,0,36262,52050127,36195,52039280,67,10847,36083,12,51487,5666,0,28,144444.0,43333.0,-67.0,-73.0,-64.0,-70.0,-65.0,-73.0,-64.0,-70.0,-75.0,-83.0,-75.0,-84.0,8.0,10.0,11.0,14.0,1
1448,CC:2F:71:3E:C5:1F,2151906,273002586,63,7493,2151843,272995093,0,298,25175,251,19431,47,5744,71,1,107,6,0,13,130000.0,39000.0,-73.0,-80.0,-72.0,-71.0,-70.0,-71.0,-67.0,-61.0,-75.0,-83.0,-75.0,-84.0,2.0,3.0,3.0,13.0,1
1449,CC:2F:71:3F:1F:24,2310504,481339682,158661,208344589,2151843,272995093,3,116293,139926654,116227,139918332,66,8322,112717,331,158698,28389,3,59,115556.0,28889.0,-68.0,-63.0,-69.0,-70.0,-67.0,-63.0,-68.0,-69.0,-75.0,-83.0,-75.0,-84.0,7.0,20.0,6.0,14.0,1
1450,F8:59:71:5A:E0:3D,2203358,351546742,51513,78551447,2151845,272995295,0,36324,52145607,36257,52134760,67,10847,36145,12,51549,5666,0,28,144444.0,43333.0,-66.0,-73.0,-64.0,-71.0,-65.0,-73.0,-64.0,-70.0,-75.0,-83.0,-75.0,-84.0,9.0,10.0,11.0,13.0,1
1451,CC:2F:71:3E:C5:1F,2151908,273002788,63,7493,2151845,272995295,0,298,25175,251,19431,47,5744,71,1,107,6,0,13,130000.0,39000.0,-73.0,-80.0,-72.0,-71.0,-70.0,-71.0,-67.0,-61.0,-75.0,-83.0,-75.0,-84.0,2.0,3.0,3.0,13.0,1
1452,CC:2F:71:3F:1F:24,2310662,481542996,158817,208547701,2151845,272995295,3,116439,140122662,116373,140114340,66,8322,112863,331,158854,28391,3,59,115556.0,28889.0,-66.0,-63.0,-64.0,-69.0,-66.0,-63.0,-65.0,-69.0,-75.0,-83.0,-75.0,-84.0,9.0,20.0,11.0,15.0,1
