sample,station,tx_total_pkts,tx_total_bytes,tx_ucast_pkts,tx_ucast_bytes,tx_mcast_bcast_pkts,tx_mcast_bcast_bytes,tx_failures,rx_data_pkts,rx_data_bytes,rx_ucast_pkts,rx_ucast_bytes,rx_mcast_bcast_pkts,rx_mcast_bcast_bytes,rx_decrypt_succeeds,tx_data_pkts_retried,tx_total_pkts_sent,tx_pkts_retries,tx_pkts_retry_exhausted,rx_total_pkts_retried,rate_last_tx_pkt_min,rate_last_tx_pkt_max,per_antenna_rssi_last_rx_data_frame_1,per_antenna_rssi_last_rx_data_frame_2,per_antenna_rssi_last_rx_data_frame_3,per_antenna_rssi_last_rx_data_frame_4,per_antenna_avg_rssi_rx_data_frames_1,per_antenna_avg_rssi_rx_data_frames_2,per_antenna_avg_rssi_rx_data_frames_3,per_antenna_avg_rssi_rx_data_frames_4,per_antenna_noise_floor_1,per_antenna_noise_floor_2,per_antenna_noise_floor_3,per_antenna_noise_floor_4,sinr_per_antenna_1,sinr_per_antenna_2,sinr_per_antenna_3,sinr_per_antenna_4,attack
1,F8:59:71:5A:E0:3D,2653069,373980049,26984,41542173,2626085,332437876,0,2995,370264,2950,361461,45,8803,2965,0,26991,865,0,19,144444.0,39000.0,-65.0,-73.0,-65.0,-71.0,-66.0,-74.0,-65.0,-71.0,-90.0,-92.0,-89.0,-92.0,25.0,19.0,24.0,21.0,0
2,CC:2F:71:3E:C5:1F,2631204,333063898,5119,626022,2626085,332437876,6,21971,1842180,18111,1384782,3860,457398,5401,29,7297,130,6,448,130000.0,39000.0,-70.0,-71.0,-68.0,-60.0,-69.0,-70.0,-67.0,-59.0,-90.0,-92.0,-89.0,-92.0,20.0,21.0,21.0,32.0,0
3,CC:2F:71:3F:1F:24,3107274,950806080,481189,618368204,2626085,332437876,19,364940,413650972,361068,413184378,3872,466594,339651,579,483264,56800,19,4534,130000.0,43333.0,-70.0,-64.0,-74.0,-68.0,-69.0,-64.0,-75.0,-68.0,-90.0,-92.0,-89.0,-92.0,20.0,28.0,15.0,24.0,0
4,F8:59:71:5A:E0:3D,2653075,373980655,26984,41542173,2626091,332438482,0,2995,370264,2950,361461,45,8803,2965,0,26991,865,0,19,144444.0,39000.0,-65.0,-73.0,-65.0,-71.0,-66.0,-74.0,-65.0,-71.0,-90.0,-92.0,-89.0,-92.0,25.0,19.0,24.0,21.0,0
5,CC:2F:71:3E:C5:1F,2631210,333064504,5119,626022,2626091,332438482,6,21973,1842320,18113,1384922,3860,457398,5401,29,7298,130,6,448,130000.0,39000.0,-70.0,-71.0,-68.0,-59.0,-69.0,-71.0,-67.0,-59.0,-90.0,-92.0,-89.0,-92.0,20.0,21.0,21.0,33.0,0
6,CC:2F:71:3F:1F:24,3107322,950822316,481220,618378410,2626102,332443906,19,364957,413653970,361085,413187376,3872,466594,339667,579,483295,56832,19,4534,117000.0,39000.0,-69.0,-64.0,-75.0,-68.0,-69.0,-64.0,-75.0,-68.0,-90.0,-92.0,-89.0,-92.0,21.0,28.0,14.0,24.0,0
7,F8:59:71:5A:E0:3D,2653103,373992225,26988,41542693,2626115,332449532,0,2999,370660,2954,361857,45,8803,2967,0,26995,865,0,19,144444.0,39000.0,-65.0,-74.0,-65.0,-70.0,-66.0,-74.0,-66.0,-71.0,-90.0,-92.0,-89.0,-92.0,25.0,18.0,24.0,22.0,0
8,CC:2F:71:3E:C5:1F,2631234,333075554,5119,626022,2626115,332449532,6,21973,1842320,18113,1384922,3860,457398,5401,29,7298,130,6,448,130000.0,39000.0,-70.0,-71.0,-68.0,-59.0,-69.0,-71.0,-67.0,-59.0,-90.0,-92.0,-89.0,-92.0,20.0,21.0,21.0,33.0,0
9,CC:2F:71:3F:1F:24,3107371,950838932,481256,618389400,2626115,332449532,19,364979,413657580,361107,413190986,3872,466594,339687,579,483331,56836,19,4534,130000.0,39000.0,-72.0,-66.0,-76.0,-70.0,-71.0,-65.0,-74.0,-69.0,-90.0,-92.0,-89.0,-92.0,18.0,26.0,13.0,22.0,0
10,F8:59:71:5A:E0:3D,2653110,373992813,26988,41542693,2626122,332450120,0,3000,370778,2954,361857,46,8921,2968,0,26995,865,0,19,144444.0,39000.0,-65.0,-74.0,-65.0,-69.0,-66.0,-74.0,-66.0,-71.0,-90.0,-92.0,-89.0,-92.0,25.0,18.0,24.0,23.0,0
11,CC:2F:71:3E:C5:1F,2631241,333076142,5119,626022,2626122,332450120,6,21973,1842320,18113,1384922,3860,457398,5401,29,7298,130,6,448,130000.0,39000.0,-70.0,-71.0,-68.0,-59.0,-69.0,-71.0,-67.0,-59.0,-90.0,-92.0,-89.0,-92.0,20.0,21.0,21.0,33.0,0
12,CC:2F:71:3F:1F:24,3107416,950850673,481292,618400351,2626124,332450322,19,365003,413661385,361130,413194673,3873,466712,339709,579,483367,56846,19,4534,130000.0,43333.0,-73.0,-63.0,-74.0,-66.0,-73.0,-63.0,-74.0,-65.0,-90.0,-92.0,-89.0,-92.0,17.0,29.0,15.0,26.0,0
13,F8:59:71:5A:E0:3D,2653112,373993015,26988,41542693,2626124,332450322,0,3001,370848,2955,361927,46,8921,2968,0,26995,865,0,19,144444.0,39000.0,-65.0,-72.0,-65.0,-69.0,-66.0,-74.0,-66.0,-70.0,-90.0,-92.0,-89.0,-92.0,25.0,20.0,24.0,23.0,0
14,CC:2F:71:3E:C5:1F,2631243,333076344,5119,626022,2626124,332450322,6,21973,1842320,18113,1384922,3860,457398,5401,29,7298,130,6,448,130000.0,39000.0,-70.0,-71.0,-68.0,-59.0,-69.0,-71.0,-67.0,-59.0,-90.0,-92.0,-89.0,-92.0,20.0,21.0,21.0,33.0,0
15,CC:2F:71:3F:1F:24,3107459,950862381,481333,618411857,2626126,332450524,19,365031,413665613,361158,413198901,3873,466712,339735,579,483408,56870,19,4534,117000.0,39000.0,-73.0,-64.0,-75.0,-66.0,-73.0,-64.0,-74.0,-66.0,-90.0,-92.0,-89.0,-92.0,17.0,28.0,14.0,26.0,0
16,F8:59:71:5A:E0:3D,2653116,373993419,26988,41542693,2626128,332450726,0,3001,370848,2955,361927,46,8921,2968,0,26995,865,0,19,144444.0,39000.0,-65.0,-72.0,-65.0,-69.0,-66.0,-74.0,-66.0,-70.0,-90.0,-92.0,-89.0,-92.0,25.0,20.0,24.0,23.0,0
17,CC:2F:71:3E:C5:1F,2631249,333076950,5119,626022,2626130,332450928,6,21973,1842320,18113,1384922,3860,457398,5401,29,7298,130,6,448,130000.0,39000.0,-70.0,-71.0,-68.0,-59.0,-69.0,-71.0,-67.0,-59.0,-90.0,-92.0,-89.0,-92.0,20.0,21.0,21.0,33.0,0
18,CC:2F:71:3F:1F:24,3107498,950873497,481367,618422509,2626131,332450988,19,365052,413669029,361179,413202317,3873,466712,339754,579,483442,56888,19,4534,130000.0,43333.0,-74.0,-64.0,-72.0,-67.0,-73.0,-64.0,-73.0,-67.0,-90.0,-92.0,-89.0,-92.0,16.0,28.0,17.0,25.0,0
19,F8:59:71:5A:E0:3D,2653121,373993883,26988,41542693,2626133,332451190,0,3001,370848,2955,361927,46,8921,2968,0,26995,865,0,19,144444.0,39000.0,-65.0,-72.0,-65.0,-69.0,-66.0,-74.0,-66.0,-70.0,-90.0,-92.0,-89.0,-92.0,25.0,20.0,24.0,23.0,0
20,CC:2F:71:3E:C5:1F,2631252,333077212,5119,626022,2626133,332451190,6,21973,1842320,18113,1384922,3860,457398,5401,29,7298,130,6,448,130000.0,39000.0,-70.0,-71.0,-68.0,-59.0,-69.0,-71.0,-67.0,-59.0,-90.0,-92.0,-89.0,-92.0,20.0,21.0,21.0,33.0,0
21,CC:2F:71:3F:1F:24,3107536,950884443,481403,618433253,2626133,332451190,19,365073,413672491,361200,413205779,3873,466712,339774,579,483478,56926,19,4534,104000.0,26000.0,-73.0,-64.0,-75.0,-68.0,-72.0,-64.0,-74.0,-67.0,-90.0,-92.0,-89.0,-92.0,17.0,28.0,14.0,24.0,0
22,F8:59:71:5A:E0:3D,2653126,373994787,26989,41543193,2626137,332451594,0,3003,371068,2957,362147,46,8921,2969,0,26996,865,0,19,144444.0,39000.0,-65.0,-74.0,-64.0,-69.0,-65.0,-73.0,-64.0,-69.0,-90.0,-92.0,-89.0,-92.0,25.0,18.0,25.0,23.0,0
23,CC:2F:71:3E:C5:1F,2631256,333077616,5119,626022,2626137,332451594,6,21973,1842320,18113,1384922,3860,457398,5401,29,7298,130,6,448,130000.0,39000.0,-70.0,-71.0,-68.0,-59.0,-69.0,-71.0,-67.0,-59.0,-90.0,-92.0,-89.0,-92.0,20.0,21.0,21.0,33.0,0
24,CC:2F:71:3F:1F:24,3107574,950895441,481435,618443645,2626139,332451796,19,365092,413675721,361219,413209009,3873,466712,339792,579,483510,56926,19,4534,115556.0,28889.0,-73.0,-64.0,-75.0,-67.0,-73.0,-64.0,-75.0,-67.0,-90.0,-92.0,-89.0,-92.0,17.0,28.0,14.0,25.0,0
25,F8:59:71:5A:E0:3D,2653133,373995449,26989,41543193,2626144,332452256,0,3006,371448,2958,362217,48,9231,2971,0,26996,865,0,19,144444.0,39000.0,-65.0,-73.0,-64.0,-69.0,-65.0,-73.0,-64.0,-69.0,-90.0,-92.0,-89.0,-92.0,25.0,19.0,25.0,23.0,0
26,CC:2F:71:3E:C5:1F,2631263,333078278,5119,626022,2626144,332452256,6,21973,1842320,18113,1384922,3860,457398,5401,29,7298,130,6,448,130000.0,39000.0,-70.0,-71.0,-68.0,-59.0,-69.0,-71.0,-67.0,-59.0,-90.0,-92.0,-89.0,-92.0,20.0,21.0,21.0,33.0,0
27,CC:2F:71:3F:1F:24,3107963,951384561,481819,618932305,2626144,332452256,19,365163,413693167,361290,413226455,3873,466712,339862,579,483894,56951,19,4534,117000.0,39000.0,-74.0,-64.0,-74.0,-67.0,-73.0,-64.0,-74.0,-67.0,-90.0,-92.0,-89.0,-92.0,16.0,28.0,15.0,25.0,0
28,F8:59:71:5A:E0:3D,2653136,373995924,26989,41543193,2626147,332452731,0,3006,371448,2958,362217,48,9231,2971,0,26996,865,0,19,144444.0,39000.0,-65.0,-73.0,-64.0,-69.0,-65.0,-73.0,-64.0,-69.0,-90.0,-92.0,-89.0,-92.0,25.0,19.0,25.0,23.0,0
29,CC:2F:71:3E:C5:1F,2631268,333078955,5119,626022,2626149,332452933,6,21973,1842320,18113,1384922,3860,457398,5401,29,7298,130,6,448,130000.0,39000.0,-70.0,-71.0,-68.0,-59.0,-69.0,-71.0,-67.0,-59.0,-90.0,-92.0,-89.0,-92.0,20.0,21.0,21.0,33.0,0
30,CC:2F:71:3F:1F:24,3107999,951395388,481850,618942455,2626149,332452933,19,365181,413696281,361308,413229569,3873,466712,339879,579,483925,56965,19,4534,115556.0,28889.0,-74.0,-65.0,-75.0,-67.0,-74.0,-64.0,-74.0,-67.0,-90.0,-92.0,-89.0,-92.0,16.0,27.0,14.0,25.0,0
31,F8:59:71:5A:E0:3D,2653146,373997542,26992,41544135,2626154,332453407,0,3011,372054,2962,362697,49,9357,2975,0,26999,865,0,19,144444.0,39000.0,-65.0,-73.0,-64.0,-69.0,-65.0,-73.0,-65.0,-69.0,-90.0,-92.0,-89.0,-92.0,25.0,19.0,25.0,23.0,0
32,CC:2F:71:3E:C5:1F,2631273,333079429,5119,626022,2626154,332453407,6,21973,1842320,18113,1384922,3860,457398,5401,29,7298,130,6,448,130000.0,39000.0,-70.0,-71.0,-68.0,-59.0,-69.0,-71.0,-67.0,-59.0,-90.0,-92.0,-89.0,-92.0,20.0,21.0,21.0,33.0,0
33,CC:2F:71:3F:1F:24,3108035,951406180,481881,618952773,2626154,332453407,19,365198,413699279,361325,413232567,3873,466712,339895,579,483956,56965,19,4534,115556.0,28889.0,-74.0,-65.0,-74.0,-67.0,-73.0,-64.0,-74.0,-67.0,-90.0,-92.0,-89.0,-92.0,16.0,27.0,15.0,25.0,0
34,F8:59:71:5A:E0:3D,2653149,373997804,26992,41544135,2626157,332453669,0,3011,372054,2962,362697,49,9357,2975,0,26999,865,0,19,144444.0,39000.0,-65.0,-73.0,-64.0,-69.0,-65.0,-73.0,-65.0,-69.0,-90.0,-92.0,-89.0,-92.0,25.0,19.0,25.0,23.0,0
35,CC:2F:71:3E:C5:1F,2631276,333079691,5119,626022,2626157,332453669,6,21973,1842320,18113,1384922,3860,457398,5401,29,7298,130,6,448,130000.0,39000.0,-70.0,-71.0,-68.0,-59.0,-69.0,-71.0,-67.0,-59.0,-90.0,-92.0,-89.0,-92.0,20.0,21.0,21.0,33.0,0
36,CC:2F:71:3F:1F:24,3108071,951416850,481912,618962979,2626159,332453871,19,365215,413702277,361342,413235565,3873,466712,339911,579,483987,56980,19,4534,104000.0,26000.0,-73.0,-65.0,-74.0,-67.0,-73.0,-65.0,-74.0,-66.0,-90.0,-92.0,-89.0,-92.0,17.0,27.0,15.0,25.0,0
37,F8:59:71:5A:E0:3D,2653153,373998208,26992,41544135,2626161,332454073,0,3011,372054,2962,362697,49,9357,2975,0,26999,865,0,19,144444.0,39000.0,-65.0,-73.0,-64.0,-69.0,-65.0,-73.0,-65.0,-69.0,-90.0,-92.0,-89.0,-92.0,25.0,19.0,25.0,23.0,0
38,CC:2F:71:3E:C5:1F,2631280,333080095,5119,626022,2626161,332454073,6,21973,1842320,18113,1384922,3860,457398,5401,29,7298,130,6,448,130000.0,39000.0,-70.0,-71.0,-68.0,-59.0,-69.0,-71.0,-67.0,-59.0,-90.0,-92.0,-89.0,-92.0,20.0,21.0,21.0,33.0,0
39,CC:2F:71:3F:1F:24,3108115,951430460,481954,618976387,2626161,332454073,19,365249,413711212,361376,413244500,3873,466712,339944,579,484029,57020,19,4534,117000.0,39000.0,-74.0,-65.0,-73.0,-68.0,-73.0,-65.0,-73.0,-68.0,-90.0,-92.0,-89.0,-92.0,16.0,27.0,16.0,24.0,0
40,F8:59:71:5A:E0:3D,2653157,373998612,26992,41544135,2626165,332454477,0,3011,372054,2962,362697,49,9357,2975,0,26999,865,0,19,144444.0,39000.0,-65.0,-73.0,-64.0,-69.0,-65.0,-73.0,-65.0,-69.0,-90.0,-92.0,-89.0,-92.0,25.0,19.0,25.0,23.0,0
41,CC:2F:71:3E:C5:1F,2631284,333080499,5119,626022,2626165,332454477,6,21973,1842320,18113,1384922,3860,457398,5401,29,7298,130,6,448,130000.0,39000.0,-70.0,-71.0,-68.0,-59.0,-69.0,-71.0,-67.0,-59.0,-90.0,-92.0,-89.0,-92.0,20.0,21.0,21.0,33.0,0
42,CC:2F:71:3F:1F:24,3108497,951940164,482332,619485687,2626165,332454477,19,365306,413719139,361433,413252427,3873,466712,339999,579,484407,57173,19,4534,78000.0,13000.0,-70.0,-64.0,-72.0,-68.0,-72.0,-64.0,-71.0,-67.0,-90.0,-92.0,-89.0,-92.0,20.0,28.0,17.0,24.0,0
43,F8:59:71:5A:E0:3D,2653163,373999192,26993,41544251,2626170,332454941,0,3014,372300,2965,362943,49,9357,2976,0,27000,865,0,19,144444.0,43333.0,-65.0,-72.0,-65.0,-69.0,-65.0,-73.0,-65.0,-69.0,-90.0,-92.0,-89.0,-92.0,25.0,20.0,24.0,23.0,0
44,CC:2F:71:3E:C5:1F,2631289,333080963,5119,626022,2626170,332454941,6,21973,1842320,18113,1384922,3860,457398,5401,29,7298,130,6,448,130000.0,39000.0,-70.0,-71.0,-68.0,-59.0,-69.0,-71.0,-67.0,-59.0,-90.0,-92.0,-89.0,-92.0,20.0,21.0,21.0,33.0,0
45,CC:2F:71:3F:1F:24,3108541,951951981,482371,619497040,2626170,332454941,19,365333,413723414,361460,413256702,3873,466712,340024,579,484446,57173,19,4534,86667.0,13000.0,-71.0,-65.0,-76.0,-68.0,-71.0,-65.0,-75.0,-68.0,-90.0,-92.0,-89.0,-92.0,19.0,27.0,13.0,24.0,0
46,F8:59:71:5A:E0:3D,2653165,373999394,26993,41544251,2626172,332455143,0,3014,372300,2965,362943,49,9357,2976,0,27000,865,0,19,144444.0,43333.0,-65.0,-72.0,-65.0,-69.0,-65.0,-73.0,-65.0,-69.0,-90.0,-92.0,-89.0,-92.0,25.0,20.0,24.0,23.0,0
47,CC:2F:71:3E:C5:1F,2631293,333081367,5119,626022,2626174,332455345,6,21973,1842320,18113,1384922,3860,457398,5401,29,7298,130,6,448,130000.0,39000.0,-70.0,-71.0,-68.0,-59.0,-69.0,-71.0,-67.0,-59.0,-90.0,-92.0,-89.0,-92.0,20.0,21.0,21.0,33.0,0
48,CC:2F:71:3F:1F:24,3108595,951967921,482421,619512576,2626174,332455345,19,365371,413730976,361498,413264264,3873,466712,340060,579,484496,57183,19,4534,115556.0,26000.0,-72.0,-65.0,-75.0,-68.0,-71.0,-65.0,-75.0,-68.0,-90.0,-92.0,-89.0,-92.0,18.0,27.0,14.0,24.0,0
49,F8:59:71:5A:E0:3D,2653171,374000000,26993,41544251,2626178,332455749,0,3014,372300,2965,362943,49,9357,2976,0,27000,865,0,19,144444.0,43333.0,-65.0,-72.0,-65.0,-69.0,-65.0,-73.0,-65.0,-69.0,-90.0,-92.0,-89.0,-92.0,25.0,20.0,24.0,23.0,0
50,CC:2F:71:3E:C5:1F,2631297,333081771,5119,626022,2626178,332455749,6,21973,1842320,18113,1384922,3860,457398,5401,29,7298,130,6,448,130000.0,39000.0,-70.0,-71.0,-68.0,-59.0,-69.0,-71.0,-67.0,-59.0,-90.0,-92.0,-89.0,-92.0,20.0,21.0,21.0,33.0,0
51,CC:2F:71:3F:1F:24,3108630,951978475,482452,619522726,2626178,332455749,19,365388,413733974,361515,413267262,3873,466712,340076,579,484527,57187,19,4534,117000.0,39000.0,-72.0,-65.0,-76.0,-69.0,-72.0,-65.0,-75.0,-68.0,-90.0,-92.0,-89.0,-92.0,18.0,27.0,13.0,23.0,0
52,F8:59:71:5A:E0:3D,2653174,374000262,26993,41544251,2626181,332456011,0,3014,372300,2965,362943,49,9357,2976,0,27000,865,0,19,144444.0,43333.0,-65.0,-72.0,-65.0,-69.0,-65.0,-73.0,-65.0,-69.0,-90.0,-92.0,-89.0,-92.0,25.0,20.0,24.0,23.0,0
53,CC:2F:71:3E:C5:1F,2631300,333082033,5119,626022,2626181,332456011,6,21973,1842320,18113,1384922,3860,457398,5401,29,7298,130,6,448,130000.0,39000.0,-70.0,-71.0,-68.0,-59.0,-69.0,-71.0,-67.0,-59.0,-90.0,-92.0,-89.0,-92.0,20.0,21.0,21.0,33.0,0
54,CC:2F:71:3F:1F:24,3108665,951989129,482484,619533118,2626181,332456011,19,365408,413737320,361535,413270608,3873,466712,340095,579,484559,57201,19,4534,104000.0,26000.0,-72.0,-66.0,-76.0,-68.0,-72.0,-65.0,-75.0,-68.0,-90.0,-92.0,-89.0,-92.0,18.0,26.0,13.0,24.0,0
55,F8:59:71:5A:E0:3D,2653181,374000942,26994,41544325,2626187,332456617,0,3016,372486,2967,363129,49,9357,2977,0,27001,865,0,19,144444.0,43333.0,-65.0,-73.0,-65.0,-69.0,-64.0,-72.0,-64.0,-69.0,-90.0,-92.0,-90.0,-92.0,25.0,19.0,25.0,23.0,0
56,CC:2F:71:3E:C5:1F,2631306,333082639,5119,626022,2626187,332456617,6,21973,1842320,18113,1384922,3860,457398,5401,29,7298,130,6,448,130000.0,39000.0,-70.0,-71.0,-68.0,-59.0,-69.0,-71.0,-67.0,-59.0,-90.0,-92.0,-90.0,-92.0,20.0,21.0,22.0,33.0,0
57,CC:2F:71:3F:1F:24,3109035,952451570,482848,619994953,2626187,332456617,19,365481,413751215,361608,413284503,3873,466712,340167,579,484923,57802,19,4535,86667.0,13000.0,-72.0,-66.0,-74.0,-68.0,-72.0,-65.0,-74.0,-68.0,-90.0,-92.0,-90.0,-92.0,18.0,26.0,16.0,24.0,0
58,F8:59:71:5A:E0:3D,2653183,374001144,26994,41544325,2626189,332456819,0,3016,372486,2967,363129,49,9357,2977,0,27001,865,0,19,144444.0,43333.0,-65.0,-73.0,-65.0,-69.0,-64.0,-72.0,-64.0,-69.0,-90.0,-92.0,-90.0,-92.0,25.0,19.0,25.0,23.0,0
59,CC:2F:71:3E:C5:1F,2631308,333082841,5119,626022,2626189,332456819,6,21973,1842320,18113,1384922,3860,457398,5401,29,7298,130,6,448,130000.0,39000.0,-70.0,-71.0,-68.0,-59.0,-69.0,-71.0,-67.0,-59.0,-90.0,-92.0,-90.0,-92.0,20.0,21.0,22.0,33.0,0
60,CC:2F:71:3F:1F:24,3109107,952472451,482918,620015632,2626189,332456819,19,365532,413764206,361659,413297494,3873,466712,340217,579,484993,57805,19,4535,115556.0,26000.0,-73.0,-66.0,-74.0,-68.0,-72.0,-66.0,-74.0,-67.0,-90.0,-93.0,-90.0,-93.0,17.0,27.0,16.0,25.0,0
61,F8:59:71:5A:E0:3D,2653189,374001724,26995,41544441,2626194,332457283,0,3018,372626,2969,363269,49,9357,2977,0,27002,865,0,19,144444.0,43333.0,-65.0,-74.0,-65.0,-69.0,-65.0,-73.0,-64.0,-69.0,-90.0,-93.0,-90.0,-93.0,25.0,19.0,25.0,24.0,0
62,CC:2F:71:3E:C5:1F,2631316,333083623,5120,626138,2626196,332457485,6,21975,1842460,18115,1385062,3860,457398,5401,29,7299,130,6,448,130000.0,39000.0,-69.0,-67.0,-64.0,-59.0,-69.0,-70.0,-67.0,-59.0,-90.0,-93.0,-90.0,-93.0,21.0,26.0,26.0,34.0,0
63,CC:2F:71:3F:1F:24,3109155,952484823,482959,620027338,2626196,332457485,19,365557,413768183,361684,413301471,3873,466712,340241,579,485034,57807,19,4535,130000.0,39000.0,-73.0,-64.0,-72.0,-70.0,-73.0,-64.0,-72.0,-69.0,-90.0,-93.0,-90.0,-93.0,17.0,29.0,18.0,23.0,0
64,F8:59:71:5A:E0:3D,2653193,374002128,26995,41544441,2626198,332457687,0,3018,372626,2969,363269,49,9357,2977,0,27002,865,0,19,144444.0,43333.0,-65.0,-74.0,-65.0,-69.0,-65.0,-73.0,-64.0,-69.0,-90.0,-93.0,-90.0,-93.0,25.0,19.0,25.0,24.0,0
65,CC:2F:71:3E:C5:1F,2631318,333083825,5120,626138,2626198,332457687,6,21975,1842460,18115,1385062,3860,457398,5401,29,7299,130,6,448,130000.0,39000.0,-69.0,-67.0,-64.0,-59.0,-69.0,-70.0,-67.0,-59.0,-90.0,-93.0,-90.0,-93.0,21.0,26.0,26.0,34.0,0
66,CC:2F:71:3F:1F:24,3109222,952508205,483024,620050518,2626198,332457687,19,365615,413780028,361742,413313316,3873,466712,340297,579,485099,57816,19,4535,144444.0,43333.0,-75.0,-64.0,-72.0,-69.0,-75.0,-64.0,-72.0,-69.0,-90.0,-93.0,-90.0,-93.0,15.0,29.0,18.0,24.0,0
67,F8:59:71:5A:E0:3D,2653197,374002532,26995,41544441,2626202,332458091,0,3018,372626,2969,363269,49,9357,2977,0,27002,865,0,19,144444.0,43333.0,-65.0,-74.0,-65.0,-69.0,-65.0,-73.0,-64.0,-69.0,-90.0,-93.0,-90.0,-93.0,25.0,19.0,25.0,24.0,0
68,CC:2F:71:3E:C5:1F,2631322,333084229,5120,626138,2626202,332458091,6,21975,1842460,18115,1385062,3860,457398,5401,29,7299,130,6,448,130000.0,39000.0,-69.0,-67.0,-64.0,-59.0,-69.0,-70.0,-67.0,-59.0,-90.0,-93.0,-90.0,-93.0,21.0,26.0,26.0,34.0,0
69,CC:2F:71:3F:1F:24,3109384,952596750,483181,620138599,2626203,332458151,19,365757,413809804,361884,413343092,3873,466712,340437,579,485256,57842,19,4535,130000.0,43333.0,-72.0,-65.0,-73.0,-69.0,-71.0,-65.0,-72.0,-68.0,-90.0,-93.0,-90.0,-93.0,18.0,28.0,17.0,24.0,0
70,F8:59:71:5A:E0:3D,2653202,374003129,26995,41544441,2626207,332458688,0,3018,372626,2969,363269,49,9357,2977,0,27002,865,0,19,144444.0,43333.0,-65.0,-74.0,-65.0,-69.0,-65.0,-73.0,-64.0,-69.0,-90.0,-93.0,-90.0,-93.0,25.0,19.0,25.0,24.0,0
71,CC:2F:71:3E:C5:1F,2631327,333084826,5120,626138,2626207,332458688,6,21977,1842648,18116,1385132,3861,457516,5402,29,7299,130,6,448,130000.0,39000.0,-70.0,-71.0,-68.0,-59.0,-69.0,-70.0,-67.0,-59.0,-90.0,-93.0,-90.0,-93.0,20.0,22.0,22.0,34.0,0
72,CC:2F:71:3F:1F:24,3109438,952612989,483231,620154301,2626207,332458688,19,365788,413816894,361915,413350182,3873,466712,340467,579,485306,57842,19,4535,130000.0,43333.0,-72.0,-65.0,-73.0,-69.0,-71.0,-65.0,-72.0,-69.0,-90.0,-93.0,-90.0,-93.0,18.0,28.0,17.0,24.0,0
73,F8:59:71:5A:E0:3D,2653206,374003533,26995,41544441,2626211,332459092,0,3018,372626,2969,363269,49,9357,2977,0,27002,865,0,19,144444.0,43333.0,-65.0,-74.0,-65.0,-69.0,-65.0,-73.0,-64.0,-69.0,-90.0,-93.0,-90.0,-93.0,25.0,19.0,25.0,24.0,0
74,CC:2F:71:3E:C5:1F,2631331,333085230,5120,626138,2626211,332459092,6,21977,1842648,18116,1385132,3861,457516,5402,29,7299,130,6,448,130000.0,39000.0,-70.0,-71.0,-68.0,-59.0,-69.0,-70.0,-67.0,-59.0,-90.0,-93.0,-90.0,-93.0,20.0,22.0,22.0,34.0,0
75,CC:2F:71:3F:1F:24,3110163,953527592,483950,621068298,2626213,332459294,19,365895,413842286,362022,413375574,3873,466712,340573,579,486025,58005,19,4535,130000.0,43333.0,-73.0,-65.0,-72.0,-68.0,-73.0,-65.0,-71.0,-68.0,-90.0,-93.0,-90.0,-93.0,17.0,28.0,18.0,25.0,0
76,F8:59:71:5A:E0:3D,2653210,374003937,26995,41544441,2626215,332459496,0,3018,372626,2969,363269,49,9357,2977,0,27002,865,0,19,144444.0,43333.0,-65.0,-74.0,-65.0,-69.0,-65.0,-73.0,-64.0,-69.0,-90.0,-93.0,-90.0,-93.0,25.0,19.0,25.0,24.0,0
77,CC:2F:71:3E:C5:1F,2631336,333085694,5120,626138,2626216,332459556,6,21977,1842648,18116,1385132,3861,457516,5402,29,7299,130,6,448,130000.0,39000.0,-70.0,-71.0,-68.0,-59.0,-69.0,-70.0,-67.0,-59.0,-90.0,-93.0,-90.0,-93.0,20.0,22.0,22.0,34.0,0
78,CC:2F:71:3F:1F:24,3110206,953540383,483990,621080827,2626216,332459556,19,365920,413846369,362047,413379657,3873,466712,340597,579,486065,58022,19,4535,117000.0,39000.0,-75.0,-65.0,-72.0,-68.0,-74.0,-64.0,-71.0,-67.0,-90.0,-93.0,-90.0,-93.0,15.0,28.0,18.0,25.0,0
79,F8:59:71:5A:E0:3D,2653215,374004401,26995,41544441,2626220,332459960,0,3018,372626,2969,363269,49,9357,2977,0,27002,865,0,19,144444.0,43333.0,-65.0,-74.0,-65.0,-69.0,-65.0,-73.0,-64.0,-69.0,-90.0,-93.0,-90.0,-93.0,25.0,19.0,25.0,24.0,0
80,CC:2F:71:3E:C5:1F,2631340,333086098,5120,626138,2626220,332459960,6,21977,1842648,18116,1385132,3861,457516,5402,29,7299,130,6,448,130000.0,39000.0,-70.0,-71.0,-68.0,-59.0,-69.0,-70.0,-67.0,-59.0,-90.0,-93.0,-90.0,-93.0,20.0,22.0,22.0,34.0,0
81,CC:2F:71:3F:1F:24,3110241,953550993,484021,621091033,2626220,332459960,19,365938,413849483,362065,413382771,3873,466712,340614,579,486096,58022,19,4535,130000.0,43333.0,-75.0,-64.0,-73.0,-67.0,-74.0,-64.0,-72.0,-67.0,-90.0,-93.0,-90.0,-93.0,15.0,29.0,17.0,26.0,0
82,F8:59:71:5A:E0:3D,2653219,374004805,26995,41544441,2626224,332460364,0,3018,372626,2969,363269,49,9357,2977,0,27002,865,0,19,144444.0,43333.0,-65.0,-74.0,-65.0,-69.0,-65.0,-73.0,-64.0,-69.0,-90.0,-93.0,-90.0,-93.0,25.0,19.0,25.0,24.0,0
83,CC:2F:71:3E:C5:1F,2631344,333086502,5120,626138,2626224,332460364,6,21977,1842648,18116,1385132,3861,457516,5402,29,7299,130,6,448,130000.0,39000.0,-70.0,-71.0,-68.0,-59.0,-69.0,-70.0,-67.0,-59.0,-90.0,-93.0,-90.0,-93.0,20.0,22.0,22.0,34.0,0
84,CC:2F:71:3F:1F:24,3110288,953564112,484064,621103748,2626224,332460364,19,365965,413853858,362092,413387146,3873,466712,340639,579,486139,58022,19,4535,130000.0,43333.0,-73.0,-64.0,-73.0,-67.0,-72.0,-64.0,-73.0,-67.0,-90.0,-93.0,-90.0,-93.0,17.0,29.0,17.0,26.0,0
85,F8:59:71:5A:E0:3D,2653223,374005193,26995,41544441,2626228,332460752,0,3018,372626,2969,363269,49,9357,2977,0,27002,865,0,19,144444.0,43333.0,-65.0,-74.0,-65.0,-69.0,-65.0,-73.0,-64.0,-69.0,-90.0,-93.0,-90.0,-93.0,25.0,19.0,25.0,24.0,0
86,CC:2F:71:3E:C5:1F,2631350,333087092,5120,626138,2626230,332460954,6,21977,1842648,18116,1385132,3861,457516,5402,29,7299,130,6,448,130000.0,39000.0,-70.0,-71.0,-68.0,-59.0,-69.0,-70.0,-67.0,-59.0,-90.0,-93.0,-90.0,-93.0,20.0,22.0,22.0,34.0,0
87,CC:2F:71:3F:1F:24,3110326,953575094,484096,621114140,2626230,332460954,19,365986,413857320,362113,413390608,3873,466712,340659,579,486171,58023,19,4535,130000.0,39000.0,-71.0,-65.0,-74.0,-68.0,-71.0,-65.0,-73.0,-67.0,-90.0,-93.0,-90.0,-93.0,19.0,28.0,16.0,25.0,0
88,F8:59:71:5A:E0:3D,2653229,374005799,26995,41544441,2626234,332461358,0,3018,372626,2969,363269,49,9357,2977,0,27002,865,0,19,144444.0,43333.0,-65.0,-74.0,-65.0,-69.0,-65.0,-73.0,-64.0,-69.0,-90.0,-93.0,-90.0,-93.0,25.0,19.0,25.0,24.0,0
89,CC:2F:71:3E:C5:1F,2631354,333087496,5120,626138,2626234,332461358,6,21977,1842648,18116,1385132,3861,457516,5402,29,7299,130,6,448,130000.0,39000.0,-70.0,-71.0,-68.0,-59.0,-69.0,-70.0,-67.0,-59.0,-90.0,-93.0,-90.0,-93.0,20.0,22.0,22.0,34.0,0
90,CC:2F:71:3F:1F:24,3110409,953618380,484175,621157022,2626234,332461358,19,366036,413868866,362163,413402154,3873,466712,340707,579,486250,58028,19,4535,144444.0,43333.0,-71.0,-65.0,-73.0,-68.0,-71.0,-65.0,-73.0,-67.0,-90.0,-93.0,-90.0,-93.0,19.0,28.0,17.0,25.0,0
91,F8:59:71:5A:E0:3D,2653231,374006001,26995,41544441,2626236,332461560,0,3020,372766,2971,363409,49,9357,2977,0,27003,865,0,19,144444.0,43333.0,-65.0,-73.0,-64.0,-69.0,-65.0,-73.0,-64.0,-69.0,-90.0,-93.0,-90.0,-93.0,25.0,20.0,26.0,24.0,0
92,CC:2F:71:3E:C5:1F,2631356,333087698,5120,626138,2626236,332461560,6,21979,1842788,18118,1385272,3861,457516,5402,29,7300,130,6,448,130000.0,39000.0,-70.0,-72.0,-68.0,-59.0,-69.0,-70.0,-67.0,-59.0,-90.0,-93.0,-90.0,-93.0,20.0,21.0,22.0,34.0,0
93,CC:2F:71:3F:1F:24,3110749,953940016,484510,621478192,2626239,332461824,19,366206,413908644,362333,413441932,3873,466712,340875,579,486565,58090,19,4536,130000.0,39000.0,-71.0,-65.0,-73.0,-68.0,-71.0,-65.0,-72.0,-67.0,-90.0,-93.0,-90.0,-93.0,19.0,28.0,17.0,25.0,0
94,F8:59:71:5A:E0:3D,2653241,374007097,26995,41544441,2626246,332462656,0,3022,372954,2972,363479,50,9475,2978,0,27003,865,0,19,144444.0,43333.0,-60.0,-63.0,-60.0,-62.0,-64.0,-72.0,-63.0,-68.0,-90.0,-93.0,-90.0,-93.0,30.0,30.0,30.0,31.0,0
95,CC:2F:71:3E:C5:1F,2631366,333088794,5120,626138,2626246,332462656,6,21979,1842788,18118,1385272,3861,457516,5402,29,7300,130,6,448,130000.0,39000.0,-70.0,-72.0,-68.0,-59.0,-69.0,-70.0,-67.0,-59.0,-90.0,-93.0,-90.0,-93.0,20.0,21.0,22.0,34.0,0
96,CC:2F:71:3F:1F:24,3111569,954838736,485323,622376080,2626246,332462656,19,366560,413983769,362687,413517057,3873,466712,341229,579,487398,58218,19,4538,130000.0,43333.0,-71.0,-65.0,-73.0,-68.0,-71.0,-65.0,-73.0,-67.0,-90.0,-93.0,-90.0,-93.0,19.0,28.0,17.0,25.0,0
97,F8:59:71:5A:E0:3D,2653243,374007299,26995,41544441,2626248,332462858,0,3022,372954,2972,363479,50,9475,2978,0,27003,865,0,19,144444.0,43333.0,-60.0,-63.0,-60.0,-62.0,-64.0,-72.0,-63.0,-68.0,-90.0,-93.0,-90.0,-93.0,30.0,30.0,30.0,31.0,0
98,CC:2F:71:3E:C5:1F,2631368,333088996,5120,626138,2626248,332462858,6,21979,1842788,18118,1385272,3861,457516,5402,29,7300,130,6,448,130000.0,39000.0,-70.0,-72.0,-68.0,-59.0,-69.0,-70.0,-67.0,-59.0,-90.0,-93.0,-90.0,-93.0,20.0,21.0,22.0,34.0,0
99,CC:2F:71:3F:1F:24,3111860,955007033,485612,622544175,2626248,332462858,19,366823,414044556,362950,413577844,3873,466712,341491,579,487687,58248,19,4538,130000.0,39000.0,-72.0,-65.0,-73.0,-68.0,-71.0,-65.0,-73.0,-67.0,-90.0,-93.0,-90.0,-93.0,18.0,28.0,17.0,25.0,0
100,F8:59:71:5A:E0:3D,2653250,374007967,26995,41544441,2626255,332463526,0,3022,372954,2972,363479,50,9475,2978,0,27003,865,0,19,144444.0,43333.0,-60.0,-63.0,-60.0,-62.0,-64.0,-72.0,-63.0,-68.0,-90.0,-93.0,-90.0,-93.0,30.0,30.0,30.0,31.0,0
101,CC:2F:71:3E:C5:1F,2631375,333089664,5120,626138,2626255,332463526,6,21979,1842788,18118,1385272,3861,457516,5402,29,7300,130,6,448,130000.0,39000.0,-70.0,-72.0,-68.0,-59.0,-69.0,-70.0,-67.0,-59.0,-90.0,-93.0,-90.0,-93.0,20.0,21.0,22.0,34.0,0
102,CC:2F:71:3F:1F:24,3113239,956275241,486984,623811715,2626255,332463526,19,367559,414214677,363685,413747847,3874,466830,342226,579,489047,58399,19,4540,117000.0,39000.0,-72.0,-66.0,-74.0,-69.0,-73.0,-66.0,-74.0,-69.0,-90.0,-93.0,-90.0,-93.0,18.0,27.0,16.0,24.0,0
103,F8:59:71:5A:E0:3D,2653251,374008027,26995,41544441,2626256,332463586,0,3022,372954,2972,363479,50,9475,2978,0,27003,865,0,19,144444.0,43333.0,-60.0,-63.0,-60.0,-62.0,-64.0,-72.0,-63.0,-68.0,-90.0,-93.0,-90.0,-93.0,30.0,30.0,30.0,31.0,0
104,CC:2F:71:3E:C5:1F,2631378,333089926,5120,626138,2626258,332463788,6,21979,1842788,18118,1385272,3861,457516,5402,29,7300,130,6,448,130000.0,39000.0,-70.0,-72.0,-68.0,-59.0,-69.0,-70.0,-67.0,-59.0,-90.0,-93.0,-90.0,-93.0,20.0,21.0,22.0,34.0,0
105,CC:2F:71:3F:1F:24,3114633,957518502,488375,625054714,2626258,332463788,19,368297,414384315,364423,413917485,3874,466830,342953,579,490450,58682,19,4541,115556.0,28889.0,-71.0,-66.0,-75.0,-68.0,-70.0,-65.0,-75.0,-67.0,-90.0,-93.0,-90.0,-93.0,19.0,27.0,15.0,25.0,0
106,F8:59:71:5A:E0:3D,2653259,374008835,26995,41544441,2626264,332464394,0,3022,372954,2972,363479,50,9475,2978,0,27003,865,0,19,144444.0,43333.0,-60.0,-63.0,-60.0,-62.0,-64.0,-72.0,-63.0,-68.0,-90.0,-93.0,-90.0,-93.0,30.0,30.0,30.0,31.0,0
107,CC:2F:71:3E:C5:1F,2631384,333090532,5120,626138,2626264,332464394,6,21979,1842788,18118,1385272,3861,457516,5402,29,7300,130,6,448,130000.0,39000.0,-70.0,-72.0,-68.0,-59.0,-69.0,-70.0,-67.0,-59.0,-90.0,-93.0,-90.0,-93.0,20.0,21.0,22.0,34.0,0
108,CC:2F:71:3F:1F:24,3114829,957608470,488565,625144076,2626264,332464394,19,368450,414424120,364576,413957290,3874,466830,343103,579,490640,58695,19,4542,115556.0,28889.0,-71.0,-65.0,-74.0,-67.0,-71.0,-65.0,-75.0,-67.0,-90.0,-93.0,-90.0,-93.0,19.0,28.0,16.0,26.0,0
109,F8:59:71:5A:E0:3D,2653259,374008835,26995,41544441,2626264,332464394,0,3022,372954,2972,363479,50,9475,2978,0,27003,865,0,19,144444.0,43333.0,-60.0,-63.0,-60.0,-62.0,-64.0,-72.0,-63.0,-68.0,-90.0,-93.0,-90.0,-93.0,30.0,30.0,30.0,31.0,0
110,CC:2F:71:3E:C5:1F,2631384,333090532,5120,626138,2626264,332464394,6,21979,1842788,18118,1385272,3861,457516,5402,29,7300,130,6,448,130000.0,39000.0,-70.0,-72.0,-68.0,-59.0,-69.0,-70.0,-67.0,-59.0,-90.0,-93.0,-90.0,-93.0,20.0,21.0,22.0,34.0,0
111,CC:2F:71:3F:1F:24,3114883,957626988,488617,625162392,2626266,332464596,19,368484,414430399,364610,413963569,3874,466830,343136,579,490692,58721,19,4542,104000.0,26000.0,-72.0,-66.0,-74.0,-68.0,-71.0,-65.0,-74.0,-68.0,-90.0,-93.0,-90.0,-93.0,18.0,27.0,16.0,25.0,0
112,F8:59:71:5A:E0:3D,2653269,374009976,26995,41544441,2626274,332465535,0,3022,372954,2972,363479,50,9475,2978,0,27003,865,0,19,144444.0,43333.0,-60.0,-63.0,-60.0,-62.0,-64.0,-72.0,-63.0,-68.0,-90.0,-93.0,-90.0,-93.0,30.0,30.0,30.0,31.0,0
113,CC:2F:71:3E:C5:1F,2631394,333091673,5120,626138,2626274,332465535,6,21979,1842788,18118,1385272,3861,457516,5402,29,7300,130,6,448,130000.0,39000.0,-70.0,-72.0,-68.0,-59.0,-69.0,-70.0,-67.0,-59.0,-90.0,-93.0,-90.0,-93.0,20.0,21.0,22.0,34.0,0
114,CC:2F:71:3F:1F:24,3114923,957638319,488649,625172784,2626274,332465535,19,368504,414433699,364630,413966869,3874,466830,343154,579,490724,58723,19,4542,115556.0,28889.0,-72.0,-66.0,-75.0,-68.0,-72.0,-66.0,-75.0,-68.0,-90.0,-93.0,-90.0,-93.0,18.0,27.0,15.0,25.0,0
115,F8:59:71:5A:E0:3D,2653269,374009976,26995,41544441,2626274,332465535,0,3022,372954,2972,363479,50,9475,2978,0,27003,865,0,19,144444.0,43333.0,-60.0,-63.0,-60.0,-62.0,-64.0,-72.0,-63.0,-68.0,-90.0,-93.0,-90.0,-93.0,30.0,30.0,30.0,31.0,0
116,CC:2F:71:3E:C5:1F,2631394,333091673,5120,626138,2626274,332465535,6,21979,1842788,18118,1385272,3861,457516,5402,29,7300,130,6,448,130000.0,39000.0,-70.0,-72.0,-68.0,-59.0,-69.0,-70.0,-67.0,-59.0,-90.0,-93.0,-90.0,-93.0,20.0,21.0,22.0,34.0,0
117,CC:2F:71:3F:1F:24,3114955,957648711,488681,625183176,2626274,332465535,19,368523,414436929,364649,413970099,3874,466830,343172,579,490756,58725,19,4542,115556.0,28889.0,-72.0,-66.0,-75.0,-68.0,-71.0,-66.0,-75.0,-68.0,-90.0,-93.0,-90.0,-93.0,18.0,27.0,15.0,25.0,0
118,F8:59:71:5A:E0:3D,2653274,374010510,26996,41544571,2626278,332465939,0,3024,373140,2974,363665,50,9475,2979,0,27004,865,0,19,130000.0,39000.0,-66.0,-73.0,-64.0,-69.0,-64.0,-72.0,-63.0,-68.0,-90.0,-93.0,-90.0,-93.0,24.0,20.0,26.0,24.0,0
119,CC:2F:71:3E:C5:1F,2631403,333092541,5120,626138,2626283,332466403,6,21979,1842788,18118,1385272,3861,457516,5402,29,7300,130,6,448,130000.0,39000.0,-70.0,-72.0,-68.0,-59.0,-69.0,-70.0,-67.0,-59.0,-90.0,-93.0,-90.0,-93.0,20.0,21.0,22.0,34.0,0
120,CC:2F:71:3F:1F:24,3115451,958291151,489168,625824748,2626283,332466403,19,368605,414452992,364731,413986162,3874,466830,343251,579,491243,59076,19,4542,104000.0,26000.0,-72.0,-66.0,-75.0,-68.0,-71.0,-66.0,-75.0,-68.0,-90.0,-93.0,-90.0,-93.0,18.0,27.0,15.0,25.0,0
121,F8:59:71:5A:E0:3D,2653281,374012098,26996,41544571,2626285,332467527,0,3024,373140,2974,363665,50,9475,2979,0,27004,865,0,19,130000.0,39000.0,-66.0,-73.0,-64.0,-69.0,-64.0,-72.0,-63.0,-68.0,-90.0,-93.0,-90.0,-93.0,24.0,20.0,26.0,24.0,0
122,CC:2F:71:3E:C5:1F,2631405,333093665,5120,626138,2626285,332467527,6,21979,1842788,18118,1385272,3861,457516,5402,29,7300,130,6,448,130000.0,39000.0,-70.0,-72.0,-68.0,-59.0,-69.0,-70.0,-67.0,-59.0,-90.0,-93.0,-90.0,-93.0,20.0,21.0,22.0,34.0,0
123,CC:2F:71:3F:1F:24,3115503,958304945,489218,625837418,2626285,332467527,19,368658,414459748,364784,413992918,3874,466830,343296,580,491294,59077,19,4542,115556.0,28889.0,-72.0,-66.0,-75.0,-68.0,-70.0,-65.0,-74.0,-67.0,-90.0,-93.0,-90.0,-93.0,18.0,27.0,15.0,25.0,0
124,F8:59:71:5A:E0:3D,2653285,374012502,26996,41544571,2626289,332467931,0,3024,373140,2974,363665,50,9475,2979,0,27004,865,0,19,130000.0,39000.0,-66.0,-73.0,-64.0,-69.0,-64.0,-72.0,-63.0,-68.0,-90.0,-93.0,-90.0,-93.0,24.0,20.0,26.0,24.0,0
125,CC:2F:71:3E:C5:1F,2631413,333094473,5120,626138,2626293,332468335,6,21979,1842788,18118,1385272,3861,457516,5402,29,7300,130,6,448,130000.0,39000.0,-70.0,-72.0,-68.0,-59.0,-69.0,-70.0,-67.0,-59.0,-90.0,-93.0,-90.0,-93.0,20.0,21.0,22.0,34.0,0
126,CC:2F:71:3F:1F:24,3115543,958316201,489250,625847866,2626293,332468335,19,368686,414463777,364812,413996947,3874,466830,343317,580,491326,59077,19,4542,115556.0,28889.0,-71.0,-66.0,-75.0,-68.0,-70.0,-65.0,-74.0,-67.0,-90.0,-93.0,-90.0,-93.0,19.0,27.0,15.0,25.0,0
127,F8:59:71:5A:E0:3D,2653292,374014090,26996,41544571,2626296,332469519,0,3024,373140,2974,363665,50,9475,2979,0,27004,865,0,19,130000.0,39000.0,-66.0,-73.0,-64.0,-69.0,-64.0,-72.0,-63.0,-68.0,-90.0,-93.0,-90.0,-93.0,24.0,20.0,26.0,24.0,0
128,CC:2F:71:3E:C5:1F,2631416,333095657,5120,626138,2626296,332469519,6,21979,1842788,18118,1385272,3861,457516,5402,29,7300,130,6,448,130000.0,39000.0,-70.0,-72.0,-68.0,-59.0,-69.0,-70.0,-67.0,-59.0,-90.0,-93.0,-90.0,-93.0,20.0,21.0,22.0,34.0,0
129,CC:2F:71:3F:1F:24,3115625,958339116,489329,625869597,2626296,332469519,19,368749,414477598,364875,414010768,3874,466830,343373,580,491405,59112,19,4542,115556.0,28889.0,-71.0,-65.0,-74.0,-67.0,-70.0,-65.0,-74.0,-67.0,-90.0,-93.0,-90.0,-93.0,19.0,28.0,16.0,26.0,0
130,F8:59:71:5A:E0:3D,2653300,374014898,26996,41544571,2626304,332470327,0,3024,373140,2974,363665,50,9475,2979,0,27004,865,0,19,130000.0,39000.0,-66.0,-73.0,-64.0,-69.0,-64.0,-72.0,-63.0,-68.0,-90.0,-93.0,-90.0,-93.0,24.0,20.0,26.0,24.0,0
131,CC:2F:71:3E:C5:1F,2631424,333096465,5120,626138,2626304,332470327,6,21979,1842788,18118,1385272,3861,457516,5402,29,7300,130,6,448,130000.0,39000.0,-70.0,-72.0,-68.0,-59.0,-69.0,-70.0,-67.0,-59.0,-90.0,-93.0,-90.0,-93.0,20.0,21.0,22.0,34.0,0
132,CC:2F:71:3F:1F:24,3116968,960051705,490662,627580254,2626306,332471451,21,369277,414573178,365403,414106348,3874,466830,343886,581,492735,60823,21,4542,78000.0,13000.0,-71.0,-66.0,-75.0,-67.0,-70.0,-65.0,-74.0,-66.0,-90.0,-93.0,-90.0,-93.0,19.0,27.0,15.0,26.0,0
133,F8:59:71:5A:E0:3D,2653308,374016594,26999,41544881,2626309,332471713,0,3028,373536,2978,364061,50,9475,2981,0,27007,865,0,19,130000.0,39000.0,-66.0,-74.0,-64.0,-70.0,-66.0,-74.0,-66.0,-69.0,-90.0,-93.0,-90.0,-93.0,24.0,19.0,26.0,23.0,0
134,CC:2F:71:3E:C5:1F,2631429,333097851,5120,626138,2626309,332471713,6,21979,1842788,18118,1385272,3861,457516,5402,29,7300,130,6,448,130000.0,39000.0,-70.0,-72.0,-68.0,-59.0,-69.0,-70.0,-67.0,-59.0,-90.0,-93.0,-90.0,-93.0,20.0,21.0,22.0,34.0,0
135,CC:2F:71:3F:1F:24,3118572,961810919,492263,629339206,2626309,332471713,21,369995,414839851,366121,414373021,3874,466830,344591,581,494340,61059,21,4543,86667.0,14444.0,-71.0,-66.0,-75.0,-67.0,-70.0,-65.0,-74.0,-67.0,-90.0,-93.0,-90.0,-93.0,19.0,27.0,15.0,26.0,0
136,F8:59:71:5A:E0:3D,2653314,374017200,26999,41544881,2626315,332472319,0,3028,373536,2978,364061,50,9475,2981,0,27007,865,0,19,130000.0,39000.0,-66.0,-74.0,-64.0,-70.0,-66.0,-74.0,-66.0,-69.0,-90.0,-93.0,-90.0,-93.0,24.0,19.0,26.0,23.0,0
137,CC:2F:71:3E:C5:1F,2631435,333098457,5120,626138,2626315,332472319,6,21979,1842788,18118,1385272,3861,457516,5402,29,7300,130,6,448,130000.0,39000.0,-70.0,-72.0,-68.0,-59.0,-69.0,-70.0,-67.0,-59.0,-90.0,-93.0,-90.0,-93.0,20.0,21.0,22.0,34.0,0
138,CC:2F:71:3F:1F:24,3118699,961846647,492384,629374328,2626315,332472319,21,370105,414862676,366231,414395846,3874,466830,344691,581,494461,61059,21,4543,86667.0,13000.0,-71.0,-66.0,-75.0,-67.0,-71.0,-66.0,-74.0,-67.0,-90.0,-93.0,-90.0,-93.0,19.0,27.0,15.0,26.0,0
139,F8:59:71:5A:E0:3D,2653316,374017402,26999,41544881,2626317,332472521,0,3028,373536,2978,364061,50,9475,2981,0,27007,865,0,19,130000.0,39000.0,-66.0,-74.0,-64.0,-70.0,-66.0,-74.0,-66.0,-69.0,-90.0,-93.0,-90.0,-93.0,24.0,19.0,26.0,23.0,0
140,CC:2F:71:3E:C5:1F,2631437,333098659,5120,626138,2626317,332472521,6,21979,1842788,18118,1385272,3861,457516,5402,29,7300,130,6,448,130000.0,39000.0,-70.0,-72.0,-68.0,-59.0,-69.0,-70.0,-67.0,-59.0,-90.0,-93.0,-90.0,-93.0,20.0,21.0,22.0,34.0,0
141,CC:2F:71:3F:1F:24,3118765,961867272,492447,629394691,2626318,332472581,21,370167,414872587,366293,414405757,3874,466830,344742,581,494524,61060,21,4543,115556.0,28889.0,-70.0,-65.0,-75.0,-69.0,-70.0,-65.0,-75.0,-68.0,-90.0,-93.0,-90.0,-93.0,20.0,28.0,15.0,24.0,0
142,F8:59:71:5A:E0:3D,2653324,374018184,27000,41544997,2626324,332473187,0,3030,373676,2980,364201,50,9475,2981,0,27008,865,0,19,130000.0,39000.0,-73.0,-84.0,-77.0,-75.0,-68.0,-77.0,-69.0,-71.0,-90.0,-93.0,-90.0,-93.0,17.0,9.0,13.0,18.0,0
143,CC:2F:71:3E:C5:1F,2631445,333099441,5121,626254,2626324,332473187,6,21981,1842928,18120,1385412,3861,457516,5402,29,7301,130,6,448,130000.0,39000.0,-64.0,-70.0,-63.0,-59.0,-70.0,-72.0,-67.0,-60.0,-90.0,-93.0,-90.0,-93.0,26.0,23.0,27.0,34.0,0
144,CC:2F:71:3F:1F:24,3118831,961885256,492507,629412069,2626324,332473187,21,370230,414881839,366356,414415009,3874,466830,344792,581,494584,61080,21,4543,115556.0,28889.0,-72.0,-63.0,-73.0,-67.0,-71.0,-63.0,-73.0,-67.0,-90.0,-93.0,-90.0,-93.0,18.0,30.0,17.0,26.0,0
145,F8:59:71:5A:E0:3D,2653326,374018386,27000,41544997,2626326,332473389,0,3030,373676,2980,364201,50,9475,2981,0,27008,865,0,19,130000.0,39000.0,-73.0,-84.0,-77.0,-75.0,-68.0,-77.0,-69.0,-71.0,-90.0,-93.0,-90.0,-93.0,17.0,9.0,13.0,18.0,0
146,CC:2F:71:3E:C5:1F,2631448,333099705,5121,626254,2626327,332473451,6,21981,1842928,18120,1385412,3861,457516,5402,29,7301,130,6,448,130000.0,39000.0,-64.0,-70.0,-63.0,-59.0,-70.0,-72.0,-67.0,-60.0,-90.0,-93.0,-90.0,-93.0,26.0,23.0,27.0,34.0,0
147,CC:2F:71:3F:1F:24,3118906,961904897,492577,629431244,2626329,332473653,21,370284,414889390,366409,414422442,3875,466948,344835,581,494654,61080,21,4543,115556.0,28889.0,-71.0,-64.0,-72.0,-69.0,-71.0,-63.0,-71.0,-68.0,-90.0,-93.0,-90.0,-93.0,19.0,29.0,18.0,24.0,0
148,F8:59:71:5A:E0:3D,2653334,374019114,27000,41544997,2626334,332474117,0,3030,373676,2980,364201,50,9475,2981,0,27008,865,0,19,130000.0,39000.0,-73.0,-84.0,-77.0,-75.0,-68.0,-77.0,-69.0,-71.0,-90.0,-93.0,-90.0,-93.0,17.0,9.0,13.0,18.0,0
149,CC:2F:71:3E:C5:1F,2631455,333100371,5121,626254,2626334,332474117,6,21981,1842928,18120,1385412,3861,457516,5402,29,7301,130,6,448,130000.0,39000.0,-64.0,-70.0,-63.0,-59.0,-70.0,-72.0,-67.0,-60.0,-90.0,-93.0,-90.0,-93.0,26.0,23.0,27.0,34.0,0
150,CC:2F:71:3F:1F:24,3118985,961926509,492651,629452392,2626334,332474117,21,370343,414898730,366468,414431782,3875,466948,344882,581,494728,61081,21,4543,130000.0,43333.0,-73.0,-64.0,-73.0,-67.0,-75.0,-69.0,-76.0,-72.0,-90.0,-93.0,-90.0,-93.0,17.0,29.0,17.0,26.0,0
151,F8:59:71:5A:E0:3D,2653339,374020151,27001,41545497,2626338,332474654,0,3034,374084,2983,364491,51,9593,2983,0,27009,865,0,19,130000.0,39000.0,-66.0,-75.0,-65.0,-70.0,-66.0,-76.0,-66.0,-70.0,-90.0,-93.0,-90.0,-93.0,24.0,18.0,25.0,23.0,0
152,CC:2F:71:3E:C5:1F,2631459,333100908,5121,626254,2626338,332474654,6,21981,1842928,18120,1385412,3861,457516,5402,29,7301,130,6,448,130000.0,39000.0,-64.0,-70.0,-63.0,-59.0,-70.0,-72.0,-67.0,-60.0,-90.0,-93.0,-90.0,-93.0,26.0,23.0,27.0,34.0,0
153,CC:2F:71:3F:1F:24,3119047,961942223,492709,629467569,2626338,332474654,21,370383,414904820,366508,414437872,3875,466948,344918,581,494786,61088,21,4543,144444.0,43333.0,-72.0,-64.0,-73.0,-68.0,-72.0,-64.0,-73.0,-68.0,-90.0,-93.0,-90.0,-93.0,18.0,29.0,17.0,25.0,0
154,F8:59:71:5A:E0:3D,2653346,374020873,27002,41545613,2626344,332475260,0,3036,374260,2985,364667,51,9593,2984,0,27010,865,0,19,130000.0,39000.0,-65.0,-74.0,-64.0,-70.0,-66.0,-76.0,-65.0,-70.0,-90.0,-93.0,-90.0,-93.0,25.0,19.0,26.0,23.0,0
155,CC:2F:71:3E:C5:1F,2631465,333101514,5121,626254,2626344,332475260,6,21981,1842928,18120,1385412,3861,457516,5402,29,7301,130,6,448,130000.0,39000.0,-64.0,-70.0,-63.0,-59.0,-70.0,-72.0,-67.0,-60.0,-90.0,-93.0,-90.0,-93.0,26.0,23.0,27.0,34.0,0
156,CC:2F:71:3F:1F:24,3119648,962716631,493304,630241371,2626344,332475260,21,370510,414926949,366635,414460001,3875,466948,345043,581,495353,61157,21,4543,117000.0,39000.0,-70.0,-64.0,-73.0,-68.0,-69.0,-64.0,-73.0,-68.0,-90.0,-93.0,-90.0,-93.0,20.0,29.0,17.0,25.0,0
157,F8:59:71:5A:E0:3D,2653349,374021135,27002,41545613,2626347,332475522,0,3036,374260,2985,364667,51,9593,2984,0,27010,865,0,19,130000.0,39000.0,-65.0,-74.0,-64.0,-70.0,-66.0,-76.0,-65.0,-70.0,-90.0,-92.0,-89.0,-92.0,25.0,18.0,25.0,22.0,0
158,CC:2F:71:3E:C5:1F,2631468,333101776,5121,626254,2626347,332475522,6,21981,1842928,18120,1385412,3861,457516,5402,29,7301,130,6,448,130000.0,39000.0,-64.0,-70.0,-63.0,-59.0,-70.0,-72.0,-67.0,-60.0,-90.0,-92.0,-89.0,-92.0,26.0,22.0,26.0,33.0,0
159,CC:2F:71:3F:1F:24,3120107,963294661,493760,630819139,2626347,332475522,21,370638,414947021,366763,414480073,3875,466948,345170,581,495837,61353,21,4543,115556.0,28889.0,-70.0,-65.0,-75.0,-68.0,-70.0,-65.0,-75.0,-68.0,-90.0,-92.0,-89.0,-92.0,20.0,27.0,14.0,24.0,0
160,F8:59:71:5A:E0:3D,2653355,374021741,27002,41545613,2626353,332476128,0,3036,374260,2985,364667,51,9593,2984,0,27010,865,0,19,130000.0,39000.0,-65.0,-74.0,-64.0,-70.0,-66.0,-76.0,-65.0,-70.0,-90.0,-92.0,-88.0,-92.0,25.0,18.0,24.0,22.0,0
161,CC:2F:71:3E:C5:1F,2631474,333102382,5121,626254,2626353,332476128,6,21981,1842928,18120,1385412,3861,457516,5402,29,7301,130,6,448,130000.0,39000.0,-64.0,-70.0,-63.0,-59.0,-70.0,-72.0,-67.0,-60.0,-90.0,-92.0,-88.0,-92.0,26.0,22.0,25.0,33.0,0
162,CC:2F:71:3F:1F:24,3120476,963732312,494123,631256184,2626353,332476128,21,370765,414971682,366890,414504734,3875,466948,345297,581,496200,61830,21,4543,104000.0,26000.0,-72.0,-65.0,-76.0,-69.0,-71.0,-64.0,-75.0,-69.0,-90.0,-92.0,-88.0,-92.0,18.0,27.0,12.0,23.0,0
163,F8:59:71:5A:E0:3D,2653356,374021895,27003,41545767,2626353,332476128,0,3038,374470,2987,364877,51,9593,2985,0,27011,865,0,19,130000.0,39000.0,-74.0,-84.0,-77.0,-75.0,-66.0,-75.0,-65.0,-70.0,-90.0,-92.0,-88.0,-92.0,16.0,8.0,11.0,17.0,0
164,CC:2F:71:3E:C5:1F,2631474,333102382,5121,626254,2626353,332476128,6,21981,1842928,18120,1385412,3861,457516,5402,29,7301,130,6,448,130000.0,39000.0,-64.0,-70.0,-63.0,-59.0,-70.0,-72.0,-67.0,-60.0,-90.0,-92.0,-88.0,-92.0,26.0,22.0,25.0,33.0,0
165,CC:2F:71:3F:1F:24,3120847,963973564,494492,631497234,2626355,332476330,21,371047,415043095,367172,414576147,3875,466948,345579,581,496569,61886,21,4543,115556.0,28889.0,-71.0,-64.0,-75.0,-68.0,-71.0,-64.0,-75.0,-68.0,-90.0,-92.0,-88.0,-92.0,19.0,28.0,13.0,24.0,0
166,F8:59:71:5A:E0:3D,2653366,374022825,27003,41545767,2626363,332477058,0,3038,374470,2987,364877,51,9593,2985,0,27011,865,0,19,130000.0,39000.0,-74.0,-84.0,-77.0,-75.0,-66.0,-75.0,-65.0,-70.0,-90.0,-92.0,-88.0,-92.0,16.0,8.0,11.0,17.0,0
167,CC:2F:71:3E:C5:1F,2631484,333103312,5121,626254,2626363,332477058,6,21983,1843116,18121,1385482,3862,457634,5403,29,7301,130,6,448,130000.0,39000.0,-69.0,-71.0,-67.0,-59.0,-70.0,-73.0,-68.0,-60.0,-90.0,-92.0,-88.0,-92.0,21.0,21.0,21.0,33.0,0
168,CC:2F:71:3F:1F:24,3120906,963988674,494543,631511616,2626363,332477058,21,371085,415049815,367210,414582867,3875,466948,345616,581,496620,61886,21,4543,115556.0,28889.0,-71.0,-64.0,-75.0,-68.0,-74.0,-66.0,-77.0,-70.0,-90.0,-92.0,-88.0,-92.0,19.0,28.0,13.0,24.0,0
169,F8:59:71:5A:E0:3D,2653366,374022825,27003,41545767,2626363,332477058,0,3038,374470,2987,364877,51,9593,2985,0,27011,865,0,19,130000.0,39000.0,-74.0,-84.0,-77.0,-75.0,-66.0,-75.0,-65.0,-70.0,-90.0,-92.0,-88.0,-92.0,16.0,8.0,11.0,17.0,0
170,CC:2F:71:3E:C5:1F,2631485,333103382,5121,626254,2626364,332477128,6,21983,1843116,18121,1385482,3862,457634,5403,29,7301,130,6,448,130000.0,39000.0,-69.0,-71.0,-67.0,-59.0,-70.0,-73.0,-68.0,-60.0,-90.0,-92.0,-88.0,-92.0,21.0,21.0,21.0,33.0,0
171,CC:2F:71:3F:1F:24,3121486,964782936,495121,632305674,2626365,332477262,21,371158,415063857,367283,414596909,3875,466948,345688,581,497192,62285,21,4543,117000.0,39000.0,-78.0,-70.0,-80.0,-75.0,-74.0,-67.0,-78.0,-71.0,-90.0,-92.0,-88.0,-92.0,12.0,22.0,8.0,17.0,0
172,F8:59:71:5A:E0:3D,2653375,374023703,27003,41545767,2626372,332477936,0,3040,374666,2988,364947,52,9719,2986,0,27011,865,0,19,130000.0,39000.0,-67.0,-75.0,-64.0,-70.0,-67.0,-75.0,-65.0,-70.0,-90.0,-92.0,-88.0,-92.0,23.0,17.0,24.0,22.0,0
173,CC:2F:71:3E:C5:1F,2631493,333104190,5121,626254,2626372,332477936,6,21983,1843116,18121,1385482,3862,457634,5403,29,7301,130,6,448,130000.0,39000.0,-69.0,-71.0,-67.0,-59.0,-70.0,-73.0,-68.0,-60.0,-90.0,-92.0,-88.0,-92.0,21.0,21.0,21.0,33.0,0
174,CC:2F:71:3F:1F:24,3121566,964831732,495193,632353736,2626373,332477996,21,371201,415070095,367326,414603147,3875,466948,345729,581,497270,62302,21,4543,115556.0,28889.0,-72.0,-64.0,-75.0,-69.0,-71.0,-64.0,-75.0,-68.0,-90.0,-92.0,-88.0,-92.0,18.0,28.0,13.0,23.0,0
175,F8:59:71:5A:E0:3D,2653377,374023879,27004,41545883,2626373,332477996,0,3043,374912,2991,365193,52,9719,2987,0,27012,865,0,19,130000.0,39000.0,-67.0,-75.0,-64.0,-70.0,-67.0,-75.0,-65.0,-70.0,-90.0,-92.0,-88.0,-92.0,23.0,17.0,24.0,22.0,0
176,CC:2F:71:3E:C5:1F,2631494,333104250,5121,626254,2626373,332477996,6,21983,1843116,18121,1385482,3862,457634,5403,29,7301,130,6,448,130000.0,39000.0,-69.0,-71.0,-67.0,-59.0,-70.0,-73.0,-68.0,-60.0,-90.0,-92.0,-88.0,-92.0,21.0,21.0,21.0,33.0,0
177,CC:2F:71:3F:1F:24,3121673,964944612,495300,632466616,2626373,332477996,21,371268,415080538,367393,414613590,3875,466948,345795,581,497377,62316,21,4543,115556.0,28889.0,-71.0,-64.0,-75.0,-68.0,-71.0,-64.0,-75.0,-68.0,-90.0,-92.0,-88.0,-92.0,19.0,28.0,13.0,24.0,0
178,F8:59:71:5A:E0:3D,2653385,374024687,27004,41545883,2626381,332478804,0,3043,374912,2991,365193,52,9719,2987,0,27012,865,0,19,130000.0,39000.0,-67.0,-75.0,-64.0,-70.0,-67.0,-75.0,-65.0,-70.0,-90.0,-92.0,-88.0,-92.0,23.0,17.0,24.0,22.0,0
179,CC:2F:71:3E:C5:1F,2631502,333105058,5121,626254,2626381,332478804,6,21983,1843116,18121,1385482,3862,457634,5403,29,7301,130,6,448,130000.0,39000.0,-69.0,-71.0,-67.0,-59.0,-70.0,-73.0,-68.0,-60.0,-90.0,-92.0,-88.0,-92.0,21.0,21.0,21.0,33.0,0
180,CC:2F:71:3F:1F:24,3125403,970755962,499022,638277158,2626381,332478804,21,371922,415161280,368047,414694332,3875,466948,346449,581,501099,63743,21,4543,86667.0,14444.0,-71.0,-65.0,-75.0,-69.0,-71.0,-65.0,-75.0,-68.0,-90.0,-92.0,-88.0,-92.0,19.0,27.0,13.0,23.0,0
181,F8:59:71:5A:E0:3D,2653390,374025151,27004,41545883,2626386,332479268,0,3043,374912,2991,365193,52,9719,2987,0,27012,865,0,19,130000.0,39000.0,-67.0,-75.0,-64.0,-70.0,-67.0,-75.0,-65.0,-70.0,-90.0,-92.0,-88.0,-92.0,23.0,17.0,24.0,22.0,0
182,CC:2F:71:3E:C5:1F,2631509,333105724,5121,626254,2626388,332479470,6,21983,1843116,18121,1385482,3862,457634,5403,29,7301,130,6,448,130000.0,39000.0,-69.0,-71.0,-67.0,-59.0,-70.0,-73.0,-68.0,-60.0,-90.0,-92.0,-88.0,-92.0,21.0,21.0,21.0,33.0,0
183,CC:2F:71:3F:1F:24,3129518,977172576,503128,644692904,2626390,332479672,21,372541,415241032,368666,414774084,3875,466948,347068,581,505179,63775,21,4543,86667.0,14444.0,-71.0,-64.0,-75.0,-68.0,-71.0,-64.0,-73.0,-68.0,-90.0,-92.0,-88.0,-92.0,19.0,28.0,13.0,24.0,0
184,F8:59:71:5A:E0:3D,2653394,374025555,27004,41545883,2626390,332479672,0,3043,374912,2991,365193,52,9719,2987,0,27012,865,0,19,130000.0,39000.0,-67.0,-75.0,-64.0,-70.0,-67.0,-75.0,-65.0,-70.0,-89.0,-92.0,-88.0,-91.0,22.0,17.0,24.0,21.0,0
185,CC:2F:71:3E:C5:1F,2631513,333106128,5121,626254,2626392,332479874,6,21983,1843116,18121,1385482,3862,457634,5403,29,7301,130,6,448,130000.0,39000.0,-69.0,-71.0,-67.0,-59.0,-70.0,-73.0,-68.0,-60.0,-89.0,-92.0,-88.0,-91.0,20.0,21.0,21.0,32.0,0
186,CC:2F:71:3F:1F:24,3135231,985970408,508836,653490272,2626395,332480136,21,373338,415355208,369463,414888260,3875,466948,347865,581,510844,64300,21,4543,86667.0,14444.0,-72.0,-65.0,-76.0,-69.0,-71.0,-64.0,-75.0,-69.0,-89.0,-92.0,-88.0,-91.0,17.0,27.0,12.0,22.0,0
187,F8:59:71:5A:E0:3D,2653404,374026696,27004,41545883,2626400,332480813,0,3043,374912,2991,365193,52,9719,2987,0,27012,865,0,19,130000.0,39000.0,-67.0,-75.0,-64.0,-70.0,-67.0,-75.0,-65.0,-70.0,-89.0,-92.0,-88.0,-91.0,22.0,17.0,24.0,21.0,0
188,CC:2F:71:3E:C5:1F,2631521,333107067,5121,626254,2626400,332480813,6,21983,1843116,18121,1385482,3862,457634,5403,29,7301,130,6,448,130000.0,39000.0,-69.0,-71.0,-67.0,-59.0,-70.0,-73.0,-68.0,-60.0,-89.0,-92.0,-88.0,-91.0,20.0,21.0,21.0,32.0,0
189,CC:2F:71:3F:1F:24,3140397,994068734,513997,661587921,2626400,332480813,21,374351,415478549,370476,415011601,3875,466948,348878,581,515986,64921,21,4544,86667.0,14444.0,-73.0,-65.0,-75.0,-69.0,-73.0,-65.0,-75.0,-69.0,-89.0,-92.0,-88.0,-91.0,16.0,27.0,13.0,22.0,0
190,F8:59:71:5A:E0:3D,2653413,374027564,27004,41545883,2626409,332481681,0,3043,374912,2991,365193,52,9719,2987,0,27012,865,0,19,130000.0,39000.0,-67.0,-75.0,-64.0,-70.0,-67.0,-75.0,-65.0,-70.0,-89.0,-92.0,-88.0,-91.0,22.0,17.0,24.0,21.0,0
191,CC:2F:71:3E:C5:1F,2631530,333107935,5121,626254,2626409,332481681,6,21983,1843116,18121,1385482,3862,457634,5403,29,7301,130,6,448,130000.0,39000.0,-69.0,-71.0,-67.0,-59.0,-70.0,-73.0,-68.0,-60.0,-89.0,-92.0,-88.0,-91.0,20.0,21.0,21.0,32.0,0
192,CC:2F:71:3F:1F:24,3144362,1000264977,517953,667783296,2626409,332481681,21,374960,415553818,371085,415086870,3875,466948,349487,581,519985,65020,21,4544,86667.0,14444.0,-75.0,-66.0,-73.0,-68.0,-75.0,-66.0,-73.0,-68.0,-89.0,-92.0,-88.0,-91.0,14.0,26.0,15.0,23.0,0
193,F8:59:71:5A:E0:3D,2653415,374027766,27004,41545883,2626411,332481883,0,3043,374912,2991,365193,52,9719,2987,0,27012,865,0,19,130000.0,39000.0,-67.0,-75.0,-64.0,-70.0,-67.0,-75.0,-65.0,-70.0,-89.0,-92.0,-88.0,-91.0,22.0,17.0,24.0,21.0,0
194,CC:2F:71:3E:C5:1F,2631532,333108137,5121,626254,2626411,332481883,6,21983,1843116,18121,1385482,3862,457634,5403,29,7301,130,6,448,130000.0,39000.0,-69.0,-71.0,-67.0,-59.0,-70.0,-73.0,-68.0,-60.0,-89.0,-92.0,-88.0,-91.0,20.0,21.0,21.0,32.0,0
195,CC:2F:71:3F:1F:24,3147977,1005916416,521564,673434331,2626413,332482085,21,375678,415642085,371803,415175137,3875,466948,350202,581,523629,65111,21,4545,144444.0,43333.0,-75.0,-64.0,-75.0,-69.0,-75.0,-64.0,-74.0,-68.0,-89.0,-92.0,-88.0,-91.0,14.0,28.0,13.0,22.0,0
196,F8:59:71:5A:E0:3D,2653434,374040309,27017,41557820,2626417,332482489,0,3057,377398,3005,367679,52,9719,3000,0,27025,865,0,19,144444.0,39000.0,-66.0,-75.0,-65.0,-71.0,-65.0,-73.0,-64.0,-69.0,-89.0,-92.0,-88.0,-91.0,23.0,17.0,23.0,20.0,0
197,CC:2F:71:3E:C5:1F,2631538,333108743,5121,626254,2626417,332482489,6,21983,1843116,18121,1385482,3862,457634,5403,29,7301,130,6,448,130000.0,39000.0,-69.0,-71.0,-67.0,-59.0,-70.0,-73.0,-68.0,-60.0,-89.0,-92.0,-88.0,-91.0,20.0,21.0,21.0,32.0,0
198,CC:2F:71:3F:1F:24,3152091,1012350418,525673,679867869,2626418,332482549,21,376586,415751319,372711,415284371,3875,466948,351110,581,527739,66544,21,4545,130000.0,43333.0,-75.0,-66.0,-74.0,-68.0,-74.0,-66.0,-74.0,-68.0,-89.0,-92.0,-88.0,-91.0,14.0,26.0,14.0,23.0,0
199,F8:59:71:5A:E0:3D,2653439,374040773,27017,41557820,2626422,332482953,0,3057,377398,3005,367679,52,9719,3000,0,27025,865,0,19,144444.0,39000.0,-66.0,-75.0,-65.0,-71.0,-65.0,-73.0,-64.0,-69.0,-89.0,-92.0,-88.0,-91.0,23.0,17.0,23.0,20.0,0
200,CC:2F:71:3E:C5:1F,2631545,333109409,5121,626254,2626424,332483155,6,21983,1843116,18121,1385482,3862,457634,5403,29,7301,130,6,448,130000.0,39000.0,-69.0,-71.0,-67.0,-59.0,-70.0,-73.0,-68.0,-60.0,-89.0,-92.0,-88.0,-91.0,20.0,21.0,21.0,32.0,0
201,CC:2F:71:3F:1F:24,3157488,1020689429,531064,688206274,2626424,332483155,21,377541,415874331,373666,415407383,3875,466948,352049,581,533129,66822,21,4545,130000.0,43333.0,-71.0,-65.0,-73.0,-67.0,-71.0,-65.0,-73.0,-67.0,-89.0,-92.0,-88.0,-91.0,18.0,27.0,15.0,24.0,0
202,F8:59:71:5A:E0:3D,2653443,374041177,27017,41557820,2626426,332483357,0,3057,377398,3005,367679,52,9719,3000,0,27025,865,0,19,144444.0,39000.0,-66.0,-75.0,-65.0,-71.0,-65.0,-73.0,-64.0,-69.0,-89.0,-92.0,-88.0,-91.0,23.0,17.0,23.0,20.0,0
203,CC:2F:71:3E:C5:1F,2631547,333109611,5121,626254,2626426,332483357,6,21983,1843116,18121,1385482,3862,457634,5403,29,7301,130,6,448,130000.0,39000.0,-69.0,-71.0,-67.0,-59.0,-70.0,-73.0,-68.0,-60.0,-89.0,-92.0,-88.0,-91.0,20.0,21.0,21.0,32.0,0
204,CC:2F:71:3F:1F:24,3162259,1028165869,535831,695682144,2626428,332483725,21,378092,415942583,374217,415475635,3875,466948,352600,581,537881,68043,21,4545,117000.0,39000.0,-71.0,-64.0,-72.0,-67.0,-72.0,-64.0,-71.0,-67.0,-89.0,-92.0,-88.0,-91.0,18.0,28.0,16.0,24.0,0
205,F8:59:71:5A:E0:3D,2653452,374042211,27017,41557820,2626435,332484391,0,3057,377398,3005,367679,52,9719,3000,0,27025,865,0,19,144444.0,39000.0,-66.0,-75.0,-65.0,-71.0,-65.0,-73.0,-64.0,-69.0,-89.0,-92.0,-88.0,-91.0,23.0,17.0,23.0,20.0,0
206,CC:2F:71:3E:C5:1F,2631558,333110847,5121,626254,2626437,332484593,6,21983,1843116,18121,1385482,3862,457634,5403,29,7301,130,6,448,130000.0,39000.0,-69.0,-71.0,-67.0,-59.0,-70.0,-73.0,-68.0,-60.0,-89.0,-92.0,-88.0,-91.0,20.0,21.0,21.0,32.0,0
207,CC:2F:71:3F:1F:24,3166786,1035245821,540349,702761228,2626437,332484593,21,378760,416025079,374885,415558131,3875,466948,353259,581,542414,68135,21,4545,130000.0,43333.0,-70.0,-65.0,-69.0,-70.0,-69.0,-64.0,-68.0,-69.0,-89.0,-92.0,-88.0,-91.0,19.0,27.0,19.0,21.0,0
208,F8:59:71:5A:E0:3D,2653454,374042413,27017,41557820,2626437,332484593,0,3057,377398,3005,367679,52,9719,3000,0,27025,865,0,19,144444.0,39000.0,-66.0,-75.0,-65.0,-71.0,-65.0,-73.0,-64.0,-69.0,-89.0,-91.0,-88.0,-91.0,23.0,16.0,23.0,20.0,0
209,CC:2F:71:3E:C5:1F,2631558,333110847,5121,626254,2626437,332484593,6,21983,1843116,18121,1385482,3862,457634,5403,29,7301,130,6,448,130000.0,39000.0,-69.0,-71.0,-67.0,-59.0,-70.0,-73.0,-68.0,-60.0,-89.0,-91.0,-88.0,-91.0,20.0,20.0,21.0,32.0,0
210,CC:2F:71:3F:1F:24,3172130,1043614693,545689,711129696,2626441,332484997,21,379348,416099741,375473,415632793,3875,466948,353847,581,547710,68472,21,4545,130000.0,43333.0,-72.0,-65.0,-71.0,-68.0,-72.0,-64.0,-70.0,-68.0,-89.0,-91.0,-88.0,-91.0,17.0,26.0,17.0,23.0,0
211,F8:59:71:5A:E0:3D,2653465,374043403,27018,41557880,2626447,332485523,0,3060,377656,3007,367819,53,9837,3001,0,27026,865,0,19,144444.0,39000.0,-66.0,-72.0,-67.0,-70.0,-65.0,-72.0,-66.0,-69.0,-89.0,-91.0,-88.0,-91.0,23.0,19.0,21.0,21.0,0
212,CC:2F:71:3E:C5:1F,2631569,333111893,5122,626370,2626447,332485523,6,21985,1843256,18123,1385622,3862,457634,5403,29,7302,130,6,448,130000.0,39000.0,-64.0,-71.0,-65.0,-61.0,-68.0,-73.0,-67.0,-61.0,-89.0,-91.0,-88.0,-91.0,25.0,20.0,23.0,30.0,0
213,CC:2F:71:3F:1F:24,3176609,1050621967,550162,718136444,2626447,332485523,21,379872,416164531,375997,415697583,3875,466948,354371,581,552239,68521,21,4545,130000.0,43333.0,-71.0,-64.0,-72.0,-67.0,-70.0,-64.0,-71.0,-66.0,-89.0,-91.0,-88.0,-91.0,18.0,27.0,16.0,24.0,0
214,F8:59:71:5A:E0:3D,2653465,374043403,27018,41557880,2626447,332485523,0,3061,377726,3008,367889,53,9837,3001,0,27026,865,0,19,144444.0,39000.0,-66.0,-70.0,-67.0,-71.0,-65.0,-71.0,-66.0,-69.0,-89.0,-91.0,-88.0,-91.0,23.0,21.0,21.0,20.0,0
215,CC:2F:71:3E:C5:1F,2631569,333111893,5122,626370,2626447,332485523,6,21985,1843256,18123,1385622,3862,457634,5403,29,7302,130,6,448,130000.0,39000.0,-64.0,-71.0,-65.0,-61.0,-68.0,-73.0,-67.0,-61.0,-89.0,-91.0,-88.0,-91.0,25.0,20.0,23.0,30.0,0
216,CC:2F:71:3F:1F:24,3180975,1057448694,554524,724962767,2626451,332485927,21,380304,416220106,376429,415753158,3875,466948,354803,581,556601,68612,21,4545,144444.0,43333.0,-75.0,-63.0,-71.0,-67.0,-74.0,-63.0,-71.0,-67.0,-89.0,-91.0,-88.0,-91.0,14.0,28.0,17.0,24.0,0
217,F8:59:71:5A:E0:3D,2653473,374044211,27018,41557880,2626455,332486331,0,3061,377726,3008,367889,53,9837,3001,0,27026,865,0,19,144444.0,39000.0,-66.0,-70.0,-67.0,-71.0,-65.0,-71.0,-66.0,-69.0,-89.0,-91.0,-88.0,-91.0,23.0,21.0,21.0,20.0,0
218,CC:2F:71:3E:C5:1F,2631579,333112823,5122,626370,2626457,332486453,6,21985,1843256,18123,1385622,3862,457634,5403,29,7302,130,6,448,130000.0,39000.0,-64.0,-71.0,-65.0,-61.0,-68.0,-73.0,-67.0,-61.0,-89.0,-91.0,-88.0,-91.0,25.0,20.0,23.0,30.0,0
219,CC:2F:71:3F:1F:24,3187147,1067128360,560690,734641907,2626457,332486453,21,381056,416311064,377180,415843998,3876,467066,355555,581,562767,68904,21,4545,130000.0,39000.0,-75.0,-65.0,-73.0,-68.0,-74.0,-65.0,-73.0,-67.0,-89.0,-91.0,-88.0,-91.0,14.0,26.0,15.0,23.0,0
220,F8:59:71:5A:E0:3D,2653480,374045010,27018,41557880,2626462,332487130,0,3061,377726,3008,367889,53,9837,3001,0,27026,865,0,19,144444.0,39000.0,-66.0,-70.0,-67.0,-71.0,-65.0,-71.0,-66.0,-69.0,-89.0,-91.0,-88.0,-91.0,23.0,21.0,21.0,20.0,0
221,CC:2F:71:3E:C5:1F,2631586,333113702,5122,626370,2626464,332487332,6,21985,1843256,18123,1385622,3862,457634,5403,29,7302,130,6,448,130000.0,39000.0,-64.0,-71.0,-65.0,-61.0,-68.0,-73.0,-67.0,-61.0,-89.0,-91.0,-88.0,-91.0,25.0,20.0,23.0,30.0,0
222,CC:2F:71:3F:1F:24,3192651,1075751296,566185,743263762,2626466,332487534,21,381674,416393082,377798,415926016,3876,467066,356173,581,568262,69484,21,4545,130000.0,39000.0,-74.0,-65.0,-72.0,-67.0,-73.0,-65.0,-71.0,-67.0,-89.0,-92.0,-88.0,-91.0,15.0,27.0,16.0,24.0,0
223,F8:59:71:5A:E0:3D,2653484,374045414,27018,41557880,2626466,332487534,0,3061,377726,3008,367889,53,9837,3001,0,27026,865,0,19,144444.0,39000.0,-66.0,-70.0,-67.0,-71.0,-65.0,-71.0,-66.0,-69.0,-89.0,-92.0,-88.0,-91.0,23.0,22.0,21.0,20.0,0
224,CC:2F:71:3E:C5:1F,2631588,333113904,5122,626370,2626466,332487534,6,21985,1843256,18123,1385622,3862,457634,5403,29,7302,130,6,448,130000.0,39000.0,-64.0,-71.0,-65.0,-61.0,-68.0,-73.0,-67.0,-61.0,-89.0,-92.0,-88.0,-91.0,25.0,21.0,23.0,30.0,0
225,CC:2F:71:3F:1F:24,3197055,1082601375,570589,750113841,2626466,332487534,21,382213,416464785,378337,415997719,3876,467066,356712,581,572666,69625,21,4545,130000.0,43333.0,-71.0,-65.0,-71.0,-68.0,-70.0,-65.0,-70.0,-67.0,-89.0,-92.0,-88.0,-91.0,18.0,27.0,17.0,23.0,0
226,F8:59:71:5A:E0:3D,2653493,374046282,27018,41557880,2626475,332488402,0,3061,377726,3008,367889,53,9837,3001,0,27026,865,0,19,144444.0,39000.0,-66.0,-70.0,-67.0,-71.0,-65.0,-71.0,-66.0,-69.0,-89.0,-92.0,-88.0,-91.0,23.0,22.0,21.0,20.0,0
227,CC:2F:71:3E:C5:1F,2631597,333114772,5122,626370,2626475,332488402,6,21985,1843256,18123,1385622,3862,457634,5403,29,7302,130,6,448,130000.0,39000.0,-64.0,-71.0,-65.0,-61.0,-68.0,-73.0,-67.0,-61.0,-89.0,-92.0,-88.0,-91.0,25.0,21.0,23.0,30.0,0
228,CC:2F:71:3F:1F:24,3201846,1090102015,575371,757613613,2626475,332488402,21,382681,416523251,378805,416056185,3876,467066,357180,581,577416,69729,21,4545,130000.0,43333.0,-72.0,-66.0,-71.0,-68.0,-71.0,-66.0,-71.0,-68.0,-89.0,-92.0,-88.0,-91.0,17.0,26.0,17.0,23.0,0
229,F8:59:71:5A:E0:3D,2653494,374046344,27018,41557880,2626476,332488464,0,3061,377726,3008,367889,53,9837,3001,0,27026,865,0,19,144444.0,39000.0,-66.0,-70.0,-67.0,-71.0,-65.0,-71.0,-66.0,-69.0,-89.0,-92.0,-88.0,-91.0,23.0,22.0,21.0,20.0,0
230,CC:2F:71:3E:C5:1F,2631598,333114834,5122,626370,2626476,332488464,6,21987,1843444,18124,1385692,3863,457752,5404,29,7302,130,6,448,130000.0,39000.0,-65.0,-69.0,-65.0,-62.0,-67.0,-72.0,-66.0,-61.0,-89.0,-92.0,-88.0,-91.0,24.0,23.0,23.0,29.0,0
231,CC:2F:71:3F:1F:24,3206360,1097174573,579882,764685907,2626478,332488666,21,383090,416576065,379214,416108999,3876,467066,357589,581,581911,69946,21,4545,130000.0,43333.0,-70.0,-66.0,-72.0,-67.0,-70.0,-65.0,-71.0,-67.0,-89.0,-92.0,-88.0,-91.0,19.0,26.0,16.0,24.0,0
232,F8:59:71:5A:E0:3D,2653503,374047212,27018,41557880,2626485,332489332,0,3061,377726,3008,367889,53,9837,3001,0,27026,865,0,19,144444.0,39000.0,-66.0,-70.0,-67.0,-71.0,-65.0,-71.0,-66.0,-69.0,-89.0,-92.0,-88.0,-91.0,23.0,22.0,21.0,20.0,0
233,CC:2F:71:3E:C5:1F,2631607,333115702,5122,626370,2626485,332489332,6,21987,1843444,18124,1385692,3863,457752,5404,29,7302,130,6,448,130000.0,39000.0,-65.0,-69.0,-65.0,-62.0,-67.0,-72.0,-66.0,-61.0,-89.0,-92.0,-88.0,-91.0,24.0,23.0,23.0,29.0,0
234,CC:2F:71:3F:1F:24,3210864,1104206823,584379,771717491,2626485,332489332,21,383559,416636017,379683,416168951,3876,467066,358054,581,586456,70116,21,4545,130000.0,43333.0,-71.0,-65.0,-70.0,-67.0,-70.0,-65.0,-70.0,-67.0,-89.0,-92.0,-88.0,-91.0,18.0,27.0,18.0,24.0,0
235,F8:59:71:5A:E0:3D,2653503,374047212,27018,41557880,2626485,332489332,0,3063,377866,3010,368029,53,9837,3001,0,27027,865,0,19,144444.0,39000.0,-65.0,-73.0,-70.0,-74.0,-65.0,-72.0,-67.0,-71.0,-89.0,-91.0,-87.0,-90.0,24.0,18.0,17.0,16.0,0
236,CC:2F:71:3E:C5:1F,2631620,333121328,5122,626370,2626498,332494958,6,21987,1843444,18124,1385692,3863,457752,5404,29,7302,130,6,448,130000.0,39000.0,-65.0,-69.0,-65.0,-62.0,-67.0,-72.0,-66.0,-61.0,-89.0,-91.0,-87.0,-90.0,24.0,22.0,22.0,28.0,0
237,CC:2F:71:3F:1F:24,3214418,1109755512,587918,777260352,2626500,332495160,21,384067,416697772,380191,416230706,3876,467066,358561,581,589962,70144,21,4545,130000.0,43333.0,-71.0,-65.0,-70.0,-67.0,-71.0,-64.0,-70.0,-67.0,-89.0,-91.0,-87.0,-90.0,18.0,26.0,17.0,23.0,0
238,F8:59:71:5A:E0:3D,2653534,374058928,27018,41557880,2626516,332501048,0,3063,377866,3010,368029,53,9837,3001,0,27027,865,0,19,144444.0,39000.0,-65.0,-73.0,-70.0,-74.0,-65.0,-72.0,-67.0,-71.0,-89.0,-91.0,-87.0,-90.0,24.0,18.0,17.0,16.0,0
239,CC:2F:71:3E:C5:1F,2631638,333127418,5122,626370,2626516,332501048,6,21987,1843444,18124,1385692,3863,457752,5404,29,7302,130,6,448,130000.0,39000.0,-65.0,-69.0,-65.0,-62.0,-67.0,-72.0,-66.0,-61.0,-89.0,-91.0,-87.0,-90.0,24.0,22.0,22.0,28.0,0
240,CC:2F:71:3F:1F:24,3218751,1116493006,592235,783991958,2626516,332501048,21,384549,416757942,380673,416290876,3876,467066,359043,581,594312,70291,21,4545,130000.0,43333.0,-72.0,-65.0,-71.0,-68.0,-72.0,-65.0,-71.0,-68.0,-89.0,-91.0,-87.0,-90.0,17.0,26.0,16.0,22.0,0
241,F8:59:71:5A:E0:3D,2653536,374059130,27018,41557880,2626518,332501250,0,3063,377866,3010,368029,53,9837,3001,0,27027,865,0,19,144444.0,39000.0,-65.0,-73.0,-70.0,-74.0,-65.0,-72.0,-67.0,-71.0,-89.0,-91.0,-87.0,-90.0,24.0,18.0,17.0,16.0,0
242,CC:2F:71:3E:C5:1F,2631640,333127620,5122,626370,2626518,332501250,6,21987,1843444,18124,1385692,3863,457752,5404,29,7302,130,6,448,130000.0,39000.0,-65.0,-69.0,-65.0,-62.0,-67.0,-72.0,-66.0,-61.0,-89.0,-91.0,-87.0,-90.0,24.0,22.0,22.0,28.0,0
243,CC:2F:71:3F:1F:24,3222796,1122797355,596276,790295903,2626520,332501452,21,385045,416822803,381169,416355737,3876,467066,359539,581,598274,70352,21,4545,130000.0,43333.0,-72.0,-66.0,-70.0,-67.0,-71.0,-66.0,-70.0,-67.0,-89.0,-91.0,-87.0,-90.0,17.0,25.0,17.0,23.0,0
244,F8:59:71:5A:E0:3D,2653542,374059736,27018,41557880,2626524,332501856,0,3063,377866,3010,368029,53,9837,3001,0,27027,865,0,19,144444.0,39000.0,-65.0,-73.0,-70.0,-74.0,-65.0,-72.0,-67.0,-71.0,-89.0,-91.0,-87.0,-90.0,24.0,18.0,17.0,16.0,0
245,CC:2F:71:3E:C5:1F,2631646,333128226,5122,626370,2626524,332501856,6,21987,1843444,18124,1385692,3863,457752,5404,29,7302,130,6,448,130000.0,39000.0,-65.0,-69.0,-65.0,-62.0,-67.0,-72.0,-66.0,-61.0,-89.0,-91.0,-87.0,-90.0,24.0,22.0,22.0,28.0,0
246,CC:2F:71:3F:1F:24,3227450,1130085139,600926,797583283,2626524,332501856,21,385470,416876897,381594,416409831,3876,467066,359964,581,603003,70585,21,4545,130000.0,39000.0,-72.0,-65.0,-72.0,-67.0,-71.0,-65.0,-72.0,-67.0,-89.0,-91.0,-87.0,-90.0,17.0,26.0,15.0,23.0,0
247,F8:59:71:5A:E0:3D,2653547,374060200,27018,41557880,2626529,332502320,0,3063,377866,3010,368029,53,9837,3001,0,27027,865,0,19,144444.0,39000.0,-65.0,-73.0,-70.0,-74.0,-65.0,-72.0,-67.0,-71.0,-89.0,-91.0,-87.0,-90.0,24.0,18.0,17.0,16.0,0
248,CC:2F:71:3E:C5:1F,2631651,333128690,5122,626370,2626529,332502320,6,21987,1843444,18124,1385692,3863,457752,5404,29,7302,130,6,448,130000.0,39000.0,-65.0,-69.0,-65.0,-62.0,-67.0,-72.0,-66.0,-61.0,-89.0,-91.0,-87.0,-90.0,24.0,22.0,22.0,28.0,0
249,CC:2F:71:3F:1F:24,3233360,1139336186,606829,806833664,2626531,332502522,21,386163,416965794,382287,416498728,3876,467066,360657,581,608886,70771,21,4546,130000.0,43333.0,-73.0,-65.0,-73.0,-68.0,-72.0,-65.0,-72.0,-67.0,-89.0,-91.0,-87.0,-90.0,16.0,26.0,14.0,22.0,0
250,F8:59:71:5A:E0:3D,2653551,374060604,27018,41557880,2626533,332502724,0,3063,377866,3010,368029,53,9837,3001,0,27027,865,0,19,144444.0,39000.0,-65.0,-73.0,-70.0,-74.0,-65.0,-72.0,-67.0,-71.0,-89.0,-91.0,-87.0,-90.0,24.0,18.0,17.0,16.0,0
251,CC:2F:71:3E:C5:1F,2631655,333129094,5122,626370,2626533,332502724,6,21987,1843444,18124,1385692,3863,457752,5404,29,7302,130,6,448,130000.0,39000.0,-65.0,-69.0,-65.0,-62.0,-67.0,-72.0,-66.0,-61.0,-89.0,-91.0,-87.0,-90.0,24.0,22.0,22.0,28.0,0
252,CC:2F:71:3F:1F:24,3237846,1146355292,611313,813852568,2626533,332502724,21,386647,417026756,382771,416559690,3876,467066,361141,581,613390,71030,21,4546,130000.0,43333.0,-72.0,-65.0,-72.0,-67.0,-71.0,-64.0,-72.0,-67.0,-89.0,-91.0,-87.0,-90.0,17.0,26.0,15.0,23.0,0
253,F8:59:71:5A:E0:3D,2653556,374061068,27018,41557880,2626538,332503188,0,3063,377866,3010,368029,53,9837,3001,0,27027,865,0,19,144444.0,39000.0,-65.0,-73.0,-70.0,-74.0,-65.0,-72.0,-67.0,-71.0,-89.0,-91.0,-87.0,-90.0,24.0,18.0,17.0,16.0,0
254,CC:2F:71:3E:C5:1F,2631662,333129760,5122,626370,2626540,332503390,6,21987,1843444,18124,1385692,3863,457752,5404,29,7302,130,6,448,130000.0,39000.0,-65.0,-69.0,-65.0,-62.0,-67.0,-72.0,-66.0,-61.0,-89.0,-91.0,-87.0,-90.0,24.0,22.0,22.0,28.0,0
255,CC:2F:71:3F:1F:24,3243242,1154806278,616700,822302686,2626542,332503592,21,387168,417092968,383292,416625902,3876,467066,361660,581,618777,71137,21,4547,130000.0,43333.0,-71.0,-64.0,-72.0,-67.0,-71.0,-64.0,-71.0,-66.0,-89.0,-91.0,-87.0,-90.0,18.0,27.0,15.0,23.0,0
256,F8:59:71:5A:E0:3D,2653561,374061745,27018,41557880,2626543,332503865,0,3063,377866,3010,368029,53,9837,3001,0,27027,865,0,19,144444.0,39000.0,-65.0,-73.0,-70.0,-74.0,-65.0,-72.0,-67.0,-71.0,-89.0,-91.0,-87.0,-90.0,24.0,18.0,17.0,16.0,0
257,CC:2F:71:3E:C5:1F,2631667,333130437,5122,626370,2626545,332504067,6,21987,1843444,18124,1385692,3863,457752,5404,29,7302,130,6,448,130000.0,39000.0,-65.0,-69.0,-65.0,-62.0,-67.0,-72.0,-66.0,-61.0,-89.0,-91.0,-87.0,-90.0,24.0,22.0,22.0,28.0,0
258,CC:2F:71:3F:1F:24,3248084,1162353525,621539,829849458,2626545,332504067,21,387708,417167832,383832,416700766,3876,467066,362200,581,623527,71465,21,4547,130000.0,43333.0,-72.0,-64.0,-72.0,-67.0,-71.0,-64.0,-72.0,-67.0,-89.0,-91.0,-87.0,-90.0,17.0,27.0,15.0,23.0,0
259,F8:59:71:5A:E0:3D,2653570,374062613,27018,41557880,2626552,332504733,0,3063,377866,3010,368029,53,9837,3001,0,27027,865,0,19,144444.0,39000.0,-65.0,-73.0,-70.0,-74.0,-65.0,-72.0,-67.0,-71.0,-89.0,-91.0,-87.0,-91.0,24.0,18.0,17.0,17.0,0
260,CC:2F:71:3E:C5:1F,2631674,333131103,5122,626370,2626552,332504733,6,21987,1843444,18124,1385692,3863,457752,5404,29,7302,130,6,448,130000.0,39000.0,-65.0,-69.0,-65.0,-62.0,-67.0,-72.0,-66.0,-61.0,-89.0,-91.0,-87.0,-91.0,24.0,22.0,22.0,29.0,0
261,CC:2F:71:3F:1F:24,3252118,1168665741,625566,836161008,2626552,332504733,21,388215,417231548,384339,416764482,3876,467066,362694,581,627643,71982,21,4547,117000.0,39000.0,-72.0,-65.0,-72.0,-68.0,-71.0,-64.0,-72.0,-67.0,-89.0,-91.0,-87.0,-91.0,17.0,26.0,15.0,23.0,0
262,F8:59:71:5A:E0:3D,2653572,374062815,27018,41557880,2626554,332504935,0,3063,377866,3010,368029,53,9837,3001,0,27027,865,0,19,144444.0,39000.0,-65.0,-73.0,-70.0,-74.0,-65.0,-72.0,-67.0,-71.0,-89.0,-91.0,-87.0,-91.0,24.0,18.0,17.0,17.0,0
263,CC:2F:71:3E:C5:1F,2631678,333131507,5122,626370,2626556,332505137,6,21987,1843444,18124,1385692,3863,457752,5404,29,7302,130,6,448,130000.0,39000.0,-65.0,-69.0,-65.0,-62.0,-67.0,-72.0,-66.0,-61.0,-89.0,-91.0,-87.0,-91.0,24.0,22.0,22.0,29.0,0
264,CC:2F:71:3F:1F:24,3257029,1176360706,630473,843855569,2626556,332505137,21,388874,417313373,384998,416846307,3876,467066,363353,581,632460,72117,21,4547,130000.0,43333.0,-71.0,-65.0,-72.0,-67.0,-71.0,-64.0,-72.0,-67.0,-89.0,-91.0,-87.0,-91.0,18.0,26.0,15.0,24.0,0
265,F8:59:71:5A:E0:3D,2653578,374063421,27018,41557880,2626560,332505541,0,3063,377866,3010,368029,53,9837,3001,0,27027,865,0,19,144444.0,39000.0,-65.0,-73.0,-70.0,-74.0,-65.0,-72.0,-67.0,-71.0,-89.0,-91.0,-87.0,-91.0,24.0,18.0,17.0,17.0,0
266,CC:2F:71:3E:C5:1F,2631682,333131911,5122,626370,2626560,332505541,6,21987,1843444,18124,1385692,3863,457752,5404,29,7302,130,6,448,130000.0,39000.0,-65.0,-69.0,-65.0,-62.0,-67.0,-72.0,-66.0,-61.0,-89.0,-91.0,-87.0,-91.0,24.0,22.0,22.0,29.0,0
267,CC:2F:71:3F:1F:24,3260973,1182494484,634412,849988883,2626561,332505601,21,389336,417378978,385460,416911912,3876,467066,363815,581,636489,72134,21,4547,130000.0,39000.0,-73.0,-64.0,-71.0,-67.0,-73.0,-64.0,-71.0,-67.0,-89.0,-91.0,-87.0,-91.0,16.0,27.0,16.0,24.0,0
268,F8:59:71:5A:E0:3D,2653583,374063885,27018,41557880,2626565,332506005,0,3063,377866,3010,368029,53,9837,3001,0,27027,865,0,19,144444.0,39000.0,-65.0,-73.0,-70.0,-74.0,-65.0,-72.0,-67.0,-71.0,-89.0,-91.0,-87.0,-91.0,24.0,18.0,17.0,17.0,0
269,CC:2F:71:3E:C5:1F,2631687,333132375,5122,626370,2626565,332506005,6,21987,1843444,18124,1385692,3863,457752,5404,29,7302,130,6,448,130000.0,39000.0,-65.0,-69.0,-65.0,-62.0,-67.0,-72.0,-66.0,-61.0,-89.0,-91.0,-87.0,-91.0,24.0,22.0,22.0,29.0,0
270,CC:2F:71:3F:1F:24,3265943,1190268285,639378,857762280,2626565,332506005,21,389808,417438126,385932,416971060,3876,467066,364287,581,641401,72588,21,4547,144444.0,43333.0,-72.0,-65.0,-71.0,-67.0,-71.0,-65.0,-71.0,-68.0,-89.0,-91.0,-87.0,-91.0,17.0,26.0,16.0,24.0,0
271,F8:59:71:5A:E0:3D,2653587,374064289,27018,41557880,2626569,332506409,0,3063,377866,3010,368029,53,9837,3001,0,27027,865,0,19,144444.0,39000.0,-65.0,-73.0,-70.0,-74.0,-65.0,-72.0,-67.0,-71.0,-89.0,-91.0,-87.0,-91.0,24.0,18.0,17.0,17.0,0
272,CC:2F:71:3E:C5:1F,2631691,333132779,5122,626370,2626569,332506409,6,21987,1843444,18124,1385692,3863,457752,5404,29,7302,130,6,448,130000.0,39000.0,-65.0,-69.0,-65.0,-62.0,-67.0,-72.0,-66.0,-61.0,-89.0,-91.0,-87.0,-91.0,24.0,22.0,22.0,29.0,0
273,CC:2F:71:3F:1F:24,3270825,1197920805,644256,865414396,2626569,332506409,21,390338,417503930,386462,417036864,3876,467066,364817,581,646333,72811,21,4547,130000.0,43333.0,-73.0,-64.0,-73.0,-67.0,-77.0,-68.0,-76.0,-71.0,-89.0,-91.0,-87.0,-91.0,16.0,27.0,14.0,24.0,0
274,F8:59:71:5A:E0:3D,2653594,374064955,27018,41557880,2626576,332507075,0,3063,377866,3010,368029,53,9837,3001,0,27027,865,0,19,144444.0,39000.0,-65.0,-73.0,-70.0,-74.0,-65.0,-72.0,-67.0,-71.0,-89.0,-91.0,-87.0,-91.0,24.0,18.0,17.0,17.0,0
275,CC:2F:71:3E:C5:1F,2631698,333133445,5122,626370,2626576,332507075,6,21987,1843444,18124,1385692,3863,457752,5404,29,7302,130,6,448,130000.0,39000.0,-65.0,-69.0,-65.0,-62.0,-67.0,-72.0,-66.0,-61.0,-89.0,-91.0,-87.0,-91.0,24.0,22.0,22.0,29.0,0
276,CC:2F:71:3F:1F:24,3275509,1205254935,648931,872747658,2626578,332507277,21,390909,417574306,387033,417107240,3876,467066,365388,581,651008,73487,21,4547,130000.0,43333.0,-72.0,-64.0,-72.0,-67.0,-72.0,-64.0,-72.0,-67.0,-89.0,-91.0,-87.0,-91.0,17.0,27.0,15.0,24.0,0
277,F8:59:71:5A:E0:3D,2653598,374065359,27018,41557880,2626580,332507479,0,3063,377866,3010,368029,53,9837,3001,0,27027,865,0,19,144444.0,39000.0,-65.0,-73.0,-70.0,-74.0,-65.0,-72.0,-67.0,-71.0,-89.0,-91.0,-87.0,-91.0,24.0,18.0,17.0,17.0,0
278,CC:2F:71:3E:C5:1F,2631702,333133849,5122,626370,2626580,332507479,6,21987,1843444,18124,1385692,3863,457752,5404,29,7302,130,6,448,130000.0,39000.0,-65.0,-69.0,-65.0,-62.0,-67.0,-72.0,-66.0,-61.0,-89.0,-91.0,-87.0,-91.0,24.0,22.0,22.0,29.0,0
279,CC:2F:71:3F:1F:24,3279517,1211527924,652937,879020445,2626580,332507479,21,391397,417634873,387521,417167807,3876,467066,365876,581,654998,73549,21,4547,130000.0,43333.0,-72.0,-64.0,-73.0,-69.0,-72.0,-64.0,-73.0,-68.0,-89.0,-91.0,-87.0,-91.0,17.0,27.0,14.0,22.0,0
280,F8:59:71:5A:E0:3D,2653604,374065939,27019,41557996,2626585,332507943,0,3064,377936,3011,368099,53,9837,3001,0,27028,865,0,19,144444.0,39000.0,-73.0,-81.0,-73.0,-76.0,-66.0,-73.0,-68.0,-72.0,-89.0,-91.0,-87.0,-91.0,16.0,10.0,14.0,15.0,0
281,CC:2F:71:3E:C5:1F,2631710,333134631,5123,626486,2626587,332508145,6,21989,1843584,18126,1385832,3863,457752,5404,29,7303,130,6,448,130000.0,39000.0,-69.0,-71.0,-68.0,-61.0,-66.0,-70.0,-65.0,-60.0,-89.0,-91.0,-87.0,-91.0,20.0,20.0,19.0,30.0,0
282,CC:2F:71:3F:1F:24,3284985,1220089834,658398,887581689,2626587,332508145,21,392036,417713967,388160,417246901,3876,467066,366515,581,660407,73794,21,4547,130000.0,43333.0,-71.0,-64.0,-74.0,-69.0,-71.0,-64.0,-73.0,-68.0,-89.0,-91.0,-87.0,-91.0,18.0,27.0,13.0,22.0,0
283,F8:59:71:5A:E0:3D,2653608,374066343,27019,41557996,2626589,332508347,0,3065,378006,3012,368169,53,9837,3001,0,27028,865,0,19,144444.0,39000.0,-68.0,-74.0,-65.0,-72.0,-66.0,-73.0,-68.0,-72.0,-89.0,-91.0,-87.0,-91.0,21.0,17.0,22.0,19.0,0
284,CC:2F:71:3E:C5:1F,2631712,333134833,5123,626486,2626589,332508347,6,21989,1843584,18126,1385832,3863,457752,5404,29,7303,130,6,448,130000.0,39000.0,-69.0,-71.0,-68.0,-61.0,-66.0,-70.0,-65.0,-60.0,-89.0,-91.0,-87.0,-91.0,20.0,20.0,19.0,30.0,0
285,CC:2F:71:3F:1F:24,3289861,1227723480,663272,895215133,2626589,332508347,21,392675,417793241,388799,417326175,3876,467066,367154,581,665303,74247,21,4547,130000.0,43333.0,-71.0,-65.0,-73.0,-66.0,-71.0,-64.0,-72.0,-65.0,-89.0,-91.0,-87.0,-91.0,18.0,26.0,14.0,25.0,0
286,F8:59:71:5A:E0:3D,2653615,374067011,27019,41557996,2626596,332509015,0,3066,378124,3012,368169,54,9955,3002,0,27028,865,0,19,144444.0,39000.0,-67.0,-76.0,-64.0,-71.0,-67.0,-73.0,-68.0,-72.0,-89.0,-91.0,-87.0,-91.0,22.0,15.0,23.0,20.0,0
287,CC:2F:71:3E:C5:1F,2631719,333135501,5123,626486,2626596,332509015,6,21989,1843584,18126,1385832,3863,457752,5404,29,7303,130,6,448,130000.0,39000.0,-69.0,-71.0,-68.0,-61.0,-66.0,-70.0,-65.0,-60.0,-89.0,-91.0,-87.0,-91.0,20.0,20.0,19.0,30.0,0
288,CC:2F:71:3F:1F:24,3294828,1235496326,668231,902987251,2626597,332509075,21,393224,417861615,389348,417394549,3876,467066,367700,581,670186,74464,21,4547,130000.0,39000.0,-71.0,-65.0,-71.0,-67.0,-71.0,-65.0,-71.0,-67.0,-90.0,-92.0,-88.0,-91.0,19.0,27.0,17.0,24.0,0
289,F8:59:71:5A:E0:3D,2653621,374067670,27019,41557996,2626602,332509674,0,3067,378194,3013,368239,54,9955,3002,0,27028,865,0,19,144444.0,39000.0,-75.0,-77.0,-76.0,-76.0,-68.0,-74.0,-69.0,-72.0,-90.0,-92.0,-88.0,-91.0,15.0,15.0,12.0,15.0,0
290,CC:2F:71:3E:C5:1F,2631729,333136564,5123,626486,2626606,332510078,6,21991,1843772,18127,1385902,3864,457870,5405,29,7303,130,6,448,130000.0,39000.0,-69.0,-70.0,-68.0,-60.0,-66.0,-70.0,-65.0,-60.0,-90.0,-92.0,-88.0,-91.0,21.0,22.0,20.0,31.0,0
291,CC:2F:71:3F:1F:24,3298957,1241926632,672351,909416554,2626606,332510078,21,393691,417924308,389814,417457124,3877,467184,368162,581,674428,75616,21,4547,130000.0,39000.0,-70.0,-64.0,-74.0,-68.0,-70.0,-64.0,-74.0,-68.0,-90.0,-92.0,-88.0,-91.0,20.0,28.0,14.0,23.0,0
292,F8:59:71:5A:E0:3D,2653627,374068276,27019,41557996,2626608,332510280,0,3067,378194,3013,368239,54,9955,3002,0,27028,865,0,19,144444.0,39000.0,-75.0,-77.0,-76.0,-76.0,-68.0,-74.0,-69.0,-72.0,-90.0,-92.0,-88.0,-91.0,15.0,15.0,12.0,15.0,0
293,CC:2F:71:3E:C5:1F,2631731,333136766,5123,626486,2626608,332510280,6,21991,1843772,18127,1385902,3864,457870,5405,29,7303,130,6,448,130000.0,39000.0,-69.0,-70.0,-68.0,-60.0,-66.0,-70.0,-65.0,-60.0,-90.0,-92.0,-88.0,-91.0,21.0,22.0,20.0,31.0,0
294,CC:2F:71:3F:1F:24,3304846,1251171646,678236,918661164,2626610,332510482,21,394662,418042520,390785,417575336,3877,467184,369133,581,680201,75933,21,4547,130000.0,43333.0,-71.0,-65.0,-74.0,-68.0,-71.0,-65.0,-74.0,-68.0,-90.0,-92.0,-88.0,-91.0,19.0,27.0,14.0,23.0,0
295,F8:59:71:5A:E0:3D,2653634,374068942,27019,41557996,2626615,332510946,0,3067,378194,3013,368239,54,9955,3002,0,27028,865,0,19,144444.0,39000.0,-75.0,-77.0,-76.0,-76.0,-68.0,-74.0,-69.0,-72.0,-90.0,-92.0,-88.0,-91.0,15.0,15.0,12.0,15.0,0
296,CC:2F:71:3E:C5:1F,2631738,333137432,5123,626486,2626615,332510946,6,21991,1843772,18127,1385902,3864,457870,5405,29,7303,130,6,448,130000.0,39000.0,-69.0,-70.0,-68.0,-60.0,-66.0,-70.0,-65.0,-60.0,-90.0,-92.0,-88.0,-91.0,21.0,22.0,20.0,31.0,0
297,CC:2F:71:3F:1F:24,3309026,1257716940,682411,925205994,2626615,332510946,21,395203,418109524,391326,417642340,3877,467184,369674,581,684483,76698,21,4547,130000.0,43333.0,-70.0,-65.0,-75.0,-69.0,-70.0,-65.0,-74.0,-69.0,-90.0,-92.0,-88.0,-91.0,20.0,27.0,13.0,22.0,0
298,F8:59:71:5A:E0:3D,2653638,374069346,27019,41557996,2626619,332511350,0,3067,378194,3013,368239,54,9955,3002,0,27028,865,0,19,144444.0,39000.0,-75.0,-77.0,-76.0,-76.0,-68.0,-74.0,-69.0,-72.0,-90.0,-92.0,-88.0,-91.0,15.0,15.0,12.0,15.0,0
299,CC:2F:71:3E:C5:1F,2631742,333137836,5123,626486,2626619,332511350,6,21991,1843772,18127,1385902,3864,457870,5405,29,7303,130,6,448,130000.0,39000.0,-69.0,-70.0,-68.0,-60.0,-66.0,-70.0,-65.0,-60.0,-90.0,-92.0,-88.0,-91.0,21.0,22.0,20.0,31.0,0
300,CC:2F:71:3F:1F:24,3314251,1265904672,687632,933393322,2626619,332511350,21,395793,418184032,391916,417716848,3877,467184,370264,581,689683,76852,21,4548,130000.0,43333.0,-72.0,-64.0,-72.0,-67.0,-72.0,-64.0,-72.0,-66.0,-90.0,-92.0,-88.0,-91.0,18.0,28.0,16.0,24.0,0
301,F8:59:71:5A:E0:3D,2653644,374069936,27019,41557996,2626625,332511940,0,3067,378194,3013,368239,54,9955,3002,0,27028,865,0,19,144444.0,39000.0,-75.0,-77.0,-76.0,-76.0,-68.0,-74.0,-69.0,-72.0,-90.0,-92.0,-88.0,-91.0,15.0,15.0,12.0,15.0,0
302,CC:2F:71:3E:C5:1F,2631750,333138628,5123,626486,2626627,332512142,6,21991,1843772,18127,1385902,3864,457870,5405,29,7303,130,6,448,130000.0,39000.0,-69.0,-70.0,-68.0,-60.0,-66.0,-70.0,-65.0,-60.0,-90.0,-92.0,-88.0,-91.0,21.0,22.0,20.0,31.0,0
303,CC:2F:71:3F:1F:24,3319191,1273589984,692564,941077842,2626627,332512142,21,396482,418270746,392605,417803562,3877,467184,370951,581,694641,78152,21,4548,115556.0,28889.0,-73.0,-64.0,-71.0,-66.0,-72.0,-64.0,-71.0,-66.0,-90.0,-92.0,-88.0,-91.0,17.0,28.0,17.0,25.0,0
304,F8:59:71:5A:E0:3D,2653650,374070542,27019,41557996,2626631,332512546,0,3069,378334,3015,368379,54,9955,3002,0,27029,865,0,19,144444.0,39000.0,-66.0,-72.0,-64.0,-71.0,-69.0,-75.0,-69.0,-73.0,-90.0,-92.0,-88.0,-91.0,24.0,20.0,24.0,20.0,0
305,CC:2F:71:3E:C5:1F,2631756,333139234,5123,626486,2626633,332512748,6,21993,1843912,18129,1386042,3864,457870,5405,29,7304,130,6,448,130000.0,39000.0,-68.0,-72.0,-69.0,-60.0,-66.0,-69.0,-66.0,-60.0,-90.0,-92.0,-88.0,-91.0,22.0,20.0,19.0,31.0,0
306,CC:2F:71:3F:1F:24,3325317,1283190039,698680,950676721,2626637,332513318,21,397255,418364795,393378,417897611,3877,467184,371724,581,700756,79602,21,4548,130000.0,39000.0,-83.0,-75.0,-82.0,-80.0,-79.0,-71.0,-79.0,-76.0,-90.0,-92.0,-88.0,-91.0,7.0,17.0,6.0,11.0,0
307,F8:59:71:5A:E0:3D,2653659,374071576,27019,41557996,2626640,332513580,0,3069,378334,3015,368379,54,9955,3002,0,27029,865,0,19,144444.0,39000.0,-66.0,-72.0,-64.0,-71.0,-69.0,-75.0,-69.0,-73.0,-90.0,-92.0,-88.0,-91.0,24.0,20.0,24.0,20.0,0
308,CC:2F:71:3E:C5:1F,2631763,333140066,5123,626486,2626640,332513580,6,21993,1843912,18129,1386042,3864,457870,5405,29,7304,130,6,448,130000.0,39000.0,-68.0,-72.0,-69.0,-60.0,-66.0,-69.0,-66.0,-60.0,-90.0,-92.0,-88.0,-91.0,22.0,20.0,19.0,31.0,0
309,CC:2F:71:3F:1F:24,3329500,1289704525,702860,957190945,2626640,332513580,21,397780,418430373,393903,417963189,3877,467184,372249,581,704851,80542,21,4548,130000.0,39000.0,-72.0,-65.0,-70.0,-66.0,-72.0,-65.0,-71.0,-66.0,-90.0,-92.0,-88.0,-91.0,18.0,27.0,18.0,25.0,0
310,F8:59:71:5A:E0:3D,2653665,374072182,27019,41557996,2626646,332514186,0,3069,378334,3015,368379,54,9955,3002,0,27029,865,0,19,144444.0,39000.0,-66.0,-72.0,-64.0,-71.0,-69.0,-75.0,-69.0,-73.0,-90.0,-92.0,-88.0,-91.0,24.0,20.0,24.0,20.0,0
311,CC:2F:71:3E:C5:1F,2631769,333140672,5123,626486,2626646,332514186,6,21993,1843912,18129,1386042,3864,457870,5405,29,7304,130,6,448,130000.0,39000.0,-68.0,-72.0,-69.0,-60.0,-66.0,-69.0,-66.0,-60.0,-90.0,-92.0,-88.0,-91.0,22.0,20.0,19.0,31.0,0
312,CC:2F:71:3F:1F:24,3333619,1296149491,706973,963635305,2626646,332514186,21,398150,418480095,394273,418012911,3877,467184,372619,581,709026,81152,21,4548,130000.0,43333.0,-74.0,-65.0,-71.0,-66.0,-73.0,-64.0,-71.0,-66.0,-90.0,-92.0,-88.0,-91.0,16.0,27.0,17.0,25.0,0
313,F8:59:71:5A:E0:3D,2653668,374072444,27019,41557996,2626649,332514448,0,3069,378334,3015,368379,54,9955,3002,0,27029,865,0,19,144444.0,39000.0,-66.0,-72.0,-64.0,-71.0,-69.0,-75.0,-69.0,-73.0,-90.0,-92.0,-88.0,-91.0,24.0,20.0,24.0,20.0,0
314,CC:2F:71:3E:C5:1F,2631772,333140934,5123,626486,2626649,332514448,6,21993,1843912,18129,1386042,3864,457870,5405,29,7304,130,6,448,130000.0,39000.0,-68.0,-72.0,-69.0,-60.0,-66.0,-69.0,-66.0,-60.0,-90.0,-92.0,-88.0,-91.0,22.0,20.0,19.0,31.0,0
315,CC:2F:71:3F:1F:24,3337550,1302297745,710901,969783297,2626649,332514448,21,398652,418541443,394775,418074259,3877,467184,373121,581,712978,83052,21,4548,130000.0,43333.0,-71.0,-65.0,-73.0,-67.0,-72.0,-65.0,-72.0,-67.0,-90.0,-92.0,-88.0,-91.0,19.0,27.0,15.0,24.0,0
316,F8:59:71:5A:E0:3D,2653676,374073252,27019,41557996,2626657,332515256,0,3069,378334,3015,368379,54,9955,3002,0,27029,865,0,19,144444.0,39000.0,-66.0,-72.0,-64.0,-71.0,-69.0,-75.0,-69.0,-73.0,-90.0,-92.0,-88.0,-91.0,24.0,20.0,24.0,20.0,0
317,CC:2F:71:3E:C5:1F,2631780,333141742,5123,626486,2626657,332515256,6,21993,1843912,18129,1386042,3864,457870,5405,29,7304,130,6,448,130000.0,39000.0,-68.0,-72.0,-69.0,-60.0,-66.0,-69.0,-66.0,-60.0,-90.0,-92.0,-88.0,-91.0,22.0,20.0,19.0,31.0,0
318,CC:2F:71:3F:1F:24,3341833,1308991439,715176,976476183,2626657,332515256,21,399336,418624711,395459,418157527,3877,467184,373805,581,717225,83358,21,4549,130000.0,43333.0,-74.0,-64.0,-74.0,-72.0,-73.0,-64.0,-73.0,-72.0,-90.0,-92.0,-88.0,-91.0,16.0,28.0,14.0,19.0,0
319,F8:59:71:5A:E0:3D,2653681,374073716,27019,41557996,2626662,332515720,0,3069,378334,3015,368379,54,9955,3002,0,27029,865,0,19,144444.0,39000.0,-66.0,-72.0,-64.0,-71.0,-69.0,-75.0,-69.0,-73.0,-90.0,-92.0,-89.0,-92.0,24.0,20.0,25.0,21.0,0
320,CC:2F:71:3E:C5:1F,2631787,333142408,5123,626486,2626664,332515922,6,21993,1843912,18129,1386042,3864,457870,5405,29,7304,130,6,448,130000.0,39000.0,-68.0,-72.0,-69.0,-60.0,-66.0,-69.0,-66.0,-60.0,-90.0,-92.0,-89.0,-92.0,22.0,20.0,20.0,32.0,0
321,CC:2F:71:3F:1F:24,3346850,1316846188,720185,984329993,2626665,332516195,21,399947,418701737,396070,418234553,3877,467184,374398,581,722231,83782,21,4552,130000.0,43333.0,-73.0,-64.0,-73.0,-70.0,-73.0,-63.0,-72.0,-69.0,-90.0,-92.0,-89.0,-92.0,17.0,28.0,16.0,22.0,0
322,F8:59:71:5A:E0:3D,2653686,374074393,27019,41557996,2626667,332516397,0,3069,378334,3015,368379,54,9955,3002,0,27029,865,0,19,144444.0,39000.0,-66.0,-72.0,-64.0,-71.0,-69.0,-75.0,-69.0,-73.0,-90.0,-92.0,-89.0,-92.0,24.0,20.0,25.0,21.0,0
323,CC:2F:71:3E:C5:1F,2631790,333142883,5123,626486,2626667,332516397,6,21993,1843912,18129,1386042,3864,457870,5405,29,7304,130,6,448,130000.0,39000.0,-68.0,-72.0,-69.0,-60.0,-66.0,-69.0,-66.0,-60.0,-90.0,-92.0,-89.0,-92.0,22.0,20.0,20.0,32.0,0
324,CC:2F:71:3F:1F:24,3351525,1324171664,724858,991655267,2626667,332516397,21,400513,418771963,396636,418304779,3877,467184,374964,581,726907,83879,21,4552,130000.0,43333.0,-79.0,-71.0,-80.0,-77.0,-79.0,-71.0,-79.0,-76.0,-90.0,-92.0,-89.0,-92.0,11.0,21.0,9.0,15.0,0
325,F8:59:71:5A:E0:3D,2653693,374075059,27019,41557996,2626674,332517063,0,3069,378334,3015,368379,54,9955,3002,0,27029,865,0,19,144444.0,39000.0,-66.0,-72.0,-64.0,-71.0,-69.0,-75.0,-69.0,-73.0,-90.0,-92.0,-89.0,-92.0,24.0,20.0,25.0,21.0,0
326,CC:2F:71:3E:C5:1F,2631797,333143549,5123,626486,2626674,332517063,6,21993,1843912,18129,1386042,3864,457870,5405,29,7304,130,6,448,130000.0,39000.0,-68.0,-72.0,-69.0,-60.0,-66.0,-69.0,-66.0,-60.0,-90.0,-92.0,-89.0,-92.0,22.0,20.0,20.0,32.0,0
327,CC:2F:71:3F:1F:24,3356572,1332079928,729896,999562663,2626676,332517265,21,401284,418867193,397407,418400009,3877,467184,375729,581,731973,84637,21,4553,115556.0,28889.0,-73.0,-65.0,-74.0,-69.0,-72.0,-65.0,-74.0,-69.0,-90.0,-92.0,-89.0,-92.0,17.0,27.0,15.0,23.0,0
328,F8:59:71:5A:E0:3D,2653695,374075261,27019,41557996,2626676,332517265,0,3069,378334,3015,368379,54,9955,3002,0,27029,865,0,19,144444.0,39000.0,-66.0,-72.0,-64.0,-71.0,-69.0,-75.0,-69.0,-73.0,-90.0,-92.0,-89.0,-92.0,24.0,20.0,25.0,21.0,0
329,CC:2F:71:3E:C5:1F,2631803,333144155,5123,626486,2626680,332517669,6,21993,1843912,18129,1386042,3864,457870,5405,29,7304,130,6,448,130000.0,39000.0,-68.0,-72.0,-69.0,-60.0,-66.0,-69.0,-66.0,-60.0,-90.0,-92.0,-89.0,-92.0,22.0,20.0,20.0,32.0,0
330,CC:2F:71:3F:1F:24,3361508,1339820884,734828,1007303215,2626680,332517669,21,401874,418940357,397997,418473173,3877,467184,376319,581,736905,84895,21,4553,117000.0,39000.0,-73.0,-65.0,-75.0,-69.0,-72.0,-65.0,-74.0,-68.0,-90.0,-92.0,-89.0,-92.0,17.0,27.0,14.0,23.0,0
331,F8:59:71:5A:E0:3D,2653703,374076069,27019,41557996,2626684,332518073,0,3069,378334,3015,368379,54,9955,3002,0,27029,865,0,19,144444.0,39000.0,-66.0,-72.0,-64.0,-71.0,-69.0,-75.0,-69.0,-73.0,-90.0,-92.0,-89.0,-92.0,24.0,20.0,25.0,21.0,0
332,CC:2F:71:3E:C5:1F,2631807,333144559,5123,626486,2626684,332518073,6,21993,1843912,18129,1386042,3864,457870,5405,29,7304,130,6,448,130000.0,39000.0,-68.0,-72.0,-69.0,-60.0,-66.0,-69.0,-66.0,-60.0,-90.0,-92.0,-89.0,-92.0,22.0,20.0,20.0,32.0,0
333,CC:2F:71:3F:1F:24,3366794,1348085750,740109,1015567617,2626685,332518133,21,402707,419041027,398830,418573843,3877,467184,377152,581,742176,85300,21,4553,130000.0,43333.0,-72.0,-66.0,-75.0,-71.0,-72.0,-65.0,-74.0,-70.0,-90.0,-93.0,-89.0,-92.0,18.0,27.0,14.0,21.0,0
334,F8:59:71:5A:E0:3D,2653706,374076331,27019,41557996,2626687,332518335,0,3069,378334,3015,368379,54,9955,3002,0,27029,865,0,19,144444.0,39000.0,-66.0,-72.0,-64.0,-71.0,-69.0,-75.0,-69.0,-73.0,-90.0,-93.0,-89.0,-92.0,24.0,21.0,25.0,21.0,0
335,CC:2F:71:3E:C5:1F,2631812,333145023,5123,626486,2626689,332518537,6,21993,1843912,18129,1386042,3864,457870,5405,29,7304,130,6,448,130000.0,39000.0,-68.0,-72.0,-69.0,-60.0,-66.0,-69.0,-66.0,-60.0,-90.0,-93.0,-89.0,-92.0,22.0,21.0,20.0,32.0,0
336,CC:2F:71:3F:1F:24,3370709,1354200254,744018,1021681507,2626691,332518747,21,403119,419094535,399242,418627351,3877,467184,377564,581,746079,85477,21,4554,130000.0,43333.0,-72.0,-65.0,-74.0,-71.0,-71.0,-64.0,-73.0,-70.0,-90.0,-93.0,-89.0,-92.0,18.0,28.0,15.0,21.0,0
337,F8:59:71:5A:E0:3D,2653717,374078367,27022,41559216,2626695,332519151,0,3076,379244,3020,368967,56,10277,3007,0,27032,865,0,20,144444.0,39000.0,-67.0,-71.0,-64.0,-71.0,-67.0,-72.0,-65.0,-71.0,-90.0,-93.0,-89.0,-92.0,23.0,22.0,25.0,21.0,0
338,CC:2F:71:3E:C5:1F,2631818,333145637,5123,626486,2626695,332519151,6,21993,1843912,18129,1386042,3864,457870,5405,29,7304,130,6,448,130000.0,39000.0,-68.0,-72.0,-69.0,-60.0,-66.0,-69.0,-66.0,-60.0,-90.0,-93.0,-89.0,-92.0,22.0,21.0,20.0,32.0,0
339,CC:2F:71:3F:1F:24,3375569,1361787341,748874,1029268190,2626695,332519151,21,403784,419177906,399907,418710722,3877,467184,378221,581,750951,85847,21,4554,130000.0,43333.0,-72.0,-66.0,-75.0,-71.0,-72.0,-66.0,-74.0,-70.0,-90.0,-93.0,-89.0,-92.0,18.0,27.0,14.0,21.0,0
340,F8:59:71:5A:E0:3D,2653724,374079041,27022,41559216,2626702,332519825,0,3079,379636,3021,369037,58,10599,3009,0,27032,865,0,21,144444.0,39000.0,-67.0,-71.0,-64.0,-70.0,-67.0,-70.0,-64.0,-70.0,-90.0,-93.0,-89.0,-92.0,23.0,22.0,25.0,22.0,0
341,CC:2F:71:3E:C5:1F,2631826,333146379,5123,626486,2626703,332519893,6,21993,1843912,18129,1386042,3864,457870,5405,29,7304,130,6,448,130000.0,39000.0,-68.0,-72.0,-69.0,-60.0,-66.0,-69.0,-66.0,-60.0,-90.0,-93.0,-89.0,-92.0,22.0,21.0,20.0,32.0,0
342,CC:2F:71:3F:1F:24,3380580,1369619621,753876,1037099594,2626704,332520027,21,404417,419257572,400540,418790388,3877,467184,378854,581,755826,85969,21,4555,130000.0,43333.0,-72.0,-65.0,-74.0,-70.0,-71.0,-65.0,-73.0,-70.0,-90.0,-93.0,-89.0,-92.0,18.0,28.0,15.0,22.0,0
343,F8:59:71:5A:E0:3D,2653728,374079445,27022,41559216,2626706,332520229,0,3079,379636,3021,369037,58,10599,3009,0,27032,865,0,21,144444.0,39000.0,-67.0,-71.0,-64.0,-70.0,-67.0,-70.0,-64.0,-70.0,-90.0,-93.0,-89.0,-92.0,23.0,22.0,25.0,22.0,0
344,CC:2F:71:3E:C5:1F,2631829,333146715,5123,626486,2626706,332520229,6,21993,1843912,18129,1386042,3864,457870,5405,29,7304,130,6,448,130000.0,39000.0,-68.0,-72.0,-69.0,-60.0,-66.0,-69.0,-66.0,-60.0,-90.0,-93.0,-89.0,-92.0,22.0,21.0,20.0,32.0,0
345,CC:2F:71:3F:1F:24,3385641,1377523633,758935,1045003404,2626706,332520229,21,405057,419336998,401180,418869814,3877,467184,379494,581,760981,86111,21,4555,130000.0,43333.0,-72.0,-65.0,-74.0,-70.0,-72.0,-65.0,-73.0,-70.0,-90.0,-93.0,-89.0,-92.0,18.0,28.0,15.0,22.0,0
346,F8:59:71:5A:E0:3D,2653738,374080437,27023,41559332,2626715,332521105,0,3084,380168,3024,369247,60,10921,3011,0,27033,865,0,21,144444.0,39000.0,-73.0,-79.0,-77.0,-75.0,-67.0,-72.0,-65.0,-71.0,-90.0,-93.0,-89.0,-92.0,17.0,14.0,12.0,17.0,0
347,CC:2F:71:3E:C5:1F,2631841,333147909,5124,626602,2626717,332521307,6,21995,1844052,18131,1386182,3864,457870,5405,29,7305,130,6,448,130000.0,39000.0,-69.0,-71.0,-69.0,-60.0,-68.0,-72.0,-67.0,-61.0,-90.0,-93.0,-89.0,-92.0,21.0,22.0,20.0,32.0,0
348,CC:2F:71:3F:1F:24,3390883,1385713271,764166,1053191964,2626717,332521307,21,405709,419417665,401832,418950481,3877,467184,380146,581,766243,86189,21,4555,130000.0,43333.0,-72.0,-64.0,-74.0,-70.0,-71.0,-64.0,-73.0,-70.0,-90.0,-93.0,-89.0,-92.0,18.0,29.0,15.0,22.0,0
349,F8:59:71:5A:E0:3D,2653740,374080639,27023,41559332,2626717,332521307,0,3084,380168,3024,369247,60,10921,3011,0,27033,865,0,21,144444.0,39000.0,-73.0,-79.0,-77.0,-75.0,-67.0,-72.0,-65.0,-71.0,-90.0,-92.0,-89.0,-92.0,17.0,13.0,12.0,17.0,0
350,CC:2F:71:3E:C5:1F,2631841,333147909,5124,626602,2626717,332521307,6,21995,1844052,18131,1386182,3864,457870,5405,29,7305,130,6,448,130000.0,39000.0,-69.0,-71.0,-69.0,-60.0,-68.0,-72.0,-67.0,-61.0,-90.0,-92.0,-89.0,-92.0,21.0,21.0,20.0,32.0,0
351,CC:2F:71:3F:1F:24,3396030,1393769413,769311,1061247904,2626719,332521509,21,406276,419487697,402399,419020513,3877,467184,380700,581,771355,86348,21,4555,144444.0,43333.0,-72.0,-65.0,-74.0,-70.0,-72.0,-64.0,-73.0,-70.0,-90.0,-92.0,-89.0,-92.0,18.0,27.0,15.0,22.0,0
352,F8:59:71:5A:E0:3D,2653750,374081679,27025,41559564,2626725,332522115,0,3086,380380,3026,369459,60,10921,3013,0,27035,865,0,21,144444.0,39000.0,-67.0,-69.0,-65.0,-70.0,-67.0,-71.0,-66.0,-71.0,-90.0,-92.0,-89.0,-92.0,23.0,23.0,24.0,22.0,0
353,CC:2F:71:3E:C5:1F,2631850,333148777,5124,626602,2626726,332522175,6,21995,1844052,18131,1386182,3864,457870,5405,29,7305,130,6,448,130000.0,39000.0,-69.0,-71.0,-69.0,-60.0,-68.0,-72.0,-67.0,-61.0,-90.0,-92.0,-89.0,-92.0,21.0,21.0,20.0,32.0,0
354,CC:2F:71:3F:1F:24,3399918,1399831007,773192,1067308832,2626726,332522175,21,406693,419540458,402816,419073274,3877,467184,381117,581,775269,86649,21,4555,130000.0,43333.0,-72.0,-65.0,-74.0,-69.0,-72.0,-65.0,-74.0,-69.0,-90.0,-92.0,-89.0,-92.0,18.0,27.0,15.0,23.0,0
355,F8:59:71:5A:E0:3D,2653756,374082416,27025,41559564,2626731,332522852,0,3087,380450,3027,369529,60,10921,3013,0,27035,865,0,21,144444.0,39000.0,-67.0,-71.0,-65.0,-71.0,-67.0,-71.0,-66.0,-71.0,-90.0,-92.0,-89.0,-92.0,23.0,21.0,24.0,21.0,0
356,CC:2F:71:3E:C5:1F,2631855,333149454,5124,626602,2626731,332522852,6,21995,1844052,18131,1386182,3864,457870,5405,29,7305,130,6,448,130000.0,39000.0,-69.0,-71.0,-69.0,-60.0,-68.0,-72.0,-67.0,-61.0,-90.0,-92.0,-89.0,-92.0,21.0,21.0,20.0,32.0,0
357,CC:2F:71:3F:1F:24,3404849,1407553424,778118,1075030572,2626731,332522852,21,407376,419627340,403499,419160156,3877,467184,381749,581,780195,86792,21,4556,130000.0,39000.0,-71.0,-65.0,-74.0,-69.0,-71.0,-64.0,-73.0,-69.0,-90.0,-92.0,-89.0,-92.0,19.0,27.0,15.0,23.0,0
358,F8:59:71:5A:E0:3D,2653761,374082882,27025,41559564,2626736,332523318,0,3089,380638,3028,369599,61,11039,3014,0,27035,865,0,21,144444.0,39000.0,-67.0,-72.0,-64.0,-70.0,-67.0,-71.0,-66.0,-71.0,-90.0,-92.0,-89.0,-92.0,23.0,20.0,25.0,22.0,0
359,CC:2F:71:3E:C5:1F,2631860,333149920,5124,626602,2626736,332523318,6,21995,1844052,18131,1386182,3864,457870,5405,29,7305,130,6,448,130000.0,39000.0,-69.0,-71.0,-69.0,-60.0,-68.0,-72.0,-67.0,-61.0,-90.0,-92.0,-89.0,-92.0,21.0,21.0,20.0,32.0,0
360,CC:2F:71:3F:1F:24,3409934,1415516568,783196,1082993040,2626738,332523528,21,407910,419694844,404033,419227660,3877,467184,382283,581,785260,87224,21,4557,130000.0,43333.0,-73.0,-66.0,-74.0,-70.0,-72.0,-65.0,-74.0,-69.0,-90.0,-92.0,-89.0,-92.0,17.0,26.0,15.0,22.0,0
361,F8:59:71:5A:E0:3D,2653770,374083680,27025,41559564,2626745,332524116,0,3092,381030,3029,369669,63,11361,3016,0,27035,865,0,21,144444.0,39000.0,-66.0,-71.0,-64.0,-70.0,-66.0,-70.0,-64.0,-70.0,-90.0,-92.0,-89.0,-92.0,24.0,21.0,25.0,22.0,0
362,CC:2F:71:3E:C5:1F,2631869,333150718,5124,626602,2626745,332524116,6,21997,1844240,18132,1386252,3865,457988,5406,29,7305,130,6,448,130000.0,39000.0,-69.0,-71.0,-68.0,-60.0,-69.0,-72.0,-68.0,-61.0,-90.0,-92.0,-89.0,-92.0,21.0,21.0,21.0,32.0,0
363,CC:2F:71:3F:1F:24,3415094,1423591290,788349,1091067174,2626745,332524116,21,408620,419781997,404742,419314695,3878,467302,382984,581,790305,87359,21,4558,130000.0,43333.0,-72.0,-65.0,-73.0,-69.0,-71.0,-65.0,-73.0,-68.0,-90.0,-92.0,-89.0,-92.0,18.0,27.0,16.0,23.0,0
364,F8:59:71:5A:E0:3D,2653774,374084084,27025,41559564,2626749,332524520,0,3092,381030,3029,369669,63,11361,3016,0,27035,865,0,21,144444.0,39000.0,-66.0,-71.0,-64.0,-70.0,-66.0,-70.0,-64.0,-70.0,-90.0,-92.0,-89.0,-92.0,24.0,21.0,25.0,22.0,0
365,CC:2F:71:3E:C5:1F,2631873,333151122,5124,626602,2626749,332524520,6,21997,1844240,18132,1386252,3865,457988,5406,29,7305,130,6,448,130000.0,39000.0,-69.0,-71.0,-68.0,-60.0,-69.0,-72.0,-68.0,-61.0,-90.0,-92.0,-89.0,-92.0,21.0,21.0,21.0,32.0,0
366,CC:2F:71:3F:1F:24,3420393,1431893803,793644,1099369283,2626749,332524520,21,409216,419855302,405338,419388000,3878,467302,383580,581,795721,87717,21,4558,130000.0,43333.0,-72.0,-65.0,-74.0,-69.0,-71.0,-65.0,-74.0,-69.0,-90.0,-92.0,-89.0,-92.0,18.0,27.0,15.0,23.0,0
367,F8:59:71:5A:E0:3D,2653779,374084548,27025,41559564,2626754,332524984,0,3092,381030,3029,369669,63,11361,3016,0,27035,865,0,21,144444.0,39000.0,-66.0,-71.0,-64.0,-70.0,-66.0,-70.0,-64.0,-70.0,-90.0,-92.0,-89.0,-92.0,24.0,21.0,25.0,22.0,0
368,CC:2F:71:3E:C5:1F,2631882,333151990,5124,626602,2626758,332525388,6,21997,1844240,18132,1386252,3865,457988,5406,29,7305,130,6,448,130000.0,39000.0,-69.0,-71.0,-68.0,-60.0,-69.0,-72.0,-68.0,-61.0,-90.0,-92.0,-89.0,-92.0,21.0,21.0,21.0,32.0,0
369,CC:2F:71:3F:1F:24,3425867,1440468273,799109,1107942885,2626758,332525388,21,409833,419932058,405955,419464756,3878,467302,384197,581,801155,87811,21,4558,130000.0,43333.0,-72.0,-66.0,-75.0,-70.0,-72.0,-65.0,-74.0,-69.0,-90.0,-92.0,-89.0,-92.0,18.0,26.0,14.0,22.0,0
370,F8:59:71:5A:E0:3D,2653783,374084952,27025,41559564,2626758,332525388,0,3092,381030,3029,369669,63,11361,3016,0,27035,865,0,21,144444.0,39000.0,-66.0,-71.0,-64.0,-70.0,-66.0,-70.0,-64.0,-70.0,-90.0,-93.0,-89.0,-92.0,24.0,22.0,25.0,22.0,0
371,CC:2F:71:3E:C5:1F,2631882,333151990,5124,626602,2626758,332525388,6,21997,1844240,18132,1386252,3865,457988,5406,29,7305,130,6,448,130000.0,39000.0,-69.0,-71.0,-68.0,-60.0,-69.0,-72.0,-68.0,-61.0,-90.0,-93.0,-89.0,-92.0,21.0,22.0,21.0,32.0,0
372,CC:2F:71:3F:1F:24,3429832,1446668859,803074,1114143471,2626758,332525388,21,410342,419996318,406464,419529016,3878,467302,384706,581,805132,87883,21,4558,130000.0,43333.0,-72.0,-65.0,-74.0,-69.0,-72.0,-65.0,-74.0,-69.0,-90.0,-93.0,-89.0,-92.0,18.0,28.0,15.0,23.0,0
373,F8:59:71:5A:E0:3D,2653789,374085558,27025,41559564,2626764,332525994,0,3092,381030,3029,369669,63,11361,3016,0,27035,865,0,21,144444.0,39000.0,-66.0,-71.0,-64.0,-70.0,-66.0,-70.0,-64.0,-70.0,-90.0,-93.0,-89.0,-92.0,24.0,22.0,25.0,22.0,0
374,CC:2F:71:3E:C5:1F,2631890,333152798,5124,626602,2626766,332526196,6,21997,1844240,18132,1386252,3865,457988,5406,29,7305,130,6,448,130000.0,39000.0,-69.0,-71.0,-68.0,-60.0,-69.0,-72.0,-68.0,-61.0,-90.0,-93.0,-89.0,-92.0,21.0,22.0,21.0,32.0,0
375,CC:2F:71:3F:1F:24,3434664,1454231893,807897,1121705637,2626767,332526256,21,410974,420074057,407096,419606755,3878,467302,385338,581,809974,88038,21,4559,130000.0,43333.0,-72.0,-65.0,-73.0,-69.0,-72.0,-65.0,-74.0,-69.0,-90.0,-93.0,-89.0,-92.0,18.0,28.0,16.0,23.0,0
376,F8:59:71:5A:E0:3D,2653803,374087576,27036,41561320,2626767,332526256,0,3104,382727,3041,371366,63,11361,3027,0,27046,865,0,21,144444.0,43333.0,-67.0,-71.0,-64.0,-70.0,-67.0,-71.0,-64.0,-70.0,-90.0,-93.0,-89.0,-92.0,23.0,22.0,25.0,22.0,0
377,CC:2F:71:3E:C5:1F,2631893,333153060,5124,626602,2626769,332526458,6,21997,1844240,18132,1386252,3865,457988,5406,29,7305,130,6,448,130000.0,39000.0,-69.0,-71.0,-68.0,-60.0,-69.0,-72.0,-68.0,-61.0,-90.0,-93.0,-89.0,-92.0,21.0,22.0,21.0,32.0,0
378,CC:2F:71:3F:1F:24,3439361,1461591349,812592,1129064891,2626769,332526458,21,411552,420147845,407674,419680543,3878,467302,385911,581,814613,88681,21,4562,130000.0,43333.0,-72.0,-65.0,-74.0,-69.0,-71.0,-65.0,-73.0,-69.0,-90.0,-93.0,-89.0,-92.0,18.0,28.0,15.0,23.0,0
379,F8:59:71:5A:E0:3D,2653812,374088538,27037,41561474,2626775,332527064,0,3106,382937,3043,371576,63,11361,3028,0,27047,865,0,21,144444.0,43333.0,-67.0,-72.0,-64.0,-70.0,-67.0,-71.0,-64.0,-70.0,-90.0,-93.0,-89.0,-92.0,23.0,21.0,25.0,22.0,0
380,CC:2F:71:3E:C5:1F,2631899,333153666,5124,626602,2626775,332527064,6,21997,1844240,18132,1386252,3865,457988,5406,29,7305,130,6,448,130000.0,39000.0,-69.0,-71.0,-68.0,-60.0,-69.0,-72.0,-68.0,-61.0,-90.0,-93.0,-89.0,-92.0,21.0,22.0,21.0,32.0,0
381,CC:2F:71:3F:1F:24,3443396,1467903003,816621,1135375939,2626775,332527064,21,411944,420199947,408066,419732645,3878,467302,386303,581,818698,88867,21,4563,130000.0,43333.0,-72.0,-65.0,-73.0,-69.0,-71.0,-65.0,-73.0,-69.0,-90.0,-93.0,-89.0,-92.0,18.0,28.0,16.0,23.0,0
382,F8:59:71:5A:E0:3D,2653816,374088934,27037,41561474,2626779,332527460,0,3106,382937,3043,371576,63,11361,3028,0,27047,865,0,21,144444.0,43333.0,-67.0,-72.0,-64.0,-70.0,-67.0,-71.0,-64.0,-70.0,-90.0,-93.0,-90.0,-93.0,23.0,21.0,26.0,23.0,0
383,CC:2F:71:3E:C5:1F,2631904,333154130,5124,626602,2626780,332527528,6,21997,1844240,18132,1386252,3865,457988,5406,29,7305,130,6,448,130000.0,39000.0,-69.0,-71.0,-68.0,-60.0,-69.0,-72.0,-68.0,-61.0,-90.0,-93.0,-90.0,-93.0,21.0,22.0,22.0,33.0,0
384,CC:2F:71:3F:1F:24,3448444,1475811769,821664,1143284241,2626780,332527528,21,412550,420276919,408672,419809617,3878,467302,386906,581,823703,89182,21,4563,130000.0,43333.0,-71.0,-64.0,-74.0,-69.0,-71.0,-64.0,-73.0,-69.0,-90.0,-93.0,-90.0,-93.0,19.0,29.0,16.0,24.0,0
385,F8:59:71:5A:E0:3D,2653821,374089406,27037,41561474,2626784,332527932,0,3106,382937,3043,371576,63,11361,3028,0,27047,865,0,21,144444.0,43333.0,-67.0,-72.0,-64.0,-70.0,-67.0,-71.0,-64.0,-70.0,-90.0,-93.0,-90.0,-93.0,23.0,21.0,26.0,23.0,0
386,CC:2F:71:3E:C5:1F,2631908,333154534,5124,626602,2626784,332527932,6,21997,1844240,18132,1386252,3865,457988,5406,29,7305,130,6,448,130000.0,39000.0,-69.0,-71.0,-68.0,-60.0,-69.0,-72.0,-68.0,-61.0,-90.0,-93.0,-90.0,-93.0,21.0,22.0,22.0,33.0,0
387,CC:2F:71:3F:1F:24,3452433,1482048887,825649,1149520955,2626784,332527932,21,412958,420330575,409080,419863273,3878,467302,387314,581,827693,89323,21,4566,130000.0,43333.0,-72.0,-65.0,-74.0,-70.0,-71.0,-65.0,-73.0,-69.0,-90.0,-93.0,-90.0,-93.0,18.0,28.0,16.0,23.0,0
388,F8:59:71:5A:E0:3D,2653828,374090080,27037,41561474,2626791,332528606,0,3109,383329,3044,371646,65,11683,3030,0,27047,865,0,21,144444.0,43333.0,-67.0,-70.0,-65.0,-72.0,-67.0,-71.0,-64.0,-70.0,-90.0,-93.0,-90.0,-93.0,23.0,23.0,25.0,21.0,0
389,CC:2F:71:3E:C5:1F,2631915,333155208,5124,626602,2626791,332528606,6,21997,1844240,18132,1386252,3865,457988,5406,29,7305,130,6,448,130000.0,39000.0,-69.0,-71.0,-68.0,-60.0,-69.0,-72.0,-68.0,-61.0,-90.0,-93.0,-90.0,-93.0,21.0,22.0,22.0,33.0,0
390,CC:2F:71:3F:1F:24,3457307,1489671997,830514,1157143189,2626793,332528808,21,413583,420408973,409705,419941671,3878,467302,387926,581,832591,89556,21,4566,130000.0,43333.0,-73.0,-65.0,-73.0,-67.0,-72.0,-65.0,-73.0,-67.0,-90.0,-93.0,-90.0,-93.0,17.0,28.0,17.0,26.0,0
391,F8:59:71:5A:E0:3D,2653833,374090757,27037,41561474,2626796,332529283,0,3109,383329,3044,371646,65,11683,3030,0,27047,865,0,21,144444.0,43333.0,-67.0,-70.0,-65.0,-72.0,-67.0,-71.0,-64.0,-70.0,-90.0,-93.0,-90.0,-93.0,23.0,23.0,25.0,21.0,0
392,CC:2F:71:3E:C5:1F,2631920,333155885,5124,626602,2626796,332529283,6,21997,1844240,18132,1386252,3865,457988,5406,29,7305,130,6,448,130000.0,39000.0,-69.0,-71.0,-68.0,-60.0,-69.0,-72.0,-68.0,-61.0,-90.0,-93.0,-90.0,-93.0,21.0,22.0,22.0,33.0,0
393,CC:2F:71:3F:1F:24,3462308,1497511948,835512,1164982665,2626796,332529283,21,414283,420497341,410405,420030039,3878,467302,388626,581,837589,89876,21,4566,130000.0,43333.0,-72.0,-65.0,-73.0,-67.0,-72.0,-65.0,-73.0,-67.0,-90.0,-93.0,-90.0,-93.0,18.0,28.0,17.0,26.0,0
394,F8:59:71:5A:E0:3D,2653839,374091363,27037,41561474,2626802,332529889,0,3109,383329,3044,371646,65,11683,3030,0,27047,865,0,21,144444.0,43333.0,-67.0,-70.0,-65.0,-72.0,-67.0,-71.0,-64.0,-70.0,-90.0,-93.0,-90.0,-93.0,23.0,23.0,25.0,21.0,0
395,CC:2F:71:3E:C5:1F,2631929,333156753,5124,626602,2626805,332530151,6,21997,1844240,18132,1386252,3865,457988,5406,29,7305,130,6,448,130000.0,39000.0,-69.0,-71.0,-68.0,-60.0,-69.0,-72.0,-68.0,-61.0,-90.0,-93.0,-90.0,-93.0,21.0,22.0,22.0,33.0,0
396,CC:2F:71:3F:1F:24,3467290,1505284225,840485,1172754074,2626805,332530151,21,414933,420586103,411055,420118801,3878,467302,389227,581,842551,90323,21,4566,130000.0,39000.0,-72.0,-65.0,-73.0,-67.0,-72.0,-65.0,-72.0,-67.0,-90.0,-93.0,-90.0,-93.0,18.0,28.0,17.0,26.0,0
397,F8:59:71:5A:E0:3D,2653842,374091625,27037,41561474,2626805,332530151,0,3109,383329,3044,371646,65,11683,3030,0,27047,865,0,21,144444.0,43333.0,-67.0,-70.0,-65.0,-72.0,-67.0,-71.0,-64.0,-70.0,-90.0,-93.0,-90.0,-93.0,23.0,23.0,25.0,21.0,0
398,CC:2F:71:3E:C5:1F,2631931,333156955,5124,626602,2626807,332530353,6,21997,1844240,18132,1386252,3865,457988,5406,29,7305,130,6,448,130000.0,39000.0,-69.0,-71.0,-68.0,-60.0,-69.0,-72.0,-68.0,-61.0,-90.0,-93.0,-90.0,-93.0,21.0,22.0,22.0,33.0,0
399,CC:2F:71:3F:1F:24,3470897,1510921861,844090,1178391508,2626807,332530353,21,415409,420647688,411531,420180386,3878,467302,389703,581,846167,90513,21,4568,130000.0,43333.0,-72.0,-65.0,-73.0,-67.0,-72.0,-65.0,-72.0,-67.0,-90.0,-93.0,-90.0,-93.0,18.0,28.0,17.0,26.0,0
400,F8:59:71:5A:E0:3D,2653850,374092433,27037,41561474,2626813,332530959,0,3109,383329,3044,371646,65,11683,3030,0,27047,865,0,21,144444.0,43333.0,-67.0,-70.0,-65.0,-72.0,-67.0,-71.0,-64.0,-70.0,-90.0,-93.0,-90.0,-93.0,23.0,23.0,25.0,21.0,0
401,CC:2F:71:3E:C5:1F,2631937,333157561,5124,626602,2626813,332530959,6,21997,1844240,18132,1386252,3865,457988,5406,29,7305,130,6,448,130000.0,39000.0,-69.0,-71.0,-68.0,-60.0,-69.0,-72.0,-68.0,-61.0,-90.0,-93.0,-90.0,-93.0,21.0,22.0,22.0,33.0,0
402,CC:2F:71:3F:1F:24,3474140,1515987013,847327,1183456054,2626813,332530959,21,415791,420695842,411913,420228540,3878,467302,390085,581,849390,90555,21,4570,130000.0,43333.0,-72.0,-65.0,-73.0,-67.0,-72.0,-65.0,-72.0,-67.0,-90.0,-93.0,-90.0,-93.0,18.0,28.0,17.0,26.0,0
403,F8:59:71:5A:E0:3D,2653851,374092493,27037,41561474,2626814,332531019,0,3109,383329,3044,371646,65,11683,3030,0,27047,865,0,21,144444.0,43333.0,-67.0,-70.0,-65.0,-72.0,-67.0,-71.0,-64.0,-70.0,-90.0,-93.0,-90.0,-93.0,23.0,23.0,25.0,21.0,0
404,CC:2F:71:3E:C5:1F,2631938,333157621,5124,626602,2626814,332531019,6,21997,1844240,18132,1386252,3865,457988,5406,29,7305,130,6,448,130000.0,39000.0,-69.0,-71.0,-68.0,-60.0,-69.0,-72.0,-68.0,-61.0,-90.0,-93.0,-90.0,-93.0,21.0,22.0,22.0,33.0,0
405,CC:2F:71:3F:1F:24,3479255,1523985003,852439,1191453782,2626816,332531221,21,416553,420790605,412675,420323303,3878,467302,390847,581,854485,90844,21,4571,130000.0,43333.0,-72.0,-65.0,-73.0,-67.0,-72.0,-65.0,-72.0,-67.0,-90.0,-93.0,-90.0,-93.0,18.0,28.0,17.0,26.0,0
406,F8:59:71:5A:E0:3D,2653859,374093301,27037,41561474,2626822,332531827,0,3109,383329,3044,371646,65,11683,3030,0,27047,865,0,21,144444.0,43333.0,-67.0,-70.0,-65.0,-72.0,-67.0,-71.0,-64.0,-70.0,-90.0,-93.0,-90.0,-93.0,23.0,23.0,25.0,21.0,0
407,CC:2F:71:3E:C5:1F,2631946,333158429,5124,626602,2626822,332531827,6,21997,1844240,18132,1386252,3865,457988,5406,29,7305,130,6,448,130000.0,39000.0,-69.0,-71.0,-68.0,-60.0,-69.0,-72.0,-68.0,-61.0,-90.0,-93.0,-90.0,-93.0,21.0,22.0,22.0,33.0,0
408,CC:2F:71:3F:1F:24,3484337,1531939637,857514,1199407740,2626823,332531897,21,417132,420864627,413254,420397325,3878,467302,391426,581,859591,91704,21,4572,130000.0,39000.0,-73.0,-65.0,-74.0,-68.0,-78.0,-70.0,-78.0,-73.0,-90.0,-93.0,-90.0,-93.0,17.0,28.0,16.0,25.0,0
409,F8:59:71:5A:E0:3D,2653867,374094203,27037,41561474,2626830,332532729,0,3111,383525,3045,371716,66,11809,3031,0,27047,865,0,21,144444.0,43333.0,-73.0,-79.0,-76.0,-76.0,-67.0,-71.0,-65.0,-71.0,-90.0,-93.0,-90.0,-93.0,17.0,14.0,14.0,17.0,0
410,CC:2F:71:3E:C5:1F,2631956,333159533,5124,626602,2626832,332532931,6,21997,1844240,18132,1386252,3865,457988,5406,29,7305,130,6,448,130000.0,39000.0,-69.0,-71.0,-68.0,-60.0,-69.0,-72.0,-68.0,-61.0,-90.0,-93.0,-90.0,-93.0,21.0,22.0,22.0,33.0,0
411,CC:2F:71:3F:1F:24,3488245,1538048477,861413,1205515546,2626832,332532931,21,417541,420916475,413663,420449173,3878,467302,391835,581,863490,91844,21,4572,130000.0,43333.0,-73.0,-65.0,-74.0,-67.0,-73.0,-65.0,-74.0,-67.0,-90.0,-93.0,-90.0,-93.0,17.0,28.0,16.0,26.0,0
412,F8:59:71:5A:E0:3D,2653871,374094607,27037,41561474,2626834,332533133,0,3111,383525,3045,371716,66,11809,3031,0,27047,865,0,21,144444.0,43333.0,-73.0,-79.0,-76.0,-76.0,-67.0,-71.0,-65.0,-71.0,-90.0,-93.0,-90.0,-93.0,17.0,14.0,14.0,17.0,0
413,CC:2F:71:3E:C5:1F,2631958,333159735,5124,626602,2626834,332533133,6,21997,1844240,18132,1386252,3865,457988,5406,29,7305,130,6,448,130000.0,39000.0,-69.0,-71.0,-68.0,-60.0,-69.0,-72.0,-68.0,-61.0,-90.0,-93.0,-90.0,-93.0,21.0,22.0,22.0,33.0,0
414,CC:2F:71:3F:1F:24,3493870,1546877173,867036,1214344040,2626834,332533133,21,418286,421008178,414408,420540876,3878,467302,392580,581,869067,92051,21,4572,130000.0,43333.0,-73.0,-65.0,-73.0,-67.0,-72.0,-65.0,-73.0,-67.0,-90.0,-93.0,-90.0,-93.0,17.0,28.0,17.0,26.0,0
415,F8:59:71:5A:E0:3D,2653881,374095591,27038,41561590,2626843,332534001,0,3112,383595,3046,371786,66,11809,3031,0,27048,865,0,21,144444.0,43333.0,-67.0,-71.0,-65.0,-71.0,-67.0,-71.0,-66.0,-71.0,-90.0,-93.0,-89.0,-92.0,23.0,22.0,24.0,21.0,0
416,CC:2F:71:3E:C5:1F,2631968,333160719,5125,626718,2626843,332534001,6,21999,1844380,18134,1386392,3865,457988,5406,29,7306,130,6,448,144444.0,39000.0,-69.0,-70.0,-68.0,-60.0,-68.0,-72.0,-68.0,-61.0,-90.0,-93.0,-89.0,-92.0,21.0,23.0,21.0,32.0,0
417,CC:2F:71:3F:1F:24,3498202,1553653881,871359,1221119880,2626843,332534001,21,418722,421064500,414844,420597198,3878,467302,393012,581,873402,92135,21,4572,130000.0,43333.0,-71.0,-64.0,-74.0,-70.0,-71.0,-64.0,-73.0,-70.0,-90.0,-93.0,-89.0,-92.0,19.0,29.0,15.0,22.0,0
418,F8:59:71:5A:E0:3D,2653883,374096324,27039,41562261,2626844,332534063,0,3114,383815,3048,372006,66,11809,3032,0,27049,865,0,21,144444.0,43333.0,-74.0,-79.0,-75.0,-74.0,-68.0,-72.0,-67.0,-72.0,-90.0,-93.0,-89.0,-92.0,16.0,14.0,14.0,18.0,0
419,CC:2F:71:3E:C5:1F,2631969,333160781,5125,626718,2626844,332534063,6,21999,1844380,18134,1386392,3865,457988,5406,29,7306,130,6,448,144444.0,39000.0,-69.0,-70.0,-68.0,-60.0,-68.0,-72.0,-68.0,-61.0,-90.0,-93.0,-89.0,-92.0,21.0,23.0,21.0,32.0,0
420,CC:2F:71:3F:1F:24,3503704,1562284353,876860,1229750290,2626844,332534063,21,419300,421137148,415421,420669728,3879,467420,393590,581,878892,92463,21,4572,144444.0,39000.0,-72.0,-65.0,-74.0,-70.0,-72.0,-65.0,-74.0,-69.0,-90.0,-93.0,-89.0,-92.0,18.0,28.0,15.0,22.0,0
421,F8:59:71:5A:E0:3D,2653892,374097194,27039,41562261,2626853,332534933,0,3115,383885,3049,372076,66,11809,3032,0,27049,865,0,21,144444.0,43333.0,-66.0,-66.0,-64.0,-68.0,-68.0,-71.0,-67.0,-71.0,-90.0,-93.0,-89.0,-92.0,24.0,27.0,25.0,24.0,0
422,CC:2F:71:3E:C5:1F,2631979,333161711,5125,626718,2626854,332534993,6,22001,1844568,18135,1386462,3866,458106,5407,29,7306,130,6,448,144444.0,39000.0,-69.0,-71.0,-68.0,-60.0,-69.0,-72.0,-68.0,-61.0,-90.0,-93.0,-89.0,-92.0,21.0,22.0,21.0,32.0,0
423,CC:2F:71:3F:1F:24,3508655,1570022077,881801,1237487084,2626854,332534993,21,420068,421232298,416189,420764878,3879,467420,394358,581,883847,92672,21,4573,130000.0,43333.0,-72.0,-65.0,-75.0,-69.0,-72.0,-65.0,-75.0,-69.0,-90.0,-93.0,-89.0,-92.0,18.0,28.0,14.0,23.0,0
424,F8:59:71:5A:E0:3D,2653894,374097527,27039,41562261,2626855,332535266,0,3115,383885,3049,372076,66,11809,3032,0,27049,865,0,21,144444.0,43333.0,-66.0,-66.0,-64.0,-68.0,-68.0,-71.0,-67.0,-71.0,-90.0,-93.0,-89.0,-92.0,24.0,27.0,25.0,24.0,0
425,CC:2F:71:3E:C5:1F,2631984,333162388,5125,626718,2626859,332535670,6,22001,1844568,18135,1386462,3866,458106,5407,29,7306,130,6,448,144444.0,39000.0,-69.0,-71.0,-68.0,-60.0,-69.0,-72.0,-68.0,-61.0,-90.0,-93.0,-89.0,-92.0,21.0,22.0,21.0,32.0,0
426,CC:2F:71:3F:1F:24,3513446,1577523574,886587,1244987904,2626859,332535670,21,420581,421296962,416702,420829542,3879,467420,394868,581,888650,92845,21,4574,130000.0,43333.0,-71.0,-65.0,-74.0,-68.0,-71.0,-65.0,-74.0,-68.0,-90.0,-93.0,-89.0,-92.0,19.0,28.0,15.0,24.0,0
427,F8:59:71:5A:E0:3D,2653902,374098335,27039,41562261,2626863,332536074,0,3115,383885,3049,372076,66,11809,3032,0,27049,865,0,21,144444.0,43333.0,-66.0,-66.0,-64.0,-68.0,-68.0,-71.0,-67.0,-71.0,-90.0,-93.0,-89.0,-92.0,24.0,27.0,25.0,24.0,0
428,CC:2F:71:3E:C5:1F,2631988,333162792,5125,626718,2626863,332536074,6,22001,1844568,18135,1386462,3866,458106,5407,29,7306,130,6,448,144444.0,39000.0,-69.0,-71.0,-68.0,-60.0,-69.0,-72.0,-68.0,-61.0,-90.0,-93.0,-89.0,-92.0,21.0,22.0,21.0,32.0,0
429,CC:2F:71:3F:1F:24,3518877,1586036584,892014,1253500510,2626863,332536074,21,421247,421379707,417368,420912287,3879,467420,395534,581,894091,93315,21,4574,130000.0,43333.0,-71.0,-65.0,-75.0,-68.0,-71.0,-65.0,-74.0,-68.0,-90.0,-93.0,-89.0,-92.0,19.0,28.0,14.0,24.0,0
430,F8:59:71:5A:E0:3D,2653908,374098861,27039,41562261,2626869,332536600,0,3117,384073,3050,372146,67,11927,3033,0,27049,865,0,21,144444.0,43333.0,-67.0,-72.0,-64.0,-70.0,-68.0,-72.0,-67.0,-71.0,-90.0,-92.0,-89.0,-92.0,23.0,20.0,25.0,22.0,0
431,CC:2F:71:3E:C5:1F,2631994,333163318,5125,626718,2626869,332536600,6,22001,1844568,18135,1386462,3866,458106,5407,29,7306,130,6,448,144444.0,39000.0,-69.0,-71.0,-68.0,-60.0,-69.0,-72.0,-68.0,-61.0,-90.0,-92.0,-89.0,-92.0,21.0,21.0,21.0,32.0,0
432,CC:2F:71:3F:1F:24,3524094,1594210778,897223,1261673976,2626871,332536802,21,421769,421445675,417890,420978255,3879,467420,396056,581,899300,93665,21,4574,130000.0,43333.0,-72.0,-65.0,-74.0,-68.0,-71.0,-65.0,-74.0,-68.0,-90.0,-92.0,-89.0,-92.0,18.0,27.0,15.0,24.0,0
433,F8:59:71:5A:E0:3D,2653912,374099265,27039,41562261,2626873,332537004,0,3117,384073,3050,372146,67,11927,3033,0,27049,865,0,21,144444.0,43333.0,-67.0,-72.0,-64.0,-70.0,-68.0,-72.0,-67.0,-71.0,-90.0,-92.0,-89.0,-92.0,23.0,20.0,25.0,22.0,0
434,CC:2F:71:3E:C5:1F,2631998,333163722,5125,626718,2626873,332537004,6,22001,1844568,18135,1386462,3866,458106,5407,29,7306,130,6,448,144444.0,39000.0,-69.0,-71.0,-68.0,-60.0,-69.0,-72.0,-68.0,-61.0,-90.0,-92.0,-89.0,-92.0,21.0,21.0,21.0,32.0,0
435,CC:2F:71:3F:1F:24,3527465,1599486198,900592,1266949194,2626873,332537004,21,422170,421496151,418291,421028731,3879,467420,396457,581,902669,94130,21,4574,130000.0,43333.0,-72.0,-65.0,-74.0,-68.0,-71.0,-65.0,-74.0,-68.0,-90.0,-92.0,-89.0,-92.0,18.0,27.0,15.0,24.0,0
436,F8:59:71:5A:E0:3D,2653921,374100133,27039,41562261,2626882,332537872,0,3117,384073,3050,372146,67,11927,3033,0,27049,865,0,21,144444.0,43333.0,-67.0,-72.0,-64.0,-70.0,-68.0,-72.0,-67.0,-71.0,-90.0,-92.0,-89.0,-92.0,23.0,20.0,25.0,22.0,0
437,CC:2F:71:3E:C5:1F,2632007,333164590,5125,626718,2626882,332537872,6,22001,1844568,18135,1386462,3866,458106,5407,29,7306,130,6,448,144444.0,39000.0,-69.0,-71.0,-68.0,-60.0,-69.0,-72.0,-68.0,-61.0,-90.0,-92.0,-89.0,-92.0,21.0,21.0,21.0,32.0,0
438,CC:2F:71:3F:1F:24,3533695,1609260492,906813,1276722620,2626882,332537872,21,422946,421589986,419067,421122566,3879,467420,397233,581,908834,94394,21,4574,130000.0,43333.0,-71.0,-65.0,-75.0,-68.0,-71.0,-64.0,-73.0,-68.0,-90.0,-92.0,-89.0,-92.0,19.0,27.0,14.0,24.0,0
439,F8:59:71:5A:E0:3D,2653921,374100133,27039,41562261,2626882,332537872,0,3117,384073,3050,372146,67,11927,3033,0,27049,865,0,21,144444.0,43333.0,-67.0,-72.0,-64.0,-70.0,-68.0,-72.0,-67.0,-71.0,-90.0,-92.0,-89.0,-92.0,23.0,20.0,25.0,22.0,0
440,CC:2F:71:3E:C5:1F,2632020,333170216,5125,626718,2626895,332543498,6,22003,1844708,18137,1386602,3866,458106,5407,29,7307,130,6,448,144444.0,39000.0,-78.0,-85.0,-76.0,-72.0,-69.0,-71.0,-68.0,-61.0,-90.0,-92.0,-89.0,-92.0,12.0,7.0,13.0,20.0,0
441,CC:2F:71:3F:1F:24,3538453,1616689452,911556,1284145752,2626897,332543700,21,423453,421653063,419574,421185643,3879,467420,397740,581,913633,94959,21,4574,130000.0,43333.0,-72.0,-65.0,-75.0,-68.0,-71.0,-65.0,-74.0,-68.0,-90.0,-92.0,-89.0,-92.0,18.0,27.0,14.0,24.0,0
442,F8:59:71:5A:E0:3D,2653954,374112059,27039,41562261,2626915,332549798,0,3120,384465,3051,372216,69,12249,3035,0,27049,865,0,21,144444.0,43333.0,-67.0,-71.0,-65.0,-70.0,-67.0,-70.0,-66.0,-69.0,-90.0,-92.0,-89.0,-92.0,23.0,21.0,24.0,22.0,0
443,CC:2F:71:3E:C5:1F,2632040,333176516,5125,626718,2626915,332549798,6,22003,1844708,18137,1386602,3866,458106,5407,29,7307,130,6,448,144444.0,39000.0,-78.0,-85.0,-76.0,-72.0,-69.0,-71.0,-68.0,-61.0,-90.0,-92.0,-89.0,-92.0,12.0,7.0,13.0,20.0,0
444,CC:2F:71:3F:1F:24,3542438,1622907524,915523,1290357726,2626915,332549798,21,423868,421705361,419989,421237941,3879,467420,398155,581,917600,95570,21,4574,130000.0,43333.0,-71.0,-65.0,-74.0,-68.0,-71.0,-65.0,-74.0,-68.0,-90.0,-92.0,-89.0,-92.0,19.0,27.0,15.0,24.0,0
445,F8:59:71:5A:E0:3D,2653958,374112463,27039,41562261,2626919,332550202,0,3120,384465,3051,372216,69,12249,3035,0,27049,865,0,21,144444.0,43333.0,-67.0,-71.0,-65.0,-70.0,-67.0,-70.0,-66.0,-69.0,-90.0,-92.0,-89.0,-92.0,23.0,21.0,24.0,22.0,0
446,CC:2F:71:3E:C5:1F,2632044,333176920,5125,626718,2626919,332550202,6,22003,1844708,18137,1386602,3866,458106,5407,29,7307,130,6,448,144444.0,39000.0,-78.0,-85.0,-76.0,-72.0,-69.0,-71.0,-68.0,-61.0,-90.0,-92.0,-89.0,-92.0,12.0,7.0,13.0,20.0,0
447,CC:2F:71:3F:1F:24,3546617,1629444254,919698,1296894052,2626919,332550202,21,424328,421763681,420449,421296261,3879,467420,398615,581,921741,96159,21,4574,130000.0,43333.0,-72.0,-65.0,-75.0,-69.0,-72.0,-65.0,-74.0,-68.0,-90.0,-92.0,-89.0,-92.0,18.0,27.0,14.0,23.0,0
448,F8:59:71:5A:E0:3D,2653962,374112867,27039,41562261,2626923,332550606,0,3120,384465,3051,372216,69,12249,3035,0,27049,865,0,21,144444.0,43333.0,-67.0,-71.0,-65.0,-70.0,-67.0,-70.0,-66.0,-69.0,-90.0,-92.0,-89.0,-91.0,23.0,21.0,24.0,21.0,0
449,CC:2F:71:3E:C5:1F,2632048,333177324,5125,626718,2626923,332550606,6,22003,1844708,18137,1386602,3866,458106,5407,29,7307,130,6,448,144444.0,39000.0,-78.0,-85.0,-76.0,-72.0,-69.0,-71.0,-68.0,-61.0,-90.0,-92.0,-89.0,-91.0,12.0,7.0,13.0,19.0,0
450,CC:2F:71:3F:1F:24,3550937,1636213826,924014,1303663220,2626923,332550606,21,424777,421820387,420898,421352967,3879,467420,399064,581,926073,96409,21,4574,130000.0,43333.0,-72.0,-65.0,-74.0,-69.0,-72.0,-65.0,-74.0,-68.0,-90.0,-92.0,-89.0,-91.0,18.0,27.0,15.0,22.0,0
451,F8:59:71:5A:E0:3D,2653967,374113331,27039,41562261,2626928,332551070,0,3120,384465,3051,372216,69,12249,3035,0,27049,865,0,21,144444.0,43333.0,-67.0,-71.0,-65.0,-70.0,-67.0,-70.0,-66.0,-69.0,-90.0,-92.0,-89.0,-91.0,23.0,21.0,24.0,21.0,0
452,CC:2F:71:3E:C5:1F,2632057,333178192,5125,626718,2626932,332551474,6,22003,1844708,18137,1386602,3866,458106,5407,29,7307,130,6,448,144444.0,39000.0,-78.0,-85.0,-76.0,-72.0,-69.0,-71.0,-68.0,-61.0,-90.0,-92.0,-89.0,-91.0,12.0,7.0,13.0,19.0,0
453,CC:2F:71:3F:1F:24,3557013,1645743652,930081,1313192178,2626932,332551474,21,425608,421923187,421729,421455767,3879,467420,399895,581,932081,98420,21,4575,86667.0,14444.0,-71.0,-66.0,-75.0,-67.0,-71.0,-66.0,-75.0,-67.0,-90.0,-92.0,-89.0,-91.0,19.0,26.0,14.0,24.0,0
454,F8:59:71:5A:E0:3D,2653980,374114603,27039,41562261,2626941,332552342,0,3120,384465,3051,372216,69,12249,3035,0,27049,865,0,21,144444.0,43333.0,-67.0,-71.0,-65.0,-70.0,-67.0,-70.0,-66.0,-69.0,-90.0,-92.0,-89.0,-91.0,23.0,21.0,24.0,21.0,0
455,CC:2F:71:3E:C5:1F,2632066,333179060,5125,626718,2626941,332552342,6,22003,1844708,18137,1386602,3866,458106,5407,29,7307,130,6,448,144444.0,39000.0,-78.0,-85.0,-76.0,-72.0,-69.0,-71.0,-68.0,-61.0,-90.0,-92.0,-89.0,-91.0,12.0,7.0,13.0,19.0,0
456,CC:2F:71:3F:1F:24,3561237,1652328381,934295,1319775766,2626942,332552615,21,426128,421991373,422249,421523953,3879,467420,400412,581,936327,98931,21,4575,86667.0,14444.0,-72.0,-65.0,-73.0,-66.0,-73.0,-65.0,-73.0,-66.0,-90.0,-92.0,-89.0,-91.0,18.0,27.0,16.0,25.0,0
457,F8:59:71:5A:E0:3D,2653981,374114876,27039,41562261,2626942,332552615,0,3120,384465,3051,372216,69,12249,3035,0,27049,865,0,21,144444.0,43333.0,-67.0,-71.0,-65.0,-70.0,-67.0,-70.0,-66.0,-69.0,-90.0,-92.0,-89.0,-91.0,23.0,21.0,24.0,21.0,0
458,CC:2F:71:3E:C5:1F,2632071,333179737,5125,626718,2626946,332553019,6,22003,1844708,18137,1386602,3866,458106,5407,29,7307,130,6,448,144444.0,39000.0,-78.0,-85.0,-76.0,-72.0,-69.0,-71.0,-68.0,-61.0,-90.0,-92.0,-89.0,-91.0,12.0,7.0,13.0,19.0,0
459,CC:2F:71:3F:1F:24,3565201,1658530665,938255,1325977646,2626946,332553019,21,426907,422086871,423028,421619451,3879,467420,401191,581,940312,99274,21,4577,115556.0,28889.0,-73.0,-65.0,-74.0,-67.0,-73.0,-65.0,-73.0,-67.0,-90.0,-92.0,-89.0,-91.0,17.0,27.0,15.0,24.0,0
460,F8:59:71:5A:E0:3D,2653990,374115744,27039,41562261,2626951,332553483,0,3120,384465,3051,372216,69,12249,3035,0,27049,865,0,21,144444.0,43333.0,-67.0,-71.0,-65.0,-70.0,-67.0,-70.0,-66.0,-69.0,-90.0,-93.0,-89.0,-92.0,23.0,22.0,24.0,22.0,0
461,CC:2F:71:3E:C5:1F,2632076,333180201,5125,626718,2626951,332553483,6,22003,1844708,18137,1386602,3866,458106,5407,29,7307,130,6,448,144444.0,39000.0,-78.0,-85.0,-76.0,-72.0,-69.0,-71.0,-68.0,-61.0,-90.0,-93.0,-89.0,-92.0,12.0,8.0,13.0,20.0,0
462,CC:2F:71:3F:1F:24,3569315,1664972435,942364,1332418952,2626951,332553483,21,427509,422163287,423630,421695867,3879,467420,401787,581,944436,100448,21,4578,115556.0,26000.0,-73.0,-65.0,-73.0,-67.0,-73.0,-65.0,-73.0,-66.0,-90.0,-93.0,-89.0,-92.0,17.0,28.0,16.0,25.0,0
463,F8:59:71:5A:E0:3D,2653994,374116148,27039,41562261,2626955,332553887,0,3120,384465,3051,372216,69,12249,3035,0,27049,865,0,21,144444.0,43333.0,-67.0,-71.0,-65.0,-70.0,-67.0,-70.0,-66.0,-69.0,-90.0,-93.0,-89.0,-92.0,23.0,22.0,24.0,22.0,0
464,CC:2F:71:3E:C5:1F,2632084,333181009,5125,626718,2626959,332554291,6,22003,1844708,18137,1386602,3866,458106,5407,29,7307,130,6,448,144444.0,39000.0,-78.0,-85.0,-76.0,-72.0,-69.0,-71.0,-68.0,-61.0,-90.0,-93.0,-89.0,-92.0,12.0,8.0,13.0,20.0,0
465,CC:2F:71:3F:1F:24,3574316,1672809517,947357,1340255226,2626959,332554291,21,428316,422262001,424437,421794581,3879,467420,402594,581,949434,101612,21,4579,86667.0,14444.0,-74.0,-65.0,-73.0,-67.0,-73.0,-65.0,-72.0,-67.0,-90.0,-93.0,-89.0,-92.0,16.0,28.0,16.0,25.0,0
466,F8:59:71:5A:E0:3D,2653999,374116612,27039,41562261,2626960,332554351,0,3120,384465,3051,372216,69,12249,3035,0,27049,865,0,21,144444.0,43333.0,-67.0,-71.0,-65.0,-70.0,-67.0,-70.0,-66.0,-69.0,-90.0,-92.0,-89.0,-92.0,23.0,21.0,24.0,22.0,0
467,CC:2F:71:3E:C5:1F,2632087,333181271,5125,626718,2626962,332554553,6,22003,1844708,18137,1386602,3866,458106,5407,29,7307,130,6,448,144444.0,39000.0,-78.0,-85.0,-76.0,-72.0,-69.0,-71.0,-68.0,-61.0,-90.0,-92.0,-89.0,-92.0,12.0,7.0,13.0,20.0,0
468,CC:2F:71:3F:1F:24,3577471,1677736737,950507,1345181982,2626964,332554755,21,428671,422307135,424792,421839715,3879,467420,402949,581,952584,102257,21,4579,115556.0,28889.0,-73.0,-66.0,-73.0,-67.0,-73.0,-65.0,-73.0,-67.0,-90.0,-92.0,-89.0,-92.0,17.0,26.0,16.0,25.0,0
469,F8:59:71:5A:E0:3D,2654007,374117420,27039,41562261,2626968,332555159,0,3120,384465,3051,372216,69,12249,3035,0,27049,865,0,21,144444.0,43333.0,-67.0,-71.0,-65.0,-70.0,-67.0,-70.0,-66.0,-69.0,-90.0,-92.0,-89.0,-92.0,23.0,21.0,24.0,22.0,0
470,CC:2F:71:3E:C5:1F,2632093,333181877,5125,626718,2626968,332555159,6,22003,1844708,18137,1386602,3866,458106,5407,29,7307,130,6,448,144444.0,39000.0,-78.0,-85.0,-76.0,-72.0,-69.0,-71.0,-68.0,-61.0,-90.0,-92.0,-89.0,-92.0,12.0,7.0,13.0,20.0,0
471,CC:2F:71:3F:1F:24,3582553,1685708521,955585,1353153362,2626968,332555159,21,429488,422408175,425609,421940755,3879,467420,403766,581,957614,102734,21,4579,115556.0,28889.0,-73.0,-66.0,-73.0,-68.0,-73.0,-65.0,-73.0,-68.0,-90.0,-92.0,-89.0,-92.0,17.0,26.0,16.0,24.0,0
472,F8:59:71:5A:E0:3D,2654012,374117884,27039,41562261,2626973,332555623,0,3120,384465,3051,372216,69,12249,3035,0,27049,865,0,21,144444.0,43333.0,-67.0,-71.0,-65.0,-70.0,-67.0,-70.0,-66.0,-69.0,-90.0,-92.0,-89.0,-92.0,23.0,21.0,24.0,22.0,0
473,CC:2F:71:3E:C5:1F,2632102,333182745,5125,626718,2626977,332556027,6,22003,1844708,18137,1386602,3866,458106,5407,29,7307,130,6,448,144444.0,39000.0,-78.0,-85.0,-76.0,-72.0,-69.0,-71.0,-68.0,-61.0,-90.0,-92.0,-89.0,-92.0,12.0,7.0,13.0,20.0,0
474,CC:2F:71:3F:1F:24,3587807,1693931495,960830,1361375468,2626977,332556027,21,430310,422508959,426431,422041539,3879,467420,404588,581,962907,104278,21,4581,117000.0,39000.0,-74.0,-65.0,-73.0,-68.0,-73.0,-65.0,-73.0,-67.0,-90.0,-92.0,-89.0,-92.0,16.0,27.0,16.0,24.0,0
475,F8:59:71:5A:E0:3D,2654016,374118288,27039,41562261,2626977,332556027,0,3120,384465,3051,372216,69,12249,3035,0,27049,865,0,21,144444.0,43333.0,-67.0,-71.0,-65.0,-70.0,-67.0,-70.0,-66.0,-69.0,-90.0,-92.0,-89.0,-92.0,23.0,21.0,24.0,22.0,0
476,CC:2F:71:3E:C5:1F,2632102,333182745,5125,626718,2626977,332556027,6,22003,1844708,18137,1386602,3866,458106,5407,29,7307,130,6,448,144444.0,39000.0,-78.0,-85.0,-76.0,-72.0,-69.0,-71.0,-68.0,-61.0,-90.0,-92.0,-89.0,-92.0,12.0,7.0,13.0,20.0,0
477,CC:2F:71:3F:1F:24,3590040,1697415681,963063,1364859654,2626977,332556027,21,430723,422558179,426844,422090759,3879,467420,405001,581,965090,104980,21,4581,115556.0,28889.0,-74.0,-65.0,-73.0,-67.0,-74.0,-65.0,-73.0,-67.0,-90.0,-92.0,-89.0,-92.0,16.0,27.0,16.0,25.0,0
478,F8:59:71:5A:E0:3D,2654021,374118826,27039,41562261,2626982,332556565,0,3120,384465,3051,372216,69,12249,3035,0,27049,865,0,21,144444.0,43333.0,-67.0,-71.0,-65.0,-70.0,-67.0,-70.0,-66.0,-69.0,-90.0,-92.0,-88.0,-91.0,23.0,21.0,23.0,21.0,0
479,CC:2F:71:3E:C5:1F,2632111,333183613,5125,626718,2626986,332556895,6,22003,1844708,18137,1386602,3866,458106,5407,29,7307,130,6,448,144444.0,39000.0,-78.0,-85.0,-76.0,-72.0,-69.0,-71.0,-68.0,-61.0,-90.0,-92.0,-88.0,-91.0,12.0,7.0,12.0,19.0,0
480,CC:2F:71:3F:1F:24,3593680,1703104725,966694,1370547830,2626986,332556895,21,431160,422613365,427281,422145945,3879,467420,405438,581,968722,104984,21,4581,115556.0,28889.0,-74.0,-65.0,-73.0,-67.0,-74.0,-65.0,-72.0,-67.0,-90.0,-92.0,-88.0,-91.0,16.0,27.0,15.0,24.0,0
481,F8:59:71:5A:E0:3D,2654026,374119272,27040,41562377,2626986,332556895,0,3123,384675,3054,372426,69,12249,3035,0,27050,865,0,21,130000.0,39000.0,-66.0,-71.0,-65.0,-70.0,-67.0,-71.0,-66.0,-70.0,-90.0,-92.0,-88.0,-91.0,24.0,21.0,23.0,21.0,0
482,CC:2F:71:3E:C5:1F,2632112,333183673,5126,626778,2626986,332556895,6,22005,1844848,18139,1386742,3866,458106,5407,29,7308,130,6,448,144444.0,39000.0,-77.0,-85.0,-75.0,-72.0,-70.0,-72.0,-69.0,-63.0,-90.0,-92.0,-88.0,-91.0,13.0,7.0,13.0,19.0,0
483,CC:2F:71:3F:1F:24,3596956,1708224985,969966,1375667686,2626990,332557299,21,431594,422667849,427715,422200429,3879,467420,405872,581,972043,105273,21,4586,104000.0,26000.0,-74.0,-66.0,-73.0,-68.0,-73.0,-65.0,-72.0,-67.0,-90.0,-92.0,-88.0,-91.0,16.0,26.0,15.0,23.0,0
484,F8:59:71:5A:E0:3D,2654034,374120080,27040,41562377,2626994,332557703,0,3123,384675,3054,372426,69,12249,3035,0,27050,865,0,21,130000.0,39000.0,-66.0,-71.0,-65.0,-70.0,-67.0,-71.0,-66.0,-70.0,-90.0,-92.0,-88.0,-91.0,24.0,21.0,23.0,21.0,0
485,CC:2F:71:3E:C5:1F,2632120,333184481,5126,626778,2626994,332557703,6,22005,1844848,18139,1386742,3866,458106,5407,29,7308,130,6,448,144444.0,39000.0,-77.0,-85.0,-75.0,-72.0,-70.0,-72.0,-69.0,-63.0,-90.0,-92.0,-88.0,-91.0,13.0,7.0,13.0,19.0,0
486,CC:2F:71:3F:1F:24,3600318,1713477705,973324,1380920002,2626994,332557703,21,431886,422706737,428007,422239317,3879,467420,406164,581,975401,106778,21,4586,104000.0,26000.0,-73.0,-66.0,-73.0,-68.0,-73.0,-66.0,-73.0,-68.0,-90.0,-92.0,-88.0,-91.0,17.0,26.0,15.0,23.0,0
487,F8:59:71:5A:E0:3D,2654040,374120817,27040,41562377,2627000,332558440,0,3123,384675,3054,372426,69,12249,3035,0,27050,865,0,21,130000.0,39000.0,-66.0,-71.0,-65.0,-70.0,-67.0,-71.0,-66.0,-70.0,-90.0,-92.0,-88.0,-91.0,24.0,21.0,23.0,21.0,0
488,CC:2F:71:3E:C5:1F,2632126,333185218,5126,626778,2627000,332558440,6,22005,1844848,18139,1386742,3866,458106,5407,29,7308,130,6,448,144444.0,39000.0,-77.0,-85.0,-75.0,-72.0,-70.0,-72.0,-69.0,-63.0,-90.0,-92.0,-88.0,-91.0,13.0,7.0,13.0,19.0,0
489,CC:2F:71:3F:1F:24,3605461,1721531284,978461,1388972844,2627000,332558440,21,432489,422783347,428610,422315927,3879,467420,406767,581,980492,106894,21,4586,115556.0,28889.0,-73.0,-65.0,-74.0,-69.0,-72.0,-65.0,-74.0,-69.0,-90.0,-92.0,-88.0,-91.0,17.0,27.0,14.0,22.0,0
490,F8:59:71:5A:E0:3D,2654044,374121221,27040,41562377,2627004,332558844,0,3123,384675,3054,372426,69,12249,3035,0,27050,865,0,21,130000.0,39000.0,-66.0,-71.0,-65.0,-70.0,-67.0,-71.0,-66.0,-70.0,-90.0,-92.0,-88.0,-91.0,24.0,21.0,23.0,21.0,0
491,CC:2F:71:3E:C5:1F,2632130,333185622,5126,626778,2627004,332558844,6,22005,1844848,18139,1386742,3866,458106,5407,29,7308,130,6,448,144444.0,39000.0,-77.0,-85.0,-75.0,-72.0,-70.0,-72.0,-69.0,-63.0,-90.0,-92.0,-88.0,-91.0,13.0,7.0,13.0,19.0,0
492,CC:2F:71:3F:1F:24,3610134,1728845016,983130,1396286172,2627004,332558844,21,432979,422846069,429100,422378649,3879,467420,407257,581,985207,107247,21,4586,130000.0,43333.0,-73.0,-65.0,-74.0,-68.0,-73.0,-65.0,-74.0,-68.0,-90.0,-92.0,-88.0,-91.0,17.0,27.0,14.0,23.0,0
493,F8:59:71:5A:E0:3D,2654049,374121685,27040,41562377,2627009,332559308,0,3123,384675,3054,372426,69,12249,3035,0,27050,865,0,21,130000.0,39000.0,-66.0,-71.0,-65.0,-70.0,-67.0,-71.0,-66.0,-70.0,-90.0,-92.0,-88.0,-91.0,24.0,21.0,23.0,21.0,0
494,CC:2F:71:3E:C5:1F,2632135,333186086,5126,626778,2627009,332559308,6,22005,1844848,18139,1386742,3866,458106,5407,29,7308,130,6,448,144444.0,39000.0,-77.0,-85.0,-75.0,-72.0,-70.0,-72.0,-69.0,-63.0,-90.0,-92.0,-88.0,-91.0,13.0,7.0,13.0,19.0,0
495,CC:2F:71:3F:1F:24,3614367,1735463283,987354,1402903571,2627013,332559712,21,433415,422900300,429536,422432880,3879,467420,407693,581,989369,108726,21,4586,115556.0,28889.0,-72.0,-65.0,-75.0,-67.0,-72.0,-65.0,-75.0,-67.0,-90.0,-92.0,-88.0,-91.0,18.0,27.0,13.0,24.0,0
496,F8:59:71:5A:E0:3D,2654055,374122291,27040,41562377,2627015,332559914,0,3123,384675,3054,372426,69,12249,3035,0,27050,865,0,21,130000.0,39000.0,-66.0,-71.0,-65.0,-70.0,-67.0,-71.0,-66.0,-70.0,-90.0,-92.0,-88.0,-91.0,24.0,21.0,23.0,21.0,0
497,CC:2F:71:3E:C5:1F,2632143,333186894,5126,626778,2627017,332560116,6,22005,1844848,18139,1386742,3866,458106,5407,29,7308,130,6,448,144444.0,39000.0,-77.0,-85.0,-75.0,-72.0,-70.0,-72.0,-69.0,-63.0,-90.0,-92.0,-88.0,-91.0,13.0,7.0,13.0,19.0,0
498,CC:2F:71:3F:1F:24,3618451,1741838295,991434,1409278179,2627017,332560116,21,434025,422976296,430146,422508876,3879,467420,408303,581,993488,110319,21,4588,86667.0,14444.0,-73.0,-65.0,-75.0,-68.0,-72.0,-65.0,-75.0,-68.0,-90.0,-92.0,-88.0,-91.0,17.0,27.0,13.0,23.0,0
499,F8:59:71:5A:E0:3D,2654064,374123145,27040,41562377,2627024,332560768,0,3123,384675,3054,372426,69,12249,3035,0,27050,865,0,21,130000.0,39000.0,-66.0,-71.0,-65.0,-70.0,-67.0,-71.0,-66.0,-70.0,-90.0,-92.0,-88.0,-91.0,24.0,21.0,23.0,21.0,0
500,CC:2F:71:3E:C5:1F,2632150,333187546,5126,626778,2627024,332560768,6,22005,1844848,18139,1386742,3866,458106,5407,29,7308,130,6,448,144444.0,39000.0,-77.0,-85.0,-75.0,-72.0,-70.0,-72.0,-69.0,-63.0,-90.0,-92.0,-88.0,-91.0,13.0,7.0,13.0,19.0,0
501,CC:2F:71:3F:1F:24,3623458,1749658582,996434,1417097814,2627024,332560768,21,434711,423063363,430831,422595825,3880,467538,408989,581,998499,110676,21,4590,115556.0,28889.0,-73.0,-65.0,-75.0,-69.0,-72.0,-65.0,-75.0,-68.0,-90.0,-92.0,-88.0,-91.0,17.0,27.0,13.0,22.0,0
502,F8:59:71:5A:E0:3D,2654068,374123549,27040,41562377,2627028,332561172,0,3125,384815,3056,372566,69,12249,3035,0,27051,865,0,21,130000.0,39000.0,-75.0,-80.0,-78.0,-75.0,-69.0,-73.0,-69.0,-71.0,-90.0,-92.0,-88.0,-91.0,15.0,12.0,10.0,16.0,0
503,CC:2F:71:3E:C5:1F,2632154,333187950,5126,626778,2627028,332561172,6,22007,1844988,18141,1386882,3866,458106,5407,29,7309,130,6,448,144444.0,39000.0,-69.0,-64.0,-67.0,-60.0,-70.0,-72.0,-69.0,-63.0,-90.0,-92.0,-88.0,-91.0,21.0,28.0,21.0,31.0,0
504,CC:2F:71:3F:1F:24,3629085,1758461918,1002055,1425900544,2627030,332561374,21,435593,423172149,431713,422704611,3880,467538,409871,581,1004079,111040,21,4593,115556.0,28889.0,-73.0,-65.0,-73.0,-68.0,-72.0,-65.0,-73.0,-68.0,-90.0,-92.0,-88.0,-91.0,17.0,27.0,15.0,23.0,0
505,F8:59:71:5A:E0:3D,2654075,374124381,27040,41562377,2627035,332562004,0,3125,384815,3056,372566,69,12249,3035,0,27051,865,0,21,130000.0,39000.0,-75.0,-80.0,-78.0,-75.0,-69.0,-73.0,-69.0,-71.0,-90.0,-92.0,-88.0,-91.0,15.0,12.0,10.0,16.0,0
506,CC:2F:71:3E:C5:1F,2632161,333188782,5126,626778,2627035,332562004,6,22007,1844988,18141,1386882,3866,458106,5407,29,7309,130,6,448,144444.0,39000.0,-69.0,-64.0,-67.0,-60.0,-70.0,-72.0,-69.0,-63.0,-90.0,-92.0,-88.0,-91.0,21.0,28.0,21.0,31.0,0
507,CC:2F:71:3F:1F:24,3633209,1764907760,1006172,1432345554,2627037,332562206,21,436213,423248685,432333,422781147,3880,467538,410491,581,1008151,111328,21,4594,115556.0,28889.0,-74.0,-65.0,-74.0,-68.0,-74.0,-65.0,-73.0,-68.0,-90.0,-92.0,-88.0,-91.0,16.0,27.0,14.0,23.0,0
508,F8:59:71:5A:E0:3D,2654081,374124987,27040,41562377,2627041,332562610,0,3125,384815,3056,372566,69,12249,3035,0,27051,865,0,21,130000.0,39000.0,-75.0,-80.0,-78.0,-75.0,-69.0,-73.0,-69.0,-71.0,-90.0,-92.0,-88.0,-91.0,15.0,12.0,10.0,16.0,0
509,CC:2F:71:3E:C5:1F,2632169,333189590,5126,626778,2627043,332562812,6,22007,1844988,18141,1386882,3866,458106,5407,29,7309,130,6,448,144444.0,39000.0,-69.0,-64.0,-67.0,-60.0,-70.0,-72.0,-69.0,-63.0,-90.0,-92.0,-88.0,-91.0,21.0,28.0,21.0,31.0,0
510,CC:2F:71:3F:1F:24,3638557,1773293594,1011514,1440730782,2627043,332562812,21,436976,423343031,433096,422875493,3880,467538,411253,581,1013567,111777,21,4594,117000.0,39000.0,-74.0,-65.0,-73.0,-68.0,-73.0,-65.0,-72.0,-68.0,-90.0,-92.0,-88.0,-91.0,16.0,27.0,15.0,23.0,0
511,F8:59:71:5A:E0:3D,2654090,374125777,27040,41562377,2627050,332563400,0,3127,385003,3057,372636,70,12367,3036,0,27051,865,0,21,130000.0,39000.0,-65.0,-63.0,-65.0,-64.0,-69.0,-73.0,-69.0,-71.0,-90.0,-92.0,-89.0,-91.0,25.0,29.0,24.0,27.0,0
512,CC:2F:71:3E:C5:1F,2632176,333190178,5126,626778,2627050,332563400,6,22009,1845176,18142,1386952,3867,458224,5408,29,7309,130,6,448,144444.0,39000.0,-70.0,-70.0,-68.0,-60.0,-70.0,-72.0,-69.0,-63.0,-90.0,-92.0,-89.0,-91.0,20.0,22.0,21.0,31.0,0
513,CC:2F:71:3F:1F:24,3641726,1778238002,1014676,1445674602,2627050,332563400,21,437335,423390152,433455,422922614,3880,467538,411612,581,1016741,111942,21,4594,115556.0,28889.0,-74.0,-65.0,-73.0,-68.0,-73.0,-65.0,-73.0,-67.0,-90.0,-92.0,-89.0,-91.0,16.0,27.0,16.0,23.0,0
514,F8:59:71:5A:E0:3D,2654094,374126181,27040,41562377,2627054,332563804,0,3127,385003,3057,372636,70,12367,3036,0,27051,865,0,21,130000.0,39000.0,-65.0,-63.0,-65.0,-64.0,-69.0,-73.0,-69.0,-71.0,-90.0,-92.0,-89.0,-91.0,25.0,29.0,24.0,27.0,0
515,CC:2F:71:3E:C5:1F,2632180,333190582,5126,626778,2627054,332563804,6,22009,1845176,18142,1386952,3867,458224,5408,29,7309,130,6,448,144444.0,39000.0,-70.0,-70.0,-68.0,-60.0,-70.0,-72.0,-69.0,-63.0,-90.0,-92.0,-89.0,-91.0,20.0,22.0,21.0,31.0,0
516,CC:2F:71:3F:1F:24,3647154,1786752954,1020100,1454189150,2627054,332563804,21,438080,423482384,434200,423014846,3880,467538,412352,581,1022123,112730,21,4596,115556.0,28889.0,-75.0,-66.0,-74.0,-68.0,-74.0,-65.0,-73.0,-67.0,-90.0,-92.0,-89.0,-91.0,15.0,26.0,15.0,23.0,0
517,F8:59:71:5A:E0:3D,2654099,374126645,27040,41562377,2627059,332564268,0,3127,385003,3057,372636,70,12367,3036,0,27051,865,0,21,130000.0,39000.0,-65.0,-63.0,-65.0,-64.0,-69.0,-73.0,-69.0,-71.0,-90.0,-92.0,-89.0,-91.0,25.0,29.0,24.0,27.0,0
518,CC:2F:71:3E:C5:1F,2632185,333191046,5126,626778,2627059,332564268,6,22009,1845176,18142,1386952,3867,458224,5408,29,7309,130,6,448,144444.0,39000.0,-70.0,-70.0,-68.0,-60.0,-70.0,-72.0,-69.0,-63.0,-90.0,-92.0,-89.0,-91.0,20.0,22.0,21.0,31.0,0
519,CC:2F:71:3F:1F:24,3651563,1793657048,1024502,1461092578,2627061,332564470,21,438670,423557492,434790,423089954,3880,467538,412942,581,1026551,113034,21,4596,115556.0,28889.0,-75.0,-66.0,-73.0,-67.0,-74.0,-65.0,-73.0,-67.0,-90.0,-92.0,-89.0,-91.0,15.0,26.0,16.0,24.0,0
520,F8:59:71:5A:E0:3D,2654107,374127995,27041,41562848,2627066,332565147,0,3128,385153,3058,372786,70,12367,3037,0,27052,865,0,21,130000.0,39000.0,-66.0,-71.0,-65.0,-70.0,-69.0,-73.0,-69.0,-71.0,-90.0,-92.0,-89.0,-91.0,24.0,21.0,24.0,21.0,0
521,CC:2F:71:3E:C5:1F,2632192,333191925,5126,626778,2627066,332565147,6,22009,1845176,18142,1386952,3867,458224,5408,29,7309,130,6,448,144444.0,39000.0,-70.0,-70.0,-68.0,-60.0,-70.0,-72.0,-69.0,-63.0,-90.0,-92.0,-89.0,-91.0,20.0,22.0,21.0,31.0,0
522,CC:2F:71:3F:1F:24,3657588,1803112747,1030520,1470547398,2627068,332565349,21,439570,423668718,435690,423201180,3880,467538,413842,581,1032485,113934,21,4596,115556.0,26000.0,-75.0,-65.0,-73.0,-67.0,-74.0,-65.0,-73.0,-67.0,-90.0,-92.0,-89.0,-91.0,15.0,27.0,16.0,24.0,0
523,F8:59:71:5A:E0:3D,2654114,374128661,27041,41562848,2627073,332565813,0,3129,385223,3059,372856,70,12367,3037,0,27052,865,0,21,130000.0,39000.0,-66.0,-63.0,-65.0,-64.0,-69.0,-72.0,-69.0,-70.0,-90.0,-92.0,-89.0,-91.0,24.0,29.0,24.0,27.0,0
524,CC:2F:71:3E:C5:1F,2632199,333192591,5126,626778,2627073,332565813,6,22009,1845176,18142,1386952,3867,458224,5408,29,7309,130,6,448,144444.0,39000.0,-70.0,-70.0,-68.0,-60.0,-70.0,-72.0,-69.0,-63.0,-90.0,-92.0,-89.0,-91.0,20.0,22.0,21.0,31.0,0
525,CC:2F:71:3F:1F:24,3662804,1811290241,1035731,1478724428,2627073,332565813,21,440413,423771697,436533,423304159,3880,467538,414685,581,1037793,114879,21,4596,115556.0,28889.0,-74.0,-65.0,-73.0,-67.0,-74.0,-65.0,-72.0,-67.0,-90.0,-92.0,-89.0,-91.0,16.0,27.0,16.0,24.0,0
526,F8:59:71:5A:E0:3D,2654118,374129065,27041,41562848,2627077,332566217,0,3129,385223,3059,372856,70,12367,3037,0,27052,865,0,21,130000.0,39000.0,-66.0,-63.0,-65.0,-64.0,-69.0,-72.0,-69.0,-70.0,-90.0,-92.0,-88.0,-91.0,24.0,29.0,23.0,27.0,0
527,CC:2F:71:3E:C5:1F,2632203,333192995,5126,626778,2627077,332566217,6,22009,1845176,18142,1386952,3867,458224,5408,29,7309,130,6,448,144444.0,39000.0,-70.0,-70.0,-68.0,-60.0,-70.0,-72.0,-69.0,-63.0,-90.0,-92.0,-88.0,-91.0,20.0,22.0,20.0,31.0,0
528,CC:2F:71:3F:1F:24,3668045,1819495708,1040964,1486929087,2627081,332566621,21,441057,423851739,437177,423384201,3880,467538,415324,581,1043041,115833,21,4596,115556.0,28889.0,-74.0,-65.0,-73.0,-67.0,-73.0,-65.0,-73.0,-67.0,-90.0,-92.0,-88.0,-91.0,16.0,27.0,15.0,24.0,0
529,F8:59:71:5A:E0:3D,2654125,374129731,27041,41562848,2627084,332566883,0,3129,385223,3059,372856,70,12367,3037,0,27052,865,0,21,130000.0,39000.0,-66.0,-63.0,-65.0,-64.0,-69.0,-72.0,-69.0,-70.0,-90.0,-92.0,-88.0,-91.0,24.0,29.0,23.0,27.0,0
530,CC:2F:71:3E:C5:1F,2632212,333193863,5126,626778,2627086,332567085,6,22009,1845176,18142,1386952,3867,458224,5408,29,7309,130,6,448,144444.0,39000.0,-70.0,-70.0,-68.0,-60.0,-70.0,-72.0,-69.0,-63.0,-90.0,-92.0,-88.0,-91.0,20.0,22.0,20.0,31.0,0
531,CC:2F:71:3F:1F:24,3671918,1825531879,1044832,1492964794,2627086,332567085,21,441631,423922166,437751,423454628,3880,467538,415893,581,1046888,117060,21,4596,86667.0,14444.0,-73.0,-65.0,-73.0,-66.0,-73.0,-65.0,-73.0,-66.0,-90.0,-92.0,-88.0,-91.0,17.0,27.0,15.0,25.0,0
532,F8:59:71:5A:E0:3D,2654131,374130337,27041,41562848,2627090,332567489,0,3129,385223,3059,372856,70,12367,3037,0,27052,865,0,21,130000.0,39000.0,-66.0,-63.0,-65.0,-64.0,-69.0,-72.0,-69.0,-70.0,-90.0,-92.0,-88.0,-91.0,24.0,29.0,23.0,27.0,0
533,CC:2F:71:3E:C5:1F,2632216,333194267,5126,626778,2627090,332567489,6,22009,1845176,18142,1386952,3867,458224,5408,29,7309,130,6,448,144444.0,39000.0,-70.0,-70.0,-68.0,-60.0,-70.0,-72.0,-69.0,-63.0,-90.0,-92.0,-88.0,-91.0,20.0,22.0,20.0,31.0,0
534,CC:2F:71:3F:1F:24,3675725,1831492057,1048635,1498924568,2627090,332567489,21,442133,423985540,438253,423518002,3880,467538,416388,581,1050682,117498,21,4596,86667.0,14444.0,-73.0,-65.0,-74.0,-67.0,-73.0,-65.0,-73.0,-66.0,-90.0,-92.0,-88.0,-91.0,17.0,27.0,14.0,24.0,0
535,F8:59:71:5A:E0:3D,2654138,374131033,27043,41563080,2627095,332567953,0,3133,385575,3063,373208,70,12367,3039,0,27054,865,0,21,130000.0,39000.0,-66.0,-71.0,-65.0,-70.0,-65.0,-68.0,-64.0,-67.0,-90.0,-92.0,-88.0,-91.0,24.0,21.0,23.0,21.0,0
536,CC:2F:71:3E:C5:1F,2632221,333194731,5126,626778,2627095,332567953,6,22009,1845176,18142,1386952,3867,458224,5408,29,7309,130,6,448,144444.0,39000.0,-70.0,-70.0,-68.0,-60.0,-70.0,-72.0,-69.0,-63.0,-90.0,-92.0,-88.0,-91.0,20.0,22.0,20.0,31.0,0
537,CC:2F:71:3F:1F:24,3679518,1837409727,1052421,1504841572,2627097,332568155,21,442746,424062918,438866,423595380,3880,467538,417001,581,1054458,117582,21,4596,86667.0,14444.0,-75.0,-66.0,-73.0,-67.0,-74.0,-66.0,-73.0,-67.0,-90.0,-92.0,-88.0,-91.0,15.0,26.0,15.0,24.0,0
538,F8:59:71:5A:E0:3D,2654144,374131639,27043,41563080,2627101,332568559,0,3134,385645,3064,373278,70,12367,3039,0,27054,865,0,21,130000.0,39000.0,-66.0,-71.0,-65.0,-70.0,-65.0,-68.0,-64.0,-67.0,-90.0,-92.0,-88.0,-91.0,24.0,21.0,23.0,21.0,0
539,CC:2F:71:3E:C5:1F,2632229,333195539,5126,626778,2627103,332568761,6,22009,1845176,18142,1386952,3867,458224,5408,29,7309,130,6,448,144444.0,39000.0,-70.0,-70.0,-68.0,-60.0,-70.0,-72.0,-69.0,-63.0,-90.0,-92.0,-89.0,-92.0,20.0,22.0,21.0,32.0,0
540,CC:2F:71:3F:1F:24,3685318,1846507529,1058215,1513938768,2627103,332568761,21,443753,424188342,439873,423720804,3880,467538,418008,581,1060292,118118,21,4596,86667.0,14444.0,-75.0,-66.0,-73.0,-67.0,-74.0,-66.0,-73.0,-67.0,-90.0,-92.0,-89.0,-92.0,15.0,26.0,16.0,25.0,0
541,F8:59:71:5A:E0:3D,2654154,374132631,27044,41563196,2627110,332569435,0,3137,386037,3065,373348,72,12689,3041,0,27055,865,0,22,130000.0,39000.0,-66.0,-71.0,-65.0,-70.0,-65.0,-69.0,-64.0,-69.0,-90.0,-92.0,-89.0,-92.0,24.0,21.0,24.0,22.0,0
542,CC:2F:71:3E:C5:1F,2632239,333196531,5127,626894,2627112,332569637,6,22011,1845316,18144,1387092,3867,458224,5408,29,7310,130,6,448,144444.0,39000.0,-69.0,-70.0,-68.0,-60.0,-70.0,-71.0,-68.0,-61.0,-90.0,-92.0,-89.0,-92.0,21.0,22.0,21.0,32.0,0
543,CC:2F:71:3F:1F:24,3689479,1853012533,1062367,1520442896,2627112,332569637,21,444243,424251368,440363,423783830,3880,467538,418498,581,1064444,118190,21,4596,86667.0,14444.0,-74.0,-66.0,-73.0,-68.0,-74.0,-66.0,-73.0,-67.0,-90.0,-92.0,-89.0,-92.0,16.0,26.0,16.0,24.0,0
544,F8:59:71:5A:E0:3D,2654160,374133237,27044,41563196,2627116,332570041,0,3137,386037,3065,373348,72,12689,3041,0,27055,865,0,22,130000.0,39000.0,-66.0,-71.0,-65.0,-70.0,-65.0,-69.0,-64.0,-69.0,-90.0,-92.0,-89.0,-92.0,24.0,21.0,24.0,22.0,0
545,CC:2F:71:3E:C5:1F,2632243,333196935,5127,626894,2627116,332570041,6,22011,1845316,18144,1387092,3867,458224,5408,29,7310,130,6,448,144444.0,39000.0,-69.0,-70.0,-68.0,-60.0,-70.0,-71.0,-68.0,-61.0,-90.0,-92.0,-89.0,-92.0,21.0,22.0,21.0,32.0,0
546,CC:2F:71:3F:1F:24,3693212,1858844281,1066094,1526274038,2627118,332570243,21,444771,424316788,440891,423849250,3880,467538,419026,581,1068147,118575,21,4596,117000.0,39000.0,-73.0,-66.0,-73.0,-67.0,-73.0,-65.0,-72.0,-67.0,-90.0,-92.0,-89.0,-92.0,17.0,26.0,16.0,25.0,0
547,F8:59:71:5A:E0:3D,2654173,374136611,27044,41563196,2627129,332573415,0,3137,386037,3065,373348,72,12689,3041,0,27055,865,0,22,130000.0,39000.0,-66.0,-71.0,-65.0,-70.0,-65.0,-69.0,-64.0,-69.0,-90.0,-92.0,-89.0,-92.0,24.0,21.0,24.0,22.0,0
548,CC:2F:71:3E:C5:1F,2632256,333200309,5127,626894,2627129,332573415,6,22011,1845316,18144,1387092,3867,458224,5408,29,7310,130,6,448,144444.0,39000.0,-69.0,-70.0,-68.0,-60.0,-70.0,-71.0,-68.0,-61.0,-90.0,-92.0,-89.0,-92.0,21.0,22.0,21.0,32.0,0
549,CC:2F:71:3F:1F:24,3697435,1865453789,1070306,1532880374,2627129,332573415,21,445387,424392132,441507,423924594,3880,467538,419640,581,1072373,118995,21,4596,115556.0,28889.0,-75.0,-66.0,-73.0,-67.0,-74.0,-66.0,-72.0,-67.0,-90.0,-92.0,-89.0,-92.0,15.0,26.0,16.0,25.0,0
550,F8:59:71:5A:E0:3D,2654178,374137288,27044,41563196,2627134,332574092,0,3137,386037,3065,373348,72,12689,3041,0,27055,865,0,22,130000.0,39000.0,-66.0,-71.0,-65.0,-70.0,-65.0,-69.0,-64.0,-69.0,-90.0,-92.0,-89.0,-92.0,24.0,21.0,24.0,22.0,0
551,CC:2F:71:3E:C5:1F,2632261,333200986,5127,626894,2627134,332574092,6,22011,1845316,18144,1387092,3867,458224,5408,29,7310,130,6,448,144444.0,39000.0,-69.0,-70.0,-68.0,-60.0,-70.0,-71.0,-68.0,-61.0,-90.0,-92.0,-89.0,-92.0,21.0,22.0,21.0,32.0,0
552,CC:2F:71:3F:1F:24,3699507,1868667404,1072373,1536093312,2627134,332574092,21,445690,424431161,441810,423963623,3880,467538,419943,581,1074437,119493,21,4598,115556.0,28889.0,-75.0,-67.0,-74.0,-67.0,-76.0,-68.0,-75.0,-68.0,-90.0,-92.0,-89.0,-92.0,15.0,25.0,15.0,25.0,0
553,F8:59:71:5A:E0:3D,2654182,374137692,27044,41563196,2627138,332574496,0,3137,386037,3065,373348,72,12689,3041,0,27055,865,0,22,130000.0,39000.0,-66.0,-71.0,-65.0,-70.0,-65.0,-69.0,-64.0,-69.0,-90.0,-92.0,-89.0,-92.0,24.0,21.0,24.0,22.0,0
554,CC:2F:71:3E:C5:1F,2632265,333201390,5127,626894,2627138,332574496,6,22011,1845316,18144,1387092,3867,458224,5408,29,7310,130,6,448,144444.0,39000.0,-69.0,-70.0,-68.0,-60.0,-70.0,-71.0,-68.0,-61.0,-90.0,-92.0,-89.0,-92.0,21.0,22.0,21.0,32.0,0
555,CC:2F:71:3F:1F:24,3704258,1876118530,1077120,1543544034,2627138,332574496,21,446387,424517065,442507,424049527,3880,467538,420640,581,1079197,119675,21,4598,115556.0,28889.0,-75.0,-67.0,-74.0,-67.0,-74.0,-67.0,-74.0,-67.0,-90.0,-92.0,-89.0,-92.0,15.0,25.0,15.0,25.0,0
556,F8:59:71:5A:E0:3D,2654187,374138156,27044,41563196,2627143,332574960,0,3137,386037,3065,373348,72,12689,3041,0,27055,865,0,22,130000.0,39000.0,-66.0,-71.0,-65.0,-70.0,-65.0,-69.0,-64.0,-69.0,-90.0,-92.0,-89.0,-92.0,24.0,21.0,24.0,22.0,0
557,CC:2F:71:3E:C5:1F,2632270,333201854,5127,626894,2627143,332574960,6,22011,1845316,18144,1387092,3867,458224,5408,29,7310,130,6,448,144444.0,39000.0,-69.0,-70.0,-68.0,-60.0,-70.0,-71.0,-68.0,-61.0,-90.0,-92.0,-89.0,-92.0,21.0,22.0,21.0,32.0,0
558,CC:2F:71:3F:1F:24,3708362,1882542334,1081217,1549967172,2627145,332575162,21,446843,424575459,442963,424107921,3880,467538,421096,581,1083264,119918,21,4599,115556.0,28889.0,-75.0,-67.0,-74.0,-68.0,-75.0,-67.0,-74.0,-68.0,-90.0,-92.0,-89.0,-92.0,15.0,25.0,15.0,24.0,0
559,F8:59:71:5A:E0:3D,2654191,374138560,27044,41563196,2627147,332575364,0,3137,386037,3065,373348,72,12689,3041,0,27055,865,0,22,130000.0,39000.0,-66.0,-71.0,-65.0,-70.0,-65.0,-69.0,-64.0,-69.0,-90.0,-92.0,-89.0,-92.0,24.0,21.0,24.0,22.0,0
560,CC:2F:71:3E:C5:1F,2632276,333202460,5127,626894,2627149,332575566,6,22011,1845316,18144,1387092,3867,458224,5408,29,7310,130,6,448,144444.0,39000.0,-69.0,-70.0,-68.0,-60.0,-70.0,-71.0,-68.0,-61.0,-90.0,-92.0,-89.0,-92.0,21.0,22.0,21.0,32.0,0
561,CC:2F:71:3F:1F:24,3713715,1890944380,1086566,1558368814,2627149,332575566,21,447695,424678749,443815,424211211,3880,467538,421941,581,1088585,121196,21,4599,115556.0,28889.0,-76.0,-67.0,-74.0,-67.0,-75.0,-66.0,-73.0,-67.0,-90.0,-92.0,-89.0,-92.0,14.0,25.0,15.0,25.0,0
562,F8:59:71:5A:E0:3D,2654198,374139226,27044,41563196,2627154,332576030,0,3137,386037,3065,373348,72,12689,3041,0,27055,865,0,22,130000.0,39000.0,-66.0,-71.0,-65.0,-70.0,-65.0,-69.0,-64.0,-69.0,-90.0,-92.0,-89.0,-92.0,24.0,21.0,24.0,22.0,0
563,CC:2F:71:3E:C5:1F,2632283,333203126,5127,626894,2627156,332576232,6,22011,1845316,18144,1387092,3867,458224,5408,29,7310,130,6,448,144444.0,39000.0,-69.0,-70.0,-68.0,-60.0,-70.0,-71.0,-68.0,-61.0,-90.0,-92.0,-89.0,-92.0,21.0,22.0,21.0,32.0,0
564,CC:2F:71:3F:1F:24,3718526,1898470180,1091370,1565893948,2627156,332576232,21,448164,424741421,444284,424273883,3880,467538,422410,581,1093447,122434,21,4599,115556.0,28889.0,-74.0,-67.0,-74.0,-67.0,-74.0,-67.0,-74.0,-67.0,-90.0,-92.0,-89.0,-92.0,16.0,25.0,15.0,25.0,0
565,F8:59:71:5A:E0:3D,2654205,374139894,27044,41563196,2627161,332576698,0,3140,386295,3067,373488,73,12807,3042,0,27056,865,0,23,130000.0,39000.0,-74.0,-80.0,-77.0,-75.0,-66.0,-71.0,-66.0,-69.0,-90.0,-92.0,-89.0,-92.0,16.0,12.0,12.0,17.0,0
566,CC:2F:71:3E:C5:1F,2632293,333204056,5127,626894,2627166,332577162,6,22013,1845456,18146,1387232,3867,458224,5408,29,7311,130,6,448,144444.0,39000.0,-70.0,-71.0,-68.0,-60.0,-69.0,-69.0,-67.0,-60.0,-90.0,-92.0,-89.0,-92.0,20.0,21.0,21.0,32.0,0
567,CC:2F:71:3F:1F:24,3723736,1906632926,1096570,1574055764,2627166,332577162,21,448976,424841031,445096,424373493,3880,467538,423222,581,1098647,124348,21,4599,86667.0,14444.0,-77.0,-70.0,-78.0,-71.0,-74.0,-66.0,-74.0,-68.0,-90.0,-92.0,-89.0,-92.0,13.0,22.0,11.0,21.0,0
568,F8:59:71:5A:E0:3D,2654214,374140684,27044,41563196,2627170,332577488,0,3141,386365,3068,373558,73,12807,3042,0,27056,865,0,23,130000.0,39000.0,-74.0,-80.0,-77.0,-75.0,-67.0,-72.0,-67.0,-70.0,-90.0,-92.0,-89.0,-92.0,16.0,12.0,12.0,17.0,0
569,CC:2F:71:3E:C5:1F,2632299,333204584,5127,626894,2627172,332577690,6,22015,1845644,18147,1387302,3868,458342,5409,29,7311,130,6,448,144444.0,39000.0,-70.0,-71.0,-68.0,-60.0,-69.0,-70.0,-68.0,-60.0,-90.0,-92.0,-89.0,-92.0,20.0,21.0,21.0,32.0,0
570,CC:2F:71:3F:1F:24,3727841,1913055684,1100669,1580477994,2627172,332577690,21,449536,424911125,445655,424443469,3881,467656,423782,581,1102746,124934,21,4600,104000.0,26000.0,-75.0,-67.0,-73.0,-66.0,-74.0,-67.0,-73.0,-66.0,-90.0,-92.0,-89.0,-92.0,15.0,25.0,16.0,26.0,0
571,F8:59:71:5A:E0:3D,2654220,374141290,27044,41563196,2627176,332578094,0,3141,386365,3068,373558,73,12807,3042,0,27056,865,0,23,130000.0,39000.0,-74.0,-80.0,-77.0,-75.0,-67.0,-72.0,-67.0,-70.0,-90.0,-92.0,-89.0,-92.0,16.0,12.0,12.0,17.0,0
572,CC:2F:71:3E:C5:1F,2632304,333205048,5127,626894,2627177,332578154,6,22015,1845644,18147,1387302,3868,458342,5409,29,7311,130,6,448,144444.0,39000.0,-70.0,-71.0,-68.0,-60.0,-69.0,-70.0,-68.0,-60.0,-90.0,-92.0,-89.0,-92.0,20.0,21.0,21.0,32.0,0
573,CC:2F:71:3F:1F:24,3732193,1919868208,1105014,1587289852,2627179,332578356,21,450112,424983731,446231,424516075,3881,467656,424357,581,1107024,125442,21,4600,86667.0,14444.0,-74.0,-66.0,-73.0,-66.0,-73.0,-66.0,-72.0,-66.0,-90.0,-92.0,-89.0,-92.0,16.0,26.0,16.0,26.0,0
574,F8:59:71:5A:E0:3D,2654227,374141956,27044,41563196,2627183,332578760,0,3141,386365,3068,373558,73,12807,3042,0,27056,865,0,23,130000.0,39000.0,-74.0,-80.0,-77.0,-75.0,-67.0,-72.0,-67.0,-70.0,-90.0,-92.0,-89.0,-92.0,16.0,12.0,12.0,17.0,0
575,CC:2F:71:3E:C5:1F,2632312,333205856,5127,626894,2627185,332578962,6,22015,1845644,18147,1387302,3868,458342,5409,29,7311,130,6,448,144444.0,39000.0,-70.0,-71.0,-68.0,-60.0,-69.0,-70.0,-68.0,-60.0,-90.0,-92.0,-89.0,-92.0,20.0,21.0,21.0,32.0,0
576,CC:2F:71:3F:1F:24,3736204,1926146224,1109019,1593567262,2627185,332578962,21,450773,425065079,446892,424597423,3881,467656,425017,581,1111096,125555,21,4600,86667.0,14444.0,-75.0,-67.0,-74.0,-67.0,-74.0,-67.0,-73.0,-66.0,-90.0,-92.0,-89.0,-92.0,15.0,25.0,15.0,25.0,0
577,F8:59:71:5A:E0:3D,2654231,374142360,27044,41563196,2627187,332579164,0,3141,386365,3068,373558,73,12807,3042,0,27056,865,0,23,130000.0,39000.0,-74.0,-80.0,-77.0,-75.0,-67.0,-72.0,-67.0,-70.0,-90.0,-92.0,-89.0,-92.0,16.0,12.0,12.0,17.0,0
578,CC:2F:71:3E:C5:1F,2632314,333206058,5127,626894,2627187,332579164,6,22015,1845644,18147,1387302,3868,458342,5409,29,7311,130,6,448,144444.0,39000.0,-70.0,-71.0,-68.0,-60.0,-69.0,-70.0,-68.0,-60.0,-90.0,-92.0,-89.0,-92.0,20.0,21.0,21.0,32.0,0
579,CC:2F:71:3F:1F:24,3739217,1930856792,1112030,1598277628,2627187,332579164,21,451303,425129783,447422,424662127,3881,467656,425547,581,1114107,126352,21,4600,115556.0,28889.0,-75.0,-67.0,-73.0,-66.0,-74.0,-67.0,-73.0,-66.0,-90.0,-92.0,-89.0,-92.0,15.0,25.0,16.0,26.0,0
580,F8:59:71:5A:E0:3D,2654239,374143299,27044,41563196,2627195,332580103,0,3141,386365,3068,373558,73,12807,3042,0,27056,865,0,23,130000.0,39000.0,-74.0,-80.0,-77.0,-75.0,-67.0,-72.0,-67.0,-70.0,-90.0,-92.0,-89.0,-92.0,16.0,12.0,12.0,17.0,0
581,CC:2F:71:3E:C5:1F,2632322,333206997,5127,626894,2627195,332580103,6,22015,1845644,18147,1387302,3868,458342,5409,29,7311,130,6,448,144444.0,39000.0,-70.0,-71.0,-68.0,-60.0,-69.0,-70.0,-68.0,-60.0,-90.0,-92.0,-89.0,-92.0,20.0,21.0,21.0,32.0,0
582,CC:2F:71:3F:1F:24,3743550,1937642541,1116355,1605062438,2627195,332580103,21,452214,425242141,448333,424774485,3881,467656,426458,581,1118432,127055,21,4600,65000.0,13000.0,-75.0,-67.0,-73.0,-67.0,-75.0,-66.0,-72.0,-66.0,-90.0,-92.0,-89.0,-92.0,15.0,25.0,16.0,25.0,0
583,F8:59:71:5A:E0:3D,2654241,374143501,27044,41563196,2627197,332580305,0,3141,386365,3068,373558,73,12807,3042,0,27056,865,0,23,130000.0,39000.0,-74.0,-80.0,-77.0,-75.0,-67.0,-72.0,-67.0,-70.0,-90.0,-92.0,-89.0,-92.0,16.0,12.0,12.0,17.0,0
584,CC:2F:71:3E:C5:1F,2632324,333207199,5127,626894,2627197,332580305,6,22015,1845644,18147,1387302,3868,458342,5409,29,7311,130,6,448,144444.0,39000.0,-70.0,-71.0,-68.0,-60.0,-69.0,-70.0,-68.0,-60.0,-90.0,-92.0,-89.0,-92.0,20.0,21.0,21.0,32.0,0
585,CC:2F:71:3F:1F:24,3746201,1941778647,1119002,1609198140,2627199,332580507,21,452708,425303447,448827,424835791,3881,467656,426936,581,1121079,127127,21,4600,86667.0,14444.0,-74.0,-66.0,-72.0,-67.0,-74.0,-66.0,-72.0,-66.0,-90.0,-92.0,-89.0,-92.0,16.0,26.0,17.0,25.0,0
586,F8:59:71:5A:E0:3D,2654250,374144369,27044,41563196,2627206,332581173,0,3141,386365,3068,373558,73,12807,3042,0,27056,865,0,23,130000.0,39000.0,-74.0,-80.0,-77.0,-75.0,-67.0,-72.0,-67.0,-70.0,-90.0,-92.0,-89.0,-92.0,16.0,12.0,12.0,17.0,0
587,CC:2F:71:3E:C5:1F,2632333,333208067,5127,626894,2627206,332581173,6,22015,1845644,18147,1387302,3868,458342,5409,29,7311,130,6,448,144444.0,39000.0,-70.0,-71.0,-68.0,-60.0,-69.0,-70.0,-68.0,-60.0,-90.0,-92.0,-89.0,-92.0,20.0,21.0,21.0,32.0,0
588,CC:2F:71:3F:1F:24,3750358,1948286485,1123152,1615705312,2627206,332581173,21,453463,425395871,449582,424928215,3881,467656,427691,581,1125201,127926,21,4600,86667.0,14444.0,-75.0,-66.0,-73.0,-67.0,-74.0,-66.0,-72.0,-66.0,-90.0,-92.0,-89.0,-92.0,15.0,26.0,16.0,25.0,0
589,F8:59:71:5A:E0:3D,2654256,374144975,27044,41563196,2627212,332581779,0,3141,386365,3068,373558,73,12807,3042,0,27056,865,0,23,130000.0,39000.0,-74.0,-80.0,-77.0,-75.0,-67.0,-72.0,-67.0,-70.0,-90.0,-92.0,-89.0,-92.0,16.0,12.0,12.0,17.0,0
590,CC:2F:71:3E:C5:1F,2632339,333208673,5127,626894,2627212,332581779,6,22015,1845644,18147,1387302,3868,458342,5409,29,7311,130,6,448,144444.0,39000.0,-70.0,-71.0,-68.0,-60.0,-69.0,-70.0,-68.0,-60.0,-90.0,-92.0,-89.0,-92.0,20.0,21.0,21.0,32.0,0
591,CC:2F:71:3F:1F:24,3753504,1953202139,1126292,1620620360,2627212,332581779,21,453908,425452083,450027,424984427,3881,467656,428129,581,1128355,127942,21,4600,86667.0,14444.0,-73.0,-66.0,-72.0,-66.0,-74.0,-66.0,-71.0,-66.0,-90.0,-92.0,-89.0,-92.0,17.0,26.0,17.0,26.0,0
592,F8:59:71:5A:E0:3D,2654259,374145237,27044,41563196,2627215,332582041,0,3141,386365,3068,373558,73,12807,3042,0,27056,865,0,23,130000.0,39000.0,-74.0,-80.0,-77.0,-75.0,-67.0,-72.0,-67.0,-70.0,-90.0,-92.0,-89.0,-92.0,16.0,12.0,12.0,17.0,0
593,CC:2F:71:3E:C5:1F,2632344,333209137,5127,626894,2627217,332582243,6,22015,1845644,18147,1387302,3868,458342,5409,29,7311,130,6,448,144444.0,39000.0,-70.0,-71.0,-68.0,-60.0,-69.0,-70.0,-68.0,-60.0,-90.0,-92.0,-89.0,-92.0,20.0,21.0,21.0,32.0,0
594,CC:2F:71:3F:1F:24,3758738,1961385111,1131521,1628802868,2627217,332582243,21,455068,425593404,451187,425125748,3881,467656,429285,581,1133518,129089,21,4600,86667.0,14444.0,-74.0,-66.0,-75.0,-68.0,-73.0,-65.0,-74.0,-68.0,-90.0,-92.0,-89.0,-92.0,16.0,26.0,14.0,24.0,0
595,F8:59:71:5A:E0:3D,2654265,374145843,27044,41563196,2627221,332582647,0,3141,386365,3068,373558,73,12807,3042,0,27056,865,0,23,130000.0,39000.0,-74.0,-80.0,-77.0,-75.0,-67.0,-72.0,-67.0,-70.0,-90.0,-93.0,-89.0,-92.0,16.0,13.0,12.0,17.0,0
596,CC:2F:71:3E:C5:1F,2632352,333210111,5127,626894,2627225,332583217,6,22015,1845644,18147,1387302,3868,458342,5409,29,7311,130,6,448,144444.0,39000.0,-70.0,-71.0,-68.0,-60.0,-69.0,-70.0,-68.0,-60.0,-90.0,-93.0,-89.0,-92.0,20.0,22.0,21.0,32.0,0
597,CC:2F:71:3F:1F:24,3762693,1967570739,1135468,1634987522,2627225,332583217,21,455718,425674064,451837,425206408,3881,467656,429935,581,1137545,129201,21,4600,86667.0,14444.0,-74.0,-66.0,-74.0,-68.0,-73.0,-66.0,-73.0,-68.0,-90.0,-93.0,-89.0,-92.0,16.0,27.0,15.0,24.0,0
598,F8:59:71:5A:E0:3D,2654276,374147079,27044,41563196,2627232,332583883,0,3141,386365,3068,373558,73,12807,3042,0,27056,865,0,23,130000.0,39000.0,-74.0,-80.0,-77.0,-75.0,-67.0,-72.0,-67.0,-70.0,-90.0,-93.0,-89.0,-92.0,16.0,13.0,12.0,17.0,0
599,CC:2F:71:3E:C5:1F,2632359,333210777,5127,626894,2627232,332583883,6,22015,1845644,18147,1387302,3868,458342,5409,29,7311,130,6,448,144444.0,39000.0,-70.0,-71.0,-68.0,-60.0,-69.0,-70.0,-68.0,-60.0,-90.0,-93.0,-89.0,-92.0,20.0,22.0,21.0,32.0,0
600,CC:2F:71:3F:1F:24,3766257,1973139863,1139025,1640555980,2627232,332583883,21,456278,425744720,452397,425277064,3881,467656,430495,581,1141102,130005,21,4604,86667.0,14444.0,-73.0,-66.0,-73.0,-67.0,-74.0,-66.0,-72.0,-67.0,-90.0,-93.0,-89.0,-92.0,17.0,27.0,16.0,25.0,0
601,F8:59:71:5A:E0:3D,2654278,374147281,27044,41563196,2627234,332584085,0,3141,386365,3068,373558,73,12807,3042,0,27056,865,0,23,130000.0,39000.0,-74.0,-80.0,-77.0,-75.0,-67.0,-72.0,-67.0,-70.0,-90.0,-93.0,-89.0,-92.0,16.0,13.0,12.0,17.0,0
602,CC:2F:71:3E:C5:1F,2632361,333210979,5127,626894,2627234,332584085,6,22015,1845644,18147,1387302,3868,458342,5409,29,7311,130,6,448,144444.0,39000.0,-70.0,-71.0,-68.0,-60.0,-69.0,-70.0,-68.0,-60.0,-90.0,-93.0,-89.0,-92.0,20.0,22.0,21.0,32.0,0
603,CC:2F:71:3F:1F:24,3770641,1980011819,1143405,1647427532,2627236,332584287,21,456953,425830384,453072,425362728,3881,467656,431164,581,1145391,130109,21,4605,86667.0,14444.0,-73.0,-67.0,-74.0,-67.0,-73.0,-66.0,-73.0,-67.0,-90.0,-93.0,-89.0,-92.0,17.0,26.0,15.0,25.0,0
604,F8:59:71:5A:E0:3D,2654286,374148063,27045,41563312,2627241,332584751,0,3143,386505,3070,373698,73,12807,3042,0,27057,865,0,23,130000.0,39000.0,-65.0,-64.0,-64.0,-64.0,-67.0,-70.0,-67.0,-69.0,-90.0,-93.0,-89.0,-92.0,25.0,29.0,25.0,28.0,0
605,CC:2F:71:3E:C5:1F,2632370,333211823,5128,627010,2627242,332584813,6,22017,1845784,18149,1387442,3868,458342,5409,29,7312,130,6,448,144444.0,39000.0,-71.0,-71.0,-68.0,-60.0,-70.0,-70.0,-68.0,-60.0,-90.0,-93.0,-89.0,-92.0,19.0,22.0,21.0,32.0,0
606,CC:2F:71:3F:1F:24,3775164,1987092595,1147920,1654507580,2627244,332585015,21,457478,425898354,453597,425430698,3881,467656,431688,581,1149936,130458,21,4605,86667.0,14444.0,-74.0,-67.0,-73.0,-67.0,-74.0,-66.0,-73.0,-67.0,-90.0,-93.0,-89.0,-92.0,16.0,26.0,16.0,25.0,0
607,F8:59:71:5A:E0:3D,2654293,374148731,27045,41563312,2627248,332585419,0,3145,386693,3071,373768,74,12925,3043,0,27057,865,0,23,130000.0,39000.0,-66.0,-72.0,-65.0,-70.0,-67.0,-70.0,-67.0,-69.0,-90.0,-93.0,-90.0,-93.0,24.0,21.0,25.0,23.0,0
608,CC:2F:71:3E:C5:1F,2632378,333212631,5128,627010,2627250,332585621,6,22017,1845784,18149,1387442,3868,458342,5409,29,7312,130,6,448,144444.0,39000.0,-71.0,-71.0,-68.0,-60.0,-70.0,-70.0,-68.0,-60.0,-90.0,-93.0,-90.0,-93.0,19.0,22.0,22.0,33.0,0
609,CC:2F:71:3F:1F:24,3779024,1993129269,1151774,1660543648,2627250,332585621,21,458088,425974354,454207,425506698,3881,467656,432298,581,1153786,130619,21,4605,86667.0,14444.0,-74.0,-66.0,-75.0,-69.0,-74.0,-65.0,-74.0,-68.0,-90.0,-93.0,-90.0,-93.0,16.0,27.0,15.0,24.0,0
610,F8:59:71:5A:E0:3D,2654299,374149468,27045,41563312,2627254,332586156,0,3145,386693,3071,373768,74,12925,3043,0,27057,865,0,23,130000.0,39000.0,-66.0,-72.0,-65.0,-70.0,-67.0,-70.0,-67.0,-69.0,-90.0,-93.0,-90.0,-93.0,24.0,21.0,25.0,23.0,0
611,CC:2F:71:3E:C5:1F,2632382,333213166,5128,627010,2627254,332586156,6,22017,1845784,18149,1387442,3868,458342,5409,29,7312,130,6,448,144444.0,39000.0,-71.0,-71.0,-68.0,-60.0,-70.0,-70.0,-68.0,-60.0,-90.0,-93.0,-90.0,-93.0,19.0,22.0,22.0,33.0,0
612,CC:2F:71:3F:1F:24,3782257,1998184030,1155003,1665597874,2627254,332586156,21,458582,426036114,454701,425568458,3881,467656,432792,581,1157080,131068,21,4607,86667.0,14444.0,-75.0,-67.0,-74.0,-67.0,-74.0,-66.0,-73.0,-67.0,-90.0,-93.0,-90.0,-93.0,15.0,26.0,16.0,26.0,0
613,F8:59:71:5A:E0:3D,2654305,374150074,27045,41563312,2627260,332586762,0,3145,386693,3071,373768,74,12925,3043,0,27057,865,0,23,130000.0,39000.0,-66.0,-72.0,-65.0,-70.0,-67.0,-70.0,-67.0,-69.0,-90.0,-93.0,-90.0,-93.0,24.0,21.0,25.0,23.0,0
614,CC:2F:71:3E:C5:1F,2632388,333213772,5128,627010,2627260,332586762,6,22017,1845784,18149,1387442,3868,458342,5409,29,7312,130,6,448,144444.0,39000.0,-71.0,-71.0,-68.0,-60.0,-70.0,-70.0,-68.0,-60.0,-90.0,-93.0,-90.0,-93.0,19.0,22.0,22.0,33.0,0
615,CC:2F:71:3F:1F:24,3786236,2004412542,1158976,1671825780,2627260,332586762,21,459306,426125008,455425,425657352,3881,467656,433516,581,1161004,131100,21,4607,86667.0,14444.0,-75.0,-67.0,-75.0,-67.0,-74.0,-67.0,-75.0,-67.0,-90.0,-93.0,-90.0,-93.0,15.0,26.0,15.0,26.0,0
616,F8:59:71:5A:E0:3D,2654308,374150336,27045,41563312,2627263,332587024,0,3145,386693,3071,373768,74,12925,3043,0,27057,865,0,23,130000.0,39000.0,-66.0,-72.0,-65.0,-70.0,-67.0,-70.0,-67.0,-69.0,-90.0,-93.0,-90.0,-93.0,24.0,21.0,25.0,23.0,0
617,CC:2F:71:3E:C5:1F,2632391,333214034,5128,627010,2627263,332587024,6,22017,1845784,18149,1387442,3868,458342,5409,29,7312,130,6,448,144444.0,39000.0,-71.0,-71.0,-68.0,-60.0,-70.0,-70.0,-68.0,-60.0,-90.0,-93.0,-90.0,-93.0,19.0,22.0,22.0,33.0,0
618,CC:2F:71:3F:1F:24,3789529,2009563272,1162266,1676976248,2627263,332587024,21,459865,426194356,455984,425726700,3881,467656,434074,581,1164343,131266,21,4607,130000.0,43333.0,-75.0,-67.0,-75.0,-67.0,-74.0,-66.0,-75.0,-67.0,-90.0,-93.0,-90.0,-93.0,15.0,26.0,15.0,26.0,0
619,F8:59:71:5A:E0:3D,2654314,374150942,27045,41563312,2627269,332587630,0,3145,386693,3071,373768,74,12925,3043,0,27057,865,0,23,130000.0,39000.0,-66.0,-72.0,-65.0,-70.0,-67.0,-70.0,-67.0,-69.0,-90.0,-93.0,-90.0,-93.0,24.0,21.0,25.0,23.0,0
620,CC:2F:71:3E:C5:1F,2632399,333214842,5128,627010,2627271,332587832,6,22017,1845784,18149,1387442,3868,458342,5409,29,7312,130,6,448,144444.0,39000.0,-71.0,-71.0,-68.0,-60.0,-70.0,-70.0,-68.0,-60.0,-90.0,-93.0,-90.0,-93.0,19.0,22.0,22.0,33.0,0
621,CC:2F:71:3F:1F:24,3794580,2017483134,1167309,1684895302,2627271,332587832,21,460633,426287680,456752,425820024,3881,467656,434841,581,1169289,132224,21,4607,104000.0,26000.0,-75.0,-67.0,-74.0,-67.0,-74.0,-66.0,-74.0,-67.0,-90.0,-93.0,-90.0,-93.0,15.0,26.0,16.0,26.0,0
622,F8:59:71:5A:E0:3D,2654319,374151406,27045,41563312,2627274,332588094,0,3145,386693,3071,373768,74,12925,3043,0,27057,865,0,23,130000.0,39000.0,-66.0,-72.0,-65.0,-70.0,-67.0,-70.0,-67.0,-69.0,-90.0,-93.0,-90.0,-93.0,24.0,21.0,25.0,23.0,0
623,CC:2F:71:3E:C5:1F,2632406,333215508,5128,627010,2627278,332588498,6,22017,1845784,18149,1387442,3868,458342,5409,29,7312,130,6,448,144444.0,39000.0,-71.0,-71.0,-68.0,-60.0,-70.0,-70.0,-68.0,-60.0,-90.0,-93.0,-90.0,-93.0,19.0,22.0,22.0,33.0,0
624,CC:2F:71:3F:1F:24,3798916,2024271162,1171638,1691682664,2627278,332588498,21,461165,426355148,457284,425887492,3881,467656,435373,581,1173715,133236,21,4607,115556.0,28889.0,-74.0,-67.0,-73.0,-69.0,-74.0,-66.0,-73.0,-68.0,-90.0,-93.0,-90.0,-93.0,16.0,26.0,17.0,24.0,0
625,F8:59:71:5A:E0:3D,2654325,374152012,27045,41563312,2627280,332588700,0,3145,386693,3071,373768,74,12925,3043,0,27057,865,0,23,130000.0,39000.0,-66.0,-72.0,-65.0,-70.0,-67.0,-70.0,-67.0,-69.0,-90.0,-93.0,-90.0,-93.0,24.0,21.0,25.0,23.0,0
626,CC:2F:71:3E:C5:1F,2632419,333221134,5128,627010,2627291,332594124,6,22019,1845924,18151,1387582,3868,458342,5409,29,7313,130,6,448,144444.0,39000.0,-65.0,-69.0,-64.0,-60.0,-70.0,-72.0,-68.0,-61.0,-90.0,-93.0,-90.0,-93.0,25.0,24.0,26.0,33.0,0
627,CC:2F:71:3F:1F:24,3801946,2028993054,1174655,1696398930,2627291,332594124,21,461516,426400594,457635,425932938,3881,467656,435722,581,1176720,134510,21,4607,86667.0,14444.0,-75.0,-67.0,-74.0,-68.0,-75.0,-67.0,-73.0,-68.0,-90.0,-93.0,-90.0,-93.0,15.0,26.0,16.0,25.0,0
628,F8:59:71:5A:E0:3D,2654354,374163526,27045,41563312,2627309,332600214,0,3147,386833,3073,373908,74,12925,3043,0,27058,865,0,23,130000.0,39000.0,-74.0,-80.0,-76.0,-75.0,-68.0,-72.0,-69.0,-70.0,-90.0,-93.0,-90.0,-93.0,16.0,13.0,14.0,18.0,0
629,CC:2F:71:3E:C5:1F,2632437,333227224,5128,627010,2627309,332600214,6,22019,1845924,18151,1387582,3868,458342,5409,29,7313,130,6,448,144444.0,39000.0,-65.0,-69.0,-64.0,-60.0,-70.0,-72.0,-68.0,-61.0,-90.0,-93.0,-90.0,-93.0,25.0,24.0,26.0,33.0,0
630,CC:2F:71:3F:1F:24,3805523,2034569820,1178212,1701969404,2627311,332600416,21,462005,426461898,458124,425994242,3881,467656,436210,581,1180289,135138,21,4608,117000.0,39000.0,-74.0,-67.0,-74.0,-67.0,-74.0,-66.0,-73.0,-67.0,-90.0,-93.0,-90.0,-93.0,16.0,26.0,16.0,26.0,0
631,F8:59:71:5A:E0:3D,2654358,374163930,27045,41563312,2627313,332600618,0,3147,386833,3073,373908,74,12925,3043,0,27058,865,0,23,130000.0,39000.0,-74.0,-80.0,-76.0,-75.0,-68.0,-72.0,-69.0,-70.0,-90.0,-93.0,-90.0,-93.0,16.0,13.0,14.0,18.0,0
632,CC:2F:71:3E:C5:1F,2632443,333227752,5128,627010,2627315,332600742,6,22020,1846042,18151,1387582,3869,458460,5410,29,7313,130,6,448,144444.0,39000.0,-70.0,-71.0,-68.0,-60.0,-70.0,-72.0,-68.0,-61.0,-90.0,-93.0,-90.0,-93.0,20.0,22.0,22.0,33.0,0
633,CC:2F:71:3F:1F:24,3809163,2040261976,1181846,1707661032,2627317,332600944,21,462528,426527300,458646,426059526,3882,467774,436733,581,1183864,135538,21,4608,86667.0,14444.0,-74.0,-66.0,-75.0,-70.0,-73.0,-66.0,-74.0,-70.0,-90.0,-93.0,-90.0,-93.0,16.0,27.0,15.0,23.0,0
634,F8:59:71:5A:E0:3D,2654367,374164720,27045,41563312,2627322,332601408,0,3147,386833,3073,373908,74,12925,3043,0,27058,865,0,23,130000.0,39000.0,-74.0,-80.0,-76.0,-75.0,-68.0,-72.0,-69.0,-70.0,-90.0,-93.0,-90.0,-93.0,16.0,13.0,14.0,18.0,0
635,CC:2F:71:3E:C5:1F,2632450,333228418,5128,627010,2627322,332601408,6,22021,1846112,18152,1387652,3869,458460,5410,29,7313,130,6,448,144444.0,39000.0,-70.0,-71.0,-68.0,-60.0,-70.0,-72.0,-68.0,-61.0,-90.0,-93.0,-90.0,-93.0,20.0,22.0,22.0,33.0,0
636,CC:2F:71:3F:1F:24,3812932,2046159392,1185610,1713557984,2627322,332601408,21,463173,426606966,459291,426139192,3882,467774,437378,581,1187664,135634,21,4609,86667.0,14444.0,-73.0,-67.0,-76.0,-69.0,-73.0,-67.0,-76.0,-69.0,-90.0,-93.0,-90.0,-93.0,17.0,26.0,14.0,24.0,0
637,F8:59:71:5A:E0:3D,2654371,374165124,27045,41563312,2627326,332601812,0,3147,386833,3073,373908,74,12925,3043,0,27058,865,0,23,130000.0,39000.0,-74.0,-80.0,-76.0,-75.0,-68.0,-72.0,-69.0,-70.0,-90.0,-93.0,-90.0,-93.0,16.0,13.0,14.0,18.0,0
638,CC:2F:71:3E:C5:1F,2632454,333228822,5128,627010,2627326,332601812,6,22021,1846112,18152,1387652,3869,458460,5410,29,7313,130,6,448,144444.0,39000.0,-70.0,-71.0,-68.0,-60.0,-70.0,-72.0,-68.0,-61.0,-90.0,-93.0,-90.0,-93.0,20.0,22.0,22.0,33.0,0
639,CC:2F:71:3F:1F:24,3817022,2052557713,1189694,1719955699,2627328,332602014,21,463747,426678537,459865,426210763,3882,467774,437952,581,1191718,136130,21,4609,86667.0,14444.0,-73.0,-64.0,-73.0,-71.0,-72.0,-64.0,-73.0,-69.0,-91.0,-94.0,-90.0,-94.0,18.0,30.0,17.0,23.0,0
640,F8:59:71:5A:E0:3D,2654378,374165790,27045,41563312,2627333,332602478,0,3147,386833,3073,373908,74,12925,3043,0,27058,865,0,23,130000.0,39000.0,-74.0,-80.0,-76.0,-75.0,-68.0,-72.0,-69.0,-70.0,-91.0,-94.0,-90.0,-94.0,17.0,14.0,14.0,19.0,0
641,CC:2F:71:3E:C5:1F,2632461,333229488,5128,627010,2627333,332602478,6,22021,1846112,18152,1387652,3869,458460,5410,29,7313,130,6,448,144444.0,39000.0,-70.0,-71.0,-68.0,-60.0,-70.0,-72.0,-68.0,-61.0,-91.0,-94.0,-90.0,-94.0,21.0,23.0,22.0,34.0,0
642,CC:2F:71:3F:1F:24,3821446,2059487191,1194113,1726884713,2627333,332602478,21,464551,426776885,460669,426309111,3882,467774,438756,581,1196150,136312,21,4609,115556.0,28889.0,-71.0,-64.0,-73.0,-71.0,-70.0,-64.0,-73.0,-71.0,-91.0,-94.0,-90.0,-94.0,20.0,30.0,17.0,23.0,0
643,F8:59:71:5A:E0:3D,2654385,374166669,27045,41563312,2627340,332603357,0,3147,386833,3073,373908,74,12925,3043,0,27058,865,0,23,130000.0,39000.0,-74.0,-80.0,-76.0,-75.0,-68.0,-72.0,-69.0,-70.0,-91.0,-94.0,-90.0,-94.0,17.0,14.0,14.0,19.0,0
644,CC:2F:71:3E:C5:1F,2632468,333230367,5128,627010,2627340,332603357,6,22021,1846112,18152,1387652,3869,458460,5410,29,7313,130,6,448,144444.0,39000.0,-70.0,-71.0,-68.0,-60.0,-70.0,-72.0,-68.0,-61.0,-91.0,-94.0,-90.0,-94.0,21.0,23.0,22.0,34.0,0
645,CC:2F:71:3F:1F:24,3826215,2066957634,1198875,1734354277,2627340,332603357,21,465167,426854139,461285,426386365,3882,467774,439372,581,1200952,137191,21,4610,130000.0,39000.0,-75.0,-68.0,-77.0,-75.0,-72.0,-65.0,-74.0,-72.0,-91.0,-94.0,-90.0,-94.0,16.0,26.0,13.0,19.0,0
646,F8:59:71:5A:E0:3D,2654387,374166871,27045,41563312,2627342,332603559,0,3147,386833,3073,373908,74,12925,3043,0,27058,865,0,23,130000.0,39000.0,-74.0,-80.0,-76.0,-75.0,-68.0,-72.0,-69.0,-70.0,-91.0,-94.0,-90.0,-94.0,17.0,14.0,14.0,19.0,0
647,CC:2F:71:3E:C5:1F,2632473,333230831,5128,627010,2627345,332603821,6,22021,1846112,18152,1387652,3869,458460,5410,29,7313,130,6,448,144444.0,39000.0,-70.0,-71.0,-68.0,-60.0,-70.0,-72.0,-68.0,-61.0,-91.0,-94.0,-90.0,-94.0,21.0,23.0,22.0,34.0,0
648,CC:2F:71:3F:1F:24,3830270,2073305956,1202923,1740701933,2627347,332604023,21,465582,426908867,461700,426441093,3882,467774,439787,581,1205000,137350,21,4612,130000.0,43333.0,-73.0,-65.0,-76.0,-70.0,-72.0,-64.0,-74.0,-69.0,-91.0,-94.0,-90.0,-94.0,18.0,29.0,14.0,24.0,0
649,F8:59:71:5A:E0:3D,2654394,374167537,27045,41563312,2627349,332604225,0,3147,386833,3073,373908,74,12925,3043,0,27058,865,0,23,130000.0,39000.0,-74.0,-80.0,-76.0,-75.0,-68.0,-72.0,-69.0,-70.0,-91.0,-94.0,-90.0,-94.0,17.0,14.0,14.0,19.0,0
650,CC:2F:71:3E:C5:1F,2632477,333231235,5128,627010,2627349,332604225,6,22021,1846112,18152,1387652,3869,458460,5410,29,7313,130,6,448,144444.0,39000.0,-70.0,-71.0,-68.0,-60.0,-70.0,-72.0,-68.0,-61.0,-91.0,-94.0,-90.0,-94.0,21.0,23.0,22.0,34.0,0
651,CC:2F:71:3F:1F:24,3833401,2078204176,1206052,1745599951,2627349,332604225,21,465978,426957485,462096,426489711,3882,467774,440183,581,1208104,138227,21,4612,130000.0,43333.0,-71.0,-65.0,-76.0,-69.0,-71.0,-65.0,-75.0,-69.0,-91.0,-94.0,-90.0,-94.0,20.0,29.0,14.0,25.0,0
652,F8:59:71:5A:E0:3D,2654398,374167941,27045,41563312,2627353,332604629,0,3147,386833,3073,373908,74,12925,3043,0,27058,865,0,23,130000.0,39000.0,-74.0,-80.0,-76.0,-75.0,-68.0,-72.0,-69.0,-70.0,-91.0,-93.0,-90.0,-94.0,17.0,13.0,14.0,19.0,0
653,CC:2F:71:3E:C5:1F,2632483,333231841,5128,627010,2627355,332604831,6,22021,1846112,18152,1387652,3869,458460,5410,29,7313,130,6,448,144444.0,39000.0,-70.0,-71.0,-68.0,-60.0,-70.0,-72.0,-68.0,-61.0,-91.0,-93.0,-90.0,-94.0,21.0,22.0,22.0,34.0,0
654,CC:2F:71:3F:1F:24,3836525,2083034838,1209170,1750430007,2627355,332604831,21,466516,427033481,462634,426565707,3882,467774,440721,581,1211247,138735,21,4617,130000.0,43333.0,-72.0,-65.0,-75.0,-69.0,-71.0,-65.0,-75.0,-69.0,-91.0,-93.0,-90.0,-94.0,19.0,28.0,15.0,25.0,0
655,F8:59:71:5A:E0:3D,2654403,374168405,27045,41563312,2627358,332605093,0,3147,386833,3073,373908,74,12925,3043,0,27058,865,0,23,130000.0,39000.0,-74.0,-80.0,-76.0,-75.0,-68.0,-72.0,-69.0,-70.0,-91.0,-93.0,-90.0,-94.0,17.0,13.0,14.0,19.0,0
656,CC:2F:71:3E:C5:1F,2632488,333232305,5128,627010,2627360,332605295,6,22021,1846112,18152,1387652,3869,458460,5410,29,7313,130,6,448,144444.0,39000.0,-70.0,-71.0,-68.0,-60.0,-70.0,-72.0,-68.0,-61.0,-91.0,-93.0,-90.0,-94.0,21.0,22.0,22.0,34.0,0
657,CC:2F:71:3F:1F:24,3840828,2089768867,1213468,1757163572,2627360,332605295,21,467015,427098158,463133,426630384,3882,467774,441220,581,1215545,140823,21,4617,115556.0,26000.0,-71.0,-65.0,-76.0,-70.0,-71.0,-65.0,-75.0,-69.0,-91.0,-93.0,-90.0,-94.0,20.0,28.0,14.0,24.0,0
658,F8:59:71:5A:E0:3D,2654409,374169011,27045,41563312,2627364,332605699,0,3147,386833,3073,373908,74,12925,3043,0,27058,865,0,23,130000.0,39000.0,-74.0,-80.0,-76.0,-75.0,-68.0,-72.0,-69.0,-70.0,-91.0,-93.0,-90.0,-94.0,17.0,13.0,14.0,19.0,0
659,CC:2F:71:3E:C5:1F,2632492,333232709,5128,627010,2627364,332605699,6,22021,1846112,18152,1387652,3869,458460,5410,29,7313,130,6,448,144444.0,39000.0,-70.0,-71.0,-68.0,-60.0,-70.0,-72.0,-68.0,-61.0,-91.0,-93.0,-90.0,-94.0,21.0,22.0,22.0,34.0,0
660,CC:2F:71:3F:1F:24,3845763,2097501043,1218397,1764895142,2627366,332605901,21,467552,427167484,463670,426699710,3882,467774,441757,581,1220424,141081,21,4617,115556.0,28889.0,-72.0,-65.0,-76.0,-70.0,-72.0,-65.0,-75.0,-69.0,-91.0,-93.0,-90.0,-94.0,19.0,28.0,14.0,24.0,0
661,F8:59:71:5A:E0:3D,2654414,374169475,27045,41563312,2627369,332606163,0,3147,386833,3073,373908,74,12925,3043,0,27058,865,0,23,130000.0,39000.0,-74.0,-80.0,-76.0,-75.0,-68.0,-72.0,-69.0,-70.0,-91.0,-93.0,-90.0,-94.0,17.0,13.0,14.0,19.0,0
662,CC:2F:71:3E:C5:1F,2632497,333233173,5128,627010,2627369,332606163,6,22021,1846112,18152,1387652,3869,458460,5410,29,7313,130,6,448,144444.0,39000.0,-70.0,-71.0,-68.0,-60.0,-70.0,-72.0,-68.0,-61.0,-91.0,-93.0,-90.0,-94.0,21.0,22.0,22.0,34.0,0
663,CC:2F:71:3F:1F:24,3849827,2103866187,1222458,1771260024,2627369,332606163,21,468034,427228061,464152,426760287,3882,467774,442235,581,1224508,141326,21,4619,115556.0,28889.0,-73.0,-66.0,-76.0,-70.0,-72.0,-65.0,-76.0,-69.0,-91.0,-93.0,-90.0,-94.0,18.0,27.0,14.0,24.0,0
664,F8:59:71:5A:E0:3D,2654420,374170081,27045,41563312,2627375,332606769,0,3147,386833,3073,373908,74,12925,3043,0,27058,865,0,23,130000.0,39000.0,-74.0,-80.0,-76.0,-75.0,-68.0,-72.0,-69.0,-70.0,-91.0,-93.0,-90.0,-94.0,17.0,13.0,14.0,19.0,0
665,CC:2F:71:3E:C5:1F,2632503,333233779,5128,627010,2627375,332606769,6,22021,1846112,18152,1387652,3869,458460,5410,29,7313,130,6,448,144444.0,39000.0,-70.0,-71.0,-68.0,-60.0,-70.0,-72.0,-68.0,-61.0,-91.0,-93.0,-90.0,-94.0,21.0,22.0,22.0,34.0,0
666,CC:2F:71:3F:1F:24,3854411,2111046181,1227036,1778439412,2627375,332606769,21,468701,427310621,464819,426842847,3882,467774,442902,581,1229113,141788,21,4620,115556.0,28889.0,-72.0,-65.0,-76.0,-70.0,-72.0,-65.0,-75.0,-69.0,-91.0,-93.0,-90.0,-94.0,19.0,28.0,14.0,24.0,0
667,F8:59:71:5A:E0:3D,2654424,374170459,27046,41563428,2627378,332607031,0,3148,386903,3074,373978,74,12925,3043,0,27059,865,0,23,130000.0,39000.0,-65.0,-68.0,-63.0,-63.0,-67.0,-71.0,-67.0,-68.0,-91.0,-93.0,-90.0,-94.0,26.0,25.0,27.0,31.0,0
668,CC:2F:71:3E:C5:1F,2632507,333234157,5129,627126,2627378,332607031,6,22023,1846252,18154,1387792,3869,458460,5410,29,7314,130,6,448,144444.0,39000.0,-64.0,-64.0,-62.0,-61.0,-70.0,-73.0,-68.0,-63.0,-91.0,-93.0,-90.0,-94.0,27.0,29.0,28.0,33.0,0
669,CC:2F:71:3F:1F:24,3858835,2117976869,1231455,1785369636,2627380,332607233,21,469306,427385990,465424,426918216,3882,467774,443501,581,1233520,141858,21,4620,115556.0,28889.0,-73.0,-66.0,-77.0,-70.0,-72.0,-66.0,-76.0,-70.0,-91.0,-93.0,-90.0,-94.0,18.0,27.0,13.0,24.0,0
670,F8:59:71:5A:E0:3D,2654430,374171065,27046,41563428,2627384,332607637,0,3149,386973,3075,374048,74,12925,3043,0,27059,865,0,23,130000.0,39000.0,-74.0,-78.0,-79.0,-75.0,-67.0,-71.0,-67.0,-68.0,-91.0,-93.0,-90.0,-94.0,17.0,15.0,11.0,19.0,0
671,CC:2F:71:3E:C5:1F,2632513,333234763,5129,627126,2627384,332607637,6,22023,1846252,18154,1387792,3869,458460,5410,29,7314,130,6,448,144444.0,39000.0,-64.0,-64.0,-62.0,-61.0,-70.0,-73.0,-68.0,-63.0,-91.0,-93.0,-90.0,-94.0,27.0,29.0,28.0,33.0,0
672,CC:2F:71:3F:1F:24,3863389,2125056173,1236005,1792448536,2627384,332607637,21,469926,427464078,466044,426996304,3882,467774,444121,581,1238063,142115,21,4621,115556.0,28889.0,-72.0,-65.0,-75.0,-69.0,-72.0,-65.0,-75.0,-69.0,-91.0,-93.0,-90.0,-94.0,19.0,28.0,15.0,25.0,0
673,F8:59:71:5A:E0:3D,2654432,374171267,27046,41563428,2627386,332607839,0,3149,386973,3075,374048,74,12925,3043,0,27059,865,0,23,130000.0,39000.0,-74.0,-78.0,-79.0,-75.0,-67.0,-71.0,-67.0,-68.0,-91.0,-93.0,-90.0,-94.0,17.0,15.0,11.0,19.0,0
674,CC:2F:71:3E:C5:1F,2632519,333235369,5129,627126,2627390,332608243,6,22023,1846252,18154,1387792,3869,458460,5410,29,7314,130,6,448,144444.0,39000.0,-64.0,-64.0,-62.0,-61.0,-70.0,-73.0,-68.0,-63.0,-91.0,-93.0,-90.0,-94.0,27.0,29.0,28.0,33.0,0
675,CC:2F:71:3F:1F:24,3868924,2133732751,1241533,1801124448,2627391,332608303,21,470626,427551413,466744,427083639,3882,467774,444820,581,1243610,142285,21,4621,115556.0,28889.0,-73.0,-65.0,-76.0,-70.0,-72.0,-65.0,-75.0,-69.0,-91.0,-93.0,-90.0,-94.0,18.0,28.0,14.0,24.0,0
676,F8:59:71:5A:E0:3D,2654441,374172268,27046,41563428,2627395,332608840,0,3149,386973,3075,374048,74,12925,3043,0,27059,865,0,23,130000.0,39000.0,-74.0,-78.0,-79.0,-75.0,-67.0,-71.0,-67.0,-68.0,-91.0,-93.0,-90.0,-94.0,17.0,15.0,11.0,19.0,0
677,CC:2F:71:3E:C5:1F,2632526,333236168,5129,627126,2627397,332609042,6,22025,1846440,18155,1387862,3870,458578,5411,29,7314,130,6,448,144444.0,39000.0,-69.0,-71.0,-68.0,-60.0,-70.0,-73.0,-68.0,-63.0,-91.0,-93.0,-90.0,-94.0,22.0,22.0,22.0,34.0,0
678,CC:2F:71:3F:1F:24,3873181,2140397440,1245784,1807788398,2627397,332609042,21,471190,427621241,467308,427153467,3882,467774,445383,581,1247861,142596,21,4622,130000.0,43333.0,-72.0,-66.0,-75.0,-67.0,-71.0,-66.0,-75.0,-67.0,-91.0,-93.0,-90.0,-94.0,19.0,27.0,15.0,27.0,0
679,F8:59:71:5A:E0:3D,2654447,374172874,27046,41563428,2627401,332609446,0,3149,386973,3075,374048,74,12925,3043,0,27059,865,0,23,130000.0,39000.0,-74.0,-78.0,-79.0,-75.0,-67.0,-71.0,-67.0,-68.0,-91.0,-93.0,-90.0,-94.0,17.0,15.0,11.0,19.0,0
680,CC:2F:71:3E:C5:1F,2632530,333236572,5129,627126,2627401,332609446,6,22025,1846440,18155,1387862,3870,458578,5411,29,7314,130,6,448,144444.0,39000.0,-69.0,-71.0,-68.0,-60.0,-70.0,-73.0,-68.0,-63.0,-91.0,-93.0,-90.0,-94.0,22.0,22.0,22.0,34.0,0
681,CC:2F:71:3F:1F:24,3876573,2145700220,1249172,1813090774,2627401,332609446,21,471560,427667605,467678,427199831,3882,467774,445750,581,1251227,143142,21,4622,130000.0,43333.0,-71.0,-65.0,-74.0,-67.0,-71.0,-65.0,-74.0,-66.0,-91.0,-93.0,-90.0,-94.0,20.0,28.0,16.0,27.0,0
682,F8:59:71:5A:E0:3D,2654452,374173338,27046,41563428,2627406,332609910,0,3149,386973,3075,374048,74,12925,3043,0,27059,865,0,23,130000.0,39000.0,-74.0,-78.0,-79.0,-75.0,-67.0,-71.0,-67.0,-68.0,-91.0,-93.0,-90.0,-94.0,17.0,15.0,11.0,19.0,0
683,CC:2F:71:3E:C5:1F,2632535,333237036,5129,627126,2627406,332609910,6,22025,1846440,18155,1387862,3870,458578,5411,29,7314,130,6,448,144444.0,39000.0,-69.0,-71.0,-68.0,-60.0,-70.0,-73.0,-68.0,-63.0,-91.0,-93.0,-90.0,-94.0,22.0,22.0,22.0,34.0,0
684,CC:2F:71:3F:1F:24,3881362,2153211252,1253956,1820601342,2627406,332609910,21,472317,427761543,468435,427293769,3882,467774,446507,581,1256028,143665,21,4622,130000.0,43333.0,-72.0,-65.0,-74.0,-67.0,-71.0,-65.0,-74.0,-66.0,-91.0,-93.0,-90.0,-94.0,19.0,28.0,16.0,27.0,0
685,F8:59:71:5A:E0:3D,2654456,374173742,27046,41563428,2627410,332610314,0,3149,386973,3075,374048,74,12925,3043,0,27059,865,0,23,130000.0,39000.0,-74.0,-78.0,-79.0,-75.0,-67.0,-71.0,-67.0,-68.0,-91.0,-93.0,-90.0,-94.0,17.0,15.0,11.0,19.0,0
686,CC:2F:71:3E:C5:1F,2632539,333237440,5129,627126,2627410,332610314,6,22025,1846440,18155,1387862,3870,458578,5411,29,7314,130,6,448,144444.0,39000.0,-69.0,-71.0,-68.0,-60.0,-70.0,-73.0,-68.0,-63.0,-91.0,-93.0,-90.0,-94.0,22.0,22.0,22.0,34.0,0
687,CC:2F:71:3F:1F:24,3886253,2160880196,1258841,1828269680,2627412,332610516,21,473086,427855269,469204,427387495,3882,467774,447276,581,1260822,143984,21,4623,117000.0,39000.0,-74.0,-65.0,-74.0,-67.0,-74.0,-65.0,-73.0,-67.0,-91.0,-93.0,-90.0,-94.0,17.0,28.0,16.0,27.0,0
688,F8:59:71:5A:E0:3D,2654461,374174206,27046,41563428,2627415,332610778,0,3149,386973,3075,374048,74,12925,3043,0,27059,865,0,23,130000.0,39000.0,-74.0,-78.0,-79.0,-75.0,-67.0,-71.0,-67.0,-68.0,-91.0,-93.0,-90.0,-94.0,17.0,15.0,11.0,19.0,0
689,CC:2F:71:3E:C5:1F,2632547,333238487,5132,627709,2627415,332610778,6,22030,1847185,18160,1388607,3870,458578,5416,29,7317,132,6,448,144444.0,39000.0,-69.0,-70.0,-69.0,-60.0,-68.0,-70.0,-68.0,-60.0,-91.0,-93.0,-90.0,-94.0,22.0,23.0,21.0,34.0,0
690,CC:2F:71:3F:1F:24,3890858,2168054878,1263443,1835444100,2627415,332610778,21,473635,427929366,469753,427461592,3882,467774,447825,581,1265506,144109,21,4623,130000.0,43333.0,-73.0,-64.0,-76.0,-70.0,-72.0,-63.0,-75.0,-69.0,-91.0,-93.0,-90.0,-94.0,18.0,29.0,14.0,24.0,0
691,F8:59:71:5A:E0:3D,2654467,374174798,27046,41563428,2627421,332611370,0,3149,386973,3075,374048,74,12925,3043,0,27059,865,0,23,130000.0,39000.0,-74.0,-78.0,-79.0,-75.0,-67.0,-71.0,-67.0,-68.0,-91.0,-93.0,-90.0,-94.0,17.0,15.0,11.0,19.0,0
692,CC:2F:71:3E:C5:1F,2632554,333239209,5133,627839,2627421,332611370,6,22031,1847255,18161,1388677,3870,458578,5416,29,7318,132,6,448,144444.0,39000.0,-69.0,-71.0,-68.0,-60.0,-69.0,-70.0,-68.0,-60.0,-91.0,-93.0,-90.0,-94.0,22.0,22.0,22.0,34.0,0
693,CC:2F:71:3F:1F:24,3895951,2176017058,1268528,1843405486,2627423,332611572,21,474210,428008413,470327,427540521,3883,467892,448400,581,1270605,144238,21,4623,130000.0,43333.0,-73.0,-65.0,-75.0,-69.0,-72.0,-64.0,-74.0,-69.0,-91.0,-93.0,-90.0,-94.0,18.0,28.0,15.0,25.0,0
694,F8:59:71:5A:E0:3D,2654474,374175632,27046,41563428,2627428,332612204,0,3151,387161,3076,374118,75,13043,3044,0,27059,865,0,24,130000.0,39000.0,-67.0,-71.0,-64.0,-73.0,-68.0,-72.0,-67.0,-71.0,-91.0,-93.0,-90.0,-94.0,24.0,22.0,26.0,21.0,0
695,CC:2F:71:3E:C5:1F,2632565,333240447,5133,627839,2627432,332612608,6,22031,1847255,18161,1388677,3870,458578,5416,29,7318,132,6,448,144444.0,39000.0,-69.0,-71.0,-68.0,-60.0,-69.0,-70.0,-68.0,-60.0,-91.0,-93.0,-90.0,-94.0,22.0,22.0,22.0,34.0,0
696,CC:2F:71:3F:1F:24,3902014,2185274896,1274581,1852662228,2627433,332612668,21,475156,428171431,471273,427703539,3883,467892,449346,581,1276658,144925,21,4623,130000.0,43333.0,-72.0,-65.0,-76.0,-69.0,-72.0,-65.0,-75.0,-69.0,-91.0,-93.0,-90.0,-94.0,19.0,28.0,14.0,25.0,0
697,F8:59:71:5A:E0:3D,2654483,374176500,27046,41563428,2627437,332613072,0,3151,387161,3076,374118,75,13043,3044,0,27059,865,0,24,130000.0,39000.0,-67.0,-71.0,-64.0,-73.0,-68.0,-72.0,-67.0,-71.0,-91.0,-93.0,-90.0,-94.0,24.0,22.0,26.0,21.0,0
698,CC:2F:71:3E:C5:1F,2632570,333240911,5133,627839,2627437,332613072,6,22031,1847255,18161,1388677,3870,458578,5416,29,7318,132,6,448,144444.0,39000.0,-69.0,-71.0,-68.0,-60.0,-69.0,-70.0,-68.0,-60.0,-91.0,-93.0,-90.0,-94.0,22.0,22.0,22.0,34.0,0
699,CC:2F:71:3F:1F:24,3906853,2192772388,1279416,1860159316,2627437,332613072,21,475699,428241507,471816,427773615,3883,467892,449889,581,1281477,145225,21,4623,130000.0,43333.0,-72.0,-65.0,-73.0,-68.0,-72.0,-65.0,-75.0,-68.0,-91.0,-93.0,-90.0,-94.0,19.0,28.0,17.0,26.0,0
700,F8:59:71:5A:E0:3D,2654487,374176904,27046,41563428,2627441,332613476,0,3151,387161,3076,374118,75,13043,3044,0,27059,865,0,24,130000.0,39000.0,-67.0,-71.0,-64.0,-73.0,-68.0,-72.0,-67.0,-71.0,-91.0,-93.0,-90.0,-94.0,24.0,22.0,26.0,21.0,0
701,CC:2F:71:3E:C5:1F,2632574,333241315,5133,627839,2627441,332613476,6,22031,1847255,18161,1388677,3870,458578,5416,29,7318,132,6,448,144444.0,39000.0,-69.0,-71.0,-68.0,-60.0,-69.0,-70.0,-68.0,-60.0,-91.0,-93.0,-90.0,-94.0,22.0,22.0,22.0,34.0,0
702,CC:2F:71:3F:1F:24,3911565,2200127154,1284124,1867513678,2627441,332613476,21,476323,428328711,472440,427860819,3883,467892,450513,581,1286156,145717,21,4623,130000.0,43333.0,-72.0,-64.0,-73.0,-69.0,-72.0,-64.0,-74.0,-69.0,-91.0,-93.0,-90.0,-94.0,19.0,29.0,17.0,25.0,0
703,F8:59:71:5A:E0:3D,2654492,374177368,27046,41563428,2627446,332613940,0,3151,387161,3076,374118,75,13043,3044,0,27059,865,0,24,130000.0,39000.0,-67.0,-71.0,-64.0,-73.0,-68.0,-72.0,-67.0,-71.0,-91.0,-93.0,-90.0,-94.0,24.0,22.0,26.0,21.0,0
704,CC:2F:71:3E:C5:1F,2632579,333241779,5133,627839,2627446,332613940,6,22031,1847255,18161,1388677,3870,458578,5416,29,7318,132,6,448,144444.0,39000.0,-69.0,-71.0,-68.0,-60.0,-69.0,-70.0,-68.0,-60.0,-91.0,-93.0,-90.0,-94.0,22.0,22.0,22.0,34.0,0
705,CC:2F:71:3F:1F:24,3917395,2209182594,1289949,1876568654,2627446,332613940,21,477082,428434402,473199,427966510,3883,467892,451271,581,1292026,145931,21,4623,130000.0,43333.0,-73.0,-65.0,-76.0,-69.0,-72.0,-64.0,-74.0,-69.0,-91.0,-93.0,-90.0,-94.0,18.0,28.0,14.0,25.0,0
706,F8:59:71:5A:E0:3D,2654498,374177974,27046,41563428,2627452,332614546,0,3151,387161,3076,374118,75,13043,3044,0,27059,865,0,24,130000.0,39000.0,-67.0,-71.0,-64.0,-73.0,-68.0,-72.0,-67.0,-71.0,-91.0,-93.0,-90.0,-94.0,24.0,22.0,26.0,21.0,0
707,CC:2F:71:3E:C5:1F,2632586,333242501,5134,627955,2627452,332614546,6,22034,1847501,18164,1388923,3870,458578,5417,29,7319,132,6,448,144444.0,39000.0,-70.0,-71.0,-69.0,-60.0,-69.0,-69.0,-68.0,-60.0,-91.0,-93.0,-90.0,-94.0,21.0,22.0,21.0,34.0,0
708,CC:2F:71:3F:1F:24,3923519,2218792362,1296065,1886177614,2627454,332614748,21,478120,428558306,474237,428090414,3883,467892,452308,581,1298110,146569,21,4623,130000.0,43333.0,-73.0,-65.0,-75.0,-69.0,-72.0,-65.0,-75.0,-69.0,-91.0,-93.0,-90.0,-94.0,18.0,28.0,15.0,25.0,0
709,F8:59:71:5A:E0:3D,2654501,374178236,27046,41563428,2627455,332614808,0,3151,387161,3076,374118,75,13043,3044,0,27059,865,0,24,130000.0,39000.0,-67.0,-71.0,-64.0,-73.0,-68.0,-72.0,-67.0,-71.0,-90.0,-93.0,-90.0,-93.0,23.0,22.0,26.0,20.0,0
710,CC:2F:71:3E:C5:1F,2632589,333242763,5134,627955,2627455,332614808,6,22034,1847501,18164,1388923,3870,458578,5417,29,7319,132,6,448,144444.0,39000.0,-70.0,-71.0,-69.0,-60.0,-69.0,-69.0,-68.0,-60.0,-90.0,-93.0,-90.0,-93.0,20.0,22.0,21.0,33.0,0
711,CC:2F:71:3F:1F:24,3925905,2222484287,1298450,1889869479,2627455,332614808,21,478514,428613939,474631,428146047,3883,467892,452699,581,1300503,146627,21,4623,130000.0,43333.0,-72.0,-65.0,-75.0,-69.0,-72.0,-64.0,-75.0,-69.0,-90.0,-93.0,-90.0,-93.0,18.0,28.0,15.0,24.0,0
712,F8:59:71:5A:E0:3D,2654508,374179115,27046,41563428,2627462,332615687,0,3151,387161,3076,374118,75,13043,3044,0,27059,865,0,24,130000.0,39000.0,-67.0,-71.0,-64.0,-73.0,-68.0,-72.0,-67.0,-71.0,-90.0,-93.0,-90.0,-93.0,23.0,22.0,26.0,20.0,0
713,CC:2F:71:3E:C5:1F,2632596,333243642,5134,627955,2627462,332615687,6,22034,1847501,18164,1388923,3870,458578,5417,29,7319,132,6,448,144444.0,39000.0,-70.0,-71.0,-69.0,-60.0,-69.0,-69.0,-68.0,-60.0,-90.0,-93.0,-90.0,-93.0,20.0,22.0,21.0,33.0,0
714,CC:2F:71:3F:1F:24,3928715,2226772501,1301251,1894156612,2627464,332615889,21,479040,428710367,475157,428242475,3883,467892,453223,581,1303328,146684,21,4623,130000.0,43333.0,-76.0,-68.0,-79.0,-73.0,-76.0,-68.0,-78.0,-72.0,-90.0,-93.0,-90.0,-93.0,14.0,25.0,11.0,20.0,0
715,F8:59:71:5A:E0:3D,2654510,374179317,27046,41563428,2627464,332615889,0,3151,387161,3076,374118,75,13043,3044,0,27059,865,0,24,130000.0,39000.0,-67.0,-71.0,-64.0,-73.0,-68.0,-72.0,-67.0,-71.0,-90.0,-93.0,-90.0,-93.0,23.0,22.0,26.0,20.0,0
716,CC:2F:71:3E:C5:1F,2632599,333243904,5134,627955,2627465,332615949,6,22034,1847501,18164,1388923,3870,458578,5417,29,7319,132,6,448,144444.0,39000.0,-70.0,-71.0,-69.0,-60.0,-69.0,-69.0,-68.0,-60.0,-90.0,-93.0,-90.0,-93.0,20.0,22.0,21.0,33.0,0
717,CC:2F:71:3F:1F:24,3932532,2232745335,1305065,1900129184,2627467,332616151,21,479602,428780431,475719,428312539,3883,467892,453757,581,1307132,146908,21,4623,130000.0,43333.0,-72.0,-65.0,-76.0,-69.0,-72.0,-66.0,-75.0,-70.0,-90.0,-93.0,-90.0,-93.0,18.0,28.0,14.0,24.0,0
718,F8:59:71:5A:E0:3D,2654519,374180185,27046,41563428,2627473,332616757,0,3151,387161,3076,374118,75,13043,3044,0,27059,865,0,24,130000.0,39000.0,-67.0,-71.0,-64.0,-73.0,-68.0,-72.0,-67.0,-71.0,-90.0,-93.0,-90.0,-93.0,23.0,22.0,26.0,20.0,0
719,CC:2F:71:3E:C5:1F,2632607,333244712,5134,627955,2627473,332616757,6,22034,1847501,18164,1388923,3870,458578,5417,29,7319,132,6,448,144444.0,39000.0,-70.0,-71.0,-69.0,-60.0,-69.0,-69.0,-68.0,-60.0,-90.0,-93.0,-90.0,-93.0,20.0,22.0,21.0,33.0,0
720,CC:2F:71:3F:1F:24,3937803,2241012599,1310330,1908395842,2627473,332616757,21,480205,428855953,476322,428388061,3883,467892,454343,581,1312329,147553,21,4623,117000.0,39000.0,-72.0,-64.0,-75.0,-69.0,-74.0,-68.0,-76.0,-72.0,-90.0,-93.0,-90.0,-93.0,18.0,29.0,15.0,24.0,0
721,F8:59:71:5A:E0:3D,2654524,374180649,27046,41563428,2627478,332617221,0,3151,387161,3076,374118,75,13043,3044,0,27059,865,0,24,130000.0,39000.0,-67.0,-71.0,-64.0,-73.0,-68.0,-72.0,-67.0,-71.0,-90.0,-93.0,-90.0,-93.0,23.0,22.0,26.0,20.0,0
722,CC:2F:71:3E:C5:1F,2632616,333245580,5134,627955,2627482,332617625,6,22034,1847501,18164,1388923,3870,458578,5417,29,7319,132,6,448,144444.0,39000.0,-70.0,-71.0,-69.0,-60.0,-69.0,-69.0,-68.0,-60.0,-90.0,-93.0,-90.0,-93.0,20.0,22.0,21.0,33.0,0
723,CC:2F:71:3F:1F:24,3942968,2249094619,1315486,1916476994,2627482,332617625,23,480739,428922163,476856,428454271,3883,467892,454865,581,1317448,148898,23,4623,117000.0,39000.0,-72.0,-65.0,-75.0,-70.0,-71.0,-65.0,-75.0,-70.0,-90.0,-93.0,-90.0,-93.0,18.0,28.0,15.0,23.0,0
724,F8:59:71:5A:E0:3D,2654538,374182717,27048,41564284,2627490,332618433,0,3154,387531,3079,374488,75,13043,3046,0,27061,865,0,24,130000.0,39000.0,-67.0,-71.0,-64.0,-72.0,-69.0,-73.0,-69.0,-72.0,-90.0,-93.0,-90.0,-93.0,23.0,22.0,26.0,21.0,0
725,CC:2F:71:3E:C5:1F,2632625,333246448,5134,627955,2627491,332618493,6,22034,1847501,18164,1388923,3870,458578,5417,29,7319,132,6,448,144444.0,39000.0,-70.0,-71.0,-69.0,-60.0,-69.0,-69.0,-68.0,-60.0,-90.0,-93.0,-90.0,-93.0,20.0,22.0,21.0,33.0,0
726,CC:2F:71:3F:1F:24,3949294,2258988435,1321803,1926369942,2627491,332618493,28,482111,429088374,478228,428620482,3883,467892,456220,582,1323882,149273,28,4623,115556.0,28889.0,-71.0,-65.0,-76.0,-71.0,-71.0,-65.0,-76.0,-70.0,-90.0,-93.0,-90.0,-93.0,19.0,28.0,14.0,22.0,0
727,F8:59:71:5A:E0:3D,2654547,374183585,27048,41564284,2627499,332619301,0,3154,387531,3079,374488,75,13043,3046,0,27061,865,0,24,130000.0,39000.0,-67.0,-71.0,-64.0,-72.0,-69.0,-73.0,-69.0,-72.0,-90.0,-93.0,-90.0,-93.0,23.0,22.0,26.0,21.0,0
728,CC:2F:71:3E:C5:1F,2632633,333247256,5134,627955,2627499,332619301,6,22034,1847501,18164,1388923,3870,458578,5417,29,7319,132,6,448,144444.0,39000.0,-70.0,-71.0,-69.0,-60.0,-69.0,-69.0,-68.0,-60.0,-90.0,-93.0,-90.0,-93.0,20.0,22.0,21.0,33.0,0
729,CC:2F:71:3F:1F:24,3954813,2267550478,1327314,1934931177,2627499,332619301,30,482814,429207716,478931,428739824,3883,467892,456905,584,1329385,150312,30,4624,130000.0,43333.0,-73.0,-65.0,-76.0,-70.0,-72.0,-65.0,-75.0,-69.0,-90.0,-93.0,-90.0,-93.0,17.0,28.0,14.0,23.0,0
730,F8:59:71:5A:E0:3D,2654551,374183963,27049,41564400,2627502,332619563,0,3156,387671,3081,374628,75,13043,3046,0,27062,865,0,24,130000.0,39000.0,-67.0,-71.0,-65.0,-72.0,-68.0,-72.0,-67.0,-71.0,-90.0,-93.0,-90.0,-93.0,23.0,22.0,25.0,21.0,0
731,CC:2F:71:3E:C5:1F,2632637,333247634,5135,628071,2627502,332619563,6,22036,1847641,18166,1389063,3870,458578,5417,29,7320,132,6,448,144444.0,39000.0,-70.0,-72.0,-68.0,-61.0,-70.0,-71.0,-69.0,-61.0,-90.0,-93.0,-90.0,-93.0,20.0,21.0,22.0,32.0,0
732,CC:2F:71:3F:1F:24,3958944,2274019948,1331440,1941400183,2627504,332619765,32,483446,429284722,479563,428816830,3883,467892,457523,585,1333521,151225,32,4624,115556.0,28889.0,-81.0,-79.0,-83.0,-80.0,-74.0,-68.0,-76.0,-70.0,-90.0,-93.0,-90.0,-93.0,9.0,14.0,7.0,13.0,0
733,F8:59:71:5A:E0:3D,2654557,374184569,27049,41564400,2627508,332620169,0,3156,387671,3081,374628,75,13043,3046,0,27062,865,0,24,130000.0,39000.0,-67.0,-71.0,-65.0,-72.0,-68.0,-72.0,-67.0,-71.0,-90.0,-93.0,-90.0,-93.0,23.0,22.0,25.0,21.0,0
734,CC:2F:71:3E:C5:1F,2632643,333248240,5135,628071,2627508,332620169,6,22036,1847641,18166,1389063,3870,458578,5417,29,7320,132,6,448,144444.0,39000.0,-70.0,-72.0,-68.0,-61.0,-70.0,-71.0,-69.0,-61.0,-90.0,-93.0,-90.0,-93.0,20.0,21.0,22.0,32.0,0
735,CC:2F:71:3F:1F:24,3962195,2279100614,1334687,1946480445,2627508,332620169,32,483922,429343286,480039,428875394,3883,467892,457968,585,1336725,151445,32,4624,130000.0,43333.0,-76.0,-66.0,-74.0,-70.0,-76.0,-66.0,-74.0,-70.0,-90.0,-93.0,-90.0,-93.0,14.0,27.0,16.0,23.0,0
736,F8:59:71:5A:E0:3D,2654571,374186066,27051,41564632,2627520,332621434,0,3161,388141,3085,374980,76,13161,3049,0,27064,865,0,24,130000.0,39000.0,-67.0,-63.0,-63.0,-66.0,-67.0,-71.0,-65.0,-70.0,-90.0,-93.0,-90.0,-93.0,23.0,30.0,27.0,27.0,0
737,CC:2F:71:3E:C5:1F,2632655,333249505,5135,628071,2627520,332621434,6,22038,1847829,18167,1389133,3871,458696,5418,29,7320,132,6,448,144444.0,39000.0,-69.0,-71.0,-68.0,-60.0,-70.0,-71.0,-69.0,-61.0,-90.0,-93.0,-90.0,-93.0,21.0,22.0,22.0,33.0,0
738,CC:2F:71:3F:1F:24,3966986,2286592995,1339466,1953971561,2627520,332621434,32,484573,429423911,480690,428956019,3883,467892,458602,585,1341548,151626,32,4624,144444.0,43333.0,-75.0,-65.0,-73.0,-70.0,-75.0,-64.0,-73.0,-70.0,-90.0,-93.0,-90.0,-93.0,15.0,28.0,17.0,23.0,0
739,F8:59:71:5A:E0:3D,2654573,374186268,27051,41564632,2627522,332621636,0,3161,388141,3085,374980,76,13161,3049,0,27064,865,0,24,130000.0,39000.0,-67.0,-63.0,-63.0,-66.0,-67.0,-71.0,-65.0,-70.0,-90.0,-93.0,-90.0,-93.0,23.0,30.0,27.0,27.0,0
740,CC:2F:71:3E:C5:1F,2632657,333249707,5135,628071,2627522,332621636,6,22038,1847829,18167,1389133,3871,458696,5418,29,7320,132,6,448,144444.0,39000.0,-69.0,-71.0,-68.0,-60.0,-70.0,-71.0,-69.0,-61.0,-90.0,-93.0,-90.0,-93.0,21.0,22.0,22.0,33.0,0
741,CC:2F:71:3F:1F:24,3970789,2292546813,1343265,1959924975,2627524,332621838,32,485034,429482111,481151,429014219,3883,467892,459061,585,1345347,151881,32,4624,130000.0,43333.0,-78.0,-65.0,-72.0,-67.0,-77.0,-65.0,-71.0,-67.0,-90.0,-93.0,-90.0,-93.0,12.0,28.0,18.0,26.0,0
742,F8:59:71:5A:E0:3D,2654583,374187206,27051,41564632,2627532,332622574,0,3164,388533,3086,375050,78,13483,3051,0,27064,865,0,25,130000.0,39000.0,-67.0,-72.0,-65.0,-71.0,-67.0,-72.0,-65.0,-70.0,-90.0,-93.0,-90.0,-93.0,23.0,21.0,25.0,22.0,0
743,CC:2F:71:3E:C5:1F,2632667,333250645,5135,628071,2627532,332622574,6,22038,1847829,18167,1389133,3871,458696,5418,29,7320,132,6,448,144444.0,39000.0,-69.0,-71.0,-68.0,-60.0,-70.0,-71.0,-69.0,-61.0,-90.0,-93.0,-90.0,-93.0,21.0,22.0,22.0,33.0,0
744,CC:2F:71:3F:1F:24,3975055,2299174191,1347523,1966551617,2627532,332622574,32,485472,429553223,481588,429085213,3884,468010,459498,585,1349491,152274,32,4624,130000.0,43333.0,-74.0,-66.0,-73.0,-69.0,-74.0,-66.0,-72.0,-68.0,-90.0,-93.0,-90.0,-93.0,16.0,27.0,17.0,24.0,0
745,F8:59:71:5A:E0:3D,2654585,374187408,27051,41564632,2627534,332622776,0,3164,388533,3086,375050,78,13483,3051,0,27064,865,0,25,130000.0,39000.0,-67.0,-72.0,-65.0,-71.0,-67.0,-72.0,-65.0,-70.0,-90.0,-93.0,-90.0,-93.0,23.0,21.0,25.0,22.0,0
746,CC:2F:71:3E:C5:1F,2632673,333251251,5135,628071,2627538,332623180,6,22038,1847829,18167,1389133,3871,458696,5418,29,7320,132,6,448,144444.0,39000.0,-69.0,-71.0,-68.0,-60.0,-70.0,-71.0,-69.0,-61.0,-90.0,-93.0,-90.0,-93.0,21.0,22.0,22.0,33.0,0
747,CC:2F:71:3F:1F:24,3980195,2307211476,1352657,1974588296,2627538,332623180,32,486052,429627039,482168,429159029,3884,468010,460077,585,1354739,152523,32,4624,130000.0,39000.0,-73.0,-66.0,-72.0,-68.0,-73.0,-66.0,-72.0,-68.0,-90.0,-93.0,-90.0,-93.0,17.0,27.0,18.0,25.0,0
748,F8:59:71:5A:E0:3D,2654591,374188014,27051,41564632,2627540,332623382,0,3164,388533,3086,375050,78,13483,3051,0,27064,865,0,25,130000.0,39000.0,-67.0,-72.0,-65.0,-71.0,-67.0,-72.0,-65.0,-70.0,-90.0,-93.0,-90.0,-93.0,23.0,21.0,25.0,22.0,0
749,CC:2F:71:3E:C5:1F,2632676,333251513,5135,628071,2627541,332623442,6,22038,1847829,18167,1389133,3871,458696,5418,29,7320,132,6,448,144444.0,39000.0,-69.0,-71.0,-68.0,-60.0,-70.0,-71.0,-69.0,-61.0,-90.0,-93.0,-90.0,-93.0,21.0,22.0,22.0,33.0,0
750,CC:2F:71:3F:1F:24,3984671,2314224980,1357130,1981601538,2627541,332623442,32,486478,429680689,482594,429212679,3884,468010,460503,585,1359200,152901,32,4624,130000.0,43333.0,-74.0,-66.0,-73.0,-67.0,-74.0,-66.0,-72.0,-67.0,-90.0,-93.0,-90.0,-93.0,16.0,27.0,17.0,26.0,0
751,F8:59:71:5A:E0:3D,2654600,374188882,27051,41564632,2627549,332624250,0,3164,388533,3086,375050,78,13483,3051,0,27064,865,0,25,130000.0,39000.0,-67.0,-72.0,-65.0,-71.0,-67.0,-72.0,-65.0,-70.0,-90.0,-93.0,-90.0,-93.0,23.0,21.0,25.0,22.0,0
752,CC:2F:71:3E:C5:1F,2632684,333252321,5135,628071,2627549,332624250,6,22038,1847829,18167,1389133,3871,458696,5418,29,7320,132,6,448,144444.0,39000.0,-69.0,-71.0,-68.0,-60.0,-70.0,-71.0,-69.0,-61.0,-90.0,-93.0,-90.0,-93.0,21.0,22.0,22.0,33.0,0
753,CC:2F:71:3F:1F:24,3989859,2322351420,1362310,1989727170,2627549,332624250,32,487172,429765843,483288,429297833,3884,468010,461197,585,1364392,153074,32,4625,130000.0,43333.0,-73.0,-65.0,-75.0,-69.0,-73.0,-65.0,-75.0,-68.0,-90.0,-93.0,-90.0,-93.0,17.0,28.0,15.0,24.0,0
754,F8:59:71:5A:E0:3D,2654608,374191792,27051,41564632,2627557,332627160,0,3164,388533,3086,375050,78,13483,3051,0,27064,865,0,25,130000.0,39000.0,-67.0,-72.0,-65.0,-71.0,-67.0,-72.0,-65.0,-70.0,-90.0,-93.0,-90.0,-93.0,23.0,21.0,25.0,22.0,0
755,CC:2F:71:3E:C5:1F,2632692,333255231,5135,628071,2627557,332627160,6,22040,1847969,18169,1389273,3871,458696,5418,29,7321,132,6,448,144444.0,39000.0,-71.0,-72.0,-69.0,-60.0,-70.0,-72.0,-69.0,-61.0,-90.0,-93.0,-90.0,-93.0,19.0,21.0,21.0,33.0,0
756,CC:2F:71:3F:1F:24,3994729,2329965485,1367171,1997338265,2627558,332627220,32,487813,429846074,483929,429378064,3884,468010,461838,585,1369232,153463,32,4626,130000.0,43333.0,-75.0,-65.0,-75.0,-68.0,-75.0,-65.0,-75.0,-68.0,-90.0,-93.0,-90.0,-93.0,15.0,28.0,15.0,25.0,0
757,F8:59:71:5A:E0:3D,2654617,374192660,27051,41564632,2627566,332628028,0,3164,388533,3086,375050,78,13483,3051,0,27064,865,0,25,130000.0,39000.0,-67.0,-72.0,-65.0,-71.0,-67.0,-72.0,-65.0,-70.0,-90.0,-93.0,-90.0,-93.0,23.0,21.0,25.0,22.0,0
758,CC:2F:71:3E:C5:1F,2632701,333256099,5135,628071,2627566,332628028,6,22040,1847969,18169,1389273,3871,458696,5418,29,7321,132,6,448,144444.0,39000.0,-71.0,-72.0,-69.0,-60.0,-70.0,-72.0,-69.0,-61.0,-90.0,-93.0,-90.0,-93.0,19.0,21.0,21.0,33.0,0
759,CC:2F:71:3F:1F:24,3999871,2338014147,1372305,2005386119,2627566,332628028,32,488490,429930914,484606,429462904,3884,468010,462515,585,1374365,153583,32,4627,130000.0,43333.0,-74.0,-65.0,-74.0,-68.0,-74.0,-65.0,-74.0,-68.0,-90.0,-93.0,-90.0,-93.0,16.0,28.0,16.0,25.0,0
760,F8:59:71:5A:E0:3D,2654617,374192660,27051,41564632,2627566,332628028,0,3164,388533,3086,375050,78,13483,3051,0,27064,865,0,25,130000.0,39000.0,-67.0,-72.0,-65.0,-71.0,-67.0,-72.0,-65.0,-70.0,-90.0,-93.0,-90.0,-93.0,23.0,21.0,25.0,22.0,0
761,CC:2F:71:3E:C5:1F,2632701,333256099,5135,628071,2627566,332628028,6,22040,1847969,18169,1389273,3871,458696,5418,29,7321,132,6,448,144444.0,39000.0,-71.0,-72.0,-69.0,-60.0,-70.0,-72.0,-69.0,-61.0,-90.0,-93.0,-90.0,-93.0,19.0,21.0,21.0,33.0,0
762,CC:2F:71:3F:1F:24,4004971,2345971485,1377403,2013343255,2627568,332628230,32,489189,430034438,485305,429566428,3884,468010,463213,585,1379427,153892,32,4629,130000.0,39000.0,-75.0,-65.0,-75.0,-69.0,-74.0,-64.0,-74.0,-68.0,-90.0,-93.0,-90.0,-93.0,15.0,28.0,15.0,24.0,0
763,F8:59:71:5A:E0:3D,2654626,374193528,27051,41564632,2627575,332628896,0,3164,388533,3086,375050,78,13483,3051,0,27064,865,0,25,130000.0,39000.0,-67.0,-72.0,-65.0,-71.0,-67.0,-72.0,-65.0,-70.0,-90.0,-93.0,-90.0,-93.0,23.0,21.0,25.0,22.0,0
764,CC:2F:71:3E:C5:1F,2632710,333256967,5135,628071,2627575,332628896,6,22040,1847969,18169,1389273,3871,458696,5418,29,7321,132,6,448,144444.0,39000.0,-71.0,-72.0,-69.0,-60.0,-70.0,-72.0,-69.0,-61.0,-90.0,-92.0,-89.0,-92.0,19.0,20.0,20.0,32.0,0
765,CC:2F:71:3F:1F:24,4010022,2353871762,1382447,2021242866,2627575,332628896,32,489776,430109074,485892,429641064,3884,468010,463796,585,1384514,154034,32,4629,130000.0,43333.0,-75.0,-65.0,-75.0,-69.0,-74.0,-65.0,-75.0,-69.0,-90.0,-92.0,-89.0,-92.0,15.0,27.0,14.0,23.0,0
766,F8:59:71:5A:E0:3D,2654626,374193528,27051,41564632,2627575,332628896,0,3164,388533,3086,375050,78,13483,3051,0,27064,865,0,25,130000.0,39000.0,-67.0,-72.0,-65.0,-71.0,-67.0,-72.0,-65.0,-70.0,-90.0,-92.0,-89.0,-92.0,23.0,20.0,24.0,21.0,0
767,CC:2F:71:3E:C5:1F,2632712,333257169,5135,628071,2627577,332629098,6,22040,1847969,18169,1389273,3871,458696,5418,29,7321,132,6,448,144444.0,39000.0,-71.0,-72.0,-69.0,-60.0,-70.0,-72.0,-69.0,-61.0,-90.0,-92.0,-89.0,-92.0,19.0,20.0,20.0,32.0,0
768,CC:2F:71:3F:1F:24,4014817,2361389436,1387238,2028760136,2627579,332629300,32,490410,430187790,486526,429719780,3884,468010,464424,585,1389298,154137,32,4632,130000.0,43333.0,-73.0,-64.0,-72.0,-67.0,-73.0,-64.0,-74.0,-67.0,-90.0,-92.0,-89.0,-92.0,17.0,28.0,17.0,25.0,0
769,F8:59:71:5A:E0:3D,2654634,374194336,27051,41564632,2627583,332629704,0,3164,388533,3086,375050,78,13483,3051,0,27064,865,0,25,130000.0,39000.0,-67.0,-72.0,-65.0,-71.0,-67.0,-72.0,-65.0,-70.0,-90.0,-92.0,-89.0,-92.0,23.0,20.0,24.0,21.0,0
770,CC:2F:71:3E:C5:1F,2632718,333257775,5135,628071,2627583,332629704,6,22040,1847969,18169,1389273,3871,458696,5418,29,7321,132,6,448,144444.0,39000.0,-71.0,-72.0,-69.0,-60.0,-70.0,-72.0,-69.0,-61.0,-90.0,-92.0,-89.0,-92.0,19.0,20.0,20.0,32.0,0
771,CC:2F:71:3F:1F:24,4019441,2368632410,1391857,2036002646,2627584,332629764,32,490896,430248292,487012,429780282,3884,468010,464910,585,1393922,154422,32,4632,130000.0,43333.0,-74.0,-64.0,-74.0,-68.0,-74.0,-64.0,-74.0,-68.0,-90.0,-92.0,-89.0,-92.0,16.0,28.0,15.0,24.0,0
772,F8:59:71:5A:E0:3D,2654636,374194669,27051,41564632,2627585,332630037,0,3164,388533,3086,375050,78,13483,3051,0,27064,865,0,25,130000.0,39000.0,-67.0,-72.0,-65.0,-71.0,-67.0,-72.0,-65.0,-70.0,-90.0,-92.0,-89.0,-92.0,23.0,20.0,24.0,21.0,0
773,CC:2F:71:3E:C5:1F,2632722,333258310,5135,628071,2627587,332630239,6,22040,1847969,18169,1389273,3871,458696,5418,29,7321,132,6,448,144444.0,39000.0,-71.0,-72.0,-69.0,-60.0,-70.0,-72.0,-69.0,-61.0,-90.0,-92.0,-89.0,-92.0,19.0,20.0,20.0,32.0,0
774,CC:2F:71:3F:1F:24,4025134,2377497564,1397545,2044867123,2627589,332630441,32,491568,430347785,487684,429879775,3884,468010,465582,585,1399591,154499,32,4632,130000.0,43333.0,-74.0,-65.0,-75.0,-68.0,-74.0,-64.0,-74.0,-68.0,-90.0,-92.0,-89.0,-92.0,16.0,27.0,14.0,24.0,0
775,F8:59:71:5A:E0:3D,2654644,374195477,27051,41564632,2627593,332630845,0,3164,388533,3086,375050,78,13483,3051,0,27064,865,0,25,130000.0,39000.0,-67.0,-72.0,-65.0,-71.0,-67.0,-72.0,-65.0,-70.0,-90.0,-92.0,-89.0,-92.0,23.0,20.0,24.0,21.0,0
776,CC:2F:71:3E:C5:1F,2632728,333258916,5135,628071,2627593,332630845,6,22040,1847969,18169,1389273,3871,458696,5418,29,7321,132,6,448,144444.0,39000.0,-71.0,-72.0,-69.0,-60.0,-70.0,-72.0,-69.0,-61.0,-90.0,-92.0,-89.0,-92.0,19.0,20.0,20.0,32.0,0
777,CC:2F:71:3F:1F:24,4027935,2381868482,1400342,2049237637,2627593,332630845,32,491877,430387741,487993,429919731,3884,468010,465891,585,1402424,154592,32,4632,130000.0,43333.0,-74.0,-64.0,-74.0,-68.0,-74.0,-64.0,-74.0,-68.0,-90.0,-92.0,-89.0,-92.0,16.0,28.0,15.0,24.0,0
778,F8:59:71:5A:E0:3D,2654649,374195941,27051,41564632,2627598,332631309,0,3164,388533,3086,375050,78,13483,3051,0,27064,865,0,25,130000.0,39000.0,-67.0,-72.0,-65.0,-71.0,-67.0,-72.0,-65.0,-70.0,-90.0,-92.0,-89.0,-92.0,23.0,20.0,24.0,21.0,0
779,CC:2F:71:3E:C5:1F,2632733,333259380,5135,628071,2627598,332631309,6,22040,1847969,18169,1389273,3871,458696,5418,29,7321,132,6,448,144444.0,39000.0,-71.0,-72.0,-69.0,-60.0,-70.0,-72.0,-69.0,-61.0,-90.0,-92.0,-89.0,-92.0,19.0,20.0,20.0,32.0,0
780,CC:2F:71:3F:1F:24,4032619,2389209256,1405021,2056577947,2627598,332631309,32,492417,430456727,488533,429988717,3884,468010,466425,585,1407089,154823,32,4633,130000.0,43333.0,-74.0,-64.0,-74.0,-68.0,-74.0,-64.0,-74.0,-68.0,-90.0,-92.0,-89.0,-92.0,16.0,28.0,15.0,24.0,0
781,F8:59:71:5A:E0:3D,2654653,374196345,27051,41564632,2627602,332631713,0,3164,388533,3086,375050,78,13483,3051,0,27064,865,0,25,130000.0,39000.0,-67.0,-72.0,-65.0,-71.0,-67.0,-72.0,-65.0,-70.0,-90.0,-92.0,-89.0,-92.0,23.0,20.0,24.0,21.0,0
782,CC:2F:71:3E:C5:1F,2632737,333259784,5135,628071,2627602,332631713,6,22040,1847969,18169,1389273,3871,458696,5418,29,7321,132,6,448,144444.0,39000.0,-71.0,-72.0,-69.0,-60.0,-70.0,-72.0,-69.0,-61.0,-90.0,-92.0,-89.0,-92.0,19.0,20.0,20.0,32.0,0
783,CC:2F:71:3F:1F:24,4037910,2397508194,1410308,2064876481,2627602,332631713,32,493015,430531601,489131,430063591,3884,468010,467023,585,1412329,155107,32,4633,130000.0,39000.0,-74.0,-64.0,-74.0,-68.0,-73.0,-64.0,-74.0,-67.0,-90.0,-92.0,-89.0,-92.0,16.0,28.0,15.0,24.0,0
784,F8:59:71:5A:E0:3D,2654660,374197011,27051,41564632,2627609,332632379,0,3164,388533,3086,375050,78,13483,3051,0,27064,865,0,25,130000.0,39000.0,-67.0,-72.0,-65.0,-71.0,-67.0,-72.0,-65.0,-70.0,-90.0,-92.0,-89.0,-92.0,23.0,20.0,24.0,21.0,0
785,CC:2F:71:3E:C5:1F,2632744,333260450,5135,628071,2627609,332632379,6,22040,1847969,18169,1389273,3871,458696,5418,29,7321,132,6,448,144444.0,39000.0,-71.0,-72.0,-69.0,-60.0,-70.0,-72.0,-69.0,-61.0,-90.0,-92.0,-89.0,-92.0,19.0,20.0,20.0,32.0,0
786,CC:2F:71:3F:1F:24,4042200,2404216992,1414589,2071584411,2627611,332632581,32,493366,430578239,489482,430110229,3884,468010,467374,585,1416621,155293,32,4635,130000.0,43333.0,-74.0,-64.0,-74.0,-68.0,-73.0,-64.0,-74.0,-68.0,-90.0,-92.0,-89.0,-92.0,16.0,28.0,15.0,24.0,0
787,F8:59:71:5A:E0:3D,2654662,374197213,27051,41564632,2627611,332632581,0,3164,388533,3086,375050,78,13483,3051,0,27064,865,0,25,130000.0,39000.0,-67.0,-72.0,-65.0,-71.0,-67.0,-72.0,-65.0,-70.0,-90.0,-92.0,-89.0,-92.0,23.0,20.0,24.0,21.0,0
788,CC:2F:71:3E:C5:1F,2632746,333260652,5135,628071,2627611,332632581,6,22040,1847969,18169,1389273,3871,458696,5418,29,7321,132,6,448,144444.0,39000.0,-71.0,-72.0,-69.0,-60.0,-70.0,-72.0,-69.0,-61.0,-90.0,-92.0,-89.0,-92.0,19.0,20.0,20.0,32.0,0
789,CC:2F:71:3F:1F:24,4045762,2409796348,1418151,2077163767,2627611,332632581,32,493802,430632671,489918,430164661,3884,468010,467810,585,1420215,155356,32,4635,130000.0,43333.0,-80.0,-71.0,-81.0,-75.0,-79.0,-70.0,-79.0,-74.0,-90.0,-92.0,-89.0,-92.0,10.0,21.0,8.0,17.0,0
790,F8:59:71:5A:E0:3D,2654671,374198175,27052,41564786,2627619,332633389,0,3166,388743,3088,375260,78,13483,3052,0,27065,865,0,25,130000.0,39000.0,-67.0,-72.0,-64.0,-71.0,-66.0,-71.0,-64.0,-70.0,-90.0,-92.0,-89.0,-92.0,23.0,20.0,25.0,21.0,0
791,CC:2F:71:3E:C5:1F,2632757,333261888,5135,628071,2627622,332633817,6,22040,1847969,18169,1389273,3871,458696,5418,29,7321,132,6,448,144444.0,39000.0,-71.0,-72.0,-69.0,-60.0,-70.0,-72.0,-69.0,-61.0,-90.0,-92.0,-89.0,-92.0,19.0,20.0,20.0,32.0,0
792,CC:2F:71:3F:1F:24,4051281,2418442712,1423659,2085808895,2627622,332633817,32,494387,430706571,490503,430238561,3884,468010,468387,585,1425710,156151,32,4635,130000.0,43333.0,-73.0,-65.0,-73.0,-70.0,-73.0,-65.0,-73.0,-70.0,-90.0,-92.0,-89.0,-92.0,17.0,27.0,16.0,22.0,0
793,F8:59:71:5A:E0:3D,2654678,374199007,27052,41564786,2627626,332634221,0,3166,388743,3088,375260,78,13483,3052,0,27065,865,0,25,130000.0,39000.0,-67.0,-72.0,-64.0,-71.0,-66.0,-71.0,-64.0,-70.0,-90.0,-92.0,-89.0,-92.0,23.0,20.0,25.0,21.0,0
794,CC:2F:71:3E:C5:1F,2632761,333262292,5135,628071,2627626,332634221,6,22040,1847969,18169,1389273,3871,458696,5418,29,7321,132,6,448,144444.0,39000.0,-71.0,-72.0,-69.0,-60.0,-70.0,-72.0,-69.0,-61.0,-90.0,-92.0,-89.0,-92.0,19.0,20.0,20.0,32.0,0
795,CC:2F:71:3F:1F:24,4056084,2425968678,1428454,2093334053,2627630,332634625,32,495092,430792795,491208,430324785,3884,468010,469078,585,1430525,156351,32,4635,130000.0,43333.0,-74.0,-65.0,-74.0,-68.0,-73.0,-64.0,-73.0,-68.0,-90.0,-92.0,-89.0,-92.0,16.0,27.0,15.0,24.0,0
796,F8:59:71:5A:E0:3D,2654682,374199411,27052,41564786,2627630,332634625,0,3166,388743,3088,375260,78,13483,3052,0,27065,865,0,25,130000.0,39000.0,-67.0,-72.0,-64.0,-71.0,-66.0,-71.0,-64.0,-70.0,-90.0,-92.0,-89.0,-92.0,23.0,20.0,25.0,21.0,0
797,CC:2F:71:3E:C5:1F,2632765,333262696,5135,628071,2627630,332634625,6,22040,1847969,18169,1389273,3871,458696,5418,29,7321,132,6,448,144444.0,39000.0,-71.0,-72.0,-69.0,-60.0,-70.0,-72.0,-69.0,-61.0,-90.0,-92.0,-89.0,-92.0,19.0,20.0,20.0,32.0,0
798,CC:2F:71:3F:1F:24,4059662,2431571582,1432031,2098936897,2627631,332634685,32,495583,430854207,491699,430386197,3884,468010,469559,585,1434095,156463,32,4635,144444.0,43333.0,-74.0,-65.0,-73.0,-69.0,-74.0,-65.0,-73.0,-69.0,-90.0,-92.0,-89.0,-92.0,16.0,27.0,16.0,23.0,0
799,F8:59:71:5A:E0:3D,2654688,374199991,27053,41564902,2627635,332635089,0,3168,388883,3090,375400,78,13483,3052,0,27066,865,0,25,130000.0,39000.0,-74.0,-80.0,-81.0,-74.0,-67.0,-72.0,-66.0,-70.0,-90.0,-92.0,-89.0,-92.0,16.0,12.0,8.0,18.0,0
800,CC:2F:71:3E:C5:1F,2632771,333263276,5136,628187,2627635,332635089,6,22042,1848109,18171,1389413,3871,458696,5418,29,7322,132,6,448,144444.0,43333.0,-70.0,-72.0,-68.0,-60.0,-70.0,-73.0,-69.0,-61.0,-90.0,-92.0,-89.0,-92.0,20.0,20.0,21.0,32.0,0
801,CC:2F:71:3F:1F:24,4063972,2438320914,1436333,2105685421,2627639,332635493,32,496119,430921295,492235,430453285,3884,468010,470094,585,1438369,156610,32,4636,144444.0,43333.0,-73.0,-65.0,-73.0,-71.0,-73.0,-64.0,-73.0,-70.0,-90.0,-92.0,-89.0,-92.0,17.0,27.0,16.0,21.0,0
802,F8:59:71:5A:E0:3D,2654692,374200395,27053,41564902,2627639,332635493,0,3168,388883,3090,375400,78,13483,3052,0,27066,865,0,25,130000.0,39000.0,-74.0,-80.0,-81.0,-74.0,-67.0,-72.0,-66.0,-70.0,-90.0,-92.0,-89.0,-92.0,16.0,12.0,8.0,18.0,0
803,CC:2F:71:3E:C5:1F,2632775,333263680,5136,628187,2627639,332635493,6,22042,1848109,18171,1389413,3871,458696,5418,29,7322,132,6,448,144444.0,43333.0,-70.0,-72.0,-68.0,-60.0,-70.0,-73.0,-69.0,-61.0,-90.0,-92.0,-89.0,-92.0,20.0,20.0,21.0,32.0,0
804,CC:2F:71:3F:1F:24,4068225,2444904520,1440586,2112269027,2627639,332635493,32,496631,431019398,492747,430551388,3884,468010,470605,585,1442630,156727,32,4637,144444.0,43333.0,-73.0,-65.0,-74.0,-69.0,-72.0,-65.0,-74.0,-69.0,-90.0,-92.0,-89.0,-92.0,17.0,27.0,15.0,23.0,0
805,F8:59:71:5A:E0:3D,2654697,374200859,27053,41564902,2627644,332635957,0,3168,388883,3090,375400,78,13483,3052,0,27066,865,0,25,130000.0,39000.0,-74.0,-80.0,-81.0,-74.0,-67.0,-72.0,-66.0,-70.0,-90.0,-92.0,-89.0,-92.0,16.0,12.0,8.0,18.0,0
806,CC:2F:71:3E:C5:1F,2632780,333264144,5136,628187,2627644,332635957,6,22042,1848109,18171,1389413,3871,458696,5418,29,7322,132,6,448,144444.0,43333.0,-70.0,-72.0,-68.0,-60.0,-70.0,-73.0,-69.0,-61.0,-90.0,-92.0,-89.0,-92.0,20.0,20.0,21.0,32.0,0
807,CC:2F:71:3F:1F:24,4073955,2453885854,1446307,2121249493,2627648,332636361,32,497255,431096874,493371,430628864,3884,468010,471229,585,1448357,156858,32,4639,144444.0,43333.0,-73.0,-65.0,-74.0,-69.0,-72.0,-64.0,-74.0,-69.0,-90.0,-92.0,-89.0,-92.0,17.0,27.0,15.0,23.0,0
808,F8:59:71:5A:E0:3D,2654703,374201598,27053,41564902,2627650,332636696,0,3168,388883,3090,375400,78,13483,3052,0,27066,865,0,25,130000.0,39000.0,-74.0,-80.0,-81.0,-74.0,-67.0,-72.0,-66.0,-70.0,-90.0,-92.0,-89.0,-92.0,16.0,12.0,8.0,18.0,0
809,CC:2F:71:3E:C5:1F,2632786,333264883,5136,628187,2627650,332636696,6,22044,1848297,18172,1389483,3872,458814,5419,29,7322,132,6,448,144444.0,43333.0,-72.0,-74.0,-72.0,-66.0,-70.0,-72.0,-68.0,-60.0,-90.0,-92.0,-89.0,-92.0,18.0,18.0,17.0,26.0,0
810,CC:2F:71:3F:1F:24,4078644,2461237899,1450994,2128601203,2627650,332636696,32,497773,431161724,493889,430693714,3884,468010,471747,585,1453015,157075,32,4640,144444.0,43333.0,-73.0,-65.0,-74.0,-69.0,-73.0,-64.0,-74.0,-69.0,-90.0,-92.0,-89.0,-92.0,17.0,27.0,15.0,23.0,0
811,F8:59:71:5A:E0:3D,2654710,374202266,27053,41564902,2627657,332637364,0,3168,388883,3090,375400,78,13483,3052,0,27066,865,0,25,130000.0,39000.0,-74.0,-80.0,-81.0,-74.0,-67.0,-72.0,-66.0,-70.0,-90.0,-92.0,-89.0,-92.0,16.0,12.0,8.0,18.0,0
812,CC:2F:71:3E:C5:1F,2632795,333265753,5136,628187,2627659,332637566,6,22044,1848297,18172,1389483,3872,458814,5419,29,7322,132,6,448,144444.0,43333.0,-72.0,-74.0,-72.0,-66.0,-70.0,-72.0,-68.0,-60.0,-90.0,-92.0,-89.0,-92.0,18.0,18.0,17.0,26.0,0
813,CC:2F:71:3F:1F:24,4083794,2469302477,1456134,2136664851,2627660,332637626,32,498230,431220918,494345,430752790,3885,468128,472204,585,1458074,157330,32,4641,144444.0,43333.0,-73.0,-65.0,-74.0,-69.0,-73.0,-64.0,-74.0,-69.0,-90.0,-92.0,-89.0,-92.0,17.0,27.0,15.0,23.0,0
814,F8:59:71:5A:E0:3D,2654713,374202528,27053,41564902,2627660,332637626,0,3168,388883,3090,375400,78,13483,3052,0,27066,865,0,25,130000.0,39000.0,-74.0,-80.0,-81.0,-74.0,-67.0,-72.0,-66.0,-70.0,-90.0,-92.0,-89.0,-92.0,16.0,12.0,8.0,18.0,0
815,CC:2F:71:3E:C5:1F,2632796,333265813,5136,628187,2627660,332637626,6,22044,1848297,18172,1389483,3872,458814,5419,29,7322,132,6,448,144444.0,43333.0,-72.0,-74.0,-72.0,-66.0,-70.0,-72.0,-68.0,-60.0,-90.0,-92.0,-89.0,-92.0,18.0,18.0,17.0,26.0,0
816,CC:2F:71:3F:1F:24,4088204,2476218529,1460544,2143580903,2627660,332637626,32,498639,431273612,494754,430805484,3885,468128,472613,585,1462608,157609,32,4641,144444.0,43333.0,-72.0,-65.0,-74.0,-70.0,-72.0,-64.0,-74.0,-69.0,-90.0,-92.0,-89.0,-92.0,18.0,27.0,15.0,22.0,0
817,F8:59:71:5A:E0:3D,2654721,374203336,27053,41564902,2627668,332638434,0,3168,388883,3090,375400,78,13483,3052,0,27066,865,0,25,130000.0,39000.0,-74.0,-80.0,-81.0,-74.0,-67.0,-72.0,-66.0,-70.0,-90.0,-92.0,-89.0,-92.0,16.0,12.0,8.0,18.0,0
818,CC:2F:71:3E:C5:1F,2632804,333266621,5136,628187,2627668,332638434,6,22044,1848297,18172,1389483,3872,458814,5419,29,7322,132,6,448,144444.0,43333.0,-72.0,-74.0,-72.0,-66.0,-70.0,-72.0,-68.0,-60.0,-90.0,-92.0,-89.0,-92.0,18.0,18.0,17.0,26.0,0
819,CC:2F:71:3F:1F:24,4092824,2483454145,1465156,2150815711,2627668,332638434,32,499212,431344364,495327,430876236,3885,468128,473186,585,1467197,157836,32,4641,144444.0,43333.0,-73.0,-65.0,-75.0,-71.0,-72.0,-65.0,-74.0,-70.0,-90.0,-92.0,-89.0,-92.0,17.0,27.0,14.0,21.0,0
820,F8:59:71:5A:E0:3D,2654722,374203396,27053,41564902,2627669,332638494,0,3168,388883,3090,375400,78,13483,3052,0,27066,865,0,25,130000.0,39000.0,-74.0,-80.0,-81.0,-74.0,-67.0,-72.0,-66.0,-70.0,-90.0,-92.0,-89.0,-92.0,16.0,12.0,8.0,18.0,0
821,CC:2F:71:3E:C5:1F,2632807,333266883,5136,628187,2627671,332638696,6,22044,1848297,18172,1389483,3872,458814,5419,29,7322,132,6,448,144444.0,43333.0,-72.0,-74.0,-72.0,-66.0,-70.0,-72.0,-68.0,-60.0,-90.0,-92.0,-89.0,-92.0,18.0,18.0,17.0,26.0,0
822,CC:2F:71:3F:1F:24,4097679,2491069405,1470006,2158430507,2627673,332638898,32,499856,431423922,495971,430955794,3885,468128,473830,585,1471934,158378,32,4641,144444.0,43333.0,-73.0,-65.0,-75.0,-69.0,-72.0,-65.0,-74.0,-69.0,-90.0,-92.0,-89.0,-92.0,17.0,27.0,14.0,23.0,0
823,F8:59:71:5A:E0:3D,2654730,374204204,27053,41564902,2627677,332639302,0,3168,388883,3090,375400,78,13483,3052,0,27066,865,0,25,130000.0,39000.0,-74.0,-80.0,-81.0,-74.0,-67.0,-72.0,-66.0,-70.0,-90.0,-92.0,-89.0,-92.0,16.0,12.0,8.0,18.0,0
824,CC:2F:71:3E:C5:1F,2632813,333267489,5136,628187,2627677,332639302,6,22044,1848297,18172,1389483,3872,458814,5419,29,7322,132,6,448,144444.0,43333.0,-72.0,-74.0,-72.0,-66.0,-70.0,-72.0,-68.0,-60.0,-90.0,-92.0,-89.0,-92.0,18.0,18.0,17.0,26.0,0
825,CC:2F:71:3F:1F:24,4101811,2497414850,1474134,2164775548,2627677,332639302,32,500374,431522769,496489,431054641,3885,468128,474348,585,1476216,159466,32,4641,130000.0,43333.0,-73.0,-65.0,-75.0,-69.0,-73.0,-65.0,-74.0,-69.0,-90.0,-92.0,-89.0,-92.0,17.0,27.0,14.0,23.0,0
826,F8:59:71:5A:E0:3D,2654754,374215254,27053,41564902,2627701,332650352,0,3170,389023,3092,375540,78,13483,3052,0,27067,865,0,25,130000.0,39000.0,-67.0,-72.0,-64.0,-70.0,-68.0,-74.0,-68.0,-71.0,-90.0,-92.0,-89.0,-92.0,23.0,20.0,25.0,22.0,0
827,CC:2F:71:3E:C5:1F,2632839,333278741,5136,628187,2627703,332650554,6,22046,1848437,18174,1389623,3872,458814,5419,29,7323,132,6,448,144444.0,43333.0,-67.0,-64.0,-67.0,-60.0,-70.0,-71.0,-68.0,-60.0,-90.0,-92.0,-89.0,-92.0,23.0,28.0,22.0,32.0,0
828,CC:2F:71:3F:1F:24,4106267,2504368364,1478563,2171717750,2627704,332650614,32,500880,431586747,496995,431118619,3885,468128,474854,585,1480645,159508,32,4642,130000.0,43333.0,-73.0,-65.0,-74.0,-71.0,-73.0,-65.0,-74.0,-70.0,-90.0,-92.0,-89.0,-92.0,17.0,27.0,15.0,21.0,0
829,F8:59:71:5A:E0:3D,2654761,374215920,27053,41564902,2627708,332651018,0,3170,389023,3092,375540,78,13483,3052,0,27067,865,0,25,130000.0,39000.0,-67.0,-72.0,-64.0,-70.0,-68.0,-74.0,-68.0,-71.0,-90.0,-92.0,-89.0,-92.0,23.0,20.0,25.0,22.0,0
830,CC:2F:71:3E:C5:1F,2632844,333279205,5136,628187,2627708,332651018,6,22046,1848437,18174,1389623,3872,458814,5419,29,7323,132,6,448,144444.0,43333.0,-67.0,-64.0,-67.0,-60.0,-70.0,-71.0,-68.0,-60.0,-90.0,-92.0,-89.0,-92.0,23.0,28.0,22.0,32.0,0
831,CC:2F:71:3F:1F:24,4111007,2511794224,1483299,2179143206,2627708,332651018,32,501279,431637367,497394,431169239,3885,468128,475252,585,1485381,159935,32,4642,144444.0,43333.0,-73.0,-65.0,-75.0,-70.0,-73.0,-65.0,-74.0,-70.0,-90.0,-92.0,-89.0,-92.0,17.0,27.0,14.0,22.0,0
832,F8:59:71:5A:E0:3D,2654765,374216324,27053,41564902,2627712,332651422,0,3170,389023,3092,375540,78,13483,3052,0,27067,865,0,25,130000.0,39000.0,-67.0,-72.0,-64.0,-70.0,-68.0,-74.0,-68.0,-71.0,-90.0,-92.0,-89.0,-92.0,23.0,20.0,25.0,22.0,0
833,CC:2F:71:3E:C5:1F,2632848,333279609,5136,628187,2627712,332651422,6,22046,1848437,18174,1389623,3872,458814,5419,29,7323,132,6,448,144444.0,43333.0,-67.0,-64.0,-67.0,-60.0,-70.0,-71.0,-68.0,-60.0,-90.0,-92.0,-89.0,-92.0,23.0,28.0,22.0,32.0,0
834,CC:2F:71:3F:1F:24,4116167,2519886220,1488455,2187234798,2627712,332651422,32,501862,431709931,497977,431241803,3885,468128,475835,585,1490506,160214,32,4643,144444.0,43333.0,-73.0,-65.0,-74.0,-69.0,-73.0,-65.0,-74.0,-69.0,-90.0,-92.0,-89.0,-92.0,17.0,27.0,15.0,23.0,0
835,F8:59:71:5A:E0:3D,2654771,374216850,27053,41564902,2627718,332651948,0,3172,389211,3093,375610,79,13601,3053,0,27067,865,0,25,130000.0,39000.0,-67.0,-72.0,-64.0,-71.0,-68.0,-74.0,-68.0,-71.0,-90.0,-92.0,-89.0,-92.0,23.0,20.0,25.0,21.0,0
836,CC:2F:71:3E:C5:1F,2632854,333280135,5136,628187,2627718,332651948,6,22046,1848437,18174,1389623,3872,458814,5419,29,7323,132,6,448,144444.0,43333.0,-67.0,-64.0,-67.0,-60.0,-70.0,-71.0,-68.0,-60.0,-90.0,-92.0,-89.0,-92.0,23.0,28.0,22.0,32.0,0
837,CC:2F:71:3F:1F:24,4120598,2526826420,1492880,2194174472,2627718,332651948,32,502339,431771507,498454,431303379,3885,468128,476312,585,1494959,160420,32,4644,144444.0,43333.0,-73.0,-65.0,-74.0,-70.0,-72.0,-64.0,-74.0,-69.0,-90.0,-92.0,-89.0,-92.0,17.0,27.0,15.0,22.0,0
838,F8:59:71:5A:E0:3D,2654775,374217254,27053,41564902,2627722,332652352,0,3172,389211,3093,375610,79,13601,3053,0,27067,865,0,25,130000.0,39000.0,-67.0,-72.0,-64.0,-71.0,-68.0,-74.0,-68.0,-71.0,-90.0,-92.0,-89.0,-92.0,23.0,20.0,25.0,21.0,0
839,CC:2F:71:3E:C5:1F,2632858,333280539,5136,628187,2627722,332652352,6,22046,1848437,18174,1389623,3872,458814,5419,29,7323,132,6,448,144444.0,43333.0,-67.0,-64.0,-67.0,-60.0,-70.0,-71.0,-68.0,-60.0,-90.0,-92.0,-89.0,-92.0,23.0,28.0,22.0,32.0,0
840,CC:2F:71:3F:1F:24,4126990,2536855660,1499264,2204202904,2627726,332652756,32,503232,431882407,499347,431414279,3885,468128,477205,585,1501346,160617,32,4644,144444.0,43333.0,-72.0,-65.0,-74.0,-70.0,-72.0,-64.0,-74.0,-69.0,-90.0,-92.0,-89.0,-92.0,18.0,27.0,15.0,22.0,0
841,F8:59:71:5A:E0:3D,2654780,374217718,27053,41564902,2627727,332652816,0,3172,389211,3093,375610,79,13601,3053,0,27067,865,0,25,130000.0,39000.0,-67.0,-72.0,-64.0,-71.0,-68.0,-74.0,-68.0,-71.0,-90.0,-92.0,-89.0,-92.0,23.0,20.0,25.0,21.0,0
842,CC:2F:71:3E:C5:1F,2632863,333281003,5136,628187,2627727,332652816,6,22046,1848437,18174,1389623,3872,458814,5419,29,7323,132,6,448,144444.0,43333.0,-67.0,-64.0,-67.0,-60.0,-70.0,-71.0,-68.0,-60.0,-90.0,-92.0,-89.0,-92.0,23.0,28.0,22.0,32.0,0
843,CC:2F:71:3F:1F:24,4130315,2542059512,1502588,2209406696,2627727,332652816,32,503554,431923845,499669,431455717,3885,468128,477525,585,1504670,160767,32,4644,144444.0,43333.0,-72.0,-65.0,-75.0,-70.0,-72.0,-64.0,-74.0,-69.0,-90.0,-92.0,-89.0,-92.0,18.0,27.0,14.0,22.0,0
844,F8:59:71:5A:E0:3D,2654785,374218395,27053,41564902,2627732,332653493,0,3172,389211,3093,375610,79,13601,3053,0,27067,865,0,25,130000.0,39000.0,-67.0,-72.0,-64.0,-71.0,-68.0,-74.0,-68.0,-71.0,-90.0,-92.0,-89.0,-92.0,23.0,20.0,25.0,21.0,0
845,CC:2F:71:3E:C5:1F,2632870,333281882,5136,628187,2627734,332653695,6,22046,1848437,18174,1389623,3872,458814,5419,29,7323,132,6,448,144444.0,43333.0,-67.0,-64.0,-67.0,-60.0,-70.0,-71.0,-68.0,-60.0,-90.0,-92.0,-89.0,-92.0,23.0,28.0,22.0,32.0,0
846,CC:2F:71:3F:1F:24,4134435,2548451621,1506699,2215797724,2627736,332653897,32,503973,431994975,500088,431526847,3885,468128,477943,585,1508771,160825,32,4645,144444.0,43333.0,-73.0,-65.0,-74.0,-69.0,-72.0,-65.0,-74.0,-69.0,-90.0,-92.0,-89.0,-92.0,17.0,27.0,15.0,23.0,0
847,F8:59:71:5A:E0:3D,2654789,374218799,27053,41564902,2627736,332653897,0,3172,389211,3093,375610,79,13601,3053,0,27067,865,0,25,130000.0,39000.0,-67.0,-72.0,-64.0,-71.0,-68.0,-74.0,-68.0,-71.0,-90.0,-92.0,-89.0,-92.0,23.0,20.0,25.0,21.0,0
848,CC:2F:71:3E:C5:1F,2632872,333282084,5136,628187,2627736,332653897,6,22046,1848437,18174,1389623,3872,458814,5419,29,7323,132,6,448,144444.0,43333.0,-67.0,-64.0,-67.0,-60.0,-70.0,-71.0,-68.0,-60.0,-90.0,-92.0,-89.0,-92.0,23.0,28.0,22.0,32.0,0
849,CC:2F:71:3F:1F:24,4139332,2556137607,1511596,2223483710,2627736,332653897,32,504473,432058895,500588,431590767,3885,468128,478442,585,1513640,160983,32,4645,144444.0,43333.0,-73.0,-65.0,-74.0,-70.0,-72.0,-65.0,-74.0,-69.0,-90.0,-92.0,-89.0,-92.0,17.0,27.0,15.0,22.0,0
850,F8:59:71:5A:E0:3D,2654798,374219667,27053,41564902,2627745,332654765,0,3172,389211,3093,375610,79,13601,3053,0,27067,865,0,25,130000.0,39000.0,-67.0,-72.0,-64.0,-71.0,-68.0,-74.0,-68.0,-71.0,-90.0,-92.0,-89.0,-92.0,23.0,20.0,25.0,21.0,0
851,CC:2F:71:3E:C5:1F,2632881,333282952,5136,628187,2627745,332654765,6,22046,1848437,18174,1389623,3872,458814,5419,29,7323,132,6,448,144444.0,43333.0,-67.0,-64.0,-67.0,-60.0,-70.0,-71.0,-68.0,-60.0,-90.0,-92.0,-89.0,-92.0,23.0,28.0,22.0,32.0,0
852,CC:2F:71:3F:1F:24,4143840,2563186793,1516095,2230532028,2627745,332654765,32,504802,432103269,500917,431635141,3885,468128,478771,585,1518177,161077,32,4646,144444.0,43333.0,-73.0,-64.0,-74.0,-69.0,-73.0,-64.0,-74.0,-69.0,-90.0,-92.0,-89.0,-92.0,17.0,28.0,15.0,23.0,0
853,F8:59:71:5A:E0:3D,2654800,374219869,27053,41564902,2627747,332654967,0,3172,389211,3093,375610,79,13601,3053,0,27067,865,0,25,130000.0,39000.0,-67.0,-72.0,-64.0,-71.0,-68.0,-74.0,-68.0,-71.0,-90.0,-92.0,-89.0,-92.0,23.0,20.0,25.0,21.0,0
854,CC:2F:71:3E:C5:1F,2632885,333283356,5136,628187,2627749,332655169,6,22046,1848437,18174,1389623,3872,458814,5419,29,7323,132,6,448,144444.0,43333.0,-67.0,-64.0,-67.0,-60.0,-70.0,-71.0,-68.0,-60.0,-90.0,-92.0,-89.0,-92.0,23.0,28.0,22.0,32.0,0
855,CC:2F:71:3F:1F:24,4149212,2571612077,1521463,2238956908,2627749,332655169,32,505215,432155725,501330,431687597,3885,468128,479184,585,1523545,161492,32,4647,144444.0,43333.0,-74.0,-65.0,-73.0,-70.0,-74.0,-65.0,-73.0,-69.0,-90.0,-92.0,-89.0,-92.0,16.0,27.0,16.0,22.0,0
856,F8:59:71:5A:E0:3D,2654807,374220535,27053,41564902,2627754,332655633,0,3172,389211,3093,375610,79,13601,3053,0,27067,865,0,25,130000.0,39000.0,-67.0,-72.0,-64.0,-71.0,-68.0,-74.0,-68.0,-71.0,-90.0,-92.0,-89.0,-92.0,23.0,20.0,25.0,21.0,0
857,CC:2F:71:3E:C5:1F,2632890,333283820,5136,628187,2627754,332655633,6,22046,1848437,18174,1389623,3872,458814,5419,29,7323,132,6,448,144444.0,43333.0,-67.0,-64.0,-67.0,-60.0,-70.0,-71.0,-68.0,-60.0,-90.0,-92.0,-89.0,-92.0,23.0,28.0,22.0,32.0,0
858,CC:2F:71:3F:1F:24,4153479,2578293601,1525725,2245637968,2627754,332655633,32,505534,432197055,501649,431728927,3885,468128,479503,585,1527779,161801,32,4647,144444.0,43333.0,-74.0,-65.0,-72.0,-70.0,-74.0,-65.0,-72.0,-70.0,-90.0,-92.0,-89.0,-92.0,16.0,27.0,17.0,22.0,0
859,F8:59:71:5A:E0:3D,2654811,374220939,27053,41564902,2627758,332656037,0,3172,389211,3093,375610,79,13601,3053,0,27067,865,0,25,130000.0,39000.0,-67.0,-72.0,-64.0,-71.0,-68.0,-74.0,-68.0,-71.0,-90.0,-92.0,-89.0,-92.0,23.0,20.0,25.0,21.0,0
860,CC:2F:71:3E:C5:1F,2632894,333284224,5136,628187,2627758,332656037,6,22046,1848437,18174,1389623,3872,458814,5419,29,7323,132,6,448,144444.0,43333.0,-67.0,-64.0,-67.0,-60.0,-70.0,-71.0,-68.0,-60.0,-90.0,-92.0,-89.0,-92.0,23.0,28.0,22.0,32.0,0
861,CC:2F:71:3F:1F:24,4157674,2584865411,1529916,2252209374,2627758,332656037,32,506031,432259653,502146,431791525,3885,468128,480000,585,1531990,161922,32,4647,144444.0,43333.0,-76.0,-65.0,-74.0,-70.0,-75.0,-65.0,-73.0,-70.0,-90.0,-92.0,-89.0,-92.0,14.0,27.0,15.0,22.0,0
862,F8:59:71:5A:E0:3D,2654815,374221343,27053,41564902,2627762,332656441,0,3172,389211,3093,375610,79,13601,3053,0,27067,865,0,25,130000.0,39000.0,-67.0,-72.0,-64.0,-71.0,-68.0,-74.0,-68.0,-71.0,-90.0,-92.0,-89.0,-92.0,23.0,20.0,25.0,21.0,0
863,CC:2F:71:3E:C5:1F,2632899,333284688,5136,628187,2627763,332656501,6,22046,1848437,18174,1389623,3872,458814,5419,29,7323,132,6,448,144444.0,43333.0,-67.0,-64.0,-67.0,-60.0,-70.0,-71.0,-68.0,-60.0,-90.0,-92.0,-89.0,-92.0,23.0,28.0,22.0,32.0,0
864,CC:2F:71:3F:1F:24,4163064,2593315581,1535301,2260659080,2627763,332656501,32,506675,432338713,502790,431870585,3885,468128,480644,585,1537383,162821,32,4649,144444.0,43333.0,-73.0,-65.0,-75.0,-70.0,-73.0,-65.0,-74.0,-70.0,-90.0,-92.0,-89.0,-92.0,17.0,27.0,14.0,22.0,0
865,F8:59:71:5A:E0:3D,2654820,374221807,27053,41564902,2627767,332656905,0,3172,389211,3093,375610,79,13601,3053,0,27067,865,0,25,130000.0,39000.0,-67.0,-72.0,-64.0,-71.0,-68.0,-74.0,-68.0,-71.0,-90.0,-92.0,-90.0,-93.0,23.0,20.0,26.0,22.0,0
866,CC:2F:71:3E:C5:1F,2632903,333285092,5136,628187,2627767,332656905,6,22046,1848437,18174,1389623,3872,458814,5419,29,7323,132,6,448,144444.0,43333.0,-67.0,-64.0,-67.0,-60.0,-70.0,-71.0,-68.0,-60.0,-90.0,-92.0,-90.0,-93.0,23.0,28.0,23.0,33.0,0
867,CC:2F:71:3F:1F:24,4169265,2602998183,1541494,2270340874,2627771,332657309,32,507514,432459248,503629,431991120,3885,468128,481483,585,1543558,163109,32,4650,144444.0,43333.0,-72.0,-65.0,-73.0,-70.0,-71.0,-64.0,-73.0,-70.0,-90.0,-92.0,-90.0,-93.0,18.0,27.0,17.0,23.0,0
868,F8:59:71:5A:E0:3D,2654824,374222211,27053,41564902,2627771,332657309,0,3172,389211,3093,375610,79,13601,3053,0,27067,865,0,25,130000.0,39000.0,-67.0,-72.0,-64.0,-71.0,-68.0,-74.0,-68.0,-71.0,-90.0,-92.0,-90.0,-93.0,23.0,20.0,26.0,22.0,0
869,CC:2F:71:3E:C5:1F,2632907,333285496,5136,628187,2627771,332657309,6,22046,1848437,18174,1389623,3872,458814,5419,29,7323,132,6,448,144444.0,43333.0,-67.0,-64.0,-67.0,-60.0,-70.0,-71.0,-68.0,-60.0,-90.0,-92.0,-90.0,-93.0,23.0,28.0,23.0,33.0,0
870,CC:2F:71:3F:1F:24,4174737,2611583201,1546963,2278925630,2627774,332657571,32,508165,432539206,504280,432071078,3885,468128,482129,585,1549044,163251,32,4650,144444.0,43333.0,-72.0,-65.0,-73.0,-70.0,-71.0,-64.0,-73.0,-70.0,-90.0,-92.0,-90.0,-93.0,18.0,27.0,17.0,23.0,0
871,F8:59:71:5A:E0:3D,2654834,374223195,27054,41565018,2627780,332658177,0,3174,389351,3095,375750,79,13601,3053,0,27068,865,0,25,130000.0,39000.0,-65.0,-63.0,-64.0,-68.0,-68.0,-72.0,-68.0,-71.0,-90.0,-92.0,-90.0,-93.0,25.0,29.0,26.0,25.0,0
872,CC:2F:71:3E:C5:1F,2632917,333286424,5137,628247,2627780,332658177,6,22048,1848577,18176,1389763,3872,458814,5419,29,7324,132,6,448,130000.0,39000.0,-70.0,-72.0,-68.0,-60.0,-69.0,-71.0,-68.0,-60.0,-90.0,-92.0,-90.0,-93.0,20.0,20.0,22.0,33.0,0
873,CC:2F:71:3F:1F:24,4179290,2618716981,1551510,2286058804,2627780,332658177,32,508755,432612948,504870,432144820,3885,468128,482713,585,1553592,163344,32,4650,144444.0,43333.0,-73.0,-65.0,-74.0,-70.0,-72.0,-65.0,-74.0,-70.0,-90.0,-92.0,-90.0,-93.0,17.0,27.0,16.0,23.0,0
874,F8:59:71:5A:E0:3D,2654835,374223257,27054,41565018,2627781,332658239,0,3176,389539,3096,375820,80,13719,3054,0,27068,865,0,26,130000.0,39000.0,-67.0,-72.0,-64.0,-70.0,-68.0,-72.0,-67.0,-71.0,-90.0,-92.0,-90.0,-93.0,23.0,20.0,26.0,23.0,0
875,CC:2F:71:3E:C5:1F,2632920,333286688,5137,628247,2627783,332658441,6,22048,1848577,18176,1389763,3872,458814,5419,29,7324,132,6,448,130000.0,39000.0,-70.0,-72.0,-68.0,-60.0,-69.0,-71.0,-68.0,-60.0,-90.0,-92.0,-90.0,-93.0,20.0,20.0,22.0,33.0,0
876,CC:2F:71:3F:1F:24,4183330,2625046231,1555547,2292387790,2627783,332658441,32,509256,432675186,505371,432207058,3885,468128,483214,585,1557568,163511,32,4654,144444.0,43333.0,-73.0,-65.0,-74.0,-70.0,-72.0,-64.0,-74.0,-70.0,-90.0,-92.0,-90.0,-93.0,17.0,27.0,16.0,23.0,0
877,F8:59:71:5A:E0:3D,2654844,374224125,27054,41565018,2627790,332659107,0,3176,389539,3096,375820,80,13719,3054,0,27068,865,0,26,130000.0,39000.0,-67.0,-72.0,-64.0,-70.0,-68.0,-72.0,-67.0,-71.0,-90.0,-92.0,-90.0,-93.0,23.0,20.0,26.0,23.0,0
878,CC:2F:71:3E:C5:1F,2632927,333287354,5137,628247,2627790,332659107,6,22048,1848577,18176,1389763,3872,458814,5419,29,7324,132,6,448,130000.0,39000.0,-70.0,-72.0,-68.0,-60.0,-69.0,-71.0,-68.0,-60.0,-90.0,-92.0,-90.0,-93.0,20.0,20.0,22.0,33.0,0
879,CC:2F:71:3F:1F:24,4189308,2634424935,1561518,2301765828,2627790,332659107,32,510105,432779100,506220,432310972,3885,468128,484063,585,1563540,163796,32,4655,144444.0,43333.0,-75.0,-66.0,-75.0,-70.0,-73.0,-65.0,-74.0,-70.0,-90.0,-92.0,-90.0,-93.0,15.0,26.0,15.0,23.0,0
880,F8:59:71:5A:E0:3D,2654847,374224600,27054,41565018,2627793,332659582,0,3176,389539,3096,375820,80,13719,3054,0,27068,865,0,26,130000.0,39000.0,-67.0,-72.0,-64.0,-70.0,-68.0,-72.0,-67.0,-71.0,-90.0,-92.0,-90.0,-93.0,23.0,20.0,26.0,23.0,0
881,CC:2F:71:3E:C5:1F,2632930,333287829,5137,628247,2627793,332659582,6,22048,1848577,18176,1389763,3872,458814,5419,29,7324,132,6,448,130000.0,39000.0,-70.0,-72.0,-68.0,-60.0,-69.0,-71.0,-68.0,-60.0,-90.0,-92.0,-90.0,-93.0,20.0,20.0,22.0,33.0,0
882,CC:2F:71:3F:1F:24,4194456,2642498466,1566661,2309838682,2627795,332659784,32,510828,432868140,506943,432400012,3885,468128,484786,585,1568743,164515,32,4655,144444.0,43333.0,-74.0,-65.0,-74.0,-70.0,-73.0,-65.0,-73.0,-69.0,-90.0,-92.0,-90.0,-93.0,16.0,27.0,16.0,23.0,0
883,F8:59:71:5A:E0:3D,2654854,374225266,27054,41565018,2627800,332660248,0,3176,389539,3096,375820,80,13719,3054,0,27068,865,0,26,130000.0,39000.0,-67.0,-72.0,-64.0,-70.0,-68.0,-72.0,-67.0,-71.0,-90.0,-92.0,-89.0,-92.0,23.0,20.0,25.0,22.0,0
884,CC:2F:71:3E:C5:1F,2632937,333288495,5137,628247,2627800,332660248,6,22048,1848577,18176,1389763,3872,458814,5419,29,7324,132,6,448,130000.0,39000.0,-70.0,-72.0,-68.0,-60.0,-69.0,-71.0,-68.0,-60.0,-90.0,-92.0,-89.0,-92.0,20.0,20.0,21.0,32.0,0
885,CC:2F:71:3F:1F:24,4200008,2651210568,1572208,2318550320,2627800,332660248,32,511323,432929624,507438,432461496,3885,468128,485281,585,1574229,164990,32,4655,144444.0,43333.0,-74.0,-65.0,-73.0,-70.0,-74.0,-65.0,-73.0,-70.0,-90.0,-92.0,-89.0,-92.0,16.0,27.0,16.0,22.0,0
886,F8:59:71:5A:E0:3D,2654858,374225670,27054,41565018,2627804,332660652,0,3176,389539,3096,375820,80,13719,3054,0,27068,865,0,26,130000.0,39000.0,-67.0,-72.0,-64.0,-70.0,-68.0,-72.0,-67.0,-71.0,-90.0,-92.0,-89.0,-92.0,23.0,20.0,25.0,22.0,0
887,CC:2F:71:3E:C5:1F,2632942,333288969,5137,628247,2627805,332660722,6,22048,1848577,18176,1389763,3872,458814,5419,29,7324,132,6,448,130000.0,39000.0,-70.0,-72.0,-68.0,-60.0,-69.0,-71.0,-68.0,-60.0,-90.0,-92.0,-89.0,-92.0,20.0,20.0,21.0,32.0,0
888,CC:2F:71:3F:1F:24,4204977,2658994568,1577170,2326333644,2627807,332660924,32,511835,432994504,507950,432526376,3885,468128,485793,585,1579252,165039,32,4655,144444.0,43333.0,-74.0,-65.0,-73.0,-71.0,-73.0,-64.0,-73.0,-70.0,-90.0,-92.0,-89.0,-92.0,16.0,27.0,16.0,21.0,0
889,F8:59:71:5A:E0:3D,2654863,374226144,27054,41565018,2627809,332661126,0,3178,389735,3097,375890,81,13845,3055,0,27068,865,0,26,130000.0,39000.0,-74.0,-81.0,-79.0,-75.0,-68.0,-73.0,-67.0,-71.0,-90.0,-92.0,-89.0,-92.0,16.0,11.0,10.0,17.0,0
890,CC:2F:71:3E:C5:1F,2632946,333289373,5137,628247,2627809,332661126,6,22048,1848577,18176,1389763,3872,458814,5419,29,7324,132,6,448,130000.0,39000.0,-70.0,-72.0,-68.0,-60.0,-69.0,-71.0,-68.0,-60.0,-90.0,-92.0,-89.0,-92.0,20.0,20.0,21.0,32.0,0
891,CC:2F:71:3F:1F:24,4208661,2664764254,1580852,2332103128,2627809,332661126,32,512333,433056134,508448,432588006,3885,468128,486291,585,1582934,165187,32,4655,144444.0,43333.0,-74.0,-65.0,-75.0,-70.0,-73.0,-65.0,-75.0,-70.0,-90.0,-92.0,-89.0,-92.0,16.0,27.0,14.0,22.0,0
892,F8:59:71:5A:E0:3D,2654871,374226936,27054,41565018,2627817,332661918,0,3178,389735,3097,375890,81,13845,3055,0,27068,865,0,26,130000.0,39000.0,-74.0,-81.0,-79.0,-75.0,-68.0,-73.0,-67.0,-71.0,-90.0,-92.0,-89.0,-92.0,16.0,11.0,10.0,17.0,0
893,CC:2F:71:3E:C5:1F,2632954,333290165,5137,628247,2627817,332661918,6,22048,1848577,18176,1389763,3872,458814,5419,29,7324,132,6,448,130000.0,39000.0,-70.0,-72.0,-68.0,-60.0,-69.0,-71.0,-68.0,-60.0,-90.0,-92.0,-89.0,-92.0,20.0,20.0,21.0,32.0,0
894,CC:2F:71:3F:1F:24,4213702,2672662725,1585883,2340000605,2627819,332662120,32,512972,433134433,509087,432666305,3885,468128,486930,585,1587929,165353,32,4656,144444.0,43333.0,-73.0,-66.0,-75.0,-70.0,-72.0,-66.0,-75.0,-70.0,-90.0,-92.0,-89.0,-92.0,17.0,26.0,14.0,22.0,0
895,F8:59:71:5A:E0:3D,2654875,374227340,27054,41565018,2627821,332662322,0,3178,389735,3097,375890,81,13845,3055,0,27068,865,0,26,130000.0,39000.0,-74.0,-81.0,-79.0,-75.0,-68.0,-73.0,-67.0,-71.0,-90.0,-92.0,-89.0,-92.0,16.0,11.0,10.0,17.0,0
896,CC:2F:71:3E:C5:1F,2632959,333290631,5137,628247,2627822,332662384,6,22050,1848765,18177,1389833,3873,458932,5420,29,7325,132,6,448,130000.0,39000.0,-70.0,-70.0,-68.0,-60.0,-69.0,-70.0,-68.0,-60.0,-90.0,-92.0,-89.0,-92.0,20.0,22.0,21.0,32.0,0
897,CC:2F:71:3F:1F:24,4219804,2682135889,1591982,2349473505,2627822,332662384,32,513755,433265602,509870,432797474,3885,468128,487713,585,1594049,165544,32,4656,144444.0,43333.0,-75.0,-65.0,-74.0,-68.0,-75.0,-64.0,-74.0,-68.0,-90.0,-92.0,-89.0,-92.0,15.0,27.0,15.0,24.0,0
898,F8:59:71:5A:E0:3D,2654885,374228436,27054,41565018,2627831,332663418,0,3178,389735,3097,375890,81,13845,3055,0,27068,865,0,26,130000.0,39000.0,-74.0,-81.0,-79.0,-75.0,-68.0,-73.0,-67.0,-71.0,-90.0,-92.0,-89.0,-92.0,16.0,11.0,10.0,17.0,0
899,CC:2F:71:3E:C5:1F,2632968,333291665,5137,628247,2627831,332663418,6,22051,1848835,18178,1389903,3873,458932,5420,29,7325,132,6,448,130000.0,39000.0,-70.0,-71.0,-68.0,-61.0,-69.0,-70.0,-68.0,-60.0,-90.0,-92.0,-89.0,-92.0,20.0,21.0,21.0,31.0,0
900,CC:2F:71:3F:1F:24,4225237,2690648762,1597406,2357985344,2627831,332663418,32,514359,433341763,510474,432873635,3885,468128,488317,585,1599488,165679,32,4656,144444.0,43333.0,-78.0,-68.0,-77.0,-73.0,-78.0,-68.0,-77.0,-72.0,-90.0,-92.0,-89.0,-92.0,12.0,24.0,12.0,19.0,0
901,F8:59:71:5A:E0:3D,2654888,374228700,27054,41565018,2627834,332663682,0,3178,389735,3097,375890,81,13845,3055,0,27068,865,0,26,130000.0,39000.0,-74.0,-81.0,-79.0,-75.0,-68.0,-73.0,-67.0,-71.0,-90.0,-92.0,-89.0,-92.0,16.0,11.0,10.0,17.0,0
902,CC:2F:71:3E:C5:1F,2632971,333291929,5137,628247,2627834,332663682,6,22051,1848835,18178,1389903,3873,458932,5420,29,7325,132,6,448,130000.0,39000.0,-70.0,-71.0,-68.0,-61.0,-69.0,-70.0,-68.0,-60.0,-90.0,-92.0,-89.0,-92.0,20.0,21.0,21.0,31.0,0
903,CC:2F:71:3F:1F:24,4231364,2700269770,1603530,2367606088,2627834,332663682,32,515110,433433101,511224,432964855,3886,468246,489063,585,1605575,165813,32,4656,144444.0,43333.0,-76.0,-64.0,-73.0,-69.0,-75.0,-64.0,-73.0,-69.0,-90.0,-92.0,-89.0,-92.0,14.0,28.0,16.0,23.0,0
904,F8:59:71:5A:E0:3D,2654897,374229568,27054,41565018,2627843,332664550,0,3178,389735,3097,375890,81,13845,3055,0,27068,865,0,26,130000.0,39000.0,-74.0,-81.0,-79.0,-75.0,-68.0,-73.0,-67.0,-71.0,-90.0,-92.0,-89.0,-92.0,16.0,11.0,10.0,17.0,0
905,CC:2F:71:3E:C5:1F,2632980,333292797,5137,628247,2627843,332664550,6,22051,1848835,18178,1389903,3873,458932,5420,29,7325,132,6,448,130000.0,39000.0,-70.0,-71.0,-68.0,-61.0,-69.0,-70.0,-68.0,-60.0,-90.0,-92.0,-89.0,-92.0,20.0,21.0,21.0,31.0,0
906,CC:2F:71:3F:1F:24,4237330,2709620580,1609487,2376956030,2627843,332664550,32,515679,433504109,511793,433035863,3886,468246,489615,585,1611404,166042,32,4656,144444.0,43333.0,-73.0,-65.0,-75.0,-70.0,-73.0,-66.0,-74.0,-70.0,-90.0,-92.0,-89.0,-92.0,17.0,27.0,14.0,22.0,0
907,F8:59:71:5A:E0:3D,2654903,374230174,27054,41565018,2627849,332665156,0,3178,389735,3097,375890,81,13845,3055,0,27068,865,0,26,130000.0,39000.0,-74.0,-81.0,-79.0,-75.0,-68.0,-73.0,-67.0,-71.0,-90.0,-92.0,-89.0,-92.0,16.0,11.0,10.0,17.0,0
908,CC:2F:71:3E:C5:1F,2632986,333293403,5137,628247,2627849,332665156,6,22051,1848835,18178,1389903,3873,458932,5420,29,7325,132,6,448,130000.0,39000.0,-70.0,-71.0,-68.0,-61.0,-69.0,-70.0,-68.0,-60.0,-90.0,-92.0,-89.0,-92.0,20.0,21.0,21.0,31.0,0
909,CC:2F:71:3F:1F:24,4241124,2715557058,1613275,2382891902,2627849,332665156,32,516149,433562187,512263,433093941,3886,468246,490067,585,1615230,166420,32,4657,144444.0,43333.0,-73.0,-65.0,-73.0,-69.0,-72.0,-63.0,-72.0,-68.0,-90.0,-92.0,-89.0,-92.0,17.0,27.0,16.0,23.0,0
910,F8:59:71:5A:E0:3D,2654906,374230436,27054,41565018,2627852,332665418,0,3178,389735,3097,375890,81,13845,3055,0,27068,865,0,26,130000.0,39000.0,-74.0,-81.0,-79.0,-75.0,-68.0,-73.0,-67.0,-71.0,-90.0,-92.0,-89.0,-92.0,16.0,11.0,10.0,17.0,0
911,CC:2F:71:3E:C5:1F,2632992,333294140,5137,628247,2627855,332665893,6,22051,1848835,18178,1389903,3873,458932,5420,29,7325,132,6,448,130000.0,39000.0,-70.0,-71.0,-68.0,-61.0,-69.0,-70.0,-68.0,-60.0,-90.0,-92.0,-89.0,-92.0,20.0,21.0,21.0,31.0,0
912,CC:2F:71:3F:1F:24,4246007,2723184809,1618150,2390518714,2627857,332666095,32,516838,433652435,512952,433184189,3886,468246,490752,585,1620217,166544,32,4658,144444.0,43333.0,-73.0,-64.0,-73.0,-70.0,-72.0,-64.0,-73.0,-69.0,-90.0,-92.0,-89.0,-92.0,17.0,28.0,16.0,22.0,0
913,F8:59:71:5A:E0:3D,2654913,374231315,27054,41565018,2627859,332666297,0,3178,389735,3097,375890,81,13845,3055,0,27068,865,0,26,130000.0,39000.0,-74.0,-81.0,-79.0,-75.0,-68.0,-73.0,-67.0,-71.0,-90.0,-92.0,-89.0,-92.0,16.0,11.0,10.0,17.0,0
914,CC:2F:71:3E:C5:1F,2632996,333294544,5137,628247,2627859,332666297,6,22051,1848835,18178,1389903,3873,458932,5420,29,7325,132,6,448,130000.0,39000.0,-70.0,-71.0,-68.0,-61.0,-69.0,-70.0,-68.0,-60.0,-90.0,-92.0,-89.0,-92.0,20.0,21.0,21.0,31.0,0
915,CC:2F:71:3F:1F:24,4250237,2729815257,1622376,2397148758,2627861,332666499,32,517305,433712647,513419,433244401,3886,468246,491219,585,1624458,166675,32,4659,144444.0,43333.0,-73.0,-64.0,-73.0,-69.0,-72.0,-64.0,-73.0,-69.0,-90.0,-92.0,-89.0,-92.0,17.0,28.0,16.0,23.0,0
916,F8:59:71:5A:E0:3D,2654918,374231779,27054,41565018,2627864,332666761,0,3178,389735,3097,375890,81,13845,3055,0,27068,865,0,26,130000.0,39000.0,-74.0,-81.0,-79.0,-75.0,-68.0,-73.0,-67.0,-71.0,-90.0,-92.0,-89.0,-92.0,16.0,11.0,10.0,17.0,0
917,CC:2F:71:3E:C5:1F,2633001,333295008,5137,628247,2627864,332666761,6,22051,1848835,18178,1389903,3873,458932,5420,29,7325,132,6,448,130000.0,39000.0,-70.0,-71.0,-68.0,-61.0,-69.0,-70.0,-68.0,-60.0,-90.0,-92.0,-89.0,-92.0,20.0,21.0,21.0,31.0,0
918,CC:2F:71:3F:1F:24,4255512,2738083332,1627646,2405416369,2627866,332666963,32,517980,433798224,514094,433329978,3886,468246,491893,585,1629680,166841,32,4660,144444.0,43333.0,-73.0,-64.0,-74.0,-70.0,-72.0,-64.0,-73.0,-69.0,-90.0,-92.0,-89.0,-92.0,17.0,28.0,15.0,22.0,0
919,F8:59:71:5A:E0:3D,2654924,374232385,27054,41565018,2627870,332667367,0,3178,389735,3097,375890,81,13845,3055,0,27068,865,0,26,130000.0,39000.0,-74.0,-81.0,-79.0,-75.0,-68.0,-73.0,-67.0,-71.0,-90.0,-92.0,-89.0,-92.0,16.0,11.0,10.0,17.0,0
920,CC:2F:71:3E:C5:1F,2633007,333295614,5137,628247,2627870,332667367,6,22051,1848835,18178,1389903,3873,458932,5420,29,7325,132,6,448,130000.0,39000.0,-70.0,-71.0,-68.0,-61.0,-69.0,-70.0,-68.0,-60.0,-90.0,-92.0,-89.0,-92.0,20.0,21.0,21.0,31.0,0
921,CC:2F:71:3F:1F:24,4261415,2747298819,1633545,2414631452,2627870,332667367,32,518785,433916036,514899,433447790,3886,468246,492698,585,1635478,167176,32,4662,144444.0,43333.0,-73.0,-65.0,-74.0,-70.0,-72.0,-65.0,-74.0,-70.0,-90.0,-92.0,-89.0,-92.0,17.0,27.0,15.0,22.0,0
922,F8:59:71:5A:E0:3D,2654928,374232789,27054,41565018,2627874,332667771,0,3178,389735,3097,375890,81,13845,3055,0,27068,865,0,26,130000.0,39000.0,-74.0,-81.0,-79.0,-75.0,-68.0,-73.0,-67.0,-71.0,-90.0,-92.0,-89.0,-92.0,16.0,11.0,10.0,17.0,0
923,CC:2F:71:3E:C5:1F,2633012,333296078,5137,628247,2627875,332667831,6,22051,1848835,18178,1389903,3873,458932,5420,29,7325,132,6,448,130000.0,39000.0,-70.0,-71.0,-68.0,-61.0,-69.0,-70.0,-68.0,-60.0,-90.0,-92.0,-89.0,-92.0,20.0,21.0,21.0,31.0,0
924,CC:2F:71:3F:1F:24,4265565,2753765519,1637690,2421097688,2627875,332667831,32,519314,433998131,515428,433529885,3886,468246,493227,585,1639758,167460,32,4663,144444.0,43333.0,-72.0,-64.0,-74.0,-69.0,-72.0,-64.0,-74.0,-69.0,-90.0,-92.0,-89.0,-92.0,18.0,28.0,15.0,23.0,0
925,F8:59:71:5A:E0:3D,2654933,374233253,27054,41565018,2627879,332668235,0,3178,389735,3097,375890,81,13845,3055,0,27068,865,0,26,130000.0,39000.0,-74.0,-81.0,-79.0,-75.0,-68.0,-73.0,-67.0,-71.0,-90.0,-92.0,-89.0,-92.0,16.0,11.0,10.0,17.0,0
926,CC:2F:71:3E:C5:1F,2633016,333296482,5137,628247,2627879,332668235,6,22051,1848835,18178,1389903,3873,458932,5420,29,7325,132,6,448,130000.0,39000.0,-70.0,-71.0,-68.0,-61.0,-69.0,-70.0,-68.0,-60.0,-90.0,-92.0,-89.0,-92.0,20.0,21.0,21.0,31.0,0
927,CC:2F:71:3F:1F:24,4270194,2761024141,1642315,2428355906,2627879,332668235,32,519871,434067443,515985,433599197,3886,468246,493784,585,1644346,167720,32,4664,144444.0,43333.0,-72.0,-64.0,-74.0,-69.0,-72.0,-64.0,-73.0,-68.0,-90.0,-92.0,-89.0,-92.0,18.0,28.0,15.0,23.0,0
928,F8:59:71:5A:E0:3D,2654937,374233657,27054,41565018,2627883,332668639,0,3178,389735,3097,375890,81,13845,3055,0,27068,865,0,26,130000.0,39000.0,-74.0,-81.0,-79.0,-75.0,-68.0,-73.0,-67.0,-71.0,-90.0,-93.0,-90.0,-93.0,16.0,12.0,11.0,18.0,0
929,CC:2F:71:3E:C5:1F,2633022,333297088,5137,628247,2627885,332668841,6,22051,1848835,18178,1389903,3873,458932,5420,29,7325,132,6,448,130000.0,39000.0,-70.0,-71.0,-68.0,-61.0,-69.0,-70.0,-68.0,-60.0,-90.0,-93.0,-90.0,-93.0,20.0,22.0,22.0,32.0,0
930,CC:2F:71:3F:1F:24,4275348,2769082879,1647463,2436414038,2627885,332668841,32,520395,434135966,516509,433667720,3886,468246,494308,585,1649545,167880,32,4664,144444.0,43333.0,-72.0,-64.0,-74.0,-70.0,-72.0,-64.0,-73.0,-69.0,-90.0,-93.0,-90.0,-93.0,18.0,29.0,16.0,23.0,0
931,F8:59:71:5A:E0:3D,2654942,374234121,27054,41565018,2627888,332669103,0,3178,389735,3097,375890,81,13845,3055,0,27068,865,0,26,130000.0,39000.0,-74.0,-81.0,-79.0,-75.0,-68.0,-73.0,-67.0,-71.0,-90.0,-93.0,-90.0,-93.0,16.0,12.0,11.0,18.0,0
932,CC:2F:71:3E:C5:1F,2633025,333297350,5137,628247,2627888,332669103,6,22051,1848835,18178,1389903,3873,458932,5420,29,7325,132,6,448,130000.0,39000.0,-70.0,-71.0,-68.0,-61.0,-69.0,-70.0,-68.0,-60.0,-90.0,-93.0,-90.0,-93.0,20.0,22.0,22.0,32.0,0
933,CC:2F:71:3F:1F:24,4280043,2776445666,1652155,2443776563,2627888,332669103,32,520996,434209042,517110,433740796,3886,468246,494909,585,1654152,168187,32,4664,144444.0,43333.0,-72.0,-64.0,-74.0,-69.0,-72.0,-64.0,-74.0,-69.0,-90.0,-93.0,-90.0,-93.0,18.0,29.0,16.0,24.0,0
934,F8:59:71:5A:E0:3D,2654948,374234727,27054,41565018,2627894,332669709,0,3178,389735,3097,375890,81,13845,3055,0,27068,865,0,26,130000.0,39000.0,-74.0,-81.0,-79.0,-75.0,-68.0,-73.0,-67.0,-71.0,-90.0,-93.0,-90.0,-93.0,16.0,12.0,11.0,18.0,0
935,CC:2F:71:3E:C5:1F,2633031,333297956,5137,628247,2627894,332669709,6,22051,1848835,18178,1389903,3873,458932,5420,29,7325,132,6,448,130000.0,39000.0,-70.0,-71.0,-68.0,-61.0,-69.0,-70.0,-68.0,-60.0,-90.0,-93.0,-90.0,-93.0,20.0,22.0,22.0,32.0,0
936,CC:2F:71:3F:1F:24,4286040,2785857270,1658146,2453187561,2627894,332669709,32,521742,434300384,517856,433832138,3886,468246,495651,585,1660191,168415,32,4667,144444.0,43333.0,-72.0,-64.0,-75.0,-69.0,-72.0,-64.0,-74.0,-69.0,-90.0,-93.0,-90.0,-93.0,18.0,29.0,15.0,24.0,0
937,F8:59:71:5A:E0:3D,2654951,374235045,27055,41565134,2627896,332669911,0,3179,389805,3098,375960,81,13845,3055,0,27069,865,0,26,130000.0,39000.0,-74.0,-81.0,-80.0,-75.0,-69.0,-74.0,-69.0,-71.0,-90.0,-93.0,-90.0,-92.0,16.0,12.0,10.0,17.0,0
938,CC:2F:71:3E:C5:1F,2633035,333298278,5138,628307,2627897,332669971,6,22053,1848975,18180,1390043,3873,458932,5420,29,7326,132,6,448,130000.0,39000.0,-78.0,-85.0,-75.0,-72.0,-70.0,-71.0,-68.0,-61.0,-90.0,-93.0,-90.0,-92.0,12.0,8.0,15.0,20.0,0
939,CC:2F:71:3F:1F:24,4291271,2794061462,1663374,2461391491,2627897,332669971,32,522305,434371720,518419,433903474,3886,468246,496214,585,1665456,168614,32,4669,144444.0,43333.0,-73.0,-65.0,-74.0,-70.0,-72.0,-65.0,-73.0,-70.0,-90.0,-93.0,-90.0,-92.0,17.0,28.0,16.0,22.0,0
940,F8:59:71:5A:E0:3D,2654963,374236883,27060,41566306,2627903,332670577,0,3187,390828,3106,376983,81,13845,3062,0,27074,865,0,26,144444.0,39000.0,-66.0,-72.0,-64.0,-70.0,-66.0,-72.0,-64.0,-70.0,-90.0,-93.0,-90.0,-92.0,24.0,21.0,26.0,22.0,0
941,CC:2F:71:3E:C5:1F,2633043,333299086,5138,628307,2627905,332670779,6,22053,1848975,18180,1390043,3873,458932,5420,29,7326,132,6,448,130000.0,39000.0,-78.0,-85.0,-75.0,-72.0,-70.0,-71.0,-68.0,-61.0,-90.0,-93.0,-90.0,-92.0,12.0,8.0,15.0,20.0,0
942,CC:2F:71:3F:1F:24,4296050,2801467594,1668145,2468796815,2627905,332670779,32,522839,434471660,518953,434003414,3886,468246,496748,585,1670227,168848,32,4672,144444.0,43333.0,-73.0,-64.0,-74.0,-69.0,-72.0,-64.0,-73.0,-68.0,-90.0,-93.0,-90.0,-92.0,17.0,29.0,16.0,23.0,0
943,F8:59:71:5A:E0:3D,2654965,374237085,27060,41566306,2627905,332670779,0,3188,390898,3107,377053,81,13845,3062,0,27074,865,0,26,144444.0,39000.0,-66.0,-72.0,-64.0,-71.0,-66.0,-72.0,-64.0,-70.0,-90.0,-93.0,-90.0,-92.0,24.0,21.0,26.0,21.0,0
944,CC:2F:71:3E:C5:1F,2633045,333299288,5138,628307,2627907,332670981,6,22053,1848975,18180,1390043,3873,458932,5420,29,7326,132,6,448,130000.0,39000.0,-78.0,-85.0,-75.0,-72.0,-70.0,-71.0,-68.0,-61.0,-90.0,-93.0,-90.0,-92.0,12.0,8.0,15.0,20.0,0
945,CC:2F:71:3F:1F:24,4301213,2809567438,1673306,2476896457,2627907,332670981,32,523359,434537508,519473,434069262,3886,468246,497264,585,1675388,169089,32,4672,144444.0,43333.0,-74.0,-65.0,-74.0,-69.0,-73.0,-65.0,-74.0,-69.0,-90.0,-93.0,-90.0,-92.0,16.0,28.0,16.0,23.0,0
946,F8:59:71:5A:E0:3D,2654974,374237953,27060,41566306,2627914,332671647,0,3188,390898,3107,377053,81,13845,3062,0,27074,865,0,26,144444.0,39000.0,-66.0,-72.0,-64.0,-71.0,-66.0,-72.0,-64.0,-70.0,-90.0,-93.0,-90.0,-92.0,24.0,21.0,26.0,21.0,0
947,CC:2F:71:3E:C5:1F,2633053,333300227,5138,628307,2627915,332671920,6,22053,1848975,18180,1390043,3873,458932,5420,29,7326,132,6,448,130000.0,39000.0,-78.0,-85.0,-75.0,-72.0,-70.0,-71.0,-68.0,-61.0,-90.0,-93.0,-90.0,-92.0,12.0,8.0,15.0,20.0,0
948,CC:2F:71:3F:1F:24,4305802,2816754267,1677887,2484082347,2627915,332671920,32,523813,434596410,519927,434128164,3886,468246,497718,585,1679969,169386,32,4674,144444.0,43333.0,-73.0,-65.0,-73.0,-69.0,-72.0,-64.0,-73.0,-69.0,-90.0,-93.0,-90.0,-92.0,17.0,28.0,17.0,23.0,0
949,F8:59:71:5A:E0:3D,2654979,374238630,27060,41566306,2627919,332672324,0,3188,390898,3107,377053,81,13845,3062,0,27074,865,0,26,144444.0,39000.0,-66.0,-72.0,-64.0,-71.0,-66.0,-72.0,-64.0,-70.0,-90.0,-93.0,-89.0,-92.0,24.0,21.0,25.0,21.0,0
950,CC:2F:71:3E:C5:1F,2633058,333300693,5138,628307,2627920,332672386,6,22054,1849093,18180,1390043,3874,459050,5421,29,7326,132,6,448,130000.0,39000.0,-70.0,-71.0,-67.0,-60.0,-71.0,-72.0,-68.0,-61.0,-90.0,-93.0,-89.0,-92.0,20.0,22.0,22.0,32.0,0
951,CC:2F:71:3F:1F:24,4310659,2824368261,1682739,2491695875,2627920,332672386,32,524356,434665416,520470,434197170,3886,468246,498261,585,1684821,169586,32,4674,144444.0,43333.0,-72.0,-65.0,-74.0,-69.0,-72.0,-64.0,-73.0,-69.0,-90.0,-93.0,-89.0,-92.0,18.0,28.0,15.0,23.0,0
952,F8:59:71:5A:E0:3D,2654985,374239156,27060,41566306,2627925,332672850,0,3188,390898,3107,377053,81,13845,3062,0,27074,865,0,26,144444.0,39000.0,-66.0,-72.0,-64.0,-71.0,-66.0,-72.0,-64.0,-70.0,-90.0,-93.0,-89.0,-92.0,24.0,21.0,25.0,21.0,0
953,CC:2F:71:3E:C5:1F,2633063,333301157,5138,628307,2627925,332672850,6,22055,1849163,18181,1390113,3874,459050,5421,29,7326,132,6,448,130000.0,39000.0,-70.0,-72.0,-67.0,-60.0,-71.0,-72.0,-68.0,-61.0,-90.0,-93.0,-89.0,-92.0,20.0,21.0,22.0,32.0,0
954,CC:2F:71:3F:1F:24,4316073,2832862135,1688148,2500189285,2627925,332672850,32,524923,434735724,521037,434267478,3886,468246,498826,585,1690230,169730,32,4675,144444.0,43333.0,-72.0,-65.0,-73.0,-70.0,-72.0,-65.0,-73.0,-69.0,-90.0,-93.0,-89.0,-92.0,18.0,28.0,16.0,22.0,0
955,F8:59:71:5A:E0:3D,2654989,374239560,27060,41566306,2627929,332673254,0,3188,390898,3107,377053,81,13845,3062,0,27074,865,0,26,144444.0,39000.0,-66.0,-72.0,-64.0,-71.0,-66.0,-72.0,-64.0,-70.0,-90.0,-93.0,-89.0,-92.0,24.0,21.0,25.0,21.0,0
956,CC:2F:71:3E:C5:1F,2633070,333301825,5138,628307,2627932,332673518,6,22055,1849163,18181,1390113,3874,459050,5421,29,7326,132,6,448,130000.0,39000.0,-70.0,-72.0,-67.0,-60.0,-71.0,-72.0,-68.0,-61.0,-90.0,-93.0,-89.0,-92.0,20.0,21.0,22.0,32.0,0
957,CC:2F:71:3F:1F:24,4321096,2840727953,1693162,2508054233,2627934,332673720,32,525388,434795252,521502,434327006,3886,468246,499291,585,1695137,170277,32,4675,144444.0,43333.0,-73.0,-65.0,-73.0,-69.0,-72.0,-65.0,-73.0,-69.0,-90.0,-93.0,-89.0,-92.0,17.0,28.0,16.0,23.0,0
958,F8:59:71:5A:E0:3D,2654997,374240264,27061,41566422,2627936,332673842,0,3192,391262,3110,377299,82,13963,3064,0,27075,865,0,27,144444.0,39000.0,-66.0,-72.0,-64.0,-70.0,-67.0,-73.0,-65.0,-70.0,-90.0,-93.0,-89.0,-92.0,24.0,21.0,25.0,22.0,0
959,CC:2F:71:3E:C5:1F,2633074,333302149,5138,628307,2627936,332673842,6,22055,1849163,18181,1390113,3874,459050,5421,29,7326,132,6,448,130000.0,39000.0,-70.0,-72.0,-67.0,-60.0,-71.0,-72.0,-68.0,-61.0,-90.0,-93.0,-89.0,-92.0,20.0,21.0,22.0,32.0,0
960,CC:2F:71:3F:1F:24,4325972,2848371975,1698036,2515698133,2627936,332673842,32,525847,434854812,521960,434386448,3887,468364,499750,585,1700055,170766,32,4676,144444.0,43333.0,-73.0,-65.0,-73.0,-69.0,-73.0,-65.0,-73.0,-69.0,-90.0,-93.0,-89.0,-92.0,17.0,28.0,16.0,23.0,0
961,F8:59:71:5A:E0:3D,2655006,374241188,27062,41566538,2627944,332674650,0,3195,391508,3113,377545,82,13963,3065,0,27076,865,0,27,144444.0,39000.0,-66.0,-71.0,-64.0,-70.0,-67.0,-73.0,-65.0,-71.0,-90.0,-93.0,-89.0,-92.0,24.0,22.0,25.0,22.0,0
962,CC:2F:71:3E:C5:1F,2633082,333302957,5138,628307,2627944,332674650,6,22055,1849163,18181,1390113,3874,459050,5421,29,7326,132,6,448,130000.0,39000.0,-70.0,-72.0,-67.0,-60.0,-71.0,-72.0,-68.0,-61.0,-90.0,-93.0,-89.0,-92.0,20.0,21.0,22.0,32.0,0
963,CC:2F:71:3F:1F:24,4330405,2855311185,1702461,2522636535,2627944,332674650,32,526224,434904278,522337,434435914,3887,468364,500127,585,1704527,170959,32,4676,144444.0,43333.0,-72.0,-65.0,-74.0,-70.0,-71.0,-65.0,-73.0,-70.0,-90.0,-93.0,-89.0,-92.0,18.0,28.0,15.0,22.0,0
964,F8:59:71:5A:E0:3D,2655006,374241188,27062,41566538,2627944,332674650,0,3195,391508,3113,377545,82,13963,3065,0,27076,865,0,27,144444.0,39000.0,-66.0,-71.0,-64.0,-70.0,-67.0,-73.0,-65.0,-71.0,-90.0,-93.0,-89.0,-92.0,24.0,22.0,25.0,22.0,0
965,CC:2F:71:3E:C5:1F,2633082,333302957,5138,628307,2627944,332674650,6,22055,1849163,18181,1390113,3874,459050,5421,29,7326,132,6,448,130000.0,39000.0,-70.0,-72.0,-67.0,-60.0,-71.0,-72.0,-68.0,-61.0,-90.0,-93.0,-89.0,-92.0,20.0,21.0,22.0,32.0,0
966,CC:2F:71:3F:1F:24,4334123,2861129469,1706176,2528454557,2627947,332674912,32,526566,434947826,522679,434479462,3887,468364,500469,585,1708243,171140,32,4677,144444.0,43333.0,-73.0,-65.0,-73.0,-70.0,-72.0,-65.0,-73.0,-70.0,-90.0,-93.0,-89.0,-92.0,17.0,28.0,16.0,22.0,0
967,F8:59:71:5A:E0:3D,2655015,374242056,27062,41566538,2627953,332675518,0,3195,391508,3113,377545,82,13963,3065,0,27076,865,0,27,144444.0,39000.0,-66.0,-71.0,-64.0,-70.0,-67.0,-73.0,-65.0,-71.0,-90.0,-93.0,-89.0,-92.0,24.0,22.0,25.0,22.0,0
968,CC:2F:71:3E:C5:1F,2633091,333303825,5138,628307,2627953,332675518,6,22055,1849163,18181,1390113,3874,459050,5421,29,7326,132,6,448,130000.0,39000.0,-70.0,-72.0,-67.0,-60.0,-71.0,-72.0,-68.0,-61.0,-90.0,-93.0,-89.0,-92.0,20.0,21.0,22.0,32.0,0
969,CC:2F:71:3F:1F:24,4338441,2867891483,1710488,2535215965,2627953,332675518,32,526997,435002942,523110,434534578,3887,468364,500899,585,1712570,171263,32,4678,144444.0,43333.0,-74.0,-64.0,-73.0,-69.0,-73.0,-64.0,-73.0,-69.0,-90.0,-93.0,-89.0,-92.0,16.0,29.0,16.0,23.0,0
970,F8:59:71:5A:E0:3D,2655015,374242056,27062,41566538,2627953,332675518,0,3195,391508,3113,377545,82,13963,3065,0,27076,865,0,27,144444.0,39000.0,-66.0,-71.0,-64.0,-70.0,-67.0,-73.0,-65.0,-71.0,-90.0,-93.0,-89.0,-92.0,24.0,22.0,25.0,22.0,0
971,CC:2F:71:3E:C5:1F,2633093,333304027,5138,628307,2627955,332675720,6,22055,1849163,18181,1390113,3874,459050,5421,29,7326,132,6,448,130000.0,39000.0,-70.0,-72.0,-67.0,-60.0,-71.0,-72.0,-68.0,-61.0,-90.0,-93.0,-89.0,-92.0,20.0,21.0,22.0,32.0,0
972,CC:2F:71:3F:1F:24,4343037,2874981098,1715080,2542305176,2627957,332675922,32,527435,435090409,523548,434622045,3887,468364,501337,585,1717162,171331,32,4680,144444.0,43333.0,-72.0,-64.0,-74.0,-71.0,-72.0,-64.0,-73.0,-70.0,-90.0,-93.0,-89.0,-92.0,18.0,29.0,15.0,21.0,0
973,F8:59:71:5A:E0:3D,2655024,374242924,27062,41566538,2627962,332676386,0,3195,391508,3113,377545,82,13963,3065,0,27076,865,0,27,144444.0,39000.0,-66.0,-71.0,-64.0,-70.0,-67.0,-73.0,-65.0,-71.0,-90.0,-93.0,-89.0,-92.0,24.0,22.0,25.0,22.0,0
974,CC:2F:71:3E:C5:1F,2633100,333304693,5138,628307,2627962,332676386,6,22055,1849163,18181,1390113,3874,459050,5421,29,7326,132,6,448,130000.0,39000.0,-70.0,-72.0,-67.0,-60.0,-71.0,-72.0,-68.0,-61.0,-90.0,-93.0,-89.0,-92.0,20.0,21.0,22.0,32.0,0
975,CC:2F:71:3F:1F:24,4348069,2882872816,1720107,2550196430,2627962,332676386,32,527971,435156213,524084,434687849,3887,468364,501873,585,1722141,171448,32,4680,144444.0,43333.0,-73.0,-64.0,-73.0,-71.0,-72.0,-64.0,-73.0,-71.0,-90.0,-93.0,-89.0,-92.0,17.0,29.0,16.0,21.0,0
976,F8:59:71:5A:E0:3D,2655028,374243328,27062,41566538,2627966,332676790,0,3195,391508,3113,377545,82,13963,3065,0,27076,865,0,27,144444.0,39000.0,-66.0,-71.0,-64.0,-70.0,-67.0,-73.0,-65.0,-71.0,-90.0,-93.0,-89.0,-92.0,24.0,22.0,25.0,22.0,0
977,CC:2F:71:3E:C5:1F,2633104,333305097,5138,628307,2627966,332676790,6,22055,1849163,18181,1390113,3874,459050,5421,29,7326,132,6,448,130000.0,39000.0,-70.0,-72.0,-67.0,-60.0,-71.0,-72.0,-68.0,-61.0,-90.0,-93.0,-89.0,-92.0,20.0,21.0,22.0,32.0,0
978,CC:2F:71:3F:1F:24,4352614,2889995990,1724648,2557319200,2627966,332676790,32,528398,435211707,524511,434743343,3887,468364,502300,585,1726718,171544,32,4682,144444.0,43333.0,-73.0,-64.0,-74.0,-69.0,-73.0,-64.0,-74.0,-69.0,-90.0,-93.0,-89.0,-92.0,17.0,29.0,15.0,23.0,0
979,F8:59:71:5A:E0:3D,2655032,374243732,27062,41566538,2627970,332677194,0,3195,391508,3113,377545,82,13963,3065,0,27076,865,0,27,144444.0,39000.0,-66.0,-71.0,-64.0,-70.0,-67.0,-73.0,-65.0,-71.0,-90.0,-93.0,-89.0,-92.0,24.0,22.0,25.0,22.0,0
980,CC:2F:71:3E:C5:1F,2633109,333305561,5138,628307,2627971,332677254,6,22055,1849163,18181,1390113,3874,459050,5421,29,7326,132,6,448,130000.0,39000.0,-70.0,-72.0,-67.0,-60.0,-71.0,-72.0,-68.0,-61.0,-90.0,-93.0,-89.0,-92.0,20.0,21.0,22.0,32.0,0
981,CC:2F:71:3F:1F:24,4357434,2897550148,1729463,2564872894,2627971,332677254,32,528942,435279805,525055,434811441,3887,468364,502843,585,1731518,171680,32,4682,144444.0,43333.0,-73.0,-65.0,-74.0,-69.0,-73.0,-65.0,-74.0,-69.0,-90.0,-93.0,-89.0,-92.0,17.0,28.0,15.0,23.0,0
982,F8:59:71:5A:E0:3D,2655036,374244267,27062,41566538,2627974,332677729,0,3195,391508,3113,377545,82,13963,3065,0,27076,865,0,27,144444.0,39000.0,-66.0,-71.0,-64.0,-70.0,-67.0,-73.0,-65.0,-71.0,-90.0,-93.0,-89.0,-92.0,24.0,22.0,25.0,22.0,0
983,CC:2F:71:3E:C5:1F,2633114,333306238,5138,628307,2627976,332677931,6,22055,1849163,18181,1390113,3874,459050,5421,29,7326,132,6,448,130000.0,39000.0,-70.0,-72.0,-67.0,-60.0,-71.0,-72.0,-68.0,-61.0,-90.0,-93.0,-89.0,-92.0,20.0,21.0,22.0,32.0,0
984,CC:2F:71:3F:1F:24,4362312,2905196171,1734336,2572518240,2627976,332677931,32,529538,435355803,525651,434887439,3887,468364,503432,585,1736418,171762,32,4682,144444.0,43333.0,-73.0,-65.0,-74.0,-68.0,-72.0,-65.0,-74.0,-68.0,-90.0,-93.0,-89.0,-92.0,17.0,28.0,15.0,24.0,0
985,F8:59:71:5A:E0:3D,2655042,374244873,27062,41566538,2627980,332678335,0,3195,391508,3113,377545,82,13963,3065,0,27076,865,0,27,144444.0,39000.0,-66.0,-71.0,-64.0,-70.0,-67.0,-73.0,-65.0,-71.0,-90.0,-93.0,-89.0,-92.0,24.0,22.0,25.0,22.0,0
986,CC:2F:71:3E:C5:1F,2633118,333306642,5138,628307,2627980,332678335,6,22055,1849163,18181,1390113,3874,459050,5421,29,7326,132,6,448,130000.0,39000.0,-70.0,-72.0,-67.0,-60.0,-71.0,-72.0,-68.0,-61.0,-90.0,-93.0,-89.0,-92.0,20.0,21.0,22.0,32.0,0
987,CC:2F:71:3F:1F:24,4367613,2913509417,1739633,2580831082,2627980,332678335,32,530122,435429945,526235,434961581,3887,468364,504015,585,1741653,171850,32,4682,144444.0,43333.0,-73.0,-64.0,-74.0,-69.0,-72.0,-64.0,-73.0,-69.0,-90.0,-93.0,-89.0,-92.0,17.0,29.0,15.0,23.0,0
988,F8:59:71:5A:E0:3D,2655047,374245337,27062,41566538,2627985,332678799,0,3195,391508,3113,377545,82,13963,3065,0,27076,865,0,27,144444.0,39000.0,-66.0,-71.0,-64.0,-70.0,-67.0,-73.0,-65.0,-71.0,-90.0,-93.0,-89.0,-92.0,24.0,22.0,25.0,22.0,0
989,CC:2F:71:3E:C5:1F,2633123,333307106,5138,628307,2627985,332678799,6,22055,1849163,18181,1390113,3874,459050,5421,29,7326,132,6,448,130000.0,39000.0,-70.0,-72.0,-67.0,-60.0,-71.0,-72.0,-68.0,-61.0,-90.0,-93.0,-89.0,-92.0,20.0,21.0,22.0,32.0,0
990,CC:2F:71:3F:1F:24,4372034,2920438425,1744049,2587759626,2627985,332678799,32,530621,435494649,526734,435026285,3887,468364,504514,585,1746131,172053,32,4683,144444.0,43333.0,-72.0,-65.0,-74.0,-69.0,-72.0,-64.0,-74.0,-69.0,-90.0,-93.0,-89.0,-92.0,18.0,28.0,15.0,23.0,0
991,F8:59:71:5A:E0:3D,2655051,374245741,27062,41566538,2627989,332679203,0,3195,391508,3113,377545,82,13963,3065,0,27076,865,0,27,144444.0,39000.0,-66.0,-71.0,-64.0,-70.0,-67.0,-73.0,-65.0,-71.0,-90.0,-93.0,-89.0,-92.0,24.0,22.0,25.0,22.0,0
992,CC:2F:71:3E:C5:1F,2633127,333307510,5138,628307,2627989,332679203,6,22055,1849163,18181,1390113,3874,459050,5421,29,7326,132,6,448,130000.0,39000.0,-70.0,-72.0,-67.0,-60.0,-71.0,-72.0,-68.0,-61.0,-90.0,-93.0,-89.0,-92.0,20.0,21.0,22.0,32.0,0
993,CC:2F:71:3F:1F:24,4375516,2925882737,1747527,2593203534,2627989,332679203,32,530991,435541465,527104,435073101,3887,468364,504884,585,1749588,172212,32,4685,144444.0,43333.0,-73.0,-65.0,-74.0,-69.0,-73.0,-65.0,-74.0,-69.0,-90.0,-93.0,-89.0,-92.0,17.0,28.0,15.0,23.0,0
994,F8:59:71:5A:E0:3D,2655055,374246145,27062,41566538,2627993,332679607,0,3195,391508,3113,377545,82,13963,3065,0,27076,865,0,27,144444.0,39000.0,-66.0,-71.0,-64.0,-70.0,-67.0,-73.0,-65.0,-71.0,-90.0,-93.0,-89.0,-92.0,24.0,22.0,25.0,22.0,0
995,CC:2F:71:3E:C5:1F,2633131,333307914,5138,628307,2627993,332679607,6,22055,1849163,18181,1390113,3874,459050,5421,29,7326,132,6,448,130000.0,39000.0,-70.0,-72.0,-67.0,-60.0,-71.0,-72.0,-68.0,-61.0,-90.0,-93.0,-89.0,-92.0,20.0,21.0,22.0,32.0,0
996,CC:2F:71:3F:1F:24,4380365,2933479597,1752367,2600799526,2627998,332680071,32,531587,435615255,527700,435146891,3887,468364,505469,585,1754337,172406,32,4686,144444.0,43333.0,-73.0,-65.0,-74.0,-69.0,-72.0,-64.0,-74.0,-69.0,-90.0,-93.0,-89.0,-92.0,17.0,28.0,15.0,23.0,0
997,F8:59:71:5A:E0:3D,2655060,374246609,27062,41566538,2627998,332680071,0,3195,391508,3113,377545,82,13963,3065,0,27076,865,0,27,144444.0,39000.0,-66.0,-71.0,-64.0,-70.0,-67.0,-73.0,-65.0,-71.0,-90.0,-93.0,-89.0,-92.0,24.0,22.0,25.0,22.0,0
998,CC:2F:71:3E:C5:1F,2633136,333308378,5138,628307,2627998,332680071,6,22055,1849163,18181,1390113,3874,459050,5421,29,7326,132,6,448,130000.0,39000.0,-70.0,-72.0,-67.0,-60.0,-71.0,-72.0,-68.0,-61.0,-90.0,-93.0,-89.0,-92.0,20.0,21.0,22.0,32.0,0
999,CC:2F:71:3F:1F:24,4386486,2943091439,1758488,2610411368,2627998,332680071,32,532319,435705473,528432,435237109,3887,468364,506201,585,1760570,172837,32,4686,144444.0,43333.0,-74.0,-65.0,-76.0,-70.0,-73.0,-65.0,-75.0,-70.0,-90.0,-93.0,-89.0,-92.0,16.0,28.0,13.0,22.0,0
1000,F8:59:71:5A:E0:3D,2655068,374247417,27062,41566538,2628006,332680879,0,3195,391508,3113,377545,82,13963,3065,0,27076,865,0,27,144444.0,39000.0,-66.0,-71.0,-64.0,-70.0,-67.0,-73.0,-65.0,-71.0,-90.0,-93.0,-89.0,-92.0,24.0,22.0,25.0,22.0,0
1001,CC:2F:71:3E:C5:1F,2633146,333309554,5138,628307,2628008,332681247,6,22055,1849163,18181,1390113,3874,459050,5421,29,7326,132,6,448,130000.0,39000.0,-70.0,-72.0,-67.0,-60.0,-71.0,-72.0,-68.0,-61.0,-90.0,-93.0,-89.0,-92.0,20.0,21.0,22.0,32.0,0
1002,CC:2F:71:3F:1F:24,4391264,2950573410,1763256,2617892163,2628008,332681247,32,532890,435790371,529003,435322007,3887,468364,506772,585,1765238,173255,32,4686,144444.0,43333.0,-73.0,-65.0,-74.0,-70.0,-73.0,-65.0,-73.0,-69.0,-90.0,-93.0,-89.0,-92.0,17.0,28.0,15.0,22.0,0
1003,F8:59:71:5A:E0:3D,2655071,374247845,27062,41566538,2628009,332681307,0,3195,391508,3113,377545,82,13963,3065,0,27076,865,0,27,144444.0,39000.0,-66.0,-71.0,-64.0,-70.0,-67.0,-73.0,-65.0,-71.0,-90.0,-92.0,-89.0,-92.0,24.0,21.0,25.0,22.0,0
1004,CC:2F:71:3E:C5:1F,2633151,333310018,5138,628307,2628013,332681711,6,22055,1849163,18181,1390113,3874,459050,5421,29,7326,132,6,448,130000.0,39000.0,-70.0,-72.0,-67.0,-60.0,-71.0,-72.0,-68.0,-61.0,-90.0,-92.0,-89.0,-92.0,20.0,20.0,22.0,32.0,0
1005,CC:2F:71:3F:1F:24,4396909,2959317571,1768896,2626635860,2628013,332681711,32,533554,435889477,529667,435421113,3887,468364,507431,585,1770978,173556,32,4688,144444.0,43333.0,-73.0,-65.0,-74.0,-69.0,-72.0,-64.0,-73.0,-69.0,-90.0,-92.0,-89.0,-92.0,17.0,27.0,15.0,23.0,0
1006,F8:59:71:5A:E0:3D,2655079,374248653,27062,41566538,2628017,332682115,0,3195,391508,3113,377545,82,13963,3065,0,27076,865,0,27,144444.0,39000.0,-66.0,-71.0,-64.0,-70.0,-67.0,-73.0,-65.0,-71.0,-90.0,-92.0,-89.0,-92.0,24.0,21.0,25.0,22.0,0
1007,CC:2F:71:3E:C5:1F,2633155,333310422,5138,628307,2628017,332682115,6,22055,1849163,18181,1390113,3874,459050,5421,29,7326,132,6,448,130000.0,39000.0,-70.0,-72.0,-67.0,-60.0,-71.0,-72.0,-68.0,-61.0,-90.0,-92.0,-89.0,-92.0,20.0,20.0,22.0,32.0,0
1008,CC:2F:71:3F:1F:24,4401754,2966910737,1773737,2634228622,2628017,332682115,32,534128,435962609,530241,435494245,3887,468364,508004,585,1775798,173699,32,4689,144444.0,43333.0,-73.0,-65.0,-74.0,-69.0,-72.0,-64.0,-73.0,-69.0,-90.0,-92.0,-89.0,-92.0,17.0,27.0,15.0,23.0,0
1009,F8:59:71:5A:E0:3D,2655085,374249233,27063,41566654,2628022,332682579,0,3197,391648,3115,377685,82,13963,3065,0,27077,865,0,27,144444.0,39000.0,-74.0,-81.0,-78.0,-75.0,-66.0,-72.0,-65.0,-69.0,-90.0,-92.0,-89.0,-92.0,16.0,11.0,11.0,17.0,0
1010,CC:2F:71:3E:C5:1F,2633161,333311002,5139,628423,2628022,332682579,6,22057,1849303,18183,1390253,3874,459050,5421,29,7327,132,6,448,130000.0,39000.0,-70.0,-72.0,-68.0,-60.0,-72.0,-74.0,-69.0,-63.0,-90.0,-92.0,-89.0,-92.0,20.0,20.0,21.0,32.0,0
1011,CC:2F:71:3F:1F:24,4405901,2973403015,1777879,2640720436,2628022,332682579,32,534630,436023371,530743,435555007,3887,468364,508506,585,1779961,173892,32,4689,144444.0,43333.0,-72.0,-64.0,-74.0,-69.0,-72.0,-64.0,-73.0,-69.0,-90.0,-92.0,-89.0,-92.0,18.0,28.0,15.0,23.0,0
1012,F8:59:71:5A:E0:3D,2655089,374249637,27063,41566654,2628026,332682983,0,3197,391648,3115,377685,82,13963,3065,0,27077,865,0,27,144444.0,39000.0,-74.0,-81.0,-78.0,-75.0,-66.0,-72.0,-65.0,-69.0,-90.0,-92.0,-89.0,-92.0,16.0,11.0,11.0,17.0,0
1013,CC:2F:71:3E:C5:1F,2633165,333311406,5139,628423,2628026,332682983,6,22057,1849303,18183,1390253,3874,459050,5421,29,7327,132,6,448,130000.0,39000.0,-70.0,-72.0,-68.0,-60.0,-72.0,-74.0,-69.0,-63.0,-90.0,-92.0,-89.0,-92.0,20.0,20.0,21.0,32.0,0
1014,CC:2F:71:3F:1F:24,4408479,2977422263,1780453,2644739280,2628026,332682983,32,534835,436051335,530948,435582971,3887,468364,508710,585,1782535,174029,32,4690,144444.0,43333.0,-73.0,-64.0,-74.0,-69.0,-72.0,-64.0,-74.0,-69.0,-90.0,-92.0,-89.0,-92.0,17.0,28.0,15.0,23.0,0
1015,F8:59:71:5A:E0:3D,2655093,374250041,27063,41566654,2628030,332683387,0,3197,391648,3115,377685,82,13963,3065,0,27077,865,0,27,144444.0,39000.0,-74.0,-81.0,-78.0,-75.0,-66.0,-72.0,-65.0,-69.0,-89.0,-92.0,-88.0,-91.0,15.0,11.0,10.0,16.0,0
1016,CC:2F:71:3E:C5:1F,2633169,333311810,5139,628423,2628030,332683387,6,22057,1849303,18183,1390253,3874,459050,5421,29,7327,132,6,448,130000.0,39000.0,-70.0,-72.0,-68.0,-60.0,-72.0,-74.0,-69.0,-63.0,-89.0,-92.0,-88.0,-91.0,19.0,20.0,20.0,31.0,0
1017,CC:2F:71:3F:1F:24,4413502,2985293753,1785469,2652610104,2628033,332683649,32,535339,436113895,531452,435645531,3887,468364,509211,585,1787449,174236,32,4690,144444.0,43333.0,-73.0,-65.0,-73.0,-69.0,-72.0,-64.0,-73.0,-68.0,-89.0,-92.0,-88.0,-91.0,16.0,27.0,15.0,22.0,0
1018,F8:59:71:5A:E0:3D,2655112,374257704,27076,41573580,2628036,332684124,0,3214,403061,3132,389098,82,13963,3082,0,27090,865,0,27,144444.0,43333.0,-66.0,-72.0,-64.0,-70.0,-65.0,-69.0,-63.0,-69.0,-89.0,-92.0,-88.0,-91.0,23.0,20.0,24.0,21.0,0
1019,CC:2F:71:3E:C5:1F,2633179,333312951,5139,628423,2628040,332684528,6,22057,1849303,18183,1390253,3874,459050,5421,29,7327,132,6,448,130000.0,39000.0,-70.0,-72.0,-68.0,-60.0,-72.0,-74.0,-69.0,-63.0,-89.0,-92.0,-88.0,-91.0,19.0,20.0,20.0,31.0,0
1020,CC:2F:71:3F:1F:24,4419750,2995029674,1791708,2662344944,2628042,332684730,34,536127,436229045,532240,435760681,3887,468364,509975,588,1793793,175363,34,4691,144444.0,43333.0,-73.0,-65.0,-74.0,-68.0,-73.0,-65.0,-74.0,-68.0,-89.0,-92.0,-88.0,-91.0,16.0,27.0,14.0,23.0,0
1021,F8:59:71:5A:E0:3D,2655155,374307167,27108,41622051,2628047,332685116,0,3229,404747,3147,390784,82,13963,3094,0,27122,865,0,27,144444.0,43333.0,-66.0,-72.0,-63.0,-70.0,-66.0,-71.0,-63.0,-69.0,-89.0,-92.0,-88.0,-91.0,23.0,20.0,25.0,21.0,0
1022,CC:2F:71:3E:C5:1F,2633186,333313539,5139,628423,2628047,332685116,6,22059,1849491,18184,1390323,3875,459168,5422,29,7327,132,6,448,130000.0,39000.0,-70.0,-72.0,-68.0,-60.0,-72.0,-74.0,-69.0,-63.0,-89.0,-92.0,-88.0,-91.0,19.0,20.0,20.0,31.0,0
1023,CC:2F:71:3F:1F:24,4423701,3001213408,1795654,2668528292,2628047,332685116,34,536593,436287559,532705,435819077,3888,468482,510432,588,1797732,175781,34,4691,144444.0,43333.0,-73.0,-65.0,-74.0,-69.0,-72.0,-65.0,-73.0,-69.0,-89.0,-92.0,-88.0,-91.0,16.0,27.0,14.0,22.0,0
1024,F8:59:71:5A:E0:3D,2655159,374307571,27108,41622051,2628051,332685520,0,3229,404747,3147,390784,82,13963,3094,0,27122,865,0,27,144444.0,43333.0,-66.0,-72.0,-63.0,-70.0,-66.0,-71.0,-63.0,-69.0,-89.0,-92.0,-88.0,-91.0,23.0,20.0,25.0,21.0,0
1025,CC:2F:71:3E:C5:1F,2633194,333314347,5139,628423,2628055,332685924,6,22059,1849491,18184,1390323,3875,459168,5422,29,7327,132,6,448,130000.0,39000.0,-70.0,-72.0,-68.0,-60.0,-72.0,-74.0,-69.0,-63.0,-89.0,-92.0,-88.0,-91.0,19.0,20.0,20.0,31.0,0
1026,CC:2F:71:3F:1F:24,4428641,3008950280,1800586,2676264356,2628055,332685924,34,537178,436361641,533290,435893159,3888,468482,511017,588,1802671,176107,34,4691,144444.0,43333.0,-72.0,-65.0,-74.0,-69.0,-73.0,-65.0,-73.0,-69.0,-89.0,-92.0,-88.0,-91.0,17.0,27.0,14.0,22.0,0
1027,F8:59:71:5A:E0:3D,2655163,374307975,27108,41622051,2628055,332685924,0,3229,404747,3147,390784,82,13963,3094,0,27122,865,0,27,144444.0,43333.0,-66.0,-72.0,-63.0,-70.0,-66.0,-71.0,-63.0,-69.0,-89.0,-92.0,-88.0,-91.0,23.0,20.0,25.0,21.0,0
1028,CC:2F:71:3E:C5:1F,2633194,333314347,5139,628423,2628055,332685924,6,22059,1849491,18184,1390323,3875,459168,5422,29,7327,132,6,448,130000.0,39000.0,-70.0,-72.0,-68.0,-60.0,-72.0,-74.0,-69.0,-63.0,-89.0,-92.0,-88.0,-91.0,19.0,20.0,20.0,31.0,0
1029,CC:2F:71:3F:1F:24,4432382,3014811460,1804326,2682125476,2628056,332685984,34,537816,436438199,533928,435969717,3888,468482,511655,588,1806374,176431,34,4691,130000.0,43333.0,-73.0,-65.0,-74.0,-69.0,-73.0,-65.0,-74.0,-69.0,-89.0,-92.0,-88.0,-91.0,16.0,27.0,14.0,22.0,0
1030,F8:59:71:5A:E0:3D,2655171,374308703,27108,41622051,2628063,332686652,0,3231,404935,3148,390854,83,14081,3095,0,27122,865,0,27,144444.0,43333.0,-65.0,-72.0,-63.0,-70.0,-65.0,-71.0,-63.0,-70.0,-89.0,-92.0,-87.0,-90.0,24.0,20.0,24.0,20.0,0
1031,CC:2F:71:3E:C5:1F,2633204,333315277,5139,628423,2628065,332686854,6,22059,1849491,18184,1390323,3875,459168,5422,29,7327,132,6,448,130000.0,39000.0,-70.0,-72.0,-68.0,-60.0,-72.0,-74.0,-69.0,-63.0,-89.0,-92.0,-87.0,-90.0,19.0,20.0,19.0,30.0,0
1032,CC:2F:71:3F:1F:24,4438897,3025035774,1810832,2692348920,2628065,332686854,34,538738,436551617,534850,436083135,3888,468482,512573,588,1812822,176639,34,4692,130000.0,43333.0,-73.0,-66.0,-75.0,-70.0,-73.0,-65.0,-74.0,-70.0,-89.0,-92.0,-87.0,-90.0,16.0,26.0,12.0,20.0,0
1033,F8:59:71:5A:E0:3D,2655195,374319753,27108,41622051,2628087,332697702,0,3231,404935,3148,390854,83,14081,3095,0,27122,865,0,27,144444.0,43333.0,-65.0,-72.0,-63.0,-70.0,-65.0,-71.0,-63.0,-70.0,-89.0,-92.0,-87.0,-90.0,24.0,20.0,24.0,20.0,0
1034,CC:2F:71:3E:C5:1F,2633226,333326125,5139,628423,2628087,332697702,6,22059,1849491,18184,1390323,3875,459168,5422,29,7327,132,6,448,130000.0,39000.0,-70.0,-72.0,-68.0,-60.0,-72.0,-74.0,-69.0,-63.0,-89.0,-92.0,-87.0,-90.0,19.0,20.0,19.0,30.0,0
1035,CC:2F:71:3F:1F:24,4443581,3032329776,1815492,2699631872,2628089,332697904,34,539208,436612293,535320,436143811,3888,468482,513043,588,1817577,176884,34,4692,144444.0,43333.0,-74.0,-65.0,-75.0,-70.0,-73.0,-65.0,-74.0,-69.0,-89.0,-92.0,-87.0,-90.0,15.0,27.0,12.0,20.0,0
1036,F8:59:71:5A:E0:3D,2655208,374321141,27112,41622571,2628096,332698570,0,3235,405331,3152,391250,83,14081,3097,0,27126,865,0,27,144444.0,43333.0,-66.0,-72.0,-63.0,-70.0,-65.0,-72.0,-63.0,-70.0,-89.0,-92.0,-87.0,-90.0,23.0,20.0,24.0,20.0,0
1037,CC:2F:71:3E:C5:1F,2633235,333326993,5139,628423,2628096,332698570,6,22059,1849491,18184,1390323,3875,459168,5422,29,7327,132,6,448,130000.0,39000.0,-70.0,-72.0,-68.0,-60.0,-72.0,-74.0,-69.0,-63.0,-89.0,-92.0,-87.0,-90.0,19.0,20.0,19.0,30.0,0
1038,CC:2F:71:3F:1F:24,4449218,3041173230,1821122,2708474660,2628096,332698570,34,539814,436688037,535926,436219555,3888,468482,513649,588,1823191,177169,34,4693,144444.0,43333.0,-73.0,-65.0,-74.0,-69.0,-73.0,-65.0,-74.0,-69.0,-89.0,-92.0,-87.0,-90.0,16.0,27.0,13.0,21.0,0
1039,F8:59:71:5A:E0:3D,2655210,374321343,27112,41622571,2628098,332698772,0,3235,405331,3152,391250,83,14081,3097,0,27126,865,0,27,144444.0,43333.0,-66.0,-72.0,-63.0,-70.0,-65.0,-72.0,-63.0,-70.0,-89.0,-92.0,-87.0,-90.0,23.0,20.0,24.0,20.0,0
1040,CC:2F:71:3E:C5:1F,2633237,333327195,5139,628423,2628098,332698772,6,22059,1849491,18184,1390323,3875,459168,5422,29,7327,132,6,448,130000.0,39000.0,-70.0,-72.0,-68.0,-60.0,-72.0,-74.0,-69.0,-63.0,-89.0,-92.0,-87.0,-90.0,19.0,20.0,19.0,30.0,0
1041,CC:2F:71:3F:1F:24,4454650,3049631156,1826548,2716931980,2628102,332699176,34,540483,436785047,536595,436316565,3888,468482,514318,588,1828592,177820,34,4693,144444.0,43333.0,-73.0,-65.0,-74.0,-69.0,-73.0,-64.0,-74.0,-69.0,-89.0,-92.0,-87.0,-90.0,16.0,27.0,13.0,21.0,0
1042,F8:59:71:5A:E0:3D,2655217,374322009,27112,41622571,2628105,332699438,0,3235,405331,3152,391250,83,14081,3097,0,27126,865,0,27,144444.0,43333.0,-66.0,-72.0,-63.0,-70.0,-65.0,-72.0,-63.0,-70.0,-89.0,-92.0,-87.0,-90.0,23.0,20.0,24.0,20.0,0
1043,CC:2F:71:3E:C5:1F,2633244,333327861,5139,628423,2628105,332699438,6,22059,1849491,18184,1390323,3875,459168,5422,29,7327,132,6,448,130000.0,39000.0,-70.0,-72.0,-68.0,-60.0,-72.0,-74.0,-69.0,-63.0,-89.0,-92.0,-87.0,-90.0,19.0,20.0,19.0,30.0,0
1044,CC:2F:71:3F:1F:24,4457842,3054619284,1829737,2721919846,2628105,332699438,34,540837,436830957,536949,436362475,3888,468482,514672,588,1831822,178031,34,4694,144444.0,43333.0,-73.0,-65.0,-74.0,-69.0,-72.0,-64.0,-73.0,-69.0,-89.0,-92.0,-87.0,-90.0,16.0,27.0,13.0,21.0,0
1045,F8:59:71:5A:E0:3D,2655219,374322211,27112,41622571,2628107,332699640,0,3235,405331,3152,391250,83,14081,3097,0,27126,865,0,27,144444.0,43333.0,-66.0,-72.0,-63.0,-70.0,-65.0,-72.0,-63.0,-70.0,-89.0,-92.0,-87.0,-90.0,23.0,20.0,24.0,20.0,0
1046,CC:2F:71:3E:C5:1F,2633248,333328265,5139,628423,2628109,332699842,6,22059,1849491,18184,1390323,3875,459168,5422,29,7327,132,6,448,130000.0,39000.0,-70.0,-72.0,-68.0,-60.0,-72.0,-74.0,-69.0,-63.0,-89.0,-92.0,-87.0,-90.0,19.0,20.0,19.0,30.0,0
1047,CC:2F:71:3F:1F:24,4463132,3062914306,1835021,2730214262,2628111,332700044,34,541442,436906805,537554,436438323,3888,468482,515277,588,1837106,178227,34,4697,144444.0,43333.0,-72.0,-64.0,-74.0,-69.0,-72.0,-64.0,-74.0,-69.0,-89.0,-92.0,-87.0,-90.0,17.0,28.0,13.0,21.0,0
1048,F8:59:71:5A:E0:3D,2655225,374322817,27112,41622571,2628113,332700246,0,3235,405331,3152,391250,83,14081,3097,0,27126,865,0,27,144444.0,43333.0,-66.0,-72.0,-63.0,-70.0,-65.0,-72.0,-63.0,-70.0,-89.0,-92.0,-87.0,-90.0,23.0,20.0,24.0,20.0,0
1049,CC:2F:71:3E:C5:1F,2633252,333328669,5139,628423,2628113,332700246,6,22059,1849491,18184,1390323,3875,459168,5422,29,7327,132,6,448,130000.0,39000.0,-70.0,-72.0,-68.0,-60.0,-72.0,-74.0,-69.0,-63.0,-89.0,-92.0,-87.0,-90.0,19.0,20.0,19.0,30.0,0
1050,CC:2F:71:3F:1F:24,4466843,3068723870,1838730,2736023624,2628113,332700246,34,541960,436970503,538072,436502021,3888,468482,515795,588,1840791,178291,34,4697,144444.0,43333.0,-73.0,-65.0,-74.0,-69.0,-72.0,-65.0,-73.0,-69.0,-89.0,-92.0,-87.0,-90.0,16.0,27.0,13.0,21.0,0
1051,F8:59:71:5A:E0:3D,2655231,374323554,27112,41622571,2628119,332700983,0,3235,405331,3152,391250,83,14081,3097,0,27126,865,0,27,144444.0,43333.0,-66.0,-72.0,-63.0,-70.0,-65.0,-72.0,-63.0,-70.0,-89.0,-92.0,-87.0,-90.0,23.0,20.0,24.0,20.0,0
1052,CC:2F:71:3E:C5:1F,2633260,333329608,5139,628423,2628121,332701185,6,22059,1849491,18184,1390323,3875,459168,5422,29,7327,132,6,448,130000.0,39000.0,-70.0,-72.0,-68.0,-60.0,-72.0,-74.0,-69.0,-63.0,-89.0,-92.0,-87.0,-90.0,19.0,20.0,19.0,30.0,0
1053,CC:2F:71:3F:1F:24,4472474,3077553469,1844351,2744852082,2628123,332701387,34,542541,437043965,538653,436575483,3888,468482,516376,588,1846436,178876,34,4701,144444.0,43333.0,-73.0,-65.0,-74.0,-69.0,-73.0,-65.0,-74.0,-69.0,-89.0,-92.0,-87.0,-90.0,16.0,27.0,13.0,21.0,0
1054,F8:59:71:5A:E0:3D,2655235,374323958,27112,41622571,2628123,332701387,0,3235,405331,3152,391250,83,14081,3097,0,27126,865,0,27,144444.0,43333.0,-66.0,-72.0,-63.0,-70.0,-65.0,-72.0,-63.0,-70.0,-89.0,-92.0,-87.0,-90.0,23.0,20.0,24.0,20.0,0
1055,CC:2F:71:3E:C5:1F,2633262,333329810,5139,628423,2628123,332701387,6,22059,1849491,18184,1390323,3875,459168,5422,29,7327,132,6,448,130000.0,39000.0,-70.0,-72.0,-68.0,-60.0,-72.0,-74.0,-69.0,-63.0,-89.0,-92.0,-88.0,-91.0,19.0,20.0,20.0,31.0,0
1056,CC:2F:71:3F:1F:24,4474984,3081474217,1846861,2748772830,2628123,332701387,34,542832,437081411,538944,436612929,3888,468482,516667,588,1848946,179392,34,4702,144444.0,43333.0,-73.0,-65.0,-74.0,-68.0,-73.0,-65.0,-74.0,-68.0,-89.0,-92.0,-88.0,-91.0,16.0,27.0,14.0,23.0,0
1057,F8:59:71:5A:E0:3D,2655242,374324624,27112,41622571,2628130,332702053,0,3235,405331,3152,391250,83,14081,3097,0,27126,865,0,27,144444.0,43333.0,-66.0,-72.0,-63.0,-70.0,-65.0,-72.0,-63.0,-70.0,-89.0,-92.0,-88.0,-91.0,23.0,20.0,25.0,21.0,0
1058,CC:2F:71:3E:C5:1F,2633269,333330476,5139,628423,2628130,332702053,6,22059,1849491,18184,1390323,3875,459168,5422,29,7327,132,6,448,130000.0,39000.0,-70.0,-72.0,-68.0,-60.0,-72.0,-74.0,-69.0,-63.0,-89.0,-92.0,-88.0,-91.0,19.0,20.0,20.0,31.0,0
1059,CC:2F:71:3F:1F:24,4479183,3088038327,1851051,2755336072,2628132,332702255,34,543341,437147947,539453,436679465,3888,468482,517176,588,1853105,179587,34,4704,144444.0,43333.0,-74.0,-65.0,-73.0,-68.0,-73.0,-64.0,-73.0,-68.0,-89.0,-92.0,-88.0,-91.0,15.0,27.0,15.0,23.0,0
1060,F8:59:71:5A:E0:3D,2655244,374324826,27112,41622571,2628132,332702255,0,3235,405331,3152,391250,83,14081,3097,0,27126,865,0,27,144444.0,43333.0,-66.0,-72.0,-63.0,-70.0,-65.0,-72.0,-63.0,-70.0,-89.0,-92.0,-88.0,-91.0,23.0,20.0,25.0,21.0,0
1061,CC:2F:71:3E:C5:1F,2633271,333330678,5139,628423,2628132,332702255,6,22059,1849491,18184,1390323,3875,459168,5422,29,7327,132,6,448,130000.0,39000.0,-70.0,-72.0,-68.0,-60.0,-72.0,-74.0,-69.0,-63.0,-89.0,-92.0,-88.0,-91.0,19.0,20.0,20.0,31.0,0
1062,CC:2F:71:3F:1F:24,4483653,3094984788,1855521,2762282533,2628132,332702255,34,543914,437237307,540026,436768825,3888,468482,517749,588,1857606,179752,34,4710,144444.0,43333.0,-72.0,-64.0,-73.0,-69.0,-73.0,-64.0,-73.0,-68.0,-89.0,-92.0,-88.0,-91.0,17.0,28.0,15.0,22.0,0
1063,F8:59:71:5A:E0:3D,2655250,374325432,27112,41622571,2628138,332702861,0,3235,405331,3152,391250,83,14081,3097,0,27126,865,0,27,144444.0,43333.0,-66.0,-72.0,-63.0,-70.0,-65.0,-72.0,-63.0,-70.0,-89.0,-92.0,-88.0,-91.0,23.0,20.0,25.0,21.0,0
1064,CC:2F:71:3E:C5:1F,2633280,333331546,5139,628423,2628141,332703123,6,22059,1849491,18184,1390323,3875,459168,5422,29,7327,132,6,448,130000.0,39000.0,-70.0,-72.0,-68.0,-60.0,-72.0,-74.0,-69.0,-63.0,-89.0,-92.0,-88.0,-91.0,19.0,20.0,20.0,31.0,0
1065,CC:2F:71:3F:1F:24,4487182,3100498992,1859041,2767795869,2628141,332703123,34,544289,437286409,540401,436817927,3888,468482,518120,588,1861126,180093,34,4711,144444.0,43333.0,-73.0,-64.0,-74.0,-68.0,-73.0,-64.0,-74.0,-68.0,-89.0,-92.0,-88.0,-91.0,16.0,28.0,14.0,23.0,0
1066,F8:59:71:5A:E0:3D,2655253,374325694,27112,41622571,2628141,332703123,0,3235,405331,3152,391250,83,14081,3097,0,27126,865,0,27,144444.0,43333.0,-66.0,-72.0,-63.0,-70.0,-65.0,-72.0,-63.0,-70.0,-89.0,-92.0,-88.0,-91.0,23.0,20.0,25.0,21.0,0
1067,CC:2F:71:3E:C5:1F,2633280,333331546,5139,628423,2628141,332703123,6,22059,1849491,18184,1390323,3875,459168,5422,29,7327,132,6,448,130000.0,39000.0,-70.0,-72.0,-68.0,-60.0,-72.0,-74.0,-69.0,-63.0,-89.0,-92.0,-88.0,-91.0,19.0,20.0,20.0,31.0,0
1068,CC:2F:71:3F:1F:24,4492437,3108733055,1864296,2776029932,2628141,332703123,34,545038,437397182,541150,436928700,3888,468482,518869,588,1866361,180505,34,4712,144444.0,43333.0,-73.0,-64.0,-74.0,-68.0,-72.0,-64.0,-74.0,-68.0,-89.0,-92.0,-88.0,-91.0,16.0,28.0,14.0,23.0,0
1069,F8:59:71:5A:E0:3D,2655261,374326502,27112,41622571,2628149,332703931,0,3235,405331,3152,391250,83,14081,3097,0,27126,865,0,27,144444.0,43333.0,-66.0,-72.0,-63.0,-70.0,-65.0,-72.0,-63.0,-70.0,-89.0,-92.0,-88.0,-91.0,23.0,20.0,25.0,21.0,0
1070,CC:2F:71:3E:C5:1F,2633288,333332354,5139,628423,2628149,332703931,6,22059,1849491,18184,1390323,3875,459168,5422,29,7327,132,6,448,130000.0,39000.0,-70.0,-72.0,-68.0,-60.0,-72.0,-74.0,-69.0,-63.0,-89.0,-92.0,-88.0,-91.0,19.0,20.0,20.0,31.0,0
1071,CC:2F:71:3F:1F:24,4496756,3115485317,1868607,2782781386,2628149,332703931,34,545460,437450840,541572,436982358,3888,468482,519291,588,1870692,180802,34,4712,144444.0,43333.0,-73.0,-64.0,-74.0,-68.0,-72.0,-64.0,-74.0,-68.0,-89.0,-92.0,-88.0,-91.0,16.0,28.0,14.0,23.0,0
1072,F8:59:71:5A:E0:3D,2655262,374326562,27112,41622571,2628150,332703991,0,3235,405331,3152,391250,83,14081,3097,0,27126,865,0,27,144444.0,43333.0,-66.0,-72.0,-63.0,-70.0,-65.0,-72.0,-63.0,-70.0,-89.0,-92.0,-88.0,-91.0,23.0,20.0,25.0,21.0,0
1073,CC:2F:71:3E:C5:1F,2633289,333332414,5139,628423,2628150,332703991,6,22059,1849491,18184,1390323,3875,459168,5422,29,7327,132,6,448,130000.0,39000.0,-70.0,-72.0,-68.0,-60.0,-72.0,-74.0,-69.0,-63.0,-89.0,-92.0,-88.0,-91.0,19.0,20.0,20.0,31.0,0
1074,CC:2F:71:3F:1F:24,4500688,3121646503,1872538,2788942512,2628150,332703991,34,545829,437498260,541941,437029778,3888,468482,519660,588,1874623,180999,34,4712,144444.0,43333.0,-73.0,-65.0,-74.0,-68.0,-72.0,-64.0,-74.0,-68.0,-89.0,-92.0,-88.0,-91.0,16.0,27.0,14.0,23.0,0
1075,F8:59:71:5A:E0:3D,2655270,374327370,27112,41622571,2628158,332704799,0,3235,405331,3152,391250,83,14081,3097,0,27126,865,0,27,144444.0,43333.0,-66.0,-72.0,-63.0,-70.0,-65.0,-72.0,-63.0,-70.0,-89.0,-92.0,-88.0,-91.0,23.0,20.0,25.0,21.0,0
1076,CC:2F:71:3E:C5:1F,2633297,333333222,5139,628423,2628158,332704799,6,22059,1849491,18184,1390323,3875,459168,5422,29,7327,132,6,448,130000.0,39000.0,-70.0,-72.0,-68.0,-60.0,-72.0,-74.0,-69.0,-63.0,-89.0,-92.0,-88.0,-91.0,19.0,20.0,20.0,31.0,0
1077,CC:2F:71:3F:1F:24,4506671,3131028589,1878513,2798323790,2628158,332704799,34,546421,437571674,542533,437103192,3888,468482,520244,588,1880598,181272,34,4713,144444.0,43333.0,-73.0,-64.0,-74.0,-68.0,-72.0,-64.0,-73.0,-68.0,-89.0,-92.0,-88.0,-91.0,16.0,28.0,14.0,23.0,0
1078,F8:59:71:5A:E0:3D,2655275,374327882,27113,41622687,2628162,332705195,0,3237,405471,3154,391390,83,14081,3097,0,27127,865,0,27,130000.0,39000.0,-73.0,-75.0,-76.0,-74.0,-66.0,-72.0,-65.0,-70.0,-89.0,-92.0,-88.0,-91.0,16.0,17.0,12.0,17.0,0
1079,CC:2F:71:3E:C5:1F,2633303,333333802,5140,628539,2628163,332705263,6,22061,1849631,18186,1390463,3875,459168,5422,29,7328,132,6,448,130000.0,39000.0,-70.0,-71.0,-68.0,-60.0,-71.0,-73.0,-68.0,-61.0,-89.0,-92.0,-88.0,-91.0,19.0,21.0,20.0,31.0,0
1080,CC:2F:71:3F:1F:24,4512820,3140675573,1884655,2807970108,2628165,332705465,34,547275,437673890,543387,437205408,3888,468482,521098,588,1886604,181668,34,4713,144444.0,43333.0,-73.0,-65.0,-74.0,-68.0,-73.0,-64.0,-73.0,-68.0,-89.0,-92.0,-88.0,-91.0,16.0,27.0,14.0,23.0,0
1081,F8:59:71:5A:E0:3D,2655280,374328354,27113,41622687,2628167,332705667,0,3237,405471,3154,391390,83,14081,3097,0,27127,865,0,27,130000.0,39000.0,-73.0,-75.0,-76.0,-74.0,-66.0,-72.0,-65.0,-70.0,-89.0,-91.0,-87.0,-90.0,16.0,16.0,11.0,16.0,0
1082,CC:2F:71:3E:C5:1F,2633307,333334206,5140,628539,2628167,332705667,6,22061,1849631,18186,1390463,3875,459168,5422,29,7328,132,6,448,130000.0,39000.0,-70.0,-71.0,-68.0,-60.0,-71.0,-73.0,-68.0,-61.0,-89.0,-91.0,-87.0,-90.0,19.0,20.0,19.0,30.0,0
1083,CC:2F:71:3F:1F:24,4518225,3149096725,1890058,2816391058,2628167,332705667,34,547804,437757884,543916,437289402,3888,468482,521627,588,1892093,181910,34,4713,144444.0,43333.0,-73.0,-64.0,-73.0,-68.0,-72.0,-64.0,-73.0,-68.0,-89.0,-91.0,-87.0,-90.0,16.0,27.0,14.0,22.0,0
1084,F8:59:71:5A:E0:3D,2655287,374329020,27113,41622687,2628174,332706333,0,3237,405471,3154,391390,83,14081,3097,0,27127,865,0,27,130000.0,39000.0,-73.0,-75.0,-76.0,-74.0,-66.0,-72.0,-65.0,-70.0,-89.0,-91.0,-87.0,-90.0,16.0,16.0,11.0,16.0,0
1085,CC:2F:71:3E:C5:1F,2633315,333334934,5140,628539,2628175,332706395,6,22061,1849631,18186,1390463,3875,459168,5422,29,7328,132,6,448,130000.0,39000.0,-70.0,-71.0,-68.0,-60.0,-71.0,-73.0,-68.0,-61.0,-89.0,-91.0,-87.0,-90.0,19.0,20.0,19.0,30.0,0
1086,CC:2F:71:3F:1F:24,4524013,3158177325,1895838,2825470930,2628175,332706395,34,548481,437841596,544592,437372996,3889,468600,522304,588,1897923,182039,34,4713,144444.0,43333.0,-72.0,-64.0,-73.0,-69.0,-71.0,-64.0,-73.0,-68.0,-89.0,-91.0,-87.0,-90.0,17.0,27.0,14.0,21.0,0
1087,F8:59:71:5A:E0:3D,2655291,374329557,27113,41622687,2628178,332706870,0,3237,405471,3154,391390,83,14081,3097,0,27127,865,0,27,130000.0,39000.0,-73.0,-75.0,-76.0,-74.0,-66.0,-72.0,-65.0,-70.0,-89.0,-91.0,-87.0,-90.0,16.0,16.0,11.0,16.0,0
1088,CC:2F:71:3E:C5:1F,2633318,333335409,5140,628539,2628178,332706870,6,22061,1849631,18186,1390463,3875,459168,5422,29,7328,132,6,448,130000.0,39000.0,-70.0,-71.0,-68.0,-60.0,-71.0,-73.0,-68.0,-61.0,-89.0,-91.0,-87.0,-90.0,19.0,20.0,19.0,30.0,0
1089,CC:2F:71:3F:1F:24,4528833,3165734098,1900655,2833027228,2628178,332706870,34,548998,437905678,545109,437437078,3889,468600,522821,588,1902740,182172,34,4713,144444.0,43333.0,-73.0,-64.0,-74.0,-69.0,-72.0,-64.0,-72.0,-68.0,-89.0,-91.0,-87.0,-90.0,16.0,27.0,13.0,21.0,0
1090,F8:59:71:5A:E0:3D,2655297,374330163,27113,41622687,2628184,332707476,0,3237,405471,3154,391390,83,14081,3097,0,27127,865,0,27,130000.0,39000.0,-73.0,-75.0,-76.0,-74.0,-66.0,-72.0,-65.0,-70.0,-89.0,-91.0,-87.0,-90.0,16.0,16.0,11.0,16.0,0
1091,CC:2F:71:3E:C5:1F,2633324,333336015,5140,628539,2628184,332707476,6,22061,1849631,18186,1390463,3875,459168,5422,29,7328,132,6,448,130000.0,39000.0,-70.0,-71.0,-68.0,-60.0,-71.0,-73.0,-68.0,-61.0,-89.0,-91.0,-87.0,-90.0,19.0,20.0,19.0,30.0,0
1092,CC:2F:71:3F:1F:24,4532477,3171433988,1904293,2838726512,2628184,332707476,34,549393,437955500,545504,437486900,3889,468600,523208,588,1906344,182278,34,4713,144444.0,43333.0,-72.0,-64.0,-72.0,-68.0,-72.0,-64.0,-73.0,-68.0,-89.0,-91.0,-87.0,-90.0,17.0,27.0,15.0,22.0,0
1093,F8:59:71:5A:E0:3D,2655301,374330487,27113,41622687,2628188,332707800,0,3239,405659,3155,391460,84,14199,3098,0,27127,865,0,27,130000.0,39000.0,-66.0,-72.0,-63.0,-70.0,-66.0,-71.0,-64.0,-70.0,-89.0,-91.0,-87.0,-90.0,23.0,19.0,24.0,20.0,0
1094,CC:2F:71:3E:C5:1F,2633328,333336339,5140,628539,2628188,332707800,6,22061,1849631,18186,1390463,3875,459168,5422,29,7328,132,6,448,130000.0,39000.0,-70.0,-71.0,-68.0,-60.0,-71.0,-73.0,-68.0,-61.0,-89.0,-91.0,-87.0,-90.0,19.0,20.0,19.0,30.0,0
1095,CC:2F:71:3F:1F:24,4537850,3179855017,1909662,2847147217,2628188,332707800,34,549869,438016751,545980,437548151,3889,468600,523684,588,1911730,182439,34,4713,144444.0,43333.0,-72.0,-64.0,-74.0,-69.0,-72.0,-64.0,-73.0,-68.0,-89.0,-91.0,-87.0,-90.0,17.0,27.0,13.0,21.0,0
1096,F8:59:71:5A:E0:3D,2655307,374331093,27113,41622687,2628194,332708406,0,3239,405659,3155,391460,84,14199,3098,0,27127,865,0,27,130000.0,39000.0,-66.0,-72.0,-63.0,-70.0,-66.0,-71.0,-64.0,-70.0,-89.0,-91.0,-87.0,-90.0,23.0,19.0,24.0,20.0,0
1097,CC:2F:71:3E:C5:1F,2633334,333336945,5140,628539,2628194,332708406,6,22061,1849631,18186,1390463,3875,459168,5422,29,7328,132,6,448,130000.0,39000.0,-70.0,-71.0,-68.0,-60.0,-71.0,-73.0,-68.0,-61.0,-89.0,-91.0,-87.0,-90.0,19.0,20.0,19.0,30.0,0
1098,CC:2F:71:3F:1F:24,4543715,3189052898,1915519,2856344290,2628196,332708608,34,550584,438103260,546695,437634660,3889,468600,524399,588,1917604,182552,34,4713,144444.0,43333.0,-72.0,-64.0,-72.0,-68.0,-71.0,-64.0,-73.0,-68.0,-89.0,-91.0,-87.0,-90.0,17.0,27.0,15.0,22.0,0
1099,F8:59:71:5A:E0:3D,2655312,374331557,27113,41622687,2628199,332708870,0,3239,405659,3155,391460,84,14199,3098,0,27127,865,0,27,130000.0,39000.0,-66.0,-72.0,-63.0,-70.0,-66.0,-71.0,-64.0,-70.0,-89.0,-91.0,-87.0,-90.0,23.0,19.0,24.0,20.0,0
1100,CC:2F:71:3E:C5:1F,2633339,333337409,5140,628539,2628199,332708870,6,22061,1849631,18186,1390463,3875,459168,5422,29,7328,132,6,448,130000.0,39000.0,-70.0,-71.0,-68.0,-60.0,-71.0,-73.0,-68.0,-61.0,-89.0,-91.0,-87.0,-90.0,19.0,20.0,19.0,30.0,0
1101,CC:2F:71:3F:1F:24,4549151,3197579329,1920952,2864870459,2628199,332708870,34,551217,438183549,547328,437714949,3889,468600,525032,588,1923037,182639,34,4713,144444.0,43333.0,-72.0,-64.0,-74.0,-69.0,-72.0,-64.0,-74.0,-69.0,-89.0,-91.0,-87.0,-90.0,17.0,27.0,13.0,21.0,0
1102,F8:59:71:5A:E0:3D,2655319,374332289,27113,41622687,2628206,332709602,0,3239,405659,3155,391460,84,14199,3098,0,27127,865,0,27,130000.0,39000.0,-66.0,-72.0,-63.0,-70.0,-66.0,-71.0,-64.0,-70.0,-89.0,-91.0,-87.0,-90.0,23.0,19.0,24.0,20.0,0
1103,CC:2F:71:3E:C5:1F,2633346,333338141,5140,628539,2628206,332709602,6,22061,1849631,18186,1390463,3875,459168,5422,29,7328,132,6,448,130000.0,39000.0,-70.0,-71.0,-68.0,-60.0,-71.0,-73.0,-68.0,-61.0,-89.0,-91.0,-87.0,-90.0,19.0,20.0,19.0,30.0,0
1104,CC:2F:71:3F:1F:24,4553284,3204050857,1925078,2871341255,2628206,332709602,34,551812,438256363,547923,437787763,3889,468600,525627,588,1927163,182759,34,4714,144444.0,43333.0,-72.0,-64.0,-74.0,-69.0,-72.0,-64.0,-73.0,-68.0,-89.0,-91.0,-87.0,-90.0,17.0,27.0,13.0,21.0,0
1105,F8:59:71:5A:E0:3D,2655321,374332491,27113,41622687,2628208,332709804,0,3239,405659,3155,391460,84,14199,3098,0,27127,865,0,27,130000.0,39000.0,-66.0,-72.0,-63.0,-70.0,-66.0,-71.0,-64.0,-70.0,-89.0,-91.0,-87.0,-90.0,23.0,19.0,24.0,20.0,0
1106,CC:2F:71:3E:C5:1F,2633350,333338711,5140,628539,2628210,332710172,6,22063,1849771,18188,1390603,3875,459168,5422,29,7329,132,6,448,130000.0,39000.0,-70.0,-72.0,-67.0,-60.0,-71.0,-73.0,-68.0,-61.0,-89.0,-91.0,-87.0,-90.0,19.0,19.0,20.0,30.0,0
1107,CC:2F:71:3F:1F:24,4558496,3212199047,1930285,2879488815,2628211,332710232,34,552242,438328589,548353,437859989,3889,468600,526057,588,1932332,183081,34,4715,144444.0,43333.0,-72.0,-65.0,-74.0,-69.0,-72.0,-64.0,-74.0,-69.0,-89.0,-91.0,-87.0,-90.0,17.0,26.0,13.0,21.0,0
1108,F8:59:71:5A:E0:3D,2655331,374333587,27113,41622687,2628218,332710900,0,3239,405659,3155,391460,84,14199,3098,0,27127,865,0,27,130000.0,39000.0,-66.0,-72.0,-63.0,-70.0,-66.0,-71.0,-64.0,-70.0,-89.0,-91.0,-87.0,-90.0,23.0,19.0,24.0,20.0,0
1109,CC:2F:71:3E:C5:1F,2633358,333339439,5140,628539,2628218,332710900,6,22065,1849959,18189,1390673,3876,459286,5423,29,7329,132,6,448,130000.0,39000.0,-70.0,-72.0,-67.0,-60.0,-70.0,-71.0,-67.0,-60.0,-89.0,-91.0,-87.0,-90.0,19.0,19.0,20.0,30.0,0
1110,CC:2F:71:3F:1F:24,4561377,3216651858,1933159,2883940958,2628218,332710900,34,552586,438387178,548697,437918578,3889,468600,526401,588,1935230,183130,34,4715,144444.0,43333.0,-72.0,-65.0,-73.0,-69.0,-72.0,-65.0,-73.0,-69.0,-89.0,-91.0,-87.0,-90.0,17.0,26.0,14.0,21.0,0
1111,F8:59:71:5A:E0:3D,2655333,374333789,27113,41622687,2628220,332711102,0,3239,405659,3155,391460,84,14199,3098,0,27127,865,0,27,130000.0,39000.0,-66.0,-72.0,-63.0,-70.0,-66.0,-71.0,-64.0,-70.0,-89.0,-91.0,-87.0,-90.0,23.0,19.0,24.0,20.0,0
1112,CC:2F:71:3E:C5:1F,2633360,333339641,5140,628539,2628220,332711102,6,22065,1849959,18189,1390673,3876,459286,5423,29,7329,132,6,448,130000.0,39000.0,-70.0,-72.0,-67.0,-60.0,-70.0,-71.0,-67.0,-60.0,-89.0,-91.0,-87.0,-90.0,19.0,19.0,20.0,30.0,0
1113,CC:2F:71:3F:1F:24,4567398,3226095542,1939174,2893384036,2628224,332711506,34,553300,438477202,549411,438008602,3889,468600,527067,588,1941259,183349,34,4715,144444.0,43333.0,-73.0,-65.0,-74.0,-69.0,-72.0,-65.0,-73.0,-69.0,-89.0,-92.0,-87.0,-90.0,16.0,27.0,13.0,21.0,0
1114,F8:59:71:5A:E0:3D,2655340,374334455,27113,41622687,2628227,332711768,0,3239,405659,3155,391460,84,14199,3098,0,27127,865,0,27,130000.0,39000.0,-66.0,-72.0,-63.0,-70.0,-66.0,-71.0,-64.0,-70.0,-89.0,-92.0,-87.0,-90.0,23.0,20.0,24.0,20.0,0
1115,CC:2F:71:3E:C5:1F,2633367,333340307,5140,628539,2628227,332711768,6,22065,1849959,18189,1390673,3876,459286,5423,29,7329,132,6,448,130000.0,39000.0,-70.0,-72.0,-67.0,-60.0,-70.0,-71.0,-67.0,-60.0,-89.0,-92.0,-87.0,-90.0,19.0,20.0,20.0,30.0,0
1116,CC:2F:71:3F:1F:24,4572690,3234398758,1944463,2901686990,2628227,332711768,34,553826,438546248,549937,438077648,3889,468600,527592,588,1946395,183556,34,4717,144444.0,43333.0,-73.0,-65.0,-74.0,-69.0,-72.0,-65.0,-73.0,-69.0,-89.0,-92.0,-87.0,-90.0,16.0,27.0,13.0,21.0,0
1117,F8:59:71:5A:E0:3D,2655346,374335061,27113,41622687,2628233,332712374,0,3239,405659,3155,391460,84,14199,3098,0,27127,865,0,27,130000.0,39000.0,-66.0,-72.0,-63.0,-70.0,-66.0,-71.0,-64.0,-70.0,-89.0,-92.0,-87.0,-90.0,23.0,20.0,24.0,20.0,0
1118,CC:2F:71:3E:C5:1F,2633373,333340913,5140,628539,2628233,332712374,6,22065,1849959,18189,1390673,3876,459286,5423,29,7329,132,6,448,130000.0,39000.0,-70.0,-72.0,-67.0,-60.0,-70.0,-71.0,-67.0,-60.0,-89.0,-92.0,-87.0,-90.0,19.0,20.0,20.0,30.0,0
1119,CC:2F:71:3F:1F:24,4577275,3241575418,1949042,2908863044,2628233,332712374,34,554220,438597192,550331,438128592,3889,468600,527986,588,1951127,183751,34,4717,144444.0,43333.0,-72.0,-64.0,-73.0,-69.0,-72.0,-64.0,-73.0,-69.0,-89.0,-92.0,-87.0,-90.0,17.0,28.0,14.0,21.0,0
1120,F8:59:71:5A:E0:3D,2655349,374335323,27113,41622687,2628236,332712636,0,3239,405659,3155,391460,84,14199,3098,0,27127,865,0,27,130000.0,39000.0,-66.0,-72.0,-63.0,-70.0,-66.0,-71.0,-64.0,-70.0,-89.0,-91.0,-87.0,-90.0,23.0,19.0,24.0,20.0,0
1121,CC:2F:71:3E:C5:1F,2633378,333341377,5140,628539,2628238,332712838,6,22065,1849959,18189,1390673,3876,459286,5423,29,7329,132,6,448,130000.0,39000.0,-70.0,-72.0,-67.0,-60.0,-70.0,-71.0,-67.0,-60.0,-89.0,-91.0,-87.0,-90.0,19.0,19.0,20.0,30.0,0
1122,CC:2F:71:3F:1F:24,4583042,3250619726,1954804,2917906888,2628238,332712838,34,554717,438662516,550828,438193916,3889,468600,528482,588,1956889,183909,34,4718,144444.0,43333.0,-73.0,-64.0,-73.0,-70.0,-73.0,-64.0,-73.0,-69.0,-89.0,-91.0,-87.0,-90.0,16.0,27.0,14.0,20.0,0
1123,F8:59:71:5A:E0:3D,2655356,374336202,27113,41622687,2628243,332713515,0,3239,405659,3155,391460,84,14199,3098,0,27127,865,0,27,130000.0,39000.0,-66.0,-72.0,-63.0,-70.0,-66.0,-71.0,-64.0,-70.0,-89.0,-91.0,-87.0,-90.0,23.0,19.0,24.0,20.0,0
1124,CC:2F:71:3E:C5:1F,2633385,333342256,5140,628539,2628245,332713717,6,22065,1849959,18189,1390673,3876,459286,5423,29,7329,132,6,448,130000.0,39000.0,-70.0,-72.0,-67.0,-60.0,-70.0,-71.0,-67.0,-60.0,-89.0,-91.0,-87.0,-90.0,19.0,19.0,20.0,30.0,0
1125,CC:2F:71:3F:1F:24,4587739,3257977985,1959494,2925264268,2628245,332713717,34,555227,438729028,551338,438260428,3889,468600,528992,588,1961563,184077,34,4719,144444.0,43333.0,-73.0,-64.0,-74.0,-69.0,-73.0,-64.0,-73.0,-69.0,-89.0,-91.0,-87.0,-90.0,16.0,27.0,13.0,21.0,0
1126,F8:59:71:5A:E0:3D,2655361,374336666,27113,41622687,2628248,332713979,0,3239,405659,3155,391460,84,14199,3098,0,27127,865,0,27,130000.0,39000.0,-66.0,-72.0,-63.0,-70.0,-66.0,-71.0,-64.0,-70.0,-89.0,-91.0,-87.0,-90.0,23.0,19.0,24.0,20.0,0
1127,CC:2F:71:3E:C5:1F,2633388,333342518,5140,628539,2628248,332713979,6,22065,1849959,18189,1390673,3876,459286,5423,29,7329,132,6,448,130000.0,39000.0,-70.0,-72.0,-67.0,-60.0,-70.0,-71.0,-67.0,-60.0,-89.0,-91.0,-87.0,-90.0,19.0,19.0,20.0,30.0,0
1128,CC:2F:71:3F:1F:24,4592111,3264781169,1963863,2932067190,2628248,332713979,34,555766,438811460,551877,438342860,3889,468600,529531,588,1965932,184207,34,4719,144444.0,43333.0,-73.0,-64.0,-73.0,-69.0,-73.0,-64.0,-73.0,-69.0,-89.0,-91.0,-87.0,-90.0,16.0,27.0,14.0,21.0,0
1129,F8:59:71:5A:E0:3D,2655366,374337204,27113,41622687,2628253,332714517,0,3239,405659,3155,391460,84,14199,3098,0,27127,865,0,27,130000.0,39000.0,-66.0,-72.0,-63.0,-70.0,-66.0,-71.0,-64.0,-70.0,-89.0,-91.0,-87.0,-90.0,23.0,19.0,24.0,20.0,0
1130,CC:2F:71:3E:C5:1F,2633394,333343124,5140,628539,2628254,332714585,6,22065,1849959,18189,1390673,3876,459286,5423,29,7329,132,6,448,130000.0,39000.0,-70.0,-72.0,-67.0,-60.0,-70.0,-71.0,-67.0,-60.0,-89.0,-91.0,-87.0,-90.0,19.0,19.0,20.0,30.0,0
1131,CC:2F:71:3F:1F:24,4596228,3271227869,1967974,2938513284,2628254,332714585,43,556157,438859750,552268,438391150,3889,468600,529912,589,1970060,184417,43,4720,144444.0,43333.0,-73.0,-64.0,-73.0,-69.0,-72.0,-63.0,-72.0,-68.0,-89.0,-91.0,-87.0,-90.0,16.0,27.0,14.0,21.0,0
1132,F8:59:71:5A:E0:3D,2655371,374338598,27113,41622687,2628258,332715911,0,3239,405659,3155,391460,84,14199,3098,0,27127,865,0,27,130000.0,39000.0,-66.0,-72.0,-63.0,-70.0,-66.0,-71.0,-64.0,-70.0,-89.0,-92.0,-87.0,-91.0,23.0,20.0,24.0,21.0,0
1133,CC:2F:71:3E:C5:1F,2633402,333344854,5140,628539,2628262,332716315,6,22065,1849959,18189,1390673,3876,459286,5423,29,7329,132,6,448,130000.0,39000.0,-70.0,-72.0,-67.0,-60.0,-70.0,-71.0,-67.0,-60.0,-89.0,-92.0,-87.0,-91.0,19.0,20.0,20.0,31.0,0
1134,CC:2F:71:3F:1F:24,4600587,3278049781,1972325,2945333466,2628262,332716315,43,556538,438907550,552649,438438950,3889,468600,530280,589,1974411,184544,43,4720,144444.0,43333.0,-73.0,-64.0,-73.0,-69.0,-73.0,-64.0,-73.0,-69.0,-89.0,-92.0,-87.0,-91.0,16.0,28.0,14.0,22.0,0
1135,F8:59:71:5A:E0:3D,2655378,374339264,27113,41622687,2628265,332716577,0,3239,405659,3155,391460,84,14199,3098,0,27127,865,0,27,130000.0,39000.0,-66.0,-72.0,-63.0,-70.0,-66.0,-71.0,-64.0,-70.0,-89.0,-92.0,-87.0,-91.0,23.0,20.0,24.0,21.0,0
1136,CC:2F:71:3E:C5:1F,2633405,333345116,5140,628539,2628265,332716577,6,22065,1849959,18189,1390673,3876,459286,5423,29,7329,132,6,448,130000.0,39000.0,-70.0,-72.0,-67.0,-60.0,-70.0,-71.0,-67.0,-60.0,-89.0,-92.0,-87.0,-91.0,19.0,20.0,20.0,31.0,0
1137,CC:2F:71:3F:1F:24,4604904,3284811269,1976637,2952094490,2628267,332716779,43,556968,438961828,553079,438493228,3889,468600,530704,589,1978709,184846,43,4720,144444.0,43333.0,-74.0,-65.0,-74.0,-69.0,-73.0,-65.0,-73.0,-69.0,-89.0,-92.0,-87.0,-91.0,15.0,27.0,13.0,22.0,0
1138,F8:59:71:5A:E0:3D,2655386,374340994,27113,41622687,2628273,332718307,0,3239,405659,3155,391460,84,14199,3098,0,27127,865,0,27,130000.0,39000.0,-66.0,-72.0,-63.0,-70.0,-66.0,-71.0,-64.0,-70.0,-89.0,-92.0,-87.0,-91.0,23.0,20.0,24.0,21.0,0
1139,CC:2F:71:3E:C5:1F,2633413,333346846,5140,628539,2628273,332718307,6,22065,1849959,18189,1390673,3876,459286,5423,29,7329,132,6,448,130000.0,39000.0,-70.0,-72.0,-67.0,-60.0,-70.0,-71.0,-67.0,-60.0,-89.0,-92.0,-87.0,-91.0,19.0,20.0,20.0,31.0,0
1140,CC:2F:71:3F:1F:24,4609405,3291838422,1981132,2959120115,2628273,332718307,43,557539,439037525,553650,438568925,3889,468600,531275,589,1983218,185256,43,4721,144444.0,43333.0,-74.0,-65.0,-74.0,-67.0,-74.0,-65.0,-73.0,-67.0,-89.0,-92.0,-87.0,-91.0,15.0,27.0,13.0,24.0,0
1141,F8:59:71:5A:E0:3D,2655391,374341458,27113,41622687,2628278,332718771,0,3239,405659,3155,391460,84,14199,3098,0,27127,865,0,27,130000.0,39000.0,-66.0,-72.0,-63.0,-70.0,-66.0,-71.0,-64.0,-70.0,-89.0,-92.0,-87.0,-91.0,23.0,20.0,24.0,21.0,0
1142,CC:2F:71:3E:C5:1F,2633418,333347310,5140,628539,2628278,332718771,6,22065,1849959,18189,1390673,3876,459286,5423,29,7329,132,6,448,130000.0,39000.0,-70.0,-72.0,-67.0,-60.0,-70.0,-71.0,-67.0,-60.0,-89.0,-92.0,-87.0,-91.0,19.0,20.0,20.0,31.0,0
1143,CC:2F:71:3F:1F:24,4612959,3297373320,1984681,2964654549,2628278,332718771,43,558033,439113641,554144,438645041,3889,468600,531769,589,1986625,185787,43,4721,144444.0,43333.0,-74.0,-65.0,-74.0,-71.0,-74.0,-64.0,-74.0,-70.0,-89.0,-92.0,-87.0,-91.0,15.0,27.0,13.0,20.0,0
1144,F8:59:71:5A:E0:3D,2655397,374342986,27113,41622687,2628284,332720299,0,3239,405659,3155,391460,84,14199,3098,0,27127,865,0,27,130000.0,39000.0,-66.0,-72.0,-63.0,-70.0,-66.0,-71.0,-64.0,-70.0,-89.0,-92.0,-87.0,-91.0,23.0,20.0,24.0,21.0,0
1145,CC:2F:71:3E:C5:1F,2633424,333348838,5140,628539,2628284,332720299,6,22065,1849959,18189,1390673,3876,459286,5423,29,7329,132,6,448,130000.0,39000.0,-70.0,-72.0,-67.0,-60.0,-70.0,-71.0,-67.0,-60.0,-89.0,-92.0,-87.0,-91.0,19.0,20.0,20.0,31.0,0
1146,CC:2F:71:3F:1F:24,4617582,3304617506,1989298,2971897207,2628284,332720299,43,558479,439169363,554590,438700763,3889,468600,532214,589,1991330,186010,43,4721,144444.0,43333.0,-74.0,-64.0,-75.0,-70.0,-74.0,-64.0,-74.0,-70.0,-89.0,-92.0,-87.0,-91.0,15.0,28.0,12.0,21.0,0
1147,F8:59:71:5A:E0:3D,2655401,374343390,27113,41622687,2628288,332720703,0,3239,405659,3155,391460,84,14199,3098,0,27127,865,0,27,130000.0,39000.0,-66.0,-72.0,-63.0,-70.0,-66.0,-71.0,-64.0,-70.0,-89.0,-92.0,-88.0,-91.0,23.0,20.0,25.0,21.0,0
1148,CC:2F:71:3E:C5:1F,2633429,333349302,5140,628539,2628289,332720763,6,22065,1849959,18189,1390673,3876,459286,5423,29,7329,132,6,448,130000.0,39000.0,-70.0,-72.0,-67.0,-60.0,-70.0,-71.0,-67.0,-60.0,-89.0,-92.0,-88.0,-91.0,19.0,20.0,21.0,31.0,0
1149,CC:2F:71:3F:1F:24,4623922,3314568784,1995631,2981847819,2628291,332720965,43,559190,439274465,555301,438805865,3889,468600,532924,589,1997691,186543,43,4722,144444.0,43333.0,-73.0,-64.0,-74.0,-70.0,-73.0,-64.0,-74.0,-70.0,-89.0,-92.0,-88.0,-91.0,16.0,28.0,14.0,21.0,0
1150,F8:59:71:5A:E0:3D,2655407,374343914,27114,41622747,2628293,332721167,0,3241,405799,3157,391600,84,14199,3098,0,27128,865,0,27,130000.0,39000.0,-75.0,-79.0,-78.0,-75.0,-68.0,-72.0,-66.0,-70.0,-89.0,-92.0,-88.0,-91.0,14.0,13.0,10.0,16.0,0
1151,CC:2F:71:3E:C5:1F,2633436,333350024,5141,628655,2628295,332721369,6,22067,1850099,18191,1390813,3876,459286,5423,29,7330,132,6,448,130000.0,39000.0,-73.0,-78.0,-73.0,-70.0,-71.0,-73.0,-69.0,-62.0,-89.0,-92.0,-88.0,-91.0,16.0,14.0,15.0,21.0,0
1152,CC:2F:71:3F:1F:24,4628232,3321264157,1999937,2988542788,2628295,332721369,43,559669,439353399,555780,438884799,3889,468600,533403,589,2002023,186805,43,4722,144444.0,43333.0,-74.0,-64.0,-74.0,-70.0,-73.0,-64.0,-74.0,-70.0,-89.0,-92.0,-88.0,-91.0,15.0,28.0,14.0,21.0,0
1153,F8:59:71:5A:E0:3D,2655413,374344442,27114,41622747,2628299,332721695,0,3243,405987,3158,391670,85,14317,3099,0,27128,865,0,27,130000.0,39000.0,-67.0,-73.0,-63.0,-72.0,-68.0,-72.0,-66.0,-71.0,-90.0,-92.0,-88.0,-91.0,23.0,19.0,25.0,19.0,0
1154,CC:2F:71:3E:C5:1F,2633442,333350552,5141,628655,2628301,332721897,6,22067,1850099,18191,1390813,3876,459286,5423,29,7330,132,6,448,130000.0,39000.0,-73.0,-78.0,-73.0,-70.0,-71.0,-73.0,-69.0,-62.0,-90.0,-92.0,-88.0,-91.0,17.0,14.0,15.0,21.0,0
1155,CC:2F:71:3F:1F:24,4631545,3326440145,2003242,2993718046,2628303,332722099,43,559998,439395627,556108,438926909,3890,468718,533732,589,2005296,187065,43,4722,144444.0,43333.0,-73.0,-64.0,-74.0,-70.0,-73.0,-64.0,-74.0,-70.0,-90.0,-92.0,-88.0,-91.0,17.0,28.0,14.0,21.0,0
1156,F8:59:71:5A:E0:3D,2655420,374345108,27114,41622747,2628306,332722361,0,3243,405987,3158,391670,85,14317,3099,0,27128,865,0,27,130000.0,39000.0,-67.0,-73.0,-63.0,-72.0,-68.0,-72.0,-66.0,-71.0,-90.0,-92.0,-88.0,-91.0,23.0,19.0,25.0,19.0,0
1157,CC:2F:71:3E:C5:1F,2633448,333351289,5141,628655,2628307,332722634,6,22067,1850099,18191,1390813,3876,459286,5423,29,7330,132,6,448,130000.0,39000.0,-73.0,-78.0,-73.0,-70.0,-71.0,-73.0,-69.0,-62.0,-90.0,-92.0,-88.0,-91.0,17.0,14.0,15.0,21.0,0
1158,CC:2F:71:3F:1F:24,4636042,3333483304,2007733,3000760468,2628309,332722836,43,560503,439457401,556613,438988683,3890,468718,534237,589,2009692,187310,43,4722,144444.0,43333.0,-73.0,-64.0,-73.0,-70.0,-72.0,-64.0,-73.0,-70.0,-90.0,-92.0,-88.0,-91.0,17.0,28.0,15.0,21.0,0
1159,F8:59:71:5A:E0:3D,2655427,374345987,27114,41622747,2628313,332723240,0,3243,405987,3158,391670,85,14317,3099,0,27128,865,0,27,130000.0,39000.0,-67.0,-73.0,-63.0,-72.0,-68.0,-72.0,-66.0,-71.0,-90.0,-92.0,-88.0,-91.0,23.0,19.0,25.0,19.0,0
1160,CC:2F:71:3E:C5:1F,2633454,333351895,5141,628655,2628313,332723240,6,22067,1850099,18191,1390813,3876,459286,5423,29,7330,132,6,448,130000.0,39000.0,-73.0,-78.0,-73.0,-70.0,-71.0,-73.0,-69.0,-62.0,-90.0,-92.0,-88.0,-91.0,17.0,14.0,15.0,21.0,0
1161,CC:2F:71:3F:1F:24,4640613,3340611230,2012300,3007887990,2628313,332723240,43,560935,439528373,557045,439059655,3890,468718,534669,589,2014219,187580,43,4722,144444.0,43333.0,-73.0,-64.0,-74.0,-70.0,-72.0,-64.0,-73.0,-70.0,-90.0,-92.0,-88.0,-91.0,17.0,28.0,14.0,21.0,0
1162,F8:59:71:5A:E0:3D,2655432,374346451,27114,41622747,2628318,332723704,0,3243,405987,3158,391670,85,14317,3099,0,27128,865,0,27,130000.0,39000.0,-67.0,-73.0,-63.0,-72.0,-68.0,-72.0,-66.0,-71.0,-90.0,-92.0,-88.0,-91.0,23.0,19.0,25.0,19.0,0
1163,CC:2F:71:3E:C5:1F,2633459,333352359,5141,628655,2628318,332723704,6,22067,1850099,18191,1390813,3876,459286,5423,29,7330,132,6,448,130000.0,39000.0,-73.0,-78.0,-73.0,-70.0,-71.0,-73.0,-69.0,-62.0,-90.0,-92.0,-88.0,-91.0,17.0,14.0,15.0,21.0,0
1164,CC:2F:71:3F:1F:24,4645926,3348929257,2017608,3016205553,2628318,332723704,43,561489,439597620,557599,439128902,3890,468718,535223,589,2019694,187754,43,4722,144444.0,43333.0,-73.0,-64.0,-74.0,-70.0,-72.0,-64.0,-74.0,-70.0,-90.0,-92.0,-88.0,-91.0,17.0,28.0,14.0,21.0,0
1165,F8:59:71:5A:E0:3D,2655438,374347882,27116,41623774,2628322,332724108,0,3246,406357,3161,392040,85,14317,3101,0,27130,865,0,27,130000.0,39000.0,-67.0,-73.0,-63.0,-72.0,-67.0,-73.0,-65.0,-72.0,-90.0,-92.0,-88.0,-91.0,23.0,19.0,25.0,19.0,0
1166,CC:2F:71:3E:C5:1F,2633463,333352763,5141,628655,2628322,332724108,6,22067,1850099,18191,1390813,3876,459286,5423,29,7330,132,6,448,130000.0,39000.0,-73.0,-78.0,-73.0,-70.0,-71.0,-73.0,-69.0,-62.0,-90.0,-92.0,-88.0,-91.0,17.0,14.0,15.0,21.0,0
1167,CC:2F:71:3F:1F:24,4651061,3356985787,2022739,3024261679,2628322,332724108,43,562016,439662716,558126,439193998,3890,468718,535750,589,2024761,187867,43,4722,144444.0,43333.0,-73.0,-64.0,-74.0,-70.0,-72.0,-64.0,-74.0,-70.0,-90.0,-92.0,-88.0,-91.0,17.0,28.0,14.0,21.0,0
1168,F8:59:71:5A:E0:3D,2655444,374348408,27116,41623774,2628328,332724634,0,3246,406357,3161,392040,85,14317,3101,0,27130,865,0,27,130000.0,39000.0,-67.0,-73.0,-63.0,-72.0,-67.0,-73.0,-65.0,-72.0,-90.0,-92.0,-88.0,-91.0,23.0,19.0,25.0,19.0,0
1169,CC:2F:71:3E:C5:1F,2633469,333353289,5141,628655,2628328,332724634,6,22069,1850287,18192,1390883,3877,459404,5424,29,7330,132,6,448,130000.0,39000.0,-70.0,-71.0,-68.0,-60.0,-70.0,-72.0,-69.0,-62.0,-90.0,-92.0,-88.0,-91.0,20.0,21.0,20.0,31.0,0
1170,CC:2F:71:3F:1F:24,4656185,3365016741,2027857,3032292107,2628328,332724634,43,562572,439731948,558682,439263230,3890,468718,536305,589,2029907,188216,43,4722,144444.0,43333.0,-73.0,-64.0,-74.0,-70.0,-73.0,-64.0,-74.0,-70.0,-90.0,-92.0,-88.0,-91.0,17.0,28.0,14.0,21.0,0
1171,F8:59:71:5A:E0:3D,2655448,374348812,27116,41623774,2628332,332725038,0,3246,406357,3161,392040,85,14317,3101,0,27130,865,0,27,130000.0,39000.0,-67.0,-73.0,-63.0,-72.0,-67.0,-73.0,-65.0,-72.0,-90.0,-92.0,-88.0,-91.0,23.0,19.0,25.0,19.0,0
1172,CC:2F:71:3E:C5:1F,2633473,333353693,5141,628655,2628332,332725038,6,22069,1850287,18192,1390883,3877,459404,5424,29,7330,132,6,448,130000.0,39000.0,-70.0,-71.0,-68.0,-60.0,-70.0,-72.0,-69.0,-62.0,-90.0,-92.0,-88.0,-91.0,20.0,21.0,20.0,31.0,0
1173,CC:2F:71:3F:1F:24,4661226,3372916705,2032892,3040191465,2628334,332725240,43,562928,439777600,559038,439308882,3890,468718,536661,589,2034863,188651,43,4722,144444.0,43333.0,-74.0,-64.0,-74.0,-67.0,-74.0,-64.0,-74.0,-67.0,-90.0,-92.0,-88.0,-91.0,16.0,28.0,14.0,24.0,0
1174,F8:59:71:5A:E0:3D,2655454,374349418,27116,41623774,2628338,332725644,0,3246,406357,3161,392040,85,14317,3101,0,27130,865,0,27,130000.0,39000.0,-67.0,-73.0,-63.0,-72.0,-67.0,-73.0,-65.0,-72.0,-90.0,-93.0,-89.0,-92.0,23.0,20.0,26.0,20.0,0
1175,CC:2F:71:3E:C5:1F,2633482,333354561,5141,628655,2628341,332725906,6,22069,1850287,18192,1390883,3877,459404,5424,29,7330,132,6,448,130000.0,39000.0,-70.0,-71.0,-68.0,-60.0,-70.0,-72.0,-69.0,-62.0,-90.0,-93.0,-89.0,-92.0,20.0,22.0,21.0,32.0,0
1176,CC:2F:71:3F:1F:24,4667463,3382652945,2039122,3049927039,2628341,332725906,43,563542,439869300,559652,439400582,3890,468718,537275,589,2041095,190291,43,4722,130000.0,43333.0,-75.0,-65.0,-74.0,-69.0,-76.0,-65.0,-73.0,-68.0,-90.0,-93.0,-89.0,-92.0,15.0,28.0,15.0,23.0,0
1177,F8:59:71:5A:E0:3D,2655461,374350084,27116,41623774,2628345,332726310,0,3246,406357,3161,392040,85,14317,3101,0,27130,865,0,27,130000.0,39000.0,-67.0,-73.0,-63.0,-72.0,-67.0,-73.0,-65.0,-72.0,-90.0,-93.0,-89.0,-92.0,23.0,20.0,26.0,20.0,0
1178,CC:2F:71:3E:C5:1F,2633486,333354965,5141,628655,2628345,332726310,6,22069,1850287,18192,1390883,3877,459404,5424,29,7330,132,6,448,130000.0,39000.0,-70.0,-71.0,-68.0,-60.0,-70.0,-72.0,-69.0,-62.0,-90.0,-93.0,-89.0,-92.0,20.0,22.0,21.0,32.0,0
1179,CC:2F:71:3F:1F:24,4672171,3390028229,2043826,3057301919,2628345,332726310,43,564129,439941868,560239,439473150,3890,468718,537860,589,2045912,190444,43,4726,130000.0,43333.0,-74.0,-65.0,-74.0,-69.0,-73.0,-64.0,-74.0,-69.0,-90.0,-93.0,-89.0,-92.0,16.0,28.0,15.0,23.0,0
1180,F8:59:71:5A:E0:3D,2655465,374350488,27116,41623774,2628349,332726714,0,3246,406357,3161,392040,85,14317,3101,0,27130,865,0,27,130000.0,39000.0,-67.0,-73.0,-63.0,-72.0,-67.0,-73.0,-65.0,-72.0,-89.0,-92.0,-89.0,-92.0,22.0,19.0,26.0,20.0,0
1181,CC:2F:71:3E:C5:1F,2633490,333355369,5141,628655,2628349,332726714,6,22069,1850287,18192,1390883,3877,459404,5424,29,7330,132,6,448,130000.0,39000.0,-70.0,-71.0,-68.0,-60.0,-70.0,-72.0,-69.0,-62.0,-89.0,-92.0,-89.0,-92.0,19.0,21.0,21.0,32.0,0
1182,CC:2F:71:3F:1F:24,4675977,3395983475,2047626,3063256567,2628351,332726908,43,564609,440004136,560719,439535418,3890,468718,538340,589,2049633,191473,43,4727,86667.0,14444.0,-72.0,-65.0,-75.0,-69.0,-71.0,-65.0,-74.0,-69.0,-89.0,-92.0,-89.0,-92.0,17.0,27.0,14.0,23.0,0
1183,F8:59:71:5A:E0:3D,2655474,374351386,27118,41624006,2628356,332727380,0,3251,406779,3166,392462,85,14317,3103,0,27132,865,0,27,130000.0,39000.0,-67.0,-74.0,-66.0,-73.0,-67.0,-73.0,-64.0,-72.0,-89.0,-92.0,-89.0,-92.0,22.0,18.0,23.0,19.0,0
1184,CC:2F:71:3E:C5:1F,2633497,333356035,5141,628655,2628356,332727380,6,22069,1850287,18192,1390883,3877,459404,5424,29,7330,132,6,448,130000.0,39000.0,-70.0,-71.0,-68.0,-60.0,-70.0,-72.0,-69.0,-62.0,-89.0,-92.0,-89.0,-92.0,19.0,21.0,21.0,32.0,0
1185,CC:2F:71:3F:1F:24,4680468,3402984501,2052110,3070256919,2628358,332727582,43,565193,440095018,561303,439626300,3890,468718,538924,589,2054132,191781,43,4732,115556.0,28889.0,-74.0,-65.0,-76.0,-68.0,-73.0,-65.0,-75.0,-68.0,-89.0,-92.0,-89.0,-92.0,15.0,27.0,13.0,24.0,0
1186,F8:59:71:5A:E0:3D,2655482,374352202,27118,41624006,2628364,332728196,0,3254,407171,3167,392532,87,14639,3105,0,27132,865,0,27,130000.0,39000.0,-66.0,-74.0,-63.0,-70.0,-67.0,-74.0,-64.0,-71.0,-90.0,-92.0,-89.0,-92.0,24.0,18.0,26.0,22.0,0
1187,CC:2F:71:3E:C5:1F,2633506,333356911,5141,628655,2628365,332728256,6,22069,1850287,18192,1390883,3877,459404,5424,29,7330,132,6,448,130000.0,39000.0,-70.0,-71.0,-68.0,-60.0,-70.0,-72.0,-69.0,-62.0,-90.0,-92.0,-89.0,-92.0,20.0,21.0,21.0,32.0,0
1188,CC:2F:71:3F:1F:24,4685662,3411125725,2057297,3078397469,2628365,332728256,43,565994,440195134,562104,439726416,3890,468718,539725,589,2059383,192436,43,4732,86667.0,14444.0,-73.0,-65.0,-74.0,-69.0,-73.0,-65.0,-73.0,-68.0,-90.0,-92.0,-89.0,-92.0,17.0,27.0,15.0,23.0,0
1189,F8:59:71:5A:E0:3D,2655488,374352939,27118,41624006,2628370,332728933,0,3254,407171,3167,392532,87,14639,3105,0,27132,865,0,27,130000.0,39000.0,-66.0,-74.0,-63.0,-70.0,-67.0,-74.0,-64.0,-71.0,-90.0,-92.0,-89.0,-92.0,24.0,18.0,26.0,22.0,0
1190,CC:2F:71:3E:C5:1F,2633511,333357588,5141,628655,2628370,332728933,6,22069,1850287,18192,1390883,3877,459404,5424,29,7330,132,6,448,130000.0,39000.0,-70.0,-71.0,-68.0,-60.0,-70.0,-72.0,-69.0,-62.0,-90.0,-92.0,-89.0,-92.0,20.0,21.0,21.0,32.0,0
1191,CC:2F:71:3F:1F:24,4689984,3417892322,2061612,3085163187,2628372,332729135,43,566527,440263136,562637,439794418,3890,468718,540256,589,2063698,192837,43,4732,117000.0,39000.0,-76.0,-66.0,-74.0,-69.0,-75.0,-65.0,-73.0,-69.0,-90.0,-92.0,-89.0,-92.0,14.0,26.0,15.0,23.0,0
1192,F8:59:71:5A:E0:3D,2655494,374353545,27118,41624006,2628376,332729539,0,3254,407171,3167,392532,87,14639,3105,0,27132,865,0,27,130000.0,39000.0,-66.0,-74.0,-63.0,-70.0,-67.0,-74.0,-64.0,-71.0,-90.0,-92.0,-89.0,-92.0,24.0,18.0,26.0,22.0,0
1193,CC:2F:71:3E:C5:1F,2633520,333358456,5141,628655,2628379,332729801,6,22069,1850287,18192,1390883,3877,459404,5424,29,7330,132,6,448,130000.0,39000.0,-70.0,-71.0,-68.0,-60.0,-70.0,-72.0,-69.0,-62.0,-90.0,-92.0,-89.0,-92.0,20.0,21.0,21.0,32.0,0
1194,CC:2F:71:3F:1F:24,4695166,3426007345,2066787,3093277544,2628379,332729801,43,567312,440361820,563422,439893102,3890,468718,541036,589,2068873,193350,43,4733,117000.0,39000.0,-72.0,-65.0,-74.0,-69.0,-72.0,-65.0,-74.0,-69.0,-90.0,-92.0,-89.0,-92.0,18.0,27.0,15.0,23.0,0
1195,F8:59:71:5A:E0:3D,2655501,374354211,27118,41624006,2628383,332730205,0,3254,407171,3167,392532,87,14639,3105,0,27132,865,0,27,130000.0,39000.0,-66.0,-74.0,-63.0,-70.0,-67.0,-74.0,-64.0,-71.0,-90.0,-92.0,-89.0,-92.0,24.0,18.0,26.0,22.0,0
1196,CC:2F:71:3E:C5:1F,2633524,333358860,5141,628655,2628383,332730205,6,22069,1850287,18192,1390883,3877,459404,5424,29,7330,132,6,448,130000.0,39000.0,-70.0,-71.0,-68.0,-60.0,-70.0,-72.0,-69.0,-62.0,-90.0,-92.0,-89.0,-92.0,20.0,21.0,21.0,32.0,0
1197,CC:2F:71:3F:1F:24,4697349,3429408347,2068966,3096678142,2628383,332730205,43,567649,440403696,563759,439934978,3890,468718,541373,589,2071019,193645,43,4733,130000.0,39000.0,-72.0,-64.0,-75.0,-68.0,-72.0,-64.0,-74.0,-67.0,-90.0,-92.0,-89.0,-92.0,18.0,28.0,14.0,24.0,0
1198,F8:59:71:5A:E0:3D,2655505,374354615,27118,41624006,2628387,332730609,0,3254,407171,3167,392532,87,14639,3105,0,27132,865,0,27,130000.0,39000.0,-66.0,-74.0,-63.0,-70.0,-67.0,-74.0,-64.0,-71.0,-90.0,-93.0,-89.0,-92.0,24.0,19.0,26.0,22.0,0
1199,CC:2F:71:3E:C5:1F,2633529,333359324,5141,628655,2628388,332730669,6,22069,1850287,18192,1390883,3877,459404,5424,29,7330,132,6,448,130000.0,39000.0,-70.0,-71.0,-68.0,-60.0,-70.0,-72.0,-69.0,-62.0,-90.0,-93.0,-89.0,-92.0,20.0,22.0,21.0,32.0,0
1200,CC:2F:71:3F:1F:24,4703166,3438472661,2074774,3105741588,2628392,332731073,43,568458,440523615,564568,440054897,3890,468718,542175,589,2076789,195872,43,4733,86667.0,14444.0,-72.0,-65.0,-73.0,-69.0,-72.0,-64.0,-73.0,-67.0,-90.0,-93.0,-89.0,-92.0,18.0,28.0,16.0,23.0,0
1201,F8:59:71:5A:E0:3D,2655514,374355483,27118,41624006,2628396,332731477,0,3254,407171,3167,392532,87,14639,3105,0,27132,865,0,27,130000.0,39000.0,-66.0,-74.0,-63.0,-70.0,-67.0,-74.0,-64.0,-71.0,-90.0,-93.0,-89.0,-92.0,24.0,19.0,26.0,22.0,0
1202,CC:2F:71:3E:C5:1F,2633537,333360132,5141,628655,2628396,332731477,6,22069,1850287,18192,1390883,3877,459404,5424,29,7330,132,6,448,130000.0,39000.0,-70.0,-71.0,-68.0,-60.0,-70.0,-72.0,-69.0,-62.0,-90.0,-93.0,-89.0,-92.0,20.0,22.0,21.0,32.0,0
1203,CC:2F:71:3F:1F:24,4708512,3446856965,2080116,3114125488,2628396,332731477,43,569438,440645141,565548,440176423,3890,468718,543130,589,2082202,196280,43,4736,86667.0,14444.0,-71.0,-66.0,-73.0,-68.0,-71.0,-66.0,-73.0,-68.0,-90.0,-93.0,-89.0,-92.0,19.0,27.0,16.0,24.0,0
1204,F8:59:71:5A:E0:3D,2655521,374356315,27118,41624006,2628403,332732309,0,3254,407171,3167,392532,87,14639,3105,0,27132,865,0,27,130000.0,39000.0,-66.0,-74.0,-63.0,-70.0,-67.0,-74.0,-64.0,-71.0,-90.0,-93.0,-89.0,-92.0,24.0,19.0,26.0,22.0,0
1205,CC:2F:71:3E:C5:1F,2633546,333361166,5141,628655,2628405,332732511,6,22069,1850287,18192,1390883,3877,459404,5424,29,7330,132,6,448,130000.0,39000.0,-70.0,-71.0,-68.0,-60.0,-70.0,-72.0,-69.0,-62.0,-90.0,-93.0,-89.0,-92.0,20.0,22.0,21.0,32.0,0
1206,CC:2F:71:3F:1F:24,4712712,3453403111,2084307,3120670600,2628405,332732511,43,570268,440763468,566378,440294750,3890,468718,543944,589,2086393,197017,43,4737,130000.0,43333.0,-70.0,-66.0,-73.0,-69.0,-70.0,-66.0,-73.0,-68.0,-90.0,-93.0,-89.0,-92.0,20.0,27.0,16.0,23.0,0
1207,F8:59:71:5A:E0:3D,2655525,374356719,27118,41624006,2628407,332732713,0,3254,407171,3167,392532,87,14639,3105,0,27132,865,0,27,130000.0,39000.0,-66.0,-74.0,-63.0,-70.0,-67.0,-74.0,-64.0,-71.0,-89.0,-92.0,-88.0,-92.0,23.0,18.0,25.0,22.0,0
1208,CC:2F:71:3E:C5:1F,2633552,333361772,5141,628655,2628411,332733117,6,22069,1850287,18192,1390883,3877,459404,5424,29,7330,132,6,448,130000.0,39000.0,-70.0,-71.0,-68.0,-60.0,-70.0,-72.0,-69.0,-62.0,-89.0,-92.0,-88.0,-92.0,19.0,21.0,20.0,32.0,0
1209,CC:2F:71:3F:1F:24,4717586,3461046325,2089175,3128313208,2628411,332733117,43,570933,440846874,567043,440378156,3890,468718,544608,589,2091237,197090,43,4738,130000.0,43333.0,-72.0,-65.0,-72.0,-68.0,-72.0,-65.0,-72.0,-67.0,-89.0,-92.0,-88.0,-92.0,17.0,27.0,16.0,24.0,0
1210,F8:59:71:5A:E0:3D,2655532,374357385,27118,41624006,2628414,332733379,0,3254,407171,3167,392532,87,14639,3105,0,27132,865,0,27,130000.0,39000.0,-66.0,-74.0,-63.0,-70.0,-67.0,-74.0,-64.0,-71.0,-89.0,-92.0,-88.0,-92.0,23.0,18.0,25.0,22.0,0
1211,CC:2F:71:3E:C5:1F,2633556,333362150,5142,628771,2628414,332733379,6,22070,1850357,18193,1390953,3877,459404,5424,29,7331,132,6,448,130000.0,39000.0,-70.0,-70.0,-69.0,-61.0,-70.0,-72.0,-69.0,-62.0,-89.0,-92.0,-88.0,-92.0,19.0,22.0,19.0,31.0,0
1212,CC:2F:71:3F:1F:24,4721698,3467488871,2093284,3134755492,2628414,332733379,43,571469,440914142,567579,440445424,3890,468718,545143,589,2095305,197275,43,4738,130000.0,43333.0,-73.0,-65.0,-73.0,-67.0,-73.0,-65.0,-73.0,-67.0,-89.0,-92.0,-88.0,-92.0,16.0,27.0,15.0,25.0,0
1213,F8:59:71:5A:E0:3D,2655539,374358107,27119,41624122,2628420,332733985,0,3256,407311,3169,392672,87,14639,3105,0,27133,865,0,27,130000.0,39000.0,-68.0,-75.0,-64.0,-73.0,-67.0,-74.0,-64.0,-71.0,-89.0,-92.0,-88.0,-92.0,21.0,17.0,24.0,19.0,0
1214,CC:2F:71:3E:C5:1F,2633562,333362756,5142,628771,2628420,332733985,6,22071,1850427,18194,1391023,3877,459404,5424,29,7331,132,6,448,130000.0,39000.0,-77.0,-85.0,-75.0,-72.0,-71.0,-74.0,-70.0,-64.0,-89.0,-92.0,-88.0,-92.0,12.0,7.0,13.0,20.0,0
1215,CC:2F:71:3F:1F:24,4727138,3475983672,2098718,3143249687,2628420,332733985,43,571989,440996939,568099,440528221,3890,468718,545659,589,2100692,197578,43,4738,130000.0,43333.0,-74.0,-65.0,-74.0,-69.0,-74.0,-65.0,-73.0,-68.0,-89.0,-92.0,-88.0,-92.0,15.0,27.0,14.0,23.0,0
1216,F8:59:71:5A:E0:3D,2655542,374358371,27119,41624122,2628423,332734249,0,3256,407311,3169,392672,87,14639,3105,0,27133,865,0,27,130000.0,39000.0,-68.0,-75.0,-64.0,-73.0,-67.0,-74.0,-64.0,-71.0,-90.0,-92.0,-89.0,-92.0,22.0,17.0,25.0,19.0,0
1217,CC:2F:71:3E:C5:1F,2633565,333363020,5142,628771,2628423,332734249,6,22071,1850427,18194,1391023,3877,459404,5424,29,7331,132,6,448,130000.0,39000.0,-77.0,-85.0,-75.0,-72.0,-71.0,-74.0,-70.0,-64.0,-90.0,-92.0,-89.0,-92.0,13.0,7.0,14.0,20.0,0
1218,CC:2F:71:3F:1F:24,4732242,3483986160,2103817,3151251709,2628425,332734451,43,572673,441081499,568782,440612663,3891,468836,546343,589,2105884,197696,43,4738,130000.0,43333.0,-73.0,-65.0,-73.0,-67.0,-72.0,-65.0,-73.0,-67.0,-90.0,-92.0,-89.0,-92.0,17.0,27.0,16.0,25.0,0
1219,F8:59:71:5A:E0:3D,2655549,374359037,27119,41624122,2628430,332734915,0,3256,407311,3169,392672,87,14639,3105,0,27133,865,0,27,130000.0,39000.0,-68.0,-75.0,-64.0,-73.0,-67.0,-74.0,-64.0,-71.0,-90.0,-92.0,-89.0,-92.0,22.0,17.0,25.0,19.0,0
1220,CC:2F:71:3E:C5:1F,2633572,333363686,5142,628771,2628430,332734915,6,22071,1850427,18194,1391023,3877,459404,5424,29,7331,132,6,448,130000.0,39000.0,-77.0,-85.0,-75.0,-72.0,-71.0,-74.0,-70.0,-64.0,-90.0,-92.0,-89.0,-92.0,13.0,7.0,14.0,20.0,0
1221,CC:2F:71:3F:1F:24,4736468,3490596533,2108038,3157861618,2628430,332734915,43,573108,441141786,569217,440672950,3891,468836,546777,589,2110109,197802,43,4738,130000.0,43333.0,-71.0,-63.0,-74.0,-68.0,-71.0,-63.0,-73.0,-68.0,-90.0,-92.0,-89.0,-92.0,19.0,29.0,15.0,24.0,0
1222,F8:59:71:5A:E0:3D,2655554,374359714,27119,41624122,2628435,332735592,0,3256,407311,3169,392672,87,14639,3105,0,27133,865,0,27,130000.0,39000.0,-68.0,-75.0,-64.0,-73.0,-67.0,-74.0,-64.0,-71.0,-90.0,-92.0,-89.0,-92.0,22.0,17.0,25.0,19.0,0
1223,CC:2F:71:3E:C5:1F,2633577,333364363,5142,628771,2628435,332735592,6,22071,1850427,18194,1391023,3877,459404,5424,29,7331,132,6,448,130000.0,39000.0,-77.0,-85.0,-75.0,-72.0,-71.0,-74.0,-70.0,-64.0,-90.0,-92.0,-89.0,-92.0,13.0,7.0,14.0,20.0,0
1224,CC:2F:71:3F:1F:24,4741633,3498589534,2113198,3165853942,2628435,332735592,43,573755,441244822,569864,440775986,3891,468836,547424,589,2115229,199003,43,4738,130000.0,43333.0,-72.0,-65.0,-73.0,-68.0,-72.0,-65.0,-73.0,-68.0,-90.0,-92.0,-89.0,-92.0,18.0,27.0,16.0,24.0,0
1225,F8:59:71:5A:E0:3D,2655559,374360178,27119,41624122,2628440,332736056,0,3256,407311,3169,392672,87,14639,3105,0,27133,865,0,27,130000.0,39000.0,-68.0,-75.0,-64.0,-73.0,-67.0,-74.0,-64.0,-71.0,-89.0,-91.0,-89.0,-91.0,21.0,16.0,25.0,18.0,0
1226,CC:2F:71:3E:C5:1F,2633582,333364827,5142,628771,2628440,332736056,6,22071,1850427,18194,1391023,3877,459404,5424,29,7331,132,6,448,130000.0,39000.0,-77.0,-85.0,-75.0,-72.0,-71.0,-74.0,-70.0,-64.0,-89.0,-91.0,-89.0,-91.0,12.0,6.0,14.0,19.0,0
1227,CC:2F:71:3F:1F:24,4747032,3507053058,2118592,3174317002,2628440,332736056,43,574345,441316768,570454,440847932,3891,468836,548014,589,2120663,199596,43,4738,130000.0,43333.0,-73.0,-65.0,-74.0,-68.0,-72.0,-65.0,-73.0,-67.0,-89.0,-91.0,-89.0,-91.0,16.0,26.0,15.0,23.0,0
1228,F8:59:71:5A:E0:3D,2655563,374360582,27119,41624122,2628444,332736460,0,3256,407311,3169,392672,87,14639,3105,0,27133,865,0,27,130000.0,39000.0,-68.0,-75.0,-64.0,-73.0,-67.0,-74.0,-64.0,-71.0,-89.0,-91.0,-89.0,-91.0,21.0,16.0,25.0,18.0,0
1229,CC:2F:71:3E:C5:1F,2633588,333365433,5142,628771,2628446,332736662,6,22071,1850427,18194,1391023,3877,459404,5424,29,7331,132,6,448,130000.0,39000.0,-77.0,-85.0,-75.0,-72.0,-71.0,-74.0,-70.0,-64.0,-89.0,-91.0,-89.0,-91.0,12.0,6.0,14.0,19.0,0
1230,CC:2F:71:3F:1F:24,4752199,3515154416,2123751,3182417552,2628448,332736864,43,575101,441408020,571210,440939184,3891,468836,548767,589,2125791,200009,43,4738,130000.0,43333.0,-72.0,-65.0,-73.0,-66.0,-72.0,-65.0,-72.0,-66.0,-89.0,-91.0,-89.0,-91.0,17.0,26.0,16.0,25.0,0
1231,F8:59:71:5A:E0:3D,2655568,374361046,27119,41624122,2628449,332736924,0,3256,407311,3169,392672,87,14639,3105,0,27133,865,0,27,130000.0,39000.0,-68.0,-75.0,-64.0,-73.0,-67.0,-74.0,-64.0,-71.0,-89.0,-91.0,-89.0,-91.0,21.0,16.0,25.0,18.0,0
1232,CC:2F:71:3E:C5:1F,2633593,333365897,5142,628771,2628451,332737126,6,22071,1850427,18194,1391023,3877,459404,5424,29,7331,132,6,448,130000.0,39000.0,-77.0,-85.0,-75.0,-72.0,-71.0,-74.0,-70.0,-64.0,-89.0,-91.0,-89.0,-91.0,12.0,6.0,14.0,19.0,0
1233,CC:2F:71:3F:1F:24,4756207,3521421701,2127756,3188684575,2628451,332737126,43,575545,441466099,571654,440997263,3891,468836,549211,589,2129725,201530,43,4739,115556.0,28889.0,-73.0,-65.0,-74.0,-68.0,-72.0,-65.0,-74.0,-67.0,-89.0,-91.0,-89.0,-91.0,16.0,26.0,15.0,23.0,0
1234,F8:59:71:5A:E0:3D,2655577,374361916,27119,41624122,2628458,332737794,0,3258,407499,3170,392742,88,14757,3106,0,27133,865,0,27,130000.0,39000.0,-68.0,-75.0,-66.0,-73.0,-67.0,-74.0,-64.0,-71.0,-89.0,-91.0,-89.0,-91.0,21.0,16.0,23.0,18.0,0
1235,CC:2F:71:3E:C5:1F,2633624,333377615,5142,628771,2628482,332748844,6,22072,1850497,18195,1391093,3877,459404,5424,30,7332,133,6,448,130000.0,39000.0,-70.0,-71.0,-70.0,-60.0,-71.0,-74.0,-70.0,-64.0,-89.0,-91.0,-89.0,-91.0,19.0,20.0,19.0,31.0,0
1236,CC:2F:71:3F:1F:24,4761361,3529465033,2132879,3196716189,2628482,332748844,50,576286,441557099,572395,441088263,3891,468836,549938,590,2134966,201879,50,4739,130000.0,39000.0,-73.0,-65.0,-73.0,-68.0,-73.0,-65.0,-72.0,-68.0,-89.0,-91.0,-89.0,-91.0,16.0,26.0,16.0,23.0,0
1237,F8:59:71:5A:E0:3D,2655609,374373694,27119,41624122,2628490,332749572,0,3258,407499,3170,392742,88,14757,3106,0,27133,865,0,27,130000.0,39000.0,-68.0,-75.0,-66.0,-73.0,-67.0,-74.0,-64.0,-71.0,-89.0,-91.0,-89.0,-91.0,21.0,16.0,23.0,18.0,0
1238,CC:2F:71:3E:C5:1F,2633632,333378343,5142,628771,2628490,332749572,6,22075,1850755,18197,1391233,3878,459522,5425,30,7332,133,6,448,130000.0,39000.0,-70.0,-71.0,-70.0,-60.0,-70.0,-71.0,-69.0,-61.0,-89.0,-91.0,-89.0,-91.0,19.0,20.0,19.0,31.0,0
1239,CC:2F:71:3F:1F:24,4763740,3533166375,2135250,3200416803,2628490,332749572,50,576525,441587869,572634,441119033,3891,468836,550171,590,2137325,201931,50,4739,130000.0,43333.0,-74.0,-66.0,-74.0,-68.0,-73.0,-65.0,-73.0,-68.0,-89.0,-91.0,-89.0,-91.0,15.0,25.0,15.0,23.0,0
1240,F8:59:71:5A:E0:3D,2655613,374374098,27119,41624122,2628494,332749976,0,3258,407499,3170,392742,88,14757,3106,0,27133,865,0,27,130000.0,39000.0,-68.0,-75.0,-66.0,-73.0,-67.0,-74.0,-64.0,-71.0,-89.0,-91.0,-88.0,-91.0,21.0,16.0,22.0,18.0,0
1241,CC:2F:71:3E:C5:1F,2633641,333379211,5142,628771,2628499,332750440,6,22075,1850755,18197,1391233,3878,459522,5425,30,7332,133,6,448,130000.0,39000.0,-70.0,-71.0,-70.0,-60.0,-70.0,-71.0,-69.0,-61.0,-89.0,-91.0,-88.0,-91.0,19.0,20.0,18.0,31.0,0
1242,CC:2F:71:3F:1F:24,4769169,3541679875,2140670,3208929435,2628499,332750440,50,577300,441682263,573409,441213427,3891,468836,550934,590,2142757,202425,50,4739,130000.0,43333.0,-73.0,-66.0,-74.0,-69.0,-73.0,-65.0,-73.0,-68.0,-89.0,-91.0,-88.0,-91.0,16.0,25.0,14.0,22.0,0
1243,F8:59:71:5A:E0:3D,2655620,374374764,27119,41624122,2628501,332750642,0,3258,407499,3170,392742,88,14757,3106,0,27133,865,0,27,130000.0,39000.0,-68.0,-75.0,-66.0,-73.0,-67.0,-74.0,-64.0,-71.0,-89.0,-91.0,-88.0,-91.0,21.0,16.0,22.0,18.0,0
1244,CC:2F:71:3E:C5:1F,2633645,333379615,5142,628771,2628503,332750844,6,22075,1850755,18197,1391233,3878,459522,5425,30,7332,133,6,448,130000.0,39000.0,-70.0,-71.0,-70.0,-60.0,-70.0,-71.0,-69.0,-61.0,-89.0,-91.0,-88.0,-91.0,19.0,20.0,18.0,31.0,0
1245,CC:2F:71:3F:1F:24,4772481,3546857093,2143976,3214106047,2628505,332751046,50,577835,441748525,573944,441279689,3891,468836,551444,590,2146063,202558,50,4740,130000.0,43333.0,-73.0,-65.0,-73.0,-68.0,-73.0,-66.0,-73.0,-69.0,-89.0,-91.0,-88.0,-91.0,16.0,26.0,15.0,23.0,0
1246,F8:59:71:5A:E0:3D,2655627,374375430,27119,41624122,2628508,332751308,0,3258,407499,3170,392742,88,14757,3106,0,27133,865,0,27,130000.0,39000.0,-68.0,-75.0,-66.0,-73.0,-67.0,-74.0,-64.0,-71.0,-89.0,-91.0,-88.0,-91.0,21.0,16.0,22.0,18.0,0
1247,CC:2F:71:3E:C5:1F,2633650,333380079,5142,628771,2628508,332751308,6,22075,1850755,18197,1391233,3878,459522,5425,30,7332,133,6,448,130000.0,39000.0,-70.0,-71.0,-70.0,-60.0,-70.0,-71.0,-69.0,-61.0,-89.0,-91.0,-88.0,-91.0,19.0,20.0,18.0,31.0,0
1248,CC:2F:71:3F:1F:24,4776217,3552707773,2147709,3219956465,2628508,332751308,50,578355,441813747,574464,441344911,3891,468836,551962,590,2149781,202640,50,4740,130000.0,43333.0,-72.0,-64.0,-73.0,-68.0,-72.0,-64.0,-73.0,-67.0,-89.0,-91.0,-88.0,-91.0,17.0,27.0,15.0,23.0,0
1249,F8:59:71:5A:E0:3D,2655634,374376309,27119,41624122,2628515,332752187,0,3258,407499,3170,392742,88,14757,3106,0,27133,865,0,27,130000.0,39000.0,-68.0,-75.0,-66.0,-73.0,-67.0,-74.0,-64.0,-71.0,-89.0,-91.0,-88.0,-91.0,21.0,16.0,22.0,18.0,0
1250,CC:2F:71:3E:C5:1F,2633657,333380958,5142,628771,2628515,332752187,6,22075,1850755,18197,1391233,3878,459522,5425,30,7332,133,6,448,130000.0,39000.0,-70.0,-71.0,-70.0,-60.0,-70.0,-71.0,-69.0,-61.0,-89.0,-91.0,-88.0,-91.0,19.0,20.0,18.0,31.0,0
1251,CC:2F:71:3F:1F:24,4781226,3560557150,2152709,3227804761,2628517,332752389,50,578942,441887633,575051,441418797,3891,468836,552549,590,2154713,202881,50,4740,130000.0,43333.0,-72.0,-64.0,-73.0,-68.0,-71.0,-64.0,-72.0,-67.0,-89.0,-91.0,-88.0,-91.0,17.0,27.0,15.0,23.0,0
1252,F8:59:71:5A:E0:3D,2655636,374376511,27119,41624122,2628517,332752389,0,3258,407499,3170,392742,88,14757,3106,0,27133,865,0,27,130000.0,39000.0,-68.0,-75.0,-66.0,-73.0,-67.0,-74.0,-64.0,-71.0,-89.0,-91.0,-88.0,-91.0,21.0,16.0,22.0,18.0,0
1253,CC:2F:71:3E:C5:1F,2633661,333381362,5142,628771,2628519,332752591,6,22075,1850755,18197,1391233,3878,459522,5425,30,7332,133,6,448,130000.0,39000.0,-70.0,-71.0,-70.0,-60.0,-70.0,-71.0,-69.0,-61.0,-89.0,-91.0,-88.0,-91.0,19.0,20.0,18.0,31.0,0
1254,CC:2F:71:3F:1F:24,4785429,3567146498,2156910,3234393907,2628519,332752591,50,579325,441937751,575434,441468915,3891,468836,552920,590,2158997,203050,50,4740,130000.0,43333.0,-72.0,-64.0,-73.0,-68.0,-72.0,-64.0,-73.0,-67.0,-89.0,-91.0,-88.0,-91.0,17.0,27.0,15.0,23.0,0
1255,F8:59:71:5A:E0:3D,2655643,374377177,27119,41624122,2628524,332753055,0,3258,407499,3170,392742,88,14757,3106,0,27133,865,0,27,130000.0,39000.0,-68.0,-75.0,-66.0,-73.0,-67.0,-74.0,-64.0,-71.0,-89.0,-91.0,-88.0,-91.0,21.0,16.0,22.0,18.0,0
1256,CC:2F:71:3E:C5:1F,2633668,333382028,5142,628771,2628526,332753257,6,22075,1850755,18197,1391233,3878,459522,5425,30,7332,133,6,448,130000.0,39000.0,-70.0,-71.0,-70.0,-60.0,-70.0,-71.0,-69.0,-61.0,-89.0,-91.0,-88.0,-91.0,19.0,20.0,18.0,31.0,0
1257,CC:2F:71:3F:1F:24,4790323,3574818818,2161797,3242065561,2628526,332753257,50,579914,442010557,576023,441541721,3891,468836,553509,590,2163863,203156,50,4740,130000.0,43333.0,-72.0,-64.0,-72.0,-67.0,-72.0,-64.0,-72.0,-67.0,-89.0,-91.0,-88.0,-91.0,17.0,27.0,16.0,24.0,0
1258,F8:59:71:5A:E0:3D,2655645,374377379,27119,41624122,2628526,332753257,0,3258,407499,3170,392742,88,14757,3106,0,27133,865,0,27,130000.0,39000.0,-68.0,-75.0,-66.0,-73.0,-67.0,-74.0,-64.0,-71.0,-89.0,-91.0,-88.0,-91.0,21.0,16.0,22.0,18.0,0
1259,CC:2F:71:3E:C5:1F,2633670,333382230,5142,628771,2628528,332753459,6,22075,1850755,18197,1391233,3878,459522,5425,30,7332,133,6,448,130000.0,39000.0,-70.0,-71.0,-70.0,-60.0,-70.0,-71.0,-69.0,-61.0,-89.0,-91.0,-88.0,-91.0,19.0,20.0,18.0,31.0,0
1260,CC:2F:71:3F:1F:24,4794416,3581232690,2165888,3248479231,2628528,332753459,50,580556,442088327,576665,441619491,3891,468836,554151,590,2167958,203414,50,4740,130000.0,43333.0,-72.0,-64.0,-73.0,-67.0,-72.0,-64.0,-73.0,-67.0,-89.0,-91.0,-88.0,-91.0,17.0,27.0,15.0,24.0,0
1261,F8:59:71:5A:E0:3D,2655654,374378247,27119,41624122,2628535,332754125,0,3258,407499,3170,392742,88,14757,3106,0,27133,865,0,27,130000.0,39000.0,-68.0,-75.0,-66.0,-73.0,-67.0,-74.0,-64.0,-71.0,-89.0,-91.0,-88.0,-91.0,21.0,16.0,22.0,18.0,0
1262,CC:2F:71:3E:C5:1F,2633677,333382896,5142,628771,2628535,332754125,6,22075,1850755,18197,1391233,3878,459522,5425,30,7332,133,6,448,130000.0,39000.0,-70.0,-71.0,-70.0,-60.0,-70.0,-71.0,-69.0,-61.0,-89.0,-91.0,-88.0,-91.0,19.0,20.0,18.0,31.0,0
1263,CC:2F:71:3F:1F:24,4799710,3589534762,2171175,3256780637,2628535,332754125,50,581273,442176969,577382,441708133,3891,468836,554868,590,2173262,203527,50,4743,130000.0,43333.0,-72.0,-65.0,-73.0,-68.0,-72.0,-65.0,-73.0,-67.0,-89.0,-91.0,-88.0,-91.0,17.0,26.0,15.0,23.0,0
1264,F8:59:71:5A:E0:3D,2655656,374378449,27119,41624122,2628537,332754327,0,3258,407499,3170,392742,88,14757,3106,0,27133,865,0,27,130000.0,39000.0,-68.0,-75.0,-66.0,-73.0,-67.0,-74.0,-64.0,-71.0,-89.0,-91.0,-88.0,-90.0,21.0,16.0,22.0,17.0,0
1265,CC:2F:71:3E:C5:1F,2633679,333383098,5142,628771,2628537,332754327,6,22075,1850755,18197,1391233,3878,459522,5425,30,7332,133,6,448,130000.0,39000.0,-70.0,-71.0,-70.0,-60.0,-70.0,-71.0,-69.0,-61.0,-89.0,-91.0,-88.0,-90.0,19.0,20.0,18.0,30.0,0
1266,CC:2F:71:3F:1F:24,4804661,3597302558,2176124,3264548231,2628537,332754327,50,581975,442262987,578084,441794151,3891,468836,555570,590,2178176,203781,50,4743,130000.0,43333.0,-73.0,-64.0,-73.0,-68.0,-72.0,-64.0,-73.0,-68.0,-89.0,-91.0,-88.0,-90.0,16.0,27.0,15.0,22.0,0
1267,F8:59:71:5A:E0:3D,2655662,374379055,27119,41624122,2628543,332754933,0,3258,407499,3170,392742,88,14757,3106,0,27133,865,0,27,130000.0,39000.0,-68.0,-75.0,-66.0,-73.0,-67.0,-74.0,-64.0,-71.0,-89.0,-91.0,-88.0,-90.0,21.0,16.0,22.0,17.0,0
1268,CC:2F:71:3E:C5:1F,2633685,333383704,5142,628771,2628543,332754933,6,22075,1850755,18197,1391233,3878,459522,5425,30,7332,133,6,448,130000.0,39000.0,-70.0,-71.0,-70.0,-60.0,-70.0,-71.0,-69.0,-61.0,-89.0,-91.0,-88.0,-90.0,19.0,20.0,18.0,30.0,0
1269,CC:2F:71:3F:1F:24,4810129,3605865624,2181583,3273110429,2628546,332755195,50,582620,442343688,578729,441874852,3891,468836,556214,590,2183670,205751,50,4745,104000.0,26000.0,-73.0,-65.0,-72.0,-67.0,-71.0,-65.0,-72.0,-67.0,-89.0,-91.0,-88.0,-90.0,16.0,26.0,16.0,23.0,0
1270,F8:59:71:5A:E0:3D,2655669,374379721,27119,41624122,2628550,332755599,0,3258,407499,3170,392742,88,14757,3106,0,27133,865,0,27,130000.0,39000.0,-68.0,-75.0,-66.0,-73.0,-67.0,-74.0,-64.0,-71.0,-89.0,-91.0,-88.0,-90.0,21.0,16.0,22.0,17.0,0
1271,CC:2F:71:3E:C5:1F,2633694,333384572,5142,628771,2628552,332755801,6,22075,1850755,18197,1391233,3878,459522,5425,30,7332,133,6,448,130000.0,39000.0,-70.0,-71.0,-70.0,-60.0,-70.0,-71.0,-69.0,-61.0,-89.0,-91.0,-88.0,-90.0,19.0,20.0,18.0,30.0,0
1272,CC:2F:71:3F:1F:24,4813722,3611478708,2185170,3278722907,2628552,332755801,50,583070,442401666,579179,441932830,3891,468836,556664,590,2187257,206782,50,4746,65000.0,13000.0,-71.0,-64.0,-73.0,-67.0,-71.0,-64.0,-73.0,-66.0,-89.0,-91.0,-88.0,-90.0,18.0,27.0,15.0,23.0,0
1273,F8:59:71:5A:E0:3D,2655675,374380301,27120,41624238,2628555,332756063,0,3259,407569,3171,392812,88,14757,3106,0,27134,865,0,27,130000.0,39000.0,-68.0,-74.0,-66.0,-73.0,-67.0,-74.0,-64.0,-71.0,-89.0,-91.0,-88.0,-90.0,21.0,17.0,22.0,17.0,0
1274,CC:2F:71:3E:C5:1F,2633698,333384950,5143,628887,2628555,332756063,6,22076,1850825,18198,1391303,3878,459522,5425,30,7333,133,6,448,130000.0,39000.0,-70.0,-71.0,-71.0,-60.0,-70.0,-72.0,-70.0,-61.0,-89.0,-91.0,-88.0,-90.0,19.0,20.0,17.0,30.0,0
1275,CC:2F:71:3F:1F:24,4817665,3617649916,2189110,3284893853,2628555,332756063,50,583601,442468911,579710,442000075,3891,468836,557194,590,2191107,206863,50,4747,86667.0,14444.0,-72.0,-65.0,-74.0,-67.0,-71.0,-64.0,-73.0,-67.0,-89.0,-91.0,-88.0,-90.0,17.0,26.0,14.0,23.0,0
1276,F8:59:71:5A:E0:3D,2655681,374380907,27120,41624238,2628561,332756669,0,3260,407639,3172,392882,88,14757,3106,0,27134,865,0,27,130000.0,39000.0,-74.0,-81.0,-78.0,-75.0,-68.0,-75.0,-66.0,-72.0,-89.0,-91.0,-88.0,-90.0,15.0,10.0,10.0,15.0,0
1277,CC:2F:71:3E:C5:1F,2633704,333385556,5143,628887,2628561,332756669,6,22077,1850895,18199,1391373,3878,459522,5425,30,7333,133,6,448,130000.0,39000.0,-66.0,-70.0,-64.0,-60.0,-70.0,-72.0,-69.0,-61.0,-89.0,-91.0,-88.0,-90.0,23.0,21.0,24.0,30.0,0
1278,CC:2F:71:3F:1F:24,4821608,3623808394,2193045,3291051523,2628563,332756871,50,584224,442548979,580333,442080143,3891,468836,557817,590,2195097,207197,50,4748,86667.0,14444.0,-72.0,-65.0,-74.0,-69.0,-72.0,-64.0,-73.0,-68.0,-89.0,-91.0,-88.0,-90.0,17.0,26.0,14.0,21.0,0
1279,F8:59:71:5A:E0:3D,2655690,374381775,27120,41624238,2628570,332757537,0,3260,407639,3172,392882,88,14757,3106,0,27134,865,0,27,130000.0,39000.0,-74.0,-81.0,-78.0,-75.0,-68.0,-75.0,-66.0,-72.0,-89.0,-91.0,-88.0,-90.0,15.0,10.0,10.0,15.0,0
1280,CC:2F:71:3E:C5:1F,2633713,333386424,5143,628887,2628570,332757537,6,22077,1850895,18199,1391373,3878,459522,5425,30,7333,133,6,448,130000.0,39000.0,-66.0,-70.0,-64.0,-60.0,-70.0,-72.0,-69.0,-61.0,-89.0,-91.0,-88.0,-90.0,23.0,21.0,24.0,30.0,0
1281,CC:2F:71:3F:1F:24,4825729,3630256744,2197159,3297499207,2628570,332757537,50,584878,442629775,580987,442160939,3891,468836,558433,590,2199246,207230,50,4749,86667.0,14444.0,-73.0,-66.0,-74.0,-68.0,-72.0,-66.0,-74.0,-68.0,-89.0,-91.0,-88.0,-90.0,16.0,25.0,14.0,22.0,0
1282,F8:59:71:5A:E0:3D,2655693,374382250,27120,41624238,2628573,332758012,0,3260,407639,3172,392882,88,14757,3106,0,27134,865,0,27,130000.0,39000.0,-74.0,-81.0,-78.0,-75.0,-68.0,-75.0,-66.0,-72.0,-89.0,-91.0,-88.0,-90.0,15.0,10.0,10.0,15.0,0
1283,CC:2F:71:3E:C5:1F,2633719,333387235,5143,628887,2628576,332758348,6,22077,1850895,18199,1391373,3878,459522,5425,30,7333,133,6,448,130000.0,39000.0,-66.0,-70.0,-64.0,-60.0,-70.0,-72.0,-69.0,-61.0,-89.0,-91.0,-88.0,-90.0,23.0,21.0,24.0,30.0,0
1284,CC:2F:71:3F:1F:24,4831259,3638927149,2202682,3306168733,2628577,332758416,50,585826,442745287,581935,442276451,3891,468836,559381,590,2204769,207833,50,4751,86667.0,14444.0,-72.0,-65.0,-75.0,-68.0,-72.0,-65.0,-75.0,-68.0,-89.0,-91.0,-88.0,-90.0,17.0,26.0,13.0,22.0,0
1285,F8:59:71:5A:E0:3D,2655701,374382978,27120,41624238,2628581,332758740,0,3260,407639,3172,392882,88,14757,3106,0,27134,865,0,27,130000.0,39000.0,-74.0,-81.0,-78.0,-75.0,-68.0,-75.0,-66.0,-72.0,-89.0,-91.0,-88.0,-90.0,15.0,10.0,10.0,15.0,0
1286,CC:2F:71:3E:C5:1F,2633724,333387627,5143,628887,2628581,332758740,6,22077,1850895,18199,1391373,3878,459522,5425,30,7333,133,6,448,130000.0,39000.0,-66.0,-70.0,-64.0,-60.0,-70.0,-72.0,-69.0,-61.0,-89.0,-91.0,-88.0,-90.0,23.0,21.0,24.0,30.0,0
1287,CC:2F:71:3F:1F:24,4835976,3646318145,2207393,3313559203,2628583,332758942,50,586575,442837957,582683,442369003,3892,468954,560130,590,2209480,208313,50,4751,86667.0,14444.0,-71.0,-65.0,-73.0,-67.0,-71.0,-64.0,-74.0,-67.0,-89.0,-91.0,-88.0,-90.0,18.0,26.0,15.0,23.0,0
1288,F8:59:71:5A:E0:3D,2655710,374383848,27120,41624238,2628590,332759610,0,3262,407827,3173,392952,89,14875,3107,0,27134,865,0,27,130000.0,39000.0,-65.0,-63.0,-65.0,-64.0,-68.0,-74.0,-66.0,-72.0,-89.0,-91.0,-88.0,-90.0,24.0,28.0,23.0,26.0,0
1289,CC:2F:71:3E:C5:1F,2633733,333388497,5143,628887,2628590,332759610,6,22077,1850895,18199,1391373,3878,459522,5425,30,7333,133,6,448,130000.0,39000.0,-66.0,-70.0,-64.0,-60.0,-70.0,-72.0,-69.0,-61.0,-89.0,-91.0,-88.0,-90.0,23.0,21.0,24.0,30.0,0
1290,CC:2F:71:3F:1F:24,4840138,3652833811,2211548,3320074201,2628590,332759610,50,587109,442906059,583217,442437105,3892,468954,560664,590,2213593,208362,50,4752,86667.0,26000.0,-72.0,-65.0,-74.0,-67.0,-71.0,-64.0,-73.0,-67.0,-89.0,-91.0,-88.0,-90.0,17.0,26.0,14.0,23.0,0
1291,F8:59:71:5A:E0:3D,2655715,374384312,27120,41624238,2628595,332760074,0,3262,407827,3173,392952,89,14875,3107,0,27134,865,0,27,130000.0,39000.0,-65.0,-63.0,-65.0,-64.0,-68.0,-74.0,-66.0,-72.0,-89.0,-91.0,-88.0,-90.0,24.0,28.0,23.0,26.0,0
1292,CC:2F:71:3E:C5:1F,2633738,333388961,5143,628887,2628595,332760074,6,22077,1850895,18199,1391373,3878,459522,5425,30,7333,133,6,448,130000.0,39000.0,-66.0,-70.0,-64.0,-60.0,-70.0,-72.0,-69.0,-61.0,-89.0,-91.0,-88.0,-90.0,23.0,21.0,24.0,30.0,0
1293,CC:2F:71:3F:1F:24,4843712,3658415859,2215115,3325655583,2628597,332760276,50,587746,442986081,583854,442517127,3892,468954,561301,590,2217202,208903,50,4753,86667.0,14444.0,-72.0,-65.0,-74.0,-67.0,-71.0,-65.0,-74.0,-67.0,-89.0,-91.0,-88.0,-90.0,17.0,26.0,14.0,23.0,0
1294,F8:59:71:5A:E0:3D,2655719,374384716,27120,41624238,2628599,332760478,0,3262,407827,3173,392952,89,14875,3107,0,27134,865,0,27,130000.0,39000.0,-65.0,-63.0,-65.0,-64.0,-68.0,-74.0,-66.0,-72.0,-89.0,-91.0,-88.0,-90.0,24.0,28.0,23.0,26.0,0
1295,CC:2F:71:3E:C5:1F,2633742,333389365,5143,628887,2628599,332760478,6,22077,1850895,18199,1391373,3878,459522,5425,30,7333,133,6,448,130000.0,39000.0,-66.0,-70.0,-64.0,-60.0,-70.0,-72.0,-69.0,-61.0,-89.0,-91.0,-88.0,-90.0,23.0,21.0,24.0,30.0,0
1296,CC:2F:71:3F:1F:24,4847367,3664131873,2218765,3331371067,2628602,332760806,50,588245,443051785,584353,442582831,3892,468954,561800,590,2220844,208903,50,4754,86667.0,14444.0,-71.0,-65.0,-74.0,-67.0,-71.0,-65.0,-74.0,-67.0,-89.0,-91.0,-88.0,-90.0,18.0,26.0,14.0,23.0,0
1297,F8:59:71:5A:E0:3D,2655731,374386078,27120,41624238,2628611,332761840,0,3262,407827,3173,392952,89,14875,3107,0,27134,865,0,27,130000.0,39000.0,-65.0,-63.0,-65.0,-64.0,-68.0,-74.0,-66.0,-72.0,-89.0,-91.0,-88.0,-90.0,24.0,28.0,23.0,26.0,0
1298,CC:2F:71:3E:C5:1F,2633754,333390727,5143,628887,2628611,332761840,6,22079,1851035,18201,1391513,3878,459522,5425,30,7334,133,6,448,130000.0,39000.0,-66.0,-63.0,-68.0,-59.0,-69.0,-70.0,-68.0,-59.0,-89.0,-91.0,-88.0,-90.0,23.0,28.0,20.0,31.0,0
1299,CC:2F:71:3F:1F:24,4850724,3669374987,2222113,3336613147,2628611,332761840,50,588787,443122543,584895,442653589,3892,468954,562342,590,2224200,209305,50,4754,86667.0,14444.0,-71.0,-65.0,-74.0,-67.0,-70.0,-65.0,-74.0,-67.0,-89.0,-91.0,-88.0,-90.0,18.0,26.0,14.0,23.0,0
1300,F8:59:71:5A:E0:3D,2655735,374386482,27120,41624238,2628615,332762244,0,3262,407827,3173,392952,89,14875,3107,0,27134,865,0,27,130000.0,39000.0,-65.0,-63.0,-65.0,-64.0,-68.0,-74.0,-66.0,-72.0,-89.0,-91.0,-88.0,-90.0,24.0,28.0,23.0,26.0,0
1301,CC:2F:71:3E:C5:1F,2633758,333391131,5143,628887,2628615,332762244,6,22079,1851035,18201,1391513,3878,459522,5425,30,7334,133,6,448,130000.0,39000.0,-66.0,-63.0,-68.0,-59.0,-69.0,-70.0,-68.0,-59.0,-89.0,-91.0,-88.0,-90.0,23.0,28.0,20.0,31.0,0
1302,CC:2F:71:3F:1F:24,4855311,3676564205,2226696,3343801961,2628615,332762244,50,589365,443197865,585473,442728911,3892,468954,562920,590,2228757,209354,50,4755,86667.0,14444.0,-71.0,-65.0,-75.0,-67.0,-70.0,-64.0,-74.0,-67.0,-89.0,-91.0,-88.0,-90.0,18.0,26.0,13.0,23.0,0
1303,F8:59:71:5A:E0:3D,2655741,374387008,27120,41624238,2628621,332762770,0,3262,407827,3173,392952,89,14875,3107,0,27134,865,0,27,130000.0,39000.0,-65.0,-63.0,-65.0,-64.0,-68.0,-74.0,-66.0,-72.0,-89.0,-91.0,-88.0,-90.0,24.0,28.0,23.0,26.0,0
1304,CC:2F:71:3E:C5:1F,2633766,333391859,5143,628887,2628623,332762972,6,22081,1851223,18202,1391583,3879,459640,5426,30,7334,133,6,448,130000.0,39000.0,-69.0,-71.0,-68.0,-60.0,-68.0,-69.0,-68.0,-59.0,-89.0,-91.0,-88.0,-90.0,20.0,20.0,20.0,30.0,0
1305,CC:2F:71:3F:1F:24,4859679,3683403541,2231056,3350640569,2628623,332762972,50,590146,443298181,586254,442829227,3892,468954,563699,590,2233130,209841,50,4757,86667.0,14444.0,-72.0,-65.0,-74.0,-67.0,-71.0,-65.0,-74.0,-67.0,-89.0,-91.0,-88.0,-90.0,17.0,26.0,14.0,23.0,0
1306,F8:59:71:5A:E0:3D,2655747,374387614,27120,41624238,2628627,332763376,0,3262,407827,3173,392952,89,14875,3107,0,27134,865,0,27,130000.0,39000.0,-65.0,-63.0,-65.0,-64.0,-68.0,-74.0,-66.0,-72.0,-89.0,-91.0,-88.0,-90.0,24.0,28.0,23.0,26.0,0
1307,CC:2F:71:3E:C5:1F,2633772,333392465,5143,628887,2628629,332763578,6,22081,1851223,18202,1391583,3879,459640,5426,30,7334,133,6,448,130000.0,39000.0,-69.0,-71.0,-68.0,-60.0,-68.0,-69.0,-68.0,-59.0,-89.0,-91.0,-88.0,-90.0,20.0,20.0,20.0,30.0,0
1308,CC:2F:71:3F:1F:24,4863253,3688992907,2234624,3356229329,2628629,332763578,50,590718,443370971,586826,442902017,3892,468954,564270,590,2236711,211000,50,4759,78000.0,13000.0,-72.0,-65.0,-74.0,-67.0,-71.0,-65.0,-74.0,-67.0,-89.0,-91.0,-88.0,-91.0,17.0,26.0,14.0,24.0,0
1309,F8:59:71:5A:E0:3D,2655754,374388280,27120,41624238,2628634,332764042,0,3262,407827,3173,392952,89,14875,3107,0,27134,865,0,27,130000.0,39000.0,-65.0,-63.0,-65.0,-64.0,-68.0,-74.0,-66.0,-72.0,-89.0,-91.0,-88.0,-91.0,24.0,28.0,23.0,27.0,0
1310,CC:2F:71:3E:C5:1F,2633777,333392929,5143,628887,2628634,332764042,6,22081,1851223,18202,1391583,3879,459640,5426,30,7334,133,6,448,130000.0,39000.0,-69.0,-71.0,-68.0,-60.0,-68.0,-69.0,-68.0,-59.0,-89.0,-91.0,-88.0,-91.0,20.0,20.0,20.0,31.0,0
1311,CC:2F:71:3F:1F:24,4867720,3695988902,2239085,3363224587,2628635,332764315,50,591339,443451693,587447,442982739,3892,468954,564889,590,2241107,211161,50,4760,78000.0,13000.0,-72.0,-65.0,-74.0,-68.0,-72.0,-65.0,-74.0,-67.0,-89.0,-91.0,-88.0,-91.0,17.0,26.0,14.0,23.0,0
1312,F8:59:71:5A:E0:3D,2655759,374388957,27120,41624238,2628639,332764719,0,3262,407827,3173,392952,89,14875,3107,0,27134,865,0,27,130000.0,39000.0,-65.0,-63.0,-65.0,-64.0,-68.0,-74.0,-66.0,-72.0,-89.0,-91.0,-88.0,-91.0,24.0,28.0,23.0,27.0,0
1313,CC:2F:71:3E:C5:1F,2633784,333393808,5143,628887,2628641,332764921,6,22081,1851223,18202,1391583,3879,459640,5426,30,7334,133,6,448,130000.0,39000.0,-69.0,-71.0,-68.0,-60.0,-68.0,-69.0,-68.0,-59.0,-89.0,-91.0,-88.0,-91.0,20.0,20.0,20.0,31.0,0
1314,CC:2F:71:3F:1F:24,4872181,3702971936,2243538,3370206813,2628643,332765123,50,592017,443536667,588125,443067713,3892,468954,565567,590,2245577,211584,50,4760,86667.0,14444.0,-72.0,-66.0,-75.0,-68.0,-72.0,-65.0,-74.0,-67.0,-89.0,-91.0,-88.0,-91.0,17.0,25.0,13.0,23.0,0
1315,F8:59:71:5A:E0:3D,2655768,374389825,27120,41624238,2628648,332765587,0,3262,407827,3173,392952,89,14875,3107,0,27134,865,0,27,130000.0,39000.0,-65.0,-63.0,-65.0,-64.0,-68.0,-74.0,-66.0,-72.0,-89.0,-91.0,-88.0,-91.0,24.0,28.0,23.0,27.0,0
1316,CC:2F:71:3E:C5:1F,2633791,333394474,5143,628887,2628648,332765587,6,22081,1851223,18202,1391583,3879,459640,5426,30,7334,133,6,448,130000.0,39000.0,-69.0,-71.0,-68.0,-60.0,-68.0,-69.0,-68.0,-59.0,-89.0,-91.0,-88.0,-90.0,20.0,20.0,20.0,30.0,0
1317,CC:2F:71:3F:1F:24,4877572,3711428188,2248924,3378662601,2628648,332765587,50,592907,443648071,589015,443179117,3892,468954,566457,590,2250941,211975,50,4761,65000.0,13000.0,-72.0,-66.0,-76.0,-68.0,-72.0,-66.0,-75.0,-68.0,-89.0,-91.0,-88.0,-90.0,17.0,25.0,12.0,22.0,0
1318,F8:59:71:5A:E0:3D,2655774,374390431,27120,41624238,2628654,332766193,0,3262,407827,3173,392952,89,14875,3107,0,27134,865,0,27,130000.0,39000.0,-65.0,-63.0,-65.0,-64.0,-68.0,-74.0,-66.0,-72.0,-89.0,-91.0,-88.0,-90.0,24.0,28.0,23.0,26.0,0
1319,CC:2F:71:3E:C5:1F,2633800,333395342,5143,628887,2628657,332766455,6,22081,1851223,18202,1391583,3879,459640,5426,30,7334,133,6,448,130000.0,39000.0,-69.0,-71.0,-68.0,-60.0,-68.0,-69.0,-68.0,-59.0,-89.0,-91.0,-88.0,-90.0,20.0,20.0,20.0,30.0,0
1320,CC:2F:71:3F:1F:24,4883405,3720576336,2254748,3387809881,2628657,332766455,50,593968,443779241,590076,443310287,3892,468954,567518,590,2256835,212144,50,4762,86667.0,14444.0,-72.0,-66.0,-75.0,-67.0,-71.0,-66.0,-74.0,-67.0,-89.0,-91.0,-88.0,-90.0,17.0,25.0,13.0,23.0,0
1321,F8:59:71:5A:E0:3D,2655781,374391097,27120,41624238,2628661,332766859,0,3262,407827,3173,392952,89,14875,3107,0,27134,865,0,27,130000.0,39000.0,-65.0,-63.0,-65.0,-64.0,-68.0,-74.0,-66.0,-72.0,-89.0,-91.0,-88.0,-90.0,24.0,28.0,23.0,26.0,0
1322,CC:2F:71:3E:C5:1F,2633804,333395746,5143,628887,2628661,332766859,6,22081,1851223,18202,1391583,3879,459640,5426,30,7334,133,6,448,130000.0,39000.0,-69.0,-71.0,-68.0,-60.0,-68.0,-69.0,-68.0,-59.0,-89.0,-91.0,-88.0,-90.0,20.0,20.0,20.0,30.0,0
1323,CC:2F:71:3F:1F:24,4886699,3725726752,2258038,3392959893,2628661,332766859,50,594382,443831397,590490,443362443,3892,468954,567932,590,2260105,212371,50,4763,130000.0,43333.0,-72.0,-65.0,-73.0,-66.0,-72.0,-64.0,-73.0,-66.0,-89.0,-91.0,-88.0,-90.0,17.0,26.0,15.0,24.0,0
1324,F8:59:71:5A:E0:3D,2655785,374391501,27120,41624238,2628665,332767263,0,3262,407827,3173,392952,89,14875,3107,0,27134,865,0,27,130000.0,39000.0,-65.0,-63.0,-65.0,-64.0,-68.0,-74.0,-66.0,-72.0,-89.0,-91.0,-88.0,-90.0,24.0,28.0,23.0,26.0,0
1325,CC:2F:71:3E:C5:1F,2633808,333396150,5143,628887,2628665,332767263,6,22081,1851223,18202,1391583,3879,459640,5426,30,7334,133,6,448,130000.0,39000.0,-69.0,-71.0,-68.0,-60.0,-68.0,-69.0,-68.0,-59.0,-89.0,-91.0,-88.0,-90.0,20.0,20.0,20.0,30.0,0
1326,CC:2F:71:3F:1F:24,4889535,3730152774,2260869,3397385451,2628666,332767323,50,594717,443875205,590825,443406251,3892,468954,568267,590,2262956,212786,50,4764,115556.0,28889.0,-72.0,-64.0,-74.0,-67.0,-72.0,-64.0,-74.0,-67.0,-89.0,-91.0,-88.0,-90.0,17.0,27.0,14.0,23.0,0
1327,F8:59:71:5A:E0:3D,2655790,374391965,27120,41624238,2628670,332767727,0,3262,407827,3173,392952,89,14875,3107,0,27134,865,0,27,130000.0,39000.0,-65.0,-63.0,-65.0,-64.0,-68.0,-74.0,-66.0,-72.0,-89.0,-91.0,-88.0,-90.0,24.0,28.0,23.0,26.0,0
1328,CC:2F:71:3E:C5:1F,2633813,333396614,5143,628887,2628670,332767727,6,22081,1851223,18202,1391583,3879,459640,5426,30,7334,133,6,448,130000.0,39000.0,-69.0,-71.0,-68.0,-60.0,-68.0,-69.0,-68.0,-59.0,-89.0,-91.0,-88.0,-90.0,20.0,20.0,20.0,30.0,0
1329,CC:2F:71:3F:1F:24,4892066,3734100752,2263396,3401333025,2628670,332767727,50,595086,443922383,591194,443453429,3892,468954,568636,590,2265443,212933,50,4766,115556.0,28889.0,-71.0,-65.0,-73.0,-67.0,-70.0,-65.0,-73.0,-67.0,-89.0,-91.0,-88.0,-90.0,18.0,26.0,15.0,23.0,0
1330,F8:59:71:5A:E0:3D,2655794,374392369,27120,41624238,2628674,332768131,0,3262,407827,3173,392952,89,14875,3107,0,27134,865,0,27,130000.0,39000.0,-65.0,-63.0,-65.0,-64.0,-68.0,-74.0,-66.0,-72.0,-89.0,-91.0,-88.0,-91.0,24.0,28.0,23.0,27.0,0
1331,CC:2F:71:3E:C5:1F,2633819,333397220,5143,628887,2628676,332768333,6,22081,1851223,18202,1391583,3879,459640,5426,30,7334,133,6,448,130000.0,39000.0,-69.0,-71.0,-68.0,-60.0,-68.0,-69.0,-68.0,-59.0,-89.0,-91.0,-88.0,-91.0,20.0,20.0,20.0,31.0,0
1332,CC:2F:71:3F:1F:24,4896468,3740992054,2267792,3408223721,2628676,332768333,50,595521,443981311,591629,443512357,3892,468954,569071,590,2269879,214422,50,4766,115556.0,28889.0,-73.0,-66.0,-75.0,-68.0,-73.0,-66.0,-74.0,-67.0,-89.0,-91.0,-88.0,-91.0,16.0,25.0,13.0,23.0,0
1333,F8:59:71:5A:E0:3D,2655800,374392949,27121,41624354,2628679,332768595,0,3264,407967,3175,393092,89,14875,3107,0,27135,865,0,27,130000.0,39000.0,-67.0,-73.0,-66.0,-71.0,-68.0,-73.0,-67.0,-71.0,-89.0,-91.0,-88.0,-91.0,22.0,18.0,22.0,20.0,0
1334,CC:2F:71:3E:C5:1F,2633826,333397862,5144,629003,2628682,332768859,6,22083,1851363,18204,1391723,3879,459640,5426,30,7335,133,6,448,130000.0,39000.0,-69.0,-72.0,-68.0,-60.0,-68.0,-69.0,-67.0,-59.0,-89.0,-91.0,-88.0,-91.0,20.0,19.0,20.0,31.0,0
1335,CC:2F:71:3F:1F:24,4900350,3747058190,2271666,3414289129,2628684,332769061,50,595995,444041047,592103,443572093,3892,468954,569545,590,2273752,216145,50,4766,104000.0,26000.0,-72.0,-66.0,-74.0,-67.0,-72.0,-66.0,-74.0,-67.0,-89.0,-91.0,-88.0,-91.0,17.0,25.0,14.0,24.0,0
1336,F8:59:71:5A:E0:3D,2655809,374393819,27121,41624354,2628688,332769465,0,3266,408155,3176,393162,90,14993,3108,0,27135,865,0,27,130000.0,39000.0,-67.0,-73.0,-65.0,-71.0,-67.0,-72.0,-66.0,-71.0,-89.0,-91.0,-88.0,-91.0,22.0,18.0,23.0,20.0,0
1337,CC:2F:71:3E:C5:1F,2633835,333398730,5144,629003,2628691,332769727,6,22083,1851363,18204,1391723,3879,459640,5426,30,7335,133,6,448,130000.0,39000.0,-69.0,-72.0,-68.0,-60.0,-68.0,-69.0,-67.0,-59.0,-89.0,-91.0,-88.0,-91.0,20.0,19.0,20.0,31.0,0
1338,CC:2F:71:3F:1F:24,4905338,3754868824,2276645,3422098895,2628693,332769929,50,596625,444120511,592733,443651557,3892,468954,570166,591,2278733,217105,50,4766,86667.0,14444.0,-73.0,-65.0,-75.0,-67.0,-72.0,-64.0,-75.0,-66.0,-89.0,-91.0,-88.0,-91.0,16.0,26.0,13.0,24.0,0
1339,F8:59:71:5A:E0:3D,2655822,374395232,27121,41624354,2628701,332770878,0,3266,408155,3176,393162,90,14993,3108,0,27135,865,0,27,130000.0,39000.0,-67.0,-73.0,-65.0,-71.0,-67.0,-72.0,-66.0,-71.0,-89.0,-91.0,-88.0,-91.0,22.0,18.0,23.0,20.0,0
1340,CC:2F:71:3E:C5:1F,2633845,333399881,5144,629003,2628701,332770878,6,22086,1851755,18205,1391793,3881,459962,5428,30,7335,133,6,448,130000.0,39000.0,-69.0,-71.0,-68.0,-60.0,-68.0,-69.0,-67.0,-59.0,-89.0,-91.0,-88.0,-91.0,20.0,20.0,20.0,31.0,0
1341,CC:2F:71:3F:1F:24,4908841,3760346411,2280140,3427575533,2628701,332770878,51,597088,444177695,593195,443708623,3893,469072,570613,592,2282138,217634,51,4767,86667.0,14444.0,-73.0,-65.0,-76.0,-67.0,-72.0,-65.0,-75.0,-67.0,-89.0,-91.0,-88.0,-91.0,16.0,26.0,12.0,24.0,0
1342,F8:59:71:5A:E0:3D,2655827,374395696,27121,41624354,2628706,332771342,0,3266,408155,3176,393162,90,14993,3108,0,27135,865,0,27,130000.0,39000.0,-67.0,-73.0,-65.0,-71.0,-67.0,-72.0,-66.0,-71.0,-89.0,-91.0,-88.0,-91.0,22.0,18.0,23.0,20.0,0
1343,CC:2F:71:3E:C5:1F,2633853,333400609,5144,629003,2628709,332771606,6,22087,1851873,18205,1391793,3882,460080,5429,30,7335,133,6,448,130000.0,39000.0,-69.0,-71.0,-68.0,-60.0,-68.0,-70.0,-67.0,-60.0,-89.0,-91.0,-88.0,-91.0,20.0,20.0,20.0,31.0,0
1344,CC:2F:71:3F:1F:24,4912488,3766045441,2283779,3433273835,2628709,332771606,51,597612,444243665,593719,443774593,3893,469072,571135,592,2285848,217698,51,4767,86667.0,14444.0,-73.0,-65.0,-76.0,-67.0,-72.0,-65.0,-75.0,-67.0,-89.0,-91.0,-88.0,-91.0,16.0,26.0,12.0,24.0,0
1345,F8:59:71:5A:E0:3D,2655834,374396364,27121,41624354,2628713,332772010,0,3266,408155,3176,393162,90,14993,3108,0,27135,865,0,27,130000.0,39000.0,-67.0,-73.0,-65.0,-71.0,-67.0,-72.0,-66.0,-71.0,-90.0,-92.0,-89.0,-91.0,23.0,19.0,24.0,20.0,0
1346,CC:2F:71:3E:C5:1F,2633859,333401215,5144,629003,2628715,332772212,6,22088,1851943,18206,1391863,3882,460080,5429,30,7335,133,6,448,130000.0,39000.0,-69.0,-71.0,-68.0,-60.0,-68.0,-70.0,-67.0,-60.0,-90.0,-92.0,-89.0,-91.0,21.0,21.0,21.0,31.0,0
1347,CC:2F:71:3F:1F:24,4917653,3774146301,2288938,3441374089,2628715,332772212,51,598636,444366055,594743,443896983,3893,469072,572157,592,2290990,218246,51,4768,86667.0,14444.0,-72.0,-65.0,-75.0,-67.0,-72.0,-65.0,-75.0,-67.0,-90.0,-92.0,-89.0,-91.0,18.0,27.0,14.0,24.0,0
1348,F8:59:71:5A:E0:3D,2655841,374397030,27121,41624354,2628720,332772676,0,3266,408155,3176,393162,90,14993,3108,0,27135,865,0,27,130000.0,39000.0,-67.0,-73.0,-65.0,-71.0,-67.0,-72.0,-66.0,-71.0,-90.0,-92.0,-89.0,-91.0,23.0,19.0,24.0,20.0,0
1349,CC:2F:71:3E:C5:1F,2633864,333401679,5144,629003,2628720,332772676,6,22088,1851943,18206,1391863,3882,460080,5429,30,7335,133,6,448,130000.0,39000.0,-69.0,-71.0,-68.0,-60.0,-68.0,-70.0,-67.0,-60.0,-90.0,-92.0,-89.0,-91.0,21.0,21.0,21.0,31.0,0
1350,CC:2F:71:3F:1F:24,4922189,3781253683,2293469,3448481007,2628720,332772676,51,599619,444486447,595726,444017375,3893,469072,573140,592,2295539,218350,51,4768,86667.0,14444.0,-72.0,-65.0,-76.0,-67.0,-72.0,-65.0,-75.0,-67.0,-90.0,-92.0,-89.0,-91.0,18.0,27.0,13.0,24.0,0
1351,F8:59:71:5A:E0:3D,2655845,374397434,27121,41624354,2628724,332773080,0,3266,408155,3176,393162,90,14993,3108,0,27135,865,0,27,130000.0,39000.0,-67.0,-73.0,-65.0,-71.0,-67.0,-72.0,-66.0,-71.0,-90.0,-92.0,-89.0,-91.0,23.0,19.0,24.0,20.0,0
1352,CC:2F:71:3E:C5:1F,2633872,333402487,5144,629003,2628728,332773484,6,22088,1851943,18206,1391863,3882,460080,5429,30,7335,133,6,448,130000.0,39000.0,-69.0,-71.0,-68.0,-60.0,-68.0,-70.0,-67.0,-60.0,-90.0,-92.0,-89.0,-91.0,21.0,21.0,21.0,31.0,0
1353,CC:2F:71:3F:1F:24,4926705,3788328043,2297977,3455554559,2628728,332773484,51,600524,444596637,596631,444127565,3893,469072,574045,592,2300032,218873,51,4768,86667.0,14444.0,-73.0,-66.0,-76.0,-68.0,-72.0,-65.0,-76.0,-68.0,-90.0,-92.0,-89.0,-91.0,17.0,26.0,13.0,23.0,0
1354,F8:59:71:5A:E0:3D,2655852,374398100,27121,41624354,2628731,332773746,0,3268,408295,3178,393302,90,14993,3108,0,27136,865,0,27,130000.0,39000.0,-67.0,-74.0,-65.0,-72.0,-66.0,-72.0,-65.0,-70.0,-90.0,-92.0,-89.0,-92.0,23.0,18.0,24.0,20.0,0
1355,CC:2F:71:3E:C5:1F,2633877,333402951,5144,629003,2628733,332773948,6,22088,1851943,18206,1391863,3882,460080,5429,30,7335,133,6,448,130000.0,39000.0,-69.0,-71.0,-68.0,-60.0,-68.0,-70.0,-67.0,-60.0,-90.0,-92.0,-89.0,-92.0,21.0,21.0,21.0,32.0,0
1356,CC:2F:71:3F:1F:24,4931576,3795966735,2302843,3463192787,2628733,332773948,51,601381,444703369,597488,444234297,3893,469072,574902,592,2304852,219017,51,4771,86667.0,14444.0,-73.0,-66.0,-76.0,-68.0,-72.0,-65.0,-76.0,-68.0,-90.0,-92.0,-89.0,-92.0,17.0,26.0,13.0,24.0,0
1357,F8:59:71:5A:E0:3D,2655858,374398706,27121,41624354,2628737,332774352,0,3268,408295,3178,393302,90,14993,3108,0,27136,865,0,27,130000.0,39000.0,-67.0,-74.0,-65.0,-72.0,-66.0,-72.0,-65.0,-70.0,-90.0,-92.0,-89.0,-92.0,23.0,18.0,24.0,20.0,0
1358,CC:2F:71:3E:C5:1F,2633881,333403355,5144,629003,2628737,332774352,6,22088,1851943,18206,1391863,3882,460080,5429,30,7335,133,6,448,130000.0,39000.0,-69.0,-71.0,-68.0,-60.0,-68.0,-70.0,-67.0,-60.0,-90.0,-92.0,-89.0,-92.0,21.0,21.0,21.0,32.0,0
1359,CC:2F:71:3F:1F:24,4935172,3801591091,2306435,3468816739,2628737,332774352,51,601914,444770189,598021,444301117,3893,469072,575435,592,2308513,219578,51,4771,86667.0,14444.0,-72.0,-65.0,-73.0,-67.0,-72.0,-65.0,-73.0,-67.0,-90.0,-92.0,-89.0,-92.0,18.0,27.0,16.0,25.0,0
1360,F8:59:71:5A:E0:3D,2655865,374399372,27121,41624354,2628744,332775018,0,3268,408295,3178,393302,90,14993,3108,0,27136,865,0,27,130000.0,39000.0,-67.0,-74.0,-65.0,-72.0,-66.0,-72.0,-65.0,-70.0,-90.0,-92.0,-89.0,-92.0,23.0,18.0,24.0,20.0,0
1361,CC:2F:71:3E:C5:1F,2633890,333404223,5144,629003,2628746,332775220,6,22088,1851943,18206,1391863,3882,460080,5429,30,7335,133,6,448,130000.0,39000.0,-69.0,-71.0,-68.0,-60.0,-68.0,-70.0,-67.0,-60.0,-90.0,-92.0,-89.0,-92.0,21.0,21.0,21.0,32.0,0
1362,CC:2F:71:3F:1F:24,4938648,3807020285,2309902,3474245065,2628746,332775220,51,602412,444832909,598519,444363837,3893,469072,575933,592,2311982,219658,51,4771,65000.0,14444.0,-71.0,-65.0,-75.0,-68.0,-71.0,-65.0,-75.0,-68.0,-90.0,-92.0,-89.0,-92.0,19.0,27.0,14.0,24.0,0
1363,F8:59:71:5A:E0:3D,2655867,374399574,27121,41624354,2628746,332775220,0,3268,408295,3178,393302,90,14993,3108,0,27136,865,0,27,130000.0,39000.0,-67.0,-74.0,-65.0,-72.0,-66.0,-72.0,-65.0,-70.0,-90.0,-92.0,-89.0,-91.0,23.0,18.0,24.0,19.0,0
1364,CC:2F:71:3E:C5:1F,2633890,333404223,5144,629003,2628746,332775220,6,22088,1851943,18206,1391863,3882,460080,5429,30,7335,133,6,448,130000.0,39000.0,-69.0,-71.0,-68.0,-60.0,-68.0,-70.0,-67.0,-60.0,-90.0,-92.0,-89.0,-91.0,21.0,21.0,21.0,31.0,0
1365,CC:2F:71:3F:1F:24,4942402,3812901833,2313656,3480126613,2628746,332775220,51,603040,444910177,599147,444441105,3893,469072,576561,592,2315691,219862,51,4771,115556.0,28889.0,-72.0,-65.0,-74.0,-67.0,-72.0,-65.0,-73.0,-67.0,-90.0,-92.0,-89.0,-91.0,18.0,27.0,15.0,24.0,0
1366,F8:59:71:5A:E0:3D,2655873,374400180,27121,41624354,2628752,332775826,0,3268,408295,3178,393302,90,14993,3108,0,27136,865,0,27,130000.0,39000.0,-67.0,-74.0,-65.0,-72.0,-66.0,-72.0,-65.0,-70.0,-90.0,-92.0,-89.0,-91.0,23.0,18.0,24.0,19.0,0
1367,CC:2F:71:3E:C5:1F,2633899,333405091,5144,629003,2628755,332776088,6,22088,1851943,18206,1391863,3882,460080,5429,30,7335,133,6,448,130000.0,39000.0,-69.0,-71.0,-68.0,-60.0,-68.0,-70.0,-67.0,-60.0,-90.0,-92.0,-89.0,-91.0,21.0,21.0,21.0,31.0,0
1368,CC:2F:71:3F:1F:24,4946992,3820088143,2318237,3487312055,2628755,332776088,51,603667,444986897,599774,444517825,3893,469072,577188,592,2320313,220089,51,4771,115556.0,28889.0,-72.0,-65.0,-75.0,-67.0,-72.0,-65.0,-74.0,-67.0,-90.0,-92.0,-89.0,-91.0,18.0,27.0,14.0,24.0,0
1369,F8:59:71:5A:E0:3D,2655877,374400715,27121,41624354,2628756,332776361,0,3268,408295,3178,393302,90,14993,3108,0,27136,865,0,27,130000.0,39000.0,-67.0,-74.0,-65.0,-72.0,-66.0,-72.0,-65.0,-70.0,-90.0,-92.0,-89.0,-91.0,23.0,18.0,24.0,19.0,0
1370,CC:2F:71:3E:C5:1F,2633900,333405364,5144,629003,2628756,332776361,6,22088,1851943,18206,1391863,3882,460080,5429,30,7335,133,6,448,130000.0,39000.0,-69.0,-71.0,-68.0,-60.0,-68.0,-70.0,-67.0,-60.0,-90.0,-92.0,-89.0,-91.0,21.0,21.0,21.0,31.0,0
1371,CC:2F:71:3F:1F:24,4952217,3828288686,2323459,3495512123,2628758,332776563,51,604289,445065037,600396,444595965,3893,469072,577810,592,2325468,220370,51,4771,115556.0,28889.0,-72.0,-65.0,-75.0,-68.0,-72.0,-65.0,-75.0,-68.0,-90.0,-92.0,-89.0,-91.0,18.0,27.0,14.0,23.0,0
1372,F8:59:71:5A:E0:3D,2655885,374401523,27121,41624354,2628764,332777169,0,3268,408295,3178,393302,90,14993,3108,0,27136,865,0,27,130000.0,39000.0,-67.0,-74.0,-65.0,-72.0,-66.0,-72.0,-65.0,-70.0,-90.0,-92.0,-89.0,-91.0,23.0,18.0,24.0,19.0,0
1373,CC:2F:71:3E:C5:1F,2633908,333406172,5144,629003,2628764,332777169,6,22088,1851943,18206,1391863,3882,460080,5429,30,7335,133,6,448,130000.0,39000.0,-69.0,-71.0,-68.0,-60.0,-68.0,-70.0,-67.0,-60.0,-90.0,-92.0,-89.0,-91.0,21.0,21.0,21.0,31.0,0
1374,CC:2F:71:3F:1F:24,4956669,3835256256,2327905,3502479087,2628764,332777169,51,604859,445138307,600966,444669235,3893,469072,578342,592,2329995,220687,51,4771,115556.0,28889.0,-73.0,-66.0,-75.0,-68.0,-72.0,-65.0,-75.0,-68.0,-90.0,-92.0,-89.0,-91.0,17.0,26.0,14.0,23.0,0
1375,F8:59:71:5A:E0:3D,2655888,374401785,27121,41624354,2628767,332777431,0,3268,408295,3178,393302,90,14993,3108,0,27136,865,0,27,130000.0,39000.0,-67.0,-74.0,-65.0,-72.0,-66.0,-72.0,-65.0,-70.0,-90.0,-92.0,-89.0,-91.0,23.0,18.0,24.0,19.0,0
1376,CC:2F:71:3E:C5:1F,2633913,333406636,5144,629003,2628769,332777633,6,22088,1851943,18206,1391863,3882,460080,5429,30,7335,133,6,448,130000.0,39000.0,-69.0,-71.0,-68.0,-60.0,-68.0,-70.0,-67.0,-60.0,-90.0,-92.0,-89.0,-91.0,21.0,21.0,21.0,31.0,0
1377,CC:2F:71:3F:1F:24,4961767,3843247880,2332996,3510470045,2628771,332777835,51,605479,445215969,601586,444746897,3893,469072,578961,592,2335068,221324,51,4771,115556.0,28889.0,-73.0,-66.0,-76.0,-68.0,-72.0,-65.0,-75.0,-68.0,-90.0,-92.0,-89.0,-91.0,17.0,26.0,13.0,23.0,0
1378,F8:59:71:5A:E0:3D,2655894,374402391,27121,41624354,2628773,332778037,0,3268,408295,3178,393302,90,14993,3108,0,27136,865,0,27,130000.0,39000.0,-67.0,-74.0,-65.0,-72.0,-66.0,-72.0,-65.0,-70.0,-90.0,-92.0,-89.0,-91.0,23.0,18.0,24.0,19.0,0
1379,CC:2F:71:3E:C5:1F,2633917,333407040,5144,629003,2628773,332778037,6,22088,1851943,18206,1391863,3882,460080,5429,30,7335,133,6,448,130000.0,39000.0,-69.0,-71.0,-68.0,-60.0,-68.0,-70.0,-67.0,-60.0,-90.0,-92.0,-89.0,-91.0,21.0,21.0,21.0,31.0,0
1380,CC:2F:71:3F:1F:24,4967330,3851970604,2338554,3519192305,2628776,332778299,51,606320,445321299,602427,444852227,3893,469072,579802,592,2340644,222738,51,4773,86667.0,14444.0,-73.0,-65.0,-75.0,-68.0,-72.0,-65.0,-75.0,-68.0,-90.0,-92.0,-89.0,-91.0,17.0,27.0,14.0,23.0,0
1381,F8:59:71:5A:E0:3D,2655903,374403259,27121,41624354,2628782,332778905,0,3268,408295,3178,393302,90,14993,3108,0,27136,865,0,27,130000.0,39000.0,-67.0,-74.0,-65.0,-72.0,-66.0,-72.0,-65.0,-70.0,-90.0,-92.0,-89.0,-91.0,23.0,18.0,24.0,19.0,0
1382,CC:2F:71:3E:C5:1F,2633926,333407908,5144,629003,2628782,332778905,6,22088,1851943,18206,1391863,3882,460080,5429,30,7335,133,6,448,130000.0,39000.0,-69.0,-71.0,-68.0,-60.0,-68.0,-70.0,-67.0,-60.0,-90.0,-92.0,-89.0,-91.0,21.0,21.0,21.0,31.0,0
1383,CC:2F:71:3F:1F:24,4970994,3857697886,2342212,3524918981,2628782,332778905,51,606842,445387837,602949,444918765,3893,469072,580320,592,2344289,222889,51,4773,86667.0,14444.0,-71.0,-65.0,-73.0,-68.0,-71.0,-65.0,-73.0,-67.0,-90.0,-92.0,-89.0,-91.0,19.0,27.0,16.0,23.0,0
1384,F8:59:71:5A:E0:3D,2655905,374403461,27121,41624354,2628784,332779107,0,3268,408295,3178,393302,90,14993,3108,0,27136,865,0,27,130000.0,39000.0,-67.0,-74.0,-65.0,-72.0,-66.0,-72.0,-65.0,-70.0,-90.0,-93.0,-89.0,-92.0,23.0,19.0,24.0,20.0,0
1385,CC:2F:71:3E:C5:1F,2633937,333409144,5144,629003,2628793,332780141,6,22088,1851943,18206,1391863,3882,460080,5429,30,7335,133,6,448,130000.0,39000.0,-69.0,-71.0,-68.0,-60.0,-68.0,-70.0,-67.0,-60.0,-90.0,-93.0,-89.0,-92.0,21.0,22.0,21.0,32.0,0
1386,CC:2F:71:3F:1F:24,4976585,3866460706,2347792,3533680565,2628793,332780141,51,607564,445478239,603671,445009167,3893,469072,581041,592,2349872,223423,51,4774,86667.0,14444.0,-72.0,-65.0,-74.0,-67.0,-71.0,-65.0,-74.0,-67.0,-90.0,-93.0,-89.0,-92.0,18.0,28.0,15.0,25.0,0
1387,F8:59:71:5A:E0:3D,2655914,374404495,27121,41624354,2628793,332780141,0,3268,408295,3178,393302,90,14993,3108,0,27136,865,0,27,130000.0,39000.0,-67.0,-74.0,-65.0,-72.0,-66.0,-72.0,-65.0,-70.0,-90.0,-93.0,-89.0,-92.0,23.0,19.0,24.0,20.0,0
1388,CC:2F:71:3E:C5:1F,2633937,333409144,5144,629003,2628793,332780141,6,22088,1851943,18206,1391863,3882,460080,5429,30,7335,133,6,448,130000.0,39000.0,-69.0,-71.0,-68.0,-60.0,-68.0,-70.0,-67.0,-60.0,-90.0,-93.0,-89.0,-92.0,21.0,22.0,21.0,32.0,0
1389,CC:2F:71:3F:1F:24,4980429,3872486554,2351636,3539706413,2628793,332780141,51,608195,445556411,604302,445087339,3893,469072,581670,592,2353714,223535,51,4774,86667.0,14444.0,-72.0,-65.0,-73.0,-68.0,-71.0,-65.0,-73.0,-68.0,-90.0,-93.0,-89.0,-92.0,18.0,28.0,16.0,24.0,0
1390,F8:59:71:5A:E0:3D,2655922,374405303,27121,41624354,2628801,332780949,0,3268,408295,3178,393302,90,14993,3108,0,27136,865,0,27,130000.0,39000.0,-67.0,-74.0,-65.0,-72.0,-66.0,-72.0,-65.0,-70.0,-90.0,-93.0,-89.0,-92.0,23.0,19.0,24.0,20.0,0
1391,CC:2F:71:3E:C5:1F,2633946,333410012,5144,629003,2628802,332781009,6,22088,1851943,18206,1391863,3882,460080,5429,30,7335,133,6,448,130000.0,39000.0,-69.0,-71.0,-68.0,-60.0,-68.0,-70.0,-67.0,-60.0,-90.0,-93.0,-89.0,-92.0,21.0,22.0,21.0,32.0,0
1392,CC:2F:71:3F:1F:24,4983173,3876763542,2354371,3543982533,2628802,332781009,51,608712,445620097,604819,445151025,3893,469072,582187,592,2356438,223694,51,4774,115556.0,28889.0,-71.0,-64.0,-75.0,-68.0,-71.0,-64.0,-74.0,-67.0,-90.0,-93.0,-89.0,-92.0,19.0,29.0,14.0,24.0,0
1393,F8:59:71:5A:E0:3D,2655924,374405479,27122,41624470,2628802,332781009,0,3270,408435,3180,393442,90,14993,3108,0,27137,865,0,27,130000.0,39000.0,-68.0,-70.0,-72.0,-66.0,-67.0,-73.0,-66.0,-70.0,-90.0,-93.0,-89.0,-92.0,22.0,23.0,17.0,26.0,0
1394,CC:2F:71:3E:C5:1F,2633949,333410330,5145,629119,2628804,332781211,6,22090,1852083,18208,1392003,3882,460080,5429,30,7336,133,6,448,130000.0,39000.0,-69.0,-71.0,-68.0,-60.0,-69.0,-70.0,-68.0,-60.0,-90.0,-93.0,-89.0,-92.0,21.0,22.0,21.0,32.0,0
1395,CC:2F:71:3F:1F:24,4987337,3883276298,2358526,3550494419,2628811,332781879,51,609441,445711937,605548,445242865,3893,469072,582916,592,2360529,224229,51,4775,86667.0,14444.0,-71.0,-65.0,-73.0,-68.0,-71.0,-64.0,-73.0,-67.0,-90.0,-93.0,-89.0,-92.0,19.0,28.0,16.0,24.0,0
1396,F8:59:71:5A:E0:3D,2655933,374406349,27122,41624470,2628811,332781879,0,3272,408623,3181,393512,91,15111,3109,0,27137,865,0,27,130000.0,39000.0,-68.0,-74.0,-66.0,-73.0,-67.0,-73.0,-66.0,-71.0,-90.0,-93.0,-89.0,-92.0,22.0,19.0,23.0,19.0,0
1397,CC:2F:71:3E:C5:1F,2633957,333411058,5145,629119,2628812,332781939,6,22090,1852083,18208,1392003,3882,460080,5429,30,7336,133,6,448,130000.0,39000.0,-69.0,-71.0,-68.0,-60.0,-69.0,-70.0,-68.0,-60.0,-90.0,-93.0,-89.0,-92.0,21.0,22.0,21.0,32.0,0
1398,CC:2F:71:3F:1F:24,4991689,3890093843,2362877,3557311904,2628812,332781939,51,610236,445810436,606343,445341364,3893,469072,583711,592,2364967,224666,51,4777,86667.0,14444.0,-72.0,-66.0,-74.0,-69.0,-72.0,-66.0,-74.0,-69.0,-90.0,-93.0,-89.0,-92.0,18.0,27.0,15.0,23.0,0
1399,F8:59:71:5A:E0:3D,2655943,374407490,27122,41624470,2628821,332783020,0,3272,408623,3181,393512,91,15111,3109,0,27137,865,0,27,130000.0,39000.0,-68.0,-74.0,-66.0,-73.0,-67.0,-73.0,-66.0,-71.0,-90.0,-93.0,-89.0,-92.0,22.0,19.0,23.0,19.0,0
1400,CC:2F:71:3E:C5:1F,2633966,333412139,5145,629119,2628821,332783020,6,22090,1852083,18208,1392003,3882,460080,5429,30,7336,133,6,448,130000.0,39000.0,-69.0,-71.0,-68.0,-60.0,-69.0,-70.0,-68.0,-60.0,-90.0,-93.0,-89.0,-92.0,21.0,22.0,21.0,32.0,0
1401,CC:2F:71:3F:1F:24,4995695,3896361862,2366874,3563578842,2628821,332783020,51,610777,445879076,606884,445410004,3893,469072,584251,592,2368953,224769,51,4780,65000.0,14444.0,-73.0,-66.0,-75.0,-69.0,-72.0,-65.0,-74.0,-68.0,-90.0,-93.0,-89.0,-92.0,17.0,27.0,14.0,23.0,0
1402,F8:59:71:5A:E0:3D,2655943,374407490,27122,41624470,2628821,332783020,0,3272,408623,3181,393512,91,15111,3109,0,27137,865,0,27,130000.0,39000.0,-68.0,-74.0,-66.0,-73.0,-67.0,-73.0,-66.0,-71.0,-90.0,-93.0,-89.0,-92.0,22.0,19.0,23.0,19.0,0
1403,CC:2F:71:3E:C5:1F,2633966,333412139,5145,629119,2628821,332783020,6,22090,1852083,18208,1392003,3882,460080,5429,30,7336,133,6,448,130000.0,39000.0,-69.0,-71.0,-68.0,-60.0,-69.0,-70.0,-68.0,-60.0,-90.0,-93.0,-89.0,-92.0,21.0,22.0,21.0,32.0,0
1404,CC:2F:71:3F:1F:24,4999536,3902374382,2370710,3569590898,2628826,332783484,51,611296,445944260,607403,445475188,3893,469072,584770,592,2372800,225240,51,4780,78000.0,13000.0,-73.0,-65.0,-75.0,-68.0,-72.0,-65.0,-74.0,-67.0,-90.0,-93.0,-89.0,-92.0,17.0,28.0,14.0,24.0,0
1405,F8:59:71:5A:E0:3D,2655953,374408420,27122,41624470,2628831,332783950,0,3272,408623,3181,393512,91,15111,3109,0,27137,865,0,27,130000.0,39000.0,-68.0,-74.0,-66.0,-73.0,-67.0,-73.0,-66.0,-71.0,-90.0,-93.0,-89.0,-92.0,22.0,19.0,23.0,19.0,0
1406,CC:2F:71:3E:C5:1F,2633976,333413069,5145,629119,2628831,332783950,6,22090,1852083,18208,1392003,3882,460080,5429,30,7336,133,6,448,130000.0,39000.0,-69.0,-71.0,-68.0,-60.0,-69.0,-70.0,-68.0,-60.0,-90.0,-93.0,-89.0,-92.0,21.0,22.0,21.0,32.0,0
1407,CC:2F:71:3F:1F:24,5003460,3908514869,2374629,3575730919,2628831,332783950,51,612165,446049413,608271,445580223,3894,469190,585639,592,2376719,225336,51,4780,86667.0,14444.0,-72.0,-65.0,-74.0,-68.0,-71.0,-65.0,-74.0,-68.0,-90.0,-93.0,-89.0,-92.0,18.0,28.0,15.0,24.0,0
1408,F8:59:71:5A:E0:3D,2655961,374409228,27122,41624470,2628839,332784758,0,3272,408623,3181,393512,91,15111,3109,0,27137,865,0,27,130000.0,39000.0,-68.0,-74.0,-66.0,-73.0,-67.0,-73.0,-66.0,-71.0,-90.0,-93.0,-89.0,-93.0,22.0,19.0,23.0,20.0,0
1409,CC:2F:71:3E:C5:1F,2633984,333413877,5145,629119,2628839,332784758,6,22090,1852083,18208,1392003,3882,460080,5429,30,7336,133,6,448,130000.0,39000.0,-69.0,-71.0,-68.0,-60.0,-69.0,-70.0,-68.0,-60.0,-90.0,-93.0,-89.0,-93.0,21.0,22.0,21.0,33.0,0
1410,CC:2F:71:3F:1F:24,5007540,3914897947,2378699,3582113067,2628841,332784880,51,612850,446133013,608956,445663823,3894,469190,586324,592,2380702,225525,51,4780,86667.0,14444.0,-73.0,-65.0,-75.0,-68.0,-72.0,-65.0,-75.0,-68.0,-90.0,-93.0,-89.0,-93.0,17.0,28.0,14.0,25.0,0
1411,F8:59:71:5A:E0:3D,2655963,374409350,27122,41624470,2628841,332784880,0,3272,408623,3181,393512,91,15111,3109,0,27137,865,0,27,130000.0,39000.0,-68.0,-74.0,-66.0,-73.0,-67.0,-73.0,-66.0,-71.0,-90.0,-93.0,-89.0,-93.0,22.0,19.0,23.0,20.0,0
1412,CC:2F:71:3E:C5:1F,2633986,333413999,5145,629119,2628841,332784880,6,22092,1852271,18209,1392073,3883,460198,5430,30,7336,133,6,448,130000.0,39000.0,-69.0,-71.0,-68.0,-60.0,-69.0,-70.0,-68.0,-60.0,-90.0,-93.0,-89.0,-93.0,21.0,22.0,21.0,33.0,0
1413,CC:2F:71:3F:1F:24,5011314,3920809055,2382473,3588024175,2628841,332784880,51,613467,446208797,609573,445739607,3894,469190,586941,592,2384537,225759,51,4780,65000.0,14444.0,-72.0,-65.0,-74.0,-68.0,-73.0,-66.0,-75.0,-69.0,-90.0,-93.0,-89.0,-93.0,18.0,28.0,15.0,25.0,0
1414,F8:59:71:5A:E0:3D,2655993,374421006,27122,41624470,2628871,332796536,0,3272,408623,3181,393512,91,15111,3109,0,27137,865,0,27,130000.0,39000.0,-68.0,-74.0,-66.0,-73.0,-67.0,-73.0,-66.0,-71.0,-90.0,-93.0,-89.0,-93.0,22.0,19.0,23.0,20.0,0
1415,CC:2F:71:3E:C5:1F,2634016,333425655,5145,629119,2628871,332796536,6,22092,1852271,18209,1392073,3883,460198,5430,30,7336,133,6,448,130000.0,39000.0,-69.0,-71.0,-68.0,-60.0,-69.0,-70.0,-68.0,-60.0,-90.0,-93.0,-89.0,-93.0,21.0,22.0,21.0,33.0,0
1416,CC:2F:71:3F:1F:24,5015428,3927222273,2386556,3594425677,2628872,332796596,51,614049,446282735,610155,445813545,3894,469190,587523,592,2388646,226055,51,4780,86667.0,14444.0,-71.0,-66.0,-74.0,-68.0,-71.0,-65.0,-73.0,-68.0,-90.0,-93.0,-89.0,-93.0,19.0,27.0,15.0,25.0,0
1417,F8:59:71:5A:E0:3D,2656002,374421874,27122,41624470,2628880,332797404,0,3274,408763,3183,393652,91,15111,3109,0,27138,865,0,27,130000.0,39000.0,-67.0,-73.0,-65.0,-73.0,-67.0,-73.0,-66.0,-71.0,-90.0,-93.0,-89.0,-93.0,23.0,20.0,24.0,20.0,0
1418,CC:2F:71:3E:C5:1F,2634025,333426523,5145,629119,2628880,332797404,6,22092,1852271,18209,1392073,3883,460198,5430,30,7336,133,6,448,130000.0,39000.0,-69.0,-71.0,-68.0,-60.0,-69.0,-70.0,-68.0,-60.0,-90.0,-93.0,-89.0,-93.0,21.0,22.0,21.0,33.0,0
1419,CC:2F:71:3F:1F:24,5020643,3935396399,2391763,3602598995,2628880,332797404,51,615088,446407701,611194,445938511,3894,469190,588562,592,2393822,226167,51,4780,65000.0,13000.0,-74.0,-66.0,-76.0,-68.0,-74.0,-66.0,-75.0,-67.0,-90.0,-93.0,-89.0,-93.0,16.0,27.0,13.0,25.0,0
1420,F8:59:71:5A:E0:3D,2656003,374421934,27122,41624470,2628881,332797464,0,3274,408763,3183,393652,91,15111,3109,0,27138,865,0,27,130000.0,39000.0,-67.0,-73.0,-65.0,-73.0,-67.0,-73.0,-66.0,-71.0,-90.0,-93.0,-89.0,-93.0,23.0,20.0,24.0,20.0,0
1421,CC:2F:71:3E:C5:1F,2634028,333426785,5145,629119,2628883,332797666,6,22092,1852271,18209,1392073,3883,460198,5430,30,7336,133,6,448,130000.0,39000.0,-69.0,-71.0,-68.0,-60.0,-69.0,-70.0,-68.0,-60.0,-90.0,-93.0,-89.0,-93.0,21.0,22.0,21.0,33.0,0
1422,CC:2F:71:3F:1F:24,5024749,3941825473,2395864,3609027605,2628885,332797868,51,615677,446481413,611783,446012223,3894,469190,589151,592,2397942,226276,51,4780,144444.0,39000.0,-74.0,-65.0,-76.0,-68.0,-73.0,-65.0,-75.0,-68.0,-90.0,-93.0,-89.0,-93.0,16.0,28.0,13.0,25.0,0
1423,F8:59:71:5A:E0:3D,2656011,374422742,27122,41624470,2628889,332798272,0,3274,408763,3183,393652,91,15111,3109,0,27138,865,0,27,130000.0,39000.0,-67.0,-73.0,-65.0,-73.0,-67.0,-73.0,-66.0,-71.0,-90.0,-93.0,-89.0,-93.0,23.0,20.0,24.0,20.0,0
1424,CC:2F:71:3E:C5:1F,2634034,333427391,5145,629119,2628889,332798272,6,22092,1852271,18209,1392073,3883,460198,5430,30,7336,133,6,448,130000.0,39000.0,-69.0,-71.0,-68.0,-60.0,-69.0,-70.0,-68.0,-60.0,-90.0,-93.0,-89.0,-93.0,21.0,22.0,21.0,33.0,0
1425,CC:2F:71:3F:1F:24,5029092,3948633899,2400203,3615835627,2628889,332798272,51,616263,446553683,612369,446084493,3894,469190,589731,592,2402279,226570,51,4781,130000.0,43333.0,-73.0,-65.0,-73.0,-68.0,-72.0,-65.0,-73.0,-68.0,-90.0,-93.0,-89.0,-93.0,17.0,28.0,16.0,25.0,0
1426,F8:59:71:5A:E0:3D,2656013,374422944,27122,41624470,2628891,332798474,0,3274,408763,3183,393652,91,15111,3109,0,27138,865,0,27,130000.0,39000.0,-67.0,-73.0,-65.0,-73.0,-67.0,-73.0,-66.0,-71.0,-90.0,-93.0,-89.0,-93.0,23.0,20.0,24.0,20.0,0
1427,CC:2F:71:3E:C5:1F,2634038,333427795,5145,629119,2628893,332798676,6,22092,1852271,18209,1392073,3883,460198,5430,30,7336,133,6,448,130000.0,39000.0,-69.0,-71.0,-68.0,-60.0,-69.0,-70.0,-68.0,-60.0,-90.0,-93.0,-89.0,-93.0,21.0,22.0,21.0,33.0,0
1428,CC:2F:71:3F:1F:24,5033274,3955186147,2404381,3622387471,2628893,332798676,51,616875,446629373,612981,446160183,3894,469190,590340,592,2406447,227917,51,4781,130000.0,39000.0,-70.0,-65.0,-73.0,-67.0,-70.0,-65.0,-73.0,-67.0,-90.0,-93.0,-89.0,-93.0,20.0,28.0,16.0,26.0,0
1429,F8:59:71:5A:E0:3D,2656020,374423610,27122,41624470,2628898,332799140,0,3274,408763,3183,393652,91,15111,3109,0,27138,865,0,27,130000.0,39000.0,-67.0,-73.0,-65.0,-73.0,-67.0,-73.0,-66.0,-71.0,-90.0,-93.0,-89.0,-93.0,23.0,20.0,24.0,20.0,0
1430,CC:2F:71:3E:C5:1F,2634043,333428259,5145,629119,2628898,332799140,6,22092,1852271,18209,1392073,3883,460198,5430,30,7336,133,6,448,130000.0,39000.0,-69.0,-71.0,-68.0,-60.0,-69.0,-70.0,-68.0,-60.0,-90.0,-93.0,-89.0,-93.0,21.0,22.0,21.0,33.0,0
1431,CC:2F:71:3F:1F:24,5037188,3961314477,2408290,3628515337,2628898,332799140,51,617413,446696503,613519,446227313,3894,469190,590871,592,2410368,228192,51,4781,130000.0,43333.0,-71.0,-65.0,-74.0,-68.0,-70.0,-65.0,-73.0,-67.0,-90.0,-93.0,-89.0,-93.0,19.0,28.0,15.0,25.0,0
1432,F8:59:71:5A:E0:3D,2656023,374424085,27122,41624470,2628901,332799615,0,3274,408763,3183,393652,91,15111,3109,0,27138,865,0,27,130000.0,39000.0,-67.0,-73.0,-65.0,-73.0,-67.0,-73.0,-66.0,-71.0,-90.0,-93.0,-89.0,-93.0,23.0,20.0,24.0,20.0,0
1433,CC:2F:71:3E:C5:1F,2634048,333428936,5145,629119,2628903,332799817,6,22092,1852271,18209,1392073,3883,460198,5430,30,7336,133,6,448,130000.0,39000.0,-69.0,-71.0,-68.0,-60.0,-69.0,-70.0,-68.0,-60.0,-90.0,-93.0,-89.0,-93.0,21.0,22.0,21.0,33.0,0
1434,CC:2F:71:3F:1F:24,5040964,3967224312,2412061,3634424495,2628903,332799817,51,617939,446761319,614045,446292129,3894,469190,591397,592,2414151,228335,51,4781,130000.0,43333.0,-71.0,-65.0,-74.0,-67.0,-70.0,-64.0,-73.0,-67.0,-90.0,-93.0,-89.0,-93.0,19.0,28.0,15.0,26.0,0
1435,F8:59:71:5A:E0:3D,2656029,374424691,27122,41624470,2628907,332800221,0,3274,408763,3183,393652,91,15111,3109,0,27138,865,0,27,130000.0,39000.0,-67.0,-73.0,-65.0,-73.0,-67.0,-73.0,-66.0,-71.0,-90.0,-93.0,-89.0,-93.0,23.0,20.0,24.0,20.0,0
1436,CC:2F:71:3E:C5:1F,2634053,333429400,5145,629119,2628908,332800281,6,22092,1852271,18209,1392073,3883,460198,5430,30,7336,133,6,448,130000.0,39000.0,-69.0,-71.0,-68.0,-60.0,-69.0,-70.0,-68.0,-60.0,-90.0,-93.0,-89.0,-93.0,21.0,22.0,21.0,33.0,0
1437,CC:2F:71:3F:1F:24,5042410,3969458546,2413502,3636658265,2628908,332800281,51,618134,446785337,614240,446316147,3894,469190,591583,592,2415585,228403,51,4781,130000.0,43333.0,-71.0,-65.0,-74.0,-67.0,-70.0,-64.0,-73.0,-67.0,-90.0,-93.0,-89.0,-93.0,19.0,28.0,15.0,26.0,0
1438,F8:59:71:5A:E0:3D,2656032,374424953,27122,41624470,2628910,332800483,0,3274,408763,3183,393652,91,15111,3109,0,27138,865,0,27,130000.0,39000.0,-67.0,-73.0,-65.0,-73.0,-67.0,-73.0,-66.0,-71.0,-90.0,-93.0,-89.0,-93.0,23.0,20.0,24.0,20.0,0
1439,CC:2F:71:3E:C5:1F,2634057,333429804,5145,629119,2628912,332800685,6,22092,1852271,18209,1392073,3883,460198,5430,30,7336,133,6,448,130000.0,39000.0,-69.0,-71.0,-68.0,-60.0,-69.0,-70.0,-68.0,-60.0,-90.0,-93.0,-89.0,-93.0,21.0,22.0,21.0,33.0,0
1440,CC:2F:71:3F:1F:24,5044801,3973186956,2415889,3640386271,2628912,332800685,51,618491,446828677,614597,446359487,3894,469190,591928,592,2417959,228563,51,4781,130000.0,43333.0,-70.0,-65.0,-74.0,-68.0,-70.0,-64.0,-73.0,-67.0,-90.0,-93.0,-89.0,-93.0,20.0,28.0,15.0,25.0,0
1441,F8:59:71:5A:E0:3D,2656038,374425559,27122,41624470,2628916,332801089,0,3274,408763,3183,393652,91,15111,3109,0,27138,865,0,27,130000.0,39000.0,-67.0,-73.0,-65.0,-73.0,-67.0,-73.0,-66.0,-71.0,-90.0,-93.0,-89.0,-93.0,23.0,20.0,24.0,20.0,0
1442,CC:2F:71:3E:C5:1F,2634061,333430208,5145,629119,2628916,332801089,6,22092,1852271,18209,1392073,3883,460198,5430,30,7336,133,6,448,130000.0,39000.0,-69.0,-71.0,-68.0,-60.0,-69.0,-70.0,-68.0,-60.0,-90.0,-93.0,-89.0,-93.0,21.0,22.0,21.0,33.0,0
1443,CC:2F:71:3F:1F:24,5048502,3978979746,2419586,3646178657,2628916,332801089,51,618836,446871935,614942,446402745,3894,469190,592264,592,2421657,228605,51,4781,130000.0,43333.0,-70.0,-65.0,-74.0,-67.0,-70.0,-64.0,-73.0,-67.0,-90.0,-93.0,-89.0,-93.0,20.0,28.0,15.0,26.0,0
1444,F8:59:71:5A:E0:3D,2656041,374425821,27122,41624470,2628919,332801351,0,3274,408763,3183,393652,91,15111,3109,0,27138,865,0,27,130000.0,39000.0,-67.0,-73.0,-65.0,-73.0,-67.0,-73.0,-66.0,-71.0,-90.0,-93.0,-89.0,-93.0,23.0,20.0,24.0,20.0,0
1445,CC:2F:71:3E:C5:1F,2634064,333430470,5145,629119,2628919,332801351,6,22092,1852271,18209,1392073,3883,460198,5430,30,7336,133,6,448,130000.0,39000.0,-69.0,-71.0,-68.0,-60.0,-69.0,-70.0,-68.0,-60.0,-90.0,-93.0,-89.0,-93.0,21.0,22.0,21.0,33.0,0
1446,CC:2F:71:3F:1F:24,5052410,3985098888,2423489,3652297335,2628921,332801553,51,619288,446929285,615394,446460095,3894,469190,592715,592,2425579,228686,51,4781,130000.0,43333.0,-71.0,-65.0,-74.0,-67.0,-70.0,-65.0,-73.0,-67.0,-90.0,-93.0,-89.0,-93.0,19.0,28.0,15.0,26.0,0
1447,F8:59:71:5A:E0:3D,2656047,374426427,27122,41624470,2628925,332801957,0,3274,408763,3183,393652,91,15111,3109,0,27138,865,0,27,130000.0,39000.0,-67.0,-73.0,-65.0,-73.0,-67.0,-73.0,-66.0,-71.0,-90.0,-93.0,-90.0,-93.0,23.0,20.0,25.0,20.0,0
1448,CC:2F:71:3E:C5:1F,2634070,333431076,5145,629119,2628925,332801957,6,22092,1852271,18209,1392073,3883,460198,5430,30,7336,133,6,448,130000.0,39000.0,-69.0,-71.0,-68.0,-60.0,-69.0,-70.0,-68.0,-60.0,-90.0,-93.0,-90.0,-93.0,21.0,22.0,22.0,33.0,0
1449,CC:2F:71:3F:1F:24,5054220,3987910576,2425295,3655108619,2628925,332801957,51,619563,446962887,615669,446493697,3894,469190,592987,592,2427385,228694,51,4781,130000.0,43333.0,-70.0,-65.0,-74.0,-68.0,-70.0,-65.0,-73.0,-67.0,-90.0,-93.0,-90.0,-93.0,20.0,28.0,16.0,25.0,0
1450,F8:59:71:5A:E0:3D,2656049,374426629,27122,41624470,2628927,332802159,0,3274,408763,3183,393652,91,15111,3109,0,27138,865,0,27,130000.0,39000.0,-67.0,-73.0,-65.0,-73.0,-67.0,-73.0,-66.0,-71.0,-90.0,-93.0,-90.0,-93.0,23.0,20.0,25.0,20.0,0
1451,CC:2F:71:3E:C5:1F,2634072,333431278,5145,629119,2628927,332802159,6,22092,1852271,18209,1392073,3883,460198,5430,30,7336,133,6,448,130000.0,39000.0,-69.0,-71.0,-68.0,-60.0,-69.0,-70.0,-68.0,-60.0,-90.0,-93.0,-90.0,-93.0,21.0,22.0,22.0,33.0,0
1452,CC:2F:71:3F:1F:24,5055131,3989306596,2426204,3656504437,2628927,332802159,51,619807,446992335,615913,446523145,3894,469190,593231,592,2428294,228705,51,4781,130000.0,43333.0,-70.0,-65.0,-72.0,-67.0,-70.0,-64.0,-73.0,-67.0,-90.0,-93.0,-90.0,-93.0,20.0,28.0,18.0,26.0,0
1453,F8:59:71:5A:E0:3D,2656056,374427295,27122,41624470,2628934,332802825,0,3274,408763,3183,393652,91,15111,3109,0,27138,865,0,27,130000.0,39000.0,-67.0,-73.0,-65.0,-73.0,-67.0,-73.0,-66.0,-71.0,-90.0,-93.0,-90.0,-93.0,23.0,20.0,25.0,20.0,0
1454,CC:2F:71:3E:C5:1F,2634079,333431944,5145,629119,2628934,332802825,6,22092,1852271,18209,1392073,3883,460198,5430,30,7336,133,6,448,130000.0,39000.0,-69.0,-71.0,-68.0,-60.0,-69.0,-70.0,-68.0,-60.0,-90.0,-93.0,-90.0,-93.0,21.0,22.0,22.0,33.0,0
1455,CC:2F:71:3F:1F:24,5055696,3990147530,2426762,3657344705,2628934,332802825,51,620047,447021387,616153,446552197,3894,469190,593470,592,2428850,228720,51,4781,130000.0,43333.0,-71.0,-65.0,-74.0,-67.0,-70.0,-64.0,-73.0,-67.0,-90.0,-93.0,-90.0,-93.0,19.0,28.0,16.0,26.0,0
1456,F8:59:71:5A:E0:3D,2656058,374427497,27122,41624470,2628936,332803027,0,3274,408763,3183,393652,91,15111,3109,0,27138,865,0,27,130000.0,39000.0,-67.0,-73.0,-65.0,-73.0,-67.0,-73.0,-66.0,-71.0,-90.0,-93.0,-90.0,-93.0,23.0,20.0,25.0,20.0,0
1457,CC:2F:71:3E:C5:1F,2634081,333432146,5145,629119,2628936,332803027,6,22092,1852271,18209,1392073,3883,460198,5430,30,7336,133,6,448,130000.0,39000.0,-69.0,-71.0,-68.0,-60.0,-69.0,-70.0,-68.0,-60.0,-90.0,-93.0,-90.0,-93.0,21.0,22.0,22.0,33.0,0
1458,CC:2F:71:3F:1F:24,5056204,3990906168,2427268,3658103141,2628936,332803027,51,620297,447051459,616403,446582269,3894,469190,593720,592,2429358,228722,51,4781,130000.0,43333.0,-70.0,-65.0,-74.0,-67.0,-70.0,-64.0,-74.0,-67.0,-90.0,-93.0,-90.0,-93.0,20.0,28.0,16.0,26.0,0
1459,F8:59:71:5A:E0:3D,2656064,374428103,27122,41624470,2628942,332803633,0,3274,408763,3183,393652,91,15111,3109,0,27138,865,0,27,130000.0,39000.0,-67.0,-73.0,-65.0,-73.0,-67.0,-73.0,-66.0,-71.0,-90.0,-93.0,-90.0,-93.0,23.0,20.0,25.0,20.0,0
1460,CC:2F:71:3E:C5:1F,2634087,333432752,5145,629119,2628942,332803633,6,22092,1852271,18209,1392073,3883,460198,5430,30,7336,133,6,448,130000.0,39000.0,-69.0,-71.0,-68.0,-60.0,-69.0,-70.0,-68.0,-60.0,-90.0,-93.0,-90.0,-93.0,21.0,22.0,22.0,33.0,0
1461,CC:2F:71:3F:1F:24,5056960,3992050074,2428018,3659246441,2628942,332803633,51,620663,447095487,616769,446626297,3894,469190,594082,592,2430105,228731,51,4781,130000.0,39000.0,-71.0,-65.0,-74.0,-67.0,-70.0,-64.0,-73.0,-67.0,-90.0,-93.0,-89.0,-92.0,19.0,28.0,15.0,25.0,0
1462,F8:59:71:5A:E0:3D,2656066,374428279,27123,41624586,2628943,332803693,0,3276,408903,3185,393792,91,15111,3109,0,27139,865,0,27,130000.0,39000.0,-67.0,-74.0,-66.0,-73.0,-67.0,-73.0,-66.0,-72.0,-90.0,-93.0,-89.0,-92.0,23.0,19.0,23.0,19.0,0
1463,CC:2F:71:3E:C5:1F,2634089,333432928,5146,629235,2628943,332803693,6,22094,1852411,18211,1392213,3883,460198,5430,30,7337,133,6,448,130000.0,39000.0,-69.0,-71.0,-69.0,-60.0,-69.0,-71.0,-68.0,-60.0,-90.0,-93.0,-89.0,-92.0,21.0,22.0,20.0,32.0,0
1464,CC:2F:71:3F:1F:24,5058474,3994394592,2429529,3661590697,2628945,332803895,51,621308,447172311,617414,446703121,3894,469190,594727,592,2431619,228731,51,4781,130000.0,43333.0,-71.0,-65.0,-74.0,-67.0,-70.0,-64.0,-74.0,-67.0,-90.0,-93.0,-89.0,-92.0,19.0,28.0,15.0,25.0,0
1465,F8:59:71:5A:E0:3D,2656074,374429087,27123,41624586,2628951,332804501,0,3276,408903,3185,393792,91,15111,3109,0,27139,865,0,27,130000.0,39000.0,-67.0,-74.0,-66.0,-73.0,-67.0,-73.0,-66.0,-72.0,-90.0,-93.0,-89.0,-92.0,23.0,19.0,23.0,19.0,0
1466,CC:2F:71:3E:C5:1F,2634097,333433736,5146,629235,2628951,332804501,6,22094,1852411,18211,1392213,3883,460198,5430,30,7337,133,6,448,130000.0,39000.0,-69.0,-71.0,-69.0,-60.0,-69.0,-71.0,-68.0,-60.0,-90.0,-93.0,-89.0,-92.0,21.0,22.0,20.0,32.0,0
1467,CC:2F:71:3F:1F:24,5060432,3997436870,2431481,3664632369,2628951,332804501,51,622157,447274353,618263,446805163,3894,469190,595576,592,2433565,228758,51,4785,130000.0,43333.0,-75.0,-69.0,-77.0,-71.0,-73.0,-68.0,-76.0,-70.0,-90.0,-93.0,-89.0,-92.0,15.0,24.0,12.0,21.0,0
1468,F8:59:71:5A:E0:3D,2656074,374429087,27123,41624586,2628951,332804501,0,3276,408903,3185,393792,91,15111,3109,0,27139,865,0,27,130000.0,39000.0,-67.0,-74.0,-66.0,-73.0,-67.0,-73.0,-66.0,-72.0,-90.0,-93.0,-89.0,-92.0,23.0,19.0,23.0,19.0,0
1469,CC:2F:71:3E:C5:1F,2634097,333433736,5146,629235,2628951,332804501,6,22094,1852411,18211,1392213,3883,460198,5430,30,7337,133,6,448,130000.0,39000.0,-69.0,-71.0,-69.0,-60.0,-69.0,-71.0,-68.0,-60.0,-90.0,-93.0,-89.0,-92.0,21.0,22.0,20.0,32.0,0
1470,CC:2F:71:3F:1F:24,5062780,4001101688,2433828,3668297127,2628952,332804561,51,622731,447344315,618837,446875125,3894,469190,596148,592,2435918,228818,51,4786,130000.0,43333.0,-71.0,-65.0,-74.0,-68.0,-70.0,-65.0,-74.0,-67.0,-90.0,-93.0,-89.0,-92.0,19.0,28.0,15.0,24.0,0
1471,F8:59:71:5A:E0:3D,2656083,374429955,27123,41624586,2628960,332805369,0,3276,408903,3185,393792,91,15111,3109,0,27139,865,0,27,130000.0,39000.0,-67.0,-74.0,-66.0,-73.0,-67.0,-73.0,-66.0,-72.0,-90.0,-93.0,-89.0,-92.0,23.0,19.0,23.0,19.0,0
1472,CC:2F:71:3E:C5:1F,2634106,333434604,5146,629235,2628960,332805369,6,22094,1852411,18211,1392213,3883,460198,5430,30,7337,133,6,448,130000.0,39000.0,-69.0,-71.0,-69.0,-60.0,-69.0,-71.0,-68.0,-60.0,-90.0,-93.0,-89.0,-92.0,21.0,22.0,20.0,32.0,0
1473,CC:2F:71:3F:1F:24,5065129,4004756481,2436168,3671950839,2628961,332805642,51,623239,447406729,619345,446937539,3894,469190,596654,592,2438258,228868,51,4791,130000.0,43333.0,-73.0,-65.0,-75.0,-68.0,-73.0,-65.0,-75.0,-68.0,-90.0,-93.0,-89.0,-92.0,17.0,28.0,14.0,24.0,0
1474,F8:59:71:5A:E0:3D,2656084,374430228,27123,41624586,2628961,332805642,0,3276,408903,3185,393792,91,15111,3109,0,27139,865,0,27,130000.0,39000.0,-67.0,-74.0,-66.0,-73.0,-67.0,-73.0,-66.0,-72.0,-90.0,-93.0,-89.0,-92.0,23.0,19.0,23.0,19.0,0
1475,CC:2F:71:3E:C5:1F,2634107,333434877,5146,629235,2628961,332805642,6,22094,1852411,18211,1392213,3883,460198,5430,30,7337,133,6,448,130000.0,39000.0,-69.0,-71.0,-69.0,-60.0,-69.0,-71.0,-68.0,-60.0,-90.0,-93.0,-89.0,-92.0,21.0,22.0,20.0,32.0,0
1476,CC:2F:71:3F:1F:24,5068817,4010536113,2439856,3677730471,2628961,332805642,51,623910,447489639,620016,447020449,3894,469190,597320,592,2441931,228892,51,4791,130000.0,43333.0,-72.0,-65.0,-75.0,-68.0,-72.0,-65.0,-74.0,-68.0,-90.0,-93.0,-89.0,-92.0,18.0,28.0,14.0,24.0,0
1477,F8:59:71:5A:E0:3D,2656092,374430956,27123,41624586,2628969,332806370,0,3276,408903,3185,393792,91,15111,3109,0,27139,865,0,27,130000.0,39000.0,-67.0,-74.0,-66.0,-73.0,-67.0,-73.0,-66.0,-72.0,-90.0,-93.0,-89.0,-92.0,23.0,19.0,23.0,19.0,0
1478,CC:2F:71:3E:C5:1F,2634117,333435807,5146,629235,2628971,332806572,6,22096,1852599,18212,1392283,3884,460316,5431,30,7337,133,6,448,130000.0,39000.0,-69.0,-71.0,-69.0,-60.0,-69.0,-71.0,-68.0,-60.0,-90.0,-93.0,-89.0,-92.0,21.0,22.0,20.0,32.0,0
1479,CC:2F:71:3F:1F:24,5072769,4016718487,2443798,3683911915,2628971,332806572,51,624510,447563347,620616,447094157,3894,469190,597917,592,2445882,228955,51,4791,130000.0,43333.0,-72.0,-65.0,-75.0,-68.0,-72.0,-65.0,-75.0,-68.0,-90.0,-93.0,-89.0,-92.0,18.0,28.0,14.0,24.0,0
1480,F8:59:71:5A:E0:3D,2656095,374431220,27123,41624586,2628972,332806634,0,3278,409091,3186,393862,92,15229,3110,0,27139,865,0,27,130000.0,39000.0,-68.0,-75.0,-65.0,-73.0,-67.0,-74.0,-65.0,-72.0,-90.0,-93.0,-88.0,-91.0,22.0,18.0,23.0,18.0,0
1481,CC:2F:71:3E:C5:1F,2634118,333435869,5146,629235,2628972,332806634,6,22096,1852599,18212,1392283,3884,460316,5431,30,7337,133,6,448,130000.0,39000.0,-69.0,-71.0,-69.0,-60.0,-69.0,-71.0,-68.0,-60.0,-90.0,-93.0,-88.0,-91.0,21.0,22.0,19.0,31.0,0
1482,CC:2F:71:3F:1F:24,5076955,4023280493,2447981,3690473657,2628974,332806836,51,625069,447632983,621175,447163793,3894,469190,598476,592,2450054,229127,51,4791,130000.0,43333.0,-71.0,-64.0,-74.0,-67.0,-71.0,-64.0,-73.0,-67.0,-90.0,-93.0,-88.0,-91.0,19.0,29.0,14.0,24.0,0
1483,F8:59:71:5A:E0:3D,2656102,374431960,27123,41624586,2628979,332807374,0,3278,409091,3186,393862,92,15229,3110,0,27139,865,0,27,130000.0,39000.0,-68.0,-75.0,-65.0,-73.0,-67.0,-74.0,-65.0,-72.0,-90.0,-93.0,-88.0,-91.0,22.0,18.0,23.0,18.0,0
1484,CC:2F:71:3E:C5:1F,2634126,333436677,5146,629235,2628980,332807442,6,22096,1852599,18212,1392283,3884,460316,5431,30,7337,133,6,448,130000.0,39000.0,-69.0,-71.0,-69.0,-60.0,-69.0,-71.0,-68.0,-60.0,-90.0,-93.0,-88.0,-91.0,21.0,22.0,19.0,31.0,0
1485,CC:2F:71:3F:1F:24,5081634,4030609213,2452654,3697801771,2628980,332807442,51,625665,447706365,621771,447237175,3894,469190,599072,592,2454698,229158,51,4791,130000.0,39000.0,-71.0,-64.0,-74.0,-67.0,-71.0,-64.0,-74.0,-67.0,-90.0,-93.0,-88.0,-91.0,19.0,29.0,14.0,24.0,0
1486,F8:59:71:5A:E0:3D,2656104,374432088,27123,41624586,2628981,332807502,0,3278,409091,3186,393862,92,15229,3110,0,27139,865,0,27,130000.0,39000.0,-68.0,-75.0,-65.0,-73.0,-67.0,-74.0,-65.0,-72.0,-90.0,-93.0,-88.0,-91.0,22.0,18.0,23.0,18.0,0
1487,CC:2F:71:3E:C5:1F,2634129,333436939,5146,629235,2628983,332807704,6,22096,1852599,18212,1392283,3884,460316,5431,30,7337,133,6,448,130000.0,39000.0,-69.0,-71.0,-69.0,-60.0,-69.0,-71.0,-68.0,-60.0,-90.0,-93.0,-88.0,-91.0,21.0,22.0,19.0,31.0,0
1488,CC:2F:71:3F:1F:24,5086313,4037943435,2457330,3705135731,2628983,332807704,51,626211,447774411,622317,447305221,3894,469190,599615,592,2459399,229486,51,4791,130000.0,43333.0,-71.0,-64.0,-74.0,-67.0,-71.0,-64.0,-74.0,-67.0,-90.0,-93.0,-88.0,-91.0,19.0,29.0,14.0,24.0,0
1489,F8:59:71:5A:E0:3D,2656112,374432896,27123,41624586,2628989,332808310,0,3278,409091,3186,393862,92,15229,3110,0,27139,865,0,27,130000.0,39000.0,-68.0,-75.0,-65.0,-73.0,-67.0,-74.0,-65.0,-72.0,-90.0,-93.0,-88.0,-91.0,22.0,18.0,23.0,18.0,0
1490,CC:2F:71:3E:C5:1F,2634135,333437545,5146,629235,2628989,332808310,6,22096,1852599,18212,1392283,3884,460316,5431,30,7337,133,6,448,130000.0,39000.0,-69.0,-71.0,-69.0,-60.0,-69.0,-71.0,-68.0,-60.0,-90.0,-93.0,-88.0,-91.0,21.0,22.0,19.0,31.0,0
1491,CC:2F:71:3F:1F:24,5092130,4047073719,2463141,3714265409,2628989,332808310,51,626914,447861895,623020,447392705,3894,469190,600318,592,2465088,229714,51,4791,130000.0,43333.0,-71.0,-64.0,-74.0,-67.0,-71.0,-64.0,-73.0,-67.0,-90.0,-93.0,-88.0,-91.0,19.0,29.0,14.0,24.0,0
1492,F8:59:71:5A:E0:3D,2656119,374433714,27123,41624586,2628996,332809128,0,3278,409091,3186,393862,92,15229,3110,0,27139,865,0,27,130000.0,39000.0,-68.0,-75.0,-65.0,-73.0,-67.0,-74.0,-65.0,-72.0,-89.0,-93.0,-88.0,-91.0,21.0,18.0,23.0,18.0,0
1493,CC:2F:71:3E:C5:1F,2634142,333438363,5146,629235,2628996,332809128,6,22096,1852599,18212,1392283,3884,460316,5431,30,7337,133,6,448,130000.0,39000.0,-69.0,-71.0,-69.0,-60.0,-69.0,-71.0,-68.0,-60.0,-89.0,-93.0,-88.0,-91.0,20.0,22.0,19.0,31.0,0
1494,CC:2F:71:3F:1F:24,5096962,4054645571,2467966,3721836443,2628996,332809128,51,627434,447927531,623539,447458223,3895,469308,600838,592,2470056,229978,51,4791,130000.0,43333.0,-71.0,-64.0,-74.0,-67.0,-70.0,-64.0,-73.0,-66.0,-89.0,-93.0,-88.0,-91.0,18.0,29.0,14.0,24.0,0
1495,F8:59:71:5A:E0:3D,2656125,374434320,27123,41624586,2629002,332809734,0,3278,409091,3186,393862,92,15229,3110,0,27139,865,0,27,130000.0,39000.0,-68.0,-75.0,-65.0,-73.0,-67.0,-74.0,-65.0,-72.0,-89.0,-93.0,-88.0,-91.0,21.0,18.0,23.0,18.0,0
1496,CC:2F:71:3E:C5:1F,2634148,333438969,5146,629235,2629002,332809734,6,22096,1852599,18212,1392283,3884,460316,5431,30,7337,133,6,448,130000.0,39000.0,-69.0,-71.0,-69.0,-60.0,-69.0,-71.0,-68.0,-60.0,-89.0,-93.0,-88.0,-91.0,20.0,22.0,19.0,31.0,0
1497,CC:2F:71:3F:1F:24,5102344,4063082897,2473342,3730273163,2629002,332809734,51,627946,447992881,624051,447523573,3895,469308,601350,592,2475348,230175,51,4791,130000.0,43333.0,-72.0,-65.0,-74.0,-67.0,-71.0,-65.0,-74.0,-67.0,-89.0,-93.0,-88.0,-91.0,17.0,28.0,14.0,24.0,0
1498,F8:59:71:5A:E0:3D,2656130,374434784,27123,41624586,2629007,332810198,0,3278,409091,3186,393862,92,15229,3110,0,27139,865,0,27,130000.0,39000.0,-68.0,-75.0,-65.0,-73.0,-67.0,-74.0,-65.0,-72.0,-89.0,-93.0,-88.0,-91.0,21.0,18.0,23.0,18.0,0
1499,CC:2F:71:3E:C5:1F,2634155,333439635,5146,629235,2629009,332810400,6,22096,1852599,18212,1392283,3884,460316,5431,30,7337,133,6,448,130000.0,39000.0,-69.0,-71.0,-69.0,-60.0,-69.0,-71.0,-68.0,-60.0,-89.0,-93.0,-88.0,-91.0,20.0,22.0,19.0,31.0,0
1500,CC:2F:71:3F:1F:24,5108291,4072410899,2479282,3739600499,2629009,332810400,51,628511,448064511,624616,447595203,3895,469308,601911,592,2481372,230535,51,4791,117000.0,39000.0,-72.0,-65.0,-74.0,-68.0,-73.0,-66.0,-75.0,-69.0,-89.0,-93.0,-88.0,-91.0,17.0,28.0,14.0,23.0,0
1501,F8:59:71:5A:E0:3D,2656136,374435390,27123,41624586,2629013,332810804,0,3278,409091,3186,393862,92,15229,3110,0,27139,865,0,27,130000.0,39000.0,-68.0,-75.0,-65.0,-73.0,-67.0,-74.0,-65.0,-72.0,-89.0,-93.0,-88.0,-91.0,21.0,18.0,23.0,18.0,0
1502,CC:2F:71:3E:C5:1F,2634159,333440039,5146,629235,2629013,332810804,6,22096,1852599,18212,1392283,3884,460316,5431,30,7337,133,6,448,130000.0,39000.0,-69.0,-71.0,-69.0,-60.0,-69.0,-71.0,-68.0,-60.0,-89.0,-93.0,-88.0,-91.0,20.0,22.0,19.0,31.0,0
1503,CC:2F:71:3F:1F:24,5111149,4076873323,2482136,3744062519,2629013,332810804,51,628805,448102755,624910,447633447,3895,469308,602205,592,2484188,230614,51,4792,130000.0,43333.0,-71.0,-64.0,-74.0,-67.0,-71.0,-64.0,-74.0,-67.0,-89.0,-93.0,-88.0,-91.0,18.0,29.0,14.0,24.0,0
1504,F8:59:71:5A:E0:3D,2656143,374436056,27123,41624586,2629020,332811470,0,3278,409091,3186,393862,92,15229,3110,0,27139,865,0,27,130000.0,39000.0,-68.0,-75.0,-65.0,-73.0,-67.0,-74.0,-65.0,-72.0,-89.0,-92.0,-87.0,-91.0,21.0,17.0,22.0,18.0,0
1505,CC:2F:71:3E:C5:1F,2634166,333440705,5146,629235,2629020,332811470,6,22096,1852599,18212,1392283,3884,460316,5431,30,7337,133,6,448,130000.0,39000.0,-69.0,-71.0,-69.0,-60.0,-69.0,-71.0,-68.0,-60.0,-89.0,-92.0,-87.0,-91.0,20.0,21.0,18.0,31.0,0
1506,CC:2F:71:3F:1F:24,5114889,4082724463,2485869,3749912993,2629020,332811470,51,629318,448165511,625423,447696203,3895,469308,602718,592,2487959,230902,51,4792,130000.0,39000.0,-72.0,-65.0,-74.0,-68.0,-71.0,-64.0,-74.0,-67.0,-89.0,-92.0,-87.0,-91.0,17.0,27.0,13.0,23.0,0
1507,F8:59:71:5A:E0:3D,2656145,374436258,27123,41624586,2629022,332811672,0,3278,409091,3186,393862,92,15229,3110,0,27139,865,0,27,130000.0,39000.0,-68.0,-75.0,-65.0,-73.0,-67.0,-74.0,-65.0,-72.0,-89.0,-92.0,-87.0,-91.0,21.0,17.0,22.0,18.0,0
1508,CC:2F:71:3E:C5:1F,2634169,333441180,5146,629235,2629023,332811945,6,22096,1852599,18212,1392283,3884,460316,5431,30,7337,133,6,448,130000.0,39000.0,-69.0,-71.0,-69.0,-60.0,-69.0,-71.0,-68.0,-60.0,-89.0,-92.0,-87.0,-91.0,20.0,21.0,18.0,31.0,0
1509,CC:2F:71:3F:1F:24,5119384,4089770106,2490361,3756958161,2629023,332811945,51,629814,448226801,625919,447757493,3895,469308,603214,592,2492425,231071,51,4792,130000.0,43333.0,-72.0,-65.0,-74.0,-68.0,-71.0,-65.0,-74.0,-68.0,-89.0,-92.0,-87.0,-91.0,17.0,27.0,13.0,23.0,0
1510,F8:59:71:5A:E0:3D,2656150,374436935,27123,41624586,2629027,332812349,0,3278,409091,3186,393862,92,15229,3110,0,27139,865,0,27,130000.0,39000.0,-68.0,-75.0,-65.0,-73.0,-67.0,-74.0,-65.0,-72.0,-89.0,-92.0,-87.0,-91.0,21.0,17.0,22.0,18.0,0
1511,CC:2F:71:3E:C5:1F,2634175,333441786,5146,629235,2629029,332812551,6,22096,1852599,18212,1392283,3884,460316,5431,30,7337,133,6,448,130000.0,39000.0,-69.0,-71.0,-69.0,-60.0,-69.0,-71.0,-68.0,-60.0,-89.0,-92.0,-87.0,-91.0,20.0,21.0,18.0,31.0,0
1512,CC:2F:71:3F:1F:24,5124435,4097687346,2495406,3764874795,2629029,332812551,51,630311,448291517,626416,447822209,3895,469308,603710,592,2497476,231228,51,4792,130000.0,43333.0,-71.0,-64.0,-74.0,-67.0,-71.0,-64.0,-74.0,-67.0,-89.0,-92.0,-87.0,-91.0,18.0,28.0,13.0,24.0,0
1513,F8:59:71:5A:E0:3D,2656155,374437399,27123,41624586,2629032,332812813,0,3278,409091,3186,393862,92,15229,3110,0,27139,865,0,27,130000.0,39000.0,-68.0,-75.0,-65.0,-73.0,-67.0,-74.0,-65.0,-72.0,-89.0,-92.0,-87.0,-91.0,21.0,17.0,22.0,18.0,0
1514,CC:2F:71:3E:C5:1F,2634178,333442048,5146,629235,2629032,332812813,6,22096,1852599,18212,1392283,3884,460316,5431,30,7337,133,6,448,130000.0,39000.0,-69.0,-71.0,-69.0,-60.0,-69.0,-71.0,-68.0,-60.0,-89.0,-92.0,-87.0,-91.0,20.0,21.0,18.0,31.0,0
1515,CC:2F:71:3F:1F:24,5129291,4105298178,2500259,3772485365,2629032,332812813,51,630852,448359379,626957,447890071,3895,469308,604245,592,2502349,231607,51,4793,130000.0,43333.0,-72.0,-65.0,-74.0,-68.0,-71.0,-64.0,-74.0,-67.0,-89.0,-92.0,-87.0,-91.0,17.0,27.0,13.0,23.0,0
1516,F8:59:71:5A:E0:3D,2656161,374438005,27123,41624586,2629038,332813419,0,3278,409091,3186,393862,92,15229,3110,0,27139,865,0,27,130000.0,39000.0,-68.0,-75.0,-65.0,-73.0,-67.0,-74.0,-65.0,-72.0,-89.0,-92.0,-88.0,-92.0,21.0,17.0,23.0,19.0,0
1517,CC:2F:71:3E:C5:1F,2634184,333442654,5146,629235,2629038,332813419,6,22096,1852599,18212,1392283,3884,460316,5431,30,7337,133,6,448,130000.0,39000.0,-69.0,-71.0,-69.0,-60.0,-69.0,-71.0,-68.0,-60.0,-89.0,-92.0,-88.0,-92.0,20.0,21.0,19.0,32.0,0
1518,CC:2F:71:3F:1F:24,5134078,4112795930,2505040,3779982511,2629038,332813419,51,631340,448422897,627445,447953589,3895,469308,604733,592,2507113,231640,51,4793,130000.0,43333.0,-78.0,-71.0,-80.0,-74.0,-75.0,-68.0,-77.0,-71.0,-89.0,-92.0,-88.0,-92.0,11.0,21.0,8.0,18.0,0
1519,F8:59:71:5A:E0:3D,2656164,374438267,27123,41624586,2629041,332813681,0,3278,409091,3186,393862,92,15229,3110,0,27139,865,0,27,130000.0,39000.0,-68.0,-75.0,-65.0,-73.0,-67.0,-74.0,-65.0,-72.0,-89.0,-92.0,-88.0,-92.0,21.0,17.0,23.0,19.0,0
1520,CC:2F:71:3E:C5:1F,2634191,333443320,5146,629235,2629045,332814085,6,22096,1852599,18212,1392283,3884,460316,5431,30,7337,133,6,448,130000.0,39000.0,-69.0,-71.0,-69.0,-60.0,-69.0,-71.0,-68.0,-60.0,-89.0,-92.0,-88.0,-92.0,20.0,21.0,19.0,32.0,0
1521,CC:2F:71:3F:1F:24,5140475,4122839760,2511430,3790025675,2629045,332814085,51,632250,448536281,628355,448066973,3895,469308,605643,592,2513486,232014,51,4796,130000.0,43333.0,-71.0,-65.0,-75.0,-68.0,-71.0,-64.0,-74.0,-67.0,-89.0,-92.0,-88.0,-92.0,18.0,27.0,13.0,24.0,0
1522,F8:59:71:5A:E0:3D,2656170,374438873,27123,41624586,2629047,332814287,0,3278,409091,3186,393862,92,15229,3110,0,27139,865,0,27,130000.0,39000.0,-68.0,-75.0,-65.0,-73.0,-67.0,-74.0,-65.0,-72.0,-89.0,-92.0,-88.0,-92.0,21.0,17.0,23.0,19.0,0
1523,CC:2F:71:3E:C5:1F,2634193,333443522,5146,629235,2629047,332814287,6,22096,1852599,18212,1392283,3884,460316,5431,30,7337,133,6,448,130000.0,39000.0,-69.0,-71.0,-69.0,-60.0,-69.0,-71.0,-68.0,-60.0,-89.0,-92.0,-88.0,-92.0,20.0,21.0,19.0,32.0,0
1524,CC:2F:71:3F:1F:24,5144391,4128970372,2515342,3796155883,2629049,332814489,51,632694,448592233,628799,448122925,3895,469308,606087,592,2517393,232014,51,4797,130000.0,43333.0,-71.0,-64.0,-74.0,-67.0,-71.0,-64.0,-73.0,-66.0,-89.0,-92.0,-88.0,-92.0,18.0,28.0,14.0,25.0,0
1525,F8:59:71:5A:E0:3D,2656176,374439479,27123,41624586,2629053,332814893,0,3278,409091,3186,393862,92,15229,3110,0,27139,865,0,27,130000.0,39000.0,-68.0,-75.0,-65.0,-73.0,-67.0,-74.0,-65.0,-72.0,-89.0,-92.0,-88.0,-92.0,21.0,17.0,23.0,19.0,0
1526,CC:2F:71:3E:C5:1F,2634199,333444128,5146,629235,2629053,332814893,6,22096,1852599,18212,1392283,3884,460316,5431,30,7337,133,6,448,130000.0,39000.0,-69.0,-71.0,-69.0,-60.0,-69.0,-71.0,-68.0,-60.0,-89.0,-92.0,-88.0,-92.0,20.0,21.0,19.0,32.0,0
1527,CC:2F:71:3F:1F:24,5148253,4135017292,2519200,3802202399,2629053,332814893,51,633135,448647855,629240,448178547,3895,469308,606528,592,2521290,232149,51,4797,130000.0,39000.0,-71.0,-64.0,-73.0,-67.0,-70.0,-64.0,-73.0,-67.0,-89.0,-92.0,-88.0,-92.0,18.0,28.0,15.0,25.0,0
1528,F8:59:71:5A:E0:3D,2656179,374439741,27123,41624586,2629056,332815155,0,3278,409091,3186,393862,92,15229,3110,0,27139,865,0,27,130000.0,39000.0,-68.0,-75.0,-65.0,-73.0,-67.0,-74.0,-65.0,-72.0,-89.0,-92.0,-88.0,-92.0,21.0,17.0,23.0,19.0,0
1529,CC:2F:71:3E:C5:1F,2634202,333444390,5146,629235,2629056,332815155,6,22096,1852599,18212,1392283,3884,460316,5431,30,7337,133,6,448,130000.0,39000.0,-69.0,-71.0,-69.0,-60.0,-69.0,-71.0,-68.0,-60.0,-89.0,-92.0,-88.0,-92.0,20.0,21.0,19.0,32.0,0
1530,CC:2F:71:3F:1F:24,5152907,4142310782,2523849,3809495425,2629058,332815357,51,633733,448721245,629838,448251937,3895,469308,607120,592,2525902,232493,51,4797,130000.0,43333.0,-70.0,-64.0,-73.0,-67.0,-70.0,-64.0,-73.0,-67.0,-89.0,-92.0,-88.0,-92.0,19.0,28.0,15.0,25.0,0
1531,F8:59:71:5A:E0:3D,2656185,374440347,27123,41624586,2629062,332815761,0,3278,409091,3186,393862,92,15229,3110,0,27139,865,0,27,130000.0,39000.0,-68.0,-75.0,-65.0,-73.0,-67.0,-74.0,-65.0,-72.0,-89.0,-92.0,-88.0,-92.0,21.0,17.0,23.0,19.0,0
1532,CC:2F:71:3E:C5:1F,2634208,333444996,5146,629235,2629062,332815761,6,22096,1852599,18212,1392283,3884,460316,5431,30,7337,133,6,448,130000.0,39000.0,-69.0,-71.0,-69.0,-60.0,-69.0,-71.0,-68.0,-60.0,-89.0,-92.0,-88.0,-92.0,20.0,21.0,19.0,32.0,0
1533,CC:2F:71:3F:1F:24,5158250,4150694776,2529188,3817879015,2629062,332815761,51,634237,448786511,630342,448317203,3895,469308,607618,592,2531215,232680,51,4797,130000.0,43333.0,-71.0,-64.0,-74.0,-67.0,-70.0,-64.0,-73.0,-67.0,-89.0,-92.0,-88.0,-92.0,18.0,28.0,14.0,25.0,0
1534,F8:59:71:5A:E0:3D,2656191,374440927,27124,41624702,2629067,332816225,0,3280,409231,3188,394002,92,15229,3110,0,27140,865,0,27,130000.0,39000.0,-75.0,-80.0,-79.0,-75.0,-68.0,-75.0,-67.0,-73.0,-89.0,-92.0,-88.0,-92.0,14.0,12.0,9.0,17.0,0
1535,CC:2F:71:3E:C5:1F,2634214,333445576,5147,629351,2629067,332816225,6,22098,1852739,18214,1392423,3884,460316,5431,30,7338,133,6,448,130000.0,39000.0,-66.0,-70.0,-64.0,-60.0,-68.0,-70.0,-68.0,-60.0,-89.0,-92.0,-88.0,-92.0,23.0,22.0,24.0,32.0,0
1536,CC:2F:71:3F:1F:24,5163462,4158862832,2534395,3826046607,2629067,332816225,51,634660,448841147,630765,448371839,3895,469308,608041,592,2536432,233001,51,4797,130000.0,43333.0,-71.0,-65.0,-75.0,-68.0,-71.0,-64.0,-74.0,-67.0,-89.0,-92.0,-88.0,-92.0,18.0,27.0,13.0,24.0,0
1537,F8:59:71:5A:E0:3D,2656196,374441393,27124,41624702,2629072,332816691,0,3280,409231,3188,394002,92,15229,3110,0,27140,865,0,27,130000.0,39000.0,-75.0,-80.0,-79.0,-75.0,-68.0,-75.0,-67.0,-73.0,-89.0,-92.0,-88.0,-92.0,14.0,12.0,9.0,17.0,0
1538,CC:2F:71:3E:C5:1F,2634219,333446042,5147,629351,2629072,332816691,6,22098,1852739,18214,1392423,3884,460316,5431,30,7338,133,6,448,130000.0,39000.0,-66.0,-70.0,-64.0,-60.0,-68.0,-70.0,-68.0,-60.0,-89.0,-92.0,-88.0,-92.0,23.0,22.0,24.0,32.0,0
1539,CC:2F:71:3F:1F:24,5168851,4167307352,2539777,3834490459,2629074,332816893,51,635283,448921525,631387,448452099,3896,469426,608664,592,2541867,233187,51,4798,130000.0,43333.0,-71.0,-65.0,-73.0,-67.0,-70.0,-64.0,-73.0,-67.0,-89.0,-92.0,-88.0,-92.0,18.0,27.0,15.0,25.0,0
1540,F8:59:71:5A:E0:3D,2656202,374441919,27124,41624702,2629078,332817217,0,3282,409419,3189,394072,93,15347,3111,0,27140,865,0,27,130000.0,39000.0,-68.0,-75.0,-66.0,-73.0,-68.0,-75.0,-67.0,-73.0,-89.0,-92.0,-88.0,-92.0,21.0,17.0,22.0,19.0,0
1541,CC:2F:71:3E:C5:1F,2634225,333446568,5147,629351,2629078,332817217,6,22098,1852739,18214,1392423,3884,460316,5431,30,7338,133,6,448,130000.0,39000.0,-66.0,-70.0,-64.0,-60.0,-68.0,-70.0,-68.0,-60.0,-89.0,-92.0,-88.0,-92.0,23.0,22.0,24.0,32.0,0
1542,CC:2F:71:3F:1F:24,5174994,4176948688,2545914,3844131269,2629080,332817419,51,636008,449011113,632112,448541687,3896,469426,609386,592,2548004,233473,51,4798,130000.0,43333.0,-71.0,-65.0,-74.0,-67.0,-70.0,-64.0,-74.0,-67.0,-89.0,-92.0,-88.0,-92.0,18.0,27.0,14.0,25.0,0
1543,F8:59:71:5A:E0:3D,2656209,374442798,27124,41624702,2629085,332818096,0,3282,409419,3189,394072,93,15347,3111,0,27140,865,0,27,130000.0,39000.0,-68.0,-75.0,-66.0,-73.0,-68.0,-75.0,-67.0,-73.0,-89.0,-92.0,-88.0,-92.0,21.0,17.0,22.0,19.0,0
1544,CC:2F:71:3E:C5:1F,2634232,333447447,5147,629351,2629085,332818096,6,22098,1852739,18214,1392423,3884,460316,5431,30,7338,133,6,448,130000.0,39000.0,-66.0,-70.0,-64.0,-60.0,-68.0,-70.0,-68.0,-60.0,-89.0,-92.0,-88.0,-92.0,23.0,22.0,24.0,32.0,0
1545,CC:2F:71:3F:1F:24,5179579,4184131667,2550492,3851313369,2629087,332818298,51,636443,449067585,632547,448598159,3896,469426,609821,592,2552582,234473,51,4798,115556.0,28889.0,-72.0,-65.0,-74.0,-68.0,-72.0,-64.0,-73.0,-68.0,-89.0,-92.0,-88.0,-92.0,17.0,27.0,14.0,24.0,0
1546,F8:59:71:5A:E0:3D,2656215,374443404,27124,41624702,2629091,332818702,0,3282,409419,3189,394072,93,15347,3111,0,27140,865,0,27,130000.0,39000.0,-68.0,-75.0,-66.0,-73.0,-68.0,-75.0,-67.0,-73.0,-89.0,-92.0,-88.0,-91.0,21.0,17.0,22.0,18.0,0
1547,CC:2F:71:3E:C5:1F,2634239,333448113,5147,629351,2629092,332818762,6,22098,1852739,18214,1392423,3884,460316,5431,30,7338,133,6,448,130000.0,39000.0,-66.0,-70.0,-64.0,-60.0,-68.0,-70.0,-68.0,-60.0,-89.0,-92.0,-88.0,-91.0,23.0,22.0,24.0,31.0,0
1548,CC:2F:71:3F:1F:24,5184799,4192322425,2555707,3859503663,2629092,332818762,51,637295,449170197,633399,448700771,3896,469426,610672,592,2557789,234676,51,4798,130000.0,43333.0,-73.0,-65.0,-75.0,-67.0,-73.0,-65.0,-74.0,-67.0,-89.0,-92.0,-88.0,-91.0,16.0,27.0,13.0,24.0,0
1549,F8:59:71:5A:E0:3D,2656220,374443868,27124,41624702,2629096,332819166,0,3282,409419,3189,394072,93,15347,3111,0,27140,865,0,27,130000.0,39000.0,-68.0,-75.0,-66.0,-73.0,-68.0,-75.0,-67.0,-73.0,-89.0,-92.0,-88.0,-91.0,21.0,17.0,22.0,18.0,0
1550,CC:2F:71:3E:C5:1F,2634243,333448517,5147,629351,2629096,332819166,6,22098,1852739,18214,1392423,3884,460316,5431,30,7338,133,6,448,130000.0,39000.0,-66.0,-70.0,-64.0,-60.0,-68.0,-70.0,-68.0,-60.0,-89.0,-92.0,-88.0,-91.0,23.0,22.0,24.0,31.0,0
1551,CC:2F:71:3F:1F:24,5188830,4198638979,2559734,3865819813,2629096,332819166,51,637725,449224393,633829,448754967,3896,469426,611100,592,2561780,234791,51,4798,130000.0,43333.0,-73.0,-65.0,-75.0,-67.0,-72.0,-65.0,-75.0,-67.0,-89.0,-92.0,-88.0,-91.0,16.0,27.0,13.0,24.0,0
1552,F8:59:71:5A:E0:3D,2656224,374444272,27124,41624702,2629100,332819570,0,3282,409419,3189,394072,93,15347,3111,0,27140,865,0,27,130000.0,39000.0,-68.0,-75.0,-66.0,-73.0,-68.0,-75.0,-67.0,-73.0,-89.0,-92.0,-88.0,-91.0,21.0,17.0,22.0,18.0,0
1553,CC:2F:71:3E:C5:1F,2634249,333449123,5147,629351,2629102,332819772,6,22098,1852739,18214,1392423,3884,460316,5431,30,7338,133,6,448,130000.0,39000.0,-66.0,-70.0,-64.0,-60.0,-68.0,-70.0,-68.0,-60.0,-89.0,-92.0,-88.0,-91.0,23.0,22.0,24.0,31.0,0
1554,CC:2F:71:3F:1F:24,5193754,4206351079,2564651,3873531247,2629103,332819832,51,638245,449290893,634349,448821467,3896,469426,611612,593,2566706,235196,51,4798,130000.0,39000.0,-77.0,-69.0,-79.0,-70.0,-76.0,-68.0,-77.0,-69.0,-89.0,-92.0,-88.0,-91.0,12.0,23.0,9.0,21.0,0
1555,F8:59:71:5A:E0:3D,2656229,374444736,27124,41624702,2629105,332820034,0,3282,409419,3189,394072,93,15347,3111,0,27140,865,0,27,130000.0,39000.0,-68.0,-75.0,-66.0,-73.0,-68.0,-75.0,-67.0,-73.0,-89.0,-92.0,-88.0,-91.0,21.0,17.0,22.0,18.0,0
1556,CC:2F:71:3E:C5:1F,2634254,333449587,5147,629351,2629107,332820236,6,22098,1852739,18214,1392423,3884,460316,5431,30,7338,133,6,448,130000.0,39000.0,-66.0,-70.0,-64.0,-60.0,-68.0,-70.0,-68.0,-60.0,-89.0,-92.0,-88.0,-91.0,23.0,22.0,24.0,31.0,0
1557,CC:2F:71:3F:1F:24,5197427,4212096395,2568318,3879275957,2629109,332820438,52,638749,449351591,634853,448882165,3896,469426,612102,593,2570405,235410,52,4798,130000.0,43333.0,-74.0,-66.0,-75.0,-68.0,-75.0,-69.0,-77.0,-71.0,-89.0,-92.0,-88.0,-91.0,15.0,26.0,13.0,23.0,0
1558,F8:59:71:5A:E0:3D,2656235,374445342,27124,41624702,2629111,332820640,0,3282,409419,3189,394072,93,15347,3111,0,27140,865,0,27,130000.0,39000.0,-68.0,-75.0,-66.0,-73.0,-68.0,-75.0,-67.0,-73.0,-89.0,-92.0,-88.0,-91.0,21.0,17.0,22.0,18.0,0
1559,CC:2F:71:3E:C5:1F,2634258,333449991,5147,629351,2629111,332820640,6,22098,1852739,18214,1392423,3884,460316,5431,30,7338,133,6,448,130000.0,39000.0,-66.0,-70.0,-64.0,-60.0,-68.0,-70.0,-68.0,-60.0,-89.0,-92.0,-88.0,-91.0,23.0,22.0,24.0,31.0,0
1560,CC:2F:71:3F:1F:24,5200342,4216647429,2571229,3883826587,2629113,332820842,52,639070,449392979,635174,448923553,3896,469426,612412,593,2573297,235446,52,4799,130000.0,43333.0,-74.0,-66.0,-76.0,-68.0,-74.0,-66.0,-75.0,-67.0,-89.0,-92.0,-88.0,-91.0,15.0,26.0,12.0,23.0,0
1561,F8:59:71:5A:E0:3D,2656240,374445806,27124,41624702,2629116,332821104,0,3284,409559,3191,394212,93,15347,3111,0,27141,865,0,27,130000.0,39000.0,-68.0,-75.0,-66.0,-71.0,-68.0,-75.0,-67.0,-72.0,-89.0,-92.0,-88.0,-91.0,21.0,17.0,22.0,20.0,0
1562,CC:2F:71:3E:C5:1F,2634265,333450657,5147,629351,2629118,332821306,6,22100,1852879,18216,1392563,3884,460316,5431,30,7339,133,6,448,130000.0,39000.0,-69.0,-71.0,-69.0,-60.0,-68.0,-70.0,-68.0,-60.0,-89.0,-92.0,-88.0,-91.0,20.0,21.0,19.0,31.0,0
1563,CC:2F:71:3F:1F:24,5204806,4223638323,2575688,3890817017,2629118,332821306,52,639661,449466977,635765,448997551,3896,469426,612984,593,2577766,235744,52,4799,130000.0,43333.0,-73.0,-65.0,-75.0,-67.0,-73.0,-65.0,-75.0,-67.0,-89.0,-92.0,-88.0,-91.0,16.0,27.0,13.0,24.0,0
1564,F8:59:71:5A:E0:3D,2656247,374446474,27124,41624702,2629123,332821772,0,3284,409559,3191,394212,93,15347,3111,0,27141,865,0,27,130000.0,39000.0,-68.0,-75.0,-66.0,-71.0,-68.0,-75.0,-67.0,-72.0,-89.0,-92.0,-88.0,-91.0,21.0,17.0,22.0,20.0,0
1565,CC:2F:71:3E:C5:1F,2634270,333451123,5147,629351,2629123,332821772,6,22102,1853067,18217,1392633,3885,460434,5432,30,7339,133,6,448,130000.0,39000.0,-69.0,-72.0,-69.0,-60.0,-68.0,-71.0,-68.0,-60.0,-89.0,-92.0,-88.0,-91.0,20.0,20.0,19.0,31.0,0
1566,CC:2F:71:3F:1F:24,5207726,4228195347,2578603,3895373575,2629123,332821772,52,639963,449505519,636067,449036093,3896,469426,613286,593,2580688,235873,52,4799,130000.0,43333.0,-74.0,-66.0,-76.0,-68.0,-74.0,-66.0,-75.0,-67.0,-89.0,-92.0,-88.0,-91.0,15.0,26.0,12.0,23.0,0
1567,F8:59:71:5A:E0:3D,2656252,374446938,27124,41624702,2629128,332822236,0,3284,409559,3191,394212,93,15347,3111,0,27141,865,0,27,130000.0,39000.0,-68.0,-75.0,-66.0,-71.0,-68.0,-75.0,-67.0,-72.0,-89.0,-92.0,-88.0,-91.0,21.0,17.0,22.0,20.0,0
1568,CC:2F:71:3E:C5:1F,2634275,333451587,5147,629351,2629128,332822236,6,22102,1853067,18217,1392633,3885,460434,5432,30,7339,133,6,448,130000.0,39000.0,-69.0,-72.0,-69.0,-60.0,-68.0,-71.0,-68.0,-60.0,-89.0,-92.0,-88.0,-91.0,20.0,20.0,19.0,31.0,0
1569,CC:2F:71:3F:1F:24,5212231,4235255235,2583103,3902432999,2629128,332822236,52,640487,449569789,636591,449100363,3896,469426,613810,593,2585179,236230,52,4799,130000.0,43333.0,-74.0,-66.0,-76.0,-67.0,-73.0,-66.0,-75.0,-67.0,-89.0,-92.0,-88.0,-91.0,15.0,26.0,12.0,24.0,0
1570,F8:59:71:5A:E0:3D,2656256,374447342,27124,41624702,2629132,332822640,0,3284,409559,3191,394212,93,15347,3111,0,27141,865,0,27,130000.0,39000.0,-68.0,-75.0,-66.0,-71.0,-68.0,-75.0,-67.0,-72.0,-89.0,-92.0,-88.0,-91.0,21.0,17.0,22.0,20.0,0
1571,CC:2F:71:3E:C5:1F,2634279,333451991,5147,629351,2629132,332822640,6,22102,1853067,18217,1392633,3885,460434,5432,30,7339,133,6,448,130000.0,39000.0,-69.0,-72.0,-69.0,-60.0,-68.0,-71.0,-68.0,-60.0,-89.0,-92.0,-88.0,-91.0,20.0,20.0,19.0,31.0,0
1572,CC:2F:71:3F:1F:24,5217020,4242763217,2587888,3909940577,2629132,332822640,52,641099,449646589,637203,449177163,3896,469426,614422,593,2589967,236549,52,4800,130000.0,43333.0,-73.0,-65.0,-75.0,-67.0,-72.0,-65.0,-74.0,-66.0,-89.0,-92.0,-88.0,-91.0,16.0,27.0,13.0,24.0,0
1573,F8:59:71:5A:E0:3D,2656260,374447746,27124,41624702,2629136,332823044,0,3284,409559,3191,394212,93,15347,3111,0,27141,865,0,27,130000.0,39000.0,-68.0,-75.0,-66.0,-71.0,-68.0,-75.0,-67.0,-72.0,-89.0,-92.0,-88.0,-91.0,21.0,17.0,22.0,20.0,0
1574,CC:2F:71:3E:C5:1F,2634283,333452395,5147,629351,2629136,332823044,6,22102,1853067,18217,1392633,3885,460434,5432,30,7339,133,6,448,130000.0,39000.0,-69.0,-72.0,-69.0,-60.0,-68.0,-71.0,-68.0,-60.0,-89.0,-92.0,-88.0,-91.0,20.0,20.0,19.0,31.0,0
1575,CC:2F:71:3F:1F:24,5222736,4251731405,2593597,3918908099,2629139,332823306,52,641878,449741271,637982,449271845,3896,469426,615169,593,2595689,236765,52,4800,130000.0,39000.0,-73.0,-65.0,-74.0,-67.0,-73.0,-65.0,-74.0,-67.0,-89.0,-92.0,-88.0,-91.0,16.0,27.0,14.0,24.0,0
1576,F8:59:71:5A:E0:3D,2656265,374448210,27124,41624702,2629141,332823508,0,3284,409559,3191,394212,93,15347,3111,0,27141,865,0,27,130000.0,39000.0,-68.0,-75.0,-66.0,-71.0,-68.0,-75.0,-67.0,-72.0,-89.0,-92.0,-88.0,-91.0,21.0,17.0,22.0,20.0,0
1577,CC:2F:71:3E:C5:1F,2634289,333453132,5147,629351,2629142,332823781,6,22102,1853067,18217,1392633,3885,460434,5432,30,7339,133,6,448,130000.0,39000.0,-69.0,-72.0,-69.0,-60.0,-68.0,-71.0,-68.0,-60.0,-89.0,-92.0,-88.0,-91.0,20.0,20.0,19.0,31.0,0
1578,CC:2F:71:3F:1F:24,5227824,4259707064,2598680,3926883081,2629144,332823983,52,642457,449812407,638561,449342981,3896,469426,615747,593,2600741,237160,52,4800,130000.0,43333.0,-72.0,-64.0,-72.0,-67.0,-72.0,-64.0,-74.0,-67.0,-89.0,-92.0,-88.0,-91.0,17.0,28.0,16.0,24.0,0
1579,F8:59:71:5A:E0:3D,2656274,374449291,27124,41624702,2629150,332824589,0,3284,409559,3191,394212,93,15347,3111,0,27141,865,0,27,130000.0,39000.0,-68.0,-75.0,-66.0,-71.0,-68.0,-75.0,-67.0,-72.0,-89.0,-92.0,-88.0,-91.0,21.0,17.0,22.0,20.0,0
1580,CC:2F:71:3E:C5:1F,2634297,333453940,5147,629351,2629150,332824589,6,22102,1853067,18217,1392633,3885,460434,5432,30,7339,133,6,448,130000.0,39000.0,-69.0,-72.0,-69.0,-60.0,-68.0,-71.0,-68.0,-60.0,-89.0,-92.0,-88.0,-91.0,20.0,20.0,19.0,31.0,0
1581,CC:2F:71:3F:1F:24,5233011,4267835864,2603861,3935011275,2629150,332824589,52,643173,449898915,639277,449429489,3896,469426,616463,593,2605953,238616,52,4800,115556.0,28889.0,-71.0,-65.0,-75.0,-67.0,-71.0,-65.0,-74.0,-67.0,-89.0,-92.0,-88.0,-91.0,18.0,27.0,13.0,24.0,0
1582,F8:59:71:5A:E0:3D,2656277,374449553,27124,41624702,2629153,332824851,0,3284,409559,3191,394212,93,15347,3111,0,27141,865,0,27,130000.0,39000.0,-68.0,-75.0,-66.0,-71.0,-68.0,-75.0,-67.0,-72.0,-89.0,-92.0,-88.0,-91.0,21.0,17.0,22.0,20.0,0
1583,CC:2F:71:3E:C5:1F,2634300,333454202,5147,629351,2629153,332824851,6,22102,1853067,18217,1392633,3885,460434,5432,30,7339,133,6,448,130000.0,39000.0,-69.0,-72.0,-69.0,-60.0,-68.0,-71.0,-68.0,-60.0,-89.0,-92.0,-88.0,-91.0,20.0,20.0,19.0,31.0,0
1584,CC:2F:71:3F:1F:24,5237065,4274184868,2607912,3941360017,2629153,332824851,52,643577,449949775,639681,449480349,3896,469426,616867,593,2610004,238823,52,4800,115556.0,28889.0,-71.0,-64.0,-74.0,-68.0,-71.0,-64.0,-73.0,-68.0,-89.0,-92.0,-88.0,-91.0,18.0,28.0,14.0,23.0,0
1585,F8:59:71:5A:E0:3D,2656283,374450159,27124,41624702,2629159,332825457,0,3284,409559,3191,394212,93,15347,3111,0,27141,865,0,27,130000.0,39000.0,-68.0,-75.0,-66.0,-71.0,-68.0,-75.0,-67.0,-72.0,-89.0,-91.0,-88.0,-91.0,21.0,16.0,22.0,20.0,0
1586,CC:2F:71:3E:C5:1F,2634306,333454808,5147,629351,2629159,332825457,6,22102,1853067,18217,1392633,3885,460434,5432,30,7339,133,6,448,130000.0,39000.0,-69.0,-72.0,-69.0,-60.0,-68.0,-71.0,-68.0,-60.0,-89.0,-91.0,-88.0,-91.0,20.0,19.0,19.0,31.0,0
1587,CC:2F:71:3F:1F:24,5240357,4279327454,2611198,3946501997,2629159,332825457,52,643929,449995733,640033,449526307,3896,469426,617219,593,2613202,240503,52,4800,86667.0,14444.0,-72.0,-65.0,-75.0,-68.0,-71.0,-65.0,-75.0,-68.0,-89.0,-91.0,-88.0,-91.0,17.0,26.0,13.0,23.0,0
1588,F8:59:71:5A:E0:3D,2656288,374450623,27124,41624702,2629164,332825921,0,3284,409559,3191,394212,93,15347,3111,0,27141,865,0,27,130000.0,39000.0,-68.0,-75.0,-66.0,-71.0,-68.0,-75.0,-67.0,-72.0,-89.0,-91.0,-88.0,-91.0,21.0,16.0,22.0,20.0,0
1589,CC:2F:71:3E:C5:1F,2634313,333455474,5147,629351,2629166,332826123,6,22102,1853067,18217,1392633,3885,460434,5432,30,7339,133,6,448,130000.0,39000.0,-69.0,-72.0,-69.0,-60.0,-68.0,-71.0,-68.0,-60.0,-89.0,-91.0,-88.0,-91.0,20.0,19.0,19.0,31.0,0
1590,CC:2F:71:3F:1F:24,5244975,4286555676,2615807,3953729351,2629168,332826325,52,644819,450105449,640923,449636023,3896,469426,618109,593,2617806,240623,52,4803,86667.0,14444.0,-72.0,-65.0,-74.0,-67.0,-72.0,-65.0,-73.0,-67.0,-89.0,-91.0,-88.0,-91.0,17.0,26.0,14.0,24.0,0
1591,F8:59:71:5A:E0:3D,2656294,374451229,27124,41624702,2629170,332826527,0,3284,409559,3191,394212,93,15347,3111,0,27141,865,0,27,130000.0,39000.0,-68.0,-75.0,-66.0,-71.0,-68.0,-75.0,-67.0,-72.0,-89.0,-91.0,-88.0,-91.0,21.0,16.0,22.0,20.0,0
1592,CC:2F:71:3E:C5:1F,2634317,333455878,5147,629351,2629170,332826527,6,22102,1853067,18217,1392633,3885,460434,5432,30,7339,133,6,448,130000.0,39000.0,-69.0,-72.0,-69.0,-60.0,-68.0,-71.0,-68.0,-60.0,-89.0,-91.0,-88.0,-91.0,20.0,19.0,19.0,31.0,0
1593,CC:2F:71:3F:1F:24,5248977,4292827054,2619807,3960000527,2629170,332826527,52,645357,450172199,641461,449702773,3896,469426,618647,593,2621884,240910,52,4803,130000.0,43333.0,-73.0,-65.0,-74.0,-68.0,-72.0,-64.0,-74.0,-68.0,-89.0,-91.0,-88.0,-91.0,16.0,26.0,14.0,23.0,0
1594,F8:59:71:5A:E0:3D,2656301,374452061,27124,41624702,2629177,332827359,0,3284,409559,3191,394212,93,15347,3111,0,27141,865,0,27,130000.0,39000.0,-68.0,-75.0,-66.0,-71.0,-68.0,-75.0,-67.0,-72.0,-89.0,-91.0,-88.0,-91.0,21.0,16.0,22.0,20.0,0
1595,CC:2F:71:3E:C5:1F,2634324,333456710,5147,629351,2629177,332827359,6,22102,1853067,18217,1392633,3885,460434,5432,30,7339,133,6,448,130000.0,39000.0,-69.0,-72.0,-69.0,-60.0,-68.0,-71.0,-68.0,-60.0,-89.0,-91.0,-88.0,-91.0,20.0,19.0,19.0,31.0,0
1596,CC:2F:71:3F:1F:24,5252156,4297791764,2622977,3964964203,2629179,332827561,52,645768,450224227,641872,449754801,3896,469426,619058,593,2625057,241015,52,4803,130000.0,43333.0,-73.0,-65.0,-74.0,-67.0,-72.0,-65.0,-74.0,-67.0,-89.0,-91.0,-88.0,-91.0,16.0,26.0,14.0,24.0,0
1597,F8:59:71:5A:E0:3D,2656303,374452263,27124,41624702,2629179,332827561,0,3284,409559,3191,394212,93,15347,3111,0,27141,865,0,27,130000.0,39000.0,-68.0,-75.0,-66.0,-71.0,-68.0,-75.0,-67.0,-72.0,-89.0,-91.0,-88.0,-91.0,21.0,16.0,22.0,20.0,0
1598,CC:2F:71:3E:C5:1F,2634326,333456912,5147,629351,2629179,332827561,6,22102,1853067,18217,1392633,3885,460434,5432,30,7339,133,6,448,130000.0,39000.0,-69.0,-72.0,-69.0,-60.0,-68.0,-71.0,-68.0,-60.0,-89.0,-91.0,-88.0,-91.0,20.0,19.0,19.0,31.0,0
1599,CC:2F:71:3F:1F:24,5256905,4305243988,2627724,3972416225,2629181,332827763,52,646447,450307009,642551,449837583,3896,469426,619737,593,2629699,241268,52,4803,117000.0,39000.0,-72.0,-65.0,-74.0,-67.0,-71.0,-65.0,-74.0,-67.0,-89.0,-91.0,-88.0,-91.0,17.0,26.0,14.0,24.0,0
1600,F8:59:71:5A:E0:3D,2656309,374452869,27124,41624702,2629185,332828167,0,3284,409559,3191,394212,93,15347,3111,0,27141,865,0,27,130000.0,39000.0,-68.0,-75.0,-66.0,-71.0,-68.0,-75.0,-67.0,-72.0,-89.0,-91.0,-88.0,-91.0,21.0,16.0,22.0,20.0,0
1601,CC:2F:71:3E:C5:1F,2634334,333457720,5147,629351,2629187,332828369,6,22102,1853067,18217,1392633,3885,460434,5432,30,7339,133,6,448,130000.0,39000.0,-69.0,-72.0,-69.0,-60.0,-68.0,-71.0,-68.0,-60.0,-89.0,-91.0,-88.0,-91.0,20.0,19.0,19.0,31.0,0
1602,CC:2F:71:3F:1F:24,5261488,4312426780,2632301,3979598411,2629187,332828369,52,647074,450383611,643178,449914185,3896,469426,620364,593,2634328,241727,52,4803,130000.0,43333.0,-72.0,-64.0,-74.0,-67.0,-71.0,-64.0,-73.0,-67.0,-89.0,-91.0,-88.0,-91.0,17.0,27.0,14.0,24.0,0
1603,F8:59:71:5A:E0:3D,2656315,374453449,27125,41624818,2629190,332828631,0,3286,409699,3193,394352,93,15347,3111,0,27142,865,0,27,130000.0,39000.0,-68.0,-75.0,-66.0,-73.0,-68.0,-75.0,-67.0,-72.0,-89.0,-91.0,-88.0,-91.0,21.0,16.0,22.0,18.0,0
1604,CC:2F:71:3E:C5:1F,2634338,333458098,5148,629467,2629190,332828631,6,22104,1853207,18219,1392773,3885,460434,5432,30,7340,133,6,448,130000.0,39000.0,-77.0,-84.0,-75.0,-72.0,-69.0,-72.0,-69.0,-61.0,-89.0,-91.0,-88.0,-91.0,12.0,7.0,13.0,19.0,0
1605,CC:2F:71:3F:1F:24,5267258,4321475240,2638066,3988646407,2629192,332828833,52,647682,450459419,643786,449989993,3896,469426,620969,593,2640009,242865,52,4803,130000.0,39000.0,-72.0,-65.0,-75.0,-68.0,-72.0,-64.0,-74.0,-67.0,-89.0,-91.0,-88.0,-91.0,17.0,26.0,13.0,23.0,0
1606,F8:59:71:5A:E0:3D,2656321,374454055,27125,41624818,2629196,332829237,0,3286,409699,3193,394352,93,15347,3111,0,27142,865,0,27,130000.0,39000.0,-68.0,-75.0,-66.0,-73.0,-68.0,-75.0,-67.0,-72.0,-89.0,-91.0,-88.0,-91.0,21.0,16.0,22.0,18.0,0
1607,CC:2F:71:3E:C5:1F,2634344,333458704,5148,629467,2629196,332829237,6,22104,1853207,18219,1392773,3885,460434,5432,30,7340,133,6,448,130000.0,39000.0,-77.0,-84.0,-75.0,-72.0,-69.0,-72.0,-69.0,-61.0,-89.0,-91.0,-88.0,-91.0,12.0,7.0,13.0,19.0,0
1608,CC:2F:71:3F:1F:24,5271757,4328522025,2642561,3995692788,2629196,332829237,52,648148,450517576,644252,450048150,3896,469426,621435,593,2644653,243324,52,4803,130000.0,43333.0,-72.0,-65.0,-75.0,-68.0,-71.0,-64.0,-73.0,-67.0,-89.0,-91.0,-88.0,-91.0,17.0,26.0,13.0,23.0,0
1609,F8:59:71:5A:E0:3D,2656326,374454519,27125,41624818,2629201,332829701,0,3286,409699,3193,394352,93,15347,3111,0,27142,865,0,27,130000.0,39000.0,-68.0,-75.0,-66.0,-73.0,-68.0,-75.0,-67.0,-72.0,-89.0,-91.0,-88.0,-91.0,21.0,16.0,22.0,18.0,0
1610,CC:2F:71:3E:C5:1F,2634351,333459370,5148,629467,2629203,332829903,6,22104,1853207,18219,1392773,3885,460434,5432,30,7340,133,6,448,130000.0,39000.0,-77.0,-84.0,-75.0,-72.0,-69.0,-72.0,-69.0,-61.0,-89.0,-91.0,-88.0,-91.0,12.0,7.0,13.0,19.0,0
1611,CC:2F:71:3F:1F:24,5275839,4334905062,2646633,4002074684,2629206,332830378,52,648603,450574866,644707,450105440,3896,469426,621887,593,2648675,244619,52,4803,115556.0,28889.0,-72.0,-65.0,-74.0,-68.0,-72.0,-64.0,-73.0,-68.0,-89.0,-91.0,-88.0,-91.0,17.0,26.0,14.0,23.0,0
1612,F8:59:71:5A:E0:3D,2656331,374455196,27125,41624818,2629206,332830378,0,3286,409699,3193,394352,93,15347,3111,0,27142,865,0,27,130000.0,39000.0,-68.0,-75.0,-66.0,-73.0,-68.0,-75.0,-67.0,-72.0,-89.0,-91.0,-88.0,-91.0,21.0,16.0,22.0,18.0,0
1613,CC:2F:71:3E:C5:1F,2634354,333459845,5148,629467,2629206,332830378,6,22104,1853207,18219,1392773,3885,460434,5432,30,7340,133,6,448,130000.0,39000.0,-77.0,-84.0,-75.0,-72.0,-69.0,-72.0,-69.0,-61.0,-89.0,-91.0,-88.0,-91.0,12.0,7.0,13.0,19.0,0
1614,CC:2F:71:3F:1F:24,5280539,4342277798,2651333,4009447420,2629206,332830378,52,649292,450660000,645396,450190574,3896,469426,622574,593,2653425,244825,52,4803,115556.0,28889.0,-72.0,-64.0,-74.0,-68.0,-72.0,-64.0,-74.0,-68.0,-89.0,-91.0,-88.0,-91.0,17.0,27.0,14.0,23.0,0
1615,F8:59:71:5A:E0:3D,2656338,374455862,27125,41624818,2629213,332831044,0,3286,409699,3193,394352,93,15347,3111,0,27142,865,0,27,130000.0,39000.0,-68.0,-75.0,-66.0,-73.0,-68.0,-75.0,-67.0,-72.0,-89.0,-91.0,-88.0,-91.0,21.0,16.0,22.0,18.0,0
1616,CC:2F:71:3E:C5:1F,2634363,333460713,5148,629467,2629215,332831246,6,22104,1853207,18219,1392773,3885,460434,5432,30,7340,133,6,448,130000.0,39000.0,-77.0,-84.0,-75.0,-72.0,-69.0,-72.0,-69.0,-61.0,-89.0,-91.0,-88.0,-91.0,12.0,7.0,13.0,19.0,0
1617,CC:2F:71:3F:1F:24,5286677,4351902291,2657462,4019071045,2629215,332831246,52,650185,450771187,646289,450301761,3896,469426,623467,593,2659522,245251,52,4803,115556.0,28889.0,-72.0,-64.0,-74.0,-68.0,-71.0,-64.0,-73.0,-68.0,-89.0,-91.0,-88.0,-91.0,17.0,27.0,14.0,23.0,0
1618,F8:59:71:5A:E0:3D,2656344,374456462,27125,41624818,2629219,332831644,0,3286,409699,3193,394352,93,15347,3111,0,27142,865,0,27,130000.0,39000.0,-68.0,-75.0,-66.0,-73.0,-68.0,-75.0,-67.0,-72.0,-88.0,-90.0,-87.0,-90.0,20.0,15.0,21.0,17.0,0
1619,CC:2F:71:3E:C5:1F,2634368,333461179,5148,629467,2629220,332831712,6,22104,1853207,18219,1392773,3885,460434,5432,30,7340,133,6,448,130000.0,39000.0,-77.0,-84.0,-75.0,-72.0,-69.0,-72.0,-69.0,-61.0,-88.0,-90.0,-87.0,-90.0,11.0,6.0,12.0,18.0,0
1620,CC:2F:71:3F:1F:24,5292203,4360570423,2662983,4027738711,2629220,332831712,52,650837,450854517,646940,450384973,3897,469544,624118,593,2665075,245768,52,4803,115556.0,28889.0,-72.0,-64.0,-74.0,-68.0,-71.0,-64.0,-73.0,-67.0,-88.0,-90.0,-87.0,-90.0,16.0,26.0,13.0,22.0,0
1621,F8:59:71:5A:E0:3D,2656350,374456994,27125,41624818,2629225,332832176,0,3286,409699,3193,394352,93,15347,3111,0,27142,865,0,27,130000.0,39000.0,-68.0,-75.0,-66.0,-73.0,-68.0,-75.0,-67.0,-72.0,-88.0,-90.0,-87.0,-90.0,20.0,15.0,21.0,17.0,0
1622,CC:2F:71:3E:C5:1F,2634373,333461643,5148,629467,2629225,332832176,6,22104,1853207,18219,1392773,3885,460434,5432,30,7340,133,6,448,130000.0,39000.0,-77.0,-84.0,-75.0,-72.0,-69.0,-72.0,-69.0,-61.0,-88.0,-90.0,-87.0,-90.0,11.0,6.0,12.0,18.0,0
1623,CC:2F:71:3F:1F:24,5297049,4368167057,2667824,4035334881,2629225,332832176,52,651465,450933125,647568,450463581,3897,469544,624746,593,2669866,245845,52,4803,115556.0,28889.0,-72.0,-64.0,-74.0,-68.0,-71.0,-64.0,-73.0,-68.0,-88.0,-90.0,-87.0,-90.0,16.0,26.0,13.0,22.0,0
1624,F8:59:71:5A:E0:3D,2656355,374457460,27125,41624818,2629230,332832642,0,3288,409887,3194,394422,94,15465,3112,0,27142,865,0,27,130000.0,39000.0,-68.0,-76.0,-66.0,-73.0,-68.0,-75.0,-65.0,-72.0,-88.0,-90.0,-87.0,-90.0,20.0,14.0,21.0,17.0,0
1625,CC:2F:71:3E:C5:1F,2634382,333462513,5148,629467,2629234,332833046,6,22104,1853207,18219,1392773,3885,460434,5432,30,7340,133,6,448,130000.0,39000.0,-77.0,-84.0,-75.0,-72.0,-69.0,-72.0,-69.0,-61.0,-88.0,-90.0,-87.0,-90.0,11.0,6.0,12.0,18.0,0
1626,CC:2F:71:3F:1F:24,5301688,4375433811,2672454,4042600765,2629234,332833046,52,651964,450996561,648067,450527017,3897,469544,625245,593,2674519,246187,52,4803,115556.0,28889.0,-71.0,-64.0,-74.0,-68.0,-70.0,-64.0,-73.0,-68.0,-88.0,-90.0,-87.0,-90.0,17.0,26.0,13.0,22.0,0
1627,F8:59:71:5A:E0:3D,2656384,374468974,27125,41624818,2629259,332844156,0,3288,409887,3194,394422,94,15465,3112,0,27142,865,0,27,130000.0,39000.0,-68.0,-76.0,-66.0,-73.0,-68.0,-75.0,-65.0,-72.0,-88.0,-90.0,-87.0,-90.0,20.0,14.0,21.0,17.0,0
1628,CC:2F:71:3E:C5:1F,2634407,333473623,5148,629467,2629259,332844156,6,22106,1853347,18221,1392913,3885,460434,5432,30,7341,133,6,448,130000.0,39000.0,-69.0,-71.0,-69.0,-60.0,-70.0,-72.0,-69.0,-61.0,-88.0,-90.0,-87.0,-90.0,19.0,19.0,18.0,30.0,0
1629,CC:2F:71:3F:1F:24,5306468,4382901741,2677207,4050057383,2629261,332844358,52,652654,451081809,648757,450612265,3897,469544,625935,593,2679221,247967,52,4803,115556.0,28889.0,-71.0,-64.0,-74.0,-68.0,-71.0,-64.0,-73.0,-68.0,-88.0,-90.0,-87.0,-90.0,17.0,26.0,13.0,22.0,0
1630,F8:59:71:5A:E0:3D,2656390,374469580,27125,41624818,2629265,332844762,0,3288,409887,3194,394422,94,15465,3112,0,27142,865,0,27,130000.0,39000.0,-68.0,-76.0,-66.0,-73.0,-68.0,-75.0,-65.0,-72.0,-88.0,-90.0,-87.0,-90.0,20.0,14.0,21.0,17.0,0
1631,CC:2F:71:3E:C5:1F,2634413,333474229,5148,629467,2629265,332844762,6,22106,1853347,18221,1392913,3885,460434,5432,30,7341,133,6,448,130000.0,39000.0,-69.0,-71.0,-69.0,-60.0,-70.0,-72.0,-69.0,-61.0,-88.0,-90.0,-87.0,-90.0,19.0,19.0,18.0,30.0,0
1632,CC:2F:71:3F:1F:24,5310305,4388908179,2681040,4056063417,2629265,332844762,52,653215,451152215,649318,450682671,3897,469544,626475,593,2683118,248776,52,4803,130000.0,43333.0,-71.0,-64.0,-73.0,-68.0,-71.0,-64.0,-73.0,-68.0,-88.0,-90.0,-87.0,-90.0,17.0,26.0,14.0,22.0,0
1633,F8:59:71:5A:E0:3D,2656396,374470106,27125,41624818,2629271,332845288,0,3288,409887,3194,394422,94,15465,3112,0,27142,865,0,27,130000.0,39000.0,-68.0,-76.0,-66.0,-73.0,-68.0,-75.0,-65.0,-72.0,-88.0,-90.0,-87.0,-90.0,20.0,14.0,21.0,17.0,0
1634,CC:2F:71:3E:C5:1F,2634419,333474755,5148,629467,2629271,332845288,6,22108,1853535,18222,1392983,3886,460552,5433,30,7341,133,6,448,130000.0,39000.0,-69.0,-72.0,-69.0,-60.0,-70.0,-72.0,-69.0,-61.0,-88.0,-90.0,-87.0,-90.0,19.0,18.0,18.0,30.0,0
1635,CC:2F:71:3F:1F:24,5315711,4397388553,2686440,4064543265,2629271,332845288,52,653948,451241873,650051,450772329,3897,469544,627204,593,2688518,248789,52,4803,130000.0,43333.0,-72.0,-64.0,-73.0,-68.0,-71.0,-64.0,-73.0,-67.0,-88.0,-90.0,-87.0,-90.0,16.0,26.0,14.0,22.0,0
1636,F8:59:71:5A:E0:3D,2656401,374471181,27126,41625489,2629275,332845692,0,3289,410037,3195,394572,94,15465,3113,0,27143,866,0,27,130000.0,39000.0,-68.0,-75.0,-65.0,-73.0,-68.0,-75.0,-65.0,-72.0,-88.0,-90.0,-87.0,-90.0,20.0,15.0,22.0,17.0,0
1637,CC:2F:71:3E:C5:1F,2634423,333475159,5148,629467,2629275,332845692,6,22108,1853535,18222,1392983,3886,460552,5433,30,7341,133,6,448,130000.0,39000.0,-69.0,-72.0,-69.0,-60.0,-70.0,-72.0,-69.0,-61.0,-88.0,-90.0,-87.0,-90.0,19.0,18.0,18.0,30.0,0
1638,CC:2F:71:3F:1F:24,5321234,4406040185,2691959,4073194493,2629275,332845692,52,654517,451313446,650620,450843902,3897,469544,627773,593,2694051,249213,52,4803,117000.0,39000.0,-72.0,-65.0,-73.0,-68.0,-71.0,-65.0,-72.0,-68.0,-88.0,-90.0,-87.0,-90.0,16.0,25.0,14.0,22.0,0
1639,F8:59:71:5A:E0:3D,2656407,374471787,27126,41625489,2629281,332846298,0,3290,410107,3196,394642,94,15465,3113,0,27143,866,0,27,130000.0,39000.0,-68.0,-69.0,-65.0,-70.0,-68.0,-74.0,-65.0,-72.0,-88.0,-90.0,-87.0,-90.0,20.0,21.0,22.0,20.0,0
1640,CC:2F:71:3E:C5:1F,2634429,333475765,5148,629467,2629281,332846298,6,22108,1853535,18222,1392983,3886,460552,5433,30,7341,133,6,448,130000.0,39000.0,-69.0,-72.0,-69.0,-60.0,-70.0,-72.0,-69.0,-61.0,-88.0,-90.0,-87.0,-90.0,19.0,18.0,18.0,30.0,0
1641,CC:2F:71:3F:1F:24,5327314,4415577539,2698030,4082730979,2629284,332846560,52,655367,451417586,651470,450948042,3897,469544,628623,593,2699998,249450,52,4803,130000.0,43333.0,-72.0,-64.0,-73.0,-68.0,-72.0,-64.0,-73.0,-67.0,-88.0,-91.0,-87.0,-90.0,16.0,27.0,14.0,22.0,0
1642,F8:59:71:5A:E0:3D,2656410,374472049,27126,41625489,2629284,332846560,0,3290,410107,3196,394642,94,15465,3113,0,27143,866,0,27,130000.0,39000.0,-68.0,-69.0,-65.0,-70.0,-68.0,-74.0,-65.0,-72.0,-88.0,-91.0,-87.0,-90.0,20.0,22.0,22.0,20.0,0
1643,CC:2F:71:3E:C5:1F,2634432,333476027,5148,629467,2629284,332846560,6,22108,1853535,18222,1392983,3886,460552,5433,30,7341,133,6,448,130000.0,39000.0,-69.0,-72.0,-69.0,-60.0,-70.0,-72.0,-69.0,-61.0,-88.0,-91.0,-87.0,-90.0,19.0,19.0,18.0,30.0,0
1644,CC:2F:71:3F:1F:24,5332094,4423077546,2702809,4090230713,2629285,332846833,52,656101,451508010,652204,451038466,3897,469544,629357,593,2704857,249599,52,4803,130000.0,43333.0,-72.0,-64.0,-73.0,-68.0,-71.0,-64.0,-73.0,-67.0,-88.0,-91.0,-87.0,-90.0,16.0,27.0,14.0,22.0,0
1645,F8:59:71:5A:E0:3D,2656419,374473130,27126,41625489,2629293,332847641,0,3290,410107,3196,394642,94,15465,3113,0,27143,866,0,27,130000.0,39000.0,-68.0,-69.0,-65.0,-70.0,-68.0,-74.0,-65.0,-72.0,-88.0,-91.0,-87.0,-90.0,20.0,22.0,22.0,20.0,0
1646,CC:2F:71:3E:C5:1F,2634441,333477108,5148,629467,2629293,332847641,6,22108,1853535,18222,1392983,3886,460552,5433,30,7341,133,6,448,130000.0,39000.0,-69.0,-72.0,-69.0,-60.0,-70.0,-72.0,-69.0,-61.0,-88.0,-91.0,-87.0,-90.0,19.0,19.0,18.0,30.0,0
1647,CC:2F:71:3F:1F:24,5334875,4427408276,2705582,4094560635,2629293,332847641,52,656376,451542606,652479,451073062,3897,469544,629632,593,2707674,249823,52,4803,130000.0,43333.0,-72.0,-64.0,-73.0,-67.0,-71.0,-64.0,-73.0,-67.0,-88.0,-91.0,-87.0,-90.0,16.0,27.0,14.0,23.0,0
1648,F8:59:71:5A:E0:3D,2656421,374473344,27127,41625643,2629294,332847701,0,3292,410317,3198,394852,94,15465,3114,0,27144,866,0,27,130000.0,39000.0,-68.0,-75.0,-66.0,-73.0,-68.0,-74.0,-65.0,-72.0,-88.0,-91.0,-87.0,-90.0,20.0,16.0,21.0,17.0,0
1649,CC:2F:71:3E:C5:1F,2634442,333477168,5148,629467,2629294,332847701,6,22108,1853535,18222,1392983,3886,460552,5433,30,7341,133,6,448,130000.0,39000.0,-69.0,-72.0,-69.0,-60.0,-70.0,-72.0,-69.0,-61.0,-88.0,-91.0,-87.0,-90.0,19.0,19.0,18.0,30.0,0
1650,CC:2F:71:3F:1F:24,5339843,4435200438,2710549,4102352737,2629294,332847701,52,656858,451602850,652961,451133306,3897,469544,630114,593,2712549,250062,52,4803,130000.0,43333.0,-71.0,-64.0,-73.0,-68.0,-71.0,-64.0,-73.0,-67.0,-88.0,-91.0,-87.0,-90.0,17.0,27.0,14.0,22.0,0
1651,F8:59:71:5A:E0:3D,2656427,374473950,27127,41625643,2629300,332848307,0,3292,410317,3198,394852,94,15465,3114,0,27144,866,0,27,130000.0,39000.0,-68.0,-75.0,-66.0,-73.0,-68.0,-74.0,-65.0,-72.0,-88.0,-91.0,-87.0,-90.0,20.0,16.0,21.0,17.0,0
1652,CC:2F:71:3E:C5:1F,2634450,333477976,5148,629467,2629302,332848509,6,22108,1853535,18222,1392983,3886,460552,5433,30,7341,133,6,448,130000.0,39000.0,-69.0,-72.0,-69.0,-60.0,-70.0,-72.0,-69.0,-61.0,-88.0,-91.0,-88.0,-91.0,19.0,19.0,19.0,31.0,0
1653,CC:2F:71:3F:1F:24,5344973,4443236394,2715671,4110387885,2629302,332848509,52,657411,451671074,653514,451201530,3897,469544,630667,593,2717746,250390,52,4803,130000.0,43333.0,-71.0,-64.0,-73.0,-67.0,-71.0,-64.0,-73.0,-67.0,-88.0,-91.0,-88.0,-91.0,17.0,27.0,15.0,24.0,0
1654,F8:59:71:5A:E0:3D,2656430,374474268,27128,41625759,2629302,332848509,0,3293,410423,3199,394958,94,15465,3115,0,27145,866,0,27,130000.0,39000.0,-68.0,-75.0,-65.0,-73.0,-68.0,-74.0,-65.0,-72.0,-88.0,-91.0,-88.0,-91.0,20.0,16.0,23.0,18.0,0
1655,CC:2F:71:3E:C5:1F,2634453,333478238,5148,629467,2629305,332848771,6,22108,1853535,18222,1392983,3886,460552,5433,30,7341,133,6,448,130000.0,39000.0,-69.0,-72.0,-69.0,-60.0,-70.0,-72.0,-69.0,-61.0,-88.0,-91.0,-88.0,-91.0,19.0,19.0,19.0,31.0,0
1656,CC:2F:71:3F:1F:24,5350022,4451155100,2720717,4118306329,2629305,332848771,52,658045,451750012,654148,451280468,3897,469544,631301,593,2722809,250695,52,4803,130000.0,39000.0,-71.0,-64.0,-73.0,-67.0,-71.0,-64.0,-73.0,-67.0,-88.0,-91.0,-88.0,-91.0,17.0,27.0,15.0,24.0,0
1657,F8:59:71:5A:E0:3D,2656440,374475252,27129,41625875,2629311,332849377,0,3297,410739,3203,395274,94,15465,3116,0,27146,866,0,28,144444.0,39000.0,-68.0,-75.0,-66.0,-74.0,-68.0,-74.0,-67.0,-72.0,-88.0,-91.0,-88.0,-91.0,20.0,16.0,22.0,17.0,0
1658,CC:2F:71:3E:C5:1F,2634459,333478844,5148,629467,2629311,332849377,6,22108,1853535,18222,1392983,3886,460552,5433,30,7341,133,6,448,130000.0,39000.0,-69.0,-72.0,-69.0,-60.0,-70.0,-72.0,-69.0,-61.0,-88.0,-91.0,-88.0,-91.0,19.0,19.0,19.0,31.0,0
1659,CC:2F:71:3F:1F:24,5356308,4461022178,2726997,4128172801,2629311,332849377,52,659107,451875292,655210,451405748,3897,469544,632347,593,2729020,250961,52,4803,130000.0,43333.0,-71.0,-64.0,-73.0,-68.0,-71.0,-64.0,-72.0,-67.0,-88.0,-91.0,-88.0,-91.0,17.0,27.0,15.0,23.0,0
1660,F8:59:71:5A:E0:3D,2656446,374475858,27129,41625875,2629317,332849983,0,3297,410739,3203,395274,94,15465,3116,0,27146,866,0,28,144444.0,39000.0,-68.0,-75.0,-66.0,-74.0,-68.0,-74.0,-67.0,-72.0,-88.0,-91.0,-88.0,-91.0,20.0,16.0,22.0,17.0,0
1661,CC:2F:71:3E:C5:1F,2634468,333479712,5148,629467,2629320,332850245,6,22108,1853535,18222,1392983,3886,460552,5433,30,7341,133,6,448,130000.0,39000.0,-69.0,-72.0,-69.0,-60.0,-70.0,-72.0,-69.0,-61.0,-88.0,-90.0,-87.0,-90.0,19.0,18.0,18.0,30.0,0
1662,CC:2F:71:3F:1F:24,5360757,4467980894,2731437,4135130649,2629320,332850245,52,659423,451915844,655526,451446300,3897,469544,632653,593,2733529,252564,52,4803,130000.0,43333.0,-73.0,-65.0,-75.0,-67.0,-74.0,-68.0,-76.0,-70.0,-88.0,-90.0,-87.0,-90.0,15.0,25.0,12.0,23.0,0
1663,F8:59:71:5A:E0:3D,2656449,374476120,27129,41625875,2629320,332850245,0,3297,410739,3203,395274,94,15465,3116,0,27146,866,0,28,144444.0,39000.0,-68.0,-75.0,-66.0,-74.0,-68.0,-74.0,-67.0,-72.0,-88.0,-90.0,-87.0,-90.0,20.0,15.0,21.0,16.0,0
1664,CC:2F:71:3E:C5:1F,2634472,333480116,5148,629467,2629324,332850649,6,22108,1853535,18222,1392983,3886,460552,5433,30,7341,133,6,448,130000.0,39000.0,-69.0,-72.0,-69.0,-60.0,-70.0,-72.0,-69.0,-61.0,-88.0,-90.0,-87.0,-90.0,19.0,18.0,18.0,30.0,0
1665,CC:2F:71:3F:1F:24,5365873,4475996576,2736547,4143145725,2629326,332850851,53,659953,451982094,656056,451512550,3897,469544,633164,594,2738585,252951,53,4803,130000.0,39000.0,-73.0,-65.0,-74.0,-67.0,-72.0,-65.0,-74.0,-67.0,-88.0,-90.0,-87.0,-90.0,15.0,25.0,13.0,23.0,0
1666,F8:59:71:5A:E0:3D,2656459,374477048,27130,41625935,2629329,332851113,0,3298,410809,3204,395344,94,15465,3116,0,27147,866,0,28,144444.0,39000.0,-67.0,-75.0,-66.0,-71.0,-68.0,-75.0,-67.0,-73.0,-88.0,-91.0,-88.0,-91.0,21.0,16.0,22.0,20.0,0
1667,CC:2F:71:3E:C5:1F,2634478,333480696,5149,629583,2629329,332851113,6,22110,1853675,18224,1393123,3886,460552,5433,30,7342,133,6,448,130000.0,39000.0,-69.0,-72.0,-69.0,-60.0,-70.0,-73.0,-69.0,-61.0,-88.0,-91.0,-88.0,-91.0,19.0,19.0,19.0,31.0,0
1668,CC:2F:71:3F:1F:24,5370536,4483305792,2741207,4150454679,2629329,332851113,53,660576,452057620,656679,451588076,3897,469544,633786,594,2743268,253101,53,4803,130000.0,43333.0,-73.0,-65.0,-75.0,-67.0,-73.0,-65.0,-75.0,-67.0,-88.0,-91.0,-88.0,-91.0,15.0,26.0,13.0,24.0,0
1669,F8:59:71:5A:E0:3D,2656465,374477654,27130,41625935,2629335,332851719,0,3299,410879,3205,395414,94,15465,3116,0,27147,866,0,28,144444.0,39000.0,-67.0,-74.0,-66.0,-71.0,-68.0,-75.0,-67.0,-72.0,-88.0,-91.0,-88.0,-91.0,21.0,17.0,22.0,20.0,0
1670,CC:2F:71:3E:C5:1F,2634484,333481302,5149,629583,2629335,332851719,6,22110,1853675,18224,1393123,3886,460552,5433,30,7342,133,6,448,130000.0,39000.0,-69.0,-72.0,-69.0,-60.0,-70.0,-73.0,-69.0,-61.0,-88.0,-91.0,-88.0,-91.0,19.0,19.0,19.0,31.0,0
1671,CC:2F:71:3F:1F:24,5375798,4491557214,2746463,4158705495,2629335,332851719,53,661122,452126002,657225,451656458,3897,469544,634329,594,2748543,253616,53,4803,130000.0,43333.0,-73.0,-65.0,-75.0,-67.0,-73.0,-65.0,-74.0,-67.0,-88.0,-91.0,-88.0,-91.0,15.0,26.0,13.0,24.0,0
1672,F8:59:71:5A:E0:3D,2656467,374477856,27130,41625935,2629337,332851921,0,3299,410879,3205,395414,94,15465,3116,0,27147,866,0,28,144444.0,39000.0,-67.0,-74.0,-66.0,-71.0,-68.0,-75.0,-67.0,-72.0,-88.0,-91.0,-88.0,-91.0,21.0,17.0,22.0,20.0,0
1673,CC:2F:71:3E:C5:1F,2634487,333481566,5149,629583,2629338,332851983,6,22110,1853675,18224,1393123,3886,460552,5433,30,7342,133,6,448,130000.0,39000.0,-69.0,-72.0,-69.0,-60.0,-70.0,-73.0,-69.0,-61.0,-88.0,-91.0,-88.0,-91.0,19.0,19.0,19.0,31.0,0
1674,CC:2F:71:3F:1F:24,5380796,4499394404,2751458,4166542421,2629338,332851983,53,661663,452193876,657765,451724214,3898,469662,634867,594,2753551,253713,53,4803,130000.0,43333.0,-73.0,-65.0,-75.0,-68.0,-73.0,-65.0,-75.0,-67.0,-88.0,-91.0,-88.0,-91.0,15.0,26.0,13.0,23.0,0
1675,F8:59:71:5A:E0:3D,2656475,374478584,27130,41625935,2629345,332852649,0,3299,410879,3205,395414,94,15465,3116,0,27147,866,0,28,144444.0,39000.0,-67.0,-74.0,-66.0,-71.0,-68.0,-75.0,-67.0,-72.0,-88.0,-91.0,-88.0,-91.0,21.0,17.0,22.0,20.0,0
1676,CC:2F:71:3E:C5:1F,2634494,333482232,5149,629583,2629345,332852649,6,22110,1853675,18224,1393123,3886,460552,5433,30,7342,133,6,448,130000.0,39000.0,-69.0,-72.0,-69.0,-60.0,-70.0,-73.0,-69.0,-61.0,-88.0,-91.0,-88.0,-91.0,19.0,19.0,19.0,31.0,0
1677,CC:2F:71:3F:1F:24,5386109,4507723921,2756763,4174870999,2629346,332852922,53,662249,452266558,658351,451796896,3898,469662,635453,594,2758733,254289,53,4803,130000.0,43333.0,-73.0,-65.0,-75.0,-67.0,-73.0,-65.0,-75.0,-67.0,-88.0,-91.0,-88.0,-91.0,15.0,26.0,13.0,24.0,0
1678,F8:59:71:5A:E0:3D,2656478,374479059,27130,41625935,2629348,332853124,0,3299,410879,3205,395414,94,15465,3116,0,27147,866,0,28,144444.0,39000.0,-67.0,-74.0,-66.0,-71.0,-68.0,-75.0,-67.0,-72.0,-88.0,-91.0,-88.0,-91.0,21.0,17.0,22.0,20.0,0
1679,CC:2F:71:3E:C5:1F,2634497,333482707,5149,629583,2629348,332853124,6,22110,1853675,18224,1393123,3886,460552,5433,30,7342,133,6,448,130000.0,39000.0,-69.0,-72.0,-69.0,-60.0,-70.0,-73.0,-69.0,-61.0,-88.0,-91.0,-88.0,-91.0,19.0,19.0,19.0,31.0,0
1680,CC:2F:71:3F:1F:24,5391277,4515830807,2761929,4182977683,2629348,332853124,53,662984,452357876,659086,451888214,3898,469662,636187,594,2764022,254592,53,4803,130000.0,43333.0,-73.0,-66.0,-75.0,-67.0,-73.0,-65.0,-74.0,-67.0,-88.0,-91.0,-88.0,-91.0,15.0,25.0,13.0,24.0,0
1681,F8:59:71:5A:E0:3D,2656485,374479725,27130,41625935,2629355,332853790,0,3299,410879,3205,395414,94,15465,3116,0,27147,866,0,28,144444.0,39000.0,-67.0,-74.0,-66.0,-71.0,-68.0,-75.0,-67.0,-72.0,-88.0,-91.0,-88.0,-91.0,21.0,17.0,22.0,20.0,0
1682,CC:2F:71:3E:C5:1F,2634506,333483575,5149,629583,2629357,332853992,6,22110,1853675,18224,1393123,3886,460552,5433,30,7342,133,6,448,130000.0,39000.0,-69.0,-72.0,-69.0,-60.0,-70.0,-73.0,-69.0,-61.0,-88.0,-91.0,-88.0,-91.0,19.0,19.0,19.0,31.0,0
1683,CC:2F:71:3F:1F:24,5396514,4524029523,2767157,4191175531,2629357,332853992,53,663441,452414768,659543,451945106,3898,469662,636641,594,2769250,256145,53,4804,130000.0,43333.0,-72.0,-65.0,-75.0,-67.0,-71.0,-65.0,-74.0,-67.0,-88.0,-91.0,-88.0,-91.0,16.0,26.0,13.0,24.0,0
1684,F8:59:71:5A:E0:3D,2656492,374480393,27130,41625935,2629362,332854458,0,3301,411067,3206,395484,95,15583,3117,0,27147,866,0,28,144444.0,39000.0,-68.0,-75.0,-66.0,-72.0,-68.0,-75.0,-67.0,-72.0,-88.0,-91.0,-88.0,-91.0,20.0,16.0,22.0,19.0,0
1685,CC:2F:71:3E:C5:1F,2634513,333484243,5149,629583,2629364,332854660,6,22110,1853675,18224,1393123,3886,460552,5433,30,7342,133,6,448,130000.0,39000.0,-69.0,-72.0,-69.0,-60.0,-70.0,-73.0,-69.0,-61.0,-88.0,-91.0,-88.0,-91.0,19.0,19.0,19.0,31.0,0
1686,CC:2F:71:3F:1F:24,5400708,4530595285,2771344,4197740625,2629364,332854660,53,663877,452468000,659979,451998338,3898,469662,637074,594,2773421,256903,53,4804,130000.0,43333.0,-72.0,-65.0,-75.0,-67.0,-72.0,-65.0,-75.0,-67.0,-88.0,-91.0,-88.0,-91.0,16.0,26.0,13.0,24.0,0
1687,F8:59:71:5A:E0:3D,2656497,374480857,27130,41625935,2629367,332854922,0,3301,411067,3206,395484,95,15583,3117,0,27147,866,0,28,144444.0,39000.0,-68.0,-75.0,-66.0,-72.0,-68.0,-75.0,-67.0,-72.0,-88.0,-91.0,-88.0,-91.0,20.0,16.0,22.0,19.0,0
1688,CC:2F:71:3E:C5:1F,2634520,333485222,5153,630300,2629367,332854922,6,22116,1854490,18230,1393938,3886,460552,5438,30,7346,133,6,448,144444.0,39000.0,-69.0,-72.0,-68.0,-60.0,-68.0,-71.0,-68.0,-59.0,-88.0,-91.0,-88.0,-91.0,19.0,19.0,20.0,31.0,0
1689,CC:2F:71:3F:1F:24,5405918,4538765225,2776551,4205910303,2629367,332854922,53,664423,452535192,660525,452065530,3898,469662,637620,594,2778644,257913,53,4804,117000.0,39000.0,-72.0,-66.0,-75.0,-68.0,-72.0,-65.0,-75.0,-67.0,-88.0,-91.0,-88.0,-91.0,16.0,25.0,13.0,23.0,0
1690,F8:59:71:5A:E0:3D,2656503,374481463,27130,41625935,2629373,332855528,0,3301,411067,3206,395484,95,15583,3117,0,27147,866,0,28,144444.0,39000.0,-68.0,-75.0,-66.0,-72.0,-68.0,-75.0,-67.0,-72.0,-88.0,-91.0,-88.0,-91.0,20.0,16.0,22.0,19.0,0
1691,CC:2F:71:3E:C5:1F,2634526,333485828,5153,630300,2629373,332855528,6,22116,1854490,18230,1393938,3886,460552,5438,30,7346,133,6,448,144444.0,39000.0,-69.0,-72.0,-68.0,-60.0,-68.0,-71.0,-68.0,-59.0,-88.0,-91.0,-88.0,-91.0,19.0,19.0,20.0,31.0,0
1692,CC:2F:71:3F:1F:24,5409953,4545078535,2780578,4212222805,2629375,332855730,53,664956,452600868,661058,452131206,3898,469662,638149,594,2782625,258232,53,4804,130000.0,43333.0,-72.0,-65.0,-75.0,-67.0,-72.0,-65.0,-75.0,-67.0,-88.0,-91.0,-88.0,-91.0,16.0,26.0,13.0,24.0,0
1693,F8:59:71:5A:E0:3D,2656510,374482281,27130,41625935,2629380,332856346,0,3301,411067,3206,395484,95,15583,3117,0,27147,866,0,28,144444.0,39000.0,-68.0,-75.0,-66.0,-72.0,-68.0,-75.0,-67.0,-72.0,-89.0,-91.0,-88.0,-91.0,21.0,16.0,22.0,19.0,0
1694,CC:2F:71:3E:C5:1F,2634537,333487050,5153,630300,2629384,332856750,6,22118,1854678,18231,1394008,3887,460670,5439,30,7346,133,6,448,144444.0,39000.0,-69.0,-72.0,-68.0,-60.0,-68.0,-71.0,-68.0,-59.0,-89.0,-91.0,-88.0,-91.0,20.0,19.0,20.0,31.0,0
1695,CC:2F:71:3F:1F:24,5415571,4553887405,2786187,4221030655,2629384,332856750,53,665701,452691802,661803,452222140,3898,469662,638886,594,2788268,259161,53,4804,130000.0,43333.0,-72.0,-65.0,-75.0,-67.0,-72.0,-65.0,-75.0,-67.0,-89.0,-91.0,-88.0,-91.0,17.0,26.0,13.0,24.0,0
1696,F8:59:71:5A:E0:3D,2656518,374483089,27130,41625935,2629388,332857154,0,3301,411067,3206,395484,95,15583,3117,0,27147,866,0,28,144444.0,39000.0,-68.0,-75.0,-66.0,-72.0,-68.0,-75.0,-67.0,-72.0,-89.0,-91.0,-88.0,-91.0,21.0,16.0,22.0,19.0,0
1697,CC:2F:71:3E:C5:1F,2634541,333487454,5153,630300,2629388,332857154,6,22118,1854678,18231,1394008,3887,460670,5439,30,7346,133,6,448,144444.0,39000.0,-69.0,-72.0,-68.0,-60.0,-68.0,-71.0,-68.0,-59.0,-89.0,-91.0,-88.0,-91.0,20.0,19.0,20.0,31.0,0
1698,CC:2F:71:3F:1F:24,5420255,4561228601,2790867,4228371447,2629388,332857154,53,666213,452755452,662315,452285790,3898,469662,639398,594,2792960,259769,53,4804,130000.0,43333.0,-72.0,-66.0,-76.0,-68.0,-72.0,-66.0,-75.0,-67.0,-89.0,-91.0,-88.0,-91.0,17.0,25.0,12.0,23.0,0
1699,F8:59:71:5A:E0:3D,2656525,374483755,27130,41625935,2629395,332857820,0,3301,411067,3206,395484,95,15583,3117,0,27147,866,0,28,144444.0,39000.0,-68.0,-75.0,-66.0,-72.0,-68.0,-75.0,-67.0,-72.0,-89.0,-91.0,-88.0,-91.0,21.0,16.0,22.0,19.0,0
1700,CC:2F:71:3E:C5:1F,2634548,333488120,5153,630300,2629395,332857820,6,22118,1854678,18231,1394008,3887,460670,5439,30,7346,133,6,448,144444.0,39000.0,-69.0,-72.0,-68.0,-60.0,-68.0,-71.0,-68.0,-59.0,-89.0,-91.0,-88.0,-91.0,20.0,19.0,20.0,31.0,0
1701,CC:2F:71:3F:1F:24,5425976,4570199863,2796581,4237342043,2629395,332857820,53,666896,452840638,662998,452370976,3898,469662,640072,594,2798673,260448,53,4807,130000.0,43333.0,-72.0,-65.0,-74.0,-67.0,-71.0,-65.0,-74.0,-67.0,-89.0,-91.0,-88.0,-91.0,17.0,26.0,14.0,24.0,0
1702,F8:59:71:5A:E0:3D,2656527,374483957,27130,41625935,2629397,332858022,0,3301,411067,3206,395484,95,15583,3117,0,27147,866,0,28,144444.0,39000.0,-68.0,-75.0,-66.0,-72.0,-68.0,-75.0,-67.0,-72.0,-89.0,-91.0,-88.0,-91.0,21.0,16.0,22.0,19.0,0
1703,CC:2F:71:3E:C5:1F,2634552,333488524,5153,630300,2629399,332858224,6,22118,1854678,18231,1394008,3887,460670,5439,30,7346,133,6,448,144444.0,39000.0,-69.0,-72.0,-68.0,-60.0,-68.0,-71.0,-68.0,-59.0,-89.0,-91.0,-88.0,-91.0,20.0,19.0,20.0,31.0,0
1704,CC:2F:71:3F:1F:24,5430473,4577245835,2801072,4244387409,2629401,332858426,53,667447,452911130,663549,452441468,3898,469662,640623,594,2803133,260846,53,4810,130000.0,43333.0,-75.0,-69.0,-78.0,-71.0,-74.0,-67.0,-77.0,-69.0,-89.0,-91.0,-88.0,-91.0,14.0,22.0,10.0,20.0,0
1705,F8:59:71:5A:E0:3D,2656536,374484825,27130,41625935,2629406,332858890,0,3301,411067,3206,395484,95,15583,3117,0,27147,866,0,28,144444.0,39000.0,-68.0,-75.0,-66.0,-72.0,-68.0,-75.0,-67.0,-72.0,-89.0,-91.0,-88.0,-91.0,21.0,16.0,22.0,19.0,0
1706,CC:2F:71:3E:C5:1F,2634560,333489250,5154,630360,2629406,332858890,6,22121,1854924,18234,1394254,3887,460670,5440,30,7347,133,6,449,144444.0,39000.0,-69.0,-72.0,-68.0,-60.0,-68.0,-70.0,-68.0,-59.0,-89.0,-91.0,-88.0,-91.0,20.0,19.0,20.0,31.0,0
1707,CC:2F:71:3F:1F:24,5434426,4583433091,2805020,4250574201,2629406,332858890,53,667931,452972606,664033,452502944,3898,469662,641107,594,2807113,261340,53,4811,130000.0,43333.0,-71.0,-65.0,-75.0,-67.0,-72.0,-65.0,-75.0,-67.0,-89.0,-91.0,-88.0,-91.0,18.0,26.0,13.0,24.0,0
1708,F8:59:71:5A:E0:3D,2656541,374485502,27130,41625935,2629411,332859567,0,3301,411067,3206,395484,95,15583,3117,0,27147,866,0,28,144444.0,39000.0,-68.0,-75.0,-66.0,-72.0,-68.0,-75.0,-67.0,-72.0,-89.0,-91.0,-88.0,-91.0,21.0,16.0,22.0,19.0,0
1709,CC:2F:71:3E:C5:1F,2634565,333489927,5154,630360,2629411,332859567,6,22121,1854924,18234,1394254,3887,460670,5440,30,7347,133,6,449,144444.0,39000.0,-69.0,-72.0,-68.0,-60.0,-68.0,-70.0,-68.0,-59.0,-89.0,-91.0,-88.0,-91.0,20.0,19.0,20.0,31.0,0
1710,CC:2F:71:3F:1F:24,5438092,4589166392,2808679,4256306623,2629413,332859769,53,668386,453029010,664488,452559348,3898,469662,641556,594,2810716,261713,53,4811,130000.0,43333.0,-72.0,-65.0,-75.0,-67.0,-71.0,-65.0,-75.0,-66.0,-89.0,-91.0,-88.0,-91.0,17.0,26.0,13.0,24.0,0
1711,F8:59:71:5A:E0:3D,2656545,374485906,27130,41625935,2629415,332859971,0,3301,411067,3206,395484,95,15583,3117,0,27147,866,0,28,144444.0,39000.0,-68.0,-75.0,-66.0,-72.0,-68.0,-75.0,-67.0,-72.0,-89.0,-91.0,-88.0,-91.0,21.0,16.0,22.0,19.0,0
1712,CC:2F:71:3E:C5:1F,2634569,333490331,5154,630360,2629415,332859971,6,22121,1854924,18234,1394254,3887,460670,5440,30,7347,133,6,449,144444.0,39000.0,-69.0,-72.0,-68.0,-60.0,-68.0,-70.0,-68.0,-59.0,-89.0,-91.0,-88.0,-91.0,20.0,19.0,20.0,31.0,0
1713,CC:2F:71:3F:1F:24,5443413,4597511842,2813997,4264651811,2629416,332860031,53,668962,453099666,665064,452630004,3898,469662,642118,594,2816090,262559,53,4811,117000.0,39000.0,-71.0,-65.0,-75.0,-67.0,-71.0,-65.0,-75.0,-67.0,-89.0,-91.0,-88.0,-91.0,18.0,26.0,13.0,24.0,0
1714,F8:59:71:5A:E0:3D,2656552,374486572,27130,41625935,2629422,332860637,0,3301,411067,3206,395484,95,15583,3117,0,27147,866,0,28,144444.0,39000.0,-68.0,-75.0,-66.0,-72.0,-68.0,-75.0,-67.0,-72.0,-89.0,-91.0,-88.0,-91.0,21.0,16.0,22.0,19.0,0
1715,CC:2F:71:3E:C5:1F,2634576,333490997,5154,630360,2629422,332860637,6,22121,1854924,18234,1394254,3887,460670,5440,30,7347,133,6,449,144444.0,39000.0,-69.0,-72.0,-68.0,-60.0,-68.0,-70.0,-68.0,-59.0,-89.0,-91.0,-88.0,-91.0,20.0,19.0,20.0,31.0,0
1716,CC:2F:71:3F:1F:24,5448222,4605046358,2818800,4272185721,2629422,332860637,53,669566,453173548,665668,452703886,3898,469662,642722,594,2820893,263207,53,4811,130000.0,43333.0,-71.0,-65.0,-74.0,-67.0,-71.0,-65.0,-74.0,-67.0,-89.0,-91.0,-88.0,-91.0,18.0,26.0,14.0,24.0,0
1717,F8:59:71:5A:E0:3D,2656554,374486774,27130,41625935,2629424,332860839,0,3301,411067,3206,395484,95,15583,3117,0,27147,866,0,28,144444.0,39000.0,-68.0,-75.0,-66.0,-72.0,-68.0,-75.0,-67.0,-72.0,-89.0,-91.0,-88.0,-91.0,21.0,16.0,22.0,19.0,0
1718,CC:2F:71:3E:C5:1F,2634578,333491199,5154,630360,2629424,332860839,6,22121,1854924,18234,1394254,3887,460670,5440,30,7347,133,6,449,144444.0,39000.0,-69.0,-72.0,-68.0,-60.0,-68.0,-70.0,-68.0,-59.0,-89.0,-91.0,-88.0,-91.0,20.0,19.0,20.0,31.0,0
1719,CC:2F:71:3F:1F:24,5453698,4613641604,2824271,4280780503,2629427,332861101,53,670305,453261582,666407,452791920,3898,469662,643461,594,2826284,263670,53,4811,130000.0,43333.0,-71.0,-65.0,-75.0,-67.0,-71.0,-65.0,-74.0,-66.0,-89.0,-91.0,-88.0,-91.0,18.0,26.0,13.0,24.0,0
1720,F8:59:71:5A:E0:3D,2656561,374487440,27130,41625935,2629431,332861505,0,3301,411067,3206,395484,95,15583,3117,0,27147,866,0,28,144444.0,39000.0,-68.0,-75.0,-66.0,-72.0,-68.0,-75.0,-67.0,-72.0,-89.0,-91.0,-88.0,-91.0,21.0,16.0,22.0,19.0,0
1721,CC:2F:71:3E:C5:1F,2634585,333491865,5154,630360,2629431,332861505,6,22121,1854924,18234,1394254,3887,460670,5440,30,7347,133,6,449,144444.0,39000.0,-69.0,-72.0,-68.0,-60.0,-68.0,-70.0,-68.0,-59.0,-89.0,-91.0,-88.0,-91.0,20.0,19.0,20.0,31.0,0
1722,CC:2F:71:3F:1F:24,5457823,4620095944,2828390,4287234237,2629433,332861707,53,670765,453319448,666867,452849786,3898,469662,643920,594,2830451,264089,53,4811,130000.0,43333.0,-73.0,-66.0,-75.0,-67.0,-72.0,-66.0,-75.0,-67.0,-89.0,-91.0,-88.0,-91.0,16.0,25.0,13.0,24.0,0
1723,F8:59:71:5A:E0:3D,2656563,374487642,27130,41625935,2629433,332861707,0,3301,411067,3206,395484,95,15583,3117,0,27147,866,0,28,144444.0,39000.0,-68.0,-75.0,-66.0,-72.0,-68.0,-75.0,-67.0,-72.0,-89.0,-91.0,-88.0,-91.0,21.0,16.0,22.0,19.0,0
1724,CC:2F:71:3E:C5:1F,2634589,333492269,5154,630360,2629435,332861909,6,22121,1854924,18234,1394254,3887,460670,5440,30,7347,133,6,449,144444.0,39000.0,-69.0,-72.0,-68.0,-60.0,-68.0,-70.0,-68.0,-59.0,-89.0,-91.0,-88.0,-91.0,20.0,19.0,20.0,31.0,0
1725,CC:2F:71:3F:1F:24,5463089,4628351320,2833652,4295489209,2629437,332862111,53,671429,453401328,667531,452931666,3898,469662,644583,594,2835694,264582,53,4811,130000.0,43333.0,-72.0,-65.0,-75.0,-67.0,-71.0,-65.0,-74.0,-67.0,-89.0,-91.0,-88.0,-91.0,17.0,26.0,13.0,24.0,0
1726,F8:59:71:5A:E0:3D,2656572,374488510,27130,41625935,2629442,332862575,0,3301,411067,3206,395484,95,15583,3117,0,27147,866,0,28,144444.0,39000.0,-68.0,-75.0,-66.0,-72.0,-68.0,-75.0,-67.0,-72.0,-89.0,-91.0,-88.0,-91.0,21.0,16.0,22.0,19.0,0
1727,CC:2F:71:3E:C5:1F,2634596,333492935,5154,630360,2629442,332862575,6,22121,1854924,18234,1394254,3887,460670,5440,30,7347,133,6,449,144444.0,39000.0,-69.0,-72.0,-68.0,-60.0,-68.0,-70.0,-68.0,-59.0,-89.0,-91.0,-88.0,-91.0,20.0,19.0,20.0,31.0,0
1728,CC:2F:71:3F:1F:24,5468083,4636177442,2838641,4303314867,2629442,332862575,53,672001,453471610,668103,453001948,3898,469662,645155,594,2840716,265128,53,4811,130000.0,43333.0,-72.0,-65.0,-75.0,-67.0,-71.0,-65.0,-75.0,-67.0,-89.0,-91.0,-88.0,-91.0,17.0,26.0,13.0,24.0,0
1729,F8:59:71:5A:E0:3D,2656576,374488914,27130,41625935,2629446,332862979,0,3301,411067,3206,395484,95,15583,3117,0,27147,866,0,28,144444.0,39000.0,-68.0,-75.0,-66.0,-72.0,-68.0,-75.0,-67.0,-72.0,-89.0,-91.0,-88.0,-91.0,21.0,16.0,22.0,19.0,0
1730,CC:2F:71:3E:C5:1F,2634600,333493339,5154,630360,2629446,332862979,6,22121,1854924,18234,1394254,3887,460670,5440,30,7347,133,6,449,144444.0,39000.0,-69.0,-72.0,-68.0,-60.0,-68.0,-70.0,-68.0,-59.0,-89.0,-91.0,-88.0,-91.0,20.0,19.0,20.0,31.0,0
1731,CC:2F:71:3F:1F:24,5473385,4644490946,2843939,4311627967,2629446,332862979,53,672552,453541122,668654,453071460,3898,469662,645706,594,2846032,265428,53,4811,130000.0,43333.0,-72.0,-65.0,-75.0,-67.0,-71.0,-65.0,-74.0,-66.0,-89.0,-91.0,-88.0,-91.0,17.0,26.0,13.0,24.0,0
1732,F8:59:71:5A:E0:3D,2656580,374489318,27130,41625935,2629450,332863383,0,3301,411067,3206,395484,95,15583,3117,0,27147,866,0,28,144444.0,39000.0,-68.0,-75.0,-66.0,-72.0,-68.0,-75.0,-67.0,-72.0,-89.0,-91.0,-88.0,-91.0,21.0,16.0,22.0,19.0,0
1733,CC:2F:71:3E:C5:1F,2634606,333493919,5155,630476,2629451,332863443,6,22122,1854994,18235,1394324,3887,460670,5440,30,7348,133,6,449,144444.0,39000.0,-66.0,-70.0,-64.0,-60.0,-68.0,-70.0,-67.0,-59.0,-89.0,-91.0,-88.0,-91.0,23.0,21.0,24.0,31.0,0
1734,CC:2F:71:3F:1F:24,5478765,4652926650,2849314,4320063207,2629451,332863443,53,673163,453617976,669265,453148314,3898,469662,646315,594,2851263,266059,53,4811,117000.0,39000.0,-72.0,-65.0,-75.0,-67.0,-71.0,-65.0,-74.0,-67.0,-89.0,-91.0,-88.0,-91.0,17.0,26.0,13.0,24.0,0
1735,F8:59:71:5A:E0:3D,2656588,374490100,27131,41626051,2629457,332864049,0,3303,411207,3208,395624,95,15583,3117,0,27148,866,0,28,144444.0,39000.0,-68.0,-75.0,-66.0,-72.0,-68.0,-74.0,-68.0,-71.0,-89.0,-91.0,-88.0,-91.0,21.0,16.0,22.0,19.0,0
1736,CC:2F:71:3E:C5:1F,2634612,333494525,5155,630476,2629457,332864049,6,22123,1855064,18236,1394394,3887,460670,5440,30,7348,133,6,449,144444.0,39000.0,-77.0,-84.0,-76.0,-72.0,-69.0,-72.0,-68.0,-61.0,-89.0,-91.0,-88.0,-91.0,12.0,7.0,12.0,19.0,0
1737,CC:2F:71:3F:1F:24,5483132,4659766002,2853675,4326901953,2629457,332864049,53,673543,453666434,669645,453196772,3898,469662,646695,594,2855673,266396,53,4811,130000.0,43333.0,-71.0,-65.0,-75.0,-67.0,-71.0,-65.0,-74.0,-67.0,-89.0,-91.0,-88.0,-91.0,18.0,26.0,13.0,24.0,0
1738,F8:59:71:5A:E0:3D,2656592,374490504,27131,41626051,2629461,332864453,0,3303,411207,3208,395624,95,15583,3117,0,27148,866,0,28,144444.0,39000.0,-68.0,-75.0,-66.0,-72.0,-68.0,-74.0,-68.0,-71.0,-89.0,-91.0,-88.0,-91.0,21.0,16.0,22.0,19.0,0
1739,CC:2F:71:3E:C5:1F,2634617,333494989,5155,630476,2629462,332864513,6,22123,1855064,18236,1394394,3887,460670,5440,30,7348,133,6,449,144444.0,39000.0,-77.0,-84.0,-76.0,-72.0,-69.0,-72.0,-68.0,-61.0,-89.0,-91.0,-88.0,-91.0,12.0,7.0,12.0,19.0,0
1740,CC:2F:71:3F:1F:24,5488956,4668903966,2859492,4336039251,2629464,332864715,53,674144,453742020,670246,453272358,3898,469662,647296,594,2861520,267853,53,4812,130000.0,43333.0,-73.0,-65.0,-74.0,-69.0,-72.0,-65.0,-73.0,-68.0,-89.0,-92.0,-88.0,-91.0,16.0,27.0,14.0,22.0,0
1741,F8:59:71:5A:E0:3D,2656600,374491443,27131,41626051,2629469,332865392,0,3303,411207,3208,395624,95,15583,3117,0,27148,866,0,28,144444.0,39000.0,-68.0,-75.0,-66.0,-72.0,-68.0,-74.0,-68.0,-71.0,-89.0,-92.0,-88.0,-91.0,21.0,17.0,22.0,19.0,0
1742,CC:2F:71:3E:C5:1F,2634624,333495868,5155,630476,2629469,332865392,6,22123,1855064,18236,1394394,3887,460670,5440,30,7348,133,6,449,144444.0,39000.0,-77.0,-84.0,-76.0,-72.0,-69.0,-72.0,-68.0,-61.0,-89.0,-92.0,-88.0,-91.0,12.0,8.0,12.0,19.0,0
1743,CC:2F:71:3F:1F:24,5494342,4677354397,2864873,4344489005,2629469,332865392,53,674885,453832796,670987,453363134,3898,469662,648037,594,2866830,268168,53,4812,117000.0,39000.0,-71.0,-65.0,-73.0,-66.0,-71.0,-65.0,-72.0,-66.0,-89.0,-92.0,-88.0,-91.0,18.0,27.0,15.0,25.0,0
1744,F8:59:71:5A:E0:3D,2656604,374491847,27131,41626051,2629473,332865796,0,3303,411207,3208,395624,95,15583,3117,0,27148,866,0,28,144444.0,39000.0,-68.0,-75.0,-66.0,-72.0,-68.0,-74.0,-68.0,-71.0,-89.0,-92.0,-88.0,-91.0,21.0,17.0,22.0,19.0,0
1745,CC:2F:71:3E:C5:1F,2634631,333496534,5155,630476,2629476,332866058,6,22123,1855064,18236,1394394,3887,460670,5440,30,7348,133,6,449,144444.0,39000.0,-77.0,-84.0,-76.0,-72.0,-69.0,-72.0,-68.0,-61.0,-89.0,-92.0,-88.0,-91.0,12.0,8.0,12.0,19.0,0
1746,CC:2F:71:3F:1F:24,5499787,4685891515,2870311,4353025457,2629476,332866058,53,675552,453916112,671654,453446450,3898,469662,648700,594,2872391,268554,53,4812,130000.0,43333.0,-73.0,-66.0,-74.0,-67.0,-72.0,-66.0,-74.0,-67.0,-89.0,-92.0,-88.0,-91.0,16.0,26.0,14.0,24.0,0
1747,F8:59:71:5A:E0:3D,2656609,374492311,27131,41626051,2629478,332866260,0,3303,411207,3208,395624,95,15583,3117,0,27148,866,0,28,144444.0,39000.0,-68.0,-75.0,-66.0,-72.0,-68.0,-74.0,-68.0,-71.0,-89.0,-92.0,-88.0,-91.0,21.0,17.0,22.0,19.0,0
1748,CC:2F:71:3E:C5:1F,2634635,333496938,5155,630476,2629480,332866462,6,22123,1855064,18236,1394394,3887,460670,5440,30,7348,133,6,449,144444.0,39000.0,-77.0,-84.0,-76.0,-72.0,-69.0,-72.0,-68.0,-61.0,-89.0,-92.0,-88.0,-91.0,12.0,8.0,12.0,19.0,0
1749,CC:2F:71:3F:1F:24,5505574,4694970269,2876094,4362103807,2629480,332866462,53,676390,454019400,672492,453549738,3898,469662,649538,594,2878122,268733,53,4812,130000.0,43333.0,-73.0,-66.0,-75.0,-68.0,-72.0,-65.0,-74.0,-67.0,-89.0,-92.0,-88.0,-91.0,16.0,26.0,13.0,23.0,0
1750,F8:59:71:5A:E0:3D,2656615,374492917,27131,41626051,2629484,332866866,0,3303,411207,3208,395624,95,15583,3117,0,27148,866,0,28,144444.0,39000.0,-68.0,-75.0,-66.0,-72.0,-68.0,-74.0,-68.0,-71.0,-89.0,-92.0,-88.0,-91.0,21.0,17.0,22.0,19.0,0
1751,CC:2F:71:3E:C5:1F,2634642,333497606,5155,630476,2629487,332867130,6,22124,1855182,18236,1394394,3888,460788,5441,30,7348,133,6,449,144444.0,39000.0,-69.0,-73.0,-68.0,-60.0,-69.0,-72.0,-68.0,-61.0,-89.0,-92.0,-88.0,-91.0,20.0,19.0,20.0,31.0,0
1752,CC:2F:71:3F:1F:24,5509357,4700881579,2879869,4368014389,2629488,332867190,53,676718,454062594,672820,453592932,3898,469662,649866,594,2881962,270055,53,4812,115556.0,28889.0,-72.0,-66.0,-72.0,-68.0,-71.0,-66.0,-72.0,-67.0,-89.0,-92.0,-88.0,-91.0,17.0,26.0,16.0,23.0,0
1753,F8:59:71:5A:E0:3D,2656623,374493645,27131,41626051,2629492,332867594,0,3303,411207,3208,395624,95,15583,3117,0,27148,866,0,28,144444.0,39000.0,-68.0,-75.0,-66.0,-72.0,-68.0,-74.0,-68.0,-71.0,-89.0,-92.0,-88.0,-91.0,21.0,17.0,22.0,19.0,0
1754,CC:2F:71:3E:C5:1F,2634649,333498272,5155,630476,2629494,332867796,6,22125,1855252,18237,1394464,3888,460788,5441,30,7348,133,6,449,144444.0,39000.0,-70.0,-72.0,-69.0,-60.0,-69.0,-72.0,-68.0,-61.0,-89.0,-92.0,-88.0,-91.0,19.0,20.0,19.0,31.0,0
1755,CC:2F:71:3F:1F:24,5513938,4708054103,2884444,4375186307,2629494,332867796,53,677360,454144480,673462,453674818,3898,469662,650508,594,2886510,270233,53,4813,86667.0,14444.0,-71.0,-66.0,-74.0,-69.0,-71.0,-65.0,-74.0,-68.0,-89.0,-92.0,-88.0,-91.0,18.0,26.0,14.0,22.0,0
1756,F8:59:71:5A:E0:3D,2656627,374494049,27131,41626051,2629496,332867998,0,3303,411207,3208,395624,95,15583,3117,0,27148,866,0,28,144444.0,39000.0,-68.0,-75.0,-66.0,-72.0,-68.0,-74.0,-68.0,-71.0,-89.0,-92.0,-88.0,-91.0,21.0,17.0,22.0,19.0,0
1757,CC:2F:71:3E:C5:1F,2634654,333498738,5155,630476,2629499,332868262,6,22125,1855252,18237,1394464,3888,460788,5441,30,7348,133,6,449,144444.0,39000.0,-70.0,-72.0,-69.0,-60.0,-69.0,-72.0,-68.0,-61.0,-89.0,-92.0,-88.0,-91.0,19.0,20.0,19.0,31.0,0
1758,CC:2F:71:3F:1F:24,5518742,4715579711,2889240,4382711187,2629502,332868524,53,678090,454233480,674191,453763700,3899,469780,651236,594,2891244,270854,53,4813,86667.0,14444.0,-70.0,-66.0,-74.0,-68.0,-70.0,-66.0,-73.0,-68.0,-89.0,-92.0,-88.0,-91.0,19.0,26.0,14.0,23.0,0
1759,F8:59:71:5A:E0:3D,2656636,374494839,27131,41626051,2629505,332868788,0,3307,411535,3211,395834,96,15701,3118,0,27149,866,0,29,144444.0,39000.0,-74.0,-80.0,-78.0,-74.0,-68.0,-74.0,-68.0,-71.0,-89.0,-92.0,-88.0,-91.0,15.0,12.0,10.0,17.0,0
1760,CC:2F:71:3E:C5:1F,2634660,333499264,5155,630476,2629505,332868788,6,22125,1855252,18237,1394464,3888,460788,5441,30,7348,133,6,449,144444.0,39000.0,-70.0,-72.0,-69.0,-60.0,-69.0,-72.0,-68.0,-61.0,-89.0,-92.0,-88.0,-91.0,19.0,20.0,19.0,31.0,0
1761,CC:2F:71:3F:1F:24,5522601,4721616037,2893094,4388747047,2629507,332868990,53,678559,454296194,674660,453826414,3899,469780,651689,594,2895112,271373,53,4813,86667.0,14444.0,-70.0,-66.0,-73.0,-68.0,-70.0,-65.0,-73.0,-68.0,-89.0,-92.0,-88.0,-91.0,19.0,26.0,15.0,23.0,0
1762,F8:59:71:5A:E0:3D,2656645,374495707,27131,41626051,2629514,332869656,0,3307,411535,3211,395834,96,15701,3118,0,27149,866,0,29,144444.0,39000.0,-74.0,-80.0,-78.0,-74.0,-68.0,-74.0,-68.0,-71.0,-89.0,-92.0,-88.0,-91.0,15.0,12.0,10.0,17.0,0
1763,CC:2F:71:3E:C5:1F,2634675,333500738,5155,630476,2629520,332870262,6,22125,1855252,18237,1394464,3888,460788,5441,30,7348,133,6,449,144444.0,39000.0,-70.0,-72.0,-69.0,-60.0,-69.0,-72.0,-68.0,-61.0,-89.0,-92.0,-88.0,-91.0,19.0,20.0,19.0,31.0,0
1764,CC:2F:71:3F:1F:24,5528486,4730829835,2898964,4397959371,2629522,332870464,53,679485,454411618,675586,453941838,3899,469780,652593,594,2900978,271868,53,4816,86667.0,14444.0,-71.0,-66.0,-73.0,-68.0,-70.0,-66.0,-73.0,-68.0,-89.0,-92.0,-88.0,-91.0,18.0,26.0,15.0,23.0,0
1765,F8:59:71:5A:E0:3D,2656661,374497454,27131,41626051,2629530,332871403,0,3307,411535,3211,395834,96,15701,3118,0,27149,866,0,29,144444.0,39000.0,-74.0,-80.0,-78.0,-74.0,-68.0,-74.0,-68.0,-71.0,-89.0,-92.0,-88.0,-91.0,15.0,12.0,10.0,17.0,0
1766,CC:2F:71:3E:C5:1F,2634687,333502081,5155,630476,2629532,332871605,6,22125,1855252,18237,1394464,3888,460788,5441,30,7348,133,6,449,144444.0,39000.0,-70.0,-72.0,-69.0,-60.0,-69.0,-72.0,-68.0,-61.0,-89.0,-92.0,-89.0,-92.0,19.0,20.0,20.0,32.0,0
1767,CC:2F:71:3F:1F:24,5533677,4738957436,2904143,4406085629,2629534,332871807,53,680320,454515238,676421,454045458,3899,469780,653364,594,2906236,272096,53,4816,86667.0,14444.0,-70.0,-65.0,-73.0,-68.0,-70.0,-65.0,-73.0,-68.0,-89.0,-92.0,-89.0,-92.0,19.0,27.0,16.0,24.0,0
1768,F8:59:71:5A:E0:3D,2656670,374498322,27131,41626051,2629539,332872271,0,3307,411535,3211,395834,96,15701,3118,0,27149,866,0,29,144444.0,39000.0,-74.0,-80.0,-78.0,-74.0,-68.0,-74.0,-68.0,-71.0,-89.0,-92.0,-89.0,-92.0,15.0,12.0,11.0,18.0,0
1769,CC:2F:71:3E:C5:1F,2634696,333502949,5155,630476,2629541,332872473,6,22125,1855252,18237,1394464,3888,460788,5441,30,7348,133,6,449,144444.0,39000.0,-70.0,-72.0,-69.0,-60.0,-69.0,-72.0,-68.0,-61.0,-89.0,-92.0,-89.0,-92.0,19.0,20.0,20.0,32.0,0
1770,CC:2F:71:3F:1F:24,5537101,4744304688,2907560,4411432215,2629541,332872473,53,680977,454596153,677078,454126373,3899,469780,654015,594,2909623,272151,53,4817,65000.0,13000.0,-70.0,-66.0,-73.0,-69.0,-72.0,-69.0,-75.0,-70.0,-89.0,-92.0,-89.0,-92.0,19.0,26.0,16.0,23.0,0
1771,F8:59:71:5A:E0:3D,2656676,374498928,27131,41626051,2629545,332872877,0,3307,411535,3211,395834,96,15701,3118,0,27149,866,0,29,144444.0,39000.0,-74.0,-80.0,-78.0,-74.0,-68.0,-74.0,-68.0,-71.0,-89.0,-92.0,-89.0,-92.0,15.0,12.0,11.0,18.0,0
1772,CC:2F:71:3E:C5:1F,2634700,333503353,5155,630476,2629545,332872877,6,22125,1855252,18237,1394464,3888,460788,5441,30,7348,133,6,449,144444.0,39000.0,-70.0,-72.0,-69.0,-60.0,-69.0,-72.0,-68.0,-61.0,-89.0,-92.0,-89.0,-92.0,19.0,20.0,20.0,32.0,0
1773,CC:2F:71:3F:1F:24,5540838,4750151044,2911291,4417277965,2629547,332873079,53,681649,454678727,677750,454208947,3899,469780,654687,594,2913360,272534,53,4818,86667.0,14444.0,-70.0,-66.0,-74.0,-68.0,-70.0,-65.0,-74.0,-68.0,-89.0,-92.0,-89.0,-92.0,19.0,26.0,15.0,24.0,0
1774,F8:59:71:5A:E0:3D,2656681,374499392,27131,41626051,2629550,332873341,0,3307,411535,3211,395834,96,15701,3118,0,27149,866,0,29,144444.0,39000.0,-74.0,-80.0,-78.0,-74.0,-68.0,-74.0,-68.0,-71.0,-89.0,-92.0,-89.0,-92.0,15.0,12.0,11.0,18.0,0
1775,CC:2F:71:3E:C5:1F,2634705,333503817,5155,630476,2629550,332873341,6,22125,1855252,18237,1394464,3888,460788,5441,30,7348,133,6,449,144444.0,39000.0,-70.0,-72.0,-69.0,-60.0,-69.0,-72.0,-68.0,-61.0,-89.0,-92.0,-89.0,-92.0,19.0,20.0,20.0,32.0,0
1776,CC:2F:71:3F:1F:24,5544780,4756322606,2915228,4423449063,2629552,332873543,53,682619,454795999,678720,454326219,3899,469780,655650,594,2917235,272621,53,4820,86667.0,14444.0,-70.0,-65.0,-73.0,-67.0,-69.0,-65.0,-72.0,-67.0,-89.0,-92.0,-89.0,-92.0,19.0,27.0,16.0,25.0,0
1777,F8:59:71:5A:E0:3D,2656687,374499998,27131,41626051,2629556,332873947,0,3307,411535,3211,395834,96,15701,3118,0,27149,866,0,29,144444.0,39000.0,-74.0,-80.0,-78.0,-74.0,-68.0,-74.0,-68.0,-71.0,-89.0,-92.0,-89.0,-92.0,15.0,12.0,11.0,18.0,0
1778,CC:2F:71:3E:C5:1F,2634711,333504423,5155,630476,2629556,332873947,6,22125,1855252,18237,1394464,3888,460788,5441,30,7348,133,6,449,144444.0,39000.0,-70.0,-72.0,-69.0,-60.0,-69.0,-72.0,-68.0,-61.0,-89.0,-92.0,-89.0,-92.0,19.0,20.0,20.0,32.0,0
1779,CC:2F:71:3F:1F:24,5548967,4762880864,2919411,4430006917,2629556,332873947,53,683668,454921171,679769,454451391,3899,469780,656699,594,2921495,273004,53,4820,86667.0,14444.0,-70.0,-66.0,-73.0,-68.0,-69.0,-65.0,-72.0,-67.0,-89.0,-92.0,-89.0,-92.0,19.0,26.0,16.0,24.0,0
1780,F8:59:71:5A:E0:3D,2656696,374501032,27131,41626051,2629565,332874981,0,3307,411535,3211,395834,96,15701,3118,0,27149,866,0,29,144444.0,39000.0,-74.0,-80.0,-78.0,-74.0,-68.0,-74.0,-68.0,-71.0,-89.0,-92.0,-89.0,-92.0,15.0,12.0,11.0,18.0,0
1781,CC:2F:71:3E:C5:1F,2634720,333505457,5155,630476,2629565,332874981,6,22125,1855252,18237,1394464,3888,460788,5441,30,7348,133,6,449,144444.0,39000.0,-70.0,-72.0,-69.0,-60.0,-69.0,-72.0,-68.0,-61.0,-89.0,-92.0,-89.0,-92.0,19.0,20.0,20.0,32.0,0
1782,CC:2F:71:3F:1F:24,5554139,4770985838,2924572,4438110655,2629567,332875183,53,684630,455040729,680731,454570949,3899,469780,657659,594,2926620,273116,53,4821,86667.0,14444.0,-70.0,-65.0,-73.0,-68.0,-70.0,-65.0,-73.0,-68.0,-89.0,-92.0,-89.0,-92.0,19.0,27.0,16.0,24.0,0
1783,F8:59:71:5A:E0:3D,2656700,374501436,27131,41626051,2629569,332875385,0,3307,411535,3211,395834,96,15701,3118,0,27149,866,0,29,144444.0,39000.0,-74.0,-80.0,-78.0,-74.0,-68.0,-74.0,-68.0,-71.0,-89.0,-92.0,-89.0,-92.0,15.0,12.0,11.0,18.0,0
1784,CC:2F:71:3E:C5:1F,2634724,333505861,5155,630476,2629569,332875385,6,22125,1855252,18237,1394464,3888,460788,5441,30,7348,133,6,449,144444.0,39000.0,-70.0,-72.0,-69.0,-60.0,-69.0,-72.0,-68.0,-61.0,-89.0,-92.0,-89.0,-92.0,19.0,20.0,20.0,32.0,0
1785,CC:2F:71:3F:1F:24,5557198,4775766992,2927627,4442891405,2629571,332875587,53,685195,455111953,681296,454642173,3899,469780,658220,594,2929719,273751,53,4821,86667.0,14444.0,-70.0,-65.0,-73.0,-67.0,-69.0,-65.0,-72.0,-67.0,-89.0,-92.0,-89.0,-92.0,19.0,27.0,16.0,25.0,0
1786,F8:59:71:5A:E0:3D,2656708,374502218,27132,41626167,2629576,332876051,0,3309,411675,3213,395974,96,15701,3118,0,27150,866,0,29,144444.0,39000.0,-75.0,-80.0,-79.0,-74.0,-70.0,-75.0,-71.0,-72.0,-89.0,-92.0,-89.0,-92.0,14.0,12.0,10.0,18.0,0
1787,CC:2F:71:3E:C5:1F,2634732,333506643,5156,630592,2629576,332876051,6,22127,1855392,18239,1394604,3888,460788,5441,30,7349,133,6,449,144444.0,39000.0,-66.0,-70.0,-64.0,-60.0,-68.0,-71.0,-67.0,-61.0,-89.0,-92.0,-89.0,-92.0,23.0,22.0,25.0,32.0,0
1788,CC:2F:71:3F:1F:24,5560813,4781420046,2931237,4448543995,2629576,332876051,53,685771,455182751,681872,454712971,3899,469780,658795,594,2933330,273844,53,4821,86667.0,14444.0,-70.0,-65.0,-73.0,-67.0,-69.0,-65.0,-72.0,-67.0,-89.0,-92.0,-89.0,-92.0,19.0,27.0,16.0,25.0,0
1789,F8:59:71:5A:E0:3D,2656712,374502622,27132,41626167,2629580,332876455,0,3309,411675,3213,395974,96,15701,3118,0,27150,866,0,29,144444.0,39000.0,-75.0,-80.0,-79.0,-74.0,-70.0,-75.0,-71.0,-72.0,-89.0,-92.0,-89.0,-92.0,14.0,12.0,10.0,18.0,0
1790,CC:2F:71:3E:C5:1F,2634738,333507249,5156,630592,2629582,332876657,6,22127,1855392,18239,1394604,3888,460788,5441,30,7349,133,6,449,144444.0,39000.0,-66.0,-70.0,-64.0,-60.0,-68.0,-71.0,-67.0,-61.0,-89.0,-92.0,-89.0,-92.0,23.0,22.0,25.0,32.0,0
1791,CC:2F:71:3F:1F:24,5565456,4788695974,2935874,4455819317,2629582,332876657,53,686630,455287773,682731,454817993,3899,469780,659648,594,2937927,274219,53,4821,86667.0,14444.0,-70.0,-65.0,-73.0,-68.0,-69.0,-65.0,-72.0,-68.0,-89.0,-92.0,-89.0,-92.0,19.0,27.0,16.0,24.0,0
1792,F8:59:71:5A:E0:3D,2656717,374503086,27132,41626167,2629585,332876919,0,3309,411675,3213,395974,96,15701,3118,0,27150,866,0,29,144444.0,39000.0,-75.0,-80.0,-79.0,-74.0,-70.0,-75.0,-71.0,-72.0,-89.0,-92.0,-89.0,-92.0,14.0,12.0,10.0,18.0,0
1793,CC:2F:71:3E:C5:1F,2634743,333507713,5156,630592,2629587,332877121,6,22127,1855392,18239,1394604,3888,460788,5441,30,7349,133,6,449,144444.0,39000.0,-66.0,-70.0,-64.0,-60.0,-68.0,-71.0,-67.0,-61.0,-89.0,-92.0,-89.0,-92.0,23.0,22.0,25.0,32.0,0
1794,CC:2F:71:3F:1F:24,5569277,4794676542,2939690,4461799421,2629587,332877121,53,687498,455392167,683599,454922387,3899,469780,660516,594,2941741,274420,53,4821,86667.0,14444.0,-70.0,-65.0,-73.0,-67.0,-69.0,-65.0,-72.0,-67.0,-89.0,-92.0,-89.0,-92.0,19.0,27.0,16.0,25.0,0
1795,F8:59:71:5A:E0:3D,2656724,374503965,27132,41626167,2629592,332877798,0,3309,411675,3213,395974,96,15701,3118,0,27150,866,0,29,144444.0,39000.0,-75.0,-80.0,-79.0,-74.0,-70.0,-75.0,-71.0,-72.0,-89.0,-92.0,-89.0,-92.0,14.0,12.0,10.0,18.0,0
1796,CC:2F:71:3E:C5:1F,2634748,333508390,5156,630592,2629592,332877798,6,22127,1855392,18239,1394604,3888,460788,5441,30,7349,133,6,449,144444.0,39000.0,-66.0,-70.0,-64.0,-60.0,-68.0,-71.0,-67.0,-61.0,-89.0,-92.0,-89.0,-92.0,23.0,22.0,25.0,32.0,0
1797,CC:2F:71:3F:1F:24,5574577,4802983838,2944983,4470105838,2629594,332878000,53,688276,455488800,684377,455019020,3899,469780,661294,594,2947007,275796,53,4821,86667.0,14444.0,-70.0,-66.0,-74.0,-67.0,-69.0,-66.0,-73.0,-67.0,-89.0,-92.0,-89.0,-92.0,19.0,26.0,15.0,25.0,0
1798,F8:59:71:5A:E0:3D,2656733,374504833,27132,41626167,2629601,332878666,0,3309,411675,3213,395974,96,15701,3118,0,27150,866,0,29,144444.0,39000.0,-75.0,-80.0,-79.0,-74.0,-70.0,-75.0,-71.0,-72.0,-89.0,-92.0,-89.0,-92.0,14.0,12.0,10.0,18.0,0
1799,CC:2F:71:3E:C5:1F,2634757,333509258,5156,630592,2629601,332878666,6,22127,1855392,18239,1394604,3888,460788,5441,30,7349,133,6,449,144444.0,39000.0,-66.0,-70.0,-64.0,-60.0,-68.0,-71.0,-67.0,-61.0,-89.0,-92.0,-89.0,-92.0,23.0,22.0,25.0,32.0,0
1800,CC:2F:71:3F:1F:24,5581592,4813990770,2951988,4481111840,2629604,332878930,53,689520,455640204,685621,455170424,3899,469780,662527,594,2953962,275972,53,4821,104000.0,26000.0,-70.0,-65.0,-73.0,-67.0,-70.0,-65.0,-73.0,-67.0,-90.0,-93.0,-89.0,-92.0,20.0,28.0,16.0,25.0,0
1801,F8:59:71:5A:E0:3D,2656738,374505299,27132,41626167,2629606,332879132,0,3311,411863,3214,396044,97,15819,3119,0,27150,866,0,30,144444.0,39000.0,-67.0,-72.0,-66.0,-71.0,-70.0,-76.0,-70.0,-73.0,-90.0,-93.0,-89.0,-92.0,23.0,21.0,23.0,21.0,0
1802,CC:2F:71:3E:C5:1F,2634765,333509986,5156,630592,2629609,332879394,6,22127,1855392,18239,1394604,3888,460788,5441,30,7349,133,6,449,144444.0,39000.0,-66.0,-70.0,-64.0,-60.0,-68.0,-71.0,-67.0,-61.0,-90.0,-93.0,-89.0,-92.0,24.0,23.0,25.0,32.0,0
1803,CC:2F:71:3F:1F:24,5584480,4818495494,2954869,4485615898,2629611,332879596,53,689845,455682646,685946,455212866,3899,469780,662851,594,2956925,276227,53,4822,130000.0,43333.0,-70.0,-66.0,-73.0,-67.0,-70.0,-65.0,-73.0,-67.0,-90.0,-93.0,-89.0,-92.0,20.0,27.0,16.0,25.0,0
1804,F8:59:71:5A:E0:3D,2656745,374505965,27132,41626167,2629613,332879798,0,3311,411863,3214,396044,97,15819,3119,0,27150,866,0,30,144444.0,39000.0,-67.0,-72.0,-66.0,-71.0,-70.0,-76.0,-70.0,-73.0,-90.0,-93.0,-89.0,-92.0,23.0,21.0,23.0,21.0,0
1805,CC:2F:71:3E:C5:1F,2634769,333510390,5156,630592,2629613,332879798,6,22127,1855392,18239,1394604,3888,460788,5441,30,7349,133,6,449,144444.0,39000.0,-66.0,-70.0,-64.0,-60.0,-68.0,-71.0,-67.0,-61.0,-90.0,-93.0,-89.0,-92.0,24.0,23.0,25.0,32.0,0
1806,CC:2F:71:3F:1F:24,5589008,4825592386,2959393,4492712386,2629615,332880000,53,690473,455759072,686574,455289292,3899,469780,663479,594,2961486,276672,53,4822,130000.0,43333.0,-70.0,-65.0,-73.0,-67.0,-70.0,-65.0,-73.0,-67.0,-90.0,-93.0,-89.0,-92.0,20.0,28.0,16.0,25.0,0
1807,F8:59:71:5A:E0:3D,2656773,374517419,27132,41626167,2629641,332891252,0,3311,411863,3214,396044,97,15819,3119,0,27150,866,0,30,144444.0,39000.0,-67.0,-72.0,-66.0,-71.0,-70.0,-76.0,-70.0,-73.0,-90.0,-93.0,-89.0,-92.0,23.0,21.0,23.0,21.0,0
1808,CC:2F:71:3E:C5:1F,2634797,333521844,5156,630592,2629641,332891252,6,22127,1855392,18239,1394604,3888,460788,5441,30,7349,133,6,449,144444.0,39000.0,-66.0,-70.0,-64.0,-60.0,-68.0,-71.0,-67.0,-61.0,-90.0,-93.0,-89.0,-92.0,24.0,23.0,25.0,32.0,0
1809,CC:2F:71:3F:1F:24,5593663,4832863244,2964018,4499971668,2629645,332891576,53,691106,455837890,687206,455367992,3900,469898,664112,594,2966087,276788,53,4822,130000.0,43333.0,-71.0,-65.0,-73.0,-67.0,-70.0,-65.0,-73.0,-67.0,-90.0,-93.0,-89.0,-92.0,19.0,28.0,16.0,25.0,0
1810,F8:59:71:5A:E0:3D,2656779,374517945,27132,41626167,2629647,332891778,0,3311,411863,3214,396044,97,15819,3119,0,27150,866,0,30,144444.0,39000.0,-67.0,-72.0,-66.0,-71.0,-70.0,-76.0,-70.0,-73.0,-90.0,-93.0,-89.0,-92.0,23.0,21.0,23.0,21.0,0
1811,CC:2F:71:3E:C5:1F,2634803,333522370,5156,630592,2629647,332891778,6,22129,1855532,18241,1394744,3888,460788,5441,30,7350,133,6,449,144444.0,39000.0,-69.0,-72.0,-68.0,-60.0,-69.0,-72.0,-67.0,-61.0,-90.0,-93.0,-89.0,-92.0,21.0,21.0,21.0,32.0,0
1812,CC:2F:71:3F:1F:24,5598182,4839949568,2968535,4507057790,2629647,332891778,53,691773,455918456,687873,455448558,3900,469898,664779,594,2970621,277114,53,4822,130000.0,43333.0,-71.0,-65.0,-73.0,-67.0,-70.0,-65.0,-73.0,-67.0,-90.0,-93.0,-89.0,-92.0,19.0,28.0,16.0,25.0,0
1813,F8:59:71:5A:E0:3D,2656784,374518411,27132,41626167,2629652,332892244,0,3311,411863,3214,396044,97,15819,3119,0,27150,866,0,30,144444.0,39000.0,-67.0,-72.0,-66.0,-71.0,-70.0,-76.0,-70.0,-73.0,-90.0,-93.0,-89.0,-92.0,23.0,21.0,23.0,21.0,0
1814,CC:2F:71:3E:C5:1F,2634808,333522836,5156,630592,2629652,332892244,6,22131,1855720,18242,1394814,3889,460906,5442,30,7350,133,6,449,144444.0,39000.0,-69.0,-72.0,-68.0,-60.0,-68.0,-71.0,-67.0,-60.0,-90.0,-93.0,-89.0,-92.0,21.0,21.0,21.0,32.0,0
1815,CC:2F:71:3F:1F:24,5602540,4846777364,2972888,4513885120,2629652,332892244,53,692303,455986246,688403,455516348,3900,469898,665309,594,2974969,277352,53,4822,130000.0,43333.0,-70.0,-65.0,-73.0,-67.0,-70.0,-65.0,-73.0,-67.0,-90.0,-93.0,-89.0,-92.0,20.0,28.0,16.0,25.0,0
1816,F8:59:71:5A:E0:3D,2656789,374518875,27132,41626167,2629657,332892708,0,3311,411863,3214,396044,97,15819,3119,0,27150,866,0,30,144444.0,39000.0,-67.0,-72.0,-66.0,-71.0,-70.0,-76.0,-70.0,-73.0,-90.0,-93.0,-89.0,-92.0,23.0,21.0,23.0,21.0,0
1817,CC:2F:71:3E:C5:1F,2634814,333523434,5156,630592,2629658,332892842,6,22131,1855720,18242,1394814,3889,460906,5442,30,7350,133,6,449,144444.0,39000.0,-69.0,-72.0,-68.0,-60.0,-68.0,-71.0,-67.0,-60.0,-90.0,-93.0,-89.0,-92.0,21.0,21.0,21.0,32.0,0
1818,CC:2F:71:3F:1F:24,5607675,4854821582,2978016,4521928672,2629659,332892910,53,692859,456056738,688959,455586840,3900,469898,665865,594,2980108,277990,53,4822,130000.0,43333.0,-71.0,-65.0,-75.0,-67.0,-71.0,-65.0,-74.0,-67.0,-90.0,-93.0,-89.0,-92.0,19.0,28.0,14.0,25.0,0
1819,F8:59:71:5A:E0:3D,2656795,374519481,27132,41626167,2629663,332893314,0,3311,411863,3214,396044,97,15819,3119,0,27150,866,0,30,144444.0,39000.0,-67.0,-72.0,-66.0,-71.0,-70.0,-76.0,-70.0,-73.0,-90.0,-93.0,-89.0,-93.0,23.0,21.0,23.0,22.0,0
1820,CC:2F:71:3E:C5:1F,2634819,333523906,5156,630592,2629663,332893314,6,22131,1855720,18242,1394814,3889,460906,5442,30,7350,133,6,449,144444.0,39000.0,-69.0,-72.0,-68.0,-60.0,-68.0,-71.0,-67.0,-60.0,-90.0,-93.0,-89.0,-93.0,21.0,21.0,21.0,33.0,0
1821,CC:2F:71:3F:1F:24,5612005,4861606326,2982342,4528713012,2629663,332893314,53,693359,456117818,689459,455647920,3900,469898,666365,594,2984387,278604,53,4822,130000.0,43333.0,-71.0,-65.0,-75.0,-67.0,-71.0,-65.0,-74.0,-67.0,-90.0,-93.0,-89.0,-93.0,19.0,28.0,14.0,26.0,0
1822,F8:59:71:5A:E0:3D,2656800,374519945,27132,41626167,2629668,332893778,0,3311,411863,3214,396044,97,15819,3119,0,27150,866,0,30,144444.0,39000.0,-67.0,-72.0,-66.0,-71.0,-70.0,-76.0,-70.0,-73.0,-90.0,-93.0,-89.0,-93.0,23.0,21.0,23.0,22.0,0
1823,CC:2F:71:3E:C5:1F,2634824,333524370,5156,630592,2629668,332893778,6,22131,1855720,18242,1394814,3889,460906,5442,30,7350,133,6,449,144444.0,39000.0,-69.0,-72.0,-68.0,-60.0,-68.0,-71.0,-67.0,-60.0,-90.0,-93.0,-89.0,-93.0,21.0,21.0,21.0,33.0,0
1824,CC:2F:71:3F:1F:24,5617065,4869535202,2987395,4536641222,2629670,332893980,53,693868,456182072,689968,455712174,3900,469898,666867,594,2989438,278933,53,4822,117000.0,39000.0,-71.0,-65.0,-74.0,-67.0,-70.0,-65.0,-74.0,-67.0,-90.0,-93.0,-89.0,-93.0,19.0,28.0,15.0,26.0,0
1825,F8:59:71:5A:E0:3D,2656805,374520622,27132,41626167,2629673,332894455,0,3311,411863,3214,396044,97,15819,3119,0,27150,866,0,30,144444.0,39000.0,-67.0,-72.0,-66.0,-71.0,-70.0,-76.0,-70.0,-73.0,-90.0,-93.0,-89.0,-93.0,23.0,21.0,23.0,22.0,0
1826,CC:2F:71:3E:C5:1F,2634829,333525047,5156,630592,2629673,332894455,6,22131,1855720,18242,1394814,3889,460906,5442,30,7350,133,6,449,144444.0,39000.0,-69.0,-72.0,-68.0,-60.0,-68.0,-71.0,-67.0,-60.0,-90.0,-93.0,-89.0,-93.0,21.0,21.0,21.0,33.0,0
1827,CC:2F:71:3F:1F:24,5621844,4877023147,2992169,4544128490,2629675,332894657,53,694357,456245008,690457,455775110,3900,469898,667352,594,2994262,279090,53,4822,130000.0,43333.0,-71.0,-65.0,-73.0,-67.0,-70.0,-65.0,-73.0,-67.0,-90.0,-93.0,-89.0,-93.0,19.0,28.0,16.0,26.0,0
1828,F8:59:71:5A:E0:3D,2656809,374521026,27132,41626167,2629677,332894859,0,3311,411863,3214,396044,97,15819,3119,0,27150,866,0,30,144444.0,39000.0,-67.0,-72.0,-66.0,-71.0,-70.0,-76.0,-70.0,-73.0,-90.0,-93.0,-89.0,-93.0,23.0,21.0,23.0,22.0,0
1829,CC:2F:71:3E:C5:1F,2634836,333525713,5156,630592,2629680,332895121,6,22131,1855720,18242,1394814,3889,460906,5442,30,7350,133,6,449,144444.0,39000.0,-69.0,-72.0,-68.0,-60.0,-68.0,-71.0,-67.0,-60.0,-90.0,-93.0,-89.0,-93.0,21.0,21.0,21.0,33.0,0
1830,CC:2F:71:3F:1F:24,5627488,4885874809,2997808,4552979688,2629680,332895121,53,694885,456311604,690985,455841706,3900,469898,667880,594,2999901,279325,53,4822,130000.0,43333.0,-70.0,-65.0,-73.0,-67.0,-70.0,-65.0,-72.0,-67.0,-90.0,-93.0,-89.0,-93.0,20.0,28.0,16.0,26.0,0
1831,F8:59:71:5A:E0:3D,2656816,374521692,27132,41626167,2629684,332895525,0,3311,411863,3214,396044,97,15819,3119,0,27150,866,0,30,144444.0,39000.0,-67.0,-72.0,-66.0,-71.0,-70.0,-76.0,-70.0,-73.0,-90.0,-93.0,-90.0,-93.0,23.0,21.0,24.0,22.0,0
1832,CC:2F:71:3E:C5:1F,2634840,333526117,5156,630592,2629684,332895525,6,22131,1855720,18242,1394814,3889,460906,5442,30,7350,133,6,449,144444.0,39000.0,-69.0,-72.0,-68.0,-60.0,-68.0,-71.0,-67.0,-60.0,-90.0,-93.0,-90.0,-93.0,21.0,21.0,22.0,33.0,0
1833,CC:2F:71:3F:1F:24,5632131,4893151667,3002447,4560256142,2629684,332895525,53,695398,456374602,691498,455904704,3900,469898,668390,594,3004540,279782,53,4822,130000.0,43333.0,-70.0,-65.0,-73.0,-67.0,-70.0,-65.0,-73.0,-66.0,-90.0,-93.0,-90.0,-93.0,20.0,28.0,17.0,26.0,0
1834,F8:59:71:5A:E0:3D,2656820,374522096,27132,41626167,2629688,332895929,0,3311,411863,3214,396044,97,15819,3119,0,27150,866,0,30,144444.0,39000.0,-67.0,-72.0,-66.0,-71.0,-70.0,-76.0,-70.0,-73.0,-90.0,-93.0,-90.0,-93.0,23.0,21.0,24.0,22.0,0
1835,CC:2F:71:3E:C5:1F,2634844,333526521,5156,630592,2629688,332895929,6,22131,1855720,18242,1394814,3889,460906,5442,30,7350,133,6,449,144444.0,39000.0,-69.0,-72.0,-68.0,-60.0,-68.0,-71.0,-67.0,-60.0,-90.0,-93.0,-90.0,-93.0,21.0,21.0,22.0,33.0,0
1836,CC:2F:71:3F:1F:24,5638266,4902781035,3008576,4569884904,2629690,332896131,53,696197,456470468,692297,456000570,3900,469898,669189,594,3010600,280102,53,4822,130000.0,43333.0,-70.0,-65.0,-73.0,-67.0,-69.0,-65.0,-72.0,-66.0,-90.0,-93.0,-90.0,-93.0,20.0,28.0,17.0,26.0,0
1837,F8:59:71:5A:E0:3D,2656825,374522560,27132,41626167,2629693,332896393,0,3311,411863,3214,396044,97,15819,3119,0,27150,866,0,30,144444.0,39000.0,-67.0,-72.0,-66.0,-71.0,-70.0,-76.0,-70.0,-73.0,-90.0,-93.0,-90.0,-93.0,23.0,21.0,24.0,22.0,0
1838,CC:2F:71:3E:C5:1F,2634851,333527187,5156,630592,2629695,332896595,6,22131,1855720,18242,1394814,3889,460906,5442,30,7350,133,6,449,144444.0,39000.0,-69.0,-72.0,-68.0,-60.0,-68.0,-71.0,-67.0,-60.0,-90.0,-93.0,-90.0,-93.0,21.0,21.0,22.0,33.0,0
1839,CC:2F:71:3F:1F:24,5642895,4910033859,3013200,4577137264,2629695,332896595,53,696708,456533894,692808,456063996,3900,469898,669699,594,3015293,280428,53,4822,130000.0,43333.0,-70.0,-65.0,-73.0,-67.0,-70.0,-65.0,-73.0,-67.0,-90.0,-93.0,-90.0,-93.0,20.0,28.0,17.0,26.0,0
1840,F8:59:71:5A:E0:3D,2656831,374523166,27132,41626167,2629699,332896999,0,3311,411863,3214,396044,97,15819,3119,0,27150,866,0,30,144444.0,39000.0,-67.0,-72.0,-66.0,-71.0,-70.0,-76.0,-70.0,-73.0,-90.0,-93.0,-90.0,-93.0,23.0,21.0,24.0,22.0,0
1841,CC:2F:71:3E:C5:1F,2634855,333527591,5156,630592,2629699,332896999,6,22131,1855720,18242,1394814,3889,460906,5442,30,7350,133,6,449,144444.0,39000.0,-69.0,-72.0,-68.0,-60.0,-68.0,-71.0,-67.0,-60.0,-90.0,-93.0,-90.0,-93.0,21.0,21.0,22.0,33.0,0
1842,CC:2F:71:3F:1F:24,5648472,4918782025,3018773,4585885026,2629699,332896999,53,697415,456619890,693515,456149992,3900,469898,670387,594,3020755,281002,53,4822,130000.0,43333.0,-70.0,-65.0,-73.0,-67.0,-70.0,-65.0,-73.0,-67.0,-90.0,-93.0,-90.0,-93.0,20.0,28.0,17.0,26.0,0
1843,F8:59:71:5A:E0:3D,2656836,374523630,27132,41626167,2629704,332897463,0,3311,411863,3214,396044,97,15819,3119,0,27150,866,0,30,144444.0,39000.0,-67.0,-72.0,-66.0,-71.0,-70.0,-76.0,-70.0,-73.0,-90.0,-93.0,-90.0,-93.0,23.0,21.0,24.0,22.0,0
1844,CC:2F:71:3E:C5:1F,2634860,333528055,5156,630592,2629704,332897463,6,22131,1855720,18242,1394814,3889,460906,5442,30,7350,133,6,449,144444.0,39000.0,-69.0,-72.0,-68.0,-60.0,-68.0,-71.0,-67.0,-60.0,-90.0,-93.0,-90.0,-93.0,21.0,21.0,22.0,33.0,0
1845,CC:2F:71:3F:1F:24,5651798,4923977273,3022092,4591079608,2629706,332897665,53,697781,456666070,693881,456196172,3900,469898,670752,594,3024185,281147,53,4822,130000.0,43333.0,-79.0,-75.0,-82.0,-77.0,-77.0,-72.0,-79.0,-74.0,-90.0,-93.0,-90.0,-93.0,11.0,18.0,8.0,16.0,0
1846,F8:59:71:5A:E0:3D,2656840,374524034,27132,41626167,2629708,332897867,0,3311,411863,3214,396044,97,15819,3119,0,27150,866,0,30,144444.0,39000.0,-67.0,-72.0,-66.0,-71.0,-70.0,-76.0,-70.0,-73.0,-90.0,-93.0,-90.0,-93.0,23.0,21.0,24.0,22.0,0
1847,CC:2F:71:3E:C5:1F,2634866,333528661,5156,630592,2629710,332898069,6,22131,1855720,18242,1394814,3889,460906,5442,30,7350,133,6,449,144444.0,39000.0,-69.0,-72.0,-68.0,-60.0,-68.0,-71.0,-67.0,-60.0,-90.0,-93.0,-90.0,-93.0,21.0,21.0,22.0,33.0,0
1848,CC:2F:71:3F:1F:24,5656394,4931173763,3026682,4598275492,2629712,332898271,53,698207,456720828,694307,456250930,3900,469898,671178,594,3028775,282725,53,4822,117000.0,39000.0,-70.0,-65.0,-74.0,-68.0,-70.0,-65.0,-74.0,-68.0,-90.0,-93.0,-90.0,-93.0,20.0,28.0,16.0,25.0,0
1849,F8:59:71:5A:E0:3D,2656848,374524816,27133,41626283,2629715,332898533,0,3313,412003,3216,396184,97,15819,3119,0,27151,866,0,30,144444.0,39000.0,-68.0,-74.0,-65.0,-71.0,-70.0,-76.0,-70.0,-72.0,-90.0,-93.0,-90.0,-93.0,22.0,19.0,25.0,22.0,0
1850,CC:2F:71:3E:C5:1F,2634872,333529241,5157,630708,2629715,332898533,6,22133,1855860,18244,1394954,3889,460906,5442,30,7351,133,6,449,144444.0,39000.0,-69.0,-72.0,-68.0,-60.0,-68.0,-71.0,-67.0,-60.0,-90.0,-93.0,-90.0,-93.0,21.0,21.0,22.0,33.0,0
1851,CC:2F:71:3F:1F:24,5660381,4937412417,3030664,4604513682,2629717,332898735,53,698523,456762674,694623,456292776,3900,469898,671494,594,3032752,283625,53,4822,130000.0,43333.0,-70.0,-65.0,-74.0,-68.0,-70.0,-65.0,-73.0,-67.0,-90.0,-93.0,-90.0,-93.0,20.0,28.0,16.0,25.0,0
1852,F8:59:71:5A:E0:3D,2656854,374525422,27133,41626283,2629721,332899139,0,3313,412003,3216,396184,97,15819,3119,0,27151,866,0,30,144444.0,39000.0,-68.0,-74.0,-65.0,-71.0,-70.0,-76.0,-70.0,-72.0,-90.0,-93.0,-90.0,-93.0,22.0,19.0,25.0,22.0,0
1853,CC:2F:71:3E:C5:1F,2634878,333529847,5157,630708,2629721,332899139,6,22133,1855860,18244,1394954,3889,460906,5442,30,7351,133,6,449,144444.0,39000.0,-69.0,-72.0,-68.0,-60.0,-68.0,-71.0,-67.0,-60.0,-90.0,-93.0,-90.0,-93.0,21.0,21.0,22.0,33.0,0
1854,CC:2F:71:3F:1F:24,5664580,4943990995,3034859,4611091856,2629721,332899139,53,699111,456834926,695211,456365028,3900,469898,672082,594,3036913,284579,53,4824,115556.0,28889.0,-71.0,-66.0,-75.0,-68.0,-71.0,-65.0,-74.0,-67.0,-90.0,-93.0,-90.0,-93.0,19.0,27.0,15.0,25.0,0
1855,F8:59:71:5A:E0:3D,2656859,374525896,27133,41626283,2629726,332899613,0,3315,412199,3217,396254,98,15945,3120,0,27151,866,0,30,144444.0,39000.0,-68.0,-74.0,-65.0,-71.0,-69.0,-75.0,-68.0,-72.0,-90.0,-93.0,-90.0,-93.0,22.0,19.0,25.0,22.0,0
1856,CC:2F:71:3E:C5:1F,2634884,333530381,5157,630708,2629727,332899673,6,22133,1855860,18244,1394954,3889,460906,5442,30,7351,133,6,449,144444.0,39000.0,-69.0,-72.0,-68.0,-60.0,-68.0,-71.0,-67.0,-60.0,-90.0,-93.0,-90.0,-93.0,21.0,21.0,22.0,33.0,0
1857,CC:2F:71:3F:1F:24,5669982,4952465449,3040255,4619565776,2629727,332899673,53,699735,456914318,695835,456444420,3900,469898,672706,594,3042348,284768,53,4824,104000.0,26000.0,-71.0,-66.0,-74.0,-68.0,-71.0,-66.0,-74.0,-68.0,-90.0,-93.0,-90.0,-93.0,19.0,27.0,16.0,25.0,0
1858,F8:59:71:5A:E0:3D,2656865,374526633,27133,41626283,2629732,332900350,0,3315,412199,3217,396254,98,15945,3120,0,27151,866,0,30,144444.0,39000.0,-68.0,-74.0,-65.0,-71.0,-69.0,-75.0,-68.0,-72.0,-90.0,-93.0,-90.0,-93.0,22.0,19.0,25.0,22.0,0
1859,CC:2F:71:3E:C5:1F,2634891,333531260,5157,630708,2629734,332900552,6,22133,1855860,18244,1394954,3889,460906,5442,30,7351,133,6,449,144444.0,39000.0,-69.0,-72.0,-68.0,-60.0,-68.0,-71.0,-67.0,-60.0,-90.0,-93.0,-90.0,-93.0,21.0,21.0,22.0,33.0,0
1860,CC:2F:71:3F:1F:24,5675424,4960997146,3045689,4628096532,2629735,332900614,53,700465,457003844,696565,456533946,3900,469898,673436,594,3047672,285829,53,4824,130000.0,43333.0,-71.0,-66.0,-74.0,-68.0,-71.0,-66.0,-74.0,-68.0,-90.0,-93.0,-90.0,-93.0,19.0,27.0,16.0,25.0,0
1861,F8:59:71:5A:E0:3D,2656870,374527099,27133,41626283,2629737,332900816,0,3317,412387,3218,396324,99,16063,3121,0,27151,866,0,30,144444.0,39000.0,-65.0,-63.0,-65.0,-64.0,-67.0,-71.0,-65.0,-69.0,-90.0,-93.0,-90.0,-93.0,25.0,30.0,25.0,29.0,0
1862,CC:2F:71:3E:C5:1F,2634896,333531726,5157,630708,2629739,332901018,6,22133,1855860,18244,1394954,3889,460906,5442,30,7351,133,6,449,144444.0,39000.0,-69.0,-72.0,-68.0,-60.0,-68.0,-71.0,-67.0,-60.0,-90.0,-93.0,-90.0,-93.0,21.0,21.0,22.0,33.0,0
1863,CC:2F:71:3F:1F:24,5679511,4967398878,3049771,4634497800,2629740,332901078,53,701051,457074992,697151,456605094,3900,469898,674022,594,3051849,287074,53,4824,130000.0,43333.0,-70.0,-66.0,-74.0,-68.0,-70.0,-66.0,-74.0,-68.0,-90.0,-93.0,-90.0,-93.0,20.0,27.0,16.0,25.0,0
1864,F8:59:71:5A:E0:3D,2656880,374528029,27133,41626283,2629747,332901746,0,3317,412387,3218,396324,99,16063,3121,0,27151,866,0,30,144444.0,39000.0,-65.0,-63.0,-65.0,-64.0,-67.0,-71.0,-65.0,-69.0,-90.0,-93.0,-90.0,-93.0,25.0,30.0,25.0,29.0,0
1865,CC:2F:71:3E:C5:1F,2634904,333532454,5157,630708,2629747,332901746,6,22135,1856048,18245,1395024,3890,461024,5443,30,7351,133,6,449,144444.0,39000.0,-69.0,-71.0,-68.0,-60.0,-69.0,-71.0,-68.0,-60.0,-90.0,-93.0,-90.0,-93.0,21.0,22.0,22.0,33.0,0
1866,CC:2F:71:3F:1F:24,5684468,4975164774,3054721,4642263028,2629747,332901746,53,701478,457130188,697578,456660290,3900,469898,674441,594,3056800,288076,53,4825,117000.0,39000.0,-71.0,-66.0,-74.0,-69.0,-70.0,-65.0,-74.0,-68.0,-90.0,-93.0,-90.0,-93.0,19.0,27.0,16.0,24.0,0
1867,F8:59:71:5A:E0:3D,2656885,374528493,27133,41626283,2629752,332902210,0,3317,412387,3218,396324,99,16063,3121,0,27151,866,0,30,144444.0,39000.0,-65.0,-63.0,-65.0,-64.0,-67.0,-71.0,-65.0,-69.0,-90.0,-93.0,-90.0,-93.0,25.0,30.0,25.0,29.0,0
1868,CC:2F:71:3E:C5:1F,2634909,333532918,5157,630708,2629752,332902210,6,22135,1856048,18245,1395024,3890,461024,5443,30,7351,133,6,449,144444.0,39000.0,-69.0,-71.0,-68.0,-60.0,-69.0,-71.0,-68.0,-60.0,-90.0,-93.0,-90.0,-93.0,21.0,22.0,22.0,33.0,0
1869,CC:2F:71:3F:1F:24,5689278,4982693076,3059522,4649790462,2629756,332902614,53,701987,457193786,698087,456723888,3900,469898,674917,594,3061615,288664,53,4825,130000.0,43333.0,-71.0,-66.0,-74.0,-68.0,-70.0,-65.0,-73.0,-67.0,-90.0,-93.0,-90.0,-93.0,19.0,27.0,16.0,25.0,0
1870,F8:59:71:5A:E0:3D,2656893,374529301,27133,41626283,2629760,332903018,0,3317,412387,3218,396324,99,16063,3121,0,27151,866,0,30,144444.0,39000.0,-65.0,-63.0,-65.0,-64.0,-67.0,-71.0,-65.0,-69.0,-90.0,-93.0,-90.0,-93.0,25.0,30.0,25.0,29.0,0
1871,CC:2F:71:3E:C5:1F,2634917,333533726,5157,630708,2629760,332903018,6,22135,1856048,18245,1395024,3890,461024,5443,30,7351,133,6,449,144444.0,39000.0,-69.0,-71.0,-68.0,-60.0,-69.0,-71.0,-68.0,-60.0,-90.0,-93.0,-90.0,-93.0,21.0,22.0,22.0,33.0,0
1872,CC:2F:71:3F:1F:24,5694236,4990465780,3064476,4657562762,2629760,332903018,53,702420,457248580,698520,456778682,3900,469898,675348,594,3066510,289667,53,4825,130000.0,39000.0,-70.0,-65.0,-74.0,-68.0,-70.0,-65.0,-73.0,-67.0,-90.0,-93.0,-90.0,-93.0,20.0,28.0,16.0,25.0,0
1873,F8:59:71:5A:E0:3D,2656902,374530321,27133,41626283,2629769,332904038,0,3317,412387,3218,396324,99,16063,3121,0,27151,866,0,30,144444.0,39000.0,-65.0,-63.0,-65.0,-64.0,-67.0,-71.0,-65.0,-69.0,-90.0,-93.0,-90.0,-93.0,25.0,30.0,25.0,29.0,0
1874,CC:2F:71:3E:C5:1F,2634926,333534746,5157,630708,2629769,332904038,6,22135,1856048,18245,1395024,3890,461024,5443,30,7351,133,6,449,144444.0,39000.0,-69.0,-71.0,-68.0,-60.0,-69.0,-71.0,-68.0,-60.0,-90.0,-93.0,-90.0,-93.0,21.0,22.0,22.0,33.0,0
1875,CC:2F:71:3F:1F:24,5699067,4998031484,3069298,4665127446,2629769,332904038,53,702824,457300494,698923,456830478,3901,470016,675752,594,3071318,290203,53,4825,130000.0,43333.0,-73.0,-68.0,-77.0,-71.0,-71.0,-66.0,-74.0,-68.0,-90.0,-93.0,-90.0,-93.0,17.0,25.0,13.0,22.0,0
1876,F8:59:71:5A:E0:3D,2656906,374530725,27133,41626283,2629773,332904442,0,3319,412527,3220,396464,99,16063,3121,0,27152,866,0,30,144444.0,39000.0,-68.0,-74.0,-65.0,-71.0,-67.0,-71.0,-65.0,-69.0,-90.0,-93.0,-90.0,-93.0,22.0,19.0,25.0,22.0,0
1877,CC:2F:71:3E:C5:1F,2634932,333535352,5157,630708,2629775,332904644,6,22135,1856048,18245,1395024,3890,461024,5443,30,7351,133,6,449,144444.0,39000.0,-69.0,-71.0,-68.0,-60.0,-69.0,-71.0,-68.0,-60.0,-90.0,-93.0,-90.0,-93.0,21.0,22.0,22.0,33.0,0
1878,CC:2F:71:3F:1F:24,5703403,5004816220,3073626,4671911374,2629777,332904846,53,703375,457369244,699474,456899228,3901,470016,676303,594,3075658,291638,53,4825,86667.0,14444.0,-70.0,-66.0,-73.0,-71.0,-70.0,-65.0,-73.0,-70.0,-90.0,-93.0,-90.0,-93.0,20.0,27.0,17.0,22.0,0
1879,F8:59:71:5A:E0:3D,2656915,374531593,27133,41626283,2629782,332905310,0,3319,412527,3220,396464,99,16063,3121,0,27152,866,0,30,144444.0,39000.0,-68.0,-74.0,-65.0,-71.0,-67.0,-71.0,-65.0,-69.0,-90.0,-93.0,-90.0,-93.0,22.0,19.0,25.0,22.0,0
1880,CC:2F:71:3E:C5:1F,2634939,333536018,5157,630708,2629782,332905310,6,22135,1856048,18245,1395024,3890,461024,5443,30,7351,133,6,449,144444.0,39000.0,-69.0,-71.0,-68.0,-60.0,-69.0,-71.0,-68.0,-60.0,-90.0,-93.0,-90.0,-93.0,21.0,22.0,22.0,33.0,0
1881,CC:2F:71:3F:1F:24,5707726,5011586376,3077944,4678681066,2629782,332905310,53,704012,457447966,700111,456977950,3901,470016,676940,594,3079997,291638,53,4825,115556.0,28889.0,-71.0,-65.0,-73.0,-70.0,-70.0,-65.0,-72.0,-70.0,-90.0,-93.0,-90.0,-93.0,19.0,28.0,17.0,23.0,0
1882,F8:59:71:5A:E0:3D,2656919,374531997,27133,41626283,2629786,332905714,0,3319,412527,3220,396464,99,16063,3121,0,27152,866,0,30,144444.0,39000.0,-68.0,-74.0,-65.0,-71.0,-67.0,-71.0,-65.0,-69.0,-90.0,-93.0,-90.0,-93.0,22.0,19.0,25.0,22.0,0
1883,CC:2F:71:3E:C5:1F,2634943,333536422,5157,630708,2629786,332905714,6,22135,1856048,18245,1395024,3890,461024,5443,30,7351,133,6,449,144444.0,39000.0,-69.0,-71.0,-68.0,-60.0,-69.0,-71.0,-68.0,-60.0,-90.0,-93.0,-90.0,-93.0,21.0,22.0,22.0,33.0,0
1884,CC:2F:71:3F:1F:24,5712970,5019810516,3083184,4686904802,2629786,332905714,53,704620,457524284,700719,457054268,3901,470016,677548,594,3085151,291812,53,4826,130000.0,39000.0,-70.0,-65.0,-73.0,-70.0,-70.0,-65.0,-73.0,-70.0,-90.0,-93.0,-90.0,-93.0,20.0,28.0,17.0,23.0,0
1885,F8:59:71:5A:E0:3D,2656924,374532461,27133,41626283,2629791,332906178,0,3319,412527,3220,396464,99,16063,3121,0,27152,866,0,30,144444.0,39000.0,-68.0,-74.0,-65.0,-71.0,-67.0,-71.0,-65.0,-69.0,-90.0,-93.0,-90.0,-93.0,22.0,19.0,25.0,22.0,0
1886,CC:2F:71:3E:C5:1F,2634950,333537088,5157,630708,2629793,332906380,6,22135,1856048,18245,1395024,3890,461024,5443,30,7351,133,6,449,144444.0,39000.0,-69.0,-71.0,-68.0,-60.0,-69.0,-71.0,-68.0,-60.0,-90.0,-93.0,-90.0,-93.0,21.0,22.0,22.0,33.0,0
1887,CC:2F:71:3F:1F:24,5717286,5026563864,3087493,4693657484,2629793,332906380,53,705036,457579958,701135,457109942,3901,470016,677963,594,3089586,293184,53,4826,115556.0,28889.0,-70.0,-64.0,-73.0,-68.0,-70.0,-64.0,-73.0,-68.0,-90.0,-93.0,-90.0,-93.0,20.0,29.0,17.0,25.0,0
1888,F8:59:71:5A:E0:3D,2656929,374533138,27133,41626283,2629796,332906855,0,3319,412527,3220,396464,99,16063,3121,0,27152,866,0,30,144444.0,39000.0,-68.0,-74.0,-65.0,-71.0,-67.0,-71.0,-65.0,-69.0,-90.0,-93.0,-90.0,-93.0,22.0,19.0,25.0,22.0,0
1889,CC:2F:71:3E:C5:1F,2634953,333537563,5157,630708,2629796,332906855,6,22135,1856048,18245,1395024,3890,461024,5443,30,7351,133,6,449,144444.0,39000.0,-69.0,-71.0,-68.0,-60.0,-69.0,-71.0,-68.0,-60.0,-90.0,-93.0,-90.0,-93.0,21.0,22.0,22.0,33.0,0
1890,CC:2F:71:3F:1F:24,5721710,5033494169,3091910,4700586910,2629800,332907259,53,705765,457668718,701864,457198702,3901,470016,678692,594,3093934,293356,53,4826,117000.0,39000.0,-70.0,-65.0,-74.0,-68.0,-70.0,-64.0,-73.0,-68.0,-90.0,-93.0,-90.0,-93.0,20.0,28.0,16.0,25.0,0
1891,F8:59:71:5A:E0:3D,2656935,374533744,27133,41626283,2629802,332907461,0,3319,412527,3220,396464,99,16063,3121,0,27152,866,0,30,144444.0,39000.0,-68.0,-74.0,-65.0,-71.0,-67.0,-71.0,-65.0,-69.0,-90.0,-93.0,-90.0,-93.0,22.0,19.0,25.0,22.0,0
1892,CC:2F:71:3E:C5:1F,2634960,333538229,5157,630708,2629803,332907521,6,22135,1856048,18245,1395024,3890,461024,5443,30,7351,133,6,449,144444.0,39000.0,-69.0,-71.0,-68.0,-60.0,-69.0,-71.0,-68.0,-60.0,-90.0,-93.0,-90.0,-93.0,21.0,22.0,22.0,33.0,0
1893,CC:2F:71:3F:1F:24,5726466,5040946999,3096661,4708039276,2629805,332907723,53,706417,457750790,702516,457280774,3901,470016,679344,594,3098726,293614,53,4826,130000.0,43333.0,-70.0,-65.0,-73.0,-68.0,-70.0,-65.0,-73.0,-68.0,-90.0,-93.0,-90.0,-93.0,20.0,28.0,17.0,25.0,0
1894,F8:59:71:5A:E0:3D,2656942,374534410,27133,41626283,2629809,332908127,0,3319,412527,3220,396464,99,16063,3121,0,27152,866,0,30,144444.0,39000.0,-68.0,-74.0,-65.0,-71.0,-67.0,-71.0,-65.0,-69.0,-90.0,-93.0,-90.0,-93.0,22.0,19.0,25.0,22.0,0
1895,CC:2F:71:3E:C5:1F,2634966,333538835,5157,630708,2629809,332908127,6,22135,1856048,18245,1395024,3890,461024,5443,30,7351,133,6,449,144444.0,39000.0,-69.0,-71.0,-68.0,-60.0,-69.0,-71.0,-68.0,-60.0,-90.0,-93.0,-90.0,-93.0,21.0,22.0,22.0,33.0,0
1896,CC:2F:71:3F:1F:24,5732082,5049759403,3102273,4716851276,2629809,332908127,53,707158,457842134,703257,457372118,3901,470016,680081,594,3104366,293777,53,4826,130000.0,43333.0,-71.0,-65.0,-74.0,-68.0,-70.0,-65.0,-73.0,-68.0,-90.0,-93.0,-90.0,-93.0,19.0,28.0,16.0,25.0,0
1897,F8:59:71:5A:E0:3D,2656946,374534814,27133,41626283,2629813,332908531,0,3319,412527,3220,396464,99,16063,3121,0,27152,866,0,30,144444.0,39000.0,-68.0,-74.0,-65.0,-71.0,-67.0,-71.0,-65.0,-69.0,-90.0,-93.0,-90.0,-93.0,22.0,19.0,25.0,22.0,0
1898,CC:2F:71:3E:C5:1F,2634970,333539239,5157,630708,2629813,332908531,6,22135,1856048,18245,1395024,3890,461024,5443,30,7351,133,6,449,144444.0,39000.0,-69.0,-71.0,-68.0,-60.0,-69.0,-71.0,-68.0,-60.0,-90.0,-93.0,-90.0,-93.0,21.0,22.0,22.0,33.0,0
1899,CC:2F:71:3F:1F:24,5737089,5057615301,3107276,4724706770,2629813,332908531,53,707769,457918472,703868,457448456,3901,470016,680686,594,3109314,294086,53,4826,130000.0,43333.0,-70.0,-65.0,-73.0,-68.0,-70.0,-65.0,-73.0,-68.0,-90.0,-93.0,-90.0,-93.0,20.0,28.0,17.0,25.0,0
1900,F8:59:71:5A:E0:3D,2656951,374535278,27133,41626283,2629818,332908995,0,3319,412527,3220,396464,99,16063,3121,0,27152,866,0,30,144444.0,39000.0,-68.0,-74.0,-65.0,-71.0,-67.0,-71.0,-65.0,-69.0,-90.0,-93.0,-90.0,-93.0,22.0,19.0,25.0,22.0,0
1901,CC:2F:71:3E:C5:1F,2634975,333539703,5157,630708,2629818,332908995,6,22135,1856048,18245,1395024,3890,461024,5443,30,7351,133,6,449,144444.0,39000.0,-69.0,-71.0,-68.0,-60.0,-69.0,-71.0,-68.0,-60.0,-90.0,-93.0,-90.0,-93.0,21.0,22.0,22.0,33.0,0
1902,CC:2F:71:3F:1F:24,5742905,5066735857,3113085,4733826660,2629820,332909197,53,708548,458013294,704647,457543278,3901,470016,681461,594,3115178,294286,53,4826,130000.0,43333.0,-70.0,-65.0,-74.0,-68.0,-70.0,-64.0,-73.0,-67.0,-90.0,-93.0,-90.0,-93.0,20.0,28.0,16.0,25.0,0
1903,F8:59:71:5A:E0:3D,2656955,374535682,27133,41626283,2629822,332909399,0,3319,412527,3220,396464,99,16063,3121,0,27152,866,0,30,144444.0,39000.0,-68.0,-74.0,-65.0,-71.0,-67.0,-71.0,-65.0,-69.0,-90.0,-93.0,-90.0,-93.0,22.0,19.0,25.0,22.0,0
1904,CC:2F:71:3E:C5:1F,2634981,333540309,5157,630708,2629824,332909601,6,22135,1856048,18245,1395024,3890,461024,5443,30,7351,133,6,449,144444.0,39000.0,-69.0,-71.0,-68.0,-60.0,-69.0,-71.0,-68.0,-60.0,-90.0,-93.0,-90.0,-93.0,21.0,22.0,22.0,33.0,0
1905,CC:2F:71:3F:1F:24,5747869,5074516523,3118043,4741606720,2629826,332909803,53,708961,458066884,705060,457596868,3901,470016,681874,594,3120099,294601,53,4826,130000.0,43333.0,-70.0,-65.0,-73.0,-68.0,-70.0,-64.0,-72.0,-68.0,-90.0,-93.0,-90.0,-93.0,20.0,28.0,17.0,25.0,0
1906,F8:59:71:5A:E0:3D,2656962,374536348,27133,41626283,2629829,332910065,0,3319,412527,3220,396464,99,16063,3121,0,27152,866,0,30,144444.0,39000.0,-68.0,-74.0,-65.0,-71.0,-67.0,-71.0,-65.0,-69.0,-90.0,-93.0,-90.0,-93.0,22.0,19.0,25.0,22.0,0
1907,CC:2F:71:3E:C5:1F,2634986,333540773,5157,630708,2629829,332910065,6,22135,1856048,18245,1395024,3890,461024,5443,30,7351,133,6,449,144444.0,39000.0,-69.0,-71.0,-68.0,-60.0,-69.0,-71.0,-68.0,-60.0,-90.0,-93.0,-90.0,-93.0,21.0,22.0,22.0,33.0,0
1908,CC:2F:71:3F:1F:24,5752574,5081891258,3122745,4748981193,2629829,332910065,53,709511,458135172,705610,457665156,3901,470016,682423,594,3124823,294782,53,4826,130000.0,43333.0,-70.0,-65.0,-73.0,-68.0,-70.0,-65.0,-73.0,-68.0,-90.0,-93.0,-90.0,-93.0,20.0,28.0,17.0,25.0,0
1909,F8:59:71:5A:E0:3D,2656966,374536752,27133,41626283,2629833,332910469,0,3319,412527,3220,396464,99,16063,3121,0,27152,866,0,30,144444.0,39000.0,-68.0,-74.0,-65.0,-71.0,-67.0,-71.0,-65.0,-69.0,-90.0,-93.0,-90.0,-93.0,22.0,19.0,25.0,22.0,0
1910,CC:2F:71:3E:C5:1F,2634992,333541379,5157,630708,2629835,332910671,6,22135,1856048,18245,1395024,3890,461024,5443,30,7351,133,6,449,144444.0,39000.0,-69.0,-71.0,-68.0,-60.0,-69.0,-71.0,-68.0,-60.0,-90.0,-93.0,-90.0,-93.0,21.0,22.0,22.0,33.0,0
1911,CC:2F:71:3F:1F:24,5757496,5089602000,3127661,4756691329,2629835,332910671,53,710006,458198978,706105,457728962,3901,470016,682918,594,3129754,295030,53,4826,130000.0,39000.0,-71.0,-66.0,-75.0,-69.0,-73.0,-68.0,-76.0,-71.0,-90.0,-93.0,-90.0,-93.0,19.0,27.0,15.0,24.0,0
1912,F8:59:71:5A:E0:3D,2656972,374537332,27134,41626399,2629838,332910933,0,3320,412597,3221,396534,99,16063,3121,0,27153,866,0,30,144444.0,39000.0,-67.0,-73.0,-65.0,-71.0,-67.0,-71.0,-64.0,-69.0,-90.0,-93.0,-90.0,-93.0,23.0,20.0,25.0,22.0,0
1913,CC:2F:71:3E:C5:1F,2634996,333541757,5158,630824,2629838,332910933,6,22137,1856188,18247,1395164,3890,461024,5443,30,7352,133,6,449,144444.0,39000.0,-66.0,-62.0,-67.0,-60.0,-68.0,-70.0,-67.0,-60.0,-90.0,-93.0,-90.0,-93.0,24.0,31.0,23.0,33.0,0
1914,CC:2F:71:3F:1F:24,5762168,5096923928,3132328,4764012793,2629840,332911135,53,710400,458248834,706499,457778818,3901,470016,683312,594,3134371,295155,53,4826,130000.0,43333.0,-71.0,-65.0,-74.0,-69.0,-71.0,-65.0,-73.0,-68.0,-90.0,-93.0,-90.0,-93.0,19.0,28.0,16.0,24.0,0
1915,F8:59:71:5A:E0:3D,2656983,374539182,27139,41627643,2629844,332911539,0,3327,413492,3228,397429,99,16063,3127,0,27158,866,0,30,144444.0,39000.0,-65.0,-63.0,-65.0,-64.0,-67.0,-72.0,-65.0,-70.0,-90.0,-93.0,-90.0,-93.0,25.0,30.0,25.0,29.0,0
1916,CC:2F:71:3E:C5:1F,2635002,333542363,5158,630824,2629844,332911539,6,22137,1856188,18247,1395164,3890,461024,5443,30,7352,133,6,449,144444.0,39000.0,-66.0,-62.0,-67.0,-60.0,-68.0,-70.0,-67.0,-60.0,-90.0,-93.0,-90.0,-93.0,24.0,31.0,23.0,33.0,0
1917,CC:2F:71:3F:1F:24,5766091,5103064170,3136247,4770152631,2629844,332911539,53,710880,458308778,706979,457838762,3901,470016,683792,594,3138340,295270,53,4827,130000.0,43333.0,-70.0,-65.0,-73.0,-67.0,-70.0,-65.0,-72.0,-67.0,-90.0,-93.0,-90.0,-93.0,20.0,28.0,17.0,26.0,0
1918,F8:59:71:5A:E0:3D,2656987,374539586,27139,41627643,2629848,332911943,0,3328,413562,3229,397499,99,16063,3127,0,27158,866,0,30,144444.0,39000.0,-67.0,-74.0,-66.0,-71.0,-67.0,-72.0,-65.0,-70.0,-90.0,-93.0,-90.0,-93.0,23.0,19.0,24.0,22.0,0
1919,CC:2F:71:3E:C5:1F,2635006,333542767,5158,630824,2629848,332911943,6,22137,1856188,18247,1395164,3890,461024,5443,30,7352,133,6,449,144444.0,39000.0,-66.0,-62.0,-67.0,-60.0,-68.0,-70.0,-67.0,-60.0,-90.0,-93.0,-90.0,-93.0,24.0,31.0,23.0,33.0,0
1920,CC:2F:71:3F:1F:24,5770328,5109701314,3140479,4776789311,2629849,332912003,53,711431,458377324,707530,457907308,3901,470016,684343,594,3142572,295661,53,4827,130000.0,43333.0,-70.0,-65.0,-73.0,-68.0,-70.0,-65.0,-73.0,-68.0,-90.0,-93.0,-90.0,-93.0,20.0,28.0,17.0,25.0,0
1921,F8:59:71:5A:E0:3D,2656993,374540112,27139,41627643,2629854,332912469,0,3328,413562,3229,397499,99,16063,3127,0,27158,866,0,30,144444.0,39000.0,-67.0,-74.0,-66.0,-71.0,-67.0,-72.0,-65.0,-70.0,-90.0,-93.0,-90.0,-93.0,23.0,19.0,24.0,22.0,0
1922,CC:2F:71:3E:C5:1F,2635012,333543293,5158,630824,2629854,332912469,6,22137,1856188,18247,1395164,3890,461024,5443,30,7352,133,6,449,144444.0,39000.0,-66.0,-62.0,-67.0,-60.0,-68.0,-70.0,-67.0,-60.0,-90.0,-93.0,-90.0,-93.0,24.0,31.0,23.0,33.0,0
1923,CC:2F:71:3F:1F:24,5774780,5116671505,3144925,4783758763,2629855,332912742,53,711940,458441652,708038,457971518,3902,470134,684852,594,3147006,295868,53,4827,130000.0,43333.0,-71.0,-65.0,-73.0,-68.0,-70.0,-65.0,-73.0,-68.0,-90.0,-93.0,-90.0,-93.0,19.0,28.0,17.0,25.0,0
1924,F8:59:71:5A:E0:3D,2656998,374540789,27139,41627643,2629859,332913146,0,3328,413562,3229,397499,99,16063,3127,0,27158,866,0,30,144444.0,39000.0,-67.0,-74.0,-66.0,-71.0,-67.0,-72.0,-65.0,-70.0,-90.0,-93.0,-90.0,-93.0,23.0,19.0,24.0,22.0,0
1925,CC:2F:71:3E:C5:1F,2635017,333543970,5158,630824,2629859,332913146,6,22137,1856188,18247,1395164,3890,461024,5443,30,7352,133,6,449,144444.0,39000.0,-66.0,-62.0,-67.0,-60.0,-68.0,-70.0,-67.0,-60.0,-90.0,-93.0,-90.0,-93.0,24.0,31.0,23.0,33.0,0
1926,CC:2F:71:3F:1F:24,5778733,5122855069,3148872,4789941721,2629861,332913348,53,712283,458486660,708381,458016526,3902,470134,685195,594,3150881,296248,53,4827,130000.0,43333.0,-77.0,-71.0,-80.0,-74.0,-76.0,-70.0,-79.0,-73.0,-90.0,-93.0,-90.0,-93.0,13.0,22.0,10.0,19.0,0
1927,F8:59:71:5A:E0:3D,2657004,374541315,27139,41627643,2629865,332913672,0,3328,413562,3229,397499,99,16063,3127,0,27158,866,0,30,144444.0,39000.0,-67.0,-74.0,-66.0,-71.0,-67.0,-72.0,-65.0,-70.0,-90.0,-93.0,-90.0,-93.0,23.0,19.0,24.0,22.0,0
1928,CC:2F:71:3E:C5:1F,2635023,333544496,5158,630824,2629865,332913672,6,22139,1856376,18248,1395234,3891,461142,5444,30,7352,133,6,449,144444.0,39000.0,-69.0,-71.0,-69.0,-60.0,-68.0,-70.0,-68.0,-60.0,-90.0,-93.0,-90.0,-93.0,21.0,22.0,21.0,33.0,0
1929,CC:2F:71:3F:1F:24,5783543,5130391419,3153676,4797477545,2629867,332913874,53,712811,458554406,708909,458084272,3902,470134,685723,594,3155752,296287,53,4827,130000.0,43333.0,-71.0,-65.0,-74.0,-68.0,-70.0,-64.0,-73.0,-68.0,-90.0,-93.0,-90.0,-93.0,19.0,28.0,16.0,25.0,0
1930,F8:59:71:5A:E0:3D,2657008,374541719,27139,41627643,2629869,332914076,0,3328,413562,3229,397499,99,16063,3127,0,27158,866,0,30,144444.0,39000.0,-67.0,-74.0,-66.0,-71.0,-67.0,-72.0,-65.0,-70.0,-90.0,-93.0,-90.0,-93.0,23.0,19.0,24.0,22.0,0
1931,CC:2F:71:3E:C5:1F,2635029,333545102,5158,630824,2629871,332914278,6,22139,1856376,18248,1395234,3891,461142,5444,30,7352,133,6,449,144444.0,39000.0,-69.0,-71.0,-69.0,-60.0,-68.0,-70.0,-68.0,-60.0,-90.0,-93.0,-90.0,-93.0,21.0,22.0,21.0,33.0,0
1932,CC:2F:71:3F:1F:24,5788295,5137840079,3158424,4804925801,2629871,332914278,53,713346,458620328,709444,458150194,3902,470134,686253,594,3160517,296718,53,4828,130000.0,43333.0,-70.0,-65.0,-74.0,-68.0,-70.0,-65.0,-73.0,-68.0,-90.0,-93.0,-90.0,-93.0,20.0,28.0,16.0,25.0,0
1933,F8:59:71:5A:E0:3D,2657013,374542185,27139,41627643,2629874,332914542,0,3331,413820,3231,397639,100,16181,3128,0,27158,866,0,31,144444.0,39000.0,-68.0,-74.0,-65.0,-71.0,-67.0,-72.0,-65.0,-70.0,-90.0,-93.0,-90.0,-93.0,22.0,19.0,25.0,22.0,0
1934,CC:2F:71:3E:C5:1F,2635034,333545568,5158,630824,2629876,332914744,6,22139,1856376,18248,1395234,3891,461142,5444,30,7352,133,6,449,144444.0,39000.0,-69.0,-71.0,-69.0,-60.0,-68.0,-70.0,-68.0,-60.0,-90.0,-93.0,-90.0,-93.0,21.0,22.0,21.0,33.0,0
1935,CC:2F:71:3F:1F:24,5792333,5144162333,3162456,4811247529,2629877,332914804,53,713828,458679406,709926,458209272,3902,470134,686735,594,3164513,297184,53,4829,130000.0,43333.0,-70.0,-65.0,-73.0,-69.0,-70.0,-65.0,-73.0,-68.0,-90.0,-93.0,-90.0,-93.0,20.0,28.0,17.0,24.0,0
1936,F8:59:71:5A:E0:3D,2657022,374543027,27141,41627819,2629881,332915208,0,3336,414242,3236,398061,100,16181,3130,0,27160,866,0,31,144444.0,43333.0,-68.0,-74.0,-65.0,-72.0,-67.0,-74.0,-65.0,-71.0,-90.0,-93.0,-90.0,-93.0,22.0,19.0,25.0,21.0,0
1937,CC:2F:71:3E:C5:1F,2635039,333546032,5158,630824,2629881,332915208,6,22139,1856376,18248,1395234,3891,461142,5444,30,7352,133,6,449,144444.0,39000.0,-69.0,-71.0,-69.0,-60.0,-68.0,-70.0,-68.0,-60.0,-90.0,-93.0,-90.0,-93.0,21.0,22.0,21.0,33.0,0
1938,CC:2F:71:3F:1F:24,5797775,5152700973,3167894,4819785765,2629881,332915208,53,714533,458767042,710631,458296908,3902,470134,687440,594,3169904,297395,53,4831,130000.0,43333.0,-71.0,-64.0,-74.0,-68.0,-71.0,-64.0,-74.0,-68.0,-90.0,-93.0,-90.0,-93.0,19.0,29.0,16.0,25.0,0
1939,F8:59:71:5A:E0:3D,2657024,374543229,27141,41627819,2629883,332915410,0,3336,414242,3236,398061,100,16181,3130,0,27160,866,0,31,144444.0,43333.0,-68.0,-74.0,-65.0,-72.0,-67.0,-74.0,-65.0,-71.0,-90.0,-93.0,-90.0,-93.0,22.0,19.0,25.0,21.0,0
1940,CC:2F:71:3E:C5:1F,2635043,333546436,5158,630824,2629885,332915612,6,22139,1856376,18248,1395234,3891,461142,5444,30,7352,133,6,449,144444.0,39000.0,-69.0,-71.0,-69.0,-60.0,-68.0,-70.0,-68.0,-60.0,-90.0,-93.0,-90.0,-93.0,21.0,22.0,21.0,33.0,0
1941,CC:2F:71:3F:1F:24,5803277,5161331685,3173392,4828416073,2629885,332915612,53,715127,458840420,711225,458370286,3902,470134,688030,594,3175485,297694,53,4831,130000.0,43333.0,-71.0,-64.0,-74.0,-68.0,-71.0,-64.0,-73.0,-68.0,-90.0,-93.0,-90.0,-93.0,19.0,29.0,16.0,25.0,0
1942,F8:59:71:5A:E0:3D,2657031,374543895,27141,41627819,2629890,332916076,0,3336,414242,3236,398061,100,16181,3130,0,27160,866,0,31,144444.0,43333.0,-68.0,-74.0,-65.0,-72.0,-67.0,-74.0,-65.0,-71.0,-90.0,-93.0,-90.0,-93.0,22.0,19.0,25.0,21.0,0
1943,CC:2F:71:3E:C5:1F,2635050,333547102,5158,630824,2629892,332916278,6,22139,1856376,18248,1395234,3891,461142,5444,30,7352,133,6,449,144444.0,39000.0,-69.0,-71.0,-69.0,-60.0,-68.0,-70.0,-68.0,-60.0,-90.0,-93.0,-90.0,-93.0,21.0,22.0,21.0,33.0,0
1944,CC:2F:71:3F:1F:24,5808101,5168890265,3178209,4835973987,2629892,332916278,53,715585,458899020,711683,458428886,3902,470134,688488,594,3180285,297885,53,4831,130000.0,43333.0,-71.0,-64.0,-74.0,-68.0,-71.0,-64.0,-73.0,-67.0,-90.0,-93.0,-90.0,-93.0,19.0,29.0,16.0,25.0,0
1945,F8:59:71:5A:E0:3D,2657035,374544299,27141,41627819,2629894,332916480,0,3336,414242,3236,398061,100,16181,3130,0,27160,866,0,31,144444.0,43333.0,-68.0,-74.0,-65.0,-72.0,-67.0,-74.0,-65.0,-71.0,-90.0,-93.0,-90.0,-93.0,22.0,19.0,25.0,21.0,0
1946,CC:2F:71:3E:C5:1F,2635054,333547506,5158,630824,2629896,332916682,6,22139,1856376,18248,1395234,3891,461142,5444,30,7352,133,6,449,144444.0,39000.0,-69.0,-71.0,-69.0,-60.0,-68.0,-70.0,-68.0,-60.0,-90.0,-93.0,-90.0,-93.0,21.0,22.0,21.0,33.0,0
1947,CC:2F:71:3F:1F:24,5812927,5176454249,3183031,4843537567,2629896,332916682,53,716039,458955684,712137,458485550,3902,470134,688942,594,3185124,298236,53,4831,130000.0,43333.0,-71.0,-64.0,-73.0,-67.0,-71.0,-64.0,-73.0,-67.0,-90.0,-93.0,-90.0,-93.0,19.0,29.0,17.0,26.0,0
1948,F8:59:71:5A:E0:3D,2657042,374544965,27141,41627819,2629901,332917146,0,3336,414242,3236,398061,100,16181,3130,0,27160,866,0,31,144444.0,43333.0,-68.0,-74.0,-65.0,-72.0,-67.0,-74.0,-65.0,-71.0,-90.0,-93.0,-90.0,-93.0,22.0,19.0,25.0,21.0,0
1949,CC:2F:71:3E:C5:1F,2635059,333547970,5158,630824,2629901,332917146,6,22139,1856376,18248,1395234,3891,461142,5444,30,7352,133,6,449,144444.0,39000.0,-69.0,-71.0,-69.0,-60.0,-68.0,-70.0,-68.0,-60.0,-90.0,-93.0,-90.0,-93.0,21.0,22.0,21.0,33.0,0
1950,CC:2F:71:3F:1F:24,5818072,5184519073,3188171,4851601927,2629901,332917146,53,716598,459024632,712696,458554498,3902,470134,689501,594,3190205,298444,53,4831,130000.0,43333.0,-71.0,-64.0,-73.0,-68.0,-70.0,-64.0,-73.0,-68.0,-90.0,-93.0,-90.0,-93.0,19.0,29.0,17.0,25.0,0
1951,F8:59:71:5A:E0:3D,2657046,374545369,27141,41627819,2629905,332917550,0,3336,414242,3236,398061,100,16181,3130,0,27160,866,0,31,144444.0,43333.0,-68.0,-74.0,-65.0,-72.0,-67.0,-74.0,-65.0,-71.0,-90.0,-93.0,-90.0,-93.0,22.0,19.0,25.0,21.0,0
1952,CC:2F:71:3E:C5:1F,2635063,333548374,5158,630824,2629905,332917550,6,22139,1856376,18248,1395234,3891,461142,5444,30,7352,133,6,449,144444.0,39000.0,-69.0,-71.0,-69.0,-60.0,-68.0,-70.0,-68.0,-60.0,-90.0,-93.0,-90.0,-93.0,21.0,22.0,21.0,33.0,0
1953,CC:2F:71:3F:1F:24,5822811,5191941593,3192904,4859023841,2629907,332917752,53,717053,459082244,713151,458612110,3902,470134,689956,594,3194997,298685,53,4831,130000.0,43333.0,-71.0,-64.0,-73.0,-68.0,-70.0,-64.0,-73.0,-68.0,-90.0,-93.0,-90.0,-93.0,19.0,29.0,17.0,25.0,0
1954,F8:59:71:5A:E0:3D,2657050,374545773,27141,41627819,2629909,332917954,0,3336,414242,3236,398061,100,16181,3130,0,27160,866,0,31,144444.0,43333.0,-68.0,-74.0,-65.0,-72.0,-67.0,-74.0,-65.0,-71.0,-90.0,-93.0,-90.0,-93.0,22.0,19.0,25.0,21.0,0
1955,CC:2F:71:3E:C5:1F,2635067,333548778,5158,630824,2629909,332917954,6,22139,1856376,18248,1395234,3891,461142,5444,30,7352,133,6,449,144444.0,39000.0,-69.0,-71.0,-69.0,-60.0,-68.0,-70.0,-68.0,-60.0,-90.0,-93.0,-90.0,-93.0,21.0,22.0,21.0,33.0,0
1956,CC:2F:71:3F:1F:24,5825381,5195951883,3195472,4863033929,2629909,332917954,53,717327,459116620,713425,458646486,3902,470134,690230,594,3197565,299052,53,4831,130000.0,43333.0,-71.0,-64.0,-74.0,-68.0,-70.0,-64.0,-73.0,-68.0,-90.0,-93.0,-90.0,-93.0,19.0,29.0,16.0,25.0,0
1957,F8:59:71:5A:E0:3D,2657055,374546237,27141,41627819,2629914,332918418,0,3336,414242,3236,398061,100,16181,3130,0,27160,866,0,31,144444.0,43333.0,-68.0,-74.0,-65.0,-72.0,-67.0,-74.0,-65.0,-71.0,-90.0,-93.0,-90.0,-93.0,22.0,19.0,25.0,21.0,0
1958,CC:2F:71:3E:C5:1F,2635072,333549242,5158,630824,2629914,332918418,6,22139,1856376,18248,1395234,3891,461142,5444,30,7352,133,6,449,144444.0,39000.0,-69.0,-71.0,-69.0,-60.0,-68.0,-70.0,-68.0,-60.0,-90.0,-93.0,-90.0,-93.0,21.0,22.0,21.0,33.0,0
1959,CC:2F:71:3F:1F:24,5827346,5199005195,3197432,4866086777,2629914,332918418,53,717573,459147272,713671,458677138,3902,470134,690476,594,3199499,299052,53,4831,130000.0,43333.0,-71.0,-64.0,-73.0,-68.0,-70.0,-64.0,-73.0,-67.0,-90.0,-93.0,-90.0,-93.0,19.0,29.0,17.0,25.0,0
1960,F8:59:71:5A:E0:3D,2657060,374546914,27141,41627819,2629919,332919095,0,3336,414242,3236,398061,100,16181,3130,0,27160,866,0,31,144444.0,43333.0,-68.0,-74.0,-65.0,-72.0,-67.0,-74.0,-65.0,-71.0,-90.0,-93.0,-90.0,-93.0,22.0,19.0,25.0,21.0,0
1961,CC:2F:71:3E:C5:1F,2635077,333549919,5158,630824,2629919,332919095,6,22139,1856376,18248,1395234,3891,461142,5444,30,7352,133,6,449,144444.0,39000.0,-69.0,-71.0,-69.0,-60.0,-68.0,-70.0,-68.0,-60.0,-90.0,-93.0,-90.0,-93.0,21.0,22.0,21.0,33.0,0
1962,CC:2F:71:3F:1F:24,5833083,5208008584,3203164,4875089489,2629919,332919095,53,718483,459255766,714581,458785632,3902,470134,691383,594,3205257,299455,53,4831,130000.0,39000.0,-71.0,-64.0,-74.0,-68.0,-71.0,-64.0,-73.0,-68.0,-90.0,-93.0,-90.0,-93.0,19.0,29.0,16.0,25.0,0
1963,F8:59:71:5A:E0:3D,2657065,374547378,27141,41627819,2629924,332919559,0,3336,414242,3236,398061,100,16181,3130,0,27160,866,0,31,144444.0,43333.0,-68.0,-74.0,-65.0,-72.0,-67.0,-74.0,-65.0,-71.0,-90.0,-93.0,-90.0,-93.0,22.0,19.0,25.0,21.0,0
1964,CC:2F:71:3E:C5:1F,2635084,333550585,5158,630824,2629926,332919761,6,22139,1856376,18248,1395234,3891,461142,5444,30,7352,133,6,449,144444.0,39000.0,-69.0,-71.0,-69.0,-60.0,-68.0,-70.0,-68.0,-60.0,-90.0,-93.0,-90.0,-93.0,21.0,22.0,21.0,33.0,0
1965,CC:2F:71:3F:1F:24,5837505,5214931520,3207579,4882011759,2629926,332919761,53,718927,459313044,715025,458842910,3902,470134,691825,594,3209658,299535,53,4831,130000.0,43333.0,-71.0,-64.0,-74.0,-68.0,-70.0,-64.0,-73.0,-67.0,-90.0,-93.0,-90.0,-93.0,19.0,29.0,16.0,25.0,0
1966,F8:59:71:5A:E0:3D,2657069,374547782,27141,41627819,2629928,332919963,0,3336,414242,3236,398061,100,16181,3130,0,27160,866,0,31,144444.0,43333.0,-68.0,-74.0,-65.0,-72.0,-67.0,-74.0,-65.0,-71.0,-90.0,-93.0,-90.0,-93.0,22.0,19.0,25.0,21.0,0
1967,CC:2F:71:3E:C5:1F,2635086,333550787,5158,630824,2629928,332919963,6,22139,1856376,18248,1395234,3891,461142,5444,30,7352,133,6,449,144444.0,39000.0,-69.0,-71.0,-69.0,-60.0,-68.0,-70.0,-68.0,-60.0,-90.0,-93.0,-90.0,-93.0,21.0,22.0,21.0,33.0,0
1968,CC:2F:71:3F:1F:24,5842992,5223543740,3213064,4890623777,2629928,332919963,53,719678,459404672,715776,458934538,3902,470134,692576,594,3215103,299834,53,4831,130000.0,43333.0,-71.0,-64.0,-74.0,-68.0,-70.0,-64.0,-73.0,-67.0,-90.0,-93.0,-90.0,-93.0,19.0,29.0,16.0,25.0,0
1969,F8:59:71:5A:E0:3D,2657075,374548388,27141,41627819,2629934,332920569,0,3336,414242,3236,398061,100,16181,3130,0,27160,866,0,31,144444.0,43333.0,-68.0,-74.0,-65.0,-72.0,-67.0,-74.0,-65.0,-71.0,-90.0,-93.0,-90.0,-93.0,22.0,19.0,25.0,21.0,0
1970,CC:2F:71:3E:C5:1F,2635092,333551393,5158,630824,2629934,332920569,6,22139,1856376,18248,1395234,3891,461142,5444,30,7352,133,6,449,144444.0,39000.0,-69.0,-71.0,-69.0,-60.0,-68.0,-70.0,-68.0,-60.0,-90.0,-93.0,-90.0,-93.0,21.0,22.0,21.0,33.0,0
1971,CC:2F:71:3F:1F:24,5847590,5230745852,3217655,4897825223,2629935,332920629,53,720150,459463620,716248,458993486,3902,470134,693048,594,3219690,300053,53,4831,130000.0,43333.0,-71.0,-64.0,-73.0,-68.0,-70.0,-64.0,-73.0,-68.0,-90.0,-93.0,-90.0,-93.0,19.0,29.0,17.0,25.0,0
1972,F8:59:71:5A:E0:3D,2657080,374548852,27141,41627819,2629939,332921033,0,3336,414242,3236,398061,100,16181,3130,0,27160,866,0,31,144444.0,43333.0,-68.0,-74.0,-65.0,-72.0,-67.0,-74.0,-65.0,-71.0,-90.0,-93.0,-90.0,-93.0,22.0,19.0,25.0,21.0,0
1973,CC:2F:71:3E:C5:1F,2635099,333552059,5158,630824,2629941,332921235,6,22139,1856376,18248,1395234,3891,461142,5444,30,7352,133,6,449,144444.0,39000.0,-69.0,-71.0,-69.0,-60.0,-68.0,-70.0,-68.0,-60.0,-90.0,-93.0,-90.0,-93.0,21.0,22.0,21.0,33.0,0
1974,CC:2F:71:3F:1F:24,5852354,5238207438,3222413,4905286203,2629941,332921235,53,720630,459524066,716728,459053932,3902,470134,693521,594,3224496,300198,53,4831,130000.0,43333.0,-71.0,-64.0,-74.0,-68.0,-71.0,-64.0,-73.0,-67.0,-90.0,-93.0,-90.0,-93.0,19.0,29.0,16.0,25.0,0
1975,F8:59:71:5A:E0:3D,2657086,374549458,27141,41627819,2629945,332921639,0,3336,414242,3236,398061,100,16181,3130,0,27160,866,0,31,144444.0,43333.0,-68.0,-74.0,-65.0,-72.0,-67.0,-74.0,-65.0,-71.0,-90.0,-93.0,-90.0,-93.0,22.0,19.0,25.0,21.0,0
1976,CC:2F:71:3E:C5:1F,2635103,333552463,5158,630824,2629945,332921639,6,22139,1856376,18248,1395234,3891,461142,5444,30,7352,133,6,449,144444.0,39000.0,-69.0,-71.0,-69.0,-60.0,-68.0,-70.0,-68.0,-60.0,-90.0,-93.0,-90.0,-93.0,21.0,22.0,21.0,33.0,0
1977,CC:2F:71:3F:1F:24,5856944,5245391428,3226996,4912469361,2629948,332922067,53,721149,459588634,717247,459118500,3902,470134,694019,594,3229074,300516,53,4831,130000.0,43333.0,-69.0,-64.0,-71.0,-68.0,-70.0,-64.0,-73.0,-68.0,-90.0,-93.0,-90.0,-93.0,21.0,29.0,19.0,25.0,0
1978,F8:59:71:5A:E0:3D,2657093,374550290,27141,41627819,2629952,332922471,0,3336,414242,3236,398061,100,16181,3130,0,27160,866,0,31,144444.0,43333.0,-68.0,-74.0,-65.0,-72.0,-67.0,-74.0,-65.0,-71.0,-90.0,-93.0,-90.0,-93.0,22.0,19.0,25.0,21.0,0
1979,CC:2F:71:3E:C5:1F,2635112,333553497,5158,630824,2629954,332922673,6,22139,1856376,18248,1395234,3891,461142,5444,30,7352,133,6,449,144444.0,39000.0,-69.0,-71.0,-69.0,-60.0,-68.0,-70.0,-68.0,-60.0,-90.0,-93.0,-90.0,-93.0,21.0,22.0,21.0,33.0,0
1980,CC:2F:71:3F:1F:24,5861048,5251818774,3231094,4918896101,2629954,332922673,53,721748,459661362,717846,459191228,3902,470134,694610,594,3233141,300679,53,4831,130000.0,43333.0,-72.0,-65.0,-74.0,-69.0,-70.0,-64.0,-73.0,-67.0,-90.0,-93.0,-90.0,-93.0,18.0,28.0,16.0,24.0,0
1981,F8:59:71:5A:E0:3D,2657097,374550694,27141,41627819,2629956,332922875,0,3336,414242,3236,398061,100,16181,3130,0,27160,866,0,31,144444.0,43333.0,-68.0,-74.0,-65.0,-72.0,-67.0,-74.0,-65.0,-71.0,-90.0,-93.0,-90.0,-93.0,22.0,19.0,25.0,21.0,0
1982,CC:2F:71:3E:C5:1F,2635114,333553699,5158,630824,2629956,332922875,6,22139,1856376,18248,1395234,3891,461142,5444,30,7352,133,6,449,144444.0,39000.0,-69.0,-71.0,-69.0,-60.0,-68.0,-70.0,-68.0,-60.0,-90.0,-93.0,-90.0,-93.0,21.0,22.0,21.0,33.0,0
1983,CC:2F:71:3F:1F:24,5865806,5259283656,3235850,4926360781,2629956,332922875,53,722298,459728818,718396,459258684,3902,470134,695160,594,3237856,300905,53,4831,117000.0,39000.0,-71.0,-65.0,-74.0,-68.0,-71.0,-64.0,-73.0,-68.0,-90.0,-93.0,-90.0,-93.0,19.0,28.0,16.0,25.0,0
1984,F8:59:71:5A:E0:3D,2657105,374551476,27142,41627935,2629963,332923541,0,3338,414382,3238,398201,100,16181,3130,0,27161,866,0,31,144444.0,43333.0,-69.0,-67.0,-71.0,-66.0,-68.0,-73.0,-65.0,-71.0,-90.0,-93.0,-90.0,-93.0,21.0,26.0,19.0,27.0,0
1985,CC:2F:71:3E:C5:1F,2635122,333554481,5159,630940,2629963,332923541,6,22141,1856516,18250,1395374,3891,461142,5444,30,7353,133,6,449,144444.0,39000.0,-66.0,-70.0,-64.0,-60.0,-69.0,-71.0,-68.0,-61.0,-90.0,-93.0,-90.0,-93.0,24.0,23.0,26.0,33.0,0
1986,CC:2F:71:3F:1F:24,5870689,5266931300,3240726,4934007759,2629963,332923541,53,722850,459797686,718948,459327552,3902,470134,695706,594,3242805,301111,53,4831,130000.0,43333.0,-71.0,-65.0,-74.0,-68.0,-71.0,-64.0,-73.0,-68.0,-90.0,-93.0,-90.0,-93.0,19.0,28.0,16.0,25.0,0
1987,F8:59:71:5A:E0:3D,2657108,374552349,27143,41628606,2629965,332923743,0,3340,414602,3240,398421,100,16181,3131,0,27162,866,0,31,144444.0,43333.0,-68.0,-74.0,-66.0,-72.0,-68.0,-73.0,-65.0,-71.0,-90.0,-93.0,-90.0,-93.0,22.0,19.0,24.0,21.0,0
1988,CC:2F:71:3E:C5:1F,2635124,333554683,5159,630940,2629965,332923743,6,22141,1856516,18250,1395374,3891,461142,5444,30,7353,133,6,449,144444.0,39000.0,-66.0,-70.0,-64.0,-60.0,-69.0,-71.0,-68.0,-61.0,-90.0,-93.0,-90.0,-93.0,24.0,23.0,26.0,33.0,0
1989,CC:2F:71:3F:1F:24,5875569,5274583874,3245604,4941660131,2629965,332923743,53,723439,459871084,719537,459400950,3902,470134,696294,594,3247697,301305,53,4833,130000.0,39000.0,-71.0,-65.0,-74.0,-69.0,-71.0,-65.0,-74.0,-68.0,-90.0,-93.0,-90.0,-93.0,19.0,28.0,16.0,24.0,0
1990,F8:59:71:5A:E0:3D,2657115,374553015,27143,41628606,2629972,332924409,0,3340,414602,3240,398421,100,16181,3131,0,27162,866,0,31,144444.0,43333.0,-68.0,-74.0,-66.0,-72.0,-68.0,-73.0,-65.0,-71.0,-90.0,-93.0,-90.0,-93.0,22.0,19.0,24.0,21.0,0
1991,CC:2F:71:3E:C5:1F,2635131,333555349,5159,630940,2629972,332924409,6,22141,1856516,18250,1395374,3891,461142,5444,30,7353,133,6,449,144444.0,39000.0,-66.0,-70.0,-64.0,-60.0,-69.0,-71.0,-68.0,-61.0,-90.0,-93.0,-90.0,-93.0,24.0,23.0,26.0,33.0,0
1992,CC:2F:71:3F:1F:24,5879664,5280988939,3249692,4948064530,2629972,332924409,53,723981,459937861,720079,459467727,3902,470134,696836,594,3251785,301556,53,4833,130000.0,43333.0,-71.0,-64.0,-74.0,-68.0,-71.0,-64.0,-73.0,-67.0,-90.0,-93.0,-90.0,-93.0,19.0,29.0,16.0,25.0,0
1993,F8:59:71:5A:E0:3D,2657118,374553490,27143,41628606,2629975,332924884,0,3340,414602,3240,398421,100,16181,3131,0,27162,866,0,31,144444.0,43333.0,-68.0,-74.0,-66.0,-72.0,-68.0,-73.0,-65.0,-71.0,-90.0,-93.0,-90.0,-93.0,22.0,19.0,24.0,21.0,0
1994,CC:2F:71:3E:C5:1F,2635134,333555824,5159,630940,2629975,332924884,6,22141,1856516,18250,1395374,3891,461142,5444,30,7353,133,6,449,144444.0,39000.0,-66.0,-70.0,-64.0,-60.0,-69.0,-71.0,-68.0,-61.0,-90.0,-93.0,-90.0,-93.0,24.0,23.0,26.0,33.0,0
1995,CC:2F:71:3F:1F:24,5885386,5289967188,3255408,4957042034,2629978,332925154,53,724584,460011717,720682,459541583,3902,470134,697434,594,3257501,301986,53,4833,130000.0,39000.0,-71.0,-64.0,-73.0,-68.0,-70.0,-64.0,-72.0,-67.0,-90.0,-93.0,-90.0,-93.0,19.0,29.0,17.0,25.0,0
1996,F8:59:71:5A:E0:3D,2657124,374554096,27143,41628606,2629981,332925490,0,3340,414602,3240,398421,100,16181,3131,0,27162,866,0,31,144444.0,43333.0,-68.0,-74.0,-66.0,-72.0,-68.0,-73.0,-65.0,-71.0,-90.0,-93.0,-90.0,-93.0,22.0,19.0,24.0,21.0,0
1997,CC:2F:71:3E:C5:1F,2635140,333556430,5159,630940,2629981,332925490,6,22141,1856516,18250,1395374,3891,461142,5444,30,7353,133,6,449,144444.0,39000.0,-66.0,-70.0,-64.0,-60.0,-69.0,-71.0,-68.0,-61.0,-90.0,-93.0,-90.0,-93.0,24.0,23.0,26.0,33.0,0
1998,CC:2F:71:3F:1F:24,5890132,5297403744,3260149,4964478052,2629983,332925692,53,725093,460075575,721191,459605441,3902,470134,697939,594,3262242,302401,53,4833,130000.0,43333.0,-71.0,-65.0,-74.0,-68.0,-70.0,-65.0,-73.0,-68.0,-90.0,-93.0,-90.0,-93.0,19.0,28.0,16.0,25.0,0
1999,F8:59:71:5A:E0:3D,2657128,374554420,27143,41628606,2629985,332925814,0,3342,414790,3241,398491,101,16299,3132,0,27162,866,0,31,144444.0,43333.0,-68.0,-74.0,-65.0,-72.0,-67.0,-71.0,-65.0,-70.0,-90.0,-93.0,-90.0,-93.0,22.0,19.0,25.0,21.0,0
2000,CC:2F:71:3E:C5:1F,2635148,333557158,5159,630940,2629989,332926218,6,22141,1856516,18250,1395374,3891,461142,5444,30,7353,133,6,449,144444.0,39000.0,-66.0,-70.0,-64.0,-60.0,-69.0,-71.0,-68.0,-61.0,-90.0,-93.0,-90.0,-93.0,24.0,23.0,26.0,33.0,0
2001,CC:2F:71:3F:1F:24,5894759,5304650326,3264768,4971723906,2629991,332926420,53,725580,460136615,721678,459666481,3902,470134,698426,594,3266845,302510,53,4833,130000.0,43333.0,-71.0,-64.0,-73.0,-68.0,-71.0,-64.0,-73.0,-67.0,-90.0,-93.0,-90.0,-93.0,19.0,29.0,17.0,25.0,0
2002,F8:59:71:5A:E0:3D,2657137,374555290,27143,41628606,2629994,332926684,0,3342,414790,3241,398491,101,16299,3132,0,27162,866,0,31,144444.0,43333.0,-68.0,-74.0,-65.0,-72.0,-67.0,-71.0,-65.0,-70.0,-90.0,-93.0,-90.0,-93.0,22.0,19.0,25.0,21.0,0
2003,CC:2F:71:3E:C5:1F,2635154,333557686,5159,630940,2629995,332926746,6,22142,1856634,18250,1395374,3892,461260,5445,30,7353,133,6,449,144444.0,39000.0,-69.0,-71.0,-69.0,-60.0,-69.0,-71.0,-68.0,-61.0,-90.0,-93.0,-90.0,-93.0,21.0,22.0,21.0,33.0,0
2004,CC:2F:71:3F:1F:24,5901530,5315287306,3271535,4982360560,2629995,332926746,53,726660,460266439,722757,459796187,3903,470252,699506,594,3273628,303007,53,4833,130000.0,43333.0,-71.0,-65.0,-74.0,-68.0,-71.0,-64.0,-73.0,-68.0,-90.0,-93.0,-90.0,-93.0,19.0,28.0,16.0,25.0,0
2005,F8:59:71:5A:E0:3D,2657145,374556018,27143,41628606,2630002,332927412,0,3342,414790,3241,398491,101,16299,3132,0,27162,866,0,31,144444.0,43333.0,-68.0,-74.0,-65.0,-72.0,-67.0,-71.0,-65.0,-70.0,-90.0,-93.0,-90.0,-93.0,22.0,19.0,25.0,21.0,0
2006,CC:2F:71:3E:C5:1F,2635161,333558352,5159,630940,2630002,332927412,6,22143,1856704,18251,1395444,3892,461260,5445,30,7353,133,6,449,144444.0,39000.0,-66.0,-61.0,-67.0,-60.0,-69.0,-70.0,-68.0,-61.0,-90.0,-93.0,-90.0,-93.0,24.0,32.0,23.0,33.0,0
2007,CC:2F:71:3F:1F:24,5905641,5321722604,3275639,4988795192,2630002,332927412,53,727089,460321359,723186,459851107,3903,470252,699935,594,3277700,303110,53,4833,130000.0,43333.0,-71.0,-65.0,-73.0,-68.0,-71.0,-65.0,-73.0,-68.0,-90.0,-93.0,-90.0,-93.0,19.0,28.0,17.0,25.0,0
2008,F8:59:71:5A:E0:3D,2657147,374556220,27143,41628606,2630004,332927614,0,3342,414790,3241,398491,101,16299,3132,0,27162,866,0,31,144444.0,43333.0,-68.0,-74.0,-65.0,-72.0,-67.0,-71.0,-65.0,-70.0,-90.0,-93.0,-90.0,-93.0,22.0,19.0,25.0,21.0,0
2009,CC:2F:71:3E:C5:1F,2635174,333563978,5159,630940,2630015,332933038,6,22143,1856704,18251,1395444,3892,461260,5445,30,7353,133,6,449,144444.0,39000.0,-66.0,-61.0,-67.0,-60.0,-69.0,-70.0,-68.0,-61.0,-90.0,-93.0,-90.0,-93.0,24.0,32.0,23.0,33.0,0
2010,CC:2F:71:3F:1F:24,5913233,5333618152,3283201,5000679084,2630032,332939068,53,728011,460433549,724108,459963297,3903,470252,700854,594,3285215,303466,53,4833,130000.0,43333.0,-71.0,-64.0,-73.0,-68.0,-70.0,-64.0,-73.0,-67.0,-90.0,-93.0,-90.0,-93.0,19.0,29.0,17.0,25.0,0
2011,F8:59:71:5A:E0:3D,2657180,374568146,27143,41628606,2630037,332939540,0,3345,415182,3242,398561,103,16621,3134,0,27162,866,0,31,144444.0,43333.0,-66.0,-64.0,-65.0,-66.0,-67.0,-70.0,-65.0,-69.0,-90.0,-93.0,-90.0,-93.0,24.0,29.0,25.0,27.0,0
2012,CC:2F:71:3E:C5:1F,2635196,333570480,5159,630940,2630037,332939540,6,22143,1856704,18251,1395444,3892,461260,5445,30,7353,133,6,449,144444.0,39000.0,-66.0,-61.0,-67.0,-60.0,-69.0,-70.0,-68.0,-61.0,-90.0,-93.0,-90.0,-93.0,24.0,32.0,23.0,33.0,0
2013,CC:2F:71:3F:1F:24,5917625,5340494038,3287588,5007554498,2630037,332939540,53,728436,460487693,724533,460017441,3903,470252,701279,594,3289661,303558,53,4833,130000.0,43333.0,-71.0,-64.0,-74.0,-68.0,-70.0,-64.0,-74.0,-67.0,-90.0,-93.0,-90.0,-93.0,19.0,29.0,16.0,25.0,0
2014,F8:59:71:5A:E0:3D,2657186,374568752,27143,41628606,2630043,332940146,0,3345,415182,3242,398561,103,16621,3134,0,27162,866,0,31,144444.0,43333.0,-66.0,-64.0,-65.0,-66.0,-67.0,-70.0,-65.0,-69.0,-90.0,-93.0,-90.0,-93.0,24.0,29.0,25.0,27.0,0
2015,CC:2F:71:3E:C5:1F,2635202,333571086,5159,630940,2630043,332940146,6,22143,1856704,18251,1395444,3892,461260,5445,30,7353,133,6,449,144444.0,39000.0,-66.0,-61.0,-67.0,-60.0,-69.0,-70.0,-68.0,-61.0,-90.0,-93.0,-90.0,-93.0,24.0,32.0,23.0,33.0,0
2016,CC:2F:71:3F:1F:24,5923616,5349890670,3293573,5016950524,2630043,332940146,53,729136,460574497,725233,460104245,3903,470252,701971,594,3295666,303890,53,4834,130000.0,43333.0,-71.0,-64.0,-73.0,-68.0,-70.0,-64.0,-73.0,-68.0,-90.0,-93.0,-90.0,-93.0,19.0,29.0,17.0,25.0,0
2017,F8:59:71:5A:E0:3D,2657189,374569014,27143,41628606,2630046,332940408,0,3345,415182,3242,398561,103,16621,3134,0,27162,866,0,31,144444.0,43333.0,-66.0,-64.0,-65.0,-66.0,-67.0,-70.0,-65.0,-69.0,-90.0,-93.0,-90.0,-93.0,24.0,29.0,25.0,27.0,0
2018,CC:2F:71:3E:C5:1F,2635205,333571348,5159,630940,2630046,332940408,6,22143,1856704,18251,1395444,3892,461260,5445,30,7353,133,6,449,144444.0,39000.0,-66.0,-61.0,-67.0,-60.0,-69.0,-70.0,-68.0,-61.0,-90.0,-93.0,-90.0,-93.0,24.0,32.0,23.0,33.0,0
2019,CC:2F:71:3F:1F:24,5927919,5356634340,3297873,5023693932,2630046,332940408,53,729608,460633783,725705,460163531,3903,470252,702441,594,3299934,303953,53,4834,130000.0,43333.0,-71.0,-64.0,-74.0,-68.0,-71.0,-64.0,-73.0,-67.0,-90.0,-93.0,-90.0,-93.0,19.0,29.0,16.0,25.0,0
2020,F8:59:71:5A:E0:3D,2657195,374569620,27143,41628606,2630052,332941014,0,3345,415182,3242,398561,103,16621,3134,0,27162,866,0,31,144444.0,43333.0,-66.0,-64.0,-65.0,-66.0,-67.0,-70.0,-65.0,-69.0,-90.0,-93.0,-90.0,-93.0,24.0,29.0,25.0,27.0,0
2021,CC:2F:71:3E:C5:1F,2635211,333571954,5159,630940,2630052,332941014,6,22143,1856704,18251,1395444,3892,461260,5445,30,7353,133,6,449,144444.0,39000.0,-66.0,-61.0,-67.0,-60.0,-69.0,-70.0,-68.0,-61.0,-90.0,-93.0,-90.0,-93.0,24.0,32.0,23.0,33.0,0
2022,CC:2F:71:3F:1F:24,5933247,5364989974,3303195,5032048960,2630052,332941014,53,730182,460706259,726279,460236007,3903,470252,703014,594,3305189,304459,53,4835,117000.0,39000.0,-70.0,-64.0,-73.0,-68.0,-70.0,-64.0,-73.0,-67.0,-90.0,-93.0,-90.0,-93.0,20.0,29.0,17.0,25.0,0
2023,F8:59:71:5A:E0:3D,2657198,374569882,27143,41628606,2630055,332941276,0,3345,415182,3242,398561,103,16621,3134,0,27162,866,0,31,144444.0,43333.0,-66.0,-64.0,-65.0,-66.0,-67.0,-70.0,-65.0,-69.0,-90.0,-93.0,-90.0,-93.0,24.0,29.0,25.0,27.0,0
2024,CC:2F:71:3E:C5:1F,2635214,333572216,5159,630940,2630055,332941276,6,22143,1856704,18251,1395444,3892,461260,5445,30,7353,133,6,449,144444.0,39000.0,-66.0,-61.0,-67.0,-60.0,-69.0,-70.0,-68.0,-61.0,-90.0,-93.0,-90.0,-93.0,24.0,32.0,23.0,33.0,0
2025,CC:2F:71:3F:1F:24,5936354,5369840848,3306295,5036899168,2630059,332941680,53,730522,460750281,726619,460280029,3903,470252,703354,594,3308293,304621,53,4835,130000.0,43333.0,-70.0,-64.0,-73.0,-68.0,-70.0,-64.0,-73.0,-67.0,-90.0,-93.0,-90.0,-93.0,20.0,29.0,17.0,25.0,0
2026,F8:59:71:5A:E0:3D,2657205,374570761,27143,41628606,2630062,332942155,0,3345,415182,3242,398561,103,16621,3134,0,27162,866,0,31,144444.0,43333.0,-66.0,-64.0,-65.0,-66.0,-67.0,-70.0,-65.0,-69.0,-90.0,-93.0,-90.0,-93.0,24.0,29.0,25.0,27.0,0
2027,CC:2F:71:3E:C5:1F,2635221,333573095,5159,630940,2630062,332942155,6,22143,1856704,18251,1395444,3892,461260,5445,30,7353,133,6,449,144444.0,39000.0,-66.0,-61.0,-67.0,-60.0,-69.0,-70.0,-68.0,-61.0,-90.0,-93.0,-90.0,-93.0,24.0,32.0,23.0,33.0,0
2028,CC:2F:71:3F:1F:24,5941510,5377920323,3311446,5044977966,2630064,332942357,53,731115,460824727,727212,460354475,3903,470252,703947,594,3313539,304765,53,4835,130000.0,43333.0,-71.0,-64.0,-74.0,-68.0,-71.0,-64.0,-73.0,-67.0,-90.0,-93.0,-90.0,-93.0,19.0,29.0,16.0,25.0,0
2029,F8:59:71:5A:E0:3D,2657211,374571367,27143,41628606,2630068,332942761,0,3345,415182,3242,398561,103,16621,3134,0,27162,866,0,31,144444.0,43333.0,-66.0,-64.0,-65.0,-66.0,-67.0,-70.0,-65.0,-69.0,-90.0,-93.0,-89.0,-92.0,24.0,29.0,24.0,26.0,0
2030,CC:2F:71:3E:C5:1F,2635227,333573701,5159,630940,2630068,332942761,6,22143,1856704,18251,1395444,3892,461260,5445,30,7353,133,6,449,144444.0,39000.0,-66.0,-61.0,-67.0,-60.0,-69.0,-70.0,-68.0,-61.0,-90.0,-93.0,-89.0,-92.0,24.0,32.0,22.0,32.0,0
2031,CC:2F:71:3F:1F:24,5945291,5383838099,3315222,5050895278,2630069,332942821,53,731542,460877581,727639,460407329,3903,470252,704373,594,3317301,305029,53,4835,130000.0,43333.0,-71.0,-64.0,-74.0,-67.0,-70.0,-64.0,-73.0,-67.0,-90.0,-93.0,-89.0,-92.0,19.0,29.0,15.0,25.0,0
2032,F8:59:71:5A:E0:3D,2657214,374571629,27143,41628606,2630071,332943023,0,3345,415182,3242,398561,103,16621,3134,0,27162,866,0,31,144444.0,43333.0,-66.0,-64.0,-65.0,-66.0,-67.0,-70.0,-65.0,-69.0,-90.0,-93.0,-89.0,-92.0,24.0,29.0,24.0,26.0,0
2033,CC:2F:71:3E:C5:1F,2635232,333574165,5159,630940,2630073,332943225,6,22143,1856704,18251,1395444,3892,461260,5445,30,7353,133,6,449,144444.0,39000.0,-66.0,-61.0,-67.0,-60.0,-69.0,-70.0,-68.0,-61.0,-90.0,-93.0,-89.0,-92.0,24.0,32.0,22.0,32.0,0
2034,CC:2F:71:3F:1F:24,5949341,5390178715,3319268,5057235490,2630073,332943225,53,732027,460939001,728124,460468749,3903,470252,704857,594,3321347,305136,53,4835,130000.0,43333.0,-71.0,-64.0,-73.0,-68.0,-70.0,-64.0,-72.0,-67.0,-90.0,-93.0,-89.0,-92.0,19.0,29.0,16.0,24.0,0
2035,F8:59:71:5A:E0:3D,2657222,374572437,27143,41628606,2630079,332943831,0,3345,415182,3242,398561,103,16621,3134,0,27162,866,0,31,144444.0,43333.0,-66.0,-64.0,-65.0,-66.0,-67.0,-70.0,-65.0,-69.0,-90.0,-93.0,-89.0,-92.0,24.0,29.0,24.0,26.0,0
2036,CC:2F:71:3E:C5:1F,2635238,333574771,5159,630940,2630079,332943831,6,22143,1856704,18251,1395444,3892,461260,5445,30,7353,133,6,449,144444.0,39000.0,-66.0,-61.0,-67.0,-60.0,-69.0,-70.0,-68.0,-61.0,-90.0,-93.0,-89.0,-92.0,24.0,32.0,22.0,32.0,0
2037,CC:2F:71:3F:1F:24,5953672,5396959039,3323593,5064015208,2630079,332943831,53,732548,461005283,728645,460535031,3903,470252,705378,594,3325609,306530,53,4835,86667.0,14444.0,-72.0,-65.0,-73.0,-68.0,-74.0,-67.0,-75.0,-71.0,-90.0,-93.0,-89.0,-92.0,18.0,28.0,16.0,24.0,0
2038,F8:59:71:5A:E0:3D,2657225,374572699,27143,41628606,2630082,332944093,0,3345,415182,3242,398561,103,16621,3134,0,27162,866,0,31,144444.0,43333.0,-66.0,-64.0,-65.0,-66.0,-67.0,-70.0,-65.0,-69.0,-90.0,-93.0,-89.0,-92.0,24.0,29.0,24.0,26.0,0
2039,CC:2F:71:3E:C5:1F,2635243,333575235,5159,630940,2630084,332944295,6,22143,1856704,18251,1395444,3892,461260,5445,30,7353,133,6,449,144444.0,39000.0,-66.0,-61.0,-67.0,-60.0,-69.0,-70.0,-68.0,-61.0,-90.0,-93.0,-89.0,-92.0,24.0,32.0,22.0,32.0,0
2040,CC:2F:71:3F:1F:24,5959042,5405371415,3328956,5072426918,2630086,332944497,53,733446,461114787,729543,460644535,3903,470252,706276,594,3331049,306642,53,4836,86667.0,14444.0,-73.0,-66.0,-75.0,-70.0,-72.0,-65.0,-74.0,-69.0,-90.0,-93.0,-89.0,-92.0,17.0,27.0,14.0,22.0,0
2041,F8:59:71:5A:E0:3D,2657231,374573305,27143,41628606,2630088,332944699,0,3345,415182,3242,398561,103,16621,3134,0,27162,866,0,31,144444.0,43333.0,-66.0,-64.0,-65.0,-66.0,-67.0,-70.0,-65.0,-69.0,-90.0,-93.0,-89.0,-92.0,24.0,29.0,24.0,26.0,0
2042,CC:2F:71:3E:C5:1F,2635247,333575639,5159,630940,2630088,332944699,6,22143,1856704,18251,1395444,3892,461260,5445,30,7353,133,6,449,144444.0,39000.0,-66.0,-61.0,-67.0,-60.0,-69.0,-70.0,-68.0,-61.0,-90.0,-93.0,-89.0,-92.0,24.0,32.0,22.0,32.0,0
2043,CC:2F:71:3F:1F:24,5962460,5410717615,3332370,5077772714,2630090,332944901,53,733928,461174933,730025,460704681,3903,470252,706758,594,3334436,306779,53,4837,130000.0,43333.0,-73.0,-66.0,-75.0,-69.0,-72.0,-66.0,-75.0,-69.0,-90.0,-93.0,-89.0,-92.0,17.0,27.0,14.0,23.0,0
2044,F8:59:71:5A:E0:3D,2657238,374573971,27143,41628606,2630095,332945365,0,3345,415182,3242,398561,103,16621,3134,0,27162,866,0,31,144444.0,43333.0,-66.0,-64.0,-65.0,-66.0,-67.0,-70.0,-65.0,-69.0,-90.0,-93.0,-89.0,-92.0,24.0,29.0,24.0,26.0,0
2045,CC:2F:71:3E:C5:1F,2635254,333576305,5159,630940,2630095,332945365,6,22143,1856704,18251,1395444,3892,461260,5445,30,7353,133,6,449,144444.0,39000.0,-66.0,-61.0,-67.0,-60.0,-69.0,-70.0,-68.0,-61.0,-90.0,-93.0,-89.0,-92.0,24.0,32.0,22.0,32.0,0
2046,CC:2F:71:3F:1F:24,5967078,5417955913,3336983,5085010548,2630095,332945365,53,734607,461258947,730704,460788695,3903,470252,707435,594,3339049,306857,53,4837,130000.0,43333.0,-73.0,-66.0,-74.0,-70.0,-73.0,-67.0,-75.0,-71.0,-90.0,-93.0,-89.0,-92.0,17.0,27.0,15.0,22.0,0
2047,F8:59:71:5A:E0:3D,2657240,374574173,27143,41628606,2630097,332945567,0,3345,415182,3242,398561,103,16621,3134,0,27162,866,0,31,144444.0,43333.0,-66.0,-64.0,-65.0,-66.0,-67.0,-70.0,-65.0,-69.0,-90.0,-93.0,-89.0,-92.0,24.0,29.0,24.0,26.0,0
2048,CC:2F:71:3E:C5:1F,2635258,333576709,5159,630940,2630099,332945769,6,22143,1856704,18251,1395444,3892,461260,5445,30,7353,133,6,449,144444.0,39000.0,-66.0,-61.0,-67.0,-60.0,-69.0,-70.0,-68.0,-61.0,-90.0,-93.0,-89.0,-92.0,24.0,32.0,22.0,32.0,0
2049,CC:2F:71:3F:1F:24,5971808,5425369417,3341709,5092423648,2630099,332945769,53,735218,461334051,731315,460863799,3903,470252,708046,594,3343802,307710,53,4837,115556.0,28889.0,-71.0,-65.0,-73.0,-68.0,-71.0,-65.0,-73.0,-68.0,-90.0,-93.0,-90.0,-93.0,19.0,28.0,17.0,25.0,0
2050,F8:59:71:5A:E0:3D,2657248,374574955,27144,41628722,2630104,332946233,0,3347,415322,3244,398701,103,16621,3134,0,27163,866,0,31,130000.0,39000.0,-68.0,-75.0,-66.0,-72.0,-67.0,-71.0,-65.0,-70.0,-90.0,-93.0,-90.0,-93.0,22.0,18.0,24.0,21.0,0
2051,CC:2F:71:3E:C5:1F,2635264,333577289,5160,631056,2630104,332946233,6,22145,1856844,18253,1395584,3892,461260,5445,30,7354,133,6,449,144444.0,39000.0,-77.0,-85.0,-75.0,-72.0,-70.0,-73.0,-69.0,-63.0,-90.0,-93.0,-90.0,-93.0,13.0,8.0,15.0,21.0,0
2052,CC:2F:71:3F:1F:24,5977700,5434610905,3347596,5101664672,2630104,332946233,53,736030,461433433,732127,460963181,3903,470252,708852,594,3349539,308030,53,4837,117000.0,39000.0,-71.0,-64.0,-72.0,-69.0,-71.0,-64.0,-72.0,-68.0,-90.0,-93.0,-90.0,-93.0,19.0,29.0,18.0,24.0,0
2053,F8:59:71:5A:E0:3D,2657252,374575359,27144,41628722,2630108,332946637,0,3347,415322,3244,398701,103,16621,3134,0,27163,866,0,31,130000.0,39000.0,-68.0,-75.0,-66.0,-72.0,-67.0,-71.0,-65.0,-70.0,-90.0,-93.0,-90.0,-93.0,22.0,18.0,24.0,21.0,0
2054,CC:2F:71:3E:C5:1F,2635268,333577693,5160,631056,2630108,332946637,6,22145,1856844,18253,1395584,3892,461260,5445,30,7354,133,6,449,144444.0,39000.0,-77.0,-85.0,-75.0,-72.0,-70.0,-73.0,-69.0,-63.0,-90.0,-93.0,-90.0,-93.0,13.0,8.0,15.0,21.0,0
2055,CC:2F:71:3F:1F:24,5981764,5440973277,3351656,5108026640,2630108,332946637,53,736503,461493307,732600,461023055,3903,470252,709320,594,3353732,308476,53,4838,130000.0,43333.0,-71.0,-65.0,-73.0,-68.0,-71.0,-65.0,-73.0,-68.0,-90.0,-93.0,-90.0,-93.0,19.0,28.0,17.0,25.0,0
2056,F8:59:71:5A:E0:3D,2657256,374575763,27144,41628722,2630112,332947041,0,3347,415322,3244,398701,103,16621,3134,0,27163,866,0,31,130000.0,39000.0,-68.0,-75.0,-66.0,-72.0,-67.0,-71.0,-65.0,-70.0,-90.0,-93.0,-90.0,-93.0,22.0,18.0,24.0,21.0,0
2057,CC:2F:71:3E:C5:1F,2635272,333578097,5160,631056,2630112,332947041,6,22145,1856844,18253,1395584,3892,461260,5445,30,7354,133,6,449,144444.0,39000.0,-77.0,-85.0,-75.0,-72.0,-70.0,-73.0,-69.0,-63.0,-90.0,-93.0,-90.0,-93.0,13.0,8.0,15.0,21.0,0
2058,CC:2F:71:3F:1F:24,5984376,5445048779,3354263,5112101678,2630113,332947101,53,736973,461550733,733070,461080481,3903,470252,709789,594,3356356,309216,53,4838,130000.0,43333.0,-71.0,-64.0,-73.0,-69.0,-70.0,-64.0,-72.0,-68.0,-90.0,-93.0,-90.0,-93.0,19.0,29.0,17.0,24.0,0
2059,F8:59:71:5A:E0:3D,2657261,374576227,27144,41628722,2630117,332947505,0,3347,415322,3244,398701,103,16621,3134,0,27163,866,0,31,130000.0,39000.0,-68.0,-75.0,-66.0,-72.0,-67.0,-71.0,-65.0,-70.0,-90.0,-93.0,-90.0,-93.0,22.0,18.0,24.0,21.0,0
2060,CC:2F:71:3E:C5:1F,2635277,333578561,5160,631056,2630117,332947505,6,22145,1856844,18253,1395584,3892,461260,5445,30,7354,133,6,449,144444.0,39000.0,-77.0,-85.0,-75.0,-72.0,-70.0,-73.0,-69.0,-63.0,-90.0,-93.0,-90.0,-93.0,13.0,8.0,15.0,21.0,0
2061,CC:2F:71:3F:1F:24,5987978,5450683735,3357857,5117735826,2630121,332947909,53,737487,461613639,733584,461143387,3903,470252,710303,594,3359910,309399,53,4838,130000.0,43333.0,-71.0,-65.0,-73.0,-69.0,-71.0,-64.0,-73.0,-68.0,-90.0,-93.0,-90.0,-93.0,19.0,28.0,17.0,24.0,0
2062,F8:59:71:5A:E0:3D,2657268,374577106,27144,41628722,2630124,332948384,0,3347,415322,3244,398701,103,16621,3134,0,27163,866,0,31,130000.0,39000.0,-68.0,-75.0,-66.0,-72.0,-67.0,-71.0,-65.0,-70.0,-90.0,-93.0,-90.0,-93.0,22.0,18.0,24.0,21.0,0
2063,CC:2F:71:3E:C5:1F,2635284,333579440,5160,631056,2630124,332948384,6,22145,1856844,18253,1395584,3892,461260,5445,30,7354,133,6,449,144444.0,39000.0,-77.0,-85.0,-75.0,-72.0,-70.0,-73.0,-69.0,-63.0,-90.0,-93.0,-90.0,-93.0,13.0,8.0,15.0,21.0,0
2064,CC:2F:71:3F:1F:24,5994997,5461709816,3364871,5128761230,2630126,332948586,53,738552,461740371,734649,461270119,3903,470252,711368,594,3366964,310114,53,4838,130000.0,43333.0,-71.0,-64.0,-74.0,-69.0,-71.0,-64.0,-74.0,-68.0,-90.0,-93.0,-90.0,-93.0,19.0,29.0,16.0,24.0,0
2065,F8:59:71:5A:E0:3D,2657275,374577772,27144,41628722,2630131,332949050,0,3347,415322,3244,398701,103,16621,3134,0,27163,866,0,31,130000.0,39000.0,-68.0,-75.0,-66.0,-72.0,-67.0,-71.0,-65.0,-70.0,-90.0,-93.0,-90.0,-93.0,22.0,18.0,24.0,21.0,0
2066,CC:2F:71:3E:C5:1F,2635291,333580106,5160,631056,2630131,332949050,6,22145,1856844,18253,1395584,3892,461260,5445,30,7354,133,6,449,144444.0,39000.0,-77.0,-85.0,-75.0,-72.0,-70.0,-73.0,-69.0,-63.0,-90.0,-93.0,-90.0,-93.0,13.0,8.0,15.0,21.0,0
2067,CC:2F:71:3F:1F:24,5999984,5469526708,3369853,5136577658,2630131,332949050,53,738962,461794003,735059,461323751,3903,470252,711776,594,3371870,311378,53,4838,115556.0,28889.0,-70.0,-66.0,-75.0,-69.0,-70.0,-66.0,-74.0,-68.0,-90.0,-93.0,-90.0,-93.0,20.0,27.0,15.0,24.0,0
2068,F8:59:71:5A:E0:3D,2657285,374578702,27144,41628722,2630141,332949980,0,3349,415510,3245,398771,104,16739,3135,0,27163,866,0,31,130000.0,39000.0,-68.0,-74.0,-65.0,-72.0,-67.0,-72.0,-65.0,-71.0,-90.0,-93.0,-90.0,-93.0,22.0,19.0,25.0,21.0,0
2069,CC:2F:71:3E:C5:1F,2635301,333581036,5160,631056,2630141,332949980,6,22145,1856844,18253,1395584,3892,461260,5445,30,7354,133,6,449,144444.0,39000.0,-77.0,-85.0,-75.0,-72.0,-70.0,-73.0,-69.0,-63.0,-90.0,-93.0,-90.0,-93.0,13.0,8.0,15.0,21.0,0
2070,CC:2F:71:3F:1F:24,6005453,5478099412,3375312,5145149432,2630141,332949980,53,739715,461887383,735812,461417131,3903,470252,712509,594,3377350,312660,53,4838,86667.0,13000.0,-71.0,-65.0,-74.0,-69.0,-70.0,-65.0,-74.0,-68.0,-90.0,-93.0,-90.0,-93.0,19.0,28.0,16.0,24.0,0
2071,F8:59:71:5A:E0:3D,2657290,374579168,27144,41628722,2630146,332950446,0,3349,415510,3245,398771,104,16739,3135,0,27163,866,0,31,130000.0,39000.0,-68.0,-74.0,-65.0,-72.0,-67.0,-72.0,-65.0,-71.0,-90.0,-93.0,-90.0,-93.0,22.0,19.0,25.0,21.0,0
2072,CC:2F:71:3E:C5:1F,2635306,333581502,5160,631056,2630146,332950446,6,22147,1857032,18254,1395654,3893,461378,5446,30,7354,133,6,449,144444.0,39000.0,-69.0,-71.0,-69.0,-60.0,-70.0,-73.0,-69.0,-63.0,-90.0,-93.0,-90.0,-93.0,21.0,22.0,21.0,33.0,0
2073,CC:2F:71:3F:1F:24,6011066,5486897222,3380915,5153946310,2630151,332950912,53,740782,462015881,736878,461545511,3904,470370,713513,594,3382932,312907,53,4838,104000.0,26000.0,-70.0,-65.0,-75.0,-69.0,-70.0,-65.0,-74.0,-68.0,-90.0,-93.0,-90.0,-93.0,20.0,28.0,15.0,24.0,0
2074,F8:59:71:5A:E0:3D,2657301,374580390,27144,41628722,2630157,332951668,0,3349,415510,3245,398771,104,16739,3135,0,27163,866,0,31,130000.0,39000.0,-68.0,-74.0,-65.0,-72.0,-67.0,-72.0,-65.0,-71.0,-90.0,-93.0,-90.0,-93.0,22.0,19.0,25.0,21.0,0
2075,CC:2F:71:3E:C5:1F,2635323,333583330,5160,631056,2630163,332952274,6,22147,1857032,18254,1395654,3893,461378,5446,30,7354,133,6,449,144444.0,39000.0,-69.0,-71.0,-69.0,-60.0,-70.0,-73.0,-69.0,-63.0,-90.0,-93.0,-90.0,-93.0,21.0,22.0,21.0,33.0,0
2076,CC:2F:71:3F:1F:24,6016910,5496054936,3386747,5163102662,2630163,332952274,61,741559,462111385,737655,461641015,3904,470370,714285,594,3388840,315505,61,4838,86667.0,14444.0,-71.0,-66.0,-75.0,-68.0,-70.0,-65.0,-74.0,-68.0,-90.0,-93.0,-90.0,-93.0,19.0,27.0,15.0,25.0,0
2077,F8:59:71:5A:E0:3D,2657309,374581198,27144,41628722,2630165,332952476,0,3349,415510,3245,398771,104,16739,3135,0,27163,866,0,31,130000.0,39000.0,-68.0,-74.0,-65.0,-72.0,-67.0,-72.0,-65.0,-71.0,-90.0,-93.0,-90.0,-93.0,22.0,19.0,25.0,21.0,0
2078,CC:2F:71:3E:C5:1F,2635330,333583996,5160,631056,2630170,332952940,6,22147,1857032,18254,1395654,3893,461378,5446,30,7354,133,6,449,144444.0,39000.0,-69.0,-71.0,-69.0,-60.0,-70.0,-73.0,-69.0,-63.0,-90.0,-93.0,-90.0,-93.0,21.0,22.0,21.0,33.0,0
2079,CC:2F:71:3F:1F:24,6021310,5502941522,3391138,5169988380,2630172,332953142,64,742293,462199845,738389,461729475,3904,470370,715000,595,3393232,315638,64,4840,115556.0,28889.0,-71.0,-66.0,-75.0,-69.0,-72.0,-67.0,-76.0,-70.0,-90.0,-93.0,-90.0,-93.0,19.0,27.0,15.0,24.0,0
2080,F8:59:71:5A:E0:3D,2657318,374582066,27144,41628722,2630174,332953344,0,3349,415510,3245,398771,104,16739,3135,0,27163,866,0,31,130000.0,39000.0,-68.0,-74.0,-65.0,-72.0,-67.0,-72.0,-65.0,-71.0,-90.0,-93.0,-90.0,-93.0,22.0,19.0,25.0,21.0,0
2081,CC:2F:71:3E:C5:1F,2635334,333584400,5160,631056,2630174,332953344,6,22147,1857032,18254,1395654,3893,461378,5446,30,7354,133,6,449,144444.0,39000.0,-69.0,-71.0,-69.0,-60.0,-70.0,-73.0,-69.0,-63.0,-90.0,-93.0,-90.0,-93.0,21.0,22.0,21.0,33.0,0
2082,CC:2F:71:3F:1F:24,6024862,5508501638,3394686,5175548092,2630176,332953546,64,742839,462267519,738935,461797149,3904,470370,715544,595,3396764,316097,64,4841,115556.0,28889.0,-71.0,-66.0,-75.0,-69.0,-71.0,-66.0,-75.0,-69.0,-90.0,-93.0,-90.0,-93.0,19.0,27.0,15.0,24.0,0
2083,F8:59:71:5A:E0:3D,2657325,374582732,27144,41628722,2630181,332954010,0,3349,415510,3245,398771,104,16739,3135,0,27163,866,0,31,130000.0,39000.0,-68.0,-74.0,-65.0,-72.0,-67.0,-72.0,-65.0,-71.0,-90.0,-93.0,-90.0,-93.0,22.0,19.0,25.0,21.0,0
2084,CC:2F:71:3E:C5:1F,2635341,333585066,5160,631056,2630181,332954010,6,22147,1857032,18254,1395654,3893,461378,5446,30,7354,133,6,449,144444.0,39000.0,-69.0,-71.0,-69.0,-60.0,-70.0,-73.0,-69.0,-63.0,-90.0,-93.0,-90.0,-93.0,21.0,22.0,21.0,33.0,0
2085,CC:2F:71:3F:1F:24,6028835,5514725022,3398654,5181771012,2630181,332954010,64,743484,462346665,739580,461876295,3904,470370,716188,595,3400735,316322,64,4842,115556.0,28889.0,-71.0,-66.0,-76.0,-69.0,-71.0,-66.0,-75.0,-69.0,-90.0,-93.0,-90.0,-93.0,19.0,27.0,14.0,24.0,0
2086,F8:59:71:5A:E0:3D,2657328,374583207,27144,41628722,2630184,332954485,0,3349,415510,3245,398771,104,16739,3135,0,27163,866,0,31,130000.0,39000.0,-68.0,-74.0,-65.0,-72.0,-67.0,-72.0,-65.0,-71.0,-90.0,-93.0,-90.0,-93.0,22.0,19.0,25.0,21.0,0
2087,CC:2F:71:3E:C5:1F,2635346,333585743,5160,631056,2630186,332954687,6,22147,1857032,18254,1395654,3893,461378,5446,30,7354,133,6,449,144444.0,39000.0,-69.0,-71.0,-69.0,-60.0,-70.0,-73.0,-69.0,-63.0,-90.0,-93.0,-90.0,-93.0,21.0,22.0,21.0,33.0,0
2088,CC:2F:71:3F:1F:24,6033373,5521836621,3403187,5188881934,2630186,332954687,64,744103,462423527,740199,461953157,3904,470370,716807,595,3405267,316578,64,4843,115556.0,28889.0,-72.0,-66.0,-75.0,-69.0,-71.0,-66.0,-75.0,-69.0,-90.0,-93.0,-90.0,-93.0,18.0,27.0,15.0,24.0,0
2089,F8:59:71:5A:E0:3D,2657334,374583813,27144,41628722,2630190,332955091,0,3349,415510,3245,398771,104,16739,3135,0,27163,866,0,31,130000.0,39000.0,-68.0,-74.0,-65.0,-72.0,-67.0,-72.0,-65.0,-71.0,-90.0,-93.0,-90.0,-93.0,22.0,19.0,25.0,21.0,0
2090,CC:2F:71:3E:C5:1F,2635350,333586147,5160,631056,2630190,332955091,6,22147,1857032,18254,1395654,3893,461378,5446,30,7354,133,6,449,144444.0,39000.0,-69.0,-71.0,-69.0,-60.0,-70.0,-73.0,-69.0,-63.0,-90.0,-93.0,-90.0,-93.0,21.0,22.0,21.0,33.0,0
2091,CC:2F:71:3F:1F:24,6037975,5529051119,3407784,5196095968,2630191,332955151,64,744810,462509431,740906,462039061,3904,470370,717511,595,3409864,316661,64,4844,115556.0,28889.0,-71.0,-66.0,-75.0,-69.0,-71.0,-66.0,-75.0,-69.0,-90.0,-93.0,-90.0,-93.0,19.0,27.0,15.0,24.0,0
2092,F8:59:71:5A:E0:3D,2657341,374584479,27144,41628722,2630197,332955757,0,3349,415510,3245,398771,104,16739,3135,0,27163,866,0,31,130000.0,39000.0,-68.0,-74.0,-65.0,-72.0,-67.0,-72.0,-65.0,-71.0,-90.0,-93.0,-90.0,-93.0,22.0,19.0,25.0,21.0,0
2093,CC:2F:71:3E:C5:1F,2635359,333587015,5160,631056,2630199,332955959,6,22147,1857032,18254,1395654,3893,461378,5446,30,7354,133,6,449,144444.0,39000.0,-69.0,-71.0,-69.0,-60.0,-70.0,-73.0,-69.0,-63.0,-90.0,-93.0,-90.0,-93.0,21.0,22.0,21.0,33.0,0
2094,CC:2F:71:3F:1F:24,6044950,5539994437,3414751,5207038478,2630199,332955959,64,745835,462635893,741931,462165523,3904,470370,718536,595,3416778,317602,64,4844,86667.0,14444.0,-71.0,-66.0,-75.0,-69.0,-71.0,-66.0,-75.0,-69.0,-90.0,-93.0,-90.0,-93.0,19.0,27.0,15.0,24.0,0
2095,F8:59:71:5A:E0:3D,2657350,374585347,27144,41628722,2630206,332956625,0,3349,415510,3245,398771,104,16739,3135,0,27163,866,0,31,130000.0,39000.0,-68.0,-74.0,-65.0,-72.0,-67.0,-72.0,-65.0,-71.0,-90.0,-93.0,-90.0,-93.0,22.0,19.0,25.0,21.0,0
2096,CC:2F:71:3E:C5:1F,2635368,333588805,5160,631056,2630208,332957749,6,22147,1857032,18254,1395654,3893,461378,5446,30,7354,133,6,449,144444.0,39000.0,-69.0,-71.0,-69.0,-60.0,-70.0,-73.0,-69.0,-63.0,-90.0,-93.0,-90.0,-93.0,21.0,22.0,21.0,33.0,0
2097,CC:2F:71:3F:1F:24,6049855,5547674659,3419647,5214716910,2630208,332957749,64,746495,462719117,742591,462248747,3904,470370,719194,595,3421612,317778,64,4846,117000.0,39000.0,-72.0,-66.0,-76.0,-69.0,-71.0,-66.0,-75.0,-69.0,-90.0,-93.0,-90.0,-93.0,18.0,27.0,14.0,24.0,0
2098,F8:59:71:5A:E0:3D,2657356,374586875,27144,41628722,2630212,332958153,0,3349,415510,3245,398771,104,16739,3135,0,27163,866,0,31,130000.0,39000.0,-68.0,-74.0,-65.0,-72.0,-67.0,-72.0,-65.0,-71.0,-90.0,-92.0,-89.0,-93.0,22.0,18.0,24.0,21.0,0
2099,CC:2F:71:3E:C5:1F,2635372,333589209,5160,631056,2630212,332958153,6,22147,1857032,18254,1395654,3893,461378,5446,30,7354,133,6,449,144444.0,39000.0,-69.0,-71.0,-69.0,-60.0,-70.0,-73.0,-69.0,-63.0,-90.0,-92.0,-89.0,-93.0,21.0,21.0,20.0,33.0,0
2100,CC:2F:71:3F:1F:24,6054123,5554359493,3423909,5221401138,2630214,332958355,64,747137,462799555,743233,462329185,3904,470370,719836,595,3425982,319541,64,4847,115556.0,28889.0,-71.0,-66.0,-75.0,-69.0,-71.0,-65.0,-74.0,-68.0,-90.0,-92.0,-89.0,-93.0,19.0,26.0,14.0,24.0,0
2101,F8:59:71:5A:E0:3D,2657365,374588665,27144,41628722,2630221,332959943,0,3349,415510,3245,398771,104,16739,3135,0,27163,866,0,31,130000.0,39000.0,-68.0,-74.0,-65.0,-72.0,-67.0,-72.0,-65.0,-71.0,-90.0,-92.0,-89.0,-93.0,22.0,18.0,24.0,21.0,0
2102,CC:2F:71:3E:C5:1F,2635381,333590999,5160,631056,2630221,332959943,6,22147,1857032,18254,1395654,3893,461378,5446,30,7354,133,6,449,144444.0,39000.0,-69.0,-71.0,-69.0,-60.0,-70.0,-73.0,-69.0,-63.0,-90.0,-92.0,-89.0,-93.0,21.0,21.0,20.0,33.0,0
2103,CC:2F:71:3F:1F:24,6058309,5560911679,3428088,5227951736,2630221,332959943,64,747800,462881619,743896,462411249,3904,470370,720499,595,3430158,320829,64,4848,86667.0,14444.0,-71.0,-65.0,-75.0,-69.0,-71.0,-65.0,-74.0,-68.0,-90.0,-92.0,-89.0,-93.0,19.0,27.0,14.0,24.0,0
2104,F8:59:71:5A:E0:3D,2657373,374590395,27144,41628722,2630229,332961673,0,3349,415510,3245,398771,104,16739,3135,0,27163,866,0,31,130000.0,39000.0,-68.0,-74.0,-65.0,-72.0,-67.0,-72.0,-65.0,-71.0,-90.0,-92.0,-89.0,-93.0,22.0,18.0,24.0,21.0,0
2105,CC:2F:71:3E:C5:1F,2635389,333592729,5160,631056,2630229,332961673,6,22147,1857032,18254,1395654,3893,461378,5446,30,7354,133,6,449,144444.0,39000.0,-69.0,-71.0,-69.0,-60.0,-70.0,-73.0,-69.0,-63.0,-90.0,-92.0,-89.0,-93.0,21.0,21.0,20.0,33.0,0
2106,CC:2F:71:3F:1F:24,6063534,5569099961,3433303,5236138086,2630231,332961875,64,748493,462970987,744589,462500617,3904,470370,721188,595,3435397,321819,64,4850,86667.0,14444.0,-71.0,-66.0,-75.0,-69.0,-71.0,-66.0,-75.0,-69.0,-90.0,-92.0,-89.0,-93.0,19.0,26.0,14.0,24.0,0
2107,F8:59:71:5A:E0:3D,2657380,374590981,27145,41628782,2630235,332962199,0,3353,415838,3248,398981,105,16857,3136,0,27164,866,0,31,130000.0,39000.0,-68.0,-75.0,-65.0,-72.0,-68.0,-74.0,-66.0,-70.0,-90.0,-92.0,-89.0,-93.0,22.0,17.0,24.0,21.0,0
2108,CC:2F:71:3E:C5:1F,2635398,333593573,5161,631172,2630237,332962401,6,22149,1857172,18256,1395794,3893,461378,5446,30,7355,133,6,449,144444.0,39000.0,-77.0,-85.0,-75.0,-72.0,-70.0,-73.0,-69.0,-63.0,-90.0,-92.0,-89.0,-93.0,13.0,7.0,14.0,21.0,0
2109,CC:2F:71:3F:1F:24,6067659,5575553029,3437420,5242590426,2630239,332962603,64,749215,463060715,745311,462590345,3904,470370,721910,595,3439469,321923,64,4851,86667.0,14444.0,-71.0,-65.0,-75.0,-69.0,-71.0,-65.0,-74.0,-68.0,-90.0,-92.0,-89.0,-93.0,19.0,27.0,14.0,24.0,0
2110,F8:59:71:5A:E0:3D,2657386,374591587,27145,41628782,2630241,332962805,0,3353,415838,3248,398981,105,16857,3136,0,27164,866,0,31,130000.0,39000.0,-68.0,-75.0,-65.0,-72.0,-68.0,-74.0,-66.0,-70.0,-90.0,-92.0,-89.0,-93.0,22.0,17.0,24.0,21.0,0
2111,CC:2F:71:3E:C5:1F,2635402,333593977,5161,631172,2630241,332962805,6,22149,1857172,18256,1395794,3893,461378,5446,30,7355,133,6,449,144444.0,39000.0,-77.0,-85.0,-75.0,-72.0,-70.0,-73.0,-69.0,-63.0,-90.0,-92.0,-89.0,-93.0,13.0,7.0,14.0,21.0,0
2112,CC:2F:71:3F:1F:24,6071715,5581910411,3441474,5248947606,2630241,332962805,64,749915,463147191,746011,462676821,3904,470370,722610,595,3443503,322440,64,4851,86667.0,14444.0,-70.0,-65.0,-74.0,-68.0,-70.0,-65.0,-74.0,-68.0,-90.0,-92.0,-89.0,-93.0,20.0,27.0,15.0,25.0,0
2113,F8:59:71:5A:E0:3D,2657393,374592253,27145,41628782,2630248,332963471,0,3353,415838,3248,398981,105,16857,3136,0,27164,866,0,31,130000.0,39000.0,-68.0,-75.0,-65.0,-72.0,-68.0,-74.0,-66.0,-70.0,-90.0,-92.0,-89.0,-93.0,22.0,17.0,24.0,21.0,0
2114,CC:2F:71:3E:C5:1F,2635409,333594643,5161,631172,2630248,332963471,6,22149,1857172,18256,1395794,3893,461378,5446,30,7355,133,6,449,144444.0,39000.0,-77.0,-85.0,-75.0,-72.0,-70.0,-73.0,-69.0,-63.0,-90.0,-92.0,-89.0,-93.0,13.0,7.0,14.0,21.0,0
2115,CC:2F:71:3F:1F:24,6074936,5586940105,3444688,5253976634,2630248,332963471,64,750463,463213795,746559,462743425,3904,470370,723158,595,3446782,322472,64,4851,86667.0,14444.0,-71.0,-65.0,-74.0,-68.0,-70.0,-65.0,-74.0,-68.0,-90.0,-92.0,-89.0,-93.0,19.0,27.0,15.0,25.0,0
2116,F8:59:71:5A:E0:3D,2657396,374592728,27145,41628782,2630251,332963946,0,3353,415838,3248,398981,105,16857,3136,0,27164,866,0,31,130000.0,39000.0,-68.0,-75.0,-65.0,-72.0,-68.0,-74.0,-66.0,-70.0,-90.0,-92.0,-89.0,-93.0,22.0,17.0,24.0,21.0,0
2117,CC:2F:71:3E:C5:1F,2635412,333595118,5161,631172,2630251,332963946,6,22149,1857172,18256,1395794,3893,461378,5446,30,7355,133,6,449,144444.0,39000.0,-77.0,-85.0,-75.0,-72.0,-70.0,-73.0,-69.0,-63.0,-90.0,-92.0,-89.0,-93.0,13.0,7.0,14.0,21.0,0
2118,CC:2F:71:3F:1F:24,6078924,5593189278,3448673,5260225332,2630251,332963946,64,751266,463312017,747362,462841647,3904,470370,723961,595,3450711,322672,64,4851,104000.0,26000.0,-70.0,-65.0,-74.0,-68.0,-70.0,-65.0,-74.0,-68.0,-90.0,-92.0,-89.0,-93.0,20.0,27.0,15.0,25.0,0
2119,F8:59:71:5A:E0:3D,2657403,374593394,27145,41628782,2630258,332964612,0,3353,415838,3248,398981,105,16857,3136,0,27164,866,0,31,130000.0,39000.0,-68.0,-75.0,-65.0,-72.0,-68.0,-74.0,-66.0,-70.0,-90.0,-92.0,-89.0,-93.0,22.0,17.0,24.0,21.0,0
2120,CC:2F:71:3E:C5:1F,2635419,333595784,5161,631172,2630258,332964612,6,22149,1857172,18256,1395794,3893,461378,5446,30,7355,133,6,449,144444.0,39000.0,-77.0,-85.0,-75.0,-72.0,-70.0,-73.0,-69.0,-63.0,-90.0,-92.0,-89.0,-93.0,13.0,7.0,14.0,21.0,0
2121,CC:2F:71:3F:1F:24,6082968,5599521634,3452710,5266557022,2630258,332964612,64,751850,463385493,747946,462915123,3904,470370,724544,595,3454794,322739,64,4851,115556.0,28889.0,-70.0,-65.0,-74.0,-69.0,-70.0,-65.0,-74.0,-68.0,-90.0,-92.0,-89.0,-93.0,20.0,27.0,15.0,24.0,0
2122,F8:59:71:5A:E0:3D,2657405,374593596,27145,41628782,2630260,332964814,0,3353,415838,3248,398981,105,16857,3136,0,27164,866,0,31,130000.0,39000.0,-68.0,-75.0,-65.0,-72.0,-68.0,-74.0,-66.0,-70.0,-90.0,-92.0,-89.0,-93.0,22.0,17.0,24.0,21.0,0
2123,CC:2F:71:3E:C5:1F,2635421,333595986,5161,631172,2630260,332964814,6,22149,1857172,18256,1395794,3893,461378,5446,30,7355,133,6,449,144444.0,39000.0,-77.0,-85.0,-75.0,-72.0,-70.0,-73.0,-69.0,-63.0,-90.0,-92.0,-89.0,-93.0,13.0,7.0,14.0,21.0,0
2124,CC:2F:71:3F:1F:24,6087590,5606767552,3457326,5273802334,2630264,332965218,64,752479,463463371,748575,462993001,3904,470370,725173,595,3459420,323343,64,4851,117000.0,39000.0,-70.0,-65.0,-74.0,-68.0,-70.0,-65.0,-74.0,-68.0,-90.0,-92.0,-89.0,-93.0,20.0,27.0,15.0,25.0,0
2125,F8:59:71:5A:E0:3D,2657412,374594264,27145,41628782,2630267,332965482,0,3353,415838,3248,398981,105,16857,3136,0,27164,866,0,31,130000.0,39000.0,-68.0,-75.0,-65.0,-72.0,-68.0,-74.0,-66.0,-70.0,-90.0,-92.0,-89.0,-93.0,22.0,17.0,24.0,21.0,0
2126,CC:2F:71:3E:C5:1F,2635431,333596916,5161,631172,2630270,332965744,6,22151,1857360,18257,1395864,3894,461496,5447,30,7355,133,6,449,144444.0,39000.0,-70.0,-71.0,-69.0,-60.0,-70.0,-74.0,-69.0,-63.0,-90.0,-92.0,-89.0,-93.0,20.0,21.0,20.0,33.0,0
2127,CC:2F:71:3F:1F:24,6091694,5613194522,3461424,5280228778,2630270,332965744,64,753266,463557655,749362,463087285,3904,470370,725958,595,3463468,323731,64,4851,115556.0,28889.0,-71.0,-65.0,-75.0,-69.0,-71.0,-65.0,-75.0,-68.0,-90.0,-92.0,-89.0,-93.0,19.0,27.0,14.0,24.0,0
2128,F8:59:71:5A:E0:3D,2657421,374595132,27145,41628782,2630276,332966350,0,3353,415838,3248,398981,105,16857,3136,0,27164,866,0,31,130000.0,39000.0,-68.0,-75.0,-65.0,-72.0,-68.0,-74.0,-66.0,-70.0,-90.0,-92.0,-89.0,-93.0,22.0,17.0,24.0,21.0,0
2129,CC:2F:71:3E:C5:1F,2635437,333597522,5161,631172,2630276,332966350,6,22151,1857360,18257,1395864,3894,461496,5447,30,7355,133,6,449,144444.0,39000.0,-70.0,-71.0,-69.0,-60.0,-70.0,-74.0,-69.0,-63.0,-90.0,-92.0,-89.0,-93.0,20.0,21.0,20.0,33.0,0
2130,CC:2F:71:3F:1F:24,6097382,5622111454,3467103,5289144840,2630279,332966614,64,754037,463653237,750132,463182749,3905,470488,726729,595,3469116,325612,64,4851,86667.0,14444.0,-70.0,-65.0,-74.0,-68.0,-70.0,-65.0,-74.0,-68.0,-90.0,-92.0,-89.0,-93.0,20.0,27.0,15.0,25.0,0
2131,F8:59:71:5A:E0:3D,2657427,374595658,27145,41628782,2630282,332966876,0,3353,415838,3248,398981,105,16857,3136,0,27164,866,0,31,130000.0,39000.0,-68.0,-75.0,-65.0,-72.0,-68.0,-74.0,-66.0,-70.0,-90.0,-92.0,-89.0,-93.0,22.0,17.0,24.0,21.0,0
2132,CC:2F:71:3E:C5:1F,2635447,333598452,5161,631172,2630286,332967280,6,22151,1857360,18257,1395864,3894,461496,5447,30,7355,133,6,449,144444.0,39000.0,-70.0,-71.0,-69.0,-60.0,-70.0,-74.0,-69.0,-63.0,-90.0,-92.0,-89.0,-93.0,20.0,21.0,20.0,33.0,0
2133,CC:2F:71:3F:1F:24,6102618,5630315258,3472332,5297347978,2630286,332967280,64,754686,463736233,750781,463265745,3905,470488,727375,595,3474426,326729,64,4851,78000.0,13000.0,-70.0,-65.0,-75.0,-69.0,-70.0,-65.0,-74.0,-69.0,-90.0,-92.0,-89.0,-93.0,20.0,27.0,14.0,24.0,0
2134,F8:59:71:5A:E0:3D,2657433,374596264,27145,41628782,2630288,332967482,0,3355,415978,3250,399121,105,16857,3136,0,27165,866,0,31,130000.0,39000.0,-68.0,-75.0,-65.0,-73.0,-68.0,-74.0,-66.0,-71.0,-90.0,-92.0,-89.0,-93.0,22.0,17.0,24.0,20.0,0
2135,CC:2F:71:3E:C5:1F,2635449,333598654,5161,631172,2630288,332967482,6,22151,1857360,18257,1395864,3894,461496,5447,30,7355,133,6,449,144444.0,39000.0,-70.0,-71.0,-69.0,-60.0,-70.0,-74.0,-69.0,-63.0,-90.0,-92.0,-89.0,-93.0,20.0,21.0,20.0,33.0,0
2136,CC:2F:71:3F:1F:24,6106132,5635813892,3475844,5302846410,2630288,332967482,64,755212,463800749,751307,463330261,3905,470488,727901,595,3477926,326896,64,4851,86667.0,14444.0,-70.0,-65.0,-74.0,-69.0,-70.0,-65.0,-74.0,-69.0,-90.0,-92.0,-89.0,-93.0,20.0,27.0,15.0,24.0,0
2137,F8:59:71:5A:E0:3D,2657440,374596930,27145,41628782,2630295,332968148,0,3355,415978,3250,399121,105,16857,3136,0,27165,866,0,31,130000.0,39000.0,-68.0,-75.0,-65.0,-73.0,-68.0,-74.0,-66.0,-71.0,-90.0,-92.0,-89.0,-93.0,22.0,17.0,24.0,20.0,0
2138,CC:2F:71:3E:C5:1F,2635456,333599320,5161,631172,2630295,332968148,6,22151,1857360,18257,1395864,3894,461496,5447,30,7355,133,6,449,144444.0,39000.0,-70.0,-71.0,-69.0,-60.0,-70.0,-74.0,-69.0,-63.0,-90.0,-92.0,-89.0,-93.0,20.0,21.0,20.0,33.0,0
2139,CC:2F:71:3F:1F:24,6109817,5641577682,3479522,5308609534,2630295,332968148,64,755771,463869957,751866,463399469,3905,470488,728460,595,3481616,327135,64,4851,104000.0,26000.0,-70.0,-65.0,-74.0,-69.0,-70.0,-65.0,-74.0,-69.0,-90.0,-92.0,-89.0,-93.0,20.0,27.0,15.0,24.0,0
2140,F8:59:71:5A:E0:3D,2657442,374597132,27145,41628782,2630297,332968350,0,3355,415978,3250,399121,105,16857,3136,0,27165,866,0,31,130000.0,39000.0,-68.0,-75.0,-65.0,-73.0,-68.0,-74.0,-66.0,-71.0,-90.0,-92.0,-89.0,-93.0,22.0,17.0,24.0,20.0,0
2141,CC:2F:71:3E:C5:1F,2635458,333599522,5161,631172,2630297,332968350,6,22151,1857360,18257,1395864,3894,461496,5447,30,7355,133,6,449,144444.0,39000.0,-70.0,-71.0,-69.0,-60.0,-70.0,-74.0,-69.0,-63.0,-90.0,-92.0,-89.0,-93.0,20.0,21.0,20.0,33.0,0
2142,CC:2F:71:3F:1F:24,6114244,5648516052,3483945,5315547500,2630299,332968552,64,756490,463957735,752585,463487247,3905,470488,729179,595,3486039,328065,64,4851,104000.0,26000.0,-71.0,-65.0,-74.0,-69.0,-70.0,-65.0,-74.0,-69.0,-90.0,-92.0,-89.0,-93.0,19.0,27.0,15.0,24.0,0
2143,F8:59:71:5A:E0:3D,2657451,374598000,27145,41628782,2630306,332969218,0,3355,415978,3250,399121,105,16857,3136,0,27165,866,0,31,130000.0,39000.0,-68.0,-75.0,-65.0,-73.0,-68.0,-74.0,-66.0,-71.0,-90.0,-92.0,-89.0,-93.0,22.0,17.0,24.0,20.0,0
2144,CC:2F:71:3E:C5:1F,2635467,333600390,5161,631172,2630306,332969218,6,22151,1857360,18257,1395864,3894,461496,5447,30,7355,133,6,449,144444.0,39000.0,-70.0,-71.0,-69.0,-60.0,-70.0,-74.0,-69.0,-63.0,-90.0,-92.0,-89.0,-93.0,20.0,21.0,20.0,33.0,0
2145,CC:2F:71:3F:1F:24,6117428,5653488360,3487122,5320519142,2630306,332969218,64,756976,464019719,753071,463549231,3905,470488,729665,595,3489190,328924,64,4851,104000.0,26000.0,-70.0,-65.0,-74.0,-69.0,-70.0,-65.0,-74.0,-69.0,-90.0,-92.0,-89.0,-93.0,20.0,27.0,15.0,24.0,0
2146,F8:59:71:5A:E0:3D,2657452,374598273,27145,41628782,2630307,332969491,0,3355,415978,3250,399121,105,16857,3136,0,27165,866,0,31,130000.0,39000.0,-68.0,-75.0,-65.0,-73.0,-68.0,-74.0,-66.0,-71.0,-90.0,-92.0,-89.0,-93.0,22.0,17.0,24.0,20.0,0
2147,CC:2F:71:3E:C5:1F,2635470,333600865,5161,631172,2630309,332969693,6,22151,1857360,18257,1395864,3894,461496,5447,30,7355,133,6,449,144444.0,39000.0,-70.0,-71.0,-69.0,-60.0,-70.0,-74.0,-69.0,-63.0,-90.0,-92.0,-89.0,-93.0,20.0,21.0,20.0,33.0,0
2148,CC:2F:71:3F:1F:24,6121227,5659431327,3490914,5326461230,2630313,332970097,64,757463,464081041,753558,463610553,3905,470488,730152,595,3492984,329629,64,4851,115556.0,28889.0,-70.0,-65.0,-74.0,-69.0,-70.0,-65.0,-73.0,-68.0,-90.0,-92.0,-89.0,-93.0,20.0,27.0,15.0,24.0,0
2149,F8:59:71:5A:E0:3D,2657460,374599081,27145,41628782,2630315,332970299,0,3355,415978,3250,399121,105,16857,3136,0,27165,866,0,31,130000.0,39000.0,-68.0,-75.0,-65.0,-73.0,-68.0,-74.0,-66.0,-71.0,-90.0,-92.0,-89.0,-93.0,22.0,17.0,24.0,20.0,0
2150,CC:2F:71:3E:C5:1F,2635476,333601471,5161,631172,2630315,332970299,6,22151,1857360,18257,1395864,3894,461496,5447,30,7355,133,6,449,144444.0,39000.0,-70.0,-71.0,-69.0,-60.0,-70.0,-74.0,-69.0,-63.0,-90.0,-92.0,-89.0,-93.0,20.0,21.0,20.0,33.0,0
2151,CC:2F:71:3F:1F:24,6125307,5665827799,3494991,5332857440,2630316,332970359,64,758121,464161703,754216,463691215,3905,470488,730810,595,3496985,330805,64,4851,104000.0,26000.0,-70.0,-65.0,-74.0,-68.0,-70.0,-64.0,-73.0,-68.0,-90.0,-92.0,-89.0,-93.0,20.0,27.0,15.0,25.0,0
2152,F8:59:71:5A:E0:3D,2657467,374599747,27145,41628782,2630322,332970965,0,3355,415978,3250,399121,105,16857,3136,0,27165,866,0,31,130000.0,39000.0,-68.0,-75.0,-65.0,-73.0,-68.0,-74.0,-66.0,-71.0,-90.0,-92.0,-89.0,-93.0,22.0,17.0,24.0,20.0,0
2153,CC:2F:71:3E:C5:1F,2635485,333602339,5161,631172,2630324,332971167,6,22151,1857360,18257,1395864,3894,461496,5447,30,7355,133,6,449,144444.0,39000.0,-70.0,-71.0,-69.0,-60.0,-70.0,-74.0,-69.0,-63.0,-90.0,-92.0,-89.0,-93.0,20.0,21.0,20.0,33.0,0
2154,CC:2F:71:3F:1F:24,6131352,5675306229,3501028,5342335062,2630324,332971167,64,759109,464281309,755204,463810821,3905,470488,731798,595,3503122,331904,64,4851,86667.0,14444.0,-70.0,-65.0,-74.0,-69.0,-70.0,-65.0,-74.0,-68.0,-90.0,-92.0,-89.0,-93.0,20.0,27.0,15.0,24.0,0
2155,F8:59:71:5A:E0:3D,2657476,374600615,27145,41628782,2630331,332971833,0,3355,415978,3250,399121,105,16857,3136,0,27165,866,0,31,130000.0,39000.0,-68.0,-75.0,-65.0,-73.0,-68.0,-74.0,-66.0,-71.0,-90.0,-92.0,-89.0,-93.0,22.0,17.0,24.0,20.0,0
2156,CC:2F:71:3E:C5:1F,2635492,333603005,5161,631172,2630331,332971833,6,22151,1857360,18257,1395864,3894,461496,5447,30,7355,133,6,449,144444.0,39000.0,-70.0,-71.0,-69.0,-60.0,-70.0,-74.0,-69.0,-63.0,-90.0,-92.0,-89.0,-93.0,20.0,21.0,20.0,33.0,0
2157,CC:2F:71:3F:1F:24,6135804,5682277769,3505473,5349305936,2630331,332971833,64,759745,464358881,755840,463888393,3905,470488,732434,595,3507512,332115,64,4851,104000.0,26000.0,-70.0,-65.0,-71.0,-68.0,-70.0,-65.0,-73.0,-68.0,-90.0,-92.0,-89.0,-93.0,20.0,27.0,18.0,25.0,0
2158,F8:59:71:5A:E0:3D,2657478,374600817,27145,41628782,2630333,332972035,0,3355,415978,3250,399121,105,16857,3136,0,27165,866,0,31,130000.0,39000.0,-68.0,-75.0,-65.0,-73.0,-68.0,-74.0,-66.0,-71.0,-90.0,-92.0,-89.0,-93.0,22.0,17.0,24.0,20.0,0
2159,CC:2F:71:3E:C5:1F,2635496,333603409,5161,631172,2630335,332972237,6,22151,1857360,18257,1395864,3894,461496,5447,30,7355,133,6,449,144444.0,39000.0,-70.0,-71.0,-69.0,-60.0,-70.0,-74.0,-69.0,-63.0,-90.0,-92.0,-89.0,-93.0,20.0,21.0,20.0,33.0,0
2160,CC:2F:71:3F:1F:24,6140187,5689144297,3509850,5356171858,2630337,332972439,64,760424,464441207,756519,463970719,3905,470488,733113,595,3511944,333517,64,4851,86667.0,14444.0,-71.0,-65.0,-74.0,-69.0,-70.0,-65.0,-73.0,-68.0,-90.0,-92.0,-89.0,-93.0,19.0,27.0,15.0,24.0,0
2161,F8:59:71:5A:E0:3D,2657489,374602053,27145,41628782,2630344,332973271,0,3355,415978,3250,399121,105,16857,3136,0,27165,866,0,31,130000.0,39000.0,-68.0,-75.0,-65.0,-73.0,-68.0,-74.0,-66.0,-71.0,-90.0,-92.0,-89.0,-93.0,22.0,17.0,24.0,20.0,0
2162,CC:2F:71:3E:C5:1F,2635505,333604443,5161,631172,2630344,332973271,6,22151,1857360,18257,1395864,3894,461496,5447,30,7355,133,6,449,144444.0,39000.0,-70.0,-71.0,-69.0,-60.0,-70.0,-74.0,-69.0,-63.0,-90.0,-92.0,-89.0,-93.0,20.0,21.0,20.0,33.0,0
2163,CC:2F:71:3F:1F:24,6144652,5696132429,3514308,5363159158,2630344,332973271,64,761183,464535475,757278,464064987,3905,470488,733868,595,3516339,334210,64,4851,65000.0,14444.0,-72.0,-66.0,-76.0,-69.0,-71.0,-65.0,-75.0,-68.0,-90.0,-92.0,-89.0,-93.0,18.0,26.0,13.0,24.0,0
2164,F8:59:71:5A:E0:3D,2657495,374602659,27145,41628782,2630350,332973877,0,3355,415978,3250,399121,105,16857,3136,0,27165,866,0,31,130000.0,39000.0,-68.0,-75.0,-65.0,-73.0,-68.0,-74.0,-66.0,-71.0,-90.0,-92.0,-89.0,-93.0,22.0,17.0,24.0,20.0,0
2165,CC:2F:71:3E:C5:1F,2635513,333605251,5161,631172,2630352,332974079,6,22151,1857360,18257,1395864,3894,461496,5447,30,7355,133,6,449,144444.0,39000.0,-70.0,-71.0,-69.0,-60.0,-70.0,-74.0,-69.0,-63.0,-90.0,-92.0,-89.0,-93.0,20.0,21.0,20.0,33.0,0
2166,CC:2F:71:3F:1F:24,6149659,5703974443,3519307,5371000364,2630352,332974079,64,761901,464625617,757996,464155129,3905,470488,734583,595,3521401,334734,64,4851,130000.0,39000.0,-72.0,-66.0,-77.0,-69.0,-72.0,-65.0,-76.0,-68.0,-90.0,-92.0,-89.0,-93.0,18.0,26.0,12.0,24.0,0
2167,F8:59:71:5A:E0:3D,2657501,374603239,27146,41628898,2630355,332974341,0,3357,416118,3252,399261,105,16857,3136,0,27166,866,0,31,130000.0,39000.0,-68.0,-75.0,-66.0,-71.0,-68.0,-75.0,-66.0,-70.0,-90.0,-92.0,-89.0,-93.0,22.0,17.0,23.0,22.0,0
2168,CC:2F:71:3E:C5:1F,2635517,333605629,5162,631288,2630355,332974341,6,22153,1857500,18259,1396004,3894,461496,5447,30,7356,133,6,449,144444.0,39000.0,-69.0,-72.0,-69.0,-61.0,-71.0,-74.0,-69.0,-63.0,-90.0,-92.0,-89.0,-93.0,21.0,20.0,20.0,32.0,0
2169,CC:2F:71:3F:1F:24,6154453,5711482108,3524094,5378507363,2630359,332974745,64,762551,464705692,758646,464235204,3905,470488,735229,595,3526188,335183,64,4851,130000.0,43333.0,-72.0,-66.0,-76.0,-68.0,-72.0,-66.0,-75.0,-68.0,-90.0,-92.0,-89.0,-93.0,18.0,26.0,13.0,25.0,0
2170,F8:59:71:5A:E0:3D,2657507,374603845,27146,41628898,2630361,332974947,0,3357,416118,3252,399261,105,16857,3136,0,27166,866,0,31,130000.0,39000.0,-68.0,-75.0,-66.0,-71.0,-68.0,-75.0,-66.0,-70.0,-90.0,-92.0,-89.0,-93.0,22.0,17.0,23.0,22.0,0
2171,CC:2F:71:3E:C5:1F,2635527,333606559,5162,631288,2630365,332975271,6,22155,1857688,18260,1396074,3895,461614,5448,30,7356,133,6,449,144444.0,39000.0,-69.0,-70.0,-70.0,-60.0,-71.0,-74.0,-69.0,-63.0,-90.0,-92.0,-89.0,-93.0,21.0,22.0,19.0,33.0,0
2172,CC:2F:71:3F:1F:24,6158635,5718026202,3528270,5385050931,2630365,332975271,64,762910,464751368,759005,464280880,3905,470488,735570,595,3530364,335788,64,4851,130000.0,43333.0,-72.0,-66.0,-76.0,-68.0,-71.0,-65.0,-74.0,-67.0,-90.0,-92.0,-89.0,-93.0,18.0,26.0,13.0,25.0,0
2173,F8:59:71:5A:E0:3D,2657517,374604775,27146,41628898,2630371,332975877,0,3357,416118,3252,399261,105,16857,3136,0,27166,866,0,31,130000.0,39000.0,-68.0,-75.0,-66.0,-71.0,-68.0,-75.0,-66.0,-70.0,-90.0,-92.0,-89.0,-93.0,22.0,17.0,23.0,22.0,0
2174,CC:2F:71:3E:C5:1F,2635534,333607438,5162,631288,2630372,332976150,6,22155,1857688,18260,1396074,3895,461614,5448,30,7356,133,6,449,144444.0,39000.0,-69.0,-70.0,-70.0,-60.0,-71.0,-74.0,-69.0,-63.0,-90.0,-92.0,-89.0,-93.0,21.0,22.0,19.0,33.0,0
2175,CC:2F:71:3F:1F:24,6162261,5723695647,3531889,5390719497,2630372,332976150,64,763313,464801916,759408,464331428,3905,470488,735966,595,3533951,336258,64,4851,130000.0,43333.0,-72.0,-65.0,-75.0,-67.0,-72.0,-65.0,-76.0,-68.0,-90.0,-92.0,-89.0,-93.0,18.0,27.0,14.0,26.0,0
2176,F8:59:71:5A:E0:3D,2657520,374605250,27146,41628898,2630374,332976352,0,3357,416118,3252,399261,105,16857,3136,0,27166,866,0,31,130000.0,39000.0,-68.0,-75.0,-66.0,-71.0,-68.0,-75.0,-66.0,-70.0,-90.0,-93.0,-90.0,-93.0,22.0,18.0,24.0,22.0,0
2177,CC:2F:71:3E:C5:1F,2635536,333607640,5162,631288,2630374,332976352,6,22155,1857688,18260,1396074,3895,461614,5448,30,7356,133,6,449,144444.0,39000.0,-69.0,-70.0,-70.0,-60.0,-71.0,-74.0,-69.0,-63.0,-90.0,-93.0,-90.0,-93.0,21.0,23.0,20.0,33.0,0
2178,CC:2F:71:3F:1F:24,6166812,5730826783,3536434,5397850027,2630378,332976756,64,763869,464871810,759964,464401322,3905,470488,736522,595,3538500,336669,64,4851,130000.0,43333.0,-72.0,-65.0,-75.0,-69.0,-71.0,-65.0,-75.0,-69.0,-90.0,-93.0,-90.0,-93.0,18.0,28.0,15.0,24.0,0
2179,F8:59:71:5A:E0:3D,2657529,374606040,27146,41628898,2630383,332977142,0,3359,416306,3253,399331,106,16975,3137,0,27166,866,0,32,130000.0,39000.0,-67.0,-74.0,-66.0,-72.0,-68.0,-75.0,-66.0,-72.0,-90.0,-93.0,-90.0,-93.0,23.0,19.0,24.0,21.0,0
2180,CC:2F:71:3E:C5:1F,2635545,333608430,5162,631288,2630383,332977142,6,22155,1857688,18260,1396074,3895,461614,5448,30,7356,133,6,449,144444.0,39000.0,-69.0,-70.0,-70.0,-60.0,-71.0,-74.0,-69.0,-63.0,-90.0,-93.0,-90.0,-93.0,21.0,23.0,20.0,33.0,0
2181,CC:2F:71:3F:1F:24,6172352,5739515789,3541967,5406538445,2630385,332977344,64,764659,464969352,760753,464498746,3906,470606,737312,595,3544061,338312,64,4851,86667.0,14444.0,-71.0,-66.0,-75.0,-69.0,-70.0,-65.0,-74.0,-68.0,-90.0,-93.0,-90.0,-93.0,19.0,27.0,15.0,24.0,0
2182,F8:59:71:5A:E0:3D,2657537,374606848,27146,41628898,2630391,332977950,0,3359,416306,3253,399331,106,16975,3137,0,27166,866,0,32,130000.0,39000.0,-67.0,-74.0,-66.0,-72.0,-68.0,-75.0,-66.0,-72.0,-90.0,-93.0,-90.0,-93.0,23.0,19.0,24.0,21.0,0
2183,CC:2F:71:3E:C5:1F,2635554,333609298,5162,631288,2630392,332978010,6,22155,1857688,18260,1396074,3895,461614,5448,30,7356,133,6,449,144444.0,39000.0,-69.0,-70.0,-70.0,-60.0,-71.0,-74.0,-69.0,-63.0,-90.0,-93.0,-90.0,-93.0,21.0,23.0,20.0,33.0,0
2184,CC:2F:71:3F:1F:24,6177461,5747523483,3547069,5414545473,2630392,332978010,64,765547,465075956,761641,464605350,3906,470606,738196,595,3549163,338424,64,4851,86667.0,14444.0,-71.0,-65.0,-76.0,-69.0,-71.0,-65.0,-74.0,-69.0,-90.0,-93.0,-90.0,-93.0,19.0,28.0,14.0,24.0,0
2185,F8:59:71:5A:E0:3D,2657544,374607514,27146,41628898,2630398,332978616,0,3359,416306,3253,399331,106,16975,3137,0,27166,866,0,32,130000.0,39000.0,-67.0,-74.0,-66.0,-72.0,-68.0,-75.0,-66.0,-72.0,-90.0,-93.0,-90.0,-93.0,23.0,19.0,24.0,21.0,0
2186,CC:2F:71:3E:C5:1F,2635560,333609904,5162,631288,2630398,332978616,6,22155,1857688,18260,1396074,3895,461614,5448,30,7356,133,6,449,144444.0,39000.0,-69.0,-70.0,-70.0,-60.0,-71.0,-74.0,-69.0,-63.0,-90.0,-93.0,-90.0,-93.0,21.0,23.0,20.0,33.0,0
2187,CC:2F:71:3F:1F:24,6181467,5753795385,3551069,5420816769,2630398,332978616,64,766128,465147566,762222,464676960,3906,470606,738777,595,3553149,338716,64,4851,130000.0,43333.0,-71.0,-65.0,-75.0,-69.0,-71.0,-65.0,-75.0,-69.0,-90.0,-93.0,-90.0,-93.0,19.0,28.0,15.0,24.0,0
2188,F8:59:71:5A:E0:3D,2657568,374618564,27146,41628898,2630422,332989666,0,3359,416306,3253,399331,106,16975,3137,0,27166,866,0,32,130000.0,39000.0,-67.0,-74.0,-66.0,-72.0,-68.0,-75.0,-66.0,-72.0,-90.0,-93.0,-90.0,-93.0,23.0,19.0,24.0,21.0,0
2189,CC:2F:71:3E:C5:1F,2635587,333621216,5162,631288,2630425,332989928,6,22155,1857688,18260,1396074,3895,461614,5448,30,7356,133,6,449,144444.0,39000.0,-69.0,-70.0,-70.0,-60.0,-71.0,-74.0,-69.0,-63.0,-90.0,-93.0,-90.0,-93.0,21.0,23.0,20.0,33.0,0
2190,CC:2F:71:3F:1F:24,6186875,5762254435,3556450,5429264507,2630425,332989928,64,766737,465224012,762831,464753406,3906,470606,739381,595,3558530,339356,64,4852,130000.0,39000.0,-71.0,-65.0,-76.0,-70.0,-71.0,-65.0,-75.0,-69.0,-90.0,-93.0,-90.0,-93.0,19.0,28.0,14.0,23.0,0
2191,F8:59:71:5A:E0:3D,2657577,374619432,27146,41628898,2630431,332990534,0,3361,416446,3255,399471,106,16975,3137,0,27167,866,0,32,130000.0,39000.0,-67.0,-74.0,-66.0,-72.0,-68.0,-73.0,-67.0,-71.0,-90.0,-93.0,-90.0,-93.0,23.0,19.0,24.0,21.0,0
2192,CC:2F:71:3E:C5:1F,2635593,333621822,5162,631288,2630431,332990534,6,22157,1857828,18262,1396214,3895,461614,5448,30,7357,133,6,449,144444.0,39000.0,-70.0,-71.0,-69.0,-60.0,-71.0,-73.0,-70.0,-62.0,-90.0,-93.0,-90.0,-93.0,20.0,22.0,21.0,33.0,0
2193,CC:2F:71:3F:1F:24,6191740,5769879559,3561309,5436889025,2630431,332990534,64,767358,465300346,763452,464829740,3906,470606,740002,595,3563403,339781,64,4852,130000.0,43333.0,-71.0,-66.0,-75.0,-70.0,-71.0,-65.0,-74.0,-69.0,-90.0,-93.0,-90.0,-93.0,19.0,27.0,15.0,23.0,0
2194,F8:59:71:5A:E0:3D,2657581,374619836,27146,41628898,2630435,332990938,0,3361,416446,3255,399471,106,16975,3137,0,27167,866,0,32,130000.0,39000.0,-67.0,-74.0,-66.0,-72.0,-68.0,-73.0,-67.0,-71.0,-90.0,-93.0,-90.0,-93.0,23.0,19.0,24.0,21.0,0
2195,CC:2F:71:3E:C5:1F,2635600,333622488,5162,631288,2630438,332991200,6,22157,1857828,18262,1396214,3895,461614,5448,30,7357,133,6,449,144444.0,39000.0,-70.0,-71.0,-69.0,-60.0,-71.0,-73.0,-70.0,-62.0,-90.0,-93.0,-90.0,-93.0,20.0,22.0,21.0,33.0,0
2196,CC:2F:71:3F:1F:24,6196995,5778107357,3566557,5445116157,2630438,332991200,64,768072,465389198,764166,464918592,3906,470606,740716,595,3568651,341300,64,4852,86667.0,14444.0,-72.0,-66.0,-74.0,-68.0,-71.0,-66.0,-74.0,-68.0,-90.0,-93.0,-90.0,-93.0,18.0,27.0,16.0,25.0,0
2197,F8:59:71:5A:E0:3D,2657586,374620300,27146,41628898,2630440,332991402,0,3361,416446,3255,399471,106,16975,3137,0,27167,866,0,32,130000.0,39000.0,-67.0,-74.0,-66.0,-72.0,-68.0,-73.0,-67.0,-71.0,-90.0,-93.0,-90.0,-93.0,23.0,19.0,24.0,21.0,0
2198,CC:2F:71:3E:C5:1F,2635604,333622892,5162,631288,2630442,332991604,6,22157,1857828,18262,1396214,3895,461614,5448,30,7357,133,6,449,144444.0,39000.0,-70.0,-71.0,-69.0,-60.0,-71.0,-73.0,-70.0,-62.0,-90.0,-93.0,-90.0,-93.0,20.0,22.0,21.0,33.0,0
2199,CC:2F:71:3F:1F:24,6200737,5783964845,3570295,5450973241,2630442,332991604,64,768620,465456936,764714,464986330,3906,470606,741263,595,3572316,341745,64,4852,86667.0,14444.0,-71.0,-66.0,-73.0,-69.0,-71.0,-66.0,-73.0,-68.0,-90.0,-93.0,-90.0,-93.0,19.0,27.0,17.0,24.0,0
2200,F8:59:71:5A:E0:3D,2657594,374621108,27146,41628898,2630448,332992210,0,3361,416446,3255,399471,106,16975,3137,0,27167,866,0,32,130000.0,39000.0,-67.0,-74.0,-66.0,-72.0,-68.0,-73.0,-67.0,-71.0,-90.0,-93.0,-90.0,-93.0,23.0,19.0,24.0,21.0,0
2201,CC:2F:71:3E:C5:1F,2635611,333623558,5162,631288,2630449,332992270,6,22157,1857828,18262,1396214,3895,461614,5448,30,7357,133,6,449,144444.0,39000.0,-70.0,-71.0,-69.0,-60.0,-71.0,-73.0,-70.0,-62.0,-90.0,-93.0,-90.0,-93.0,20.0,22.0,21.0,33.0,0
2202,CC:2F:71:3F:1F:24,6204728,5790209487,3574279,5457217217,2630449,332992270,64,769261,465536354,765355,465065748,3906,470606,741903,595,3576358,341809,64,4852,86667.0,14444.0,-70.0,-65.0,-74.0,-68.0,-70.0,-65.0,-74.0,-68.0,-90.0,-93.0,-90.0,-93.0,20.0,28.0,16.0,25.0,0
2203,F8:59:71:5A:E0:3D,2657597,374621370,27146,41628898,2630451,332992472,0,3361,416446,3255,399471,106,16975,3137,0,27167,866,0,32,130000.0,39000.0,-67.0,-74.0,-66.0,-72.0,-68.0,-73.0,-67.0,-71.0,-90.0,-93.0,-90.0,-93.0,23.0,19.0,24.0,21.0,0
2204,CC:2F:71:3E:C5:1F,2635616,333624235,5162,631288,2630454,332992947,6,22157,1857828,18262,1396214,3895,461614,5448,30,7357,133,6,449,144444.0,39000.0,-70.0,-71.0,-69.0,-60.0,-71.0,-73.0,-70.0,-62.0,-90.0,-93.0,-90.0,-93.0,20.0,22.0,21.0,33.0,0
2205,CC:2F:71:3F:1F:24,6208387,5795938032,3577933,5462945085,2630454,332992947,64,769778,465601552,765872,465130946,3906,470606,742416,595,3580012,342280,64,4854,130000.0,43333.0,-71.0,-65.0,-74.0,-68.0,-70.0,-65.0,-73.0,-67.0,-90.0,-93.0,-90.0,-93.0,19.0,28.0,16.0,25.0,0
2206,F8:59:71:5A:E0:3D,2657604,374622249,27146,41628898,2630458,332993351,0,3361,416446,3255,399471,106,16975,3137,0,27167,866,0,32,130000.0,39000.0,-67.0,-74.0,-66.0,-72.0,-68.0,-73.0,-67.0,-71.0,-90.0,-93.0,-90.0,-93.0,23.0,19.0,24.0,21.0,0
2207,CC:2F:71:3E:C5:1F,2635620,333624639,5162,631288,2630458,332993351,6,22157,1857828,18262,1396214,3895,461614,5448,30,7357,133,6,449,144444.0,39000.0,-70.0,-71.0,-69.0,-60.0,-71.0,-73.0,-70.0,-62.0,-90.0,-93.0,-90.0,-93.0,20.0,22.0,21.0,33.0,0
2208,CC:2F:71:3F:1F:24,6212788,5802836998,3582330,5469843647,2630458,332993351,64,770181,465654314,766275,465183708,3906,470606,742819,595,3584424,342367,64,4854,130000.0,43333.0,-71.0,-65.0,-75.0,-68.0,-70.0,-65.0,-74.0,-68.0,-90.0,-93.0,-90.0,-93.0,19.0,28.0,15.0,25.0,0
2209,F8:59:71:5A:E0:3D,2657607,374622511,27146,41628898,2630461,332993613,0,3361,416446,3255,399471,106,16975,3137,0,27167,866,0,32,130000.0,39000.0,-67.0,-74.0,-66.0,-72.0,-68.0,-73.0,-67.0,-71.0,-90.0,-93.0,-90.0,-93.0,23.0,19.0,24.0,21.0,0
2210,CC:2F:71:3E:C5:1F,2635625,333625103,5162,631288,2630463,332993815,6,22157,1857828,18262,1396214,3895,461614,5448,30,7357,133,6,449,144444.0,39000.0,-70.0,-71.0,-69.0,-60.0,-71.0,-73.0,-70.0,-62.0,-90.0,-93.0,-90.0,-93.0,20.0,22.0,21.0,33.0,0
2211,CC:2F:71:3F:1F:24,6218159,5811258224,3587694,5478264207,2630465,332994017,64,770826,465735266,766920,465264660,3906,470606,743464,595,3589788,342943,64,4854,130000.0,43333.0,-71.0,-66.0,-75.0,-69.0,-71.0,-66.0,-75.0,-68.0,-90.0,-93.0,-90.0,-93.0,19.0,27.0,15.0,24.0,0
2212,F8:59:71:5A:E0:3D,2657613,374623117,27146,41628898,2630467,332994219,0,3361,416446,3255,399471,106,16975,3137,0,27167,866,0,32,130000.0,39000.0,-67.0,-74.0,-66.0,-72.0,-68.0,-73.0,-67.0,-71.0,-90.0,-93.0,-90.0,-93.0,23.0,19.0,24.0,21.0,0
2213,CC:2F:71:3E:C5:1F,2635629,333625507,5162,631288,2630467,332994219,6,22157,1857828,18262,1396214,3895,461614,5448,30,7357,133,6,449,144444.0,39000.0,-70.0,-71.0,-69.0,-60.0,-71.0,-73.0,-70.0,-62.0,-90.0,-93.0,-90.0,-93.0,20.0,22.0,21.0,33.0,0
2214,CC:2F:71:3F:1F:24,6221923,5817153452,3591454,5484159031,2630469,332994421,64,771349,465799210,767443,465328604,3906,470606,743987,595,3593548,343069,64,4854,130000.0,43333.0,-71.0,-66.0,-75.0,-69.0,-71.0,-65.0,-75.0,-68.0,-90.0,-93.0,-90.0,-93.0,19.0,27.0,15.0,24.0,0
2215,F8:59:71:5A:E0:3D,2657620,374623783,27146,41628898,2630474,332994885,0,3361,416446,3255,399471,106,16975,3137,0,27167,866,0,32,130000.0,39000.0,-67.0,-74.0,-66.0,-72.0,-68.0,-73.0,-67.0,-71.0,-90.0,-93.0,-90.0,-93.0,23.0,19.0,24.0,21.0,0
2216,CC:2F:71:3E:C5:1F,2635636,333626173,5162,631288,2630474,332994885,6,22157,1857828,18262,1396214,3895,461614,5448,30,7357,133,6,449,144444.0,39000.0,-70.0,-71.0,-69.0,-60.0,-71.0,-73.0,-70.0,-62.0,-90.0,-93.0,-90.0,-93.0,20.0,22.0,21.0,33.0,0
2217,CC:2F:71:3F:1F:24,6226051,5823618146,3595577,5490623261,2630474,332994885,64,771913,465869042,768007,465398436,3906,470606,744550,595,3597627,343220,64,4854,130000.0,43333.0,-71.0,-65.0,-75.0,-68.0,-71.0,-65.0,-75.0,-68.0,-90.0,-93.0,-90.0,-93.0,19.0,28.0,15.0,25.0,0
2218,F8:59:71:5A:E0:3D,2657624,374624187,27146,41628898,2630478,332995289,0,3361,416446,3255,399471,106,16975,3137,0,27167,866,0,32,130000.0,39000.0,-67.0,-74.0,-66.0,-72.0,-68.0,-73.0,-67.0,-71.0,-90.0,-93.0,-90.0,-93.0,23.0,19.0,24.0,21.0,0
2219,CC:2F:71:3E:C5:1F,2635640,333626577,5162,631288,2630478,332995289,6,22157,1857828,18262,1396214,3895,461614,5448,30,7357,133,6,449,144444.0,39000.0,-70.0,-71.0,-69.0,-60.0,-71.0,-73.0,-70.0,-62.0,-90.0,-93.0,-90.0,-93.0,20.0,22.0,21.0,33.0,0
2220,CC:2F:71:3F:1F:24,6231402,5832007588,3600924,5499012299,2630478,332995289,64,772479,465942480,768573,465471874,3906,470606,745115,595,3603018,343704,64,4854,130000.0,43333.0,-71.0,-65.0,-75.0,-68.0,-71.0,-65.0,-75.0,-68.0,-90.0,-93.0,-90.0,-93.0,19.0,28.0,15.0,25.0,0
2221,F8:59:71:5A:E0:3D,2657628,374624591,27146,41628898,2630482,332995693,0,3361,416446,3255,399471,106,16975,3137,0,27167,866,0,32,130000.0,39000.0,-67.0,-74.0,-66.0,-72.0,-68.0,-73.0,-67.0,-71.0,-90.0,-93.0,-90.0,-93.0,23.0,19.0,24.0,21.0,0
2222,CC:2F:71:3E:C5:1F,2635647,333627243,5162,631288,2630485,332995955,6,22157,1857828,18262,1396214,3895,461614,5448,30,7357,133,6,449,144444.0,39000.0,-70.0,-71.0,-69.0,-60.0,-71.0,-73.0,-70.0,-62.0,-90.0,-93.0,-90.0,-93.0,20.0,22.0,21.0,33.0,0
2223,CC:2F:71:3F:1F:24,6237188,5841081180,3606703,5508085225,2630485,332995955,64,773226,466034734,769320,465564128,3906,470606,745862,595,3608765,343947,64,4854,130000.0,43333.0,-71.0,-66.0,-75.0,-69.0,-71.0,-65.0,-75.0,-68.0,-90.0,-93.0,-90.0,-93.0,19.0,27.0,15.0,24.0,0
2224,F8:59:71:5A:E0:3D,2657633,374625055,27146,41628898,2630487,332996157,0,3361,416446,3255,399471,106,16975,3137,0,27167,866,0,32,130000.0,39000.0,-67.0,-74.0,-66.0,-72.0,-68.0,-73.0,-67.0,-71.0,-90.0,-93.0,-90.0,-93.0,23.0,19.0,24.0,21.0,0
2225,CC:2F:71:3E:C5:1F,2635649,333627445,5162,631288,2630487,332996157,6,22157,1857828,18262,1396214,3895,461614,5448,30,7357,133,6,449,144444.0,39000.0,-70.0,-71.0,-69.0,-60.0,-71.0,-73.0,-70.0,-62.0,-90.0,-93.0,-90.0,-93.0,20.0,22.0,21.0,33.0,0
2226,CC:2F:71:3F:1F:24,6241888,5848450354,3611401,5515454197,2630487,332996157,64,773696,466094338,769790,465623732,3906,470606,746332,595,3613495,344322,64,4855,130000.0,43333.0,-71.0,-66.0,-75.0,-69.0,-71.0,-65.0,-75.0,-68.0,-90.0,-93.0,-90.0,-93.0,19.0,27.0,15.0,24.0,0
2227,F8:59:71:5A:E0:3D,2657637,374625459,27146,41628898,2630491,332996561,0,3361,416446,3255,399471,106,16975,3137,0,27167,866,0,32,130000.0,39000.0,-67.0,-74.0,-66.0,-72.0,-68.0,-73.0,-67.0,-71.0,-90.0,-93.0,-90.0,-93.0,23.0,19.0,24.0,21.0,0
2228,CC:2F:71:3E:C5:1F,2635655,333628051,5162,631288,2630493,332996763,6,22157,1857828,18262,1396214,3895,461614,5448,30,7357,133,6,449,144444.0,39000.0,-70.0,-71.0,-69.0,-60.0,-71.0,-73.0,-70.0,-62.0,-90.0,-93.0,-90.0,-93.0,20.0,22.0,21.0,33.0,0
2229,CC:2F:71:3F:1F:24,6246201,5855204478,3615708,5522207715,2630493,332996763,64,774204,466157714,770298,465687108,3906,470606,746840,595,3617763,344357,64,4855,130000.0,43333.0,-71.0,-65.0,-74.0,-68.0,-71.0,-65.0,-74.0,-68.0,-90.0,-93.0,-90.0,-93.0,19.0,28.0,16.0,25.0,0
2230,F8:59:71:5A:E0:3D,2657643,374626039,27147,41629014,2630496,332997025,0,3363,416586,3257,399611,106,16975,3137,0,27168,866,0,32,130000.0,39000.0,-75.0,-80.0,-78.0,-74.0,-69.0,-74.0,-68.0,-71.0,-90.0,-93.0,-90.0,-93.0,15.0,13.0,12.0,19.0,0
2231,CC:2F:71:3E:C5:1F,2635659,333628429,5163,631404,2630496,332997025,6,22159,1857968,18264,1396354,3895,461614,5448,30,7358,133,6,449,144444.0,43333.0,-67.0,-70.0,-65.0,-60.0,-70.0,-73.0,-70.0,-62.0,-90.0,-93.0,-90.0,-93.0,23.0,23.0,25.0,33.0,0
2232,CC:2F:71:3F:1F:24,6251805,5863997190,3621307,5530999963,2630498,332997227,64,774982,466253038,771076,465782432,3906,470606,747618,595,3623293,344611,64,4856,117000.0,39000.0,-71.0,-65.0,-75.0,-68.0,-71.0,-65.0,-75.0,-68.0,-90.0,-93.0,-90.0,-93.0,19.0,28.0,15.0,25.0,0
2233,F8:59:71:5A:E0:3D,2657649,374626645,27147,41629014,2630502,332997631,0,3363,416586,3257,399611,106,16975,3137,0,27168,866,0,32,130000.0,39000.0,-75.0,-80.0,-78.0,-74.0,-69.0,-74.0,-68.0,-71.0,-90.0,-93.0,-90.0,-93.0,15.0,13.0,12.0,19.0,0
2234,CC:2F:71:3E:C5:1F,2635666,333629097,5163,631404,2630503,332997693,6,22160,1858086,18264,1396354,3896,461732,5449,30,7358,133,6,449,144444.0,43333.0,-69.0,-71.0,-69.0,-60.0,-69.0,-71.0,-69.0,-61.0,-90.0,-93.0,-90.0,-93.0,21.0,22.0,21.0,33.0,0
2235,CC:2F:71:3F:1F:24,6255566,5869879024,3625063,5536881331,2630503,332997693,64,775485,466315794,771579,465845188,3906,470606,748121,595,3627157,344800,64,4858,130000.0,43333.0,-71.0,-66.0,-76.0,-69.0,-71.0,-66.0,-75.0,-68.0,-90.0,-93.0,-90.0,-93.0,19.0,27.0,14.0,24.0,0
2236,F8:59:71:5A:E0:3D,2657653,374626969,27147,41629014,2630506,332997955,0,3363,416586,3257,399611,106,16975,3137,0,27168,866,0,32,130000.0,39000.0,-75.0,-80.0,-78.0,-74.0,-69.0,-74.0,-68.0,-71.0,-90.0,-93.0,-90.0,-93.0,15.0,13.0,12.0,19.0,0
2237,CC:2F:71:3E:C5:1F,2635669,333629359,5163,631404,2630506,332997955,6,22161,1858156,18265,1396424,3896,461732,5449,30,7358,133,6,449,144444.0,43333.0,-69.0,-71.0,-69.0,-60.0,-69.0,-71.0,-69.0,-61.0,-90.0,-93.0,-90.0,-93.0,21.0,22.0,21.0,33.0,0
2238,CC:2F:71:3F:1F:24,6259613,5876217348,3629105,5543219191,2630508,332998157,64,775942,466373442,772036,465902836,3906,470606,748578,595,3631176,344894,64,4859,130000.0,43333.0,-70.0,-65.0,-75.0,-68.0,-70.0,-65.0,-75.0,-68.0,-90.0,-93.0,-90.0,-93.0,20.0,28.0,15.0,25.0,0
2239,F8:59:71:5A:E0:3D,2657659,374627575,27147,41629014,2630512,332998561,0,3363,416586,3257,399611,106,16975,3137,0,27168,866,0,32,130000.0,39000.0,-75.0,-80.0,-78.0,-74.0,-69.0,-74.0,-68.0,-71.0,-90.0,-93.0,-90.0,-93.0,15.0,13.0,12.0,19.0,0
2240,CC:2F:71:3E:C5:1F,2635676,333630238,5163,631404,2630513,332998834,6,22161,1858156,18265,1396424,3896,461732,5449,30,7358,133,6,449,144444.0,43333.0,-69.0,-71.0,-69.0,-60.0,-69.0,-71.0,-69.0,-61.0,-90.0,-93.0,-90.0,-93.0,21.0,22.0,21.0,33.0,0
2241,CC:2F:71:3F:1F:24,6264469,5883825253,3633954,5550826217,2630515,332999036,64,776530,466447542,772624,465976936,3906,470606,749150,595,3636048,345326,64,4859,130000.0,43333.0,-71.0,-66.0,-75.0,-69.0,-71.0,-66.0,-75.0,-69.0,-90.0,-93.0,-90.0,-93.0,19.0,27.0,15.0,24.0,0
2242,F8:59:71:5A:E0:3D,2657662,374628050,27147,41629014,2630515,332999036,0,3363,416586,3257,399611,106,16975,3137,0,27168,866,0,32,130000.0,39000.0,-75.0,-80.0,-78.0,-74.0,-69.0,-74.0,-68.0,-71.0,-90.0,-93.0,-90.0,-93.0,15.0,13.0,12.0,19.0,0
2243,CC:2F:71:3E:C5:1F,2635680,333630642,5163,631404,2630517,332999238,6,22161,1858156,18265,1396424,3896,461732,5449,30,7358,133,6,449,144444.0,43333.0,-69.0,-71.0,-69.0,-60.0,-69.0,-71.0,-69.0,-61.0,-90.0,-93.0,-90.0,-93.0,21.0,22.0,21.0,33.0,0
2244,CC:2F:71:3F:1F:24,6269176,5891206081,3638659,5558206843,2630517,332999238,64,777037,466512614,773131,466042008,3906,470606,749657,595,3640733,345444,64,4859,130000.0,43333.0,-71.0,-65.0,-75.0,-69.0,-70.0,-65.0,-75.0,-68.0,-90.0,-93.0,-90.0,-93.0,19.0,28.0,15.0,24.0,0
2245,F8:59:71:5A:E0:3D,2657669,374628716,27147,41629014,2630522,332999702,0,3363,416586,3257,399611,106,16975,3137,0,27168,866,0,32,130000.0,39000.0,-75.0,-80.0,-78.0,-74.0,-69.0,-74.0,-68.0,-71.0,-90.0,-93.0,-90.0,-93.0,15.0,13.0,12.0,19.0,0
2246,CC:2F:71:3E:C5:1F,2635685,333631106,5163,631404,2630522,332999702,6,22161,1858156,18265,1396424,3896,461732,5449,30,7358,133,6,449,144444.0,43333.0,-69.0,-71.0,-69.0,-60.0,-69.0,-71.0,-69.0,-61.0,-90.0,-93.0,-90.0,-93.0,21.0,22.0,21.0,33.0,0
2247,CC:2F:71:3F:1F:24,6273880,5898575133,3643356,5565575229,2630524,332999904,64,777450,466565978,773544,466095372,3906,470606,750070,595,3645450,345700,64,4859,130000.0,39000.0,-71.0,-66.0,-75.0,-69.0,-70.0,-65.0,-75.0,-68.0,-90.0,-93.0,-90.0,-93.0,19.0,27.0,15.0,24.0,0
2248,F8:59:71:5A:E0:3D,2657673,374629120,27147,41629014,2630526,333000106,0,3363,416586,3257,399611,106,16975,3137,0,27168,866,0,32,130000.0,39000.0,-75.0,-80.0,-78.0,-74.0,-69.0,-74.0,-68.0,-71.0,-90.0,-93.0,-90.0,-93.0,15.0,13.0,12.0,19.0,0
2249,CC:2F:71:3E:C5:1F,2635689,333631510,5163,631404,2630526,333000106,6,22161,1858156,18265,1396424,3896,461732,5449,30,7358,133,6,449,144444.0,43333.0,-69.0,-71.0,-69.0,-60.0,-69.0,-71.0,-69.0,-61.0,-90.0,-93.0,-90.0,-93.0,21.0,22.0,21.0,33.0,0
2250,CC:2F:71:3F:1F:24,6279019,5906631015,3648488,5573630445,2630531,333000570,64,778368,466676800,774462,466206194,3906,470606,750988,595,3650508,347050,64,4859,86667.0,14444.0,-74.0,-66.0,-76.0,-68.0,-73.0,-66.0,-76.0,-68.0,-90.0,-93.0,-90.0,-93.0,16.0,27.0,14.0,25.0,0
2251,F8:59:71:5A:E0:3D,2657681,374629848,27147,41629014,2630534,333000834,0,3364,416704,3257,399611,107,17093,3138,0,27168,866,0,32,130000.0,39000.0,-67.0,-74.0,-66.0,-71.0,-68.0,-74.0,-68.0,-71.0,-90.0,-93.0,-90.0,-93.0,23.0,19.0,24.0,22.0,0
2252,CC:2F:71:3E:C5:1F,2635699,333632440,5163,631404,2630536,333001036,6,22161,1858156,18265,1396424,3896,461732,5449,30,7358,133,6,449,144444.0,43333.0,-69.0,-71.0,-69.0,-60.0,-69.0,-71.0,-69.0,-61.0,-90.0,-93.0,-90.0,-93.0,21.0,22.0,21.0,33.0,0
2253,CC:2F:71:3F:1F:24,6283711,5913973149,3653173,5580971911,2630538,333001238,64,778994,466755682,775088,466285076,3906,470606,751614,595,3655252,347569,64,4861,130000.0,43333.0,-73.0,-66.0,-75.0,-68.0,-72.0,-66.0,-75.0,-68.0,-90.0,-93.0,-90.0,-93.0,17.0,27.0,15.0,25.0,0
2254,F8:59:71:5A:E0:3D,2657689,374630656,27147,41629014,2630542,333001642,0,3365,416774,3258,399681,107,17093,3138,0,27168,866,0,32,130000.0,39000.0,-67.0,-72.0,-65.0,-71.0,-68.0,-73.0,-68.0,-71.0,-90.0,-93.0,-90.0,-93.0,23.0,21.0,25.0,22.0,0
2255,CC:2F:71:3E:C5:1F,2635705,333633046,5163,631404,2630542,333001642,6,22161,1858156,18265,1396424,3896,461732,5449,30,7358,133,6,449,144444.0,43333.0,-69.0,-71.0,-69.0,-60.0,-69.0,-71.0,-69.0,-61.0,-90.0,-93.0,-90.0,-93.0,21.0,22.0,21.0,33.0,0
2256,CC:2F:71:3F:1F:24,6288268,5921119603,3657726,5588117961,2630542,333001642,64,779542,466823660,775636,466353054,3906,470606,752156,595,3659806,347861,64,4861,130000.0,43333.0,-73.0,-66.0,-76.0,-68.0,-72.0,-66.0,-76.0,-68.0,-90.0,-93.0,-90.0,-93.0,17.0,27.0,14.0,25.0,0
2257,F8:59:71:5A:E0:3D,2657697,374631614,27147,41629014,2630550,333002600,0,3365,416774,3258,399681,107,17093,3138,0,27168,866,0,32,130000.0,39000.0,-67.0,-72.0,-65.0,-71.0,-68.0,-73.0,-68.0,-71.0,-90.0,-93.0,-90.0,-93.0,23.0,21.0,25.0,22.0,0
2258,CC:2F:71:3E:C5:1F,2635715,333634206,5163,631404,2630552,333002802,6,22163,1858296,18267,1396564,3896,461732,5449,30,7359,133,6,449,144444.0,43333.0,-70.0,-71.0,-70.0,-60.0,-69.0,-71.0,-69.0,-61.0,-90.0,-93.0,-90.0,-93.0,20.0,22.0,20.0,33.0,0
2259,CC:2F:71:3F:1F:24,6293881,5929917985,3663329,5596915183,2630552,333002802,64,780239,466909324,776333,466438718,3906,470606,752853,595,3665423,349125,64,4861,130000.0,43333.0,-72.0,-66.0,-75.0,-68.0,-72.0,-66.0,-75.0,-68.0,-90.0,-93.0,-90.0,-93.0,18.0,27.0,15.0,25.0,0
2260,F8:59:71:5A:E0:3D,2657702,374632080,27147,41629014,2630555,333003066,0,3365,416774,3258,399681,107,17093,3138,0,27168,866,0,32,130000.0,39000.0,-67.0,-72.0,-65.0,-71.0,-68.0,-73.0,-68.0,-71.0,-90.0,-93.0,-90.0,-93.0,23.0,21.0,25.0,22.0,0
2261,CC:2F:71:3E:C5:1F,2635718,333634470,5163,631404,2630555,333003066,6,22163,1858296,18267,1396564,3896,461732,5449,30,7359,133,6,449,144444.0,43333.0,-70.0,-71.0,-70.0,-60.0,-69.0,-71.0,-69.0,-61.0,-90.0,-93.0,-90.0,-93.0,20.0,22.0,20.0,33.0,0
2262,CC:2F:71:3F:1F:24,6296508,5934016705,3665953,5601013639,2630555,333003066,64,780594,466953380,776687,466482656,3907,470724,753208,595,3668017,349544,64,4861,130000.0,43333.0,-72.0,-65.0,-76.0,-68.0,-72.0,-65.0,-74.0,-68.0,-90.0,-93.0,-90.0,-93.0,18.0,28.0,14.0,25.0,0
2263,F8:59:71:5A:E0:3D,2657709,374632746,27147,41629014,2630562,333003732,0,3365,416774,3258,399681,107,17093,3138,0,27168,866,0,32,130000.0,39000.0,-67.0,-72.0,-65.0,-71.0,-68.0,-73.0,-68.0,-71.0,-90.0,-93.0,-90.0,-93.0,23.0,21.0,25.0,22.0,0
2264,CC:2F:71:3E:C5:1F,2635725,333635136,5163,631404,2630562,333003732,6,22163,1858296,18267,1396564,3896,461732,5449,30,7359,133,6,449,144444.0,43333.0,-70.0,-71.0,-70.0,-60.0,-69.0,-71.0,-69.0,-61.0,-90.0,-93.0,-90.0,-93.0,20.0,22.0,20.0,33.0,0
2265,CC:2F:71:3F:1F:24,6301488,5941821837,3670926,5608818105,2630562,333003732,64,781036,467009496,777129,466538772,3907,470724,753650,595,3672903,350043,64,4861,130000.0,43333.0,-73.0,-66.0,-77.0,-69.0,-72.0,-66.0,-76.0,-68.0,-90.0,-93.0,-90.0,-93.0,17.0,27.0,13.0,24.0,0
2266,F8:59:71:5A:E0:3D,2657711,374632948,27147,41629014,2630564,333003934,0,3365,416774,3258,399681,107,17093,3138,0,27168,866,0,32,130000.0,39000.0,-67.0,-72.0,-65.0,-71.0,-68.0,-73.0,-68.0,-71.0,-90.0,-92.0,-89.0,-93.0,23.0,20.0,24.0,22.0,0
2267,CC:2F:71:3E:C5:1F,2635727,333635338,5163,631404,2630564,333003934,6,22163,1858296,18267,1396564,3896,461732,5449,30,7359,133,6,449,144444.0,43333.0,-70.0,-71.0,-70.0,-60.0,-69.0,-71.0,-69.0,-61.0,-90.0,-92.0,-89.0,-93.0,20.0,21.0,19.0,33.0,0
2268,CC:2F:71:3F:1F:24,6306103,5949059377,3675539,5616055443,2630564,333003934,64,781510,467070190,777603,466599466,3907,470724,754124,595,3677520,350715,64,4863,130000.0,43333.0,-72.0,-65.0,-76.0,-68.0,-72.0,-65.0,-76.0,-68.0,-90.0,-92.0,-89.0,-93.0,18.0,27.0,13.0,25.0,0
2269,F8:59:71:5A:E0:3D,2657720,374633816,27147,41629014,2630573,333004802,0,3365,416774,3258,399681,107,17093,3138,0,27168,866,0,32,130000.0,39000.0,-67.0,-72.0,-65.0,-71.0,-68.0,-73.0,-68.0,-71.0,-90.0,-92.0,-89.0,-93.0,23.0,20.0,24.0,22.0,0
2270,CC:2F:71:3E:C5:1F,2635736,333636206,5163,631404,2630573,333004802,6,22163,1858296,18267,1396564,3896,461732,5449,30,7359,133,6,449,144444.0,43333.0,-70.0,-71.0,-70.0,-60.0,-69.0,-71.0,-69.0,-61.0,-90.0,-92.0,-89.0,-93.0,20.0,21.0,19.0,33.0,0
2271,CC:2F:71:3F:1F:24,6311842,5958052085,3681269,5625047283,2630573,333004802,64,782268,467164570,778361,466693846,3907,470724,754882,595,3683363,352442,64,4863,115556.0,28889.0,-72.0,-65.0,-76.0,-68.0,-72.0,-65.0,-76.0,-68.0,-90.0,-92.0,-89.0,-93.0,18.0,27.0,13.0,25.0,0
2272,F8:59:71:5A:E0:3D,2657727,374634695,27147,41629014,2630580,333005681,0,3365,416774,3258,399681,107,17093,3138,0,27168,866,0,32,130000.0,39000.0,-67.0,-72.0,-65.0,-71.0,-68.0,-73.0,-68.0,-71.0,-90.0,-92.0,-89.0,-93.0,23.0,20.0,24.0,22.0,0
2273,CC:2F:71:3E:C5:1F,2635743,333637085,5163,631404,2630580,333005681,6,22163,1858296,18267,1396564,3896,461732,5449,30,7359,133,6,449,144444.0,43333.0,-70.0,-71.0,-70.0,-60.0,-69.0,-71.0,-69.0,-61.0,-90.0,-92.0,-89.0,-93.0,20.0,21.0,19.0,33.0,0
2274,CC:2F:71:3F:1F:24,6316846,5965883390,3686263,5632877447,2630583,333005943,64,782872,467239008,778965,466768284,3907,470724,755458,595,3688336,353705,64,4863,117000.0,39000.0,-72.0,-66.0,-76.0,-68.0,-71.0,-64.0,-75.0,-67.0,-90.0,-93.0,-90.0,-93.0,18.0,27.0,14.0,25.0,0
2275,F8:59:71:5A:E0:3D,2657730,374634957,27147,41629014,2630583,333005943,0,3365,416774,3258,399681,107,17093,3138,0,27168,866,0,32,130000.0,39000.0,-67.0,-72.0,-65.0,-71.0,-68.0,-73.0,-68.0,-71.0,-90.0,-93.0,-90.0,-93.0,23.0,21.0,25.0,22.0,0
2276,CC:2F:71:3E:C5:1F,2635748,333637549,5163,631404,2630585,333006145,6,22163,1858296,18267,1396564,3896,461732,5449,30,7359,133,6,449,144444.0,43333.0,-70.0,-71.0,-70.0,-60.0,-69.0,-71.0,-69.0,-61.0,-90.0,-93.0,-90.0,-93.0,20.0,22.0,20.0,33.0,0
2277,CC:2F:71:3F:1F:24,6319969,5970759062,3689380,5637752513,2630589,333006549,64,783282,467289656,779375,466818932,3907,470724,755855,595,3691454,354422,64,4863,115556.0,28889.0,-72.0,-66.0,-76.0,-68.0,-72.0,-65.0,-76.0,-68.0,-90.0,-93.0,-90.0,-93.0,18.0,27.0,14.0,25.0,0
2278,F8:59:71:5A:E0:3D,2657738,374635765,27147,41629014,2630591,333006751,0,3365,416774,3258,399681,107,17093,3138,0,27168,866,0,32,130000.0,39000.0,-67.0,-72.0,-65.0,-71.0,-68.0,-73.0,-68.0,-71.0,-90.0,-93.0,-90.0,-93.0,23.0,21.0,25.0,22.0,0
2279,CC:2F:71:3E:C5:1F,2635759,333638619,5163,631404,2630596,333007215,6,22163,1858296,18267,1396564,3896,461732,5449,30,7359,133,6,449,144444.0,43333.0,-70.0,-71.0,-70.0,-60.0,-69.0,-71.0,-69.0,-61.0,-90.0,-93.0,-90.0,-93.0,20.0,22.0,20.0,33.0,0
2280,CC:2F:71:3F:1F:24,6325553,5979509976,3694955,5646502559,2630598,333007417,68,784315,467414022,780408,466943298,3907,470724,756869,596,3697050,356243,68,4863,115556.0,28889.0,-72.0,-65.0,-76.0,-68.0,-72.0,-65.0,-76.0,-68.0,-90.0,-93.0,-90.0,-93.0,18.0,28.0,14.0,25.0,0
2281,F8:59:71:5A:E0:3D,2657747,374636633,27147,41629014,2630600,333007619,0,3365,416774,3258,399681,107,17093,3138,0,27168,866,0,32,130000.0,39000.0,-67.0,-72.0,-65.0,-71.0,-68.0,-73.0,-68.0,-71.0,-90.0,-93.0,-90.0,-93.0,23.0,21.0,25.0,22.0,0
2282,CC:2F:71:3E:C5:1F,2635767,333639427,5163,631404,2630604,333008023,6,22163,1858296,18267,1396564,3896,461732,5449,30,7359,133,6,449,144444.0,43333.0,-70.0,-71.0,-70.0,-60.0,-69.0,-71.0,-69.0,-61.0,-90.0,-93.0,-90.0,-93.0,20.0,22.0,20.0,33.0,0
2283,CC:2F:71:3F:1F:24,6330411,5987121926,3699804,5654113641,2630607,333008285,70,785117,467512908,781210,467042184,3907,470724,757650,597,3701892,357885,70,4863,115556.0,28889.0,-73.0,-66.0,-77.0,-69.0,-72.0,-65.0,-76.0,-68.0,-90.0,-93.0,-90.0,-93.0,17.0,27.0,13.0,24.0,0
2284,F8:59:71:5A:E0:3D,2657756,374637501,27147,41629014,2630609,333008487,0,3365,416774,3258,399681,107,17093,3138,0,27168,866,0,32,130000.0,39000.0,-67.0,-72.0,-65.0,-71.0,-68.0,-73.0,-68.0,-71.0,-90.0,-93.0,-90.0,-93.0,23.0,21.0,25.0,22.0,0
2285,CC:2F:71:3E:C5:1F,2635772,333639891,5163,631404,2630609,333008487,6,22163,1858296,18267,1396564,3896,461732,5449,30,7359,133,6,449,144444.0,43333.0,-70.0,-71.0,-70.0,-60.0,-69.0,-71.0,-69.0,-61.0,-90.0,-93.0,-90.0,-93.0,20.0,22.0,20.0,33.0,0
2286,CC:2F:71:3F:1F:24,6333785,5992401440,3703176,5659392953,2630609,333008487,70,785643,467578170,781736,467107446,3907,470724,758160,597,3705272,359083,70,4864,115556.0,28889.0,-72.0,-65.0,-75.0,-68.0,-72.0,-65.0,-75.0,-68.0,-90.0,-93.0,-90.0,-93.0,18.0,28.0,15.0,25.0,0
2287,F8:59:71:5A:E0:3D,2657764,374638309,27147,41629014,2630617,333009295,0,3365,416774,3258,399681,107,17093,3138,0,27168,866,0,32,130000.0,39000.0,-67.0,-72.0,-65.0,-71.0,-68.0,-73.0,-68.0,-71.0,-90.0,-93.0,-90.0,-93.0,23.0,21.0,25.0,22.0,0
2288,CC:2F:71:3E:C5:1F,2635782,333640819,5164,631464,2630618,333009355,6,22164,1858366,18268,1396634,3896,461732,5449,30,7360,133,6,449,130000.0,39000.0,-70.0,-72.0,-69.0,-60.0,-69.0,-71.0,-68.0,-60.0,-90.0,-93.0,-90.0,-93.0,20.0,21.0,21.0,33.0,0
2289,CC:2F:71:3F:1F:24,6337842,5998751406,3707224,5665742051,2630618,333009355,70,786408,467669962,782501,467199238,3907,470724,758910,597,3709211,359805,70,4864,115556.0,28889.0,-72.0,-66.0,-77.0,-68.0,-71.0,-65.0,-76.0,-68.0,-90.0,-93.0,-90.0,-93.0,18.0,27.0,13.0,25.0,0
2290,F8:59:71:5A:E0:3D,2657774,374639293,27148,41629130,2630626,333010163,0,3367,416914,3260,399821,107,17093,3138,0,27169,866,0,32,130000.0,39000.0,-67.0,-74.0,-66.0,-71.0,-67.0,-73.0,-67.0,-71.0,-90.0,-93.0,-90.0,-93.0,23.0,19.0,24.0,22.0,0
2291,CC:2F:71:3E:C5:1F,2635790,333641627,5164,631464,2630626,333010163,6,22165,1858436,18269,1396704,3896,461732,5449,30,7360,133,6,449,130000.0,39000.0,-70.0,-72.0,-69.0,-61.0,-69.0,-71.0,-68.0,-60.0,-90.0,-93.0,-90.0,-93.0,20.0,21.0,21.0,32.0,0
2292,CC:2F:71:3F:1F:24,6342272,6005685796,3711646,5672675633,2630626,333010163,71,787274,467774498,783367,467303774,3907,470724,759758,597,3713734,361035,71,4864,115556.0,28889.0,-72.0,-65.0,-76.0,-68.0,-71.0,-65.0,-76.0,-68.0,-90.0,-93.0,-90.0,-93.0,18.0,28.0,14.0,25.0,0
2293,F8:59:71:5A:E0:3D,2657775,374639353,27148,41629130,2630627,333010223,0,3367,416914,3260,399821,107,17093,3138,0,27169,866,0,32,130000.0,39000.0,-67.0,-74.0,-66.0,-71.0,-67.0,-73.0,-67.0,-71.0,-90.0,-93.0,-90.0,-93.0,23.0,19.0,24.0,22.0,0
2294,CC:2F:71:3E:C5:1F,2635791,333641687,5164,631464,2630627,333010223,6,22165,1858436,18269,1396704,3896,461732,5449,30,7360,133,6,449,130000.0,39000.0,-70.0,-72.0,-69.0,-61.0,-69.0,-71.0,-68.0,-60.0,-90.0,-93.0,-90.0,-93.0,20.0,21.0,21.0,32.0,0
2295,CC:2F:71:3F:1F:24,6345496,6010730212,3714867,5677719787,2630629,333010425,71,787959,467856920,784052,467386196,3907,470724,760441,597,3716959,361268,71,4864,115556.0,28889.0,-72.0,-66.0,-77.0,-69.0,-72.0,-66.0,-76.0,-68.0,-90.0,-93.0,-90.0,-93.0,18.0,27.0,13.0,24.0,0
2296,F8:59:71:5A:E0:3D,2657784,374640434,27148,41629130,2630636,333011304,0,3367,416914,3260,399821,107,17093,3138,0,27169,866,0,32,130000.0,39000.0,-67.0,-74.0,-66.0,-71.0,-67.0,-73.0,-67.0,-71.0,-90.0,-93.0,-90.0,-93.0,23.0,19.0,24.0,22.0,0
2297,CC:2F:71:3E:C5:1F,2635800,333642768,5164,631464,2630636,333011304,6,22165,1858436,18269,1396704,3896,461732,5449,30,7360,133,6,449,130000.0,39000.0,-70.0,-72.0,-69.0,-61.0,-69.0,-71.0,-68.0,-60.0,-90.0,-93.0,-90.0,-93.0,20.0,21.0,21.0,32.0,0
2298,CC:2F:71:3F:1F:24,6349774,6017426513,3719138,5684415209,2630636,333011304,71,788567,467933042,784660,467462318,3907,470724,761049,597,3721198,362980,71,4864,65000.0,13000.0,-73.0,-66.0,-76.0,-69.0,-72.0,-66.0,-76.0,-69.0,-90.0,-93.0,-90.0,-93.0,17.0,27.0,14.0,24.0,0
2299,F8:59:71:5A:E0:3D,2657794,374641364,27148,41629130,2630646,333012234,0,3369,417102,3261,399891,108,17211,3139,0,27169,866,0,32,130000.0,39000.0,-66.0,-67.0,-66.0,-68.0,-68.0,-73.0,-67.0,-71.0,-90.0,-93.0,-90.0,-93.0,24.0,26.0,24.0,25.0,0
2300,CC:2F:71:3E:C5:1F,2635810,333643698,5164,631464,2630646,333012234,6,22165,1858436,18269,1396704,3896,461732,5449,30,7360,133,6,449,130000.0,39000.0,-70.0,-72.0,-69.0,-61.0,-69.0,-71.0,-68.0,-60.0,-90.0,-93.0,-90.0,-93.0,20.0,21.0,21.0,32.0,0
2301,CC:2F:71:3F:1F:24,6354131,6024245241,3723485,5691233007,2630646,333012234,71,789206,468014664,785299,467543940,3907,470724,761687,597,3725581,363635,71,4864,86667.0,14444.0,-71.0,-66.0,-76.0,-70.0,-71.0,-65.0,-76.0,-69.0,-90.0,-93.0,-90.0,-93.0,19.0,27.0,14.0,23.0,0
2302,F8:59:71:5A:E0:3D,2657794,374641364,27148,41629130,2630646,333012234,0,3369,417102,3261,399891,108,17211,3139,0,27169,866,0,32,130000.0,39000.0,-66.0,-67.0,-66.0,-68.0,-68.0,-73.0,-67.0,-71.0,-90.0,-93.0,-90.0,-93.0,24.0,26.0,24.0,25.0,0
2303,CC:2F:71:3E:C5:1F,2635810,333643698,5164,631464,2630646,333012234,6,22165,1858436,18269,1396704,3896,461732,5449,30,7360,133,6,449,130000.0,39000.0,-70.0,-72.0,-69.0,-61.0,-69.0,-71.0,-68.0,-60.0,-90.0,-93.0,-90.0,-93.0,20.0,21.0,21.0,32.0,0
2304,CC:2F:71:3F:1F:24,6357343,6029273849,3726697,5696261615,2630646,333012234,71,789785,468086304,785878,467615580,3907,470724,762266,597,3728766,363710,71,4864,86667.0,14444.0,-70.0,-66.0,-75.0,-70.0,-69.0,-65.0,-74.0,-69.0,-90.0,-93.0,-90.0,-93.0,20.0,27.0,15.0,23.0,0
2305,F8:59:71:5A:E0:3D,2657803,374642232,27148,41629130,2630655,333013102,0,3369,417102,3261,399891,108,17211,3139,0,27169,866,0,32,130000.0,39000.0,-66.0,-67.0,-66.0,-68.0,-68.0,-73.0,-67.0,-71.0,-90.0,-93.0,-90.0,-93.0,24.0,26.0,24.0,25.0,0
2306,CC:2F:71:3E:C5:1F,2635819,333644566,5164,631464,2630655,333013102,6,22165,1858436,18269,1396704,3896,461732,5449,30,7360,133,6,449,130000.0,39000.0,-70.0,-72.0,-69.0,-61.0,-69.0,-71.0,-68.0,-60.0,-90.0,-93.0,-90.0,-93.0,20.0,21.0,21.0,32.0,0
2307,CC:2F:71:3F:1F:24,6361721,6036126023,3731066,5703112921,2630655,333013102,71,790576,468183998,786669,467713274,3907,470724,763054,597,3733154,364198,71,4866,86667.0,14444.0,-71.0,-66.0,-75.0,-69.0,-71.0,-66.0,-75.0,-69.0,-90.0,-93.0,-90.0,-93.0,19.0,27.0,15.0,24.0,0
2308,F8:59:71:5A:E0:3D,2657803,374642232,27148,41629130,2630655,333013102,0,3369,417102,3261,399891,108,17211,3139,0,27169,866,0,32,130000.0,39000.0,-66.0,-67.0,-66.0,-68.0,-68.0,-73.0,-67.0,-71.0,-90.0,-93.0,-90.0,-93.0,24.0,26.0,24.0,25.0,0
2309,CC:2F:71:3E:C5:1F,2635819,333644566,5164,631464,2630655,333013102,6,22165,1858436,18269,1396704,3896,461732,5449,30,7360,133,6,449,130000.0,39000.0,-70.0,-72.0,-69.0,-61.0,-69.0,-71.0,-68.0,-60.0,-90.0,-93.0,-90.0,-93.0,20.0,21.0,21.0,32.0,0
2310,CC:2F:71:3F:1F:24,6364887,6041076191,3734228,5708062685,2630659,333013506,71,791145,468254082,787238,467783358,3907,470724,763611,597,3736289,364230,71,4866,86667.0,14444.0,-70.0,-66.0,-75.0,-69.0,-70.0,-66.0,-75.0,-68.0,-90.0,-93.0,-90.0,-93.0,20.0,27.0,15.0,24.0,0
2311,F8:59:71:5A:E0:3D,2657811,374643040,27148,41629130,2630663,333013910,0,3369,417102,3261,399891,108,17211,3139,0,27169,866,0,32,130000.0,39000.0,-66.0,-67.0,-66.0,-68.0,-68.0,-73.0,-67.0,-71.0,-90.0,-93.0,-90.0,-93.0,24.0,26.0,24.0,25.0,0
2312,CC:2F:71:3E:C5:1F,2635827,333645374,5164,631464,2630663,333013910,6,22165,1858436,18269,1396704,3896,461732,5449,30,7360,133,6,449,130000.0,39000.0,-70.0,-72.0,-69.0,-61.0,-69.0,-71.0,-68.0,-60.0,-90.0,-93.0,-90.0,-93.0,20.0,21.0,21.0,32.0,0
2313,CC:2F:71:3F:1F:24,6368320,6046447797,3737657,5713433887,2630663,333013910,71,791770,468331158,787863,467860434,3907,470724,764236,597,3739733,364348,71,4867,115556.0,28889.0,-71.0,-66.0,-76.0,-70.0,-71.0,-66.0,-75.0,-69.0,-90.0,-93.0,-90.0,-93.0,19.0,27.0,14.0,23.0,0
2314,F8:59:71:5A:E0:3D,2657812,374643100,27148,41629130,2630664,333013970,0,3369,417102,3261,399891,108,17211,3139,0,27169,866,0,32,130000.0,39000.0,-66.0,-67.0,-66.0,-68.0,-68.0,-73.0,-67.0,-71.0,-90.0,-93.0,-90.0,-93.0,24.0,26.0,24.0,25.0,0
2315,CC:2F:71:3E:C5:1F,2635836,333646242,5164,631464,2630672,333014778,6,22167,1858576,18271,1396844,3896,461732,5449,30,7361,133,6,449,130000.0,39000.0,-77.0,-84.0,-76.0,-72.0,-70.0,-72.0,-70.0,-61.0,-90.0,-93.0,-90.0,-93.0,13.0,9.0,14.0,21.0,0
2316,CC:2F:71:3F:1F:24,6372881,6053588405,3742208,5720573565,2630673,333014840,71,792428,468413618,788520,467942776,3908,470842,764877,597,3744304,365213,71,4868,115556.0,26000.0,-71.0,-66.0,-76.0,-69.0,-71.0,-66.0,-76.0,-69.0,-90.0,-93.0,-90.0,-93.0,19.0,27.0,14.0,24.0,0
2317,F8:59:71:5A:E0:3D,2657821,374643970,27148,41629130,2630673,333014840,0,3371,417242,3263,400031,108,17211,3139,0,27170,866,0,32,130000.0,39000.0,-67.0,-74.0,-66.0,-72.0,-66.0,-72.0,-65.0,-70.0,-90.0,-93.0,-90.0,-93.0,23.0,19.0,24.0,21.0,0
2318,CC:2F:71:3E:C5:1F,2635838,333646366,5164,631464,2630674,333014902,6,22169,1858764,18272,1396914,3897,461850,5450,30,7361,133,6,449,130000.0,39000.0,-70.0,-71.0,-69.0,-60.0,-70.0,-72.0,-70.0,-61.0,-90.0,-93.0,-90.0,-93.0,20.0,22.0,21.0,33.0,0
2319,CC:2F:71:3F:1F:24,6377369,6060627705,3746695,5727612803,2630674,333014902,71,793068,468492628,789160,468021786,3908,470842,765517,597,3748791,365868,71,4868,115556.0,28889.0,-71.0,-66.0,-76.0,-70.0,-71.0,-66.0,-76.0,-70.0,-90.0,-93.0,-90.0,-93.0,19.0,27.0,14.0,23.0,0
2320,F8:59:71:5A:E0:3D,2657831,374644900,27148,41629130,2630683,333015770,0,3371,417242,3263,400031,108,17211,3139,0,27170,866,0,32,130000.0,39000.0,-67.0,-74.0,-66.0,-72.0,-66.0,-72.0,-65.0,-70.0,-90.0,-93.0,-90.0,-93.0,23.0,19.0,24.0,21.0,0
2321,CC:2F:71:3E:C5:1F,2635847,333647234,5164,631464,2630683,333015770,6,22169,1858764,18272,1396914,3897,461850,5450,30,7361,133,6,449,130000.0,39000.0,-70.0,-71.0,-69.0,-60.0,-70.0,-72.0,-70.0,-61.0,-90.0,-93.0,-90.0,-93.0,20.0,22.0,21.0,33.0,0
2322,CC:2F:71:3F:1F:24,6380602,6065672605,3749919,5732656835,2630683,333015770,71,793583,468555738,789675,468084896,3908,470842,766032,597,3752015,366297,71,4868,115556.0,28889.0,-78.0,-72.0,-81.0,-76.0,-77.0,-72.0,-81.0,-75.0,-90.0,-93.0,-90.0,-93.0,12.0,21.0,9.0,17.0,0
2323,F8:59:71:5A:E0:3D,2657831,374644900,27148,41629130,2630683,333015770,0,3371,417242,3263,400031,108,17211,3139,0,27170,866,0,32,130000.0,39000.0,-67.0,-74.0,-66.0,-72.0,-66.0,-72.0,-65.0,-70.0,-90.0,-93.0,-90.0,-93.0,23.0,19.0,24.0,21.0,0
2324,CC:2F:71:3E:C5:1F,2635847,333647234,5164,631464,2630683,333015770,6,22169,1858764,18272,1396914,3897,461850,5450,30,7361,133,6,449,130000.0,39000.0,-70.0,-71.0,-69.0,-60.0,-70.0,-72.0,-70.0,-61.0,-90.0,-93.0,-90.0,-93.0,20.0,22.0,21.0,33.0,0
2325,CC:2F:71:3F:1F:24,6385495,6073350799,3754812,5740335029,2630683,333015770,71,794208,468636350,790300,468165508,3908,470842,766657,597,3756908,366863,71,4868,117000.0,39000.0,-70.0,-65.0,-74.0,-69.0,-70.0,-65.0,-75.0,-68.0,-90.0,-93.0,-90.0,-93.0,20.0,28.0,16.0,24.0,0
2326,F8:59:71:5A:E0:3D,2657840,374645768,27148,41629130,2630692,333016638,0,3371,417242,3263,400031,108,17211,3139,0,27170,866,0,32,130000.0,39000.0,-67.0,-74.0,-66.0,-72.0,-66.0,-72.0,-65.0,-70.0,-90.0,-93.0,-90.0,-93.0,23.0,19.0,24.0,21.0,0
2327,CC:2F:71:3E:C5:1F,2635856,333648102,5164,631464,2630692,333016638,6,22169,1858764,18272,1396914,3897,461850,5450,30,7361,133,6,449,130000.0,39000.0,-70.0,-71.0,-69.0,-60.0,-70.0,-72.0,-70.0,-61.0,-90.0,-93.0,-90.0,-93.0,20.0,22.0,21.0,33.0,0
2328,CC:2F:71:3F:1F:24,6389932,6080296835,3759240,5747280197,2630692,333016638,71,794818,468711496,790910,468240654,3908,470842,767267,597,3761321,367328,71,4868,115556.0,28889.0,-71.0,-65.0,-75.0,-69.0,-70.0,-65.0,-74.0,-69.0,-90.0,-93.0,-90.0,-93.0,19.0,28.0,15.0,24.0,0
2329,F8:59:71:5A:E0:3D,2657841,374646041,27148,41629130,2630693,333016911,0,3371,417242,3263,400031,108,17211,3139,0,27170,866,0,32,130000.0,39000.0,-67.0,-74.0,-66.0,-72.0,-66.0,-72.0,-65.0,-70.0,-90.0,-93.0,-90.0,-93.0,23.0,19.0,24.0,21.0,0
2330,CC:2F:71:3E:C5:1F,2635861,333648779,5164,631464,2630697,333017315,6,22169,1858764,18272,1396914,3897,461850,5450,30,7361,133,6,449,130000.0,39000.0,-70.0,-71.0,-69.0,-60.0,-70.0,-72.0,-70.0,-61.0,-90.0,-93.0,-90.0,-93.0,20.0,22.0,21.0,33.0,0
2331,CC:2F:71:3F:1F:24,6394233,6087030718,3763534,5754013201,2630699,333017517,71,795340,468778040,791432,468307198,3908,470842,767789,597,3765615,367703,71,4869,115556.0,28889.0,-70.0,-65.0,-75.0,-69.0,-70.0,-65.0,-74.0,-69.0,-90.0,-93.0,-90.0,-93.0,20.0,28.0,15.0,24.0,0
2332,F8:59:71:5A:E0:3D,2657850,374646909,27148,41629130,2630702,333017779,0,3371,417242,3263,400031,108,17211,3139,0,27170,866,0,32,130000.0,39000.0,-67.0,-74.0,-66.0,-72.0,-66.0,-72.0,-65.0,-70.0,-90.0,-93.0,-90.0,-93.0,23.0,19.0,24.0,21.0,0
2333,CC:2F:71:3E:C5:1F,2635866,333649243,5164,631464,2630702,333017779,6,22169,1858764,18272,1396914,3897,461850,5450,30,7361,133,6,449,130000.0,39000.0,-70.0,-71.0,-69.0,-60.0,-70.0,-72.0,-70.0,-61.0,-90.0,-93.0,-90.0,-93.0,20.0,22.0,21.0,33.0,0
2334,CC:2F:71:3F:1F:24,6399439,6095203306,3768737,5762185527,2630702,333017779,71,796223,468884384,792315,468413542,3908,470842,768672,597,3770766,369467,71,4869,65000.0,13000.0,-71.0,-66.0,-76.0,-69.0,-70.0,-65.0,-75.0,-69.0,-90.0,-93.0,-90.0,-93.0,19.0,27.0,14.0,24.0,0
2335,F8:59:71:5A:E0:3D,2657858,374647717,27148,41629130,2630710,333018587,0,3371,417242,3263,400031,108,17211,3139,0,27170,866,0,32,130000.0,39000.0,-67.0,-74.0,-66.0,-72.0,-66.0,-72.0,-65.0,-70.0,-90.0,-93.0,-90.0,-93.0,23.0,19.0,24.0,21.0,0
2336,CC:2F:71:3E:C5:1F,2635874,333650051,5164,631464,2630710,333018587,6,22169,1858764,18272,1396914,3897,461850,5450,30,7361,133,6,449,130000.0,39000.0,-70.0,-71.0,-69.0,-60.0,-70.0,-72.0,-70.0,-61.0,-90.0,-93.0,-90.0,-93.0,20.0,22.0,21.0,33.0,0
2337,CC:2F:71:3F:1F:24,6404434,6103029176,3773724,5770010589,2630710,333018587,71,796916,468971096,793008,468500254,3908,470842,769365,597,3775747,369563,71,4869,86667.0,14444.0,-71.0,-66.0,-76.0,-70.0,-73.0,-67.0,-77.0,-71.0,-90.0,-93.0,-90.0,-93.0,19.0,27.0,14.0,23.0,0
2338,F8:59:71:5A:E0:3D,2657861,374647979,27148,41629130,2630713,333018849,0,3371,417242,3263,400031,108,17211,3139,0,27170,866,0,32,130000.0,39000.0,-67.0,-74.0,-66.0,-72.0,-66.0,-72.0,-65.0,-70.0,-90.0,-93.0,-90.0,-93.0,23.0,19.0,24.0,21.0,0
2339,CC:2F:71:3E:C5:1F,2635881,333650717,5164,631464,2630717,333019253,6,22169,1858764,18272,1396914,3897,461850,5450,30,7361,133,6,449,130000.0,39000.0,-70.0,-71.0,-69.0,-60.0,-70.0,-72.0,-70.0,-61.0,-90.0,-93.0,-90.0,-93.0,20.0,22.0,21.0,33.0,0
2340,CC:2F:71:3F:1F:24,6407898,6108442940,3777181,5775423687,2630717,333019253,71,797444,469037060,793536,468566218,3908,470842,769893,597,3779267,370091,71,4869,115556.0,28889.0,-70.0,-65.0,-72.0,-68.0,-70.0,-65.0,-74.0,-68.0,-90.0,-93.0,-90.0,-93.0,20.0,28.0,18.0,25.0,0
2341,F8:59:71:5A:E0:3D,2657867,374648585,27148,41629130,2630719,333019455,0,3371,417242,3263,400031,108,17211,3139,0,27170,866,0,32,130000.0,39000.0,-67.0,-74.0,-66.0,-72.0,-66.0,-72.0,-65.0,-70.0,-90.0,-93.0,-90.0,-93.0,23.0,19.0,24.0,21.0,0
2342,CC:2F:71:3E:C5:1F,2635883,333650919,5164,631464,2630719,333019455,6,22169,1858764,18272,1396914,3897,461850,5450,30,7361,133,6,449,130000.0,39000.0,-70.0,-71.0,-69.0,-60.0,-70.0,-72.0,-70.0,-61.0,-90.0,-93.0,-90.0,-93.0,20.0,22.0,21.0,33.0,0
2343,CC:2F:71:3F:1F:24,6412369,6115456640,3781650,5782437185,2630719,333019455,71,797976,469104332,794068,468633490,3908,470842,770425,597,3783746,370232,71,4869,115556.0,28889.0,-70.0,-65.0,-75.0,-69.0,-70.0,-65.0,-74.0,-69.0,-90.0,-93.0,-90.0,-93.0,20.0,28.0,15.0,24.0,0
2344,F8:59:71:5A:E0:3D,2657874,374649251,27148,41629130,2630726,333020121,0,3371,417242,3263,400031,108,17211,3139,0,27170,866,0,32,130000.0,39000.0,-67.0,-74.0,-66.0,-72.0,-66.0,-72.0,-65.0,-70.0,-90.0,-93.0,-90.0,-93.0,23.0,19.0,24.0,21.0,0
2345,CC:2F:71:3E:C5:1F,2635892,333651953,5164,631464,2630728,333020489,6,22169,1858764,18272,1396914,3897,461850,5450,30,7361,133,6,449,130000.0,39000.0,-70.0,-71.0,-69.0,-60.0,-70.0,-72.0,-70.0,-61.0,-90.0,-93.0,-90.0,-93.0,20.0,22.0,21.0,33.0,0
2346,CC:2F:71:3F:1F:24,6416845,6122464742,3786115,5789444051,2630730,333020691,71,798486,469168280,794578,468697438,3908,470842,770935,597,3788202,371249,71,4869,115556.0,28889.0,-71.0,-65.0,-75.0,-69.0,-70.0,-65.0,-75.0,-69.0,-90.0,-93.0,-90.0,-93.0,19.0,28.0,15.0,24.0,0
2347,F8:59:71:5A:E0:3D,2657878,374649821,27148,41629130,2630730,333020691,0,3371,417242,3263,400031,108,17211,3139,0,27170,866,0,32,130000.0,39000.0,-67.0,-74.0,-66.0,-72.0,-66.0,-72.0,-65.0,-70.0,-90.0,-93.0,-90.0,-93.0,23.0,19.0,24.0,21.0,0
2348,CC:2F:71:3E:C5:1F,2635894,333652155,5164,631464,2630730,333020691,6,22169,1858764,18272,1396914,3897,461850,5450,30,7361,133,6,449,130000.0,39000.0,-70.0,-71.0,-69.0,-60.0,-70.0,-72.0,-70.0,-61.0,-90.0,-93.0,-90.0,-93.0,20.0,22.0,21.0,33.0,0
2349,CC:2F:71:3F:1F:24,6421252,6129377508,3790522,5796356817,2630730,333020691,71,799019,469234080,795111,468763238,3908,470842,771467,597,3792569,371980,71,4869,115556.0,28889.0,-71.0,-65.0,-75.0,-69.0,-70.0,-65.0,-74.0,-68.0,-90.0,-93.0,-90.0,-93.0,19.0,28.0,15.0,24.0,0
2350,F8:59:71:5A:E0:3D,2657886,374650629,27148,41629130,2630738,333021499,0,3371,417242,3263,400031,108,17211,3139,0,27170,866,0,32,130000.0,39000.0,-67.0,-74.0,-66.0,-72.0,-66.0,-72.0,-65.0,-70.0,-90.0,-93.0,-90.0,-93.0,23.0,19.0,24.0,21.0,0
2351,CC:2F:71:3E:C5:1F,2635904,333653083,5165,631524,2630739,333021559,6,22170,1858834,18273,1396984,3897,461850,5450,30,7362,133,6,449,130000.0,39000.0,-66.0,-62.0,-68.0,-60.0,-70.0,-71.0,-70.0,-61.0,-90.0,-93.0,-90.0,-93.0,24.0,31.0,22.0,33.0,0
2352,CC:2F:71:3F:1F:24,6427336,6138920503,3796597,5805898944,2630739,333021559,71,799873,469337785,795965,468866943,3908,470842,772320,597,3798617,373381,71,4869,86667.0,14444.0,-70.0,-65.0,-75.0,-68.0,-70.0,-65.0,-74.0,-68.0,-90.0,-93.0,-90.0,-93.0,20.0,28.0,15.0,25.0,0
2353,F8:59:71:5A:E0:3D,2657898,374651737,27149,41629246,2630749,333022491,0,3373,417382,3265,400171,108,17211,3139,0,27171,866,0,32,130000.0,39000.0,-67.0,-75.0,-66.0,-72.0,-67.0,-73.0,-67.0,-71.0,-90.0,-93.0,-90.0,-93.0,23.0,18.0,24.0,21.0,0
2354,CC:2F:71:3E:C5:1F,2635914,333654015,5165,631524,2630749,333022491,6,22173,1859092,18275,1397124,3898,461968,5451,30,7362,133,6,449,130000.0,39000.0,-65.0,-63.0,-68.0,-59.0,-69.0,-70.0,-69.0,-61.0,-90.0,-93.0,-90.0,-93.0,25.0,30.0,22.0,34.0,0
2355,CC:2F:71:3F:1F:24,6432381,6146819265,3801632,5813796774,2630749,333022491,71,800821,469453765,796912,468982805,3909,470960,773268,597,3803642,373976,71,4869,86667.0,14444.0,-72.0,-66.0,-76.0,-69.0,-71.0,-66.0,-76.0,-69.0,-90.0,-93.0,-90.0,-93.0,18.0,27.0,14.0,24.0,0
2356,F8:59:71:5A:E0:3D,2657899,374651797,27149,41629246,2630750,333022551,0,3373,417382,3265,400171,108,17211,3139,0,27171,866,0,32,130000.0,39000.0,-67.0,-75.0,-66.0,-72.0,-67.0,-73.0,-67.0,-71.0,-90.0,-93.0,-90.0,-93.0,23.0,18.0,24.0,21.0,0
2357,CC:2F:71:3E:C5:1F,2635919,333654479,5165,631524,2630754,333022955,6,22173,1859092,18275,1397124,3898,461968,5451,30,7362,133,6,449,130000.0,39000.0,-65.0,-63.0,-68.0,-59.0,-69.0,-70.0,-69.0,-61.0,-90.0,-93.0,-90.0,-93.0,25.0,30.0,22.0,34.0,0
2358,CC:2F:71:3F:1F:24,6434754,6150517361,3804000,5817494406,2630754,333022955,71,801299,469512131,797390,469041171,3909,470960,773746,597,3806096,374434,71,4869,115556.0,28889.0,-71.0,-66.0,-75.0,-69.0,-71.0,-65.0,-75.0,-69.0,-90.0,-93.0,-90.0,-93.0,19.0,27.0,15.0,24.0,0
2359,F8:59:71:5A:E0:3D,2657908,374652878,27149,41629246,2630759,333023632,0,3373,417382,3265,400171,108,17211,3139,0,27171,866,0,32,130000.0,39000.0,-67.0,-75.0,-66.0,-72.0,-67.0,-73.0,-67.0,-71.0,-90.0,-93.0,-90.0,-93.0,23.0,18.0,24.0,21.0,0
2360,CC:2F:71:3E:C5:1F,2635924,333655156,5165,631524,2630759,333023632,6,22173,1859092,18275,1397124,3898,461968,5451,30,7362,133,6,449,130000.0,39000.0,-65.0,-63.0,-68.0,-59.0,-69.0,-70.0,-69.0,-61.0,-90.0,-93.0,-90.0,-93.0,25.0,30.0,22.0,34.0,0
2361,CC:2F:71:3F:1F:24,6438922,6157045772,3808163,5824022140,2630759,333023632,71,801922,469588637,798013,469117677,3909,470960,774369,597,3810248,374531,71,4869,115556.0,28889.0,-71.0,-66.0,-75.0,-69.0,-71.0,-66.0,-75.0,-69.0,-90.0,-93.0,-90.0,-93.0,19.0,27.0,15.0,24.0,0
2362,F8:59:71:5A:E0:3D,2657911,374653142,27149,41629246,2630762,333023896,0,3375,417570,3266,400241,109,17329,3140,0,27171,866,0,32,130000.0,39000.0,-67.0,-73.0,-66.0,-72.0,-67.0,-73.0,-67.0,-71.0,-90.0,-93.0,-90.0,-93.0,23.0,20.0,24.0,21.0,0
2363,CC:2F:71:3E:C5:1F,2635929,333655622,5165,631524,2630764,333024098,6,22173,1859092,18275,1397124,3898,461968,5451,30,7362,133,6,449,130000.0,39000.0,-65.0,-63.0,-68.0,-59.0,-69.0,-70.0,-69.0,-61.0,-90.0,-93.0,-90.0,-93.0,25.0,30.0,22.0,34.0,0
2364,CC:2F:71:3F:1F:24,6443390,6164048526,3812625,5831024368,2630765,333024158,71,802560,469667005,798651,469196045,3909,470960,775007,597,3814664,374976,71,4869,115556.0,28889.0,-70.0,-66.0,-74.0,-69.0,-70.0,-65.0,-74.0,-69.0,-90.0,-93.0,-90.0,-93.0,20.0,27.0,16.0,24.0,0
2365,F8:59:71:5A:E0:3D,2657918,374653808,27149,41629246,2630769,333024562,0,3375,417570,3266,400241,109,17329,3140,0,27171,866,0,32,130000.0,39000.0,-67.0,-73.0,-66.0,-72.0,-67.0,-73.0,-67.0,-71.0,-90.0,-93.0,-90.0,-93.0,23.0,20.0,24.0,21.0,0
2366,CC:2F:71:3E:C5:1F,2635934,333656086,5165,631524,2630769,333024562,6,22173,1859092,18275,1397124,3898,461968,5451,30,7362,133,6,449,130000.0,39000.0,-65.0,-63.0,-68.0,-59.0,-69.0,-70.0,-69.0,-61.0,-90.0,-93.0,-90.0,-93.0,25.0,30.0,22.0,34.0,0
2367,CC:2F:71:3F:1F:24,6448545,6172136904,3817776,5839112342,2630769,333024562,71,803500,469779351,799591,469308391,3909,470960,775947,597,3819870,375469,71,4869,115556.0,28889.0,-71.0,-65.0,-75.0,-69.0,-70.0,-65.0,-75.0,-69.0,-90.0,-93.0,-90.0,-93.0,19.0,28.0,15.0,24.0,0
2368,F8:59:71:5A:E0:3D,2657922,374654212,27149,41629246,2630773,333024966,0,3375,417570,3266,400241,109,17329,3140,0,27171,866,0,32,130000.0,39000.0,-67.0,-73.0,-66.0,-72.0,-67.0,-73.0,-67.0,-71.0,-90.0,-93.0,-90.0,-93.0,23.0,20.0,24.0,21.0,0
2369,CC:2F:71:3E:C5:1F,2635940,333656692,5165,631524,2630775,333025168,6,22173,1859092,18275,1397124,3898,461968,5451,30,7362,133,6,449,130000.0,39000.0,-65.0,-63.0,-68.0,-59.0,-69.0,-70.0,-69.0,-61.0,-90.0,-93.0,-90.0,-93.0,25.0,30.0,22.0,34.0,0
2370,CC:2F:71:3F:1F:24,6454304,6181166672,3823526,5848141242,2630778,333025430,71,804302,469877005,800393,469406045,3909,470960,776749,597,3825566,376185,71,4869,115556.0,28889.0,-71.0,-65.0,-75.0,-69.0,-70.0,-65.0,-74.0,-69.0,-90.0,-93.0,-90.0,-93.0,19.0,28.0,15.0,24.0,0
2371,F8:59:71:5A:E0:3D,2657927,374654676,27149,41629246,2630778,333025430,0,3375,417570,3266,400241,109,17329,3140,0,27171,866,0,32,130000.0,39000.0,-67.0,-73.0,-66.0,-72.0,-67.0,-73.0,-67.0,-71.0,-90.0,-93.0,-90.0,-93.0,23.0,20.0,24.0,21.0,0
2372,CC:2F:71:3E:C5:1F,2635943,333656954,5165,631524,2630778,333025430,6,22173,1859092,18275,1397124,3898,461968,5451,30,7362,133,6,449,130000.0,39000.0,-65.0,-63.0,-68.0,-59.0,-69.0,-70.0,-69.0,-61.0,-90.0,-93.0,-90.0,-93.0,25.0,30.0,22.0,34.0,0
2373,CC:2F:71:3F:1F:24,6458195,6187260612,3827415,5854234980,2630780,333025632,71,804754,469933829,800845,469462869,3909,470960,777201,597,3829481,376749,71,4869,115556.0,28889.0,-71.0,-65.0,-75.0,-69.0,-70.0,-65.0,-74.0,-69.0,-90.0,-93.0,-90.0,-93.0,19.0,28.0,15.0,24.0,0
2374,F8:59:71:5A:E0:3D,2657933,374655282,27149,41629246,2630784,333026036,0,3375,417570,3266,400241,109,17329,3140,0,27171,866,0,32,130000.0,39000.0,-67.0,-73.0,-66.0,-72.0,-67.0,-73.0,-67.0,-71.0,-90.0,-93.0,-90.0,-93.0,23.0,20.0,24.0,21.0,0
2375,CC:2F:71:3E:C5:1F,2635951,333657762,5165,631524,2630786,333026238,6,22173,1859092,18275,1397124,3898,461968,5451,30,7362,133,6,449,130000.0,39000.0,-65.0,-63.0,-68.0,-59.0,-69.0,-70.0,-69.0,-61.0,-90.0,-93.0,-90.0,-93.0,25.0,30.0,22.0,34.0,0
2376,CC:2F:71:3F:1F:24,6462816,6194493250,3832019,5861461588,2630797,333031662,71,805441,470017255,801532,469546295,3909,470960,777888,597,3834059,377011,71,4869,115556.0,28889.0,-70.0,-66.0,-75.0,-70.0,-70.0,-66.0,-75.0,-69.0,-90.0,-93.0,-90.0,-93.0,20.0,27.0,15.0,23.0,0
2377,F8:59:71:5A:E0:3D,2657960,374666594,27149,41629246,2630811,333037348,0,3375,417570,3266,400241,109,17329,3140,0,27171,866,0,32,130000.0,39000.0,-67.0,-73.0,-66.0,-72.0,-67.0,-73.0,-67.0,-71.0,-90.0,-93.0,-90.0,-93.0,23.0,20.0,24.0,21.0,0
2378,CC:2F:71:3E:C5:1F,2635976,333668872,5165,631524,2630811,333037348,6,22173,1859092,18275,1397124,3898,461968,5451,30,7362,133,6,449,130000.0,39000.0,-65.0,-63.0,-68.0,-59.0,-69.0,-70.0,-69.0,-61.0,-90.0,-93.0,-90.0,-93.0,25.0,30.0,22.0,34.0,0
2379,CC:2F:71:3F:1F:24,6467487,6201798408,3836674,5868760858,2630813,333037550,71,806045,470094951,802136,469623991,3909,470960,778492,597,3838757,377596,71,4869,115556.0,28889.0,-71.0,-66.0,-75.0,-70.0,-71.0,-66.0,-75.0,-70.0,-90.0,-93.0,-90.0,-93.0,19.0,27.0,15.0,23.0,0
2380,F8:59:71:5A:E0:3D,2657966,374667200,27149,41629246,2630817,333037954,0,3377,417710,3268,400381,109,17329,3140,0,27172,866,0,32,130000.0,39000.0,-67.0,-74.0,-66.0,-72.0,-68.0,-74.0,-67.0,-72.0,-90.0,-93.0,-90.0,-93.0,23.0,19.0,24.0,21.0,0
2381,CC:2F:71:3E:C5:1F,2635982,333669478,5165,631524,2630817,333037954,6,22175,1859232,18277,1397264,3898,461968,5451,30,7363,133,6,449,130000.0,39000.0,-69.0,-71.0,-70.0,-60.0,-68.0,-69.0,-69.0,-61.0,-90.0,-93.0,-90.0,-93.0,21.0,22.0,20.0,33.0,0
2382,CC:2F:71:3F:1F:24,6472438,6209558802,3841621,5876520848,2630817,333037954,71,806612,470166547,802703,469695587,3909,470960,779059,597,3843717,378552,71,4869,86667.0,14444.0,-71.0,-66.0,-74.0,-68.0,-71.0,-66.0,-73.0,-68.0,-90.0,-93.0,-90.0,-93.0,19.0,27.0,16.0,25.0,0
2383,F8:59:71:5A:E0:3D,2657973,374667866,27149,41629246,2630824,333038620,0,3377,417710,3268,400381,109,17329,3140,0,27172,866,0,32,130000.0,39000.0,-67.0,-74.0,-66.0,-72.0,-68.0,-74.0,-67.0,-72.0,-90.0,-93.0,-90.0,-93.0,23.0,19.0,24.0,21.0,0
2384,CC:2F:71:3E:C5:1F,2635991,333670346,5165,631524,2630826,333038822,6,22175,1859232,18277,1397264,3898,461968,5451,30,7363,133,6,449,130000.0,39000.0,-69.0,-71.0,-70.0,-60.0,-68.0,-69.0,-69.0,-61.0,-90.0,-93.0,-90.0,-93.0,21.0,22.0,20.0,33.0,0
2385,CC:2F:71:3F:1F:24,6477982,6218243292,3847156,5885204470,2630826,333038822,71,807400,470268229,803491,469797269,3909,470960,779847,597,3849252,379116,71,4871,86667.0,14444.0,-72.0,-66.0,-74.0,-70.0,-71.0,-66.0,-73.0,-69.0,-90.0,-93.0,-90.0,-93.0,18.0,27.0,16.0,23.0,0
2386,F8:59:71:5A:E0:3D,2657979,374668472,27149,41629246,2630830,333039226,0,3377,417710,3268,400381,109,17329,3140,0,27172,866,0,32,130000.0,39000.0,-67.0,-74.0,-66.0,-72.0,-68.0,-74.0,-67.0,-72.0,-90.0,-93.0,-90.0,-93.0,23.0,19.0,24.0,21.0,0
2387,CC:2F:71:3E:C5:1F,2635997,333670952,5165,631524,2630832,333039428,6,22175,1859232,18277,1397264,3898,461968,5451,30,7363,133,6,449,130000.0,39000.0,-69.0,-71.0,-70.0,-60.0,-68.0,-69.0,-69.0,-61.0,-90.0,-93.0,-90.0,-93.0,21.0,22.0,20.0,33.0,0
2388,CC:2F:71:3F:1F:24,6483372,6226691018,3852537,5893651328,2630835,333039690,71,808273,470376119,804364,469905159,3909,470960,780714,597,3854632,379228,71,4871,86667.0,14444.0,-71.0,-66.0,-74.0,-69.0,-73.0,-69.0,-77.0,-72.0,-90.0,-93.0,-90.0,-93.0,19.0,27.0,16.0,24.0,0
2389,F8:59:71:5A:E0:3D,2657989,374669613,27149,41629246,2630840,333040367,0,3377,417710,3268,400381,109,17329,3140,0,27172,866,0,32,130000.0,39000.0,-67.0,-74.0,-66.0,-72.0,-68.0,-74.0,-67.0,-72.0,-90.0,-92.0,-89.0,-92.0,23.0,18.0,23.0,20.0,0
2390,CC:2F:71:3E:C5:1F,2636005,333671891,5165,631524,2630840,333040367,6,22175,1859232,18277,1397264,3898,461968,5451,30,7363,133,6,449,130000.0,39000.0,-69.0,-71.0,-70.0,-60.0,-68.0,-69.0,-69.0,-61.0,-90.0,-92.0,-89.0,-92.0,21.0,21.0,19.0,32.0,0
2391,CC:2F:71:3F:1F:24,6486525,6231610781,3855683,5898570212,2630842,333040569,72,808679,470426457,804770,469955497,3909,470960,781107,598,3857770,379528,72,4871,130000.0,43333.0,-71.0,-65.0,-74.0,-69.0,-71.0,-65.0,-74.0,-69.0,-90.0,-92.0,-89.0,-92.0,19.0,27.0,15.0,23.0,0
2392,F8:59:71:5A:E0:3D,2657993,374670017,27149,41629246,2630844,333040771,0,3377,417710,3268,400381,109,17329,3140,0,27172,866,0,32,130000.0,39000.0,-67.0,-74.0,-66.0,-72.0,-68.0,-74.0,-67.0,-72.0,-90.0,-92.0,-89.0,-92.0,23.0,18.0,23.0,20.0,0
2393,CC:2F:71:3E:C5:1F,2636010,333672355,5165,631524,2630845,333040831,6,22175,1859232,18277,1397264,3898,461968,5451,30,7363,133,6,449,130000.0,39000.0,-69.0,-71.0,-70.0,-60.0,-68.0,-69.0,-69.0,-61.0,-90.0,-92.0,-89.0,-92.0,21.0,21.0,19.0,32.0,0
2394,CC:2F:71:3F:1F:24,6490568,6237941491,3859723,5904900660,2630845,333040831,74,809217,470493207,805308,470022247,3909,470960,781637,598,3861805,379653,74,4871,130000.0,43333.0,-71.0,-65.0,-74.0,-70.0,-71.0,-65.0,-74.0,-69.0,-90.0,-92.0,-89.0,-92.0,19.0,27.0,15.0,22.0,0
2395,F8:59:71:5A:E0:3D,2658000,374670683,27149,41629246,2630851,333041437,0,3377,417710,3268,400381,109,17329,3140,0,27172,866,0,32,130000.0,39000.0,-67.0,-74.0,-66.0,-72.0,-68.0,-74.0,-67.0,-72.0,-90.0,-92.0,-89.0,-92.0,23.0,18.0,23.0,20.0,0
2396,CC:2F:71:3E:C5:1F,2636016,333672961,5165,631524,2630851,333041437,6,22175,1859232,18277,1397264,3898,461968,5451,30,7363,133,6,449,130000.0,39000.0,-69.0,-71.0,-70.0,-60.0,-68.0,-69.0,-69.0,-61.0,-90.0,-92.0,-89.0,-92.0,21.0,21.0,19.0,32.0,0
2397,CC:2F:71:3F:1F:24,6494874,6244685681,3864023,5911644244,2630851,333041437,74,809775,470562587,805866,470091627,3909,470960,782193,598,3866120,380027,74,4871,117000.0,39000.0,-71.0,-65.0,-74.0,-69.0,-71.0,-65.0,-74.0,-69.0,-90.0,-92.0,-89.0,-92.0,19.0,27.0,15.0,23.0,0
2398,F8:59:71:5A:E0:3D,2658002,374670885,27149,41629246,2630853,333041639,0,3377,417710,3268,400381,109,17329,3140,0,27172,866,0,32,130000.0,39000.0,-67.0,-74.0,-66.0,-72.0,-68.0,-74.0,-67.0,-72.0,-90.0,-92.0,-89.0,-92.0,23.0,18.0,23.0,20.0,0
2399,CC:2F:71:3E:C5:1F,2636018,333673163,5165,631524,2630853,333041639,6,22175,1859232,18277,1397264,3898,461968,5451,30,7363,133,6,449,130000.0,39000.0,-69.0,-71.0,-70.0,-60.0,-68.0,-69.0,-69.0,-61.0,-90.0,-92.0,-89.0,-92.0,21.0,21.0,19.0,32.0,0
2400,CC:2F:71:3F:1F:24,6498775,6250795407,3867920,5917753566,2630855,333041841,74,810346,470634107,806437,470163147,3909,470960,782758,598,3870005,380123,74,4871,130000.0,43333.0,-71.0,-65.0,-75.0,-70.0,-70.0,-65.0,-74.0,-69.0,-90.0,-92.0,-89.0,-92.0,19.0,27.0,14.0,22.0,0
2401,F8:59:71:5A:E0:3D,2658009,374671551,27149,41629246,2630860,333042305,0,3377,417710,3268,400381,109,17329,3140,0,27172,866,0,32,130000.0,39000.0,-67.0,-74.0,-66.0,-72.0,-68.0,-74.0,-67.0,-72.0,-90.0,-92.0,-89.0,-92.0,23.0,18.0,23.0,20.0,0
2402,CC:2F:71:3E:C5:1F,2636025,333673829,5165,631524,2630860,333042305,6,22175,1859232,18277,1397264,3898,461968,5451,30,7363,133,6,449,130000.0,39000.0,-69.0,-71.0,-70.0,-60.0,-68.0,-69.0,-69.0,-61.0,-90.0,-92.0,-89.0,-92.0,21.0,21.0,19.0,32.0,0
2403,CC:2F:71:3F:1F:24,6503988,6258972567,3873128,5925930262,2630860,333042305,74,811041,470720845,807132,470249885,3909,470960,783450,598,3875222,380264,74,4871,130000.0,43333.0,-71.0,-65.0,-74.0,-69.0,-71.0,-65.0,-74.0,-69.0,-90.0,-92.0,-89.0,-92.0,19.0,27.0,15.0,23.0,0
2404,F8:59:71:5A:E0:3D,2658011,374671753,27149,41629246,2630862,333042507,0,3377,417710,3268,400381,109,17329,3140,0,27172,866,0,32,130000.0,39000.0,-67.0,-74.0,-66.0,-72.0,-68.0,-74.0,-67.0,-72.0,-90.0,-92.0,-89.0,-92.0,23.0,18.0,23.0,20.0,0
2405,CC:2F:71:3E:C5:1F,2636029,333674233,5165,631524,2630864,333042709,6,22175,1859232,18277,1397264,3898,461968,5451,30,7363,133,6,449,130000.0,39000.0,-69.0,-71.0,-70.0,-60.0,-68.0,-69.0,-69.0,-61.0,-90.0,-92.0,-89.0,-92.0,21.0,21.0,19.0,32.0,0
2406,CC:2F:71:3F:1F:24,6508432,6265933579,3877568,5932890870,2630864,333042709,74,811553,470785081,807644,470314121,3909,470960,783960,598,3879633,380752,74,4871,130000.0,43333.0,-71.0,-65.0,-74.0,-69.0,-71.0,-65.0,-74.0,-69.0,-90.0,-92.0,-89.0,-92.0,19.0,27.0,15.0,23.0,0
2407,F8:59:71:5A:E0:3D,2658018,374672419,27149,41629246,2630869,333043173,0,3377,417710,3268,400381,109,17329,3140,0,27172,866,0,32,130000.0,39000.0,-67.0,-74.0,-66.0,-72.0,-68.0,-74.0,-67.0,-72.0,-90.0,-92.0,-89.0,-92.0,23.0,18.0,23.0,20.0,0
2408,CC:2F:71:3E:C5:1F,2636034,333674697,5165,631524,2630869,333043173,6,22175,1859232,18277,1397264,3898,461968,5451,30,7363,133,6,449,130000.0,39000.0,-69.0,-71.0,-70.0,-60.0,-68.0,-69.0,-69.0,-61.0,-90.0,-92.0,-89.0,-92.0,21.0,21.0,19.0,32.0,0
2409,CC:2F:71:3F:1F:24,6513131,6273294839,3882262,5940251666,2630869,333043173,74,811945,470836793,808036,470365833,3909,470960,784351,598,3884333,380923,74,4871,130000.0,43333.0,-71.0,-65.0,-74.0,-69.0,-70.0,-65.0,-74.0,-69.0,-90.0,-92.0,-89.0,-92.0,19.0,27.0,15.0,23.0,0
2410,F8:59:71:5A:E0:3D,2658022,374672823,27149,41629246,2630873,333043577,0,3377,417710,3268,400381,109,17329,3140,0,27172,866,0,32,130000.0,39000.0,-67.0,-74.0,-66.0,-72.0,-68.0,-74.0,-67.0,-72.0,-90.0,-92.0,-89.0,-92.0,23.0,18.0,23.0,20.0,0
2411,CC:2F:71:3E:C5:1F,2636038,333675101,5165,631524,2630873,333043577,6,22175,1859232,18277,1397264,3898,461968,5451,30,7363,133,6,449,130000.0,39000.0,-69.0,-71.0,-70.0,-60.0,-68.0,-69.0,-69.0,-61.0,-90.0,-92.0,-89.0,-92.0,21.0,21.0,19.0,32.0,0
2412,CC:2F:71:3F:1F:24,6518374,6281514889,3887501,5948471312,2630873,333043577,74,812443,470900587,808534,470429627,3909,470960,784849,598,3889585,381576,74,4871,130000.0,43333.0,-71.0,-65.0,-74.0,-69.0,-70.0,-65.0,-73.0,-69.0,-90.0,-92.0,-89.0,-92.0,19.0,27.0,15.0,23.0,0
2413,F8:59:71:5A:E0:3D,2658026,374673227,27149,41629246,2630877,333043981,0,3377,417710,3268,400381,109,17329,3140,0,27172,866,0,32,130000.0,39000.0,-67.0,-74.0,-66.0,-72.0,-68.0,-74.0,-67.0,-72.0,-90.0,-92.0,-89.0,-92.0,23.0,18.0,23.0,20.0,0
2414,CC:2F:71:3E:C5:1F,2636044,333675707,5165,631524,2630879,333044183,6,22175,1859232,18277,1397264,3898,461968,5451,30,7363,133,6,449,130000.0,39000.0,-69.0,-71.0,-70.0,-60.0,-68.0,-69.0,-69.0,-61.0,-90.0,-92.0,-89.0,-92.0,21.0,21.0,19.0,32.0,0
2415,CC:2F:71:3F:1F:24,6522691,6288275311,3891812,5955231128,2630879,333044183,74,812929,470961215,809020,470490255,3909,470960,785335,598,3893909,381784,74,4871,130000.0,43333.0,-70.0,-65.0,-74.0,-69.0,-70.0,-65.0,-73.0,-69.0,-90.0,-92.0,-89.0,-92.0,20.0,27.0,15.0,23.0,0
2416,F8:59:71:5A:E0:3D,2658032,374673807,27150,41629362,2630882,333044445,0,3379,417850,3270,400521,109,17329,3140,0,27173,866,0,32,130000.0,39000.0,-67.0,-74.0,-66.0,-72.0,-67.0,-74.0,-67.0,-72.0,-90.0,-92.0,-89.0,-92.0,23.0,18.0,23.0,20.0,0
2417,CC:2F:71:3E:C5:1F,2636048,333676085,5166,631640,2630882,333044445,6,22177,1859372,18279,1397404,3898,461968,5451,30,7364,133,6,449,130000.0,39000.0,-70.0,-71.0,-70.0,-60.0,-68.0,-69.0,-69.0,-61.0,-90.0,-92.0,-89.0,-92.0,20.0,21.0,19.0,32.0,0
2418,CC:2F:71:3F:1F:24,6527723,6296154355,3896837,5963109506,2630886,333044849,74,813623,471049001,809714,470578041,3909,470960,786029,598,3898913,382297,74,4873,130000.0,43333.0,-71.0,-65.0,-74.0,-69.0,-71.0,-65.0,-73.0,-68.0,-90.0,-92.0,-89.0,-92.0,19.0,27.0,15.0,23.0,0
2419,F8:59:71:5A:E0:3D,2658038,374674413,27150,41629362,2630888,333045051,0,3379,417850,3270,400521,109,17329,3140,0,27173,866,0,32,130000.0,39000.0,-67.0,-74.0,-66.0,-72.0,-67.0,-74.0,-67.0,-72.0,-90.0,-92.0,-89.0,-92.0,23.0,18.0,23.0,20.0,0
2420,CC:2F:71:3E:C5:1F,2636054,333676691,5166,631640,2630888,333045051,6,22177,1859372,18279,1397404,3898,461968,5451,30,7364,133,6,449,130000.0,39000.0,-70.0,-71.0,-70.0,-60.0,-68.0,-69.0,-69.0,-61.0,-90.0,-92.0,-89.0,-92.0,20.0,21.0,19.0,32.0,0
2421,CC:2F:71:3F:1F:24,6532523,6303682489,3901635,5970637438,2630888,333045051,74,814237,471125069,810328,470654109,3909,470960,786642,598,3903677,382511,74,4873,130000.0,43333.0,-70.0,-65.0,-74.0,-69.0,-70.0,-65.0,-73.0,-69.0,-90.0,-92.0,-89.0,-92.0,20.0,27.0,15.0,23.0,0
2422,F8:59:71:5A:E0:3D,2658044,374674939,27150,41629362,2630894,333045577,0,3379,417850,3270,400521,109,17329,3140,0,27173,866,0,32,130000.0,39000.0,-67.0,-74.0,-66.0,-72.0,-67.0,-74.0,-67.0,-72.0,-90.0,-92.0,-89.0,-92.0,23.0,18.0,23.0,20.0,0
2423,CC:2F:71:3E:C5:1F,2636062,333677419,5166,631640,2630896,333045779,6,22177,1859372,18279,1397404,3898,461968,5451,30,7364,133,6,449,130000.0,39000.0,-70.0,-71.0,-70.0,-60.0,-68.0,-69.0,-69.0,-61.0,-90.0,-92.0,-89.0,-92.0,20.0,21.0,19.0,32.0,0
2424,CC:2F:71:3F:1F:24,6537413,6311339917,3906517,5978294138,2630896,333045779,74,814711,471185251,810801,470714173,3910,471078,787115,598,3908573,382842,74,4873,130000.0,43333.0,-71.0,-65.0,-74.0,-69.0,-70.0,-65.0,-73.0,-69.0,-90.0,-92.0,-89.0,-92.0,19.0,27.0,15.0,23.0,0
2425,F8:59:71:5A:E0:3D,2658049,374675616,27150,41629362,2630899,333046254,0,3379,417850,3270,400521,109,17329,3140,0,27173,866,0,32,130000.0,39000.0,-67.0,-74.0,-66.0,-72.0,-67.0,-74.0,-67.0,-72.0,-90.0,-92.0,-89.0,-92.0,23.0,18.0,23.0,20.0,0
2426,CC:2F:71:3E:C5:1F,2636067,333678096,5166,631640,2630901,333046456,6,22177,1859372,18279,1397404,3898,461968,5451,30,7364,133,6,449,130000.0,39000.0,-70.0,-71.0,-70.0,-60.0,-68.0,-69.0,-69.0,-61.0,-90.0,-92.0,-89.0,-92.0,20.0,21.0,19.0,32.0,0
2427,CC:2F:71:3F:1F:24,6542946,6320023298,3912045,5986976842,2630901,333046456,74,815454,471276549,811544,470805471,3910,471078,787854,598,3914142,383625,74,4873,130000.0,43333.0,-71.0,-65.0,-74.0,-69.0,-70.0,-65.0,-74.0,-69.0,-90.0,-92.0,-89.0,-92.0,19.0,27.0,15.0,23.0,0
2428,F8:59:71:5A:E0:3D,2658056,374676282,27150,41629362,2630906,333046920,0,3379,417850,3270,400521,109,17329,3140,0,27173,866,0,32,130000.0,39000.0,-67.0,-74.0,-66.0,-72.0,-67.0,-74.0,-67.0,-72.0,-90.0,-92.0,-89.0,-92.0,23.0,18.0,23.0,20.0,0
2429,CC:2F:71:3E:C5:1F,2636072,333678560,5166,631640,2630906,333046920,6,22177,1859372,18279,1397404,3898,461968,5451,30,7364,133,6,449,130000.0,39000.0,-70.0,-71.0,-70.0,-60.0,-68.0,-69.0,-69.0,-61.0,-90.0,-92.0,-89.0,-92.0,20.0,21.0,19.0,32.0,0
2430,CC:2F:71:3F:1F:24,6548577,6328854318,3917671,5995807398,2630906,333046920,74,815968,471344741,812058,470873663,3910,471078,788368,598,3919722,383867,74,4873,130000.0,43333.0,-71.0,-65.0,-74.0,-69.0,-70.0,-65.0,-73.0,-69.0,-90.0,-92.0,-89.0,-92.0,19.0,27.0,15.0,23.0,0
2431,F8:59:71:5A:E0:3D,2658060,374676686,27150,41629362,2630910,333047324,0,3379,417850,3270,400521,109,17329,3140,0,27173,866,0,32,130000.0,39000.0,-67.0,-74.0,-66.0,-72.0,-67.0,-74.0,-67.0,-72.0,-90.0,-92.0,-89.0,-92.0,23.0,18.0,23.0,20.0,0
2432,CC:2F:71:3E:C5:1F,2636076,333678964,5166,631640,2630910,333047324,6,22177,1859372,18279,1397404,3898,461968,5451,30,7364,133,6,449,130000.0,39000.0,-70.0,-71.0,-70.0,-60.0,-68.0,-69.0,-69.0,-61.0,-90.0,-92.0,-89.0,-92.0,20.0,21.0,19.0,32.0,0
2433,CC:2F:71:3F:1F:24,6552133,6334410020,3921221,6001362494,2630912,333047526,74,816384,471398137,812474,470927059,3910,471078,788784,598,3923246,385370,74,4873,65000.0,13000.0,-70.0,-65.0,-73.0,-68.0,-70.0,-65.0,-73.0,-67.0,-90.0,-92.0,-89.0,-92.0,20.0,27.0,16.0,24.0,0
2434,F8:59:71:5A:E0:3D,2658068,374677414,27150,41629362,2630918,333048052,0,3379,417850,3270,400521,109,17329,3140,0,27173,866,0,32,130000.0,39000.0,-67.0,-74.0,-66.0,-72.0,-67.0,-74.0,-67.0,-72.0,-90.0,-92.0,-89.0,-92.0,23.0,18.0,23.0,20.0,0
2435,CC:2F:71:3E:C5:1F,2636086,333679894,5166,631640,2630920,333048254,6,22179,1859560,18280,1397474,3899,462086,5452,30,7364,133,6,449,130000.0,39000.0,-69.0,-72.0,-69.0,-60.0,-68.0,-69.0,-69.0,-61.0,-90.0,-92.0,-89.0,-92.0,21.0,20.0,20.0,32.0,0
2436,CC:2F:71:3F:1F:24,6557012,6342047530,3926092,6008999276,2630920,333048254,74,817018,471478287,813108,471007209,3910,471078,789411,598,3928189,385530,74,4873,86667.0,14444.0,-71.0,-67.0,-74.0,-69.0,-71.0,-67.0,-74.0,-69.0,-90.0,-92.0,-89.0,-92.0,19.0,25.0,15.0,23.0,0
2437,F8:59:71:5A:E0:3D,2658074,374678020,27150,41629362,2630924,333048658,0,3379,417850,3270,400521,109,17329,3140,0,27173,866,0,32,130000.0,39000.0,-67.0,-74.0,-66.0,-72.0,-67.0,-74.0,-67.0,-72.0,-90.0,-92.0,-89.0,-92.0,23.0,18.0,23.0,20.0,0
2438,CC:2F:71:3E:C5:1F,2636090,333680298,5166,631640,2630924,333048658,6,22179,1859560,18280,1397474,3899,462086,5452,30,7364,133,6,449,130000.0,39000.0,-69.0,-72.0,-69.0,-60.0,-68.0,-69.0,-69.0,-61.0,-90.0,-92.0,-89.0,-92.0,21.0,20.0,20.0,32.0,0
2439,CC:2F:71:3F:1F:24,6561310,6348777466,3930386,6015728808,2630924,333048658,74,817666,471558985,813756,471087907,3910,471078,790058,598,3932400,386271,74,4873,86667.0,14444.0,-70.0,-66.0,-73.0,-68.0,-70.0,-66.0,-73.0,-68.0,-90.0,-92.0,-89.0,-92.0,20.0,26.0,16.0,24.0,0
2440,F8:59:71:5A:E0:3D,2658081,374678852,27150,41629362,2630931,333049490,0,3379,417850,3270,400521,109,17329,3140,0,27173,866,0,32,130000.0,39000.0,-67.0,-74.0,-66.0,-72.0,-67.0,-74.0,-67.0,-72.0,-90.0,-92.0,-89.0,-92.0,23.0,18.0,23.0,20.0,0
2441,CC:2F:71:3E:C5:1F,2636099,333681332,5166,631640,2630933,333049692,6,22179,1859560,18280,1397474,3899,462086,5452,30,7364,133,6,449,130000.0,39000.0,-69.0,-72.0,-69.0,-60.0,-68.0,-69.0,-69.0,-61.0,-90.0,-92.0,-89.0,-92.0,21.0,20.0,20.0,32.0,0
2442,CC:2F:71:3F:1F:24,6565593,6355479994,3934657,6022429974,2630936,333050020,74,818278,471635519,814368,471164441,3910,471078,790670,598,3936670,386345,74,4873,86667.0,14444.0,-70.0,-66.0,-74.0,-68.0,-70.0,-66.0,-73.0,-68.0,-90.0,-92.0,-89.0,-92.0,20.0,26.0,15.0,24.0,0
2443,F8:59:71:5A:E0:3D,2658091,374679848,27150,41629362,2630941,333050486,0,3382,418108,3272,400661,110,17447,3141,0,27174,866,0,32,130000.0,39000.0,-68.0,-74.0,-66.0,-71.0,-66.0,-72.0,-65.0,-70.0,-90.0,-92.0,-89.0,-92.0,22.0,18.0,23.0,21.0,0
2444,CC:2F:71:3E:C5:1F,2636107,333682126,5166,631640,2630941,333050486,6,22179,1859560,18280,1397474,3899,462086,5452,30,7364,133,6,449,130000.0,39000.0,-69.0,-72.0,-69.0,-60.0,-68.0,-69.0,-69.0,-61.0,-90.0,-92.0,-89.0,-92.0,21.0,20.0,20.0,32.0,0
2445,CC:2F:71:3F:1F:24,6570516,6363199280,3939575,6030148794,2630941,333050486,74,819124,471739859,815214,471268781,3910,471078,791516,598,3941604,386800,74,4873,86667.0,14444.0,-70.0,-66.0,-73.0,-68.0,-70.0,-66.0,-73.0,-68.0,-90.0,-92.0,-89.0,-92.0,20.0,26.0,16.0,24.0,0
2446,F8:59:71:5A:E0:3D,2658096,374680312,27150,41629362,2630946,333050950,0,3383,418178,3273,400731,110,17447,3141,0,27174,866,0,32,130000.0,39000.0,-68.0,-74.0,-66.0,-71.0,-67.0,-72.0,-65.0,-70.0,-90.0,-92.0,-89.0,-92.0,22.0,18.0,23.0,21.0,0
2447,CC:2F:71:3E:C5:1F,2636112,333682590,5166,631640,2630946,333050950,6,22179,1859560,18280,1397474,3899,462086,5452,30,7364,133,6,449,130000.0,39000.0,-69.0,-72.0,-69.0,-60.0,-68.0,-69.0,-69.0,-61.0,-90.0,-92.0,-89.0,-92.0,21.0,20.0,20.0,32.0,0
2448,CC:2F:71:3F:1F:24,6574098,6368801530,3943152,6035750580,2630946,333050950,74,819660,471807271,815750,471336193,3910,471078,792051,598,3945249,386880,74,4874,86667.0,14444.0,-70.0,-66.0,-74.0,-69.0,-69.0,-66.0,-73.0,-69.0,-90.0,-92.0,-89.0,-92.0,20.0,26.0,15.0,23.0,0
2449,F8:59:71:5A:E0:3D,2658102,374680918,27150,41629362,2630952,333051556,0,3383,418178,3273,400731,110,17447,3141,0,27174,866,0,32,130000.0,39000.0,-68.0,-74.0,-66.0,-71.0,-67.0,-72.0,-65.0,-70.0,-90.0,-92.0,-89.0,-92.0,22.0,18.0,23.0,21.0,0
2450,CC:2F:71:3E:C5:1F,2636118,333683196,5166,631640,2630952,333051556,6,22179,1859560,18280,1397474,3899,462086,5452,30,7364,133,6,449,130000.0,39000.0,-69.0,-72.0,-69.0,-60.0,-68.0,-69.0,-69.0,-61.0,-90.0,-92.0,-89.0,-92.0,21.0,20.0,20.0,32.0,0
2451,CC:2F:71:3F:1F:24,6577365,6373900672,3946411,6040848914,2630954,333051758,74,820210,471875939,816300,471404861,3910,471078,792601,598,3948485,387377,74,4875,86667.0,14444.0,-71.0,-67.0,-74.0,-69.0,-71.0,-67.0,-74.0,-69.0,-90.0,-92.0,-89.0,-92.0,19.0,25.0,15.0,23.0,0
2452,F8:59:71:5A:E0:3D,2658105,374681180,27150,41629362,2630955,333051818,0,3383,418178,3273,400731,110,17447,3141,0,27174,866,0,32,130000.0,39000.0,-68.0,-74.0,-66.0,-71.0,-67.0,-72.0,-65.0,-70.0,-90.0,-92.0,-89.0,-92.0,22.0,18.0,23.0,21.0,0
2453,CC:2F:71:3E:C5:1F,2636124,333683794,5166,631640,2630958,333052154,6,22179,1859560,18280,1397474,3899,462086,5452,30,7364,133,6,449,130000.0,39000.0,-69.0,-72.0,-69.0,-60.0,-68.0,-69.0,-69.0,-61.0,-90.0,-92.0,-89.0,-92.0,21.0,20.0,20.0,32.0,0
2454,CC:2F:71:3F:1F:24,6581307,6380073738,3950348,6047021516,2630959,333052222,74,821026,471975047,817116,471503969,3910,471078,793417,598,3952436,387482,74,4876,86667.0,14444.0,-70.0,-66.0,-73.0,-69.0,-69.0,-66.0,-73.0,-68.0,-90.0,-92.0,-89.0,-92.0,20.0,26.0,16.0,23.0,0
2455,F8:59:71:5A:E0:3D,2658114,374682261,27150,41629362,2630964,333052899,0,3383,418178,3273,400731,110,17447,3141,0,27174,866,0,32,130000.0,39000.0,-68.0,-74.0,-66.0,-71.0,-67.0,-72.0,-65.0,-70.0,-90.0,-92.0,-89.0,-92.0,22.0,18.0,23.0,21.0,0
2456,CC:2F:71:3E:C5:1F,2636130,333684539,5166,631640,2630964,333052899,6,22179,1859560,18280,1397474,3899,462086,5452,30,7364,133,6,449,130000.0,39000.0,-69.0,-72.0,-69.0,-60.0,-68.0,-69.0,-69.0,-61.0,-90.0,-92.0,-89.0,-92.0,21.0,20.0,20.0,32.0,0
2457,CC:2F:71:3F:1F:24,6585479,6386608125,3954515,6053555226,2630964,333052899,74,821651,472053659,817741,471582581,3910,471078,794037,598,3956574,388036,74,4876,86667.0,14444.0,-70.0,-66.0,-73.0,-68.0,-70.0,-66.0,-73.0,-68.0,-90.0,-92.0,-89.0,-92.0,20.0,26.0,16.0,24.0,0
2458,F8:59:71:5A:E0:3D,2658121,374682927,27150,41629362,2630971,333053565,0,3383,418178,3273,400731,110,17447,3141,0,27174,866,0,32,130000.0,39000.0,-68.0,-74.0,-66.0,-71.0,-67.0,-72.0,-65.0,-70.0,-90.0,-92.0,-89.0,-92.0,22.0,18.0,23.0,21.0,0
2459,CC:2F:71:3E:C5:1F,2636139,333685407,5166,631640,2630973,333053767,6,22179,1859560,18280,1397474,3899,462086,5452,30,7364,133,6,449,130000.0,39000.0,-69.0,-72.0,-69.0,-60.0,-68.0,-69.0,-69.0,-61.0,-90.0,-92.0,-89.0,-92.0,21.0,20.0,20.0,32.0,0
2460,CC:2F:71:3F:1F:24,6590373,6394274595,3959400,6061220828,2630973,333053767,74,822478,472154549,818568,471683471,3910,471078,794864,598,3961497,388155,74,4876,104000.0,26000.0,-71.0,-66.0,-73.0,-67.0,-70.0,-66.0,-73.0,-67.0,-90.0,-92.0,-89.0,-92.0,19.0,26.0,16.0,25.0,0
2461,F8:59:71:5A:E0:3D,2658125,374683331,27150,41629362,2630975,333053969,0,3383,418178,3273,400731,110,17447,3141,0,27174,866,0,32,130000.0,39000.0,-68.0,-74.0,-66.0,-71.0,-67.0,-72.0,-65.0,-70.0,-90.0,-92.0,-89.0,-92.0,22.0,18.0,23.0,21.0,0
2462,CC:2F:71:3E:C5:1F,2636143,333685811,5166,631640,2630977,333054171,6,22179,1859560,18280,1397474,3899,462086,5452,30,7364,133,6,449,130000.0,39000.0,-69.0,-72.0,-69.0,-60.0,-68.0,-69.0,-69.0,-61.0,-90.0,-92.0,-89.0,-92.0,21.0,20.0,20.0,32.0,0
2463,CC:2F:71:3F:1F:24,6594410,6400597529,3963433,6067543358,2630977,333054171,74,822993,472219007,819083,471747929,3910,471078,795379,598,3965486,388419,74,4876,86667.0,14444.0,-70.0,-66.0,-74.0,-68.0,-69.0,-66.0,-73.0,-68.0,-90.0,-92.0,-89.0,-92.0,20.0,26.0,15.0,24.0,0
2464,F8:59:71:5A:E0:3D,2658132,374683997,27150,41629362,2630982,333054635,0,3383,418178,3273,400731,110,17447,3141,0,27174,866,0,32,130000.0,39000.0,-68.0,-74.0,-66.0,-71.0,-67.0,-72.0,-65.0,-70.0,-90.0,-92.0,-89.0,-92.0,22.0,18.0,23.0,21.0,0
2465,CC:2F:71:3E:C5:1F,2636148,333686275,5166,631640,2630982,333054635,6,22179,1859560,18280,1397474,3899,462086,5452,30,7364,133,6,449,130000.0,39000.0,-69.0,-72.0,-69.0,-60.0,-68.0,-69.0,-69.0,-61.0,-90.0,-92.0,-89.0,-92.0,21.0,20.0,20.0,32.0,0
2466,CC:2F:71:3F:1F:24,6598404,6406851147,3967422,6073796512,2630982,333054635,74,823644,472299417,819734,471828339,3910,471078,796014,598,3969502,388452,74,4876,86667.0,14444.0,-70.0,-66.0,-73.0,-68.0,-70.0,-66.0,-73.0,-68.0,-90.0,-92.0,-89.0,-92.0,20.0,26.0,16.0,24.0,0
2467,F8:59:71:5A:E0:3D,2658136,374684401,27150,41629362,2630986,333055039,0,3383,418178,3273,400731,110,17447,3141,0,27174,866,0,32,130000.0,39000.0,-68.0,-74.0,-66.0,-71.0,-67.0,-72.0,-65.0,-70.0,-90.0,-93.0,-90.0,-93.0,22.0,19.0,24.0,22.0,0
2468,CC:2F:71:3E:C5:1F,2636152,333686679,5166,631640,2630986,333055039,6,22179,1859560,18280,1397474,3899,462086,5452,30,7364,133,6,449,130000.0,39000.0,-69.0,-72.0,-69.0,-60.0,-68.0,-69.0,-69.0,-61.0,-90.0,-93.0,-90.0,-93.0,21.0,21.0,21.0,33.0,0
2469,CC:2F:71:3F:1F:24,6602323,6412989293,3971337,6079934254,2630986,333055039,74,824297,472380467,820387,471909389,3910,471078,796664,598,3973357,388824,74,4876,78000.0,13000.0,-70.0,-66.0,-74.0,-68.0,-70.0,-66.0,-73.0,-68.0,-90.0,-93.0,-90.0,-93.0,20.0,27.0,16.0,25.0,0
2470,F8:59:71:5A:E0:3D,2658141,374684865,27150,41629362,2630991,333055503,0,3383,418178,3273,400731,110,17447,3141,0,27174,866,0,32,130000.0,39000.0,-68.0,-74.0,-66.0,-71.0,-67.0,-72.0,-65.0,-70.0,-90.0,-93.0,-90.0,-93.0,22.0,19.0,24.0,22.0,0
2471,CC:2F:71:3E:C5:1F,2636157,333687143,5166,631640,2630991,333055503,6,22179,1859560,18280,1397474,3899,462086,5452,30,7364,133,6,449,130000.0,39000.0,-69.0,-72.0,-69.0,-60.0,-68.0,-69.0,-69.0,-61.0,-90.0,-93.0,-90.0,-93.0,21.0,21.0,21.0,33.0,0
2472,CC:2F:71:3F:1F:24,6606076,6418855531,3975083,6085799826,2630993,333055705,74,824944,472461855,821034,471990777,3910,471078,797311,598,3977167,388925,74,4876,86667.0,14444.0,-69.0,-66.0,-72.0,-68.0,-69.0,-66.0,-73.0,-68.0,-90.0,-93.0,-90.0,-93.0,21.0,27.0,18.0,25.0,0
2473,F8:59:71:5A:E0:3D,2658147,374685471,27150,41629362,2630997,333056109,0,3383,418178,3273,400731,110,17447,3141,0,27174,866,0,32,130000.0,39000.0,-68.0,-74.0,-66.0,-71.0,-67.0,-72.0,-65.0,-70.0,-90.0,-93.0,-90.0,-93.0,22.0,19.0,24.0,22.0,0
2474,CC:2F:71:3E:C5:1F,2636165,333687951,5166,631640,2630999,333056311,6,22179,1859560,18280,1397474,3899,462086,5452,30,7364,133,6,449,130000.0,39000.0,-69.0,-72.0,-69.0,-60.0,-68.0,-69.0,-69.0,-61.0,-90.0,-93.0,-90.0,-93.0,21.0,21.0,21.0,33.0,0
2475,CC:2F:71:3F:1F:24,6610630,6425991025,3979631,6092934714,2630999,333056311,74,825670,472552851,821760,472081773,3910,471078,798021,598,3981664,389735,74,4877,86667.0,14444.0,-69.0,-66.0,-73.0,-69.0,-69.0,-66.0,-73.0,-68.0,-90.0,-93.0,-90.0,-93.0,21.0,27.0,17.0,24.0,0
2476,F8:59:71:5A:E0:3D,2658153,374686051,27151,41629478,2631002,333056573,0,3386,418388,3276,400941,110,17447,3141,0,27175,866,0,32,130000.0,39000.0,-68.0,-74.0,-66.0,-72.0,-67.0,-72.0,-66.0,-69.0,-90.0,-93.0,-90.0,-93.0,22.0,19.0,24.0,21.0,0
2477,CC:2F:71:3E:C5:1F,2636171,333688531,5167,631756,2631004,333056775,6,22181,1859700,18282,1397614,3899,462086,5452,30,7365,133,6,449,130000.0,39000.0,-69.0,-71.0,-70.0,-60.0,-69.0,-70.0,-69.0,-61.0,-90.0,-93.0,-90.0,-93.0,21.0,22.0,20.0,33.0,0
2478,CC:2F:71:3F:1F:24,6614731,6432404947,3983727,6099348172,2631004,333056775,74,826270,472627571,822360,472156493,3910,471078,798621,598,3985800,389815,74,4877,86667.0,14444.0,-70.0,-66.0,-73.0,-68.0,-70.0,-66.0,-73.0,-68.0,-90.0,-93.0,-90.0,-93.0,20.0,27.0,17.0,25.0,0
2479,F8:59:71:5A:E0:3D,2658161,374686867,27151,41629478,2631010,333057389,0,3386,418388,3276,400941,110,17447,3141,0,27175,866,0,32,130000.0,39000.0,-68.0,-74.0,-66.0,-72.0,-67.0,-72.0,-66.0,-69.0,-90.0,-93.0,-90.0,-93.0,22.0,19.0,24.0,21.0,0
2480,CC:2F:71:3E:C5:1F,2636177,333689145,5167,631756,2631010,333057389,6,22181,1859700,18282,1397614,3899,462086,5452,30,7365,133,6,449,130000.0,39000.0,-69.0,-71.0,-70.0,-60.0,-69.0,-70.0,-69.0,-61.0,-90.0,-93.0,-90.0,-93.0,21.0,22.0,20.0,33.0,0
2481,CC:2F:71:3F:1F:24,6619110,6439263049,3988098,6106205458,2631012,333057591,74,826892,472705655,822982,472234577,3910,471078,799242,598,3990195,390290,74,4877,86667.0,14444.0,-70.0,-66.0,-74.0,-69.0,-70.0,-66.0,-73.0,-68.0,-90.0,-93.0,-90.0,-93.0,20.0,27.0,16.0,24.0,0
2482,F8:59:71:5A:E0:3D,2658167,374687393,27151,41629478,2631016,333057915,0,3388,418576,3277,401011,111,17565,3142,0,27175,866,0,32,130000.0,39000.0,-68.0,-74.0,-66.0,-72.0,-67.0,-71.0,-66.0,-69.0,-90.0,-92.0,-89.0,-93.0,22.0,18.0,23.0,21.0,0
2483,CC:2F:71:3E:C5:1F,2636183,333689671,5167,631756,2631016,333057915,6,22181,1859700,18282,1397614,3899,462086,5452,30,7365,133,6,449,130000.0,39000.0,-69.0,-71.0,-70.0,-60.0,-69.0,-70.0,-69.0,-61.0,-90.0,-92.0,-89.0,-93.0,21.0,21.0,19.0,33.0,0
2484,CC:2F:71:3F:1F:24,6621806,6443467371,3990788,6110409254,2631018,333058117,74,827224,472750509,823314,472279431,3910,471078,799574,598,3992885,390502,74,4877,86667.0,14444.0,-70.0,-66.0,-73.0,-69.0,-70.0,-66.0,-73.0,-68.0,-90.0,-92.0,-89.0,-93.0,20.0,26.0,16.0,24.0,0
2485,F8:59:71:5A:E0:3D,2658174,374688272,27151,41629478,2631023,333058794,0,3388,418576,3277,401011,111,17565,3142,0,27175,866,0,32,130000.0,39000.0,-68.0,-74.0,-66.0,-72.0,-67.0,-71.0,-66.0,-69.0,-90.0,-92.0,-89.0,-93.0,22.0,18.0,23.0,21.0,0
2486,CC:2F:71:3E:C5:1F,2636190,333690550,5167,631756,2631023,333058794,6,22181,1859700,18282,1397614,3899,462086,5452,30,7365,133,6,449,130000.0,39000.0,-69.0,-71.0,-70.0,-60.0,-69.0,-70.0,-69.0,-61.0,-90.0,-92.0,-89.0,-93.0,21.0,21.0,19.0,33.0,0
2487,CC:2F:71:3F:1F:24,6626368,6450613008,3995343,6117554012,2631025,333058996,74,827894,472834549,823984,472363471,3910,471078,800244,598,3997379,390913,74,4877,86667.0,14444.0,-70.0,-66.0,-74.0,-68.0,-69.0,-66.0,-73.0,-68.0,-90.0,-92.0,-89.0,-93.0,20.0,26.0,15.0,25.0,0
2488,F8:59:71:5A:E0:3D,2658184,374689202,27151,41629478,2631033,333059724,0,3388,418576,3277,401011,111,17565,3142,0,27175,866,0,32,130000.0,39000.0,-68.0,-74.0,-66.0,-72.0,-67.0,-71.0,-66.0,-69.0,-90.0,-92.0,-89.0,-93.0,22.0,18.0,23.0,21.0,0
2489,CC:2F:71:3E:C5:1F,2636200,333691480,5167,631756,2631033,333059724,6,22181,1859700,18282,1397614,3899,462086,5452,30,7365,133,6,449,130000.0,39000.0,-69.0,-71.0,-70.0,-60.0,-69.0,-70.0,-69.0,-61.0,-90.0,-92.0,-89.0,-93.0,21.0,21.0,19.0,33.0,0
2490,CC:2F:71:3F:1F:24,6630206,6456611768,3999173,6123552044,2631033,333059724,74,828414,472898835,824503,472427639,3911,471196,800750,598,4001214,390955,74,4877,86667.0,14444.0,-69.0,-66.0,-73.0,-68.0,-68.0,-65.0,-72.0,-67.0,-90.0,-92.0,-89.0,-93.0,21.0,26.0,16.0,25.0,0
2491,F8:59:71:5A:E0:3D,2658192,374690010,27151,41629478,2631041,333060532,0,3388,418576,3277,401011,111,17565,3142,0,27175,866,0,32,130000.0,39000.0,-68.0,-74.0,-66.0,-72.0,-67.0,-71.0,-66.0,-69.0,-90.0,-92.0,-89.0,-93.0,22.0,18.0,23.0,21.0,0
2492,CC:2F:71:3E:C5:1F,2636208,333692288,5167,631756,2631041,333060532,6,22181,1859700,18282,1397614,3899,462086,5452,30,7365,133,6,449,130000.0,39000.0,-69.0,-71.0,-70.0,-60.0,-69.0,-70.0,-69.0,-61.0,-90.0,-92.0,-89.0,-93.0,21.0,21.0,19.0,33.0,0
2493,CC:2F:71:3F:1F:24,6634579,6463453100,4003537,6130392508,2631042,333060592,78,829170,472990037,825259,472518841,3911,471196,801491,599,4005585,391544,78,4877,86667.0,14444.0,-71.0,-65.0,-74.0,-67.0,-70.0,-65.0,-73.0,-67.0,-90.0,-92.0,-89.0,-93.0,19.0,27.0,15.0,26.0,0
2494,F8:59:71:5A:E0:3D,2658195,374690272,27151,41629478,2631044,333060794,0,3388,418576,3277,401011,111,17565,3142,0,27175,866,0,32,130000.0,39000.0,-68.0,-74.0,-66.0,-72.0,-67.0,-71.0,-66.0,-69.0,-90.0,-92.0,-89.0,-93.0,22.0,18.0,23.0,21.0,0
2495,CC:2F:71:3E:C5:1F,2636212,333692684,5167,631756,2631045,333060928,6,22181,1859700,18282,1397614,3899,462086,5452,30,7365,133,6,449,130000.0,39000.0,-69.0,-71.0,-70.0,-60.0,-69.0,-70.0,-69.0,-61.0,-90.0,-92.0,-89.0,-93.0,21.0,21.0,19.0,33.0,0
2496,CC:2F:71:3F:1F:24,6635180,6464324996,4004134,6131264000,2631046,333060996,78,829332,473014325,825421,472543129,3911,471196,801652,599,4006232,391564,78,4877,104000.0,26000.0,-71.0,-65.0,-74.0,-67.0,-70.0,-65.0,-74.0,-67.0,-90.0,-92.0,-89.0,-93.0,19.0,27.0,15.0,26.0,0
2497,F8:59:71:5A:E0:3D,2658201,374690878,27151,41629478,2631050,333061400,0,3388,418576,3277,401011,111,17565,3142,0,27175,866,0,32,130000.0,39000.0,-68.0,-74.0,-66.0,-72.0,-67.0,-71.0,-66.0,-69.0,-90.0,-92.0,-89.0,-93.0,22.0,18.0,23.0,21.0,0
2498,CC:2F:71:3E:C5:1F,2636217,333693156,5167,631756,2631050,333061400,6,22181,1859700,18282,1397614,3899,462086,5452,30,7365,133,6,449,130000.0,39000.0,-69.0,-71.0,-70.0,-60.0,-69.0,-70.0,-69.0,-61.0,-90.0,-92.0,-89.0,-93.0,21.0,21.0,19.0,33.0,0
2499,CC:2F:71:3F:1F:24,6635216,6464335808,4004166,6131274408,2631050,333061400,78,829352,473017733,825441,472546537,3911,471196,801670,599,4006264,391592,78,4877,115556.0,26000.0,-71.0,-66.0,-74.0,-67.0,-71.0,-65.0,-74.0,-67.0,-90.0,-92.0,-89.0,-93.0,19.0,26.0,15.0,26.0,0
2500,F8:59:71:5A:E0:3D,2658204,374691140,27151,41629478,2631053,333061662,0,3388,418576,3277,401011,111,17565,3142,0,27175,866,0,32,130000.0,39000.0,-68.0,-74.0,-66.0,-72.0,-67.0,-71.0,-66.0,-69.0,-90.0,-92.0,-89.0,-93.0,22.0,18.0,23.0,21.0,0
2501,CC:2F:71:3E:C5:1F,2636220,333693418,5167,631756,2631053,333061662,6,22181,1859700,18282,1397614,3899,462086,5452,30,7365,133,6,449,130000.0,39000.0,-69.0,-71.0,-70.0,-60.0,-69.0,-70.0,-69.0,-61.0,-90.0,-92.0,-89.0,-93.0,21.0,21.0,19.0,33.0,0
2502,CC:2F:71:3F:1F:24,6635256,6464347040,4004203,6131285378,2631053,333061662,78,829377,473021625,825466,472550429,3911,471196,801693,599,4006301,391632,78,4877,104000.0,26000.0,-71.0,-66.0,-74.0,-67.0,-71.0,-65.0,-74.0,-67.0,-90.0,-92.0,-89.0,-93.0,19.0,26.0,15.0,26.0,0
2503,F8:59:71:5A:E0:3D,2658208,374691544,27151,41629478,2631057,333062066,0,3388,418576,3277,401011,111,17565,3142,0,27175,866,0,32,130000.0,39000.0,-68.0,-74.0,-66.0,-72.0,-67.0,-71.0,-66.0,-69.0,-90.0,-92.0,-89.0,-93.0,22.0,18.0,23.0,21.0,0
2504,CC:2F:71:3E:C5:1F,2636226,333694024,5167,631756,2631059,333062268,6,22182,1859770,18283,1397684,3899,462086,5452,30,7366,133,6,449,130000.0,39000.0,-69.0,-69.0,-68.0,-60.0,-68.0,-69.0,-69.0,-59.0,-90.0,-92.0,-89.0,-93.0,21.0,23.0,21.0,33.0,0
2505,CC:2F:71:3F:1F:24,6635293,6464357884,4004234,6131295616,2631059,333062268,78,829397,473024983,825486,472553787,3911,471196,801712,599,4006332,391640,78,4877,86667.0,13000.0,-71.0,-65.0,-74.0,-67.0,-70.0,-65.0,-73.0,-67.0,-90.0,-92.0,-89.0,-93.0,19.0,27.0,15.0,26.0,0
2506,F8:59:71:5A:E0:3D,2658213,374692010,27151,41629478,2631062,333062532,0,3390,418716,3279,401151,111,17565,3142,0,27176,866,0,32,130000.0,39000.0,-67.0,-74.0,-66.0,-72.0,-67.0,-71.0,-66.0,-70.0,-90.0,-92.0,-89.0,-93.0,23.0,18.0,23.0,21.0,0
2507,CC:2F:71:3E:C5:1F,2636229,333694288,5167,631756,2631062,333062532,6,22185,1860028,18285,1397824,3900,462204,5453,30,7366,133,6,449,130000.0,39000.0,-69.0,-71.0,-69.0,-60.0,-68.0,-70.0,-68.0,-59.0,-90.0,-92.0,-89.0,-93.0,21.0,21.0,20.0,33.0,0
2508,CC:2F:71:3F:1F:24,6635327,6464368258,4004265,6131305726,2631062,333062532,78,829415,473028097,825504,472556901,3911,471196,801729,599,4006363,391641,78,4877,104000.0,26000.0,-71.0,-66.0,-74.0,-68.0,-70.0,-66.0,-74.0,-68.0,-90.0,-92.0,-89.0,-93.0,19.0,26.0,15.0,25.0,0
2509,F8:59:71:5A:E0:3D,2658218,374692474,27151,41629478,2631067,333062996,0,3390,418716,3279,401151,111,17565,3142,0,27176,866,0,32,130000.0,39000.0,-67.0,-74.0,-66.0,-72.0,-67.0,-71.0,-66.0,-70.0,-90.0,-92.0,-89.0,-93.0,23.0,18.0,23.0,21.0,0
2510,CC:2F:71:3E:C5:1F,2636234,333694752,5167,631756,2631067,333062996,6,22185,1860028,18285,1397824,3900,462204,5453,30,7366,133,6,449,130000.0,39000.0,-69.0,-71.0,-69.0,-60.0,-68.0,-70.0,-68.0,-59.0,-90.0,-92.0,-89.0,-93.0,21.0,21.0,20.0,33.0,0
2511,CC:2F:71:3F:1F:24,6635363,6464379000,4004296,6131316004,2631067,333062996,78,829433,473031211,825522,472560015,3911,471196,801746,599,4006394,391669,78,4877,115556.0,26000.0,-70.0,-66.0,-74.0,-68.0,-70.0,-66.0,-74.0,-68.0,-90.0,-92.0,-89.0,-93.0,20.0,26.0,15.0,25.0,0
2512,F8:59:71:5A:E0:3D,2658220,374692676,27151,41629478,2631069,333063198,0,3390,418716,3279,401151,111,17565,3142,0,27176,866,0,32,130000.0,39000.0,-67.0,-74.0,-66.0,-72.0,-67.0,-71.0,-66.0,-70.0,-90.0,-92.0,-89.0,-93.0,23.0,18.0,23.0,21.0,0
2513,CC:2F:71:3E:C5:1F,2636236,333694954,5167,631756,2631069,333063198,6,22185,1860028,18285,1397824,3900,462204,5453,30,7366,133,6,449,130000.0,39000.0,-69.0,-71.0,-69.0,-60.0,-68.0,-70.0,-68.0,-59.0,-90.0,-92.0,-89.0,-93.0,21.0,21.0,20.0,33.0,0
2514,CC:2F:71:3F:1F:24,6635397,6464389498,4004328,6131326300,2631069,333063198,78,829451,473034325,825540,472563129,3911,471196,801763,599,4006426,391714,78,4877,104000.0,26000.0,-71.0,-66.0,-74.0,-68.0,-70.0,-66.0,-73.0,-68.0,-90.0,-92.0,-89.0,-93.0,19.0,26.0,15.0,25.0,0
2515,F8:59:71:5A:E0:3D,2658226,374693282,27151,41629478,2631075,333063804,0,3390,418716,3279,401151,111,17565,3142,0,27176,866,0,32,130000.0,39000.0,-67.0,-74.0,-66.0,-72.0,-67.0,-71.0,-66.0,-70.0,-90.0,-92.0,-89.0,-93.0,23.0,18.0,23.0,21.0,0
2516,CC:2F:71:3E:C5:1F,2636242,333695560,5167,631756,2631075,333063804,6,22185,1860028,18285,1397824,3900,462204,5453,30,7366,133,6,449,130000.0,39000.0,-69.0,-71.0,-69.0,-60.0,-68.0,-70.0,-68.0,-59.0,-90.0,-92.0,-89.0,-93.0,21.0,21.0,20.0,33.0,0
2517,CC:2F:71:3F:1F:24,6635434,6464400398,4004359,6131336594,2631075,333063804,78,829470,473037567,825559,472566371,3911,471196,801781,599,4006457,391721,78,4877,86667.0,13000.0,-70.0,-66.0,-74.0,-68.0,-70.0,-66.0,-73.0,-68.0,-90.0,-92.0,-89.0,-93.0,20.0,26.0,15.0,25.0,0
2518,F8:59:71:5A:E0:3D,2658229,374693544,27151,41629478,2631078,333064066,0,3390,418716,3279,401151,111,17565,3142,0,27176,866,0,32,130000.0,39000.0,-67.0,-74.0,-66.0,-72.0,-67.0,-71.0,-66.0,-70.0,-90.0,-92.0,-89.0,-93.0,23.0,18.0,23.0,21.0,0
2519,CC:2F:71:3E:C5:1F,2636245,333695822,5167,631756,2631078,333064066,6,22185,1860028,18285,1397824,3900,462204,5453,30,7366,133,6,449,130000.0,39000.0,-69.0,-71.0,-69.0,-60.0,-68.0,-70.0,-68.0,-59.0,-90.0,-92.0,-89.0,-93.0,21.0,21.0,20.0,33.0,0
2520,CC:2F:71:3F:1F:24,6635469,6464410900,4004391,6131346834,2631078,333064066,78,829488,473040681,825577,472569485,3911,471196,801798,599,4006489,391721,78,4877,86667.0,14444.0,-69.0,-66.0,-73.0,-69.0,-69.0,-66.0,-73.0,-68.0,-90.0,-92.0,-89.0,-93.0,21.0,26.0,16.0,24.0,0
2521,F8:59:71:5A:E0:3D,2658234,374694221,27151,41629478,2631083,333064743,0,3390,418716,3279,401151,111,17565,3142,0,27176,866,0,32,130000.0,39000.0,-67.0,-74.0,-66.0,-72.0,-67.0,-71.0,-66.0,-70.0,-90.0,-92.0,-89.0,-93.0,23.0,18.0,23.0,21.0,0
2522,CC:2F:71:3E:C5:1F,2636250,333696499,5167,631756,2631083,333064743,6,22185,1860028,18285,1397824,3900,462204,5453,30,7366,133,6,449,130000.0,39000.0,-69.0,-71.0,-69.0,-60.0,-68.0,-70.0,-68.0,-59.0,-90.0,-92.0,-89.0,-93.0,21.0,21.0,20.0,33.0,0
2523,CC:2F:71:3F:1F:24,6635508,6464422187,4004423,6131357242,2631085,333064945,78,829509,473044143,825598,472572947,3911,471196,801818,599,4006521,391725,78,4877,104000.0,26000.0,-71.0,-65.0,-76.0,-67.0,-71.0,-65.0,-75.0,-67.0,-90.0,-92.0,-89.0,-93.0,19.0,27.0,13.0,26.0,0
2524,F8:59:71:5A:E0:3D,2658238,374694625,27151,41629478,2631087,333065147,0,3390,418716,3279,401151,111,17565,3142,0,27176,866,0,32,130000.0,39000.0,-67.0,-74.0,-66.0,-72.0,-67.0,-71.0,-66.0,-70.0,-90.0,-92.0,-89.0,-93.0,23.0,18.0,23.0,21.0,0
2525,CC:2F:71:3E:C5:1F,2636254,333696903,5167,631756,2631087,333065147,6,22185,1860028,18285,1397824,3900,462204,5453,30,7366,133,6,449,130000.0,39000.0,-69.0,-71.0,-69.0,-60.0,-68.0,-70.0,-68.0,-59.0,-90.0,-92.0,-89.0,-93.0,21.0,21.0,20.0,33.0,0
2526,CC:2F:71:3F:1F:24,6635541,6464432683,4004454,6131367536,2631087,333065147,78,829528,473047385,825617,472576189,3911,471196,801836,599,4006552,391729,78,4877,117000.0,39000.0,-72.0,-65.0,-74.0,-69.0,-72.0,-65.0,-73.0,-69.0,-90.0,-92.0,-89.0,-93.0,18.0,27.0,15.0,24.0,0
2527,F8:59:71:5A:E0:3D,2658241,374694887,27151,41629478,2631090,333065409,0,3390,418716,3279,401151,111,17565,3142,0,27176,866,0,32,130000.0,39000.0,-67.0,-74.0,-66.0,-72.0,-67.0,-71.0,-66.0,-70.0,-90.0,-92.0,-89.0,-93.0,23.0,18.0,23.0,21.0,0
2528,CC:2F:71:3E:C5:1F,2636259,333697367,5167,631756,2631092,333065611,6,22185,1860028,18285,1397824,3900,462204,5453,30,7366,133,6,449,130000.0,39000.0,-69.0,-71.0,-69.0,-60.0,-68.0,-70.0,-68.0,-59.0,-90.0,-92.0,-89.0,-93.0,21.0,21.0,20.0,33.0,0
2529,CC:2F:71:3F:1F:24,6635577,6464443425,4004485,6131377814,2631092,333065611,78,829545,473050383,825634,472579187,3911,471196,801852,599,4006583,391740,78,4877,115556.0,26000.0,-72.0,-65.0,-75.0,-68.0,-72.0,-65.0,-74.0,-67.0,-90.0,-92.0,-89.0,-93.0,18.0,27.0,14.0,25.0,0
2530,F8:59:71:5A:E0:3D,2658247,374695493,27151,41629478,2631096,333066015,0,3390,418716,3279,401151,111,17565,3142,0,27176,866,0,32,130000.0,39000.0,-67.0,-74.0,-66.0,-72.0,-67.0,-71.0,-66.0,-70.0,-90.0,-92.0,-89.0,-93.0,23.0,18.0,23.0,21.0,0
2531,CC:2F:71:3E:C5:1F,2636263,333697771,5167,631756,2631096,333066015,6,22185,1860028,18285,1397824,3900,462204,5453,30,7366,133,6,449,130000.0,39000.0,-69.0,-71.0,-69.0,-60.0,-68.0,-70.0,-68.0,-59.0,-90.0,-92.0,-89.0,-93.0,21.0,21.0,20.0,33.0,0
2532,CC:2F:71:3F:1F:24,6635612,6464453995,4004516,6131387980,2631096,333066015,78,829562,473053381,825651,472582185,3911,471196,801868,599,4006614,391771,78,4877,117000.0,39000.0,-72.0,-65.0,-75.0,-67.0,-71.0,-65.0,-74.0,-67.0,-90.0,-92.0,-89.0,-93.0,18.0,27.0,14.0,26.0,0
2533,F8:59:71:5A:E0:3D,2658249,374695695,27151,41629478,2631098,333066217,0,3390,418716,3279,401151,111,17565,3142,0,27176,866,0,32,130000.0,39000.0,-67.0,-74.0,-66.0,-72.0,-67.0,-71.0,-66.0,-70.0,-90.0,-92.0,-89.0,-93.0,23.0,18.0,23.0,21.0,0
2534,CC:2F:71:3E:C5:1F,2636265,333697973,5167,631756,2631098,333066217,6,22185,1860028,18285,1397824,3900,462204,5453,30,7366,133,6,449,130000.0,39000.0,-69.0,-71.0,-69.0,-60.0,-68.0,-70.0,-68.0,-59.0,-90.0,-92.0,-89.0,-93.0,21.0,21.0,20.0,33.0,0
2535,CC:2F:71:3F:1F:24,6635645,6464464419,4004547,6131398202,2631098,333066217,78,829579,473056379,825668,472585183,3911,471196,801884,599,4006645,391782,78,4877,115556.0,26000.0,-72.0,-65.0,-74.0,-68.0,-72.0,-65.0,-74.0,-68.0,-90.0,-92.0,-89.0,-93.0,18.0,27.0,15.0,25.0,0
2536,F8:59:71:5A:E0:3D,2658256,374696361,27151,41629478,2631105,333066883,0,3390,418716,3279,401151,111,17565,3142,0,27176,866,0,32,130000.0,39000.0,-67.0,-74.0,-66.0,-72.0,-67.0,-71.0,-66.0,-70.0,-90.0,-92.0,-89.0,-93.0,23.0,18.0,23.0,21.0,0
2537,CC:2F:71:3E:C5:1F,2636272,333698639,5167,631756,2631105,333066883,6,22185,1860028,18285,1397824,3900,462204,5453,30,7366,133,6,449,130000.0,39000.0,-69.0,-71.0,-69.0,-60.0,-68.0,-70.0,-68.0,-59.0,-90.0,-92.0,-89.0,-93.0,21.0,21.0,20.0,33.0,0
2538,CC:2F:71:3F:1F:24,6635683,6464475363,4004578,6131408480,2631105,333066883,78,829599,473059725,825688,472588529,3911,471196,801903,599,4006676,391790,78,4877,115556.0,28889.0,-73.0,-66.0,-75.0,-69.0,-72.0,-65.0,-74.0,-68.0,-90.0,-92.0,-89.0,-93.0,17.0,26.0,14.0,24.0,0
2539,F8:59:71:5A:E0:3D,2658258,374696563,27151,41629478,2631107,333067085,0,3390,418716,3279,401151,111,17565,3142,0,27176,866,0,32,130000.0,39000.0,-67.0,-74.0,-66.0,-72.0,-67.0,-71.0,-66.0,-70.0,-90.0,-92.0,-89.0,-93.0,23.0,18.0,23.0,21.0,0
2540,CC:2F:71:3E:C5:1F,2636274,333698841,5167,631756,2631107,333067085,6,22185,1860028,18285,1397824,3900,462204,5453,30,7366,133,6,449,130000.0,39000.0,-69.0,-71.0,-69.0,-60.0,-68.0,-70.0,-68.0,-59.0,-90.0,-92.0,-89.0,-93.0,21.0,21.0,20.0,33.0,0
2541,CC:2F:71:3F:1F:24,6635716,6464485787,4004609,6131418702,2631107,333067085,78,829616,473062723,825705,472591527,3911,471196,801919,599,4006707,391810,78,4877,104000.0,26000.0,-72.0,-66.0,-74.0,-68.0,-75.0,-69.0,-76.0,-71.0,-90.0,-92.0,-89.0,-93.0,18.0,26.0,15.0,25.0,0
2542,F8:59:71:5A:E0:3D,2658264,374697169,27151,41629478,2631113,333067691,0,3390,418716,3279,401151,111,17565,3142,0,27176,866,0,32,130000.0,39000.0,-67.0,-74.0,-66.0,-72.0,-67.0,-71.0,-66.0,-70.0,-90.0,-92.0,-89.0,-93.0,23.0,18.0,23.0,21.0,0
2543,CC:2F:71:3E:C5:1F,2636283,333699875,5167,631756,2631116,333068119,6,22185,1860028,18285,1397824,3900,462204,5453,30,7366,133,6,449,130000.0,39000.0,-69.0,-71.0,-69.0,-60.0,-68.0,-70.0,-68.0,-59.0,-90.0,-92.0,-89.0,-93.0,21.0,21.0,20.0,33.0,0
2544,CC:2F:71:3F:1F:24,6635756,6464497043,4004640,6131428924,2631116,333068119,78,829634,473065837,825723,472594641,3911,471196,801936,599,4006738,391836,78,4877,117000.0,39000.0,-81.0,-75.0,-82.0,-78.0,-78.0,-72.0,-80.0,-75.0,-90.0,-92.0,-89.0,-93.0,9.0,17.0,7.0,15.0,0
2545,F8:59:71:5A:E0:3D,2658267,374697597,27151,41629478,2631116,333068119,0,3390,418716,3279,401151,111,17565,3142,0,27176,866,0,32,130000.0,39000.0,-67.0,-74.0,-66.0,-72.0,-67.0,-71.0,-66.0,-70.0,-90.0,-92.0,-89.0,-93.0,23.0,18.0,23.0,21.0,0
2546,CC:2F:71:3E:C5:1F,2636285,333700077,5167,631756,2631118,333068321,6,22185,1860028,18285,1397824,3900,462204,5453,30,7366,133,6,449,130000.0,39000.0,-69.0,-71.0,-69.0,-60.0,-68.0,-70.0,-68.0,-59.0,-90.0,-92.0,-89.0,-93.0,21.0,21.0,20.0,33.0,0
2547,CC:2F:71:3F:1F:24,6635789,6464507467,4004671,6131439146,2631118,333068321,78,829651,473068835,825740,472597639,3911,471196,801952,599,4006769,391867,78,4877,104000.0,26000.0,-72.0,-65.0,-74.0,-68.0,-78.0,-72.0,-80.0,-75.0,-90.0,-92.0,-89.0,-93.0,18.0,27.0,15.0,25.0,0
2548,F8:59:71:5A:E0:3D,2658272,374698135,27151,41629478,2631121,333068657,0,3390,418716,3279,401151,111,17565,3142,0,27176,866,0,32,130000.0,39000.0,-67.0,-74.0,-66.0,-72.0,-67.0,-71.0,-66.0,-70.0,-90.0,-92.0,-89.0,-93.0,23.0,18.0,23.0,21.0,0
2549,CC:2F:71:3E:C5:1F,2636290,333700615,5167,631756,2631123,333068859,6,22185,1860028,18285,1397824,3900,462204,5453,30,7366,133,6,449,130000.0,39000.0,-69.0,-71.0,-69.0,-60.0,-68.0,-70.0,-68.0,-59.0,-90.0,-92.0,-89.0,-93.0,21.0,21.0,20.0,33.0,0
2550,CC:2F:71:3F:1F:24,6635827,6464518425,4004703,6131449498,2631124,333068927,78,829669,473071949,825758,472600753,3911,471196,801969,599,4006801,391886,78,4877,115556.0,28889.0,-71.0,-65.0,-73.0,-68.0,-71.0,-65.0,-73.0,-68.0,-90.0,-92.0,-89.0,-93.0,19.0,27.0,16.0,25.0,0
2551,F8:59:71:5A:E0:3D,2658277,374698581,27152,41629594,2631125,333068987,0,3392,418856,3281,401291,111,17565,3142,0,27177,866,0,32,130000.0,39000.0,-67.0,-74.0,-66.0,-71.0,-67.0,-71.0,-66.0,-70.0,-90.0,-92.0,-89.0,-93.0,23.0,18.0,23.0,22.0,0
2552,CC:2F:71:3E:C5:1F,2636293,333700859,5168,631872,2631125,333068987,6,22187,1860168,18287,1397964,3900,462204,5453,30,7367,133,6,449,130000.0,39000.0,-69.0,-71.0,-69.0,-60.0,-68.0,-69.0,-68.0,-60.0,-90.0,-92.0,-89.0,-93.0,21.0,21.0,20.0,33.0,0
2553,CC:2F:71:3F:1F:24,6635862,6464529025,4004735,6131459836,2631127,333069189,78,829688,473075133,825777,472603937,3911,471196,801986,599,4006832,391926,78,4877,104000.0,26000.0,-72.0,-65.0,-74.0,-68.0,-71.0,-65.0,-73.0,-68.0,-90.0,-92.0,-89.0,-93.0,18.0,27.0,15.0,25.0,0
2554,F8:59:71:5A:E0:3D,2658281,374698985,27152,41629594,2631129,333069391,0,3392,418856,3281,401291,111,17565,3142,0,27177,866,0,32,130000.0,39000.0,-67.0,-74.0,-66.0,-71.0,-67.0,-71.0,-66.0,-70.0,-90.0,-92.0,-89.0,-93.0,23.0,18.0,23.0,22.0,0
2555,CC:2F:71:3E:C5:1F,2636299,333701465,5168,631872,2631131,333069593,6,22187,1860168,18287,1397964,3900,462204,5453,30,7367,133,6,449,130000.0,39000.0,-69.0,-71.0,-69.0,-60.0,-68.0,-69.0,-68.0,-60.0,-90.0,-92.0,-89.0,-93.0,21.0,21.0,20.0,33.0,0
2556,CC:2F:71:3F:1F:24,6635898,6464539909,4004767,6131470316,2631131,333069593,78,829707,473078375,825796,472607179,3911,471196,802004,599,4006865,391951,78,4877,115556.0,28889.0,-71.0,-65.0,-73.0,-67.0,-71.0,-65.0,-73.0,-67.0,-90.0,-92.0,-89.0,-93.0,19.0,27.0,16.0,26.0,0
2557,F8:59:71:5A:E0:3D,2658285,374699389,27152,41629594,2631133,333069795,0,3392,418856,3281,401291,111,17565,3142,0,27177,866,0,32,130000.0,39000.0,-67.0,-74.0,-66.0,-71.0,-67.0,-71.0,-66.0,-70.0,-90.0,-92.0,-89.0,-93.0,23.0,18.0,23.0,22.0,0
2558,CC:2F:71:3E:C5:1F,2636301,333701667,5168,631872,2631133,333069795,6,22187,1860168,18287,1397964,3900,462204,5453,30,7367,133,6,449,130000.0,39000.0,-69.0,-71.0,-69.0,-60.0,-68.0,-69.0,-68.0,-60.0,-90.0,-92.0,-89.0,-93.0,21.0,21.0,20.0,33.0,0
2559,CC:2F:71:3F:1F:24,6635931,6464550445,4004798,6131480650,2631133,333069795,78,829724,473081373,825813,472610177,3911,471196,802020,599,4006896,391972,78,4877,115556.0,28889.0,-71.0,-65.0,-73.0,-68.0,-71.0,-65.0,-73.0,-67.0,-90.0,-92.0,-89.0,-93.0,19.0,27.0,16.0,25.0,0
2560,F8:59:71:5A:E0:3D,2658290,374699853,27152,41629594,2631138,333070259,0,3392,418856,3281,401291,111,17565,3142,0,27177,866,0,32,130000.0,39000.0,-67.0,-74.0,-66.0,-71.0,-67.0,-71.0,-66.0,-70.0,-90.0,-92.0,-89.0,-93.0,23.0,18.0,23.0,22.0,0
2561,CC:2F:71:3E:C5:1F,2636306,333702131,5168,631872,2631138,333070259,6,22187,1860168,18287,1397964,3900,462204,5453,30,7367,133,6,449,130000.0,39000.0,-69.0,-71.0,-69.0,-60.0,-68.0,-69.0,-68.0,-60.0,-90.0,-92.0,-89.0,-93.0,21.0,21.0,20.0,33.0,0
2562,CC:2F:71:3F:1F:24,6635967,6464561131,4004829,6131490872,2631138,333070259,78,829742,473084487,825831,472613291,3911,471196,802037,599,4006927,391997,78,4877,104000.0,26000.0,-72.0,-65.0,-73.0,-68.0,-72.0,-65.0,-73.0,-68.0,-90.0,-92.0,-89.0,-93.0,18.0,27.0,16.0,25.0,0
2563,F8:59:71:5A:E0:3D,2658296,374700592,27152,41629594,2631144,333070998,0,3392,418856,3281,401291,111,17565,3142,0,27177,866,0,32,130000.0,39000.0,-67.0,-74.0,-66.0,-71.0,-67.0,-71.0,-66.0,-70.0,-90.0,-92.0,-89.0,-93.0,23.0,18.0,23.0,22.0,0
2564,CC:2F:71:3E:C5:1F,2636312,333702870,5168,631872,2631144,333070998,6,22187,1860168,18287,1397964,3900,462204,5453,30,7367,133,6,449,130000.0,39000.0,-69.0,-71.0,-69.0,-60.0,-68.0,-69.0,-68.0,-60.0,-90.0,-92.0,-89.0,-93.0,21.0,21.0,20.0,33.0,0
2565,CC:2F:71:3F:1F:24,6636005,6464572222,4004861,6131501224,2631144,333070998,78,829761,473087719,825849,472616405,3912,471314,802055,599,4006959,392011,78,4877,115556.0,28889.0,-72.0,-65.0,-73.0,-68.0,-72.0,-65.0,-73.0,-68.0,-90.0,-92.0,-89.0,-93.0,18.0,27.0,16.0,25.0,0
2566,F8:59:71:5A:E0:3D,2658299,374700856,27152,41629594,2631147,333071262,0,3393,418974,3281,401291,112,17683,3143,0,27177,866,0,32,130000.0,39000.0,-67.0,-73.0,-65.0,-71.0,-67.0,-72.0,-65.0,-70.0,-90.0,-92.0,-89.0,-93.0,23.0,19.0,24.0,22.0,0
2567,CC:2F:71:3E:C5:1F,2636317,333703336,5168,631872,2631149,333071464,6,22187,1860168,18287,1397964,3900,462204,5453,30,7367,133,6,449,130000.0,39000.0,-69.0,-71.0,-69.0,-60.0,-68.0,-69.0,-68.0,-60.0,-90.0,-92.0,-89.0,-93.0,21.0,21.0,20.0,33.0,0
2568,CC:2F:71:3F:1F:24,6636040,6464582820,4004891,6131511356,2631149,333071464,78,829780,473090949,825868,472619635,3912,471314,802073,599,4006989,392028,78,4877,117000.0,39000.0,-72.0,-65.0,-73.0,-69.0,-71.0,-65.0,-73.0,-68.0,-90.0,-92.0,-89.0,-93.0,18.0,27.0,16.0,24.0,0
2569,F8:59:71:5A:E0:3D,2658306,374701522,27152,41629594,2631154,333071928,0,3394,419044,3282,401361,112,17683,3143,0,27177,866,0,32,130000.0,39000.0,-67.0,-74.0,-65.0,-71.0,-67.0,-72.0,-65.0,-70.0,-90.0,-92.0,-89.0,-93.0,23.0,18.0,24.0,22.0,0
2570,CC:2F:71:3E:C5:1F,2636322,333703800,5168,631872,2631154,333071928,6,22187,1860168,18287,1397964,3900,462204,5453,30,7367,133,6,449,130000.0,39000.0,-69.0,-71.0,-69.0,-60.0,-68.0,-69.0,-68.0,-60.0,-90.0,-92.0,-89.0,-93.0,21.0,21.0,20.0,33.0,0
2571,CC:2F:71:3F:1F:24,6636076,6464593562,4004922,6131521634,2631154,333071928,78,829797,473093947,825885,472622633,3912,471314,802089,599,4007020,392059,78,4877,104000.0,26000.0,-72.0,-65.0,-74.0,-68.0,-71.0,-65.0,-73.0,-68.0,-90.0,-92.0,-89.0,-93.0,18.0,27.0,15.0,25.0,0
2572,F8:59:71:5A:E0:3D,2658308,374701724,27152,41629594,2631156,333072130,0,3394,419044,3282,401361,112,17683,3143,0,27177,866,0,32,130000.0,39000.0,-67.0,-74.0,-65.0,-71.0,-67.0,-72.0,-65.0,-70.0,-90.0,-92.0,-89.0,-93.0,23.0,18.0,24.0,22.0,0
2573,CC:2F:71:3E:C5:1F,2636324,333704002,5168,631872,2631156,333072130,6,22187,1860168,18287,1397964,3900,462204,5453,30,7367,133,6,449,130000.0,39000.0,-69.0,-71.0,-69.0,-60.0,-68.0,-69.0,-68.0,-60.0,-90.0,-92.0,-89.0,-93.0,21.0,21.0,20.0,33.0,0
2574,CC:2F:71:3F:1F:24,6636109,6464603986,4004953,6131531856,2631156,333072130,78,829815,473097061,825903,472625747,3912,471314,802106,599,4007051,392088,78,4877,115556.0,28889.0,-72.0,-65.0,-74.0,-68.0,-71.0,-65.0,-73.0,-68.0,-90.0,-92.0,-89.0,-93.0,18.0,27.0,15.0,25.0,0
2575,F8:59:71:5A:E0:3D,2658314,374702330,27152,41629594,2631162,333072736,0,3394,419044,3282,401361,112,17683,3143,0,27177,866,0,32,130000.0,39000.0,-67.0,-74.0,-65.0,-71.0,-67.0,-72.0,-65.0,-70.0,-90.0,-92.0,-89.0,-93.0,23.0,18.0,24.0,22.0,0
2576,CC:2F:71:3E:C5:1F,2636330,333704608,5168,631872,2631162,333072736,6,22187,1860168,18287,1397964,3900,462204,5453,30,7367,133,6,449,130000.0,39000.0,-69.0,-71.0,-69.0,-60.0,-68.0,-69.0,-68.0,-60.0,-90.0,-92.0,-89.0,-93.0,21.0,21.0,20.0,33.0,0
2577,CC:2F:71:3F:1F:24,6636147,6464614944,4004985,6131542208,2631162,333072736,78,829834,473100291,825922,472628977,3912,471314,802124,599,4007083,392116,78,4877,104000.0,26000.0,-72.0,-65.0,-73.0,-68.0,-71.0,-65.0,-73.0,-68.0,-90.0,-92.0,-89.0,-93.0,18.0,27.0,16.0,25.0,0
2578,F8:59:71:5A:E0:3D,2658317,374702592,27152,41629594,2631165,333072998,0,3394,419044,3282,401361,112,17683,3143,0,27177,866,0,32,130000.0,39000.0,-67.0,-74.0,-65.0,-71.0,-67.0,-72.0,-65.0,-70.0,-90.0,-92.0,-89.0,-93.0,23.0,18.0,24.0,22.0,0
2579,CC:2F:71:3E:C5:1F,2636333,333704870,5168,631872,2631165,333072998,6,22187,1860168,18287,1397964,3900,462204,5453,30,7367,133,6,449,130000.0,39000.0,-69.0,-71.0,-69.0,-60.0,-68.0,-69.0,-68.0,-60.0,-90.0,-92.0,-89.0,-93.0,21.0,21.0,20.0,33.0,0
2580,CC:2F:71:3F:1F:24,6636181,6464625484,4005016,6131552486,2631165,333072998,78,829851,473103289,825939,472631975,3912,471314,802140,599,4007114,392138,78,4877,115556.0,26000.0,-71.0,-65.0,-73.0,-67.0,-71.0,-65.0,-73.0,-67.0,-90.0,-92.0,-89.0,-93.0,19.0,27.0,16.0,26.0,0
2581,F8:59:71:5A:E0:3D,2658323,374703198,27152,41629594,2631171,333073604,0,3394,419044,3282,401361,112,17683,3143,0,27177,866,0,32,130000.0,39000.0,-67.0,-74.0,-65.0,-71.0,-67.0,-72.0,-65.0,-70.0,-90.0,-92.0,-89.0,-93.0,23.0,18.0,24.0,22.0,0
2582,CC:2F:71:3E:C5:1F,2636339,333705476,5168,631872,2631171,333073604,6,22187,1860168,18287,1397964,3900,462204,5453,30,7367,133,6,449,130000.0,39000.0,-69.0,-71.0,-69.0,-60.0,-68.0,-69.0,-68.0,-60.0,-90.0,-92.0,-89.0,-93.0,21.0,21.0,20.0,33.0,0
2583,CC:2F:71:3F:1F:24,6636219,6464636442,4005048,6131562838,2631171,333073604,78,829868,473106287,825956,472634973,3912,471314,802156,599,4007146,392168,78,4877,104000.0,26000.0,-72.0,-65.0,-73.0,-68.0,-71.0,-65.0,-73.0,-67.0,-90.0,-92.0,-89.0,-93.0,18.0,27.0,16.0,25.0,0
2584,F8:59:71:5A:E0:3D,2658345,374714046,27152,41629594,2631193,333084452,0,3394,419044,3282,401361,112,17683,3143,0,27177,866,0,32,130000.0,39000.0,-67.0,-74.0,-65.0,-71.0,-67.0,-72.0,-65.0,-70.0,-90.0,-92.0,-89.0,-93.0,23.0,18.0,24.0,22.0,0
2585,CC:2F:71:3E:C5:1F,2636361,333716324,5168,631872,2631193,333084452,6,22187,1860168,18287,1397964,3900,462204,5453,30,7367,133,6,449,130000.0,39000.0,-69.0,-71.0,-69.0,-60.0,-68.0,-69.0,-68.0,-60.0,-90.0,-92.0,-89.0,-93.0,21.0,21.0,20.0,33.0,0
2586,CC:2F:71:3F:1F:24,6636275,6464657774,4005079,6131573060,2631196,333084714,78,829885,473109285,825973,472637971,3912,471314,802172,599,4007177,392194,78,4877,115556.0,26000.0,-71.0,-65.0,-73.0,-67.0,-71.0,-65.0,-73.0,-67.0,-90.0,-92.0,-89.0,-93.0,19.0,27.0,16.0,26.0,0
2587,F8:59:71:5A:E0:3D,2658353,374714774,27152,41629594,2631201,333085180,0,3394,419044,3282,401361,112,17683,3143,0,27177,866,0,32,130000.0,39000.0,-67.0,-74.0,-65.0,-71.0,-67.0,-72.0,-65.0,-70.0,-90.0,-92.0,-89.0,-93.0,23.0,18.0,24.0,22.0,0
2588,CC:2F:71:3E:C5:1F,2636371,333717254,5168,631872,2631203,333085382,6,22189,1860356,18288,1398034,3901,462322,5454,30,7367,133,6,449,130000.0,39000.0,-69.0,-71.0,-68.0,-60.0,-68.0,-69.0,-68.0,-60.0,-90.0,-92.0,-89.0,-93.0,21.0,21.0,21.0,33.0,0
2589,CC:2F:71:3F:1F:24,6636313,6464668608,4005110,6131583226,2631203,333085382,78,829903,473112399,825991,472641085,3912,471314,802189,599,4007208,392213,78,4877,86667.0,14444.0,-71.0,-65.0,-74.0,-68.0,-71.0,-64.0,-73.0,-67.0,-90.0,-92.0,-89.0,-93.0,19.0,27.0,15.0,25.0,0
2590,F8:59:71:5A:E0:3D,2658355,374714976,27152,41629594,2631203,333085382,0,3396,419184,3284,401501,112,17683,3143,0,27178,866,0,32,130000.0,39000.0,-67.0,-74.0,-65.0,-71.0,-66.0,-72.0,-65.0,-70.0,-90.0,-92.0,-89.0,-93.0,23.0,18.0,24.0,22.0,0
2591,CC:2F:71:3E:C5:1F,2636371,333717254,5168,631872,2631203,333085382,6,22189,1860356,18288,1398034,3901,462322,5454,30,7367,133,6,449,130000.0,39000.0,-69.0,-71.0,-68.0,-60.0,-68.0,-69.0,-68.0,-60.0,-90.0,-92.0,-89.0,-93.0,21.0,21.0,21.0,33.0,0
2592,CC:2F:71:3F:1F:24,6636344,6464678942,4005141,6131593560,2631203,333085382,78,829920,473115397,826008,472644083,3912,471314,802205,599,4007239,392213,78,4877,86667.0,14444.0,-71.0,-65.0,-74.0,-67.0,-71.0,-65.0,-74.0,-67.0,-90.0,-92.0,-89.0,-93.0,19.0,27.0,15.0,26.0,0
2593,F8:59:71:5A:E0:3D,2658362,374715642,27152,41629594,2631210,333086048,0,3396,419184,3284,401501,112,17683,3143,0,27178,866,0,32,130000.0,39000.0,-67.0,-74.0,-65.0,-71.0,-66.0,-72.0,-65.0,-70.0,-90.0,-92.0,-89.0,-93.0,23.0,18.0,24.0,22.0,0
2594,CC:2F:71:3E:C5:1F,2636378,333717920,5168,631872,2631210,333086048,6,22189,1860356,18288,1398034,3901,462322,5454,30,7367,133,6,449,130000.0,39000.0,-69.0,-71.0,-68.0,-60.0,-68.0,-69.0,-68.0,-60.0,-90.0,-92.0,-89.0,-93.0,21.0,21.0,21.0,33.0,0
2595,CC:2F:71:3F:1F:24,6636383,6464689904,4005173,6131603856,2631210,333086048,78,829938,473118511,826026,472647197,3912,471314,802222,599,4007271,392216,78,4877,104000.0,26000.0,-78.0,-71.0,-81.0,-74.0,-75.0,-69.0,-77.0,-71.0,-90.0,-92.0,-89.0,-93.0,12.0,21.0,8.0,19.0,0
2596,F8:59:71:5A:E0:3D,2658364,374715844,27152,41629594,2631212,333086250,0,3396,419184,3284,401501,112,17683,3143,0,27178,866,0,32,130000.0,39000.0,-67.0,-74.0,-65.0,-71.0,-66.0,-72.0,-65.0,-70.0,-90.0,-92.0,-89.0,-93.0,23.0,18.0,24.0,22.0,0
2597,CC:2F:71:3E:C5:1F,2636380,333718122,5168,631872,2631212,333086250,6,22189,1860356,18288,1398034,3901,462322,5454,30,7367,133,6,449,130000.0,39000.0,-69.0,-71.0,-68.0,-60.0,-68.0,-69.0,-68.0,-60.0,-90.0,-92.0,-89.0,-93.0,21.0,21.0,21.0,33.0,0
2598,CC:2F:71:3F:1F:24,6636421,6464701460,4005209,6131615210,2631212,333086250,78,829962,473122450,826050,472651136,3912,471314,802245,599,4007307,392249,78,4877,104000.0,26000.0,-74.0,-69.0,-78.0,-71.0,-74.0,-69.0,-78.0,-71.0,-90.0,-92.0,-89.0,-93.0,16.0,23.0,11.0,22.0,0
2599,F8:59:71:5A:E0:3D,2658369,374716919,27153,41630265,2631216,333086654,0,3398,419404,3286,401721,112,17683,3144,0,27179,866,0,32,130000.0,39000.0,-67.0,-74.0,-65.0,-71.0,-66.0,-74.0,-65.0,-71.0,-90.0,-92.0,-89.0,-93.0,23.0,18.0,24.0,22.0,0
2600,CC:2F:71:3E:C5:1F,2636386,333718728,5168,631872,2631218,333086856,6,22189,1860356,18288,1398034,3901,462322,5454,30,7367,133,6,449,130000.0,39000.0,-69.0,-71.0,-68.0,-60.0,-68.0,-69.0,-68.0,-60.0,-90.0,-92.0,-89.0,-93.0,21.0,21.0,21.0,33.0,0
2601,CC:2F:71:3F:1F:24,6636459,6464712474,4005241,6131625618,2631218,333086856,78,829979,473125448,826067,472654134,3912,471314,802261,599,4007339,392251,78,4877,115556.0,26000.0,-75.0,-68.0,-77.0,-71.0,-75.0,-68.0,-77.0,-70.0,-90.0,-92.0,-89.0,-93.0,15.0,24.0,12.0,22.0,0
2602,F8:59:71:5A:E0:3D,2658374,374717383,27153,41630265,2631221,333087118,0,3398,419404,3286,401721,112,17683,3144,0,27179,866,0,32,130000.0,39000.0,-67.0,-74.0,-65.0,-71.0,-66.0,-74.0,-65.0,-71.0,-90.0,-92.0,-89.0,-93.0,23.0,18.0,24.0,22.0,0
2603,CC:2F:71:3E:C5:1F,2636389,333718990,5168,631872,2631221,333087118,6,22189,1860356,18288,1398034,3901,462322,5454,30,7367,133,6,449,130000.0,39000.0,-69.0,-71.0,-68.0,-60.0,-68.0,-69.0,-68.0,-60.0,-90.0,-92.0,-89.0,-93.0,21.0,21.0,21.0,33.0,0
2604,CC:2F:71:3F:1F:24,6636493,6464722958,4005272,6131635840,2631221,333087118,78,829997,473128562,826085,472657248,3912,471314,802278,599,4007370,392253,78,4877,117000.0,39000.0,-75.0,-69.0,-78.0,-71.0,-75.0,-69.0,-77.0,-70.0,-90.0,-92.0,-89.0,-93.0,15.0,23.0,11.0,22.0,0
2605,F8:59:71:5A:E0:3D,2658376,374717585,27153,41630265,2631223,333087320,0,3398,419404,3286,401721,112,17683,3144,0,27179,866,0,32,130000.0,39000.0,-67.0,-74.0,-65.0,-71.0,-66.0,-74.0,-65.0,-71.0,-90.0,-92.0,-89.0,-93.0,23.0,18.0,24.0,22.0,0
2606,CC:2F:71:3E:C5:1F,2636391,333719192,5168,631872,2631223,333087320,6,22189,1860356,18288,1398034,3901,462322,5454,30,7367,133,6,449,130000.0,39000.0,-69.0,-71.0,-68.0,-60.0,-68.0,-69.0,-68.0,-60.0,-90.0,-92.0,-89.0,-93.0,21.0,21.0,21.0,33.0,0
2607,CC:2F:71:3F:1F:24,6636528,6464733584,4005303,6131646062,2631225,333087522,78,830014,473131560,826102,472660246,3912,471314,802294,599,4007401,392253,78,4877,130000.0,43333.0,-75.0,-69.0,-78.0,-70.0,-75.0,-68.0,-77.0,-69.0,-90.0,-92.0,-89.0,-93.0,15.0,23.0,11.0,23.0,0
2608,F8:59:71:5A:E0:3D,2658383,374718464,27153,41630265,2631230,333088199,0,3398,419404,3286,401721,112,17683,3144,0,27179,866,0,32,130000.0,39000.0,-67.0,-74.0,-65.0,-71.0,-66.0,-74.0,-65.0,-71.0,-90.0,-92.0,-89.0,-93.0,23.0,18.0,24.0,22.0,0
2609,CC:2F:71:3E:C5:1F,2636398,333720071,5168,631872,2631230,333088199,6,22189,1860356,18288,1398034,3901,462322,5454,30,7367,133,6,449,130000.0,39000.0,-69.0,-71.0,-68.0,-60.0,-68.0,-69.0,-68.0,-60.0,-90.0,-92.0,-89.0,-93.0,21.0,21.0,21.0,33.0,0
2610,CC:2F:71:3F:1F:24,6636564,6464744483,4005334,6131656284,2631230,333088199,78,830032,473134674,826120,472663360,3912,471314,802311,599,4007432,392266,78,4877,144444.0,39000.0,-76.0,-69.0,-78.0,-70.0,-75.0,-68.0,-77.0,-69.0,-90.0,-92.0,-89.0,-93.0,14.0,23.0,11.0,23.0,0
2611,F8:59:71:5A:E0:3D,2658386,374718726,27153,41630265,2631233,333088461,0,3398,419404,3286,401721,112,17683,3144,0,27179,866,0,32,130000.0,39000.0,-67.0,-74.0,-65.0,-71.0,-66.0,-74.0,-65.0,-71.0,-90.0,-92.0,-89.0,-93.0,23.0,18.0,24.0,22.0,0
2612,CC:2F:71:3E:C5:1F,2636401,333720333,5168,631872,2631233,333088461,6,22189,1860356,18288,1398034,3901,462322,5454,30,7367,133,6,449,130000.0,39000.0,-69.0,-71.0,-68.0,-60.0,-68.0,-69.0,-68.0,-60.0,-90.0,-92.0,-89.0,-93.0,21.0,21.0,21.0,33.0,0
2613,CC:2F:71:3F:1F:24,6636599,6464755097,4005366,6131666636,2631233,333088461,78,830049,473137672,826137,472666358,3912,471314,802327,599,4007464,392279,78,4877,130000.0,43333.0,-76.0,-69.0,-78.0,-70.0,-75.0,-69.0,-78.0,-70.0,-90.0,-92.0,-89.0,-93.0,14.0,23.0,11.0,23.0,0
2614,F8:59:71:5A:E0:3D,2658392,374719332,27153,41630265,2631239,333089067,0,3398,419404,3286,401721,112,17683,3144,0,27179,866,0,32,130000.0,39000.0,-67.0,-74.0,-65.0,-71.0,-66.0,-74.0,-65.0,-71.0,-90.0,-92.0,-89.0,-93.0,23.0,18.0,24.0,22.0,0
2615,CC:2F:71:3E:C5:1F,2636407,333720939,5168,631872,2631239,333089067,6,22189,1860356,18288,1398034,3901,462322,5454,30,7367,133,6,449,130000.0,39000.0,-69.0,-71.0,-68.0,-60.0,-68.0,-69.0,-68.0,-60.0,-90.0,-92.0,-89.0,-93.0,21.0,21.0,21.0,33.0,0
2616,CC:2F:71:3F:1F:24,6636636,6464766037,4005397,6131676970,2631239,333089067,78,830067,473140786,826155,472669472,3912,471314,802344,599,4007495,392279,78,4877,130000.0,43333.0,-76.0,-69.0,-78.0,-70.0,-74.0,-67.0,-77.0,-68.0,-90.0,-92.0,-89.0,-93.0,14.0,23.0,11.0,23.0,0
2617,F8:59:71:5A:E0:3D,2658392,374719332,27153,41630265,2631239,333089067,0,3398,419404,3286,401721,112,17683,3144,0,27179,866,0,32,130000.0,39000.0,-67.0,-74.0,-65.0,-71.0,-66.0,-74.0,-65.0,-71.0,-90.0,-92.0,-89.0,-93.0,23.0,18.0,24.0,22.0,0
2618,CC:2F:71:3E:C5:1F,2636407,333720939,5168,631872,2631239,333089067,6,22189,1860356,18288,1398034,3901,462322,5454,30,7367,133,6,449,130000.0,39000.0,-69.0,-71.0,-68.0,-60.0,-68.0,-69.0,-68.0,-60.0,-90.0,-92.0,-89.0,-93.0,21.0,21.0,21.0,33.0,0
2619,CC:2F:71:3F:1F:24,6636670,6464776703,4005429,6131687434,2631241,333089269,78,830084,473143784,826172,472672470,3912,471314,802360,599,4007527,392279,78,4877,130000.0,43333.0,-72.0,-65.0,-74.0,-67.0,-73.0,-66.0,-76.0,-67.0,-90.0,-92.0,-89.0,-93.0,18.0,27.0,15.0,26.0,0
2620,F8:59:71:5A:E0:3D,2658403,374720432,27155,41630497,2631248,333089935,0,3402,419756,3290,402073,112,17683,3146,0,27181,866,0,32,130000.0,39000.0,-66.0,-72.0,-65.0,-71.0,-66.0,-73.0,-65.0,-71.0,-90.0,-92.0,-89.0,-93.0,24.0,20.0,24.0,22.0,0
2621,CC:2F:71:3E:C5:1F,2636416,333721807,5168,631872,2631248,333089935,6,22189,1860356,18288,1398034,3901,462322,5454,30,7367,133,6,449,130000.0,39000.0,-69.0,-71.0,-68.0,-60.0,-68.0,-69.0,-68.0,-60.0,-90.0,-92.0,-89.0,-93.0,21.0,21.0,21.0,33.0,0
2622,CC:2F:71:3F:1F:24,6636709,6464787705,4005461,6131697770,2631248,333089935,78,830104,473147130,826192,472675816,3912,471314,802379,599,4007559,392290,78,4877,117000.0,39000.0,-72.0,-65.0,-75.0,-66.0,-71.0,-65.0,-75.0,-66.0,-90.0,-92.0,-89.0,-93.0,18.0,27.0,14.0,27.0,0
2623,F8:59:71:5A:E0:3D,2658403,374720432,27155,41630497,2631248,333089935,0,3403,419826,3291,402143,112,17683,3146,0,27181,866,0,32,130000.0,39000.0,-67.0,-74.0,-65.0,-72.0,-66.0,-73.0,-65.0,-71.0,-90.0,-92.0,-89.0,-93.0,23.0,18.0,24.0,21.0,0
2624,CC:2F:71:3E:C5:1F,2636416,333721807,5168,631872,2631248,333089935,6,22189,1860356,18288,1398034,3901,462322,5454,30,7367,133,6,449,130000.0,39000.0,-69.0,-71.0,-68.0,-60.0,-68.0,-69.0,-68.0,-60.0,-90.0,-92.0,-89.0,-93.0,21.0,21.0,21.0,33.0,0
2625,CC:2F:71:3F:1F:24,6636740,6464797983,4005492,6131708048,2631248,333089935,78,830121,473150128,826209,472678814,3912,471314,802395,599,4007590,392290,78,4877,130000.0,39000.0,-72.0,-65.0,-75.0,-66.0,-71.0,-65.0,-74.0,-66.0,-90.0,-92.0,-89.0,-93.0,18.0,27.0,14.0,27.0,0
2626,F8:59:71:5A:E0:3D,2658409,374721038,27155,41630497,2631254,333090541,0,3403,419826,3291,402143,112,17683,3146,0,27181,866,0,32,130000.0,39000.0,-67.0,-74.0,-65.0,-72.0,-66.0,-73.0,-65.0,-71.0,-90.0,-92.0,-89.0,-93.0,23.0,18.0,24.0,21.0,0
2627,CC:2F:71:3E:C5:1F,2636422,333722413,5168,631872,2631254,333090541,6,22189,1860356,18288,1398034,3901,462322,5454,30,7367,133,6,449,130000.0,39000.0,-69.0,-71.0,-68.0,-60.0,-68.0,-69.0,-68.0,-60.0,-90.0,-92.0,-89.0,-93.0,21.0,21.0,21.0,33.0,0
2628,CC:2F:71:3F:1F:24,6636780,6464809087,4005524,6131718344,2631256,333090743,78,830142,473153590,826230,472682276,3912,471314,802415,599,4007622,392306,78,4877,117000.0,39000.0,-72.0,-65.0,-75.0,-66.0,-71.0,-65.0,-74.0,-66.0,-90.0,-92.0,-89.0,-93.0,18.0,27.0,14.0,27.0,0
2629,F8:59:71:5A:E0:3D,2658412,374721300,27155,41630497,2631257,333090803,0,3403,419826,3291,402143,112,17683,3146,0,27181,866,0,32,130000.0,39000.0,-67.0,-74.0,-65.0,-72.0,-66.0,-73.0,-65.0,-71.0,-90.0,-92.0,-89.0,-93.0,23.0,18.0,24.0,21.0,0
2630,CC:2F:71:3E:C5:1F,2636425,333722675,5168,631872,2631257,333090803,6,22189,1860356,18288,1398034,3901,462322,5454,30,7367,133,6,449,130000.0,39000.0,-69.0,-71.0,-68.0,-60.0,-68.0,-69.0,-68.0,-60.0,-90.0,-92.0,-89.0,-93.0,21.0,21.0,21.0,33.0,0
2631,CC:2F:71:3F:1F:24,6636812,6464819425,4005555,6131728622,2631257,333090803,78,830159,473156588,826247,472685274,3912,471314,802431,599,4007653,392306,78,4877,130000.0,39000.0,-72.0,-65.0,-74.0,-66.0,-71.0,-65.0,-74.0,-66.0,-90.0,-92.0,-89.0,-93.0,18.0,27.0,15.0,27.0,0
2632,F8:59:71:5A:E0:3D,2658418,374721906,27155,41630497,2631263,333091409,0,3403,419826,3291,402143,112,17683,3146,0,27181,866,0,32,130000.0,39000.0,-67.0,-74.0,-65.0,-72.0,-66.0,-73.0,-65.0,-71.0,-90.0,-92.0,-89.0,-93.0,23.0,18.0,24.0,21.0,0
2633,CC:2F:71:3E:C5:1F,2636431,333723281,5168,631872,2631263,333091409,6,22189,1860356,18288,1398034,3901,462322,5454,30,7367,133,6,449,130000.0,39000.0,-69.0,-71.0,-68.0,-60.0,-68.0,-69.0,-68.0,-60.0,-90.0,-92.0,-89.0,-93.0,21.0,21.0,21.0,33.0,0
2634,CC:2F:71:3F:1F:24,6636850,6464830327,4005587,6131738918,2631263,333091409,78,830177,473159702,826265,472688388,3912,471314,802448,599,4007685,392318,78,4877,117000.0,39000.0,-71.0,-65.0,-75.0,-66.0,-71.0,-65.0,-75.0,-66.0,-90.0,-92.0,-89.0,-93.0,19.0,27.0,14.0,27.0,0
2635,F8:59:71:5A:E0:3D,2658420,374722108,27155,41630497,2631265,333091611,0,3403,419826,3291,402143,112,17683,3146,0,27181,866,0,32,130000.0,39000.0,-67.0,-74.0,-65.0,-72.0,-66.0,-73.0,-65.0,-71.0,-90.0,-92.0,-89.0,-93.0,23.0,18.0,24.0,21.0,0
2636,CC:2F:71:3E:C5:1F,2636433,333723483,5168,631872,2631265,333091611,6,22189,1860356,18288,1398034,3901,462322,5454,30,7367,133,6,449,130000.0,39000.0,-69.0,-71.0,-68.0,-60.0,-68.0,-69.0,-68.0,-60.0,-90.0,-92.0,-89.0,-93.0,21.0,21.0,21.0,33.0,0
2637,CC:2F:71:3F:1F:24,6636883,6464840807,4005618,6131749196,2631265,333091611,78,830194,473162700,826282,472691386,3912,471314,802464,599,4007716,392318,78,4877,130000.0,39000.0,-71.0,-65.0,-73.0,-66.0,-71.0,-65.0,-74.0,-66.0,-90.0,-92.0,-89.0,-93.0,19.0,27.0,16.0,27.0,0
2638,F8:59:71:5A:E0:3D,2658426,374722688,27156,41630613,2631270,333092075,0,3405,419966,3293,402283,112,17683,3146,0,27182,866,0,32,130000.0,39000.0,-67.0,-74.0,-65.0,-72.0,-66.0,-73.0,-65.0,-71.0,-90.0,-92.0,-89.0,-93.0,23.0,18.0,24.0,21.0,0
2639,CC:2F:71:3E:C5:1F,2636439,333724063,5169,631988,2631270,333092075,6,22191,1860496,18290,1398174,3901,462322,5454,30,7368,133,6,449,130000.0,39000.0,-69.0,-71.0,-69.0,-60.0,-68.0,-70.0,-68.0,-60.0,-90.0,-92.0,-89.0,-93.0,21.0,21.0,20.0,33.0,0
2640,CC:2F:71:3F:1F:24,6636923,6464852125,4005651,6131759848,2631272,333092277,78,830213,473165942,826301,472694628,3912,471314,802482,599,4007749,392319,78,4877,130000.0,43333.0,-72.0,-65.0,-74.0,-67.0,-71.0,-65.0,-74.0,-66.0,-90.0,-92.0,-89.0,-93.0,18.0,27.0,15.0,26.0,0
2641,F8:59:71:5A:E0:3D,2658430,374723092,27156,41630613,2631274,333092479,0,3405,419966,3293,402283,112,17683,3146,0,27182,866,0,32,130000.0,39000.0,-67.0,-74.0,-65.0,-72.0,-66.0,-73.0,-65.0,-71.0,-90.0,-92.0,-89.0,-93.0,23.0,18.0,24.0,21.0,0
2642,CC:2F:71:3E:C5:1F,2636443,333724467,5169,631988,2631274,333092479,6,22191,1860496,18290,1398174,3901,462322,5454,30,7368,133,6,449,130000.0,39000.0,-69.0,-71.0,-69.0,-60.0,-68.0,-70.0,-68.0,-60.0,-90.0,-92.0,-89.0,-93.0,21.0,21.0,20.0,33.0,0
2643,CC:2F:71:3F:1F:24,6636956,6464862549,4005682,6131770070,2631274,333092479,78,830230,473168940,826318,472697626,3912,471314,802498,599,4007780,392333,78,4877,117000.0,39000.0,-74.0,-68.0,-76.0,-70.0,-71.0,-65.0,-74.0,-68.0,-90.0,-92.0,-89.0,-93.0,16.0,24.0,13.0,23.0,0
2644,F8:59:71:5A:E0:3D,2658432,374723294,27156,41630613,2631276,333092681,0,3405,419966,3293,402283,112,17683,3146,0,27182,866,0,32,130000.0,39000.0,-67.0,-74.0,-65.0,-72.0,-66.0,-73.0,-65.0,-71.0,-90.0,-92.0,-89.0,-93.0,23.0,18.0,24.0,21.0,0
2645,CC:2F:71:3E:C5:1F,2636445,333724669,5169,631988,2631276,333092681,6,22191,1860496,18290,1398174,3901,462322,5454,30,7368,133,6,449,130000.0,39000.0,-69.0,-71.0,-69.0,-60.0,-68.0,-70.0,-68.0,-60.0,-90.0,-92.0,-89.0,-93.0,21.0,21.0,20.0,33.0,0
2646,CC:2F:71:3F:1F:24,6636992,6464873291,4005713,6131780348,2631279,333092943,78,830247,473171938,826335,472700624,3912,471314,802514,599,4007811,392334,78,4877,130000.0,39000.0,-72.0,-65.0,-74.0,-67.0,-75.0,-68.0,-77.0,-71.0,-90.0,-92.0,-89.0,-93.0,18.0,27.0,15.0,26.0,0
2647,F8:59:71:5A:E0:3D,2658439,374723960,27156,41630613,2631283,333093347,0,3405,419966,3293,402283,112,17683,3146,0,27182,866,0,32,130000.0,39000.0,-67.0,-74.0,-65.0,-72.0,-66.0,-73.0,-65.0,-71.0,-90.0,-92.0,-89.0,-93.0,23.0,18.0,24.0,21.0,0
2648,CC:2F:71:3E:C5:1F,2636452,333725335,5169,631988,2631283,333093347,6,22191,1860496,18290,1398174,3901,462322,5454,30,7368,133,6,449,130000.0,39000.0,-69.0,-71.0,-69.0,-60.0,-68.0,-70.0,-68.0,-60.0,-90.0,-92.0,-89.0,-93.0,21.0,21.0,20.0,33.0,0
2649,CC:2F:71:3F:1F:24,6637027,6464883973,4005744,6131790626,2631283,333093347,78,830264,473174936,826352,472703622,3912,471314,802530,599,4007842,392334,78,4877,130000.0,43333.0,-71.0,-65.0,-74.0,-67.0,-71.0,-65.0,-74.0,-67.0,-90.0,-92.0,-89.0,-93.0,19.0,27.0,15.0,26.0,0
2650,F8:59:71:5A:E0:3D,2658443,374724497,27156,41630613,2631287,333093884,0,3405,419966,3293,402283,112,17683,3146,0,27182,866,0,32,130000.0,39000.0,-67.0,-74.0,-65.0,-72.0,-66.0,-73.0,-65.0,-71.0,-90.0,-92.0,-89.0,-93.0,23.0,18.0,24.0,21.0,0
2651,CC:2F:71:3E:C5:1F,2636456,333725872,5169,631988,2631287,333093884,6,22191,1860496,18290,1398174,3901,462322,5454,30,7368,133,6,449,130000.0,39000.0,-69.0,-71.0,-69.0,-60.0,-68.0,-70.0,-68.0,-60.0,-90.0,-92.0,-89.0,-93.0,21.0,21.0,20.0,33.0,0
2652,CC:2F:71:3F:1F:24,6637062,6464894732,4005775,6131800848,2631287,333093884,78,830284,473178284,826371,472706852,3913,471432,802549,599,4007873,392353,78,4877,117000.0,39000.0,-72.0,-65.0,-75.0,-67.0,-71.0,-65.0,-74.0,-67.0,-90.0,-92.0,-89.0,-93.0,18.0,27.0,14.0,26.0,0
2653,F8:59:71:5A:E0:3D,2658448,374724961,27156,41630613,2631292,333094348,0,3405,419966,3293,402283,112,17683,3146,0,27182,866,0,32,130000.0,39000.0,-67.0,-74.0,-65.0,-72.0,-66.0,-73.0,-65.0,-71.0,-90.0,-92.0,-89.0,-93.0,23.0,18.0,24.0,21.0,0
2654,CC:2F:71:3E:C5:1F,2636461,333726336,5169,631988,2631292,333094348,6,22191,1860496,18290,1398174,3901,462322,5454,30,7368,133,6,449,130000.0,39000.0,-69.0,-71.0,-69.0,-60.0,-68.0,-70.0,-68.0,-60.0,-90.0,-92.0,-89.0,-93.0,21.0,21.0,20.0,33.0,0
2655,CC:2F:71:3F:1F:24,6637100,6464905676,4005806,6131811126,2631294,333094550,78,830302,473181398,826389,472709966,3913,471432,802566,599,4007904,392355,78,4877,130000.0,39000.0,-71.0,-65.0,-74.0,-67.0,-71.0,-65.0,-74.0,-67.0,-90.0,-92.0,-89.0,-93.0,19.0,27.0,15.0,26.0,0
2656,F8:59:71:5A:E0:3D,2658450,374725163,27156,41630613,2631294,333094550,0,3405,419966,3293,402283,112,17683,3146,0,27182,866,0,32,130000.0,39000.0,-67.0,-74.0,-65.0,-72.0,-66.0,-73.0,-65.0,-71.0,-90.0,-92.0,-89.0,-93.0,23.0,18.0,24.0,21.0,0
2657,CC:2F:71:3E:C5:1F,2636463,333726538,5169,631988,2631294,333094550,6,22191,1860496,18290,1398174,3901,462322,5454,30,7368,133,6,449,130000.0,39000.0,-69.0,-71.0,-69.0,-60.0,-68.0,-70.0,-68.0,-60.0,-90.0,-92.0,-89.0,-93.0,21.0,21.0,20.0,33.0,0
2658,CC:2F:71:3F:1F:24,6637131,6464915898,4005837,6131821348,2631294,333094550,78,830319,473184396,826406,472712964,3913,471432,802582,599,4007935,392358,78,4877,130000.0,39000.0,-71.0,-65.0,-74.0,-67.0,-71.0,-65.0,-74.0,-67.0,-90.0,-92.0,-89.0,-93.0,19.0,27.0,15.0,26.0,0
2659,F8:59:71:5A:E0:3D,2658456,374725769,27156,41630613,2631300,333095156,0,3405,419966,3293,402283,112,17683,3146,0,27182,866,0,32,130000.0,39000.0,-67.0,-74.0,-65.0,-72.0,-66.0,-73.0,-65.0,-71.0,-90.0,-92.0,-89.0,-93.0,23.0,18.0,24.0,21.0,0
2660,CC:2F:71:3E:C5:1F,2636469,333727144,5169,631988,2631300,333095156,6,22191,1860496,18290,1398174,3901,462322,5454,30,7368,133,6,449,130000.0,39000.0,-69.0,-71.0,-69.0,-60.0,-68.0,-70.0,-68.0,-60.0,-90.0,-92.0,-89.0,-93.0,21.0,21.0,20.0,33.0,0
2661,CC:2F:71:3F:1F:24,6637168,6464926782,4005868,6131831626,2631300,333095156,78,830336,473187394,826423,472715962,3913,471432,802598,599,4007966,392385,78,4877,144444.0,39000.0,-72.0,-65.0,-74.0,-67.0,-71.0,-65.0,-74.0,-67.0,-90.0,-92.0,-89.0,-93.0,18.0,27.0,15.0,26.0,0
2662,F8:59:71:5A:E0:3D,2658460,374726093,27156,41630613,2631304,333095480,0,3405,419966,3293,402283,112,17683,3146,0,27182,866,0,32,130000.0,39000.0,-67.0,-74.0,-65.0,-72.0,-66.0,-73.0,-65.0,-71.0,-90.0,-92.0,-89.0,-93.0,23.0,18.0,24.0,21.0,0
2663,CC:2F:71:3E:C5:1F,2636477,333728185,5173,632705,2631304,333095480,6,22200,1861629,18298,1399189,3902,462440,5461,30,7372,133,6,450,130000.0,39000.0,-69.0,-71.0,-69.0,-60.0,-69.0,-70.0,-68.0,-60.0,-90.0,-92.0,-89.0,-93.0,21.0,21.0,20.0,33.0,0
2664,CC:2F:71:3F:1F:24,6637204,6464937446,4005899,6131841904,2631305,333095542,78,830353,473190392,826440,472718960,3913,471432,802614,599,4007997,392412,78,4877,144444.0,43333.0,-71.0,-65.0,-74.0,-67.0,-71.0,-65.0,-73.0,-67.0,-90.0,-92.0,-89.0,-93.0,19.0,27.0,15.0,26.0,0
2665,F8:59:71:5A:E0:3D,2658467,374726761,27156,41630613,2631311,333096148,0,3407,420154,3294,402353,113,17801,3147,0,27182,866,0,32,130000.0,39000.0,-67.0,-74.0,-65.0,-72.0,-66.0,-73.0,-65.0,-71.0,-90.0,-92.0,-89.0,-93.0,23.0,18.0,24.0,21.0,0
2666,CC:2F:71:3E:C5:1F,2636484,333728853,5173,632705,2631311,333096148,6,22200,1861629,18298,1399189,3902,462440,5461,30,7372,133,6,450,130000.0,39000.0,-69.0,-71.0,-69.0,-60.0,-69.0,-70.0,-68.0,-60.0,-90.0,-92.0,-89.0,-93.0,21.0,21.0,20.0,33.0,0
2667,CC:2F:71:3F:1F:24,6637241,6464948386,4005930,6131852238,2631311,333096148,78,830370,473193390,826457,472721958,3913,471432,802630,599,4008028,392442,78,4877,144444.0,43333.0,-72.0,-66.0,-75.0,-68.0,-71.0,-65.0,-74.0,-67.0,-90.0,-92.0,-89.0,-93.0,18.0,26.0,14.0,25.0,0
2668,F8:59:71:5A:E0:3D,2658469,374726963,27156,41630613,2631313,333096350,0,3407,420154,3294,402353,113,17801,3147,0,27182,866,0,32,130000.0,39000.0,-67.0,-74.0,-65.0,-72.0,-66.0,-73.0,-65.0,-71.0,-90.0,-92.0,-89.0,-93.0,23.0,18.0,24.0,21.0,0
2669,CC:2F:71:3E:C5:1F,2636486,333729055,5173,632705,2631313,333096350,6,22200,1861629,18298,1399189,3902,462440,5461,30,7372,133,6,450,130000.0,39000.0,-69.0,-71.0,-69.0,-60.0,-69.0,-70.0,-68.0,-60.0,-90.0,-92.0,-89.0,-93.0,21.0,21.0,20.0,33.0,0
2670,CC:2F:71:3F:1F:24,6637274,6464958866,4005961,6131862516,2631313,333096350,78,830387,473196388,826474,472724956,3913,471432,802646,599,4008059,392468,78,4877,130000.0,43333.0,-70.0,-65.0,-73.0,-67.0,-70.0,-65.0,-73.0,-66.0,-90.0,-92.0,-89.0,-93.0,20.0,27.0,16.0,26.0,0
2671,F8:59:71:5A:E0:3D,2658476,374727795,27156,41630613,2631320,333097182,0,3407,420154,3294,402353,113,17801,3147,0,27182,866,0,32,130000.0,39000.0,-67.0,-74.0,-65.0,-72.0,-66.0,-73.0,-65.0,-71.0,-90.0,-92.0,-89.0,-93.0,23.0,18.0,24.0,21.0,0
2672,CC:2F:71:3E:C5:1F,2636495,333730089,5173,632705,2631322,333097384,6,22200,1861629,18298,1399189,3902,462440,5461,30,7372,133,6,450,130000.0,39000.0,-69.0,-71.0,-69.0,-60.0,-69.0,-70.0,-68.0,-60.0,-90.0,-92.0,-89.0,-93.0,21.0,21.0,20.0,33.0,0
2673,CC:2F:71:3F:1F:24,6637315,6464970364,4005993,6131872980,2631322,333097384,78,830404,473199386,826491,472727954,3913,471432,802662,599,4008091,392468,78,4877,130000.0,43333.0,-70.0,-65.0,-74.0,-67.0,-70.0,-65.0,-74.0,-67.0,-90.0,-92.0,-89.0,-93.0,20.0,27.0,15.0,26.0,0
2674,F8:59:71:5A:E0:3D,2658481,374728325,27156,41630613,2631325,333097712,0,3407,420154,3294,402353,113,17801,3147,0,27182,866,0,32,130000.0,39000.0,-67.0,-74.0,-65.0,-72.0,-66.0,-73.0,-65.0,-71.0,-90.0,-92.0,-89.0,-93.0,23.0,18.0,24.0,21.0,0
2675,CC:2F:71:3E:C5:1F,2636498,333730417,5173,632705,2631325,333097712,6,22200,1861629,18298,1399189,3902,462440,5461,30,7372,133,6,450,130000.0,39000.0,-69.0,-71.0,-69.0,-60.0,-69.0,-70.0,-68.0,-60.0,-90.0,-92.0,-89.0,-93.0,21.0,21.0,20.0,33.0,0
2676,CC:2F:71:3F:1F:24,6637349,6464980914,4006024,6131883202,2631325,333097712,78,830423,473202616,826510,472731184,3913,471432,802680,599,4008122,392483,78,4877,117000.0,39000.0,-70.0,-65.0,-74.0,-66.0,-70.0,-65.0,-74.0,-66.0,-90.0,-92.0,-89.0,-93.0,20.0,27.0,15.0,27.0,0
2677,F8:59:71:5A:E0:3D,2658485,374728729,27156,41630613,2631329,333098116,0,3407,420154,3294,402353,113,17801,3147,0,27182,866,0,32,130000.0,39000.0,-67.0,-74.0,-65.0,-72.0,-66.0,-73.0,-65.0,-71.0,-90.0,-92.0,-89.0,-93.0,23.0,18.0,24.0,21.0,0
2678,CC:2F:71:3E:C5:1F,2636502,333730821,5173,632705,2631329,333098116,6,22200,1861629,18298,1399189,3902,462440,5461,30,7372,133,6,450,130000.0,39000.0,-69.0,-71.0,-69.0,-60.0,-69.0,-70.0,-68.0,-60.0,-90.0,-92.0,-89.0,-93.0,21.0,21.0,20.0,33.0,0
2679,CC:2F:71:3F:1F:24,6637384,6464991596,4006055,6131893480,2631329,333098116,78,830441,473205730,826528,472734298,3913,471432,802697,599,4008153,392484,78,4877,130000.0,39000.0,-70.0,-65.0,-74.0,-67.0,-70.0,-65.0,-74.0,-66.0,-90.0,-92.0,-89.0,-93.0,20.0,27.0,15.0,26.0,0
2680,F8:59:71:5A:E0:3D,2658490,374729193,27156,41630613,2631334,333098580,0,3407,420154,3294,402353,113,17801,3147,0,27182,866,0,32,130000.0,39000.0,-67.0,-74.0,-65.0,-72.0,-66.0,-73.0,-65.0,-71.0,-90.0,-92.0,-89.0,-93.0,23.0,18.0,24.0,21.0,0
2681,CC:2F:71:3E:C5:1F,2636507,333731285,5173,632705,2631334,333098580,6,22200,1861629,18298,1399189,3902,462440,5461,30,7372,133,6,450,130000.0,39000.0,-69.0,-71.0,-69.0,-60.0,-69.0,-70.0,-68.0,-60.0,-90.0,-92.0,-89.0,-93.0,21.0,21.0,20.0,33.0,0
2682,CC:2F:71:3F:1F:24,6637420,6465002338,4006086,6131903758,2631334,333098580,78,830458,473208728,826545,472737296,3913,471432,802713,599,4008184,392486,78,4877,130000.0,43333.0,-70.0,-65.0,-74.0,-66.0,-70.0,-65.0,-74.0,-66.0,-90.0,-92.0,-89.0,-93.0,20.0,27.0,15.0,27.0,0
2683,F8:59:71:5A:E0:3D,2658492,374729395,27156,41630613,2631336,333098782,0,3407,420154,3294,402353,113,17801,3147,0,27182,866,0,32,130000.0,39000.0,-67.0,-74.0,-65.0,-72.0,-66.0,-73.0,-65.0,-71.0,-90.0,-92.0,-89.0,-93.0,23.0,18.0,24.0,21.0,0
2684,CC:2F:71:3E:C5:1F,2636509,333731487,5173,632705,2631336,333098782,6,22200,1861629,18298,1399189,3902,462440,5461,30,7372,133,6,450,130000.0,39000.0,-69.0,-71.0,-69.0,-60.0,-69.0,-70.0,-68.0,-60.0,-90.0,-92.0,-89.0,-93.0,21.0,21.0,20.0,33.0,0
2685,CC:2F:71:3F:1F:24,6637456,6465013094,4006118,6131914110,2631338,333098984,78,830475,473211726,826562,472740294,3913,471432,802729,599,4008216,392505,78,4877,117000.0,39000.0,-70.0,-65.0,-74.0,-67.0,-70.0,-65.0,-74.0,-66.0,-90.0,-92.0,-89.0,-93.0,20.0,27.0,15.0,26.0,0
2686,F8:59:71:5A:E0:3D,2658496,374729799,27156,41630613,2631340,333099186,0,3407,420154,3294,402353,113,17801,3147,0,27182,866,0,32,130000.0,39000.0,-67.0,-74.0,-65.0,-72.0,-66.0,-73.0,-65.0,-71.0,-90.0,-92.0,-89.0,-93.0,23.0,18.0,24.0,21.0,0
2687,CC:2F:71:3E:C5:1F,2636515,333732123,5175,632937,2631340,333099186,6,22204,1861981,18302,1399541,3902,462440,5463,30,7374,133,6,450,130000.0,39000.0,-69.0,-70.0,-68.0,-60.0,-69.0,-70.0,-68.0,-60.0,-90.0,-92.0,-89.0,-93.0,21.0,22.0,21.0,33.0,0
2688,CC:2F:71:3F:1F:24,6637491,6465023776,4006149,6131924388,2631342,333099388,78,830493,473214840,826580,472743408,3913,471432,802746,599,4008247,392509,78,4877,130000.0,39000.0,-70.0,-65.0,-74.0,-67.0,-70.0,-65.0,-74.0,-67.0,-90.0,-92.0,-89.0,-93.0,20.0,27.0,15.0,26.0,0
2689,F8:59:71:5A:E0:3D,2658499,374730061,27156,41630613,2631343,333099448,0,3407,420154,3294,402353,113,17801,3147,0,27182,866,0,32,130000.0,39000.0,-67.0,-74.0,-65.0,-72.0,-66.0,-73.0,-65.0,-71.0,-90.0,-92.0,-89.0,-93.0,23.0,18.0,24.0,21.0,0
2690,CC:2F:71:3E:C5:1F,2636518,333732385,5175,632937,2631343,333099448,6,22204,1861981,18302,1399541,3902,462440,5463,30,7374,133,6,450,130000.0,39000.0,-69.0,-70.0,-68.0,-60.0,-69.0,-70.0,-68.0,-60.0,-90.0,-92.0,-89.0,-93.0,21.0,22.0,21.0,33.0,0
2691,CC:2F:71:3F:1F:24,6637525,6465034260,4006180,6131934610,2631345,333099650,78,830511,473217954,826598,472746522,3913,471432,802763,599,4008278,392524,78,4877,130000.0,39000.0,-71.0,-65.0,-75.0,-67.0,-70.0,-65.0,-74.0,-66.0,-90.0,-92.0,-89.0,-93.0,19.0,27.0,14.0,26.0,0
2692,F8:59:71:5A:E0:3D,2658506,374730940,27156,41630613,2631350,333100327,0,3407,420154,3294,402353,113,17801,3147,0,27182,866,0,32,130000.0,39000.0,-67.0,-74.0,-65.0,-72.0,-66.0,-73.0,-65.0,-71.0,-90.0,-92.0,-89.0,-93.0,23.0,18.0,24.0,21.0,0
2693,CC:2F:71:3E:C5:1F,2636525,333733264,5175,632937,2631350,333100327,6,22204,1861981,18302,1399541,3902,462440,5463,30,7374,133,6,450,130000.0,39000.0,-69.0,-70.0,-68.0,-60.0,-69.0,-70.0,-68.0,-60.0,-90.0,-92.0,-89.0,-93.0,21.0,22.0,21.0,33.0,0
2694,CC:2F:71:3F:1F:24,6637561,6465045159,4006211,6131944832,2631350,333100327,78,830528,473220952,826615,472749520,3913,471432,802779,599,4008309,392548,78,4877,144444.0,43333.0,-71.0,-66.0,-75.0,-67.0,-71.0,-65.0,-74.0,-67.0,-90.0,-92.0,-89.0,-93.0,19.0,26.0,14.0,26.0,0
2695,F8:59:71:5A:E0:3D,2658508,374731142,27156,41630613,2631352,333100529,0,3407,420154,3294,402353,113,17801,3147,0,27182,866,0,32,130000.0,39000.0,-67.0,-74.0,-65.0,-72.0,-66.0,-73.0,-65.0,-71.0,-90.0,-92.0,-89.0,-93.0,23.0,18.0,24.0,21.0,0
2696,CC:2F:71:3E:C5:1F,2636527,333733466,5175,632937,2631352,333100529,6,22204,1861981,18302,1399541,3902,462440,5463,30,7374,133,6,450,130000.0,39000.0,-69.0,-70.0,-68.0,-60.0,-69.0,-70.0,-68.0,-60.0,-90.0,-92.0,-89.0,-93.0,21.0,22.0,21.0,33.0,0
2697,CC:2F:71:3F:1F:24,6637594,6465055639,4006242,6131955110,2631352,333100529,78,830546,473224066,826633,472752634,3913,471432,802796,599,4008340,392556,78,4877,130000.0,43333.0,-75.0,-69.0,-78.0,-70.0,-74.0,-68.0,-77.0,-69.0,-90.0,-92.0,-89.0,-93.0,15.0,23.0,11.0,23.0,0
2698,F8:59:71:5A:E0:3D,2658515,374731808,27156,41630613,2631359,333101195,0,3407,420154,3294,402353,113,17801,3147,0,27182,866,0,32,130000.0,39000.0,-67.0,-74.0,-65.0,-72.0,-66.0,-73.0,-65.0,-71.0,-90.0,-92.0,-89.0,-93.0,23.0,18.0,24.0,21.0,0
2699,CC:2F:71:3E:C5:1F,2636534,333734132,5175,632937,2631359,333101195,6,22204,1861981,18302,1399541,3902,462440,5463,30,7374,133,6,450,130000.0,39000.0,-69.0,-70.0,-68.0,-60.0,-69.0,-70.0,-68.0,-60.0,-90.0,-92.0,-89.0,-93.0,21.0,22.0,21.0,33.0,0
2700,CC:2F:71:3F:1F:24,6637633,6465066769,4006274,6131965574,2631359,333101195,78,830564,473227180,826651,472755748,3913,471432,802813,599,4008372,392556,78,4877,130000.0,43333.0,-81.0,-75.0,-83.0,-76.0,-80.0,-74.0,-82.0,-75.0,-90.0,-92.0,-89.0,-93.0,9.0,17.0,6.0,17.0,0
2701,F8:59:71:5A:E0:3D,2658517,374732010,27156,41630613,2631361,333101397,0,3407,420154,3294,402353,113,17801,3147,0,27182,866,0,32,130000.0,39000.0,-67.0,-74.0,-65.0,-72.0,-66.0,-73.0,-65.0,-71.0,-90.0,-92.0,-89.0,-93.0,23.0,18.0,24.0,21.0,0
2702,CC:2F:71:3E:C5:1F,2636536,333734334,5175,632937,2631361,333101397,6,22204,1861981,18302,1399541,3902,462440,5463,30,7374,133,6,450,130000.0,39000.0,-69.0,-70.0,-68.0,-60.0,-69.0,-70.0,-68.0,-60.0,-90.0,-92.0,-89.0,-93.0,21.0,22.0,21.0,33.0,0
2703,CC:2F:71:3F:1F:24,6637666,6465077193,4006305,6131975796,2631361,333101397,78,830581,473230178,826668,472758746,3913,471432,802829,599,4008403,392570,78,4877,117000.0,39000.0,-73.0,-65.0,-74.0,-67.0,-74.0,-66.0,-74.0,-68.0,-90.0,-92.0,-89.0,-93.0,17.0,27.0,15.0,26.0,0
2704,F8:59:71:5A:E0:3D,2658521,374732414,27156,41630613,2631365,333101801,0,3407,420154,3294,402353,113,17801,3147,0,27182,866,0,32,130000.0,39000.0,-67.0,-74.0,-65.0,-72.0,-66.0,-73.0,-65.0,-71.0,-90.0,-92.0,-89.0,-93.0,23.0,18.0,24.0,21.0,0
2705,CC:2F:71:3E:C5:1F,2636542,333734940,5175,632937,2631367,333102003,6,22204,1861981,18302,1399541,3902,462440,5463,30,7374,133,6,450,130000.0,39000.0,-69.0,-70.0,-68.0,-60.0,-69.0,-70.0,-68.0,-60.0,-90.0,-92.0,-89.0,-93.0,21.0,22.0,21.0,33.0,0
2706,CC:2F:71:3F:1F:24,6637704,6465088207,4006337,6131986204,2631367,333102003,78,830600,473233408,826687,472761976,3913,471432,802847,599,4008435,392582,78,4877,130000.0,39000.0,-70.0,-65.0,-74.0,-67.0,-70.0,-65.0,-74.0,-66.0,-90.0,-92.0,-89.0,-93.0,20.0,27.0,15.0,26.0,0
2707,F8:59:71:5A:E0:3D,2658526,374732878,27156,41630613,2631370,333102265,0,3407,420154,3294,402353,113,17801,3147,0,27182,866,0,32,130000.0,39000.0,-67.0,-74.0,-65.0,-72.0,-66.0,-73.0,-65.0,-71.0,-90.0,-92.0,-89.0,-93.0,23.0,18.0,24.0,21.0,0
2708,CC:2F:71:3E:C5:1F,2636545,333735202,5175,632937,2631370,333102265,6,22204,1861981,18302,1399541,3902,462440,5463,30,7374,133,6,450,130000.0,39000.0,-69.0,-70.0,-68.0,-60.0,-69.0,-70.0,-68.0,-60.0,-90.0,-92.0,-89.0,-93.0,21.0,22.0,21.0,33.0,0
2709,CC:2F:71:3F:1F:24,6637738,6465098691,4006368,6131996426,2631370,333102265,78,830617,473236406,826704,472764974,3913,471432,802863,599,4008466,392594,78,4877,130000.0,39000.0,-72.0,-66.0,-73.0,-67.0,-72.0,-65.0,-72.0,-67.0,-90.0,-92.0,-89.0,-93.0,18.0,26.0,16.0,26.0,0
2710,F8:59:71:5A:E0:3D,2658530,374733282,27156,41630613,2631374,333102669,0,3407,420154,3294,402353,113,17801,3147,0,27182,866,0,32,130000.0,39000.0,-67.0,-74.0,-65.0,-72.0,-66.0,-73.0,-65.0,-71.0,-90.0,-92.0,-89.0,-93.0,23.0,18.0,24.0,21.0,0
2711,CC:2F:71:3E:C5:1F,2636549,333735606,5175,632937,2631374,333102669,6,22204,1861981,18302,1399541,3902,462440,5463,30,7374,133,6,450,130000.0,39000.0,-69.0,-70.0,-68.0,-60.0,-69.0,-70.0,-68.0,-60.0,-90.0,-92.0,-89.0,-93.0,21.0,22.0,21.0,33.0,0
2712,CC:2F:71:3F:1F:24,6637773,6465109317,4006399,6132006648,2631374,333102669,78,830634,473239404,826721,472767972,3913,471432,802879,599,4008497,392624,78,4877,130000.0,43333.0,-72.0,-66.0,-72.0,-67.0,-72.0,-65.0,-72.0,-67.0,-90.0,-92.0,-89.0,-93.0,18.0,26.0,17.0,26.0,0
2713,F8:59:71:5A:E0:3D,2658534,374733686,27156,41630613,2631378,333103073,0,3407,420154,3294,402353,113,17801,3147,0,27182,866,0,32,130000.0,39000.0,-67.0,-74.0,-65.0,-72.0,-66.0,-73.0,-65.0,-71.0,-90.0,-92.0,-89.0,-93.0,23.0,18.0,24.0,21.0,0
2714,CC:2F:71:3E:C5:1F,2636554,333736070,5175,632937,2631379,333103133,6,22204,1861981,18302,1399541,3902,462440,5463,30,7374,133,6,450,130000.0,39000.0,-69.0,-70.0,-68.0,-60.0,-69.0,-70.0,-68.0,-60.0,-90.0,-92.0,-89.0,-93.0,21.0,22.0,21.0,33.0,0
2715,CC:2F:71:3F:1F:24,6637810,6465120189,4006431,6132017056,2631379,333103133,78,830651,473242402,826738,472770970,3913,471432,802895,599,4008529,392625,78,4877,130000.0,43333.0,-75.0,-68.0,-75.0,-70.0,-74.0,-68.0,-74.0,-69.0,-90.0,-92.0,-89.0,-93.0,15.0,24.0,14.0,23.0,0
2716,F8:59:71:5A:E0:3D,2658539,374734150,27156,41630613,2631383,333103537,0,3407,420154,3294,402353,113,17801,3147,0,27182,866,0,32,130000.0,39000.0,-67.0,-74.0,-65.0,-72.0,-66.0,-73.0,-65.0,-71.0,-90.0,-92.0,-89.0,-93.0,23.0,18.0,24.0,21.0,0
2717,CC:2F:71:3E:C5:1F,2636558,333736474,5175,632937,2631383,333103537,6,22204,1861981,18302,1399541,3902,462440,5463,30,7374,133,6,450,130000.0,39000.0,-69.0,-70.0,-68.0,-60.0,-69.0,-70.0,-68.0,-60.0,-90.0,-92.0,-89.0,-93.0,21.0,22.0,21.0,33.0,0
2718,CC:2F:71:3F:1F:24,6637845,6465130927,4006462,6132027390,2631383,333103537,78,830668,473245400,826755,472773968,3913,471432,802911,599,4008560,392625,78,4877,130000.0,43333.0,-71.0,-66.0,-71.0,-67.0,-71.0,-65.0,-71.0,-67.0,-90.0,-92.0,-89.0,-93.0,19.0,26.0,18.0,26.0,0
2719,F8:59:71:5A:E0:3D,2658541,374734352,27156,41630613,2631385,333103739,0,3407,420154,3294,402353,113,17801,3147,0,27182,866,0,32,130000.0,39000.0,-67.0,-74.0,-65.0,-72.0,-66.0,-73.0,-65.0,-71.0,-90.0,-92.0,-89.0,-93.0,23.0,18.0,24.0,21.0,0
2720,CC:2F:71:3E:C5:1F,2636560,333736676,5175,632937,2631385,333103739,6,22204,1861981,18302,1399541,3902,462440,5463,30,7374,133,6,450,130000.0,39000.0,-69.0,-70.0,-68.0,-60.0,-69.0,-70.0,-68.0,-60.0,-90.0,-92.0,-89.0,-93.0,21.0,22.0,21.0,33.0,0
2721,CC:2F:71:3F:1F:24,6637880,6465141609,4006493,6132037668,2631387,333103941,78,830686,473248514,826773,472777082,3913,471432,802928,599,4008591,392633,78,4877,130000.0,39000.0,-71.0,-66.0,-72.0,-67.0,-71.0,-66.0,-72.0,-67.0,-90.0,-92.0,-89.0,-93.0,19.0,26.0,17.0,26.0,0
2722,F8:59:71:5A:E0:3D,2658547,374734932,27157,41630729,2631390,333104203,0,3408,420224,3295,402423,113,17801,3147,0,27183,866,0,32,130000.0,39000.0,-67.0,-74.0,-65.0,-70.0,-66.0,-73.0,-65.0,-71.0,-90.0,-92.0,-89.0,-93.0,23.0,18.0,24.0,23.0,0
2723,CC:2F:71:3E:C5:1F,2636568,333737458,5176,633053,2631392,333104405,6,22205,1862051,18303,1399611,3902,462440,5463,30,7375,133,6,450,130000.0,39000.0,-69.0,-72.0,-68.0,-60.0,-69.0,-70.0,-68.0,-60.0,-90.0,-92.0,-89.0,-93.0,21.0,20.0,21.0,33.0,0
2724,CC:2F:71:3F:1F:24,6637917,6465152339,4006525,6132047934,2631392,333104405,78,830703,473251512,826790,472780080,3913,471432,802944,599,4008623,392653,78,4877,130000.0,43333.0,-72.0,-66.0,-71.0,-67.0,-72.0,-65.0,-71.0,-67.0,-90.0,-92.0,-89.0,-93.0,18.0,26.0,18.0,26.0,0
2725,F8:59:71:5A:E0:3D,2658551,374735336,27157,41630729,2631394,333104607,0,3409,420294,3296,402493,113,17801,3147,0,27183,866,0,32,130000.0,39000.0,-67.0,-74.0,-65.0,-71.0,-66.0,-73.0,-65.0,-71.0,-90.0,-92.0,-89.0,-93.0,23.0,18.0,24.0,22.0,0
2726,CC:2F:71:3E:C5:1F,2636570,333737660,5176,633053,2631394,333104607,6,22206,1862121,18304,1399681,3902,462440,5463,30,7375,133,6,450,130000.0,39000.0,-70.0,-72.0,-69.0,-60.0,-69.0,-71.0,-68.0,-60.0,-90.0,-92.0,-89.0,-93.0,20.0,20.0,20.0,33.0,0
2727,CC:2F:71:3F:1F:24,6637949,6465162745,4006555,6132058138,2631394,333104607,78,830720,473254510,826807,472783078,3913,471432,802960,599,4008653,392653,78,4877,130000.0,43333.0,-71.0,-65.0,-73.0,-67.0,-71.0,-65.0,-72.0,-67.0,-90.0,-92.0,-89.0,-93.0,19.0,27.0,16.0,26.0,0
2728,F8:59:71:5A:E0:3D,2658553,374735538,27157,41630729,2631396,333104809,0,3409,420294,3296,402493,113,17801,3147,0,27183,866,0,32,130000.0,39000.0,-67.0,-74.0,-65.0,-71.0,-66.0,-73.0,-65.0,-71.0,-90.0,-92.0,-89.0,-93.0,23.0,18.0,24.0,22.0,0
2729,CC:2F:71:3E:C5:1F,2636572,333737862,5176,633053,2631396,333104809,6,22206,1862121,18304,1399681,3902,462440,5463,30,7375,133,6,450,130000.0,39000.0,-70.0,-72.0,-69.0,-60.0,-69.0,-71.0,-68.0,-60.0,-90.0,-92.0,-89.0,-93.0,20.0,20.0,20.0,33.0,0
2730,CC:2F:71:3F:1F:24,6637982,6465173281,4006586,6132068472,2631396,333104809,78,830737,473257508,826824,472786076,3913,471432,802976,599,4008684,392653,78,4877,130000.0,43333.0,-72.0,-66.0,-72.0,-67.0,-71.0,-66.0,-71.0,-67.0,-90.0,-92.0,-89.0,-93.0,18.0,26.0,17.0,26.0,0
2731,F8:59:71:5A:E0:3D,2658559,374736136,27157,41630729,2631402,333105407,0,3409,420294,3296,402493,113,17801,3147,0,27183,866,0,32,130000.0,39000.0,-67.0,-74.0,-65.0,-71.0,-66.0,-73.0,-65.0,-71.0,-90.0,-92.0,-90.0,-93.0,23.0,18.0,25.0,22.0,0
2732,CC:2F:71:3E:C5:1F,2636579,333738528,5176,633053,2631403,333105475,6,22206,1862121,18304,1399681,3902,462440,5463,30,7375,133,6,450,130000.0,39000.0,-70.0,-72.0,-69.0,-60.0,-69.0,-71.0,-68.0,-60.0,-90.0,-92.0,-90.0,-93.0,20.0,20.0,21.0,33.0,0
2733,CC:2F:71:3F:1F:24,6638020,6465184169,4006617,6132078694,2631403,333105475,78,830754,473260506,826841,472789074,3913,471432,802992,599,4008715,392665,78,4877,117000.0,39000.0,-72.0,-65.0,-73.0,-67.0,-71.0,-65.0,-72.0,-67.0,-90.0,-92.0,-90.0,-93.0,18.0,27.0,17.0,26.0,0
2734,F8:59:71:5A:E0:3D,2658562,374736406,27157,41630729,2631405,333105677,0,3409,420294,3296,402493,113,17801,3147,0,27183,866,0,32,130000.0,39000.0,-67.0,-74.0,-65.0,-71.0,-66.0,-73.0,-65.0,-71.0,-90.0,-92.0,-90.0,-93.0,23.0,18.0,25.0,22.0,0
2735,CC:2F:71:3E:C5:1F,2636581,333738730,5176,633053,2631405,333105677,6,22206,1862121,18304,1399681,3902,462440,5463,30,7375,133,6,450,130000.0,39000.0,-70.0,-72.0,-69.0,-60.0,-69.0,-71.0,-68.0,-60.0,-90.0,-92.0,-90.0,-93.0,20.0,20.0,21.0,33.0,0
2736,CC:2F:71:3F:1F:24,6638054,6465194922,4006648,6132088972,2631406,333105950,78,830772,473263620,826859,472792188,3913,471432,803009,599,4008746,392666,78,4877,130000.0,39000.0,-72.0,-65.0,-72.0,-67.0,-71.0,-65.0,-72.0,-67.0,-90.0,-92.0,-90.0,-93.0,18.0,27.0,18.0,26.0,0
2737,F8:59:71:5A:E0:3D,2658567,374737083,27157,41630729,2631410,333106354,0,3409,420294,3296,402493,113,17801,3147,0,27183,866,0,32,130000.0,39000.0,-67.0,-74.0,-65.0,-71.0,-66.0,-73.0,-65.0,-71.0,-90.0,-92.0,-90.0,-93.0,23.0,18.0,25.0,22.0,0
2738,CC:2F:71:3E:C5:1F,2636587,333739469,5176,633053,2631411,333106416,6,22207,1862239,18304,1399681,3903,462558,5464,30,7375,133,6,450,130000.0,39000.0,-69.0,-72.0,-69.0,-60.0,-69.0,-71.0,-68.0,-60.0,-90.0,-92.0,-90.0,-93.0,21.0,20.0,21.0,33.0,0
2739,CC:2F:71:3F:1F:24,6638090,6465205610,4006679,6132099194,2631411,333106416,78,830793,473267082,826880,472795650,3913,471432,803029,599,4008777,392678,78,4877,130000.0,39000.0,-72.0,-65.0,-72.0,-68.0,-71.0,-65.0,-71.0,-67.0,-90.0,-92.0,-90.0,-93.0,18.0,27.0,18.0,25.0,0
2740,F8:59:71:5A:E0:3D,2658574,374737671,27157,41630729,2631417,333106942,0,3411,420482,3297,402563,114,17919,3148,0,27183,866,0,33,130000.0,39000.0,-67.0,-74.0,-65.0,-71.0,-67.0,-74.0,-65.0,-71.0,-90.0,-92.0,-90.0,-93.0,23.0,18.0,25.0,22.0,0
2741,CC:2F:71:3E:C5:1F,2636593,333739995,5176,633053,2631417,333106942,6,22208,1862309,18305,1399751,3903,462558,5464,30,7375,133,6,450,130000.0,39000.0,-69.0,-72.0,-69.0,-60.0,-69.0,-71.0,-68.0,-60.0,-90.0,-92.0,-90.0,-93.0,21.0,20.0,21.0,33.0,0
2742,CC:2F:71:3F:1F:24,6638127,6465216302,4006710,6132109360,2631417,333106942,78,830811,473270235,826898,472798803,3913,471432,803046,599,4008808,392693,78,4877,130000.0,43333.0,-71.0,-66.0,-73.0,-67.0,-71.0,-66.0,-73.0,-67.0,-90.0,-92.0,-90.0,-93.0,19.0,26.0,17.0,26.0,0
2743,F8:59:71:5A:E0:3D,2658578,374738075,27157,41630729,2631421,333107346,0,3411,420482,3297,402563,114,17919,3148,0,27183,866,0,33,130000.0,39000.0,-67.0,-74.0,-65.0,-71.0,-67.0,-74.0,-65.0,-71.0,-90.0,-92.0,-90.0,-93.0,23.0,18.0,25.0,22.0,0
2744,CC:2F:71:3E:C5:1F,2636597,333740399,5176,633053,2631421,333107346,6,22208,1862309,18305,1399751,3903,462558,5464,30,7375,133,6,450,130000.0,39000.0,-69.0,-72.0,-69.0,-60.0,-69.0,-71.0,-68.0,-60.0,-90.0,-92.0,-90.0,-93.0,21.0,20.0,21.0,33.0,0
2745,CC:2F:71:3F:1F:24,6638163,6465227209,4006742,6132119863,2631421,333107346,78,830831,473273581,826918,472802149,3913,471432,803065,599,4008840,392693,78,4877,130000.0,43333.0,-70.0,-66.0,-72.0,-67.0,-70.0,-66.0,-72.0,-67.0,-90.0,-92.0,-90.0,-93.0,20.0,26.0,18.0,26.0,0
2746,F8:59:71:5A:E0:3D,2658583,374738541,27157,41630729,2631426,333107812,0,3411,420482,3297,402563,114,17919,3148,0,27183,866,0,33,130000.0,39000.0,-67.0,-74.0,-65.0,-71.0,-67.0,-74.0,-65.0,-71.0,-90.0,-92.0,-90.0,-93.0,23.0,18.0,25.0,22.0,0
2747,CC:2F:71:3E:C5:1F,2636602,333740865,5176,633053,2631426,333107812,6,22208,1862309,18305,1399751,3903,462558,5464,30,7375,133,6,450,130000.0,39000.0,-69.0,-72.0,-69.0,-60.0,-69.0,-71.0,-68.0,-60.0,-90.0,-92.0,-90.0,-93.0,21.0,20.0,21.0,33.0,0
2748,CC:2F:71:3F:1F:24,6638199,6465238009,4006773,6132130197,2631426,333107812,78,830850,473276813,826936,472805263,3914,471550,803083,599,4008871,392693,78,4877,130000.0,43333.0,-70.0,-66.0,-73.0,-68.0,-70.0,-65.0,-73.0,-67.0,-90.0,-92.0,-90.0,-93.0,20.0,26.0,17.0,25.0,0
2749,F8:59:71:5A:E0:3D,2658588,374739005,27157,41630729,2631431,333108276,0,3411,420482,3297,402563,114,17919,3148,0,27183,866,0,33,130000.0,39000.0,-67.0,-74.0,-65.0,-71.0,-67.0,-74.0,-65.0,-71.0,-90.0,-92.0,-90.0,-93.0,23.0,18.0,25.0,22.0,0
2750,CC:2F:71:3E:C5:1F,2636607,333741329,5176,633053,2631431,333108276,6,22208,1862309,18305,1399751,3903,462558,5464,30,7375,133,6,450,130000.0,39000.0,-69.0,-72.0,-69.0,-60.0,-69.0,-71.0,-68.0,-60.0,-90.0,-92.0,-90.0,-93.0,21.0,20.0,21.0,33.0,0
2751,CC:2F:71:3F:1F:24,6638235,6465248695,4006804,6132140419,2631431,333108276,78,830868,473279927,826954,472808377,3914,471550,803100,599,4008902,392705,78,4877,117000.0,39000.0,-71.0,-64.0,-73.0,-69.0,-69.0,-64.0,-72.0,-67.0,-90.0,-92.0,-90.0,-93.0,19.0,28.0,17.0,24.0,0
2752,F8:59:71:5A:E0:3D,2658592,374739409,27157,41630729,2631435,333108680,0,3411,420482,3297,402563,114,17919,3148,0,27183,866,0,33,130000.0,39000.0,-67.0,-74.0,-65.0,-71.0,-67.0,-74.0,-65.0,-71.0,-90.0,-92.0,-90.0,-93.0,23.0,18.0,25.0,22.0,0
2753,CC:2F:71:3E:C5:1F,2636611,333741733,5176,633053,2631435,333108680,6,22208,1862309,18305,1399751,3903,462558,5464,30,7375,133,6,450,130000.0,39000.0,-69.0,-72.0,-69.0,-60.0,-69.0,-71.0,-68.0,-60.0,-90.0,-92.0,-90.0,-93.0,21.0,20.0,21.0,33.0,0
2754,CC:2F:71:3F:1F:24,6638270,6465259321,4006835,6132150641,2631435,333108680,78,830888,473283273,826974,472811723,3914,471550,803119,599,4008933,392741,78,4877,78000.0,13000.0,-70.0,-65.0,-74.0,-68.0,-69.0,-64.0,-73.0,-67.0,-90.0,-92.0,-90.0,-93.0,20.0,27.0,16.0,25.0,0
2755,F8:59:71:5A:E0:3D,2658596,374739813,27157,41630729,2631439,333109084,0,3411,420482,3297,402563,114,17919,3148,0,27183,866,0,33,130000.0,39000.0,-67.0,-74.0,-65.0,-71.0,-67.0,-74.0,-65.0,-71.0,-90.0,-92.0,-90.0,-93.0,23.0,18.0,25.0,22.0,0
2756,CC:2F:71:3E:C5:1F,2636615,333742137,5176,633053,2631439,333109084,6,22208,1862309,18305,1399751,3903,462558,5464,30,7375,133,6,450,130000.0,39000.0,-69.0,-72.0,-69.0,-60.0,-69.0,-71.0,-68.0,-60.0,-90.0,-92.0,-90.0,-93.0,21.0,20.0,21.0,33.0,0
2757,CC:2F:71:3F:1F:24,6638305,6465269891,4006866,6132160807,2631439,333109084,78,830905,473286271,826991,472814721,3914,471550,803135,599,4008964,392741,78,4877,86667.0,13000.0,-70.0,-65.0,-74.0,-68.0,-74.0,-69.0,-78.0,-72.0,-90.0,-92.0,-90.0,-93.0,20.0,27.0,16.0,25.0,0
2758,F8:59:71:5A:E0:3D,2658601,374740277,27157,41630729,2631444,333109548,0,3411,420482,3297,402563,114,17919,3148,0,27183,866,0,33,130000.0,39000.0,-67.0,-74.0,-65.0,-71.0,-67.0,-74.0,-65.0,-71.0,-90.0,-92.0,-90.0,-93.0,23.0,18.0,25.0,22.0,0
2759,CC:2F:71:3E:C5:1F,2636620,333742601,5176,633053,2631444,333109548,6,22208,1862309,18305,1399751,3903,462558,5464,30,7375,133,6,450,130000.0,39000.0,-69.0,-72.0,-69.0,-60.0,-69.0,-71.0,-68.0,-60.0,-90.0,-92.0,-90.0,-93.0,21.0,20.0,21.0,33.0,0
2760,CC:2F:71:3F:1F:24,6638341,6465280521,4006897,6132170973,2631444,333109548,78,830922,473289269,827008,472817719,3914,471550,803151,599,4008995,392741,78,4877,86667.0,14444.0,-79.0,-74.0,-81.0,-78.0,-78.0,-72.0,-81.0,-76.0,-90.0,-92.0,-90.0,-93.0,11.0,18.0,9.0,15.0,0
2761,F8:59:71:5A:E0:3D,2658603,374740479,27157,41630729,2631446,333109750,0,3413,420622,3299,402703,114,17919,3148,0,27184,866,0,33,130000.0,39000.0,-68.0,-74.0,-65.0,-71.0,-67.0,-74.0,-65.0,-71.0,-90.0,-92.0,-90.0,-93.0,22.0,18.0,25.0,22.0,0
2762,CC:2F:71:3E:C5:1F,2636622,333742803,5176,633053,2631446,333109750,6,22210,1862449,18307,1399891,3903,462558,5464,30,7376,133,6,450,130000.0,39000.0,-69.0,-71.0,-68.0,-60.0,-69.0,-72.0,-69.0,-61.0,-90.0,-92.0,-90.0,-93.0,21.0,21.0,22.0,33.0,0
2763,CC:2F:71:3F:1F:24,6638457,6465357022,4007009,6132247070,2631448,333109952,78,831001,473303224,827087,472831674,3914,471550,803227,599,4009107,392799,78,4877,86667.0,14444.0,-70.0,-65.0,-74.0,-68.0,-69.0,-65.0,-73.0,-68.0,-90.0,-92.0,-90.0,-93.0,20.0,27.0,16.0,25.0,0
2764,F8:59:71:5A:E0:3D,2658607,374740883,27157,41630729,2631450,333110154,0,3413,420622,3299,402703,114,17919,3148,0,27184,866,0,33,130000.0,39000.0,-68.0,-74.0,-65.0,-71.0,-67.0,-74.0,-65.0,-71.0,-90.0,-92.0,-90.0,-93.0,22.0,18.0,25.0,22.0,0
2765,CC:2F:71:3E:C5:1F,2636626,333743207,5176,633053,2631450,333110154,6,22210,1862449,18307,1399891,3903,462558,5464,30,7376,133,6,450,130000.0,39000.0,-69.0,-71.0,-68.0,-60.0,-69.0,-72.0,-69.0,-61.0,-90.0,-92.0,-90.0,-93.0,21.0,21.0,22.0,33.0,0
2766,CC:2F:71:3F:1F:24,6638500,6465372667,4007049,6132262453,2631451,333110214,78,831024,473307177,827110,472835627,3914,471550,803249,599,4009147,392799,78,4877,86667.0,14444.0,-70.0,-65.0,-74.0,-68.0,-70.0,-65.0,-74.0,-67.0,-90.0,-92.0,-90.0,-93.0,20.0,27.0,16.0,25.0,0
2767,F8:59:71:5A:E0:3D,2658610,374741145,27157,41630729,2631453,333110416,0,3413,420622,3299,402703,114,17919,3148,0,27184,866,0,33,130000.0,39000.0,-68.0,-74.0,-65.0,-71.0,-67.0,-74.0,-65.0,-71.0,-90.0,-92.0,-90.0,-93.0,22.0,18.0,25.0,22.0,0
2768,CC:2F:71:3E:C5:1F,2636631,333743671,5176,633053,2631455,333110618,6,22210,1862449,18307,1399891,3903,462558,5464,30,7376,133,6,450,130000.0,39000.0,-69.0,-71.0,-68.0,-60.0,-69.0,-72.0,-69.0,-61.0,-90.0,-92.0,-90.0,-93.0,21.0,21.0,22.0,33.0,0
2769,CC:2F:71:3F:1F:24,6638535,6465383293,4007080,6132272675,2631455,333110618,78,831043,473310407,827129,472838857,3914,471550,803267,599,4009178,392799,78,4877,86667.0,14444.0,-70.0,-65.0,-74.0,-68.0,-70.0,-65.0,-74.0,-67.0,-90.0,-92.0,-90.0,-93.0,20.0,27.0,16.0,25.0,0
2770,F8:59:71:5A:E0:3D,2658614,374741549,27157,41630729,2631457,333110820,0,3413,420622,3299,402703,114,17919,3148,0,27184,866,0,33,130000.0,39000.0,-68.0,-74.0,-65.0,-71.0,-67.0,-74.0,-65.0,-71.0,-90.0,-92.0,-89.0,-92.0,22.0,18.0,24.0,21.0,0
2771,CC:2F:71:3E:C5:1F,2636633,333743873,5176,633053,2631457,333110820,6,22210,1862449,18307,1399891,3903,462558,5464,30,7376,133,6,450,130000.0,39000.0,-69.0,-71.0,-68.0,-60.0,-69.0,-72.0,-69.0,-61.0,-90.0,-92.0,-89.0,-92.0,21.0,21.0,21.0,32.0,0
2772,CC:2F:71:3F:1F:24,6638570,6465393975,4007111,6132282953,2631459,333111022,78,831060,473313405,827146,472841855,3914,471550,803283,599,4009209,392801,78,4877,104000.0,26000.0,-70.0,-65.0,-74.0,-68.0,-70.0,-65.0,-74.0,-68.0,-90.0,-92.0,-89.0,-92.0,20.0,27.0,15.0,24.0,0
2773,F8:59:71:5A:E0:3D,2658618,374741953,27157,41630729,2631461,333111224,0,3413,420622,3299,402703,114,17919,3148,0,27184,866,0,33,130000.0,39000.0,-68.0,-74.0,-65.0,-71.0,-67.0,-74.0,-65.0,-71.0,-90.0,-92.0,-89.0,-92.0,22.0,18.0,24.0,21.0,0
2774,CC:2F:71:3E:C5:1F,2636638,333744337,5176,633053,2631462,333111284,6,22210,1862449,18307,1399891,3903,462558,5464,30,7376,133,6,450,130000.0,39000.0,-69.0,-71.0,-68.0,-60.0,-69.0,-72.0,-69.0,-61.0,-90.0,-92.0,-89.0,-92.0,21.0,21.0,21.0,32.0,0
2775,CC:2F:71:3F:1F:24,6638604,6465404403,4007142,6132293119,2631462,333111284,78,831078,473316519,827164,472844969,3914,471550,803300,599,4009240,392808,78,4877,117000.0,39000.0,-70.0,-65.0,-74.0,-67.0,-70.0,-65.0,-74.0,-67.0,-90.0,-92.0,-89.0,-92.0,20.0,27.0,15.0,25.0,0
2776,F8:59:71:5A:E0:3D,2658623,374742417,27157,41630729,2631466,333111688,0,3413,420622,3299,402703,114,17919,3148,0,27184,866,0,33,130000.0,39000.0,-68.0,-74.0,-65.0,-71.0,-67.0,-74.0,-65.0,-71.0,-90.0,-92.0,-89.0,-92.0,22.0,18.0,24.0,21.0,0
2777,CC:2F:71:3E:C5:1F,2636642,333744741,5176,633053,2631466,333111688,6,22210,1862449,18307,1399891,3903,462558,5464,30,7376,133,6,450,130000.0,39000.0,-69.0,-71.0,-68.0,-60.0,-69.0,-72.0,-69.0,-61.0,-90.0,-92.0,-89.0,-92.0,21.0,21.0,21.0,32.0,0
2778,CC:2F:71:3F:1F:24,6638638,6465414955,4007172,6132303267,2631466,333111688,78,831096,473319633,827182,472848083,3914,471550,803317,599,4009270,392832,78,4877,115556.0,26000.0,-70.0,-65.0,-74.0,-69.0,-70.0,-64.0,-73.0,-67.0,-90.0,-92.0,-89.0,-92.0,20.0,27.0,15.0,23.0,0
2779,F8:59:71:5A:E0:3D,2658628,374743094,27157,41630729,2631471,333112365,0,3413,420622,3299,402703,114,17919,3148,0,27184,866,0,33,130000.0,39000.0,-68.0,-74.0,-65.0,-71.0,-67.0,-74.0,-65.0,-71.0,-90.0,-92.0,-89.0,-92.0,22.0,18.0,24.0,21.0,0
2780,CC:2F:71:3E:C5:1F,2636647,333745418,5176,633053,2631471,333112365,6,22210,1862449,18307,1399891,3903,462558,5464,30,7376,133,6,450,130000.0,39000.0,-69.0,-71.0,-68.0,-60.0,-69.0,-72.0,-69.0,-61.0,-90.0,-92.0,-89.0,-92.0,21.0,21.0,21.0,32.0,0
2781,CC:2F:71:3F:1F:24,6638675,6465425928,4007204,6132313563,2631471,333112365,78,831114,473322747,827200,472851197,3914,471550,803334,599,4009302,392845,78,4877,117000.0,39000.0,-77.0,-71.0,-79.0,-74.0,-76.0,-70.0,-79.0,-73.0,-90.0,-92.0,-89.0,-92.0,13.0,21.0,10.0,18.0,0
2782,F8:59:71:5A:E0:3D,2658633,374743558,27157,41630729,2631476,333112829,0,3413,420622,3299,402703,114,17919,3148,0,27184,866,0,33,130000.0,39000.0,-68.0,-74.0,-65.0,-71.0,-67.0,-74.0,-65.0,-71.0,-90.0,-92.0,-89.0,-92.0,22.0,18.0,24.0,21.0,0
2783,CC:2F:71:3E:C5:1F,2636652,333745882,5176,633053,2631476,333112829,6,22210,1862449,18307,1399891,3903,462558,5464,30,7376,133,6,450,130000.0,39000.0,-69.0,-71.0,-68.0,-60.0,-69.0,-72.0,-69.0,-61.0,-90.0,-92.0,-89.0,-92.0,21.0,21.0,21.0,32.0,0
2784,CC:2F:71:3F:1F:24,6638711,6465436670,4007235,6132323841,2631476,333112829,78,831132,473325861,827218,472854311,3914,471550,803351,599,4009333,392866,78,4877,104000.0,26000.0,-77.0,-71.0,-80.0,-74.0,-77.0,-72.0,-81.0,-75.0,-90.0,-92.0,-89.0,-92.0,13.0,21.0,9.0,18.0,0
2785,F8:59:71:5A:E0:3D,2658637,374743962,27157,41630729,2631480,333113233,0,3413,420622,3299,402703,114,17919,3148,0,27184,866,0,33,130000.0,39000.0,-68.0,-74.0,-65.0,-71.0,-67.0,-74.0,-65.0,-71.0,-90.0,-92.0,-89.0,-92.0,22.0,18.0,24.0,21.0,0
2786,CC:2F:71:3E:C5:1F,2636656,333746286,5176,633053,2631480,333113233,6,22210,1862449,18307,1399891,3903,462558,5464,30,7376,133,6,450,130000.0,39000.0,-69.0,-71.0,-68.0,-60.0,-69.0,-72.0,-69.0,-61.0,-90.0,-92.0,-89.0,-92.0,21.0,21.0,21.0,32.0,0
2787,CC:2F:71:3F:1F:24,6638746,6465447296,4007266,6132334063,2631480,333113233,78,831149,473328859,827235,472857309,3914,471550,803367,599,4009364,392875,78,4877,115556.0,28889.0,-70.0,-65.0,-74.0,-68.0,-70.0,-65.0,-74.0,-68.0,-90.0,-92.0,-89.0,-92.0,20.0,27.0,15.0,24.0,0
2788,F8:59:71:5A:E0:3D,2658641,374744366,27157,41630729,2631484,333113637,0,3413,420622,3299,402703,114,17919,3148,0,27184,866,0,33,130000.0,39000.0,-68.0,-74.0,-65.0,-71.0,-67.0,-74.0,-65.0,-71.0,-90.0,-92.0,-89.0,-92.0,22.0,18.0,24.0,21.0,0
2789,CC:2F:71:3E:C5:1F,2636660,333746690,5176,633053,2631484,333113637,6,22210,1862449,18307,1399891,3903,462558,5464,30,7376,133,6,450,130000.0,39000.0,-69.0,-71.0,-68.0,-60.0,-69.0,-72.0,-69.0,-61.0,-90.0,-92.0,-89.0,-92.0,21.0,21.0,21.0,32.0,0
2790,CC:2F:71:3F:1F:24,6638782,6465458164,4007298,6132344527,2631484,333113637,78,831167,473331973,827253,472860423,3914,471550,803384,599,4009396,392887,78,4877,115556.0,28889.0,-70.0,-65.0,-74.0,-68.0,-70.0,-65.0,-74.0,-67.0,-90.0,-92.0,-89.0,-92.0,20.0,27.0,15.0,24.0,0
2791,F8:59:71:5A:E0:3D,2658646,374744830,27157,41630729,2631489,333114101,0,3413,420622,3299,402703,114,17919,3148,0,27184,866,0,33,130000.0,39000.0,-68.0,-74.0,-65.0,-71.0,-67.0,-74.0,-65.0,-71.0,-90.0,-92.0,-89.0,-92.0,22.0,18.0,24.0,21.0,0
2792,CC:2F:71:3E:C5:1F,2636665,333747154,5176,633053,2631489,333114101,6,22210,1862449,18307,1399891,3903,462558,5464,30,7376,133,6,450,130000.0,39000.0,-69.0,-71.0,-68.0,-60.0,-69.0,-72.0,-69.0,-61.0,-90.0,-92.0,-89.0,-92.0,21.0,21.0,21.0,32.0,0
2793,CC:2F:71:3F:1F:24,6638817,6465468720,4007328,6132354619,2631489,333114101,78,831185,473335087,827271,472863537,3914,471550,803401,599,4009426,392909,78,4877,104000.0,26000.0,-70.0,-65.0,-74.0,-68.0,-70.0,-65.0,-73.0,-68.0,-90.0,-92.0,-89.0,-92.0,20.0,27.0,15.0,24.0,0
2794,F8:59:71:5A:E0:3D,2658648,374745032,27157,41630729,2631491,333114303,0,3413,420622,3299,402703,114,17919,3148,0,27184,866,0,33,130000.0,39000.0,-68.0,-74.0,-65.0,-71.0,-67.0,-74.0,-65.0,-71.0,-90.0,-92.0,-89.0,-92.0,22.0,18.0,24.0,21.0,0
2795,CC:2F:71:3E:C5:1F,2636667,333747356,5176,633053,2631491,333114303,6,22210,1862449,18307,1399891,3903,462558,5464,30,7376,133,6,450,130000.0,39000.0,-69.0,-71.0,-68.0,-60.0,-69.0,-72.0,-69.0,-61.0,-90.0,-92.0,-89.0,-92.0,21.0,21.0,21.0,32.0,0
2796,CC:2F:71:3F:1F:24,6638852,6465479402,4007359,6132364897,2631493,333114505,78,831204,473338317,827290,472866767,3914,471550,803419,599,4009457,392914,78,4877,115556.0,28889.0,-70.0,-65.0,-75.0,-69.0,-70.0,-65.0,-75.0,-68.0,-90.0,-92.0,-89.0,-92.0,20.0,27.0,14.0,23.0,0
2797,F8:59:71:5A:E0:3D,2658652,374745436,27157,41630729,2631495,333114707,0,3413,420622,3299,402703,114,17919,3148,0,27184,866,0,33,130000.0,39000.0,-68.0,-74.0,-65.0,-71.0,-67.0,-74.0,-65.0,-71.0,-90.0,-92.0,-89.0,-92.0,22.0,18.0,24.0,21.0,0
2798,CC:2F:71:3E:C5:1F,2636673,333747962,5176,633053,2631497,333114909,6,22210,1862449,18307,1399891,3903,462558,5464,30,7376,133,6,450,130000.0,39000.0,-69.0,-71.0,-68.0,-60.0,-69.0,-72.0,-69.0,-61.0,-90.0,-92.0,-89.0,-92.0,21.0,21.0,21.0,32.0,0
2799,CC:2F:71:3F:1F:24,6638887,6465490084,4007390,6132375175,2631497,333114909,78,831223,473341547,827309,472869997,3914,471550,803437,599,4009488,392914,78,4877,115556.0,28889.0,-70.0,-66.0,-76.0,-67.0,-70.0,-65.0,-75.0,-67.0,-90.0,-92.0,-89.0,-92.0,20.0,26.0,13.0,25.0,0
2800,F8:59:71:5A:E0:3D,2658659,374746268,27157,41630729,2631502,333115539,0,3413,420622,3299,402703,114,17919,3148,0,27184,866,0,33,130000.0,39000.0,-68.0,-74.0,-65.0,-71.0,-67.0,-74.0,-65.0,-71.0,-90.0,-92.0,-89.0,-92.0,22.0,18.0,24.0,21.0,0
2801,CC:2F:71:3E:C5:1F,2636678,333748592,5176,633053,2631502,333115539,6,22210,1862449,18307,1399891,3903,462558,5464,30,7376,133,6,450,130000.0,39000.0,-69.0,-71.0,-68.0,-60.0,-69.0,-72.0,-69.0,-61.0,-90.0,-92.0,-89.0,-92.0,21.0,21.0,21.0,32.0,0
2802,CC:2F:71:3F:1F:24,6638923,6465500992,4007421,6132385453,2631502,333115539,78,831241,473344661,827327,472873111,3914,471550,803454,599,4009519,392914,78,4877,117000.0,39000.0,-71.0,-66.0,-76.0,-67.0,-70.0,-66.0,-75.0,-67.0,-90.0,-92.0,-89.0,-92.0,19.0,26.0,13.0,25.0,0
2803,F8:59:71:5A:E0:3D,2658661,374746470,27157,41630729,2631504,333115741,0,3413,420622,3299,402703,114,17919,3148,0,27184,866,0,33,130000.0,39000.0,-68.0,-74.0,-65.0,-71.0,-67.0,-74.0,-65.0,-71.0,-90.0,-92.0,-89.0,-92.0,22.0,18.0,24.0,21.0,0
2804,CC:2F:71:3E:C5:1F,2636682,333748996,5176,633053,2631506,333115943,6,22210,1862449,18307,1399891,3903,462558,5464,30,7376,133,6,450,130000.0,39000.0,-69.0,-71.0,-68.0,-60.0,-69.0,-72.0,-69.0,-61.0,-90.0,-92.0,-89.0,-92.0,21.0,21.0,21.0,32.0,0
2805,CC:2F:71:3F:1F:24,6638958,6465511562,4007452,6132395619,2631506,333115943,78,831258,473347659,827344,472876109,3914,471550,803470,599,4009550,392918,78,4877,130000.0,39000.0,-70.0,-66.0,-75.0,-67.0,-70.0,-65.0,-75.0,-67.0,-90.0,-92.0,-89.0,-92.0,20.0,26.0,14.0,25.0,0
2806,F8:59:71:5A:E0:3D,2658667,374747076,27157,41630729,2631510,333116347,0,3413,420622,3299,402703,114,17919,3148,0,27184,866,0,33,130000.0,39000.0,-68.0,-74.0,-65.0,-71.0,-67.0,-74.0,-65.0,-71.0,-90.0,-92.0,-89.0,-92.0,22.0,18.0,24.0,21.0,0
2807,CC:2F:71:3E:C5:1F,2636686,333749400,5176,633053,2631510,333116347,6,22210,1862449,18307,1399891,3903,462558,5464,30,7376,133,6,450,130000.0,39000.0,-69.0,-71.0,-68.0,-60.0,-69.0,-72.0,-69.0,-61.0,-90.0,-92.0,-89.0,-92.0,21.0,21.0,21.0,32.0,0
2808,CC:2F:71:3F:1F:24,6638994,6465522374,4007484,6132406027,2631510,333116347,78,831275,473350657,827361,472879107,3914,471550,803486,599,4009582,392934,78,4877,144444.0,39000.0,-70.0,-66.0,-76.0,-67.0,-70.0,-66.0,-75.0,-67.0,-90.0,-92.0,-89.0,-92.0,20.0,26.0,13.0,25.0,0
2809,F8:59:71:5A:E0:3D,2658671,374747454,27158,41630845,2631513,333116609,0,3415,420762,3301,402843,114,17919,3148,0,27185,866,0,33,130000.0,39000.0,-68.0,-74.0,-66.0,-72.0,-68.0,-74.0,-66.0,-71.0,-90.0,-92.0,-89.0,-92.0,22.0,18.0,23.0,20.0,0
2810,CC:2F:71:3E:C5:1F,2636690,333749778,5177,633169,2631513,333116609,6,22212,1862589,18309,1400031,3903,462558,5464,30,7377,133,6,450,130000.0,39000.0,-69.0,-72.0,-68.0,-60.0,-68.0,-71.0,-68.0,-61.0,-90.0,-92.0,-89.0,-92.0,21.0,20.0,21.0,32.0,0
2811,CC:2F:71:3F:1F:24,6639030,6465533104,4007517,6132416495,2631513,333116609,78,831295,473353911,827381,472882361,3914,471550,803503,599,4009615,392943,78,4877,130000.0,43333.0,-70.0,-66.0,-75.0,-67.0,-70.0,-66.0,-75.0,-67.0,-90.0,-92.0,-89.0,-92.0,20.0,26.0,14.0,25.0,0
2812,F8:59:71:5A:E0:3D,2658676,374747920,27158,41630845,2631518,333117075,0,3417,420950,3302,402913,115,18037,3149,0,27185,866,0,33,130000.0,39000.0,-68.0,-74.0,-65.0,-71.0,-68.0,-74.0,-66.0,-71.0,-90.0,-92.0,-89.0,-92.0,22.0,18.0,24.0,21.0,0
2813,CC:2F:71:3E:C5:1F,2636695,333750244,5177,633169,2631518,333117075,6,22212,1862589,18309,1400031,3903,462558,5464,30,7377,133,6,450,130000.0,39000.0,-69.0,-72.0,-68.0,-60.0,-68.0,-71.0,-68.0,-61.0,-90.0,-92.0,-89.0,-92.0,21.0,20.0,21.0,32.0,0
2814,CC:2F:71:3F:1F:24,6639069,6465544180,4007549,6132426903,2631520,333117277,78,831314,473357141,827400,472885591,3914,471550,803521,599,4009647,392948,78,4877,130000.0,39000.0,-70.0,-66.0,-76.0,-67.0,-70.0,-65.0,-75.0,-67.0,-90.0,-92.0,-89.0,-92.0,20.0,26.0,13.0,25.0,0
2815,F8:59:71:5A:E0:3D,2658681,374748386,27158,41630845,2631523,333117541,0,3417,420950,3302,402913,115,18037,3149,0,27185,866,0,33,130000.0,39000.0,-68.0,-74.0,-65.0,-71.0,-68.0,-74.0,-66.0,-71.0,-90.0,-92.0,-89.0,-92.0,22.0,18.0,24.0,21.0,0
2816,CC:2F:71:3E:C5:1F,2636700,333750710,5177,633169,2631523,333117541,6,22212,1862589,18309,1400031,3903,462558,5464,30,7377,133,6,450,130000.0,39000.0,-69.0,-72.0,-68.0,-60.0,-68.0,-71.0,-68.0,-61.0,-90.0,-92.0,-89.0,-92.0,21.0,20.0,21.0,32.0,0
2817,CC:2F:71:3F:1F:24,6639103,6465554666,4007580,6132437125,2631523,333117541,78,831333,473360373,827418,472888705,3915,471668,803539,599,4009678,392952,78,4877,130000.0,39000.0,-70.0,-65.0,-76.0,-67.0,-70.0,-65.0,-75.0,-67.0,-90.0,-92.0,-89.0,-92.0,20.0,27.0,13.0,25.0,0
2818,F8:59:71:5A:E0:3D,2658686,374748850,27158,41630845,2631528,333118005,0,3417,420950,3302,402913,115,18037,3149,0,27185,866,0,33,130000.0,39000.0,-68.0,-74.0,-65.0,-71.0,-68.0,-74.0,-66.0,-71.0,-90.0,-92.0,-89.0,-92.0,22.0,18.0,24.0,21.0,0
2819,CC:2F:71:3E:C5:1F,2636705,333751174,5177,633169,2631528,333118005,6,22212,1862589,18309,1400031,3903,462558,5464,30,7377,133,6,450,130000.0,39000.0,-69.0,-72.0,-68.0,-60.0,-68.0,-71.0,-68.0,-61.0,-90.0,-92.0,-89.0,-92.0,21.0,20.0,21.0,32.0,0
2820,CC:2F:71:3F:1F:24,6639139,6465565408,4007611,6132447403,2631528,333118005,78,831351,473363487,827436,472891819,3915,471668,803556,599,4009709,392952,78,4877,130000.0,43333.0,-70.0,-66.0,-75.0,-67.0,-70.0,-66.0,-75.0,-67.0,-90.0,-92.0,-89.0,-92.0,20.0,26.0,14.0,25.0,0
2821,F8:59:71:5A:E0:3D,2658691,374749527,27158,41630845,2631533,333118682,0,3417,420950,3302,402913,115,18037,3149,0,27185,866,0,33,130000.0,39000.0,-68.0,-74.0,-65.0,-71.0,-68.0,-74.0,-66.0,-71.0,-90.0,-92.0,-89.0,-92.0,22.0,18.0,24.0,21.0,0
2822,CC:2F:71:3E:C5:1F,2636710,333751851,5177,633169,2631533,333118682,6,22212,1862589,18309,1400031,3903,462558,5464,30,7377,133,6,450,130000.0,39000.0,-69.0,-72.0,-68.0,-60.0,-68.0,-71.0,-68.0,-61.0,-90.0,-92.0,-89.0,-92.0,21.0,20.0,21.0,32.0,0
2823,CC:2F:71:3F:1F:24,6639175,6465576307,4007642,6132457625,2631533,333118682,78,831368,473366485,827453,472894817,3915,471668,803572,599,4009740,392964,78,4877,117000.0,39000.0,-70.0,-66.0,-75.0,-67.0,-69.0,-65.0,-74.0,-66.0,-90.0,-92.0,-89.0,-92.0,20.0,26.0,14.0,25.0,0
2824,F8:59:71:5A:E0:3D,2658695,374749931,27158,41630845,2631537,333119086,0,3417,420950,3302,402913,115,18037,3149,0,27185,866,0,33,130000.0,39000.0,-68.0,-74.0,-65.0,-71.0,-68.0,-74.0,-66.0,-71.0,-90.0,-92.0,-89.0,-92.0,22.0,18.0,24.0,21.0,0
2825,CC:2F:71:3E:C5:1F,2636714,333752255,5177,633169,2631537,333119086,6,22212,1862589,18309,1400031,3903,462558,5464,30,7377,133,6,450,130000.0,39000.0,-69.0,-72.0,-68.0,-60.0,-68.0,-71.0,-68.0,-61.0,-90.0,-92.0,-89.0,-92.0,21.0,20.0,21.0,32.0,0
2826,CC:2F:71:3F:1F:24,6639211,6465586993,4007673,6132467847,2631538,333119146,78,831386,473369599,827471,472897931,3915,471668,803589,599,4009771,392965,78,4877,130000.0,43333.0,-70.0,-65.0,-76.0,-67.0,-70.0,-65.0,-75.0,-67.0,-90.0,-92.0,-89.0,-92.0,20.0,27.0,13.0,25.0,0
2827,F8:59:71:5A:E0:3D,2658698,374750193,27158,41630845,2631540,333119348,0,3417,420950,3302,402913,115,18037,3149,0,27185,866,0,33,130000.0,39000.0,-68.0,-74.0,-65.0,-71.0,-68.0,-74.0,-66.0,-71.0,-90.0,-92.0,-89.0,-92.0,22.0,18.0,24.0,21.0,0
2828,CC:2F:71:3E:C5:1F,2636719,333752719,5177,633169,2631542,333119550,6,22212,1862589,18309,1400031,3903,462558,5464,30,7377,133,6,450,130000.0,39000.0,-69.0,-72.0,-68.0,-60.0,-68.0,-71.0,-68.0,-61.0,-90.0,-92.0,-89.0,-92.0,21.0,20.0,21.0,32.0,0
2829,CC:2F:71:3F:1F:24,6639246,6465597731,4007704,6132478181,2631542,333119550,78,831403,473372597,827488,472900929,3915,471668,803605,599,4009802,392965,78,4877,130000.0,43333.0,-70.0,-66.0,-75.0,-68.0,-70.0,-66.0,-75.0,-67.0,-90.0,-92.0,-89.0,-92.0,20.0,26.0,14.0,24.0,0
2830,F8:59:71:5A:E0:3D,2658700,374750395,27158,41630845,2631542,333119550,0,3417,420950,3302,402913,115,18037,3149,0,27185,866,0,33,130000.0,39000.0,-68.0,-74.0,-65.0,-71.0,-68.0,-74.0,-66.0,-71.0,-90.0,-92.0,-89.0,-92.0,22.0,18.0,24.0,21.0,0
2831,CC:2F:71:3E:C5:1F,2636723,333753123,5177,633169,2631546,333119954,6,22212,1862589,18309,1400031,3903,462558,5464,30,7377,133,6,450,130000.0,39000.0,-69.0,-72.0,-68.0,-60.0,-68.0,-71.0,-68.0,-61.0,-90.0,-92.0,-89.0,-92.0,21.0,20.0,21.0,32.0,0
2832,CC:2F:71:3F:1F:24,6639281,6465608357,4007735,6132488403,2631546,333119954,78,831421,473375711,827506,472904043,3915,471668,803622,599,4009833,392978,78,4877,117000.0,39000.0,-70.0,-65.0,-75.0,-67.0,-70.0,-65.0,-75.0,-67.0,-90.0,-92.0,-89.0,-92.0,20.0,27.0,14.0,25.0,0
2833,F8:59:71:5A:E0:3D,2658706,374751001,27158,41630845,2631548,333120156,0,3417,420950,3302,402913,115,18037,3149,0,27185,866,0,33,130000.0,39000.0,-68.0,-74.0,-65.0,-71.0,-68.0,-74.0,-66.0,-71.0,-90.0,-92.0,-89.0,-92.0,22.0,18.0,24.0,21.0,0
2834,CC:2F:71:3E:C5:1F,2636726,333753385,5177,633169,2631549,333120216,6,22212,1862589,18309,1400031,3903,462558,5464,30,7377,133,6,450,130000.0,39000.0,-69.0,-72.0,-68.0,-60.0,-68.0,-71.0,-68.0,-61.0,-90.0,-92.0,-89.0,-92.0,21.0,20.0,21.0,32.0,0
2835,CC:2F:71:3F:1F:24,6639315,6465618897,4007766,6132498681,2631549,333120216,78,831438,473378709,827523,472907041,3915,471668,803638,599,4009864,392979,78,4877,130000.0,43333.0,-70.0,-65.0,-76.0,-66.0,-70.0,-65.0,-75.0,-66.0,-90.0,-92.0,-89.0,-92.0,20.0,27.0,13.0,26.0,0
2836,F8:59:71:5A:E0:3D,2658709,374751263,27158,41630845,2631551,333120418,0,3417,420950,3302,402913,115,18037,3149,0,27185,866,0,33,130000.0,39000.0,-68.0,-74.0,-65.0,-71.0,-68.0,-74.0,-66.0,-71.0,-90.0,-92.0,-89.0,-92.0,22.0,18.0,24.0,21.0,0
2837,CC:2F:71:3E:C5:1F,2636728,333753587,5177,633169,2631551,333120418,6,22212,1862589,18309,1400031,3903,462558,5464,30,7377,133,6,450,130000.0,39000.0,-69.0,-72.0,-68.0,-60.0,-68.0,-71.0,-68.0,-61.0,-90.0,-92.0,-89.0,-92.0,21.0,20.0,21.0,32.0,0
2838,CC:2F:71:3F:1F:24,6639349,6465629395,4007798,6132508977,2631551,333120418,78,831456,473381823,827541,472910155,3915,471668,803655,599,4009896,393007,78,4877,117000.0,39000.0,-70.0,-66.0,-74.0,-67.0,-70.0,-66.0,-75.0,-67.0,-90.0,-92.0,-89.0,-92.0,20.0,26.0,15.0,25.0,0
2839,F8:59:71:5A:E0:3D,2658715,374751869,27158,41630845,2631557,333121024,0,3417,420950,3302,402913,115,18037,3149,0,27185,866,0,33,130000.0,39000.0,-68.0,-74.0,-65.0,-71.0,-68.0,-74.0,-66.0,-71.0,-90.0,-92.0,-89.0,-92.0,22.0,18.0,24.0,21.0,0
2840,CC:2F:71:3E:C5:1F,2636735,333754255,5177,633169,2631558,333121086,6,22213,1862707,18309,1400031,3904,462676,5465,30,7377,133,6,450,130000.0,39000.0,-70.0,-70.0,-70.0,-60.0,-69.0,-71.0,-68.0,-61.0,-90.0,-92.0,-89.0,-92.0,20.0,22.0,19.0,32.0,0
2841,CC:2F:71:3F:1F:24,6639387,6465640285,4007829,6132519199,2631558,333121086,78,831474,473384937,827559,472913269,3915,471668,803672,599,4009927,393011,78,4877,130000.0,43333.0,-72.0,-65.0,-75.0,-67.0,-72.0,-65.0,-74.0,-66.0,-90.0,-92.0,-89.0,-92.0,18.0,27.0,14.0,25.0,0
2842,F8:59:71:5A:E0:3D,2658741,374763041,27158,41630845,2631583,333132196,0,3417,420950,3302,402913,115,18037,3149,0,27185,866,0,33,130000.0,39000.0,-68.0,-74.0,-65.0,-71.0,-68.0,-74.0,-66.0,-71.0,-90.0,-92.0,-89.0,-92.0,22.0,18.0,24.0,21.0,0
2843,CC:2F:71:3E:C5:1F,2636760,333765365,5177,633169,2631583,333132196,6,22214,1862777,18310,1400101,3904,462676,5465,30,7377,133,6,450,130000.0,39000.0,-70.0,-71.0,-69.0,-60.0,-69.0,-71.0,-68.0,-61.0,-90.0,-92.0,-89.0,-92.0,20.0,21.0,20.0,32.0,0
2844,CC:2F:71:3F:1F:24,6639443,6465661745,4007860,6132529549,2631583,333132196,78,831497,473388643,827582,472916975,3915,471668,803694,599,4009958,393026,78,4877,117000.0,39000.0,-72.0,-65.0,-75.0,-68.0,-73.0,-65.0,-75.0,-68.0,-90.0,-92.0,-89.0,-92.0,18.0,27.0,14.0,24.0,0
2845,F8:59:71:5A:E0:3D,2658747,374763647,27158,41630845,2631589,333132802,0,3417,420950,3302,402913,115,18037,3149,0,27185,866,0,33,130000.0,39000.0,-68.0,-74.0,-65.0,-71.0,-68.0,-74.0,-66.0,-71.0,-90.0,-92.0,-89.0,-92.0,22.0,18.0,24.0,21.0,0
2846,CC:2F:71:3E:C5:1F,2636766,333765971,5177,633169,2631589,333132802,6,22214,1862777,18310,1400101,3904,462676,5465,30,7377,133,6,450,130000.0,39000.0,-70.0,-71.0,-69.0,-60.0,-69.0,-71.0,-68.0,-61.0,-90.0,-92.0,-89.0,-92.0,20.0,21.0,20.0,32.0,0
2847,CC:2F:71:3F:1F:24,6639480,6465672573,4007891,6132539771,2631589,333132802,78,831514,473391641,827599,472919973,3915,471668,803710,599,4009989,393031,78,4877,130000.0,43333.0,-79.0,-71.0,-82.0,-74.0,-77.0,-69.0,-80.0,-72.0,-90.0,-92.0,-89.0,-92.0,11.0,21.0,7.0,18.0,0
2848,F8:59:71:5A:E0:3D,2658749,374763849,27158,41630845,2631591,333133004,0,3419,421090,3304,403053,115,18037,3149,0,27186,866,0,33,130000.0,39000.0,-67.0,-75.0,-65.0,-73.0,-68.0,-75.0,-66.0,-72.0,-90.0,-92.0,-89.0,-92.0,23.0,17.0,24.0,19.0,0
2849,CC:2F:71:3E:C5:1F,2636768,333766173,5177,633169,2631591,333133004,6,22214,1862777,18310,1400101,3904,462676,5465,30,7377,133,6,450,130000.0,39000.0,-70.0,-71.0,-69.0,-60.0,-69.0,-71.0,-68.0,-61.0,-90.0,-92.0,-89.0,-92.0,20.0,21.0,20.0,32.0,0
2850,CC:2F:71:3F:1F:24,6639513,6465682997,4007922,6132549993,2631591,333133004,78,831531,473394639,827616,472922971,3915,471668,803726,599,4010020,393063,78,4877,117000.0,39000.0,-73.0,-65.0,-76.0,-68.0,-79.0,-71.0,-81.0,-74.0,-90.0,-92.0,-89.0,-92.0,17.0,27.0,13.0,24.0,0
2851,F8:59:71:5A:E0:3D,2658756,374764515,27158,41630845,2631598,333133670,0,3419,421090,3304,403053,115,18037,3149,0,27186,866,0,33,130000.0,39000.0,-67.0,-75.0,-65.0,-73.0,-68.0,-75.0,-66.0,-72.0,-90.0,-92.0,-89.0,-92.0,23.0,17.0,24.0,19.0,0
2852,CC:2F:71:3E:C5:1F,2636775,333766839,5177,633169,2631598,333133670,6,22214,1862777,18310,1400101,3904,462676,5465,30,7377,133,6,450,130000.0,39000.0,-70.0,-71.0,-69.0,-60.0,-69.0,-71.0,-68.0,-61.0,-90.0,-92.0,-89.0,-92.0,20.0,21.0,20.0,32.0,0
2853,CC:2F:71:3F:1F:24,6639552,6465694015,4007954,6132560345,2631598,333133670,78,831549,473397753,827634,472926085,3915,471668,803743,599,4010052,393108,78,4877,130000.0,39000.0,-83.0,-77.0,-85.0,-79.0,-78.0,-70.0,-80.0,-73.0,-90.0,-92.0,-89.0,-92.0,7.0,15.0,4.0,13.0,0
2854,F8:59:71:5A:E0:3D,2658758,374764717,27158,41630845,2631600,333133872,0,3419,421090,3304,403053,115,18037,3149,0,27186,866,0,33,130000.0,39000.0,-67.0,-75.0,-65.0,-73.0,-68.0,-75.0,-66.0,-72.0,-90.0,-92.0,-89.0,-92.0,23.0,17.0,24.0,19.0,0
2855,CC:2F:71:3E:C5:1F,2636777,333767041,5177,633169,2631600,333133872,6,22214,1862777,18310,1400101,3904,462676,5465,30,7377,133,6,450,130000.0,39000.0,-70.0,-71.0,-69.0,-60.0,-69.0,-71.0,-68.0,-61.0,-90.0,-92.0,-89.0,-92.0,20.0,21.0,20.0,32.0,0
2856,CC:2F:71:3F:1F:24,6639585,6465704383,4007985,6132570511,2631600,333133872,78,831568,473400983,827653,472929315,3915,471668,803761,599,4010083,393133,78,4877,104000.0,26000.0,-73.0,-64.0,-75.0,-67.0,-72.0,-64.0,-75.0,-67.0,-90.0,-92.0,-89.0,-92.0,17.0,28.0,14.0,25.0,0
2857,F8:59:71:5A:E0:3D,2658762,374765121,27158,41630845,2631604,333134276,0,3419,421090,3304,403053,115,18037,3149,0,27186,866,0,33,130000.0,39000.0,-67.0,-75.0,-65.0,-73.0,-68.0,-75.0,-66.0,-72.0,-90.0,-92.0,-89.0,-92.0,23.0,17.0,24.0,19.0,0
2858,CC:2F:71:3E:C5:1F,2636781,333767445,5177,633169,2631604,333134276,6,22214,1862777,18310,1400101,3904,462676,5465,30,7377,133,6,450,130000.0,39000.0,-70.0,-71.0,-69.0,-60.0,-69.0,-71.0,-68.0,-61.0,-90.0,-92.0,-89.0,-92.0,20.0,21.0,20.0,32.0,0
2859,CC:2F:71:3F:1F:24,6639622,6465715155,4008016,6132580677,2631606,333134478,78,831585,473403981,827670,472932313,3915,471668,803777,599,4010114,393133,78,4877,104000.0,26000.0,-72.0,-64.0,-75.0,-67.0,-72.0,-64.0,-75.0,-67.0,-90.0,-92.0,-89.0,-92.0,18.0,28.0,14.0,25.0,0
2860,F8:59:71:5A:E0:3D,2658767,374765585,27158,41630845,2631609,333134740,0,3419,421090,3304,403053,115,18037,3149,0,27186,866,0,33,130000.0,39000.0,-67.0,-75.0,-65.0,-73.0,-68.0,-75.0,-66.0,-72.0,-90.0,-92.0,-89.0,-92.0,23.0,17.0,24.0,19.0,0
2861,CC:2F:71:3E:C5:1F,2636786,333767909,5177,633169,2631609,333134740,6,22214,1862777,18310,1400101,3904,462676,5465,30,7377,133,6,450,130000.0,39000.0,-70.0,-71.0,-69.0,-60.0,-69.0,-71.0,-68.0,-61.0,-90.0,-92.0,-89.0,-92.0,20.0,21.0,20.0,32.0,0
2862,CC:2F:71:3F:1F:24,6639655,6465725565,4008046,6132590825,2631609,333134740,78,831602,473406979,827687,472935311,3915,471668,803793,599,4010144,393133,78,4877,115556.0,26000.0,-72.0,-64.0,-75.0,-67.0,-72.0,-64.0,-75.0,-67.0,-90.0,-92.0,-89.0,-92.0,18.0,28.0,14.0,25.0,0
2863,F8:59:71:5A:E0:3D,2658770,374766060,27158,41630845,2631612,333135215,0,3419,421090,3304,403053,115,18037,3149,0,27186,866,0,33,130000.0,39000.0,-67.0,-75.0,-65.0,-73.0,-68.0,-75.0,-66.0,-72.0,-90.0,-92.0,-89.0,-92.0,23.0,17.0,24.0,19.0,0
2864,CC:2F:71:3E:C5:1F,2636791,333768586,5177,633169,2631614,333135417,6,22214,1862777,18310,1400101,3904,462676,5465,30,7377,133,6,450,130000.0,39000.0,-70.0,-71.0,-69.0,-60.0,-69.0,-71.0,-68.0,-61.0,-90.0,-92.0,-89.0,-92.0,20.0,21.0,20.0,32.0,0
2865,CC:2F:71:3F:1F:24,6639691,6465736408,4008077,6132600991,2631614,333135417,78,831622,473410325,827707,472938657,3915,471668,803812,599,4010175,393145,78,4877,104000.0,26000.0,-73.0,-65.0,-76.0,-68.0,-72.0,-65.0,-75.0,-67.0,-90.0,-92.0,-89.0,-92.0,17.0,27.0,13.0,24.0,0
2866,F8:59:71:5A:E0:3D,2658776,374766666,27158,41630845,2631618,333135821,0,3419,421090,3304,403053,115,18037,3149,0,27186,866,0,33,130000.0,39000.0,-67.0,-75.0,-65.0,-73.0,-68.0,-75.0,-66.0,-72.0,-90.0,-92.0,-89.0,-92.0,23.0,17.0,24.0,19.0,0
2867,CC:2F:71:3E:C5:1F,2636795,333768990,5177,633169,2631618,333135821,6,22214,1862777,18310,1400101,3904,462676,5465,30,7377,133,6,450,130000.0,39000.0,-70.0,-71.0,-69.0,-60.0,-69.0,-71.0,-68.0,-61.0,-90.0,-92.0,-89.0,-92.0,20.0,21.0,20.0,32.0,0
2868,CC:2F:71:3F:1F:24,6639726,6465747090,4008108,6132611269,2631618,333135821,78,831642,473413671,827727,472942003,3915,471668,803831,599,4010206,393145,78,4877,115556.0,28889.0,-73.0,-65.0,-75.0,-67.0,-72.0,-64.0,-75.0,-67.0,-90.0,-92.0,-89.0,-92.0,17.0,27.0,14.0,25.0,0
2869,F8:59:71:5A:E0:3D,2658779,374766928,27158,41630845,2631621,333136083,0,3419,421090,3304,403053,115,18037,3149,0,27186,866,0,33,130000.0,39000.0,-67.0,-75.0,-65.0,-73.0,-68.0,-75.0,-66.0,-72.0,-90.0,-92.0,-89.0,-92.0,23.0,17.0,24.0,19.0,0
2870,CC:2F:71:3E:C5:1F,2636798,333769252,5177,633169,2631621,333136083,6,22214,1862777,18310,1400101,3904,462676,5465,30,7377,133,6,450,130000.0,39000.0,-70.0,-71.0,-69.0,-60.0,-69.0,-71.0,-68.0,-61.0,-90.0,-92.0,-89.0,-92.0,20.0,21.0,20.0,32.0,0
2871,CC:2F:71:3F:1F:24,6639760,6465757518,4008139,6132621435,2631621,333136083,78,831660,473416785,827745,472945117,3915,471668,803848,599,4010237,393164,78,4877,104000.0,26000.0,-73.0,-65.0,-76.0,-68.0,-72.0,-65.0,-75.0,-67.0,-90.0,-92.0,-89.0,-92.0,17.0,27.0,13.0,24.0,0
2872,F8:59:71:5A:E0:3D,2658783,374767332,27158,41630845,2631625,333136487,0,3419,421090,3304,403053,115,18037,3149,0,27186,866,0,33,130000.0,39000.0,-67.0,-75.0,-65.0,-73.0,-68.0,-75.0,-66.0,-72.0,-90.0,-93.0,-90.0,-93.0,23.0,18.0,25.0,20.0,0
2873,CC:2F:71:3E:C5:1F,2636802,333769656,5177,633169,2631625,333136487,6,22214,1862777,18310,1400101,3904,462676,5465,30,7377,133,6,450,130000.0,39000.0,-70.0,-71.0,-69.0,-60.0,-69.0,-71.0,-68.0,-61.0,-90.0,-93.0,-90.0,-93.0,20.0,22.0,21.0,33.0,0
2874,CC:2F:71:3F:1F:24,6639798,6465768532,4008171,6132631843,2631627,333136689,78,831679,473420015,827764,472948347,3915,471668,803866,599,4010269,393164,78,4877,115556.0,26000.0,-72.0,-65.0,-75.0,-67.0,-72.0,-64.0,-75.0,-67.0,-90.0,-93.0,-90.0,-93.0,18.0,28.0,15.0,26.0,0
2875,F8:59:71:5A:E0:3D,2658785,374767534,27158,41630845,2631627,333136689,0,3419,421090,3304,403053,115,18037,3149,0,27186,866,0,33,130000.0,39000.0,-67.0,-75.0,-65.0,-73.0,-68.0,-75.0,-66.0,-72.0,-90.0,-93.0,-90.0,-93.0,23.0,18.0,25.0,20.0,0
2876,CC:2F:71:3E:C5:1F,2636804,333769858,5177,633169,2631627,333136689,6,22214,1862777,18310,1400101,3904,462676,5465,30,7377,133,6,450,130000.0,39000.0,-70.0,-71.0,-69.0,-60.0,-69.0,-71.0,-68.0,-61.0,-90.0,-93.0,-90.0,-93.0,20.0,22.0,21.0,33.0,0
2877,CC:2F:71:3F:1F:24,6639831,6465778956,4008202,6132642065,2631629,333136891,78,831696,473423013,827781,472951345,3915,471668,803882,599,4010300,393169,78,4877,117000.0,39000.0,-71.0,-65.0,-75.0,-67.0,-71.0,-64.0,-75.0,-66.0,-90.0,-93.0,-90.0,-93.0,19.0,28.0,15.0,26.0,0
2878,F8:59:71:5A:E0:3D,2658792,374768200,27158,41630845,2631634,333137355,0,3419,421090,3304,403053,115,18037,3149,0,27186,866,0,33,130000.0,39000.0,-67.0,-75.0,-65.0,-73.0,-68.0,-75.0,-66.0,-72.0,-90.0,-93.0,-90.0,-93.0,23.0,18.0,25.0,20.0,0
2879,CC:2F:71:3E:C5:1F,2636811,333770524,5177,633169,2631634,333137355,6,22214,1862777,18310,1400101,3904,462676,5465,30,7377,133,6,450,130000.0,39000.0,-70.0,-71.0,-69.0,-60.0,-69.0,-71.0,-68.0,-61.0,-90.0,-93.0,-90.0,-93.0,20.0,22.0,21.0,33.0,0
2880,CC:2F:71:3F:1F:24,6639867,6465789698,4008233,6132652343,2631634,333137355,78,831713,473426011,827798,472954343,3915,471668,803898,599,4010331,393178,78,4877,104000.0,26000.0,-72.0,-65.0,-75.0,-67.0,-71.0,-64.0,-74.0,-66.0,-90.0,-93.0,-90.0,-93.0,18.0,28.0,15.0,26.0,0
2881,F8:59:71:5A:E0:3D,2658794,374768402,27158,41630845,2631636,333137557,0,3419,421090,3304,403053,115,18037,3149,0,27186,866,0,33,130000.0,39000.0,-67.0,-75.0,-65.0,-73.0,-68.0,-75.0,-66.0,-72.0,-90.0,-93.0,-90.0,-93.0,23.0,18.0,25.0,20.0,0
2882,CC:2F:71:3E:C5:1F,2636813,333770726,5177,633169,2631636,333137557,6,22214,1862777,18310,1400101,3904,462676,5465,30,7377,133,6,450,130000.0,39000.0,-70.0,-71.0,-69.0,-60.0,-69.0,-71.0,-68.0,-61.0,-90.0,-93.0,-90.0,-93.0,20.0,22.0,21.0,33.0,0
2883,CC:2F:71:3F:1F:24,6639900,6465800122,4008264,6132662565,2631636,333137557,78,831730,473429009,827815,472957341,3915,471668,803914,599,4010362,393184,78,4877,115556.0,28889.0,-72.0,-65.0,-75.0,-67.0,-71.0,-64.0,-75.0,-66.0,-90.0,-93.0,-90.0,-93.0,18.0,28.0,15.0,26.0,0
2884,F8:59:71:5A:E0:3D,2658800,374769008,27158,41630845,2631642,333138163,0,3419,421090,3304,403053,115,18037,3149,0,27186,866,0,33,130000.0,39000.0,-67.0,-75.0,-65.0,-73.0,-68.0,-75.0,-66.0,-72.0,-90.0,-93.0,-90.0,-93.0,23.0,18.0,25.0,20.0,0
2885,CC:2F:71:3E:C5:1F,2636819,333771332,5177,633169,2631642,333138163,6,22214,1862777,18310,1400101,3904,462676,5465,30,7377,133,6,450,130000.0,39000.0,-70.0,-71.0,-69.0,-60.0,-69.0,-71.0,-68.0,-61.0,-90.0,-93.0,-90.0,-93.0,20.0,22.0,21.0,33.0,0
2886,CC:2F:71:3F:1F:24,6639938,6465811066,4008295,6132672843,2631643,333138223,78,831748,473432123,827833,472960455,3915,471668,803931,599,4010393,393194,78,4877,117000.0,39000.0,-72.0,-65.0,-75.0,-67.0,-71.0,-64.0,-75.0,-66.0,-90.0,-93.0,-90.0,-93.0,18.0,28.0,15.0,26.0,0
2887,F8:59:71:5A:E0:3D,2658803,374769270,27158,41630845,2631645,333138425,0,3419,421090,3304,403053,115,18037,3149,0,27186,866,0,33,130000.0,39000.0,-67.0,-75.0,-65.0,-73.0,-68.0,-75.0,-66.0,-72.0,-90.0,-93.0,-90.0,-93.0,23.0,18.0,25.0,20.0,0
2888,CC:2F:71:3E:C5:1F,2636822,333771594,5177,633169,2631645,333138425,6,22214,1862777,18310,1400101,3904,462676,5465,30,7377,133,6,450,130000.0,39000.0,-70.0,-71.0,-69.0,-60.0,-69.0,-71.0,-68.0,-61.0,-90.0,-93.0,-90.0,-93.0,20.0,22.0,21.0,33.0,0
2889,CC:2F:71:3F:1F:24,6639971,6465821490,4008326,6132683065,2631645,333138425,78,831765,473435121,827850,472963453,3915,471668,803947,599,4010424,393199,78,4877,115556.0,26000.0,-72.0,-64.0,-75.0,-66.0,-71.0,-64.0,-75.0,-66.0,-90.0,-93.0,-90.0,-93.0,18.0,29.0,15.0,27.0,0
2890,F8:59:71:5A:E0:3D,2658809,374769876,27158,41630845,2631651,333139031,0,3419,421090,3304,403053,115,18037,3149,0,27186,866,0,33,130000.0,39000.0,-67.0,-75.0,-65.0,-73.0,-68.0,-75.0,-66.0,-72.0,-90.0,-93.0,-90.0,-93.0,23.0,18.0,25.0,20.0,0
2891,CC:2F:71:3E:C5:1F,2636828,333772200,5177,633169,2631651,333139031,6,22214,1862777,18310,1400101,3904,462676,5465,30,7377,133,6,450,130000.0,39000.0,-70.0,-71.0,-69.0,-60.0,-69.0,-71.0,-68.0,-61.0,-90.0,-93.0,-90.0,-93.0,20.0,22.0,21.0,33.0,0
2892,CC:2F:71:3F:1F:24,6640009,6465832504,4008358,6132693473,2631651,333139031,78,831784,473438351,827869,472966683,3915,471668,803965,599,4010456,393199,78,4877,115556.0,28889.0,-71.0,-64.0,-75.0,-67.0,-71.0,-64.0,-75.0,-66.0,-90.0,-93.0,-90.0,-93.0,19.0,29.0,15.0,26.0,0
2893,F8:59:71:5A:E0:3D,2658811,374770078,27158,41630845,2631653,333139233,0,3419,421090,3304,403053,115,18037,3149,0,27186,866,0,33,130000.0,39000.0,-67.0,-75.0,-65.0,-73.0,-68.0,-75.0,-66.0,-72.0,-90.0,-93.0,-90.0,-93.0,23.0,18.0,25.0,20.0,0
2894,CC:2F:71:3E:C5:1F,2636831,333772462,5177,633169,2631654,333139293,6,22214,1862777,18310,1400101,3904,462676,5465,30,7377,133,6,450,130000.0,39000.0,-70.0,-71.0,-69.0,-60.0,-69.0,-71.0,-68.0,-61.0,-90.0,-93.0,-90.0,-93.0,20.0,22.0,21.0,33.0,0
2895,CC:2F:71:3F:1F:24,6640044,6465843104,4008390,6132703811,2631654,333139293,78,831802,473441465,827887,472969797,3915,471668,803982,599,4010488,393215,78,4877,104000.0,26000.0,-71.0,-65.0,-74.0,-66.0,-71.0,-65.0,-74.0,-66.0,-90.0,-93.0,-90.0,-93.0,19.0,28.0,16.0,27.0,0
2896,F8:59:71:5A:E0:3D,2658815,374770456,27159,41630961,2631656,333139495,0,3421,421230,3306,403193,115,18037,3149,0,27187,866,0,33,144444.0,39000.0,-67.0,-75.0,-65.0,-72.0,-68.0,-75.0,-66.0,-72.0,-90.0,-93.0,-90.0,-93.0,23.0,18.0,25.0,21.0,0
2897,CC:2F:71:3E:C5:1F,2636836,333772982,5178,633285,2631658,333139697,6,22216,1862917,18312,1400241,3904,462676,5465,30,7378,133,6,450,130000.0,39000.0,-70.0,-71.0,-69.0,-60.0,-69.0,-71.0,-68.0,-61.0,-90.0,-93.0,-90.0,-93.0,20.0,22.0,21.0,33.0,0
2898,CC:2F:71:3F:1F:24,6640079,6465853786,4008421,6132714089,2631658,333139697,78,831821,473444695,827906,472973027,3915,471668,804000,599,4010519,393215,78,4877,115556.0,28889.0,-71.0,-65.0,-74.0,-66.0,-71.0,-65.0,-74.0,-66.0,-90.0,-93.0,-90.0,-93.0,19.0,28.0,16.0,27.0,0
2899,F8:59:71:5A:E0:3D,2658820,374770922,27159,41630961,2631661,333139961,0,3421,421230,3306,403193,115,18037,3149,0,27187,866,0,33,144444.0,39000.0,-67.0,-75.0,-65.0,-72.0,-68.0,-75.0,-66.0,-72.0,-90.0,-93.0,-90.0,-93.0,23.0,18.0,25.0,21.0,0
2900,CC:2F:71:3E:C5:1F,2636839,333773246,5178,633285,2631661,333139961,6,22216,1862917,18312,1400241,3904,462676,5465,30,7378,133,6,450,130000.0,39000.0,-70.0,-71.0,-69.0,-60.0,-69.0,-71.0,-68.0,-61.0,-90.0,-93.0,-90.0,-93.0,20.0,22.0,21.0,33.0,0
2901,CC:2F:71:3F:1F:24,6640116,6465864788,4008453,6132724625,2631663,333140163,78,831844,473448357,827928,472976571,3916,471786,804021,599,4010551,393215,78,4877,115556.0,28889.0,-71.0,-66.0,-75.0,-68.0,-71.0,-65.0,-75.0,-67.0,-90.0,-93.0,-90.0,-93.0,19.0,27.0,15.0,25.0,0
2902,F8:59:71:5A:E0:3D,2658825,374771386,27159,41630961,2631666,333140425,0,3421,421230,3306,403193,115,18037,3149,0,27187,866,0,33,144444.0,39000.0,-67.0,-75.0,-65.0,-72.0,-68.0,-75.0,-66.0,-72.0,-90.0,-93.0,-90.0,-93.0,23.0,18.0,25.0,21.0,0
2903,CC:2F:71:3E:C5:1F,2636844,333773710,5178,633285,2631666,333140425,6,22216,1862917,18312,1400241,3904,462676,5465,30,7378,133,6,450,130000.0,39000.0,-70.0,-71.0,-69.0,-60.0,-69.0,-71.0,-68.0,-61.0,-90.0,-93.0,-90.0,-93.0,20.0,22.0,21.0,33.0,0
2904,CC:2F:71:3F:1F:24,6640150,6465875272,4008484,6132734847,2631666,333140425,78,831861,473451355,827945,472979569,3916,471786,804037,599,4010582,393232,78,4877,104000.0,26000.0,-71.0,-65.0,-75.0,-67.0,-71.0,-65.0,-75.0,-67.0,-90.0,-93.0,-90.0,-93.0,19.0,28.0,15.0,26.0,0
2905,F8:59:71:5A:E0:3D,2658829,374771790,27159,41630961,2631670,333140829,0,3421,421230,3306,403193,115,18037,3149,0,27187,866,0,33,144444.0,39000.0,-67.0,-75.0,-65.0,-72.0,-68.0,-75.0,-66.0,-72.0,-90.0,-93.0,-90.0,-93.0,23.0,18.0,25.0,21.0,0
2906,CC:2F:71:3E:C5:1F,2636848,333774114,5178,633285,2631670,333140829,6,22216,1862917,18312,1400241,3904,462676,5465,30,7378,133,6,450,130000.0,39000.0,-70.0,-71.0,-69.0,-60.0,-69.0,-71.0,-68.0,-61.0,-90.0,-93.0,-90.0,-93.0,20.0,22.0,21.0,33.0,0
2907,CC:2F:71:3F:1F:24,6640185,6465885954,4008515,6132745125,2631670,333140829,78,831878,473454353,827962,472982567,3916,471786,804053,599,4010613,393234,78,4877,115556.0,26000.0,-71.0,-65.0,-74.0,-67.0,-71.0,-65.0,-74.0,-67.0,-90.0,-93.0,-90.0,-93.0,19.0,28.0,16.0,26.0,0
2908,F8:59:71:5A:E0:3D,2658835,374772529,27159,41630961,2631676,333141568,0,3422,421348,3306,403193,116,18155,3150,0,27187,866,0,33,144444.0,39000.0,-67.0,-75.0,-65.0,-72.0,-67.0,-74.0,-65.0,-72.0,-90.0,-93.0,-90.0,-93.0,23.0,18.0,25.0,21.0,0
2909,CC:2F:71:3E:C5:1F,2636854,333774853,5178,633285,2631676,333141568,6,22216,1862917,18312,1400241,3904,462676,5465,30,7378,133,6,450,130000.0,39000.0,-70.0,-71.0,-69.0,-60.0,-69.0,-71.0,-68.0,-61.0,-90.0,-93.0,-90.0,-93.0,20.0,22.0,21.0,33.0,0
2910,CC:2F:71:3F:1F:24,6640222,6465896955,4008546,6132755387,2631676,333141568,78,831895,473457351,827979,472985565,3916,471786,804069,599,4010644,393238,78,4877,115556.0,28889.0,-80.0,-75.0,-83.0,-76.0,-77.0,-71.0,-80.0,-72.0,-90.0,-93.0,-90.0,-93.0,10.0,18.0,7.0,17.0,0
2911,F8:59:71:5A:E0:3D,2658840,374772993,27159,41630961,2631681,333142032,0,3423,421418,3307,403263,116,18155,3150,0,27187,866,0,33,144444.0,39000.0,-67.0,-73.0,-65.0,-70.0,-67.0,-74.0,-65.0,-71.0,-90.0,-93.0,-90.0,-93.0,23.0,20.0,25.0,23.0,0
2912,CC:2F:71:3E:C5:1F,2636859,333775317,5178,633285,2631681,333142032,6,22216,1862917,18312,1400241,3904,462676,5465,30,7378,133,6,450,130000.0,39000.0,-70.0,-71.0,-69.0,-60.0,-69.0,-71.0,-68.0,-61.0,-90.0,-93.0,-90.0,-93.0,20.0,22.0,21.0,33.0,0
2913,CC:2F:71:3F:1F:24,6640259,6465907771,4008578,6132765739,2631681,333142032,78,831912,473460349,827996,472988563,3916,471786,804085,599,4010676,393252,78,4877,104000.0,26000.0,-72.0,-66.0,-75.0,-67.0,-72.0,-67.0,-75.0,-68.0,-90.0,-93.0,-90.0,-93.0,18.0,27.0,15.0,26.0,0
2914,F8:59:71:5A:E0:3D,2658842,374773195,27159,41630961,2631683,333142234,0,3423,421418,3307,403263,116,18155,3150,0,27187,866,0,33,144444.0,39000.0,-67.0,-73.0,-65.0,-70.0,-67.0,-74.0,-65.0,-71.0,-90.0,-93.0,-90.0,-93.0,23.0,20.0,25.0,23.0,0
2915,CC:2F:71:3E:C5:1F,2636861,333775519,5178,633285,2631683,333142234,6,22216,1862917,18312,1400241,3904,462676,5465,30,7378,133,6,450,130000.0,39000.0,-70.0,-71.0,-69.0,-60.0,-69.0,-71.0,-68.0,-61.0,-90.0,-93.0,-90.0,-93.0,20.0,22.0,21.0,33.0,0
2916,CC:2F:71:3F:1F:24,6640293,6465918323,4008608,6132775887,2631685,333142436,78,831929,473463347,828013,472991561,3916,471786,804101,599,4010706,393253,78,4877,115556.0,26000.0,-71.0,-65.0,-75.0,-67.0,-70.0,-65.0,-75.0,-67.0,-90.0,-93.0,-90.0,-93.0,19.0,28.0,15.0,26.0,0
2917,F8:59:71:5A:E0:3D,2658848,374773801,27159,41630961,2631689,333142840,0,3423,421418,3307,403263,116,18155,3150,0,27187,866,0,33,144444.0,39000.0,-67.0,-73.0,-65.0,-70.0,-67.0,-74.0,-65.0,-71.0,-90.0,-93.0,-90.0,-93.0,23.0,20.0,25.0,23.0,0
2918,CC:2F:71:3E:C5:1F,2636867,333776125,5178,633285,2631689,333142840,6,22216,1862917,18312,1400241,3904,462676,5465,30,7378,133,6,450,130000.0,39000.0,-70.0,-71.0,-69.0,-60.0,-69.0,-71.0,-68.0,-61.0,-90.0,-93.0,-90.0,-93.0,20.0,22.0,21.0,33.0,0
2919,CC:2F:71:3F:1F:24,6640328,6465929005,4008639,6132786165,2631689,333142840,78,831947,473466461,828031,472994675,3916,471786,804118,599,4010737,393256,78,4877,115556.0,28889.0,-71.0,-65.0,-75.0,-67.0,-71.0,-65.0,-74.0,-67.0,-90.0,-93.0,-90.0,-93.0,19.0,28.0,15.0,26.0,0
2920,F8:59:71:5A:E0:3D,2658851,374774063,27159,41630961,2631692,333143102,0,3423,421418,3307,403263,116,18155,3150,0,27187,866,0,33,144444.0,39000.0,-67.0,-73.0,-65.0,-70.0,-67.0,-74.0,-65.0,-71.0,-90.0,-93.0,-90.0,-93.0,23.0,20.0,25.0,23.0,0
2921,CC:2F:71:3E:C5:1F,2636870,333776387,5178,633285,2631692,333143102,6,22216,1862917,18312,1400241,3904,462676,5465,30,7378,133,6,450,130000.0,39000.0,-70.0,-71.0,-69.0,-60.0,-69.0,-71.0,-68.0,-61.0,-90.0,-93.0,-90.0,-93.0,20.0,22.0,21.0,33.0,0
2922,CC:2F:71:3F:1F:24,6640362,6465939489,4008670,6132796387,2631692,333143102,78,831965,473469575,828049,472997789,3916,471786,804135,599,4010768,393272,78,4877,104000.0,26000.0,-71.0,-65.0,-74.0,-67.0,-71.0,-65.0,-74.0,-67.0,-90.0,-93.0,-90.0,-93.0,19.0,28.0,16.0,26.0,0
2923,F8:59:71:5A:E0:3D,2658857,374774669,27159,41630961,2631698,333143708,0,3423,421418,3307,403263,116,18155,3150,0,27187,866,0,33,144444.0,39000.0,-67.0,-73.0,-65.0,-70.0,-67.0,-74.0,-65.0,-71.0,-90.0,-93.0,-90.0,-93.0,23.0,20.0,25.0,23.0,0
2924,CC:2F:71:3E:C5:1F,2636876,333776993,5178,633285,2631698,333143708,6,22216,1862917,18312,1400241,3904,462676,5465,30,7378,133,6,450,130000.0,39000.0,-70.0,-71.0,-69.0,-60.0,-69.0,-71.0,-68.0,-61.0,-90.0,-93.0,-90.0,-93.0,20.0,22.0,21.0,33.0,0
2925,CC:2F:71:3F:1F:24,6640399,6465950317,4008701,6132806609,2631698,333143708,78,831982,473472573,828066,473000787,3916,471786,804151,599,4010799,393272,78,4877,115556.0,28889.0,-72.0,-66.0,-75.0,-67.0,-71.0,-65.0,-75.0,-67.0,-90.0,-93.0,-90.0,-93.0,18.0,27.0,15.0,26.0,0
2926,F8:59:71:5A:E0:3D,2658859,374774871,27159,41630961,2631700,333143910,0,3423,421418,3307,403263,116,18155,3150,0,27187,866,0,33,144444.0,39000.0,-67.0,-73.0,-65.0,-70.0,-67.0,-74.0,-65.0,-71.0,-90.0,-93.0,-90.0,-93.0,23.0,20.0,25.0,23.0,0
2927,CC:2F:71:3E:C5:1F,2636878,333777195,5178,633285,2631700,333143910,6,22216,1862917,18312,1400241,3904,462676,5465,30,7378,133,6,450,130000.0,39000.0,-70.0,-71.0,-69.0,-60.0,-69.0,-71.0,-68.0,-61.0,-90.0,-93.0,-90.0,-93.0,20.0,22.0,21.0,33.0,0
2928,CC:2F:71:3F:1F:24,6640431,6465960723,4008731,6132816813,2631700,333143910,78,831999,473475571,828083,473003785,3916,471786,804167,599,4010829,393276,78,4877,115556.0,28889.0,-71.0,-65.0,-75.0,-67.0,-71.0,-65.0,-74.0,-67.0,-90.0,-93.0,-90.0,-93.0,19.0,28.0,15.0,26.0,0
2929,F8:59:71:5A:E0:3D,2658868,374775905,27159,41630961,2631709,333144944,0,3423,421418,3307,403263,116,18155,3150,0,27187,866,0,33,144444.0,39000.0,-67.0,-73.0,-65.0,-70.0,-67.0,-74.0,-65.0,-71.0,-90.0,-93.0,-90.0,-93.0,23.0,20.0,25.0,23.0,0
2930,CC:2F:71:3E:C5:1F,2636887,333778229,5178,633285,2631709,333144944,6,22216,1862917,18312,1400241,3904,462676,5465,30,7378,133,6,450,130000.0,39000.0,-70.0,-71.0,-69.0,-60.0,-69.0,-71.0,-68.0,-61.0,-90.0,-93.0,-90.0,-93.0,20.0,22.0,21.0,33.0,0
2931,CC:2F:71:3F:1F:24,6640471,6465971979,4008762,6132827035,2631709,333144944,78,832017,473478685,828101,473006899,3916,471786,804184,599,4010860,393289,78,4877,104000.0,26000.0,-71.0,-65.0,-74.0,-67.0,-70.0,-65.0,-74.0,-67.0,-90.0,-93.0,-90.0,-93.0,19.0,28.0,16.0,26.0,0
2932,F8:59:71:5A:E0:3D,2658871,374776233,27159,41630961,2631712,333145272,0,3425,421558,3309,403403,116,18155,3150,0,27188,866,0,33,144444.0,39000.0,-67.0,-73.0,-65.0,-72.0,-67.0,-75.0,-66.0,-72.0,-90.0,-93.0,-90.0,-93.0,23.0,20.0,25.0,21.0,0
2933,CC:2F:71:3E:C5:1F,2636890,333778557,5178,633285,2631712,333145272,6,22218,1863057,18314,1400381,3904,462676,5465,30,7379,133,6,450,130000.0,39000.0,-77.0,-84.0,-75.0,-72.0,-70.0,-71.0,-69.0,-61.0,-90.0,-93.0,-90.0,-93.0,13.0,9.0,15.0,21.0,0
2934,CC:2F:71:3F:1F:24,6640505,6465982585,4008793,6132837313,2631712,333145272,78,832034,473481683,828118,473009897,3916,471786,804200,599,4010891,393294,78,4877,115556.0,28889.0,-71.0,-65.0,-75.0,-67.0,-71.0,-65.0,-74.0,-66.0,-90.0,-93.0,-90.0,-93.0,19.0,28.0,15.0,26.0,0
2935,F8:59:71:5A:E0:3D,2658875,374776637,27159,41630961,2631716,333145676,0,3425,421558,3309,403403,116,18155,3150,0,27188,866,0,33,144444.0,39000.0,-67.0,-73.0,-65.0,-72.0,-67.0,-75.0,-66.0,-72.0,-90.0,-93.0,-90.0,-93.0,23.0,20.0,25.0,21.0,0
2936,CC:2F:71:3E:C5:1F,2636894,333778961,5178,633285,2631716,333145676,6,22218,1863057,18314,1400381,3904,462676,5465,30,7379,133,6,450,130000.0,39000.0,-77.0,-84.0,-75.0,-72.0,-70.0,-71.0,-69.0,-61.0,-90.0,-93.0,-90.0,-93.0,13.0,9.0,15.0,21.0,0
2937,CC:2F:71:3F:1F:24,6640542,6465993413,4008824,6132847535,2631718,333145878,78,832052,473484797,828136,473013011,3916,471786,804217,599,4010922,393299,78,4877,117000.0,39000.0,-71.0,-65.0,-75.0,-67.0,-70.0,-65.0,-75.0,-66.0,-90.0,-93.0,-90.0,-93.0,19.0,28.0,15.0,26.0,0
2938,F8:59:71:5A:E0:3D,2658879,374776961,27159,41630961,2631720,333146000,0,3425,421558,3309,403403,116,18155,3150,0,27188,866,0,33,144444.0,39000.0,-67.0,-73.0,-65.0,-72.0,-67.0,-75.0,-66.0,-72.0,-90.0,-93.0,-90.0,-93.0,23.0,20.0,25.0,21.0,0
2939,CC:2F:71:3E:C5:1F,2636898,333779285,5178,633285,2631720,333146000,6,22220,1863245,18315,1400451,3905,462794,5466,30,7379,133,6,450,130000.0,39000.0,-70.0,-71.0,-69.0,-60.0,-70.0,-72.0,-69.0,-61.0,-90.0,-93.0,-90.0,-93.0,20.0,22.0,21.0,33.0,0
2940,CC:2F:71:3F:1F:24,6640577,6466003959,4008855,6132857757,2631722,333146202,78,832069,473487795,828153,473016009,3916,471786,804233,599,4010953,393311,78,4877,115556.0,26000.0,-71.0,-65.0,-75.0,-67.0,-71.0,-65.0,-74.0,-67.0,-90.0,-93.0,-90.0,-93.0,19.0,28.0,15.0,26.0,0
2941,F8:59:71:5A:E0:3D,2658883,374777365,27159,41630961,2631724,333146404,0,3425,421558,3309,403403,116,18155,3150,0,27188,866,0,33,144444.0,39000.0,-67.0,-73.0,-65.0,-72.0,-67.0,-75.0,-66.0,-72.0,-90.0,-93.0,-90.0,-93.0,23.0,20.0,25.0,21.0,0
2942,CC:2F:71:3E:C5:1F,2636904,333779891,5178,633285,2631726,333146606,6,22220,1863245,18315,1400451,3905,462794,5466,30,7379,133,6,450,130000.0,39000.0,-70.0,-71.0,-69.0,-60.0,-70.0,-72.0,-69.0,-61.0,-90.0,-93.0,-90.0,-93.0,20.0,22.0,21.0,33.0,0
2943,CC:2F:71:3F:1F:24,6640612,6466014641,4008886,6132868035,2631726,333146606,78,832089,473491141,828173,473019355,3916,471786,804252,599,4010984,393311,78,4877,115556.0,28889.0,-71.0,-65.0,-75.0,-67.0,-71.0,-65.0,-74.0,-67.0,-90.0,-93.0,-90.0,-93.0,19.0,28.0,15.0,26.0,0
2944,F8:59:71:5A:E0:3D,2658887,374777769,27159,41630961,2631728,333146808,0,3425,421558,3309,403403,116,18155,3150,0,27188,866,0,33,144444.0,39000.0,-67.0,-73.0,-65.0,-72.0,-67.0,-75.0,-66.0,-72.0,-90.0,-93.0,-90.0,-93.0,23.0,20.0,25.0,21.0,0
2945,CC:2F:71:3E:C5:1F,2636906,333780093,5178,633285,2631728,333146808,6,22220,1863245,18315,1400451,3905,462794,5466,30,7379,133,6,450,130000.0,39000.0,-70.0,-71.0,-69.0,-60.0,-70.0,-72.0,-69.0,-61.0,-90.0,-93.0,-90.0,-93.0,20.0,22.0,21.0,33.0,0
2946,CC:2F:71:3F:1F:24,6640646,6466025125,4008917,6132878257,2631729,333146868,78,832106,473494139,828190,473022353,3916,471786,804268,599,4011015,393327,78,4877,104000.0,26000.0,-71.0,-65.0,-75.0,-67.0,-71.0,-65.0,-74.0,-67.0,-90.0,-93.0,-90.0,-93.0,19.0,28.0,15.0,26.0,0
2947,F8:59:71:5A:E0:3D,2658890,374778031,27159,41630961,2631731,333147070,0,3425,421558,3309,403403,116,18155,3150,0,27188,866,0,33,144444.0,39000.0,-67.0,-73.0,-65.0,-72.0,-67.0,-75.0,-66.0,-72.0,-90.0,-93.0,-90.0,-93.0,23.0,20.0,25.0,21.0,0
2948,CC:2F:71:3E:C5:1F,2636911,333780557,5178,633285,2631733,333147272,6,22220,1863245,18315,1400451,3905,462794,5466,30,7379,133,6,450,130000.0,39000.0,-70.0,-71.0,-69.0,-60.0,-70.0,-72.0,-69.0,-61.0,-90.0,-93.0,-90.0,-93.0,20.0,22.0,21.0,33.0,0
2949,CC:2F:71:3F:1F:24,6640682,6466035937,4008949,6132888665,2631733,333147272,78,832123,473497137,828207,473025351,3916,471786,804284,599,4011047,393332,78,4877,115556.0,26000.0,-71.0,-65.0,-75.0,-67.0,-71.0,-65.0,-74.0,-66.0,-90.0,-93.0,-90.0,-93.0,19.0,28.0,15.0,26.0,0
2950,F8:59:71:5A:E0:3D,2658897,374778910,27159,41630961,2631738,333147949,0,3425,421558,3309,403403,116,18155,3150,0,27188,866,0,33,144444.0,39000.0,-67.0,-73.0,-65.0,-72.0,-67.0,-75.0,-66.0,-72.0,-90.0,-93.0,-90.0,-93.0,23.0,20.0,25.0,21.0,0
2951,CC:2F:71:3E:C5:1F,2636916,333781234,5178,633285,2631738,333147949,6,22220,1863245,18315,1400451,3905,462794,5466,30,7379,133,6,450,130000.0,39000.0,-70.0,-71.0,-69.0,-60.0,-70.0,-72.0,-69.0,-61.0,-90.0,-93.0,-90.0,-93.0,20.0,22.0,21.0,33.0,0
2952,CC:2F:71:3F:1F:24,6640718,6466046892,4008980,6132898943,2631738,333147949,78,832140,473500135,828224,473028349,3916,471786,804300,599,4011078,393335,78,4877,115556.0,28889.0,-72.0,-65.0,-75.0,-67.0,-71.0,-65.0,-74.0,-67.0,-90.0,-93.0,-90.0,-93.0,18.0,28.0,15.0,26.0,0
2953,F8:59:71:5A:E0:3D,2658900,374779172,27159,41630961,2631741,333148211,0,3425,421558,3309,403403,116,18155,3150,0,27188,866,0,33,144444.0,39000.0,-67.0,-73.0,-65.0,-72.0,-67.0,-75.0,-66.0,-72.0,-90.0,-93.0,-90.0,-93.0,23.0,20.0,25.0,21.0,0
2954,CC:2F:71:3E:C5:1F,2636919,333781496,5178,633285,2631741,333148211,6,22220,1863245,18315,1400451,3905,462794,5466,30,7379,133,6,450,130000.0,39000.0,-70.0,-71.0,-69.0,-60.0,-70.0,-72.0,-69.0,-61.0,-90.0,-93.0,-90.0,-93.0,20.0,22.0,21.0,33.0,0
2955,CC:2F:71:3F:1F:24,6640752,6466057376,4009011,6132909165,2631741,333148211,78,832157,473503133,828241,473031347,3916,471786,804316,599,4011109,393349,78,4877,104000.0,26000.0,-71.0,-65.0,-75.0,-66.0,-71.0,-65.0,-75.0,-66.0,-90.0,-93.0,-90.0,-93.0,19.0,28.0,15.0,27.0,0
2956,F8:59:71:5A:E0:3D,2658906,374779778,27159,41630961,2631747,333148817,0,3425,421558,3309,403403,116,18155,3150,0,27188,866,0,33,144444.0,39000.0,-67.0,-73.0,-65.0,-72.0,-67.0,-75.0,-66.0,-72.0,-90.0,-93.0,-90.0,-93.0,23.0,20.0,25.0,21.0,0
2957,CC:2F:71:3E:C5:1F,2636925,333782102,5178,633285,2631747,333148817,6,22220,1863245,18315,1400451,3905,462794,5466,30,7379,133,6,450,130000.0,39000.0,-70.0,-71.0,-69.0,-60.0,-70.0,-72.0,-69.0,-61.0,-90.0,-93.0,-90.0,-93.0,20.0,22.0,21.0,33.0,0
2958,CC:2F:71:3F:1F:24,6640789,6466068260,4009042,6132919443,2631747,333148817,78,832174,473506131,828258,473034345,3916,471786,804332,599,4011140,393349,78,4877,115556.0,28889.0,-78.0,-72.0,-81.0,-73.0,-75.0,-69.0,-79.0,-70.0,-90.0,-93.0,-90.0,-93.0,12.0,21.0,9.0,20.0,0
2959,F8:59:71:5A:E0:3D,2658908,374779980,27159,41630961,2631749,333149019,0,3425,421558,3309,403403,116,18155,3150,0,27188,866,0,33,144444.0,39000.0,-67.0,-73.0,-65.0,-72.0,-67.0,-75.0,-66.0,-72.0,-90.0,-93.0,-90.0,-93.0,23.0,20.0,25.0,21.0,0
2960,CC:2F:71:3E:C5:1F,2636927,333782304,5178,633285,2631749,333149019,6,22220,1863245,18315,1400451,3905,462794,5466,30,7379,133,6,450,130000.0,39000.0,-70.0,-71.0,-69.0,-60.0,-70.0,-72.0,-69.0,-61.0,-90.0,-93.0,-90.0,-93.0,20.0,22.0,21.0,33.0,0
2961,CC:2F:71:3F:1F:24,6640822,6466078740,4009073,6132929721,2631749,333149019,78,832191,473509129,828275,473037343,3916,471786,804348,599,4011171,393349,78,4877,115556.0,28889.0,-72.0,-66.0,-75.0,-67.0,-79.0,-73.0,-82.0,-75.0,-90.0,-93.0,-90.0,-93.0,18.0,27.0,15.0,26.0,0
2962,F8:59:71:5A:E0:3D,2658913,374780444,27159,41630961,2631754,333149483,0,3425,421558,3309,403403,116,18155,3150,0,27188,866,0,33,144444.0,39000.0,-67.0,-73.0,-65.0,-72.0,-67.0,-75.0,-66.0,-72.0,-90.0,-93.0,-90.0,-93.0,23.0,20.0,25.0,21.0,0
2963,CC:2F:71:3E:C5:1F,2636934,333782970,5178,633285,2631756,333149685,6,22220,1863245,18315,1400451,3905,462794,5466,30,7379,133,6,450,130000.0,39000.0,-70.0,-71.0,-69.0,-60.0,-70.0,-72.0,-69.0,-61.0,-90.0,-93.0,-90.0,-93.0,20.0,22.0,21.0,33.0,0
2964,CC:2F:71:3F:1F:24,6640859,6466089498,4009103,6132939813,2631756,333149685,78,832208,473512127,828292,473040341,3916,471786,804364,599,4011201,393360,78,4877,104000.0,26000.0,-71.0,-65.0,-75.0,-67.0,-71.0,-65.0,-74.0,-66.0,-90.0,-93.0,-90.0,-93.0,19.0,28.0,15.0,26.0,0
2965,F8:59:71:5A:E0:3D,2658917,374780848,27159,41630961,2631758,333149887,0,3425,421558,3309,403403,116,18155,3150,0,27188,866,0,33,144444.0,39000.0,-67.0,-73.0,-65.0,-72.0,-67.0,-75.0,-66.0,-72.0,-90.0,-93.0,-90.0,-93.0,23.0,20.0,25.0,21.0,0
2966,CC:2F:71:3E:C5:1F,2636936,333783172,5178,633285,2631758,333149887,6,22220,1863245,18315,1400451,3905,462794,5466,30,7379,133,6,450,130000.0,39000.0,-70.0,-71.0,-69.0,-60.0,-70.0,-72.0,-69.0,-61.0,-90.0,-93.0,-90.0,-93.0,20.0,22.0,21.0,33.0,0
2967,CC:2F:71:3F:1F:24,6640892,6466099922,4009134,6132950035,2631758,333149887,78,832226,473515241,828310,473043455,3916,471786,804381,599,4011232,393362,78,4877,115556.0,28889.0,-71.0,-65.0,-75.0,-67.0,-71.0,-65.0,-74.0,-67.0,-90.0,-93.0,-90.0,-93.0,19.0,28.0,15.0,26.0,0
2968,F8:59:71:5A:E0:3D,2658921,374781252,27159,41630961,2631762,333150291,0,3425,421558,3309,403403,116,18155,3150,0,27188,866,0,33,144444.0,39000.0,-67.0,-73.0,-65.0,-72.0,-67.0,-75.0,-66.0,-72.0,-90.0,-93.0,-90.0,-93.0,23.0,20.0,25.0,21.0,0
2969,CC:2F:71:3E:C5:1F,2636940,333783576,5178,633285,2631762,333150291,6,22220,1863245,18315,1400451,3905,462794,5466,30,7379,133,6,450,130000.0,39000.0,-70.0,-71.0,-69.0,-60.0,-70.0,-72.0,-69.0,-61.0,-90.0,-93.0,-90.0,-93.0,20.0,22.0,21.0,33.0,0
2970,CC:2F:71:3F:1F:24,6640927,6466110660,4009165,6132960369,2631762,333150291,78,832244,473518355,828328,473046569,3916,471786,804398,599,4011263,393364,78,4877,115556.0,28889.0,-71.0,-65.0,-75.0,-67.0,-71.0,-65.0,-75.0,-67.0,-90.0,-93.0,-90.0,-93.0,19.0,28.0,15.0,26.0,0
2971,F8:59:71:5A:E0:3D,2658924,374781514,27159,41630961,2631765,333150553,0,3425,421558,3309,403403,116,18155,3150,0,27188,866,0,33,144444.0,39000.0,-67.0,-73.0,-65.0,-72.0,-67.0,-75.0,-66.0,-72.0,-90.0,-93.0,-90.0,-93.0,23.0,20.0,25.0,21.0,0
2972,CC:2F:71:3E:C5:1F,2636945,333784040,5178,633285,2631767,333150755,6,22220,1863245,18315,1400451,3905,462794,5466,30,7379,133,6,450,130000.0,39000.0,-70.0,-71.0,-69.0,-60.0,-70.0,-72.0,-69.0,-61.0,-90.0,-93.0,-90.0,-93.0,20.0,22.0,21.0,33.0,0
2973,CC:2F:71:3F:1F:24,6640965,6466122147,4009198,6132971392,2631767,333150755,78,832264,473521689,828348,473049903,3916,471786,804416,599,4011296,393376,78,4877,104000.0,26000.0,-72.0,-65.0,-75.0,-67.0,-71.0,-65.0,-74.0,-67.0,-90.0,-93.0,-90.0,-93.0,18.0,28.0,15.0,26.0,0
2974,F8:59:71:5A:E0:3D,2658930,374782120,27159,41630961,2631771,333151159,0,3425,421558,3309,403403,116,18155,3150,0,27188,866,0,33,144444.0,39000.0,-67.0,-73.0,-65.0,-72.0,-67.0,-75.0,-66.0,-72.0,-90.0,-93.0,-90.0,-93.0,23.0,20.0,25.0,21.0,0
2975,CC:2F:71:3E:C5:1F,2636949,333784444,5178,633285,2631771,333151159,6,22220,1863245,18315,1400451,3905,462794,5466,30,7379,133,6,450,130000.0,39000.0,-70.0,-71.0,-69.0,-60.0,-70.0,-72.0,-69.0,-61.0,-90.0,-93.0,-90.0,-93.0,20.0,22.0,21.0,33.0,0
2976,CC:2F:71:3F:1F:24,6640999,6466132643,4009228,6132981484,2631771,333151159,78,832281,473524687,828365,473052901,3916,471786,804432,599,4011326,393377,78,4877,115556.0,28889.0,-71.0,-65.0,-74.0,-67.0,-71.0,-65.0,-74.0,-67.0,-90.0,-93.0,-90.0,-93.0,19.0,28.0,16.0,26.0,0
2977,F8:59:71:5A:E0:3D,2658940,374785232,27159,41630961,2631781,333154271,0,3425,421558,3309,403403,116,18155,3150,0,27188,866,0,33,144444.0,39000.0,-67.0,-73.0,-65.0,-72.0,-67.0,-75.0,-66.0,-72.0,-90.0,-93.0,-90.0,-93.0,23.0,20.0,25.0,21.0,0
2978,CC:2F:71:3E:C5:1F,2636959,333787556,5178,633285,2631781,333154271,6,22220,1863245,18315,1400451,3905,462794,5466,30,7379,133,6,450,130000.0,39000.0,-70.0,-71.0,-69.0,-60.0,-70.0,-72.0,-69.0,-61.0,-90.0,-93.0,-90.0,-93.0,20.0,22.0,21.0,33.0,0
2979,CC:2F:71:3F:1F:24,6641040,6466146089,4009259,6132991818,2631781,333154271,78,832299,473527801,828383,473056015,3916,471786,804449,599,4011357,393379,78,4877,115556.0,28889.0,-72.0,-66.0,-76.0,-67.0,-71.0,-65.0,-75.0,-67.0,-90.0,-93.0,-90.0,-93.0,18.0,27.0,14.0,26.0,0
2980,F8:59:71:5A:E0:3D,2658948,374785958,27160,41631021,2631788,333154937,0,3427,421698,3311,403543,116,18155,3150,0,27189,866,0,33,144444.0,39000.0,-67.0,-75.0,-65.0,-72.0,-67.0,-75.0,-66.0,-72.0,-90.0,-93.0,-90.0,-92.0,23.0,18.0,25.0,20.0,0
2981,CC:2F:71:3E:C5:1F,2636967,333788338,5179,633401,2631788,333154937,6,22222,1863385,18317,1400591,3905,462794,5466,30,7380,133,6,450,144444.0,39000.0,-70.0,-71.0,-69.0,-60.0,-70.0,-71.0,-69.0,-61.0,-90.0,-93.0,-90.0,-92.0,20.0,22.0,21.0,32.0,0
2982,CC:2F:71:3F:1F:24,6641079,6466157093,4009291,6133002156,2631788,333154937,78,832318,473530939,828402,473059153,3916,471786,804465,599,4011389,393390,78,4877,104000.0,26000.0,-71.0,-65.0,-75.0,-67.0,-71.0,-65.0,-75.0,-67.0,-90.0,-93.0,-90.0,-92.0,19.0,28.0,15.0,25.0,0
2983,F8:59:71:5A:E0:3D,2658952,374786825,27162,41631686,2631790,333155139,0,3432,422361,3316,404206,116,18155,3154,0,27191,866,0,33,144444.0,39000.0,-67.0,-75.0,-65.0,-72.0,-67.0,-74.0,-65.0,-72.0,-90.0,-93.0,-90.0,-92.0,23.0,18.0,25.0,20.0,0
2984,CC:2F:71:3E:C5:1F,2636969,333788540,5179,633401,2631790,333155139,6,22222,1863385,18317,1400591,3905,462794,5466,30,7380,133,6,450,144444.0,39000.0,-70.0,-71.0,-69.0,-60.0,-70.0,-71.0,-69.0,-61.0,-90.0,-93.0,-90.0,-92.0,20.0,22.0,21.0,32.0,0
2985,CC:2F:71:3F:1F:24,6641112,6466167517,4009322,6133012378,2631790,333155139,78,832336,473534053,828420,473062267,3916,471786,804482,599,4011420,393390,78,4877,115556.0,28889.0,-71.0,-65.0,-73.0,-68.0,-71.0,-65.0,-73.0,-68.0,-90.0,-93.0,-90.0,-92.0,19.0,28.0,17.0,24.0,0
2986,F8:59:71:5A:E0:3D,2658957,374787606,27165,41632265,2631792,333155341,0,3436,422866,3320,404711,116,18155,3157,0,27194,866,0,33,144444.0,39000.0,-67.0,-75.0,-65.0,-73.0,-67.0,-75.0,-65.0,-72.0,-90.0,-93.0,-90.0,-92.0,23.0,18.0,25.0,19.0,0
2987,CC:2F:71:3E:C5:1F,2636972,333788804,5179,633401,2631793,333155403,6,22223,1863503,18317,1400591,3906,462912,5467,30,7380,133,6,451,144444.0,39000.0,-70.0,-71.0,-69.0,-60.0,-70.0,-71.0,-69.0,-61.0,-90.0,-93.0,-90.0,-92.0,20.0,22.0,21.0,32.0,0
2988,CC:2F:71:3F:1F:24,6641148,6466178317,4009353,6133022712,2631795,333155605,78,832353,473537051,828437,473065265,3916,471786,804498,599,4011451,393390,78,4877,115556.0,28889.0,-73.0,-64.0,-75.0,-67.0,-72.0,-64.0,-73.0,-67.0,-90.0,-93.0,-90.0,-92.0,17.0,29.0,15.0,25.0,0
2989,F8:59:71:5A:E0:3D,2658965,374788334,27165,41632265,2631800,333156069,0,3436,422866,3320,404711,116,18155,3157,0,27194,866,0,33,144444.0,39000.0,-67.0,-75.0,-65.0,-73.0,-67.0,-75.0,-65.0,-72.0,-90.0,-93.0,-90.0,-92.0,23.0,18.0,25.0,19.0,0
2990,CC:2F:71:3E:C5:1F,2636979,333789470,5179,633401,2631800,333156069,6,22224,1863573,18318,1400661,3906,462912,5467,30,7380,133,6,451,144444.0,39000.0,-69.0,-71.0,-69.0,-60.0,-70.0,-71.0,-69.0,-61.0,-90.0,-93.0,-90.0,-92.0,21.0,22.0,21.0,32.0,0
2991,CC:2F:71:3F:1F:24,6641185,6466189189,4009385,6133033120,2631800,333156069,78,832371,473540165,828455,473068379,3916,471786,804515,599,4011483,393390,78,4877,117000.0,39000.0,-71.0,-65.0,-73.0,-66.0,-70.0,-65.0,-73.0,-66.0,-90.0,-93.0,-90.0,-92.0,19.0,28.0,17.0,26.0,0
2992,F8:59:71:5A:E0:3D,2658970,374788933,27165,41632265,2631805,333156668,0,3438,423054,3321,404781,117,18273,3158,0,27194,866,0,33,144444.0,39000.0,-66.0,-75.0,-65.0,-73.0,-66.0,-75.0,-65.0,-72.0,-90.0,-92.0,-89.0,-92.0,24.0,17.0,24.0,19.0,0
2993,CC:2F:71:3E:C5:1F,2636984,333790069,5179,633401,2631805,333156668,6,22224,1863573,18318,1400661,3906,462912,5467,30,7380,133,6,451,144444.0,39000.0,-69.0,-71.0,-69.0,-60.0,-70.0,-71.0,-69.0,-61.0,-90.0,-92.0,-89.0,-92.0,21.0,21.0,20.0,32.0,0
2994,CC:2F:71:3F:1F:24,6641221,6466199954,4009416,6133043286,2631805,333156668,78,832391,473543529,828474,473071625,3917,471904,804532,599,4011514,393390,78,4877,130000.0,39000.0,-72.0,-65.0,-74.0,-67.0,-72.0,-65.0,-73.0,-66.0,-90.0,-92.0,-89.0,-92.0,18.0,27.0,15.0,25.0,0
2995,F8:59:71:5A:E0:3D,2658974,374789337,27165,41632265,2631809,333157072,0,3438,423054,3321,404781,117,18273,3158,0,27194,866,0,33,144444.0,39000.0,-66.0,-75.0,-65.0,-73.0,-66.0,-75.0,-65.0,-72.0,-90.0,-92.0,-89.0,-92.0,24.0,17.0,24.0,19.0,0
2996,CC:2F:71:3E:C5:1F,2636988,333790473,5179,633401,2631809,333157072,6,22224,1863573,18318,1400661,3906,462912,5467,30,7380,133,6,451,144444.0,39000.0,-69.0,-71.0,-69.0,-60.0,-70.0,-71.0,-69.0,-61.0,-90.0,-92.0,-89.0,-92.0,21.0,21.0,20.0,32.0,0
2997,CC:2F:71:3F:1F:24,6641258,6466210838,4009447,6133053564,2631811,333157274,78,832408,473546527,828491,473074623,3917,471904,804548,599,4011545,393397,78,4877,144444.0,39000.0,-71.0,-65.0,-74.0,-66.0,-71.0,-65.0,-74.0,-66.0,-90.0,-92.0,-89.0,-92.0,19.0,27.0,15.0,26.0,0
2998,F8:59:71:5A:E0:3D,2658977,374789599,27165,41632265,2631812,333157334,0,3438,423054,3321,404781,117,18273,3158,0,27194,866,0,33,144444.0,39000.0,-66.0,-75.0,-65.0,-73.0,-66.0,-75.0,-65.0,-72.0,-90.0,-92.0,-89.0,-92.0,24.0,17.0,24.0,19.0,0
2999,CC:2F:71:3E:C5:1F,2636991,333790735,5179,633401,2631812,333157334,6,22224,1863573,18318,1400661,3906,462912,5467,30,7380,133,6,451,144444.0,39000.0,-69.0,-71.0,-69.0,-60.0,-70.0,-71.0,-69.0,-61.0,-90.0,-92.0,-89.0,-92.0,21.0,21.0,20.0,32.0,0
3000,CC:2F:71:3F:1F:24,6641291,6466221248,4009477,6133063712,2631814,333157536,78,832425,473549525,828508,473077621,3917,471904,804564,599,4011575,393408,78,4877,144444.0,43333.0,-71.0,-65.0,-74.0,-66.0,-70.0,-65.0,-74.0,-66.0,-90.0,-92.0,-89.0,-92.0,19.0,27.0,15.0,26.0,0
3001,F8:59:71:5A:E0:3D,2658983,374790205,27165,41632265,2631818,333157940,0,3438,423054,3321,404781,117,18273,3158,0,27194,866,0,33,144444.0,39000.0,-66.0,-75.0,-65.0,-73.0,-66.0,-75.0,-65.0,-72.0,-90.0,-92.0,-89.0,-92.0,24.0,17.0,24.0,19.0,0
3002,CC:2F:71:3E:C5:1F,2636997,333791341,5179,633401,2631818,333157940,6,22224,1863573,18318,1400661,3906,462912,5467,30,7380,133,6,451,144444.0,39000.0,-69.0,-71.0,-69.0,-60.0,-70.0,-71.0,-69.0,-61.0,-90.0,-92.0,-89.0,-92.0,21.0,21.0,20.0,32.0,0
3003,CC:2F:71:3F:1F:24,6641326,6466231930,4009508,6133073990,2631818,333157940,78,832442,473552523,828525,473080619,3917,471904,804580,599,4011606,393410,78,4877,130000.0,43333.0,-71.0,-65.0,-74.0,-66.0,-70.0,-65.0,-74.0,-66.0,-90.0,-92.0,-89.0,-92.0,19.0,27.0,15.0,26.0,0
3004,F8:59:71:5A:E0:3D,2658985,374790407,27165,41632265,2631820,333158142,0,3438,423054,3321,404781,117,18273,3158,0,27194,866,0,33,144444.0,39000.0,-66.0,-75.0,-65.0,-73.0,-66.0,-75.0,-65.0,-72.0,-90.0,-92.0,-89.0,-92.0,24.0,17.0,24.0,19.0,0
3005,CC:2F:71:3E:C5:1F,2636999,333791543,5179,633401,2631820,333158142,6,22224,1863573,18318,1400661,3906,462912,5467,30,7380,133,6,451,144444.0,39000.0,-69.0,-71.0,-69.0,-60.0,-70.0,-71.0,-69.0,-61.0,-90.0,-92.0,-89.0,-92.0,21.0,21.0,20.0,32.0,0
3006,CC:2F:71:3F:1F:24,6641360,6466242470,4009539,6133084268,2631821,333158202,78,832460,473555637,828543,473083733,3917,471904,804597,599,4011637,393410,78,4877,130000.0,39000.0,-71.0,-66.0,-74.0,-66.0,-71.0,-66.0,-74.0,-66.0,-90.0,-92.0,-89.0,-92.0,19.0,26.0,15.0,26.0,0
3007,F8:59:71:5A:E0:3D,2658993,374791189,27166,41632381,2631827,333158808,0,3441,423300,3324,405027,117,18273,3159,0,27195,866,0,33,144444.0,39000.0,-66.0,-75.0,-66.0,-73.0,-66.0,-75.0,-65.0,-72.0,-90.0,-92.0,-89.0,-92.0,24.0,17.0,23.0,19.0,0
3008,CC:2F:71:3E:C5:1F,2637006,333792209,5179,633401,2631827,333158808,6,22224,1863573,18318,1400661,3906,462912,5467,30,7380,133,6,451,144444.0,39000.0,-69.0,-71.0,-69.0,-60.0,-70.0,-71.0,-69.0,-61.0,-90.0,-92.0,-89.0,-92.0,21.0,21.0,20.0,32.0,0
3009,CC:2F:71:3F:1F:24,6641397,6466253354,4009570,6133094546,2631827,333158808,78,832477,473558635,828560,473086731,3917,471904,804613,599,4011668,393414,78,4877,144444.0,39000.0,-78.0,-71.0,-79.0,-72.0,-75.0,-69.0,-78.0,-70.0,-90.0,-92.0,-89.0,-92.0,12.0,21.0,10.0,20.0,0
