sample,station,tx_total_pkts,tx_total_bytes,tx_ucast_pkts,tx_ucast_bytes,tx_mcast_bcast_pkts,tx_mcast_bcast_bytes,tx_failures,rx_data_pkts,rx_data_bytes,rx_ucast_pkts,rx_ucast_bytes,rx_mcast_bcast_pkts,rx_mcast_bcast_bytes,rx_decrypt_succeeds,tx_data_pkts_retried,tx_total_pkts_sent,tx_pkts_retries,tx_pkts_retry_exhausted,rx_total_pkts_retried,rate_last_tx_pkt_min,rate_last_tx_pkt_max,per_antenna_rssi_last_rx_data_frame_1,per_antenna_rssi_last_rx_data_frame_2,per_antenna_rssi_last_rx_data_frame_3,per_antenna_rssi_last_rx_data_frame_4,per_antenna_avg_rssi_rx_data_frames_1,per_antenna_avg_rssi_rx_data_frames_2,per_antenna_avg_rssi_rx_data_frames_3,per_antenna_avg_rssi_rx_data_frames_4,per_antenna_noise_floor_1,per_antenna_noise_floor_2,per_antenna_noise_floor_3,per_antenna_noise_floor_4,sinr_per_antenna_1,sinr_per_antenna_2,sinr_per_antenna_3,sinr_per_antenna_4,attack
1,92:69:1D:31:68:E9,3819906,484800324,3444,3448245,3816462,481352079,0,3545,921647,3451,900792,94,20855,1769,6,3570,77,0,31,216660.0,130000.0,-52.0,-50.0,-44.0,-46.0,-52.0,-50.0,-44.0,-46.0,-90.0,-93.0,-89.0,-92.0,38.0,43.0,45.0,46.0,0
2,CC:2F:71:3F:1F:24,4392592,1161331057,576130,679978978,3816462,481352079,37,483255,555736703,482700,555669737,555,66966,465592,10,576367,41073,34,429,144444.0,43333.0,-65.0,-63.0,-69.0,-65.0,-65.0,-63.0,-69.0,-65.0,-90.0,-93.0,-89.0,-92.0,25.0,30.0,20.0,27.0,0
3,CC:2F:71:3E:C5:1F,3817132,481433951,670,81872,3816462,481352079,0,2878,240584,2388,182406,490,58178,709,8,1001,18,0,31,144444.0,39000.0,-70.0,-71.0,-67.0,-60.0,-70.0,-71.0,-67.0,-61.0,-90.0,-93.0,-89.0,-92.0,20.0,22.0,22.0,32.0,0
4,BA:8C:B9:54:50:24,3818179,482188312,1715,836031,3816464,481352281,0,5488,815979,5468,812857,20,3122,1001,14,2090,29,0,48,229410.0,130000.0,-51.0,-35.0,-44.0,-44.0,-43.0,-36.0,-44.0,-48.0,-90.0,-93.0,-89.0,-92.0,39.0,58.0,45.0,48.0,0
5,92:69:1D:31:68:E9,3819912,484800930,3444,3448245,3816468,481352685,0,3545,921647,3451,900792,94,20855,1769,6,3570,77,0,31,216660.0,130000.0,-52.0,-50.0,-44.0,-46.0,-52.0,-50.0,-44.0,-46.0,-90.0,-93.0,-89.0,-92.0,38.0,43.0,45.0,46.0,0
6,CC:2F:71:3F:1F:24,4392640,1161346203,576172,679993518,3816468,481352685,37,483283,555741857,482728,555674891,555,66966,465619,10,576409,41116,34,429,144444.0,43333.0,-65.0,-63.0,-70.0,-66.0,-65.0,-63.0,-69.0,-65.0,-90.0,-93.0,-89.0,-92.0,25.0,30.0,19.0,26.0,0
7,CC:2F:71:3E:C5:1F,3817140,481434759,670,81872,3816470,481352887,0,2878,240584,2388,182406,490,58178,709,8,1001,18,0,31,144444.0,39000.0,-70.0,-71.0,-67.0,-60.0,-70.0,-71.0,-67.0,-61.0,-90.0,-92.0,-89.0,-92.0,20.0,21.0,22.0,32.0,0
8,BA:8C:B9:54:50:24,3818186,482188978,1715,836031,3816471,481352947,0,5488,815979,5468,812857,20,3122,1001,14,2090,29,0,48,229410.0,130000.0,-51.0,-35.0,-44.0,-44.0,-43.0,-36.0,-44.0,-48.0,-90.0,-92.0,-89.0,-92.0,39.0,57.0,45.0,48.0,0
9,92:69:1D:31:68:E9,3819915,484801192,3444,3448245,3816471,481352947,0,3545,921647,3451,900792,94,20855,1769,6,3570,77,0,31,216660.0,130000.0,-52.0,-50.0,-44.0,-46.0,-52.0,-50.0,-44.0,-46.0,-90.0,-92.0,-89.0,-92.0,38.0,42.0,45.0,46.0,0
10,CC:2F:71:3F:1F:24,4392687,1161361394,576215,680008174,3816472,481353220,37,483310,555746847,482755,555679881,555,66966,465645,10,576452,41166,34,429,144444.0,43333.0,-67.0,-65.0,-70.0,-67.0,-66.0,-64.0,-70.0,-67.0,-90.0,-92.0,-89.0,-92.0,23.0,27.0,19.0,25.0,0
11,CC:2F:71:3E:C5:1F,3817143,481435208,671,81988,3816472,481353220,0,2880,240724,2390,182546,490,58178,709,8,1002,18,0,31,144444.0,39000.0,-70.0,-71.0,-67.0,-60.0,-71.0,-72.0,-68.0,-61.0,-90.0,-92.0,-89.0,-92.0,20.0,21.0,22.0,32.0,0
12,BA:8C:B9:54:50:24,3818189,482189453,1715,836031,3816474,481353422,0,5488,815979,5468,812857,20,3122,1001,14,2090,29,0,48,229410.0,130000.0,-51.0,-35.0,-44.0,-44.0,-43.0,-36.0,-44.0,-48.0,-90.0,-92.0,-89.0,-92.0,39.0,57.0,45.0,48.0,0
13,92:69:1D:31:68:E9,3819923,484802131,3445,3448305,3816478,481353826,0,3547,921783,3453,900928,94,20855,1769,6,3571,77,0,31,216660.0,130000.0,-51.0,-47.0,-42.0,-49.0,-51.0,-49.0,-44.0,-47.0,-90.0,-92.0,-89.0,-92.0,39.0,45.0,47.0,43.0,0
14,CC:2F:71:3F:1F:24,4392735,1161376484,576257,680022658,3816478,481353826,37,483335,555751651,482780,555684685,555,66966,465670,10,576494,41178,34,429,130000.0,43333.0,-67.0,-65.0,-71.0,-68.0,-67.0,-65.0,-70.0,-67.0,-90.0,-92.0,-89.0,-92.0,23.0,27.0,18.0,24.0,0
15,CC:2F:71:3E:C5:1F,3817149,481435814,671,81988,3816478,481353826,0,2880,240724,2390,182546,490,58178,709,8,1002,18,0,31,144444.0,39000.0,-70.0,-71.0,-67.0,-60.0,-71.0,-72.0,-68.0,-61.0,-90.0,-92.0,-89.0,-92.0,20.0,21.0,22.0,32.0,0
16,BA:8C:B9:54:50:24,3818196,482190175,1716,836147,3816480,481354028,0,5490,816115,5470,812993,20,3122,1001,14,2091,29,0,48,229410.0,130000.0,-39.0,-37.0,-44.0,-51.0,-42.0,-36.0,-44.0,-49.0,-90.0,-92.0,-89.0,-92.0,51.0,55.0,45.0,41.0,0
17,92:69:1D:31:68:E9,3819970,484806661,3445,3448305,3816525,481358356,0,3547,921783,3453,900928,94,20855,1769,6,3571,77,0,31,216660.0,130000.0,-51.0,-47.0,-42.0,-49.0,-51.0,-49.0,-44.0,-47.0,-90.0,-93.0,-90.0,-93.0,39.0,46.0,48.0,44.0,0
18,CC:2F:71:3F:1F:24,4392849,1161399584,576324,680041228,3816525,481358356,37,483387,555761841,482831,555694757,556,67084,465722,10,576561,41204,34,430,130000.0,39000.0,-67.0,-65.0,-70.0,-67.0,-67.0,-65.0,-70.0,-67.0,-90.0,-93.0,-90.0,-93.0,23.0,28.0,20.0,26.0,0
19,CC:2F:71:3E:C5:1F,3817196,481440344,671,81988,3816525,481358356,0,2882,240912,2391,182616,491,58296,710,8,1002,18,0,31,144444.0,39000.0,-70.0,-71.0,-67.0,-60.0,-71.0,-72.0,-68.0,-61.0,-90.0,-93.0,-90.0,-93.0,20.0,22.0,23.0,33.0,0
20,BA:8C:B9:54:50:24,3818243,482194705,1716,836147,3816527,481358558,0,5491,816183,5471,813061,20,3122,1001,14,2091,29,0,48,229410.0,130000.0,-49.0,-35.0,-42.0,-45.0,-43.0,-36.0,-44.0,-49.0,-90.0,-93.0,-90.0,-93.0,41.0,58.0,48.0,48.0,0
21,92:69:1D:31:68:E9,3819976,484807267,3445,3448305,3816531,481358962,0,3547,921783,3453,900928,94,20855,1769,6,3571,77,0,31,216660.0,130000.0,-51.0,-47.0,-42.0,-49.0,-51.0,-49.0,-44.0,-47.0,-90.0,-93.0,-90.0,-93.0,39.0,46.0,48.0,44.0,0
22,CC:2F:71:3F:1F:24,4392898,1161414686,576367,680055724,3816531,481358962,37,483413,555766785,482857,555699701,556,67084,465748,10,576604,41253,34,430,130000.0,39000.0,-67.0,-65.0,-70.0,-67.0,-67.0,-65.0,-70.0,-67.0,-90.0,-93.0,-90.0,-93.0,23.0,28.0,20.0,26.0,0
23,CC:2F:71:3E:C5:1F,3817203,481441010,671,81988,3816532,481359022,0,2882,240912,2391,182616,491,58296,710,8,1002,18,0,31,144444.0,39000.0,-70.0,-71.0,-67.0,-60.0,-71.0,-72.0,-68.0,-61.0,-90.0,-93.0,-90.0,-93.0,20.0,22.0,23.0,33.0,0
24,BA:8C:B9:54:50:24,3818248,482195169,1716,836147,3816532,481359022,0,5491,816183,5471,813061,20,3122,1001,14,2091,29,0,48,229410.0,130000.0,-49.0,-35.0,-42.0,-45.0,-43.0,-36.0,-44.0,-49.0,-90.0,-93.0,-90.0,-93.0,41.0,58.0,48.0,48.0,0
25,92:69:1D:31:68:E9,3819980,484807802,3445,3448305,3816535,481359497,0,3547,921783,3453,900928,94,20855,1769,6,3571,77,0,31,216660.0,130000.0,-51.0,-47.0,-42.0,-49.0,-51.0,-49.0,-44.0,-47.0,-90.0,-93.0,-90.0,-93.0,39.0,46.0,48.0,44.0,0
26,CC:2F:71:3F:1F:24,4392943,1161429525,576408,680070028,3816535,481359497,37,483438,555771589,482882,555704505,556,67084,465773,10,576645,41298,34,430,144444.0,43333.0,-67.0,-65.0,-70.0,-68.0,-67.0,-65.0,-70.0,-67.0,-90.0,-93.0,-90.0,-93.0,23.0,28.0,20.0,25.0,0
27,CC:2F:71:3E:C5:1F,3817208,481441687,671,81988,3816537,481359699,0,2882,240912,2391,182616,491,58296,710,8,1002,18,0,31,144444.0,39000.0,-70.0,-71.0,-67.0,-60.0,-71.0,-72.0,-68.0,-61.0,-90.0,-93.0,-90.0,-93.0,20.0,22.0,23.0,33.0,0
28,BA:8C:B9:54:50:24,3818253,482195846,1716,836147,3816537,481359699,0,5491,816183,5471,813061,20,3122,1001,14,2091,29,0,48,229410.0,130000.0,-49.0,-35.0,-42.0,-45.0,-43.0,-36.0,-44.0,-49.0,-90.0,-93.0,-90.0,-93.0,41.0,58.0,48.0,48.0,0
29,92:69:1D:31:68:E9,3819986,484808408,3445,3448305,3816541,481360103,0,3547,921783,3453,900928,94,20855,1769,6,3571,77,0,31,216660.0,130000.0,-51.0,-47.0,-42.0,-49.0,-51.0,-49.0,-44.0,-47.0,-90.0,-93.0,-90.0,-93.0,39.0,46.0,48.0,44.0,0
30,CC:2F:71:3F:1F:24,4392993,1161445183,576452,680085080,3816541,481360103,37,483466,555776799,482910,555709715,556,67084,465801,10,576689,41336,34,430,144444.0,39000.0,-67.0,-65.0,-70.0,-67.0,-67.0,-65.0,-70.0,-67.0,-90.0,-93.0,-90.0,-93.0,23.0,28.0,20.0,26.0,0
31,CC:2F:71:3E:C5:1F,3817212,481442091,671,81988,3816541,481360103,0,2882,240912,2391,182616,491,58296,710,8,1002,18,0,31,144444.0,39000.0,-70.0,-71.0,-67.0,-60.0,-71.0,-72.0,-68.0,-61.0,-90.0,-93.0,-90.0,-93.0,20.0,22.0,23.0,33.0,0
32,BA:8C:B9:54:50:24,3818257,482196250,1716,836147,3816541,481360103,0,5491,816183,5471,813061,20,3122,1001,14,2091,29,0,48,229410.0,130000.0,-49.0,-35.0,-42.0,-45.0,-43.0,-36.0,-44.0,-49.0,-90.0,-93.0,-90.0,-93.0,41.0,58.0,48.0,48.0,0
33,92:69:1D:31:68:E9,3819989,484808670,3445,3448305,3816544,481360365,0,3547,921783,3453,900928,94,20855,1769,6,3571,77,0,31,216660.0,130000.0,-51.0,-47.0,-42.0,-49.0,-51.0,-49.0,-44.0,-47.0,-90.0,-93.0,-90.0,-93.0,39.0,46.0,48.0,44.0,0
34,CC:2F:71:3F:1F:24,4393036,1161459675,576492,680099310,3816544,481360365,37,483492,555781779,482936,555714695,556,67084,465827,10,576729,41373,34,430,144444.0,43333.0,-67.0,-65.0,-71.0,-67.0,-67.0,-65.0,-70.0,-67.0,-90.0,-93.0,-90.0,-93.0,23.0,28.0,19.0,26.0,0
35,CC:2F:71:3E:C5:1F,3817215,481442353,671,81988,3816544,481360365,0,2882,240912,2391,182616,491,58296,710,8,1002,18,0,31,144444.0,39000.0,-70.0,-71.0,-67.0,-60.0,-71.0,-72.0,-68.0,-61.0,-90.0,-93.0,-90.0,-93.0,20.0,22.0,23.0,33.0,0
36,BA:8C:B9:54:50:24,3818262,482196714,1716,836147,3816546,481360567,0,5491,816183,5471,813061,20,3122,1001,14,2091,29,0,48,229410.0,130000.0,-49.0,-35.0,-42.0,-45.0,-43.0,-36.0,-44.0,-49.0,-90.0,-93.0,-90.0,-93.0,41.0,58.0,48.0,48.0,0
37,92:69:1D:31:68:E9,3819995,484809276,3445,3448305,3816550,481360971,0,3547,921783,3453,900928,94,20855,1769,6,3571,77,0,31,216660.0,130000.0,-51.0,-47.0,-42.0,-49.0,-51.0,-49.0,-44.0,-47.0,-90.0,-93.0,-90.0,-93.0,39.0,46.0,48.0,44.0,0
38,CC:2F:71:3F:1F:24,4393086,1161475019,576536,680114048,3816550,481360971,37,483518,555786723,482962,555719639,556,67084,465853,10,576773,41419,34,430,130000.0,39000.0,-67.0,-65.0,-70.0,-68.0,-67.0,-65.0,-70.0,-67.0,-90.0,-93.0,-90.0,-93.0,23.0,28.0,20.0,25.0,0
39,CC:2F:71:3E:C5:1F,3817221,481442959,671,81988,3816550,481360971,0,2882,240912,2391,182616,491,58296,710,8,1002,18,0,31,144444.0,39000.0,-70.0,-71.0,-67.0,-60.0,-71.0,-72.0,-68.0,-61.0,-90.0,-93.0,-90.0,-93.0,20.0,22.0,23.0,33.0,0
40,BA:8C:B9:54:50:24,3818266,482197118,1716,836147,3816550,481360971,0,5491,816183,5471,813061,20,3122,1001,14,2091,29,0,48,229410.0,130000.0,-49.0,-35.0,-42.0,-45.0,-43.0,-36.0,-44.0,-49.0,-90.0,-93.0,-90.0,-93.0,41.0,58.0,48.0,48.0,0
41,92:69:1D:31:68:E9,3819997,484809478,3445,3448305,3816552,481361173,0,3547,921783,3453,900928,94,20855,1769,6,3571,77,0,31,216660.0,130000.0,-51.0,-47.0,-42.0,-49.0,-51.0,-49.0,-44.0,-47.0,-90.0,-93.0,-90.0,-93.0,39.0,46.0,48.0,44.0,0
42,CC:2F:71:3F:1F:24,4393130,1161489649,576578,680128476,3816552,481361173,37,483544,555791667,482988,555724583,556,67084,465879,10,576815,41434,34,430,130000.0,39000.0,-67.0,-65.0,-71.0,-67.0,-67.0,-65.0,-70.0,-67.0,-90.0,-93.0,-90.0,-93.0,23.0,28.0,19.0,26.0,0
43,CC:2F:71:3E:C5:1F,3817225,481443363,671,81988,3816554,481361375,0,2882,240912,2391,182616,491,58296,710,8,1002,18,0,31,144444.0,39000.0,-70.0,-71.0,-67.0,-60.0,-71.0,-72.0,-68.0,-61.0,-90.0,-93.0,-90.0,-93.0,20.0,22.0,23.0,33.0,0
44,BA:8C:B9:54:50:24,3818270,482197522,1716,836147,3816554,481361375,0,5491,816183,5471,813061,20,3122,1001,14,2091,29,0,48,229410.0,130000.0,-49.0,-35.0,-42.0,-45.0,-43.0,-36.0,-44.0,-49.0,-90.0,-93.0,-90.0,-93.0,41.0,58.0,48.0,48.0,0
45,92:69:1D:31:68:E9,3820004,484810144,3445,3448305,3816559,481361839,0,3547,921783,3453,900928,94,20855,1769,6,3571,77,0,31,216660.0,130000.0,-51.0,-47.0,-42.0,-49.0,-51.0,-49.0,-44.0,-47.0,-90.0,-93.0,-90.0,-93.0,39.0,46.0,48.0,44.0,0
46,CC:2F:71:3F:1F:24,4393180,1161504923,576621,680143084,3816559,481361839,37,483570,555796611,483014,555729527,556,67084,465905,10,576858,41441,34,430,130000.0,43333.0,-67.0,-65.0,-70.0,-67.0,-67.0,-65.0,-70.0,-67.0,-90.0,-93.0,-90.0,-93.0,23.0,28.0,20.0,26.0,0
47,CC:2F:71:3E:C5:1F,3817230,481443827,671,81988,3816559,481361839,0,2882,240912,2391,182616,491,58296,710,8,1002,18,0,31,144444.0,39000.0,-70.0,-71.0,-67.0,-60.0,-71.0,-72.0,-68.0,-61.0,-90.0,-93.0,-90.0,-93.0,20.0,22.0,23.0,33.0,0
48,BA:8C:B9:54:50:24,3818275,482197986,1716,836147,3816559,481361839,0,5491,816183,5471,813061,20,3122,1001,14,2091,29,0,48,229410.0,130000.0,-49.0,-35.0,-42.0,-45.0,-43.0,-36.0,-44.0,-49.0,-90.0,-93.0,-90.0,-93.0,41.0,58.0,48.0,48.0,0
49,92:69:1D:31:68:E9,3820006,484810346,3445,3448305,3816561,481362041,0,3547,921783,3453,900928,94,20855,1769,6,3571,77,0,31,216660.0,130000.0,-51.0,-47.0,-42.0,-49.0,-51.0,-49.0,-44.0,-47.0,-90.0,-93.0,-90.0,-93.0,39.0,46.0,48.0,44.0,0
50,CC:2F:71:3F:1F:24,4393226,1161519857,576665,680157816,3816561,481362041,37,483596,555801591,483040,555734507,556,67084,465931,10,576902,41462,34,430,130000.0,39000.0,-67.0,-65.0,-71.0,-67.0,-67.0,-65.0,-70.0,-67.0,-90.0,-93.0,-90.0,-93.0,23.0,28.0,19.0,26.0,0
51,CC:2F:71:3E:C5:1F,3817234,481444231,671,81988,3816563,481362243,0,2882,240912,2391,182616,491,58296,710,8,1002,18,0,31,144444.0,39000.0,-70.0,-71.0,-67.0,-60.0,-71.0,-72.0,-68.0,-61.0,-90.0,-93.0,-90.0,-93.0,20.0,22.0,23.0,33.0,0
52,BA:8C:B9:54:50:24,3818279,482198390,1716,836147,3816563,481362243,0,5491,816183,5471,813061,20,3122,1001,14,2091,29,0,48,229410.0,130000.0,-49.0,-35.0,-42.0,-45.0,-43.0,-36.0,-44.0,-49.0,-90.0,-93.0,-90.0,-93.0,41.0,58.0,48.0,48.0,0
53,92:69:1D:31:68:E9,3820015,484811222,3445,3448305,3816570,481362917,0,3547,921783,3453,900928,94,20855,1769,6,3571,77,0,31,216660.0,130000.0,-51.0,-47.0,-42.0,-49.0,-51.0,-49.0,-44.0,-47.0,-90.0,-93.0,-90.0,-93.0,39.0,46.0,48.0,44.0,0
54,CC:2F:71:3F:1F:24,4393277,1161535161,576707,680172244,3816570,481362917,37,483622,555806511,483066,555739427,556,67084,465957,10,576944,41473,34,430,130000.0,43333.0,-67.0,-65.0,-70.0,-67.0,-67.0,-65.0,-70.0,-67.0,-90.0,-93.0,-90.0,-93.0,23.0,28.0,20.0,26.0,0
55,CC:2F:71:3E:C5:1F,3817241,481444905,671,81988,3816570,481362917,0,2885,241304,2392,182686,493,58618,712,8,1002,18,0,32,144444.0,39000.0,-70.0,-71.0,-67.0,-60.0,-70.0,-71.0,-67.0,-60.0,-90.0,-93.0,-90.0,-93.0,20.0,22.0,23.0,33.0,0
56,BA:8C:B9:54:50:24,3818286,482199064,1716,836147,3816570,481362917,0,5491,816183,5471,813061,20,3122,1001,14,2091,29,0,48,229410.0,130000.0,-49.0,-35.0,-42.0,-45.0,-43.0,-36.0,-44.0,-49.0,-90.0,-93.0,-90.0,-93.0,41.0,58.0,48.0,48.0,0
57,92:69:1D:31:68:E9,3820017,484811424,3445,3448305,3816572,481363119,0,3547,921783,3453,900928,94,20855,1769,6,3571,77,0,31,216660.0,130000.0,-51.0,-47.0,-42.0,-49.0,-51.0,-49.0,-44.0,-47.0,-90.0,-93.0,-90.0,-93.0,39.0,46.0,48.0,44.0,0
58,CC:2F:71:3F:1F:24,4393321,1161549847,576749,680186728,3816572,481363119,37,483649,555811571,483093,555744487,556,67084,465984,10,576986,41475,34,430,130000.0,43333.0,-67.0,-65.0,-70.0,-67.0,-67.0,-65.0,-70.0,-67.0,-90.0,-93.0,-90.0,-93.0,23.0,28.0,20.0,26.0,0
59,CC:2F:71:3E:C5:1F,3817243,481445107,671,81988,3816572,481363119,0,2885,241304,2392,182686,493,58618,712,8,1002,18,0,32,144444.0,39000.0,-70.0,-71.0,-67.0,-60.0,-70.0,-71.0,-67.0,-60.0,-90.0,-93.0,-90.0,-93.0,20.0,22.0,23.0,33.0,0
60,BA:8C:B9:54:50:24,3818288,482199266,1716,836147,3816572,481363119,0,5491,816183,5471,813061,20,3122,1001,14,2091,29,0,48,229410.0,130000.0,-49.0,-35.0,-42.0,-45.0,-43.0,-36.0,-44.0,-49.0,-90.0,-93.0,-90.0,-93.0,41.0,58.0,48.0,48.0,0
61,92:69:1D:31:68:E9,3820023,484812030,3445,3448305,3816578,481363725,0,3547,921783,3453,900928,94,20855,1769,6,3571,77,0,31,216660.0,130000.0,-51.0,-47.0,-42.0,-49.0,-51.0,-49.0,-44.0,-47.0,-90.0,-93.0,-90.0,-93.0,39.0,46.0,48.0,44.0,0
62,CC:2F:71:3F:1F:24,4393369,1161564881,576791,680201156,3816578,481363725,37,483674,555816375,483118,555749291,556,67084,466009,10,577028,41490,34,430,117000.0,39000.0,-67.0,-65.0,-70.0,-67.0,-67.0,-65.0,-70.0,-67.0,-90.0,-93.0,-90.0,-93.0,23.0,28.0,20.0,26.0,0
63,CC:2F:71:3E:C5:1F,3817249,481445713,671,81988,3816578,481363725,0,2885,241304,2392,182686,493,58618,712,8,1002,18,0,32,144444.0,39000.0,-70.0,-71.0,-67.0,-60.0,-70.0,-71.0,-67.0,-60.0,-90.0,-93.0,-90.0,-93.0,20.0,22.0,23.0,33.0,0
64,BA:8C:B9:54:50:24,3818294,482199872,1716,836147,3816578,481363725,0,5491,816183,5471,813061,20,3122,1001,14,2091,29,0,48,229410.0,130000.0,-49.0,-35.0,-42.0,-45.0,-43.0,-36.0,-44.0,-49.0,-90.0,-93.0,-90.0,-93.0,41.0,58.0,48.0,48.0,0
65,92:69:1D:31:68:E9,3820026,484812292,3445,3448305,3816581,481363987,0,3548,921851,3454,900996,94,20855,1769,6,3571,77,0,31,216660.0,130000.0,-52.0,-50.0,-44.0,-46.0,-51.0,-49.0,-44.0,-47.0,-90.0,-93.0,-90.0,-93.0,38.0,43.0,46.0,47.0,0
66,CC:2F:71:3F:1F:24,4393415,1161579701,576834,680215714,3816581,481363987,37,483699,555821179,483143,555754095,556,67084,466034,10,577071,41493,34,430,130000.0,43333.0,-67.0,-65.0,-70.0,-68.0,-67.0,-65.0,-70.0,-67.0,-90.0,-93.0,-90.0,-93.0,23.0,28.0,20.0,25.0,0
67,CC:2F:71:3E:C5:1F,3817252,481445975,671,81988,3816581,481363987,0,2885,241304,2392,182686,493,58618,712,8,1002,18,0,32,144444.0,39000.0,-70.0,-71.0,-67.0,-60.0,-70.0,-71.0,-67.0,-60.0,-90.0,-93.0,-90.0,-93.0,20.0,22.0,23.0,33.0,0
68,BA:8C:B9:54:50:24,3818297,482200134,1716,836147,3816581,481363987,0,5491,816183,5471,813061,20,3122,1001,14,2091,29,0,48,229410.0,130000.0,-49.0,-35.0,-42.0,-45.0,-43.0,-36.0,-44.0,-49.0,-90.0,-93.0,-90.0,-93.0,41.0,58.0,48.0,48.0,0
69,92:69:1D:31:68:E9,3820032,484812898,3445,3448305,3816587,481364593,0,3548,921851,3454,900996,94,20855,1769,6,3571,77,0,31,216660.0,130000.0,-52.0,-50.0,-44.0,-46.0,-51.0,-49.0,-44.0,-47.0,-90.0,-93.0,-90.0,-93.0,38.0,43.0,46.0,47.0,0
70,CC:2F:71:3F:1F:24,4393463,1161594735,576876,680230142,3816587,481364593,37,483726,555826215,483170,555759131,556,67084,466061,10,577113,41513,34,430,117000.0,39000.0,-67.0,-65.0,-70.0,-67.0,-67.0,-65.0,-70.0,-67.0,-90.0,-93.0,-90.0,-93.0,23.0,28.0,20.0,26.0,0
71,CC:2F:71:3E:C5:1F,3817258,481446581,671,81988,3816587,481364593,0,2885,241304,2392,182686,493,58618,712,8,1002,18,0,32,144444.0,39000.0,-70.0,-71.0,-67.0,-60.0,-70.0,-71.0,-67.0,-60.0,-90.0,-93.0,-90.0,-93.0,20.0,22.0,23.0,33.0,0
72,BA:8C:B9:54:50:24,3818303,482200740,1716,836147,3816587,481364593,0,5491,816183,5471,813061,20,3122,1001,14,2091,29,0,48,229410.0,130000.0,-49.0,-35.0,-42.0,-45.0,-43.0,-36.0,-44.0,-49.0,-90.0,-93.0,-90.0,-93.0,41.0,58.0,48.0,48.0,0
73,92:69:1D:31:68:E9,3820034,484813100,3445,3448305,3816589,481364795,0,3548,921851,3454,900996,94,20855,1769,6,3571,77,0,31,216660.0,130000.0,-52.0,-50.0,-44.0,-46.0,-51.0,-49.0,-44.0,-47.0,-90.0,-93.0,-90.0,-93.0,38.0,43.0,46.0,47.0,0
74,CC:2F:71:3F:1F:24,4393506,1161609235,576917,680244440,3816589,481364795,37,483753,555831299,483197,555764215,556,67084,466088,10,577154,41520,34,430,130000.0,43333.0,-67.0,-65.0,-70.0,-67.0,-67.0,-65.0,-70.0,-67.0,-90.0,-93.0,-90.0,-93.0,23.0,28.0,20.0,26.0,0
75,CC:2F:71:3E:C5:1F,3817260,481446783,671,81988,3816589,481364795,0,2885,241304,2392,182686,493,58618,712,8,1002,18,0,32,144444.0,39000.0,-70.0,-71.0,-67.0,-60.0,-70.0,-71.0,-67.0,-60.0,-90.0,-93.0,-90.0,-93.0,20.0,22.0,23.0,33.0,0
76,BA:8C:B9:54:50:24,3818308,482201204,1716,836147,3816592,481365057,0,5491,816183,5471,813061,20,3122,1001,14,2091,29,0,48,229410.0,130000.0,-49.0,-35.0,-42.0,-45.0,-43.0,-36.0,-44.0,-49.0,-90.0,-93.0,-90.0,-93.0,41.0,58.0,48.0,48.0,0
77,92:69:1D:31:68:E9,3820040,484813698,3445,3448305,3816595,481365393,0,3548,921851,3454,900996,94,20855,1769,6,3571,77,0,31,216660.0,130000.0,-52.0,-50.0,-44.0,-46.0,-51.0,-49.0,-44.0,-47.0,-90.0,-93.0,-90.0,-93.0,38.0,43.0,46.0,47.0,0
78,CC:2F:71:3F:1F:24,4393557,1161624724,576961,680259058,3816596,481365666,37,483779,555836219,483223,555769135,556,67084,466114,10,577198,41532,34,430,130000.0,39000.0,-67.0,-65.0,-71.0,-68.0,-67.0,-65.0,-70.0,-67.0,-90.0,-93.0,-90.0,-93.0,23.0,28.0,19.0,25.0,0
79,CC:2F:71:3E:C5:1F,3817269,481447838,672,82104,3816597,481365734,0,2886,241374,2393,182756,493,58618,712,8,1003,18,0,32,144444.0,39000.0,-70.0,-71.0,-67.0,-60.0,-70.0,-71.0,-67.0,-60.0,-90.0,-93.0,-90.0,-93.0,20.0,22.0,23.0,33.0,0
80,BA:8C:B9:54:50:24,3818316,482202283,1719,836549,3816597,481365734,0,5503,817129,5483,814007,20,3122,1003,14,2094,29,0,48,229410.0,130000.0,-40.0,-37.0,-45.0,-52.0,-42.0,-35.0,-42.0,-47.0,-90.0,-93.0,-90.0,-93.0,50.0,56.0,45.0,41.0,0
81,92:69:1D:31:68:E9,3820045,484814357,3446,3448421,3816599,481365936,0,3550,921987,3456,901132,94,20855,1769,6,3572,77,0,31,216660.0,130000.0,-52.0,-50.0,-44.0,-46.0,-51.0,-49.0,-44.0,-47.0,-90.0,-93.0,-90.0,-93.0,38.0,43.0,46.0,47.0,0
82,CC:2F:71:3F:1F:24,4393601,1161639354,577002,680273418,3816599,481365936,37,483805,555841249,483249,555774165,556,67084,466139,10,577239,41539,34,430,130000.0,43333.0,-67.0,-65.0,-70.0,-67.0,-67.0,-65.0,-70.0,-67.0,-90.0,-93.0,-90.0,-93.0,23.0,28.0,20.0,26.0,0
83,CC:2F:71:3E:C5:1F,3817271,481448040,672,82104,3816599,481365936,0,2887,241444,2394,182826,493,58618,712,8,1003,18,0,32,144444.0,39000.0,-70.0,-71.0,-67.0,-60.0,-70.0,-71.0,-67.0,-60.0,-90.0,-93.0,-90.0,-93.0,20.0,22.0,23.0,33.0,0
84,BA:8C:B9:54:50:24,3818320,482202687,1719,836549,3816601,481366138,0,5503,817129,5483,814007,20,3122,1003,14,2094,29,0,48,229410.0,130000.0,-40.0,-37.0,-45.0,-52.0,-42.0,-35.0,-42.0,-47.0,-90.0,-93.0,-90.0,-93.0,50.0,56.0,45.0,41.0,0
85,92:69:1D:31:68:E9,3820050,484814821,3446,3448421,3816604,481366400,0,3550,921987,3456,901132,94,20855,1769,6,3572,77,0,31,216660.0,130000.0,-52.0,-50.0,-44.0,-46.0,-51.0,-49.0,-44.0,-47.0,-90.0,-93.0,-90.0,-93.0,38.0,43.0,46.0,47.0,0
86,CC:2F:71:3F:1F:24,4393649,1161654370,577045,680287970,3816604,481366400,37,483830,555846053,483274,555778969,556,67084,466164,10,577282,41553,34,430,117000.0,39000.0,-67.0,-65.0,-70.0,-67.0,-67.0,-65.0,-70.0,-67.0,-90.0,-93.0,-90.0,-93.0,23.0,28.0,20.0,26.0,0
87,CC:2F:71:3E:C5:1F,3817277,481448638,672,82104,3816605,481366534,0,2887,241444,2394,182826,493,58618,712,8,1003,18,0,32,144444.0,39000.0,-70.0,-71.0,-67.0,-60.0,-70.0,-71.0,-67.0,-60.0,-90.0,-93.0,-90.0,-93.0,20.0,22.0,23.0,33.0,0
88,BA:8C:B9:54:50:24,3818325,482203151,1719,836549,3816606,481366602,0,5503,817129,5483,814007,20,3122,1003,14,2094,29,0,48,229410.0,130000.0,-40.0,-37.0,-45.0,-52.0,-42.0,-35.0,-42.0,-47.0,-90.0,-93.0,-90.0,-93.0,50.0,56.0,45.0,41.0,0
89,92:69:1D:31:68:E9,3820054,484815225,3446,3448421,3816608,481366804,0,3550,921987,3456,901132,94,20855,1769,6,3572,77,0,31,216660.0,130000.0,-52.0,-50.0,-44.0,-46.0,-51.0,-49.0,-44.0,-47.0,-90.0,-93.0,-90.0,-93.0,38.0,43.0,46.0,47.0,0
90,CC:2F:71:3F:1F:24,4393695,1161669202,577087,680302398,3816608,481366804,37,483857,555851149,483301,555784065,556,67084,466191,10,577324,41560,34,430,130000.0,43333.0,-67.0,-65.0,-71.0,-68.0,-67.0,-65.0,-70.0,-67.0,-90.0,-93.0,-90.0,-93.0,23.0,28.0,19.0,25.0,0
91,CC:2F:71:3E:C5:1F,3817280,481448908,672,82104,3816608,481366804,0,2887,241444,2394,182826,493,58618,712,8,1003,18,0,32,144444.0,39000.0,-70.0,-71.0,-67.0,-60.0,-70.0,-71.0,-67.0,-60.0,-90.0,-93.0,-90.0,-93.0,20.0,22.0,23.0,33.0,0
92,BA:8C:B9:54:50:24,3818329,482203555,1719,836549,3816610,481367006,0,5503,817129,5483,814007,20,3122,1003,14,2094,29,0,48,229410.0,130000.0,-40.0,-37.0,-45.0,-52.0,-42.0,-35.0,-42.0,-47.0,-90.0,-93.0,-90.0,-93.0,50.0,56.0,45.0,41.0,0
93,92:69:1D:31:68:E9,3820060,484815997,3446,3448421,3816614,481367576,0,3550,921987,3456,901132,94,20855,1769,6,3572,77,0,31,216660.0,130000.0,-52.0,-50.0,-44.0,-46.0,-51.0,-49.0,-44.0,-47.0,-90.0,-93.0,-90.0,-93.0,38.0,43.0,46.0,47.0,0
94,CC:2F:71:3F:1F:24,4393744,1161684588,577130,680317012,3816614,481367576,37,483884,555856233,483328,555789149,556,67084,466218,10,577367,41578,34,430,130000.0,39000.0,-67.0,-65.0,-70.0,-67.0,-67.0,-65.0,-70.0,-67.0,-90.0,-93.0,-90.0,-93.0,23.0,28.0,20.0,26.0,0
95,CC:2F:71:3E:C5:1F,3817286,481449680,672,82104,3816614,481367576,0,2887,241444,2394,182826,493,58618,712,8,1003,18,0,32,144444.0,39000.0,-70.0,-71.0,-67.0,-60.0,-70.0,-71.0,-67.0,-60.0,-90.0,-93.0,-90.0,-93.0,20.0,22.0,23.0,33.0,0
96,BA:8C:B9:54:50:24,3818335,482204327,1719,836549,3816616,481367778,0,5503,817129,5483,814007,20,3122,1003,14,2094,29,0,48,229410.0,130000.0,-40.0,-37.0,-45.0,-52.0,-42.0,-35.0,-42.0,-47.0,-90.0,-93.0,-90.0,-93.0,50.0,56.0,45.0,41.0,0
97,92:69:1D:31:68:E9,3820065,484816461,3446,3448421,3816619,481368040,0,3550,921987,3456,901132,94,20855,1769,6,3572,77,0,31,216660.0,130000.0,-52.0,-50.0,-44.0,-46.0,-51.0,-49.0,-44.0,-47.0,-90.0,-93.0,-90.0,-93.0,38.0,43.0,46.0,47.0,0
98,CC:2F:71:3F:1F:24,4393791,1161699424,577172,680331384,3816619,481368040,37,483911,555861293,483355,555794209,556,67084,466245,10,577409,41591,34,430,130000.0,43333.0,-67.0,-65.0,-70.0,-68.0,-67.0,-65.0,-70.0,-67.0,-90.0,-93.0,-90.0,-93.0,23.0,28.0,20.0,25.0,0
99,CC:2F:71:3E:C5:1F,3817291,481450144,672,82104,3816619,481368040,0,2887,241444,2394,182826,493,58618,712,8,1003,18,0,32,144444.0,39000.0,-70.0,-71.0,-67.0,-60.0,-70.0,-71.0,-67.0,-60.0,-90.0,-93.0,-90.0,-93.0,20.0,22.0,23.0,33.0,0
100,BA:8C:B9:54:50:24,3818340,482204791,1719,836549,3816621,481368242,0,5503,817129,5483,814007,20,3122,1003,14,2094,29,0,48,229410.0,130000.0,-40.0,-37.0,-45.0,-52.0,-42.0,-35.0,-42.0,-47.0,-90.0,-93.0,-90.0,-93.0,50.0,56.0,45.0,41.0,0
101,92:69:1D:31:68:E9,3820069,484816865,3446,3448421,3816623,481368444,0,3550,921987,3456,901132,94,20855,1769,6,3572,77,0,31,216660.0,130000.0,-52.0,-50.0,-44.0,-46.0,-51.0,-49.0,-44.0,-47.0,-90.0,-93.0,-90.0,-93.0,38.0,43.0,46.0,47.0,0
102,CC:2F:71:3F:1F:24,4393837,1161714256,577214,680345812,3816623,481368444,37,483939,555866445,483383,555799361,556,67084,466273,10,577451,41606,34,430,117000.0,39000.0,-67.0,-65.0,-70.0,-67.0,-67.0,-65.0,-70.0,-67.0,-90.0,-93.0,-90.0,-93.0,23.0,28.0,20.0,26.0,0
103,CC:2F:71:3E:C5:1F,3817295,481450548,672,82104,3816623,481368444,0,2887,241444,2394,182826,493,58618,712,8,1003,18,0,32,144444.0,39000.0,-70.0,-71.0,-67.0,-60.0,-70.0,-71.0,-67.0,-60.0,-90.0,-93.0,-90.0,-93.0,20.0,22.0,23.0,33.0,0
104,BA:8C:B9:54:50:24,3818344,482205195,1719,836549,3816625,481368646,0,5503,817129,5483,814007,20,3122,1003,14,2094,29,0,48,229410.0,130000.0,-40.0,-37.0,-45.0,-52.0,-42.0,-35.0,-42.0,-47.0,-90.0,-93.0,-90.0,-93.0,50.0,56.0,45.0,41.0,0
105,92:69:1D:31:68:E9,3820074,484817331,3446,3448421,3816628,481368910,0,3550,921987,3456,901132,94,20855,1769,6,3572,77,0,31,216660.0,130000.0,-52.0,-50.0,-44.0,-46.0,-51.0,-49.0,-44.0,-47.0,-90.0,-93.0,-90.0,-93.0,38.0,43.0,46.0,47.0,0
106,CC:2F:71:3F:1F:24,4393885,1161729274,577257,680360364,3816628,481368910,37,483965,555871389,483409,555804305,556,67084,466299,10,577494,41609,34,430,130000.0,43333.0,-67.0,-65.0,-71.0,-68.0,-67.0,-65.0,-70.0,-67.0,-90.0,-93.0,-90.0,-93.0,23.0,28.0,19.0,25.0,0
107,CC:2F:71:3E:C5:1F,3817301,481451074,672,82104,3816629,481368970,0,2889,241632,2395,182896,494,58736,713,8,1003,18,0,32,144444.0,39000.0,-70.0,-71.0,-67.0,-60.0,-70.0,-71.0,-67.0,-60.0,-90.0,-93.0,-90.0,-93.0,20.0,22.0,23.0,33.0,0
108,BA:8C:B9:54:50:24,3818351,482205837,1720,836665,3816631,481369172,0,5506,817375,5486,814253,20,3122,1004,14,2095,29,0,48,229410.0,130000.0,-49.0,-35.0,-42.0,-44.0,-42.0,-35.0,-42.0,-47.0,-90.0,-93.0,-90.0,-93.0,41.0,58.0,48.0,49.0,0
109,92:69:1D:31:68:E9,3820079,484817795,3446,3448421,3816633,481369374,0,3550,921987,3456,901132,94,20855,1769,6,3572,77,0,31,216660.0,130000.0,-52.0,-50.0,-44.0,-46.0,-51.0,-49.0,-44.0,-47.0,-90.0,-93.0,-90.0,-93.0,38.0,43.0,46.0,47.0,0
110,CC:2F:71:3F:1F:24,4393930,1161744030,577297,680374656,3816633,481369374,37,483991,555876333,483435,555809249,556,67084,466325,10,577534,41614,34,430,130000.0,43333.0,-67.0,-65.0,-71.0,-68.0,-67.0,-65.0,-70.0,-67.0,-90.0,-93.0,-90.0,-93.0,23.0,28.0,19.0,25.0,0
111,CC:2F:71:3E:C5:1F,3817305,481451478,672,82104,3816633,481369374,0,2889,241632,2395,182896,494,58736,713,8,1003,18,0,32,144444.0,39000.0,-70.0,-71.0,-67.0,-60.0,-70.0,-71.0,-67.0,-60.0,-90.0,-93.0,-90.0,-93.0,20.0,22.0,23.0,33.0,0
112,BA:8C:B9:54:50:24,3818353,482206039,1720,836665,3816633,481369374,0,5506,817375,5486,814253,20,3122,1004,14,2095,29,0,48,229410.0,130000.0,-49.0,-35.0,-42.0,-44.0,-42.0,-35.0,-42.0,-47.0,-90.0,-93.0,-90.0,-93.0,41.0,58.0,48.0,49.0,0
113,92:69:1D:31:68:E9,3820083,484818199,3446,3448421,3816637,481369778,0,3550,921987,3456,901132,94,20855,1769,6,3572,77,0,31,216660.0,130000.0,-52.0,-50.0,-44.0,-46.0,-51.0,-49.0,-44.0,-47.0,-90.0,-93.0,-90.0,-93.0,38.0,43.0,46.0,47.0,0
114,CC:2F:71:3F:1F:24,4393976,1161758862,577339,680389084,3816637,481369778,37,484018,555881393,483462,555814309,556,67084,466352,10,577576,41634,34,430,117000.0,39000.0,-67.0,-65.0,-70.0,-67.0,-67.0,-65.0,-70.0,-67.0,-90.0,-93.0,-90.0,-93.0,23.0,28.0,20.0,26.0,0
115,CC:2F:71:3E:C5:1F,3817309,481451882,672,82104,3816637,481369778,0,2889,241632,2395,182896,494,58736,713,8,1003,18,0,32,144444.0,39000.0,-70.0,-71.0,-67.0,-60.0,-70.0,-71.0,-67.0,-60.0,-90.0,-93.0,-90.0,-93.0,20.0,22.0,23.0,33.0,0
116,BA:8C:B9:54:50:24,3818359,482206645,1720,836665,3816639,481369980,0,5506,817375,5486,814253,20,3122,1004,14,2095,29,0,48,229410.0,130000.0,-49.0,-35.0,-42.0,-44.0,-42.0,-35.0,-42.0,-47.0,-90.0,-93.0,-90.0,-93.0,41.0,58.0,48.0,49.0,0
117,92:69:1D:31:68:E9,3820088,484818663,3446,3448421,3816642,481370242,0,3550,921987,3456,901132,94,20855,1769,6,3572,77,0,31,216660.0,130000.0,-52.0,-50.0,-44.0,-46.0,-51.0,-49.0,-44.0,-47.0,-90.0,-93.0,-90.0,-93.0,38.0,43.0,46.0,47.0,0
118,CC:2F:71:3F:1F:24,4394024,1161773878,577382,680403636,3816642,481370242,37,484047,555886685,483491,555819601,556,67084,466381,10,577619,41635,34,430,130000.0,43333.0,-67.0,-65.0,-71.0,-67.0,-67.0,-65.0,-70.0,-67.0,-90.0,-93.0,-90.0,-93.0,23.0,28.0,19.0,26.0,0
119,CC:2F:71:3E:C5:1F,3817314,481452346,672,82104,3816642,481370242,0,2889,241632,2395,182896,494,58736,713,8,1003,18,0,32,144444.0,39000.0,-70.0,-71.0,-67.0,-60.0,-70.0,-71.0,-67.0,-60.0,-90.0,-93.0,-90.0,-93.0,20.0,22.0,23.0,33.0,0
120,BA:8C:B9:54:50:24,3818362,482206907,1720,836665,3816642,481370242,0,5506,817375,5486,814253,20,3122,1004,14,2095,29,0,48,229410.0,130000.0,-49.0,-35.0,-42.0,-44.0,-42.0,-35.0,-42.0,-47.0,-90.0,-93.0,-90.0,-93.0,41.0,58.0,48.0,49.0,0
121,92:69:1D:31:68:E9,3820092,484819067,3446,3448421,3816646,481370646,0,3550,921987,3456,901132,94,20855,1769,6,3572,77,0,31,216660.0,130000.0,-52.0,-50.0,-44.0,-46.0,-51.0,-49.0,-44.0,-47.0,-90.0,-93.0,-90.0,-93.0,38.0,43.0,46.0,47.0,0
122,CC:2F:71:3F:1F:24,4394072,1161789014,577426,680418368,3816646,481370646,37,484073,555891605,483517,555824521,556,67084,466407,10,577662,41640,34,430,130000.0,39000.0,-67.0,-65.0,-70.0,-67.0,-67.0,-65.0,-70.0,-67.0,-90.0,-93.0,-90.0,-93.0,23.0,28.0,20.0,26.0,0
123,CC:2F:71:3E:C5:1F,3817318,481452750,672,82104,3816646,481370646,0,2889,241632,2395,182896,494,58736,713,8,1003,18,0,32,144444.0,39000.0,-70.0,-71.0,-67.0,-60.0,-70.0,-71.0,-67.0,-60.0,-90.0,-93.0,-90.0,-93.0,20.0,22.0,23.0,33.0,0
124,BA:8C:B9:54:50:24,3818368,482207513,1720,836665,3816648,481370848,0,5506,817375,5486,814253,20,3122,1004,14,2095,29,0,48,229410.0,130000.0,-49.0,-35.0,-42.0,-44.0,-42.0,-35.0,-42.0,-47.0,-90.0,-93.0,-90.0,-93.0,41.0,58.0,48.0,49.0,0
125,92:69:1D:31:68:E9,3820096,484819471,3446,3448421,3816650,481371050,0,3550,921987,3456,901132,94,20855,1769,6,3572,77,0,31,216660.0,130000.0,-52.0,-50.0,-44.0,-46.0,-51.0,-49.0,-44.0,-47.0,-90.0,-93.0,-90.0,-93.0,38.0,43.0,46.0,47.0,0
126,CC:2F:71:3F:1F:24,4394119,1161803908,577468,680432796,3816651,481371112,37,484101,555896819,483544,555829617,557,67202,466435,10,577705,41653,34,430,130000.0,43333.0,-67.0,-65.0,-71.0,-68.0,-67.0,-65.0,-70.0,-67.0,-90.0,-93.0,-90.0,-93.0,23.0,28.0,19.0,25.0,0
127,CC:2F:71:3E:C5:1F,3817323,481453216,672,82104,3816651,481371112,0,2889,241632,2395,182896,494,58736,713,8,1003,18,0,32,144444.0,39000.0,-70.0,-71.0,-67.0,-60.0,-70.0,-71.0,-67.0,-60.0,-90.0,-93.0,-90.0,-93.0,20.0,22.0,23.0,33.0,0
128,BA:8C:B9:54:50:24,3818371,482207777,1720,836665,3816651,481371112,0,5506,817375,5486,814253,20,3122,1004,14,2095,29,0,48,229410.0,130000.0,-49.0,-35.0,-42.0,-44.0,-42.0,-35.0,-42.0,-47.0,-90.0,-93.0,-90.0,-93.0,41.0,58.0,48.0,49.0,0
129,92:69:1D:31:68:E9,3820102,484819997,3446,3448421,3816656,481371576,0,3550,921987,3456,901132,94,20855,1769,6,3572,77,0,31,216660.0,130000.0,-52.0,-50.0,-44.0,-46.0,-51.0,-49.0,-44.0,-47.0,-90.0,-93.0,-90.0,-93.0,38.0,43.0,46.0,47.0,0
130,CC:2F:71:3F:1F:24,4394165,1161818732,577509,680447156,3816656,481371576,37,484127,555901739,483570,555834537,557,67202,466461,10,577746,41655,34,430,130000.0,43333.0,-67.0,-65.0,-71.0,-68.0,-67.0,-65.0,-70.0,-67.0,-90.0,-93.0,-90.0,-93.0,23.0,28.0,19.0,25.0,0
131,CC:2F:71:3E:C5:1F,3817328,481453680,672,82104,3816656,481371576,0,2889,241632,2395,182896,494,58736,713,8,1003,18,0,32,144444.0,39000.0,-70.0,-71.0,-67.0,-60.0,-70.0,-71.0,-67.0,-60.0,-90.0,-93.0,-90.0,-93.0,20.0,22.0,23.0,33.0,0
132,BA:8C:B9:54:50:24,3818379,482208716,1720,836665,3816659,481372051,0,5506,817375,5486,814253,20,3122,1004,14,2095,29,0,48,229410.0,130000.0,-49.0,-35.0,-42.0,-44.0,-42.0,-35.0,-42.0,-47.0,-90.0,-93.0,-90.0,-93.0,41.0,58.0,48.0,49.0,0
133,92:69:1D:31:68:E9,3820107,484820674,3446,3448421,3816661,481372253,0,3550,921987,3456,901132,94,20855,1769,6,3572,77,0,31,216660.0,130000.0,-52.0,-50.0,-44.0,-46.0,-51.0,-49.0,-44.0,-47.0,-90.0,-93.0,-90.0,-93.0,38.0,43.0,46.0,47.0,0
134,CC:2F:71:3F:1F:24,4394211,1161833713,577550,680461460,3816661,481372253,37,484155,555906891,483598,555839689,557,67202,466489,10,577787,41664,34,430,117000.0,39000.0,-67.0,-65.0,-70.0,-68.0,-67.0,-65.0,-70.0,-67.0,-90.0,-93.0,-90.0,-93.0,23.0,28.0,20.0,25.0,0
135,CC:2F:71:3E:C5:1F,3817333,481454357,672,82104,3816661,481372253,0,2889,241632,2395,182896,494,58736,713,8,1003,18,0,32,144444.0,39000.0,-70.0,-71.0,-67.0,-60.0,-70.0,-71.0,-67.0,-60.0,-90.0,-93.0,-90.0,-93.0,20.0,22.0,23.0,33.0,0
136,BA:8C:B9:54:50:24,3818381,482208918,1720,836665,3816661,481372253,0,5506,817375,5486,814253,20,3122,1004,14,2095,29,0,48,229410.0,130000.0,-49.0,-35.0,-42.0,-44.0,-42.0,-35.0,-42.0,-47.0,-90.0,-93.0,-90.0,-93.0,41.0,58.0,48.0,49.0,0
137,92:69:1D:31:68:E9,3820112,484821138,3446,3448421,3816666,481372717,0,3550,921987,3456,901132,94,20855,1769,6,3572,77,0,31,216660.0,130000.0,-52.0,-50.0,-44.0,-46.0,-51.0,-49.0,-44.0,-47.0,-90.0,-93.0,-90.0,-93.0,38.0,43.0,46.0,47.0,0
138,CC:2F:71:3F:1F:24,4394258,1161848549,577592,680475832,3816666,481372717,37,484181,555911835,483624,555844633,557,67202,466515,10,577829,41676,34,430,130000.0,39000.0,-67.0,-66.0,-71.0,-68.0,-67.0,-65.0,-70.0,-67.0,-90.0,-93.0,-90.0,-93.0,23.0,27.0,19.0,25.0,0
139,CC:2F:71:3E:C5:1F,3817338,481454821,672,82104,3816666,481372717,0,2889,241632,2395,182896,494,58736,713,8,1003,18,0,32,144444.0,39000.0,-70.0,-71.0,-67.0,-60.0,-70.0,-71.0,-67.0,-60.0,-90.0,-93.0,-90.0,-93.0,20.0,22.0,23.0,33.0,0
140,BA:8C:B9:54:50:24,3818386,482209382,1720,836665,3816666,481372717,0,5507,817443,5487,814321,20,3122,1004,14,2095,29,0,48,229410.0,130000.0,-40.0,-37.0,-45.0,-51.0,-42.0,-35.0,-43.0,-48.0,-90.0,-93.0,-90.0,-93.0,50.0,56.0,45.0,42.0,0
141,92:69:1D:31:68:E9,3820116,484821542,3446,3448421,3816670,481373121,0,3550,921987,3456,901132,94,20855,1769,6,3572,77,0,31,216660.0,130000.0,-52.0,-50.0,-44.0,-46.0,-51.0,-49.0,-44.0,-47.0,-90.0,-93.0,-90.0,-93.0,38.0,43.0,46.0,47.0,0
142,CC:2F:71:3F:1F:24,4394305,1161863561,577635,680490440,3816670,481373121,37,484208,555916895,483651,555849693,557,67202,466542,10,577872,41703,34,430,130000.0,39000.0,-67.0,-65.0,-70.0,-68.0,-67.0,-65.0,-70.0,-68.0,-90.0,-93.0,-90.0,-93.0,23.0,28.0,20.0,25.0,0
143,CC:2F:71:3E:C5:1F,3817342,481455225,672,82104,3816670,481373121,0,2889,241632,2395,182896,494,58736,713,8,1003,18,0,32,144444.0,39000.0,-70.0,-71.0,-67.0,-60.0,-70.0,-71.0,-67.0,-60.0,-90.0,-93.0,-90.0,-93.0,20.0,22.0,23.0,33.0,0
144,BA:8C:B9:54:50:24,3818390,482209786,1720,836665,3816670,481373121,0,5507,817443,5487,814321,20,3122,1004,14,2095,29,0,48,229410.0,130000.0,-40.0,-37.0,-45.0,-51.0,-42.0,-35.0,-43.0,-48.0,-90.0,-93.0,-90.0,-93.0,50.0,56.0,45.0,42.0,0
145,92:69:1D:31:68:E9,3820120,484821946,3446,3448421,3816674,481373525,0,3550,921987,3456,901132,94,20855,1769,6,3572,77,0,31,216660.0,130000.0,-52.0,-50.0,-44.0,-46.0,-51.0,-49.0,-44.0,-47.0,-90.0,-93.0,-90.0,-93.0,38.0,43.0,46.0,47.0,0
146,CC:2F:71:3F:1F:24,4394351,1161878393,577677,680504868,3816674,481373525,37,484234,555921875,483677,555854673,557,67202,466568,10,577914,41704,34,430,130000.0,43333.0,-67.0,-65.0,-70.0,-67.0,-67.0,-65.0,-70.0,-67.0,-90.0,-93.0,-90.0,-93.0,23.0,28.0,20.0,26.0,0
147,CC:2F:71:3E:C5:1F,3817346,481455629,672,82104,3816674,481373525,0,2889,241632,2395,182896,494,58736,713,8,1003,18,0,32,144444.0,39000.0,-70.0,-71.0,-67.0,-60.0,-70.0,-71.0,-67.0,-60.0,-90.0,-93.0,-90.0,-93.0,20.0,22.0,23.0,33.0,0
148,BA:8C:B9:54:50:24,3818394,482210190,1720,836665,3816674,481373525,0,5507,817443,5487,814321,20,3122,1004,14,2095,29,0,48,229410.0,130000.0,-40.0,-37.0,-45.0,-51.0,-42.0,-35.0,-43.0,-48.0,-90.0,-93.0,-90.0,-93.0,50.0,56.0,45.0,42.0,0
149,92:69:1D:31:68:E9,3820125,484822410,3446,3448421,3816679,481373989,0,3550,921987,3456,901132,94,20855,1769,6,3572,77,0,31,216660.0,130000.0,-52.0,-50.0,-44.0,-46.0,-51.0,-49.0,-44.0,-47.0,-90.0,-93.0,-90.0,-93.0,38.0,43.0,46.0,47.0,0
150,CC:2F:71:3F:1F:24,4394400,1161893539,577721,680519550,3816679,481373989,37,484260,555926819,483703,555859617,557,67202,466594,10,577958,41718,34,430,117000.0,39000.0,-67.0,-65.0,-70.0,-68.0,-67.0,-65.0,-70.0,-67.0,-90.0,-93.0,-90.0,-93.0,23.0,28.0,20.0,25.0,0
151,CC:2F:71:3E:C5:1F,3817351,481456093,672,82104,3816679,481373989,0,2889,241632,2395,182896,494,58736,713,8,1003,18,0,32,144444.0,39000.0,-70.0,-71.0,-67.0,-60.0,-70.0,-71.0,-67.0,-60.0,-90.0,-93.0,-90.0,-93.0,20.0,22.0,23.0,33.0,0
152,BA:8C:B9:54:50:24,3818399,482210654,1720,836665,3816679,481373989,0,5507,817443,5487,814321,20,3122,1004,14,2095,29,0,48,229410.0,130000.0,-40.0,-37.0,-45.0,-51.0,-42.0,-35.0,-43.0,-48.0,-90.0,-93.0,-90.0,-93.0,50.0,56.0,45.0,42.0,0
153,92:69:1D:31:68:E9,3820152,484828897,3469,3454504,3816683,481374393,0,3578,927484,3484,906629,94,20855,1790,6,3595,78,0,31,229410.0,130000.0,-51.0,-50.0,-44.0,-46.0,-52.0,-51.0,-45.0,-51.0,-90.0,-93.0,-90.0,-93.0,39.0,43.0,46.0,47.0,0
154,CC:2F:71:3F:1F:24,4394446,1161908371,577763,680533978,3816683,481374393,37,484285,555931623,483728,555864421,557,67202,466619,10,578000,41722,34,430,130000.0,43333.0,-67.0,-65.0,-70.0,-68.0,-67.0,-65.0,-70.0,-67.0,-90.0,-93.0,-90.0,-93.0,23.0,28.0,20.0,25.0,0
155,CC:2F:71:3E:C5:1F,3817355,481456497,672,82104,3816683,481374393,0,2889,241632,2395,182896,494,58736,713,8,1003,18,0,32,144444.0,39000.0,-70.0,-71.0,-67.0,-60.0,-70.0,-71.0,-67.0,-60.0,-90.0,-93.0,-90.0,-93.0,20.0,22.0,23.0,33.0,0
156,BA:8C:B9:54:50:24,3818403,482211058,1720,836665,3816683,481374393,0,5507,817443,5487,814321,20,3122,1004,14,2095,29,0,48,229410.0,130000.0,-40.0,-37.0,-45.0,-51.0,-42.0,-35.0,-43.0,-48.0,-90.0,-93.0,-90.0,-93.0,50.0,56.0,45.0,42.0,0
157,92:69:1D:31:68:E9,3820156,484829301,3469,3454504,3816687,481374797,0,3578,927484,3484,906629,94,20855,1790,6,3595,78,0,31,229410.0,130000.0,-51.0,-50.0,-44.0,-46.0,-52.0,-51.0,-45.0,-51.0,-90.0,-93.0,-90.0,-93.0,39.0,43.0,46.0,47.0,0
158,CC:2F:71:3F:1F:24,4394493,1161923439,577806,680548642,3816687,481374797,37,484311,555936543,483754,555869341,557,67202,466645,10,578043,41726,34,430,130000.0,43333.0,-67.0,-65.0,-70.0,-67.0,-67.0,-65.0,-70.0,-67.0,-90.0,-93.0,-90.0,-93.0,23.0,28.0,20.0,26.0,0
159,CC:2F:71:3E:C5:1F,3817359,481456901,672,82104,3816687,481374797,0,2889,241632,2395,182896,494,58736,713,8,1003,18,0,32,144444.0,39000.0,-70.0,-71.0,-67.0,-60.0,-70.0,-71.0,-67.0,-60.0,-90.0,-93.0,-90.0,-93.0,20.0,22.0,23.0,33.0,0
160,BA:8C:B9:54:50:24,3818407,482211462,1720,836665,3816687,481374797,0,5507,817443,5487,814321,20,3122,1004,14,2095,29,0,48,229410.0,130000.0,-40.0,-37.0,-45.0,-51.0,-42.0,-35.0,-43.0,-48.0,-90.0,-93.0,-90.0,-93.0,50.0,56.0,45.0,42.0,0
161,92:69:1D:31:68:E9,3820161,484829765,3469,3454504,3816692,481375261,0,3578,927484,3484,906629,94,20855,1790,6,3595,78,0,31,229410.0,130000.0,-51.0,-50.0,-44.0,-46.0,-52.0,-51.0,-45.0,-51.0,-90.0,-93.0,-90.0,-93.0,39.0,43.0,46.0,47.0,0
162,CC:2F:71:3F:1F:24,4394539,1161938207,577847,680562946,3816692,481375261,37,484336,555941347,483779,555874145,557,67202,466670,10,578084,41746,34,430,117000.0,39000.0,-67.0,-65.0,-70.0,-68.0,-67.0,-65.0,-70.0,-67.0,-90.0,-93.0,-90.0,-93.0,23.0,28.0,20.0,25.0,0
163,CC:2F:71:3E:C5:1F,3817364,481457365,672,82104,3816692,481375261,0,2889,241632,2395,182896,494,58736,713,8,1003,18,0,32,144444.0,39000.0,-70.0,-71.0,-67.0,-60.0,-70.0,-71.0,-67.0,-60.0,-90.0,-93.0,-90.0,-93.0,20.0,22.0,23.0,33.0,0
164,BA:8C:B9:54:50:24,3818412,482211926,1720,836665,3816692,481375261,0,5507,817443,5487,814321,20,3122,1004,14,2095,29,0,48,229410.0,130000.0,-40.0,-37.0,-45.0,-51.0,-42.0,-35.0,-43.0,-48.0,-90.0,-93.0,-90.0,-93.0,50.0,56.0,45.0,42.0,0
165,92:69:1D:31:68:E9,3820165,484830169,3469,3454504,3816696,481375665,0,3578,927484,3484,906629,94,20855,1790,6,3595,78,0,31,229410.0,130000.0,-51.0,-50.0,-44.0,-46.0,-52.0,-51.0,-45.0,-51.0,-90.0,-93.0,-90.0,-93.0,39.0,43.0,46.0,47.0,0
166,CC:2F:71:3F:1F:24,4394585,1161952983,577889,680577318,3816696,481375665,37,484362,555946267,483805,555879065,557,67202,466696,10,578126,41761,34,430,130000.0,39000.0,-67.0,-65.0,-70.0,-68.0,-67.0,-65.0,-70.0,-67.0,-90.0,-93.0,-90.0,-93.0,23.0,28.0,20.0,25.0,0
167,CC:2F:71:3E:C5:1F,3817368,481457769,672,82104,3816696,481375665,0,2889,241632,2395,182896,494,58736,713,8,1003,18,0,32,144444.0,39000.0,-70.0,-71.0,-67.0,-60.0,-70.0,-71.0,-67.0,-60.0,-90.0,-93.0,-90.0,-93.0,20.0,22.0,23.0,33.0,0
168,BA:8C:B9:54:50:24,3818416,482212330,1720,836665,3816696,481375665,0,5507,817443,5487,814321,20,3122,1004,14,2095,29,0,48,229410.0,130000.0,-40.0,-37.0,-45.0,-51.0,-42.0,-35.0,-43.0,-48.0,-90.0,-93.0,-90.0,-93.0,50.0,56.0,45.0,42.0,0
169,92:69:1D:31:68:E9,3820170,484830633,3469,3454504,3816701,481376129,0,3578,927484,3484,906629,94,20855,1790,6,3595,78,0,31,229410.0,130000.0,-51.0,-50.0,-44.0,-46.0,-52.0,-51.0,-45.0,-51.0,-90.0,-93.0,-90.0,-93.0,39.0,43.0,46.0,47.0,0
170,CC:2F:71:3F:1F:24,4394631,1161967751,577930,680591622,3816701,481376129,37,484388,555951211,483831,555884009,557,67202,466722,10,578167,41770,34,430,130000.0,39000.0,-67.0,-65.0,-71.0,-68.0,-67.0,-65.0,-70.0,-67.0,-90.0,-93.0,-90.0,-93.0,23.0,28.0,19.0,25.0,0
171,CC:2F:71:3E:C5:1F,3817373,481458233,672,82104,3816701,481376129,0,2889,241632,2395,182896,494,58736,713,8,1003,18,0,32,144444.0,39000.0,-70.0,-71.0,-67.0,-60.0,-70.0,-71.0,-67.0,-60.0,-90.0,-93.0,-90.0,-93.0,20.0,22.0,23.0,33.0,0
172,BA:8C:B9:54:50:24,3818421,482212794,1720,836665,3816701,481376129,0,5507,817443,5487,814321,20,3122,1004,14,2095,29,0,48,229410.0,130000.0,-40.0,-37.0,-45.0,-51.0,-42.0,-35.0,-43.0,-48.0,-90.0,-93.0,-90.0,-93.0,50.0,56.0,45.0,42.0,0
173,92:69:1D:31:68:E9,3820174,484831037,3469,3454504,3816705,481376533,0,3578,927484,3484,906629,94,20855,1790,6,3595,78,0,31,229410.0,130000.0,-51.0,-50.0,-44.0,-46.0,-52.0,-51.0,-45.0,-51.0,-90.0,-93.0,-90.0,-93.0,39.0,43.0,46.0,47.0,0
174,CC:2F:71:3F:1F:24,4394677,1161982639,577972,680606106,3816705,481376533,37,484413,555956015,483856,555888813,557,67202,466747,10,578209,41776,34,430,130000.0,43333.0,-67.0,-65.0,-70.0,-68.0,-67.0,-65.0,-70.0,-67.0,-90.0,-93.0,-90.0,-93.0,23.0,28.0,20.0,25.0,0
175,CC:2F:71:3E:C5:1F,3817377,481458637,672,82104,3816705,481376533,0,2889,241632,2395,182896,494,58736,713,8,1003,18,0,32,144444.0,39000.0,-70.0,-71.0,-67.0,-60.0,-70.0,-71.0,-67.0,-60.0,-90.0,-93.0,-90.0,-93.0,20.0,22.0,23.0,33.0,0
176,BA:8C:B9:54:50:24,3818425,482213198,1720,836665,3816705,481376533,0,5507,817443,5487,814321,20,3122,1004,14,2095,29,0,48,229410.0,130000.0,-40.0,-37.0,-45.0,-51.0,-42.0,-35.0,-43.0,-48.0,-90.0,-93.0,-90.0,-93.0,50.0,56.0,45.0,42.0,0
177,92:69:1D:31:68:E9,3820178,484831441,3469,3454504,3816709,481376937,0,3578,927484,3484,906629,94,20855,1790,6,3595,78,0,31,229410.0,130000.0,-51.0,-50.0,-44.0,-46.0,-52.0,-51.0,-45.0,-51.0,-90.0,-93.0,-90.0,-93.0,39.0,43.0,46.0,47.0,0
178,CC:2F:71:3F:1F:24,4394724,1161997595,578015,680620658,3816709,481376937,37,484439,555960959,483882,555893757,557,67202,466773,10,578252,41793,34,430,117000.0,39000.0,-67.0,-65.0,-70.0,-67.0,-67.0,-65.0,-70.0,-67.0,-90.0,-93.0,-90.0,-93.0,23.0,28.0,20.0,26.0,0
179,CC:2F:71:3E:C5:1F,3817381,481459041,672,82104,3816709,481376937,0,2889,241632,2395,182896,494,58736,713,8,1003,18,0,32,144444.0,39000.0,-70.0,-71.0,-67.0,-60.0,-70.0,-71.0,-67.0,-60.0,-90.0,-93.0,-90.0,-93.0,20.0,22.0,23.0,33.0,0
180,BA:8C:B9:54:50:24,3818429,482213602,1720,836665,3816709,481376937,0,5507,817443,5487,814321,20,3122,1004,14,2095,29,0,48,229410.0,130000.0,-40.0,-37.0,-45.0,-51.0,-42.0,-35.0,-43.0,-48.0,-90.0,-93.0,-90.0,-93.0,50.0,56.0,45.0,42.0,0
181,92:69:1D:31:68:E9,3820184,484832021,3470,3454620,3816714,481377401,0,3581,927730,3487,906875,94,20855,1791,6,3596,78,0,31,229410.0,130000.0,-51.0,-50.0,-44.0,-46.0,-52.0,-50.0,-45.0,-49.0,-90.0,-93.0,-90.0,-93.0,39.0,43.0,46.0,47.0,0
182,CC:2F:71:3F:1F:24,4394771,1162012487,578057,680635086,3816714,481377401,37,484465,555965903,483908,555898701,557,67202,466799,10,578294,41804,34,430,130000.0,43333.0,-67.0,-65.0,-70.0,-67.0,-67.0,-65.0,-70.0,-67.0,-90.0,-93.0,-90.0,-93.0,23.0,28.0,20.0,26.0,0
183,CC:2F:71:3E:C5:1F,3817386,481459505,672,82104,3816714,481377401,0,2889,241632,2395,182896,494,58736,713,8,1003,18,0,32,144444.0,39000.0,-70.0,-71.0,-67.0,-60.0,-70.0,-71.0,-67.0,-60.0,-90.0,-93.0,-90.0,-93.0,20.0,22.0,23.0,33.0,0
184,BA:8C:B9:54:50:24,3818434,482214066,1720,836665,3816714,481377401,0,5507,817443,5487,814321,20,3122,1004,14,2095,29,0,48,229410.0,130000.0,-40.0,-37.0,-45.0,-51.0,-42.0,-35.0,-43.0,-48.0,-90.0,-93.0,-90.0,-93.0,50.0,56.0,45.0,42.0,0
185,92:69:1D:31:68:E9,3820190,484832814,3471,3454736,3816719,481378078,0,3583,927866,3489,907011,94,20855,1791,6,3597,78,0,31,229410.0,130000.0,-51.0,-50.0,-44.0,-46.0,-51.0,-50.0,-44.0,-48.0,-90.0,-93.0,-90.0,-93.0,39.0,43.0,46.0,47.0,0
186,CC:2F:71:3F:1F:24,4394818,1162027578,578099,680649500,3816719,481378078,37,484490,555970749,483933,555903547,557,67202,466824,10,578335,41826,34,430,117000.0,39000.0,-67.0,-65.0,-71.0,-68.0,-67.0,-65.0,-70.0,-67.0,-90.0,-93.0,-90.0,-93.0,23.0,28.0,19.0,25.0,0
187,CC:2F:71:3E:C5:1F,3817392,481460298,673,82220,3816719,481378078,0,2891,241772,2397,183036,494,58736,713,8,1004,18,0,32,144444.0,39000.0,-70.0,-71.0,-67.0,-60.0,-70.0,-70.0,-67.0,-60.0,-90.0,-93.0,-90.0,-93.0,20.0,22.0,23.0,33.0,0
188,BA:8C:B9:54:50:24,3818440,482214859,1721,836781,3816719,481378078,0,5509,817579,5489,814457,20,3122,1004,14,2096,29,0,48,229410.0,130000.0,-40.0,-37.0,-44.0,-51.0,-43.0,-36.0,-43.0,-48.0,-90.0,-93.0,-90.0,-93.0,50.0,56.0,46.0,42.0,0
189,92:69:1D:31:68:E9,3820194,484833218,3471,3454736,3816723,481378482,0,3583,927866,3489,907011,94,20855,1791,6,3597,78,0,31,229410.0,130000.0,-51.0,-50.0,-44.0,-46.0,-51.0,-50.0,-44.0,-48.0,-90.0,-93.0,-90.0,-93.0,39.0,43.0,46.0,47.0,0
190,CC:2F:71:3F:1F:24,4394865,1162042540,578142,680664058,3816723,481378482,37,484518,555975973,483961,555908771,557,67202,466852,10,578379,41831,34,430,130000.0,43333.0,-67.0,-65.0,-70.0,-68.0,-67.0,-65.0,-70.0,-67.0,-90.0,-93.0,-90.0,-93.0,23.0,28.0,20.0,25.0,0
191,CC:2F:71:3E:C5:1F,3817397,481460762,673,82220,3816724,481378542,0,2891,241772,2397,183036,494,58736,713,8,1004,18,0,32,144444.0,39000.0,-70.0,-71.0,-67.0,-60.0,-70.0,-70.0,-67.0,-60.0,-91.0,-93.0,-90.0,-93.0,21.0,22.0,23.0,33.0,0
192,BA:8C:B9:54:50:24,3818445,482215323,1721,836781,3816724,481378542,0,5509,817579,5489,814457,20,3122,1004,14,2096,29,0,48,229410.0,130000.0,-40.0,-37.0,-44.0,-51.0,-43.0,-36.0,-43.0,-48.0,-91.0,-93.0,-90.0,-93.0,51.0,56.0,46.0,42.0,0
193,92:69:1D:31:68:E9,3820197,484833480,3471,3454736,3816726,481378744,0,3583,927866,3489,907011,94,20855,1791,6,3597,78,0,31,229410.0,130000.0,-51.0,-50.0,-44.0,-46.0,-51.0,-50.0,-44.0,-48.0,-91.0,-93.0,-90.0,-93.0,40.0,43.0,46.0,47.0,0
194,CC:2F:71:3F:1F:24,4394913,1162057668,578185,680678722,3816728,481378946,37,484544,555980917,483987,555913715,557,67202,466878,10,578422,41837,34,430,130000.0,43333.0,-67.0,-65.0,-70.0,-68.0,-67.0,-65.0,-70.0,-67.0,-91.0,-93.0,-90.0,-93.0,24.0,28.0,20.0,25.0,0
195,CC:2F:71:3E:C5:1F,3817401,481461166,673,82220,3816728,481378946,0,2891,241772,2397,183036,494,58736,713,8,1004,18,0,32,144444.0,39000.0,-70.0,-71.0,-67.0,-60.0,-70.0,-70.0,-67.0,-60.0,-91.0,-93.0,-90.0,-93.0,21.0,22.0,23.0,33.0,0
196,BA:8C:B9:54:50:24,3818449,482215727,1721,836781,3816728,481378946,0,5509,817579,5489,814457,20,3122,1004,14,2096,29,0,48,229410.0,130000.0,-40.0,-37.0,-44.0,-51.0,-43.0,-36.0,-43.0,-48.0,-91.0,-93.0,-90.0,-93.0,51.0,56.0,46.0,42.0,0
197,92:69:1D:31:68:E9,3820203,484834086,3471,3454736,3816732,481379350,0,3583,927866,3489,907011,94,20855,1791,6,3597,78,0,31,229410.0,130000.0,-51.0,-50.0,-44.0,-46.0,-51.0,-50.0,-44.0,-48.0,-91.0,-93.0,-90.0,-93.0,40.0,43.0,46.0,47.0,0
198,CC:2F:71:3F:1F:24,4394960,1162072624,578228,680693274,3816732,481379350,37,484571,555985977,484014,555918775,557,67202,466905,10,578465,41853,34,430,117000.0,39000.0,-67.0,-65.0,-70.0,-67.0,-67.0,-65.0,-70.0,-67.0,-91.0,-93.0,-90.0,-93.0,24.0,28.0,20.0,26.0,0
199,CC:2F:71:3E:C5:1F,3817405,481461570,673,82220,3816732,481379350,0,2891,241772,2397,183036,494,58736,713,8,1004,18,0,32,144444.0,39000.0,-70.0,-71.0,-67.0,-60.0,-70.0,-70.0,-67.0,-60.0,-91.0,-93.0,-90.0,-93.0,21.0,22.0,23.0,33.0,0
200,BA:8C:B9:54:50:24,3818453,482216131,1721,836781,3816732,481379350,0,5509,817579,5489,814457,20,3122,1004,14,2096,29,0,48,229410.0,130000.0,-40.0,-37.0,-44.0,-51.0,-43.0,-36.0,-43.0,-48.0,-91.0,-93.0,-90.0,-93.0,51.0,56.0,46.0,42.0,0
201,92:69:1D:31:68:E9,3820206,484834348,3471,3454736,3816735,481379612,0,3583,927866,3489,907011,94,20855,1791,6,3597,78,0,31,229410.0,130000.0,-51.0,-50.0,-44.0,-46.0,-51.0,-50.0,-44.0,-48.0,-90.0,-93.0,-90.0,-93.0,39.0,43.0,46.0,47.0,0
202,CC:2F:71:3F:1F:24,4395007,1162087516,578270,680707702,3816737,481379814,37,484596,555990781,484039,555923579,557,67202,466930,10,578507,41861,34,430,130000.0,43333.0,-67.0,-65.0,-71.0,-68.0,-67.0,-65.0,-70.0,-67.0,-90.0,-93.0,-90.0,-93.0,23.0,28.0,19.0,25.0,0
203,CC:2F:71:3E:C5:1F,3817410,481462034,673,82220,3816737,481379814,0,2891,241772,2397,183036,494,58736,713,8,1004,18,0,32,144444.0,39000.0,-70.0,-71.0,-67.0,-60.0,-70.0,-70.0,-67.0,-60.0,-90.0,-93.0,-90.0,-93.0,20.0,22.0,23.0,33.0,0
204,BA:8C:B9:54:50:24,3818458,482216595,1721,836781,3816737,481379814,0,5509,817579,5489,814457,20,3122,1004,14,2096,29,0,48,229410.0,130000.0,-40.0,-37.0,-44.0,-51.0,-43.0,-36.0,-43.0,-48.0,-90.0,-93.0,-90.0,-93.0,50.0,56.0,46.0,42.0,0
205,92:69:1D:31:68:E9,3820212,484834954,3471,3454736,3816741,481380218,0,3583,927866,3489,907011,94,20855,1791,6,3597,78,0,31,229410.0,130000.0,-51.0,-50.0,-44.0,-46.0,-51.0,-50.0,-44.0,-48.0,-90.0,-93.0,-90.0,-93.0,39.0,43.0,46.0,47.0,0
206,CC:2F:71:3F:1F:24,4395052,1162102336,578311,680722118,3816741,481380218,37,484622,555995725,484065,555928523,557,67202,466956,10,578548,41866,34,430,130000.0,43333.0,-67.0,-65.0,-70.0,-67.0,-67.0,-65.0,-70.0,-67.0,-90.0,-93.0,-90.0,-93.0,23.0,28.0,20.0,26.0,0
207,CC:2F:71:3E:C5:1F,3817414,481462438,673,82220,3816741,481380218,0,2891,241772,2397,183036,494,58736,713,8,1004,18,0,32,144444.0,39000.0,-70.0,-71.0,-67.0,-60.0,-70.0,-70.0,-67.0,-60.0,-90.0,-93.0,-90.0,-93.0,20.0,22.0,23.0,33.0,0
208,BA:8C:B9:54:50:24,3818462,482216999,1721,836781,3816741,481380218,0,5509,817579,5489,814457,20,3122,1004,14,2096,29,0,48,229410.0,130000.0,-40.0,-37.0,-44.0,-51.0,-43.0,-36.0,-43.0,-48.0,-90.0,-93.0,-90.0,-93.0,50.0,56.0,46.0,42.0,0
209,92:69:1D:31:68:E9,3820214,484835156,3471,3454736,3816743,481380420,0,3583,927866,3489,907011,94,20855,1791,6,3597,78,0,31,229410.0,130000.0,-51.0,-50.0,-44.0,-46.0,-51.0,-50.0,-44.0,-48.0,-90.0,-93.0,-90.0,-93.0,39.0,43.0,46.0,47.0,0
210,CC:2F:71:3F:1F:24,4395099,1162117242,578354,680736620,3816745,481380622,37,484647,556000529,484090,555933327,557,67202,466981,10,578591,41905,34,430,144444.0,39000.0,-67.0,-65.0,-70.0,-67.0,-67.0,-65.0,-70.0,-67.0,-90.0,-93.0,-90.0,-93.0,23.0,28.0,20.0,26.0,0
211,CC:2F:71:3E:C5:1F,3817418,481462842,673,82220,3816745,481380622,0,2891,241772,2397,183036,494,58736,713,8,1004,18,0,32,144444.0,39000.0,-70.0,-71.0,-67.0,-60.0,-70.0,-70.0,-67.0,-60.0,-90.0,-93.0,-90.0,-93.0,20.0,22.0,23.0,33.0,0
212,BA:8C:B9:54:50:24,3818466,482217403,1721,836781,3816745,481380622,0,5509,817579,5489,814457,20,3122,1004,14,2096,29,0,48,229410.0,130000.0,-40.0,-37.0,-44.0,-51.0,-43.0,-36.0,-43.0,-48.0,-90.0,-93.0,-90.0,-93.0,50.0,56.0,46.0,42.0,0
213,92:69:1D:31:68:E9,3820221,484835822,3471,3454736,3816750,481381086,0,3583,927866,3489,907011,94,20855,1791,6,3597,78,0,31,229410.0,130000.0,-51.0,-50.0,-44.0,-46.0,-51.0,-50.0,-44.0,-48.0,-90.0,-93.0,-90.0,-93.0,39.0,43.0,46.0,47.0,0
214,CC:2F:71:3F:1F:24,4395147,1162132158,578397,680751072,3816750,481381086,37,484673,556005473,484116,555938271,557,67202,467007,10,578634,41923,34,430,117000.0,39000.0,-67.0,-65.0,-70.0,-68.0,-67.0,-65.0,-70.0,-67.0,-90.0,-93.0,-90.0,-93.0,23.0,28.0,20.0,25.0,0
215,CC:2F:71:3E:C5:1F,3817423,481463306,673,82220,3816750,481381086,0,2891,241772,2397,183036,494,58736,713,8,1004,18,0,32,144444.0,39000.0,-70.0,-71.0,-67.0,-60.0,-70.0,-70.0,-67.0,-60.0,-90.0,-93.0,-90.0,-93.0,20.0,22.0,23.0,33.0,0
216,BA:8C:B9:54:50:24,3818471,482217867,1721,836781,3816750,481381086,0,5509,817579,5489,814457,20,3122,1004,14,2096,29,0,48,229410.0,130000.0,-40.0,-37.0,-44.0,-51.0,-43.0,-36.0,-43.0,-48.0,-90.0,-93.0,-90.0,-93.0,50.0,56.0,46.0,42.0,0
217,92:69:1D:31:68:E9,3820223,484836024,3471,3454736,3816752,481381288,0,3583,927866,3489,907011,94,20855,1791,6,3597,78,0,31,229410.0,130000.0,-51.0,-50.0,-44.0,-46.0,-51.0,-50.0,-44.0,-48.0,-90.0,-93.0,-90.0,-93.0,39.0,43.0,46.0,47.0,0
218,CC:2F:71:3F:1F:24,4395193,1162146992,578441,680765704,3816752,481381288,37,484699,556010453,484142,555943251,557,67202,467033,10,578678,41932,34,430,117000.0,39000.0,-67.0,-65.0,-70.0,-67.0,-67.0,-65.0,-70.0,-67.0,-90.0,-93.0,-90.0,-93.0,23.0,28.0,20.0,26.0,0
219,CC:2F:71:3E:C5:1F,3817427,481463710,673,82220,3816754,481381490,0,2891,241772,2397,183036,494,58736,713,8,1004,18,0,32,144444.0,39000.0,-70.0,-71.0,-67.0,-60.0,-70.0,-70.0,-67.0,-60.0,-90.0,-93.0,-90.0,-93.0,20.0,22.0,23.0,33.0,0
220,BA:8C:B9:54:50:24,3818475,482218271,1721,836781,3816754,481381490,0,5509,817579,5489,814457,20,3122,1004,14,2096,29,0,48,229410.0,130000.0,-40.0,-37.0,-44.0,-51.0,-43.0,-36.0,-43.0,-48.0,-90.0,-93.0,-90.0,-93.0,50.0,56.0,46.0,42.0,0
221,92:69:1D:31:68:E9,3820229,484836630,3471,3454736,3816758,481381894,0,3584,927934,3490,907079,94,20855,1791,6,3597,78,0,31,229410.0,130000.0,-52.0,-50.0,-44.0,-46.0,-51.0,-49.0,-44.0,-47.0,-90.0,-93.0,-90.0,-93.0,38.0,43.0,46.0,47.0,0
222,CC:2F:71:3F:1F:24,4395244,1162162290,578485,680780336,3816759,481381954,37,484725,556015397,484168,555948195,557,67202,467059,10,578722,41952,34,430,130000.0,39000.0,-67.0,-65.0,-70.0,-67.0,-67.0,-65.0,-70.0,-67.0,-90.0,-93.0,-90.0,-93.0,23.0,28.0,20.0,26.0,0
223,CC:2F:71:3E:C5:1F,3817432,481464174,673,82220,3816759,481381954,0,2891,241772,2397,183036,494,58736,713,8,1004,18,0,32,144444.0,39000.0,-70.0,-71.0,-67.0,-60.0,-70.0,-70.0,-67.0,-60.0,-90.0,-93.0,-90.0,-93.0,20.0,22.0,23.0,33.0,0
224,BA:8C:B9:54:50:24,3818480,482218735,1721,836781,3816759,481381954,0,5509,817579,5489,814457,20,3122,1004,14,2096,29,0,48,229410.0,130000.0,-40.0,-37.0,-44.0,-51.0,-43.0,-36.0,-43.0,-48.0,-90.0,-93.0,-90.0,-93.0,50.0,56.0,46.0,42.0,0
225,92:69:1D:31:68:E9,3820232,484836892,3471,3454736,3816761,481382156,0,3584,927934,3490,907079,94,20855,1791,6,3597,78,0,31,229410.0,130000.0,-52.0,-50.0,-44.0,-46.0,-51.0,-49.0,-44.0,-47.0,-90.0,-93.0,-90.0,-93.0,38.0,43.0,46.0,47.0,0
226,CC:2F:71:3F:1F:24,4395289,1162177056,578528,680794900,3816761,481382156,37,484750,556020201,484193,555952999,557,67202,467084,10,578765,41969,34,430,130000.0,39000.0,-67.0,-65.0,-70.0,-68.0,-67.0,-65.0,-70.0,-67.0,-90.0,-93.0,-90.0,-93.0,23.0,28.0,20.0,25.0,0
227,CC:2F:71:3E:C5:1F,3817436,481464578,673,82220,3816763,481382358,0,2891,241772,2397,183036,494,58736,713,8,1004,18,0,32,144444.0,39000.0,-70.0,-71.0,-67.0,-60.0,-70.0,-70.0,-67.0,-60.0,-90.0,-93.0,-90.0,-93.0,20.0,22.0,23.0,33.0,0
228,BA:8C:B9:54:50:24,3818484,482219139,1721,836781,3816763,481382358,0,5509,817579,5489,814457,20,3122,1004,14,2096,29,0,48,229410.0,130000.0,-40.0,-37.0,-44.0,-51.0,-43.0,-36.0,-43.0,-48.0,-90.0,-93.0,-90.0,-93.0,50.0,56.0,46.0,42.0,0
229,92:69:1D:31:68:E9,3820239,484837560,3471,3454736,3816768,481382824,0,3584,927934,3490,907079,94,20855,1791,6,3597,78,0,31,229410.0,130000.0,-52.0,-50.0,-44.0,-46.0,-51.0,-49.0,-44.0,-47.0,-90.0,-93.0,-90.0,-93.0,38.0,43.0,46.0,47.0,0
230,CC:2F:71:3F:1F:24,4395340,1162192468,578572,680809644,3816768,481382824,37,484780,556025587,484222,555958267,558,67320,467114,10,578809,41975,34,430,130000.0,43333.0,-67.0,-65.0,-71.0,-68.0,-67.0,-65.0,-70.0,-67.0,-90.0,-93.0,-90.0,-93.0,23.0,28.0,19.0,25.0,0
231,CC:2F:71:3E:C5:1F,3817441,481465044,673,82220,3816768,481382824,0,2891,241772,2397,183036,494,58736,713,8,1004,18,0,32,144444.0,39000.0,-70.0,-71.0,-67.0,-60.0,-70.0,-70.0,-67.0,-60.0,-90.0,-93.0,-90.0,-93.0,20.0,22.0,23.0,33.0,0
232,BA:8C:B9:54:50:24,3818489,482219605,1721,836781,3816768,481382824,0,5509,817579,5489,814457,20,3122,1004,14,2096,29,0,48,229410.0,130000.0,-40.0,-37.0,-44.0,-51.0,-43.0,-36.0,-43.0,-48.0,-90.0,-93.0,-90.0,-93.0,50.0,56.0,46.0,42.0,0
233,92:69:1D:31:68:E9,3820254,484843415,3471,3454736,3816783,481388679,0,3587,928305,3492,907215,95,21090,1792,6,3597,78,0,31,229410.0,130000.0,-52.0,-50.0,-44.0,-46.0,-51.0,-49.0,-44.0,-47.0,-90.0,-93.0,-90.0,-93.0,38.0,43.0,46.0,47.0,0
234,CC:2F:71:3F:1F:24,4395401,1162213157,578615,680824208,3816786,481388949,37,484809,556030903,484251,555963583,558,67320,467143,10,578852,41994,34,430,117000.0,39000.0,-67.0,-65.0,-70.0,-68.0,-67.0,-65.0,-70.0,-67.0,-90.0,-93.0,-90.0,-93.0,23.0,28.0,20.0,25.0,0
235,CC:2F:71:3E:C5:1F,3817459,481471169,673,82220,3816786,481388949,0,2893,241960,2398,183106,495,58854,714,8,1004,18,0,32,144444.0,39000.0,-70.0,-71.0,-67.0,-60.0,-70.0,-70.0,-67.0,-60.0,-90.0,-93.0,-90.0,-93.0,20.0,22.0,23.0,33.0,0
236,BA:8C:B9:54:50:24,3818518,482231154,1721,836781,3816797,481394373,0,5509,817579,5489,814457,20,3122,1004,14,2096,29,0,48,229410.0,130000.0,-40.0,-37.0,-44.0,-51.0,-43.0,-36.0,-43.0,-48.0,-90.0,-93.0,-90.0,-93.0,50.0,56.0,46.0,42.0,0
237,92:69:1D:31:68:E9,3820273,484849786,3471,3454736,3816802,481395050,0,3587,928305,3492,907215,95,21090,1792,6,3597,78,0,31,229410.0,130000.0,-52.0,-50.0,-44.0,-46.0,-51.0,-49.0,-44.0,-47.0,-90.0,-93.0,-90.0,-93.0,38.0,43.0,46.0,47.0,0
238,CC:2F:71:3F:1F:24,4395460,1162233878,578658,680838828,3816802,481395050,37,484834,556035707,484276,555968387,558,67320,467168,10,578895,42001,34,430,130000.0,43333.0,-67.0,-65.0,-70.0,-68.0,-67.0,-65.0,-70.0,-67.0,-90.0,-93.0,-90.0,-93.0,23.0,28.0,20.0,25.0,0
239,CC:2F:71:3E:C5:1F,3817475,481477270,673,82220,3816802,481395050,0,2893,241960,2398,183106,495,58854,714,8,1004,18,0,32,144444.0,39000.0,-70.0,-71.0,-67.0,-60.0,-70.0,-70.0,-67.0,-60.0,-90.0,-93.0,-90.0,-93.0,20.0,22.0,23.0,33.0,0
240,BA:8C:B9:54:50:24,3818523,482231831,1721,836781,3816802,481395050,0,5509,817579,5489,814457,20,3122,1004,14,2096,29,0,48,229410.0,130000.0,-40.0,-37.0,-44.0,-51.0,-43.0,-36.0,-43.0,-48.0,-90.0,-93.0,-90.0,-93.0,50.0,56.0,46.0,42.0,0
241,92:69:1D:31:68:E9,3820273,484849786,3471,3454736,3816802,481395050,0,3587,928305,3492,907215,95,21090,1792,6,3597,78,0,31,229410.0,130000.0,-52.0,-50.0,-44.0,-46.0,-51.0,-49.0,-44.0,-47.0,-90.0,-93.0,-90.0,-93.0,38.0,43.0,46.0,47.0,0
242,CC:2F:71:3F:1F:24,4395507,1162248790,578701,680853336,3816806,481395454,37,484862,556040859,484304,555973539,558,67320,467196,10,578938,42027,34,430,117000.0,39000.0,-67.0,-65.0,-70.0,-68.0,-67.0,-65.0,-70.0,-67.0,-90.0,-93.0,-90.0,-93.0,23.0,28.0,20.0,25.0,0
243,CC:2F:71:3E:C5:1F,3817479,481477674,673,82220,3816806,481395454,0,2893,241960,2398,183106,495,58854,714,8,1004,18,0,32,144444.0,39000.0,-70.0,-71.0,-67.0,-60.0,-70.0,-70.0,-67.0,-60.0,-90.0,-93.0,-90.0,-93.0,20.0,22.0,23.0,33.0,0
244,BA:8C:B9:54:50:24,3818527,482232235,1721,836781,3816806,481395454,0,5509,817579,5489,814457,20,3122,1004,14,2096,29,0,48,229410.0,130000.0,-40.0,-37.0,-44.0,-51.0,-43.0,-36.0,-43.0,-48.0,-90.0,-93.0,-90.0,-93.0,50.0,56.0,46.0,42.0,0
245,92:69:1D:31:68:E9,3820282,484850654,3471,3454736,3816811,481395918,0,3587,928305,3492,907215,95,21090,1792,6,3597,78,0,31,229410.0,130000.0,-52.0,-50.0,-44.0,-46.0,-51.0,-49.0,-44.0,-47.0,-90.0,-93.0,-90.0,-93.0,38.0,43.0,46.0,47.0,0
246,CC:2F:71:3F:1F:24,4395556,1162263942,578745,680868024,3816811,481395918,37,484887,556045663,484329,555978343,558,67320,467221,10,578982,42033,34,430,130000.0,43333.0,-67.0,-65.0,-70.0,-67.0,-67.0,-65.0,-70.0,-67.0,-90.0,-93.0,-90.0,-93.0,23.0,28.0,20.0,26.0,0
247,CC:2F:71:3E:C5:1F,3817484,481478138,673,82220,3816811,481395918,0,2893,241960,2398,183106,495,58854,714,8,1004,18,0,32,144444.0,39000.0,-70.0,-71.0,-67.0,-60.0,-70.0,-70.0,-67.0,-60.0,-90.0,-93.0,-90.0,-93.0,20.0,22.0,23.0,33.0,0
248,BA:8C:B9:54:50:24,3818532,482232699,1721,836781,3816811,481395918,0,5509,817579,5489,814457,20,3122,1004,14,2096,29,0,48,229410.0,130000.0,-40.0,-37.0,-44.0,-51.0,-43.0,-36.0,-43.0,-48.0,-90.0,-93.0,-90.0,-93.0,50.0,56.0,46.0,42.0,0
249,92:69:1D:31:68:E9,3820282,484850654,3471,3454736,3816811,481395918,0,3587,928305,3492,907215,95,21090,1792,6,3597,78,0,31,229410.0,130000.0,-52.0,-50.0,-44.0,-46.0,-51.0,-49.0,-44.0,-47.0,-90.0,-93.0,-90.0,-93.0,38.0,43.0,46.0,47.0,0
250,CC:2F:71:3F:1F:24,4395603,1162279012,578790,680882892,3816813,481396120,37,484913,556050643,484355,555983323,558,67320,467247,10,579027,42049,34,430,130000.0,39000.0,-67.0,-65.0,-71.0,-68.0,-67.0,-65.0,-70.0,-67.0,-90.0,-93.0,-90.0,-93.0,23.0,28.0,19.0,25.0,0
251,CC:2F:71:3E:C5:1F,3817490,481478910,673,82220,3816817,481396690,0,2893,241960,2398,183106,495,58854,714,8,1004,18,0,32,144444.0,39000.0,-70.0,-71.0,-67.0,-60.0,-70.0,-70.0,-67.0,-60.0,-90.0,-93.0,-90.0,-93.0,20.0,22.0,23.0,33.0,0
252,BA:8C:B9:54:50:24,3818538,482233471,1721,836781,3816817,481396690,0,5509,817579,5489,814457,20,3122,1004,14,2096,29,0,48,229410.0,130000.0,-40.0,-37.0,-44.0,-51.0,-43.0,-36.0,-43.0,-48.0,-90.0,-93.0,-90.0,-93.0,50.0,56.0,46.0,42.0,0
253,92:69:1D:31:68:E9,3820293,484851890,3471,3454736,3816822,481397154,0,3587,928305,3492,907215,95,21090,1792,6,3597,78,0,31,229410.0,130000.0,-52.0,-50.0,-44.0,-46.0,-51.0,-49.0,-44.0,-47.0,-90.0,-93.0,-90.0,-93.0,38.0,43.0,46.0,47.0,0
254,CC:2F:71:3F:1F:24,4395655,1162294554,578833,680897400,3816822,481397154,37,484941,556055795,484383,555988475,558,67320,467275,10,579070,42061,34,430,130000.0,43333.0,-67.0,-65.0,-71.0,-67.0,-67.0,-65.0,-70.0,-67.0,-90.0,-93.0,-90.0,-93.0,23.0,28.0,19.0,26.0,0
255,CC:2F:71:3E:C5:1F,3817495,481479374,673,82220,3816822,481397154,0,2893,241960,2398,183106,495,58854,714,8,1004,18,0,32,144444.0,39000.0,-70.0,-71.0,-67.0,-60.0,-70.0,-70.0,-67.0,-60.0,-90.0,-93.0,-90.0,-93.0,20.0,22.0,23.0,33.0,0
256,BA:8C:B9:54:50:24,3818543,482233935,1721,836781,3816822,481397154,0,5509,817579,5489,814457,20,3122,1004,14,2096,29,0,48,229410.0,130000.0,-40.0,-37.0,-44.0,-51.0,-43.0,-36.0,-43.0,-48.0,-90.0,-93.0,-90.0,-93.0,50.0,56.0,46.0,42.0,0
257,92:69:1D:31:68:E9,3820293,484851890,3471,3454736,3816822,481397154,0,3587,928305,3492,907215,95,21090,1792,6,3597,78,0,31,229410.0,130000.0,-52.0,-50.0,-44.0,-46.0,-51.0,-49.0,-44.0,-47.0,-90.0,-93.0,-90.0,-93.0,38.0,43.0,46.0,47.0,0
258,CC:2F:71:3F:1F:24,4395703,1162309758,578878,680912268,3816825,481397490,37,484967,556060739,484409,555993419,558,67320,467301,10,579115,42089,34,430,117000.0,39000.0,-67.0,-65.0,-71.0,-68.0,-67.0,-65.0,-70.0,-67.0,-90.0,-93.0,-90.0,-93.0,23.0,28.0,19.0,25.0,0
259,CC:2F:71:3E:C5:1F,3817499,481479778,673,82220,3816826,481397558,0,2893,241960,2398,183106,495,58854,714,8,1004,18,0,32,144444.0,39000.0,-70.0,-71.0,-67.0,-60.0,-70.0,-70.0,-67.0,-60.0,-90.0,-93.0,-90.0,-93.0,20.0,22.0,23.0,33.0,0
260,BA:8C:B9:54:50:24,3818547,482234339,1721,836781,3816826,481397558,0,5509,817579,5489,814457,20,3122,1004,14,2096,29,0,48,229410.0,130000.0,-40.0,-37.0,-44.0,-51.0,-43.0,-36.0,-43.0,-48.0,-90.0,-93.0,-90.0,-93.0,50.0,56.0,46.0,42.0,0
261,92:69:1D:31:68:E9,3820301,484852698,3471,3454736,3816830,481397962,0,3587,928305,3492,907215,95,21090,1792,6,3597,78,0,31,229410.0,130000.0,-52.0,-50.0,-44.0,-46.0,-51.0,-49.0,-44.0,-47.0,-90.0,-93.0,-90.0,-93.0,38.0,43.0,46.0,47.0,0
262,CC:2F:71:3F:1F:24,4395751,1162324738,578921,680926776,3816830,481397962,37,484993,556065683,484435,555998363,558,67320,467327,10,579158,42098,34,430,130000.0,43333.0,-67.0,-65.0,-71.0,-68.0,-67.0,-65.0,-70.0,-67.0,-90.0,-93.0,-90.0,-93.0,23.0,28.0,19.0,25.0,0
263,CC:2F:71:3E:C5:1F,3817503,481480182,673,82220,3816830,481397962,0,2893,241960,2398,183106,495,58854,714,8,1004,18,0,32,144444.0,39000.0,-70.0,-71.0,-67.0,-60.0,-70.0,-70.0,-67.0,-60.0,-90.0,-93.0,-90.0,-93.0,20.0,22.0,23.0,33.0,0
264,BA:8C:B9:54:50:24,3818551,482234743,1721,836781,3816830,481397962,0,5509,817579,5489,814457,20,3122,1004,14,2096,29,0,48,229410.0,130000.0,-40.0,-37.0,-44.0,-51.0,-43.0,-36.0,-43.0,-48.0,-90.0,-93.0,-90.0,-93.0,50.0,56.0,46.0,42.0,0
265,92:69:1D:31:68:E9,3820302,484852758,3471,3454736,3816831,481398022,0,3587,928305,3492,907215,95,21090,1792,6,3597,78,0,31,229410.0,130000.0,-52.0,-50.0,-44.0,-46.0,-51.0,-49.0,-44.0,-47.0,-90.0,-93.0,-90.0,-93.0,38.0,43.0,46.0,47.0,0
266,CC:2F:71:3F:1F:24,4395799,1162339812,578966,680941588,3816833,481398224,37,485018,556070487,484460,556003167,558,67320,467352,10,579203,42132,34,430,144444.0,39000.0,-67.0,-65.0,-70.0,-67.0,-67.0,-65.0,-70.0,-67.0,-90.0,-93.0,-90.0,-93.0,23.0,28.0,20.0,26.0,0
267,CC:2F:71:3E:C5:1F,3817508,481480646,673,82220,3816835,481398426,0,2893,241960,2398,183106,495,58854,714,8,1004,18,0,32,144444.0,39000.0,-70.0,-71.0,-67.0,-60.0,-70.0,-70.0,-67.0,-60.0,-90.0,-93.0,-90.0,-93.0,20.0,22.0,23.0,33.0,0
268,BA:8C:B9:54:50:24,3818556,482235207,1721,836781,3816835,481398426,0,5509,817579,5489,814457,20,3122,1004,14,2096,29,0,48,229410.0,130000.0,-40.0,-37.0,-44.0,-51.0,-43.0,-36.0,-43.0,-48.0,-90.0,-93.0,-90.0,-93.0,50.0,56.0,46.0,42.0,0
269,92:69:1D:31:68:E9,3820310,484853566,3471,3454736,3816839,481398830,0,3587,928305,3492,907215,95,21090,1792,6,3597,78,0,31,229410.0,130000.0,-52.0,-50.0,-44.0,-46.0,-51.0,-49.0,-44.0,-47.0,-90.0,-93.0,-90.0,-93.0,38.0,43.0,46.0,47.0,0
270,CC:2F:71:3F:1F:24,4395851,1162356230,579010,680956276,3816841,481399954,37,485044,556075431,484486,556008111,558,67320,467378,10,579247,42149,34,430,130000.0,43333.0,-67.0,-65.0,-70.0,-67.0,-67.0,-65.0,-70.0,-67.0,-90.0,-93.0,-90.0,-93.0,23.0,28.0,20.0,26.0,0
271,CC:2F:71:3E:C5:1F,3817514,481482174,673,82220,3816841,481399954,0,2893,241960,2398,183106,495,58854,714,8,1004,18,0,32,144444.0,39000.0,-70.0,-71.0,-67.0,-60.0,-70.0,-70.0,-67.0,-60.0,-90.0,-93.0,-90.0,-93.0,20.0,22.0,23.0,33.0,0
272,BA:8C:B9:54:50:24,3818562,482236735,1721,836781,3816841,481399954,0,5509,817579,5489,814457,20,3122,1004,14,2096,29,0,48,229410.0,130000.0,-40.0,-37.0,-44.0,-51.0,-43.0,-36.0,-43.0,-48.0,-90.0,-93.0,-90.0,-93.0,50.0,56.0,46.0,42.0,0
273,92:69:1D:31:68:E9,3820312,484854690,3471,3454736,3816841,481399954,0,3587,928305,3492,907215,95,21090,1792,6,3597,78,0,31,229410.0,130000.0,-52.0,-50.0,-44.0,-46.0,-51.0,-49.0,-44.0,-47.0,-90.0,-93.0,-90.0,-93.0,38.0,43.0,46.0,47.0,0
274,CC:2F:71:3F:1F:24,4395896,1162371154,579055,680971200,3816841,481399954,37,485071,556080515,484513,556013195,558,67320,467405,10,579292,42150,34,430,130000.0,43333.0,-67.0,-65.0,-70.0,-68.0,-67.0,-65.0,-70.0,-67.0,-90.0,-93.0,-90.0,-93.0,23.0,28.0,20.0,25.0,0
275,CC:2F:71:3E:C5:1F,3817518,481482578,673,82220,3816845,481400358,0,2893,241960,2398,183106,495,58854,714,8,1004,18,0,32,144444.0,39000.0,-70.0,-71.0,-67.0,-60.0,-70.0,-70.0,-67.0,-60.0,-90.0,-93.0,-90.0,-93.0,20.0,22.0,23.0,33.0,0
276,BA:8C:B9:54:50:24,3818567,482237199,1721,836781,3816846,481400418,0,5509,817579,5489,814457,20,3122,1004,14,2096,29,0,48,229410.0,130000.0,-40.0,-37.0,-44.0,-51.0,-43.0,-36.0,-43.0,-48.0,-90.0,-93.0,-90.0,-93.0,50.0,56.0,46.0,42.0,0
277,92:69:1D:31:68:E9,3820321,484855558,3471,3454736,3816850,481400822,0,3587,928305,3492,907215,95,21090,1792,6,3597,78,0,31,229410.0,130000.0,-52.0,-50.0,-44.0,-46.0,-51.0,-49.0,-44.0,-47.0,-90.0,-93.0,-90.0,-93.0,38.0,43.0,46.0,47.0,0
278,CC:2F:71:3F:1F:24,4395950,1162387710,579098,680985764,3816852,481401946,37,485097,556085459,484539,556018139,558,67320,467431,10,579335,42165,34,430,130000.0,39000.0,-67.0,-65.0,-70.0,-68.0,-67.0,-65.0,-70.0,-67.0,-90.0,-93.0,-90.0,-93.0,23.0,28.0,20.0,25.0,0
279,CC:2F:71:3E:C5:1F,3817525,481484166,673,82220,3816852,481401946,0,2893,241960,2398,183106,495,58854,714,8,1004,18,0,32,144444.0,39000.0,-70.0,-71.0,-67.0,-60.0,-70.0,-70.0,-67.0,-60.0,-90.0,-93.0,-90.0,-93.0,20.0,22.0,23.0,33.0,0
280,BA:8C:B9:54:50:24,3818573,482238727,1721,836781,3816852,481401946,0,5509,817579,5489,814457,20,3122,1004,14,2096,29,0,48,229410.0,130000.0,-40.0,-37.0,-44.0,-51.0,-43.0,-36.0,-43.0,-48.0,-90.0,-93.0,-90.0,-93.0,50.0,56.0,46.0,42.0,0
281,92:69:1D:31:68:E9,3820323,484856682,3471,3454736,3816852,481401946,0,3587,928305,3492,907215,95,21090,1792,6,3597,78,0,31,229410.0,130000.0,-52.0,-50.0,-44.0,-46.0,-51.0,-49.0,-44.0,-47.0,-90.0,-93.0,-90.0,-93.0,38.0,43.0,46.0,47.0,0
282,CC:2F:71:3F:1F:24,4395995,1162402410,579143,681000464,3816852,481401946,37,485123,556090403,484565,556023083,558,67320,467457,10,579380,42177,34,430,117000.0,39000.0,-67.0,-65.0,-70.0,-68.0,-67.0,-65.0,-70.0,-67.0,-90.0,-93.0,-90.0,-93.0,23.0,28.0,20.0,25.0,0
283,CC:2F:71:3E:C5:1F,3817529,481484570,673,82220,3816856,481402350,0,2893,241960,2398,183106,495,58854,714,8,1004,18,0,32,144444.0,39000.0,-70.0,-71.0,-67.0,-60.0,-70.0,-70.0,-67.0,-60.0,-90.0,-93.0,-90.0,-93.0,20.0,22.0,23.0,33.0,0
284,BA:8C:B9:54:50:24,3818577,482239131,1721,836781,3816856,481402350,0,5509,817579,5489,814457,20,3122,1004,14,2096,29,0,48,229410.0,130000.0,-40.0,-37.0,-44.0,-51.0,-43.0,-36.0,-43.0,-48.0,-90.0,-93.0,-90.0,-93.0,50.0,56.0,46.0,42.0,0
285,92:69:1D:31:68:E9,3820334,484858674,3471,3454736,3816863,481403938,0,3587,928305,3492,907215,95,21090,1792,6,3597,78,0,31,229410.0,130000.0,-52.0,-50.0,-44.0,-46.0,-51.0,-49.0,-44.0,-47.0,-90.0,-93.0,-90.0,-93.0,38.0,43.0,46.0,47.0,0
286,CC:2F:71:3F:1F:24,4396049,1162418966,579186,681015028,3816863,481403938,37,485149,556095347,484591,556028027,558,67320,467483,10,579423,42183,34,430,130000.0,43333.0,-67.0,-65.0,-71.0,-68.0,-67.0,-65.0,-70.0,-67.0,-90.0,-93.0,-90.0,-93.0,23.0,28.0,19.0,25.0,0
287,CC:2F:71:3E:C5:1F,3817536,481486158,673,82220,3816863,481403938,0,2893,241960,2398,183106,495,58854,714,8,1004,18,0,32,144444.0,39000.0,-70.0,-71.0,-67.0,-60.0,-70.0,-70.0,-67.0,-60.0,-90.0,-93.0,-90.0,-93.0,20.0,22.0,23.0,33.0,0
288,BA:8C:B9:54:50:24,3818585,482240797,1721,836781,3816864,481404016,0,5509,817579,5489,814457,20,3122,1004,14,2096,29,0,48,229410.0,130000.0,-40.0,-37.0,-44.0,-51.0,-43.0,-36.0,-43.0,-48.0,-90.0,-93.0,-90.0,-93.0,50.0,56.0,46.0,42.0,0
289,92:69:1D:31:68:E9,3820337,484859141,3472,3454852,3816865,481404289,0,3589,928441,3494,907351,95,21090,1792,6,3598,78,0,31,229410.0,130000.0,-51.0,-53.0,-47.0,-48.0,-51.0,-50.0,-44.0,-47.0,-90.0,-93.0,-90.0,-93.0,39.0,40.0,43.0,45.0,0
290,CC:2F:71:3F:1F:24,4396096,1162434177,579231,681029888,3816865,481404289,37,485176,556100407,484618,556033087,558,67320,467510,10,579468,42191,34,430,130000.0,39000.0,-67.0,-65.0,-70.0,-67.0,-67.0,-65.0,-70.0,-67.0,-90.0,-93.0,-90.0,-93.0,23.0,28.0,20.0,26.0,0
291,CC:2F:71:3E:C5:1F,3817542,481486961,674,82336,3816868,481404625,0,2895,242100,2400,183246,495,58854,714,8,1005,18,0,32,144444.0,39000.0,-70.0,-71.0,-67.0,-60.0,-70.0,-70.0,-67.0,-60.0,-90.0,-93.0,-90.0,-93.0,20.0,22.0,23.0,33.0,0
292,BA:8C:B9:54:50:24,3818593,482241792,1722,836897,3816871,481404895,0,5511,817715,5491,814593,20,3122,1004,14,2097,29,0,48,229410.0,130000.0,-40.0,-37.0,-44.0,-52.0,-43.0,-36.0,-43.0,-49.0,-90.0,-93.0,-90.0,-93.0,50.0,56.0,46.0,41.0,0
293,92:69:1D:31:68:E9,3820345,484859949,3472,3454852,3816873,481405097,0,3589,928441,3494,907351,95,21090,1792,6,3598,78,0,31,229410.0,130000.0,-51.0,-53.0,-47.0,-48.0,-51.0,-50.0,-44.0,-47.0,-90.0,-93.0,-90.0,-93.0,39.0,40.0,43.0,45.0,0
294,CC:2F:71:3F:1F:24,4396147,1162449549,579274,681044452,3816873,481405097,37,485202,556105351,484644,556038031,558,67320,467536,10,579511,42212,34,430,130000.0,39000.0,-67.0,-65.0,-70.0,-68.0,-67.0,-65.0,-70.0,-67.0,-90.0,-93.0,-90.0,-93.0,23.0,28.0,20.0,25.0,0
295,CC:2F:71:3E:C5:1F,3817547,481487433,674,82336,3816873,481405097,0,2895,242100,2400,183246,495,58854,714,8,1005,18,0,32,144444.0,39000.0,-70.0,-71.0,-67.0,-60.0,-70.0,-70.0,-67.0,-60.0,-90.0,-93.0,-90.0,-93.0,20.0,22.0,23.0,33.0,0
296,BA:8C:B9:54:50:24,3818596,482242056,1722,836897,3816874,481405159,0,5511,817715,5491,814593,20,3122,1004,14,2097,29,0,48,229410.0,130000.0,-40.0,-37.0,-44.0,-52.0,-43.0,-36.0,-43.0,-49.0,-90.0,-93.0,-90.0,-93.0,50.0,56.0,46.0,41.0,0
297,92:69:1D:31:68:E9,3820348,484860133,3472,3454852,3816876,481405281,0,3589,928441,3494,907351,95,21090,1792,6,3598,78,0,31,229410.0,130000.0,-51.0,-53.0,-47.0,-48.0,-51.0,-50.0,-44.0,-47.0,-90.0,-93.0,-90.0,-93.0,39.0,40.0,43.0,45.0,0
298,CC:2F:71:3F:1F:24,4396194,1162464549,579318,681059268,3816876,481405281,37,485234,556111041,484675,556043603,559,67438,467568,10,579555,42236,34,431,130000.0,39000.0,-67.0,-65.0,-71.0,-67.0,-67.0,-65.0,-70.0,-67.0,-90.0,-93.0,-90.0,-93.0,23.0,28.0,19.0,26.0,0
299,CC:2F:71:3E:C5:1F,3817556,481488223,674,82336,3816882,481405887,0,2897,242288,2401,183316,496,58972,715,8,1005,18,0,32,144444.0,39000.0,-70.0,-71.0,-67.0,-60.0,-70.0,-70.0,-67.0,-60.0,-90.0,-93.0,-90.0,-93.0,20.0,22.0,23.0,33.0,0
300,BA:8C:B9:54:50:24,3818604,482242784,1722,836897,3816882,481405887,0,5512,817783,5492,814661,20,3122,1004,14,2097,29,0,48,229410.0,130000.0,-39.0,-37.0,-45.0,-51.0,-42.0,-36.0,-44.0,-49.0,-90.0,-93.0,-90.0,-93.0,51.0,56.0,45.0,42.0,0
301,92:69:1D:31:68:E9,3820356,484860941,3472,3454852,3816884,481406089,0,3589,928441,3494,907351,95,21090,1792,6,3598,78,0,31,229410.0,130000.0,-51.0,-53.0,-47.0,-48.0,-51.0,-50.0,-44.0,-47.0,-90.0,-93.0,-90.0,-93.0,39.0,40.0,43.0,45.0,0
302,CC:2F:71:3F:1F:24,4396247,1162480113,579363,681074024,3816884,481406089,37,485259,556115845,484700,556048407,559,67438,467593,10,579600,42250,34,431,130000.0,43333.0,-67.0,-65.0,-70.0,-67.0,-67.0,-65.0,-70.0,-67.0,-90.0,-93.0,-90.0,-93.0,23.0,28.0,20.0,26.0,0
303,CC:2F:71:3E:C5:1F,3817558,481488425,674,82336,3816884,481406089,0,2897,242288,2401,183316,496,58972,715,8,1005,18,0,32,144444.0,39000.0,-70.0,-71.0,-67.0,-60.0,-70.0,-70.0,-67.0,-60.0,-90.0,-93.0,-90.0,-93.0,20.0,22.0,23.0,33.0,0
304,BA:8C:B9:54:50:24,3818606,482242986,1722,836897,3816884,481406089,0,5512,817783,5492,814661,20,3122,1004,14,2097,29,0,48,229410.0,130000.0,-39.0,-37.0,-45.0,-51.0,-42.0,-36.0,-44.0,-49.0,-90.0,-93.0,-90.0,-93.0,51.0,56.0,45.0,42.0,0
305,92:69:1D:31:68:E9,3820357,484861001,3472,3454852,3816885,481406149,0,3589,928441,3494,907351,95,21090,1792,6,3598,78,0,31,229410.0,130000.0,-51.0,-53.0,-47.0,-48.0,-51.0,-50.0,-44.0,-47.0,-90.0,-93.0,-90.0,-93.0,39.0,40.0,43.0,45.0,0
306,CC:2F:71:3F:1F:24,4396295,1162495253,579407,681088768,3816888,481406485,37,485285,556120765,484726,556053327,559,67438,467619,10,579644,42263,34,431,130000.0,39000.0,-67.0,-65.0,-70.0,-68.0,-67.0,-65.0,-70.0,-67.0,-90.0,-93.0,-90.0,-93.0,23.0,28.0,20.0,25.0,0
307,CC:2F:71:3E:C5:1F,3817563,481488889,674,82336,3816889,481406553,0,2897,242288,2401,183316,496,58972,715,8,1005,18,0,32,144444.0,39000.0,-70.0,-71.0,-67.0,-60.0,-70.0,-70.0,-67.0,-60.0,-90.0,-93.0,-90.0,-93.0,20.0,22.0,23.0,33.0,0
308,BA:8C:B9:54:50:24,3818612,482243584,1722,836897,3816890,481406687,0,5512,817783,5492,814661,20,3122,1004,14,2097,29,0,48,229410.0,130000.0,-39.0,-37.0,-45.0,-51.0,-42.0,-36.0,-44.0,-49.0,-90.0,-93.0,-90.0,-93.0,51.0,56.0,45.0,42.0,0
309,92:69:1D:31:68:E9,3820365,484861809,3472,3454852,3816893,481406957,0,3589,928441,3494,907351,95,21090,1792,6,3598,78,0,31,229410.0,130000.0,-51.0,-53.0,-47.0,-48.0,-51.0,-50.0,-44.0,-47.0,-90.0,-93.0,-90.0,-93.0,39.0,40.0,43.0,45.0,0
310,CC:2F:71:3F:1F:24,4396342,1162510165,579449,681103208,3816893,481406957,37,485310,556125569,484751,556058131,559,67438,467644,10,579686,42275,34,431,130000.0,39000.0,-67.0,-65.0,-71.0,-68.0,-67.0,-65.0,-70.0,-67.0,-90.0,-93.0,-90.0,-93.0,23.0,28.0,19.0,25.0,0
311,CC:2F:71:3E:C5:1F,3817567,481489293,674,82336,3816893,481406957,0,2897,242288,2401,183316,496,58972,715,8,1005,18,0,32,144444.0,39000.0,-70.0,-71.0,-67.0,-60.0,-70.0,-70.0,-67.0,-60.0,-90.0,-93.0,-90.0,-93.0,20.0,22.0,23.0,33.0,0
312,BA:8C:B9:54:50:24,3818615,482243854,1722,836897,3816893,481406957,0,5512,817783,5492,814661,20,3122,1004,14,2097,29,0,48,229410.0,130000.0,-39.0,-37.0,-45.0,-51.0,-42.0,-36.0,-44.0,-49.0,-90.0,-93.0,-90.0,-93.0,51.0,56.0,45.0,42.0,0
313,92:69:1D:31:68:E9,3820365,484861809,3472,3454852,3816893,481406957,0,3589,928441,3494,907351,95,21090,1792,6,3598,78,0,31,229410.0,130000.0,-51.0,-53.0,-47.0,-48.0,-51.0,-50.0,-44.0,-47.0,-90.0,-93.0,-90.0,-93.0,39.0,40.0,43.0,45.0,0
314,CC:2F:71:3F:1F:24,4396392,1162525393,579495,681118032,3816897,481407361,37,485335,556130373,484776,556062935,559,67438,467669,10,579732,42286,34,431,130000.0,39000.0,-67.0,-65.0,-70.0,-68.0,-67.0,-65.0,-70.0,-67.0,-90.0,-93.0,-90.0,-93.0,23.0,28.0,20.0,25.0,0
315,CC:2F:71:3E:C5:1F,3817571,481489697,674,82336,3816897,481407361,0,2897,242288,2401,183316,496,58972,715,8,1005,18,0,32,144444.0,39000.0,-70.0,-71.0,-67.0,-60.0,-70.0,-70.0,-67.0,-60.0,-90.0,-93.0,-90.0,-93.0,20.0,22.0,23.0,33.0,0
316,BA:8C:B9:54:50:24,3818619,482244258,1722,836897,3816897,481407361,0,5512,817783,5492,814661,20,3122,1004,14,2097,29,0,48,229410.0,130000.0,-39.0,-37.0,-45.0,-51.0,-42.0,-36.0,-44.0,-49.0,-90.0,-93.0,-90.0,-93.0,51.0,56.0,45.0,42.0,0
317,92:69:1D:31:68:E9,3820374,484862677,3472,3454852,3816902,481407825,0,3589,928441,3494,907351,95,21090,1792,6,3598,78,0,31,229410.0,130000.0,-51.0,-53.0,-47.0,-48.0,-51.0,-50.0,-44.0,-47.0,-90.0,-93.0,-90.0,-93.0,39.0,40.0,43.0,45.0,0
318,CC:2F:71:3F:1F:24,4396440,1162540421,579538,681132596,3816902,481407825,37,485363,556135525,484804,556068087,559,67438,467697,10,579775,42302,34,431,130000.0,39000.0,-67.0,-65.0,-70.0,-68.0,-67.0,-65.0,-70.0,-67.0,-90.0,-93.0,-90.0,-93.0,23.0,28.0,20.0,25.0,0
319,CC:2F:71:3E:C5:1F,3817576,481490161,674,82336,3816902,481407825,0,2897,242288,2401,183316,496,58972,715,8,1005,18,0,32,144444.0,39000.0,-70.0,-71.0,-67.0,-60.0,-70.0,-70.0,-67.0,-60.0,-90.0,-93.0,-90.0,-93.0,20.0,22.0,23.0,33.0,0
320,BA:8C:B9:54:50:24,3818624,482244722,1722,836897,3816902,481407825,0,5512,817783,5492,814661,20,3122,1004,14,2097,29,0,48,229410.0,130000.0,-39.0,-37.0,-45.0,-51.0,-42.0,-36.0,-44.0,-49.0,-90.0,-93.0,-90.0,-93.0,51.0,56.0,45.0,42.0,0
321,92:69:1D:31:68:E9,3820374,484862677,3472,3454852,3816902,481407825,0,3589,928441,3494,907351,95,21090,1792,6,3598,78,0,31,229410.0,130000.0,-51.0,-53.0,-47.0,-48.0,-51.0,-50.0,-44.0,-47.0,-90.0,-93.0,-90.0,-93.0,39.0,40.0,43.0,45.0,0
322,CC:2F:71:3F:1F:24,4396489,1162555639,579583,681147352,3816906,481408287,37,485388,556140329,484829,556072891,559,67438,467722,10,579820,42314,34,431,130000.0,43333.0,-67.0,-65.0,-70.0,-67.0,-67.0,-65.0,-70.0,-67.0,-90.0,-93.0,-90.0,-93.0,23.0,28.0,20.0,26.0,0
323,CC:2F:71:3E:C5:1F,3817581,481490691,674,82336,3816907,481408355,0,2897,242288,2401,183316,496,58972,715,8,1005,18,0,32,144444.0,39000.0,-70.0,-71.0,-67.0,-60.0,-70.0,-70.0,-67.0,-60.0,-90.0,-93.0,-90.0,-93.0,20.0,22.0,23.0,33.0,0
324,BA:8C:B9:54:50:24,3818629,482245252,1722,836897,3816907,481408355,0,5512,817783,5492,814661,20,3122,1004,14,2097,29,0,48,229410.0,130000.0,-39.0,-37.0,-45.0,-51.0,-42.0,-36.0,-44.0,-49.0,-90.0,-93.0,-90.0,-93.0,51.0,56.0,45.0,42.0,0
325,92:69:1D:31:68:E9,3820383,484863611,3472,3454852,3816911,481408759,0,3589,928441,3494,907351,95,21090,1792,6,3598,78,0,31,229410.0,130000.0,-51.0,-53.0,-47.0,-48.0,-51.0,-50.0,-44.0,-47.0,-90.0,-93.0,-90.0,-93.0,39.0,40.0,43.0,45.0,0
326,CC:2F:71:3F:1F:24,4396537,1162570787,579626,681162028,3816911,481408759,37,485414,556145249,484855,556077811,559,67438,467748,10,579863,42321,34,431,130000.0,43333.0,-67.0,-65.0,-70.0,-68.0,-67.0,-65.0,-70.0,-67.0,-90.0,-93.0,-90.0,-93.0,23.0,28.0,20.0,25.0,0
327,CC:2F:71:3E:C5:1F,3817585,481491095,674,82336,3816911,481408759,0,2897,242288,2401,183316,496,58972,715,8,1005,18,0,32,144444.0,39000.0,-70.0,-71.0,-67.0,-60.0,-70.0,-70.0,-67.0,-60.0,-90.0,-93.0,-90.0,-93.0,20.0,22.0,23.0,33.0,0
328,BA:8C:B9:54:50:24,3818634,482245716,1722,836897,3816912,481408819,0,5512,817783,5492,814661,20,3122,1004,14,2097,29,0,48,229410.0,130000.0,-39.0,-37.0,-45.0,-51.0,-42.0,-36.0,-44.0,-49.0,-90.0,-93.0,-90.0,-93.0,51.0,56.0,45.0,42.0,0
329,92:69:1D:31:68:E9,3820384,484863671,3472,3454852,3816912,481408819,0,3589,928441,3494,907351,95,21090,1792,6,3598,78,0,31,229410.0,130000.0,-51.0,-53.0,-47.0,-48.0,-51.0,-50.0,-44.0,-47.0,-90.0,-93.0,-90.0,-93.0,39.0,40.0,43.0,45.0,0
330,CC:2F:71:3F:1F:24,4396584,1162585737,579670,681176716,3816914,481409021,37,485440,556150229,484881,556082791,559,67438,467774,10,579907,42341,34,431,117000.0,39000.0,-67.0,-65.0,-71.0,-67.0,-67.0,-65.0,-70.0,-67.0,-90.0,-93.0,-90.0,-93.0,23.0,28.0,19.0,26.0,0
331,CC:2F:71:3E:C5:1F,3817590,481491559,674,82336,3816916,481409223,0,2897,242288,2401,183316,496,58972,715,8,1005,18,0,32,144444.0,39000.0,-70.0,-71.0,-67.0,-60.0,-70.0,-70.0,-67.0,-60.0,-90.0,-93.0,-90.0,-93.0,20.0,22.0,23.0,33.0,0
332,BA:8C:B9:54:50:24,3818638,482246120,1722,836897,3816916,481409223,0,5512,817783,5492,814661,20,3122,1004,14,2097,29,0,48,229410.0,130000.0,-39.0,-37.0,-45.0,-51.0,-42.0,-36.0,-44.0,-49.0,-90.0,-93.0,-90.0,-93.0,51.0,56.0,45.0,42.0,0
333,92:69:1D:31:68:E9,3820392,484864479,3472,3454852,3816920,481409627,0,3589,928441,3494,907351,95,21090,1792,6,3598,78,0,31,229410.0,130000.0,-51.0,-53.0,-47.0,-48.0,-51.0,-50.0,-44.0,-47.0,-90.0,-93.0,-90.0,-93.0,39.0,40.0,43.0,45.0,0
334,CC:2F:71:3F:1F:24,4396635,1162601155,579715,681191528,3816920,481409627,37,485467,556155313,484908,556087875,559,67438,467801,10,579952,42348,34,431,130000.0,43333.0,-67.0,-65.0,-71.0,-67.0,-67.0,-65.0,-70.0,-67.0,-90.0,-93.0,-90.0,-93.0,23.0,28.0,19.0,26.0,0
335,CC:2F:71:3E:C5:1F,3817594,481491963,674,82336,3816920,481409627,0,2897,242288,2401,183316,496,58972,715,8,1005,18,0,32,144444.0,39000.0,-70.0,-71.0,-67.0,-60.0,-70.0,-70.0,-67.0,-60.0,-90.0,-93.0,-90.0,-93.0,20.0,22.0,23.0,33.0,0
336,BA:8C:B9:54:50:24,3818642,482246524,1722,836897,3816920,481409627,0,5512,817783,5492,814661,20,3122,1004,14,2097,29,0,48,229410.0,130000.0,-39.0,-37.0,-45.0,-51.0,-42.0,-36.0,-44.0,-49.0,-90.0,-93.0,-90.0,-93.0,51.0,56.0,45.0,42.0,0
337,92:69:1D:31:68:E9,3820393,484864539,3472,3454852,3816921,481409687,0,3589,928441,3494,907351,95,21090,1792,6,3598,78,0,31,229410.0,130000.0,-51.0,-53.0,-47.0,-48.0,-51.0,-50.0,-44.0,-47.0,-90.0,-93.0,-90.0,-93.0,39.0,40.0,43.0,45.0,0
338,CC:2F:71:3F:1F:24,4396682,1162616105,579759,681206216,3816923,481409889,37,485494,556160373,484935,556092935,559,67438,467828,10,579995,42367,34,431,117000.0,39000.0,-67.0,-65.0,-70.0,-67.0,-67.0,-65.0,-70.0,-67.0,-90.0,-93.0,-90.0,-93.0,23.0,28.0,20.0,26.0,0
339,CC:2F:71:3E:C5:1F,3817599,481492427,674,82336,3816925,481410091,0,2897,242288,2401,183316,496,58972,715,8,1005,18,0,32,144444.0,39000.0,-70.0,-71.0,-67.0,-60.0,-70.0,-70.0,-67.0,-60.0,-90.0,-93.0,-90.0,-93.0,20.0,22.0,23.0,33.0,0
340,BA:8C:B9:54:50:24,3818647,482246988,1722,836897,3816925,481410091,0,5512,817783,5492,814661,20,3122,1004,14,2097,29,0,48,229410.0,130000.0,-39.0,-37.0,-45.0,-51.0,-42.0,-36.0,-44.0,-49.0,-90.0,-93.0,-90.0,-93.0,51.0,56.0,45.0,42.0,0
341,92:69:1D:31:68:E9,3820402,484865620,3472,3454852,3816930,481410768,0,3589,928441,3494,907351,95,21090,1792,6,3598,78,0,31,229410.0,130000.0,-51.0,-53.0,-47.0,-48.0,-51.0,-50.0,-44.0,-47.0,-90.0,-93.0,-90.0,-93.0,39.0,40.0,43.0,45.0,0
342,CC:2F:71:3F:1F:24,4396733,1162631672,579803,681220904,3816930,481410768,37,485519,556165177,484960,556097739,559,67438,467853,10,580040,42375,34,431,130000.0,43333.0,-67.0,-65.0,-70.0,-67.0,-67.0,-65.0,-70.0,-67.0,-90.0,-93.0,-90.0,-93.0,23.0,28.0,20.0,26.0,0
343,CC:2F:71:3E:C5:1F,3817604,481493104,674,82336,3816930,481410768,0,2897,242288,2401,183316,496,58972,715,8,1005,18,0,32,144444.0,39000.0,-70.0,-71.0,-67.0,-60.0,-70.0,-70.0,-67.0,-60.0,-90.0,-93.0,-90.0,-93.0,20.0,22.0,23.0,33.0,0
344,BA:8C:B9:54:50:24,3818652,482247665,1722,836897,3816930,481410768,0,5512,817783,5492,814661,20,3122,1004,14,2097,29,0,48,229410.0,130000.0,-39.0,-37.0,-45.0,-51.0,-42.0,-36.0,-44.0,-49.0,-90.0,-93.0,-90.0,-93.0,51.0,56.0,45.0,42.0,0
345,92:69:1D:31:68:E9,3820402,484865620,3472,3454852,3816930,481410768,0,3589,928441,3494,907351,95,21090,1792,6,3598,78,0,31,229410.0,130000.0,-51.0,-53.0,-47.0,-48.0,-51.0,-50.0,-44.0,-47.0,-90.0,-93.0,-90.0,-93.0,39.0,40.0,43.0,45.0,0
346,CC:2F:71:3F:1F:24,4396777,1162646426,579845,681235456,3816932,481410970,37,485544,556169981,484985,556102543,559,67438,467878,10,580082,42384,34,431,130000.0,43333.0,-67.0,-65.0,-71.0,-68.0,-67.0,-65.0,-70.0,-67.0,-90.0,-93.0,-90.0,-93.0,23.0,28.0,19.0,25.0,0
347,CC:2F:71:3E:C5:1F,3817608,481493508,674,82336,3816934,481411172,0,2897,242288,2401,183316,496,58972,715,8,1005,18,0,32,144444.0,39000.0,-70.0,-71.0,-67.0,-60.0,-70.0,-70.0,-67.0,-60.0,-90.0,-93.0,-90.0,-93.0,20.0,22.0,23.0,33.0,0
348,BA:8C:B9:54:50:24,3818656,482248069,1722,836897,3816934,481411172,0,5512,817783,5492,814661,20,3122,1004,14,2097,29,0,48,229410.0,130000.0,-39.0,-37.0,-45.0,-51.0,-42.0,-36.0,-44.0,-49.0,-90.0,-93.0,-90.0,-93.0,51.0,56.0,45.0,42.0,0
349,92:69:1D:31:68:E9,3820411,484866488,3472,3454852,3816939,481411636,0,3589,928441,3494,907351,95,21090,1792,6,3598,78,0,31,229410.0,130000.0,-51.0,-53.0,-47.0,-48.0,-51.0,-50.0,-44.0,-47.0,-90.0,-93.0,-90.0,-93.0,39.0,40.0,43.0,45.0,0
350,CC:2F:71:3F:1F:24,4396825,1162661452,579886,681249816,3816939,481411636,37,485570,556174925,485011,556107487,559,67438,467904,10,580123,42400,34,431,130000.0,39000.0,-67.0,-65.0,-70.0,-67.0,-67.0,-65.0,-70.0,-67.0,-90.0,-93.0,-90.0,-93.0,23.0,28.0,20.0,26.0,0
351,CC:2F:71:3E:C5:1F,3817613,481493972,674,82336,3816939,481411636,0,2897,242288,2401,183316,496,58972,715,8,1005,18,0,32,144444.0,39000.0,-70.0,-71.0,-67.0,-60.0,-70.0,-70.0,-67.0,-60.0,-90.0,-93.0,-90.0,-93.0,20.0,22.0,23.0,33.0,0
352,BA:8C:B9:54:50:24,3818661,482248533,1722,836897,3816939,481411636,0,5512,817783,5492,814661,20,3122,1004,14,2097,29,0,48,229410.0,130000.0,-39.0,-37.0,-45.0,-51.0,-42.0,-36.0,-44.0,-49.0,-90.0,-93.0,-90.0,-93.0,51.0,56.0,45.0,42.0,0
353,92:69:1D:31:68:E9,3820413,484866690,3472,3454852,3816941,481411838,0,3589,928441,3494,907351,95,21090,1792,6,3598,78,0,31,229410.0,130000.0,-51.0,-53.0,-47.0,-48.0,-51.0,-50.0,-44.0,-47.0,-90.0,-93.0,-90.0,-93.0,39.0,40.0,43.0,45.0,0
354,CC:2F:71:3F:1F:24,4396871,1162676280,579930,681264442,3816941,481411838,37,485596,556179845,485037,556112407,559,67438,467930,10,580167,42420,34,431,130000.0,43333.0,-67.0,-65.0,-70.0,-67.0,-67.0,-65.0,-70.0,-67.0,-90.0,-93.0,-90.0,-93.0,23.0,28.0,20.0,26.0,0
355,CC:2F:71:3E:C5:1F,3817617,481494376,674,82336,3816943,481412040,0,2897,242288,2401,183316,496,58972,715,8,1005,18,0,32,144444.0,39000.0,-70.0,-71.0,-67.0,-60.0,-70.0,-70.0,-67.0,-60.0,-90.0,-93.0,-90.0,-93.0,20.0,22.0,23.0,33.0,0
356,BA:8C:B9:54:50:24,3818665,482248937,1722,836897,3816943,481412040,0,5512,817783,5492,814661,20,3122,1004,14,2097,29,0,48,229410.0,130000.0,-39.0,-37.0,-45.0,-51.0,-42.0,-36.0,-44.0,-49.0,-90.0,-93.0,-90.0,-93.0,51.0,56.0,45.0,42.0,0
357,92:69:1D:31:68:E9,3820419,484867296,3472,3454852,3816947,481412444,0,3589,928441,3494,907351,95,21090,1792,6,3598,78,0,31,229410.0,130000.0,-51.0,-53.0,-47.0,-48.0,-51.0,-50.0,-44.0,-47.0,-90.0,-93.0,-90.0,-93.0,39.0,40.0,43.0,45.0,0
358,CC:2F:71:3F:1F:24,4396921,1162691518,579974,681279074,3816947,481412444,37,485623,556184905,485064,556117467,559,67438,467957,10,580211,42436,34,431,130000.0,39000.0,-67.0,-65.0,-71.0,-68.0,-67.0,-65.0,-70.0,-67.0,-90.0,-93.0,-90.0,-93.0,23.0,28.0,19.0,25.0,0
359,CC:2F:71:3E:C5:1F,3817622,481494840,674,82336,3816948,481412504,0,2897,242288,2401,183316,496,58972,715,8,1005,18,0,32,144444.0,39000.0,-70.0,-71.0,-67.0,-60.0,-70.0,-70.0,-67.0,-60.0,-90.0,-93.0,-90.0,-93.0,20.0,22.0,23.0,33.0,0
360,BA:8C:B9:54:50:24,3818670,482249401,1722,836897,3816948,481412504,0,5512,817783,5492,814661,20,3122,1004,14,2097,29,0,48,229410.0,130000.0,-39.0,-37.0,-45.0,-51.0,-42.0,-36.0,-44.0,-49.0,-90.0,-93.0,-90.0,-93.0,51.0,56.0,45.0,42.0,0
361,92:69:1D:31:68:E9,3820422,484867558,3472,3454852,3816950,481412706,0,3589,928441,3494,907351,95,21090,1792,6,3598,78,0,31,229410.0,130000.0,-51.0,-53.0,-47.0,-48.0,-51.0,-50.0,-44.0,-47.0,-90.0,-93.0,-90.0,-93.0,39.0,40.0,43.0,45.0,0
362,CC:2F:71:3F:1F:24,4396968,1162706524,580018,681293818,3816950,481412706,37,485649,556189849,485090,556122411,559,67438,467983,10,580255,42446,34,431,130000.0,43333.0,-67.0,-65.0,-70.0,-67.0,-67.0,-65.0,-70.0,-67.0,-90.0,-93.0,-90.0,-93.0,23.0,28.0,20.0,26.0,0
363,CC:2F:71:3E:C5:1F,3817624,481495042,674,82336,3816950,481412706,0,2897,242288,2401,183316,496,58972,715,8,1005,18,0,32,144444.0,39000.0,-70.0,-71.0,-67.0,-60.0,-70.0,-70.0,-67.0,-60.0,-90.0,-93.0,-90.0,-93.0,20.0,22.0,23.0,33.0,0
364,BA:8C:B9:54:50:24,3818674,482249805,1722,836897,3816952,481412908,0,5512,817783,5492,814661,20,3122,1004,14,2097,29,0,48,229410.0,130000.0,-39.0,-37.0,-45.0,-51.0,-42.0,-36.0,-44.0,-49.0,-90.0,-93.0,-90.0,-93.0,51.0,56.0,45.0,42.0,0
365,92:69:1D:31:68:E9,3820428,484868164,3472,3454852,3816956,481413312,0,3589,928441,3494,907351,95,21090,1792,6,3598,78,0,31,229410.0,130000.0,-51.0,-53.0,-47.0,-48.0,-51.0,-50.0,-44.0,-47.0,-90.0,-93.0,-90.0,-93.0,39.0,40.0,43.0,45.0,0
366,CC:2F:71:3F:1F:24,4397018,1162721874,580062,681308562,3816956,481413312,37,485674,556194653,485115,556127215,559,67438,468008,10,580299,42466,34,431,130000.0,39000.0,-67.0,-65.0,-71.0,-67.0,-67.0,-65.0,-70.0,-67.0,-90.0,-93.0,-90.0,-93.0,23.0,28.0,19.0,26.0,0
367,CC:2F:71:3E:C5:1F,3817630,481495648,674,82336,3816956,481413312,0,2897,242288,2401,183316,496,58972,715,8,1005,18,0,32,144444.0,39000.0,-70.0,-71.0,-67.0,-60.0,-70.0,-70.0,-67.0,-60.0,-90.0,-93.0,-90.0,-93.0,20.0,22.0,23.0,33.0,0
368,BA:8C:B9:54:50:24,3818678,482250209,1722,836897,3816956,481413312,0,5512,817783,5492,814661,20,3122,1004,14,2097,29,0,48,229410.0,130000.0,-39.0,-37.0,-45.0,-51.0,-42.0,-36.0,-44.0,-49.0,-90.0,-93.0,-90.0,-93.0,51.0,56.0,45.0,42.0,0
369,92:69:1D:31:68:E9,3820431,484868426,3472,3454852,3816959,481413574,0,3589,928441,3494,907351,95,21090,1792,6,3598,78,0,31,229410.0,130000.0,-51.0,-53.0,-47.0,-48.0,-51.0,-50.0,-44.0,-47.0,-90.0,-93.0,-90.0,-93.0,39.0,40.0,43.0,45.0,0
370,CC:2F:71:3F:1F:24,4397065,1162736824,580106,681323250,3816959,481413574,37,485700,556199597,485141,556132159,559,67438,468034,10,580343,42477,34,431,130000.0,39000.0,-67.0,-65.0,-70.0,-67.0,-67.0,-65.0,-70.0,-67.0,-90.0,-93.0,-90.0,-93.0,23.0,28.0,20.0,26.0,0
371,CC:2F:71:3E:C5:1F,3817633,481495910,674,82336,3816959,481413574,0,2897,242288,2401,183316,496,58972,715,8,1005,18,0,32,144444.0,39000.0,-70.0,-71.0,-67.0,-60.0,-70.0,-70.0,-67.0,-60.0,-90.0,-93.0,-90.0,-93.0,20.0,22.0,23.0,33.0,0
372,BA:8C:B9:54:50:24,3818683,482250673,1722,836897,3816961,481413776,0,5512,817783,5492,814661,20,3122,1004,14,2097,29,0,48,229410.0,130000.0,-39.0,-37.0,-45.0,-51.0,-42.0,-36.0,-44.0,-49.0,-90.0,-93.0,-90.0,-93.0,51.0,56.0,45.0,42.0,0
373,92:69:1D:31:68:E9,3820437,484869032,3472,3454852,3816965,481414180,0,3589,928441,3494,907351,95,21090,1792,6,3598,78,0,31,229410.0,130000.0,-51.0,-53.0,-47.0,-48.0,-51.0,-50.0,-44.0,-47.0,-90.0,-93.0,-90.0,-93.0,39.0,40.0,43.0,45.0,0
374,CC:2F:71:3F:1F:24,4397115,1162752174,580150,681337994,3816965,481414180,37,485726,556204541,485167,556137103,559,67438,468060,10,580387,42487,34,431,130000.0,43333.0,-67.0,-65.0,-70.0,-67.0,-67.0,-65.0,-70.0,-67.0,-90.0,-93.0,-90.0,-93.0,23.0,28.0,20.0,26.0,0
375,CC:2F:71:3E:C5:1F,3817639,481496516,674,82336,3816965,481414180,0,2897,242288,2401,183316,496,58972,715,8,1005,18,0,32,144444.0,39000.0,-70.0,-71.0,-67.0,-60.0,-70.0,-70.0,-67.0,-60.0,-90.0,-93.0,-90.0,-93.0,20.0,22.0,23.0,33.0,0
376,BA:8C:B9:54:50:24,3818687,482251077,1722,836897,3816965,481414180,0,5512,817783,5492,814661,20,3122,1004,14,2097,29,0,48,229410.0,130000.0,-39.0,-37.0,-45.0,-51.0,-42.0,-36.0,-44.0,-49.0,-90.0,-93.0,-90.0,-93.0,51.0,56.0,45.0,42.0,0
377,92:69:1D:31:68:E9,3820439,484869234,3472,3454852,3816967,481414382,0,3589,928441,3494,907351,95,21090,1792,6,3598,78,0,31,229410.0,130000.0,-51.0,-53.0,-47.0,-48.0,-51.0,-50.0,-44.0,-47.0,-90.0,-93.0,-90.0,-93.0,39.0,40.0,43.0,45.0,0
378,CC:2F:71:3F:1F:24,4397159,1162766816,580192,681352434,3816967,481414382,37,485751,556209345,485192,556141907,559,67438,468085,10,580429,42508,34,431,117000.0,39000.0,-67.0,-65.0,-70.0,-67.0,-67.0,-65.0,-70.0,-67.0,-90.0,-93.0,-90.0,-93.0,23.0,28.0,20.0,26.0,0
379,CC:2F:71:3E:C5:1F,3817641,481496718,674,82336,3816967,481414382,0,2897,242288,2401,183316,496,58972,715,8,1005,18,0,32,144444.0,39000.0,-70.0,-71.0,-67.0,-60.0,-70.0,-70.0,-67.0,-60.0,-90.0,-93.0,-90.0,-93.0,20.0,22.0,23.0,33.0,0
380,BA:8C:B9:54:50:24,3818691,482251481,1722,836897,3816969,481414584,0,5512,817783,5492,814661,20,3122,1004,14,2097,29,0,48,229410.0,130000.0,-39.0,-37.0,-45.0,-51.0,-42.0,-36.0,-44.0,-49.0,-90.0,-93.0,-90.0,-93.0,51.0,56.0,45.0,42.0,0
381,92:69:1D:31:68:E9,3820446,484869900,3472,3454852,3816974,481415048,0,3590,928509,3495,907419,95,21090,1792,6,3598,78,0,31,229410.0,130000.0,-52.0,-51.0,-47.0,-48.0,-51.0,-51.0,-45.0,-47.0,-90.0,-93.0,-90.0,-93.0,38.0,42.0,43.0,45.0,0
382,CC:2F:71:3F:1F:24,4397209,1162782040,580235,681366992,3816974,481415048,37,485778,556214429,485219,556146991,559,67438,468112,10,580472,42515,34,431,130000.0,43333.0,-67.0,-65.0,-70.0,-67.0,-67.0,-65.0,-70.0,-67.0,-90.0,-93.0,-90.0,-93.0,23.0,28.0,20.0,26.0,0
383,CC:2F:71:3E:C5:1F,3817648,481497384,674,82336,3816974,481415048,0,2897,242288,2401,183316,496,58972,715,8,1005,18,0,32,144444.0,39000.0,-70.0,-71.0,-67.0,-60.0,-70.0,-70.0,-67.0,-60.0,-90.0,-93.0,-90.0,-93.0,20.0,22.0,23.0,33.0,0
384,BA:8C:B9:54:50:24,3818696,482251945,1722,836897,3816974,481415048,0,5512,817783,5492,814661,20,3122,1004,14,2097,29,0,48,229410.0,130000.0,-39.0,-37.0,-45.0,-51.0,-42.0,-36.0,-44.0,-49.0,-90.0,-93.0,-90.0,-93.0,51.0,56.0,45.0,42.0,0
385,92:69:1D:31:68:E9,3820448,484870102,3472,3454852,3816976,481415250,0,3590,928509,3495,907419,95,21090,1792,6,3598,78,0,31,229410.0,130000.0,-52.0,-51.0,-47.0,-48.0,-51.0,-51.0,-45.0,-47.0,-90.0,-93.0,-90.0,-93.0,38.0,42.0,43.0,45.0,0
386,CC:2F:71:3F:1F:24,4397256,1162797188,580280,681381938,3816976,481415250,37,485805,556219501,485246,556152063,559,67438,468139,10,580517,42532,34,431,117000.0,39000.0,-67.0,-65.0,-70.0,-67.0,-67.0,-65.0,-70.0,-67.0,-90.0,-93.0,-90.0,-93.0,23.0,28.0,20.0,26.0,0
387,CC:2F:71:3E:C5:1F,3817652,481497788,674,82336,3816978,481415452,0,2897,242288,2401,183316,496,58972,715,8,1005,18,0,32,144444.0,39000.0,-70.0,-71.0,-67.0,-60.0,-70.0,-70.0,-67.0,-60.0,-90.0,-93.0,-90.0,-93.0,20.0,22.0,23.0,33.0,0
388,BA:8C:B9:54:50:24,3818700,482252349,1722,836897,3816978,481415452,0,5512,817783,5492,814661,20,3122,1004,14,2097,29,0,48,229410.0,130000.0,-39.0,-37.0,-45.0,-51.0,-42.0,-36.0,-44.0,-49.0,-90.0,-93.0,-90.0,-93.0,51.0,56.0,45.0,42.0,0
389,92:69:1D:31:68:E9,3820455,484870768,3472,3454852,3816983,481415916,0,3590,928509,3495,907419,95,21090,1792,6,3598,78,0,31,229410.0,130000.0,-52.0,-51.0,-47.0,-48.0,-51.0,-51.0,-45.0,-47.0,-91.0,-93.0,-90.0,-93.0,39.0,42.0,43.0,45.0,0
390,CC:2F:71:3F:1F:24,4397308,1162812666,580325,681396750,3816983,481415916,37,485831,556224421,485272,556156983,559,67438,468165,10,580562,42537,34,431,130000.0,43333.0,-67.0,-65.0,-70.0,-67.0,-67.0,-65.0,-70.0,-67.0,-91.0,-93.0,-90.0,-93.0,24.0,28.0,20.0,26.0,0
391,CC:2F:71:3E:C5:1F,3817657,481498252,674,82336,3816983,481415916,0,2897,242288,2401,183316,496,58972,715,8,1005,18,0,32,144444.0,39000.0,-70.0,-71.0,-67.0,-60.0,-70.0,-70.0,-67.0,-60.0,-91.0,-93.0,-90.0,-93.0,21.0,22.0,23.0,33.0,0
392,BA:8C:B9:54:50:24,3818705,482252813,1722,836897,3816983,481415916,0,5512,817783,5492,814661,20,3122,1004,14,2097,29,0,48,229410.0,130000.0,-39.0,-37.0,-45.0,-51.0,-42.0,-36.0,-44.0,-49.0,-91.0,-93.0,-90.0,-93.0,52.0,56.0,45.0,42.0,0
393,92:69:1D:31:68:E9,3820459,484871359,3473,3454968,3816986,481416391,0,3592,928645,3497,907555,95,21090,1792,6,3599,78,0,31,229410.0,137640.0,-50.0,-47.0,-42.0,-48.0,-51.0,-50.0,-45.0,-48.0,-91.0,-93.0,-90.0,-93.0,41.0,46.0,48.0,45.0,0
394,CC:2F:71:3F:1F:24,4397357,1162828129,580369,681411536,3816988,481416593,37,485857,556229341,485298,556161903,559,67438,468191,10,580606,42544,34,431,130000.0,43333.0,-67.0,-65.0,-70.0,-68.0,-66.0,-65.0,-70.0,-67.0,-91.0,-93.0,-90.0,-93.0,24.0,28.0,20.0,25.0,0
395,CC:2F:71:3E:C5:1F,3817663,481499045,675,82452,3816988,481416593,0,2899,242428,2403,183456,496,58972,715,8,1006,18,0,32,144444.0,43333.0,-70.0,-71.0,-67.0,-60.0,-70.0,-70.0,-67.0,-60.0,-91.0,-93.0,-90.0,-93.0,21.0,22.0,23.0,33.0,0
396,BA:8C:B9:54:50:24,3818711,482253606,1723,837013,3816988,481416593,0,5516,818055,5496,814933,20,3122,1004,14,2098,29,0,48,229410.0,137640.0,-40.0,-37.0,-45.0,-51.0,-41.0,-36.0,-43.0,-48.0,-91.0,-93.0,-90.0,-93.0,51.0,56.0,45.0,42.0,0
397,92:69:1D:31:68:E9,3820465,484871965,3473,3454968,3816992,481416997,0,3592,928645,3497,907555,95,21090,1792,6,3599,78,0,31,229410.0,137640.0,-50.0,-47.0,-42.0,-48.0,-51.0,-50.0,-45.0,-48.0,-91.0,-93.0,-90.0,-93.0,41.0,46.0,48.0,45.0,0
398,CC:2F:71:3F:1F:24,4397405,1162843203,580412,681426144,3816993,481417059,37,485884,556234439,485324,556166883,560,67556,468218,10,580649,42560,34,431,130000.0,39000.0,-67.0,-65.0,-70.0,-67.0,-67.0,-65.0,-70.0,-67.0,-91.0,-93.0,-90.0,-93.0,24.0,28.0,20.0,26.0,0
399,CC:2F:71:3E:C5:1F,3817668,481499511,675,82452,3816993,481417059,0,2899,242428,2403,183456,496,58972,715,8,1006,18,0,32,144444.0,43333.0,-70.0,-71.0,-67.0,-60.0,-70.0,-70.0,-67.0,-60.0,-91.0,-93.0,-90.0,-93.0,21.0,22.0,23.0,33.0,0
400,BA:8C:B9:54:50:24,3818716,482254072,1723,837013,3816993,481417059,0,5516,818055,5496,814933,20,3122,1004,14,2098,29,0,48,229410.0,137640.0,-40.0,-37.0,-45.0,-51.0,-41.0,-36.0,-43.0,-48.0,-91.0,-93.0,-90.0,-93.0,51.0,56.0,45.0,42.0,0
401,92:69:1D:31:68:E9,3820469,484872289,3473,3454968,3816996,481417321,0,3592,928645,3497,907555,95,21090,1792,6,3599,78,0,31,229410.0,137640.0,-50.0,-47.0,-42.0,-48.0,-51.0,-50.0,-45.0,-48.0,-91.0,-93.0,-90.0,-93.0,41.0,46.0,48.0,45.0,0
402,CC:2F:71:3F:1F:24,4397451,1162857915,580453,681440392,3816998,481417523,37,485910,556239383,485350,556171827,560,67556,468244,10,580690,42583,34,431,130000.0,43333.0,-67.0,-65.0,-70.0,-68.0,-67.0,-65.0,-70.0,-67.0,-91.0,-93.0,-90.0,-93.0,24.0,28.0,20.0,25.0,0
403,CC:2F:71:3E:C5:1F,3817673,481499975,675,82452,3816998,481417523,0,2899,242428,2403,183456,496,58972,715,8,1006,18,0,32,144444.0,43333.0,-70.0,-71.0,-67.0,-60.0,-70.0,-70.0,-67.0,-60.0,-91.0,-93.0,-90.0,-93.0,21.0,22.0,23.0,33.0,0
404,BA:8C:B9:54:50:24,3818721,482254536,1723,837013,3816998,481417523,0,5516,818055,5496,814933,20,3122,1004,14,2098,29,0,48,229410.0,137640.0,-40.0,-37.0,-45.0,-51.0,-41.0,-36.0,-43.0,-48.0,-91.0,-93.0,-90.0,-93.0,51.0,56.0,45.0,42.0,0
405,92:69:1D:31:68:E9,3820475,484872895,3473,3454968,3817002,481417927,0,3592,928645,3497,907555,95,21090,1792,6,3599,78,0,31,229410.0,137640.0,-50.0,-47.0,-42.0,-48.0,-51.0,-50.0,-45.0,-48.0,-91.0,-93.0,-90.0,-93.0,41.0,46.0,48.0,45.0,0
406,CC:2F:71:3F:1F:24,4397497,1162872859,580495,681454932,3817002,481417927,37,485936,556244303,485376,556176747,560,67556,468270,10,580732,42591,34,431,130000.0,43333.0,-67.0,-65.0,-70.0,-68.0,-67.0,-65.0,-70.0,-67.0,-91.0,-93.0,-90.0,-93.0,24.0,28.0,20.0,25.0,0
407,CC:2F:71:3E:C5:1F,3817677,481500379,675,82452,3817002,481417927,0,2899,242428,2403,183456,496,58972,715,8,1006,18,0,32,144444.0,43333.0,-70.0,-71.0,-67.0,-60.0,-70.0,-70.0,-67.0,-60.0,-91.0,-93.0,-90.0,-93.0,21.0,22.0,23.0,33.0,0
408,BA:8C:B9:54:50:24,3818725,482254940,1723,837013,3817002,481417927,0,5516,818055,5496,814933,20,3122,1004,14,2098,29,0,48,229410.0,137640.0,-40.0,-37.0,-45.0,-51.0,-41.0,-36.0,-43.0,-48.0,-91.0,-93.0,-90.0,-93.0,51.0,56.0,45.0,42.0,0
409,92:69:1D:31:68:E9,3820479,484873465,3473,3454968,3817006,481418497,0,3592,928645,3497,907555,95,21090,1792,6,3599,78,0,31,229410.0,137640.0,-50.0,-47.0,-42.0,-48.0,-51.0,-50.0,-45.0,-48.0,-91.0,-93.0,-90.0,-93.0,41.0,46.0,48.0,45.0,0
410,CC:2F:71:3F:1F:24,4397544,1162888047,580536,681469348,3817008,481418699,37,485963,556249363,485403,556181807,560,67556,468297,10,580773,42596,34,431,130000.0,43333.0,-67.0,-65.0,-70.0,-68.0,-67.0,-65.0,-70.0,-67.0,-91.0,-93.0,-90.0,-93.0,24.0,28.0,20.0,25.0,0
411,CC:2F:71:3E:C5:1F,3817683,481501151,675,82452,3817008,481418699,0,2899,242428,2403,183456,496,58972,715,8,1006,18,0,32,144444.0,43333.0,-70.0,-71.0,-67.0,-60.0,-70.0,-70.0,-67.0,-60.0,-91.0,-93.0,-90.0,-93.0,21.0,22.0,23.0,33.0,0
412,BA:8C:B9:54:50:24,3818731,482255712,1723,837013,3817008,481418699,0,5516,818055,5496,814933,20,3122,1004,14,2098,29,0,48,229410.0,137640.0,-40.0,-37.0,-45.0,-51.0,-41.0,-36.0,-43.0,-48.0,-91.0,-93.0,-90.0,-93.0,51.0,56.0,45.0,42.0,0
413,92:69:1D:31:68:E9,3820486,484874131,3473,3454968,3817013,481419163,0,3592,928645,3497,907555,95,21090,1792,6,3599,78,0,31,229410.0,137640.0,-50.0,-47.0,-42.0,-48.0,-51.0,-50.0,-45.0,-48.0,-91.0,-93.0,-90.0,-93.0,41.0,46.0,48.0,45.0,0
414,CC:2F:71:3F:1F:24,4397590,1162902815,580577,681483652,3817013,481419163,37,485989,556254307,485429,556186751,560,67556,468323,10,580814,42613,34,431,117000.0,39000.0,-67.0,-65.0,-70.0,-68.0,-67.0,-65.0,-70.0,-67.0,-91.0,-93.0,-90.0,-93.0,24.0,28.0,20.0,25.0,0
415,CC:2F:71:3E:C5:1F,3817688,481501615,675,82452,3817013,481419163,0,2899,242428,2403,183456,496,58972,715,8,1006,18,0,32,144444.0,43333.0,-70.0,-71.0,-67.0,-60.0,-70.0,-70.0,-67.0,-60.0,-91.0,-93.0,-90.0,-93.0,21.0,22.0,23.0,33.0,0
416,BA:8C:B9:54:50:24,3818736,482256176,1723,837013,3817013,481419163,0,5516,818055,5496,814933,20,3122,1004,14,2098,29,0,48,229410.0,137640.0,-40.0,-37.0,-45.0,-51.0,-41.0,-36.0,-43.0,-48.0,-91.0,-93.0,-90.0,-93.0,51.0,56.0,45.0,42.0,0
417,92:69:1D:31:68:E9,3820490,484874535,3473,3454968,3817017,481419567,0,3592,928645,3497,907555,95,21090,1792,6,3599,78,0,31,229410.0,137640.0,-50.0,-47.0,-42.0,-48.0,-51.0,-50.0,-45.0,-48.0,-91.0,-93.0,-90.0,-93.0,41.0,46.0,48.0,45.0,0
418,CC:2F:71:3F:1F:24,4397637,1162917777,580620,681498210,3817017,481419567,37,486014,556259111,485454,556191555,560,67556,468348,10,580857,42621,34,431,130000.0,43333.0,-67.0,-65.0,-71.0,-67.0,-67.0,-65.0,-70.0,-67.0,-91.0,-93.0,-90.0,-93.0,24.0,28.0,19.0,26.0,0
419,CC:2F:71:3E:C5:1F,3817692,481502019,675,82452,3817017,481419567,0,2899,242428,2403,183456,496,58972,715,8,1006,18,0,32,144444.0,43333.0,-70.0,-71.0,-67.0,-60.0,-70.0,-70.0,-67.0,-60.0,-91.0,-93.0,-90.0,-93.0,21.0,22.0,23.0,33.0,0
420,BA:8C:B9:54:50:24,3818740,482256580,1723,837013,3817017,481419567,0,5516,818055,5496,814933,20,3122,1004,14,2098,29,0,48,229410.0,137640.0,-40.0,-37.0,-45.0,-51.0,-41.0,-36.0,-43.0,-48.0,-91.0,-93.0,-90.0,-93.0,51.0,56.0,45.0,42.0,0
421,92:69:1D:31:68:E9,3820495,484874999,3473,3454968,3817022,481420031,0,3592,928645,3497,907555,95,21090,1792,6,3599,78,0,31,229410.0,137640.0,-50.0,-47.0,-42.0,-48.0,-51.0,-50.0,-45.0,-48.0,-91.0,-93.0,-90.0,-93.0,41.0,46.0,48.0,45.0,0
422,CC:2F:71:3F:1F:24,4397687,1162933071,580665,681513040,3817022,481420031,37,486042,556264299,485482,556196743,560,67556,468376,10,580902,42643,34,431,117000.0,39000.0,-67.0,-65.0,-70.0,-67.0,-67.0,-65.0,-70.0,-67.0,-91.0,-93.0,-90.0,-93.0,24.0,28.0,20.0,26.0,0
423,CC:2F:71:3E:C5:1F,3817697,481502483,675,82452,3817022,481420031,0,2899,242428,2403,183456,496,58972,715,8,1006,18,0,32,144444.0,43333.0,-70.0,-71.0,-67.0,-60.0,-70.0,-70.0,-67.0,-60.0,-91.0,-93.0,-90.0,-93.0,21.0,22.0,23.0,33.0,0
424,BA:8C:B9:54:50:24,3818745,482257044,1723,837013,3817022,481420031,0,5516,818055,5496,814933,20,3122,1004,14,2098,29,0,48,229410.0,137640.0,-40.0,-37.0,-45.0,-51.0,-41.0,-36.0,-43.0,-48.0,-91.0,-93.0,-90.0,-93.0,51.0,56.0,45.0,42.0,0
425,92:69:1D:31:68:E9,3820497,484875201,3473,3454968,3817024,481420233,0,3592,928645,3497,907555,95,21090,1792,6,3599,78,0,31,229410.0,137640.0,-50.0,-47.0,-42.0,-48.0,-51.0,-50.0,-45.0,-48.0,-91.0,-93.0,-90.0,-93.0,41.0,46.0,48.0,45.0,0
426,CC:2F:71:3F:1F:24,4397732,1162947779,580706,681527344,3817026,481420435,37,486068,556269243,485508,556201687,560,67556,468402,10,580943,42650,34,431,130000.0,43333.0,-67.0,-65.0,-70.0,-67.0,-67.0,-65.0,-70.0,-67.0,-91.0,-93.0,-90.0,-93.0,24.0,28.0,20.0,26.0,0
427,CC:2F:71:3E:C5:1F,3817701,481502887,675,82452,3817026,481420435,0,2899,242428,2403,183456,496,58972,715,8,1006,18,0,32,144444.0,43333.0,-70.0,-71.0,-67.0,-60.0,-70.0,-70.0,-67.0,-60.0,-91.0,-93.0,-90.0,-93.0,21.0,22.0,23.0,33.0,0
428,BA:8C:B9:54:50:24,3818749,482257448,1723,837013,3817026,481420435,0,5516,818055,5496,814933,20,3122,1004,14,2098,29,0,48,229410.0,137640.0,-40.0,-37.0,-45.0,-51.0,-41.0,-36.0,-43.0,-48.0,-91.0,-93.0,-90.0,-93.0,51.0,56.0,45.0,42.0,0
429,92:69:1D:31:68:E9,3820503,484875807,3473,3454968,3817030,481420839,0,3592,928645,3497,907555,95,21090,1792,6,3599,78,0,31,229410.0,137640.0,-50.0,-47.0,-42.0,-48.0,-51.0,-50.0,-45.0,-48.0,-91.0,-93.0,-90.0,-93.0,41.0,46.0,48.0,45.0,0
430,CC:2F:71:3F:1F:24,4397780,1162962971,580750,681542132,3817030,481420839,37,486094,556274223,485534,556206667,560,67556,468428,10,580987,42657,34,431,130000.0,43333.0,-67.0,-65.0,-70.0,-67.0,-67.0,-65.0,-70.0,-67.0,-91.0,-93.0,-90.0,-93.0,24.0,28.0,20.0,26.0,0
431,CC:2F:71:3E:C5:1F,3817705,481503291,675,82452,3817030,481420839,0,2899,242428,2403,183456,496,58972,715,8,1006,18,0,32,144444.0,43333.0,-70.0,-71.0,-67.0,-60.0,-70.0,-70.0,-67.0,-60.0,-91.0,-93.0,-90.0,-93.0,21.0,22.0,23.0,33.0,0
432,BA:8C:B9:54:50:24,3818753,482257852,1723,837013,3817030,481420839,0,5517,818123,5497,815001,20,3122,1004,14,2098,29,0,48,229410.0,137640.0,-40.0,-37.0,-45.0,-51.0,-41.0,-36.0,-43.0,-48.0,-91.0,-93.0,-90.0,-93.0,51.0,56.0,45.0,42.0,0
433,92:69:1D:31:68:E9,3820508,484876271,3473,3454968,3817035,481421303,0,3592,928645,3497,907555,95,21090,1792,6,3599,78,0,31,229410.0,137640.0,-50.0,-47.0,-42.0,-48.0,-51.0,-50.0,-45.0,-48.0,-91.0,-93.0,-90.0,-93.0,41.0,46.0,48.0,45.0,0
434,CC:2F:71:3F:1F:24,4397827,1162977919,580792,681556616,3817035,481421303,37,486120,556279203,485560,556211647,560,67556,468454,10,581029,42677,34,431,130000.0,39000.0,-67.0,-65.0,-70.0,-68.0,-67.0,-65.0,-70.0,-67.0,-91.0,-93.0,-90.0,-93.0,24.0,28.0,20.0,25.0,0
435,CC:2F:71:3E:C5:1F,3817710,481503755,675,82452,3817035,481421303,0,2899,242428,2403,183456,496,58972,715,8,1006,18,0,32,144444.0,43333.0,-70.0,-71.0,-67.0,-60.0,-70.0,-70.0,-67.0,-60.0,-91.0,-93.0,-90.0,-93.0,21.0,22.0,23.0,33.0,0
436,BA:8C:B9:54:50:24,3818758,482258316,1723,837013,3817035,481421303,0,5519,818259,5499,815137,20,3122,1004,14,2098,29,0,48,229410.0,137640.0,-40.0,-37.0,-44.0,-51.0,-42.0,-35.0,-43.0,-47.0,-91.0,-93.0,-90.0,-93.0,51.0,56.0,46.0,42.0,0
437,92:69:1D:31:68:E9,3820513,484876737,3473,3454968,3817040,481421769,0,3592,928645,3497,907555,95,21090,1792,6,3599,78,0,31,229410.0,137640.0,-50.0,-47.0,-42.0,-48.0,-51.0,-50.0,-45.0,-48.0,-90.0,-93.0,-89.0,-93.0,40.0,46.0,47.0,45.0,0
438,CC:2F:71:3F:1F:24,4397874,1162992757,580834,681570988,3817040,481421769,37,486146,556284147,485586,556216591,560,67556,468480,10,581071,42702,34,431,130000.0,43333.0,-67.0,-65.0,-71.0,-68.0,-67.0,-65.0,-70.0,-67.0,-90.0,-93.0,-89.0,-93.0,23.0,28.0,18.0,25.0,0
439,CC:2F:71:3E:C5:1F,3817715,481504221,675,82452,3817040,481421769,0,2901,242616,2404,183526,497,59090,716,8,1006,18,0,32,144444.0,43333.0,-71.0,-71.0,-67.0,-60.0,-70.0,-70.0,-67.0,-60.0,-90.0,-93.0,-89.0,-93.0,19.0,22.0,22.0,33.0,0
440,BA:8C:B9:54:50:24,3818763,482258782,1723,837013,3817040,481421769,0,5519,818259,5499,815137,20,3122,1004,14,2098,29,0,48,229410.0,137640.0,-40.0,-37.0,-44.0,-51.0,-42.0,-35.0,-43.0,-47.0,-90.0,-93.0,-89.0,-93.0,50.0,56.0,45.0,42.0,0
441,92:69:1D:31:68:E9,3820517,484877141,3473,3454968,3817044,481422173,0,3592,928645,3497,907555,95,21090,1792,6,3599,78,0,31,229410.0,137640.0,-50.0,-47.0,-42.0,-48.0,-51.0,-50.0,-45.0,-48.0,-90.0,-93.0,-89.0,-93.0,40.0,46.0,47.0,45.0,0
442,CC:2F:71:3F:1F:24,4397921,1163007761,580876,681585528,3817045,481422233,37,486172,556289091,485612,556221535,560,67556,468506,10,581113,42707,34,431,130000.0,43333.0,-67.0,-65.0,-71.0,-67.0,-67.0,-65.0,-70.0,-67.0,-90.0,-93.0,-89.0,-93.0,23.0,28.0,18.0,26.0,0
443,CC:2F:71:3E:C5:1F,3817720,481504685,675,82452,3817045,481422233,0,2901,242616,2404,183526,497,59090,716,8,1006,18,0,32,144444.0,43333.0,-71.0,-71.0,-67.0,-60.0,-70.0,-70.0,-67.0,-60.0,-90.0,-93.0,-89.0,-93.0,19.0,22.0,22.0,33.0,0
444,BA:8C:B9:54:50:24,3818768,482259246,1723,837013,3817045,481422233,0,5519,818259,5499,815137,20,3122,1004,14,2098,29,0,48,229410.0,137640.0,-40.0,-37.0,-44.0,-51.0,-42.0,-35.0,-43.0,-47.0,-90.0,-93.0,-89.0,-93.0,50.0,56.0,45.0,42.0,0
445,92:69:1D:31:68:E9,3820523,484877878,3473,3454968,3817050,481422910,0,3592,928645,3497,907555,95,21090,1792,6,3599,78,0,31,229410.0,137640.0,-50.0,-47.0,-42.0,-48.0,-51.0,-50.0,-45.0,-48.0,-90.0,-93.0,-89.0,-93.0,40.0,46.0,47.0,45.0,0
446,CC:2F:71:3F:1F:24,4397969,1163023102,580919,681600192,3817050,481422910,37,486199,556294175,485639,556226619,560,67556,468533,10,581156,42709,34,431,130000.0,43333.0,-67.0,-65.0,-70.0,-68.0,-67.0,-65.0,-70.0,-67.0,-90.0,-93.0,-89.0,-93.0,23.0,28.0,19.0,25.0,0
447,CC:2F:71:3E:C5:1F,3817725,481505362,675,82452,3817050,481422910,0,2901,242616,2404,183526,497,59090,716,8,1006,18,0,32,144444.0,43333.0,-71.0,-71.0,-67.0,-60.0,-70.0,-70.0,-67.0,-60.0,-90.0,-93.0,-89.0,-93.0,19.0,22.0,22.0,33.0,0
448,BA:8C:B9:54:50:24,3818773,482259923,1723,837013,3817050,481422910,0,5519,818259,5499,815137,20,3122,1004,14,2098,29,0,48,229410.0,137640.0,-40.0,-37.0,-44.0,-51.0,-42.0,-35.0,-43.0,-47.0,-90.0,-93.0,-89.0,-93.0,50.0,56.0,45.0,42.0,0
449,92:69:1D:31:68:E9,3820527,484878282,3473,3454968,3817054,481423314,0,3592,928645,3497,907555,95,21090,1792,6,3599,78,0,31,229410.0,137640.0,-50.0,-47.0,-42.0,-48.0,-51.0,-50.0,-45.0,-48.0,-90.0,-93.0,-89.0,-93.0,40.0,46.0,47.0,45.0,0
450,CC:2F:71:3F:1F:24,4398016,1163038114,580962,681614800,3817054,481423314,37,486225,556299119,485665,556231563,560,67556,468559,10,581199,42724,34,431,130000.0,39000.0,-67.0,-65.0,-70.0,-67.0,-67.0,-65.0,-70.0,-67.0,-90.0,-93.0,-89.0,-93.0,23.0,28.0,19.0,26.0,0
451,CC:2F:71:3E:C5:1F,3817729,481505766,675,82452,3817054,481423314,0,2901,242616,2404,183526,497,59090,716,8,1006,18,0,32,144444.0,43333.0,-71.0,-71.0,-67.0,-60.0,-70.0,-70.0,-67.0,-60.0,-90.0,-93.0,-89.0,-93.0,19.0,22.0,22.0,33.0,0
452,BA:8C:B9:54:50:24,3818777,482260327,1723,837013,3817054,481423314,0,5519,818259,5499,815137,20,3122,1004,14,2098,29,0,48,229410.0,137640.0,-40.0,-37.0,-44.0,-51.0,-42.0,-35.0,-43.0,-47.0,-90.0,-93.0,-89.0,-93.0,50.0,56.0,45.0,42.0,0
453,92:69:1D:31:68:E9,3820532,484878746,3473,3454968,3817059,481423778,0,3592,928645,3497,907555,95,21090,1792,6,3599,78,0,31,229410.0,137640.0,-50.0,-47.0,-42.0,-48.0,-51.0,-50.0,-45.0,-48.0,-90.0,-93.0,-89.0,-93.0,40.0,46.0,47.0,45.0,0
454,CC:2F:71:3F:1F:24,4398065,1163053198,581006,681629420,3817059,481423778,37,486251,556304063,485691,556236507,560,67556,468585,10,581242,42740,34,431,130000.0,43333.0,-67.0,-65.0,-70.0,-67.0,-67.0,-65.0,-70.0,-67.0,-90.0,-93.0,-89.0,-93.0,23.0,28.0,19.0,26.0,0
455,CC:2F:71:3E:C5:1F,3817734,481506230,675,82452,3817059,481423778,0,2901,242616,2404,183526,497,59090,716,8,1006,18,0,32,144444.0,43333.0,-71.0,-71.0,-67.0,-60.0,-70.0,-70.0,-67.0,-60.0,-90.0,-93.0,-89.0,-93.0,19.0,22.0,22.0,33.0,0
456,BA:8C:B9:54:50:24,3818782,482260791,1723,837013,3817059,481423778,0,5520,818327,5500,815205,20,3122,1004,14,2098,29,0,48,229410.0,137640.0,-39.0,-37.0,-45.0,-51.0,-42.0,-35.0,-43.0,-47.0,-90.0,-93.0,-89.0,-93.0,51.0,56.0,44.0,42.0,0
457,92:69:1D:31:68:E9,3820534,484878948,3473,3454968,3817061,481423980,0,3592,928645,3497,907555,95,21090,1792,6,3599,78,0,31,229410.0,137640.0,-50.0,-47.0,-42.0,-48.0,-51.0,-50.0,-45.0,-48.0,-90.0,-93.0,-89.0,-93.0,40.0,46.0,47.0,45.0,0
458,CC:2F:71:3F:1F:24,4398112,1163068154,581049,681643972,3817063,481424182,37,486277,556309007,485717,556241451,560,67556,468611,10,581286,42770,34,431,144444.0,39000.0,-67.0,-65.0,-70.0,-67.0,-67.0,-65.0,-70.0,-67.0,-90.0,-93.0,-89.0,-93.0,23.0,28.0,19.0,26.0,0
459,CC:2F:71:3E:C5:1F,3817738,481506634,675,82452,3817063,481424182,0,2901,242616,2404,183526,497,59090,716,8,1006,18,0,32,144444.0,43333.0,-71.0,-71.0,-67.0,-60.0,-70.0,-70.0,-67.0,-60.0,-90.0,-93.0,-89.0,-93.0,19.0,22.0,22.0,33.0,0
460,BA:8C:B9:54:50:24,3818786,482261195,1723,837013,3817063,481424182,0,5520,818327,5500,815205,20,3122,1004,14,2098,29,0,48,229410.0,137640.0,-39.0,-37.0,-45.0,-51.0,-42.0,-35.0,-43.0,-47.0,-90.0,-93.0,-89.0,-93.0,51.0,56.0,44.0,42.0,0
461,92:69:1D:31:68:E9,3820540,484879554,3473,3454968,3817067,481424586,0,3592,928645,3497,907555,95,21090,1792,6,3599,78,0,31,229410.0,137640.0,-50.0,-47.0,-42.0,-48.0,-51.0,-50.0,-45.0,-48.0,-90.0,-93.0,-89.0,-93.0,40.0,46.0,47.0,45.0,0
462,CC:2F:71:3F:1F:24,4398158,1163082874,581091,681658288,3817067,481424586,37,486302,556313811,485742,556246255,560,67556,468636,10,581328,42797,34,431,130000.0,43333.0,-67.0,-65.0,-70.0,-67.0,-67.0,-65.0,-70.0,-67.0,-90.0,-93.0,-89.0,-93.0,23.0,28.0,19.0,26.0,0
463,CC:2F:71:3E:C5:1F,3817742,481507038,675,82452,3817067,481424586,0,2901,242616,2404,183526,497,59090,716,8,1006,18,0,32,144444.0,43333.0,-71.0,-71.0,-67.0,-60.0,-70.0,-70.0,-67.0,-60.0,-90.0,-93.0,-89.0,-93.0,19.0,22.0,22.0,33.0,0
464,BA:8C:B9:54:50:24,3818791,482261659,1723,837013,3817068,481424646,0,5520,818327,5500,815205,20,3122,1004,14,2098,29,0,48,229410.0,137640.0,-39.0,-37.0,-45.0,-51.0,-42.0,-35.0,-43.0,-47.0,-90.0,-93.0,-89.0,-93.0,51.0,56.0,44.0,42.0,0
465,92:69:1D:31:68:E9,3820543,484879816,3473,3454968,3817070,481424848,0,3592,928645,3497,907555,95,21090,1792,6,3599,78,0,31,229410.0,137640.0,-50.0,-47.0,-42.0,-48.0,-51.0,-50.0,-45.0,-48.0,-90.0,-93.0,-89.0,-93.0,40.0,46.0,47.0,45.0,0
466,CC:2F:71:3F:1F:24,4398205,1163097822,581133,681672772,3817072,481425050,37,486327,556318615,485767,556251059,560,67556,468661,10,581370,42801,34,431,117000.0,39000.0,-67.0,-65.0,-70.0,-67.0,-67.0,-65.0,-70.0,-67.0,-90.0,-93.0,-89.0,-93.0,23.0,28.0,19.0,26.0,0
467,CC:2F:71:3E:C5:1F,3817747,481507502,675,82452,3817072,481425050,0,2901,242616,2404,183526,497,59090,716,8,1006,18,0,32,144444.0,43333.0,-71.0,-71.0,-67.0,-60.0,-70.0,-70.0,-67.0,-60.0,-90.0,-93.0,-89.0,-93.0,19.0,22.0,22.0,33.0,0
468,BA:8C:B9:54:50:24,3818795,482262063,1723,837013,3817072,481425050,0,5520,818327,5500,815205,20,3122,1004,14,2098,29,0,48,229410.0,137640.0,-39.0,-37.0,-45.0,-51.0,-42.0,-35.0,-43.0,-47.0,-90.0,-93.0,-89.0,-93.0,51.0,56.0,44.0,42.0,0
469,92:69:1D:31:68:E9,3820549,484880422,3473,3454968,3817076,481425454,0,3592,928645,3497,907555,95,21090,1792,6,3599,78,0,31,229410.0,137640.0,-50.0,-47.0,-42.0,-48.0,-51.0,-50.0,-45.0,-48.0,-89.0,-92.0,-89.0,-92.0,39.0,45.0,47.0,44.0,0
470,CC:2F:71:3F:1F:24,4398252,1163112728,581176,681687274,3817076,481425454,37,486352,556323419,485792,556255863,560,67556,468686,10,581413,42803,34,431,117000.0,39000.0,-67.0,-65.0,-70.0,-68.0,-67.0,-65.0,-70.0,-67.0,-89.0,-92.0,-89.0,-92.0,22.0,27.0,19.0,24.0,0
471,CC:2F:71:3E:C5:1F,3817751,481507906,675,82452,3817076,481425454,0,2901,242616,2404,183526,497,59090,716,8,1006,18,0,32,144444.0,43333.0,-71.0,-71.0,-67.0,-60.0,-70.0,-70.0,-67.0,-60.0,-89.0,-92.0,-89.0,-92.0,18.0,21.0,22.0,32.0,0
472,BA:8C:B9:54:50:24,3818799,482262467,1723,837013,3817076,481425454,0,5520,818327,5500,815205,20,3122,1004,14,2098,29,0,48,229410.0,137640.0,-39.0,-37.0,-45.0,-51.0,-42.0,-35.0,-43.0,-47.0,-89.0,-92.0,-89.0,-92.0,50.0,55.0,44.0,41.0,0
473,92:69:1D:31:68:E9,3820552,484880684,3473,3454968,3817079,481425716,0,3592,928645,3497,907555,95,21090,1792,6,3599,78,0,31,229410.0,137640.0,-50.0,-47.0,-42.0,-48.0,-51.0,-50.0,-45.0,-48.0,-89.0,-92.0,-89.0,-92.0,39.0,45.0,47.0,44.0,0
474,CC:2F:71:3F:1F:24,4398299,1163127508,581218,681701590,3817081,481425918,37,486378,556328399,485818,556260843,560,67556,468712,10,581455,42815,34,431,117000.0,39000.0,-67.0,-65.0,-71.0,-68.0,-67.0,-65.0,-70.0,-67.0,-89.0,-92.0,-89.0,-92.0,22.0,27.0,18.0,24.0,0
475,CC:2F:71:3E:C5:1F,3817756,481508370,675,82452,3817081,481425918,0,2901,242616,2404,183526,497,59090,716,8,1006,18,0,32,144444.0,43333.0,-71.0,-71.0,-67.0,-60.0,-70.0,-70.0,-67.0,-60.0,-89.0,-92.0,-89.0,-92.0,18.0,21.0,22.0,32.0,0
476,BA:8C:B9:54:50:24,3818804,482262931,1723,837013,3817081,481425918,0,5520,818327,5500,815205,20,3122,1004,14,2098,29,0,48,229410.0,137640.0,-39.0,-37.0,-45.0,-51.0,-42.0,-35.0,-43.0,-47.0,-89.0,-92.0,-89.0,-92.0,50.0,55.0,44.0,41.0,0
477,92:69:1D:31:68:E9,3820558,484881290,3473,3454968,3817085,481426322,0,3592,928645,3497,907555,95,21090,1792,6,3599,78,0,31,229410.0,137640.0,-50.0,-47.0,-42.0,-48.0,-51.0,-50.0,-45.0,-48.0,-89.0,-92.0,-89.0,-92.0,39.0,45.0,47.0,44.0,0
478,CC:2F:71:3F:1F:24,4398345,1163142340,581260,681716018,3817085,481426322,37,486405,556333495,485845,556265939,560,67556,468739,10,581497,42821,34,431,130000.0,39000.0,-67.0,-65.0,-70.0,-67.0,-67.0,-65.0,-70.0,-67.0,-89.0,-92.0,-89.0,-92.0,22.0,27.0,19.0,25.0,0
479,CC:2F:71:3E:C5:1F,3817760,481508774,675,82452,3817085,481426322,0,2901,242616,2404,183526,497,59090,716,8,1006,18,0,32,144444.0,43333.0,-71.0,-71.0,-67.0,-60.0,-70.0,-70.0,-67.0,-60.0,-89.0,-92.0,-89.0,-92.0,18.0,21.0,22.0,32.0,0
480,BA:8C:B9:54:50:24,3818808,482263335,1723,837013,3817085,481426322,0,5520,818327,5500,815205,20,3122,1004,14,2098,29,0,48,229410.0,137640.0,-39.0,-37.0,-45.0,-51.0,-42.0,-35.0,-43.0,-47.0,-89.0,-92.0,-89.0,-92.0,50.0,55.0,44.0,41.0,0
481,92:69:1D:31:68:E9,3820560,484881492,3473,3454968,3817087,481426524,0,3592,928645,3497,907555,95,21090,1792,6,3599,78,0,31,229410.0,137640.0,-50.0,-47.0,-42.0,-48.0,-51.0,-50.0,-45.0,-48.0,-89.0,-92.0,-89.0,-92.0,39.0,45.0,47.0,44.0,0
482,CC:2F:71:3F:1F:24,4398390,1163157038,581303,681730514,3817087,481426524,37,486431,556338475,485871,556270919,560,67556,468765,10,581540,42828,34,431,130000.0,43333.0,-67.0,-65.0,-70.0,-68.0,-67.0,-65.0,-70.0,-67.0,-89.0,-92.0,-89.0,-92.0,22.0,27.0,19.0,24.0,0
483,CC:2F:71:3E:C5:1F,3817762,481508976,675,82452,3817087,481426524,0,2901,242616,2404,183526,497,59090,716,8,1006,18,0,32,144444.0,43333.0,-71.0,-71.0,-67.0,-60.0,-70.0,-70.0,-67.0,-60.0,-89.0,-92.0,-89.0,-92.0,18.0,21.0,22.0,32.0,0
484,BA:8C:B9:54:50:24,3818810,482263537,1723,837013,3817087,481426524,0,5520,818327,5500,815205,20,3122,1004,14,2098,29,0,48,229410.0,137640.0,-39.0,-37.0,-45.0,-51.0,-42.0,-35.0,-43.0,-47.0,-89.0,-92.0,-89.0,-92.0,50.0,55.0,44.0,41.0,0
485,92:69:1D:31:68:E9,3820567,484882158,3473,3454968,3817094,481427190,0,3592,928645,3497,907555,95,21090,1792,6,3599,78,0,31,229410.0,137640.0,-50.0,-47.0,-42.0,-48.0,-51.0,-50.0,-45.0,-48.0,-89.0,-92.0,-89.0,-92.0,39.0,45.0,47.0,44.0,0
486,CC:2F:71:3F:1F:24,4398440,1163172200,581346,681745010,3817094,481427190,37,486457,556343419,485897,556275863,560,67556,468791,10,581583,42850,34,431,117000.0,39000.0,-67.0,-65.0,-70.0,-68.0,-67.0,-65.0,-70.0,-67.0,-89.0,-92.0,-89.0,-92.0,22.0,27.0,19.0,24.0,0
487,CC:2F:71:3E:C5:1F,3817769,481509642,675,82452,3817094,481427190,0,2901,242616,2404,183526,497,59090,716,8,1006,18,0,32,144444.0,43333.0,-71.0,-71.0,-67.0,-60.0,-70.0,-70.0,-67.0,-60.0,-89.0,-92.0,-89.0,-92.0,18.0,21.0,22.0,32.0,0
488,BA:8C:B9:54:50:24,3818817,482264203,1723,837013,3817094,481427190,0,5520,818327,5500,815205,20,3122,1004,14,2098,29,0,48,229410.0,137640.0,-39.0,-37.0,-45.0,-51.0,-42.0,-35.0,-43.0,-47.0,-89.0,-92.0,-89.0,-92.0,50.0,55.0,44.0,41.0,0
489,92:69:1D:31:68:E9,3820569,484882360,3473,3454968,3817096,481427392,0,3592,928645,3497,907555,95,21090,1792,6,3599,78,0,31,229410.0,137640.0,-50.0,-47.0,-42.0,-48.0,-51.0,-50.0,-45.0,-48.0,-89.0,-92.0,-89.0,-92.0,39.0,45.0,47.0,44.0,0
490,CC:2F:71:3F:1F:24,4398484,1163186830,581388,681759438,3817096,481427392,37,486485,556348595,485925,556281039,560,67556,468819,10,581625,42854,34,431,130000.0,43333.0,-67.0,-65.0,-70.0,-67.0,-67.0,-65.0,-70.0,-67.0,-89.0,-92.0,-89.0,-92.0,22.0,27.0,19.0,25.0,0
491,CC:2F:71:3E:C5:1F,3817771,481509844,675,82452,3817096,481427392,0,2901,242616,2404,183526,497,59090,716,8,1006,18,0,32,144444.0,43333.0,-71.0,-71.0,-67.0,-60.0,-70.0,-70.0,-67.0,-60.0,-89.0,-92.0,-89.0,-92.0,18.0,21.0,22.0,32.0,0
492,BA:8C:B9:54:50:24,3818819,482264405,1723,837013,3817096,481427392,0,5520,818327,5500,815205,20,3122,1004,14,2098,29,0,48,229410.0,137640.0,-39.0,-37.0,-45.0,-51.0,-42.0,-35.0,-43.0,-47.0,-89.0,-92.0,-89.0,-92.0,50.0,55.0,44.0,41.0,0
493,92:69:1D:31:68:E9,3820575,484882966,3473,3454968,3817102,481427998,0,3592,928645,3497,907555,95,21090,1792,6,3599,78,0,31,229410.0,137640.0,-50.0,-47.0,-42.0,-48.0,-51.0,-50.0,-45.0,-48.0,-89.0,-92.0,-89.0,-92.0,39.0,45.0,47.0,44.0,0
494,CC:2F:71:3F:1F:24,4398531,1163201846,581429,681773848,3817102,481427998,37,486510,556353399,485950,556285843,560,67556,468844,10,581666,42858,34,431,130000.0,43333.0,-67.0,-65.0,-70.0,-67.0,-67.0,-65.0,-70.0,-67.0,-89.0,-92.0,-89.0,-92.0,22.0,27.0,19.0,25.0,0
495,CC:2F:71:3E:C5:1F,3817778,481510510,675,82452,3817103,481428058,0,2901,242616,2404,183526,497,59090,716,8,1006,18,0,32,144444.0,43333.0,-71.0,-71.0,-67.0,-60.0,-70.0,-70.0,-67.0,-60.0,-89.0,-92.0,-89.0,-92.0,18.0,21.0,22.0,32.0,0
496,BA:8C:B9:54:50:24,3818826,482265071,1723,837013,3817103,481428058,0,5520,818327,5500,815205,20,3122,1004,14,2098,29,0,48,229410.0,137640.0,-39.0,-37.0,-45.0,-51.0,-42.0,-35.0,-43.0,-47.0,-89.0,-92.0,-89.0,-92.0,50.0,55.0,44.0,41.0,0
497,92:69:1D:31:68:E9,3820578,484883228,3473,3454968,3817105,481428260,0,3592,928645,3497,907555,95,21090,1792,6,3599,78,0,31,229410.0,137640.0,-50.0,-47.0,-42.0,-48.0,-51.0,-50.0,-45.0,-48.0,-89.0,-92.0,-89.0,-92.0,39.0,45.0,47.0,44.0,0
498,CC:2F:71:3F:1F:24,4398579,1163216906,581474,681788646,3817105,481428260,37,486538,556358551,485978,556290995,560,67556,468872,10,581711,42878,34,431,117000.0,39000.0,-67.0,-65.0,-70.0,-67.0,-67.0,-65.0,-70.0,-67.0,-89.0,-92.0,-89.0,-92.0,22.0,27.0,19.0,25.0,0
499,CC:2F:71:3E:C5:1F,3817782,481511045,676,82512,3817106,481428533,0,2903,242756,2406,183666,497,59090,716,8,1007,18,0,32,130000.0,39000.0,-70.0,-71.0,-68.0,-60.0,-70.0,-70.0,-67.0,-60.0,-89.0,-92.0,-89.0,-92.0,19.0,21.0,21.0,32.0,0
500,BA:8C:B9:54:50:24,3818830,482265606,1724,837073,3817106,481428533,0,5522,818463,5502,815341,20,3122,1004,14,2099,29,0,48,216660.0,130000.0,-40.0,-37.0,-44.0,-51.0,-42.0,-36.0,-43.0,-48.0,-89.0,-92.0,-89.0,-92.0,49.0,55.0,45.0,41.0,0
501,92:69:1D:31:68:E9,3820586,484884167,3474,3455028,3817112,481429139,0,3594,928781,3499,907691,95,21090,1792,6,3600,78,0,31,216660.0,130000.0,-51.0,-53.0,-47.0,-48.0,-50.0,-50.0,-45.0,-48.0,-89.0,-92.0,-89.0,-92.0,38.0,39.0,42.0,44.0,0
502,CC:2F:71:3F:1F:24,4398628,1163232163,581516,681803024,3817112,481429139,37,486566,556363703,486006,556296147,560,67556,468900,10,581753,42886,34,431,130000.0,39000.0,-67.0,-65.0,-70.0,-67.0,-67.0,-65.0,-70.0,-67.0,-89.0,-92.0,-89.0,-92.0,22.0,27.0,19.0,25.0,0
503,CC:2F:71:3E:C5:1F,3817788,481511651,676,82512,3817112,481429139,0,2903,242756,2406,183666,497,59090,716,8,1007,18,0,32,130000.0,39000.0,-70.0,-71.0,-68.0,-60.0,-70.0,-70.0,-67.0,-60.0,-89.0,-92.0,-89.0,-92.0,19.0,21.0,21.0,32.0,0
504,BA:8C:B9:54:50:24,3818836,482266212,1724,837073,3817112,481429139,0,5522,818463,5502,815341,20,3122,1004,14,2099,29,0,48,216660.0,130000.0,-40.0,-37.0,-44.0,-51.0,-42.0,-36.0,-43.0,-48.0,-89.0,-92.0,-89.0,-92.0,49.0,55.0,45.0,41.0,0
505,92:69:1D:31:68:E9,3820589,484884429,3474,3455028,3817115,481429401,0,3594,928781,3499,907691,95,21090,1792,6,3600,78,0,31,216660.0,130000.0,-51.0,-53.0,-47.0,-48.0,-50.0,-50.0,-45.0,-48.0,-89.0,-92.0,-89.0,-92.0,38.0,39.0,42.0,44.0,0
506,CC:2F:71:3F:1F:24,4398678,1163247926,581563,681818525,3817115,481429401,37,486599,556369612,486039,556302056,560,67556,468933,10,581800,42904,34,431,130000.0,39000.0,-67.0,-65.0,-70.0,-68.0,-67.0,-65.0,-70.0,-67.0,-89.0,-92.0,-89.0,-92.0,22.0,27.0,19.0,24.0,0
507,CC:2F:71:3E:C5:1F,3817791,481511913,676,82512,3817115,481429401,0,2903,242756,2406,183666,497,59090,716,8,1007,18,0,32,130000.0,39000.0,-70.0,-71.0,-68.0,-60.0,-70.0,-70.0,-67.0,-60.0,-89.0,-92.0,-89.0,-92.0,19.0,21.0,21.0,32.0,0
508,BA:8C:B9:54:50:24,3818839,482266474,1724,837073,3817115,481429401,0,5522,818463,5502,815341,20,3122,1004,14,2099,29,0,48,216660.0,130000.0,-40.0,-37.0,-44.0,-51.0,-42.0,-36.0,-43.0,-48.0,-89.0,-92.0,-89.0,-92.0,49.0,55.0,45.0,41.0,0
509,92:69:1D:31:68:E9,3820595,484885035,3474,3455028,3817121,481430007,0,3594,928781,3499,907691,95,21090,1792,6,3600,78,0,31,216660.0,130000.0,-51.0,-53.0,-47.0,-48.0,-50.0,-50.0,-45.0,-48.0,-89.0,-92.0,-89.0,-92.0,38.0,39.0,42.0,44.0,0
510,CC:2F:71:3F:1F:24,4398726,1163262904,581605,681832897,3817121,481430007,37,486626,556374696,486066,556307140,560,67556,468960,10,581842,42916,34,431,117000.0,39000.0,-67.0,-65.0,-70.0,-68.0,-67.0,-65.0,-70.0,-67.0,-89.0,-92.0,-89.0,-92.0,22.0,27.0,19.0,24.0,0
511,CC:2F:71:3E:C5:1F,3817797,481512519,676,82512,3817121,481430007,0,2903,242756,2406,183666,497,59090,716,8,1007,18,0,32,130000.0,39000.0,-70.0,-71.0,-68.0,-60.0,-70.0,-70.0,-67.0,-60.0,-89.0,-92.0,-89.0,-92.0,19.0,21.0,21.0,32.0,0
512,BA:8C:B9:54:50:24,3818845,482267080,1724,837073,3817121,481430007,0,5522,818463,5502,815341,20,3122,1004,14,2099,29,0,48,216660.0,130000.0,-40.0,-37.0,-44.0,-51.0,-42.0,-36.0,-43.0,-48.0,-89.0,-92.0,-89.0,-92.0,49.0,55.0,45.0,41.0,0
513,92:69:1D:31:68:E9,3820597,484885237,3474,3455028,3817123,481430209,0,3594,928781,3499,907691,95,21090,1792,6,3600,78,0,31,216660.0,130000.0,-51.0,-53.0,-47.0,-48.0,-50.0,-50.0,-45.0,-48.0,-89.0,-92.0,-89.0,-92.0,38.0,39.0,42.0,44.0,0
514,CC:2F:71:3F:1F:24,4398771,1163277596,581647,681847325,3817124,481430271,37,486651,556379500,486091,556311944,560,67556,468985,10,581884,42921,34,431,130000.0,43333.0,-67.0,-65.0,-70.0,-68.0,-67.0,-65.0,-70.0,-67.0,-89.0,-92.0,-89.0,-92.0,22.0,27.0,19.0,24.0,0
515,CC:2F:71:3E:C5:1F,3817800,481512783,676,82512,3817124,481430271,0,2905,242944,2407,183736,498,59208,717,8,1007,18,0,32,130000.0,39000.0,-70.0,-71.0,-67.0,-60.0,-70.0,-70.0,-67.0,-60.0,-89.0,-92.0,-89.0,-92.0,19.0,21.0,22.0,32.0,0
516,BA:8C:B9:54:50:24,3818848,482267344,1724,837073,3817124,481430271,0,5522,818463,5502,815341,20,3122,1004,14,2099,29,0,48,216660.0,130000.0,-40.0,-37.0,-44.0,-51.0,-42.0,-36.0,-43.0,-48.0,-89.0,-92.0,-89.0,-92.0,49.0,55.0,45.0,41.0,0
517,92:69:1D:31:68:E9,3820605,484885965,3474,3455028,3817131,481430937,0,3594,928781,3499,907691,95,21090,1792,6,3600,78,0,31,216660.0,130000.0,-51.0,-53.0,-47.0,-48.0,-50.0,-50.0,-45.0,-48.0,-89.0,-91.0,-89.0,-92.0,38.0,38.0,42.0,44.0,0
518,CC:2F:71:3F:1F:24,4398820,1163292746,581689,681861809,3817131,481430937,37,486677,556384444,486117,556316888,560,67556,469011,10,581926,42935,34,431,130000.0,39000.0,-67.0,-65.0,-71.0,-68.0,-67.0,-65.0,-70.0,-67.0,-89.0,-91.0,-89.0,-92.0,22.0,26.0,18.0,24.0,0
519,CC:2F:71:3E:C5:1F,3817807,481513449,676,82512,3817131,481430937,0,2905,242944,2407,183736,498,59208,717,8,1007,18,0,32,130000.0,39000.0,-70.0,-71.0,-67.0,-60.0,-70.0,-70.0,-67.0,-60.0,-89.0,-91.0,-89.0,-92.0,19.0,20.0,22.0,32.0,0
520,BA:8C:B9:54:50:24,3818855,482268010,1724,837073,3817131,481430937,0,5522,818463,5502,815341,20,3122,1004,14,2099,29,0,48,216660.0,130000.0,-40.0,-37.0,-44.0,-51.0,-42.0,-36.0,-43.0,-48.0,-89.0,-91.0,-89.0,-92.0,49.0,54.0,45.0,41.0,0
521,92:69:1D:31:68:E9,3820608,484886320,3475,3455181,3817133,481431139,0,3599,929230,3504,908140,95,21090,1792,6,3601,78,0,31,1000.0,130000.0,-52.0,-52.0,-45.0,-48.0,-51.0,-50.0,-44.0,-47.0,-89.0,-91.0,-89.0,-92.0,37.0,39.0,44.0,44.0,0
522,CC:2F:71:3F:1F:24,4398865,1163307441,581732,681876302,3817133,481431139,37,486708,556390053,486148,556322497,560,67556,469041,10,581969,42960,34,431,130000.0,43333.0,-67.0,-65.0,-70.0,-67.0,-67.0,-65.0,-70.0,-67.0,-89.0,-91.0,-89.0,-92.0,22.0,26.0,19.0,25.0,0
523,CC:2F:71:3E:C5:1F,3817810,481513804,677,82665,3817133,481431139,0,2908,243261,2410,184053,498,59208,717,8,1008,18,0,32,1000.0,39000.0,-70.0,-71.0,-67.0,-60.0,-70.0,-71.0,-67.0,-60.0,-89.0,-91.0,-89.0,-92.0,19.0,20.0,22.0,32.0,0
524,BA:8C:B9:54:50:24,3818858,482268365,1725,837226,3817133,481431139,0,5528,818980,5508,815858,20,3122,1004,14,2100,29,0,48,1000.0,130000.0,-40.0,-37.0,-44.0,-51.0,-42.0,-36.0,-44.0,-49.0,-89.0,-91.0,-89.0,-92.0,49.0,54.0,45.0,41.0,0
525,92:69:1D:31:68:E9,3820614,484886926,3475,3455181,3817139,481431745,0,3600,929298,3505,908208,95,21090,1792,6,3601,78,0,31,1000.0,130000.0,-52.0,-51.0,-45.0,-47.0,-51.0,-51.0,-45.0,-47.0,-89.0,-91.0,-89.0,-92.0,37.0,40.0,44.0,45.0,0
526,CC:2F:71:3F:1F:24,4398914,1163322647,581775,681890902,3817139,481431745,37,486734,556394997,486174,556327441,560,67556,469067,10,582012,42966,34,431,130000.0,43333.0,-67.0,-65.0,-70.0,-67.0,-67.0,-65.0,-70.0,-67.0,-89.0,-91.0,-89.0,-92.0,22.0,26.0,19.0,25.0,0
527,CC:2F:71:3E:C5:1F,3817817,481514470,677,82665,3817140,481431805,0,2908,243261,2410,184053,498,59208,717,8,1008,18,0,32,1000.0,39000.0,-70.0,-71.0,-67.0,-60.0,-70.0,-71.0,-67.0,-60.0,-89.0,-91.0,-89.0,-92.0,19.0,20.0,22.0,32.0,0
528,BA:8C:B9:54:50:24,3818865,482269031,1725,837226,3817140,481431805,0,5528,818980,5508,815858,20,3122,1004,14,2100,29,0,48,1000.0,130000.0,-40.0,-37.0,-44.0,-51.0,-42.0,-36.0,-44.0,-49.0,-89.0,-91.0,-89.0,-92.0,49.0,54.0,45.0,41.0,0
529,92:69:1D:31:68:E9,3820618,484887250,3475,3455181,3817143,481432069,0,3600,929298,3505,908208,95,21090,1792,6,3601,78,0,31,1000.0,130000.0,-52.0,-51.0,-45.0,-47.0,-51.0,-51.0,-45.0,-47.0,-89.0,-92.0,-89.0,-92.0,37.0,41.0,44.0,45.0,0
530,CC:2F:71:3F:1F:24,4398961,1163337521,581818,681905452,3817143,481432069,37,486761,556400059,486200,556332385,561,67674,469094,10,582055,42972,34,431,130000.0,39000.0,-67.0,-65.0,-70.0,-68.0,-67.0,-65.0,-70.0,-67.0,-89.0,-92.0,-89.0,-92.0,22.0,27.0,19.0,24.0,0
531,CC:2F:71:3E:C5:1F,3817820,481514734,677,82665,3817143,481432069,0,2908,243261,2410,184053,498,59208,717,8,1008,18,0,32,1000.0,39000.0,-70.0,-71.0,-67.0,-60.0,-70.0,-71.0,-67.0,-60.0,-89.0,-92.0,-89.0,-92.0,19.0,21.0,22.0,32.0,0
532,BA:8C:B9:54:50:24,3818868,482269295,1725,837226,3817143,481432069,0,5528,818980,5508,815858,20,3122,1004,14,2100,29,0,48,1000.0,130000.0,-40.0,-37.0,-44.0,-51.0,-42.0,-36.0,-44.0,-49.0,-89.0,-92.0,-89.0,-92.0,49.0,55.0,45.0,41.0,0
533,92:69:1D:31:68:E9,3820624,484887856,3475,3455181,3817149,481432675,0,3600,929298,3505,908208,95,21090,1792,6,3601,78,0,31,1000.0,130000.0,-52.0,-51.0,-45.0,-47.0,-51.0,-51.0,-45.0,-47.0,-89.0,-92.0,-89.0,-92.0,37.0,41.0,44.0,45.0,0
534,CC:2F:71:3F:1F:24,4399011,1163352689,581862,681920014,3817149,481432675,37,486786,556404863,486225,556337189,561,67674,469119,10,582099,43002,34,431,130000.0,43333.0,-67.0,-65.0,-70.0,-68.0,-67.0,-65.0,-70.0,-67.0,-89.0,-92.0,-89.0,-92.0,22.0,27.0,19.0,24.0,0
535,CC:2F:71:3E:C5:1F,3817826,481515340,677,82665,3817149,481432675,0,2908,243261,2410,184053,498,59208,717,8,1008,18,0,32,1000.0,39000.0,-70.0,-71.0,-67.0,-60.0,-70.0,-71.0,-67.0,-60.0,-89.0,-92.0,-89.0,-92.0,19.0,21.0,22.0,32.0,0
536,BA:8C:B9:54:50:24,3818874,482269901,1725,837226,3817149,481432675,0,5528,818980,5508,815858,20,3122,1004,14,2100,29,0,48,1000.0,130000.0,-40.0,-37.0,-44.0,-51.0,-42.0,-36.0,-44.0,-49.0,-89.0,-92.0,-89.0,-92.0,49.0,55.0,45.0,41.0,0
537,92:69:1D:31:68:E9,3820627,484888118,3475,3455181,3817152,481432937,0,3601,929366,3506,908276,95,21090,1792,6,3601,78,0,31,1000.0,130000.0,-50.0,-47.0,-42.0,-49.0,-51.0,-50.0,-44.0,-47.0,-90.0,-92.0,-89.0,-92.0,40.0,45.0,47.0,43.0,0
538,CC:2F:71:3F:1F:24,4399056,1163367427,581904,681934490,3817152,481432937,37,486812,556409783,486251,556342109,561,67674,469145,10,582141,43009,34,431,130000.0,43333.0,-67.0,-65.0,-70.0,-68.0,-67.0,-65.0,-70.0,-67.0,-90.0,-92.0,-89.0,-92.0,23.0,27.0,19.0,24.0,0
539,CC:2F:71:3E:C5:1F,3817829,481515602,677,82665,3817152,481432937,0,2908,243261,2410,184053,498,59208,717,8,1008,18,0,32,1000.0,39000.0,-70.0,-71.0,-67.0,-60.0,-70.0,-71.0,-67.0,-60.0,-90.0,-92.0,-89.0,-92.0,20.0,21.0,22.0,32.0,0
540,BA:8C:B9:54:50:24,3818877,482270163,1725,837226,3817152,481432937,0,5528,818980,5508,815858,20,3122,1004,14,2100,29,0,48,1000.0,130000.0,-40.0,-37.0,-44.0,-51.0,-42.0,-36.0,-44.0,-49.0,-90.0,-92.0,-89.0,-92.0,50.0,55.0,45.0,41.0,0
541,92:69:1D:31:68:E9,3820631,484888522,3475,3455181,3817156,481433341,0,3601,929366,3506,908276,95,21090,1792,6,3601,78,0,31,1000.0,130000.0,-50.0,-47.0,-42.0,-49.0,-51.0,-50.0,-44.0,-47.0,-90.0,-92.0,-89.0,-92.0,40.0,45.0,47.0,43.0,0
542,CC:2F:71:3F:1F:24,4399105,1163382577,581947,681949034,3817158,481433543,37,486839,556414867,486278,556347193,561,67674,469172,10,582184,43028,34,431,130000.0,39000.0,-67.0,-65.0,-70.0,-67.0,-67.0,-65.0,-70.0,-67.0,-90.0,-92.0,-89.0,-92.0,23.0,27.0,19.0,25.0,0
543,CC:2F:71:3E:C5:1F,3817835,481516208,677,82665,3817158,481433543,0,2908,243261,2410,184053,498,59208,717,8,1008,18,0,32,1000.0,39000.0,-70.0,-71.0,-67.0,-60.0,-70.0,-71.0,-67.0,-60.0,-90.0,-92.0,-89.0,-92.0,20.0,21.0,22.0,32.0,0
544,BA:8C:B9:54:50:24,3818883,482270769,1725,837226,3817158,481433543,0,5532,819252,5512,816130,20,3122,1004,14,2100,29,0,48,1000.0,130000.0,-40.0,-37.0,-45.0,-52.0,-40.0,-36.0,-44.0,-50.0,-90.0,-92.0,-89.0,-92.0,50.0,55.0,44.0,40.0,0
545,92:69:1D:31:68:E9,3820635,484888926,3475,3455181,3817160,481433745,0,3601,929366,3506,908276,95,21090,1792,6,3601,78,0,31,1000.0,130000.0,-50.0,-47.0,-42.0,-49.0,-51.0,-50.0,-44.0,-47.0,-90.0,-92.0,-89.0,-92.0,40.0,45.0,47.0,43.0,0
546,CC:2F:71:3F:1F:24,4399148,1163396957,581988,681963212,3817160,481433745,37,486865,556419811,486304,556352137,561,67674,469198,10,582225,43056,34,431,130000.0,43333.0,-67.0,-65.0,-70.0,-68.0,-67.0,-65.0,-70.0,-67.0,-90.0,-92.0,-89.0,-92.0,23.0,27.0,19.0,24.0,0
547,CC:2F:71:3E:C5:1F,3817837,481516410,677,82665,3817160,481433745,0,2908,243261,2410,184053,498,59208,717,8,1008,18,0,32,1000.0,39000.0,-70.0,-71.0,-67.0,-60.0,-70.0,-71.0,-67.0,-60.0,-90.0,-92.0,-89.0,-92.0,20.0,21.0,22.0,32.0,0
548,BA:8C:B9:54:50:24,3818885,482270971,1725,837226,3817160,481433745,0,5532,819252,5512,816130,20,3122,1004,14,2100,29,0,48,1000.0,130000.0,-40.0,-37.0,-45.0,-52.0,-40.0,-36.0,-44.0,-50.0,-90.0,-92.0,-89.0,-92.0,50.0,55.0,44.0,40.0,0
549,92:69:1D:31:68:E9,3820665,484900615,3475,3455181,3817190,481445434,0,3604,929737,3508,908412,96,21325,1793,6,3601,78,0,31,1000.0,130000.0,-52.0,-50.0,-45.0,-46.0,-51.0,-50.0,-44.0,-48.0,-90.0,-92.0,-89.0,-92.0,38.0,42.0,44.0,46.0,0
550,CC:2F:71:3F:1F:24,4399221,1163423246,582031,681977812,3817190,481445434,37,486892,556424895,486331,556357221,561,67674,469225,10,582268,43065,34,431,130000.0,43333.0,-67.0,-65.0,-70.0,-67.0,-67.0,-65.0,-70.0,-67.0,-90.0,-92.0,-89.0,-92.0,23.0,27.0,19.0,25.0,0
551,CC:2F:71:3E:C5:1F,3817867,481528099,677,82665,3817190,481445434,0,2908,243261,2410,184053,498,59208,717,8,1008,18,0,32,1000.0,39000.0,-70.0,-71.0,-67.0,-60.0,-70.0,-71.0,-67.0,-60.0,-90.0,-92.0,-89.0,-92.0,20.0,21.0,22.0,32.0,0
552,BA:8C:B9:54:50:24,3818916,482282933,1725,837226,3817191,481445707,0,5532,819252,5512,816130,20,3122,1004,14,2100,29,0,48,1000.0,130000.0,-40.0,-37.0,-45.0,-52.0,-40.0,-36.0,-44.0,-50.0,-90.0,-92.0,-89.0,-92.0,50.0,55.0,44.0,40.0,0
553,92:69:1D:31:68:E9,3820668,484901090,3475,3455181,3817193,481445909,0,3604,929737,3508,908412,96,21325,1793,6,3601,78,0,31,1000.0,130000.0,-52.0,-50.0,-45.0,-46.0,-51.0,-50.0,-44.0,-48.0,-90.0,-92.0,-89.0,-92.0,38.0,42.0,44.0,46.0,0
554,CC:2F:71:3F:1F:24,4399266,1163438147,582073,681992238,3817193,481445909,37,486917,556429699,486356,556362025,561,67674,469250,10,582310,43085,34,431,130000.0,39000.0,-67.0,-65.0,-71.0,-67.0,-67.0,-65.0,-70.0,-67.0,-90.0,-92.0,-89.0,-92.0,23.0,27.0,18.0,25.0,0
555,CC:2F:71:3E:C5:1F,3817870,481528574,677,82665,3817193,481445909,0,2908,243261,2410,184053,498,59208,717,8,1008,18,0,32,1000.0,39000.0,-70.0,-71.0,-67.0,-60.0,-70.0,-71.0,-67.0,-60.0,-90.0,-92.0,-89.0,-92.0,20.0,21.0,22.0,32.0,0
556,BA:8C:B9:54:50:24,3818918,482283135,1725,837226,3817193,481445909,0,5536,819524,5516,816402,20,3122,1004,14,2100,29,0,48,1000.0,130000.0,-49.0,-35.0,-42.0,-44.0,-43.0,-36.0,-43.0,-48.0,-90.0,-92.0,-89.0,-92.0,41.0,57.0,47.0,48.0,0
557,92:69:1D:31:68:E9,3820675,484901756,3475,3455181,3817200,481446575,0,3604,929737,3508,908412,96,21325,1793,6,3601,78,0,31,1000.0,130000.0,-52.0,-50.0,-45.0,-46.0,-51.0,-50.0,-44.0,-48.0,-90.0,-92.0,-89.0,-92.0,38.0,42.0,44.0,46.0,0
558,CC:2F:71:3F:1F:24,4399314,1163452997,582114,682006422,3817200,481446575,37,486944,556434759,486383,556367085,561,67674,469277,10,582351,43101,34,431,130000.0,43333.0,-67.0,-65.0,-71.0,-67.0,-67.0,-65.0,-70.0,-67.0,-90.0,-92.0,-89.0,-92.0,23.0,27.0,18.0,25.0,0
559,CC:2F:71:3E:C5:1F,3817877,481529240,677,82665,3817200,481446575,0,2908,243261,2410,184053,498,59208,717,8,1008,18,0,32,1000.0,39000.0,-70.0,-71.0,-67.0,-60.0,-70.0,-71.0,-67.0,-60.0,-90.0,-92.0,-89.0,-92.0,20.0,21.0,22.0,32.0,0
560,BA:8C:B9:54:50:24,3818925,482283801,1725,837226,3817200,481446575,0,5536,819524,5516,816402,20,3122,1004,14,2100,29,0,48,1000.0,130000.0,-49.0,-35.0,-42.0,-44.0,-43.0,-36.0,-43.0,-48.0,-90.0,-92.0,-89.0,-92.0,41.0,57.0,47.0,48.0,0
561,92:69:1D:31:68:E9,3820677,484901958,3475,3455181,3817202,481446777,0,3604,929737,3508,908412,96,21325,1793,6,3601,78,0,31,1000.0,130000.0,-52.0,-50.0,-45.0,-46.0,-51.0,-50.0,-44.0,-48.0,-90.0,-92.0,-89.0,-92.0,38.0,42.0,44.0,46.0,0
562,CC:2F:71:3F:1F:24,4399357,1163467439,582155,682020662,3817202,481446777,37,486969,556439563,486408,556371889,561,67674,469302,10,582392,43125,34,431,117000.0,39000.0,-67.0,-65.0,-70.0,-67.0,-67.0,-65.0,-70.0,-67.0,-90.0,-92.0,-89.0,-92.0,23.0,27.0,19.0,25.0,0
563,CC:2F:71:3E:C5:1F,3817879,481529442,677,82665,3817202,481446777,0,2908,243261,2410,184053,498,59208,717,8,1008,18,0,32,1000.0,39000.0,-70.0,-71.0,-67.0,-60.0,-70.0,-71.0,-67.0,-60.0,-90.0,-92.0,-89.0,-92.0,20.0,21.0,22.0,32.0,0
564,BA:8C:B9:54:50:24,3818927,482284003,1725,837226,3817202,481446777,0,5536,819524,5516,816402,20,3122,1004,14,2100,29,0,48,1000.0,130000.0,-49.0,-35.0,-42.0,-44.0,-43.0,-36.0,-43.0,-48.0,-90.0,-92.0,-89.0,-92.0,41.0,57.0,47.0,48.0,0
565,92:69:1D:31:68:E9,3820685,484902932,3475,3455181,3817210,481447751,0,3604,929737,3508,908412,96,21325,1793,6,3601,78,0,31,1000.0,130000.0,-52.0,-50.0,-45.0,-46.0,-51.0,-50.0,-44.0,-48.0,-90.0,-92.0,-89.0,-92.0,38.0,42.0,44.0,46.0,0
566,CC:2F:71:3F:1F:24,4399408,1163482907,582198,682035156,3817210,481447751,37,486994,556444367,486433,556376693,561,67674,469327,10,582435,43137,34,431,130000.0,43333.0,-67.0,-65.0,-70.0,-68.0,-67.0,-65.0,-70.0,-67.0,-90.0,-92.0,-89.0,-92.0,23.0,27.0,19.0,24.0,0
567,CC:2F:71:3E:C5:1F,3817887,481530416,677,82665,3817210,481447751,0,2908,243261,2410,184053,498,59208,717,8,1008,18,0,32,1000.0,39000.0,-70.0,-71.0,-67.0,-60.0,-70.0,-71.0,-67.0,-60.0,-90.0,-92.0,-89.0,-92.0,20.0,21.0,22.0,32.0,0
568,BA:8C:B9:54:50:24,3818935,482284977,1725,837226,3817210,481447751,0,5536,819524,5516,816402,20,3122,1004,14,2100,29,0,48,1000.0,130000.0,-49.0,-35.0,-42.0,-44.0,-43.0,-36.0,-43.0,-48.0,-90.0,-92.0,-89.0,-92.0,41.0,57.0,47.0,48.0,0
569,92:69:1D:31:68:E9,3820688,484903194,3475,3455181,3817213,481448013,0,3604,929737,3508,908412,96,21325,1793,6,3601,78,0,31,1000.0,130000.0,-52.0,-50.0,-45.0,-46.0,-51.0,-50.0,-44.0,-48.0,-90.0,-92.0,-89.0,-92.0,38.0,42.0,44.0,46.0,0
570,CC:2F:71:3F:1F:24,4399453,1163497539,582240,682049526,3817213,481448013,37,487022,556449519,486461,556381845,561,67674,469355,10,582477,43162,34,431,117000.0,39000.0,-67.0,-65.0,-71.0,-67.0,-67.0,-65.0,-70.0,-67.0,-90.0,-92.0,-89.0,-92.0,23.0,27.0,18.0,25.0,0
571,CC:2F:71:3E:C5:1F,3817890,481530678,677,82665,3817213,481448013,0,2908,243261,2410,184053,498,59208,717,8,1008,18,0,32,1000.0,39000.0,-70.0,-71.0,-67.0,-60.0,-70.0,-71.0,-67.0,-60.0,-90.0,-92.0,-89.0,-92.0,20.0,21.0,22.0,32.0,0
572,BA:8C:B9:54:50:24,3818938,482285239,1725,837226,3817213,481448013,0,5536,819524,5516,816402,20,3122,1004,14,2100,29,0,48,1000.0,130000.0,-49.0,-35.0,-42.0,-44.0,-43.0,-36.0,-43.0,-48.0,-90.0,-92.0,-89.0,-92.0,41.0,57.0,47.0,48.0,0
573,92:69:1D:31:68:E9,3820692,484903598,3475,3455181,3817217,481448417,0,3604,929737,3508,908412,96,21325,1793,6,3601,78,0,31,1000.0,130000.0,-52.0,-50.0,-45.0,-46.0,-51.0,-50.0,-44.0,-48.0,-90.0,-93.0,-90.0,-93.0,38.0,43.0,45.0,47.0,0
574,CC:2F:71:3F:1F:24,4399501,1163512515,582282,682063896,3817219,481448619,37,487050,556454671,486489,556386997,561,67674,469383,10,582519,43170,34,431,130000.0,43333.0,-67.0,-65.0,-70.0,-68.0,-67.0,-65.0,-70.0,-67.0,-90.0,-93.0,-90.0,-93.0,23.0,28.0,20.0,25.0,0
575,CC:2F:71:3E:C5:1F,3817896,481531284,677,82665,3817219,481448619,0,2908,243261,2410,184053,498,59208,717,8,1008,18,0,32,1000.0,39000.0,-70.0,-71.0,-67.0,-60.0,-70.0,-71.0,-67.0,-60.0,-90.0,-93.0,-90.0,-93.0,20.0,22.0,23.0,33.0,0
576,BA:8C:B9:54:50:24,3818944,482285845,1725,837226,3817219,481448619,0,5536,819524,5516,816402,20,3122,1004,14,2100,29,0,48,1000.0,130000.0,-49.0,-35.0,-42.0,-44.0,-43.0,-36.0,-43.0,-48.0,-90.0,-93.0,-90.0,-93.0,41.0,58.0,48.0,49.0,0
577,92:69:1D:31:68:E9,3820696,484904002,3475,3455181,3817221,481448821,0,3604,929737,3508,908412,96,21325,1793,6,3601,78,0,31,1000.0,130000.0,-52.0,-50.0,-45.0,-46.0,-51.0,-50.0,-44.0,-48.0,-90.0,-93.0,-90.0,-93.0,38.0,43.0,45.0,47.0,0
578,CC:2F:71:3F:1F:24,4399545,1163527209,582324,682078388,3817221,481448821,37,487078,556459871,486517,556392197,561,67674,469411,10,582561,43179,34,431,130000.0,43333.0,-67.0,-65.0,-70.0,-68.0,-67.0,-65.0,-70.0,-67.0,-90.0,-93.0,-90.0,-93.0,23.0,28.0,20.0,25.0,0
579,CC:2F:71:3E:C5:1F,3817898,481531486,677,82665,3817221,481448821,0,2908,243261,2410,184053,498,59208,717,8,1008,18,0,32,1000.0,39000.0,-70.0,-71.0,-67.0,-60.0,-70.0,-71.0,-67.0,-60.0,-90.0,-93.0,-90.0,-93.0,20.0,22.0,23.0,33.0,0
580,BA:8C:B9:54:50:24,3818947,482286107,1725,837226,3817222,481448881,0,5536,819524,5516,816402,20,3122,1004,14,2100,29,0,48,1000.0,130000.0,-49.0,-35.0,-42.0,-44.0,-43.0,-36.0,-43.0,-48.0,-90.0,-93.0,-90.0,-93.0,41.0,58.0,48.0,49.0,0
581,92:69:1D:31:68:E9,3820701,484904466,3475,3455181,3817226,481449285,0,3604,929737,3508,908412,96,21325,1793,6,3601,78,0,31,1000.0,130000.0,-52.0,-50.0,-45.0,-46.0,-51.0,-50.0,-44.0,-48.0,-90.0,-93.0,-89.0,-93.0,38.0,43.0,44.0,47.0,0
582,CC:2F:71:3F:1F:24,4399592,1163542053,582366,682092768,3817226,481449285,37,487104,556464815,486543,556397141,561,67674,469437,10,582603,43198,34,431,117000.0,39000.0,-67.0,-65.0,-70.0,-67.0,-67.0,-65.0,-70.0,-67.0,-90.0,-93.0,-89.0,-93.0,23.0,28.0,19.0,26.0,0
583,CC:2F:71:3E:C5:1F,3817905,481532152,677,82665,3817228,481449487,0,2908,243261,2410,184053,498,59208,717,8,1008,18,0,32,1000.0,39000.0,-70.0,-71.0,-67.0,-60.0,-70.0,-71.0,-67.0,-60.0,-90.0,-93.0,-89.0,-93.0,20.0,22.0,22.0,33.0,0
584,BA:8C:B9:54:50:24,3818953,482286713,1725,837226,3817228,481449487,0,5536,819524,5516,816402,20,3122,1004,14,2100,29,0,48,1000.0,130000.0,-49.0,-35.0,-42.0,-44.0,-43.0,-36.0,-43.0,-48.0,-90.0,-93.0,-89.0,-93.0,41.0,58.0,47.0,49.0,0
585,92:69:1D:31:68:E9,3820705,484904870,3475,3455181,3817230,481449689,0,3604,929737,3508,908412,96,21325,1793,6,3601,78,0,31,1000.0,130000.0,-52.0,-50.0,-45.0,-46.0,-51.0,-50.0,-44.0,-48.0,-90.0,-93.0,-89.0,-93.0,38.0,43.0,44.0,47.0,0
586,CC:2F:71:3F:1F:24,4399640,1163557091,582410,682107402,3817230,481449689,37,487130,556469759,486569,556402085,561,67674,469463,10,582647,43203,34,431,130000.0,43333.0,-67.0,-65.0,-71.0,-68.0,-67.0,-65.0,-70.0,-67.0,-90.0,-93.0,-89.0,-93.0,23.0,28.0,18.0,25.0,0
587,CC:2F:71:3E:C5:1F,3817907,481532354,677,82665,3817230,481449689,0,2908,243261,2410,184053,498,59208,717,8,1008,18,0,32,1000.0,39000.0,-70.0,-71.0,-67.0,-60.0,-70.0,-71.0,-67.0,-60.0,-90.0,-93.0,-89.0,-93.0,20.0,22.0,22.0,33.0,0
588,BA:8C:B9:54:50:24,3818955,482286915,1725,837226,3817230,481449689,0,5536,819524,5516,816402,20,3122,1004,14,2100,29,0,48,1000.0,130000.0,-49.0,-35.0,-42.0,-44.0,-43.0,-36.0,-43.0,-48.0,-90.0,-93.0,-89.0,-93.0,41.0,58.0,47.0,49.0,0
589,92:69:1D:31:68:E9,3820710,484905334,3475,3455181,3817235,481450153,0,3604,929737,3508,908412,96,21325,1793,6,3601,78,0,31,1000.0,130000.0,-52.0,-50.0,-45.0,-46.0,-51.0,-50.0,-44.0,-48.0,-90.0,-93.0,-89.0,-93.0,38.0,43.0,44.0,47.0,0
590,CC:2F:71:3F:1F:24,4399686,1163571867,582451,682121714,3817235,481450153,37,487158,556474911,486597,556407237,561,67674,469491,10,582688,43223,34,431,130000.0,39000.0,-68.0,-66.0,-71.0,-68.0,-67.0,-65.0,-70.0,-68.0,-90.0,-93.0,-89.0,-93.0,22.0,27.0,18.0,25.0,0
591,CC:2F:71:3E:C5:1F,3817914,481533020,677,82665,3817237,481450355,0,2908,243261,2410,184053,498,59208,717,8,1008,18,0,32,1000.0,39000.0,-70.0,-71.0,-67.0,-60.0,-70.0,-71.0,-67.0,-60.0,-90.0,-93.0,-89.0,-93.0,20.0,22.0,22.0,33.0,0
592,BA:8C:B9:54:50:24,3818962,482287581,1725,837226,3817237,481450355,0,5536,819524,5516,816402,20,3122,1004,14,2100,29,0,48,1000.0,130000.0,-49.0,-35.0,-42.0,-44.0,-43.0,-36.0,-43.0,-48.0,-90.0,-93.0,-89.0,-93.0,41.0,58.0,47.0,49.0,0
593,92:69:1D:31:68:E9,3820714,484905738,3475,3455181,3817239,481450557,0,3604,929737,3508,908412,96,21325,1793,6,3601,78,0,31,1000.0,130000.0,-52.0,-50.0,-45.0,-46.0,-51.0,-50.0,-44.0,-48.0,-90.0,-93.0,-89.0,-93.0,38.0,43.0,44.0,47.0,0
594,CC:2F:71:3F:1F:24,4399732,1163586595,582493,682136038,3817239,481450557,37,487185,556479995,486624,556412321,561,67674,469518,10,582730,43236,34,431,130000.0,43333.0,-67.0,-65.0,-70.0,-68.0,-67.0,-65.0,-70.0,-67.0,-90.0,-93.0,-89.0,-93.0,23.0,28.0,19.0,25.0,0
595,CC:2F:71:3E:C5:1F,3817916,481533222,677,82665,3817239,481450557,0,2908,243261,2410,184053,498,59208,717,8,1008,18,0,32,1000.0,39000.0,-70.0,-71.0,-67.0,-60.0,-70.0,-71.0,-67.0,-60.0,-90.0,-93.0,-89.0,-93.0,20.0,22.0,22.0,33.0,0
596,BA:8C:B9:54:50:24,3818964,482287783,1725,837226,3817239,481450557,0,5536,819524,5516,816402,20,3122,1004,14,2100,29,0,48,1000.0,130000.0,-49.0,-35.0,-42.0,-44.0,-43.0,-36.0,-43.0,-48.0,-90.0,-93.0,-89.0,-93.0,41.0,58.0,47.0,49.0,0
597,92:69:1D:31:68:E9,3820718,484906142,3475,3455181,3817243,481450961,0,3604,929737,3508,908412,96,21325,1793,6,3601,78,0,31,1000.0,130000.0,-52.0,-50.0,-45.0,-46.0,-51.0,-50.0,-44.0,-48.0,-90.0,-93.0,-89.0,-93.0,38.0,43.0,44.0,47.0,0
598,CC:2F:71:3F:1F:24,4399778,1163601491,582535,682150530,3817243,481450961,37,487210,556484799,486649,556417125,561,67674,469543,10,582772,43240,34,431,130000.0,43333.0,-67.0,-65.0,-71.0,-67.0,-67.0,-65.0,-70.0,-67.0,-90.0,-93.0,-89.0,-93.0,23.0,28.0,18.0,26.0,0
599,CC:2F:71:3E:C5:1F,3817922,481533828,677,82665,3817245,481451163,0,2908,243261,2410,184053,498,59208,717,8,1008,18,0,32,1000.0,39000.0,-70.0,-71.0,-67.0,-60.0,-70.0,-71.0,-67.0,-60.0,-90.0,-93.0,-89.0,-93.0,20.0,22.0,22.0,33.0,0
600,BA:8C:B9:54:50:24,3818970,482288389,1725,837226,3817245,481451163,0,5536,819524,5516,816402,20,3122,1004,14,2100,29,0,48,1000.0,130000.0,-49.0,-35.0,-42.0,-44.0,-43.0,-36.0,-43.0,-48.0,-90.0,-93.0,-89.0,-93.0,41.0,58.0,47.0,49.0,0
601,92:69:1D:31:68:E9,3820723,484906606,3475,3455181,3817248,481451425,0,3604,929737,3508,908412,96,21325,1793,6,3601,78,0,31,1000.0,130000.0,-52.0,-50.0,-45.0,-46.0,-51.0,-50.0,-44.0,-48.0,-90.0,-93.0,-89.0,-93.0,38.0,43.0,44.0,47.0,0
602,CC:2F:71:3F:1F:24,4399823,1163616081,582575,682164656,3817248,481451425,37,487238,556489975,486677,556422301,561,67674,469571,10,582812,43260,34,431,117000.0,39000.0,-67.0,-65.0,-70.0,-67.0,-67.0,-65.0,-70.0,-67.0,-90.0,-93.0,-89.0,-93.0,23.0,28.0,19.0,26.0,0
603,CC:2F:71:3E:C5:1F,3817925,481534090,677,82665,3817248,481451425,0,2908,243261,2410,184053,498,59208,717,8,1008,18,0,32,1000.0,39000.0,-70.0,-71.0,-67.0,-60.0,-70.0,-71.0,-67.0,-60.0,-90.0,-93.0,-89.0,-93.0,20.0,22.0,22.0,33.0,0
604,BA:8C:B9:54:50:24,3818973,482288651,1725,837226,3817248,481451425,0,5536,819524,5516,816402,20,3122,1004,14,2100,29,0,48,1000.0,130000.0,-49.0,-35.0,-42.0,-44.0,-43.0,-36.0,-43.0,-48.0,-90.0,-93.0,-89.0,-93.0,41.0,58.0,47.0,49.0,0
605,92:69:1D:31:68:E9,3820729,484907343,3476,3455241,3817253,481452102,0,3606,929873,3510,908548,96,21325,1793,6,3602,78,0,31,216660.0,130000.0,-50.0,-47.0,-42.0,-48.0,-51.0,-50.0,-44.0,-47.0,-90.0,-93.0,-89.0,-93.0,40.0,46.0,47.0,45.0,0
606,CC:2F:71:3F:1F:24,4399870,1163631156,582617,682179054,3817253,481452102,37,487263,556494779,486702,556427105,561,67674,469596,10,582854,43277,34,431,130000.0,39000.0,-67.0,-65.0,-70.0,-67.0,-67.0,-65.0,-70.0,-67.0,-90.0,-93.0,-89.0,-93.0,23.0,28.0,19.0,26.0,0
607,CC:2F:71:3E:C5:1F,3817935,481535544,682,83442,3817253,481452102,0,2914,244076,2416,184868,498,59208,722,8,1013,18,0,32,130000.0,39000.0,-70.0,-71.0,-67.0,-60.0,-70.0,-71.0,-67.0,-60.0,-90.0,-93.0,-89.0,-93.0,20.0,22.0,22.0,33.0,0
608,BA:8C:B9:54:50:24,3818980,482289456,1726,837286,3817254,481452170,0,5538,819660,5518,816538,20,3122,1004,14,2101,29,0,48,216660.0,130000.0,-49.0,-35.0,-42.0,-44.0,-44.0,-36.0,-43.0,-47.0,-90.0,-93.0,-89.0,-93.0,41.0,58.0,47.0,49.0,0
609,92:69:1D:31:68:E9,3820733,484907747,3476,3455241,3817257,481452506,0,3606,929873,3510,908548,96,21325,1793,6,3602,78,0,31,216660.0,130000.0,-50.0,-47.0,-42.0,-48.0,-51.0,-50.0,-44.0,-47.0,-90.0,-93.0,-89.0,-93.0,40.0,46.0,47.0,45.0,0
610,CC:2F:71:3F:1F:24,4399916,1163645932,582659,682193426,3817257,481452506,37,487288,556499583,486727,556431909,561,67674,469621,10,582896,43315,34,431,144444.0,43333.0,-67.0,-65.0,-70.0,-67.0,-67.0,-65.0,-70.0,-67.0,-90.0,-93.0,-89.0,-93.0,23.0,28.0,19.0,26.0,0
611,CC:2F:71:3E:C5:1F,3817940,481536008,682,83442,3817258,481452566,0,2914,244076,2416,184868,498,59208,722,8,1013,18,0,32,130000.0,39000.0,-70.0,-71.0,-67.0,-60.0,-70.0,-71.0,-67.0,-60.0,-90.0,-93.0,-89.0,-93.0,20.0,22.0,22.0,33.0,0
612,BA:8C:B9:54:50:24,3818984,482289852,1726,837286,3817258,481452566,0,5539,819728,5519,816606,20,3122,1004,14,2101,29,0,48,216660.0,130000.0,-49.0,-35.0,-42.0,-44.0,-44.0,-36.0,-43.0,-47.0,-90.0,-93.0,-89.0,-93.0,41.0,58.0,47.0,49.0,0
613,92:69:1D:31:68:E9,3820738,484908211,3476,3455241,3817262,481452970,0,3606,929873,3510,908548,96,21325,1793,6,3602,78,0,31,216660.0,130000.0,-50.0,-47.0,-42.0,-48.0,-51.0,-50.0,-44.0,-47.0,-90.0,-93.0,-89.0,-93.0,40.0,46.0,47.0,45.0,0
614,CC:2F:71:3F:1F:24,4399963,1163661008,582701,682208038,3817262,481452970,37,487316,556504747,486755,556437073,561,67674,469649,10,582938,43344,34,431,130000.0,43333.0,-67.0,-65.0,-70.0,-67.0,-67.0,-65.0,-70.0,-67.0,-90.0,-93.0,-89.0,-93.0,23.0,28.0,19.0,26.0,0
615,CC:2F:71:3E:C5:1F,3817946,481536614,682,83442,3817264,481453172,0,2914,244076,2416,184868,498,59208,722,8,1013,18,0,32,130000.0,39000.0,-70.0,-71.0,-67.0,-60.0,-70.0,-71.0,-67.0,-60.0,-90.0,-93.0,-89.0,-93.0,20.0,22.0,22.0,33.0,0
616,BA:8C:B9:54:50:24,3818990,482290458,1726,837286,3817264,481453172,0,5539,819728,5519,816606,20,3122,1004,14,2101,29,0,48,216660.0,130000.0,-49.0,-35.0,-42.0,-44.0,-44.0,-36.0,-43.0,-47.0,-90.0,-93.0,-89.0,-93.0,41.0,58.0,47.0,49.0,0
617,92:69:1D:31:68:E9,3820743,484908677,3476,3455241,3817267,481453436,0,3606,929873,3510,908548,96,21325,1793,6,3602,78,0,31,216660.0,130000.0,-50.0,-47.0,-42.0,-48.0,-51.0,-50.0,-44.0,-47.0,-90.0,-93.0,-90.0,-93.0,40.0,46.0,48.0,45.0,0
618,CC:2F:71:3F:1F:24,4400009,1163675890,582742,682222454,3817267,481453436,37,487343,556509831,486782,556442157,561,67674,469676,10,582979,43347,34,431,130000.0,43333.0,-67.0,-65.0,-70.0,-68.0,-67.0,-65.0,-70.0,-67.0,-90.0,-93.0,-90.0,-93.0,23.0,28.0,20.0,25.0,0
619,CC:2F:71:3E:C5:1F,3817949,481536878,682,83442,3817267,481453436,0,2916,244264,2417,184938,499,59326,723,8,1013,18,0,32,130000.0,39000.0,-70.0,-71.0,-67.0,-60.0,-70.0,-71.0,-67.0,-60.0,-90.0,-93.0,-90.0,-93.0,20.0,22.0,23.0,33.0,0
620,BA:8C:B9:54:50:24,3818993,482290722,1726,837286,3817267,481453436,0,5539,819728,5519,816606,20,3122,1004,14,2101,29,0,48,216660.0,130000.0,-49.0,-35.0,-42.0,-44.0,-44.0,-36.0,-43.0,-47.0,-90.0,-93.0,-90.0,-93.0,41.0,58.0,48.0,49.0,0
621,92:69:1D:31:68:E9,3820748,484909141,3476,3455241,3817272,481453900,0,3606,929873,3510,908548,96,21325,1793,6,3602,78,0,31,216660.0,130000.0,-50.0,-47.0,-42.0,-48.0,-51.0,-50.0,-44.0,-47.0,-90.0,-93.0,-90.0,-93.0,40.0,46.0,48.0,45.0,0
622,CC:2F:71:3F:1F:24,4400056,1163690782,582784,682236882,3817272,481453900,37,487370,556514915,486809,556447241,561,67674,469703,10,583021,43358,34,431,117000.0,39000.0,-67.0,-65.0,-70.0,-67.0,-66.0,-65.0,-70.0,-67.0,-90.0,-93.0,-90.0,-93.0,23.0,28.0,20.0,26.0,0
623,CC:2F:71:3E:C5:1F,3817956,481537544,682,83442,3817274,481454102,0,2916,244264,2417,184938,499,59326,723,8,1013,18,0,32,130000.0,39000.0,-70.0,-71.0,-67.0,-60.0,-70.0,-71.0,-67.0,-60.0,-90.0,-93.0,-90.0,-93.0,20.0,22.0,23.0,33.0,0
624,BA:8C:B9:54:50:24,3819000,482291388,1726,837286,3817274,481454102,0,5539,819728,5519,816606,20,3122,1004,14,2101,29,0,48,216660.0,130000.0,-49.0,-35.0,-42.0,-44.0,-44.0,-36.0,-43.0,-47.0,-90.0,-93.0,-90.0,-93.0,41.0,58.0,48.0,49.0,0
625,92:69:1D:31:68:E9,3820752,484909545,3476,3455241,3817276,481454304,0,3606,929873,3510,908548,96,21325,1793,6,3602,78,0,31,216660.0,130000.0,-50.0,-47.0,-42.0,-48.0,-51.0,-50.0,-44.0,-47.0,-90.0,-93.0,-90.0,-93.0,40.0,46.0,48.0,45.0,0
626,CC:2F:71:3F:1F:24,4400101,1163705378,582825,682251074,3817276,481454304,37,487396,556519859,486835,556452185,561,67674,469729,10,583062,43365,34,431,117000.0,39000.0,-67.0,-65.0,-70.0,-68.0,-67.0,-65.0,-70.0,-67.0,-90.0,-93.0,-90.0,-93.0,23.0,28.0,20.0,25.0,0
627,CC:2F:71:3E:C5:1F,3817958,481537746,682,83442,3817276,481454304,0,2916,244264,2417,184938,499,59326,723,8,1013,18,0,32,130000.0,39000.0,-70.0,-71.0,-67.0,-60.0,-70.0,-71.0,-67.0,-60.0,-90.0,-93.0,-90.0,-93.0,20.0,22.0,23.0,33.0,0
628,BA:8C:B9:54:50:24,3819002,482291590,1726,837286,3817276,481454304,0,5539,819728,5519,816606,20,3122,1004,14,2101,29,0,48,216660.0,130000.0,-49.0,-35.0,-42.0,-44.0,-44.0,-36.0,-43.0,-47.0,-90.0,-93.0,-90.0,-93.0,41.0,58.0,48.0,49.0,0
629,92:69:1D:31:68:E9,3820757,484910011,3476,3455241,3817281,481454770,0,3606,929873,3510,908548,96,21325,1793,6,3602,78,0,31,216660.0,130000.0,-50.0,-47.0,-42.0,-48.0,-51.0,-50.0,-44.0,-47.0,-90.0,-93.0,-90.0,-93.0,40.0,46.0,48.0,45.0,0
630,CC:2F:71:3F:1F:24,4400149,1163720402,582868,682265632,3817281,481454770,37,487424,556525037,486862,556457245,562,67792,469757,10,583105,43373,34,431,130000.0,43333.0,-67.0,-65.0,-70.0,-68.0,-67.0,-65.0,-70.0,-67.0,-90.0,-93.0,-90.0,-93.0,23.0,28.0,20.0,25.0,0
631,CC:2F:71:3E:C5:1F,3817965,481538414,682,83442,3817283,481454972,0,2916,244264,2417,184938,499,59326,723,8,1013,18,0,32,130000.0,39000.0,-70.0,-71.0,-67.0,-60.0,-70.0,-71.0,-67.0,-60.0,-90.0,-93.0,-90.0,-93.0,20.0,22.0,23.0,33.0,0
632,BA:8C:B9:54:50:24,3819009,482292258,1726,837286,3817283,481454972,0,5539,819728,5519,816606,20,3122,1004,14,2101,29,0,48,216660.0,130000.0,-49.0,-35.0,-42.0,-44.0,-44.0,-36.0,-43.0,-47.0,-90.0,-93.0,-90.0,-93.0,41.0,58.0,48.0,49.0,0
633,92:69:1D:31:68:E9,3820762,484910475,3476,3455241,3817286,481455234,0,3606,929873,3510,908548,96,21325,1793,6,3602,78,0,31,216660.0,130000.0,-50.0,-47.0,-42.0,-48.0,-51.0,-50.0,-44.0,-47.0,-90.0,-93.0,-90.0,-93.0,40.0,46.0,48.0,45.0,0
634,CC:2F:71:3F:1F:24,4400196,1163735182,582910,682279948,3817286,481455234,37,487449,556529841,486887,556462049,562,67792,469782,10,583147,43411,34,431,130000.0,43333.0,-67.0,-65.0,-70.0,-67.0,-67.0,-65.0,-70.0,-67.0,-90.0,-93.0,-90.0,-93.0,23.0,28.0,20.0,26.0,0
635,CC:2F:71:3E:C5:1F,3817969,481538792,683,83558,3817286,481455234,0,2919,244510,2420,185184,499,59326,724,8,1014,18,0,32,130000.0,39000.0,-70.0,-71.0,-67.0,-60.0,-70.0,-71.0,-67.0,-60.0,-90.0,-93.0,-90.0,-93.0,20.0,22.0,23.0,33.0,0
636,BA:8C:B9:54:50:24,3819012,482292520,1726,837286,3817286,481455234,0,5539,819728,5519,816606,20,3122,1004,14,2101,29,0,48,216660.0,130000.0,-49.0,-35.0,-42.0,-44.0,-44.0,-36.0,-43.0,-47.0,-90.0,-93.0,-90.0,-93.0,41.0,58.0,48.0,49.0,0
637,92:69:1D:31:68:E9,3820764,484910677,3476,3455241,3817288,481455436,0,3606,929873,3510,908548,96,21325,1793,6,3602,78,0,31,216660.0,130000.0,-50.0,-47.0,-42.0,-48.0,-51.0,-50.0,-44.0,-47.0,-90.0,-93.0,-90.0,-93.0,40.0,46.0,48.0,45.0,0
638,CC:2F:71:3F:1F:24,4400243,1163750252,582952,682294488,3817291,481455764,37,487476,556534877,486914,556467085,562,67792,469809,10,583189,43414,34,431,130000.0,43333.0,-67.0,-65.0,-71.0,-67.0,-67.0,-65.0,-70.0,-67.0,-90.0,-93.0,-90.0,-93.0,23.0,28.0,19.0,26.0,0
639,CC:2F:71:3E:C5:1F,3817976,481539524,683,83558,3817293,481455966,0,2919,244510,2420,185184,499,59326,724,8,1014,18,0,32,130000.0,39000.0,-70.0,-71.0,-67.0,-60.0,-70.0,-71.0,-67.0,-60.0,-90.0,-93.0,-90.0,-93.0,20.0,22.0,23.0,33.0,0
640,BA:8C:B9:54:50:24,3819019,482293252,1726,837286,3817293,481455966,0,5539,819728,5519,816606,20,3122,1004,14,2101,29,0,48,216660.0,130000.0,-49.0,-35.0,-42.0,-44.0,-44.0,-36.0,-43.0,-47.0,-90.0,-93.0,-90.0,-93.0,41.0,58.0,48.0,49.0,0
641,92:69:1D:31:68:E9,3820772,484911469,3476,3455241,3817296,481456228,0,3606,929873,3510,908548,96,21325,1793,6,3602,78,0,31,216660.0,130000.0,-50.0,-47.0,-42.0,-48.0,-51.0,-50.0,-44.0,-47.0,-90.0,-93.0,-90.0,-93.0,40.0,46.0,48.0,45.0,0
642,CC:2F:71:3F:1F:24,4400291,1163765380,582995,682309152,3817296,481456228,37,487501,556539681,486939,556471889,562,67792,469834,10,583232,43423,34,431,130000.0,43333.0,-67.0,-65.0,-71.0,-68.0,-67.0,-65.0,-70.0,-67.0,-90.0,-93.0,-90.0,-93.0,23.0,28.0,19.0,25.0,0
643,CC:2F:71:3E:C5:1F,3817979,481539786,683,83558,3817296,481456228,0,2919,244510,2420,185184,499,59326,724,8,1014,18,0,32,130000.0,39000.0,-70.0,-71.0,-67.0,-60.0,-70.0,-71.0,-67.0,-60.0,-90.0,-93.0,-90.0,-93.0,20.0,22.0,23.0,33.0,0
644,BA:8C:B9:54:50:24,3819022,482293514,1726,837286,3817296,481456228,0,5539,819728,5519,816606,20,3122,1004,14,2101,29,0,48,216660.0,130000.0,-49.0,-35.0,-42.0,-44.0,-44.0,-36.0,-43.0,-47.0,-90.0,-93.0,-90.0,-93.0,41.0,58.0,48.0,49.0,0
645,92:69:1D:31:68:E9,3820774,484911671,3476,3455241,3817298,481456430,0,3606,929873,3510,908548,96,21325,1793,6,3602,78,0,31,216660.0,130000.0,-50.0,-47.0,-42.0,-48.0,-51.0,-50.0,-44.0,-47.0,-90.0,-93.0,-90.0,-93.0,40.0,46.0,48.0,45.0,0
646,CC:2F:71:3F:1F:24,4400337,1163780166,583035,682323332,3817302,481456834,37,487526,556544485,486964,556476693,562,67792,469859,10,583272,43439,34,431,117000.0,39000.0,-67.0,-65.0,-70.0,-67.0,-67.0,-65.0,-70.0,-67.0,-90.0,-93.0,-90.0,-93.0,23.0,28.0,20.0,26.0,0
647,CC:2F:71:3E:C5:1F,3817985,481540392,683,83558,3817302,481456834,0,2919,244510,2420,185184,499,59326,724,8,1014,18,0,32,130000.0,39000.0,-70.0,-71.0,-67.0,-60.0,-70.0,-71.0,-67.0,-60.0,-90.0,-93.0,-90.0,-93.0,20.0,22.0,23.0,33.0,0
648,BA:8C:B9:54:50:24,3819028,482294120,1726,837286,3817302,481456834,0,5539,819728,5519,816606,20,3122,1004,14,2101,29,0,48,216660.0,130000.0,-49.0,-35.0,-42.0,-44.0,-44.0,-36.0,-43.0,-47.0,-90.0,-93.0,-90.0,-93.0,41.0,58.0,48.0,49.0,0
649,92:69:1D:31:68:E9,3820780,484912277,3476,3455241,3817304,481457036,0,3606,929873,3510,908548,96,21325,1793,6,3602,78,0,31,216660.0,130000.0,-50.0,-47.0,-42.0,-48.0,-51.0,-50.0,-44.0,-47.0,-90.0,-92.0,-89.0,-92.0,40.0,45.0,47.0,44.0,0
650,CC:2F:71:3F:1F:24,4400382,1163794920,583078,682337884,3817304,481457036,37,487551,556549289,486989,556481497,562,67792,469884,10,583315,43449,34,431,130000.0,43333.0,-67.0,-65.0,-70.0,-67.0,-67.0,-65.0,-70.0,-67.0,-90.0,-92.0,-89.0,-92.0,23.0,27.0,19.0,25.0,0
651,CC:2F:71:3E:C5:1F,3817987,481540594,683,83558,3817304,481457036,0,2919,244510,2420,185184,499,59326,724,8,1014,18,0,32,130000.0,39000.0,-70.0,-71.0,-67.0,-60.0,-70.0,-71.0,-67.0,-60.0,-90.0,-92.0,-89.0,-92.0,20.0,21.0,22.0,32.0,0
652,BA:8C:B9:54:50:24,3819030,482294322,1726,837286,3817304,481457036,0,5539,819728,5519,816606,20,3122,1004,14,2101,29,0,48,216660.0,130000.0,-49.0,-35.0,-42.0,-44.0,-44.0,-36.0,-43.0,-47.0,-90.0,-92.0,-89.0,-92.0,41.0,57.0,47.0,48.0,0
653,92:69:1D:31:68:E9,3820783,484912539,3476,3455241,3817307,481457298,0,3606,929873,3510,908548,96,21325,1793,6,3602,78,0,31,216660.0,130000.0,-50.0,-47.0,-42.0,-48.0,-51.0,-50.0,-44.0,-47.0,-90.0,-92.0,-89.0,-92.0,40.0,45.0,47.0,44.0,0
654,CC:2F:71:3F:1F:24,4400431,1163810008,583120,682352306,3817311,481457702,37,487577,556554233,487015,556486441,562,67792,469910,10,583357,43469,34,431,117000.0,39000.0,-67.0,-65.0,-70.0,-68.0,-67.0,-65.0,-70.0,-67.0,-90.0,-92.0,-89.0,-92.0,23.0,27.0,19.0,24.0,0
655,CC:2F:71:3E:C5:1F,3817994,481541260,683,83558,3817311,481457702,0,2919,244510,2420,185184,499,59326,724,8,1014,18,0,32,130000.0,39000.0,-70.0,-71.0,-67.0,-60.0,-70.0,-71.0,-67.0,-60.0,-90.0,-92.0,-89.0,-92.0,20.0,21.0,22.0,32.0,0
656,BA:8C:B9:54:50:24,3819037,482294988,1726,837286,3817311,481457702,0,5542,819932,5522,816810,20,3122,1004,14,2101,29,0,49,216660.0,130000.0,-40.0,-37.0,-45.0,-52.0,-43.0,-36.0,-43.0,-48.0,-90.0,-92.0,-89.0,-92.0,50.0,55.0,44.0,40.0,0
657,92:69:1D:31:68:E9,3820790,484913418,3476,3455241,3817314,481458177,0,3606,929873,3510,908548,96,21325,1793,6,3602,78,0,31,216660.0,130000.0,-50.0,-47.0,-42.0,-48.0,-51.0,-50.0,-44.0,-47.0,-90.0,-92.0,-89.0,-92.0,40.0,45.0,47.0,44.0,0
658,CC:2F:71:3F:1F:24,4400476,1163824911,583162,682366734,3817314,481458177,37,487602,556559037,487040,556491245,562,67792,469935,10,583399,43481,34,431,130000.0,43333.0,-67.0,-65.0,-70.0,-67.0,-67.0,-65.0,-70.0,-67.0,-90.0,-92.0,-89.0,-92.0,23.0,27.0,19.0,25.0,0
659,CC:2F:71:3E:C5:1F,3817997,481541735,683,83558,3817314,481458177,0,2919,244510,2420,185184,499,59326,724,8,1014,18,0,32,130000.0,39000.0,-70.0,-71.0,-67.0,-60.0,-70.0,-71.0,-67.0,-60.0,-90.0,-92.0,-89.0,-92.0,20.0,21.0,22.0,32.0,0
660,BA:8C:B9:54:50:24,3819040,482295463,1726,837286,3817314,481458177,0,5543,820000,5523,816878,20,3122,1004,14,2101,29,0,49,216660.0,130000.0,-40.0,-37.0,-44.0,-51.0,-43.0,-36.0,-43.0,-48.0,-90.0,-92.0,-89.0,-92.0,50.0,55.0,45.0,41.0,0
661,92:69:1D:31:68:E9,3820792,484913620,3476,3455241,3817316,481458379,0,3606,929873,3510,908548,96,21325,1793,6,3602,78,0,31,216660.0,130000.0,-50.0,-47.0,-42.0,-48.0,-51.0,-50.0,-44.0,-47.0,-90.0,-92.0,-89.0,-92.0,40.0,45.0,47.0,44.0,0
662,CC:2F:71:3F:1F:24,4400524,1163839945,583204,682381162,3817320,481458783,37,487628,556563981,487066,556496189,562,67792,469961,10,583441,43511,34,431,144444.0,39000.0,-67.0,-65.0,-70.0,-68.0,-67.0,-65.0,-70.0,-67.0,-90.0,-92.0,-89.0,-92.0,23.0,27.0,19.0,24.0,0
663,CC:2F:71:3E:C5:1F,3818003,481542341,683,83558,3817320,481458783,0,2919,244510,2420,185184,499,59326,724,8,1014,18,0,32,130000.0,39000.0,-70.0,-71.0,-67.0,-60.0,-70.0,-71.0,-67.0,-60.0,-90.0,-92.0,-89.0,-92.0,20.0,21.0,22.0,32.0,0
664,BA:8C:B9:54:50:24,3819047,482296129,1726,837286,3817321,481458843,0,5543,820000,5523,816878,20,3122,1004,14,2101,29,0,49,216660.0,130000.0,-40.0,-37.0,-44.0,-51.0,-43.0,-36.0,-43.0,-48.0,-90.0,-92.0,-89.0,-92.0,50.0,55.0,45.0,41.0,0
665,92:69:1D:31:68:E9,3820799,484914286,3476,3455241,3817323,481459045,0,3606,929873,3510,908548,96,21325,1793,6,3602,78,0,31,216660.0,130000.0,-50.0,-47.0,-42.0,-48.0,-51.0,-50.0,-44.0,-47.0,-90.0,-92.0,-89.0,-92.0,40.0,45.0,47.0,44.0,0
666,CC:2F:71:3F:1F:24,4400568,1163854511,583245,682395466,3817323,481459045,37,487653,556568785,487091,556500993,562,67792,469986,10,583482,43523,34,431,130000.0,43333.0,-67.0,-65.0,-70.0,-67.0,-67.0,-65.0,-70.0,-67.0,-90.0,-92.0,-89.0,-92.0,23.0,27.0,19.0,25.0,0
667,CC:2F:71:3E:C5:1F,3818006,481542603,683,83558,3817323,481459045,0,2919,244510,2420,185184,499,59326,724,8,1014,18,0,32,130000.0,39000.0,-70.0,-71.0,-67.0,-60.0,-70.0,-71.0,-67.0,-60.0,-90.0,-92.0,-89.0,-92.0,20.0,21.0,22.0,32.0,0
668,BA:8C:B9:54:50:24,3819049,482296331,1726,837286,3817323,481459045,0,5543,820000,5523,816878,20,3122,1004,14,2101,29,0,49,216660.0,130000.0,-40.0,-37.0,-44.0,-51.0,-43.0,-36.0,-43.0,-48.0,-90.0,-92.0,-89.0,-92.0,50.0,55.0,45.0,41.0,0
669,92:69:1D:31:68:E9,3820801,484914488,3476,3455241,3817325,481459247,0,3606,929873,3510,908548,96,21325,1793,6,3602,78,0,31,216660.0,130000.0,-50.0,-47.0,-42.0,-48.0,-51.0,-50.0,-44.0,-47.0,-90.0,-92.0,-89.0,-92.0,40.0,45.0,47.0,44.0,0
670,CC:2F:71:3F:1F:24,4400618,1163869855,583289,682410204,3817329,481459651,37,487681,556573961,487119,556506169,562,67792,470014,10,583526,43539,34,431,130000.0,39000.0,-67.0,-65.0,-70.0,-67.0,-67.0,-65.0,-70.0,-67.0,-90.0,-92.0,-89.0,-92.0,23.0,27.0,19.0,25.0,0
671,CC:2F:71:3E:C5:1F,3818012,481543209,683,83558,3817329,481459651,0,2919,244510,2420,185184,499,59326,724,8,1014,18,0,32,130000.0,39000.0,-70.0,-71.0,-67.0,-60.0,-70.0,-71.0,-67.0,-60.0,-90.0,-92.0,-89.0,-92.0,20.0,21.0,22.0,32.0,0
672,BA:8C:B9:54:50:24,3819055,482296937,1726,837286,3817329,481459651,0,5543,820000,5523,816878,20,3122,1004,14,2101,29,0,49,216660.0,130000.0,-40.0,-37.0,-44.0,-51.0,-43.0,-36.0,-43.0,-48.0,-90.0,-92.0,-89.0,-92.0,50.0,55.0,45.0,41.0,0
673,92:69:1D:31:68:E9,3820808,484915154,3476,3455241,3817332,481459913,0,3606,929873,3510,908548,96,21325,1793,6,3602,78,0,31,216660.0,130000.0,-50.0,-47.0,-42.0,-48.0,-51.0,-50.0,-44.0,-47.0,-90.0,-92.0,-89.0,-92.0,40.0,45.0,47.0,44.0,0
674,CC:2F:71:3F:1F:24,4400663,1163884489,583331,682424576,3817332,481459913,37,487707,556578881,487145,556511089,562,67792,470040,10,583568,43553,34,431,130000.0,43333.0,-67.0,-65.0,-70.0,-67.0,-67.0,-65.0,-70.0,-67.0,-90.0,-92.0,-89.0,-92.0,23.0,27.0,19.0,25.0,0
675,CC:2F:71:3E:C5:1F,3818015,481543471,683,83558,3817332,481459913,0,2919,244510,2420,185184,499,59326,724,8,1014,18,0,32,130000.0,39000.0,-70.0,-71.0,-67.0,-60.0,-70.0,-71.0,-67.0,-60.0,-90.0,-92.0,-89.0,-92.0,20.0,21.0,22.0,32.0,0
676,BA:8C:B9:54:50:24,3819058,482297199,1726,837286,3817332,481459913,0,5543,820000,5523,816878,20,3122,1004,14,2101,29,0,49,216660.0,130000.0,-40.0,-37.0,-44.0,-51.0,-43.0,-36.0,-43.0,-48.0,-90.0,-92.0,-89.0,-92.0,50.0,55.0,45.0,41.0,0
677,92:69:1D:31:68:E9,3820810,484915356,3476,3455241,3817334,481460115,0,3606,929873,3510,908548,96,21325,1793,6,3602,78,0,31,216660.0,130000.0,-50.0,-47.0,-42.0,-48.0,-51.0,-50.0,-44.0,-47.0,-90.0,-92.0,-89.0,-92.0,40.0,45.0,47.0,44.0,0
678,CC:2F:71:3F:1F:24,4400711,1163899523,583373,682439004,3817338,481460519,37,487733,556583825,487171,556516033,562,67792,470066,10,583610,43574,34,431,117000.0,39000.0,-67.0,-65.0,-71.0,-67.0,-67.0,-65.0,-70.0,-67.0,-90.0,-92.0,-89.0,-92.0,23.0,27.0,18.0,25.0,0
679,CC:2F:71:3E:C5:1F,3818021,481544077,683,83558,3817338,481460519,0,2919,244510,2420,185184,499,59326,724,8,1014,18,0,32,130000.0,39000.0,-70.0,-71.0,-67.0,-60.0,-70.0,-71.0,-67.0,-60.0,-90.0,-92.0,-89.0,-92.0,20.0,21.0,22.0,32.0,0
680,BA:8C:B9:54:50:24,3819064,482297805,1726,837286,3817338,481460519,0,5543,820000,5523,816878,20,3122,1004,14,2101,29,0,49,216660.0,130000.0,-40.0,-37.0,-44.0,-51.0,-43.0,-36.0,-43.0,-48.0,-90.0,-92.0,-89.0,-92.0,50.0,55.0,45.0,41.0,0
681,92:69:1D:31:68:E9,3820816,484915962,3476,3455241,3817340,481460721,0,3606,929873,3510,908548,96,21325,1793,6,3602,78,0,31,216660.0,130000.0,-50.0,-47.0,-42.0,-48.0,-51.0,-50.0,-44.0,-47.0,-90.0,-92.0,-89.0,-92.0,40.0,45.0,47.0,44.0,0
682,CC:2F:71:3F:1F:24,4400756,1163914277,583416,682453556,3817340,481460721,37,487761,556589025,487199,556521233,562,67792,470094,10,583653,43582,34,431,130000.0,43333.0,-67.0,-65.0,-70.0,-67.0,-67.0,-65.0,-70.0,-67.0,-90.0,-92.0,-89.0,-92.0,23.0,27.0,19.0,25.0,0
683,CC:2F:71:3E:C5:1F,3818023,481544279,683,83558,3817340,481460721,0,2919,244510,2420,185184,499,59326,724,8,1014,18,0,32,130000.0,39000.0,-70.0,-71.0,-67.0,-60.0,-70.0,-71.0,-67.0,-60.0,-90.0,-92.0,-89.0,-92.0,20.0,21.0,22.0,32.0,0
684,BA:8C:B9:54:50:24,3819066,482298007,1726,837286,3817340,481460721,0,5543,820000,5523,816878,20,3122,1004,14,2101,29,0,49,216660.0,130000.0,-40.0,-37.0,-44.0,-51.0,-43.0,-36.0,-43.0,-48.0,-90.0,-92.0,-89.0,-92.0,50.0,55.0,45.0,41.0,0
685,92:69:1D:31:68:E9,3820819,484916224,3476,3455241,3817343,481460983,0,3606,929873,3510,908548,96,21325,1793,6,3602,78,0,31,216660.0,130000.0,-50.0,-47.0,-42.0,-48.0,-51.0,-50.0,-44.0,-47.0,-90.0,-92.0,-89.0,-92.0,40.0,45.0,47.0,44.0,0
686,CC:2F:71:3F:1F:24,4400802,1163929045,583457,682467860,3817345,481461185,37,487786,556593829,487224,556526037,562,67792,470119,10,583694,43606,34,431,117000.0,39000.0,-67.0,-65.0,-71.0,-67.0,-67.0,-65.0,-70.0,-67.0,-90.0,-92.0,-89.0,-92.0,23.0,27.0,18.0,25.0,0
687,CC:2F:71:3E:C5:1F,3818030,481544945,683,83558,3817347,481461387,0,2919,244510,2420,185184,499,59326,724,8,1014,18,0,32,130000.0,39000.0,-70.0,-71.0,-67.0,-60.0,-70.0,-71.0,-67.0,-60.0,-90.0,-92.0,-89.0,-92.0,20.0,21.0,22.0,32.0,0
688,BA:8C:B9:54:50:24,3819073,482298673,1726,837286,3817347,481461387,0,5543,820000,5523,816878,20,3122,1004,14,2101,29,0,49,216660.0,130000.0,-40.0,-37.0,-44.0,-51.0,-43.0,-36.0,-43.0,-48.0,-90.0,-92.0,-89.0,-92.0,50.0,55.0,45.0,41.0,0
689,92:69:1D:31:68:E9,3820825,484916830,3476,3455241,3817349,481461589,0,3606,929873,3510,908548,96,21325,1793,6,3602,78,0,31,216660.0,130000.0,-50.0,-47.0,-42.0,-48.0,-51.0,-50.0,-44.0,-47.0,-90.0,-92.0,-89.0,-92.0,40.0,45.0,47.0,44.0,0
690,CC:2F:71:3F:1F:24,4400848,1163943877,583499,682482288,3817349,481461589,37,487813,556598913,487251,556531121,562,67792,470146,10,583736,43618,34,431,130000.0,43333.0,-67.0,-65.0,-70.0,-67.0,-67.0,-65.0,-70.0,-67.0,-90.0,-92.0,-89.0,-92.0,23.0,27.0,19.0,25.0,0
691,CC:2F:71:3E:C5:1F,3818032,481545147,683,83558,3817349,481461589,0,2919,244510,2420,185184,499,59326,724,8,1014,18,0,32,130000.0,39000.0,-70.0,-71.0,-67.0,-60.0,-70.0,-71.0,-67.0,-60.0,-90.0,-92.0,-89.0,-92.0,20.0,21.0,22.0,32.0,0
692,BA:8C:B9:54:50:24,3819075,482298875,1726,837286,3817349,481461589,0,5543,820000,5523,816878,20,3122,1004,14,2101,29,0,49,216660.0,130000.0,-40.0,-37.0,-44.0,-51.0,-43.0,-36.0,-43.0,-48.0,-90.0,-92.0,-89.0,-92.0,50.0,55.0,45.0,41.0,0
693,92:69:1D:31:68:E9,3820827,484917032,3476,3455241,3817351,481461791,0,3607,929941,3511,908616,96,21325,1793,6,3602,78,0,31,216660.0,130000.0,-52.0,-51.0,-45.0,-48.0,-51.0,-49.0,-44.0,-47.0,-90.0,-92.0,-89.0,-92.0,38.0,41.0,44.0,44.0,0
694,CC:2F:71:3F:1F:24,4400895,1163958787,583540,682496592,3817355,481462195,37,487839,556603857,487277,556536065,562,67792,470172,10,583777,43642,34,431,117000.0,39000.0,-67.0,-65.0,-70.0,-67.0,-67.0,-65.0,-70.0,-67.0,-90.0,-92.0,-89.0,-92.0,23.0,27.0,19.0,25.0,0
695,CC:2F:71:3E:C5:1F,3818038,481545753,683,83558,3817355,481462195,0,2919,244510,2420,185184,499,59326,724,8,1014,18,0,32,130000.0,39000.0,-70.0,-71.0,-67.0,-60.0,-70.0,-71.0,-67.0,-60.0,-90.0,-92.0,-89.0,-92.0,20.0,21.0,22.0,32.0,0
696,BA:8C:B9:54:50:24,3819082,482299541,1726,837286,3817356,481462255,0,5543,820000,5523,816878,20,3122,1004,14,2101,29,0,49,216660.0,130000.0,-40.0,-37.0,-44.0,-51.0,-43.0,-36.0,-43.0,-48.0,-90.0,-92.0,-89.0,-92.0,50.0,55.0,45.0,41.0,0
697,92:69:1D:31:68:E9,3820834,484917698,3476,3455241,3817358,481462457,0,3607,929941,3511,908616,96,21325,1793,6,3602,78,0,31,216660.0,130000.0,-52.0,-51.0,-45.0,-48.0,-51.0,-49.0,-44.0,-47.0,-90.0,-92.0,-89.0,-92.0,38.0,41.0,44.0,44.0,0
698,CC:2F:71:3F:1F:24,4400939,1163973353,583581,682510896,3817358,481462457,37,487866,556608941,487304,556541149,562,67792,470199,10,583818,43648,34,431,130000.0,43333.0,-67.0,-65.0,-70.0,-67.0,-67.0,-65.0,-70.0,-67.0,-90.0,-92.0,-89.0,-92.0,23.0,27.0,19.0,25.0,0
699,CC:2F:71:3E:C5:1F,3818041,481546015,683,83558,3817358,481462457,0,2919,244510,2420,185184,499,59326,724,8,1014,18,0,32,130000.0,39000.0,-70.0,-71.0,-67.0,-60.0,-70.0,-71.0,-67.0,-60.0,-90.0,-92.0,-89.0,-92.0,20.0,21.0,22.0,32.0,0
700,BA:8C:B9:54:50:24,3819084,482299743,1726,837286,3817358,481462457,0,5543,820000,5523,816878,20,3122,1004,14,2101,29,0,49,216660.0,130000.0,-40.0,-37.0,-44.0,-51.0,-43.0,-36.0,-43.0,-48.0,-90.0,-92.0,-89.0,-92.0,50.0,55.0,45.0,41.0,0
701,92:69:1D:31:68:E9,3820836,484917900,3476,3455241,3817360,481462659,0,3607,929941,3511,908616,96,21325,1793,6,3602,78,0,31,216660.0,130000.0,-52.0,-51.0,-45.0,-48.0,-51.0,-49.0,-44.0,-47.0,-90.0,-92.0,-89.0,-92.0,38.0,41.0,44.0,44.0,0
702,CC:2F:71:3F:1F:24,4400985,1163988185,583623,682525324,3817362,481462861,37,487891,556613745,487329,556545953,562,67792,470224,10,583860,43661,34,431,117000.0,39000.0,-67.0,-65.0,-70.0,-67.0,-67.0,-65.0,-70.0,-67.0,-90.0,-92.0,-89.0,-92.0,23.0,27.0,19.0,25.0,0
703,CC:2F:71:3E:C5:1F,3818047,481546621,683,83558,3817364,481463063,0,2919,244510,2420,185184,499,59326,724,8,1014,18,0,32,130000.0,39000.0,-70.0,-71.0,-67.0,-60.0,-70.0,-71.0,-67.0,-60.0,-90.0,-92.0,-89.0,-92.0,20.0,21.0,22.0,32.0,0
704,BA:8C:B9:54:50:24,3819090,482300349,1726,837286,3817364,481463063,0,5543,820000,5523,816878,20,3122,1004,14,2101,29,0,49,216660.0,130000.0,-40.0,-37.0,-44.0,-51.0,-43.0,-36.0,-43.0,-48.0,-90.0,-92.0,-89.0,-92.0,50.0,55.0,45.0,41.0,0
705,92:69:1D:31:68:E9,3820843,484918566,3476,3455241,3817367,481463325,0,3607,929941,3511,908616,96,21325,1793,6,3602,78,0,31,216660.0,130000.0,-52.0,-51.0,-45.0,-48.0,-51.0,-49.0,-44.0,-47.0,-90.0,-92.0,-89.0,-92.0,38.0,41.0,44.0,44.0,0
706,CC:2F:71:3F:1F:24,4401034,1164003331,583667,682540006,3817367,481463325,37,487917,556618725,487355,556550933,562,67792,470250,10,583904,43665,34,431,130000.0,43333.0,-67.0,-65.0,-71.0,-67.0,-67.0,-65.0,-70.0,-67.0,-90.0,-92.0,-89.0,-92.0,23.0,27.0,18.0,25.0,0
707,CC:2F:71:3E:C5:1F,3818050,481546883,683,83558,3817367,481463325,0,2919,244510,2420,185184,499,59326,724,8,1014,18,0,32,130000.0,39000.0,-70.0,-71.0,-67.0,-60.0,-70.0,-71.0,-67.0,-60.0,-90.0,-92.0,-89.0,-92.0,20.0,21.0,22.0,32.0,0
708,BA:8C:B9:54:50:24,3819093,482300611,1726,837286,3817367,481463325,0,5543,820000,5523,816878,20,3122,1004,14,2101,29,0,49,216660.0,130000.0,-40.0,-37.0,-44.0,-51.0,-43.0,-36.0,-43.0,-48.0,-90.0,-92.0,-89.0,-92.0,50.0,55.0,45.0,41.0,0
709,92:69:1D:31:68:E9,3820847,484919157,3477,3455357,3817370,481463800,0,3609,930077,3513,908752,96,21325,1793,6,3603,78,0,31,216660.0,130000.0,-51.0,-53.0,-47.0,-48.0,-51.0,-50.0,-45.0,-47.0,-90.0,-92.0,-89.0,-92.0,39.0,39.0,42.0,44.0,0
710,CC:2F:71:3F:1F:24,4401082,1164018664,583710,682554662,3817372,481464002,37,487944,556623809,487382,556556017,562,67792,470277,10,583947,43667,34,431,130000.0,43333.0,-67.0,-65.0,-70.0,-67.0,-67.0,-65.0,-70.0,-67.0,-90.0,-92.0,-89.0,-92.0,23.0,27.0,19.0,25.0,0
711,CC:2F:71:3E:C5:1F,3818058,481547878,684,83674,3817374,481464204,0,2921,244650,2422,185324,499,59326,724,8,1015,18,0,32,130000.0,39000.0,-70.0,-71.0,-67.0,-60.0,-70.0,-71.0,-67.0,-60.0,-90.0,-92.0,-89.0,-92.0,20.0,21.0,22.0,32.0,0
712,BA:8C:B9:54:50:24,3819101,482301606,1727,837402,3817374,481464204,0,5545,820136,5525,817014,20,3122,1004,14,2102,29,0,49,216660.0,130000.0,-40.0,-37.0,-45.0,-51.0,-43.0,-36.0,-43.0,-48.0,-90.0,-92.0,-89.0,-92.0,50.0,55.0,44.0,41.0,0
713,92:69:1D:31:68:E9,3820853,484919763,3477,3455357,3817376,481464406,0,3609,930077,3513,908752,96,21325,1793,6,3603,78,0,31,216660.0,130000.0,-51.0,-53.0,-47.0,-48.0,-51.0,-50.0,-45.0,-47.0,-90.0,-92.0,-89.0,-92.0,39.0,39.0,42.0,44.0,0
714,CC:2F:71:3F:1F:24,4401128,1164033496,583752,682569090,3817376,481464406,37,487970,556628753,487408,556560961,562,67792,470303,10,583989,43688,34,431,117000.0,39000.0,-67.0,-65.0,-70.0,-67.0,-67.0,-65.0,-70.0,-67.0,-90.0,-92.0,-89.0,-92.0,23.0,27.0,19.0,25.0,0
715,CC:2F:71:3E:C5:1F,3818060,481548080,684,83674,3817376,481464406,0,2921,244650,2422,185324,499,59326,724,8,1015,18,0,32,130000.0,39000.0,-70.0,-71.0,-67.0,-60.0,-70.0,-71.0,-67.0,-60.0,-90.0,-92.0,-89.0,-92.0,20.0,21.0,22.0,32.0,0
716,BA:8C:B9:54:50:24,3819103,482301808,1727,837402,3817376,481464406,0,5545,820136,5525,817014,20,3122,1004,14,2102,29,0,49,216660.0,130000.0,-40.0,-37.0,-45.0,-51.0,-43.0,-36.0,-43.0,-48.0,-90.0,-92.0,-89.0,-92.0,50.0,55.0,44.0,41.0,0
717,92:69:1D:31:68:E9,3820856,484920025,3477,3455357,3817379,481464668,0,3609,930077,3513,908752,96,21325,1793,6,3603,78,0,31,216660.0,130000.0,-51.0,-53.0,-47.0,-48.0,-51.0,-50.0,-45.0,-47.0,-90.0,-92.0,-89.0,-92.0,39.0,39.0,42.0,44.0,0
718,CC:2F:71:3F:1F:24,4401177,1164048642,583796,682583772,3817381,481464870,37,487996,556633697,487434,556565905,562,67792,470329,10,584032,43692,34,431,130000.0,43333.0,-67.0,-65.0,-70.0,-68.0,-67.0,-65.0,-70.0,-67.0,-90.0,-92.0,-89.0,-92.0,23.0,27.0,19.0,24.0,0
719,CC:2F:71:3E:C5:1F,3818065,481548544,684,83674,3817381,481464870,0,2921,244650,2422,185324,499,59326,724,8,1015,18,0,32,130000.0,39000.0,-70.0,-71.0,-67.0,-60.0,-70.0,-71.0,-67.0,-60.0,-90.0,-92.0,-89.0,-92.0,20.0,21.0,22.0,32.0,0
720,BA:8C:B9:54:50:24,3819110,482302474,1727,837402,3817383,481465072,0,5545,820136,5525,817014,20,3122,1004,14,2102,29,0,49,216660.0,130000.0,-40.0,-37.0,-45.0,-51.0,-43.0,-36.0,-43.0,-48.0,-90.0,-92.0,-89.0,-92.0,50.0,55.0,44.0,41.0,0
721,92:69:1D:31:68:E9,3820862,484920631,3477,3455357,3817385,481465274,0,3609,930077,3513,908752,96,21325,1793,6,3603,78,0,31,216660.0,130000.0,-51.0,-53.0,-47.0,-48.0,-51.0,-50.0,-45.0,-47.0,-90.0,-92.0,-89.0,-92.0,39.0,39.0,42.0,44.0,0
722,CC:2F:71:3F:1F:24,4401224,1164063598,583839,682598324,3817385,481465274,37,488022,556638641,487460,556570849,562,67792,470355,10,584076,43705,34,431,117000.0,39000.0,-67.0,-65.0,-70.0,-68.0,-67.0,-65.0,-70.0,-67.0,-90.0,-92.0,-89.0,-92.0,23.0,27.0,19.0,24.0,0
723,CC:2F:71:3E:C5:1F,3818069,481548948,684,83674,3817385,481465274,0,2921,244650,2422,185324,499,59326,724,8,1015,18,0,32,130000.0,39000.0,-70.0,-71.0,-67.0,-60.0,-70.0,-71.0,-67.0,-60.0,-90.0,-92.0,-89.0,-92.0,20.0,21.0,22.0,32.0,0
724,BA:8C:B9:54:50:24,3819112,482302676,1727,837402,3817385,481465274,0,5545,820136,5525,817014,20,3122,1004,14,2102,29,0,49,216660.0,130000.0,-40.0,-37.0,-45.0,-51.0,-43.0,-36.0,-43.0,-48.0,-90.0,-92.0,-89.0,-92.0,50.0,55.0,44.0,41.0,0
725,92:69:1D:31:68:E9,3820867,484921263,3477,3455357,3817390,481465906,0,3609,930077,3513,908752,96,21325,1793,6,3603,78,0,31,216660.0,130000.0,-51.0,-53.0,-47.0,-48.0,-51.0,-50.0,-45.0,-47.0,-90.0,-92.0,-89.0,-92.0,39.0,39.0,42.0,44.0,0
726,CC:2F:71:3F:1F:24,4401274,1164078920,583881,682612752,3817393,481466168,37,488047,556643445,487485,556575653,562,67792,470380,10,584118,43715,34,431,130000.0,39000.0,-67.0,-65.0,-70.0,-68.0,-67.0,-65.0,-70.0,-67.0,-90.0,-92.0,-89.0,-92.0,23.0,27.0,19.0,24.0,0
727,CC:2F:71:3E:C5:1F,3818077,481549842,684,83674,3817393,481466168,0,2923,244838,2423,185394,500,59444,725,8,1015,18,0,32,130000.0,39000.0,-70.0,-71.0,-67.0,-60.0,-70.0,-71.0,-67.0,-60.0,-90.0,-92.0,-89.0,-92.0,20.0,21.0,22.0,32.0,0
728,BA:8C:B9:54:50:24,3819120,482303570,1727,837402,3817393,481466168,0,5545,820136,5525,817014,20,3122,1004,14,2102,29,0,49,216660.0,130000.0,-40.0,-37.0,-45.0,-51.0,-43.0,-36.0,-43.0,-48.0,-90.0,-92.0,-89.0,-92.0,50.0,55.0,44.0,41.0,0
729,92:69:1D:31:68:E9,3820874,484921929,3477,3455357,3817397,481466572,0,3609,930077,3513,908752,96,21325,1793,6,3603,78,0,31,216660.0,130000.0,-51.0,-53.0,-47.0,-48.0,-51.0,-50.0,-45.0,-47.0,-90.0,-92.0,-89.0,-92.0,39.0,39.0,42.0,44.0,0
730,CC:2F:71:3F:1F:24,4401321,1164093758,583924,682627186,3817397,481466572,37,488074,556648529,487512,556580737,562,67792,470407,10,584161,43726,34,431,130000.0,43333.0,-67.0,-65.0,-70.0,-67.0,-67.0,-65.0,-70.0,-67.0,-90.0,-92.0,-89.0,-92.0,23.0,27.0,19.0,25.0,0
731,CC:2F:71:3E:C5:1F,3818081,481550246,684,83674,3817397,481466572,0,2923,244838,2423,185394,500,59444,725,8,1015,18,0,32,130000.0,39000.0,-70.0,-71.0,-67.0,-60.0,-70.0,-71.0,-67.0,-60.0,-90.0,-92.0,-89.0,-92.0,20.0,21.0,22.0,32.0,0
732,BA:8C:B9:54:50:24,3819124,482303974,1727,837402,3817397,481466572,0,5545,820136,5525,817014,20,3122,1004,14,2102,29,0,49,216660.0,130000.0,-40.0,-37.0,-45.0,-51.0,-43.0,-36.0,-43.0,-48.0,-90.0,-92.0,-89.0,-92.0,50.0,55.0,44.0,41.0,0
733,92:69:1D:31:68:E9,3820876,484922131,3477,3455357,3817399,481466774,0,3609,930077,3513,908752,96,21325,1793,6,3603,78,0,31,216660.0,130000.0,-51.0,-53.0,-47.0,-48.0,-51.0,-50.0,-45.0,-47.0,-90.0,-92.0,-89.0,-92.0,39.0,39.0,42.0,44.0,0
734,CC:2F:71:3F:1F:24,4401365,1164108444,583966,682641670,3817399,481466774,37,488102,556653729,487540,556585937,562,67792,470435,10,584203,43742,34,431,130000.0,39000.0,-67.0,-65.0,-70.0,-68.0,-67.0,-65.0,-70.0,-67.0,-90.0,-92.0,-89.0,-92.0,23.0,27.0,19.0,24.0,0
735,CC:2F:71:3E:C5:1F,3818085,481550650,684,83674,3817401,481466976,0,2923,244838,2423,185394,500,59444,725,8,1015,18,0,32,130000.0,39000.0,-70.0,-71.0,-67.0,-60.0,-70.0,-71.0,-67.0,-60.0,-90.0,-92.0,-89.0,-92.0,20.0,21.0,22.0,32.0,0
736,BA:8C:B9:54:50:24,3819128,482304378,1727,837402,3817401,481466976,0,5545,820136,5525,817014,20,3122,1004,14,2102,29,0,49,216660.0,130000.0,-40.0,-37.0,-45.0,-51.0,-43.0,-36.0,-43.0,-48.0,-90.0,-92.0,-89.0,-92.0,50.0,55.0,44.0,41.0,0
737,92:69:1D:31:68:E9,3820884,484922859,3477,3455357,3817407,481467502,0,3609,930077,3513,908752,96,21325,1793,6,3603,78,0,31,216660.0,130000.0,-51.0,-53.0,-47.0,-48.0,-51.0,-50.0,-45.0,-47.0,-90.0,-92.0,-89.0,-92.0,39.0,39.0,42.0,44.0,0
738,CC:2F:71:3F:1F:24,4401415,1164123594,584008,682656092,3817407,481467502,37,488130,556658931,487567,556591021,563,67910,470463,10,584245,43750,34,431,130000.0,39000.0,-67.0,-65.0,-70.0,-68.0,-67.0,-65.0,-70.0,-67.0,-90.0,-92.0,-89.0,-92.0,23.0,27.0,19.0,24.0,0
739,CC:2F:71:3E:C5:1F,3818091,481551176,684,83674,3817407,481467502,0,2923,244838,2423,185394,500,59444,725,8,1015,18,0,32,130000.0,39000.0,-70.0,-71.0,-67.0,-60.0,-70.0,-71.0,-67.0,-60.0,-90.0,-92.0,-89.0,-92.0,20.0,21.0,22.0,32.0,0
740,BA:8C:B9:54:50:24,3819134,482304904,1727,837402,3817407,481467502,0,5545,820136,5525,817014,20,3122,1004,14,2102,29,0,49,216660.0,130000.0,-40.0,-37.0,-45.0,-51.0,-43.0,-36.0,-43.0,-48.0,-90.0,-92.0,-89.0,-92.0,50.0,55.0,44.0,41.0,0
741,92:69:1D:31:68:E9,3820886,484923061,3477,3455357,3817409,481467704,0,3609,930077,3513,908752,96,21325,1793,6,3603,78,0,31,216660.0,130000.0,-51.0,-53.0,-47.0,-48.0,-51.0,-50.0,-45.0,-47.0,-90.0,-92.0,-89.0,-92.0,39.0,39.0,42.0,44.0,0
742,CC:2F:71:3F:1F:24,4401461,1164138528,584052,682670824,3817409,481467704,37,488157,556663991,487594,556596081,563,67910,470490,10,584288,43752,34,431,130000.0,43333.0,-67.0,-65.0,-70.0,-67.0,-67.0,-65.0,-70.0,-67.0,-90.0,-92.0,-89.0,-92.0,23.0,27.0,19.0,25.0,0
743,CC:2F:71:3E:C5:1F,3818094,481551446,684,83674,3817410,481467772,0,2923,244838,2423,185394,500,59444,725,8,1015,18,0,32,130000.0,39000.0,-70.0,-71.0,-67.0,-60.0,-70.0,-71.0,-67.0,-60.0,-90.0,-92.0,-89.0,-92.0,20.0,21.0,22.0,32.0,0
744,BA:8C:B9:54:50:24,3819138,482305308,1727,837402,3817411,481467906,0,5545,820136,5525,817014,20,3122,1004,14,2102,29,0,49,216660.0,130000.0,-40.0,-37.0,-45.0,-51.0,-43.0,-36.0,-43.0,-48.0,-90.0,-92.0,-89.0,-92.0,50.0,55.0,44.0,41.0,0
745,92:69:1D:31:68:E9,3820892,484923667,3477,3455357,3817415,481468310,0,3609,930077,3513,908752,96,21325,1793,6,3603,78,0,31,216660.0,130000.0,-51.0,-53.0,-47.0,-48.0,-51.0,-50.0,-45.0,-47.0,-90.0,-92.0,-89.0,-92.0,39.0,39.0,42.0,44.0,0
746,CC:2F:71:3F:1F:24,4401509,1164153562,584094,682685252,3817415,481468310,37,488184,556669075,487621,556601165,563,67910,470517,10,584331,43774,34,431,117000.0,39000.0,-67.0,-65.0,-70.0,-68.0,-67.0,-65.0,-70.0,-67.0,-90.0,-92.0,-89.0,-92.0,23.0,27.0,19.0,24.0,0
747,CC:2F:71:3E:C5:1F,3818099,481551984,684,83674,3817415,481468310,0,2923,244838,2423,185394,500,59444,725,8,1015,18,0,32,130000.0,39000.0,-70.0,-71.0,-67.0,-60.0,-70.0,-71.0,-67.0,-60.0,-90.0,-92.0,-89.0,-92.0,20.0,21.0,22.0,32.0,0
748,BA:8C:B9:54:50:24,3819142,482305712,1727,837402,3817415,481468310,0,5545,820136,5525,817014,20,3122,1004,14,2102,29,0,49,216660.0,130000.0,-40.0,-37.0,-45.0,-51.0,-43.0,-36.0,-43.0,-48.0,-90.0,-92.0,-89.0,-92.0,50.0,55.0,44.0,41.0,0
749,92:69:1D:31:68:E9,3820895,484923929,3477,3455357,3817418,481468572,0,3609,930077,3513,908752,96,21325,1793,6,3603,78,0,31,216660.0,130000.0,-51.0,-53.0,-47.0,-48.0,-51.0,-50.0,-45.0,-47.0,-90.0,-92.0,-89.0,-92.0,39.0,39.0,42.0,44.0,0
750,CC:2F:71:3F:1F:24,4401555,1164168258,584137,682699686,3817418,481468572,37,488211,556674135,487648,556606225,563,67910,470544,10,584374,43794,34,431,117000.0,39000.0,-67.0,-65.0,-71.0,-68.0,-67.0,-65.0,-70.0,-67.0,-90.0,-92.0,-89.0,-92.0,23.0,27.0,18.0,24.0,0
751,CC:2F:71:3E:C5:1F,3818102,481552246,684,83674,3817418,481468572,0,2923,244838,2423,185394,500,59444,725,8,1015,18,0,32,130000.0,39000.0,-70.0,-71.0,-67.0,-60.0,-70.0,-71.0,-67.0,-60.0,-90.0,-92.0,-89.0,-92.0,20.0,21.0,22.0,32.0,0
752,BA:8C:B9:54:50:24,3819145,482305974,1727,837402,3817418,481468572,0,5545,820136,5525,817014,20,3122,1004,14,2102,29,0,49,216660.0,130000.0,-40.0,-37.0,-45.0,-51.0,-43.0,-36.0,-43.0,-48.0,-90.0,-92.0,-89.0,-92.0,50.0,55.0,44.0,41.0,0
753,92:69:1D:31:68:E9,3820899,484924333,3477,3455357,3817422,481468976,0,3609,930077,3513,908752,96,21325,1793,6,3603,78,0,31,216660.0,130000.0,-51.0,-53.0,-47.0,-48.0,-51.0,-50.0,-45.0,-47.0,-90.0,-92.0,-89.0,-92.0,39.0,39.0,42.0,44.0,0
754,CC:2F:71:3F:1F:24,4401604,1164183416,584180,682714238,3817424,481469178,37,488236,556678939,487673,556611029,563,67910,470569,10,584417,43796,34,431,130000.0,43333.0,-67.0,-65.0,-71.0,-67.0,-67.0,-65.0,-70.0,-67.0,-90.0,-92.0,-89.0,-92.0,23.0,27.0,18.0,25.0,0
755,CC:2F:71:3E:C5:1F,3818108,481552852,684,83674,3817424,481469178,0,2923,244838,2423,185394,500,59444,725,8,1015,18,0,32,130000.0,39000.0,-70.0,-71.0,-67.0,-60.0,-70.0,-71.0,-67.0,-60.0,-90.0,-92.0,-89.0,-92.0,20.0,21.0,22.0,32.0,0
756,BA:8C:B9:54:50:24,3819151,482306580,1727,837402,3817424,481469178,0,5545,820136,5525,817014,20,3122,1004,14,2102,29,0,49,216660.0,130000.0,-40.0,-37.0,-45.0,-51.0,-43.0,-36.0,-43.0,-48.0,-90.0,-92.0,-89.0,-92.0,50.0,55.0,44.0,41.0,0
757,92:69:1D:31:68:E9,3820904,484924797,3477,3455357,3817427,481469440,0,3609,930077,3513,908752,96,21325,1793,6,3603,78,0,31,216660.0,130000.0,-51.0,-53.0,-47.0,-48.0,-51.0,-50.0,-45.0,-47.0,-90.0,-92.0,-89.0,-92.0,39.0,39.0,42.0,44.0,0
758,CC:2F:71:3F:1F:24,4401650,1164198348,584223,682728908,3817427,481469440,37,488262,556683859,487699,556615949,563,67910,470595,10,584460,43807,34,431,130000.0,43333.0,-67.0,-65.0,-70.0,-67.0,-67.0,-65.0,-70.0,-67.0,-90.0,-92.0,-89.0,-92.0,23.0,27.0,19.0,25.0,0
759,CC:2F:71:3E:C5:1F,3818111,481553114,684,83674,3817427,481469440,0,2923,244838,2423,185394,500,59444,725,8,1015,18,0,32,130000.0,39000.0,-70.0,-71.0,-67.0,-60.0,-70.0,-71.0,-67.0,-60.0,-90.0,-92.0,-89.0,-92.0,20.0,21.0,22.0,32.0,0
760,BA:8C:B9:54:50:24,3819154,482306842,1727,837402,3817427,481469440,0,5545,820136,5525,817014,20,3122,1004,14,2102,29,0,49,216660.0,130000.0,-40.0,-37.0,-45.0,-51.0,-43.0,-36.0,-43.0,-48.0,-90.0,-92.0,-89.0,-92.0,50.0,55.0,44.0,41.0,0
761,92:69:1D:31:68:E9,3820909,484925474,3477,3455357,3817432,481470117,0,3609,930077,3513,908752,96,21325,1793,6,3603,78,0,31,216660.0,130000.0,-51.0,-53.0,-47.0,-48.0,-51.0,-50.0,-45.0,-47.0,-90.0,-92.0,-89.0,-92.0,39.0,39.0,42.0,44.0,0
762,CC:2F:71:3F:1F:24,4401699,1164213701,584267,682743584,3817432,481470117,37,488289,556688919,487726,556621009,563,67910,470622,10,584504,43822,34,431,117000.0,39000.0,-67.0,-65.0,-70.0,-67.0,-67.0,-65.0,-70.0,-67.0,-90.0,-92.0,-89.0,-92.0,23.0,27.0,19.0,25.0,0
763,CC:2F:71:3E:C5:1F,3818118,481553993,684,83674,3817434,481470319,0,2923,244838,2423,185394,500,59444,725,8,1015,18,0,32,130000.0,39000.0,-70.0,-71.0,-67.0,-60.0,-70.0,-71.0,-67.0,-60.0,-90.0,-92.0,-89.0,-92.0,20.0,21.0,22.0,32.0,0
764,BA:8C:B9:54:50:24,3819161,482307721,1727,837402,3817434,481470319,0,5545,820136,5525,817014,20,3122,1004,14,2102,29,0,49,216660.0,130000.0,-40.0,-37.0,-45.0,-51.0,-43.0,-36.0,-43.0,-48.0,-90.0,-92.0,-89.0,-92.0,50.0,55.0,44.0,41.0,0
765,92:69:1D:31:68:E9,3820913,484925878,3477,3455357,3817436,481470521,0,3609,930077,3513,908752,96,21325,1793,6,3603,78,0,31,216660.0,130000.0,-51.0,-53.0,-47.0,-48.0,-51.0,-50.0,-45.0,-47.0,-90.0,-93.0,-90.0,-93.0,39.0,40.0,43.0,45.0,0
766,CC:2F:71:3F:1F:24,4401744,1164228353,584308,682757832,3817436,481470521,37,488315,556693863,487752,556625953,563,67910,470648,10,584545,43833,34,431,130000.0,39000.0,-67.0,-65.0,-71.0,-68.0,-67.0,-65.0,-70.0,-67.0,-90.0,-93.0,-90.0,-93.0,23.0,28.0,19.0,25.0,0
767,CC:2F:71:3E:C5:1F,3818120,481554195,684,83674,3817436,481470521,0,2923,244838,2423,185394,500,59444,725,8,1015,18,0,32,130000.0,39000.0,-70.0,-71.0,-67.0,-60.0,-70.0,-71.0,-67.0,-60.0,-90.0,-93.0,-90.0,-93.0,20.0,22.0,23.0,33.0,0
768,BA:8C:B9:54:50:24,3819163,482307923,1727,837402,3817436,481470521,0,5545,820136,5525,817014,20,3122,1004,14,2102,29,0,49,216660.0,130000.0,-40.0,-37.0,-45.0,-51.0,-43.0,-36.0,-43.0,-48.0,-90.0,-93.0,-90.0,-93.0,50.0,56.0,45.0,42.0,0
769,92:69:1D:31:68:E9,3820918,484926342,3477,3455357,3817441,481470985,0,3609,930077,3513,908752,96,21325,1793,6,3603,78,0,31,216660.0,130000.0,-51.0,-53.0,-47.0,-48.0,-51.0,-50.0,-45.0,-47.0,-90.0,-93.0,-90.0,-93.0,39.0,40.0,43.0,45.0,0
770,CC:2F:71:3F:1F:24,4401791,1164243245,584350,682772260,3817441,481470985,37,488340,556698667,487777,556630757,563,67910,470673,10,584587,43867,34,431,144444.0,43333.0,-67.0,-65.0,-71.0,-68.0,-67.0,-65.0,-70.0,-67.0,-90.0,-93.0,-90.0,-93.0,23.0,28.0,19.0,25.0,0
771,CC:2F:71:3E:C5:1F,3818125,481554659,684,83674,3817441,481470985,0,2923,244838,2423,185394,500,59444,725,8,1015,18,0,32,130000.0,39000.0,-70.0,-71.0,-67.0,-60.0,-70.0,-71.0,-67.0,-60.0,-90.0,-93.0,-90.0,-93.0,20.0,22.0,23.0,33.0,0
772,BA:8C:B9:54:50:24,3819168,482308387,1727,837402,3817441,481470985,0,5546,820204,5526,817082,20,3122,1004,14,2102,29,0,49,216660.0,130000.0,-39.0,-37.0,-45.0,-51.0,-42.0,-36.0,-44.0,-49.0,-90.0,-93.0,-90.0,-93.0,51.0,56.0,45.0,42.0,0
773,92:69:1D:31:68:E9,3820922,484926746,3477,3455357,3817445,481471389,0,3609,930077,3513,908752,96,21325,1793,6,3603,78,0,31,216660.0,130000.0,-51.0,-53.0,-47.0,-48.0,-51.0,-50.0,-45.0,-47.0,-90.0,-93.0,-90.0,-93.0,39.0,40.0,43.0,45.0,0
774,CC:2F:71:3F:1F:24,4401837,1164258133,584392,682786744,3817445,481471389,37,488365,556703471,487802,556635561,563,67910,470698,10,584629,43896,34,431,130000.0,43333.0,-67.0,-65.0,-71.0,-67.0,-67.0,-65.0,-70.0,-67.0,-90.0,-93.0,-90.0,-93.0,23.0,28.0,19.0,26.0,0
775,CC:2F:71:3E:C5:1F,3818129,481555063,684,83674,3817445,481471389,0,2923,244838,2423,185394,500,59444,725,8,1015,18,0,32,130000.0,39000.0,-70.0,-71.0,-67.0,-60.0,-70.0,-71.0,-67.0,-60.0,-90.0,-93.0,-90.0,-93.0,20.0,22.0,23.0,33.0,0
776,BA:8C:B9:54:50:24,3819172,482308791,1727,837402,3817445,481471389,0,5546,820204,5526,817082,20,3122,1004,14,2102,29,0,49,216660.0,130000.0,-39.0,-37.0,-45.0,-51.0,-42.0,-36.0,-44.0,-49.0,-90.0,-93.0,-90.0,-93.0,51.0,56.0,45.0,42.0,0
777,92:69:1D:31:68:E9,3820926,484927150,3477,3455357,3817449,481471793,0,3609,930077,3513,908752,96,21325,1793,6,3603,78,0,31,216660.0,130000.0,-51.0,-53.0,-47.0,-48.0,-51.0,-50.0,-45.0,-47.0,-90.0,-93.0,-90.0,-93.0,39.0,40.0,43.0,45.0,0
778,CC:2F:71:3F:1F:24,4401884,1164273201,584435,682801408,3817449,481471793,37,488391,556708415,487828,556640505,563,67910,470724,10,584672,43897,34,431,130000.0,43333.0,-67.0,-65.0,-70.0,-68.0,-67.0,-65.0,-70.0,-67.0,-90.0,-93.0,-90.0,-93.0,23.0,28.0,20.0,25.0,0
779,CC:2F:71:3E:C5:1F,3818133,481555467,684,83674,3817449,481471793,0,2923,244838,2423,185394,500,59444,725,8,1015,18,0,32,130000.0,39000.0,-70.0,-71.0,-67.0,-60.0,-70.0,-71.0,-67.0,-60.0,-90.0,-93.0,-90.0,-93.0,20.0,22.0,23.0,33.0,0
780,BA:8C:B9:54:50:24,3819176,482309195,1727,837402,3817449,481471793,0,5546,820204,5526,817082,20,3122,1004,14,2102,29,0,49,216660.0,130000.0,-39.0,-37.0,-45.0,-51.0,-42.0,-36.0,-44.0,-49.0,-90.0,-93.0,-90.0,-93.0,51.0,56.0,45.0,42.0,0
781,92:69:1D:31:68:E9,3820931,484927614,3477,3455357,3817454,481472257,0,3609,930077,3513,908752,96,21325,1793,6,3603,78,0,31,216660.0,130000.0,-51.0,-53.0,-47.0,-48.0,-51.0,-50.0,-45.0,-47.0,-90.0,-93.0,-90.0,-93.0,39.0,40.0,43.0,45.0,0
782,CC:2F:71:3F:1F:24,4401932,1164288217,584478,682815960,3817454,481472257,37,488417,556713359,487854,556645449,563,67910,470750,10,584715,43918,34,431,117000.0,39000.0,-67.0,-65.0,-71.0,-67.0,-67.0,-65.0,-70.0,-67.0,-90.0,-93.0,-90.0,-93.0,23.0,28.0,19.0,26.0,0
783,CC:2F:71:3E:C5:1F,3818138,481555931,684,83674,3817454,481472257,0,2923,244838,2423,185394,500,59444,725,8,1015,18,0,32,130000.0,39000.0,-70.0,-71.0,-67.0,-60.0,-70.0,-71.0,-67.0,-60.0,-90.0,-93.0,-90.0,-93.0,20.0,22.0,23.0,33.0,0
784,BA:8C:B9:54:50:24,3819181,482309659,1727,837402,3817454,481472257,0,5546,820204,5526,817082,20,3122,1004,14,2102,29,0,49,216660.0,130000.0,-39.0,-37.0,-45.0,-51.0,-42.0,-36.0,-44.0,-49.0,-90.0,-93.0,-90.0,-93.0,51.0,56.0,45.0,42.0,0
785,92:69:1D:31:68:E9,3820935,484928018,3477,3455357,3817458,481472661,0,3609,930077,3513,908752,96,21325,1793,6,3603,78,0,31,216660.0,130000.0,-51.0,-53.0,-47.0,-48.0,-51.0,-50.0,-45.0,-47.0,-90.0,-93.0,-90.0,-93.0,39.0,40.0,43.0,45.0,0
786,CC:2F:71:3F:1F:24,4401977,1164302925,584519,682830264,3817458,481472661,37,488442,556718163,487879,556650253,563,67910,470775,10,584756,43921,34,431,130000.0,43333.0,-67.0,-65.0,-70.0,-67.0,-67.0,-65.0,-70.0,-67.0,-90.0,-93.0,-90.0,-93.0,23.0,28.0,20.0,26.0,0
787,CC:2F:71:3E:C5:1F,3818142,481556335,684,83674,3817458,481472661,0,2923,244838,2423,185394,500,59444,725,8,1015,18,0,32,130000.0,39000.0,-70.0,-71.0,-67.0,-60.0,-70.0,-71.0,-67.0,-60.0,-90.0,-93.0,-90.0,-93.0,20.0,22.0,23.0,33.0,0
788,BA:8C:B9:54:50:24,3819185,482310063,1727,837402,3817458,481472661,0,5546,820204,5526,817082,20,3122,1004,14,2102,29,0,49,216660.0,130000.0,-39.0,-37.0,-45.0,-51.0,-42.0,-36.0,-44.0,-49.0,-90.0,-93.0,-90.0,-93.0,51.0,56.0,45.0,42.0,0
789,92:69:1D:31:68:E9,3820940,484928482,3477,3455357,3817463,481473125,0,3609,930077,3513,908752,96,21325,1793,6,3603,78,0,31,216660.0,130000.0,-51.0,-53.0,-47.0,-48.0,-51.0,-50.0,-45.0,-47.0,-90.0,-93.0,-90.0,-93.0,39.0,40.0,43.0,45.0,0
790,CC:2F:71:3F:1F:24,4402025,1164318053,584562,682844928,3817463,481473125,37,488467,556722967,487904,556655057,563,67910,470800,10,584799,43930,34,431,130000.0,43333.0,-67.0,-65.0,-70.0,-68.0,-67.0,-65.0,-70.0,-67.0,-90.0,-93.0,-90.0,-93.0,23.0,28.0,20.0,25.0,0
791,CC:2F:71:3E:C5:1F,3818147,481556799,684,83674,3817463,481473125,0,2923,244838,2423,185394,500,59444,725,8,1015,18,0,32,130000.0,39000.0,-70.0,-71.0,-67.0,-60.0,-70.0,-71.0,-67.0,-60.0,-91.0,-93.0,-90.0,-93.0,21.0,22.0,23.0,33.0,0
792,BA:8C:B9:54:50:24,3819190,482310527,1727,837402,3817463,481473125,0,5546,820204,5526,817082,20,3122,1004,14,2102,29,0,49,216660.0,130000.0,-39.0,-37.0,-45.0,-51.0,-42.0,-36.0,-44.0,-49.0,-91.0,-93.0,-90.0,-93.0,52.0,56.0,45.0,42.0,0
793,92:69:1D:31:68:E9,3820944,484928886,3477,3455357,3817467,481473529,0,3609,930077,3513,908752,96,21325,1793,6,3603,78,0,31,216660.0,130000.0,-51.0,-53.0,-47.0,-48.0,-51.0,-50.0,-45.0,-47.0,-91.0,-93.0,-90.0,-93.0,40.0,40.0,43.0,45.0,0
794,CC:2F:71:3F:1F:24,4402071,1164332885,584604,682859356,3817467,481473529,37,488493,556727911,487930,556660001,563,67910,470826,10,584841,43951,34,431,117000.0,39000.0,-67.0,-65.0,-70.0,-67.0,-67.0,-65.0,-70.0,-67.0,-91.0,-93.0,-90.0,-93.0,24.0,28.0,20.0,26.0,0
795,CC:2F:71:3E:C5:1F,3818151,481557203,684,83674,3817467,481473529,0,2923,244838,2423,185394,500,59444,725,8,1015,18,0,32,130000.0,39000.0,-70.0,-71.0,-67.0,-60.0,-70.0,-71.0,-67.0,-60.0,-91.0,-93.0,-90.0,-93.0,21.0,22.0,23.0,33.0,0
796,BA:8C:B9:54:50:24,3819194,482310931,1727,837402,3817467,481473529,0,5546,820204,5526,817082,20,3122,1004,14,2102,29,0,49,216660.0,130000.0,-39.0,-37.0,-45.0,-51.0,-42.0,-36.0,-44.0,-49.0,-91.0,-93.0,-90.0,-93.0,52.0,56.0,45.0,42.0,0
797,92:69:1D:31:68:E9,3820948,484929290,3477,3455357,3817471,481473933,0,3609,930077,3513,908752,96,21325,1793,6,3603,78,0,31,216660.0,130000.0,-51.0,-53.0,-47.0,-48.0,-51.0,-50.0,-45.0,-47.0,-91.0,-93.0,-90.0,-93.0,40.0,40.0,43.0,45.0,0
798,CC:2F:71:3F:1F:24,4402119,1164347915,584648,682873982,3817471,481473933,37,488519,556732855,487956,556664945,563,67910,470852,10,584885,43956,34,431,130000.0,39000.0,-67.0,-65.0,-71.0,-67.0,-67.0,-65.0,-70.0,-67.0,-91.0,-93.0,-90.0,-93.0,24.0,28.0,19.0,26.0,0
799,CC:2F:71:3E:C5:1F,3818155,481557607,684,83674,3817471,481473933,0,2923,244838,2423,185394,500,59444,725,8,1015,18,0,32,130000.0,39000.0,-70.0,-71.0,-67.0,-60.0,-70.0,-71.0,-67.0,-60.0,-91.0,-93.0,-90.0,-93.0,21.0,22.0,23.0,33.0,0
800,BA:8C:B9:54:50:24,3819198,482311335,1727,837402,3817471,481473933,0,5546,820204,5526,817082,20,3122,1004,14,2102,29,0,49,216660.0,130000.0,-39.0,-37.0,-45.0,-51.0,-42.0,-36.0,-44.0,-49.0,-91.0,-93.0,-90.0,-93.0,52.0,56.0,45.0,42.0,0
801,92:69:1D:31:68:E9,3820953,484929754,3477,3455357,3817476,481474397,0,3609,930077,3513,908752,96,21325,1793,6,3603,78,0,31,216660.0,130000.0,-51.0,-53.0,-47.0,-48.0,-51.0,-50.0,-45.0,-47.0,-91.0,-93.0,-90.0,-93.0,40.0,40.0,43.0,45.0,0
802,CC:2F:71:3F:1F:24,4402167,1164362931,584691,682888534,3817476,481474397,37,488545,556737799,487982,556669889,563,67910,470878,10,584928,43978,34,431,130000.0,39000.0,-67.0,-65.0,-70.0,-68.0,-67.0,-65.0,-70.0,-67.0,-91.0,-93.0,-90.0,-93.0,24.0,28.0,20.0,25.0,0
803,CC:2F:71:3E:C5:1F,3818160,481558071,684,83674,3817476,481474397,0,2923,244838,2423,185394,500,59444,725,8,1015,18,0,32,130000.0,39000.0,-70.0,-71.0,-67.0,-60.0,-70.0,-71.0,-67.0,-60.0,-91.0,-93.0,-90.0,-93.0,21.0,22.0,23.0,33.0,0
804,BA:8C:B9:54:50:24,3819203,482311799,1727,837402,3817476,481474397,0,5546,820204,5526,817082,20,3122,1004,14,2102,29,0,49,216660.0,130000.0,-39.0,-37.0,-45.0,-51.0,-42.0,-36.0,-44.0,-49.0,-91.0,-93.0,-90.0,-93.0,52.0,56.0,45.0,42.0,0
805,92:69:1D:31:68:E9,3820957,484930158,3477,3455357,3817480,481474801,0,3609,930077,3513,908752,96,21325,1793,6,3603,78,0,31,216660.0,130000.0,-51.0,-53.0,-47.0,-48.0,-51.0,-50.0,-45.0,-47.0,-91.0,-93.0,-90.0,-93.0,40.0,40.0,43.0,45.0,0
806,CC:2F:71:3F:1F:24,4402212,1164377639,584732,682902838,3817480,481474801,37,488570,556742603,488007,556674693,563,67910,470903,10,584969,43986,34,431,130000.0,39000.0,-67.0,-65.0,-71.0,-67.0,-67.0,-65.0,-70.0,-67.0,-91.0,-93.0,-90.0,-93.0,24.0,28.0,19.0,26.0,0
807,CC:2F:71:3E:C5:1F,3818164,481558475,684,83674,3817480,481474801,0,2923,244838,2423,185394,500,59444,725,8,1015,18,0,32,130000.0,39000.0,-70.0,-71.0,-67.0,-60.0,-70.0,-71.0,-67.0,-60.0,-91.0,-93.0,-90.0,-93.0,21.0,22.0,23.0,33.0,0
808,BA:8C:B9:54:50:24,3819207,482312203,1727,837402,3817480,481474801,0,5546,820204,5526,817082,20,3122,1004,14,2102,29,0,49,216660.0,130000.0,-39.0,-37.0,-45.0,-51.0,-42.0,-36.0,-44.0,-49.0,-91.0,-93.0,-90.0,-93.0,52.0,56.0,45.0,42.0,0
809,92:69:1D:31:68:E9,3820961,484930562,3477,3455357,3817484,481475205,0,3609,930077,3513,908752,96,21325,1793,6,3603,78,0,31,216660.0,130000.0,-51.0,-53.0,-47.0,-48.0,-51.0,-50.0,-45.0,-47.0,-91.0,-93.0,-90.0,-93.0,40.0,40.0,43.0,45.0,0
810,CC:2F:71:3F:1F:24,4402258,1164392477,584774,682917272,3817484,481475205,37,488596,556747547,488033,556679637,563,67910,470929,10,585011,44009,34,431,130000.0,39000.0,-67.0,-65.0,-70.0,-68.0,-67.0,-65.0,-70.0,-67.0,-91.0,-93.0,-90.0,-93.0,24.0,28.0,20.0,25.0,0
811,CC:2F:71:3E:C5:1F,3818169,481558939,684,83674,3817485,481475265,0,2923,244838,2423,185394,500,59444,725,8,1015,18,0,32,130000.0,39000.0,-70.0,-71.0,-67.0,-60.0,-70.0,-71.0,-67.0,-60.0,-91.0,-93.0,-90.0,-93.0,21.0,22.0,23.0,33.0,0
812,BA:8C:B9:54:50:24,3819212,482312667,1727,837402,3817485,481475265,0,5546,820204,5526,817082,20,3122,1004,14,2102,29,0,49,216660.0,130000.0,-39.0,-37.0,-45.0,-51.0,-42.0,-36.0,-44.0,-49.0,-91.0,-93.0,-90.0,-93.0,52.0,56.0,45.0,42.0,0
813,92:69:1D:31:68:E9,3820966,484931026,3477,3455357,3817489,481475669,0,3609,930077,3513,908752,96,21325,1793,6,3603,78,0,31,216660.0,130000.0,-51.0,-53.0,-47.0,-48.0,-51.0,-50.0,-45.0,-47.0,-91.0,-93.0,-90.0,-93.0,40.0,40.0,43.0,45.0,0
814,CC:2F:71:3F:1F:24,4402306,1164407541,584817,682931872,3817489,481475669,37,488621,556752351,488058,556684441,563,67910,470954,10,585054,44019,34,431,130000.0,43333.0,-67.0,-65.0,-70.0,-67.0,-67.0,-65.0,-70.0,-67.0,-91.0,-93.0,-90.0,-93.0,24.0,28.0,20.0,26.0,0
815,CC:2F:71:3E:C5:1F,3818175,481559732,685,83790,3817490,481475942,0,2925,244978,2425,185534,500,59444,725,8,1016,18,0,32,130000.0,39000.0,-70.0,-71.0,-67.0,-60.0,-70.0,-71.0,-67.0,-60.0,-91.0,-93.0,-90.0,-93.0,21.0,22.0,23.0,33.0,0
816,BA:8C:B9:54:50:24,3819218,482313460,1728,837518,3817490,481475942,0,5550,820476,5530,817354,20,3122,1004,14,2103,29,0,49,216660.0,130000.0,-49.0,-35.0,-42.0,-44.0,-43.0,-35.0,-42.0,-46.0,-91.0,-93.0,-90.0,-93.0,42.0,58.0,48.0,49.0,0
817,92:69:1D:31:68:E9,3820972,484931819,3478,3455473,3817494,481476346,0,3611,930213,3515,908888,96,21325,1793,6,3604,78,0,31,216660.0,130000.0,-50.0,-48.0,-43.0,-49.0,-51.0,-50.0,-44.0,-47.0,-91.0,-93.0,-90.0,-93.0,41.0,45.0,47.0,44.0,0
818,CC:2F:71:3F:1F:24,4402354,1164422770,584860,682946424,3817494,481476346,37,488646,556757155,488083,556689245,563,67910,470979,10,585097,44041,34,431,117000.0,39000.0,-67.0,-65.0,-70.0,-68.0,-67.0,-65.0,-70.0,-67.0,-91.0,-93.0,-90.0,-93.0,24.0,28.0,20.0,25.0,0
819,CC:2F:71:3E:C5:1F,3818179,481560136,685,83790,3817494,481476346,0,2925,244978,2425,185534,500,59444,725,8,1016,18,0,32,130000.0,39000.0,-70.0,-71.0,-67.0,-60.0,-70.0,-71.0,-67.0,-60.0,-91.0,-93.0,-90.0,-93.0,21.0,22.0,23.0,33.0,0
820,BA:8C:B9:54:50:24,3819222,482313864,1728,837518,3817494,481476346,0,5550,820476,5530,817354,20,3122,1004,14,2103,29,0,49,216660.0,130000.0,-49.0,-35.0,-42.0,-44.0,-43.0,-35.0,-42.0,-46.0,-91.0,-93.0,-90.0,-93.0,42.0,58.0,48.0,49.0,0
821,92:69:1D:31:68:E9,3820978,484932345,3478,3455473,3817500,481476872,0,3611,930213,3515,908888,96,21325,1793,6,3604,78,0,31,216660.0,130000.0,-50.0,-48.0,-43.0,-49.0,-51.0,-50.0,-44.0,-47.0,-91.0,-93.0,-90.0,-93.0,41.0,45.0,47.0,44.0,0
822,CC:2F:71:3F:1F:24,4402402,1164437724,584902,682960852,3817500,481476872,37,488672,556762135,488109,556694225,563,67910,471005,10,585139,44044,34,431,130000.0,43333.0,-67.0,-65.0,-70.0,-67.0,-67.0,-65.0,-70.0,-67.0,-90.0,-93.0,-90.0,-93.0,23.0,28.0,20.0,26.0,0
823,CC:2F:71:3E:C5:1F,3818185,481560662,685,83790,3817500,481476872,0,2927,245166,2426,185604,501,59562,726,8,1016,18,0,32,130000.0,39000.0,-70.0,-71.0,-67.0,-60.0,-70.0,-71.0,-67.0,-60.0,-90.0,-93.0,-90.0,-93.0,20.0,22.0,23.0,33.0,0
824,BA:8C:B9:54:50:24,3819228,482314390,1728,837518,3817500,481476872,0,5550,820476,5530,817354,20,3122,1004,14,2103,29,0,49,216660.0,130000.0,-49.0,-35.0,-42.0,-44.0,-43.0,-35.0,-42.0,-46.0,-90.0,-93.0,-90.0,-93.0,41.0,58.0,48.0,49.0,0
825,92:69:1D:31:68:E9,3820982,484932749,3478,3455473,3817504,481477276,0,3611,930213,3515,908888,96,21325,1793,6,3604,78,0,31,216660.0,130000.0,-50.0,-48.0,-43.0,-49.0,-51.0,-50.0,-44.0,-47.0,-90.0,-93.0,-90.0,-93.0,40.0,45.0,47.0,44.0,0
826,CC:2F:71:3F:1F:24,4402449,1164452792,584945,682975516,3817504,481477276,37,488699,556767219,488136,556699309,563,67910,471032,10,585182,44051,34,431,130000.0,43333.0,-67.0,-65.0,-71.0,-67.0,-67.0,-65.0,-70.0,-67.0,-90.0,-93.0,-90.0,-93.0,23.0,28.0,19.0,26.0,0
827,CC:2F:71:3E:C5:1F,3818189,481561066,685,83790,3817504,481477276,0,2927,245166,2426,185604,501,59562,726,8,1016,18,0,32,130000.0,39000.0,-70.0,-71.0,-67.0,-60.0,-70.0,-71.0,-67.0,-60.0,-90.0,-93.0,-90.0,-93.0,20.0,22.0,23.0,33.0,0
828,BA:8C:B9:54:50:24,3819232,482314794,1728,837518,3817504,481477276,0,5550,820476,5530,817354,20,3122,1004,14,2103,29,0,49,216660.0,130000.0,-49.0,-35.0,-42.0,-44.0,-43.0,-35.0,-42.0,-46.0,-90.0,-93.0,-90.0,-93.0,41.0,58.0,48.0,49.0,0
829,92:69:1D:31:68:E9,3820986,484933153,3478,3455473,3817508,481477680,0,3611,930213,3515,908888,96,21325,1793,6,3604,78,0,31,216660.0,130000.0,-50.0,-48.0,-43.0,-49.0,-51.0,-50.0,-44.0,-47.0,-90.0,-93.0,-89.0,-93.0,40.0,45.0,46.0,44.0,0
830,CC:2F:71:3F:1F:24,4402495,1164467686,584987,682990006,3817508,481477680,37,488725,556772163,488162,556704253,563,67910,471058,10,585224,44073,34,431,130000.0,39000.0,-67.0,-65.0,-70.0,-67.0,-67.0,-65.0,-70.0,-67.0,-90.0,-93.0,-89.0,-93.0,23.0,28.0,19.0,26.0,0
831,CC:2F:71:3E:C5:1F,3818193,481561470,685,83790,3817508,481477680,0,2927,245166,2426,185604,501,59562,726,8,1016,18,0,32,130000.0,39000.0,-70.0,-71.0,-67.0,-60.0,-70.0,-71.0,-67.0,-60.0,-90.0,-93.0,-89.0,-93.0,20.0,22.0,22.0,33.0,0
832,BA:8C:B9:54:50:24,3819236,482315198,1728,837518,3817508,481477680,0,5550,820476,5530,817354,20,3122,1004,14,2103,29,0,49,216660.0,130000.0,-49.0,-35.0,-42.0,-44.0,-43.0,-35.0,-42.0,-46.0,-90.0,-93.0,-89.0,-93.0,41.0,58.0,47.0,49.0,0
833,92:69:1D:31:68:E9,3820991,484933617,3478,3455473,3817513,481478144,0,3611,930213,3515,908888,96,21325,1793,6,3604,78,0,31,216660.0,130000.0,-50.0,-48.0,-43.0,-49.0,-51.0,-50.0,-44.0,-47.0,-90.0,-93.0,-89.0,-93.0,40.0,45.0,46.0,44.0,0
834,CC:2F:71:3F:1F:24,4402542,1164482578,585029,683004434,3817513,481478144,37,488751,556777107,488188,556709197,563,67910,471084,10,585266,44088,34,431,130000.0,43333.0,-67.0,-65.0,-70.0,-67.0,-67.0,-65.0,-70.0,-67.0,-90.0,-93.0,-89.0,-93.0,23.0,28.0,19.0,26.0,0
835,CC:2F:71:3E:C5:1F,3818198,481561934,685,83790,3817513,481478144,0,2927,245166,2426,185604,501,59562,726,8,1016,18,0,32,130000.0,39000.0,-70.0,-71.0,-67.0,-60.0,-70.0,-71.0,-67.0,-60.0,-90.0,-93.0,-89.0,-93.0,20.0,22.0,22.0,33.0,0
836,BA:8C:B9:54:50:24,3819241,482315662,1728,837518,3817513,481478144,0,5550,820476,5530,817354,20,3122,1004,14,2103,29,0,49,216660.0,130000.0,-49.0,-35.0,-42.0,-44.0,-43.0,-35.0,-42.0,-46.0,-90.0,-93.0,-89.0,-93.0,41.0,58.0,47.0,49.0,0
837,92:69:1D:31:68:E9,3820995,484934021,3478,3455473,3817517,481478548,0,3611,930213,3515,908888,96,21325,1793,6,3604,78,0,31,216660.0,130000.0,-50.0,-48.0,-43.0,-49.0,-51.0,-50.0,-44.0,-47.0,-90.0,-93.0,-89.0,-93.0,40.0,45.0,46.0,44.0,0
838,CC:2F:71:3F:1F:24,4402589,1164497534,585072,683018986,3817517,481478548,37,488776,556781911,488213,556714001,563,67910,471109,10,585309,44099,34,431,130000.0,39000.0,-67.0,-65.0,-70.0,-68.0,-67.0,-65.0,-70.0,-67.0,-90.0,-93.0,-89.0,-93.0,23.0,28.0,19.0,25.0,0
839,CC:2F:71:3E:C5:1F,3818202,481562338,685,83790,3817517,481478548,0,2927,245166,2426,185604,501,59562,726,8,1016,18,0,32,130000.0,39000.0,-70.0,-71.0,-67.0,-60.0,-70.0,-71.0,-67.0,-60.0,-90.0,-93.0,-89.0,-93.0,20.0,22.0,22.0,33.0,0
840,BA:8C:B9:54:50:24,3819245,482316066,1728,837518,3817517,481478548,0,5554,820748,5534,817626,20,3122,1004,14,2103,29,0,49,216660.0,130000.0,-39.0,-37.0,-44.0,-51.0,-43.0,-35.0,-42.0,-46.0,-90.0,-93.0,-89.0,-93.0,51.0,56.0,45.0,42.0,0
841,92:69:1D:31:68:E9,3820999,484934425,3478,3455473,3817521,481478952,0,3611,930213,3515,908888,96,21325,1793,6,3604,78,0,31,216660.0,130000.0,-50.0,-48.0,-43.0,-49.0,-51.0,-50.0,-44.0,-47.0,-90.0,-93.0,-89.0,-93.0,40.0,45.0,46.0,44.0,0
842,CC:2F:71:3F:1F:24,4402634,1164512116,585112,683033104,3817522,481479012,37,488802,556786855,488239,556718945,563,67910,471135,10,585349,44111,34,431,130000.0,43333.0,-67.0,-65.0,-70.0,-67.0,-67.0,-65.0,-70.0,-67.0,-90.0,-93.0,-89.0,-93.0,23.0,28.0,19.0,26.0,0
843,CC:2F:71:3E:C5:1F,3818207,481562802,685,83790,3817522,481479012,0,2927,245166,2426,185604,501,59562,726,8,1016,18,0,32,130000.0,39000.0,-70.0,-71.0,-67.0,-60.0,-70.0,-71.0,-67.0,-60.0,-90.0,-93.0,-89.0,-93.0,20.0,22.0,22.0,33.0,0
844,BA:8C:B9:54:50:24,3819250,482316530,1728,837518,3817522,481479012,0,5554,820748,5534,817626,20,3122,1004,14,2103,29,0,49,216660.0,130000.0,-39.0,-37.0,-44.0,-51.0,-43.0,-35.0,-42.0,-46.0,-90.0,-93.0,-89.0,-93.0,51.0,56.0,45.0,42.0,0
845,92:69:1D:31:68:E9,3821004,484934889,3478,3455473,3817526,481479416,0,3611,930213,3515,908888,96,21325,1793,6,3604,78,0,31,216660.0,130000.0,-50.0,-48.0,-43.0,-49.0,-51.0,-50.0,-44.0,-47.0,-90.0,-93.0,-89.0,-93.0,40.0,45.0,46.0,44.0,0
846,CC:2F:71:3F:1F:24,4402683,1164527398,585157,683047982,3817526,481479416,37,488829,556791951,488266,556724041,563,67910,471162,10,585394,44130,34,431,130000.0,39000.0,-67.0,-65.0,-71.0,-68.0,-67.0,-65.0,-70.0,-67.0,-90.0,-93.0,-89.0,-93.0,23.0,28.0,18.0,25.0,0
847,CC:2F:71:3E:C5:1F,3818211,481563206,685,83790,3817526,481479416,0,2927,245166,2426,185604,501,59562,726,8,1016,18,0,32,130000.0,39000.0,-70.0,-71.0,-67.0,-60.0,-70.0,-71.0,-67.0,-60.0,-90.0,-93.0,-89.0,-93.0,20.0,22.0,22.0,33.0,0
848,BA:8C:B9:54:50:24,3819254,482316934,1728,837518,3817526,481479416,0,5554,820748,5534,817626,20,3122,1004,14,2103,29,0,49,216660.0,130000.0,-39.0,-37.0,-44.0,-51.0,-43.0,-35.0,-42.0,-46.0,-90.0,-93.0,-89.0,-93.0,51.0,56.0,45.0,42.0,0
849,92:69:1D:31:68:E9,3821008,484935293,3478,3455473,3817530,481479820,0,3611,930213,3515,908888,96,21325,1793,6,3604,78,0,31,216660.0,130000.0,-50.0,-48.0,-43.0,-49.0,-51.0,-50.0,-44.0,-47.0,-90.0,-93.0,-89.0,-93.0,40.0,45.0,46.0,44.0,0
850,CC:2F:71:3F:1F:24,4402727,1164542032,585197,683062212,3817530,481479820,37,488855,556796895,488292,556728985,563,67910,471188,10,585434,44132,34,431,130000.0,43333.0,-67.0,-65.0,-70.0,-68.0,-67.0,-65.0,-70.0,-67.0,-90.0,-93.0,-89.0,-93.0,23.0,28.0,19.0,25.0,0
851,CC:2F:71:3E:C5:1F,3818215,481563610,685,83790,3817530,481479820,0,2927,245166,2426,185604,501,59562,726,8,1016,18,0,32,130000.0,39000.0,-70.0,-71.0,-67.0,-60.0,-70.0,-71.0,-67.0,-60.0,-90.0,-93.0,-89.0,-93.0,20.0,22.0,22.0,33.0,0
852,BA:8C:B9:54:50:24,3819258,482317338,1728,837518,3817530,481479820,0,5554,820748,5534,817626,20,3122,1004,14,2103,29,0,49,216660.0,130000.0,-39.0,-37.0,-44.0,-51.0,-43.0,-35.0,-42.0,-46.0,-90.0,-93.0,-89.0,-93.0,51.0,56.0,45.0,42.0,0
853,92:69:1D:31:68:E9,3821013,484935757,3478,3455473,3817535,481480284,0,3612,930281,3516,908956,96,21325,1793,6,3604,78,0,31,216660.0,130000.0,-52.0,-50.0,-44.0,-46.0,-51.0,-50.0,-44.0,-47.0,-90.0,-93.0,-89.0,-93.0,38.0,43.0,45.0,47.0,0
854,CC:2F:71:3F:1F:24,4402772,1164556670,585237,683076386,3817535,481480284,37,488881,556801839,488318,556733929,563,67910,471214,10,585474,44147,34,431,117000.0,39000.0,-67.0,-65.0,-70.0,-67.0,-67.0,-65.0,-70.0,-67.0,-90.0,-93.0,-89.0,-93.0,23.0,28.0,19.0,26.0,0
855,CC:2F:71:3E:C5:1F,3818220,481564074,685,83790,3817535,481480284,0,2927,245166,2426,185604,501,59562,726,8,1016,18,0,32,130000.0,39000.0,-70.0,-71.0,-67.0,-60.0,-70.0,-71.0,-67.0,-60.0,-90.0,-93.0,-89.0,-93.0,20.0,22.0,22.0,33.0,0
856,BA:8C:B9:54:50:24,3819263,482317802,1728,837518,3817535,481480284,0,5554,820748,5534,817626,20,3122,1004,14,2103,29,0,49,216660.0,130000.0,-39.0,-37.0,-44.0,-51.0,-43.0,-35.0,-42.0,-46.0,-90.0,-93.0,-89.0,-93.0,51.0,56.0,45.0,42.0,0
857,92:69:1D:31:68:E9,3821017,484936161,3478,3455473,3817539,481480688,0,3612,930281,3516,908956,96,21325,1793,6,3604,78,0,31,216660.0,130000.0,-52.0,-50.0,-44.0,-46.0,-51.0,-50.0,-44.0,-47.0,-90.0,-93.0,-89.0,-93.0,38.0,43.0,45.0,47.0,0
858,CC:2F:71:3F:1F:24,4402818,1164571446,585279,683090758,3817539,481480688,37,488906,556806643,488343,556738733,563,67910,471239,10,585516,44152,34,431,130000.0,39000.0,-67.0,-65.0,-71.0,-68.0,-67.0,-65.0,-70.0,-67.0,-90.0,-93.0,-89.0,-93.0,23.0,28.0,18.0,25.0,0
859,CC:2F:71:3E:C5:1F,3818224,481564478,685,83790,3817539,481480688,0,2927,245166,2426,185604,501,59562,726,8,1016,18,0,32,130000.0,39000.0,-70.0,-71.0,-67.0,-60.0,-70.0,-71.0,-67.0,-60.0,-90.0,-93.0,-89.0,-93.0,20.0,22.0,22.0,33.0,0
860,BA:8C:B9:54:50:24,3819267,482318206,1728,837518,3817539,481480688,0,5554,820748,5534,817626,20,3122,1004,14,2103,29,0,49,216660.0,130000.0,-39.0,-37.0,-44.0,-51.0,-43.0,-35.0,-42.0,-46.0,-90.0,-93.0,-89.0,-93.0,51.0,56.0,45.0,42.0,0
861,92:69:1D:31:68:E9,3821021,484936565,3478,3455473,3817543,481481092,0,3612,930281,3516,908956,96,21325,1793,6,3604,78,0,31,216660.0,130000.0,-52.0,-50.0,-44.0,-46.0,-51.0,-50.0,-44.0,-47.0,-90.0,-93.0,-89.0,-93.0,38.0,43.0,45.0,47.0,0
862,CC:2F:71:3F:1F:24,4402863,1164586148,585320,683105056,3817543,481481092,37,488933,556811703,488370,556743793,563,67910,471266,10,585557,44165,34,431,130000.0,43333.0,-67.0,-65.0,-70.0,-68.0,-67.0,-65.0,-70.0,-67.0,-90.0,-93.0,-89.0,-93.0,23.0,28.0,19.0,25.0,0
863,CC:2F:71:3E:C5:1F,3818228,481564882,685,83790,3817543,481481092,0,2927,245166,2426,185604,501,59562,726,8,1016,18,0,32,130000.0,39000.0,-70.0,-71.0,-67.0,-60.0,-70.0,-71.0,-67.0,-60.0,-90.0,-93.0,-89.0,-93.0,20.0,22.0,22.0,33.0,0
864,BA:8C:B9:54:50:24,3819271,482318610,1728,837518,3817543,481481092,0,5554,820748,5534,817626,20,3122,1004,14,2103,29,0,49,216660.0,130000.0,-39.0,-37.0,-44.0,-51.0,-43.0,-35.0,-42.0,-46.0,-90.0,-93.0,-89.0,-93.0,51.0,56.0,45.0,42.0,0
865,92:69:1D:31:68:E9,3821050,484948114,3478,3455473,3817572,481492641,0,3615,930652,3518,909092,97,21560,1794,6,3604,78,0,31,216660.0,130000.0,-51.0,-47.0,-42.0,-49.0,-51.0,-50.0,-44.0,-48.0,-90.0,-93.0,-89.0,-93.0,39.0,46.0,47.0,44.0,0
866,CC:2F:71:3F:1F:24,4402935,1164612351,585363,683119710,3817572,481492641,37,488962,556816997,488398,556748969,564,68028,471295,10,585600,44188,34,431,117000.0,39000.0,-67.0,-65.0,-70.0,-67.0,-67.0,-65.0,-70.0,-67.0,-90.0,-93.0,-89.0,-93.0,23.0,28.0,19.0,26.0,0
867,CC:2F:71:3E:C5:1F,3818257,481576431,685,83790,3817572,481492641,0,2927,245166,2426,185604,501,59562,726,8,1016,18,0,32,130000.0,39000.0,-70.0,-71.0,-67.0,-60.0,-70.0,-71.0,-67.0,-60.0,-90.0,-93.0,-89.0,-93.0,20.0,22.0,22.0,33.0,0
868,BA:8C:B9:54:50:24,3819301,482330432,1728,837518,3817573,481492914,0,5554,820748,5534,817626,20,3122,1004,14,2103,29,0,49,216660.0,130000.0,-39.0,-37.0,-44.0,-51.0,-43.0,-35.0,-42.0,-46.0,-90.0,-93.0,-89.0,-93.0,51.0,56.0,45.0,42.0,0
869,92:69:1D:31:68:E9,3821055,484948791,3478,3455473,3817577,481493318,0,3615,930652,3518,909092,97,21560,1794,6,3604,78,0,31,216660.0,130000.0,-51.0,-47.0,-42.0,-49.0,-51.0,-50.0,-44.0,-48.0,-90.0,-93.0,-89.0,-93.0,39.0,46.0,47.0,44.0,0
870,CC:2F:71:3F:1F:24,4402980,1164627208,585403,683133890,3817577,481493318,37,488987,556821801,488423,556753773,564,68028,471320,10,585640,44191,34,431,130000.0,43333.0,-67.0,-65.0,-70.0,-67.0,-67.0,-65.0,-70.0,-67.0,-90.0,-93.0,-89.0,-93.0,23.0,28.0,19.0,26.0,0
871,CC:2F:71:3E:C5:1F,3818262,481577108,685,83790,3817577,481493318,0,2927,245166,2426,185604,501,59562,726,8,1016,18,0,32,130000.0,39000.0,-70.0,-71.0,-67.0,-60.0,-70.0,-71.0,-67.0,-60.0,-90.0,-93.0,-89.0,-93.0,20.0,22.0,22.0,33.0,0
872,BA:8C:B9:54:50:24,3819305,482330836,1728,837518,3817577,481493318,0,5554,820748,5534,817626,20,3122,1004,14,2103,29,0,49,216660.0,130000.0,-39.0,-37.0,-44.0,-51.0,-43.0,-35.0,-42.0,-46.0,-90.0,-93.0,-89.0,-93.0,51.0,56.0,45.0,42.0,0
873,92:69:1D:31:68:E9,3821060,484949255,3478,3455473,3817582,481493782,0,3615,930652,3518,909092,97,21560,1794,6,3604,78,0,31,216660.0,130000.0,-51.0,-47.0,-42.0,-49.0,-51.0,-50.0,-44.0,-48.0,-90.0,-93.0,-89.0,-93.0,39.0,46.0,47.0,44.0,0
874,CC:2F:71:3F:1F:24,4403028,1164642342,585446,683148560,3817582,481493782,37,489015,556827001,488451,556758973,564,68028,471348,10,585683,44202,34,431,130000.0,43333.0,-67.0,-65.0,-70.0,-68.0,-67.0,-65.0,-70.0,-67.0,-90.0,-93.0,-89.0,-93.0,23.0,28.0,19.0,25.0,0
875,CC:2F:71:3E:C5:1F,3818267,481577572,685,83790,3817582,481493782,0,2927,245166,2426,185604,501,59562,726,8,1016,18,0,32,130000.0,39000.0,-70.0,-71.0,-67.0,-60.0,-70.0,-71.0,-67.0,-60.0,-90.0,-93.0,-89.0,-93.0,20.0,22.0,22.0,33.0,0
876,BA:8C:B9:54:50:24,3819310,482331300,1728,837518,3817582,481493782,0,5554,820748,5534,817626,20,3122,1004,14,2103,29,0,49,216660.0,130000.0,-39.0,-37.0,-44.0,-51.0,-43.0,-35.0,-42.0,-46.0,-90.0,-93.0,-89.0,-93.0,51.0,56.0,45.0,42.0,0
877,92:69:1D:31:68:E9,3821064,484949659,3478,3455473,3817586,481494186,0,3615,930652,3518,909092,97,21560,1794,6,3604,78,0,31,216660.0,130000.0,-51.0,-47.0,-42.0,-49.0,-51.0,-50.0,-44.0,-48.0,-90.0,-93.0,-89.0,-93.0,39.0,46.0,47.0,44.0,0
878,CC:2F:71:3F:1F:24,4403076,1164657372,585490,683163186,3817586,481494186,37,489041,556831945,488477,556763917,564,68028,471374,10,585727,44230,34,431,130000.0,39000.0,-67.0,-65.0,-70.0,-67.0,-67.0,-65.0,-70.0,-67.0,-90.0,-93.0,-89.0,-93.0,23.0,28.0,19.0,26.0,0
879,CC:2F:71:3E:C5:1F,3818271,481577976,685,83790,3817586,481494186,0,2927,245166,2426,185604,501,59562,726,8,1016,18,0,32,130000.0,39000.0,-70.0,-71.0,-67.0,-60.0,-70.0,-71.0,-67.0,-60.0,-90.0,-93.0,-89.0,-93.0,20.0,22.0,22.0,33.0,0
880,BA:8C:B9:54:50:24,3819314,482331704,1728,837518,3817586,481494186,0,5554,820748,5534,817626,20,3122,1004,14,2103,29,0,49,216660.0,130000.0,-39.0,-37.0,-44.0,-51.0,-43.0,-35.0,-42.0,-46.0,-90.0,-93.0,-89.0,-93.0,51.0,56.0,45.0,42.0,0
881,92:69:1D:31:68:E9,3821070,484950431,3478,3455473,3817592,481494958,0,3615,930652,3518,909092,97,21560,1794,6,3604,78,0,31,216660.0,130000.0,-51.0,-47.0,-42.0,-49.0,-51.0,-50.0,-44.0,-48.0,-90.0,-93.0,-89.0,-93.0,39.0,46.0,47.0,44.0,0
882,CC:2F:71:3F:1F:24,4403124,1164672628,585532,683177670,3817592,481494958,37,489066,556836749,488502,556768721,564,68028,471399,10,585769,44234,34,431,130000.0,43333.0,-67.0,-65.0,-70.0,-67.0,-67.0,-65.0,-70.0,-67.0,-90.0,-93.0,-89.0,-93.0,23.0,28.0,19.0,26.0,0
883,CC:2F:71:3E:C5:1F,3818277,481578748,685,83790,3817592,481494958,0,2927,245166,2426,185604,501,59562,726,8,1016,18,0,32,130000.0,39000.0,-70.0,-71.0,-67.0,-60.0,-70.0,-71.0,-67.0,-60.0,-90.0,-93.0,-89.0,-93.0,20.0,22.0,22.0,33.0,0
884,BA:8C:B9:54:50:24,3819320,482332476,1728,837518,3817592,481494958,0,5554,820748,5534,817626,20,3122,1004,14,2103,29,0,49,216660.0,130000.0,-39.0,-37.0,-44.0,-51.0,-43.0,-35.0,-42.0,-46.0,-90.0,-93.0,-89.0,-93.0,51.0,56.0,45.0,42.0,0
885,92:69:1D:31:68:E9,3821075,484950895,3478,3455473,3817597,481495422,0,3615,930652,3518,909092,97,21560,1794,6,3604,78,0,31,216660.0,130000.0,-51.0,-47.0,-42.0,-49.0,-51.0,-50.0,-44.0,-48.0,-90.0,-93.0,-89.0,-93.0,39.0,46.0,47.0,44.0,0
886,CC:2F:71:3F:1F:24,4403171,1164687526,585574,683192104,3817597,481495422,37,489092,556841693,488528,556773665,564,68028,471425,10,585811,44254,34,431,117000.0,39000.0,-67.0,-65.0,-70.0,-67.0,-67.0,-65.0,-70.0,-67.0,-90.0,-93.0,-89.0,-93.0,23.0,28.0,19.0,26.0,0
887,CC:2F:71:3E:C5:1F,3818282,481579212,685,83790,3817597,481495422,0,2927,245166,2426,185604,501,59562,726,8,1016,18,0,32,130000.0,39000.0,-70.0,-71.0,-67.0,-60.0,-70.0,-71.0,-67.0,-60.0,-90.0,-93.0,-89.0,-93.0,20.0,22.0,22.0,33.0,0
888,BA:8C:B9:54:50:24,3819325,482332940,1728,837518,3817597,481495422,0,5554,820748,5534,817626,20,3122,1004,14,2103,29,0,49,216660.0,130000.0,-39.0,-37.0,-44.0,-51.0,-43.0,-35.0,-42.0,-46.0,-90.0,-93.0,-89.0,-93.0,51.0,56.0,45.0,42.0,0
889,92:69:1D:31:68:E9,3821079,484951299,3478,3455473,3817601,481495826,0,3615,930652,3518,909092,97,21560,1794,6,3604,78,0,31,216660.0,130000.0,-51.0,-47.0,-42.0,-49.0,-51.0,-50.0,-44.0,-48.0,-90.0,-93.0,-89.0,-93.0,39.0,46.0,47.0,44.0,0
890,CC:2F:71:3F:1F:24,4403217,1164702358,585616,683206532,3817601,481495826,37,489120,556846893,488556,556778865,564,68028,471453,10,585853,44260,34,431,130000.0,43333.0,-67.0,-65.0,-70.0,-68.0,-67.0,-65.0,-70.0,-67.0,-90.0,-93.0,-89.0,-93.0,23.0,28.0,19.0,25.0,0
891,CC:2F:71:3E:C5:1F,3818286,481579616,685,83790,3817601,481495826,0,2927,245166,2426,185604,501,59562,726,8,1016,18,0,32,130000.0,39000.0,-70.0,-71.0,-67.0,-60.0,-70.0,-71.0,-67.0,-60.0,-90.0,-93.0,-89.0,-93.0,20.0,22.0,22.0,33.0,0
892,BA:8C:B9:54:50:24,3819329,482333344,1728,837518,3817601,481495826,0,5555,820816,5535,817694,20,3122,1004,14,2103,29,0,49,216660.0,130000.0,-49.0,-35.0,-42.0,-44.0,-43.0,-35.0,-42.0,-46.0,-90.0,-93.0,-89.0,-93.0,41.0,58.0,47.0,49.0,0
893,92:69:1D:31:68:E9,3821083,484951703,3478,3455473,3817605,481496230,0,3615,930652,3518,909092,97,21560,1794,6,3604,78,0,31,216660.0,130000.0,-51.0,-47.0,-42.0,-49.0,-51.0,-50.0,-44.0,-48.0,-90.0,-93.0,-89.0,-93.0,39.0,46.0,47.0,44.0,0
894,CC:2F:71:3F:1F:24,4403264,1164717320,585659,683221090,3817605,481496230,37,489145,556851697,488581,556783669,564,68028,471478,10,585896,44281,34,431,117000.0,39000.0,-67.0,-65.0,-70.0,-67.0,-67.0,-65.0,-70.0,-67.0,-90.0,-93.0,-89.0,-93.0,23.0,28.0,19.0,26.0,0
895,CC:2F:71:3E:C5:1F,3818291,481580080,685,83790,3817606,481496290,0,2927,245166,2426,185604,501,59562,726,8,1016,18,0,32,130000.0,39000.0,-70.0,-71.0,-67.0,-60.0,-70.0,-71.0,-67.0,-60.0,-90.0,-93.0,-89.0,-93.0,20.0,22.0,22.0,33.0,0
896,BA:8C:B9:54:50:24,3819334,482333808,1728,837518,3817606,481496290,0,5560,821156,5540,818034,20,3122,1004,14,2103,29,0,49,216660.0,130000.0,-40.0,-37.0,-44.0,-51.0,-44.0,-36.0,-43.0,-47.0,-90.0,-93.0,-89.0,-93.0,50.0,56.0,45.0,42.0,0
897,92:69:1D:31:68:E9,3821088,484952167,3478,3455473,3817610,481496694,0,3615,930652,3518,909092,97,21560,1794,6,3604,78,0,31,216660.0,130000.0,-51.0,-47.0,-42.0,-49.0,-51.0,-50.0,-44.0,-48.0,-90.0,-93.0,-89.0,-93.0,39.0,46.0,47.0,44.0,0
898,CC:2F:71:3F:1F:24,4403313,1164732466,585703,683235772,3817610,481496694,37,489171,556856677,488607,556788649,564,68028,471504,10,585940,44289,34,431,130000.0,43333.0,-67.0,-65.0,-70.0,-68.0,-67.0,-65.0,-70.0,-67.0,-90.0,-93.0,-89.0,-93.0,23.0,28.0,19.0,25.0,0
899,CC:2F:71:3E:C5:1F,3818295,481580484,685,83790,3817610,481496694,0,2927,245166,2426,185604,501,59562,726,8,1016,18,0,32,130000.0,39000.0,-70.0,-71.0,-67.0,-60.0,-70.0,-71.0,-67.0,-60.0,-90.0,-93.0,-89.0,-93.0,20.0,22.0,22.0,33.0,0
900,BA:8C:B9:54:50:24,3819338,482334212,1728,837518,3817610,481496694,0,5560,821156,5540,818034,20,3122,1004,14,2103,29,0,49,216660.0,130000.0,-40.0,-37.0,-44.0,-51.0,-44.0,-36.0,-43.0,-47.0,-90.0,-93.0,-89.0,-93.0,50.0,56.0,45.0,42.0,0
901,92:69:1D:31:68:E9,3821092,484952571,3478,3455473,3817614,481497098,0,3615,930652,3518,909092,97,21560,1794,6,3604,78,0,31,216660.0,130000.0,-51.0,-47.0,-42.0,-49.0,-51.0,-50.0,-44.0,-48.0,-90.0,-93.0,-89.0,-93.0,39.0,46.0,47.0,44.0,0
902,CC:2F:71:3F:1F:24,4403359,1164747354,585745,683250256,3817614,481497098,37,489197,556861621,488633,556793593,564,68028,471530,10,585982,44309,34,431,130000.0,39000.0,-67.0,-65.0,-70.0,-67.0,-67.0,-65.0,-70.0,-67.0,-90.0,-93.0,-89.0,-93.0,23.0,28.0,19.0,26.0,0
903,CC:2F:71:3E:C5:1F,3818299,481580888,685,83790,3817614,481497098,0,2927,245166,2426,185604,501,59562,726,8,1016,18,0,32,130000.0,39000.0,-70.0,-71.0,-67.0,-60.0,-70.0,-71.0,-67.0,-60.0,-90.0,-93.0,-89.0,-93.0,20.0,22.0,22.0,33.0,0
904,BA:8C:B9:54:50:24,3819342,482334616,1728,837518,3817614,481497098,0,5560,821156,5540,818034,20,3122,1004,14,2103,29,0,49,216660.0,130000.0,-40.0,-37.0,-44.0,-51.0,-44.0,-36.0,-43.0,-47.0,-90.0,-93.0,-89.0,-93.0,50.0,56.0,45.0,42.0,0
905,92:69:1D:31:68:E9,3821097,484953035,3478,3455473,3817619,481497562,0,3615,930652,3518,909092,97,21560,1794,6,3604,78,0,31,216660.0,130000.0,-51.0,-47.0,-42.0,-49.0,-51.0,-50.0,-44.0,-48.0,-90.0,-93.0,-89.0,-93.0,39.0,46.0,47.0,44.0,0
906,CC:2F:71:3F:1F:24,4403406,1164762190,585787,683264628,3817619,481497562,37,489225,556866821,488661,556798793,564,68028,471558,10,586024,44329,34,431,130000.0,43333.0,-67.0,-65.0,-70.0,-67.0,-67.0,-65.0,-70.0,-67.0,-90.0,-93.0,-89.0,-93.0,23.0,28.0,19.0,26.0,0
907,CC:2F:71:3E:C5:1F,3818304,481581352,685,83790,3817619,481497562,0,2927,245166,2426,185604,501,59562,726,8,1016,18,0,32,130000.0,39000.0,-70.0,-71.0,-67.0,-60.0,-70.0,-71.0,-67.0,-60.0,-90.0,-93.0,-89.0,-93.0,20.0,22.0,22.0,33.0,0
908,BA:8C:B9:54:50:24,3819347,482335080,1728,837518,3817619,481497562,0,5560,821156,5540,818034,20,3122,1004,14,2103,29,0,49,216660.0,130000.0,-40.0,-37.0,-44.0,-51.0,-44.0,-36.0,-43.0,-47.0,-90.0,-93.0,-89.0,-93.0,50.0,56.0,45.0,42.0,0
909,92:69:1D:31:68:E9,3821099,484953237,3478,3455473,3817621,481497764,0,3615,930652,3518,909092,97,21560,1794,6,3604,78,0,31,216660.0,130000.0,-51.0,-47.0,-42.0,-49.0,-51.0,-50.0,-44.0,-48.0,-90.0,-93.0,-89.0,-93.0,39.0,46.0,47.0,44.0,0
910,CC:2F:71:3F:1F:24,4403451,1164776944,585830,683279180,3817621,481497764,37,489251,556871765,488687,556803737,564,68028,471584,10,586067,44358,34,431,144444.0,39000.0,-67.0,-65.0,-71.0,-68.0,-67.0,-65.0,-70.0,-67.0,-90.0,-93.0,-89.0,-93.0,23.0,28.0,18.0,25.0,0
911,CC:2F:71:3E:C5:1F,3818308,481581756,685,83790,3817623,481497966,0,2927,245166,2426,185604,501,59562,726,8,1016,18,0,32,130000.0,39000.0,-70.0,-71.0,-67.0,-60.0,-70.0,-71.0,-67.0,-60.0,-90.0,-93.0,-89.0,-93.0,20.0,22.0,22.0,33.0,0
912,BA:8C:B9:54:50:24,3819351,482335484,1728,837518,3817623,481497966,0,5560,821156,5540,818034,20,3122,1004,14,2103,29,0,49,216660.0,130000.0,-40.0,-37.0,-44.0,-51.0,-44.0,-36.0,-43.0,-47.0,-90.0,-93.0,-89.0,-93.0,50.0,56.0,45.0,42.0,0
913,92:69:1D:31:68:E9,3821105,484953843,3478,3455473,3817627,481498370,0,3615,930652,3518,909092,97,21560,1794,6,3604,78,0,31,216660.0,130000.0,-51.0,-47.0,-42.0,-49.0,-51.0,-50.0,-44.0,-48.0,-90.0,-93.0,-89.0,-93.0,39.0,46.0,47.0,44.0,0
914,CC:2F:71:3F:1F:24,4403499,1164791978,585872,683293608,3817627,481498370,37,489278,556876801,488714,556808773,564,68028,471611,10,586109,44379,34,431,130000.0,43333.0,-67.0,-65.0,-70.0,-68.0,-67.0,-65.0,-70.0,-67.0,-90.0,-93.0,-89.0,-93.0,23.0,28.0,19.0,25.0,0
915,CC:2F:71:3E:C5:1F,3818312,481582160,685,83790,3817627,481498370,0,2927,245166,2426,185604,501,59562,726,8,1016,18,0,32,130000.0,39000.0,-70.0,-71.0,-67.0,-60.0,-70.0,-71.0,-67.0,-60.0,-90.0,-93.0,-89.0,-93.0,20.0,22.0,22.0,33.0,0
916,BA:8C:B9:54:50:24,3819355,482335888,1728,837518,3817627,481498370,0,5560,821156,5540,818034,20,3122,1004,14,2103,29,0,49,216660.0,130000.0,-40.0,-37.0,-44.0,-51.0,-44.0,-36.0,-43.0,-47.0,-90.0,-93.0,-89.0,-93.0,50.0,56.0,45.0,42.0,0
917,92:69:1D:31:68:E9,3821108,484954105,3478,3455473,3817630,481498632,0,3615,930652,3518,909092,97,21560,1794,6,3604,78,0,31,216660.0,130000.0,-51.0,-47.0,-42.0,-49.0,-51.0,-50.0,-44.0,-48.0,-90.0,-93.0,-89.0,-93.0,39.0,46.0,47.0,44.0,0
918,CC:2F:71:3F:1F:24,4403548,1164807174,585916,683308340,3817632,481498834,37,489305,556881885,488741,556813857,564,68028,471638,10,586153,44396,34,431,130000.0,39000.0,-67.0,-65.0,-71.0,-68.0,-67.0,-65.0,-70.0,-67.0,-90.0,-93.0,-89.0,-93.0,23.0,28.0,18.0,25.0,0
919,CC:2F:71:3E:C5:1F,3818317,481582624,685,83790,3817632,481498834,0,2927,245166,2426,185604,501,59562,726,8,1016,18,0,32,130000.0,39000.0,-70.0,-71.0,-67.0,-60.0,-70.0,-71.0,-67.0,-60.0,-90.0,-93.0,-89.0,-93.0,20.0,22.0,22.0,33.0,0
920,BA:8C:B9:54:50:24,3819360,482336352,1728,837518,3817632,481498834,0,5560,821156,5540,818034,20,3122,1004,14,2103,29,0,49,216660.0,130000.0,-40.0,-37.0,-44.0,-51.0,-44.0,-36.0,-43.0,-47.0,-90.0,-93.0,-89.0,-93.0,50.0,56.0,45.0,42.0,0
921,92:69:1D:31:68:E9,3821115,484954960,3479,3455589,3817636,481499371,0,3617,930788,3520,909228,97,21560,1794,6,3605,78,0,31,216660.0,130000.0,-52.0,-50.0,-44.0,-46.0,-51.0,-49.0,-44.0,-47.0,-90.0,-93.0,-89.0,-93.0,38.0,43.0,45.0,47.0,0
922,CC:2F:71:3F:1F:24,4403597,1164822463,585960,683322958,3817637,481499505,37,489330,556886689,488766,556818661,564,68028,471663,10,586197,44413,34,431,130000.0,43333.0,-67.0,-65.0,-71.0,-67.0,-67.0,-65.0,-70.0,-67.0,-90.0,-93.0,-89.0,-93.0,23.0,28.0,18.0,26.0,0
923,CC:2F:71:3E:C5:1F,3818324,481583479,686,83906,3817638,481499573,0,2930,245424,2428,185744,502,59680,727,8,1017,18,0,32,130000.0,39000.0,-70.0,-71.0,-67.0,-60.0,-70.0,-70.0,-67.0,-60.0,-90.0,-93.0,-89.0,-93.0,20.0,22.0,22.0,33.0,0
924,BA:8C:B9:54:50:24,3819367,482337207,1729,837634,3817638,481499573,0,5562,821292,5542,818170,20,3122,1004,14,2104,29,0,49,216660.0,130000.0,-39.0,-37.0,-44.0,-51.0,-43.0,-36.0,-43.0,-48.0,-90.0,-93.0,-89.0,-93.0,51.0,56.0,45.0,42.0,0
925,92:69:1D:31:68:E9,3821119,484955364,3479,3455589,3817640,481499775,0,3617,930788,3520,909228,97,21560,1794,6,3605,78,0,31,216660.0,130000.0,-52.0,-50.0,-44.0,-46.0,-51.0,-49.0,-44.0,-47.0,-90.0,-93.0,-89.0,-93.0,38.0,43.0,45.0,47.0,0
926,CC:2F:71:3F:1F:24,4403642,1164837097,586001,683337262,3817641,481499835,37,489355,556891493,488791,556823465,564,68028,471688,10,586238,44446,34,431,144444.0,39000.0,-67.0,-65.0,-70.0,-67.0,-67.0,-65.0,-70.0,-67.0,-90.0,-93.0,-89.0,-93.0,23.0,28.0,19.0,26.0,0
927,CC:2F:71:3E:C5:1F,3818327,481583741,686,83906,3817641,481499835,0,2930,245424,2428,185744,502,59680,727,8,1017,18,0,32,130000.0,39000.0,-70.0,-71.0,-67.0,-60.0,-70.0,-70.0,-67.0,-60.0,-90.0,-93.0,-89.0,-93.0,20.0,22.0,22.0,33.0,0
928,BA:8C:B9:54:50:24,3819372,482337671,1729,837634,3817643,481500037,0,5563,821360,5543,818238,20,3122,1004,14,2104,29,0,49,216660.0,130000.0,-40.0,-37.0,-44.0,-52.0,-42.0,-36.0,-43.0,-49.0,-90.0,-93.0,-89.0,-93.0,50.0,56.0,45.0,41.0,0
929,92:69:1D:31:68:E9,3821124,484955828,3479,3455589,3817645,481500239,0,3617,930788,3520,909228,97,21560,1794,6,3605,78,0,31,216660.0,130000.0,-52.0,-50.0,-44.0,-46.0,-51.0,-49.0,-44.0,-47.0,-90.0,-93.0,-90.0,-93.0,38.0,43.0,46.0,47.0,0
930,CC:2F:71:3F:1F:24,4403688,1164851929,586043,683351690,3817645,481500239,37,489381,556896437,488817,556828409,564,68028,471714,10,586280,44465,34,431,130000.0,43333.0,-67.0,-65.0,-71.0,-68.0,-67.0,-65.0,-70.0,-67.0,-90.0,-93.0,-90.0,-93.0,23.0,28.0,19.0,25.0,0
931,CC:2F:71:3E:C5:1F,3818333,481584347,686,83906,3817647,481500441,0,2930,245424,2428,185744,502,59680,727,8,1017,18,0,32,130000.0,39000.0,-70.0,-71.0,-67.0,-60.0,-70.0,-70.0,-67.0,-60.0,-90.0,-93.0,-90.0,-93.0,20.0,22.0,23.0,33.0,0
932,BA:8C:B9:54:50:24,3819376,482338075,1729,837634,3817647,481500441,0,5563,821360,5543,818238,20,3122,1004,14,2104,29,0,49,216660.0,130000.0,-40.0,-37.0,-44.0,-52.0,-42.0,-36.0,-43.0,-49.0,-90.0,-93.0,-90.0,-93.0,50.0,56.0,46.0,41.0,0
933,92:69:1D:31:68:E9,3821128,484956232,3479,3455589,3817649,481500643,0,3617,930788,3520,909228,97,21560,1794,6,3605,78,0,31,216660.0,130000.0,-52.0,-50.0,-44.0,-46.0,-51.0,-49.0,-44.0,-47.0,-90.0,-93.0,-90.0,-93.0,38.0,43.0,46.0,47.0,0
934,CC:2F:71:3F:1F:24,4403734,1164866811,586085,683366168,3817649,481500643,37,489407,556901381,488843,556833353,564,68028,471740,10,586322,44480,34,431,130000.0,39000.0,-67.0,-65.0,-70.0,-67.0,-67.0,-65.0,-70.0,-67.0,-90.0,-93.0,-90.0,-93.0,23.0,28.0,20.0,26.0,0
935,CC:2F:71:3E:C5:1F,3818335,481584549,686,83906,3817649,481500643,0,2930,245424,2428,185744,502,59680,727,8,1017,18,0,32,130000.0,39000.0,-70.0,-71.0,-67.0,-60.0,-70.0,-70.0,-67.0,-60.0,-90.0,-93.0,-90.0,-93.0,20.0,22.0,23.0,33.0,0
936,BA:8C:B9:54:50:24,3819378,482338277,1729,837634,3817649,481500643,0,5563,821360,5543,818238,20,3122,1004,14,2104,29,0,49,216660.0,130000.0,-40.0,-37.0,-44.0,-52.0,-42.0,-36.0,-43.0,-49.0,-90.0,-93.0,-90.0,-93.0,50.0,56.0,46.0,41.0,0
937,92:69:1D:31:68:E9,3821133,484956696,3479,3455589,3817654,481501107,0,3617,930788,3520,909228,97,21560,1794,6,3605,78,0,31,216660.0,130000.0,-52.0,-50.0,-44.0,-46.0,-51.0,-49.0,-44.0,-47.0,-90.0,-93.0,-90.0,-93.0,38.0,43.0,46.0,47.0,0
938,CC:2F:71:3F:1F:24,4403781,1164881703,586127,683380596,3817654,481501107,37,489434,556906441,488870,556838413,564,68028,471767,10,586364,44488,34,431,130000.0,43333.0,-67.0,-65.0,-70.0,-67.0,-67.0,-65.0,-70.0,-67.0,-90.0,-93.0,-90.0,-93.0,23.0,28.0,20.0,26.0,0
939,CC:2F:71:3E:C5:1F,3818342,481585215,686,83906,3817656,481501309,0,2930,245424,2428,185744,502,59680,727,8,1017,18,0,32,130000.0,39000.0,-70.0,-71.0,-67.0,-60.0,-70.0,-70.0,-67.0,-60.0,-90.0,-93.0,-90.0,-93.0,20.0,22.0,23.0,33.0,0
940,BA:8C:B9:54:50:24,3819385,482338943,1729,837634,3817656,481501309,0,5563,821360,5543,818238,20,3122,1004,14,2104,29,0,49,216660.0,130000.0,-40.0,-37.0,-44.0,-52.0,-42.0,-36.0,-43.0,-49.0,-90.0,-93.0,-90.0,-93.0,50.0,56.0,46.0,41.0,0
941,92:69:1D:31:68:E9,3821137,484957100,3479,3455589,3817658,481501511,0,3617,930788,3520,909228,97,21560,1794,6,3605,78,0,31,216660.0,130000.0,-52.0,-50.0,-44.0,-46.0,-51.0,-49.0,-44.0,-47.0,-90.0,-93.0,-90.0,-93.0,38.0,43.0,46.0,47.0,0
942,CC:2F:71:3F:1F:24,4403827,1164896535,586169,683395024,3817658,481501511,37,489460,556911361,488896,556843333,564,68028,471793,10,586406,44508,34,431,130000.0,39000.0,-67.0,-65.0,-70.0,-67.0,-67.0,-65.0,-70.0,-67.0,-90.0,-93.0,-90.0,-93.0,23.0,28.0,20.0,26.0,0
943,CC:2F:71:3E:C5:1F,3818344,481585417,686,83906,3817658,481501511,0,2930,245424,2428,185744,502,59680,727,8,1017,18,0,32,130000.0,39000.0,-70.0,-71.0,-67.0,-60.0,-70.0,-70.0,-67.0,-60.0,-90.0,-93.0,-90.0,-93.0,20.0,22.0,23.0,33.0,0
944,BA:8C:B9:54:50:24,3819387,482339145,1729,837634,3817658,481501511,0,5563,821360,5543,818238,20,3122,1004,14,2104,29,0,49,216660.0,130000.0,-40.0,-37.0,-44.0,-52.0,-42.0,-36.0,-43.0,-49.0,-90.0,-93.0,-90.0,-93.0,50.0,56.0,46.0,41.0,0
945,92:69:1D:31:68:E9,3821141,484957504,3479,3455589,3817662,481501915,0,3617,930788,3520,909228,97,21560,1794,6,3605,78,0,31,216660.0,130000.0,-52.0,-50.0,-44.0,-46.0,-51.0,-49.0,-44.0,-47.0,-90.0,-93.0,-90.0,-93.0,38.0,43.0,46.0,47.0,0
946,CC:2F:71:3F:1F:24,4403874,1164911441,586212,683409526,3817662,481501915,37,489487,556916421,488923,556848393,564,68028,471820,10,586449,44542,34,431,130000.0,43333.0,-67.0,-65.0,-71.0,-68.0,-67.0,-65.0,-70.0,-67.0,-90.0,-93.0,-90.0,-93.0,23.0,28.0,19.0,25.0,0
947,CC:2F:71:3E:C5:1F,3818350,481586023,686,83906,3817664,481502117,0,2930,245424,2428,185744,502,59680,727,8,1017,18,0,32,130000.0,39000.0,-70.0,-71.0,-67.0,-60.0,-70.0,-70.0,-67.0,-60.0,-90.0,-93.0,-90.0,-93.0,20.0,22.0,23.0,33.0,0
948,BA:8C:B9:54:50:24,3819393,482339751,1729,837634,3817664,481502117,0,5563,821360,5543,818238,20,3122,1004,14,2104,29,0,49,216660.0,130000.0,-40.0,-37.0,-44.0,-52.0,-42.0,-36.0,-43.0,-49.0,-90.0,-93.0,-90.0,-93.0,50.0,56.0,46.0,41.0,0
949,92:69:1D:31:68:E9,3821146,484957968,3479,3455589,3817667,481502379,0,3617,930788,3520,909228,97,21560,1794,6,3605,78,0,31,216660.0,130000.0,-52.0,-50.0,-44.0,-46.0,-51.0,-49.0,-44.0,-47.0,-90.0,-93.0,-90.0,-93.0,38.0,43.0,46.0,47.0,0
950,CC:2F:71:3F:1F:24,4403920,1164926315,586253,683423936,3817667,481502379,37,489513,556921365,488949,556853337,564,68028,471846,10,586490,44547,34,431,130000.0,43333.0,-67.0,-65.0,-70.0,-67.0,-67.0,-65.0,-70.0,-67.0,-90.0,-93.0,-90.0,-93.0,23.0,28.0,20.0,26.0,0
951,CC:2F:71:3E:C5:1F,3818353,481586285,686,83906,3817667,481502379,0,2930,245424,2428,185744,502,59680,727,8,1017,18,0,32,130000.0,39000.0,-70.0,-71.0,-67.0,-60.0,-70.0,-70.0,-67.0,-60.0,-90.0,-93.0,-90.0,-93.0,20.0,22.0,23.0,33.0,0
952,BA:8C:B9:54:50:24,3819398,482340215,1729,837634,3817669,481502581,0,5563,821360,5543,818238,20,3122,1004,14,2104,29,0,49,216660.0,130000.0,-40.0,-37.0,-44.0,-52.0,-42.0,-36.0,-43.0,-49.0,-90.0,-93.0,-90.0,-93.0,50.0,56.0,46.0,41.0,0
953,92:69:1D:31:68:E9,3821150,484958372,3479,3455589,3817671,481502783,0,3617,930788,3520,909228,97,21560,1794,6,3605,78,0,31,216660.0,130000.0,-52.0,-50.0,-44.0,-46.0,-51.0,-49.0,-44.0,-47.0,-90.0,-93.0,-90.0,-93.0,38.0,43.0,46.0,47.0,0
954,CC:2F:71:3F:1F:24,4403966,1164941203,586295,683438420,3817671,481502783,37,489540,556926425,488976,556858397,564,68028,471873,10,586532,44567,34,431,130000.0,39000.0,-67.0,-65.0,-70.0,-67.0,-67.0,-65.0,-70.0,-67.0,-90.0,-93.0,-90.0,-93.0,23.0,28.0,20.0,26.0,0
955,CC:2F:71:3E:C5:1F,3818360,481587017,686,83906,3817674,481503111,0,2930,245424,2428,185744,502,59680,727,8,1017,18,0,32,130000.0,39000.0,-70.0,-71.0,-67.0,-60.0,-70.0,-70.0,-67.0,-60.0,-90.0,-93.0,-90.0,-93.0,20.0,22.0,23.0,33.0,0
956,BA:8C:B9:54:50:24,3819403,482340745,1729,837634,3817674,481503111,0,5563,821360,5543,818238,20,3122,1004,14,2104,29,0,49,216660.0,130000.0,-40.0,-37.0,-44.0,-52.0,-42.0,-36.0,-43.0,-49.0,-90.0,-93.0,-90.0,-93.0,50.0,56.0,46.0,41.0,0
957,92:69:1D:31:68:E9,3821156,484958962,3479,3455589,3817677,481503373,0,3617,930788,3520,909228,97,21560,1794,6,3605,78,0,31,216660.0,130000.0,-52.0,-50.0,-44.0,-46.0,-51.0,-49.0,-44.0,-47.0,-90.0,-93.0,-90.0,-93.0,38.0,43.0,46.0,47.0,0
958,CC:2F:71:3F:1F:24,4404014,1164956221,586337,683452848,3817677,481503373,37,489566,556931369,489002,556863341,564,68028,471899,10,586574,44584,34,431,130000.0,43333.0,-67.0,-65.0,-70.0,-68.0,-67.0,-65.0,-70.0,-67.0,-90.0,-93.0,-90.0,-93.0,23.0,28.0,20.0,25.0,0
959,CC:2F:71:3E:C5:1F,3818363,481587279,686,83906,3817677,481503373,0,2930,245424,2428,185744,502,59680,727,8,1017,18,0,32,130000.0,39000.0,-70.0,-71.0,-67.0,-60.0,-70.0,-70.0,-67.0,-60.0,-90.0,-93.0,-90.0,-93.0,20.0,22.0,23.0,33.0,0
960,BA:8C:B9:54:50:24,3819406,482341007,1729,837634,3817677,481503373,0,5563,821360,5543,818238,20,3122,1004,14,2104,29,0,49,216660.0,130000.0,-40.0,-37.0,-44.0,-52.0,-42.0,-36.0,-43.0,-49.0,-90.0,-93.0,-90.0,-93.0,50.0,56.0,46.0,41.0,0
961,92:69:1D:31:68:E9,3821160,484959366,3479,3455589,3817681,481503777,0,3617,930788,3520,909228,97,21560,1794,6,3605,78,0,31,216660.0,130000.0,-52.0,-50.0,-44.0,-46.0,-51.0,-49.0,-44.0,-47.0,-90.0,-93.0,-90.0,-93.0,38.0,43.0,46.0,47.0,0
962,CC:2F:71:3F:1F:24,4404061,1164971233,586380,683467456,3817681,481503777,37,489593,556936453,489029,556868425,564,68028,471926,10,586617,44589,34,431,130000.0,43333.0,-67.0,-65.0,-70.0,-68.0,-67.0,-65.0,-70.0,-67.0,-90.0,-93.0,-90.0,-93.0,23.0,28.0,20.0,25.0,0
963,CC:2F:71:3E:C5:1F,3818368,481587817,686,83906,3817682,481503911,0,2930,245424,2428,185744,502,59680,727,8,1017,18,0,32,130000.0,39000.0,-70.0,-71.0,-67.0,-60.0,-70.0,-70.0,-67.0,-60.0,-90.0,-93.0,-90.0,-93.0,20.0,22.0,23.0,33.0,0
964,BA:8C:B9:54:50:24,3819413,482341675,1729,837634,3817684,481504041,0,5563,821360,5543,818238,20,3122,1004,14,2104,29,0,49,216660.0,130000.0,-40.0,-37.0,-44.0,-52.0,-42.0,-36.0,-43.0,-49.0,-90.0,-93.0,-90.0,-93.0,50.0,56.0,46.0,41.0,0
965,92:69:1D:31:68:E9,3821165,484959832,3479,3455589,3817686,481504243,0,3617,930788,3520,909228,97,21560,1794,6,3605,78,0,31,216660.0,130000.0,-52.0,-50.0,-44.0,-46.0,-51.0,-49.0,-44.0,-47.0,-90.0,-93.0,-90.0,-93.0,38.0,43.0,46.0,47.0,0
966,CC:2F:71:3F:1F:24,4404108,1164986183,586422,683481940,3817686,481504243,37,489619,556941403,489054,556873257,565,68146,471952,10,586659,44607,34,431,130000.0,39000.0,-67.0,-65.0,-70.0,-68.0,-67.0,-65.0,-70.0,-67.0,-90.0,-93.0,-90.0,-93.0,23.0,28.0,20.0,25.0,0
967,CC:2F:71:3E:C5:1F,3818372,481588149,686,83906,3817686,481504243,0,2930,245424,2428,185744,502,59680,727,8,1017,18,0,32,130000.0,39000.0,-70.0,-71.0,-67.0,-60.0,-70.0,-70.0,-67.0,-60.0,-90.0,-93.0,-90.0,-93.0,20.0,22.0,23.0,33.0,0
968,BA:8C:B9:54:50:24,3819415,482341877,1729,837634,3817686,481504243,0,5563,821360,5543,818238,20,3122,1004,14,2104,29,0,49,216660.0,130000.0,-40.0,-37.0,-44.0,-52.0,-42.0,-36.0,-43.0,-49.0,-90.0,-93.0,-90.0,-93.0,50.0,56.0,46.0,41.0,0
969,92:69:1D:31:68:E9,3821170,484960296,3479,3455589,3817691,481504707,0,3617,930788,3520,909228,97,21560,1794,6,3605,78,0,31,216660.0,130000.0,-52.0,-50.0,-44.0,-46.0,-51.0,-49.0,-44.0,-47.0,-90.0,-93.0,-90.0,-93.0,38.0,43.0,46.0,47.0,0
970,CC:2F:71:3F:1F:24,4404154,1165000951,586463,683496244,3817691,481504707,37,489645,556946347,489080,556878201,565,68146,471978,10,586700,44632,34,431,130000.0,39000.0,-67.0,-65.0,-70.0,-67.0,-67.0,-65.0,-70.0,-67.0,-90.0,-93.0,-90.0,-93.0,23.0,28.0,20.0,26.0,0
971,CC:2F:71:3E:C5:1F,3818377,481588613,686,83906,3817691,481504707,0,2930,245424,2428,185744,502,59680,727,8,1017,18,0,32,130000.0,39000.0,-70.0,-71.0,-67.0,-60.0,-70.0,-70.0,-67.0,-60.0,-90.0,-93.0,-90.0,-93.0,20.0,22.0,23.0,33.0,0
972,BA:8C:B9:54:50:24,3819422,482342543,1729,837634,3817693,481504909,0,5563,821360,5543,818238,20,3122,1004,14,2104,29,0,49,216660.0,130000.0,-40.0,-37.0,-44.0,-52.0,-42.0,-36.0,-43.0,-49.0,-90.0,-93.0,-90.0,-93.0,50.0,56.0,46.0,41.0,0
973,92:69:1D:31:68:E9,3821175,484960973,3479,3455589,3817696,481505384,0,3617,930788,3520,909228,97,21560,1794,6,3605,78,0,31,216660.0,130000.0,-52.0,-50.0,-44.0,-46.0,-51.0,-49.0,-44.0,-47.0,-90.0,-93.0,-90.0,-93.0,38.0,43.0,46.0,47.0,0
974,CC:2F:71:3F:1F:24,4404203,1165016248,586507,683510864,3817696,481505384,37,489673,556951523,489108,556883377,565,68146,472006,10,586744,44652,34,431,117000.0,39000.0,-67.0,-65.0,-70.0,-67.0,-67.0,-65.0,-70.0,-67.0,-90.0,-93.0,-90.0,-93.0,23.0,28.0,20.0,26.0,0
975,CC:2F:71:3E:C5:1F,3818382,481589290,686,83906,3817696,481505384,0,2930,245424,2428,185744,502,59680,727,8,1017,18,0,32,130000.0,39000.0,-70.0,-71.0,-67.0,-60.0,-70.0,-70.0,-67.0,-60.0,-90.0,-93.0,-90.0,-93.0,20.0,22.0,23.0,33.0,0
976,BA:8C:B9:54:50:24,3819425,482343018,1729,837634,3817696,481505384,0,5563,821360,5543,818238,20,3122,1004,14,2104,29,0,49,216660.0,130000.0,-40.0,-37.0,-44.0,-52.0,-42.0,-36.0,-43.0,-49.0,-90.0,-93.0,-90.0,-93.0,50.0,56.0,46.0,41.0,0
977,92:69:1D:31:68:E9,3821179,484961377,3479,3455589,3817700,481505788,0,3617,930788,3520,909228,97,21560,1794,6,3605,78,0,31,216660.0,130000.0,-52.0,-50.0,-44.0,-46.0,-51.0,-49.0,-44.0,-47.0,-90.0,-93.0,-90.0,-93.0,38.0,43.0,46.0,47.0,0
978,CC:2F:71:3F:1F:24,4404248,1165030956,586548,683525168,3817700,481505788,37,489700,556956607,489135,556888461,565,68146,472033,10,586785,44659,34,431,130000.0,43333.0,-67.0,-65.0,-71.0,-68.0,-67.0,-65.0,-70.0,-67.0,-90.0,-93.0,-90.0,-93.0,23.0,28.0,19.0,25.0,0
979,CC:2F:71:3E:C5:1F,3818387,481589754,686,83906,3817701,481505848,0,2930,245424,2428,185744,502,59680,727,8,1017,18,0,32,130000.0,39000.0,-70.0,-71.0,-67.0,-60.0,-70.0,-70.0,-67.0,-60.0,-90.0,-93.0,-90.0,-93.0,20.0,22.0,23.0,33.0,0
980,BA:8C:B9:54:50:24,3819432,482343684,1729,837634,3817703,481506050,0,5563,821360,5543,818238,20,3122,1004,14,2104,29,0,49,216660.0,130000.0,-40.0,-37.0,-44.0,-52.0,-42.0,-36.0,-43.0,-49.0,-90.0,-93.0,-90.0,-93.0,50.0,56.0,46.0,41.0,0
981,92:69:1D:31:68:E9,3821184,484961841,3479,3455589,3817705,481506252,0,3617,930788,3520,909228,97,21560,1794,6,3605,78,0,31,216660.0,130000.0,-52.0,-50.0,-44.0,-46.0,-51.0,-49.0,-44.0,-47.0,-90.0,-93.0,-90.0,-93.0,38.0,43.0,46.0,47.0,0
982,CC:2F:71:3F:1F:24,4404295,1165045854,586590,683539602,3817705,481506252,37,489727,556961691,489162,556893545,565,68146,472060,10,586827,44672,34,431,117000.0,39000.0,-67.0,-65.0,-70.0,-67.0,-67.0,-65.0,-70.0,-67.0,-90.0,-93.0,-90.0,-93.0,23.0,28.0,20.0,26.0,0
983,CC:2F:71:3E:C5:1F,3818391,481590158,686,83906,3817705,481506252,0,2930,245424,2428,185744,502,59680,727,8,1017,18,0,32,130000.0,39000.0,-70.0,-71.0,-67.0,-60.0,-70.0,-70.0,-67.0,-60.0,-90.0,-93.0,-90.0,-93.0,20.0,22.0,23.0,33.0,0
984,BA:8C:B9:54:50:24,3819434,482343886,1729,837634,3817705,481506252,0,5563,821360,5543,818238,20,3122,1004,14,2104,29,0,49,216660.0,130000.0,-40.0,-37.0,-44.0,-52.0,-42.0,-36.0,-43.0,-49.0,-90.0,-93.0,-90.0,-93.0,50.0,56.0,46.0,41.0,0
985,92:69:1D:31:68:E9,3821186,484962043,3479,3455589,3817707,481506454,0,3617,930788,3520,909228,97,21560,1794,6,3605,78,0,31,216660.0,130000.0,-52.0,-50.0,-44.0,-46.0,-51.0,-49.0,-44.0,-47.0,-90.0,-93.0,-90.0,-93.0,38.0,43.0,46.0,47.0,0
986,CC:2F:71:3F:1F:24,4404341,1165060692,586632,683554036,3817709,481506656,37,489752,556966495,489187,556898349,565,68146,472085,10,586869,44678,34,431,130000.0,43333.0,-67.0,-65.0,-71.0,-68.0,-67.0,-65.0,-70.0,-67.0,-90.0,-93.0,-90.0,-93.0,23.0,28.0,19.0,25.0,0
987,CC:2F:71:3E:C5:1F,3818395,481590562,686,83906,3817709,481506656,0,2930,245424,2428,185744,502,59680,727,8,1017,18,0,32,130000.0,39000.0,-70.0,-71.0,-67.0,-60.0,-70.0,-70.0,-67.0,-60.0,-90.0,-93.0,-90.0,-93.0,20.0,22.0,23.0,33.0,0
988,BA:8C:B9:54:50:24,3819440,482344492,1729,837634,3817711,481506858,0,5563,821360,5543,818238,20,3122,1004,14,2104,29,0,49,216660.0,130000.0,-40.0,-37.0,-44.0,-52.0,-42.0,-36.0,-43.0,-49.0,-90.0,-93.0,-90.0,-93.0,50.0,56.0,46.0,41.0,0
989,92:69:1D:31:68:E9,3821193,484962709,3479,3455589,3817714,481507120,0,3617,930788,3520,909228,97,21560,1794,6,3605,78,0,31,216660.0,130000.0,-52.0,-50.0,-44.0,-46.0,-51.0,-49.0,-44.0,-47.0,-90.0,-93.0,-90.0,-93.0,38.0,43.0,46.0,47.0,0
990,CC:2F:71:3F:1F:24,4404388,1165075708,586674,683568588,3817714,481507120,37,489777,556971299,489212,556903153,565,68146,472110,10,586911,44686,34,431,130000.0,43333.0,-67.0,-65.0,-70.0,-68.0,-67.0,-65.0,-70.0,-67.0,-90.0,-93.0,-90.0,-93.0,23.0,28.0,20.0,25.0,0
991,CC:2F:71:3E:C5:1F,3818400,481591026,686,83906,3817714,481507120,0,2930,245424,2428,185744,502,59680,727,8,1017,18,0,32,130000.0,39000.0,-70.0,-71.0,-67.0,-60.0,-70.0,-70.0,-67.0,-60.0,-90.0,-93.0,-90.0,-93.0,20.0,22.0,23.0,33.0,0
992,BA:8C:B9:54:50:24,3819443,482344754,1729,837634,3817714,481507120,0,5563,821360,5543,818238,20,3122,1004,14,2104,29,0,49,216660.0,130000.0,-40.0,-37.0,-44.0,-52.0,-42.0,-36.0,-43.0,-49.0,-90.0,-93.0,-90.0,-93.0,50.0,56.0,46.0,41.0,0
993,92:69:1D:31:68:E9,3821195,484962911,3479,3455589,3817716,481507322,0,3617,930788,3520,909228,97,21560,1794,6,3605,78,0,31,216660.0,130000.0,-52.0,-50.0,-44.0,-46.0,-51.0,-49.0,-44.0,-47.0,-90.0,-93.0,-90.0,-93.0,38.0,43.0,46.0,47.0,0
994,CC:2F:71:3F:1F:24,4404434,1165090484,586716,683582960,3817718,481507524,37,489803,556976243,489238,556908097,565,68146,472136,10,586953,44698,34,431,130000.0,39000.0,-67.0,-65.0,-70.0,-67.0,-67.0,-65.0,-70.0,-67.0,-90.0,-93.0,-90.0,-93.0,23.0,28.0,20.0,26.0,0
995,CC:2F:71:3E:C5:1F,3818404,481591430,686,83906,3817718,481507524,0,2930,245424,2428,185744,502,59680,727,8,1017,18,0,32,130000.0,39000.0,-70.0,-71.0,-67.0,-60.0,-70.0,-70.0,-67.0,-60.0,-90.0,-93.0,-90.0,-93.0,20.0,22.0,23.0,33.0,0
996,BA:8C:B9:54:50:24,3819447,482345158,1729,837634,3817718,481507524,0,5563,821360,5543,818238,20,3122,1004,14,2104,29,0,49,216660.0,130000.0,-40.0,-37.0,-44.0,-52.0,-42.0,-36.0,-43.0,-49.0,-90.0,-93.0,-90.0,-93.0,50.0,56.0,46.0,41.0,0
997,92:69:1D:31:68:E9,3821201,484963517,3479,3455589,3817722,481507928,0,3617,930788,3520,909228,97,21560,1794,6,3605,78,0,31,216660.0,130000.0,-52.0,-50.0,-44.0,-46.0,-51.0,-49.0,-44.0,-47.0,-90.0,-93.0,-90.0,-93.0,38.0,43.0,46.0,47.0,0
998,CC:2F:71:3F:1F:24,4404479,1165105248,586757,683597320,3817722,481507928,37,489829,556981223,489264,556913077,565,68146,472162,10,586994,44710,34,431,130000.0,43333.0,-67.0,-65.0,-71.0,-67.0,-67.0,-65.0,-70.0,-67.0,-90.0,-93.0,-90.0,-93.0,23.0,28.0,19.0,26.0,0
999,CC:2F:71:3E:C5:1F,3818408,481591834,686,83906,3817722,481507928,0,2930,245424,2428,185744,502,59680,727,8,1017,18,0,32,130000.0,39000.0,-70.0,-71.0,-67.0,-60.0,-70.0,-70.0,-67.0,-60.0,-90.0,-93.0,-90.0,-93.0,20.0,22.0,23.0,33.0,0
1000,BA:8C:B9:54:50:24,3819451,482345562,1729,837634,3817722,481507928,0,5563,821360,5543,818238,20,3122,1004,14,2104,29,0,49,216660.0,130000.0,-40.0,-37.0,-44.0,-52.0,-42.0,-36.0,-43.0,-49.0,-90.0,-93.0,-90.0,-93.0,50.0,56.0,46.0,41.0,0
1001,92:69:1D:31:68:E9,3821205,484963847,3479,3455589,3817726,481508258,0,3617,930788,3520,909228,97,21560,1794,6,3605,78,0,31,216660.0,130000.0,-52.0,-50.0,-44.0,-46.0,-51.0,-49.0,-44.0,-47.0,-90.0,-93.0,-90.0,-93.0,38.0,43.0,46.0,47.0,0
1002,CC:2F:71:3F:1F:24,4404527,1165120320,586800,683611928,3817727,481508392,37,489855,556986167,489290,556918021,565,68146,472188,10,587037,44728,34,431,130000.0,39000.0,-67.0,-65.0,-70.0,-67.0,-67.0,-65.0,-70.0,-67.0,-90.0,-93.0,-90.0,-93.0,23.0,28.0,20.0,26.0,0
1003,CC:2F:71:3E:C5:1F,3818413,481592298,686,83906,3817727,481508392,0,2930,245424,2428,185744,502,59680,727,8,1017,18,0,32,130000.0,39000.0,-70.0,-71.0,-67.0,-60.0,-70.0,-70.0,-67.0,-60.0,-90.0,-93.0,-90.0,-93.0,20.0,22.0,23.0,33.0,0
1004,BA:8C:B9:54:50:24,3819460,482346430,1729,837634,3817731,481508796,0,5563,821360,5543,818238,20,3122,1004,14,2104,29,0,49,216660.0,130000.0,-40.0,-37.0,-44.0,-52.0,-42.0,-36.0,-43.0,-49.0,-90.0,-93.0,-90.0,-93.0,50.0,56.0,46.0,41.0,0
1005,92:69:1D:31:68:E9,3821210,484964385,3479,3455589,3817731,481508796,0,3617,930788,3520,909228,97,21560,1794,6,3605,78,0,31,216660.0,130000.0,-52.0,-50.0,-44.0,-46.0,-51.0,-49.0,-44.0,-47.0,-90.0,-93.0,-90.0,-93.0,38.0,43.0,46.0,47.0,0
1006,CC:2F:71:3F:1F:24,4404574,1165135220,586843,683626424,3817731,481508796,37,489880,556990971,489315,556922825,565,68146,472213,10,587080,44743,34,431,130000.0,43333.0,-67.0,-65.0,-70.0,-68.0,-67.0,-65.0,-70.0,-67.0,-90.0,-93.0,-90.0,-93.0,23.0,28.0,20.0,25.0,0
1007,CC:2F:71:3E:C5:1F,3818417,481592702,686,83906,3817731,481508796,0,2930,245424,2428,185744,502,59680,727,8,1017,18,0,32,130000.0,39000.0,-70.0,-71.0,-67.0,-60.0,-70.0,-70.0,-67.0,-60.0,-90.0,-93.0,-90.0,-93.0,20.0,22.0,23.0,33.0,0
1008,BA:8C:B9:54:50:24,3819460,482346430,1729,837634,3817731,481508796,0,5563,821360,5543,818238,20,3122,1004,14,2104,29,0,49,216660.0,130000.0,-40.0,-37.0,-44.0,-52.0,-42.0,-36.0,-43.0,-49.0,-90.0,-93.0,-90.0,-93.0,50.0,56.0,46.0,41.0,0
1009,92:69:1D:31:68:E9,3821213,484964647,3479,3455589,3817734,481509058,0,3618,930856,3521,909296,97,21560,1794,6,3605,78,0,31,216660.0,130000.0,-52.0,-50.0,-44.0,-46.0,-51.0,-49.0,-44.0,-47.0,-90.0,-93.0,-90.0,-93.0,38.0,43.0,46.0,47.0,0
1010,CC:2F:71:3F:1F:24,4404622,1165150236,586886,683640976,3817736,481509260,37,489906,556995915,489341,556927769,565,68146,472239,10,587123,44768,34,431,144444.0,39000.0,-67.0,-65.0,-71.0,-67.0,-67.0,-65.0,-70.0,-67.0,-90.0,-93.0,-90.0,-93.0,23.0,28.0,19.0,26.0,0
1011,CC:2F:71:3E:C5:1F,3818424,481593368,686,83906,3817738,481509462,0,2930,245424,2428,185744,502,59680,727,8,1017,18,0,32,130000.0,39000.0,-70.0,-71.0,-67.0,-60.0,-70.0,-70.0,-67.0,-60.0,-90.0,-93.0,-90.0,-93.0,20.0,22.0,23.0,33.0,0
1012,BA:8C:B9:54:50:24,3819469,482347298,1729,837634,3817740,481509664,0,5563,821360,5543,818238,20,3122,1004,14,2104,29,0,49,216660.0,130000.0,-40.0,-37.0,-44.0,-52.0,-42.0,-36.0,-43.0,-49.0,-90.0,-93.0,-90.0,-93.0,50.0,56.0,46.0,41.0,0
1013,92:69:1D:31:68:E9,3821219,484965253,3479,3455589,3817740,481509664,0,3618,930856,3521,909296,97,21560,1794,6,3605,78,0,31,216660.0,130000.0,-52.0,-50.0,-44.0,-46.0,-51.0,-49.0,-44.0,-47.0,-90.0,-93.0,-90.0,-93.0,38.0,43.0,46.0,47.0,0
1014,CC:2F:71:3F:1F:24,4404668,1165165068,586928,683655404,3817740,481509664,37,489931,557000719,489366,556932573,565,68146,472264,10,587165,44793,34,431,130000.0,43333.0,-67.0,-65.0,-70.0,-68.0,-67.0,-65.0,-70.0,-67.0,-90.0,-93.0,-90.0,-93.0,23.0,28.0,20.0,25.0,0
1015,CC:2F:71:3E:C5:1F,3818426,481593570,686,83906,3817740,481509664,0,2930,245424,2428,185744,502,59680,727,8,1017,18,0,32,130000.0,39000.0,-70.0,-71.0,-67.0,-60.0,-70.0,-70.0,-67.0,-60.0,-90.0,-93.0,-90.0,-93.0,20.0,22.0,23.0,33.0,0
1016,BA:8C:B9:54:50:24,3819469,482347298,1729,837634,3817740,481509664,0,5563,821360,5543,818238,20,3122,1004,14,2104,29,0,49,216660.0,130000.0,-40.0,-37.0,-44.0,-52.0,-42.0,-36.0,-43.0,-49.0,-90.0,-93.0,-90.0,-93.0,50.0,56.0,46.0,41.0,0
1017,92:69:1D:31:68:E9,3821221,484965455,3479,3455589,3817742,481509866,0,3618,930856,3521,909296,97,21560,1794,6,3605,78,0,31,216660.0,130000.0,-52.0,-50.0,-44.0,-46.0,-51.0,-49.0,-44.0,-47.0,-90.0,-93.0,-90.0,-93.0,38.0,43.0,46.0,47.0,0
1018,CC:2F:71:3F:1F:24,4404714,1165179900,586970,683669832,3817744,481510068,37,489958,557005779,489393,556937633,565,68146,472291,10,587207,44807,34,431,117000.0,39000.0,-67.0,-65.0,-70.0,-67.0,-67.0,-65.0,-70.0,-67.0,-90.0,-93.0,-90.0,-93.0,23.0,28.0,20.0,26.0,0
1019,CC:2F:71:3E:C5:1F,3818432,481594176,686,83906,3817746,481510270,0,2930,245424,2428,185744,502,59680,727,8,1017,18,0,32,130000.0,39000.0,-70.0,-71.0,-67.0,-60.0,-70.0,-70.0,-67.0,-60.0,-90.0,-93.0,-90.0,-93.0,20.0,22.0,23.0,33.0,0
1020,BA:8C:B9:54:50:24,3819477,482348106,1729,837634,3817748,481510472,0,5563,821360,5543,818238,20,3122,1004,14,2104,29,0,49,216660.0,130000.0,-40.0,-37.0,-44.0,-52.0,-42.0,-36.0,-43.0,-49.0,-90.0,-93.0,-90.0,-93.0,50.0,56.0,46.0,41.0,0
1021,92:69:1D:31:68:E9,3821228,484966121,3479,3455589,3817749,481510532,0,3618,930856,3521,909296,97,21560,1794,6,3605,78,0,31,216660.0,130000.0,-52.0,-50.0,-44.0,-46.0,-51.0,-49.0,-44.0,-47.0,-90.0,-93.0,-90.0,-93.0,38.0,43.0,46.0,47.0,0
1022,CC:2F:71:3F:1F:24,4404760,1165194668,587011,683684136,3817749,481510532,37,489984,557010723,489419,556942577,565,68146,472317,10,587248,44812,34,431,130000.0,43333.0,-67.0,-65.0,-70.0,-67.0,-67.0,-65.0,-70.0,-67.0,-90.0,-93.0,-90.0,-93.0,23.0,28.0,20.0,26.0,0
1023,CC:2F:71:3E:C5:1F,3818435,481594438,686,83906,3817749,481510532,0,2930,245424,2428,185744,502,59680,727,8,1017,18,0,32,130000.0,39000.0,-70.0,-71.0,-67.0,-60.0,-70.0,-70.0,-67.0,-60.0,-90.0,-93.0,-90.0,-93.0,20.0,22.0,23.0,33.0,0
1024,BA:8C:B9:54:50:24,3819478,482348166,1729,837634,3817749,481510532,0,5563,821360,5543,818238,20,3122,1004,14,2104,29,0,49,216660.0,130000.0,-40.0,-37.0,-44.0,-52.0,-42.0,-36.0,-43.0,-49.0,-90.0,-93.0,-90.0,-93.0,50.0,56.0,46.0,41.0,0
1025,92:69:1D:31:68:E9,3821232,484966712,3480,3455705,3817752,481511007,0,3620,930992,3523,909432,97,21560,1794,6,3606,78,0,31,216660.0,130000.0,-52.0,-50.0,-44.0,-46.0,-51.0,-49.0,-44.0,-47.0,-90.0,-93.0,-90.0,-93.0,38.0,43.0,46.0,47.0,0
1026,CC:2F:71:3F:1F:24,4404808,1165210047,587056,683699040,3817752,481511007,37,490010,557015667,489445,556947521,565,68146,472343,10,587293,44822,34,431,130000.0,43333.0,-67.0,-65.0,-70.0,-68.0,-67.0,-65.0,-70.0,-67.0,-90.0,-93.0,-90.0,-93.0,23.0,28.0,20.0,25.0,0
1027,CC:2F:71:3E:C5:1F,3818441,481595231,687,84022,3817754,481511209,0,2932,245564,2430,185884,502,59680,727,8,1018,18,0,32,130000.0,39000.0,-70.0,-71.0,-67.0,-60.0,-70.0,-70.0,-67.0,-60.0,-90.0,-93.0,-90.0,-93.0,20.0,22.0,23.0,33.0,0
1028,BA:8C:B9:54:50:24,3819488,482349363,1730,837750,3817758,481511613,0,5565,821496,5545,818374,20,3122,1004,14,2105,29,0,49,216660.0,130000.0,-49.0,-35.0,-42.0,-44.0,-42.0,-36.0,-43.0,-49.0,-90.0,-93.0,-90.0,-93.0,41.0,58.0,48.0,49.0,0
1029,92:69:1D:31:68:E9,3821239,484967380,3480,3455705,3817759,481511675,0,3620,930992,3523,909432,97,21560,1794,6,3606,78,0,31,216660.0,130000.0,-52.0,-50.0,-44.0,-46.0,-51.0,-49.0,-44.0,-47.0,-90.0,-93.0,-90.0,-93.0,38.0,43.0,46.0,47.0,0
1030,CC:2F:71:3F:1F:24,4404856,1165225075,587097,683713400,3817759,481511675,37,490037,557020729,489471,556952465,566,68264,472370,10,587334,44837,34,431,130000.0,39000.0,-67.0,-65.0,-70.0,-67.0,-67.0,-65.0,-70.0,-67.0,-90.0,-93.0,-90.0,-93.0,23.0,28.0,20.0,26.0,0
1031,CC:2F:71:3E:C5:1F,3818446,481595697,687,84022,3817759,481511675,0,2932,245564,2430,185884,502,59680,727,8,1018,18,0,32,130000.0,39000.0,-70.0,-71.0,-67.0,-60.0,-70.0,-70.0,-67.0,-60.0,-90.0,-93.0,-90.0,-93.0,20.0,22.0,23.0,33.0,0
1032,BA:8C:B9:54:50:24,3819489,482349425,1730,837750,3817759,481511675,0,5565,821496,5545,818374,20,3122,1004,14,2105,29,0,49,216660.0,130000.0,-49.0,-35.0,-42.0,-44.0,-42.0,-36.0,-43.0,-49.0,-90.0,-93.0,-90.0,-93.0,41.0,58.0,48.0,49.0,0
1033,92:69:1D:31:68:E9,3821242,484967642,3480,3455705,3817762,481511937,0,3620,930992,3523,909432,97,21560,1794,6,3606,78,0,31,216660.0,130000.0,-52.0,-50.0,-44.0,-46.0,-51.0,-49.0,-44.0,-47.0,-90.0,-93.0,-90.0,-93.0,38.0,43.0,46.0,47.0,0
1034,CC:2F:71:3F:1F:24,4404901,1165239709,587139,683727772,3817762,481511937,37,490063,557025649,489497,556957385,566,68264,472396,10,587376,44862,34,431,130000.0,43333.0,-67.0,-65.0,-70.0,-67.0,-67.0,-65.0,-70.0,-67.0,-90.0,-93.0,-90.0,-93.0,23.0,28.0,20.0,26.0,0
1035,CC:2F:71:3E:C5:1F,3818451,481596161,687,84022,3817764,481512139,0,2932,245564,2430,185884,502,59680,727,8,1018,18,0,32,130000.0,39000.0,-70.0,-71.0,-67.0,-60.0,-70.0,-70.0,-67.0,-60.0,-90.0,-93.0,-90.0,-93.0,20.0,22.0,23.0,33.0,0
1036,BA:8C:B9:54:50:24,3819497,482350159,1730,837750,3817767,481512409,0,5565,821496,5545,818374,20,3122,1004,14,2105,29,0,49,216660.0,130000.0,-49.0,-35.0,-42.0,-44.0,-42.0,-36.0,-43.0,-49.0,-90.0,-93.0,-90.0,-93.0,41.0,58.0,48.0,49.0,0
1037,92:69:1D:31:68:E9,3821248,484968248,3480,3455705,3817768,481512543,0,3620,930992,3523,909432,97,21560,1794,6,3606,78,0,31,216660.0,130000.0,-52.0,-50.0,-44.0,-46.0,-51.0,-49.0,-44.0,-47.0,-90.0,-93.0,-90.0,-93.0,38.0,43.0,46.0,47.0,0
1038,CC:2F:71:3F:1F:24,4404951,1165255047,587183,683742504,3817768,481512543,37,490089,557030593,489523,556962329,566,68264,472422,10,587420,44880,34,431,130000.0,39000.0,-67.0,-65.0,-71.0,-68.0,-67.0,-65.0,-70.0,-67.0,-90.0,-93.0,-90.0,-93.0,23.0,28.0,19.0,25.0,0
1039,CC:2F:71:3E:C5:1F,3818455,481596565,687,84022,3817768,481512543,0,2932,245564,2430,185884,502,59680,727,8,1018,18,0,32,130000.0,39000.0,-70.0,-71.0,-67.0,-60.0,-70.0,-70.0,-67.0,-60.0,-90.0,-93.0,-90.0,-93.0,20.0,22.0,23.0,33.0,0
1040,BA:8C:B9:54:50:24,3819500,482350661,1730,837750,3817770,481512911,0,5565,821496,5545,818374,20,3122,1004,14,2105,29,0,49,216660.0,130000.0,-49.0,-35.0,-42.0,-44.0,-42.0,-36.0,-43.0,-49.0,-90.0,-93.0,-90.0,-93.0,41.0,58.0,48.0,49.0,0
1041,92:69:1D:31:68:E9,3821253,484968878,3480,3455705,3817773,481513173,0,3620,930992,3523,909432,97,21560,1794,6,3606,78,0,31,216660.0,130000.0,-52.0,-50.0,-44.0,-46.0,-51.0,-49.0,-44.0,-47.0,-90.0,-93.0,-90.0,-93.0,38.0,43.0,46.0,47.0,0
1042,CC:2F:71:3F:1F:24,4404998,1165270049,587225,683756876,3817773,481513173,37,490116,557035653,489550,556967389,566,68264,472449,10,587462,44917,34,431,130000.0,43333.0,-67.0,-65.0,-70.0,-68.0,-67.0,-65.0,-70.0,-67.0,-90.0,-93.0,-90.0,-93.0,23.0,28.0,20.0,25.0,0
1043,CC:2F:71:3E:C5:1F,3818462,481597397,687,84022,3817775,481513375,0,2932,245564,2430,185884,502,59680,727,8,1018,18,0,32,130000.0,39000.0,-70.0,-71.0,-67.0,-60.0,-70.0,-70.0,-67.0,-60.0,-90.0,-93.0,-90.0,-93.0,20.0,22.0,23.0,33.0,0
1044,BA:8C:B9:54:50:24,3819507,482351327,1730,837750,3817777,481513577,0,5565,821496,5545,818374,20,3122,1004,14,2105,29,0,49,216660.0,130000.0,-49.0,-35.0,-42.0,-44.0,-42.0,-36.0,-43.0,-49.0,-90.0,-93.0,-90.0,-93.0,41.0,58.0,48.0,49.0,0
1045,92:69:1D:31:68:E9,3821259,484969484,3480,3455705,3817779,481513779,0,3620,930992,3523,909432,97,21560,1794,6,3606,78,0,31,216660.0,130000.0,-52.0,-50.0,-44.0,-46.0,-51.0,-49.0,-44.0,-47.0,-90.0,-93.0,-90.0,-93.0,38.0,43.0,46.0,47.0,0
1046,CC:2F:71:3F:1F:24,4405046,1165285195,587267,683771416,3817779,481513779,37,490141,557040457,489575,556972193,566,68264,472474,10,587504,44927,34,431,130000.0,43333.0,-67.0,-65.0,-70.0,-67.0,-67.0,-65.0,-70.0,-67.0,-90.0,-93.0,-90.0,-93.0,23.0,28.0,20.0,26.0,0
1047,CC:2F:71:3E:C5:1F,3818466,481597801,687,84022,3817779,481513779,0,2932,245564,2430,185884,502,59680,727,8,1018,18,0,32,130000.0,39000.0,-70.0,-71.0,-67.0,-60.0,-70.0,-70.0,-67.0,-60.0,-90.0,-93.0,-90.0,-93.0,20.0,22.0,23.0,33.0,0
1048,BA:8C:B9:54:50:24,3819509,482351529,1730,837750,3817779,481513779,0,5565,821496,5545,818374,20,3122,1004,14,2105,29,0,49,216660.0,130000.0,-49.0,-35.0,-42.0,-44.0,-42.0,-36.0,-43.0,-49.0,-90.0,-93.0,-90.0,-93.0,41.0,58.0,48.0,49.0,0
1049,92:69:1D:31:68:E9,3821261,484969686,3480,3455705,3817781,481513981,0,3620,930992,3523,909432,97,21560,1794,6,3606,78,0,31,216660.0,130000.0,-52.0,-50.0,-44.0,-46.0,-51.0,-49.0,-44.0,-47.0,-90.0,-93.0,-90.0,-93.0,38.0,43.0,46.0,47.0,0
1050,CC:2F:71:3F:1F:24,4405094,1165300337,587311,683786154,3817783,481514183,37,490166,557045261,489600,556976997,566,68264,472499,10,587548,44949,34,431,130000.0,39000.0,-67.0,-65.0,-70.0,-68.0,-67.0,-65.0,-70.0,-67.0,-90.0,-93.0,-90.0,-93.0,23.0,28.0,20.0,25.0,0
1051,CC:2F:71:3E:C5:1F,3818470,481598205,687,84022,3817783,481514183,0,2932,245564,2430,185884,502,59680,727,8,1018,18,0,32,130000.0,39000.0,-70.0,-71.0,-67.0,-60.0,-70.0,-70.0,-67.0,-60.0,-90.0,-93.0,-90.0,-93.0,20.0,22.0,23.0,33.0,0
1052,BA:8C:B9:54:50:24,3819517,482352337,1730,837750,3817787,481514587,0,5565,821496,5545,818374,20,3122,1004,14,2105,29,0,49,216660.0,130000.0,-49.0,-35.0,-42.0,-44.0,-42.0,-36.0,-43.0,-49.0,-90.0,-93.0,-90.0,-93.0,41.0,58.0,48.0,49.0,0
1053,92:69:1D:31:68:E9,3821268,484970352,3480,3455705,3817788,481514647,0,3620,930992,3523,909432,97,21560,1794,6,3606,78,0,31,216660.0,130000.0,-52.0,-50.0,-44.0,-46.0,-51.0,-49.0,-44.0,-47.0,-90.0,-93.0,-90.0,-93.0,38.0,43.0,46.0,47.0,0
1054,CC:2F:71:3F:1F:24,4405141,1165315173,587353,683800526,3817788,481514647,37,490193,557050345,489627,556982081,566,68264,472526,10,587590,44979,34,431,130000.0,43333.0,-67.0,-65.0,-70.0,-67.0,-67.0,-65.0,-70.0,-67.0,-90.0,-93.0,-90.0,-93.0,23.0,28.0,20.0,26.0,0
1055,CC:2F:71:3E:C5:1F,3818475,481598669,687,84022,3817788,481514647,0,2932,245564,2430,185884,502,59680,727,8,1018,18,0,32,130000.0,39000.0,-70.0,-71.0,-67.0,-60.0,-70.0,-70.0,-67.0,-60.0,-90.0,-93.0,-90.0,-93.0,20.0,22.0,23.0,33.0,0
1056,BA:8C:B9:54:50:24,3819518,482352397,1730,837750,3817788,481514647,0,5565,821496,5545,818374,20,3122,1004,14,2105,29,0,49,216660.0,130000.0,-49.0,-35.0,-42.0,-44.0,-42.0,-36.0,-43.0,-49.0,-90.0,-93.0,-90.0,-93.0,41.0,58.0,48.0,49.0,0
1057,92:69:1D:31:68:E9,3821270,484970554,3480,3455705,3817790,481514849,0,3620,930992,3523,909432,97,21560,1794,6,3606,78,0,31,216660.0,130000.0,-52.0,-50.0,-44.0,-46.0,-51.0,-49.0,-44.0,-47.0,-90.0,-93.0,-90.0,-93.0,38.0,43.0,46.0,47.0,0
1058,CC:2F:71:3F:1F:24,4405187,1165330055,587395,683815004,3817792,481515051,37,490218,557055149,489652,556986885,566,68264,472551,10,587632,44983,34,431,130000.0,39000.0,-67.0,-65.0,-71.0,-68.0,-67.0,-65.0,-70.0,-67.0,-90.0,-93.0,-90.0,-93.0,23.0,28.0,19.0,25.0,0
1059,CC:2F:71:3E:C5:1F,3818479,481599073,687,84022,3817792,481515051,0,2932,245564,2430,185884,502,59680,727,8,1018,18,0,32,130000.0,39000.0,-70.0,-71.0,-67.0,-60.0,-70.0,-70.0,-67.0,-60.0,-90.0,-93.0,-90.0,-93.0,20.0,22.0,23.0,33.0,0
1060,BA:8C:B9:54:50:24,3819525,482353137,1730,837750,3817795,481515387,0,5565,821496,5545,818374,20,3122,1004,14,2105,29,0,49,216660.0,130000.0,-49.0,-35.0,-42.0,-44.0,-42.0,-36.0,-43.0,-49.0,-90.0,-93.0,-90.0,-93.0,41.0,58.0,48.0,49.0,0
1061,92:69:1D:31:68:E9,3821276,484971160,3480,3455705,3817796,481515455,0,3620,930992,3523,909432,97,21560,1794,6,3606,78,0,31,216660.0,130000.0,-52.0,-50.0,-44.0,-46.0,-51.0,-49.0,-44.0,-47.0,-90.0,-93.0,-90.0,-93.0,38.0,43.0,46.0,47.0,0
1062,CC:2F:71:3F:1F:24,4405233,1165344823,587436,683829308,3817797,481515515,37,490246,557060325,489680,556992061,566,68264,472579,10,587673,44996,34,431,130000.0,39000.0,-67.0,-65.0,-71.0,-67.0,-67.0,-65.0,-70.0,-67.0,-90.0,-93.0,-90.0,-93.0,23.0,28.0,19.0,26.0,0
1063,CC:2F:71:3E:C5:1F,3818484,481599537,687,84022,3817797,481515515,0,2932,245564,2430,185884,502,59680,727,8,1018,18,0,32,130000.0,39000.0,-70.0,-71.0,-67.0,-60.0,-70.0,-70.0,-67.0,-60.0,-90.0,-93.0,-90.0,-93.0,20.0,22.0,23.0,33.0,0
1064,BA:8C:B9:54:50:24,3819527,482353265,1730,837750,3817797,481515515,0,5565,821496,5545,818374,20,3122,1004,14,2105,29,0,49,216660.0,130000.0,-49.0,-35.0,-42.0,-44.0,-42.0,-36.0,-43.0,-49.0,-90.0,-93.0,-90.0,-93.0,41.0,58.0,48.0,49.0,0
1065,92:69:1D:31:68:E9,3821282,484971686,3480,3455705,3817802,481515981,0,3620,930992,3523,909432,97,21560,1794,6,3606,78,0,31,216660.0,130000.0,-52.0,-50.0,-44.0,-46.0,-51.0,-49.0,-44.0,-47.0,-90.0,-93.0,-90.0,-93.0,38.0,43.0,46.0,47.0,0
1066,CC:2F:71:3F:1F:24,4405280,1165359717,587478,683843736,3817802,481515981,37,490273,557065385,489707,556997121,566,68264,472606,10,587715,45008,34,431,130000.0,39000.0,-67.0,-65.0,-71.0,-68.0,-67.0,-65.0,-70.0,-67.0,-90.0,-93.0,-90.0,-93.0,23.0,28.0,19.0,25.0,0
1067,CC:2F:71:3E:C5:1F,3818489,481600003,687,84022,3817802,481515981,0,2934,245752,2431,185954,503,59798,728,8,1018,18,0,32,130000.0,39000.0,-70.0,-71.0,-67.0,-60.0,-70.0,-70.0,-67.0,-60.0,-90.0,-93.0,-90.0,-93.0,20.0,22.0,23.0,33.0,0
1068,BA:8C:B9:54:50:24,3819532,482353731,1730,837750,3817802,481515981,0,5565,821496,5545,818374,20,3122,1004,14,2105,29,0,49,216660.0,130000.0,-49.0,-35.0,-42.0,-44.0,-42.0,-36.0,-43.0,-49.0,-90.0,-93.0,-90.0,-93.0,41.0,58.0,48.0,49.0,0
1069,92:69:1D:31:68:E9,3821286,484972090,3480,3455705,3817806,481516385,0,3620,930992,3523,909432,97,21560,1794,6,3606,78,0,31,216660.0,130000.0,-52.0,-50.0,-44.0,-46.0,-51.0,-49.0,-44.0,-47.0,-90.0,-93.0,-90.0,-93.0,38.0,43.0,46.0,47.0,0
1070,CC:2F:71:3F:1F:24,4405326,1165374549,587520,683858164,3817806,481516385,37,490300,557070481,489734,557002217,566,68264,472633,10,587757,45045,34,431,144444.0,43333.0,-67.0,-65.0,-71.0,-68.0,-67.0,-65.0,-70.0,-67.0,-90.0,-93.0,-90.0,-93.0,23.0,28.0,19.0,25.0,0
1071,CC:2F:71:3E:C5:1F,3818493,481600407,687,84022,3817806,481516385,0,2934,245752,2431,185954,503,59798,728,8,1018,18,0,32,130000.0,39000.0,-70.0,-71.0,-67.0,-60.0,-70.0,-70.0,-67.0,-60.0,-90.0,-93.0,-90.0,-93.0,20.0,22.0,23.0,33.0,0
1072,BA:8C:B9:54:50:24,3819536,482354135,1730,837750,3817806,481516385,0,5565,821496,5545,818374,20,3122,1004,14,2105,29,0,49,216660.0,130000.0,-49.0,-35.0,-42.0,-44.0,-42.0,-36.0,-43.0,-49.0,-90.0,-93.0,-90.0,-93.0,41.0,58.0,48.0,49.0,0
1073,92:69:1D:31:68:E9,3821291,484972554,3480,3455705,3817811,481516849,0,3620,930992,3523,909432,97,21560,1794,6,3606,78,0,31,216660.0,130000.0,-52.0,-50.0,-44.0,-46.0,-51.0,-49.0,-44.0,-47.0,-90.0,-93.0,-90.0,-93.0,38.0,43.0,46.0,47.0,0
1074,CC:2F:71:3F:1F:24,4405375,1165389745,587564,683872896,3817811,481516849,37,490327,557075541,489761,557007277,566,68264,472660,10,587801,45072,34,431,130000.0,43333.0,-67.0,-65.0,-70.0,-67.0,-67.0,-65.0,-70.0,-67.0,-90.0,-93.0,-90.0,-93.0,23.0,28.0,20.0,26.0,0
1075,CC:2F:71:3E:C5:1F,3818498,481600871,687,84022,3817811,481516849,0,2934,245752,2431,185954,503,59798,728,8,1018,18,0,32,130000.0,39000.0,-70.0,-71.0,-67.0,-60.0,-70.0,-70.0,-67.0,-60.0,-90.0,-93.0,-90.0,-93.0,20.0,22.0,23.0,33.0,0
1076,BA:8C:B9:54:50:24,3819543,482354801,1730,837750,3817813,481517051,0,5565,821496,5545,818374,20,3122,1004,14,2105,29,0,49,216660.0,130000.0,-49.0,-35.0,-42.0,-44.0,-42.0,-36.0,-43.0,-49.0,-90.0,-93.0,-90.0,-93.0,41.0,58.0,48.0,49.0,0
1077,92:69:1D:31:68:E9,3821296,484973231,3480,3455705,3817816,481517526,0,3620,930992,3523,909432,97,21560,1794,6,3606,78,0,31,216660.0,130000.0,-52.0,-50.0,-44.0,-46.0,-51.0,-49.0,-44.0,-47.0,-90.0,-93.0,-90.0,-93.0,38.0,43.0,46.0,47.0,0
1078,CC:2F:71:3F:1F:24,4405422,1165405090,587606,683887564,3817816,481517526,37,490354,557080613,489788,557012349,566,68264,472687,10,587843,45077,34,431,130000.0,43333.0,-67.0,-65.0,-70.0,-68.0,-66.0,-65.0,-70.0,-67.0,-90.0,-93.0,-90.0,-93.0,23.0,28.0,20.0,25.0,0
1079,CC:2F:71:3E:C5:1F,3818503,481601548,687,84022,3817816,481517526,0,2934,245752,2431,185954,503,59798,728,8,1018,18,0,32,130000.0,39000.0,-70.0,-71.0,-67.0,-60.0,-70.0,-70.0,-67.0,-60.0,-90.0,-93.0,-90.0,-93.0,20.0,22.0,23.0,33.0,0
1080,BA:8C:B9:54:50:24,3819546,482355276,1730,837750,3817816,481517526,0,5565,821496,5545,818374,20,3122,1004,14,2105,29,0,49,216660.0,130000.0,-49.0,-35.0,-42.0,-44.0,-42.0,-36.0,-43.0,-49.0,-90.0,-93.0,-90.0,-93.0,41.0,58.0,48.0,49.0,0
1081,92:69:1D:31:68:E9,3821300,484973635,3480,3455705,3817820,481517930,0,3620,930992,3523,909432,97,21560,1794,6,3606,78,0,31,216660.0,130000.0,-52.0,-50.0,-44.0,-46.0,-51.0,-49.0,-44.0,-47.0,-90.0,-93.0,-90.0,-93.0,38.0,43.0,46.0,47.0,0
1082,CC:2F:71:3F:1F:24,4405468,1165419922,587648,683901992,3817820,481517930,37,490379,557085417,489813,557017153,566,68264,472712,10,587885,45096,34,431,117000.0,39000.0,-67.0,-65.0,-70.0,-68.0,-67.0,-65.0,-70.0,-67.0,-90.0,-93.0,-90.0,-93.0,23.0,28.0,20.0,25.0,0
1083,CC:2F:71:3E:C5:1F,3818507,481601952,687,84022,3817820,481517930,0,2934,245752,2431,185954,503,59798,728,8,1018,18,0,32,130000.0,39000.0,-70.0,-71.0,-67.0,-60.0,-70.0,-70.0,-67.0,-60.0,-90.0,-93.0,-90.0,-93.0,20.0,22.0,23.0,33.0,0
1084,BA:8C:B9:54:50:24,3819552,482355882,1730,837750,3817822,481518132,0,5565,821496,5545,818374,20,3122,1004,14,2105,29,0,49,216660.0,130000.0,-49.0,-35.0,-42.0,-44.0,-42.0,-36.0,-43.0,-49.0,-90.0,-93.0,-90.0,-93.0,41.0,58.0,48.0,49.0,0
1085,92:69:1D:31:68:E9,3821305,484974099,3480,3455705,3817825,481518394,0,3620,930992,3523,909432,97,21560,1794,6,3606,78,0,31,216660.0,130000.0,-52.0,-50.0,-44.0,-46.0,-51.0,-49.0,-44.0,-47.0,-90.0,-93.0,-90.0,-93.0,38.0,43.0,46.0,47.0,0
1086,CC:2F:71:3F:1F:24,4405517,1165435068,587692,683916674,3817825,481518394,37,490406,557090477,489840,557022213,566,68264,472739,10,587929,45101,34,431,130000.0,43333.0,-67.0,-65.0,-70.0,-68.0,-67.0,-65.0,-70.0,-67.0,-90.0,-93.0,-90.0,-93.0,23.0,28.0,20.0,25.0,0
1087,CC:2F:71:3E:C5:1F,3818512,481602416,687,84022,3817825,481518394,0,2934,245752,2431,185954,503,59798,728,8,1018,18,0,32,130000.0,39000.0,-70.0,-71.0,-67.0,-60.0,-70.0,-70.0,-67.0,-60.0,-90.0,-93.0,-90.0,-93.0,20.0,22.0,23.0,33.0,0
1088,BA:8C:B9:54:50:24,3819555,482356144,1730,837750,3817825,481518394,0,5566,821564,5546,818442,20,3122,1004,14,2105,29,0,49,216660.0,130000.0,-40.0,-37.0,-44.0,-52.0,-42.0,-36.0,-43.0,-49.0,-90.0,-93.0,-90.0,-93.0,50.0,56.0,46.0,41.0,0
1089,92:69:1D:31:68:E9,3821309,484974503,3480,3455705,3817829,481518798,0,3620,930992,3523,909432,97,21560,1794,6,3606,78,0,31,216660.0,130000.0,-52.0,-50.0,-44.0,-46.0,-51.0,-49.0,-44.0,-47.0,-90.0,-93.0,-90.0,-93.0,38.0,43.0,46.0,47.0,0
1090,CC:2F:71:3F:1F:24,4405562,1165449776,587733,683930978,3817829,481518798,37,490432,557095421,489866,557027157,566,68264,472765,10,587970,45127,34,431,117000.0,39000.0,-67.0,-65.0,-70.0,-67.0,-67.0,-65.0,-70.0,-67.0,-90.0,-93.0,-90.0,-93.0,23.0,28.0,20.0,26.0,0
1091,CC:2F:71:3E:C5:1F,3818516,481602820,687,84022,3817829,481518798,0,2934,245752,2431,185954,503,59798,728,8,1018,18,0,32,130000.0,39000.0,-70.0,-71.0,-67.0,-60.0,-70.0,-70.0,-67.0,-60.0,-90.0,-93.0,-90.0,-93.0,20.0,22.0,23.0,33.0,0
1092,BA:8C:B9:54:50:24,3819561,482356750,1730,837750,3817831,481519000,0,5566,821564,5546,818442,20,3122,1004,14,2105,29,0,49,216660.0,130000.0,-40.0,-37.0,-44.0,-52.0,-42.0,-36.0,-43.0,-49.0,-90.0,-93.0,-90.0,-93.0,50.0,56.0,46.0,41.0,0
1093,92:69:1D:31:68:E9,3821314,484974967,3480,3455705,3817834,481519262,0,3620,930992,3523,909432,97,21560,1794,6,3606,78,0,31,216660.0,130000.0,-52.0,-50.0,-44.0,-46.0,-51.0,-49.0,-44.0,-47.0,-90.0,-93.0,-90.0,-93.0,38.0,43.0,46.0,47.0,0
1094,CC:2F:71:3F:1F:24,4405609,1165464668,587775,683945406,3817834,481519262,37,490458,557100365,489892,557032101,566,68264,472791,10,588012,45137,34,431,130000.0,43333.0,-67.0,-65.0,-71.0,-68.0,-67.0,-65.0,-70.0,-67.0,-90.0,-93.0,-90.0,-93.0,23.0,28.0,19.0,25.0,0
1095,CC:2F:71:3E:C5:1F,3818521,481603284,687,84022,3817834,481519262,0,2934,245752,2431,185954,503,59798,728,8,1018,18,0,32,130000.0,39000.0,-70.0,-71.0,-67.0,-60.0,-70.0,-70.0,-67.0,-60.0,-90.0,-93.0,-90.0,-93.0,20.0,22.0,23.0,33.0,0
1096,BA:8C:B9:54:50:24,3819564,482357012,1730,837750,3817834,481519262,0,5566,821564,5546,818442,20,3122,1004,14,2105,29,0,49,216660.0,130000.0,-40.0,-37.0,-44.0,-52.0,-42.0,-36.0,-43.0,-49.0,-90.0,-93.0,-90.0,-93.0,50.0,56.0,46.0,41.0,0
1097,92:69:1D:31:68:E9,3821318,484975371,3480,3455705,3817838,481519666,0,3620,930992,3523,909432,97,21560,1794,6,3606,78,0,31,216660.0,130000.0,-52.0,-50.0,-44.0,-46.0,-51.0,-49.0,-44.0,-47.0,-90.0,-93.0,-90.0,-93.0,38.0,43.0,46.0,47.0,0
1098,CC:2F:71:3F:1F:24,4405655,1165479612,587817,683959946,3817838,481519666,37,490485,557105449,489919,557037185,566,68264,472818,10,588054,45142,34,431,130000.0,43333.0,-67.0,-65.0,-70.0,-67.0,-67.0,-65.0,-70.0,-67.0,-90.0,-93.0,-90.0,-93.0,23.0,28.0,20.0,26.0,0
1099,CC:2F:71:3E:C5:1F,3818525,481603688,687,84022,3817838,481519666,0,2934,245752,2431,185954,503,59798,728,8,1018,18,0,32,130000.0,39000.0,-70.0,-71.0,-67.0,-60.0,-70.0,-70.0,-67.0,-60.0,-90.0,-93.0,-90.0,-93.0,20.0,22.0,23.0,33.0,0
1100,BA:8C:B9:54:50:24,3819570,482357618,1730,837750,3817840,481519868,0,5566,821564,5546,818442,20,3122,1004,14,2105,29,0,49,216660.0,130000.0,-40.0,-37.0,-44.0,-52.0,-42.0,-36.0,-43.0,-49.0,-90.0,-93.0,-90.0,-93.0,50.0,56.0,46.0,41.0,0
1101,92:69:1D:31:68:E9,3821322,484975775,3480,3455705,3817842,481520070,0,3620,930992,3523,909432,97,21560,1794,6,3606,78,0,31,216660.0,130000.0,-52.0,-50.0,-44.0,-46.0,-51.0,-49.0,-44.0,-47.0,-90.0,-93.0,-90.0,-93.0,38.0,43.0,46.0,47.0,0
1102,CC:2F:71:3F:1F:24,4405703,1165494692,587861,683974622,3817842,481520070,37,490511,557110393,489945,557042129,566,68264,472844,10,588097,45157,34,431,117000.0,39000.0,-67.0,-65.0,-70.0,-67.0,-67.0,-65.0,-70.0,-67.0,-90.0,-93.0,-90.0,-93.0,23.0,28.0,20.0,26.0,0
1103,CC:2F:71:3E:C5:1F,3818529,481604092,687,84022,3817842,481520070,0,2934,245752,2431,185954,503,59798,728,8,1018,18,0,32,130000.0,39000.0,-70.0,-71.0,-67.0,-60.0,-70.0,-70.0,-67.0,-60.0,-90.0,-93.0,-90.0,-93.0,20.0,22.0,23.0,33.0,0
1104,BA:8C:B9:54:50:24,3819572,482357820,1730,837750,3817842,481520070,0,5566,821564,5546,818442,20,3122,1004,14,2105,29,0,49,216660.0,130000.0,-40.0,-37.0,-44.0,-52.0,-42.0,-36.0,-43.0,-49.0,-90.0,-93.0,-90.0,-93.0,50.0,56.0,46.0,41.0,0
1105,92:69:1D:31:68:E9,3821327,484976239,3480,3455705,3817847,481520534,0,3620,930992,3523,909432,97,21560,1794,6,3606,78,0,31,216660.0,130000.0,-52.0,-50.0,-44.0,-46.0,-51.0,-49.0,-44.0,-47.0,-90.0,-93.0,-90.0,-93.0,38.0,43.0,46.0,47.0,0
1106,CC:2F:71:3F:1F:24,4405748,1165509336,587901,683988802,3817847,481520534,37,490537,557115313,489971,557047049,566,68264,472870,10,588138,45165,34,431,130000.0,43333.0,-67.0,-65.0,-70.0,-68.0,-67.0,-65.0,-70.0,-67.0,-90.0,-93.0,-90.0,-93.0,23.0,28.0,20.0,25.0,0
1107,CC:2F:71:3E:C5:1F,3818534,481604556,687,84022,3817847,481520534,0,2934,245752,2431,185954,503,59798,728,8,1018,18,0,32,130000.0,39000.0,-70.0,-71.0,-67.0,-60.0,-70.0,-70.0,-67.0,-60.0,-90.0,-93.0,-90.0,-93.0,20.0,22.0,23.0,33.0,0
1108,BA:8C:B9:54:50:24,3819579,482358486,1730,837750,3817849,481520736,0,5566,821564,5546,818442,20,3122,1004,14,2105,29,0,49,216660.0,130000.0,-40.0,-37.0,-44.0,-52.0,-42.0,-36.0,-43.0,-49.0,-90.0,-93.0,-90.0,-93.0,50.0,56.0,46.0,41.0,0
1109,92:69:1D:31:68:E9,3821331,484976643,3480,3455705,3817851,481520938,0,3620,930992,3523,909432,97,21560,1794,6,3606,78,0,31,216660.0,130000.0,-52.0,-50.0,-44.0,-46.0,-51.0,-49.0,-44.0,-47.0,-90.0,-93.0,-90.0,-93.0,38.0,43.0,46.0,47.0,0
1110,CC:2F:71:3F:1F:24,4405794,1165524280,587943,684003342,3817851,481520938,37,490562,557120117,489996,557051853,566,68264,472895,10,588180,45169,34,431,130000.0,43333.0,-67.0,-65.0,-70.0,-68.0,-67.0,-65.0,-70.0,-67.0,-90.0,-93.0,-90.0,-93.0,23.0,28.0,20.0,25.0,0
1111,CC:2F:71:3E:C5:1F,3818538,481604960,687,84022,3817851,481520938,0,2934,245752,2431,185954,503,59798,728,8,1018,18,0,32,130000.0,39000.0,-70.0,-71.0,-67.0,-60.0,-70.0,-70.0,-67.0,-60.0,-90.0,-93.0,-90.0,-93.0,20.0,22.0,23.0,33.0,0
1112,BA:8C:B9:54:50:24,3819581,482358688,1730,837750,3817851,481520938,0,5566,821564,5546,818442,20,3122,1004,14,2105,29,0,49,216660.0,130000.0,-40.0,-37.0,-44.0,-52.0,-42.0,-36.0,-43.0,-49.0,-90.0,-93.0,-90.0,-93.0,50.0,56.0,46.0,41.0,0
1113,92:69:1D:31:68:E9,3821335,484977047,3480,3455705,3817855,481521342,0,3620,930992,3523,909432,97,21560,1794,6,3606,78,0,31,216660.0,130000.0,-52.0,-50.0,-44.0,-46.0,-51.0,-49.0,-44.0,-47.0,-90.0,-93.0,-90.0,-93.0,38.0,43.0,46.0,47.0,0
1114,CC:2F:71:3F:1F:24,4405842,1165539372,587987,684018030,3817855,481521342,37,490588,557125061,490022,557056797,566,68264,472921,10,588224,45193,34,431,117000.0,39000.0,-67.0,-65.0,-70.0,-68.0,-67.0,-65.0,-70.0,-67.0,-90.0,-93.0,-90.0,-93.0,23.0,28.0,20.0,25.0,0
1115,CC:2F:71:3E:C5:1F,3818542,481605364,687,84022,3817855,481521342,0,2934,245752,2431,185954,503,59798,728,8,1018,18,0,32,130000.0,39000.0,-70.0,-71.0,-67.0,-60.0,-70.0,-70.0,-67.0,-60.0,-90.0,-93.0,-90.0,-93.0,20.0,22.0,23.0,33.0,0
1116,BA:8C:B9:54:50:24,3819587,482359294,1730,837750,3817857,481521544,0,5566,821564,5546,818442,20,3122,1004,14,2105,29,0,49,216660.0,130000.0,-40.0,-37.0,-44.0,-52.0,-42.0,-36.0,-43.0,-49.0,-90.0,-93.0,-90.0,-93.0,50.0,56.0,46.0,41.0,0
1117,92:69:1D:31:68:E9,3821340,484977511,3480,3455705,3817860,481521806,0,3620,930992,3523,909432,97,21560,1794,6,3606,78,0,31,216660.0,130000.0,-52.0,-50.0,-44.0,-46.0,-51.0,-49.0,-44.0,-47.0,-90.0,-93.0,-90.0,-93.0,38.0,43.0,46.0,47.0,0
1118,CC:2F:71:3F:1F:24,4405891,1165554518,588031,684032712,3817860,481521806,37,490615,557130145,490049,557061881,566,68264,472948,10,588268,45200,34,431,130000.0,43333.0,-67.0,-65.0,-70.0,-67.0,-67.0,-65.0,-70.0,-67.0,-90.0,-93.0,-90.0,-93.0,23.0,28.0,20.0,26.0,0
1119,CC:2F:71:3E:C5:1F,3818547,481605828,687,84022,3817860,481521806,0,2934,245752,2431,185954,503,59798,728,8,1018,18,0,32,130000.0,39000.0,-70.0,-71.0,-67.0,-60.0,-70.0,-70.0,-67.0,-60.0,-90.0,-93.0,-90.0,-93.0,20.0,22.0,23.0,33.0,0
1120,BA:8C:B9:54:50:24,3819590,482359556,1730,837750,3817860,481521806,0,5566,821564,5546,818442,20,3122,1004,14,2105,29,0,49,216660.0,130000.0,-40.0,-37.0,-44.0,-52.0,-42.0,-36.0,-43.0,-49.0,-90.0,-93.0,-90.0,-93.0,50.0,56.0,46.0,41.0,0
1121,92:69:1D:31:68:E9,3821342,484977713,3480,3455705,3817862,481522008,0,3620,930992,3523,909432,97,21560,1794,6,3606,78,0,31,216660.0,130000.0,-52.0,-50.0,-44.0,-46.0,-51.0,-49.0,-44.0,-47.0,-90.0,-93.0,-90.0,-93.0,38.0,43.0,46.0,47.0,0
1122,CC:2F:71:3F:1F:24,4405938,1165569468,588074,684047258,3817864,481522210,37,490642,557135283,490076,557067019,566,68264,472974,10,588311,45220,34,431,117000.0,39000.0,-67.0,-65.0,-71.0,-68.0,-67.0,-65.0,-70.0,-67.0,-90.0,-93.0,-90.0,-93.0,23.0,28.0,19.0,25.0,0
1123,CC:2F:71:3E:C5:1F,3818551,481606232,687,84022,3817864,481522210,0,2934,245752,2431,185954,503,59798,728,8,1018,18,0,32,130000.0,39000.0,-70.0,-71.0,-67.0,-60.0,-70.0,-70.0,-67.0,-60.0,-90.0,-93.0,-90.0,-93.0,20.0,22.0,23.0,33.0,0
1124,BA:8C:B9:54:50:24,3819596,482360162,1730,837750,3817866,481522412,0,5566,821564,5546,818442,20,3122,1004,14,2105,29,0,49,216660.0,130000.0,-40.0,-37.0,-44.0,-52.0,-42.0,-36.0,-43.0,-49.0,-90.0,-93.0,-90.0,-93.0,50.0,56.0,46.0,41.0,0
1125,92:69:1D:31:68:E9,3821349,484978379,3480,3455705,3817869,481522674,0,3620,930992,3523,909432,97,21560,1794,6,3606,78,0,31,216660.0,130000.0,-52.0,-50.0,-44.0,-46.0,-51.0,-49.0,-44.0,-47.0,-90.0,-93.0,-90.0,-93.0,38.0,43.0,46.0,47.0,0
1126,CC:2F:71:3F:1F:24,4405986,1165584490,588117,684061816,3817869,481522674,37,490667,557140087,490101,557071823,566,68264,472999,10,588354,45228,34,431,130000.0,43333.0,-67.0,-65.0,-71.0,-68.0,-67.0,-65.0,-70.0,-67.0,-90.0,-93.0,-90.0,-93.0,23.0,28.0,19.0,25.0,0
1127,CC:2F:71:3E:C5:1F,3818556,481606696,687,84022,3817869,481522674,0,2934,245752,2431,185954,503,59798,728,8,1018,18,0,32,130000.0,39000.0,-70.0,-71.0,-67.0,-60.0,-70.0,-70.0,-67.0,-60.0,-90.0,-93.0,-90.0,-93.0,20.0,22.0,23.0,33.0,0
1128,BA:8C:B9:54:50:24,3819599,482360424,1730,837750,3817869,481522674,0,5566,821564,5546,818442,20,3122,1004,14,2105,29,0,49,216660.0,130000.0,-40.0,-37.0,-44.0,-52.0,-42.0,-36.0,-43.0,-49.0,-90.0,-93.0,-90.0,-93.0,50.0,56.0,46.0,41.0,0
1129,92:69:1D:31:68:E9,3821353,484978970,3481,3455821,3817872,481523149,0,3622,931128,3525,909568,97,21560,1794,6,3607,78,0,31,216660.0,130000.0,-51.0,-47.0,-42.0,-49.0,-51.0,-49.0,-43.0,-47.0,-90.0,-93.0,-90.0,-93.0,39.0,46.0,48.0,44.0,0
1130,CC:2F:71:3F:1F:24,4406033,1165599699,588159,684076348,3817874,481523351,37,490692,557144891,490126,557076627,566,68264,473024,10,588396,45234,34,431,130000.0,43333.0,-67.0,-65.0,-70.0,-68.0,-67.0,-65.0,-70.0,-67.0,-90.0,-93.0,-90.0,-93.0,23.0,28.0,20.0,25.0,0
1131,CC:2F:71:3E:C5:1F,3818562,481607489,688,84138,3817874,481523351,0,2936,245892,2433,186094,503,59798,728,8,1019,18,0,32,130000.0,39000.0,-78.0,-86.0,-75.0,-71.0,-71.0,-72.0,-68.0,-61.0,-90.0,-93.0,-90.0,-93.0,12.0,7.0,15.0,22.0,0
1132,BA:8C:B9:54:50:24,3819607,482361419,1731,837866,3817876,481523553,0,5568,821700,5548,818578,20,3122,1004,14,2106,29,0,49,216660.0,130000.0,-49.0,-35.0,-42.0,-44.0,-42.0,-36.0,-43.0,-49.0,-90.0,-93.0,-90.0,-93.0,41.0,58.0,48.0,49.0,0
1133,92:69:1D:31:68:E9,3821359,484979576,3481,3455821,3817878,481523755,0,3622,931128,3525,909568,97,21560,1794,6,3607,78,0,31,216660.0,130000.0,-51.0,-47.0,-42.0,-49.0,-51.0,-49.0,-43.0,-47.0,-90.0,-93.0,-90.0,-93.0,39.0,46.0,48.0,44.0,0
1134,CC:2F:71:3F:1F:24,4406081,1165614841,588203,684091086,3817878,481523755,37,490717,557149695,490151,557081431,566,68264,473049,10,588440,45250,34,431,130000.0,39000.0,-67.0,-65.0,-70.0,-67.0,-67.0,-65.0,-70.0,-67.0,-90.0,-93.0,-90.0,-93.0,23.0,28.0,20.0,26.0,0
1135,CC:2F:71:3E:C5:1F,3818566,481607893,688,84138,3817878,481523755,0,2936,245892,2433,186094,503,59798,728,8,1019,18,0,32,130000.0,39000.0,-78.0,-86.0,-75.0,-71.0,-71.0,-72.0,-68.0,-61.0,-90.0,-93.0,-90.0,-93.0,12.0,7.0,15.0,22.0,0
1136,BA:8C:B9:54:50:24,3819609,482361621,1731,837866,3817878,481523755,0,5568,821700,5548,818578,20,3122,1004,14,2106,29,0,49,216660.0,130000.0,-49.0,-35.0,-42.0,-44.0,-42.0,-36.0,-43.0,-49.0,-90.0,-93.0,-90.0,-93.0,41.0,58.0,48.0,49.0,0
1137,92:69:1D:31:68:E9,3821362,484979838,3481,3455821,3817881,481524017,0,3622,931128,3525,909568,97,21560,1794,6,3607,78,0,31,216660.0,130000.0,-51.0,-47.0,-42.0,-49.0,-51.0,-49.0,-43.0,-47.0,-90.0,-93.0,-90.0,-93.0,39.0,46.0,48.0,44.0,0
1138,CC:2F:71:3F:1F:24,4406130,1165629925,588247,684105706,3817883,481524219,37,490744,557154779,490178,557086515,566,68264,473076,10,588484,45264,34,431,130000.0,43333.0,-67.0,-65.0,-70.0,-67.0,-67.0,-65.0,-70.0,-67.0,-90.0,-93.0,-90.0,-93.0,23.0,28.0,20.0,26.0,0
1139,CC:2F:71:3E:C5:1F,3818571,481608357,688,84138,3817883,481524219,0,2936,245892,2433,186094,503,59798,728,8,1019,18,0,32,130000.0,39000.0,-78.0,-86.0,-75.0,-71.0,-71.0,-72.0,-68.0,-61.0,-90.0,-93.0,-90.0,-93.0,12.0,7.0,15.0,22.0,0
1140,BA:8C:B9:54:50:24,3819616,482362287,1731,837866,3817885,481524421,0,5568,821700,5548,818578,20,3122,1004,14,2106,29,0,49,216660.0,130000.0,-49.0,-35.0,-42.0,-44.0,-42.0,-36.0,-43.0,-49.0,-90.0,-93.0,-90.0,-93.0,41.0,58.0,48.0,49.0,0
1141,92:69:1D:31:68:E9,3821368,484980444,3481,3455821,3817887,481524623,0,3622,931128,3525,909568,97,21560,1794,6,3607,78,0,31,216660.0,130000.0,-51.0,-47.0,-42.0,-49.0,-51.0,-49.0,-43.0,-47.0,-90.0,-93.0,-90.0,-93.0,39.0,46.0,48.0,44.0,0
1142,CC:2F:71:3F:1F:24,4406175,1165644739,588288,684120116,3817887,481524623,37,490770,557159699,490204,557091435,566,68264,473102,10,588525,45266,34,431,130000.0,43333.0,-67.0,-65.0,-71.0,-67.0,-67.0,-65.0,-70.0,-67.0,-90.0,-93.0,-90.0,-93.0,23.0,28.0,19.0,26.0,0
1143,CC:2F:71:3E:C5:1F,3818575,481608761,688,84138,3817887,481524623,0,2936,245892,2433,186094,503,59798,728,8,1019,18,0,32,130000.0,39000.0,-78.0,-86.0,-75.0,-71.0,-71.0,-72.0,-68.0,-61.0,-90.0,-93.0,-90.0,-93.0,12.0,7.0,15.0,22.0,0
1144,BA:8C:B9:54:50:24,3819618,482362489,1731,837866,3817887,481524623,0,5568,821700,5548,818578,20,3122,1004,14,2106,29,0,49,216660.0,130000.0,-49.0,-35.0,-42.0,-44.0,-42.0,-36.0,-43.0,-49.0,-90.0,-93.0,-90.0,-93.0,41.0,58.0,48.0,49.0,0
1145,92:69:1D:31:68:E9,3821370,484980646,3481,3455821,3817889,481524825,0,3622,931128,3525,909568,97,21560,1794,6,3607,78,0,31,216660.0,130000.0,-51.0,-47.0,-42.0,-49.0,-51.0,-49.0,-43.0,-47.0,-90.0,-93.0,-90.0,-93.0,39.0,46.0,48.0,44.0,0
1146,CC:2F:71:3F:1F:24,4406219,1165659369,588330,684134544,3817889,481524825,37,490797,557164783,490231,557096519,566,68264,473129,10,588567,45282,34,431,117000.0,39000.0,-67.0,-65.0,-70.0,-68.0,-67.0,-65.0,-70.0,-67.0,-90.0,-93.0,-90.0,-93.0,23.0,28.0,20.0,25.0,0
1147,CC:2F:71:3E:C5:1F,3818578,481609023,688,84138,3817890,481524885,0,2936,245892,2433,186094,503,59798,728,8,1019,18,0,32,130000.0,39000.0,-78.0,-86.0,-75.0,-71.0,-71.0,-72.0,-68.0,-61.0,-90.0,-93.0,-90.0,-93.0,12.0,7.0,15.0,22.0,0
1148,BA:8C:B9:54:50:24,3819623,482362953,1731,837866,3817892,481525087,0,5568,821700,5548,818578,20,3122,1004,14,2106,29,0,49,216660.0,130000.0,-49.0,-35.0,-42.0,-44.0,-42.0,-36.0,-43.0,-49.0,-90.0,-93.0,-90.0,-93.0,41.0,58.0,48.0,49.0,0
1149,92:69:1D:31:68:E9,3821377,484981312,3481,3455821,3817896,481525491,0,3622,931128,3525,909568,97,21560,1794,6,3607,78,0,31,216660.0,130000.0,-51.0,-47.0,-42.0,-49.0,-51.0,-49.0,-43.0,-47.0,-90.0,-93.0,-90.0,-93.0,39.0,46.0,48.0,44.0,0
1150,CC:2F:71:3F:1F:24,4406269,1165674531,588373,684149040,3817896,481525491,37,490824,557169867,490258,557101603,566,68264,473156,10,588610,45297,34,431,130000.0,39000.0,-67.0,-65.0,-70.0,-68.0,-67.0,-65.0,-70.0,-67.0,-90.0,-93.0,-90.0,-93.0,23.0,28.0,20.0,25.0,0
1151,CC:2F:71:3E:C5:1F,3818584,481609629,688,84138,3817896,481525491,0,2936,245892,2433,186094,503,59798,728,8,1019,18,0,32,130000.0,39000.0,-78.0,-86.0,-75.0,-71.0,-71.0,-72.0,-68.0,-61.0,-90.0,-93.0,-90.0,-93.0,12.0,7.0,15.0,22.0,0
1152,BA:8C:B9:54:50:24,3819628,482363419,1731,837866,3817897,481525553,0,5568,821700,5548,818578,20,3122,1004,14,2106,29,0,49,216660.0,130000.0,-49.0,-35.0,-42.0,-44.0,-42.0,-36.0,-43.0,-49.0,-90.0,-93.0,-90.0,-93.0,41.0,58.0,48.0,49.0,0
1153,92:69:1D:31:68:E9,3821381,484981638,3481,3455821,3817900,481525817,0,3622,931128,3525,909568,97,21560,1794,6,3607,78,0,31,216660.0,130000.0,-51.0,-47.0,-42.0,-49.0,-51.0,-49.0,-43.0,-47.0,-90.0,-93.0,-90.0,-93.0,39.0,46.0,48.0,44.0,0
1154,CC:2F:71:3F:1F:24,4406315,1165689285,588415,684163468,3817900,481525817,37,490851,557174929,490284,557106547,567,68382,473183,10,588652,45314,34,431,130000.0,39000.0,-67.0,-65.0,-70.0,-68.0,-67.0,-65.0,-70.0,-67.0,-90.0,-93.0,-90.0,-93.0,23.0,28.0,20.0,25.0,0
1155,CC:2F:71:3E:C5:1F,3818588,481609955,688,84138,3817900,481525817,0,2938,246080,2434,186164,504,59916,729,8,1019,18,0,32,130000.0,39000.0,-70.0,-71.0,-67.0,-60.0,-71.0,-72.0,-68.0,-61.0,-90.0,-93.0,-90.0,-93.0,20.0,22.0,23.0,33.0,0
1156,BA:8C:B9:54:50:24,3819633,482363885,1731,837866,3817902,481526019,0,5568,821700,5548,818578,20,3122,1004,14,2106,29,0,49,216660.0,130000.0,-49.0,-35.0,-42.0,-44.0,-42.0,-36.0,-43.0,-49.0,-90.0,-93.0,-90.0,-93.0,41.0,58.0,48.0,49.0,0
1157,92:69:1D:31:68:E9,3821388,484982304,3481,3455821,3817907,481526483,0,3622,931128,3525,909568,97,21560,1794,6,3607,78,0,31,216660.0,130000.0,-51.0,-47.0,-42.0,-49.0,-51.0,-49.0,-43.0,-47.0,-90.0,-93.0,-90.0,-93.0,39.0,46.0,48.0,44.0,0
1158,CC:2F:71:3F:1F:24,4406364,1165704379,588457,684177896,3817907,481526483,37,490876,557179733,490309,557111351,567,68382,473208,10,588694,45331,34,431,130000.0,39000.0,-67.0,-65.0,-70.0,-67.0,-67.0,-65.0,-70.0,-67.0,-90.0,-93.0,-90.0,-93.0,23.0,28.0,20.0,26.0,0
1159,CC:2F:71:3E:C5:1F,3818595,481610621,688,84138,3817907,481526483,0,2938,246080,2434,186164,504,59916,729,8,1019,18,0,32,130000.0,39000.0,-70.0,-71.0,-67.0,-60.0,-71.0,-72.0,-68.0,-61.0,-90.0,-93.0,-90.0,-93.0,20.0,22.0,23.0,33.0,0
1160,BA:8C:B9:54:50:24,3819638,482364349,1731,837866,3817907,481526483,0,5568,821700,5548,818578,20,3122,1004,14,2106,29,0,49,216660.0,130000.0,-49.0,-35.0,-42.0,-44.0,-42.0,-36.0,-43.0,-49.0,-90.0,-93.0,-90.0,-93.0,41.0,58.0,48.0,49.0,0
1161,92:69:1D:31:68:E9,3821390,484982506,3481,3455821,3817909,481526685,0,3622,931128,3525,909568,97,21560,1794,6,3607,78,0,31,216660.0,130000.0,-51.0,-47.0,-42.0,-49.0,-51.0,-49.0,-43.0,-47.0,-90.0,-93.0,-90.0,-93.0,39.0,46.0,48.0,44.0,0
1162,CC:2F:71:3F:1F:24,4406409,1165719139,588500,684192454,3817909,481526685,37,490901,557184537,490334,557116155,567,68382,473233,10,588737,45344,34,431,130000.0,39000.0,-67.0,-65.0,-70.0,-67.0,-67.0,-65.0,-70.0,-67.0,-90.0,-93.0,-90.0,-93.0,23.0,28.0,20.0,26.0,0
1163,CC:2F:71:3E:C5:1F,3818599,481611025,688,84138,3817911,481526887,0,2938,246080,2434,186164,504,59916,729,8,1019,18,0,32,130000.0,39000.0,-70.0,-71.0,-67.0,-60.0,-71.0,-72.0,-68.0,-61.0,-90.0,-93.0,-90.0,-93.0,20.0,22.0,23.0,33.0,0
1164,BA:8C:B9:54:50:24,3819642,482364753,1731,837866,3817911,481526887,0,5568,821700,5548,818578,20,3122,1004,14,2106,29,0,49,216660.0,130000.0,-49.0,-35.0,-42.0,-44.0,-42.0,-36.0,-43.0,-49.0,-90.0,-93.0,-90.0,-93.0,41.0,58.0,48.0,49.0,0
1165,92:69:1D:31:68:E9,3821396,484983112,3481,3455821,3817915,481527291,0,3622,931128,3525,909568,97,21560,1794,6,3607,78,0,31,216660.0,130000.0,-51.0,-47.0,-42.0,-49.0,-51.0,-49.0,-43.0,-47.0,-90.0,-93.0,-90.0,-93.0,39.0,46.0,48.0,44.0,0
1166,CC:2F:71:3F:1F:24,4406458,1165734353,588543,684207062,3817915,481527291,37,490928,557189621,490361,557121239,567,68382,473260,10,588780,45354,34,431,130000.0,43333.0,-67.0,-65.0,-70.0,-67.0,-67.0,-65.0,-70.0,-67.0,-90.0,-93.0,-90.0,-93.0,23.0,28.0,20.0,26.0,0
1167,CC:2F:71:3E:C5:1F,3818603,481611429,688,84138,3817915,481527291,0,2938,246080,2434,186164,504,59916,729,8,1019,18,0,32,130000.0,39000.0,-70.0,-71.0,-67.0,-60.0,-71.0,-72.0,-68.0,-61.0,-90.0,-93.0,-90.0,-93.0,20.0,22.0,23.0,33.0,0
1168,BA:8C:B9:54:50:24,3819646,482365157,1731,837866,3817915,481527291,0,5568,821700,5548,818578,20,3122,1004,14,2106,29,0,49,216660.0,130000.0,-49.0,-35.0,-42.0,-44.0,-42.0,-36.0,-43.0,-49.0,-90.0,-93.0,-90.0,-93.0,41.0,58.0,48.0,49.0,0
1169,92:69:1D:31:68:E9,3821399,484983374,3481,3455821,3817918,481527553,0,3623,931196,3526,909636,97,21560,1794,6,3607,78,0,31,216660.0,130000.0,-52.0,-50.0,-44.0,-46.0,-51.0,-49.0,-43.0,-46.0,-90.0,-93.0,-90.0,-93.0,38.0,43.0,46.0,47.0,0
1170,CC:2F:71:3F:1F:24,4406504,1165749223,588586,684221670,3817918,481527553,37,490953,557194425,490386,557126043,567,68382,473285,10,588823,45375,34,431,130000.0,39000.0,-67.0,-65.0,-70.0,-67.0,-67.0,-65.0,-70.0,-67.0,-90.0,-93.0,-90.0,-93.0,23.0,28.0,20.0,26.0,0
1171,CC:2F:71:3E:C5:1F,3818606,481611691,688,84138,3817918,481527553,0,2938,246080,2434,186164,504,59916,729,8,1019,18,0,32,130000.0,39000.0,-70.0,-71.0,-67.0,-60.0,-71.0,-72.0,-68.0,-61.0,-90.0,-93.0,-90.0,-93.0,20.0,22.0,23.0,33.0,0
1172,BA:8C:B9:54:50:24,3819649,482365419,1731,837866,3817918,481527553,0,5568,821700,5548,818578,20,3122,1004,14,2106,29,0,49,216660.0,130000.0,-49.0,-35.0,-42.0,-44.0,-42.0,-36.0,-43.0,-49.0,-90.0,-93.0,-90.0,-93.0,41.0,58.0,48.0,49.0,0
1173,92:69:1D:31:68:E9,3821405,484983980,3481,3455821,3817924,481528159,0,3623,931196,3526,909636,97,21560,1794,6,3607,78,0,31,216660.0,130000.0,-52.0,-50.0,-44.0,-46.0,-51.0,-49.0,-43.0,-46.0,-90.0,-93.0,-90.0,-93.0,38.0,43.0,46.0,47.0,0
1174,CC:2F:71:3F:1F:24,4406552,1165764201,588628,684236042,3817924,481528159,37,490979,557199369,490412,557130987,567,68382,473311,10,588865,45408,34,431,130000.0,43333.0,-67.0,-65.0,-70.0,-67.0,-67.0,-65.0,-70.0,-67.0,-90.0,-93.0,-90.0,-93.0,23.0,28.0,20.0,26.0,0
1175,CC:2F:71:3E:C5:1F,3818612,481612297,688,84138,3817924,481528159,0,2938,246080,2434,186164,504,59916,729,8,1019,18,0,32,130000.0,39000.0,-70.0,-71.0,-67.0,-60.0,-71.0,-72.0,-68.0,-61.0,-90.0,-93.0,-90.0,-93.0,20.0,22.0,23.0,33.0,0
1176,BA:8C:B9:54:50:24,3819655,482366025,1731,837866,3817924,481528159,0,5568,821700,5548,818578,20,3122,1004,14,2106,29,0,49,216660.0,130000.0,-49.0,-35.0,-42.0,-44.0,-42.0,-36.0,-43.0,-49.0,-90.0,-93.0,-90.0,-93.0,41.0,58.0,48.0,49.0,0
1177,92:69:1D:31:68:E9,3821407,484984182,3481,3455821,3817926,481528361,0,3623,931196,3526,909636,97,21560,1794,6,3607,78,0,31,216660.0,130000.0,-52.0,-50.0,-44.0,-46.0,-51.0,-49.0,-43.0,-46.0,-90.0,-93.0,-90.0,-93.0,38.0,43.0,46.0,47.0,0
1178,CC:2F:71:3F:1F:24,4406597,1165779003,588670,684250582,3817927,481528421,37,491005,557204313,490438,557135931,567,68382,473337,10,588907,45415,34,431,130000.0,43333.0,-67.0,-65.0,-70.0,-68.0,-67.0,-65.0,-70.0,-67.0,-90.0,-93.0,-90.0,-93.0,23.0,28.0,20.0,25.0,0
1179,CC:2F:71:3E:C5:1F,3818615,481612559,688,84138,3817927,481528421,0,2938,246080,2434,186164,504,59916,729,8,1019,18,0,32,130000.0,39000.0,-70.0,-71.0,-67.0,-60.0,-71.0,-72.0,-68.0,-61.0,-90.0,-93.0,-90.0,-93.0,20.0,22.0,23.0,33.0,0
1180,BA:8C:B9:54:50:24,3819658,482366287,1731,837866,3817927,481528421,0,5568,821700,5548,818578,20,3122,1004,14,2106,29,0,49,216660.0,130000.0,-49.0,-35.0,-42.0,-44.0,-42.0,-36.0,-43.0,-49.0,-90.0,-93.0,-90.0,-93.0,41.0,58.0,48.0,49.0,0
1181,92:69:1D:31:68:E9,3821437,484995871,3481,3455821,3817956,481540050,0,3626,931567,3528,909772,98,21795,1795,6,3607,78,0,31,216660.0,130000.0,-52.0,-50.0,-45.0,-46.0,-52.0,-49.0,-44.0,-47.0,-90.0,-93.0,-90.0,-93.0,38.0,43.0,45.0,47.0,0
1182,CC:2F:71:3F:1F:24,4406668,1165805054,588712,684265004,3817956,481540050,37,491031,557209257,490464,557140875,567,68382,473363,10,588949,45435,34,431,117000.0,39000.0,-67.0,-65.0,-70.0,-67.0,-67.0,-65.0,-70.0,-67.0,-90.0,-93.0,-90.0,-93.0,23.0,28.0,20.0,26.0,0
1183,CC:2F:71:3E:C5:1F,3818645,481624461,688,84138,3817957,481540323,0,2938,246080,2434,186164,504,59916,729,8,1019,18,0,32,130000.0,39000.0,-70.0,-71.0,-67.0,-60.0,-71.0,-72.0,-68.0,-61.0,-90.0,-93.0,-90.0,-93.0,20.0,22.0,23.0,33.0,0
1184,BA:8C:B9:54:50:24,3819688,482378189,1731,837866,3817957,481540323,0,5574,822108,5554,818986,20,3122,1004,14,2106,29,0,49,216660.0,130000.0,-40.0,-37.0,-45.0,-52.0,-42.0,-36.0,-44.0,-49.0,-90.0,-93.0,-90.0,-93.0,50.0,56.0,45.0,41.0,0
1185,92:69:1D:31:68:E9,3821440,484996346,3481,3455821,3817959,481540525,0,3626,931567,3528,909772,98,21795,1795,6,3607,78,0,31,216660.0,130000.0,-52.0,-50.0,-45.0,-46.0,-52.0,-49.0,-44.0,-47.0,-90.0,-93.0,-90.0,-93.0,38.0,43.0,45.0,47.0,0
1186,CC:2F:71:3F:1F:24,4406714,1165820081,588755,684279556,3817959,481540525,37,491058,557214341,490491,557145959,567,68382,473390,10,588992,45443,34,431,130000.0,43333.0,-67.0,-65.0,-70.0,-67.0,-67.0,-65.0,-70.0,-67.0,-90.0,-93.0,-90.0,-93.0,23.0,28.0,20.0,26.0,0
1187,CC:2F:71:3E:C5:1F,3818647,481624663,688,84138,3817959,481540525,0,2938,246080,2434,186164,504,59916,729,8,1019,18,0,32,130000.0,39000.0,-70.0,-71.0,-67.0,-60.0,-71.0,-72.0,-68.0,-61.0,-90.0,-93.0,-90.0,-93.0,20.0,22.0,23.0,33.0,0
1188,BA:8C:B9:54:50:24,3819690,482378391,1731,837866,3817959,481540525,0,5574,822108,5554,818986,20,3122,1004,14,2106,29,0,49,216660.0,130000.0,-40.0,-37.0,-45.0,-52.0,-42.0,-36.0,-44.0,-49.0,-90.0,-93.0,-90.0,-93.0,50.0,56.0,45.0,41.0,0
1189,92:69:1D:31:68:E9,3821447,484997012,3481,3455821,3817966,481541191,0,3626,931567,3528,909772,98,21795,1795,6,3607,78,0,31,216660.0,130000.0,-52.0,-50.0,-45.0,-46.0,-52.0,-49.0,-44.0,-47.0,-90.0,-93.0,-90.0,-93.0,38.0,43.0,45.0,47.0,0
1190,CC:2F:71:3F:1F:24,4406763,1165835231,588797,684294040,3817966,481541191,37,491083,557219145,490516,557150763,567,68382,473415,10,589034,45446,34,431,130000.0,39000.0,-67.0,-65.0,-70.0,-68.0,-67.0,-65.0,-70.0,-67.0,-90.0,-93.0,-90.0,-93.0,23.0,28.0,20.0,25.0,0
1191,CC:2F:71:3E:C5:1F,3818654,481625329,688,84138,3817966,481541191,0,2938,246080,2434,186164,504,59916,729,8,1019,18,0,32,130000.0,39000.0,-70.0,-71.0,-67.0,-60.0,-71.0,-72.0,-68.0,-61.0,-90.0,-93.0,-90.0,-93.0,20.0,22.0,23.0,33.0,0
1192,BA:8C:B9:54:50:24,3819697,482379057,1731,837866,3817966,481541191,0,5574,822108,5554,818986,20,3122,1004,14,2106,29,0,49,216660.0,130000.0,-40.0,-37.0,-45.0,-52.0,-42.0,-36.0,-44.0,-49.0,-90.0,-93.0,-90.0,-93.0,50.0,56.0,45.0,41.0,0
1193,92:69:1D:31:68:E9,3821449,484997214,3481,3455821,3817968,481541393,0,3626,931567,3528,909772,98,21795,1795,6,3607,78,0,31,216660.0,130000.0,-52.0,-50.0,-45.0,-46.0,-52.0,-49.0,-44.0,-47.0,-90.0,-93.0,-90.0,-93.0,38.0,43.0,45.0,47.0,0
1194,CC:2F:71:3F:1F:24,4406807,1165849861,588839,684308468,3817968,481541393,37,491111,557224345,490544,557155963,567,68382,473443,10,589076,45471,34,431,130000.0,39000.0,-67.0,-65.0,-71.0,-67.0,-67.0,-65.0,-70.0,-67.0,-90.0,-93.0,-90.0,-93.0,23.0,28.0,19.0,26.0,0
1195,CC:2F:71:3E:C5:1F,3818656,481625531,688,84138,3817968,481541393,0,2938,246080,2434,186164,504,59916,729,8,1019,18,0,32,130000.0,39000.0,-70.0,-71.0,-67.0,-60.0,-71.0,-72.0,-68.0,-61.0,-90.0,-93.0,-90.0,-93.0,20.0,22.0,23.0,33.0,0
1196,BA:8C:B9:54:50:24,3819699,482379259,1731,837866,3817968,481541393,0,5574,822108,5554,818986,20,3122,1004,14,2106,29,0,49,216660.0,130000.0,-40.0,-37.0,-45.0,-52.0,-42.0,-36.0,-44.0,-49.0,-90.0,-93.0,-90.0,-93.0,50.0,56.0,45.0,41.0,0
1197,92:69:1D:31:68:E9,3821457,484998188,3481,3455821,3817976,481542367,0,3626,931567,3528,909772,98,21795,1795,6,3607,78,0,31,216660.0,130000.0,-52.0,-50.0,-45.0,-46.0,-52.0,-49.0,-44.0,-47.0,-90.0,-93.0,-90.0,-93.0,38.0,43.0,45.0,47.0,0
1198,CC:2F:71:3F:1F:24,4406858,1165865449,588882,684323082,3817976,481542367,37,491136,557229149,490569,557160767,567,68382,473468,10,589119,45478,34,431,130000.0,43333.0,-67.0,-65.0,-70.0,-67.0,-67.0,-65.0,-70.0,-67.0,-90.0,-93.0,-90.0,-93.0,23.0,28.0,20.0,26.0,0
1199,CC:2F:71:3E:C5:1F,3818664,481626505,688,84138,3817976,481542367,0,2938,246080,2434,186164,504,59916,729,8,1019,18,0,32,130000.0,39000.0,-70.0,-71.0,-67.0,-60.0,-71.0,-72.0,-68.0,-61.0,-90.0,-93.0,-90.0,-93.0,20.0,22.0,23.0,33.0,0
1200,BA:8C:B9:54:50:24,3819707,482380233,1731,837866,3817976,481542367,0,5574,822108,5554,818986,20,3122,1004,14,2106,29,0,49,216660.0,130000.0,-40.0,-37.0,-45.0,-52.0,-42.0,-36.0,-44.0,-49.0,-90.0,-93.0,-90.0,-93.0,50.0,56.0,45.0,41.0,0
1201,92:69:1D:31:68:E9,3821460,484998450,3481,3455821,3817979,481542629,0,3626,931567,3528,909772,98,21795,1795,6,3607,78,0,31,216660.0,130000.0,-52.0,-50.0,-45.0,-46.0,-52.0,-49.0,-44.0,-47.0,-90.0,-93.0,-90.0,-93.0,38.0,43.0,45.0,47.0,0
1202,CC:2F:71:3F:1F:24,4406904,1165880397,588925,684337768,3817979,481542629,37,491166,557234545,490599,557166163,567,68382,473498,10,589162,45499,34,431,117000.0,39000.0,-67.0,-65.0,-70.0,-68.0,-67.0,-65.0,-70.0,-67.0,-90.0,-93.0,-90.0,-93.0,23.0,28.0,20.0,25.0,0
1203,CC:2F:71:3E:C5:1F,3818667,481626767,688,84138,3817979,481542629,0,2938,246080,2434,186164,504,59916,729,8,1019,18,0,32,130000.0,39000.0,-70.0,-71.0,-67.0,-60.0,-71.0,-72.0,-68.0,-61.0,-90.0,-93.0,-90.0,-93.0,20.0,22.0,23.0,33.0,0
1204,BA:8C:B9:54:50:24,3819710,482380495,1731,837866,3817979,481542629,0,5574,822108,5554,818986,20,3122,1004,14,2106,29,0,49,216660.0,130000.0,-40.0,-37.0,-45.0,-52.0,-42.0,-36.0,-44.0,-49.0,-90.0,-93.0,-90.0,-93.0,50.0,56.0,45.0,41.0,0
1205,92:69:1D:31:68:E9,3821466,484999056,3481,3455821,3817985,481543235,0,3626,931567,3528,909772,98,21795,1795,6,3607,78,0,31,216660.0,130000.0,-52.0,-50.0,-45.0,-46.0,-52.0,-49.0,-44.0,-47.0,-90.0,-93.0,-90.0,-93.0,38.0,43.0,45.0,47.0,0
1206,CC:2F:71:3F:1F:24,4406954,1165895679,588969,684352444,3817985,481543235,37,491191,557239349,490624,557170967,567,68382,473523,10,589206,45502,34,431,130000.0,43333.0,-67.0,-65.0,-71.0,-68.0,-67.0,-65.0,-70.0,-67.0,-90.0,-93.0,-90.0,-93.0,23.0,28.0,19.0,25.0,0
1207,CC:2F:71:3E:C5:1F,3818673,481627373,688,84138,3817985,481543235,0,2938,246080,2434,186164,504,59916,729,8,1019,18,0,32,130000.0,39000.0,-70.0,-71.0,-67.0,-60.0,-71.0,-72.0,-68.0,-61.0,-90.0,-93.0,-90.0,-93.0,20.0,22.0,23.0,33.0,0
1208,BA:8C:B9:54:50:24,3819716,482381101,1731,837866,3817985,481543235,0,5574,822108,5554,818986,20,3122,1004,14,2106,29,0,49,216660.0,130000.0,-40.0,-37.0,-45.0,-52.0,-42.0,-36.0,-44.0,-49.0,-90.0,-93.0,-90.0,-93.0,50.0,56.0,45.0,41.0,0
1209,92:69:1D:31:68:E9,3821469,484999318,3481,3455821,3817988,481543497,0,3626,931567,3528,909772,98,21795,1795,6,3607,78,0,31,216660.0,130000.0,-52.0,-50.0,-45.0,-46.0,-52.0,-49.0,-44.0,-47.0,-90.0,-93.0,-90.0,-93.0,38.0,43.0,45.0,47.0,0
1210,CC:2F:71:3F:1F:24,4407000,1165910605,589012,684367108,3817988,481543497,37,491216,557244153,490649,557175771,567,68382,473548,10,589248,45513,34,431,130000.0,43333.0,-67.0,-65.0,-70.0,-68.0,-67.0,-65.0,-70.0,-67.0,-90.0,-93.0,-90.0,-93.0,23.0,28.0,20.0,25.0,0
1211,CC:2F:71:3E:C5:1F,3818676,481627635,688,84138,3817988,481543497,0,2938,246080,2434,186164,504,59916,729,8,1019,18,0,32,130000.0,39000.0,-70.0,-71.0,-67.0,-60.0,-71.0,-72.0,-68.0,-61.0,-90.0,-93.0,-90.0,-93.0,20.0,22.0,23.0,33.0,0
1212,BA:8C:B9:54:50:24,3819719,482381363,1731,837866,3817988,481543497,0,5574,822108,5554,818986,20,3122,1004,14,2106,29,0,49,216660.0,130000.0,-40.0,-37.0,-45.0,-52.0,-42.0,-36.0,-44.0,-49.0,-90.0,-93.0,-90.0,-93.0,50.0,56.0,45.0,41.0,0
1213,92:69:1D:31:68:E9,3821475,484999924,3481,3455821,3817994,481544103,0,3626,931567,3528,909772,98,21795,1795,6,3607,78,0,31,216660.0,130000.0,-52.0,-50.0,-45.0,-46.0,-52.0,-49.0,-44.0,-47.0,-90.0,-93.0,-90.0,-93.0,38.0,43.0,45.0,47.0,0
1214,CC:2F:71:3F:1F:24,4407046,1165925391,589052,684381288,3817994,481544103,37,491241,557248957,490674,557180575,567,68382,473573,10,589289,45532,34,431,117000.0,39000.0,-67.0,-65.0,-70.0,-68.0,-67.0,-65.0,-70.0,-67.0,-90.0,-93.0,-90.0,-93.0,23.0,28.0,20.0,25.0,0
1215,CC:2F:71:3E:C5:1F,3818682,481628241,688,84138,3817994,481544103,0,2938,246080,2434,186164,504,59916,729,8,1019,18,0,32,130000.0,39000.0,-70.0,-71.0,-67.0,-60.0,-71.0,-72.0,-68.0,-61.0,-90.0,-93.0,-90.0,-93.0,20.0,22.0,23.0,33.0,0
1216,BA:8C:B9:54:50:24,3819725,482381969,1731,837866,3817994,481544103,0,5574,822108,5554,818986,20,3122,1004,14,2106,29,0,49,216660.0,130000.0,-40.0,-37.0,-45.0,-52.0,-42.0,-36.0,-44.0,-49.0,-90.0,-93.0,-90.0,-93.0,50.0,56.0,45.0,41.0,0
1217,92:69:1D:31:68:E9,3821477,485000126,3481,3455821,3817996,481544305,0,3626,931567,3528,909772,98,21795,1795,6,3607,78,0,31,216660.0,130000.0,-52.0,-50.0,-45.0,-46.0,-52.0,-49.0,-44.0,-47.0,-90.0,-93.0,-90.0,-93.0,38.0,43.0,45.0,47.0,0
1218,CC:2F:71:3F:1F:24,4407089,1165939897,589093,684395592,3817996,481544305,37,491267,557253937,490700,557185555,567,68382,473599,10,589330,45542,34,431,130000.0,43333.0,-67.0,-65.0,-70.0,-68.0,-67.0,-65.0,-70.0,-67.0,-90.0,-93.0,-90.0,-93.0,23.0,28.0,20.0,25.0,0
1219,CC:2F:71:3E:C5:1F,3818684,481628443,688,84138,3817996,481544305,0,2938,246080,2434,186164,504,59916,729,8,1019,18,0,32,130000.0,39000.0,-70.0,-71.0,-67.0,-60.0,-71.0,-72.0,-68.0,-61.0,-90.0,-93.0,-90.0,-93.0,20.0,22.0,23.0,33.0,0
1220,BA:8C:B9:54:50:24,3819727,482382171,1731,837866,3817996,481544305,0,5574,822108,5554,818986,20,3122,1004,14,2106,29,0,49,216660.0,130000.0,-40.0,-37.0,-45.0,-52.0,-42.0,-36.0,-44.0,-49.0,-90.0,-93.0,-90.0,-93.0,50.0,56.0,45.0,41.0,0
1221,92:69:1D:31:68:E9,3821484,485000792,3481,3455821,3818003,481544971,0,3626,931567,3528,909772,98,21795,1795,6,3607,78,0,31,216660.0,130000.0,-52.0,-50.0,-45.0,-46.0,-52.0,-49.0,-44.0,-47.0,-90.0,-93.0,-90.0,-93.0,38.0,43.0,45.0,47.0,0
1222,CC:2F:71:3F:1F:24,4407139,1165955115,589136,684410144,3818003,481544971,37,491293,557258857,490726,557190475,567,68382,473625,10,589373,45575,34,431,144444.0,43333.0,-67.0,-65.0,-70.0,-68.0,-67.0,-65.0,-70.0,-67.0,-90.0,-93.0,-90.0,-93.0,23.0,28.0,20.0,25.0,0
1223,CC:2F:71:3E:C5:1F,3818691,481629109,688,84138,3818003,481544971,0,2938,246080,2434,186164,504,59916,729,8,1019,18,0,32,130000.0,39000.0,-70.0,-71.0,-67.0,-60.0,-71.0,-72.0,-68.0,-61.0,-90.0,-93.0,-90.0,-93.0,20.0,22.0,23.0,33.0,0
1224,BA:8C:B9:54:50:24,3819734,482382837,1731,837866,3818003,481544971,0,5574,822108,5554,818986,20,3122,1004,14,2106,29,0,49,216660.0,130000.0,-40.0,-37.0,-45.0,-52.0,-42.0,-36.0,-44.0,-49.0,-90.0,-93.0,-90.0,-93.0,50.0,56.0,45.0,41.0,0
1225,92:69:1D:31:68:E9,3821486,485000994,3481,3455821,3818005,481545173,0,3626,931567,3528,909772,98,21795,1795,6,3607,78,0,31,216660.0,130000.0,-52.0,-50.0,-45.0,-46.0,-52.0,-49.0,-44.0,-47.0,-90.0,-93.0,-90.0,-93.0,38.0,43.0,45.0,47.0,0
1226,CC:2F:71:3F:1F:24,4407183,1165969751,589178,684424578,3818005,481545173,37,491319,557263801,490752,557195419,567,68382,473651,10,589415,45593,34,431,130000.0,43333.0,-67.0,-65.0,-70.0,-68.0,-67.0,-65.0,-70.0,-67.0,-90.0,-93.0,-90.0,-93.0,23.0,28.0,20.0,25.0,0
1227,CC:2F:71:3E:C5:1F,3818693,481629311,688,84138,3818005,481545173,0,2938,246080,2434,186164,504,59916,729,8,1019,18,0,32,130000.0,39000.0,-70.0,-71.0,-67.0,-60.0,-71.0,-72.0,-68.0,-61.0,-90.0,-93.0,-90.0,-93.0,20.0,22.0,23.0,33.0,0
1228,BA:8C:B9:54:50:24,3819736,482383039,1731,837866,3818005,481545173,0,5574,822108,5554,818986,20,3122,1004,14,2106,29,0,49,216660.0,130000.0,-40.0,-37.0,-45.0,-52.0,-42.0,-36.0,-44.0,-49.0,-90.0,-93.0,-90.0,-93.0,50.0,56.0,45.0,41.0,0
1229,92:69:1D:31:68:E9,3821492,485001600,3481,3455821,3818011,481545779,0,3626,931567,3528,909772,98,21795,1795,6,3607,78,0,31,216660.0,130000.0,-52.0,-50.0,-45.0,-46.0,-52.0,-49.0,-44.0,-47.0,-90.0,-93.0,-90.0,-93.0,38.0,43.0,45.0,47.0,0
1230,CC:2F:71:3F:1F:24,4407233,1165985279,589222,684439500,3818011,481545779,37,491347,557268989,490780,557200607,567,68382,473679,10,589459,45600,34,431,130000.0,43333.0,-67.0,-65.0,-70.0,-67.0,-67.0,-65.0,-70.0,-67.0,-90.0,-93.0,-90.0,-93.0,23.0,28.0,20.0,26.0,0
1231,CC:2F:71:3E:C5:1F,3818700,481629977,688,84138,3818012,481545839,0,2938,246080,2434,186164,504,59916,729,8,1019,18,0,32,130000.0,39000.0,-70.0,-71.0,-67.0,-60.0,-71.0,-72.0,-68.0,-61.0,-90.0,-93.0,-90.0,-93.0,20.0,22.0,23.0,33.0,0
1232,BA:8C:B9:54:50:24,3819743,482383705,1731,837866,3818012,481545839,0,5574,822108,5554,818986,20,3122,1004,14,2106,29,0,49,216660.0,130000.0,-40.0,-37.0,-45.0,-52.0,-42.0,-36.0,-44.0,-49.0,-90.0,-93.0,-90.0,-93.0,50.0,56.0,45.0,41.0,0
1233,92:69:1D:31:68:E9,3821496,485001978,3482,3455937,3818014,481546041,0,3627,931635,3529,909840,98,21795,1795,6,3608,78,0,31,216660.0,130000.0,-52.0,-50.0,-44.0,-46.0,-52.0,-49.0,-44.0,-47.0,-90.0,-93.0,-90.0,-93.0,38.0,43.0,46.0,47.0,0
1234,CC:2F:71:3F:1F:24,4407280,1166000209,589266,684454168,3818014,481546041,37,491373,557273933,490806,557205551,567,68382,473705,10,589503,45630,34,431,117000.0,39000.0,-67.0,-65.0,-71.0,-68.0,-67.0,-65.0,-70.0,-67.0,-90.0,-93.0,-90.0,-93.0,23.0,28.0,19.0,25.0,0
1235,CC:2F:71:3E:C5:1F,3818703,481630295,689,84254,3818014,481546041,0,2940,246220,2436,186304,504,59916,729,8,1020,18,0,32,130000.0,39000.0,-71.0,-71.0,-67.0,-60.0,-71.0,-72.0,-68.0,-61.0,-90.0,-93.0,-90.0,-93.0,19.0,22.0,23.0,33.0,0
1236,BA:8C:B9:54:50:24,3819746,482384023,1732,837982,3818014,481546041,0,5576,822244,5556,819122,20,3122,1004,14,2107,29,0,49,216660.0,130000.0,-49.0,-35.0,-42.0,-44.0,-42.0,-36.0,-44.0,-49.0,-90.0,-93.0,-90.0,-93.0,41.0,58.0,48.0,49.0,0
1237,92:69:1D:31:68:E9,3821503,485002857,3482,3455937,3818021,481546920,0,3628,931703,3530,909908,98,21795,1795,6,3608,78,0,31,216660.0,130000.0,-51.0,-47.0,-42.0,-48.0,-51.0,-49.0,-43.0,-47.0,-90.0,-93.0,-90.0,-93.0,39.0,46.0,48.0,45.0,0
1238,CC:2F:71:3F:1F:24,4407328,1166015386,589307,684468466,3818021,481546920,37,491398,557278737,490831,557210355,567,68382,473730,10,589544,45638,34,431,130000.0,43333.0,-67.0,-65.0,-70.0,-67.0,-67.0,-65.0,-70.0,-67.0,-90.0,-93.0,-90.0,-93.0,23.0,28.0,20.0,26.0,0
1239,CC:2F:71:3E:C5:1F,3818710,481631174,689,84254,3818021,481546920,0,2940,246220,2436,186304,504,59916,729,8,1020,18,0,32,130000.0,39000.0,-71.0,-71.0,-67.0,-60.0,-71.0,-72.0,-68.0,-61.0,-90.0,-93.0,-90.0,-93.0,19.0,22.0,23.0,33.0,0
1240,BA:8C:B9:54:50:24,3819753,482384902,1732,837982,3818021,481546920,0,5576,822244,5556,819122,20,3122,1004,14,2107,29,0,49,216660.0,130000.0,-49.0,-35.0,-42.0,-44.0,-42.0,-36.0,-44.0,-49.0,-90.0,-93.0,-90.0,-93.0,41.0,58.0,48.0,49.0,0
1241,92:69:1D:31:68:E9,3821506,485003119,3482,3455937,3818024,481547182,0,3628,931703,3530,909908,98,21795,1795,6,3608,78,0,31,216660.0,130000.0,-51.0,-47.0,-42.0,-48.0,-51.0,-49.0,-43.0,-47.0,-90.0,-93.0,-90.0,-93.0,39.0,46.0,48.0,45.0,0
1242,CC:2F:71:3F:1F:24,4407372,1166030064,589348,684482882,3818024,481547182,37,491424,557283681,490857,557215299,567,68382,473756,10,589585,45644,34,431,130000.0,43333.0,-67.0,-65.0,-70.0,-68.0,-67.0,-65.0,-70.0,-67.0,-90.0,-93.0,-90.0,-93.0,23.0,28.0,20.0,25.0,0
1243,CC:2F:71:3E:C5:1F,3818713,481631436,689,84254,3818024,481547182,0,2940,246220,2436,186304,504,59916,729,8,1020,18,0,32,130000.0,39000.0,-71.0,-71.0,-67.0,-60.0,-71.0,-72.0,-68.0,-61.0,-90.0,-93.0,-90.0,-93.0,19.0,22.0,23.0,33.0,0
1244,BA:8C:B9:54:50:24,3819756,482385164,1732,837982,3818024,481547182,0,5577,822312,5557,819190,20,3122,1004,14,2107,29,0,49,216660.0,130000.0,-39.0,-38.0,-44.0,-52.0,-42.0,-36.0,-44.0,-49.0,-90.0,-93.0,-90.0,-92.0,51.0,55.0,46.0,40.0,0
1245,92:69:1D:31:68:E9,3821512,485003725,3482,3455937,3818030,481547788,0,3628,931703,3530,909908,98,21795,1795,6,3608,78,0,31,216660.0,130000.0,-51.0,-47.0,-42.0,-48.0,-51.0,-49.0,-43.0,-47.0,-90.0,-93.0,-90.0,-92.0,39.0,46.0,48.0,44.0,0
1246,CC:2F:71:3F:1F:24,4407420,1166045098,589390,684497310,3818030,481547788,37,491451,557288765,490884,557220383,567,68382,473783,10,589627,45663,34,431,117000.0,39000.0,-67.0,-65.0,-70.0,-67.0,-67.0,-65.0,-70.0,-67.0,-90.0,-93.0,-90.0,-92.0,23.0,28.0,20.0,25.0,0
1247,CC:2F:71:3E:C5:1F,3818719,481632042,689,84254,3818030,481547788,0,2940,246220,2436,186304,504,59916,729,8,1020,18,0,32,130000.0,39000.0,-71.0,-71.0,-67.0,-60.0,-71.0,-72.0,-68.0,-61.0,-90.0,-93.0,-90.0,-92.0,19.0,22.0,23.0,32.0,0
1248,BA:8C:B9:54:50:24,3819762,482385770,1732,837982,3818030,481547788,0,5577,822312,5557,819190,20,3122,1004,14,2107,29,0,49,216660.0,130000.0,-39.0,-38.0,-44.0,-52.0,-42.0,-36.0,-44.0,-49.0,-90.0,-93.0,-90.0,-92.0,51.0,55.0,46.0,40.0,0
1249,92:69:1D:31:68:E9,3821514,485003927,3482,3455937,3818032,481547990,0,3628,931703,3530,909908,98,21795,1795,6,3608,78,0,31,216660.0,130000.0,-51.0,-47.0,-42.0,-48.0,-51.0,-49.0,-43.0,-47.0,-90.0,-93.0,-90.0,-92.0,39.0,46.0,48.0,44.0,0
1250,CC:2F:71:3F:1F:24,4407465,1166059858,589433,684511868,3818032,481547990,37,491476,557293569,490909,557225187,567,68382,473808,10,589670,45664,34,431,130000.0,43333.0,-67.0,-65.0,-71.0,-68.0,-67.0,-65.0,-70.0,-67.0,-90.0,-93.0,-90.0,-92.0,23.0,28.0,19.0,24.0,0
1251,CC:2F:71:3E:C5:1F,3818721,481632244,689,84254,3818032,481547990,0,2940,246220,2436,186304,504,59916,729,8,1020,18,0,32,130000.0,39000.0,-71.0,-71.0,-67.0,-60.0,-71.0,-72.0,-68.0,-61.0,-90.0,-93.0,-90.0,-92.0,19.0,22.0,23.0,32.0,0
1252,BA:8C:B9:54:50:24,3819764,482385972,1732,837982,3818032,481547990,0,5577,822312,5557,819190,20,3122,1004,14,2107,29,0,49,216660.0,130000.0,-39.0,-38.0,-44.0,-52.0,-42.0,-36.0,-44.0,-49.0,-90.0,-93.0,-90.0,-92.0,51.0,55.0,46.0,40.0,0
1253,92:69:1D:31:68:E9,3821521,485004593,3482,3455937,3818039,481548656,0,3628,931703,3530,909908,98,21795,1795,6,3608,78,0,31,216660.0,130000.0,-51.0,-47.0,-42.0,-48.0,-51.0,-49.0,-43.0,-47.0,-90.0,-93.0,-90.0,-92.0,39.0,46.0,48.0,44.0,0
1254,CC:2F:71:3F:1F:24,4407513,1166074884,589474,684526228,3818039,481548656,37,491502,557298549,490935,557230167,567,68382,473834,10,589711,45686,34,431,130000.0,39000.0,-67.0,-65.0,-70.0,-68.0,-67.0,-65.0,-70.0,-67.0,-90.0,-93.0,-90.0,-92.0,23.0,28.0,20.0,24.0,0
1255,CC:2F:71:3E:C5:1F,3818728,481632910,689,84254,3818039,481548656,0,2940,246220,2436,186304,504,59916,729,8,1020,18,0,32,130000.0,39000.0,-71.0,-71.0,-67.0,-60.0,-71.0,-72.0,-68.0,-61.0,-90.0,-93.0,-90.0,-92.0,19.0,22.0,23.0,32.0,0
1256,BA:8C:B9:54:50:24,3819771,482386638,1732,837982,3818039,481548656,0,5577,822312,5557,819190,20,3122,1004,14,2107,29,0,49,216660.0,130000.0,-39.0,-38.0,-44.0,-52.0,-42.0,-36.0,-44.0,-49.0,-90.0,-93.0,-90.0,-92.0,51.0,55.0,46.0,40.0,0
1257,92:69:1D:31:68:E9,3821523,485004795,3482,3455937,3818041,481548858,0,3628,931703,3530,909908,98,21795,1795,6,3608,78,0,31,216660.0,130000.0,-51.0,-47.0,-42.0,-48.0,-51.0,-49.0,-43.0,-47.0,-90.0,-93.0,-90.0,-92.0,39.0,46.0,48.0,44.0,0
1258,CC:2F:71:3F:1F:24,4407557,1166089458,589516,684540600,3818041,481548858,37,491527,557303353,490960,557234971,567,68382,473859,10,589753,45708,34,431,130000.0,43333.0,-67.0,-65.0,-70.0,-68.0,-67.0,-65.0,-70.0,-67.0,-90.0,-93.0,-90.0,-92.0,23.0,28.0,20.0,24.0,0
1259,CC:2F:71:3E:C5:1F,3818730,481633112,689,84254,3818041,481548858,0,2940,246220,2436,186304,504,59916,729,8,1020,18,0,32,130000.0,39000.0,-71.0,-71.0,-67.0,-60.0,-71.0,-72.0,-68.0,-61.0,-90.0,-93.0,-90.0,-92.0,19.0,22.0,23.0,32.0,0
1260,BA:8C:B9:54:50:24,3819773,482386840,1732,837982,3818041,481548858,0,5577,822312,5557,819190,20,3122,1004,14,2107,29,0,49,216660.0,130000.0,-39.0,-38.0,-44.0,-52.0,-42.0,-36.0,-44.0,-49.0,-90.0,-93.0,-90.0,-92.0,51.0,55.0,46.0,40.0,0
1261,92:69:1D:31:68:E9,3821529,485005401,3482,3455937,3818047,481549464,0,3628,931703,3530,909908,98,21795,1795,6,3608,78,0,31,216660.0,130000.0,-51.0,-47.0,-42.0,-48.0,-51.0,-49.0,-43.0,-47.0,-90.0,-93.0,-90.0,-92.0,39.0,46.0,48.0,44.0,0
1262,CC:2F:71:3F:1F:24,4407606,1166105104,589559,684555640,3818047,481549464,37,491553,557308307,490986,557239925,567,68382,473885,10,589796,45710,34,431,130000.0,43333.0,-67.0,-65.0,-70.0,-67.0,-67.0,-65.0,-70.0,-67.0,-90.0,-93.0,-90.0,-92.0,23.0,28.0,20.0,25.0,0
1263,CC:2F:71:3E:C5:1F,3818737,481633778,689,84254,3818048,481549524,0,2940,246220,2436,186304,504,59916,729,8,1020,18,0,32,130000.0,39000.0,-71.0,-71.0,-67.0,-60.0,-71.0,-72.0,-68.0,-61.0,-90.0,-93.0,-90.0,-92.0,19.0,22.0,23.0,32.0,0
1264,BA:8C:B9:54:50:24,3819780,482387506,1732,837982,3818048,481549524,0,5577,822312,5557,819190,20,3122,1004,14,2107,29,0,49,216660.0,130000.0,-39.0,-38.0,-44.0,-52.0,-42.0,-36.0,-44.0,-49.0,-90.0,-93.0,-90.0,-92.0,51.0,55.0,46.0,40.0,0
1265,92:69:1D:31:68:E9,3821532,485005663,3482,3455937,3818050,481549726,0,3628,931703,3530,909908,98,21795,1795,6,3608,78,0,31,216660.0,130000.0,-51.0,-47.0,-42.0,-48.0,-51.0,-49.0,-43.0,-47.0,-90.0,-93.0,-90.0,-93.0,39.0,46.0,48.0,45.0,0
1266,CC:2F:71:3F:1F:24,4407651,1166119794,589601,684570068,3818050,481549726,37,491578,557313111,491011,557244729,567,68382,473910,10,589838,45731,34,431,117000.0,39000.0,-67.0,-65.0,-70.0,-68.0,-67.0,-65.0,-70.0,-67.0,-90.0,-93.0,-90.0,-93.0,23.0,28.0,20.0,25.0,0
1267,CC:2F:71:3E:C5:1F,3818739,481633980,689,84254,3818050,481549726,0,2940,246220,2436,186304,504,59916,729,8,1020,18,0,32,130000.0,39000.0,-71.0,-71.0,-67.0,-60.0,-71.0,-72.0,-68.0,-61.0,-90.0,-93.0,-90.0,-93.0,19.0,22.0,23.0,33.0,0
1268,BA:8C:B9:54:50:24,3819782,482387708,1732,837982,3818050,481549726,0,5579,822448,5559,819326,20,3122,1004,14,2107,29,0,49,216660.0,130000.0,-40.0,-37.0,-45.0,-52.0,-42.0,-36.0,-44.0,-49.0,-90.0,-93.0,-90.0,-93.0,50.0,56.0,45.0,41.0,0
1269,92:69:1D:31:68:E9,3821536,485006067,3482,3455937,3818054,481550130,0,3628,931703,3530,909908,98,21795,1795,6,3608,78,0,31,216660.0,130000.0,-51.0,-47.0,-42.0,-48.0,-51.0,-49.0,-43.0,-47.0,-90.0,-93.0,-90.0,-93.0,39.0,46.0,48.0,45.0,0
1270,CC:2F:71:3F:1F:24,4407698,1166134756,589644,684584626,3818054,481550130,37,491605,557318195,491038,557249813,567,68382,473937,10,589881,45734,34,431,130000.0,43333.0,-67.0,-65.0,-70.0,-68.0,-67.0,-65.0,-70.0,-67.0,-90.0,-93.0,-90.0,-93.0,23.0,28.0,20.0,25.0,0
1271,CC:2F:71:3E:C5:1F,3818745,481634586,689,84254,3818056,481550332,0,2940,246220,2436,186304,504,59916,729,8,1020,18,0,32,130000.0,39000.0,-71.0,-71.0,-67.0,-60.0,-71.0,-72.0,-68.0,-61.0,-90.0,-93.0,-90.0,-93.0,19.0,22.0,23.0,33.0,0
1272,BA:8C:B9:54:50:24,3819789,482388440,1732,837982,3818057,481550458,0,5580,822516,5560,819394,20,3122,1004,14,2107,29,0,49,216660.0,130000.0,-49.0,-35.0,-42.0,-44.0,-42.0,-36.0,-44.0,-49.0,-90.0,-93.0,-90.0,-93.0,41.0,58.0,48.0,49.0,0
1273,92:69:1D:31:68:E9,3821543,485006719,3482,3455937,3818061,481550782,0,3628,931703,3530,909908,98,21795,1795,6,3608,78,0,31,216660.0,130000.0,-51.0,-47.0,-42.0,-48.0,-51.0,-49.0,-43.0,-47.0,-90.0,-93.0,-90.0,-93.0,39.0,46.0,48.0,45.0,0
1274,CC:2F:71:3F:1F:24,4407746,1166149824,589685,684599042,3818061,481550782,37,491633,557323373,491065,557254873,568,68500,473965,10,589922,45740,34,431,130000.0,43333.0,-67.0,-65.0,-70.0,-68.0,-67.0,-65.0,-70.0,-67.0,-90.0,-93.0,-90.0,-93.0,23.0,28.0,20.0,25.0,0
1275,CC:2F:71:3E:C5:1F,3818750,481635036,689,84254,3818061,481550782,0,2940,246220,2436,186304,504,59916,729,8,1020,18,0,32,130000.0,39000.0,-71.0,-71.0,-67.0,-60.0,-71.0,-72.0,-68.0,-61.0,-90.0,-93.0,-90.0,-93.0,19.0,22.0,23.0,33.0,0
1276,BA:8C:B9:54:50:24,3819794,482388826,1732,837982,3818062,481550844,0,5580,822516,5560,819394,20,3122,1004,14,2107,29,0,49,216660.0,130000.0,-49.0,-35.0,-42.0,-44.0,-42.0,-36.0,-44.0,-49.0,-90.0,-93.0,-90.0,-93.0,41.0,58.0,48.0,49.0,0
1277,92:69:1D:31:68:E9,3821548,485007185,3482,3455937,3818066,481551248,0,3628,931703,3530,909908,98,21795,1795,6,3608,78,0,31,216660.0,130000.0,-51.0,-47.0,-42.0,-48.0,-51.0,-49.0,-43.0,-47.0,-90.0,-93.0,-90.0,-93.0,39.0,46.0,48.0,45.0,0
1278,CC:2F:71:3F:1F:24,4407794,1166164842,589728,684613594,3818066,481551248,37,491658,557328177,491090,557259677,568,68500,473990,10,589965,45775,34,431,144444.0,39000.0,-67.0,-65.0,-70.0,-67.0,-67.0,-65.0,-70.0,-67.0,-90.0,-93.0,-90.0,-93.0,23.0,28.0,20.0,26.0,0
1279,CC:2F:71:3E:C5:1F,3818757,481635704,689,84254,3818068,481551450,0,2942,246408,2437,186374,505,60034,730,8,1020,18,0,32,130000.0,39000.0,-70.0,-71.0,-67.0,-60.0,-71.0,-72.0,-68.0,-61.0,-90.0,-93.0,-90.0,-93.0,20.0,22.0,23.0,33.0,0
1280,BA:8C:B9:54:50:24,3819800,482389432,1732,837982,3818068,481551450,0,5580,822516,5560,819394,20,3122,1004,14,2107,29,0,49,216660.0,130000.0,-49.0,-35.0,-42.0,-44.0,-42.0,-36.0,-44.0,-49.0,-90.0,-93.0,-90.0,-93.0,41.0,58.0,48.0,49.0,0
1281,92:69:1D:31:68:E9,3821552,485007589,3482,3455937,3818070,481551652,0,3628,931703,3530,909908,98,21795,1795,6,3608,78,0,31,216660.0,130000.0,-51.0,-47.0,-42.0,-48.0,-51.0,-49.0,-43.0,-47.0,-90.0,-93.0,-90.0,-93.0,39.0,46.0,48.0,45.0,0
1282,CC:2F:71:3F:1F:24,4407840,1166179674,589770,684628022,3818070,481551652,37,491685,557333237,491117,557264737,568,68500,474017,10,590007,45798,34,431,130000.0,43333.0,-67.0,-65.0,-71.0,-68.0,-67.0,-65.0,-70.0,-67.0,-90.0,-93.0,-90.0,-93.0,23.0,28.0,19.0,25.0,0
1283,CC:2F:71:3E:C5:1F,3818759,481635906,689,84254,3818070,481551652,0,2942,246408,2437,186374,505,60034,730,8,1020,18,0,32,130000.0,39000.0,-70.0,-71.0,-67.0,-60.0,-71.0,-72.0,-68.0,-61.0,-90.0,-93.0,-90.0,-93.0,20.0,22.0,23.0,33.0,0
1284,BA:8C:B9:54:50:24,3819802,482389634,1732,837982,3818070,481551652,0,5580,822516,5560,819394,20,3122,1004,14,2107,29,0,49,216660.0,130000.0,-49.0,-35.0,-42.0,-44.0,-42.0,-36.0,-44.0,-49.0,-90.0,-93.0,-90.0,-93.0,41.0,58.0,48.0,49.0,0
1285,92:69:1D:31:68:E9,3821557,485008053,3482,3455937,3818075,481552116,0,3628,931703,3530,909908,98,21795,1795,6,3608,78,0,31,216660.0,130000.0,-51.0,-47.0,-42.0,-48.0,-51.0,-49.0,-43.0,-47.0,-90.0,-93.0,-90.0,-93.0,39.0,46.0,48.0,45.0,0
1286,CC:2F:71:3F:1F:24,4407890,1166194948,589813,684642630,3818077,481552318,37,491711,557338181,491143,557269681,568,68500,474043,10,590050,45815,34,431,130000.0,39000.0,-68.0,-66.0,-71.0,-69.0,-68.0,-66.0,-71.0,-68.0,-90.0,-93.0,-90.0,-93.0,22.0,27.0,19.0,24.0,0
1287,CC:2F:71:3E:C5:1F,3818766,481636572,689,84254,3818077,481552318,0,2942,246408,2437,186374,505,60034,730,8,1020,18,0,32,130000.0,39000.0,-70.0,-71.0,-67.0,-60.0,-71.0,-72.0,-68.0,-61.0,-90.0,-93.0,-90.0,-93.0,20.0,22.0,23.0,33.0,0
1288,BA:8C:B9:54:50:24,3819809,482390300,1732,837982,3818077,481552318,0,5580,822516,5560,819394,20,3122,1004,14,2107,29,0,49,216660.0,130000.0,-49.0,-35.0,-42.0,-44.0,-42.0,-36.0,-44.0,-49.0,-90.0,-93.0,-90.0,-93.0,41.0,58.0,48.0,49.0,0
1289,92:69:1D:31:68:E9,3821562,485008730,3482,3455937,3818080,481552793,0,3628,931703,3530,909908,98,21795,1795,6,3608,78,0,31,216660.0,130000.0,-51.0,-47.0,-42.0,-48.0,-51.0,-49.0,-43.0,-47.0,-90.0,-93.0,-90.0,-93.0,39.0,46.0,48.0,45.0,0
1290,CC:2F:71:3F:1F:24,4407934,1166209665,589854,684656872,3818080,481552793,37,491737,557343125,491169,557274625,568,68500,474069,10,590091,45833,34,431,130000.0,43333.0,-67.0,-65.0,-70.0,-67.0,-67.0,-65.0,-70.0,-67.0,-90.0,-93.0,-90.0,-93.0,23.0,28.0,20.0,26.0,0
1291,CC:2F:71:3E:C5:1F,3818769,481637047,689,84254,3818080,481552793,0,2942,246408,2437,186374,505,60034,730,8,1020,18,0,32,130000.0,39000.0,-70.0,-71.0,-67.0,-60.0,-71.0,-72.0,-68.0,-61.0,-90.0,-93.0,-90.0,-93.0,20.0,22.0,23.0,33.0,0
1292,BA:8C:B9:54:50:24,3819812,482390775,1732,837982,3818080,481552793,0,5580,822516,5560,819394,20,3122,1004,14,2107,29,0,49,216660.0,130000.0,-49.0,-35.0,-42.0,-44.0,-42.0,-36.0,-44.0,-49.0,-90.0,-93.0,-90.0,-93.0,41.0,58.0,48.0,49.0,0
1293,92:69:1D:31:68:E9,3821565,485009066,3482,3455937,3818083,481553129,0,3628,931703,3530,909908,98,21795,1795,6,3608,78,0,31,216660.0,130000.0,-51.0,-47.0,-42.0,-48.0,-51.0,-49.0,-43.0,-47.0,-90.0,-93.0,-90.0,-93.0,39.0,46.0,48.0,45.0,0
1294,CC:2F:71:3F:1F:24,4407984,1166224883,589897,684671424,3818087,481553459,37,491763,557348069,491195,557279569,568,68500,474095,10,590134,45869,34,431,144444.0,39000.0,-67.0,-65.0,-70.0,-67.0,-67.0,-65.0,-70.0,-67.0,-90.0,-93.0,-90.0,-93.0,23.0,28.0,20.0,26.0,0
1295,CC:2F:71:3E:C5:1F,3818776,481637713,689,84254,3818087,481553459,0,2942,246408,2437,186374,505,60034,730,8,1020,18,0,32,130000.0,39000.0,-70.0,-71.0,-67.0,-60.0,-71.0,-72.0,-68.0,-61.0,-90.0,-93.0,-90.0,-93.0,20.0,22.0,23.0,33.0,0
1296,BA:8C:B9:54:50:24,3819819,482391441,1732,837982,3818087,481553459,0,5580,822516,5560,819394,20,3122,1004,14,2107,29,0,49,216660.0,130000.0,-49.0,-35.0,-42.0,-44.0,-42.0,-36.0,-44.0,-49.0,-90.0,-93.0,-90.0,-93.0,41.0,58.0,48.0,49.0,0
1297,92:69:1D:31:68:E9,3821571,485009598,3482,3455937,3818089,481553661,0,3628,931703,3530,909908,98,21795,1795,6,3608,78,0,31,216660.0,130000.0,-51.0,-47.0,-42.0,-48.0,-51.0,-49.0,-43.0,-47.0,-90.0,-93.0,-90.0,-93.0,39.0,46.0,48.0,45.0,0
1298,CC:2F:71:3F:1F:24,4408027,1166239383,589938,684685722,3818089,481553661,37,491789,557353013,491221,557284513,568,68500,474121,10,590175,45883,34,431,130000.0,43333.0,-67.0,-65.0,-70.0,-67.0,-67.0,-65.0,-70.0,-67.0,-90.0,-93.0,-90.0,-93.0,23.0,28.0,20.0,26.0,0
1299,CC:2F:71:3E:C5:1F,3818778,481637915,689,84254,3818089,481553661,0,2942,246408,2437,186374,505,60034,730,8,1020,18,0,32,130000.0,39000.0,-70.0,-71.0,-67.0,-60.0,-71.0,-72.0,-68.0,-61.0,-90.0,-93.0,-90.0,-93.0,20.0,22.0,23.0,33.0,0
1300,BA:8C:B9:54:50:24,3819821,482391643,1732,837982,3818089,481553661,0,5580,822516,5560,819394,20,3122,1004,14,2107,29,0,49,216660.0,130000.0,-49.0,-35.0,-42.0,-44.0,-42.0,-36.0,-44.0,-49.0,-90.0,-93.0,-90.0,-93.0,41.0,58.0,48.0,49.0,0
1301,92:69:1D:31:68:E9,3821575,485010002,3482,3455937,3818093,481554065,0,3628,931703,3530,909908,98,21795,1795,6,3608,78,0,31,216660.0,130000.0,-51.0,-47.0,-42.0,-48.0,-51.0,-49.0,-43.0,-47.0,-90.0,-93.0,-90.0,-93.0,39.0,46.0,48.0,45.0,0
1302,CC:2F:71:3F:1F:24,4408074,1166254401,589981,684700336,3818093,481554065,37,491815,557357957,491247,557289457,568,68500,474147,10,590218,45907,34,431,130000.0,39000.0,-67.0,-65.0,-70.0,-67.0,-67.0,-65.0,-70.0,-67.0,-90.0,-93.0,-90.0,-93.0,23.0,28.0,20.0,26.0,0
1303,CC:2F:71:3E:C5:1F,3818784,481638521,689,84254,3818095,481554267,0,2942,246408,2437,186374,505,60034,730,8,1020,18,0,32,130000.0,39000.0,-70.0,-71.0,-67.0,-60.0,-71.0,-72.0,-68.0,-61.0,-90.0,-93.0,-90.0,-93.0,20.0,22.0,23.0,33.0,0
1304,BA:8C:B9:54:50:24,3819827,482392249,1732,837982,3818095,481554267,0,5580,822516,5560,819394,20,3122,1004,14,2107,29,0,49,216660.0,130000.0,-49.0,-35.0,-42.0,-44.0,-42.0,-36.0,-44.0,-49.0,-90.0,-93.0,-90.0,-93.0,41.0,58.0,48.0,49.0,0
1305,92:69:1D:31:68:E9,3821580,485010466,3482,3455937,3818098,481554529,0,3628,931703,3530,909908,98,21795,1795,6,3608,78,0,31,216660.0,130000.0,-51.0,-47.0,-42.0,-48.0,-51.0,-49.0,-43.0,-47.0,-90.0,-93.0,-90.0,-93.0,39.0,46.0,48.0,45.0,0
1306,CC:2F:71:3F:1F:24,4408122,1166269361,590024,684714832,3818098,481554529,37,491842,557363017,491274,557294517,568,68500,474174,10,590261,45933,34,431,130000.0,43333.0,-67.0,-65.0,-71.0,-67.0,-67.0,-65.0,-70.0,-67.0,-90.0,-93.0,-90.0,-93.0,23.0,28.0,19.0,26.0,0
1307,CC:2F:71:3E:C5:1F,3818787,481638783,689,84254,3818098,481554529,0,2942,246408,2437,186374,505,60034,730,8,1020,18,0,32,130000.0,39000.0,-70.0,-71.0,-67.0,-60.0,-71.0,-72.0,-68.0,-61.0,-90.0,-93.0,-90.0,-93.0,20.0,22.0,23.0,33.0,0
1308,BA:8C:B9:54:50:24,3819830,482392511,1732,837982,3818098,481554529,0,5580,822516,5560,819394,20,3122,1004,14,2107,29,0,49,216660.0,130000.0,-49.0,-35.0,-42.0,-44.0,-42.0,-36.0,-44.0,-49.0,-90.0,-93.0,-90.0,-93.0,41.0,58.0,48.0,49.0,0
1309,92:69:1D:31:68:E9,3821580,485010466,3482,3455937,3818098,481554529,0,3628,931703,3530,909908,98,21795,1795,6,3608,78,0,31,216660.0,130000.0,-51.0,-47.0,-42.0,-48.0,-51.0,-49.0,-43.0,-47.0,-90.0,-93.0,-90.0,-93.0,39.0,46.0,48.0,45.0,0
1310,CC:2F:71:3F:1F:24,4408169,1166284563,590067,684729630,3818102,481554933,37,491870,557368205,491302,557299705,568,68500,474202,10,590304,45936,34,431,130000.0,43333.0,-67.0,-65.0,-70.0,-68.0,-67.0,-65.0,-70.0,-67.0,-90.0,-93.0,-90.0,-93.0,23.0,28.0,20.0,25.0,0
1311,CC:2F:71:3E:C5:1F,3818793,481639389,689,84254,3818104,481555135,0,2942,246408,2437,186374,505,60034,730,8,1020,18,0,32,130000.0,39000.0,-70.0,-71.0,-67.0,-60.0,-71.0,-72.0,-68.0,-61.0,-90.0,-93.0,-90.0,-93.0,20.0,22.0,23.0,33.0,0
1312,BA:8C:B9:54:50:24,3819836,482393117,1732,837982,3818104,481555135,0,5580,822516,5560,819394,20,3122,1004,14,2107,29,0,49,216660.0,130000.0,-49.0,-35.0,-42.0,-44.0,-42.0,-36.0,-44.0,-49.0,-90.0,-93.0,-90.0,-93.0,41.0,58.0,48.0,49.0,0
1313,92:69:1D:31:68:E9,3821588,485011274,3482,3455937,3818106,481555337,0,3628,931703,3530,909908,98,21795,1795,6,3608,78,0,31,216660.0,130000.0,-51.0,-47.0,-42.0,-48.0,-51.0,-49.0,-43.0,-47.0,-90.0,-93.0,-90.0,-93.0,39.0,46.0,48.0,45.0,0
1314,CC:2F:71:3F:1F:24,4408216,1166299549,590110,684744212,3818106,481555337,37,491898,557373369,491330,557304869,568,68500,474230,10,590347,45946,34,431,117000.0,39000.0,-67.0,-65.0,-70.0,-67.0,-67.0,-65.0,-70.0,-67.0,-90.0,-93.0,-90.0,-93.0,23.0,28.0,20.0,26.0,0
1315,CC:2F:71:3E:C5:1F,3818795,481639591,689,84254,3818106,481555337,0,2942,246408,2437,186374,505,60034,730,8,1020,18,0,32,130000.0,39000.0,-70.0,-71.0,-67.0,-60.0,-71.0,-72.0,-68.0,-61.0,-90.0,-93.0,-90.0,-93.0,20.0,22.0,23.0,33.0,0
1316,BA:8C:B9:54:50:24,3819839,482393379,1732,837982,3818107,481555397,0,5580,822516,5560,819394,20,3122,1004,14,2107,29,0,49,216660.0,130000.0,-49.0,-35.0,-42.0,-44.0,-42.0,-36.0,-44.0,-49.0,-90.0,-93.0,-90.0,-93.0,41.0,58.0,48.0,49.0,0
1317,92:69:1D:31:68:E9,3821589,485011334,3482,3455937,3818107,481555397,0,3628,931703,3530,909908,98,21795,1795,6,3608,78,0,31,216660.0,130000.0,-51.0,-47.0,-42.0,-48.0,-51.0,-49.0,-43.0,-47.0,-90.0,-93.0,-90.0,-93.0,39.0,46.0,48.0,45.0,0
1318,CC:2F:71:3F:1F:24,4408264,1166314565,590153,684758764,3818111,481555801,37,491924,557378313,491356,557309813,568,68500,474256,10,590390,45950,34,431,130000.0,43333.0,-67.0,-65.0,-70.0,-67.0,-67.0,-65.0,-70.0,-67.0,-90.0,-93.0,-90.0,-93.0,23.0,28.0,20.0,26.0,0
1319,CC:2F:71:3E:C5:1F,3818802,481640257,689,84254,3818113,481556003,0,2942,246408,2437,186374,505,60034,730,8,1020,18,0,32,130000.0,39000.0,-70.0,-71.0,-67.0,-60.0,-71.0,-72.0,-68.0,-61.0,-90.0,-93.0,-90.0,-93.0,20.0,22.0,23.0,33.0,0
1320,BA:8C:B9:54:50:24,3819845,482393985,1732,837982,3818113,481556003,0,5580,822516,5560,819394,20,3122,1004,14,2107,29,0,49,216660.0,130000.0,-49.0,-35.0,-42.0,-44.0,-42.0,-36.0,-44.0,-49.0,-90.0,-93.0,-90.0,-93.0,41.0,58.0,48.0,49.0,0
1321,92:69:1D:31:68:E9,3821597,485012142,3482,3455937,3818115,481556205,0,3628,931703,3530,909908,98,21795,1795,6,3608,78,0,31,216660.0,130000.0,-51.0,-47.0,-42.0,-48.0,-51.0,-49.0,-43.0,-47.0,-90.0,-93.0,-90.0,-93.0,39.0,46.0,48.0,45.0,0
1322,CC:2F:71:3F:1F:24,4408310,1166329459,590195,684773254,3818115,481556205,37,491951,557383349,491383,557314849,568,68500,474283,10,590432,45967,34,431,130000.0,39000.0,-67.0,-65.0,-71.0,-68.0,-67.0,-65.0,-70.0,-67.0,-90.0,-93.0,-90.0,-93.0,23.0,28.0,19.0,25.0,0
1323,CC:2F:71:3E:C5:1F,3818804,481640459,689,84254,3818115,481556205,0,2942,246408,2437,186374,505,60034,730,8,1020,18,0,32,130000.0,39000.0,-70.0,-71.0,-67.0,-60.0,-71.0,-72.0,-68.0,-61.0,-90.0,-93.0,-90.0,-93.0,20.0,22.0,23.0,33.0,0
1324,BA:8C:B9:54:50:24,3819847,482394187,1732,837982,3818115,481556205,0,5580,822516,5560,819394,20,3122,1004,14,2107,29,0,49,216660.0,130000.0,-49.0,-35.0,-42.0,-44.0,-42.0,-36.0,-44.0,-49.0,-90.0,-93.0,-90.0,-93.0,41.0,58.0,48.0,49.0,0
1325,92:69:1D:31:68:E9,3821598,485012202,3482,3455937,3818116,481556265,0,3629,931771,3531,909976,98,21795,1795,6,3608,78,0,31,216660.0,130000.0,-52.0,-50.0,-44.0,-46.0,-51.0,-49.0,-43.0,-47.0,-90.0,-93.0,-90.0,-93.0,38.0,43.0,46.0,47.0,0
1326,CC:2F:71:3F:1F:24,4408354,1166344025,590236,684787558,3818118,481556467,37,491976,557388153,491408,557319653,568,68500,474308,10,590473,45984,34,431,130000.0,39000.0,-67.0,-65.0,-70.0,-68.0,-67.0,-65.0,-70.0,-67.0,-90.0,-93.0,-90.0,-93.0,23.0,28.0,20.0,25.0,0
1327,CC:2F:71:3E:C5:1F,3818809,481640923,689,84254,3818120,481556669,0,2942,246408,2437,186374,505,60034,730,8,1020,18,0,32,130000.0,39000.0,-70.0,-71.0,-67.0,-60.0,-71.0,-72.0,-68.0,-61.0,-90.0,-93.0,-90.0,-93.0,20.0,22.0,23.0,33.0,0
1328,BA:8C:B9:54:50:24,3819854,482394853,1732,837982,3818122,481556871,0,5580,822516,5560,819394,20,3122,1004,14,2107,29,0,49,216660.0,130000.0,-49.0,-35.0,-42.0,-44.0,-42.0,-36.0,-44.0,-49.0,-90.0,-93.0,-90.0,-93.0,41.0,58.0,48.0,49.0,0
1329,92:69:1D:31:68:E9,3821606,485013010,3482,3455937,3818124,481557073,0,3629,931771,3531,909976,98,21795,1795,6,3608,78,0,31,216660.0,130000.0,-52.0,-50.0,-44.0,-46.0,-51.0,-49.0,-43.0,-47.0,-90.0,-93.0,-90.0,-93.0,38.0,43.0,46.0,47.0,0
1330,CC:2F:71:3F:1F:24,4408402,1166359003,590278,684801930,3818124,481557073,37,492003,557393237,491435,557324737,568,68500,474335,10,590515,45999,34,431,117000.0,39000.0,-67.0,-65.0,-70.0,-68.0,-67.0,-65.0,-70.0,-67.0,-90.0,-93.0,-90.0,-93.0,23.0,28.0,20.0,25.0,0
1331,CC:2F:71:3E:C5:1F,3818813,481641327,689,84254,3818124,481557073,0,2942,246408,2437,186374,505,60034,730,8,1020,18,0,32,130000.0,39000.0,-70.0,-71.0,-67.0,-60.0,-71.0,-72.0,-68.0,-61.0,-90.0,-93.0,-90.0,-93.0,20.0,22.0,23.0,33.0,0
1332,BA:8C:B9:54:50:24,3819856,482395055,1732,837982,3818124,481557073,0,5580,822516,5560,819394,20,3122,1004,14,2107,29,0,49,216660.0,130000.0,-49.0,-35.0,-42.0,-44.0,-42.0,-36.0,-44.0,-49.0,-90.0,-93.0,-90.0,-93.0,41.0,58.0,48.0,49.0,0
1333,92:69:1D:31:68:E9,3821606,485013010,3482,3455937,3818124,481557073,0,3629,931771,3531,909976,98,21795,1795,6,3608,78,0,31,216660.0,130000.0,-52.0,-50.0,-44.0,-46.0,-51.0,-49.0,-43.0,-47.0,-90.0,-93.0,-90.0,-93.0,38.0,43.0,46.0,47.0,0
1334,CC:2F:71:3F:1F:24,4408448,1166373887,590322,684816612,3818126,481557275,37,492031,557398437,491463,557329937,568,68500,474363,10,590559,46008,34,431,130000.0,43333.0,-67.0,-65.0,-70.0,-67.0,-67.0,-65.0,-70.0,-67.0,-90.0,-93.0,-90.0,-93.0,23.0,28.0,20.0,26.0,0
1335,CC:2F:71:3E:C5:1F,3818815,481641529,689,84254,3818126,481557275,0,2942,246408,2437,186374,505,60034,730,8,1020,18,0,32,130000.0,39000.0,-70.0,-71.0,-67.0,-60.0,-71.0,-72.0,-68.0,-61.0,-90.0,-93.0,-90.0,-93.0,20.0,22.0,23.0,33.0,0
1336,BA:8C:B9:54:50:24,3819862,482395661,1732,837982,3818130,481557679,0,5580,822516,5560,819394,20,3122,1004,14,2107,29,0,49,216660.0,130000.0,-49.0,-35.0,-42.0,-44.0,-42.0,-36.0,-44.0,-49.0,-90.0,-93.0,-90.0,-93.0,41.0,58.0,48.0,49.0,0
1337,92:69:1D:31:68:E9,3821615,485013878,3482,3455937,3818133,481557941,0,3629,931771,3531,909976,98,21795,1795,6,3608,78,0,31,216660.0,130000.0,-52.0,-50.0,-44.0,-46.0,-51.0,-49.0,-43.0,-47.0,-90.0,-93.0,-90.0,-93.0,38.0,43.0,46.0,47.0,0
1338,CC:2F:71:3F:1F:24,4408497,1166388981,590364,684831040,3818133,481557941,37,492056,557403241,491488,557334741,568,68500,474388,10,590601,46025,34,431,117000.0,39000.0,-67.0,-65.0,-70.0,-68.0,-67.0,-65.0,-70.0,-67.0,-90.0,-93.0,-90.0,-93.0,23.0,28.0,20.0,25.0,0
1339,CC:2F:71:3E:C5:1F,3818822,481642195,689,84254,3818133,481557941,0,2942,246408,2437,186374,505,60034,730,8,1020,18,0,32,130000.0,39000.0,-70.0,-71.0,-67.0,-60.0,-71.0,-72.0,-68.0,-61.0,-90.0,-93.0,-90.0,-93.0,20.0,22.0,23.0,33.0,0
1340,BA:8C:B9:54:50:24,3819865,482395923,1732,837982,3818133,481557941,0,5580,822516,5560,819394,20,3122,1004,14,2107,29,0,49,216660.0,130000.0,-49.0,-35.0,-42.0,-44.0,-42.0,-36.0,-44.0,-49.0,-90.0,-93.0,-90.0,-93.0,41.0,58.0,48.0,49.0,0
1341,92:69:1D:31:68:E9,3821617,485014267,3483,3456053,3818134,481558214,0,3631,931907,3533,910112,98,21795,1795,6,3609,78,0,31,216660.0,130000.0,-52.0,-50.0,-44.0,-46.0,-51.0,-49.0,-43.0,-47.0,-90.0,-93.0,-90.0,-93.0,38.0,43.0,46.0,47.0,0
1342,CC:2F:71:3F:1F:24,4408543,1166404000,590407,684845584,3818136,481558416,37,492081,557408045,491513,557339545,568,68500,474413,10,590644,46028,34,431,130000.0,43333.0,-67.0,-65.0,-70.0,-67.0,-67.0,-65.0,-70.0,-67.0,-90.0,-93.0,-90.0,-93.0,23.0,28.0,20.0,26.0,0
1343,CC:2F:71:3E:C5:1F,3818826,481642786,690,84370,3818136,481558416,0,2944,246548,2439,186514,505,60034,730,8,1021,18,0,32,130000.0,39000.0,-70.0,-71.0,-67.0,-60.0,-70.0,-70.0,-67.0,-60.0,-90.0,-93.0,-90.0,-93.0,20.0,22.0,23.0,33.0,0
1344,BA:8C:B9:54:50:24,3819869,482396514,1733,838098,3818136,481558416,0,5582,822652,5562,819530,20,3122,1004,14,2108,29,0,49,216660.0,130000.0,-49.0,-35.0,-42.0,-44.0,-44.0,-36.0,-43.0,-47.0,-90.0,-93.0,-90.0,-93.0,41.0,58.0,48.0,49.0,0
1345,92:69:1D:31:68:E9,3821624,485014935,3483,3456053,3818141,481558882,0,3631,931907,3533,910112,98,21795,1795,6,3609,78,0,31,216660.0,130000.0,-52.0,-50.0,-44.0,-46.0,-51.0,-49.0,-43.0,-47.0,-90.0,-93.0,-90.0,-93.0,38.0,43.0,46.0,47.0,0
1346,CC:2F:71:3F:1F:24,4408591,1166419130,590450,684860248,3818141,481558882,37,492109,557413247,491540,557344629,569,68618,474441,10,590687,46031,34,431,130000.0,43333.0,-67.0,-65.0,-70.0,-67.0,-67.0,-65.0,-70.0,-67.0,-90.0,-93.0,-90.0,-93.0,23.0,28.0,20.0,26.0,0
1347,CC:2F:71:3E:C5:1F,3818832,481643312,690,84370,3818142,481558942,0,2944,246548,2439,186514,505,60034,730,8,1021,18,0,32,130000.0,39000.0,-70.0,-71.0,-67.0,-60.0,-70.0,-70.0,-67.0,-60.0,-90.0,-93.0,-90.0,-93.0,20.0,22.0,23.0,33.0,0
1348,BA:8C:B9:54:50:24,3819875,482397040,1733,838098,3818142,481558942,0,5582,822652,5562,819530,20,3122,1004,14,2108,29,0,49,216660.0,130000.0,-49.0,-35.0,-42.0,-44.0,-44.0,-36.0,-43.0,-47.0,-90.0,-93.0,-90.0,-93.0,41.0,58.0,48.0,49.0,0
1349,92:69:1D:31:68:E9,3821625,485014995,3483,3456053,3818142,481558942,0,3631,931907,3533,910112,98,21795,1795,6,3609,78,0,31,216660.0,130000.0,-52.0,-50.0,-44.0,-46.0,-51.0,-49.0,-43.0,-47.0,-91.0,-94.0,-90.0,-93.0,39.0,44.0,46.0,47.0,0
1350,CC:2F:71:3F:1F:24,4408634,1166433618,590492,684874676,3818142,481558942,37,492138,557418515,491569,557349897,569,68618,474470,10,590729,46039,34,431,117000.0,39000.0,-67.0,-65.0,-70.0,-67.0,-67.0,-65.0,-70.0,-67.0,-91.0,-94.0,-90.0,-93.0,24.0,29.0,20.0,26.0,0
1351,CC:2F:71:3E:C5:1F,3818832,481643312,690,84370,3818142,481558942,0,2944,246548,2439,186514,505,60034,730,8,1021,18,0,32,130000.0,39000.0,-70.0,-71.0,-67.0,-60.0,-70.0,-70.0,-67.0,-60.0,-91.0,-94.0,-90.0,-93.0,21.0,23.0,23.0,33.0,0
1352,BA:8C:B9:54:50:24,3819877,482397242,1733,838098,3818144,481559144,0,5582,822652,5562,819530,20,3122,1004,14,2108,29,0,49,216660.0,130000.0,-49.0,-35.0,-42.0,-44.0,-44.0,-36.0,-43.0,-47.0,-91.0,-94.0,-90.0,-93.0,42.0,59.0,48.0,49.0,0
1353,92:69:1D:31:68:E9,3821631,485015601,3483,3456053,3818148,481559548,0,3631,931907,3533,910112,98,21795,1795,6,3609,78,0,31,216660.0,130000.0,-52.0,-50.0,-44.0,-46.0,-51.0,-49.0,-43.0,-47.0,-91.0,-94.0,-90.0,-93.0,39.0,44.0,46.0,47.0,0
1354,CC:2F:71:3F:1F:24,4408685,1166449082,590535,684889166,3818150,481559916,37,492166,557423667,491597,557355049,569,68618,474498,10,590772,46053,34,431,130000.0,39000.0,-67.0,-65.0,-70.0,-68.0,-67.0,-65.0,-70.0,-67.0,-91.0,-94.0,-90.0,-93.0,24.0,29.0,20.0,25.0,0
1355,CC:2F:71:3E:C5:1F,3818840,481644286,690,84370,3818150,481559916,0,2944,246548,2439,186514,505,60034,730,8,1021,18,0,32,130000.0,39000.0,-70.0,-71.0,-67.0,-60.0,-70.0,-70.0,-67.0,-60.0,-91.0,-94.0,-90.0,-93.0,21.0,23.0,23.0,33.0,0
1356,BA:8C:B9:54:50:24,3819883,482398014,1733,838098,3818150,481559916,0,5582,822652,5562,819530,20,3122,1004,14,2108,29,0,49,216660.0,130000.0,-49.0,-35.0,-42.0,-44.0,-44.0,-36.0,-43.0,-47.0,-91.0,-94.0,-90.0,-93.0,42.0,59.0,48.0,49.0,0
1357,92:69:1D:31:68:E9,3821634,485016029,3483,3456053,3818151,481559976,0,3631,931907,3533,910112,98,21795,1795,6,3609,78,0,31,216660.0,130000.0,-52.0,-50.0,-44.0,-46.0,-51.0,-49.0,-43.0,-47.0,-91.0,-94.0,-90.0,-93.0,39.0,44.0,46.0,47.0,0
1358,CC:2F:71:3F:1F:24,4408728,1166463570,590577,684903594,3818151,481559976,37,492192,557428611,491623,557359993,569,68618,474524,10,590814,46072,34,431,130000.0,39000.0,-67.0,-65.0,-70.0,-67.0,-67.0,-65.0,-70.0,-67.0,-91.0,-94.0,-90.0,-93.0,24.0,29.0,20.0,26.0,0
1359,CC:2F:71:3E:C5:1F,3818841,481644346,690,84370,3818151,481559976,0,2944,246548,2439,186514,505,60034,730,8,1021,18,0,32,130000.0,39000.0,-70.0,-71.0,-67.0,-60.0,-70.0,-70.0,-67.0,-60.0,-91.0,-94.0,-90.0,-93.0,21.0,23.0,23.0,33.0,0
1360,BA:8C:B9:54:50:24,3819886,482398276,1733,838098,3818153,481560178,0,5582,822652,5562,819530,20,3122,1004,14,2108,29,0,49,216660.0,130000.0,-49.0,-35.0,-42.0,-44.0,-44.0,-36.0,-43.0,-47.0,-91.0,-94.0,-90.0,-93.0,42.0,59.0,48.0,49.0,0
1361,92:69:1D:31:68:E9,3821640,485016635,3483,3456053,3818157,481560582,0,3631,931907,3533,910112,98,21795,1795,6,3609,78,0,31,216660.0,130000.0,-52.0,-50.0,-44.0,-46.0,-51.0,-49.0,-43.0,-47.0,-91.0,-94.0,-90.0,-93.0,39.0,44.0,46.0,47.0,0
1362,CC:2F:71:3F:1F:24,4408775,1166478536,590618,684917954,3818157,481560582,37,492217,557433415,491648,557364797,569,68618,474549,10,590855,46075,34,431,130000.0,43333.0,-67.0,-65.0,-70.0,-68.0,-67.0,-65.0,-70.0,-67.0,-91.0,-94.0,-90.0,-93.0,24.0,29.0,20.0,25.0,0
1363,CC:2F:71:3E:C5:1F,3818847,481644952,690,84370,3818157,481560582,0,2944,246548,2439,186514,505,60034,730,8,1021,18,0,32,130000.0,39000.0,-70.0,-71.0,-67.0,-60.0,-70.0,-70.0,-67.0,-60.0,-91.0,-94.0,-90.0,-93.0,21.0,23.0,23.0,33.0,0
1364,BA:8C:B9:54:50:24,3819890,482398680,1733,838098,3818157,481560582,0,5582,822652,5562,819530,20,3122,1004,14,2108,29,0,49,216660.0,130000.0,-49.0,-35.0,-42.0,-44.0,-44.0,-36.0,-43.0,-47.0,-91.0,-94.0,-90.0,-93.0,42.0,59.0,48.0,49.0,0
1365,92:69:1D:31:68:E9,3821640,485016635,3483,3456053,3818157,481560582,0,3631,931907,3533,910112,98,21795,1795,6,3609,78,0,31,216660.0,130000.0,-52.0,-50.0,-44.0,-46.0,-51.0,-49.0,-43.0,-47.0,-91.0,-94.0,-90.0,-93.0,39.0,44.0,46.0,47.0,0
1366,CC:2F:71:3F:1F:24,4408815,1166492716,590658,684932134,3818157,481560582,37,492242,557438219,491673,557369601,569,68618,474574,10,590895,46097,34,431,117000.0,39000.0,-67.0,-65.0,-70.0,-67.0,-67.0,-65.0,-70.0,-67.0,-91.0,-94.0,-90.0,-93.0,24.0,29.0,20.0,26.0,0
1367,CC:2F:71:3E:C5:1F,3818847,481644952,690,84370,3818157,481560582,0,2944,246548,2439,186514,505,60034,730,8,1021,18,0,32,130000.0,39000.0,-70.0,-71.0,-67.0,-60.0,-70.0,-70.0,-67.0,-60.0,-91.0,-94.0,-90.0,-93.0,21.0,23.0,23.0,33.0,0
1368,BA:8C:B9:54:50:24,3819890,482398680,1733,838098,3818157,481560582,0,5582,822652,5562,819530,20,3122,1004,14,2108,29,0,49,216660.0,130000.0,-49.0,-35.0,-42.0,-44.0,-44.0,-36.0,-43.0,-47.0,-91.0,-94.0,-90.0,-93.0,42.0,59.0,48.0,49.0,0
1369,92:69:1D:31:68:E9,3821649,485017503,3483,3456053,3818166,481561450,0,3631,931907,3533,910112,98,21795,1795,6,3609,78,0,31,216660.0,130000.0,-52.0,-50.0,-44.0,-46.0,-51.0,-49.0,-43.0,-47.0,-91.0,-94.0,-90.0,-93.0,39.0,44.0,46.0,47.0,0
1370,CC:2F:71:3F:1F:24,4408866,1166508012,590700,684946562,3818166,481561450,37,492269,557443279,491700,557374661,569,68618,474601,10,590937,46106,34,431,130000.0,43333.0,-67.0,-65.0,-71.0,-67.0,-67.0,-65.0,-70.0,-67.0,-91.0,-94.0,-90.0,-93.0,24.0,29.0,19.0,26.0,0
1371,CC:2F:71:3E:C5:1F,3818856,481645820,690,84370,3818166,481561450,0,2944,246548,2439,186514,505,60034,730,8,1021,18,0,32,130000.0,39000.0,-70.0,-71.0,-67.0,-60.0,-70.0,-70.0,-67.0,-60.0,-91.0,-94.0,-90.0,-93.0,21.0,23.0,23.0,33.0,0
1372,BA:8C:B9:54:50:24,3819899,482399548,1733,838098,3818166,481561450,0,5582,822652,5562,819530,20,3122,1004,14,2108,29,0,49,216660.0,130000.0,-49.0,-35.0,-42.0,-44.0,-44.0,-36.0,-43.0,-47.0,-91.0,-94.0,-90.0,-93.0,42.0,59.0,48.0,49.0,0
1373,92:69:1D:31:68:E9,3821649,485017503,3483,3456053,3818166,481561450,0,3631,931907,3533,910112,98,21795,1795,6,3609,78,0,31,216660.0,130000.0,-52.0,-50.0,-44.0,-46.0,-51.0,-49.0,-43.0,-47.0,-91.0,-94.0,-90.0,-93.0,39.0,44.0,46.0,47.0,0
1374,CC:2F:71:3F:1F:24,4408908,1166522440,590742,684960990,3818166,481561450,37,492295,557448223,491726,557379605,569,68618,474627,10,590979,46145,34,431,144444.0,43333.0,-67.0,-65.0,-70.0,-67.0,-67.0,-65.0,-70.0,-67.0,-91.0,-94.0,-90.0,-93.0,24.0,29.0,20.0,26.0,0
1375,CC:2F:71:3E:C5:1F,3818856,481645820,690,84370,3818166,481561450,0,2944,246548,2439,186514,505,60034,730,8,1021,18,0,32,130000.0,39000.0,-70.0,-71.0,-67.0,-60.0,-70.0,-70.0,-67.0,-60.0,-91.0,-94.0,-90.0,-93.0,21.0,23.0,23.0,33.0,0
1376,BA:8C:B9:54:50:24,3819899,482399548,1733,838098,3818166,481561450,0,5582,822652,5562,819530,20,3122,1004,14,2108,29,0,49,216660.0,130000.0,-49.0,-35.0,-42.0,-44.0,-44.0,-36.0,-43.0,-47.0,-91.0,-94.0,-90.0,-93.0,42.0,59.0,48.0,49.0,0
1377,92:69:1D:31:68:E9,3821657,485018311,3483,3456053,3818174,481562258,0,3631,931907,3533,910112,98,21795,1795,6,3609,78,0,31,216660.0,130000.0,-52.0,-50.0,-44.0,-46.0,-51.0,-49.0,-43.0,-47.0,-91.0,-94.0,-90.0,-93.0,39.0,44.0,46.0,47.0,0
1378,CC:2F:71:3F:1F:24,4408959,1166537736,590784,684975418,3818175,481562318,37,492320,557453027,491751,557384409,569,68618,474652,10,591021,46153,34,431,130000.0,43333.0,-67.0,-65.0,-71.0,-67.0,-67.0,-65.0,-70.0,-67.0,-91.0,-94.0,-90.0,-93.0,24.0,29.0,19.0,26.0,0
1379,CC:2F:71:3E:C5:1F,3818865,481646688,690,84370,3818175,481562318,0,2944,246548,2439,186514,505,60034,730,8,1021,18,0,32,130000.0,39000.0,-70.0,-71.0,-67.0,-60.0,-70.0,-70.0,-67.0,-60.0,-91.0,-94.0,-90.0,-93.0,21.0,23.0,23.0,33.0,0
1380,BA:8C:B9:54:50:24,3819908,482400416,1733,838098,3818175,481562318,0,5582,822652,5562,819530,20,3122,1004,14,2108,29,0,49,216660.0,130000.0,-49.0,-35.0,-42.0,-44.0,-44.0,-36.0,-43.0,-47.0,-91.0,-94.0,-90.0,-93.0,42.0,59.0,48.0,49.0,0
1381,92:69:1D:31:68:E9,3821658,485018371,3483,3456053,3818175,481562318,0,3631,931907,3533,910112,98,21795,1795,6,3609,78,0,31,216660.0,130000.0,-52.0,-50.0,-44.0,-46.0,-51.0,-49.0,-43.0,-47.0,-91.0,-94.0,-90.0,-93.0,39.0,44.0,46.0,47.0,0
1382,CC:2F:71:3F:1F:24,4409002,1166552344,590827,684990026,3818175,481562318,37,492347,557458111,491778,557389493,569,68618,474679,10,591064,46170,34,431,130000.0,39000.0,-67.0,-65.0,-70.0,-68.0,-67.0,-65.0,-70.0,-67.0,-91.0,-94.0,-90.0,-93.0,24.0,29.0,20.0,25.0,0
1383,CC:2F:71:3E:C5:1F,3818866,481646750,690,84370,3818176,481562380,0,2945,246666,2439,186514,506,60152,731,8,1021,18,0,32,130000.0,39000.0,-70.0,-71.0,-67.0,-60.0,-70.0,-71.0,-67.0,-60.0,-91.0,-94.0,-90.0,-93.0,21.0,23.0,23.0,33.0,0
1384,BA:8C:B9:54:50:24,3819909,482400478,1733,838098,3818176,481562380,0,5582,822652,5562,819530,20,3122,1004,14,2108,29,0,49,216660.0,130000.0,-49.0,-35.0,-42.0,-44.0,-44.0,-36.0,-43.0,-47.0,-91.0,-94.0,-90.0,-93.0,42.0,59.0,48.0,49.0,0
1385,92:69:1D:31:68:E9,3821667,485019241,3483,3456053,3818184,481563188,0,3631,931907,3533,910112,98,21795,1795,6,3609,78,0,31,216660.0,130000.0,-52.0,-50.0,-44.0,-46.0,-51.0,-49.0,-43.0,-47.0,-91.0,-94.0,-90.0,-93.0,39.0,44.0,46.0,47.0,0
1386,CC:2F:71:3F:1F:24,4409054,1166567766,590870,685004578,3818184,481563188,37,492373,557463055,491804,557394437,569,68618,474705,10,591107,46185,34,431,130000.0,39000.0,-67.0,-65.0,-71.0,-68.0,-67.0,-65.0,-70.0,-67.0,-91.0,-94.0,-90.0,-93.0,24.0,29.0,19.0,25.0,0
1387,CC:2F:71:3E:C5:1F,3818874,481647558,690,84370,3818184,481563188,0,2946,246736,2440,186584,506,60152,731,8,1021,18,0,32,130000.0,39000.0,-70.0,-71.0,-67.0,-60.0,-70.0,-71.0,-67.0,-60.0,-91.0,-94.0,-90.0,-93.0,21.0,23.0,23.0,33.0,0
1388,BA:8C:B9:54:50:24,3819917,482401286,1733,838098,3818184,481563188,0,5582,822652,5562,819530,20,3122,1004,14,2108,29,0,49,216660.0,130000.0,-49.0,-35.0,-42.0,-44.0,-44.0,-36.0,-43.0,-47.0,-91.0,-94.0,-90.0,-93.0,42.0,59.0,48.0,49.0,0
1389,92:69:1D:31:68:E9,3821668,485019301,3483,3456053,3818185,481563248,0,3631,931907,3533,910112,98,21795,1795,6,3609,78,0,31,216660.0,130000.0,-52.0,-50.0,-44.0,-46.0,-51.0,-49.0,-43.0,-47.0,-91.0,-94.0,-90.0,-93.0,39.0,44.0,46.0,47.0,0
1390,CC:2F:71:3F:1F:24,4409095,1166581944,590910,685018696,3818185,481563248,37,492398,557467859,491829,557399241,569,68618,474730,10,591147,46204,34,431,117000.0,39000.0,-67.0,-65.0,-70.0,-68.0,-67.0,-65.0,-70.0,-67.0,-91.0,-94.0,-90.0,-93.0,24.0,29.0,20.0,25.0,0
1391,CC:2F:71:3E:C5:1F,3818875,481647618,690,84370,3818185,481563248,0,2946,246736,2440,186584,506,60152,731,8,1021,18,0,32,130000.0,39000.0,-70.0,-71.0,-67.0,-60.0,-70.0,-71.0,-67.0,-60.0,-91.0,-94.0,-90.0,-93.0,21.0,23.0,23.0,33.0,0
1392,BA:8C:B9:54:50:24,3819920,482401548,1733,838098,3818187,481563450,0,5582,822652,5562,819530,20,3122,1004,14,2108,29,0,49,216660.0,130000.0,-49.0,-35.0,-42.0,-44.0,-44.0,-36.0,-43.0,-47.0,-91.0,-94.0,-90.0,-93.0,42.0,59.0,48.0,49.0,0
1393,92:69:1D:31:68:E9,3821677,485020382,3483,3456053,3818194,481564329,0,3631,931907,3533,910112,98,21795,1795,6,3609,78,0,31,216660.0,130000.0,-52.0,-50.0,-44.0,-46.0,-51.0,-49.0,-43.0,-47.0,-91.0,-94.0,-90.0,-93.0,39.0,44.0,46.0,47.0,0
1394,CC:2F:71:3F:1F:24,4409147,1166597583,590953,685033254,3818194,481564329,37,492423,557472663,491854,557404045,569,68618,474755,10,591190,46212,34,431,130000.0,43333.0,-67.0,-65.0,-70.0,-67.0,-67.0,-65.0,-70.0,-67.0,-91.0,-94.0,-90.0,-93.0,24.0,29.0,20.0,26.0,0
1395,CC:2F:71:3E:C5:1F,3818884,481648699,690,84370,3818194,481564329,0,2946,246736,2440,186584,506,60152,731,8,1021,18,0,32,130000.0,39000.0,-70.0,-71.0,-67.0,-60.0,-70.0,-71.0,-67.0,-60.0,-91.0,-94.0,-90.0,-93.0,21.0,23.0,23.0,33.0,0
1396,BA:8C:B9:54:50:24,3819927,482402427,1733,838098,3818194,481564329,0,5582,822652,5562,819530,20,3122,1004,14,2108,29,0,49,216660.0,130000.0,-49.0,-35.0,-42.0,-44.0,-44.0,-36.0,-43.0,-47.0,-91.0,-94.0,-90.0,-93.0,42.0,59.0,48.0,49.0,0
1397,92:69:1D:31:68:E9,3821677,485020382,3483,3456053,3818194,481564329,0,3631,931907,3533,910112,98,21795,1795,6,3609,78,0,31,216660.0,130000.0,-52.0,-50.0,-44.0,-46.0,-51.0,-49.0,-43.0,-47.0,-91.0,-94.0,-90.0,-93.0,39.0,44.0,46.0,47.0,0
1398,CC:2F:71:3F:1F:24,4409189,1166612011,590995,685047682,3818194,481564329,37,492448,557477467,491879,557408849,569,68618,474780,10,591232,46245,34,431,144444.0,43333.0,-67.0,-65.0,-70.0,-68.0,-67.0,-65.0,-70.0,-67.0,-91.0,-94.0,-90.0,-93.0,24.0,29.0,20.0,25.0,0
1399,CC:2F:71:3E:C5:1F,3818884,481648699,690,84370,3818194,481564329,0,2946,246736,2440,186584,506,60152,731,8,1021,18,0,32,130000.0,39000.0,-70.0,-71.0,-67.0,-60.0,-70.0,-71.0,-67.0,-60.0,-91.0,-94.0,-90.0,-93.0,21.0,23.0,23.0,33.0,0
1400,BA:8C:B9:54:50:24,3819930,482402689,1733,838098,3818197,481564591,0,5582,822652,5562,819530,20,3122,1004,14,2108,29,0,49,216660.0,130000.0,-49.0,-35.0,-42.0,-44.0,-44.0,-36.0,-43.0,-47.0,-91.0,-94.0,-90.0,-93.0,42.0,59.0,48.0,49.0,0
1401,92:69:1D:31:68:E9,3821686,485021250,3483,3456053,3818203,481565197,0,3631,931907,3533,910112,98,21795,1795,6,3609,78,0,31,216660.0,130000.0,-52.0,-50.0,-44.0,-46.0,-51.0,-49.0,-43.0,-47.0,-91.0,-94.0,-90.0,-93.0,39.0,44.0,46.0,47.0,0
1402,CC:2F:71:3F:1F:24,4409239,1166627177,591036,685061980,3818203,481565197,37,492475,557482527,491906,557413909,569,68618,474807,10,591273,46253,34,431,130000.0,43333.0,-67.0,-65.0,-70.0,-67.0,-67.0,-65.0,-70.0,-67.0,-91.0,-94.0,-90.0,-93.0,24.0,29.0,20.0,26.0,0
1403,CC:2F:71:3E:C5:1F,3818893,481649567,690,84370,3818203,481565197,0,2946,246736,2440,186584,506,60152,731,8,1021,18,0,32,130000.0,39000.0,-70.0,-71.0,-67.0,-60.0,-70.0,-71.0,-67.0,-60.0,-91.0,-94.0,-90.0,-93.0,21.0,23.0,23.0,33.0,0
1404,BA:8C:B9:54:50:24,3819936,482403295,1733,838098,3818203,481565197,0,5583,822720,5563,819598,20,3122,1004,14,2108,29,0,49,216660.0,130000.0,-40.0,-37.0,-45.0,-52.0,-44.0,-36.0,-43.0,-47.0,-91.0,-94.0,-90.0,-93.0,51.0,57.0,45.0,41.0,0
1405,92:69:1D:31:68:E9,3821686,485021250,3483,3456053,3818203,481565197,0,3631,931907,3533,910112,98,21795,1795,6,3609,78,0,31,216660.0,130000.0,-52.0,-50.0,-44.0,-46.0,-51.0,-49.0,-43.0,-47.0,-91.0,-94.0,-90.0,-93.0,39.0,44.0,46.0,47.0,0
1406,CC:2F:71:3F:1F:24,4409280,1166641531,591077,685076334,3818203,481565197,37,492500,557487331,491931,557418713,569,68618,474832,10,591314,46258,34,431,130000.0,39000.0,-67.0,-65.0,-71.0,-67.0,-67.0,-64.0,-70.0,-67.0,-91.0,-94.0,-90.0,-93.0,24.0,29.0,19.0,26.0,0
1407,CC:2F:71:3E:C5:1F,3818895,481649769,690,84370,3818205,481565399,0,2946,246736,2440,186584,506,60152,731,8,1021,18,0,32,130000.0,39000.0,-70.0,-71.0,-67.0,-60.0,-70.0,-71.0,-67.0,-60.0,-91.0,-94.0,-90.0,-93.0,21.0,23.0,23.0,33.0,0
1408,BA:8C:B9:54:50:24,3819938,482403497,1733,838098,3818205,481565399,0,5583,822720,5563,819598,20,3122,1004,14,2108,29,0,49,216660.0,130000.0,-40.0,-37.0,-45.0,-52.0,-44.0,-36.0,-43.0,-47.0,-91.0,-94.0,-90.0,-93.0,51.0,57.0,45.0,41.0,0
1409,92:69:1D:31:68:E9,3821695,485022118,3483,3456053,3818212,481566065,0,3631,931907,3533,910112,98,21795,1795,6,3609,78,0,31,216660.0,130000.0,-52.0,-50.0,-44.0,-46.0,-51.0,-49.0,-43.0,-47.0,-91.0,-94.0,-90.0,-93.0,39.0,44.0,46.0,47.0,0
1410,CC:2F:71:3F:1F:24,4409331,1166656771,591119,685090706,3818212,481566065,37,492525,557492135,491956,557423517,569,68618,474857,10,591356,46291,34,431,130000.0,43333.0,-67.0,-65.0,-70.0,-67.0,-67.0,-65.0,-70.0,-67.0,-91.0,-94.0,-90.0,-93.0,24.0,29.0,20.0,26.0,0
1411,CC:2F:71:3E:C5:1F,3818902,481650435,690,84370,3818212,481566065,0,2946,246736,2440,186584,506,60152,731,8,1021,18,0,32,130000.0,39000.0,-70.0,-71.0,-67.0,-60.0,-70.0,-71.0,-67.0,-60.0,-91.0,-94.0,-90.0,-93.0,21.0,23.0,23.0,33.0,0
1412,BA:8C:B9:54:50:24,3819945,482404163,1733,838098,3818212,481566065,0,5583,822720,5563,819598,20,3122,1004,14,2108,29,0,49,216660.0,130000.0,-40.0,-37.0,-45.0,-52.0,-44.0,-36.0,-43.0,-47.0,-91.0,-94.0,-90.0,-93.0,51.0,57.0,45.0,41.0,0
1413,92:69:1D:31:68:E9,3821695,485022118,3483,3456053,3818212,481566065,0,3631,931907,3533,910112,98,21795,1795,6,3609,78,0,31,216660.0,130000.0,-52.0,-50.0,-44.0,-46.0,-51.0,-49.0,-43.0,-47.0,-91.0,-94.0,-90.0,-93.0,39.0,44.0,46.0,47.0,0
1414,CC:2F:71:3F:1F:24,4409373,1166671311,591161,685105246,3818212,481566065,37,492551,557497079,491982,557428461,569,68618,474883,10,591398,46294,34,431,130000.0,43333.0,-67.0,-65.0,-70.0,-68.0,-67.0,-65.0,-70.0,-67.0,-91.0,-94.0,-90.0,-93.0,24.0,29.0,20.0,25.0,0
1415,CC:2F:71:3E:C5:1F,3818904,481650637,690,84370,3818214,481566267,0,2946,246736,2440,186584,506,60152,731,8,1021,18,0,32,130000.0,39000.0,-70.0,-71.0,-67.0,-60.0,-70.0,-71.0,-67.0,-60.0,-91.0,-94.0,-90.0,-93.0,21.0,23.0,23.0,33.0,0
1416,BA:8C:B9:54:50:24,3819947,482404365,1733,838098,3818214,481566267,0,5583,822720,5563,819598,20,3122,1004,14,2108,29,0,49,216660.0,130000.0,-40.0,-37.0,-45.0,-52.0,-44.0,-36.0,-43.0,-47.0,-91.0,-94.0,-90.0,-93.0,51.0,57.0,45.0,41.0,0
1417,92:69:1D:31:68:E9,3821703,485022926,3483,3456053,3818220,481566873,0,3631,931907,3533,910112,98,21795,1795,6,3609,78,0,31,216660.0,130000.0,-52.0,-50.0,-44.0,-46.0,-51.0,-49.0,-43.0,-47.0,-91.0,-94.0,-90.0,-93.0,39.0,44.0,46.0,47.0,0
1418,CC:2F:71:3F:1F:24,4409423,1166686547,591203,685119674,3818220,481566873,37,492576,557501883,492007,557433265,569,68618,474908,10,591440,46311,34,431,117000.0,39000.0,-67.0,-65.0,-70.0,-68.0,-67.0,-65.0,-70.0,-67.0,-91.0,-94.0,-90.0,-93.0,24.0,29.0,20.0,25.0,0
1419,CC:2F:71:3E:C5:1F,3818910,481651243,690,84370,3818220,481566873,0,2946,246736,2440,186584,506,60152,731,8,1021,18,0,32,130000.0,39000.0,-70.0,-71.0,-67.0,-60.0,-70.0,-71.0,-67.0,-60.0,-91.0,-94.0,-90.0,-93.0,21.0,23.0,23.0,33.0,0
1420,BA:8C:B9:54:50:24,3819953,482404971,1733,838098,3818220,481566873,0,5583,822720,5563,819598,20,3122,1004,14,2108,29,0,49,216660.0,130000.0,-40.0,-37.0,-45.0,-52.0,-44.0,-36.0,-43.0,-47.0,-91.0,-94.0,-90.0,-93.0,51.0,57.0,45.0,41.0,0
1421,92:69:1D:31:68:E9,3821704,485022986,3483,3456053,3818221,481566933,0,3631,931907,3533,910112,98,21795,1795,6,3609,78,0,31,216660.0,130000.0,-52.0,-50.0,-44.0,-46.0,-51.0,-49.0,-43.0,-47.0,-90.0,-93.0,-90.0,-93.0,38.0,43.0,46.0,47.0,0
1422,CC:2F:71:3F:1F:24,4409470,1166701491,591247,685134356,3818223,481567135,37,492603,557506967,492034,557438349,569,68618,474935,10,591484,46319,34,431,130000.0,43333.0,-67.0,-65.0,-70.0,-68.0,-67.0,-65.0,-70.0,-67.0,-90.0,-93.0,-90.0,-93.0,23.0,28.0,20.0,25.0,0
1423,CC:2F:71:3E:C5:1F,3818913,481651505,690,84370,3818223,481567135,0,2946,246736,2440,186584,506,60152,731,8,1021,18,0,32,130000.0,39000.0,-70.0,-71.0,-67.0,-60.0,-70.0,-71.0,-67.0,-60.0,-90.0,-93.0,-90.0,-93.0,20.0,22.0,23.0,33.0,0
1424,BA:8C:B9:54:50:24,3819956,482405233,1733,838098,3818223,481567135,0,5583,822720,5563,819598,20,3122,1004,14,2108,29,0,49,216660.0,130000.0,-40.0,-37.0,-45.0,-52.0,-44.0,-36.0,-43.0,-47.0,-90.0,-93.0,-90.0,-93.0,50.0,56.0,45.0,41.0,0
1425,92:69:1D:31:68:E9,3821712,485023794,3483,3456053,3818229,481567741,0,3631,931907,3533,910112,98,21795,1795,6,3609,78,0,31,216660.0,130000.0,-52.0,-50.0,-44.0,-46.0,-51.0,-49.0,-43.0,-47.0,-90.0,-93.0,-90.0,-93.0,38.0,43.0,46.0,47.0,0
1426,CC:2F:71:3F:1F:24,4409516,1166716389,591287,685148648,3818229,481567741,37,492630,557512027,492061,557443409,569,68618,474962,10,591524,46327,34,431,130000.0,43333.0,-67.0,-65.0,-70.0,-67.0,-67.0,-65.0,-70.0,-67.0,-90.0,-93.0,-90.0,-93.0,23.0,28.0,20.0,26.0,0
1427,CC:2F:71:3E:C5:1F,3818919,481652111,690,84370,3818229,481567741,0,2946,246736,2440,186584,506,60152,731,8,1021,18,0,32,130000.0,39000.0,-70.0,-71.0,-67.0,-60.0,-70.0,-71.0,-67.0,-60.0,-90.0,-93.0,-90.0,-93.0,20.0,22.0,23.0,33.0,0
1428,BA:8C:B9:54:50:24,3819962,482405839,1733,838098,3818229,481567741,0,5583,822720,5563,819598,20,3122,1004,14,2108,29,0,49,216660.0,130000.0,-40.0,-37.0,-45.0,-52.0,-44.0,-36.0,-43.0,-47.0,-90.0,-93.0,-90.0,-93.0,50.0,56.0,45.0,41.0,0
1429,92:69:1D:31:68:E9,3821712,485023794,3483,3456053,3818229,481567741,0,3631,931907,3533,910112,98,21795,1795,6,3609,78,0,31,216660.0,130000.0,-52.0,-50.0,-44.0,-46.0,-51.0,-49.0,-43.0,-47.0,-90.0,-93.0,-90.0,-93.0,38.0,43.0,46.0,47.0,0
1430,CC:2F:71:3F:1F:24,4409560,1166731019,591329,685163076,3818231,481567943,37,492656,557516971,492087,557448353,569,68618,474988,10,591566,46350,34,431,117000.0,39000.0,-67.0,-65.0,-71.0,-67.0,-67.0,-65.0,-70.0,-67.0,-90.0,-93.0,-90.0,-93.0,23.0,28.0,19.0,26.0,0
1431,CC:2F:71:3E:C5:1F,3818922,481652373,690,84370,3818232,481568003,0,2946,246736,2440,186584,506,60152,731,8,1021,18,0,32,130000.0,39000.0,-70.0,-71.0,-67.0,-60.0,-70.0,-71.0,-67.0,-60.0,-90.0,-93.0,-90.0,-93.0,20.0,22.0,23.0,33.0,0
1432,BA:8C:B9:54:50:24,3819965,482406101,1733,838098,3818232,481568003,0,5587,822992,5567,819870,20,3122,1004,14,2108,29,0,49,216660.0,130000.0,-40.0,-37.0,-45.0,-52.0,-44.0,-36.0,-43.0,-47.0,-90.0,-93.0,-90.0,-93.0,50.0,56.0,45.0,41.0,0
1433,92:69:1D:31:68:E9,3821721,485024662,3483,3456053,3818238,481568609,0,3631,931907,3533,910112,98,21795,1795,6,3609,78,0,31,216660.0,130000.0,-52.0,-50.0,-44.0,-46.0,-51.0,-49.0,-43.0,-47.0,-90.0,-93.0,-90.0,-93.0,38.0,43.0,46.0,47.0,0
1434,CC:2F:71:3F:1F:24,4409608,1166745989,591370,685177380,3818238,481568609,37,492681,557521775,492112,557453157,569,68618,475013,10,591607,46355,34,431,130000.0,43333.0,-67.0,-65.0,-70.0,-68.0,-67.0,-65.0,-70.0,-67.0,-90.0,-93.0,-90.0,-93.0,23.0,28.0,20.0,25.0,0
1435,CC:2F:71:3E:C5:1F,3818928,481652979,690,84370,3818238,481568609,0,2946,246736,2440,186584,506,60152,731,8,1021,18,0,32,130000.0,39000.0,-70.0,-71.0,-67.0,-60.0,-70.0,-71.0,-67.0,-60.0,-90.0,-93.0,-90.0,-93.0,20.0,22.0,23.0,33.0,0
1436,BA:8C:B9:54:50:24,3819971,482406707,1733,838098,3818238,481568609,0,5587,822992,5567,819870,20,3122,1004,14,2108,29,0,49,216660.0,130000.0,-40.0,-37.0,-45.0,-52.0,-44.0,-36.0,-43.0,-47.0,-90.0,-93.0,-90.0,-93.0,50.0,56.0,45.0,41.0,0
1437,92:69:1D:31:68:E9,3821721,485024662,3483,3456053,3818238,481568609,0,3631,931907,3533,910112,98,21795,1795,6,3609,78,0,31,216660.0,130000.0,-52.0,-50.0,-44.0,-46.0,-51.0,-49.0,-43.0,-47.0,-90.0,-93.0,-90.0,-93.0,38.0,43.0,46.0,47.0,0
1438,CC:2F:71:3F:1F:24,4409652,1166760675,591412,685191864,3818240,481568811,37,492707,557526719,492138,557458101,569,68618,475039,10,591649,46377,34,431,130000.0,39000.0,-67.0,-65.0,-70.0,-67.0,-67.0,-65.0,-70.0,-67.0,-90.0,-93.0,-90.0,-93.0,23.0,28.0,20.0,26.0,0
1439,CC:2F:71:3E:C5:1F,3818930,481653181,690,84370,3818240,481568811,0,2946,246736,2440,186584,506,60152,731,8,1021,18,0,32,130000.0,39000.0,-70.0,-71.0,-67.0,-60.0,-70.0,-71.0,-67.0,-60.0,-90.0,-93.0,-90.0,-93.0,20.0,22.0,23.0,33.0,0
1440,BA:8C:B9:54:50:24,3819973,482406909,1733,838098,3818240,481568811,0,5587,822992,5567,819870,20,3122,1004,14,2108,29,0,49,216660.0,130000.0,-40.0,-37.0,-45.0,-52.0,-44.0,-36.0,-43.0,-47.0,-90.0,-93.0,-90.0,-93.0,50.0,56.0,45.0,41.0,0
1441,92:69:1D:31:68:E9,3821730,485025530,3483,3456053,3818247,481569477,0,3631,931907,3533,910112,98,21795,1795,6,3609,78,0,31,216660.0,130000.0,-52.0,-50.0,-44.0,-46.0,-51.0,-49.0,-43.0,-47.0,-90.0,-93.0,-90.0,-93.0,38.0,43.0,46.0,47.0,0
1442,CC:2F:71:3F:1F:24,4409704,1166776097,591457,685206620,3818247,481569477,37,492737,557532199,492168,557463581,569,68618,475069,10,591694,46385,34,431,130000.0,43333.0,-67.0,-65.0,-70.0,-68.0,-67.0,-65.0,-70.0,-67.0,-90.0,-93.0,-90.0,-93.0,23.0,28.0,20.0,25.0,0
1443,CC:2F:71:3E:C5:1F,3818937,481653847,690,84370,3818247,481569477,0,2946,246736,2440,186584,506,60152,731,8,1021,18,0,32,130000.0,39000.0,-70.0,-71.0,-67.0,-60.0,-70.0,-71.0,-67.0,-60.0,-90.0,-93.0,-90.0,-93.0,20.0,22.0,23.0,33.0,0
1444,BA:8C:B9:54:50:24,3819980,482407575,1733,838098,3818247,481569477,0,5587,822992,5567,819870,20,3122,1004,14,2108,29,0,49,216660.0,130000.0,-40.0,-37.0,-45.0,-52.0,-44.0,-36.0,-43.0,-47.0,-90.0,-93.0,-90.0,-93.0,50.0,56.0,45.0,41.0,0
1445,92:69:1D:31:68:E9,3821732,485025919,3484,3456169,3818248,481569750,0,3633,932043,3535,910248,98,21795,1795,6,3610,78,0,31,216660.0,130000.0,-51.0,-47.0,-42.0,-49.0,-51.0,-49.0,-43.0,-47.0,-90.0,-93.0,-90.0,-93.0,39.0,46.0,48.0,44.0,0
1446,CC:2F:71:3F:1F:24,4409751,1166791358,591501,685221406,3818250,481569952,37,492769,557537947,492200,557469329,569,68618,475101,10,591738,46395,34,431,130000.0,43333.0,-67.0,-65.0,-70.0,-67.0,-67.0,-65.0,-70.0,-67.0,-90.0,-93.0,-90.0,-93.0,23.0,28.0,20.0,26.0,0
1447,CC:2F:71:3E:C5:1F,3818941,481654438,691,84486,3818250,481569952,0,2948,246876,2442,186724,506,60152,731,8,1022,18,0,32,130000.0,39000.0,-70.0,-71.0,-67.0,-60.0,-70.0,-71.0,-67.0,-60.0,-90.0,-93.0,-90.0,-93.0,20.0,22.0,23.0,33.0,0
1448,BA:8C:B9:54:50:24,3819984,482408166,1734,838214,3818250,481569952,0,5589,823128,5569,820006,20,3122,1004,14,2109,29,0,49,216660.0,130000.0,-49.0,-35.0,-42.0,-44.0,-44.0,-36.0,-43.0,-47.0,-90.0,-93.0,-90.0,-93.0,41.0,58.0,48.0,49.0,0
1449,92:69:1D:31:68:E9,3821740,485026727,3484,3456169,3818256,481570558,0,3633,932043,3535,910248,98,21795,1795,6,3610,78,0,31,216660.0,130000.0,-51.0,-47.0,-42.0,-49.0,-51.0,-49.0,-43.0,-47.0,-90.0,-93.0,-90.0,-93.0,39.0,46.0,48.0,44.0,0
1450,CC:2F:71:3F:1F:24,4409800,1166806516,591544,685235958,3818256,481570558,37,492798,557543311,492229,557474693,569,68618,475130,10,591781,46416,34,431,117000.0,39000.0,-67.0,-65.0,-70.0,-67.0,-67.0,-65.0,-70.0,-67.0,-90.0,-93.0,-90.0,-93.0,23.0,28.0,20.0,26.0,0
1451,CC:2F:71:3E:C5:1F,3818947,481655044,691,84486,3818256,481570558,0,2948,246876,2442,186724,506,60152,731,8,1022,18,0,32,130000.0,39000.0,-70.0,-71.0,-67.0,-60.0,-70.0,-71.0,-67.0,-60.0,-90.0,-93.0,-90.0,-93.0,20.0,22.0,23.0,33.0,0
1452,BA:8C:B9:54:50:24,3819990,482408772,1734,838214,3818256,481570558,0,5589,823128,5569,820006,20,3122,1004,14,2109,29,0,49,216660.0,130000.0,-49.0,-35.0,-42.0,-44.0,-44.0,-36.0,-43.0,-47.0,-90.0,-93.0,-90.0,-93.0,41.0,58.0,48.0,49.0,0
1453,92:69:1D:31:68:E9,3821743,485026989,3484,3456169,3818259,481570820,0,3633,932043,3535,910248,98,21795,1795,6,3610,78,0,31,216660.0,130000.0,-51.0,-47.0,-42.0,-49.0,-51.0,-49.0,-43.0,-47.0,-90.0,-93.0,-90.0,-93.0,39.0,46.0,48.0,44.0,0
1454,CC:2F:71:3F:1F:24,4409844,1166821082,591585,685250262,3818259,481570820,37,492829,557548883,492260,557480265,569,68618,475161,10,591822,46427,34,431,130000.0,43333.0,-67.0,-65.0,-70.0,-68.0,-67.0,-65.0,-70.0,-67.0,-90.0,-93.0,-90.0,-93.0,23.0,28.0,20.0,25.0,0
1455,CC:2F:71:3E:C5:1F,3818950,481655306,691,84486,3818259,481570820,0,2948,246876,2442,186724,506,60152,731,8,1022,18,0,32,130000.0,39000.0,-70.0,-71.0,-67.0,-60.0,-70.0,-71.0,-67.0,-60.0,-90.0,-93.0,-90.0,-93.0,20.0,22.0,23.0,33.0,0
1456,BA:8C:B9:54:50:24,3819993,482409034,1734,838214,3818259,481570820,0,5589,823128,5569,820006,20,3122,1004,14,2109,29,0,49,216660.0,130000.0,-49.0,-35.0,-42.0,-44.0,-44.0,-36.0,-43.0,-47.0,-90.0,-93.0,-90.0,-93.0,41.0,58.0,48.0,49.0,0
1457,92:69:1D:31:68:E9,3821749,485027595,3484,3456169,3818265,481571426,0,3633,932043,3535,910248,98,21795,1795,6,3610,78,0,31,216660.0,130000.0,-51.0,-47.0,-42.0,-49.0,-51.0,-49.0,-43.0,-47.0,-90.0,-93.0,-90.0,-93.0,39.0,46.0,48.0,44.0,0
1458,CC:2F:71:3F:1F:24,4409894,1166836488,591629,685265062,3818265,481571426,37,492858,557554247,492289,557485629,569,68618,475190,10,591866,46431,34,431,130000.0,43333.0,-67.0,-65.0,-70.0,-67.0,-67.0,-65.0,-70.0,-67.0,-90.0,-93.0,-90.0,-93.0,23.0,28.0,20.0,26.0,0
1459,CC:2F:71:3E:C5:1F,3818956,481655912,691,84486,3818265,481571426,0,2948,246876,2442,186724,506,60152,731,8,1022,18,0,32,130000.0,39000.0,-70.0,-71.0,-67.0,-60.0,-70.0,-71.0,-67.0,-60.0,-90.0,-93.0,-89.0,-93.0,20.0,22.0,22.0,33.0,0
1460,BA:8C:B9:54:50:24,3819999,482409640,1734,838214,3818265,481571426,0,5589,823128,5569,820006,20,3122,1004,14,2109,29,0,49,216660.0,130000.0,-49.0,-35.0,-42.0,-44.0,-44.0,-36.0,-43.0,-47.0,-90.0,-93.0,-89.0,-93.0,41.0,58.0,47.0,49.0,0
1461,92:69:1D:31:68:E9,3821752,485027857,3484,3456169,3818268,481571688,0,3633,932043,3535,910248,98,21795,1795,6,3610,78,0,31,216660.0,130000.0,-51.0,-47.0,-42.0,-49.0,-51.0,-49.0,-43.0,-47.0,-90.0,-93.0,-89.0,-93.0,39.0,46.0,47.0,44.0,0
1462,CC:2F:71:3F:1F:24,4409940,1166851246,591672,685279558,3818268,481571688,37,492888,557559727,492319,557491109,569,68618,475220,10,591909,46450,34,431,130000.0,39000.0,-67.0,-65.0,-70.0,-67.0,-67.0,-65.0,-70.0,-67.0,-90.0,-93.0,-89.0,-93.0,23.0,28.0,19.0,26.0,0
1463,CC:2F:71:3E:C5:1F,3818959,481656174,691,84486,3818268,481571688,0,2948,246876,2442,186724,506,60152,731,8,1022,18,0,32,130000.0,39000.0,-70.0,-71.0,-67.0,-60.0,-70.0,-71.0,-67.0,-60.0,-90.0,-93.0,-89.0,-93.0,20.0,22.0,22.0,33.0,0
1464,BA:8C:B9:54:50:24,3820002,482409902,1734,838214,3818268,481571688,0,5589,823128,5569,820006,20,3122,1004,14,2109,29,0,49,216660.0,130000.0,-49.0,-35.0,-42.0,-44.0,-44.0,-36.0,-43.0,-47.0,-90.0,-93.0,-89.0,-93.0,41.0,58.0,47.0,49.0,0
1465,92:69:1D:31:68:E9,3821758,485028463,3484,3456169,3818274,481572294,0,3633,932043,3535,910248,98,21795,1795,6,3610,78,0,31,216660.0,130000.0,-51.0,-47.0,-42.0,-49.0,-51.0,-49.0,-43.0,-47.0,-90.0,-93.0,-89.0,-93.0,39.0,46.0,47.0,44.0,0
1466,CC:2F:71:3F:1F:24,4409989,1166866460,591715,685294166,3818274,481572294,37,492917,557565091,492348,557496473,569,68618,475249,10,591952,46453,34,431,130000.0,43333.0,-67.0,-65.0,-70.0,-67.0,-67.0,-65.0,-70.0,-67.0,-90.0,-93.0,-89.0,-93.0,23.0,28.0,19.0,26.0,0
1467,CC:2F:71:3E:C5:1F,3818965,481656780,691,84486,3818274,481572294,0,2948,246876,2442,186724,506,60152,731,8,1022,18,0,32,130000.0,39000.0,-70.0,-71.0,-67.0,-60.0,-70.0,-71.0,-67.0,-60.0,-90.0,-93.0,-89.0,-93.0,20.0,22.0,22.0,33.0,0
1468,BA:8C:B9:54:50:24,3820008,482410508,1734,838214,3818274,481572294,0,5589,823128,5569,820006,20,3122,1004,14,2109,29,0,49,216660.0,130000.0,-49.0,-35.0,-42.0,-44.0,-44.0,-36.0,-43.0,-47.0,-90.0,-93.0,-89.0,-93.0,41.0,58.0,47.0,49.0,0
1469,92:69:1D:31:68:E9,3821761,485028727,3484,3456169,3818277,481572558,0,3633,932043,3535,910248,98,21795,1795,6,3610,78,0,31,216660.0,130000.0,-51.0,-47.0,-42.0,-49.0,-51.0,-49.0,-43.0,-47.0,-90.0,-93.0,-89.0,-93.0,39.0,46.0,47.0,44.0,0
1470,CC:2F:71:3F:1F:24,4410035,1166881332,591758,685308774,3818277,481572558,37,492947,557570549,492377,557501813,570,68736,475279,10,591995,46471,34,431,130000.0,39000.0,-67.0,-65.0,-70.0,-67.0,-67.0,-65.0,-70.0,-67.0,-90.0,-93.0,-89.0,-93.0,23.0,28.0,19.0,26.0,0
1471,CC:2F:71:3E:C5:1F,3818968,481657044,691,84486,3818277,481572558,0,2948,246876,2442,186724,506,60152,731,8,1022,18,0,32,130000.0,39000.0,-70.0,-71.0,-67.0,-60.0,-70.0,-71.0,-67.0,-60.0,-90.0,-93.0,-89.0,-93.0,20.0,22.0,22.0,33.0,0
1472,BA:8C:B9:54:50:24,3820011,482410772,1734,838214,3818277,481572558,0,5589,823128,5569,820006,20,3122,1004,14,2109,29,0,49,216660.0,130000.0,-49.0,-35.0,-42.0,-44.0,-44.0,-36.0,-43.0,-47.0,-90.0,-93.0,-89.0,-93.0,41.0,58.0,47.0,49.0,0
1473,92:69:1D:31:68:E9,3821768,485029393,3484,3456169,3818284,481573224,0,3633,932043,3535,910248,98,21795,1795,6,3610,78,0,31,216660.0,130000.0,-51.0,-47.0,-42.0,-49.0,-51.0,-49.0,-43.0,-47.0,-90.0,-93.0,-89.0,-93.0,39.0,46.0,47.0,44.0,0
1474,CC:2F:71:3F:1F:24,4410084,1166896426,591800,685323202,3818284,481573224,37,492976,557575913,492406,557507177,570,68736,475308,10,592037,46480,34,431,130000.0,39000.0,-67.0,-65.0,-70.0,-67.0,-67.0,-65.0,-70.0,-67.0,-90.0,-93.0,-89.0,-93.0,23.0,28.0,19.0,26.0,0
1475,CC:2F:71:3E:C5:1F,3818975,481657710,691,84486,3818284,481573224,0,2948,246876,2442,186724,506,60152,731,8,1022,18,0,32,130000.0,39000.0,-70.0,-71.0,-67.0,-60.0,-70.0,-71.0,-67.0,-60.0,-90.0,-93.0,-89.0,-93.0,20.0,22.0,22.0,33.0,0
1476,BA:8C:B9:54:50:24,3820018,482411438,1734,838214,3818284,481573224,0,5589,823128,5569,820006,20,3122,1004,14,2109,29,0,49,216660.0,130000.0,-49.0,-35.0,-42.0,-44.0,-44.0,-36.0,-43.0,-47.0,-90.0,-93.0,-89.0,-93.0,41.0,58.0,47.0,49.0,0
1477,92:69:1D:31:68:E9,3821770,485029595,3484,3456169,3818286,481573426,0,3633,932043,3535,910248,98,21795,1795,6,3610,78,0,31,216660.0,130000.0,-51.0,-47.0,-42.0,-49.0,-51.0,-49.0,-43.0,-47.0,-90.0,-93.0,-89.0,-93.0,39.0,46.0,47.0,44.0,0
1478,CC:2F:71:3F:1F:24,4410128,1166911112,591842,685337686,3818286,481573426,37,493007,557581485,492437,557512749,570,68736,475339,10,592079,46485,34,431,130000.0,43333.0,-67.0,-65.0,-70.0,-67.0,-67.0,-65.0,-70.0,-67.0,-90.0,-93.0,-89.0,-93.0,23.0,28.0,19.0,26.0,0
1479,CC:2F:71:3E:C5:1F,3818977,481657912,691,84486,3818286,481573426,0,2948,246876,2442,186724,506,60152,731,8,1022,18,0,32,130000.0,39000.0,-70.0,-71.0,-67.0,-60.0,-70.0,-71.0,-67.0,-60.0,-90.0,-93.0,-89.0,-93.0,20.0,22.0,22.0,33.0,0
1480,BA:8C:B9:54:50:24,3820020,482411640,1734,838214,3818286,481573426,0,5589,823128,5569,820006,20,3122,1004,14,2109,29,0,49,216660.0,130000.0,-49.0,-35.0,-42.0,-44.0,-44.0,-36.0,-43.0,-47.0,-90.0,-93.0,-89.0,-93.0,41.0,58.0,47.0,49.0,0
1481,92:69:1D:31:68:E9,3821776,485030201,3484,3456169,3818292,481574032,0,3633,932043,3535,910248,98,21795,1795,6,3610,78,0,31,216660.0,130000.0,-51.0,-47.0,-42.0,-49.0,-51.0,-49.0,-43.0,-47.0,-90.0,-93.0,-90.0,-93.0,39.0,46.0,48.0,44.0,0
1482,CC:2F:71:3F:1F:24,4410177,1166926270,591885,685352238,3818292,481574032,37,493037,557586941,492467,557518205,570,68736,475369,10,592122,46503,34,431,117000.0,39000.0,-67.0,-65.0,-71.0,-67.0,-67.0,-65.0,-70.0,-67.0,-90.0,-93.0,-90.0,-93.0,23.0,28.0,19.0,26.0,0
1483,CC:2F:71:3E:C5:1F,3818983,481658518,691,84486,3818292,481574032,0,2948,246876,2442,186724,506,60152,731,8,1022,18,0,32,130000.0,39000.0,-70.0,-71.0,-67.0,-60.0,-70.0,-71.0,-67.0,-60.0,-90.0,-93.0,-90.0,-93.0,20.0,22.0,23.0,33.0,0
1484,BA:8C:B9:54:50:24,3820027,482412306,1734,838214,3818293,481574092,0,5589,823128,5569,820006,20,3122,1004,14,2109,29,0,49,216660.0,130000.0,-49.0,-35.0,-42.0,-44.0,-44.0,-36.0,-43.0,-47.0,-90.0,-93.0,-90.0,-93.0,41.0,58.0,48.0,49.0,0
1485,92:69:1D:31:68:E9,3821779,485030463,3484,3456169,3818295,481574294,0,3634,932111,3536,910316,98,21795,1795,6,3610,78,0,31,216660.0,130000.0,-52.0,-50.0,-44.0,-46.0,-51.0,-49.0,-43.0,-47.0,-90.0,-93.0,-90.0,-93.0,38.0,43.0,46.0,47.0,0
1486,CC:2F:71:3F:1F:24,4410223,1166941084,591928,685366790,3818295,481574294,37,493067,557592421,492497,557523685,570,68736,475399,10,592165,46507,34,431,130000.0,43333.0,-67.0,-65.0,-70.0,-68.0,-67.0,-65.0,-70.0,-67.0,-90.0,-93.0,-90.0,-93.0,23.0,28.0,20.0,25.0,0
1487,CC:2F:71:3E:C5:1F,3818986,481658780,691,84486,3818295,481574294,0,2948,246876,2442,186724,506,60152,731,8,1022,18,0,32,130000.0,39000.0,-70.0,-71.0,-67.0,-60.0,-70.0,-71.0,-67.0,-60.0,-90.0,-93.0,-90.0,-93.0,20.0,22.0,23.0,33.0,0
1488,BA:8C:B9:54:50:24,3820029,482412508,1734,838214,3818295,481574294,0,5589,823128,5569,820006,20,3122,1004,14,2109,29,0,49,216660.0,130000.0,-49.0,-35.0,-42.0,-44.0,-44.0,-36.0,-43.0,-47.0,-90.0,-93.0,-90.0,-93.0,41.0,58.0,48.0,49.0,0
1489,92:69:1D:31:68:E9,3821785,485031069,3484,3456169,3818301,481574900,0,3634,932111,3536,910316,98,21795,1795,6,3610,78,0,31,216660.0,130000.0,-52.0,-50.0,-44.0,-46.0,-51.0,-49.0,-43.0,-47.0,-90.0,-93.0,-90.0,-93.0,38.0,43.0,46.0,47.0,0
1490,CC:2F:71:3F:1F:24,4410270,1166956050,591969,685381150,3818301,481574900,37,493096,557597785,492526,557529049,570,68736,475428,10,592206,46512,34,431,130000.0,39000.0,-67.0,-65.0,-70.0,-67.0,-67.0,-65.0,-70.0,-67.0,-90.0,-93.0,-90.0,-93.0,23.0,28.0,20.0,26.0,0
1491,CC:2F:71:3E:C5:1F,3818992,481659386,691,84486,3818301,481574900,0,2948,246876,2442,186724,506,60152,731,8,1022,18,0,32,130000.0,39000.0,-70.0,-71.0,-67.0,-60.0,-70.0,-71.0,-67.0,-60.0,-90.0,-93.0,-90.0,-93.0,20.0,22.0,23.0,33.0,0
1492,BA:8C:B9:54:50:24,3820035,482413114,1734,838214,3818301,481574900,0,5589,823128,5569,820006,20,3122,1004,14,2109,29,0,49,216660.0,130000.0,-49.0,-35.0,-42.0,-44.0,-44.0,-36.0,-43.0,-47.0,-90.0,-93.0,-90.0,-93.0,41.0,58.0,48.0,49.0,0
1493,92:69:1D:31:68:E9,3821789,485031393,3484,3456169,3818305,481575224,0,3634,932111,3536,910316,98,21795,1795,6,3610,78,0,31,216660.0,130000.0,-52.0,-50.0,-44.0,-46.0,-51.0,-49.0,-43.0,-47.0,-90.0,-93.0,-90.0,-93.0,38.0,43.0,46.0,47.0,0
1494,CC:2F:71:3F:1F:24,4410317,1166970982,592012,685395758,3818305,481575224,37,493125,557603149,492555,557534413,570,68736,475457,10,592249,46536,34,431,130000.0,39000.0,-67.0,-65.0,-71.0,-67.0,-67.0,-65.0,-70.0,-67.0,-90.0,-93.0,-90.0,-93.0,23.0,28.0,19.0,26.0,0
1495,CC:2F:71:3E:C5:1F,3818996,481659710,691,84486,3818305,481575224,0,2950,247064,2443,186794,507,60270,732,8,1022,18,0,32,130000.0,39000.0,-70.0,-71.0,-67.0,-60.0,-70.0,-71.0,-67.0,-60.0,-90.0,-93.0,-90.0,-93.0,20.0,22.0,23.0,33.0,0
1496,BA:8C:B9:54:50:24,3820051,482419037,1734,838214,3818317,481580823,0,5589,823128,5569,820006,20,3122,1004,14,2109,29,0,49,216660.0,130000.0,-49.0,-35.0,-42.0,-44.0,-44.0,-36.0,-43.0,-47.0,-90.0,-93.0,-90.0,-93.0,41.0,58.0,48.0,49.0,0
1497,92:69:1D:31:68:E9,3821819,485043295,3484,3456169,3818335,481587126,0,3637,932482,3538,910452,99,22030,1796,6,3610,78,0,31,216660.0,130000.0,-51.0,-47.0,-42.0,-48.0,-51.0,-49.0,-43.0,-47.0,-90.0,-93.0,-90.0,-93.0,39.0,46.0,48.0,45.0,0
1498,CC:2F:71:3F:1F:24,4410389,1166997446,592054,685410320,3818335,481587126,37,493155,557608569,492585,557539833,570,68736,475487,10,592291,46536,34,431,130000.0,43333.0,-67.0,-65.0,-70.0,-68.0,-66.0,-65.0,-70.0,-67.0,-90.0,-93.0,-90.0,-93.0,23.0,28.0,20.0,25.0,0
1499,CC:2F:71:3E:C5:1F,3819026,481671612,691,84486,3818335,481587126,0,2950,247064,2443,186794,507,60270,732,8,1022,18,0,32,130000.0,39000.0,-70.0,-71.0,-67.0,-60.0,-70.0,-71.0,-67.0,-60.0,-90.0,-93.0,-90.0,-93.0,20.0,22.0,23.0,33.0,0
1500,BA:8C:B9:54:50:24,3820069,482425340,1734,838214,3818335,481587126,0,5589,823128,5569,820006,20,3122,1004,14,2109,29,0,49,216660.0,130000.0,-49.0,-35.0,-42.0,-44.0,-44.0,-36.0,-43.0,-47.0,-90.0,-93.0,-90.0,-93.0,41.0,58.0,48.0,49.0,0
1501,92:69:1D:31:68:E9,3821821,485043497,3484,3456169,3818337,481587328,0,3637,932482,3538,910452,99,22030,1796,6,3610,78,0,31,216660.0,130000.0,-51.0,-47.0,-42.0,-48.0,-51.0,-49.0,-43.0,-47.0,-90.0,-93.0,-90.0,-93.0,39.0,46.0,48.0,45.0,0
1502,CC:2F:71:3F:1F:24,4410435,1167012324,592098,685424996,3818337,481587328,37,493184,557613933,492614,557545197,570,68736,475516,10,592335,46553,34,431,117000.0,39000.0,-67.0,-65.0,-70.0,-68.0,-67.0,-65.0,-70.0,-67.0,-90.0,-93.0,-90.0,-93.0,23.0,28.0,20.0,25.0,0
1503,CC:2F:71:3E:C5:1F,3819028,481671814,691,84486,3818337,481587328,0,2950,247064,2443,186794,507,60270,732,8,1022,18,0,32,130000.0,39000.0,-70.0,-71.0,-67.0,-60.0,-70.0,-71.0,-67.0,-60.0,-90.0,-93.0,-90.0,-93.0,20.0,22.0,23.0,33.0,0
1504,BA:8C:B9:54:50:24,3820071,482425542,1734,838214,3818337,481587328,0,5589,823128,5569,820006,20,3122,1004,14,2109,29,0,49,216660.0,130000.0,-49.0,-35.0,-42.0,-44.0,-44.0,-36.0,-43.0,-47.0,-90.0,-93.0,-90.0,-93.0,41.0,58.0,48.0,49.0,0
1505,92:69:1D:31:68:E9,3821828,485044163,3484,3456169,3818344,481587994,0,3637,932482,3538,910452,99,22030,1796,6,3610,78,0,31,216660.0,130000.0,-51.0,-47.0,-42.0,-48.0,-51.0,-49.0,-43.0,-47.0,-90.0,-93.0,-90.0,-93.0,39.0,46.0,48.0,45.0,0
1506,CC:2F:71:3F:1F:24,4410485,1167027486,592141,685439492,3818344,481587994,37,493213,557619297,492643,557550561,570,68736,475545,10,592378,46563,34,431,130000.0,39000.0,-67.0,-65.0,-71.0,-68.0,-67.0,-65.0,-70.0,-67.0,-90.0,-93.0,-90.0,-93.0,23.0,28.0,19.0,25.0,0
1507,CC:2F:71:3E:C5:1F,3819035,481672480,691,84486,3818344,481587994,0,2950,247064,2443,186794,507,60270,732,8,1022,18,0,32,130000.0,39000.0,-70.0,-71.0,-67.0,-60.0,-70.0,-71.0,-67.0,-60.0,-90.0,-93.0,-90.0,-93.0,20.0,22.0,23.0,33.0,0
1508,BA:8C:B9:54:50:24,3820078,482426208,1734,838214,3818344,481587994,0,5589,823128,5569,820006,20,3122,1004,14,2109,29,0,49,216660.0,130000.0,-49.0,-35.0,-42.0,-44.0,-44.0,-36.0,-43.0,-47.0,-90.0,-93.0,-90.0,-93.0,41.0,58.0,48.0,49.0,0
1509,92:69:1D:31:68:E9,3821830,485044365,3484,3456169,3818346,481588196,0,3637,932482,3538,910452,99,22030,1796,6,3610,78,0,31,216660.0,130000.0,-51.0,-47.0,-42.0,-48.0,-51.0,-49.0,-43.0,-47.0,-90.0,-93.0,-90.0,-93.0,39.0,46.0,48.0,45.0,0
1510,CC:2F:71:3F:1F:24,4410530,1167042240,592184,685454044,3818346,481588196,37,493242,557624661,492672,557555925,570,68736,475574,10,592421,46573,34,431,130000.0,39000.0,-67.0,-65.0,-70.0,-67.0,-67.0,-65.0,-70.0,-67.0,-90.0,-93.0,-90.0,-93.0,23.0,28.0,20.0,26.0,0
1511,CC:2F:71:3E:C5:1F,3819037,481672682,691,84486,3818346,481588196,0,2950,247064,2443,186794,507,60270,732,8,1022,18,0,32,130000.0,39000.0,-70.0,-71.0,-67.0,-60.0,-70.0,-71.0,-67.0,-60.0,-90.0,-93.0,-90.0,-93.0,20.0,22.0,23.0,33.0,0
1512,BA:8C:B9:54:50:24,3820080,482426410,1734,838214,3818346,481588196,0,5589,823128,5569,820006,20,3122,1004,14,2109,29,0,49,216660.0,130000.0,-49.0,-35.0,-42.0,-44.0,-44.0,-36.0,-43.0,-47.0,-90.0,-93.0,-90.0,-93.0,41.0,58.0,48.0,49.0,0
1513,92:69:1D:31:68:E9,3821839,485045399,3484,3456169,3818355,481589230,0,3637,932482,3538,910452,99,22030,1796,6,3610,78,0,31,216660.0,130000.0,-51.0,-47.0,-42.0,-48.0,-51.0,-49.0,-43.0,-47.0,-90.0,-93.0,-90.0,-93.0,39.0,46.0,48.0,45.0,0
1514,CC:2F:71:3F:1F:24,4410582,1167057882,592227,685468652,3818355,481589230,37,493271,557630025,492701,557561289,570,68736,475603,10,592464,46579,34,431,130000.0,43333.0,-67.0,-65.0,-71.0,-67.0,-67.0,-65.0,-70.0,-67.0,-90.0,-93.0,-90.0,-93.0,23.0,28.0,19.0,26.0,0
1515,CC:2F:71:3E:C5:1F,3819046,481673716,691,84486,3818355,481589230,0,2950,247064,2443,186794,507,60270,732,8,1022,18,0,32,130000.0,39000.0,-70.0,-71.0,-67.0,-60.0,-70.0,-71.0,-67.0,-60.0,-90.0,-93.0,-90.0,-93.0,20.0,22.0,23.0,33.0,0
1516,BA:8C:B9:54:50:24,3820089,482427444,1734,838214,3818355,481589230,0,5589,823128,5569,820006,20,3122,1004,14,2109,29,0,49,216660.0,130000.0,-49.0,-35.0,-42.0,-44.0,-44.0,-36.0,-43.0,-47.0,-90.0,-93.0,-90.0,-93.0,41.0,58.0,48.0,49.0,0
1517,92:69:1D:31:68:E9,3821841,485045601,3484,3456169,3818357,481589432,0,3637,932482,3538,910452,99,22030,1796,6,3610,78,0,31,216660.0,130000.0,-51.0,-47.0,-42.0,-48.0,-51.0,-49.0,-43.0,-47.0,-90.0,-93.0,-90.0,-93.0,39.0,46.0,48.0,45.0,0
1518,CC:2F:71:3F:1F:24,4410628,1167072894,592271,685483462,3818357,481589432,37,493302,557635633,492732,557566897,570,68736,475634,10,592508,46595,34,431,117000.0,39000.0,-67.0,-65.0,-70.0,-67.0,-67.0,-65.0,-70.0,-67.0,-90.0,-93.0,-90.0,-93.0,23.0,28.0,20.0,26.0,0
1519,CC:2F:71:3E:C5:1F,3819048,481673918,691,84486,3818357,481589432,0,2950,247064,2443,186794,507,60270,732,8,1022,18,0,32,130000.0,39000.0,-70.0,-71.0,-67.0,-60.0,-70.0,-71.0,-67.0,-60.0,-90.0,-93.0,-90.0,-93.0,20.0,22.0,23.0,33.0,0
1520,BA:8C:B9:54:50:24,3820091,482427646,1734,838214,3818357,481589432,0,5589,823128,5569,820006,20,3122,1004,14,2109,29,0,49,216660.0,130000.0,-49.0,-35.0,-42.0,-44.0,-44.0,-36.0,-43.0,-47.0,-90.0,-93.0,-90.0,-93.0,41.0,58.0,48.0,49.0,0
1521,92:69:1D:31:68:E9,3821847,485046207,3484,3456169,3818363,481590038,0,3637,932482,3538,910452,99,22030,1796,6,3610,78,0,31,216660.0,130000.0,-51.0,-47.0,-42.0,-48.0,-51.0,-49.0,-43.0,-47.0,-90.0,-93.0,-90.0,-93.0,39.0,46.0,48.0,45.0,0
1522,CC:2F:71:3F:1F:24,4410677,1167088052,592314,685498014,3818363,481590038,37,493331,557640997,492761,557572261,570,68736,475663,10,592551,46599,34,431,130000.0,43333.0,-67.0,-65.0,-70.0,-67.0,-67.0,-65.0,-70.0,-67.0,-90.0,-93.0,-90.0,-93.0,23.0,28.0,20.0,26.0,0
1523,CC:2F:71:3E:C5:1F,3819054,481674524,691,84486,3818363,481590038,0,2950,247064,2443,186794,507,60270,732,8,1022,18,0,32,130000.0,39000.0,-70.0,-71.0,-67.0,-60.0,-70.0,-71.0,-67.0,-60.0,-90.0,-93.0,-90.0,-93.0,20.0,22.0,23.0,33.0,0
1524,BA:8C:B9:54:50:24,3820097,482428252,1734,838214,3818363,481590038,0,5589,823128,5569,820006,20,3122,1004,14,2109,29,0,49,216660.0,130000.0,-49.0,-35.0,-42.0,-44.0,-44.0,-36.0,-43.0,-47.0,-90.0,-93.0,-90.0,-93.0,41.0,58.0,48.0,49.0,0
1525,92:69:1D:31:68:E9,3821850,485046469,3484,3456169,3818366,481590300,0,3637,932482,3538,910452,99,22030,1796,6,3610,78,0,31,216660.0,130000.0,-51.0,-47.0,-42.0,-48.0,-51.0,-49.0,-43.0,-47.0,-90.0,-93.0,-90.0,-93.0,39.0,46.0,48.0,45.0,0
1526,CC:2F:71:3F:1F:24,4410724,1167103180,592358,685512880,3818366,481590300,37,493363,557646745,492793,557578009,570,68736,475695,10,592595,46604,34,431,130000.0,39000.0,-67.0,-65.0,-70.0,-67.0,-67.0,-65.0,-70.0,-67.0,-90.0,-93.0,-90.0,-93.0,23.0,28.0,20.0,26.0,0
1527,CC:2F:71:3E:C5:1F,3819057,481674786,691,84486,3818366,481590300,0,2950,247064,2443,186794,507,60270,732,8,1022,18,0,32,130000.0,39000.0,-70.0,-71.0,-67.0,-60.0,-70.0,-71.0,-67.0,-60.0,-90.0,-93.0,-90.0,-93.0,20.0,22.0,23.0,33.0,0
1528,BA:8C:B9:54:50:24,3820100,482428514,1734,838214,3818366,481590300,0,5589,823128,5569,820006,20,3122,1004,14,2109,29,0,49,216660.0,130000.0,-49.0,-35.0,-42.0,-44.0,-44.0,-36.0,-43.0,-47.0,-90.0,-93.0,-90.0,-93.0,41.0,58.0,48.0,49.0,0
1529,92:69:1D:31:68:E9,3821856,485047075,3484,3456169,3818372,481590906,0,3637,932482,3538,910452,99,22030,1796,6,3610,78,0,31,216660.0,130000.0,-51.0,-47.0,-42.0,-48.0,-51.0,-49.0,-43.0,-47.0,-90.0,-93.0,-90.0,-93.0,39.0,46.0,48.0,45.0,0
1530,CC:2F:71:3F:1F:24,4410774,1167118468,592402,685527562,3818372,481590906,37,493392,557652109,492822,557583373,570,68736,475724,10,592639,46627,34,431,130000.0,39000.0,-67.0,-65.0,-70.0,-68.0,-67.0,-65.0,-70.0,-67.0,-90.0,-93.0,-90.0,-93.0,23.0,28.0,20.0,25.0,0
1531,CC:2F:71:3E:C5:1F,3819071,481678302,691,84486,3818380,481593816,0,2950,247064,2443,186794,507,60270,732,8,1022,18,0,32,130000.0,39000.0,-70.0,-71.0,-67.0,-60.0,-70.0,-71.0,-67.0,-60.0,-90.0,-93.0,-90.0,-93.0,20.0,22.0,23.0,33.0,0
1532,BA:8C:B9:54:50:24,3820114,482432030,1734,838214,3818380,481593816,0,5592,823332,5572,820210,20,3122,1004,14,2109,29,0,49,216660.0,130000.0,-40.0,-37.0,-45.0,-52.0,-44.0,-36.0,-43.0,-47.0,-90.0,-93.0,-89.0,-93.0,50.0,56.0,44.0,41.0,0
1533,92:69:1D:31:68:E9,3821866,485050187,3484,3456169,3818382,481594018,0,3637,932482,3538,910452,99,22030,1796,6,3610,78,0,31,216660.0,130000.0,-51.0,-47.0,-42.0,-48.0,-51.0,-49.0,-43.0,-47.0,-90.0,-93.0,-89.0,-93.0,39.0,46.0,47.0,45.0,0
1534,CC:2F:71:3F:1F:24,4410827,1167136132,592445,685542114,3818382,481594018,37,493422,557657589,492852,557588853,570,68736,475754,10,592682,46647,34,431,130000.0,39000.0,-67.0,-65.0,-70.0,-67.0,-67.0,-65.0,-71.0,-68.0,-90.0,-93.0,-89.0,-93.0,23.0,28.0,19.0,26.0,0
1535,CC:2F:71:3E:C5:1F,3819074,481678564,691,84486,3818383,481594078,0,2950,247064,2443,186794,507,60270,732,8,1022,18,0,32,130000.0,39000.0,-70.0,-71.0,-67.0,-60.0,-70.0,-71.0,-67.0,-60.0,-90.0,-93.0,-89.0,-93.0,20.0,22.0,22.0,33.0,0
1536,BA:8C:B9:54:50:24,3820119,482432494,1734,838214,3818385,481594280,0,5593,823400,5573,820278,20,3122,1004,14,2109,29,0,49,216660.0,130000.0,-40.0,-37.0,-45.0,-51.0,-43.0,-36.0,-43.0,-48.0,-90.0,-93.0,-89.0,-93.0,50.0,56.0,44.0,42.0,0
1537,92:69:1D:31:68:E9,3821873,485050853,3484,3456169,3818389,481594684,0,3637,932482,3538,910452,99,22030,1796,6,3610,78,0,31,216660.0,130000.0,-51.0,-47.0,-42.0,-48.0,-51.0,-49.0,-43.0,-47.0,-90.0,-93.0,-90.0,-93.0,39.0,46.0,48.0,45.0,0
1538,CC:2F:71:3F:1F:24,4410875,1167151046,592486,685556362,3818389,481594684,37,493452,557663069,492882,557594333,570,68736,475784,10,592723,46679,34,431,130000.0,43333.0,-67.0,-65.0,-70.0,-68.0,-67.0,-65.0,-70.0,-67.0,-90.0,-93.0,-90.0,-93.0,23.0,28.0,20.0,25.0,0
1539,CC:2F:71:3E:C5:1F,3819080,481679170,691,84486,3818389,481594684,0,2950,247064,2443,186794,507,60270,732,8,1022,18,0,32,130000.0,39000.0,-70.0,-71.0,-67.0,-60.0,-70.0,-71.0,-67.0,-60.0,-90.0,-93.0,-90.0,-93.0,20.0,22.0,23.0,33.0,0
1540,BA:8C:B9:54:50:24,3820123,482432898,1734,838214,3818389,481594684,0,5597,823672,5577,820550,20,3122,1004,14,2109,29,0,49,216660.0,130000.0,-40.0,-37.0,-45.0,-52.0,-42.0,-36.0,-44.0,-49.0,-90.0,-93.0,-90.0,-93.0,50.0,56.0,45.0,41.0,0
1541,92:69:1D:31:68:E9,3821875,485051055,3484,3456169,3818391,481594886,0,3637,932482,3538,910452,99,22030,1796,6,3610,78,0,31,216660.0,130000.0,-51.0,-47.0,-42.0,-48.0,-51.0,-49.0,-43.0,-47.0,-90.0,-93.0,-89.0,-93.0,39.0,46.0,47.0,45.0,0
1542,CC:2F:71:3F:1F:24,4410919,1167165794,592528,685570908,3818391,481594886,37,493481,557668473,492911,557599737,570,68736,475813,10,592765,46684,34,431,130000.0,43333.0,-67.0,-65.0,-71.0,-68.0,-67.0,-65.0,-71.0,-68.0,-90.0,-93.0,-89.0,-93.0,23.0,28.0,18.0,25.0,0
1543,CC:2F:71:3E:C5:1F,3819082,481679372,691,84486,3818391,481594886,0,2950,247064,2443,186794,507,60270,732,8,1022,18,0,32,130000.0,39000.0,-70.0,-71.0,-67.0,-60.0,-70.0,-71.0,-67.0,-60.0,-90.0,-93.0,-89.0,-93.0,20.0,22.0,22.0,33.0,0
1544,BA:8C:B9:54:50:24,3820127,482433302,1734,838214,3818393,481595088,0,5597,823672,5577,820550,20,3122,1004,14,2109,29,0,49,216660.0,130000.0,-40.0,-37.0,-45.0,-52.0,-42.0,-36.0,-44.0,-49.0,-90.0,-93.0,-89.0,-93.0,50.0,56.0,44.0,41.0,0
1545,92:69:1D:31:68:E9,3821882,485051721,3484,3456169,3818398,481595552,0,3637,932482,3538,910452,99,22030,1796,6,3610,78,0,31,216660.0,130000.0,-51.0,-47.0,-42.0,-48.0,-51.0,-49.0,-43.0,-47.0,-90.0,-93.0,-89.0,-93.0,39.0,46.0,47.0,45.0,0
1546,CC:2F:71:3F:1F:24,4410967,1167180870,592569,685585318,3818398,481595552,37,493506,557673277,492936,557604541,570,68736,475838,10,592806,46690,34,431,130000.0,43333.0,-67.0,-65.0,-71.0,-68.0,-67.0,-65.0,-70.0,-68.0,-90.0,-93.0,-89.0,-93.0,23.0,28.0,18.0,25.0,0
1547,CC:2F:71:3E:C5:1F,3819089,481680038,691,84486,3818398,481595552,0,2950,247064,2443,186794,507,60270,732,8,1022,18,0,32,130000.0,39000.0,-70.0,-71.0,-67.0,-60.0,-70.0,-71.0,-67.0,-60.0,-90.0,-93.0,-89.0,-93.0,20.0,22.0,22.0,33.0,0
1548,BA:8C:B9:54:50:24,3820132,482433766,1734,838214,3818398,481595552,0,5597,823672,5577,820550,20,3122,1004,14,2109,29,0,49,216660.0,130000.0,-40.0,-37.0,-45.0,-52.0,-42.0,-36.0,-44.0,-49.0,-90.0,-93.0,-89.0,-93.0,50.0,56.0,44.0,41.0,0
1549,92:69:1D:31:68:E9,3821886,485052312,3485,3456285,3818401,481596027,0,3639,932618,3540,910588,99,22030,1796,6,3611,78,0,31,216660.0,130000.0,-52.0,-50.0,-44.0,-46.0,-51.0,-49.0,-43.0,-47.0,-90.0,-93.0,-89.0,-93.0,38.0,43.0,45.0,47.0,0
1550,CC:2F:71:3F:1F:24,4411014,1167196013,592613,685599986,3818401,481596027,37,493536,557678793,492966,557610057,570,68736,475868,10,592850,46709,34,431,117000.0,39000.0,-67.0,-65.0,-71.0,-68.0,-67.0,-65.0,-71.0,-68.0,-90.0,-93.0,-89.0,-93.0,23.0,28.0,18.0,25.0,0
1551,CC:2F:71:3E:C5:1F,3819093,481680629,692,84602,3818401,481596027,0,2952,247204,2445,186934,507,60270,732,8,1023,18,0,32,130000.0,39000.0,-71.0,-71.0,-67.0,-60.0,-70.0,-71.0,-67.0,-60.0,-90.0,-93.0,-89.0,-93.0,19.0,22.0,22.0,33.0,0
1552,BA:8C:B9:54:50:24,3820138,482434559,1735,838330,3818403,481596229,0,5599,823808,5579,820686,20,3122,1004,14,2110,29,0,49,216660.0,130000.0,-51.0,-34.0,-43.0,-43.0,-43.0,-36.0,-44.0,-48.0,-90.0,-93.0,-89.0,-93.0,39.0,59.0,46.0,50.0,0
1553,92:69:1D:31:68:E9,3821892,485052918,3485,3456285,3818407,481596633,0,3639,932618,3540,910588,99,22030,1796,6,3611,78,0,31,216660.0,130000.0,-52.0,-50.0,-44.0,-46.0,-51.0,-49.0,-43.0,-47.0,-90.0,-93.0,-89.0,-93.0,38.0,43.0,45.0,47.0,0
1554,CC:2F:71:3F:1F:24,4411062,1167211047,592655,685614414,3818407,481596633,37,493566,557684297,492996,557615561,570,68736,475898,10,592892,46718,34,431,130000.0,43333.0,-67.0,-65.0,-70.0,-68.0,-67.0,-65.0,-70.0,-68.0,-90.0,-93.0,-89.0,-93.0,23.0,28.0,19.0,25.0,0
1555,CC:2F:71:3E:C5:1F,3819099,481681235,692,84602,3818407,481596633,0,2952,247204,2445,186934,507,60270,732,8,1023,18,0,32,130000.0,39000.0,-71.0,-71.0,-67.0,-60.0,-70.0,-71.0,-67.0,-60.0,-90.0,-93.0,-89.0,-93.0,19.0,22.0,22.0,33.0,0
1556,BA:8C:B9:54:50:24,3820142,482434963,1735,838330,3818407,481596633,0,5599,823808,5579,820686,20,3122,1004,14,2110,29,0,49,216660.0,130000.0,-51.0,-34.0,-43.0,-43.0,-43.0,-36.0,-44.0,-48.0,-90.0,-93.0,-89.0,-93.0,39.0,59.0,46.0,50.0,0
1557,92:69:1D:31:68:E9,3821895,485053180,3485,3456285,3818410,481596895,0,3639,932618,3540,910588,99,22030,1796,6,3611,78,0,31,216660.0,130000.0,-52.0,-50.0,-44.0,-46.0,-51.0,-49.0,-43.0,-47.0,-90.0,-93.0,-89.0,-93.0,38.0,43.0,45.0,47.0,0
1558,CC:2F:71:3F:1F:24,4411108,1167225917,592698,685629022,3818410,481596895,37,493596,557689801,493026,557621065,570,68736,475928,10,592935,46734,34,431,130000.0,39000.0,-68.0,-66.0,-71.0,-68.0,-67.0,-65.0,-71.0,-68.0,-90.0,-93.0,-89.0,-93.0,22.0,27.0,18.0,25.0,0
1559,CC:2F:71:3E:C5:1F,3819102,481681497,692,84602,3818410,481596895,0,2952,247204,2445,186934,507,60270,732,8,1023,18,0,32,130000.0,39000.0,-71.0,-71.0,-67.0,-60.0,-70.0,-71.0,-67.0,-60.0,-90.0,-93.0,-89.0,-93.0,19.0,22.0,22.0,33.0,0
1560,BA:8C:B9:54:50:24,3820147,482435427,1735,838330,3818412,481597097,0,5600,823876,5580,820754,20,3122,1004,14,2110,29,0,49,216660.0,130000.0,-40.0,-37.0,-45.0,-52.0,-43.0,-36.0,-44.0,-48.0,-90.0,-93.0,-89.0,-93.0,50.0,56.0,44.0,41.0,0
1561,92:69:1D:31:68:E9,3821901,485053786,3485,3456285,3818416,481597501,0,3639,932618,3540,910588,99,22030,1796,6,3611,78,0,31,216660.0,130000.0,-52.0,-50.0,-44.0,-46.0,-51.0,-49.0,-43.0,-47.0,-90.0,-93.0,-89.0,-93.0,38.0,43.0,45.0,47.0,0
1562,CC:2F:71:3F:1F:24,4411156,1167240895,592740,685643394,3818416,481597501,37,493625,557695141,493055,557626405,570,68736,475957,10,592977,46748,34,431,130000.0,43333.0,-67.0,-65.0,-70.0,-67.0,-67.0,-65.0,-70.0,-67.0,-90.0,-93.0,-89.0,-93.0,23.0,28.0,19.0,26.0,0
1563,CC:2F:71:3E:C5:1F,3819108,481682103,692,84602,3818416,481597501,0,2952,247204,2445,186934,507,60270,732,8,1023,18,0,32,130000.0,39000.0,-71.0,-71.0,-67.0,-60.0,-70.0,-71.0,-67.0,-60.0,-90.0,-93.0,-89.0,-93.0,19.0,22.0,22.0,33.0,0
1564,BA:8C:B9:54:50:24,3820151,482435831,1735,838330,3818416,481597501,0,5600,823876,5580,820754,20,3122,1004,14,2110,29,0,49,216660.0,130000.0,-40.0,-37.0,-45.0,-52.0,-43.0,-36.0,-44.0,-48.0,-90.0,-93.0,-89.0,-93.0,50.0,56.0,44.0,41.0,0
1565,92:69:1D:31:68:E9,3821904,485054048,3485,3456285,3818419,481597763,0,3639,932618,3540,910588,99,22030,1796,6,3611,78,0,31,216660.0,130000.0,-52.0,-50.0,-44.0,-46.0,-51.0,-49.0,-43.0,-47.0,-90.0,-93.0,-89.0,-93.0,38.0,43.0,45.0,47.0,0
1566,CC:2F:71:3F:1F:24,4411201,1167255697,592782,685657934,3818419,481597763,37,493656,557700839,493086,557632103,570,68736,475987,10,593019,46752,34,431,130000.0,43333.0,-67.0,-65.0,-71.0,-67.0,-67.0,-65.0,-70.0,-67.0,-90.0,-93.0,-89.0,-93.0,23.0,28.0,18.0,26.0,0
1567,CC:2F:71:3E:C5:1F,3819111,481682365,692,84602,3818419,481597763,0,2952,247204,2445,186934,507,60270,732,8,1023,18,0,32,130000.0,39000.0,-71.0,-71.0,-67.0,-60.0,-70.0,-71.0,-67.0,-60.0,-90.0,-93.0,-89.0,-93.0,19.0,22.0,22.0,33.0,0
1568,BA:8C:B9:54:50:24,3820156,482436295,1735,838330,3818421,481597965,0,5600,823876,5580,820754,20,3122,1004,14,2110,29,0,49,216660.0,130000.0,-40.0,-37.0,-45.0,-52.0,-43.0,-36.0,-44.0,-48.0,-90.0,-93.0,-89.0,-93.0,50.0,56.0,44.0,41.0,0
1569,92:69:1D:31:68:E9,3821911,485054716,3485,3456285,3818426,481598431,0,3639,932618,3540,910588,99,22030,1796,6,3611,78,0,31,216660.0,130000.0,-52.0,-50.0,-44.0,-46.0,-51.0,-49.0,-43.0,-47.0,-90.0,-93.0,-90.0,-93.0,38.0,43.0,46.0,47.0,0
1570,CC:2F:71:3F:1F:24,4411250,1167270849,592824,685672418,3818426,481598431,37,493683,557705923,493113,557637187,570,68736,476014,10,593061,46766,34,431,130000.0,39000.0,-67.0,-65.0,-70.0,-67.0,-67.0,-65.0,-70.0,-67.0,-90.0,-93.0,-90.0,-93.0,23.0,28.0,20.0,26.0,0
1571,CC:2F:71:3E:C5:1F,3819118,481683033,692,84602,3818426,481598431,0,2954,247392,2446,187004,508,60388,733,8,1023,18,0,32,130000.0,39000.0,-70.0,-71.0,-68.0,-60.0,-70.0,-71.0,-67.0,-60.0,-90.0,-93.0,-90.0,-93.0,20.0,22.0,22.0,33.0,0
1572,BA:8C:B9:54:50:24,3820161,482436761,1735,838330,3818426,481598431,0,5600,823876,5580,820754,20,3122,1004,14,2110,29,0,49,216660.0,130000.0,-40.0,-37.0,-45.0,-52.0,-43.0,-36.0,-44.0,-48.0,-90.0,-93.0,-90.0,-93.0,50.0,56.0,45.0,41.0,0
1573,92:69:1D:31:68:E9,3821913,485054918,3485,3456285,3818428,481598633,0,3639,932618,3540,910588,99,22030,1796,6,3611,78,0,31,216660.0,130000.0,-52.0,-50.0,-44.0,-46.0,-51.0,-49.0,-43.0,-47.0,-91.0,-93.0,-90.0,-94.0,39.0,43.0,46.0,48.0,0
1574,CC:2F:71:3F:1F:24,4411296,1167285671,592868,685687038,3818428,481598633,37,493709,557710867,493139,557642131,570,68736,476040,10,593105,46774,34,431,130000.0,43333.0,-67.0,-65.0,-70.0,-68.0,-67.0,-65.0,-70.0,-67.0,-91.0,-93.0,-90.0,-94.0,24.0,28.0,20.0,26.0,0
1575,CC:2F:71:3E:C5:1F,3819121,481683369,692,84602,3818429,481598767,0,2954,247392,2446,187004,508,60388,733,8,1023,18,0,32,130000.0,39000.0,-70.0,-71.0,-68.0,-60.0,-70.0,-71.0,-67.0,-60.0,-91.0,-93.0,-90.0,-94.0,21.0,22.0,22.0,34.0,0
1576,BA:8C:B9:54:50:24,3820164,482437097,1735,838330,3818429,481598767,0,5600,823876,5580,820754,20,3122,1004,14,2110,29,0,49,216660.0,130000.0,-40.0,-37.0,-45.0,-52.0,-43.0,-36.0,-44.0,-48.0,-91.0,-93.0,-90.0,-94.0,51.0,56.0,45.0,42.0,0
1577,92:69:1D:31:68:E9,3821920,485055584,3485,3456285,3818435,481599299,0,3639,932618,3540,910588,99,22030,1796,6,3611,78,0,31,216660.0,130000.0,-52.0,-50.0,-44.0,-46.0,-51.0,-49.0,-43.0,-47.0,-91.0,-93.0,-90.0,-94.0,39.0,43.0,46.0,48.0,0
1578,CC:2F:71:3F:1F:24,4411345,1167300821,592910,685701522,3818435,481599299,37,493735,557715811,493165,557647075,570,68736,476066,10,593147,46787,34,431,130000.0,39000.0,-67.0,-65.0,-70.0,-68.0,-67.0,-65.0,-70.0,-67.0,-91.0,-93.0,-90.0,-94.0,24.0,28.0,20.0,26.0,0
1579,CC:2F:71:3E:C5:1F,3819127,481683901,692,84602,3818435,481599299,0,2954,247392,2446,187004,508,60388,733,8,1023,18,0,32,130000.0,39000.0,-70.0,-71.0,-68.0,-60.0,-70.0,-71.0,-67.0,-60.0,-91.0,-93.0,-90.0,-94.0,21.0,22.0,22.0,34.0,0
1580,BA:8C:B9:54:50:24,3820170,482437629,1735,838330,3818435,481599299,0,5600,823876,5580,820754,20,3122,1004,14,2110,29,0,49,216660.0,130000.0,-40.0,-37.0,-45.0,-52.0,-43.0,-36.0,-44.0,-48.0,-91.0,-93.0,-90.0,-94.0,51.0,56.0,45.0,42.0,0
1581,92:69:1D:31:68:E9,3821922,485055786,3485,3456285,3818437,481599501,0,3639,932618,3540,910588,99,22030,1796,6,3611,78,0,31,216660.0,130000.0,-52.0,-50.0,-44.0,-46.0,-51.0,-49.0,-43.0,-47.0,-91.0,-93.0,-90.0,-94.0,39.0,43.0,46.0,48.0,0
1582,CC:2F:71:3F:1F:24,4411390,1167315575,592953,685716074,3818437,481599501,37,493760,557720615,493190,557651879,570,68736,476091,10,593190,46808,34,431,130000.0,39000.0,-67.0,-65.0,-70.0,-68.0,-67.0,-65.0,-70.0,-67.0,-91.0,-93.0,-90.0,-94.0,24.0,28.0,20.0,26.0,0
1583,CC:2F:71:3E:C5:1F,3819129,481684103,692,84602,3818437,481599501,0,2954,247392,2446,187004,508,60388,733,8,1023,18,0,32,130000.0,39000.0,-70.0,-71.0,-68.0,-60.0,-70.0,-71.0,-67.0,-60.0,-91.0,-93.0,-90.0,-94.0,21.0,22.0,22.0,34.0,0
1584,BA:8C:B9:54:50:24,3820174,482438033,1735,838330,3818439,481599703,0,5600,823876,5580,820754,20,3122,1004,14,2110,29,0,49,216660.0,130000.0,-40.0,-37.0,-45.0,-52.0,-43.0,-36.0,-44.0,-48.0,-91.0,-93.0,-90.0,-94.0,51.0,56.0,45.0,42.0,0
1585,92:69:1D:31:68:E9,3821930,485056580,3485,3456285,3818445,481600295,0,3639,932618,3540,910588,99,22030,1796,6,3611,78,0,31,216660.0,130000.0,-52.0,-50.0,-44.0,-46.0,-51.0,-49.0,-43.0,-47.0,-91.0,-93.0,-90.0,-94.0,39.0,43.0,46.0,48.0,0
1586,CC:2F:71:3F:1F:24,4411440,1167330853,592995,685730558,3818445,481600295,37,493787,557725677,493216,557656823,571,68854,476118,10,593232,46819,34,431,130000.0,43333.0,-67.0,-65.0,-70.0,-68.0,-67.0,-65.0,-70.0,-67.0,-91.0,-93.0,-90.0,-94.0,24.0,28.0,20.0,26.0,0
1587,CC:2F:71:3E:C5:1F,3819138,481684957,692,84602,3818446,481600355,0,2954,247392,2446,187004,508,60388,733,8,1023,18,0,32,130000.0,39000.0,-70.0,-71.0,-68.0,-60.0,-70.0,-71.0,-67.0,-60.0,-91.0,-93.0,-90.0,-94.0,21.0,22.0,22.0,34.0,0
1588,BA:8C:B9:54:50:24,3820183,482438887,1735,838330,3818448,481600557,0,5600,823876,5580,820754,20,3122,1004,14,2110,29,0,49,216660.0,130000.0,-40.0,-37.0,-45.0,-52.0,-43.0,-36.0,-44.0,-48.0,-91.0,-93.0,-90.0,-94.0,51.0,56.0,45.0,42.0,0
1589,92:69:1D:31:68:E9,3821933,485056842,3485,3456285,3818448,481600557,0,3639,932618,3540,910588,99,22030,1796,6,3611,78,0,31,216660.0,130000.0,-52.0,-50.0,-44.0,-46.0,-51.0,-49.0,-43.0,-47.0,-91.0,-93.0,-90.0,-93.0,39.0,43.0,46.0,47.0,0
1590,CC:2F:71:3F:1F:24,4411486,1167345667,593038,685745110,3818448,481600557,37,493814,557730761,493243,557661907,571,68854,476145,10,593275,46841,34,431,117000.0,39000.0,-67.0,-65.0,-70.0,-68.0,-67.0,-65.0,-70.0,-67.0,-91.0,-93.0,-90.0,-93.0,24.0,28.0,20.0,25.0,0
1591,CC:2F:71:3E:C5:1F,3819140,481685159,692,84602,3818448,481600557,0,2954,247392,2446,187004,508,60388,733,8,1023,18,0,32,130000.0,39000.0,-70.0,-71.0,-68.0,-60.0,-70.0,-71.0,-67.0,-60.0,-91.0,-93.0,-90.0,-93.0,21.0,22.0,22.0,33.0,0
1592,BA:8C:B9:54:50:24,3820185,482439089,1735,838330,3818450,481600759,0,5600,823876,5580,820754,20,3122,1004,14,2110,29,0,49,216660.0,130000.0,-40.0,-37.0,-45.0,-52.0,-43.0,-36.0,-44.0,-48.0,-91.0,-93.0,-90.0,-93.0,51.0,56.0,45.0,41.0,0
1593,92:69:1D:31:68:E9,3821939,485057448,3485,3456285,3818454,481601163,0,3639,932618,3540,910588,99,22030,1796,6,3611,78,0,31,216660.0,130000.0,-52.0,-50.0,-44.0,-46.0,-51.0,-49.0,-43.0,-47.0,-91.0,-93.0,-90.0,-93.0,39.0,43.0,46.0,47.0,0
1594,CC:2F:71:3F:1F:24,4411534,1167360701,593080,685759538,3818454,481601163,37,493841,557735821,493270,557666967,571,68854,476172,10,593317,46847,34,431,130000.0,43333.0,-67.0,-65.0,-70.0,-67.0,-67.0,-65.0,-70.0,-67.0,-91.0,-93.0,-90.0,-93.0,24.0,28.0,20.0,26.0,0
1595,CC:2F:71:3E:C5:1F,3819146,481685765,692,84602,3818454,481601163,0,2954,247392,2446,187004,508,60388,733,8,1023,18,0,32,130000.0,39000.0,-70.0,-71.0,-68.0,-60.0,-70.0,-71.0,-67.0,-60.0,-91.0,-93.0,-90.0,-93.0,21.0,22.0,22.0,33.0,0
1596,BA:8C:B9:54:50:24,3820191,482439695,1735,838330,3818456,481601365,0,5600,823876,5580,820754,20,3122,1004,14,2110,29,0,49,216660.0,130000.0,-40.0,-37.0,-45.0,-52.0,-43.0,-36.0,-44.0,-48.0,-91.0,-93.0,-90.0,-93.0,51.0,56.0,45.0,41.0,0
1597,92:69:1D:31:68:E9,3821942,485057710,3485,3456285,3818457,481601425,0,3639,932618,3540,910588,99,22030,1796,6,3611,78,0,31,216660.0,130000.0,-52.0,-50.0,-44.0,-46.0,-51.0,-49.0,-43.0,-47.0,-91.0,-93.0,-90.0,-93.0,39.0,43.0,46.0,47.0,0
1598,CC:2F:71:3F:1F:24,4411580,1167375627,593123,685774202,3818457,481601425,37,493868,557740881,493297,557672027,571,68854,476199,10,593360,46848,34,431,130000.0,43333.0,-67.0,-65.0,-70.0,-68.0,-67.0,-65.0,-70.0,-67.0,-91.0,-93.0,-90.0,-93.0,24.0,28.0,20.0,25.0,0
1599,CC:2F:71:3E:C5:1F,3819149,481686027,692,84602,3818457,481601425,0,2954,247392,2446,187004,508,60388,733,8,1023,18,0,32,130000.0,39000.0,-70.0,-71.0,-68.0,-60.0,-70.0,-71.0,-67.0,-60.0,-91.0,-93.0,-90.0,-93.0,21.0,22.0,22.0,33.0,0
1600,BA:8C:B9:54:50:24,3820192,482439755,1735,838330,3818457,481601425,0,5600,823876,5580,820754,20,3122,1004,14,2110,29,0,49,216660.0,130000.0,-40.0,-37.0,-45.0,-52.0,-43.0,-36.0,-44.0,-48.0,-91.0,-93.0,-90.0,-93.0,51.0,56.0,45.0,41.0,0
1601,92:69:1D:31:68:E9,3821949,485058589,3485,3456285,3818464,481602304,0,3639,932618,3540,910588,99,22030,1796,6,3611,78,0,31,216660.0,130000.0,-52.0,-50.0,-44.0,-46.0,-51.0,-49.0,-43.0,-47.0,-91.0,-93.0,-90.0,-93.0,39.0,43.0,46.0,47.0,0
1602,CC:2F:71:3F:1F:24,4411631,1167391188,593167,685788884,3818464,481602304,37,493895,557745965,493324,557677111,571,68854,476226,10,593404,46865,34,431,117000.0,39000.0,-67.0,-65.0,-71.0,-68.0,-67.0,-65.0,-70.0,-67.0,-91.0,-93.0,-90.0,-93.0,24.0,28.0,19.0,25.0,0
1603,CC:2F:71:3E:C5:1F,3819156,481686906,692,84602,3818464,481602304,0,2954,247392,2446,187004,508,60388,733,8,1023,18,0,32,130000.0,39000.0,-70.0,-71.0,-68.0,-60.0,-70.0,-71.0,-67.0,-60.0,-91.0,-93.0,-90.0,-93.0,21.0,22.0,22.0,33.0,0
1604,BA:8C:B9:54:50:24,3820201,482440836,1735,838330,3818466,481602506,0,5600,823876,5580,820754,20,3122,1004,14,2110,29,0,49,216660.0,130000.0,-40.0,-37.0,-45.0,-52.0,-43.0,-36.0,-44.0,-48.0,-91.0,-93.0,-90.0,-93.0,51.0,56.0,45.0,41.0,0
1605,92:69:1D:31:68:E9,3821951,485058791,3485,3456285,3818466,481602506,0,3639,932618,3540,910588,99,22030,1796,6,3611,78,0,31,216660.0,130000.0,-52.0,-50.0,-44.0,-46.0,-51.0,-49.0,-43.0,-47.0,-91.0,-93.0,-90.0,-93.0,39.0,43.0,46.0,47.0,0
1606,CC:2F:71:3F:1F:24,4411676,1167406318,593210,685803812,3818466,481602506,37,493921,557750919,493350,557682065,571,68854,476252,10,593447,46867,34,431,130000.0,43333.0,-67.0,-65.0,-70.0,-67.0,-67.0,-65.0,-70.0,-67.0,-91.0,-93.0,-90.0,-93.0,24.0,28.0,20.0,26.0,0
1607,CC:2F:71:3E:C5:1F,3819158,481687108,692,84602,3818466,481602506,0,2954,247392,2446,187004,508,60388,733,8,1023,18,0,32,130000.0,39000.0,-70.0,-71.0,-68.0,-60.0,-70.0,-71.0,-67.0,-60.0,-91.0,-93.0,-90.0,-93.0,21.0,22.0,22.0,33.0,0
1608,BA:8C:B9:54:50:24,3820201,482440836,1735,838330,3818466,481602506,0,5600,823876,5580,820754,20,3122,1004,14,2110,29,0,49,216660.0,130000.0,-40.0,-37.0,-45.0,-52.0,-43.0,-36.0,-44.0,-48.0,-91.0,-93.0,-90.0,-93.0,51.0,56.0,45.0,41.0,0
1609,92:69:1D:31:68:E9,3821958,485059457,3485,3456285,3818473,481603172,0,3639,932618,3540,910588,99,22030,1796,6,3611,78,0,31,216660.0,130000.0,-52.0,-50.0,-44.0,-46.0,-51.0,-49.0,-43.0,-47.0,-91.0,-93.0,-90.0,-93.0,39.0,43.0,46.0,47.0,0
1610,CC:2F:71:3F:1F:24,4411725,1167421412,593252,685818240,3818473,481603172,37,493946,557755723,493375,557686869,571,68854,476277,10,593489,46884,34,431,117000.0,39000.0,-67.0,-65.0,-71.0,-67.0,-67.0,-65.0,-70.0,-67.0,-91.0,-93.0,-90.0,-93.0,24.0,28.0,19.0,26.0,0
1611,CC:2F:71:3E:C5:1F,3819165,481687774,692,84602,3818473,481603172,0,2954,247392,2446,187004,508,60388,733,8,1023,18,0,32,130000.0,39000.0,-70.0,-71.0,-68.0,-60.0,-70.0,-71.0,-67.0,-60.0,-91.0,-93.0,-90.0,-93.0,21.0,22.0,22.0,33.0,0
1612,BA:8C:B9:54:50:24,3820210,482441704,1735,838330,3818475,481603374,0,5600,823876,5580,820754,20,3122,1004,14,2110,29,0,49,216660.0,130000.0,-40.0,-37.0,-45.0,-52.0,-43.0,-36.0,-44.0,-48.0,-91.0,-93.0,-90.0,-93.0,51.0,56.0,45.0,41.0,0
1613,92:69:1D:31:68:E9,3821960,485059659,3485,3456285,3818475,481603374,0,3639,932618,3540,910588,99,22030,1796,6,3611,78,0,31,216660.0,130000.0,-52.0,-50.0,-44.0,-46.0,-51.0,-49.0,-43.0,-47.0,-91.0,-93.0,-90.0,-93.0,39.0,43.0,46.0,47.0,0
1614,CC:2F:71:3F:1F:24,4411768,1167435918,593293,685832544,3818475,481603374,37,493973,557760759,493402,557691905,571,68854,476304,10,593530,46890,34,431,130000.0,43333.0,-67.0,-65.0,-70.0,-68.0,-67.0,-65.0,-70.0,-67.0,-91.0,-93.0,-90.0,-93.0,24.0,28.0,20.0,25.0,0
1615,CC:2F:71:3E:C5:1F,3819167,481687976,692,84602,3818475,481603374,0,2954,247392,2446,187004,508,60388,733,8,1023,18,0,32,130000.0,39000.0,-70.0,-71.0,-68.0,-60.0,-70.0,-71.0,-67.0,-60.0,-91.0,-93.0,-90.0,-93.0,21.0,22.0,22.0,33.0,0
1616,BA:8C:B9:54:50:24,3820210,482441704,1735,838330,3818475,481603374,0,5600,823876,5580,820754,20,3122,1004,14,2110,29,0,49,216660.0,130000.0,-40.0,-37.0,-45.0,-52.0,-43.0,-36.0,-44.0,-48.0,-91.0,-93.0,-90.0,-93.0,51.0,56.0,45.0,41.0,0
1617,92:69:1D:31:68:E9,3821966,485060265,3485,3456285,3818481,481603980,0,3639,932618,3540,910588,99,22030,1796,6,3611,78,0,31,216660.0,130000.0,-52.0,-50.0,-44.0,-46.0,-51.0,-49.0,-43.0,-47.0,-91.0,-93.0,-90.0,-93.0,39.0,43.0,46.0,47.0,0
1618,CC:2F:71:3F:1F:24,4411816,1167450832,593334,685846792,3818482,481604040,37,493999,557765703,493428,557696849,571,68854,476330,10,593571,46901,34,431,130000.0,39000.0,-67.0,-65.0,-70.0,-68.0,-67.0,-65.0,-70.0,-67.0,-91.0,-93.0,-90.0,-93.0,24.0,28.0,20.0,25.0,0
1619,CC:2F:71:3E:C5:1F,3819176,481688844,692,84602,3818484,481604242,0,2954,247392,2446,187004,508,60388,733,8,1023,18,0,32,130000.0,39000.0,-70.0,-71.0,-68.0,-60.0,-70.0,-71.0,-67.0,-60.0,-91.0,-93.0,-90.0,-93.0,21.0,22.0,22.0,33.0,0
1620,BA:8C:B9:54:50:24,3820219,482442572,1735,838330,3818484,481604242,0,5600,823876,5580,820754,20,3122,1004,14,2110,29,0,49,216660.0,130000.0,-40.0,-37.0,-45.0,-52.0,-43.0,-36.0,-44.0,-48.0,-91.0,-93.0,-90.0,-93.0,51.0,56.0,45.0,41.0,0
1621,92:69:1D:31:68:E9,3821969,485060527,3485,3456285,3818484,481604242,0,3639,932618,3540,910588,99,22030,1796,6,3611,78,0,31,216660.0,130000.0,-52.0,-50.0,-44.0,-46.0,-51.0,-49.0,-43.0,-47.0,-91.0,-93.0,-90.0,-93.0,39.0,43.0,46.0,47.0,0
1622,CC:2F:71:3F:1F:24,4411861,1167465530,593377,685861288,3818484,481604242,37,494025,557770647,493454,557701793,571,68854,476356,10,593614,46920,34,431,117000.0,39000.0,-67.0,-65.0,-70.0,-67.0,-67.0,-65.0,-70.0,-67.0,-91.0,-93.0,-90.0,-93.0,24.0,28.0,20.0,26.0,0
1623,CC:2F:71:3E:C5:1F,3819176,481688844,692,84602,3818484,481604242,0,2954,247392,2446,187004,508,60388,733,8,1023,18,0,32,130000.0,39000.0,-70.0,-71.0,-68.0,-60.0,-70.0,-71.0,-67.0,-60.0,-91.0,-93.0,-90.0,-93.0,21.0,22.0,22.0,33.0,0
1624,BA:8C:B9:54:50:24,3820219,482442572,1735,838330,3818484,481604242,0,5600,823876,5580,820754,20,3122,1004,14,2110,29,0,49,216660.0,130000.0,-40.0,-37.0,-45.0,-52.0,-43.0,-36.0,-44.0,-48.0,-91.0,-93.0,-90.0,-93.0,51.0,56.0,45.0,41.0,0
1625,92:69:1D:31:68:E9,3821975,485061133,3485,3456285,3818490,481604848,0,3639,932618,3540,910588,99,22030,1796,6,3611,78,0,31,216660.0,130000.0,-52.0,-50.0,-44.0,-46.0,-51.0,-49.0,-43.0,-47.0,-91.0,-93.0,-90.0,-93.0,39.0,43.0,46.0,47.0,0
1626,CC:2F:71:3F:1F:24,4411908,1167480434,593418,685875586,3818490,481604848,37,494052,557775707,493481,557706853,571,68854,476383,10,593655,46926,34,431,130000.0,43333.0,-67.0,-65.0,-70.0,-67.0,-67.0,-65.0,-70.0,-67.0,-91.0,-93.0,-90.0,-93.0,24.0,28.0,20.0,26.0,0
1627,CC:2F:71:3E:C5:1F,3819184,481689652,692,84602,3818492,481605050,0,2954,247392,2446,187004,508,60388,733,8,1023,18,0,32,130000.0,39000.0,-70.0,-71.0,-68.0,-60.0,-70.0,-71.0,-67.0,-60.0,-91.0,-93.0,-90.0,-93.0,21.0,22.0,22.0,33.0,0
1628,BA:8C:B9:54:50:24,3820227,482443380,1735,838330,3818492,481605050,0,5600,823876,5580,820754,20,3122,1004,14,2110,29,0,49,216660.0,130000.0,-40.0,-37.0,-45.0,-52.0,-43.0,-36.0,-44.0,-48.0,-91.0,-93.0,-90.0,-93.0,51.0,56.0,45.0,41.0,0
1629,92:69:1D:31:68:E9,3821978,485061395,3485,3456285,3818493,481605110,0,3639,932618,3540,910588,99,22030,1796,6,3611,78,0,31,216660.0,130000.0,-52.0,-50.0,-44.0,-46.0,-51.0,-49.0,-43.0,-47.0,-91.0,-93.0,-90.0,-93.0,39.0,43.0,46.0,47.0,0
1630,CC:2F:71:3F:1F:24,4411952,1167495112,593459,685890002,3818493,481605110,37,494079,557780767,493508,557711913,571,68854,476410,10,593696,46934,34,431,130000.0,43333.0,-67.0,-65.0,-70.0,-68.0,-67.0,-65.0,-70.0,-68.0,-91.0,-93.0,-90.0,-93.0,24.0,28.0,20.0,25.0,0
1631,CC:2F:71:3E:C5:1F,3819185,481689712,692,84602,3818493,481605110,0,2954,247392,2446,187004,508,60388,733,8,1023,18,0,32,130000.0,39000.0,-70.0,-71.0,-68.0,-60.0,-70.0,-71.0,-67.0,-60.0,-91.0,-93.0,-90.0,-93.0,21.0,22.0,22.0,33.0,0
1632,BA:8C:B9:54:50:24,3820228,482443440,1735,838330,3818493,481605110,0,5600,823876,5580,820754,20,3122,1004,14,2110,29,0,49,216660.0,130000.0,-40.0,-37.0,-45.0,-52.0,-43.0,-36.0,-44.0,-48.0,-91.0,-93.0,-90.0,-93.0,51.0,56.0,45.0,41.0,0
1633,92:69:1D:31:68:E9,3821984,485062001,3485,3456285,3818499,481605716,0,3639,932618,3540,910588,99,22030,1796,6,3611,78,0,31,216660.0,130000.0,-52.0,-50.0,-44.0,-46.0,-51.0,-49.0,-43.0,-47.0,-91.0,-93.0,-90.0,-93.0,39.0,43.0,46.0,47.0,0
1634,CC:2F:71:3F:1F:24,4412000,1167510090,593501,685904374,3818499,481605716,37,494107,557785919,493536,557717065,571,68854,476438,10,593738,46956,34,431,130000.0,39000.0,-67.0,-65.0,-71.0,-68.0,-67.0,-65.0,-70.0,-68.0,-91.0,-93.0,-90.0,-93.0,24.0,28.0,19.0,25.0,0
1635,CC:2F:71:3E:C5:1F,3819193,481690520,692,84602,3818501,481605918,0,2954,247392,2446,187004,508,60388,733,8,1023,18,0,32,130000.0,39000.0,-70.0,-71.0,-68.0,-60.0,-70.0,-71.0,-67.0,-60.0,-91.0,-93.0,-90.0,-93.0,21.0,22.0,22.0,33.0,0
1636,BA:8C:B9:54:50:24,3820236,482444248,1735,838330,3818501,481605918,0,5600,823876,5580,820754,20,3122,1004,14,2110,29,0,49,216660.0,130000.0,-40.0,-37.0,-45.0,-52.0,-43.0,-36.0,-44.0,-48.0,-91.0,-93.0,-90.0,-93.0,51.0,56.0,45.0,41.0,0
1637,92:69:1D:31:68:E9,3821986,485062203,3485,3456285,3818501,481605918,0,3639,932618,3540,910588,99,22030,1796,6,3611,78,0,31,216660.0,130000.0,-52.0,-50.0,-44.0,-46.0,-51.0,-49.0,-43.0,-47.0,-91.0,-93.0,-90.0,-93.0,39.0,43.0,46.0,47.0,0
1638,CC:2F:71:3F:1F:24,4412045,1167524844,593544,685918926,3818501,481605918,37,494134,557790979,493563,557722125,571,68854,476465,10,593781,46974,34,431,130000.0,39000.0,-67.0,-65.0,-71.0,-68.0,-67.0,-65.0,-71.0,-67.0,-91.0,-93.0,-90.0,-93.0,24.0,28.0,19.0,25.0,0
1639,CC:2F:71:3E:C5:1F,3819193,481690520,692,84602,3818501,481605918,0,2954,247392,2446,187004,508,60388,733,8,1023,18,0,32,130000.0,39000.0,-70.0,-71.0,-68.0,-60.0,-70.0,-71.0,-67.0,-60.0,-91.0,-93.0,-90.0,-93.0,21.0,22.0,22.0,33.0,0
1640,BA:8C:B9:54:50:24,3820236,482444248,1735,838330,3818501,481605918,0,5600,823876,5580,820754,20,3122,1004,14,2110,29,0,49,216660.0,130000.0,-40.0,-37.0,-45.0,-52.0,-43.0,-36.0,-44.0,-48.0,-91.0,-93.0,-90.0,-93.0,51.0,56.0,45.0,41.0,0
1641,92:69:1D:31:68:E9,3821993,485062869,3485,3456285,3818508,481606584,0,3640,932686,3541,910656,99,22030,1796,6,3611,78,0,31,216660.0,130000.0,-52.0,-50.0,-44.0,-46.0,-51.0,-49.0,-43.0,-47.0,-91.0,-93.0,-90.0,-93.0,39.0,43.0,46.0,47.0,0
1642,CC:2F:71:3F:1F:24,4412093,1167539758,593585,685933174,3818508,481606584,37,494161,557796063,493590,557727209,571,68854,476492,10,593822,47005,34,431,130000.0,43333.0,-67.0,-65.0,-70.0,-68.0,-67.0,-65.0,-70.0,-67.0,-91.0,-93.0,-90.0,-93.0,24.0,28.0,20.0,25.0,0
1643,CC:2F:71:3E:C5:1F,3819202,481691388,692,84602,3818510,481606786,0,2954,247392,2446,187004,508,60388,733,8,1023,18,0,32,130000.0,39000.0,-70.0,-71.0,-68.0,-60.0,-70.0,-71.0,-67.0,-60.0,-91.0,-93.0,-90.0,-93.0,21.0,22.0,22.0,33.0,0
1644,BA:8C:B9:54:50:24,3820245,482445116,1735,838330,3818510,481606786,0,5600,823876,5580,820754,20,3122,1004,14,2110,29,0,49,216660.0,130000.0,-40.0,-37.0,-45.0,-52.0,-43.0,-36.0,-44.0,-48.0,-91.0,-93.0,-90.0,-93.0,51.0,56.0,45.0,41.0,0
1645,92:69:1D:31:68:E9,3821995,485063071,3485,3456285,3818510,481606786,0,3640,932686,3541,910656,99,22030,1796,6,3611,78,0,31,216660.0,130000.0,-52.0,-50.0,-44.0,-46.0,-51.0,-49.0,-43.0,-47.0,-91.0,-93.0,-90.0,-93.0,39.0,43.0,46.0,47.0,0
1646,CC:2F:71:3F:1F:24,4412139,1167554754,593629,685947968,3818510,481606786,37,494187,557800983,493616,557732129,571,68854,476518,10,593866,47012,34,431,130000.0,43333.0,-67.0,-65.0,-71.0,-68.0,-67.0,-65.0,-70.0,-68.0,-91.0,-93.0,-90.0,-93.0,24.0,28.0,19.0,25.0,0
1647,CC:2F:71:3E:C5:1F,3819202,481691388,692,84602,3818510,481606786,0,2954,247392,2446,187004,508,60388,733,8,1023,18,0,32,130000.0,39000.0,-70.0,-71.0,-68.0,-60.0,-70.0,-71.0,-67.0,-60.0,-91.0,-93.0,-90.0,-93.0,21.0,22.0,22.0,33.0,0
1648,BA:8C:B9:54:50:24,3820245,482445116,1735,838330,3818510,481606786,0,5600,823876,5580,820754,20,3122,1004,14,2110,29,0,49,216660.0,130000.0,-40.0,-37.0,-45.0,-52.0,-43.0,-36.0,-44.0,-48.0,-91.0,-93.0,-90.0,-93.0,51.0,56.0,45.0,41.0,0
1649,92:69:1D:31:68:E9,3822000,485063535,3485,3456285,3818515,481607250,0,3640,932686,3541,910656,99,22030,1796,6,3611,78,0,31,216660.0,130000.0,-52.0,-50.0,-44.0,-46.0,-51.0,-49.0,-43.0,-47.0,-91.0,-93.0,-90.0,-93.0,39.0,43.0,46.0,47.0,0
1650,CC:2F:71:3F:1F:24,4412189,1167570038,593670,685962384,3818519,481607654,37,494214,557806079,493643,557737225,571,68854,476545,10,593907,47016,34,431,130000.0,43333.0,-67.0,-65.0,-71.0,-68.0,-67.0,-65.0,-70.0,-67.0,-91.0,-93.0,-90.0,-93.0,24.0,28.0,19.0,25.0,0
1651,CC:2F:71:3E:C5:1F,3819211,481692256,692,84602,3818519,481607654,0,2954,247392,2446,187004,508,60388,733,8,1023,18,0,32,130000.0,39000.0,-70.0,-71.0,-68.0,-60.0,-70.0,-71.0,-67.0,-60.0,-91.0,-93.0,-90.0,-93.0,21.0,22.0,22.0,33.0,0
1652,BA:8C:B9:54:50:24,3820254,482445984,1735,838330,3818519,481607654,0,5600,823876,5580,820754,20,3122,1004,14,2110,29,0,49,216660.0,130000.0,-40.0,-37.0,-45.0,-52.0,-43.0,-36.0,-44.0,-48.0,-91.0,-93.0,-90.0,-93.0,51.0,56.0,45.0,41.0,0
1653,92:69:1D:31:68:E9,3822005,485064055,3486,3456401,3818519,481607654,0,3642,932822,3543,910792,99,22030,1796,6,3612,78,0,31,216660.0,130000.0,-52.0,-50.0,-44.0,-46.0,-52.0,-49.0,-43.0,-46.0,-91.0,-93.0,-90.0,-93.0,39.0,43.0,46.0,47.0,0
1654,CC:2F:71:3F:1F:24,4412233,1167584855,593713,685976928,3818520,481607927,37,494240,557811023,493669,557742169,571,68854,476571,10,593950,47037,34,431,117000.0,39000.0,-67.0,-65.0,-71.0,-68.0,-67.0,-65.0,-70.0,-68.0,-91.0,-93.0,-90.0,-93.0,24.0,28.0,19.0,25.0,0
1655,CC:2F:71:3E:C5:1F,3819213,481692645,693,84718,3818520,481607927,0,2956,247532,2448,187144,508,60388,733,8,1024,18,0,32,144444.0,39000.0,-70.0,-71.0,-67.0,-60.0,-70.0,-71.0,-67.0,-60.0,-91.0,-93.0,-90.0,-93.0,21.0,22.0,23.0,33.0,0
1656,BA:8C:B9:54:50:24,3820256,482446373,1736,838446,3818520,481607927,0,5602,824012,5582,820890,20,3122,1004,14,2111,29,0,49,216660.0,130000.0,-49.0,-35.0,-42.0,-44.0,-44.0,-35.0,-43.0,-47.0,-91.0,-93.0,-90.0,-93.0,42.0,58.0,48.0,49.0,0
1657,92:69:1D:31:68:E9,3822010,485064732,3486,3456401,3818524,481608331,0,3642,932822,3543,910792,99,22030,1796,6,3612,78,0,31,216660.0,130000.0,-52.0,-50.0,-44.0,-46.0,-52.0,-49.0,-43.0,-46.0,-91.0,-93.0,-90.0,-93.0,39.0,43.0,46.0,47.0,0
1658,CC:2F:71:3F:1F:24,4412283,1167600091,593755,685991356,3818528,481608735,37,494267,557816059,493696,557747205,571,68854,476598,10,593992,47039,34,431,130000.0,43333.0,-68.0,-66.0,-71.0,-68.0,-67.0,-65.0,-70.0,-68.0,-91.0,-93.0,-90.0,-93.0,23.0,27.0,19.0,25.0,0
1659,CC:2F:71:3E:C5:1F,3819221,481693453,693,84718,3818528,481608735,0,2956,247532,2448,187144,508,60388,733,8,1024,18,0,32,144444.0,39000.0,-70.0,-71.0,-67.0,-60.0,-70.0,-71.0,-67.0,-60.0,-91.0,-93.0,-90.0,-93.0,21.0,22.0,23.0,33.0,0
1660,BA:8C:B9:54:50:24,3820264,482447181,1736,838446,3818528,481608735,0,5602,824012,5582,820890,20,3122,1004,14,2111,29,0,49,216660.0,130000.0,-49.0,-35.0,-42.0,-44.0,-44.0,-35.0,-43.0,-47.0,-91.0,-93.0,-90.0,-93.0,42.0,58.0,48.0,49.0,0
1661,92:69:1D:31:68:E9,3822015,485065196,3486,3456401,3818529,481608795,0,3642,932822,3543,910792,99,22030,1796,6,3612,78,0,31,216660.0,130000.0,-52.0,-50.0,-44.0,-46.0,-52.0,-49.0,-43.0,-46.0,-91.0,-93.0,-90.0,-93.0,39.0,43.0,46.0,47.0,0
1662,CC:2F:71:3F:1F:24,4412324,1167614443,593795,686005648,3818529,481608795,37,494294,557821119,493723,557752265,571,68854,476625,10,594032,47043,34,431,130000.0,43333.0,-67.0,-65.0,-70.0,-67.0,-67.0,-65.0,-70.0,-67.0,-91.0,-93.0,-90.0,-93.0,24.0,28.0,20.0,26.0,0
1663,CC:2F:71:3E:C5:1F,3819222,481693513,693,84718,3818529,481608795,0,2956,247532,2448,187144,508,60388,733,8,1024,18,0,32,144444.0,39000.0,-70.0,-71.0,-67.0,-60.0,-70.0,-71.0,-67.0,-60.0,-91.0,-93.0,-90.0,-93.0,21.0,22.0,23.0,33.0,0
1664,BA:8C:B9:54:50:24,3820265,482447241,1736,838446,3818529,481608795,0,5602,824012,5582,820890,20,3122,1004,14,2111,29,0,49,216660.0,130000.0,-49.0,-35.0,-42.0,-44.0,-44.0,-35.0,-43.0,-47.0,-91.0,-93.0,-90.0,-93.0,42.0,58.0,48.0,49.0,0
1665,92:69:1D:31:68:E9,3822019,485065600,3486,3456401,3818533,481609199,0,3642,932822,3543,910792,99,22030,1796,6,3612,78,0,31,216660.0,130000.0,-52.0,-50.0,-44.0,-46.0,-52.0,-49.0,-43.0,-46.0,-91.0,-93.0,-90.0,-93.0,39.0,43.0,46.0,47.0,0
1666,CC:2F:71:3F:1F:24,4412376,1167629871,593839,686020268,3818537,481609603,37,494320,557826039,493749,557757185,571,68854,476651,10,594076,47069,34,431,144444.0,43333.0,-67.0,-65.0,-71.0,-68.0,-67.0,-65.0,-70.0,-67.0,-91.0,-93.0,-90.0,-93.0,24.0,28.0,19.0,25.0,0
1667,CC:2F:71:3E:C5:1F,3819230,481694321,693,84718,3818537,481609603,0,2956,247532,2448,187144,508,60388,733,8,1024,18,0,32,144444.0,39000.0,-70.0,-71.0,-67.0,-60.0,-70.0,-71.0,-67.0,-60.0,-91.0,-93.0,-90.0,-93.0,21.0,22.0,23.0,33.0,0
1668,BA:8C:B9:54:50:24,3820273,482448049,1736,838446,3818537,481609603,0,5602,824012,5582,820890,20,3122,1004,14,2111,29,0,49,216660.0,130000.0,-49.0,-35.0,-42.0,-44.0,-44.0,-35.0,-43.0,-47.0,-91.0,-93.0,-90.0,-93.0,42.0,58.0,48.0,49.0,0
1669,92:69:1D:31:68:E9,3822025,485066372,3486,3456401,3818539,481609971,0,3642,932822,3543,910792,99,22030,1796,6,3612,78,0,31,216660.0,130000.0,-52.0,-50.0,-44.0,-46.0,-52.0,-49.0,-43.0,-46.0,-91.0,-93.0,-90.0,-93.0,39.0,43.0,46.0,47.0,0
1670,CC:2F:71:3F:1F:24,4412419,1167644599,593880,686034628,3818539,481609971,37,494347,557831099,493776,557762245,571,68854,476678,10,594117,47086,34,431,130000.0,43333.0,-67.0,-65.0,-71.0,-68.0,-67.0,-65.0,-70.0,-67.0,-91.0,-93.0,-90.0,-93.0,24.0,28.0,19.0,25.0,0
1671,CC:2F:71:3E:C5:1F,3819232,481694689,693,84718,3818539,481609971,0,2956,247532,2448,187144,508,60388,733,8,1024,18,0,32,144444.0,39000.0,-70.0,-71.0,-67.0,-60.0,-70.0,-71.0,-67.0,-60.0,-91.0,-93.0,-90.0,-93.0,21.0,22.0,23.0,33.0,0
1672,BA:8C:B9:54:50:24,3820276,482448477,1736,838446,3818540,481610031,0,5602,824012,5582,820890,20,3122,1004,14,2111,29,0,49,216660.0,130000.0,-49.0,-35.0,-42.0,-44.0,-44.0,-35.0,-43.0,-47.0,-91.0,-93.0,-90.0,-93.0,42.0,58.0,48.0,49.0,0
1673,92:69:1D:31:68:E9,3822030,485066836,3486,3456401,3818544,481610435,0,3642,932822,3543,910792,99,22030,1796,6,3612,78,0,31,216660.0,130000.0,-52.0,-50.0,-44.0,-46.0,-52.0,-49.0,-43.0,-46.0,-91.0,-93.0,-90.0,-93.0,39.0,43.0,46.0,47.0,0
1674,CC:2F:71:3F:1F:24,4412471,1167660075,593923,686049236,3818548,481610839,37,494373,557836043,493802,557767189,571,68854,476704,10,594160,47107,34,431,130000.0,39000.0,-67.0,-65.0,-70.0,-67.0,-67.0,-65.0,-70.0,-67.0,-91.0,-93.0,-90.0,-93.0,24.0,28.0,20.0,26.0,0
1675,CC:2F:71:3E:C5:1F,3819241,481695557,693,84718,3818548,481610839,0,2956,247532,2448,187144,508,60388,733,8,1024,18,0,32,144444.0,39000.0,-70.0,-71.0,-67.0,-60.0,-70.0,-71.0,-67.0,-60.0,-91.0,-93.0,-90.0,-93.0,21.0,22.0,23.0,33.0,0
1676,BA:8C:B9:54:50:24,3820284,482449285,1736,838446,3818548,481610839,0,5602,824012,5582,820890,20,3122,1004,14,2111,29,0,49,216660.0,130000.0,-49.0,-35.0,-42.0,-44.0,-44.0,-35.0,-43.0,-47.0,-91.0,-93.0,-90.0,-93.0,42.0,58.0,48.0,49.0,0
1677,92:69:1D:31:68:E9,3822035,485067302,3486,3456401,3818549,481610901,0,3642,932822,3543,910792,99,22030,1796,6,3612,78,0,31,216660.0,130000.0,-52.0,-50.0,-44.0,-46.0,-52.0,-49.0,-43.0,-46.0,-91.0,-93.0,-90.0,-93.0,39.0,43.0,46.0,47.0,0
1678,CC:2F:71:3F:1F:24,4412515,1167674633,593966,686063732,3818549,481610901,37,494400,557841105,493828,557772133,572,68972,476731,10,594203,47117,34,431,130000.0,43333.0,-67.0,-65.0,-70.0,-67.0,-67.0,-65.0,-70.0,-67.0,-91.0,-93.0,-90.0,-93.0,24.0,28.0,20.0,26.0,0
1679,CC:2F:71:3E:C5:1F,3819242,481695619,693,84718,3818549,481610901,0,2956,247532,2448,187144,508,60388,733,8,1024,18,0,32,144444.0,39000.0,-70.0,-71.0,-67.0,-60.0,-70.0,-71.0,-67.0,-60.0,-91.0,-93.0,-90.0,-93.0,21.0,22.0,23.0,33.0,0
1680,BA:8C:B9:54:50:24,3820285,482449347,1736,838446,3818549,481610901,0,5602,824012,5582,820890,20,3122,1004,14,2111,29,0,49,216660.0,130000.0,-49.0,-35.0,-42.0,-44.0,-44.0,-35.0,-43.0,-47.0,-91.0,-93.0,-90.0,-93.0,42.0,58.0,48.0,49.0,0
1681,92:69:1D:31:68:E9,3822043,485068030,3486,3456401,3818557,481611629,0,3642,932822,3543,910792,99,22030,1796,6,3612,78,0,31,216660.0,130000.0,-52.0,-50.0,-44.0,-46.0,-52.0,-49.0,-43.0,-46.0,-91.0,-93.0,-90.0,-93.0,39.0,43.0,46.0,47.0,0
1682,CC:2F:71:3F:1F:24,4412568,1167690227,594009,686078396,3818559,481611831,37,494426,557846049,493854,557777077,572,68972,476757,10,594246,47120,34,431,130000.0,43333.0,-67.0,-65.0,-71.0,-67.0,-67.0,-65.0,-70.0,-67.0,-91.0,-93.0,-90.0,-93.0,24.0,28.0,19.0,26.0,0
1683,CC:2F:71:3E:C5:1F,3819252,481696549,693,84718,3818559,481611831,0,2958,247720,2449,187214,509,60506,734,8,1024,18,0,32,144444.0,39000.0,-70.0,-71.0,-67.0,-60.0,-70.0,-71.0,-67.0,-60.0,-91.0,-93.0,-90.0,-93.0,21.0,22.0,23.0,33.0,0
1684,BA:8C:B9:54:50:24,3820295,482450277,1736,838446,3818559,481611831,0,5602,824012,5582,820890,20,3122,1004,14,2111,29,0,49,216660.0,130000.0,-49.0,-35.0,-42.0,-44.0,-44.0,-35.0,-43.0,-47.0,-91.0,-93.0,-90.0,-93.0,42.0,58.0,48.0,49.0,0
1685,92:69:1D:31:68:E9,3822045,485068232,3486,3456401,3818559,481611831,0,3642,932822,3543,910792,99,22030,1796,6,3612,78,0,31,216660.0,130000.0,-52.0,-50.0,-44.0,-46.0,-52.0,-49.0,-43.0,-46.0,-91.0,-93.0,-90.0,-93.0,39.0,43.0,46.0,47.0,0
1686,CC:2F:71:3F:1F:24,4412611,1167704841,594052,686093010,3818559,481611831,37,494452,557850993,493880,557782021,572,68972,476783,10,594289,47143,34,431,130000.0,39000.0,-67.0,-65.0,-70.0,-67.0,-67.0,-65.0,-70.0,-67.0,-91.0,-93.0,-90.0,-93.0,24.0,28.0,20.0,26.0,0
1687,CC:2F:71:3E:C5:1F,3819252,481696549,693,84718,3818559,481611831,0,2958,247720,2449,187214,509,60506,734,8,1024,18,0,32,144444.0,39000.0,-70.0,-71.0,-67.0,-60.0,-70.0,-71.0,-67.0,-60.0,-91.0,-93.0,-90.0,-93.0,21.0,22.0,23.0,33.0,0
1688,BA:8C:B9:54:50:24,3820295,482450277,1736,838446,3818559,481611831,0,5602,824012,5582,820890,20,3122,1004,14,2111,29,0,49,216660.0,130000.0,-49.0,-35.0,-42.0,-44.0,-44.0,-35.0,-43.0,-47.0,-91.0,-93.0,-90.0,-93.0,42.0,58.0,48.0,49.0,0
1689,92:69:1D:31:68:E9,3822051,485068838,3486,3456401,3818565,481612437,0,3642,932822,3543,910792,99,22030,1796,6,3612,78,0,31,216660.0,130000.0,-52.0,-50.0,-44.0,-46.0,-52.0,-49.0,-43.0,-46.0,-91.0,-93.0,-90.0,-93.0,39.0,43.0,46.0,47.0,0
1690,CC:2F:71:3F:1F:24,4412660,1167719897,594093,686107258,3818567,481612639,37,494482,557856425,493910,557787453,572,68972,476813,10,594330,47159,34,431,130000.0,43333.0,-67.0,-65.0,-70.0,-68.0,-67.0,-65.0,-70.0,-67.0,-91.0,-93.0,-90.0,-93.0,24.0,28.0,20.0,25.0,0
1691,CC:2F:71:3E:C5:1F,3819260,481697357,693,84718,3818567,481612639,0,2958,247720,2449,187214,509,60506,734,8,1024,18,0,32,144444.0,39000.0,-70.0,-71.0,-67.0,-60.0,-70.0,-71.0,-67.0,-60.0,-91.0,-93.0,-90.0,-93.0,21.0,22.0,23.0,33.0,0
1692,BA:8C:B9:54:50:24,3820303,482451085,1736,838446,3818567,481612639,0,5602,824012,5582,820890,20,3122,1004,14,2111,29,0,49,216660.0,130000.0,-49.0,-35.0,-42.0,-44.0,-44.0,-35.0,-43.0,-47.0,-91.0,-93.0,-90.0,-93.0,42.0,58.0,48.0,49.0,0
1693,92:69:1D:31:68:E9,3822054,485069100,3486,3456401,3818568,481612699,0,3642,932822,3543,910792,99,22030,1796,6,3612,78,0,31,216660.0,130000.0,-52.0,-50.0,-44.0,-46.0,-52.0,-49.0,-43.0,-46.0,-91.0,-93.0,-90.0,-93.0,39.0,43.0,46.0,47.0,0
1694,CC:2F:71:3F:1F:24,4412702,1167734317,594134,686121618,3818568,481612699,37,494508,557861345,493936,557792373,572,68972,476839,10,594371,47172,34,431,130000.0,39000.0,-67.0,-65.0,-71.0,-68.0,-67.0,-65.0,-70.0,-67.0,-91.0,-93.0,-90.0,-93.0,24.0,28.0,19.0,25.0,0
1695,CC:2F:71:3E:C5:1F,3819261,481697417,693,84718,3818568,481612699,0,2958,247720,2449,187214,509,60506,734,8,1024,18,0,32,144444.0,39000.0,-70.0,-71.0,-67.0,-60.0,-70.0,-71.0,-67.0,-60.0,-91.0,-93.0,-90.0,-93.0,21.0,22.0,23.0,33.0,0
1696,BA:8C:B9:54:50:24,3820304,482451145,1736,838446,3818568,481612699,0,5602,824012,5582,820890,20,3122,1004,14,2111,29,0,49,216660.0,130000.0,-49.0,-35.0,-42.0,-44.0,-44.0,-35.0,-43.0,-47.0,-91.0,-93.0,-90.0,-93.0,42.0,58.0,48.0,49.0,0
1697,92:69:1D:31:68:E9,3822060,485069706,3486,3456401,3818574,481613305,0,3642,932822,3543,910792,99,22030,1796,6,3612,78,0,31,216660.0,130000.0,-52.0,-50.0,-44.0,-46.0,-52.0,-49.0,-43.0,-46.0,-91.0,-93.0,-90.0,-93.0,39.0,43.0,46.0,47.0,0
1698,CC:2F:71:3F:1F:24,4412750,1167749357,594176,686136052,3818574,481613305,37,494534,557866289,493962,557797317,572,68972,476865,10,594413,47186,34,431,130000.0,39000.0,-67.0,-65.0,-70.0,-67.0,-67.0,-65.0,-70.0,-67.0,-91.0,-93.0,-90.0,-93.0,24.0,28.0,20.0,26.0,0
1699,CC:2F:71:3E:C5:1F,3819269,481698225,693,84718,3818576,481613507,0,2958,247720,2449,187214,509,60506,734,8,1024,18,0,32,144444.0,39000.0,-70.0,-71.0,-67.0,-60.0,-70.0,-71.0,-67.0,-60.0,-91.0,-93.0,-90.0,-93.0,21.0,22.0,23.0,33.0,0
1700,BA:8C:B9:54:50:24,3820312,482451953,1736,838446,3818576,481613507,0,5602,824012,5582,820890,20,3122,1004,14,2111,29,0,49,216660.0,130000.0,-49.0,-35.0,-42.0,-44.0,-44.0,-35.0,-43.0,-47.0,-91.0,-93.0,-90.0,-93.0,42.0,58.0,48.0,49.0,0
1701,92:69:1D:31:68:E9,3822062,485069908,3486,3456401,3818576,481613507,0,3642,932822,3543,910792,99,22030,1796,6,3612,78,0,31,216660.0,130000.0,-52.0,-50.0,-44.0,-46.0,-52.0,-49.0,-43.0,-46.0,-91.0,-93.0,-90.0,-93.0,39.0,43.0,46.0,47.0,0
1702,CC:2F:71:3F:1F:24,4412795,1167764111,594219,686150604,3818576,481613507,37,494561,557871325,493989,557802353,572,68972,476892,10,594456,47193,34,431,130000.0,39000.0,-67.0,-65.0,-71.0,-68.0,-67.0,-65.0,-70.0,-67.0,-91.0,-93.0,-90.0,-93.0,24.0,28.0,19.0,25.0,0
1703,CC:2F:71:3E:C5:1F,3819270,481698285,693,84718,3818577,481613567,0,2958,247720,2449,187214,509,60506,734,8,1024,18,0,32,144444.0,39000.0,-70.0,-71.0,-67.0,-60.0,-70.0,-71.0,-67.0,-60.0,-91.0,-93.0,-90.0,-93.0,21.0,22.0,23.0,33.0,0
1704,BA:8C:B9:54:50:24,3820313,482452013,1736,838446,3818577,481613567,0,5602,824012,5582,820890,20,3122,1004,14,2111,29,0,49,216660.0,130000.0,-49.0,-35.0,-42.0,-44.0,-44.0,-35.0,-43.0,-47.0,-91.0,-93.0,-90.0,-93.0,42.0,58.0,48.0,49.0,0
1705,92:69:1D:31:68:E9,3822069,485070574,3486,3456401,3818583,481614173,0,3642,932822,3543,910792,99,22030,1796,6,3612,78,0,31,216660.0,130000.0,-52.0,-50.0,-44.0,-46.0,-52.0,-49.0,-43.0,-46.0,-91.0,-93.0,-90.0,-93.0,39.0,43.0,46.0,47.0,0
1706,CC:2F:71:3F:1F:24,4412844,1167779143,594261,686164970,3818583,481614173,37,494590,557876653,494018,557807681,572,68972,476921,10,594498,47205,34,431,130000.0,43333.0,-67.0,-65.0,-70.0,-67.0,-67.0,-65.0,-70.0,-67.0,-91.0,-93.0,-90.0,-93.0,24.0,28.0,20.0,26.0,0
1707,CC:2F:71:3E:C5:1F,3819278,481699093,693,84718,3818585,481614375,0,2958,247720,2449,187214,509,60506,734,8,1024,18,0,32,144444.0,39000.0,-70.0,-71.0,-67.0,-60.0,-70.0,-71.0,-67.0,-60.0,-91.0,-93.0,-90.0,-93.0,21.0,22.0,23.0,33.0,0
1708,BA:8C:B9:54:50:24,3820322,482453094,1736,838446,3818586,481614648,0,5602,824012,5582,820890,20,3122,1004,14,2111,29,0,49,216660.0,130000.0,-49.0,-35.0,-42.0,-44.0,-44.0,-35.0,-43.0,-47.0,-91.0,-93.0,-90.0,-93.0,42.0,58.0,48.0,49.0,0
1709,92:69:1D:31:68:E9,3822072,485071049,3486,3456401,3818586,481614648,0,3642,932822,3543,910792,99,22030,1796,6,3612,78,0,31,216660.0,130000.0,-52.0,-50.0,-44.0,-46.0,-52.0,-49.0,-43.0,-46.0,-90.0,-93.0,-90.0,-93.0,38.0,43.0,46.0,47.0,0
1710,CC:2F:71:3F:1F:24,4412890,1167794176,594304,686179528,3818586,481614648,37,494615,557881457,494043,557812485,572,68972,476946,10,594541,47228,34,431,117000.0,39000.0,-67.0,-65.0,-71.0,-68.0,-67.0,-65.0,-70.0,-67.0,-90.0,-93.0,-90.0,-93.0,23.0,28.0,19.0,25.0,0
1711,CC:2F:71:3E:C5:1F,3819279,481699366,693,84718,3818586,481614648,0,2958,247720,2449,187214,509,60506,734,8,1024,18,0,32,144444.0,39000.0,-70.0,-71.0,-67.0,-60.0,-70.0,-71.0,-67.0,-60.0,-90.0,-93.0,-90.0,-93.0,20.0,22.0,23.0,33.0,0
1712,BA:8C:B9:54:50:24,3820322,482453094,1736,838446,3818586,481614648,0,5605,824216,5585,821094,20,3122,1004,14,2111,29,0,49,216660.0,130000.0,-39.0,-37.0,-44.0,-52.0,-43.0,-36.0,-43.0,-48.0,-90.0,-93.0,-90.0,-93.0,51.0,56.0,46.0,41.0,0
1713,92:69:1D:31:68:E9,3822079,485071715,3486,3456401,3818593,481615314,0,3642,932822,3543,910792,99,22030,1796,6,3612,78,0,31,216660.0,130000.0,-52.0,-50.0,-44.0,-46.0,-52.0,-49.0,-43.0,-46.0,-90.0,-93.0,-90.0,-93.0,38.0,43.0,46.0,47.0,0
1714,CC:2F:71:3F:1F:24,4412941,1167809472,594346,686193956,3818595,481615516,37,494642,557886541,494070,557817569,572,68972,476973,10,594583,47235,34,431,130000.0,43333.0,-67.0,-65.0,-71.0,-68.0,-67.0,-65.0,-70.0,-67.0,-90.0,-93.0,-90.0,-93.0,23.0,28.0,19.0,25.0,0
1715,CC:2F:71:3E:C5:1F,3819288,481700234,693,84718,3818595,481615516,0,2958,247720,2449,187214,509,60506,734,8,1024,18,0,32,144444.0,39000.0,-70.0,-71.0,-67.0,-60.0,-70.0,-71.0,-67.0,-60.0,-90.0,-93.0,-90.0,-93.0,20.0,22.0,23.0,33.0,0
1716,BA:8C:B9:54:50:24,3820331,482453962,1736,838446,3818595,481615516,0,5606,824284,5586,821162,20,3122,1004,14,2111,29,0,49,216660.0,130000.0,-40.0,-37.0,-45.0,-51.0,-42.0,-36.0,-44.0,-49.0,-90.0,-92.0,-89.0,-92.0,50.0,55.0,44.0,41.0,0
1717,92:69:1D:31:68:E9,3822081,485071917,3486,3456401,3818595,481615516,0,3642,932822,3543,910792,99,22030,1796,6,3612,78,0,31,216660.0,130000.0,-52.0,-50.0,-44.0,-46.0,-52.0,-49.0,-43.0,-46.0,-90.0,-92.0,-89.0,-92.0,38.0,42.0,45.0,46.0,0
1718,CC:2F:71:3F:1F:24,4412982,1167823714,594387,686208198,3818595,481615516,37,494668,557891485,494096,557822513,572,68972,476999,10,594624,47240,34,431,130000.0,39000.0,-67.0,-65.0,-71.0,-68.0,-67.0,-65.0,-70.0,-67.0,-90.0,-92.0,-89.0,-92.0,23.0,27.0,18.0,24.0,0
1719,CC:2F:71:3E:C5:1F,3819288,481700234,693,84718,3818595,481615516,0,2958,247720,2449,187214,509,60506,734,8,1024,18,0,32,144444.0,39000.0,-70.0,-71.0,-67.0,-60.0,-70.0,-71.0,-67.0,-60.0,-90.0,-92.0,-89.0,-92.0,20.0,21.0,22.0,32.0,0
1720,BA:8C:B9:54:50:24,3820331,482453962,1736,838446,3818595,481615516,0,5606,824284,5586,821162,20,3122,1004,14,2111,29,0,49,216660.0,130000.0,-40.0,-37.0,-45.0,-51.0,-42.0,-36.0,-44.0,-49.0,-90.0,-92.0,-89.0,-92.0,50.0,55.0,44.0,41.0,0
1721,92:69:1D:31:68:E9,3822087,485072523,3486,3456401,3818601,481616122,0,3642,932822,3543,910792,99,22030,1796,6,3612,78,0,31,216660.0,130000.0,-52.0,-50.0,-44.0,-46.0,-52.0,-49.0,-43.0,-46.0,-90.0,-92.0,-89.0,-92.0,38.0,42.0,45.0,46.0,0
1722,CC:2F:71:3F:1F:24,4413034,1167839204,594431,686222880,3818603,481616324,37,494695,557896545,494123,557827573,572,68972,477026,10,594668,47259,34,431,130000.0,39000.0,-67.0,-65.0,-71.0,-68.0,-67.0,-65.0,-70.0,-67.0,-90.0,-92.0,-89.0,-92.0,23.0,27.0,18.0,24.0,0
1723,CC:2F:71:3E:C5:1F,3819296,481701042,693,84718,3818603,481616324,0,2958,247720,2449,187214,509,60506,734,8,1024,18,0,32,144444.0,39000.0,-70.0,-71.0,-67.0,-60.0,-70.0,-71.0,-67.0,-60.0,-90.0,-92.0,-89.0,-92.0,20.0,21.0,22.0,32.0,0
1724,BA:8C:B9:54:50:24,3820339,482454770,1736,838446,3818603,481616324,0,5606,824284,5586,821162,20,3122,1004,14,2111,29,0,49,216660.0,130000.0,-40.0,-37.0,-45.0,-51.0,-42.0,-36.0,-44.0,-49.0,-90.0,-92.0,-89.0,-92.0,50.0,55.0,44.0,41.0,0
1725,92:69:1D:31:68:E9,3822090,485072785,3486,3456401,3818604,481616384,0,3642,932822,3543,910792,99,22030,1796,6,3612,78,0,31,216660.0,130000.0,-52.0,-50.0,-44.0,-46.0,-52.0,-49.0,-43.0,-46.0,-90.0,-92.0,-89.0,-92.0,38.0,42.0,45.0,46.0,0
1726,CC:2F:71:3F:1F:24,4413077,1167853692,594473,686237308,3818604,481616384,37,494722,557901605,494150,557832633,572,68972,477053,10,594710,47276,34,431,130000.0,43333.0,-67.0,-65.0,-70.0,-67.0,-67.0,-65.0,-70.0,-67.0,-90.0,-92.0,-89.0,-92.0,23.0,27.0,19.0,25.0,0
1727,CC:2F:71:3E:C5:1F,3819297,481701102,693,84718,3818604,481616384,0,2958,247720,2449,187214,509,60506,734,8,1024,18,0,32,144444.0,39000.0,-70.0,-71.0,-67.0,-60.0,-70.0,-71.0,-67.0,-60.0,-90.0,-92.0,-89.0,-92.0,20.0,21.0,22.0,32.0,0
1728,BA:8C:B9:54:50:24,3820340,482454830,1736,838446,3818604,481616384,0,5606,824284,5586,821162,20,3122,1004,14,2111,29,0,49,216660.0,130000.0,-40.0,-37.0,-45.0,-51.0,-42.0,-36.0,-44.0,-49.0,-90.0,-92.0,-89.0,-92.0,50.0,55.0,44.0,41.0,0
1729,92:69:1D:31:68:E9,3822096,485073391,3486,3456401,3818610,481616990,0,3642,932822,3543,910792,99,22030,1796,6,3612,78,0,31,216660.0,130000.0,-52.0,-50.0,-44.0,-46.0,-52.0,-49.0,-43.0,-46.0,-90.0,-92.0,-89.0,-92.0,38.0,42.0,45.0,46.0,0
1730,CC:2F:71:3F:1F:24,4413128,1167869114,594516,686251922,3818612,481617192,37,494747,557906409,494175,557837437,572,68972,477078,10,594753,47283,34,431,130000.0,43333.0,-67.0,-65.0,-71.0,-68.0,-67.0,-65.0,-70.0,-67.0,-90.0,-92.0,-89.0,-92.0,23.0,27.0,18.0,24.0,0
1731,CC:2F:71:3E:C5:1F,3819305,481701910,693,84718,3818612,481617192,0,2958,247720,2449,187214,509,60506,734,8,1024,18,0,32,144444.0,39000.0,-70.0,-71.0,-67.0,-60.0,-70.0,-71.0,-67.0,-60.0,-90.0,-91.0,-89.0,-91.0,20.0,20.0,22.0,31.0,0
1732,BA:8C:B9:54:50:24,3820348,482455638,1736,838446,3818612,481617192,0,5606,824284,5586,821162,20,3122,1004,14,2111,29,0,49,216660.0,130000.0,-40.0,-37.0,-45.0,-51.0,-42.0,-36.0,-44.0,-49.0,-90.0,-91.0,-89.0,-91.0,50.0,54.0,44.0,40.0,0
1733,92:69:1D:31:68:E9,3822099,485073653,3486,3456401,3818613,481617252,0,3642,932822,3543,910792,99,22030,1796,6,3612,78,0,31,216660.0,130000.0,-52.0,-50.0,-44.0,-46.0,-52.0,-49.0,-43.0,-46.0,-90.0,-91.0,-89.0,-91.0,38.0,41.0,45.0,45.0,0
1734,CC:2F:71:3F:1F:24,4413171,1167883602,594558,686266350,3818613,481617252,37,494773,557911353,494201,557842381,572,68972,477104,10,594795,47320,34,431,144444.0,39000.0,-67.0,-65.0,-70.0,-67.0,-67.0,-65.0,-70.0,-67.0,-90.0,-91.0,-89.0,-91.0,23.0,26.0,19.0,24.0,0
1735,CC:2F:71:3E:C5:1F,3819306,481701970,693,84718,3818613,481617252,0,2958,247720,2449,187214,509,60506,734,8,1024,18,0,32,144444.0,39000.0,-70.0,-71.0,-67.0,-60.0,-70.0,-71.0,-67.0,-60.0,-90.0,-91.0,-89.0,-91.0,20.0,20.0,22.0,31.0,0
1736,BA:8C:B9:54:50:24,3820349,482455698,1736,838446,3818613,481617252,0,5606,824284,5586,821162,20,3122,1004,14,2111,29,0,49,216660.0,130000.0,-40.0,-37.0,-45.0,-51.0,-42.0,-36.0,-44.0,-49.0,-90.0,-91.0,-89.0,-91.0,50.0,54.0,44.0,40.0,0
1737,92:69:1D:31:68:E9,3822105,485074259,3486,3456401,3818619,481617858,0,3642,932822,3543,910792,99,22030,1796,6,3612,78,0,31,216660.0,130000.0,-52.0,-50.0,-44.0,-46.0,-52.0,-49.0,-43.0,-46.0,-90.0,-91.0,-88.0,-91.0,38.0,41.0,44.0,45.0,0
1738,CC:2F:71:3F:1F:24,4413220,1167898714,594599,686280654,3818621,481618060,37,494798,557916157,494226,557847185,572,68972,477129,10,594836,47339,34,431,130000.0,43333.0,-67.0,-65.0,-70.0,-67.0,-67.0,-65.0,-70.0,-67.0,-90.0,-91.0,-88.0,-91.0,23.0,26.0,18.0,24.0,0
1739,CC:2F:71:3E:C5:1F,3819314,481702778,693,84718,3818621,481618060,0,2958,247720,2449,187214,509,60506,734,8,1024,18,0,32,144444.0,39000.0,-70.0,-71.0,-67.0,-60.0,-70.0,-71.0,-67.0,-60.0,-90.0,-91.0,-88.0,-91.0,20.0,20.0,21.0,31.0,0
1740,BA:8C:B9:54:50:24,3820357,482456506,1736,838446,3818621,481618060,0,5606,824284,5586,821162,20,3122,1004,14,2111,29,0,49,216660.0,130000.0,-40.0,-37.0,-45.0,-51.0,-42.0,-36.0,-44.0,-49.0,-90.0,-91.0,-88.0,-91.0,50.0,54.0,43.0,40.0,0
1741,92:69:1D:31:68:E9,3822107,485074461,3486,3456401,3818621,481618060,0,3642,932822,3543,910792,99,22030,1796,6,3612,78,0,31,216660.0,130000.0,-52.0,-50.0,-44.0,-46.0,-52.0,-49.0,-43.0,-46.0,-90.0,-91.0,-88.0,-91.0,38.0,41.0,44.0,45.0,0
1742,CC:2F:71:3F:1F:24,4413260,1167912888,594639,686294828,3818621,481618060,37,494823,557920961,494251,557851989,572,68972,477154,10,594876,47361,34,431,117000.0,39000.0,-67.0,-65.0,-70.0,-67.0,-67.0,-65.0,-70.0,-67.0,-90.0,-91.0,-88.0,-91.0,23.0,26.0,18.0,24.0,0
1743,CC:2F:71:3E:C5:1F,3819314,481702778,693,84718,3818621,481618060,0,2958,247720,2449,187214,509,60506,734,8,1024,18,0,32,144444.0,39000.0,-70.0,-71.0,-67.0,-60.0,-70.0,-71.0,-67.0,-60.0,-90.0,-91.0,-88.0,-91.0,20.0,20.0,21.0,31.0,0
1744,BA:8C:B9:54:50:24,3820357,482456506,1736,838446,3818621,481618060,0,5606,824284,5586,821162,20,3122,1004,14,2111,29,0,49,216660.0,130000.0,-40.0,-37.0,-45.0,-51.0,-42.0,-36.0,-44.0,-49.0,-90.0,-91.0,-88.0,-91.0,50.0,54.0,43.0,40.0,0
1745,92:69:1D:31:68:E9,3822114,485075127,3486,3456401,3818628,481618726,0,3642,932822,3543,910792,99,22030,1796,6,3612,78,0,31,216660.0,130000.0,-52.0,-50.0,-44.0,-46.0,-52.0,-49.0,-43.0,-46.0,-90.0,-91.0,-88.0,-91.0,38.0,41.0,44.0,45.0,0
1746,CC:2F:71:3F:1F:24,4413310,1167928054,594680,686309126,3818630,481618928,37,494850,557926045,494278,557857073,572,68972,477181,10,594917,47369,34,431,130000.0,43333.0,-67.0,-65.0,-70.0,-67.0,-67.0,-65.0,-70.0,-67.0,-90.0,-91.0,-88.0,-91.0,23.0,26.0,18.0,24.0,0
1747,CC:2F:71:3E:C5:1F,3819323,481703646,693,84718,3818630,481618928,0,2958,247720,2449,187214,509,60506,734,8,1024,18,0,32,144444.0,39000.0,-70.0,-71.0,-67.0,-60.0,-70.0,-71.0,-67.0,-60.0,-90.0,-91.0,-88.0,-91.0,20.0,20.0,21.0,31.0,0
1748,BA:8C:B9:54:50:24,3820366,482457374,1736,838446,3818630,481618928,0,5606,824284,5586,821162,20,3122,1004,14,2111,29,0,49,216660.0,130000.0,-40.0,-37.0,-45.0,-51.0,-42.0,-36.0,-44.0,-49.0,-90.0,-91.0,-88.0,-91.0,50.0,54.0,43.0,40.0,0
1749,92:69:1D:31:68:E9,3822116,485075329,3486,3456401,3818630,481618928,0,3642,932822,3543,910792,99,22030,1796,6,3612,78,0,31,216660.0,130000.0,-52.0,-50.0,-44.0,-46.0,-52.0,-49.0,-43.0,-46.0,-90.0,-91.0,-88.0,-91.0,38.0,41.0,44.0,45.0,0
1750,CC:2F:71:3F:1F:24,4413353,1167942718,594723,686323790,3818630,481618928,37,494882,557931757,494310,557862785,572,68972,477213,10,594960,47374,34,431,130000.0,43333.0,-67.0,-65.0,-70.0,-68.0,-67.0,-65.0,-70.0,-67.0,-90.0,-91.0,-88.0,-91.0,23.0,26.0,18.0,23.0,0
1751,CC:2F:71:3E:C5:1F,3819323,481703646,693,84718,3818630,481618928,0,2958,247720,2449,187214,509,60506,734,8,1024,18,0,32,144444.0,39000.0,-70.0,-71.0,-67.0,-60.0,-70.0,-71.0,-67.0,-60.0,-90.0,-91.0,-88.0,-91.0,20.0,20.0,21.0,31.0,0
1752,BA:8C:B9:54:50:24,3820366,482457374,1736,838446,3818630,481618928,0,5606,824284,5586,821162,20,3122,1004,14,2111,29,0,49,216660.0,130000.0,-40.0,-37.0,-45.0,-51.0,-42.0,-36.0,-44.0,-49.0,-90.0,-91.0,-88.0,-91.0,50.0,54.0,43.0,40.0,0
1753,92:69:1D:31:68:E9,3822122,485075935,3486,3456401,3818636,481619534,0,3642,932822,3543,910792,99,22030,1796,6,3612,78,0,31,216660.0,130000.0,-52.0,-50.0,-44.0,-46.0,-52.0,-49.0,-43.0,-46.0,-90.0,-91.0,-88.0,-91.0,38.0,41.0,44.0,45.0,0
1754,CC:2F:71:3F:1F:24,4413404,1167958140,594766,686338404,3818638,481619736,37,494911,557937121,494339,557868149,572,68972,477242,10,595003,47398,34,431,130000.0,39000.0,-67.0,-65.0,-70.0,-67.0,-67.0,-65.0,-70.0,-67.0,-90.0,-91.0,-88.0,-91.0,23.0,26.0,18.0,24.0,0
1755,CC:2F:71:3E:C5:1F,3819331,481704454,693,84718,3818638,481619736,0,2958,247720,2449,187214,509,60506,734,8,1024,18,0,32,144444.0,39000.0,-70.0,-71.0,-67.0,-60.0,-70.0,-71.0,-67.0,-60.0,-90.0,-91.0,-88.0,-91.0,20.0,20.0,21.0,31.0,0
1756,BA:8C:B9:54:50:24,3820375,482458242,1736,838446,3818639,481619796,0,5606,824284,5586,821162,20,3122,1004,14,2111,29,0,49,216660.0,130000.0,-40.0,-37.0,-45.0,-51.0,-42.0,-36.0,-44.0,-49.0,-90.0,-91.0,-88.0,-91.0,50.0,54.0,43.0,40.0,0
1757,92:69:1D:31:68:E9,3822126,485076313,3487,3456517,3818639,481619796,0,3644,932958,3545,910928,99,22030,1796,6,3613,78,0,31,216660.0,130000.0,-52.0,-50.0,-44.0,-46.0,-51.0,-49.0,-43.0,-46.0,-90.0,-91.0,-88.0,-91.0,38.0,41.0,44.0,45.0,0
1758,CC:2F:71:3F:1F:24,4413450,1167972966,594811,686353170,3818639,481619796,37,494941,557942589,494369,557873617,572,68972,477272,10,595048,47411,34,431,130000.0,43333.0,-67.0,-65.0,-70.0,-67.0,-67.0,-65.0,-70.0,-67.0,-90.0,-91.0,-88.0,-91.0,23.0,26.0,18.0,24.0,0
1759,CC:2F:71:3E:C5:1F,3819333,481704574,694,84778,3818639,481619796,0,2960,247860,2451,187354,509,60506,734,8,1025,18,0,32,144444.0,39000.0,-70.0,-71.0,-67.0,-60.0,-70.0,-71.0,-67.0,-60.0,-90.0,-91.0,-88.0,-91.0,20.0,20.0,21.0,31.0,0
1760,BA:8C:B9:54:50:24,3820376,482458358,1737,838562,3818639,481619796,0,5612,824692,5592,821570,20,3122,1004,14,2112,29,0,49,216660.0,130000.0,-49.0,-35.0,-42.0,-44.0,-42.0,-35.0,-42.0,-46.0,-90.0,-91.0,-88.0,-91.0,41.0,56.0,46.0,47.0,0
1761,92:69:1D:31:68:E9,3822133,485077192,3487,3456517,3818646,481620675,0,3644,932958,3545,910928,99,22030,1796,6,3613,78,0,31,216660.0,130000.0,-52.0,-50.0,-44.0,-46.0,-51.0,-49.0,-43.0,-46.0,-90.0,-91.0,-88.0,-91.0,38.0,41.0,44.0,45.0,0
1762,CC:2F:71:3F:1F:24,4413500,1167988459,594854,686367784,3818646,481620675,37,494971,557948069,494399,557879097,572,68972,477302,10,595091,47418,34,431,130000.0,39000.0,-67.0,-65.0,-71.0,-67.0,-67.0,-65.0,-70.0,-67.0,-90.0,-91.0,-88.0,-91.0,23.0,26.0,17.0,24.0,0
1763,CC:2F:71:3E:C5:1F,3819342,481705655,694,84778,3818648,481620877,0,2960,247860,2451,187354,509,60506,734,8,1025,18,0,32,144444.0,39000.0,-70.0,-71.0,-67.0,-60.0,-70.0,-71.0,-67.0,-60.0,-90.0,-91.0,-88.0,-91.0,20.0,20.0,21.0,31.0,0
1764,BA:8C:B9:54:50:24,3820385,482459439,1737,838562,3818648,481620877,0,5612,824692,5592,821570,20,3122,1004,14,2112,29,0,49,216660.0,130000.0,-49.0,-35.0,-42.0,-44.0,-42.0,-35.0,-42.0,-46.0,-90.0,-91.0,-88.0,-91.0,41.0,56.0,46.0,47.0,0
1765,92:69:1D:31:68:E9,3822136,485077454,3487,3456517,3818649,481620937,0,3644,932958,3545,910928,99,22030,1796,6,3613,78,0,31,216660.0,130000.0,-52.0,-50.0,-44.0,-46.0,-51.0,-49.0,-43.0,-46.0,-90.0,-91.0,-88.0,-91.0,38.0,41.0,44.0,45.0,0
1766,CC:2F:71:3F:1F:24,4413547,1168003403,594898,686382466,3818649,481620937,37,495000,557953433,494428,557884461,572,68972,477331,10,595135,47448,34,431,144444.0,43333.0,-67.0,-65.0,-71.0,-68.0,-67.0,-65.0,-70.0,-67.0,-90.0,-91.0,-88.0,-91.0,23.0,26.0,17.0,23.0,0
1767,CC:2F:71:3E:C5:1F,3819343,481705715,694,84778,3818649,481620937,0,2960,247860,2451,187354,509,60506,734,8,1025,18,0,32,144444.0,39000.0,-70.0,-71.0,-67.0,-60.0,-70.0,-71.0,-67.0,-60.0,-90.0,-91.0,-88.0,-91.0,20.0,20.0,21.0,31.0,0
1768,BA:8C:B9:54:50:24,3820386,482459499,1737,838562,3818649,481620937,0,5612,824692,5592,821570,20,3122,1004,14,2112,29,0,49,216660.0,130000.0,-49.0,-35.0,-42.0,-44.0,-42.0,-35.0,-42.0,-46.0,-90.0,-91.0,-88.0,-91.0,41.0,56.0,46.0,47.0,0
1769,92:69:1D:31:68:E9,3822142,485078060,3487,3456517,3818655,481621543,0,3644,932958,3545,910928,99,22030,1796,6,3613,78,0,31,216660.0,130000.0,-52.0,-50.0,-44.0,-46.0,-51.0,-49.0,-43.0,-46.0,-90.0,-91.0,-88.0,-91.0,38.0,41.0,44.0,45.0,0
1770,CC:2F:71:3F:1F:24,4413595,1168018493,594940,686396950,3818655,481621543,37,495030,557958949,494458,557889977,572,68972,477361,10,595177,47476,34,431,130000.0,43333.0,-67.0,-65.0,-70.0,-67.0,-67.0,-65.0,-70.0,-67.0,-90.0,-91.0,-88.0,-91.0,23.0,26.0,18.0,24.0,0
1771,CC:2F:71:3E:C5:1F,3819351,481706523,694,84778,3818657,481621745,0,2960,247860,2451,187354,509,60506,734,8,1025,18,0,32,144444.0,39000.0,-70.0,-71.0,-67.0,-60.0,-70.0,-71.0,-67.0,-60.0,-90.0,-91.0,-88.0,-91.0,20.0,20.0,21.0,31.0,0
1772,BA:8C:B9:54:50:24,3820394,482460307,1737,838562,3818657,481621745,0,5612,824692,5592,821570,20,3122,1004,14,2112,29,0,49,216660.0,130000.0,-49.0,-35.0,-42.0,-44.0,-42.0,-35.0,-42.0,-46.0,-90.0,-91.0,-88.0,-91.0,41.0,56.0,46.0,47.0,0
1773,92:69:1D:31:68:E9,3822145,485078324,3487,3456517,3818658,481621807,0,3644,932958,3545,910928,99,22030,1796,6,3613,78,0,31,216660.0,130000.0,-52.0,-50.0,-44.0,-46.0,-51.0,-49.0,-43.0,-46.0,-90.0,-91.0,-88.0,-91.0,38.0,41.0,44.0,45.0,0
1774,CC:2F:71:3F:1F:24,4413642,1168033495,594984,686411688,3818658,481621807,37,495059,557964313,494487,557895341,572,68972,477390,10,595221,47497,34,431,130000.0,39000.0,-67.0,-65.0,-71.0,-67.0,-67.0,-65.0,-70.0,-67.0,-90.0,-91.0,-88.0,-91.0,23.0,26.0,17.0,24.0,0
1775,CC:2F:71:3E:C5:1F,3819352,481706585,694,84778,3818658,481621807,0,2962,248048,2452,187424,510,60624,735,8,1025,18,0,32,144444.0,39000.0,-70.0,-71.0,-67.0,-60.0,-70.0,-71.0,-67.0,-60.0,-90.0,-91.0,-88.0,-91.0,20.0,20.0,21.0,31.0,0
1776,BA:8C:B9:54:50:24,3820395,482460369,1737,838562,3818658,481621807,0,5612,824692,5592,821570,20,3122,1004,14,2112,29,0,49,216660.0,130000.0,-49.0,-35.0,-42.0,-44.0,-42.0,-35.0,-42.0,-46.0,-90.0,-91.0,-88.0,-91.0,41.0,56.0,46.0,47.0,0
1777,92:69:1D:31:68:E9,3822152,485078990,3487,3456517,3818665,481622473,0,3644,932958,3545,910928,99,22030,1796,6,3613,78,0,31,216660.0,130000.0,-52.0,-50.0,-44.0,-46.0,-51.0,-49.0,-43.0,-46.0,-90.0,-91.0,-88.0,-91.0,38.0,41.0,44.0,45.0,0
1778,CC:2F:71:3F:1F:24,4413690,1168048409,595025,686425936,3818665,481622473,37,495088,557969713,494516,557900741,572,68972,477419,10,595262,47528,34,431,130000.0,43333.0,-67.0,-65.0,-71.0,-67.0,-67.0,-65.0,-70.0,-67.0,-90.0,-91.0,-88.0,-91.0,23.0,26.0,17.0,24.0,0
1779,CC:2F:71:3E:C5:1F,3819361,481707453,694,84778,3818667,481622675,0,2962,248048,2452,187424,510,60624,735,8,1025,18,0,32,144444.0,39000.0,-70.0,-71.0,-67.0,-60.0,-70.0,-71.0,-67.0,-60.0,-90.0,-91.0,-88.0,-91.0,20.0,20.0,21.0,31.0,0
1780,BA:8C:B9:54:50:24,3820404,482461237,1737,838562,3818667,481622675,0,5612,824692,5592,821570,20,3122,1004,14,2112,29,0,49,216660.0,130000.0,-49.0,-35.0,-42.0,-44.0,-42.0,-35.0,-42.0,-46.0,-90.0,-91.0,-88.0,-91.0,41.0,56.0,46.0,47.0,0
1781,92:69:1D:31:68:E9,3822154,485079192,3487,3456517,3818667,481622675,0,3644,932958,3545,910928,99,22030,1796,6,3613,78,0,31,216660.0,130000.0,-52.0,-50.0,-44.0,-46.0,-51.0,-49.0,-43.0,-46.0,-90.0,-91.0,-88.0,-91.0,38.0,41.0,44.0,45.0,0
1782,CC:2F:71:3F:1F:24,4413735,1168063281,595068,686440606,3818667,481622675,37,495117,557975077,494545,557906105,572,68972,477448,10,595305,47531,34,431,130000.0,43333.0,-67.0,-65.0,-71.0,-68.0,-67.0,-65.0,-70.0,-67.0,-90.0,-91.0,-88.0,-91.0,23.0,26.0,17.0,23.0,0
1783,CC:2F:71:3E:C5:1F,3819361,481707453,694,84778,3818667,481622675,0,2962,248048,2452,187424,510,60624,735,8,1025,18,0,32,144444.0,39000.0,-70.0,-71.0,-67.0,-60.0,-70.0,-71.0,-67.0,-60.0,-90.0,-91.0,-88.0,-91.0,20.0,20.0,21.0,31.0,0
1784,BA:8C:B9:54:50:24,3820404,482461237,1737,838562,3818667,481622675,0,5612,824692,5592,821570,20,3122,1004,14,2112,29,0,49,216660.0,130000.0,-49.0,-35.0,-42.0,-44.0,-42.0,-35.0,-42.0,-46.0,-90.0,-91.0,-88.0,-91.0,41.0,56.0,46.0,47.0,0
1785,92:69:1D:31:68:E9,3822160,485079798,3487,3456517,3818673,481623281,0,3644,932958,3545,910928,99,22030,1796,6,3613,78,0,31,216660.0,130000.0,-52.0,-50.0,-44.0,-46.0,-51.0,-49.0,-43.0,-46.0,-90.0,-91.0,-88.0,-91.0,38.0,41.0,44.0,45.0,0
1786,CC:2F:71:3F:1F:24,4413787,1168078701,595111,686455158,3818676,481623543,37,495146,557980441,494574,557911469,572,68972,477477,10,595348,47552,34,431,117000.0,39000.0,-67.0,-65.0,-70.0,-67.0,-67.0,-65.0,-70.0,-67.0,-90.0,-91.0,-88.0,-91.0,23.0,26.0,18.0,24.0,0
1787,CC:2F:71:3E:C5:1F,3819370,481708321,694,84778,3818676,481623543,0,2962,248048,2452,187424,510,60624,735,8,1025,18,0,32,144444.0,39000.0,-70.0,-71.0,-67.0,-60.0,-70.0,-71.0,-67.0,-60.0,-90.0,-91.0,-88.0,-91.0,20.0,20.0,21.0,31.0,0
1788,BA:8C:B9:54:50:24,3820413,482462105,1737,838562,3818676,481623543,0,5612,824692,5592,821570,20,3122,1004,14,2112,29,0,49,216660.0,130000.0,-49.0,-35.0,-42.0,-44.0,-42.0,-35.0,-42.0,-46.0,-90.0,-91.0,-88.0,-91.0,41.0,56.0,46.0,47.0,0
1789,92:69:1D:31:68:E9,3822163,485080060,3487,3456517,3818676,481623543,0,3644,932958,3545,910928,99,22030,1796,6,3613,78,0,31,216660.0,130000.0,-52.0,-50.0,-44.0,-46.0,-51.0,-49.0,-43.0,-46.0,-90.0,-91.0,-88.0,-91.0,38.0,41.0,44.0,45.0,0
1790,CC:2F:71:3F:1F:24,4413830,1168093259,595154,686469716,3818676,481623543,37,495176,557985921,494604,557916949,572,68972,477507,10,595391,47558,34,431,130000.0,43333.0,-67.0,-65.0,-70.0,-68.0,-67.0,-65.0,-70.0,-67.0,-90.0,-91.0,-88.0,-91.0,23.0,26.0,18.0,23.0,0
1791,CC:2F:71:3E:C5:1F,3819370,481708321,694,84778,3818676,481623543,0,2962,248048,2452,187424,510,60624,735,8,1025,18,0,32,144444.0,39000.0,-70.0,-71.0,-67.0,-60.0,-70.0,-71.0,-67.0,-60.0,-90.0,-91.0,-88.0,-91.0,20.0,20.0,21.0,31.0,0
1792,BA:8C:B9:54:50:24,3820413,482462105,1737,838562,3818676,481623543,0,5612,824692,5592,821570,20,3122,1004,14,2112,29,0,49,216660.0,130000.0,-49.0,-35.0,-42.0,-44.0,-42.0,-35.0,-42.0,-46.0,-90.0,-91.0,-88.0,-91.0,41.0,56.0,46.0,47.0,0
1793,92:69:1D:31:68:E9,3822171,485080868,3487,3456517,3818684,481624351,0,3644,932958,3545,910928,99,22030,1796,6,3613,78,0,31,216660.0,130000.0,-52.0,-50.0,-44.0,-46.0,-51.0,-49.0,-43.0,-46.0,-90.0,-91.0,-88.0,-91.0,38.0,41.0,44.0,45.0,0
1794,CC:2F:71:3F:1F:24,4413881,1168108619,595197,686484268,3818684,481624351,37,495205,557991285,494633,557922313,572,68972,477536,10,595434,47583,34,431,130000.0,39000.0,-67.0,-65.0,-70.0,-68.0,-67.0,-65.0,-70.0,-67.0,-90.0,-91.0,-88.0,-91.0,23.0,26.0,18.0,23.0,0
1795,CC:2F:71:3E:C5:1F,3819378,481709129,694,84778,3818684,481624351,0,2962,248048,2452,187424,510,60624,735,8,1025,18,0,32,144444.0,39000.0,-70.0,-71.0,-67.0,-60.0,-70.0,-71.0,-67.0,-60.0,-90.0,-91.0,-88.0,-91.0,20.0,20.0,21.0,31.0,0
1796,BA:8C:B9:54:50:24,3820421,482462913,1737,838562,3818684,481624351,0,5612,824692,5592,821570,20,3122,1004,14,2112,29,0,49,216660.0,130000.0,-49.0,-35.0,-42.0,-44.0,-42.0,-35.0,-42.0,-46.0,-90.0,-91.0,-88.0,-91.0,41.0,56.0,46.0,47.0,0
1797,92:69:1D:31:68:E9,3822173,485080990,3487,3456517,3818686,481624473,0,3645,933026,3546,910996,99,22030,1796,6,3613,78,0,31,216660.0,130000.0,-52.0,-50.0,-44.0,-46.0,-52.0,-50.0,-44.0,-46.0,-90.0,-91.0,-88.0,-91.0,38.0,41.0,44.0,45.0,0
1798,CC:2F:71:3F:1F:24,4413925,1168123113,595239,686498640,3818686,481624473,37,495235,557996767,494662,557927677,573,69090,477566,10,595476,47609,34,431,130000.0,39000.0,-67.0,-65.0,-70.0,-68.0,-67.0,-65.0,-70.0,-67.0,-90.0,-91.0,-88.0,-91.0,23.0,26.0,18.0,23.0,0
1799,CC:2F:71:3E:C5:1F,3819380,481709251,694,84778,3818686,481624473,0,2962,248048,2452,187424,510,60624,735,8,1025,18,0,32,144444.0,39000.0,-70.0,-71.0,-67.0,-60.0,-70.0,-71.0,-67.0,-60.0,-90.0,-91.0,-88.0,-91.0,20.0,20.0,21.0,31.0,0
1800,BA:8C:B9:54:50:24,3820423,482463035,1737,838562,3818686,481624473,0,5612,824692,5592,821570,20,3122,1004,14,2112,29,0,49,216660.0,130000.0,-49.0,-35.0,-42.0,-44.0,-42.0,-35.0,-42.0,-46.0,-90.0,-91.0,-88.0,-91.0,41.0,56.0,46.0,47.0,0
1801,92:69:1D:31:68:E9,3822181,485081798,3487,3456517,3818694,481625281,0,3645,933026,3546,910996,99,22030,1796,6,3613,78,0,31,216660.0,130000.0,-52.0,-50.0,-44.0,-46.0,-52.0,-50.0,-44.0,-46.0,-90.0,-91.0,-88.0,-91.0,38.0,41.0,44.0,45.0,0
1802,CC:2F:71:3F:1F:24,4413975,1168138293,595281,686513012,3818694,481625281,37,495264,558002131,494691,557933041,573,69090,477595,10,595518,47624,34,431,130000.0,43333.0,-67.0,-65.0,-70.0,-68.0,-67.0,-65.0,-70.0,-67.0,-90.0,-91.0,-88.0,-91.0,23.0,26.0,18.0,23.0,0
1803,CC:2F:71:3E:C5:1F,3819388,481710059,694,84778,3818694,481625281,0,2962,248048,2452,187424,510,60624,735,8,1025,18,0,32,144444.0,39000.0,-70.0,-71.0,-67.0,-60.0,-70.0,-71.0,-67.0,-60.0,-90.0,-91.0,-88.0,-91.0,20.0,20.0,21.0,31.0,0
1804,BA:8C:B9:54:50:24,3820431,482463843,1737,838562,3818694,481625281,0,5612,824692,5592,821570,20,3122,1004,14,2112,29,0,49,216660.0,130000.0,-49.0,-35.0,-42.0,-44.0,-42.0,-35.0,-42.0,-46.0,-90.0,-91.0,-88.0,-91.0,41.0,56.0,46.0,47.0,0
1805,92:69:1D:31:68:E9,3822181,485081798,3487,3456517,3818694,481625281,0,3645,933026,3546,910996,99,22030,1796,6,3613,78,0,31,216660.0,130000.0,-52.0,-50.0,-44.0,-46.0,-52.0,-50.0,-44.0,-46.0,-90.0,-91.0,-88.0,-91.0,38.0,41.0,44.0,45.0,0
1806,CC:2F:71:3F:1F:24,4414016,1168152597,595322,686527316,3818694,481625281,37,495293,558007495,494720,557938405,573,69090,477624,10,595559,47643,34,431,117000.0,39000.0,-67.0,-65.0,-71.0,-67.0,-67.0,-65.0,-70.0,-67.0,-90.0,-91.0,-88.0,-91.0,23.0,26.0,17.0,24.0,0
1807,CC:2F:71:3E:C5:1F,3819388,481710059,694,84778,3818694,481625281,0,2962,248048,2452,187424,510,60624,735,8,1025,18,0,32,144444.0,39000.0,-70.0,-71.0,-67.0,-60.0,-70.0,-71.0,-67.0,-60.0,-90.0,-91.0,-88.0,-91.0,20.0,20.0,21.0,31.0,0
1808,BA:8C:B9:54:50:24,3820432,482463903,1737,838562,3818695,481625341,0,5612,824692,5592,821570,20,3122,1004,14,2112,29,0,49,216660.0,130000.0,-49.0,-35.0,-42.0,-44.0,-42.0,-35.0,-42.0,-46.0,-90.0,-91.0,-88.0,-91.0,41.0,56.0,46.0,47.0,0
1809,92:69:1D:31:68:E9,3822211,485093487,3487,3456517,3818724,481636970,0,3648,933397,3548,911132,100,22265,1797,6,3613,78,0,31,216660.0,130000.0,-51.0,-47.0,-42.0,-49.0,-52.0,-49.0,-43.0,-46.0,-90.0,-91.0,-88.0,-91.0,39.0,44.0,46.0,42.0,0
1810,CC:2F:71:3F:1F:24,4414089,1168178838,595365,686541868,3818724,481636970,37,495322,558012859,494749,557943769,573,69090,477653,10,595602,47652,34,431,130000.0,43333.0,-67.0,-65.0,-71.0,-68.0,-67.0,-65.0,-70.0,-67.0,-90.0,-91.0,-88.0,-91.0,23.0,26.0,17.0,23.0,0
1811,CC:2F:71:3E:C5:1F,3819420,481721950,694,84778,3818726,481637172,0,2962,248048,2452,187424,510,60624,735,8,1025,18,0,32,144444.0,39000.0,-70.0,-71.0,-67.0,-60.0,-70.0,-71.0,-67.0,-60.0,-90.0,-91.0,-88.0,-91.0,20.0,20.0,21.0,31.0,0
1812,BA:8C:B9:54:50:24,3820463,482475734,1737,838562,3818726,481637172,0,5612,824692,5592,821570,20,3122,1004,14,2112,29,0,49,216660.0,130000.0,-49.0,-35.0,-42.0,-44.0,-42.0,-35.0,-42.0,-46.0,-90.0,-91.0,-88.0,-91.0,41.0,56.0,46.0,47.0,0
1813,92:69:1D:31:68:E9,3822214,485093962,3487,3456517,3818727,481637445,0,3648,933397,3548,911132,100,22265,1797,6,3613,78,0,31,216660.0,130000.0,-51.0,-47.0,-42.0,-49.0,-52.0,-49.0,-43.0,-46.0,-90.0,-91.0,-88.0,-91.0,39.0,44.0,46.0,42.0,0
1814,CC:2F:71:3F:1F:24,4414133,1168193617,595406,686556172,3818727,481637445,37,495351,558018223,494778,557949133,573,69090,477682,10,595643,47684,34,431,144444.0,39000.0,-67.0,-65.0,-70.0,-67.0,-67.0,-65.0,-70.0,-67.0,-90.0,-91.0,-88.0,-91.0,23.0,26.0,18.0,24.0,0
1815,CC:2F:71:3E:C5:1F,3819421,481722223,694,84778,3818727,481637445,0,2962,248048,2452,187424,510,60624,735,8,1025,18,0,32,144444.0,39000.0,-70.0,-71.0,-67.0,-60.0,-70.0,-71.0,-67.0,-60.0,-90.0,-91.0,-88.0,-91.0,20.0,20.0,21.0,31.0,0
1816,BA:8C:B9:54:50:24,3820464,482476007,1737,838562,3818727,481637445,0,5612,824692,5592,821570,20,3122,1004,14,2112,29,0,49,216660.0,130000.0,-49.0,-35.0,-42.0,-44.0,-42.0,-35.0,-42.0,-46.0,-90.0,-91.0,-88.0,-91.0,41.0,56.0,46.0,47.0,0
1817,92:69:1D:31:68:E9,3822221,485094628,3487,3456517,3818734,481638111,0,3648,933397,3548,911132,100,22265,1797,6,3613,78,0,31,216660.0,130000.0,-51.0,-47.0,-42.0,-49.0,-52.0,-49.0,-43.0,-46.0,-90.0,-91.0,-88.0,-91.0,39.0,44.0,46.0,42.0,0
1818,CC:2F:71:3F:1F:24,4414185,1168209171,595449,686570858,3818736,481638313,37,495382,558023831,494809,557954741,573,69090,477713,10,595686,47707,34,431,130000.0,43333.0,-67.0,-65.0,-71.0,-68.0,-67.0,-65.0,-70.0,-67.0,-90.0,-91.0,-88.0,-91.0,23.0,26.0,17.0,23.0,0
1819,CC:2F:71:3E:C5:1F,3819430,481723091,694,84778,3818736,481638313,0,2962,248048,2452,187424,510,60624,735,8,1025,18,0,32,144444.0,39000.0,-70.0,-71.0,-67.0,-60.0,-70.0,-71.0,-67.0,-60.0,-90.0,-91.0,-88.0,-91.0,20.0,20.0,21.0,31.0,0
1820,BA:8C:B9:54:50:24,3820473,482476875,1737,838562,3818736,481638313,0,5612,824692,5592,821570,20,3122,1004,14,2112,29,0,49,216660.0,130000.0,-49.0,-35.0,-42.0,-44.0,-42.0,-35.0,-42.0,-46.0,-90.0,-91.0,-88.0,-91.0,41.0,56.0,46.0,47.0,0
1821,92:69:1D:31:68:E9,3822223,485094830,3487,3456517,3818736,481638313,0,3648,933397,3548,911132,100,22265,1797,6,3613,78,0,31,216660.0,130000.0,-51.0,-47.0,-42.0,-49.0,-52.0,-49.0,-43.0,-46.0,-90.0,-91.0,-88.0,-91.0,39.0,44.0,46.0,42.0,0
1822,CC:2F:71:3F:1F:24,4414227,1168223717,595491,686585404,3818736,481638313,37,495411,558029171,494838,557960081,573,69090,477742,10,595728,47716,34,431,130000.0,43333.0,-67.0,-65.0,-70.0,-68.0,-67.0,-65.0,-70.0,-67.0,-90.0,-91.0,-88.0,-91.0,23.0,26.0,18.0,23.0,0
1823,CC:2F:71:3E:C5:1F,3819430,481723091,694,84778,3818736,481638313,0,2962,248048,2452,187424,510,60624,735,8,1025,18,0,32,144444.0,39000.0,-70.0,-71.0,-67.0,-60.0,-70.0,-71.0,-67.0,-60.0,-90.0,-91.0,-88.0,-91.0,20.0,20.0,21.0,31.0,0
1824,BA:8C:B9:54:50:24,3820473,482476875,1737,838562,3818736,481638313,0,5612,824692,5592,821570,20,3122,1004,14,2112,29,0,49,216660.0,130000.0,-49.0,-35.0,-42.0,-44.0,-42.0,-35.0,-42.0,-46.0,-90.0,-91.0,-88.0,-91.0,41.0,56.0,46.0,47.0,0
1825,92:69:1D:31:68:E9,3822231,485095804,3487,3456517,3818744,481639287,0,3648,933397,3548,911132,100,22265,1797,6,3613,78,0,31,216660.0,130000.0,-51.0,-47.0,-42.0,-49.0,-52.0,-49.0,-43.0,-46.0,-90.0,-93.0,-89.0,-93.0,39.0,46.0,47.0,44.0,0
1826,CC:2F:71:3F:1F:24,4414277,1168239175,595533,686599888,3818744,481639287,37,495440,558034535,494867,557965445,573,69090,477771,10,595770,47737,34,431,130000.0,39000.0,-67.0,-65.0,-71.0,-67.0,-67.0,-65.0,-70.0,-67.0,-90.0,-93.0,-89.0,-93.0,23.0,28.0,18.0,26.0,0
1827,CC:2F:71:3E:C5:1F,3819438,481724065,694,84778,3818744,481639287,0,2962,248048,2452,187424,510,60624,735,8,1025,18,0,32,144444.0,39000.0,-70.0,-71.0,-67.0,-60.0,-70.0,-71.0,-67.0,-60.0,-90.0,-93.0,-89.0,-93.0,20.0,22.0,22.0,33.0,0
1828,BA:8C:B9:54:50:24,3820483,482478051,1737,838562,3818746,481639489,0,5612,824692,5592,821570,20,3122,1004,14,2112,29,0,49,216660.0,130000.0,-49.0,-35.0,-42.0,-44.0,-42.0,-35.0,-42.0,-46.0,-90.0,-93.0,-89.0,-93.0,41.0,58.0,47.0,49.0,0
1829,92:69:1D:31:68:E9,3822234,485096066,3487,3456517,3818747,481639549,0,3648,933397,3548,911132,100,22265,1797,6,3613,78,0,31,216660.0,130000.0,-51.0,-47.0,-42.0,-49.0,-52.0,-49.0,-43.0,-46.0,-90.0,-93.0,-89.0,-93.0,39.0,46.0,47.0,44.0,0
1830,CC:2F:71:3F:1F:24,4414324,1168254063,595577,686614514,3818747,481639549,37,495471,558040155,494898,557971065,573,69090,477802,10,595814,47748,34,431,130000.0,43333.0,-67.0,-65.0,-70.0,-68.0,-67.0,-65.0,-70.0,-67.0,-90.0,-93.0,-89.0,-93.0,23.0,28.0,19.0,25.0,0
1831,CC:2F:71:3E:C5:1F,3819441,481724327,694,84778,3818747,481639549,0,2962,248048,2452,187424,510,60624,735,8,1025,18,0,32,144444.0,39000.0,-70.0,-71.0,-67.0,-60.0,-70.0,-71.0,-67.0,-60.0,-90.0,-93.0,-89.0,-93.0,20.0,22.0,22.0,33.0,0
1832,BA:8C:B9:54:50:24,3820484,482478111,1737,838562,3818747,481639549,0,5612,824692,5592,821570,20,3122,1004,14,2112,29,0,49,216660.0,130000.0,-49.0,-35.0,-42.0,-44.0,-42.0,-35.0,-42.0,-46.0,-90.0,-93.0,-89.0,-93.0,41.0,58.0,47.0,49.0,0
1833,92:69:1D:31:68:E9,3822240,485096672,3487,3456517,3818753,481640155,0,3648,933397,3548,911132,100,22265,1797,6,3613,78,0,31,216660.0,130000.0,-51.0,-47.0,-42.0,-49.0,-52.0,-49.0,-43.0,-46.0,-90.0,-93.0,-89.0,-93.0,39.0,46.0,47.0,44.0,0
1834,CC:2F:71:3F:1F:24,4414373,1168269333,595620,686629178,3818753,481640155,37,495500,558045519,494927,557976429,573,69090,477831,10,595857,47756,34,431,130000.0,43333.0,-67.0,-65.0,-70.0,-68.0,-67.0,-65.0,-70.0,-67.0,-90.0,-93.0,-89.0,-93.0,23.0,28.0,19.0,25.0,0
1835,CC:2F:71:3E:C5:1F,3819447,481724933,694,84778,3818753,481640155,0,2962,248048,2452,187424,510,60624,735,8,1025,18,0,32,144444.0,39000.0,-70.0,-71.0,-67.0,-60.0,-70.0,-71.0,-67.0,-60.0,-90.0,-93.0,-89.0,-93.0,20.0,22.0,22.0,33.0,0
1836,BA:8C:B9:54:50:24,3820492,482478919,1737,838562,3818755,481640357,0,5612,824692,5592,821570,20,3122,1004,14,2112,29,0,49,216660.0,130000.0,-49.0,-35.0,-42.0,-44.0,-42.0,-35.0,-42.0,-46.0,-90.0,-93.0,-89.0,-93.0,41.0,58.0,47.0,49.0,0
1837,92:69:1D:31:68:E9,3822242,485096874,3487,3456517,3818755,481640357,0,3648,933397,3548,911132,100,22265,1797,6,3613,78,0,31,216660.0,130000.0,-51.0,-47.0,-42.0,-49.0,-52.0,-49.0,-43.0,-46.0,-90.0,-93.0,-90.0,-93.0,39.0,46.0,48.0,44.0,0
1838,CC:2F:71:3F:1F:24,4414417,1168283963,595662,686643606,3818755,481640357,37,495530,558050999,494957,557981909,573,69090,477861,10,595899,47770,34,431,117000.0,39000.0,-67.0,-65.0,-70.0,-68.0,-67.0,-65.0,-70.0,-67.0,-90.0,-93.0,-90.0,-93.0,23.0,28.0,20.0,25.0,0
1839,CC:2F:71:3E:C5:1F,3819450,481725195,694,84778,3818756,481640417,0,2962,248048,2452,187424,510,60624,735,8,1025,18,0,32,144444.0,39000.0,-70.0,-71.0,-67.0,-60.0,-70.0,-71.0,-67.0,-60.0,-90.0,-93.0,-90.0,-93.0,20.0,22.0,23.0,33.0,0
1840,BA:8C:B9:54:50:24,3820493,482478979,1737,838562,3818756,481640417,0,5612,824692,5592,821570,20,3122,1004,14,2112,29,0,49,216660.0,130000.0,-49.0,-35.0,-42.0,-44.0,-42.0,-35.0,-42.0,-46.0,-90.0,-93.0,-90.0,-93.0,41.0,58.0,48.0,49.0,0
1841,92:69:1D:31:68:E9,3822249,485097540,3487,3456517,3818762,481641023,0,3648,933397,3548,911132,100,22265,1797,6,3613,78,0,31,216660.0,130000.0,-51.0,-47.0,-42.0,-49.0,-52.0,-49.0,-43.0,-46.0,-90.0,-93.0,-90.0,-93.0,39.0,46.0,48.0,44.0,0
1842,CC:2F:71:3F:1F:24,4414466,1168299057,595704,686658034,3818762,481641023,37,495561,558056619,494988,557987529,573,69090,477892,10,595941,47776,34,431,130000.0,39000.0,-67.0,-65.0,-70.0,-67.0,-67.0,-65.0,-70.0,-67.0,-90.0,-93.0,-90.0,-93.0,23.0,28.0,20.0,26.0,0
1843,CC:2F:71:3E:C5:1F,3819458,481726003,694,84778,3818764,481641225,0,2962,248048,2452,187424,510,60624,735,8,1025,18,0,32,144444.0,39000.0,-70.0,-71.0,-67.0,-60.0,-70.0,-71.0,-67.0,-60.0,-90.0,-93.0,-90.0,-93.0,20.0,22.0,23.0,33.0,0
1844,BA:8C:B9:54:50:24,3820501,482479787,1737,838562,3818764,481641225,0,5612,824692,5592,821570,20,3122,1004,14,2112,29,0,49,216660.0,130000.0,-49.0,-35.0,-42.0,-44.0,-42.0,-35.0,-42.0,-46.0,-90.0,-93.0,-90.0,-93.0,41.0,58.0,48.0,49.0,0
1845,92:69:1D:31:68:E9,3822251,485097742,3487,3456517,3818764,481641225,0,3648,933397,3548,911132,100,22265,1797,6,3613,78,0,31,216660.0,130000.0,-51.0,-47.0,-42.0,-49.0,-52.0,-49.0,-43.0,-46.0,-90.0,-93.0,-90.0,-93.0,39.0,46.0,48.0,44.0,0
1846,CC:2F:71:3F:1F:24,4414510,1168313687,595746,686672462,3818764,481641225,37,495590,558062019,495017,557992929,573,69090,477921,10,595983,47799,34,431,130000.0,39000.0,-67.0,-65.0,-70.0,-68.0,-67.0,-65.0,-70.0,-67.0,-90.0,-93.0,-90.0,-93.0,23.0,28.0,20.0,25.0,0
1847,CC:2F:71:3E:C5:1F,3819458,481726003,694,84778,3818764,481641225,0,2962,248048,2452,187424,510,60624,735,8,1025,18,0,32,144444.0,39000.0,-70.0,-71.0,-67.0,-60.0,-70.0,-71.0,-67.0,-60.0,-90.0,-93.0,-90.0,-93.0,20.0,22.0,23.0,33.0,0
1848,BA:8C:B9:54:50:24,3820501,482479787,1737,838562,3818764,481641225,0,5612,824692,5592,821570,20,3122,1004,14,2112,29,0,49,216660.0,130000.0,-49.0,-35.0,-42.0,-44.0,-42.0,-35.0,-42.0,-46.0,-90.0,-93.0,-90.0,-93.0,41.0,58.0,48.0,49.0,0
1849,92:69:1D:31:68:E9,3822260,485099532,3487,3456517,3818773,481643015,0,3648,933397,3548,911132,100,22265,1797,6,3613,78,0,31,216660.0,130000.0,-51.0,-47.0,-42.0,-49.0,-52.0,-49.0,-43.0,-46.0,-90.0,-93.0,-90.0,-93.0,39.0,46.0,48.0,44.0,0
1850,CC:2F:71:3F:1F:24,4414564,1168330177,595791,686687162,3818773,481643015,37,495621,558067615,495048,557998525,573,69090,477952,10,596028,47817,34,431,117000.0,39000.0,-67.0,-65.0,-70.0,-67.0,-67.0,-65.0,-70.0,-67.0,-90.0,-93.0,-90.0,-93.0,23.0,28.0,20.0,26.0,0
1851,CC:2F:71:3E:C5:1F,3819467,481727793,694,84778,3818773,481643015,0,2962,248048,2452,187424,510,60624,735,8,1025,18,0,32,144444.0,39000.0,-70.0,-71.0,-67.0,-60.0,-70.0,-71.0,-67.0,-60.0,-90.0,-93.0,-90.0,-93.0,20.0,22.0,23.0,33.0,0
1852,BA:8C:B9:54:50:24,3820512,482481779,1737,838562,3818775,481643217,0,5612,824692,5592,821570,20,3122,1004,14,2112,29,0,49,216660.0,130000.0,-49.0,-35.0,-42.0,-44.0,-42.0,-35.0,-42.0,-46.0,-90.0,-93.0,-90.0,-93.0,41.0,58.0,48.0,49.0,0
1853,92:69:1D:31:68:E9,3822262,485099734,3487,3456517,3818775,481643217,0,3648,933397,3548,911132,100,22265,1797,6,3613,78,0,31,216660.0,130000.0,-51.0,-47.0,-42.0,-49.0,-52.0,-49.0,-43.0,-46.0,-90.0,-93.0,-90.0,-93.0,39.0,46.0,48.0,44.0,0
1854,CC:2F:71:3F:1F:24,4414610,1168345067,595835,686701850,3818775,481643217,37,495650,558072979,495077,558003889,573,69090,477981,10,596072,47823,34,431,130000.0,43333.0,-67.0,-65.0,-70.0,-67.0,-67.0,-65.0,-70.0,-67.0,-90.0,-93.0,-90.0,-93.0,23.0,28.0,20.0,26.0,0
1855,CC:2F:71:3E:C5:1F,3819469,481727995,694,84778,3818775,481643217,0,2962,248048,2452,187424,510,60624,735,8,1025,18,0,32,144444.0,39000.0,-70.0,-71.0,-67.0,-60.0,-70.0,-71.0,-67.0,-60.0,-90.0,-93.0,-90.0,-93.0,20.0,22.0,23.0,33.0,0
1856,BA:8C:B9:54:50:24,3820512,482481779,1737,838562,3818775,481643217,0,5612,824692,5592,821570,20,3122,1004,14,2112,29,0,49,216660.0,130000.0,-49.0,-35.0,-42.0,-44.0,-42.0,-35.0,-42.0,-46.0,-90.0,-93.0,-90.0,-93.0,41.0,58.0,48.0,49.0,0
1857,92:69:1D:31:68:E9,3822270,485101464,3487,3456517,3818783,481644947,0,3648,933397,3548,911132,100,22265,1797,6,3613,78,0,31,216660.0,130000.0,-51.0,-47.0,-42.0,-49.0,-52.0,-49.0,-43.0,-46.0,-90.0,-93.0,-90.0,-93.0,39.0,46.0,48.0,44.0,0
1858,CC:2F:71:3F:1F:24,4414661,1168361477,595878,686716530,3818783,481644947,37,495681,558078587,495108,558009497,573,69090,478012,10,596115,47848,34,431,117000.0,39000.0,-67.0,-65.0,-70.0,-67.0,-67.0,-65.0,-70.0,-67.0,-90.0,-93.0,-90.0,-93.0,23.0,28.0,20.0,26.0,0
1859,CC:2F:71:3E:C5:1F,3819477,481729725,694,84778,3818783,481644947,0,2962,248048,2452,187424,510,60624,735,8,1025,18,0,32,144444.0,39000.0,-70.0,-71.0,-67.0,-60.0,-70.0,-71.0,-67.0,-60.0,-90.0,-93.0,-90.0,-93.0,20.0,22.0,23.0,33.0,0
1860,BA:8C:B9:54:50:24,3820520,482483509,1737,838562,3818783,481644947,0,5612,824692,5592,821570,20,3122,1004,14,2112,29,0,49,216660.0,130000.0,-49.0,-35.0,-42.0,-44.0,-42.0,-35.0,-42.0,-46.0,-90.0,-93.0,-90.0,-93.0,41.0,58.0,48.0,49.0,0
1861,92:69:1D:31:68:E9,3822273,485101726,3487,3456517,3818786,481645209,0,3648,933397,3548,911132,100,22265,1797,6,3613,78,0,31,216660.0,130000.0,-51.0,-47.0,-42.0,-49.0,-52.0,-49.0,-43.0,-46.0,-91.0,-94.0,-90.0,-94.0,40.0,47.0,48.0,45.0,0
1862,CC:2F:71:3F:1F:24,4414708,1168376407,595922,686731198,3818786,481645209,37,495711,558084103,495138,558015013,573,69090,478042,10,596159,47850,34,431,130000.0,43333.0,-67.0,-65.0,-71.0,-68.0,-67.0,-65.0,-70.0,-67.0,-91.0,-94.0,-90.0,-94.0,24.0,29.0,19.0,26.0,0
1863,CC:2F:71:3E:C5:1F,3819481,481730103,695,84894,3818786,481645209,0,2963,248118,2453,187494,510,60624,735,8,1026,18,0,32,144444.0,39000.0,-70.0,-71.0,-67.0,-60.0,-70.0,-71.0,-67.0,-60.0,-91.0,-94.0,-90.0,-94.0,21.0,23.0,23.0,34.0,0
1864,BA:8C:B9:54:50:24,3820523,482483771,1737,838562,3818786,481645209,0,5612,824692,5592,821570,20,3122,1004,14,2112,29,0,49,216660.0,130000.0,-49.0,-35.0,-42.0,-44.0,-42.0,-35.0,-42.0,-46.0,-91.0,-94.0,-90.0,-94.0,42.0,59.0,48.0,50.0,0
1865,92:69:1D:31:68:E9,3822283,485103845,3488,3456633,3818795,481647212,0,3650,933533,3550,911268,100,22265,1797,6,3614,78,0,31,216660.0,130000.0,-52.0,-49.0,-44.0,-46.0,-52.0,-49.0,-43.0,-46.0,-91.0,-94.0,-90.0,-94.0,39.0,45.0,46.0,48.0,0
1866,CC:2F:71:3F:1F:24,4414760,1168393080,595965,686745868,3818795,481647212,37,495741,558089559,495168,558020469,573,69090,478072,10,596202,47855,34,431,130000.0,43333.0,-67.0,-65.0,-70.0,-68.0,-67.0,-65.0,-70.0,-67.0,-91.0,-94.0,-90.0,-94.0,24.0,29.0,20.0,26.0,0
1867,CC:2F:71:3E:C5:1F,3819490,481732106,695,84894,3818795,481647212,0,2964,248188,2454,187564,510,60624,735,8,1026,18,0,32,144444.0,39000.0,-70.0,-71.0,-67.0,-60.0,-70.0,-71.0,-67.0,-60.0,-91.0,-94.0,-90.0,-94.0,21.0,23.0,23.0,34.0,0
1868,BA:8C:B9:54:50:24,3820534,482485952,1738,838678,3818796,481647274,0,5614,824828,5594,821706,20,3122,1004,14,2113,29,0,49,216660.0,130000.0,-49.0,-35.0,-42.0,-44.0,-43.0,-34.0,-42.0,-45.0,-91.0,-94.0,-90.0,-94.0,42.0,59.0,48.0,50.0,0
1869,92:69:1D:31:68:E9,3822287,485104169,3488,3456633,3818799,481647536,0,3650,933533,3550,911268,100,22265,1797,6,3614,78,0,31,216660.0,130000.0,-52.0,-49.0,-44.0,-46.0,-52.0,-49.0,-43.0,-46.0,-91.0,-94.0,-90.0,-94.0,39.0,45.0,46.0,48.0,0
1870,CC:2F:71:3F:1F:24,4414807,1168407968,596008,686760432,3818799,481647536,37,495770,558094923,495197,558025833,573,69090,478101,10,596245,47877,34,431,117000.0,39000.0,-67.0,-65.0,-71.0,-68.0,-67.0,-65.0,-70.0,-67.0,-91.0,-94.0,-90.0,-94.0,24.0,29.0,19.0,26.0,0
1871,CC:2F:71:3E:C5:1F,3819494,481732430,695,84894,3818799,481647536,0,2966,248376,2455,187634,511,60742,736,8,1026,18,0,32,144444.0,39000.0,-70.0,-71.0,-67.0,-60.0,-70.0,-71.0,-67.0,-60.0,-91.0,-94.0,-90.0,-94.0,21.0,23.0,23.0,34.0,0
1872,BA:8C:B9:54:50:24,3820537,482486214,1738,838678,3818799,481647536,0,5615,824896,5595,821774,20,3122,1004,14,2113,29,0,49,216660.0,130000.0,-39.0,-37.0,-45.0,-51.0,-42.0,-35.0,-42.0,-46.0,-91.0,-94.0,-90.0,-94.0,52.0,57.0,45.0,43.0,0
1873,92:69:1D:31:68:E9,3822293,485104775,3488,3456633,3818805,481648142,0,3650,933533,3550,911268,100,22265,1797,6,3614,78,0,31,216660.0,130000.0,-52.0,-49.0,-44.0,-46.0,-52.0,-49.0,-43.0,-46.0,-91.0,-94.0,-90.0,-93.0,39.0,45.0,46.0,47.0,0
1874,CC:2F:71:3F:1F:24,4414856,1168423076,596051,686774934,3818805,481648142,37,495801,558100519,495228,558031429,573,69090,478132,10,596288,47888,34,431,130000.0,39000.0,-67.0,-65.0,-70.0,-67.0,-67.0,-65.0,-70.0,-67.0,-91.0,-94.0,-90.0,-93.0,24.0,29.0,20.0,26.0,0
1875,CC:2F:71:3E:C5:1F,3819500,481733036,695,84894,3818805,481648142,0,2966,248376,2455,187634,511,60742,736,8,1026,18,0,32,144444.0,39000.0,-70.0,-71.0,-67.0,-60.0,-70.0,-71.0,-67.0,-60.0,-91.0,-94.0,-90.0,-93.0,21.0,23.0,23.0,33.0,0
1876,BA:8C:B9:54:50:24,3820543,482486820,1738,838678,3818805,481648142,0,5615,824896,5595,821774,20,3122,1004,14,2113,29,0,49,216660.0,130000.0,-39.0,-37.0,-45.0,-51.0,-42.0,-35.0,-42.0,-46.0,-91.0,-94.0,-90.0,-93.0,52.0,57.0,45.0,42.0,0
1877,92:69:1D:31:68:E9,3822295,485104977,3488,3456633,3818807,481648344,0,3650,933533,3550,911268,100,22265,1797,6,3614,78,0,31,216660.0,130000.0,-52.0,-49.0,-44.0,-46.0,-52.0,-49.0,-43.0,-46.0,-91.0,-94.0,-90.0,-93.0,39.0,45.0,46.0,47.0,0
1878,CC:2F:71:3F:1F:24,4414901,1168437958,596094,686789614,3818807,481648344,37,495831,558106011,495258,558036921,573,69090,478162,10,596331,47925,34,431,144444.0,43333.0,-67.0,-65.0,-71.0,-68.0,-67.0,-65.0,-70.0,-67.0,-91.0,-94.0,-90.0,-93.0,24.0,29.0,19.0,25.0,0
1879,CC:2F:71:3E:C5:1F,3819502,481733238,695,84894,3818807,481648344,0,2966,248376,2455,187634,511,60742,736,8,1026,18,0,32,144444.0,39000.0,-70.0,-71.0,-67.0,-60.0,-70.0,-71.0,-67.0,-60.0,-91.0,-94.0,-90.0,-93.0,21.0,23.0,23.0,33.0,0
1880,BA:8C:B9:54:50:24,3820545,482487022,1738,838678,3818807,481648344,0,5615,824896,5595,821774,20,3122,1004,14,2113,29,0,49,216660.0,130000.0,-39.0,-37.0,-45.0,-51.0,-42.0,-35.0,-42.0,-46.0,-91.0,-94.0,-90.0,-93.0,52.0,57.0,45.0,42.0,0
1881,92:69:1D:31:68:E9,3822302,485105643,3488,3456633,3818814,481649010,0,3650,933533,3550,911268,100,22265,1797,6,3614,78,0,31,216660.0,130000.0,-52.0,-49.0,-44.0,-46.0,-52.0,-49.0,-43.0,-46.0,-91.0,-94.0,-90.0,-93.0,39.0,45.0,46.0,47.0,0
1882,CC:2F:71:3F:1F:24,4414952,1168453362,596138,686804352,3818814,481649010,37,495860,558111411,495287,558042321,573,69090,478191,10,596375,47952,34,431,130000.0,43333.0,-67.0,-65.0,-70.0,-67.0,-67.0,-65.0,-70.0,-67.0,-91.0,-94.0,-90.0,-93.0,24.0,29.0,20.0,26.0,0
1883,CC:2F:71:3E:C5:1F,3819509,481733904,695,84894,3818814,481649010,0,2966,248376,2455,187634,511,60742,736,8,1026,18,0,32,144444.0,39000.0,-70.0,-71.0,-67.0,-60.0,-70.0,-71.0,-67.0,-60.0,-91.0,-94.0,-90.0,-93.0,21.0,23.0,23.0,33.0,0
1884,BA:8C:B9:54:50:24,3820552,482487688,1738,838678,3818814,481649010,0,5615,824896,5595,821774,20,3122,1004,14,2113,29,0,49,216660.0,130000.0,-39.0,-37.0,-45.0,-51.0,-42.0,-35.0,-42.0,-46.0,-91.0,-94.0,-90.0,-93.0,52.0,57.0,45.0,42.0,0
1885,92:69:1D:31:68:E9,3822304,485105845,3488,3456633,3818816,481649212,0,3650,933533,3550,911268,100,22265,1797,6,3614,78,0,31,216660.0,130000.0,-52.0,-49.0,-44.0,-46.0,-52.0,-49.0,-43.0,-46.0,-91.0,-94.0,-90.0,-93.0,39.0,45.0,46.0,47.0,0
1886,CC:2F:71:3F:1F:24,4414998,1168468358,596182,686819146,3818816,481649212,37,495889,558116811,495316,558047721,573,69090,478220,10,596419,47960,34,431,130000.0,43333.0,-67.0,-65.0,-70.0,-68.0,-67.0,-65.0,-70.0,-67.0,-91.0,-94.0,-90.0,-93.0,24.0,29.0,20.0,25.0,0
1887,CC:2F:71:3E:C5:1F,3819511,481734106,695,84894,3818816,481649212,0,2966,248376,2455,187634,511,60742,736,8,1026,18,0,32,144444.0,39000.0,-70.0,-71.0,-67.0,-60.0,-70.0,-71.0,-67.0,-60.0,-91.0,-94.0,-90.0,-93.0,21.0,23.0,23.0,33.0,0
1888,BA:8C:B9:54:50:24,3820554,482487890,1738,838678,3818816,481649212,0,5615,824896,5595,821774,20,3122,1004,14,2113,29,0,49,216660.0,130000.0,-39.0,-37.0,-45.0,-51.0,-42.0,-35.0,-42.0,-46.0,-91.0,-94.0,-90.0,-93.0,52.0,57.0,45.0,42.0,0
1889,92:69:1D:31:68:E9,3822310,485106451,3488,3456633,3818822,481649818,0,3650,933533,3550,911268,100,22265,1797,6,3614,78,0,31,216660.0,130000.0,-52.0,-49.0,-44.0,-46.0,-52.0,-49.0,-43.0,-46.0,-91.0,-94.0,-90.0,-93.0,39.0,45.0,46.0,47.0,0
1890,CC:2F:71:3F:1F:24,4415047,1168483516,596225,686833698,3818822,481649818,37,495918,558122175,495345,558053085,573,69090,478249,10,596462,47985,34,431,117000.0,39000.0,-67.0,-65.0,-70.0,-67.0,-67.0,-65.0,-70.0,-67.0,-91.0,-94.0,-90.0,-93.0,24.0,29.0,20.0,26.0,0
1891,CC:2F:71:3E:C5:1F,3819518,481734772,695,84894,3818823,481649878,0,2966,248376,2455,187634,511,60742,736,8,1026,18,0,32,144444.0,39000.0,-70.0,-71.0,-67.0,-60.0,-70.0,-71.0,-67.0,-60.0,-91.0,-94.0,-90.0,-93.0,21.0,23.0,23.0,33.0,0
1892,BA:8C:B9:54:50:24,3820561,482488556,1738,838678,3818823,481649878,0,5615,824896,5595,821774,20,3122,1004,14,2113,29,0,49,216660.0,130000.0,-39.0,-37.0,-45.0,-51.0,-42.0,-35.0,-42.0,-46.0,-91.0,-94.0,-90.0,-93.0,52.0,57.0,45.0,42.0,0
1893,92:69:1D:31:68:E9,3822313,485106713,3488,3456633,3818825,481650080,0,3650,933533,3550,911268,100,22265,1797,6,3614,78,0,31,216660.0,130000.0,-52.0,-49.0,-44.0,-46.0,-52.0,-49.0,-43.0,-46.0,-91.0,-94.0,-90.0,-93.0,39.0,45.0,46.0,47.0,0
1894,CC:2F:71:3F:1F:24,4415093,1168498330,596268,686848250,3818825,481650080,37,495948,558127679,495375,558058589,573,69090,478279,10,596505,47989,34,431,130000.0,43333.0,-67.0,-65.0,-70.0,-67.0,-67.0,-65.0,-70.0,-67.0,-91.0,-94.0,-90.0,-93.0,24.0,29.0,20.0,26.0,0
1895,CC:2F:71:3E:C5:1F,3819520,481734974,695,84894,3818825,481650080,0,2966,248376,2455,187634,511,60742,736,8,1026,18,0,32,144444.0,39000.0,-70.0,-71.0,-67.0,-60.0,-70.0,-71.0,-67.0,-60.0,-91.0,-94.0,-90.0,-93.0,21.0,23.0,23.0,33.0,0
1896,BA:8C:B9:54:50:24,3820565,482488960,1738,838678,3818827,481650282,0,5615,824896,5595,821774,20,3122,1004,14,2113,29,0,49,216660.0,130000.0,-39.0,-37.0,-45.0,-51.0,-42.0,-35.0,-42.0,-46.0,-91.0,-94.0,-90.0,-93.0,52.0,57.0,45.0,42.0,0
1897,92:69:1D:31:68:E9,3822319,485107319,3488,3456633,3818831,481650686,0,3650,933533,3550,911268,100,22265,1797,6,3614,78,0,31,216660.0,130000.0,-52.0,-49.0,-44.0,-46.0,-52.0,-49.0,-43.0,-46.0,-91.0,-94.0,-90.0,-93.0,39.0,45.0,46.0,47.0,0
1898,CC:2F:71:3F:1F:24,4415143,1168513736,596312,686863050,3818831,481650686,37,495978,558133223,495405,558064133,573,69090,478309,10,596549,47993,34,431,130000.0,43333.0,-67.0,-65.0,-70.0,-67.0,-67.0,-65.0,-70.0,-67.0,-91.0,-94.0,-90.0,-93.0,24.0,29.0,20.0,26.0,0
1899,CC:2F:71:3E:C5:1F,3819526,481735580,695,84894,3818831,481650686,0,2966,248376,2455,187634,511,60742,736,8,1026,18,0,32,144444.0,39000.0,-70.0,-71.0,-67.0,-60.0,-70.0,-71.0,-67.0,-60.0,-90.0,-93.0,-90.0,-93.0,20.0,22.0,23.0,33.0,0
1900,BA:8C:B9:54:50:24,3820569,482489364,1738,838678,3818831,481650686,0,5615,824896,5595,821774,20,3122,1004,14,2113,29,0,49,216660.0,130000.0,-39.0,-37.0,-45.0,-51.0,-42.0,-35.0,-42.0,-46.0,-90.0,-93.0,-90.0,-93.0,51.0,56.0,45.0,42.0,0
1901,92:69:1D:31:68:E9,3822323,485107707,3488,3456633,3818835,481651074,0,3650,933533,3550,911268,100,22265,1797,6,3614,78,0,31,216660.0,130000.0,-52.0,-49.0,-44.0,-46.0,-52.0,-49.0,-43.0,-46.0,-90.0,-93.0,-90.0,-93.0,38.0,44.0,46.0,47.0,0
1902,CC:2F:71:3F:1F:24,4415192,1168528886,596357,686877812,3818835,481651074,37,496010,558139087,495437,558069997,573,69090,478341,10,596594,48012,34,431,130000.0,39000.0,-67.0,-65.0,-70.0,-67.0,-67.0,-65.0,-70.0,-67.0,-90.0,-93.0,-90.0,-93.0,23.0,28.0,20.0,26.0,0
1903,CC:2F:71:3E:C5:1F,3819530,481735968,695,84894,3818835,481651074,0,2966,248376,2455,187634,511,60742,736,8,1026,18,0,32,144444.0,39000.0,-70.0,-71.0,-67.0,-60.0,-70.0,-71.0,-67.0,-60.0,-90.0,-93.0,-90.0,-93.0,20.0,22.0,23.0,33.0,0
1904,BA:8C:B9:54:50:24,3820575,482489954,1738,838678,3818837,481651276,0,5615,824896,5595,821774,20,3122,1004,14,2113,29,0,49,216660.0,130000.0,-39.0,-37.0,-45.0,-51.0,-42.0,-35.0,-42.0,-46.0,-90.0,-93.0,-90.0,-93.0,51.0,56.0,45.0,42.0,0
1905,92:69:1D:31:68:E9,3822329,485108313,3488,3456633,3818841,481651680,0,3650,933533,3550,911268,100,22265,1797,6,3614,78,0,31,216660.0,130000.0,-52.0,-49.0,-44.0,-46.0,-52.0,-49.0,-43.0,-46.0,-90.0,-93.0,-90.0,-93.0,38.0,44.0,46.0,47.0,0
1906,CC:2F:71:3F:1F:24,4415241,1168544106,596400,686892426,3818841,481651680,37,496041,558144683,495468,558075593,573,69090,478372,10,596637,48021,34,431,130000.0,43333.0,-67.0,-65.0,-70.0,-67.0,-67.0,-65.0,-70.0,-67.0,-90.0,-93.0,-90.0,-93.0,23.0,28.0,20.0,26.0,0
1907,CC:2F:71:3E:C5:1F,3819536,481736574,695,84894,3818841,481651680,0,2966,248376,2455,187634,511,60742,736,8,1026,18,0,32,144444.0,39000.0,-70.0,-71.0,-67.0,-60.0,-70.0,-71.0,-67.0,-60.0,-90.0,-93.0,-90.0,-93.0,20.0,22.0,23.0,33.0,0
1908,BA:8C:B9:54:50:24,3820579,482490358,1738,838678,3818841,481651680,0,5615,824896,5595,821774,20,3122,1004,14,2113,29,0,49,216660.0,130000.0,-39.0,-37.0,-45.0,-51.0,-42.0,-35.0,-42.0,-46.0,-90.0,-93.0,-90.0,-93.0,51.0,56.0,45.0,42.0,0
1909,92:69:1D:31:68:E9,3822332,485108577,3488,3456633,3818844,481651944,0,3650,933533,3550,911268,100,22265,1797,6,3614,78,0,31,216660.0,130000.0,-52.0,-49.0,-44.0,-46.0,-52.0,-49.0,-43.0,-46.0,-90.0,-93.0,-90.0,-93.0,38.0,44.0,46.0,47.0,0
1910,CC:2F:71:3F:1F:24,4415286,1168558742,596442,686906798,3818844,481651944,37,496072,558150257,495498,558081049,574,69208,478403,10,596679,48038,34,431,130000.0,39000.0,-67.0,-65.0,-70.0,-68.0,-67.0,-65.0,-70.0,-67.0,-90.0,-93.0,-90.0,-93.0,23.0,28.0,20.0,25.0,0
1911,CC:2F:71:3E:C5:1F,3819541,481737040,695,84894,3818846,481652146,0,2966,248376,2455,187634,511,60742,736,8,1026,18,0,32,144444.0,39000.0,-70.0,-71.0,-67.0,-60.0,-70.0,-71.0,-67.0,-60.0,-90.0,-93.0,-90.0,-93.0,20.0,22.0,23.0,33.0,0
1912,BA:8C:B9:54:50:24,3820584,482490824,1738,838678,3818846,481652146,0,5615,824896,5595,821774,20,3122,1004,14,2113,29,0,49,216660.0,130000.0,-39.0,-37.0,-45.0,-51.0,-42.0,-35.0,-42.0,-46.0,-90.0,-93.0,-90.0,-93.0,51.0,56.0,45.0,42.0,0
1913,92:69:1D:31:68:E9,3822339,485109243,3488,3456633,3818851,481652610,0,3650,933533,3550,911268,100,22265,1797,6,3614,78,0,31,216660.0,130000.0,-52.0,-49.0,-44.0,-46.0,-52.0,-49.0,-43.0,-46.0,-90.0,-93.0,-90.0,-93.0,38.0,44.0,46.0,47.0,0
1914,CC:2F:71:3F:1F:24,4415336,1168573966,596485,686921356,3818851,481652610,37,496098,558155201,495524,558085993,574,69208,478429,10,596722,48046,34,431,130000.0,39000.0,-67.0,-65.0,-70.0,-67.0,-67.0,-65.0,-70.0,-67.0,-90.0,-93.0,-90.0,-93.0,23.0,28.0,20.0,26.0,0
1915,CC:2F:71:3E:C5:1F,3819546,481737504,695,84894,3818851,481652610,0,2966,248376,2455,187634,511,60742,736,8,1026,18,0,32,144444.0,39000.0,-70.0,-71.0,-67.0,-60.0,-70.0,-71.0,-67.0,-60.0,-90.0,-93.0,-90.0,-93.0,20.0,22.0,23.0,33.0,0
1916,BA:8C:B9:54:50:24,3820589,482491288,1738,838678,3818851,481652610,0,5615,824896,5595,821774,20,3122,1004,14,2113,29,0,49,216660.0,130000.0,-39.0,-37.0,-45.0,-51.0,-42.0,-35.0,-42.0,-46.0,-90.0,-93.0,-90.0,-93.0,51.0,56.0,45.0,42.0,0
1917,92:69:1D:31:68:E9,3822342,485109718,3488,3456633,3818854,481653085,0,3650,933533,3550,911268,100,22265,1797,6,3614,78,0,31,216660.0,130000.0,-52.0,-49.0,-44.0,-46.0,-52.0,-49.0,-43.0,-46.0,-90.0,-93.0,-90.0,-93.0,38.0,44.0,46.0,47.0,0
1918,CC:2F:71:3F:1F:24,4415382,1168588993,596528,686935908,3818854,481653085,37,496124,558160145,495550,558090937,574,69208,478455,10,596765,48066,34,431,130000.0,39000.0,-67.0,-65.0,-70.0,-67.0,-67.0,-65.0,-70.0,-67.0,-90.0,-93.0,-90.0,-93.0,23.0,28.0,20.0,26.0,0
1919,CC:2F:71:3E:C5:1F,3819551,481738181,695,84894,3818856,481653287,0,2966,248376,2455,187634,511,60742,736,8,1026,18,0,32,144444.0,39000.0,-70.0,-71.0,-67.0,-60.0,-70.0,-71.0,-67.0,-60.0,-90.0,-93.0,-90.0,-93.0,20.0,22.0,23.0,33.0,0
1920,BA:8C:B9:54:50:24,3820594,482491965,1738,838678,3818856,481653287,0,5615,824896,5595,821774,20,3122,1004,14,2113,29,0,49,216660.0,130000.0,-39.0,-37.0,-45.0,-51.0,-42.0,-35.0,-42.0,-46.0,-90.0,-93.0,-90.0,-93.0,51.0,56.0,45.0,42.0,0
1921,92:69:1D:31:68:E9,3822349,485110384,3488,3456633,3818861,481653751,0,3650,933533,3550,911268,100,22265,1797,6,3614,78,0,31,216660.0,130000.0,-52.0,-49.0,-44.0,-46.0,-52.0,-49.0,-43.0,-46.0,-90.0,-93.0,-90.0,-93.0,38.0,44.0,46.0,47.0,0
1922,CC:2F:71:3F:1F:24,4415431,1168603981,596570,686950230,3818861,481653751,37,496150,558165089,495576,558095881,574,69208,478481,10,596807,48074,34,431,130000.0,39000.0,-67.0,-65.0,-70.0,-68.0,-67.0,-65.0,-70.0,-67.0,-90.0,-93.0,-90.0,-93.0,23.0,28.0,20.0,25.0,0
1923,CC:2F:71:3E:C5:1F,3819556,481738645,695,84894,3818861,481653751,0,2966,248376,2455,187634,511,60742,736,8,1026,18,0,32,144444.0,39000.0,-70.0,-71.0,-67.0,-60.0,-70.0,-71.0,-67.0,-60.0,-90.0,-93.0,-90.0,-93.0,20.0,22.0,23.0,33.0,0
1924,BA:8C:B9:54:50:24,3820599,482492429,1738,838678,3818861,481653751,0,5615,824896,5595,821774,20,3122,1004,14,2113,29,0,49,216660.0,130000.0,-39.0,-37.0,-45.0,-51.0,-42.0,-35.0,-42.0,-46.0,-90.0,-93.0,-90.0,-93.0,51.0,56.0,45.0,42.0,0
1925,92:69:1D:31:68:E9,3822351,485110586,3488,3456633,3818863,481653953,0,3650,933533,3550,911268,100,22265,1797,6,3614,78,0,31,216660.0,130000.0,-52.0,-49.0,-44.0,-46.0,-52.0,-49.0,-43.0,-46.0,-90.0,-93.0,-90.0,-93.0,38.0,44.0,46.0,47.0,0
1926,CC:2F:71:3F:1F:24,4415476,1168618627,596611,686964472,3818865,481654155,37,496176,558170033,495602,558100825,574,69208,478507,10,596848,48094,34,431,117000.0,39000.0,-67.0,-65.0,-70.0,-68.0,-67.0,-65.0,-70.0,-67.0,-90.0,-93.0,-90.0,-93.0,23.0,28.0,20.0,25.0,0
1927,CC:2F:71:3E:C5:1F,3819560,481739049,695,84894,3818865,481654155,0,2966,248376,2455,187634,511,60742,736,8,1026,18,0,32,144444.0,39000.0,-70.0,-71.0,-67.0,-60.0,-70.0,-71.0,-67.0,-60.0,-90.0,-93.0,-90.0,-93.0,20.0,22.0,23.0,33.0,0
1928,BA:8C:B9:54:50:24,3820603,482492833,1738,838678,3818865,481654155,0,5615,824896,5595,821774,20,3122,1004,14,2113,29,0,49,216660.0,130000.0,-39.0,-37.0,-45.0,-51.0,-42.0,-35.0,-42.0,-46.0,-90.0,-93.0,-90.0,-93.0,51.0,56.0,45.0,42.0,0
1929,92:69:1D:31:68:E9,3822357,485111192,3488,3456633,3818869,481654559,0,3650,933533,3550,911268,100,22265,1797,6,3614,78,0,31,216660.0,130000.0,-52.0,-49.0,-44.0,-46.0,-52.0,-49.0,-43.0,-46.0,-90.0,-93.0,-90.0,-93.0,38.0,44.0,46.0,47.0,0
1930,CC:2F:71:3F:1F:24,4415522,1168633459,596653,686978900,3818869,481654559,37,496203,558175153,495629,558105945,574,69208,478534,10,596890,48107,34,431,130000.0,43333.0,-67.0,-65.0,-71.0,-68.0,-67.0,-65.0,-70.0,-67.0,-90.0,-93.0,-90.0,-93.0,23.0,28.0,19.0,25.0,0
1931,CC:2F:71:3E:C5:1F,3819564,481739453,695,84894,3818869,481654559,0,2966,248376,2455,187634,511,60742,736,8,1026,18,0,32,144444.0,39000.0,-70.0,-71.0,-67.0,-60.0,-70.0,-71.0,-67.0,-60.0,-90.0,-93.0,-90.0,-93.0,20.0,22.0,23.0,33.0,0
1932,BA:8C:B9:54:50:24,3820607,482493237,1738,838678,3818869,481654559,0,5615,824896,5595,821774,20,3122,1004,14,2113,29,0,49,216660.0,130000.0,-39.0,-37.0,-45.0,-51.0,-42.0,-35.0,-42.0,-46.0,-90.0,-93.0,-90.0,-93.0,51.0,56.0,45.0,42.0,0
1933,92:69:1D:31:68:E9,3822360,485111454,3488,3456633,3818872,481654821,0,3650,933533,3550,911268,100,22265,1797,6,3614,78,0,31,216660.0,130000.0,-52.0,-49.0,-44.0,-46.0,-52.0,-49.0,-43.0,-46.0,-90.0,-93.0,-90.0,-93.0,38.0,44.0,46.0,47.0,0
1934,CC:2F:71:3F:1F:24,4415568,1168648339,596694,686993316,3818874,481655023,37,496233,558180633,495659,558111425,574,69208,478564,10,596931,48116,34,431,130000.0,43333.0,-67.0,-65.0,-70.0,-67.0,-67.0,-65.0,-70.0,-67.0,-90.0,-93.0,-90.0,-93.0,23.0,28.0,20.0,26.0,0
1935,CC:2F:71:3E:C5:1F,3819569,481739917,695,84894,3818874,481655023,0,2966,248376,2455,187634,511,60742,736,8,1026,18,0,32,144444.0,39000.0,-70.0,-71.0,-67.0,-60.0,-70.0,-71.0,-67.0,-60.0,-90.0,-93.0,-90.0,-93.0,20.0,22.0,23.0,33.0,0
1936,BA:8C:B9:54:50:24,3820612,482493701,1738,838678,3818874,481655023,0,5615,824896,5595,821774,20,3122,1004,14,2113,29,0,49,216660.0,130000.0,-39.0,-37.0,-45.0,-51.0,-42.0,-35.0,-42.0,-46.0,-90.0,-93.0,-90.0,-93.0,51.0,56.0,45.0,42.0,0
1937,92:69:1D:31:68:E9,3822366,485112060,3488,3456633,3818878,481655427,0,3650,933533,3550,911268,100,22265,1797,6,3614,78,0,31,216660.0,130000.0,-52.0,-49.0,-44.0,-46.0,-52.0,-49.0,-43.0,-46.0,-90.0,-93.0,-90.0,-93.0,38.0,44.0,46.0,47.0,0
1938,CC:2F:71:3F:1F:24,4415617,1168663437,596739,687008010,3818878,481655427,37,496263,558186113,495689,558116905,574,69208,478594,10,596976,48154,34,431,130000.0,43333.0,-67.0,-65.0,-70.0,-67.0,-67.0,-65.0,-70.0,-67.0,-90.0,-93.0,-90.0,-93.0,23.0,28.0,20.0,26.0,0
1939,CC:2F:71:3E:C5:1F,3819573,481740321,695,84894,3818878,481655427,0,2966,248376,2455,187634,511,60742,736,8,1026,18,0,32,144444.0,39000.0,-70.0,-71.0,-67.0,-60.0,-70.0,-71.0,-67.0,-60.0,-90.0,-93.0,-90.0,-93.0,20.0,22.0,23.0,33.0,0
1940,BA:8C:B9:54:50:24,3820616,482494105,1738,838678,3818878,481655427,0,5615,824896,5595,821774,20,3122,1004,14,2113,29,0,49,216660.0,130000.0,-39.0,-37.0,-45.0,-51.0,-42.0,-35.0,-42.0,-46.0,-90.0,-93.0,-90.0,-93.0,51.0,56.0,45.0,42.0,0
1941,92:69:1D:31:68:E9,3822370,485112464,3488,3456633,3818882,481655831,0,3650,933533,3550,911268,100,22265,1797,6,3614,78,0,31,216660.0,130000.0,-52.0,-49.0,-44.0,-46.0,-52.0,-49.0,-43.0,-46.0,-90.0,-93.0,-90.0,-93.0,38.0,44.0,46.0,47.0,0
1942,CC:2F:71:3F:1F:24,4415663,1168678381,596781,687022550,3818882,481655831,37,496291,558191337,495717,558122129,574,69208,478622,10,597018,48160,34,431,130000.0,43333.0,-67.0,-65.0,-70.0,-67.0,-67.0,-65.0,-70.0,-67.0,-90.0,-93.0,-90.0,-93.0,23.0,28.0,20.0,26.0,0
1943,CC:2F:71:3E:C5:1F,3819578,481740785,695,84894,3818883,481655891,0,2966,248376,2455,187634,511,60742,736,8,1026,18,0,32,144444.0,39000.0,-70.0,-71.0,-67.0,-60.0,-70.0,-71.0,-67.0,-60.0,-90.0,-93.0,-90.0,-93.0,20.0,22.0,23.0,33.0,0
1944,BA:8C:B9:54:50:24,3820621,482494569,1738,838678,3818883,481655891,0,5615,824896,5595,821774,20,3122,1004,14,2113,29,0,49,216660.0,130000.0,-39.0,-37.0,-45.0,-51.0,-42.0,-35.0,-42.0,-46.0,-90.0,-93.0,-90.0,-93.0,51.0,56.0,45.0,42.0,0
1945,92:69:1D:31:68:E9,3822375,485112928,3488,3456633,3818887,481656295,0,3650,933533,3550,911268,100,22265,1797,6,3614,78,0,31,216660.0,130000.0,-52.0,-49.0,-44.0,-46.0,-52.0,-49.0,-43.0,-46.0,-90.0,-93.0,-90.0,-93.0,38.0,44.0,46.0,47.0,0
1946,CC:2F:71:3F:1F:24,4415711,1168693397,596824,687037102,3818887,481656295,37,496320,558196701,495746,558127493,574,69208,478651,10,597061,48180,34,431,117000.0,39000.0,-67.0,-65.0,-70.0,-68.0,-67.0,-65.0,-70.0,-67.0,-90.0,-93.0,-90.0,-93.0,23.0,28.0,20.0,25.0,0
1947,CC:2F:71:3E:C5:1F,3819582,481741189,695,84894,3818887,481656295,0,2966,248376,2455,187634,511,60742,736,8,1026,18,0,32,144444.0,39000.0,-70.0,-71.0,-67.0,-60.0,-70.0,-71.0,-67.0,-60.0,-90.0,-93.0,-90.0,-93.0,20.0,22.0,23.0,33.0,0
1948,BA:8C:B9:54:50:24,3820625,482494973,1738,838678,3818887,481656295,0,5615,824896,5595,821774,20,3122,1004,14,2113,29,0,49,216660.0,130000.0,-39.0,-37.0,-45.0,-51.0,-42.0,-35.0,-42.0,-46.0,-90.0,-93.0,-90.0,-93.0,51.0,56.0,45.0,42.0,0
1949,92:69:1D:31:68:E9,3822379,485113332,3488,3456633,3818891,481656699,0,3650,933533,3550,911268,100,22265,1797,6,3614,78,0,31,216660.0,130000.0,-52.0,-49.0,-44.0,-46.0,-52.0,-49.0,-43.0,-46.0,-90.0,-93.0,-90.0,-93.0,38.0,44.0,46.0,47.0,0
1950,CC:2F:71:3F:1F:24,4415756,1168708161,596865,687051462,3818891,481656699,37,496348,558201925,495774,558132717,574,69208,478679,10,597102,48181,34,431,130000.0,39000.0,-67.0,-65.0,-70.0,-68.0,-67.0,-65.0,-70.0,-67.0,-90.0,-93.0,-90.0,-93.0,23.0,28.0,20.0,25.0,0
1951,CC:2F:71:3E:C5:1F,3819586,481741593,695,84894,3818891,481656699,0,2966,248376,2455,187634,511,60742,736,8,1026,18,0,32,144444.0,39000.0,-70.0,-71.0,-67.0,-60.0,-70.0,-71.0,-67.0,-60.0,-90.0,-93.0,-90.0,-93.0,20.0,22.0,23.0,33.0,0
1952,BA:8C:B9:54:50:24,3820629,482495377,1738,838678,3818891,481656699,0,5615,824896,5595,821774,20,3122,1004,14,2113,29,0,49,216660.0,130000.0,-39.0,-37.0,-45.0,-51.0,-42.0,-35.0,-42.0,-46.0,-90.0,-93.0,-90.0,-93.0,51.0,56.0,45.0,42.0,0
1953,92:69:1D:31:68:E9,3822384,485113796,3488,3456633,3818896,481657163,0,3651,933601,3551,911336,100,22265,1797,6,3614,78,0,31,216660.0,130000.0,-52.0,-50.0,-44.0,-46.0,-52.0,-49.0,-43.0,-46.0,-90.0,-93.0,-90.0,-93.0,38.0,43.0,46.0,47.0,0
1954,CC:2F:71:3F:1F:24,4415805,1168723307,596909,687066144,3818896,481657163,37,496378,558207405,495804,558138197,574,69208,478709,10,597146,48193,34,431,130000.0,39000.0,-67.0,-65.0,-70.0,-67.0,-67.0,-65.0,-70.0,-67.0,-90.0,-93.0,-90.0,-93.0,23.0,28.0,20.0,26.0,0
1955,CC:2F:71:3E:C5:1F,3819591,481742057,695,84894,3818896,481657163,0,2966,248376,2455,187634,511,60742,736,8,1026,18,0,32,144444.0,39000.0,-70.0,-71.0,-67.0,-60.0,-70.0,-71.0,-67.0,-60.0,-90.0,-93.0,-90.0,-93.0,20.0,22.0,23.0,33.0,0
1956,BA:8C:B9:54:50:24,3820634,482495841,1738,838678,3818896,481657163,0,5615,824896,5595,821774,20,3122,1004,14,2113,29,0,49,216660.0,130000.0,-39.0,-37.0,-45.0,-51.0,-42.0,-35.0,-42.0,-46.0,-90.0,-93.0,-90.0,-93.0,51.0,56.0,45.0,42.0,0
1957,92:69:1D:31:68:E9,3822388,485114200,3488,3456633,3818900,481657567,0,3651,933601,3551,911336,100,22265,1797,6,3614,78,0,31,216660.0,130000.0,-52.0,-50.0,-44.0,-46.0,-52.0,-49.0,-43.0,-46.0,-90.0,-93.0,-90.0,-93.0,38.0,43.0,46.0,47.0,0
1958,CC:2F:71:3F:1F:24,4415850,1168737959,596950,687080392,3818900,481657567,37,496407,558212769,495833,558143561,574,69208,478738,10,597187,48228,34,431,130000.0,43333.0,-67.0,-65.0,-71.0,-68.0,-67.0,-65.0,-70.0,-67.0,-90.0,-93.0,-90.0,-93.0,23.0,28.0,19.0,25.0,0
1959,CC:2F:71:3E:C5:1F,3819595,481742461,695,84894,3818900,481657567,0,2966,248376,2455,187634,511,60742,736,8,1026,18,0,32,144444.0,39000.0,-70.0,-71.0,-67.0,-60.0,-70.0,-71.0,-67.0,-60.0,-90.0,-93.0,-90.0,-93.0,20.0,22.0,23.0,33.0,0
1960,BA:8C:B9:54:50:24,3820638,482496245,1738,838678,3818900,481657567,0,5615,824896,5595,821774,20,3122,1004,14,2113,29,0,49,216660.0,130000.0,-39.0,-37.0,-45.0,-51.0,-42.0,-35.0,-42.0,-46.0,-90.0,-93.0,-90.0,-93.0,51.0,56.0,45.0,42.0,0
1961,92:69:1D:31:68:E9,3822392,485114604,3488,3456633,3818904,481657971,0,3651,933601,3551,911336,100,22265,1797,6,3614,78,0,31,216660.0,130000.0,-52.0,-50.0,-44.0,-46.0,-52.0,-49.0,-43.0,-46.0,-90.0,-93.0,-90.0,-93.0,38.0,43.0,46.0,47.0,0
1962,CC:2F:71:3F:1F:24,4415896,1168752903,596992,687094932,3818904,481657971,37,496436,558218133,495862,558148925,574,69208,478767,10,597229,48234,34,431,130000.0,43333.0,-67.0,-65.0,-70.0,-67.0,-67.0,-65.0,-70.0,-67.0,-90.0,-93.0,-90.0,-93.0,23.0,28.0,20.0,26.0,0
1963,CC:2F:71:3E:C5:1F,3819599,481742865,695,84894,3818904,481657971,0,2966,248376,2455,187634,511,60742,736,8,1026,18,0,32,144444.0,39000.0,-70.0,-71.0,-67.0,-60.0,-70.0,-71.0,-67.0,-60.0,-90.0,-93.0,-90.0,-93.0,20.0,22.0,23.0,33.0,0
1964,BA:8C:B9:54:50:24,3820642,482496649,1738,838678,3818904,481657971,0,5615,824896,5595,821774,20,3122,1004,14,2113,29,0,49,216660.0,130000.0,-39.0,-37.0,-45.0,-51.0,-42.0,-35.0,-42.0,-46.0,-90.0,-93.0,-90.0,-93.0,51.0,56.0,45.0,42.0,0
1965,92:69:1D:31:68:E9,3822397,485115068,3488,3456633,3818909,481658435,0,3651,933601,3551,911336,100,22265,1797,6,3614,78,0,31,216660.0,130000.0,-52.0,-50.0,-44.0,-46.0,-52.0,-49.0,-43.0,-46.0,-90.0,-93.0,-90.0,-93.0,38.0,43.0,46.0,47.0,0
1966,CC:2F:71:3F:1F:24,4415944,1168767975,597035,687109540,3818909,481658435,37,496464,558223357,495890,558154149,574,69208,478795,10,597272,48237,34,431,130000.0,39000.0,-67.0,-65.0,-70.0,-68.0,-67.0,-65.0,-70.0,-67.0,-90.0,-93.0,-90.0,-93.0,23.0,28.0,20.0,25.0,0
1967,CC:2F:71:3E:C5:1F,3819604,481743329,695,84894,3818909,481658435,0,2966,248376,2455,187634,511,60742,736,8,1026,18,0,32,144444.0,39000.0,-70.0,-71.0,-67.0,-60.0,-70.0,-71.0,-67.0,-60.0,-90.0,-93.0,-90.0,-93.0,20.0,22.0,23.0,33.0,0
1968,BA:8C:B9:54:50:24,3820647,482497113,1738,838678,3818909,481658435,0,5615,824896,5595,821774,20,3122,1004,14,2113,29,0,49,216660.0,130000.0,-39.0,-37.0,-45.0,-51.0,-42.0,-35.0,-42.0,-46.0,-90.0,-93.0,-90.0,-93.0,51.0,56.0,45.0,42.0,0
1969,92:69:1D:31:68:E9,3822403,485115861,3489,3456749,3818914,481659112,0,3653,933737,3553,911472,100,22265,1797,6,3615,78,0,31,216660.0,130000.0,-52.0,-50.0,-44.0,-46.0,-52.0,-49.0,-43.0,-46.0,-90.0,-93.0,-90.0,-93.0,38.0,43.0,46.0,47.0,0
1970,CC:2F:71:3F:1F:24,4415992,1168783140,597078,687124028,3818914,481659112,37,496493,558228721,495919,558159513,574,69208,478824,10,597315,48267,34,431,130000.0,43333.0,-67.0,-65.0,-70.0,-68.0,-67.0,-65.0,-70.0,-67.0,-90.0,-93.0,-90.0,-93.0,23.0,28.0,20.0,25.0,0
1971,CC:2F:71:3E:C5:1F,3819610,481744122,696,85010,3818914,481659112,0,2968,248516,2457,187774,511,60742,736,8,1027,18,0,32,144444.0,39000.0,-70.0,-71.0,-67.0,-60.0,-70.0,-71.0,-67.0,-60.0,-90.0,-93.0,-90.0,-93.0,20.0,22.0,23.0,33.0,0
1972,BA:8C:B9:54:50:24,3820653,482497906,1739,838794,3818914,481659112,0,5621,825304,5601,822182,20,3122,1004,14,2114,29,0,49,216660.0,130000.0,-49.0,-35.0,-42.0,-44.0,-43.0,-34.0,-41.0,-45.0,-90.0,-93.0,-90.0,-93.0,41.0,58.0,48.0,49.0,0
1973,92:69:1D:31:68:E9,3822408,485116325,3489,3456749,3818919,481659576,0,3653,933737,3553,911472,100,22265,1797,6,3615,78,0,31,216660.0,130000.0,-52.0,-50.0,-44.0,-46.0,-52.0,-49.0,-43.0,-46.0,-90.0,-93.0,-90.0,-93.0,38.0,43.0,46.0,47.0,0
1974,CC:2F:71:3F:1F:24,4416040,1168798268,597121,687138692,3818919,481659576,37,496522,558234085,495948,558164877,574,69208,478853,10,597358,48270,34,431,130000.0,43333.0,-67.0,-65.0,-70.0,-67.0,-67.0,-65.0,-70.0,-67.0,-90.0,-93.0,-90.0,-93.0,23.0,28.0,20.0,26.0,0
1975,CC:2F:71:3E:C5:1F,3819615,481744586,696,85010,3818919,481659576,0,2968,248516,2457,187774,511,60742,736,8,1027,18,0,32,144444.0,39000.0,-70.0,-71.0,-67.0,-60.0,-70.0,-71.0,-67.0,-60.0,-90.0,-93.0,-90.0,-93.0,20.0,22.0,23.0,33.0,0
1976,BA:8C:B9:54:50:24,3820658,482498370,1739,838794,3818919,481659576,0,5621,825304,5601,822182,20,3122,1004,14,2114,29,0,49,216660.0,130000.0,-49.0,-35.0,-42.0,-44.0,-43.0,-34.0,-41.0,-45.0,-90.0,-93.0,-90.0,-93.0,41.0,58.0,48.0,49.0,0
1977,92:69:1D:31:68:E9,3822412,485116729,3489,3456749,3818923,481659980,0,3653,933737,3553,911472,100,22265,1797,6,3615,78,0,31,216660.0,130000.0,-52.0,-50.0,-44.0,-46.0,-52.0,-49.0,-43.0,-46.0,-90.0,-93.0,-90.0,-93.0,38.0,43.0,46.0,47.0,0
1978,CC:2F:71:3F:1F:24,4416087,1168813224,597164,687153244,3818923,481659980,37,496551,558239449,495977,558170241,574,69208,478882,10,597401,48289,34,431,117000.0,39000.0,-67.0,-65.0,-70.0,-67.0,-67.0,-65.0,-70.0,-67.0,-90.0,-93.0,-90.0,-93.0,23.0,28.0,20.0,26.0,0
1979,CC:2F:71:3E:C5:1F,3819619,481744990,696,85010,3818923,481659980,0,2968,248516,2457,187774,511,60742,736,8,1027,18,0,32,144444.0,39000.0,-70.0,-71.0,-67.0,-60.0,-70.0,-71.0,-67.0,-60.0,-90.0,-93.0,-90.0,-93.0,20.0,22.0,23.0,33.0,0
1980,BA:8C:B9:54:50:24,3820662,482498774,1739,838794,3818923,481659980,0,5621,825304,5601,822182,20,3122,1004,14,2114,29,0,49,216660.0,130000.0,-49.0,-35.0,-42.0,-44.0,-43.0,-34.0,-41.0,-45.0,-90.0,-93.0,-90.0,-93.0,41.0,58.0,48.0,49.0,0
1981,92:69:1D:31:68:E9,3822416,485117133,3489,3456749,3818927,481660384,0,3653,933737,3553,911472,100,22265,1797,6,3615,78,0,31,216660.0,130000.0,-52.0,-50.0,-44.0,-46.0,-52.0,-49.0,-43.0,-46.0,-90.0,-93.0,-90.0,-93.0,38.0,43.0,46.0,47.0,0
1982,CC:2F:71:3F:1F:24,4416137,1168828678,597208,687167926,3818929,481660752,37,496584,558245277,496010,558176069,574,69208,478915,10,597445,48294,34,431,130000.0,43333.0,-67.0,-65.0,-71.0,-67.0,-67.0,-65.0,-70.0,-67.0,-90.0,-93.0,-90.0,-93.0,23.0,28.0,19.0,26.0,0
1983,CC:2F:71:3E:C5:1F,3819625,481745762,696,85010,3818929,481660752,0,2968,248516,2457,187774,511,60742,736,8,1027,18,0,32,144444.0,39000.0,-70.0,-71.0,-67.0,-60.0,-70.0,-71.0,-67.0,-60.0,-90.0,-93.0,-90.0,-93.0,20.0,22.0,23.0,33.0,0
1984,BA:8C:B9:54:50:24,3820668,482499546,1739,838794,3818929,481660752,0,5621,825304,5601,822182,20,3122,1004,14,2114,29,0,49,216660.0,130000.0,-49.0,-35.0,-42.0,-44.0,-43.0,-34.0,-41.0,-45.0,-90.0,-93.0,-90.0,-93.0,41.0,58.0,48.0,49.0,0
1985,92:69:1D:31:68:E9,3822424,485118027,3489,3456749,3818935,481661278,0,3653,933737,3553,911472,100,22265,1797,6,3615,78,0,31,216660.0,130000.0,-52.0,-50.0,-44.0,-46.0,-52.0,-49.0,-43.0,-46.0,-90.0,-93.0,-90.0,-93.0,38.0,43.0,46.0,47.0,0
1986,CC:2F:71:3F:1F:24,4416186,1168843812,597251,687182534,3818935,481661278,37,496614,558250733,496040,558181525,574,69208,478945,10,597488,48310,34,431,130000.0,39000.0,-67.0,-65.0,-70.0,-67.0,-67.0,-65.0,-70.0,-67.0,-90.0,-93.0,-90.0,-93.0,23.0,28.0,20.0,26.0,0
1987,CC:2F:71:3E:C5:1F,3819631,481746288,696,85010,3818935,481661278,0,2970,248704,2458,187844,512,60860,737,8,1027,18,0,32,144444.0,39000.0,-70.0,-71.0,-67.0,-60.0,-70.0,-71.0,-67.0,-60.0,-90.0,-93.0,-90.0,-93.0,20.0,22.0,23.0,33.0,0
1988,BA:8C:B9:54:50:24,3820674,482500072,1739,838794,3818935,481661278,0,5621,825304,5601,822182,20,3122,1004,14,2114,29,0,49,216660.0,130000.0,-49.0,-35.0,-42.0,-44.0,-43.0,-34.0,-41.0,-45.0,-90.0,-93.0,-90.0,-93.0,41.0,58.0,48.0,49.0,0
1989,92:69:1D:31:68:E9,3822428,485118431,3489,3456749,3818939,481661682,0,3653,933737,3553,911472,100,22265,1797,6,3615,78,0,31,216660.0,130000.0,-52.0,-50.0,-44.0,-46.0,-52.0,-49.0,-43.0,-46.0,-90.0,-93.0,-90.0,-93.0,38.0,43.0,46.0,47.0,0
1990,CC:2F:71:3F:1F:24,4416231,1168858514,597292,687196832,3818939,481661682,37,496643,558256133,496069,558186925,574,69208,478974,10,597528,48322,34,431,130000.0,39000.0,-67.0,-65.0,-71.0,-68.0,-67.0,-65.0,-70.0,-68.0,-90.0,-93.0,-90.0,-93.0,23.0,28.0,19.0,25.0,0
1991,CC:2F:71:3E:C5:1F,3819635,481746692,696,85010,3818939,481661682,0,2970,248704,2458,187844,512,60860,737,8,1027,18,0,32,144444.0,39000.0,-70.0,-71.0,-67.0,-60.0,-70.0,-71.0,-67.0,-60.0,-90.0,-93.0,-90.0,-93.0,20.0,22.0,23.0,33.0,0
1992,BA:8C:B9:54:50:24,3820678,482500476,1739,838794,3818939,481661682,0,5621,825304,5601,822182,20,3122,1004,14,2114,29,0,49,216660.0,130000.0,-49.0,-35.0,-42.0,-44.0,-43.0,-34.0,-41.0,-45.0,-90.0,-93.0,-90.0,-93.0,41.0,58.0,48.0,49.0,0
1993,92:69:1D:31:68:E9,3822432,485118835,3489,3456749,3818943,481662086,0,3653,933737,3553,911472,100,22265,1797,6,3615,78,0,31,216660.0,130000.0,-52.0,-50.0,-44.0,-46.0,-52.0,-49.0,-43.0,-46.0,-90.0,-93.0,-90.0,-93.0,38.0,43.0,46.0,47.0,0
1994,CC:2F:71:3F:1F:24,4416276,1168873222,597333,687211136,3818943,481662086,37,496672,558261497,496098,558192289,574,69208,479003,10,597570,48345,34,431,130000.0,39000.0,-73.0,-72.0,-77.0,-74.0,-72.0,-71.0,-76.0,-73.0,-90.0,-93.0,-90.0,-93.0,17.0,21.0,13.0,19.0,0
1995,CC:2F:71:3E:C5:1F,3819639,481747096,696,85010,3818943,481662086,0,2970,248704,2458,187844,512,60860,737,8,1027,18,0,32,144444.0,39000.0,-70.0,-71.0,-67.0,-60.0,-70.0,-71.0,-67.0,-60.0,-90.0,-93.0,-90.0,-93.0,20.0,22.0,23.0,33.0,0
1996,BA:8C:B9:54:50:24,3820682,482500880,1739,838794,3818943,481662086,0,5621,825304,5601,822182,20,3122,1004,14,2114,29,0,49,216660.0,130000.0,-49.0,-35.0,-42.0,-44.0,-43.0,-34.0,-41.0,-45.0,-90.0,-93.0,-90.0,-93.0,41.0,58.0,48.0,49.0,0
1997,92:69:1D:31:68:E9,3822437,485119299,3489,3456749,3818948,481662550,0,3653,933737,3553,911472,100,22265,1797,6,3615,78,0,31,216660.0,130000.0,-52.0,-50.0,-44.0,-46.0,-52.0,-49.0,-43.0,-46.0,-90.0,-93.0,-90.0,-93.0,38.0,43.0,46.0,47.0,0
1998,CC:2F:71:3F:1F:24,4416324,1168888182,597376,687225632,3818948,481662550,37,496701,558266861,496127,558197653,574,69208,479032,10,597613,48372,34,431,130000.0,43333.0,-67.0,-65.0,-71.0,-68.0,-67.0,-65.0,-71.0,-68.0,-90.0,-93.0,-90.0,-93.0,23.0,28.0,19.0,25.0,0
1999,CC:2F:71:3E:C5:1F,3819644,481747560,696,85010,3818948,481662550,0,2970,248704,2458,187844,512,60860,737,8,1027,18,0,32,144444.0,39000.0,-70.0,-71.0,-67.0,-60.0,-70.0,-71.0,-67.0,-60.0,-90.0,-93.0,-90.0,-93.0,20.0,22.0,23.0,33.0,0
2000,BA:8C:B9:54:50:24,3820687,482501344,1739,838794,3818948,481662550,0,5621,825304,5601,822182,20,3122,1004,14,2114,29,0,49,216660.0,130000.0,-49.0,-35.0,-42.0,-44.0,-43.0,-34.0,-41.0,-45.0,-90.0,-93.0,-90.0,-93.0,41.0,58.0,48.0,49.0,0
2001,92:69:1D:31:68:E9,3822441,485119703,3489,3456749,3818952,481662954,0,3653,933737,3553,911472,100,22265,1797,6,3615,78,0,31,216660.0,130000.0,-52.0,-50.0,-44.0,-46.0,-52.0,-49.0,-43.0,-46.0,-90.0,-93.0,-90.0,-93.0,38.0,43.0,46.0,47.0,0
2002,CC:2F:71:3F:1F:24,4416371,1168903250,597419,687240296,3818952,481662954,37,496731,558272365,496157,558203157,574,69208,479062,10,597656,48376,34,431,130000.0,43333.0,-67.0,-65.0,-70.0,-68.0,-67.0,-65.0,-70.0,-68.0,-90.0,-93.0,-90.0,-93.0,23.0,28.0,20.0,25.0,0
2003,CC:2F:71:3E:C5:1F,3819648,481747964,696,85010,3818952,481662954,0,2970,248704,2458,187844,512,60860,737,8,1027,18,0,32,144444.0,39000.0,-70.0,-71.0,-67.0,-60.0,-70.0,-71.0,-67.0,-60.0,-90.0,-93.0,-90.0,-93.0,20.0,22.0,23.0,33.0,0
2004,BA:8C:B9:54:50:24,3820691,482501748,1739,838794,3818952,481662954,0,5622,825372,5602,822250,20,3122,1004,14,2114,29,0,49,216660.0,130000.0,-40.0,-37.0,-44.0,-52.0,-42.0,-35.0,-42.0,-46.0,-90.0,-93.0,-90.0,-93.0,50.0,56.0,46.0,41.0,0
2005,92:69:1D:31:68:E9,3822446,485120167,3489,3456749,3818957,481663418,0,3653,933737,3553,911472,100,22265,1797,6,3615,78,0,31,216660.0,130000.0,-52.0,-50.0,-44.0,-46.0,-52.0,-49.0,-43.0,-46.0,-90.0,-93.0,-90.0,-93.0,38.0,43.0,46.0,47.0,0
2006,CC:2F:71:3F:1F:24,4416419,1168918266,597462,687254848,3818957,481663418,37,496760,558277729,496186,558208521,574,69208,479091,10,597699,48389,34,431,117000.0,39000.0,-71.0,-69.0,-74.0,-71.0,-70.0,-69.0,-73.0,-71.0,-90.0,-93.0,-90.0,-93.0,19.0,24.0,16.0,22.0,0
2007,CC:2F:71:3E:C5:1F,3819653,481748428,696,85010,3818957,481663418,0,2970,248704,2458,187844,512,60860,737,8,1027,18,0,32,144444.0,39000.0,-70.0,-71.0,-67.0,-60.0,-70.0,-71.0,-67.0,-60.0,-90.0,-93.0,-90.0,-93.0,20.0,22.0,23.0,33.0,0
2008,BA:8C:B9:54:50:24,3820696,482502212,1739,838794,3818957,481663418,0,5625,825576,5605,822454,20,3122,1004,14,2114,29,0,49,216660.0,130000.0,-40.0,-37.0,-44.0,-52.0,-41.0,-35.0,-43.0,-48.0,-90.0,-93.0,-90.0,-93.0,50.0,56.0,46.0,41.0,0
2009,92:69:1D:31:68:E9,3822450,485120571,3489,3456749,3818961,481663822,0,3653,933737,3553,911472,100,22265,1797,6,3615,78,0,31,216660.0,130000.0,-52.0,-50.0,-44.0,-46.0,-52.0,-49.0,-43.0,-46.0,-90.0,-93.0,-90.0,-93.0,38.0,43.0,46.0,47.0,0
2010,CC:2F:71:3F:1F:24,4416466,1168933228,597505,687269406,3818961,481663822,37,496792,558283417,496218,558214209,574,69208,479123,10,597742,48395,34,431,130000.0,43333.0,-71.0,-69.0,-74.0,-71.0,-70.0,-68.0,-73.0,-70.0,-90.0,-93.0,-90.0,-93.0,19.0,24.0,16.0,22.0,0
2011,CC:2F:71:3E:C5:1F,3819657,481748832,696,85010,3818961,481663822,0,2970,248704,2458,187844,512,60860,737,8,1027,18,0,32,144444.0,39000.0,-70.0,-71.0,-67.0,-60.0,-70.0,-71.0,-67.0,-60.0,-90.0,-93.0,-90.0,-93.0,20.0,22.0,23.0,33.0,0
2012,BA:8C:B9:54:50:24,3820700,482502616,1739,838794,3818961,481663822,0,5625,825576,5605,822454,20,3122,1004,14,2114,29,0,49,216660.0,130000.0,-40.0,-37.0,-44.0,-52.0,-41.0,-35.0,-43.0,-48.0,-90.0,-93.0,-90.0,-93.0,50.0,56.0,46.0,41.0,0
2013,92:69:1D:31:68:E9,3822454,485120975,3489,3456749,3818965,481664226,0,3653,933737,3553,911472,100,22265,1797,6,3615,78,0,31,216660.0,130000.0,-52.0,-50.0,-44.0,-46.0,-52.0,-49.0,-43.0,-46.0,-90.0,-93.0,-90.0,-93.0,38.0,43.0,46.0,47.0,0
2014,CC:2F:71:3F:1F:24,4416514,1168948314,597549,687284088,3818965,481664226,37,496821,558288781,496247,558219573,574,69208,479152,10,597786,48419,34,431,117000.0,39000.0,-71.0,-69.0,-75.0,-71.0,-70.0,-69.0,-74.0,-71.0,-90.0,-93.0,-90.0,-93.0,19.0,24.0,15.0,22.0,0
2015,CC:2F:71:3E:C5:1F,3819661,481749236,696,85010,3818965,481664226,0,2970,248704,2458,187844,512,60860,737,8,1027,18,0,32,144444.0,39000.0,-70.0,-71.0,-67.0,-60.0,-70.0,-71.0,-67.0,-60.0,-90.0,-93.0,-90.0,-93.0,20.0,22.0,23.0,33.0,0
2016,BA:8C:B9:54:50:24,3820704,482503020,1739,838794,3818965,481664226,0,5625,825576,5605,822454,20,3122,1004,14,2114,29,0,49,216660.0,130000.0,-40.0,-37.0,-44.0,-52.0,-41.0,-35.0,-43.0,-48.0,-90.0,-93.0,-90.0,-93.0,50.0,56.0,46.0,41.0,0
2017,92:69:1D:31:68:E9,3822460,485121501,3489,3456749,3818971,481664752,0,3653,933737,3553,911472,100,22265,1797,6,3615,78,0,31,216660.0,130000.0,-52.0,-50.0,-44.0,-46.0,-52.0,-49.0,-43.0,-46.0,-90.0,-93.0,-90.0,-93.0,38.0,43.0,46.0,47.0,0
2018,CC:2F:71:3F:1F:24,4416563,1168963392,597592,687298640,3818971,481664752,37,496851,558294263,496276,558224937,575,69326,479182,10,597829,48421,34,431,130000.0,43333.0,-70.0,-68.0,-73.0,-70.0,-70.0,-68.0,-73.0,-70.0,-90.0,-93.0,-90.0,-93.0,20.0,25.0,17.0,23.0,0
2019,CC:2F:71:3E:C5:1F,3819667,481749762,696,85010,3818971,481664752,0,2970,248704,2458,187844,512,60860,737,8,1027,18,0,32,144444.0,39000.0,-70.0,-71.0,-67.0,-60.0,-70.0,-71.0,-67.0,-60.0,-90.0,-93.0,-90.0,-93.0,20.0,22.0,23.0,33.0,0
2020,BA:8C:B9:54:50:24,3820710,482503546,1739,838794,3818971,481664752,0,5625,825576,5605,822454,20,3122,1004,14,2114,29,0,49,216660.0,130000.0,-40.0,-37.0,-44.0,-52.0,-41.0,-35.0,-43.0,-48.0,-90.0,-93.0,-90.0,-93.0,50.0,56.0,46.0,41.0,0
2021,92:69:1D:31:68:E9,3822465,485122178,3489,3456749,3818976,481665429,0,3653,933737,3553,911472,100,22265,1797,6,3615,78,0,31,216660.0,130000.0,-52.0,-50.0,-44.0,-46.0,-52.0,-49.0,-43.0,-46.0,-90.0,-93.0,-90.0,-93.0,38.0,43.0,46.0,47.0,0
2022,CC:2F:71:3F:1F:24,4416610,1168978503,597634,687313074,3818976,481665429,37,496881,558299767,496306,558230441,575,69326,479212,10,597871,48451,34,431,117000.0,39000.0,-68.0,-66.0,-71.0,-68.0,-73.0,-71.0,-76.0,-74.0,-90.0,-93.0,-90.0,-93.0,22.0,27.0,19.0,25.0,0
2023,CC:2F:71:3E:C5:1F,3819672,481750439,696,85010,3818976,481665429,0,2970,248704,2458,187844,512,60860,737,8,1027,18,0,32,144444.0,39000.0,-70.0,-71.0,-67.0,-60.0,-70.0,-71.0,-67.0,-60.0,-90.0,-93.0,-90.0,-93.0,20.0,22.0,23.0,33.0,0
2024,BA:8C:B9:54:50:24,3820715,482504223,1739,838794,3818976,481665429,0,5625,825576,5605,822454,20,3122,1004,14,2114,29,0,49,216660.0,130000.0,-40.0,-37.0,-44.0,-52.0,-41.0,-35.0,-43.0,-48.0,-90.0,-93.0,-90.0,-93.0,50.0,56.0,46.0,41.0,0
2025,92:69:1D:31:68:E9,3822469,485122582,3489,3456749,3818980,481665833,0,3653,933737,3553,911472,100,22265,1797,6,3615,78,0,31,216660.0,130000.0,-52.0,-50.0,-44.0,-46.0,-52.0,-49.0,-43.0,-46.0,-91.0,-94.0,-90.0,-93.0,39.0,44.0,46.0,47.0,0
2026,CC:2F:71:3F:1F:24,4416658,1168993519,597677,687327626,3818981,481665893,37,496910,558305131,496335,558235805,575,69326,479241,10,597914,48451,34,431,130000.0,43333.0,-67.0,-65.0,-71.0,-68.0,-67.0,-65.0,-70.0,-67.0,-91.0,-94.0,-90.0,-93.0,24.0,29.0,19.0,25.0,0
2027,CC:2F:71:3E:C5:1F,3819677,481750903,696,85010,3818981,481665893,0,2970,248704,2458,187844,512,60860,737,8,1027,18,0,32,144444.0,39000.0,-70.0,-71.0,-67.0,-60.0,-70.0,-71.0,-67.0,-60.0,-91.0,-94.0,-90.0,-93.0,21.0,23.0,23.0,33.0,0
2028,BA:8C:B9:54:50:24,3820720,482504687,1739,838794,3818981,481665893,0,5626,825644,5606,822522,20,3122,1004,14,2114,29,0,49,216660.0,130000.0,-49.0,-35.0,-42.0,-44.0,-42.0,-35.0,-43.0,-48.0,-91.0,-94.0,-90.0,-93.0,42.0,59.0,48.0,49.0,0
2029,92:69:1D:31:68:E9,3822474,485123046,3489,3456749,3818985,481666297,0,3653,933737,3553,911472,100,22265,1797,6,3615,78,0,31,216660.0,130000.0,-52.0,-50.0,-44.0,-46.0,-52.0,-49.0,-43.0,-46.0,-91.0,-94.0,-90.0,-93.0,39.0,44.0,46.0,47.0,0
2030,CC:2F:71:3F:1F:24,4416706,1169008605,597721,687342308,3818985,481666297,37,496941,558310763,496366,558241437,575,69326,479272,10,597958,48472,34,431,117000.0,39000.0,-67.0,-65.0,-71.0,-68.0,-67.0,-65.0,-70.0,-67.0,-91.0,-94.0,-90.0,-93.0,24.0,29.0,19.0,25.0,0
2031,CC:2F:71:3E:C5:1F,3819681,481751307,696,85010,3818985,481666297,0,2970,248704,2458,187844,512,60860,737,8,1027,18,0,32,144444.0,39000.0,-70.0,-71.0,-67.0,-60.0,-70.0,-71.0,-67.0,-60.0,-91.0,-94.0,-90.0,-93.0,21.0,23.0,23.0,33.0,0
2032,BA:8C:B9:54:50:24,3820724,482505091,1739,838794,3818985,481666297,0,5626,825644,5606,822522,20,3122,1004,14,2114,29,0,49,216660.0,130000.0,-49.0,-35.0,-42.0,-44.0,-42.0,-35.0,-43.0,-48.0,-91.0,-94.0,-90.0,-93.0,42.0,59.0,48.0,49.0,0
2033,92:69:1D:31:68:E9,3822478,485123450,3489,3456749,3818989,481666701,0,3653,933737,3553,911472,100,22265,1797,6,3615,78,0,31,216660.0,130000.0,-52.0,-50.0,-44.0,-46.0,-52.0,-49.0,-43.0,-46.0,-91.0,-94.0,-90.0,-93.0,39.0,44.0,46.0,47.0,0
2034,CC:2F:71:3F:1F:24,4416750,1169023189,597761,687356488,3818989,481666701,37,496970,558316127,496395,558246801,575,69326,479301,10,597998,48479,34,431,130000.0,43333.0,-67.0,-65.0,-71.0,-68.0,-67.0,-65.0,-70.0,-68.0,-91.0,-94.0,-90.0,-93.0,24.0,29.0,19.0,25.0,0
2035,CC:2F:71:3E:C5:1F,3819685,481751711,696,85010,3818989,481666701,0,2970,248704,2458,187844,512,60860,737,8,1027,18,0,32,144444.0,39000.0,-70.0,-71.0,-67.0,-60.0,-70.0,-71.0,-67.0,-60.0,-91.0,-94.0,-90.0,-93.0,21.0,23.0,23.0,33.0,0
2036,BA:8C:B9:54:50:24,3820728,482505495,1739,838794,3818989,481666701,0,5626,825644,5606,822522,20,3122,1004,14,2114,29,0,49,216660.0,130000.0,-49.0,-35.0,-42.0,-44.0,-42.0,-35.0,-43.0,-48.0,-91.0,-94.0,-90.0,-93.0,42.0,59.0,48.0,49.0,0
2037,92:69:1D:31:68:E9,3822483,485123914,3489,3456749,3818994,481667165,0,3653,933737,3553,911472,100,22265,1797,6,3615,78,0,31,216660.0,130000.0,-52.0,-50.0,-44.0,-46.0,-52.0,-49.0,-43.0,-46.0,-91.0,-94.0,-90.0,-93.0,39.0,44.0,46.0,47.0,0
2038,CC:2F:71:3F:1F:24,4416798,1169038323,597804,687371158,3818994,481667165,37,496999,558321491,496424,558252165,575,69326,479330,10,598041,48486,34,431,130000.0,43333.0,-67.0,-65.0,-71.0,-68.0,-67.0,-65.0,-70.0,-67.0,-91.0,-94.0,-90.0,-93.0,24.0,29.0,19.0,25.0,0
2039,CC:2F:71:3E:C5:1F,3819690,481752175,696,85010,3818994,481667165,0,2970,248704,2458,187844,512,60860,737,8,1027,18,0,32,144444.0,39000.0,-70.0,-71.0,-67.0,-60.0,-70.0,-71.0,-67.0,-60.0,-91.0,-94.0,-90.0,-93.0,21.0,23.0,23.0,33.0,0
2040,BA:8C:B9:54:50:24,3820733,482505959,1739,838794,3818994,481667165,0,5626,825644,5606,822522,20,3122,1004,14,2114,29,0,49,216660.0,130000.0,-49.0,-35.0,-42.0,-44.0,-42.0,-35.0,-43.0,-48.0,-91.0,-94.0,-90.0,-93.0,42.0,59.0,48.0,49.0,0
2041,92:69:1D:31:68:E9,3822487,485124318,3489,3456749,3818998,481667569,0,3653,933737,3553,911472,100,22265,1797,6,3615,78,0,31,216660.0,130000.0,-52.0,-50.0,-44.0,-46.0,-52.0,-49.0,-43.0,-46.0,-91.0,-94.0,-90.0,-93.0,39.0,44.0,46.0,47.0,0
2042,CC:2F:71:3F:1F:24,4416846,1169053465,597848,687385896,3818998,481667569,37,497028,558326855,496453,558257529,575,69326,479359,10,598085,48507,34,431,144444.0,39000.0,-67.0,-65.0,-71.0,-68.0,-67.0,-65.0,-70.0,-67.0,-91.0,-94.0,-90.0,-93.0,24.0,29.0,19.0,25.0,0
2043,CC:2F:71:3E:C5:1F,3819694,481752579,696,85010,3818998,481667569,0,2970,248704,2458,187844,512,60860,737,8,1027,18,0,32,144444.0,39000.0,-70.0,-71.0,-67.0,-60.0,-70.0,-71.0,-67.0,-60.0,-91.0,-94.0,-90.0,-93.0,21.0,23.0,23.0,33.0,0
2044,BA:8C:B9:54:50:24,3820737,482506363,1739,838794,3818998,481667569,0,5626,825644,5606,822522,20,3122,1004,14,2114,29,0,49,216660.0,130000.0,-49.0,-35.0,-42.0,-44.0,-42.0,-35.0,-43.0,-48.0,-91.0,-94.0,-90.0,-93.0,42.0,59.0,48.0,49.0,0
2045,92:69:1D:31:68:E9,3822491,485124722,3489,3456749,3819002,481667973,0,3653,933737,3553,911472,100,22265,1797,6,3615,78,0,31,216660.0,130000.0,-52.0,-50.0,-44.0,-46.0,-52.0,-49.0,-43.0,-46.0,-91.0,-94.0,-90.0,-93.0,39.0,44.0,46.0,47.0,0
2046,CC:2F:71:3F:1F:24,4416892,1169068297,597890,687400324,3819002,481667973,37,497057,558332219,496482,558262893,575,69326,479388,10,598127,48539,34,431,144444.0,43333.0,-68.0,-66.0,-71.0,-68.0,-67.0,-65.0,-70.0,-67.0,-91.0,-94.0,-90.0,-93.0,23.0,28.0,19.0,25.0,0
2047,CC:2F:71:3E:C5:1F,3819698,481752983,696,85010,3819002,481667973,0,2970,248704,2458,187844,512,60860,737,8,1027,18,0,32,144444.0,39000.0,-70.0,-71.0,-67.0,-60.0,-70.0,-71.0,-67.0,-60.0,-91.0,-94.0,-90.0,-93.0,21.0,23.0,23.0,33.0,0
2048,BA:8C:B9:54:50:24,3820741,482506767,1739,838794,3819002,481667973,0,5626,825644,5606,822522,20,3122,1004,14,2114,29,0,49,216660.0,130000.0,-49.0,-35.0,-42.0,-44.0,-42.0,-35.0,-43.0,-48.0,-91.0,-94.0,-90.0,-93.0,42.0,59.0,48.0,49.0,0
2049,92:69:1D:31:68:E9,3822496,485125186,3489,3456749,3819007,481668437,0,3653,933737,3553,911472,100,22265,1797,6,3615,78,0,31,216660.0,130000.0,-52.0,-50.0,-44.0,-46.0,-52.0,-49.0,-43.0,-46.0,-91.0,-94.0,-90.0,-93.0,39.0,44.0,46.0,47.0,0
2050,CC:2F:71:3F:1F:24,4416940,1169083425,597933,687414988,3819007,481668437,37,497087,558337723,496512,558268397,575,69326,479418,10,598170,48585,34,431,144444.0,43333.0,-67.0,-65.0,-71.0,-67.0,-67.0,-65.0,-70.0,-67.0,-91.0,-94.0,-90.0,-93.0,24.0,29.0,19.0,26.0,0
2051,CC:2F:71:3E:C5:1F,3819703,481753447,696,85010,3819007,481668437,0,2970,248704,2458,187844,512,60860,737,8,1027,18,0,32,144444.0,39000.0,-70.0,-71.0,-67.0,-60.0,-70.0,-71.0,-67.0,-60.0,-91.0,-94.0,-90.0,-93.0,21.0,23.0,23.0,33.0,0
2052,BA:8C:B9:54:50:24,3820746,482507231,1739,838794,3819007,481668437,0,5626,825644,5606,822522,20,3122,1004,14,2114,29,0,49,216660.0,130000.0,-49.0,-35.0,-42.0,-44.0,-42.0,-35.0,-43.0,-48.0,-91.0,-94.0,-90.0,-93.0,42.0,59.0,48.0,49.0,0
2053,92:69:1D:31:68:E9,3822500,485125590,3489,3456749,3819011,481668841,0,3653,933737,3553,911472,100,22265,1797,6,3615,78,0,31,216660.0,130000.0,-52.0,-50.0,-44.0,-46.0,-52.0,-49.0,-43.0,-46.0,-91.0,-94.0,-90.0,-93.0,39.0,44.0,46.0,47.0,0
2054,CC:2F:71:3F:1F:24,4416987,1169098499,597976,687429658,3819011,481668841,37,497117,558343203,496542,558273877,575,69326,479448,10,598213,48627,34,431,144444.0,43333.0,-67.0,-65.0,-70.0,-68.0,-67.0,-65.0,-70.0,-67.0,-91.0,-94.0,-90.0,-93.0,24.0,29.0,20.0,25.0,0
2055,CC:2F:71:3E:C5:1F,3819707,481753851,696,85010,3819011,481668841,0,2970,248704,2458,187844,512,60860,737,8,1027,18,0,32,144444.0,39000.0,-70.0,-71.0,-67.0,-60.0,-70.0,-71.0,-67.0,-60.0,-91.0,-94.0,-90.0,-93.0,21.0,23.0,23.0,33.0,0
2056,BA:8C:B9:54:50:24,3820750,482507635,1739,838794,3819011,481668841,0,5626,825644,5606,822522,20,3122,1004,14,2114,29,0,49,216660.0,130000.0,-49.0,-35.0,-42.0,-44.0,-42.0,-35.0,-43.0,-48.0,-91.0,-94.0,-90.0,-93.0,42.0,59.0,48.0,49.0,0
2057,92:69:1D:31:68:E9,3822505,485126054,3489,3456749,3819016,481669305,0,3653,933737,3553,911472,100,22265,1797,6,3615,78,0,31,216660.0,130000.0,-52.0,-50.0,-44.0,-46.0,-52.0,-49.0,-43.0,-46.0,-91.0,-94.0,-90.0,-93.0,39.0,44.0,46.0,47.0,0
2058,CC:2F:71:3F:1F:24,4417036,1169113701,598020,687444396,3819016,481669305,37,497146,558348567,496571,558279241,575,69326,479477,10,598257,48655,34,431,130000.0,43333.0,-67.0,-65.0,-70.0,-67.0,-67.0,-65.0,-70.0,-67.0,-91.0,-94.0,-90.0,-93.0,24.0,29.0,20.0,26.0,0
2059,CC:2F:71:3E:C5:1F,3819712,481754315,696,85010,3819016,481669305,0,2970,248704,2458,187844,512,60860,737,8,1027,18,0,32,144444.0,39000.0,-70.0,-71.0,-67.0,-60.0,-70.0,-71.0,-67.0,-60.0,-91.0,-94.0,-90.0,-93.0,21.0,23.0,23.0,33.0,0
2060,BA:8C:B9:54:50:24,3820755,482508099,1739,838794,3819016,481669305,0,5626,825644,5606,822522,20,3122,1004,14,2114,29,0,49,216660.0,130000.0,-49.0,-35.0,-42.0,-44.0,-42.0,-35.0,-43.0,-48.0,-91.0,-94.0,-90.0,-93.0,42.0,59.0,48.0,49.0,0
2061,92:69:1D:31:68:E9,3822509,485126458,3489,3456749,3819020,481669709,0,3653,933737,3553,911472,100,22265,1797,6,3615,78,0,31,216660.0,130000.0,-52.0,-50.0,-44.0,-46.0,-52.0,-49.0,-43.0,-46.0,-91.0,-94.0,-90.0,-93.0,39.0,44.0,46.0,47.0,0
2062,CC:2F:71:3F:1F:24,4417082,1169128533,598062,687458824,3819020,481669709,37,497176,558354071,496601,558284745,575,69326,479507,10,598299,48679,34,431,117000.0,39000.0,-67.0,-65.0,-70.0,-67.0,-67.0,-65.0,-70.0,-67.0,-91.0,-94.0,-90.0,-93.0,24.0,29.0,20.0,26.0,0
2063,CC:2F:71:3E:C5:1F,3819716,481754719,696,85010,3819020,481669709,0,2970,248704,2458,187844,512,60860,737,8,1027,18,0,32,144444.0,39000.0,-70.0,-71.0,-67.0,-60.0,-70.0,-71.0,-67.0,-60.0,-91.0,-94.0,-90.0,-93.0,21.0,23.0,23.0,33.0,0
2064,BA:8C:B9:54:50:24,3820759,482508503,1739,838794,3819020,481669709,0,5626,825644,5606,822522,20,3122,1004,14,2114,29,0,49,216660.0,130000.0,-49.0,-35.0,-42.0,-44.0,-42.0,-35.0,-43.0,-48.0,-91.0,-94.0,-90.0,-93.0,42.0,59.0,48.0,49.0,0
2065,92:69:1D:31:68:E9,3822513,485126862,3489,3456749,3819024,481670113,0,3653,933737,3553,911472,100,22265,1797,6,3615,78,0,31,216660.0,130000.0,-52.0,-50.0,-44.0,-46.0,-52.0,-49.0,-43.0,-46.0,-91.0,-94.0,-90.0,-93.0,39.0,44.0,46.0,47.0,0
2066,CC:2F:71:3F:1F:24,4417128,1169143365,598104,687473252,3819024,481670113,37,497204,558359295,496629,558289969,575,69326,479535,10,598341,48681,34,431,130000.0,43333.0,-67.0,-65.0,-71.0,-68.0,-67.0,-65.0,-70.0,-67.0,-91.0,-94.0,-90.0,-93.0,24.0,29.0,19.0,25.0,0
2067,CC:2F:71:3E:C5:1F,3819720,481755123,696,85010,3819024,481670113,0,2970,248704,2458,187844,512,60860,737,8,1027,18,0,32,144444.0,39000.0,-70.0,-71.0,-67.0,-60.0,-70.0,-71.0,-67.0,-60.0,-91.0,-94.0,-90.0,-93.0,21.0,23.0,23.0,33.0,0
2068,BA:8C:B9:54:50:24,3820763,482508907,1739,838794,3819024,481670113,0,5626,825644,5606,822522,20,3122,1004,14,2114,29,0,49,216660.0,130000.0,-49.0,-35.0,-42.0,-44.0,-42.0,-35.0,-43.0,-48.0,-91.0,-94.0,-90.0,-93.0,42.0,59.0,48.0,49.0,0
2069,92:69:1D:31:68:E9,3822518,485127326,3489,3456749,3819029,481670577,0,3653,933737,3553,911472,100,22265,1797,6,3615,78,0,31,216660.0,130000.0,-52.0,-50.0,-44.0,-46.0,-52.0,-49.0,-43.0,-46.0,-91.0,-94.0,-90.0,-93.0,39.0,44.0,46.0,47.0,0
2070,CC:2F:71:3F:1F:24,4417174,1169158245,598145,687487668,3819029,481670577,37,497234,558364775,496659,558295449,575,69326,479565,10,598382,48688,34,431,130000.0,43333.0,-67.0,-65.0,-70.0,-67.0,-67.0,-65.0,-70.0,-67.0,-91.0,-94.0,-90.0,-93.0,24.0,29.0,20.0,26.0,0
2071,CC:2F:71:3E:C5:1F,3819725,481755587,696,85010,3819029,481670577,0,2970,248704,2458,187844,512,60860,737,8,1027,18,0,32,144444.0,39000.0,-70.0,-71.0,-67.0,-60.0,-70.0,-71.0,-67.0,-60.0,-91.0,-94.0,-90.0,-93.0,21.0,23.0,23.0,33.0,0
2072,BA:8C:B9:54:50:24,3820768,482509371,1739,838794,3819029,481670577,0,5626,825644,5606,822522,20,3122,1004,14,2114,29,0,49,216660.0,130000.0,-49.0,-35.0,-42.0,-44.0,-42.0,-35.0,-43.0,-48.0,-91.0,-94.0,-90.0,-93.0,42.0,59.0,48.0,49.0,0
2073,92:69:1D:31:68:E9,3822525,485128181,3490,3456865,3819035,481671316,0,3655,933873,3555,911608,100,22265,1797,6,3616,78,0,31,229410.0,130000.0,-52.0,-50.0,-45.0,-46.0,-51.0,-49.0,-43.0,-46.0,-91.0,-94.0,-90.0,-93.0,39.0,44.0,45.0,47.0,0
2074,CC:2F:71:3F:1F:24,4417225,1169173776,598190,687502460,3819035,481671316,37,497265,558370349,496689,558300905,576,69444,479596,10,598427,48712,34,431,117000.0,39000.0,-67.0,-65.0,-70.0,-68.0,-67.0,-65.0,-70.0,-67.0,-91.0,-94.0,-90.0,-93.0,24.0,29.0,20.0,25.0,0
2075,CC:2F:71:3E:C5:1F,3819732,481756442,697,85126,3819035,481671316,0,2972,248844,2460,187984,512,60860,737,8,1028,18,0,32,144444.0,39000.0,-70.0,-71.0,-68.0,-60.0,-70.0,-71.0,-67.0,-60.0,-91.0,-94.0,-90.0,-93.0,21.0,23.0,22.0,33.0,0
2076,BA:8C:B9:54:50:24,3820775,482510226,1740,838910,3819035,481671316,0,5630,825916,5610,822794,20,3122,1004,14,2115,29,0,49,229410.0,130000.0,-49.0,-35.0,-42.0,-44.0,-42.0,-36.0,-43.0,-47.0,-91.0,-94.0,-90.0,-93.0,42.0,59.0,48.0,49.0,0
2077,92:69:1D:31:68:E9,3822529,485128585,3490,3456865,3819039,481671720,0,3655,933873,3555,911608,100,22265,1797,6,3616,78,0,31,229410.0,130000.0,-52.0,-50.0,-45.0,-46.0,-51.0,-49.0,-43.0,-46.0,-91.0,-94.0,-90.0,-93.0,39.0,44.0,45.0,47.0,0
2078,CC:2F:71:3F:1F:24,4417276,1169189687,598237,687517967,3819039,481671720,37,497301,558376654,496725,558307210,576,69444,479632,10,598474,48716,34,431,130000.0,43333.0,-68.0,-66.0,-71.0,-68.0,-67.0,-65.0,-70.0,-67.0,-91.0,-94.0,-90.0,-93.0,23.0,28.0,19.0,25.0,0
2079,CC:2F:71:3E:C5:1F,3819736,481756846,697,85126,3819039,481671720,0,2972,248844,2460,187984,512,60860,737,8,1028,18,0,32,144444.0,39000.0,-70.0,-71.0,-68.0,-60.0,-70.0,-71.0,-67.0,-60.0,-91.0,-94.0,-90.0,-93.0,21.0,23.0,22.0,33.0,0
2080,BA:8C:B9:54:50:24,3820780,482510690,1740,838910,3819040,481671780,0,5630,825916,5610,822794,20,3122,1004,14,2115,29,0,49,229410.0,130000.0,-49.0,-35.0,-42.0,-44.0,-42.0,-36.0,-43.0,-47.0,-91.0,-94.0,-90.0,-93.0,42.0,59.0,48.0,49.0,0
2081,92:69:1D:31:68:E9,3822535,485129111,3490,3456865,3819045,481672246,0,3655,933873,3555,911608,100,22265,1797,6,3616,78,0,31,229410.0,130000.0,-52.0,-50.0,-45.0,-46.0,-51.0,-49.0,-43.0,-46.0,-91.0,-94.0,-90.0,-93.0,39.0,44.0,45.0,47.0,0
2082,CC:2F:71:3F:1F:24,4417325,1169204827,598280,687532581,3819045,481672246,37,497331,558382110,496755,558312666,576,69444,479662,10,598517,48733,34,431,130000.0,39000.0,-77.0,-75.0,-80.0,-77.0,-74.0,-72.0,-77.0,-74.0,-91.0,-94.0,-90.0,-93.0,14.0,19.0,10.0,16.0,0
2083,CC:2F:71:3E:C5:1F,3819742,481757372,697,85126,3819045,481672246,0,2974,249032,2461,188054,513,60978,738,8,1028,18,0,32,144444.0,39000.0,-70.0,-71.0,-67.0,-60.0,-70.0,-71.0,-67.0,-60.0,-91.0,-94.0,-90.0,-93.0,21.0,23.0,23.0,33.0,0
2084,BA:8C:B9:54:50:24,3820785,482511156,1740,838910,3819045,481672246,0,5630,825916,5610,822794,20,3122,1004,14,2115,29,0,49,229410.0,130000.0,-49.0,-35.0,-42.0,-44.0,-42.0,-36.0,-43.0,-47.0,-91.0,-94.0,-90.0,-93.0,42.0,59.0,48.0,49.0,0
2085,92:69:1D:31:68:E9,3822539,485129515,3490,3456865,3819049,481672650,0,3655,933873,3555,911608,100,22265,1797,6,3616,78,0,31,229410.0,130000.0,-52.0,-50.0,-45.0,-46.0,-51.0,-49.0,-43.0,-46.0,-91.0,-94.0,-90.0,-93.0,39.0,44.0,45.0,47.0,0
2086,CC:2F:71:3F:1F:24,4417373,1169219857,598324,687547207,3819049,481672650,37,497360,558387474,496784,558318030,576,69444,479691,10,598561,48746,34,431,130000.0,43333.0,-68.0,-66.0,-71.0,-68.0,-68.0,-66.0,-71.0,-68.0,-91.0,-94.0,-90.0,-93.0,23.0,28.0,19.0,25.0,0
2087,CC:2F:71:3E:C5:1F,3819746,481757776,697,85126,3819049,481672650,0,2974,249032,2461,188054,513,60978,738,8,1028,18,0,32,144444.0,39000.0,-70.0,-71.0,-67.0,-60.0,-70.0,-71.0,-67.0,-60.0,-91.0,-94.0,-90.0,-93.0,21.0,23.0,23.0,33.0,0
2088,BA:8C:B9:54:50:24,3820789,482511560,1740,838910,3819049,481672650,0,5630,825916,5610,822794,20,3122,1004,14,2115,29,0,49,229410.0,130000.0,-49.0,-35.0,-42.0,-44.0,-42.0,-36.0,-43.0,-47.0,-91.0,-94.0,-90.0,-93.0,42.0,59.0,48.0,49.0,0
2089,92:69:1D:31:68:E9,3822544,485129979,3490,3456865,3819054,481673114,0,3655,933873,3555,911608,100,22265,1797,6,3616,78,0,31,229410.0,130000.0,-52.0,-50.0,-45.0,-46.0,-51.0,-49.0,-43.0,-46.0,-91.0,-94.0,-90.0,-93.0,39.0,44.0,45.0,47.0,0
2090,CC:2F:71:3F:1F:24,4417422,1169234953,598368,687561839,3819054,481673114,37,497390,558392954,496814,558323510,576,69444,479721,10,598605,48754,34,431,130000.0,39000.0,-67.0,-65.0,-70.0,-68.0,-67.0,-65.0,-70.0,-67.0,-91.0,-94.0,-90.0,-93.0,24.0,29.0,20.0,25.0,0
2091,CC:2F:71:3E:C5:1F,3819751,481758240,697,85126,3819054,481673114,0,2974,249032,2461,188054,513,60978,738,8,1028,18,0,32,144444.0,39000.0,-70.0,-71.0,-67.0,-60.0,-70.0,-71.0,-67.0,-60.0,-91.0,-94.0,-90.0,-93.0,21.0,23.0,23.0,33.0,0
2092,BA:8C:B9:54:50:24,3820794,482512024,1740,838910,3819054,481673114,0,5630,825916,5610,822794,20,3122,1004,14,2115,29,0,49,229410.0,130000.0,-49.0,-35.0,-42.0,-44.0,-42.0,-36.0,-43.0,-47.0,-91.0,-94.0,-90.0,-93.0,42.0,59.0,48.0,49.0,0
2093,92:69:1D:31:68:E9,3822548,485130383,3490,3456865,3819058,481673518,0,3655,933873,3555,911608,100,22265,1797,6,3616,78,0,31,229410.0,130000.0,-52.0,-50.0,-45.0,-46.0,-51.0,-49.0,-43.0,-46.0,-91.0,-93.0,-90.0,-93.0,39.0,43.0,45.0,47.0,0
2094,CC:2F:71:3F:1F:24,4417470,1169250101,598412,687576583,3819058,481673518,37,497421,558398586,496845,558329142,576,69444,479752,10,598649,48761,34,431,130000.0,43333.0,-67.0,-65.0,-70.0,-68.0,-67.0,-65.0,-70.0,-68.0,-91.0,-93.0,-90.0,-93.0,24.0,28.0,20.0,25.0,0
2095,CC:2F:71:3E:C5:1F,3819755,481758644,697,85126,3819058,481673518,0,2974,249032,2461,188054,513,60978,738,8,1028,18,0,32,144444.0,39000.0,-70.0,-71.0,-67.0,-60.0,-70.0,-71.0,-67.0,-60.0,-91.0,-93.0,-90.0,-93.0,21.0,22.0,23.0,33.0,0
2096,BA:8C:B9:54:50:24,3820798,482512428,1740,838910,3819058,481673518,0,5630,825916,5610,822794,20,3122,1004,14,2115,29,0,49,229410.0,130000.0,-49.0,-35.0,-42.0,-44.0,-42.0,-36.0,-43.0,-47.0,-91.0,-93.0,-90.0,-93.0,42.0,58.0,48.0,49.0,0
2097,92:69:1D:31:68:E9,3822552,485130787,3490,3456865,3819062,481673922,0,3655,933873,3555,911608,100,22265,1797,6,3616,78,0,31,229410.0,130000.0,-52.0,-50.0,-45.0,-46.0,-51.0,-49.0,-43.0,-46.0,-91.0,-93.0,-90.0,-93.0,39.0,43.0,45.0,47.0,0
2098,CC:2F:71:3F:1F:24,4417518,1169265243,598456,687591321,3819062,481673922,37,497451,558404102,496875,558334658,576,69444,479782,10,598693,48791,34,431,117000.0,39000.0,-67.0,-65.0,-70.0,-67.0,-67.0,-65.0,-70.0,-67.0,-91.0,-93.0,-90.0,-93.0,24.0,28.0,20.0,26.0,0
2099,CC:2F:71:3E:C5:1F,3819759,481759048,697,85126,3819062,481673922,0,2974,249032,2461,188054,513,60978,738,8,1028,18,0,32,144444.0,39000.0,-70.0,-71.0,-67.0,-60.0,-70.0,-71.0,-67.0,-60.0,-91.0,-93.0,-90.0,-93.0,21.0,22.0,23.0,33.0,0
2100,BA:8C:B9:54:50:24,3820802,482512832,1740,838910,3819062,481673922,0,5630,825916,5610,822794,20,3122,1004,14,2115,29,0,49,229410.0,130000.0,-49.0,-35.0,-42.0,-44.0,-42.0,-36.0,-43.0,-47.0,-91.0,-93.0,-90.0,-93.0,42.0,58.0,48.0,49.0,0
2101,92:69:1D:31:68:E9,3822557,485131251,3490,3456865,3819067,481674386,0,3655,933873,3555,911608,100,22265,1797,6,3616,78,0,31,229410.0,130000.0,-52.0,-50.0,-45.0,-46.0,-51.0,-49.0,-43.0,-46.0,-91.0,-93.0,-90.0,-93.0,39.0,43.0,45.0,47.0,0
2102,CC:2F:71:3F:1F:24,4417564,1169279955,598497,687605569,3819067,481674386,37,497480,558409466,496904,558340022,576,69444,479811,10,598734,48797,34,431,130000.0,43333.0,-67.0,-65.0,-70.0,-67.0,-67.0,-65.0,-70.0,-67.0,-91.0,-93.0,-90.0,-93.0,24.0,28.0,20.0,26.0,0
2103,CC:2F:71:3E:C5:1F,3819764,481759512,697,85126,3819067,481674386,0,2974,249032,2461,188054,513,60978,738,8,1028,18,0,32,144444.0,39000.0,-70.0,-71.0,-67.0,-60.0,-70.0,-71.0,-67.0,-60.0,-91.0,-93.0,-90.0,-93.0,21.0,22.0,23.0,33.0,0
2104,BA:8C:B9:54:50:24,3820807,482513296,1740,838910,3819067,481674386,0,5630,825916,5610,822794,20,3122,1004,14,2115,29,0,49,229410.0,130000.0,-49.0,-35.0,-42.0,-44.0,-42.0,-36.0,-43.0,-47.0,-91.0,-93.0,-90.0,-93.0,42.0,58.0,48.0,49.0,0
2105,92:69:1D:31:68:E9,3822561,485131655,3490,3456865,3819071,481674790,0,3655,933873,3555,911608,100,22265,1797,6,3616,78,0,31,229410.0,130000.0,-52.0,-50.0,-45.0,-46.0,-51.0,-49.0,-43.0,-46.0,-91.0,-93.0,-90.0,-93.0,39.0,43.0,45.0,47.0,0
2106,CC:2F:71:3F:1F:24,4417611,1169294967,598540,687620177,3819071,481674790,37,497510,558414946,496934,558345502,576,69444,479841,10,598777,48808,34,431,130000.0,39000.0,-67.0,-65.0,-71.0,-68.0,-67.0,-65.0,-70.0,-67.0,-91.0,-93.0,-90.0,-93.0,24.0,28.0,19.0,25.0,0
2107,CC:2F:71:3E:C5:1F,3819768,481759916,697,85126,3819071,481674790,0,2974,249032,2461,188054,513,60978,738,8,1028,18,0,32,144444.0,39000.0,-70.0,-71.0,-67.0,-60.0,-70.0,-71.0,-67.0,-60.0,-91.0,-93.0,-90.0,-93.0,21.0,22.0,23.0,33.0,0
2108,BA:8C:B9:54:50:24,3820811,482513700,1740,838910,3819071,481674790,0,5630,825916,5610,822794,20,3122,1004,14,2115,29,0,49,229410.0,130000.0,-49.0,-35.0,-42.0,-44.0,-42.0,-36.0,-43.0,-47.0,-91.0,-93.0,-90.0,-93.0,42.0,58.0,48.0,49.0,0
2109,92:69:1D:31:68:E9,3822606,485159539,3530,3484285,3819076,481675254,0,3714,953747,3614,931482,100,22265,1842,6,3656,78,0,31,229410.0,137640.0,-52.0,-50.0,-44.0,-46.0,-52.0,-50.0,-45.0,-50.0,-91.0,-93.0,-90.0,-93.0,39.0,43.0,46.0,47.0,0
2110,CC:2F:71:3F:1F:24,4417659,1169309927,598583,687634673,3819076,481675254,37,497539,558420310,496963,558350866,576,69444,479870,10,598820,48844,34,431,130000.0,43333.0,-67.0,-65.0,-71.0,-68.0,-67.0,-65.0,-70.0,-67.0,-91.0,-93.0,-90.0,-93.0,24.0,28.0,19.0,25.0,0
2111,CC:2F:71:3E:C5:1F,3819773,481760380,697,85126,3819076,481675254,0,2974,249032,2461,188054,513,60978,738,8,1028,18,0,32,144444.0,39000.0,-70.0,-71.0,-67.0,-60.0,-70.0,-71.0,-67.0,-60.0,-91.0,-93.0,-90.0,-93.0,21.0,22.0,23.0,33.0,0
2112,BA:8C:B9:54:50:24,3820816,482514164,1740,838910,3819076,481675254,0,5630,825916,5610,822794,20,3122,1004,14,2115,29,0,49,229410.0,130000.0,-49.0,-35.0,-42.0,-44.0,-42.0,-36.0,-43.0,-47.0,-91.0,-93.0,-90.0,-93.0,42.0,58.0,48.0,49.0,0
2113,92:69:1D:31:68:E9,3822634,485169672,3554,3494014,3819080,481675658,0,3752,967217,3652,944952,100,22265,1867,6,3680,79,0,31,229410.0,137640.0,-52.0,-50.0,-44.0,-46.0,-52.0,-50.0,-45.0,-50.0,-91.0,-93.0,-90.0,-93.0,39.0,43.0,46.0,47.0,0
2114,CC:2F:71:3F:1F:24,4417705,1169324871,598625,687649213,3819080,481675658,37,497569,558425814,496993,558356370,576,69444,479900,10,598862,48849,34,431,130000.0,43333.0,-67.0,-65.0,-70.0,-67.0,-67.0,-65.0,-70.0,-67.0,-91.0,-93.0,-90.0,-93.0,24.0,28.0,20.0,26.0,0
2115,CC:2F:71:3E:C5:1F,3819777,481760784,697,85126,3819080,481675658,0,2974,249032,2461,188054,513,60978,738,8,1028,18,0,32,144444.0,39000.0,-70.0,-71.0,-67.0,-60.0,-70.0,-71.0,-67.0,-60.0,-91.0,-93.0,-90.0,-93.0,21.0,22.0,23.0,33.0,0
2116,BA:8C:B9:54:50:24,3820820,482514568,1740,838910,3819080,481675658,0,5630,825916,5610,822794,20,3122,1004,14,2115,29,0,49,229410.0,130000.0,-49.0,-35.0,-42.0,-44.0,-42.0,-36.0,-43.0,-47.0,-91.0,-93.0,-90.0,-93.0,42.0,58.0,48.0,49.0,0
2117,92:69:1D:31:68:E9,3822638,485170076,3554,3494014,3819084,481676062,0,3752,967217,3652,944952,100,22265,1867,6,3680,79,0,31,229410.0,137640.0,-52.0,-50.0,-44.0,-46.0,-52.0,-50.0,-45.0,-50.0,-91.0,-93.0,-90.0,-93.0,39.0,43.0,46.0,47.0,0
2118,CC:2F:71:3F:1F:24,4417753,1169340013,598669,687663951,3819084,481676062,37,497599,558431294,497023,558361850,576,69444,479930,10,598906,48854,34,431,130000.0,39000.0,-67.0,-65.0,-71.0,-67.0,-67.0,-65.0,-70.0,-67.0,-91.0,-93.0,-90.0,-93.0,24.0,28.0,19.0,26.0,0
2119,CC:2F:71:3E:C5:1F,3819781,481761188,697,85126,3819084,481676062,0,2974,249032,2461,188054,513,60978,738,8,1028,18,0,32,144444.0,39000.0,-70.0,-71.0,-67.0,-60.0,-70.0,-71.0,-67.0,-60.0,-91.0,-93.0,-90.0,-93.0,21.0,22.0,23.0,33.0,0
2120,BA:8C:B9:54:50:24,3820824,482514972,1740,838910,3819084,481676062,0,5630,825916,5610,822794,20,3122,1004,14,2115,29,0,49,229410.0,130000.0,-49.0,-35.0,-42.0,-44.0,-42.0,-36.0,-43.0,-47.0,-91.0,-93.0,-90.0,-93.0,42.0,58.0,48.0,49.0,0
2121,92:69:1D:31:68:E9,3822655,485176139,3554,3494014,3819101,481682125,0,3754,967520,3653,945020,101,22500,1868,6,3680,79,0,31,229410.0,137640.0,-53.0,-51.0,-46.0,-52.0,-52.0,-50.0,-45.0,-49.0,-91.0,-93.0,-90.0,-93.0,38.0,42.0,44.0,41.0,0
2122,CC:2F:71:3F:1F:24,4417812,1169360520,598711,687678395,3819101,481682125,37,497628,558436658,497052,558367214,576,69444,479959,10,598948,48875,34,431,130000.0,39000.0,-67.0,-65.0,-70.0,-67.0,-67.0,-65.0,-70.0,-67.0,-91.0,-93.0,-90.0,-93.0,24.0,28.0,20.0,26.0,0
2123,CC:2F:71:3E:C5:1F,3819798,481767251,697,85126,3819101,481682125,0,2974,249032,2461,188054,513,60978,738,8,1028,18,0,32,144444.0,39000.0,-70.0,-71.0,-67.0,-60.0,-70.0,-71.0,-67.0,-60.0,-91.0,-93.0,-90.0,-93.0,21.0,22.0,23.0,33.0,0
2124,BA:8C:B9:54:50:24,3820843,482521237,1740,838910,3819103,481682327,0,5630,825916,5610,822794,20,3122,1004,14,2115,29,0,49,229410.0,130000.0,-49.0,-35.0,-42.0,-44.0,-42.0,-36.0,-43.0,-47.0,-91.0,-93.0,-90.0,-93.0,42.0,58.0,48.0,49.0,0
2125,92:69:1D:31:68:E9,3822671,485182240,3554,3494014,3819117,481688226,0,3755,967588,3654,945088,101,22500,1868,6,3680,79,0,31,229410.0,137640.0,-52.0,-50.0,-44.0,-46.0,-52.0,-50.0,-45.0,-49.0,-91.0,-93.0,-90.0,-93.0,39.0,43.0,46.0,47.0,0
2126,CC:2F:71:3F:1F:24,4417872,1169381191,598755,687692965,3819117,481688226,37,497658,558442138,497082,558372694,576,69444,479989,10,598992,48889,34,431,130000.0,39000.0,-67.0,-65.0,-71.0,-68.0,-67.0,-65.0,-70.0,-67.0,-91.0,-93.0,-90.0,-93.0,24.0,28.0,19.0,25.0,0
2127,CC:2F:71:3E:C5:1F,3819814,481773352,697,85126,3819117,481688226,0,2974,249032,2461,188054,513,60978,738,8,1028,18,0,32,144444.0,39000.0,-70.0,-71.0,-67.0,-60.0,-70.0,-71.0,-67.0,-60.0,-91.0,-93.0,-90.0,-93.0,21.0,22.0,23.0,33.0,0
2128,BA:8C:B9:54:50:24,3820857,482527136,1740,838910,3819117,481688226,0,5630,825916,5610,822794,20,3122,1004,14,2115,29,0,49,229410.0,130000.0,-49.0,-35.0,-42.0,-44.0,-42.0,-36.0,-43.0,-47.0,-91.0,-93.0,-90.0,-93.0,42.0,58.0,48.0,49.0,0
2129,92:69:1D:31:68:E9,3822675,485182644,3554,3494014,3819121,481688630,0,3755,967588,3654,945088,101,22500,1868,6,3680,79,0,31,229410.0,137640.0,-52.0,-50.0,-44.0,-46.0,-52.0,-50.0,-45.0,-49.0,-91.0,-93.0,-90.0,-93.0,39.0,43.0,46.0,47.0,0
2130,CC:2F:71:3F:1F:24,4417921,1169396401,598800,687707771,3819121,481688630,37,497688,558447670,497112,558378226,576,69444,480019,10,599037,48908,34,431,130000.0,39000.0,-67.0,-65.0,-70.0,-68.0,-67.0,-65.0,-70.0,-67.0,-91.0,-93.0,-90.0,-93.0,24.0,28.0,20.0,25.0,0
2131,CC:2F:71:3E:C5:1F,3819818,481773756,697,85126,3819121,481688630,0,2974,249032,2461,188054,513,60978,738,8,1028,18,0,32,144444.0,39000.0,-70.0,-71.0,-67.0,-60.0,-70.0,-71.0,-67.0,-60.0,-91.0,-93.0,-90.0,-93.0,21.0,22.0,23.0,33.0,0
2132,BA:8C:B9:54:50:24,3820864,482527802,1740,838910,3819124,481688892,0,5630,825916,5610,822794,20,3122,1004,14,2115,29,0,49,229410.0,130000.0,-49.0,-35.0,-42.0,-44.0,-42.0,-36.0,-43.0,-47.0,-91.0,-93.0,-90.0,-93.0,42.0,58.0,48.0,49.0,0
2133,92:69:1D:31:68:E9,3822680,485183108,3554,3494014,3819126,481689094,0,3755,967588,3654,945088,101,22500,1868,6,3680,79,0,31,229410.0,137640.0,-52.0,-50.0,-44.0,-46.0,-52.0,-50.0,-45.0,-49.0,-91.0,-93.0,-90.0,-93.0,39.0,43.0,46.0,47.0,0
2134,CC:2F:71:3F:1F:24,4417968,1169411237,598842,687722143,3819126,481689094,37,497717,558453034,497141,558383590,576,69444,480048,10,599079,48936,34,431,130000.0,43333.0,-67.0,-65.0,-70.0,-67.0,-67.0,-65.0,-70.0,-67.0,-91.0,-93.0,-90.0,-93.0,24.0,28.0,20.0,26.0,0
2135,CC:2F:71:3E:C5:1F,3819823,481774220,697,85126,3819126,481689094,0,2974,249032,2461,188054,513,60978,738,8,1028,18,0,32,144444.0,39000.0,-70.0,-71.0,-67.0,-60.0,-70.0,-71.0,-67.0,-60.0,-91.0,-93.0,-90.0,-93.0,21.0,22.0,23.0,33.0,0
2136,BA:8C:B9:54:50:24,3820866,482528004,1740,838910,3819126,481689094,0,5630,825916,5610,822794,20,3122,1004,14,2115,29,0,49,229410.0,130000.0,-49.0,-35.0,-42.0,-44.0,-42.0,-36.0,-43.0,-47.0,-91.0,-93.0,-90.0,-93.0,42.0,58.0,48.0,49.0,0
2137,92:69:1D:31:68:E9,3822685,485183628,3555,3494130,3819130,481689498,0,3758,967834,3657,945334,101,22500,1869,6,3681,79,0,31,229410.0,137640.0,-52.0,-49.0,-44.0,-46.0,-52.0,-50.0,-44.0,-47.0,-91.0,-93.0,-90.0,-93.0,39.0,44.0,46.0,47.0,0
2138,CC:2F:71:3F:1F:24,4418016,1169426379,598886,687736881,3819130,481689498,37,497746,558458398,497170,558388954,576,69444,480077,10,599123,48961,34,431,130000.0,39000.0,-67.0,-65.0,-70.0,-68.0,-67.0,-65.0,-70.0,-67.0,-91.0,-93.0,-90.0,-93.0,24.0,28.0,20.0,25.0,0
2139,CC:2F:71:3E:C5:1F,3819827,481774624,697,85126,3819130,481689498,0,2974,249032,2461,188054,513,60978,738,8,1028,18,0,32,144444.0,39000.0,-70.0,-71.0,-67.0,-60.0,-70.0,-71.0,-67.0,-60.0,-91.0,-93.0,-90.0,-93.0,21.0,22.0,23.0,33.0,0
2140,BA:8C:B9:54:50:24,3820872,482528610,1740,838910,3819132,481689700,0,5630,825916,5610,822794,20,3122,1004,14,2115,29,0,49,229410.0,130000.0,-49.0,-35.0,-42.0,-44.0,-42.0,-36.0,-43.0,-47.0,-91.0,-93.0,-90.0,-93.0,42.0,58.0,48.0,49.0,0
2141,92:69:1D:31:68:E9,3822692,485184460,3555,3494130,3819137,481690330,0,3758,967834,3657,945334,101,22500,1869,6,3681,79,0,31,229410.0,137640.0,-52.0,-49.0,-44.0,-46.0,-52.0,-50.0,-44.0,-47.0,-91.0,-93.0,-90.0,-93.0,39.0,44.0,46.0,47.0,0
2142,CC:2F:71:3F:1F:24,4418065,1169441583,598928,687751253,3819137,481690330,37,497775,558463762,497199,558394318,576,69444,480106,10,599165,48973,34,431,130000.0,43333.0,-67.0,-65.0,-71.0,-68.0,-67.0,-65.0,-70.0,-67.0,-91.0,-93.0,-90.0,-93.0,24.0,28.0,19.0,25.0,0
2143,CC:2F:71:3E:C5:1F,3819834,481775456,697,85126,3819137,481690330,0,2974,249032,2461,188054,513,60978,738,8,1028,18,0,32,144444.0,39000.0,-70.0,-71.0,-67.0,-60.0,-70.0,-71.0,-67.0,-60.0,-91.0,-93.0,-90.0,-93.0,21.0,22.0,23.0,33.0,0
2144,BA:8C:B9:54:50:24,3820877,482529240,1740,838910,3819137,481690330,0,5630,825916,5610,822794,20,3122,1004,14,2115,29,0,49,229410.0,130000.0,-49.0,-35.0,-42.0,-44.0,-42.0,-36.0,-43.0,-47.0,-91.0,-93.0,-90.0,-93.0,42.0,58.0,48.0,49.0,0
2145,92:69:1D:31:68:E9,3822695,485184730,3555,3494130,3819140,481690600,0,3758,967834,3657,945334,101,22500,1869,6,3681,79,0,31,229410.0,137640.0,-52.0,-49.0,-44.0,-46.0,-52.0,-50.0,-44.0,-47.0,-91.0,-93.0,-90.0,-93.0,39.0,44.0,46.0,47.0,0
2146,CC:2F:71:3F:1F:24,4418112,1169456595,598971,687765861,3819141,481690734,37,497804,558469126,497228,558399682,576,69444,480135,10,599208,49003,34,431,130000.0,39000.0,-67.0,-65.0,-70.0,-67.0,-67.0,-65.0,-70.0,-67.0,-91.0,-93.0,-90.0,-93.0,24.0,28.0,20.0,26.0,0
2147,CC:2F:71:3E:C5:1F,3819838,481775860,697,85126,3819141,481690734,0,2974,249032,2461,188054,513,60978,738,8,1028,18,0,32,144444.0,39000.0,-70.0,-71.0,-67.0,-60.0,-70.0,-71.0,-67.0,-60.0,-91.0,-93.0,-90.0,-93.0,21.0,22.0,23.0,33.0,0
2148,BA:8C:B9:54:50:24,3820883,482529846,1740,838910,3819143,481690936,0,5630,825916,5610,822794,20,3122,1004,14,2115,29,0,49,229410.0,130000.0,-49.0,-35.0,-42.0,-44.0,-42.0,-36.0,-43.0,-47.0,-91.0,-93.0,-90.0,-93.0,42.0,58.0,48.0,49.0,0
2149,92:69:1D:31:68:E9,3822700,485185268,3555,3494130,3819145,481691138,0,3758,967834,3657,945334,101,22500,1869,6,3681,79,0,31,229410.0,137640.0,-52.0,-49.0,-44.0,-46.0,-52.0,-50.0,-44.0,-47.0,-91.0,-93.0,-90.0,-93.0,39.0,44.0,46.0,47.0,0
2150,CC:2F:71:3F:1F:24,4418159,1169471495,599014,687780357,3819145,481691138,37,497833,558474490,497257,558405046,576,69444,480164,10,599251,49021,34,431,130000.0,43333.0,-67.0,-65.0,-70.0,-68.0,-67.0,-65.0,-70.0,-67.0,-91.0,-93.0,-90.0,-93.0,24.0,28.0,20.0,25.0,0
2151,CC:2F:71:3E:C5:1F,3819842,481776264,697,85126,3819145,481691138,0,2974,249032,2461,188054,513,60978,738,8,1028,18,0,32,144444.0,39000.0,-70.0,-71.0,-67.0,-60.0,-70.0,-71.0,-67.0,-60.0,-91.0,-93.0,-90.0,-93.0,21.0,22.0,23.0,33.0,0
2152,BA:8C:B9:54:50:24,3820885,482530048,1740,838910,3819145,481691138,0,5630,825916,5610,822794,20,3122,1004,14,2115,29,0,49,229410.0,130000.0,-49.0,-35.0,-42.0,-44.0,-42.0,-36.0,-43.0,-47.0,-91.0,-93.0,-90.0,-93.0,42.0,58.0,48.0,49.0,0
2153,92:69:1D:31:68:E9,3822703,485185530,3555,3494130,3819148,481691400,0,3758,967834,3657,945334,101,22500,1869,6,3681,79,0,31,229410.0,137640.0,-52.0,-49.0,-44.0,-46.0,-52.0,-50.0,-44.0,-47.0,-91.0,-93.0,-90.0,-93.0,39.0,44.0,46.0,47.0,0
2154,CC:2F:71:3F:1F:24,4418207,1169486629,599057,687795027,3819150,481691602,37,497864,558480150,497288,558410706,576,69444,480195,10,599294,49031,34,431,130000.0,43333.0,-67.0,-65.0,-70.0,-67.0,-67.0,-65.0,-70.0,-67.0,-91.0,-93.0,-90.0,-93.0,24.0,28.0,20.0,26.0,0
2155,CC:2F:71:3E:C5:1F,3819849,481776930,697,85126,3819152,481691804,0,2974,249032,2461,188054,513,60978,738,8,1028,18,0,32,144444.0,39000.0,-70.0,-71.0,-67.0,-60.0,-70.0,-71.0,-67.0,-60.0,-91.0,-93.0,-90.0,-93.0,21.0,22.0,23.0,33.0,0
2156,BA:8C:B9:54:50:24,3820892,482530714,1740,838910,3819152,481691804,0,5630,825916,5610,822794,20,3122,1004,14,2115,29,0,49,229410.0,130000.0,-49.0,-35.0,-42.0,-44.0,-42.0,-36.0,-43.0,-47.0,-90.0,-93.0,-90.0,-93.0,41.0,58.0,48.0,49.0,0
2157,92:69:1D:31:68:E9,3822709,485186136,3555,3494130,3819154,481692006,0,3758,967834,3657,945334,101,22500,1869,6,3681,79,0,31,229410.0,137640.0,-52.0,-49.0,-44.0,-46.0,-52.0,-50.0,-44.0,-47.0,-90.0,-93.0,-90.0,-93.0,38.0,44.0,46.0,47.0,0
2158,CC:2F:71:3F:1F:24,4418255,1169501721,599101,687809715,3819154,481692006,37,497894,558485694,497318,558416250,576,69444,480225,10,599338,49060,34,431,117000.0,39000.0,-67.0,-65.0,-71.0,-68.0,-67.0,-65.0,-70.0,-67.0,-90.0,-93.0,-90.0,-93.0,23.0,28.0,19.0,25.0,0
2159,CC:2F:71:3E:C5:1F,3819851,481777132,697,85126,3819154,481692006,0,2974,249032,2461,188054,513,60978,738,8,1028,18,0,32,144444.0,39000.0,-70.0,-71.0,-67.0,-60.0,-70.0,-71.0,-67.0,-60.0,-90.0,-93.0,-90.0,-93.0,20.0,22.0,23.0,33.0,0
2160,BA:8C:B9:54:50:24,3820894,482530916,1740,838910,3819154,481692006,0,5630,825916,5610,822794,20,3122,1004,14,2115,29,0,49,229410.0,130000.0,-49.0,-35.0,-42.0,-44.0,-42.0,-36.0,-43.0,-47.0,-90.0,-93.0,-90.0,-93.0,41.0,58.0,48.0,49.0,0
2161,92:69:1D:31:68:E9,3822711,485186338,3555,3494130,3819156,481692208,0,3758,967834,3657,945334,101,22500,1869,6,3681,79,0,31,229410.0,137640.0,-52.0,-49.0,-44.0,-46.0,-52.0,-50.0,-44.0,-47.0,-90.0,-93.0,-90.0,-93.0,38.0,44.0,46.0,47.0,0
2162,CC:2F:71:3F:1F:24,4418301,1169516605,599145,687824397,3819156,481692208,37,497924,558491238,497348,558421794,576,69444,480255,10,599382,49067,34,431,130000.0,43333.0,-67.0,-65.0,-70.0,-68.0,-67.0,-65.0,-70.0,-67.0,-90.0,-93.0,-90.0,-93.0,23.0,28.0,20.0,25.0,0
2163,CC:2F:71:3E:C5:1F,3819858,481777798,697,85126,3819161,481692672,0,2974,249032,2461,188054,513,60978,738,8,1028,18,0,32,144444.0,39000.0,-70.0,-71.0,-67.0,-60.0,-70.0,-71.0,-67.0,-60.0,-90.0,-93.0,-90.0,-93.0,20.0,22.0,23.0,33.0,0
2164,BA:8C:B9:54:50:24,3820901,482531582,1740,838910,3819161,481692672,0,5630,825916,5610,822794,20,3122,1004,14,2115,29,0,49,229410.0,130000.0,-49.0,-35.0,-42.0,-44.0,-42.0,-36.0,-43.0,-47.0,-90.0,-93.0,-90.0,-93.0,41.0,58.0,48.0,49.0,0
2165,92:69:1D:31:68:E9,3822718,485187004,3555,3494130,3819163,481692874,0,3758,967834,3657,945334,101,22500,1869,6,3681,79,0,31,229410.0,137640.0,-52.0,-49.0,-44.0,-46.0,-52.0,-50.0,-44.0,-47.0,-90.0,-93.0,-90.0,-93.0,38.0,44.0,46.0,47.0,0
2166,CC:2F:71:3F:1F:24,4418349,1169531631,599186,687838757,3819163,481692874,37,497953,558496602,497377,558427158,576,69444,480284,10,599423,49081,34,431,130000.0,39000.0,-67.0,-65.0,-70.0,-68.0,-67.0,-65.0,-70.0,-67.0,-90.0,-93.0,-90.0,-93.0,23.0,28.0,20.0,25.0,0
2167,CC:2F:71:3E:C5:1F,3819860,481778000,697,85126,3819163,481692874,0,2974,249032,2461,188054,513,60978,738,8,1028,18,0,32,144444.0,39000.0,-70.0,-71.0,-67.0,-60.0,-70.0,-71.0,-67.0,-60.0,-90.0,-93.0,-90.0,-93.0,20.0,22.0,23.0,33.0,0
2168,BA:8C:B9:54:50:24,3820903,482531784,1740,838910,3819163,481692874,0,5630,825916,5610,822794,20,3122,1004,14,2115,29,0,49,229410.0,130000.0,-49.0,-35.0,-42.0,-44.0,-42.0,-36.0,-43.0,-47.0,-90.0,-93.0,-90.0,-93.0,41.0,58.0,48.0,49.0,0
2169,92:69:1D:31:68:E9,3822720,485187206,3555,3494130,3819165,481693076,0,3758,967834,3657,945334,101,22500,1869,6,3681,79,0,31,229410.0,137640.0,-52.0,-49.0,-44.0,-46.0,-52.0,-50.0,-44.0,-47.0,-90.0,-93.0,-90.0,-93.0,38.0,44.0,46.0,47.0,0
2170,CC:2F:71:3F:1F:24,4418394,1169546329,599229,687853253,3819165,481693076,37,497984,558502198,497408,558432754,576,69444,480315,10,599466,49096,34,431,130000.0,43333.0,-67.0,-65.0,-71.0,-68.0,-67.0,-65.0,-70.0,-67.0,-90.0,-93.0,-90.0,-93.0,23.0,28.0,19.0,25.0,0
2171,CC:2F:71:3E:C5:1F,3819865,481778538,697,85126,3819168,481693412,0,2974,249032,2461,188054,513,60978,738,8,1028,18,0,32,144444.0,39000.0,-70.0,-71.0,-67.0,-60.0,-70.0,-71.0,-67.0,-60.0,-90.0,-93.0,-90.0,-93.0,20.0,22.0,23.0,33.0,0
2172,BA:8C:B9:54:50:24,3820909,482532390,1740,838910,3819169,481693480,0,5630,825916,5610,822794,20,3122,1004,14,2115,29,0,49,229410.0,130000.0,-49.0,-35.0,-42.0,-44.0,-42.0,-36.0,-43.0,-47.0,-90.0,-93.0,-90.0,-93.0,41.0,58.0,48.0,49.0,0
2173,92:69:1D:31:68:E9,3822727,485187872,3555,3494130,3819172,481693742,0,3758,967834,3657,945334,101,22500,1869,6,3681,79,0,31,229410.0,137640.0,-52.0,-49.0,-44.0,-46.0,-52.0,-50.0,-44.0,-47.0,-90.0,-93.0,-90.0,-93.0,38.0,44.0,46.0,47.0,0
2174,CC:2F:71:3F:1F:24,4418446,1169561919,599274,687868177,3819172,481693742,37,498014,558507678,497438,558438234,576,69444,480345,10,599511,49101,34,431,130000.0,43333.0,-67.0,-65.0,-70.0,-67.0,-67.0,-65.0,-70.0,-67.0,-90.0,-93.0,-90.0,-93.0,23.0,28.0,20.0,26.0,0
2175,CC:2F:71:3E:C5:1F,3819869,481778868,697,85126,3819172,481693742,0,2974,249032,2461,188054,513,60978,738,8,1028,18,0,32,144444.0,39000.0,-70.0,-71.0,-67.0,-60.0,-70.0,-71.0,-67.0,-60.0,-90.0,-93.0,-90.0,-93.0,20.0,22.0,23.0,33.0,0
2176,BA:8C:B9:54:50:24,3820912,482532652,1740,838910,3819172,481693742,0,5630,825916,5610,822794,20,3122,1004,14,2115,29,0,49,229410.0,130000.0,-49.0,-35.0,-42.0,-44.0,-42.0,-36.0,-43.0,-47.0,-90.0,-93.0,-90.0,-93.0,41.0,58.0,48.0,49.0,0
2177,92:69:1D:31:68:E9,3822731,485188463,3556,3494246,3819175,481694217,0,3760,967970,3659,945470,101,22500,1869,6,3682,79,0,31,229410.0,137640.0,-51.0,-47.0,-42.0,-49.0,-52.0,-49.0,-44.0,-47.0,-90.0,-93.0,-90.0,-93.0,39.0,46.0,48.0,44.0,0
2178,CC:2F:71:3F:1F:24,4418496,1169577450,599319,687883031,3819177,481694419,37,498044,558513158,497468,558443714,576,69444,480375,10,599556,49119,34,431,130000.0,39000.0,-67.0,-65.0,-70.0,-67.0,-67.0,-65.0,-70.0,-67.0,-90.0,-93.0,-90.0,-93.0,23.0,28.0,20.0,26.0,0
2179,CC:2F:71:3E:C5:1F,3819879,481780374,702,85955,3819177,481694419,0,2980,249847,2467,188869,513,60978,743,8,1033,18,0,32,144444.0,39000.0,-70.0,-71.0,-67.0,-60.0,-70.0,-70.0,-67.0,-60.0,-90.0,-93.0,-90.0,-93.0,20.0,22.0,23.0,33.0,0
2180,BA:8C:B9:54:50:24,3820920,482533591,1741,838970,3819179,481694621,0,5632,826052,5612,822930,20,3122,1004,14,2116,29,0,49,229410.0,130000.0,-49.0,-35.0,-42.0,-44.0,-43.0,-35.0,-42.0,-47.0,-90.0,-93.0,-90.0,-93.0,41.0,58.0,48.0,49.0,0
2181,92:69:1D:31:68:E9,3822737,485189069,3556,3494246,3819181,481694823,0,3760,967970,3659,945470,101,22500,1869,6,3682,79,0,31,229410.0,137640.0,-51.0,-47.0,-42.0,-49.0,-52.0,-49.0,-44.0,-47.0,-90.0,-93.0,-90.0,-93.0,39.0,46.0,48.0,44.0,0
2182,CC:2F:71:3F:1F:24,4418542,1169592232,599361,687897409,3819181,481694823,37,498073,558518522,497497,558449078,576,69444,480404,10,599598,49146,34,431,130000.0,43333.0,-67.0,-65.0,-70.0,-68.0,-67.0,-65.0,-70.0,-67.0,-90.0,-93.0,-90.0,-93.0,23.0,28.0,20.0,25.0,0
2183,CC:2F:71:3E:C5:1F,3819883,481780778,702,85955,3819181,481694823,0,2980,249847,2467,188869,513,60978,743,8,1033,18,0,32,144444.0,39000.0,-70.0,-71.0,-67.0,-60.0,-70.0,-70.0,-67.0,-60.0,-90.0,-93.0,-90.0,-93.0,20.0,22.0,23.0,33.0,0
2184,BA:8C:B9:54:50:24,3820922,482533793,1741,838970,3819181,481694823,0,5632,826052,5612,822930,20,3122,1004,14,2116,29,0,49,229410.0,130000.0,-49.0,-35.0,-42.0,-44.0,-43.0,-35.0,-42.0,-47.0,-90.0,-93.0,-90.0,-93.0,41.0,58.0,48.0,49.0,0
2185,92:69:1D:31:68:E9,3822741,485189393,3556,3494246,3819185,481695147,0,3763,968174,3662,945674,101,22500,1869,6,3682,79,0,31,229410.0,137640.0,-52.0,-50.0,-44.0,-46.0,-51.0,-49.0,-44.0,-46.0,-90.0,-93.0,-90.0,-93.0,38.0,43.0,46.0,47.0,0
2186,CC:2F:71:3F:1F:24,4418591,1169607366,599404,687912017,3819187,481695349,37,498102,558523886,497526,558454442,576,69444,480433,10,599641,49149,34,431,130000.0,39000.0,-67.0,-65.0,-71.0,-67.0,-67.0,-65.0,-70.0,-67.0,-90.0,-93.0,-90.0,-93.0,23.0,28.0,19.0,26.0,0
2187,CC:2F:71:3E:C5:1F,3819889,481781304,702,85955,3819187,481695349,0,2982,250035,2468,188939,514,61096,744,8,1033,18,0,32,144444.0,39000.0,-70.0,-71.0,-67.0,-60.0,-70.0,-70.0,-67.0,-60.0,-90.0,-93.0,-90.0,-93.0,20.0,22.0,23.0,33.0,0
2188,BA:8C:B9:54:50:24,3820930,482534521,1741,838970,3819189,481695551,0,5633,826120,5613,822998,20,3122,1004,14,2116,29,0,49,229410.0,130000.0,-39.0,-37.0,-44.0,-51.0,-43.0,-35.0,-42.0,-47.0,-90.0,-93.0,-90.0,-93.0,51.0,56.0,46.0,42.0,0
2189,92:69:1D:31:68:E9,3822747,485189999,3556,3494246,3819191,481695753,0,3763,968174,3662,945674,101,22500,1869,6,3682,79,0,31,229410.0,137640.0,-52.0,-50.0,-44.0,-46.0,-51.0,-49.0,-44.0,-46.0,-90.0,-93.0,-90.0,-93.0,38.0,43.0,46.0,47.0,0
2190,CC:2F:71:3F:1F:24,4418636,1169622074,599445,687926321,3819191,481695753,37,498132,558529366,497556,558459922,576,69444,480463,10,599682,49167,34,431,130000.0,39000.0,-67.0,-65.0,-70.0,-68.0,-67.0,-65.0,-70.0,-67.0,-90.0,-93.0,-90.0,-93.0,23.0,28.0,20.0,25.0,0
2191,CC:2F:71:3E:C5:1F,3819893,481781708,702,85955,3819191,481695753,0,2982,250035,2468,188939,514,61096,744,8,1033,18,0,32,144444.0,39000.0,-70.0,-71.0,-67.0,-60.0,-70.0,-70.0,-67.0,-60.0,-90.0,-93.0,-90.0,-93.0,20.0,22.0,23.0,33.0,0
2192,BA:8C:B9:54:50:24,3820932,482534723,1741,838970,3819191,481695753,0,5633,826120,5613,822998,20,3122,1004,14,2116,29,0,49,229410.0,130000.0,-39.0,-37.0,-44.0,-51.0,-43.0,-35.0,-42.0,-47.0,-90.0,-93.0,-90.0,-93.0,51.0,56.0,46.0,42.0,0
2193,92:69:1D:31:68:E9,3822752,485190463,3556,3494246,3819196,481696217,0,3763,968174,3662,945674,101,22500,1869,6,3682,79,0,31,229410.0,137640.0,-52.0,-50.0,-44.0,-46.0,-51.0,-49.0,-44.0,-46.0,-90.0,-93.0,-90.0,-93.0,38.0,43.0,46.0,47.0,0
2194,CC:2F:71:3F:1F:24,4418684,1169637152,599488,687940935,3819196,481696217,37,498161,558534730,497585,558465286,576,69444,480492,10,599725,49178,34,431,130000.0,43333.0,-67.0,-65.0,-70.0,-68.0,-67.0,-65.0,-70.0,-67.0,-90.0,-93.0,-90.0,-93.0,23.0,28.0,20.0,25.0,0
2195,CC:2F:71:3E:C5:1F,3819898,481782172,702,85955,3819196,481696217,0,2982,250035,2468,188939,514,61096,744,8,1033,18,0,32,144444.0,39000.0,-70.0,-71.0,-67.0,-60.0,-70.0,-70.0,-67.0,-60.0,-90.0,-93.0,-90.0,-93.0,20.0,22.0,23.0,33.0,0
2196,BA:8C:B9:54:50:24,3820937,482535187,1741,838970,3819196,481696217,0,5633,826120,5613,822998,20,3122,1004,14,2116,29,0,49,229410.0,130000.0,-39.0,-37.0,-44.0,-51.0,-43.0,-35.0,-42.0,-47.0,-90.0,-93.0,-90.0,-93.0,51.0,56.0,46.0,42.0,0
2197,92:69:1D:31:68:E9,3822756,485190867,3556,3494246,3819200,481696621,0,3763,968174,3662,945674,101,22500,1869,6,3682,79,0,31,229410.0,137640.0,-52.0,-50.0,-44.0,-46.0,-51.0,-49.0,-44.0,-46.0,-90.0,-93.0,-90.0,-93.0,38.0,43.0,46.0,47.0,0
2198,CC:2F:71:3F:1F:24,4418731,1169652248,599531,687955627,3819200,481696621,37,498191,558540222,497615,558470778,576,69444,480522,10,599768,49197,34,431,117000.0,39000.0,-67.0,-65.0,-70.0,-68.0,-67.0,-65.0,-70.0,-67.0,-90.0,-93.0,-90.0,-93.0,23.0,28.0,20.0,25.0,0
2199,CC:2F:71:3E:C5:1F,3819902,481782576,702,85955,3819200,481696621,0,2982,250035,2468,188939,514,61096,744,8,1033,18,0,32,144444.0,39000.0,-70.0,-71.0,-67.0,-60.0,-70.0,-70.0,-67.0,-60.0,-90.0,-93.0,-90.0,-93.0,20.0,22.0,23.0,33.0,0
2200,BA:8C:B9:54:50:24,3820941,482535591,1741,838970,3819200,481696621,0,5633,826120,5613,822998,20,3122,1004,14,2116,29,0,49,229410.0,130000.0,-39.0,-37.0,-44.0,-51.0,-43.0,-35.0,-42.0,-47.0,-90.0,-93.0,-90.0,-93.0,51.0,56.0,46.0,42.0,0
2201,92:69:1D:31:68:E9,3822760,485191271,3556,3494246,3819204,481697025,0,3763,968174,3662,945674,101,22500,1869,6,3682,79,0,31,229410.0,137640.0,-52.0,-50.0,-44.0,-46.0,-51.0,-49.0,-44.0,-46.0,-90.0,-93.0,-90.0,-93.0,38.0,43.0,46.0,47.0,0
2202,CC:2F:71:3F:1F:24,4418780,1169667426,599576,687970401,3819204,481697025,37,498222,558545806,497646,558476362,576,69444,480553,10,599813,49208,34,431,130000.0,39000.0,-67.0,-65.0,-70.0,-67.0,-67.0,-65.0,-70.0,-67.0,-90.0,-93.0,-90.0,-93.0,23.0,28.0,20.0,26.0,0
2203,CC:2F:71:3E:C5:1F,3819907,481783096,703,86071,3819204,481697025,0,2983,250141,2469,189045,514,61096,745,8,1034,18,0,32,144444.0,39000.0,-70.0,-71.0,-67.0,-60.0,-70.0,-71.0,-67.0,-60.0,-90.0,-93.0,-90.0,-93.0,20.0,22.0,23.0,33.0,0
2204,BA:8C:B9:54:50:24,3820945,482535995,1741,838970,3819204,481697025,0,5633,826120,5613,822998,20,3122,1004,14,2116,29,0,49,229410.0,130000.0,-39.0,-37.0,-44.0,-51.0,-43.0,-35.0,-42.0,-47.0,-90.0,-93.0,-90.0,-93.0,51.0,56.0,46.0,42.0,0
2205,92:69:1D:31:68:E9,3822765,485191735,3556,3494246,3819209,481697489,0,3763,968174,3662,945674,101,22500,1869,6,3682,79,0,31,229410.0,137640.0,-52.0,-50.0,-44.0,-46.0,-51.0,-49.0,-44.0,-46.0,-90.0,-93.0,-90.0,-93.0,38.0,43.0,46.0,47.0,0
2206,CC:2F:71:3F:1F:24,4418826,1169682138,599617,687984649,3819209,481697489,37,498251,558551170,497675,558481726,576,69444,480582,10,599854,49254,34,431,130000.0,43333.0,-67.0,-65.0,-70.0,-67.0,-67.0,-65.0,-70.0,-67.0,-90.0,-93.0,-90.0,-93.0,23.0,28.0,20.0,26.0,0
2207,CC:2F:71:3E:C5:1F,3819913,481783676,704,86187,3819209,481697489,0,2987,250457,2473,189361,514,61096,746,8,1035,18,0,32,144444.0,43333.0,-70.0,-71.0,-67.0,-59.0,-70.0,-71.0,-67.0,-59.0,-90.0,-93.0,-90.0,-93.0,20.0,22.0,23.0,34.0,0
2208,BA:8C:B9:54:50:24,3820951,482536521,1741,838970,3819210,481697551,0,5633,826120,5613,822998,20,3122,1004,14,2116,29,0,49,229410.0,130000.0,-39.0,-37.0,-44.0,-51.0,-43.0,-35.0,-42.0,-47.0,-90.0,-93.0,-90.0,-93.0,51.0,56.0,46.0,42.0,0
2209,92:69:1D:31:68:E9,3822770,485192201,3556,3494246,3819214,481697955,0,3763,968174,3662,945674,101,22500,1869,6,3682,79,0,31,229410.0,137640.0,-52.0,-50.0,-44.0,-46.0,-51.0,-49.0,-44.0,-46.0,-90.0,-93.0,-90.0,-93.0,38.0,43.0,46.0,47.0,0
2210,CC:2F:71:3F:1F:24,4418876,1169697522,599662,687999567,3819214,481697955,37,498281,558556652,497704,558487090,577,69562,480612,10,599899,49259,34,431,130000.0,43333.0,-67.0,-65.0,-70.0,-67.0,-67.0,-65.0,-70.0,-67.0,-90.0,-93.0,-90.0,-93.0,23.0,28.0,20.0,26.0,0
2211,CC:2F:71:3E:C5:1F,3819918,481784142,704,86187,3819214,481697955,0,2987,250457,2473,189361,514,61096,746,8,1035,18,0,32,144444.0,43333.0,-70.0,-71.0,-67.0,-59.0,-70.0,-71.0,-67.0,-59.0,-90.0,-93.0,-90.0,-93.0,20.0,22.0,23.0,34.0,0
2212,BA:8C:B9:54:50:24,3820955,482536925,1741,838970,3819214,481697955,0,5633,826120,5613,822998,20,3122,1004,14,2116,29,0,49,229410.0,130000.0,-39.0,-37.0,-44.0,-51.0,-43.0,-35.0,-42.0,-47.0,-90.0,-93.0,-90.0,-93.0,51.0,56.0,46.0,42.0,0
2213,92:69:1D:31:68:E9,3822774,485192605,3556,3494246,3819218,481698359,0,3763,968174,3662,945674,101,22500,1869,6,3682,79,0,31,229410.0,137640.0,-52.0,-50.0,-44.0,-46.0,-51.0,-49.0,-44.0,-46.0,-90.0,-93.0,-90.0,-93.0,38.0,43.0,46.0,47.0,0
2214,CC:2F:71:3F:1F:24,4418922,1169712404,599704,688014045,3819218,481698359,37,498310,558562016,497733,558492454,577,69562,480641,10,599941,49282,34,431,130000.0,39000.0,-67.0,-65.0,-71.0,-67.0,-67.0,-65.0,-70.0,-67.0,-90.0,-93.0,-90.0,-93.0,23.0,28.0,19.0,26.0,0
2215,CC:2F:71:3E:C5:1F,3819923,481784606,704,86187,3819219,481698419,0,2987,250457,2473,189361,514,61096,746,8,1035,18,0,32,144444.0,43333.0,-70.0,-71.0,-67.0,-59.0,-70.0,-71.0,-67.0,-59.0,-90.0,-93.0,-90.0,-93.0,20.0,22.0,23.0,34.0,0
2216,BA:8C:B9:54:50:24,3820961,482537515,1741,838970,3819220,481698545,0,5633,826120,5613,822998,20,3122,1004,14,2116,29,0,49,229410.0,130000.0,-39.0,-37.0,-44.0,-51.0,-43.0,-35.0,-42.0,-47.0,-90.0,-93.0,-90.0,-93.0,51.0,56.0,46.0,42.0,0
2217,92:69:1D:31:68:E9,3822780,485193195,3556,3494246,3819224,481698949,0,3763,968174,3662,945674,101,22500,1869,6,3682,79,0,31,229410.0,137640.0,-52.0,-50.0,-44.0,-46.0,-51.0,-49.0,-44.0,-46.0,-90.0,-93.0,-90.0,-93.0,38.0,43.0,46.0,47.0,0
2218,CC:2F:71:3F:1F:24,4418970,1169727366,599746,688028417,3819224,481698949,37,498341,558567636,497764,558498074,577,69562,480672,10,599983,49302,34,431,130000.0,43333.0,-67.0,-65.0,-70.0,-68.0,-67.0,-65.0,-70.0,-67.0,-90.0,-93.0,-90.0,-93.0,23.0,28.0,20.0,25.0,0
2219,CC:2F:71:3E:C5:1F,3819928,481785136,704,86187,3819224,481698949,0,2987,250457,2473,189361,514,61096,746,8,1035,18,0,32,144444.0,43333.0,-70.0,-71.0,-67.0,-59.0,-70.0,-71.0,-67.0,-59.0,-90.0,-93.0,-90.0,-93.0,20.0,22.0,23.0,34.0,0
2220,BA:8C:B9:54:50:24,3820965,482537919,1741,838970,3819224,481698949,0,5633,826120,5613,822998,20,3122,1004,14,2116,29,0,49,229410.0,130000.0,-39.0,-37.0,-44.0,-51.0,-43.0,-35.0,-42.0,-47.0,-90.0,-93.0,-90.0,-93.0,51.0,56.0,46.0,42.0,0
2221,92:69:1D:31:68:E9,3822784,485193599,3556,3494246,3819228,481699353,0,3763,968174,3662,945674,101,22500,1869,6,3682,79,0,31,229410.0,137640.0,-52.0,-50.0,-44.0,-46.0,-51.0,-49.0,-44.0,-46.0,-90.0,-93.0,-90.0,-93.0,38.0,43.0,46.0,47.0,0
2222,CC:2F:71:3F:1F:24,4419017,1169742378,599789,688043025,3819228,481699353,37,498370,558573000,497793,558503438,577,69562,480701,10,600026,49315,34,431,130000.0,39000.0,-67.0,-65.0,-70.0,-67.0,-67.0,-65.0,-70.0,-67.0,-90.0,-93.0,-90.0,-93.0,23.0,28.0,20.0,26.0,0
2223,CC:2F:71:3E:C5:1F,3819932,481785540,704,86187,3819228,481699353,0,2987,250457,2473,189361,514,61096,746,8,1035,18,0,32,144444.0,43333.0,-70.0,-71.0,-67.0,-59.0,-70.0,-71.0,-67.0,-59.0,-90.0,-93.0,-90.0,-93.0,20.0,22.0,23.0,34.0,0
2224,BA:8C:B9:54:50:24,3820969,482538323,1741,838970,3819228,481699353,0,5633,826120,5613,822998,20,3122,1004,14,2116,29,0,49,229410.0,130000.0,-39.0,-37.0,-44.0,-51.0,-43.0,-35.0,-42.0,-47.0,-90.0,-93.0,-90.0,-93.0,51.0,56.0,46.0,42.0,0
2225,92:69:1D:31:68:E9,3822789,485194063,3556,3494246,3819233,481699817,0,3763,968174,3662,945674,101,22500,1869,6,3682,79,0,31,229410.0,137640.0,-52.0,-50.0,-44.0,-46.0,-51.0,-49.0,-44.0,-46.0,-90.0,-93.0,-90.0,-93.0,38.0,43.0,46.0,47.0,0
2226,CC:2F:71:3F:1F:24,4419066,1169757524,599833,688057707,3819233,481699817,37,498399,558578364,497822,558508802,577,69562,480730,10,600070,49348,34,431,144444.0,43333.0,-67.0,-65.0,-70.0,-68.0,-67.0,-65.0,-70.0,-67.0,-90.0,-93.0,-90.0,-93.0,23.0,28.0,20.0,25.0,0
2227,CC:2F:71:3E:C5:1F,3819937,481786004,704,86187,3819233,481699817,0,2987,250457,2473,189361,514,61096,746,8,1035,18,0,32,144444.0,43333.0,-70.0,-71.0,-67.0,-59.0,-70.0,-71.0,-67.0,-59.0,-90.0,-93.0,-90.0,-93.0,20.0,22.0,23.0,34.0,0
2228,BA:8C:B9:54:50:24,3820974,482538787,1741,838970,3819233,481699817,0,5633,826120,5613,822998,20,3122,1004,14,2116,29,0,49,229410.0,130000.0,-39.0,-37.0,-44.0,-51.0,-43.0,-35.0,-42.0,-47.0,-90.0,-93.0,-90.0,-93.0,51.0,56.0,46.0,42.0,0
2229,92:69:1D:31:68:E9,3822794,485194740,3556,3494246,3819238,481700494,0,3763,968174,3662,945674,101,22500,1869,6,3682,79,0,31,229410.0,137640.0,-52.0,-50.0,-44.0,-46.0,-51.0,-49.0,-44.0,-46.0,-90.0,-93.0,-90.0,-93.0,38.0,43.0,46.0,47.0,0
2230,CC:2F:71:3F:1F:24,4419114,1169772809,599876,688072315,3819238,481700494,37,498428,558583728,497851,558514166,577,69562,480759,10,600113,49365,34,431,130000.0,43333.0,-67.0,-65.0,-71.0,-68.0,-67.0,-65.0,-70.0,-67.0,-90.0,-93.0,-90.0,-93.0,23.0,28.0,19.0,25.0,0
2231,CC:2F:71:3E:C5:1F,3819942,481786681,704,86187,3819238,481700494,0,2987,250457,2473,189361,514,61096,746,8,1035,18,0,32,144444.0,43333.0,-70.0,-71.0,-67.0,-59.0,-70.0,-71.0,-67.0,-59.0,-90.0,-93.0,-90.0,-93.0,20.0,22.0,23.0,34.0,0
2232,BA:8C:B9:54:50:24,3820979,482539464,1741,838970,3819238,481700494,0,5633,826120,5613,822998,20,3122,1004,14,2116,29,0,49,229410.0,130000.0,-39.0,-37.0,-44.0,-51.0,-43.0,-35.0,-42.0,-47.0,-90.0,-93.0,-90.0,-93.0,51.0,56.0,46.0,42.0,0
2233,92:69:1D:31:68:E9,3822798,485195144,3556,3494246,3819242,481700898,0,3763,968174,3662,945674,101,22500,1869,6,3682,79,0,31,229410.0,137640.0,-52.0,-50.0,-44.0,-46.0,-51.0,-49.0,-44.0,-46.0,-90.0,-93.0,-90.0,-93.0,38.0,43.0,46.0,47.0,0
2234,CC:2F:71:3F:1F:24,4419160,1169787641,599918,688086743,3819242,481700898,37,498458,558589208,497881,558519646,577,69562,480789,10,600155,49385,34,431,117000.0,39000.0,-67.0,-65.0,-70.0,-68.0,-67.0,-65.0,-70.0,-67.0,-90.0,-93.0,-90.0,-93.0,23.0,28.0,20.0,25.0,0
2235,CC:2F:71:3E:C5:1F,3819946,481787085,704,86187,3819242,481700898,0,2987,250457,2473,189361,514,61096,746,8,1035,18,0,32,144444.0,43333.0,-70.0,-71.0,-67.0,-59.0,-70.0,-71.0,-67.0,-59.0,-90.0,-93.0,-90.0,-93.0,20.0,22.0,23.0,34.0,0
2236,BA:8C:B9:54:50:24,3820983,482539868,1741,838970,3819242,481700898,0,5633,826120,5613,822998,20,3122,1004,14,2116,29,0,49,229410.0,130000.0,-39.0,-37.0,-44.0,-51.0,-43.0,-35.0,-42.0,-47.0,-90.0,-93.0,-90.0,-93.0,51.0,56.0,46.0,42.0,0
2237,92:69:1D:31:68:E9,3822803,485195608,3556,3494246,3819247,481701362,0,3763,968174,3662,945674,101,22500,1869,6,3682,79,0,31,229410.0,137640.0,-52.0,-50.0,-44.0,-46.0,-51.0,-49.0,-44.0,-46.0,-90.0,-93.0,-90.0,-93.0,38.0,43.0,46.0,47.0,0
2238,CC:2F:71:3F:1F:24,4419207,1169802533,599960,688101171,3819247,481701362,37,498487,558594572,497910,558525010,577,69562,480818,10,600197,49388,34,431,130000.0,43333.0,-67.0,-65.0,-70.0,-67.0,-67.0,-65.0,-70.0,-67.0,-90.0,-93.0,-90.0,-93.0,23.0,28.0,20.0,26.0,0
2239,CC:2F:71:3E:C5:1F,3819951,481787549,704,86187,3819247,481701362,0,2987,250457,2473,189361,514,61096,746,8,1035,18,0,32,144444.0,43333.0,-70.0,-71.0,-67.0,-59.0,-70.0,-71.0,-67.0,-59.0,-90.0,-93.0,-90.0,-93.0,20.0,22.0,23.0,34.0,0
2240,BA:8C:B9:54:50:24,3820988,482540332,1741,838970,3819247,481701362,0,5633,826120,5613,822998,20,3122,1004,14,2116,29,0,49,229410.0,130000.0,-39.0,-37.0,-44.0,-51.0,-43.0,-35.0,-42.0,-47.0,-90.0,-93.0,-90.0,-93.0,51.0,56.0,46.0,42.0,0
2241,92:69:1D:31:68:E9,3822807,485196012,3556,3494246,3819251,481701766,0,3763,968174,3662,945674,101,22500,1869,6,3682,79,0,31,229410.0,137640.0,-52.0,-50.0,-44.0,-46.0,-51.0,-49.0,-44.0,-46.0,-90.0,-93.0,-90.0,-93.0,38.0,43.0,46.0,47.0,0
2242,CC:2F:71:3F:1F:24,4419255,1169817731,600004,688115965,3819251,481701766,37,498516,558599936,497939,558530374,577,69562,480847,10,600241,49390,34,431,130000.0,43333.0,-67.0,-65.0,-71.0,-67.0,-67.0,-65.0,-70.0,-67.0,-90.0,-93.0,-90.0,-93.0,23.0,28.0,19.0,26.0,0
2243,CC:2F:71:3E:C5:1F,3819955,481787953,704,86187,3819251,481701766,0,2987,250457,2473,189361,514,61096,746,8,1035,18,0,32,144444.0,43333.0,-70.0,-71.0,-67.0,-59.0,-70.0,-71.0,-67.0,-59.0,-90.0,-93.0,-90.0,-93.0,20.0,22.0,23.0,34.0,0
2244,BA:8C:B9:54:50:24,3820992,482540736,1741,838970,3819251,481701766,0,5633,826120,5613,822998,20,3122,1004,14,2116,29,0,49,229410.0,130000.0,-39.0,-37.0,-44.0,-51.0,-43.0,-35.0,-42.0,-47.0,-90.0,-93.0,-90.0,-93.0,51.0,56.0,46.0,42.0,0
2245,92:69:1D:31:68:E9,3822811,485196416,3556,3494246,3819255,481702170,0,3763,968174,3662,945674,101,22500,1869,6,3682,79,0,31,229410.0,137640.0,-52.0,-50.0,-44.0,-46.0,-51.0,-49.0,-44.0,-46.0,-90.0,-93.0,-90.0,-93.0,38.0,43.0,46.0,47.0,0
2246,CC:2F:71:3F:1F:24,4419303,1169832753,600047,688130523,3819256,481702230,37,498545,558605300,497968,558535738,577,69562,480876,10,600284,49417,34,431,117000.0,39000.0,-67.0,-65.0,-70.0,-67.0,-67.0,-65.0,-70.0,-67.0,-90.0,-93.0,-90.0,-93.0,23.0,28.0,20.0,26.0,0
2247,CC:2F:71:3E:C5:1F,3819960,481788417,704,86187,3819256,481702230,0,2987,250457,2473,189361,514,61096,746,8,1035,18,0,32,144444.0,43333.0,-70.0,-71.0,-67.0,-59.0,-70.0,-71.0,-67.0,-59.0,-90.0,-93.0,-90.0,-93.0,20.0,22.0,23.0,34.0,0
2248,BA:8C:B9:54:50:24,3820997,482541200,1741,838970,3819256,481702230,0,5633,826120,5613,822998,20,3122,1004,14,2116,29,0,49,229410.0,130000.0,-39.0,-37.0,-44.0,-51.0,-43.0,-35.0,-42.0,-47.0,-90.0,-93.0,-90.0,-93.0,51.0,56.0,46.0,42.0,0
2249,92:69:1D:31:68:E9,3822816,485196880,3556,3494246,3819260,481702634,0,3763,968174,3662,945674,101,22500,1869,6,3682,79,0,31,229410.0,137640.0,-52.0,-50.0,-44.0,-46.0,-51.0,-49.0,-44.0,-46.0,-90.0,-93.0,-90.0,-93.0,38.0,43.0,46.0,47.0,0
2250,CC:2F:71:3F:1F:24,4419350,1169847709,600090,688145075,3819260,481702634,37,498575,558610804,497998,558541242,577,69562,480906,10,600327,49421,34,431,130000.0,43333.0,-67.0,-65.0,-71.0,-68.0,-67.0,-65.0,-70.0,-67.0,-90.0,-93.0,-90.0,-93.0,23.0,28.0,19.0,25.0,0
2251,CC:2F:71:3E:C5:1F,3819964,481788821,704,86187,3819260,481702634,0,2987,250457,2473,189361,514,61096,746,8,1035,18,0,32,144444.0,43333.0,-70.0,-71.0,-67.0,-59.0,-70.0,-71.0,-67.0,-59.0,-90.0,-93.0,-90.0,-93.0,20.0,22.0,23.0,34.0,0
2252,BA:8C:B9:54:50:24,3821001,482541604,1741,838970,3819260,481702634,0,5633,826120,5613,822998,20,3122,1004,14,2116,29,0,49,229410.0,130000.0,-39.0,-37.0,-44.0,-51.0,-43.0,-35.0,-42.0,-47.0,-90.0,-93.0,-90.0,-93.0,51.0,56.0,46.0,42.0,0
2253,92:69:1D:31:68:E9,3822820,485197284,3556,3494246,3819264,481703038,0,3763,968174,3662,945674,101,22500,1869,6,3682,79,0,31,229410.0,137640.0,-52.0,-50.0,-44.0,-46.0,-51.0,-49.0,-44.0,-46.0,-90.0,-93.0,-90.0,-93.0,38.0,43.0,46.0,47.0,0
2254,CC:2F:71:3F:1F:24,4419397,1169862777,600133,688159739,3819264,481703038,37,498606,558616436,498029,558546874,577,69562,480937,10,600370,49432,34,431,130000.0,43333.0,-67.0,-65.0,-70.0,-67.0,-67.0,-65.0,-70.0,-67.0,-90.0,-93.0,-90.0,-93.0,23.0,28.0,20.0,26.0,0
2255,CC:2F:71:3E:C5:1F,3819968,481789225,704,86187,3819264,481703038,0,2987,250457,2473,189361,514,61096,746,8,1035,18,0,32,144444.0,43333.0,-70.0,-71.0,-67.0,-59.0,-70.0,-71.0,-67.0,-59.0,-90.0,-93.0,-90.0,-93.0,20.0,22.0,23.0,34.0,0
2256,BA:8C:B9:54:50:24,3821005,482542008,1741,838970,3819264,481703038,0,5633,826120,5613,822998,20,3122,1004,14,2116,29,0,49,229410.0,130000.0,-39.0,-37.0,-44.0,-51.0,-43.0,-35.0,-42.0,-47.0,-90.0,-93.0,-90.0,-93.0,51.0,56.0,46.0,42.0,0
2257,92:69:1D:31:68:E9,3822825,485197748,3556,3494246,3819269,481703502,0,3763,968174,3662,945674,101,22500,1869,6,3682,79,0,31,229410.0,137640.0,-52.0,-50.0,-44.0,-46.0,-51.0,-49.0,-44.0,-46.0,-90.0,-93.0,-90.0,-93.0,38.0,43.0,46.0,47.0,0
2258,CC:2F:71:3F:1F:24,4419445,1169877793,600176,688174291,3819269,481703502,37,498635,558621800,498058,558552238,577,69562,480966,10,600413,49465,34,431,144444.0,39000.0,-67.0,-65.0,-71.0,-68.0,-67.0,-65.0,-70.0,-67.0,-90.0,-93.0,-90.0,-93.0,23.0,28.0,19.0,25.0,0
2259,CC:2F:71:3E:C5:1F,3819973,481789689,704,86187,3819269,481703502,0,2987,250457,2473,189361,514,61096,746,8,1035,18,0,32,144444.0,43333.0,-70.0,-71.0,-67.0,-59.0,-70.0,-71.0,-67.0,-59.0,-90.0,-93.0,-90.0,-93.0,20.0,22.0,23.0,34.0,0
2260,BA:8C:B9:54:50:24,3821010,482542472,1741,838970,3819269,481703502,0,5633,826120,5613,822998,20,3122,1004,14,2116,29,0,49,229410.0,130000.0,-39.0,-37.0,-44.0,-51.0,-43.0,-35.0,-42.0,-47.0,-90.0,-93.0,-90.0,-93.0,51.0,56.0,46.0,42.0,0
2261,92:69:1D:31:68:E9,3822829,485198152,3556,3494246,3819273,481703906,0,3763,968174,3662,945674,101,22500,1869,6,3682,79,0,31,229410.0,137640.0,-52.0,-50.0,-44.0,-46.0,-51.0,-49.0,-44.0,-46.0,-90.0,-92.0,-90.0,-93.0,38.0,42.0,46.0,47.0,0
2262,CC:2F:71:3F:1F:24,4419490,1169892501,600217,688188595,3819273,481703906,37,498664,558627140,498087,558557578,577,69562,480995,10,600454,49479,34,431,130000.0,43333.0,-67.0,-65.0,-70.0,-68.0,-67.0,-65.0,-70.0,-67.0,-90.0,-92.0,-90.0,-93.0,23.0,27.0,20.0,25.0,0
2263,CC:2F:71:3E:C5:1F,3819977,481790093,704,86187,3819273,481703906,0,2987,250457,2473,189361,514,61096,746,8,1035,18,0,32,144444.0,43333.0,-70.0,-71.0,-67.0,-59.0,-70.0,-71.0,-67.0,-59.0,-90.0,-92.0,-90.0,-93.0,20.0,21.0,23.0,34.0,0
2264,BA:8C:B9:54:50:24,3821014,482542876,1741,838970,3819273,481703906,0,5633,826120,5613,822998,20,3122,1004,14,2116,29,0,49,229410.0,130000.0,-39.0,-37.0,-44.0,-51.0,-43.0,-35.0,-42.0,-47.0,-90.0,-92.0,-90.0,-93.0,51.0,55.0,46.0,42.0,0
2265,92:69:1D:31:68:E9,3822833,485198556,3556,3494246,3819277,481704310,0,3763,968174,3662,945674,101,22500,1869,6,3682,79,0,31,229410.0,137640.0,-52.0,-50.0,-44.0,-46.0,-51.0,-49.0,-44.0,-46.0,-90.0,-93.0,-90.0,-93.0,38.0,43.0,46.0,47.0,0
2266,CC:2F:71:3F:1F:24,4419537,1169907457,600260,688203147,3819277,481704310,37,498693,558632504,498116,558562942,577,69562,481024,10,600497,49501,34,431,117000.0,39000.0,-67.0,-65.0,-71.0,-67.0,-67.0,-65.0,-70.0,-67.0,-90.0,-93.0,-90.0,-93.0,23.0,28.0,19.0,26.0,0
2267,CC:2F:71:3E:C5:1F,3819981,481790497,704,86187,3819277,481704310,0,2987,250457,2473,189361,514,61096,746,8,1035,18,0,32,144444.0,43333.0,-70.0,-71.0,-67.0,-59.0,-70.0,-71.0,-67.0,-59.0,-90.0,-93.0,-90.0,-93.0,20.0,22.0,23.0,34.0,0
2268,BA:8C:B9:54:50:24,3821018,482543280,1741,838970,3819277,481704310,0,5637,826392,5617,823270,20,3122,1004,14,2116,29,0,49,229410.0,130000.0,-40.0,-37.0,-44.0,-51.0,-43.0,-36.0,-43.0,-48.0,-90.0,-93.0,-90.0,-93.0,50.0,56.0,46.0,42.0,0
2269,92:69:1D:31:68:E9,3822838,485199020,3556,3494246,3819282,481704774,0,3764,968242,3663,945742,101,22500,1869,6,3682,79,0,31,229410.0,137640.0,-52.0,-50.0,-44.0,-46.0,-51.0,-49.0,-44.0,-46.0,-90.0,-93.0,-90.0,-93.0,38.0,43.0,46.0,47.0,0
2270,CC:2F:71:3F:1F:24,4419585,1169922473,600303,688217699,3819282,481704774,37,498722,558637868,498145,558568306,577,69562,481053,10,600540,49507,34,431,130000.0,43333.0,-67.0,-65.0,-70.0,-67.0,-67.0,-65.0,-70.0,-67.0,-90.0,-93.0,-90.0,-93.0,23.0,28.0,20.0,26.0,0
2271,CC:2F:71:3E:C5:1F,3819986,481790961,704,86187,3819282,481704774,0,2987,250457,2473,189361,514,61096,746,8,1035,18,0,32,144444.0,43333.0,-70.0,-71.0,-67.0,-59.0,-70.0,-71.0,-67.0,-59.0,-90.0,-93.0,-90.0,-93.0,20.0,22.0,23.0,34.0,0
2272,BA:8C:B9:54:50:24,3821023,482543744,1741,838970,3819282,481704774,0,5637,826392,5617,823270,20,3122,1004,14,2116,29,0,49,229410.0,130000.0,-40.0,-37.0,-44.0,-51.0,-43.0,-36.0,-43.0,-48.0,-90.0,-93.0,-90.0,-93.0,50.0,56.0,46.0,42.0,0
2273,92:69:1D:31:68:E9,3822842,485199424,3556,3494246,3819286,481705178,0,3764,968242,3663,945742,101,22500,1869,6,3682,79,0,31,229410.0,137640.0,-52.0,-50.0,-44.0,-46.0,-51.0,-49.0,-44.0,-46.0,-90.0,-93.0,-90.0,-93.0,38.0,43.0,46.0,47.0,0
2274,CC:2F:71:3F:1F:24,4419631,1169937361,600345,688232183,3819286,481705178,37,498751,558643208,498174,558573646,577,69562,481082,10,600582,49530,34,431,130000.0,39000.0,-67.0,-65.0,-70.0,-68.0,-67.0,-65.0,-70.0,-67.0,-90.0,-93.0,-90.0,-93.0,23.0,28.0,20.0,25.0,0
2275,CC:2F:71:3E:C5:1F,3819990,481791365,704,86187,3819286,481705178,0,2987,250457,2473,189361,514,61096,746,8,1035,18,0,32,144444.0,43333.0,-70.0,-71.0,-67.0,-59.0,-70.0,-71.0,-67.0,-59.0,-90.0,-93.0,-90.0,-93.0,20.0,22.0,23.0,34.0,0
2276,BA:8C:B9:54:50:24,3821027,482544148,1741,838970,3819286,481705178,0,5637,826392,5617,823270,20,3122,1004,14,2116,29,0,49,229410.0,130000.0,-40.0,-37.0,-44.0,-51.0,-43.0,-36.0,-43.0,-48.0,-90.0,-93.0,-90.0,-93.0,50.0,56.0,46.0,42.0,0
2277,92:69:1D:31:68:E9,3822847,485199888,3556,3494246,3819291,481705642,0,3764,968242,3663,945742,101,22500,1869,6,3682,79,0,31,229410.0,137640.0,-52.0,-50.0,-44.0,-46.0,-51.0,-49.0,-44.0,-46.0,-90.0,-93.0,-90.0,-93.0,38.0,43.0,46.0,47.0,0
2278,CC:2F:71:3F:1F:24,4419677,1169952201,600386,688246559,3819291,481705642,37,498779,558648396,498202,558578834,577,69562,481110,10,600623,49554,34,431,130000.0,43333.0,-67.0,-65.0,-70.0,-67.0,-67.0,-65.0,-70.0,-67.0,-90.0,-93.0,-90.0,-93.0,23.0,28.0,20.0,26.0,0
2279,CC:2F:71:3E:C5:1F,3819995,481791829,704,86187,3819291,481705642,0,2987,250457,2473,189361,514,61096,746,8,1035,18,0,32,144444.0,43333.0,-70.0,-71.0,-67.0,-59.0,-70.0,-71.0,-67.0,-59.0,-90.0,-93.0,-90.0,-93.0,20.0,22.0,23.0,34.0,0
2280,BA:8C:B9:54:50:24,3821032,482544612,1741,838970,3819291,481705642,0,5637,826392,5617,823270,20,3122,1004,14,2116,29,0,49,229410.0,130000.0,-40.0,-37.0,-44.0,-51.0,-43.0,-36.0,-43.0,-48.0,-90.0,-93.0,-90.0,-93.0,50.0,56.0,46.0,42.0,0
2281,92:69:1D:31:68:E9,3822852,485200408,3557,3494362,3819295,481706046,0,3766,968378,3665,945878,101,22500,1869,6,3683,79,0,31,216660.0,130000.0,-52.0,-50.0,-44.0,-46.0,-51.0,-49.0,-43.0,-46.0,-90.0,-93.0,-90.0,-93.0,38.0,43.0,46.0,47.0,0
2282,CC:2F:71:3F:1F:24,4419725,1169967335,600430,688261289,3819295,481706046,37,498807,558653620,498230,558584058,577,69562,481138,10,600667,49576,34,431,117000.0,39000.0,-67.0,-65.0,-70.0,-67.0,-67.0,-65.0,-70.0,-67.0,-90.0,-93.0,-90.0,-93.0,23.0,28.0,20.0,26.0,0
2283,CC:2F:71:3E:C5:1F,3820001,481792566,705,86247,3819296,481706319,0,2989,250597,2475,189501,514,61096,746,8,1036,18,0,32,144444.0,43333.0,-70.0,-71.0,-67.0,-60.0,-70.0,-71.0,-67.0,-59.0,-90.0,-93.0,-90.0,-93.0,20.0,22.0,23.0,33.0,0
2284,BA:8C:B9:54:50:24,3821038,482545405,1742,839086,3819296,481706319,0,5639,826528,5619,823406,20,3122,1004,14,2117,29,0,49,229410.0,130000.0,-49.0,-35.0,-42.0,-44.0,-44.0,-36.0,-43.0,-47.0,-90.0,-93.0,-90.0,-93.0,41.0,58.0,48.0,49.0,0
2285,92:69:1D:31:68:E9,3822857,485201085,3557,3494362,3819300,481706723,0,3766,968378,3665,945878,101,22500,1869,6,3683,79,0,31,216660.0,130000.0,-52.0,-50.0,-44.0,-46.0,-51.0,-49.0,-43.0,-46.0,-90.0,-93.0,-90.0,-93.0,38.0,43.0,46.0,47.0,0
2286,CC:2F:71:3F:1F:24,4419772,1169982390,600472,688275667,3819300,481706723,37,498836,558658984,498259,558589422,577,69562,481167,10,600709,49588,34,431,130000.0,43333.0,-67.0,-65.0,-70.0,-68.0,-67.0,-65.0,-70.0,-67.0,-90.0,-93.0,-90.0,-93.0,23.0,28.0,20.0,25.0,0
2287,CC:2F:71:3E:C5:1F,3820005,481792970,705,86247,3819300,481706723,0,2989,250597,2475,189501,514,61096,746,8,1036,18,0,32,144444.0,43333.0,-70.0,-71.0,-67.0,-60.0,-70.0,-71.0,-67.0,-59.0,-90.0,-93.0,-90.0,-93.0,20.0,22.0,23.0,33.0,0
2288,BA:8C:B9:54:50:24,3821042,482545809,1742,839086,3819300,481706723,0,5639,826528,5619,823406,20,3122,1004,14,2117,29,0,49,229410.0,130000.0,-49.0,-35.0,-42.0,-44.0,-44.0,-36.0,-43.0,-47.0,-90.0,-93.0,-90.0,-93.0,41.0,58.0,48.0,49.0,0
2289,92:69:1D:31:68:E9,3822862,485201549,3557,3494362,3819305,481707187,0,3766,968378,3665,945878,101,22500,1869,6,3683,79,0,31,216660.0,130000.0,-52.0,-50.0,-44.0,-46.0,-51.0,-49.0,-43.0,-46.0,-90.0,-93.0,-90.0,-93.0,38.0,43.0,46.0,47.0,0
2290,CC:2F:71:3F:1F:24,4419819,1169997282,600514,688290095,3819305,481707187,37,498867,558664556,498290,558594994,577,69562,481198,10,600751,49610,34,431,117000.0,39000.0,-67.0,-65.0,-71.0,-68.0,-67.0,-65.0,-70.0,-67.0,-90.0,-93.0,-90.0,-93.0,23.0,28.0,19.0,25.0,0
2291,CC:2F:71:3E:C5:1F,3820010,481793434,705,86247,3819305,481707187,0,2989,250597,2475,189501,514,61096,746,8,1036,18,0,32,144444.0,43333.0,-70.0,-71.0,-67.0,-60.0,-70.0,-71.0,-67.0,-59.0,-90.0,-93.0,-90.0,-93.0,20.0,22.0,23.0,33.0,0
2292,BA:8C:B9:54:50:24,3821047,482546273,1742,839086,3819305,481707187,0,5639,826528,5619,823406,20,3122,1004,14,2117,29,0,49,229410.0,130000.0,-49.0,-35.0,-42.0,-44.0,-44.0,-36.0,-43.0,-47.0,-90.0,-93.0,-90.0,-93.0,41.0,58.0,48.0,49.0,0
2293,92:69:1D:31:68:E9,3822866,485201875,3557,3494362,3819309,481707513,0,3766,968378,3665,945878,101,22500,1869,6,3683,79,0,31,216660.0,130000.0,-52.0,-50.0,-44.0,-46.0,-51.0,-49.0,-43.0,-46.0,-90.0,-93.0,-90.0,-93.0,38.0,43.0,46.0,47.0,0
2294,CC:2F:71:3F:1F:24,4419867,1170012290,600558,688304777,3819309,481707513,37,498899,558670294,498321,558600614,578,69680,481230,10,600795,49616,34,432,130000.0,43333.0,-67.0,-65.0,-70.0,-68.0,-67.0,-65.0,-70.0,-67.0,-90.0,-93.0,-90.0,-93.0,23.0,28.0,20.0,25.0,0
2295,CC:2F:71:3E:C5:1F,3820016,481793962,705,86247,3819311,481707715,0,2991,250785,2476,189571,515,61214,747,8,1036,18,0,32,144444.0,43333.0,-70.0,-71.0,-68.0,-60.0,-70.0,-71.0,-67.0,-59.0,-90.0,-93.0,-90.0,-93.0,20.0,22.0,22.0,33.0,0
2296,BA:8C:B9:54:50:24,3821053,482546801,1742,839086,3819311,481707715,0,5639,826528,5619,823406,20,3122,1004,14,2117,29,0,49,229410.0,130000.0,-49.0,-35.0,-42.0,-44.0,-44.0,-36.0,-43.0,-47.0,-90.0,-93.0,-90.0,-93.0,41.0,58.0,48.0,49.0,0
2297,92:69:1D:31:68:E9,3822874,485202849,3557,3494362,3819317,481708487,0,3766,968378,3665,945878,101,22500,1869,6,3683,79,0,31,216660.0,130000.0,-52.0,-50.0,-44.0,-46.0,-51.0,-49.0,-43.0,-46.0,-90.0,-92.0,-90.0,-93.0,38.0,42.0,46.0,47.0,0
2298,CC:2F:71:3F:1F:24,4419918,1170027872,600601,688319385,3819317,481708487,37,498928,558675658,498350,558605978,578,69680,481259,10,600838,49641,34,432,130000.0,39000.0,-67.0,-65.0,-70.0,-67.0,-67.0,-65.0,-70.0,-67.0,-90.0,-92.0,-90.0,-93.0,23.0,27.0,20.0,26.0,0
2299,CC:2F:71:3E:C5:1F,3820023,481794794,705,86247,3819318,481708547,0,2991,250785,2476,189571,515,61214,747,8,1036,18,0,32,144444.0,43333.0,-70.0,-71.0,-68.0,-60.0,-70.0,-71.0,-67.0,-59.0,-90.0,-92.0,-90.0,-93.0,20.0,21.0,22.0,33.0,0
2300,BA:8C:B9:54:50:24,3821060,482547633,1742,839086,3819318,481708547,0,5639,826528,5619,823406,20,3122,1004,14,2117,29,0,49,229410.0,130000.0,-49.0,-35.0,-42.0,-44.0,-44.0,-36.0,-43.0,-47.0,-90.0,-92.0,-90.0,-93.0,41.0,57.0,48.0,49.0,0
2301,92:69:1D:31:68:E9,3822877,485203111,3557,3494362,3819320,481708749,0,3766,968378,3665,945878,101,22500,1869,6,3683,79,0,31,216660.0,130000.0,-52.0,-50.0,-44.0,-46.0,-51.0,-49.0,-43.0,-46.0,-90.0,-92.0,-90.0,-93.0,38.0,42.0,46.0,47.0,0
2302,CC:2F:71:3F:1F:24,4419965,1170042764,600643,688333813,3819322,481708951,37,498959,558681254,498381,558611574,578,69680,481290,10,600880,49658,34,432,130000.0,43333.0,-67.0,-65.0,-70.0,-68.0,-67.0,-65.0,-70.0,-67.0,-90.0,-92.0,-90.0,-93.0,23.0,27.0,20.0,25.0,0
2303,CC:2F:71:3E:C5:1F,3820027,481795198,705,86247,3819322,481708951,0,2991,250785,2476,189571,515,61214,747,8,1036,18,0,32,144444.0,43333.0,-70.0,-71.0,-68.0,-60.0,-70.0,-71.0,-67.0,-59.0,-90.0,-92.0,-90.0,-93.0,20.0,21.0,22.0,33.0,0
2304,BA:8C:B9:54:50:24,3821064,482548037,1742,839086,3819322,481708951,0,5639,826528,5619,823406,20,3122,1004,14,2117,29,0,49,229410.0,130000.0,-49.0,-35.0,-42.0,-44.0,-44.0,-36.0,-43.0,-47.0,-90.0,-92.0,-90.0,-93.0,41.0,57.0,48.0,49.0,0
2305,92:69:1D:31:68:E9,3822883,485203717,3557,3494362,3819326,481709355,0,3766,968378,3665,945878,101,22500,1869,6,3683,79,0,31,216660.0,130000.0,-52.0,-50.0,-44.0,-46.0,-51.0,-49.0,-43.0,-46.0,-90.0,-92.0,-90.0,-93.0,38.0,42.0,46.0,47.0,0
2306,CC:2F:71:3F:1F:24,4420010,1170057528,600684,688348173,3819326,481709355,37,498990,558686920,498412,558617240,578,69680,481320,10,600921,49662,34,432,130000.0,43333.0,-67.0,-65.0,-70.0,-68.0,-67.0,-65.0,-70.0,-67.0,-90.0,-92.0,-90.0,-93.0,23.0,27.0,20.0,25.0,0
2307,CC:2F:71:3E:C5:1F,3820031,481795602,705,86247,3819326,481709355,0,2991,250785,2476,189571,515,61214,747,8,1036,18,0,32,144444.0,43333.0,-70.0,-71.0,-68.0,-60.0,-70.0,-71.0,-67.0,-59.0,-90.0,-92.0,-90.0,-93.0,20.0,21.0,22.0,33.0,0
2308,BA:8C:B9:54:50:24,3821068,482548441,1742,839086,3819326,481709355,0,5639,826528,5619,823406,20,3122,1004,14,2117,29,0,49,229410.0,130000.0,-49.0,-35.0,-42.0,-44.0,-44.0,-36.0,-43.0,-47.0,-90.0,-92.0,-90.0,-93.0,41.0,57.0,48.0,49.0,0
2309,92:69:1D:31:68:E9,3822886,485203979,3557,3494362,3819329,481709617,0,3766,968378,3665,945878,101,22500,1869,6,3683,79,0,31,216660.0,130000.0,-52.0,-50.0,-44.0,-46.0,-51.0,-49.0,-43.0,-46.0,-90.0,-92.0,-90.0,-93.0,38.0,42.0,46.0,47.0,0
2310,CC:2F:71:3F:1F:24,4420058,1170072544,600727,688362725,3819331,481709819,37,499019,558692284,498441,558622604,578,69680,481349,10,600964,49684,34,432,117000.0,39000.0,-67.0,-65.0,-70.0,-67.0,-67.0,-65.0,-70.0,-67.0,-90.0,-92.0,-90.0,-93.0,23.0,27.0,20.0,26.0,0
2311,CC:2F:71:3E:C5:1F,3820036,481796066,705,86247,3819331,481709819,0,2991,250785,2476,189571,515,61214,747,8,1036,18,0,32,144444.0,43333.0,-70.0,-71.0,-68.0,-60.0,-70.0,-71.0,-67.0,-59.0,-90.0,-92.0,-90.0,-93.0,20.0,21.0,22.0,33.0,0
2312,BA:8C:B9:54:50:24,3821073,482548905,1742,839086,3819331,481709819,0,5640,826596,5620,823474,20,3122,1004,14,2117,29,0,49,229410.0,130000.0,-39.0,-37.0,-45.0,-51.0,-43.0,-36.0,-43.0,-48.0,-90.0,-92.0,-90.0,-93.0,51.0,55.0,45.0,42.0,0
2313,92:69:1D:31:68:E9,3822892,485204585,3557,3494362,3819335,481710223,0,3766,968378,3665,945878,101,22500,1869,6,3683,79,0,31,216660.0,130000.0,-52.0,-50.0,-44.0,-46.0,-51.0,-49.0,-43.0,-46.0,-90.0,-92.0,-90.0,-93.0,38.0,42.0,46.0,47.0,0
2314,CC:2F:71:3F:1F:24,4420104,1170087382,600769,688377159,3819335,481710223,37,499049,558697788,498471,558628108,578,69680,481379,10,601006,49697,34,432,130000.0,39000.0,-67.0,-65.0,-70.0,-68.0,-67.0,-65.0,-70.0,-67.0,-90.0,-92.0,-90.0,-93.0,23.0,27.0,20.0,25.0,0
2315,CC:2F:71:3E:C5:1F,3820040,481796470,705,86247,3819335,481710223,0,2991,250785,2476,189571,515,61214,747,8,1036,18,0,32,144444.0,43333.0,-70.0,-71.0,-68.0,-60.0,-70.0,-71.0,-67.0,-59.0,-90.0,-92.0,-90.0,-93.0,20.0,21.0,22.0,33.0,0
2316,BA:8C:B9:54:50:24,3821077,482549309,1742,839086,3819335,481710223,0,5643,826800,5623,823678,20,3122,1004,14,2117,29,0,49,229410.0,130000.0,-39.0,-37.0,-44.0,-51.0,-44.0,-36.0,-43.0,-47.0,-90.0,-92.0,-90.0,-93.0,51.0,55.0,46.0,42.0,0
2317,92:69:1D:31:68:E9,3822894,485204787,3557,3494362,3819337,481710425,0,3766,968378,3665,945878,101,22500,1869,6,3683,79,0,31,216660.0,130000.0,-52.0,-50.0,-44.0,-46.0,-51.0,-49.0,-43.0,-46.0,-90.0,-92.0,-90.0,-93.0,38.0,42.0,46.0,47.0,0
2318,CC:2F:71:3F:1F:24,4420150,1170102214,600811,688391587,3819339,481710627,37,499078,558703152,498500,558633472,578,69680,481408,10,601048,49722,34,432,117000.0,39000.0,-67.0,-65.0,-70.0,-68.0,-67.0,-65.0,-70.0,-67.0,-90.0,-92.0,-90.0,-93.0,23.0,27.0,20.0,25.0,0
2319,CC:2F:71:3E:C5:1F,3820044,481796874,705,86247,3819339,481710627,0,2991,250785,2476,189571,515,61214,747,8,1036,18,0,32,144444.0,43333.0,-70.0,-71.0,-68.0,-60.0,-70.0,-71.0,-67.0,-59.0,-90.0,-92.0,-90.0,-93.0,20.0,21.0,22.0,33.0,0
2320,BA:8C:B9:54:50:24,3821081,482549713,1742,839086,3819339,481710627,0,5643,826800,5623,823678,20,3122,1004,14,2117,29,0,49,229410.0,130000.0,-39.0,-37.0,-44.0,-51.0,-44.0,-36.0,-43.0,-47.0,-90.0,-92.0,-90.0,-93.0,51.0,55.0,46.0,42.0,0
2321,92:69:1D:31:68:E9,3822901,485205453,3557,3494362,3819344,481711091,0,3766,968378,3665,945878,101,22500,1869,6,3683,79,0,31,216660.0,130000.0,-52.0,-50.0,-44.0,-46.0,-51.0,-49.0,-43.0,-46.0,-90.0,-92.0,-90.0,-93.0,38.0,42.0,46.0,47.0,0
2322,CC:2F:71:3F:1F:24,4420198,1170117230,600854,688406139,3819344,481711091,37,499107,558708516,498529,558638836,578,69680,481437,10,601091,49724,34,432,130000.0,43333.0,-67.0,-65.0,-70.0,-67.0,-67.0,-65.0,-70.0,-67.0,-90.0,-92.0,-90.0,-93.0,23.0,27.0,20.0,26.0,0
2323,CC:2F:71:3E:C5:1F,3820049,481797338,705,86247,3819344,481711091,0,2991,250785,2476,189571,515,61214,747,8,1036,18,0,32,144444.0,43333.0,-70.0,-71.0,-68.0,-60.0,-70.0,-71.0,-67.0,-59.0,-90.0,-92.0,-90.0,-93.0,20.0,21.0,22.0,33.0,0
2324,BA:8C:B9:54:50:24,3821086,482550177,1742,839086,3819344,481711091,0,5643,826800,5623,823678,20,3122,1004,14,2117,29,0,49,229410.0,130000.0,-39.0,-37.0,-44.0,-51.0,-44.0,-36.0,-43.0,-47.0,-90.0,-92.0,-90.0,-93.0,51.0,55.0,46.0,42.0,0
2325,92:69:1D:31:68:E9,3822903,485205655,3557,3494362,3819346,481711293,0,3766,968378,3665,945878,101,22500,1869,6,3683,79,0,31,216660.0,130000.0,-52.0,-50.0,-44.0,-46.0,-51.0,-49.0,-43.0,-46.0,-90.0,-92.0,-90.0,-93.0,38.0,42.0,46.0,47.0,0
2326,CC:2F:71:3F:1F:24,4420245,1170132192,600897,688420697,3819348,481711495,37,499136,558713880,498558,558644200,578,69680,481466,10,601134,49742,34,432,117000.0,39000.0,-67.0,-65.0,-70.0,-68.0,-67.0,-65.0,-70.0,-67.0,-90.0,-92.0,-90.0,-93.0,23.0,27.0,20.0,25.0,0
2327,CC:2F:71:3E:C5:1F,3820053,481797742,705,86247,3819348,481711495,0,2991,250785,2476,189571,515,61214,747,8,1036,18,0,32,144444.0,43333.0,-70.0,-71.0,-68.0,-60.0,-70.0,-71.0,-67.0,-59.0,-90.0,-92.0,-90.0,-93.0,20.0,21.0,22.0,33.0,0
2328,BA:8C:B9:54:50:24,3821090,482550581,1742,839086,3819348,481711495,0,5647,827072,5627,823950,20,3122,1004,14,2117,29,0,49,229410.0,130000.0,-49.0,-35.0,-42.0,-45.0,-43.0,-36.0,-43.0,-48.0,-90.0,-92.0,-90.0,-93.0,41.0,57.0,48.0,48.0,0
2329,92:69:1D:31:68:E9,3822909,485206261,3557,3494362,3819352,481711899,0,3766,968378,3665,945878,101,22500,1869,6,3683,79,0,31,216660.0,130000.0,-52.0,-50.0,-44.0,-46.0,-51.0,-49.0,-43.0,-46.0,-90.0,-92.0,-90.0,-93.0,38.0,42.0,46.0,47.0,0
2330,CC:2F:71:3F:1F:24,4420292,1170147084,600939,688435125,3819353,481711959,37,499165,558719280,498587,558649600,578,69680,481495,10,601176,49743,34,432,130000.0,43333.0,-67.0,-65.0,-71.0,-68.0,-67.0,-65.0,-70.0,-67.0,-90.0,-92.0,-90.0,-93.0,23.0,27.0,19.0,25.0,0
2331,CC:2F:71:3E:C5:1F,3820058,481798206,705,86247,3819353,481711959,0,2991,250785,2476,189571,515,61214,747,8,1036,18,0,32,144444.0,43333.0,-70.0,-71.0,-68.0,-60.0,-70.0,-71.0,-67.0,-59.0,-90.0,-92.0,-90.0,-93.0,20.0,21.0,22.0,33.0,0
2332,BA:8C:B9:54:50:24,3821095,482551045,1742,839086,3819353,481711959,0,5647,827072,5627,823950,20,3122,1004,14,2117,29,0,49,229410.0,130000.0,-49.0,-35.0,-42.0,-45.0,-43.0,-36.0,-43.0,-48.0,-90.0,-92.0,-90.0,-93.0,41.0,57.0,48.0,48.0,0
2333,92:69:1D:31:68:E9,3822912,485206523,3557,3494362,3819355,481712161,0,3766,968378,3665,945878,101,22500,1869,6,3683,79,0,31,216660.0,130000.0,-52.0,-50.0,-44.0,-46.0,-51.0,-49.0,-43.0,-46.0,-90.0,-92.0,-90.0,-93.0,38.0,42.0,46.0,47.0,0
2334,CC:2F:71:3F:1F:24,4420338,1170161916,600981,688449553,3819357,481712363,37,499194,558724680,498616,558655000,578,69680,481524,10,601218,49763,34,432,117000.0,39000.0,-67.0,-65.0,-70.0,-67.0,-67.0,-65.0,-70.0,-67.0,-90.0,-92.0,-90.0,-93.0,23.0,27.0,20.0,26.0,0
2335,CC:2F:71:3E:C5:1F,3820062,481798610,705,86247,3819357,481712363,0,2991,250785,2476,189571,515,61214,747,8,1036,18,0,32,144444.0,43333.0,-70.0,-71.0,-68.0,-60.0,-70.0,-71.0,-67.0,-59.0,-90.0,-92.0,-90.0,-93.0,20.0,21.0,22.0,33.0,0
2336,BA:8C:B9:54:50:24,3821099,482551449,1742,839086,3819357,481712363,0,5647,827072,5627,823950,20,3122,1004,14,2117,29,0,49,229410.0,130000.0,-49.0,-35.0,-42.0,-45.0,-43.0,-36.0,-43.0,-48.0,-90.0,-92.0,-90.0,-93.0,41.0,57.0,48.0,48.0,0
2337,92:69:1D:31:68:E9,3822919,485207402,3557,3494362,3819362,481713040,0,3766,968378,3665,945878,101,22500,1869,6,3683,79,0,31,216660.0,130000.0,-52.0,-50.0,-44.0,-46.0,-51.0,-49.0,-43.0,-46.0,-90.0,-92.0,-90.0,-93.0,38.0,42.0,46.0,47.0,0
2338,CC:2F:71:3F:1F:24,4420387,1170177275,601025,688464235,3819362,481713040,37,499223,558730044,498645,558660364,578,69680,481553,10,601262,49768,34,432,130000.0,39000.0,-67.0,-65.0,-70.0,-68.0,-67.0,-65.0,-70.0,-67.0,-90.0,-92.0,-90.0,-93.0,23.0,27.0,20.0,25.0,0
2339,CC:2F:71:3E:C5:1F,3820067,481799287,705,86247,3819362,481713040,0,2991,250785,2476,189571,515,61214,747,8,1036,18,0,32,144444.0,43333.0,-70.0,-71.0,-68.0,-60.0,-70.0,-71.0,-67.0,-59.0,-90.0,-92.0,-90.0,-93.0,20.0,21.0,22.0,33.0,0
2340,BA:8C:B9:54:50:24,3821104,482552126,1742,839086,3819362,481713040,0,5647,827072,5627,823950,20,3122,1004,14,2117,29,0,49,229410.0,130000.0,-49.0,-35.0,-42.0,-45.0,-43.0,-36.0,-43.0,-48.0,-90.0,-92.0,-90.0,-93.0,41.0,57.0,48.0,48.0,0
2341,92:69:1D:31:68:E9,3822924,485207866,3557,3494362,3819367,481713504,0,3766,968378,3665,945878,101,22500,1869,6,3683,79,0,31,216660.0,130000.0,-52.0,-50.0,-44.0,-46.0,-51.0,-49.0,-43.0,-46.0,-90.0,-92.0,-90.0,-93.0,38.0,42.0,46.0,47.0,0
2342,CC:2F:71:3F:1F:24,4420434,1170192055,601067,688478551,3819367,481713504,37,499254,558735664,498676,558665984,578,69680,481584,10,601304,49775,34,432,130000.0,43333.0,-67.0,-65.0,-70.0,-67.0,-67.0,-65.0,-70.0,-67.0,-90.0,-92.0,-90.0,-93.0,23.0,27.0,20.0,26.0,0
2343,CC:2F:71:3E:C5:1F,3820072,481799751,705,86247,3819367,481713504,0,2991,250785,2476,189571,515,61214,747,8,1036,18,0,32,144444.0,43333.0,-70.0,-71.0,-68.0,-60.0,-70.0,-71.0,-67.0,-59.0,-90.0,-92.0,-90.0,-93.0,20.0,21.0,22.0,33.0,0
2344,BA:8C:B9:54:50:24,3821109,482552590,1742,839086,3819367,481713504,0,5648,827140,5628,824018,20,3122,1004,14,2117,29,0,49,229410.0,130000.0,-39.0,-37.0,-44.0,-52.0,-43.0,-36.0,-43.0,-48.0,-90.0,-92.0,-90.0,-93.0,51.0,55.0,46.0,41.0,0
2345,92:69:1D:31:68:E9,3822928,485208270,3557,3494362,3819371,481713908,0,3766,968378,3665,945878,101,22500,1869,6,3683,79,0,31,216660.0,130000.0,-52.0,-50.0,-44.0,-46.0,-51.0,-49.0,-43.0,-46.0,-90.0,-92.0,-90.0,-92.0,38.0,42.0,46.0,46.0,0
2346,CC:2F:71:3F:1F:24,4420481,1170207123,601110,688493215,3819371,481713908,37,499283,558741028,498705,558671348,578,69680,481613,10,601347,49782,34,432,130000.0,43333.0,-67.0,-65.0,-71.0,-67.0,-67.0,-65.0,-70.0,-67.0,-90.0,-92.0,-90.0,-92.0,23.0,27.0,19.0,25.0,0
2347,CC:2F:71:3E:C5:1F,3820076,481800155,705,86247,3819371,481713908,0,2991,250785,2476,189571,515,61214,747,8,1036,18,0,32,144444.0,43333.0,-70.0,-71.0,-68.0,-60.0,-70.0,-71.0,-67.0,-59.0,-90.0,-92.0,-90.0,-92.0,20.0,21.0,22.0,32.0,0
2348,BA:8C:B9:54:50:24,3821113,482552994,1742,839086,3819371,481713908,0,5648,827140,5628,824018,20,3122,1004,14,2117,29,0,49,229410.0,130000.0,-39.0,-37.0,-44.0,-52.0,-43.0,-36.0,-43.0,-48.0,-90.0,-92.0,-90.0,-92.0,51.0,55.0,46.0,40.0,0
2349,92:69:1D:31:68:E9,3822930,485208472,3557,3494362,3819373,481714110,0,3766,968378,3665,945878,101,22500,1869,6,3683,79,0,31,216660.0,130000.0,-52.0,-50.0,-44.0,-46.0,-51.0,-49.0,-43.0,-46.0,-90.0,-92.0,-90.0,-92.0,38.0,42.0,46.0,46.0,0
2350,CC:2F:71:3F:1F:24,4420526,1170221939,601153,688507829,3819373,481714110,37,499313,558746532,498735,558676852,578,69680,481643,10,601390,49802,34,432,130000.0,39000.0,-67.0,-65.0,-70.0,-67.0,-67.0,-65.0,-70.0,-67.0,-90.0,-92.0,-90.0,-92.0,23.0,27.0,20.0,25.0,0
2351,CC:2F:71:3E:C5:1F,3820080,481800559,705,86247,3819375,481714312,0,2991,250785,2476,189571,515,61214,747,8,1036,18,0,32,144444.0,43333.0,-70.0,-71.0,-68.0,-60.0,-70.0,-71.0,-67.0,-59.0,-90.0,-92.0,-90.0,-92.0,20.0,21.0,22.0,32.0,0
2352,BA:8C:B9:54:50:24,3821118,482553458,1742,839086,3819376,481714372,0,5648,827140,5628,824018,20,3122,1004,14,2117,29,0,49,229410.0,130000.0,-39.0,-37.0,-44.0,-52.0,-43.0,-36.0,-43.0,-48.0,-90.0,-92.0,-90.0,-92.0,51.0,55.0,46.0,40.0,0
2353,92:69:1D:31:68:E9,3822937,485209138,3557,3494362,3819380,481714776,0,3766,968378,3665,945878,101,22500,1869,6,3683,79,0,31,216660.0,130000.0,-52.0,-50.0,-44.0,-46.0,-51.0,-49.0,-43.0,-46.0,-90.0,-92.0,-90.0,-92.0,38.0,42.0,46.0,46.0,0
2354,CC:2F:71:3F:1F:24,4420576,1170237101,601196,688522325,3819380,481714776,37,499343,558752012,498765,558682332,578,69680,481673,10,601433,49832,34,432,130000.0,43333.0,-67.0,-65.0,-70.0,-67.0,-67.0,-65.0,-70.0,-67.0,-90.0,-92.0,-90.0,-92.0,23.0,27.0,20.0,25.0,0
2355,CC:2F:71:3E:C5:1F,3820085,481801023,705,86247,3819380,481714776,0,2991,250785,2476,189571,515,61214,747,8,1036,18,0,32,144444.0,43333.0,-70.0,-71.0,-68.0,-60.0,-70.0,-71.0,-67.0,-59.0,-90.0,-92.0,-90.0,-92.0,20.0,21.0,22.0,32.0,0
2356,BA:8C:B9:54:50:24,3821122,482553862,1742,839086,3819380,481714776,0,5648,827140,5628,824018,20,3122,1004,14,2117,29,0,49,229410.0,130000.0,-39.0,-37.0,-44.0,-52.0,-43.0,-36.0,-43.0,-48.0,-90.0,-92.0,-90.0,-92.0,51.0,55.0,46.0,40.0,0
2357,92:69:1D:31:68:E9,3822939,485209340,3557,3494362,3819382,481714978,0,3766,968378,3665,945878,101,22500,1869,6,3683,79,0,31,216660.0,130000.0,-52.0,-50.0,-44.0,-46.0,-51.0,-49.0,-43.0,-46.0,-90.0,-92.0,-90.0,-92.0,38.0,42.0,46.0,46.0,0
2358,CC:2F:71:3F:1F:24,4420621,1170251921,601237,688536741,3819384,481715180,37,499372,558757376,498794,558687696,578,69680,481702,10,601474,49838,34,432,130000.0,43333.0,-67.0,-65.0,-70.0,-67.0,-67.0,-65.0,-70.0,-67.0,-90.0,-92.0,-90.0,-92.0,23.0,27.0,20.0,25.0,0
2359,CC:2F:71:3E:C5:1F,3820089,481801427,705,86247,3819384,481715180,0,2991,250785,2476,189571,515,61214,747,8,1036,18,0,32,144444.0,43333.0,-70.0,-71.0,-68.0,-60.0,-70.0,-71.0,-67.0,-59.0,-90.0,-92.0,-90.0,-92.0,20.0,21.0,22.0,32.0,0
2360,BA:8C:B9:54:50:24,3821126,482554266,1742,839086,3819384,481715180,0,5648,827140,5628,824018,20,3122,1004,14,2117,29,0,49,229410.0,130000.0,-39.0,-37.0,-44.0,-52.0,-43.0,-36.0,-43.0,-48.0,-90.0,-92.0,-90.0,-92.0,51.0,55.0,46.0,40.0,0
2361,92:69:1D:31:68:E9,3822946,485210006,3557,3494362,3819389,481715644,0,3766,968378,3665,945878,101,22500,1869,6,3683,79,0,31,216660.0,130000.0,-52.0,-50.0,-44.0,-46.0,-51.0,-49.0,-43.0,-46.0,-90.0,-92.0,-90.0,-92.0,38.0,42.0,46.0,46.0,0
2362,CC:2F:71:3F:1F:24,4420669,1170266937,601280,688551293,3819389,481715644,37,499401,558762740,498823,558693060,578,69680,481731,10,601517,49858,34,432,117000.0,39000.0,-67.0,-65.0,-70.0,-67.0,-67.0,-65.0,-70.0,-67.0,-90.0,-92.0,-90.0,-92.0,23.0,27.0,20.0,25.0,0
2363,CC:2F:71:3E:C5:1F,3820094,481801891,705,86247,3819389,481715644,0,2991,250785,2476,189571,515,61214,747,8,1036,18,0,32,144444.0,43333.0,-70.0,-71.0,-68.0,-60.0,-70.0,-71.0,-67.0,-59.0,-90.0,-92.0,-90.0,-92.0,20.0,21.0,22.0,32.0,0
2364,BA:8C:B9:54:50:24,3821131,482554730,1742,839086,3819389,481715644,0,5648,827140,5628,824018,20,3122,1004,14,2117,29,0,49,229410.0,130000.0,-39.0,-37.0,-44.0,-52.0,-43.0,-36.0,-43.0,-48.0,-90.0,-92.0,-90.0,-92.0,51.0,55.0,46.0,40.0,0
2365,92:69:1D:31:68:E9,3822948,485210208,3557,3494362,3819391,481715846,0,3766,968378,3665,945878,101,22500,1869,6,3683,79,0,31,216660.0,130000.0,-52.0,-50.0,-44.0,-46.0,-51.0,-49.0,-43.0,-46.0,-90.0,-93.0,-90.0,-93.0,38.0,43.0,46.0,47.0,0
2366,CC:2F:71:3F:1F:24,4420717,1170282023,601324,688565975,3819393,481716048,37,499430,558768104,498852,558698424,578,69680,481760,10,601561,49865,34,432,130000.0,43333.0,-67.0,-65.0,-70.0,-68.0,-67.0,-65.0,-70.0,-67.0,-90.0,-93.0,-90.0,-93.0,23.0,28.0,20.0,25.0,0
2367,CC:2F:71:3E:C5:1F,3820098,481802295,705,86247,3819393,481716048,0,2991,250785,2476,189571,515,61214,747,8,1036,18,0,32,144444.0,43333.0,-70.0,-71.0,-68.0,-60.0,-70.0,-71.0,-67.0,-59.0,-90.0,-93.0,-90.0,-93.0,20.0,22.0,22.0,33.0,0
2368,BA:8C:B9:54:50:24,3821135,482555134,1742,839086,3819393,481716048,0,5648,827140,5628,824018,20,3122,1004,14,2117,29,0,49,229410.0,130000.0,-39.0,-37.0,-44.0,-52.0,-43.0,-36.0,-43.0,-48.0,-90.0,-93.0,-90.0,-93.0,51.0,56.0,46.0,41.0,0
2369,92:69:1D:31:68:E9,3822954,485210814,3557,3494362,3819397,481716452,0,3766,968378,3665,945878,101,22500,1869,6,3683,79,0,31,216660.0,130000.0,-52.0,-50.0,-44.0,-46.0,-51.0,-49.0,-43.0,-46.0,-90.0,-93.0,-90.0,-93.0,38.0,43.0,46.0,47.0,0
2370,CC:2F:71:3F:1F:24,4420764,1170297035,601367,688580583,3819397,481716452,37,499459,558773468,498881,558703788,578,69680,481789,10,601604,49878,34,432,130000.0,39000.0,-67.0,-65.0,-70.0,-68.0,-67.0,-65.0,-70.0,-67.0,-90.0,-93.0,-90.0,-93.0,23.0,28.0,20.0,25.0,0
2371,CC:2F:71:3E:C5:1F,3820102,481802699,705,86247,3819397,481716452,0,2991,250785,2476,189571,515,61214,747,8,1036,18,0,32,144444.0,43333.0,-70.0,-71.0,-68.0,-60.0,-70.0,-71.0,-67.0,-59.0,-90.0,-93.0,-90.0,-93.0,20.0,22.0,22.0,33.0,0
2372,BA:8C:B9:54:50:24,3821139,482555538,1742,839086,3819397,481716452,0,5648,827140,5628,824018,20,3122,1004,14,2117,29,0,49,229410.0,130000.0,-39.0,-37.0,-44.0,-52.0,-43.0,-36.0,-43.0,-48.0,-90.0,-93.0,-90.0,-93.0,51.0,56.0,46.0,41.0,0
2373,92:69:1D:31:68:E9,3822957,485211076,3557,3494362,3819400,481716714,0,3766,968378,3665,945878,101,22500,1869,6,3683,79,0,31,216660.0,130000.0,-52.0,-50.0,-44.0,-46.0,-51.0,-49.0,-43.0,-46.0,-90.0,-93.0,-90.0,-93.0,38.0,43.0,46.0,47.0,0
2374,CC:2F:71:3F:1F:24,4420812,1170311995,601410,688595079,3819402,481716916,37,499489,558778948,498911,558709268,578,69680,481819,10,601647,49898,34,432,130000.0,43333.0,-67.0,-65.0,-70.0,-68.0,-67.0,-65.0,-70.0,-67.0,-90.0,-93.0,-90.0,-93.0,23.0,28.0,20.0,25.0,0
2375,CC:2F:71:3E:C5:1F,3820107,481803163,705,86247,3819402,481716916,0,2991,250785,2476,189571,515,61214,747,8,1036,18,0,32,144444.0,43333.0,-70.0,-71.0,-68.0,-60.0,-70.0,-71.0,-67.0,-59.0,-90.0,-93.0,-90.0,-93.0,20.0,22.0,22.0,33.0,0
2376,BA:8C:B9:54:50:24,3821144,482556002,1742,839086,3819402,481716916,0,5648,827140,5628,824018,20,3122,1004,14,2117,29,0,49,229410.0,130000.0,-39.0,-37.0,-44.0,-52.0,-43.0,-36.0,-43.0,-48.0,-90.0,-93.0,-90.0,-93.0,51.0,56.0,46.0,41.0,0
2377,92:69:1D:31:68:E9,3822963,485211682,3557,3494362,3819406,481717320,0,3766,968378,3665,945878,101,22500,1869,6,3683,79,0,31,216660.0,130000.0,-52.0,-50.0,-44.0,-46.0,-51.0,-49.0,-43.0,-46.0,-90.0,-93.0,-90.0,-93.0,38.0,43.0,46.0,47.0,0
2378,CC:2F:71:3F:1F:24,4420859,1170326901,601453,688609581,3819406,481717320,37,499518,558784312,498940,558714632,578,69680,481848,10,601690,49908,34,432,130000.0,39000.0,-67.0,-65.0,-70.0,-67.0,-67.0,-65.0,-70.0,-67.0,-90.0,-93.0,-90.0,-93.0,23.0,28.0,20.0,26.0,0
2379,CC:2F:71:3E:C5:1F,3820111,481803567,705,86247,3819406,481717320,0,2991,250785,2476,189571,515,61214,747,8,1036,18,0,32,144444.0,43333.0,-70.0,-71.0,-68.0,-60.0,-70.0,-71.0,-67.0,-59.0,-90.0,-93.0,-90.0,-93.0,20.0,22.0,22.0,33.0,0
2380,BA:8C:B9:54:50:24,3821148,482556406,1742,839086,3819406,481717320,0,5648,827140,5628,824018,20,3122,1004,14,2117,29,0,49,229410.0,130000.0,-39.0,-37.0,-44.0,-52.0,-43.0,-36.0,-43.0,-48.0,-90.0,-93.0,-90.0,-93.0,51.0,56.0,46.0,41.0,0
2381,92:69:1D:31:68:E9,3822963,485211682,3557,3494362,3819406,481717320,0,3766,968378,3665,945878,101,22500,1869,6,3683,79,0,31,216660.0,130000.0,-52.0,-50.0,-44.0,-46.0,-51.0,-49.0,-43.0,-46.0,-90.0,-93.0,-90.0,-93.0,38.0,43.0,46.0,47.0,0
2382,CC:2F:71:3F:1F:24,4420904,1170341655,601496,688624133,3819408,481717522,37,499547,558789676,498969,558719996,578,69680,481877,10,601733,49925,34,432,130000.0,39000.0,-67.0,-65.0,-71.0,-67.0,-67.0,-65.0,-70.0,-67.0,-90.0,-93.0,-90.0,-93.0,23.0,28.0,19.0,26.0,0
2383,CC:2F:71:3E:C5:1F,3820116,481804031,705,86247,3819411,481717784,0,2991,250785,2476,189571,515,61214,747,8,1036,18,0,32,144444.0,43333.0,-70.0,-71.0,-68.0,-60.0,-70.0,-71.0,-67.0,-59.0,-90.0,-93.0,-90.0,-93.0,20.0,22.0,22.0,33.0,0
2384,BA:8C:B9:54:50:24,3821153,482556870,1742,839086,3819411,481717784,0,5648,827140,5628,824018,20,3122,1004,14,2117,29,0,49,229410.0,130000.0,-39.0,-37.0,-44.0,-52.0,-43.0,-36.0,-43.0,-48.0,-90.0,-93.0,-90.0,-93.0,51.0,56.0,46.0,41.0,0
2385,92:69:1D:31:68:E9,3822973,485212610,3558,3494422,3819415,481718188,0,3768,968514,3667,946014,101,22500,1869,6,3684,79,0,31,216660.0,130000.0,-52.0,-50.0,-44.0,-46.0,-51.0,-49.0,-43.0,-46.0,-90.0,-93.0,-90.0,-93.0,38.0,43.0,46.0,47.0,0
2386,CC:2F:71:3F:1F:24,4420955,1170356933,601540,688638745,3819415,481718188,37,499578,558795272,499000,558725592,578,69680,481908,10,601777,49938,34,432,130000.0,43333.0,-67.0,-65.0,-71.0,-67.0,-67.0,-65.0,-70.0,-67.0,-90.0,-93.0,-90.0,-93.0,23.0,28.0,19.0,26.0,0
2387,CC:2F:71:3E:C5:1F,3820121,481804551,706,86363,3819415,481718188,0,2993,250925,2478,189711,515,61214,747,8,1037,18,0,32,130000.0,39000.0,-70.0,-71.0,-67.0,-60.0,-69.0,-70.0,-67.0,-59.0,-90.0,-93.0,-90.0,-93.0,20.0,22.0,23.0,33.0,0
2388,BA:8C:B9:54:50:24,3821158,482557390,1743,839202,3819415,481718188,0,5650,827276,5630,824154,20,3122,1004,14,2118,29,0,49,229410.0,130000.0,-49.0,-35.0,-42.0,-44.0,-44.0,-36.0,-43.0,-47.0,-90.0,-93.0,-90.0,-93.0,41.0,58.0,48.0,49.0,0
2389,92:69:1D:31:68:E9,3822974,485212883,3558,3494422,3819416,481718461,0,3768,968514,3667,946014,101,22500,1869,6,3684,79,0,31,216660.0,130000.0,-52.0,-50.0,-44.0,-46.0,-51.0,-49.0,-43.0,-46.0,-90.0,-93.0,-90.0,-93.0,38.0,43.0,46.0,47.0,0
2390,CC:2F:71:3F:1F:24,4421000,1170371892,601582,688653229,3819418,481718663,37,499607,558800636,499029,558730956,578,69680,481937,10,601819,49957,34,432,130000.0,39000.0,-67.0,-65.0,-71.0,-68.0,-67.0,-65.0,-70.0,-67.0,-90.0,-93.0,-90.0,-93.0,23.0,28.0,19.0,25.0,0
2391,CC:2F:71:3E:C5:1F,3820126,481805228,706,86363,3819420,481718865,0,2993,250925,2478,189711,515,61214,747,8,1037,18,0,32,130000.0,39000.0,-70.0,-71.0,-67.0,-60.0,-69.0,-70.0,-67.0,-59.0,-90.0,-93.0,-90.0,-93.0,20.0,22.0,23.0,33.0,0
2392,BA:8C:B9:54:50:24,3821165,482558351,1745,839486,3819420,481718865,0,5660,828088,5640,824966,20,3122,1006,14,2120,29,0,49,229410.0,130000.0,-49.0,-35.0,-42.0,-44.0,-43.0,-35.0,-43.0,-46.0,-90.0,-93.0,-90.0,-93.0,41.0,58.0,48.0,49.0,0
2393,92:69:1D:31:68:E9,3822983,485213751,3558,3494422,3819425,481719329,0,3768,968514,3667,946014,101,22500,1869,6,3684,79,0,31,216660.0,130000.0,-52.0,-50.0,-44.0,-46.0,-51.0,-49.0,-43.0,-46.0,-90.0,-93.0,-90.0,-93.0,38.0,43.0,46.0,47.0,0
2394,CC:2F:71:3F:1F:24,4421049,1170386930,601624,688667601,3819425,481719329,37,499636,558806000,499058,558736320,578,69680,481966,10,601861,49982,34,432,130000.0,43333.0,-67.0,-65.0,-70.0,-68.0,-67.0,-65.0,-70.0,-67.0,-90.0,-93.0,-90.0,-93.0,23.0,28.0,20.0,25.0,0
2395,CC:2F:71:3E:C5:1F,3820131,481805692,706,86363,3819425,481719329,0,2993,250925,2478,189711,515,61214,747,8,1037,18,0,32,130000.0,39000.0,-70.0,-71.0,-67.0,-60.0,-69.0,-70.0,-67.0,-59.0,-90.0,-93.0,-90.0,-93.0,20.0,22.0,23.0,33.0,0
2396,BA:8C:B9:54:50:24,3821170,482558815,1745,839486,3819425,481719329,0,5660,828088,5640,824966,20,3122,1006,14,2120,29,0,49,229410.0,130000.0,-49.0,-35.0,-42.0,-44.0,-43.0,-35.0,-43.0,-46.0,-90.0,-93.0,-90.0,-93.0,41.0,58.0,48.0,49.0,0
2397,92:69:1D:31:68:E9,3822983,485213751,3558,3494422,3819425,481719329,0,3768,968514,3667,946014,101,22500,1869,6,3684,79,0,31,216660.0,130000.0,-52.0,-50.0,-44.0,-46.0,-51.0,-49.0,-43.0,-46.0,-90.0,-93.0,-90.0,-93.0,38.0,43.0,46.0,47.0,0
2398,CC:2F:71:3F:1F:24,4421093,1170401672,601666,688682141,3819427,481719531,37,499667,558811572,499089,558741892,578,69680,481997,10,601903,49988,34,432,130000.0,43333.0,-67.0,-65.0,-71.0,-67.0,-67.0,-65.0,-70.0,-67.0,-90.0,-93.0,-90.0,-93.0,23.0,28.0,19.0,26.0,0
2399,CC:2F:71:3E:C5:1F,3820133,481805894,706,86363,3819427,481719531,0,2993,250925,2478,189711,515,61214,747,8,1037,18,0,32,130000.0,39000.0,-70.0,-71.0,-67.0,-60.0,-69.0,-70.0,-67.0,-59.0,-90.0,-93.0,-90.0,-93.0,20.0,22.0,23.0,33.0,0
2400,BA:8C:B9:54:50:24,3821174,482559219,1745,839486,3819429,481719733,0,5660,828088,5640,824966,20,3122,1006,14,2120,29,0,49,229410.0,130000.0,-49.0,-35.0,-42.0,-44.0,-43.0,-35.0,-43.0,-46.0,-90.0,-93.0,-90.0,-93.0,41.0,58.0,48.0,49.0,0
2401,92:69:1D:31:68:E9,3822991,485214559,3558,3494422,3819433,481720137,0,3768,968514,3667,946014,101,22500,1869,6,3684,79,0,31,216660.0,130000.0,-52.0,-50.0,-44.0,-46.0,-51.0,-49.0,-43.0,-46.0,-90.0,-93.0,-90.0,-93.0,38.0,43.0,46.0,47.0,0
2402,CC:2F:71:3F:1F:24,4421141,1170416762,601708,688696625,3819433,481720137,37,499696,558816936,499118,558747256,578,69680,482026,10,601945,50007,34,432,130000.0,39000.0,-67.0,-65.0,-71.0,-67.0,-67.0,-65.0,-70.0,-67.0,-90.0,-93.0,-90.0,-93.0,23.0,28.0,19.0,26.0,0
2403,CC:2F:71:3E:C5:1F,3820139,481806500,706,86363,3819433,481720137,0,2993,250925,2478,189711,515,61214,747,8,1037,18,0,32,130000.0,39000.0,-70.0,-71.0,-67.0,-60.0,-69.0,-70.0,-67.0,-59.0,-90.0,-93.0,-90.0,-93.0,20.0,22.0,23.0,33.0,0
2404,BA:8C:B9:54:50:24,3821178,482559623,1745,839486,3819433,481720137,0,5660,828088,5640,824966,20,3122,1006,14,2120,29,0,49,229410.0,130000.0,-49.0,-35.0,-42.0,-44.0,-43.0,-35.0,-43.0,-46.0,-90.0,-93.0,-90.0,-93.0,41.0,58.0,48.0,49.0,0
2405,92:69:1D:31:68:E9,3822992,485214619,3558,3494422,3819434,481720197,0,3768,968514,3667,946014,101,22500,1869,6,3684,79,0,31,216660.0,130000.0,-52.0,-50.0,-44.0,-46.0,-51.0,-49.0,-43.0,-46.0,-90.0,-93.0,-90.0,-93.0,38.0,43.0,46.0,47.0,0
2406,CC:2F:71:3F:1F:24,4421186,1170431396,601750,688710997,3819436,481720399,37,499725,558822300,499147,558752620,578,69680,482055,10,601986,50036,34,432,130000.0,43333.0,-67.0,-65.0,-70.0,-68.0,-67.0,-65.0,-70.0,-67.0,-90.0,-93.0,-90.0,-93.0,23.0,28.0,20.0,25.0,0
2407,CC:2F:71:3E:C5:1F,3820142,481806762,706,86363,3819436,481720399,0,2993,250925,2478,189711,515,61214,747,8,1037,18,0,32,130000.0,39000.0,-70.0,-71.0,-67.0,-60.0,-69.0,-70.0,-67.0,-59.0,-90.0,-93.0,-90.0,-93.0,20.0,22.0,23.0,33.0,0
2408,BA:8C:B9:54:50:24,3821183,482560087,1745,839486,3819438,481720601,0,5660,828088,5640,824966,20,3122,1006,14,2120,29,0,49,229410.0,130000.0,-49.0,-35.0,-42.0,-44.0,-43.0,-35.0,-43.0,-46.0,-90.0,-93.0,-90.0,-93.0,41.0,58.0,48.0,49.0,0
2409,92:69:1D:31:68:E9,3823000,485215427,3558,3494422,3819442,481721005,0,3768,968514,3667,946014,101,22500,1869,6,3684,79,0,31,216660.0,130000.0,-52.0,-50.0,-44.0,-46.0,-51.0,-49.0,-43.0,-46.0,-90.0,-93.0,-90.0,-93.0,38.0,43.0,46.0,47.0,0
2410,CC:2F:71:3F:1F:24,4421235,1170446672,601793,688725667,3819442,481721005,37,499754,558827664,499176,558757984,578,69680,482084,10,602030,50041,34,432,130000.0,43333.0,-67.0,-65.0,-70.0,-67.0,-67.0,-65.0,-70.0,-67.0,-90.0,-93.0,-90.0,-93.0,23.0,28.0,20.0,26.0,0
2411,CC:2F:71:3E:C5:1F,3820148,481807368,706,86363,3819442,481721005,0,2993,250925,2478,189711,515,61214,747,8,1037,18,0,32,130000.0,39000.0,-70.0,-71.0,-67.0,-60.0,-69.0,-70.0,-67.0,-59.0,-90.0,-93.0,-90.0,-93.0,20.0,22.0,23.0,33.0,0
2412,BA:8C:B9:54:50:24,3821187,482560491,1745,839486,3819442,481721005,0,5660,828088,5640,824966,20,3122,1006,14,2120,29,0,49,229410.0,130000.0,-49.0,-35.0,-42.0,-44.0,-43.0,-35.0,-43.0,-46.0,-90.0,-93.0,-90.0,-93.0,41.0,58.0,48.0,49.0,0
2413,92:69:1D:31:68:E9,3823000,485215427,3558,3494422,3819442,481721005,0,3768,968514,3667,946014,101,22500,1869,6,3684,79,0,31,216660.0,130000.0,-52.0,-50.0,-44.0,-46.0,-51.0,-49.0,-43.0,-46.0,-90.0,-93.0,-90.0,-93.0,38.0,43.0,46.0,47.0,0
2414,CC:2F:71:3F:1F:24,4421281,1170461486,601836,688740219,3819445,481721267,37,499783,558833070,499205,558763390,578,69680,482113,10,602073,50061,34,432,117000.0,39000.0,-67.0,-65.0,-70.0,-68.0,-67.0,-65.0,-70.0,-67.0,-90.0,-93.0,-90.0,-93.0,23.0,28.0,20.0,25.0,0
2415,CC:2F:71:3E:C5:1F,3820151,481807630,706,86363,3819445,481721267,0,2993,250925,2478,189711,515,61214,747,8,1037,18,0,32,130000.0,39000.0,-70.0,-71.0,-67.0,-60.0,-69.0,-70.0,-67.0,-59.0,-90.0,-93.0,-90.0,-93.0,20.0,22.0,23.0,33.0,0
2416,BA:8C:B9:54:50:24,3821190,482560753,1745,839486,3819445,481721267,0,5660,828088,5640,824966,20,3122,1006,14,2120,29,0,49,229410.0,130000.0,-49.0,-35.0,-42.0,-44.0,-43.0,-35.0,-43.0,-46.0,-90.0,-93.0,-90.0,-93.0,41.0,58.0,48.0,49.0,0
2417,92:69:1D:31:68:E9,3823009,485216295,3558,3494422,3819451,481721873,0,3768,968514,3667,946014,101,22500,1869,6,3684,79,0,31,216660.0,130000.0,-52.0,-50.0,-44.0,-46.0,-51.0,-49.0,-43.0,-46.0,-90.0,-93.0,-90.0,-93.0,38.0,43.0,46.0,47.0,0
2418,CC:2F:71:3F:1F:24,4421330,1170476644,601879,688754771,3819451,481721873,37,499813,558838550,499235,558768870,578,69680,482143,10,602116,50067,34,432,130000.0,43333.0,-67.0,-65.0,-70.0,-67.0,-67.0,-65.0,-70.0,-67.0,-90.0,-93.0,-90.0,-93.0,23.0,28.0,20.0,26.0,0
2419,CC:2F:71:3E:C5:1F,3820157,481808236,706,86363,3819451,481721873,0,2993,250925,2478,189711,515,61214,747,8,1037,18,0,32,130000.0,39000.0,-70.0,-71.0,-67.0,-60.0,-69.0,-70.0,-67.0,-59.0,-90.0,-93.0,-90.0,-93.0,20.0,22.0,23.0,33.0,0
2420,BA:8C:B9:54:50:24,3821197,482561475,1746,839602,3819451,481721873,0,5665,828466,5645,825344,20,3122,1007,14,2121,29,0,49,229410.0,130000.0,-40.0,-37.0,-44.0,-51.0,-41.0,-36.0,-43.0,-49.0,-90.0,-93.0,-90.0,-93.0,50.0,56.0,46.0,42.0,0
2421,92:69:1D:31:68:E9,3823013,485218062,3562,3496189,3819451,481721873,0,3776,971799,3675,949299,101,22500,1874,6,3688,79,0,31,216660.0,130000.0,-52.0,-50.0,-44.0,-46.0,-52.0,-50.0,-45.0,-49.0,-90.0,-93.0,-90.0,-93.0,38.0,43.0,46.0,47.0,0
2422,CC:2F:71:3F:1F:24,4421373,1170491252,601922,688769379,3819451,481721873,37,499842,558843914,499264,558774234,578,69680,482172,10,602159,50079,34,432,130000.0,39000.0,-67.0,-65.0,-70.0,-68.0,-67.0,-65.0,-70.0,-67.0,-90.0,-93.0,-90.0,-93.0,23.0,28.0,20.0,25.0,0
2423,CC:2F:71:3E:C5:1F,3820159,481808438,706,86363,3819453,481722075,0,2993,250925,2478,189711,515,61214,747,8,1037,18,0,32,130000.0,39000.0,-70.0,-71.0,-67.0,-60.0,-69.0,-70.0,-67.0,-59.0,-90.0,-93.0,-90.0,-93.0,20.0,22.0,23.0,33.0,0
2424,BA:8C:B9:54:50:24,3821199,482561677,1746,839602,3819453,481722075,0,5665,828466,5645,825344,20,3122,1007,14,2121,29,0,49,229410.0,130000.0,-40.0,-37.0,-44.0,-51.0,-41.0,-36.0,-43.0,-49.0,-90.0,-93.0,-90.0,-93.0,50.0,56.0,46.0,42.0,0
2425,92:69:1D:31:68:E9,3823023,485218992,3562,3496189,3819461,481722803,0,3777,971867,3676,949367,101,22500,1874,6,3688,79,0,31,216660.0,130000.0,-52.0,-50.0,-44.0,-46.0,-52.0,-50.0,-45.0,-49.0,-90.0,-93.0,-90.0,-93.0,38.0,43.0,46.0,47.0,0
2426,CC:2F:71:3F:1F:24,4421426,1170506684,601965,688783881,3819461,481722803,37,499874,558849764,499295,558779966,579,69798,482204,10,602202,50120,34,432,130000.0,43333.0,-67.0,-65.0,-70.0,-68.0,-67.0,-65.0,-70.0,-67.0,-90.0,-93.0,-90.0,-93.0,23.0,28.0,20.0,25.0,0
2427,CC:2F:71:3E:C5:1F,3820167,481809166,706,86363,3819461,481722803,0,2993,250925,2478,189711,515,61214,747,8,1037,18,0,32,130000.0,39000.0,-70.0,-71.0,-67.0,-60.0,-69.0,-70.0,-67.0,-59.0,-90.0,-93.0,-90.0,-93.0,20.0,22.0,23.0,33.0,0
2428,BA:8C:B9:54:50:24,3821207,482562405,1746,839602,3819461,481722803,0,5665,828466,5645,825344,20,3122,1007,14,2121,29,0,49,229410.0,130000.0,-40.0,-37.0,-44.0,-51.0,-41.0,-36.0,-43.0,-49.0,-90.0,-93.0,-90.0,-93.0,50.0,56.0,46.0,42.0,0
2429,92:69:1D:31:68:E9,3823023,485218992,3562,3496189,3819461,481722803,0,3777,971867,3676,949367,101,22500,1874,6,3688,79,0,31,216660.0,130000.0,-52.0,-50.0,-44.0,-46.0,-52.0,-50.0,-45.0,-49.0,-90.0,-93.0,-90.0,-93.0,38.0,43.0,46.0,47.0,0
2430,CC:2F:71:3F:1F:24,4421470,1170521478,602009,688798675,3819461,481722803,37,499903,558855128,499324,558785330,579,69798,482233,10,602246,50125,34,432,130000.0,43333.0,-67.0,-65.0,-70.0,-67.0,-67.0,-65.0,-70.0,-67.0,-90.0,-93.0,-90.0,-93.0,23.0,28.0,20.0,26.0,0
2431,CC:2F:71:3E:C5:1F,3820169,481809368,706,86363,3819463,481723005,0,2993,250925,2478,189711,515,61214,747,8,1037,18,0,32,130000.0,39000.0,-70.0,-71.0,-67.0,-60.0,-69.0,-70.0,-67.0,-59.0,-90.0,-93.0,-90.0,-93.0,20.0,22.0,23.0,33.0,0
2432,BA:8C:B9:54:50:24,3821211,482562809,1746,839602,3819465,481723207,0,5665,828466,5645,825344,20,3122,1007,14,2121,29,0,49,229410.0,130000.0,-40.0,-37.0,-44.0,-51.0,-41.0,-36.0,-43.0,-49.0,-90.0,-93.0,-90.0,-93.0,50.0,56.0,46.0,42.0,0
2433,92:69:1D:31:68:E9,3823031,485219800,3562,3496189,3819469,481723611,0,3777,971867,3676,949367,101,22500,1874,6,3688,79,0,31,216660.0,130000.0,-52.0,-50.0,-44.0,-46.0,-52.0,-50.0,-45.0,-49.0,-90.0,-93.0,-90.0,-93.0,38.0,43.0,46.0,47.0,0
2434,CC:2F:71:3F:1F:24,4421521,1170536894,602052,688813283,3819469,481723611,37,499932,558860492,499353,558790694,579,69798,482262,10,602289,50147,34,432,130000.0,39000.0,-67.0,-65.0,-70.0,-68.0,-67.0,-65.0,-70.0,-67.0,-90.0,-93.0,-90.0,-93.0,23.0,28.0,20.0,25.0,0
2435,CC:2F:71:3E:C5:1F,3820175,481809974,706,86363,3819469,481723611,0,2993,250925,2478,189711,515,61214,747,8,1037,18,0,32,130000.0,39000.0,-70.0,-71.0,-67.0,-60.0,-69.0,-70.0,-67.0,-59.0,-90.0,-93.0,-90.0,-93.0,20.0,22.0,23.0,33.0,0
2436,BA:8C:B9:54:50:24,3821215,482563213,1746,839602,3819469,481723611,0,5665,828466,5645,825344,20,3122,1007,14,2121,29,0,49,229410.0,130000.0,-40.0,-37.0,-44.0,-51.0,-41.0,-36.0,-43.0,-49.0,-90.0,-93.0,-90.0,-93.0,50.0,56.0,46.0,42.0,0
2437,92:69:1D:31:68:E9,3823056,485230945,3562,3496189,3819494,481734756,0,3780,972238,3678,949503,102,22735,1875,6,3688,79,0,31,216660.0,130000.0,-52.0,-50.0,-44.0,-46.0,-51.0,-50.0,-44.0,-49.0,-90.0,-93.0,-90.0,-93.0,38.0,43.0,46.0,47.0,0
2438,CC:2F:71:3F:1F:24,4421589,1170562535,602095,688827779,3819494,481734756,37,499963,558866152,499384,558796354,579,69798,482293,10,602332,50156,34,432,130000.0,43333.0,-67.0,-65.0,-71.0,-68.0,-67.0,-65.0,-70.0,-67.0,-90.0,-93.0,-90.0,-93.0,23.0,28.0,19.0,25.0,0
2439,CC:2F:71:3E:C5:1F,3820202,481821321,706,86363,3819496,481734958,0,2995,251113,2479,189781,516,61332,748,8,1037,18,0,32,130000.0,39000.0,-70.0,-71.0,-67.0,-60.0,-69.0,-70.0,-67.0,-60.0,-90.0,-93.0,-90.0,-93.0,20.0,22.0,23.0,33.0,0
2440,BA:8C:B9:54:50:24,3821246,482574964,1746,839602,3819500,481735362,0,5665,828466,5645,825344,20,3122,1007,14,2121,29,0,49,229410.0,130000.0,-40.0,-37.0,-44.0,-51.0,-41.0,-36.0,-43.0,-49.0,-90.0,-93.0,-90.0,-93.0,50.0,56.0,46.0,42.0,0
2441,92:69:1D:31:68:E9,3823065,485232026,3562,3496189,3819503,481735837,0,3780,972238,3678,949503,102,22735,1875,6,3688,79,0,31,216660.0,130000.0,-52.0,-50.0,-44.0,-46.0,-51.0,-50.0,-44.0,-49.0,-90.0,-93.0,-90.0,-93.0,38.0,43.0,46.0,47.0,0
2442,CC:2F:71:3F:1F:24,4421638,1170577902,602135,688842065,3819503,481735837,37,499993,558871632,499414,558801834,579,69798,482323,10,602372,50163,34,432,130000.0,43333.0,-67.0,-65.0,-70.0,-67.0,-67.0,-65.0,-70.0,-67.0,-90.0,-93.0,-90.0,-93.0,23.0,28.0,20.0,26.0,0
2443,CC:2F:71:3E:C5:1F,3820209,481822200,706,86363,3819503,481735837,0,2995,251113,2479,189781,516,61332,748,8,1037,18,0,32,130000.0,39000.0,-70.0,-71.0,-67.0,-60.0,-69.0,-70.0,-67.0,-60.0,-90.0,-93.0,-90.0,-93.0,20.0,22.0,23.0,33.0,0
2444,BA:8C:B9:54:50:24,3821249,482575439,1746,839602,3819503,481735837,0,5665,828466,5645,825344,20,3122,1007,14,2121,29,0,49,229410.0,130000.0,-40.0,-37.0,-44.0,-51.0,-41.0,-36.0,-43.0,-49.0,-90.0,-93.0,-90.0,-93.0,50.0,56.0,46.0,42.0,0
2445,92:69:1D:31:68:E9,3823066,485232086,3562,3496189,3819504,481735897,0,3780,972238,3678,949503,102,22735,1875,6,3688,79,0,31,216660.0,130000.0,-52.0,-50.0,-44.0,-46.0,-51.0,-50.0,-44.0,-49.0,-90.0,-93.0,-90.0,-93.0,38.0,43.0,46.0,47.0,0
2446,CC:2F:71:3F:1F:24,4421683,1170592694,602179,688856797,3819504,481735897,37,500022,558876996,499443,558807198,579,69798,482352,10,602416,50184,34,432,130000.0,39000.0,-67.0,-65.0,-70.0,-68.0,-67.0,-65.0,-70.0,-67.0,-90.0,-93.0,-90.0,-93.0,23.0,28.0,20.0,25.0,0
2447,CC:2F:71:3E:C5:1F,3820214,481822664,706,86363,3819508,481736301,0,2995,251113,2479,189781,516,61332,748,8,1037,18,0,32,130000.0,39000.0,-70.0,-71.0,-67.0,-60.0,-69.0,-70.0,-67.0,-60.0,-90.0,-93.0,-90.0,-93.0,20.0,22.0,23.0,33.0,0
2448,BA:8C:B9:54:50:24,3821254,482575903,1746,839602,3819508,481736301,0,5665,828466,5645,825344,20,3122,1007,14,2121,29,0,49,229410.0,130000.0,-40.0,-37.0,-44.0,-51.0,-41.0,-36.0,-43.0,-49.0,-90.0,-93.0,-90.0,-93.0,50.0,56.0,46.0,42.0,0
2449,92:69:1D:31:68:E9,3823076,485233126,3564,3496421,3819512,481736705,0,3786,972726,3684,949991,102,22735,1877,6,3690,79,0,31,216660.0,130000.0,-50.0,-47.0,-42.0,-48.0,-51.0,-50.0,-44.0,-48.0,-90.0,-93.0,-90.0,-93.0,40.0,46.0,48.0,45.0,0
2450,CC:2F:71:3F:1F:24,4421735,1170608128,602223,688871423,3819512,481736705,37,500051,558882360,499472,558812562,579,69798,482381,10,602460,50192,34,432,130000.0,43333.0,-67.0,-65.0,-70.0,-67.0,-67.0,-65.0,-70.0,-67.0,-90.0,-93.0,-90.0,-93.0,23.0,28.0,20.0,26.0,0
2451,CC:2F:71:3E:C5:1F,3820218,481823068,706,86363,3819512,481736705,0,2995,251113,2479,189781,516,61332,748,8,1037,18,0,32,130000.0,39000.0,-70.0,-71.0,-67.0,-60.0,-69.0,-70.0,-67.0,-60.0,-90.0,-93.0,-90.0,-93.0,20.0,22.0,23.0,33.0,0
2452,BA:8C:B9:54:50:24,3821258,482576307,1746,839602,3819512,481736705,0,5665,828466,5645,825344,20,3122,1007,14,2121,29,0,49,229410.0,130000.0,-40.0,-37.0,-44.0,-51.0,-41.0,-36.0,-43.0,-49.0,-90.0,-93.0,-90.0,-93.0,50.0,56.0,46.0,42.0,0
2453,92:69:1D:31:68:E9,3823078,485233494,3564,3496421,3819514,481737073,0,3786,972726,3684,949991,102,22735,1877,6,3690,79,0,31,216660.0,130000.0,-50.0,-47.0,-42.0,-48.0,-51.0,-50.0,-44.0,-48.0,-90.0,-93.0,-90.0,-93.0,40.0,46.0,48.0,45.0,0
2454,CC:2F:71:3F:1F:24,4421780,1170623110,602266,688886037,3819514,481737073,37,500080,558887760,499501,558817962,579,69798,482410,10,602503,50202,34,432,130000.0,39000.0,-67.0,-65.0,-71.0,-68.0,-67.0,-65.0,-70.0,-67.0,-90.0,-93.0,-90.0,-93.0,23.0,28.0,19.0,25.0,0
2455,CC:2F:71:3E:C5:1F,3820224,481823840,706,86363,3819518,481737477,0,2995,251113,2479,189781,516,61332,748,8,1037,18,0,32,130000.0,39000.0,-70.0,-71.0,-67.0,-60.0,-69.0,-70.0,-67.0,-60.0,-90.0,-93.0,-90.0,-93.0,20.0,22.0,23.0,33.0,0
2456,BA:8C:B9:54:50:24,3821264,482577079,1746,839602,3819518,481737477,0,5665,828466,5645,825344,20,3122,1007,14,2121,29,0,49,229410.0,130000.0,-40.0,-37.0,-44.0,-51.0,-41.0,-36.0,-43.0,-49.0,-90.0,-93.0,-90.0,-93.0,50.0,56.0,46.0,42.0,0
2457,92:69:1D:31:68:E9,3823085,485234160,3564,3496421,3819521,481737739,0,3786,972726,3684,949991,102,22735,1877,6,3690,79,0,31,216660.0,130000.0,-50.0,-47.0,-42.0,-48.0,-51.0,-50.0,-44.0,-48.0,-90.0,-93.0,-90.0,-93.0,40.0,46.0,48.0,45.0,0
2458,CC:2F:71:3F:1F:24,4421830,1170638338,602307,688900397,3819523,481737941,37,500110,558893240,499531,558823442,579,69798,482440,10,602544,50228,34,432,130000.0,39000.0,-67.0,-65.0,-70.0,-67.0,-67.0,-65.0,-70.0,-67.0,-90.0,-93.0,-90.0,-93.0,23.0,28.0,20.0,26.0,0
2459,CC:2F:71:3E:C5:1F,3820229,481824304,706,86363,3819523,481737941,0,2995,251113,2479,189781,516,61332,748,8,1037,18,0,32,130000.0,39000.0,-70.0,-71.0,-67.0,-60.0,-69.0,-70.0,-67.0,-60.0,-90.0,-93.0,-90.0,-93.0,20.0,22.0,23.0,33.0,0
2460,BA:8C:B9:54:50:24,3821269,482577543,1746,839602,3819523,481737941,0,5665,828466,5645,825344,20,3122,1007,14,2121,29,0,49,229410.0,130000.0,-40.0,-37.0,-44.0,-51.0,-41.0,-36.0,-43.0,-49.0,-90.0,-93.0,-90.0,-93.0,50.0,56.0,46.0,42.0,0
2461,92:69:1D:31:68:E9,3823087,485234362,3564,3496421,3819523,481737941,0,3786,972726,3684,949991,102,22735,1877,6,3690,79,0,31,216660.0,130000.0,-50.0,-47.0,-42.0,-48.0,-51.0,-50.0,-44.0,-48.0,-90.0,-93.0,-90.0,-93.0,40.0,46.0,48.0,45.0,0
2462,CC:2F:71:3F:1F:24,4421876,1170653114,602349,688914769,3819527,481738345,37,500139,558898604,499560,558828806,579,69798,482469,10,602586,50237,34,432,130000.0,39000.0,-67.0,-65.0,-71.0,-68.0,-67.0,-65.0,-70.0,-67.0,-90.0,-93.0,-90.0,-93.0,23.0,28.0,19.0,25.0,0
2463,CC:2F:71:3E:C5:1F,3820233,481824708,706,86363,3819527,481738345,0,2995,251113,2479,189781,516,61332,748,8,1037,18,0,32,130000.0,39000.0,-70.0,-71.0,-67.0,-60.0,-69.0,-70.0,-67.0,-60.0,-90.0,-93.0,-90.0,-93.0,20.0,22.0,23.0,33.0,0
2464,BA:8C:B9:54:50:24,3821275,482578149,1746,839602,3819529,481738547,0,5671,828874,5651,825752,20,3122,1007,14,2121,29,0,49,229410.0,130000.0,-49.0,-35.0,-42.0,-44.0,-43.0,-36.0,-43.0,-48.0,-90.0,-93.0,-90.0,-93.0,41.0,58.0,48.0,49.0,0
2465,92:69:1D:31:68:E9,3823095,485235170,3564,3496421,3819531,481738749,0,3786,972726,3684,949991,102,22735,1877,6,3690,79,0,31,216660.0,130000.0,-50.0,-47.0,-42.0,-48.0,-51.0,-50.0,-44.0,-48.0,-90.0,-93.0,-90.0,-93.0,40.0,46.0,48.0,45.0,0
2466,CC:2F:71:3F:1F:24,4421924,1170668186,602392,688929377,3819532,481738809,37,500169,558904108,499590,558834310,579,69798,482499,10,602629,50266,34,432,130000.0,39000.0,-67.0,-65.0,-70.0,-67.0,-67.0,-65.0,-70.0,-67.0,-90.0,-93.0,-90.0,-93.0,23.0,28.0,20.0,26.0,0
2467,CC:2F:71:3E:C5:1F,3820238,481825172,706,86363,3819532,481738809,0,2995,251113,2479,189781,516,61332,748,8,1037,18,0,32,130000.0,39000.0,-70.0,-71.0,-67.0,-60.0,-69.0,-70.0,-67.0,-60.0,-90.0,-93.0,-90.0,-93.0,20.0,22.0,23.0,33.0,0
2468,BA:8C:B9:54:50:24,3821278,482578411,1746,839602,3819532,481738809,0,5671,828874,5651,825752,20,3122,1007,14,2121,29,0,49,229410.0,130000.0,-49.0,-35.0,-42.0,-44.0,-43.0,-36.0,-43.0,-48.0,-90.0,-93.0,-90.0,-93.0,41.0,58.0,48.0,49.0,0
2469,92:69:1D:31:68:E9,3823098,485235432,3564,3496421,3819534,481739011,0,3786,972726,3684,949991,102,22735,1877,6,3690,79,0,31,216660.0,130000.0,-50.0,-47.0,-42.0,-48.0,-51.0,-50.0,-44.0,-48.0,-90.0,-93.0,-90.0,-93.0,40.0,46.0,48.0,45.0,0
2470,CC:2F:71:3F:1F:24,4421969,1170682782,602433,688943569,3819536,481739213,37,500198,558909448,499619,558839650,579,69798,482528,10,602670,50284,34,432,117000.0,39000.0,-67.0,-65.0,-70.0,-68.0,-67.0,-65.0,-70.0,-67.0,-90.0,-93.0,-90.0,-93.0,23.0,28.0,20.0,25.0,0
2471,CC:2F:71:3E:C5:1F,3820242,481825576,706,86363,3819536,481739213,0,2995,251113,2479,189781,516,61332,748,8,1037,18,0,32,130000.0,39000.0,-70.0,-71.0,-67.0,-60.0,-69.0,-70.0,-67.0,-60.0,-90.0,-93.0,-90.0,-93.0,20.0,22.0,23.0,33.0,0
2472,BA:8C:B9:54:50:24,3821282,482578815,1746,839602,3819536,481739213,0,5671,828874,5651,825752,20,3122,1007,14,2121,29,0,49,229410.0,130000.0,-49.0,-35.0,-42.0,-44.0,-43.0,-36.0,-43.0,-48.0,-90.0,-93.0,-90.0,-93.0,41.0,58.0,48.0,49.0,0
2473,92:69:1D:31:68:E9,3823104,485236038,3564,3496421,3819540,481739617,0,3786,972726,3684,949991,102,22735,1877,6,3690,79,0,31,216660.0,130000.0,-50.0,-47.0,-42.0,-48.0,-51.0,-50.0,-44.0,-48.0,-90.0,-93.0,-90.0,-93.0,40.0,46.0,48.0,45.0,0
2474,CC:2F:71:3F:1F:24,4422018,1170697992,602478,688958375,3819540,481739617,37,500229,558915080,499650,558845282,579,69798,482559,10,602715,50292,34,432,130000.0,43333.0,-67.0,-65.0,-71.0,-68.0,-67.0,-65.0,-70.0,-67.0,-90.0,-93.0,-90.0,-93.0,23.0,28.0,19.0,25.0,0
2475,CC:2F:71:3E:C5:1F,3820246,481825980,706,86363,3819540,481739617,0,2995,251113,2479,189781,516,61332,748,8,1037,18,0,32,130000.0,39000.0,-70.0,-71.0,-67.0,-60.0,-69.0,-70.0,-67.0,-60.0,-90.0,-93.0,-90.0,-93.0,20.0,22.0,23.0,33.0,0
2476,BA:8C:B9:54:50:24,3821286,482579219,1746,839602,3819540,481739617,0,5671,828874,5651,825752,20,3122,1007,14,2121,29,0,49,229410.0,130000.0,-49.0,-35.0,-42.0,-44.0,-43.0,-36.0,-43.0,-48.0,-90.0,-93.0,-90.0,-93.0,41.0,58.0,48.0,49.0,0
2477,92:69:1D:31:68:E9,3823109,485236502,3564,3496421,3819545,481740081,0,3786,972726,3684,949991,102,22735,1877,6,3690,79,0,31,216660.0,130000.0,-50.0,-47.0,-42.0,-48.0,-51.0,-50.0,-44.0,-48.0,-90.0,-93.0,-90.0,-93.0,40.0,46.0,48.0,45.0,0
2478,CC:2F:71:3F:1F:24,4422066,1170713120,602521,688973039,3819545,481740081,37,500258,558920444,499679,558850646,579,69798,482588,10,602757,50298,34,432,130000.0,43333.0,-67.0,-65.0,-71.0,-68.0,-67.0,-65.0,-70.0,-67.0,-90.0,-93.0,-90.0,-93.0,23.0,28.0,19.0,25.0,0
2479,CC:2F:71:3E:C5:1F,3820251,481826444,706,86363,3819545,481740081,0,2995,251113,2479,189781,516,61332,748,8,1037,18,0,32,130000.0,39000.0,-70.0,-71.0,-67.0,-60.0,-69.0,-70.0,-67.0,-60.0,-90.0,-93.0,-90.0,-93.0,20.0,22.0,23.0,33.0,0
2480,BA:8C:B9:54:50:24,3821291,482579683,1746,839602,3819545,481740081,0,5671,828874,5651,825752,20,3122,1007,14,2121,29,0,49,229410.0,130000.0,-49.0,-35.0,-42.0,-44.0,-43.0,-36.0,-43.0,-48.0,-90.0,-93.0,-90.0,-93.0,41.0,58.0,48.0,49.0,0
2481,92:69:1D:31:68:E9,3823111,485236704,3564,3496421,3819547,481740283,0,3786,972726,3684,949991,102,22735,1877,6,3690,79,0,31,216660.0,130000.0,-50.0,-47.0,-42.0,-48.0,-51.0,-50.0,-44.0,-48.0,-90.0,-93.0,-90.0,-93.0,40.0,46.0,48.0,45.0,0
2482,CC:2F:71:3F:1F:24,4422111,1170727880,602564,688987597,3819547,481740283,37,500288,558925960,499709,558856162,579,69798,482618,10,602801,50313,34,432,117000.0,39000.0,-67.0,-65.0,-71.0,-67.0,-67.0,-65.0,-70.0,-67.0,-90.0,-93.0,-90.0,-93.0,23.0,28.0,19.0,26.0,0
2483,CC:2F:71:3E:C5:1F,3820255,481826848,706,86363,3819549,481740485,0,2995,251113,2479,189781,516,61332,748,8,1037,18,0,32,130000.0,39000.0,-70.0,-71.0,-67.0,-60.0,-69.0,-70.0,-67.0,-60.0,-90.0,-93.0,-90.0,-93.0,20.0,22.0,23.0,33.0,0
2484,BA:8C:B9:54:50:24,3821295,482580087,1746,839602,3819549,481740485,0,5671,828874,5651,825752,20,3122,1007,14,2121,29,0,49,229410.0,130000.0,-49.0,-35.0,-42.0,-44.0,-43.0,-36.0,-43.0,-48.0,-90.0,-93.0,-90.0,-93.0,41.0,58.0,48.0,49.0,0
2485,92:69:1D:31:68:E9,3823117,485237310,3564,3496421,3819553,481740889,0,3786,972726,3684,949991,102,22735,1877,6,3690,79,0,31,216660.0,130000.0,-50.0,-47.0,-42.0,-48.0,-51.0,-50.0,-44.0,-48.0,-90.0,-93.0,-90.0,-93.0,40.0,46.0,48.0,45.0,0
2486,CC:2F:71:3F:1F:24,4422159,1170742908,602606,689002019,3819553,481740889,37,500317,558931324,499738,558861526,579,69798,482647,10,602843,50318,34,432,130000.0,43333.0,-67.0,-65.0,-70.0,-67.0,-67.0,-65.0,-70.0,-67.0,-90.0,-93.0,-90.0,-93.0,23.0,28.0,20.0,26.0,0
2487,CC:2F:71:3E:C5:1F,3820259,481827252,706,86363,3819553,481740889,0,2995,251113,2479,189781,516,61332,748,8,1037,18,0,32,130000.0,39000.0,-70.0,-71.0,-67.0,-60.0,-69.0,-70.0,-67.0,-60.0,-90.0,-93.0,-90.0,-93.0,20.0,22.0,23.0,33.0,0
2488,BA:8C:B9:54:50:24,3821299,482580491,1746,839602,3819553,481740889,0,5671,828874,5651,825752,20,3122,1007,14,2121,29,0,49,229410.0,130000.0,-49.0,-35.0,-42.0,-44.0,-43.0,-36.0,-43.0,-48.0,-90.0,-93.0,-90.0,-93.0,41.0,58.0,48.0,49.0,0
2489,92:69:1D:31:68:E9,3823120,485237572,3564,3496421,3819556,481741151,0,3786,972726,3684,949991,102,22735,1877,6,3690,79,0,31,216660.0,130000.0,-50.0,-47.0,-42.0,-48.0,-51.0,-50.0,-44.0,-48.0,-90.0,-93.0,-90.0,-93.0,40.0,46.0,48.0,45.0,0
2490,CC:2F:71:3F:1F:24,4422207,1170758028,602649,689016675,3819558,481741353,37,500347,558936804,499768,558867006,579,69798,482677,10,602886,50325,34,432,130000.0,43333.0,-67.0,-65.0,-70.0,-67.0,-67.0,-65.0,-70.0,-67.0,-90.0,-93.0,-90.0,-93.0,23.0,28.0,20.0,26.0,0
2491,CC:2F:71:3E:C5:1F,3820265,481827776,707,86423,3819558,481741353,0,2996,251183,2480,189851,516,61332,748,8,1038,18,0,32,130000.0,39000.0,-70.0,-71.0,-67.0,-60.0,-69.0,-70.0,-67.0,-60.0,-90.0,-93.0,-90.0,-93.0,20.0,22.0,23.0,33.0,0
2492,BA:8C:B9:54:50:24,3821305,482581071,1747,839718,3819558,481741353,0,5675,829146,5655,826024,20,3122,1007,14,2122,29,0,49,229410.0,130000.0,-49.0,-35.0,-42.0,-44.0,-43.0,-35.0,-43.0,-47.0,-90.0,-93.0,-90.0,-93.0,41.0,58.0,48.0,49.0,0
2493,92:69:1D:31:68:E9,3823128,485238567,3565,3496537,3819563,481742030,0,3788,972862,3686,950127,102,22735,1877,6,3691,79,0,31,216660.0,130000.0,-52.0,-50.0,-44.0,-46.0,-51.0,-50.0,-44.0,-47.0,-90.0,-93.0,-90.0,-93.0,38.0,43.0,46.0,47.0,0
2494,CC:2F:71:3F:1F:24,4422257,1170773517,602694,689031487,3819563,481742030,37,500376,558942168,499797,558872370,579,69798,482706,10,602931,50345,34,432,130000.0,39000.0,-67.0,-65.0,-70.0,-68.0,-67.0,-65.0,-70.0,-67.0,-90.0,-93.0,-90.0,-93.0,23.0,28.0,20.0,25.0,0
2495,CC:2F:71:3E:C5:1F,3820270,481828453,707,86423,3819563,481742030,0,2997,251253,2481,189921,516,61332,748,8,1038,18,0,32,130000.0,39000.0,-70.0,-71.0,-67.0,-60.0,-69.0,-70.0,-67.0,-60.0,-90.0,-93.0,-90.0,-93.0,20.0,22.0,23.0,33.0,0
2496,BA:8C:B9:54:50:24,3821310,482581748,1747,839718,3819563,481742030,0,5675,829146,5655,826024,20,3122,1007,14,2122,29,0,49,229410.0,130000.0,-49.0,-35.0,-42.0,-44.0,-43.0,-35.0,-43.0,-47.0,-90.0,-93.0,-90.0,-93.0,41.0,58.0,48.0,49.0,0
2497,92:69:1D:31:68:E9,3823131,485238829,3565,3496537,3819566,481742292,0,3788,972862,3686,950127,102,22735,1877,6,3691,79,0,31,216660.0,130000.0,-52.0,-50.0,-44.0,-46.0,-51.0,-50.0,-44.0,-47.0,-90.0,-93.0,-90.0,-93.0,38.0,43.0,46.0,47.0,0
2498,CC:2F:71:3F:1F:24,4422301,1170788083,602735,689045791,3819566,481742292,37,500405,558947532,499826,558877734,579,69798,482735,10,602972,50349,34,432,130000.0,43333.0,-67.0,-65.0,-70.0,-67.0,-67.0,-65.0,-70.0,-67.0,-90.0,-93.0,-90.0,-93.0,23.0,28.0,20.0,26.0,0
2499,CC:2F:71:3E:C5:1F,3820275,481828917,707,86423,3819568,481742494,0,2997,251253,2481,189921,516,61332,748,8,1038,18,0,32,130000.0,39000.0,-70.0,-71.0,-67.0,-60.0,-69.0,-70.0,-67.0,-60.0,-90.0,-93.0,-90.0,-93.0,20.0,22.0,23.0,33.0,0
2500,BA:8C:B9:54:50:24,3821315,482582212,1747,839718,3819568,481742494,0,5676,829214,5656,826092,20,3122,1007,14,2122,29,0,49,229410.0,130000.0,-39.0,-37.0,-44.0,-51.0,-43.0,-35.0,-43.0,-47.0,-90.0,-93.0,-90.0,-93.0,51.0,56.0,46.0,42.0,0
2501,92:69:1D:31:68:E9,3823137,485239435,3565,3496537,3819572,481742898,0,3788,972862,3686,950127,102,22735,1877,6,3691,79,0,31,216660.0,130000.0,-52.0,-50.0,-44.0,-46.0,-51.0,-50.0,-44.0,-47.0,-90.0,-93.0,-90.0,-93.0,38.0,43.0,46.0,47.0,0
2502,CC:2F:71:3F:1F:24,4422351,1170803371,602779,689060473,3819572,481742898,37,500434,558952896,499855,558883098,579,69798,482764,10,603016,50373,34,432,117000.0,39000.0,-67.0,-65.0,-70.0,-68.0,-67.0,-65.0,-70.0,-67.0,-90.0,-93.0,-90.0,-93.0,23.0,28.0,20.0,25.0,0
2503,CC:2F:71:3E:C5:1F,3820279,481829321,707,86423,3819572,481742898,0,2997,251253,2481,189921,516,61332,748,8,1038,18,0,32,130000.0,39000.0,-70.0,-71.0,-67.0,-60.0,-69.0,-70.0,-67.0,-60.0,-90.0,-93.0,-90.0,-93.0,20.0,22.0,23.0,33.0,0
2504,BA:8C:B9:54:50:24,3821319,482582616,1747,839718,3819572,481742898,0,5676,829214,5656,826092,20,3122,1007,14,2122,29,0,49,229410.0,130000.0,-39.0,-37.0,-44.0,-51.0,-43.0,-35.0,-43.0,-47.0,-90.0,-93.0,-90.0,-93.0,51.0,56.0,46.0,42.0,0
2505,92:69:1D:31:68:E9,3823139,485239637,3565,3496537,3819574,481743100,0,3788,972862,3686,950127,102,22735,1877,6,3691,79,0,31,216660.0,130000.0,-52.0,-50.0,-44.0,-46.0,-51.0,-50.0,-44.0,-47.0,-90.0,-93.0,-90.0,-93.0,38.0,43.0,46.0,47.0,0
2506,CC:2F:71:3F:1F:24,4422396,1170818131,602822,689075031,3819574,481743100,37,500463,558958260,499884,558888462,579,69798,482793,10,603059,50377,34,432,130000.0,43333.0,-67.0,-65.0,-70.0,-67.0,-67.0,-65.0,-70.0,-67.0,-90.0,-93.0,-90.0,-93.0,23.0,28.0,20.0,26.0,0
2507,CC:2F:71:3E:C5:1F,3820283,481829725,707,86423,3819576,481743302,0,2997,251253,2481,189921,516,61332,748,8,1038,18,0,32,130000.0,39000.0,-70.0,-71.0,-67.0,-60.0,-69.0,-70.0,-67.0,-60.0,-90.0,-93.0,-90.0,-93.0,20.0,22.0,23.0,33.0,0
2508,BA:8C:B9:54:50:24,3821323,482583020,1747,839718,3819576,481743302,0,5676,829214,5656,826092,20,3122,1007,14,2122,29,0,49,229410.0,130000.0,-39.0,-37.0,-44.0,-51.0,-43.0,-35.0,-43.0,-47.0,-90.0,-93.0,-90.0,-93.0,51.0,56.0,46.0,42.0,0
2509,92:69:1D:31:68:E9,3823146,485240303,3565,3496537,3819581,481743766,0,3788,972862,3686,950127,102,22735,1877,6,3691,79,0,31,216660.0,130000.0,-52.0,-50.0,-44.0,-46.0,-51.0,-50.0,-44.0,-47.0,-90.0,-93.0,-90.0,-93.0,38.0,43.0,46.0,47.0,0
2510,CC:2F:71:3F:1F:24,4422446,1170833461,602865,689089695,3819581,481743766,37,500492,558963624,499913,558893826,579,69798,482822,10,603102,50388,34,432,130000.0,43333.0,-67.0,-65.0,-70.0,-67.0,-67.0,-65.0,-70.0,-67.0,-90.0,-93.0,-90.0,-93.0,23.0,28.0,20.0,26.0,0
2511,CC:2F:71:3E:C5:1F,3820288,481830189,707,86423,3819581,481743766,0,2997,251253,2481,189921,516,61332,748,8,1038,18,0,32,130000.0,39000.0,-70.0,-71.0,-67.0,-60.0,-69.0,-70.0,-67.0,-60.0,-90.0,-93.0,-90.0,-93.0,20.0,22.0,23.0,33.0,0
2512,BA:8C:B9:54:50:24,3821330,482583686,1747,839718,3819583,481743968,0,5676,829214,5656,826092,20,3122,1007,14,2122,29,0,49,229410.0,130000.0,-39.0,-37.0,-44.0,-51.0,-43.0,-35.0,-43.0,-47.0,-90.0,-93.0,-90.0,-93.0,51.0,56.0,46.0,42.0,0
2513,92:69:1D:31:68:E9,3823148,485240505,3565,3496537,3819583,481743968,0,3788,972862,3686,950127,102,22735,1877,6,3691,79,0,31,216660.0,130000.0,-52.0,-50.0,-44.0,-46.0,-51.0,-50.0,-44.0,-47.0,-90.0,-93.0,-90.0,-93.0,38.0,43.0,46.0,47.0,0
2514,CC:2F:71:3F:1F:24,4422490,1170848225,602907,689104257,3819583,481743968,37,500523,558969244,499944,558899446,579,69798,482853,10,603144,50408,34,432,117000.0,39000.0,-68.0,-66.0,-72.0,-68.0,-68.0,-66.0,-71.0,-68.0,-90.0,-93.0,-90.0,-93.0,22.0,27.0,18.0,25.0,0
2515,CC:2F:71:3E:C5:1F,3820291,481830525,707,86423,3819584,481744102,0,2997,251253,2481,189921,516,61332,748,8,1038,18,0,32,130000.0,39000.0,-70.0,-71.0,-67.0,-60.0,-69.0,-70.0,-67.0,-60.0,-90.0,-93.0,-90.0,-93.0,20.0,22.0,23.0,33.0,0
2516,BA:8C:B9:54:50:24,3821332,482583888,1747,839718,3819585,481744170,0,5676,829214,5656,826092,20,3122,1007,14,2122,29,0,49,229410.0,130000.0,-39.0,-37.0,-44.0,-51.0,-43.0,-35.0,-43.0,-47.0,-90.0,-93.0,-90.0,-93.0,51.0,56.0,46.0,42.0,0
2517,92:69:1D:31:68:E9,3823154,485241111,3565,3496537,3819589,481744574,0,3788,972862,3686,950127,102,22735,1877,6,3691,79,0,31,216660.0,130000.0,-52.0,-50.0,-44.0,-46.0,-51.0,-50.0,-44.0,-47.0,-90.0,-93.0,-90.0,-93.0,38.0,43.0,46.0,47.0,0
2518,CC:2F:71:3F:1F:24,4422538,1170863203,602949,689118629,3819589,481744574,37,500549,558974164,499970,558904366,579,69798,482879,10,603186,50418,34,432,130000.0,39000.0,-67.0,-65.0,-70.0,-68.0,-67.0,-65.0,-70.0,-67.0,-90.0,-93.0,-90.0,-93.0,23.0,28.0,20.0,25.0,0
2519,CC:2F:71:3E:C5:1F,3820297,481831057,707,86423,3819590,481744634,0,2997,251253,2481,189921,516,61332,748,8,1038,18,0,32,130000.0,39000.0,-70.0,-71.0,-67.0,-60.0,-69.0,-70.0,-67.0,-60.0,-90.0,-93.0,-90.0,-93.0,20.0,22.0,23.0,33.0,0
2520,BA:8C:B9:54:50:24,3821339,482584554,1747,839718,3819592,481744836,0,5676,829214,5656,826092,20,3122,1007,14,2122,29,0,49,229410.0,130000.0,-39.0,-37.0,-44.0,-51.0,-43.0,-35.0,-43.0,-47.0,-90.0,-93.0,-90.0,-93.0,51.0,56.0,46.0,42.0,0
2521,92:69:1D:31:68:E9,3823157,485241373,3565,3496537,3819592,481744836,0,3788,972862,3686,950127,102,22735,1877,6,3691,79,0,31,216660.0,130000.0,-52.0,-50.0,-44.0,-46.0,-51.0,-50.0,-44.0,-47.0,-90.0,-93.0,-90.0,-93.0,38.0,43.0,46.0,47.0,0
2522,CC:2F:71:3F:1F:24,4422582,1170877707,602990,689132871,3819592,481744836,37,500574,558978968,499995,558909170,579,69798,482904,10,603227,50433,34,432,130000.0,43333.0,-67.0,-65.0,-70.0,-67.0,-67.0,-65.0,-70.0,-67.0,-90.0,-93.0,-90.0,-93.0,23.0,28.0,20.0,26.0,0
2523,CC:2F:71:3E:C5:1F,3820299,481831259,707,86423,3819592,481744836,0,2997,251253,2481,189921,516,61332,748,8,1038,18,0,32,130000.0,39000.0,-70.0,-71.0,-67.0,-60.0,-69.0,-70.0,-67.0,-60.0,-90.0,-93.0,-90.0,-93.0,20.0,22.0,23.0,33.0,0
2524,BA:8C:B9:54:50:24,3821339,482584554,1747,839718,3819592,481744836,0,5676,829214,5656,826092,20,3122,1007,14,2122,29,0,49,229410.0,130000.0,-39.0,-37.0,-44.0,-51.0,-43.0,-35.0,-43.0,-47.0,-90.0,-93.0,-90.0,-93.0,51.0,56.0,46.0,42.0,0
2525,92:69:1D:31:68:E9,3823163,485241979,3565,3496537,3819598,481745442,0,3788,972862,3686,950127,102,22735,1877,6,3691,79,0,31,216660.0,130000.0,-52.0,-50.0,-44.0,-46.0,-51.0,-50.0,-44.0,-47.0,-90.0,-93.0,-90.0,-93.0,38.0,43.0,46.0,47.0,0
2526,CC:2F:71:3F:1F:24,4422629,1170892611,603031,689147169,3819598,481745442,37,500602,558984120,500023,558914322,579,69798,482932,10,603268,50457,34,432,144444.0,43333.0,-67.0,-65.0,-70.0,-67.0,-67.0,-65.0,-70.0,-67.0,-90.0,-93.0,-90.0,-93.0,23.0,28.0,20.0,26.0,0
2527,CC:2F:71:3E:C5:1F,3820305,481831865,707,86423,3819598,481745442,0,2997,251253,2481,189921,516,61332,748,8,1038,18,0,32,130000.0,39000.0,-70.0,-71.0,-67.0,-60.0,-69.0,-70.0,-67.0,-60.0,-90.0,-93.0,-90.0,-93.0,20.0,22.0,23.0,33.0,0
2528,BA:8C:B9:54:50:24,3821347,482585362,1747,839718,3819600,481745644,0,5676,829214,5656,826092,20,3122,1007,14,2122,29,0,49,229410.0,130000.0,-39.0,-37.0,-44.0,-51.0,-43.0,-35.0,-43.0,-47.0,-90.0,-93.0,-90.0,-93.0,51.0,56.0,46.0,42.0,0
2529,92:69:1D:31:68:E9,3823167,485242303,3565,3496537,3819602,481745766,0,3788,972862,3686,950127,102,22735,1877,6,3691,79,0,31,216660.0,130000.0,-52.0,-50.0,-44.0,-46.0,-51.0,-50.0,-44.0,-47.0,-90.0,-93.0,-90.0,-93.0,38.0,43.0,46.0,47.0,0
2530,CC:2F:71:3F:1F:24,4422676,1170907489,603073,689161597,3819603,481745892,37,500629,558989182,500049,558919266,580,69916,482959,10,603310,50470,34,432,130000.0,43333.0,-67.0,-65.0,-71.0,-67.0,-67.0,-65.0,-70.0,-67.0,-90.0,-93.0,-90.0,-93.0,23.0,28.0,19.0,26.0,0
2531,CC:2F:71:3E:C5:1F,3820310,481832315,707,86423,3819603,481745892,0,2997,251253,2481,189921,516,61332,748,8,1038,18,0,32,130000.0,39000.0,-70.0,-71.0,-67.0,-60.0,-69.0,-70.0,-67.0,-60.0,-90.0,-93.0,-90.0,-93.0,20.0,22.0,23.0,33.0,0
2532,BA:8C:B9:54:50:24,3821350,482585610,1747,839718,3819603,481745892,0,5676,829214,5656,826092,20,3122,1007,14,2122,29,0,49,229410.0,130000.0,-39.0,-37.0,-44.0,-51.0,-43.0,-35.0,-43.0,-47.0,-90.0,-93.0,-90.0,-93.0,51.0,56.0,46.0,42.0,0
2533,92:69:1D:31:68:E9,3823174,485243035,3565,3496537,3819609,481746498,0,3788,972862,3686,950127,102,22735,1877,6,3691,79,0,31,216660.0,130000.0,-52.0,-50.0,-44.0,-46.0,-51.0,-50.0,-44.0,-47.0,-90.0,-93.0,-90.0,-93.0,38.0,43.0,46.0,47.0,0
2534,CC:2F:71:3F:1F:24,4422724,1170922579,603115,689176081,3819609,481746498,37,500654,558993986,500074,558924070,580,69916,482984,10,603352,50489,34,432,130000.0,39000.0,-67.0,-65.0,-70.0,-67.0,-67.0,-65.0,-70.0,-67.0,-90.0,-93.0,-90.0,-93.0,23.0,28.0,20.0,26.0,0
2535,CC:2F:71:3E:C5:1F,3820316,481832921,707,86423,3819609,481746498,0,2997,251253,2481,189921,516,61332,748,8,1038,18,0,32,130000.0,39000.0,-70.0,-71.0,-67.0,-60.0,-69.0,-70.0,-67.0,-60.0,-90.0,-93.0,-90.0,-93.0,20.0,22.0,23.0,33.0,0
2536,BA:8C:B9:54:50:24,3821357,482586284,1747,839718,3819610,481746566,0,5676,829214,5656,826092,20,3122,1007,14,2122,29,0,49,229410.0,130000.0,-39.0,-37.0,-44.0,-51.0,-43.0,-35.0,-43.0,-47.0,-90.0,-93.0,-90.0,-93.0,51.0,56.0,46.0,42.0,0
2537,92:69:1D:31:68:E9,3823176,485243237,3565,3496537,3819611,481746700,0,3788,972862,3686,950127,102,22735,1877,6,3691,79,0,31,216660.0,130000.0,-52.0,-50.0,-44.0,-46.0,-51.0,-50.0,-44.0,-47.0,-90.0,-93.0,-90.0,-93.0,38.0,43.0,46.0,47.0,0
2538,CC:2F:71:3F:1F:24,4422766,1170936905,603155,689190205,3819611,481746700,37,500679,558998790,500099,558928874,580,69916,483009,10,603392,50497,34,432,130000.0,43333.0,-67.0,-65.0,-70.0,-67.0,-67.0,-65.0,-70.0,-67.0,-90.0,-93.0,-90.0,-93.0,23.0,28.0,20.0,26.0,0
2539,CC:2F:71:3E:C5:1F,3820318,481833123,707,86423,3819611,481746700,0,2997,251253,2481,189921,516,61332,748,8,1038,18,0,32,130000.0,39000.0,-70.0,-71.0,-67.0,-60.0,-69.0,-70.0,-67.0,-60.0,-90.0,-93.0,-90.0,-93.0,20.0,22.0,23.0,33.0,0
2540,BA:8C:B9:54:50:24,3821358,482586418,1747,839718,3819611,481746700,0,5676,829214,5656,826092,20,3122,1007,14,2122,29,0,49,229410.0,130000.0,-39.0,-37.0,-44.0,-51.0,-43.0,-35.0,-43.0,-47.0,-90.0,-93.0,-90.0,-93.0,51.0,56.0,46.0,42.0,0
2541,92:69:1D:31:68:E9,3823183,485243903,3565,3496537,3819618,481747366,0,3788,972862,3686,950127,102,22735,1877,6,3691,79,0,31,216660.0,130000.0,-52.0,-50.0,-44.0,-46.0,-51.0,-50.0,-44.0,-47.0,-90.0,-93.0,-90.0,-93.0,38.0,43.0,46.0,47.0,0
2542,CC:2F:71:3F:1F:24,4422816,1170952117,603197,689204689,3819619,481747428,37,500706,559003826,500126,558933910,580,69916,483036,10,603434,50519,34,432,130000.0,39000.0,-67.0,-65.0,-71.0,-67.0,-67.0,-65.0,-70.0,-67.0,-90.0,-93.0,-90.0,-93.0,23.0,28.0,19.0,26.0,0
2543,CC:2F:71:3E:C5:1F,3820326,481833851,707,86423,3819619,481747428,0,2999,251441,2482,189991,517,61450,749,8,1038,18,0,32,130000.0,39000.0,-70.0,-71.0,-67.0,-60.0,-69.0,-70.0,-67.0,-60.0,-90.0,-93.0,-90.0,-93.0,20.0,22.0,23.0,33.0,0
2544,BA:8C:B9:54:50:24,3821366,482587146,1747,839718,3819619,481747428,0,5676,829214,5656,826092,20,3122,1007,14,2122,29,0,49,229410.0,130000.0,-39.0,-37.0,-44.0,-51.0,-43.0,-35.0,-43.0,-47.0,-90.0,-93.0,-90.0,-93.0,51.0,56.0,46.0,42.0,0
2545,92:69:1D:31:68:E9,3823187,485244440,3565,3496537,3819622,481747903,0,3788,972862,3686,950127,102,22735,1877,6,3691,79,0,31,216660.0,130000.0,-52.0,-50.0,-44.0,-46.0,-51.0,-50.0,-44.0,-47.0,-90.0,-93.0,-90.0,-93.0,38.0,43.0,46.0,47.0,0
2546,CC:2F:71:3F:1F:24,4422862,1170967150,603240,689219247,3819622,481747903,37,500732,559008770,500152,558938854,580,69916,483062,10,603477,50544,34,432,130000.0,39000.0,-67.0,-65.0,-70.0,-67.0,-67.0,-65.0,-70.0,-67.0,-90.0,-93.0,-90.0,-93.0,23.0,28.0,20.0,26.0,0
2547,CC:2F:71:3E:C5:1F,3820329,481834326,707,86423,3819622,481747903,0,2999,251441,2482,189991,517,61450,749,8,1038,18,0,32,130000.0,39000.0,-70.0,-71.0,-67.0,-60.0,-69.0,-70.0,-67.0,-60.0,-90.0,-93.0,-90.0,-93.0,20.0,22.0,23.0,33.0,0
2548,BA:8C:B9:54:50:24,3821369,482587621,1747,839718,3819622,481747903,0,5676,829214,5656,826092,20,3122,1007,14,2122,29,0,49,229410.0,130000.0,-39.0,-37.0,-44.0,-51.0,-43.0,-35.0,-43.0,-47.0,-90.0,-93.0,-90.0,-93.0,51.0,56.0,46.0,42.0,0
2549,92:69:1D:31:68:E9,3823193,485245046,3565,3496537,3819628,481748509,0,3788,972862,3686,950127,102,22735,1877,6,3691,79,0,31,216660.0,130000.0,-52.0,-50.0,-44.0,-46.0,-51.0,-50.0,-44.0,-47.0,-90.0,-93.0,-90.0,-93.0,38.0,43.0,46.0,47.0,0
2550,CC:2F:71:3F:1F:24,4422911,1170982188,603282,689233619,3819629,481748569,37,500757,559013574,500177,558943658,580,69916,483087,10,603519,50566,34,432,117000.0,39000.0,-67.0,-65.0,-70.0,-68.0,-67.0,-65.0,-70.0,-67.0,-90.0,-93.0,-90.0,-93.0,23.0,28.0,20.0,25.0,0
2551,CC:2F:71:3E:C5:1F,3820336,481834992,707,86423,3819629,481748569,0,2999,251441,2482,189991,517,61450,749,8,1038,18,0,32,130000.0,39000.0,-70.0,-71.0,-67.0,-60.0,-69.0,-70.0,-67.0,-60.0,-90.0,-93.0,-90.0,-93.0,20.0,22.0,23.0,33.0,0
2552,BA:8C:B9:54:50:24,3821376,482588287,1747,839718,3819629,481748569,0,5676,829214,5656,826092,20,3122,1007,14,2122,29,0,49,229410.0,130000.0,-39.0,-37.0,-44.0,-51.0,-43.0,-35.0,-43.0,-47.0,-90.0,-93.0,-90.0,-93.0,51.0,56.0,46.0,42.0,0
2553,92:69:1D:31:68:E9,3823196,485245308,3565,3496537,3819631,481748771,0,3788,972862,3686,950127,102,22735,1877,6,3691,79,0,31,216660.0,130000.0,-52.0,-50.0,-44.0,-46.0,-51.0,-50.0,-44.0,-47.0,-90.0,-93.0,-90.0,-93.0,38.0,43.0,46.0,47.0,0
2554,CC:2F:71:3F:1F:24,4422955,1170996818,603324,689248047,3819631,481748771,37,500783,559018494,500203,558948578,580,69916,483113,10,603561,50570,34,432,130000.0,43333.0,-67.0,-65.0,-70.0,-68.0,-66.0,-65.0,-70.0,-67.0,-90.0,-93.0,-90.0,-93.0,23.0,28.0,20.0,25.0,0
2555,CC:2F:71:3E:C5:1F,3820338,481835194,707,86423,3819631,481748771,0,2999,251441,2482,189991,517,61450,749,8,1038,18,0,32,130000.0,39000.0,-70.0,-71.0,-67.0,-60.0,-69.0,-70.0,-67.0,-60.0,-90.0,-93.0,-90.0,-93.0,20.0,22.0,23.0,33.0,0
2556,BA:8C:B9:54:50:24,3821378,482588489,1747,839718,3819631,481748771,0,5676,829214,5656,826092,20,3122,1007,14,2122,29,0,49,229410.0,130000.0,-39.0,-37.0,-44.0,-51.0,-43.0,-35.0,-43.0,-47.0,-90.0,-93.0,-90.0,-93.0,51.0,56.0,46.0,42.0,0
2557,92:69:1D:31:68:E9,3823202,485245914,3565,3496537,3819637,481749377,0,3788,972862,3686,950127,102,22735,1877,6,3691,79,0,31,216660.0,130000.0,-52.0,-50.0,-44.0,-46.0,-51.0,-50.0,-44.0,-47.0,-90.0,-93.0,-90.0,-93.0,38.0,43.0,46.0,47.0,0
2558,CC:2F:71:3F:1F:24,4423003,1171011964,603366,689262587,3819637,481749377,37,500809,559023438,500229,558953522,580,69916,483139,10,603603,50573,34,432,130000.0,43333.0,-67.0,-65.0,-70.0,-67.0,-67.0,-65.0,-70.0,-67.0,-90.0,-93.0,-90.0,-93.0,23.0,28.0,20.0,26.0,0
2559,CC:2F:71:3E:C5:1F,3820344,481835800,707,86423,3819637,481749377,0,2999,251441,2482,189991,517,61450,749,8,1038,18,0,32,130000.0,39000.0,-70.0,-71.0,-67.0,-60.0,-69.0,-70.0,-67.0,-60.0,-90.0,-93.0,-90.0,-93.0,20.0,22.0,23.0,33.0,0
2560,BA:8C:B9:54:50:24,3821386,482591248,1749,841871,3819637,481749377,0,5685,830089,5665,826967,20,3122,1009,14,2124,29,0,49,229410.0,130000.0,-40.0,-37.0,-45.0,-52.0,-41.0,-35.0,-43.0,-47.0,-90.0,-93.0,-90.0,-93.0,50.0,56.0,45.0,41.0,0
2561,92:69:1D:31:68:E9,3823205,485246176,3565,3496537,3819640,481749639,0,3788,972862,3686,950127,102,22735,1877,6,3691,79,0,31,216660.0,130000.0,-52.0,-50.0,-44.0,-46.0,-51.0,-50.0,-44.0,-47.0,-90.0,-93.0,-90.0,-93.0,38.0,43.0,46.0,47.0,0
2562,CC:2F:71:3F:1F:24,4423048,1171026598,603408,689276959,3819640,481749639,37,500835,559028382,500255,558958466,580,69916,483165,10,603645,50588,34,432,130000.0,39000.0,-67.0,-65.0,-71.0,-67.0,-67.0,-65.0,-70.0,-67.0,-90.0,-93.0,-90.0,-93.0,23.0,28.0,19.0,26.0,0
2563,CC:2F:71:3E:C5:1F,3820347,481836062,707,86423,3819640,481749639,0,2999,251441,2482,189991,517,61450,749,8,1038,18,0,32,130000.0,39000.0,-70.0,-71.0,-67.0,-60.0,-69.0,-70.0,-67.0,-60.0,-90.0,-93.0,-90.0,-93.0,20.0,22.0,23.0,33.0,0
2564,BA:8C:B9:54:50:24,3821460,482642961,1818,893120,3819642,481749841,0,5782,858179,5762,855057,20,3122,1076,14,2193,29,0,50,229410.0,137640.0,-49.0,-35.0,-42.0,-44.0,-44.0,-36.0,-43.0,-46.0,-90.0,-93.0,-90.0,-93.0,41.0,58.0,48.0,49.0,0
2565,92:69:1D:31:68:E9,3823211,485246782,3565,3496537,3819646,481750245,0,3788,972862,3686,950127,102,22735,1877,6,3691,79,0,31,216660.0,130000.0,-52.0,-50.0,-44.0,-46.0,-51.0,-50.0,-44.0,-47.0,-90.0,-93.0,-90.0,-93.0,38.0,43.0,46.0,47.0,0
2566,CC:2F:71:3F:1F:24,4423096,1171041632,603450,689291387,3819646,481750245,37,500861,559033326,500281,558963410,580,69916,483191,10,603687,50601,34,432,130000.0,39000.0,-67.0,-65.0,-70.0,-67.0,-67.0,-65.0,-70.0,-67.0,-90.0,-93.0,-90.0,-93.0,23.0,28.0,20.0,26.0,0
2567,CC:2F:71:3E:C5:1F,3820353,481836668,707,86423,3819646,481750245,0,2999,251441,2482,189991,517,61450,749,8,1038,18,0,32,130000.0,39000.0,-70.0,-71.0,-67.0,-60.0,-69.0,-70.0,-67.0,-60.0,-90.0,-93.0,-90.0,-93.0,20.0,22.0,23.0,33.0,0
2568,BA:8C:B9:54:50:24,3821497,482660005,1851,909760,3819646,481750245,0,5838,876698,5818,873576,20,3122,1102,14,2226,29,0,50,229410.0,137640.0,-49.0,-35.0,-42.0,-44.0,-44.0,-37.0,-44.0,-46.0,-90.0,-93.0,-90.0,-93.0,41.0,58.0,48.0,49.0,0
2569,92:69:1D:31:68:E9,3823213,485246984,3565,3496537,3819648,481750447,0,3788,972862,3686,950127,102,22735,1877,6,3691,79,0,31,216660.0,130000.0,-52.0,-50.0,-44.0,-46.0,-51.0,-50.0,-44.0,-47.0,-90.0,-93.0,-90.0,-93.0,38.0,43.0,46.0,47.0,0
2570,CC:2F:71:3F:1F:24,4423140,1171056268,603492,689305821,3819648,481750447,37,500888,559038422,500308,558968506,580,69916,483218,10,603729,50623,34,432,130000.0,39000.0,-67.0,-65.0,-70.0,-67.0,-67.0,-65.0,-70.0,-67.0,-90.0,-93.0,-90.0,-93.0,23.0,28.0,20.0,26.0,0
2571,CC:2F:71:3E:C5:1F,3820356,481836930,707,86423,3819649,481750507,0,2999,251441,2482,189991,517,61450,749,8,1038,18,0,32,130000.0,39000.0,-70.0,-71.0,-67.0,-60.0,-69.0,-70.0,-67.0,-60.0,-90.0,-93.0,-90.0,-93.0,20.0,22.0,23.0,33.0,0
2572,BA:8C:B9:54:50:24,3821624,482823796,1973,1073087,3819651,481750709,0,5928,892123,5908,889001,20,3122,1160,14,2348,29,0,50,229410.0,137640.0,-45.0,-38.0,-46.0,-49.0,-45.0,-38.0,-46.0,-49.0,-90.0,-93.0,-90.0,-93.0,45.0,55.0,44.0,44.0,0
2573,92:69:1D:31:68:E9,3823218,485247448,3565,3496537,3819653,481750911,0,3788,972862,3686,950127,102,22735,1877,6,3691,79,0,31,216660.0,130000.0,-52.0,-50.0,-44.0,-46.0,-51.0,-50.0,-44.0,-47.0,-90.0,-93.0,-90.0,-93.0,38.0,43.0,46.0,47.0,0
2574,CC:2F:71:3F:1F:24,4423191,1171071632,603536,689320519,3819655,481751113,37,500913,559043226,500333,558973310,580,69916,483243,10,603773,50634,34,432,130000.0,39000.0,-67.0,-65.0,-70.0,-67.0,-67.0,-65.0,-70.0,-67.0,-90.0,-93.0,-90.0,-93.0,23.0,28.0,20.0,26.0,0
2575,CC:2F:71:3E:C5:1F,3820362,481837536,707,86423,3819655,481751113,0,2999,251441,2482,189991,517,61450,749,8,1038,18,0,32,130000.0,39000.0,-70.0,-71.0,-67.0,-60.0,-69.0,-70.0,-67.0,-60.0,-90.0,-93.0,-90.0,-93.0,20.0,22.0,23.0,33.0,0
2576,BA:8C:B9:54:50:24,3821663,482844218,2008,1093105,3819655,481751113,0,5981,916482,5961,913360,20,3122,1193,14,2383,29,0,50,229410.0,137640.0,-46.0,-38.0,-46.0,-49.0,-45.0,-38.0,-46.0,-49.0,-90.0,-93.0,-90.0,-93.0,44.0,55.0,44.0,44.0,0
2577,92:69:1D:31:68:E9,3823223,485248027,3565,3496537,3819658,481751490,0,3788,972862,3686,950127,102,22735,1877,6,3691,79,0,31,216660.0,130000.0,-52.0,-50.0,-44.0,-46.0,-51.0,-50.0,-44.0,-47.0,-90.0,-93.0,-90.0,-93.0,38.0,43.0,46.0,47.0,0
2578,CC:2F:71:3F:1F:24,4423238,1171086707,603580,689335217,3819658,481751490,37,500940,559048286,500360,558978370,580,69916,483270,10,603817,50663,34,432,130000.0,39000.0,-67.0,-65.0,-71.0,-68.0,-67.0,-65.0,-70.0,-67.0,-90.0,-93.0,-90.0,-93.0,23.0,28.0,19.0,25.0,0
2579,CC:2F:71:3E:C5:1F,3820365,481837913,707,86423,3819658,481751490,0,2999,251441,2482,189991,517,61450,749,8,1038,18,0,32,130000.0,39000.0,-70.0,-71.0,-67.0,-60.0,-69.0,-70.0,-67.0,-60.0,-90.0,-93.0,-90.0,-93.0,20.0,22.0,23.0,33.0,0
2580,BA:8C:B9:54:50:24,3821742,482896787,2082,1145095,3819660,481751692,0,6100,973605,6079,970248,21,3357,1271,14,2457,29,0,50,229410.0,137640.0,-45.0,-38.0,-46.0,-49.0,-45.0,-38.0,-46.0,-49.0,-90.0,-93.0,-90.0,-93.0,45.0,55.0,44.0,44.0,0
2581,92:69:1D:31:68:E9,3823228,485248491,3565,3496537,3819663,481751954,0,3789,972930,3687,950195,102,22735,1877,6,3691,79,0,31,216660.0,130000.0,-52.0,-50.0,-44.0,-46.0,-51.0,-50.0,-44.0,-47.0,-90.0,-93.0,-90.0,-93.0,38.0,43.0,46.0,47.0,0
2582,CC:2F:71:3F:1F:24,4423285,1171101677,603622,689349723,3819663,481751954,37,500966,559053230,500386,558983314,580,69916,483296,10,603859,50674,34,432,130000.0,43333.0,-67.0,-66.0,-71.0,-68.0,-67.0,-65.0,-71.0,-68.0,-90.0,-93.0,-90.0,-93.0,23.0,27.0,19.0,25.0,0
2583,CC:2F:71:3E:C5:1F,3820370,481838377,707,86423,3819663,481751954,0,2999,251441,2482,189991,517,61450,749,8,1038,18,0,32,130000.0,39000.0,-70.0,-71.0,-67.0,-60.0,-69.0,-70.0,-67.0,-60.0,-90.0,-93.0,-90.0,-93.0,20.0,22.0,23.0,33.0,0
2584,BA:8C:B9:54:50:24,3821796,482929829,2131,1177673,3819665,481752156,0,6172,998039,6151,994682,21,3357,1319,14,2506,29,0,50,229410.0,137640.0,-45.0,-38.0,-46.0,-49.0,-44.0,-37.0,-45.0,-48.0,-90.0,-93.0,-90.0,-93.0,45.0,55.0,44.0,44.0,0
2585,92:69:1D:31:68:E9,3823232,485248895,3565,3496537,3819667,481752358,0,3789,972930,3687,950195,102,22735,1877,6,3691,79,0,31,216660.0,130000.0,-52.0,-50.0,-44.0,-46.0,-51.0,-50.0,-44.0,-47.0,-90.0,-93.0,-90.0,-93.0,38.0,43.0,46.0,47.0,0
2586,CC:2F:71:3F:1F:24,4423332,1171116705,603665,689364347,3819667,481752358,37,500991,559058034,500411,558988118,580,69916,483321,10,603902,50699,34,432,130000.0,39000.0,-67.0,-66.0,-71.0,-68.0,-67.0,-65.0,-70.0,-68.0,-90.0,-93.0,-90.0,-93.0,23.0,27.0,19.0,25.0,0
2587,CC:2F:71:3E:C5:1F,3820374,481838781,707,86423,3819667,481752358,0,2999,251441,2482,189991,517,61450,749,8,1038,18,0,32,130000.0,39000.0,-70.0,-71.0,-67.0,-60.0,-69.0,-70.0,-67.0,-60.0,-90.0,-93.0,-90.0,-93.0,20.0,22.0,23.0,33.0,0
2588,BA:8C:B9:54:50:24,3823158,486356547,3489,4603987,3819669,481752560,0,6619,1168684,6598,1165327,21,3357,1617,14,3864,35,0,50,229410.0,137640.0,-45.0,-39.0,-46.0,-49.0,-43.0,-37.0,-44.0,-47.0,-90.0,-93.0,-90.0,-93.0,45.0,54.0,44.0,44.0,0
2589,92:69:1D:31:68:E9,3823236,485249299,3565,3496537,3819671,481752762,0,3789,972930,3687,950195,102,22735,1877,6,3691,79,0,31,216660.0,130000.0,-52.0,-50.0,-44.0,-46.0,-51.0,-50.0,-44.0,-47.0,-90.0,-93.0,-90.0,-93.0,38.0,43.0,46.0,47.0,0
2590,CC:2F:71:3F:1F:24,4423378,1171131497,603707,689378735,3819671,481752762,37,501017,559062978,500437,558993062,580,69916,483347,10,603944,50708,34,432,130000.0,43333.0,-68.0,-66.0,-71.0,-68.0,-67.0,-65.0,-71.0,-67.0,-90.0,-93.0,-90.0,-93.0,22.0,27.0,19.0,25.0,0
2591,CC:2F:71:3E:C5:1F,3820378,481839185,707,86423,3819671,481752762,0,2999,251441,2482,189991,517,61450,749,8,1038,18,0,32,130000.0,39000.0,-70.0,-71.0,-67.0,-60.0,-69.0,-70.0,-67.0,-60.0,-90.0,-93.0,-90.0,-93.0,20.0,22.0,23.0,33.0,0
2592,BA:8C:B9:54:50:24,3823185,486364893,3512,4611929,3819673,481752964,0,6665,1193727,6644,1190370,21,3357,1641,14,3887,35,0,50,229410.0,137640.0,-45.0,-39.0,-46.0,-48.0,-45.0,-39.0,-46.0,-48.0,-90.0,-93.0,-90.0,-93.0,45.0,54.0,44.0,45.0,0
2593,92:69:1D:31:68:E9,3823241,485249763,3565,3496537,3819676,481753226,0,3789,972930,3687,950195,102,22735,1877,6,3691,79,0,31,216660.0,130000.0,-52.0,-50.0,-44.0,-46.0,-51.0,-50.0,-44.0,-47.0,-90.0,-93.0,-90.0,-93.0,38.0,43.0,46.0,47.0,0
2594,CC:2F:71:3F:1F:24,4423425,1171146517,603749,689393291,3819676,481753226,37,501044,559068038,500464,558998122,580,69916,483374,10,603986,50710,34,432,130000.0,43333.0,-68.0,-65.0,-70.0,-68.0,-67.0,-65.0,-70.0,-68.0,-90.0,-93.0,-90.0,-93.0,22.0,28.0,20.0,25.0,0
2595,CC:2F:71:3E:C5:1F,3820383,481839649,707,86423,3819676,481753226,0,2999,251441,2482,189991,517,61450,749,8,1038,18,0,32,130000.0,39000.0,-70.0,-71.0,-67.0,-60.0,-69.0,-70.0,-67.0,-60.0,-90.0,-93.0,-90.0,-93.0,20.0,22.0,23.0,33.0,0
2596,BA:8C:B9:54:50:24,3823269,486438385,3591,4684957,3819678,481753428,0,6746,1222092,6725,1218735,21,3357,1686,14,3966,35,0,50,229410.0,137640.0,-45.0,-39.0,-46.0,-49.0,-44.0,-37.0,-44.0,-47.0,-90.0,-93.0,-90.0,-93.0,45.0,54.0,44.0,44.0,0
2597,92:69:1D:31:68:E9,3823247,485250556,3566,3496653,3819681,481753903,0,3791,973066,3689,950331,102,22735,1877,6,3692,79,0,31,216660.0,130000.0,-51.0,-47.0,-42.0,-48.0,-51.0,-49.0,-43.0,-47.0,-90.0,-93.0,-90.0,-93.0,39.0,46.0,48.0,45.0,0
2598,CC:2F:71:3F:1F:24,4423473,1171161810,603792,689407907,3819681,481753903,37,501069,559072842,500489,559002926,580,69916,483399,10,604029,50725,34,432,130000.0,39000.0,-68.0,-65.0,-71.0,-68.0,-67.0,-65.0,-71.0,-67.0,-90.0,-93.0,-90.0,-93.0,22.0,28.0,19.0,25.0,0
2599,CC:2F:71:3E:C5:1F,3820389,481840442,708,86539,3819681,481753903,0,3001,251581,2484,190131,517,61450,749,8,1039,18,0,32,130000.0,39000.0,-71.0,-71.0,-68.0,-60.0,-70.0,-71.0,-67.0,-60.0,-90.0,-93.0,-90.0,-93.0,19.0,22.0,22.0,33.0,0
2600,BA:8C:B9:54:50:24,3823344,486527582,3663,4773679,3819681,481753903,0,6792,1231974,6771,1228617,21,3357,1713,14,4038,35,0,50,229410.0,137640.0,-49.0,-35.0,-42.0,-44.0,-44.0,-37.0,-44.0,-47.0,-90.0,-93.0,-90.0,-93.0,41.0,58.0,48.0,49.0,0
2601,92:69:1D:31:68:E9,3823251,485250960,3566,3496653,3819685,481754307,0,3791,973066,3689,950331,102,22735,1877,6,3692,79,0,31,216660.0,130000.0,-51.0,-47.0,-42.0,-48.0,-51.0,-49.0,-43.0,-47.0,-90.0,-93.0,-90.0,-93.0,39.0,46.0,48.0,45.0,0
2602,CC:2F:71:3F:1F:24,4423519,1171176522,603833,689422155,3819686,481754367,37,501095,559077786,500515,559007870,580,69916,483425,10,604070,50735,34,432,130000.0,43333.0,-68.0,-65.0,-71.0,-68.0,-67.0,-65.0,-71.0,-68.0,-90.0,-93.0,-90.0,-93.0,22.0,28.0,19.0,25.0,0
2603,CC:2F:71:3E:C5:1F,3820394,481840906,708,86539,3819686,481754367,0,3001,251581,2484,190131,517,61450,749,8,1039,18,0,32,130000.0,39000.0,-71.0,-71.0,-68.0,-60.0,-70.0,-71.0,-67.0,-60.0,-90.0,-93.0,-90.0,-93.0,19.0,22.0,22.0,33.0,0
2604,BA:8C:B9:54:50:24,3823353,486532126,3667,4777759,3819686,481754367,0,6804,1236904,6783,1233547,21,3357,1718,14,4042,35,0,50,229410.0,137640.0,-45.0,-38.0,-45.0,-48.0,-44.0,-38.0,-45.0,-48.0,-90.0,-93.0,-90.0,-93.0,45.0,55.0,45.0,45.0,0
2605,92:69:1D:31:68:E9,3823256,485251424,3566,3496653,3819690,481754771,0,3791,973066,3689,950331,102,22735,1877,6,3692,79,0,31,216660.0,130000.0,-51.0,-47.0,-42.0,-48.0,-51.0,-49.0,-43.0,-47.0,-90.0,-93.0,-90.0,-93.0,39.0,46.0,48.0,45.0,0
2606,CC:2F:71:3F:1F:24,4423566,1171191550,603876,689436779,3819690,481754771,37,501121,559082730,500541,559012814,580,69916,483451,10,604113,50743,34,432,130000.0,39000.0,-68.0,-66.0,-71.0,-68.0,-67.0,-65.0,-70.0,-68.0,-90.0,-93.0,-90.0,-93.0,22.0,27.0,19.0,25.0,0
2607,CC:2F:71:3E:C5:1F,3820399,481841372,708,86539,3819691,481754833,0,3001,251581,2484,190131,517,61450,749,8,1039,18,0,32,130000.0,39000.0,-71.0,-71.0,-68.0,-60.0,-70.0,-71.0,-67.0,-60.0,-90.0,-93.0,-90.0,-93.0,19.0,22.0,22.0,33.0,0
2608,BA:8C:B9:54:50:24,3823445,486616011,3754,4861178,3819691,481754833,0,6890,1324450,6869,1321093,21,3357,1762,14,4129,35,0,50,229410.0,137640.0,-40.0,-37.0,-45.0,-52.0,-44.0,-38.0,-45.0,-49.0,-90.0,-93.0,-90.0,-93.0,50.0,56.0,45.0,41.0,0
2609,92:69:1D:31:68:E9,3823261,485251890,3566,3496653,3819695,481755237,0,3791,973066,3689,950331,102,22735,1877,6,3692,79,0,31,216660.0,130000.0,-51.0,-47.0,-42.0,-48.0,-51.0,-49.0,-43.0,-47.0,-90.0,-93.0,-90.0,-93.0,39.0,46.0,48.0,45.0,0
2610,CC:2F:71:3F:1F:24,4423612,1171206320,603917,689451083,3819695,481755237,37,501149,559087908,500568,559017874,581,70034,483479,10,604154,50757,34,432,130000.0,39000.0,-67.0,-65.0,-71.0,-68.0,-67.0,-65.0,-71.0,-68.0,-90.0,-93.0,-90.0,-93.0,23.0,28.0,19.0,25.0,0
2611,CC:2F:71:3E:C5:1F,3820403,481841776,708,86539,3819695,481755237,0,3001,251581,2484,190131,517,61450,749,8,1039,18,0,32,130000.0,39000.0,-71.0,-71.0,-68.0,-60.0,-70.0,-71.0,-67.0,-60.0,-90.0,-93.0,-90.0,-93.0,19.0,22.0,22.0,33.0,0
2612,BA:8C:B9:54:50:24,3823464,486623785,3767,4868180,3819697,481755605,0,6909,1328804,6888,1325447,21,3357,1772,14,4142,35,0,50,229410.0,137640.0,-45.0,-39.0,-46.0,-48.0,-43.0,-38.0,-45.0,-49.0,-90.0,-93.0,-90.0,-93.0,45.0,54.0,44.0,45.0,0
2613,92:69:1D:31:68:E9,3823268,485252722,3566,3496653,3819702,481756069,0,3791,973066,3689,950331,102,22735,1877,6,3692,79,0,31,216660.0,130000.0,-51.0,-47.0,-42.0,-48.0,-51.0,-49.0,-43.0,-47.0,-90.0,-93.0,-90.0,-93.0,39.0,46.0,48.0,45.0,0
2614,CC:2F:71:3F:1F:24,4423661,1171221484,603959,689465415,3819702,481756069,37,501174,559092712,500593,559022678,581,70034,483504,10,604196,50771,34,432,130000.0,39000.0,-67.0,-65.0,-70.0,-68.0,-67.0,-65.0,-70.0,-68.0,-90.0,-93.0,-90.0,-93.0,23.0,28.0,20.0,25.0,0
2615,CC:2F:71:3E:C5:1F,3820410,481842608,708,86539,3819702,481756069,0,3001,251581,2484,190131,517,61450,749,8,1039,18,0,32,130000.0,39000.0,-71.0,-71.0,-68.0,-60.0,-70.0,-71.0,-67.0,-60.0,-90.0,-93.0,-90.0,-93.0,19.0,22.0,22.0,33.0,0
2616,BA:8C:B9:54:50:24,3823502,486630885,3800,4874816,3819702,481756069,0,6953,1371618,6932,1368261,21,3357,1791,14,4175,35,0,50,229410.0,137640.0,-40.0,-37.0,-44.0,-52.0,-41.0,-36.0,-43.0,-47.0,-90.0,-93.0,-90.0,-93.0,50.0,56.0,46.0,41.0,0
2617,92:69:1D:31:68:E9,3823273,485253244,3567,3496771,3819706,481756473,0,3794,973350,3692,950615,102,22735,1878,6,3693,79,0,31,216660.0,130000.0,-52.0,-50.0,-44.0,-46.0,-51.0,-49.0,-43.0,-47.0,-90.0,-93.0,-90.0,-93.0,38.0,43.0,46.0,47.0,0
2618,CC:2F:71:3F:1F:24,4423708,1171236384,604002,689479911,3819706,481756473,37,501201,559097796,500620,559027762,581,70034,483531,10,604239,50792,34,432,117000.0,39000.0,-67.0,-66.0,-71.0,-68.0,-67.0,-65.0,-70.0,-67.0,-90.0,-93.0,-90.0,-93.0,23.0,27.0,19.0,25.0,0
2619,CC:2F:71:3E:C5:1F,3820414,481843012,708,86539,3819706,481756473,0,3001,251581,2484,190131,517,61450,749,8,1039,18,0,32,130000.0,39000.0,-71.0,-71.0,-68.0,-60.0,-70.0,-71.0,-67.0,-60.0,-90.0,-93.0,-90.0,-93.0,19.0,22.0,22.0,33.0,0
2620,BA:8C:B9:54:50:24,3823506,486631289,3800,4874816,3819706,481756473,0,6953,1371618,6932,1368261,21,3357,1791,14,4175,35,0,50,229410.0,137640.0,-40.0,-37.0,-44.0,-52.0,-41.0,-36.0,-43.0,-47.0,-90.0,-93.0,-90.0,-93.0,50.0,56.0,46.0,41.0,0
2621,92:69:1D:31:68:E9,3823298,485259259,3588,3502382,3819710,481756877,0,3821,978695,3719,955960,102,22735,1900,6,3714,79,0,31,229410.0,137640.0,-52.0,-50.0,-43.0,-45.0,-52.0,-50.0,-45.0,-50.0,-91.0,-93.0,-90.0,-93.0,39.0,43.0,47.0,48.0,0
2622,CC:2F:71:3F:1F:24,4423753,1171251092,604043,689494215,3819710,481756877,37,501226,559102600,500645,559032566,581,70034,483556,10,604280,50805,34,432,130000.0,43333.0,-68.0,-66.0,-71.0,-68.0,-67.0,-65.0,-70.0,-68.0,-91.0,-93.0,-90.0,-93.0,23.0,27.0,19.0,25.0,0
2623,CC:2F:71:3E:C5:1F,3820418,481843416,708,86539,3819710,481756877,0,3001,251581,2484,190131,517,61450,749,8,1039,18,0,32,130000.0,39000.0,-71.0,-71.0,-68.0,-60.0,-70.0,-71.0,-67.0,-60.0,-91.0,-93.0,-90.0,-93.0,20.0,22.0,22.0,33.0,0
2624,BA:8C:B9:54:50:24,3823510,486631693,3800,4874816,3819710,481756877,0,6953,1371618,6932,1368261,21,3357,1791,14,4175,35,0,50,229410.0,137640.0,-40.0,-37.0,-44.0,-52.0,-41.0,-36.0,-43.0,-47.0,-91.0,-93.0,-90.0,-93.0,51.0,56.0,46.0,41.0,0
2625,92:69:1D:31:68:E9,3823303,485259723,3588,3502382,3819715,481757341,0,3821,978695,3719,955960,102,22735,1900,6,3714,79,0,31,229410.0,137640.0,-52.0,-50.0,-43.0,-45.0,-52.0,-50.0,-45.0,-50.0,-91.0,-93.0,-90.0,-93.0,39.0,43.0,47.0,48.0,0
2626,CC:2F:71:3F:1F:24,4423800,1171265928,604085,689508587,3819715,481757341,37,501252,559107520,500671,559037486,581,70034,483582,10,604322,50831,34,432,144444.0,43333.0,-68.0,-65.0,-71.0,-68.0,-67.0,-65.0,-70.0,-68.0,-91.0,-93.0,-90.0,-93.0,23.0,28.0,19.0,25.0,0
2627,CC:2F:71:3E:C5:1F,3820423,481843880,708,86539,3819715,481757341,0,3001,251581,2484,190131,517,61450,749,8,1039,18,0,32,130000.0,39000.0,-71.0,-71.0,-68.0,-60.0,-70.0,-71.0,-67.0,-60.0,-91.0,-93.0,-90.0,-93.0,20.0,22.0,22.0,33.0,0
2628,BA:8C:B9:54:50:24,3823515,486632157,3800,4874816,3819715,481757341,0,6953,1371618,6932,1368261,21,3357,1791,14,4175,35,0,50,229410.0,137640.0,-40.0,-37.0,-44.0,-52.0,-41.0,-36.0,-43.0,-47.0,-91.0,-93.0,-90.0,-93.0,51.0,56.0,46.0,41.0,0
2629,92:69:1D:31:68:E9,3823307,485260127,3588,3502382,3819719,481757745,0,3821,978695,3719,955960,102,22735,1900,6,3714,79,0,31,229410.0,137640.0,-52.0,-50.0,-43.0,-45.0,-52.0,-50.0,-45.0,-50.0,-91.0,-93.0,-90.0,-93.0,39.0,43.0,47.0,48.0,0
2630,CC:2F:71:3F:1F:24,4423845,1171280692,604126,689522947,3819719,481757745,37,501278,559112440,500697,559042406,581,70034,483608,10,604363,50862,34,432,130000.0,43333.0,-67.0,-66.0,-71.0,-68.0,-67.0,-65.0,-70.0,-68.0,-91.0,-93.0,-90.0,-93.0,24.0,27.0,19.0,25.0,0
2631,CC:2F:71:3E:C5:1F,3820427,481844284,708,86539,3819719,481757745,0,3001,251581,2484,190131,517,61450,749,8,1039,18,0,32,130000.0,39000.0,-71.0,-71.0,-68.0,-60.0,-70.0,-71.0,-67.0,-60.0,-91.0,-93.0,-90.0,-93.0,20.0,22.0,22.0,33.0,0
2632,BA:8C:B9:54:50:24,3823519,486632561,3800,4874816,3819719,481757745,0,6953,1371618,6932,1368261,21,3357,1791,14,4175,35,0,50,229410.0,137640.0,-40.0,-37.0,-44.0,-52.0,-41.0,-36.0,-43.0,-47.0,-91.0,-93.0,-90.0,-93.0,51.0,56.0,46.0,41.0,0
2633,92:69:1D:31:68:E9,3823311,485260531,3588,3502382,3819723,481758149,0,3821,978695,3719,955960,102,22735,1900,6,3714,79,0,31,229410.0,137640.0,-52.0,-50.0,-43.0,-45.0,-52.0,-50.0,-45.0,-50.0,-91.0,-93.0,-90.0,-93.0,39.0,43.0,47.0,48.0,0
2634,CC:2F:71:3F:1F:24,4423892,1171295696,604168,689537487,3819724,481758209,37,501305,559117524,500724,559047490,581,70034,483635,10,604405,50869,34,432,130000.0,43333.0,-68.0,-66.0,-71.0,-68.0,-67.0,-65.0,-70.0,-68.0,-91.0,-93.0,-90.0,-93.0,23.0,27.0,19.0,25.0,0
2635,CC:2F:71:3E:C5:1F,3820432,481844748,708,86539,3819724,481758209,0,3001,251581,2484,190131,517,61450,749,8,1039,18,0,32,130000.0,39000.0,-71.0,-71.0,-68.0,-60.0,-70.0,-71.0,-67.0,-60.0,-91.0,-93.0,-90.0,-93.0,20.0,22.0,22.0,33.0,0
2636,BA:8C:B9:54:50:24,3823524,486633025,3800,4874816,3819724,481758209,0,6953,1371618,6932,1368261,21,3357,1791,14,4175,35,0,50,229410.0,137640.0,-40.0,-37.0,-44.0,-52.0,-41.0,-36.0,-43.0,-47.0,-91.0,-93.0,-90.0,-93.0,51.0,56.0,46.0,41.0,0
2637,92:69:1D:31:68:E9,3823316,485260995,3588,3502382,3819728,481758613,0,3821,978695,3719,955960,102,22735,1900,6,3714,79,0,31,229410.0,137640.0,-52.0,-50.0,-43.0,-45.0,-52.0,-50.0,-45.0,-50.0,-91.0,-93.0,-90.0,-93.0,39.0,43.0,47.0,48.0,0
2638,CC:2F:71:3F:1F:24,4423938,1171310584,604210,689551971,3819728,481758613,37,501332,559122584,500751,559052550,581,70034,483662,10,604447,50885,34,432,130000.0,39000.0,-68.0,-65.0,-71.0,-68.0,-67.0,-65.0,-71.0,-68.0,-91.0,-93.0,-90.0,-93.0,23.0,28.0,19.0,25.0,0
2639,CC:2F:71:3E:C5:1F,3820436,481845152,708,86539,3819728,481758613,0,3001,251581,2484,190131,517,61450,749,8,1039,18,0,32,130000.0,39000.0,-71.0,-71.0,-68.0,-60.0,-70.0,-71.0,-67.0,-60.0,-91.0,-93.0,-90.0,-93.0,20.0,22.0,22.0,33.0,0
2640,BA:8C:B9:54:50:24,3823529,486633491,3800,4874816,3819729,481758675,0,6953,1371618,6932,1368261,21,3357,1791,14,4175,35,0,50,229410.0,137640.0,-40.0,-37.0,-44.0,-52.0,-41.0,-36.0,-43.0,-47.0,-91.0,-93.0,-90.0,-93.0,51.0,56.0,46.0,41.0,0
2641,92:69:1D:31:68:E9,3823321,485261461,3588,3502382,3819733,481759079,0,3821,978695,3719,955960,102,22735,1900,6,3714,79,0,31,229410.0,137640.0,-52.0,-50.0,-43.0,-45.0,-52.0,-50.0,-45.0,-50.0,-91.0,-93.0,-90.0,-93.0,39.0,43.0,47.0,48.0,0
2642,CC:2F:71:3F:1F:24,4423984,1171325354,604251,689566275,3819733,481759079,37,501358,559127528,500777,559057494,581,70034,483688,10,604488,50898,34,432,130000.0,39000.0,-67.0,-65.0,-70.0,-68.0,-67.0,-65.0,-70.0,-68.0,-91.0,-93.0,-90.0,-93.0,24.0,28.0,20.0,25.0,0
2643,CC:2F:71:3E:C5:1F,3820441,481845618,708,86539,3819733,481759079,0,3003,251769,2485,190201,518,61568,750,8,1039,18,0,32,130000.0,39000.0,-70.0,-71.0,-67.0,-60.0,-70.0,-71.0,-67.0,-60.0,-91.0,-93.0,-90.0,-93.0,21.0,22.0,23.0,33.0,0
2644,BA:8C:B9:54:50:24,3823533,486633895,3800,4874816,3819733,481759079,0,6953,1371618,6932,1368261,21,3357,1791,14,4175,35,0,50,229410.0,137640.0,-40.0,-37.0,-44.0,-52.0,-41.0,-36.0,-43.0,-47.0,-91.0,-93.0,-90.0,-93.0,51.0,56.0,46.0,41.0,0
2645,92:69:1D:31:68:E9,3823326,485261925,3588,3502382,3819738,481759543,0,3821,978695,3719,955960,102,22735,1900,6,3714,79,0,31,229410.0,137640.0,-52.0,-50.0,-43.0,-45.0,-52.0,-50.0,-45.0,-50.0,-91.0,-93.0,-90.0,-93.0,39.0,43.0,47.0,48.0,0
2646,CC:2F:71:3F:1F:24,4424032,1171340590,604294,689581047,3819738,481759543,37,501385,559132576,500804,559062542,581,70034,483715,10,604531,50902,34,432,130000.0,43333.0,-67.0,-65.0,-71.0,-68.0,-67.0,-65.0,-70.0,-68.0,-91.0,-93.0,-90.0,-93.0,24.0,28.0,19.0,25.0,0
2647,CC:2F:71:3E:C5:1F,3820446,481846082,708,86539,3819738,481759543,0,3003,251769,2485,190201,518,61568,750,8,1039,18,0,32,130000.0,39000.0,-70.0,-71.0,-67.0,-60.0,-70.0,-71.0,-67.0,-60.0,-91.0,-93.0,-90.0,-93.0,21.0,22.0,23.0,33.0,0
2648,BA:8C:B9:54:50:24,3823543,486636156,3805,4876613,3819738,481759543,0,6962,1373685,6941,1370328,21,3357,1798,14,4180,35,0,50,216660.0,130000.0,-45.0,-39.0,-46.0,-49.0,-44.0,-37.0,-44.0,-49.0,-91.0,-93.0,-90.0,-93.0,46.0,54.0,44.0,44.0,0
2649,92:69:1D:31:68:E9,3823331,485262602,3588,3502382,3819743,481760220,0,3821,978695,3719,955960,102,22735,1900,6,3714,79,0,31,229410.0,137640.0,-52.0,-50.0,-43.0,-45.0,-52.0,-50.0,-45.0,-50.0,-91.0,-93.0,-90.0,-93.0,39.0,43.0,47.0,48.0,0
2650,CC:2F:71:3F:1F:24,4424079,1171355711,604336,689595491,3819743,481760220,37,501411,559137484,500830,559067450,581,70034,483741,10,604573,50920,34,432,117000.0,39000.0,-67.0,-65.0,-71.0,-68.0,-67.0,-65.0,-70.0,-67.0,-91.0,-93.0,-90.0,-93.0,24.0,28.0,19.0,25.0,0
2651,CC:2F:71:3E:C5:1F,3820451,481846759,708,86539,3819743,481760220,0,3003,251769,2485,190201,518,61568,750,8,1039,18,0,32,130000.0,39000.0,-70.0,-71.0,-67.0,-60.0,-70.0,-71.0,-67.0,-60.0,-91.0,-93.0,-90.0,-93.0,21.0,22.0,23.0,33.0,0
2652,BA:8C:B9:54:50:24,3823759,487109461,4016,5349241,3819743,481760220,0,7120,1406708,7099,1403351,21,3357,1909,14,4391,35,0,50,229410.0,137640.0,-45.0,-38.0,-45.0,-49.0,-45.0,-38.0,-45.0,-49.0,-91.0,-93.0,-90.0,-93.0,46.0,55.0,45.0,44.0,0
2653,92:69:1D:31:68:E9,3823335,485263006,3588,3502382,3819747,481760624,0,3821,978695,3719,955960,102,22735,1900,6,3714,79,0,31,229410.0,137640.0,-52.0,-50.0,-43.0,-45.0,-52.0,-50.0,-45.0,-50.0,-90.0,-93.0,-89.0,-93.0,38.0,43.0,46.0,48.0,0
2654,CC:2F:71:3F:1F:24,4424124,1171370435,604377,689609811,3819747,481760624,37,501438,559142568,500857,559072534,581,70034,483768,10,604614,50929,34,432,130000.0,43333.0,-67.0,-65.0,-70.0,-68.0,-67.0,-65.0,-70.0,-67.0,-90.0,-93.0,-89.0,-93.0,23.0,28.0,19.0,25.0,0
2655,CC:2F:71:3E:C5:1F,3820456,481847223,708,86539,3819748,481760684,0,3003,251769,2485,190201,518,61568,750,8,1039,18,0,32,130000.0,39000.0,-70.0,-71.0,-67.0,-60.0,-70.0,-71.0,-67.0,-60.0,-90.0,-93.0,-89.0,-93.0,20.0,22.0,22.0,33.0,0
2656,BA:8C:B9:54:50:24,3823806,487197808,4058,5437124,3819748,481760684,0,7186,1419093,7165,1415736,21,3357,1951,14,4433,35,0,50,229410.0,137640.0,-41.0,-37.0,-45.0,-52.0,-44.0,-37.0,-44.0,-48.0,-90.0,-93.0,-89.0,-93.0,49.0,56.0,44.0,41.0,0
2657,92:69:1D:31:68:E9,3823340,485263470,3588,3502382,3819752,481761088,0,3821,978695,3719,955960,102,22735,1900,6,3714,79,0,31,229410.0,137640.0,-52.0,-50.0,-43.0,-45.0,-52.0,-50.0,-45.0,-50.0,-90.0,-93.0,-89.0,-93.0,38.0,43.0,46.0,48.0,0
2658,CC:2F:71:3F:1F:24,4424171,1171385327,604419,689624239,3819752,481761088,37,501463,559147372,500882,559077338,581,70034,483793,10,604656,50962,34,432,144444.0,39000.0,-68.0,-65.0,-71.0,-68.0,-67.0,-65.0,-70.0,-67.0,-90.0,-93.0,-89.0,-93.0,22.0,28.0,18.0,25.0,0
2659,CC:2F:71:3E:C5:1F,3820460,481847627,708,86539,3819752,481761088,0,3003,251769,2485,190201,518,61568,750,8,1039,18,0,32,130000.0,39000.0,-70.0,-71.0,-67.0,-60.0,-70.0,-71.0,-67.0,-60.0,-90.0,-93.0,-89.0,-93.0,20.0,22.0,22.0,33.0,0
2660,BA:8C:B9:54:50:24,3823818,487199522,4066,5438434,3819752,481761088,0,7215,1422317,7194,1418960,21,3357,1964,14,4441,35,0,50,229410.0,137640.0,-49.0,-35.0,-42.0,-44.0,-45.0,-37.0,-44.0,-47.0,-90.0,-93.0,-89.0,-93.0,41.0,58.0,47.0,49.0,0
2661,92:69:1D:31:68:E9,3823344,485263874,3588,3502382,3819756,481761492,0,3821,978695,3719,955960,102,22735,1900,6,3714,79,0,31,229410.0,137640.0,-52.0,-50.0,-43.0,-45.0,-52.0,-50.0,-45.0,-50.0,-90.0,-93.0,-89.0,-93.0,38.0,43.0,46.0,48.0,0
2662,CC:2F:71:3F:1F:24,4424219,1171400413,604463,689638921,3819756,481761492,37,501489,559152316,500908,559082282,581,70034,483819,10,604700,50975,34,432,130000.0,43333.0,-68.0,-65.0,-71.0,-68.0,-67.0,-65.0,-70.0,-68.0,-90.0,-93.0,-89.0,-93.0,22.0,28.0,18.0,25.0,0
2663,CC:2F:71:3E:C5:1F,3820464,481848031,708,86539,3819756,481761492,0,3003,251769,2485,190201,518,61568,750,8,1039,18,0,32,130000.0,39000.0,-70.0,-71.0,-67.0,-60.0,-70.0,-71.0,-67.0,-60.0,-90.0,-93.0,-89.0,-93.0,20.0,22.0,22.0,33.0,0
2664,BA:8C:B9:54:50:24,3823822,487199926,4066,5438434,3819756,481761492,0,7215,1422317,7194,1418960,21,3357,1964,14,4441,35,0,50,229410.0,137640.0,-49.0,-35.0,-42.0,-44.0,-45.0,-37.0,-44.0,-47.0,-90.0,-93.0,-89.0,-93.0,41.0,58.0,47.0,49.0,0
2665,92:69:1D:31:68:E9,3823349,485264338,3588,3502382,3819761,481761956,0,3821,978695,3719,955960,102,22735,1900,6,3714,79,0,31,229410.0,137640.0,-52.0,-50.0,-43.0,-45.0,-52.0,-50.0,-45.0,-50.0,-90.0,-93.0,-89.0,-93.0,38.0,43.0,46.0,48.0,0
2666,CC:2F:71:3F:1F:24,4424265,1171415293,604504,689653337,3819761,481761956,37,501515,559157260,500934,559087226,581,70034,483845,10,604741,50979,34,432,130000.0,43333.0,-67.0,-66.0,-71.0,-68.0,-67.0,-65.0,-71.0,-67.0,-90.0,-93.0,-89.0,-93.0,23.0,27.0,18.0,25.0,0
2667,CC:2F:71:3E:C5:1F,3820469,481848495,708,86539,3819761,481761956,0,3003,251769,2485,190201,518,61568,750,8,1039,18,0,32,130000.0,39000.0,-70.0,-71.0,-67.0,-60.0,-70.0,-71.0,-67.0,-60.0,-90.0,-93.0,-89.0,-93.0,20.0,22.0,22.0,33.0,0
2668,BA:8C:B9:54:50:24,3823827,487200390,4066,5438434,3819761,481761956,0,7215,1422317,7194,1418960,21,3357,1964,14,4441,35,0,50,229410.0,137640.0,-49.0,-35.0,-42.0,-44.0,-45.0,-37.0,-44.0,-47.0,-90.0,-93.0,-89.0,-93.0,41.0,58.0,47.0,49.0,0
2669,92:69:1D:31:68:E9,3823353,485264742,3588,3502382,3819765,481762360,0,3821,978695,3719,955960,102,22735,1900,6,3714,79,0,31,229410.0,137640.0,-52.0,-50.0,-43.0,-45.0,-52.0,-50.0,-45.0,-50.0,-90.0,-92.0,-89.0,-93.0,38.0,42.0,46.0,48.0,0
2670,CC:2F:71:3F:1F:24,4424312,1171430249,604547,689667889,3819765,481762360,37,501544,559162552,500963,559092518,581,70034,483874,10,604784,50987,34,432,117000.0,39000.0,-67.0,-65.0,-70.0,-68.0,-67.0,-65.0,-70.0,-68.0,-90.0,-92.0,-89.0,-93.0,23.0,27.0,19.0,25.0,0
2671,CC:2F:71:3E:C5:1F,3820473,481848899,708,86539,3819765,481762360,0,3003,251769,2485,190201,518,61568,750,8,1039,18,0,32,130000.0,39000.0,-70.0,-71.0,-67.0,-60.0,-70.0,-71.0,-67.0,-60.0,-90.0,-92.0,-89.0,-93.0,20.0,21.0,22.0,33.0,0
2672,BA:8C:B9:54:50:24,3823831,487200794,4066,5438434,3819765,481762360,0,7215,1422317,7194,1418960,21,3357,1964,14,4441,35,0,50,229410.0,137640.0,-49.0,-35.0,-42.0,-44.0,-45.0,-37.0,-44.0,-47.0,-90.0,-92.0,-89.0,-93.0,41.0,57.0,47.0,49.0,0
2673,92:69:1D:31:68:E9,3823357,485265146,3588,3502382,3819769,481762764,0,3821,978695,3719,955960,102,22735,1900,6,3714,79,0,31,229410.0,137640.0,-52.0,-50.0,-43.0,-45.0,-52.0,-50.0,-45.0,-50.0,-90.0,-92.0,-89.0,-93.0,38.0,42.0,46.0,48.0,0
2674,CC:2F:71:3F:1F:24,4424359,1171445099,604590,689682335,3819769,481762764,37,501571,559167612,500990,559097578,581,70034,483901,10,604827,50996,34,432,117000.0,39000.0,-67.0,-65.0,-71.0,-68.0,-67.0,-65.0,-70.0,-68.0,-90.0,-92.0,-89.0,-93.0,23.0,27.0,18.0,25.0,0
2675,CC:2F:71:3E:C5:1F,3820477,481849303,708,86539,3819769,481762764,0,3003,251769,2485,190201,518,61568,750,8,1039,18,0,32,130000.0,39000.0,-70.0,-71.0,-67.0,-60.0,-70.0,-71.0,-67.0,-60.0,-90.0,-92.0,-89.0,-93.0,20.0,21.0,22.0,33.0,0
2676,BA:8C:B9:54:50:24,3823836,487201314,4067,5438550,3819769,481762764,0,7222,1422835,7201,1419478,21,3357,1965,14,4442,35,0,50,229410.0,137640.0,-49.0,-35.0,-42.0,-45.0,-45.0,-37.0,-44.0,-48.0,-90.0,-92.0,-89.0,-93.0,41.0,57.0,47.0,48.0,0
2677,92:69:1D:31:68:E9,3823362,485265610,3588,3502382,3819774,481763228,0,3821,978695,3719,955960,102,22735,1900,6,3714,79,0,31,229410.0,137640.0,-52.0,-50.0,-43.0,-45.0,-52.0,-50.0,-45.0,-50.0,-90.0,-92.0,-89.0,-93.0,38.0,42.0,46.0,48.0,0
2678,CC:2F:71:3F:1F:24,4424406,1171459991,604632,689696763,3819774,481763228,37,501597,559172556,501016,559102522,581,70034,483927,10,604869,50999,34,432,130000.0,43333.0,-67.0,-65.0,-71.0,-68.0,-67.0,-65.0,-70.0,-67.0,-90.0,-92.0,-89.0,-93.0,23.0,27.0,18.0,25.0,0
2679,CC:2F:71:3E:C5:1F,3820482,481849767,708,86539,3819774,481763228,0,3003,251769,2485,190201,518,61568,750,8,1039,18,0,32,130000.0,39000.0,-70.0,-71.0,-67.0,-60.0,-70.0,-71.0,-67.0,-60.0,-90.0,-92.0,-89.0,-93.0,20.0,21.0,22.0,33.0,0
2680,BA:8C:B9:54:50:24,3823841,487201778,4067,5438550,3819774,481763228,0,7222,1422835,7201,1419478,21,3357,1965,14,4442,35,0,50,229410.0,137640.0,-49.0,-35.0,-42.0,-45.0,-45.0,-37.0,-44.0,-48.0,-90.0,-92.0,-89.0,-93.0,41.0,57.0,47.0,48.0,0
2681,92:69:1D:31:68:E9,3823366,485266014,3588,3502382,3819778,481763632,0,3821,978695,3719,955960,102,22735,1900,6,3714,79,0,31,229410.0,137640.0,-52.0,-50.0,-43.0,-45.0,-52.0,-50.0,-45.0,-50.0,-90.0,-92.0,-89.0,-93.0,38.0,42.0,46.0,48.0,0
2682,CC:2F:71:3F:1F:24,4424452,1171474823,604674,689711191,3819778,481763632,37,501623,559177500,501042,559107466,581,70034,483953,10,604911,51015,34,432,117000.0,39000.0,-67.0,-65.0,-70.0,-68.0,-67.0,-65.0,-70.0,-67.0,-90.0,-92.0,-89.0,-93.0,23.0,27.0,19.0,25.0,0
2683,CC:2F:71:3E:C5:1F,3820486,481850171,708,86539,3819778,481763632,0,3003,251769,2485,190201,518,61568,750,8,1039,18,0,32,130000.0,39000.0,-70.0,-71.0,-67.0,-60.0,-70.0,-71.0,-67.0,-60.0,-90.0,-92.0,-89.0,-93.0,20.0,21.0,22.0,33.0,0
2684,BA:8C:B9:54:50:24,3823845,487202182,4067,5438550,3819778,481763632,0,7222,1422835,7201,1419478,21,3357,1965,14,4442,35,0,50,229410.0,137640.0,-49.0,-35.0,-42.0,-45.0,-45.0,-37.0,-44.0,-48.0,-90.0,-92.0,-89.0,-93.0,41.0,57.0,47.0,48.0,0
2685,92:69:1D:31:68:E9,3823370,485266418,3588,3502382,3819782,481764036,0,3821,978695,3719,955960,102,22735,1900,6,3714,79,0,31,229410.0,137640.0,-52.0,-50.0,-43.0,-45.0,-52.0,-50.0,-45.0,-50.0,-90.0,-92.0,-89.0,-93.0,38.0,42.0,46.0,48.0,0
2686,CC:2F:71:3F:1F:24,4424501,1171489969,604718,689725873,3819783,481764096,37,501648,559182304,501067,559112270,581,70034,483978,10,604955,51019,34,432,130000.0,43333.0,-68.0,-66.0,-71.0,-68.0,-67.0,-65.0,-70.0,-68.0,-90.0,-92.0,-89.0,-93.0,22.0,26.0,18.0,25.0,0
2687,CC:2F:71:3E:C5:1F,3820491,481850635,708,86539,3819783,481764096,0,3003,251769,2485,190201,518,61568,750,8,1039,18,0,32,130000.0,39000.0,-70.0,-71.0,-67.0,-60.0,-70.0,-71.0,-67.0,-60.0,-90.0,-92.0,-89.0,-93.0,20.0,21.0,22.0,33.0,0
2688,BA:8C:B9:54:50:24,3823850,487202646,4067,5438550,3819783,481764096,0,7222,1422835,7201,1419478,21,3357,1965,14,4442,35,0,50,229410.0,137640.0,-49.0,-35.0,-42.0,-45.0,-45.0,-37.0,-44.0,-48.0,-90.0,-92.0,-89.0,-93.0,41.0,57.0,47.0,48.0,0
2689,92:69:1D:31:68:E9,3823375,485266882,3588,3502382,3819787,481764500,0,3821,978695,3719,955960,102,22735,1900,6,3714,79,0,31,229410.0,137640.0,-52.0,-50.0,-43.0,-45.0,-52.0,-50.0,-45.0,-50.0,-90.0,-92.0,-89.0,-93.0,38.0,42.0,46.0,48.0,0
2690,CC:2F:71:3F:1F:24,4424547,1171504801,604760,689740301,3819787,481764500,37,501673,559187108,501092,559117074,581,70034,484003,10,604997,51049,34,432,144444.0,39000.0,-67.0,-65.0,-71.0,-68.0,-67.0,-65.0,-70.0,-67.0,-90.0,-92.0,-89.0,-92.0,23.0,27.0,18.0,24.0,0
2691,CC:2F:71:3E:C5:1F,3820495,481851039,708,86539,3819787,481764500,0,3003,251769,2485,190201,518,61568,750,8,1039,18,0,32,130000.0,39000.0,-70.0,-71.0,-67.0,-60.0,-70.0,-71.0,-67.0,-60.0,-90.0,-92.0,-89.0,-92.0,20.0,21.0,22.0,32.0,0
2692,BA:8C:B9:54:50:24,3823854,487203050,4067,5438550,3819787,481764500,0,7222,1422835,7201,1419478,21,3357,1965,14,4442,35,0,50,229410.0,137640.0,-49.0,-35.0,-42.0,-45.0,-45.0,-37.0,-44.0,-48.0,-90.0,-92.0,-89.0,-92.0,41.0,57.0,47.0,47.0,0
2693,92:69:1D:31:68:E9,3823379,485267286,3588,3502382,3819791,481764904,0,3821,978695,3719,955960,102,22735,1900,6,3714,79,0,31,229410.0,137640.0,-52.0,-50.0,-43.0,-45.0,-52.0,-50.0,-45.0,-50.0,-90.0,-92.0,-89.0,-92.0,38.0,42.0,46.0,47.0,0
2694,CC:2F:71:3F:1F:24,4424594,1171519757,604803,689754853,3819791,481764904,37,501699,559192052,501118,559122018,581,70034,484029,10,605040,51067,34,432,130000.0,43333.0,-67.0,-66.0,-71.0,-68.0,-67.0,-65.0,-70.0,-67.0,-90.0,-92.0,-89.0,-92.0,23.0,26.0,18.0,24.0,0
2695,CC:2F:71:3E:C5:1F,3820499,481851443,708,86539,3819791,481764904,0,3003,251769,2485,190201,518,61568,750,8,1039,18,0,32,130000.0,39000.0,-70.0,-71.0,-67.0,-60.0,-70.0,-71.0,-67.0,-60.0,-90.0,-92.0,-89.0,-92.0,20.0,21.0,22.0,32.0,0
2696,BA:8C:B9:54:50:24,3823880,487218405,4089,5453501,3819791,481764904,0,7249,1427841,7228,1424484,21,3357,1984,14,4464,35,0,50,229410.0,137640.0,-52.0,-48.0,-55.0,-58.0,-44.0,-38.0,-46.0,-50.0,-90.0,-92.0,-89.0,-92.0,38.0,44.0,34.0,34.0,0
2697,92:69:1D:31:68:E9,3823384,485267750,3588,3502382,3819796,481765368,0,3821,978695,3719,955960,102,22735,1900,6,3714,79,0,31,229410.0,137640.0,-52.0,-50.0,-43.0,-45.0,-52.0,-50.0,-45.0,-50.0,-90.0,-92.0,-89.0,-92.0,38.0,42.0,46.0,47.0,0
2698,CC:2F:71:3F:1F:24,4424640,1171534637,604844,689769269,3819796,481765368,37,501726,559197112,501145,559127078,581,70034,484056,10,605081,51073,34,432,130000.0,43333.0,-68.0,-65.0,-71.0,-68.0,-67.0,-65.0,-71.0,-68.0,-90.0,-92.0,-89.0,-92.0,22.0,27.0,18.0,24.0,0
2699,CC:2F:71:3E:C5:1F,3820504,481851907,708,86539,3819796,481765368,0,3003,251769,2485,190201,518,61568,750,8,1039,18,0,32,130000.0,39000.0,-70.0,-71.0,-67.0,-60.0,-70.0,-71.0,-67.0,-60.0,-90.0,-92.0,-89.0,-92.0,20.0,21.0,22.0,32.0,0
2700,BA:8C:B9:54:50:24,3823909,487236564,4113,5471196,3819796,481765368,0,7286,1439129,7265,1435772,21,3357,2006,14,4488,35,0,50,229410.0,137640.0,-49.0,-35.0,-42.0,-44.0,-45.0,-38.0,-45.0,-47.0,-90.0,-92.0,-89.0,-92.0,41.0,57.0,47.0,48.0,0
2701,92:69:1D:31:68:E9,3823390,485268543,3589,3502498,3819801,481766045,0,3823,978831,3721,956096,102,22735,1900,6,3715,79,0,31,229410.0,137640.0,-52.0,-49.0,-44.0,-45.0,-52.0,-50.0,-45.0,-48.0,-90.0,-92.0,-89.0,-92.0,38.0,43.0,45.0,47.0,0
2702,CC:2F:71:3F:1F:24,4424688,1171549858,604887,689783813,3819801,481766045,37,501751,559201916,501170,559131882,581,70034,484081,10,605124,51098,34,432,117000.0,39000.0,-67.0,-65.0,-71.0,-68.0,-67.0,-65.0,-70.0,-67.0,-90.0,-92.0,-89.0,-92.0,23.0,27.0,18.0,24.0,0
2703,CC:2F:71:3E:C5:1F,3820510,481852700,709,86655,3819801,481766045,0,3005,251909,2487,190341,518,61568,750,8,1040,18,0,32,130000.0,39000.0,-71.0,-71.0,-68.0,-60.0,-70.0,-71.0,-67.0,-60.0,-90.0,-92.0,-89.0,-92.0,19.0,21.0,21.0,32.0,0
2704,BA:8C:B9:54:50:24,3823929,487244858,4128,5478813,3819801,481766045,0,7316,1443957,7295,1440600,21,3357,2018,14,4503,35,0,50,229410.0,137640.0,-40.0,-36.0,-45.0,-51.0,-43.0,-36.0,-44.0,-47.0,-90.0,-92.0,-89.0,-92.0,50.0,56.0,44.0,41.0,0
2705,92:69:1D:31:68:E9,3823402,485271857,3589,3502498,3819813,481769359,0,3823,978831,3721,956096,102,22735,1900,6,3715,79,0,31,229410.0,137640.0,-52.0,-49.0,-44.0,-45.0,-52.0,-50.0,-45.0,-48.0,-90.0,-92.0,-89.0,-92.0,38.0,43.0,45.0,47.0,0
2706,CC:2F:71:3F:1F:24,4424741,1171567476,604928,689798117,3819813,481769359,37,501777,559206860,501196,559136826,581,70034,484107,10,605165,51106,34,432,130000.0,43333.0,-68.0,-66.0,-71.0,-68.0,-67.0,-65.0,-70.0,-68.0,-90.0,-92.0,-89.0,-92.0,22.0,26.0,18.0,24.0,0
2707,CC:2F:71:3E:C5:1F,3820522,481856014,709,86655,3819813,481769359,0,3005,251909,2487,190341,518,61568,750,8,1040,18,0,32,130000.0,39000.0,-71.0,-71.0,-68.0,-60.0,-70.0,-71.0,-67.0,-60.0,-90.0,-92.0,-89.0,-92.0,19.0,21.0,21.0,32.0,0
2708,BA:8C:B9:54:50:24,3823965,487302417,4150,5532856,3819815,481769561,0,7349,1448972,7328,1445615,21,3357,2033,14,4525,35,0,50,229410.0,137640.0,-45.0,-38.0,-45.0,-49.0,-44.0,-36.0,-44.0,-48.0,-90.0,-92.0,-89.0,-92.0,45.0,54.0,44.0,43.0,0
2709,92:69:1D:31:68:E9,3823407,485272321,3589,3502498,3819818,481769823,0,3823,978831,3721,956096,102,22735,1900,6,3715,79,0,31,229410.0,137640.0,-52.0,-49.0,-44.0,-45.0,-52.0,-50.0,-45.0,-48.0,-90.0,-92.0,-89.0,-92.0,38.0,43.0,45.0,47.0,0
2710,CC:2F:71:3F:1F:24,4424788,1171582384,604970,689812561,3819818,481769823,37,501803,559211804,501222,559141770,581,70034,484133,10,605207,51139,34,432,144444.0,39000.0,-67.0,-65.0,-71.0,-67.0,-67.0,-65.0,-71.0,-67.0,-90.0,-92.0,-89.0,-92.0,23.0,27.0,18.0,25.0,0
2711,CC:2F:71:3E:C5:1F,3820527,481856478,709,86655,3819818,481769823,0,3005,251909,2487,190341,518,61568,750,8,1040,18,0,32,130000.0,39000.0,-71.0,-71.0,-68.0,-60.0,-70.0,-71.0,-67.0,-60.0,-90.0,-92.0,-89.0,-92.0,19.0,21.0,21.0,32.0,0
2712,BA:8C:B9:54:50:24,3824111,487715635,4293,5945812,3819818,481769823,0,7467,1464486,7446,1461129,21,3357,2092,14,4668,35,0,50,229410.0,137640.0,-45.0,-39.0,-46.0,-49.0,-45.0,-38.0,-45.0,-48.0,-90.0,-92.0,-89.0,-92.0,45.0,53.0,43.0,43.0,0
2713,92:69:1D:31:68:E9,3823411,485272725,3589,3502498,3819822,481770227,0,3823,978831,3721,956096,102,22735,1900,6,3715,79,0,31,229410.0,137640.0,-52.0,-49.0,-44.0,-45.0,-52.0,-50.0,-45.0,-48.0,-90.0,-92.0,-89.0,-92.0,38.0,43.0,45.0,47.0,0
2714,CC:2F:71:3F:1F:24,4424834,1171597216,605012,689826989,3819822,481770227,37,501829,559216748,501248,559146714,581,70034,484159,10,605249,51152,34,432,130000.0,43333.0,-67.0,-66.0,-71.0,-68.0,-67.0,-65.0,-70.0,-68.0,-90.0,-92.0,-89.0,-92.0,23.0,26.0,18.0,24.0,0
2715,CC:2F:71:3E:C5:1F,3820531,481856882,709,86655,3819822,481770227,0,3005,251909,2487,190341,518,61568,750,8,1040,18,0,32,130000.0,39000.0,-71.0,-71.0,-68.0,-60.0,-70.0,-71.0,-67.0,-60.0,-90.0,-92.0,-89.0,-92.0,19.0,21.0,21.0,32.0,0
2716,BA:8C:B9:54:50:24,3824122,487717243,4298,5946814,3819824,481770429,0,7482,1467498,7461,1464141,21,3357,2098,14,4673,35,0,50,229410.0,137640.0,-40.0,-36.0,-45.0,-51.0,-43.0,-37.0,-44.0,-47.0,-90.0,-92.0,-89.0,-92.0,50.0,56.0,44.0,41.0,0
2717,92:69:1D:31:68:E9,3823416,485273189,3589,3502498,3819827,481770691,0,3823,978831,3721,956096,102,22735,1900,6,3715,79,0,31,229410.0,137640.0,-52.0,-49.0,-44.0,-45.0,-52.0,-50.0,-45.0,-48.0,-90.0,-92.0,-89.0,-92.0,38.0,43.0,45.0,47.0,0
2718,CC:2F:71:3F:1F:24,4424879,1171611860,605052,689841169,3819827,481770691,37,501855,559221692,501274,559151658,581,70034,484185,10,605289,51172,34,432,117000.0,39000.0,-67.0,-65.0,-71.0,-68.0,-67.0,-65.0,-70.0,-68.0,-90.0,-92.0,-89.0,-92.0,23.0,27.0,18.0,24.0,0
2719,CC:2F:71:3E:C5:1F,3820536,481857346,709,86655,3819827,481770691,0,3005,251909,2487,190341,518,61568,750,8,1040,18,0,32,130000.0,39000.0,-71.0,-71.0,-68.0,-60.0,-70.0,-71.0,-67.0,-60.0,-90.0,-92.0,-89.0,-92.0,19.0,21.0,21.0,32.0,0
2720,BA:8C:B9:54:50:24,3824190,487755534,4363,5984843,3819827,481770691,0,7563,1489742,7542,1486385,21,3357,2146,14,4738,35,0,50,229410.0,137640.0,-45.0,-39.0,-47.0,-49.0,-44.0,-38.0,-46.0,-48.0,-90.0,-92.0,-89.0,-92.0,45.0,53.0,42.0,43.0,0
2721,92:69:1D:31:68:E9,3823421,485273655,3589,3502498,3819832,481771157,0,3823,978831,3721,956096,102,22735,1900,6,3715,79,0,31,229410.0,137640.0,-52.0,-49.0,-44.0,-45.0,-52.0,-50.0,-45.0,-48.0,-90.0,-92.0,-89.0,-92.0,38.0,43.0,45.0,47.0,0
2722,CC:2F:71:3F:1F:24,4424926,1171626754,605094,689855597,3819832,481771157,37,501881,559226636,501300,559156602,581,70034,484211,10,605331,51175,34,432,130000.0,43333.0,-68.0,-66.0,-71.0,-68.0,-67.0,-65.0,-70.0,-68.0,-90.0,-92.0,-89.0,-92.0,22.0,26.0,18.0,24.0,0
2723,CC:2F:71:3E:C5:1F,3820541,481857812,709,86655,3819832,481771157,0,3007,252097,2488,190411,519,61686,751,8,1040,18,0,32,130000.0,39000.0,-71.0,-71.0,-67.0,-60.0,-70.0,-71.0,-67.0,-60.0,-90.0,-92.0,-89.0,-92.0,19.0,21.0,22.0,32.0,0
2724,BA:8C:B9:54:50:24,3824207,487761339,4373,5989980,3819834,481771359,0,7586,1494504,7565,1491147,21,3357,2156,14,4748,35,0,50,229410.0,137640.0,-39.0,-37.0,-43.0,-53.0,-41.0,-37.0,-44.0,-50.0,-90.0,-92.0,-89.0,-92.0,51.0,55.0,46.0,39.0,0
2725,92:69:1D:31:68:E9,3823425,485274059,3589,3502498,3819836,481771561,0,3823,978831,3721,956096,102,22735,1900,6,3715,79,0,31,229410.0,137640.0,-52.0,-49.0,-44.0,-45.0,-52.0,-50.0,-45.0,-48.0,-90.0,-92.0,-89.0,-92.0,38.0,43.0,45.0,47.0,0
2726,CC:2F:71:3F:1F:24,4424972,1171641586,605136,689870025,3819836,481771561,37,501907,559231580,501326,559161546,581,70034,484237,10,605373,51196,34,432,117000.0,39000.0,-67.0,-66.0,-71.0,-68.0,-67.0,-65.0,-70.0,-68.0,-90.0,-92.0,-89.0,-92.0,23.0,26.0,18.0,24.0,0
2727,CC:2F:71:3E:C5:1F,3820545,481858216,709,86655,3819836,481771561,0,3007,252097,2488,190411,519,61686,751,8,1040,18,0,32,130000.0,39000.0,-71.0,-71.0,-67.0,-60.0,-70.0,-71.0,-67.0,-60.0,-90.0,-92.0,-89.0,-92.0,19.0,21.0,22.0,32.0,0
2728,BA:8C:B9:54:50:24,3824248,487794928,4412,6023367,3819836,481771561,0,7644,1510417,7623,1507060,21,3357,2191,14,4787,35,0,50,229410.0,137640.0,-52.0,-35.0,-43.0,-44.0,-44.0,-35.0,-43.0,-45.0,-90.0,-92.0,-89.0,-92.0,38.0,57.0,46.0,48.0,0
2729,92:69:1D:31:68:E9,3823431,485274585,3589,3502498,3819842,481772087,0,3823,978831,3721,956096,102,22735,1900,6,3715,79,0,31,229410.0,137640.0,-52.0,-49.0,-44.0,-45.0,-52.0,-50.0,-45.0,-48.0,-90.0,-92.0,-89.0,-92.0,38.0,43.0,45.0,47.0,0
2730,CC:2F:71:3F:1F:24,4425021,1171656664,605179,689884577,3819842,481772087,37,501933,559236502,501351,559166350,582,70152,484263,10,605416,51207,34,432,130000.0,43333.0,-67.0,-65.0,-70.0,-68.0,-67.0,-65.0,-70.0,-67.0,-90.0,-92.0,-89.0,-92.0,23.0,27.0,19.0,24.0,0
2731,CC:2F:71:3E:C5:1F,3820553,481858944,709,86655,3819844,481772289,0,3007,252097,2488,190411,519,61686,751,8,1040,18,0,32,130000.0,39000.0,-71.0,-71.0,-67.0,-60.0,-70.0,-71.0,-67.0,-60.0,-90.0,-92.0,-89.0,-92.0,19.0,21.0,22.0,32.0,0
2732,BA:8C:B9:54:50:24,3824286,487814497,4442,6042208,3819844,481772289,0,7699,1522113,7678,1518756,21,3357,2224,14,4817,35,0,50,229410.0,137640.0,-44.0,-38.0,-46.0,-48.0,-43.0,-38.0,-45.0,-48.0,-90.0,-92.0,-89.0,-92.0,46.0,54.0,43.0,44.0,0
2733,92:69:1D:31:68:E9,3823435,485274989,3589,3502498,3819846,481772491,0,3823,978831,3721,956096,102,22735,1900,6,3715,79,0,31,229410.0,137640.0,-52.0,-49.0,-44.0,-45.0,-52.0,-50.0,-45.0,-48.0,-90.0,-92.0,-89.0,-92.0,38.0,43.0,45.0,47.0,0
2734,CC:2F:71:3F:1F:24,4425067,1171671568,605221,689899077,3819846,481772491,37,501958,559241306,501376,559171154,582,70152,484288,10,605458,51220,34,432,130000.0,39000.0,-68.0,-65.0,-70.0,-68.0,-67.0,-65.0,-70.0,-68.0,-90.0,-92.0,-89.0,-92.0,22.0,27.0,19.0,24.0,0
2735,CC:2F:71:3E:C5:1F,3820555,481859146,709,86655,3819846,481772491,0,3007,252097,2488,190411,519,61686,751,8,1040,18,0,32,130000.0,39000.0,-71.0,-71.0,-67.0,-60.0,-70.0,-71.0,-67.0,-60.0,-90.0,-92.0,-89.0,-92.0,19.0,21.0,22.0,32.0,0
2736,BA:8C:B9:54:50:24,3824288,487814699,4442,6042208,3819846,481772491,0,7704,1522453,7683,1519096,21,3357,2224,14,4817,35,0,50,229410.0,137640.0,-39.0,-37.0,-44.0,-52.0,-44.0,-38.0,-45.0,-48.0,-90.0,-92.0,-89.0,-92.0,51.0,55.0,45.0,40.0,0
2737,92:69:1D:31:68:E9,3823437,485275191,3589,3502498,3819848,481772693,0,3823,978831,3721,956096,102,22735,1900,6,3715,79,0,31,229410.0,137640.0,-52.0,-49.0,-44.0,-45.0,-52.0,-50.0,-45.0,-48.0,-90.0,-92.0,-89.0,-92.0,38.0,43.0,45.0,47.0,0
2738,CC:2F:71:3F:1F:24,4425113,1171686344,605263,689913449,3819850,481772895,37,501985,559246366,501403,559176214,582,70152,484315,10,605500,51247,34,432,130000.0,43333.0,-67.0,-65.0,-71.0,-68.0,-67.0,-65.0,-70.0,-68.0,-90.0,-92.0,-89.0,-92.0,23.0,27.0,18.0,24.0,0
2739,CC:2F:71:3E:C5:1F,3820561,481859752,709,86655,3819852,481773097,0,3007,252097,2488,190411,519,61686,751,8,1040,18,0,32,130000.0,39000.0,-71.0,-71.0,-67.0,-60.0,-70.0,-71.0,-67.0,-60.0,-90.0,-92.0,-89.0,-92.0,19.0,21.0,22.0,32.0,0
2740,BA:8C:B9:54:50:24,3824323,487822465,4470,6049308,3819853,481773157,0,7751,1577868,7730,1574511,21,3357,2254,14,4845,35,0,50,216660.0,130000.0,-40.0,-36.0,-44.0,-51.0,-44.0,-38.0,-45.0,-49.0,-90.0,-92.0,-89.0,-92.0,50.0,56.0,45.0,41.0,0
2741,92:69:1D:31:68:E9,3823444,485275857,3589,3502498,3819855,481773359,0,3824,978899,3722,956164,102,22735,1900,6,3715,79,0,31,229410.0,137640.0,-52.0,-51.0,-44.0,-48.0,-52.0,-50.0,-44.0,-48.0,-90.0,-92.0,-89.0,-92.0,38.0,41.0,45.0,44.0,0
2742,CC:2F:71:3F:1F:24,4425161,1171701472,605306,689928113,3819855,481773359,37,502011,559251310,501429,559181158,582,70152,484341,10,605543,51252,34,432,130000.0,43333.0,-68.0,-66.0,-71.0,-68.0,-67.0,-65.0,-71.0,-68.0,-90.0,-92.0,-89.0,-92.0,22.0,26.0,18.0,24.0,0
2743,CC:2F:71:3E:C5:1F,3820564,481860014,709,86655,3819855,481773359,0,3007,252097,2488,190411,519,61686,751,8,1040,18,0,32,130000.0,39000.0,-71.0,-71.0,-67.0,-60.0,-70.0,-71.0,-67.0,-60.0,-90.0,-92.0,-89.0,-92.0,19.0,21.0,22.0,32.0,0
2744,BA:8C:B9:54:50:24,3824390,487891454,4535,6118095,3819855,481773359,0,7807,1601014,7786,1597657,21,3357,2285,14,4910,35,0,50,229410.0,130000.0,-45.0,-38.0,-46.0,-49.0,-45.0,-38.0,-45.0,-49.0,-90.0,-92.0,-89.0,-92.0,45.0,54.0,43.0,43.0,0
2745,92:69:1D:31:68:E9,3823446,485276059,3589,3502498,3819857,481773561,0,3824,978899,3722,956164,102,22735,1900,6,3715,79,0,31,229410.0,137640.0,-52.0,-51.0,-44.0,-48.0,-52.0,-50.0,-44.0,-48.0,-90.0,-92.0,-89.0,-92.0,38.0,41.0,45.0,44.0,0
2746,CC:2F:71:3F:1F:24,4425207,1171716320,605348,689942557,3819859,481773763,37,502038,559256394,501456,559186242,582,70152,484368,10,605585,51268,34,432,117000.0,39000.0,-67.0,-66.0,-71.0,-68.0,-67.0,-65.0,-70.0,-67.0,-90.0,-92.0,-89.0,-92.0,23.0,26.0,18.0,24.0,0
2747,CC:2F:71:3E:C5:1F,3820570,481860620,709,86655,3819861,481773965,0,3007,252097,2488,190411,519,61686,751,8,1040,18,0,32,130000.0,39000.0,-71.0,-71.0,-67.0,-60.0,-70.0,-71.0,-67.0,-60.0,-90.0,-92.0,-89.0,-92.0,19.0,21.0,22.0,32.0,0
2748,BA:8C:B9:54:50:24,3824404,487895921,4543,6121956,3819861,481773965,0,7819,1604276,7798,1600919,21,3357,2291,14,4918,35,0,50,229410.0,130000.0,-49.0,-35.0,-42.0,-44.0,-45.0,-37.0,-44.0,-48.0,-90.0,-92.0,-89.0,-92.0,41.0,57.0,47.0,48.0,0
2749,92:69:1D:31:68:E9,3823453,485276725,3589,3502498,3819864,481774227,0,3824,978899,3722,956164,102,22735,1900,6,3715,79,0,31,229410.0,137640.0,-52.0,-51.0,-44.0,-48.0,-52.0,-50.0,-44.0,-48.0,-90.0,-92.0,-89.0,-92.0,38.0,41.0,45.0,44.0,0
2750,CC:2F:71:3F:1F:24,4425255,1171731230,605391,689957003,3819864,481774227,37,502065,559261454,501483,559191302,582,70152,484395,10,605628,51283,34,432,117000.0,39000.0,-67.0,-65.0,-71.0,-64.0,-67.0,-65.0,-71.0,-64.0,-90.0,-92.0,-89.0,-92.0,23.0,27.0,18.0,28.0,0
2751,CC:2F:71:3E:C5:1F,3820573,481860882,709,86655,3819864,481774227,0,3007,252097,2488,190411,519,61686,751,8,1040,18,0,32,130000.0,39000.0,-71.0,-71.0,-67.0,-60.0,-70.0,-71.0,-67.0,-60.0,-90.0,-92.0,-89.0,-92.0,19.0,21.0,22.0,32.0,0
2752,BA:8C:B9:54:50:24,3824419,487901782,4543,6121956,3819876,481779826,0,7819,1604276,7798,1600919,21,3357,2291,14,4918,35,0,50,229410.0,130000.0,-49.0,-35.0,-42.0,-44.0,-45.0,-37.0,-44.0,-48.0,-90.0,-92.0,-89.0,-92.0,41.0,57.0,47.0,48.0,0
2753,92:69:1D:31:68:E9,3823478,485287950,3589,3502498,3819889,481785452,0,3827,979270,3724,956300,103,22970,1901,6,3715,79,0,31,229410.0,137640.0,-51.0,-47.0,-42.0,-48.0,-52.0,-49.0,-44.0,-47.0,-90.0,-92.0,-89.0,-92.0,39.0,45.0,47.0,44.0,0
2754,CC:2F:71:3F:1F:24,4425324,1171757085,605433,689971431,3819891,481785654,37,502090,559266258,501508,559196106,582,70152,484420,10,605670,51293,34,432,130000.0,43333.0,-67.0,-65.0,-70.0,-68.0,-67.0,-65.0,-70.0,-67.0,-90.0,-92.0,-89.0,-92.0,23.0,27.0,19.0,24.0,0
2755,CC:2F:71:3E:C5:1F,3820602,481872511,709,86655,3819893,481785856,0,3007,252097,2488,190411,519,61686,751,8,1040,18,0,32,130000.0,39000.0,-71.0,-71.0,-67.0,-60.0,-70.0,-71.0,-67.0,-60.0,-90.0,-92.0,-89.0,-92.0,19.0,21.0,22.0,32.0,0
2756,BA:8C:B9:54:50:24,3824437,487908085,4543,6121956,3819894,481786129,0,7819,1604276,7798,1600919,21,3357,2291,14,4918,35,0,50,229410.0,130000.0,-49.0,-35.0,-42.0,-44.0,-45.0,-37.0,-44.0,-48.0,-90.0,-92.0,-89.0,-92.0,41.0,57.0,47.0,48.0,0
2757,92:69:1D:31:68:E9,3823485,485288829,3589,3502498,3819896,481786331,0,3827,979270,3724,956300,103,22970,1901,6,3715,79,0,31,229410.0,137640.0,-51.0,-47.0,-42.0,-48.0,-52.0,-49.0,-44.0,-47.0,-90.0,-92.0,-89.0,-92.0,39.0,45.0,47.0,44.0,0
2758,CC:2F:71:3F:1F:24,4425371,1171772308,605475,689985977,3819896,481786331,37,502116,559271202,501534,559201050,582,70152,484446,10,605712,51301,34,432,130000.0,43333.0,-68.0,-66.0,-71.0,-68.0,-68.0,-66.0,-71.0,-68.0,-90.0,-92.0,-89.0,-92.0,22.0,26.0,18.0,24.0,0
2759,CC:2F:71:3E:C5:1F,3820605,481872986,709,86655,3819896,481786331,0,3007,252097,2488,190411,519,61686,751,8,1040,18,0,32,130000.0,39000.0,-71.0,-71.0,-67.0,-60.0,-70.0,-71.0,-67.0,-60.0,-90.0,-92.0,-89.0,-92.0,19.0,21.0,22.0,32.0,0
2760,BA:8C:B9:54:50:24,3824439,487908287,4543,6121956,3819896,481786331,0,7819,1604276,7798,1600919,21,3357,2291,14,4918,35,0,50,229410.0,130000.0,-49.0,-35.0,-42.0,-44.0,-45.0,-37.0,-44.0,-48.0,-90.0,-92.0,-89.0,-92.0,41.0,57.0,47.0,48.0,0
2761,92:69:1D:31:68:E9,3823488,485289091,3589,3502498,3819899,481786593,0,3827,979270,3724,956300,103,22970,1901,6,3715,79,0,31,229410.0,137640.0,-51.0,-47.0,-42.0,-48.0,-52.0,-49.0,-44.0,-47.0,-90.0,-92.0,-89.0,-92.0,39.0,45.0,47.0,44.0,0
2762,CC:2F:71:3F:1F:24,4425417,1171787126,605517,690000399,3819900,481786727,37,502143,559276262,501561,559206110,582,70152,484473,10,605754,51330,34,432,144444.0,43333.0,-74.0,-72.0,-77.0,-75.0,-72.0,-69.0,-75.0,-72.0,-90.0,-92.0,-89.0,-92.0,16.0,20.0,12.0,17.0,0
2763,CC:2F:71:3E:C5:1F,3820612,481873652,709,86655,3819903,481786997,0,3007,252097,2488,190411,519,61686,751,8,1040,18,0,32,130000.0,39000.0,-71.0,-71.0,-67.0,-60.0,-70.0,-71.0,-67.0,-60.0,-90.0,-92.0,-89.0,-92.0,19.0,21.0,22.0,32.0,0
2764,BA:8C:B9:54:50:24,3824446,487908953,4543,6121956,3819903,481786997,0,7819,1604276,7798,1600919,21,3357,2291,14,4918,35,0,50,229410.0,130000.0,-49.0,-35.0,-42.0,-44.0,-45.0,-37.0,-44.0,-48.0,-90.0,-92.0,-89.0,-92.0,41.0,57.0,47.0,48.0,0
2765,92:69:1D:31:68:E9,3823494,485289697,3589,3502498,3819905,481787199,0,3827,979270,3724,956300,103,22970,1901,6,3715,79,0,31,229410.0,137640.0,-51.0,-47.0,-42.0,-48.0,-52.0,-49.0,-44.0,-47.0,-89.0,-92.0,-89.0,-92.0,38.0,45.0,47.0,44.0,0
2766,CC:2F:71:3F:1F:24,4425465,1171802150,605560,690014951,3819905,481787199,37,502170,559281322,501588,559211170,582,70152,484500,10,605797,51339,34,432,130000.0,43333.0,-68.0,-66.0,-71.0,-64.0,-67.0,-65.0,-71.0,-64.0,-89.0,-92.0,-89.0,-92.0,21.0,26.0,18.0,28.0,0
2767,CC:2F:71:3E:C5:1F,3820614,481873854,709,86655,3819905,481787199,0,3007,252097,2488,190411,519,61686,751,8,1040,18,0,32,130000.0,39000.0,-71.0,-71.0,-67.0,-60.0,-70.0,-71.0,-67.0,-60.0,-89.0,-92.0,-89.0,-92.0,18.0,21.0,22.0,32.0,0
2768,BA:8C:B9:54:50:24,3824448,487909155,4543,6121956,3819905,481787199,0,7819,1604276,7798,1600919,21,3357,2291,14,4918,35,0,50,229410.0,130000.0,-49.0,-35.0,-42.0,-44.0,-45.0,-37.0,-44.0,-48.0,-89.0,-92.0,-89.0,-92.0,40.0,57.0,47.0,48.0,0
2769,92:69:1D:31:68:E9,3823498,485290267,3589,3502498,3819909,481787769,0,3827,979270,3724,956300,103,22970,1901,6,3715,79,0,31,229410.0,137640.0,-51.0,-47.0,-42.0,-48.0,-52.0,-49.0,-44.0,-47.0,-89.0,-92.0,-89.0,-92.0,38.0,45.0,47.0,44.0,0
2770,CC:2F:71:3F:1F:24,4425515,1171817668,605603,690029637,3819912,481788031,37,502197,559286370,501615,559216218,582,70152,484527,10,605840,51356,34,432,117000.0,39000.0,-68.0,-66.0,-72.0,-68.0,-68.0,-66.0,-71.0,-68.0,-89.0,-92.0,-89.0,-92.0,21.0,26.0,17.0,24.0,0
2771,CC:2F:71:3E:C5:1F,3820623,481874888,709,86655,3819914,481788233,0,3007,252097,2488,190411,519,61686,751,8,1040,18,0,32,130000.0,39000.0,-71.0,-71.0,-67.0,-60.0,-70.0,-71.0,-67.0,-60.0,-89.0,-92.0,-89.0,-92.0,18.0,21.0,22.0,32.0,0
2772,BA:8C:B9:54:50:24,3824457,487910189,4543,6121956,3819914,481788233,0,7819,1604276,7798,1600919,21,3357,2291,14,4918,35,0,50,229410.0,130000.0,-49.0,-35.0,-42.0,-44.0,-45.0,-37.0,-44.0,-48.0,-89.0,-92.0,-89.0,-92.0,40.0,57.0,47.0,48.0,0
2773,92:69:1D:31:68:E9,3823505,485290933,3589,3502498,3819916,481788435,0,3827,979270,3724,956300,103,22970,1901,6,3715,79,0,31,229410.0,137640.0,-51.0,-47.0,-42.0,-48.0,-52.0,-49.0,-44.0,-47.0,-89.0,-92.0,-89.0,-92.0,38.0,45.0,47.0,44.0,0
2774,CC:2F:71:3F:1F:24,4425561,1171832500,605645,690044065,3819916,481788435,37,502223,559291314,501641,559221162,582,70152,484553,10,605882,51358,34,432,130000.0,43333.0,-68.0,-66.0,-72.0,-68.0,-68.0,-66.0,-71.0,-68.0,-89.0,-92.0,-89.0,-92.0,21.0,26.0,17.0,24.0,0
2775,CC:2F:71:3E:C5:1F,3820625,481875090,709,86655,3819916,481788435,0,3007,252097,2488,190411,519,61686,751,8,1040,18,0,32,130000.0,39000.0,-71.0,-71.0,-67.0,-60.0,-70.0,-71.0,-67.0,-60.0,-89.0,-92.0,-89.0,-92.0,18.0,21.0,22.0,32.0,0
2776,BA:8C:B9:54:50:24,3824459,487910391,4543,6121956,3819916,481788435,0,7819,1604276,7798,1600919,21,3357,2291,14,4918,35,0,50,229410.0,130000.0,-49.0,-35.0,-42.0,-44.0,-45.0,-37.0,-44.0,-48.0,-89.0,-92.0,-89.0,-92.0,40.0,57.0,47.0,48.0,0
2777,92:69:1D:31:68:E9,3823507,485291135,3589,3502498,3819918,481788637,0,3827,979270,3724,956300,103,22970,1901,6,3715,79,0,31,229410.0,137640.0,-51.0,-47.0,-42.0,-48.0,-52.0,-49.0,-44.0,-47.0,-89.0,-92.0,-89.0,-92.0,38.0,45.0,47.0,44.0,0
2778,CC:2F:71:3F:1F:24,4425609,1171847642,605689,690058803,3819920,481788839,37,502252,559296678,501670,559226526,582,70152,484582,10,605926,51372,34,432,130000.0,39000.0,-68.0,-66.0,-72.0,-64.0,-70.0,-67.0,-73.0,-69.0,-89.0,-92.0,-89.0,-92.0,21.0,26.0,17.0,28.0,0
2779,CC:2F:71:3E:C5:1F,3820629,481875494,709,86655,3819920,481788839,0,3007,252097,2488,190411,519,61686,751,8,1040,18,0,32,130000.0,39000.0,-71.0,-71.0,-67.0,-60.0,-70.0,-71.0,-67.0,-60.0,-89.0,-92.0,-89.0,-92.0,18.0,21.0,22.0,32.0,0
2780,BA:8C:B9:54:50:24,3824465,487910997,4543,6121956,3819922,481789041,0,7819,1604276,7798,1600919,21,3357,2291,14,4918,35,0,50,229410.0,130000.0,-49.0,-35.0,-42.0,-44.0,-45.0,-37.0,-44.0,-48.0,-89.0,-92.0,-89.0,-92.0,40.0,57.0,47.0,48.0,0
2781,92:69:1D:31:68:E9,3823516,485292029,3591,3502726,3819925,481789303,0,3831,979674,3728,956704,103,22970,1903,6,3717,79,0,31,216660.0,130000.0,-52.0,-50.0,-44.0,-46.0,-52.0,-49.0,-44.0,-48.0,-90.0,-93.0,-89.0,-92.0,38.0,43.0,45.0,46.0,0
2782,CC:2F:71:3F:1F:24,4425657,1171862658,605732,690073355,3819925,481789303,37,502281,559302042,501699,559231890,582,70152,484611,10,605969,51383,34,432,130000.0,39000.0,-71.0,-67.0,-75.0,-71.0,-70.0,-67.0,-74.0,-70.0,-90.0,-93.0,-89.0,-92.0,19.0,26.0,14.0,21.0,0
2783,CC:2F:71:3E:C5:1F,3820634,481875958,709,86655,3819925,481789303,0,3007,252097,2488,190411,519,61686,751,8,1040,18,0,32,130000.0,39000.0,-71.0,-71.0,-67.0,-60.0,-70.0,-71.0,-67.0,-60.0,-90.0,-93.0,-89.0,-92.0,19.0,22.0,22.0,32.0,0
2784,BA:8C:B9:54:50:24,3824468,487911259,4543,6121956,3819925,481789303,0,7819,1604276,7798,1600919,21,3357,2291,14,4918,35,0,50,229410.0,130000.0,-49.0,-35.0,-42.0,-44.0,-45.0,-37.0,-44.0,-48.0,-90.0,-93.0,-89.0,-92.0,41.0,58.0,47.0,48.0,0
2785,92:69:1D:31:68:E9,3823518,485292231,3591,3502726,3819927,481789505,0,3831,979674,3728,956704,103,22970,1903,6,3717,79,0,31,216660.0,130000.0,-52.0,-50.0,-44.0,-46.0,-52.0,-49.0,-44.0,-48.0,-90.0,-93.0,-89.0,-92.0,38.0,43.0,45.0,46.0,0
2786,CC:2F:71:3F:1F:24,4425702,1171877304,605773,690087597,3819929,481789707,37,502310,559307406,501728,559237254,582,70152,484640,10,606010,51399,34,432,117000.0,39000.0,-71.0,-69.0,-75.0,-71.0,-70.0,-69.0,-74.0,-71.0,-90.0,-93.0,-89.0,-92.0,19.0,24.0,14.0,21.0,0
2787,CC:2F:71:3E:C5:1F,3820638,481876362,709,86655,3819929,481789707,0,3007,252097,2488,190411,519,61686,751,8,1040,18,0,32,130000.0,39000.0,-71.0,-71.0,-67.0,-60.0,-70.0,-71.0,-67.0,-60.0,-90.0,-93.0,-89.0,-92.0,19.0,22.0,22.0,32.0,0
2788,BA:8C:B9:54:50:24,3824472,487911663,4543,6121956,3819929,481789707,0,7819,1604276,7798,1600919,21,3357,2291,14,4918,35,0,50,229410.0,130000.0,-49.0,-35.0,-42.0,-44.0,-45.0,-37.0,-44.0,-48.0,-90.0,-93.0,-89.0,-92.0,41.0,58.0,47.0,48.0,0
2789,92:69:1D:31:68:E9,3823524,485292837,3591,3502726,3819933,481790111,0,3831,979674,3728,956704,103,22970,1903,6,3717,79,0,31,216660.0,130000.0,-52.0,-50.0,-44.0,-46.0,-52.0,-49.0,-44.0,-48.0,-90.0,-93.0,-89.0,-92.0,38.0,43.0,45.0,46.0,0
2790,CC:2F:71:3F:1F:24,4425749,1171892260,605816,690102149,3819933,481790111,37,502339,559312806,501757,559242654,582,70152,484669,10,606053,51404,34,432,130000.0,43333.0,-67.0,-65.0,-71.0,-68.0,-69.0,-67.0,-73.0,-70.0,-90.0,-93.0,-89.0,-92.0,23.0,28.0,18.0,24.0,0
2791,CC:2F:71:3E:C5:1F,3820642,481876766,709,86655,3819933,481790111,0,3007,252097,2488,190411,519,61686,751,8,1040,18,0,32,130000.0,39000.0,-71.0,-71.0,-67.0,-60.0,-70.0,-71.0,-67.0,-60.0,-90.0,-93.0,-89.0,-92.0,19.0,22.0,22.0,32.0,0
2792,BA:8C:B9:54:50:24,3824476,487912067,4543,6121956,3819933,481790111,0,7819,1604276,7798,1600919,21,3357,2291,14,4918,35,0,50,229410.0,130000.0,-49.0,-35.0,-42.0,-44.0,-45.0,-37.0,-44.0,-48.0,-90.0,-93.0,-89.0,-92.0,41.0,58.0,47.0,48.0,0
2793,92:69:1D:31:68:E9,3823527,485293099,3591,3502726,3819936,481790373,0,3831,979674,3728,956704,103,22970,1903,6,3717,79,0,31,216660.0,130000.0,-52.0,-50.0,-44.0,-46.0,-52.0,-49.0,-44.0,-48.0,-90.0,-93.0,-89.0,-92.0,38.0,43.0,45.0,46.0,0
2794,CC:2F:71:3F:1F:24,4425797,1171907388,605859,690116813,3819938,481790575,37,502368,559318170,501786,559248018,582,70152,484698,10,606096,51409,34,432,130000.0,43333.0,-67.0,-65.0,-71.0,-68.0,-67.0,-65.0,-70.0,-68.0,-90.0,-93.0,-89.0,-92.0,23.0,28.0,18.0,24.0,0
2795,CC:2F:71:3E:C5:1F,3820647,481877230,709,86655,3819938,481790575,0,3007,252097,2488,190411,519,61686,751,8,1040,18,0,32,130000.0,39000.0,-71.0,-71.0,-67.0,-60.0,-70.0,-71.0,-67.0,-60.0,-90.0,-93.0,-89.0,-92.0,19.0,22.0,22.0,32.0,0
2796,BA:8C:B9:54:50:24,3824483,487912733,4543,6121956,3819940,481790777,0,7819,1604276,7798,1600919,21,3357,2291,14,4918,35,0,50,229410.0,130000.0,-49.0,-35.0,-42.0,-44.0,-45.0,-37.0,-44.0,-48.0,-90.0,-93.0,-89.0,-92.0,41.0,58.0,47.0,48.0,0
2797,92:69:1D:31:68:E9,3823533,485293705,3591,3502726,3819942,481790979,0,3831,979674,3728,956704,103,22970,1903,6,3717,79,0,31,216660.0,130000.0,-52.0,-50.0,-44.0,-46.0,-52.0,-49.0,-44.0,-48.0,-90.0,-93.0,-89.0,-92.0,38.0,43.0,45.0,46.0,0
2798,CC:2F:71:3F:1F:24,4425843,1171922354,605901,690131375,3819942,481790979,37,502401,559324010,501819,559253858,582,70152,484731,10,606138,51428,34,432,117000.0,39000.0,-67.0,-65.0,-70.0,-68.0,-67.0,-66.0,-71.0,-68.0,-90.0,-93.0,-89.0,-92.0,23.0,28.0,19.0,24.0,0
2799,CC:2F:71:3E:C5:1F,3820651,481877634,709,86655,3819942,481790979,0,3007,252097,2488,190411,519,61686,751,8,1040,18,0,32,130000.0,39000.0,-71.0,-71.0,-67.0,-60.0,-70.0,-71.0,-67.0,-60.0,-90.0,-93.0,-89.0,-92.0,19.0,22.0,22.0,32.0,0
2800,BA:8C:B9:54:50:24,3824485,487912935,4543,6121956,3819942,481790979,0,7819,1604276,7798,1600919,21,3357,2291,14,4918,35,0,50,229410.0,130000.0,-49.0,-35.0,-42.0,-44.0,-45.0,-37.0,-44.0,-48.0,-90.0,-93.0,-89.0,-92.0,41.0,58.0,47.0,48.0,0
2801,92:69:1D:31:68:E9,3823536,485293967,3591,3502726,3819945,481791241,0,3831,979674,3728,956704,103,22970,1903,6,3717,79,0,31,216660.0,130000.0,-52.0,-50.0,-44.0,-46.0,-52.0,-49.0,-44.0,-48.0,-90.0,-92.0,-89.0,-92.0,38.0,42.0,45.0,46.0,0
2802,CC:2F:71:3F:1F:24,4425892,1171937500,605945,690146057,3819947,481791443,37,502430,559329374,501848,559259222,582,70152,484760,10,606182,51431,34,432,130000.0,43333.0,-68.0,-66.0,-71.0,-69.0,-68.0,-66.0,-71.0,-68.0,-90.0,-92.0,-89.0,-92.0,22.0,26.0,18.0,23.0,0
2803,CC:2F:71:3E:C5:1F,3820656,481878098,709,86655,3819947,481791443,0,3007,252097,2488,190411,519,61686,751,8,1040,18,0,32,130000.0,39000.0,-71.0,-71.0,-67.0,-60.0,-70.0,-71.0,-67.0,-60.0,-90.0,-92.0,-89.0,-92.0,19.0,21.0,22.0,32.0,0
2804,BA:8C:B9:54:50:24,3824490,487913399,4543,6121956,3819947,481791443,0,7819,1604276,7798,1600919,21,3357,2291,14,4918,35,0,50,229410.0,130000.0,-49.0,-35.0,-42.0,-44.0,-45.0,-37.0,-44.0,-48.0,-90.0,-92.0,-89.0,-92.0,41.0,57.0,47.0,48.0,0
2805,92:69:1D:31:68:E9,3823544,485294805,3593,3502958,3819951,481791847,0,3835,979984,3732,957014,103,22970,1904,6,3719,79,0,31,216660.0,130000.0,-51.0,-47.0,-42.0,-48.0,-52.0,-49.0,-44.0,-47.0,-90.0,-93.0,-89.0,-92.0,39.0,46.0,47.0,44.0,0
2806,CC:2F:71:3F:1F:24,4425940,1171952628,605989,690160781,3819951,481791847,37,502461,559334994,501879,559264842,582,70152,484791,10,606226,51442,34,432,130000.0,39000.0,-68.0,-66.0,-71.0,-69.0,-68.0,-66.0,-72.0,-69.0,-90.0,-93.0,-89.0,-92.0,22.0,27.0,18.0,23.0,0
2807,CC:2F:71:3E:C5:1F,3820661,481878618,710,86771,3819951,481791847,0,3009,252237,2490,190551,519,61686,751,8,1041,18,0,32,130000.0,39000.0,-70.0,-72.0,-68.0,-60.0,-70.0,-71.0,-67.0,-60.0,-90.0,-93.0,-89.0,-92.0,20.0,21.0,21.0,32.0,0
2808,BA:8C:B9:54:50:24,3824496,487914192,4544,6122072,3819952,481792120,0,7821,1604412,7800,1601055,21,3357,2291,14,4919,35,0,50,229410.0,130000.0,-49.0,-35.0,-42.0,-44.0,-45.0,-37.0,-44.0,-48.0,-90.0,-93.0,-89.0,-92.0,41.0,58.0,47.0,48.0,0
2809,92:69:1D:31:68:E9,3823547,485295280,3593,3502958,3819954,481792322,0,3835,979984,3732,957014,103,22970,1904,6,3719,79,0,31,216660.0,130000.0,-51.0,-47.0,-42.0,-48.0,-52.0,-49.0,-44.0,-47.0,-90.0,-93.0,-89.0,-92.0,39.0,46.0,47.0,44.0,0
2810,CC:2F:71:3F:1F:24,4425988,1171967863,606032,690175339,3819956,481792524,37,502491,559340498,501909,559270346,582,70152,484821,10,606269,51451,34,432,130000.0,43333.0,-68.0,-66.0,-72.0,-68.0,-68.0,-66.0,-71.0,-68.0,-90.0,-93.0,-89.0,-92.0,22.0,27.0,17.0,24.0,0
2811,CC:2F:71:3E:C5:1F,3820666,481879295,710,86771,3819956,481792524,0,3009,252237,2490,190551,519,61686,751,8,1041,18,0,32,130000.0,39000.0,-70.0,-72.0,-68.0,-60.0,-70.0,-71.0,-67.0,-60.0,-90.0,-93.0,-89.0,-92.0,20.0,21.0,21.0,32.0,0
2812,BA:8C:B9:54:50:24,3824500,487914596,4544,6122072,3819956,481792524,0,7821,1604412,7800,1601055,21,3357,2291,14,4919,35,0,50,229410.0,130000.0,-49.0,-35.0,-42.0,-44.0,-45.0,-37.0,-44.0,-48.0,-90.0,-93.0,-89.0,-92.0,41.0,58.0,47.0,48.0,0
2813,92:69:1D:31:68:E9,3823555,485296008,3593,3502958,3819962,481793050,0,3835,979984,3732,957014,103,22970,1904,6,3719,79,0,31,216660.0,130000.0,-51.0,-47.0,-42.0,-48.0,-52.0,-49.0,-44.0,-47.0,-90.0,-93.0,-89.0,-92.0,39.0,46.0,47.0,44.0,0
2814,CC:2F:71:3F:1F:24,4426036,1171982699,606074,690189649,3819962,481793050,37,502520,559345862,501938,559275710,582,70152,484850,10,606311,51458,34,432,130000.0,39000.0,-68.0,-66.0,-72.0,-68.0,-68.0,-66.0,-71.0,-67.0,-90.0,-93.0,-89.0,-92.0,22.0,27.0,17.0,24.0,0
2815,CC:2F:71:3E:C5:1F,3820672,481879821,710,86771,3819962,481793050,0,3011,252425,2491,190621,520,61804,752,8,1041,18,0,32,130000.0,39000.0,-70.0,-71.0,-67.0,-60.0,-70.0,-71.0,-67.0,-60.0,-90.0,-93.0,-89.0,-92.0,20.0,22.0,22.0,32.0,0
2816,BA:8C:B9:54:50:24,3824506,487915122,4544,6122072,3819962,481793050,0,7822,1604480,7801,1601123,21,3357,2291,14,4919,35,0,50,229410.0,130000.0,-40.0,-36.0,-44.0,-51.0,-44.0,-36.0,-44.0,-48.0,-90.0,-93.0,-89.0,-92.0,50.0,57.0,45.0,41.0,0
2817,92:69:1D:31:68:E9,3823557,485296210,3593,3502958,3819964,481793252,0,3835,979984,3732,957014,103,22970,1904,6,3719,79,0,31,216660.0,130000.0,-51.0,-47.0,-42.0,-48.0,-52.0,-49.0,-44.0,-47.0,-90.0,-92.0,-89.0,-92.0,39.0,45.0,47.0,44.0,0
2818,CC:2F:71:3F:1F:24,4426079,1171997205,606115,690203953,3819964,481793252,37,502549,559351226,501967,559281074,582,70152,484879,10,606352,51471,34,432,130000.0,39000.0,-71.0,-67.0,-74.0,-71.0,-70.0,-67.0,-74.0,-71.0,-90.0,-92.0,-89.0,-92.0,19.0,25.0,15.0,21.0,0
2819,CC:2F:71:3E:C5:1F,3820676,481880225,710,86771,3819966,481793454,0,3011,252425,2491,190621,520,61804,752,8,1041,18,0,32,130000.0,39000.0,-70.0,-71.0,-67.0,-60.0,-70.0,-71.0,-67.0,-60.0,-90.0,-92.0,-89.0,-92.0,20.0,21.0,22.0,32.0,0
2820,BA:8C:B9:54:50:24,3824510,487915526,4544,6122072,3819966,481793454,0,7822,1604480,7801,1601123,21,3357,2291,14,4919,35,0,50,229410.0,130000.0,-40.0,-36.0,-44.0,-51.0,-44.0,-36.0,-44.0,-48.0,-90.0,-92.0,-89.0,-92.0,50.0,56.0,45.0,41.0,0
2821,92:69:1D:31:68:E9,3823563,485296816,3593,3502958,3819970,481793858,0,3835,979984,3732,957014,103,22970,1904,6,3719,79,0,31,216660.0,130000.0,-51.0,-47.0,-42.0,-48.0,-52.0,-49.0,-44.0,-47.0,-90.0,-92.0,-89.0,-92.0,39.0,45.0,47.0,44.0,0
2822,CC:2F:71:3F:1F:24,4426128,1172012363,606158,690218505,3819970,481793858,37,502578,559356566,501996,559286414,582,70152,484908,10,606395,51485,34,432,130000.0,43333.0,-71.0,-67.0,-74.0,-71.0,-69.0,-66.0,-72.0,-68.0,-90.0,-92.0,-89.0,-92.0,19.0,25.0,15.0,21.0,0
2823,CC:2F:71:3E:C5:1F,3820681,481880689,710,86771,3819971,481793918,0,3011,252425,2491,190621,520,61804,752,8,1041,18,0,32,130000.0,39000.0,-70.0,-71.0,-67.0,-60.0,-70.0,-71.0,-67.0,-60.0,-90.0,-92.0,-89.0,-92.0,20.0,21.0,22.0,32.0,0
2824,BA:8C:B9:54:50:24,3824515,487915990,4544,6122072,3819971,481793918,0,7822,1604480,7801,1601123,21,3357,2291,14,4919,35,0,50,229410.0,130000.0,-40.0,-36.0,-44.0,-51.0,-44.0,-36.0,-44.0,-48.0,-90.0,-92.0,-89.0,-92.0,50.0,56.0,45.0,41.0,0
2825,92:69:1D:31:68:E9,3823566,485297078,3593,3502958,3819973,481794120,0,3835,979984,3732,957014,103,22970,1904,6,3719,79,0,31,216660.0,130000.0,-51.0,-47.0,-42.0,-48.0,-52.0,-49.0,-44.0,-47.0,-90.0,-92.0,-89.0,-92.0,39.0,45.0,47.0,44.0,0
2826,CC:2F:71:3F:1F:24,4426172,1172026873,606199,690232753,3819973,481794120,37,502603,559361370,502021,559291218,582,70152,484933,10,606436,51505,34,432,117000.0,39000.0,-67.0,-65.0,-71.0,-64.0,-67.0,-65.0,-70.0,-63.0,-90.0,-92.0,-89.0,-92.0,23.0,27.0,18.0,28.0,0
2827,CC:2F:71:3E:C5:1F,3820685,481881093,710,86771,3819975,481794322,0,3011,252425,2491,190621,520,61804,752,8,1041,18,0,32,130000.0,39000.0,-70.0,-71.0,-67.0,-60.0,-70.0,-71.0,-67.0,-60.0,-90.0,-92.0,-89.0,-92.0,20.0,21.0,22.0,32.0,0
2828,BA:8C:B9:54:50:24,3824519,487916394,4544,6122072,3819975,481794322,0,7822,1604480,7801,1601123,21,3357,2291,14,4919,35,0,50,229410.0,130000.0,-40.0,-36.0,-44.0,-51.0,-44.0,-36.0,-44.0,-48.0,-90.0,-93.0,-89.0,-92.0,50.0,57.0,45.0,41.0,0
2829,92:69:1D:31:68:E9,3823572,485297684,3593,3502958,3819979,481794726,0,3835,979984,3732,957014,103,22970,1904,6,3719,79,0,31,216660.0,130000.0,-51.0,-47.0,-42.0,-48.0,-52.0,-49.0,-44.0,-47.0,-90.0,-93.0,-89.0,-92.0,39.0,46.0,47.0,44.0,0
2830,CC:2F:71:3F:1F:24,4426221,1172042031,606242,690247305,3819979,481794726,37,502629,559366314,502047,559296162,582,70152,484959,10,606479,51507,34,432,130000.0,43333.0,-67.0,-65.0,-70.0,-68.0,-67.0,-65.0,-70.0,-68.0,-90.0,-93.0,-89.0,-92.0,23.0,28.0,19.0,24.0,0
2831,CC:2F:71:3E:C5:1F,3820689,481881497,710,86771,3819979,481794726,0,3011,252425,2491,190621,520,61804,752,8,1041,18,0,32,130000.0,39000.0,-70.0,-71.0,-67.0,-60.0,-70.0,-71.0,-67.0,-60.0,-90.0,-93.0,-89.0,-92.0,20.0,22.0,22.0,32.0,0
2832,BA:8C:B9:54:50:24,3824523,487916798,4544,6122072,3819979,481794726,0,7822,1604480,7801,1601123,21,3357,2291,14,4919,35,0,50,229410.0,130000.0,-40.0,-36.0,-44.0,-51.0,-44.0,-36.0,-44.0,-48.0,-90.0,-93.0,-89.0,-92.0,50.0,57.0,45.0,41.0,0
2833,92:69:1D:31:68:E9,3823575,485297946,3593,3502958,3819982,481794988,0,3835,979984,3732,957014,103,22970,1904,6,3719,79,0,31,216660.0,130000.0,-51.0,-47.0,-42.0,-48.0,-52.0,-49.0,-44.0,-47.0,-90.0,-93.0,-89.0,-92.0,39.0,46.0,47.0,44.0,0
2834,CC:2F:71:3F:1F:24,4426269,1172057475,606287,690262487,3819982,481794988,37,502657,559371548,502075,559301396,582,70152,484987,10,606524,51525,34,432,117000.0,39000.0,-67.0,-65.0,-71.0,-68.0,-67.0,-65.0,-70.0,-68.0,-90.0,-93.0,-89.0,-92.0,23.0,28.0,18.0,24.0,0
2835,CC:2F:71:3E:C5:1F,3820693,481881893,710,86771,3819983,481795122,0,3011,252425,2491,190621,520,61804,752,8,1041,18,0,32,130000.0,39000.0,-70.0,-71.0,-67.0,-60.0,-70.0,-71.0,-67.0,-60.0,-90.0,-93.0,-89.0,-92.0,20.0,22.0,22.0,32.0,0
2836,BA:8C:B9:54:50:24,3824528,487917262,4544,6122072,3819984,481795190,0,7822,1604480,7801,1601123,21,3357,2291,14,4919,35,0,50,229410.0,130000.0,-40.0,-36.0,-44.0,-51.0,-44.0,-36.0,-44.0,-48.0,-90.0,-93.0,-89.0,-92.0,50.0,57.0,45.0,41.0,0
2837,92:69:1D:31:68:E9,3823581,485298552,3593,3502958,3819988,481795594,0,3835,979984,3732,957014,103,22970,1904,6,3719,79,0,31,216660.0,130000.0,-51.0,-47.0,-42.0,-48.0,-52.0,-49.0,-44.0,-47.0,-90.0,-92.0,-89.0,-92.0,39.0,45.0,47.0,44.0,0
2838,CC:2F:71:3F:1F:24,4426318,1172072633,606330,690277039,3819988,481795594,37,502684,559376632,502102,559306480,582,70152,485014,10,606567,51527,34,432,130000.0,43333.0,-67.0,-65.0,-70.0,-68.0,-67.0,-65.0,-70.0,-68.0,-90.0,-92.0,-89.0,-92.0,23.0,27.0,19.0,24.0,0
2839,CC:2F:71:3E:C5:1F,3820698,481882365,710,86771,3819988,481795594,0,3011,252425,2491,190621,520,61804,752,8,1041,18,0,32,130000.0,39000.0,-70.0,-71.0,-67.0,-60.0,-70.0,-71.0,-67.0,-60.0,-90.0,-92.0,-89.0,-92.0,20.0,21.0,22.0,32.0,0
2840,BA:8C:B9:54:50:24,3824532,487917666,4544,6122072,3819988,481795594,0,7822,1604480,7801,1601123,21,3357,2291,14,4919,35,0,50,229410.0,130000.0,-40.0,-36.0,-44.0,-51.0,-44.0,-36.0,-44.0,-48.0,-90.0,-92.0,-89.0,-92.0,50.0,56.0,45.0,41.0,0
2841,92:69:1D:31:68:E9,3823583,485298754,3593,3502958,3819990,481795796,0,3835,979984,3732,957014,103,22970,1904,6,3719,79,0,31,216660.0,130000.0,-51.0,-47.0,-42.0,-48.0,-52.0,-49.0,-44.0,-47.0,-90.0,-92.0,-89.0,-92.0,39.0,45.0,47.0,44.0,0
2842,CC:2F:71:3F:1F:24,4426363,1172087499,606373,690291703,3819990,481795796,37,502711,559381692,502129,559311540,582,70152,485041,10,606610,51535,34,432,130000.0,43333.0,-67.0,-66.0,-71.0,-68.0,-67.0,-65.0,-70.0,-67.0,-90.0,-92.0,-89.0,-92.0,23.0,26.0,18.0,24.0,0
2843,CC:2F:71:3E:C5:1F,3820700,481882567,710,86771,3819990,481795796,0,3011,252425,2491,190621,520,61804,752,8,1041,18,0,32,130000.0,39000.0,-70.0,-71.0,-67.0,-60.0,-70.0,-71.0,-67.0,-60.0,-90.0,-92.0,-89.0,-92.0,20.0,21.0,22.0,32.0,0
2844,BA:8C:B9:54:50:24,3824536,487918070,4544,6122072,3819992,481795998,0,7822,1604480,7801,1601123,21,3357,2291,14,4919,35,0,50,229410.0,130000.0,-40.0,-36.0,-44.0,-51.0,-44.0,-36.0,-44.0,-48.0,-90.0,-92.0,-89.0,-92.0,50.0,56.0,45.0,41.0,0
2845,92:69:1D:31:68:E9,3823591,485299546,3593,3502958,3819998,481796588,0,3835,979984,3732,957014,103,22970,1904,6,3719,79,0,31,216660.0,130000.0,-51.0,-47.0,-42.0,-48.0,-52.0,-49.0,-44.0,-47.0,-90.0,-92.0,-89.0,-92.0,39.0,45.0,47.0,44.0,0
2846,CC:2F:71:3F:1F:24,4426412,1172102589,606414,690306001,3819998,481796588,37,502737,559386636,502155,559316484,582,70152,485067,10,606651,51555,34,432,117000.0,39000.0,-67.0,-65.0,-70.0,-67.0,-67.0,-65.0,-70.0,-67.0,-90.0,-92.0,-89.0,-92.0,23.0,27.0,19.0,25.0,0
2847,CC:2F:71:3E:C5:1F,3820708,481883359,710,86771,3819998,481796588,0,3011,252425,2491,190621,520,61804,752,8,1041,18,0,32,130000.0,39000.0,-70.0,-71.0,-67.0,-60.0,-70.0,-71.0,-67.0,-60.0,-90.0,-92.0,-89.0,-92.0,20.0,21.0,22.0,32.0,0
2848,BA:8C:B9:54:50:24,3824542,487918660,4544,6122072,3819998,481796588,0,7822,1604480,7801,1601123,21,3357,2291,14,4919,35,0,50,229410.0,130000.0,-40.0,-36.0,-44.0,-51.0,-44.0,-36.0,-44.0,-48.0,-90.0,-92.0,-89.0,-92.0,50.0,56.0,45.0,41.0,0
2849,92:69:1D:31:68:E9,3823594,485299810,3593,3502958,3820001,481796852,0,3835,979984,3732,957014,103,22970,1904,6,3719,79,0,31,216660.0,130000.0,-51.0,-47.0,-42.0,-48.0,-52.0,-49.0,-44.0,-47.0,-90.0,-92.0,-89.0,-92.0,39.0,45.0,47.0,44.0,0
2850,CC:2F:71:3F:1F:24,4426459,1172117417,606458,690320565,3820001,481796852,37,502765,559391814,502182,559321544,583,70270,485095,10,606695,51566,34,432,117000.0,39000.0,-67.0,-65.0,-70.0,-68.0,-67.0,-65.0,-70.0,-67.0,-90.0,-92.0,-89.0,-92.0,23.0,27.0,19.0,24.0,0
2851,CC:2F:71:3E:C5:1F,3820711,481883623,710,86771,3820001,481796852,0,3011,252425,2491,190621,520,61804,752,8,1041,18,0,32,130000.0,39000.0,-70.0,-71.0,-67.0,-60.0,-70.0,-71.0,-67.0,-60.0,-90.0,-92.0,-89.0,-92.0,20.0,21.0,22.0,32.0,0
2852,BA:8C:B9:54:50:24,3824547,487919126,4544,6122072,3820003,481797054,0,7822,1604480,7801,1601123,21,3357,2291,14,4919,35,0,50,229410.0,130000.0,-40.0,-36.0,-44.0,-51.0,-44.0,-36.0,-44.0,-48.0,-90.0,-92.0,-89.0,-92.0,50.0,56.0,45.0,41.0,0
2853,92:69:1D:31:68:E9,3823600,485300416,3593,3502958,3820007,481797458,0,3835,979984,3732,957014,103,22970,1904,6,3719,79,0,31,216660.0,130000.0,-51.0,-47.0,-42.0,-48.0,-52.0,-49.0,-44.0,-47.0,-90.0,-92.0,-89.0,-92.0,39.0,45.0,47.0,44.0,0
2854,CC:2F:71:3F:1F:24,4426508,1172132511,606500,690334993,3820008,481797518,37,502792,559396874,502209,559326604,583,70270,485122,10,606737,51570,34,432,130000.0,43333.0,-67.0,-65.0,-71.0,-68.0,-67.0,-65.0,-70.0,-67.0,-90.0,-92.0,-89.0,-92.0,23.0,27.0,18.0,24.0,0
2855,CC:2F:71:3E:C5:1F,3820718,481884289,710,86771,3820008,481797518,0,3011,252425,2491,190621,520,61804,752,8,1041,18,0,32,130000.0,39000.0,-70.0,-71.0,-67.0,-60.0,-70.0,-71.0,-67.0,-60.0,-90.0,-92.0,-89.0,-92.0,20.0,21.0,22.0,32.0,0
2856,BA:8C:B9:54:50:24,3824552,487919590,4544,6122072,3820008,481797518,0,7822,1604480,7801,1601123,21,3357,2291,14,4919,35,0,50,229410.0,130000.0,-40.0,-36.0,-44.0,-51.0,-44.0,-36.0,-44.0,-48.0,-90.0,-92.0,-89.0,-92.0,50.0,56.0,45.0,41.0,0
2857,92:69:1D:31:68:E9,3823603,485300678,3593,3502958,3820010,481797720,0,3835,979984,3732,957014,103,22970,1904,6,3719,79,0,31,216660.0,130000.0,-51.0,-47.0,-42.0,-48.0,-52.0,-49.0,-44.0,-47.0,-90.0,-92.0,-89.0,-92.0,39.0,45.0,47.0,44.0,0
2858,CC:2F:71:3F:1F:24,4426553,1172147377,606543,690349657,3820010,481797720,37,502818,559401818,502235,559331548,583,70270,485148,10,606780,51575,34,432,130000.0,43333.0,-67.0,-65.0,-70.0,-68.0,-67.0,-65.0,-70.0,-67.0,-90.0,-92.0,-89.0,-92.0,23.0,27.0,19.0,24.0,0
2859,CC:2F:71:3E:C5:1F,3820720,481884491,710,86771,3820010,481797720,0,3011,252425,2491,190621,520,61804,752,8,1041,18,0,32,130000.0,39000.0,-70.0,-71.0,-67.0,-60.0,-70.0,-71.0,-67.0,-60.0,-90.0,-92.0,-89.0,-92.0,20.0,21.0,22.0,32.0,0
2860,BA:8C:B9:54:50:24,3824554,487919792,4544,6122072,3820010,481797720,0,7822,1604480,7801,1601123,21,3357,2291,14,4919,35,0,50,229410.0,130000.0,-40.0,-36.0,-44.0,-51.0,-44.0,-36.0,-44.0,-48.0,-90.0,-92.0,-89.0,-92.0,50.0,56.0,45.0,41.0,0
2861,92:69:1D:31:68:E9,3823610,485301557,3593,3502958,3820017,481798599,0,3835,979984,3732,957014,103,22970,1904,6,3719,79,0,31,216660.0,130000.0,-51.0,-47.0,-42.0,-48.0,-52.0,-49.0,-44.0,-47.0,-90.0,-92.0,-89.0,-92.0,39.0,45.0,47.0,44.0,0
2862,CC:2F:71:3F:1F:24,4426603,1172162808,606586,690364209,3820017,481798599,37,502844,559406762,502261,559336492,583,70270,485174,10,606823,51606,34,432,144444.0,39000.0,-67.0,-65.0,-70.0,-67.0,-67.0,-65.0,-70.0,-67.0,-90.0,-92.0,-89.0,-92.0,23.0,27.0,19.0,25.0,0
2863,CC:2F:71:3E:C5:1F,3820727,481885370,710,86771,3820017,481798599,0,3011,252425,2491,190621,520,61804,752,8,1041,18,0,32,130000.0,39000.0,-70.0,-71.0,-67.0,-60.0,-70.0,-71.0,-67.0,-60.0,-90.0,-92.0,-89.0,-92.0,20.0,21.0,22.0,32.0,0
2864,BA:8C:B9:54:50:24,3824561,487920671,4544,6122072,3820017,481798599,0,7822,1604480,7801,1601123,21,3357,2291,14,4919,35,0,50,229410.0,130000.0,-40.0,-36.0,-44.0,-51.0,-44.0,-36.0,-44.0,-48.0,-90.0,-92.0,-89.0,-92.0,50.0,56.0,45.0,41.0,0
2865,92:69:1D:31:68:E9,3823613,485301819,3593,3502958,3820020,481798861,0,3835,979984,3732,957014,103,22970,1904,6,3719,79,0,31,216660.0,130000.0,-51.0,-47.0,-42.0,-48.0,-52.0,-49.0,-44.0,-47.0,-90.0,-92.0,-89.0,-92.0,39.0,45.0,47.0,44.0,0
2866,CC:2F:71:3F:1F:24,4426648,1172177498,606628,690378637,3820020,481798861,37,502869,559411566,502286,559341296,583,70270,485199,10,606865,51615,34,432,130000.0,43333.0,-67.0,-65.0,-71.0,-68.0,-67.0,-65.0,-70.0,-67.0,-90.0,-92.0,-89.0,-92.0,23.0,27.0,18.0,24.0,0
2867,CC:2F:71:3E:C5:1F,3820730,481885632,710,86771,3820020,481798861,0,3011,252425,2491,190621,520,61804,752,8,1041,18,0,32,130000.0,39000.0,-70.0,-71.0,-67.0,-60.0,-70.0,-71.0,-67.0,-60.0,-90.0,-92.0,-89.0,-92.0,20.0,21.0,22.0,32.0,0
2868,BA:8C:B9:54:50:24,3824564,487920933,4544,6122072,3820020,481798861,0,7822,1604480,7801,1601123,21,3357,2291,14,4919,35,0,50,229410.0,130000.0,-40.0,-36.0,-44.0,-51.0,-44.0,-36.0,-44.0,-48.0,-90.0,-92.0,-89.0,-92.0,50.0,56.0,45.0,41.0,0
2869,92:69:1D:31:68:E9,3823619,485302425,3593,3502958,3820026,481799467,0,3835,979984,3732,957014,103,22970,1904,6,3719,79,0,31,216660.0,130000.0,-51.0,-47.0,-42.0,-48.0,-52.0,-49.0,-44.0,-47.0,-90.0,-93.0,-90.0,-93.0,39.0,46.0,48.0,45.0,0
2870,CC:2F:71:3F:1F:24,4426697,1172192656,606671,690393189,3820026,481799467,37,502896,559416626,502313,559346356,583,70270,485226,10,606908,51639,34,432,117000.0,39000.0,-67.0,-65.0,-70.0,-67.0,-67.0,-65.0,-70.0,-67.0,-90.0,-93.0,-90.0,-93.0,23.0,28.0,20.0,26.0,0
2871,CC:2F:71:3E:C5:1F,3820736,481886238,710,86771,3820026,481799467,0,3011,252425,2491,190621,520,61804,752,8,1041,18,0,32,130000.0,39000.0,-70.0,-71.0,-67.0,-60.0,-70.0,-71.0,-67.0,-60.0,-90.0,-93.0,-90.0,-93.0,20.0,22.0,23.0,33.0,0
2872,BA:8C:B9:54:50:24,3824570,487921539,4544,6122072,3820026,481799467,0,7822,1604480,7801,1601123,21,3357,2291,14,4919,35,0,50,229410.0,130000.0,-40.0,-36.0,-44.0,-51.0,-44.0,-36.0,-44.0,-48.0,-90.0,-93.0,-90.0,-93.0,50.0,57.0,46.0,42.0,0
2873,92:69:1D:31:68:E9,3823621,485302627,3593,3502958,3820028,481799669,0,3835,979984,3732,957014,103,22970,1904,6,3719,79,0,31,216660.0,130000.0,-51.0,-47.0,-42.0,-48.0,-52.0,-49.0,-44.0,-47.0,-90.0,-93.0,-90.0,-93.0,39.0,46.0,48.0,45.0,0
2874,CC:2F:71:3F:1F:24,4426741,1172207286,606713,690407617,3820028,481799669,37,502921,559421430,502338,559351160,583,70270,485251,10,606949,51644,34,432,130000.0,43333.0,-67.0,-65.0,-71.0,-68.0,-67.0,-65.0,-70.0,-67.0,-90.0,-93.0,-90.0,-93.0,23.0,28.0,19.0,25.0,0
2875,CC:2F:71:3E:C5:1F,3820738,481886440,710,86771,3820028,481799669,0,3011,252425,2491,190621,520,61804,752,8,1041,18,0,32,130000.0,39000.0,-70.0,-71.0,-67.0,-60.0,-70.0,-71.0,-67.0,-60.0,-90.0,-93.0,-90.0,-93.0,20.0,22.0,23.0,33.0,0
2876,BA:8C:B9:54:50:24,3824572,487921741,4544,6122072,3820028,481799669,0,7822,1604480,7801,1601123,21,3357,2291,14,4919,35,0,50,229410.0,130000.0,-40.0,-36.0,-44.0,-51.0,-44.0,-36.0,-44.0,-48.0,-90.0,-93.0,-90.0,-93.0,50.0,57.0,46.0,42.0,0
2877,92:69:1D:31:68:E9,3823628,485303293,3593,3502958,3820035,481800335,0,3835,979984,3732,957014,103,22970,1904,6,3719,79,0,31,216660.0,130000.0,-51.0,-47.0,-42.0,-48.0,-52.0,-49.0,-44.0,-47.0,-90.0,-93.0,-90.0,-93.0,39.0,46.0,48.0,45.0,0
2878,CC:2F:71:3F:1F:24,4426791,1172222616,606756,690422281,3820035,481800335,37,502948,559426490,502365,559356220,583,70270,485278,10,606992,51654,34,432,130000.0,43333.0,-67.0,-65.0,-70.0,-68.0,-67.0,-65.0,-70.0,-67.0,-90.0,-93.0,-90.0,-93.0,23.0,28.0,20.0,25.0,0
2879,CC:2F:71:3E:C5:1F,3820745,481887106,710,86771,3820035,481800335,0,3011,252425,2491,190621,520,61804,752,8,1041,18,0,32,130000.0,39000.0,-70.0,-71.0,-67.0,-60.0,-70.0,-71.0,-67.0,-60.0,-90.0,-93.0,-90.0,-93.0,20.0,22.0,23.0,33.0,0
2880,BA:8C:B9:54:50:24,3824579,487922407,4544,6122072,3820035,481800335,0,7822,1604480,7801,1601123,21,3357,2291,14,4919,35,0,50,229410.0,130000.0,-40.0,-36.0,-44.0,-51.0,-44.0,-36.0,-44.0,-48.0,-90.0,-93.0,-90.0,-93.0,50.0,57.0,46.0,42.0,0
2881,92:69:1D:31:68:E9,3823630,485303495,3593,3502958,3820037,481800537,0,3835,979984,3732,957014,103,22970,1904,6,3719,79,0,31,216660.0,130000.0,-51.0,-47.0,-42.0,-48.0,-52.0,-49.0,-44.0,-47.0,-90.0,-93.0,-90.0,-93.0,39.0,46.0,48.0,45.0,0
2882,CC:2F:71:3F:1F:24,4426834,1172237178,606797,690436641,3820037,481800537,37,502973,559431294,502390,559361024,583,70270,485303,10,607034,51668,34,432,130000.0,39000.0,-67.0,-65.0,-70.0,-67.0,-67.0,-65.0,-70.0,-67.0,-90.0,-93.0,-90.0,-93.0,23.0,28.0,20.0,26.0,0
2883,CC:2F:71:3E:C5:1F,3820747,481887308,710,86771,3820037,481800537,0,3011,252425,2491,190621,520,61804,752,8,1041,18,0,32,130000.0,39000.0,-70.0,-71.0,-67.0,-60.0,-70.0,-71.0,-67.0,-60.0,-90.0,-93.0,-90.0,-93.0,20.0,22.0,23.0,33.0,0
2884,BA:8C:B9:54:50:24,3824581,487922609,4544,6122072,3820037,481800537,0,7822,1604480,7801,1601123,21,3357,2291,14,4919,35,0,50,229410.0,130000.0,-40.0,-36.0,-44.0,-51.0,-44.0,-36.0,-44.0,-48.0,-90.0,-93.0,-90.0,-93.0,50.0,57.0,46.0,42.0,0
2885,92:69:1D:31:68:E9,3823637,485304161,3593,3502958,3820044,481801203,0,3835,979984,3732,957014,103,22970,1904,6,3719,79,0,31,216660.0,130000.0,-51.0,-47.0,-42.0,-48.0,-52.0,-49.0,-44.0,-47.0,-90.0,-93.0,-90.0,-92.0,39.0,46.0,48.0,44.0,0
2886,CC:2F:71:3F:1F:24,4426886,1172252650,606842,690451447,3820044,481801203,37,502999,559436214,502416,559365944,583,70270,485329,10,607079,51692,34,432,130000.0,39000.0,-67.0,-65.0,-70.0,-68.0,-67.0,-65.0,-70.0,-67.0,-90.0,-93.0,-90.0,-92.0,23.0,28.0,20.0,24.0,0
2887,CC:2F:71:3E:C5:1F,3820754,481887974,710,86771,3820044,481801203,0,3011,252425,2491,190621,520,61804,752,8,1041,18,0,32,130000.0,39000.0,-70.0,-71.0,-67.0,-60.0,-70.0,-71.0,-67.0,-60.0,-90.0,-93.0,-90.0,-92.0,20.0,22.0,23.0,32.0,0
2888,BA:8C:B9:54:50:24,3824588,487923275,4544,6122072,3820044,481801203,0,7822,1604480,7801,1601123,21,3357,2291,14,4919,35,0,50,229410.0,130000.0,-40.0,-36.0,-44.0,-51.0,-44.0,-36.0,-44.0,-48.0,-90.0,-93.0,-90.0,-92.0,50.0,57.0,46.0,41.0,0
2889,92:69:1D:31:68:E9,3823639,485304363,3593,3502958,3820046,481801405,0,3835,979984,3732,957014,103,22970,1904,6,3719,79,0,31,216660.0,130000.0,-51.0,-47.0,-42.0,-48.0,-52.0,-49.0,-44.0,-47.0,-90.0,-93.0,-90.0,-92.0,39.0,46.0,48.0,44.0,0
2890,CC:2F:71:3F:1F:24,4426931,1172267348,606885,690465943,3820046,481801405,37,503027,559441414,502444,559371144,583,70270,485357,10,607122,51716,34,432,144444.0,39000.0,-67.0,-65.0,-70.0,-67.0,-67.0,-65.0,-70.0,-67.0,-90.0,-93.0,-90.0,-92.0,23.0,28.0,20.0,25.0,0
2891,CC:2F:71:3E:C5:1F,3820756,481888176,710,86771,3820046,481801405,0,3011,252425,2491,190621,520,61804,752,8,1041,18,0,32,130000.0,39000.0,-70.0,-71.0,-67.0,-60.0,-70.0,-71.0,-67.0,-60.0,-90.0,-93.0,-90.0,-92.0,20.0,22.0,23.0,32.0,0
2892,BA:8C:B9:54:50:24,3824592,487923679,4544,6122072,3820048,481801607,0,7822,1604480,7801,1601123,21,3357,2291,14,4919,35,0,50,229410.0,130000.0,-40.0,-36.0,-44.0,-51.0,-44.0,-36.0,-44.0,-48.0,-90.0,-93.0,-90.0,-92.0,50.0,57.0,46.0,41.0,0
2893,92:69:1D:31:68:E9,3823645,485304969,3593,3502958,3820052,481802011,0,3835,979984,3732,957014,103,22970,1904,6,3719,79,0,31,216660.0,130000.0,-51.0,-47.0,-42.0,-48.0,-52.0,-49.0,-44.0,-47.0,-90.0,-93.0,-90.0,-92.0,39.0,46.0,48.0,44.0,0
2894,CC:2F:71:3F:1F:24,4426979,1172282382,606927,690480371,3820052,481802011,37,503054,559446474,502471,559376204,583,70270,485384,10,607164,51746,34,432,130000.0,43333.0,-67.0,-65.0,-70.0,-68.0,-67.0,-65.0,-70.0,-67.0,-90.0,-93.0,-90.0,-92.0,23.0,28.0,20.0,24.0,0
2895,CC:2F:71:3E:C5:1F,3820762,481888782,710,86771,3820052,481802011,0,3011,252425,2491,190621,520,61804,752,8,1041,18,0,32,130000.0,39000.0,-70.0,-71.0,-67.0,-60.0,-70.0,-71.0,-67.0,-60.0,-90.0,-93.0,-90.0,-92.0,20.0,22.0,23.0,32.0,0
2896,BA:8C:B9:54:50:24,3824596,487924083,4544,6122072,3820052,481802011,0,7822,1604480,7801,1601123,21,3357,2291,14,4919,35,0,50,229410.0,130000.0,-40.0,-36.0,-44.0,-51.0,-44.0,-36.0,-44.0,-48.0,-90.0,-93.0,-90.0,-92.0,50.0,57.0,46.0,41.0,0
2897,92:69:1D:31:68:E9,3823648,485305231,3593,3502958,3820055,481802273,0,3836,980052,3733,957082,103,22970,1904,6,3719,79,0,31,216660.0,130000.0,-52.0,-50.0,-44.0,-46.0,-52.0,-49.0,-44.0,-47.0,-90.0,-93.0,-90.0,-92.0,38.0,43.0,46.0,46.0,0
2898,CC:2F:71:3F:1F:24,4427024,1172297184,606969,690494911,3820055,481802273,37,503080,559451418,502497,559381148,583,70270,485410,10,607206,51755,34,432,130000.0,43333.0,-67.0,-65.0,-70.0,-68.0,-67.0,-65.0,-70.0,-67.0,-90.0,-93.0,-90.0,-92.0,23.0,28.0,20.0,24.0,0
2899,CC:2F:71:3E:C5:1F,3820765,481889044,710,86771,3820055,481802273,0,3011,252425,2491,190621,520,61804,752,8,1041,18,0,32,130000.0,39000.0,-70.0,-71.0,-67.0,-60.0,-70.0,-71.0,-67.0,-60.0,-90.0,-93.0,-90.0,-92.0,20.0,22.0,23.0,32.0,0
2900,BA:8C:B9:54:50:24,3824601,487924547,4544,6122072,3820057,481802475,0,7822,1604480,7801,1601123,21,3357,2291,14,4919,35,0,50,229410.0,130000.0,-40.0,-36.0,-44.0,-51.0,-44.0,-36.0,-44.0,-48.0,-90.0,-93.0,-90.0,-92.0,50.0,57.0,46.0,41.0,0
2901,92:69:1D:31:68:E9,3823654,485305837,3593,3502958,3820061,481802879,0,3836,980052,3733,957082,103,22970,1904,6,3719,79,0,31,216660.0,130000.0,-52.0,-50.0,-44.0,-46.0,-52.0,-49.0,-44.0,-47.0,-90.0,-93.0,-90.0,-92.0,38.0,43.0,46.0,46.0,0
2902,CC:2F:71:3F:1F:24,4427072,1172312218,607011,690509339,3820061,481802879,37,503106,559456362,502523,559386092,583,70270,485436,10,607247,51775,34,432,117000.0,39000.0,-67.0,-65.0,-70.0,-67.0,-67.0,-65.0,-70.0,-67.0,-90.0,-93.0,-90.0,-92.0,23.0,28.0,20.0,25.0,0
2903,CC:2F:71:3E:C5:1F,3820771,481889650,710,86771,3820061,481802879,0,3011,252425,2491,190621,520,61804,752,8,1041,18,0,32,130000.0,39000.0,-70.0,-71.0,-67.0,-60.0,-70.0,-71.0,-67.0,-60.0,-90.0,-93.0,-90.0,-92.0,20.0,22.0,23.0,32.0,0
2904,BA:8C:B9:54:50:24,3824605,487924951,4544,6122072,3820061,481802879,0,7822,1604480,7801,1601123,21,3357,2291,14,4919,35,0,50,229410.0,130000.0,-40.0,-36.0,-44.0,-51.0,-44.0,-36.0,-44.0,-48.0,-90.0,-93.0,-90.0,-92.0,50.0,57.0,46.0,41.0,0
2905,92:69:1D:31:68:E9,3823656,485306039,3593,3502958,3820063,481803081,0,3836,980052,3733,957082,103,22970,1904,6,3719,79,0,31,216660.0,130000.0,-52.0,-50.0,-44.0,-46.0,-52.0,-49.0,-44.0,-47.0,-90.0,-93.0,-90.0,-92.0,38.0,43.0,46.0,46.0,0
2906,CC:2F:71:3F:1F:24,4427119,1172327162,607055,690524021,3820064,481803141,37,503131,559461166,502548,559390896,583,70270,485461,10,607292,51778,34,432,130000.0,43333.0,-67.0,-65.0,-71.0,-67.0,-67.0,-65.0,-70.0,-67.0,-90.0,-93.0,-90.0,-92.0,23.0,28.0,19.0,25.0,0
2907,CC:2F:71:3E:C5:1F,3820774,481889912,710,86771,3820064,481803141,0,3011,252425,2491,190621,520,61804,752,8,1041,18,0,32,130000.0,39000.0,-70.0,-71.0,-67.0,-60.0,-70.0,-71.0,-67.0,-60.0,-90.0,-93.0,-90.0,-92.0,20.0,22.0,23.0,32.0,0
2908,BA:8C:B9:54:50:24,3824610,487925415,4544,6122072,3820066,481803343,0,7822,1604480,7801,1601123,21,3357,2291,14,4919,35,0,50,229410.0,130000.0,-40.0,-36.0,-44.0,-51.0,-44.0,-36.0,-44.0,-48.0,-90.0,-93.0,-90.0,-92.0,50.0,57.0,46.0,41.0,0
2909,92:69:1D:31:68:E9,3823664,485306821,3594,3503074,3820070,481803747,0,3838,980188,3735,957218,103,22970,1904,6,3720,79,0,31,216660.0,130000.0,-52.0,-50.0,-44.0,-46.0,-51.0,-49.0,-43.0,-46.0,-90.0,-93.0,-90.0,-92.0,38.0,43.0,46.0,46.0,0
2910,CC:2F:71:3F:1F:24,4427167,1172342244,607097,690538497,3820070,481803747,37,503158,559466226,502575,559395956,583,70270,485488,10,607334,51807,34,432,130000.0,39000.0,-67.0,-65.0,-70.0,-67.0,-67.0,-65.0,-70.0,-67.0,-90.0,-93.0,-90.0,-92.0,23.0,28.0,20.0,25.0,0
2911,CC:2F:71:3E:C5:1F,3820781,481890634,711,86887,3820070,481803747,0,3013,252565,2493,190761,520,61804,752,8,1042,18,0,32,130000.0,39000.0,-70.0,-71.0,-67.0,-60.0,-70.0,-71.0,-67.0,-60.0,-90.0,-93.0,-90.0,-92.0,20.0,22.0,23.0,32.0,0
2912,BA:8C:B9:54:50:24,3824615,487925935,4545,6122188,3820070,481803747,0,7824,1604616,7803,1601259,21,3357,2291,14,4920,35,0,50,229410.0,130000.0,-51.0,-34.0,-43.0,-43.0,-44.0,-36.0,-43.0,-47.0,-90.0,-93.0,-90.0,-92.0,39.0,59.0,47.0,49.0,0
2913,92:69:1D:31:68:E9,3823667,485307296,3594,3503074,3820073,481804222,0,3838,980188,3735,957218,103,22970,1904,6,3720,79,0,31,216660.0,130000.0,-52.0,-50.0,-44.0,-46.0,-51.0,-49.0,-43.0,-46.0,-90.0,-93.0,-90.0,-92.0,38.0,43.0,46.0,46.0,0
2914,CC:2F:71:3F:1F:24,4427213,1172357277,607140,690553055,3820073,481804222,37,503184,559471170,502601,559400900,583,70270,485514,10,607377,51817,34,432,130000.0,43333.0,-67.0,-65.0,-70.0,-68.0,-67.0,-65.0,-70.0,-67.0,-90.0,-93.0,-90.0,-92.0,23.0,28.0,20.0,24.0,0
2915,CC:2F:71:3E:C5:1F,3820784,481891109,711,86887,3820073,481804222,0,3013,252565,2493,190761,520,61804,752,8,1042,18,0,32,130000.0,39000.0,-70.0,-71.0,-67.0,-60.0,-70.0,-71.0,-67.0,-60.0,-90.0,-93.0,-90.0,-92.0,20.0,22.0,23.0,32.0,0
2916,BA:8C:B9:54:50:24,3824620,487926612,4545,6122188,3820075,481804424,0,7824,1604616,7803,1601259,21,3357,2291,14,4920,35,0,50,229410.0,130000.0,-51.0,-34.0,-43.0,-43.0,-44.0,-36.0,-43.0,-47.0,-90.0,-93.0,-90.0,-92.0,39.0,59.0,47.0,49.0,0
2917,92:69:1D:31:68:E9,3823674,485307962,3594,3503074,3820080,481804888,0,3838,980188,3735,957218,103,22970,1904,6,3720,79,0,31,216660.0,130000.0,-52.0,-50.0,-44.0,-46.0,-51.0,-49.0,-43.0,-46.0,-90.0,-93.0,-90.0,-92.0,38.0,43.0,46.0,46.0,0
2918,CC:2F:71:3F:1F:24,4427260,1172372061,607180,690567173,3820080,481804888,37,503210,559476114,502627,559405844,583,70270,485540,10,607417,51842,34,432,117000.0,39000.0,-67.0,-65.0,-70.0,-67.0,-67.0,-65.0,-70.0,-67.0,-90.0,-93.0,-90.0,-92.0,23.0,28.0,20.0,25.0,0
2919,CC:2F:71:3E:C5:1F,3820791,481891775,711,86887,3820080,481804888,0,3013,252565,2493,190761,520,61804,752,8,1042,18,0,32,130000.0,39000.0,-70.0,-71.0,-67.0,-60.0,-70.0,-71.0,-67.0,-60.0,-90.0,-93.0,-90.0,-92.0,20.0,22.0,23.0,32.0,0
2920,BA:8C:B9:54:50:24,3824625,487927076,4545,6122188,3820080,481804888,0,7824,1604616,7803,1601259,21,3357,2291,14,4920,35,0,50,229410.0,130000.0,-51.0,-34.0,-43.0,-43.0,-44.0,-36.0,-43.0,-47.0,-90.0,-93.0,-90.0,-92.0,39.0,59.0,47.0,49.0,0
2921,92:69:1D:31:68:E9,3823676,485308164,3594,3503074,3820082,481805090,0,3838,980188,3735,957218,103,22970,1904,6,3720,79,0,31,216660.0,130000.0,-52.0,-50.0,-44.0,-46.0,-51.0,-49.0,-43.0,-46.0,-90.0,-93.0,-90.0,-93.0,38.0,43.0,46.0,47.0,0
2922,CC:2F:71:3F:1F:24,4427306,1172386939,607224,690581849,3820082,481805090,37,503236,559481058,502653,559410788,583,70270,485566,10,607461,51844,34,432,130000.0,43333.0,-67.0,-65.0,-70.0,-68.0,-67.0,-65.0,-70.0,-67.0,-90.0,-93.0,-90.0,-93.0,23.0,28.0,20.0,25.0,0
2923,CC:2F:71:3E:C5:1F,3820793,481891977,711,86887,3820082,481805090,0,3013,252565,2493,190761,520,61804,752,8,1042,18,0,32,130000.0,39000.0,-70.0,-71.0,-67.0,-60.0,-70.0,-71.0,-67.0,-60.0,-90.0,-93.0,-90.0,-93.0,20.0,22.0,23.0,33.0,0
2924,BA:8C:B9:54:50:24,3824628,487927412,4545,6122188,3820083,481805224,0,7824,1604616,7803,1601259,21,3357,2291,14,4920,35,0,50,229410.0,130000.0,-51.0,-34.0,-43.0,-43.0,-44.0,-36.0,-43.0,-47.0,-90.0,-93.0,-90.0,-93.0,39.0,59.0,47.0,50.0,0
2925,92:69:1D:31:68:E9,3823684,485309138,3594,3503074,3820090,481806064,0,3838,980188,3735,957218,103,22970,1904,6,3720,79,0,31,216660.0,130000.0,-52.0,-50.0,-44.0,-46.0,-51.0,-49.0,-43.0,-46.0,-90.0,-93.0,-90.0,-93.0,38.0,43.0,46.0,47.0,0
2926,CC:2F:71:3F:1F:24,4427357,1172402577,607267,690596513,3820090,481806064,37,503262,559486002,502679,559415732,583,70270,485592,10,607504,51851,34,432,130000.0,39000.0,-67.0,-65.0,-70.0,-68.0,-67.0,-65.0,-70.0,-67.0,-90.0,-93.0,-90.0,-93.0,23.0,28.0,20.0,25.0,0
2927,CC:2F:71:3E:C5:1F,3820801,481892951,711,86887,3820090,481806064,0,3013,252565,2493,190761,520,61804,752,8,1042,18,0,32,130000.0,39000.0,-70.0,-71.0,-67.0,-60.0,-70.0,-71.0,-67.0,-60.0,-90.0,-93.0,-90.0,-93.0,20.0,22.0,23.0,33.0,0
2928,BA:8C:B9:54:50:24,3824635,487928252,4545,6122188,3820090,481806064,0,7824,1604616,7803,1601259,21,3357,2291,14,4920,35,0,50,229410.0,130000.0,-51.0,-34.0,-43.0,-43.0,-44.0,-36.0,-43.0,-47.0,-90.0,-93.0,-90.0,-93.0,39.0,59.0,47.0,50.0,0
2929,92:69:1D:31:68:E9,3823687,485309400,3594,3503074,3820093,481806326,0,3838,980188,3735,957218,103,22970,1904,6,3720,79,0,31,216660.0,130000.0,-52.0,-50.0,-44.0,-46.0,-51.0,-49.0,-43.0,-46.0,-90.0,-93.0,-90.0,-93.0,38.0,43.0,46.0,47.0,0
2930,CC:2F:71:3F:1F:24,4427402,1172417217,607309,690610891,3820093,481806326,37,503288,559490946,502705,559420676,583,70270,485618,10,607546,51871,34,432,130000.0,39000.0,-67.0,-65.0,-70.0,-68.0,-67.0,-65.0,-70.0,-67.0,-90.0,-93.0,-90.0,-93.0,23.0,28.0,20.0,25.0,0
2931,CC:2F:71:3E:C5:1F,3820804,481893213,711,86887,3820093,481806326,0,3013,252565,2493,190761,520,61804,752,8,1042,18,0,32,130000.0,39000.0,-70.0,-71.0,-67.0,-60.0,-70.0,-71.0,-67.0,-60.0,-90.0,-93.0,-90.0,-93.0,20.0,22.0,23.0,33.0,0
2932,BA:8C:B9:54:50:24,3824638,487928514,4545,6122188,3820093,481806326,0,7824,1604616,7803,1601259,21,3357,2291,14,4920,35,0,50,229410.0,130000.0,-51.0,-34.0,-43.0,-43.0,-44.0,-36.0,-43.0,-47.0,-90.0,-93.0,-90.0,-93.0,39.0,59.0,47.0,50.0,0
2933,92:69:1D:31:68:E9,3823693,485310006,3594,3503074,3820099,481806932,0,3838,980188,3735,957218,103,22970,1904,6,3720,79,0,31,216660.0,130000.0,-52.0,-50.0,-44.0,-46.0,-51.0,-49.0,-43.0,-46.0,-90.0,-93.0,-90.0,-93.0,38.0,43.0,46.0,47.0,0
2934,CC:2F:71:3F:1F:24,4427451,1172432431,607352,690625499,3820099,481806932,37,503315,559496006,502732,559425736,583,70270,485645,10,607589,51878,34,432,130000.0,43333.0,-67.0,-65.0,-70.0,-67.0,-67.0,-65.0,-70.0,-67.0,-90.0,-93.0,-90.0,-93.0,23.0,28.0,20.0,26.0,0
2935,CC:2F:71:3E:C5:1F,3820810,481893819,711,86887,3820099,481806932,0,3013,252565,2493,190761,520,61804,752,8,1042,18,0,32,130000.0,39000.0,-70.0,-71.0,-67.0,-60.0,-70.0,-71.0,-67.0,-60.0,-90.0,-93.0,-90.0,-93.0,20.0,22.0,23.0,33.0,0
2936,BA:8C:B9:54:50:24,3824644,487929120,4545,6122188,3820099,481806932,0,7824,1604616,7803,1601259,21,3357,2291,14,4920,35,0,50,229410.0,130000.0,-51.0,-34.0,-43.0,-43.0,-44.0,-36.0,-43.0,-47.0,-90.0,-93.0,-90.0,-93.0,39.0,59.0,47.0,50.0,0
2937,92:69:1D:31:68:E9,3823697,485310330,3594,3503074,3820103,481807256,0,3838,980188,3735,957218,103,22970,1904,6,3720,79,0,31,216660.0,130000.0,-52.0,-50.0,-44.0,-46.0,-51.0,-49.0,-43.0,-46.0,-90.0,-93.0,-90.0,-93.0,38.0,43.0,46.0,47.0,0
2938,CC:2F:71:3F:1F:24,4427497,1172447245,607394,690639989,3820103,481807256,37,503341,559500928,502757,559430540,584,70388,485671,10,607631,51897,34,432,130000.0,39000.0,-67.0,-65.0,-70.0,-67.0,-67.0,-65.0,-70.0,-67.0,-90.0,-93.0,-90.0,-93.0,23.0,28.0,20.0,26.0,0
2939,CC:2F:71:3E:C5:1F,3820814,481894143,711,86887,3820103,481807256,0,3013,252565,2493,190761,520,61804,752,8,1042,18,0,32,130000.0,39000.0,-70.0,-71.0,-67.0,-60.0,-70.0,-71.0,-67.0,-60.0,-90.0,-93.0,-90.0,-93.0,20.0,22.0,23.0,33.0,0
2940,BA:8C:B9:54:50:24,3824648,487929444,4545,6122188,3820103,481807256,0,7824,1604616,7803,1601259,21,3357,2291,14,4920,35,0,50,229410.0,130000.0,-51.0,-34.0,-43.0,-43.0,-44.0,-36.0,-43.0,-47.0,-90.0,-93.0,-90.0,-93.0,39.0,59.0,47.0,50.0,0
2941,92:69:1D:31:68:E9,3823703,485310936,3594,3503074,3820109,481807862,0,3838,980188,3735,957218,103,22970,1904,6,3720,79,0,31,216660.0,130000.0,-52.0,-50.0,-44.0,-46.0,-51.0,-49.0,-43.0,-46.0,-90.0,-93.0,-90.0,-93.0,38.0,43.0,46.0,47.0,0
2942,CC:2F:71:3F:1F:24,4427547,1172462471,607438,690654609,3820109,481807862,37,503367,559505872,502783,559435484,584,70388,485697,10,607675,51907,34,432,130000.0,43333.0,-67.0,-65.0,-71.0,-67.0,-67.0,-65.0,-70.0,-67.0,-90.0,-93.0,-90.0,-93.0,23.0,28.0,19.0,26.0,0
2943,CC:2F:71:3E:C5:1F,3820820,481894749,711,86887,3820109,481807862,0,3013,252565,2493,190761,520,61804,752,8,1042,18,0,32,130000.0,39000.0,-70.0,-71.0,-67.0,-60.0,-70.0,-71.0,-67.0,-60.0,-90.0,-93.0,-90.0,-93.0,20.0,22.0,23.0,33.0,0
2944,BA:8C:B9:54:50:24,3824654,487930050,4545,6122188,3820109,481807862,0,7824,1604616,7803,1601259,21,3357,2291,14,4920,35,0,50,229410.0,130000.0,-51.0,-34.0,-43.0,-43.0,-44.0,-36.0,-43.0,-47.0,-90.0,-93.0,-90.0,-93.0,39.0,59.0,47.0,50.0,0
2945,92:69:1D:31:68:E9,3823705,485311138,3594,3503074,3820111,481808064,0,3838,980188,3735,957218,103,22970,1904,6,3720,79,0,31,216660.0,130000.0,-52.0,-50.0,-44.0,-46.0,-51.0,-49.0,-43.0,-46.0,-90.0,-93.0,-90.0,-93.0,38.0,43.0,46.0,47.0,0
2946,CC:2F:71:3F:1F:24,4427590,1172477089,607479,690669025,3820111,481808064,37,503392,559510676,502808,559440288,584,70388,485722,10,607716,51916,34,432,130000.0,43333.0,-67.0,-65.0,-70.0,-67.0,-67.0,-65.0,-70.0,-67.0,-90.0,-93.0,-90.0,-93.0,23.0,28.0,20.0,26.0,0
2947,CC:2F:71:3E:C5:1F,3820822,481894951,711,86887,3820111,481808064,0,3013,252565,2493,190761,520,61804,752,8,1042,18,0,32,130000.0,39000.0,-70.0,-71.0,-67.0,-60.0,-70.0,-71.0,-67.0,-60.0,-90.0,-93.0,-90.0,-93.0,20.0,22.0,23.0,33.0,0
2948,BA:8C:B9:54:50:24,3824656,487930252,4545,6122188,3820111,481808064,0,7824,1604616,7803,1601259,21,3357,2291,14,4920,35,0,50,229410.0,130000.0,-51.0,-34.0,-43.0,-43.0,-44.0,-36.0,-43.0,-47.0,-90.0,-93.0,-90.0,-93.0,39.0,59.0,47.0,50.0,0
2949,92:69:1D:31:68:E9,3823712,485311804,3594,3503074,3820118,481808730,0,3838,980188,3735,957218,103,22970,1904,6,3720,79,0,31,216660.0,130000.0,-52.0,-50.0,-44.0,-46.0,-51.0,-49.0,-43.0,-46.0,-90.0,-93.0,-90.0,-93.0,38.0,43.0,46.0,47.0,0
2950,CC:2F:71:3F:1F:24,4427640,1172492307,607522,690683577,3820118,481808730,37,503418,559515620,502834,559445232,584,70388,485748,10,607759,51929,34,432,117000.0,39000.0,-67.0,-65.0,-71.0,-67.0,-67.0,-65.0,-70.0,-67.0,-90.0,-93.0,-90.0,-93.0,23.0,28.0,19.0,26.0,0
2951,CC:2F:71:3E:C5:1F,3820829,481895617,711,86887,3820118,481808730,0,3013,252565,2493,190761,520,61804,752,8,1042,18,0,32,130000.0,39000.0,-70.0,-71.0,-67.0,-60.0,-70.0,-71.0,-67.0,-60.0,-90.0,-93.0,-90.0,-93.0,20.0,22.0,23.0,33.0,0
2952,BA:8C:B9:54:50:24,3824663,487930918,4545,6122188,3820118,481808730,0,7824,1604616,7803,1601259,21,3357,2291,14,4920,35,0,50,229410.0,130000.0,-51.0,-34.0,-43.0,-43.0,-44.0,-36.0,-43.0,-47.0,-90.0,-93.0,-90.0,-93.0,39.0,59.0,47.0,50.0,0
2953,92:69:1D:31:68:E9,3823714,485312006,3594,3503074,3820120,481808932,0,3838,980188,3735,957218,103,22970,1904,6,3720,79,0,31,216660.0,130000.0,-52.0,-50.0,-44.0,-46.0,-51.0,-49.0,-43.0,-46.0,-90.0,-92.0,-89.0,-92.0,38.0,42.0,45.0,46.0,0
2954,CC:2F:71:3F:1F:24,4427686,1172507191,607566,690698259,3820120,481808932,37,503445,559520680,502861,559450292,584,70388,485775,10,607802,51932,34,432,130000.0,43333.0,-67.0,-65.0,-70.0,-68.0,-67.0,-65.0,-70.0,-67.0,-90.0,-92.0,-89.0,-92.0,23.0,27.0,19.0,24.0,0
2955,CC:2F:71:3E:C5:1F,3820831,481895819,711,86887,3820120,481808932,0,3013,252565,2493,190761,520,61804,752,8,1042,18,0,32,130000.0,39000.0,-70.0,-71.0,-67.0,-60.0,-70.0,-71.0,-67.0,-60.0,-90.0,-92.0,-89.0,-92.0,20.0,21.0,22.0,32.0,0
2956,BA:8C:B9:54:50:24,3824665,487931120,4545,6122188,3820120,481808932,0,7824,1604616,7803,1601259,21,3357,2291,14,4920,35,0,50,229410.0,130000.0,-51.0,-34.0,-43.0,-43.0,-44.0,-36.0,-43.0,-47.0,-90.0,-92.0,-89.0,-92.0,39.0,58.0,46.0,49.0,0
2957,92:69:1D:31:68:E9,3823720,485312612,3594,3503074,3820126,481809538,0,3838,980188,3735,957218,103,22970,1904,6,3720,79,0,31,216660.0,130000.0,-52.0,-50.0,-44.0,-46.0,-51.0,-49.0,-43.0,-46.0,-90.0,-92.0,-89.0,-92.0,38.0,42.0,45.0,46.0,0
2958,CC:2F:71:3F:1F:24,4427735,1172522343,607608,690712743,3820127,481809600,37,503472,559525740,502888,559455352,584,70388,485802,10,607845,51939,34,432,130000.0,39000.0,-67.0,-65.0,-70.0,-67.0,-67.0,-65.0,-70.0,-67.0,-90.0,-92.0,-89.0,-92.0,23.0,27.0,19.0,25.0,0
2959,CC:2F:71:3E:C5:1F,3820838,481896487,711,86887,3820127,481809600,0,3014,252683,2493,190761,521,61922,753,8,1042,18,0,32,130000.0,39000.0,-70.0,-71.0,-67.0,-60.0,-70.0,-71.0,-67.0,-60.0,-90.0,-92.0,-89.0,-92.0,20.0,21.0,22.0,32.0,0
2960,BA:8C:B9:54:50:24,3824672,487931788,4545,6122188,3820127,481809600,0,7824,1604616,7803,1601259,21,3357,2291,14,4920,35,0,50,229410.0,130000.0,-51.0,-34.0,-43.0,-43.0,-44.0,-36.0,-43.0,-47.0,-90.0,-92.0,-89.0,-92.0,39.0,58.0,46.0,49.0,0
2961,92:69:1D:31:68:E9,3823724,485312936,3594,3503074,3820130,481809862,0,3838,980188,3735,957218,103,22970,1904,6,3720,79,0,31,216660.0,130000.0,-52.0,-50.0,-44.0,-46.0,-51.0,-49.0,-43.0,-46.0,-90.0,-92.0,-89.0,-92.0,38.0,42.0,45.0,46.0,0
2962,CC:2F:71:3F:1F:24,4427781,1172537157,607651,690727295,3820130,481809862,37,503497,559530544,502913,559460156,584,70388,485827,10,607888,51957,34,432,130000.0,39000.0,-67.0,-65.0,-70.0,-68.0,-67.0,-65.0,-70.0,-67.0,-90.0,-92.0,-89.0,-92.0,23.0,27.0,19.0,24.0,0
2963,CC:2F:71:3E:C5:1F,3820841,481896749,711,86887,3820130,481809862,0,3015,252753,2494,190831,521,61922,753,8,1042,18,0,32,130000.0,39000.0,-70.0,-71.0,-67.0,-60.0,-70.0,-71.0,-67.0,-60.0,-90.0,-92.0,-89.0,-92.0,20.0,21.0,22.0,32.0,0
2964,BA:8C:B9:54:50:24,3824675,487932050,4545,6122188,3820130,481809862,0,7824,1604616,7803,1601259,21,3357,2291,14,4920,35,0,50,229410.0,130000.0,-51.0,-34.0,-43.0,-43.0,-44.0,-36.0,-43.0,-47.0,-90.0,-92.0,-89.0,-92.0,39.0,58.0,46.0,49.0,0
2965,92:69:1D:31:68:E9,3823731,485313815,3594,3503074,3820137,481810741,0,3838,980188,3735,957218,103,22970,1904,6,3720,79,0,31,216660.0,130000.0,-52.0,-50.0,-44.0,-46.0,-51.0,-49.0,-43.0,-46.0,-90.0,-92.0,-89.0,-92.0,38.0,42.0,45.0,46.0,0
2966,CC:2F:71:3F:1F:24,4427831,1172552644,607694,690741903,3820137,481810741,37,503523,559535488,502939,559465100,584,70388,485853,10,607931,51966,34,432,130000.0,43333.0,-67.0,-65.0,-70.0,-67.0,-67.0,-65.0,-70.0,-67.0,-90.0,-92.0,-89.0,-92.0,23.0,27.0,19.0,25.0,0
2967,CC:2F:71:3E:C5:1F,3820848,481897628,711,86887,3820137,481810741,0,3015,252753,2494,190831,521,61922,753,8,1042,18,0,32,130000.0,39000.0,-70.0,-71.0,-67.0,-60.0,-70.0,-71.0,-67.0,-60.0,-90.0,-92.0,-89.0,-92.0,20.0,21.0,22.0,32.0,0
2968,BA:8C:B9:54:50:24,3824682,487932929,4545,6122188,3820137,481810741,0,7824,1604616,7803,1601259,21,3357,2291,14,4920,35,0,50,229410.0,130000.0,-51.0,-34.0,-43.0,-43.0,-44.0,-36.0,-43.0,-47.0,-90.0,-92.0,-89.0,-92.0,39.0,58.0,46.0,49.0,0
2969,92:69:1D:31:68:E9,3823734,485314077,3594,3503074,3820140,481811003,0,3838,980188,3735,957218,103,22970,1904,6,3720,79,0,31,216660.0,130000.0,-52.0,-50.0,-44.0,-46.0,-51.0,-49.0,-43.0,-46.0,-90.0,-92.0,-89.0,-92.0,38.0,42.0,45.0,46.0,0
2970,CC:2F:71:3F:1F:24,4427876,1172567390,607736,690756387,3820140,481811003,37,503548,559540320,502964,559469932,584,70388,485878,10,607973,51979,34,432,130000.0,39000.0,-67.0,-65.0,-70.0,-67.0,-67.0,-65.0,-70.0,-67.0,-90.0,-92.0,-89.0,-92.0,23.0,27.0,19.0,25.0,0
2971,CC:2F:71:3E:C5:1F,3820851,481897890,711,86887,3820140,481811003,0,3015,252753,2494,190831,521,61922,753,8,1042,18,0,32,130000.0,39000.0,-70.0,-71.0,-67.0,-60.0,-70.0,-71.0,-67.0,-60.0,-90.0,-92.0,-89.0,-92.0,20.0,21.0,22.0,32.0,0
2972,BA:8C:B9:54:50:24,3824685,487933191,4545,6122188,3820140,481811003,0,7825,1604684,7804,1601327,21,3357,2291,14,4920,35,0,50,229410.0,130000.0,-39.0,-36.0,-44.0,-52.0,-44.0,-35.0,-43.0,-48.0,-90.0,-92.0,-89.0,-92.0,51.0,56.0,45.0,40.0,0
2973,92:69:1D:31:68:E9,3823740,485314683,3594,3503074,3820146,481811609,0,3838,980188,3735,957218,103,22970,1904,6,3720,79,0,31,216660.0,130000.0,-52.0,-50.0,-44.0,-46.0,-51.0,-49.0,-43.0,-46.0,-90.0,-92.0,-89.0,-92.0,38.0,42.0,45.0,46.0,0
2974,CC:2F:71:3F:1F:24,4427925,1172582492,607779,690770883,3820146,481811609,37,503575,559545380,502991,559474992,584,70388,485905,10,608016,51995,34,432,130000.0,43333.0,-67.0,-65.0,-70.0,-68.0,-67.0,-65.0,-70.0,-67.0,-90.0,-92.0,-89.0,-92.0,23.0,27.0,19.0,24.0,0
2975,CC:2F:71:3E:C5:1F,3820857,481898496,711,86887,3820146,481811609,0,3015,252753,2494,190831,521,61922,753,8,1042,18,0,32,130000.0,39000.0,-70.0,-71.0,-67.0,-60.0,-70.0,-71.0,-67.0,-60.0,-90.0,-92.0,-89.0,-92.0,20.0,21.0,22.0,32.0,0
2976,BA:8C:B9:54:50:24,3824691,487933797,4545,6122188,3820146,481811609,0,7825,1604684,7804,1601327,21,3357,2291,14,4920,35,0,50,229410.0,130000.0,-39.0,-36.0,-44.0,-52.0,-44.0,-35.0,-43.0,-48.0,-90.0,-92.0,-89.0,-92.0,51.0,56.0,45.0,40.0,0
2977,92:69:1D:31:68:E9,3823742,485314885,3594,3503074,3820148,481811811,0,3838,980188,3735,957218,103,22970,1904,6,3720,79,0,31,216660.0,130000.0,-52.0,-50.0,-44.0,-46.0,-51.0,-49.0,-43.0,-46.0,-90.0,-92.0,-89.0,-92.0,38.0,42.0,45.0,46.0,0
2978,CC:2F:71:3F:1F:24,4427970,1172597246,607822,690785435,3820148,481811811,37,503605,559550812,503021,559480424,584,70388,485935,10,608059,52020,34,432,117000.0,39000.0,-67.0,-65.0,-70.0,-67.0,-67.0,-65.0,-70.0,-67.0,-90.0,-92.0,-89.0,-92.0,23.0,27.0,19.0,25.0,0
2979,CC:2F:71:3E:C5:1F,3820859,481898698,711,86887,3820148,481811811,0,3015,252753,2494,190831,521,61922,753,8,1042,18,0,32,130000.0,39000.0,-70.0,-71.0,-67.0,-60.0,-70.0,-71.0,-67.0,-60.0,-90.0,-92.0,-89.0,-92.0,20.0,21.0,22.0,32.0,0
2980,BA:8C:B9:54:50:24,3824693,487933999,4545,6122188,3820148,481811811,0,7825,1604684,7804,1601327,21,3357,2291,14,4920,35,0,50,229410.0,130000.0,-39.0,-36.0,-44.0,-52.0,-44.0,-35.0,-43.0,-48.0,-90.0,-92.0,-89.0,-92.0,51.0,56.0,45.0,40.0,0
2981,92:69:1D:31:68:E9,3823749,485315551,3594,3503074,3820155,481812477,0,3838,980188,3735,957218,103,22970,1904,6,3720,79,0,31,216660.0,130000.0,-52.0,-50.0,-44.0,-46.0,-51.0,-49.0,-43.0,-46.0,-90.0,-92.0,-89.0,-92.0,38.0,42.0,45.0,46.0,0
2982,CC:2F:71:3F:1F:24,4428017,1172612030,607862,690799553,3820155,481812477,37,503631,559555756,503047,559485368,584,70388,485961,10,608099,52044,34,432,130000.0,39000.0,-67.0,-65.0,-70.0,-68.0,-67.0,-65.0,-70.0,-67.0,-90.0,-92.0,-89.0,-92.0,23.0,27.0,19.0,24.0,0
2983,CC:2F:71:3E:C5:1F,3820866,481899364,711,86887,3820155,481812477,0,3015,252753,2494,190831,521,61922,753,8,1042,18,0,32,130000.0,39000.0,-70.0,-71.0,-67.0,-60.0,-70.0,-71.0,-67.0,-60.0,-90.0,-92.0,-89.0,-92.0,20.0,21.0,22.0,32.0,0
2984,BA:8C:B9:54:50:24,3824702,487934867,4545,6122188,3820157,481812679,0,7825,1604684,7804,1601327,21,3357,2291,14,4920,35,0,50,229410.0,130000.0,-39.0,-36.0,-44.0,-52.0,-44.0,-35.0,-43.0,-48.0,-90.0,-92.0,-89.0,-92.0,51.0,56.0,45.0,40.0,0
2985,92:69:1D:31:68:E9,3823751,485315753,3594,3503074,3820157,481812679,0,3838,980188,3735,957218,103,22970,1904,6,3720,79,0,31,216660.0,130000.0,-52.0,-50.0,-44.0,-46.0,-51.0,-49.0,-43.0,-46.0,-90.0,-92.0,-89.0,-92.0,38.0,42.0,45.0,46.0,0
2986,CC:2F:71:3F:1F:24,4428062,1172626728,607905,690814049,3820157,481812679,37,503658,559560840,503074,559490452,584,70388,485988,10,608142,52054,34,432,130000.0,43333.0,-67.0,-65.0,-70.0,-67.0,-67.0,-65.0,-70.0,-67.0,-90.0,-92.0,-89.0,-92.0,23.0,27.0,19.0,25.0,0
2987,CC:2F:71:3E:C5:1F,3820868,481899566,711,86887,3820157,481812679,0,3015,252753,2494,190831,521,61922,753,8,1042,18,0,32,130000.0,39000.0,-70.0,-71.0,-67.0,-60.0,-70.0,-71.0,-67.0,-60.0,-90.0,-92.0,-89.0,-92.0,20.0,21.0,22.0,32.0,0
2988,BA:8C:B9:54:50:24,3824702,487934867,4545,6122188,3820157,481812679,0,7825,1604684,7804,1601327,21,3357,2291,14,4920,35,0,50,229410.0,130000.0,-39.0,-36.0,-44.0,-52.0,-44.0,-35.0,-43.0,-48.0,-90.0,-92.0,-89.0,-92.0,51.0,56.0,45.0,40.0,0
2989,92:69:1D:31:68:E9,3823757,485316359,3594,3503074,3820163,481813285,0,3838,980188,3735,957218,103,22970,1904,6,3720,79,0,31,216660.0,130000.0,-52.0,-50.0,-44.0,-46.0,-51.0,-49.0,-43.0,-46.0,-90.0,-92.0,-89.0,-92.0,38.0,42.0,45.0,46.0,0
2990,CC:2F:71:3F:1F:24,4428112,1172641946,607948,690828601,3820164,481813345,37,503685,559565924,503101,559495536,584,70388,486015,10,608185,52073,34,432,117000.0,39000.0,-67.0,-65.0,-70.0,-67.0,-67.0,-65.0,-70.0,-67.0,-90.0,-92.0,-89.0,-92.0,23.0,27.0,19.0,25.0,0
2991,CC:2F:71:3E:C5:1F,3820875,481900232,711,86887,3820164,481813345,0,3015,252753,2494,190831,521,61922,753,8,1042,18,0,32,130000.0,39000.0,-70.0,-71.0,-67.0,-60.0,-70.0,-71.0,-67.0,-60.0,-90.0,-92.0,-89.0,-92.0,20.0,21.0,22.0,32.0,0
2992,BA:8C:B9:54:50:24,3824711,487935735,4545,6122188,3820166,481813547,0,7825,1604684,7804,1601327,21,3357,2291,14,4920,35,0,50,229410.0,130000.0,-39.0,-36.0,-44.0,-52.0,-44.0,-35.0,-43.0,-48.0,-90.0,-92.0,-89.0,-92.0,51.0,56.0,45.0,40.0,0
2993,92:69:1D:31:68:E9,3823760,485316621,3594,3503074,3820166,481813547,0,3838,980188,3735,957218,103,22970,1904,6,3720,79,0,31,216660.0,130000.0,-52.0,-50.0,-44.0,-46.0,-51.0,-49.0,-43.0,-46.0,-90.0,-92.0,-89.0,-92.0,38.0,42.0,45.0,46.0,0
2994,CC:2F:71:3F:1F:24,4428156,1172656576,607990,690843029,3820166,481813547,37,503711,559570868,503127,559500480,584,70388,486041,10,608227,52076,34,432,130000.0,43333.0,-67.0,-65.0,-70.0,-67.0,-67.0,-65.0,-70.0,-67.0,-90.0,-92.0,-89.0,-92.0,23.0,27.0,19.0,25.0,0
2995,CC:2F:71:3E:C5:1F,3820877,481900434,711,86887,3820166,481813547,0,3015,252753,2494,190831,521,61922,753,8,1042,18,0,32,130000.0,39000.0,-70.0,-71.0,-67.0,-60.0,-70.0,-71.0,-67.0,-60.0,-90.0,-92.0,-89.0,-92.0,20.0,21.0,22.0,32.0,0
2996,BA:8C:B9:54:50:24,3824711,487935735,4545,6122188,3820166,481813547,0,7825,1604684,7804,1601327,21,3357,2291,14,4920,35,0,50,229410.0,130000.0,-39.0,-36.0,-44.0,-52.0,-44.0,-35.0,-43.0,-48.0,-90.0,-92.0,-89.0,-92.0,51.0,56.0,45.0,40.0,0
2997,92:69:1D:31:68:E9,3823764,485317025,3594,3503074,3820170,481813951,0,3838,980188,3735,957218,103,22970,1904,6,3720,79,0,31,216660.0,130000.0,-52.0,-50.0,-44.0,-46.0,-51.0,-49.0,-43.0,-46.0,-90.0,-92.0,-89.0,-92.0,38.0,42.0,45.0,46.0,0
2998,CC:2F:71:3F:1F:24,4428204,1172671722,608032,690857569,3820172,481814153,37,503736,559575672,503152,559505284,584,70388,486066,10,608269,52083,34,432,130000.0,43333.0,-67.0,-65.0,-70.0,-68.0,-67.0,-65.0,-70.0,-67.0,-90.0,-92.0,-89.0,-92.0,23.0,27.0,19.0,24.0,0
2999,CC:2F:71:3E:C5:1F,3820883,481901040,711,86887,3820172,481814153,0,3015,252753,2494,190831,521,61922,753,8,1042,18,0,32,130000.0,39000.0,-70.0,-71.0,-67.0,-60.0,-70.0,-71.0,-67.0,-60.0,-90.0,-92.0,-89.0,-92.0,20.0,21.0,22.0,32.0,0
3000,BA:8C:B9:54:50:24,3824719,487936543,4545,6122188,3820174,481814355,0,7825,1604684,7804,1601327,21,3357,2291,14,4920,35,0,50,229410.0,130000.0,-39.0,-36.0,-44.0,-52.0,-44.0,-35.0,-43.0,-48.0,-90.0,-92.0,-89.0,-92.0,51.0,56.0,45.0,40.0,0
3001,92:69:1D:31:68:E9,3823769,485317489,3594,3503074,3820175,481814415,0,3838,980188,3735,957218,103,22970,1904,6,3720,79,0,31,216660.0,130000.0,-52.0,-50.0,-44.0,-46.0,-51.0,-49.0,-43.0,-46.0,-90.0,-92.0,-89.0,-92.0,38.0,42.0,45.0,46.0,0
3002,CC:2F:71:3F:1F:24,4428248,1172686344,608073,690871929,3820175,481814415,37,503762,559580592,503178,559510204,584,70388,486092,10,608310,52102,34,432,130000.0,39000.0,-67.0,-65.0,-70.0,-67.0,-67.0,-65.0,-70.0,-67.0,-90.0,-92.0,-89.0,-92.0,23.0,27.0,19.0,25.0,0
3003,CC:2F:71:3E:C5:1F,3820886,481901302,711,86887,3820175,481814415,0,3015,252753,2494,190831,521,61922,753,8,1042,18,0,32,130000.0,39000.0,-70.0,-71.0,-67.0,-60.0,-70.0,-71.0,-67.0,-60.0,-90.0,-92.0,-89.0,-92.0,20.0,21.0,22.0,32.0,0
3004,BA:8C:B9:54:50:24,3824720,487936603,4545,6122188,3820175,481814415,0,7825,1604684,7804,1601327,21,3357,2291,14,4920,35,0,50,229410.0,130000.0,-39.0,-36.0,-44.0,-52.0,-44.0,-35.0,-43.0,-48.0,-90.0,-92.0,-89.0,-92.0,51.0,56.0,45.0,40.0,0
3005,92:69:1D:31:68:E9,3823773,485317893,3594,3503074,3820179,481814819,0,3838,980188,3735,957218,103,22970,1904,6,3720,79,0,31,216660.0,130000.0,-52.0,-50.0,-44.0,-46.0,-51.0,-49.0,-43.0,-46.0,-90.0,-92.0,-89.0,-92.0,38.0,42.0,45.0,46.0,0
3006,CC:2F:71:3F:1F:24,4428294,1172701176,608115,690886357,3820179,481814819,37,503788,559585536,503204,559515148,584,70388,486118,10,608352,52112,34,432,130000.0,39000.0,-67.0,-65.0,-70.0,-67.0,-67.0,-65.0,-70.0,-67.0,-90.0,-92.0,-89.0,-92.0,23.0,27.0,19.0,25.0,0
3007,CC:2F:71:3E:C5:1F,3820894,481902110,711,86887,3820183,481815223,0,3015,252753,2494,190831,521,61922,753,8,1042,18,0,32,130000.0,39000.0,-70.0,-71.0,-67.0,-60.0,-70.0,-71.0,-67.0,-60.0,-90.0,-92.0,-89.0,-92.0,20.0,21.0,22.0,32.0,0
3008,BA:8C:B9:54:50:24,3824728,487937411,4545,6122188,3820183,481815223,0,7825,1604684,7804,1601327,21,3357,2291,14,4920,35,0,50,229410.0,130000.0,-39.0,-36.0,-44.0,-52.0,-44.0,-35.0,-43.0,-48.0,-90.0,-92.0,-89.0,-92.0,51.0,56.0,45.0,40.0,0
3009,92:69:1D:31:68:E9,3823777,485318297,3594,3503074,3820183,481815223,0,3838,980188,3735,957218,103,22970,1904,6,3720,79,0,31,216660.0,130000.0,-52.0,-50.0,-44.0,-46.0,-51.0,-49.0,-43.0,-46.0,-90.0,-92.0,-89.0,-92.0,38.0,42.0,45.0,46.0,0
3010,CC:2F:71:3F:1F:24,4428341,1172716132,608158,690900909,3820183,481815223,37,503814,559590480,503230,559520092,584,70388,486144,10,608395,52120,34,432,130000.0,39000.0,-67.0,-65.0,-71.0,-68.0,-67.0,-65.0,-70.0,-67.0,-90.0,-92.0,-89.0,-92.0,23.0,27.0,18.0,24.0,0
3011,CC:2F:71:3E:C5:1F,3820894,481902110,711,86887,3820183,481815223,0,3015,252753,2494,190831,521,61922,753,8,1042,18,0,32,130000.0,39000.0,-70.0,-71.0,-67.0,-60.0,-70.0,-71.0,-67.0,-60.0,-90.0,-92.0,-89.0,-92.0,20.0,21.0,22.0,32.0,0
3012,BA:8C:B9:54:50:24,3824728,487937411,4545,6122188,3820183,481815223,0,7829,1604956,7808,1601599,21,3357,2291,14,4920,35,0,50,229410.0,130000.0,-39.0,-36.0,-44.0,-51.0,-40.0,-35.0,-43.0,-50.0,-90.0,-92.0,-89.0,-92.0,51.0,56.0,45.0,41.0,0
3013,92:69:1D:31:68:E9,3823782,485318761,3594,3503074,3820188,481815687,0,3838,980188,3735,957218,103,22970,1904,6,3720,79,0,31,216660.0,130000.0,-52.0,-50.0,-44.0,-46.0,-51.0,-49.0,-43.0,-46.0,-90.0,-92.0,-89.0,-92.0,38.0,42.0,45.0,46.0,0
3014,CC:2F:71:3F:1F:24,4428392,1172731466,608202,690915577,3820190,481815889,37,503840,559595424,503256,559525036,584,70388,486170,10,608439,52137,34,432,130000.0,39000.0,-67.0,-65.0,-71.0,-67.0,-67.0,-65.0,-70.0,-67.0,-90.0,-92.0,-89.0,-92.0,23.0,27.0,18.0,25.0,0
3015,CC:2F:71:3E:C5:1F,3820904,481903094,712,87003,3820192,481816091,0,3016,252823,2495,190901,521,61922,753,8,1043,18,0,32,130000.0,39000.0,-70.0,-71.0,-67.0,-60.0,-70.0,-71.0,-67.0,-60.0,-90.0,-92.0,-89.0,-92.0,20.0,21.0,22.0,32.0,0
3016,BA:8C:B9:54:50:24,3824738,487938395,4546,6122304,3820192,481816091,0,7834,1605296,7813,1601939,21,3357,2291,14,4921,35,0,50,229410.0,130000.0,-39.0,-36.0,-44.0,-51.0,-41.0,-34.0,-42.0,-47.0,-90.0,-92.0,-89.0,-92.0,51.0,56.0,45.0,41.0,0
3017,92:69:1D:31:68:E9,3823788,485319554,3595,3503190,3820193,481816364,0,3840,980324,3737,957354,103,22970,1904,6,3721,79,0,31,216660.0,130000.0,-51.0,-47.0,-42.0,-49.0,-51.0,-49.0,-43.0,-46.0,-90.0,-92.0,-89.0,-92.0,39.0,45.0,47.0,43.0,0
3018,CC:2F:71:3F:1F:24,4428436,1172746239,608243,690929875,3820193,481816364,37,503867,559600484,503283,559530096,584,70388,486197,10,608480,52155,34,432,130000.0,39000.0,-67.0,-65.0,-70.0,-67.0,-67.0,-65.0,-70.0,-67.0,-90.0,-92.0,-89.0,-92.0,23.0,27.0,19.0,25.0,0
3019,CC:2F:71:3E:C5:1F,3820905,481903367,712,87003,3820193,481816364,0,3017,252893,2496,190971,521,61922,753,8,1043,18,0,32,130000.0,39000.0,-78.0,-85.0,-75.0,-71.0,-71.0,-72.0,-68.0,-61.0,-90.0,-92.0,-89.0,-92.0,12.0,7.0,14.0,21.0,0
3020,BA:8C:B9:54:50:24,3824739,487938668,4546,6122304,3820193,481816364,0,7834,1605296,7813,1601939,21,3357,2291,14,4921,35,0,50,229410.0,130000.0,-39.0,-36.0,-44.0,-51.0,-41.0,-34.0,-42.0,-47.0,-90.0,-92.0,-89.0,-92.0,51.0,56.0,45.0,41.0,0
3021,92:69:1D:31:68:E9,3823791,485319816,3595,3503190,3820196,481816626,0,3840,980324,3737,957354,103,22970,1904,6,3721,79,0,31,216660.0,130000.0,-51.0,-47.0,-42.0,-49.0,-51.0,-49.0,-43.0,-46.0,-90.0,-92.0,-89.0,-92.0,39.0,45.0,47.0,43.0,0
3022,CC:2F:71:3F:1F:24,4428487,1172761531,608287,690944501,3820200,481817030,37,503894,559605544,503310,559535156,584,70388,486224,10,608524,52170,34,432,130000.0,43333.0,-67.0,-65.0,-71.0,-67.0,-67.0,-65.0,-70.0,-67.0,-90.0,-92.0,-89.0,-92.0,23.0,27.0,18.0,25.0,0
3023,CC:2F:71:3E:C5:1F,3820914,481904235,712,87003,3820202,481817232,0,3017,252893,2496,190971,521,61922,753,8,1043,18,0,32,130000.0,39000.0,-78.0,-85.0,-75.0,-71.0,-71.0,-72.0,-68.0,-61.0,-90.0,-92.0,-89.0,-92.0,12.0,7.0,14.0,21.0,0
3024,BA:8C:B9:54:50:24,3824748,487939536,4546,6122304,3820202,481817232,0,7834,1605296,7813,1601939,21,3357,2291,14,4921,35,0,50,229410.0,130000.0,-39.0,-36.0,-44.0,-51.0,-41.0,-34.0,-42.0,-47.0,-90.0,-92.0,-89.0,-92.0,51.0,56.0,45.0,41.0,0
3025,92:69:1D:31:68:E9,3823797,485320422,3595,3503190,3820202,481817232,0,3840,980324,3737,957354,103,22970,1904,6,3721,79,0,31,216660.0,130000.0,-51.0,-47.0,-42.0,-49.0,-51.0,-49.0,-43.0,-46.0,-90.0,-92.0,-89.0,-92.0,39.0,45.0,47.0,43.0,0
3026,CC:2F:71:3F:1F:24,4428530,1172776093,608328,690958861,3820202,481817232,37,503920,559610488,503336,559540100,584,70388,486250,10,608565,52188,34,432,130000.0,39000.0,-67.0,-65.0,-71.0,-67.0,-67.0,-65.0,-70.0,-67.0,-90.0,-92.0,-89.0,-92.0,23.0,27.0,18.0,25.0,0
3027,CC:2F:71:3E:C5:1F,3820914,481904235,712,87003,3820202,481817232,0,3017,252893,2496,190971,521,61922,753,8,1043,18,0,32,130000.0,39000.0,-78.0,-85.0,-75.0,-71.0,-71.0,-72.0,-68.0,-61.0,-90.0,-92.0,-89.0,-92.0,12.0,7.0,14.0,21.0,0
3028,BA:8C:B9:54:50:24,3824748,487939536,4546,6122304,3820202,481817232,0,7834,1605296,7813,1601939,21,3357,2291,14,4921,35,0,50,229410.0,130000.0,-39.0,-36.0,-44.0,-51.0,-41.0,-34.0,-42.0,-47.0,-90.0,-92.0,-89.0,-92.0,51.0,56.0,45.0,41.0,0
3029,92:69:1D:31:68:E9,3823799,485320624,3595,3503190,3820204,481817434,0,3840,980324,3737,957354,103,22970,1904,6,3721,79,0,31,216660.0,130000.0,-51.0,-47.0,-42.0,-49.0,-51.0,-49.0,-43.0,-46.0,-90.0,-92.0,-89.0,-92.0,39.0,45.0,47.0,43.0,0
3030,CC:2F:71:3F:1F:24,4428576,1172790869,608370,690973233,3820206,481817636,37,503946,559615408,503362,559545020,584,70388,486276,10,608607,52198,34,432,130000.0,43333.0,-67.0,-65.0,-70.0,-68.0,-67.0,-65.0,-70.0,-67.0,-90.0,-92.0,-89.0,-92.0,23.0,27.0,19.0,24.0,0
3031,CC:2F:71:3E:C5:1F,3820922,481905043,712,87003,3820210,481818040,0,3017,252893,2496,190971,521,61922,753,8,1043,18,0,32,130000.0,39000.0,-78.0,-85.0,-75.0,-71.0,-71.0,-72.0,-68.0,-61.0,-90.0,-92.0,-89.0,-92.0,12.0,7.0,14.0,21.0,0
3032,BA:8C:B9:54:50:24,3824756,487940344,4546,6122304,3820210,481818040,0,7834,1605296,7813,1601939,21,3357,2291,14,4921,35,0,50,229410.0,130000.0,-39.0,-36.0,-44.0,-51.0,-41.0,-34.0,-42.0,-47.0,-90.0,-92.0,-89.0,-92.0,51.0,56.0,45.0,41.0,0
3033,92:69:1D:31:68:E9,3823806,485321290,3595,3503190,3820211,481818100,0,3840,980324,3737,957354,103,22970,1904,6,3721,79,0,31,216660.0,130000.0,-51.0,-47.0,-42.0,-49.0,-51.0,-49.0,-43.0,-46.0,-90.0,-93.0,-89.0,-92.0,39.0,46.0,47.0,43.0,0
3034,CC:2F:71:3F:1F:24,4428621,1172805625,608410,690987525,3820211,481818100,37,503973,559620468,503389,559550080,584,70388,486303,10,608647,52205,34,432,130000.0,43333.0,-67.0,-65.0,-71.0,-68.0,-67.0,-65.0,-70.0,-67.0,-90.0,-93.0,-89.0,-92.0,23.0,28.0,18.0,24.0,0
3035,CC:2F:71:3E:C5:1F,3820923,481905103,712,87003,3820211,481818100,0,3017,252893,2496,190971,521,61922,753,8,1043,18,0,32,130000.0,39000.0,-78.0,-85.0,-75.0,-71.0,-71.0,-72.0,-68.0,-61.0,-90.0,-93.0,-89.0,-92.0,12.0,8.0,14.0,21.0,0
3036,BA:8C:B9:54:50:24,3824757,487940404,4546,6122304,3820211,481818100,0,7834,1605296,7813,1601939,21,3357,2291,14,4921,35,0,50,229410.0,130000.0,-39.0,-36.0,-44.0,-51.0,-41.0,-34.0,-42.0,-47.0,-90.0,-93.0,-89.0,-92.0,51.0,57.0,45.0,41.0,0
3037,92:69:1D:31:68:E9,3823808,485321492,3595,3503190,3820213,481818302,0,3840,980324,3737,957354,103,22970,1904,6,3721,79,0,31,216660.0,130000.0,-51.0,-47.0,-42.0,-49.0,-51.0,-49.0,-43.0,-46.0,-90.0,-93.0,-89.0,-92.0,39.0,46.0,47.0,43.0,0
3038,CC:2F:71:3F:1F:24,4428667,1172820457,608452,691001953,3820215,481818504,37,504000,559625528,503416,559555140,584,70388,486330,10,608689,52220,34,432,117000.0,39000.0,-67.0,-65.0,-70.0,-68.0,-67.0,-65.0,-70.0,-67.0,-90.0,-93.0,-89.0,-92.0,23.0,28.0,19.0,24.0,0
3039,CC:2F:71:3E:C5:1F,3820931,481905911,712,87003,3820219,481818908,0,3017,252893,2496,190971,521,61922,753,8,1043,18,0,32,130000.0,39000.0,-78.0,-85.0,-75.0,-71.0,-71.0,-72.0,-68.0,-61.0,-90.0,-93.0,-89.0,-92.0,12.0,8.0,14.0,21.0,0
3040,BA:8C:B9:54:50:24,3824765,487941212,4546,6122304,3820219,481818908,0,7834,1605296,7813,1601939,21,3357,2291,14,4921,35,0,50,229410.0,130000.0,-39.0,-36.0,-44.0,-51.0,-41.0,-34.0,-42.0,-47.0,-90.0,-93.0,-89.0,-92.0,51.0,57.0,45.0,41.0,0
3041,92:69:1D:31:68:E9,3823815,485322160,3595,3503190,3820220,481818970,0,3840,980324,3737,957354,103,22970,1904,6,3721,79,0,31,216660.0,130000.0,-51.0,-47.0,-42.0,-49.0,-51.0,-49.0,-43.0,-46.0,-90.0,-93.0,-89.0,-92.0,39.0,46.0,47.0,43.0,0
3042,CC:2F:71:3F:1F:24,4428714,1172835351,608494,691016381,3820220,481818970,37,504027,559630588,503443,559560200,584,70388,486357,10,608731,52226,34,432,130000.0,43333.0,-67.0,-65.0,-70.0,-67.0,-67.0,-65.0,-70.0,-67.0,-90.0,-93.0,-89.0,-92.0,23.0,28.0,19.0,25.0,0
3043,CC:2F:71:3E:C5:1F,3820932,481905973,712,87003,3820220,481818970,0,3019,253081,2497,191041,522,62040,754,8,1043,18,0,32,130000.0,39000.0,-71.0,-71.0,-67.0,-60.0,-71.0,-72.0,-68.0,-61.0,-90.0,-93.0,-89.0,-92.0,19.0,22.0,22.0,32.0,0
3044,BA:8C:B9:54:50:24,3824767,487941334,4546,6122304,3820221,481819030,0,7834,1605296,7813,1601939,21,3357,2291,14,4921,35,0,50,229410.0,130000.0,-39.0,-36.0,-44.0,-51.0,-41.0,-34.0,-42.0,-47.0,-90.0,-93.0,-89.0,-92.0,51.0,57.0,45.0,41.0,0
3045,92:69:1D:31:68:E9,3823818,485322422,3595,3503190,3820223,481819232,0,3840,980324,3737,957354,103,22970,1904,6,3721,79,0,31,216660.0,130000.0,-51.0,-47.0,-42.0,-49.0,-51.0,-49.0,-43.0,-46.0,-90.0,-93.0,-89.0,-92.0,39.0,46.0,47.0,43.0,0
3046,CC:2F:71:3F:1F:24,4428762,1172850423,608537,691030989,3820225,481819434,37,504054,559635648,503470,559565260,584,70388,486384,10,608774,52244,34,432,130000.0,39000.0,-67.0,-65.0,-71.0,-67.0,-67.0,-65.0,-70.0,-67.0,-90.0,-93.0,-89.0,-92.0,23.0,28.0,18.0,25.0,0
3047,CC:2F:71:3E:C5:1F,3820939,481906639,712,87003,3820227,481819636,0,3019,253081,2497,191041,522,62040,754,8,1043,18,0,32,130000.0,39000.0,-71.0,-71.0,-67.0,-60.0,-71.0,-72.0,-68.0,-61.0,-90.0,-93.0,-89.0,-92.0,19.0,22.0,22.0,32.0,0
3048,BA:8C:B9:54:50:24,3824773,487941940,4546,6122304,3820227,481819636,0,7834,1605296,7813,1601939,21,3357,2291,14,4921,35,0,50,229410.0,130000.0,-39.0,-36.0,-44.0,-51.0,-41.0,-34.0,-42.0,-47.0,-90.0,-93.0,-89.0,-92.0,51.0,57.0,45.0,41.0,0
3049,92:69:1D:31:68:E9,3823824,485323028,3595,3503190,3820229,481819838,0,3840,980324,3737,957354,103,22970,1904,6,3721,79,0,31,216660.0,130000.0,-51.0,-47.0,-42.0,-49.0,-51.0,-49.0,-43.0,-46.0,-90.0,-93.0,-89.0,-92.0,39.0,46.0,47.0,43.0,0
3050,CC:2F:71:3F:1F:24,4428809,1172865323,608580,691045485,3820229,481819838,37,504082,559640800,503498,559570412,584,70388,486412,10,608817,52262,34,432,130000.0,43333.0,-67.0,-65.0,-70.0,-68.0,-67.0,-65.0,-70.0,-67.0,-90.0,-93.0,-89.0,-92.0,23.0,28.0,19.0,24.0,0
3051,CC:2F:71:3E:C5:1F,3820941,481906841,712,87003,3820229,481819838,0,3019,253081,2497,191041,522,62040,754,8,1043,18,0,32,130000.0,39000.0,-71.0,-71.0,-67.0,-60.0,-71.0,-72.0,-68.0,-61.0,-90.0,-93.0,-89.0,-92.0,19.0,22.0,22.0,32.0,0
3052,BA:8C:B9:54:50:24,3824775,487942142,4546,6122304,3820229,481819838,0,7834,1605296,7813,1601939,21,3357,2291,14,4921,35,0,50,229410.0,130000.0,-39.0,-36.0,-44.0,-51.0,-41.0,-34.0,-42.0,-47.0,-90.0,-93.0,-89.0,-92.0,51.0,57.0,45.0,41.0,0
3053,92:69:1D:31:68:E9,3823827,485323290,3595,3503190,3820232,481820100,0,3841,980392,3738,957422,103,22970,1904,6,3721,79,0,31,216660.0,130000.0,-51.0,-51.0,-45.0,-48.0,-51.0,-49.0,-43.0,-46.0,-90.0,-93.0,-89.0,-92.0,39.0,42.0,44.0,44.0,0
3054,CC:2F:71:3F:1F:24,4428856,1172880215,608622,691059913,3820234,481820302,37,504108,559645744,503524,559575356,584,70388,486438,10,608859,52285,34,432,117000.0,39000.0,-67.0,-65.0,-70.0,-68.0,-67.0,-65.0,-70.0,-67.0,-90.0,-93.0,-89.0,-92.0,23.0,28.0,19.0,24.0,0
3055,CC:2F:71:3E:C5:1F,3820946,481907305,712,87003,3820234,481820302,0,3019,253081,2497,191041,522,62040,754,8,1043,18,0,32,130000.0,39000.0,-71.0,-71.0,-67.0,-60.0,-71.0,-72.0,-68.0,-61.0,-90.0,-93.0,-89.0,-92.0,19.0,22.0,22.0,32.0,0
3056,BA:8C:B9:54:50:24,3824782,487942808,4546,6122304,3820236,481820504,0,7834,1605296,7813,1601939,21,3357,2291,14,4921,35,0,50,229410.0,130000.0,-39.0,-36.0,-44.0,-51.0,-41.0,-34.0,-42.0,-47.0,-90.0,-93.0,-89.0,-92.0,51.0,57.0,45.0,41.0,0
3057,92:69:1D:31:68:E9,3823833,485323896,3595,3503190,3820238,481820706,0,3841,980392,3738,957422,103,22970,1904,6,3721,79,0,31,216660.0,130000.0,-51.0,-51.0,-45.0,-48.0,-51.0,-49.0,-43.0,-46.0,-90.0,-93.0,-89.0,-93.0,39.0,42.0,44.0,45.0,0
3058,CC:2F:71:3F:1F:24,4428901,1172894923,608663,691074217,3820238,481820706,37,504135,559650780,503551,559580392,584,70388,486465,10,608900,52294,34,432,130000.0,43333.0,-67.0,-65.0,-70.0,-68.0,-67.0,-65.0,-70.0,-67.0,-90.0,-93.0,-89.0,-93.0,23.0,28.0,19.0,25.0,0
3059,CC:2F:71:3E:C5:1F,3820950,481907709,712,87003,3820238,481820706,0,3019,253081,2497,191041,522,62040,754,8,1043,18,0,32,130000.0,39000.0,-71.0,-71.0,-67.0,-60.0,-71.0,-72.0,-68.0,-61.0,-90.0,-93.0,-89.0,-93.0,19.0,22.0,22.0,33.0,0
3060,BA:8C:B9:54:50:24,3824784,487943010,4546,6122304,3820238,481820706,0,7834,1605296,7813,1601939,21,3357,2291,14,4921,35,0,50,229410.0,130000.0,-39.0,-36.0,-44.0,-51.0,-41.0,-34.0,-42.0,-47.0,-90.0,-93.0,-89.0,-93.0,51.0,57.0,45.0,42.0,0
3061,92:69:1D:31:68:E9,3823835,485324098,3595,3503190,3820240,481820908,0,3841,980392,3738,957422,103,22970,1904,6,3721,79,0,31,216660.0,130000.0,-51.0,-51.0,-45.0,-48.0,-51.0,-49.0,-43.0,-46.0,-90.0,-93.0,-89.0,-93.0,39.0,42.0,44.0,45.0,0
3062,CC:2F:71:3F:1F:24,4428948,1172909991,608706,691088881,3820242,481821110,37,504161,559655700,503577,559585312,584,70388,486491,10,608943,52302,34,432,130000.0,43333.0,-67.0,-65.0,-70.0,-68.0,-67.0,-65.0,-70.0,-67.0,-90.0,-93.0,-89.0,-93.0,23.0,28.0,19.0,25.0,0
3063,CC:2F:71:3E:C5:1F,3820954,481908113,712,87003,3820242,481821110,0,3019,253081,2497,191041,522,62040,754,8,1043,18,0,32,130000.0,39000.0,-71.0,-71.0,-67.0,-60.0,-71.0,-72.0,-68.0,-61.0,-90.0,-93.0,-89.0,-93.0,19.0,22.0,22.0,33.0,0
3064,BA:8C:B9:54:50:24,3824790,487943616,4546,6122304,3820244,481821312,0,7834,1605296,7813,1601939,21,3357,2291,14,4921,35,0,50,229410.0,130000.0,-39.0,-36.0,-44.0,-51.0,-41.0,-34.0,-42.0,-47.0,-90.0,-93.0,-89.0,-93.0,51.0,57.0,45.0,42.0,0
3065,92:69:1D:31:68:E9,3823855,485330425,3595,3503190,3820260,481827235,0,3844,980763,3740,957558,104,23205,1905,6,3721,79,0,31,216660.0,130000.0,-52.0,-50.0,-44.0,-46.0,-51.0,-49.0,-43.0,-47.0,-90.0,-93.0,-90.0,-93.0,38.0,43.0,46.0,47.0,0
3066,CC:2F:71:3F:1F:24,4429008,1172930600,608748,691103365,3820260,481827235,37,504188,559660762,503603,559590256,585,70506,486518,10,608985,52320,34,432,130000.0,39000.0,-67.0,-65.0,-70.0,-68.0,-67.0,-65.0,-70.0,-67.0,-90.0,-93.0,-90.0,-93.0,23.0,28.0,20.0,25.0,0
3067,CC:2F:71:3E:C5:1F,3820972,481914238,712,87003,3820260,481827235,0,3019,253081,2497,191041,522,62040,754,8,1043,18,0,32,130000.0,39000.0,-71.0,-71.0,-67.0,-60.0,-71.0,-72.0,-68.0,-61.0,-90.0,-93.0,-90.0,-93.0,19.0,22.0,23.0,33.0,0
3068,BA:8C:B9:54:50:24,3824817,487954963,4546,6122304,3820271,481832659,0,7834,1605296,7813,1601939,21,3357,2291,14,4921,35,0,50,229410.0,130000.0,-39.0,-36.0,-44.0,-51.0,-41.0,-34.0,-42.0,-47.0,-90.0,-93.0,-90.0,-93.0,51.0,57.0,46.0,42.0,0
3069,92:69:1D:31:68:E9,3823869,485336324,3595,3503190,3820274,481833134,0,3844,980763,3740,957558,104,23205,1905,6,3721,79,0,31,216660.0,130000.0,-52.0,-50.0,-44.0,-46.0,-51.0,-49.0,-43.0,-47.0,-90.0,-93.0,-90.0,-93.0,38.0,43.0,46.0,47.0,0
3070,CC:2F:71:3F:1F:24,4429065,1172950943,608789,691117607,3820276,481833336,37,504214,559665706,503629,559595200,585,70506,486544,10,609026,52331,34,432,130000.0,43333.0,-67.0,-65.0,-71.0,-68.0,-67.0,-65.0,-70.0,-67.0,-90.0,-93.0,-90.0,-93.0,23.0,28.0,19.0,25.0,0
3071,CC:2F:71:3E:C5:1F,3820988,481920339,712,87003,3820276,481833336,0,3019,253081,2497,191041,522,62040,754,8,1043,18,0,32,130000.0,39000.0,-71.0,-71.0,-67.0,-60.0,-71.0,-72.0,-68.0,-61.0,-90.0,-93.0,-90.0,-93.0,19.0,22.0,23.0,33.0,0
3072,BA:8C:B9:54:50:24,3824824,487955842,4546,6122304,3820278,481833538,0,7834,1605296,7813,1601939,21,3357,2291,14,4921,35,0,50,229410.0,130000.0,-39.0,-36.0,-44.0,-51.0,-41.0,-34.0,-42.0,-47.0,-90.0,-93.0,-90.0,-93.0,51.0,57.0,46.0,42.0,0
3073,92:69:1D:31:68:E9,3823875,485336930,3595,3503190,3820280,481833740,0,3844,980763,3740,957558,104,23205,1905,6,3721,79,0,31,216660.0,130000.0,-52.0,-50.0,-44.0,-46.0,-51.0,-49.0,-43.0,-47.0,-90.0,-93.0,-90.0,-93.0,38.0,43.0,46.0,47.0,0
3074,CC:2F:71:3F:1F:24,4429111,1172965775,608831,691132035,3820280,481833740,37,504241,559670766,503656,559600260,585,70506,486571,10,609068,52347,34,432,117000.0,39000.0,-67.0,-65.0,-70.0,-68.0,-67.0,-65.0,-70.0,-67.0,-90.0,-93.0,-90.0,-93.0,23.0,28.0,20.0,25.0,0
3075,CC:2F:71:3E:C5:1F,3820993,481920803,712,87003,3820281,481833800,0,3019,253081,2497,191041,522,62040,754,8,1043,18,0,32,130000.0,39000.0,-71.0,-71.0,-67.0,-60.0,-71.0,-72.0,-68.0,-61.0,-90.0,-93.0,-90.0,-93.0,19.0,22.0,23.0,33.0,0
3076,BA:8C:B9:54:50:24,3824827,487956104,4546,6122304,3820281,481833800,0,7834,1605296,7813,1601939,21,3357,2291,14,4921,35,0,50,229410.0,130000.0,-39.0,-36.0,-44.0,-51.0,-41.0,-34.0,-42.0,-47.0,-90.0,-93.0,-90.0,-93.0,51.0,57.0,46.0,42.0,0
3077,92:69:1D:31:68:E9,3823878,485337192,3595,3503190,3820283,481834002,0,3844,980763,3740,957558,104,23205,1905,6,3721,79,0,31,216660.0,130000.0,-52.0,-50.0,-44.0,-46.0,-51.0,-49.0,-43.0,-47.0,-90.0,-93.0,-90.0,-93.0,38.0,43.0,46.0,47.0,0
3078,CC:2F:71:3F:1F:24,4429157,1172980543,608872,691146339,3820285,481834204,37,504269,559675990,503684,559605484,585,70506,486599,10,609109,52357,34,432,130000.0,43333.0,-67.0,-65.0,-71.0,-68.0,-67.0,-65.0,-70.0,-67.0,-90.0,-93.0,-90.0,-93.0,23.0,28.0,19.0,25.0,0
3079,CC:2F:71:3E:C5:1F,3820997,481921207,712,87003,3820285,481834204,0,3019,253081,2497,191041,522,62040,754,8,1043,18,0,32,130000.0,39000.0,-71.0,-71.0,-67.0,-60.0,-71.0,-72.0,-68.0,-61.0,-90.0,-93.0,-90.0,-93.0,19.0,22.0,23.0,33.0,0
3080,BA:8C:B9:54:50:24,3824833,487956710,4546,6122304,3820287,481834406,0,7834,1605296,7813,1601939,21,3357,2291,14,4921,35,0,50,229410.0,130000.0,-39.0,-36.0,-44.0,-51.0,-41.0,-34.0,-42.0,-47.0,-90.0,-93.0,-90.0,-93.0,51.0,57.0,46.0,42.0,0
3081,92:69:1D:31:68:E9,3823884,485337798,3595,3503190,3820289,481834608,0,3844,980763,3740,957558,104,23205,1905,6,3721,79,0,31,216660.0,130000.0,-52.0,-50.0,-44.0,-46.0,-51.0,-49.0,-43.0,-47.0,-90.0,-93.0,-90.0,-93.0,38.0,43.0,46.0,47.0,0
3082,CC:2F:71:3F:1F:24,4429203,1172995487,608914,691160879,3820289,481834608,37,504296,559681074,503711,559610568,585,70506,486626,10,609151,52362,34,432,130000.0,43333.0,-67.0,-65.0,-71.0,-68.0,-67.0,-65.0,-70.0,-67.0,-90.0,-93.0,-90.0,-93.0,23.0,28.0,19.0,25.0,0
3083,CC:2F:71:3E:C5:1F,3821001,481921611,712,87003,3820289,481834608,0,3019,253081,2497,191041,522,62040,754,8,1043,18,0,32,130000.0,39000.0,-71.0,-71.0,-67.0,-60.0,-71.0,-72.0,-68.0,-61.0,-90.0,-93.0,-90.0,-93.0,19.0,22.0,23.0,33.0,0
3084,BA:8C:B9:54:50:24,3824835,487956912,4546,6122304,3820289,481834608,0,7834,1605296,7813,1601939,21,3357,2291,14,4921,35,0,50,229410.0,130000.0,-39.0,-36.0,-44.0,-51.0,-41.0,-34.0,-42.0,-47.0,-90.0,-93.0,-90.0,-93.0,51.0,57.0,46.0,42.0,0
3085,92:69:1D:31:68:E9,3823887,485338226,3595,3503190,3820292,481835036,0,3844,980763,3740,957558,104,23205,1905,6,3721,79,0,31,216660.0,130000.0,-52.0,-50.0,-44.0,-46.0,-51.0,-49.0,-43.0,-47.0,-90.0,-93.0,-90.0,-93.0,38.0,43.0,46.0,47.0,0
3086,CC:2F:71:3F:1F:24,4429251,1173010669,608957,691175431,3820294,481835238,37,504323,559686110,503738,559615604,585,70506,486653,10,609194,52380,34,432,117000.0,39000.0,-67.0,-65.0,-70.0,-68.0,-67.0,-65.0,-70.0,-67.0,-90.0,-93.0,-90.0,-93.0,23.0,28.0,20.0,25.0,0
3087,CC:2F:71:3E:C5:1F,3821006,481922241,712,87003,3820294,481835238,0,3019,253081,2497,191041,522,62040,754,8,1043,18,0,32,130000.0,39000.0,-71.0,-71.0,-67.0,-60.0,-71.0,-72.0,-68.0,-61.0,-90.0,-93.0,-90.0,-93.0,19.0,22.0,23.0,33.0,0
3088,BA:8C:B9:54:50:24,3824844,487957946,4546,6122304,3820298,481835642,0,7834,1605296,7813,1601939,21,3357,2291,14,4921,35,0,50,229410.0,130000.0,-39.0,-36.0,-44.0,-51.0,-41.0,-34.0,-42.0,-47.0,-90.0,-93.0,-90.0,-93.0,51.0,57.0,46.0,42.0,0
3089,92:69:1D:31:68:E9,3823895,485339034,3595,3503190,3820300,481835844,0,3844,980763,3740,957558,104,23205,1905,6,3721,79,0,31,216660.0,130000.0,-52.0,-50.0,-44.0,-46.0,-51.0,-49.0,-43.0,-47.0,-90.0,-93.0,-90.0,-93.0,38.0,43.0,46.0,47.0,0
3090,CC:2F:71:3F:1F:24,4429298,1173025585,608998,691189741,3820300,481835844,37,504351,559691286,503766,559620780,585,70506,486681,10,609235,52382,34,432,130000.0,43333.0,-67.0,-65.0,-70.0,-67.0,-67.0,-65.0,-70.0,-67.0,-90.0,-93.0,-90.0,-93.0,23.0,28.0,20.0,26.0,0
3091,CC:2F:71:3E:C5:1F,3821012,481922847,712,87003,3820300,481835844,0,3019,253081,2497,191041,522,62040,754,8,1043,18,0,32,130000.0,39000.0,-71.0,-71.0,-67.0,-60.0,-71.0,-72.0,-68.0,-61.0,-90.0,-93.0,-90.0,-93.0,19.0,22.0,23.0,33.0,0
3092,BA:8C:B9:54:50:24,3824846,487958148,4546,6122304,3820300,481835844,0,7834,1605296,7813,1601939,21,3357,2291,14,4921,35,0,50,229410.0,130000.0,-39.0,-36.0,-44.0,-51.0,-41.0,-34.0,-42.0,-47.0,-90.0,-93.0,-90.0,-93.0,51.0,57.0,46.0,42.0,0
3093,92:69:1D:31:68:E9,3823895,485339034,3595,3503190,3820300,481835844,0,3844,980763,3740,957558,104,23205,1905,6,3721,79,0,31,216660.0,130000.0,-52.0,-50.0,-44.0,-46.0,-51.0,-49.0,-43.0,-47.0,-90.0,-93.0,-90.0,-93.0,38.0,43.0,46.0,47.0,0
3094,CC:2F:71:3F:1F:24,4429343,1173040481,609041,691204435,3820302,481836046,37,504383,559696914,503798,559626408,585,70506,486713,10,609278,52386,34,432,130000.0,43333.0,-67.0,-65.0,-71.0,-67.0,-67.0,-65.0,-70.0,-67.0,-90.0,-93.0,-90.0,-93.0,23.0,28.0,19.0,26.0,0
3095,CC:2F:71:3E:C5:1F,3821014,481923049,712,87003,3820302,481836046,0,3019,253081,2497,191041,522,62040,754,8,1043,18,0,32,130000.0,39000.0,-71.0,-71.0,-67.0,-60.0,-71.0,-72.0,-68.0,-61.0,-90.0,-93.0,-90.0,-93.0,19.0,22.0,23.0,33.0,0
3096,BA:8C:B9:54:50:24,3824852,487958754,4546,6122304,3820306,481836450,0,7834,1605296,7813,1601939,21,3357,2291,14,4921,35,0,50,229410.0,130000.0,-39.0,-36.0,-44.0,-51.0,-41.0,-34.0,-42.0,-47.0,-90.0,-93.0,-90.0,-93.0,51.0,57.0,46.0,42.0,0
3097,92:69:1D:31:68:E9,3823904,485339902,3595,3503190,3820309,481836712,0,3844,980763,3740,957558,104,23205,1905,6,3721,79,0,31,216660.0,130000.0,-52.0,-50.0,-44.0,-46.0,-51.0,-49.0,-43.0,-47.0,-90.0,-93.0,-90.0,-93.0,38.0,43.0,46.0,47.0,0
3098,CC:2F:71:3F:1F:24,4429391,1173055451,609082,691218739,3820309,481836712,37,504409,559701858,503824,559631352,585,70506,486739,10,609319,52413,34,432,117000.0,39000.0,-67.0,-65.0,-70.0,-68.0,-67.0,-65.0,-70.0,-67.0,-90.0,-93.0,-90.0,-93.0,23.0,28.0,20.0,25.0,0
3099,CC:2F:71:3E:C5:1F,3821021,481923715,712,87003,3820309,481836712,0,3019,253081,2497,191041,522,62040,754,8,1043,18,0,32,130000.0,39000.0,-71.0,-71.0,-67.0,-60.0,-71.0,-72.0,-68.0,-61.0,-90.0,-93.0,-90.0,-93.0,19.0,22.0,23.0,33.0,0
3100,BA:8C:B9:54:50:24,3824855,487959016,4546,6122304,3820309,481836712,0,7834,1605296,7813,1601939,21,3357,2291,14,4921,35,0,50,229410.0,130000.0,-39.0,-36.0,-44.0,-51.0,-41.0,-34.0,-42.0,-47.0,-90.0,-93.0,-90.0,-93.0,51.0,57.0,46.0,42.0,0
3101,92:69:1D:31:68:E9,3823906,485340104,3595,3503190,3820311,481836914,0,3844,980763,3740,957558,104,23205,1905,6,3721,79,0,31,216660.0,130000.0,-52.0,-50.0,-44.0,-46.0,-51.0,-49.0,-43.0,-47.0,-90.0,-93.0,-90.0,-93.0,38.0,43.0,46.0,47.0,0
3102,CC:2F:71:3F:1F:24,4429434,1173069957,609123,691233043,3820311,481836914,37,504436,559706918,503851,559636412,585,70506,486766,10,609360,52426,34,432,130000.0,39000.0,-67.0,-65.0,-70.0,-67.0,-67.0,-65.0,-70.0,-67.0,-90.0,-93.0,-90.0,-93.0,23.0,28.0,20.0,26.0,0
3103,CC:2F:71:3E:C5:1F,3821027,481924321,712,87003,3820315,481837318,0,3019,253081,2497,191041,522,62040,754,8,1043,18,0,32,130000.0,39000.0,-71.0,-71.0,-67.0,-60.0,-71.0,-72.0,-68.0,-61.0,-90.0,-93.0,-90.0,-93.0,19.0,22.0,23.0,33.0,0
3104,BA:8C:B9:54:50:24,3824861,487959622,4546,6122304,3820315,481837318,0,7834,1605296,7813,1601939,21,3357,2291,14,4921,35,0,50,229410.0,130000.0,-39.0,-36.0,-44.0,-51.0,-41.0,-34.0,-42.0,-47.0,-90.0,-93.0,-90.0,-93.0,51.0,57.0,46.0,42.0,0
3105,92:69:1D:31:68:E9,3823912,485340710,3595,3503190,3820317,481837520,0,3844,980763,3740,957558,104,23205,1905,6,3721,79,0,31,216660.0,130000.0,-52.0,-50.0,-44.0,-46.0,-51.0,-49.0,-43.0,-47.0,-90.0,-93.0,-90.0,-93.0,38.0,43.0,46.0,47.0,0
3106,CC:2F:71:3F:1F:24,4429482,1173084871,609164,691247291,3820318,481837580,37,504461,559711722,503876,559641216,585,70506,486791,10,609401,52445,34,432,130000.0,39000.0,-67.0,-65.0,-70.0,-67.0,-67.0,-65.0,-70.0,-67.0,-90.0,-93.0,-90.0,-93.0,23.0,28.0,20.0,26.0,0
3107,CC:2F:71:3E:C5:1F,3821030,481924583,712,87003,3820318,481837580,0,3019,253081,2497,191041,522,62040,754,8,1043,18,0,32,130000.0,39000.0,-71.0,-71.0,-67.0,-60.0,-71.0,-72.0,-68.0,-61.0,-90.0,-93.0,-90.0,-93.0,19.0,22.0,23.0,33.0,0
3108,BA:8C:B9:54:50:24,3824864,487959884,4546,6122304,3820318,481837580,0,7834,1605296,7813,1601939,21,3357,2291,14,4921,35,0,50,229410.0,130000.0,-39.0,-36.0,-44.0,-51.0,-41.0,-34.0,-42.0,-47.0,-90.0,-93.0,-90.0,-93.0,51.0,57.0,46.0,42.0,0
3109,92:69:1D:31:68:E9,3823915,485340972,3595,3503190,3820320,481837782,0,3844,980763,3740,957558,104,23205,1905,6,3721,79,0,31,216660.0,130000.0,-52.0,-50.0,-44.0,-46.0,-51.0,-49.0,-43.0,-47.0,-90.0,-93.0,-90.0,-93.0,38.0,43.0,46.0,47.0,0
3110,CC:2F:71:3F:1F:24,4429526,1173099557,609206,691261775,3820320,481837782,37,504487,559716666,503902,559646160,585,70506,486817,10,609443,52460,34,432,130000.0,43333.0,-67.0,-65.0,-70.0,-67.0,-67.0,-65.0,-70.0,-67.0,-90.0,-93.0,-90.0,-93.0,23.0,28.0,20.0,26.0,0
3111,CC:2F:71:3E:C5:1F,3821032,481924785,712,87003,3820320,481837782,0,3019,253081,2497,191041,522,62040,754,8,1043,18,0,32,130000.0,39000.0,-71.0,-71.0,-67.0,-60.0,-71.0,-72.0,-68.0,-61.0,-90.0,-93.0,-90.0,-93.0,19.0,22.0,23.0,33.0,0
3112,BA:8C:B9:54:50:24,3824870,487960490,4546,6122304,3820324,481838186,0,7834,1605296,7813,1601939,21,3357,2291,14,4921,35,0,50,229410.0,130000.0,-39.0,-36.0,-44.0,-51.0,-41.0,-34.0,-42.0,-47.0,-90.0,-93.0,-90.0,-93.0,51.0,57.0,46.0,42.0,0
3113,92:69:1D:31:68:E9,3823921,485341578,3595,3503190,3820326,481838388,0,3844,980763,3740,957558,104,23205,1905,6,3721,79,0,31,216660.0,130000.0,-52.0,-50.0,-44.0,-46.0,-51.0,-49.0,-43.0,-47.0,-90.0,-93.0,-90.0,-93.0,38.0,43.0,46.0,47.0,0
3114,CC:2F:71:3F:1F:24,4429574,1173114591,609248,691276203,3820326,481838388,37,504513,559721610,503928,559651104,585,70506,486843,10,609485,52503,34,432,144444.0,39000.0,-67.0,-65.0,-70.0,-67.0,-67.0,-65.0,-70.0,-67.0,-90.0,-93.0,-90.0,-93.0,23.0,28.0,20.0,26.0,0
3115,CC:2F:71:3E:C5:1F,3821038,481925391,712,87003,3820326,481838388,0,3019,253081,2497,191041,522,62040,754,8,1043,18,0,32,130000.0,39000.0,-71.0,-71.0,-67.0,-60.0,-71.0,-72.0,-68.0,-61.0,-90.0,-93.0,-90.0,-93.0,19.0,22.0,23.0,33.0,0
3116,BA:8C:B9:54:50:24,3824872,487960692,4546,6122304,3820326,481838388,0,7834,1605296,7813,1601939,21,3357,2291,14,4921,35,0,50,229410.0,130000.0,-39.0,-36.0,-44.0,-51.0,-41.0,-34.0,-42.0,-47.0,-90.0,-93.0,-90.0,-93.0,51.0,57.0,46.0,42.0,0
3117,92:69:1D:31:68:E9,3823924,485341840,3595,3503190,3820329,481838650,0,3844,980763,3740,957558,104,23205,1905,6,3721,79,0,31,216660.0,130000.0,-52.0,-50.0,-44.0,-46.0,-51.0,-49.0,-43.0,-47.0,-90.0,-93.0,-90.0,-93.0,38.0,43.0,46.0,47.0,0
3118,CC:2F:71:3F:1F:24,4429619,1173129113,609290,691290463,3820329,481838650,37,504539,559726554,503954,559656048,585,70506,486869,10,609527,52536,34,432,117000.0,39000.0,-67.0,-65.0,-70.0,-68.0,-67.0,-65.0,-70.0,-67.0,-90.0,-93.0,-90.0,-93.0,23.0,28.0,20.0,25.0,0
3119,CC:2F:71:3E:C5:1F,3821041,481925653,712,87003,3820329,481838650,0,3019,253081,2497,191041,522,62040,754,8,1043,18,0,32,130000.0,39000.0,-71.0,-71.0,-67.0,-60.0,-71.0,-72.0,-68.0,-61.0,-90.0,-93.0,-90.0,-93.0,19.0,22.0,23.0,33.0,0
3120,BA:8C:B9:54:50:24,3824879,487961358,4546,6122304,3820333,481839054,0,7834,1605296,7813,1601939,21,3357,2291,14,4921,35,0,50,229410.0,130000.0,-39.0,-36.0,-44.0,-51.0,-41.0,-34.0,-42.0,-47.0,-90.0,-93.0,-90.0,-93.0,51.0,57.0,46.0,42.0,0
3121,92:69:1D:31:68:E9,3823931,485342562,3596,3503306,3820335,481839256,0,3846,980899,3742,957694,104,23205,1905,6,3722,79,0,31,216660.0,130000.0,-52.0,-50.0,-44.0,-46.0,-51.0,-49.0,-43.0,-47.0,-91.0,-93.0,-90.0,-93.0,39.0,43.0,46.0,47.0,0
3122,CC:2F:71:3F:1F:24,4429668,1173144207,609333,691304951,3820335,481839256,37,504566,559731614,503981,559661108,585,70506,486896,10,609570,52547,34,432,117000.0,39000.0,-67.0,-65.0,-71.0,-68.0,-67.0,-65.0,-70.0,-68.0,-91.0,-93.0,-90.0,-93.0,24.0,28.0,19.0,25.0,0
3123,CC:2F:71:3E:C5:1F,3821049,481926648,713,87119,3820336,481839529,0,3021,253221,2499,191181,522,62040,754,8,1044,18,0,32,130000.0,39000.0,-70.0,-71.0,-67.0,-60.0,-71.0,-72.0,-68.0,-61.0,-91.0,-93.0,-90.0,-93.0,21.0,22.0,23.0,33.0,0
3124,BA:8C:B9:54:50:24,3824883,487961949,4547,6122420,3820336,481839529,0,7840,1605704,7819,1602347,21,3357,2291,14,4922,35,0,50,229410.0,137640.0,-49.0,-35.0,-42.0,-44.0,-41.0,-34.0,-42.0,-46.0,-91.0,-93.0,-90.0,-93.0,42.0,58.0,48.0,49.0,0
3125,92:69:1D:31:68:E9,3823934,485343037,3596,3503306,3820338,481839731,0,3846,980899,3742,957694,104,23205,1905,6,3722,79,0,31,216660.0,130000.0,-52.0,-50.0,-44.0,-46.0,-51.0,-49.0,-43.0,-47.0,-91.0,-93.0,-90.0,-93.0,39.0,43.0,46.0,47.0,0
3126,CC:2F:71:3F:1F:24,4429713,1173159054,609375,691319323,3820338,481839731,37,504592,559736558,504007,559666052,585,70506,486922,10,609612,52563,34,432,130000.0,39000.0,-68.0,-66.0,-71.0,-67.0,-67.0,-65.0,-70.0,-67.0,-91.0,-93.0,-90.0,-93.0,23.0,27.0,19.0,26.0,0
3127,CC:2F:71:3E:C5:1F,3821051,481926850,713,87119,3820338,481839731,0,3021,253221,2499,191181,522,62040,754,8,1044,18,0,32,130000.0,39000.0,-70.0,-71.0,-67.0,-60.0,-71.0,-72.0,-68.0,-61.0,-91.0,-93.0,-90.0,-93.0,21.0,22.0,23.0,33.0,0
3128,BA:8C:B9:54:50:24,3824887,487962353,4547,6122420,3820340,481839933,0,7840,1605704,7819,1602347,21,3357,2291,14,4922,35,0,50,229410.0,137640.0,-49.0,-35.0,-42.0,-44.0,-41.0,-34.0,-42.0,-46.0,-91.0,-93.0,-90.0,-93.0,42.0,58.0,48.0,49.0,0
3129,92:69:1D:31:68:E9,3823942,485343765,3596,3503306,3820346,481840459,0,3846,980899,3742,957694,104,23205,1905,6,3722,79,0,31,216660.0,130000.0,-52.0,-50.0,-44.0,-46.0,-51.0,-49.0,-43.0,-47.0,-91.0,-93.0,-90.0,-93.0,39.0,43.0,46.0,47.0,0
3130,CC:2F:71:3F:1F:24,4429763,1173174210,609417,691333751,3820346,481840459,37,504618,559741480,504032,559670856,586,70624,486948,10,609654,52582,34,432,130000.0,43333.0,-67.0,-65.0,-71.0,-68.0,-67.0,-65.0,-70.0,-68.0,-91.0,-93.0,-90.0,-93.0,24.0,28.0,19.0,25.0,0
3131,CC:2F:71:3E:C5:1F,3821059,481927578,713,87119,3820346,481840459,0,3021,253221,2499,191181,522,62040,754,8,1044,18,0,32,130000.0,39000.0,-70.0,-71.0,-67.0,-60.0,-71.0,-72.0,-68.0,-61.0,-91.0,-93.0,-90.0,-93.0,21.0,22.0,23.0,33.0,0
3132,BA:8C:B9:54:50:24,3824893,487962879,4547,6122420,3820346,481840459,0,7841,1605772,7820,1602415,21,3357,2291,14,4922,35,0,50,229410.0,137640.0,-40.0,-37.0,-44.0,-51.0,-41.0,-34.0,-42.0,-47.0,-91.0,-93.0,-90.0,-93.0,51.0,56.0,46.0,42.0,0
3133,92:69:1D:31:68:E9,3823944,485343967,3596,3503306,3820348,481840661,0,3846,980899,3742,957694,104,23205,1905,6,3722,79,0,31,216660.0,130000.0,-52.0,-50.0,-44.0,-46.0,-51.0,-49.0,-43.0,-47.0,-91.0,-93.0,-90.0,-93.0,39.0,43.0,46.0,47.0,0
3134,CC:2F:71:3F:1F:24,4429806,1173188660,609458,691347999,3820348,481840661,37,504645,559746682,504059,559676058,586,70624,486974,10,609695,52601,34,432,117000.0,39000.0,-68.0,-65.0,-71.0,-67.0,-67.0,-65.0,-70.0,-67.0,-91.0,-93.0,-90.0,-93.0,23.0,28.0,19.0,26.0,0
3135,CC:2F:71:3E:C5:1F,3821061,481927780,713,87119,3820348,481840661,0,3021,253221,2499,191181,522,62040,754,8,1044,18,0,32,130000.0,39000.0,-70.0,-71.0,-67.0,-60.0,-71.0,-72.0,-68.0,-61.0,-91.0,-93.0,-90.0,-93.0,21.0,22.0,23.0,33.0,0
3136,BA:8C:B9:54:50:24,3824897,487963283,4547,6122420,3820350,481840863,0,7841,1605772,7820,1602415,21,3357,2291,14,4922,35,0,50,229410.0,137640.0,-40.0,-37.0,-44.0,-51.0,-41.0,-34.0,-42.0,-47.0,-91.0,-93.0,-90.0,-93.0,51.0,56.0,46.0,42.0,0
3137,92:69:1D:31:68:E9,3823951,485344633,3596,3503306,3820355,481841327,0,3846,980899,3742,957694,104,23205,1905,6,3722,79,0,31,216660.0,130000.0,-52.0,-50.0,-44.0,-46.0,-51.0,-49.0,-43.0,-47.0,-91.0,-93.0,-90.0,-93.0,39.0,43.0,46.0,47.0,0
3138,CC:2F:71:3F:1F:24,4429856,1173203878,609501,691362551,3820355,481841327,37,504672,559751766,504086,559681142,586,70624,487001,10,609738,52609,34,432,130000.0,43333.0,-67.0,-66.0,-71.0,-68.0,-67.0,-65.0,-70.0,-68.0,-91.0,-93.0,-90.0,-93.0,24.0,27.0,19.0,25.0,0
3139,CC:2F:71:3E:C5:1F,3821068,481928446,713,87119,3820355,481841327,0,3021,253221,2499,191181,522,62040,754,8,1044,18,0,32,130000.0,39000.0,-70.0,-71.0,-67.0,-60.0,-71.0,-72.0,-68.0,-61.0,-91.0,-93.0,-90.0,-93.0,21.0,22.0,23.0,33.0,0
3140,BA:8C:B9:54:50:24,3824902,487963747,4547,6122420,3820355,481841327,0,7841,1605772,7820,1602415,21,3357,2291,14,4922,35,0,50,229410.0,137640.0,-40.0,-37.0,-44.0,-51.0,-41.0,-34.0,-42.0,-47.0,-91.0,-93.0,-90.0,-93.0,51.0,56.0,46.0,42.0,0
3141,92:69:1D:31:68:E9,3823953,485344835,3596,3503306,3820357,481841529,0,3846,980899,3742,957694,104,23205,1905,6,3722,79,0,31,216660.0,130000.0,-52.0,-50.0,-44.0,-46.0,-51.0,-49.0,-43.0,-47.0,-91.0,-93.0,-90.0,-93.0,39.0,43.0,46.0,47.0,0
3142,CC:2F:71:3F:1F:24,4429901,1173218638,609544,691377109,3820357,481841529,37,504699,559756850,504113,559686226,586,70624,487028,10,609781,52628,34,432,117000.0,39000.0,-67.0,-65.0,-71.0,-68.0,-67.0,-65.0,-70.0,-67.0,-91.0,-93.0,-90.0,-93.0,24.0,28.0,19.0,25.0,0
3143,CC:2F:71:3E:C5:1F,3821070,481928648,713,87119,3820357,481841529,0,3021,253221,2499,191181,522,62040,754,8,1044,18,0,32,130000.0,39000.0,-70.0,-71.0,-67.0,-60.0,-71.0,-72.0,-68.0,-61.0,-91.0,-93.0,-90.0,-93.0,21.0,22.0,23.0,33.0,0
3144,BA:8C:B9:54:50:24,3824906,487964151,4547,6122420,3820359,481841731,0,7841,1605772,7820,1602415,21,3357,2291,14,4922,35,0,50,229410.0,137640.0,-40.0,-37.0,-44.0,-51.0,-41.0,-34.0,-42.0,-47.0,-91.0,-93.0,-90.0,-93.0,51.0,56.0,46.0,42.0,0
3145,92:69:1D:31:68:E9,3823959,485345441,3596,3503306,3820363,481842135,0,3846,980899,3742,957694,104,23205,1905,6,3722,79,0,31,216660.0,130000.0,-52.0,-50.0,-44.0,-46.0,-51.0,-49.0,-43.0,-47.0,-91.0,-93.0,-90.0,-93.0,39.0,43.0,46.0,47.0,0
3146,CC:2F:71:3F:1F:24,4429949,1173233672,609586,691391537,3820363,481842135,37,504724,559761654,504138,559691030,586,70624,487053,10,609823,52636,34,432,130000.0,43333.0,-67.0,-65.0,-70.0,-68.0,-67.0,-65.0,-70.0,-67.0,-91.0,-93.0,-90.0,-93.0,24.0,28.0,20.0,25.0,0
3147,CC:2F:71:3E:C5:1F,3821076,481929254,713,87119,3820363,481842135,0,3021,253221,2499,191181,522,62040,754,8,1044,18,0,32,130000.0,39000.0,-70.0,-71.0,-67.0,-60.0,-71.0,-72.0,-68.0,-61.0,-91.0,-93.0,-90.0,-93.0,21.0,22.0,23.0,33.0,0
3148,BA:8C:B9:54:50:24,3824910,487964555,4547,6122420,3820363,481842135,0,7841,1605772,7820,1602415,21,3357,2291,14,4922,35,0,50,229410.0,137640.0,-40.0,-37.0,-44.0,-51.0,-41.0,-34.0,-42.0,-47.0,-91.0,-93.0,-90.0,-93.0,51.0,56.0,46.0,42.0,0
3149,92:69:1D:31:68:E9,3823962,485345703,3596,3503306,3820366,481842397,0,3846,980899,3742,957694,104,23205,1905,6,3722,79,0,31,216660.0,130000.0,-52.0,-50.0,-44.0,-46.0,-51.0,-49.0,-43.0,-47.0,-91.0,-93.0,-90.0,-93.0,39.0,43.0,46.0,47.0,0
3150,CC:2F:71:3F:1F:24,4429994,1173248418,609628,691406021,3820366,481842397,37,504752,559766830,504166,559696206,586,70624,487081,10,609865,52661,34,432,130000.0,39000.0,-67.0,-66.0,-71.0,-68.0,-67.0,-65.0,-70.0,-68.0,-91.0,-93.0,-90.0,-93.0,24.0,27.0,19.0,25.0,0
3151,CC:2F:71:3E:C5:1F,3821079,481929516,713,87119,3820366,481842397,0,3021,253221,2499,191181,522,62040,754,8,1044,18,0,32,130000.0,39000.0,-70.0,-71.0,-67.0,-60.0,-71.0,-72.0,-68.0,-61.0,-91.0,-93.0,-90.0,-93.0,21.0,22.0,23.0,33.0,0
3152,BA:8C:B9:54:50:24,3824915,487965019,4547,6122420,3820368,481842599,0,7841,1605772,7820,1602415,21,3357,2291,14,4922,35,0,50,229410.0,137640.0,-40.0,-37.0,-44.0,-51.0,-41.0,-34.0,-42.0,-47.0,-91.0,-93.0,-90.0,-93.0,51.0,56.0,46.0,42.0,0
3153,92:69:1D:31:68:E9,3823968,485346309,3596,3503306,3820372,481843003,0,3846,980899,3742,957694,104,23205,1905,6,3722,79,0,31,216660.0,130000.0,-52.0,-50.0,-44.0,-46.0,-51.0,-49.0,-43.0,-47.0,-91.0,-93.0,-90.0,-93.0,39.0,43.0,46.0,47.0,0
3154,CC:2F:71:3F:1F:24,4430042,1173263396,609670,691420393,3820372,481843003,37,504777,559771634,504191,559701010,586,70624,487106,10,609907,52668,34,432,130000.0,43333.0,-67.0,-65.0,-70.0,-68.0,-67.0,-65.0,-70.0,-68.0,-91.0,-93.0,-90.0,-93.0,24.0,28.0,20.0,25.0,0
3155,CC:2F:71:3E:C5:1F,3821085,481930122,713,87119,3820372,481843003,0,3021,253221,2499,191181,522,62040,754,8,1044,18,0,32,130000.0,39000.0,-70.0,-71.0,-67.0,-60.0,-71.0,-72.0,-68.0,-61.0,-91.0,-93.0,-90.0,-93.0,21.0,22.0,23.0,33.0,0
3156,BA:8C:B9:54:50:24,3824919,487965423,4547,6122420,3820372,481843003,0,7841,1605772,7820,1602415,21,3357,2291,14,4922,35,0,50,229410.0,137640.0,-40.0,-37.0,-44.0,-51.0,-41.0,-34.0,-42.0,-47.0,-91.0,-93.0,-90.0,-93.0,51.0,56.0,46.0,42.0,0
3157,92:69:1D:31:68:E9,3823970,485346511,3596,3503306,3820374,481843205,0,3846,980899,3742,957694,104,23205,1905,6,3722,79,0,31,216660.0,130000.0,-52.0,-50.0,-44.0,-46.0,-51.0,-49.0,-43.0,-47.0,-91.0,-93.0,-90.0,-93.0,39.0,43.0,46.0,47.0,0
3158,CC:2F:71:3F:1F:24,4430085,1173277958,609711,691434753,3820374,481843205,37,504803,559776578,504217,559705954,586,70624,487132,10,609948,52675,34,432,130000.0,39000.0,-67.0,-65.0,-71.0,-68.0,-67.0,-65.0,-71.0,-68.0,-91.0,-93.0,-90.0,-93.0,24.0,28.0,19.0,25.0,0
3159,CC:2F:71:3E:C5:1F,3821087,481930324,713,87119,3820374,481843205,0,3021,253221,2499,191181,522,62040,754,8,1044,18,0,32,130000.0,39000.0,-70.0,-71.0,-67.0,-60.0,-71.0,-72.0,-68.0,-61.0,-91.0,-93.0,-90.0,-93.0,21.0,22.0,23.0,33.0,0
3160,BA:8C:B9:54:50:24,3824924,487965887,4547,6122420,3820377,481843467,0,7841,1605772,7820,1602415,21,3357,2291,14,4922,35,0,50,229410.0,137640.0,-40.0,-37.0,-44.0,-51.0,-41.0,-34.0,-42.0,-47.0,-91.0,-93.0,-90.0,-93.0,51.0,56.0,46.0,42.0,0
3161,92:69:1D:31:68:E9,3823978,485347303,3596,3503306,3820382,481843997,0,3846,980899,3742,957694,104,23205,1905,6,3722,79,0,31,216660.0,130000.0,-52.0,-50.0,-44.0,-46.0,-51.0,-49.0,-43.0,-47.0,-91.0,-93.0,-90.0,-93.0,39.0,43.0,46.0,47.0,0
3162,CC:2F:71:3F:1F:24,4430135,1173293178,609753,691449181,3820382,481843997,37,504830,559781638,504244,559711014,586,70624,487159,10,609990,52696,34,432,130000.0,39000.0,-67.0,-65.0,-70.0,-68.0,-67.0,-65.0,-70.0,-68.0,-91.0,-93.0,-90.0,-93.0,24.0,28.0,20.0,25.0,0
3163,CC:2F:71:3E:C5:1F,3821095,481931116,713,87119,3820382,481843997,0,3021,253221,2499,191181,522,62040,754,8,1044,18,0,32,130000.0,39000.0,-70.0,-71.0,-67.0,-60.0,-71.0,-72.0,-68.0,-61.0,-91.0,-93.0,-90.0,-93.0,21.0,22.0,23.0,33.0,0
3164,BA:8C:B9:54:50:24,3824929,487966417,4547,6122420,3820382,481843997,0,7841,1605772,7820,1602415,21,3357,2291,14,4922,35,0,50,229410.0,137640.0,-40.0,-37.0,-44.0,-51.0,-41.0,-34.0,-42.0,-47.0,-91.0,-93.0,-90.0,-93.0,51.0,56.0,46.0,42.0,0
3165,92:69:1D:31:68:E9,3823980,485347505,3596,3503306,3820384,481844199,0,3846,980899,3742,957694,104,23205,1905,6,3722,79,0,31,216660.0,130000.0,-52.0,-50.0,-44.0,-46.0,-51.0,-49.0,-43.0,-47.0,-91.0,-93.0,-90.0,-93.0,39.0,43.0,46.0,47.0,0
3166,CC:2F:71:3F:1F:24,4430179,1173307696,609795,691463497,3820384,481844199,37,504855,559786442,504269,559715818,586,70624,487184,10,610032,52711,34,432,130000.0,39000.0,-67.0,-65.0,-71.0,-68.0,-67.0,-65.0,-70.0,-67.0,-91.0,-93.0,-90.0,-93.0,24.0,28.0,19.0,25.0,0
3167,CC:2F:71:3E:C5:1F,3821097,481931318,713,87119,3820384,481844199,0,3021,253221,2499,191181,522,62040,754,8,1044,18,0,32,130000.0,39000.0,-70.0,-71.0,-67.0,-60.0,-71.0,-72.0,-68.0,-61.0,-91.0,-93.0,-90.0,-93.0,21.0,22.0,23.0,33.0,0
3168,BA:8C:B9:54:50:24,3824933,487966821,4547,6122420,3820386,481844401,0,7841,1605772,7820,1602415,21,3357,2291,14,4922,35,0,50,229410.0,137640.0,-40.0,-37.0,-44.0,-51.0,-41.0,-34.0,-42.0,-47.0,-91.0,-93.0,-90.0,-93.0,51.0,56.0,46.0,42.0,0
3169,92:69:1D:31:68:E9,3823988,485348233,3596,3503306,3820392,481844927,0,3846,980899,3742,957694,104,23205,1905,6,3722,79,0,31,216660.0,130000.0,-52.0,-50.0,-44.0,-46.0,-51.0,-49.0,-43.0,-47.0,-91.0,-93.0,-90.0,-93.0,39.0,43.0,46.0,47.0,0
3170,CC:2F:71:3F:1F:24,4430232,1173323230,609840,691478303,3820392,481844927,37,504880,559791246,504294,559720622,586,70624,487209,10,610077,52732,34,432,130000.0,39000.0,-67.0,-65.0,-70.0,-68.0,-67.0,-65.0,-70.0,-67.0,-91.0,-93.0,-90.0,-93.0,24.0,28.0,20.0,25.0,0
3171,CC:2F:71:3E:C5:1F,3821105,481932046,713,87119,3820392,481844927,0,3023,253409,2500,191251,523,62158,755,8,1044,18,0,32,130000.0,39000.0,-70.0,-71.0,-67.0,-60.0,-71.0,-72.0,-68.0,-61.0,-91.0,-93.0,-90.0,-93.0,21.0,22.0,23.0,33.0,0
3172,BA:8C:B9:54:50:24,3824939,487967347,4547,6122420,3820392,481844927,0,7841,1605772,7820,1602415,21,3357,2291,14,4922,35,0,50,229410.0,137640.0,-40.0,-37.0,-44.0,-51.0,-41.0,-34.0,-42.0,-47.0,-91.0,-93.0,-90.0,-93.0,51.0,56.0,46.0,42.0,0
3173,92:69:1D:31:68:E9,3823990,485348435,3596,3503306,3820394,481845129,0,3846,980899,3742,957694,104,23205,1905,6,3722,79,0,31,216660.0,130000.0,-52.0,-50.0,-44.0,-46.0,-51.0,-49.0,-43.0,-47.0,-91.0,-93.0,-90.0,-93.0,39.0,43.0,46.0,47.0,0
3174,CC:2F:71:3F:1F:24,4430276,1173337804,609882,691492675,3820394,481845129,37,504906,559796166,504320,559725542,586,70624,487235,10,610119,52761,34,432,130000.0,43333.0,-67.0,-65.0,-70.0,-67.0,-67.0,-65.0,-70.0,-67.0,-91.0,-93.0,-90.0,-93.0,24.0,28.0,20.0,26.0,0
3175,CC:2F:71:3E:C5:1F,3821107,481932248,713,87119,3820394,481845129,0,3023,253409,2500,191251,523,62158,755,8,1044,18,0,32,130000.0,39000.0,-70.0,-71.0,-67.0,-60.0,-71.0,-72.0,-68.0,-61.0,-91.0,-93.0,-90.0,-93.0,21.0,22.0,23.0,33.0,0
3176,BA:8C:B9:54:50:24,3824943,487967751,4547,6122420,3820396,481845331,0,7841,1605772,7820,1602415,21,3357,2291,14,4922,35,0,50,229410.0,137640.0,-40.0,-37.0,-44.0,-51.0,-41.0,-34.0,-42.0,-47.0,-91.0,-93.0,-90.0,-93.0,51.0,56.0,46.0,42.0,0
3177,92:69:1D:31:68:E9,3823995,485349112,3596,3503306,3820399,481845806,0,3846,980899,3742,957694,104,23205,1905,6,3722,79,0,31,216660.0,130000.0,-52.0,-50.0,-44.0,-46.0,-51.0,-49.0,-43.0,-47.0,-91.0,-93.0,-90.0,-93.0,39.0,43.0,46.0,47.0,0
3178,CC:2F:71:3F:1F:24,4430325,1173353599,609924,691507591,3820401,481846008,37,504932,559801120,504346,559730496,586,70624,487261,10,610161,52766,34,432,130000.0,43333.0,-67.0,-65.0,-71.0,-67.0,-67.0,-65.0,-70.0,-67.0,-91.0,-93.0,-90.0,-93.0,24.0,28.0,19.0,26.0,0
3179,CC:2F:71:3E:C5:1F,3821114,481933127,713,87119,3820401,481846008,0,3023,253409,2500,191251,523,62158,755,8,1044,18,0,32,130000.0,39000.0,-70.0,-71.0,-67.0,-60.0,-71.0,-72.0,-68.0,-61.0,-91.0,-93.0,-90.0,-93.0,21.0,22.0,23.0,33.0,0
3180,BA:8C:B9:54:50:24,3824948,487968428,4547,6122420,3820401,481846008,0,7841,1605772,7820,1602415,21,3357,2291,14,4922,35,0,50,229410.0,137640.0,-40.0,-37.0,-44.0,-51.0,-41.0,-34.0,-42.0,-47.0,-91.0,-93.0,-90.0,-93.0,51.0,56.0,46.0,42.0,0
3181,92:69:1D:31:68:E9,3824000,485349576,3596,3503306,3820404,481846270,0,3846,980899,3742,957694,104,23205,1905,6,3722,79,0,31,216660.0,130000.0,-52.0,-50.0,-44.0,-46.0,-51.0,-49.0,-43.0,-47.0,-91.0,-93.0,-90.0,-93.0,39.0,43.0,46.0,47.0,0
3182,CC:2F:71:3F:1F:24,4430371,1173368469,609967,691522199,3820404,481846270,37,504961,559806436,504375,559735812,586,70624,487290,10,610204,52782,34,432,130000.0,39000.0,-67.0,-65.0,-70.0,-67.0,-67.0,-65.0,-70.0,-67.0,-91.0,-93.0,-90.0,-93.0,24.0,28.0,20.0,26.0,0
3183,CC:2F:71:3E:C5:1F,3821117,481933389,713,87119,3820404,481846270,0,3023,253409,2500,191251,523,62158,755,8,1044,18,0,32,130000.0,39000.0,-70.0,-71.0,-67.0,-60.0,-71.0,-72.0,-68.0,-61.0,-91.0,-93.0,-90.0,-93.0,21.0,22.0,23.0,33.0,0
3184,BA:8C:B9:54:50:24,3824953,487968892,4547,6122420,3820406,481846472,0,7841,1605772,7820,1602415,21,3357,2291,14,4922,35,0,50,229410.0,137640.0,-40.0,-37.0,-44.0,-51.0,-41.0,-34.0,-42.0,-47.0,-91.0,-93.0,-90.0,-93.0,51.0,56.0,46.0,42.0,0
3185,92:69:1D:31:68:E9,3824004,485349980,3596,3503306,3820408,481846674,0,3846,980899,3742,957694,104,23205,1905,6,3722,79,0,31,216660.0,130000.0,-52.0,-50.0,-44.0,-46.0,-51.0,-49.0,-43.0,-47.0,-91.0,-93.0,-90.0,-93.0,39.0,43.0,46.0,47.0,0
3186,CC:2F:71:3F:1F:24,4430416,1173383177,610008,691536503,3820408,481846674,37,504988,559811496,504402,559740872,586,70624,487317,10,610245,52791,34,432,130000.0,39000.0,-67.0,-65.0,-70.0,-68.0,-67.0,-65.0,-70.0,-67.0,-91.0,-93.0,-90.0,-93.0,24.0,28.0,20.0,25.0,0
3187,CC:2F:71:3E:C5:1F,3821123,481933995,713,87119,3820410,481846876,0,3023,253409,2500,191251,523,62158,755,8,1044,18,0,32,130000.0,39000.0,-70.0,-71.0,-67.0,-60.0,-71.0,-72.0,-68.0,-61.0,-91.0,-93.0,-90.0,-93.0,21.0,22.0,23.0,33.0,0
3188,BA:8C:B9:54:50:24,3824957,487969296,4547,6122420,3820410,481846876,0,7841,1605772,7820,1602415,21,3357,2291,14,4922,35,0,50,229410.0,137640.0,-40.0,-37.0,-44.0,-51.0,-41.0,-34.0,-42.0,-47.0,-91.0,-93.0,-90.0,-93.0,51.0,56.0,46.0,42.0,0
3189,92:69:1D:31:68:E9,3824008,485350384,3596,3503306,3820412,481847078,0,3846,980899,3742,957694,104,23205,1905,6,3722,79,0,31,216660.0,130000.0,-52.0,-50.0,-44.0,-46.0,-51.0,-49.0,-43.0,-47.0,-91.0,-93.0,-90.0,-93.0,39.0,43.0,46.0,47.0,0
3190,CC:2F:71:3F:1F:24,4430462,1173398009,610050,691550931,3820412,481847078,37,505014,559816416,504428,559745792,586,70624,487343,10,610287,52805,34,432,130000.0,39000.0,-67.0,-65.0,-71.0,-67.0,-67.0,-65.0,-70.0,-67.0,-91.0,-93.0,-90.0,-93.0,24.0,28.0,19.0,26.0,0
3191,CC:2F:71:3E:C5:1F,3821126,481934257,713,87119,3820413,481847138,0,3023,253409,2500,191251,523,62158,755,8,1044,18,0,32,130000.0,39000.0,-70.0,-71.0,-67.0,-60.0,-71.0,-72.0,-68.0,-61.0,-91.0,-93.0,-90.0,-93.0,21.0,22.0,23.0,33.0,0
3192,BA:8C:B9:54:50:24,3824960,487969558,4547,6122420,3820413,481847138,0,7841,1605772,7820,1602415,21,3357,2291,14,4922,35,0,50,229410.0,137640.0,-40.0,-37.0,-44.0,-51.0,-41.0,-34.0,-42.0,-47.0,-91.0,-93.0,-90.0,-93.0,51.0,56.0,46.0,42.0,0
3193,92:69:1D:31:68:E9,3824015,485351058,3596,3503306,3820419,481847752,0,3846,980899,3742,957694,104,23205,1905,6,3722,79,0,31,216660.0,130000.0,-52.0,-50.0,-44.0,-46.0,-51.0,-49.0,-43.0,-47.0,-91.0,-93.0,-90.0,-93.0,39.0,43.0,46.0,47.0,0
3194,CC:2F:71:3F:1F:24,4430511,1173413111,610092,691565359,3820419,481847752,37,505039,559821220,504453,559750596,586,70624,487368,10,610329,52822,34,432,130000.0,39000.0,-67.0,-65.0,-70.0,-67.0,-67.0,-65.0,-70.0,-67.0,-91.0,-93.0,-90.0,-93.0,24.0,28.0,20.0,26.0,0
3195,CC:2F:71:3E:C5:1F,3821134,481935073,713,87119,3820421,481847954,0,3023,253409,2500,191251,523,62158,755,8,1044,18,0,32,130000.0,39000.0,-70.0,-71.0,-67.0,-60.0,-71.0,-72.0,-68.0,-61.0,-91.0,-93.0,-90.0,-93.0,21.0,22.0,23.0,33.0,0
3196,BA:8C:B9:54:50:24,3824968,487970374,4547,6122420,3820421,481847954,0,7841,1605772,7820,1602415,21,3357,2291,14,4922,35,0,50,229410.0,137640.0,-40.0,-37.0,-44.0,-51.0,-41.0,-34.0,-42.0,-47.0,-91.0,-93.0,-90.0,-93.0,51.0,56.0,46.0,42.0,0
3197,92:69:1D:31:68:E9,3824019,485351462,3596,3503306,3820423,481848156,0,3846,980899,3742,957694,104,23205,1905,6,3722,79,0,31,216660.0,130000.0,-52.0,-50.0,-44.0,-46.0,-51.0,-49.0,-43.0,-47.0,-91.0,-93.0,-90.0,-93.0,39.0,43.0,46.0,47.0,0
3198,CC:2F:71:3F:1F:24,4430557,1173427893,610134,691579737,3820423,481848156,37,505065,559826164,504479,559755540,586,70624,487394,10,610371,52838,34,432,117000.0,39000.0,-67.0,-65.0,-70.0,-67.0,-67.0,-65.0,-70.0,-67.0,-91.0,-93.0,-90.0,-93.0,24.0,28.0,20.0,26.0,0
3199,CC:2F:71:3E:C5:1F,3821136,481935275,713,87119,3820423,481848156,0,3023,253409,2500,191251,523,62158,755,8,1044,18,0,32,130000.0,39000.0,-70.0,-71.0,-67.0,-60.0,-71.0,-72.0,-68.0,-61.0,-91.0,-93.0,-90.0,-93.0,21.0,22.0,23.0,33.0,0
3200,BA:8C:B9:54:50:24,3824970,487970576,4547,6122420,3820423,481848156,0,7841,1605772,7820,1602415,21,3357,2291,14,4922,35,0,50,229410.0,137640.0,-40.0,-37.0,-44.0,-51.0,-41.0,-34.0,-42.0,-47.0,-91.0,-93.0,-90.0,-93.0,51.0,56.0,46.0,42.0,0
3201,92:69:1D:31:68:E9,3824024,485351926,3596,3503306,3820428,481848620,0,3846,980899,3742,957694,104,23205,1905,6,3722,79,0,31,216660.0,130000.0,-52.0,-50.0,-44.0,-46.0,-51.0,-49.0,-43.0,-47.0,-91.0,-93.0,-90.0,-93.0,39.0,43.0,46.0,47.0,0
3202,CC:2F:71:3F:1F:24,4430605,1173442853,610177,691594233,3820428,481848620,37,505092,559831224,504506,559760600,586,70624,487421,10,610414,52863,34,432,144444.0,39000.0,-67.0,-65.0,-70.0,-67.0,-67.0,-65.0,-70.0,-67.0,-91.0,-93.0,-90.0,-93.0,24.0,28.0,20.0,26.0,0
3203,CC:2F:71:3E:C5:1F,3821143,481935941,713,87119,3820430,481848822,0,3023,253409,2500,191251,523,62158,755,8,1044,18,0,32,130000.0,39000.0,-70.0,-71.0,-67.0,-60.0,-71.0,-72.0,-68.0,-61.0,-91.0,-93.0,-90.0,-93.0,21.0,22.0,23.0,33.0,0
3204,BA:8C:B9:54:50:24,3824977,487971242,4547,6122420,3820430,481848822,0,7841,1605772,7820,1602415,21,3357,2291,14,4922,35,0,50,229410.0,137640.0,-40.0,-37.0,-44.0,-51.0,-41.0,-34.0,-42.0,-47.0,-91.0,-93.0,-90.0,-93.0,51.0,56.0,46.0,42.0,0
3205,92:69:1D:31:68:E9,3824028,485352330,3596,3503306,3820432,481849024,0,3846,980899,3742,957694,104,23205,1905,6,3722,79,0,31,216660.0,130000.0,-52.0,-50.0,-44.0,-46.0,-51.0,-49.0,-43.0,-47.0,-91.0,-93.0,-90.0,-93.0,39.0,43.0,46.0,47.0,0
3206,CC:2F:71:3F:1F:24,4430652,1173457759,610220,691608735,3820432,481849024,37,505117,559836028,504531,559765404,586,70624,487446,10,610457,52889,34,432,130000.0,43333.0,-67.0,-65.0,-70.0,-67.0,-67.0,-65.0,-70.0,-67.0,-91.0,-93.0,-90.0,-93.0,24.0,28.0,20.0,26.0,0
3207,CC:2F:71:3E:C5:1F,3821145,481936143,713,87119,3820432,481849024,0,3023,253409,2500,191251,523,62158,755,8,1044,18,0,32,130000.0,39000.0,-70.0,-71.0,-67.0,-60.0,-71.0,-72.0,-68.0,-61.0,-91.0,-93.0,-90.0,-93.0,21.0,22.0,23.0,33.0,0
3208,BA:8C:B9:54:50:24,3824979,487971444,4547,6122420,3820432,481849024,0,7841,1605772,7820,1602415,21,3357,2291,14,4922,35,0,50,229410.0,137640.0,-40.0,-37.0,-44.0,-51.0,-41.0,-34.0,-42.0,-47.0,-91.0,-93.0,-90.0,-93.0,51.0,56.0,46.0,42.0,0
3209,92:69:1D:31:68:E9,3824032,485352734,3596,3503306,3820436,481849428,0,3846,980899,3742,957694,104,23205,1905,6,3722,79,0,31,216660.0,130000.0,-52.0,-50.0,-44.0,-46.0,-51.0,-49.0,-43.0,-47.0,-91.0,-93.0,-90.0,-93.0,39.0,43.0,46.0,47.0,0
3210,CC:2F:71:3F:1F:24,4430698,1173472703,610262,691623275,3820436,481849428,37,505143,559840972,504557,559770348,586,70624,487472,10,610499,52904,34,432,130000.0,43333.0,-67.0,-65.0,-70.0,-67.0,-67.0,-65.0,-70.0,-67.0,-91.0,-93.0,-90.0,-93.0,24.0,28.0,20.0,26.0,0
3211,CC:2F:71:3E:C5:1F,3821151,481936749,713,87119,3820438,481849630,0,3023,253409,2500,191251,523,62158,755,8,1044,18,0,32,130000.0,39000.0,-70.0,-71.0,-67.0,-60.0,-71.0,-72.0,-68.0,-61.0,-91.0,-93.0,-90.0,-93.0,21.0,22.0,23.0,33.0,0
3212,BA:8C:B9:54:50:24,3824985,487972050,4547,6122420,3820438,481849630,0,7841,1605772,7820,1602415,21,3357,2291,14,4922,35,0,50,229410.0,137640.0,-40.0,-37.0,-44.0,-51.0,-41.0,-34.0,-42.0,-47.0,-91.0,-93.0,-90.0,-93.0,51.0,56.0,46.0,42.0,0
3213,92:69:1D:31:68:E9,3824037,485353198,3596,3503306,3820441,481849892,0,3847,980967,3743,957762,104,23205,1905,6,3722,79,0,31,216660.0,130000.0,-52.0,-50.0,-44.0,-46.0,-51.0,-49.0,-43.0,-47.0,-91.0,-93.0,-90.0,-93.0,39.0,43.0,46.0,47.0,0
3214,CC:2F:71:3F:1F:24,4430744,1173487471,610303,691637579,3820441,481849892,37,505169,559845916,504583,559775292,586,70624,487498,10,610540,52931,34,432,144444.0,39000.0,-67.0,-65.0,-71.0,-67.0,-67.0,-65.0,-70.0,-67.0,-91.0,-93.0,-90.0,-93.0,24.0,28.0,19.0,26.0,0
3215,CC:2F:71:3E:C5:1F,3821154,481937011,713,87119,3820441,481849892,0,3023,253409,2500,191251,523,62158,755,8,1044,18,0,32,130000.0,39000.0,-70.0,-71.0,-67.0,-60.0,-71.0,-72.0,-68.0,-61.0,-91.0,-93.0,-90.0,-93.0,21.0,22.0,23.0,33.0,0
3216,BA:8C:B9:54:50:24,3824988,487972312,4547,6122420,3820441,481849892,0,7841,1605772,7820,1602415,21,3357,2291,14,4922,35,0,50,229410.0,137640.0,-40.0,-37.0,-44.0,-51.0,-41.0,-34.0,-42.0,-47.0,-91.0,-93.0,-90.0,-93.0,51.0,56.0,46.0,42.0,0
3217,92:69:1D:31:68:E9,3824041,485353602,3596,3503306,3820445,481850296,0,3847,980967,3743,957762,104,23205,1905,6,3722,79,0,31,216660.0,130000.0,-52.0,-50.0,-44.0,-46.0,-51.0,-49.0,-43.0,-47.0,-91.0,-93.0,-90.0,-93.0,39.0,43.0,46.0,47.0,0
3218,CC:2F:71:3F:1F:24,4430792,1173502505,610345,691652007,3820447,481850498,37,505195,559850860,504609,559780236,586,70624,487524,10,610582,52952,34,432,130000.0,43333.0,-67.0,-65.0,-70.0,-68.0,-67.0,-65.0,-70.0,-67.0,-91.0,-93.0,-90.0,-93.0,24.0,28.0,20.0,25.0,0
3219,CC:2F:71:3E:C5:1F,3821160,481937617,713,87119,3820447,481850498,0,3023,253409,2500,191251,523,62158,755,8,1044,18,0,32,130000.0,39000.0,-70.0,-71.0,-67.0,-60.0,-71.0,-72.0,-68.0,-61.0,-91.0,-93.0,-90.0,-93.0,21.0,22.0,23.0,33.0,0
3220,BA:8C:B9:54:50:24,3824994,487972918,4547,6122420,3820447,481850498,0,7841,1605772,7820,1602415,21,3357,2291,14,4922,35,0,50,229410.0,137640.0,-40.0,-37.0,-44.0,-51.0,-41.0,-34.0,-42.0,-47.0,-91.0,-93.0,-90.0,-93.0,51.0,56.0,46.0,42.0,0
3221,92:69:1D:31:68:E9,3824046,485354066,3596,3503306,3820450,481850760,0,3847,980967,3743,957762,104,23205,1905,6,3722,79,0,31,216660.0,130000.0,-52.0,-50.0,-44.0,-46.0,-51.0,-49.0,-43.0,-47.0,-91.0,-93.0,-90.0,-93.0,39.0,43.0,46.0,47.0,0
3222,CC:2F:71:3F:1F:24,4430837,1173517195,610387,691666435,3820450,481850760,37,505221,559855804,504635,559785180,586,70624,487550,10,610624,52972,34,432,117000.0,39000.0,-70.0,-68.0,-74.0,-71.0,-69.0,-67.0,-72.0,-69.0,-91.0,-93.0,-90.0,-93.0,21.0,25.0,16.0,22.0,0
3223,CC:2F:71:3E:C5:1F,3821163,481937879,713,87119,3820450,481850760,0,3023,253409,2500,191251,523,62158,755,8,1044,18,0,32,130000.0,39000.0,-70.0,-71.0,-67.0,-60.0,-71.0,-72.0,-68.0,-61.0,-91.0,-93.0,-90.0,-93.0,21.0,22.0,23.0,33.0,0
3224,BA:8C:B9:54:50:24,3824997,487973180,4547,6122420,3820450,481850760,0,7841,1605772,7820,1602415,21,3357,2291,14,4922,35,0,50,229410.0,137640.0,-40.0,-37.0,-44.0,-51.0,-41.0,-34.0,-42.0,-47.0,-91.0,-93.0,-90.0,-93.0,51.0,56.0,46.0,42.0,0
3225,92:69:1D:31:68:E9,3824051,485354586,3597,3503422,3820454,481851164,0,3849,981103,3745,957898,104,23205,1905,6,3723,79,0,31,216660.0,130000.0,-52.0,-50.0,-44.0,-46.0,-51.0,-49.0,-43.0,-46.0,-91.0,-93.0,-90.0,-93.0,39.0,43.0,46.0,47.0,0
3226,CC:2F:71:3F:1F:24,4430883,1173532019,610429,691680855,3820454,481851164,37,505246,559860608,504660,559789984,586,70624,487575,10,610666,52980,34,432,130000.0,43333.0,-67.0,-65.0,-70.0,-67.0,-67.0,-65.0,-70.0,-67.0,-91.0,-93.0,-90.0,-93.0,24.0,28.0,20.0,26.0,0
3227,CC:2F:71:3E:C5:1F,3821170,481938601,714,87235,3820456,481851366,0,3025,253549,2502,191391,523,62158,755,8,1045,18,0,32,130000.0,39000.0,-70.0,-71.0,-68.0,-60.0,-70.0,-71.0,-67.0,-60.0,-91.0,-93.0,-90.0,-93.0,21.0,22.0,22.0,33.0,0
3228,BA:8C:B9:54:50:24,3825004,487973846,4548,6122480,3820456,481851366,0,7843,1605908,7822,1602551,21,3357,2291,14,4923,35,0,50,216660.0,130000.0,-49.0,-35.0,-42.0,-44.0,-42.0,-34.0,-42.0,-46.0,-91.0,-93.0,-90.0,-93.0,42.0,58.0,48.0,49.0,0
3229,92:69:1D:31:68:E9,3824056,485355263,3597,3503422,3820459,481851841,0,3849,981103,3745,957898,104,23205,1905,6,3723,79,0,31,216660.0,130000.0,-52.0,-50.0,-44.0,-46.0,-51.0,-49.0,-43.0,-46.0,-91.0,-93.0,-90.0,-93.0,39.0,43.0,46.0,47.0,0
3230,CC:2F:71:3F:1F:24,4430929,1173547112,610470,691695271,3820459,481851841,37,505271,559865412,504685,559794788,586,70624,487600,10,610707,52983,34,432,130000.0,43333.0,-67.0,-65.0,-70.0,-67.0,-67.0,-65.0,-70.0,-67.0,-91.0,-93.0,-90.0,-93.0,24.0,28.0,20.0,26.0,0
3231,CC:2F:71:3E:C5:1F,3821173,481939076,714,87235,3820459,481851841,0,3025,253549,2502,191391,523,62158,755,8,1045,18,0,32,130000.0,39000.0,-70.0,-71.0,-68.0,-60.0,-70.0,-71.0,-67.0,-60.0,-91.0,-93.0,-90.0,-93.0,21.0,22.0,22.0,33.0,0
3232,BA:8C:B9:54:50:24,3825007,487974321,4548,6122480,3820459,481851841,0,7843,1605908,7822,1602551,21,3357,2291,14,4923,35,0,50,216660.0,130000.0,-49.0,-35.0,-42.0,-44.0,-42.0,-34.0,-42.0,-46.0,-91.0,-93.0,-90.0,-93.0,42.0,58.0,48.0,49.0,0
3233,92:69:1D:31:68:E9,3824061,485355727,3597,3503422,3820464,481852305,0,3849,981103,3745,957898,104,23205,1905,6,3723,79,0,31,216660.0,130000.0,-52.0,-50.0,-44.0,-46.0,-51.0,-49.0,-43.0,-46.0,-91.0,-93.0,-90.0,-93.0,39.0,43.0,46.0,47.0,0
3234,CC:2F:71:3F:1F:24,4430975,1173561936,610511,691709631,3820464,481852305,37,505297,559870356,504711,559799732,586,70624,487626,10,610748,52997,34,432,130000.0,39000.0,-67.0,-65.0,-71.0,-67.0,-67.0,-65.0,-70.0,-67.0,-91.0,-93.0,-90.0,-93.0,24.0,28.0,19.0,26.0,0
3235,CC:2F:71:3E:C5:1F,3821179,481939608,714,87235,3820465,481852373,0,3025,253549,2502,191391,523,62158,755,8,1045,18,0,32,130000.0,39000.0,-70.0,-71.0,-68.0,-60.0,-70.0,-71.0,-67.0,-60.0,-91.0,-93.0,-90.0,-93.0,21.0,22.0,22.0,33.0,0
3236,BA:8C:B9:54:50:24,3825013,487974853,4548,6122480,3820465,481852373,0,7843,1605908,7822,1602551,21,3357,2291,14,4923,35,0,50,216660.0,130000.0,-49.0,-35.0,-42.0,-44.0,-42.0,-34.0,-42.0,-46.0,-91.0,-93.0,-90.0,-93.0,42.0,58.0,48.0,49.0,0
3237,92:69:1D:31:68:E9,3824066,485356193,3597,3503422,3820469,481852771,0,3849,981103,3745,957898,104,23205,1905,6,3723,79,0,31,216660.0,130000.0,-52.0,-50.0,-44.0,-46.0,-51.0,-49.0,-43.0,-46.0,-91.0,-93.0,-90.0,-93.0,39.0,43.0,46.0,47.0,0
3238,CC:2F:71:3F:1F:24,4431021,1173576712,610552,691723941,3820469,481852771,37,505324,559875394,504737,559804652,587,70742,487653,10,610789,53016,34,432,130000.0,39000.0,-67.0,-65.0,-70.0,-67.0,-67.0,-65.0,-70.0,-67.0,-91.0,-93.0,-90.0,-93.0,24.0,28.0,20.0,26.0,0
3239,CC:2F:71:3E:C5:1F,3821183,481940006,714,87235,3820469,481852771,0,3025,253549,2502,191391,523,62158,755,8,1045,18,0,32,130000.0,39000.0,-70.0,-71.0,-68.0,-60.0,-70.0,-71.0,-67.0,-60.0,-91.0,-93.0,-90.0,-93.0,21.0,22.0,22.0,33.0,0
3240,BA:8C:B9:54:50:24,3825017,487975251,4548,6122480,3820469,481852771,0,7843,1605908,7822,1602551,21,3357,2291,14,4923,35,0,50,216660.0,130000.0,-49.0,-35.0,-42.0,-44.0,-42.0,-34.0,-42.0,-46.0,-91.0,-93.0,-90.0,-93.0,42.0,58.0,48.0,49.0,0
3241,92:69:1D:31:68:E9,3824073,485357027,3597,3503422,3820476,481853605,0,3849,981103,3745,957898,104,23205,1905,6,3723,79,0,31,216660.0,130000.0,-52.0,-50.0,-44.0,-46.0,-51.0,-49.0,-43.0,-46.0,-91.0,-93.0,-90.0,-93.0,39.0,43.0,46.0,47.0,0
3242,CC:2F:71:3F:1F:24,4431070,1173591918,610594,691738313,3820476,481853605,37,505351,559880454,504764,559809712,587,70742,487680,10,610831,53033,34,432,117000.0,39000.0,-67.0,-65.0,-70.0,-68.0,-67.0,-65.0,-70.0,-67.0,-91.0,-93.0,-90.0,-93.0,24.0,28.0,20.0,25.0,0
3243,CC:2F:71:3E:C5:1F,3821190,481940840,714,87235,3820476,481853605,0,3027,253737,2503,191461,524,62276,756,8,1045,18,0,32,130000.0,39000.0,-70.0,-71.0,-67.0,-60.0,-70.0,-71.0,-67.0,-60.0,-91.0,-93.0,-90.0,-93.0,21.0,22.0,23.0,33.0,0
3244,BA:8C:B9:54:50:24,3825025,487976145,4548,6122480,3820477,481853665,0,7843,1605908,7822,1602551,21,3357,2291,14,4923,35,0,50,216660.0,130000.0,-49.0,-35.0,-42.0,-44.0,-42.0,-34.0,-42.0,-46.0,-91.0,-93.0,-90.0,-93.0,42.0,58.0,48.0,49.0,0
3245,92:69:1D:31:68:E9,3824078,485357491,3597,3503422,3820481,481854069,0,3849,981103,3745,957898,104,23205,1905,6,3723,79,0,31,216660.0,130000.0,-52.0,-50.0,-44.0,-46.0,-51.0,-49.0,-43.0,-46.0,-91.0,-93.0,-90.0,-93.0,39.0,43.0,46.0,47.0,0
3246,CC:2F:71:3F:1F:24,4431117,1173606754,610636,691752685,3820481,481854069,37,505377,559885398,504790,559814656,587,70742,487706,10,610873,53045,34,432,130000.0,39000.0,-67.0,-65.0,-71.0,-68.0,-67.0,-65.0,-70.0,-67.0,-91.0,-93.0,-90.0,-93.0,24.0,28.0,19.0,25.0,0
3247,CC:2F:71:3E:C5:1F,3821195,481941304,714,87235,3820481,481854069,0,3027,253737,2503,191461,524,62276,756,8,1045,18,0,32,130000.0,39000.0,-70.0,-71.0,-67.0,-60.0,-70.0,-71.0,-67.0,-60.0,-91.0,-93.0,-90.0,-93.0,21.0,22.0,23.0,33.0,0
3248,BA:8C:B9:54:50:24,3825031,487976751,4548,6122480,3820483,481854271,0,7843,1605908,7822,1602551,21,3357,2291,14,4923,35,0,50,216660.0,130000.0,-49.0,-35.0,-42.0,-44.0,-42.0,-34.0,-42.0,-46.0,-91.0,-93.0,-90.0,-93.0,42.0,58.0,48.0,49.0,0
3249,92:69:1D:31:68:E9,3824082,485357895,3597,3503422,3820485,481854473,0,3849,981103,3745,957898,104,23205,1905,6,3723,79,0,31,216660.0,130000.0,-52.0,-50.0,-44.0,-46.0,-51.0,-49.0,-43.0,-46.0,-91.0,-93.0,-90.0,-93.0,39.0,43.0,46.0,47.0,0
3250,CC:2F:71:3F:1F:24,4431163,1173621530,610678,691767057,3820485,481854473,37,505403,559890342,504816,559819600,587,70742,487732,10,610915,53071,34,432,130000.0,43333.0,-67.0,-65.0,-70.0,-68.0,-67.0,-65.0,-70.0,-67.0,-91.0,-93.0,-90.0,-93.0,24.0,28.0,20.0,25.0,0
3251,CC:2F:71:3E:C5:1F,3821199,481941708,714,87235,3820485,481854473,0,3027,253737,2503,191461,524,62276,756,8,1045,18,0,32,130000.0,39000.0,-70.0,-71.0,-67.0,-60.0,-70.0,-71.0,-67.0,-60.0,-91.0,-93.0,-90.0,-93.0,21.0,22.0,23.0,33.0,0
3252,BA:8C:B9:54:50:24,3825033,487976953,4548,6122480,3820485,481854473,0,7843,1605908,7822,1602551,21,3357,2291,14,4923,35,0,50,216660.0,130000.0,-49.0,-35.0,-42.0,-44.0,-42.0,-34.0,-42.0,-46.0,-91.0,-93.0,-90.0,-93.0,42.0,58.0,48.0,49.0,0
3253,92:69:1D:31:68:E9,3824087,485358359,3597,3503422,3820490,481854937,0,3849,981103,3745,957898,104,23205,1905,6,3723,79,0,31,216660.0,130000.0,-52.0,-50.0,-44.0,-46.0,-51.0,-49.0,-43.0,-46.0,-90.0,-93.0,-90.0,-93.0,38.0,43.0,46.0,47.0,0
3254,CC:2F:71:3F:1F:24,4431211,1173636658,610721,691781721,3820490,481854937,37,505429,559895286,504842,559824544,587,70742,487758,10,610958,53081,34,432,130000.0,43333.0,-67.0,-65.0,-70.0,-68.0,-67.0,-65.0,-70.0,-67.0,-90.0,-93.0,-90.0,-93.0,23.0,28.0,20.0,25.0,0
3255,CC:2F:71:3E:C5:1F,3821204,481942172,714,87235,3820490,481854937,0,3027,253737,2503,191461,524,62276,756,8,1045,18,0,32,130000.0,39000.0,-70.0,-71.0,-67.0,-60.0,-70.0,-71.0,-67.0,-60.0,-90.0,-93.0,-90.0,-93.0,20.0,22.0,23.0,33.0,0
3256,BA:8C:B9:54:50:24,3825040,487977619,4548,6122480,3820492,481855139,0,7843,1605908,7822,1602551,21,3357,2291,14,4923,35,0,50,216660.0,130000.0,-49.0,-35.0,-42.0,-44.0,-42.0,-34.0,-42.0,-46.0,-90.0,-93.0,-90.0,-93.0,41.0,58.0,48.0,49.0,0
3257,92:69:1D:31:68:E9,3824091,485358763,3597,3503422,3820494,481855341,0,3849,981103,3745,957898,104,23205,1905,6,3723,79,0,31,216660.0,130000.0,-52.0,-50.0,-44.0,-46.0,-51.0,-49.0,-43.0,-46.0,-90.0,-93.0,-90.0,-93.0,38.0,43.0,46.0,47.0,0
3258,CC:2F:71:3F:1F:24,4431258,1173651670,610764,691796329,3820494,481855341,37,505455,559900230,504868,559829488,587,70742,487784,10,611001,53083,34,432,130000.0,39000.0,-67.0,-65.0,-70.0,-67.0,-67.0,-65.0,-70.0,-67.0,-90.0,-93.0,-90.0,-93.0,23.0,28.0,20.0,26.0,0
3259,CC:2F:71:3E:C5:1F,3821208,481942576,714,87235,3820494,481855341,0,3027,253737,2503,191461,524,62276,756,8,1045,18,0,32,130000.0,39000.0,-70.0,-71.0,-67.0,-60.0,-70.0,-71.0,-67.0,-60.0,-90.0,-93.0,-90.0,-93.0,20.0,22.0,23.0,33.0,0
3260,BA:8C:B9:54:50:24,3825042,487977821,4548,6122480,3820494,481855341,0,7843,1605908,7822,1602551,21,3357,2291,14,4923,35,0,50,216660.0,130000.0,-49.0,-35.0,-42.0,-44.0,-42.0,-34.0,-42.0,-46.0,-90.0,-93.0,-90.0,-93.0,41.0,58.0,48.0,49.0,0
3261,92:69:1D:31:68:E9,3824095,485359167,3597,3503422,3820498,481855745,0,3849,981103,3745,957898,104,23205,1905,6,3723,79,0,31,216660.0,130000.0,-52.0,-50.0,-44.0,-46.0,-51.0,-49.0,-43.0,-46.0,-90.0,-93.0,-90.0,-93.0,38.0,43.0,46.0,47.0,0
3262,CC:2F:71:3F:1F:24,4431304,1173666502,610806,691810757,3820498,481855745,37,505481,559905174,504894,559834432,587,70742,487810,10,611043,53107,34,432,130000.0,39000.0,-67.0,-65.0,-70.0,-67.0,-67.0,-65.0,-69.0,-67.0,-90.0,-93.0,-90.0,-93.0,23.0,28.0,20.0,26.0,0
3263,CC:2F:71:3E:C5:1F,3821212,481942980,714,87235,3820498,481855745,0,3027,253737,2503,191461,524,62276,756,8,1045,18,0,32,130000.0,39000.0,-70.0,-71.0,-67.0,-60.0,-70.0,-71.0,-67.0,-60.0,-90.0,-93.0,-90.0,-93.0,20.0,22.0,23.0,33.0,0
3264,BA:8C:B9:54:50:24,3825046,487978225,4548,6122480,3820498,481855745,0,7843,1605908,7822,1602551,21,3357,2291,14,4923,35,0,50,216660.0,130000.0,-49.0,-35.0,-42.0,-44.0,-42.0,-34.0,-42.0,-46.0,-90.0,-93.0,-90.0,-93.0,41.0,58.0,48.0,49.0,0
3265,92:69:1D:31:68:E9,3824100,485359631,3597,3503422,3820503,481856209,0,3849,981103,3745,957898,104,23205,1905,6,3723,79,0,31,216660.0,130000.0,-52.0,-50.0,-44.0,-46.0,-51.0,-49.0,-43.0,-46.0,-90.0,-93.0,-90.0,-93.0,38.0,43.0,46.0,47.0,0
3266,CC:2F:71:3F:1F:24,4431351,1173681338,610848,691825129,3820503,481856209,37,505507,559910118,504920,559839376,587,70742,487836,10,611085,53112,34,432,117000.0,39000.0,-67.0,-65.0,-70.0,-68.0,-67.0,-65.0,-70.0,-67.0,-90.0,-93.0,-90.0,-93.0,23.0,28.0,20.0,25.0,0
3267,CC:2F:71:3E:C5:1F,3821217,481943444,714,87235,3820503,481856209,0,3027,253737,2503,191461,524,62276,756,8,1045,18,0,32,130000.0,39000.0,-70.0,-71.0,-67.0,-60.0,-70.0,-71.0,-67.0,-60.0,-90.0,-93.0,-90.0,-93.0,20.0,22.0,23.0,33.0,0
3268,BA:8C:B9:54:50:24,3825051,487978689,4548,6122480,3820503,481856209,0,7843,1605908,7822,1602551,21,3357,2291,14,4923,35,0,50,216660.0,130000.0,-49.0,-35.0,-42.0,-44.0,-42.0,-34.0,-42.0,-46.0,-90.0,-93.0,-90.0,-93.0,41.0,58.0,48.0,49.0,0
3269,92:69:1D:31:68:E9,3824104,485360035,3597,3503422,3820507,481856613,0,3849,981103,3745,957898,104,23205,1905,6,3723,79,0,31,216660.0,130000.0,-52.0,-50.0,-44.0,-46.0,-51.0,-49.0,-43.0,-46.0,-90.0,-93.0,-90.0,-93.0,38.0,43.0,46.0,47.0,0
3270,CC:2F:71:3F:1F:24,4431398,1173696244,610891,691839631,3820507,481856613,37,505532,559914922,504945,559844180,587,70742,487861,10,611128,53123,34,432,130000.0,39000.0,-67.0,-65.0,-70.0,-68.0,-67.0,-65.0,-70.0,-67.0,-90.0,-93.0,-90.0,-93.0,23.0,28.0,20.0,25.0,0
3271,CC:2F:71:3E:C5:1F,3821221,481943848,714,87235,3820507,481856613,0,3027,253737,2503,191461,524,62276,756,8,1045,18,0,32,130000.0,39000.0,-70.0,-71.0,-67.0,-60.0,-70.0,-71.0,-67.0,-60.0,-90.0,-93.0,-90.0,-93.0,20.0,22.0,23.0,33.0,0
3272,BA:8C:B9:54:50:24,3825055,487979093,4548,6122480,3820507,481856613,0,7843,1605908,7822,1602551,21,3357,2291,14,4923,35,0,50,216660.0,130000.0,-49.0,-35.0,-42.0,-44.0,-42.0,-34.0,-42.0,-46.0,-90.0,-93.0,-90.0,-93.0,41.0,58.0,48.0,49.0,0
3273,92:69:1D:31:68:E9,3824108,485360439,3597,3503422,3820511,481857017,0,3849,981103,3745,957898,104,23205,1905,6,3723,79,0,31,216660.0,130000.0,-52.0,-50.0,-44.0,-46.0,-51.0,-49.0,-43.0,-46.0,-90.0,-93.0,-90.0,-93.0,38.0,43.0,46.0,47.0,0
3274,CC:2F:71:3F:1F:24,4431445,1173711150,610934,691854133,3820511,481857017,37,505557,559919726,504970,559848984,587,70742,487886,10,611171,53154,34,432,130000.0,43333.0,-67.0,-65.0,-70.0,-68.0,-67.0,-65.0,-70.0,-67.0,-90.0,-93.0,-90.0,-93.0,23.0,28.0,20.0,25.0,0
3275,CC:2F:71:3E:C5:1F,3821226,481944312,714,87235,3820512,481857077,0,3027,253737,2503,191461,524,62276,756,8,1045,18,0,32,130000.0,39000.0,-70.0,-71.0,-67.0,-60.0,-70.0,-71.0,-67.0,-60.0,-90.0,-93.0,-90.0,-93.0,20.0,22.0,23.0,33.0,0
3276,BA:8C:B9:54:50:24,3825060,487979557,4548,6122480,3820512,481857077,0,7843,1605908,7822,1602551,21,3357,2291,14,4923,35,0,50,216660.0,130000.0,-49.0,-35.0,-42.0,-44.0,-42.0,-34.0,-42.0,-46.0,-90.0,-93.0,-90.0,-93.0,41.0,58.0,48.0,49.0,0
3277,92:69:1D:31:68:E9,3824113,485360903,3597,3503422,3820516,481857481,0,3849,981103,3745,957898,104,23205,1905,6,3723,79,0,31,216660.0,130000.0,-52.0,-50.0,-44.0,-46.0,-51.0,-49.0,-43.0,-46.0,-90.0,-93.0,-90.0,-93.0,38.0,43.0,46.0,47.0,0
3278,CC:2F:71:3F:1F:24,4431491,1173726030,610975,691868549,3820516,481857481,37,505584,559924786,504997,559854044,587,70742,487913,10,611212,53162,34,432,130000.0,43333.0,-67.0,-65.0,-71.0,-67.0,-67.0,-65.0,-70.0,-67.0,-90.0,-93.0,-90.0,-93.0,23.0,28.0,19.0,26.0,0
3279,CC:2F:71:3E:C5:1F,3821230,481944716,714,87235,3820516,481857481,0,3027,253737,2503,191461,524,62276,756,8,1045,18,0,32,130000.0,39000.0,-70.0,-71.0,-67.0,-60.0,-70.0,-71.0,-67.0,-60.0,-90.0,-93.0,-90.0,-93.0,20.0,22.0,23.0,33.0,0
3280,BA:8C:B9:54:50:24,3825064,487979961,4548,6122480,3820516,481857481,0,7843,1605908,7822,1602551,21,3357,2291,14,4923,35,0,50,216660.0,130000.0,-49.0,-35.0,-42.0,-44.0,-42.0,-34.0,-42.0,-46.0,-90.0,-93.0,-90.0,-93.0,41.0,58.0,48.0,49.0,0
3281,92:69:1D:31:68:E9,3824118,485361580,3597,3503422,3820521,481858158,0,3849,981103,3745,957898,104,23205,1905,6,3723,79,0,31,216660.0,130000.0,-52.0,-50.0,-44.0,-46.0,-51.0,-49.0,-43.0,-46.0,-90.0,-93.0,-90.0,-93.0,38.0,43.0,46.0,47.0,0
3282,CC:2F:71:3F:1F:24,4431540,1173741389,611019,691883231,3820521,481858158,37,505609,559929590,505022,559858848,587,70742,487938,10,611256,53186,34,432,117000.0,39000.0,-67.0,-65.0,-70.0,-68.0,-67.0,-65.0,-70.0,-67.0,-90.0,-93.0,-90.0,-93.0,23.0,28.0,20.0,25.0,0
3283,CC:2F:71:3E:C5:1F,3821235,481945393,714,87235,3820521,481858158,0,3027,253737,2503,191461,524,62276,756,8,1045,18,0,32,130000.0,39000.0,-70.0,-71.0,-67.0,-60.0,-70.0,-71.0,-67.0,-60.0,-90.0,-93.0,-90.0,-93.0,20.0,22.0,23.0,33.0,0
3284,BA:8C:B9:54:50:24,3825069,487980638,4548,6122480,3820521,481858158,0,7843,1605908,7822,1602551,21,3357,2291,14,4923,35,0,50,216660.0,130000.0,-49.0,-35.0,-42.0,-44.0,-42.0,-34.0,-42.0,-46.0,-90.0,-93.0,-90.0,-93.0,41.0,58.0,48.0,49.0,0
3285,92:69:1D:31:68:E9,3824123,485362044,3597,3503422,3820526,481858622,0,3849,981103,3745,957898,104,23205,1905,6,3723,79,0,31,216660.0,130000.0,-52.0,-50.0,-44.0,-46.0,-51.0,-49.0,-43.0,-46.0,-90.0,-93.0,-90.0,-93.0,38.0,43.0,46.0,47.0,0
3286,CC:2F:71:3F:1F:24,4431586,1173756157,611060,691897535,3820526,481858622,37,505635,559934534,505048,559863792,587,70742,487964,10,611297,53197,34,432,130000.0,43333.0,-67.0,-65.0,-71.0,-68.0,-67.0,-65.0,-71.0,-67.0,-90.0,-93.0,-90.0,-93.0,23.0,28.0,19.0,25.0,0
3287,CC:2F:71:3E:C5:1F,3821240,481945857,714,87235,3820526,481858622,0,3027,253737,2503,191461,524,62276,756,8,1045,18,0,32,130000.0,39000.0,-70.0,-71.0,-67.0,-60.0,-70.0,-71.0,-67.0,-60.0,-90.0,-93.0,-90.0,-93.0,20.0,22.0,23.0,33.0,0
3288,BA:8C:B9:54:50:24,3825074,487981102,4548,6122480,3820526,481858622,0,7844,1605976,7823,1602619,21,3357,2291,14,4923,35,0,50,216660.0,130000.0,-39.0,-37.0,-45.0,-51.0,-42.0,-35.0,-42.0,-47.0,-90.0,-93.0,-90.0,-93.0,51.0,56.0,45.0,42.0,0
3289,92:69:1D:31:68:E9,3824127,485362448,3597,3503422,3820530,481859026,0,3849,981103,3745,957898,104,23205,1905,6,3723,79,0,31,216660.0,130000.0,-52.0,-50.0,-44.0,-46.0,-51.0,-49.0,-43.0,-46.0,-90.0,-93.0,-90.0,-93.0,38.0,43.0,46.0,47.0,0
3290,CC:2F:71:3F:1F:24,4431633,1173771169,611103,691912143,3820530,481859026,37,505661,559939454,505074,559868712,587,70742,487990,10,611340,53212,34,432,130000.0,39000.0,-67.0,-65.0,-71.0,-68.0,-67.0,-65.0,-70.0,-68.0,-90.0,-93.0,-90.0,-93.0,23.0,28.0,19.0,25.0,0
3291,CC:2F:71:3E:C5:1F,3821244,481946261,714,87235,3820530,481859026,0,3027,253737,2503,191461,524,62276,756,8,1045,18,0,32,130000.0,39000.0,-70.0,-71.0,-67.0,-60.0,-70.0,-71.0,-67.0,-60.0,-90.0,-93.0,-90.0,-93.0,20.0,22.0,23.0,33.0,0
3292,BA:8C:B9:54:50:24,3825078,487981506,4548,6122480,3820530,481859026,0,7844,1605976,7823,1602619,21,3357,2291,14,4923,35,0,50,216660.0,130000.0,-39.0,-37.0,-45.0,-51.0,-42.0,-35.0,-42.0,-47.0,-90.0,-93.0,-90.0,-93.0,51.0,56.0,45.0,42.0,0
3293,92:69:1D:31:68:E9,3824131,485362852,3597,3503422,3820534,481859430,0,3849,981103,3745,957898,104,23205,1905,6,3723,79,0,31,216660.0,130000.0,-52.0,-50.0,-44.0,-46.0,-51.0,-49.0,-43.0,-46.0,-90.0,-93.0,-90.0,-93.0,38.0,43.0,46.0,47.0,0
3294,CC:2F:71:3F:1F:24,4431679,1173785945,611145,691926515,3820534,481859430,37,505688,559944514,505101,559873772,587,70742,488017,10,611382,53223,34,432,130000.0,43333.0,-67.0,-66.0,-71.0,-68.0,-67.0,-65.0,-70.0,-68.0,-90.0,-93.0,-90.0,-93.0,23.0,27.0,19.0,25.0,0
3295,CC:2F:71:3E:C5:1F,3821248,481946665,714,87235,3820534,481859430,0,3027,253737,2503,191461,524,62276,756,8,1045,18,0,32,130000.0,39000.0,-70.0,-71.0,-67.0,-60.0,-70.0,-71.0,-67.0,-60.0,-90.0,-93.0,-90.0,-93.0,20.0,22.0,23.0,33.0,0
3296,BA:8C:B9:54:50:24,3825082,487981910,4548,6122480,3820534,481859430,0,7844,1605976,7823,1602619,21,3357,2291,14,4923,35,0,50,216660.0,130000.0,-39.0,-37.0,-45.0,-51.0,-42.0,-35.0,-42.0,-47.0,-90.0,-93.0,-90.0,-93.0,51.0,56.0,45.0,42.0,0
3297,92:69:1D:31:68:E9,3824136,485363316,3597,3503422,3820539,481859894,0,3849,981103,3745,957898,104,23205,1905,6,3723,79,0,31,216660.0,130000.0,-52.0,-50.0,-44.0,-46.0,-51.0,-49.0,-43.0,-46.0,-90.0,-93.0,-89.0,-93.0,38.0,43.0,45.0,47.0,0
3298,CC:2F:71:3F:1F:24,4431726,1173800949,611187,691941055,3820539,481859894,37,505716,559949738,505129,559878996,587,70742,488045,10,611424,53228,34,432,130000.0,43333.0,-68.0,-66.0,-71.0,-68.0,-68.0,-66.0,-71.0,-68.0,-90.0,-93.0,-89.0,-93.0,22.0,27.0,18.0,25.0,0
3299,CC:2F:71:3E:C5:1F,3821253,481947129,714,87235,3820539,481859894,0,3027,253737,2503,191461,524,62276,756,8,1045,18,0,32,130000.0,39000.0,-70.0,-71.0,-67.0,-60.0,-70.0,-71.0,-67.0,-60.0,-90.0,-93.0,-89.0,-93.0,20.0,22.0,22.0,33.0,0
3300,BA:8C:B9:54:50:24,3825087,487982374,4548,6122480,3820539,481859894,0,7844,1605976,7823,1602619,21,3357,2291,14,4923,35,0,50,216660.0,130000.0,-39.0,-37.0,-45.0,-51.0,-42.0,-35.0,-42.0,-47.0,-90.0,-93.0,-89.0,-93.0,51.0,56.0,44.0,42.0,0
3301,92:69:1D:31:68:E9,3824140,485363720,3597,3503422,3820543,481860298,0,3849,981103,3745,957898,104,23205,1905,6,3723,79,0,31,216660.0,130000.0,-52.0,-50.0,-44.0,-46.0,-51.0,-49.0,-43.0,-46.0,-90.0,-92.0,-89.0,-93.0,38.0,42.0,45.0,47.0,0
3302,CC:2F:71:3F:1F:24,4431772,1173815781,611229,691955483,3820543,481860298,37,505742,559954682,505155,559883940,587,70742,488071,10,611466,53245,34,432,117000.0,39000.0,-68.0,-66.0,-71.0,-68.0,-67.0,-66.0,-71.0,-68.0,-90.0,-92.0,-89.0,-93.0,22.0,26.0,18.0,25.0,0
3303,CC:2F:71:3E:C5:1F,3821257,481947533,714,87235,3820543,481860298,0,3027,253737,2503,191461,524,62276,756,8,1045,18,0,32,130000.0,39000.0,-70.0,-71.0,-67.0,-60.0,-70.0,-71.0,-67.0,-60.0,-90.0,-92.0,-89.0,-93.0,20.0,21.0,22.0,33.0,0
3304,BA:8C:B9:54:50:24,3825091,487982778,4548,6122480,3820543,481860298,0,7844,1605976,7823,1602619,21,3357,2291,14,4923,35,0,50,216660.0,130000.0,-39.0,-37.0,-45.0,-51.0,-42.0,-35.0,-42.0,-47.0,-90.0,-92.0,-89.0,-93.0,51.0,55.0,44.0,42.0,0
3305,92:69:1D:31:68:E9,3824142,485363922,3597,3503422,3820545,481860500,0,3849,981103,3745,957898,104,23205,1905,6,3723,79,0,31,216660.0,130000.0,-52.0,-50.0,-44.0,-46.0,-51.0,-49.0,-43.0,-46.0,-90.0,-92.0,-89.0,-93.0,38.0,42.0,45.0,47.0,0
3306,CC:2F:71:3F:1F:24,4431818,1173830549,611270,691969787,3820548,481860762,37,505768,559959602,505181,559888860,587,70742,488097,10,611507,53248,34,432,130000.0,43333.0,-74.0,-72.0,-77.0,-74.0,-73.0,-71.0,-76.0,-73.0,-90.0,-92.0,-89.0,-93.0,16.0,20.0,12.0,19.0,0
3307,CC:2F:71:3E:C5:1F,3821262,481947997,714,87235,3820548,481860762,0,3027,253737,2503,191461,524,62276,756,8,1045,18,0,32,130000.0,39000.0,-70.0,-71.0,-67.0,-60.0,-70.0,-71.0,-67.0,-60.0,-90.0,-92.0,-89.0,-93.0,20.0,21.0,22.0,33.0,0
3308,BA:8C:B9:54:50:24,3825096,487983242,4548,6122480,3820548,481860762,0,7844,1605976,7823,1602619,21,3357,2291,14,4923,35,0,50,216660.0,130000.0,-39.0,-37.0,-45.0,-51.0,-42.0,-35.0,-42.0,-47.0,-90.0,-92.0,-89.0,-93.0,51.0,55.0,44.0,42.0,0
3309,92:69:1D:31:68:E9,3824149,485364588,3597,3503422,3820552,481861166,0,3849,981103,3745,957898,104,23205,1905,6,3723,79,0,31,216660.0,130000.0,-52.0,-50.0,-44.0,-46.0,-51.0,-49.0,-43.0,-46.0,-90.0,-92.0,-89.0,-93.0,38.0,42.0,45.0,47.0,0
3310,CC:2F:71:3F:1F:24,4431864,1173845381,611312,691984215,3820552,481861166,37,505794,559964546,505207,559893804,587,70742,488123,10,611549,53285,34,432,144444.0,39000.0,-78.0,-77.0,-82.0,-79.0,-73.0,-71.0,-76.0,-73.0,-90.0,-92.0,-89.0,-93.0,12.0,15.0,7.0,14.0,0
3311,CC:2F:71:3E:C5:1F,3821266,481948401,714,87235,3820552,481861166,0,3027,253737,2503,191461,524,62276,756,8,1045,18,0,32,130000.0,39000.0,-70.0,-71.0,-67.0,-60.0,-70.0,-71.0,-67.0,-60.0,-90.0,-92.0,-89.0,-93.0,20.0,21.0,22.0,33.0,0
3312,BA:8C:B9:54:50:24,3825100,487983646,4548,6122480,3820552,481861166,0,7844,1605976,7823,1602619,21,3357,2291,14,4923,35,0,50,216660.0,130000.0,-39.0,-37.0,-45.0,-51.0,-42.0,-35.0,-42.0,-47.0,-90.0,-92.0,-89.0,-93.0,51.0,55.0,44.0,42.0,0
3313,92:69:1D:31:68:E9,3824151,485364790,3597,3503422,3820554,481861368,0,3849,981103,3745,957898,104,23205,1905,6,3723,79,0,31,216660.0,130000.0,-52.0,-50.0,-44.0,-46.0,-51.0,-49.0,-43.0,-46.0,-90.0,-92.0,-89.0,-93.0,38.0,42.0,45.0,47.0,0
3314,CC:2F:71:3F:1F:24,4431910,1173860213,611354,691998643,3820556,481861570,37,505819,559969350,505232,559898608,587,70742,488148,10,611591,53296,34,432,130000.0,43333.0,-79.0,-77.0,-81.0,-79.0,-74.0,-72.0,-77.0,-75.0,-90.0,-92.0,-89.0,-93.0,11.0,15.0,8.0,14.0,0
3315,CC:2F:71:3E:C5:1F,3821270,481948805,714,87235,3820556,481861570,0,3027,253737,2503,191461,524,62276,756,8,1045,18,0,32,130000.0,39000.0,-70.0,-71.0,-67.0,-60.0,-70.0,-71.0,-67.0,-60.0,-90.0,-92.0,-89.0,-93.0,20.0,21.0,22.0,33.0,0
3316,BA:8C:B9:54:50:24,3825104,487984050,4548,6122480,3820556,481861570,0,7844,1605976,7823,1602619,21,3357,2291,14,4923,35,0,50,216660.0,130000.0,-39.0,-37.0,-45.0,-51.0,-42.0,-35.0,-42.0,-47.0,-90.0,-92.0,-89.0,-93.0,51.0,55.0,44.0,42.0,0
3317,92:69:1D:31:68:E9,3824158,485365456,3597,3503422,3820561,481862034,0,3849,981103,3745,957898,104,23205,1905,6,3723,79,0,31,216660.0,130000.0,-52.0,-50.0,-44.0,-46.0,-51.0,-49.0,-43.0,-46.0,-90.0,-92.0,-89.0,-93.0,38.0,42.0,45.0,47.0,0
3318,CC:2F:71:3F:1F:24,4431956,1173875037,611395,692013003,3820561,481862034,37,505845,559974294,505258,559903552,587,70742,488174,10,611632,53309,34,432,130000.0,39000.0,-67.0,-65.0,-70.0,-67.0,-67.0,-65.0,-70.0,-67.0,-90.0,-92.0,-89.0,-93.0,23.0,27.0,19.0,26.0,0
3319,CC:2F:71:3E:C5:1F,3821275,481949269,714,87235,3820561,481862034,0,3027,253737,2503,191461,524,62276,756,8,1045,18,0,32,130000.0,39000.0,-70.0,-71.0,-67.0,-60.0,-70.0,-71.0,-67.0,-60.0,-90.0,-92.0,-89.0,-93.0,20.0,21.0,22.0,33.0,0
3320,BA:8C:B9:54:50:24,3825109,487984514,4548,6122480,3820561,481862034,0,7844,1605976,7823,1602619,21,3357,2291,14,4923,35,0,50,216660.0,130000.0,-39.0,-37.0,-45.0,-51.0,-42.0,-35.0,-42.0,-47.0,-90.0,-92.0,-89.0,-93.0,51.0,55.0,44.0,42.0,0
3321,92:69:1D:31:68:E9,3824160,485365658,3597,3503422,3820563,481862236,0,3849,981103,3745,957898,104,23205,1905,6,3723,79,0,31,216660.0,130000.0,-52.0,-50.0,-44.0,-46.0,-51.0,-49.0,-43.0,-46.0,-90.0,-92.0,-89.0,-93.0,38.0,42.0,45.0,47.0,0
3322,CC:2F:71:3F:1F:24,4432003,1173889993,611438,692027555,3820565,481862438,37,505872,559979378,505285,559908636,587,70742,488201,10,611675,53324,34,432,130000.0,43333.0,-67.0,-65.0,-70.0,-67.0,-67.0,-65.0,-69.0,-67.0,-90.0,-92.0,-89.0,-93.0,23.0,27.0,19.0,26.0,0
3323,CC:2F:71:3E:C5:1F,3821279,481949673,714,87235,3820565,481862438,0,3027,253737,2503,191461,524,62276,756,8,1045,18,0,32,130000.0,39000.0,-70.0,-71.0,-67.0,-60.0,-70.0,-71.0,-67.0,-60.0,-90.0,-92.0,-89.0,-93.0,20.0,21.0,22.0,33.0,0
3324,BA:8C:B9:54:50:24,3825113,487984918,4548,6122480,3820565,481862438,0,7844,1605976,7823,1602619,21,3357,2291,14,4923,35,0,50,216660.0,130000.0,-39.0,-37.0,-45.0,-51.0,-42.0,-35.0,-42.0,-47.0,-90.0,-92.0,-89.0,-93.0,51.0,55.0,44.0,42.0,0
3325,92:69:1D:31:68:E9,3824166,485366264,3597,3503422,3820569,481862842,0,3849,981103,3745,957898,104,23205,1905,6,3723,79,0,31,216660.0,130000.0,-52.0,-50.0,-44.0,-46.0,-51.0,-49.0,-43.0,-46.0,-90.0,-92.0,-89.0,-93.0,38.0,42.0,45.0,47.0,0
3326,CC:2F:71:3F:1F:24,4432049,1173904769,611480,692041927,3820569,481862842,37,505898,559984298,505311,559913556,587,70742,488227,10,611717,53343,34,432,144444.0,39000.0,-67.0,-65.0,-71.0,-67.0,-67.0,-65.0,-70.0,-67.0,-90.0,-92.0,-89.0,-93.0,23.0,27.0,18.0,26.0,0
3327,CC:2F:71:3E:C5:1F,3821283,481950077,714,87235,3820569,481862842,0,3027,253737,2503,191461,524,62276,756,8,1045,18,0,32,130000.0,39000.0,-70.0,-71.0,-67.0,-60.0,-70.0,-71.0,-67.0,-60.0,-90.0,-92.0,-89.0,-93.0,20.0,21.0,22.0,33.0,0
3328,BA:8C:B9:54:50:24,3825117,487985322,4548,6122480,3820569,481862842,0,7844,1605976,7823,1602619,21,3357,2291,14,4923,35,0,50,216660.0,130000.0,-39.0,-37.0,-45.0,-51.0,-42.0,-35.0,-42.0,-47.0,-90.0,-92.0,-89.0,-93.0,51.0,55.0,44.0,42.0,0
3329,92:69:1D:31:68:E9,3824169,485366526,3597,3503422,3820572,481863104,0,3849,981103,3745,957898,104,23205,1905,6,3723,79,0,31,216660.0,130000.0,-52.0,-50.0,-44.0,-46.0,-51.0,-49.0,-43.0,-46.0,-90.0,-92.0,-89.0,-93.0,38.0,42.0,45.0,47.0,0
3330,CC:2F:71:3F:1F:24,4432098,1173919901,611524,692056595,3820574,481863306,37,505924,559989242,505337,559918500,587,70742,488253,10,611761,53379,34,432,130000.0,43333.0,-67.0,-65.0,-70.0,-67.0,-67.0,-65.0,-69.0,-67.0,-90.0,-92.0,-89.0,-93.0,23.0,27.0,19.0,26.0,0
3331,CC:2F:71:3E:C5:1F,3821289,481950657,715,87351,3820574,481863306,0,3028,253807,2504,191531,524,62276,756,8,1046,18,0,32,130000.0,39000.0,-70.0,-71.0,-67.0,-60.0,-70.0,-71.0,-67.0,-60.0,-90.0,-92.0,-89.0,-93.0,20.0,21.0,22.0,33.0,0
3332,BA:8C:B9:54:50:24,3825123,487985846,4549,6122540,3820574,481863306,0,7846,1606112,7825,1602755,21,3357,2291,14,4924,35,0,50,216660.0,130000.0,-39.0,-37.0,-45.0,-51.0,-41.0,-35.0,-43.0,-48.0,-90.0,-92.0,-89.0,-93.0,51.0,55.0,44.0,42.0,0
3333,92:69:1D:31:68:E9,3824177,485367521,3598,3503538,3820579,481863983,0,3851,981239,3747,958034,104,23205,1905,6,3724,79,0,31,216660.0,130000.0,-52.0,-50.0,-44.0,-46.0,-52.0,-50.0,-44.0,-46.0,-90.0,-92.0,-89.0,-93.0,38.0,42.0,45.0,47.0,0
3334,CC:2F:71:3F:1F:24,4432146,1173935242,611567,692071259,3820579,481863983,37,505950,559994186,505363,559923444,587,70742,488279,10,611804,53382,34,432,130000.0,43333.0,-67.0,-65.0,-70.0,-68.0,-67.0,-65.0,-70.0,-67.0,-90.0,-92.0,-89.0,-93.0,23.0,27.0,19.0,25.0,0
3335,CC:2F:71:3E:C5:1F,3821294,481951334,715,87351,3820579,481863983,0,3029,253877,2505,191601,524,62276,756,8,1046,18,0,32,130000.0,39000.0,-71.0,-71.0,-67.0,-60.0,-70.0,-71.0,-67.0,-60.0,-90.0,-92.0,-89.0,-93.0,19.0,21.0,22.0,33.0,0
3336,BA:8C:B9:54:50:24,3825128,487986523,4549,6122540,3820579,481863983,0,7846,1606112,7825,1602755,21,3357,2291,14,4924,35,0,50,216660.0,130000.0,-39.0,-37.0,-45.0,-51.0,-41.0,-35.0,-43.0,-48.0,-90.0,-92.0,-89.0,-93.0,51.0,55.0,44.0,42.0,0
3337,92:69:1D:31:68:E9,3824180,485367783,3598,3503538,3820582,481864245,0,3851,981239,3747,958034,104,23205,1905,6,3724,79,0,31,216660.0,130000.0,-52.0,-50.0,-44.0,-46.0,-52.0,-50.0,-44.0,-46.0,-90.0,-92.0,-89.0,-92.0,38.0,42.0,45.0,46.0,0
3338,CC:2F:71:3F:1F:24,4432191,1173949932,611609,692085687,3820582,481864245,37,505976,559999130,505389,559928388,587,70742,488305,10,611846,53398,34,432,117000.0,39000.0,-67.0,-65.0,-70.0,-67.0,-67.0,-65.0,-70.0,-67.0,-90.0,-92.0,-89.0,-92.0,23.0,27.0,19.0,25.0,0
3339,CC:2F:71:3E:C5:1F,3821297,481951596,715,87351,3820582,481864245,0,3029,253877,2505,191601,524,62276,756,8,1046,18,0,32,130000.0,39000.0,-71.0,-71.0,-67.0,-60.0,-70.0,-71.0,-67.0,-60.0,-90.0,-92.0,-89.0,-92.0,19.0,21.0,22.0,32.0,0
3340,BA:8C:B9:54:50:24,3825133,487986987,4549,6122540,3820584,481864447,0,7846,1606112,7825,1602755,21,3357,2291,14,4924,35,0,50,216660.0,130000.0,-39.0,-37.0,-45.0,-51.0,-41.0,-35.0,-43.0,-48.0,-90.0,-92.0,-89.0,-92.0,51.0,55.0,44.0,41.0,0
3341,92:69:1D:31:68:E9,3824186,485368389,3598,3503538,3820588,481864851,0,3851,981239,3747,958034,104,23205,1905,6,3724,79,0,31,216660.0,130000.0,-52.0,-50.0,-44.0,-46.0,-52.0,-50.0,-44.0,-46.0,-90.0,-92.0,-89.0,-92.0,38.0,42.0,45.0,46.0,0
3342,CC:2F:71:3F:1F:24,4432239,1173964966,611651,692100115,3820588,481864851,37,506002,560004074,505415,559933332,587,70742,488331,10,611888,53400,34,432,130000.0,43333.0,-67.0,-65.0,-71.0,-68.0,-67.0,-65.0,-70.0,-67.0,-90.0,-92.0,-89.0,-92.0,23.0,27.0,18.0,24.0,0
3343,CC:2F:71:3E:C5:1F,3821303,481952202,715,87351,3820588,481864851,0,3029,253877,2505,191601,524,62276,756,8,1046,18,0,32,130000.0,39000.0,-71.0,-71.0,-67.0,-60.0,-70.0,-71.0,-67.0,-60.0,-90.0,-92.0,-89.0,-92.0,19.0,21.0,22.0,32.0,0
3344,BA:8C:B9:54:50:24,3825137,487987391,4549,6122540,3820588,481864851,0,7846,1606112,7825,1602755,21,3357,2291,14,4924,35,0,50,216660.0,130000.0,-39.0,-37.0,-45.0,-51.0,-41.0,-35.0,-43.0,-48.0,-90.0,-92.0,-89.0,-92.0,51.0,55.0,44.0,41.0,0
3345,92:69:1D:31:68:E9,3824189,485368653,3598,3503538,3820591,481865115,0,3851,981239,3747,958034,104,23205,1905,6,3724,79,0,31,216660.0,130000.0,-52.0,-50.0,-44.0,-46.0,-52.0,-50.0,-44.0,-46.0,-90.0,-92.0,-89.0,-92.0,38.0,42.0,45.0,46.0,0
3346,CC:2F:71:3F:1F:24,4432285,1173979782,611694,692114667,3820591,481865115,37,506029,560009136,505441,559938276,588,70860,488358,10,611931,53427,34,432,117000.0,39000.0,-67.0,-65.0,-70.0,-68.0,-67.0,-65.0,-70.0,-67.0,-90.0,-92.0,-89.0,-92.0,23.0,27.0,19.0,24.0,0
3347,CC:2F:71:3E:C5:1F,3821306,481952466,715,87351,3820591,481865115,0,3029,253877,2505,191601,524,62276,756,8,1046,18,0,32,130000.0,39000.0,-71.0,-71.0,-67.0,-60.0,-70.0,-71.0,-67.0,-60.0,-90.0,-92.0,-89.0,-92.0,19.0,21.0,22.0,32.0,0
3348,BA:8C:B9:54:50:24,3825141,487987789,4549,6122540,3820592,481865249,0,7846,1606112,7825,1602755,21,3357,2291,14,4924,35,0,50,216660.0,130000.0,-39.0,-37.0,-45.0,-51.0,-41.0,-35.0,-43.0,-48.0,-90.0,-92.0,-89.0,-92.0,51.0,55.0,44.0,41.0,0
3349,92:69:1D:31:68:E9,3824196,485369319,3598,3503538,3820598,481865781,0,3851,981239,3747,958034,104,23205,1905,6,3724,79,0,31,216660.0,130000.0,-52.0,-50.0,-44.0,-46.0,-52.0,-50.0,-44.0,-46.0,-90.0,-92.0,-89.0,-92.0,38.0,42.0,45.0,46.0,0
3350,CC:2F:71:3F:1F:24,4432334,1173994876,611736,692129095,3820598,481865781,37,506056,560014196,505468,559943336,588,70860,488385,10,611973,53433,34,432,130000.0,43333.0,-67.0,-65.0,-71.0,-68.0,-67.0,-65.0,-70.0,-67.0,-90.0,-92.0,-89.0,-92.0,23.0,27.0,18.0,24.0,0
3351,CC:2F:71:3E:C5:1F,3821313,481953132,715,87351,3820598,481865781,0,3029,253877,2505,191601,524,62276,756,8,1046,18,0,32,130000.0,39000.0,-71.0,-71.0,-67.0,-60.0,-70.0,-71.0,-67.0,-60.0,-90.0,-92.0,-89.0,-92.0,19.0,21.0,22.0,32.0,0
3352,BA:8C:B9:54:50:24,3825147,487988321,4549,6122540,3820598,481865781,0,7846,1606112,7825,1602755,21,3357,2291,14,4924,35,0,50,216660.0,130000.0,-39.0,-37.0,-45.0,-51.0,-41.0,-35.0,-43.0,-48.0,-90.0,-92.0,-89.0,-92.0,51.0,55.0,44.0,41.0,0
3353,92:69:1D:31:68:E9,3824198,485369521,3598,3503538,3820600,481865983,0,3851,981239,3747,958034,104,23205,1905,6,3724,79,0,31,216660.0,130000.0,-52.0,-50.0,-44.0,-46.0,-52.0,-50.0,-44.0,-46.0,-90.0,-92.0,-89.0,-92.0,38.0,42.0,45.0,46.0,0
3354,CC:2F:71:3F:1F:24,4432378,1174009506,611778,692143523,3820600,481865983,37,506081,560019000,505493,559948140,588,70860,488410,10,612015,53451,34,432,117000.0,39000.0,-67.0,-65.0,-70.0,-67.0,-67.0,-65.0,-70.0,-67.0,-90.0,-92.0,-89.0,-92.0,23.0,27.0,19.0,25.0,0
3355,CC:2F:71:3E:C5:1F,3821315,481953334,715,87351,3820600,481865983,0,3029,253877,2505,191601,524,62276,756,8,1046,18,0,32,130000.0,39000.0,-71.0,-71.0,-67.0,-60.0,-70.0,-71.0,-67.0,-60.0,-90.0,-92.0,-89.0,-92.0,19.0,21.0,22.0,32.0,0
3356,BA:8C:B9:54:50:24,3825149,487988523,4549,6122540,3820600,481865983,0,7846,1606112,7825,1602755,21,3357,2291,14,4924,35,0,50,216660.0,130000.0,-39.0,-37.0,-45.0,-51.0,-41.0,-35.0,-43.0,-48.0,-90.0,-92.0,-89.0,-92.0,51.0,55.0,44.0,41.0,0
3357,92:69:1D:31:68:E9,3824206,485370413,3600,3503824,3820606,481866589,0,3854,981575,3750,958370,104,23205,1907,6,3726,79,0,31,216660.0,130000.0,-53.0,-51.0,-46.0,-51.0,-52.0,-50.0,-44.0,-47.0,-90.0,-92.0,-89.0,-92.0,37.0,41.0,43.0,41.0,0
3358,CC:2F:71:3F:1F:24,4432427,1174024624,611821,692158035,3820606,481866589,37,506106,560023804,505518,559952944,588,70860,488435,10,612058,53461,34,432,130000.0,39000.0,-67.0,-65.0,-70.0,-67.0,-67.0,-65.0,-70.0,-67.0,-90.0,-92.0,-89.0,-92.0,23.0,27.0,19.0,25.0,0
3359,CC:2F:71:3E:C5:1F,3821322,481954000,715,87351,3820607,481866649,0,3029,253877,2505,191601,524,62276,756,8,1046,18,0,32,130000.0,39000.0,-71.0,-71.0,-67.0,-60.0,-70.0,-71.0,-67.0,-60.0,-90.0,-92.0,-89.0,-92.0,19.0,21.0,22.0,32.0,0
3360,BA:8C:B9:54:50:24,3825156,487989189,4549,6122540,3820607,481866649,0,7846,1606112,7825,1602755,21,3357,2291,14,4924,35,0,50,216660.0,130000.0,-39.0,-37.0,-45.0,-51.0,-41.0,-35.0,-43.0,-48.0,-90.0,-92.0,-89.0,-92.0,51.0,55.0,44.0,41.0,0
3361,92:69:1D:31:68:E9,3824209,485370675,3600,3503824,3820609,481866851,0,3855,981643,3751,958438,104,23205,1907,6,3726,79,0,31,216660.0,130000.0,-52.0,-50.0,-44.0,-46.0,-52.0,-50.0,-44.0,-47.0,-90.0,-92.0,-89.0,-92.0,38.0,42.0,45.0,46.0,0
3362,CC:2F:71:3F:1F:24,4432471,1174039190,611862,692172339,3820609,481866851,37,506132,560028784,505544,559957924,588,70860,488461,10,612099,53501,34,432,144444.0,43333.0,-67.0,-65.0,-70.0,-68.0,-67.0,-65.0,-70.0,-67.0,-90.0,-92.0,-89.0,-92.0,23.0,27.0,19.0,24.0,0
3363,CC:2F:71:3E:C5:1F,3821324,481954202,715,87351,3820609,481866851,0,3029,253877,2505,191601,524,62276,756,8,1046,18,0,32,130000.0,39000.0,-71.0,-71.0,-67.0,-60.0,-70.0,-71.0,-67.0,-60.0,-90.0,-92.0,-89.0,-92.0,19.0,21.0,22.0,32.0,0
3364,BA:8C:B9:54:50:24,3825158,487989391,4549,6122540,3820609,481866851,0,7846,1606112,7825,1602755,21,3357,2291,14,4924,35,0,50,216660.0,130000.0,-39.0,-37.0,-45.0,-51.0,-41.0,-35.0,-43.0,-48.0,-90.0,-92.0,-89.0,-92.0,51.0,55.0,44.0,41.0,0
3365,92:69:1D:31:68:E9,3824216,485371484,3601,3504027,3820615,481867457,0,3856,981711,3752,958506,104,23205,1907,6,3727,79,0,31,216660.0,130000.0,-52.0,-50.0,-44.0,-46.0,-52.0,-50.0,-44.0,-47.0,-90.0,-92.0,-89.0,-92.0,38.0,42.0,45.0,46.0,0
3366,CC:2F:71:3F:1F:24,4432520,1174054404,611905,692186947,3820615,481867457,37,506161,560034100,505573,559963240,588,70860,488490,10,612142,53512,34,432,130000.0,43333.0,-67.0,-65.0,-71.0,-67.0,-67.0,-65.0,-70.0,-67.0,-90.0,-92.0,-89.0,-92.0,23.0,27.0,18.0,25.0,0
3367,CC:2F:71:3E:C5:1F,3821330,481954808,715,87351,3820615,481867457,0,3029,253877,2505,191601,524,62276,756,8,1046,18,0,32,130000.0,39000.0,-71.0,-71.0,-67.0,-60.0,-70.0,-71.0,-67.0,-60.0,-90.0,-92.0,-89.0,-92.0,19.0,21.0,22.0,32.0,0
3368,BA:8C:B9:54:50:24,3825164,487989997,4549,6122540,3820615,481867457,0,7846,1606112,7825,1602755,21,3357,2291,14,4924,35,0,50,216660.0,130000.0,-39.0,-37.0,-45.0,-51.0,-41.0,-35.0,-43.0,-48.0,-90.0,-92.0,-89.0,-92.0,51.0,55.0,44.0,41.0,0
3369,92:69:1D:31:68:E9,3824219,485371746,3601,3504027,3820618,481867719,0,3861,982103,3757,958898,104,23205,1908,6,3727,79,0,31,216660.0,130000.0,-50.0,-47.0,-42.0,-48.0,-51.0,-48.0,-43.0,-48.0,-90.0,-92.0,-89.0,-92.0,40.0,45.0,47.0,44.0,0
3370,CC:2F:71:3F:1F:24,4432565,1174069094,611947,692201375,3820618,481867719,37,506187,560039044,505599,559968184,588,70860,488516,10,612184,53532,34,432,117000.0,39000.0,-67.0,-65.0,-70.0,-67.0,-67.0,-65.0,-70.0,-67.0,-90.0,-92.0,-89.0,-92.0,23.0,27.0,19.0,25.0,0
3371,CC:2F:71:3E:C5:1F,3821333,481955070,715,87351,3820618,481867719,0,3029,253877,2505,191601,524,62276,756,8,1046,18,0,32,130000.0,39000.0,-71.0,-71.0,-67.0,-60.0,-70.0,-71.0,-67.0,-60.0,-90.0,-92.0,-89.0,-92.0,19.0,21.0,22.0,32.0,0
3372,BA:8C:B9:54:50:24,3825167,487990259,4549,6122540,3820618,481867719,0,7846,1606112,7825,1602755,21,3357,2291,14,4924,35,0,50,216660.0,130000.0,-39.0,-37.0,-45.0,-51.0,-41.0,-35.0,-43.0,-48.0,-90.0,-92.0,-89.0,-92.0,51.0,55.0,44.0,41.0,0
3373,92:69:1D:31:68:E9,3824225,485372352,3601,3504027,3820624,481868325,0,3861,982103,3757,958898,104,23205,1908,6,3727,79,0,31,216660.0,130000.0,-50.0,-47.0,-42.0,-48.0,-51.0,-48.0,-43.0,-48.0,-90.0,-92.0,-89.0,-92.0,40.0,45.0,47.0,44.0,0
3374,CC:2F:71:3F:1F:24,4432615,1174084382,611991,692216057,3820624,481868325,37,506216,560044336,505628,559973476,588,70860,488545,10,612228,53540,34,432,130000.0,39000.0,-67.0,-65.0,-70.0,-67.0,-67.0,-65.0,-70.0,-67.0,-90.0,-92.0,-89.0,-92.0,23.0,27.0,19.0,25.0,0
3375,CC:2F:71:3E:C5:1F,3821339,481955676,715,87351,3820624,481868325,0,3029,253877,2505,191601,524,62276,756,8,1046,18,0,32,130000.0,39000.0,-71.0,-71.0,-67.0,-60.0,-70.0,-71.0,-67.0,-60.0,-90.0,-92.0,-89.0,-92.0,19.0,21.0,22.0,32.0,0
3376,BA:8C:B9:54:50:24,3825173,487990865,4549,6122540,3820624,481868325,0,7846,1606112,7825,1602755,21,3357,2291,14,4924,35,0,50,216660.0,130000.0,-39.0,-37.0,-45.0,-51.0,-41.0,-35.0,-43.0,-48.0,-90.0,-92.0,-89.0,-92.0,51.0,55.0,44.0,41.0,0
3377,92:69:1D:31:68:E9,3824228,485372616,3601,3504027,3820627,481868589,0,3861,982103,3757,958898,104,23205,1908,6,3727,79,0,31,216660.0,130000.0,-50.0,-47.0,-42.0,-48.0,-51.0,-48.0,-43.0,-48.0,-90.0,-92.0,-89.0,-92.0,40.0,45.0,47.0,44.0,0
3378,CC:2F:71:3F:1F:24,4432659,1174098950,612032,692230361,3820627,481868589,37,506241,560049140,505653,559978280,588,70860,488570,10,612269,53570,34,432,117000.0,39000.0,-67.0,-65.0,-71.0,-68.0,-67.0,-65.0,-70.0,-67.0,-90.0,-92.0,-89.0,-92.0,23.0,27.0,18.0,24.0,0
3379,CC:2F:71:3E:C5:1F,3821342,481955940,715,87351,3820627,481868589,0,3031,254065,2506,191671,525,62394,757,8,1046,18,0,32,130000.0,39000.0,-70.0,-71.0,-67.0,-60.0,-70.0,-71.0,-67.0,-60.0,-90.0,-92.0,-89.0,-92.0,20.0,21.0,22.0,32.0,0
3380,BA:8C:B9:54:50:24,3825176,487991129,4549,6122540,3820627,481868589,0,7846,1606112,7825,1602755,21,3357,2291,14,4924,35,0,50,216660.0,130000.0,-39.0,-37.0,-45.0,-51.0,-41.0,-35.0,-43.0,-48.0,-90.0,-92.0,-89.0,-92.0,51.0,55.0,44.0,41.0,0
3381,92:69:1D:31:68:E9,3824247,485378881,3601,3504027,3820646,481874854,0,3864,982474,3759,959034,105,23440,1909,6,3727,79,0,31,216660.0,130000.0,-50.0,-47.0,-42.0,-48.0,-51.0,-48.0,-43.0,-48.0,-90.0,-92.0,-89.0,-92.0,40.0,45.0,47.0,44.0,0
3382,CC:2F:71:3F:1F:24,4432720,1174119587,612074,692244733,3820646,481874854,37,506268,560054224,505680,559983364,588,70860,488597,10,612311,53579,34,432,130000.0,39000.0,-67.0,-65.0,-70.0,-67.0,-67.0,-65.0,-70.0,-67.0,-90.0,-92.0,-89.0,-92.0,23.0,27.0,19.0,25.0,0
3383,CC:2F:71:3E:C5:1F,3821372,481967629,715,87351,3820657,481880278,0,3031,254065,2506,191671,525,62394,757,8,1046,18,0,32,130000.0,39000.0,-70.0,-71.0,-67.0,-60.0,-70.0,-71.0,-67.0,-60.0,-90.0,-92.0,-89.0,-92.0,20.0,21.0,22.0,32.0,0
3384,BA:8C:B9:54:50:24,3825206,488002818,4549,6122540,3820657,481880278,0,7846,1606112,7825,1602755,21,3357,2291,14,4924,35,0,50,216660.0,130000.0,-39.0,-37.0,-45.0,-51.0,-41.0,-35.0,-43.0,-48.0,-90.0,-92.0,-89.0,-92.0,51.0,55.0,44.0,41.0,0
3385,92:69:1D:31:68:E9,3824261,485384780,3601,3504027,3820660,481880753,0,3864,982474,3759,959034,105,23440,1909,6,3727,79,0,31,216660.0,130000.0,-50.0,-47.0,-42.0,-48.0,-51.0,-48.0,-43.0,-48.0,-90.0,-92.0,-89.0,-92.0,40.0,45.0,47.0,44.0,0
3386,CC:2F:71:3F:1F:24,4432778,1174140364,612118,692259611,3820660,481880753,37,506298,560059686,505710,559988826,588,70860,488627,10,612355,53617,34,432,130000.0,39000.0,-67.0,-65.0,-70.0,-68.0,-67.0,-65.0,-70.0,-67.0,-90.0,-92.0,-89.0,-92.0,23.0,27.0,19.0,24.0,0
3387,CC:2F:71:3E:C5:1F,3821375,481968104,715,87351,3820660,481880753,0,3031,254065,2506,191671,525,62394,757,8,1046,18,0,32,130000.0,39000.0,-70.0,-71.0,-67.0,-60.0,-70.0,-71.0,-67.0,-60.0,-90.0,-92.0,-89.0,-92.0,20.0,21.0,22.0,32.0,0
3388,BA:8C:B9:54:50:24,3825211,488003495,4549,6122540,3820662,481880955,0,7846,1606112,7825,1602755,21,3357,2291,14,4924,35,0,50,216660.0,130000.0,-39.0,-37.0,-45.0,-51.0,-41.0,-35.0,-43.0,-48.0,-90.0,-92.0,-89.0,-92.0,51.0,55.0,44.0,41.0,0
3389,92:69:1D:31:68:E9,3824268,485385446,3601,3504027,3820667,481881419,0,3864,982474,3759,959034,105,23440,1909,6,3727,79,0,31,216660.0,130000.0,-50.0,-47.0,-42.0,-48.0,-51.0,-48.0,-43.0,-48.0,-90.0,-92.0,-89.0,-92.0,40.0,45.0,47.0,44.0,0
3390,CC:2F:71:3F:1F:24,4432828,1174155526,612161,692274107,3820667,481881419,37,506326,560064862,505738,559994002,588,70860,488655,10,612398,53641,34,432,130000.0,39000.0,-67.0,-65.0,-70.0,-68.0,-67.0,-65.0,-70.0,-67.0,-90.0,-92.0,-89.0,-92.0,23.0,27.0,19.0,24.0,0
3391,CC:2F:71:3E:C5:1F,3821382,481968770,715,87351,3820667,481881419,0,3031,254065,2506,191671,525,62394,757,8,1046,18,0,32,130000.0,39000.0,-70.0,-71.0,-67.0,-60.0,-70.0,-71.0,-67.0,-60.0,-90.0,-92.0,-89.0,-92.0,20.0,21.0,22.0,32.0,0
3392,BA:8C:B9:54:50:24,3825216,488003959,4549,6122540,3820667,481881419,0,7846,1606112,7825,1602755,21,3357,2291,14,4924,35,0,50,216660.0,130000.0,-39.0,-37.0,-45.0,-51.0,-41.0,-35.0,-43.0,-48.0,-90.0,-92.0,-89.0,-92.0,51.0,55.0,44.0,41.0,0
3393,92:69:1D:31:68:E9,3824274,485386210,3605,3504589,3820669,481881621,0,3871,983120,3766,959680,105,23440,1911,6,3731,79,0,31,216660.0,130000.0,-52.0,-50.0,-44.0,-46.0,-51.0,-49.0,-44.0,-48.0,-90.0,-92.0,-89.0,-92.0,38.0,42.0,45.0,46.0,0
3394,CC:2F:71:3F:1F:24,4432873,1174170280,612204,692288659,3820669,481881621,37,506352,560069806,505764,559998946,588,70860,488681,10,612441,53654,34,432,130000.0,43333.0,-67.0,-65.0,-70.0,-67.0,-67.0,-65.0,-70.0,-67.0,-90.0,-92.0,-89.0,-92.0,23.0,27.0,19.0,25.0,0
3395,CC:2F:71:3E:C5:1F,3821384,481968972,715,87351,3820669,481881621,0,3031,254065,2506,191671,525,62394,757,8,1046,18,0,32,130000.0,39000.0,-70.0,-71.0,-67.0,-60.0,-70.0,-71.0,-67.0,-60.0,-90.0,-92.0,-89.0,-92.0,20.0,21.0,22.0,32.0,0
3396,BA:8C:B9:54:50:24,3825220,488004363,4549,6122540,3820671,481881823,0,7846,1606112,7825,1602755,21,3357,2291,14,4924,35,0,50,216660.0,130000.0,-39.0,-37.0,-45.0,-51.0,-41.0,-35.0,-43.0,-48.0,-90.0,-92.0,-89.0,-92.0,51.0,55.0,44.0,41.0,0
3397,92:69:1D:31:68:E9,3824280,485386816,3605,3504589,3820675,481882227,0,3871,983120,3766,959680,105,23440,1911,6,3731,79,0,31,216660.0,130000.0,-52.0,-50.0,-44.0,-46.0,-51.0,-49.0,-44.0,-48.0,-90.0,-92.0,-89.0,-92.0,38.0,42.0,45.0,46.0,0
3398,CC:2F:71:3F:1F:24,4432922,1174185500,612247,692303273,3820675,481882227,37,506379,560074866,505791,560004006,588,70860,488708,10,612484,53659,34,432,130000.0,43333.0,-67.0,-65.0,-70.0,-68.0,-67.0,-65.0,-70.0,-67.0,-90.0,-92.0,-89.0,-92.0,23.0,27.0,19.0,24.0,0
3399,CC:2F:71:3E:C5:1F,3821392,481969946,715,87351,3820677,481882595,0,3031,254065,2506,191671,525,62394,757,8,1046,18,0,32,130000.0,39000.0,-70.0,-71.0,-67.0,-60.0,-70.0,-71.0,-67.0,-60.0,-90.0,-92.0,-89.0,-92.0,20.0,21.0,22.0,32.0,0
3400,BA:8C:B9:54:50:24,3825226,488005135,4549,6122540,3820677,481882595,0,7846,1606112,7825,1602755,21,3357,2291,14,4924,35,0,50,216660.0,130000.0,-39.0,-37.0,-45.0,-51.0,-41.0,-35.0,-43.0,-48.0,-90.0,-92.0,-89.0,-92.0,51.0,55.0,44.0,41.0,0
3401,92:69:1D:31:68:E9,3824285,485387446,3605,3504589,3820680,481882857,0,3871,983120,3766,959680,105,23440,1911,6,3731,79,0,31,216660.0,130000.0,-52.0,-50.0,-44.0,-46.0,-51.0,-49.0,-44.0,-48.0,-90.0,-92.0,-89.0,-92.0,38.0,42.0,45.0,46.0,0
3402,CC:2F:71:3F:1F:24,4432969,1174200614,612289,692317757,3820680,481882857,37,506406,560079926,505818,560009066,588,70860,488735,10,612526,53679,34,432,130000.0,39000.0,-67.0,-65.0,-70.0,-67.0,-67.0,-65.0,-70.0,-67.0,-90.0,-92.0,-89.0,-92.0,23.0,27.0,19.0,25.0,0
3403,CC:2F:71:3E:C5:1F,3821395,481970208,715,87351,3820680,481882857,0,3031,254065,2506,191671,525,62394,757,8,1046,18,0,32,130000.0,39000.0,-70.0,-71.0,-67.0,-60.0,-70.0,-71.0,-67.0,-60.0,-90.0,-92.0,-89.0,-92.0,20.0,21.0,22.0,32.0,0
3404,BA:8C:B9:54:50:24,3825231,488005599,4549,6122540,3820682,481883059,0,7846,1606112,7825,1602755,21,3357,2291,14,4924,35,0,50,216660.0,130000.0,-39.0,-37.0,-45.0,-51.0,-41.0,-35.0,-43.0,-48.0,-90.0,-92.0,-89.0,-92.0,51.0,55.0,44.0,41.0,0
3405,92:69:1D:31:68:E9,3824291,485388052,3605,3504589,3820686,481883463,0,3871,983120,3766,959680,105,23440,1911,6,3731,79,0,31,216660.0,130000.0,-52.0,-50.0,-44.0,-46.0,-51.0,-49.0,-44.0,-48.0,-90.0,-92.0,-89.0,-92.0,38.0,42.0,45.0,46.0,0
3406,CC:2F:71:3F:1F:24,4433018,1174215772,612332,692332309,3820686,481883463,37,506432,560084870,505844,560014010,588,70860,488761,10,612569,53694,34,432,130000.0,43333.0,-67.0,-65.0,-71.0,-68.0,-67.0,-65.0,-70.0,-67.0,-90.0,-92.0,-89.0,-92.0,23.0,27.0,18.0,24.0,0
3407,CC:2F:71:3E:C5:1F,3821401,481970814,715,87351,3820686,481883463,0,3031,254065,2506,191671,525,62394,757,8,1046,18,0,32,130000.0,39000.0,-70.0,-71.0,-67.0,-60.0,-70.0,-71.0,-67.0,-60.0,-90.0,-92.0,-89.0,-92.0,20.0,21.0,22.0,32.0,0
3408,BA:8C:B9:54:50:24,3825235,488006003,4549,6122540,3820686,481883463,0,7846,1606112,7825,1602755,21,3357,2291,14,4924,35,0,50,216660.0,130000.0,-39.0,-37.0,-45.0,-51.0,-41.0,-35.0,-43.0,-48.0,-90.0,-92.0,-89.0,-92.0,51.0,55.0,44.0,41.0,0
3409,92:69:1D:31:68:E9,3824293,485388254,3605,3504589,3820688,481883665,0,3871,983120,3766,959680,105,23440,1911,6,3731,79,0,31,216660.0,130000.0,-52.0,-50.0,-44.0,-46.0,-51.0,-49.0,-44.0,-48.0,-90.0,-92.0,-89.0,-92.0,38.0,42.0,45.0,46.0,0
3410,CC:2F:71:3F:1F:24,4433062,1174230346,612374,692346681,3820688,481883665,37,506457,560089674,505869,560018814,588,70860,488786,10,612611,53724,34,432,144444.0,39000.0,-67.0,-65.0,-70.0,-67.0,-67.0,-65.0,-70.0,-67.0,-90.0,-92.0,-89.0,-92.0,23.0,27.0,19.0,25.0,0
3411,CC:2F:71:3E:C5:1F,3821405,481971218,715,87351,3820690,481883867,0,3031,254065,2506,191671,525,62394,757,8,1046,18,0,32,130000.0,39000.0,-70.0,-71.0,-67.0,-60.0,-70.0,-71.0,-67.0,-60.0,-90.0,-92.0,-89.0,-92.0,20.0,21.0,22.0,32.0,0
3412,BA:8C:B9:54:50:24,3825240,488006467,4549,6122540,3820691,481883927,0,7846,1606112,7825,1602755,21,3357,2291,14,4924,35,0,50,216660.0,130000.0,-39.0,-37.0,-45.0,-51.0,-41.0,-35.0,-43.0,-48.0,-90.0,-92.0,-89.0,-92.0,51.0,55.0,44.0,41.0,0
3413,92:69:1D:31:68:E9,3824300,485388920,3605,3504589,3820695,481884331,0,3871,983120,3766,959680,105,23440,1911,6,3731,79,0,31,216660.0,130000.0,-52.0,-50.0,-44.0,-46.0,-51.0,-49.0,-44.0,-48.0,-90.0,-92.0,-89.0,-92.0,38.0,42.0,45.0,46.0,0
3414,CC:2F:71:3F:1F:24,4433110,1174245316,612415,692360985,3820695,481884331,37,506482,560094478,505894,560023618,588,70860,488811,10,612652,53742,34,432,130000.0,43333.0,-67.0,-65.0,-70.0,-67.0,-67.0,-65.0,-70.0,-67.0,-90.0,-92.0,-89.0,-92.0,23.0,27.0,19.0,25.0,0
3415,CC:2F:71:3E:C5:1F,3821410,481971682,715,87351,3820695,481884331,0,3031,254065,2506,191671,525,62394,757,8,1046,18,0,32,130000.0,39000.0,-70.0,-71.0,-67.0,-60.0,-70.0,-71.0,-67.0,-60.0,-90.0,-92.0,-89.0,-92.0,20.0,21.0,22.0,32.0,0
3416,BA:8C:B9:54:50:24,3825244,488006871,4549,6122540,3820695,481884331,0,7846,1606112,7825,1602755,21,3357,2291,14,4924,35,0,50,216660.0,130000.0,-39.0,-37.0,-45.0,-51.0,-41.0,-35.0,-43.0,-48.0,-90.0,-92.0,-89.0,-92.0,51.0,55.0,44.0,41.0,0
3417,92:69:1D:31:68:E9,3824302,485389122,3605,3504589,3820697,481884533,0,3871,983120,3766,959680,105,23440,1911,6,3731,79,0,31,216660.0,130000.0,-52.0,-50.0,-44.0,-46.0,-51.0,-49.0,-44.0,-48.0,-90.0,-93.0,-90.0,-93.0,38.0,43.0,46.0,47.0,0
3418,CC:2F:71:3F:1F:24,4433153,1174259934,612456,692375401,3820697,481884533,37,506508,560099398,505920,560028538,588,70860,488837,10,612693,53746,34,432,130000.0,43333.0,-67.0,-65.0,-70.0,-67.0,-67.0,-65.0,-70.0,-67.0,-90.0,-93.0,-90.0,-93.0,23.0,28.0,20.0,26.0,0
3419,CC:2F:71:3E:C5:1F,3821414,481972086,715,87351,3820699,481884735,0,3031,254065,2506,191671,525,62394,757,8,1046,18,0,32,130000.0,39000.0,-70.0,-71.0,-67.0,-60.0,-70.0,-71.0,-67.0,-60.0,-90.0,-93.0,-90.0,-93.0,20.0,22.0,23.0,33.0,0
3420,BA:8C:B9:54:50:24,3825248,488007275,4549,6122540,3820699,481884735,0,7846,1606112,7825,1602755,21,3357,2291,14,4924,35,0,50,216660.0,130000.0,-39.0,-37.0,-45.0,-51.0,-41.0,-35.0,-43.0,-48.0,-90.0,-93.0,-90.0,-93.0,51.0,56.0,45.0,42.0,0
3421,92:69:1D:31:68:E9,3824309,485389788,3605,3504589,3820704,481885199,0,3871,983120,3766,959680,105,23440,1911,6,3731,79,0,31,216660.0,130000.0,-52.0,-50.0,-44.0,-46.0,-51.0,-49.0,-44.0,-48.0,-90.0,-93.0,-90.0,-93.0,38.0,43.0,46.0,47.0,0
3422,CC:2F:71:3F:1F:24,4433202,1174275028,612498,692389829,3820704,481885199,37,506534,560104342,505946,560033482,588,70860,488863,10,612735,53764,34,432,117000.0,39000.0,-67.0,-65.0,-70.0,-67.0,-67.0,-65.0,-70.0,-67.0,-90.0,-93.0,-90.0,-93.0,23.0,28.0,20.0,26.0,0
3423,CC:2F:71:3E:C5:1F,3821419,481972550,715,87351,3820704,481885199,0,3031,254065,2506,191671,525,62394,757,8,1046,18,0,32,130000.0,39000.0,-70.0,-71.0,-67.0,-60.0,-70.0,-71.0,-67.0,-60.0,-90.0,-93.0,-90.0,-93.0,20.0,22.0,23.0,33.0,0
3424,BA:8C:B9:54:50:24,3825253,488007739,4549,6122540,3820704,481885199,0,7846,1606112,7825,1602755,21,3357,2291,14,4924,35,0,50,216660.0,130000.0,-39.0,-37.0,-45.0,-51.0,-41.0,-35.0,-43.0,-48.0,-90.0,-93.0,-90.0,-93.0,51.0,56.0,45.0,42.0,0
3425,92:69:1D:31:68:E9,3824311,485389990,3605,3504589,3820706,481885401,0,3871,983120,3766,959680,105,23440,1911,6,3731,79,0,31,216660.0,130000.0,-52.0,-50.0,-44.0,-46.0,-51.0,-49.0,-44.0,-48.0,-90.0,-93.0,-90.0,-93.0,38.0,43.0,46.0,47.0,0
3426,CC:2F:71:3F:1F:24,4433247,1174289782,612541,692404381,3820706,481885401,37,506561,560109402,505973,560038542,588,70860,488890,10,612778,53767,34,432,130000.0,43333.0,-67.0,-65.0,-70.0,-67.0,-67.0,-65.0,-70.0,-67.0,-90.0,-93.0,-90.0,-93.0,23.0,28.0,20.0,26.0,0
3427,CC:2F:71:3E:C5:1F,3821423,481972954,715,87351,3820708,481885603,0,3031,254065,2506,191671,525,62394,757,8,1046,18,0,32,130000.0,39000.0,-70.0,-71.0,-67.0,-60.0,-70.0,-71.0,-67.0,-60.0,-90.0,-93.0,-90.0,-93.0,20.0,22.0,23.0,33.0,0
3428,BA:8C:B9:54:50:24,3825257,488008143,4549,6122540,3820708,481885603,0,7846,1606112,7825,1602755,21,3357,2291,14,4924,35,0,50,216660.0,130000.0,-39.0,-37.0,-45.0,-51.0,-41.0,-35.0,-43.0,-48.0,-90.0,-93.0,-90.0,-93.0,51.0,56.0,45.0,42.0,0
3429,92:69:1D:31:68:E9,3824319,485391720,3605,3504589,3820714,481887131,0,3871,983120,3766,959680,105,23440,1911,6,3731,79,0,31,216660.0,130000.0,-52.0,-50.0,-44.0,-46.0,-51.0,-49.0,-44.0,-48.0,-90.0,-93.0,-90.0,-93.0,38.0,43.0,46.0,47.0,0
3430,CC:2F:71:3F:1F:24,4433299,1174306300,612585,692419169,3820714,481887131,37,506587,560114346,505999,560043486,588,70860,488916,10,612822,53770,34,432,130000.0,43333.0,-67.0,-65.0,-71.0,-67.0,-67.0,-65.0,-70.0,-67.0,-90.0,-93.0,-90.0,-93.0,23.0,28.0,19.0,26.0,0
3431,CC:2F:71:3E:C5:1F,3821429,481974482,715,87351,3820714,481887131,0,3031,254065,2506,191671,525,62394,757,8,1046,18,0,32,130000.0,39000.0,-70.0,-71.0,-67.0,-60.0,-70.0,-71.0,-67.0,-60.0,-90.0,-93.0,-90.0,-93.0,20.0,22.0,23.0,33.0,0
3432,BA:8C:B9:54:50:24,3825263,488009671,4549,6122540,3820714,481887131,0,7846,1606112,7825,1602755,21,3357,2291,14,4924,35,0,50,216660.0,130000.0,-39.0,-37.0,-45.0,-51.0,-41.0,-35.0,-43.0,-48.0,-90.0,-93.0,-90.0,-93.0,51.0,56.0,45.0,42.0,0
3433,92:69:1D:31:68:E9,3824322,485391982,3605,3504589,3820717,481887393,0,3871,983120,3766,959680,105,23440,1911,6,3731,79,0,31,216660.0,130000.0,-52.0,-50.0,-44.0,-46.0,-51.0,-49.0,-44.0,-48.0,-90.0,-93.0,-90.0,-93.0,38.0,43.0,46.0,47.0,0
3434,CC:2F:71:3F:1F:24,4433344,1174320990,612627,692433597,3820717,481887393,37,506613,560119290,506025,560048430,588,70860,488942,10,612864,53790,34,432,117000.0,39000.0,-67.0,-65.0,-70.0,-67.0,-67.0,-65.0,-70.0,-67.0,-90.0,-93.0,-90.0,-93.0,23.0,28.0,20.0,26.0,0
3435,CC:2F:71:3E:C5:1F,3821434,481974946,715,87351,3820719,481887595,0,3031,254065,2506,191671,525,62394,757,8,1046,18,0,32,130000.0,39000.0,-70.0,-71.0,-67.0,-60.0,-70.0,-71.0,-67.0,-60.0,-90.0,-93.0,-90.0,-93.0,20.0,22.0,23.0,33.0,0
3436,BA:8C:B9:54:50:24,3825268,488010135,4549,6122540,3820719,481887595,0,7846,1606112,7825,1602755,21,3357,2291,14,4924,35,0,50,216660.0,130000.0,-39.0,-37.0,-45.0,-51.0,-41.0,-35.0,-43.0,-48.0,-90.0,-93.0,-90.0,-93.0,51.0,56.0,45.0,42.0,0
3437,92:69:1D:31:68:E9,3824332,485394101,3606,3504705,3820726,481889396,0,3873,983256,3768,959816,105,23440,1911,6,3732,79,0,31,216660.0,130000.0,-51.0,-47.0,-42.0,-49.0,-51.0,-49.0,-43.0,-48.0,-90.0,-93.0,-90.0,-93.0,39.0,46.0,48.0,44.0,0
3438,CC:2F:71:3F:1F:24,4433397,1174337667,612671,692448271,3820726,481889396,37,506639,560124234,506051,560053374,588,70860,488968,10,612908,53791,34,432,130000.0,43333.0,-67.0,-65.0,-71.0,-67.0,-67.0,-65.0,-70.0,-67.0,-90.0,-93.0,-90.0,-93.0,23.0,28.0,19.0,26.0,0
3439,CC:2F:71:3E:C5:1F,3821442,481976863,716,87467,3820726,481889396,0,3033,254205,2508,191811,525,62394,757,8,1047,18,0,32,130000.0,39000.0,-70.0,-71.0,-67.0,-60.0,-70.0,-71.0,-67.0,-60.0,-90.0,-93.0,-90.0,-93.0,20.0,22.0,23.0,33.0,0
3440,BA:8C:B9:54:50:24,3825276,488012052,4550,6122656,3820726,481889396,0,7848,1606248,7827,1602891,21,3357,2291,14,4925,35,0,50,216660.0,130000.0,-39.0,-37.0,-45.0,-52.0,-41.0,-36.0,-44.0,-49.0,-90.0,-93.0,-90.0,-93.0,51.0,56.0,45.0,41.0,0
3441,92:69:1D:31:68:E9,3824334,485394303,3606,3504705,3820728,481889598,0,3873,983256,3768,959816,105,23440,1911,6,3732,79,0,31,216660.0,130000.0,-51.0,-47.0,-42.0,-49.0,-51.0,-49.0,-43.0,-48.0,-90.0,-93.0,-90.0,-93.0,39.0,46.0,48.0,44.0,0
3442,CC:2F:71:3F:1F:24,4433441,1174352353,612713,692462755,3820728,481889598,37,506664,560129038,506076,560058178,588,70860,488993,10,612950,53805,34,432,130000.0,39000.0,-67.0,-65.0,-70.0,-67.0,-67.0,-65.0,-70.0,-67.0,-90.0,-93.0,-90.0,-93.0,23.0,28.0,20.0,26.0,0
3443,CC:2F:71:3E:C5:1F,3821447,481977327,716,87467,3820731,481889860,0,3033,254205,2508,191811,525,62394,757,8,1047,18,0,32,130000.0,39000.0,-70.0,-71.0,-67.0,-60.0,-70.0,-71.0,-67.0,-60.0,-90.0,-93.0,-90.0,-93.0,20.0,22.0,23.0,33.0,0
3444,BA:8C:B9:54:50:24,3825281,488012516,4550,6122656,3820731,481889860,0,7848,1606248,7827,1602891,21,3357,2291,14,4925,35,0,50,216660.0,130000.0,-39.0,-37.0,-45.0,-52.0,-41.0,-36.0,-44.0,-49.0,-90.0,-93.0,-90.0,-93.0,51.0,56.0,45.0,41.0,0
3445,92:69:1D:31:68:E9,3824344,485396155,3606,3504705,3820738,481891450,0,3873,983256,3768,959816,105,23440,1911,6,3732,79,0,31,216660.0,130000.0,-51.0,-47.0,-42.0,-49.0,-51.0,-49.0,-43.0,-48.0,-90.0,-93.0,-90.0,-93.0,39.0,46.0,48.0,44.0,0
3446,CC:2F:71:3F:1F:24,4433495,1174368949,612757,692477499,3820738,481891450,37,506691,560134136,506102,560063158,589,70978,489020,10,612994,53834,34,432,130000.0,39000.0,-67.0,-65.0,-70.0,-67.0,-67.0,-65.0,-70.0,-67.0,-90.0,-93.0,-90.0,-93.0,23.0,28.0,20.0,26.0,0
3447,CC:2F:71:3E:C5:1F,3821454,481978917,716,87467,3820738,481891450,0,3033,254205,2508,191811,525,62394,757,8,1047,18,0,32,130000.0,39000.0,-70.0,-71.0,-67.0,-60.0,-70.0,-71.0,-67.0,-60.0,-90.0,-93.0,-90.0,-93.0,20.0,22.0,23.0,33.0,0
3448,BA:8C:B9:54:50:24,3825288,488014106,4550,6122656,3820738,481891450,0,7849,1606316,7828,1602959,21,3357,2291,14,4925,35,0,50,216660.0,130000.0,-39.0,-36.0,-44.0,-52.0,-41.0,-36.0,-44.0,-49.0,-90.0,-93.0,-90.0,-93.0,51.0,57.0,46.0,41.0,0
3449,92:69:1D:31:68:E9,3824346,485396357,3606,3504705,3820740,481891652,0,3873,983256,3768,959816,105,23440,1911,6,3732,79,0,31,216660.0,130000.0,-51.0,-47.0,-42.0,-49.0,-51.0,-49.0,-43.0,-48.0,-90.0,-93.0,-90.0,-93.0,39.0,46.0,48.0,44.0,0
3450,CC:2F:71:3F:1F:24,4433539,1174383533,612797,692491679,3820742,481891854,37,506716,560138940,506127,560067962,589,70978,489045,10,613034,53845,34,432,130000.0,43333.0,-67.0,-65.0,-70.0,-67.0,-67.0,-65.0,-70.0,-67.0,-90.0,-93.0,-90.0,-93.0,23.0,28.0,20.0,26.0,0
3451,CC:2F:71:3E:C5:1F,3821458,481979321,716,87467,3820742,481891854,0,3033,254205,2508,191811,525,62394,757,8,1047,18,0,32,130000.0,39000.0,-70.0,-71.0,-67.0,-60.0,-70.0,-71.0,-67.0,-60.0,-90.0,-93.0,-90.0,-93.0,20.0,22.0,23.0,33.0,0
3452,BA:8C:B9:54:50:24,3825292,488014510,4550,6122656,3820742,481891854,0,7849,1606316,7828,1602959,21,3357,2291,14,4925,35,0,50,216660.0,130000.0,-39.0,-36.0,-44.0,-52.0,-41.0,-36.0,-44.0,-49.0,-90.0,-93.0,-90.0,-93.0,51.0,57.0,46.0,41.0,0
3453,92:69:1D:31:68:E9,3824353,485397023,3606,3504705,3820747,481892318,0,3873,983256,3768,959816,105,23440,1911,6,3732,79,0,31,216660.0,130000.0,-51.0,-47.0,-42.0,-49.0,-51.0,-49.0,-43.0,-48.0,-90.0,-93.0,-90.0,-93.0,39.0,46.0,48.0,44.0,0
3454,CC:2F:71:3F:1F:24,4433587,1174398549,612840,692506231,3820747,481892318,37,506743,560144000,506154,560073022,589,70978,489072,10,613077,53865,34,432,117000.0,39000.0,-67.0,-65.0,-70.0,-68.0,-67.0,-65.0,-70.0,-67.0,-90.0,-93.0,-90.0,-93.0,23.0,28.0,20.0,25.0,0
3455,CC:2F:71:3E:C5:1F,3821463,481979785,716,87467,3820747,481892318,0,3033,254205,2508,191811,525,62394,757,8,1047,18,0,32,130000.0,39000.0,-70.0,-71.0,-67.0,-60.0,-70.0,-71.0,-67.0,-60.0,-90.0,-93.0,-90.0,-93.0,20.0,22.0,23.0,33.0,0
3456,BA:8C:B9:54:50:24,3825297,488014974,4550,6122656,3820747,481892318,0,7849,1606316,7828,1602959,21,3357,2291,14,4925,35,0,50,216660.0,130000.0,-39.0,-36.0,-44.0,-52.0,-41.0,-36.0,-44.0,-49.0,-90.0,-93.0,-90.0,-93.0,51.0,57.0,46.0,41.0,0
3457,92:69:1D:31:68:E9,3824355,485397225,3606,3504705,3820749,481892520,0,3873,983256,3768,959816,105,23440,1911,6,3732,79,0,31,216660.0,130000.0,-51.0,-47.0,-42.0,-49.0,-51.0,-49.0,-43.0,-48.0,-90.0,-93.0,-90.0,-93.0,39.0,46.0,48.0,44.0,0
3458,CC:2F:71:3F:1F:24,4433634,1174413505,612883,692520783,3820751,481892722,37,506771,560149200,506182,560078222,589,70978,489100,10,613120,53868,34,432,130000.0,43333.0,-67.0,-65.0,-71.0,-67.0,-67.0,-65.0,-70.0,-67.0,-90.0,-93.0,-90.0,-93.0,23.0,28.0,19.0,26.0,0
3459,CC:2F:71:3E:C5:1F,3821467,481980189,716,87467,3820751,481892722,0,3033,254205,2508,191811,525,62394,757,8,1047,18,0,32,130000.0,39000.0,-70.0,-71.0,-67.0,-60.0,-70.0,-71.0,-67.0,-60.0,-90.0,-93.0,-90.0,-93.0,20.0,22.0,23.0,33.0,0
3460,BA:8C:B9:54:50:24,3825301,488015378,4550,6122656,3820751,481892722,0,7849,1606316,7828,1602959,21,3357,2291,14,4925,35,0,50,216660.0,130000.0,-39.0,-36.0,-44.0,-52.0,-41.0,-36.0,-44.0,-49.0,-90.0,-93.0,-90.0,-93.0,51.0,57.0,46.0,41.0,0
3461,92:69:1D:31:68:E9,3824361,485397831,3606,3504705,3820755,481893126,0,3873,983256,3768,959816,105,23440,1911,6,3732,79,0,31,216660.0,130000.0,-51.0,-47.0,-42.0,-49.0,-51.0,-49.0,-43.0,-48.0,-90.0,-93.0,-90.0,-93.0,39.0,46.0,48.0,44.0,0
3462,CC:2F:71:3F:1F:24,4433680,1174428449,612925,692535323,3820755,481893126,37,506797,560154144,506208,560083166,589,70978,489126,10,613162,53873,34,432,130000.0,43333.0,-67.0,-65.0,-70.0,-67.0,-67.0,-65.0,-70.0,-67.0,-90.0,-93.0,-90.0,-93.0,23.0,28.0,20.0,26.0,0
3463,CC:2F:71:3E:C5:1F,3821471,481980593,716,87467,3820755,481893126,0,3033,254205,2508,191811,525,62394,757,8,1047,18,0,32,130000.0,39000.0,-70.0,-71.0,-67.0,-60.0,-70.0,-71.0,-67.0,-60.0,-90.0,-93.0,-90.0,-93.0,20.0,22.0,23.0,33.0,0
3464,BA:8C:B9:54:50:24,3825305,488015782,4550,6122656,3820755,481893126,0,7849,1606316,7828,1602959,21,3357,2291,14,4925,35,0,50,216660.0,130000.0,-39.0,-36.0,-44.0,-52.0,-41.0,-36.0,-44.0,-49.0,-90.0,-93.0,-90.0,-93.0,51.0,57.0,46.0,41.0,0
3465,92:69:1D:31:68:E9,3824363,485397953,3606,3504705,3820757,481893248,0,3873,983256,3768,959816,105,23440,1911,6,3732,79,0,31,216660.0,130000.0,-51.0,-47.0,-42.0,-49.0,-51.0,-49.0,-43.0,-48.0,-90.0,-93.0,-90.0,-93.0,39.0,46.0,48.0,44.0,0
3466,CC:2F:71:3F:1F:24,4433727,1174443279,612966,692549627,3820761,481893652,37,506822,560158948,506233,560087970,589,70978,489151,10,613203,53884,34,432,117000.0,39000.0,-67.0,-65.0,-70.0,-67.0,-67.0,-65.0,-70.0,-67.0,-90.0,-93.0,-90.0,-93.0,23.0,28.0,20.0,26.0,0
3467,CC:2F:71:3E:C5:1F,3821477,481981119,716,87467,3820761,481893652,0,3035,254393,2509,191881,526,62512,758,8,1047,18,0,32,130000.0,39000.0,-70.0,-71.0,-68.0,-60.0,-70.0,-71.0,-67.0,-60.0,-90.0,-93.0,-90.0,-93.0,20.0,22.0,22.0,33.0,0
3468,BA:8C:B9:54:50:24,3825311,488016308,4550,6122656,3820761,481893652,0,7849,1606316,7828,1602959,21,3357,2291,14,4925,35,0,50,216660.0,130000.0,-39.0,-36.0,-44.0,-52.0,-41.0,-36.0,-44.0,-49.0,-90.0,-93.0,-90.0,-93.0,51.0,57.0,46.0,41.0,0
3469,92:69:1D:31:68:E9,3824371,485398761,3606,3504705,3820765,481894056,0,3873,983256,3768,959816,105,23440,1911,6,3732,79,0,31,216660.0,130000.0,-51.0,-47.0,-42.0,-49.0,-51.0,-49.0,-43.0,-48.0,-90.0,-93.0,-90.0,-93.0,39.0,46.0,48.0,44.0,0
3470,CC:2F:71:3F:1F:24,4433774,1174458235,613009,692564179,3820765,481894056,37,506849,560164008,506260,560093030,589,70978,489178,10,613246,53887,34,432,130000.0,43333.0,-67.0,-65.0,-70.0,-67.0,-67.0,-65.0,-70.0,-67.0,-90.0,-93.0,-90.0,-93.0,23.0,28.0,20.0,26.0,0
3471,CC:2F:71:3E:C5:1F,3821481,481981523,716,87467,3820765,481894056,0,3035,254393,2509,191881,526,62512,758,8,1047,18,0,32,130000.0,39000.0,-70.0,-71.0,-68.0,-60.0,-70.0,-71.0,-67.0,-60.0,-90.0,-93.0,-90.0,-93.0,20.0,22.0,22.0,33.0,0
3472,BA:8C:B9:54:50:24,3825315,488016712,4550,6122656,3820765,481894056,0,7849,1606316,7828,1602959,21,3357,2291,14,4925,35,0,50,216660.0,130000.0,-39.0,-36.0,-44.0,-52.0,-41.0,-36.0,-44.0,-49.0,-90.0,-93.0,-90.0,-93.0,51.0,57.0,46.0,41.0,0
3473,92:69:1D:31:68:E9,3826013,485601302,3624,3506733,3822389,482094569,0,3932,988276,3823,963896,109,24380,1921,6,3750,79,0,32,216660.0,130000.0,-52.0,-49.0,-44.0,-46.0,-51.0,-48.0,-43.0,-47.0,-91.0,-93.0,-90.0,-93.0,39.0,44.0,46.0,47.0,0
3474,CC:2F:71:3F:1F:24,4435673,1174714121,613284,692619552,3822389,482094569,37,507756,561209089,507146,561135633,610,73456,490075,10,613521,54085,34,445,130000.0,43333.0,-65.0,-63.0,-69.0,-65.0,-65.0,-63.0,-69.0,-65.0,-91.0,-93.0,-90.0,-93.0,26.0,30.0,21.0,28.0,0
3475,CC:2F:71:3E:C5:1F,3823122,482184149,733,89580,3822389,482094569,0,3091,259320,2553,195392,538,63928,776,8,1064,18,0,34,130000.0,39000.0,-70.0,-71.0,-67.0,-60.0,-71.0,-72.0,-68.0,-61.0,-91.0,-93.0,-90.0,-93.0,21.0,22.0,23.0,33.0,0
3476,BA:8C:B9:54:50:24,3827074,488236991,4685,6142422,3822389,482094569,0,8171,1629046,8150,1625689,21,3357,2303,14,5060,36,0,53,216660.0,130000.0,-39.0,-36.0,-44.0,-52.0,-40.0,-36.0,-44.0,-51.0,-91.0,-93.0,-90.0,-93.0,52.0,57.0,46.0,41.0,0
3477,92:69:1D:31:68:E9,3826014,485601418,3625,3506849,3822389,482094569,0,3934,988412,3825,964032,109,24380,1921,6,3751,79,0,32,216660.0,130000.0,-52.0,-50.0,-44.0,-46.0,-52.0,-49.0,-44.0,-47.0,-91.0,-93.0,-90.0,-93.0,39.0,43.0,46.0,47.0,0
3478,CC:2F:71:3F:1F:24,4435716,1174728619,613325,692633848,3822391,482094771,37,507782,561214009,507172,561140553,610,73456,490101,10,613562,54119,34,445,144444.0,39000.0,-76.0,-80.0,-78.0,-80.0,-74.0,-77.0,-76.0,-78.0,-91.0,-93.0,-90.0,-93.0,15.0,13.0,12.0,13.0,0
3479,CC:2F:71:3E:C5:1F,3823125,482184411,734,89640,3822391,482094771,0,3093,259460,2555,195532,538,63928,776,8,1065,18,0,34,130000.0,39000.0,-70.0,-71.0,-67.0,-60.0,-71.0,-72.0,-68.0,-61.0,-91.0,-93.0,-90.0,-93.0,21.0,22.0,23.0,33.0,0
3480,BA:8C:B9:54:50:24,3827077,488237309,4686,6142538,3822391,482094771,0,8173,1629182,8152,1625825,21,3357,2303,14,5061,36,0,53,216660.0,130000.0,-49.0,-35.0,-42.0,-45.0,-41.0,-36.0,-43.0,-50.0,-91.0,-93.0,-90.0,-93.0,42.0,58.0,48.0,48.0,0
3481,92:69:1D:31:68:E9,3826023,485602499,3625,3506849,3822398,482095650,0,3934,988412,3825,964032,109,24380,1921,6,3751,79,0,32,216660.0,130000.0,-52.0,-50.0,-44.0,-46.0,-52.0,-49.0,-44.0,-47.0,-91.0,-93.0,-90.0,-93.0,39.0,43.0,46.0,47.0,0
3482,CC:2F:71:3F:1F:24,4435765,1174743758,613367,692648108,3822398,482095650,37,507808,561218989,507198,561145533,610,73456,490127,10,613604,54145,34,445,117000.0,39000.0,-67.0,-65.0,-70.0,-68.0,-67.0,-65.0,-69.0,-67.0,-91.0,-93.0,-90.0,-93.0,24.0,28.0,20.0,25.0,0
3483,CC:2F:71:3E:C5:1F,3823132,482185290,734,89640,3822398,482095650,0,3093,259460,2555,195532,538,63928,776,8,1065,18,0,34,130000.0,39000.0,-70.0,-71.0,-67.0,-60.0,-71.0,-72.0,-68.0,-61.0,-91.0,-93.0,-90.0,-93.0,21.0,22.0,23.0,33.0,0
3484,BA:8C:B9:54:50:24,3827084,488238188,4686,6142538,3822398,482095650,0,8173,1629182,8152,1625825,21,3357,2303,14,5061,36,0,53,216660.0,130000.0,-49.0,-35.0,-42.0,-45.0,-41.0,-36.0,-43.0,-50.0,-91.0,-93.0,-90.0,-93.0,42.0,58.0,48.0,48.0,0
3485,92:69:1D:31:68:E9,3826024,485602559,3625,3506849,3822399,482095710,0,3934,988412,3825,964032,109,24380,1921,6,3751,79,0,32,216660.0,130000.0,-52.0,-50.0,-44.0,-46.0,-52.0,-49.0,-44.0,-47.0,-91.0,-93.0,-90.0,-93.0,39.0,43.0,46.0,47.0,0
3486,CC:2F:71:3F:1F:24,4435810,1174758392,613409,692662480,3822401,482095912,37,507833,561223793,507223,561150337,610,73456,490152,10,613646,54150,34,445,117000.0,39000.0,-67.0,-65.0,-71.0,-68.0,-67.0,-65.0,-70.0,-68.0,-91.0,-93.0,-90.0,-93.0,24.0,28.0,19.0,25.0,0
3487,CC:2F:71:3E:C5:1F,3823135,482185552,734,89640,3822401,482095912,0,3093,259460,2555,195532,538,63928,776,8,1065,18,0,34,130000.0,39000.0,-70.0,-71.0,-67.0,-60.0,-71.0,-72.0,-68.0,-61.0,-91.0,-93.0,-90.0,-93.0,21.0,22.0,23.0,33.0,0
3488,BA:8C:B9:54:50:24,3827087,488238450,4686,6142538,3822401,482095912,0,8173,1629182,8152,1625825,21,3357,2303,14,5061,36,0,53,216660.0,130000.0,-49.0,-35.0,-42.0,-45.0,-41.0,-36.0,-43.0,-50.0,-91.0,-93.0,-90.0,-93.0,42.0,58.0,48.0,48.0,0
3489,92:69:1D:31:68:E9,3826032,485603367,3625,3506849,3822407,482096518,0,3934,988412,3825,964032,109,24380,1921,6,3751,79,0,32,216660.0,130000.0,-52.0,-50.0,-44.0,-46.0,-52.0,-49.0,-44.0,-47.0,-91.0,-93.0,-90.0,-93.0,39.0,43.0,46.0,47.0,0
3490,CC:2F:71:3F:1F:24,4435859,1174773500,613452,692676982,3822407,482096518,37,507860,561228853,507250,561155397,610,73456,490179,10,613689,54161,34,445,130000.0,39000.0,-67.0,-65.0,-70.0,-68.0,-67.0,-65.0,-70.0,-67.0,-91.0,-93.0,-90.0,-93.0,24.0,28.0,20.0,25.0,0
3491,CC:2F:71:3E:C5:1F,3823141,482186158,734,89640,3822407,482096518,0,3093,259460,2555,195532,538,63928,776,8,1065,18,0,34,130000.0,39000.0,-70.0,-71.0,-67.0,-60.0,-71.0,-72.0,-68.0,-61.0,-91.0,-93.0,-90.0,-93.0,21.0,22.0,23.0,33.0,0
3492,BA:8C:B9:54:50:24,3827093,488239056,4686,6142538,3822407,482096518,0,8173,1629182,8152,1625825,21,3357,2303,14,5061,36,0,53,216660.0,130000.0,-49.0,-35.0,-42.0,-45.0,-41.0,-36.0,-43.0,-50.0,-91.0,-93.0,-90.0,-93.0,42.0,58.0,48.0,48.0,0
3493,92:69:1D:31:68:E9,3826036,485603937,3625,3506849,3822411,482097088,0,3934,988412,3825,964032,109,24380,1921,6,3751,79,0,32,216660.0,130000.0,-52.0,-50.0,-44.0,-46.0,-52.0,-49.0,-44.0,-47.0,-91.0,-93.0,-90.0,-93.0,39.0,43.0,46.0,47.0,0
3494,CC:2F:71:3F:1F:24,4435905,1174788434,613493,692691286,3822412,482097148,37,507887,561233913,507277,561160457,610,73456,490206,10,613730,54179,34,445,130000.0,39000.0,-67.0,-65.0,-70.0,-67.0,-67.0,-65.0,-70.0,-67.0,-91.0,-93.0,-90.0,-93.0,24.0,28.0,20.0,26.0,0
3495,CC:2F:71:3E:C5:1F,3823146,482186788,734,89640,3822412,482097148,0,3093,259460,2555,195532,538,63928,776,8,1065,18,0,34,130000.0,39000.0,-70.0,-71.0,-67.0,-60.0,-71.0,-72.0,-68.0,-61.0,-91.0,-93.0,-90.0,-93.0,21.0,22.0,23.0,33.0,0
3496,BA:8C:B9:54:50:24,3827098,488239686,4686,6142538,3822412,482097148,0,8173,1629182,8152,1625825,21,3357,2303,14,5061,36,0,53,216660.0,130000.0,-49.0,-35.0,-42.0,-45.0,-41.0,-36.0,-43.0,-50.0,-91.0,-93.0,-90.0,-93.0,42.0,58.0,48.0,48.0,0
3497,92:69:1D:31:68:E9,3826043,485604603,3625,3506849,3822418,482097754,0,3934,988412,3825,964032,109,24380,1921,6,3751,79,0,32,216660.0,130000.0,-52.0,-50.0,-44.0,-46.0,-52.0,-49.0,-44.0,-47.0,-91.0,-93.0,-90.0,-93.0,39.0,43.0,46.0,47.0,0
3498,CC:2F:71:3F:1F:24,4435953,1174803412,613535,692705658,3822418,482097754,37,507912,561238717,507302,561165261,610,73456,490231,10,613772,54198,34,445,117000.0,39000.0,-67.0,-65.0,-71.0,-68.0,-67.0,-65.0,-70.0,-67.0,-91.0,-93.0,-90.0,-93.0,24.0,28.0,19.0,25.0,0
3499,CC:2F:71:3E:C5:1F,3823152,482187394,734,89640,3822418,482097754,0,3093,259460,2555,195532,538,63928,776,8,1065,18,0,34,130000.0,39000.0,-70.0,-71.0,-67.0,-60.0,-71.0,-72.0,-68.0,-61.0,-91.0,-93.0,-90.0,-93.0,21.0,22.0,23.0,33.0,0
3500,BA:8C:B9:54:50:24,3827104,488240292,4686,6142538,3822418,482097754,0,8173,1629182,8152,1625825,21,3357,2303,14,5061,36,0,53,216660.0,130000.0,-49.0,-35.0,-42.0,-45.0,-41.0,-36.0,-43.0,-50.0,-91.0,-93.0,-90.0,-93.0,42.0,58.0,48.0,48.0,0
3501,92:69:1D:31:68:E9,3826045,485604805,3625,3506849,3822420,482097956,0,3937,988616,3828,964236,109,24380,1921,6,3751,79,0,32,216660.0,130000.0,-52.0,-50.0,-45.0,-46.0,-51.0,-49.0,-43.0,-46.0,-91.0,-93.0,-90.0,-93.0,39.0,43.0,45.0,47.0,0
3502,CC:2F:71:3F:1F:24,4435998,1174818166,613578,692720210,3822420,482097956,37,507938,561243661,507328,561170205,610,73456,490257,10,613815,54201,34,445,130000.0,43333.0,-67.0,-65.0,-70.0,-68.0,-67.0,-65.0,-70.0,-67.0,-91.0,-93.0,-90.0,-93.0,24.0,28.0,20.0,25.0,0
3503,CC:2F:71:3E:C5:1F,3823154,482187596,734,89640,3822420,482097956,0,3093,259460,2555,195532,538,63928,776,8,1065,18,0,34,130000.0,39000.0,-70.0,-71.0,-67.0,-60.0,-71.0,-72.0,-68.0,-61.0,-91.0,-93.0,-90.0,-93.0,21.0,22.0,23.0,33.0,0
3504,BA:8C:B9:54:50:24,3827106,488240494,4686,6142538,3822420,482097956,0,8173,1629182,8152,1625825,21,3357,2303,14,5061,36,0,53,216660.0,130000.0,-49.0,-35.0,-42.0,-45.0,-41.0,-36.0,-43.0,-50.0,-91.0,-93.0,-90.0,-93.0,42.0,58.0,48.0,48.0,0
3505,92:69:1D:31:68:E9,3826050,485605269,3625,3506849,3822425,482098420,0,3937,988616,3828,964236,109,24380,1921,6,3751,79,0,32,216660.0,130000.0,-52.0,-50.0,-45.0,-46.0,-51.0,-49.0,-43.0,-46.0,-91.0,-93.0,-90.0,-93.0,39.0,43.0,45.0,47.0,0
3506,CC:2F:71:3F:1F:24,4436044,1174832984,613619,692734564,3822425,482098420,37,507965,561248745,507355,561175289,610,73456,490284,10,613856,54227,34,445,130000.0,39000.0,-67.0,-65.0,-71.0,-68.0,-67.0,-65.0,-70.0,-67.0,-91.0,-93.0,-90.0,-93.0,24.0,28.0,19.0,25.0,0
3507,CC:2F:71:3E:C5:1F,3823161,482188262,734,89640,3822427,482098622,0,3093,259460,2555,195532,538,63928,776,8,1065,18,0,34,130000.0,39000.0,-70.0,-71.0,-67.0,-60.0,-71.0,-72.0,-68.0,-61.0,-91.0,-93.0,-90.0,-93.0,21.0,22.0,23.0,33.0,0
3508,BA:8C:B9:54:50:24,3827114,488241222,4686,6142538,3822428,482098684,0,8173,1629182,8152,1625825,21,3357,2303,14,5061,36,0,53,216660.0,130000.0,-49.0,-35.0,-42.0,-45.0,-41.0,-36.0,-43.0,-50.0,-91.0,-93.0,-90.0,-93.0,42.0,58.0,48.0,48.0,0
3509,92:69:1D:31:68:E9,3826055,485605735,3625,3506849,3822430,482098886,0,3937,988616,3828,964236,109,24380,1921,6,3751,79,0,32,216660.0,130000.0,-52.0,-50.0,-45.0,-46.0,-51.0,-49.0,-43.0,-46.0,-91.0,-93.0,-90.0,-93.0,39.0,43.0,45.0,47.0,0
3510,CC:2F:71:3F:1F:24,4436089,1174847624,613659,692748738,3822430,482098886,37,507990,561253549,507380,561180093,610,73456,490309,10,613896,54231,34,445,130000.0,43333.0,-67.0,-65.0,-70.0,-68.0,-67.0,-65.0,-70.0,-67.0,-91.0,-93.0,-90.0,-93.0,24.0,28.0,20.0,25.0,0
3511,CC:2F:71:3E:C5:1F,3823164,482188526,734,89640,3822430,482098886,0,3095,259648,2556,195602,539,64046,777,8,1065,18,0,34,130000.0,39000.0,-70.0,-71.0,-67.0,-60.0,-71.0,-72.0,-68.0,-61.0,-91.0,-93.0,-90.0,-93.0,21.0,22.0,23.0,33.0,0
3512,BA:8C:B9:54:50:24,3827116,488241424,4686,6142538,3822430,482098886,0,8173,1629182,8152,1625825,21,3357,2303,14,5061,36,0,53,216660.0,130000.0,-49.0,-35.0,-42.0,-45.0,-41.0,-36.0,-43.0,-50.0,-91.0,-93.0,-90.0,-93.0,42.0,58.0,48.0,48.0,0
3513,92:69:1D:31:68:E9,3826059,485606139,3625,3506849,3822434,482099290,0,3937,988616,3828,964236,109,24380,1921,6,3751,79,0,32,216660.0,130000.0,-52.0,-50.0,-45.0,-46.0,-51.0,-49.0,-43.0,-46.0,-91.0,-93.0,-90.0,-93.0,39.0,43.0,45.0,47.0,0
3514,CC:2F:71:3F:1F:24,4436134,1174862388,613700,692763098,3822434,482099290,37,508016,561258493,507406,561185037,610,73456,490335,10,613937,54236,34,445,130000.0,43333.0,-67.0,-65.0,-71.0,-68.0,-67.0,-65.0,-70.0,-67.0,-91.0,-93.0,-90.0,-93.0,24.0,28.0,19.0,25.0,0
3515,CC:2F:71:3E:C5:1F,3823170,482189132,734,89640,3822436,482099492,0,3095,259648,2556,195602,539,64046,777,8,1065,18,0,34,130000.0,39000.0,-70.0,-71.0,-67.0,-60.0,-71.0,-72.0,-68.0,-61.0,-91.0,-93.0,-90.0,-93.0,21.0,22.0,23.0,33.0,0
3516,BA:8C:B9:54:50:24,3827123,488242090,4686,6142538,3822437,482099552,0,8173,1629182,8152,1625825,21,3357,2303,14,5061,36,0,53,216660.0,130000.0,-49.0,-35.0,-42.0,-45.0,-41.0,-36.0,-43.0,-50.0,-91.0,-93.0,-90.0,-93.0,42.0,58.0,48.0,48.0,0
3517,92:69:1D:31:68:E9,3826064,485606603,3625,3506849,3822439,482099754,0,3937,988616,3828,964236,109,24380,1921,6,3751,79,0,32,216660.0,130000.0,-52.0,-50.0,-45.0,-46.0,-51.0,-49.0,-43.0,-46.0,-91.0,-93.0,-90.0,-93.0,39.0,43.0,45.0,47.0,0
3518,CC:2F:71:3F:1F:24,4436183,1174877534,613744,692777780,3822439,482099754,37,508042,561263437,507432,561189981,610,73456,490361,10,613981,54255,34,445,117000.0,39000.0,-67.0,-65.0,-70.0,-68.0,-67.0,-65.0,-70.0,-67.0,-91.0,-93.0,-90.0,-93.0,24.0,28.0,20.0,25.0,0
3519,CC:2F:71:3E:C5:1F,3823173,482189394,734,89640,3822439,482099754,0,3095,259648,2556,195602,539,64046,777,8,1065,18,0,34,130000.0,39000.0,-70.0,-71.0,-67.0,-60.0,-71.0,-72.0,-68.0,-61.0,-91.0,-93.0,-90.0,-93.0,21.0,22.0,23.0,33.0,0
3520,BA:8C:B9:54:50:24,3827125,488242292,4686,6142538,3822439,482099754,0,8173,1629182,8152,1625825,21,3357,2303,14,5061,36,0,53,216660.0,130000.0,-49.0,-35.0,-42.0,-45.0,-41.0,-36.0,-43.0,-50.0,-91.0,-93.0,-90.0,-93.0,42.0,58.0,48.0,48.0,0
3521,92:69:1D:31:68:E9,3826068,485607007,3625,3506849,3822443,482100158,0,3937,988616,3828,964236,109,24380,1921,6,3751,79,0,32,216660.0,130000.0,-52.0,-50.0,-45.0,-46.0,-51.0,-49.0,-43.0,-46.0,-91.0,-93.0,-90.0,-93.0,39.0,43.0,45.0,47.0,0
3522,CC:2F:71:3F:1F:24,4436231,1174892620,613788,692792462,3822443,482100158,37,508068,561268381,507458,561194925,610,73456,490387,10,614025,54263,34,445,130000.0,43333.0,-67.0,-65.0,-70.0,-67.0,-67.0,-65.0,-70.0,-67.0,-91.0,-93.0,-90.0,-93.0,24.0,28.0,20.0,26.0,0
3523,CC:2F:71:3E:C5:1F,3823179,482190000,734,89640,3822445,482100360,0,3095,259648,2556,195602,539,64046,777,8,1065,18,0,34,130000.0,39000.0,-70.0,-71.0,-67.0,-60.0,-71.0,-72.0,-68.0,-61.0,-91.0,-93.0,-90.0,-93.0,21.0,22.0,23.0,33.0,0
3524,BA:8C:B9:54:50:24,3827131,488242898,4686,6142538,3822445,482100360,0,8173,1629182,8152,1625825,21,3357,2303,14,5061,36,0,53,216660.0,130000.0,-49.0,-35.0,-42.0,-45.0,-41.0,-36.0,-43.0,-50.0,-91.0,-93.0,-90.0,-93.0,42.0,58.0,48.0,48.0,0
3525,92:69:1D:31:68:E9,3826074,485607533,3625,3506849,3822449,482100684,0,3937,988616,3828,964236,109,24380,1921,6,3751,79,0,32,216660.0,130000.0,-52.0,-50.0,-45.0,-46.0,-51.0,-49.0,-43.0,-46.0,-91.0,-93.0,-90.0,-93.0,39.0,43.0,45.0,47.0,0
3526,CC:2F:71:3F:1F:24,4436279,1174907686,613830,692807002,3822449,482100684,37,508096,561273559,507485,561199985,611,73574,490415,10,614067,54267,34,446,130000.0,43333.0,-67.0,-65.0,-70.0,-67.0,-66.0,-65.0,-70.0,-67.0,-91.0,-93.0,-90.0,-93.0,24.0,28.0,20.0,26.0,0
3527,CC:2F:71:3E:C5:1F,3823183,482190324,734,89640,3822449,482100684,0,3095,259648,2556,195602,539,64046,777,8,1065,18,0,34,130000.0,39000.0,-70.0,-71.0,-67.0,-60.0,-71.0,-72.0,-68.0,-61.0,-91.0,-93.0,-90.0,-93.0,21.0,22.0,23.0,33.0,0
3528,BA:8C:B9:54:50:24,3827135,488243222,4686,6142538,3822449,482100684,0,8173,1629182,8152,1625825,21,3357,2303,14,5061,36,0,53,216660.0,130000.0,-49.0,-35.0,-42.0,-45.0,-41.0,-36.0,-43.0,-50.0,-91.0,-93.0,-90.0,-93.0,42.0,58.0,48.0,48.0,0
3529,92:69:1D:31:68:E9,3826076,485607735,3625,3506849,3822451,482100886,0,3937,988616,3828,964236,109,24380,1921,6,3751,79,0,32,216660.0,130000.0,-52.0,-50.0,-45.0,-46.0,-51.0,-49.0,-43.0,-46.0,-91.0,-93.0,-90.0,-93.0,39.0,43.0,45.0,47.0,0
3530,CC:2F:71:3F:1F:24,4436326,1174922672,613873,692821584,3822453,482101088,37,508124,561278723,507513,561205149,611,73574,490443,10,614110,54284,34,446,117000.0,39000.0,-67.0,-65.0,-70.0,-68.0,-67.0,-65.0,-70.0,-67.0,-91.0,-93.0,-90.0,-93.0,24.0,28.0,20.0,25.0,0
3531,CC:2F:71:3E:C5:1F,3823189,482190930,734,89640,3822455,482101290,0,3095,259648,2556,195602,539,64046,777,8,1065,18,0,34,130000.0,39000.0,-70.0,-71.0,-67.0,-60.0,-71.0,-72.0,-68.0,-61.0,-91.0,-93.0,-90.0,-93.0,21.0,22.0,23.0,33.0,0
3532,BA:8C:B9:54:50:24,3827141,488243828,4686,6142538,3822455,482101290,0,8173,1629182,8152,1625825,21,3357,2303,14,5061,36,0,53,216660.0,130000.0,-49.0,-35.0,-42.0,-45.0,-41.0,-36.0,-43.0,-50.0,-91.0,-93.0,-90.0,-93.0,42.0,58.0,48.0,48.0,0
3533,92:69:1D:31:68:E9,3826083,485608614,3625,3506849,3822458,482101765,0,3937,988616,3828,964236,109,24380,1921,6,3751,79,0,32,216660.0,130000.0,-52.0,-50.0,-45.0,-46.0,-51.0,-49.0,-43.0,-46.0,-91.0,-93.0,-90.0,-93.0,39.0,43.0,45.0,47.0,0
3534,CC:2F:71:3F:1F:24,4436372,1174937653,613914,692835888,3822458,482101765,37,508149,561283527,507538,561209953,611,73574,490468,10,614151,54293,34,446,130000.0,43333.0,-67.0,-65.0,-71.0,-67.0,-67.0,-65.0,-70.0,-67.0,-91.0,-93.0,-90.0,-93.0,24.0,28.0,19.0,26.0,0
3535,CC:2F:71:3E:C5:1F,3823192,482191405,734,89640,3822458,482101765,0,3095,259648,2556,195602,539,64046,777,8,1065,18,0,34,130000.0,39000.0,-70.0,-71.0,-67.0,-60.0,-71.0,-72.0,-68.0,-61.0,-91.0,-93.0,-90.0,-93.0,21.0,22.0,23.0,33.0,0
3536,BA:8C:B9:54:50:24,3827144,488244303,4686,6142538,3822458,482101765,0,8173,1629182,8152,1625825,21,3357,2303,14,5061,36,0,53,216660.0,130000.0,-49.0,-35.0,-42.0,-45.0,-41.0,-36.0,-43.0,-50.0,-91.0,-93.0,-90.0,-93.0,42.0,58.0,48.0,48.0,0
3537,92:69:1D:31:68:E9,3826086,485608876,3625,3506849,3822461,482102027,0,3937,988616,3828,964236,109,24380,1921,6,3751,79,0,32,216660.0,130000.0,-52.0,-50.0,-45.0,-46.0,-51.0,-49.0,-43.0,-46.0,-91.0,-93.0,-90.0,-93.0,39.0,43.0,45.0,47.0,0
3538,CC:2F:71:3F:1F:24,4436418,1174952477,613955,692850248,3822463,482102229,37,508176,561288587,507565,561215013,611,73574,490495,10,614192,54303,34,446,130000.0,39000.0,-67.0,-65.0,-70.0,-67.0,-67.0,-65.0,-70.0,-67.0,-91.0,-93.0,-90.0,-93.0,24.0,28.0,20.0,26.0,0
3539,CC:2F:71:3E:C5:1F,3823199,482192071,734,89640,3822465,482102431,0,3095,259648,2556,195602,539,64046,777,8,1065,18,0,34,130000.0,39000.0,-70.0,-71.0,-67.0,-60.0,-71.0,-72.0,-68.0,-61.0,-91.0,-93.0,-90.0,-93.0,21.0,22.0,23.0,33.0,0
3540,BA:8C:B9:54:50:24,3827151,488244969,4686,6142538,3822465,482102431,0,8174,1629250,8153,1625893,21,3357,2303,14,5061,36,0,53,216660.0,130000.0,-39.0,-36.0,-44.0,-51.0,-41.0,-35.0,-43.0,-50.0,-91.0,-93.0,-90.0,-93.0,52.0,57.0,46.0,42.0,0
3541,92:69:1D:31:68:E9,3826092,485609482,3625,3506849,3822467,482102633,0,3937,988616,3828,964236,109,24380,1921,6,3751,79,0,32,216660.0,130000.0,-52.0,-50.0,-45.0,-46.0,-51.0,-49.0,-43.0,-46.0,-91.0,-93.0,-90.0,-93.0,39.0,43.0,45.0,47.0,0
3542,CC:2F:71:3F:1F:24,4436462,1174967061,613995,692864428,3822467,482102633,37,508201,561293391,507590,561219817,611,73574,490520,10,614232,54319,34,446,130000.0,39000.0,-67.0,-65.0,-70.0,-67.0,-67.0,-65.0,-70.0,-67.0,-91.0,-93.0,-90.0,-93.0,24.0,28.0,20.0,26.0,0
3543,CC:2F:71:3E:C5:1F,3823201,482192273,734,89640,3822467,482102633,0,3095,259648,2556,195602,539,64046,777,8,1065,18,0,34,130000.0,39000.0,-70.0,-71.0,-67.0,-60.0,-71.0,-72.0,-68.0,-61.0,-91.0,-93.0,-90.0,-93.0,21.0,22.0,23.0,33.0,0
3544,BA:8C:B9:54:50:24,3827153,488245171,4686,6142538,3822467,482102633,0,8174,1629250,8153,1625893,21,3357,2303,14,5061,36,0,53,216660.0,130000.0,-39.0,-36.0,-44.0,-51.0,-41.0,-35.0,-43.0,-50.0,-91.0,-93.0,-90.0,-93.0,52.0,57.0,46.0,42.0,0
3545,92:69:1D:31:68:E9,3826094,485609684,3625,3506849,3822469,482102835,0,3937,988616,3828,964236,109,24380,1921,6,3751,79,0,32,216660.0,130000.0,-52.0,-50.0,-45.0,-46.0,-51.0,-49.0,-43.0,-46.0,-90.0,-93.0,-89.0,-93.0,38.0,43.0,44.0,47.0,0
3546,CC:2F:71:3F:1F:24,4436507,1174981651,614036,692878614,3822471,482103037,37,508226,561298195,507615,561224621,611,73574,490545,10,614273,54334,34,446,130000.0,39000.0,-67.0,-65.0,-70.0,-68.0,-67.0,-65.0,-70.0,-67.0,-90.0,-93.0,-89.0,-93.0,23.0,28.0,19.0,25.0,0
3547,CC:2F:71:3E:C5:1F,3823208,482192939,734,89640,3822474,482103299,0,3095,259648,2556,195602,539,64046,777,8,1065,18,0,34,130000.0,39000.0,-70.0,-71.0,-67.0,-60.0,-71.0,-72.0,-68.0,-61.0,-90.0,-93.0,-89.0,-93.0,20.0,22.0,22.0,33.0,0
3548,BA:8C:B9:54:50:24,3827162,488246121,4688,6142822,3822474,482103299,0,8179,1629722,8158,1626365,21,3357,2305,14,5062,36,0,53,216660.0,130000.0,-46.0,-38.0,-46.0,-50.0,-43.0,-36.0,-44.0,-49.0,-90.0,-93.0,-89.0,-93.0,44.0,55.0,43.0,43.0,0
3549,92:69:1D:31:68:E9,3826101,485610350,3625,3506849,3822476,482103501,0,3937,988616,3828,964236,109,24380,1921,6,3751,79,0,32,216660.0,130000.0,-52.0,-50.0,-45.0,-46.0,-51.0,-49.0,-43.0,-46.0,-90.0,-93.0,-89.0,-93.0,38.0,43.0,44.0,47.0,0
3550,CC:2F:71:3F:1F:24,4436553,1174996507,614077,692893006,3822476,482103501,37,508253,561303243,507642,561229669,611,73574,490572,10,614314,54355,34,446,117000.0,39000.0,-67.0,-65.0,-71.0,-67.0,-67.0,-65.0,-70.0,-67.0,-90.0,-93.0,-89.0,-93.0,23.0,28.0,18.0,26.0,0
3551,CC:2F:71:3E:C5:1F,3823210,482193141,734,89640,3822476,482103501,0,3095,259648,2556,195602,539,64046,777,8,1065,18,0,34,130000.0,39000.0,-70.0,-71.0,-67.0,-60.0,-71.0,-72.0,-68.0,-61.0,-90.0,-93.0,-89.0,-93.0,20.0,22.0,22.0,33.0,0
3552,BA:8C:B9:54:50:24,3827164,488246323,4688,6142822,3822476,482103501,0,8180,1629790,8159,1626433,21,3357,2305,14,5063,36,0,53,216660.0,130000.0,-39.0,-37.0,-44.0,-53.0,-41.0,-36.0,-44.0,-50.0,-90.0,-93.0,-89.0,-93.0,51.0,56.0,45.0,40.0,0
3553,92:69:1D:31:68:E9,3826103,485610552,3625,3506849,3822478,482103703,0,3937,988616,3828,964236,109,24380,1921,6,3751,79,0,32,216660.0,130000.0,-52.0,-50.0,-45.0,-46.0,-51.0,-49.0,-43.0,-46.0,-90.0,-93.0,-89.0,-93.0,38.0,43.0,44.0,47.0,0
3554,CC:2F:71:3F:1F:24,4436601,1175011547,614119,692907440,3822482,482104107,37,508278,561308047,507667,561234473,611,73574,490597,10,614356,54362,34,446,130000.0,43333.0,-67.0,-65.0,-71.0,-68.0,-67.0,-65.0,-70.0,-68.0,-90.0,-93.0,-89.0,-93.0,23.0,28.0,18.0,25.0,0
3555,CC:2F:71:3E:C5:1F,3823216,482193747,734,89640,3822482,482104107,0,3095,259648,2556,195602,539,64046,777,8,1065,18,0,34,130000.0,39000.0,-70.0,-71.0,-67.0,-60.0,-71.0,-72.0,-68.0,-61.0,-90.0,-93.0,-89.0,-93.0,20.0,22.0,22.0,33.0,0
3556,BA:8C:B9:54:50:24,3827170,488246929,4688,6142822,3822482,482104107,0,8180,1629790,8159,1626433,21,3357,2305,14,5063,36,0,53,216660.0,130000.0,-39.0,-37.0,-44.0,-53.0,-41.0,-36.0,-44.0,-50.0,-90.0,-93.0,-89.0,-93.0,51.0,56.0,45.0,40.0,0
3557,92:69:1D:31:68:E9,3826110,485611218,3625,3506849,3822485,482104369,0,3937,988616,3828,964236,109,24380,1921,6,3751,79,0,32,216660.0,130000.0,-52.0,-50.0,-45.0,-46.0,-51.0,-49.0,-43.0,-46.0,-90.0,-93.0,-89.0,-93.0,38.0,43.0,44.0,47.0,0
3558,CC:2F:71:3F:1F:24,4436646,1175026237,614161,692921868,3822485,482104369,37,508303,561312851,507692,561239277,611,73574,490622,10,614398,54392,34,446,117000.0,39000.0,-67.0,-65.0,-70.0,-67.0,-67.0,-65.0,-70.0,-67.0,-90.0,-93.0,-89.0,-93.0,23.0,28.0,19.0,26.0,0
3559,CC:2F:71:3E:C5:1F,3823219,482194009,734,89640,3822485,482104369,0,3095,259648,2556,195602,539,64046,777,8,1065,18,0,34,130000.0,39000.0,-70.0,-71.0,-67.0,-60.0,-71.0,-72.0,-68.0,-61.0,-90.0,-93.0,-89.0,-93.0,20.0,22.0,22.0,33.0,0
3560,BA:8C:B9:54:50:24,3827173,488247191,4688,6142822,3822485,482104369,0,8180,1629790,8159,1626433,21,3357,2305,14,5063,36,0,53,216660.0,130000.0,-39.0,-37.0,-44.0,-53.0,-41.0,-36.0,-44.0,-50.0,-90.0,-93.0,-89.0,-93.0,51.0,56.0,45.0,40.0,0
3561,92:69:1D:31:68:E9,3826112,485611420,3625,3506849,3822487,482104571,0,3937,988616,3828,964236,109,24380,1921,6,3751,79,0,32,216660.0,130000.0,-52.0,-50.0,-45.0,-46.0,-51.0,-49.0,-43.0,-46.0,-90.0,-93.0,-89.0,-93.0,38.0,43.0,44.0,47.0,0
3562,CC:2F:71:3F:1F:24,4436693,1175041143,614204,692936370,3822489,482104773,37,508328,561317655,507717,561244081,611,73574,490647,10,614441,54405,34,446,130000.0,39000.0,-67.0,-65.0,-70.0,-68.0,-67.0,-65.0,-70.0,-67.0,-90.0,-93.0,-89.0,-93.0,23.0,28.0,19.0,25.0,0
3563,CC:2F:71:3E:C5:1F,3823223,482194413,734,89640,3822489,482104773,0,3095,259648,2556,195602,539,64046,777,8,1065,18,0,34,130000.0,39000.0,-70.0,-71.0,-67.0,-60.0,-71.0,-72.0,-68.0,-61.0,-90.0,-93.0,-89.0,-93.0,20.0,22.0,22.0,33.0,0
3564,BA:8C:B9:54:50:24,3827179,488247797,4688,6142822,3822491,482104975,0,8180,1629790,8159,1626433,21,3357,2305,14,5063,36,0,53,216660.0,130000.0,-39.0,-37.0,-44.0,-53.0,-41.0,-36.0,-44.0,-50.0,-90.0,-93.0,-89.0,-93.0,51.0,56.0,45.0,40.0,0
3565,92:69:1D:31:68:E9,3826118,485612026,3625,3506849,3822493,482105177,0,3937,988616,3828,964236,109,24380,1921,6,3751,79,0,32,216660.0,130000.0,-52.0,-50.0,-45.0,-46.0,-51.0,-49.0,-43.0,-46.0,-90.0,-93.0,-89.0,-93.0,38.0,43.0,44.0,47.0,0
3566,CC:2F:71:3F:1F:24,4436739,1175055975,614246,692950798,3822493,482105177,37,508354,561322575,507743,561249001,611,73574,490673,10,614483,54436,34,446,144444.0,43333.0,-67.0,-65.0,-71.0,-68.0,-67.0,-65.0,-70.0,-67.0,-90.0,-93.0,-89.0,-93.0,23.0,28.0,18.0,25.0,0
3567,CC:2F:71:3E:C5:1F,3823227,482194817,734,89640,3822493,482105177,0,3095,259648,2556,195602,539,64046,777,8,1065,18,0,34,130000.0,39000.0,-70.0,-71.0,-67.0,-60.0,-71.0,-72.0,-68.0,-61.0,-90.0,-93.0,-89.0,-93.0,20.0,22.0,22.0,33.0,0
3568,BA:8C:B9:54:50:24,3827181,488247999,4688,6142822,3822493,482105177,0,8180,1629790,8159,1626433,21,3357,2305,14,5063,36,0,53,216660.0,130000.0,-39.0,-37.0,-44.0,-53.0,-41.0,-36.0,-44.0,-50.0,-90.0,-93.0,-89.0,-93.0,51.0,56.0,45.0,40.0,0
3569,92:69:1D:31:68:E9,3826121,485612288,3625,3506849,3822496,482105439,0,3937,988616,3828,964236,109,24380,1921,6,3751,79,0,32,216660.0,130000.0,-52.0,-50.0,-45.0,-46.0,-51.0,-49.0,-43.0,-46.0,-90.0,-93.0,-89.0,-93.0,38.0,43.0,44.0,47.0,0
3570,CC:2F:71:3F:1F:24,4436786,1175070923,614288,692965282,3822498,482105641,37,508383,561327915,507772,561254341,611,73574,490702,10,614525,54462,34,446,130000.0,43333.0,-67.0,-65.0,-70.0,-68.0,-67.0,-65.0,-70.0,-68.0,-90.0,-93.0,-89.0,-93.0,23.0,28.0,19.0,25.0,0
3571,CC:2F:71:3E:C5:1F,3823232,482195281,734,89640,3822498,482105641,0,3095,259648,2556,195602,539,64046,777,8,1065,18,0,34,130000.0,39000.0,-70.0,-71.0,-67.0,-60.0,-71.0,-72.0,-68.0,-61.0,-90.0,-93.0,-89.0,-93.0,20.0,22.0,22.0,33.0,0
3572,BA:8C:B9:54:50:24,3827188,488248665,4688,6142822,3822500,482105843,0,8180,1629790,8159,1626433,21,3357,2305,14,5063,36,0,53,216660.0,130000.0,-39.0,-37.0,-44.0,-53.0,-41.0,-36.0,-44.0,-50.0,-90.0,-93.0,-89.0,-93.0,51.0,56.0,45.0,40.0,0
3573,92:69:1D:31:68:E9,3826127,485612894,3625,3506849,3822502,482106045,0,3937,988616,3828,964236,109,24380,1921,6,3751,79,0,32,216660.0,130000.0,-52.0,-50.0,-45.0,-46.0,-51.0,-49.0,-43.0,-46.0,-90.0,-93.0,-89.0,-93.0,38.0,43.0,44.0,47.0,0
3574,CC:2F:71:3F:1F:24,4436834,1175086115,614332,692980070,3822502,482106045,37,508409,561332859,507798,561259285,611,73574,490728,10,614568,54469,34,446,130000.0,43333.0,-67.0,-65.0,-71.0,-68.0,-67.0,-65.0,-70.0,-68.0,-90.0,-93.0,-89.0,-93.0,23.0,28.0,18.0,25.0,0
3575,CC:2F:71:3E:C5:1F,3823236,482195685,734,89640,3822502,482106045,0,3095,259648,2556,195602,539,64046,777,8,1065,18,0,34,130000.0,39000.0,-70.0,-71.0,-67.0,-60.0,-71.0,-72.0,-68.0,-61.0,-90.0,-93.0,-89.0,-92.0,20.0,22.0,22.0,32.0,0
3576,BA:8C:B9:54:50:24,3827191,488248983,4689,6142938,3822502,482106045,0,8183,1630036,8162,1626679,21,3357,2306,14,5064,36,0,53,216660.0,130000.0,-40.0,-37.0,-45.0,-52.0,-41.0,-37.0,-45.0,-51.0,-90.0,-93.0,-89.0,-92.0,50.0,56.0,44.0,40.0,0
3577,92:69:1D:31:68:E9,3826129,485613096,3625,3506849,3822504,482106247,0,3937,988616,3828,964236,109,24380,1921,6,3751,79,0,32,216660.0,130000.0,-52.0,-50.0,-45.0,-46.0,-51.0,-49.0,-43.0,-46.0,-90.0,-93.0,-89.0,-92.0,38.0,43.0,44.0,46.0,0
3578,CC:2F:71:3F:1F:24,4436880,1175100883,614373,692994374,3822507,482106509,37,508437,561338011,507826,561264437,611,73574,490756,10,614610,54498,34,446,144444.0,39000.0,-68.0,-66.0,-71.0,-68.0,-68.0,-66.0,-71.0,-68.0,-90.0,-93.0,-89.0,-92.0,22.0,27.0,18.0,24.0,0
3579,CC:2F:71:3E:C5:1F,3823243,482196351,734,89640,3822509,482106711,0,3095,259648,2556,195602,539,64046,777,8,1065,18,0,34,130000.0,39000.0,-70.0,-71.0,-67.0,-60.0,-71.0,-72.0,-68.0,-61.0,-90.0,-93.0,-89.0,-92.0,20.0,22.0,22.0,32.0,0
3580,BA:8C:B9:54:50:24,3827198,488249649,4689,6142938,3822509,482106711,0,8183,1630036,8162,1626679,21,3357,2306,14,5064,36,0,53,216660.0,130000.0,-40.0,-37.0,-45.0,-52.0,-41.0,-37.0,-45.0,-51.0,-90.0,-93.0,-89.0,-92.0,50.0,56.0,44.0,40.0,0
3581,92:69:1D:31:68:E9,3826137,485613878,3626,3506965,3822511,482106913,0,3939,988752,3830,964372,109,24380,1921,6,3752,79,0,32,216660.0,130000.0,-52.0,-50.0,-44.0,-46.0,-51.0,-49.0,-43.0,-46.0,-90.0,-93.0,-89.0,-92.0,38.0,43.0,45.0,46.0,0
3582,CC:2F:71:3F:1F:24,4436927,1175115831,614416,693008918,3822511,482106913,37,508463,561342955,507852,561269381,611,73574,490782,10,614653,54508,34,446,130000.0,43333.0,-68.0,-66.0,-71.0,-68.0,-68.0,-66.0,-71.0,-68.0,-90.0,-93.0,-89.0,-92.0,22.0,27.0,18.0,24.0,0
3583,CC:2F:71:3E:C5:1F,3823246,482196669,735,89756,3822511,482106913,0,3097,259788,2558,195742,539,64046,777,8,1066,18,0,34,130000.0,39000.0,-71.0,-71.0,-67.0,-60.0,-71.0,-72.0,-68.0,-61.0,-90.0,-93.0,-89.0,-92.0,19.0,22.0,22.0,32.0,0
3584,BA:8C:B9:54:50:24,3827201,488249967,4690,6143054,3822511,482106913,0,8185,1630172,8164,1626815,21,3357,2306,14,5065,36,0,53,216660.0,130000.0,-51.0,-34.0,-43.0,-43.0,-43.0,-37.0,-45.0,-50.0,-90.0,-93.0,-89.0,-92.0,39.0,59.0,46.0,49.0,0
3585,92:69:1D:31:68:E9,3826142,485614555,3626,3506965,3822516,482107590,0,3939,988752,3830,964372,109,24380,1921,6,3752,79,0,32,216660.0,130000.0,-52.0,-50.0,-44.0,-46.0,-51.0,-49.0,-43.0,-46.0,-90.0,-93.0,-89.0,-92.0,38.0,43.0,45.0,46.0,0
3586,CC:2F:71:3F:1F:24,4436974,1175130936,614458,693023346,3822516,482107590,37,508488,561347759,507877,561274185,611,73574,490807,10,614695,54530,34,446,117000.0,39000.0,-68.0,-66.0,-72.0,-69.0,-68.0,-66.0,-71.0,-68.0,-90.0,-93.0,-89.0,-92.0,22.0,27.0,17.0,23.0,0
3587,CC:2F:71:3E:C5:1F,3823253,482197548,735,89756,3822518,482107792,0,3097,259788,2558,195742,539,64046,777,8,1066,18,0,34,130000.0,39000.0,-71.0,-71.0,-67.0,-60.0,-71.0,-72.0,-68.0,-61.0,-90.0,-93.0,-89.0,-92.0,19.0,22.0,22.0,32.0,0
3588,BA:8C:B9:54:50:24,3827208,488250846,4690,6143054,3822518,482107792,0,8185,1630172,8164,1626815,21,3357,2306,14,5065,36,0,53,216660.0,130000.0,-51.0,-34.0,-43.0,-43.0,-43.0,-37.0,-45.0,-50.0,-90.0,-93.0,-89.0,-92.0,39.0,59.0,46.0,49.0,0
3589,92:69:1D:31:68:E9,3826147,485615019,3626,3506965,3822521,482108054,0,3939,988752,3830,964372,109,24380,1921,6,3752,79,0,32,216660.0,130000.0,-52.0,-50.0,-44.0,-46.0,-51.0,-49.0,-43.0,-46.0,-90.0,-93.0,-89.0,-92.0,38.0,43.0,45.0,46.0,0
3590,CC:2F:71:3F:1F:24,4437020,1175145760,614499,693037706,3822521,482108054,37,508514,561352703,507903,561279129,611,73574,490833,10,614736,54533,34,446,130000.0,43333.0,-68.0,-66.0,-71.0,-68.0,-67.0,-65.0,-70.0,-67.0,-90.0,-93.0,-89.0,-92.0,22.0,27.0,18.0,24.0,0
3591,CC:2F:71:3E:C5:1F,3823256,482197810,735,89756,3822521,482108054,0,3097,259788,2558,195742,539,64046,777,8,1066,18,0,34,130000.0,39000.0,-71.0,-71.0,-67.0,-60.0,-71.0,-72.0,-68.0,-61.0,-90.0,-93.0,-89.0,-92.0,19.0,22.0,22.0,32.0,0
3592,BA:8C:B9:54:50:24,3827211,488251108,4690,6143054,3822521,482108054,0,8185,1630172,8164,1626815,21,3357,2306,14,5065,36,0,53,216660.0,130000.0,-51.0,-34.0,-43.0,-43.0,-43.0,-37.0,-45.0,-50.0,-90.0,-93.0,-89.0,-92.0,39.0,59.0,46.0,49.0,0
3593,92:69:1D:31:68:E9,3826151,485615423,3626,3506965,3822525,482108458,0,3939,988752,3830,964372,109,24380,1921,6,3752,79,0,32,216660.0,130000.0,-52.0,-50.0,-44.0,-46.0,-51.0,-49.0,-43.0,-46.0,-90.0,-93.0,-89.0,-92.0,38.0,43.0,45.0,46.0,0
3594,CC:2F:71:3F:1F:24,4437065,1175160524,614540,693052066,3822525,482108458,37,508539,561357507,507928,561283933,611,73574,490858,10,614777,54536,34,446,130000.0,43333.0,-67.0,-65.0,-70.0,-68.0,-67.0,-65.0,-70.0,-68.0,-90.0,-93.0,-89.0,-92.0,23.0,28.0,19.0,24.0,0
3595,CC:2F:71:3E:C5:1F,3823262,482198416,735,89756,3822527,482108660,0,3097,259788,2558,195742,539,64046,777,8,1066,18,0,34,130000.0,39000.0,-71.0,-71.0,-67.0,-60.0,-71.0,-72.0,-68.0,-61.0,-90.0,-93.0,-89.0,-92.0,19.0,22.0,22.0,32.0,0
3596,BA:8C:B9:54:50:24,3827217,488251714,4690,6143054,3822527,482108660,0,8185,1630172,8164,1626815,21,3357,2306,14,5065,36,0,53,216660.0,130000.0,-51.0,-34.0,-43.0,-43.0,-43.0,-37.0,-45.0,-50.0,-90.0,-93.0,-89.0,-92.0,39.0,59.0,46.0,49.0,0
3597,92:69:1D:31:68:E9,3826155,485615827,3626,3506965,3822529,482108862,0,3939,988752,3830,964372,109,24380,1921,6,3752,79,0,32,216660.0,130000.0,-52.0,-50.0,-44.0,-46.0,-51.0,-49.0,-43.0,-46.0,-90.0,-93.0,-89.0,-92.0,38.0,43.0,45.0,46.0,0
3598,CC:2F:71:3F:1F:24,4437111,1175175356,614582,693066494,3822529,482108862,37,508565,561362451,507954,561288877,611,73574,490884,10,614819,54556,34,446,117000.0,39000.0,-68.0,-66.0,-71.0,-68.0,-67.0,-66.0,-70.0,-68.0,-90.0,-93.0,-89.0,-92.0,22.0,27.0,18.0,24.0,0
3599,CC:2F:71:3E:C5:1F,3823264,482198618,735,89756,3822529,482108862,0,3097,259788,2558,195742,539,64046,777,8,1066,18,0,34,130000.0,39000.0,-71.0,-71.0,-67.0,-60.0,-71.0,-72.0,-68.0,-61.0,-90.0,-93.0,-89.0,-92.0,19.0,22.0,22.0,32.0,0
3600,BA:8C:B9:54:50:24,3827220,488251976,4690,6143054,3822530,482108922,0,8185,1630172,8164,1626815,21,3357,2306,14,5065,36,0,53,216660.0,130000.0,-51.0,-34.0,-43.0,-43.0,-43.0,-37.0,-45.0,-50.0,-90.0,-93.0,-89.0,-92.0,39.0,59.0,46.0,49.0,0
3601,92:69:1D:31:68:E9,3826160,485616291,3626,3506965,3822534,482109326,0,3939,988752,3830,964372,109,24380,1921,6,3752,79,0,32,216660.0,130000.0,-52.0,-50.0,-44.0,-46.0,-51.0,-49.0,-43.0,-46.0,-90.0,-93.0,-89.0,-92.0,38.0,43.0,45.0,46.0,0
3602,CC:2F:71:3F:1F:24,4437158,1175190192,614624,693080866,3822534,482109326,37,508590,561367255,507979,561293681,611,73574,490909,10,614861,54565,34,446,130000.0,39000.0,-67.0,-66.0,-71.0,-68.0,-67.0,-65.0,-70.0,-68.0,-90.0,-93.0,-89.0,-92.0,23.0,27.0,18.0,24.0,0
3603,CC:2F:71:3E:C5:1F,3823269,482199082,735,89756,3822534,482109326,0,3097,259788,2558,195742,539,64046,777,8,1066,18,0,34,130000.0,39000.0,-71.0,-71.0,-67.0,-60.0,-71.0,-72.0,-68.0,-61.0,-90.0,-93.0,-89.0,-92.0,19.0,22.0,22.0,32.0,0
3604,BA:8C:B9:54:50:24,3827226,488252582,4690,6143054,3822536,482109528,0,8185,1630172,8164,1626815,21,3357,2306,14,5065,36,0,53,216660.0,130000.0,-51.0,-34.0,-43.0,-43.0,-43.0,-37.0,-45.0,-50.0,-90.0,-93.0,-89.0,-92.0,39.0,59.0,46.0,49.0,0
3605,92:69:1D:31:68:E9,3826164,485616695,3626,3506965,3822538,482109730,0,3939,988752,3830,964372,109,24380,1921,6,3752,79,0,32,216660.0,130000.0,-52.0,-50.0,-44.0,-46.0,-51.0,-49.0,-43.0,-46.0,-90.0,-93.0,-89.0,-93.0,38.0,43.0,45.0,47.0,0
3606,CC:2F:71:3F:1F:24,4437205,1175205148,614667,693095418,3822538,482109730,37,508615,561372059,508004,561298485,611,73574,490934,10,614904,54589,34,446,130000.0,39000.0,-67.0,-65.0,-71.0,-64.0,-67.0,-65.0,-70.0,-64.0,-90.0,-93.0,-89.0,-93.0,23.0,28.0,18.0,29.0,0
3607,CC:2F:71:3E:C5:1F,3823273,482199486,735,89756,3822538,482109730,0,3097,259788,2558,195742,539,64046,777,8,1066,18,0,34,130000.0,39000.0,-71.0,-71.0,-67.0,-60.0,-71.0,-72.0,-68.0,-61.0,-90.0,-93.0,-89.0,-93.0,19.0,22.0,22.0,33.0,0
3608,BA:8C:B9:54:50:24,3827228,488252784,4690,6143054,3822538,482109730,0,8185,1630172,8164,1626815,21,3357,2306,14,5065,36,0,53,216660.0,130000.0,-51.0,-34.0,-43.0,-43.0,-43.0,-37.0,-45.0,-50.0,-90.0,-93.0,-89.0,-93.0,39.0,59.0,46.0,50.0,0
3609,92:69:1D:31:68:E9,3826169,485617159,3626,3506965,3822543,482110194,0,3939,988752,3830,964372,109,24380,1921,6,3752,79,0,32,216660.0,130000.0,-52.0,-50.0,-44.0,-46.0,-51.0,-49.0,-43.0,-46.0,-90.0,-93.0,-89.0,-93.0,38.0,43.0,45.0,47.0,0
3610,CC:2F:71:3F:1F:24,4437254,1175220366,614711,693110172,3822543,482110194,37,508644,561377363,508033,561303789,611,73574,490963,10,614948,54621,34,446,117000.0,39000.0,-67.0,-65.0,-71.0,-64.0,-67.0,-65.0,-70.0,-63.0,-90.0,-93.0,-89.0,-93.0,23.0,28.0,18.0,29.0,0
3611,CC:2F:71:3E:C5:1F,3823278,482199950,735,89756,3822543,482110194,0,3097,259788,2558,195742,539,64046,777,8,1066,18,0,34,130000.0,39000.0,-71.0,-71.0,-67.0,-60.0,-71.0,-72.0,-68.0,-61.0,-90.0,-93.0,-89.0,-93.0,19.0,22.0,22.0,33.0,0
3612,BA:8C:B9:54:50:24,3827235,488253450,4690,6143054,3822545,482110396,0,8185,1630172,8164,1626815,21,3357,2306,14,5065,36,0,53,216660.0,130000.0,-51.0,-34.0,-43.0,-43.0,-43.0,-37.0,-45.0,-50.0,-90.0,-93.0,-89.0,-93.0,39.0,59.0,46.0,50.0,0
3613,92:69:1D:31:68:E9,3826173,485617563,3626,3506965,3822547,482110598,0,3939,988752,3830,964372,109,24380,1921,6,3752,79,0,32,216660.0,130000.0,-52.0,-50.0,-44.0,-46.0,-51.0,-49.0,-43.0,-46.0,-90.0,-93.0,-89.0,-93.0,38.0,43.0,45.0,47.0,0
3614,CC:2F:71:3F:1F:24,4437299,1175235068,614752,693124470,3822547,482110598,37,508671,561382423,508060,561308849,611,73574,490990,10,614989,54631,34,446,130000.0,43333.0,-67.0,-66.0,-71.0,-68.0,-67.0,-65.0,-70.0,-68.0,-90.0,-93.0,-89.0,-93.0,23.0,27.0,18.0,25.0,0
3615,CC:2F:71:3E:C5:1F,3823282,482200354,735,89756,3822547,482110598,0,3097,259788,2558,195742,539,64046,777,8,1066,18,0,34,130000.0,39000.0,-71.0,-71.0,-67.0,-60.0,-71.0,-72.0,-68.0,-61.0,-90.0,-93.0,-89.0,-93.0,19.0,22.0,22.0,33.0,0
3616,BA:8C:B9:54:50:24,3827237,488253652,4690,6143054,3822547,482110598,0,8185,1630172,8164,1626815,21,3357,2306,14,5065,36,0,53,216660.0,130000.0,-51.0,-34.0,-43.0,-43.0,-43.0,-37.0,-45.0,-50.0,-90.0,-93.0,-89.0,-93.0,39.0,59.0,46.0,50.0,0
3617,92:69:1D:31:68:E9,3826177,485617967,3626,3506965,3822551,482111002,0,3939,988752,3830,964372,109,24380,1921,6,3752,79,0,32,216660.0,130000.0,-52.0,-50.0,-44.0,-46.0,-51.0,-49.0,-43.0,-46.0,-90.0,-93.0,-89.0,-93.0,38.0,43.0,45.0,47.0,0
3618,CC:2F:71:3F:1F:24,4437344,1175249832,614793,693138830,3822551,482111002,37,508699,561387599,508088,561314025,611,73574,491018,10,615030,54650,34,446,130000.0,39000.0,-67.0,-65.0,-71.0,-67.0,-67.0,-65.0,-70.0,-67.0,-90.0,-93.0,-89.0,-93.0,23.0,28.0,18.0,26.0,0
3619,CC:2F:71:3E:C5:1F,3823288,482200960,735,89756,3822553,482111204,0,3097,259788,2558,195742,539,64046,777,8,1066,18,0,34,130000.0,39000.0,-71.0,-71.0,-67.0,-60.0,-71.0,-72.0,-68.0,-61.0,-90.0,-93.0,-89.0,-93.0,19.0,22.0,22.0,33.0,0
3620,BA:8C:B9:54:50:24,3827243,488254258,4690,6143054,3822553,482111204,0,8185,1630172,8164,1626815,21,3357,2306,14,5065,36,0,53,216660.0,130000.0,-51.0,-34.0,-43.0,-43.0,-43.0,-37.0,-45.0,-50.0,-90.0,-93.0,-89.0,-93.0,39.0,59.0,46.0,50.0,0
3621,92:69:1D:31:68:E9,3826183,485618493,3626,3506965,3822557,482111528,0,3940,988820,3831,964440,109,24380,1921,6,3752,79,0,32,216660.0,130000.0,-52.0,-50.0,-44.0,-46.0,-51.0,-49.0,-43.0,-46.0,-90.0,-93.0,-89.0,-93.0,38.0,43.0,45.0,47.0,0
3622,CC:2F:71:3F:1F:24,4437393,1175264854,614836,693153326,3822557,482111528,37,508725,561392519,508114,561318945,611,73574,491044,10,615073,54684,34,446,130000.0,43333.0,-67.0,-66.0,-71.0,-68.0,-67.0,-65.0,-70.0,-67.0,-90.0,-93.0,-89.0,-93.0,23.0,27.0,18.0,25.0,0
3623,CC:2F:71:3E:C5:1F,3823292,482201284,735,89756,3822557,482111528,0,3099,259976,2559,195812,540,64164,778,8,1066,18,0,34,130000.0,39000.0,-70.0,-71.0,-67.0,-60.0,-70.0,-70.0,-67.0,-60.0,-90.0,-93.0,-89.0,-93.0,20.0,22.0,22.0,33.0,0
3624,BA:8C:B9:54:50:24,3827247,488254582,4690,6143054,3822557,482111528,0,8185,1630172,8164,1626815,21,3357,2306,14,5065,36,0,53,216660.0,130000.0,-51.0,-34.0,-43.0,-43.0,-43.0,-37.0,-45.0,-50.0,-90.0,-93.0,-89.0,-93.0,39.0,59.0,46.0,50.0,0
3625,92:69:1D:31:68:E9,3826187,485618897,3626,3506965,3822561,482111932,0,3940,988820,3831,964440,109,24380,1921,6,3752,79,0,32,216660.0,130000.0,-52.0,-50.0,-44.0,-46.0,-51.0,-49.0,-43.0,-46.0,-90.0,-93.0,-89.0,-93.0,38.0,43.0,45.0,47.0,0
3626,CC:2F:71:3F:1F:24,4437439,1175279798,614878,693167866,3822561,482111932,37,508750,561397323,508139,561323749,611,73574,491069,10,615115,54691,34,446,130000.0,43333.0,-67.0,-65.0,-70.0,-67.0,-67.0,-65.0,-70.0,-67.0,-90.0,-93.0,-89.0,-93.0,23.0,28.0,19.0,26.0,0
3627,CC:2F:71:3E:C5:1F,3823298,482201890,735,89756,3822563,482112134,0,3099,259976,2559,195812,540,64164,778,8,1066,18,0,34,130000.0,39000.0,-70.0,-71.0,-67.0,-60.0,-70.0,-70.0,-67.0,-60.0,-90.0,-93.0,-89.0,-93.0,20.0,22.0,22.0,33.0,0
3628,BA:8C:B9:54:50:24,3827253,488255188,4690,6143054,3822563,482112134,0,8185,1630172,8164,1626815,21,3357,2306,14,5065,36,0,53,216660.0,130000.0,-51.0,-34.0,-43.0,-43.0,-43.0,-37.0,-45.0,-50.0,-90.0,-93.0,-89.0,-93.0,39.0,59.0,46.0,50.0,0
3629,92:69:1D:31:68:E9,3826193,485619423,3626,3506965,3822567,482112458,0,3940,988820,3831,964440,109,24380,1921,6,3752,79,0,32,216660.0,130000.0,-52.0,-50.0,-44.0,-46.0,-51.0,-49.0,-43.0,-46.0,-90.0,-93.0,-89.0,-93.0,38.0,43.0,45.0,47.0,0
3630,CC:2F:71:3F:1F:24,4437487,1175294864,614920,693182406,3822567,482112458,37,508777,561402361,508165,561328669,612,73692,491096,10,615157,54696,34,447,130000.0,43333.0,-67.0,-65.0,-70.0,-68.0,-67.0,-65.0,-70.0,-67.0,-90.0,-93.0,-89.0,-93.0,23.0,28.0,19.0,25.0,0
3631,CC:2F:71:3E:C5:1F,3823302,482202214,735,89756,3822567,482112458,0,3099,259976,2559,195812,540,64164,778,8,1066,18,0,34,130000.0,39000.0,-70.0,-71.0,-67.0,-60.0,-70.0,-70.0,-67.0,-60.0,-90.0,-93.0,-89.0,-93.0,20.0,22.0,22.0,33.0,0
3632,BA:8C:B9:54:50:24,3827257,488255512,4690,6143054,3822567,482112458,0,8185,1630172,8164,1626815,21,3357,2306,14,5065,36,0,53,216660.0,130000.0,-51.0,-34.0,-43.0,-43.0,-43.0,-37.0,-45.0,-50.0,-90.0,-93.0,-89.0,-93.0,39.0,59.0,46.0,50.0,0
3633,92:69:1D:31:68:E9,3826220,485630850,3626,3506965,3822594,482123885,0,3943,989191,3833,964576,110,24615,1922,6,3752,79,0,32,216660.0,130000.0,-52.0,-50.0,-45.0,-46.0,-52.0,-49.0,-44.0,-46.0,-90.0,-93.0,-89.0,-93.0,38.0,43.0,44.0,47.0,0
3634,CC:2F:71:3F:1F:24,4437559,1175320933,614963,693196846,3822596,482124087,37,508802,561407165,508190,561333473,612,73692,491121,10,615200,54719,34,447,117000.0,39000.0,-67.0,-65.0,-71.0,-67.0,-67.0,-65.0,-70.0,-67.0,-90.0,-93.0,-89.0,-93.0,23.0,28.0,18.0,26.0,0
3635,CC:2F:71:3E:C5:1F,3823331,482213843,735,89756,3822596,482124087,0,3099,259976,2559,195812,540,64164,778,8,1066,18,0,34,130000.0,39000.0,-70.0,-71.0,-67.0,-60.0,-70.0,-70.0,-67.0,-60.0,-90.0,-93.0,-89.0,-93.0,20.0,22.0,22.0,33.0,0
3636,BA:8C:B9:54:50:24,3827288,488267343,4690,6143054,3822598,482124289,0,8185,1630172,8164,1626815,21,3357,2306,14,5065,36,0,53,216660.0,130000.0,-51.0,-34.0,-43.0,-43.0,-43.0,-37.0,-45.0,-50.0,-90.0,-93.0,-89.0,-93.0,39.0,59.0,46.0,50.0,0
3637,92:69:1D:31:68:E9,3826225,485631527,3626,3506965,3822599,482124562,0,3943,989191,3833,964576,110,24615,1922,6,3752,79,0,32,216660.0,130000.0,-52.0,-50.0,-45.0,-46.0,-52.0,-49.0,-44.0,-46.0,-90.0,-93.0,-89.0,-93.0,38.0,43.0,44.0,47.0,0
3638,CC:2F:71:3F:1F:24,4437604,1175335970,615005,693211408,3822599,482124562,37,508831,561412469,508219,561338777,612,73692,491150,10,615242,54725,34,447,130000.0,43333.0,-67.0,-65.0,-70.0,-68.0,-67.0,-65.0,-70.0,-67.0,-90.0,-93.0,-89.0,-93.0,23.0,28.0,19.0,25.0,0
3639,CC:2F:71:3E:C5:1F,3823334,482214318,735,89756,3822599,482124562,0,3099,259976,2559,195812,540,64164,778,8,1066,18,0,34,130000.0,39000.0,-70.0,-71.0,-67.0,-60.0,-70.0,-70.0,-67.0,-60.0,-90.0,-93.0,-89.0,-93.0,20.0,22.0,22.0,33.0,0
3640,BA:8C:B9:54:50:24,3827289,488267616,4690,6143054,3822599,482124562,0,8185,1630172,8164,1626815,21,3357,2306,14,5065,36,0,53,216660.0,130000.0,-51.0,-34.0,-43.0,-43.0,-43.0,-37.0,-45.0,-50.0,-90.0,-93.0,-89.0,-93.0,39.0,59.0,46.0,50.0,0
3641,92:69:1D:31:68:E9,3826232,485632193,3626,3506965,3822606,482125228,0,3943,989191,3833,964576,110,24615,1922,6,3752,79,0,32,216660.0,130000.0,-52.0,-50.0,-45.0,-46.0,-52.0,-49.0,-44.0,-46.0,-90.0,-93.0,-89.0,-93.0,38.0,43.0,44.0,47.0,0
3642,CC:2F:71:3F:1F:24,4437653,1175351064,615047,693225836,3822606,482125228,37,508860,561417761,508248,561344069,612,73692,491179,10,615284,54743,34,447,117000.0,39000.0,-67.0,-65.0,-70.0,-68.0,-66.0,-64.0,-70.0,-67.0,-90.0,-93.0,-89.0,-93.0,23.0,28.0,19.0,25.0,0
3643,CC:2F:71:3E:C5:1F,3823343,482215186,735,89756,3822608,482125430,0,3099,259976,2559,195812,540,64164,778,8,1066,18,0,34,130000.0,39000.0,-70.0,-71.0,-67.0,-60.0,-70.0,-70.0,-67.0,-60.0,-90.0,-93.0,-89.0,-93.0,20.0,22.0,22.0,33.0,0
3644,BA:8C:B9:54:50:24,3827298,488268484,4690,6143054,3822608,482125430,0,8185,1630172,8164,1626815,21,3357,2306,14,5065,36,0,53,216660.0,130000.0,-51.0,-34.0,-43.0,-43.0,-43.0,-37.0,-45.0,-50.0,-90.0,-93.0,-89.0,-93.0,39.0,59.0,46.0,50.0,0
3645,92:69:1D:31:68:E9,3826234,485632395,3626,3506965,3822608,482125430,0,3943,989191,3833,964576,110,24615,1922,6,3752,79,0,32,216660.0,130000.0,-52.0,-50.0,-45.0,-46.0,-52.0,-49.0,-44.0,-46.0,-90.0,-93.0,-89.0,-93.0,38.0,43.0,44.0,47.0,0
3646,CC:2F:71:3F:1F:24,4437697,1175365694,615089,693240264,3822608,482125430,37,508888,561422937,508276,561349245,612,73692,491207,10,615326,54751,34,447,130000.0,43333.0,-67.0,-65.0,-71.0,-68.0,-67.0,-65.0,-70.0,-67.0,-90.0,-93.0,-89.0,-93.0,23.0,28.0,18.0,25.0,0
3647,CC:2F:71:3E:C5:1F,3823343,482215186,735,89756,3822608,482125430,0,3099,259976,2559,195812,540,64164,778,8,1066,18,0,34,130000.0,39000.0,-70.0,-71.0,-67.0,-60.0,-70.0,-70.0,-67.0,-60.0,-90.0,-93.0,-89.0,-93.0,20.0,22.0,22.0,33.0,0
3648,BA:8C:B9:54:50:24,3827298,488268484,4690,6143054,3822608,482125430,0,8189,1630444,8168,1627087,21,3357,2306,14,5065,36,0,53,216660.0,130000.0,-49.0,-35.0,-42.0,-44.0,-44.0,-36.0,-44.0,-48.0,-90.0,-93.0,-89.0,-93.0,41.0,58.0,47.0,49.0,0
3649,92:69:1D:31:68:E9,3826243,485633429,3626,3506965,3822617,482126464,0,3943,989191,3833,964576,110,24615,1922,6,3752,79,0,32,216660.0,130000.0,-52.0,-50.0,-45.0,-46.0,-52.0,-49.0,-44.0,-46.0,-90.0,-93.0,-89.0,-93.0,38.0,43.0,44.0,47.0,0
3650,CC:2F:71:3F:1F:24,4437751,1175381594,615132,693254928,3822619,482126666,37,508913,561427741,508301,561354049,612,73692,491232,10,615369,54756,34,447,130000.0,43333.0,-67.0,-65.0,-70.0,-68.0,-67.0,-65.0,-70.0,-67.0,-90.0,-93.0,-89.0,-93.0,23.0,28.0,19.0,25.0,0
3651,CC:2F:71:3E:C5:1F,3823354,482216422,735,89756,3822619,482126666,0,3099,259976,2559,195812,540,64164,778,8,1066,18,0,34,130000.0,39000.0,-70.0,-71.0,-67.0,-60.0,-70.0,-70.0,-67.0,-60.0,-90.0,-93.0,-89.0,-93.0,20.0,22.0,22.0,33.0,0
3652,BA:8C:B9:54:50:24,3827309,488269720,4690,6143054,3822619,482126666,0,8189,1630444,8168,1627087,21,3357,2306,14,5065,36,0,53,216660.0,130000.0,-49.0,-35.0,-42.0,-44.0,-44.0,-36.0,-44.0,-48.0,-90.0,-93.0,-89.0,-93.0,41.0,58.0,47.0,49.0,0
3653,92:69:1D:31:68:E9,3826245,485633631,3626,3506965,3822619,482126666,0,3946,989395,3836,964780,110,24615,1922,6,3752,79,0,32,216660.0,130000.0,-52.0,-50.0,-44.0,-46.0,-52.0,-50.0,-44.0,-46.0,-90.0,-93.0,-89.0,-93.0,38.0,43.0,45.0,47.0,0
3654,CC:2F:71:3F:1F:24,4437794,1175396202,615175,693269536,3822619,482126666,37,508938,561432545,508326,561358853,612,73692,491257,10,615412,54774,34,447,130000.0,39000.0,-67.0,-66.0,-71.0,-68.0,-67.0,-65.0,-70.0,-67.0,-90.0,-93.0,-89.0,-93.0,23.0,27.0,18.0,25.0,0
3655,CC:2F:71:3E:C5:1F,3823354,482216422,735,89756,3822619,482126666,0,3099,259976,2559,195812,540,64164,778,8,1066,18,0,34,130000.0,39000.0,-70.0,-71.0,-67.0,-60.0,-70.0,-70.0,-67.0,-60.0,-90.0,-93.0,-89.0,-93.0,20.0,22.0,22.0,33.0,0
3656,BA:8C:B9:54:50:24,3827309,488269720,4690,6143054,3822619,482126666,0,8189,1630444,8168,1627087,21,3357,2306,14,5065,36,0,53,216660.0,130000.0,-49.0,-35.0,-42.0,-44.0,-44.0,-36.0,-44.0,-48.0,-90.0,-93.0,-89.0,-93.0,41.0,58.0,47.0,49.0,0
3657,92:69:1D:31:68:E9,3826253,485634439,3626,3506965,3822627,482127474,0,3946,989395,3836,964780,110,24615,1922,6,3752,79,0,32,216660.0,130000.0,-52.0,-50.0,-44.0,-46.0,-52.0,-50.0,-44.0,-46.0,-90.0,-93.0,-89.0,-93.0,38.0,43.0,45.0,47.0,0
3658,CC:2F:71:3F:1F:24,4437843,1175411314,615216,693283840,3822627,482127474,37,508965,561437581,508353,561363889,612,73692,491284,10,615453,54790,34,447,130000.0,39000.0,-67.0,-65.0,-71.0,-67.0,-67.0,-65.0,-70.0,-67.0,-90.0,-93.0,-89.0,-93.0,23.0,28.0,18.0,26.0,0
3659,CC:2F:71:3E:C5:1F,3823362,482217230,735,89756,3822627,482127474,0,3099,259976,2559,195812,540,64164,778,8,1066,18,0,34,130000.0,39000.0,-70.0,-71.0,-67.0,-60.0,-70.0,-70.0,-67.0,-60.0,-90.0,-93.0,-89.0,-93.0,20.0,22.0,22.0,33.0,0
3660,BA:8C:B9:54:50:24,3827317,488270528,4690,6143054,3822627,482127474,0,8189,1630444,8168,1627087,21,3357,2306,14,5065,36,0,53,216660.0,130000.0,-49.0,-35.0,-42.0,-44.0,-44.0,-36.0,-44.0,-48.0,-90.0,-93.0,-89.0,-93.0,41.0,58.0,47.0,49.0,0
3661,92:69:1D:31:68:E9,3826254,485634499,3626,3506965,3822628,482127534,0,3946,989395,3836,964780,110,24615,1922,6,3752,79,0,32,216660.0,130000.0,-52.0,-50.0,-44.0,-46.0,-52.0,-50.0,-44.0,-46.0,-90.0,-93.0,-89.0,-93.0,38.0,43.0,45.0,47.0,0
3662,CC:2F:71:3F:1F:24,4437888,1175426000,615260,693298466,3822628,482127534,37,508991,561442525,508379,561368833,612,73692,491310,10,615497,54819,34,447,144444.0,39000.0,-67.0,-65.0,-70.0,-67.0,-67.0,-65.0,-70.0,-67.0,-90.0,-93.0,-89.0,-93.0,23.0,28.0,19.0,26.0,0
3663,CC:2F:71:3E:C5:1F,3823363,482217290,735,89756,3822628,482127534,0,3099,259976,2559,195812,540,64164,778,8,1066,18,0,34,130000.0,39000.0,-70.0,-71.0,-67.0,-60.0,-70.0,-70.0,-67.0,-60.0,-90.0,-93.0,-89.0,-93.0,20.0,22.0,22.0,33.0,0
3664,BA:8C:B9:54:50:24,3827318,488270588,4690,6143054,3822628,482127534,0,8189,1630444,8168,1627087,21,3357,2306,14,5065,36,0,53,216660.0,130000.0,-49.0,-35.0,-42.0,-44.0,-44.0,-36.0,-44.0,-48.0,-90.0,-93.0,-89.0,-93.0,41.0,58.0,47.0,49.0,0
3665,92:69:1D:31:68:E9,3826262,485635307,3626,3506965,3822636,482128342,0,3946,989395,3836,964780,110,24615,1922,6,3752,79,0,32,216660.0,130000.0,-52.0,-50.0,-44.0,-46.0,-52.0,-50.0,-44.0,-46.0,-90.0,-93.0,-89.0,-93.0,38.0,43.0,45.0,47.0,0
3666,CC:2F:71:3F:1F:24,4437937,1175441118,615301,693312776,3822636,482128342,37,509017,561447469,508405,561373777,612,73692,491336,10,615538,54841,34,447,130000.0,43333.0,-67.0,-65.0,-71.0,-68.0,-67.0,-65.0,-70.0,-67.0,-90.0,-93.0,-89.0,-93.0,23.0,28.0,18.0,25.0,0
3667,CC:2F:71:3E:C5:1F,3823371,482218098,735,89756,3822636,482128342,0,3099,259976,2559,195812,540,64164,778,8,1066,18,0,34,130000.0,39000.0,-70.0,-71.0,-67.0,-60.0,-70.0,-70.0,-67.0,-60.0,-90.0,-93.0,-89.0,-93.0,20.0,22.0,22.0,33.0,0
3668,BA:8C:B9:54:50:24,3827326,488271396,4690,6143054,3822636,482128342,0,8189,1630444,8168,1627087,21,3357,2306,14,5065,36,0,53,216660.0,130000.0,-49.0,-35.0,-42.0,-44.0,-44.0,-36.0,-44.0,-48.0,-90.0,-93.0,-89.0,-93.0,41.0,58.0,47.0,49.0,0
3669,92:69:1D:31:68:E9,3826262,485635307,3626,3506965,3822636,482128342,0,3946,989395,3836,964780,110,24615,1922,6,3752,79,0,32,216660.0,130000.0,-52.0,-50.0,-44.0,-46.0,-52.0,-50.0,-44.0,-46.0,-90.0,-93.0,-89.0,-93.0,38.0,43.0,45.0,47.0,0
3670,CC:2F:71:3F:1F:24,4437982,1175455978,615345,693327576,3822637,482128402,37,509042,561452273,508430,561378581,612,73692,491361,10,615582,54852,34,447,130000.0,43333.0,-67.0,-65.0,-70.0,-68.0,-67.0,-65.0,-70.0,-67.0,-90.0,-93.0,-89.0,-93.0,23.0,28.0,19.0,25.0,0
3671,CC:2F:71:3E:C5:1F,3823372,482218158,735,89756,3822637,482128402,0,3099,259976,2559,195812,540,64164,778,8,1066,18,0,34,130000.0,39000.0,-70.0,-71.0,-67.0,-60.0,-70.0,-70.0,-67.0,-60.0,-90.0,-93.0,-89.0,-93.0,20.0,22.0,22.0,33.0,0
3672,BA:8C:B9:54:50:24,3827327,488271456,4690,6143054,3822637,482128402,0,8189,1630444,8168,1627087,21,3357,2306,14,5065,36,0,53,216660.0,130000.0,-49.0,-35.0,-42.0,-44.0,-44.0,-36.0,-44.0,-48.0,-90.0,-93.0,-89.0,-93.0,41.0,58.0,47.0,49.0,0
3673,92:69:1D:31:68:E9,3826272,485636253,3626,3506965,3822646,482129288,0,3946,989395,3836,964780,110,24615,1922,6,3752,79,0,32,216660.0,130000.0,-52.0,-50.0,-44.0,-46.0,-52.0,-50.0,-44.0,-46.0,-90.0,-93.0,-89.0,-93.0,38.0,43.0,45.0,47.0,0
3674,CC:2F:71:3F:1F:24,4438034,1175471484,615388,693342196,3822646,482129288,37,509068,561457217,508456,561383525,612,73692,491387,10,615625,54871,34,447,130000.0,39000.0,-67.0,-65.0,-70.0,-67.0,-67.0,-65.0,-70.0,-67.0,-90.0,-93.0,-89.0,-93.0,23.0,28.0,19.0,26.0,0
3675,CC:2F:71:3E:C5:1F,3823381,482219044,735,89756,3822646,482129288,0,3099,259976,2559,195812,540,64164,778,8,1066,18,0,34,130000.0,39000.0,-70.0,-71.0,-67.0,-60.0,-70.0,-70.0,-67.0,-60.0,-90.0,-93.0,-89.0,-93.0,20.0,22.0,22.0,33.0,0
3676,BA:8C:B9:54:50:24,3827336,488272342,4690,6143054,3822646,482129288,0,8189,1630444,8168,1627087,21,3357,2306,14,5065,36,0,53,216660.0,130000.0,-49.0,-35.0,-42.0,-44.0,-44.0,-36.0,-44.0,-48.0,-90.0,-93.0,-89.0,-93.0,41.0,58.0,47.0,49.0,0
3677,92:69:1D:31:68:E9,3826272,485636253,3626,3506965,3822646,482129288,0,3946,989395,3836,964780,110,24615,1922,6,3752,79,0,32,216660.0,130000.0,-52.0,-50.0,-44.0,-46.0,-52.0,-50.0,-44.0,-46.0,-90.0,-93.0,-89.0,-93.0,38.0,43.0,45.0,47.0,0
3678,CC:2F:71:3F:1F:24,4438079,1175486240,615433,693356952,3822646,482129288,37,509093,561462021,508481,561388329,612,73692,491412,10,615670,54906,34,447,130000.0,43333.0,-67.0,-65.0,-70.0,-67.0,-67.0,-65.0,-70.0,-67.0,-90.0,-93.0,-89.0,-93.0,23.0,28.0,19.0,26.0,0
3679,CC:2F:71:3E:C5:1F,3823381,482219044,735,89756,3822646,482129288,0,3099,259976,2559,195812,540,64164,778,8,1066,18,0,34,130000.0,39000.0,-70.0,-71.0,-67.0,-60.0,-70.0,-70.0,-67.0,-60.0,-90.0,-93.0,-89.0,-93.0,20.0,22.0,22.0,33.0,0
3680,BA:8C:B9:54:50:24,3827336,488272342,4690,6143054,3822646,482129288,0,8189,1630444,8168,1627087,21,3357,2306,14,5065,36,0,53,216660.0,130000.0,-49.0,-35.0,-42.0,-44.0,-44.0,-36.0,-44.0,-48.0,-90.0,-93.0,-89.0,-93.0,41.0,58.0,47.0,49.0,0
3681,92:69:1D:31:68:E9,3826283,485638245,3626,3506965,3822657,482131280,0,3946,989395,3836,964780,110,24615,1922,6,3752,79,0,32,216660.0,130000.0,-52.0,-50.0,-44.0,-46.0,-52.0,-50.0,-44.0,-46.0,-90.0,-93.0,-89.0,-93.0,38.0,43.0,45.0,47.0,0
3682,CC:2F:71:3F:1F:24,4438133,1175502902,615476,693371622,3822657,482131280,37,509119,561467001,508507,561393309,612,73692,491438,10,615713,54921,34,447,130000.0,39000.0,-67.0,-65.0,-70.0,-68.0,-67.0,-65.0,-70.0,-67.0,-90.0,-93.0,-89.0,-93.0,23.0,28.0,19.0,25.0,0
3683,CC:2F:71:3E:C5:1F,3823392,482221036,735,89756,3822657,482131280,0,3099,259976,2559,195812,540,64164,778,8,1066,18,0,34,130000.0,39000.0,-70.0,-71.0,-67.0,-60.0,-70.0,-70.0,-67.0,-60.0,-90.0,-93.0,-90.0,-93.0,20.0,22.0,23.0,33.0,0
3684,BA:8C:B9:54:50:24,3827347,488274334,4690,6143054,3822657,482131280,0,8189,1630444,8168,1627087,21,3357,2306,14,5065,36,0,53,216660.0,130000.0,-49.0,-35.0,-42.0,-44.0,-44.0,-36.0,-44.0,-48.0,-90.0,-93.0,-90.0,-93.0,41.0,58.0,48.0,49.0,0
3685,92:69:1D:31:68:E9,3826284,485638361,3627,3507081,3822657,482131280,0,3948,989531,3838,964916,110,24615,1922,6,3753,79,0,32,216660.0,130000.0,-52.0,-50.0,-45.0,-46.0,-52.0,-50.0,-44.0,-46.0,-90.0,-93.0,-90.0,-93.0,38.0,43.0,45.0,47.0,0
3686,CC:2F:71:3F:1F:24,4438179,1175517774,615522,693386494,3822657,482131280,37,509144,561471805,508532,561398113,612,73692,491463,10,615759,54927,34,447,130000.0,43333.0,-67.0,-65.0,-70.0,-68.0,-67.0,-65.0,-70.0,-67.0,-90.0,-93.0,-90.0,-93.0,23.0,28.0,20.0,25.0,0
3687,CC:2F:71:3E:C5:1F,3823393,482221152,736,89872,3822657,482131280,0,3101,260116,2561,195952,540,64164,778,8,1067,18,0,34,130000.0,39000.0,-71.0,-71.0,-68.0,-60.0,-70.0,-71.0,-67.0,-60.0,-90.0,-93.0,-90.0,-93.0,19.0,22.0,22.0,33.0,0
3688,BA:8C:B9:54:50:24,3827348,488274450,4691,6143170,3822657,482131280,0,8195,1630852,8174,1627495,21,3357,2306,14,5066,36,0,53,216660.0,130000.0,-39.0,-36.0,-44.0,-51.0,-43.0,-34.0,-41.0,-45.0,-90.0,-93.0,-90.0,-93.0,51.0,57.0,46.0,42.0,0
3689,92:69:1D:31:68:E9,3826295,485640566,3627,3507081,3822668,482133485,0,3948,989531,3838,964916,110,24615,1922,6,3753,79,0,32,216660.0,130000.0,-52.0,-50.0,-45.0,-46.0,-52.0,-50.0,-44.0,-46.0,-90.0,-93.0,-90.0,-93.0,38.0,43.0,45.0,47.0,0
3690,CC:2F:71:3F:1F:24,4438234,1175534739,615566,693401254,3822668,482133485,37,509172,561476993,508560,561403301,612,73692,491491,10,615803,54944,34,447,117000.0,39000.0,-67.0,-65.0,-70.0,-68.0,-67.0,-65.0,-70.0,-67.0,-90.0,-93.0,-90.0,-93.0,23.0,28.0,20.0,25.0,0
3691,CC:2F:71:3E:C5:1F,3823404,482223357,736,89872,3822668,482133485,0,3101,260116,2561,195952,540,64164,778,8,1067,18,0,34,130000.0,39000.0,-71.0,-71.0,-68.0,-60.0,-70.0,-71.0,-67.0,-60.0,-90.0,-93.0,-90.0,-93.0,19.0,22.0,22.0,33.0,0
3692,BA:8C:B9:54:50:24,3827359,488276655,4691,6143170,3822668,482133485,0,8195,1630852,8174,1627495,21,3357,2306,14,5066,36,0,53,216660.0,130000.0,-39.0,-36.0,-44.0,-51.0,-43.0,-34.0,-41.0,-45.0,-90.0,-93.0,-90.0,-93.0,51.0,57.0,46.0,42.0,0
3693,92:69:1D:31:68:E9,3826296,485640626,3627,3507081,3822669,482133545,0,3948,989531,3838,964916,110,24615,1922,6,3753,79,0,32,216660.0,130000.0,-52.0,-50.0,-45.0,-46.0,-52.0,-50.0,-44.0,-46.0,-90.0,-93.0,-90.0,-93.0,38.0,43.0,45.0,47.0,0
3694,CC:2F:71:3F:1F:24,4438279,1175549431,615610,693415886,3822669,482133545,37,509198,561481937,508586,561408245,612,73692,491517,10,615847,54960,34,447,130000.0,39000.0,-67.0,-65.0,-70.0,-67.0,-67.0,-65.0,-70.0,-67.0,-90.0,-93.0,-90.0,-93.0,23.0,28.0,20.0,26.0,0
3695,CC:2F:71:3E:C5:1F,3823405,482223417,736,89872,3822669,482133545,0,3101,260116,2561,195952,540,64164,778,8,1067,18,0,34,130000.0,39000.0,-71.0,-71.0,-68.0,-60.0,-70.0,-71.0,-67.0,-60.0,-90.0,-93.0,-90.0,-93.0,19.0,22.0,22.0,33.0,0
3696,BA:8C:B9:54:50:24,3827360,488276715,4691,6143170,3822669,482133545,0,8196,1630920,8175,1627563,21,3357,2306,14,5066,36,0,53,216660.0,130000.0,-49.0,-35.0,-42.0,-44.0,-43.0,-34.0,-41.0,-45.0,-90.0,-93.0,-90.0,-93.0,41.0,58.0,48.0,49.0,0
3697,92:69:1D:31:68:E9,3826307,485642620,3627,3507081,3822680,482135539,0,3948,989531,3838,964916,110,24615,1922,6,3753,79,0,32,216660.0,130000.0,-52.0,-50.0,-45.0,-46.0,-52.0,-50.0,-44.0,-46.0,-90.0,-93.0,-90.0,-93.0,38.0,43.0,45.0,47.0,0
3698,CC:2F:71:3F:1F:24,4438334,1175566247,615654,693430708,3822680,482135539,37,509226,561487103,508613,561413293,613,73810,491545,10,615891,54971,34,447,130000.0,39000.0,-67.0,-65.0,-71.0,-67.0,-67.0,-65.0,-70.0,-67.0,-90.0,-93.0,-90.0,-93.0,23.0,28.0,19.0,26.0,0
3699,CC:2F:71:3E:C5:1F,3823416,482225411,736,89872,3822680,482135539,0,3101,260116,2561,195952,540,64164,778,8,1067,18,0,34,130000.0,39000.0,-71.0,-71.0,-68.0,-60.0,-70.0,-71.0,-67.0,-60.0,-90.0,-93.0,-90.0,-93.0,19.0,22.0,22.0,33.0,0
3700,BA:8C:B9:54:50:24,3827371,488278709,4691,6143170,3822680,482135539,0,8196,1630920,8175,1627563,21,3357,2306,14,5066,36,0,53,216660.0,130000.0,-49.0,-35.0,-42.0,-44.0,-43.0,-34.0,-41.0,-45.0,-90.0,-93.0,-90.0,-93.0,41.0,58.0,48.0,49.0,0
3701,92:69:1D:31:68:E9,3826308,485642680,3627,3507081,3822681,482135599,0,3948,989531,3838,964916,110,24615,1922,6,3753,79,0,32,216660.0,130000.0,-52.0,-50.0,-45.0,-46.0,-52.0,-50.0,-44.0,-46.0,-90.0,-93.0,-90.0,-93.0,38.0,43.0,45.0,47.0,0
3702,CC:2F:71:3F:1F:24,4438377,1175580791,615696,693445192,3822681,482135599,37,509252,561492023,508639,561418213,613,73810,491571,10,615932,54971,34,447,130000.0,43333.0,-67.0,-65.0,-70.0,-67.0,-67.0,-65.0,-70.0,-67.0,-90.0,-93.0,-90.0,-93.0,23.0,28.0,20.0,26.0,0
3703,CC:2F:71:3E:C5:1F,3823417,482225471,736,89872,3822681,482135599,0,3101,260116,2561,195952,540,64164,778,8,1067,18,0,34,130000.0,39000.0,-71.0,-71.0,-68.0,-60.0,-70.0,-71.0,-67.0,-60.0,-90.0,-93.0,-90.0,-93.0,19.0,22.0,22.0,33.0,0
3704,BA:8C:B9:54:50:24,3827372,488278769,4691,6143170,3822681,482135599,0,8196,1630920,8175,1627563,21,3357,2306,14,5066,36,0,53,216660.0,130000.0,-49.0,-35.0,-42.0,-44.0,-43.0,-34.0,-41.0,-45.0,-90.0,-93.0,-90.0,-93.0,41.0,58.0,48.0,49.0,0
3705,92:69:1D:31:68:E9,3826316,485643488,3627,3507081,3822689,482136407,0,3948,989531,3838,964916,110,24615,1922,6,3753,79,0,32,216660.0,130000.0,-52.0,-50.0,-45.0,-46.0,-52.0,-50.0,-44.0,-46.0,-90.0,-93.0,-90.0,-93.0,38.0,43.0,45.0,47.0,0
3706,CC:2F:71:3F:1F:24,4438428,1175596219,615739,693459812,3822689,482136407,37,509277,561496827,508664,561423017,613,73810,491596,10,615976,54992,34,447,130000.0,39000.0,-67.0,-65.0,-70.0,-67.0,-67.0,-65.0,-70.0,-67.0,-90.0,-93.0,-90.0,-93.0,23.0,28.0,20.0,26.0,0
3707,CC:2F:71:3E:C5:1F,3823425,482226279,736,89872,3822689,482136407,0,3101,260116,2561,195952,540,64164,778,8,1067,18,0,34,130000.0,39000.0,-71.0,-71.0,-68.0,-60.0,-70.0,-71.0,-67.0,-60.0,-90.0,-93.0,-90.0,-93.0,19.0,22.0,22.0,33.0,0
3708,BA:8C:B9:54:50:24,3827380,488279577,4691,6143170,3822689,482136407,0,8196,1630920,8175,1627563,21,3357,2306,14,5066,36,0,53,216660.0,130000.0,-49.0,-35.0,-42.0,-44.0,-43.0,-34.0,-41.0,-45.0,-90.0,-93.0,-90.0,-93.0,41.0,58.0,48.0,49.0,0
3709,92:69:1D:31:68:E9,3826316,485643488,3627,3507081,3822689,482136407,0,3948,989531,3838,964916,110,24615,1922,6,3753,79,0,32,216660.0,130000.0,-52.0,-50.0,-45.0,-46.0,-52.0,-50.0,-44.0,-46.0,-90.0,-93.0,-90.0,-93.0,38.0,43.0,45.0,47.0,0
3710,CC:2F:71:3F:1F:24,4438471,1175610783,615782,693474376,3822689,482136407,37,509302,561501631,508689,561427821,613,73810,491621,10,616019,55006,34,447,130000.0,39000.0,-67.0,-65.0,-70.0,-68.0,-67.0,-65.0,-70.0,-67.0,-90.0,-93.0,-90.0,-93.0,23.0,28.0,20.0,25.0,0
3711,CC:2F:71:3E:C5:1F,3823425,482226279,736,89872,3822689,482136407,0,3101,260116,2561,195952,540,64164,778,8,1067,18,0,34,130000.0,39000.0,-71.0,-71.0,-68.0,-60.0,-70.0,-71.0,-67.0,-60.0,-90.0,-93.0,-90.0,-93.0,19.0,22.0,22.0,33.0,0
3712,BA:8C:B9:54:50:24,3827380,488279577,4691,6143170,3822689,482136407,0,8196,1630920,8175,1627563,21,3357,2306,14,5066,36,0,53,216660.0,130000.0,-49.0,-35.0,-42.0,-44.0,-43.0,-34.0,-41.0,-45.0,-90.0,-93.0,-90.0,-93.0,41.0,58.0,48.0,49.0,0
3713,92:69:1D:31:68:E9,3826325,485644356,3627,3507081,3822698,482137275,0,3948,989531,3838,964916,110,24615,1922,6,3753,79,0,32,216660.0,130000.0,-52.0,-50.0,-45.0,-46.0,-52.0,-50.0,-44.0,-46.0,-90.0,-93.0,-90.0,-93.0,38.0,43.0,45.0,47.0,0
3714,CC:2F:71:3F:1F:24,4438526,1175626525,615827,693489188,3822699,482137337,37,509327,561506435,508714,561432625,613,73810,491646,10,616064,55013,34,447,130000.0,39000.0,-67.0,-65.0,-71.0,-68.0,-67.0,-65.0,-70.0,-67.0,-90.0,-93.0,-90.0,-93.0,23.0,28.0,19.0,25.0,0
3715,CC:2F:71:3E:C5:1F,3823435,482227209,736,89872,3822699,482137337,0,3103,260304,2562,196022,541,64282,779,8,1067,18,0,34,130000.0,39000.0,-70.0,-71.0,-67.0,-60.0,-70.0,-71.0,-67.0,-60.0,-90.0,-93.0,-90.0,-93.0,20.0,22.0,23.0,33.0,0
3716,BA:8C:B9:54:50:24,3827390,488280507,4691,6143170,3822699,482137337,0,8196,1630920,8175,1627563,21,3357,2306,14,5066,36,0,53,216660.0,130000.0,-49.0,-35.0,-42.0,-44.0,-43.0,-34.0,-41.0,-45.0,-90.0,-93.0,-90.0,-93.0,41.0,58.0,48.0,49.0,0
3717,92:69:1D:31:68:E9,3826326,485644418,3627,3507081,3822699,482137337,0,3948,989531,3838,964916,110,24615,1922,6,3753,79,0,32,216660.0,130000.0,-52.0,-50.0,-45.0,-46.0,-52.0,-50.0,-44.0,-46.0,-90.0,-93.0,-90.0,-93.0,38.0,43.0,45.0,47.0,0
3718,CC:2F:71:3F:1F:24,4438569,1175641089,615870,693503752,3822699,482137337,37,509353,561511379,508740,561437569,613,73810,491672,10,616107,55037,34,447,130000.0,39000.0,-67.0,-65.0,-70.0,-68.0,-67.0,-65.0,-70.0,-67.0,-90.0,-93.0,-90.0,-93.0,23.0,28.0,20.0,25.0,0
3719,CC:2F:71:3E:C5:1F,3823435,482227209,736,89872,3822699,482137337,0,3103,260304,2562,196022,541,64282,779,8,1067,18,0,34,130000.0,39000.0,-70.0,-71.0,-67.0,-60.0,-70.0,-71.0,-67.0,-60.0,-90.0,-93.0,-90.0,-93.0,20.0,22.0,23.0,33.0,0
3720,BA:8C:B9:54:50:24,3827390,488280507,4691,6143170,3822699,482137337,0,8196,1630920,8175,1627563,21,3357,2306,14,5066,36,0,53,216660.0,130000.0,-49.0,-35.0,-42.0,-44.0,-43.0,-34.0,-41.0,-45.0,-90.0,-93.0,-90.0,-93.0,41.0,58.0,48.0,49.0,0
3721,92:69:1D:31:68:E9,3826334,485645226,3627,3507081,3822707,482138145,0,3948,989531,3838,964916,110,24615,1922,6,3753,79,0,32,216660.0,130000.0,-52.0,-50.0,-45.0,-46.0,-52.0,-50.0,-44.0,-46.0,-90.0,-94.0,-90.0,-93.0,38.0,44.0,45.0,47.0,0
3722,CC:2F:71:3F:1F:24,4438621,1175656585,615914,693518440,3822707,482138145,37,509378,561516183,508765,561442373,613,73810,491697,10,616151,55050,34,447,130000.0,39000.0,-67.0,-65.0,-70.0,-68.0,-67.0,-65.0,-70.0,-67.0,-90.0,-94.0,-90.0,-93.0,23.0,29.0,20.0,25.0,0
3723,CC:2F:71:3E:C5:1F,3823444,482228077,736,89872,3822708,482138205,0,3103,260304,2562,196022,541,64282,779,8,1067,18,0,34,130000.0,39000.0,-70.0,-71.0,-67.0,-60.0,-70.0,-71.0,-67.0,-60.0,-90.0,-94.0,-90.0,-93.0,20.0,23.0,23.0,33.0,0
3724,BA:8C:B9:54:50:24,3827399,488281375,4691,6143170,3822708,482138205,0,8196,1630920,8175,1627563,21,3357,2306,14,5066,36,0,53,216660.0,130000.0,-49.0,-35.0,-42.0,-44.0,-43.0,-34.0,-41.0,-45.0,-90.0,-94.0,-90.0,-93.0,41.0,59.0,48.0,49.0,0
3725,92:69:1D:31:68:E9,3826335,485645286,3627,3507081,3822708,482138205,0,3948,989531,3838,964916,110,24615,1922,6,3753,79,0,32,216660.0,130000.0,-52.0,-50.0,-45.0,-46.0,-52.0,-50.0,-44.0,-46.0,-90.0,-94.0,-90.0,-93.0,38.0,44.0,45.0,47.0,0
3726,CC:2F:71:3F:1F:24,4438665,1175671153,615957,693532948,3822708,482138205,37,509403,561520987,508790,561447177,613,73810,491722,10,616194,55089,34,447,130000.0,43333.0,-67.0,-65.0,-71.0,-67.0,-67.0,-65.0,-70.0,-67.0,-90.0,-94.0,-90.0,-93.0,23.0,29.0,19.0,26.0,0
3727,CC:2F:71:3E:C5:1F,3823444,482228077,736,89872,3822708,482138205,0,3103,260304,2562,196022,541,64282,779,8,1067,18,0,34,130000.0,39000.0,-70.0,-71.0,-67.0,-60.0,-70.0,-71.0,-67.0,-60.0,-90.0,-94.0,-90.0,-93.0,20.0,23.0,23.0,33.0,0
3728,BA:8C:B9:54:50:24,3827399,488281375,4691,6143170,3822708,482138205,0,8196,1630920,8175,1627563,21,3357,2306,14,5066,36,0,53,216660.0,130000.0,-49.0,-35.0,-42.0,-44.0,-43.0,-34.0,-41.0,-45.0,-90.0,-94.0,-90.0,-93.0,41.0,59.0,48.0,49.0,0
3729,92:69:1D:31:68:E9,3826344,485646220,3627,3507081,3822717,482139139,0,3948,989531,3838,964916,110,24615,1922,6,3753,79,0,32,216660.0,130000.0,-52.0,-50.0,-45.0,-46.0,-52.0,-50.0,-44.0,-46.0,-90.0,-94.0,-90.0,-93.0,38.0,44.0,45.0,47.0,0
3730,CC:2F:71:3F:1F:24,4438719,1175687011,616002,693547872,3822717,482139139,37,509428,561525791,508815,561451981,613,73810,491747,10,616239,55099,34,447,130000.0,43333.0,-67.0,-65.0,-70.0,-67.0,-67.0,-65.0,-70.0,-67.0,-90.0,-94.0,-90.0,-93.0,23.0,29.0,20.0,26.0,0
3731,CC:2F:71:3E:C5:1F,3823453,482229011,736,89872,3822717,482139139,0,3103,260304,2562,196022,541,64282,779,8,1067,18,0,34,130000.0,39000.0,-70.0,-71.0,-67.0,-60.0,-70.0,-71.0,-67.0,-60.0,-90.0,-94.0,-90.0,-93.0,20.0,23.0,23.0,33.0,0
3732,BA:8C:B9:54:50:24,3827408,488282309,4691,6143170,3822717,482139139,0,8196,1630920,8175,1627563,21,3357,2306,14,5066,36,0,53,216660.0,130000.0,-49.0,-35.0,-42.0,-44.0,-43.0,-34.0,-41.0,-45.0,-90.0,-94.0,-90.0,-93.0,41.0,59.0,48.0,49.0,0
3733,92:69:1D:31:68:E9,3826345,485646280,3627,3507081,3822718,482139199,0,3948,989531,3838,964916,110,24615,1922,6,3753,79,0,32,216660.0,130000.0,-52.0,-50.0,-45.0,-46.0,-52.0,-50.0,-44.0,-46.0,-90.0,-94.0,-90.0,-93.0,38.0,44.0,45.0,47.0,0
3734,CC:2F:71:3F:1F:24,4438764,1175701871,616046,693562672,3822718,482139199,37,509453,561530595,508840,561456785,613,73810,491772,10,616283,55102,34,447,130000.0,43333.0,-67.0,-65.0,-70.0,-67.0,-67.0,-65.0,-70.0,-67.0,-90.0,-94.0,-90.0,-93.0,23.0,29.0,20.0,26.0,0
3735,CC:2F:71:3E:C5:1F,3823454,482229071,736,89872,3822718,482139199,0,3103,260304,2562,196022,541,64282,779,8,1067,18,0,34,130000.0,39000.0,-70.0,-71.0,-67.0,-60.0,-70.0,-71.0,-67.0,-60.0,-90.0,-94.0,-90.0,-93.0,20.0,23.0,23.0,33.0,0
3736,BA:8C:B9:54:50:24,3827409,488282369,4691,6143170,3822718,482139199,0,8196,1630920,8175,1627563,21,3357,2306,14,5066,36,0,53,216660.0,130000.0,-49.0,-35.0,-42.0,-44.0,-43.0,-34.0,-41.0,-45.0,-90.0,-94.0,-90.0,-93.0,41.0,59.0,48.0,49.0,0
3737,92:69:1D:31:68:E9,3826353,485647088,3627,3507081,3822726,482140007,0,3948,989531,3838,964916,110,24615,1922,6,3753,79,0,32,216660.0,130000.0,-52.0,-50.0,-45.0,-46.0,-52.0,-50.0,-44.0,-46.0,-90.0,-94.0,-90.0,-93.0,38.0,44.0,45.0,47.0,0
3738,CC:2F:71:3F:1F:24,4438816,1175717367,616090,693577360,3822726,482140007,37,509479,561535575,508866,561461765,613,73810,491798,10,616327,55123,34,447,144444.0,39000.0,-67.0,-65.0,-70.0,-67.0,-67.0,-65.0,-70.0,-67.0,-90.0,-94.0,-90.0,-93.0,23.0,29.0,20.0,26.0,0
3739,CC:2F:71:3E:C5:1F,3823462,482229879,736,89872,3822726,482140007,0,3103,260304,2562,196022,541,64282,779,8,1067,18,0,34,130000.0,39000.0,-70.0,-71.0,-67.0,-60.0,-70.0,-71.0,-67.0,-60.0,-90.0,-94.0,-90.0,-93.0,20.0,23.0,23.0,33.0,0
3740,BA:8C:B9:54:50:24,3827417,488283177,4691,6143170,3822726,482140007,0,8196,1630920,8175,1627563,21,3357,2306,14,5066,36,0,53,216660.0,130000.0,-49.0,-35.0,-42.0,-44.0,-43.0,-34.0,-41.0,-45.0,-90.0,-94.0,-90.0,-93.0,41.0,59.0,48.0,49.0,0
3741,92:69:1D:31:68:E9,3826354,485647361,3627,3507081,3822727,482140280,0,3948,989531,3838,964916,110,24615,1922,6,3753,79,0,32,216660.0,130000.0,-52.0,-50.0,-45.0,-46.0,-52.0,-50.0,-44.0,-46.0,-90.0,-94.0,-90.0,-93.0,38.0,44.0,45.0,47.0,0
3742,CC:2F:71:3F:1F:24,4438862,1175732452,616135,693592172,3822727,482140280,37,509504,561540379,508891,561466569,613,73810,491823,10,616372,55140,34,447,130000.0,43333.0,-67.0,-65.0,-70.0,-67.0,-67.0,-65.0,-70.0,-67.0,-90.0,-94.0,-90.0,-93.0,23.0,29.0,20.0,26.0,0
3743,CC:2F:71:3E:C5:1F,3823463,482230152,736,89872,3822727,482140280,0,3103,260304,2562,196022,541,64282,779,8,1067,18,0,34,130000.0,39000.0,-70.0,-71.0,-67.0,-60.0,-70.0,-71.0,-67.0,-60.0,-90.0,-94.0,-90.0,-93.0,20.0,23.0,23.0,33.0,0
3744,BA:8C:B9:54:50:24,3827418,488283450,4691,6143170,3822727,482140280,0,8196,1630920,8175,1627563,21,3357,2306,14,5066,36,0,53,216660.0,130000.0,-49.0,-35.0,-42.0,-44.0,-43.0,-34.0,-41.0,-45.0,-90.0,-94.0,-90.0,-93.0,41.0,59.0,48.0,49.0,0
3745,92:69:1D:31:68:E9,3826363,485648229,3627,3507081,3822736,482141148,0,3948,989531,3838,964916,110,24615,1922,6,3753,79,0,32,216660.0,130000.0,-52.0,-50.0,-45.0,-46.0,-52.0,-50.0,-44.0,-46.0,-90.0,-94.0,-90.0,-93.0,38.0,44.0,45.0,47.0,0
3746,CC:2F:71:3F:1F:24,4438916,1175748132,616180,693606984,3822736,482141148,37,509529,561545183,508916,561471373,613,73810,491848,10,616417,55159,34,447,117000.0,39000.0,-67.0,-65.0,-71.0,-67.0,-67.0,-65.0,-70.0,-67.0,-90.0,-94.0,-90.0,-93.0,23.0,29.0,19.0,26.0,0
3747,CC:2F:71:3E:C5:1F,3823472,482231020,736,89872,3822736,482141148,0,3103,260304,2562,196022,541,64282,779,8,1067,18,0,34,130000.0,39000.0,-70.0,-71.0,-67.0,-60.0,-70.0,-71.0,-67.0,-60.0,-90.0,-94.0,-90.0,-93.0,20.0,23.0,23.0,33.0,0
3748,BA:8C:B9:54:50:24,3827427,488284318,4691,6143170,3822736,482141148,0,8196,1630920,8175,1627563,21,3357,2306,14,5066,36,0,53,216660.0,130000.0,-49.0,-35.0,-42.0,-44.0,-43.0,-34.0,-41.0,-45.0,-90.0,-94.0,-90.0,-93.0,41.0,59.0,48.0,49.0,0
3749,92:69:1D:31:68:E9,3826363,485648229,3627,3507081,3822736,482141148,0,3948,989531,3838,964916,110,24615,1922,6,3753,79,0,32,216660.0,130000.0,-52.0,-50.0,-45.0,-46.0,-52.0,-50.0,-44.0,-46.0,-90.0,-94.0,-90.0,-93.0,38.0,44.0,45.0,47.0,0
3750,CC:2F:71:3F:1F:24,4438960,1175762820,616224,693621672,3822736,482141148,37,509554,561549987,508941,561476177,613,73810,491873,10,616461,55165,34,447,130000.0,43333.0,-67.0,-65.0,-71.0,-67.0,-67.0,-65.0,-70.0,-67.0,-90.0,-94.0,-90.0,-93.0,23.0,29.0,19.0,26.0,0
3751,CC:2F:71:3E:C5:1F,3823472,482231020,736,89872,3822736,482141148,0,3103,260304,2562,196022,541,64282,779,8,1067,18,0,34,130000.0,39000.0,-70.0,-71.0,-67.0,-60.0,-70.0,-71.0,-67.0,-60.0,-90.0,-94.0,-90.0,-93.0,20.0,23.0,23.0,33.0,0
3752,BA:8C:B9:54:50:24,3827427,488284318,4691,6143170,3822736,482141148,0,8196,1630920,8175,1627563,21,3357,2306,14,5066,36,0,53,216660.0,130000.0,-49.0,-35.0,-42.0,-44.0,-43.0,-34.0,-41.0,-45.0,-90.0,-94.0,-90.0,-93.0,41.0,59.0,48.0,49.0,0
3753,92:69:1D:31:68:E9,3826372,485649097,3627,3507081,3822745,482142016,0,3948,989531,3838,964916,110,24615,1922,6,3753,79,0,32,216660.0,130000.0,-52.0,-50.0,-45.0,-46.0,-52.0,-50.0,-44.0,-46.0,-90.0,-94.0,-90.0,-93.0,38.0,44.0,45.0,47.0,0
3754,CC:2F:71:3F:1F:24,4439012,1175778364,616267,693636348,3822745,482142016,37,509579,561554791,508966,561480981,613,73810,491898,10,616504,55167,34,447,130000.0,43333.0,-67.0,-65.0,-70.0,-68.0,-67.0,-65.0,-70.0,-67.0,-90.0,-94.0,-90.0,-93.0,23.0,29.0,20.0,25.0,0
3755,CC:2F:71:3E:C5:1F,3823481,482231888,736,89872,3822745,482142016,0,3103,260304,2562,196022,541,64282,779,8,1067,18,0,34,130000.0,39000.0,-70.0,-71.0,-67.0,-60.0,-70.0,-71.0,-67.0,-60.0,-90.0,-94.0,-90.0,-93.0,20.0,23.0,23.0,33.0,0
3756,BA:8C:B9:54:50:24,3827436,488285186,4691,6143170,3822745,482142016,0,8196,1630920,8175,1627563,21,3357,2306,14,5066,36,0,53,216660.0,130000.0,-49.0,-35.0,-42.0,-44.0,-43.0,-34.0,-41.0,-45.0,-90.0,-94.0,-90.0,-93.0,41.0,59.0,48.0,49.0,0
3757,92:69:1D:31:68:E9,3826372,485649097,3627,3507081,3822745,482142016,0,3948,989531,3838,964916,110,24615,1922,6,3753,79,0,32,216660.0,130000.0,-52.0,-50.0,-45.0,-46.0,-52.0,-50.0,-44.0,-46.0,-90.0,-93.0,-90.0,-93.0,38.0,43.0,45.0,47.0,0
3758,CC:2F:71:3F:1F:24,4439056,1175793052,616311,693651036,3822745,482142016,37,509605,561559711,508992,561485901,613,73810,491924,10,616548,55182,34,447,117000.0,39000.0,-67.0,-65.0,-70.0,-67.0,-67.0,-65.0,-70.0,-67.0,-90.0,-93.0,-90.0,-93.0,23.0,28.0,20.0,26.0,0
3759,CC:2F:71:3E:C5:1F,3823481,482231888,736,89872,3822745,482142016,0,3103,260304,2562,196022,541,64282,779,8,1067,18,0,34,130000.0,39000.0,-70.0,-71.0,-67.0,-60.0,-70.0,-71.0,-67.0,-60.0,-90.0,-93.0,-90.0,-93.0,20.0,22.0,23.0,33.0,0
3760,BA:8C:B9:54:50:24,3827436,488285186,4691,6143170,3822745,482142016,0,8196,1630920,8175,1627563,21,3357,2306,14,5066,36,0,53,216660.0,130000.0,-49.0,-35.0,-42.0,-44.0,-43.0,-34.0,-41.0,-45.0,-90.0,-93.0,-90.0,-93.0,41.0,58.0,48.0,49.0,0
3761,92:69:1D:31:68:E9,3826380,485649905,3627,3507081,3822753,482142824,0,3948,989531,3838,964916,110,24615,1922,6,3753,79,0,32,216660.0,130000.0,-52.0,-50.0,-45.0,-46.0,-52.0,-50.0,-44.0,-46.0,-90.0,-93.0,-90.0,-93.0,38.0,43.0,45.0,47.0,0
3762,CC:2F:71:3F:1F:24,4439108,1175808492,616355,693665668,3822753,482142824,37,509630,561564515,509017,561490705,613,73810,491949,10,616592,55186,34,447,130000.0,39000.0,-67.0,-65.0,-70.0,-67.0,-67.0,-65.0,-70.0,-67.0,-90.0,-93.0,-90.0,-93.0,23.0,28.0,20.0,26.0,0
3763,CC:2F:71:3E:C5:1F,3823489,482232696,736,89872,3822753,482142824,0,3103,260304,2562,196022,541,64282,779,8,1067,18,0,34,130000.0,39000.0,-70.0,-71.0,-67.0,-60.0,-70.0,-71.0,-67.0,-60.0,-90.0,-93.0,-90.0,-93.0,20.0,22.0,23.0,33.0,0
3764,BA:8C:B9:54:50:24,3827444,488285994,4691,6143170,3822753,482142824,0,8196,1630920,8175,1627563,21,3357,2306,14,5066,36,0,53,216660.0,130000.0,-49.0,-35.0,-42.0,-44.0,-43.0,-34.0,-41.0,-45.0,-90.0,-93.0,-90.0,-93.0,41.0,58.0,48.0,49.0,0
3765,92:69:1D:31:68:E9,3826381,485649965,3627,3507081,3822754,482142884,0,3948,989531,3838,964916,110,24615,1922,6,3753,79,0,32,216660.0,130000.0,-52.0,-50.0,-45.0,-46.0,-52.0,-50.0,-44.0,-46.0,-90.0,-93.0,-90.0,-93.0,38.0,43.0,45.0,47.0,0
3766,CC:2F:71:3F:1F:24,4439154,1175823364,616400,693680480,3822754,482142884,37,509655,561569319,509042,561495509,613,73810,491974,10,616637,55208,34,447,130000.0,39000.0,-67.0,-65.0,-70.0,-67.0,-67.0,-65.0,-70.0,-67.0,-90.0,-93.0,-90.0,-93.0,23.0,28.0,20.0,26.0,0
3767,CC:2F:71:3E:C5:1F,3823490,482232756,736,89872,3822754,482142884,0,3103,260304,2562,196022,541,64282,779,8,1067,18,0,34,130000.0,39000.0,-70.0,-71.0,-67.0,-60.0,-70.0,-71.0,-67.0,-60.0,-90.0,-93.0,-90.0,-93.0,20.0,22.0,23.0,33.0,0
3768,BA:8C:B9:54:50:24,3827445,488286054,4691,6143170,3822754,482142884,0,8196,1630920,8175,1627563,21,3357,2306,14,5066,36,0,53,216660.0,130000.0,-49.0,-35.0,-42.0,-44.0,-43.0,-34.0,-41.0,-45.0,-90.0,-93.0,-90.0,-93.0,41.0,58.0,48.0,49.0,0
3769,92:69:1D:31:68:E9,3826389,485650773,3627,3507081,3822762,482143692,0,3948,989531,3838,964916,110,24615,1922,6,3753,79,0,32,216660.0,130000.0,-52.0,-50.0,-45.0,-46.0,-52.0,-50.0,-44.0,-46.0,-90.0,-93.0,-90.0,-93.0,38.0,43.0,45.0,47.0,0
3770,CC:2F:71:3F:1F:24,4439205,1175838680,616443,693694988,3822762,482143692,37,509681,561574263,509068,561500453,613,73810,492000,10,616680,55232,34,447,117000.0,39000.0,-67.0,-65.0,-71.0,-68.0,-67.0,-65.0,-70.0,-67.0,-90.0,-93.0,-90.0,-93.0,23.0,28.0,19.0,25.0,0
3771,CC:2F:71:3E:C5:1F,3823498,482233564,736,89872,3822762,482143692,0,3103,260304,2562,196022,541,64282,779,8,1067,18,0,34,130000.0,39000.0,-70.0,-71.0,-67.0,-60.0,-70.0,-71.0,-67.0,-60.0,-90.0,-93.0,-90.0,-93.0,20.0,22.0,23.0,33.0,0
3772,BA:8C:B9:54:50:24,3827453,488286862,4691,6143170,3822762,482143692,0,8196,1630920,8175,1627563,21,3357,2306,14,5066,36,0,53,216660.0,130000.0,-49.0,-35.0,-42.0,-44.0,-43.0,-34.0,-41.0,-45.0,-90.0,-93.0,-90.0,-93.0,41.0,58.0,48.0,49.0,0
3773,92:69:1D:31:68:E9,3826389,485650773,3627,3507081,3822762,482143692,0,3948,989531,3838,964916,110,24615,1922,6,3753,79,0,32,216660.0,130000.0,-52.0,-50.0,-45.0,-46.0,-52.0,-50.0,-44.0,-46.0,-90.0,-93.0,-90.0,-93.0,38.0,43.0,45.0,47.0,0
3774,CC:2F:71:3F:1F:24,4439250,1175853492,616488,693709800,3822762,482143692,37,509708,561579323,509095,561505513,613,73810,492027,10,616725,55234,34,447,130000.0,43333.0,-67.0,-65.0,-70.0,-67.0,-67.0,-65.0,-70.0,-67.0,-90.0,-93.0,-90.0,-93.0,23.0,28.0,20.0,26.0,0
3775,CC:2F:71:3E:C5:1F,3823498,482233564,736,89872,3822762,482143692,0,3103,260304,2562,196022,541,64282,779,8,1067,18,0,34,130000.0,39000.0,-70.0,-71.0,-67.0,-60.0,-70.0,-71.0,-67.0,-60.0,-90.0,-93.0,-90.0,-93.0,20.0,22.0,23.0,33.0,0
3776,BA:8C:B9:54:50:24,3827453,488286862,4691,6143170,3822762,482143692,0,8196,1630920,8175,1627563,21,3357,2306,14,5066,36,0,53,216660.0,130000.0,-49.0,-35.0,-42.0,-44.0,-43.0,-34.0,-41.0,-45.0,-90.0,-93.0,-90.0,-93.0,41.0,58.0,48.0,49.0,0
3777,92:69:1D:31:68:E9,3826398,485651641,3627,3507081,3822771,482144560,0,3949,989599,3839,964984,110,24615,1922,6,3753,79,0,32,216660.0,130000.0,-51.0,-47.0,-42.0,-49.0,-52.0,-49.0,-44.0,-47.0,-90.0,-93.0,-90.0,-93.0,39.0,46.0,48.0,44.0,0
3778,CC:2F:71:3F:1F:24,4439301,1175868856,616530,693724296,3822771,482144560,37,509733,561584127,509120,561510317,613,73810,492052,10,616767,55251,34,447,130000.0,39000.0,-67.0,-65.0,-70.0,-67.0,-67.0,-65.0,-70.0,-67.0,-90.0,-93.0,-90.0,-93.0,23.0,28.0,20.0,26.0,0
3779,CC:2F:71:3E:C5:1F,3823507,482234432,736,89872,3822771,482144560,0,3103,260304,2562,196022,541,64282,779,8,1067,18,0,34,130000.0,39000.0,-70.0,-71.0,-67.0,-60.0,-70.0,-71.0,-67.0,-60.0,-90.0,-93.0,-90.0,-93.0,20.0,22.0,23.0,33.0,0
3780,BA:8C:B9:54:50:24,3827462,488287730,4691,6143170,3822771,482144560,0,8196,1630920,8175,1627563,21,3357,2306,14,5066,36,0,53,216660.0,130000.0,-49.0,-35.0,-42.0,-44.0,-43.0,-34.0,-41.0,-45.0,-90.0,-93.0,-90.0,-93.0,41.0,58.0,48.0,49.0,0
3781,92:69:1D:31:68:E9,3826398,485651641,3627,3507081,3822771,482144560,0,3949,989599,3839,964984,110,24615,1922,6,3753,79,0,32,216660.0,130000.0,-51.0,-47.0,-42.0,-49.0,-52.0,-49.0,-44.0,-47.0,-90.0,-93.0,-90.0,-93.0,39.0,46.0,48.0,44.0,0
3782,CC:2F:71:3F:1F:24,4439345,1175883544,616574,693738984,3822771,482144560,37,509759,561589047,509146,561515237,613,73810,492078,10,616811,55261,34,447,130000.0,43333.0,-67.0,-65.0,-70.0,-67.0,-67.0,-65.0,-70.0,-67.0,-90.0,-93.0,-90.0,-93.0,23.0,28.0,20.0,26.0,0
3783,CC:2F:71:3E:C5:1F,3823507,482234432,736,89872,3822771,482144560,0,3103,260304,2562,196022,541,64282,779,8,1067,18,0,34,130000.0,39000.0,-70.0,-71.0,-67.0,-60.0,-70.0,-71.0,-67.0,-60.0,-90.0,-93.0,-90.0,-93.0,20.0,22.0,23.0,33.0,0
3784,BA:8C:B9:54:50:24,3827462,488287730,4691,6143170,3822771,482144560,0,8196,1630920,8175,1627563,21,3357,2306,14,5066,36,0,53,216660.0,130000.0,-49.0,-35.0,-42.0,-44.0,-43.0,-34.0,-41.0,-45.0,-90.0,-93.0,-90.0,-93.0,41.0,58.0,48.0,49.0,0
3785,92:69:1D:31:68:E9,3826407,485652509,3627,3507081,3822780,482145428,0,3949,989599,3839,964984,110,24615,1922,6,3753,79,0,32,216660.0,130000.0,-51.0,-47.0,-42.0,-49.0,-52.0,-49.0,-44.0,-47.0,-90.0,-93.0,-90.0,-93.0,39.0,46.0,48.0,44.0,0
3786,CC:2F:71:3F:1F:24,4439399,1175899218,616619,693753790,3822780,482145428,37,509786,561594131,509173,561520321,613,73810,492105,10,616856,55269,34,447,130000.0,39000.0,-67.0,-65.0,-70.0,-67.0,-67.0,-65.0,-70.0,-67.0,-90.0,-93.0,-90.0,-93.0,23.0,28.0,20.0,26.0,0
3787,CC:2F:71:3E:C5:1F,3823516,482235300,736,89872,3822780,482145428,0,3103,260304,2562,196022,541,64282,779,8,1067,18,0,34,130000.0,39000.0,-70.0,-71.0,-67.0,-60.0,-70.0,-71.0,-67.0,-60.0,-90.0,-93.0,-90.0,-93.0,20.0,22.0,23.0,33.0,0
3788,BA:8C:B9:54:50:24,3827479,488291508,4691,6143170,3822788,482148338,0,8196,1630920,8175,1627563,21,3357,2306,14,5066,36,0,53,216660.0,130000.0,-49.0,-35.0,-42.0,-44.0,-43.0,-34.0,-41.0,-45.0,-90.0,-93.0,-90.0,-93.0,41.0,58.0,48.0,49.0,0
3789,92:69:1D:31:68:E9,3826416,485655535,3628,3507197,3822788,482148338,0,3951,989735,3841,965120,110,24615,1922,6,3754,79,0,32,216660.0,130000.0,-51.0,-47.0,-42.0,-49.0,-51.0,-49.0,-43.0,-47.0,-90.0,-93.0,-90.0,-93.0,39.0,46.0,48.0,44.0,0
3790,CC:2F:71:3F:1F:24,4439452,1175916932,616664,693768594,3822788,482148338,37,509813,561599191,509200,561525381,613,73810,492132,10,616901,55289,34,447,130000.0,39000.0,-67.0,-65.0,-70.0,-67.0,-67.0,-65.0,-70.0,-67.0,-90.0,-93.0,-90.0,-93.0,23.0,28.0,20.0,26.0,0
3791,CC:2F:71:3E:C5:1F,3823525,482238326,737,89988,3822788,482148338,0,3105,260444,2564,196162,541,64282,779,8,1068,18,0,34,130000.0,39000.0,-70.0,-71.0,-67.0,-60.0,-70.0,-71.0,-67.0,-60.0,-90.0,-93.0,-90.0,-93.0,20.0,22.0,23.0,33.0,0
3792,BA:8C:B9:54:50:24,3827480,488291624,4692,6143286,3822788,482148338,0,8202,1631328,8181,1627971,21,3357,2306,14,5067,36,0,53,216660.0,130000.0,-50.0,-35.0,-43.0,-44.0,-42.0,-34.0,-42.0,-46.0,-90.0,-93.0,-90.0,-93.0,40.0,58.0,47.0,49.0,0
3793,92:69:1D:31:68:E9,3826425,485656616,3628,3507197,3822797,482149419,0,3951,989735,3841,965120,110,24615,1922,6,3754,79,0,32,216660.0,130000.0,-51.0,-47.0,-42.0,-49.0,-51.0,-49.0,-43.0,-47.0,-90.0,-93.0,-90.0,-93.0,39.0,46.0,48.0,44.0,0
3794,CC:2F:71:3F:1F:24,4439505,1175932701,616708,693783282,3822797,482149419,37,509838,561603995,509225,561530185,613,73810,492157,10,616945,55310,34,447,130000.0,39000.0,-67.0,-65.0,-70.0,-68.0,-67.0,-65.0,-70.0,-67.0,-90.0,-93.0,-90.0,-93.0,23.0,28.0,20.0,25.0,0
3795,CC:2F:71:3E:C5:1F,3823534,482239407,737,89988,3822797,482149419,0,3105,260444,2564,196162,541,64282,779,8,1068,18,0,34,130000.0,39000.0,-70.0,-71.0,-67.0,-60.0,-70.0,-71.0,-67.0,-60.0,-90.0,-93.0,-90.0,-93.0,20.0,22.0,23.0,33.0,0
3796,BA:8C:B9:54:50:24,3827489,488292705,4692,6143286,3822797,482149419,0,8202,1631328,8181,1627971,21,3357,2306,14,5067,36,0,53,216660.0,130000.0,-50.0,-35.0,-43.0,-44.0,-42.0,-34.0,-42.0,-46.0,-90.0,-93.0,-90.0,-93.0,40.0,58.0,47.0,49.0,0
3797,92:69:1D:31:68:E9,3826426,485656676,3628,3507197,3822798,482149479,0,3951,989735,3841,965120,110,24615,1922,6,3754,79,0,32,216660.0,130000.0,-51.0,-47.0,-42.0,-49.0,-51.0,-49.0,-43.0,-47.0,-90.0,-93.0,-89.0,-93.0,39.0,46.0,47.0,44.0,0
3798,CC:2F:71:3F:1F:24,4439550,1175947449,616752,693797970,3822798,482149479,37,509865,561609055,509252,561535245,613,73810,492184,10,616989,55320,34,447,130000.0,43333.0,-67.0,-65.0,-71.0,-67.0,-67.0,-65.0,-70.0,-67.0,-90.0,-93.0,-89.0,-93.0,23.0,28.0,18.0,26.0,0
3799,CC:2F:71:3E:C5:1F,3823535,482239467,737,89988,3822798,482149479,0,3105,260444,2564,196162,541,64282,779,8,1068,18,0,34,130000.0,39000.0,-70.0,-71.0,-67.0,-60.0,-70.0,-71.0,-67.0,-60.0,-90.0,-93.0,-89.0,-93.0,20.0,22.0,22.0,33.0,0
3800,BA:8C:B9:54:50:24,3827490,488292765,4692,6143286,3822798,482149479,0,8202,1631328,8181,1627971,21,3357,2306,14,5067,36,0,53,216660.0,130000.0,-50.0,-35.0,-43.0,-44.0,-42.0,-34.0,-42.0,-46.0,-90.0,-93.0,-89.0,-93.0,40.0,58.0,46.0,49.0,0
3801,92:69:1D:31:68:E9,3826434,485657484,3628,3507197,3822806,482150287,0,3951,989735,3841,965120,110,24615,1922,6,3754,79,0,32,216660.0,130000.0,-51.0,-47.0,-42.0,-49.0,-51.0,-49.0,-43.0,-47.0,-90.0,-93.0,-89.0,-93.0,39.0,46.0,47.0,44.0,0
3802,CC:2F:71:3F:1F:24,4439602,1175963001,616796,693812714,3822806,482150287,37,509891,561613999,509278,561540189,613,73810,492210,10,617033,55321,34,447,130000.0,43333.0,-67.0,-65.0,-71.0,-67.0,-67.0,-65.0,-70.0,-67.0,-90.0,-93.0,-89.0,-93.0,23.0,28.0,18.0,26.0,0
3803,CC:2F:71:3E:C5:1F,3823543,482240275,737,89988,3822806,482150287,0,3105,260444,2564,196162,541,64282,779,8,1068,18,0,34,130000.0,39000.0,-70.0,-71.0,-67.0,-60.0,-70.0,-71.0,-67.0,-60.0,-90.0,-93.0,-89.0,-93.0,20.0,22.0,22.0,33.0,0
3804,BA:8C:B9:54:50:24,3827498,488293573,4692,6143286,3822806,482150287,0,8202,1631328,8181,1627971,21,3357,2306,14,5067,36,0,53,216660.0,130000.0,-50.0,-35.0,-43.0,-44.0,-42.0,-34.0,-42.0,-46.0,-90.0,-93.0,-89.0,-93.0,40.0,58.0,46.0,49.0,0
3805,92:69:1D:31:68:E9,3826436,485657852,3628,3507197,3822808,482150655,0,3951,989735,3841,965120,110,24615,1922,6,3754,79,0,32,216660.0,130000.0,-51.0,-47.0,-42.0,-49.0,-51.0,-49.0,-43.0,-47.0,-90.0,-93.0,-89.0,-93.0,39.0,46.0,47.0,44.0,0
3806,CC:2F:71:3F:1F:24,4439651,1175978365,616842,693827650,3822809,482150715,37,509918,561619059,509305,561545249,613,73810,492237,10,617079,55334,34,447,117000.0,39000.0,-67.0,-65.0,-70.0,-67.0,-67.0,-65.0,-70.0,-67.0,-90.0,-93.0,-89.0,-93.0,23.0,28.0,19.0,26.0,0
3807,CC:2F:71:3E:C5:1F,3823546,482240703,737,89988,3822809,482150715,0,3105,260444,2564,196162,541,64282,779,8,1068,18,0,34,130000.0,39000.0,-70.0,-71.0,-67.0,-60.0,-70.0,-71.0,-67.0,-60.0,-90.0,-93.0,-89.0,-93.0,20.0,22.0,22.0,33.0,0
3808,BA:8C:B9:54:50:24,3827501,488294001,4692,6143286,3822809,482150715,0,8202,1631328,8181,1627971,21,3357,2306,14,5067,36,0,53,216660.0,130000.0,-50.0,-35.0,-43.0,-44.0,-42.0,-34.0,-42.0,-46.0,-90.0,-93.0,-89.0,-93.0,40.0,58.0,46.0,49.0,0
3809,92:69:1D:31:68:E9,3826445,485658720,3628,3507197,3822817,482151523,0,3951,989735,3841,965120,110,24615,1922,6,3754,79,0,32,216660.0,130000.0,-51.0,-47.0,-42.0,-49.0,-51.0,-49.0,-43.0,-47.0,-90.0,-93.0,-90.0,-93.0,39.0,46.0,48.0,44.0,0
3810,CC:2F:71:3F:1F:24,4439702,1175993737,616885,693842214,3822817,482151523,37,509945,561624119,509332,561550309,613,73810,492264,10,617121,55337,34,447,130000.0,43333.0,-67.0,-65.0,-70.0,-68.0,-67.0,-65.0,-70.0,-67.0,-90.0,-93.0,-90.0,-93.0,23.0,28.0,20.0,25.0,0
3811,CC:2F:71:3E:C5:1F,3823554,482241511,737,89988,3822817,482151523,0,3105,260444,2564,196162,541,64282,779,8,1068,18,0,34,130000.0,39000.0,-70.0,-71.0,-67.0,-60.0,-70.0,-71.0,-67.0,-60.0,-90.0,-93.0,-90.0,-93.0,20.0,22.0,23.0,33.0,0
3812,BA:8C:B9:54:50:24,3827509,488294809,4692,6143286,3822817,482151523,0,8202,1631328,8181,1627971,21,3357,2306,14,5067,36,0,53,216660.0,130000.0,-50.0,-35.0,-43.0,-44.0,-42.0,-34.0,-42.0,-46.0,-90.0,-93.0,-90.0,-93.0,40.0,58.0,47.0,49.0,0
3813,92:69:1D:31:68:E9,3826445,485658720,3628,3507197,3822817,482151523,0,3951,989735,3841,965120,110,24615,1922,6,3754,79,0,32,216660.0,130000.0,-51.0,-47.0,-42.0,-49.0,-51.0,-49.0,-43.0,-47.0,-90.0,-93.0,-90.0,-93.0,39.0,46.0,48.0,44.0,0
3814,CC:2F:71:3F:1F:24,4439745,1176008301,616928,693856778,3822817,482151523,37,509970,561628923,509357,561555113,613,73810,492289,10,617165,55367,34,447,144444.0,39000.0,-67.0,-65.0,-70.0,-67.0,-67.0,-65.0,-70.0,-67.0,-90.0,-93.0,-90.0,-93.0,23.0,28.0,20.0,26.0,0
3815,CC:2F:71:3E:C5:1F,3823554,482241511,737,89988,3822817,482151523,0,3105,260444,2564,196162,541,64282,779,8,1068,18,0,34,130000.0,39000.0,-70.0,-71.0,-67.0,-60.0,-70.0,-71.0,-67.0,-60.0,-90.0,-93.0,-90.0,-93.0,20.0,22.0,23.0,33.0,0
3816,BA:8C:B9:54:50:24,3827509,488294809,4692,6143286,3822817,482151523,0,8202,1631328,8181,1627971,21,3357,2306,14,5067,36,0,53,216660.0,130000.0,-50.0,-35.0,-43.0,-44.0,-42.0,-34.0,-42.0,-46.0,-90.0,-93.0,-90.0,-93.0,40.0,58.0,47.0,49.0,0
3817,92:69:1D:31:68:E9,3826454,485659588,3628,3507197,3822826,482152391,0,3951,989735,3841,965120,110,24615,1922,6,3754,79,0,32,216660.0,130000.0,-51.0,-47.0,-42.0,-49.0,-51.0,-49.0,-43.0,-47.0,-90.0,-93.0,-90.0,-93.0,39.0,46.0,48.0,44.0,0
3818,CC:2F:71:3F:1F:24,4439798,1176023857,616972,693871466,3822826,482152391,37,509996,561633843,509383,561560033,613,73810,492315,10,617209,55383,34,447,130000.0,43333.0,-67.0,-65.0,-70.0,-68.0,-67.0,-65.0,-70.0,-67.0,-90.0,-93.0,-90.0,-93.0,23.0,28.0,20.0,25.0,0
3819,CC:2F:71:3E:C5:1F,3823563,482242379,737,89988,3822826,482152391,0,3105,260444,2564,196162,541,64282,779,8,1068,18,0,34,130000.0,39000.0,-70.0,-71.0,-67.0,-60.0,-70.0,-71.0,-67.0,-60.0,-90.0,-93.0,-90.0,-93.0,20.0,22.0,23.0,33.0,0
3820,BA:8C:B9:54:50:24,3827518,488295677,4692,6143286,3822826,482152391,0,8202,1631328,8181,1627971,21,3357,2306,14,5067,36,0,53,216660.0,130000.0,-50.0,-35.0,-43.0,-44.0,-42.0,-34.0,-42.0,-46.0,-90.0,-93.0,-90.0,-93.0,40.0,58.0,47.0,49.0,0
3821,92:69:1D:31:68:E9,3826455,485659650,3628,3507197,3822827,482152453,0,3951,989735,3841,965120,110,24615,1922,6,3754,79,0,32,216660.0,130000.0,-51.0,-47.0,-42.0,-49.0,-51.0,-49.0,-43.0,-47.0,-90.0,-93.0,-90.0,-93.0,39.0,46.0,48.0,44.0,0
3822,CC:2F:71:3F:1F:24,4439843,1176038719,617016,693886266,3822827,482152453,37,510023,561638905,509409,561564977,614,73928,492342,10,617253,55388,34,447,130000.0,43333.0,-67.0,-65.0,-71.0,-68.0,-67.0,-65.0,-70.0,-67.0,-90.0,-93.0,-90.0,-93.0,23.0,28.0,19.0,25.0,0
3823,CC:2F:71:3E:C5:1F,3823564,482242441,737,89988,3822827,482152453,0,3105,260444,2564,196162,541,64282,779,8,1068,18,0,34,130000.0,39000.0,-70.0,-71.0,-67.0,-60.0,-70.0,-71.0,-67.0,-60.0,-90.0,-93.0,-90.0,-93.0,20.0,22.0,23.0,33.0,0
3824,BA:8C:B9:54:50:24,3827519,488295739,4692,6143286,3822827,482152453,0,8202,1631328,8181,1627971,21,3357,2306,14,5067,36,0,53,216660.0,130000.0,-50.0,-35.0,-43.0,-44.0,-42.0,-34.0,-42.0,-46.0,-90.0,-93.0,-90.0,-93.0,40.0,58.0,47.0,49.0,0
3825,92:69:1D:31:68:E9,3826463,485660458,3628,3507197,3822835,482153261,0,3951,989735,3841,965120,110,24615,1922,6,3754,79,0,32,216660.0,130000.0,-51.0,-47.0,-42.0,-49.0,-51.0,-49.0,-43.0,-47.0,-90.0,-93.0,-89.0,-93.0,39.0,46.0,47.0,44.0,0
3826,CC:2F:71:3F:1F:24,4439895,1176054215,617060,693900954,3822835,482153261,37,510048,561643709,509434,561569781,614,73928,492367,10,617297,55405,34,447,117000.0,39000.0,-67.0,-65.0,-71.0,-67.0,-67.0,-65.0,-70.0,-67.0,-90.0,-93.0,-89.0,-93.0,23.0,28.0,18.0,26.0,0
3827,CC:2F:71:3E:C5:1F,3823572,482243249,737,89988,3822835,482153261,0,3105,260444,2564,196162,541,64282,779,8,1068,18,0,34,130000.0,39000.0,-70.0,-71.0,-67.0,-60.0,-70.0,-71.0,-67.0,-60.0,-90.0,-93.0,-89.0,-93.0,20.0,22.0,22.0,33.0,0
3828,BA:8C:B9:54:50:24,3827527,488296547,4692,6143286,3822835,482153261,0,8202,1631328,8181,1627971,21,3357,2306,14,5067,36,0,53,216660.0,130000.0,-50.0,-35.0,-43.0,-44.0,-42.0,-34.0,-42.0,-46.0,-90.0,-93.0,-89.0,-93.0,40.0,58.0,46.0,49.0,0
3829,92:69:1D:31:68:E9,3826464,485660518,3628,3507197,3822836,482153321,0,3951,989735,3841,965120,110,24615,1922,6,3754,79,0,32,216660.0,130000.0,-51.0,-47.0,-42.0,-49.0,-51.0,-49.0,-43.0,-47.0,-90.0,-93.0,-89.0,-93.0,39.0,46.0,47.0,44.0,0
3830,CC:2F:71:3F:1F:24,4439939,1176068777,617103,693915456,3822836,482153321,37,510076,561648861,509462,561574933,614,73928,492395,10,617340,55414,34,447,130000.0,39000.0,-67.0,-65.0,-70.0,-68.0,-67.0,-65.0,-70.0,-67.0,-90.0,-93.0,-89.0,-93.0,23.0,28.0,19.0,25.0,0
3831,CC:2F:71:3E:C5:1F,3823573,482243309,737,89988,3822836,482153321,0,3105,260444,2564,196162,541,64282,779,8,1068,18,0,34,130000.0,39000.0,-70.0,-71.0,-67.0,-60.0,-70.0,-71.0,-67.0,-60.0,-90.0,-93.0,-89.0,-93.0,20.0,22.0,22.0,33.0,0
3832,BA:8C:B9:54:50:24,3827528,488296607,4692,6143286,3822836,482153321,0,8202,1631328,8181,1627971,21,3357,2306,14,5067,36,0,53,216660.0,130000.0,-50.0,-35.0,-43.0,-44.0,-42.0,-34.0,-42.0,-46.0,-90.0,-93.0,-89.0,-93.0,40.0,58.0,46.0,49.0,0
3833,92:69:1D:31:68:E9,3826473,485661388,3628,3507197,3822845,482154191,0,3951,989735,3841,965120,110,24615,1922,6,3754,79,0,32,216660.0,130000.0,-51.0,-47.0,-42.0,-49.0,-51.0,-49.0,-43.0,-47.0,-90.0,-93.0,-89.0,-93.0,39.0,46.0,47.0,44.0,0
3834,CC:2F:71:3F:1F:24,4439992,1176084335,617147,693930144,3822845,482154191,37,510101,561653665,509487,561579737,614,73928,492420,10,617384,55429,34,447,130000.0,39000.0,-67.0,-65.0,-70.0,-67.0,-67.0,-65.0,-70.0,-67.0,-90.0,-93.0,-89.0,-93.0,23.0,28.0,19.0,26.0,0
3835,CC:2F:71:3E:C5:1F,3823582,482244179,737,89988,3822845,482154191,0,3107,260632,2565,196232,542,64400,780,8,1068,18,0,34,130000.0,39000.0,-70.0,-71.0,-68.0,-60.0,-70.0,-71.0,-67.0,-60.0,-90.0,-93.0,-89.0,-93.0,20.0,22.0,21.0,33.0,0
3836,BA:8C:B9:54:50:24,3827537,488297477,4692,6143286,3822845,482154191,0,8202,1631328,8181,1627971,21,3357,2306,14,5067,36,0,53,216660.0,130000.0,-50.0,-35.0,-43.0,-44.0,-42.0,-34.0,-42.0,-46.0,-90.0,-93.0,-89.0,-93.0,40.0,58.0,46.0,49.0,0
3837,92:69:1D:31:68:E9,3826474,485661448,3628,3507197,3822846,482154251,0,3951,989735,3841,965120,110,24615,1922,6,3754,79,0,32,216660.0,130000.0,-51.0,-47.0,-42.0,-49.0,-51.0,-49.0,-43.0,-47.0,-90.0,-93.0,-89.0,-93.0,39.0,46.0,47.0,44.0,0
3838,CC:2F:71:3F:1F:24,4440038,1176099263,617192,693945012,3822846,482154251,37,510126,561658469,509512,561584541,614,73928,492445,10,617429,55434,34,447,130000.0,43333.0,-67.0,-65.0,-70.0,-68.0,-67.0,-65.0,-70.0,-67.0,-90.0,-93.0,-89.0,-93.0,23.0,28.0,19.0,25.0,0
3839,CC:2F:71:3E:C5:1F,3823583,482244239,737,89988,3822846,482154251,0,3107,260632,2565,196232,542,64400,780,8,1068,18,0,34,130000.0,39000.0,-70.0,-71.0,-68.0,-60.0,-70.0,-71.0,-67.0,-60.0,-90.0,-93.0,-89.0,-93.0,20.0,22.0,21.0,33.0,0
3840,BA:8C:B9:54:50:24,3827538,488297537,4692,6143286,3822846,482154251,0,8202,1631328,8181,1627971,21,3357,2306,14,5067,36,0,53,216660.0,130000.0,-50.0,-35.0,-43.0,-44.0,-42.0,-34.0,-42.0,-46.0,-90.0,-93.0,-89.0,-93.0,40.0,58.0,46.0,49.0,0
3841,92:69:1D:31:68:E9,3826482,485662256,3628,3507197,3822854,482155059,0,3951,989735,3841,965120,110,24615,1922,6,3754,79,0,32,216660.0,130000.0,-51.0,-47.0,-42.0,-49.0,-51.0,-49.0,-43.0,-47.0,-90.0,-93.0,-89.0,-93.0,39.0,46.0,47.0,44.0,0
3842,CC:2F:71:3F:1F:24,4440091,1176114883,617237,693959824,3822854,482155059,37,510154,561663645,509540,561589717,614,73928,492473,10,617474,55449,34,447,117000.0,39000.0,-67.0,-65.0,-70.0,-67.0,-66.0,-65.0,-70.0,-67.0,-90.0,-93.0,-89.0,-93.0,23.0,28.0,19.0,26.0,0
3843,CC:2F:71:3E:C5:1F,3823591,482245047,737,89988,3822854,482155059,0,3107,260632,2565,196232,542,64400,780,8,1068,18,0,34,130000.0,39000.0,-70.0,-71.0,-68.0,-60.0,-70.0,-71.0,-67.0,-60.0,-90.0,-93.0,-89.0,-93.0,20.0,22.0,21.0,33.0,0
3844,BA:8C:B9:54:50:24,3827546,488298345,4692,6143286,3822854,482155059,0,8202,1631328,8181,1627971,21,3357,2306,14,5067,36,0,53,216660.0,130000.0,-50.0,-35.0,-43.0,-44.0,-42.0,-34.0,-42.0,-46.0,-90.0,-93.0,-89.0,-93.0,40.0,58.0,46.0,49.0,0
3845,92:69:1D:31:68:E9,3826483,485662529,3628,3507197,3822855,482155332,0,3951,989735,3841,965120,110,24615,1922,6,3754,79,0,32,216660.0,130000.0,-51.0,-47.0,-42.0,-49.0,-51.0,-49.0,-43.0,-47.0,-90.0,-93.0,-89.0,-93.0,39.0,46.0,47.0,44.0,0
3846,CC:2F:71:3F:1F:24,4440136,1176129844,617281,693974512,3822855,482155332,37,510180,561668589,509566,561594661,614,73928,492499,10,617518,55455,34,447,130000.0,43333.0,-67.0,-65.0,-70.0,-67.0,-67.0,-65.0,-70.0,-67.0,-90.0,-93.0,-89.0,-93.0,23.0,28.0,19.0,26.0,0
3847,CC:2F:71:3E:C5:1F,3823592,482245320,737,89988,3822855,482155332,0,3107,260632,2565,196232,542,64400,780,8,1068,18,0,34,130000.0,39000.0,-70.0,-71.0,-68.0,-60.0,-70.0,-71.0,-67.0,-60.0,-90.0,-93.0,-89.0,-93.0,20.0,22.0,21.0,33.0,0
3848,BA:8C:B9:54:50:24,3827547,488298618,4692,6143286,3822855,482155332,0,8202,1631328,8181,1627971,21,3357,2306,14,5067,36,0,53,216660.0,130000.0,-50.0,-35.0,-43.0,-44.0,-42.0,-34.0,-42.0,-46.0,-90.0,-93.0,-89.0,-93.0,40.0,58.0,46.0,49.0,0
3849,92:69:1D:31:68:E9,3826492,485663397,3628,3507197,3822864,482156200,0,3951,989735,3841,965120,110,24615,1922,6,3754,79,0,32,216660.0,130000.0,-51.0,-47.0,-42.0,-49.0,-51.0,-49.0,-43.0,-47.0,-90.0,-93.0,-89.0,-93.0,39.0,46.0,47.0,44.0,0
3850,CC:2F:71:3F:1F:24,4440188,1176145214,617324,693989014,3822864,482156200,37,510205,561673393,509591,561599465,614,73928,492524,10,617561,55477,34,447,144444.0,43333.0,-67.0,-65.0,-70.0,-68.0,-67.0,-65.0,-70.0,-67.0,-90.0,-93.0,-89.0,-93.0,23.0,28.0,19.0,25.0,0
3851,CC:2F:71:3E:C5:1F,3823601,482246188,737,89988,3822864,482156200,0,3107,260632,2565,196232,542,64400,780,8,1068,18,0,34,130000.0,39000.0,-70.0,-71.0,-68.0,-60.0,-70.0,-71.0,-67.0,-60.0,-90.0,-93.0,-89.0,-93.0,20.0,22.0,21.0,33.0,0
3852,BA:8C:B9:54:50:24,3827556,488299486,4692,6143286,3822864,482156200,0,8203,1631396,8182,1628039,21,3357,2306,14,5067,36,0,53,216660.0,130000.0,-39.0,-36.0,-45.0,-51.0,-42.0,-34.0,-42.0,-46.0,-90.0,-93.0,-89.0,-93.0,51.0,57.0,44.0,42.0,0
3853,92:69:1D:31:68:E9,3826492,485663397,3628,3507197,3822864,482156200,0,3951,989735,3841,965120,110,24615,1922,6,3754,79,0,32,216660.0,130000.0,-51.0,-47.0,-42.0,-49.0,-51.0,-49.0,-43.0,-47.0,-90.0,-93.0,-89.0,-93.0,39.0,46.0,47.0,44.0,0
3854,CC:2F:71:3F:1F:24,4440230,1176159698,617366,694003498,3822864,482156200,37,510232,561678453,509618,561604525,614,73928,492551,10,617603,55501,34,447,130000.0,43333.0,-67.0,-65.0,-70.0,-67.0,-67.0,-65.0,-70.0,-67.0,-90.0,-93.0,-89.0,-93.0,23.0,28.0,19.0,26.0,0
3855,CC:2F:71:3E:C5:1F,3823601,482246188,737,89988,3822864,482156200,0,3107,260632,2565,196232,542,64400,780,8,1068,18,0,34,130000.0,39000.0,-70.0,-71.0,-68.0,-60.0,-70.0,-71.0,-67.0,-60.0,-90.0,-93.0,-89.0,-93.0,20.0,22.0,21.0,33.0,0
3856,BA:8C:B9:54:50:24,3827556,488299486,4692,6143286,3822864,482156200,0,8203,1631396,8182,1628039,21,3357,2306,14,5067,36,0,53,216660.0,130000.0,-39.0,-36.0,-45.0,-51.0,-42.0,-34.0,-42.0,-46.0,-90.0,-93.0,-89.0,-93.0,51.0,57.0,44.0,42.0,0
3857,92:69:1D:31:68:E9,3826498,485664003,3628,3507197,3822870,482156806,0,3951,989735,3841,965120,110,24615,1922,6,3754,79,0,32,216660.0,130000.0,-51.0,-47.0,-42.0,-49.0,-51.0,-49.0,-43.0,-47.0,-90.0,-93.0,-89.0,-93.0,39.0,46.0,47.0,44.0,0
3858,CC:2F:71:3F:1F:24,4440279,1176174922,617407,694017914,3822872,482157008,37,510257,561683257,509643,561609329,614,73928,492576,10,617644,55504,34,447,130000.0,43333.0,-67.0,-65.0,-71.0,-67.0,-67.0,-65.0,-70.0,-67.0,-90.0,-93.0,-89.0,-93.0,23.0,28.0,18.0,26.0,0
3859,CC:2F:71:3E:C5:1F,3823609,482246996,737,89988,3822872,482157008,0,3107,260632,2565,196232,542,64400,780,8,1068,18,0,34,130000.0,39000.0,-70.0,-71.0,-68.0,-60.0,-70.0,-71.0,-67.0,-60.0,-90.0,-93.0,-89.0,-93.0,20.0,22.0,21.0,33.0,0
3860,BA:8C:B9:54:50:24,3827564,488300294,4692,6143286,3822872,482157008,0,8203,1631396,8182,1628039,21,3357,2306,14,5067,36,0,53,216660.0,130000.0,-39.0,-36.0,-45.0,-51.0,-42.0,-34.0,-42.0,-46.0,-90.0,-93.0,-89.0,-93.0,51.0,57.0,44.0,42.0,0
3861,92:69:1D:31:68:E9,3826501,485664265,3628,3507197,3822873,482157068,0,3951,989735,3841,965120,110,24615,1922,6,3754,79,0,32,216660.0,130000.0,-51.0,-47.0,-42.0,-49.0,-51.0,-49.0,-43.0,-47.0,-90.0,-93.0,-89.0,-93.0,39.0,46.0,47.0,44.0,0
3862,CC:2F:71:3F:1F:24,4440323,1176189534,617450,694032466,3822873,482157068,37,510282,561688061,509668,561614133,614,73928,492601,10,617687,55522,34,447,117000.0,39000.0,-67.0,-65.0,-70.0,-68.0,-67.0,-65.0,-70.0,-67.0,-90.0,-93.0,-89.0,-93.0,23.0,28.0,19.0,25.0,0
3863,CC:2F:71:3E:C5:1F,3823610,482247056,737,89988,3822873,482157068,0,3107,260632,2565,196232,542,64400,780,8,1068,18,0,34,130000.0,39000.0,-70.0,-71.0,-68.0,-60.0,-70.0,-71.0,-67.0,-60.0,-90.0,-93.0,-89.0,-93.0,20.0,22.0,21.0,33.0,0
3864,BA:8C:B9:54:50:24,3827567,488300556,4692,6143286,3822875,482157270,0,8203,1631396,8182,1628039,21,3357,2306,14,5067,36,0,53,216660.0,130000.0,-39.0,-36.0,-45.0,-51.0,-42.0,-34.0,-42.0,-46.0,-90.0,-93.0,-89.0,-93.0,51.0,57.0,44.0,42.0,0
3865,92:69:1D:31:68:E9,3826507,485664871,3628,3507197,3822879,482157674,0,3951,989735,3841,965120,110,24615,1922,6,3754,79,0,32,216660.0,130000.0,-51.0,-47.0,-42.0,-49.0,-51.0,-49.0,-43.0,-47.0,-90.0,-93.0,-89.0,-93.0,39.0,46.0,47.0,44.0,0
3866,CC:2F:71:3F:1F:24,4440374,1176204894,617493,694047018,3822881,482157876,37,510308,561693005,509694,561619077,614,73928,492627,10,617730,55524,34,447,130000.0,43333.0,-67.0,-65.0,-70.0,-68.0,-67.0,-65.0,-70.0,-67.0,-90.0,-93.0,-89.0,-93.0,23.0,28.0,19.0,25.0,0
3867,CC:2F:71:3E:C5:1F,3823618,482247864,737,89988,3822881,482157876,0,3107,260632,2565,196232,542,64400,780,8,1068,18,0,34,130000.0,39000.0,-70.0,-71.0,-68.0,-60.0,-70.0,-71.0,-67.0,-60.0,-90.0,-93.0,-89.0,-93.0,20.0,22.0,21.0,33.0,0
3868,BA:8C:B9:54:50:24,3827573,488301162,4692,6143286,3822881,482157876,0,8203,1631396,8182,1628039,21,3357,2306,14,5067,36,0,53,216660.0,130000.0,-39.0,-36.0,-45.0,-51.0,-42.0,-34.0,-42.0,-46.0,-90.0,-93.0,-89.0,-93.0,51.0,57.0,44.0,42.0,0
3869,92:69:1D:31:68:E9,3826510,485665133,3628,3507197,3822882,482157936,0,3951,989735,3841,965120,110,24615,1922,6,3754,79,0,32,216660.0,130000.0,-51.0,-47.0,-42.0,-49.0,-51.0,-49.0,-43.0,-47.0,-90.0,-93.0,-89.0,-93.0,39.0,46.0,47.0,44.0,0
3870,CC:2F:71:3F:1F:24,4440418,1176219618,617536,694061682,3822882,482157936,37,510334,561697925,509720,561623997,614,73928,492653,10,617773,55532,34,447,130000.0,43333.0,-67.0,-65.0,-71.0,-67.0,-67.0,-65.0,-70.0,-67.0,-90.0,-93.0,-89.0,-93.0,23.0,28.0,18.0,26.0,0
3871,CC:2F:71:3E:C5:1F,3823619,482247924,737,89988,3822882,482157936,0,3107,260632,2565,196232,542,64400,780,8,1068,18,0,34,130000.0,39000.0,-70.0,-71.0,-68.0,-60.0,-70.0,-71.0,-67.0,-60.0,-90.0,-93.0,-89.0,-93.0,20.0,22.0,21.0,33.0,0
3872,BA:8C:B9:54:50:24,3827576,488301424,4692,6143286,3822884,482158138,0,8203,1631396,8182,1628039,21,3357,2306,14,5067,36,0,53,216660.0,130000.0,-39.0,-36.0,-45.0,-51.0,-42.0,-34.0,-42.0,-46.0,-90.0,-93.0,-89.0,-93.0,51.0,57.0,44.0,42.0,0
3873,92:69:1D:31:68:E9,3826516,485665739,3628,3507197,3822888,482158542,0,3951,989735,3841,965120,110,24615,1922,6,3754,79,0,32,216660.0,130000.0,-51.0,-47.0,-42.0,-49.0,-51.0,-49.0,-43.0,-47.0,-90.0,-93.0,-89.0,-93.0,39.0,46.0,47.0,44.0,0
3874,CC:2F:71:3F:1F:24,4440468,1176234854,617578,694076110,3822890,482158744,37,510359,561702729,509745,561628801,614,73928,492678,10,617815,55546,34,447,117000.0,39000.0,-67.0,-65.0,-70.0,-67.0,-67.0,-65.0,-70.0,-67.0,-90.0,-93.0,-89.0,-93.0,23.0,28.0,19.0,26.0,0
3875,CC:2F:71:3E:C5:1F,3823627,482248732,737,89988,3822890,482158744,0,3107,260632,2565,196232,542,64400,780,8,1068,18,0,34,130000.0,39000.0,-70.0,-71.0,-68.0,-60.0,-70.0,-71.0,-67.0,-60.0,-90.0,-93.0,-89.0,-93.0,20.0,22.0,21.0,33.0,0
3876,BA:8C:B9:54:50:24,3827582,488302030,4692,6143286,3822890,482158744,0,8203,1631396,8182,1628039,21,3357,2306,14,5067,36,0,53,216660.0,130000.0,-39.0,-36.0,-45.0,-51.0,-42.0,-34.0,-42.0,-46.0,-90.0,-93.0,-89.0,-93.0,51.0,57.0,44.0,42.0,0
3877,92:69:1D:31:68:E9,3826518,485665941,3628,3507197,3822890,482158744,0,3951,989735,3841,965120,110,24615,1922,6,3754,79,0,32,216660.0,130000.0,-51.0,-47.0,-42.0,-49.0,-51.0,-49.0,-43.0,-47.0,-90.0,-93.0,-90.0,-93.0,39.0,46.0,48.0,44.0,0
3878,CC:2F:71:3F:1F:24,4440510,1176249282,617620,694090538,3822890,482158744,37,510384,561707533,509770,561633605,614,73928,492703,10,617857,55553,34,447,130000.0,43333.0,-67.0,-65.0,-70.0,-67.0,-67.0,-65.0,-70.0,-67.0,-90.0,-93.0,-90.0,-93.0,23.0,28.0,20.0,26.0,0
3879,CC:2F:71:3E:C5:1F,3823627,482248732,737,89988,3822890,482158744,0,3107,260632,2565,196232,542,64400,780,8,1068,18,0,34,130000.0,39000.0,-70.0,-71.0,-68.0,-60.0,-70.0,-71.0,-67.0,-60.0,-90.0,-93.0,-90.0,-93.0,20.0,22.0,22.0,33.0,0
3880,BA:8C:B9:54:50:24,3827584,488302232,4692,6143286,3822892,482158946,0,8203,1631396,8182,1628039,21,3357,2306,14,5067,36,0,53,216660.0,130000.0,-39.0,-36.0,-45.0,-51.0,-42.0,-34.0,-42.0,-46.0,-90.0,-93.0,-90.0,-93.0,51.0,57.0,45.0,42.0,0
3881,92:69:1D:31:68:E9,3826525,485666607,3628,3507197,3822897,482159410,0,3951,989735,3841,965120,110,24615,1922,6,3754,79,0,32,216660.0,130000.0,-51.0,-47.0,-42.0,-49.0,-51.0,-49.0,-43.0,-47.0,-90.0,-93.0,-90.0,-93.0,39.0,46.0,48.0,44.0,0
3882,CC:2F:71:3F:1F:24,4440560,1176264454,617661,694104842,3822899,482159612,37,510409,561712337,509795,561638409,614,73928,492728,10,617898,55573,34,447,117000.0,39000.0,-67.0,-65.0,-70.0,-67.0,-67.0,-65.0,-70.0,-67.0,-90.0,-93.0,-90.0,-93.0,23.0,28.0,20.0,26.0,0
3883,CC:2F:71:3E:C5:1F,3823636,482249600,737,89988,3822899,482159612,0,3107,260632,2565,196232,542,64400,780,8,1068,18,0,34,130000.0,39000.0,-70.0,-71.0,-68.0,-60.0,-70.0,-71.0,-67.0,-60.0,-90.0,-93.0,-90.0,-93.0,20.0,22.0,22.0,33.0,0
3884,BA:8C:B9:54:50:24,3827591,488302898,4692,6143286,3822899,482159612,0,8203,1631396,8182,1628039,21,3357,2306,14,5067,36,0,53,216660.0,130000.0,-39.0,-36.0,-45.0,-51.0,-42.0,-34.0,-42.0,-46.0,-90.0,-93.0,-90.0,-93.0,51.0,57.0,45.0,42.0,0
3885,92:69:1D:31:68:E9,3826527,485666809,3628,3507197,3822899,482159612,0,3951,989735,3841,965120,110,24615,1922,6,3754,79,0,32,216660.0,130000.0,-51.0,-47.0,-42.0,-49.0,-51.0,-49.0,-43.0,-47.0,-90.0,-93.0,-90.0,-93.0,39.0,46.0,48.0,44.0,0
3886,CC:2F:71:3F:1F:24,4440602,1176278882,617703,694119270,3822899,482159612,37,510434,561717141,509820,561643213,614,73928,492753,10,617940,55584,34,447,130000.0,43333.0,-67.0,-65.0,-70.0,-68.0,-67.0,-65.0,-70.0,-67.0,-90.0,-93.0,-90.0,-93.0,23.0,28.0,20.0,25.0,0
3887,CC:2F:71:3E:C5:1F,3823636,482249600,737,89988,3822899,482159612,0,3107,260632,2565,196232,542,64400,780,8,1068,18,0,34,130000.0,39000.0,-70.0,-71.0,-68.0,-60.0,-70.0,-71.0,-67.0,-60.0,-90.0,-93.0,-90.0,-93.0,20.0,22.0,22.0,33.0,0
3888,BA:8C:B9:54:50:24,3827593,488303100,4692,6143286,3822901,482159814,0,8203,1631396,8182,1628039,21,3357,2306,14,5067,36,0,53,216660.0,130000.0,-39.0,-36.0,-45.0,-51.0,-42.0,-34.0,-42.0,-46.0,-90.0,-93.0,-90.0,-93.0,51.0,57.0,45.0,42.0,0
3889,92:69:1D:31:68:E9,3826531,485667213,3628,3507197,3822903,482160016,0,3951,989735,3841,965120,110,24615,1922,6,3754,79,0,32,216660.0,130000.0,-51.0,-47.0,-42.0,-49.0,-51.0,-49.0,-43.0,-47.0,-90.0,-93.0,-90.0,-93.0,39.0,46.0,48.0,44.0,0
3890,CC:2F:71:3F:1F:24,4440651,1176294230,617746,694134012,3822905,482160218,37,510461,561722189,509847,561648261,614,73928,492780,10,617983,55600,34,447,130000.0,39000.0,-67.0,-65.0,-71.0,-68.0,-67.0,-65.0,-70.0,-67.0,-90.0,-93.0,-90.0,-93.0,23.0,28.0,19.0,25.0,0
3891,CC:2F:71:3E:C5:1F,3823645,482250468,737,89988,3822908,482160480,0,3107,260632,2565,196232,542,64400,780,8,1068,18,0,34,130000.0,39000.0,-70.0,-71.0,-68.0,-60.0,-70.0,-71.0,-67.0,-60.0,-90.0,-93.0,-90.0,-93.0,20.0,22.0,22.0,33.0,0
3892,BA:8C:B9:54:50:24,3827600,488303766,4692,6143286,3822908,482160480,0,8203,1631396,8182,1628039,21,3357,2306,14,5067,36,0,53,216660.0,130000.0,-39.0,-36.0,-45.0,-51.0,-42.0,-34.0,-42.0,-46.0,-90.0,-93.0,-90.0,-93.0,51.0,57.0,45.0,42.0,0
3893,92:69:1D:31:68:E9,3826536,485667677,3628,3507197,3822908,482160480,0,3951,989735,3841,965120,110,24615,1922,6,3754,79,0,32,216660.0,130000.0,-51.0,-47.0,-42.0,-49.0,-51.0,-49.0,-43.0,-47.0,-90.0,-93.0,-90.0,-93.0,39.0,46.0,48.0,44.0,0
3894,CC:2F:71:3F:1F:24,4440699,1176309228,617791,694148748,3822908,482160480,37,510486,561726993,509872,561653065,614,73928,492805,10,618028,55621,34,447,130000.0,43333.0,-67.0,-65.0,-70.0,-68.0,-67.0,-65.0,-70.0,-67.0,-90.0,-93.0,-90.0,-93.0,23.0,28.0,20.0,25.0,0
3895,CC:2F:71:3E:C5:1F,3823648,482250786,738,90104,3822910,482160682,0,3109,260772,2567,196372,542,64400,780,8,1069,18,0,34,130000.0,39000.0,-70.0,-71.0,-68.0,-60.0,-70.0,-71.0,-67.0,-60.0,-90.0,-93.0,-90.0,-93.0,20.0,22.0,22.0,33.0,0
3896,BA:8C:B9:54:50:24,3827603,488304084,4693,6143402,3822910,482160682,0,8205,1631532,8184,1628175,21,3357,2306,14,5068,36,0,53,216660.0,130000.0,-49.0,-35.0,-42.0,-45.0,-42.0,-34.0,-42.0,-46.0,-90.0,-93.0,-90.0,-93.0,41.0,58.0,48.0,48.0,0
3897,92:69:1D:31:68:E9,3826542,485668470,3629,3507313,3822913,482161157,0,3953,989871,3843,965256,110,24615,1922,6,3755,79,0,32,216660.0,130000.0,-52.0,-50.0,-44.0,-46.0,-51.0,-49.0,-43.0,-47.0,-90.0,-93.0,-90.0,-93.0,38.0,43.0,46.0,47.0,0
3898,CC:2F:71:3F:1F:24,4440749,1176324961,617834,694163602,3822915,482161359,37,510517,561732646,509903,561658718,614,73928,492836,10,618071,55634,34,447,130000.0,39000.0,-67.0,-65.0,-71.0,-67.0,-67.0,-65.0,-70.0,-67.0,-90.0,-93.0,-90.0,-93.0,23.0,28.0,19.0,26.0,0
3899,CC:2F:71:3E:C5:1F,3823655,482251665,738,90104,3822917,482161561,0,3109,260772,2567,196372,542,64400,780,8,1069,18,0,34,130000.0,39000.0,-70.0,-71.0,-68.0,-60.0,-70.0,-71.0,-67.0,-60.0,-90.0,-93.0,-90.0,-93.0,20.0,22.0,22.0,33.0,0
3900,BA:8C:B9:54:50:24,3827610,488304963,4693,6143402,3822917,482161561,0,8205,1631532,8184,1628175,21,3357,2306,14,5068,36,0,53,216660.0,130000.0,-49.0,-35.0,-42.0,-45.0,-42.0,-34.0,-42.0,-46.0,-90.0,-93.0,-90.0,-93.0,41.0,58.0,48.0,48.0,0
3901,92:69:1D:31:68:E9,3826547,485668934,3629,3507313,3822918,482161621,0,3953,989871,3843,965256,110,24615,1922,6,3755,79,0,32,216660.0,130000.0,-52.0,-50.0,-44.0,-46.0,-51.0,-49.0,-43.0,-47.0,-90.0,-93.0,-90.0,-93.0,38.0,43.0,46.0,47.0,0
3902,CC:2F:71:3F:1F:24,4440798,1176340294,617880,694178673,3822918,482161621,37,510545,561737822,509931,561663894,614,73928,492864,10,618117,55668,34,447,130000.0,43333.0,-67.0,-65.0,-70.0,-68.0,-67.0,-65.0,-70.0,-67.0,-90.0,-93.0,-90.0,-93.0,23.0,28.0,20.0,25.0,0
3903,CC:2F:71:3E:C5:1F,3823658,482251927,738,90104,3822920,482161823,0,3109,260772,2567,196372,542,64400,780,8,1069,18,0,34,130000.0,39000.0,-70.0,-71.0,-68.0,-60.0,-70.0,-71.0,-67.0,-60.0,-90.0,-93.0,-90.0,-93.0,20.0,22.0,22.0,33.0,0
3904,BA:8C:B9:54:50:24,3827613,488305225,4693,6143402,3822920,482161823,0,8205,1631532,8184,1628175,21,3357,2306,14,5068,36,0,53,216660.0,130000.0,-49.0,-35.0,-42.0,-45.0,-42.0,-34.0,-42.0,-46.0,-90.0,-93.0,-90.0,-93.0,41.0,58.0,48.0,48.0,0
3905,92:69:1D:31:68:E9,3826552,485669400,3629,3507313,3822923,482162087,0,3953,989871,3843,965256,110,24615,1922,6,3755,79,0,32,216660.0,130000.0,-52.0,-50.0,-44.0,-46.0,-51.0,-49.0,-43.0,-47.0,-90.0,-93.0,-90.0,-93.0,38.0,43.0,46.0,47.0,0
3906,CC:2F:71:3F:1F:24,4440847,1176355502,617922,694193213,3822925,482162289,37,510570,561742626,509956,561668698,614,73928,492889,10,618159,55673,34,447,130000.0,43333.0,-67.0,-65.0,-70.0,-67.0,-67.0,-65.0,-70.0,-67.0,-90.0,-93.0,-90.0,-93.0,23.0,28.0,20.0,26.0,0
3907,CC:2F:71:3E:C5:1F,3823663,482252393,738,90104,3822925,482162289,0,3111,260960,2568,196442,543,64518,781,8,1069,18,0,34,130000.0,39000.0,-70.0,-71.0,-67.0,-60.0,-70.0,-71.0,-67.0,-60.0,-90.0,-93.0,-90.0,-93.0,20.0,22.0,23.0,33.0,0
3908,BA:8C:B9:54:50:24,3827620,488305893,4693,6143402,3822927,482162491,0,8205,1631532,8184,1628175,21,3357,2306,14,5068,36,0,53,216660.0,130000.0,-49.0,-35.0,-42.0,-45.0,-42.0,-34.0,-42.0,-46.0,-90.0,-93.0,-90.0,-93.0,41.0,58.0,48.0,48.0,0
3909,92:69:1D:31:68:E9,3826556,485669804,3629,3507313,3822927,482162491,0,3953,989871,3843,965256,110,24615,1922,6,3755,79,0,32,216660.0,130000.0,-52.0,-50.0,-44.0,-46.0,-51.0,-49.0,-43.0,-47.0,-90.0,-93.0,-90.0,-93.0,38.0,43.0,46.0,47.0,0
3910,CC:2F:71:3F:1F:24,4440891,1176370132,617964,694207641,3822927,482162491,37,510595,561747430,509981,561673502,614,73928,492914,10,618201,55693,34,447,117000.0,39000.0,-67.0,-65.0,-70.0,-68.0,-67.0,-65.0,-70.0,-67.0,-90.0,-93.0,-90.0,-93.0,23.0,28.0,20.0,25.0,0
3911,CC:2F:71:3E:C5:1F,3823667,482252797,738,90104,3822929,482162693,0,3111,260960,2568,196442,543,64518,781,8,1069,18,0,34,130000.0,39000.0,-70.0,-71.0,-67.0,-60.0,-70.0,-71.0,-67.0,-60.0,-90.0,-93.0,-90.0,-93.0,20.0,22.0,23.0,33.0,0
3912,BA:8C:B9:54:50:24,3827622,488306095,4693,6143402,3822929,482162693,0,8205,1631532,8184,1628175,21,3357,2306,14,5068,36,0,53,216660.0,130000.0,-49.0,-35.0,-42.0,-45.0,-42.0,-34.0,-42.0,-46.0,-90.0,-93.0,-90.0,-93.0,41.0,58.0,48.0,48.0,0
3913,92:69:1D:31:68:E9,3826561,485670268,3629,3507313,3822932,482162955,0,3953,989871,3843,965256,110,24615,1922,6,3755,79,0,32,216660.0,130000.0,-52.0,-50.0,-44.0,-46.0,-51.0,-49.0,-43.0,-47.0,-90.0,-93.0,-90.0,-93.0,38.0,43.0,46.0,47.0,0
3914,CC:2F:71:3F:1F:24,4440940,1176385226,618006,694222069,3822934,482163157,37,510624,561752746,510010,561678818,614,73928,492943,10,618243,55693,34,447,130000.0,43333.0,-67.0,-65.0,-70.0,-67.0,-67.0,-65.0,-70.0,-67.0,-90.0,-93.0,-90.0,-93.0,23.0,28.0,20.0,26.0,0
3915,CC:2F:71:3E:C5:1F,3823672,482253261,738,90104,3822934,482163157,0,3111,260960,2568,196442,543,64518,781,8,1069,18,0,34,130000.0,39000.0,-70.0,-71.0,-67.0,-60.0,-70.0,-71.0,-67.0,-60.0,-90.0,-93.0,-90.0,-93.0,20.0,22.0,23.0,33.0,0
3916,BA:8C:B9:54:50:24,3827627,488306559,4693,6143402,3822934,482163157,0,8205,1631532,8184,1628175,21,3357,2306,14,5068,36,0,53,216660.0,130000.0,-49.0,-35.0,-42.0,-45.0,-42.0,-34.0,-42.0,-46.0,-90.0,-93.0,-90.0,-93.0,41.0,58.0,48.0,48.0,0
3917,92:69:1D:31:68:E9,3826565,485670672,3629,3507313,3822936,482163359,0,3953,989871,3843,965256,110,24615,1922,6,3755,79,0,32,216660.0,130000.0,-52.0,-50.0,-44.0,-46.0,-51.0,-49.0,-43.0,-47.0,-90.0,-93.0,-90.0,-93.0,38.0,43.0,46.0,47.0,0
3918,CC:2F:71:3F:1F:24,4440986,1176400164,618048,694236603,3822938,482163561,37,510649,561757550,510035,561683622,614,73928,492968,10,618285,55696,34,447,130000.0,43333.0,-67.0,-65.0,-70.0,-67.0,-67.0,-65.0,-70.0,-67.0,-90.0,-93.0,-90.0,-93.0,23.0,28.0,20.0,26.0,0
3919,CC:2F:71:3E:C5:1F,3823676,482253665,738,90104,3822938,482163561,0,3111,260960,2568,196442,543,64518,781,8,1069,18,0,34,130000.0,39000.0,-70.0,-71.0,-67.0,-60.0,-70.0,-71.0,-67.0,-60.0,-90.0,-93.0,-90.0,-93.0,20.0,22.0,23.0,33.0,0
3920,BA:8C:B9:54:50:24,3827631,488306963,4693,6143402,3822938,482163561,0,8205,1631532,8184,1628175,21,3357,2306,14,5068,36,0,53,216660.0,130000.0,-49.0,-35.0,-42.0,-45.0,-42.0,-34.0,-42.0,-46.0,-90.0,-93.0,-90.0,-93.0,41.0,58.0,48.0,48.0,0
3921,92:69:1D:31:68:E9,3826568,485670934,3629,3507313,3822939,482163621,0,3953,989871,3843,965256,110,24615,1922,6,3755,79,0,32,216660.0,130000.0,-52.0,-50.0,-44.0,-46.0,-51.0,-49.0,-43.0,-47.0,-90.0,-93.0,-90.0,-93.0,38.0,43.0,46.0,47.0,0
3922,CC:2F:71:3F:1F:24,4441033,1176415056,618090,694251031,3822943,482164025,37,510676,561762610,510062,561688682,614,73928,492995,10,618327,55712,34,447,117000.0,39000.0,-67.0,-65.0,-70.0,-68.0,-67.0,-65.0,-70.0,-67.0,-90.0,-93.0,-90.0,-93.0,23.0,28.0,20.0,25.0,0
3923,CC:2F:71:3E:C5:1F,3823681,482254129,738,90104,3822943,482164025,0,3111,260960,2568,196442,543,64518,781,8,1069,18,0,34,130000.0,39000.0,-70.0,-71.0,-67.0,-60.0,-70.0,-71.0,-67.0,-60.0,-90.0,-93.0,-90.0,-93.0,20.0,22.0,23.0,33.0,0
3924,BA:8C:B9:54:50:24,3827636,488307427,4693,6143402,3822943,482164025,0,8205,1631532,8184,1628175,21,3357,2306,14,5068,36,0,53,216660.0,130000.0,-49.0,-35.0,-42.0,-45.0,-42.0,-34.0,-42.0,-46.0,-90.0,-93.0,-90.0,-93.0,41.0,58.0,48.0,48.0,0
3925,92:69:1D:31:68:E9,3826576,485671824,3631,3507597,3822945,482164227,0,3959,990415,3849,965800,110,24615,1924,6,3757,79,0,32,216660.0,130000.0,-51.0,-47.0,-42.0,-49.0,-52.0,-49.0,-44.0,-48.0,-90.0,-93.0,-90.0,-93.0,39.0,46.0,48.0,44.0,0
3926,CC:2F:71:3F:1F:24,4441079,1176429888,618132,694265459,3822947,482164429,37,510701,561767414,510087,561693486,614,73928,493020,10,618369,55716,34,447,130000.0,43333.0,-67.0,-65.0,-70.0,-67.0,-67.0,-65.0,-70.0,-67.0,-90.0,-93.0,-90.0,-93.0,23.0,28.0,20.0,26.0,0
3927,CC:2F:71:3E:C5:1F,3823685,482254533,738,90104,3822947,482164429,0,3111,260960,2568,196442,543,64518,781,8,1069,18,0,34,130000.0,39000.0,-70.0,-71.0,-67.0,-60.0,-70.0,-71.0,-67.0,-60.0,-90.0,-93.0,-90.0,-93.0,20.0,22.0,23.0,33.0,0
3928,BA:8C:B9:54:50:24,3827640,488307831,4693,6143402,3822947,482164429,0,8205,1631532,8184,1628175,21,3357,2306,14,5068,36,0,53,216660.0,130000.0,-49.0,-35.0,-42.0,-45.0,-42.0,-34.0,-42.0,-46.0,-90.0,-93.0,-90.0,-93.0,41.0,58.0,48.0,48.0,0
3929,92:69:1D:31:68:E9,3826580,485672228,3631,3507597,3822949,482164631,0,3959,990415,3849,965800,110,24615,1924,6,3757,79,0,32,216660.0,130000.0,-51.0,-47.0,-42.0,-49.0,-52.0,-49.0,-44.0,-48.0,-90.0,-93.0,-90.0,-93.0,39.0,46.0,48.0,44.0,0
3930,CC:2F:71:3F:1F:24,4441124,1176444540,618173,694279707,3822951,482164833,37,510728,561772450,510114,561698522,614,73928,493047,10,618410,55727,34,447,130000.0,39000.0,-67.0,-65.0,-70.0,-67.0,-67.0,-65.0,-70.0,-67.0,-90.0,-93.0,-90.0,-93.0,23.0,28.0,20.0,26.0,0
3931,CC:2F:71:3E:C5:1F,3823689,482254937,738,90104,3822951,482164833,0,3111,260960,2568,196442,543,64518,781,8,1069,18,0,34,130000.0,39000.0,-70.0,-71.0,-67.0,-60.0,-70.0,-71.0,-67.0,-60.0,-90.0,-93.0,-90.0,-93.0,20.0,22.0,23.0,33.0,0
3932,BA:8C:B9:54:50:24,3827644,488308235,4693,6143402,3822951,482164833,0,8205,1631532,8184,1628175,21,3357,2306,14,5068,36,0,53,216660.0,130000.0,-49.0,-35.0,-42.0,-45.0,-42.0,-34.0,-42.0,-46.0,-90.0,-93.0,-90.0,-93.0,41.0,58.0,48.0,48.0,0
3933,92:69:1D:31:68:E9,3826587,485672894,3631,3507597,3822956,482165297,0,3960,990483,3850,965868,110,24615,1924,6,3757,79,0,32,216660.0,130000.0,-52.0,-50.0,-44.0,-46.0,-52.0,-50.0,-44.0,-47.0,-90.0,-93.0,-90.0,-93.0,38.0,43.0,46.0,47.0,0
3934,CC:2F:71:3F:1F:24,4441172,1176459612,618216,694294315,3822956,482165297,37,510755,561777546,510141,561703618,614,73928,493074,10,618453,55738,34,447,130000.0,43333.0,-67.0,-65.0,-70.0,-67.0,-67.0,-65.0,-70.0,-67.0,-90.0,-93.0,-90.0,-93.0,23.0,28.0,20.0,26.0,0
3935,CC:2F:71:3E:C5:1F,3823694,482255401,738,90104,3822956,482165297,0,3111,260960,2568,196442,543,64518,781,8,1069,18,0,34,130000.0,39000.0,-70.0,-71.0,-67.0,-60.0,-70.0,-71.0,-67.0,-60.0,-90.0,-93.0,-90.0,-93.0,20.0,22.0,23.0,33.0,0
3936,BA:8C:B9:54:50:24,3827649,488308699,4693,6143402,3822956,482165297,0,8205,1631532,8184,1628175,21,3357,2306,14,5068,36,0,53,216660.0,130000.0,-49.0,-35.0,-42.0,-45.0,-42.0,-34.0,-42.0,-46.0,-90.0,-93.0,-90.0,-93.0,41.0,58.0,48.0,48.0,0
3937,92:69:1D:31:68:E9,3826591,485673298,3631,3507597,3822960,482165701,0,3960,990483,3850,965868,110,24615,1924,6,3757,79,0,32,216660.0,130000.0,-52.0,-50.0,-44.0,-46.0,-52.0,-50.0,-44.0,-47.0,-90.0,-93.0,-90.0,-93.0,38.0,43.0,46.0,47.0,0
3938,CC:2F:71:3F:1F:24,4441219,1176474702,618259,694309001,3822960,482165701,37,510787,561783174,510173,561709246,614,73928,493106,10,618496,55757,34,447,117000.0,39000.0,-67.0,-65.0,-70.0,-67.0,-67.0,-65.0,-70.0,-67.0,-90.0,-93.0,-90.0,-93.0,23.0,28.0,20.0,26.0,0
3939,CC:2F:71:3E:C5:1F,3823698,482255805,738,90104,3822960,482165701,0,3111,260960,2568,196442,543,64518,781,8,1069,18,0,34,130000.0,39000.0,-70.0,-71.0,-67.0,-60.0,-70.0,-71.0,-67.0,-60.0,-90.0,-93.0,-90.0,-93.0,20.0,22.0,23.0,33.0,0
3940,BA:8C:B9:54:50:24,3827653,488309103,4693,6143402,3822960,482165701,0,8205,1631532,8184,1628175,21,3357,2306,14,5068,36,0,53,216660.0,130000.0,-49.0,-35.0,-42.0,-45.0,-42.0,-34.0,-42.0,-46.0,-90.0,-93.0,-90.0,-93.0,41.0,58.0,48.0,48.0,0
3941,92:69:1D:31:68:E9,3826595,485673702,3631,3507597,3822964,482166105,0,3960,990483,3850,965868,110,24615,1924,6,3757,79,0,32,216660.0,130000.0,-52.0,-50.0,-44.0,-46.0,-52.0,-50.0,-44.0,-47.0,-90.0,-93.0,-90.0,-93.0,38.0,43.0,46.0,47.0,0
3942,CC:2F:71:3F:1F:24,4441265,1176489534,618301,694323429,3822964,482166105,37,510812,561787978,510198,561714050,614,73928,493131,10,618538,55762,34,447,130000.0,43333.0,-67.0,-65.0,-70.0,-67.0,-67.0,-65.0,-70.0,-67.0,-90.0,-93.0,-90.0,-93.0,23.0,28.0,20.0,26.0,0
3943,CC:2F:71:3E:C5:1F,3823702,482256209,738,90104,3822964,482166105,0,3111,260960,2568,196442,543,64518,781,8,1069,18,0,34,130000.0,39000.0,-70.0,-71.0,-67.0,-60.0,-70.0,-71.0,-67.0,-60.0,-90.0,-93.0,-90.0,-93.0,20.0,22.0,23.0,33.0,0
3944,BA:8C:B9:54:50:24,3827658,488309567,4693,6143402,3822965,482166165,0,8205,1631532,8184,1628175,21,3357,2306,14,5068,36,0,53,216660.0,130000.0,-49.0,-35.0,-42.0,-45.0,-42.0,-34.0,-42.0,-46.0,-90.0,-93.0,-90.0,-93.0,41.0,58.0,48.0,48.0,0
3945,92:69:1D:31:68:E9,3826624,485685251,3631,3507597,3822993,482177654,0,3963,990854,3852,966004,111,24850,1925,6,3757,79,0,32,216660.0,130000.0,-52.0,-50.0,-44.0,-46.0,-52.0,-49.0,-44.0,-48.0,-90.0,-93.0,-90.0,-93.0,38.0,43.0,46.0,47.0,0
3946,CC:2F:71:3F:1F:24,4441336,1176515517,618343,694337863,3822993,482177654,37,510840,561793156,510225,561719110,615,74046,493159,10,618580,55786,34,447,117000.0,39000.0,-67.0,-65.0,-70.0,-67.0,-67.0,-65.0,-70.0,-67.0,-90.0,-93.0,-90.0,-93.0,23.0,28.0,20.0,26.0,0
3947,CC:2F:71:3E:C5:1F,3823731,482267758,738,90104,3822993,482177654,0,3111,260960,2568,196442,543,64518,781,8,1069,18,0,34,130000.0,39000.0,-70.0,-71.0,-67.0,-60.0,-70.0,-71.0,-67.0,-60.0,-90.0,-93.0,-90.0,-93.0,20.0,22.0,23.0,33.0,0
3948,BA:8C:B9:54:50:24,3827686,488321056,4693,6143402,3822993,482177654,0,8205,1631532,8184,1628175,21,3357,2306,14,5068,36,0,53,216660.0,130000.0,-49.0,-35.0,-42.0,-45.0,-42.0,-34.0,-42.0,-46.0,-90.0,-93.0,-90.0,-93.0,41.0,58.0,48.0,48.0,0
3949,92:69:1D:31:68:E9,3826629,485685928,3631,3507597,3822998,482178331,0,3963,990854,3852,966004,111,24850,1925,6,3757,79,0,32,216660.0,130000.0,-52.0,-50.0,-44.0,-46.0,-52.0,-49.0,-44.0,-48.0,-90.0,-93.0,-90.0,-93.0,38.0,43.0,46.0,47.0,0
3950,CC:2F:71:3F:1F:24,4441383,1176530622,618385,694352291,3822998,482178331,37,510866,561798136,510251,561724090,615,74046,493185,10,618622,55787,34,447,130000.0,43333.0,-67.0,-65.0,-71.0,-68.0,-67.0,-65.0,-70.0,-67.0,-90.0,-93.0,-90.0,-93.0,23.0,28.0,19.0,25.0,0
3951,CC:2F:71:3E:C5:1F,3823736,482268435,738,90104,3822998,482178331,0,3111,260960,2568,196442,543,64518,781,8,1069,18,0,34,130000.0,39000.0,-70.0,-71.0,-67.0,-60.0,-70.0,-71.0,-67.0,-60.0,-90.0,-93.0,-90.0,-93.0,20.0,22.0,23.0,33.0,0
3952,BA:8C:B9:54:50:24,3827691,488321733,4693,6143402,3822998,482178331,0,8205,1631532,8184,1628175,21,3357,2306,14,5068,36,0,53,216660.0,130000.0,-49.0,-35.0,-42.0,-45.0,-42.0,-34.0,-42.0,-46.0,-90.0,-93.0,-90.0,-93.0,41.0,58.0,48.0,48.0,0
3953,92:69:1D:31:68:E9,3826633,485686306,3632,3507713,3823001,482178593,0,3966,991096,3855,966246,111,24850,1926,6,3758,79,0,32,216660.0,130000.0,-52.0,-50.0,-45.0,-46.0,-51.0,-49.0,-43.0,-47.0,-90.0,-93.0,-90.0,-93.0,38.0,43.0,45.0,47.0,0
3954,CC:2F:71:3F:1F:24,4441428,1176545424,618427,694366831,3823001,482178593,37,510892,561803056,510277,561729010,615,74046,493211,10,618664,55794,34,447,130000.0,43333.0,-67.0,-65.0,-71.0,-68.0,-67.0,-65.0,-70.0,-68.0,-90.0,-93.0,-90.0,-93.0,23.0,28.0,19.0,25.0,0
3955,CC:2F:71:3E:C5:1F,3823741,482268899,738,90104,3823003,482178795,0,3111,260960,2568,196442,543,64518,781,8,1069,18,0,34,130000.0,39000.0,-70.0,-71.0,-67.0,-60.0,-70.0,-71.0,-67.0,-60.0,-90.0,-93.0,-90.0,-93.0,20.0,22.0,23.0,33.0,0
3956,BA:8C:B9:54:50:24,3827696,488322197,4693,6143402,3823003,482178795,0,8205,1631532,8184,1628175,21,3357,2306,14,5068,36,0,53,216660.0,130000.0,-49.0,-35.0,-42.0,-45.0,-42.0,-34.0,-42.0,-46.0,-90.0,-93.0,-90.0,-93.0,41.0,58.0,48.0,48.0,0
3957,92:69:1D:31:68:E9,3826639,485686912,3632,3507713,3823007,482179199,0,3966,991096,3855,966246,111,24850,1926,6,3758,79,0,32,216660.0,130000.0,-52.0,-50.0,-45.0,-46.0,-51.0,-49.0,-43.0,-47.0,-90.0,-93.0,-90.0,-93.0,38.0,43.0,45.0,47.0,0
3958,CC:2F:71:3F:1F:24,4441477,1176560638,618470,694381439,3823007,482179199,37,510918,561807976,510303,561733930,615,74046,493237,10,618707,55818,34,447,130000.0,39000.0,-67.0,-65.0,-71.0,-68.0,-67.0,-65.0,-71.0,-67.0,-90.0,-93.0,-90.0,-93.0,23.0,28.0,19.0,25.0,0
3959,CC:2F:71:3E:C5:1F,3823745,482269303,738,90104,3823007,482179199,0,3111,260960,2568,196442,543,64518,781,8,1069,18,0,34,130000.0,39000.0,-70.0,-71.0,-67.0,-60.0,-70.0,-71.0,-67.0,-60.0,-90.0,-93.0,-90.0,-93.0,20.0,22.0,23.0,33.0,0
3960,BA:8C:B9:54:50:24,3827700,488322601,4693,6143402,3823007,482179199,0,8205,1631532,8184,1628175,21,3357,2306,14,5068,36,0,53,216660.0,130000.0,-49.0,-35.0,-42.0,-45.0,-42.0,-34.0,-42.0,-46.0,-90.0,-93.0,-90.0,-93.0,41.0,58.0,48.0,48.0,0
3961,92:69:1D:31:68:E9,3826641,485687114,3632,3507713,3823009,482179401,0,3966,991096,3855,966246,111,24850,1926,6,3758,79,0,32,216660.0,130000.0,-52.0,-50.0,-45.0,-46.0,-51.0,-49.0,-43.0,-47.0,-90.0,-93.0,-90.0,-93.0,38.0,43.0,45.0,47.0,0
3962,CC:2F:71:3F:1F:24,4441523,1176575580,618512,694395811,3823011,482179769,37,510944,561812920,510329,561738874,615,74046,493263,10,618749,55840,34,447,130000.0,43333.0,-67.0,-65.0,-70.0,-68.0,-67.0,-65.0,-70.0,-68.0,-90.0,-93.0,-90.0,-93.0,23.0,28.0,20.0,25.0,0
3963,CC:2F:71:3E:C5:1F,3823751,482270075,738,90104,3823013,482179971,0,3111,260960,2568,196442,543,64518,781,8,1069,18,0,34,130000.0,39000.0,-70.0,-71.0,-67.0,-60.0,-70.0,-71.0,-67.0,-60.0,-90.0,-93.0,-90.0,-93.0,20.0,22.0,23.0,33.0,0
3964,BA:8C:B9:54:50:24,3827706,488323373,4693,6143402,3823013,482179971,0,8205,1631532,8184,1628175,21,3357,2306,14,5068,36,0,53,216660.0,130000.0,-49.0,-35.0,-42.0,-45.0,-42.0,-34.0,-42.0,-46.0,-90.0,-93.0,-90.0,-93.0,41.0,58.0,48.0,48.0,0
3965,92:69:1D:31:68:E9,3826650,485688148,3632,3507713,3823018,482180435,0,3966,991096,3855,966246,111,24850,1926,6,3758,79,0,32,216660.0,130000.0,-52.0,-50.0,-45.0,-46.0,-51.0,-49.0,-43.0,-47.0,-90.0,-93.0,-90.0,-93.0,38.0,43.0,45.0,47.0,0
3966,CC:2F:71:3F:1F:24,4441572,1176590724,618554,694410289,3823018,482180435,37,510969,561817724,510354,561743678,615,74046,493288,10,618791,55852,34,447,130000.0,39000.0,-74.0,-72.0,-77.0,-74.0,-71.0,-69.0,-75.0,-71.0,-90.0,-93.0,-90.0,-93.0,16.0,21.0,13.0,19.0,0
3967,CC:2F:71:3E:C5:1F,3823756,482270539,738,90104,3823018,482180435,0,3111,260960,2568,196442,543,64518,781,8,1069,18,0,34,130000.0,39000.0,-70.0,-71.0,-67.0,-60.0,-70.0,-71.0,-67.0,-60.0,-90.0,-93.0,-90.0,-93.0,20.0,22.0,23.0,33.0,0
3968,BA:8C:B9:54:50:24,3827711,488323837,4693,6143402,3823018,482180435,0,8205,1631532,8184,1628175,21,3357,2306,14,5068,36,0,53,216660.0,130000.0,-49.0,-35.0,-42.0,-45.0,-42.0,-34.0,-42.0,-46.0,-90.0,-93.0,-90.0,-93.0,41.0,58.0,48.0,48.0,0
3969,92:69:1D:31:68:E9,3826650,485688148,3632,3507713,3823018,482180435,0,3966,991096,3855,966246,111,24850,1926,6,3758,79,0,32,216660.0,130000.0,-52.0,-50.0,-45.0,-46.0,-51.0,-49.0,-43.0,-47.0,-90.0,-93.0,-90.0,-93.0,38.0,43.0,45.0,47.0,0
3970,CC:2F:71:3F:1F:24,4441616,1176605354,618596,694424717,3823020,482180637,37,510994,561822528,510379,561748482,615,74046,493313,10,618833,55866,34,447,130000.0,39000.0,-67.0,-65.0,-71.0,-68.0,-68.0,-66.0,-72.0,-69.0,-90.0,-93.0,-90.0,-93.0,23.0,28.0,19.0,25.0,0
3971,CC:2F:71:3E:C5:1F,3823760,482270943,738,90104,3823022,482180839,0,3111,260960,2568,196442,543,64518,781,8,1069,18,0,34,130000.0,39000.0,-70.0,-71.0,-67.0,-60.0,-70.0,-71.0,-67.0,-60.0,-90.0,-93.0,-90.0,-93.0,20.0,22.0,23.0,33.0,0
3972,BA:8C:B9:54:50:24,3827715,488324241,4693,6143402,3823022,482180839,0,8205,1631532,8184,1628175,21,3357,2306,14,5068,36,0,53,216660.0,130000.0,-49.0,-35.0,-42.0,-45.0,-42.0,-34.0,-42.0,-46.0,-90.0,-93.0,-90.0,-93.0,41.0,58.0,48.0,48.0,0
3973,92:69:1D:31:68:E9,3826659,485689016,3632,3507713,3823027,482181303,0,3966,991096,3855,966246,111,24850,1926,6,3758,79,0,32,216660.0,130000.0,-52.0,-50.0,-45.0,-46.0,-51.0,-49.0,-43.0,-47.0,-90.0,-93.0,-90.0,-93.0,38.0,43.0,45.0,47.0,0
3974,CC:2F:71:3F:1F:24,4441664,1176620324,618637,694439021,3823027,482181303,37,511020,561827472,510405,561753426,615,74046,493339,10,618874,55876,34,447,130000.0,39000.0,-67.0,-65.0,-71.0,-68.0,-67.0,-65.0,-70.0,-67.0,-90.0,-93.0,-90.0,-93.0,23.0,28.0,19.0,25.0,0
3975,CC:2F:71:3E:C5:1F,3823765,482271407,738,90104,3823027,482181303,0,3111,260960,2568,196442,543,64518,781,8,1069,18,0,34,130000.0,39000.0,-70.0,-71.0,-67.0,-60.0,-70.0,-71.0,-67.0,-60.0,-90.0,-93.0,-90.0,-93.0,20.0,22.0,23.0,33.0,0
3976,BA:8C:B9:54:50:24,3827720,488324705,4693,6143402,3823027,482181303,0,8205,1631532,8184,1628175,21,3357,2306,14,5068,36,0,53,216660.0,130000.0,-49.0,-35.0,-42.0,-45.0,-42.0,-34.0,-42.0,-46.0,-90.0,-93.0,-90.0,-93.0,41.0,58.0,48.0,48.0,0
3977,92:69:1D:31:68:E9,3826659,485689016,3632,3507713,3823027,482181303,0,3966,991096,3855,966246,111,24850,1926,6,3758,79,0,32,216660.0,130000.0,-52.0,-50.0,-45.0,-46.0,-51.0,-49.0,-43.0,-47.0,-90.0,-93.0,-90.0,-93.0,38.0,43.0,45.0,47.0,0
3978,CC:2F:71:3F:1F:24,4441708,1176635030,618681,694453727,3823027,482181303,37,511048,561832660,510433,561758614,615,74046,493367,10,618918,55898,34,447,130000.0,39000.0,-67.0,-65.0,-71.0,-68.0,-66.0,-65.0,-70.0,-67.0,-90.0,-93.0,-90.0,-93.0,23.0,28.0,19.0,25.0,0
3979,CC:2F:71:3E:C5:1F,3823767,482271609,738,90104,3823029,482181505,0,3111,260960,2568,196442,543,64518,781,8,1069,18,0,34,130000.0,39000.0,-70.0,-71.0,-67.0,-60.0,-70.0,-71.0,-67.0,-60.0,-90.0,-93.0,-90.0,-93.0,20.0,22.0,23.0,33.0,0
3980,BA:8C:B9:54:50:24,3827724,488325109,4693,6143402,3823031,482181707,0,8205,1631532,8184,1628175,21,3357,2306,14,5068,36,0,53,216660.0,130000.0,-49.0,-35.0,-42.0,-45.0,-42.0,-34.0,-42.0,-46.0,-90.0,-93.0,-90.0,-93.0,41.0,58.0,48.0,48.0,0
3981,92:69:1D:31:68:E9,3826667,485689824,3632,3507713,3823035,482182111,0,3966,991096,3855,966246,111,24850,1926,6,3758,79,0,32,216660.0,130000.0,-52.0,-50.0,-45.0,-46.0,-51.0,-49.0,-43.0,-47.0,-90.0,-93.0,-90.0,-93.0,38.0,43.0,45.0,47.0,0
3982,CC:2F:71:3F:1F:24,4441758,1176650266,618723,694468155,3823035,482182111,37,511073,561837464,510458,561763418,615,74046,493392,10,618960,55914,34,447,130000.0,39000.0,-68.0,-66.0,-71.0,-68.0,-67.0,-65.0,-70.0,-68.0,-90.0,-93.0,-90.0,-93.0,22.0,27.0,19.0,25.0,0
3983,CC:2F:71:3E:C5:1F,3823773,482272215,738,90104,3823035,482182111,0,3111,260960,2568,196442,543,64518,781,8,1069,18,0,34,130000.0,39000.0,-70.0,-71.0,-67.0,-60.0,-70.0,-71.0,-67.0,-60.0,-90.0,-93.0,-90.0,-93.0,20.0,22.0,23.0,33.0,0
3984,BA:8C:B9:54:50:24,3827728,488325513,4693,6143402,3823035,482182111,0,8205,1631532,8184,1628175,21,3357,2306,14,5068,36,0,53,216660.0,130000.0,-49.0,-35.0,-42.0,-45.0,-42.0,-34.0,-42.0,-46.0,-90.0,-93.0,-90.0,-93.0,41.0,58.0,48.0,48.0,0
3985,92:69:1D:31:68:E9,3826668,485689884,3632,3507713,3823036,482182171,0,3966,991096,3855,966246,111,24850,1926,6,3758,79,0,32,216660.0,130000.0,-52.0,-50.0,-45.0,-46.0,-51.0,-49.0,-43.0,-47.0,-90.0,-93.0,-90.0,-93.0,38.0,43.0,45.0,47.0,0
3986,CC:2F:71:3F:1F:24,4441801,1176664754,618765,694482583,3823036,482182171,37,511098,561842268,510483,561768222,615,74046,493417,10,619002,55925,34,447,130000.0,39000.0,-68.0,-66.0,-71.0,-68.0,-69.0,-68.0,-73.0,-70.0,-90.0,-93.0,-90.0,-93.0,22.0,27.0,19.0,25.0,0
3987,CC:2F:71:3E:C5:1F,3823776,482272477,738,90104,3823038,482182373,0,3111,260960,2568,196442,543,64518,781,8,1069,18,0,34,130000.0,39000.0,-70.0,-71.0,-67.0,-60.0,-70.0,-71.0,-67.0,-60.0,-90.0,-93.0,-90.0,-93.0,20.0,22.0,23.0,33.0,0
3988,BA:8C:B9:54:50:24,3827733,488325977,4693,6143402,3823040,482182575,0,8205,1631532,8184,1628175,21,3357,2306,14,5068,36,0,53,216660.0,130000.0,-49.0,-35.0,-42.0,-45.0,-42.0,-34.0,-42.0,-46.0,-90.0,-93.0,-90.0,-93.0,41.0,58.0,48.0,48.0,0
3989,92:69:1D:31:68:E9,3826676,485690692,3632,3507713,3823044,482182979,0,3966,991096,3855,966246,111,24850,1926,6,3758,79,0,32,216660.0,130000.0,-52.0,-50.0,-45.0,-46.0,-51.0,-49.0,-43.0,-47.0,-90.0,-93.0,-90.0,-93.0,38.0,43.0,45.0,47.0,0
3990,CC:2F:71:3F:1F:24,4441852,1176680170,618808,694497191,3823044,482182979,37,511124,561847212,510509,561773166,615,74046,493443,10,619045,55927,34,447,130000.0,43333.0,-67.0,-65.0,-71.0,-68.0,-67.0,-65.0,-70.0,-67.0,-90.0,-93.0,-90.0,-93.0,23.0,28.0,19.0,25.0,0
3991,CC:2F:71:3E:C5:1F,3823782,482273083,738,90104,3823044,482182979,0,3111,260960,2568,196442,543,64518,781,8,1069,18,0,34,130000.0,39000.0,-70.0,-71.0,-67.0,-60.0,-70.0,-71.0,-67.0,-60.0,-90.0,-93.0,-90.0,-93.0,20.0,22.0,23.0,33.0,0
3992,BA:8C:B9:54:50:24,3827737,488326381,4693,6143402,3823044,482182979,0,8205,1631532,8184,1628175,21,3357,2306,14,5068,36,0,53,216660.0,130000.0,-49.0,-35.0,-42.0,-45.0,-42.0,-34.0,-42.0,-46.0,-90.0,-93.0,-90.0,-93.0,41.0,58.0,48.0,48.0,0
3993,92:69:1D:31:68:E9,3826676,485690692,3632,3507713,3823044,482182979,0,3966,991096,3855,966246,111,24850,1926,6,3758,79,0,32,216660.0,130000.0,-52.0,-50.0,-45.0,-46.0,-51.0,-49.0,-43.0,-47.0,-90.0,-93.0,-90.0,-93.0,38.0,43.0,45.0,47.0,0
3994,CC:2F:71:3F:1F:24,4441895,1176694722,618851,694511743,3823044,482182979,37,511149,561852016,510534,561777970,615,74046,493468,10,619088,55946,34,447,117000.0,39000.0,-67.0,-65.0,-70.0,-67.0,-67.0,-65.0,-70.0,-67.0,-90.0,-93.0,-90.0,-93.0,23.0,28.0,20.0,26.0,0
3995,CC:2F:71:3E:C5:1F,3823784,482273285,738,90104,3823046,482183181,0,3111,260960,2568,196442,543,64518,781,8,1069,18,0,34,130000.0,39000.0,-70.0,-71.0,-67.0,-60.0,-70.0,-71.0,-67.0,-60.0,-90.0,-93.0,-90.0,-93.0,20.0,22.0,23.0,33.0,0
3996,BA:8C:B9:54:50:24,3827741,488326785,4693,6143402,3823048,482183383,0,8205,1631532,8184,1628175,21,3357,2306,14,5068,36,0,53,216660.0,130000.0,-49.0,-35.0,-42.0,-45.0,-42.0,-34.0,-42.0,-46.0,-90.0,-93.0,-90.0,-93.0,41.0,58.0,48.0,48.0,0
3997,92:69:1D:31:68:E9,3826685,485691560,3632,3507713,3823053,482183847,0,3966,991096,3855,966246,111,24850,1926,6,3758,79,0,32,216660.0,130000.0,-52.0,-50.0,-45.0,-46.0,-51.0,-49.0,-43.0,-47.0,-90.0,-93.0,-90.0,-93.0,38.0,43.0,45.0,47.0,0
3998,CC:2F:71:3F:1F:24,4441947,1176710078,618894,694526231,3823053,482183847,37,511174,561856820,510559,561782774,615,74046,493493,10,619131,55949,34,447,130000.0,39000.0,-67.0,-65.0,-71.0,-67.0,-67.0,-65.0,-70.0,-67.0,-90.0,-93.0,-90.0,-93.0,23.0,28.0,19.0,26.0,0
3999,CC:2F:71:3E:C5:1F,3823793,482274205,740,90358,3823053,482183847,0,3113,261228,2570,196710,543,64518,783,8,1071,18,0,34,130000.0,39000.0,-70.0,-71.0,-67.0,-60.0,-70.0,-71.0,-67.0,-60.0,-90.0,-93.0,-90.0,-93.0,20.0,22.0,23.0,33.0,0
4000,BA:8C:B9:54:50:24,3827747,488327365,4694,6143518,3823053,482183847,0,8206,1631600,8185,1628243,21,3357,2306,14,5069,36,0,53,216660.0,130000.0,-49.0,-35.0,-42.0,-45.0,-43.0,-34.0,-42.0,-46.0,-90.0,-93.0,-90.0,-93.0,41.0,58.0,48.0,48.0,0
4001,92:69:1D:31:68:E9,3826687,485691949,3633,3507829,3823054,482184120,0,3968,991232,3857,966382,111,24850,1926,6,3759,79,0,32,229410.0,130000.0,-52.0,-50.0,-44.0,-46.0,-51.0,-49.0,-43.0,-47.0,-90.0,-93.0,-90.0,-93.0,38.0,43.0,46.0,47.0,0
4002,CC:2F:71:3F:1F:24,4441990,1176724779,618936,694540659,3823054,482184120,37,511201,561861856,510586,561787810,615,74046,493520,10,619173,55972,34,447,130000.0,39000.0,-67.0,-65.0,-71.0,-68.0,-67.0,-65.0,-70.0,-68.0,-90.0,-93.0,-90.0,-93.0,23.0,28.0,19.0,25.0,0
4003,CC:2F:71:3E:C5:1F,3823799,482275259,743,90937,3823056,482184322,0,3117,261775,2574,197257,543,64518,786,8,1074,18,0,34,130000.0,39000.0,-70.0,-71.0,-67.0,-60.0,-70.0,-71.0,-67.0,-60.0,-90.0,-93.0,-90.0,-93.0,20.0,22.0,23.0,33.0,0
4004,BA:8C:B9:54:50:24,3827752,488328042,4694,6143518,3823058,482184524,0,8207,1631668,8186,1628311,21,3357,2306,14,5069,36,0,53,216660.0,130000.0,-39.0,-36.0,-45.0,-51.0,-43.0,-35.0,-43.0,-47.0,-90.0,-93.0,-90.0,-93.0,51.0,57.0,45.0,42.0,0
4005,92:69:1D:31:68:E9,3826697,485692879,3633,3507829,3823064,482185050,0,3968,991232,3857,966382,111,24850,1926,6,3759,79,0,32,229410.0,130000.0,-52.0,-50.0,-44.0,-46.0,-51.0,-49.0,-43.0,-47.0,-90.0,-93.0,-90.0,-93.0,38.0,43.0,46.0,47.0,0
4006,CC:2F:71:3F:1F:24,4442043,1176740153,618978,694555025,3823065,482185128,37,511227,561866800,510612,561792754,615,74046,493546,10,619215,55999,34,447,144444.0,39000.0,-67.0,-65.0,-71.0,-68.0,-67.0,-65.0,-70.0,-68.0,-90.0,-93.0,-90.0,-93.0,23.0,28.0,19.0,25.0,0
4007,CC:2F:71:3E:C5:1F,3823808,482276065,743,90937,3823065,482185128,0,3119,261963,2575,197327,544,64636,787,8,1074,18,0,34,130000.0,39000.0,-70.0,-71.0,-67.0,-60.0,-70.0,-71.0,-67.0,-60.0,-90.0,-93.0,-90.0,-93.0,20.0,22.0,23.0,33.0,0
4008,BA:8C:B9:54:50:24,3827759,488328646,4694,6143518,3823065,482185128,0,8208,1631736,8187,1628379,21,3357,2306,14,5069,36,0,53,216660.0,130000.0,-39.0,-36.0,-44.0,-51.0,-43.0,-35.0,-43.0,-48.0,-90.0,-93.0,-90.0,-93.0,51.0,57.0,46.0,42.0,0
4009,92:69:1D:31:68:E9,3826698,485692957,3633,3507829,3823065,482185128,0,3968,991232,3857,966382,111,24850,1926,6,3759,79,0,32,229410.0,130000.0,-52.0,-50.0,-44.0,-46.0,-51.0,-49.0,-43.0,-47.0,-90.0,-93.0,-90.0,-93.0,38.0,43.0,46.0,47.0,0
4010,CC:2F:71:3F:1F:24,4442086,1176754705,619021,694569577,3823065,482185128,37,511253,561871744,510638,561797698,615,74046,493572,10,619257,56020,34,447,130000.0,43333.0,-67.0,-65.0,-71.0,-68.0,-67.0,-65.0,-70.0,-68.0,-90.0,-93.0,-90.0,-93.0,23.0,28.0,19.0,25.0,0
4011,CC:2F:71:3E:C5:1F,3823810,482276267,743,90937,3823067,482185330,0,3119,261963,2575,197327,544,64636,787,8,1074,18,0,34,130000.0,39000.0,-70.0,-71.0,-67.0,-60.0,-70.0,-71.0,-67.0,-60.0,-90.0,-93.0,-90.0,-93.0,20.0,22.0,23.0,33.0,0
4012,BA:8C:B9:54:50:24,3827763,488329050,4694,6143518,3823069,482185532,0,8208,1631736,8187,1628379,21,3357,2306,14,5069,36,0,53,216660.0,130000.0,-39.0,-36.0,-44.0,-51.0,-43.0,-35.0,-43.0,-48.0,-90.0,-93.0,-90.0,-93.0,51.0,57.0,46.0,42.0,0
4013,92:69:1D:31:68:E9,3826706,485693765,3633,3507829,3823073,482185936,0,3968,991232,3857,966382,111,24850,1926,6,3759,79,0,32,229410.0,130000.0,-52.0,-50.0,-44.0,-46.0,-51.0,-49.0,-43.0,-47.0,-90.0,-93.0,-90.0,-93.0,38.0,43.0,46.0,47.0,0
4014,CC:2F:71:3F:1F:24,4442135,1176769867,619062,694583931,3823073,482185936,37,511280,561876804,510665,561802758,615,74046,493599,10,619299,56039,34,447,130000.0,39000.0,-68.0,-66.0,-71.0,-68.0,-67.0,-65.0,-70.0,-68.0,-90.0,-93.0,-90.0,-93.0,22.0,27.0,19.0,25.0,0
4015,CC:2F:71:3E:C5:1F,3823816,482276873,743,90937,3823073,482185936,0,3119,261963,2575,197327,544,64636,787,8,1074,18,0,34,130000.0,39000.0,-70.0,-71.0,-67.0,-60.0,-70.0,-71.0,-67.0,-60.0,-90.0,-93.0,-90.0,-93.0,20.0,22.0,23.0,33.0,0
4016,BA:8C:B9:54:50:24,3827767,488329454,4694,6143518,3823073,482185936,0,8208,1631736,8187,1628379,21,3357,2306,14,5069,36,0,53,216660.0,130000.0,-39.0,-36.0,-44.0,-51.0,-43.0,-35.0,-43.0,-48.0,-90.0,-93.0,-90.0,-93.0,51.0,57.0,46.0,42.0,0
4017,92:69:1D:31:68:E9,3826707,485693825,3633,3507829,3823074,482185996,0,3968,991232,3857,966382,111,24850,1926,6,3759,79,0,32,229410.0,130000.0,-52.0,-50.0,-44.0,-46.0,-51.0,-49.0,-43.0,-47.0,-90.0,-93.0,-90.0,-93.0,38.0,43.0,46.0,47.0,0
4018,CC:2F:71:3F:1F:24,4442177,1176784231,619103,694598235,3823074,482185996,37,511308,561881956,510693,561807910,615,74046,493627,10,619340,56046,34,447,130000.0,43333.0,-67.0,-65.0,-70.0,-68.0,-67.0,-65.0,-70.0,-68.0,-90.0,-93.0,-90.0,-93.0,23.0,28.0,20.0,25.0,0
4019,CC:2F:71:3E:C5:1F,3823819,482277135,743,90937,3823076,482186198,0,3119,261963,2575,197327,544,64636,787,8,1074,18,0,34,130000.0,39000.0,-70.0,-71.0,-67.0,-60.0,-70.0,-71.0,-67.0,-60.0,-90.0,-93.0,-90.0,-93.0,20.0,22.0,23.0,33.0,0
4020,BA:8C:B9:54:50:24,3827772,488329918,4694,6143518,3823078,482186400,0,8208,1631736,8187,1628379,21,3357,2306,14,5069,36,0,53,216660.0,130000.0,-39.0,-36.0,-44.0,-51.0,-43.0,-35.0,-43.0,-48.0,-90.0,-93.0,-90.0,-93.0,51.0,57.0,46.0,42.0,0
4021,92:69:1D:31:68:E9,3826715,485694633,3633,3507829,3823082,482186804,0,3968,991232,3857,966382,111,24850,1926,6,3759,79,0,32,229410.0,130000.0,-52.0,-50.0,-44.0,-46.0,-51.0,-49.0,-43.0,-47.0,-90.0,-93.0,-90.0,-93.0,38.0,43.0,46.0,47.0,0
4022,CC:2F:71:3F:1F:24,4442225,1176799219,619143,694612415,3823082,482186804,37,511334,561886900,510719,561812854,615,74046,493653,10,619380,56054,34,447,130000.0,39000.0,-67.0,-65.0,-71.0,-68.0,-67.0,-65.0,-70.0,-68.0,-90.0,-93.0,-90.0,-93.0,23.0,28.0,19.0,25.0,0
4023,CC:2F:71:3E:C5:1F,3823825,482277741,743,90937,3823082,482186804,0,3119,261963,2575,197327,544,64636,787,8,1074,18,0,34,130000.0,39000.0,-70.0,-71.0,-67.0,-60.0,-70.0,-71.0,-67.0,-60.0,-90.0,-93.0,-90.0,-93.0,20.0,22.0,23.0,33.0,0
4024,BA:8C:B9:54:50:24,3827776,488330322,4694,6143518,3823082,482186804,0,8208,1631736,8187,1628379,21,3357,2306,14,5069,36,0,53,216660.0,130000.0,-39.0,-36.0,-44.0,-51.0,-43.0,-35.0,-43.0,-48.0,-90.0,-93.0,-90.0,-93.0,51.0,57.0,46.0,42.0,0
4025,92:69:1D:31:68:E9,3826715,485694633,3633,3507829,3823082,482186804,0,3968,991232,3857,966382,111,24850,1926,6,3759,79,0,32,229410.0,130000.0,-52.0,-50.0,-44.0,-46.0,-51.0,-49.0,-43.0,-47.0,-90.0,-93.0,-90.0,-93.0,38.0,43.0,46.0,47.0,0
4026,CC:2F:71:3F:1F:24,4442266,1176813467,619184,694626663,3823082,482186804,37,511360,561891820,510745,561817774,615,74046,493679,10,619421,56088,34,447,144444.0,39000.0,-77.0,-75.0,-79.0,-78.0,-75.0,-73.0,-77.0,-75.0,-90.0,-93.0,-90.0,-93.0,13.0,18.0,11.0,15.0,0
4027,CC:2F:71:3E:C5:1F,3823828,482278059,744,91053,3823084,482187006,0,3121,262139,2577,197503,544,64636,788,8,1075,18,0,34,130000.0,39000.0,-70.0,-71.0,-68.0,-60.0,-70.0,-71.0,-67.0,-60.0,-90.0,-93.0,-90.0,-93.0,20.0,22.0,22.0,33.0,0
4028,BA:8C:B9:54:50:24,3827779,488330584,4694,6143518,3823085,482187066,0,8208,1631736,8187,1628379,21,3357,2306,14,5069,36,0,53,216660.0,130000.0,-39.0,-36.0,-44.0,-51.0,-43.0,-35.0,-43.0,-48.0,-90.0,-93.0,-90.0,-93.0,51.0,57.0,46.0,42.0,0
4029,92:69:1D:31:68:E9,3826724,485695501,3633,3507829,3823091,482187672,0,3968,991232,3857,966382,111,24850,1926,6,3759,79,0,32,229410.0,130000.0,-52.0,-50.0,-44.0,-46.0,-51.0,-49.0,-43.0,-47.0,-90.0,-93.0,-90.0,-93.0,38.0,43.0,46.0,47.0,0
4030,CC:2F:71:3F:1F:24,4442318,1176828837,619227,694641165,3823091,482187672,37,511385,561896624,510770,561822578,615,74046,493704,10,619464,56113,34,447,117000.0,39000.0,-67.0,-66.0,-71.0,-68.0,-67.0,-65.0,-70.0,-68.0,-90.0,-93.0,-90.0,-93.0,23.0,27.0,19.0,25.0,0
4031,CC:2F:71:3E:C5:1F,3823836,482278841,745,91169,3823091,482187672,0,3124,262385,2580,197749,544,64636,789,8,1076,18,0,34,130000.0,39000.0,-70.0,-71.0,-67.0,-60.0,-70.0,-71.0,-67.0,-60.0,-90.0,-93.0,-90.0,-93.0,20.0,22.0,23.0,33.0,0
4032,BA:8C:B9:54:50:24,3827785,488331190,4694,6143518,3823091,482187672,0,8208,1631736,8187,1628379,21,3357,2306,14,5069,36,0,53,216660.0,130000.0,-39.0,-36.0,-44.0,-51.0,-43.0,-35.0,-43.0,-48.0,-90.0,-93.0,-90.0,-93.0,51.0,57.0,46.0,42.0,0
4033,92:69:1D:31:68:E9,3826724,485695501,3633,3507829,3823091,482187672,0,3968,991232,3857,966382,111,24850,1926,6,3759,79,0,32,229410.0,130000.0,-52.0,-50.0,-44.0,-46.0,-51.0,-49.0,-43.0,-47.0,-90.0,-93.0,-90.0,-93.0,38.0,43.0,46.0,47.0,0
4034,CC:2F:71:3F:1F:24,4442363,1176843597,619270,694655723,3823093,482187874,37,511412,561901684,510797,561827638,615,74046,493731,10,619507,56119,34,447,130000.0,43333.0,-68.0,-66.0,-71.0,-68.0,-68.0,-66.0,-71.0,-68.0,-90.0,-93.0,-90.0,-93.0,22.0,27.0,19.0,25.0,0
4035,CC:2F:71:3E:C5:1F,3823838,482279043,745,91169,3823093,482187874,0,3124,262385,2580,197749,544,64636,789,8,1076,18,0,34,130000.0,39000.0,-70.0,-71.0,-67.0,-60.0,-70.0,-71.0,-67.0,-60.0,-90.0,-93.0,-90.0,-93.0,20.0,22.0,23.0,33.0,0
4036,BA:8C:B9:54:50:24,3827787,488331392,4694,6143518,3823093,482187874,0,8208,1631736,8187,1628379,21,3357,2306,14,5069,36,0,53,216660.0,130000.0,-39.0,-36.0,-44.0,-51.0,-43.0,-35.0,-43.0,-48.0,-90.0,-93.0,-90.0,-93.0,51.0,57.0,46.0,42.0,0
4037,92:69:1D:31:68:E9,3826733,485696369,3633,3507829,3823100,482188540,0,3968,991232,3857,966382,111,24850,1926,6,3759,79,0,32,229410.0,130000.0,-52.0,-50.0,-44.0,-46.0,-51.0,-49.0,-43.0,-47.0,-90.0,-93.0,-90.0,-93.0,38.0,43.0,46.0,47.0,0
4038,CC:2F:71:3F:1F:24,4442414,1176859079,619314,694670539,3823100,482188540,37,511441,561907012,510826,561832966,615,74046,493760,10,619551,56127,34,447,130000.0,39000.0,-68.0,-66.0,-71.0,-69.0,-70.0,-68.0,-73.0,-70.0,-90.0,-93.0,-90.0,-93.0,22.0,27.0,19.0,24.0,0
4039,CC:2F:71:3E:C5:1F,3823845,482279709,745,91169,3823100,482188540,0,3124,262385,2580,197749,544,64636,789,8,1076,18,0,34,130000.0,39000.0,-70.0,-71.0,-67.0,-60.0,-70.0,-71.0,-67.0,-60.0,-90.0,-93.0,-90.0,-93.0,20.0,22.0,23.0,33.0,0
4040,BA:8C:B9:54:50:24,3827794,488332058,4694,6143518,3823100,482188540,0,8208,1631736,8187,1628379,21,3357,2306,14,5069,36,0,53,216660.0,130000.0,-39.0,-36.0,-44.0,-51.0,-43.0,-35.0,-43.0,-48.0,-90.0,-93.0,-90.0,-93.0,51.0,57.0,46.0,42.0,0
4041,92:69:1D:31:68:E9,3826733,485696369,3633,3507829,3823100,482188540,0,3971,991436,3860,966586,111,24850,1926,6,3759,79,0,32,229410.0,130000.0,-52.0,-50.0,-44.0,-46.0,-51.0,-49.0,-43.0,-46.0,-90.0,-93.0,-90.0,-93.0,38.0,43.0,46.0,47.0,0
4042,CC:2F:71:3F:1F:24,4442458,1176873705,619358,694685165,3823100,482188540,37,511466,561911816,510851,561837770,615,74046,493785,10,619595,56146,34,447,117000.0,39000.0,-70.0,-68.0,-73.0,-70.0,-70.0,-68.0,-73.0,-70.0,-90.0,-93.0,-90.0,-93.0,20.0,25.0,17.0,23.0,0
4043,CC:2F:71:3E:C5:1F,3823847,482279911,745,91169,3823102,482188742,0,3124,262385,2580,197749,544,64636,789,8,1076,18,0,34,130000.0,39000.0,-70.0,-71.0,-67.0,-60.0,-70.0,-71.0,-67.0,-60.0,-90.0,-93.0,-90.0,-93.0,20.0,22.0,23.0,33.0,0
4044,BA:8C:B9:54:50:24,3827798,488332462,4694,6143518,3823104,482188944,0,8208,1631736,8187,1628379,21,3357,2306,14,5069,36,0,53,216660.0,130000.0,-39.0,-36.0,-44.0,-51.0,-43.0,-35.0,-43.0,-48.0,-90.0,-93.0,-90.0,-93.0,51.0,57.0,46.0,42.0,0
4045,92:69:1D:31:68:E9,3826743,485697365,3633,3507829,3823110,482189536,0,3971,991436,3860,966586,111,24850,1926,6,3759,79,0,32,229410.0,130000.0,-52.0,-50.0,-44.0,-46.0,-51.0,-49.0,-43.0,-46.0,-90.0,-93.0,-90.0,-93.0,38.0,43.0,46.0,47.0,0
4046,CC:2F:71:3F:1F:24,4442509,1176889005,619399,694699469,3823110,482189536,37,511493,561916854,510877,561842690,616,74164,493812,10,619636,56151,34,447,130000.0,43333.0,-67.0,-65.0,-70.0,-67.0,-68.0,-66.0,-71.0,-68.0,-90.0,-93.0,-90.0,-93.0,23.0,28.0,20.0,26.0,0
4047,CC:2F:71:3E:C5:1F,3823855,482280705,745,91169,3823110,482189536,0,3124,262385,2580,197749,544,64636,789,8,1076,18,0,34,130000.0,39000.0,-70.0,-71.0,-67.0,-60.0,-70.0,-71.0,-67.0,-60.0,-90.0,-93.0,-90.0,-93.0,20.0,22.0,23.0,33.0,0
4048,BA:8C:B9:54:50:24,3827804,488333054,4694,6143518,3823110,482189536,0,8208,1631736,8187,1628379,21,3357,2306,14,5069,36,0,53,216660.0,130000.0,-39.0,-36.0,-44.0,-51.0,-43.0,-35.0,-43.0,-48.0,-90.0,-93.0,-90.0,-93.0,51.0,57.0,46.0,42.0,0
4049,92:69:1D:31:68:E9,3826744,485697425,3633,3507829,3823111,482189596,0,3971,991436,3860,966586,111,24850,1926,6,3759,79,0,32,229410.0,130000.0,-52.0,-50.0,-44.0,-46.0,-51.0,-49.0,-43.0,-46.0,-90.0,-93.0,-90.0,-93.0,38.0,43.0,46.0,47.0,0
4050,CC:2F:71:3F:1F:24,4442555,1176903875,619442,694714077,3823113,482189798,37,511522,561922170,510906,561848006,616,74164,493841,10,619679,56158,34,447,130000.0,39000.0,-67.0,-65.0,-71.0,-67.0,-67.0,-65.0,-70.0,-67.0,-91.0,-93.0,-90.0,-93.0,24.0,28.0,19.0,26.0,0
4051,CC:2F:71:3E:C5:1F,3823858,482280967,745,91169,3823113,482189798,0,3124,262385,2580,197749,544,64636,789,8,1076,18,0,34,130000.0,39000.0,-70.0,-71.0,-67.0,-60.0,-70.0,-71.0,-67.0,-60.0,-91.0,-93.0,-90.0,-93.0,21.0,22.0,23.0,33.0,0
4052,BA:8C:B9:54:50:24,3827809,488333518,4694,6143518,3823115,482190000,0,8208,1631736,8187,1628379,21,3357,2306,14,5069,36,0,53,216660.0,130000.0,-39.0,-36.0,-44.0,-51.0,-43.0,-35.0,-43.0,-48.0,-91.0,-93.0,-90.0,-93.0,52.0,57.0,46.0,42.0,0
4053,92:69:1D:31:68:E9,3826752,485698233,3633,3507829,3823119,482190404,0,3971,991436,3860,966586,111,24850,1926,6,3759,79,0,32,229410.0,130000.0,-52.0,-50.0,-44.0,-46.0,-51.0,-49.0,-43.0,-46.0,-91.0,-93.0,-90.0,-93.0,39.0,43.0,46.0,47.0,0
4054,CC:2F:71:3F:1F:24,4442603,1176918909,619484,694728505,3823119,482190404,37,511548,561927114,510932,561852950,616,74164,493867,10,619721,56172,34,447,130000.0,39000.0,-67.0,-65.0,-70.0,-67.0,-67.0,-65.0,-70.0,-67.0,-91.0,-93.0,-90.0,-93.0,24.0,28.0,20.0,26.0,0
4055,CC:2F:71:3E:C5:1F,3823865,482281846,745,91169,3823120,482190677,0,3124,262385,2580,197749,544,64636,789,8,1076,18,0,34,130000.0,39000.0,-70.0,-71.0,-67.0,-60.0,-70.0,-71.0,-67.0,-60.0,-91.0,-93.0,-90.0,-93.0,21.0,22.0,23.0,33.0,0
4056,BA:8C:B9:54:50:24,3827814,488334195,4694,6143518,3823120,482190677,0,8208,1631736,8187,1628379,21,3357,2306,14,5069,36,0,53,216660.0,130000.0,-39.0,-36.0,-44.0,-51.0,-43.0,-35.0,-43.0,-48.0,-91.0,-93.0,-90.0,-93.0,52.0,57.0,46.0,42.0,0
4057,92:69:1D:31:68:E9,3826754,485698566,3633,3507829,3823121,482190737,0,3971,991436,3860,966586,111,24850,1926,6,3759,79,0,32,229410.0,130000.0,-52.0,-50.0,-44.0,-46.0,-51.0,-49.0,-43.0,-46.0,-91.0,-93.0,-90.0,-93.0,39.0,43.0,46.0,47.0,0
4058,CC:2F:71:3F:1F:24,4442650,1176934052,619527,694743113,3823123,482190939,37,511575,561932174,510959,561858010,616,74164,493894,10,619764,56175,34,447,130000.0,43333.0,-67.0,-65.0,-70.0,-67.0,-67.0,-65.0,-70.0,-67.0,-91.0,-93.0,-90.0,-93.0,24.0,28.0,20.0,26.0,0
4059,CC:2F:71:3E:C5:1F,3823868,482282108,745,91169,3823123,482190939,0,3124,262385,2580,197749,544,64636,789,8,1076,18,0,34,130000.0,39000.0,-70.0,-71.0,-67.0,-60.0,-70.0,-71.0,-67.0,-60.0,-91.0,-93.0,-90.0,-93.0,21.0,22.0,23.0,33.0,0
4060,BA:8C:B9:54:50:24,3827817,488334457,4694,6143518,3823123,482190939,0,8208,1631736,8187,1628379,21,3357,2306,14,5069,36,0,53,216660.0,130000.0,-39.0,-36.0,-44.0,-51.0,-43.0,-35.0,-43.0,-48.0,-91.0,-93.0,-90.0,-93.0,52.0,57.0,46.0,42.0,0
4061,92:69:1D:31:68:E9,3826762,485699374,3633,3507829,3823129,482191545,0,3971,991436,3860,966586,111,24850,1926,6,3759,79,0,32,229410.0,130000.0,-52.0,-50.0,-44.0,-46.0,-51.0,-49.0,-43.0,-46.0,-91.0,-93.0,-90.0,-93.0,39.0,43.0,46.0,47.0,0
4062,CC:2F:71:3F:1F:24,4442698,1176949086,619569,694757541,3823129,482191545,37,511601,561937118,510985,561862954,616,74164,493920,10,619806,56192,34,447,117000.0,39000.0,-67.0,-65.0,-71.0,-67.0,-67.0,-65.0,-70.0,-67.0,-91.0,-93.0,-90.0,-93.0,24.0,28.0,19.0,26.0,0
4063,CC:2F:71:3E:C5:1F,3823874,482282714,745,91169,3823129,482191545,0,3124,262385,2580,197749,544,64636,789,8,1076,18,0,34,130000.0,39000.0,-70.0,-71.0,-67.0,-60.0,-70.0,-71.0,-67.0,-60.0,-91.0,-93.0,-90.0,-93.0,21.0,22.0,23.0,33.0,0
4064,BA:8C:B9:54:50:24,3827823,488335063,4694,6143518,3823129,482191545,0,8208,1631736,8187,1628379,21,3357,2306,14,5069,36,0,53,216660.0,130000.0,-39.0,-36.0,-44.0,-51.0,-43.0,-35.0,-43.0,-48.0,-91.0,-93.0,-90.0,-93.0,52.0,57.0,46.0,42.0,0
4065,92:69:1D:31:68:E9,3826762,485699374,3633,3507829,3823129,482191545,0,3971,991436,3860,966586,111,24850,1926,6,3759,79,0,32,229410.0,130000.0,-52.0,-50.0,-44.0,-46.0,-51.0,-49.0,-43.0,-46.0,-91.0,-93.0,-90.0,-93.0,39.0,43.0,46.0,47.0,0
4066,CC:2F:71:3F:1F:24,4442740,1176963514,619611,694771969,3823129,482191545,37,511626,561941922,511010,561867758,616,74164,493945,10,619847,56195,34,447,130000.0,43333.0,-67.0,-65.0,-70.0,-67.0,-67.0,-65.0,-70.0,-67.0,-91.0,-93.0,-90.0,-93.0,24.0,28.0,20.0,26.0,0
4067,CC:2F:71:3E:C5:1F,3823876,482282916,745,91169,3823131,482191747,0,3124,262385,2580,197749,544,64636,789,8,1076,18,0,34,130000.0,39000.0,-70.0,-71.0,-67.0,-60.0,-70.0,-71.0,-67.0,-60.0,-91.0,-93.0,-90.0,-93.0,21.0,22.0,23.0,33.0,0
4068,BA:8C:B9:54:50:24,3827825,488335265,4694,6143518,3823131,482191747,0,8208,1631736,8187,1628379,21,3357,2306,14,5069,36,0,53,216660.0,130000.0,-39.0,-36.0,-44.0,-51.0,-43.0,-35.0,-43.0,-48.0,-91.0,-93.0,-90.0,-93.0,52.0,57.0,46.0,42.0,0
4069,92:69:1D:31:68:E9,3826771,485700242,3633,3507829,3823138,482192413,0,3971,991436,3860,966586,111,24850,1926,6,3759,79,0,32,229410.0,130000.0,-52.0,-50.0,-44.0,-46.0,-51.0,-49.0,-43.0,-46.0,-91.0,-93.0,-90.0,-93.0,39.0,43.0,46.0,47.0,0
4070,CC:2F:71:3F:1F:24,4442792,1176979068,619654,694786655,3823138,482192413,37,511651,561946738,511035,561872574,616,74164,493970,10,619891,56209,34,447,130000.0,39000.0,-67.0,-65.0,-70.0,-67.0,-67.0,-65.0,-70.0,-67.0,-91.0,-93.0,-90.0,-93.0,24.0,28.0,20.0,26.0,0
4071,CC:2F:71:3E:C5:1F,3823883,482283582,745,91169,3823138,482192413,0,3124,262385,2580,197749,544,64636,789,8,1076,18,0,34,130000.0,39000.0,-70.0,-71.0,-67.0,-60.0,-70.0,-71.0,-67.0,-60.0,-91.0,-93.0,-90.0,-93.0,21.0,22.0,23.0,33.0,0
4072,BA:8C:B9:54:50:24,3827832,488335931,4694,6143518,3823138,482192413,0,8208,1631736,8187,1628379,21,3357,2306,14,5069,36,0,53,216660.0,130000.0,-39.0,-36.0,-44.0,-51.0,-43.0,-35.0,-43.0,-48.0,-91.0,-93.0,-90.0,-93.0,52.0,57.0,46.0,42.0,0
4073,92:69:1D:31:68:E9,3826771,485700242,3633,3507829,3823138,482192413,0,3971,991436,3860,966586,111,24850,1926,6,3759,79,0,32,229410.0,130000.0,-52.0,-50.0,-44.0,-46.0,-51.0,-49.0,-43.0,-46.0,-91.0,-93.0,-90.0,-93.0,39.0,43.0,46.0,47.0,0
4074,CC:2F:71:3F:1F:24,4442837,1176993822,619697,694801207,3823140,482192615,37,511677,561951682,511061,561877518,616,74164,493996,10,619934,56211,34,447,130000.0,43333.0,-67.0,-65.0,-70.0,-67.0,-67.0,-65.0,-70.0,-67.0,-91.0,-93.0,-90.0,-93.0,24.0,28.0,20.0,26.0,0
4075,CC:2F:71:3E:C5:1F,3823885,482283784,745,91169,3823140,482192615,0,3124,262385,2580,197749,544,64636,789,8,1076,18,0,34,130000.0,39000.0,-70.0,-71.0,-67.0,-60.0,-70.0,-71.0,-67.0,-60.0,-91.0,-93.0,-90.0,-93.0,21.0,22.0,23.0,33.0,0
4076,BA:8C:B9:54:50:24,3827834,488336133,4694,6143518,3823140,482192615,0,8208,1631736,8187,1628379,21,3357,2306,14,5069,36,0,53,216660.0,130000.0,-39.0,-36.0,-44.0,-51.0,-43.0,-35.0,-43.0,-48.0,-91.0,-93.0,-90.0,-93.0,52.0,57.0,46.0,42.0,0
4077,92:69:1D:31:68:E9,3826779,485701050,3633,3507829,3823146,482193221,0,3971,991436,3860,966586,111,24850,1926,6,3759,79,0,32,229410.0,130000.0,-52.0,-50.0,-44.0,-46.0,-51.0,-49.0,-43.0,-46.0,-91.0,-93.0,-90.0,-93.0,39.0,43.0,46.0,47.0,0
4078,CC:2F:71:3F:1F:24,4442885,1177008912,619739,694815691,3823146,482193221,37,511702,561956486,511086,561882322,616,74164,494021,10,619976,56227,34,447,130000.0,39000.0,-67.0,-65.0,-70.0,-67.0,-67.0,-65.0,-70.0,-67.0,-91.0,-93.0,-90.0,-93.0,24.0,28.0,20.0,26.0,0
4079,CC:2F:71:3E:C5:1F,3823891,482284390,745,91169,3823146,482193221,0,3124,262385,2580,197749,544,64636,789,8,1076,18,0,34,130000.0,39000.0,-70.0,-71.0,-67.0,-60.0,-70.0,-71.0,-67.0,-60.0,-91.0,-93.0,-90.0,-93.0,21.0,22.0,23.0,33.0,0
4080,BA:8C:B9:54:50:24,3827841,488336799,4694,6143518,3823147,482193281,0,8208,1631736,8187,1628379,21,3357,2306,14,5069,36,0,53,216660.0,130000.0,-39.0,-36.0,-44.0,-51.0,-43.0,-35.0,-43.0,-48.0,-91.0,-93.0,-90.0,-93.0,52.0,57.0,46.0,42.0,0
4081,92:69:1D:31:68:E9,3826780,485701110,3633,3507829,3823147,482193281,0,3971,991436,3860,966586,111,24850,1926,6,3759,79,0,32,229410.0,130000.0,-52.0,-50.0,-44.0,-46.0,-51.0,-49.0,-43.0,-46.0,-91.0,-93.0,-90.0,-93.0,39.0,43.0,46.0,47.0,0
4082,CC:2F:71:3F:1F:24,4442928,1177023344,619781,694830063,3823147,482193281,37,511729,561961546,511113,561887382,616,74164,494048,10,620018,56234,34,447,130000.0,43333.0,-67.0,-65.0,-70.0,-67.0,-66.0,-65.0,-70.0,-67.0,-91.0,-93.0,-90.0,-93.0,24.0,28.0,20.0,26.0,0
4083,CC:2F:71:3E:C5:1F,3823892,482284450,745,91169,3823147,482193281,0,3124,262385,2580,197749,544,64636,789,8,1076,18,0,34,130000.0,39000.0,-70.0,-71.0,-67.0,-60.0,-70.0,-71.0,-67.0,-60.0,-91.0,-93.0,-90.0,-93.0,21.0,22.0,23.0,33.0,0
4084,BA:8C:B9:54:50:24,3827841,488336799,4694,6143518,3823147,482193281,0,8208,1631736,8187,1628379,21,3357,2306,14,5069,36,0,53,216660.0,130000.0,-39.0,-36.0,-44.0,-51.0,-43.0,-35.0,-43.0,-48.0,-91.0,-93.0,-90.0,-93.0,52.0,57.0,46.0,42.0,0
4085,92:69:1D:31:68:E9,3826788,485701918,3633,3507829,3823155,482194089,0,3971,991436,3860,966586,111,24850,1926,6,3759,79,0,32,229410.0,130000.0,-52.0,-50.0,-44.0,-46.0,-51.0,-49.0,-43.0,-46.0,-91.0,-93.0,-90.0,-93.0,39.0,43.0,46.0,47.0,0
4086,CC:2F:71:3F:1F:24,4442977,1177038568,619822,694844479,3823155,482194089,37,511754,561966350,511138,561892186,616,74164,494073,10,620059,56236,34,447,130000.0,43333.0,-67.0,-65.0,-70.0,-67.0,-67.0,-65.0,-70.0,-67.0,-91.0,-93.0,-90.0,-93.0,24.0,28.0,20.0,26.0,0
4087,CC:2F:71:3E:C5:1F,3823900,482285258,745,91169,3823155,482194089,0,3124,262385,2580,197749,544,64636,789,8,1076,18,0,34,130000.0,39000.0,-70.0,-71.0,-67.0,-60.0,-70.0,-71.0,-67.0,-60.0,-91.0,-93.0,-90.0,-93.0,21.0,22.0,23.0,33.0,0
4088,BA:8C:B9:54:50:24,3827849,488337607,4694,6143518,3823155,482194089,0,8208,1631736,8187,1628379,21,3357,2306,14,5069,36,0,53,216660.0,130000.0,-39.0,-36.0,-44.0,-51.0,-43.0,-35.0,-43.0,-48.0,-91.0,-93.0,-90.0,-93.0,52.0,57.0,46.0,42.0,0
4089,92:69:1D:31:68:E9,3826789,485701978,3633,3507829,3823156,482194149,0,3972,991504,3861,966654,111,24850,1926,6,3759,79,0,32,229410.0,130000.0,-52.0,-50.0,-45.0,-46.0,-51.0,-49.0,-43.0,-46.0,-91.0,-93.0,-90.0,-93.0,39.0,43.0,45.0,47.0,0
4090,CC:2F:71:3F:1F:24,4443020,1177053056,619864,694858907,3823156,482194149,37,511782,561971526,511166,561897362,616,74164,494101,10,620101,56253,34,447,117000.0,39000.0,-67.0,-65.0,-70.0,-67.0,-67.0,-65.0,-70.0,-67.0,-91.0,-93.0,-90.0,-93.0,24.0,28.0,20.0,26.0,0
4091,CC:2F:71:3E:C5:1F,3823901,482285318,745,91169,3823156,482194149,0,3124,262385,2580,197749,544,64636,789,8,1076,18,0,34,130000.0,39000.0,-70.0,-71.0,-67.0,-60.0,-70.0,-71.0,-67.0,-60.0,-91.0,-93.0,-90.0,-93.0,21.0,22.0,23.0,33.0,0
4092,BA:8C:B9:54:50:24,3827850,488337667,4694,6143518,3823156,482194149,0,8208,1631736,8187,1628379,21,3357,2306,14,5069,36,0,53,216660.0,130000.0,-39.0,-36.0,-44.0,-51.0,-43.0,-35.0,-43.0,-48.0,-91.0,-93.0,-90.0,-93.0,52.0,57.0,46.0,42.0,0
4093,92:69:1D:31:68:E9,3826797,485702786,3633,3507829,3823164,482194957,0,3972,991504,3861,966654,111,24850,1926,6,3759,79,0,32,229410.0,130000.0,-52.0,-50.0,-45.0,-46.0,-51.0,-49.0,-43.0,-46.0,-91.0,-93.0,-90.0,-93.0,39.0,43.0,45.0,47.0,0
4094,CC:2F:71:3F:1F:24,4443070,1177068180,619906,694873223,3823164,482194957,37,511810,561976726,511194,561902562,616,74164,494129,10,620143,56267,34,447,117000.0,39000.0,-67.0,-65.0,-70.0,-67.0,-67.0,-65.0,-70.0,-67.0,-91.0,-93.0,-90.0,-93.0,24.0,28.0,20.0,26.0,0
4095,CC:2F:71:3E:C5:1F,3823909,482286126,745,91169,3823164,482194957,0,3124,262385,2580,197749,544,64636,789,8,1076,18,0,34,130000.0,39000.0,-70.0,-71.0,-67.0,-60.0,-70.0,-71.0,-67.0,-60.0,-91.0,-93.0,-90.0,-93.0,21.0,22.0,23.0,33.0,0
4096,BA:8C:B9:54:50:24,3827858,488338475,4694,6143518,3823164,482194957,0,8208,1631736,8187,1628379,21,3357,2306,14,5069,36,0,53,216660.0,130000.0,-39.0,-36.0,-44.0,-51.0,-43.0,-35.0,-43.0,-48.0,-91.0,-93.0,-90.0,-93.0,52.0,57.0,46.0,42.0,0
4097,92:69:1D:31:68:E9,3826797,485702786,3633,3507829,3823164,482194957,0,3972,991504,3861,966654,111,24850,1926,6,3759,79,0,32,229410.0,130000.0,-52.0,-50.0,-45.0,-46.0,-51.0,-49.0,-43.0,-46.0,-91.0,-93.0,-90.0,-93.0,39.0,43.0,45.0,47.0,0
4098,CC:2F:71:3F:1F:24,4443113,1177082732,619949,694887775,3823164,482194957,37,511835,561981530,511219,561907366,616,74164,494154,10,620186,56269,34,447,130000.0,43333.0,-67.0,-65.0,-71.0,-68.0,-67.0,-65.0,-70.0,-67.0,-91.0,-93.0,-90.0,-93.0,24.0,28.0,19.0,25.0,0
4099,CC:2F:71:3E:C5:1F,3823909,482286126,745,91169,3823164,482194957,0,3124,262385,2580,197749,544,64636,789,8,1076,18,0,34,130000.0,39000.0,-70.0,-71.0,-67.0,-60.0,-70.0,-71.0,-67.0,-60.0,-91.0,-93.0,-90.0,-93.0,21.0,22.0,23.0,33.0,0
4100,BA:8C:B9:54:50:24,3827858,488338475,4694,6143518,3823164,482194957,0,8208,1631736,8187,1628379,21,3357,2306,14,5069,36,0,53,216660.0,130000.0,-39.0,-36.0,-44.0,-51.0,-43.0,-35.0,-43.0,-48.0,-91.0,-93.0,-90.0,-93.0,52.0,57.0,46.0,42.0,0
4101,92:69:1D:31:68:E9,3826806,485703654,3633,3507829,3823173,482195825,0,3972,991504,3861,966654,111,24850,1926,6,3759,79,0,32,229410.0,130000.0,-52.0,-50.0,-45.0,-46.0,-51.0,-49.0,-43.0,-46.0,-91.0,-93.0,-90.0,-93.0,39.0,43.0,45.0,47.0,0
4102,CC:2F:71:3F:1F:24,4443165,1177098270,619992,694902445,3823173,482195825,37,511865,561986962,511249,561912798,616,74164,494184,10,620229,56275,34,447,130000.0,43333.0,-67.0,-65.0,-70.0,-67.0,-67.0,-65.0,-70.0,-67.0,-91.0,-93.0,-90.0,-93.0,24.0,28.0,20.0,26.0,0
4103,CC:2F:71:3E:C5:1F,3823918,482286994,745,91169,3823173,482195825,0,3124,262385,2580,197749,544,64636,789,8,1076,18,0,34,130000.0,39000.0,-70.0,-71.0,-67.0,-60.0,-70.0,-71.0,-67.0,-60.0,-91.0,-93.0,-90.0,-93.0,21.0,22.0,23.0,33.0,0
4104,BA:8C:B9:54:50:24,3827867,488339343,4694,6143518,3823173,482195825,0,8208,1631736,8187,1628379,21,3357,2306,14,5069,36,0,53,216660.0,130000.0,-39.0,-36.0,-44.0,-51.0,-43.0,-35.0,-43.0,-48.0,-91.0,-93.0,-90.0,-93.0,52.0,57.0,46.0,42.0,0
4105,92:69:1D:31:68:E9,3826807,485703714,3634,3507889,3823173,482195825,0,3974,991640,3863,966790,111,24850,1926,6,3760,79,0,32,229410.0,130000.0,-51.0,-47.0,-42.0,-49.0,-51.0,-49.0,-43.0,-47.0,-91.0,-93.0,-90.0,-93.0,40.0,46.0,48.0,44.0,0
4106,CC:2F:71:3F:1F:24,4443208,1177112814,620035,694916989,3823173,482195825,37,511892,561991998,511276,561917834,616,74164,494211,10,620272,56295,34,447,117000.0,39000.0,-67.0,-65.0,-70.0,-67.0,-67.0,-65.0,-70.0,-67.0,-91.0,-93.0,-90.0,-93.0,24.0,28.0,20.0,26.0,0
4107,CC:2F:71:3E:C5:1F,3823919,482287110,746,91285,3823173,482195825,0,3126,262525,2582,197889,544,64636,789,8,1077,18,0,34,130000.0,39000.0,-70.0,-71.0,-67.0,-60.0,-70.0,-71.0,-67.0,-60.0,-91.0,-93.0,-90.0,-93.0,21.0,22.0,23.0,33.0,0
4108,BA:8C:B9:54:50:24,3827869,488339732,4695,6143634,3823174,482196098,0,8212,1632008,8191,1628651,21,3357,2306,14,5070,36,0,53,216660.0,130000.0,-49.0,-35.0,-42.0,-44.0,-43.0,-35.0,-42.0,-47.0,-91.0,-93.0,-90.0,-93.0,42.0,58.0,48.0,49.0,0
4109,92:69:1D:31:68:E9,3826817,485704857,3634,3507889,3823183,482196968,0,3974,991640,3863,966790,111,24850,1926,6,3760,79,0,32,229410.0,130000.0,-51.0,-47.0,-42.0,-49.0,-51.0,-49.0,-43.0,-47.0,-91.0,-93.0,-90.0,-93.0,40.0,46.0,48.0,44.0,0
4110,CC:2F:71:3F:1F:24,4443259,1177128261,620076,694931293,3823183,482196968,37,511918,561996978,511302,561922814,616,74164,494237,10,620313,56305,34,447,130000.0,43333.0,-67.0,-65.0,-70.0,-67.0,-67.0,-65.0,-70.0,-67.0,-91.0,-93.0,-90.0,-93.0,24.0,28.0,20.0,26.0,0
4111,CC:2F:71:3E:C5:1F,3823930,482288313,746,91285,3823184,482197028,0,3128,262713,2583,197959,545,64754,790,8,1077,18,0,34,130000.0,39000.0,-70.0,-71.0,-68.0,-60.0,-70.0,-71.0,-67.0,-60.0,-91.0,-93.0,-90.0,-93.0,21.0,22.0,22.0,33.0,0
4112,BA:8C:B9:54:50:24,3827879,488340662,4695,6143634,3823184,482197028,0,8212,1632008,8191,1628651,21,3357,2306,14,5070,36,0,53,216660.0,130000.0,-49.0,-35.0,-42.0,-44.0,-43.0,-35.0,-42.0,-47.0,-91.0,-93.0,-90.0,-93.0,42.0,58.0,48.0,49.0,0
4113,92:69:1D:31:68:E9,3826818,485704917,3634,3507889,3823184,482197028,0,3974,991640,3863,966790,111,24850,1926,6,3760,79,0,32,229410.0,130000.0,-51.0,-47.0,-42.0,-49.0,-51.0,-49.0,-43.0,-47.0,-91.0,-93.0,-90.0,-93.0,40.0,46.0,48.0,44.0,0
4114,CC:2F:71:3F:1F:24,4443303,1177142873,620119,694945845,3823184,482197028,37,511944,562001922,511328,561927758,616,74164,494263,10,620355,56326,34,447,117000.0,39000.0,-67.0,-65.0,-70.0,-67.0,-67.0,-65.0,-70.0,-67.0,-91.0,-93.0,-90.0,-93.0,24.0,28.0,20.0,26.0,0
4115,CC:2F:71:3E:C5:1F,3823930,482288313,746,91285,3823184,482197028,0,3128,262713,2583,197959,545,64754,790,8,1077,18,0,34,130000.0,39000.0,-70.0,-71.0,-68.0,-60.0,-70.0,-71.0,-67.0,-60.0,-91.0,-93.0,-90.0,-93.0,21.0,22.0,22.0,33.0,0
4116,BA:8C:B9:54:50:24,3827879,488340662,4695,6143634,3823184,482197028,0,8212,1632008,8191,1628651,21,3357,2306,14,5070,36,0,53,216660.0,130000.0,-49.0,-35.0,-42.0,-44.0,-43.0,-35.0,-42.0,-47.0,-91.0,-93.0,-90.0,-93.0,42.0,58.0,48.0,49.0,0
4117,92:69:1D:31:68:E9,3826826,485705725,3634,3507889,3823192,482197836,0,3974,991640,3863,966790,111,24850,1926,6,3760,79,0,32,229410.0,130000.0,-51.0,-47.0,-42.0,-49.0,-51.0,-49.0,-43.0,-47.0,-91.0,-93.0,-90.0,-93.0,40.0,46.0,48.0,44.0,0
4118,CC:2F:71:3F:1F:24,4443351,1177157861,620159,694960025,3823192,482197836,37,511970,562006866,511354,561932702,616,74164,494289,10,620396,56332,34,447,130000.0,43333.0,-67.0,-65.0,-70.0,-67.0,-67.0,-65.0,-70.0,-67.0,-91.0,-93.0,-90.0,-93.0,24.0,28.0,20.0,26.0,0
4119,CC:2F:71:3E:C5:1F,3823938,482289121,746,91285,3823192,482197836,0,3128,262713,2583,197959,545,64754,790,8,1077,18,0,34,130000.0,39000.0,-70.0,-71.0,-68.0,-60.0,-70.0,-71.0,-67.0,-60.0,-91.0,-93.0,-90.0,-93.0,21.0,22.0,22.0,33.0,0
4120,BA:8C:B9:54:50:24,3827887,488341470,4695,6143634,3823192,482197836,0,8212,1632008,8191,1628651,21,3357,2306,14,5070,36,0,53,216660.0,130000.0,-49.0,-35.0,-42.0,-44.0,-43.0,-35.0,-42.0,-47.0,-91.0,-93.0,-90.0,-93.0,42.0,58.0,48.0,49.0,0
4121,92:69:1D:31:68:E9,3826829,485706153,3634,3507889,3823195,482198264,0,3974,991640,3863,966790,111,24850,1926,6,3760,79,0,32,229410.0,130000.0,-51.0,-47.0,-42.0,-49.0,-51.0,-49.0,-43.0,-47.0,-91.0,-93.0,-90.0,-93.0,40.0,46.0,48.0,44.0,0
4122,CC:2F:71:3F:1F:24,4443396,1177172829,620201,694974565,3823195,482198264,37,511995,562011670,511379,561937506,616,74164,494314,10,620438,56336,34,447,130000.0,43333.0,-67.0,-65.0,-70.0,-67.0,-67.0,-65.0,-70.0,-67.0,-91.0,-93.0,-90.0,-93.0,24.0,28.0,20.0,26.0,0
4123,CC:2F:71:3E:C5:1F,3823941,482289549,746,91285,3823195,482198264,0,3128,262713,2583,197959,545,64754,790,8,1077,18,0,34,130000.0,39000.0,-70.0,-71.0,-68.0,-60.0,-70.0,-71.0,-67.0,-60.0,-91.0,-93.0,-90.0,-93.0,21.0,22.0,22.0,33.0,0
4124,BA:8C:B9:54:50:24,3827890,488341898,4695,6143634,3823195,482198264,0,8212,1632008,8191,1628651,21,3357,2306,14,5070,36,0,53,216660.0,130000.0,-49.0,-35.0,-42.0,-44.0,-43.0,-35.0,-42.0,-47.0,-91.0,-93.0,-90.0,-93.0,42.0,58.0,48.0,49.0,0
4125,92:69:1D:31:68:E9,3826837,485706961,3634,3507889,3823203,482199072,0,3974,991640,3863,966790,111,24850,1926,6,3760,79,0,32,229410.0,130000.0,-51.0,-47.0,-42.0,-49.0,-51.0,-49.0,-43.0,-47.0,-91.0,-94.0,-90.0,-93.0,40.0,47.0,48.0,44.0,0
4126,CC:2F:71:3F:1F:24,4443446,1177188071,620243,694988999,3823203,482199072,37,512023,562016870,511407,561942706,616,74164,494342,10,620480,56354,34,447,117000.0,39000.0,-67.0,-65.0,-71.0,-68.0,-67.0,-65.0,-70.0,-67.0,-91.0,-94.0,-90.0,-93.0,24.0,29.0,19.0,25.0,0
4127,CC:2F:71:3E:C5:1F,3823949,482290357,746,91285,3823203,482199072,0,3128,262713,2583,197959,545,64754,790,8,1077,18,0,34,130000.0,39000.0,-70.0,-71.0,-68.0,-60.0,-70.0,-71.0,-67.0,-60.0,-91.0,-94.0,-90.0,-93.0,21.0,23.0,22.0,33.0,0
4128,BA:8C:B9:54:50:24,3827898,488342706,4695,6143634,3823203,482199072,0,8212,1632008,8191,1628651,21,3357,2306,14,5070,36,0,53,216660.0,130000.0,-49.0,-35.0,-42.0,-44.0,-43.0,-35.0,-42.0,-47.0,-91.0,-94.0,-90.0,-93.0,42.0,59.0,48.0,49.0,0
4129,92:69:1D:31:68:E9,3826837,485706961,3634,3507889,3823203,482199072,0,3974,991640,3863,966790,111,24850,1926,6,3760,79,0,32,229410.0,130000.0,-51.0,-47.0,-42.0,-49.0,-51.0,-49.0,-43.0,-47.0,-91.0,-94.0,-90.0,-93.0,40.0,47.0,48.0,44.0,0
4130,CC:2F:71:3F:1F:24,4443487,1177202375,620284,695003303,3823203,482199072,37,512048,562021674,511432,561947510,616,74164,494367,10,620521,56359,34,447,130000.0,43333.0,-67.0,-65.0,-70.0,-67.0,-67.0,-65.0,-70.0,-67.0,-91.0,-94.0,-90.0,-93.0,24.0,29.0,20.0,26.0,0
4131,CC:2F:71:3E:C5:1F,3823949,482290357,746,91285,3823203,482199072,0,3128,262713,2583,197959,545,64754,790,8,1077,18,0,34,130000.0,39000.0,-70.0,-71.0,-68.0,-60.0,-70.0,-71.0,-67.0,-60.0,-91.0,-94.0,-90.0,-93.0,21.0,23.0,22.0,33.0,0
4132,BA:8C:B9:54:50:24,3827898,488342706,4695,6143634,3823203,482199072,0,8212,1632008,8191,1628651,21,3357,2306,14,5070,36,0,53,216660.0,130000.0,-49.0,-35.0,-42.0,-44.0,-43.0,-35.0,-42.0,-47.0,-91.0,-94.0,-90.0,-93.0,42.0,59.0,48.0,49.0,0
4133,92:69:1D:31:68:E9,3826846,485707829,3634,3507889,3823212,482199940,0,3974,991640,3863,966790,111,24850,1926,6,3760,79,0,32,229410.0,130000.0,-51.0,-47.0,-42.0,-49.0,-51.0,-49.0,-43.0,-47.0,-91.0,-94.0,-90.0,-93.0,40.0,47.0,48.0,44.0,0
4134,CC:2F:71:3F:1F:24,4443539,1177217907,620327,695017967,3823212,482199940,37,512073,562026478,511457,561952314,616,74164,494392,10,620564,56366,34,447,130000.0,43333.0,-67.0,-65.0,-70.0,-68.0,-67.0,-65.0,-70.0,-67.0,-91.0,-94.0,-90.0,-93.0,24.0,29.0,20.0,25.0,0
4135,CC:2F:71:3E:C5:1F,3823958,482291225,746,91285,3823212,482199940,0,3128,262713,2583,197959,545,64754,790,8,1077,18,0,34,130000.0,39000.0,-70.0,-71.0,-68.0,-60.0,-70.0,-71.0,-67.0,-60.0,-91.0,-94.0,-90.0,-93.0,21.0,23.0,22.0,33.0,0
4136,BA:8C:B9:54:50:24,3827907,488343574,4695,6143634,3823212,482199940,0,8212,1632008,8191,1628651,21,3357,2306,14,5070,36,0,53,216660.0,130000.0,-49.0,-35.0,-42.0,-44.0,-43.0,-35.0,-42.0,-47.0,-91.0,-94.0,-90.0,-93.0,42.0,59.0,48.0,49.0,0
4137,92:69:1D:31:68:E9,3826846,485707829,3634,3507889,3823212,482199940,0,3974,991640,3863,966790,111,24850,1926,6,3760,79,0,32,229410.0,130000.0,-51.0,-47.0,-42.0,-49.0,-51.0,-49.0,-43.0,-47.0,-91.0,-94.0,-90.0,-93.0,40.0,47.0,48.0,44.0,0
4138,CC:2F:71:3F:1F:24,4443581,1177232335,620369,695032395,3823212,482199940,37,512099,562031422,511483,561957258,616,74164,494418,10,620606,56382,34,447,117000.0,39000.0,-67.0,-65.0,-70.0,-67.0,-67.0,-65.0,-70.0,-67.0,-91.0,-94.0,-90.0,-93.0,24.0,29.0,20.0,26.0,0
4139,CC:2F:71:3E:C5:1F,3823958,482291225,746,91285,3823212,482199940,0,3128,262713,2583,197959,545,64754,790,8,1077,18,0,34,130000.0,39000.0,-70.0,-71.0,-68.0,-60.0,-70.0,-71.0,-67.0,-60.0,-91.0,-94.0,-90.0,-93.0,21.0,23.0,22.0,33.0,0
4140,BA:8C:B9:54:50:24,3827907,488343574,4695,6143634,3823212,482199940,0,8212,1632008,8191,1628651,21,3357,2306,14,5070,36,0,53,216660.0,130000.0,-49.0,-35.0,-42.0,-44.0,-43.0,-35.0,-42.0,-47.0,-91.0,-94.0,-90.0,-93.0,42.0,59.0,48.0,49.0,0
4141,92:69:1D:31:68:E9,3826854,485708637,3634,3507889,3823220,482200748,0,3974,991640,3863,966790,111,24850,1926,6,3760,79,0,32,229410.0,130000.0,-51.0,-47.0,-42.0,-49.0,-51.0,-49.0,-43.0,-47.0,-91.0,-94.0,-90.0,-93.0,40.0,47.0,48.0,44.0,0
4142,CC:2F:71:3F:1F:24,4443632,1177247575,620411,695046767,3823221,482200808,37,512126,562036458,511510,561962294,616,74164,494445,10,620648,56400,34,447,130000.0,39000.0,-67.0,-65.0,-70.0,-67.0,-67.0,-65.0,-70.0,-67.0,-91.0,-94.0,-90.0,-93.0,24.0,29.0,20.0,26.0,0
4143,CC:2F:71:3E:C5:1F,3823967,482292093,746,91285,3823221,482200808,0,3128,262713,2583,197959,545,64754,790,8,1077,18,0,34,130000.0,39000.0,-70.0,-71.0,-68.0,-60.0,-70.0,-71.0,-67.0,-60.0,-91.0,-94.0,-90.0,-93.0,21.0,23.0,22.0,33.0,0
4144,BA:8C:B9:54:50:24,3827916,488344442,4695,6143634,3823221,482200808,0,8212,1632008,8191,1628651,21,3357,2306,14,5070,36,0,53,216660.0,130000.0,-49.0,-35.0,-42.0,-44.0,-43.0,-35.0,-42.0,-47.0,-91.0,-94.0,-90.0,-93.0,42.0,59.0,48.0,49.0,0
4145,92:69:1D:31:68:E9,3826855,485708697,3634,3507889,3823221,482200808,0,3974,991640,3863,966790,111,24850,1926,6,3760,79,0,32,229410.0,130000.0,-51.0,-47.0,-42.0,-49.0,-51.0,-49.0,-43.0,-47.0,-91.0,-94.0,-90.0,-93.0,40.0,47.0,48.0,44.0,0
4146,CC:2F:71:3F:1F:24,4443672,1177261749,620451,695060941,3823221,482200808,37,512153,562041518,511537,561967354,616,74164,494472,10,620688,56414,34,447,130000.0,39000.0,-67.0,-65.0,-70.0,-68.0,-67.0,-65.0,-70.0,-67.0,-91.0,-94.0,-90.0,-93.0,24.0,29.0,20.0,25.0,0
4147,CC:2F:71:3E:C5:1F,3823967,482292093,746,91285,3823221,482200808,0,3128,262713,2583,197959,545,64754,790,8,1077,18,0,34,130000.0,39000.0,-70.0,-71.0,-68.0,-60.0,-70.0,-71.0,-67.0,-60.0,-91.0,-94.0,-90.0,-93.0,21.0,23.0,22.0,33.0,0
4148,BA:8C:B9:54:50:24,3827917,488344504,4695,6143634,3823222,482200870,0,8212,1632008,8191,1628651,21,3357,2306,14,5070,36,0,53,216660.0,130000.0,-49.0,-35.0,-42.0,-44.0,-43.0,-35.0,-42.0,-47.0,-91.0,-94.0,-90.0,-93.0,42.0,59.0,48.0,49.0,0
4149,92:69:1D:31:68:E9,3826864,485709567,3634,3507889,3823230,482201678,0,3974,991640,3863,966790,111,24850,1926,6,3760,79,0,32,229410.0,130000.0,-51.0,-47.0,-42.0,-49.0,-51.0,-49.0,-43.0,-47.0,-91.0,-94.0,-90.0,-93.0,40.0,47.0,48.0,44.0,0
4150,CC:2F:71:3F:1F:24,4443724,1177277177,620494,695075499,3823230,482201678,37,512179,562046440,511562,561972158,617,74282,494498,10,620731,56416,34,447,130000.0,39000.0,-67.0,-65.0,-70.0,-68.0,-67.0,-65.0,-70.0,-67.0,-91.0,-94.0,-90.0,-93.0,24.0,29.0,20.0,25.0,0
4151,CC:2F:71:3E:C5:1F,3823976,482292963,746,91285,3823230,482201678,0,3128,262713,2583,197959,545,64754,790,8,1077,18,0,34,130000.0,39000.0,-70.0,-71.0,-68.0,-60.0,-70.0,-71.0,-67.0,-60.0,-91.0,-94.0,-90.0,-93.0,21.0,23.0,22.0,33.0,0
4152,BA:8C:B9:54:50:24,3827925,488345312,4695,6143634,3823230,482201678,0,8212,1632008,8191,1628651,21,3357,2306,14,5070,36,0,53,216660.0,130000.0,-49.0,-35.0,-42.0,-44.0,-43.0,-35.0,-42.0,-47.0,-91.0,-94.0,-90.0,-93.0,42.0,59.0,48.0,49.0,0
4153,92:69:1D:31:68:E9,3826865,485709627,3634,3507889,3823231,482201738,0,3974,991640,3863,966790,111,24850,1926,6,3760,79,0,32,229410.0,130000.0,-51.0,-47.0,-42.0,-49.0,-51.0,-49.0,-43.0,-47.0,-91.0,-94.0,-90.0,-93.0,40.0,47.0,48.0,44.0,0
4154,CC:2F:71:3F:1F:24,4443767,1177291665,620536,695089927,3823231,482201738,37,512205,562051384,511588,561977102,617,74282,494524,10,620773,56443,34,447,130000.0,39000.0,-67.0,-65.0,-70.0,-67.0,-67.0,-65.0,-70.0,-67.0,-91.0,-94.0,-90.0,-93.0,24.0,29.0,20.0,26.0,0
4155,CC:2F:71:3E:C5:1F,3823977,482293023,746,91285,3823231,482201738,0,3128,262713,2583,197959,545,64754,790,8,1077,18,0,34,130000.0,39000.0,-70.0,-71.0,-68.0,-60.0,-70.0,-71.0,-67.0,-60.0,-91.0,-94.0,-90.0,-93.0,21.0,23.0,22.0,33.0,0
4156,BA:8C:B9:54:50:24,3827926,488345372,4695,6143634,3823231,482201738,0,8212,1632008,8191,1628651,21,3357,2306,14,5070,36,0,53,216660.0,130000.0,-49.0,-35.0,-42.0,-44.0,-43.0,-35.0,-42.0,-47.0,-91.0,-94.0,-90.0,-93.0,42.0,59.0,48.0,49.0,0
4157,92:69:1D:31:68:E9,3826873,485710435,3634,3507889,3823239,482202546,0,3974,991640,3863,966790,111,24850,1926,6,3760,79,0,32,229410.0,130000.0,-51.0,-47.0,-42.0,-49.0,-51.0,-49.0,-43.0,-47.0,-91.0,-94.0,-90.0,-93.0,40.0,47.0,48.0,44.0,0
4158,CC:2F:71:3F:1F:24,4443816,1177306727,620577,695104181,3823239,482202546,37,512230,562056188,511613,561981906,617,74282,494549,10,620814,56456,34,447,117000.0,39000.0,-67.0,-65.0,-70.0,-67.0,-67.0,-65.0,-70.0,-67.0,-91.0,-94.0,-90.0,-93.0,24.0,29.0,20.0,26.0,0
4159,CC:2F:71:3E:C5:1F,3823985,482293831,746,91285,3823239,482202546,0,3128,262713,2583,197959,545,64754,790,8,1077,18,0,34,130000.0,39000.0,-70.0,-71.0,-68.0,-60.0,-70.0,-71.0,-67.0,-60.0,-91.0,-94.0,-90.0,-93.0,21.0,23.0,22.0,33.0,0
4160,BA:8C:B9:54:50:24,3827934,488346180,4695,6143634,3823239,482202546,0,8212,1632008,8191,1628651,21,3357,2306,14,5070,36,0,53,216660.0,130000.0,-49.0,-35.0,-42.0,-44.0,-43.0,-35.0,-42.0,-47.0,-91.0,-94.0,-90.0,-93.0,42.0,59.0,48.0,49.0,0
4161,92:69:1D:31:68:E9,3826874,485710708,3634,3507889,3823240,482202819,0,3974,991640,3863,966790,111,24850,1926,6,3760,79,0,32,229410.0,130000.0,-51.0,-47.0,-42.0,-49.0,-51.0,-49.0,-43.0,-47.0,-91.0,-94.0,-90.0,-93.0,40.0,47.0,48.0,44.0,0
4162,CC:2F:71:3F:1F:24,4443858,1177321304,620618,695118485,3823240,482202819,37,512255,562060992,511638,561986710,617,74282,494574,10,620855,56461,34,447,130000.0,43333.0,-67.0,-65.0,-70.0,-67.0,-67.0,-65.0,-70.0,-67.0,-91.0,-94.0,-90.0,-93.0,24.0,29.0,20.0,26.0,0
4163,CC:2F:71:3E:C5:1F,3823986,482294104,746,91285,3823240,482202819,0,3128,262713,2583,197959,545,64754,790,8,1077,18,0,34,130000.0,39000.0,-70.0,-71.0,-68.0,-60.0,-70.0,-71.0,-67.0,-60.0,-91.0,-94.0,-90.0,-93.0,21.0,23.0,22.0,33.0,0
4164,BA:8C:B9:54:50:24,3827935,488346453,4695,6143634,3823240,482202819,0,8212,1632008,8191,1628651,21,3357,2306,14,5070,36,0,53,216660.0,130000.0,-49.0,-35.0,-42.0,-44.0,-43.0,-35.0,-42.0,-47.0,-91.0,-94.0,-90.0,-93.0,42.0,59.0,48.0,49.0,0
4165,92:69:1D:31:68:E9,3826883,485711576,3634,3507889,3823249,482203687,0,3974,991640,3863,966790,111,24850,1926,6,3760,79,0,32,229410.0,130000.0,-51.0,-47.0,-42.0,-49.0,-51.0,-49.0,-43.0,-47.0,-91.0,-94.0,-90.0,-93.0,40.0,47.0,48.0,44.0,0
4166,CC:2F:71:3F:1F:24,4443909,1177336656,620660,695132969,3823249,482203687,37,512280,562065796,511663,561991514,617,74282,494599,10,620897,56470,34,447,130000.0,39000.0,-67.0,-65.0,-71.0,-68.0,-67.0,-65.0,-70.0,-67.0,-91.0,-94.0,-90.0,-93.0,24.0,29.0,19.0,25.0,0
4167,CC:2F:71:3E:C5:1F,3823995,482294972,746,91285,3823249,482203687,0,3128,262713,2583,197959,545,64754,790,8,1077,18,0,34,130000.0,39000.0,-70.0,-71.0,-68.0,-60.0,-70.0,-71.0,-67.0,-60.0,-91.0,-94.0,-90.0,-93.0,21.0,23.0,22.0,33.0,0
4168,BA:8C:B9:54:50:24,3827944,488347321,4695,6143634,3823249,482203687,0,8213,1632076,8192,1628719,21,3357,2306,14,5070,36,0,53,216660.0,130000.0,-39.0,-36.0,-44.0,-51.0,-42.0,-35.0,-43.0,-48.0,-91.0,-94.0,-90.0,-93.0,52.0,58.0,46.0,42.0,0
4169,92:69:1D:31:68:E9,3826883,485711576,3634,3507889,3823249,482203687,0,3974,991640,3863,966790,111,24850,1926,6,3760,79,0,32,229410.0,130000.0,-51.0,-47.0,-42.0,-49.0,-51.0,-49.0,-43.0,-47.0,-91.0,-94.0,-90.0,-93.0,40.0,47.0,48.0,44.0,0
4170,CC:2F:71:3F:1F:24,4443949,1177350836,620700,695147149,3823249,482203687,37,512307,562070856,511690,561996574,617,74282,494626,10,620937,56487,34,447,130000.0,39000.0,-67.0,-65.0,-71.0,-67.0,-67.0,-65.0,-70.0,-67.0,-91.0,-94.0,-90.0,-93.0,24.0,29.0,19.0,26.0,0
4171,CC:2F:71:3E:C5:1F,3823995,482294972,746,91285,3823249,482203687,0,3128,262713,2583,197959,545,64754,790,8,1077,18,0,34,130000.0,39000.0,-70.0,-71.0,-68.0,-60.0,-70.0,-71.0,-67.0,-60.0,-91.0,-94.0,-90.0,-93.0,21.0,23.0,22.0,33.0,0
4172,BA:8C:B9:54:50:24,3827944,488347321,4695,6143634,3823249,482203687,0,8213,1632076,8192,1628719,21,3357,2306,14,5070,36,0,53,216660.0,130000.0,-39.0,-36.0,-44.0,-51.0,-42.0,-35.0,-43.0,-48.0,-91.0,-94.0,-90.0,-93.0,52.0,58.0,46.0,42.0,0
4173,92:69:1D:31:68:E9,3826892,485712444,3634,3507889,3823258,482204555,0,3974,991640,3863,966790,111,24850,1926,6,3760,79,0,32,229410.0,130000.0,-51.0,-47.0,-42.0,-49.0,-51.0,-49.0,-43.0,-47.0,-91.0,-94.0,-90.0,-93.0,40.0,47.0,48.0,44.0,0
4174,CC:2F:71:3F:1F:24,4443999,1177366064,620741,695161509,3823258,482204555,37,512332,562075660,511715,562001378,617,74282,494651,10,620978,56491,34,447,130000.0,43333.0,-67.0,-65.0,-70.0,-67.0,-67.0,-65.0,-70.0,-67.0,-91.0,-94.0,-90.0,-93.0,24.0,29.0,20.0,26.0,0
4175,CC:2F:71:3E:C5:1F,3824004,482295840,746,91285,3823258,482204555,0,3128,262713,2583,197959,545,64754,790,8,1077,18,0,34,130000.0,39000.0,-70.0,-71.0,-68.0,-60.0,-70.0,-71.0,-67.0,-60.0,-91.0,-94.0,-90.0,-93.0,21.0,23.0,22.0,33.0,0
4176,BA:8C:B9:54:50:24,3827953,488348189,4695,6143634,3823258,482204555,0,8213,1632076,8192,1628719,21,3357,2306,14,5070,36,0,53,216660.0,130000.0,-39.0,-36.0,-44.0,-51.0,-42.0,-35.0,-43.0,-48.0,-91.0,-94.0,-90.0,-93.0,52.0,58.0,46.0,42.0,0
4177,92:69:1D:31:68:E9,3826892,485712444,3634,3507889,3823258,482204555,0,3974,991640,3863,966790,111,24850,1926,6,3760,79,0,32,229410.0,130000.0,-51.0,-47.0,-42.0,-49.0,-51.0,-49.0,-43.0,-47.0,-91.0,-94.0,-90.0,-93.0,40.0,47.0,48.0,44.0,0
4178,CC:2F:71:3F:1F:24,4444042,1177380616,620784,695176061,3823258,482204555,37,512359,562080744,511742,562006462,617,74282,494678,10,621021,56512,34,447,117000.0,39000.0,-67.0,-65.0,-70.0,-67.0,-67.0,-65.0,-70.0,-67.0,-91.0,-94.0,-90.0,-93.0,24.0,29.0,20.0,26.0,0
4179,CC:2F:71:3E:C5:1F,3824004,482295840,746,91285,3823258,482204555,0,3128,262713,2583,197959,545,64754,790,8,1077,18,0,34,130000.0,39000.0,-70.0,-71.0,-68.0,-60.0,-70.0,-71.0,-67.0,-60.0,-91.0,-94.0,-90.0,-93.0,21.0,23.0,22.0,33.0,0
4180,BA:8C:B9:54:50:24,3827953,488348189,4695,6143634,3823258,482204555,0,8213,1632076,8192,1628719,21,3357,2306,14,5070,36,0,53,216660.0,130000.0,-39.0,-36.0,-44.0,-51.0,-42.0,-35.0,-43.0,-48.0,-91.0,-94.0,-90.0,-93.0,52.0,58.0,46.0,42.0,0
4181,92:69:1D:31:68:E9,3826900,485713252,3634,3507889,3823266,482205363,0,3974,991640,3863,966790,111,24850,1926,6,3760,79,0,32,229410.0,130000.0,-51.0,-47.0,-42.0,-49.0,-51.0,-49.0,-43.0,-47.0,-91.0,-94.0,-90.0,-93.0,40.0,47.0,48.0,44.0,0
4182,CC:2F:71:3F:1F:24,4444094,1177396106,620828,695190743,3823266,482205363,37,512384,562085548,511767,562011266,617,74282,494703,10,621065,56519,34,447,130000.0,43333.0,-67.0,-65.0,-70.0,-67.0,-67.0,-65.0,-70.0,-67.0,-91.0,-94.0,-90.0,-93.0,24.0,29.0,20.0,26.0,0
4183,CC:2F:71:3E:C5:1F,3824012,482296648,746,91285,3823266,482205363,0,3128,262713,2583,197959,545,64754,790,8,1077,18,0,34,130000.0,39000.0,-70.0,-71.0,-68.0,-60.0,-70.0,-71.0,-67.0,-60.0,-91.0,-94.0,-90.0,-93.0,21.0,23.0,22.0,33.0,0
4184,BA:8C:B9:54:50:24,3827961,488348997,4695,6143634,3823266,482205363,0,8213,1632076,8192,1628719,21,3357,2306,14,5070,36,0,53,216660.0,130000.0,-39.0,-36.0,-44.0,-51.0,-42.0,-35.0,-43.0,-48.0,-91.0,-94.0,-90.0,-93.0,52.0,58.0,46.0,42.0,0
4185,92:69:1D:31:68:E9,3826901,485713312,3634,3507889,3823267,482205423,0,3974,991640,3863,966790,111,24850,1926,6,3760,79,0,32,229410.0,130000.0,-51.0,-47.0,-42.0,-49.0,-51.0,-49.0,-43.0,-47.0,-91.0,-94.0,-90.0,-93.0,40.0,47.0,48.0,44.0,0
4186,CC:2F:71:3F:1F:24,4444137,1177410594,620870,695205171,3823267,482205423,37,512410,562090492,511793,562016210,617,74282,494729,10,621107,56537,34,447,130000.0,39000.0,-67.0,-65.0,-70.0,-68.0,-67.0,-65.0,-70.0,-67.0,-91.0,-94.0,-90.0,-93.0,24.0,29.0,20.0,25.0,0
4187,CC:2F:71:3E:C5:1F,3824013,482296708,746,91285,3823267,482205423,0,3128,262713,2583,197959,545,64754,790,8,1077,18,0,34,130000.0,39000.0,-70.0,-71.0,-68.0,-60.0,-70.0,-71.0,-67.0,-60.0,-91.0,-94.0,-90.0,-93.0,21.0,23.0,22.0,33.0,0
4188,BA:8C:B9:54:50:24,3827962,488349057,4695,6143634,3823267,482205423,0,8213,1632076,8192,1628719,21,3357,2306,14,5070,36,0,53,216660.0,130000.0,-39.0,-36.0,-44.0,-51.0,-42.0,-35.0,-43.0,-48.0,-91.0,-94.0,-90.0,-93.0,52.0,58.0,46.0,42.0,0
4189,92:69:1D:31:68:E9,3826909,485714120,3634,3507889,3823275,482206231,0,3974,991640,3863,966790,111,24850,1926,6,3760,79,0,32,229410.0,130000.0,-51.0,-47.0,-42.0,-49.0,-51.0,-49.0,-43.0,-47.0,-91.0,-94.0,-90.0,-93.0,40.0,47.0,48.0,44.0,0
4190,CC:2F:71:3F:1F:24,4444187,1177425836,620912,695219605,3823275,482206231,37,512435,562095296,511818,562021014,617,74282,494754,10,621149,56540,34,447,130000.0,43333.0,-67.0,-65.0,-70.0,-67.0,-67.0,-65.0,-70.0,-67.0,-91.0,-94.0,-90.0,-93.0,24.0,29.0,20.0,26.0,0
4191,CC:2F:71:3E:C5:1F,3824021,482297516,746,91285,3823275,482206231,0,3128,262713,2583,197959,545,64754,790,8,1077,18,0,34,130000.0,39000.0,-70.0,-71.0,-68.0,-60.0,-70.0,-71.0,-67.0,-60.0,-91.0,-94.0,-90.0,-93.0,21.0,23.0,22.0,33.0,0
4192,BA:8C:B9:54:50:24,3827970,488349865,4695,6143634,3823275,482206231,0,8213,1632076,8192,1628719,21,3357,2306,14,5070,36,0,53,216660.0,130000.0,-39.0,-36.0,-44.0,-51.0,-42.0,-35.0,-43.0,-48.0,-91.0,-94.0,-90.0,-93.0,52.0,58.0,46.0,42.0,0
4193,92:69:1D:31:68:E9,3826909,485714120,3634,3507889,3823275,482206231,0,3974,991640,3863,966790,111,24850,1926,6,3760,79,0,32,229410.0,130000.0,-51.0,-47.0,-42.0,-49.0,-51.0,-49.0,-43.0,-47.0,-91.0,-93.0,-90.0,-93.0,40.0,46.0,48.0,44.0,0
4194,CC:2F:71:3F:1F:24,4444230,1177440394,620955,695234163,3823275,482206231,37,512460,562100100,511843,562025818,617,74282,494779,10,621192,56563,34,447,117000.0,39000.0,-67.0,-65.0,-70.0,-67.0,-67.0,-65.0,-70.0,-67.0,-91.0,-93.0,-90.0,-93.0,24.0,28.0,20.0,26.0,0
4195,CC:2F:71:3E:C5:1F,3824021,482297516,746,91285,3823275,482206231,0,3128,262713,2583,197959,545,64754,790,8,1077,18,0,34,130000.0,39000.0,-70.0,-71.0,-68.0,-60.0,-70.0,-71.0,-67.0,-60.0,-91.0,-93.0,-90.0,-93.0,21.0,22.0,22.0,33.0,0
4196,BA:8C:B9:54:50:24,3827970,488349865,4695,6143634,3823275,482206231,0,8213,1632076,8192,1628719,21,3357,2306,14,5070,36,0,53,216660.0,130000.0,-39.0,-36.0,-44.0,-51.0,-42.0,-35.0,-43.0,-48.0,-91.0,-93.0,-90.0,-93.0,52.0,57.0,46.0,42.0,0
4197,92:69:1D:31:68:E9,3826918,485714988,3634,3507889,3823284,482207099,0,3974,991640,3863,966790,111,24850,1926,6,3760,79,0,32,229410.0,130000.0,-51.0,-47.0,-42.0,-49.0,-51.0,-49.0,-43.0,-47.0,-91.0,-93.0,-90.0,-93.0,40.0,46.0,48.0,44.0,0
4198,CC:2F:71:3F:1F:24,4444282,1177455814,620998,695248715,3823284,482207099,37,512486,562105044,511869,562030762,617,74282,494805,10,621235,56569,34,447,130000.0,43333.0,-67.0,-65.0,-70.0,-68.0,-67.0,-65.0,-70.0,-67.0,-91.0,-93.0,-90.0,-93.0,24.0,28.0,20.0,25.0,0
4199,CC:2F:71:3E:C5:1F,3824030,482298384,746,91285,3823284,482207099,0,3128,262713,2583,197959,545,64754,790,8,1077,18,0,34,130000.0,39000.0,-70.0,-71.0,-68.0,-60.0,-70.0,-71.0,-67.0,-60.0,-91.0,-93.0,-90.0,-93.0,21.0,22.0,22.0,33.0,0
4200,BA:8C:B9:54:50:24,3827979,488350733,4695,6143634,3823284,482207099,0,8213,1632076,8192,1628719,21,3357,2306,14,5070,36,0,53,216660.0,130000.0,-39.0,-36.0,-44.0,-51.0,-42.0,-35.0,-43.0,-48.0,-91.0,-93.0,-90.0,-93.0,52.0,57.0,46.0,42.0,0
4201,92:69:1D:31:68:E9,3826918,485714988,3634,3507889,3823284,482207099,0,3974,991640,3863,966790,111,24850,1926,6,3760,79,0,32,229410.0,130000.0,-51.0,-47.0,-42.0,-49.0,-51.0,-49.0,-43.0,-47.0,-91.0,-93.0,-90.0,-93.0,40.0,46.0,48.0,44.0,0
4202,CC:2F:71:3F:1F:24,4444322,1177470050,621038,695262951,3823284,482207099,37,512513,562110104,511896,562035822,617,74282,494832,10,621275,56582,34,447,130000.0,39000.0,-67.0,-65.0,-70.0,-67.0,-67.0,-65.0,-70.0,-67.0,-91.0,-93.0,-90.0,-93.0,24.0,28.0,20.0,26.0,0
4203,CC:2F:71:3E:C5:1F,3824030,482298384,746,91285,3823284,482207099,0,3128,262713,2583,197959,545,64754,790,8,1077,18,0,34,130000.0,39000.0,-70.0,-71.0,-68.0,-60.0,-70.0,-71.0,-67.0,-60.0,-91.0,-93.0,-90.0,-93.0,21.0,22.0,22.0,33.0,0
4204,BA:8C:B9:54:50:24,3827979,488350733,4695,6143634,3823284,482207099,0,8213,1632076,8192,1628719,21,3357,2306,14,5070,36,0,53,216660.0,130000.0,-39.0,-36.0,-44.0,-51.0,-42.0,-35.0,-43.0,-48.0,-91.0,-93.0,-90.0,-93.0,52.0,57.0,46.0,42.0,0
4205,92:69:1D:31:68:E9,3826925,485715654,3634,3507889,3823291,482207765,0,3974,991640,3863,966790,111,24850,1926,6,3760,79,0,32,229410.0,130000.0,-51.0,-47.0,-42.0,-49.0,-51.0,-49.0,-43.0,-47.0,-91.0,-93.0,-90.0,-93.0,40.0,46.0,48.0,44.0,0
4206,CC:2F:71:3F:1F:24,4444375,1177485538,621082,695277571,3823293,482207967,37,512541,562115304,511924,562041022,617,74282,494860,10,621318,56614,34,447,130000.0,43333.0,-67.0,-65.0,-70.0,-67.0,-67.0,-65.0,-70.0,-67.0,-91.0,-93.0,-90.0,-93.0,24.0,28.0,20.0,26.0,0
4207,CC:2F:71:3E:C5:1F,3824039,482299252,746,91285,3823293,482207967,0,3128,262713,2583,197959,545,64754,790,8,1077,18,0,34,130000.0,39000.0,-70.0,-71.0,-68.0,-60.0,-70.0,-71.0,-67.0,-60.0,-91.0,-93.0,-90.0,-93.0,21.0,22.0,22.0,33.0,0
4208,BA:8C:B9:54:50:24,3827988,488351601,4695,6143634,3823293,482207967,0,8213,1632076,8192,1628719,21,3357,2306,14,5070,36,0,53,216660.0,130000.0,-39.0,-36.0,-44.0,-51.0,-42.0,-35.0,-43.0,-48.0,-91.0,-93.0,-90.0,-93.0,52.0,57.0,46.0,42.0,0
4209,92:69:1D:31:68:E9,3826928,485715972,3635,3508005,3823293,482207967,0,3976,991776,3865,966926,111,24850,1926,6,3761,79,0,32,229410.0,130000.0,-51.0,-47.0,-42.0,-48.0,-51.0,-49.0,-43.0,-47.0,-91.0,-93.0,-90.0,-93.0,40.0,46.0,48.0,45.0,0
4210,CC:2F:71:3F:1F:24,4444418,1177500188,621125,695292221,3823293,482207967,37,512566,562120108,511949,562045826,617,74282,494885,10,621362,56619,34,447,130000.0,43333.0,-67.0,-65.0,-70.0,-67.0,-67.0,-65.0,-70.0,-67.0,-91.0,-93.0,-90.0,-93.0,24.0,28.0,20.0,26.0,0
4211,CC:2F:71:3E:C5:1F,3824040,482299368,747,91401,3823293,482207967,0,3130,262853,2585,198099,545,64754,790,8,1078,18,0,34,130000.0,39000.0,-70.0,-71.0,-67.0,-60.0,-70.0,-71.0,-67.0,-60.0,-91.0,-93.0,-90.0,-93.0,21.0,22.0,23.0,33.0,0
4212,BA:8C:B9:54:50:24,3827991,488351919,4696,6143750,3823295,482208169,0,8219,1632484,8198,1629127,21,3357,2306,14,5071,36,0,53,216660.0,130000.0,-39.0,-36.0,-45.0,-51.0,-41.0,-34.0,-42.0,-47.0,-91.0,-93.0,-90.0,-93.0,52.0,57.0,45.0,42.0,0
4213,92:69:1D:31:68:E9,3826935,485716851,3635,3508005,3823300,482208846,0,3976,991776,3865,966926,111,24850,1926,6,3761,79,0,32,229410.0,130000.0,-51.0,-47.0,-42.0,-48.0,-51.0,-49.0,-43.0,-47.0,-91.0,-93.0,-90.0,-93.0,40.0,46.0,48.0,45.0,0
4214,CC:2F:71:3F:1F:24,4444467,1177515495,621167,695306649,3823300,482208846,37,512591,562124912,511974,562050630,617,74282,494910,10,621404,56641,34,447,117000.0,39000.0,-67.0,-65.0,-70.0,-68.0,-67.0,-65.0,-70.0,-67.0,-91.0,-93.0,-90.0,-93.0,24.0,28.0,20.0,25.0,0
4215,CC:2F:71:3E:C5:1F,3824049,482300449,747,91401,3823302,482209048,0,3130,262853,2585,198099,545,64754,790,8,1078,18,0,34,130000.0,39000.0,-70.0,-71.0,-67.0,-60.0,-70.0,-71.0,-67.0,-60.0,-91.0,-93.0,-90.0,-93.0,21.0,22.0,23.0,33.0,0
4216,BA:8C:B9:54:50:24,3827998,488352798,4696,6143750,3823302,482209048,0,8219,1632484,8198,1629127,21,3357,2306,14,5071,36,0,53,216660.0,130000.0,-39.0,-36.0,-45.0,-51.0,-41.0,-34.0,-42.0,-47.0,-91.0,-93.0,-90.0,-93.0,52.0,57.0,45.0,42.0,0
4217,92:69:1D:31:68:E9,3826938,485717113,3635,3508005,3823303,482209108,0,3976,991776,3865,966926,111,24850,1926,6,3761,79,0,32,229410.0,130000.0,-51.0,-47.0,-42.0,-48.0,-51.0,-49.0,-43.0,-47.0,-91.0,-93.0,-90.0,-93.0,40.0,46.0,48.0,45.0,0
4218,CC:2F:71:3F:1F:24,4444511,1177530061,621208,695320953,3823303,482209108,37,512618,562129972,512001,562055690,617,74282,494937,10,621445,56646,34,447,130000.0,43333.0,-67.0,-65.0,-70.0,-68.0,-67.0,-65.0,-70.0,-67.0,-91.0,-93.0,-90.0,-93.0,24.0,28.0,20.0,25.0,0
4219,CC:2F:71:3E:C5:1F,3824050,482300509,747,91401,3823303,482209108,0,3130,262853,2585,198099,545,64754,790,8,1078,18,0,34,130000.0,39000.0,-70.0,-71.0,-67.0,-60.0,-70.0,-71.0,-67.0,-60.0,-91.0,-93.0,-90.0,-93.0,21.0,22.0,23.0,33.0,0
4220,BA:8C:B9:54:50:24,3828001,488353060,4696,6143750,3823305,482209310,0,8219,1632484,8198,1629127,21,3357,2306,14,5071,36,0,53,216660.0,130000.0,-39.0,-36.0,-45.0,-51.0,-41.0,-34.0,-42.0,-47.0,-91.0,-93.0,-90.0,-93.0,52.0,57.0,45.0,42.0,0
4221,92:69:1D:31:68:E9,3826944,485717719,3635,3508005,3823309,482209714,0,3976,991776,3865,966926,111,24850,1926,6,3761,79,0,32,229410.0,130000.0,-51.0,-47.0,-42.0,-48.0,-51.0,-49.0,-43.0,-47.0,-91.0,-93.0,-90.0,-93.0,40.0,46.0,48.0,45.0,0
4222,CC:2F:71:3F:1F:24,4444561,1177545455,621252,695335741,3823309,482209714,37,512644,562134916,512027,562060634,617,74282,494963,10,621489,56652,34,447,130000.0,43333.0,-67.0,-65.0,-70.0,-68.0,-67.0,-65.0,-70.0,-67.0,-91.0,-93.0,-90.0,-93.0,24.0,28.0,20.0,25.0,0
4223,CC:2F:71:3E:C5:1F,3824057,482301183,747,91401,3823310,482209782,0,3130,262853,2585,198099,545,64754,790,8,1078,18,0,34,130000.0,39000.0,-70.0,-71.0,-67.0,-60.0,-70.0,-71.0,-67.0,-60.0,-91.0,-93.0,-90.0,-93.0,21.0,22.0,23.0,33.0,0
4224,BA:8C:B9:54:50:24,3828007,488353666,4696,6143750,3823311,482209916,0,8219,1632484,8198,1629127,21,3357,2306,14,5071,36,0,53,216660.0,130000.0,-39.0,-36.0,-45.0,-51.0,-41.0,-34.0,-42.0,-47.0,-91.0,-93.0,-90.0,-93.0,52.0,57.0,45.0,42.0,0
4225,92:69:1D:31:68:E9,3826946,485717921,3635,3508005,3823311,482209916,0,3976,991776,3865,966926,111,24850,1926,6,3761,79,0,32,229410.0,130000.0,-51.0,-47.0,-42.0,-48.0,-51.0,-49.0,-43.0,-47.0,-91.0,-93.0,-90.0,-93.0,40.0,46.0,48.0,45.0,0
4226,CC:2F:71:3F:1F:24,4444605,1177560085,621294,695350169,3823311,482209916,37,512672,562140068,512055,562065786,617,74282,494991,10,621531,56672,34,447,117000.0,39000.0,-67.0,-65.0,-70.0,-67.0,-67.0,-65.0,-70.0,-67.0,-91.0,-93.0,-90.0,-93.0,24.0,28.0,20.0,26.0,0
4227,CC:2F:71:3E:C5:1F,3824059,482301377,747,91401,3823312,482209976,0,3130,262853,2585,198099,545,64754,790,8,1078,18,0,34,130000.0,39000.0,-70.0,-71.0,-67.0,-60.0,-70.0,-71.0,-67.0,-60.0,-91.0,-93.0,-90.0,-93.0,21.0,22.0,23.0,33.0,0
4228,BA:8C:B9:54:50:24,3828010,488353928,4696,6143750,3823314,482210178,0,8219,1632484,8198,1629127,21,3357,2306,14,5071,36,0,53,216660.0,130000.0,-39.0,-36.0,-45.0,-51.0,-41.0,-34.0,-42.0,-47.0,-91.0,-93.0,-90.0,-93.0,52.0,57.0,45.0,42.0,0
4229,92:69:1D:31:68:E9,3826953,485718587,3635,3508005,3823318,482210582,0,3976,991776,3865,966926,111,24850,1926,6,3761,79,0,32,229410.0,130000.0,-51.0,-47.0,-42.0,-48.0,-51.0,-49.0,-43.0,-47.0,-91.0,-93.0,-90.0,-93.0,40.0,46.0,48.0,45.0,0
4230,CC:2F:71:3F:1F:24,4444655,1177575303,621337,695364721,3823318,482210582,37,512697,562144872,512080,562070590,617,74282,495016,10,621574,56676,34,447,130000.0,43333.0,-67.0,-65.0,-70.0,-68.0,-67.0,-65.0,-70.0,-67.0,-91.0,-93.0,-90.0,-93.0,24.0,28.0,20.0,25.0,0
4231,CC:2F:71:3E:C5:1F,3824065,482301983,747,91401,3823318,482210582,0,3130,262853,2585,198099,545,64754,790,8,1078,18,0,34,130000.0,39000.0,-70.0,-71.0,-67.0,-60.0,-70.0,-71.0,-67.0,-60.0,-91.0,-93.0,-90.0,-93.0,21.0,22.0,23.0,33.0,0
4232,BA:8C:B9:54:50:24,3828014,488354332,4696,6143750,3823318,482210582,0,8219,1632484,8198,1629127,21,3357,2306,14,5071,36,0,53,216660.0,130000.0,-39.0,-36.0,-45.0,-51.0,-41.0,-34.0,-42.0,-47.0,-91.0,-93.0,-90.0,-93.0,52.0,57.0,45.0,42.0,0
4233,92:69:1D:31:68:E9,3826955,485718789,3635,3508005,3823320,482210784,0,3976,991776,3865,966926,111,24850,1926,6,3761,79,0,32,229410.0,130000.0,-51.0,-47.0,-42.0,-48.0,-51.0,-49.0,-43.0,-47.0,-91.0,-93.0,-90.0,-93.0,40.0,46.0,48.0,45.0,0
4234,CC:2F:71:3F:1F:24,4444700,1177590169,621380,695379385,3823320,482210784,37,512723,562149816,512106,562075534,617,74282,495042,10,621616,56683,34,447,130000.0,43333.0,-67.0,-65.0,-70.0,-67.0,-67.0,-65.0,-70.0,-67.0,-91.0,-93.0,-90.0,-93.0,24.0,28.0,20.0,26.0,0
4235,CC:2F:71:3E:C5:1F,3824067,482302185,747,91401,3823320,482210784,0,3130,262853,2585,198099,545,64754,790,8,1078,18,0,34,130000.0,39000.0,-70.0,-71.0,-67.0,-60.0,-70.0,-71.0,-67.0,-60.0,-91.0,-93.0,-90.0,-93.0,21.0,22.0,23.0,33.0,0
4236,BA:8C:B9:54:50:24,3828018,488354736,4696,6143750,3823322,482210986,0,8219,1632484,8198,1629127,21,3357,2306,14,5071,36,0,53,216660.0,130000.0,-39.0,-36.0,-45.0,-51.0,-41.0,-34.0,-42.0,-47.0,-91.0,-93.0,-90.0,-93.0,52.0,57.0,45.0,42.0,0
4237,92:69:1D:31:68:E9,3826962,485719455,3635,3508005,3823327,482211450,0,3976,991776,3865,966926,111,24850,1926,6,3761,79,0,32,229410.0,130000.0,-51.0,-47.0,-42.0,-48.0,-51.0,-49.0,-43.0,-47.0,-91.0,-93.0,-90.0,-93.0,40.0,46.0,48.0,45.0,0
4238,CC:2F:71:3F:1F:24,4444749,1177605263,621422,695393813,3823327,482211450,37,512749,562154796,512132,562080514,617,74282,495068,10,621659,56710,34,447,144444.0,39000.0,-67.0,-65.0,-71.0,-68.0,-67.0,-65.0,-70.0,-67.0,-91.0,-93.0,-90.0,-93.0,24.0,28.0,19.0,25.0,0
4239,CC:2F:71:3E:C5:1F,3824074,482302851,747,91401,3823327,482211450,0,3130,262853,2585,198099,545,64754,790,8,1078,18,0,34,130000.0,39000.0,-70.0,-71.0,-67.0,-60.0,-70.0,-71.0,-67.0,-60.0,-91.0,-93.0,-90.0,-93.0,21.0,22.0,23.0,33.0,0
4240,BA:8C:B9:54:50:24,3828023,488355200,4696,6143750,3823327,482211450,0,8219,1632484,8198,1629127,21,3357,2306,14,5071,36,0,53,216660.0,130000.0,-39.0,-36.0,-45.0,-51.0,-41.0,-34.0,-42.0,-47.0,-91.0,-93.0,-90.0,-93.0,52.0,57.0,45.0,42.0,0
4241,92:69:1D:31:68:E9,3826965,485719719,3635,3508005,3823330,482211714,0,3976,991776,3865,966926,111,24850,1926,6,3761,79,0,32,229410.0,130000.0,-51.0,-47.0,-42.0,-48.0,-51.0,-49.0,-43.0,-47.0,-91.0,-93.0,-90.0,-93.0,40.0,46.0,48.0,45.0,0
4242,CC:2F:71:3F:1F:24,4444794,1177619955,621464,695408241,3823330,482211714,37,512774,562159600,512157,562085318,617,74282,495093,10,621701,56730,34,447,130000.0,43333.0,-67.0,-65.0,-70.0,-68.0,-67.0,-65.0,-70.0,-67.0,-91.0,-93.0,-90.0,-93.0,24.0,28.0,20.0,25.0,0
4243,CC:2F:71:3E:C5:1F,3824079,482303317,747,91401,3823332,482211916,0,3132,263041,2586,198169,546,64872,791,8,1078,18,0,34,130000.0,39000.0,-70.0,-71.0,-67.0,-59.0,-70.0,-71.0,-67.0,-59.0,-91.0,-93.0,-90.0,-93.0,21.0,22.0,23.0,34.0,0
4244,BA:8C:B9:54:50:24,3828028,488355666,4696,6143750,3823332,482211916,0,8219,1632484,8198,1629127,21,3357,2306,14,5071,36,0,53,216660.0,130000.0,-39.0,-36.0,-45.0,-51.0,-41.0,-34.0,-42.0,-47.0,-91.0,-93.0,-90.0,-93.0,52.0,57.0,45.0,42.0,0
4245,92:69:1D:31:68:E9,3826971,485720325,3635,3508005,3823336,482212320,0,3976,991776,3865,966926,111,24850,1926,6,3761,79,0,32,229410.0,130000.0,-51.0,-47.0,-42.0,-48.0,-51.0,-49.0,-43.0,-47.0,-91.0,-93.0,-90.0,-93.0,40.0,46.0,48.0,45.0,0
4246,CC:2F:71:3F:1F:24,4444842,1177634989,621506,695422669,3823336,482212320,37,512800,562164544,512183,562090262,617,74282,495119,10,621743,56747,34,447,117000.0,39000.0,-67.0,-65.0,-71.0,-68.0,-67.0,-65.0,-70.0,-67.0,-91.0,-93.0,-90.0,-93.0,24.0,28.0,19.0,25.0,0
4247,CC:2F:71:3E:C5:1F,3824083,482303721,747,91401,3823336,482212320,0,3132,263041,2586,198169,546,64872,791,8,1078,18,0,34,130000.0,39000.0,-70.0,-71.0,-67.0,-59.0,-70.0,-71.0,-67.0,-59.0,-91.0,-93.0,-90.0,-93.0,21.0,22.0,23.0,34.0,0
4248,BA:8C:B9:54:50:24,3828032,488356070,4696,6143750,3823336,482212320,0,8219,1632484,8198,1629127,21,3357,2306,14,5071,36,0,53,216660.0,130000.0,-39.0,-36.0,-45.0,-51.0,-41.0,-34.0,-42.0,-47.0,-91.0,-93.0,-90.0,-93.0,52.0,57.0,45.0,42.0,0
4249,92:69:1D:31:68:E9,3826974,485720587,3635,3508005,3823339,482212582,0,3977,991844,3866,966994,111,24850,1926,6,3761,79,0,32,229410.0,130000.0,-52.0,-50.0,-44.0,-46.0,-51.0,-49.0,-43.0,-47.0,-91.0,-93.0,-90.0,-93.0,39.0,43.0,46.0,47.0,0
4250,CC:2F:71:3F:1F:24,4444888,1177649803,621549,695437221,3823339,482212582,37,512825,562169348,512208,562095066,617,74282,495144,10,621786,56754,34,447,130000.0,43333.0,-67.0,-65.0,-70.0,-68.0,-67.0,-65.0,-70.0,-67.0,-91.0,-93.0,-90.0,-93.0,24.0,28.0,20.0,25.0,0
4251,CC:2F:71:3E:C5:1F,3824088,482304185,747,91401,3823341,482212784,0,3132,263041,2586,198169,546,64872,791,8,1078,18,0,34,130000.0,39000.0,-70.0,-71.0,-67.0,-59.0,-70.0,-71.0,-67.0,-59.0,-91.0,-93.0,-90.0,-93.0,21.0,22.0,23.0,34.0,0
4252,BA:8C:B9:54:50:24,3828037,488356534,4696,6143750,3823341,482212784,0,8219,1632484,8198,1629127,21,3357,2306,14,5071,36,0,53,216660.0,130000.0,-39.0,-36.0,-45.0,-51.0,-41.0,-34.0,-42.0,-47.0,-91.0,-93.0,-90.0,-93.0,52.0,57.0,45.0,42.0,0
4253,92:69:1D:31:68:E9,3826980,485721193,3635,3508005,3823345,482213188,0,3977,991844,3866,966994,111,24850,1926,6,3761,79,0,32,229410.0,130000.0,-52.0,-50.0,-44.0,-46.0,-51.0,-49.0,-43.0,-47.0,-91.0,-93.0,-90.0,-93.0,39.0,43.0,46.0,47.0,0
4254,CC:2F:71:3F:1F:24,4444937,1177665079,621592,695451891,3823345,482213188,37,512852,562174408,512235,562100126,617,74282,495171,10,621829,56760,34,447,130000.0,43333.0,-67.0,-65.0,-70.0,-67.0,-67.0,-65.0,-70.0,-67.0,-91.0,-93.0,-90.0,-93.0,24.0,28.0,20.0,26.0,0
4255,CC:2F:71:3E:C5:1F,3824092,482304589,747,91401,3823345,482213188,0,3132,263041,2586,198169,546,64872,791,8,1078,18,0,34,130000.0,39000.0,-70.0,-71.0,-67.0,-59.0,-70.0,-71.0,-67.0,-59.0,-91.0,-93.0,-90.0,-93.0,21.0,22.0,23.0,34.0,0
4256,BA:8C:B9:54:50:24,3828041,488356938,4696,6143750,3823345,482213188,0,8219,1632484,8198,1629127,21,3357,2306,14,5071,36,0,53,216660.0,130000.0,-39.0,-36.0,-45.0,-51.0,-41.0,-34.0,-42.0,-47.0,-91.0,-93.0,-90.0,-93.0,52.0,57.0,45.0,42.0,0
4257,92:69:1D:31:68:E9,3826982,485721395,3635,3508005,3823347,482213390,0,3977,991844,3866,966994,111,24850,1926,6,3761,79,0,32,229410.0,130000.0,-52.0,-50.0,-44.0,-46.0,-51.0,-49.0,-43.0,-47.0,-91.0,-93.0,-90.0,-93.0,39.0,43.0,46.0,47.0,0
4258,CC:2F:71:3F:1F:24,4444983,1177679899,621635,695466449,3823348,482213450,37,512877,562179212,512260,562104930,617,74282,495196,10,621872,56784,34,447,117000.0,39000.0,-67.0,-65.0,-70.0,-68.0,-67.0,-65.0,-70.0,-67.0,-91.0,-93.0,-90.0,-93.0,24.0,28.0,20.0,25.0,0
4259,CC:2F:71:3E:C5:1F,3824097,482305053,747,91401,3823350,482213652,0,3132,263041,2586,198169,546,64872,791,8,1078,18,0,34,130000.0,39000.0,-70.0,-71.0,-67.0,-59.0,-70.0,-71.0,-67.0,-59.0,-91.0,-93.0,-90.0,-93.0,21.0,22.0,23.0,34.0,0
4260,BA:8C:B9:54:50:24,3828047,488357464,4696,6143750,3823351,482213714,0,8219,1632484,8198,1629127,21,3357,2306,14,5071,36,0,53,216660.0,130000.0,-39.0,-36.0,-45.0,-51.0,-41.0,-34.0,-42.0,-47.0,-91.0,-93.0,-90.0,-93.0,52.0,57.0,45.0,42.0,0
4261,92:69:1D:31:68:E9,3827013,485733146,3635,3508005,3823378,482225141,0,3980,992215,3868,967130,112,25085,1927,6,3761,79,0,32,229410.0,130000.0,-51.0,-47.0,-42.0,-48.0,-51.0,-49.0,-43.0,-47.0,-91.0,-93.0,-90.0,-93.0,40.0,46.0,48.0,45.0,0
4262,CC:2F:71:3F:1F:24,4445055,1177706146,621677,695481005,3823378,482225141,37,512908,562184768,512290,562110368,618,74400,495227,10,621914,56795,34,447,130000.0,39000.0,-67.0,-65.0,-71.0,-67.0,-67.0,-65.0,-70.0,-67.0,-91.0,-93.0,-90.0,-93.0,24.0,28.0,19.0,26.0,0
4263,CC:2F:71:3E:C5:1F,3824125,482316542,747,91401,3823378,482225141,0,3132,263041,2586,198169,546,64872,791,8,1078,18,0,34,130000.0,39000.0,-70.0,-71.0,-67.0,-59.0,-70.0,-71.0,-67.0,-59.0,-91.0,-93.0,-90.0,-93.0,21.0,22.0,23.0,34.0,0
4264,BA:8C:B9:54:50:24,3828074,488368891,4696,6143750,3823378,482225141,0,8219,1632484,8198,1629127,21,3357,2306,14,5071,36,0,53,216660.0,130000.0,-39.0,-36.0,-45.0,-51.0,-41.0,-34.0,-42.0,-47.0,-91.0,-93.0,-90.0,-93.0,52.0,57.0,45.0,42.0,0
4265,92:69:1D:31:68:E9,3827016,485733621,3635,3508005,3823381,482225616,0,3980,992215,3868,967130,112,25085,1927,6,3761,79,0,32,229410.0,130000.0,-51.0,-47.0,-42.0,-48.0,-51.0,-49.0,-43.0,-47.0,-91.0,-93.0,-90.0,-93.0,40.0,46.0,48.0,45.0,0
4266,CC:2F:71:3F:1F:24,4445101,1177721127,621718,695495309,3823383,482225818,37,512933,562189572,512315,562115172,618,74400,495252,10,621955,56827,34,447,144444.0,39000.0,-67.0,-65.0,-70.0,-68.0,-67.0,-65.0,-70.0,-67.0,-91.0,-93.0,-90.0,-93.0,24.0,28.0,20.0,25.0,0
4267,CC:2F:71:3E:C5:1F,3824130,482317219,747,91401,3823383,482225818,0,3132,263041,2586,198169,546,64872,791,8,1078,18,0,34,130000.0,39000.0,-70.0,-71.0,-67.0,-59.0,-70.0,-71.0,-67.0,-59.0,-91.0,-93.0,-90.0,-93.0,21.0,22.0,23.0,34.0,0
4268,BA:8C:B9:54:50:24,3828079,488369568,4696,6143750,3823383,482225818,0,8219,1632484,8198,1629127,21,3357,2306,14,5071,36,0,53,216660.0,130000.0,-39.0,-36.0,-45.0,-51.0,-41.0,-34.0,-42.0,-47.0,-91.0,-93.0,-90.0,-93.0,52.0,57.0,45.0,42.0,0
4269,92:69:1D:31:68:E9,3827023,485734287,3635,3508005,3823388,482226282,0,3980,992215,3868,967130,112,25085,1927,6,3761,79,0,32,229410.0,130000.0,-51.0,-47.0,-42.0,-48.0,-51.0,-49.0,-43.0,-47.0,-91.0,-93.0,-90.0,-93.0,40.0,46.0,48.0,45.0,0
4270,CC:2F:71:3F:1F:24,4445148,1177736019,621760,695509737,3823388,482226282,37,512959,562194492,512341,562120092,618,74400,495278,10,621997,56849,34,447,130000.0,43333.0,-67.0,-65.0,-70.0,-67.0,-67.0,-65.0,-70.0,-67.0,-91.0,-93.0,-90.0,-93.0,24.0,28.0,20.0,26.0,0
4271,CC:2F:71:3E:C5:1F,3824135,482317683,747,91401,3823388,482226282,0,3132,263041,2586,198169,546,64872,791,8,1078,18,0,34,130000.0,39000.0,-70.0,-71.0,-67.0,-59.0,-70.0,-71.0,-67.0,-59.0,-91.0,-93.0,-90.0,-93.0,21.0,22.0,23.0,34.0,0
4272,BA:8C:B9:54:50:24,3828084,488370032,4696,6143750,3823388,482226282,0,8219,1632484,8198,1629127,21,3357,2306,14,5071,36,0,53,216660.0,130000.0,-39.0,-36.0,-45.0,-51.0,-41.0,-34.0,-42.0,-47.0,-91.0,-93.0,-90.0,-93.0,52.0,57.0,45.0,42.0,0
4273,92:69:1D:31:68:E9,3827027,485734691,3635,3508005,3823392,482226686,0,3980,992215,3868,967130,112,25085,1927,6,3761,79,0,32,229410.0,130000.0,-51.0,-47.0,-42.0,-48.0,-51.0,-49.0,-43.0,-47.0,-91.0,-93.0,-90.0,-93.0,40.0,46.0,48.0,45.0,0
4274,CC:2F:71:3F:1F:24,4445192,1177750715,621800,695524029,3823392,482226686,37,512985,562199412,512367,562125012,618,74400,495304,10,622037,56855,34,447,130000.0,43333.0,-67.0,-65.0,-70.0,-67.0,-67.0,-65.0,-70.0,-67.0,-91.0,-93.0,-90.0,-93.0,24.0,28.0,20.0,26.0,0
4275,CC:2F:71:3E:C5:1F,3824139,482318087,747,91401,3823392,482226686,0,3132,263041,2586,198169,546,64872,791,8,1078,18,0,34,130000.0,39000.0,-70.0,-71.0,-67.0,-59.0,-70.0,-71.0,-67.0,-59.0,-91.0,-93.0,-90.0,-93.0,21.0,22.0,23.0,34.0,0
4276,BA:8C:B9:54:50:24,3828088,488370436,4696,6143750,3823392,482226686,0,8219,1632484,8198,1629127,21,3357,2306,14,5071,36,0,53,216660.0,130000.0,-39.0,-36.0,-45.0,-51.0,-41.0,-34.0,-42.0,-47.0,-91.0,-93.0,-90.0,-93.0,52.0,57.0,45.0,42.0,0
4277,92:69:1D:31:68:E9,3827033,485735463,3635,3508005,3823398,482227458,0,3980,992215,3868,967130,112,25085,1927,6,3761,79,0,32,229410.0,130000.0,-51.0,-47.0,-42.0,-48.0,-51.0,-49.0,-43.0,-47.0,-91.0,-93.0,-90.0,-93.0,40.0,46.0,48.0,45.0,0
4278,CC:2F:71:3F:1F:24,4445240,1177765915,621842,695538457,3823398,482227458,37,513011,562204356,512393,562129956,618,74400,495330,10,622079,56875,34,447,117000.0,39000.0,-67.0,-65.0,-71.0,-67.0,-67.0,-65.0,-70.0,-67.0,-91.0,-93.0,-90.0,-93.0,24.0,28.0,19.0,26.0,0
4279,CC:2F:71:3E:C5:1F,3824146,482318919,747,91401,3823399,482227518,0,3132,263041,2586,198169,546,64872,791,8,1078,18,0,34,130000.0,39000.0,-70.0,-71.0,-67.0,-59.0,-70.0,-71.0,-67.0,-59.0,-91.0,-93.0,-90.0,-93.0,21.0,22.0,23.0,34.0,0
4280,BA:8C:B9:54:50:24,3828095,488371268,4696,6143750,3823399,482227518,0,8219,1632484,8198,1629127,21,3357,2306,14,5071,36,0,53,216660.0,130000.0,-39.0,-36.0,-45.0,-51.0,-41.0,-34.0,-42.0,-47.0,-91.0,-93.0,-90.0,-93.0,52.0,57.0,45.0,42.0,0
4281,92:69:1D:31:68:E9,3827038,485735927,3635,3508005,3823403,482227922,0,3980,992215,3868,967130,112,25085,1927,6,3761,79,0,32,229410.0,130000.0,-51.0,-47.0,-42.0,-48.0,-51.0,-49.0,-43.0,-47.0,-91.0,-93.0,-90.0,-93.0,40.0,46.0,48.0,45.0,0
4282,CC:2F:71:3F:1F:24,4445287,1177780807,621884,695552885,3823403,482227922,37,513037,562209276,512419,562134876,618,74400,495356,10,622121,56880,34,447,130000.0,43333.0,-67.0,-65.0,-71.0,-68.0,-67.0,-65.0,-70.0,-67.0,-91.0,-93.0,-90.0,-93.0,24.0,28.0,19.0,25.0,0
4283,CC:2F:71:3E:C5:1F,3824150,482319323,747,91401,3823403,482227922,0,3132,263041,2586,198169,546,64872,791,8,1078,18,0,34,130000.0,39000.0,-70.0,-71.0,-67.0,-59.0,-70.0,-71.0,-67.0,-59.0,-91.0,-93.0,-90.0,-93.0,21.0,22.0,23.0,34.0,0
4284,BA:8C:B9:54:50:24,3828099,488371672,4696,6143750,3823403,482227922,0,8219,1632484,8198,1629127,21,3357,2306,14,5071,36,0,53,216660.0,130000.0,-39.0,-36.0,-45.0,-51.0,-41.0,-34.0,-42.0,-47.0,-91.0,-93.0,-90.0,-93.0,52.0,57.0,45.0,42.0,0
4285,92:69:1D:31:68:E9,3827042,485736331,3635,3508005,3823407,482228326,0,3980,992215,3868,967130,112,25085,1927,6,3761,79,0,32,229410.0,130000.0,-51.0,-47.0,-42.0,-48.0,-51.0,-49.0,-43.0,-47.0,-91.0,-93.0,-90.0,-93.0,40.0,46.0,48.0,45.0,0
4286,CC:2F:71:3F:1F:24,4445334,1177795881,621927,695567555,3823407,482228326,37,513065,562214476,512447,562140076,618,74400,495384,10,622164,56888,34,447,130000.0,43333.0,-67.0,-65.0,-71.0,-68.0,-67.0,-65.0,-70.0,-67.0,-91.0,-93.0,-90.0,-93.0,24.0,28.0,19.0,25.0,0
4287,CC:2F:71:3E:C5:1F,3824154,482319727,747,91401,3823407,482228326,0,3132,263041,2586,198169,546,64872,791,8,1078,18,0,34,130000.0,39000.0,-70.0,-71.0,-67.0,-59.0,-70.0,-71.0,-67.0,-59.0,-91.0,-93.0,-90.0,-93.0,21.0,22.0,23.0,34.0,0
4288,BA:8C:B9:54:50:24,3828103,488372076,4696,6143750,3823407,482228326,0,8219,1632484,8198,1629127,21,3357,2306,14,5071,36,0,53,216660.0,130000.0,-39.0,-36.0,-45.0,-51.0,-41.0,-34.0,-42.0,-47.0,-91.0,-93.0,-90.0,-93.0,52.0,57.0,45.0,42.0,0
4289,92:69:1D:31:68:E9,3827047,485736795,3635,3508005,3823412,482228790,0,3980,992215,3868,967130,112,25085,1927,6,3761,79,0,32,229410.0,130000.0,-51.0,-47.0,-42.0,-48.0,-51.0,-49.0,-43.0,-47.0,-91.0,-93.0,-90.0,-93.0,40.0,46.0,48.0,45.0,0
4290,CC:2F:71:3F:1F:24,4445380,1177810649,621968,695581859,3823412,482228790,37,513090,562219280,512472,562144880,618,74400,495409,10,622205,56913,34,447,144444.0,39000.0,-67.0,-65.0,-70.0,-67.0,-67.0,-65.0,-70.0,-67.0,-91.0,-93.0,-90.0,-93.0,24.0,28.0,20.0,26.0,0
4291,CC:2F:71:3E:C5:1F,3824159,482320191,747,91401,3823412,482228790,0,3132,263041,2586,198169,546,64872,791,8,1078,18,0,34,130000.0,39000.0,-70.0,-71.0,-67.0,-59.0,-70.0,-71.0,-67.0,-59.0,-91.0,-93.0,-90.0,-93.0,21.0,22.0,23.0,34.0,0
4292,BA:8C:B9:54:50:24,3828108,488372540,4696,6143750,3823412,482228790,0,8219,1632484,8198,1629127,21,3357,2306,14,5071,36,0,53,216660.0,130000.0,-39.0,-36.0,-45.0,-51.0,-41.0,-34.0,-42.0,-47.0,-91.0,-93.0,-90.0,-93.0,52.0,57.0,45.0,42.0,0
4293,92:69:1D:31:68:E9,3827051,485737199,3635,3508005,3823416,482229194,0,3980,992215,3868,967130,112,25085,1927,6,3761,79,0,32,229410.0,130000.0,-51.0,-47.0,-42.0,-48.0,-51.0,-49.0,-43.0,-47.0,-91.0,-93.0,-90.0,-93.0,40.0,46.0,48.0,45.0,0
4294,CC:2F:71:3F:1F:24,4445426,1177825487,622010,695596293,3823416,482229194,37,513115,562224084,512497,562149684,618,74400,495434,10,622247,56935,34,447,130000.0,43333.0,-67.0,-65.0,-70.0,-67.0,-67.0,-65.0,-70.0,-67.0,-91.0,-93.0,-90.0,-93.0,24.0,28.0,20.0,26.0,0
4295,CC:2F:71:3E:C5:1F,3824163,482320595,747,91401,3823416,482229194,0,3132,263041,2586,198169,546,64872,791,8,1078,18,0,34,130000.0,39000.0,-70.0,-71.0,-67.0,-59.0,-70.0,-71.0,-67.0,-59.0,-91.0,-93.0,-90.0,-93.0,21.0,22.0,23.0,34.0,0
4296,BA:8C:B9:54:50:24,3828112,488372944,4696,6143750,3823416,482229194,0,8219,1632484,8198,1629127,21,3357,2306,14,5071,36,0,53,216660.0,130000.0,-39.0,-36.0,-45.0,-51.0,-41.0,-34.0,-42.0,-47.0,-91.0,-93.0,-90.0,-93.0,52.0,57.0,45.0,42.0,0
4297,92:69:1D:31:68:E9,3827055,485737603,3635,3508005,3823420,482229598,0,3980,992215,3868,967130,112,25085,1927,6,3761,79,0,32,229410.0,130000.0,-51.0,-47.0,-42.0,-48.0,-51.0,-49.0,-43.0,-47.0,-91.0,-93.0,-90.0,-93.0,40.0,46.0,48.0,45.0,0
4298,CC:2F:71:3F:1F:24,4445473,1177840455,622053,695610857,3823420,482229598,37,513141,562229004,512523,562154604,618,74400,495460,10,622290,56961,34,447,117000.0,39000.0,-67.0,-65.0,-70.0,-67.0,-67.0,-65.0,-70.0,-67.0,-91.0,-93.0,-90.0,-93.0,24.0,28.0,20.0,26.0,0
4299,CC:2F:71:3E:C5:1F,3824167,482320999,747,91401,3823420,482229598,0,3132,263041,2586,198169,546,64872,791,8,1078,18,0,34,130000.0,39000.0,-70.0,-71.0,-67.0,-59.0,-70.0,-71.0,-67.0,-59.0,-91.0,-93.0,-90.0,-93.0,21.0,22.0,23.0,34.0,0
4300,BA:8C:B9:54:50:24,3828116,488373348,4696,6143750,3823420,482229598,0,8219,1632484,8198,1629127,21,3357,2306,14,5071,36,0,53,216660.0,130000.0,-39.0,-36.0,-45.0,-51.0,-41.0,-34.0,-42.0,-47.0,-91.0,-93.0,-90.0,-93.0,52.0,57.0,45.0,42.0,0
4301,92:69:1D:31:68:E9,3827060,485738067,3635,3508005,3823425,482230062,0,3980,992215,3868,967130,112,25085,1927,6,3761,79,0,32,229410.0,130000.0,-51.0,-47.0,-42.0,-48.0,-51.0,-49.0,-43.0,-47.0,-91.0,-93.0,-90.0,-93.0,40.0,46.0,48.0,45.0,0
4302,CC:2F:71:3F:1F:24,4445521,1177855471,622096,695625409,3823425,482230062,37,513167,562233948,512549,562159548,618,74400,495486,10,622333,56963,34,447,130000.0,43333.0,-67.0,-65.0,-70.0,-67.0,-67.0,-65.0,-70.0,-67.0,-91.0,-93.0,-90.0,-93.0,24.0,28.0,20.0,26.0,0
4303,CC:2F:71:3E:C5:1F,3824172,482321463,747,91401,3823425,482230062,0,3132,263041,2586,198169,546,64872,791,8,1078,18,0,34,130000.0,39000.0,-70.0,-71.0,-67.0,-59.0,-70.0,-71.0,-67.0,-59.0,-91.0,-93.0,-90.0,-93.0,21.0,22.0,23.0,34.0,0
4304,BA:8C:B9:54:50:24,3828121,488373812,4696,6143750,3823425,482230062,0,8219,1632484,8198,1629127,21,3357,2306,14,5071,36,0,53,216660.0,130000.0,-39.0,-36.0,-45.0,-51.0,-41.0,-34.0,-42.0,-47.0,-91.0,-93.0,-90.0,-93.0,52.0,57.0,45.0,42.0,0
4305,92:69:1D:31:68:E9,3827064,485738471,3635,3508005,3823429,482230466,0,3980,992215,3868,967130,112,25085,1927,6,3761,79,0,32,229410.0,130000.0,-51.0,-47.0,-42.0,-48.0,-51.0,-49.0,-43.0,-47.0,-91.0,-93.0,-90.0,-93.0,40.0,46.0,48.0,45.0,0
4306,CC:2F:71:3F:1F:24,4445567,1177870415,622138,695639949,3823429,482230466,37,513194,562239008,512576,562164608,618,74400,495513,10,622375,56971,34,447,130000.0,43333.0,-67.0,-65.0,-71.0,-67.0,-67.0,-65.0,-70.0,-67.0,-91.0,-93.0,-90.0,-93.0,24.0,28.0,19.0,26.0,0
4307,CC:2F:71:3E:C5:1F,3824176,482321867,747,91401,3823429,482230466,0,3132,263041,2586,198169,546,64872,791,8,1078,18,0,34,130000.0,39000.0,-70.0,-71.0,-67.0,-59.0,-70.0,-71.0,-67.0,-59.0,-91.0,-93.0,-90.0,-93.0,21.0,22.0,23.0,34.0,0
4308,BA:8C:B9:54:50:24,3828125,488374216,4696,6143750,3823429,482230466,0,8219,1632484,8198,1629127,21,3357,2306,14,5071,36,0,53,216660.0,130000.0,-39.0,-36.0,-45.0,-51.0,-41.0,-34.0,-42.0,-47.0,-91.0,-93.0,-90.0,-93.0,52.0,57.0,45.0,42.0,0
4309,92:69:1D:31:68:E9,3827069,485738935,3635,3508005,3823434,482230930,0,3980,992215,3868,967130,112,25085,1927,6,3761,79,0,32,229410.0,130000.0,-51.0,-47.0,-42.0,-48.0,-51.0,-49.0,-43.0,-47.0,-91.0,-93.0,-90.0,-93.0,40.0,46.0,48.0,45.0,0
4310,CC:2F:71:3F:1F:24,4445615,1177885431,622181,695654501,3823434,482230930,37,513221,562244068,512603,562169668,618,74400,495540,10,622418,56987,34,447,117000.0,39000.0,-67.0,-65.0,-70.0,-67.0,-67.0,-65.0,-70.0,-67.0,-91.0,-93.0,-90.0,-93.0,24.0,28.0,20.0,26.0,0
4311,CC:2F:71:3E:C5:1F,3824181,482322331,747,91401,3823434,482230930,0,3132,263041,2586,198169,546,64872,791,8,1078,18,0,34,130000.0,39000.0,-70.0,-71.0,-67.0,-59.0,-70.0,-71.0,-67.0,-59.0,-91.0,-93.0,-90.0,-93.0,21.0,22.0,23.0,34.0,0
4312,BA:8C:B9:54:50:24,3828132,488374882,4696,6143750,3823436,482231132,0,8219,1632484,8198,1629127,21,3357,2306,14,5071,36,0,53,216660.0,130000.0,-39.0,-36.0,-45.0,-51.0,-41.0,-34.0,-42.0,-47.0,-91.0,-93.0,-90.0,-93.0,52.0,57.0,45.0,42.0,0
4313,92:69:1D:31:68:E9,3827074,485739455,3636,3508121,3823438,482231334,0,3982,992351,3870,967266,112,25085,1927,6,3762,79,0,32,229410.0,130000.0,-51.0,-51.0,-45.0,-48.0,-51.0,-49.0,-43.0,-47.0,-91.0,-93.0,-90.0,-93.0,40.0,42.0,45.0,45.0,0
4314,CC:2F:71:3F:1F:24,4445662,1177900379,622224,695669045,3823438,482231334,37,513247,562249012,512629,562174612,618,74400,495566,10,622461,56989,34,447,130000.0,43333.0,-67.0,-65.0,-70.0,-68.0,-67.0,-64.0,-70.0,-67.0,-91.0,-93.0,-90.0,-93.0,24.0,28.0,20.0,25.0,0
4315,CC:2F:71:3E:C5:1F,3824186,482322851,748,91517,3823438,482231334,0,3134,263181,2588,198309,546,64872,791,8,1079,18,0,34,130000.0,39000.0,-79.0,-85.0,-76.0,-71.0,-71.0,-72.0,-68.0,-61.0,-91.0,-93.0,-90.0,-93.0,12.0,8.0,14.0,22.0,0
4316,BA:8C:B9:54:50:24,3828135,488375200,4697,6143866,3823438,482231334,0,8221,1632620,8200,1629263,21,3357,2306,14,5072,36,0,53,229410.0,130000.0,-39.0,-36.0,-44.0,-51.0,-40.0,-35.0,-43.0,-48.0,-91.0,-93.0,-90.0,-93.0,52.0,57.0,46.0,42.0,0
4317,92:69:1D:31:68:E9,3827079,485740132,3636,3508121,3823443,482232011,0,3982,992351,3870,967266,112,25085,1927,6,3762,79,0,32,229410.0,130000.0,-51.0,-51.0,-45.0,-48.0,-51.0,-49.0,-43.0,-47.0,-91.0,-93.0,-90.0,-93.0,40.0,42.0,45.0,45.0,0
4318,CC:2F:71:3F:1F:24,4445708,1177915360,622265,695683349,3823443,482232011,37,513273,562253956,512655,562179556,618,74400,495592,10,622502,57003,34,447,117000.0,39000.0,-67.0,-65.0,-70.0,-67.0,-67.0,-65.0,-70.0,-67.0,-91.0,-93.0,-90.0,-93.0,24.0,28.0,20.0,26.0,0
4319,CC:2F:71:3E:C5:1F,3824193,482323730,748,91517,3823445,482232213,0,3134,263181,2588,198309,546,64872,791,8,1079,18,0,34,130000.0,39000.0,-79.0,-85.0,-76.0,-71.0,-71.0,-72.0,-68.0,-61.0,-91.0,-93.0,-90.0,-93.0,12.0,8.0,14.0,22.0,0
4320,BA:8C:B9:54:50:24,3828142,488376079,4697,6143866,3823445,482232213,0,8221,1632620,8200,1629263,21,3357,2306,14,5072,36,0,53,229410.0,130000.0,-39.0,-36.0,-44.0,-51.0,-40.0,-35.0,-43.0,-48.0,-91.0,-93.0,-90.0,-93.0,52.0,57.0,46.0,42.0,0
4321,92:69:1D:31:68:E9,3827085,485740658,3636,3508121,3823449,482232537,0,3982,992351,3870,967266,112,25085,1927,6,3762,79,0,32,229410.0,130000.0,-51.0,-51.0,-45.0,-48.0,-51.0,-49.0,-43.0,-47.0,-91.0,-93.0,-90.0,-93.0,40.0,42.0,45.0,45.0,0
4322,CC:2F:71:3F:1F:24,4445757,1177930438,622308,695697901,3823449,482232537,37,513299,562258900,512681,562184500,618,74400,495618,10,622545,57011,34,447,130000.0,43333.0,-67.0,-65.0,-70.0,-67.0,-67.0,-65.0,-70.0,-67.0,-91.0,-93.0,-90.0,-93.0,24.0,28.0,20.0,26.0,0
4323,CC:2F:71:3E:C5:1F,3824197,482324054,748,91517,3823449,482232537,0,3136,263369,2589,198379,547,64990,792,8,1079,18,0,34,130000.0,39000.0,-70.0,-71.0,-68.0,-60.0,-71.0,-72.0,-68.0,-61.0,-91.0,-93.0,-90.0,-93.0,21.0,22.0,22.0,33.0,0
4324,BA:8C:B9:54:50:24,3828146,488376403,4697,6143866,3823449,482232537,0,8222,1632688,8201,1629331,21,3357,2306,14,5072,36,0,53,229410.0,130000.0,-39.0,-36.0,-45.0,-51.0,-40.0,-35.0,-43.0,-48.0,-91.0,-93.0,-90.0,-93.0,52.0,57.0,45.0,42.0,0
4325,92:69:1D:31:68:E9,3827089,485741062,3636,3508121,3823453,482232941,0,3982,992351,3870,967266,112,25085,1927,6,3762,79,0,32,229410.0,130000.0,-51.0,-51.0,-45.0,-48.0,-51.0,-49.0,-43.0,-47.0,-91.0,-93.0,-90.0,-93.0,40.0,42.0,45.0,45.0,0
4326,CC:2F:71:3F:1F:24,4445802,1177945090,622349,695712149,3823453,482232941,37,513324,562263704,512706,562189304,618,74400,495643,10,622586,57020,34,447,130000.0,39000.0,-67.0,-65.0,-70.0,-67.0,-67.0,-65.0,-70.0,-67.0,-91.0,-93.0,-90.0,-93.0,24.0,28.0,20.0,26.0,0
4327,CC:2F:71:3E:C5:1F,3824203,482324660,748,91517,3823455,482233143,0,3136,263369,2589,198379,547,64990,792,8,1079,18,0,34,130000.0,39000.0,-70.0,-71.0,-68.0,-60.0,-71.0,-72.0,-68.0,-61.0,-91.0,-93.0,-90.0,-93.0,21.0,22.0,22.0,33.0,0
4328,BA:8C:B9:54:50:24,3828152,488377009,4697,6143866,3823455,482233143,0,8222,1632688,8201,1629331,21,3357,2306,14,5072,36,0,53,229410.0,130000.0,-39.0,-36.0,-45.0,-51.0,-40.0,-35.0,-43.0,-48.0,-91.0,-93.0,-90.0,-93.0,52.0,57.0,45.0,42.0,0
4329,92:69:1D:31:68:E9,3827093,485741466,3636,3508121,3823457,482233345,0,3982,992351,3870,967266,112,25085,1927,6,3762,79,0,32,229410.0,130000.0,-51.0,-51.0,-45.0,-48.0,-51.0,-49.0,-43.0,-47.0,-91.0,-93.0,-90.0,-93.0,40.0,42.0,45.0,45.0,0
4330,CC:2F:71:3F:1F:24,4445848,1177959866,622391,695726521,3823457,482233345,37,513349,562268508,512731,562194108,618,74400,495668,10,622628,57037,34,447,117000.0,39000.0,-67.0,-65.0,-70.0,-68.0,-67.0,-65.0,-70.0,-67.0,-91.0,-93.0,-90.0,-93.0,24.0,28.0,20.0,25.0,0
4331,CC:2F:71:3E:C5:1F,3824206,482324922,748,91517,3823458,482233405,0,3136,263369,2589,198379,547,64990,792,8,1079,18,0,34,130000.0,39000.0,-70.0,-71.0,-68.0,-60.0,-71.0,-72.0,-68.0,-61.0,-91.0,-93.0,-90.0,-93.0,21.0,22.0,22.0,33.0,0
4332,BA:8C:B9:54:50:24,3828155,488377271,4697,6143866,3823458,482233405,0,8222,1632688,8201,1629331,21,3357,2306,14,5072,36,0,53,229410.0,130000.0,-39.0,-36.0,-45.0,-51.0,-40.0,-35.0,-43.0,-48.0,-91.0,-93.0,-90.0,-93.0,52.0,57.0,45.0,42.0,0
4333,92:69:1D:31:68:E9,3827098,485741930,3636,3508121,3823462,482233809,0,3982,992351,3870,967266,112,25085,1927,6,3762,79,0,32,229410.0,130000.0,-51.0,-51.0,-45.0,-48.0,-51.0,-49.0,-43.0,-47.0,-90.0,-93.0,-90.0,-93.0,39.0,42.0,45.0,45.0,0
4334,CC:2F:71:3F:1F:24,4445896,1177974882,622434,695741073,3823462,482233809,37,513375,562273452,512757,562199052,618,74400,495694,10,622671,57043,34,447,130000.0,43333.0,-67.0,-65.0,-71.0,-68.0,-67.0,-65.0,-70.0,-67.0,-90.0,-93.0,-90.0,-93.0,23.0,28.0,19.0,25.0,0
4335,CC:2F:71:3E:C5:1F,3824210,482325326,748,91517,3823462,482233809,0,3136,263369,2589,198379,547,64990,792,8,1079,18,0,34,130000.0,39000.0,-70.0,-71.0,-68.0,-60.0,-71.0,-72.0,-68.0,-61.0,-90.0,-93.0,-90.0,-93.0,20.0,22.0,22.0,33.0,0
4336,BA:8C:B9:54:50:24,3828161,488377877,4697,6143866,3823464,482234011,0,8222,1632688,8201,1629331,21,3357,2306,14,5072,36,0,53,229410.0,130000.0,-39.0,-36.0,-45.0,-51.0,-40.0,-35.0,-43.0,-48.0,-90.0,-93.0,-90.0,-93.0,51.0,57.0,45.0,42.0,0
4337,92:69:1D:31:68:E9,3827102,485742334,3636,3508121,3823466,482234213,0,3982,992351,3870,967266,112,25085,1927,6,3762,79,0,32,229410.0,130000.0,-51.0,-51.0,-45.0,-48.0,-51.0,-49.0,-43.0,-47.0,-90.0,-93.0,-90.0,-93.0,39.0,42.0,45.0,45.0,0
4338,CC:2F:71:3F:1F:24,4445940,1177989466,622474,695755253,3823466,482234213,37,513400,562278256,512782,562203856,618,74400,495719,10,622711,57075,34,447,144444.0,39000.0,-67.0,-65.0,-70.0,-67.0,-67.0,-65.0,-70.0,-67.0,-90.0,-93.0,-90.0,-93.0,23.0,28.0,20.0,26.0,0
4339,CC:2F:71:3E:C5:1F,3824214,482325730,748,91517,3823466,482234213,0,3136,263369,2589,198379,547,64990,792,8,1079,18,0,34,130000.0,39000.0,-70.0,-71.0,-68.0,-60.0,-71.0,-72.0,-68.0,-61.0,-90.0,-93.0,-90.0,-93.0,20.0,22.0,22.0,33.0,0
4340,BA:8C:B9:54:50:24,3828163,488378079,4697,6143866,3823466,482234213,0,8222,1632688,8201,1629331,21,3357,2306,14,5072,36,0,53,229410.0,130000.0,-39.0,-36.0,-45.0,-51.0,-40.0,-35.0,-43.0,-48.0,-90.0,-93.0,-90.0,-93.0,51.0,57.0,45.0,42.0,0
4341,92:69:1D:31:68:E9,3827107,485742798,3636,3508121,3823471,482234677,0,3982,992351,3870,967266,112,25085,1927,6,3762,79,0,32,229410.0,130000.0,-51.0,-51.0,-45.0,-48.0,-51.0,-49.0,-43.0,-47.0,-90.0,-93.0,-90.0,-93.0,39.0,42.0,45.0,45.0,0
4342,CC:2F:71:3F:1F:24,4445988,1178004482,622517,695769805,3823471,482234677,37,513425,562283060,512807,562208660,618,74400,495744,10,622754,57086,34,447,130000.0,43333.0,-67.0,-65.0,-71.0,-67.0,-67.0,-65.0,-70.0,-67.0,-90.0,-93.0,-90.0,-93.0,23.0,28.0,19.0,26.0,0
4343,CC:2F:71:3E:C5:1F,3824220,482326256,748,91517,3823472,482234739,0,3136,263369,2589,198379,547,64990,792,8,1079,18,0,34,130000.0,39000.0,-70.0,-71.0,-68.0,-60.0,-71.0,-72.0,-68.0,-61.0,-90.0,-93.0,-90.0,-93.0,20.0,22.0,22.0,33.0,0
4344,BA:8C:B9:54:50:24,3828169,488378605,4697,6143866,3823472,482234739,0,8222,1632688,8201,1629331,21,3357,2306,14,5072,36,0,53,229410.0,130000.0,-39.0,-36.0,-45.0,-51.0,-40.0,-35.0,-43.0,-48.0,-90.0,-93.0,-90.0,-93.0,51.0,57.0,45.0,42.0,0
4345,92:69:1D:31:68:E9,3827112,485743264,3636,3508121,3823476,482235143,0,3982,992351,3870,967266,112,25085,1927,6,3762,79,0,32,229410.0,130000.0,-51.0,-51.0,-45.0,-48.0,-51.0,-49.0,-43.0,-47.0,-90.0,-93.0,-90.0,-93.0,39.0,42.0,45.0,45.0,0
4346,CC:2F:71:3F:1F:24,4446035,1178019376,622559,695784233,3823476,482235143,37,513453,562288238,512834,562213720,619,74518,495772,10,622796,57101,34,447,117000.0,39000.0,-67.0,-65.0,-71.0,-68.0,-67.0,-65.0,-70.0,-67.0,-90.0,-93.0,-90.0,-93.0,23.0,28.0,19.0,25.0,0
4347,CC:2F:71:3E:C5:1F,3824224,482326660,748,91517,3823476,482235143,0,3136,263369,2589,198379,547,64990,792,8,1079,18,0,34,130000.0,39000.0,-70.0,-71.0,-68.0,-60.0,-71.0,-72.0,-68.0,-61.0,-90.0,-93.0,-90.0,-93.0,20.0,22.0,22.0,33.0,0
4348,BA:8C:B9:54:50:24,3828173,488379009,4697,6143866,3823476,482235143,0,8222,1632688,8201,1629331,21,3357,2306,14,5072,36,0,53,229410.0,130000.0,-39.0,-36.0,-45.0,-51.0,-40.0,-35.0,-43.0,-48.0,-90.0,-93.0,-90.0,-93.0,51.0,57.0,45.0,42.0,0
4349,92:69:1D:31:68:E9,3827118,485743952,3638,3508405,3823480,482235547,0,3987,992771,3875,967686,112,25085,1928,6,3764,79,0,32,229410.0,130000.0,-50.0,-47.0,-42.0,-48.0,-50.0,-49.0,-43.0,-48.0,-90.0,-93.0,-90.0,-93.0,40.0,46.0,48.0,45.0,0
4350,CC:2F:71:3F:1F:24,4446082,1178034332,622602,695798785,3823480,482235547,37,513479,562293182,512860,562218664,619,74518,495798,10,622839,57105,34,447,130000.0,43333.0,-67.0,-65.0,-70.0,-68.0,-67.0,-65.0,-70.0,-67.0,-90.0,-93.0,-90.0,-93.0,23.0,28.0,20.0,25.0,0
4351,CC:2F:71:3E:C5:1F,3824228,482327064,748,91517,3823480,482235547,0,3136,263369,2589,198379,547,64990,792,8,1079,18,0,34,130000.0,39000.0,-70.0,-71.0,-68.0,-60.0,-71.0,-72.0,-68.0,-61.0,-90.0,-93.0,-90.0,-93.0,20.0,22.0,22.0,33.0,0
4352,BA:8C:B9:54:50:24,3828177,488379413,4697,6143866,3823480,482235547,0,8222,1632688,8201,1629331,21,3357,2306,14,5072,36,0,53,229410.0,130000.0,-39.0,-36.0,-45.0,-51.0,-40.0,-35.0,-43.0,-48.0,-90.0,-93.0,-90.0,-93.0,51.0,57.0,45.0,42.0,0
4353,92:69:1D:31:68:E9,3827123,485744416,3638,3508405,3823485,482236011,0,3987,992771,3875,967686,112,25085,1928,6,3764,79,0,32,229410.0,130000.0,-50.0,-47.0,-42.0,-48.0,-50.0,-49.0,-43.0,-48.0,-90.0,-93.0,-90.0,-93.0,40.0,46.0,48.0,45.0,0
4354,CC:2F:71:3F:1F:24,4446129,1178049336,622644,695813325,3823485,482236011,37,513506,562298266,512887,562223748,619,74518,495825,10,622881,57113,34,447,130000.0,43333.0,-67.0,-65.0,-70.0,-67.0,-67.0,-65.0,-70.0,-67.0,-90.0,-93.0,-90.0,-93.0,23.0,28.0,20.0,26.0,0
4355,CC:2F:71:3E:C5:1F,3824233,482327528,748,91517,3823485,482236011,0,3136,263369,2589,198379,547,64990,792,8,1079,18,0,34,130000.0,39000.0,-70.0,-71.0,-68.0,-60.0,-71.0,-72.0,-68.0,-61.0,-90.0,-93.0,-90.0,-93.0,20.0,22.0,22.0,33.0,0
4356,BA:8C:B9:54:50:24,3828182,488379877,4697,6143866,3823485,482236011,0,8222,1632688,8201,1629331,21,3357,2306,14,5072,36,0,53,229410.0,130000.0,-39.0,-36.0,-45.0,-51.0,-40.0,-35.0,-43.0,-48.0,-90.0,-93.0,-89.0,-93.0,51.0,57.0,44.0,42.0,0
4357,92:69:1D:31:68:E9,3827125,485744618,3638,3508405,3823487,482236213,0,3987,992771,3875,967686,112,25085,1928,6,3764,79,0,32,229410.0,130000.0,-50.0,-47.0,-42.0,-48.0,-50.0,-49.0,-43.0,-48.0,-90.0,-93.0,-89.0,-93.0,40.0,46.0,47.0,45.0,0
4358,CC:2F:71:3F:1F:24,4446174,1178064044,622685,695827629,3823489,482236415,37,513533,562303302,512914,562228784,619,74518,495852,10,622922,57137,34,447,117000.0,39000.0,-67.0,-65.0,-70.0,-67.0,-67.0,-65.0,-70.0,-67.0,-90.0,-93.0,-89.0,-93.0,23.0,28.0,19.0,26.0,0
4359,CC:2F:71:3E:C5:1F,3824237,482327932,748,91517,3823489,482236415,0,3136,263369,2589,198379,547,64990,792,8,1079,18,0,34,130000.0,39000.0,-70.0,-71.0,-68.0,-60.0,-71.0,-72.0,-68.0,-61.0,-90.0,-93.0,-89.0,-93.0,20.0,22.0,21.0,33.0,0
4360,BA:8C:B9:54:50:24,3828186,488380281,4697,6143866,3823489,482236415,0,8222,1632688,8201,1629331,21,3357,2306,14,5072,36,0,53,229410.0,130000.0,-39.0,-36.0,-45.0,-51.0,-40.0,-35.0,-43.0,-48.0,-90.0,-93.0,-89.0,-93.0,51.0,57.0,44.0,42.0,0
4361,92:69:1D:31:68:E9,3827132,485745350,3638,3508405,3823494,482236945,0,3987,992771,3875,967686,112,25085,1928,6,3764,79,0,32,229410.0,130000.0,-50.0,-47.0,-42.0,-48.0,-50.0,-49.0,-43.0,-48.0,-90.0,-93.0,-89.0,-93.0,40.0,46.0,47.0,45.0,0
4362,CC:2F:71:3F:1F:24,4446220,1178078878,622726,695841933,3823494,482236945,37,513559,562308222,512940,562233704,619,74518,495878,10,622963,57149,34,447,130000.0,39000.0,-67.0,-65.0,-70.0,-67.0,-67.0,-65.0,-70.0,-67.0,-90.0,-93.0,-89.0,-93.0,23.0,28.0,19.0,26.0,0
4363,CC:2F:71:3E:C5:1F,3824243,482328522,748,91517,3823495,482237005,0,3136,263369,2589,198379,547,64990,792,8,1079,18,0,34,130000.0,39000.0,-70.0,-71.0,-68.0,-60.0,-71.0,-72.0,-68.0,-61.0,-90.0,-93.0,-89.0,-93.0,20.0,22.0,21.0,33.0,0
4364,BA:8C:B9:54:50:24,3828192,488380871,4697,6143866,3823495,482237005,0,8222,1632688,8201,1629331,21,3357,2306,14,5072,36,0,53,229410.0,130000.0,-39.0,-36.0,-45.0,-51.0,-40.0,-35.0,-43.0,-48.0,-90.0,-93.0,-89.0,-93.0,51.0,57.0,44.0,42.0,0
4365,92:69:1D:31:68:E9,3827137,485745814,3638,3508405,3823499,482237409,0,3987,992771,3875,967686,112,25085,1928,6,3764,79,0,32,229410.0,130000.0,-50.0,-47.0,-42.0,-48.0,-50.0,-49.0,-43.0,-48.0,-90.0,-93.0,-89.0,-93.0,40.0,46.0,47.0,45.0,0
4366,CC:2F:71:3F:1F:24,4446268,1178093782,622769,695856373,3823499,482237409,37,513586,562313282,512967,562238764,619,74518,495905,10,623005,57183,34,447,130000.0,43333.0,-67.0,-65.0,-71.0,-68.0,-67.0,-65.0,-70.0,-67.0,-90.0,-93.0,-89.0,-93.0,23.0,28.0,18.0,25.0,0
4367,CC:2F:71:3E:C5:1F,3824247,482328926,748,91517,3823499,482237409,0,3136,263369,2589,198379,547,64990,792,8,1079,18,0,34,130000.0,39000.0,-70.0,-71.0,-68.0,-60.0,-71.0,-72.0,-68.0,-61.0,-90.0,-93.0,-89.0,-93.0,20.0,22.0,21.0,33.0,0
4368,BA:8C:B9:54:50:24,3828196,488381275,4697,6143866,3823499,482237409,0,8222,1632688,8201,1629331,21,3357,2306,14,5072,36,0,53,229410.0,130000.0,-39.0,-36.0,-45.0,-51.0,-40.0,-35.0,-43.0,-48.0,-90.0,-93.0,-89.0,-93.0,51.0,57.0,44.0,42.0,0
4369,92:69:1D:31:68:E9,3827142,485746491,3638,3508405,3823504,482238086,0,3987,992771,3875,967686,112,25085,1928,6,3764,79,0,32,229410.0,130000.0,-50.0,-47.0,-42.0,-48.0,-50.0,-49.0,-43.0,-48.0,-90.0,-93.0,-89.0,-93.0,40.0,46.0,47.0,45.0,0
4370,CC:2F:71:3F:1F:24,4446315,1178108999,622811,695870913,3823504,482238086,37,513612,562318202,512993,562243684,619,74518,495931,10,623048,57189,34,447,130000.0,43333.0,-67.0,-65.0,-70.0,-67.0,-67.0,-65.0,-70.0,-67.0,-90.0,-93.0,-89.0,-93.0,23.0,28.0,19.0,26.0,0
4371,CC:2F:71:3E:C5:1F,3824252,482329603,748,91517,3823504,482238086,0,3136,263369,2589,198379,547,64990,792,8,1079,18,0,34,130000.0,39000.0,-70.0,-71.0,-68.0,-60.0,-71.0,-72.0,-68.0,-61.0,-90.0,-93.0,-89.0,-93.0,20.0,22.0,21.0,33.0,0
4372,BA:8C:B9:54:50:24,3828201,488381952,4697,6143866,3823504,482238086,0,8222,1632688,8201,1629331,21,3357,2306,14,5072,36,0,53,229410.0,130000.0,-39.0,-36.0,-45.0,-51.0,-40.0,-35.0,-43.0,-48.0,-90.0,-93.0,-89.0,-93.0,51.0,57.0,44.0,42.0,0
4373,92:69:1D:31:68:E9,3827145,485746753,3638,3508405,3823507,482238348,0,3987,992771,3875,967686,112,25085,1928,6,3764,79,0,32,229410.0,130000.0,-50.0,-47.0,-42.0,-48.0,-50.0,-49.0,-43.0,-48.0,-90.0,-93.0,-89.0,-93.0,40.0,46.0,47.0,45.0,0
4374,CC:2F:71:3F:1F:24,4446361,1178123879,622852,695885329,3823509,482238550,37,513638,562323146,513019,562248628,619,74518,495957,10,623089,57196,34,447,130000.0,43333.0,-67.0,-65.0,-71.0,-68.0,-67.0,-65.0,-70.0,-67.0,-90.0,-93.0,-89.0,-93.0,23.0,28.0,18.0,25.0,0
4375,CC:2F:71:3E:C5:1F,3824257,482330067,748,91517,3823509,482238550,0,3136,263369,2589,198379,547,64990,792,8,1079,18,0,34,130000.0,39000.0,-70.0,-71.0,-68.0,-60.0,-71.0,-72.0,-68.0,-61.0,-90.0,-93.0,-89.0,-93.0,20.0,22.0,21.0,33.0,0
4376,BA:8C:B9:54:50:24,3828206,488382416,4697,6143866,3823509,482238550,0,8222,1632688,8201,1629331,21,3357,2306,14,5072,36,0,53,229410.0,130000.0,-39.0,-36.0,-45.0,-51.0,-40.0,-35.0,-43.0,-48.0,-90.0,-93.0,-89.0,-93.0,51.0,57.0,44.0,42.0,0
4377,92:69:1D:31:68:E9,3827152,485747475,3639,3508521,3823513,482238954,0,3990,993013,3878,967928,112,25085,1929,6,3765,79,0,32,229410.0,130000.0,-51.0,-51.0,-45.0,-48.0,-51.0,-50.0,-44.0,-48.0,-90.0,-93.0,-89.0,-93.0,39.0,42.0,44.0,45.0,0
4378,CC:2F:71:3F:1F:24,4446406,1178138637,622893,695899683,3823513,482238954,37,513663,562327950,513044,562253432,619,74518,495982,10,623130,57214,34,447,130000.0,39000.0,-67.0,-65.0,-70.0,-67.0,-67.0,-65.0,-70.0,-67.0,-90.0,-93.0,-89.0,-93.0,23.0,28.0,19.0,26.0,0
4379,CC:2F:71:3E:C5:1F,3824261,482330471,748,91517,3823513,482238954,0,3136,263369,2589,198379,547,64990,792,8,1079,18,0,34,130000.0,39000.0,-70.0,-71.0,-68.0,-60.0,-71.0,-72.0,-68.0,-61.0,-90.0,-93.0,-89.0,-93.0,20.0,22.0,21.0,33.0,0
4380,BA:8C:B9:54:50:24,3828210,488382820,4697,6143866,3823513,482238954,0,8222,1632688,8201,1629331,21,3357,2306,14,5072,36,0,53,229410.0,130000.0,-39.0,-36.0,-45.0,-51.0,-40.0,-35.0,-43.0,-48.0,-90.0,-93.0,-89.0,-93.0,51.0,57.0,44.0,42.0,0
4381,92:69:1D:31:68:E9,3827154,485747677,3639,3508521,3823515,482239156,0,3990,993013,3878,967928,112,25085,1929,6,3765,79,0,32,229410.0,130000.0,-51.0,-51.0,-45.0,-48.0,-51.0,-50.0,-44.0,-48.0,-90.0,-92.0,-89.0,-93.0,39.0,41.0,44.0,45.0,0
4382,CC:2F:71:3F:1F:24,4446449,1178153143,622934,695913987,3823515,482239156,37,513689,562332894,513070,562258376,619,74518,496008,10,623171,57228,34,447,130000.0,39000.0,-67.0,-65.0,-71.0,-67.0,-67.0,-65.0,-70.0,-67.0,-90.0,-92.0,-89.0,-93.0,23.0,27.0,18.0,26.0,0
4383,CC:2F:71:3E:C5:1F,3824265,482330875,748,91517,3823517,482239358,0,3136,263369,2589,198379,547,64990,792,8,1079,18,0,34,130000.0,39000.0,-70.0,-71.0,-68.0,-60.0,-71.0,-72.0,-68.0,-61.0,-90.0,-92.0,-89.0,-93.0,20.0,21.0,21.0,33.0,0
4384,BA:8C:B9:54:50:24,3828214,488383224,4697,6143866,3823517,482239358,0,8222,1632688,8201,1629331,21,3357,2306,14,5072,36,0,53,229410.0,130000.0,-39.0,-36.0,-45.0,-51.0,-40.0,-35.0,-43.0,-48.0,-90.0,-92.0,-89.0,-93.0,51.0,56.0,44.0,42.0,0
4385,92:69:1D:31:68:E9,3827161,485748343,3639,3508521,3823522,482239822,0,3990,993013,3878,967928,112,25085,1929,6,3765,79,0,32,229410.0,130000.0,-51.0,-51.0,-45.0,-48.0,-51.0,-50.0,-44.0,-48.0,-90.0,-92.0,-89.0,-93.0,39.0,41.0,44.0,45.0,0
4386,CC:2F:71:3F:1F:24,4446498,1178168237,622976,695928415,3823522,482239822,37,513718,562338186,513099,562263668,619,74518,496037,10,623213,57238,34,447,130000.0,39000.0,-67.0,-65.0,-70.0,-68.0,-67.0,-65.0,-70.0,-67.0,-90.0,-92.0,-89.0,-93.0,23.0,27.0,19.0,25.0,0
4387,CC:2F:71:3E:C5:1F,3824270,482331339,748,91517,3823522,482239822,0,3136,263369,2589,198379,547,64990,792,8,1079,18,0,34,130000.0,39000.0,-70.0,-71.0,-68.0,-60.0,-71.0,-72.0,-68.0,-61.0,-90.0,-92.0,-89.0,-93.0,20.0,21.0,21.0,33.0,0
4388,BA:8C:B9:54:50:24,3828219,488383688,4697,6143866,3823522,482239822,0,8222,1632688,8201,1629331,21,3357,2306,14,5072,36,0,53,229410.0,130000.0,-39.0,-36.0,-45.0,-51.0,-40.0,-35.0,-43.0,-48.0,-90.0,-92.0,-89.0,-93.0,51.0,56.0,44.0,42.0,0
4389,92:69:1D:31:68:E9,3827163,485748545,3639,3508521,3823524,482240024,0,3990,993013,3878,967928,112,25085,1929,6,3765,79,0,32,229410.0,130000.0,-51.0,-51.0,-45.0,-48.0,-51.0,-50.0,-44.0,-48.0,-90.0,-92.0,-89.0,-93.0,39.0,41.0,44.0,45.0,0
4390,CC:2F:71:3F:1F:24,4446541,1178182743,623017,695942719,3823524,482240024,37,513744,562343130,513125,562268612,619,74518,496063,10,623254,57252,34,447,130000.0,39000.0,-67.0,-65.0,-70.0,-68.0,-67.0,-65.0,-70.0,-67.0,-90.0,-92.0,-89.0,-93.0,23.0,27.0,19.0,25.0,0
4391,CC:2F:71:3E:C5:1F,3824274,482331743,748,91517,3823526,482240226,0,3136,263369,2589,198379,547,64990,792,8,1079,18,0,34,130000.0,39000.0,-70.0,-71.0,-68.0,-60.0,-71.0,-72.0,-68.0,-61.0,-90.0,-92.0,-89.0,-93.0,20.0,21.0,21.0,33.0,0
4392,BA:8C:B9:54:50:24,3828223,488384092,4697,6143866,3823526,482240226,0,8222,1632688,8201,1629331,21,3357,2306,14,5072,36,0,53,229410.0,130000.0,-39.0,-36.0,-45.0,-51.0,-40.0,-35.0,-43.0,-48.0,-90.0,-92.0,-89.0,-93.0,51.0,56.0,44.0,42.0,0
4393,92:69:1D:31:68:E9,3827170,485749211,3639,3508521,3823531,482240690,0,3990,993013,3878,967928,112,25085,1929,6,3765,79,0,32,229410.0,130000.0,-51.0,-51.0,-45.0,-48.0,-51.0,-50.0,-44.0,-48.0,-90.0,-92.0,-89.0,-93.0,39.0,41.0,44.0,45.0,0
4394,CC:2F:71:3F:1F:24,4446589,1178197657,623058,695956967,3823531,482240690,37,513769,562347934,513150,562273416,619,74518,496088,10,623295,57266,34,447,130000.0,39000.0,-67.0,-65.0,-70.0,-67.0,-67.0,-65.0,-70.0,-67.0,-90.0,-92.0,-89.0,-93.0,23.0,27.0,19.0,26.0,0
4395,CC:2F:71:3E:C5:1F,3824279,482332207,748,91517,3823531,482240690,0,3136,263369,2589,198379,547,64990,792,8,1079,18,0,34,130000.0,39000.0,-70.0,-71.0,-68.0,-60.0,-71.0,-72.0,-68.0,-61.0,-90.0,-92.0,-89.0,-93.0,20.0,21.0,21.0,33.0,0
4396,BA:8C:B9:54:50:24,3828228,488384556,4697,6143866,3823531,482240690,0,8222,1632688,8201,1629331,21,3357,2306,14,5072,36,0,53,229410.0,130000.0,-39.0,-36.0,-45.0,-51.0,-40.0,-35.0,-43.0,-48.0,-90.0,-92.0,-89.0,-93.0,51.0,56.0,44.0,42.0,0
4397,92:69:1D:31:68:E9,3827172,485749413,3639,3508521,3823533,482240892,0,3990,993013,3878,967928,112,25085,1929,6,3765,79,0,32,229410.0,130000.0,-51.0,-51.0,-45.0,-48.0,-51.0,-50.0,-44.0,-48.0,-90.0,-92.0,-89.0,-93.0,39.0,41.0,44.0,45.0,0
4398,CC:2F:71:3F:1F:24,4446635,1178212383,623100,695971289,3823535,482241094,37,513796,562352994,513177,562278476,619,74518,496115,10,623337,57281,34,447,117000.0,39000.0,-67.0,-65.0,-70.0,-67.0,-67.0,-65.0,-70.0,-67.0,-90.0,-92.0,-89.0,-93.0,23.0,27.0,19.0,26.0,0
4399,CC:2F:71:3E:C5:1F,3824283,482332611,748,91517,3823535,482241094,0,3136,263369,2589,198379,547,64990,792,8,1079,18,0,34,130000.0,39000.0,-70.0,-71.0,-68.0,-60.0,-71.0,-72.0,-68.0,-61.0,-90.0,-92.0,-89.0,-93.0,20.0,21.0,21.0,33.0,0
4400,BA:8C:B9:54:50:24,3828232,488384960,4697,6143866,3823535,482241094,0,8222,1632688,8201,1629331,21,3357,2306,14,5072,36,0,53,229410.0,130000.0,-39.0,-36.0,-45.0,-51.0,-40.0,-35.0,-43.0,-48.0,-90.0,-92.0,-89.0,-93.0,51.0,56.0,44.0,42.0,0
4401,92:69:1D:31:68:E9,3827178,485750019,3639,3508521,3823539,482241498,0,3990,993013,3878,967928,112,25085,1929,6,3765,79,0,32,229410.0,130000.0,-51.0,-51.0,-45.0,-48.0,-51.0,-50.0,-44.0,-48.0,-90.0,-92.0,-89.0,-93.0,39.0,41.0,44.0,45.0,0
4402,CC:2F:71:3F:1F:24,4446682,1178227339,623143,695985841,3823539,482241498,37,513822,562357938,513203,562283420,619,74518,496141,10,623380,57283,34,447,130000.0,43333.0,-67.0,-65.0,-70.0,-67.0,-67.0,-65.0,-70.0,-67.0,-90.0,-92.0,-89.0,-93.0,23.0,27.0,19.0,26.0,0
4403,CC:2F:71:3E:C5:1F,3824287,482333015,748,91517,3823539,482241498,0,3136,263369,2589,198379,547,64990,792,8,1079,18,0,34,130000.0,39000.0,-70.0,-71.0,-68.0,-60.0,-71.0,-72.0,-68.0,-61.0,-90.0,-92.0,-89.0,-93.0,20.0,21.0,21.0,33.0,0
4404,BA:8C:B9:54:50:24,3828236,488385364,4697,6143866,3823539,482241498,0,8222,1632688,8201,1629331,21,3357,2306,14,5072,36,0,53,229410.0,130000.0,-39.0,-36.0,-45.0,-51.0,-40.0,-35.0,-43.0,-48.0,-90.0,-92.0,-89.0,-93.0,51.0,56.0,44.0,42.0,0
4405,92:69:1D:31:68:E9,3827181,485750281,3639,3508521,3823542,482241760,0,3991,993081,3879,967996,112,25085,1929,6,3765,79,0,32,229410.0,130000.0,-50.0,-47.0,-43.0,-49.0,-50.0,-49.0,-44.0,-48.0,-90.0,-92.0,-89.0,-93.0,40.0,45.0,46.0,44.0,0
4406,CC:2F:71:3F:1F:24,4446727,1178242141,623185,696000381,3823542,482241760,37,513848,562362882,513229,562288364,619,74518,496167,10,623422,57284,34,447,130000.0,43333.0,-67.0,-65.0,-70.0,-67.0,-67.0,-65.0,-70.0,-67.0,-90.0,-92.0,-89.0,-93.0,23.0,27.0,19.0,26.0,0
4407,CC:2F:71:3E:C5:1F,3824292,482333479,748,91517,3823544,482241962,0,3136,263369,2589,198379,547,64990,792,8,1079,18,0,34,130000.0,39000.0,-70.0,-71.0,-68.0,-60.0,-71.0,-72.0,-68.0,-61.0,-90.0,-92.0,-89.0,-93.0,20.0,21.0,21.0,33.0,0
4408,BA:8C:B9:54:50:24,3828241,488385828,4697,6143866,3823544,482241962,0,8222,1632688,8201,1629331,21,3357,2306,14,5072,36,0,53,229410.0,130000.0,-39.0,-36.0,-45.0,-51.0,-40.0,-35.0,-43.0,-48.0,-90.0,-92.0,-89.0,-93.0,51.0,56.0,44.0,42.0,0
4409,92:69:1D:31:68:E9,3827187,485750887,3639,3508521,3823548,482242366,0,3991,993081,3879,967996,112,25085,1929,6,3765,79,0,32,229410.0,130000.0,-50.0,-47.0,-43.0,-49.0,-50.0,-49.0,-44.0,-48.0,-90.0,-92.0,-89.0,-93.0,40.0,45.0,46.0,44.0,0
4410,CC:2F:71:3F:1F:24,4446775,1178257175,623227,696014809,3823548,482242366,37,513873,562367686,513254,562293168,619,74518,496192,10,623464,57299,34,447,117000.0,39000.0,-67.0,-65.0,-71.0,-68.0,-67.0,-65.0,-70.0,-67.0,-90.0,-92.0,-89.0,-93.0,23.0,27.0,18.0,25.0,0
4411,CC:2F:71:3E:C5:1F,3824296,482333883,748,91517,3823548,482242366,0,3136,263369,2589,198379,547,64990,792,8,1079,18,0,34,130000.0,39000.0,-70.0,-71.0,-68.0,-60.0,-71.0,-72.0,-68.0,-61.0,-90.0,-92.0,-89.0,-93.0,20.0,21.0,21.0,33.0,0
4412,BA:8C:B9:54:50:24,3828245,488386232,4697,6143866,3823548,482242366,0,8222,1632688,8201,1629331,21,3357,2306,14,5072,36,0,53,229410.0,130000.0,-39.0,-36.0,-45.0,-51.0,-40.0,-35.0,-43.0,-48.0,-90.0,-92.0,-89.0,-93.0,51.0,56.0,44.0,42.0,0
4413,92:69:1D:31:68:E9,3827189,485751089,3639,3508521,3823550,482242568,0,3991,993081,3879,967996,112,25085,1929,6,3765,79,0,32,229410.0,130000.0,-50.0,-47.0,-43.0,-49.0,-50.0,-49.0,-44.0,-48.0,-90.0,-92.0,-89.0,-93.0,40.0,45.0,46.0,44.0,0
4414,CC:2F:71:3F:1F:24,4446821,1178272137,623271,696029569,3823550,482242568,37,513900,562372734,513281,562298216,619,74518,496219,10,623508,57307,34,447,130000.0,39000.0,-67.0,-65.0,-70.0,-67.0,-67.0,-65.0,-70.0,-67.0,-90.0,-92.0,-89.0,-93.0,23.0,27.0,19.0,26.0,0
4415,CC:2F:71:3E:C5:1F,3824301,482334347,748,91517,3823553,482242830,0,3136,263369,2589,198379,547,64990,792,8,1079,18,0,34,130000.0,39000.0,-70.0,-71.0,-68.0,-60.0,-71.0,-72.0,-68.0,-61.0,-90.0,-92.0,-89.0,-93.0,20.0,21.0,21.0,33.0,0
4416,BA:8C:B9:54:50:24,3828250,488386696,4697,6143866,3823553,482242830,0,8222,1632688,8201,1629331,21,3357,2306,14,5072,36,0,53,229410.0,130000.0,-39.0,-36.0,-45.0,-51.0,-40.0,-35.0,-43.0,-48.0,-90.0,-92.0,-89.0,-93.0,51.0,56.0,44.0,42.0,0
4417,92:69:1D:31:68:E9,3827196,485751755,3639,3508521,3823557,482243234,0,3991,993081,3879,967996,112,25085,1929,6,3765,79,0,32,229410.0,130000.0,-50.0,-47.0,-43.0,-49.0,-50.0,-49.0,-44.0,-48.0,-90.0,-92.0,-89.0,-93.0,40.0,45.0,46.0,44.0,0
4418,CC:2F:71:3F:1F:24,4446870,1178287161,623313,696043927,3823557,482243234,37,513927,562377794,513308,562303276,619,74518,496246,10,623550,57348,34,447,130000.0,43333.0,-67.0,-65.0,-70.0,-67.0,-67.0,-65.0,-70.0,-67.0,-90.0,-92.0,-89.0,-93.0,23.0,27.0,19.0,26.0,0
4419,CC:2F:71:3E:C5:1F,3824306,482334867,749,91633,3823557,482243234,0,3138,263509,2591,198519,547,64990,792,8,1080,18,0,34,144444.0,39000.0,-70.0,-71.0,-68.0,-60.0,-71.0,-72.0,-68.0,-61.0,-90.0,-92.0,-89.0,-93.0,20.0,21.0,21.0,33.0,0
4420,BA:8C:B9:54:50:24,3828255,488387160,4698,6143926,3823557,482243234,0,8224,1632824,8203,1629467,21,3357,2306,14,5073,36,0,53,229410.0,130000.0,-51.0,-34.0,-43.0,-44.0,-42.0,-35.0,-43.0,-48.0,-90.0,-92.0,-89.0,-93.0,39.0,58.0,46.0,49.0,0
4421,92:69:1D:31:68:E9,3827200,485752346,3640,3508637,3823560,482243709,0,3993,993217,3881,968132,112,25085,1929,6,3766,79,0,32,229410.0,130000.0,-50.0,-48.0,-43.0,-45.0,-50.0,-49.0,-43.0,-48.0,-90.0,-92.0,-89.0,-93.0,40.0,44.0,46.0,48.0,0
4422,CC:2F:71:3F:1F:24,4446914,1178302076,623354,696058367,3823560,482243709,37,513955,562382958,513336,562308440,619,74518,496274,10,623591,57358,34,447,130000.0,43333.0,-67.0,-65.0,-70.0,-68.0,-67.0,-65.0,-70.0,-67.0,-90.0,-92.0,-89.0,-93.0,23.0,27.0,19.0,25.0,0
4423,CC:2F:71:3E:C5:1F,3824311,482335544,749,91633,3823562,482243911,0,3138,263509,2591,198519,547,64990,792,8,1080,18,0,34,144444.0,39000.0,-70.0,-71.0,-68.0,-60.0,-71.0,-72.0,-68.0,-61.0,-90.0,-92.0,-89.0,-93.0,20.0,21.0,21.0,33.0,0
4424,BA:8C:B9:54:50:24,3828270,488391898,4708,6147987,3823562,482243911,0,8242,1641632,8221,1638275,21,3357,2315,14,5083,36,0,53,229410.0,130000.0,-49.0,-35.0,-42.0,-44.0,-46.0,-38.0,-45.0,-47.0,-90.0,-92.0,-89.0,-93.0,41.0,57.0,47.0,49.0,0
4425,92:69:1D:31:68:E9,3827207,485753012,3640,3508637,3823567,482244375,0,3993,993217,3881,968132,112,25085,1929,6,3766,79,0,32,229410.0,130000.0,-50.0,-48.0,-43.0,-45.0,-50.0,-49.0,-43.0,-48.0,-90.0,-92.0,-89.0,-93.0,40.0,44.0,46.0,48.0,0
4426,CC:2F:71:3F:1F:24,4446962,1178317158,623395,696072783,3823567,482244375,37,513982,562388054,513363,562313536,619,74518,496301,10,623632,57363,34,447,130000.0,43333.0,-67.0,-65.0,-71.0,-67.0,-67.0,-65.0,-70.0,-67.0,-90.0,-92.0,-89.0,-93.0,23.0,27.0,18.0,26.0,0
4427,CC:2F:71:3E:C5:1F,3824316,482336008,749,91633,3823567,482244375,0,3138,263509,2591,198519,547,64990,792,8,1080,18,0,34,144444.0,39000.0,-70.0,-71.0,-68.0,-60.0,-71.0,-72.0,-68.0,-61.0,-90.0,-92.0,-89.0,-93.0,20.0,21.0,21.0,33.0,0
4428,BA:8C:B9:54:50:24,3828279,488393742,4712,6149367,3823567,482244375,0,8250,1642434,8229,1639077,21,3357,2318,14,5087,36,0,53,229410.0,130000.0,-39.0,-36.0,-45.0,-51.0,-45.0,-36.0,-44.0,-48.0,-90.0,-92.0,-89.0,-93.0,51.0,56.0,44.0,42.0,0
4429,92:69:1D:31:68:E9,3827209,485753214,3640,3508637,3823569,482244577,0,3993,993217,3881,968132,112,25085,1929,6,3766,79,0,32,229410.0,130000.0,-50.0,-48.0,-43.0,-45.0,-50.0,-49.0,-43.0,-48.0,-90.0,-92.0,-89.0,-93.0,40.0,44.0,46.0,48.0,0
4430,CC:2F:71:3F:1F:24,4447007,1178331974,623438,696087397,3823569,482244577,37,514010,562393272,513391,562318754,619,74518,496329,10,623675,57381,34,447,130000.0,39000.0,-67.0,-65.0,-71.0,-67.0,-67.0,-65.0,-70.0,-67.0,-90.0,-92.0,-89.0,-93.0,23.0,27.0,18.0,26.0,0
4431,CC:2F:71:3E:C5:1F,3824320,482336412,749,91633,3823571,482244779,0,3138,263509,2591,198519,547,64990,792,8,1080,18,0,34,144444.0,39000.0,-70.0,-71.0,-68.0,-60.0,-71.0,-72.0,-68.0,-61.0,-90.0,-92.0,-89.0,-93.0,20.0,21.0,21.0,33.0,0
4432,BA:8C:B9:54:50:24,3828283,488394146,4712,6149367,3823571,482244779,0,8250,1642434,8229,1639077,21,3357,2318,14,5087,36,0,53,229410.0,130000.0,-39.0,-36.0,-45.0,-51.0,-45.0,-36.0,-44.0,-48.0,-90.0,-92.0,-89.0,-93.0,51.0,56.0,44.0,42.0,0
4433,92:69:1D:31:68:E9,3827216,485753882,3640,3508637,3823576,482245245,0,3993,993217,3881,968132,112,25085,1929,6,3766,79,0,32,229410.0,130000.0,-50.0,-48.0,-43.0,-45.0,-50.0,-49.0,-43.0,-48.0,-90.0,-92.0,-89.0,-93.0,40.0,44.0,46.0,48.0,0
4434,CC:2F:71:3F:1F:24,4447056,1178347070,623480,696101825,3823576,482245245,37,514036,562398194,513416,562323558,620,74636,496355,10,623717,57392,34,447,130000.0,39000.0,-67.0,-65.0,-71.0,-67.0,-67.0,-65.0,-70.0,-67.0,-90.0,-92.0,-89.0,-93.0,23.0,27.0,18.0,26.0,0
4435,CC:2F:71:3E:C5:1F,3824327,482337246,749,91633,3823578,482245613,0,3138,263509,2591,198519,547,64990,792,8,1080,18,0,34,144444.0,39000.0,-70.0,-71.0,-68.0,-60.0,-71.0,-72.0,-68.0,-61.0,-90.0,-92.0,-89.0,-93.0,20.0,21.0,21.0,33.0,0
4436,BA:8C:B9:54:50:24,3828290,488394980,4712,6149367,3823578,482245613,0,8250,1642434,8229,1639077,21,3357,2318,14,5087,36,0,53,229410.0,130000.0,-39.0,-36.0,-45.0,-51.0,-45.0,-36.0,-44.0,-48.0,-90.0,-92.0,-89.0,-93.0,51.0,56.0,44.0,42.0,0
4437,92:69:1D:31:68:E9,3827221,485754512,3640,3508637,3823581,482245875,0,3993,993217,3881,968132,112,25085,1929,6,3766,79,0,32,229410.0,130000.0,-50.0,-48.0,-43.0,-45.0,-50.0,-49.0,-43.0,-48.0,-90.0,-92.0,-89.0,-93.0,40.0,44.0,46.0,48.0,0
4438,CC:2F:71:3F:1F:24,4447102,1178362054,623521,696116179,3823581,482245875,37,514063,562403254,513443,562328618,620,74636,496382,10,623758,57401,34,447,130000.0,43333.0,-67.0,-65.0,-71.0,-67.0,-67.0,-65.0,-70.0,-67.0,-90.0,-92.0,-89.0,-93.0,23.0,27.0,18.0,26.0,0
4439,CC:2F:71:3E:C5:1F,3824332,482337710,749,91633,3823583,482246077,0,3138,263509,2591,198519,547,64990,792,8,1080,18,0,34,144444.0,39000.0,-70.0,-71.0,-68.0,-60.0,-71.0,-72.0,-68.0,-61.0,-90.0,-92.0,-89.0,-93.0,20.0,21.0,21.0,33.0,0
4440,BA:8C:B9:54:50:24,3828295,488395444,4712,6149367,3823583,482246077,0,8250,1642434,8229,1639077,21,3357,2318,14,5087,36,0,53,229410.0,130000.0,-39.0,-36.0,-45.0,-51.0,-45.0,-36.0,-44.0,-48.0,-90.0,-92.0,-89.0,-93.0,51.0,56.0,44.0,42.0,0
4441,92:69:1D:31:68:E9,3827227,485755118,3640,3508637,3823587,482246481,0,3993,993217,3881,968132,112,25085,1929,6,3766,79,0,32,229410.0,130000.0,-50.0,-48.0,-43.0,-45.0,-50.0,-49.0,-43.0,-48.0,-90.0,-92.0,-89.0,-93.0,40.0,44.0,46.0,48.0,0
4442,CC:2F:71:3F:1F:24,4447149,1178376964,623562,696130483,3823587,482246481,37,514088,562408058,513468,562333422,620,74636,496407,10,623799,57426,34,447,144444.0,39000.0,-67.0,-65.0,-71.0,-68.0,-67.0,-65.0,-70.0,-67.0,-90.0,-92.0,-89.0,-93.0,23.0,27.0,18.0,25.0,0
4443,CC:2F:71:3E:C5:1F,3824336,482338114,749,91633,3823587,482246481,0,3138,263509,2591,198519,547,64990,792,8,1080,18,0,34,144444.0,39000.0,-70.0,-71.0,-68.0,-60.0,-71.0,-72.0,-68.0,-61.0,-90.0,-92.0,-89.0,-93.0,20.0,21.0,21.0,33.0,0
4444,BA:8C:B9:54:50:24,3828299,488395848,4712,6149367,3823587,482246481,0,8250,1642434,8229,1639077,21,3357,2318,14,5087,36,0,53,229410.0,130000.0,-39.0,-36.0,-45.0,-51.0,-45.0,-36.0,-44.0,-48.0,-90.0,-92.0,-89.0,-93.0,51.0,56.0,44.0,42.0,0
4445,92:69:1D:31:68:E9,3827229,485755320,3640,3508637,3823589,482246683,0,3993,993217,3881,968132,112,25085,1929,6,3766,79,0,32,229410.0,130000.0,-50.0,-48.0,-43.0,-45.0,-50.0,-49.0,-43.0,-48.0,-90.0,-92.0,-89.0,-93.0,40.0,44.0,46.0,48.0,0
4446,CC:2F:71:3F:1F:24,4447196,1178391908,623606,696145165,3823590,482246743,37,514114,562413002,513494,562338366,620,74636,496433,10,623843,57446,34,447,130000.0,43333.0,-67.0,-65.0,-70.0,-67.0,-67.0,-65.0,-70.0,-67.0,-90.0,-92.0,-89.0,-93.0,23.0,27.0,19.0,26.0,0
4447,CC:2F:71:3E:C5:1F,3824339,482338376,749,91633,3823590,482246743,0,3138,263509,2591,198519,547,64990,792,8,1080,18,0,34,144444.0,39000.0,-70.0,-71.0,-68.0,-60.0,-71.0,-72.0,-68.0,-61.0,-90.0,-92.0,-89.0,-93.0,20.0,21.0,21.0,33.0,0
4448,BA:8C:B9:54:50:24,3828302,488396110,4712,6149367,3823590,482246743,0,8250,1642434,8229,1639077,21,3357,2318,14,5087,36,0,53,229410.0,130000.0,-39.0,-36.0,-45.0,-51.0,-45.0,-36.0,-44.0,-48.0,-90.0,-92.0,-89.0,-93.0,51.0,56.0,44.0,42.0,0
4449,92:69:1D:31:68:E9,3827236,485755986,3640,3508637,3823596,482247349,0,3993,993217,3881,968132,112,25085,1929,6,3766,79,0,32,229410.0,130000.0,-50.0,-48.0,-43.0,-45.0,-50.0,-49.0,-43.0,-48.0,-90.0,-92.0,-89.0,-93.0,40.0,44.0,46.0,48.0,0
4450,CC:2F:71:3F:1F:24,4447244,1178406998,623648,696159649,3823596,482247349,37,514139,562417806,513519,562343170,620,74636,496458,10,623885,57458,34,447,130000.0,39000.0,-67.0,-65.0,-70.0,-67.0,-67.0,-65.0,-70.0,-67.0,-90.0,-92.0,-89.0,-93.0,23.0,27.0,19.0,26.0,0
4451,CC:2F:71:3E:C5:1F,3824345,482338982,749,91633,3823596,482247349,0,3138,263509,2591,198519,547,64990,792,8,1080,18,0,34,144444.0,39000.0,-70.0,-71.0,-68.0,-60.0,-71.0,-72.0,-68.0,-61.0,-90.0,-92.0,-89.0,-93.0,20.0,21.0,21.0,33.0,0
4452,BA:8C:B9:54:50:24,3828309,488396832,4713,6149483,3823596,482247349,0,8257,1642952,8236,1639595,21,3357,2319,14,5088,36,0,53,229410.0,130000.0,-39.0,-36.0,-45.0,-52.0,-42.0,-37.0,-45.0,-50.0,-90.0,-92.0,-89.0,-93.0,51.0,56.0,44.0,41.0,0
4453,92:69:1D:31:68:E9,3827238,485756188,3640,3508637,3823598,482247551,0,3993,993217,3881,968132,112,25085,1929,6,3766,79,0,32,229410.0,130000.0,-50.0,-48.0,-43.0,-45.0,-50.0,-49.0,-43.0,-48.0,-90.0,-92.0,-89.0,-93.0,40.0,44.0,46.0,48.0,0
4454,CC:2F:71:3F:1F:24,4447288,1178421628,623690,696174077,3823598,482247551,37,514164,562422610,513544,562347974,620,74636,496483,10,623927,57474,34,447,130000.0,43333.0,-67.0,-65.0,-70.0,-68.0,-67.0,-65.0,-70.0,-67.0,-90.0,-92.0,-89.0,-93.0,23.0,27.0,19.0,25.0,0
4455,CC:2F:71:3E:C5:1F,3824347,482339184,749,91633,3823598,482247551,0,3138,263509,2591,198519,547,64990,792,8,1080,18,0,34,144444.0,39000.0,-70.0,-71.0,-68.0,-60.0,-71.0,-72.0,-68.0,-61.0,-90.0,-92.0,-89.0,-93.0,20.0,21.0,21.0,33.0,0
4456,BA:8C:B9:54:50:24,3828311,488397034,4713,6149483,3823598,482247551,0,8257,1642952,8236,1639595,21,3357,2319,14,5088,36,0,53,229410.0,130000.0,-39.0,-36.0,-45.0,-52.0,-42.0,-37.0,-45.0,-50.0,-90.0,-92.0,-89.0,-93.0,51.0,56.0,44.0,41.0,0
4457,92:69:1D:31:68:E9,3827246,485756916,3640,3508637,3823606,482248279,0,3993,993217,3881,968132,112,25085,1929,6,3766,79,0,32,229410.0,130000.0,-50.0,-48.0,-43.0,-45.0,-50.0,-49.0,-43.0,-48.0,-90.0,-92.0,-89.0,-93.0,40.0,44.0,46.0,48.0,0
4458,CC:2F:71:3F:1F:24,4447339,1178436858,623733,696188579,3823606,482248279,37,514189,562427414,513569,562352778,620,74636,496508,10,623970,57492,34,447,117000.0,39000.0,-67.0,-65.0,-70.0,-67.0,-67.0,-65.0,-70.0,-67.0,-90.0,-92.0,-89.0,-93.0,23.0,27.0,19.0,26.0,0
4459,CC:2F:71:3E:C5:1F,3824355,482339912,749,91633,3823606,482248279,0,3140,263697,2592,198589,548,65108,793,8,1080,18,0,34,144444.0,39000.0,-70.0,-71.0,-68.0,-60.0,-71.0,-72.0,-68.0,-61.0,-90.0,-92.0,-89.0,-93.0,20.0,21.0,21.0,33.0,0
4460,BA:8C:B9:54:50:24,3828319,488397762,4713,6149483,3823606,482248279,0,8257,1642952,8236,1639595,21,3357,2319,14,5088,36,0,53,229410.0,130000.0,-39.0,-36.0,-45.0,-52.0,-42.0,-37.0,-45.0,-50.0,-90.0,-92.0,-89.0,-93.0,51.0,56.0,44.0,41.0,0
4461,92:69:1D:31:68:E9,3827248,485757118,3640,3508637,3823608,482248481,0,3993,993217,3881,968132,112,25085,1929,6,3766,79,0,32,229410.0,130000.0,-50.0,-48.0,-43.0,-45.0,-50.0,-49.0,-43.0,-48.0,-90.0,-92.0,-89.0,-93.0,40.0,44.0,46.0,48.0,0
4462,CC:2F:71:3F:1F:24,4447384,1178451612,623776,696203131,3823608,482248481,37,514214,562432218,513594,562357582,620,74636,496533,10,624013,57496,34,447,130000.0,43333.0,-67.0,-65.0,-70.0,-67.0,-67.0,-65.0,-70.0,-67.0,-90.0,-92.0,-89.0,-93.0,23.0,27.0,19.0,26.0,0
4463,CC:2F:71:3E:C5:1F,3824357,482340114,749,91633,3823608,482248481,0,3140,263697,2592,198589,548,65108,793,8,1080,18,0,34,144444.0,39000.0,-70.0,-71.0,-68.0,-60.0,-71.0,-72.0,-68.0,-61.0,-90.0,-92.0,-89.0,-93.0,20.0,21.0,21.0,33.0,0
4464,BA:8C:B9:54:50:24,3828321,488397964,4713,6149483,3823608,482248481,0,8257,1642952,8236,1639595,21,3357,2319,14,5088,36,0,53,229410.0,130000.0,-39.0,-36.0,-45.0,-52.0,-42.0,-37.0,-45.0,-50.0,-90.0,-92.0,-89.0,-93.0,51.0,56.0,44.0,41.0,0
4465,92:69:1D:31:68:E9,3827254,485757724,3640,3508637,3823614,482249087,0,3993,993217,3881,968132,112,25085,1929,6,3766,79,0,32,229410.0,130000.0,-50.0,-48.0,-43.0,-45.0,-50.0,-49.0,-43.0,-48.0,-90.0,-92.0,-89.0,-92.0,40.0,44.0,46.0,47.0,0
4466,CC:2F:71:3F:1F:24,4447429,1178466268,623815,696217181,3823614,482249087,37,514239,562437022,513619,562362386,620,74636,496558,10,624052,57517,34,447,117000.0,39000.0,-67.0,-65.0,-70.0,-67.0,-67.0,-65.0,-70.0,-67.0,-90.0,-92.0,-89.0,-92.0,23.0,27.0,19.0,25.0,0
4467,CC:2F:71:3E:C5:1F,3824363,482340720,749,91633,3823614,482249087,0,3140,263697,2592,198589,548,65108,793,8,1080,18,0,34,144444.0,39000.0,-70.0,-71.0,-68.0,-60.0,-71.0,-72.0,-68.0,-61.0,-90.0,-92.0,-89.0,-92.0,20.0,21.0,21.0,32.0,0
4468,BA:8C:B9:54:50:24,3828327,488398570,4713,6149483,3823614,482249087,0,8257,1642952,8236,1639595,21,3357,2319,14,5088,36,0,53,229410.0,130000.0,-39.0,-36.0,-45.0,-52.0,-42.0,-37.0,-45.0,-50.0,-90.0,-92.0,-89.0,-92.0,51.0,56.0,44.0,40.0,0
4469,92:69:1D:31:68:E9,3827257,485757986,3640,3508637,3823617,482249349,0,3993,993217,3881,968132,112,25085,1929,6,3766,79,0,32,229410.0,130000.0,-50.0,-48.0,-43.0,-45.0,-50.0,-49.0,-43.0,-48.0,-90.0,-92.0,-89.0,-92.0,40.0,44.0,46.0,47.0,0
4470,CC:2F:71:3F:1F:24,4447474,1178480958,623857,696231609,3823617,482249349,37,514264,562441826,513644,562367190,620,74636,496583,10,624094,57521,34,447,130000.0,43333.0,-67.0,-65.0,-70.0,-67.0,-67.0,-65.0,-70.0,-67.0,-90.0,-92.0,-89.0,-92.0,23.0,27.0,19.0,25.0,0
4471,CC:2F:71:3E:C5:1F,3824366,482340982,749,91633,3823617,482249349,0,3140,263697,2592,198589,548,65108,793,8,1080,18,0,34,144444.0,39000.0,-70.0,-71.0,-68.0,-60.0,-71.0,-72.0,-68.0,-61.0,-90.0,-92.0,-89.0,-92.0,20.0,21.0,21.0,32.0,0
4472,BA:8C:B9:54:50:24,3828330,488398832,4713,6149483,3823617,482249349,0,8257,1642952,8236,1639595,21,3357,2319,14,5088,36,0,53,229410.0,130000.0,-39.0,-36.0,-45.0,-52.0,-42.0,-37.0,-45.0,-50.0,-90.0,-92.0,-89.0,-92.0,51.0,56.0,44.0,40.0,0
4473,92:69:1D:31:68:E9,3827261,485758390,3640,3508637,3823621,482249753,0,3993,993217,3881,968132,112,25085,1929,6,3766,79,0,32,229410.0,130000.0,-50.0,-48.0,-43.0,-45.0,-50.0,-49.0,-43.0,-48.0,-90.0,-92.0,-89.0,-92.0,40.0,44.0,46.0,47.0,0
4474,CC:2F:71:3F:1F:24,4447526,1178496755,623902,696246527,3823624,482250228,37,514290,562446770,513670,562372134,620,74636,496609,10,624139,57525,34,447,130000.0,43333.0,-67.0,-65.0,-71.0,-68.0,-67.0,-65.0,-70.0,-67.0,-90.0,-92.0,-89.0,-92.0,23.0,27.0,18.0,24.0,0
4475,CC:2F:71:3E:C5:1F,3824373,482341861,749,91633,3823624,482250228,0,3140,263697,2592,198589,548,65108,793,8,1080,18,0,34,144444.0,39000.0,-70.0,-71.0,-68.0,-60.0,-71.0,-72.0,-68.0,-61.0,-90.0,-92.0,-89.0,-92.0,20.0,21.0,21.0,32.0,0
4476,BA:8C:B9:54:50:24,3828337,488399711,4713,6149483,3823624,482250228,0,8257,1642952,8236,1639595,21,3357,2319,14,5088,36,0,53,229410.0,130000.0,-39.0,-36.0,-45.0,-52.0,-42.0,-37.0,-45.0,-50.0,-90.0,-92.0,-89.0,-92.0,51.0,56.0,44.0,40.0,0
4477,92:69:1D:31:68:E9,3827267,485759127,3640,3508637,3823627,482250490,0,3993,993217,3881,968132,112,25085,1929,6,3766,79,0,32,229410.0,130000.0,-50.0,-48.0,-43.0,-45.0,-50.0,-49.0,-43.0,-48.0,-90.0,-92.0,-89.0,-92.0,40.0,44.0,46.0,47.0,0
4478,CC:2F:71:3F:1F:24,4447572,1178511703,623945,696261213,3823627,482250490,37,514316,562451758,513696,562377122,620,74636,496635,10,624182,57547,34,449,117000.0,39000.0,-67.0,-65.0,-71.0,-68.0,-67.0,-65.0,-70.0,-68.0,-90.0,-92.0,-89.0,-92.0,23.0,27.0,18.0,24.0,0
4479,CC:2F:71:3E:C5:1F,3824378,482342325,749,91633,3823629,482250692,0,3140,263697,2592,198589,548,65108,793,8,1080,18,0,34,144444.0,39000.0,-70.0,-71.0,-68.0,-60.0,-71.0,-72.0,-68.0,-61.0,-90.0,-92.0,-89.0,-92.0,20.0,21.0,21.0,32.0,0
4480,BA:8C:B9:54:50:24,3828344,488400377,4713,6149483,3823631,482250894,0,8258,1643020,8237,1639663,21,3357,2319,14,5088,36,0,53,229410.0,130000.0,-39.0,-36.0,-44.0,-51.0,-42.0,-37.0,-45.0,-50.0,-90.0,-92.0,-89.0,-92.0,51.0,56.0,45.0,41.0,0
4481,92:69:1D:31:68:E9,3827271,485759531,3640,3508637,3823631,482250894,0,3993,993217,3881,968132,112,25085,1929,6,3766,79,0,32,229410.0,130000.0,-50.0,-48.0,-43.0,-45.0,-50.0,-49.0,-43.0,-48.0,-90.0,-92.0,-89.0,-92.0,40.0,44.0,46.0,47.0,0
4482,CC:2F:71:3F:1F:24,4447619,1178526613,623986,696275517,3823633,482251096,37,514342,562456702,513722,562382066,620,74636,496661,10,624223,57551,34,449,130000.0,43333.0,-67.0,-65.0,-70.0,-68.0,-67.0,-65.0,-70.0,-67.0,-90.0,-92.0,-89.0,-92.0,23.0,27.0,19.0,24.0,0
4483,CC:2F:71:3E:C5:1F,3824382,482342729,749,91633,3823633,482251096,0,3140,263697,2592,198589,548,65108,793,8,1080,18,0,34,144444.0,39000.0,-70.0,-71.0,-68.0,-60.0,-71.0,-72.0,-68.0,-61.0,-90.0,-92.0,-89.0,-92.0,20.0,21.0,21.0,32.0,0
4484,BA:8C:B9:54:50:24,3828346,488400579,4713,6149483,3823633,482251096,0,8258,1643020,8237,1639663,21,3357,2319,14,5088,36,0,53,229410.0,130000.0,-39.0,-36.0,-44.0,-51.0,-42.0,-37.0,-45.0,-50.0,-90.0,-92.0,-89.0,-92.0,51.0,56.0,45.0,41.0,0
4485,92:69:1D:31:68:E9,3827275,485759935,3640,3508637,3823635,482251298,0,3993,993217,3881,968132,112,25085,1929,6,3766,79,0,32,229410.0,130000.0,-50.0,-48.0,-43.0,-45.0,-50.0,-49.0,-43.0,-48.0,-90.0,-92.0,-89.0,-92.0,40.0,44.0,46.0,47.0,0
4486,CC:2F:71:3F:1F:24,4447663,1178541243,624028,696289945,3823635,482251298,37,514367,562461506,513747,562386870,620,74636,496686,10,624265,57568,34,449,117000.0,39000.0,-67.0,-65.0,-71.0,-68.0,-67.0,-65.0,-70.0,-67.0,-90.0,-92.0,-89.0,-92.0,23.0,27.0,18.0,24.0,0
4487,CC:2F:71:3E:C5:1F,3824386,482343133,749,91633,3823637,482251500,0,3140,263697,2592,198589,548,65108,793,8,1080,18,0,34,144444.0,39000.0,-70.0,-71.0,-68.0,-60.0,-71.0,-72.0,-68.0,-61.0,-90.0,-92.0,-89.0,-92.0,20.0,21.0,21.0,32.0,0
4488,BA:8C:B9:54:50:24,3828351,488401117,4713,6149483,3823638,482251634,0,8258,1643020,8237,1639663,21,3357,2319,14,5088,36,0,53,229410.0,130000.0,-39.0,-36.0,-44.0,-51.0,-42.0,-37.0,-45.0,-50.0,-90.0,-92.0,-89.0,-92.0,51.0,56.0,45.0,41.0,0
4489,92:69:1D:31:68:E9,3827280,485760399,3640,3508637,3823640,482251762,0,3993,993217,3881,968132,112,25085,1929,6,3766,79,0,32,229410.0,130000.0,-50.0,-48.0,-43.0,-45.0,-50.0,-49.0,-43.0,-48.0,-90.0,-92.0,-89.0,-92.0,40.0,44.0,46.0,47.0,0
4490,CC:2F:71:3F:1F:24,4447710,1178556089,624068,696304125,3823642,482251964,37,514394,562466566,513774,562391930,620,74636,496713,10,624305,57573,34,449,130000.0,43333.0,-67.0,-65.0,-71.0,-68.0,-67.0,-65.0,-70.0,-67.0,-90.0,-92.0,-89.0,-92.0,23.0,27.0,18.0,24.0,0
4491,CC:2F:71:3E:C5:1F,3824391,482343597,749,91633,3823642,482251964,0,3140,263697,2592,198589,548,65108,793,8,1080,18,0,34,144444.0,39000.0,-70.0,-71.0,-68.0,-60.0,-71.0,-72.0,-68.0,-61.0,-90.0,-92.0,-89.0,-92.0,20.0,21.0,21.0,32.0,0
4492,BA:8C:B9:54:50:24,3828355,488401447,4713,6149483,3823642,482251964,0,8258,1643020,8237,1639663,21,3357,2319,14,5088,36,0,53,229410.0,130000.0,-39.0,-36.0,-44.0,-51.0,-42.0,-37.0,-45.0,-50.0,-90.0,-92.0,-89.0,-92.0,51.0,56.0,45.0,41.0,0
4493,92:69:1D:31:68:E9,3827284,485760803,3640,3508637,3823644,482252166,0,3993,993217,3881,968132,112,25085,1929,6,3766,79,0,32,229410.0,130000.0,-50.0,-48.0,-43.0,-45.0,-50.0,-49.0,-43.0,-48.0,-90.0,-92.0,-89.0,-92.0,40.0,44.0,46.0,47.0,0
4494,CC:2F:71:3F:1F:24,4447755,1178570793,624111,696318627,3823644,482252166,37,514419,562471370,513799,562396734,620,74636,496738,10,624348,57584,34,449,130000.0,39000.0,-67.0,-65.0,-71.0,-68.0,-67.0,-65.0,-70.0,-67.0,-90.0,-92.0,-89.0,-92.0,23.0,27.0,18.0,24.0,0
4495,CC:2F:71:3E:C5:1F,3824395,482344001,749,91633,3823646,482252368,0,3140,263697,2592,198589,548,65108,793,8,1080,18,0,34,144444.0,39000.0,-70.0,-71.0,-68.0,-60.0,-71.0,-72.0,-68.0,-61.0,-90.0,-92.0,-89.0,-92.0,20.0,21.0,21.0,32.0,0
4496,BA:8C:B9:54:50:24,3828359,488401851,4713,6149483,3823646,482252368,0,8258,1643020,8237,1639663,21,3357,2319,14,5088,36,0,53,229410.0,130000.0,-39.0,-36.0,-44.0,-51.0,-42.0,-37.0,-45.0,-50.0,-90.0,-92.0,-89.0,-92.0,51.0,56.0,45.0,41.0,0
4497,92:69:1D:31:68:E9,3827288,485761207,3640,3508637,3823648,482252570,0,3993,993217,3881,968132,112,25085,1929,6,3766,79,0,32,229410.0,130000.0,-50.0,-48.0,-43.0,-45.0,-50.0,-49.0,-43.0,-48.0,-90.0,-93.0,-90.0,-93.0,40.0,45.0,47.0,48.0,0
4498,CC:2F:71:3F:1F:24,4447799,1178585377,624151,696332807,3823648,482252570,37,514445,562476314,513825,562401678,620,74636,496764,10,624388,57603,34,449,130000.0,39000.0,-67.0,-65.0,-70.0,-68.0,-67.0,-65.0,-70.0,-67.0,-90.0,-93.0,-90.0,-93.0,23.0,28.0,20.0,25.0,0
4499,CC:2F:71:3E:C5:1F,3824400,482344465,749,91633,3823651,482252832,0,3140,263697,2592,198589,548,65108,793,8,1080,18,0,34,144444.0,39000.0,-70.0,-71.0,-68.0,-60.0,-71.0,-72.0,-68.0,-61.0,-90.0,-93.0,-90.0,-93.0,20.0,22.0,22.0,33.0,0
4500,BA:8C:B9:54:50:24,3828364,488402315,4713,6149483,3823651,482252832,0,8258,1643020,8237,1639663,21,3357,2319,14,5088,36,0,53,229410.0,130000.0,-39.0,-36.0,-44.0,-51.0,-42.0,-37.0,-45.0,-50.0,-90.0,-93.0,-90.0,-93.0,51.0,57.0,46.0,42.0,0
4501,92:69:1D:31:68:E9,3827293,485761671,3640,3508637,3823653,482253034,0,3993,993217,3881,968132,112,25085,1929,6,3766,79,0,32,229410.0,130000.0,-50.0,-48.0,-43.0,-45.0,-50.0,-49.0,-43.0,-48.0,-90.0,-93.0,-90.0,-93.0,40.0,45.0,47.0,48.0,0
4502,CC:2F:71:3F:1F:24,4447846,1178600213,624193,696347179,3823653,482253034,37,514470,562481118,513850,562406482,620,74636,496789,10,624430,57626,34,449,130000.0,43333.0,-67.0,-65.0,-70.0,-67.0,-67.0,-65.0,-70.0,-67.0,-90.0,-93.0,-90.0,-93.0,23.0,28.0,20.0,26.0,0
4503,CC:2F:71:3E:C5:1F,3824404,482344869,749,91633,3823655,482253236,0,3140,263697,2592,198589,548,65108,793,8,1080,18,0,34,144444.0,39000.0,-70.0,-71.0,-68.0,-60.0,-71.0,-72.0,-68.0,-61.0,-90.0,-93.0,-90.0,-93.0,20.0,22.0,22.0,33.0,0
4504,BA:8C:B9:54:50:24,3828368,488402719,4713,6149483,3823655,482253236,0,8258,1643020,8237,1639663,21,3357,2319,14,5088,36,0,53,229410.0,130000.0,-39.0,-36.0,-44.0,-51.0,-42.0,-37.0,-45.0,-50.0,-90.0,-93.0,-90.0,-93.0,51.0,57.0,46.0,42.0,0
4505,92:69:1D:31:68:E9,3827297,485762075,3640,3508637,3823657,482253438,0,3993,993217,3881,968132,112,25085,1929,6,3766,79,0,32,229410.0,130000.0,-50.0,-48.0,-43.0,-45.0,-50.0,-49.0,-43.0,-48.0,-90.0,-93.0,-90.0,-93.0,40.0,45.0,47.0,48.0,0
4506,CC:2F:71:3F:1F:24,4447891,1178615027,624234,696361589,3823657,482253438,37,514496,562486062,513876,562411426,620,74636,496815,10,624471,57632,34,449,130000.0,43333.0,-67.0,-65.0,-70.0,-67.0,-67.0,-65.0,-70.0,-67.0,-90.0,-93.0,-90.0,-93.0,23.0,28.0,20.0,26.0,0
4507,CC:2F:71:3E:C5:1F,3824408,482345273,749,91633,3823659,482253640,0,3140,263697,2592,198589,548,65108,793,8,1080,18,0,34,144444.0,39000.0,-70.0,-71.0,-68.0,-60.0,-71.0,-72.0,-68.0,-61.0,-90.0,-93.0,-90.0,-93.0,20.0,22.0,22.0,33.0,0
4508,BA:8C:B9:54:50:24,3828372,488403123,4713,6149483,3823659,482253640,0,8258,1643020,8237,1639663,21,3357,2319,14,5088,36,0,53,229410.0,130000.0,-39.0,-36.0,-44.0,-51.0,-42.0,-37.0,-45.0,-50.0,-90.0,-93.0,-90.0,-93.0,51.0,57.0,46.0,42.0,0
4509,92:69:1D:31:68:E9,3827302,485762539,3640,3508637,3823662,482253902,0,3993,993217,3881,968132,112,25085,1929,6,3766,79,0,32,229410.0,130000.0,-50.0,-48.0,-43.0,-45.0,-50.0,-49.0,-43.0,-48.0,-90.0,-93.0,-90.0,-93.0,40.0,45.0,47.0,48.0,0
4510,CC:2F:71:3F:1F:24,4447940,1178630121,624276,696376017,3823664,482254104,37,514521,562490866,513901,562416230,620,74636,496840,10,624513,57656,34,449,117000.0,39000.0,-67.0,-65.0,-71.0,-67.0,-67.0,-65.0,-70.0,-67.0,-90.0,-93.0,-90.0,-93.0,23.0,28.0,19.0,26.0,0
4511,CC:2F:71:3E:C5:1F,3824413,482345737,749,91633,3823664,482254104,0,3140,263697,2592,198589,548,65108,793,8,1080,18,0,34,144444.0,39000.0,-70.0,-71.0,-68.0,-60.0,-71.0,-72.0,-68.0,-61.0,-90.0,-93.0,-90.0,-93.0,20.0,22.0,22.0,33.0,0
4512,BA:8C:B9:54:50:24,3828377,488403587,4713,6149483,3823664,482254104,0,8258,1643020,8237,1639663,21,3357,2319,14,5088,36,0,53,229410.0,130000.0,-39.0,-36.0,-44.0,-51.0,-42.0,-37.0,-45.0,-50.0,-90.0,-93.0,-90.0,-93.0,51.0,57.0,46.0,42.0,0
4513,92:69:1D:31:68:E9,3827306,485762943,3640,3508637,3823666,482254306,0,3993,993217,3881,968132,112,25085,1929,6,3766,79,0,32,229410.0,130000.0,-50.0,-48.0,-43.0,-45.0,-50.0,-49.0,-43.0,-48.0,-90.0,-93.0,-89.0,-93.0,40.0,45.0,46.0,48.0,0
4514,CC:2F:71:3F:1F:24,4447987,1178645083,624319,696390575,3823668,482254508,37,514546,562495670,513926,562421034,620,74636,496865,10,624556,57659,34,449,130000.0,43333.0,-67.0,-65.0,-70.0,-67.0,-67.0,-65.0,-70.0,-67.0,-90.0,-93.0,-89.0,-93.0,23.0,28.0,19.0,26.0,0
4515,CC:2F:71:3E:C5:1F,3824417,482346141,749,91633,3823668,482254508,0,3140,263697,2592,198589,548,65108,793,8,1080,18,0,34,144444.0,39000.0,-70.0,-71.0,-68.0,-60.0,-71.0,-72.0,-68.0,-61.0,-90.0,-93.0,-89.0,-93.0,20.0,22.0,21.0,33.0,0
4516,BA:8C:B9:54:50:24,3828381,488403991,4713,6149483,3823668,482254508,0,8258,1643020,8237,1639663,21,3357,2319,14,5088,36,0,53,229410.0,130000.0,-39.0,-36.0,-44.0,-51.0,-42.0,-37.0,-45.0,-50.0,-90.0,-93.0,-89.0,-93.0,51.0,57.0,45.0,42.0,0
4517,92:69:1D:31:68:E9,3827308,485763145,3640,3508637,3823668,482254508,0,3993,993217,3881,968132,112,25085,1929,6,3766,79,0,32,229410.0,130000.0,-50.0,-48.0,-43.0,-45.0,-50.0,-49.0,-43.0,-48.0,-90.0,-93.0,-90.0,-93.0,40.0,45.0,47.0,48.0,0
4518,CC:2F:71:3F:1F:24,4448032,1178659837,624362,696405127,3823670,482254710,37,514571,562500474,513951,562425838,620,74636,496890,10,624599,57684,34,449,117000.0,39000.0,-67.0,-65.0,-70.0,-68.0,-67.0,-65.0,-70.0,-67.0,-90.0,-93.0,-90.0,-93.0,23.0,28.0,20.0,25.0,0
4519,CC:2F:71:3E:C5:1F,3824421,482346545,749,91633,3823672,482254912,0,3140,263697,2592,198589,548,65108,793,8,1080,18,0,34,144444.0,39000.0,-70.0,-71.0,-68.0,-60.0,-71.0,-72.0,-68.0,-61.0,-90.0,-93.0,-90.0,-93.0,20.0,22.0,22.0,33.0,0
4520,BA:8C:B9:54:50:24,3828385,488404395,4713,6149483,3823672,482254912,0,8258,1643020,8237,1639663,21,3357,2319,14,5088,36,0,53,229410.0,130000.0,-39.0,-36.0,-44.0,-51.0,-42.0,-37.0,-45.0,-50.0,-90.0,-93.0,-90.0,-93.0,51.0,57.0,46.0,42.0,0
4521,92:69:1D:31:68:E9,3827315,485763811,3640,3508637,3823675,482255174,0,3993,993217,3881,968132,112,25085,1929,6,3766,79,0,32,229410.0,130000.0,-50.0,-48.0,-43.0,-45.0,-50.0,-49.0,-43.0,-48.0,-90.0,-93.0,-90.0,-93.0,40.0,45.0,47.0,48.0,0
4522,CC:2F:71:3F:1F:24,4448081,1178674931,624404,696419555,3823677,482255376,37,514600,562505766,513980,562431130,620,74636,496919,10,624640,57691,34,449,130000.0,43333.0,-67.0,-65.0,-70.0,-67.0,-67.0,-65.0,-70.0,-67.0,-90.0,-93.0,-90.0,-93.0,23.0,28.0,20.0,26.0,0
4523,CC:2F:71:3E:C5:1F,3824426,482347009,749,91633,3823677,482255376,0,3140,263697,2592,198589,548,65108,793,8,1080,18,0,34,144444.0,39000.0,-70.0,-71.0,-68.0,-60.0,-71.0,-72.0,-68.0,-61.0,-90.0,-93.0,-90.0,-93.0,20.0,22.0,22.0,33.0,0
4524,BA:8C:B9:54:50:24,3828391,488404975,4714,6149599,3823677,482255376,0,8264,1643428,8243,1640071,21,3357,2319,14,5089,36,0,53,229410.0,137640.0,-41.0,-35.0,-43.0,-45.0,-40.0,-35.0,-43.0,-47.0,-90.0,-93.0,-90.0,-93.0,49.0,58.0,47.0,48.0,0
4525,92:69:1D:31:68:E9,3827318,485764129,3641,3508753,3823677,482255376,0,3995,993353,3883,968268,112,25085,1929,6,3767,79,0,32,229410.0,130000.0,-50.0,-46.0,-42.0,-48.0,-50.0,-48.0,-43.0,-47.0,-90.0,-93.0,-90.0,-93.0,40.0,47.0,48.0,45.0,0
4526,CC:2F:71:3F:1F:24,4448128,1178689997,624447,696434217,3823681,482255780,37,514627,562510850,514007,562436214,620,74636,496946,10,624684,57702,34,449,130000.0,43333.0,-67.0,-65.0,-70.0,-68.0,-67.0,-65.0,-70.0,-67.0,-90.0,-93.0,-90.0,-93.0,23.0,28.0,20.0,25.0,0
4527,CC:2F:71:3E:C5:1F,3824432,482347746,750,91693,3823682,482256053,0,3142,263837,2594,198729,548,65108,793,8,1081,18,0,34,144444.0,39000.0,-70.0,-71.0,-67.0,-60.0,-70.0,-71.0,-67.0,-60.0,-90.0,-93.0,-90.0,-93.0,20.0,22.0,23.0,33.0,0
4528,BA:8C:B9:54:50:24,3828396,488405652,4714,6149599,3823682,482256053,0,8266,1643564,8245,1640207,21,3357,2319,14,5089,36,0,53,229410.0,137640.0,-49.0,-35.0,-42.0,-44.0,-41.0,-35.0,-42.0,-45.0,-90.0,-93.0,-90.0,-93.0,41.0,58.0,48.0,49.0,0
4529,92:69:1D:31:68:E9,3827325,485765008,3641,3508753,3823684,482256255,0,3995,993353,3883,968268,112,25085,1929,6,3767,79,0,32,229410.0,130000.0,-50.0,-46.0,-42.0,-48.0,-50.0,-48.0,-43.0,-47.0,-90.0,-93.0,-90.0,-93.0,40.0,47.0,48.0,45.0,0
4530,CC:2F:71:3F:1F:24,4448177,1178705286,624490,696448769,3823687,482256517,37,514653,562515794,514033,562441158,620,74636,496972,10,624727,57722,34,449,117000.0,39000.0,-67.0,-65.0,-70.0,-67.0,-67.0,-65.0,-70.0,-67.0,-90.0,-93.0,-90.0,-93.0,23.0,28.0,20.0,26.0,0
4531,CC:2F:71:3E:C5:1F,3824437,482348210,750,91693,3823687,482256517,0,3142,263837,2594,198729,548,65108,793,8,1081,18,0,34,144444.0,39000.0,-70.0,-71.0,-67.0,-60.0,-70.0,-71.0,-67.0,-60.0,-90.0,-93.0,-90.0,-93.0,20.0,22.0,23.0,33.0,0
4532,BA:8C:B9:54:50:24,3828401,488406116,4714,6149599,3823687,482256517,0,8266,1643564,8245,1640207,21,3357,2319,14,5089,36,0,53,229410.0,137640.0,-49.0,-35.0,-42.0,-44.0,-41.0,-35.0,-42.0,-45.0,-90.0,-93.0,-90.0,-93.0,41.0,58.0,48.0,49.0,0
4533,92:69:1D:31:68:E9,3827330,485765472,3641,3508753,3823689,482256719,0,3995,993353,3883,968268,112,25085,1929,6,3767,79,0,32,229410.0,130000.0,-50.0,-46.0,-42.0,-48.0,-50.0,-48.0,-43.0,-47.0,-90.0,-93.0,-90.0,-93.0,40.0,47.0,48.0,45.0,0
4534,CC:2F:71:3F:1F:24,4448219,1178719724,624530,696463005,3823689,482256719,37,514681,562520946,514061,562446310,620,74636,497000,10,624767,57723,34,449,130000.0,43333.0,-67.0,-66.0,-71.0,-68.0,-67.0,-65.0,-70.0,-67.0,-90.0,-93.0,-90.0,-93.0,23.0,27.0,19.0,25.0,0
4535,CC:2F:71:3E:C5:1F,3824441,482348614,750,91693,3823691,482256921,0,3142,263837,2594,198729,548,65108,793,8,1081,18,0,34,144444.0,39000.0,-70.0,-71.0,-67.0,-60.0,-70.0,-71.0,-67.0,-60.0,-90.0,-93.0,-90.0,-93.0,20.0,22.0,23.0,33.0,0
4536,BA:8C:B9:54:50:24,3828405,488406520,4714,6149599,3823691,482256921,0,8266,1643564,8245,1640207,21,3357,2319,14,5089,36,0,53,229410.0,137640.0,-49.0,-35.0,-42.0,-44.0,-41.0,-35.0,-42.0,-45.0,-90.0,-93.0,-90.0,-93.0,41.0,58.0,48.0,49.0,0
4537,92:69:1D:31:68:E9,3827334,485765876,3641,3508753,3823693,482257123,0,3995,993353,3883,968268,112,25085,1929,6,3767,79,0,32,229410.0,130000.0,-50.0,-46.0,-42.0,-48.0,-50.0,-48.0,-43.0,-47.0,-90.0,-93.0,-90.0,-93.0,40.0,47.0,48.0,45.0,0
4538,CC:2F:71:3F:1F:24,4448268,1178734944,624573,696477619,3823695,482257325,37,514706,562525750,514086,562451114,620,74636,497025,10,624810,57730,34,449,130000.0,43333.0,-74.0,-72.0,-77.0,-74.0,-70.0,-69.0,-74.0,-71.0,-90.0,-93.0,-90.0,-93.0,16.0,21.0,13.0,19.0,0
4539,CC:2F:71:3E:C5:1F,3824446,482349096,750,91693,3823696,482257403,0,3142,263837,2594,198729,548,65108,793,8,1081,18,0,34,144444.0,39000.0,-70.0,-71.0,-67.0,-60.0,-70.0,-71.0,-67.0,-60.0,-90.0,-93.0,-90.0,-93.0,20.0,22.0,23.0,33.0,0
4540,BA:8C:B9:54:50:24,3828410,488407002,4714,6149599,3823696,482257403,0,8269,1643838,8247,1640343,22,3495,2320,14,5089,36,0,53,229410.0,137640.0,-39.0,-36.0,-44.0,-51.0,-42.0,-35.0,-43.0,-46.0,-90.0,-93.0,-90.0,-93.0,51.0,57.0,46.0,42.0,0
4541,92:69:1D:31:68:E9,3827340,485766418,3641,3508753,3823699,482257665,0,3995,993353,3883,968268,112,25085,1929,6,3767,79,0,32,229410.0,130000.0,-50.0,-46.0,-42.0,-48.0,-50.0,-48.0,-43.0,-47.0,-90.0,-93.0,-90.0,-93.0,40.0,47.0,48.0,45.0,0
4542,CC:2F:71:3F:1F:24,4448313,1178749582,624614,696491917,3823699,482257665,37,514733,562530846,514113,562456210,620,74636,497052,10,624851,57766,34,449,144444.0,39000.0,-67.0,-65.0,-71.0,-68.0,-68.0,-66.0,-72.0,-69.0,-90.0,-93.0,-90.0,-93.0,23.0,28.0,19.0,25.0,0
4543,CC:2F:71:3E:C5:1F,3824449,482349358,750,91693,3823699,482257665,0,3142,263837,2594,198729,548,65108,793,8,1081,18,0,34,144444.0,39000.0,-70.0,-71.0,-67.0,-60.0,-70.0,-71.0,-67.0,-60.0,-90.0,-93.0,-90.0,-93.0,20.0,22.0,23.0,33.0,0
4544,BA:8C:B9:54:50:24,3828413,488407264,4714,6149599,3823699,482257665,0,8269,1643838,8247,1640343,22,3495,2320,14,5089,36,0,53,229410.0,137640.0,-39.0,-36.0,-44.0,-51.0,-42.0,-35.0,-43.0,-46.0,-90.0,-93.0,-90.0,-93.0,51.0,57.0,46.0,42.0,0
4545,92:69:1D:31:68:E9,3827344,485766822,3641,3508753,3823703,482258069,0,3995,993353,3883,968268,112,25085,1929,6,3767,79,0,32,229410.0,130000.0,-50.0,-46.0,-42.0,-48.0,-50.0,-48.0,-43.0,-47.0,-90.0,-93.0,-90.0,-93.0,40.0,47.0,48.0,45.0,0
4546,CC:2F:71:3F:1F:24,4448361,1178764616,624656,696506345,3823705,482258271,37,514760,562535930,514140,562461294,620,74636,497079,10,624893,57777,34,449,130000.0,43333.0,-68.0,-66.0,-71.0,-68.0,-68.0,-66.0,-71.0,-68.0,-90.0,-93.0,-90.0,-93.0,22.0,27.0,19.0,25.0,0
4547,CC:2F:71:3E:C5:1F,3824455,482349964,750,91693,3823705,482258271,0,3142,263837,2594,198729,548,65108,793,8,1081,18,0,34,144444.0,39000.0,-70.0,-71.0,-67.0,-60.0,-70.0,-71.0,-67.0,-60.0,-90.0,-93.0,-90.0,-93.0,20.0,22.0,23.0,33.0,0
4548,BA:8C:B9:54:50:24,3828419,488407870,4714,6149599,3823705,482258271,0,8269,1643838,8247,1640343,22,3495,2320,14,5089,36,0,53,229410.0,137640.0,-39.0,-36.0,-44.0,-51.0,-42.0,-35.0,-43.0,-46.0,-90.0,-93.0,-90.0,-93.0,51.0,57.0,46.0,42.0,0
4549,92:69:1D:31:68:E9,3827349,485767288,3641,3508753,3823708,482258535,0,3995,993353,3883,968268,112,25085,1929,6,3767,79,0,32,229410.0,130000.0,-50.0,-46.0,-42.0,-48.0,-50.0,-48.0,-43.0,-47.0,-90.0,-93.0,-90.0,-93.0,40.0,47.0,48.0,45.0,0
4550,CC:2F:71:3F:1F:24,4448407,1178779494,624699,696520959,3823708,482258535,37,514786,562540852,514165,562466098,621,74754,497105,10,624936,57798,34,449,130000.0,39000.0,-71.0,-69.0,-74.0,-71.0,-70.0,-69.0,-74.0,-71.0,-90.0,-93.0,-90.0,-93.0,19.0,24.0,16.0,22.0,0
4551,CC:2F:71:3E:C5:1F,3824458,482350228,750,91693,3823708,482258535,0,3142,263837,2594,198729,548,65108,793,8,1081,18,0,34,144444.0,39000.0,-70.0,-71.0,-67.0,-60.0,-70.0,-71.0,-67.0,-60.0,-90.0,-93.0,-90.0,-93.0,20.0,22.0,23.0,33.0,0
4552,BA:8C:B9:54:50:24,3828422,488408134,4714,6149599,3823708,482258535,0,8269,1643838,8247,1640343,22,3495,2320,14,5089,36,0,53,229410.0,137640.0,-39.0,-36.0,-44.0,-51.0,-42.0,-35.0,-43.0,-46.0,-90.0,-93.0,-90.0,-93.0,51.0,57.0,46.0,42.0,0
4553,92:69:1D:31:68:E9,3827354,485767752,3641,3508753,3823713,482258999,0,3995,993353,3883,968268,112,25085,1929,6,3767,79,0,32,229410.0,130000.0,-50.0,-46.0,-42.0,-48.0,-50.0,-48.0,-43.0,-47.0,-90.0,-93.0,-90.0,-93.0,40.0,47.0,48.0,45.0,0
4554,CC:2F:71:3F:1F:24,4448455,1178794408,624740,696535207,3823715,482259201,37,514812,562545796,514191,562471042,621,74754,497131,10,624977,57829,34,449,130000.0,43333.0,-71.0,-69.0,-74.0,-71.0,-70.0,-69.0,-74.0,-71.0,-90.0,-93.0,-90.0,-93.0,19.0,24.0,16.0,22.0,0
4555,CC:2F:71:3E:C5:1F,3824465,482350894,750,91693,3823715,482259201,0,3142,263837,2594,198729,548,65108,793,8,1081,18,0,34,144444.0,39000.0,-70.0,-71.0,-67.0,-60.0,-70.0,-71.0,-67.0,-60.0,-90.0,-93.0,-90.0,-93.0,20.0,22.0,23.0,33.0,0
4556,BA:8C:B9:54:50:24,3828429,488408800,4714,6149599,3823715,482259201,0,8269,1643838,8247,1640343,22,3495,2320,14,5089,36,0,53,229410.0,137640.0,-39.0,-36.0,-44.0,-51.0,-42.0,-35.0,-43.0,-46.0,-90.0,-93.0,-90.0,-93.0,51.0,57.0,46.0,42.0,0
4557,92:69:1D:31:68:E9,3827358,485768156,3641,3508753,3823717,482259403,0,3995,993353,3883,968268,112,25085,1929,6,3767,79,0,32,229410.0,130000.0,-50.0,-46.0,-42.0,-48.0,-50.0,-48.0,-43.0,-47.0,-90.0,-93.0,-90.0,-93.0,40.0,47.0,48.0,45.0,0
4558,CC:2F:71:3F:1F:24,4448500,1178809274,624783,696549871,3823717,482259403,37,514838,562550716,514217,562475962,621,74754,497157,10,625020,57833,34,449,130000.0,43333.0,-68.0,-66.0,-71.0,-68.0,-70.0,-68.0,-73.0,-70.0,-90.0,-93.0,-90.0,-93.0,22.0,27.0,19.0,25.0,0
4559,CC:2F:71:3E:C5:1F,3824467,482351096,750,91693,3823717,482259403,0,3142,263837,2594,198729,548,65108,793,8,1081,18,0,34,144444.0,39000.0,-70.0,-71.0,-67.0,-60.0,-70.0,-71.0,-67.0,-60.0,-90.0,-93.0,-90.0,-93.0,20.0,22.0,23.0,33.0,0
4560,BA:8C:B9:54:50:24,3828431,488409002,4714,6149599,3823717,482259403,0,8269,1643838,8247,1640343,22,3495,2320,14,5089,36,0,53,229410.0,137640.0,-39.0,-36.0,-44.0,-51.0,-42.0,-35.0,-43.0,-46.0,-90.0,-93.0,-90.0,-93.0,51.0,57.0,46.0,42.0,0
4561,92:69:1D:31:68:E9,3827363,485768620,3641,3508753,3823722,482259867,0,3996,993421,3884,968336,112,25085,1929,6,3767,79,0,32,229410.0,130000.0,-52.0,-50.0,-44.0,-46.0,-50.0,-48.0,-43.0,-47.0,-90.0,-93.0,-90.0,-93.0,38.0,43.0,46.0,47.0,0
4562,CC:2F:71:3F:1F:24,4448548,1178824346,624826,696564479,3823722,482259867,37,514864,562555660,514243,562480906,621,74754,497183,10,625063,57852,34,449,117000.0,39000.0,-71.0,-69.0,-74.0,-71.0,-70.0,-68.0,-73.0,-70.0,-90.0,-93.0,-90.0,-93.0,19.0,24.0,16.0,22.0,0
4563,CC:2F:71:3E:C5:1F,3824474,482351762,750,91693,3823724,482260069,0,3142,263837,2594,198729,548,65108,793,8,1081,18,0,34,144444.0,39000.0,-70.0,-71.0,-67.0,-60.0,-70.0,-71.0,-67.0,-60.0,-90.0,-93.0,-90.0,-93.0,20.0,22.0,23.0,33.0,0
4564,BA:8C:B9:54:50:24,3828438,488409668,4714,6149599,3823724,482260069,0,8269,1643838,8247,1640343,22,3495,2320,14,5089,36,0,53,229410.0,137640.0,-39.0,-36.0,-44.0,-51.0,-42.0,-35.0,-43.0,-46.0,-90.0,-93.0,-90.0,-93.0,51.0,57.0,46.0,42.0,0
4565,92:69:1D:31:68:E9,3827368,485769086,3641,3508753,3823727,482260333,0,3996,993421,3884,968336,112,25085,1929,6,3767,79,0,32,229410.0,130000.0,-52.0,-50.0,-44.0,-46.0,-50.0,-48.0,-43.0,-47.0,-90.0,-93.0,-90.0,-93.0,38.0,43.0,46.0,47.0,0
4566,CC:2F:71:3F:1F:24,4448594,1178839060,624867,696578727,3823727,482260333,37,514892,562560836,514271,562486082,621,74754,497211,10,625104,57855,34,449,130000.0,43333.0,-70.0,-68.0,-73.0,-70.0,-70.0,-68.0,-73.0,-70.0,-90.0,-93.0,-90.0,-93.0,20.0,25.0,17.0,23.0,0
4567,CC:2F:71:3E:C5:1F,3824477,482352026,750,91693,3823727,482260333,0,3144,264025,2595,198799,549,65226,794,8,1081,18,0,34,144444.0,39000.0,-70.0,-71.0,-67.0,-60.0,-70.0,-71.0,-67.0,-60.0,-90.0,-93.0,-90.0,-93.0,20.0,22.0,23.0,33.0,0
4568,BA:8C:B9:54:50:24,3828441,488409932,4714,6149599,3823727,482260333,0,8269,1643838,8247,1640343,22,3495,2320,14,5089,36,0,53,229410.0,137640.0,-39.0,-36.0,-44.0,-51.0,-42.0,-35.0,-43.0,-46.0,-90.0,-93.0,-90.0,-93.0,51.0,57.0,46.0,42.0,0
4569,92:69:1D:31:68:E9,3827372,485769490,3641,3508753,3823731,482260737,0,3996,993421,3884,968336,112,25085,1929,6,3767,79,0,32,229410.0,130000.0,-52.0,-50.0,-44.0,-46.0,-50.0,-48.0,-43.0,-47.0,-90.0,-93.0,-90.0,-93.0,38.0,43.0,46.0,47.0,0
4570,CC:2F:71:3F:1F:24,4448642,1178854208,624911,696593471,3823731,482260737,37,514917,562565640,514296,562490886,621,74754,497236,10,625148,57859,34,449,130000.0,39000.0,-67.0,-65.0,-70.0,-67.0,-67.0,-65.0,-70.0,-67.0,-90.0,-93.0,-90.0,-93.0,23.0,28.0,20.0,26.0,0
4571,CC:2F:71:3E:C5:1F,3824483,482352632,750,91693,3823733,482260939,0,3144,264025,2595,198799,549,65226,794,8,1081,18,0,34,144444.0,39000.0,-70.0,-71.0,-67.0,-60.0,-70.0,-71.0,-67.0,-60.0,-90.0,-93.0,-90.0,-93.0,20.0,22.0,23.0,33.0,0
4572,BA:8C:B9:54:50:24,3828447,488410538,4714,6149599,3823733,482260939,0,8269,1643838,8247,1640343,22,3495,2320,14,5089,36,0,53,229410.0,137640.0,-39.0,-36.0,-44.0,-51.0,-42.0,-35.0,-43.0,-46.0,-90.0,-93.0,-90.0,-93.0,51.0,57.0,46.0,42.0,0
4573,92:69:1D:31:68:E9,3827377,485769954,3641,3508753,3823736,482261201,0,3996,993421,3884,968336,112,25085,1929,6,3767,79,0,32,229410.0,130000.0,-52.0,-50.0,-44.0,-46.0,-50.0,-48.0,-43.0,-47.0,-90.0,-93.0,-90.0,-93.0,38.0,43.0,46.0,47.0,0
4574,CC:2F:71:3F:1F:24,4448702,1178874829,624954,696608029,3823748,482266800,37,514944,562570676,514323,562495922,621,74754,497263,10,625191,57870,34,449,130000.0,43333.0,-67.0,-65.0,-70.0,-67.0,-67.0,-65.0,-70.0,-67.0,-90.0,-93.0,-90.0,-93.0,23.0,28.0,20.0,26.0,0
4575,CC:2F:71:3E:C5:1F,3824498,482358493,750,91693,3823748,482266800,0,3144,264025,2595,198799,549,65226,794,8,1081,18,0,34,144444.0,39000.0,-70.0,-71.0,-67.0,-60.0,-70.0,-71.0,-67.0,-60.0,-90.0,-93.0,-90.0,-93.0,20.0,22.0,23.0,33.0,0
4576,BA:8C:B9:54:50:24,3828464,488416601,4714,6149599,3823750,482267002,0,8269,1643838,8247,1640343,22,3495,2320,14,5089,36,0,53,229410.0,137640.0,-39.0,-36.0,-44.0,-51.0,-42.0,-35.0,-43.0,-46.0,-90.0,-93.0,-90.0,-93.0,51.0,57.0,46.0,42.0,0
4577,92:69:1D:31:68:E9,3827404,485781381,3641,3508753,3823763,482272628,0,3999,993792,3886,968472,113,25320,1930,6,3767,79,0,33,229410.0,130000.0,-52.0,-50.0,-44.0,-46.0,-50.0,-48.0,-43.0,-47.0,-90.0,-93.0,-90.0,-93.0,38.0,43.0,46.0,47.0,0
4578,CC:2F:71:3F:1F:24,4448761,1178895175,624996,696622345,3823765,482272830,37,514970,562575620,514349,562500866,621,74754,497289,10,625233,57880,34,449,130000.0,39000.0,-67.0,-65.0,-70.0,-67.0,-67.0,-65.0,-70.0,-67.0,-90.0,-93.0,-90.0,-93.0,23.0,28.0,20.0,26.0,0
4579,CC:2F:71:3E:C5:1F,3824515,482364523,750,91693,3823765,482272830,0,3144,264025,2595,198799,549,65226,794,8,1081,18,0,34,144444.0,39000.0,-70.0,-71.0,-67.0,-60.0,-70.0,-71.0,-67.0,-60.0,-90.0,-93.0,-90.0,-93.0,20.0,22.0,23.0,33.0,0
4580,BA:8C:B9:54:50:24,3828480,488422702,4714,6149599,3823766,482273103,0,8269,1643838,8247,1640343,22,3495,2320,14,5089,36,0,53,229410.0,137640.0,-39.0,-36.0,-44.0,-51.0,-42.0,-35.0,-43.0,-46.0,-90.0,-93.0,-90.0,-93.0,51.0,57.0,46.0,42.0,0
4581,92:69:1D:31:68:E9,3827409,485782058,3641,3508753,3823768,482273305,0,3999,993792,3886,968472,113,25320,1930,6,3767,79,0,33,229410.0,130000.0,-52.0,-50.0,-44.0,-46.0,-50.0,-48.0,-43.0,-47.0,-90.0,-93.0,-90.0,-93.0,38.0,43.0,46.0,47.0,0
4582,CC:2F:71:3F:1F:24,4448805,1178909898,625037,696636593,3823768,482273305,37,514996,562580564,514375,562505810,621,74754,497315,10,625274,57895,34,449,117000.0,39000.0,-67.0,-65.0,-70.0,-67.0,-67.0,-65.0,-70.0,-67.0,-90.0,-93.0,-90.0,-93.0,23.0,28.0,20.0,26.0,0
4583,CC:2F:71:3E:C5:1F,3824519,482365058,750,91693,3823769,482273365,0,3144,264025,2595,198799,549,65226,794,8,1081,18,0,34,144444.0,39000.0,-70.0,-71.0,-67.0,-60.0,-70.0,-71.0,-67.0,-60.0,-90.0,-93.0,-90.0,-93.0,20.0,22.0,23.0,33.0,0
4584,BA:8C:B9:54:50:24,3828485,488423166,4714,6149599,3823771,482273567,0,8269,1643838,8247,1640343,22,3495,2320,14,5089,36,0,53,229410.0,137640.0,-39.0,-36.0,-44.0,-51.0,-42.0,-35.0,-43.0,-46.0,-90.0,-93.0,-90.0,-93.0,51.0,57.0,46.0,42.0,0
4585,92:69:1D:31:68:E9,3827414,485782522,3641,3508753,3823773,482273769,0,3999,993792,3886,968472,113,25320,1930,6,3767,79,0,33,229410.0,130000.0,-52.0,-50.0,-44.0,-46.0,-50.0,-48.0,-43.0,-47.0,-90.0,-93.0,-90.0,-93.0,38.0,43.0,46.0,47.0,0
4586,CC:2F:71:3F:1F:24,4448853,1178924868,625078,696650897,3823775,482273971,37,515021,562585368,514400,562510614,621,74754,497340,10,625315,57903,34,449,130000.0,43333.0,-67.0,-65.0,-70.0,-67.0,-67.0,-65.0,-70.0,-67.0,-90.0,-93.0,-90.0,-93.0,23.0,28.0,20.0,26.0,0
4587,CC:2F:71:3E:C5:1F,3824525,482365664,750,91693,3823775,482273971,0,3144,264025,2595,198799,549,65226,794,8,1081,18,0,34,144444.0,39000.0,-70.0,-71.0,-67.0,-60.0,-70.0,-71.0,-67.0,-60.0,-90.0,-93.0,-90.0,-93.0,20.0,22.0,23.0,33.0,0
4588,BA:8C:B9:54:50:24,3828489,488423570,4714,6149599,3823775,482273971,0,8269,1643838,8247,1640343,22,3495,2320,14,5089,36,0,53,229410.0,137640.0,-39.0,-36.0,-44.0,-51.0,-42.0,-35.0,-43.0,-46.0,-90.0,-93.0,-90.0,-93.0,51.0,57.0,46.0,42.0,0
4589,92:69:1D:31:68:E9,3827418,485782926,3641,3508753,3823777,482274173,0,3999,993792,3886,968472,113,25320,1930,6,3767,79,0,33,229410.0,130000.0,-52.0,-50.0,-44.0,-46.0,-50.0,-48.0,-43.0,-47.0,-90.0,-93.0,-90.0,-93.0,38.0,43.0,46.0,47.0,0
4590,CC:2F:71:3F:1F:24,4448897,1178939442,625120,696665269,3823777,482274173,37,515048,562590428,514427,562515674,621,74754,497367,10,625357,57926,34,449,130000.0,39000.0,-67.0,-65.0,-71.0,-68.0,-67.0,-65.0,-70.0,-67.0,-90.0,-93.0,-90.0,-93.0,23.0,28.0,19.0,25.0,0
4591,CC:2F:71:3E:C5:1F,3824527,482365866,750,91693,3823777,482274173,0,3144,264025,2595,198799,549,65226,794,8,1081,18,0,34,144444.0,39000.0,-70.0,-71.0,-67.0,-60.0,-70.0,-71.0,-67.0,-60.0,-90.0,-93.0,-90.0,-93.0,20.0,22.0,23.0,33.0,0
4592,BA:8C:B9:54:50:24,3828493,488423974,4714,6149599,3823779,482274375,0,8269,1643838,8247,1640343,22,3495,2320,14,5089,36,0,53,229410.0,137640.0,-39.0,-36.0,-44.0,-51.0,-42.0,-35.0,-43.0,-46.0,-90.0,-93.0,-90.0,-93.0,51.0,57.0,46.0,42.0,0
4593,92:69:1D:31:68:E9,3827425,485783758,3641,3508753,3823784,482275005,0,3999,993792,3886,968472,113,25320,1930,6,3767,79,0,33,229410.0,130000.0,-52.0,-50.0,-44.0,-46.0,-50.0,-48.0,-43.0,-47.0,-90.0,-93.0,-90.0,-93.0,38.0,43.0,46.0,47.0,0
4594,CC:2F:71:3F:1F:24,4448946,1178954758,625162,696679753,3823784,482275005,37,515075,562595488,514454,562520734,621,74754,497394,10,625399,57931,34,449,130000.0,43333.0,-67.0,-65.0,-70.0,-67.0,-67.0,-65.0,-70.0,-67.0,-90.0,-93.0,-90.0,-93.0,23.0,28.0,20.0,26.0,0
4595,CC:2F:71:3E:C5:1F,3824536,482366900,750,91693,3823786,482275207,0,3144,264025,2595,198799,549,65226,794,8,1081,18,0,34,144444.0,39000.0,-70.0,-71.0,-67.0,-60.0,-70.0,-71.0,-67.0,-60.0,-90.0,-93.0,-90.0,-93.0,20.0,22.0,23.0,33.0,0
4596,BA:8C:B9:54:50:24,3828500,488424806,4714,6149599,3823786,482275207,0,8269,1643838,8247,1640343,22,3495,2320,14,5089,36,0,53,229410.0,137640.0,-39.0,-36.0,-44.0,-51.0,-42.0,-35.0,-43.0,-46.0,-90.0,-93.0,-90.0,-93.0,51.0,57.0,46.0,42.0,0
4597,92:69:1D:31:68:E9,3827429,485784162,3641,3508753,3823788,482275409,0,3999,993792,3886,968472,113,25320,1930,6,3767,79,0,33,229410.0,130000.0,-52.0,-50.0,-44.0,-46.0,-50.0,-48.0,-43.0,-47.0,-90.0,-93.0,-90.0,-93.0,38.0,43.0,46.0,47.0,0
4598,CC:2F:71:3F:1F:24,4448992,1178969596,625204,696694187,3823788,482275409,37,515102,562600548,514481,562525794,621,74754,497421,10,625441,57941,34,449,117000.0,39000.0,-67.0,-65.0,-70.0,-67.0,-67.0,-65.0,-70.0,-67.0,-90.0,-93.0,-90.0,-93.0,23.0,28.0,20.0,26.0,0
4599,CC:2F:71:3E:C5:1F,3824538,482367102,750,91693,3823788,482275409,0,3144,264025,2595,198799,549,65226,794,8,1081,18,0,34,144444.0,39000.0,-70.0,-71.0,-67.0,-60.0,-70.0,-71.0,-67.0,-60.0,-90.0,-93.0,-90.0,-93.0,20.0,22.0,23.0,33.0,0
4600,BA:8C:B9:54:50:24,3828502,488425008,4714,6149599,3823788,482275409,0,8269,1643838,8247,1640343,22,3495,2320,14,5089,36,0,53,229410.0,137640.0,-39.0,-36.0,-44.0,-51.0,-42.0,-35.0,-43.0,-46.0,-90.0,-93.0,-90.0,-93.0,51.0,57.0,46.0,42.0,0
4601,92:69:1D:31:68:E9,3827433,485784566,3641,3508753,3823792,482275813,0,3999,993792,3886,968472,113,25320,1930,6,3767,79,0,33,229410.0,130000.0,-52.0,-50.0,-44.0,-46.0,-50.0,-48.0,-43.0,-47.0,-90.0,-93.0,-90.0,-93.0,38.0,43.0,46.0,47.0,0
4602,CC:2F:71:3F:1F:24,4449040,1178984630,625246,696708615,3823794,482276015,37,515127,562605352,514506,562530598,621,74754,497446,10,625483,57945,34,449,130000.0,43333.0,-67.0,-65.0,-71.0,-68.0,-67.0,-65.0,-70.0,-67.0,-90.0,-93.0,-90.0,-93.0,23.0,28.0,19.0,25.0,0
4603,CC:2F:71:3E:C5:1F,3824544,482367708,750,91693,3823794,482276015,0,3144,264025,2595,198799,549,65226,794,8,1081,18,0,34,144444.0,39000.0,-70.0,-71.0,-67.0,-60.0,-70.0,-71.0,-67.0,-60.0,-90.0,-93.0,-90.0,-93.0,20.0,22.0,23.0,33.0,0
4604,BA:8C:B9:54:50:24,3828508,488425614,4714,6149599,3823794,482276015,0,8269,1643838,8247,1640343,22,3495,2320,14,5089,36,0,53,229410.0,137640.0,-39.0,-36.0,-44.0,-51.0,-42.0,-35.0,-43.0,-46.0,-90.0,-93.0,-90.0,-93.0,51.0,57.0,46.0,42.0,0
4605,92:69:1D:31:68:E9,3827438,485785030,3641,3508753,3823797,482276277,0,3999,993792,3886,968472,113,25320,1930,6,3767,79,0,33,229410.0,130000.0,-52.0,-50.0,-44.0,-46.0,-50.0,-48.0,-43.0,-47.0,-90.0,-93.0,-90.0,-93.0,38.0,43.0,46.0,47.0,0
4606,CC:2F:71:3F:1F:24,4449084,1178999196,625287,696722919,3823797,482276277,37,515153,562610296,514532,562535542,621,74754,497472,10,625524,57968,34,449,117000.0,39000.0,-67.0,-65.0,-70.0,-68.0,-67.0,-65.0,-70.0,-67.0,-90.0,-93.0,-90.0,-93.0,23.0,28.0,20.0,25.0,0
4607,CC:2F:71:3E:C5:1F,3824547,482367970,750,91693,3823797,482276277,0,3144,264025,2595,198799,549,65226,794,8,1081,18,0,34,144444.0,39000.0,-70.0,-71.0,-67.0,-60.0,-70.0,-71.0,-67.0,-60.0,-90.0,-93.0,-90.0,-93.0,20.0,22.0,23.0,33.0,0
4608,BA:8C:B9:54:50:24,3828511,488425876,4714,6149599,3823797,482276277,0,8269,1643838,8247,1640343,22,3495,2320,14,5089,36,0,53,229410.0,137640.0,-39.0,-36.0,-44.0,-51.0,-42.0,-35.0,-43.0,-46.0,-90.0,-93.0,-90.0,-93.0,51.0,57.0,46.0,42.0,0
4609,92:69:1D:31:68:E9,3827442,485785434,3641,3508753,3823801,482276681,0,3999,993792,3886,968472,113,25320,1930,6,3767,79,0,33,229410.0,130000.0,-52.0,-50.0,-44.0,-46.0,-50.0,-48.0,-43.0,-47.0,-90.0,-93.0,-90.0,-93.0,38.0,43.0,46.0,47.0,0
4610,CC:2F:71:3F:1F:24,4449132,1179014224,625329,696737341,3823803,482276883,37,515179,562615240,514558,562540486,621,74754,497498,10,625566,57970,34,449,130000.0,43333.0,-67.0,-65.0,-70.0,-67.0,-67.0,-65.0,-70.0,-67.0,-90.0,-93.0,-90.0,-93.0,23.0,28.0,20.0,26.0,0
4611,CC:2F:71:3E:C5:1F,3824553,482368576,750,91693,3823803,482276883,0,3144,264025,2595,198799,549,65226,794,8,1081,18,0,34,144444.0,39000.0,-70.0,-71.0,-67.0,-60.0,-70.0,-71.0,-67.0,-60.0,-90.0,-93.0,-90.0,-93.0,20.0,22.0,23.0,33.0,0
4612,BA:8C:B9:54:50:24,3828517,488426482,4714,6149599,3823803,482276883,0,8269,1643838,8247,1640343,22,3495,2320,14,5089,36,0,53,229410.0,137640.0,-39.0,-36.0,-44.0,-51.0,-42.0,-35.0,-43.0,-46.0,-90.0,-93.0,-90.0,-93.0,51.0,57.0,46.0,42.0,0
4613,92:69:1D:31:68:E9,3827446,485785838,3641,3508753,3823805,482277085,0,3999,993792,3886,968472,113,25320,1930,6,3767,79,0,33,229410.0,130000.0,-52.0,-50.0,-44.0,-46.0,-50.0,-48.0,-43.0,-47.0,-90.0,-93.0,-90.0,-93.0,38.0,43.0,46.0,47.0,0
4614,CC:2F:71:3F:1F:24,4449176,1179028846,625370,696751701,3823806,482277145,37,515206,562620300,514585,562545546,621,74754,497525,10,625607,57984,34,449,130000.0,39000.0,-67.0,-65.0,-71.0,-68.0,-67.0,-65.0,-70.0,-67.0,-90.0,-93.0,-90.0,-93.0,23.0,28.0,19.0,25.0,0
4615,CC:2F:71:3E:C5:1F,3824556,482368838,750,91693,3823806,482277145,0,3144,264025,2595,198799,549,65226,794,8,1081,18,0,34,144444.0,39000.0,-70.0,-71.0,-67.0,-60.0,-70.0,-71.0,-67.0,-60.0,-90.0,-93.0,-90.0,-93.0,20.0,22.0,23.0,33.0,0
4616,BA:8C:B9:54:50:24,3828520,488426744,4714,6149599,3823806,482277145,0,8269,1643838,8247,1640343,22,3495,2320,14,5089,36,0,53,229410.0,137640.0,-39.0,-36.0,-44.0,-51.0,-42.0,-35.0,-43.0,-46.0,-90.0,-93.0,-90.0,-93.0,51.0,57.0,46.0,42.0,0
4617,92:69:1D:31:68:E9,3827451,485786302,3641,3508753,3823810,482277549,0,3999,993792,3886,968472,113,25320,1930,6,3767,79,0,33,229410.0,130000.0,-52.0,-50.0,-44.0,-46.0,-50.0,-48.0,-43.0,-47.0,-90.0,-93.0,-90.0,-93.0,38.0,43.0,46.0,47.0,0
4618,CC:2F:71:3F:1F:24,4449221,1179043682,625411,696766133,3823810,482277549,37,515233,562625348,514612,562550594,621,74754,497552,10,625648,57995,34,449,130000.0,39000.0,-67.0,-65.0,-70.0,-67.0,-67.0,-65.0,-70.0,-67.0,-90.0,-93.0,-90.0,-93.0,23.0,28.0,20.0,26.0,0
4619,CC:2F:71:3E:C5:1F,3824562,482369444,750,91693,3823812,482277751,0,3144,264025,2595,198799,549,65226,794,8,1081,18,0,34,144444.0,39000.0,-70.0,-71.0,-67.0,-60.0,-70.0,-71.0,-67.0,-60.0,-90.0,-93.0,-90.0,-93.0,20.0,22.0,23.0,33.0,0
4620,BA:8C:B9:54:50:24,3828526,488427350,4714,6149599,3823812,482277751,0,8269,1643838,8247,1640343,22,3495,2320,14,5089,36,0,53,229410.0,137640.0,-39.0,-36.0,-44.0,-51.0,-42.0,-35.0,-43.0,-46.0,-90.0,-93.0,-90.0,-93.0,51.0,57.0,46.0,42.0,0
4621,92:69:1D:31:68:E9,3827455,485786706,3641,3508753,3823814,482277953,0,3999,993792,3886,968472,113,25320,1930,6,3767,79,0,33,229410.0,130000.0,-52.0,-50.0,-44.0,-46.0,-50.0,-48.0,-43.0,-47.0,-90.0,-93.0,-90.0,-93.0,38.0,43.0,46.0,47.0,0
4622,CC:2F:71:3F:1F:24,4449266,1179058446,625452,696780493,3823814,482277953,37,515259,562630292,514638,562555538,621,74754,497578,10,625689,58000,34,449,130000.0,43333.0,-67.0,-65.0,-70.0,-68.0,-67.0,-65.0,-70.0,-67.0,-90.0,-93.0,-90.0,-93.0,23.0,28.0,20.0,25.0,0
4623,CC:2F:71:3E:C5:1F,3824564,482369646,750,91693,3823814,482277953,0,3144,264025,2595,198799,549,65226,794,8,1081,18,0,34,144444.0,39000.0,-70.0,-71.0,-67.0,-60.0,-70.0,-71.0,-67.0,-60.0,-90.0,-93.0,-90.0,-93.0,20.0,22.0,23.0,33.0,0
4624,BA:8C:B9:54:50:24,3828528,488427552,4714,6149599,3823814,482277953,0,8269,1643838,8247,1640343,22,3495,2320,14,5089,36,0,53,229410.0,137640.0,-39.0,-36.0,-44.0,-51.0,-42.0,-35.0,-43.0,-46.0,-90.0,-93.0,-90.0,-93.0,51.0,57.0,46.0,42.0,0
4625,92:69:1D:31:68:E9,3827460,485787170,3641,3508753,3823819,482278417,0,3999,993792,3886,968472,113,25320,1930,6,3767,79,0,33,229410.0,130000.0,-52.0,-50.0,-44.0,-46.0,-50.0,-48.0,-43.0,-47.0,-90.0,-93.0,-90.0,-93.0,38.0,43.0,46.0,47.0,0
4626,CC:2F:71:3F:1F:24,4449313,1179073344,625494,696794927,3823819,482278417,37,515285,562635236,514664,562560482,621,74754,497604,10,625731,58032,34,449,144444.0,39000.0,-67.0,-65.0,-70.0,-67.0,-67.0,-65.0,-70.0,-67.0,-90.0,-93.0,-90.0,-93.0,23.0,28.0,20.0,26.0,0
4627,CC:2F:71:3E:C5:1F,3824571,482370312,750,91693,3823821,482278619,0,3144,264025,2595,198799,549,65226,794,8,1081,18,0,34,144444.0,39000.0,-70.0,-71.0,-67.0,-60.0,-70.0,-71.0,-67.0,-60.0,-90.0,-93.0,-90.0,-93.0,20.0,22.0,23.0,33.0,0
4628,BA:8C:B9:54:50:24,3828535,488428218,4714,6149599,3823821,482278619,0,8269,1643838,8247,1640343,22,3495,2320,14,5089,36,0,53,229410.0,137640.0,-39.0,-36.0,-44.0,-51.0,-42.0,-35.0,-43.0,-46.0,-90.0,-93.0,-90.0,-93.0,51.0,57.0,46.0,42.0,0
4629,92:69:1D:31:68:E9,3827465,485787690,3642,3508869,3823823,482278821,0,4001,993928,3888,968608,113,25320,1930,6,3768,79,0,34,229410.0,130000.0,-51.0,-47.0,-42.0,-48.0,-51.0,-49.0,-44.0,-47.0,-90.0,-93.0,-90.0,-93.0,39.0,46.0,48.0,45.0,0
4630,CC:2F:71:3F:1F:24,4449362,1179088546,625539,696809725,3823823,482278821,37,515314,562640528,514693,562565774,621,74754,497633,10,625776,58042,34,449,130000.0,43333.0,-67.0,-65.0,-70.0,-67.0,-67.0,-65.0,-70.0,-67.0,-90.0,-93.0,-90.0,-93.0,23.0,28.0,20.0,26.0,0
4631,CC:2F:71:3E:C5:1F,3824574,482370630,751,91809,3823823,482278821,0,3146,264165,2597,198939,549,65226,794,8,1082,18,0,34,144444.0,39000.0,-71.0,-71.0,-67.0,-60.0,-70.0,-71.0,-67.0,-60.0,-90.0,-93.0,-90.0,-93.0,19.0,22.0,23.0,33.0,0
4632,BA:8C:B9:54:50:24,3828538,488428480,4715,6149659,3823823,482278821,0,8271,1643974,8249,1640479,22,3495,2320,14,5090,36,0,53,216660.0,130000.0,-49.0,-35.0,-42.0,-44.0,-42.0,-35.0,-43.0,-47.0,-90.0,-93.0,-90.0,-93.0,41.0,58.0,48.0,49.0,0
4633,92:69:1D:31:68:E9,3827470,485788367,3642,3508869,3823828,482279498,0,4001,993928,3888,968608,113,25320,1930,6,3768,79,0,34,229410.0,130000.0,-51.0,-47.0,-42.0,-48.0,-51.0,-49.0,-44.0,-47.0,-90.0,-93.0,-90.0,-93.0,39.0,46.0,48.0,45.0,0
4634,CC:2F:71:3F:1F:24,4449409,1179103651,625581,696824153,3823828,482279498,37,515344,562645912,514723,562571158,621,74754,497663,10,625818,58050,34,449,117000.0,39000.0,-67.0,-65.0,-70.0,-68.0,-67.0,-65.0,-70.0,-67.0,-90.0,-93.0,-90.0,-93.0,23.0,28.0,20.0,25.0,0
4635,CC:2F:71:3E:C5:1F,3824579,482371307,751,91809,3823828,482279498,0,3146,264165,2597,198939,549,65226,794,8,1082,18,0,34,144444.0,39000.0,-71.0,-71.0,-67.0,-60.0,-70.0,-71.0,-67.0,-60.0,-90.0,-93.0,-90.0,-93.0,19.0,22.0,23.0,33.0,0
4636,BA:8C:B9:54:50:24,3828543,488429157,4715,6149659,3823828,482279498,0,8271,1643974,8249,1640479,22,3495,2320,14,5090,36,0,53,216660.0,130000.0,-49.0,-35.0,-42.0,-44.0,-42.0,-35.0,-43.0,-47.0,-90.0,-93.0,-90.0,-93.0,41.0,58.0,48.0,49.0,0
4637,92:69:1D:31:68:E9,3827475,485788831,3642,3508869,3823833,482279962,0,4001,993928,3888,968608,113,25320,1930,6,3768,79,0,34,229410.0,130000.0,-51.0,-47.0,-42.0,-48.0,-51.0,-49.0,-44.0,-47.0,-90.0,-93.0,-90.0,-93.0,39.0,46.0,48.0,45.0,0
4638,CC:2F:71:3F:1F:24,4449454,1179118295,625621,696838333,3823833,482279962,37,515373,562651204,514752,562576450,621,74754,497692,10,625858,58058,34,449,130000.0,43333.0,-67.0,-65.0,-70.0,-67.0,-67.0,-65.0,-70.0,-67.0,-90.0,-93.0,-90.0,-93.0,23.0,28.0,20.0,26.0,0
4639,CC:2F:71:3E:C5:1F,3824584,482371771,751,91809,3823833,482279962,0,3146,264165,2597,198939,549,65226,794,8,1082,18,0,34,144444.0,39000.0,-71.0,-71.0,-67.0,-60.0,-70.0,-71.0,-67.0,-60.0,-90.0,-93.0,-90.0,-93.0,19.0,22.0,23.0,33.0,0
4640,BA:8C:B9:54:50:24,3828548,488429621,4715,6149659,3823833,482279962,0,8272,1644042,8250,1640547,22,3495,2320,14,5090,36,0,53,216660.0,130000.0,-39.0,-36.0,-44.0,-52.0,-42.0,-35.0,-43.0,-48.0,-90.0,-93.0,-90.0,-93.0,51.0,57.0,46.0,41.0,0
4641,92:69:1D:31:68:E9,3827479,485789235,3642,3508869,3823837,482280366,0,4001,993928,3888,968608,113,25320,1930,6,3768,79,0,34,229410.0,130000.0,-51.0,-47.0,-42.0,-48.0,-51.0,-49.0,-44.0,-47.0,-90.0,-93.0,-90.0,-93.0,39.0,46.0,48.0,45.0,0
4642,CC:2F:71:3F:1F:24,4449501,1179133251,625664,696852885,3823837,482280366,37,515401,562656380,514780,562581626,621,74754,497720,10,625901,58081,34,449,117000.0,39000.0,-67.0,-65.0,-70.0,-68.0,-67.0,-65.0,-70.0,-67.0,-90.0,-93.0,-90.0,-93.0,23.0,28.0,20.0,25.0,0
4643,CC:2F:71:3E:C5:1F,3824588,482372175,751,91809,3823837,482280366,0,3146,264165,2597,198939,549,65226,794,8,1082,18,0,34,144444.0,39000.0,-71.0,-71.0,-67.0,-60.0,-70.0,-71.0,-67.0,-60.0,-90.0,-93.0,-90.0,-93.0,19.0,22.0,23.0,33.0,0
4644,BA:8C:B9:54:50:24,3828552,488430025,4715,6149659,3823837,482280366,0,8272,1644042,8250,1640547,22,3495,2320,14,5090,36,0,53,216660.0,130000.0,-39.0,-36.0,-44.0,-52.0,-42.0,-35.0,-43.0,-48.0,-90.0,-93.0,-90.0,-93.0,51.0,57.0,46.0,41.0,0
4645,92:69:1D:31:68:E9,3827484,485789699,3642,3508869,3823842,482280830,0,4001,993928,3888,968608,113,25320,1930,6,3768,79,0,34,229410.0,130000.0,-51.0,-47.0,-42.0,-48.0,-51.0,-49.0,-44.0,-47.0,-90.0,-93.0,-90.0,-93.0,39.0,46.0,48.0,45.0,0
4646,CC:2F:71:3F:1F:24,4449548,1179148143,625706,696867313,3823842,482280830,37,515428,562661416,514807,562586662,621,74754,497747,10,625943,58085,34,449,130000.0,43333.0,-67.0,-65.0,-70.0,-67.0,-67.0,-65.0,-70.0,-67.0,-90.0,-93.0,-90.0,-93.0,23.0,28.0,20.0,26.0,0
4647,CC:2F:71:3E:C5:1F,3824593,482372639,751,91809,3823842,482280830,0,3146,264165,2597,198939,549,65226,794,8,1082,18,0,34,144444.0,39000.0,-71.0,-71.0,-67.0,-60.0,-70.0,-71.0,-67.0,-60.0,-90.0,-93.0,-90.0,-93.0,19.0,22.0,23.0,33.0,0
4648,BA:8C:B9:54:50:24,3828557,488430489,4715,6149659,3823842,482280830,0,8272,1644042,8250,1640547,22,3495,2320,14,5090,36,0,53,216660.0,130000.0,-39.0,-36.0,-44.0,-52.0,-42.0,-35.0,-43.0,-48.0,-90.0,-93.0,-90.0,-93.0,51.0,57.0,46.0,41.0,0
4649,92:69:1D:31:68:E9,3827488,485790103,3642,3508869,3823846,482281234,0,4001,993928,3888,968608,113,25320,1930,6,3768,79,0,34,229410.0,130000.0,-51.0,-47.0,-42.0,-48.0,-51.0,-49.0,-44.0,-47.0,-90.0,-93.0,-90.0,-93.0,39.0,46.0,48.0,45.0,0
4650,CC:2F:71:3F:1F:24,4449594,1179163037,625748,696881803,3823846,482281234,37,515455,562666476,514834,562591722,621,74754,497774,10,625985,58102,34,449,130000.0,39000.0,-67.0,-65.0,-70.0,-68.0,-67.0,-65.0,-70.0,-67.0,-90.0,-93.0,-90.0,-93.0,23.0,28.0,20.0,25.0,0
4651,CC:2F:71:3E:C5:1F,3824597,482373043,751,91809,3823846,482281234,0,3146,264165,2597,198939,549,65226,794,8,1082,18,0,34,144444.0,39000.0,-71.0,-71.0,-67.0,-60.0,-70.0,-71.0,-67.0,-60.0,-90.0,-93.0,-90.0,-93.0,19.0,22.0,23.0,33.0,0
4652,BA:8C:B9:54:50:24,3828561,488430893,4715,6149659,3823846,482281234,0,8272,1644042,8250,1640547,22,3495,2320,14,5090,36,0,53,216660.0,130000.0,-39.0,-36.0,-44.0,-52.0,-42.0,-35.0,-43.0,-48.0,-90.0,-93.0,-90.0,-93.0,51.0,57.0,46.0,41.0,0
4653,92:69:1D:31:68:E9,3827492,485790507,3642,3508869,3823850,482281638,0,4001,993928,3888,968608,113,25320,1930,6,3768,79,0,34,229410.0,130000.0,-51.0,-47.0,-42.0,-48.0,-51.0,-49.0,-44.0,-47.0,-90.0,-93.0,-90.0,-93.0,39.0,46.0,48.0,45.0,0
4654,CC:2F:71:3F:1F:24,4449641,1179177993,625791,696896355,3823850,482281638,37,515481,562671456,514860,562596702,621,74754,497800,10,626028,58113,34,449,130000.0,39000.0,-67.0,-65.0,-71.0,-68.0,-67.0,-65.0,-70.0,-67.0,-90.0,-93.0,-90.0,-93.0,23.0,28.0,19.0,25.0,0
4655,CC:2F:71:3E:C5:1F,3824601,482373447,751,91809,3823850,482281638,0,3146,264165,2597,198939,549,65226,794,8,1082,18,0,34,144444.0,39000.0,-71.0,-71.0,-67.0,-60.0,-70.0,-71.0,-67.0,-60.0,-90.0,-93.0,-90.0,-93.0,19.0,22.0,23.0,33.0,0
4656,BA:8C:B9:54:50:24,3828565,488431297,4715,6149659,3823850,482281638,0,8272,1644042,8250,1640547,22,3495,2320,14,5090,36,0,53,216660.0,130000.0,-39.0,-36.0,-44.0,-52.0,-42.0,-35.0,-43.0,-48.0,-90.0,-93.0,-90.0,-93.0,51.0,57.0,46.0,41.0,0
4657,92:69:1D:31:68:E9,3827497,485790971,3642,3508869,3823855,482282102,0,4001,993928,3888,968608,113,25320,1930,6,3768,79,0,34,229410.0,130000.0,-51.0,-47.0,-42.0,-48.0,-51.0,-49.0,-44.0,-47.0,-90.0,-93.0,-90.0,-93.0,39.0,46.0,48.0,45.0,0
4658,CC:2F:71:3F:1F:24,4449689,1179193379,625833,696911215,3823856,482282164,37,515511,562676898,514890,562602144,621,74754,497830,10,626070,58114,34,449,130000.0,43333.0,-71.0,-69.0,-74.0,-71.0,-69.0,-67.0,-72.0,-69.0,-90.0,-93.0,-90.0,-93.0,19.0,24.0,16.0,22.0,0
4659,CC:2F:71:3E:C5:1F,3824607,482373973,751,91809,3823856,482282164,0,3148,264353,2598,199009,550,65344,795,8,1082,18,0,34,144444.0,39000.0,-70.0,-71.0,-67.0,-60.0,-70.0,-71.0,-67.0,-60.0,-90.0,-93.0,-90.0,-93.0,20.0,22.0,23.0,33.0,0
4660,BA:8C:B9:54:50:24,3828571,488431823,4715,6149659,3823856,482282164,0,8272,1644042,8250,1640547,22,3495,2320,14,5090,36,0,53,216660.0,130000.0,-39.0,-36.0,-44.0,-52.0,-42.0,-35.0,-43.0,-48.0,-90.0,-93.0,-90.0,-93.0,51.0,57.0,46.0,41.0,0
4661,92:69:1D:31:68:E9,3827502,485791437,3642,3508869,3823860,482282568,0,4001,993928,3888,968608,113,25320,1930,6,3768,79,0,34,229410.0,130000.0,-51.0,-47.0,-42.0,-48.0,-51.0,-49.0,-44.0,-47.0,-90.0,-93.0,-90.0,-93.0,39.0,46.0,48.0,45.0,0
4662,CC:2F:71:3F:1F:24,4449735,1179208205,625875,696925637,3823860,482282568,37,515536,562681702,514915,562606948,621,74754,497855,10,626112,58133,34,449,117000.0,39000.0,-68.0,-66.0,-72.0,-68.0,-74.0,-72.0,-77.0,-74.0,-90.0,-93.0,-90.0,-93.0,22.0,27.0,18.0,25.0,0
4663,CC:2F:71:3E:C5:1F,3824611,482374377,751,91809,3823860,482282568,0,3148,264353,2598,199009,550,65344,795,8,1082,18,0,34,144444.0,39000.0,-70.0,-71.0,-67.0,-60.0,-70.0,-71.0,-67.0,-60.0,-90.0,-93.0,-90.0,-93.0,20.0,22.0,23.0,33.0,0
4664,BA:8C:B9:54:50:24,3828575,488432227,4715,6149659,3823860,482282568,0,8272,1644042,8250,1640547,22,3495,2320,14,5090,36,0,53,216660.0,130000.0,-39.0,-36.0,-44.0,-52.0,-42.0,-35.0,-43.0,-48.0,-90.0,-93.0,-90.0,-93.0,51.0,57.0,46.0,41.0,0
4665,92:69:1D:31:68:E9,3827506,485791841,3642,3508869,3823864,482282972,0,4001,993928,3888,968608,113,25320,1930,6,3768,79,0,34,229410.0,130000.0,-51.0,-47.0,-42.0,-48.0,-51.0,-49.0,-44.0,-47.0,-90.0,-93.0,-90.0,-93.0,39.0,46.0,48.0,45.0,0
4666,CC:2F:71:3F:1F:24,4449780,1179222913,625916,696939941,3823864,482282972,37,515561,562686506,514940,562611752,621,74754,497880,10,626153,58141,34,449,130000.0,43333.0,-68.0,-66.0,-71.0,-68.0,-67.0,-66.0,-71.0,-68.0,-90.0,-93.0,-90.0,-93.0,22.0,27.0,19.0,25.0,0
4667,CC:2F:71:3E:C5:1F,3824615,482374781,751,91809,3823864,482282972,0,3148,264353,2598,199009,550,65344,795,8,1082,18,0,34,144444.0,39000.0,-70.0,-71.0,-67.0,-60.0,-70.0,-71.0,-67.0,-60.0,-90.0,-93.0,-90.0,-93.0,20.0,22.0,23.0,33.0,0
4668,BA:8C:B9:54:50:24,3828580,488432691,4715,6149659,3823865,482283032,0,8272,1644042,8250,1640547,22,3495,2320,14,5090,36,0,53,216660.0,130000.0,-39.0,-36.0,-44.0,-52.0,-42.0,-35.0,-43.0,-48.0,-90.0,-93.0,-90.0,-93.0,51.0,57.0,46.0,41.0,0
4669,92:69:1D:31:68:E9,3827511,485792305,3642,3508869,3823869,482283436,0,4001,993928,3888,968608,113,25320,1930,6,3768,79,0,34,229410.0,130000.0,-51.0,-47.0,-42.0,-48.0,-51.0,-49.0,-44.0,-47.0,-90.0,-93.0,-90.0,-93.0,39.0,46.0,48.0,45.0,0
4670,CC:2F:71:3F:1F:24,4449827,1179237861,625958,696954425,3823869,482283436,37,515588,562691566,514967,562616812,621,74754,497907,10,626195,58148,34,449,130000.0,39000.0,-67.0,-65.0,-71.0,-67.0,-67.0,-65.0,-70.0,-67.0,-90.0,-93.0,-90.0,-93.0,23.0,28.0,19.0,26.0,0
4671,CC:2F:71:3E:C5:1F,3824620,482375245,751,91809,3823869,482283436,0,3148,264353,2598,199009,550,65344,795,8,1082,18,0,34,144444.0,39000.0,-70.0,-71.0,-67.0,-60.0,-70.0,-71.0,-67.0,-60.0,-90.0,-93.0,-90.0,-93.0,20.0,22.0,23.0,33.0,0
4672,BA:8C:B9:54:50:24,3828584,488433095,4715,6149659,3823869,482283436,0,8272,1644042,8250,1640547,22,3495,2320,14,5090,36,0,53,216660.0,130000.0,-39.0,-36.0,-44.0,-52.0,-42.0,-35.0,-43.0,-48.0,-90.0,-93.0,-90.0,-93.0,51.0,57.0,46.0,41.0,0
4673,92:69:1D:31:68:E9,3827515,485792709,3642,3508869,3823873,482283840,0,4001,993928,3888,968608,113,25320,1930,6,3768,79,0,34,229410.0,130000.0,-51.0,-47.0,-42.0,-48.0,-51.0,-49.0,-44.0,-47.0,-90.0,-93.0,-90.0,-93.0,39.0,46.0,48.0,45.0,0
4674,CC:2F:71:3F:1F:24,4449875,1179252891,626002,696969051,3823873,482283840,37,515616,562696742,514995,562621988,621,74754,497935,10,626239,58180,34,449,130000.0,43333.0,-67.0,-65.0,-70.0,-67.0,-67.0,-65.0,-70.0,-67.0,-90.0,-93.0,-90.0,-93.0,23.0,28.0,20.0,26.0,0
4675,CC:2F:71:3E:C5:1F,3824624,482375649,751,91809,3823873,482283840,0,3148,264353,2598,199009,550,65344,795,8,1082,18,0,34,144444.0,39000.0,-70.0,-71.0,-67.0,-60.0,-70.0,-71.0,-67.0,-60.0,-90.0,-93.0,-90.0,-93.0,20.0,22.0,23.0,33.0,0
4676,BA:8C:B9:54:50:24,3828588,488433499,4715,6149659,3823873,482283840,0,8272,1644042,8250,1640547,22,3495,2320,14,5090,36,0,53,216660.0,130000.0,-39.0,-36.0,-44.0,-52.0,-42.0,-35.0,-43.0,-48.0,-90.0,-93.0,-90.0,-93.0,51.0,57.0,46.0,41.0,0
4677,92:69:1D:31:68:E9,3827521,485793299,3642,3508869,3823879,482284430,0,4001,993928,3888,968608,113,25320,1930,6,3768,79,0,34,229410.0,130000.0,-51.0,-47.0,-42.0,-48.0,-51.0,-49.0,-44.0,-47.0,-90.0,-93.0,-90.0,-93.0,39.0,46.0,48.0,45.0,0
4678,CC:2F:71:3F:1F:24,4449921,1179267773,626042,696983343,3823879,482284430,37,515641,562701546,515020,562626792,621,74754,497960,10,626279,58185,34,449,130000.0,43333.0,-67.0,-65.0,-71.0,-67.0,-67.0,-65.0,-70.0,-67.0,-90.0,-93.0,-90.0,-93.0,23.0,28.0,19.0,26.0,0
4679,CC:2F:71:3E:C5:1F,3824630,482376239,751,91809,3823879,482284430,0,3148,264353,2598,199009,550,65344,795,8,1082,18,0,34,144444.0,39000.0,-70.0,-71.0,-67.0,-60.0,-70.0,-71.0,-67.0,-60.0,-90.0,-93.0,-90.0,-93.0,20.0,22.0,23.0,33.0,0
4680,BA:8C:B9:54:50:24,3828594,488434089,4715,6149659,3823879,482284430,0,8272,1644042,8250,1640547,22,3495,2320,14,5090,36,0,53,216660.0,130000.0,-39.0,-36.0,-44.0,-52.0,-42.0,-35.0,-43.0,-48.0,-90.0,-93.0,-90.0,-93.0,51.0,57.0,46.0,41.0,0
4681,92:69:1D:31:68:E9,3827526,485793765,3642,3508869,3823884,482284896,0,4001,993928,3888,968608,113,25320,1930,6,3768,79,0,34,229410.0,130000.0,-51.0,-47.0,-42.0,-48.0,-51.0,-49.0,-44.0,-47.0,-90.0,-93.0,-90.0,-93.0,39.0,46.0,48.0,45.0,0
4682,CC:2F:71:3F:1F:24,4449967,1179282543,626083,696997647,3823884,482284896,37,515671,562706980,515049,562632108,622,74872,497990,10,626320,58203,34,449,117000.0,39000.0,-67.0,-65.0,-70.0,-68.0,-67.0,-65.0,-70.0,-67.0,-90.0,-93.0,-90.0,-93.0,23.0,28.0,20.0,25.0,0
4683,CC:2F:71:3E:C5:1F,3824635,482376705,751,91809,3823884,482284896,0,3148,264353,2598,199009,550,65344,795,8,1082,18,0,34,144444.0,39000.0,-70.0,-71.0,-67.0,-60.0,-70.0,-71.0,-67.0,-60.0,-90.0,-93.0,-90.0,-93.0,20.0,22.0,23.0,33.0,0
4684,BA:8C:B9:54:50:24,3828599,488434555,4715,6149659,3823884,482284896,0,8272,1644042,8250,1640547,22,3495,2320,14,5090,36,0,53,216660.0,130000.0,-39.0,-36.0,-44.0,-52.0,-42.0,-35.0,-43.0,-48.0,-90.0,-93.0,-90.0,-93.0,51.0,57.0,46.0,41.0,0
4685,92:69:1D:31:68:E9,3827531,485794442,3642,3508869,3823889,482285573,0,4001,993928,3888,968608,113,25320,1930,6,3768,79,0,34,229410.0,130000.0,-51.0,-47.0,-42.0,-48.0,-51.0,-49.0,-44.0,-47.0,-90.0,-93.0,-90.0,-93.0,39.0,46.0,48.0,45.0,0
4686,CC:2F:71:3F:1F:24,4450014,1179297648,626125,697012075,3823889,482285573,37,515696,562711784,515074,562636912,622,74872,498015,10,626362,58216,34,449,130000.0,43333.0,-67.0,-65.0,-70.0,-68.0,-67.0,-65.0,-70.0,-67.0,-90.0,-93.0,-90.0,-93.0,23.0,28.0,20.0,25.0,0
4687,CC:2F:71:3E:C5:1F,3824640,482377382,751,91809,3823889,482285573,0,3148,264353,2598,199009,550,65344,795,8,1082,18,0,34,144444.0,39000.0,-70.0,-71.0,-67.0,-60.0,-70.0,-71.0,-67.0,-60.0,-90.0,-93.0,-90.0,-93.0,20.0,22.0,23.0,33.0,0
4688,BA:8C:B9:54:50:24,3828604,488435232,4715,6149659,3823889,482285573,0,8272,1644042,8250,1640547,22,3495,2320,14,5090,36,0,53,216660.0,130000.0,-39.0,-36.0,-44.0,-52.0,-42.0,-35.0,-43.0,-48.0,-90.0,-93.0,-90.0,-93.0,51.0,57.0,46.0,41.0,0
4689,92:69:1D:31:68:E9,3827536,485794906,3642,3508869,3823894,482286037,0,4001,993928,3888,968608,113,25320,1930,6,3768,79,0,34,229410.0,130000.0,-51.0,-47.0,-42.0,-48.0,-51.0,-49.0,-44.0,-47.0,-90.0,-93.0,-90.0,-93.0,39.0,46.0,48.0,45.0,0
4690,CC:2F:71:3F:1F:24,4450061,1179312596,626167,697026559,3823894,482286037,37,515722,562716704,515100,562641832,622,74872,498041,10,626404,58235,34,449,130000.0,39000.0,-67.0,-65.0,-70.0,-68.0,-67.0,-65.0,-70.0,-67.0,-90.0,-93.0,-90.0,-93.0,23.0,28.0,20.0,25.0,0
4691,CC:2F:71:3E:C5:1F,3824645,482377846,751,91809,3823894,482286037,0,3148,264353,2598,199009,550,65344,795,8,1082,18,0,34,144444.0,39000.0,-70.0,-71.0,-67.0,-60.0,-70.0,-71.0,-67.0,-60.0,-90.0,-93.0,-90.0,-93.0,20.0,22.0,23.0,33.0,0
4692,BA:8C:B9:54:50:24,3828609,488435696,4715,6149659,3823894,482286037,0,8272,1644042,8250,1640547,22,3495,2320,14,5090,36,0,53,216660.0,130000.0,-39.0,-36.0,-44.0,-52.0,-42.0,-35.0,-43.0,-48.0,-90.0,-93.0,-90.0,-93.0,51.0,57.0,46.0,41.0,0
4693,92:69:1D:31:68:E9,3827540,485795310,3642,3508869,3823898,482286441,0,4001,993928,3888,968608,113,25320,1930,6,3768,79,0,34,229410.0,130000.0,-51.0,-47.0,-42.0,-48.0,-51.0,-49.0,-44.0,-47.0,-90.0,-93.0,-90.0,-93.0,39.0,46.0,48.0,45.0,0
4694,CC:2F:71:3F:1F:24,4450107,1179327428,626209,697040987,3823898,482286441,37,515748,562721624,515126,562646752,622,74872,498067,10,626446,58249,34,449,130000.0,39000.0,-67.0,-65.0,-71.0,-67.0,-67.0,-65.0,-70.0,-67.0,-90.0,-93.0,-90.0,-93.0,23.0,28.0,19.0,26.0,0
4695,CC:2F:71:3E:C5:1F,3824649,482378250,751,91809,3823898,482286441,0,3148,264353,2598,199009,550,65344,795,8,1082,18,0,34,144444.0,39000.0,-70.0,-71.0,-67.0,-60.0,-70.0,-71.0,-67.0,-60.0,-90.0,-93.0,-90.0,-93.0,20.0,22.0,23.0,33.0,0
4696,BA:8C:B9:54:50:24,3828613,488436100,4715,6149659,3823898,482286441,0,8272,1644042,8250,1640547,22,3495,2320,14,5090,36,0,53,216660.0,130000.0,-39.0,-36.0,-44.0,-52.0,-42.0,-35.0,-43.0,-48.0,-90.0,-93.0,-90.0,-93.0,51.0,57.0,46.0,41.0,0
4697,92:69:1D:31:68:E9,3827544,485795714,3642,3508869,3823902,482286845,0,4001,993928,3888,968608,113,25320,1930,6,3768,79,0,34,229410.0,130000.0,-51.0,-47.0,-42.0,-48.0,-51.0,-49.0,-44.0,-47.0,-90.0,-93.0,-90.0,-93.0,39.0,46.0,48.0,45.0,0
4698,CC:2F:71:3F:1F:24,4450151,1179341950,626249,697055105,3823902,482286845,37,515774,562726568,515152,562651696,622,74872,498093,10,626486,58259,34,449,117000.0,39000.0,-67.0,-65.0,-71.0,-67.0,-67.0,-65.0,-70.0,-67.0,-90.0,-93.0,-90.0,-93.0,23.0,28.0,19.0,26.0,0
4699,CC:2F:71:3E:C5:1F,3824653,482378654,751,91809,3823902,482286845,0,3148,264353,2598,199009,550,65344,795,8,1082,18,0,34,144444.0,39000.0,-70.0,-71.0,-67.0,-60.0,-70.0,-71.0,-67.0,-60.0,-90.0,-93.0,-90.0,-93.0,20.0,22.0,23.0,33.0,0
4700,BA:8C:B9:54:50:24,3828618,488436564,4715,6149659,3823903,482286905,0,8272,1644042,8250,1640547,22,3495,2320,14,5090,36,0,53,216660.0,130000.0,-39.0,-36.0,-44.0,-52.0,-42.0,-35.0,-43.0,-48.0,-90.0,-93.0,-90.0,-93.0,51.0,57.0,46.0,41.0,0
4701,92:69:1D:31:68:E9,3827549,485796178,3642,3508869,3823907,482287309,0,4001,993928,3888,968608,113,25320,1930,6,3768,79,0,34,229410.0,130000.0,-51.0,-47.0,-42.0,-48.0,-51.0,-49.0,-44.0,-47.0,-90.0,-93.0,-90.0,-93.0,39.0,46.0,48.0,45.0,0
4702,CC:2F:71:3F:1F:24,4450198,1179356786,626291,697069477,3823907,482287309,37,515799,562731372,515177,562656500,622,74872,498118,10,626528,58267,34,449,130000.0,39000.0,-67.0,-65.0,-70.0,-67.0,-67.0,-65.0,-70.0,-67.0,-90.0,-93.0,-90.0,-93.0,23.0,28.0,20.0,26.0,0
4703,CC:2F:71:3E:C5:1F,3824658,482379118,751,91809,3823907,482287309,0,3148,264353,2598,199009,550,65344,795,8,1082,18,0,34,144444.0,39000.0,-70.0,-71.0,-67.0,-60.0,-70.0,-71.0,-67.0,-60.0,-90.0,-93.0,-90.0,-93.0,20.0,22.0,23.0,33.0,0
4704,BA:8C:B9:54:50:24,3828622,488436968,4715,6149659,3823907,482287309,0,8272,1644042,8250,1640547,22,3495,2320,14,5090,36,0,53,216660.0,130000.0,-39.0,-36.0,-44.0,-52.0,-42.0,-35.0,-43.0,-48.0,-90.0,-93.0,-90.0,-93.0,51.0,57.0,46.0,41.0,0
4705,92:69:1D:31:68:E9,3827553,485796582,3642,3508869,3823911,482287713,0,4001,993928,3888,968608,113,25320,1930,6,3768,79,0,34,229410.0,130000.0,-51.0,-47.0,-42.0,-48.0,-51.0,-49.0,-44.0,-47.0,-90.0,-93.0,-90.0,-93.0,39.0,46.0,48.0,45.0,0
4706,CC:2F:71:3F:1F:24,4450244,1179371674,626333,697083961,3823911,482287713,37,515824,562736176,515202,562661304,622,74872,498143,10,626570,58294,34,449,130000.0,39000.0,-67.0,-65.0,-70.0,-68.0,-67.0,-65.0,-70.0,-67.0,-90.0,-93.0,-90.0,-93.0,23.0,28.0,20.0,25.0,0
4707,CC:2F:71:3E:C5:1F,3824662,482379522,751,91809,3823911,482287713,0,3148,264353,2598,199009,550,65344,795,8,1082,18,0,34,144444.0,39000.0,-70.0,-71.0,-67.0,-60.0,-70.0,-71.0,-67.0,-60.0,-90.0,-93.0,-90.0,-93.0,20.0,22.0,23.0,33.0,0
4708,BA:8C:B9:54:50:24,3828626,488437372,4715,6149659,3823911,482287713,0,8272,1644042,8250,1640547,22,3495,2320,14,5090,36,0,53,216660.0,130000.0,-39.0,-36.0,-44.0,-52.0,-42.0,-35.0,-43.0,-48.0,-90.0,-93.0,-90.0,-93.0,51.0,57.0,46.0,41.0,0
4709,92:69:1D:31:68:E9,3827558,485797046,3642,3508869,3823916,482288177,0,4001,993928,3888,968608,113,25320,1930,6,3768,79,0,34,229410.0,130000.0,-51.0,-47.0,-42.0,-48.0,-51.0,-49.0,-44.0,-47.0,-90.0,-93.0,-90.0,-93.0,39.0,46.0,48.0,45.0,0
4710,CC:2F:71:3F:1F:24,4450291,1179386566,626375,697098389,3823916,482288177,37,515849,562740980,515227,562666108,622,74872,498168,10,626612,58299,34,449,130000.0,43333.0,-67.0,-65.0,-71.0,-68.0,-67.0,-65.0,-70.0,-67.0,-90.0,-93.0,-90.0,-93.0,23.0,28.0,19.0,25.0,0
4711,CC:2F:71:3E:C5:1F,3824667,482379986,751,91809,3823916,482288177,0,3148,264353,2598,199009,550,65344,795,8,1082,18,0,34,144444.0,39000.0,-70.0,-71.0,-67.0,-60.0,-70.0,-71.0,-67.0,-60.0,-90.0,-93.0,-90.0,-93.0,20.0,22.0,23.0,33.0,0
4712,BA:8C:B9:54:50:24,3828631,488437836,4715,6149659,3823916,482288177,0,8272,1644042,8250,1640547,22,3495,2320,14,5090,36,0,53,216660.0,130000.0,-39.0,-36.0,-44.0,-52.0,-42.0,-35.0,-43.0,-48.0,-90.0,-93.0,-90.0,-93.0,51.0,57.0,46.0,41.0,0
4713,92:69:1D:31:68:E9,3827562,485797450,3642,3508869,3823920,482288581,0,4001,993928,3888,968608,113,25320,1930,6,3768,79,0,34,229410.0,130000.0,-51.0,-47.0,-42.0,-48.0,-51.0,-49.0,-44.0,-47.0,-90.0,-93.0,-90.0,-93.0,39.0,46.0,48.0,45.0,0
4714,CC:2F:71:3F:1F:24,4450337,1179401454,626417,697112873,3823920,482288581,37,515875,562745924,515253,562671052,622,74872,498194,10,626654,58317,34,449,130000.0,39000.0,-67.0,-65.0,-70.0,-68.0,-67.0,-65.0,-70.0,-67.0,-90.0,-93.0,-90.0,-93.0,23.0,28.0,20.0,25.0,0
4715,CC:2F:71:3E:C5:1F,3824671,482380390,751,91809,3823920,482288581,0,3148,264353,2598,199009,550,65344,795,8,1082,18,0,34,144444.0,39000.0,-70.0,-71.0,-67.0,-60.0,-70.0,-71.0,-67.0,-60.0,-90.0,-93.0,-90.0,-93.0,20.0,22.0,23.0,33.0,0
4716,BA:8C:B9:54:50:24,3828635,488438240,4715,6149659,3823920,482288581,0,8272,1644042,8250,1640547,22,3495,2320,14,5090,36,0,53,216660.0,130000.0,-39.0,-36.0,-44.0,-52.0,-42.0,-35.0,-43.0,-48.0,-90.0,-93.0,-90.0,-93.0,51.0,57.0,46.0,41.0,0
4717,92:69:1D:31:68:E9,3827566,485797854,3642,3508869,3823924,482288985,0,4001,993928,3888,968608,113,25320,1930,6,3768,79,0,34,229410.0,130000.0,-51.0,-47.0,-42.0,-48.0,-51.0,-49.0,-44.0,-47.0,-90.0,-93.0,-90.0,-93.0,39.0,46.0,48.0,45.0,0
4718,CC:2F:71:3F:1F:24,4450383,1179416230,626459,697127245,3823924,482288985,37,515900,562750728,515278,562675856,622,74872,498219,10,626696,58331,34,449,130000.0,43333.0,-67.0,-65.0,-71.0,-67.0,-67.0,-65.0,-70.0,-67.0,-90.0,-93.0,-90.0,-93.0,23.0,28.0,19.0,26.0,0
4719,CC:2F:71:3E:C5:1F,3824675,482380794,751,91809,3823924,482288985,0,3148,264353,2598,199009,550,65344,795,8,1082,18,0,34,144444.0,39000.0,-70.0,-71.0,-67.0,-60.0,-70.0,-71.0,-67.0,-60.0,-90.0,-93.0,-90.0,-93.0,20.0,22.0,23.0,33.0,0
4720,BA:8C:B9:54:50:24,3828639,488438644,4715,6149659,3823924,482288985,0,8272,1644042,8250,1640547,22,3495,2320,14,5090,36,0,53,216660.0,130000.0,-39.0,-36.0,-44.0,-52.0,-42.0,-35.0,-43.0,-48.0,-90.0,-93.0,-90.0,-93.0,51.0,57.0,46.0,41.0,0
4721,92:69:1D:31:68:E9,3827571,485798318,3642,3508869,3823929,482289449,0,4002,993996,3889,968676,113,25320,1930,6,3768,79,0,34,229410.0,130000.0,-51.0,-50.0,-44.0,-49.0,-51.0,-49.0,-44.0,-48.0,-90.0,-93.0,-90.0,-93.0,39.0,43.0,46.0,44.0,0
4722,CC:2F:71:3F:1F:24,4450430,1179431178,626501,697141729,3823929,482289449,37,515925,562755532,515303,562680660,622,74872,498244,10,626738,58344,34,449,130000.0,39000.0,-67.0,-65.0,-70.0,-68.0,-67.0,-65.0,-70.0,-67.0,-90.0,-93.0,-90.0,-93.0,23.0,28.0,20.0,25.0,0
4723,CC:2F:71:3E:C5:1F,3824680,482381258,751,91809,3823929,482289449,0,3148,264353,2598,199009,550,65344,795,8,1082,18,0,34,144444.0,39000.0,-70.0,-71.0,-67.0,-60.0,-70.0,-71.0,-67.0,-60.0,-90.0,-93.0,-90.0,-93.0,20.0,22.0,23.0,33.0,0
4724,BA:8C:B9:54:50:24,3828644,488439108,4715,6149659,3823929,482289449,0,8272,1644042,8250,1640547,22,3495,2320,14,5090,36,0,53,216660.0,130000.0,-39.0,-36.0,-44.0,-52.0,-42.0,-35.0,-43.0,-48.0,-90.0,-93.0,-90.0,-93.0,51.0,57.0,46.0,41.0,0
4725,92:69:1D:31:68:E9,3827575,485798722,3642,3508869,3823933,482289853,0,4002,993996,3889,968676,113,25320,1930,6,3768,79,0,34,229410.0,130000.0,-51.0,-50.0,-44.0,-49.0,-51.0,-49.0,-44.0,-48.0,-90.0,-93.0,-90.0,-93.0,39.0,43.0,46.0,44.0,0
4726,CC:2F:71:3F:1F:24,4450476,1179446010,626543,697156157,3823933,482289853,37,515950,562760336,515328,562685464,622,74872,498269,10,626780,58365,34,449,130000.0,39000.0,-67.0,-65.0,-70.0,-68.0,-67.0,-65.0,-70.0,-67.0,-90.0,-93.0,-90.0,-93.0,23.0,28.0,20.0,25.0,0
4727,CC:2F:71:3E:C5:1F,3824684,482381662,751,91809,3823933,482289853,0,3148,264353,2598,199009,550,65344,795,8,1082,18,0,34,144444.0,39000.0,-70.0,-71.0,-67.0,-60.0,-70.0,-71.0,-67.0,-60.0,-90.0,-93.0,-90.0,-93.0,20.0,22.0,23.0,33.0,0
4728,BA:8C:B9:54:50:24,3828648,488439512,4715,6149659,3823933,482289853,0,8272,1644042,8250,1640547,22,3495,2320,14,5090,36,0,53,216660.0,130000.0,-39.0,-36.0,-44.0,-52.0,-42.0,-35.0,-43.0,-48.0,-90.0,-93.0,-90.0,-93.0,51.0,57.0,46.0,41.0,0
4729,92:69:1D:31:68:E9,3827580,485799186,3642,3508869,3823938,482290317,0,4002,993996,3889,968676,113,25320,1930,6,3768,79,0,34,229410.0,130000.0,-51.0,-50.0,-44.0,-49.0,-51.0,-49.0,-44.0,-48.0,-90.0,-93.0,-90.0,-93.0,39.0,43.0,46.0,44.0,0
4730,CC:2F:71:3F:1F:24,4450522,1179460722,626584,697170405,3823938,482290317,37,515976,562765280,515354,562690408,622,74872,498295,10,626821,58382,34,449,117000.0,39000.0,-67.0,-65.0,-70.0,-68.0,-67.0,-65.0,-70.0,-67.0,-90.0,-93.0,-90.0,-93.0,23.0,28.0,20.0,25.0,0
4731,CC:2F:71:3E:C5:1F,3824689,482382126,751,91809,3823938,482290317,0,3148,264353,2598,199009,550,65344,795,8,1082,18,0,34,144444.0,39000.0,-70.0,-71.0,-67.0,-60.0,-70.0,-71.0,-67.0,-60.0,-90.0,-93.0,-90.0,-93.0,20.0,22.0,23.0,33.0,0
4732,BA:8C:B9:54:50:24,3828653,488439976,4715,6149659,3823938,482290317,0,8272,1644042,8250,1640547,22,3495,2320,14,5090,36,0,53,216660.0,130000.0,-39.0,-36.0,-44.0,-52.0,-42.0,-35.0,-43.0,-48.0,-90.0,-93.0,-90.0,-93.0,51.0,57.0,46.0,41.0,0
4733,92:69:1D:31:68:E9,3827585,485799706,3643,3508985,3823942,482290721,0,4004,994132,3891,968812,113,25320,1930,6,3769,79,0,34,229410.0,137640.0,-51.0,-51.0,-45.0,-47.0,-51.0,-49.0,-44.0,-48.0,-90.0,-93.0,-90.0,-93.0,39.0,42.0,45.0,46.0,0
4734,CC:2F:71:3F:1F:24,4450568,1179475540,626626,697184819,3823942,482290721,37,516001,562770112,515379,562695240,622,74872,498320,10,626863,58389,34,449,130000.0,43333.0,-67.0,-65.0,-70.0,-67.0,-67.0,-65.0,-70.0,-67.0,-90.0,-93.0,-90.0,-93.0,23.0,28.0,20.0,26.0,0
4735,CC:2F:71:3E:C5:1F,3824694,482382646,752,91925,3823942,482290721,0,3150,264493,2600,199149,550,65344,795,8,1083,18,0,34,144444.0,39000.0,-78.0,-85.0,-75.0,-71.0,-71.0,-72.0,-68.0,-61.0,-90.0,-93.0,-90.0,-93.0,12.0,8.0,15.0,22.0,0
4736,BA:8C:B9:54:50:24,3828658,488440440,4716,6149719,3823942,482290721,0,8274,1644178,8252,1640683,22,3495,2320,14,5091,36,0,53,216660.0,130000.0,-39.0,-36.0,-45.0,-52.0,-42.0,-36.0,-44.0,-49.0,-90.0,-93.0,-90.0,-93.0,51.0,57.0,45.0,41.0,0
4737,92:69:1D:31:68:E9,3827590,485800383,3643,3508985,3823947,482291398,0,4004,994132,3891,968812,113,25320,1930,6,3769,79,0,34,229410.0,137640.0,-51.0,-51.0,-45.0,-47.0,-51.0,-49.0,-44.0,-48.0,-90.0,-93.0,-90.0,-93.0,39.0,42.0,45.0,46.0,0
4738,CC:2F:71:3F:1F:24,4450616,1179490769,626669,697199371,3823947,482291398,37,516028,562775196,515406,562700324,622,74872,498347,10,626906,58417,34,449,144444.0,39000.0,-67.0,-65.0,-71.0,-68.0,-67.0,-65.0,-70.0,-67.0,-90.0,-93.0,-90.0,-93.0,23.0,28.0,19.0,25.0,0
4739,CC:2F:71:3E:C5:1F,3824699,482383323,752,91925,3823947,482291398,0,3150,264493,2600,199149,550,65344,795,8,1083,18,0,34,144444.0,39000.0,-78.0,-85.0,-75.0,-71.0,-71.0,-72.0,-68.0,-61.0,-90.0,-93.0,-90.0,-93.0,12.0,8.0,15.0,22.0,0
4740,BA:8C:B9:54:50:24,3828663,488441117,4716,6149719,3823947,482291398,0,8274,1644178,8252,1640683,22,3495,2320,14,5091,36,0,53,216660.0,130000.0,-39.0,-36.0,-45.0,-52.0,-42.0,-36.0,-44.0,-49.0,-90.0,-93.0,-90.0,-93.0,51.0,57.0,45.0,41.0,0
4741,92:69:1D:31:68:E9,3827595,485800847,3643,3508985,3823952,482291862,0,4004,994132,3891,968812,113,25320,1930,6,3769,79,0,34,229410.0,137640.0,-51.0,-51.0,-45.0,-47.0,-51.0,-49.0,-44.0,-48.0,-90.0,-93.0,-90.0,-93.0,39.0,42.0,45.0,46.0,0
4742,CC:2F:71:3F:1F:24,4450664,1179505791,626712,697213929,3823952,482291862,37,516055,562780292,515433,562705420,622,74872,498374,10,626949,58450,34,449,130000.0,43333.0,-67.0,-65.0,-70.0,-67.0,-67.0,-65.0,-70.0,-67.0,-90.0,-93.0,-90.0,-93.0,23.0,28.0,20.0,26.0,0
4743,CC:2F:71:3E:C5:1F,3824704,482383787,752,91925,3823952,482291862,0,3150,264493,2600,199149,550,65344,795,8,1083,18,0,34,144444.0,39000.0,-78.0,-85.0,-75.0,-71.0,-71.0,-72.0,-68.0,-61.0,-90.0,-93.0,-90.0,-93.0,12.0,8.0,15.0,22.0,0
4744,BA:8C:B9:54:50:24,3828668,488441581,4716,6149719,3823952,482291862,0,8274,1644178,8252,1640683,22,3495,2320,14,5091,36,0,53,216660.0,130000.0,-39.0,-36.0,-45.0,-52.0,-42.0,-36.0,-44.0,-49.0,-90.0,-93.0,-90.0,-93.0,51.0,57.0,45.0,41.0,0
4745,92:69:1D:31:68:E9,3827599,485801251,3643,3508985,3823956,482292266,0,4004,994132,3891,968812,113,25320,1930,6,3769,79,0,34,229410.0,137640.0,-51.0,-51.0,-45.0,-47.0,-51.0,-49.0,-44.0,-48.0,-90.0,-93.0,-90.0,-93.0,39.0,42.0,45.0,46.0,0
4746,CC:2F:71:3F:1F:24,4450711,1179520865,626755,697228599,3823956,482292266,37,516082,562785388,515460,562710516,622,74872,498401,10,626992,58454,34,449,130000.0,43333.0,-67.0,-65.0,-70.0,-68.0,-67.0,-65.0,-70.0,-67.0,-90.0,-93.0,-90.0,-93.0,23.0,28.0,20.0,25.0,0
4747,CC:2F:71:3E:C5:1F,3824708,482384191,752,91925,3823956,482292266,0,3150,264493,2600,199149,550,65344,795,8,1083,18,0,34,144444.0,39000.0,-78.0,-85.0,-75.0,-71.0,-71.0,-72.0,-68.0,-61.0,-90.0,-93.0,-90.0,-93.0,12.0,8.0,15.0,22.0,0
4748,BA:8C:B9:54:50:24,3828672,488441985,4716,6149719,3823956,482292266,0,8274,1644178,8252,1640683,22,3495,2320,14,5091,36,0,53,216660.0,130000.0,-39.0,-36.0,-45.0,-52.0,-42.0,-36.0,-44.0,-49.0,-90.0,-93.0,-90.0,-93.0,51.0,57.0,45.0,41.0,0
4749,92:69:1D:31:68:E9,3827605,485802023,3643,3508985,3823962,482293038,0,4004,994132,3891,968812,113,25320,1930,6,3769,79,0,34,229410.0,137640.0,-51.0,-51.0,-45.0,-47.0,-51.0,-49.0,-44.0,-48.0,-90.0,-93.0,-90.0,-93.0,39.0,42.0,45.0,46.0,0
4750,CC:2F:71:3F:1F:24,4450760,1179536251,626798,697243213,3823962,482293038,37,516108,562790368,515486,562715496,622,74872,498427,10,627035,58473,34,449,130000.0,39000.0,-67.0,-65.0,-71.0,-68.0,-67.0,-65.0,-70.0,-67.0,-90.0,-93.0,-90.0,-93.0,23.0,28.0,19.0,25.0,0
4751,CC:2F:71:3E:C5:1F,3824714,482384963,752,91925,3823962,482293038,0,3150,264493,2600,199149,550,65344,795,8,1083,18,0,34,144444.0,39000.0,-78.0,-85.0,-75.0,-71.0,-71.0,-72.0,-68.0,-61.0,-90.0,-93.0,-90.0,-93.0,12.0,8.0,15.0,22.0,0
4752,BA:8C:B9:54:50:24,3828679,488442817,4716,6149719,3823963,482293098,0,8274,1644178,8252,1640683,22,3495,2320,14,5091,36,0,53,216660.0,130000.0,-39.0,-36.0,-45.0,-52.0,-42.0,-36.0,-44.0,-49.0,-90.0,-93.0,-90.0,-93.0,51.0,57.0,45.0,41.0,0
4753,92:69:1D:31:68:E9,3827610,485802487,3643,3508985,3823967,482293502,0,4004,994132,3891,968812,113,25320,1930,6,3769,79,0,34,229410.0,137640.0,-51.0,-51.0,-45.0,-47.0,-51.0,-49.0,-44.0,-48.0,-90.0,-93.0,-90.0,-93.0,39.0,42.0,45.0,46.0,0
4754,CC:2F:71:3F:1F:24,4450809,1179551397,626842,697257895,3823967,482293502,37,516135,562795452,515513,562720580,622,74872,498454,10,627079,58488,34,449,130000.0,43333.0,-67.0,-65.0,-70.0,-67.0,-67.0,-65.0,-70.0,-67.0,-90.0,-93.0,-90.0,-93.0,23.0,28.0,20.0,26.0,0
4755,CC:2F:71:3E:C5:1F,3824719,482385427,752,91925,3823967,482293502,0,3150,264493,2600,199149,550,65344,795,8,1083,18,0,34,144444.0,39000.0,-78.0,-85.0,-75.0,-71.0,-71.0,-72.0,-68.0,-61.0,-90.0,-93.0,-90.0,-93.0,12.0,8.0,15.0,22.0,0
4756,BA:8C:B9:54:50:24,3828683,488443221,4716,6149719,3823967,482293502,0,8274,1644178,8252,1640683,22,3495,2320,14,5091,36,0,53,216660.0,130000.0,-39.0,-36.0,-45.0,-52.0,-42.0,-36.0,-44.0,-49.0,-90.0,-93.0,-90.0,-93.0,51.0,57.0,45.0,41.0,0
4757,92:69:1D:31:68:E9,3827614,485802891,3643,3508985,3823971,482293906,0,4004,994132,3891,968812,113,25320,1930,6,3769,79,0,34,229410.0,137640.0,-51.0,-51.0,-45.0,-47.0,-51.0,-49.0,-44.0,-48.0,-90.0,-93.0,-90.0,-93.0,39.0,42.0,45.0,46.0,0
4758,CC:2F:71:3F:1F:24,4450854,1179566161,626883,697272255,3823971,482293906,37,516161,562800396,515539,562725524,622,74872,498480,10,627120,58491,34,449,130000.0,43333.0,-67.0,-65.0,-70.0,-67.0,-67.0,-65.0,-70.0,-67.0,-90.0,-93.0,-90.0,-93.0,23.0,28.0,20.0,26.0,0
4759,CC:2F:71:3E:C5:1F,3824723,482385831,752,91925,3823971,482293906,0,3150,264493,2600,199149,550,65344,795,8,1083,18,0,34,144444.0,39000.0,-78.0,-85.0,-75.0,-71.0,-71.0,-72.0,-68.0,-61.0,-90.0,-93.0,-90.0,-93.0,12.0,8.0,15.0,22.0,0
4760,BA:8C:B9:54:50:24,3828687,488443625,4716,6149719,3823971,482293906,0,8274,1644178,8252,1640683,22,3495,2320,14,5091,36,0,53,216660.0,130000.0,-39.0,-36.0,-45.0,-52.0,-42.0,-36.0,-44.0,-49.0,-90.0,-93.0,-90.0,-93.0,51.0,57.0,45.0,41.0,0
4761,92:69:1D:31:68:E9,3827619,485803355,3643,3508985,3823976,482294370,0,4004,994132,3891,968812,113,25320,1930,6,3769,79,0,34,229410.0,137640.0,-51.0,-51.0,-45.0,-47.0,-51.0,-49.0,-44.0,-48.0,-90.0,-93.0,-90.0,-93.0,39.0,42.0,45.0,46.0,0
4762,CC:2F:71:3F:1F:24,4450901,1179581053,626925,697286683,3823976,482294370,37,516188,562805456,515566,562730584,622,74872,498507,10,627162,58508,34,449,117000.0,39000.0,-67.0,-65.0,-70.0,-68.0,-67.0,-65.0,-70.0,-67.0,-90.0,-93.0,-90.0,-93.0,23.0,28.0,20.0,25.0,0
4763,CC:2F:71:3E:C5:1F,3824728,482386295,752,91925,3823976,482294370,0,3150,264493,2600,199149,550,65344,795,8,1083,18,0,34,144444.0,39000.0,-78.0,-85.0,-75.0,-71.0,-71.0,-72.0,-68.0,-61.0,-90.0,-93.0,-90.0,-93.0,12.0,8.0,15.0,22.0,0
4764,BA:8C:B9:54:50:24,3828692,488444089,4716,6149719,3823976,482294370,0,8274,1644178,8252,1640683,22,3495,2320,14,5091,36,0,53,216660.0,130000.0,-39.0,-36.0,-45.0,-52.0,-42.0,-36.0,-44.0,-49.0,-90.0,-93.0,-90.0,-93.0,51.0,57.0,45.0,41.0,0
4765,92:69:1D:31:68:E9,3827624,485803821,3643,3508985,3823981,482294836,0,4004,994132,3891,968812,113,25320,1930,6,3769,79,0,34,229410.0,137640.0,-51.0,-51.0,-45.0,-47.0,-51.0,-49.0,-44.0,-48.0,-90.0,-93.0,-90.0,-93.0,39.0,42.0,45.0,46.0,0
4766,CC:2F:71:3F:1F:24,4450947,1179595823,626966,697300987,3823981,482294836,37,516217,562810774,515594,562735784,623,74990,498536,10,627203,58516,34,449,130000.0,43333.0,-67.0,-65.0,-70.0,-67.0,-67.0,-65.0,-70.0,-67.0,-90.0,-93.0,-90.0,-93.0,23.0,28.0,20.0,26.0,0
4767,CC:2F:71:3E:C5:1F,3824733,482386761,752,91925,3823981,482294836,0,3150,264493,2600,199149,550,65344,795,8,1083,18,0,34,144444.0,39000.0,-78.0,-85.0,-75.0,-71.0,-71.0,-72.0,-68.0,-61.0,-90.0,-93.0,-90.0,-93.0,12.0,8.0,15.0,22.0,0
4768,BA:8C:B9:54:50:24,3828697,488444555,4716,6149719,3823981,482294836,0,8274,1644178,8252,1640683,22,3495,2320,14,5091,36,0,53,216660.0,130000.0,-39.0,-36.0,-45.0,-52.0,-42.0,-36.0,-44.0,-49.0,-90.0,-93.0,-90.0,-93.0,51.0,57.0,45.0,41.0,0
4769,92:69:1D:31:68:E9,3827627,485804085,3643,3508985,3823984,482295100,0,4004,994132,3891,968812,113,25320,1930,6,3769,79,0,34,229410.0,137640.0,-51.0,-51.0,-45.0,-47.0,-51.0,-49.0,-44.0,-48.0,-90.0,-93.0,-90.0,-93.0,39.0,42.0,45.0,46.0,0
4770,CC:2F:71:3F:1F:24,4450995,1179610897,627009,697315595,3823986,482295302,37,516243,562815718,515620,562740728,623,74990,498562,10,627246,58518,34,449,130000.0,39000.0,-67.0,-65.0,-70.0,-68.0,-67.0,-65.0,-70.0,-67.0,-90.0,-93.0,-90.0,-93.0,23.0,28.0,20.0,25.0,0
4771,CC:2F:71:3E:C5:1F,3824738,482387227,752,91925,3823986,482295302,0,3152,264681,2601,199219,551,65462,796,8,1083,18,0,34,144444.0,39000.0,-70.0,-71.0,-67.0,-60.0,-71.0,-72.0,-68.0,-61.0,-90.0,-93.0,-90.0,-93.0,20.0,22.0,23.0,33.0,0
4772,BA:8C:B9:54:50:24,3828702,488445021,4716,6149719,3823986,482295302,0,8274,1644178,8252,1640683,22,3495,2320,14,5091,36,0,53,216660.0,130000.0,-39.0,-36.0,-45.0,-52.0,-42.0,-36.0,-44.0,-49.0,-90.0,-93.0,-90.0,-93.0,51.0,57.0,45.0,41.0,0
4773,92:69:1D:31:68:E9,3827634,485804751,3643,3508985,3823991,482295766,0,4004,994132,3891,968812,113,25320,1930,6,3769,79,0,34,229410.0,137640.0,-51.0,-51.0,-45.0,-47.0,-51.0,-49.0,-44.0,-48.0,-90.0,-93.0,-90.0,-93.0,39.0,42.0,45.0,46.0,0
4774,CC:2F:71:3F:1F:24,4451041,1179625665,627050,697329899,3823991,482295766,37,516270,562820802,515647,562745812,623,74990,498589,10,627287,58537,34,449,130000.0,39000.0,-67.0,-65.0,-71.0,-67.0,-67.0,-65.0,-70.0,-67.0,-90.0,-93.0,-90.0,-93.0,23.0,28.0,19.0,26.0,0
4775,CC:2F:71:3E:C5:1F,3824743,482387691,752,91925,3823991,482295766,0,3152,264681,2601,199219,551,65462,796,8,1083,18,0,34,144444.0,39000.0,-70.0,-71.0,-67.0,-60.0,-71.0,-72.0,-68.0,-61.0,-90.0,-93.0,-90.0,-93.0,20.0,22.0,23.0,33.0,0
4776,BA:8C:B9:54:50:24,3828707,488445485,4716,6149719,3823991,482295766,0,8274,1644178,8252,1640683,22,3495,2320,14,5091,36,0,53,216660.0,130000.0,-39.0,-36.0,-45.0,-52.0,-42.0,-36.0,-44.0,-49.0,-90.0,-93.0,-90.0,-93.0,51.0,57.0,45.0,41.0,0
4777,92:69:1D:31:68:E9,3827636,485804953,3643,3508985,3823993,482295968,0,4006,994268,3893,968948,113,25320,1930,6,3769,79,0,34,229410.0,137640.0,-50.0,-45.0,-43.0,-48.0,-50.0,-48.0,-43.0,-47.0,-90.0,-93.0,-90.0,-93.0,40.0,48.0,47.0,45.0,0
4778,CC:2F:71:3F:1F:24,4451087,1179640441,627092,697344271,3823995,482296170,37,516295,562825606,515672,562750616,623,74990,498614,10,627329,58547,34,449,117000.0,39000.0,-67.0,-65.0,-71.0,-68.0,-67.0,-65.0,-70.0,-67.0,-90.0,-93.0,-90.0,-93.0,23.0,28.0,19.0,25.0,0
4779,CC:2F:71:3E:C5:1F,3824747,482388095,752,91925,3823995,482296170,0,3152,264681,2601,199219,551,65462,796,8,1083,18,0,34,144444.0,39000.0,-70.0,-71.0,-67.0,-60.0,-71.0,-72.0,-68.0,-61.0,-90.0,-93.0,-90.0,-93.0,20.0,22.0,23.0,33.0,0
4780,BA:8C:B9:54:50:24,3828711,488445889,4716,6149719,3823995,482296170,0,8274,1644178,8252,1640683,22,3495,2320,14,5091,36,0,53,216660.0,130000.0,-39.0,-36.0,-45.0,-52.0,-42.0,-36.0,-44.0,-49.0,-90.0,-93.0,-90.0,-93.0,51.0,57.0,45.0,41.0,0
4781,92:69:1D:31:68:E9,3827642,485805559,3643,3508985,3823999,482296574,0,4007,994336,3894,969016,113,25320,1930,6,3769,79,0,34,229410.0,137640.0,-51.0,-50.0,-45.0,-46.0,-50.0,-48.0,-43.0,-47.0,-90.0,-93.0,-90.0,-93.0,39.0,43.0,45.0,47.0,0
4782,CC:2F:71:3F:1F:24,4451133,1179655273,627134,697358699,3823999,482296574,37,516320,562830410,515697,562755420,623,74990,498639,10,627371,58555,34,449,130000.0,43333.0,-67.0,-65.0,-70.0,-67.0,-67.0,-65.0,-70.0,-67.0,-90.0,-93.0,-90.0,-93.0,23.0,28.0,20.0,26.0,0
4783,CC:2F:71:3E:C5:1F,3824752,482388559,752,91925,3824000,482296634,0,3152,264681,2601,199219,551,65462,796,8,1083,18,0,34,144444.0,39000.0,-70.0,-71.0,-67.0,-60.0,-71.0,-72.0,-68.0,-61.0,-90.0,-93.0,-90.0,-93.0,20.0,22.0,23.0,33.0,0
4784,BA:8C:B9:54:50:24,3828716,488446353,4716,6149719,3824000,482296634,0,8274,1644178,8252,1640683,22,3495,2320,14,5091,36,0,53,216660.0,130000.0,-39.0,-36.0,-45.0,-52.0,-42.0,-36.0,-44.0,-49.0,-90.0,-93.0,-90.0,-93.0,51.0,57.0,45.0,41.0,0
4785,92:69:1D:31:68:E9,3827645,485805821,3643,3508985,3824002,482296836,0,4007,994336,3894,969016,113,25320,1930,6,3769,79,0,34,229410.0,137640.0,-51.0,-50.0,-45.0,-46.0,-50.0,-48.0,-43.0,-47.0,-90.0,-93.0,-90.0,-93.0,39.0,43.0,45.0,47.0,0
4786,CC:2F:71:3F:1F:24,4451181,1179670351,627177,697373313,3824004,482297038,37,516345,562835214,515722,562760224,623,74990,498664,10,627414,58560,34,449,130000.0,39000.0,-67.0,-65.0,-70.0,-67.0,-67.0,-65.0,-70.0,-67.0,-90.0,-93.0,-90.0,-93.0,23.0,28.0,20.0,26.0,0
4787,CC:2F:71:3E:C5:1F,3824756,482388963,752,91925,3824004,482297038,0,3152,264681,2601,199219,551,65462,796,8,1083,18,0,34,144444.0,39000.0,-70.0,-71.0,-67.0,-60.0,-71.0,-72.0,-68.0,-61.0,-90.0,-93.0,-90.0,-93.0,20.0,22.0,23.0,33.0,0
4788,BA:8C:B9:54:50:24,3828720,488446757,4716,6149719,3824004,482297038,0,8274,1644178,8252,1640683,22,3495,2320,14,5091,36,0,53,216660.0,130000.0,-39.0,-36.0,-45.0,-52.0,-42.0,-36.0,-44.0,-49.0,-90.0,-93.0,-90.0,-93.0,51.0,57.0,45.0,41.0,0
4789,92:69:1D:31:68:E9,3827652,485806700,3643,3508985,3824009,482297715,0,4007,994336,3894,969016,113,25320,1930,6,3769,79,0,34,229410.0,137640.0,-51.0,-50.0,-45.0,-46.0,-50.0,-48.0,-43.0,-47.0,-90.0,-93.0,-90.0,-93.0,39.0,43.0,45.0,47.0,0
4790,CC:2F:71:3F:1F:24,4451228,1179685518,627219,697387803,3824009,482297715,37,516371,562840158,515748,562765168,623,74990,498690,10,627456,58586,34,449,117000.0,39000.0,-67.0,-65.0,-70.0,-67.0,-67.0,-65.0,-70.0,-67.0,-90.0,-93.0,-90.0,-93.0,23.0,28.0,20.0,26.0,0
4791,CC:2F:71:3E:C5:1F,3824761,482389640,752,91925,3824009,482297715,0,3152,264681,2601,199219,551,65462,796,8,1083,18,0,34,144444.0,39000.0,-70.0,-71.0,-67.0,-60.0,-71.0,-72.0,-68.0,-61.0,-90.0,-93.0,-90.0,-93.0,20.0,22.0,23.0,33.0,0
4792,BA:8C:B9:54:50:24,3828725,488447434,4716,6149719,3824009,482297715,0,8274,1644178,8252,1640683,22,3495,2320,14,5091,36,0,53,216660.0,130000.0,-39.0,-36.0,-45.0,-52.0,-42.0,-36.0,-44.0,-49.0,-90.0,-93.0,-90.0,-93.0,51.0,57.0,45.0,41.0,0
4793,92:69:1D:31:68:E9,3827655,485806962,3643,3508985,3824012,482297977,0,4007,994336,3894,969016,113,25320,1930,6,3769,79,0,34,229410.0,137640.0,-51.0,-50.0,-45.0,-46.0,-50.0,-48.0,-43.0,-47.0,-90.0,-93.0,-90.0,-93.0,39.0,43.0,45.0,47.0,0
4794,CC:2F:71:3F:1F:24,4451275,1179700404,627261,697402225,3824014,482298179,37,516398,562845218,515775,562770228,623,74990,498717,10,627498,58593,34,449,130000.0,43333.0,-67.0,-65.0,-70.0,-67.0,-67.0,-65.0,-70.0,-67.0,-90.0,-93.0,-90.0,-93.0,23.0,28.0,20.0,26.0,0
4795,CC:2F:71:3E:C5:1F,3824766,482390104,752,91925,3824014,482298179,0,3152,264681,2601,199219,551,65462,796,8,1083,18,0,34,144444.0,39000.0,-70.0,-71.0,-67.0,-60.0,-71.0,-72.0,-68.0,-61.0,-90.0,-93.0,-90.0,-93.0,20.0,22.0,23.0,33.0,0
4796,BA:8C:B9:54:50:24,3828730,488447898,4716,6149719,3824014,482298179,0,8275,1644246,8253,1640751,22,3495,2320,14,5091,36,0,53,216660.0,130000.0,-39.0,-36.0,-44.0,-51.0,-42.0,-36.0,-43.0,-49.0,-90.0,-93.0,-90.0,-93.0,51.0,57.0,46.0,42.0,0
4797,92:69:1D:31:68:E9,3827661,485807568,3643,3508985,3824018,482298583,0,4007,994336,3894,969016,113,25320,1930,6,3769,79,0,34,229410.0,137640.0,-51.0,-50.0,-45.0,-46.0,-50.0,-48.0,-43.0,-47.0,-90.0,-93.0,-90.0,-93.0,39.0,43.0,45.0,47.0,0
4798,CC:2F:71:3F:1F:24,4451321,1179715292,627303,697416709,3824018,482298583,37,516424,562850162,515801,562775172,623,74990,498743,10,627540,58613,34,449,130000.0,39000.0,-67.0,-65.0,-70.0,-68.0,-67.0,-65.0,-70.0,-67.0,-90.0,-93.0,-90.0,-93.0,23.0,28.0,20.0,25.0,0
4799,CC:2F:71:3E:C5:1F,3824770,482390508,752,91925,3824018,482298583,0,3152,264681,2601,199219,551,65462,796,8,1083,18,0,34,144444.0,39000.0,-70.0,-71.0,-67.0,-60.0,-71.0,-72.0,-68.0,-61.0,-90.0,-93.0,-90.0,-93.0,20.0,22.0,23.0,33.0,0
4800,BA:8C:B9:54:50:24,3828734,488448302,4716,6149719,3824018,482298583,0,8275,1644246,8253,1640751,22,3495,2320,14,5091,36,0,53,216660.0,130000.0,-39.0,-36.0,-44.0,-51.0,-42.0,-36.0,-43.0,-49.0,-90.0,-93.0,-90.0,-93.0,51.0,57.0,46.0,42.0,0
4801,92:69:1D:31:68:E9,3827663,485807770,3643,3508985,3824020,482298785,0,4007,994336,3894,969016,113,25320,1930,6,3769,79,0,34,229410.0,137640.0,-51.0,-50.0,-45.0,-46.0,-50.0,-48.0,-43.0,-47.0,-90.0,-93.0,-90.0,-93.0,39.0,43.0,45.0,47.0,0
4802,CC:2F:71:3F:1F:24,4451368,1179730248,627346,697431261,3824022,482298987,37,516450,562855142,515827,562780152,623,74990,498769,10,627583,58625,34,449,130000.0,39000.0,-67.0,-65.0,-71.0,-67.0,-67.0,-65.0,-70.0,-67.0,-90.0,-93.0,-90.0,-93.0,23.0,28.0,19.0,26.0,0
4803,CC:2F:71:3E:C5:1F,3824774,482390912,752,91925,3824022,482298987,0,3152,264681,2601,199219,551,65462,796,8,1083,18,0,34,144444.0,39000.0,-70.0,-71.0,-67.0,-60.0,-71.0,-72.0,-68.0,-61.0,-90.0,-93.0,-90.0,-93.0,20.0,22.0,23.0,33.0,0
4804,BA:8C:B9:54:50:24,3828738,488448706,4716,6149719,3824022,482298987,0,8275,1644246,8253,1640751,22,3495,2320,14,5091,36,0,53,216660.0,130000.0,-39.0,-36.0,-44.0,-51.0,-42.0,-36.0,-43.0,-49.0,-90.0,-93.0,-90.0,-93.0,51.0,57.0,46.0,42.0,0
4805,92:69:1D:31:68:E9,3827670,485808436,3643,3508985,3824027,482299451,0,4007,994336,3894,969016,113,25320,1930,6,3769,79,0,34,229410.0,137640.0,-51.0,-50.0,-45.0,-46.0,-50.0,-48.0,-43.0,-47.0,-90.0,-93.0,-90.0,-93.0,39.0,43.0,45.0,47.0,0
4806,CC:2F:71:3F:1F:24,4451414,1179745072,627387,697445621,3824027,482299451,37,516476,562860062,515853,562785072,623,74990,498795,10,627624,58628,34,449,130000.0,43333.0,-67.0,-65.0,-70.0,-67.0,-67.0,-65.0,-70.0,-67.0,-90.0,-93.0,-90.0,-93.0,23.0,28.0,20.0,26.0,0
4807,CC:2F:71:3E:C5:1F,3824779,482391376,752,91925,3824027,482299451,0,3152,264681,2601,199219,551,65462,796,8,1083,18,0,34,144444.0,39000.0,-70.0,-71.0,-67.0,-60.0,-71.0,-72.0,-68.0,-61.0,-90.0,-93.0,-90.0,-93.0,20.0,22.0,23.0,33.0,0
4808,BA:8C:B9:54:50:24,3828743,488449170,4716,6149719,3824027,482299451,0,8275,1644246,8253,1640751,22,3495,2320,14,5091,36,0,53,216660.0,130000.0,-39.0,-36.0,-44.0,-51.0,-42.0,-36.0,-43.0,-49.0,-90.0,-93.0,-90.0,-93.0,51.0,57.0,46.0,42.0,0
4809,92:69:1D:31:68:E9,3827672,485808638,3643,3508985,3824029,482299653,0,4007,994336,3894,969016,113,25320,1930,6,3769,79,0,34,229410.0,137640.0,-51.0,-50.0,-45.0,-46.0,-50.0,-48.0,-43.0,-47.0,-90.0,-93.0,-90.0,-93.0,39.0,43.0,45.0,47.0,0
4810,CC:2F:71:3F:1F:24,4451461,1179760084,627430,697460229,3824031,482299855,37,516501,562864866,515878,562789876,623,74990,498820,10,627667,58649,34,449,130000.0,39000.0,-67.0,-65.0,-70.0,-68.0,-67.0,-65.0,-70.0,-67.0,-90.0,-93.0,-90.0,-93.0,23.0,28.0,20.0,25.0,0
4811,CC:2F:71:3E:C5:1F,3824783,482391780,752,91925,3824031,482299855,0,3152,264681,2601,199219,551,65462,796,8,1083,18,0,34,144444.0,39000.0,-70.0,-71.0,-67.0,-60.0,-71.0,-72.0,-68.0,-61.0,-90.0,-93.0,-90.0,-93.0,20.0,22.0,23.0,33.0,0
4812,BA:8C:B9:54:50:24,3828747,488449574,4716,6149719,3824031,482299855,0,8275,1644246,8253,1640751,22,3495,2320,14,5091,36,0,53,216660.0,130000.0,-39.0,-36.0,-44.0,-51.0,-42.0,-36.0,-43.0,-49.0,-90.0,-93.0,-90.0,-93.0,51.0,57.0,46.0,42.0,0
4813,92:69:1D:31:68:E9,3827679,485809304,3643,3508985,3824036,482300319,0,4007,994336,3894,969016,113,25320,1930,6,3769,79,0,34,229410.0,137640.0,-51.0,-50.0,-45.0,-46.0,-50.0,-48.0,-43.0,-47.0,-90.0,-93.0,-90.0,-93.0,39.0,43.0,45.0,47.0,0
4814,CC:2F:71:3F:1F:24,4451507,1179774790,627471,697474471,3824036,482300319,37,516527,562869810,515904,562794820,623,74990,498846,10,627708,58671,34,449,130000.0,43333.0,-67.0,-65.0,-70.0,-67.0,-67.0,-65.0,-70.0,-67.0,-90.0,-93.0,-90.0,-93.0,23.0,28.0,20.0,26.0,0
4815,CC:2F:71:3E:C5:1F,3824788,482392244,752,91925,3824036,482300319,0,3152,264681,2601,199219,551,65462,796,8,1083,18,0,34,144444.0,39000.0,-70.0,-71.0,-67.0,-60.0,-71.0,-72.0,-68.0,-61.0,-90.0,-93.0,-90.0,-93.0,20.0,22.0,23.0,33.0,0
4816,BA:8C:B9:54:50:24,3828752,488450038,4716,6149719,3824036,482300319,0,8275,1644246,8253,1640751,22,3495,2320,14,5091,36,0,53,216660.0,130000.0,-39.0,-36.0,-44.0,-51.0,-42.0,-36.0,-43.0,-49.0,-90.0,-93.0,-90.0,-93.0,51.0,57.0,46.0,42.0,0
4817,92:69:1D:31:68:E9,3827679,485809304,3643,3508985,3824036,482300319,0,4007,994336,3894,969016,113,25320,1930,6,3769,79,0,34,229410.0,137640.0,-51.0,-50.0,-45.0,-46.0,-50.0,-48.0,-43.0,-47.0,-90.0,-93.0,-90.0,-93.0,39.0,43.0,45.0,47.0,0
4818,CC:2F:71:3F:1F:24,4451554,1179789746,627514,697489023,3824040,482300723,37,516555,562875010,515932,562800020,623,74990,498874,10,627751,58688,34,449,117000.0,39000.0,-67.0,-65.0,-70.0,-67.0,-67.0,-65.0,-70.0,-67.0,-90.0,-93.0,-90.0,-93.0,23.0,28.0,20.0,26.0,0
4819,CC:2F:71:3E:C5:1F,3824792,482392648,752,91925,3824040,482300723,0,3152,264681,2601,199219,551,65462,796,8,1083,18,0,34,144444.0,39000.0,-70.0,-71.0,-67.0,-60.0,-71.0,-72.0,-68.0,-61.0,-90.0,-93.0,-90.0,-93.0,20.0,22.0,23.0,33.0,0
4820,BA:8C:B9:54:50:24,3828756,488450442,4716,6149719,3824040,482300723,0,8275,1644246,8253,1640751,22,3495,2320,14,5091,36,0,53,216660.0,130000.0,-39.0,-36.0,-44.0,-51.0,-42.0,-36.0,-43.0,-49.0,-90.0,-93.0,-90.0,-93.0,51.0,57.0,46.0,42.0,0
4821,92:69:1D:31:68:E9,3827687,485810112,3643,3508985,3824044,482301127,0,4007,994336,3894,969016,113,25320,1930,6,3769,79,0,34,229410.0,137640.0,-51.0,-50.0,-45.0,-46.0,-50.0,-48.0,-43.0,-47.0,-90.0,-93.0,-90.0,-93.0,39.0,43.0,45.0,47.0,0
4822,CC:2F:71:3F:1F:24,4451602,1179804832,627558,697503705,3824044,482301127,37,516580,562879814,515957,562804824,623,74990,498899,10,627795,58689,34,449,130000.0,43333.0,-67.0,-65.0,-70.0,-67.0,-67.0,-65.0,-70.0,-67.0,-90.0,-93.0,-90.0,-93.0,23.0,28.0,20.0,26.0,0
4823,CC:2F:71:3E:C5:1F,3824796,482393052,752,91925,3824044,482301127,0,3152,264681,2601,199219,551,65462,796,8,1083,18,0,34,144444.0,39000.0,-70.0,-71.0,-67.0,-60.0,-71.0,-72.0,-68.0,-61.0,-90.0,-93.0,-90.0,-93.0,20.0,22.0,23.0,33.0,0
4824,BA:8C:B9:54:50:24,3828760,488450846,4716,6149719,3824044,482301127,0,8275,1644246,8253,1640751,22,3495,2320,14,5091,36,0,53,216660.0,130000.0,-39.0,-36.0,-44.0,-51.0,-42.0,-36.0,-43.0,-49.0,-90.0,-93.0,-90.0,-93.0,51.0,57.0,46.0,42.0,0
4825,92:69:1D:31:68:E9,3827688,485810172,3643,3508985,3824045,482301187,0,4007,994336,3894,969016,113,25320,1930,6,3769,79,0,34,229410.0,137640.0,-51.0,-50.0,-45.0,-46.0,-50.0,-48.0,-43.0,-47.0,-90.0,-93.0,-90.0,-93.0,39.0,43.0,45.0,47.0,0
4826,CC:2F:71:3F:1F:24,4451646,1179819510,627599,697518121,3824047,482301389,37,516605,562884618,515982,562809628,623,74990,498924,10,627836,58695,34,449,130000.0,43333.0,-67.0,-65.0,-71.0,-67.0,-67.0,-65.0,-70.0,-67.0,-90.0,-93.0,-90.0,-93.0,23.0,28.0,19.0,26.0,0
4827,CC:2F:71:3E:C5:1F,3824801,482393516,752,91925,3824049,482301591,0,3152,264681,2601,199219,551,65462,796,8,1083,18,0,34,144444.0,39000.0,-70.0,-71.0,-67.0,-60.0,-71.0,-72.0,-68.0,-61.0,-90.0,-93.0,-90.0,-93.0,20.0,22.0,23.0,33.0,0
4828,BA:8C:B9:54:50:24,3828765,488451310,4716,6149719,3824049,482301591,0,8275,1644246,8253,1640751,22,3495,2320,14,5091,36,0,53,216660.0,130000.0,-39.0,-36.0,-44.0,-51.0,-42.0,-36.0,-43.0,-49.0,-90.0,-93.0,-90.0,-93.0,51.0,57.0,46.0,42.0,0
4829,92:69:1D:31:68:E9,3827696,485810980,3643,3508985,3824053,482301995,0,4007,994336,3894,969016,113,25320,1930,6,3769,79,0,34,229410.0,137640.0,-51.0,-50.0,-45.0,-46.0,-50.0,-48.0,-43.0,-47.0,-90.0,-93.0,-90.0,-93.0,39.0,43.0,45.0,47.0,0
4830,CC:2F:71:3F:1F:24,4451694,1179834600,627641,697532605,3824053,482301995,37,516630,562889422,516007,562814432,623,74990,498949,10,627878,58712,34,449,130000.0,39000.0,-67.0,-65.0,-70.0,-68.0,-67.0,-65.0,-70.0,-67.0,-90.0,-93.0,-90.0,-93.0,23.0,28.0,20.0,25.0,0
4831,CC:2F:71:3E:C5:1F,3824805,482393920,752,91925,3824053,482301995,0,3152,264681,2601,199219,551,65462,796,8,1083,18,0,34,144444.0,39000.0,-70.0,-71.0,-67.0,-60.0,-71.0,-72.0,-68.0,-61.0,-90.0,-93.0,-90.0,-93.0,20.0,22.0,23.0,33.0,0
4832,BA:8C:B9:54:50:24,3828769,488451714,4716,6149719,3824053,482301995,0,8275,1644246,8253,1640751,22,3495,2320,14,5091,36,0,53,216660.0,130000.0,-39.0,-36.0,-44.0,-51.0,-42.0,-36.0,-43.0,-49.0,-90.0,-93.0,-90.0,-93.0,51.0,57.0,46.0,42.0,0
4833,92:69:1D:31:68:E9,3827696,485810980,3643,3508985,3824053,482301995,0,4007,994336,3894,969016,113,25320,1930,6,3769,79,0,34,229410.0,137640.0,-51.0,-50.0,-45.0,-46.0,-50.0,-48.0,-43.0,-47.0,-90.0,-93.0,-90.0,-93.0,39.0,43.0,45.0,47.0,0
4834,CC:2F:71:3F:1F:24,4451736,1179849028,627683,697547033,3824053,482301995,37,516655,562894226,516032,562819236,623,74990,498974,10,627920,58723,34,449,130000.0,39000.0,-67.0,-65.0,-70.0,-67.0,-67.0,-65.0,-70.0,-67.0,-90.0,-93.0,-90.0,-93.0,23.0,28.0,20.0,26.0,0
4835,CC:2F:71:3E:C5:1F,3824809,482394324,752,91925,3824057,482302399,0,3152,264681,2601,199219,551,65462,796,8,1083,18,0,34,144444.0,39000.0,-70.0,-71.0,-67.0,-60.0,-71.0,-72.0,-68.0,-61.0,-90.0,-93.0,-90.0,-93.0,20.0,22.0,23.0,33.0,0
4836,BA:8C:B9:54:50:24,3828773,488452118,4716,6149719,3824057,482302399,0,8275,1644246,8253,1640751,22,3495,2320,14,5091,36,0,53,216660.0,130000.0,-39.0,-36.0,-44.0,-51.0,-42.0,-36.0,-43.0,-49.0,-90.0,-93.0,-90.0,-93.0,51.0,57.0,46.0,42.0,0
4837,92:69:1D:31:68:E9,3827705,485811848,3643,3508985,3824062,482302863,0,4007,994336,3894,969016,113,25320,1930,6,3769,79,0,34,229410.0,137640.0,-51.0,-50.0,-45.0,-46.0,-50.0,-48.0,-43.0,-47.0,-90.0,-93.0,-90.0,-93.0,39.0,43.0,45.0,47.0,0
4838,CC:2F:71:3F:1F:24,4451788,1179864390,627726,697561527,3824062,482302863,37,516681,562899170,516058,562824180,623,74990,499000,10,627963,58745,34,449,117000.0,39000.0,-67.0,-65.0,-70.0,-68.0,-67.0,-65.0,-70.0,-67.0,-90.0,-93.0,-90.0,-93.0,23.0,28.0,20.0,25.0,0
4839,CC:2F:71:3E:C5:1F,3824815,482394904,753,92041,3824062,482302863,0,3153,264751,2602,199289,551,65462,796,8,1084,18,0,34,144444.0,39000.0,-70.0,-71.0,-67.0,-60.0,-71.0,-72.0,-68.0,-61.0,-90.0,-93.0,-90.0,-93.0,20.0,22.0,23.0,33.0,0
4840,BA:8C:B9:54:50:24,3828779,488452698,4717,6149835,3824062,482302863,0,8277,1644382,8255,1640887,22,3495,2320,14,5092,36,0,53,216660.0,130000.0,-46.0,-35.0,-40.0,-43.0,-43.0,-35.0,-42.0,-47.0,-90.0,-93.0,-90.0,-93.0,44.0,58.0,50.0,50.0,0
4841,92:69:1D:31:68:E9,3827706,485811908,3644,3509045,3824062,482302863,0,4009,994472,3896,969152,113,25320,1930,6,3770,79,0,35,216660.0,130000.0,-50.0,-46.0,-43.0,-49.0,-50.0,-47.0,-43.0,-48.0,-90.0,-93.0,-90.0,-93.0,40.0,47.0,47.0,44.0,0
4842,CC:2F:71:3F:1F:24,4451832,1179879153,627768,697575955,3824064,482303198,37,516710,562904488,516086,562829380,624,75108,499029,10,628005,58747,34,449,130000.0,43333.0,-67.0,-65.0,-70.0,-67.0,-67.0,-65.0,-70.0,-67.0,-90.0,-93.0,-90.0,-93.0,23.0,28.0,20.0,26.0,0
4843,CC:2F:71:3E:C5:1F,3824819,482395441,753,92041,3824066,482303400,0,3154,264821,2603,199359,551,65462,796,8,1084,18,0,34,144444.0,39000.0,-70.0,-71.0,-67.0,-60.0,-70.0,-72.0,-68.0,-61.0,-90.0,-93.0,-90.0,-93.0,20.0,22.0,23.0,33.0,0
4844,BA:8C:B9:54:50:24,3828785,488453437,4717,6149835,3824068,482303602,0,8277,1644382,8255,1640887,22,3495,2320,14,5092,36,0,53,216660.0,130000.0,-46.0,-35.0,-40.0,-43.0,-43.0,-35.0,-42.0,-47.0,-90.0,-93.0,-90.0,-93.0,44.0,58.0,50.0,50.0,0
4845,92:69:1D:31:68:E9,3827715,485812909,3644,3509045,3824071,482303864,0,4009,994472,3896,969152,113,25320,1930,6,3770,79,0,35,216660.0,130000.0,-50.0,-46.0,-43.0,-49.0,-50.0,-47.0,-43.0,-48.0,-90.0,-93.0,-90.0,-93.0,40.0,47.0,47.0,44.0,0
4846,CC:2F:71:3F:1F:24,4451881,1179894201,627808,697590135,3824073,482304066,37,516736,562909432,516112,562834324,624,75108,499055,10,628045,58768,34,449,117000.0,39000.0,-67.0,-65.0,-70.0,-68.0,-67.0,-65.0,-70.0,-67.0,-90.0,-93.0,-90.0,-93.0,23.0,28.0,20.0,25.0,0
4847,CC:2F:71:3E:C5:1F,3824826,482396107,753,92041,3824073,482304066,0,3154,264821,2603,199359,551,65462,796,8,1084,18,0,34,144444.0,39000.0,-70.0,-71.0,-67.0,-60.0,-70.0,-72.0,-68.0,-61.0,-90.0,-93.0,-90.0,-93.0,20.0,22.0,23.0,33.0,0
4848,BA:8C:B9:54:50:24,3828790,488453901,4717,6149835,3824073,482304066,0,8277,1644382,8255,1640887,22,3495,2320,14,5092,36,0,53,216660.0,130000.0,-46.0,-35.0,-40.0,-43.0,-43.0,-35.0,-42.0,-47.0,-90.0,-93.0,-90.0,-93.0,44.0,58.0,50.0,50.0,0
4849,92:69:1D:31:68:E9,3827717,485813111,3644,3509045,3824073,482304066,0,4009,994472,3896,969152,113,25320,1930,6,3770,79,0,35,216660.0,130000.0,-50.0,-46.0,-43.0,-49.0,-50.0,-47.0,-43.0,-48.0,-90.0,-93.0,-90.0,-93.0,40.0,47.0,47.0,44.0,0
4850,CC:2F:71:3F:1F:24,4451924,1179908753,627851,697604687,3824073,482304066,37,516762,562914376,516138,562839268,624,75108,499081,10,628088,58772,34,449,130000.0,43333.0,-67.0,-65.0,-70.0,-67.0,-67.0,-65.0,-70.0,-67.0,-90.0,-93.0,-90.0,-93.0,23.0,28.0,20.0,26.0,0
4851,CC:2F:71:3E:C5:1F,3824828,482396309,753,92041,3824075,482304268,0,3154,264821,2603,199359,551,65462,796,8,1084,18,0,34,144444.0,39000.0,-70.0,-71.0,-67.0,-60.0,-70.0,-72.0,-68.0,-61.0,-90.0,-93.0,-90.0,-93.0,20.0,22.0,23.0,33.0,0
4852,BA:8C:B9:54:50:24,3828794,488454305,4717,6149835,3824077,482304470,0,8277,1644382,8255,1640887,22,3495,2320,14,5092,36,0,53,216660.0,130000.0,-46.0,-35.0,-40.0,-43.0,-43.0,-35.0,-42.0,-47.0,-90.0,-93.0,-90.0,-93.0,44.0,58.0,50.0,50.0,0
4853,92:69:1D:31:68:E9,3827725,485813919,3644,3509045,3824081,482304874,0,4009,994472,3896,969152,113,25320,1930,6,3770,79,0,35,216660.0,130000.0,-50.0,-46.0,-43.0,-49.0,-50.0,-47.0,-43.0,-48.0,-90.0,-93.0,-90.0,-93.0,40.0,47.0,47.0,44.0,0
4854,CC:2F:71:3F:1F:24,4451973,1179923977,627892,697619103,3824081,482304874,37,516787,562919180,516163,562844072,624,75108,499106,10,628129,58779,34,449,130000.0,43333.0,-67.0,-65.0,-70.0,-68.0,-67.0,-65.0,-70.0,-67.0,-90.0,-93.0,-90.0,-93.0,23.0,28.0,20.0,25.0,0
4855,CC:2F:71:3E:C5:1F,3824834,482396915,753,92041,3824081,482304874,0,3154,264821,2603,199359,551,65462,796,8,1084,18,0,34,144444.0,39000.0,-70.0,-71.0,-67.0,-60.0,-70.0,-72.0,-68.0,-61.0,-90.0,-93.0,-90.0,-93.0,20.0,22.0,23.0,33.0,0
4856,BA:8C:B9:54:50:24,3828798,488454709,4717,6149835,3824081,482304874,0,8277,1644382,8255,1640887,22,3495,2320,14,5092,36,0,53,216660.0,130000.0,-46.0,-35.0,-40.0,-43.0,-43.0,-35.0,-42.0,-47.0,-90.0,-93.0,-90.0,-93.0,44.0,58.0,50.0,50.0,0
4857,92:69:1D:31:68:E9,3827727,485814041,3644,3509045,3824083,482304996,0,4009,994472,3896,969152,113,25320,1930,6,3770,79,0,35,216660.0,130000.0,-50.0,-46.0,-43.0,-49.0,-50.0,-47.0,-43.0,-48.0,-90.0,-93.0,-90.0,-93.0,40.0,47.0,47.0,44.0,0
4858,CC:2F:71:3F:1F:24,4452017,1179938527,627934,697633531,3824083,482304996,37,516813,562924100,516189,562848992,624,75108,499132,10,628171,58796,34,449,117000.0,39000.0,-67.0,-65.0,-71.0,-67.0,-67.0,-65.0,-70.0,-67.0,-90.0,-93.0,-90.0,-93.0,23.0,28.0,19.0,26.0,0
4859,CC:2F:71:3E:C5:1F,3824838,482397239,753,92041,3824085,482305198,0,3156,265009,2604,199429,552,65580,797,8,1084,18,0,34,144444.0,39000.0,-78.0,-85.0,-75.0,-71.0,-71.0,-74.0,-69.0,-62.0,-90.0,-93.0,-90.0,-93.0,12.0,8.0,15.0,22.0,0
4860,BA:8C:B9:54:50:24,3828804,488455235,4717,6149835,3824087,482305400,0,8277,1644382,8255,1640887,22,3495,2320,14,5092,36,0,53,216660.0,130000.0,-46.0,-35.0,-40.0,-43.0,-43.0,-35.0,-42.0,-47.0,-90.0,-93.0,-90.0,-93.0,44.0,58.0,50.0,50.0,0
4861,92:69:1D:31:68:E9,3827735,485814849,3644,3509045,3824091,482305804,0,4009,994472,3896,969152,113,25320,1930,6,3770,79,0,35,216660.0,130000.0,-50.0,-46.0,-43.0,-49.0,-50.0,-47.0,-43.0,-48.0,-90.0,-93.0,-90.0,-93.0,40.0,47.0,47.0,44.0,0
4862,CC:2F:71:3F:1F:24,4452066,1179953639,627975,697647835,3824091,482305804,37,516840,562929160,516216,562854052,624,75108,499159,10,628212,58807,34,449,130000.0,43333.0,-67.0,-65.0,-70.0,-68.0,-67.0,-65.0,-70.0,-67.0,-90.0,-93.0,-90.0,-93.0,23.0,28.0,20.0,25.0,0
4863,CC:2F:71:3E:C5:1F,3824844,482397845,753,92041,3824091,482305804,0,3156,265009,2604,199429,552,65580,797,8,1084,18,0,34,144444.0,39000.0,-78.0,-85.0,-75.0,-71.0,-71.0,-74.0,-69.0,-62.0,-90.0,-93.0,-90.0,-93.0,12.0,8.0,15.0,22.0,0
4864,BA:8C:B9:54:50:24,3828808,488455639,4717,6149835,3824091,482305804,0,8277,1644382,8255,1640887,22,3495,2320,14,5092,36,0,53,216660.0,130000.0,-46.0,-35.0,-40.0,-43.0,-43.0,-35.0,-42.0,-47.0,-90.0,-93.0,-90.0,-93.0,44.0,58.0,50.0,50.0,0
4865,92:69:1D:31:68:E9,3827735,485814849,3644,3509045,3824091,482305804,0,4009,994472,3896,969152,113,25320,1930,6,3770,79,0,35,216660.0,130000.0,-50.0,-46.0,-43.0,-49.0,-50.0,-47.0,-43.0,-48.0,-90.0,-93.0,-90.0,-93.0,40.0,47.0,47.0,44.0,0
4866,CC:2F:71:3F:1F:24,4452113,1179968621,628020,697662615,3824093,482306006,37,516871,562934696,516247,562859588,624,75108,499190,10,628257,58846,34,449,130000.0,43333.0,-67.0,-65.0,-71.0,-68.0,-67.0,-65.0,-70.0,-67.0,-90.0,-93.0,-90.0,-93.0,23.0,28.0,19.0,25.0,0
4867,CC:2F:71:3E:C5:1F,3824849,482398309,753,92041,3824096,482306268,0,3156,265009,2604,199429,552,65580,797,8,1084,18,0,34,144444.0,39000.0,-78.0,-85.0,-75.0,-71.0,-71.0,-74.0,-69.0,-62.0,-90.0,-93.0,-90.0,-93.0,12.0,8.0,15.0,22.0,0
4868,BA:8C:B9:54:50:24,3828813,488456103,4717,6149835,3824096,482306268,0,8277,1644382,8255,1640887,22,3495,2320,14,5092,36,0,53,216660.0,130000.0,-46.0,-35.0,-40.0,-43.0,-43.0,-35.0,-42.0,-47.0,-90.0,-93.0,-90.0,-93.0,44.0,58.0,50.0,50.0,0
4869,92:69:1D:31:68:E9,3827743,485815649,3644,3509045,3824099,482306604,0,4009,994472,3896,969152,113,25320,1930,6,3770,79,0,35,216660.0,130000.0,-50.0,-46.0,-43.0,-49.0,-50.0,-47.0,-43.0,-48.0,-90.0,-93.0,-90.0,-93.0,40.0,47.0,47.0,44.0,0
4870,CC:2F:71:3F:1F:24,4452164,1179984087,628065,697677483,3824099,482306604,37,516899,562939920,516275,562864812,624,75108,499218,10,628302,58852,34,449,130000.0,43333.0,-67.0,-65.0,-71.0,-68.0,-67.0,-65.0,-70.0,-67.0,-90.0,-93.0,-90.0,-93.0,23.0,28.0,19.0,25.0,0
4871,CC:2F:71:3E:C5:1F,3824853,482398713,753,92041,3824100,482306672,0,3156,265009,2604,199429,552,65580,797,8,1084,18,0,34,144444.0,39000.0,-78.0,-85.0,-75.0,-71.0,-71.0,-74.0,-69.0,-62.0,-90.0,-93.0,-90.0,-93.0,12.0,8.0,15.0,22.0,0
4872,BA:8C:B9:54:50:24,3828817,488456507,4717,6149835,3824100,482306672,0,8277,1644382,8255,1640887,22,3495,2320,14,5092,36,0,53,216660.0,130000.0,-46.0,-35.0,-40.0,-43.0,-43.0,-35.0,-42.0,-47.0,-90.0,-93.0,-90.0,-93.0,44.0,58.0,50.0,50.0,0
4873,92:69:1D:31:68:E9,3827746,485815919,3644,3509045,3824102,482306874,0,4009,994472,3896,969152,113,25320,1930,6,3770,79,0,35,216660.0,130000.0,-50.0,-46.0,-43.0,-49.0,-50.0,-47.0,-43.0,-48.0,-90.0,-93.0,-90.0,-93.0,40.0,47.0,47.0,44.0,0
4874,CC:2F:71:3F:1F:24,4452209,1179998897,628107,697692023,3824102,482306874,37,516925,562944864,516301,562869756,624,75108,499244,10,628344,58859,34,449,130000.0,43333.0,-67.0,-65.0,-70.0,-67.0,-67.0,-65.0,-70.0,-67.0,-90.0,-93.0,-90.0,-93.0,23.0,28.0,20.0,26.0,0
4875,CC:2F:71:3E:C5:1F,3824857,482399117,753,92041,3824104,482307076,0,3156,265009,2604,199429,552,65580,797,8,1084,18,0,34,144444.0,39000.0,-78.0,-85.0,-75.0,-71.0,-71.0,-74.0,-69.0,-62.0,-90.0,-93.0,-90.0,-93.0,12.0,8.0,15.0,22.0,0
4876,BA:8C:B9:54:50:24,3828821,488456911,4717,6149835,3824104,482307076,0,8277,1644382,8255,1640887,22,3495,2320,14,5092,36,0,53,216660.0,130000.0,-46.0,-35.0,-40.0,-43.0,-43.0,-35.0,-42.0,-47.0,-90.0,-93.0,-90.0,-93.0,44.0,58.0,50.0,50.0,0
4877,92:69:1D:31:68:E9,3827751,485816383,3644,3509045,3824107,482307338,0,4010,994540,3897,969220,113,25320,1930,6,3770,79,0,35,216660.0,130000.0,-51.0,-53.0,-47.0,-48.0,-50.0,-48.0,-43.0,-48.0,-90.0,-93.0,-90.0,-93.0,39.0,40.0,43.0,45.0,0
4878,CC:2F:71:3F:1F:24,4452257,1180013913,628150,697706575,3824107,482307338,37,516950,562949668,516326,562874560,624,75108,499269,10,628386,58880,34,449,117000.0,39000.0,-67.0,-65.0,-70.0,-67.0,-67.0,-65.0,-70.0,-67.0,-90.0,-93.0,-90.0,-93.0,23.0,28.0,20.0,26.0,0
4879,CC:2F:71:3E:C5:1F,3824862,482399581,753,92041,3824109,482307540,0,3156,265009,2604,199429,552,65580,797,8,1084,18,0,34,144444.0,39000.0,-78.0,-85.0,-75.0,-71.0,-71.0,-74.0,-69.0,-62.0,-90.0,-93.0,-90.0,-93.0,12.0,8.0,15.0,22.0,0
4880,BA:8C:B9:54:50:24,3828826,488457375,4717,6149835,3824109,482307540,0,8277,1644382,8255,1640887,22,3495,2320,14,5092,36,0,53,216660.0,130000.0,-46.0,-35.0,-40.0,-43.0,-43.0,-35.0,-42.0,-47.0,-90.0,-93.0,-90.0,-93.0,44.0,58.0,50.0,50.0,0
4881,92:69:1D:31:68:E9,3827753,485816585,3644,3509045,3824109,482307540,0,4010,994540,3897,969220,113,25320,1930,6,3770,79,0,35,216660.0,130000.0,-51.0,-53.0,-47.0,-48.0,-50.0,-48.0,-43.0,-48.0,-90.0,-93.0,-90.0,-93.0,39.0,40.0,43.0,45.0,0
4882,CC:2F:71:3F:1F:24,4452302,1180028621,628191,697720879,3824111,482307742,37,516978,562954820,516354,562879712,624,75108,499297,10,628428,58884,34,449,130000.0,43333.0,-67.0,-65.0,-70.0,-68.0,-67.0,-65.0,-70.0,-67.0,-90.0,-93.0,-90.0,-93.0,23.0,28.0,20.0,25.0,0
4883,CC:2F:71:3E:C5:1F,3824866,482399985,753,92041,3824113,482307944,0,3156,265009,2604,199429,552,65580,797,8,1084,18,0,34,144444.0,39000.0,-78.0,-85.0,-75.0,-71.0,-71.0,-74.0,-69.0,-62.0,-90.0,-93.0,-90.0,-93.0,12.0,8.0,15.0,22.0,0
4884,BA:8C:B9:54:50:24,3828830,488457779,4717,6149835,3824113,482307944,0,8277,1644382,8255,1640887,22,3495,2320,14,5092,36,0,53,216660.0,130000.0,-46.0,-35.0,-40.0,-43.0,-43.0,-35.0,-42.0,-47.0,-90.0,-93.0,-90.0,-93.0,44.0,58.0,50.0,50.0,0
4885,92:69:1D:31:68:E9,3827759,485817191,3644,3509045,3824115,482308146,0,4012,994676,3899,969356,113,25320,1930,6,3770,79,0,35,216660.0,130000.0,-51.0,-47.0,-42.0,-49.0,-50.0,-47.0,-43.0,-48.0,-90.0,-93.0,-90.0,-93.0,39.0,46.0,48.0,44.0,0
4886,CC:2F:71:3F:1F:24,4452349,1180043583,628234,697735437,3824115,482308146,37,517004,562959740,516380,562884632,624,75108,499323,10,628471,58897,34,449,117000.0,39000.0,-67.0,-65.0,-70.0,-68.0,-67.0,-65.0,-70.0,-67.0,-90.0,-93.0,-90.0,-93.0,23.0,28.0,20.0,25.0,0
4887,CC:2F:71:3E:C5:1F,3824868,482400187,753,92041,3824115,482308146,0,3156,265009,2604,199429,552,65580,797,8,1084,18,0,34,144444.0,39000.0,-78.0,-85.0,-75.0,-71.0,-71.0,-74.0,-69.0,-62.0,-90.0,-93.0,-90.0,-93.0,12.0,8.0,15.0,22.0,0
4888,BA:8C:B9:54:50:24,3828834,488458183,4717,6149835,3824117,482308348,0,8277,1644382,8255,1640887,22,3495,2320,14,5092,36,0,53,216660.0,130000.0,-46.0,-35.0,-40.0,-43.0,-43.0,-35.0,-42.0,-47.0,-90.0,-93.0,-90.0,-93.0,44.0,58.0,50.0,50.0,0
4889,92:69:1D:31:68:E9,3827774,485823052,3644,3509045,3824130,482314007,0,4015,995047,3901,969492,114,25555,1931,6,3770,79,0,35,216660.0,130000.0,-51.0,-47.0,-42.0,-48.0,-51.0,-48.0,-43.0,-48.0,-90.0,-93.0,-90.0,-93.0,39.0,46.0,48.0,45.0,0
4890,CC:2F:71:3F:1F:24,4452411,1180064472,628277,697750061,3824134,482314411,37,517034,562965160,516410,562890052,624,75108,499353,10,628514,58907,34,449,130000.0,39000.0,-67.0,-65.0,-70.0,-68.0,-67.0,-65.0,-70.0,-67.0,-90.0,-93.0,-90.0,-93.0,23.0,28.0,20.0,25.0,0
4891,CC:2F:71:3E:C5:1F,3824898,482411876,753,92041,3824145,482319835,0,3156,265009,2604,199429,552,65580,797,8,1084,18,0,34,144444.0,39000.0,-78.0,-85.0,-75.0,-71.0,-71.0,-74.0,-69.0,-62.0,-90.0,-93.0,-90.0,-93.0,12.0,8.0,15.0,22.0,0
4892,BA:8C:B9:54:50:24,3828862,488469670,4717,6149835,3824145,482319835,0,8277,1644382,8255,1640887,22,3495,2320,14,5092,36,0,53,216660.0,130000.0,-46.0,-35.0,-40.0,-43.0,-43.0,-35.0,-42.0,-47.0,-90.0,-93.0,-90.0,-93.0,44.0,58.0,50.0,50.0,0
4893,92:69:1D:31:68:E9,3827791,485829082,3644,3509045,3824147,482320037,0,4015,995047,3901,969492,114,25555,1931,6,3770,79,0,35,216660.0,130000.0,-51.0,-47.0,-42.0,-48.0,-51.0,-48.0,-43.0,-48.0,-90.0,-93.0,-90.0,-93.0,39.0,46.0,48.0,45.0,0
4894,CC:2F:71:3F:1F:24,4452466,1180084675,628318,697764365,3824148,482320310,37,517059,562969964,516435,562894856,624,75108,499378,10,628555,58928,34,449,130000.0,39000.0,-67.0,-65.0,-70.0,-68.0,-67.0,-65.0,-70.0,-67.0,-90.0,-93.0,-90.0,-93.0,23.0,28.0,20.0,25.0,0
4895,CC:2F:71:3E:C5:1F,3824903,482412553,753,92041,3824150,482320512,0,3156,265009,2604,199429,552,65580,797,8,1084,18,0,34,144444.0,39000.0,-78.0,-85.0,-75.0,-71.0,-71.0,-74.0,-69.0,-62.0,-90.0,-93.0,-90.0,-93.0,12.0,8.0,15.0,22.0,0
4896,BA:8C:B9:54:50:24,3828867,488470347,4717,6149835,3824150,482320512,0,8277,1644382,8255,1640887,22,3495,2320,14,5092,36,0,53,216660.0,130000.0,-46.0,-35.0,-40.0,-43.0,-43.0,-35.0,-42.0,-47.0,-90.0,-93.0,-90.0,-93.0,44.0,58.0,50.0,50.0,0
4897,92:69:1D:31:68:E9,3827799,485830021,3644,3509045,3824155,482320976,0,4015,995047,3901,969492,114,25555,1931,6,3770,79,0,35,216660.0,130000.0,-51.0,-47.0,-42.0,-48.0,-51.0,-48.0,-43.0,-48.0,-90.0,-93.0,-90.0,-93.0,39.0,46.0,48.0,45.0,0
4898,CC:2F:71:3F:1F:24,4452515,1180099719,628360,697778743,3824155,482320976,37,517084,562974768,516460,562899660,624,75108,499403,10,628597,58946,34,449,117000.0,39000.0,-67.0,-65.0,-70.0,-68.0,-67.0,-65.0,-70.0,-67.0,-90.0,-93.0,-90.0,-93.0,23.0,28.0,20.0,25.0,0
4899,CC:2F:71:3E:C5:1F,3824908,482413017,753,92041,3824155,482320976,0,3156,265009,2604,199429,552,65580,797,8,1084,18,0,34,144444.0,39000.0,-78.0,-85.0,-75.0,-71.0,-71.0,-74.0,-69.0,-62.0,-90.0,-93.0,-90.0,-93.0,12.0,8.0,15.0,22.0,0
4900,BA:8C:B9:54:50:24,3828872,488470811,4717,6149835,3824155,482320976,0,8277,1644382,8255,1640887,22,3495,2320,14,5092,36,0,53,216660.0,130000.0,-46.0,-35.0,-40.0,-43.0,-43.0,-35.0,-42.0,-47.0,-90.0,-93.0,-90.0,-93.0,44.0,58.0,50.0,50.0,0
4901,92:69:1D:31:68:E9,3827801,485830223,3644,3509045,3824157,482321178,0,4015,995047,3901,969492,114,25555,1931,6,3770,79,0,35,216660.0,130000.0,-51.0,-47.0,-42.0,-48.0,-51.0,-48.0,-43.0,-48.0,-90.0,-93.0,-90.0,-93.0,39.0,46.0,48.0,45.0,0
4902,CC:2F:71:3F:1F:24,4452558,1180114225,628401,697793047,3824157,482321178,37,517110,562979688,516486,562904580,624,75108,499429,10,628638,58952,34,449,130000.0,43333.0,-67.0,-65.0,-70.0,-68.0,-67.0,-65.0,-70.0,-67.0,-90.0,-93.0,-90.0,-93.0,23.0,28.0,20.0,25.0,0
4903,CC:2F:71:3E:C5:1F,3824912,482413421,753,92041,3824159,482321380,0,3156,265009,2604,199429,552,65580,797,8,1084,18,0,34,144444.0,39000.0,-78.0,-85.0,-75.0,-71.0,-71.0,-74.0,-69.0,-62.0,-90.0,-93.0,-90.0,-93.0,12.0,8.0,15.0,22.0,0
4904,BA:8C:B9:54:50:24,3828876,488471215,4717,6149835,3824159,482321380,0,8277,1644382,8255,1640887,22,3495,2320,14,5092,36,0,53,216660.0,130000.0,-46.0,-35.0,-40.0,-43.0,-43.0,-35.0,-42.0,-47.0,-90.0,-93.0,-90.0,-93.0,44.0,58.0,50.0,50.0,0
4905,92:69:1D:31:68:E9,3827807,485830829,3644,3509045,3824163,482321784,0,4015,995047,3901,969492,114,25555,1931,6,3770,79,0,35,216660.0,130000.0,-51.0,-47.0,-42.0,-48.0,-51.0,-48.0,-43.0,-48.0,-90.0,-93.0,-90.0,-93.0,39.0,46.0,48.0,45.0,0
4906,CC:2F:71:3F:1F:24,4452605,1180129247,628442,697807463,3824163,482321784,37,517136,562984632,516512,562909524,624,75108,499455,10,628679,58953,34,449,130000.0,43333.0,-67.0,-65.0,-70.0,-67.0,-67.0,-65.0,-70.0,-67.0,-90.0,-93.0,-90.0,-93.0,23.0,28.0,20.0,26.0,0
4907,CC:2F:71:3E:C5:1F,3824916,482413825,753,92041,3824163,482321784,0,3156,265009,2604,199429,552,65580,797,8,1084,18,0,34,144444.0,39000.0,-78.0,-85.0,-75.0,-71.0,-71.0,-74.0,-69.0,-62.0,-91.0,-93.0,-90.0,-93.0,13.0,8.0,15.0,22.0,0
4908,BA:8C:B9:54:50:24,3828880,488471619,4717,6149835,3824163,482321784,0,8277,1644382,8255,1640887,22,3495,2320,14,5092,36,0,53,216660.0,130000.0,-46.0,-35.0,-40.0,-43.0,-43.0,-35.0,-42.0,-47.0,-91.0,-93.0,-90.0,-93.0,45.0,58.0,50.0,50.0,0
4909,92:69:1D:31:68:E9,3827812,485831459,3644,3509045,3824168,482322414,0,4015,995047,3901,969492,114,25555,1931,6,3770,79,0,35,216660.0,130000.0,-51.0,-47.0,-42.0,-48.0,-51.0,-48.0,-43.0,-48.0,-91.0,-93.0,-90.0,-93.0,40.0,46.0,48.0,45.0,0
4910,CC:2F:71:3F:1F:24,4452651,1180144125,628483,697821711,3824168,482322414,37,517162,562989576,516538,562914468,624,75108,499481,10,628720,58968,34,449,130000.0,39000.0,-67.0,-65.0,-70.0,-68.0,-67.0,-65.0,-70.0,-67.0,-91.0,-93.0,-90.0,-93.0,24.0,28.0,20.0,25.0,0
4911,CC:2F:71:3E:C5:1F,3824921,482414455,753,92041,3824168,482322414,0,3156,265009,2604,199429,552,65580,797,8,1084,18,0,34,144444.0,39000.0,-78.0,-85.0,-75.0,-71.0,-71.0,-74.0,-69.0,-62.0,-91.0,-93.0,-90.0,-93.0,13.0,8.0,15.0,22.0,0
4912,BA:8C:B9:54:50:24,3828885,488472249,4717,6149835,3824168,482322414,0,8277,1644382,8255,1640887,22,3495,2320,14,5092,36,0,53,216660.0,130000.0,-46.0,-35.0,-40.0,-43.0,-43.0,-35.0,-42.0,-47.0,-91.0,-93.0,-90.0,-93.0,45.0,58.0,50.0,50.0,0
4913,92:69:1D:31:68:E9,3827816,485831863,3644,3509045,3824172,482322818,0,4015,995047,3901,969492,114,25555,1931,6,3770,79,0,35,216660.0,130000.0,-51.0,-47.0,-42.0,-48.0,-51.0,-48.0,-43.0,-48.0,-91.0,-93.0,-90.0,-93.0,40.0,46.0,48.0,45.0,0
4914,CC:2F:71:3F:1F:24,4452698,1180158979,628524,697835959,3824174,482323020,37,517188,562994496,516564,562919388,624,75108,499507,10,628761,58978,34,449,117000.0,39000.0,-67.0,-65.0,-70.0,-67.0,-67.0,-65.0,-70.0,-67.0,-91.0,-93.0,-90.0,-93.0,24.0,28.0,20.0,26.0,0
4915,CC:2F:71:3E:C5:1F,3824927,482415061,753,92041,3824174,482323020,0,3156,265009,2604,199429,552,65580,797,8,1084,18,0,34,144444.0,39000.0,-78.0,-85.0,-75.0,-71.0,-71.0,-74.0,-69.0,-62.0,-91.0,-93.0,-90.0,-93.0,13.0,8.0,15.0,22.0,0
4916,BA:8C:B9:54:50:24,3828891,488472855,4717,6149835,3824174,482323020,0,8277,1644382,8255,1640887,22,3495,2320,14,5092,36,0,53,216660.0,130000.0,-46.0,-35.0,-40.0,-43.0,-43.0,-35.0,-42.0,-47.0,-91.0,-93.0,-90.0,-93.0,45.0,58.0,50.0,50.0,0
4917,92:69:1D:31:68:E9,3827820,485832267,3644,3509045,3824176,482323222,0,4015,995047,3901,969492,114,25555,1931,6,3770,79,0,35,216660.0,130000.0,-51.0,-47.0,-42.0,-48.0,-51.0,-48.0,-43.0,-48.0,-91.0,-93.0,-90.0,-93.0,40.0,46.0,48.0,45.0,0
4918,CC:2F:71:3F:1F:24,4452743,1180173689,628567,697850467,3824176,482323222,37,517214,562999416,516590,562924308,624,75108,499533,10,628804,58990,34,449,130000.0,39000.0,-67.0,-65.0,-70.0,-67.0,-67.0,-65.0,-70.0,-67.0,-91.0,-93.0,-90.0,-93.0,24.0,28.0,20.0,26.0,0
4919,CC:2F:71:3E:C5:1F,3824930,482415323,753,92041,3824177,482323282,0,3156,265009,2604,199429,552,65580,797,8,1084,18,0,34,144444.0,39000.0,-78.0,-85.0,-75.0,-71.0,-71.0,-74.0,-69.0,-62.0,-91.0,-93.0,-90.0,-93.0,13.0,8.0,15.0,22.0,0
4920,BA:8C:B9:54:50:24,3828894,488473117,4717,6149835,3824177,482323282,0,8277,1644382,8255,1640887,22,3495,2320,14,5092,36,0,53,216660.0,130000.0,-46.0,-35.0,-40.0,-43.0,-43.0,-35.0,-42.0,-47.0,-91.0,-93.0,-90.0,-93.0,45.0,58.0,50.0,50.0,0
4921,92:69:1D:31:68:E9,3827825,485832731,3644,3509045,3824181,482323686,0,4015,995047,3901,969492,114,25555,1931,6,3770,79,0,35,216660.0,130000.0,-51.0,-47.0,-42.0,-48.0,-51.0,-48.0,-43.0,-48.0,-91.0,-93.0,-90.0,-93.0,40.0,46.0,48.0,45.0,0
4922,CC:2F:71:3F:1F:24,4452791,1180188603,628608,697864715,3824183,482323888,37,517240,563004360,516616,562929252,624,75108,499559,10,628845,59020,34,449,130000.0,43333.0,-67.0,-65.0,-70.0,-67.0,-67.0,-65.0,-70.0,-67.0,-91.0,-93.0,-90.0,-93.0,24.0,28.0,20.0,26.0,0
4923,CC:2F:71:3E:C5:1F,3824936,482415929,753,92041,3824183,482323888,0,3156,265009,2604,199429,552,65580,797,8,1084,18,0,34,144444.0,39000.0,-78.0,-85.0,-75.0,-71.0,-71.0,-74.0,-69.0,-62.0,-91.0,-93.0,-90.0,-93.0,13.0,8.0,15.0,22.0,0
4924,BA:8C:B9:54:50:24,3828900,488473723,4717,6149835,3824183,482323888,0,8277,1644382,8255,1640887,22,3495,2320,14,5092,36,0,53,216660.0,130000.0,-46.0,-35.0,-40.0,-43.0,-43.0,-35.0,-42.0,-47.0,-91.0,-93.0,-90.0,-93.0,45.0,58.0,50.0,50.0,0
4925,92:69:1D:31:68:E9,3827829,485833135,3644,3509045,3824185,482324090,0,4015,995047,3901,969492,114,25555,1931,6,3770,79,0,35,216660.0,130000.0,-51.0,-47.0,-42.0,-48.0,-51.0,-48.0,-43.0,-48.0,-91.0,-93.0,-90.0,-93.0,40.0,46.0,48.0,45.0,0
4926,CC:2F:71:3F:1F:24,4452836,1180203475,628651,697879385,3824185,482324090,37,517265,563009164,516641,562934056,624,75108,499584,10,628888,59023,34,449,130000.0,43333.0,-67.0,-65.0,-70.0,-67.0,-67.0,-65.0,-70.0,-67.0,-91.0,-93.0,-90.0,-93.0,24.0,28.0,20.0,26.0,0
4927,CC:2F:71:3E:C5:1F,3824938,482416131,753,92041,3824185,482324090,0,3156,265009,2604,199429,552,65580,797,8,1084,18,0,34,144444.0,39000.0,-78.0,-85.0,-75.0,-71.0,-71.0,-74.0,-69.0,-62.0,-91.0,-93.0,-90.0,-93.0,13.0,8.0,15.0,22.0,0
4928,BA:8C:B9:54:50:24,3828902,488473925,4717,6149835,3824185,482324090,0,8277,1644382,8255,1640887,22,3495,2320,14,5092,36,0,53,216660.0,130000.0,-46.0,-35.0,-40.0,-43.0,-43.0,-35.0,-42.0,-47.0,-91.0,-93.0,-90.0,-93.0,45.0,58.0,50.0,50.0,0
4929,92:69:1D:31:68:E9,3827834,485833599,3644,3509045,3824190,482324554,0,4015,995047,3901,969492,114,25555,1931,6,3770,79,0,35,216660.0,130000.0,-51.0,-47.0,-42.0,-48.0,-51.0,-48.0,-43.0,-48.0,-91.0,-93.0,-90.0,-93.0,40.0,46.0,48.0,45.0,0
4930,CC:2F:71:3F:1F:24,4452884,1180218501,628692,697893745,3824192,482324756,37,517291,563014108,516667,562939000,624,75108,499610,10,628929,59043,34,449,130000.0,39000.0,-67.0,-65.0,-71.0,-68.0,-67.0,-65.0,-70.0,-67.0,-91.0,-93.0,-90.0,-93.0,24.0,28.0,19.0,25.0,0
4931,CC:2F:71:3E:C5:1F,3824945,482416797,753,92041,3824192,482324756,0,3156,265009,2604,199429,552,65580,797,8,1084,18,0,34,144444.0,39000.0,-78.0,-85.0,-75.0,-71.0,-71.0,-74.0,-69.0,-62.0,-91.0,-93.0,-90.0,-93.0,13.0,8.0,15.0,22.0,0
4932,BA:8C:B9:54:50:24,3828909,488474591,4717,6149835,3824192,482324756,0,8277,1644382,8255,1640887,22,3495,2320,14,5092,36,0,53,216660.0,130000.0,-46.0,-35.0,-40.0,-43.0,-43.0,-35.0,-42.0,-47.0,-91.0,-93.0,-90.0,-93.0,45.0,58.0,50.0,50.0,0
4933,92:69:1D:31:68:E9,3827838,485834003,3644,3509045,3824194,482324958,0,4015,995047,3901,969492,114,25555,1931,6,3770,79,0,35,216660.0,130000.0,-51.0,-47.0,-42.0,-48.0,-51.0,-48.0,-43.0,-48.0,-91.0,-93.0,-90.0,-93.0,40.0,46.0,48.0,45.0,0
4934,CC:2F:71:3F:1F:24,4452927,1180232957,628733,697907999,3824194,482324958,37,517317,563019028,516693,562943920,624,75108,499636,10,628970,59074,34,449,130000.0,43333.0,-67.0,-65.0,-70.0,-68.0,-67.0,-65.0,-70.0,-67.0,-91.0,-93.0,-90.0,-93.0,24.0,28.0,20.0,25.0,0
4935,CC:2F:71:3E:C5:1F,3824947,482416999,753,92041,3824194,482324958,0,3156,265009,2604,199429,552,65580,797,8,1084,18,0,34,144444.0,39000.0,-78.0,-85.0,-75.0,-71.0,-71.0,-74.0,-69.0,-62.0,-91.0,-93.0,-90.0,-93.0,13.0,8.0,15.0,22.0,0
4936,BA:8C:B9:54:50:24,3828911,488474793,4717,6149835,3824194,482324958,0,8277,1644382,8255,1640887,22,3495,2320,14,5092,36,0,53,216660.0,130000.0,-46.0,-35.0,-40.0,-43.0,-43.0,-35.0,-42.0,-47.0,-91.0,-93.0,-90.0,-93.0,45.0,58.0,50.0,50.0,0
4937,92:69:1D:31:68:E9,3827842,485834407,3644,3509045,3824198,482325362,0,4015,995047,3901,969492,114,25555,1931,6,3770,79,0,35,216660.0,130000.0,-51.0,-47.0,-42.0,-48.0,-51.0,-48.0,-43.0,-48.0,-91.0,-93.0,-90.0,-93.0,40.0,46.0,48.0,45.0,0
4938,CC:2F:71:3F:1F:24,4452976,1180248233,628776,697922669,3824200,482325564,37,517343,563023948,516719,562948840,624,75108,499662,10,629013,59084,34,449,130000.0,39000.0,-67.0,-65.0,-70.0,-68.0,-67.0,-65.0,-70.0,-67.0,-91.0,-93.0,-90.0,-93.0,24.0,28.0,20.0,25.0,0
4939,CC:2F:71:3E:C5:1F,3824953,482417605,753,92041,3824200,482325564,0,3156,265009,2604,199429,552,65580,797,8,1084,18,0,34,144444.0,39000.0,-78.0,-85.0,-75.0,-71.0,-71.0,-74.0,-69.0,-62.0,-91.0,-93.0,-90.0,-93.0,13.0,8.0,15.0,22.0,0
4940,BA:8C:B9:54:50:24,3828917,488475399,4717,6149835,3824200,482325564,0,8277,1644382,8255,1640887,22,3495,2320,14,5092,36,0,53,216660.0,130000.0,-46.0,-35.0,-40.0,-43.0,-43.0,-35.0,-42.0,-47.0,-91.0,-93.0,-90.0,-93.0,45.0,58.0,50.0,50.0,0
4941,92:69:1D:31:68:E9,3827847,485834871,3644,3509045,3824203,482325826,0,4015,995047,3901,969492,114,25555,1931,6,3770,79,0,35,216660.0,130000.0,-51.0,-47.0,-42.0,-48.0,-51.0,-48.0,-43.0,-48.0,-91.0,-93.0,-90.0,-93.0,40.0,46.0,48.0,45.0,0
4942,CC:2F:71:3F:1F:24,4453023,1180263065,628820,697937239,3824203,482325826,37,517369,563028892,516745,562953784,624,75108,499688,10,629057,59122,34,449,130000.0,43333.0,-67.0,-65.0,-70.0,-67.0,-67.0,-65.0,-70.0,-67.0,-91.0,-93.0,-90.0,-93.0,24.0,28.0,20.0,26.0,0
4943,CC:2F:71:3E:C5:1F,3824956,482417867,753,92041,3824203,482325826,0,3156,265009,2604,199429,552,65580,797,8,1084,18,0,34,144444.0,39000.0,-78.0,-85.0,-75.0,-71.0,-71.0,-74.0,-69.0,-62.0,-91.0,-93.0,-90.0,-93.0,13.0,8.0,15.0,22.0,0
4944,BA:8C:B9:54:50:24,3828920,488475661,4717,6149835,3824203,482325826,0,8277,1644382,8255,1640887,22,3495,2320,14,5092,36,0,53,216660.0,130000.0,-46.0,-35.0,-40.0,-43.0,-43.0,-35.0,-42.0,-47.0,-91.0,-93.0,-90.0,-93.0,45.0,58.0,50.0,50.0,0
4945,92:69:1D:31:68:E9,3827854,485835537,3645,3509105,3824209,482326432,0,4017,995183,3903,969628,114,25555,1931,6,3771,79,0,35,216660.0,130000.0,-52.0,-50.0,-44.0,-46.0,-51.0,-49.0,-44.0,-47.0,-91.0,-94.0,-90.0,-93.0,39.0,44.0,46.0,47.0,0
4946,CC:2F:71:3F:1F:24,4453073,1180278457,628864,697952025,3824209,482326432,37,517396,563033952,516772,562958844,624,75108,499715,10,629101,59126,34,449,130000.0,43333.0,-67.0,-65.0,-70.0,-68.0,-67.0,-65.0,-70.0,-67.0,-91.0,-94.0,-90.0,-93.0,24.0,29.0,20.0,25.0,0
4947,CC:2F:71:3E:C5:1F,3824963,482418589,754,92157,3824209,482326432,0,3158,265149,2606,199569,552,65580,797,8,1085,18,0,34,144444.0,39000.0,-70.0,-71.0,-67.0,-60.0,-70.0,-72.0,-68.0,-61.0,-91.0,-94.0,-90.0,-93.0,21.0,23.0,23.0,33.0,0
4948,BA:8C:B9:54:50:24,3828928,488476656,4718,6149951,3824210,482326705,0,8283,1644790,8261,1641295,22,3495,2320,14,5093,36,0,53,216660.0,130000.0,-39.0,-36.0,-45.0,-52.0,-42.0,-35.0,-42.0,-46.0,-91.0,-94.0,-90.0,-93.0,52.0,58.0,45.0,41.0,0
4949,92:69:1D:31:68:E9,3827857,485836012,3645,3509105,3824212,482326907,0,4017,995183,3903,969628,114,25555,1931,6,3771,79,0,35,216660.0,130000.0,-52.0,-50.0,-44.0,-46.0,-51.0,-49.0,-44.0,-47.0,-91.0,-94.0,-90.0,-93.0,39.0,44.0,46.0,47.0,0
4950,CC:2F:71:3F:1F:24,4453118,1180293352,628905,697966385,3824213,482326967,37,517421,563038756,516797,562963648,624,75108,499740,10,629142,59144,34,449,130000.0,39000.0,-67.0,-65.0,-70.0,-68.0,-67.0,-65.0,-70.0,-67.0,-91.0,-94.0,-90.0,-93.0,24.0,29.0,20.0,25.0,0
4951,CC:2F:71:3E:C5:1F,3824967,482419124,754,92157,3824213,482326967,0,3158,265149,2606,199569,552,65580,797,8,1085,18,0,34,144444.0,39000.0,-70.0,-71.0,-67.0,-60.0,-70.0,-72.0,-68.0,-61.0,-91.0,-94.0,-90.0,-93.0,21.0,23.0,23.0,33.0,0
4952,BA:8C:B9:54:50:24,3828931,488476918,4718,6149951,3824213,482326967,0,8284,1644858,8262,1641363,22,3495,2320,14,5093,36,0,53,216660.0,130000.0,-39.0,-36.0,-45.0,-52.0,-40.0,-35.0,-43.0,-47.0,-91.0,-94.0,-90.0,-93.0,52.0,58.0,45.0,41.0,0
4953,92:69:1D:31:68:E9,3827864,485836678,3645,3509105,3824219,482327573,0,4017,995183,3903,969628,114,25555,1931,6,3771,79,0,35,216660.0,130000.0,-52.0,-50.0,-44.0,-46.0,-51.0,-49.0,-44.0,-47.0,-91.0,-94.0,-90.0,-93.0,39.0,44.0,46.0,47.0,0
4954,CC:2F:71:3F:1F:24,4453166,1180308386,628947,697980813,3824219,482327573,37,517449,563043956,516825,562968848,624,75108,499768,10,629184,59160,34,449,130000.0,43333.0,-67.0,-65.0,-70.0,-67.0,-67.0,-65.0,-70.0,-67.0,-91.0,-94.0,-90.0,-93.0,24.0,29.0,20.0,26.0,0
4955,CC:2F:71:3E:C5:1F,3824973,482419730,754,92157,3824219,482327573,0,3158,265149,2606,199569,552,65580,797,8,1085,18,0,34,144444.0,39000.0,-70.0,-71.0,-67.0,-60.0,-70.0,-72.0,-68.0,-61.0,-91.0,-94.0,-90.0,-93.0,21.0,23.0,23.0,33.0,0
4956,BA:8C:B9:54:50:24,3828937,488477524,4718,6149951,3824219,482327573,0,8284,1644858,8262,1641363,22,3495,2320,14,5093,36,0,53,216660.0,130000.0,-39.0,-36.0,-45.0,-52.0,-40.0,-35.0,-43.0,-47.0,-91.0,-94.0,-90.0,-93.0,52.0,58.0,45.0,41.0,0
4957,92:69:1D:31:68:E9,3827866,485836880,3645,3509105,3824221,482327775,0,4017,995183,3903,969628,114,25555,1931,6,3771,79,0,35,216660.0,130000.0,-52.0,-50.0,-44.0,-46.0,-51.0,-49.0,-44.0,-47.0,-91.0,-94.0,-90.0,-93.0,39.0,44.0,46.0,47.0,0
4958,CC:2F:71:3F:1F:24,4453209,1180322836,628988,697995061,3824221,482327775,37,517477,563049132,516853,562974024,624,75108,499796,10,629225,59176,34,449,130000.0,39000.0,-67.0,-65.0,-70.0,-67.0,-67.0,-65.0,-70.0,-67.0,-91.0,-94.0,-90.0,-93.0,24.0,29.0,20.0,26.0,0
4959,CC:2F:71:3E:C5:1F,3824975,482419932,754,92157,3824221,482327775,0,3158,265149,2606,199569,552,65580,797,8,1085,18,0,34,144444.0,39000.0,-70.0,-71.0,-67.0,-60.0,-70.0,-72.0,-68.0,-61.0,-91.0,-94.0,-90.0,-93.0,21.0,23.0,23.0,33.0,0
4960,BA:8C:B9:54:50:24,3828939,488477726,4718,6149951,3824221,482327775,0,8284,1644858,8262,1641363,22,3495,2320,14,5093,36,0,53,216660.0,130000.0,-39.0,-36.0,-45.0,-52.0,-40.0,-35.0,-43.0,-47.0,-91.0,-94.0,-90.0,-93.0,52.0,58.0,45.0,41.0,0
4961,92:69:1D:31:68:E9,3827873,485837546,3645,3509105,3824228,482328441,0,4017,995183,3903,969628,114,25555,1931,6,3771,79,0,35,216660.0,130000.0,-52.0,-50.0,-44.0,-46.0,-51.0,-49.0,-44.0,-47.0,-91.0,-94.0,-90.0,-93.0,39.0,44.0,46.0,47.0,0
4962,CC:2F:71:3F:1F:24,4453259,1180338060,629031,698009619,3824228,482328441,37,517504,563054216,516880,562979108,624,75108,499823,10,629268,59176,34,449,130000.0,43333.0,-67.0,-65.0,-70.0,-67.0,-67.0,-65.0,-70.0,-67.0,-91.0,-94.0,-90.0,-93.0,24.0,29.0,20.0,26.0,0
4963,CC:2F:71:3E:C5:1F,3824982,482420598,754,92157,3824228,482328441,0,3158,265149,2606,199569,552,65580,797,8,1085,18,0,34,144444.0,39000.0,-70.0,-71.0,-67.0,-60.0,-70.0,-72.0,-68.0,-61.0,-91.0,-94.0,-90.0,-93.0,21.0,23.0,23.0,33.0,0
4964,BA:8C:B9:54:50:24,3828946,488478392,4718,6149951,3824228,482328441,0,8284,1644858,8262,1641363,22,3495,2320,14,5093,36,0,53,216660.0,130000.0,-39.0,-36.0,-45.0,-52.0,-40.0,-35.0,-43.0,-47.0,-91.0,-94.0,-90.0,-93.0,52.0,58.0,45.0,41.0,0
4965,92:69:1D:31:68:E9,3827875,485837748,3645,3509105,3824230,482328643,0,4019,995319,3905,969764,114,25555,1931,6,3772,79,0,35,216660.0,130000.0,-51.0,-47.0,-43.0,-49.0,-51.0,-49.0,-43.0,-47.0,-91.0,-94.0,-90.0,-93.0,40.0,47.0,47.0,44.0,0
4966,CC:2F:71:3F:1F:24,4453302,1180352566,629072,698023923,3824230,482328643,37,517530,563059160,516906,562984052,624,75108,499849,10,629309,59191,34,449,117000.0,39000.0,-67.0,-65.0,-70.0,-67.0,-67.0,-65.0,-70.0,-67.0,-91.0,-94.0,-90.0,-93.0,24.0,29.0,20.0,26.0,0
4967,CC:2F:71:3E:C5:1F,3824984,482420800,754,92157,3824230,482328643,0,3160,265289,2608,199709,552,65580,797,8,1086,18,0,34,144444.0,39000.0,-70.0,-71.0,-68.0,-60.0,-71.0,-72.0,-68.0,-61.0,-91.0,-94.0,-90.0,-93.0,21.0,23.0,22.0,33.0,0
4968,BA:8C:B9:54:50:24,3828948,488478594,4718,6149951,3824230,482328643,0,8284,1644858,8262,1641363,22,3495,2320,14,5093,36,0,53,216660.0,130000.0,-39.0,-36.0,-45.0,-52.0,-40.0,-35.0,-43.0,-47.0,-91.0,-94.0,-90.0,-93.0,52.0,58.0,45.0,41.0,0
4969,92:69:1D:31:68:E9,3827879,485838152,3645,3509105,3824234,482329047,0,4019,995319,3905,969764,114,25555,1931,6,3772,79,0,35,216660.0,130000.0,-51.0,-47.0,-43.0,-49.0,-51.0,-49.0,-43.0,-47.0,-91.0,-94.0,-90.0,-93.0,40.0,47.0,47.0,44.0,0
4970,CC:2F:71:3F:1F:24,4453349,1180367476,629113,698038227,3824236,482329249,37,517555,563063964,516931,562988856,624,75108,499874,10,629350,59195,34,449,130000.0,43333.0,-67.0,-65.0,-71.0,-67.0,-67.0,-65.0,-70.0,-67.0,-91.0,-94.0,-90.0,-93.0,24.0,29.0,19.0,26.0,0
4971,CC:2F:71:3E:C5:1F,3824990,482421406,754,92157,3824236,482329249,0,3160,265289,2608,199709,552,65580,797,8,1086,18,0,34,144444.0,39000.0,-70.0,-71.0,-68.0,-60.0,-71.0,-72.0,-68.0,-61.0,-91.0,-94.0,-90.0,-93.0,21.0,23.0,22.0,33.0,0
4972,BA:8C:B9:54:50:24,3828954,488479200,4718,6149951,3824236,482329249,0,8284,1644858,8262,1641363,22,3495,2320,14,5093,36,0,53,216660.0,130000.0,-39.0,-36.0,-45.0,-52.0,-40.0,-35.0,-43.0,-47.0,-91.0,-94.0,-90.0,-93.0,52.0,58.0,45.0,41.0,0
4973,92:69:1D:31:68:E9,3827884,485838616,3645,3509105,3824239,482329511,0,4019,995319,3905,969764,114,25555,1931,6,3772,79,0,35,216660.0,130000.0,-51.0,-47.0,-43.0,-49.0,-51.0,-49.0,-43.0,-47.0,-91.0,-94.0,-90.0,-93.0,40.0,47.0,47.0,44.0,0
4974,CC:2F:71:3F:1F:24,4453393,1180382154,629154,698052643,3824239,482329511,37,517581,563068908,516957,562993800,624,75108,499900,10,629391,59198,34,449,130000.0,43333.0,-67.0,-65.0,-70.0,-68.0,-67.0,-65.0,-70.0,-67.0,-91.0,-94.0,-90.0,-93.0,24.0,29.0,20.0,25.0,0
4975,CC:2F:71:3E:C5:1F,3824993,482421668,754,92157,3824239,482329511,0,3160,265289,2608,199709,552,65580,797,8,1086,18,0,34,144444.0,39000.0,-70.0,-71.0,-68.0,-60.0,-71.0,-72.0,-68.0,-61.0,-91.0,-94.0,-90.0,-93.0,21.0,23.0,22.0,33.0,0
4976,BA:8C:B9:54:50:24,3828957,488479462,4718,6149951,3824239,482329511,0,8290,1645266,8268,1641771,22,3495,2320,14,5093,36,0,53,216660.0,130000.0,-39.0,-36.0,-45.0,-51.0,-41.0,-35.0,-44.0,-49.0,-91.0,-94.0,-90.0,-93.0,52.0,58.0,45.0,42.0,0
4977,92:69:1D:31:68:E9,3827889,485839082,3645,3509105,3824244,482329977,0,4019,995319,3905,969764,114,25555,1931,6,3772,79,0,35,216660.0,130000.0,-51.0,-47.0,-43.0,-49.0,-51.0,-49.0,-43.0,-47.0,-91.0,-94.0,-90.0,-93.0,40.0,47.0,47.0,44.0,0
4978,CC:2F:71:3F:1F:24,4453441,1180397126,629195,698066947,3824246,482330179,37,517608,563073946,516983,562998720,625,75226,499927,10,629432,59218,34,449,117000.0,39000.0,-67.0,-65.0,-70.0,-68.0,-67.0,-65.0,-70.0,-67.0,-91.0,-94.0,-90.0,-93.0,24.0,29.0,20.0,25.0,0
4979,CC:2F:71:3E:C5:1F,3825000,482422336,754,92157,3824246,482330179,0,3160,265289,2608,199709,552,65580,797,8,1086,18,0,34,144444.0,39000.0,-70.0,-71.0,-68.0,-60.0,-71.0,-72.0,-68.0,-61.0,-91.0,-94.0,-90.0,-93.0,21.0,23.0,22.0,33.0,0
4980,BA:8C:B9:54:50:24,3828964,488480130,4718,6149951,3824246,482330179,0,8290,1645266,8268,1641771,22,3495,2320,14,5093,36,0,53,216660.0,130000.0,-39.0,-36.0,-45.0,-51.0,-41.0,-35.0,-44.0,-49.0,-91.0,-94.0,-90.0,-93.0,52.0,58.0,45.0,42.0,0
4981,92:69:1D:31:68:E9,3827894,485839546,3645,3509105,3824249,482330441,0,4019,995319,3905,969764,114,25555,1931,6,3772,79,0,35,216660.0,130000.0,-51.0,-47.0,-43.0,-49.0,-51.0,-49.0,-43.0,-47.0,-91.0,-94.0,-90.0,-93.0,40.0,47.0,47.0,44.0,0
4982,CC:2F:71:3F:1F:24,4453487,1180411940,629238,698081499,3824249,482330441,37,517634,563078890,517009,563003664,625,75226,499953,10,629475,59219,34,449,130000.0,43333.0,-67.0,-65.0,-70.0,-67.0,-67.0,-65.0,-70.0,-67.0,-91.0,-94.0,-90.0,-93.0,24.0,29.0,20.0,26.0,0
4983,CC:2F:71:3E:C5:1F,3825003,482422598,754,92157,3824249,482330441,0,3160,265289,2608,199709,552,65580,797,8,1086,18,0,34,144444.0,39000.0,-70.0,-71.0,-68.0,-60.0,-71.0,-72.0,-68.0,-61.0,-91.0,-94.0,-90.0,-93.0,21.0,23.0,22.0,33.0,0
4984,BA:8C:B9:54:50:24,3828967,488480392,4718,6149951,3824249,482330441,0,8290,1645266,8268,1641771,22,3495,2320,14,5093,36,0,53,216660.0,130000.0,-39.0,-36.0,-45.0,-51.0,-41.0,-35.0,-44.0,-49.0,-91.0,-94.0,-90.0,-93.0,52.0,58.0,45.0,42.0,0
4985,92:69:1D:31:68:E9,3827901,485840214,3645,3509105,3824256,482331109,0,4019,995319,3905,969764,114,25555,1931,6,3772,79,0,35,216660.0,130000.0,-51.0,-47.0,-43.0,-49.0,-51.0,-49.0,-43.0,-47.0,-91.0,-94.0,-90.0,-93.0,40.0,47.0,47.0,44.0,0
4986,CC:2F:71:3F:1F:24,4453535,1180426912,629279,698095803,3824256,482331109,37,517659,563083694,517034,563008468,625,75226,499978,10,629516,59240,34,449,117000.0,39000.0,-67.0,-65.0,-70.0,-68.0,-67.0,-65.0,-70.0,-67.0,-91.0,-94.0,-90.0,-93.0,24.0,29.0,20.0,25.0,0
4987,CC:2F:71:3E:C5:1F,3825010,482423266,754,92157,3824256,482331109,0,3162,265477,2609,199779,553,65698,798,8,1086,18,0,34,144444.0,39000.0,-78.0,-85.0,-75.0,-71.0,-72.0,-74.0,-69.0,-62.0,-91.0,-94.0,-90.0,-93.0,13.0,9.0,15.0,22.0,0
4988,BA:8C:B9:54:50:24,3828974,488481060,4718,6149951,3824256,482331109,0,8290,1645266,8268,1641771,22,3495,2320,14,5093,36,0,53,216660.0,130000.0,-39.0,-36.0,-45.0,-51.0,-41.0,-35.0,-44.0,-49.0,-91.0,-94.0,-90.0,-93.0,52.0,58.0,45.0,42.0,0
4989,92:69:1D:31:68:E9,3827903,485840416,3645,3509105,3824258,482331311,0,4019,995319,3905,969764,114,25555,1931,6,3772,79,0,35,216660.0,130000.0,-51.0,-47.0,-43.0,-49.0,-51.0,-49.0,-43.0,-47.0,-91.0,-94.0,-90.0,-93.0,40.0,47.0,47.0,44.0,0
4990,CC:2F:71:3F:1F:24,4453582,1180441808,629324,698110497,3824258,482331311,37,517687,563088894,517062,563013668,625,75226,500006,10,629561,59250,34,449,117000.0,39000.0,-67.0,-65.0,-70.0,-68.0,-67.0,-65.0,-70.0,-67.0,-91.0,-94.0,-90.0,-93.0,24.0,29.0,20.0,25.0,0
4991,CC:2F:71:3E:C5:1F,3825012,482423468,754,92157,3824258,482331311,0,3162,265477,2609,199779,553,65698,798,8,1086,18,0,34,144444.0,39000.0,-78.0,-85.0,-75.0,-71.0,-72.0,-74.0,-69.0,-62.0,-91.0,-94.0,-90.0,-93.0,13.0,9.0,15.0,22.0,0
4992,BA:8C:B9:54:50:24,3828976,488481262,4718,6149951,3824258,482331311,0,8290,1645266,8268,1641771,22,3495,2320,14,5093,36,0,53,216660.0,130000.0,-39.0,-36.0,-45.0,-51.0,-41.0,-35.0,-44.0,-49.0,-91.0,-94.0,-90.0,-93.0,52.0,58.0,45.0,42.0,0
4993,92:69:1D:31:68:E9,3827911,485841208,3645,3509105,3824266,482332103,0,4019,995319,3905,969764,114,25555,1931,6,3772,79,0,35,216660.0,130000.0,-51.0,-47.0,-43.0,-49.0,-51.0,-49.0,-43.0,-47.0,-91.0,-94.0,-90.0,-93.0,40.0,47.0,47.0,44.0,0
4994,CC:2F:71:3F:1F:24,4453631,1180456960,629365,698124857,3824266,482332103,37,517712,563093698,517087,563018472,625,75226,500031,10,629602,59259,34,449,130000.0,43333.0,-67.0,-65.0,-70.0,-67.0,-67.0,-65.0,-70.0,-67.0,-91.0,-94.0,-90.0,-93.0,24.0,29.0,20.0,26.0,0
4995,CC:2F:71:3E:C5:1F,3825020,482424260,754,92157,3824266,482332103,0,3162,265477,2609,199779,553,65698,798,8,1086,18,0,34,144444.0,39000.0,-78.0,-85.0,-75.0,-71.0,-72.0,-74.0,-69.0,-62.0,-91.0,-94.0,-90.0,-93.0,13.0,9.0,15.0,22.0,0
4996,BA:8C:B9:54:50:24,3828984,488482054,4718,6149951,3824266,482332103,0,8291,1645334,8269,1641839,22,3495,2320,14,5093,36,0,53,216660.0,130000.0,-39.0,-36.0,-44.0,-51.0,-41.0,-35.0,-44.0,-49.0,-91.0,-94.0,-90.0,-93.0,52.0,58.0,46.0,42.0,0
4997,92:69:1D:31:68:E9,3827913,485841410,3645,3509105,3824268,482332305,0,4019,995319,3905,969764,114,25555,1931,6,3772,79,0,35,216660.0,130000.0,-51.0,-47.0,-43.0,-49.0,-51.0,-49.0,-43.0,-47.0,-91.0,-94.0,-90.0,-93.0,40.0,47.0,47.0,44.0,0
4998,CC:2F:71:3F:1F:24,4453675,1180471534,629407,698139229,3824268,482332305,37,517739,563098758,517114,563023532,625,75226,500058,10,629644,59288,34,449,144444.0,39000.0,-67.0,-65.0,-70.0,-67.0,-67.0,-65.0,-70.0,-67.0,-91.0,-94.0,-90.0,-93.0,24.0,29.0,20.0,26.0,0
4999,CC:2F:71:3E:C5:1F,3825022,482424462,754,92157,3824268,482332305,0,3162,265477,2609,199779,553,65698,798,8,1086,18,0,34,144444.0,39000.0,-78.0,-85.0,-75.0,-71.0,-72.0,-74.0,-69.0,-62.0,-91.0,-94.0,-90.0,-93.0,13.0,9.0,15.0,22.0,0
5000,BA:8C:B9:54:50:24,3828986,488482256,4718,6149951,3824268,482332305,0,8294,1645538,8272,1642043,22,3495,2320,14,5093,36,0,53,216660.0,130000.0,-39.0,-36.0,-44.0,-51.0,-40.0,-35.0,-44.0,-50.0,-91.0,-94.0,-90.0,-93.0,52.0,58.0,46.0,42.0,0
5001,92:69:1D:31:68:E9,3827920,485842289,3645,3509105,3824275,482333184,0,4019,995319,3905,969764,114,25555,1931,6,3772,79,0,35,216660.0,130000.0,-51.0,-47.0,-43.0,-49.0,-51.0,-49.0,-43.0,-47.0,-91.0,-94.0,-90.0,-93.0,40.0,47.0,47.0,44.0,0
5002,CC:2F:71:3F:1F:24,4453725,1180487341,629450,698154157,3824275,482333184,37,517766,563103852,517141,563028626,625,75226,500085,10,629687,59310,34,449,130000.0,43333.0,-67.0,-65.0,-70.0,-68.0,-67.0,-65.0,-70.0,-67.0,-91.0,-94.0,-90.0,-93.0,24.0,29.0,20.0,25.0,0
5003,CC:2F:71:3E:C5:1F,3825030,482425401,754,92157,3824276,482333244,0,3162,265477,2609,199779,553,65698,798,8,1086,18,0,34,144444.0,39000.0,-78.0,-85.0,-75.0,-71.0,-72.0,-74.0,-69.0,-62.0,-91.0,-94.0,-90.0,-93.0,13.0,9.0,15.0,22.0,0
5004,BA:8C:B9:54:50:24,3828994,488483195,4718,6149951,3824276,482333244,0,8294,1645538,8272,1642043,22,3495,2320,14,5093,36,0,53,216660.0,130000.0,-39.0,-36.0,-44.0,-51.0,-40.0,-35.0,-44.0,-50.0,-91.0,-94.0,-90.0,-93.0,52.0,58.0,46.0,42.0,0
5005,92:69:1D:31:68:E9,3827923,485842551,3645,3509105,3824278,482333446,0,4019,995319,3905,969764,114,25555,1931,6,3772,79,0,35,216660.0,130000.0,-51.0,-47.0,-43.0,-49.0,-51.0,-49.0,-43.0,-47.0,-91.0,-94.0,-90.0,-93.0,40.0,47.0,47.0,44.0,0
5006,CC:2F:71:3F:1F:24,4453770,1180502143,629492,698168697,3824278,482333446,37,517791,563108656,517166,563033430,625,75226,500110,10,629729,59314,34,449,130000.0,43333.0,-67.0,-65.0,-70.0,-68.0,-67.0,-65.0,-70.0,-67.0,-91.0,-94.0,-90.0,-93.0,24.0,29.0,20.0,25.0,0
5007,CC:2F:71:3E:C5:1F,3825032,482425603,754,92157,3824278,482333446,0,3162,265477,2609,199779,553,65698,798,8,1086,18,0,34,144444.0,39000.0,-78.0,-85.0,-75.0,-71.0,-72.0,-74.0,-69.0,-62.0,-91.0,-94.0,-90.0,-93.0,13.0,9.0,15.0,22.0,0
5008,BA:8C:B9:54:50:24,3828996,488483397,4718,6149951,3824278,482333446,0,8294,1645538,8272,1642043,22,3495,2320,14,5093,36,0,53,216660.0,130000.0,-39.0,-36.0,-44.0,-51.0,-40.0,-35.0,-44.0,-50.0,-91.0,-94.0,-90.0,-93.0,52.0,58.0,46.0,42.0,0
5009,92:69:1D:31:68:E9,3827929,485843157,3645,3509105,3824284,482334052,0,4019,995319,3905,969764,114,25555,1931,6,3772,79,0,35,216660.0,130000.0,-51.0,-47.0,-43.0,-49.0,-51.0,-49.0,-43.0,-47.0,-91.0,-94.0,-90.0,-93.0,40.0,47.0,47.0,44.0,0
5010,CC:2F:71:3F:1F:24,4453820,1180517431,629536,698183379,3824284,482334052,37,517816,563113460,517191,563038234,625,75226,500135,10,629773,59344,34,449,144444.0,43333.0,-67.0,-65.0,-70.0,-67.0,-67.0,-65.0,-70.0,-67.0,-91.0,-94.0,-90.0,-93.0,24.0,29.0,20.0,26.0,0
5011,CC:2F:71:3E:C5:1F,3825038,482426209,754,92157,3824284,482334052,0,3162,265477,2609,199779,553,65698,798,8,1086,18,0,34,144444.0,39000.0,-78.0,-85.0,-75.0,-71.0,-72.0,-74.0,-69.0,-62.0,-91.0,-94.0,-90.0,-93.0,13.0,9.0,15.0,22.0,0
5012,BA:8C:B9:54:50:24,3829002,488484003,4718,6149951,3824284,482334052,0,8294,1645538,8272,1642043,22,3495,2320,14,5093,36,0,53,216660.0,130000.0,-39.0,-36.0,-44.0,-51.0,-40.0,-35.0,-44.0,-50.0,-91.0,-94.0,-90.0,-93.0,52.0,58.0,46.0,42.0,0
5013,92:69:1D:31:68:E9,3827932,485843419,3645,3509105,3824287,482334314,0,4019,995319,3905,969764,114,25555,1931,6,3772,79,0,35,216660.0,130000.0,-51.0,-47.0,-43.0,-49.0,-51.0,-49.0,-43.0,-47.0,-90.0,-93.0,-89.0,-93.0,39.0,46.0,46.0,44.0,0
5014,CC:2F:71:3F:1F:24,4453866,1180532245,629579,698197931,3824287,482334314,37,517845,563118752,517220,563043526,625,75226,500164,10,629816,59356,34,449,130000.0,43333.0,-67.0,-65.0,-70.0,-67.0,-67.0,-65.0,-70.0,-67.0,-90.0,-93.0,-89.0,-93.0,23.0,28.0,19.0,26.0,0
5015,CC:2F:71:3E:C5:1F,3825041,482426471,754,92157,3824287,482334314,0,3162,265477,2609,199779,553,65698,798,8,1086,18,0,34,144444.0,39000.0,-78.0,-85.0,-75.0,-71.0,-72.0,-74.0,-69.0,-62.0,-90.0,-93.0,-89.0,-93.0,12.0,8.0,14.0,22.0,0
5016,BA:8C:B9:54:50:24,3829005,488484265,4718,6149951,3824287,482334314,0,8296,1645674,8274,1642179,22,3495,2320,14,5093,36,0,53,216660.0,130000.0,-39.0,-36.0,-44.0,-52.0,-39.0,-36.0,-44.0,-51.0,-90.0,-93.0,-89.0,-93.0,51.0,57.0,45.0,41.0,0
5017,92:69:1D:31:68:E9,3827937,485843891,3645,3509105,3824292,482334786,0,4019,995319,3905,969764,114,25555,1931,6,3772,79,0,35,216660.0,130000.0,-51.0,-47.0,-43.0,-49.0,-51.0,-49.0,-43.0,-47.0,-90.0,-92.0,-89.0,-92.0,39.0,45.0,46.0,43.0,0
5018,CC:2F:71:3F:1F:24,4453916,1180547533,629623,698212613,3824293,482334920,37,517871,563123672,517246,563048446,625,75226,500190,10,629860,59372,34,449,130000.0,39000.0,-67.0,-65.0,-70.0,-67.0,-67.0,-65.0,-70.0,-67.0,-90.0,-92.0,-89.0,-92.0,23.0,27.0,19.0,25.0,0
5019,CC:2F:71:3E:C5:1F,3825047,482427077,754,92157,3824293,482334920,0,3162,265477,2609,199779,553,65698,798,8,1086,18,0,34,144444.0,39000.0,-78.0,-85.0,-75.0,-71.0,-72.0,-74.0,-69.0,-62.0,-90.0,-92.0,-89.0,-92.0,12.0,7.0,14.0,21.0,0
5020,BA:8C:B9:54:50:24,3829011,488484871,4718,6149951,3824293,482334920,0,8296,1645674,8274,1642179,22,3495,2320,14,5093,36,0,53,216660.0,130000.0,-39.0,-36.0,-44.0,-52.0,-39.0,-36.0,-44.0,-51.0,-90.0,-92.0,-89.0,-92.0,51.0,56.0,45.0,40.0,0
5021,92:69:1D:31:68:E9,3827940,485844227,3645,3509105,3824295,482335122,0,4019,995319,3905,969764,114,25555,1931,6,3772,79,0,35,216660.0,130000.0,-51.0,-47.0,-43.0,-49.0,-51.0,-49.0,-43.0,-47.0,-90.0,-92.0,-89.0,-92.0,39.0,45.0,46.0,43.0,0
5022,CC:2F:71:3F:1F:24,4453961,1180562231,629666,698227109,3824295,482335122,37,517898,563128756,517273,563053530,625,75226,500217,10,629903,59388,34,449,130000.0,39000.0,-67.0,-65.0,-70.0,-67.0,-67.0,-65.0,-70.0,-67.0,-90.0,-92.0,-89.0,-92.0,23.0,27.0,19.0,25.0,0
5023,CC:2F:71:3E:C5:1F,3825049,482427279,754,92157,3824295,482335122,0,3162,265477,2609,199779,553,65698,798,8,1086,18,0,34,144444.0,39000.0,-78.0,-85.0,-75.0,-71.0,-72.0,-74.0,-69.0,-62.0,-90.0,-92.0,-89.0,-92.0,12.0,7.0,14.0,21.0,0
5024,BA:8C:B9:54:50:24,3829013,488485073,4718,6149951,3824295,482335122,0,8296,1645674,8274,1642179,22,3495,2320,14,5093,36,0,53,216660.0,130000.0,-39.0,-36.0,-44.0,-52.0,-39.0,-36.0,-44.0,-51.0,-90.0,-92.0,-89.0,-92.0,51.0,56.0,45.0,40.0,0
5025,92:69:1D:31:68:E9,3827945,485844691,3645,3509105,3824300,482335586,0,4019,995319,3905,969764,114,25555,1931,6,3772,79,0,35,216660.0,130000.0,-51.0,-47.0,-43.0,-49.0,-51.0,-49.0,-43.0,-47.0,-90.0,-92.0,-89.0,-92.0,39.0,45.0,46.0,43.0,0
5026,CC:2F:71:3F:1F:24,4454008,1180577077,629706,698241289,3824302,482335788,37,517924,563133676,517299,563058450,625,75226,500243,10,629943,59400,34,449,130000.0,39000.0,-67.0,-65.0,-71.0,-67.0,-67.0,-65.0,-70.0,-67.0,-90.0,-92.0,-89.0,-92.0,23.0,27.0,18.0,25.0,0
5027,CC:2F:71:3E:C5:1F,3825056,482427945,754,92157,3824302,482335788,0,3162,265477,2609,199779,553,65698,798,8,1086,18,0,34,144444.0,39000.0,-78.0,-85.0,-75.0,-71.0,-72.0,-74.0,-69.0,-62.0,-90.0,-92.0,-89.0,-92.0,12.0,7.0,14.0,21.0,0
5028,BA:8C:B9:54:50:24,3829020,488485739,4718,6149951,3824302,482335788,0,8296,1645674,8274,1642179,22,3495,2320,14,5093,36,0,53,216660.0,130000.0,-39.0,-36.0,-44.0,-52.0,-39.0,-36.0,-44.0,-51.0,-90.0,-92.0,-89.0,-92.0,51.0,56.0,45.0,40.0,0
5029,92:69:1D:31:68:E9,3827949,485845095,3645,3509105,3824304,482335990,0,4019,995319,3905,969764,114,25555,1931,6,3772,79,0,35,216660.0,130000.0,-51.0,-47.0,-43.0,-49.0,-51.0,-49.0,-43.0,-47.0,-90.0,-92.0,-89.0,-93.0,39.0,45.0,46.0,44.0,0
5030,CC:2F:71:3F:1F:24,4454053,1180591887,629749,698255897,3824304,482335990,37,517949,563138480,517324,563063254,625,75226,500268,10,629986,59402,34,449,130000.0,43333.0,-67.0,-65.0,-70.0,-67.0,-67.0,-65.0,-70.0,-67.0,-90.0,-92.0,-89.0,-93.0,23.0,27.0,19.0,26.0,0
5031,CC:2F:71:3E:C5:1F,3825058,482428147,754,92157,3824304,482335990,0,3162,265477,2609,199779,553,65698,798,8,1086,18,0,34,144444.0,39000.0,-78.0,-85.0,-75.0,-71.0,-72.0,-74.0,-69.0,-62.0,-90.0,-92.0,-89.0,-93.0,12.0,7.0,14.0,22.0,0
5032,BA:8C:B9:54:50:24,3829022,488485941,4718,6149951,3824304,482335990,0,8296,1645674,8274,1642179,22,3495,2320,14,5093,36,0,53,216660.0,130000.0,-39.0,-36.0,-44.0,-52.0,-39.0,-36.0,-44.0,-51.0,-90.0,-92.0,-89.0,-93.0,51.0,56.0,45.0,41.0,0
5033,92:69:1D:31:68:E9,3827953,485845499,3645,3509105,3824308,482336394,0,4020,995387,3906,969832,114,25555,1931,6,3772,79,0,35,216660.0,130000.0,-52.0,-50.0,-44.0,-46.0,-51.0,-49.0,-44.0,-47.0,-90.0,-92.0,-89.0,-93.0,38.0,42.0,45.0,47.0,0
5034,CC:2F:71:3F:1F:24,4454100,1180606835,629791,698270381,3824309,482336454,37,517975,563143424,517350,563068198,625,75226,500294,10,630028,59421,34,449,130000.0,39000.0,-67.0,-65.0,-70.0,-68.0,-67.0,-65.0,-70.0,-67.0,-90.0,-92.0,-89.0,-93.0,23.0,27.0,19.0,25.0,0
5035,CC:2F:71:3E:C5:1F,3825065,482428813,754,92157,3824311,482336656,0,3162,265477,2609,199779,553,65698,798,8,1086,18,0,34,144444.0,39000.0,-78.0,-85.0,-75.0,-71.0,-72.0,-74.0,-69.0,-62.0,-90.0,-92.0,-89.0,-93.0,12.0,7.0,14.0,22.0,0
5036,BA:8C:B9:54:50:24,3829029,488486607,4718,6149951,3824311,482336656,0,8296,1645674,8274,1642179,22,3495,2320,14,5093,36,0,53,216660.0,130000.0,-39.0,-36.0,-44.0,-52.0,-39.0,-36.0,-44.0,-51.0,-90.0,-92.0,-89.0,-93.0,51.0,56.0,45.0,41.0,0
5037,92:69:1D:31:68:E9,3827958,485845963,3645,3509105,3824313,482336858,0,4020,995387,3906,969832,114,25555,1931,6,3772,79,0,35,216660.0,130000.0,-52.0,-50.0,-44.0,-46.0,-51.0,-49.0,-44.0,-47.0,-90.0,-92.0,-89.0,-93.0,38.0,42.0,45.0,47.0,0
5038,CC:2F:71:3F:1F:24,4454147,1180621735,629834,698284877,3824313,482336858,37,518000,563148228,517375,563073002,625,75226,500319,10,630071,59436,34,449,130000.0,43333.0,-67.0,-65.0,-70.0,-67.0,-67.0,-65.0,-70.0,-67.0,-90.0,-92.0,-89.0,-93.0,23.0,27.0,19.0,26.0,0
5039,CC:2F:71:3E:C5:1F,3825067,482429015,754,92157,3824313,482336858,0,3162,265477,2609,199779,553,65698,798,8,1086,18,0,34,144444.0,39000.0,-78.0,-85.0,-75.0,-71.0,-72.0,-74.0,-69.0,-62.0,-90.0,-92.0,-89.0,-93.0,12.0,7.0,14.0,22.0,0
5040,BA:8C:B9:54:50:24,3829031,488486809,4718,6149951,3824313,482336858,0,8296,1645674,8274,1642179,22,3495,2320,14,5093,36,0,53,216660.0,130000.0,-39.0,-36.0,-44.0,-52.0,-39.0,-36.0,-44.0,-51.0,-90.0,-92.0,-89.0,-93.0,51.0,56.0,45.0,41.0,0
5041,92:69:1D:31:68:E9,3827962,485846367,3645,3509105,3824317,482337262,0,4020,995387,3906,969832,114,25555,1931,6,3772,79,0,35,216660.0,130000.0,-52.0,-50.0,-44.0,-46.0,-51.0,-49.0,-44.0,-47.0,-90.0,-92.0,-89.0,-93.0,38.0,42.0,45.0,47.0,0
5042,CC:2F:71:3F:1F:24,4454192,1180636499,629875,698299237,3824317,482337262,37,518026,563153172,517401,563077946,625,75226,500345,10,630112,59441,34,449,130000.0,39000.0,-67.0,-65.0,-70.0,-68.0,-67.0,-65.0,-70.0,-67.0,-90.0,-92.0,-89.0,-93.0,23.0,27.0,19.0,25.0,0
5043,CC:2F:71:3E:C5:1F,3825071,482429419,754,92157,3824317,482337262,0,3162,265477,2609,199779,553,65698,798,8,1086,18,0,34,144444.0,39000.0,-78.0,-85.0,-75.0,-71.0,-72.0,-74.0,-69.0,-62.0,-90.0,-92.0,-89.0,-93.0,12.0,7.0,14.0,22.0,0
5044,BA:8C:B9:54:50:24,3829037,488487415,4718,6149951,3824319,482337464,0,8296,1645674,8274,1642179,22,3495,2320,14,5093,36,0,53,216660.0,130000.0,-39.0,-36.0,-44.0,-52.0,-39.0,-36.0,-44.0,-51.0,-90.0,-92.0,-89.0,-93.0,51.0,56.0,45.0,41.0,0
5045,92:69:1D:31:68:E9,3827967,485846831,3645,3509105,3824322,482337726,0,4020,995387,3906,969832,114,25555,1931,6,3772,79,0,35,216660.0,130000.0,-52.0,-50.0,-44.0,-46.0,-51.0,-49.0,-44.0,-47.0,-90.0,-92.0,-89.0,-93.0,38.0,42.0,45.0,47.0,0
5046,CC:2F:71:3F:1F:24,4454239,1180651335,629917,698313609,3824322,482337726,37,518053,563158268,517428,563083042,625,75226,500372,10,630154,59478,34,449,130000.0,43333.0,-67.0,-65.0,-70.0,-67.0,-67.0,-65.0,-70.0,-67.0,-90.0,-92.0,-89.0,-93.0,23.0,27.0,19.0,26.0,0
5047,CC:2F:71:3E:C5:1F,3825076,482429883,754,92157,3824322,482337726,0,3162,265477,2609,199779,553,65698,798,8,1086,18,0,34,144444.0,39000.0,-78.0,-85.0,-75.0,-71.0,-72.0,-74.0,-69.0,-62.0,-90.0,-92.0,-89.0,-93.0,12.0,7.0,14.0,22.0,0
5048,BA:8C:B9:54:50:24,3829040,488487677,4718,6149951,3824322,482337726,0,8296,1645674,8274,1642179,22,3495,2320,14,5093,36,0,53,216660.0,130000.0,-39.0,-36.0,-44.0,-52.0,-39.0,-36.0,-44.0,-51.0,-90.0,-92.0,-89.0,-93.0,51.0,56.0,45.0,41.0,0
5049,92:69:1D:31:68:E9,3827972,485847351,3646,3509221,3824326,482338130,0,4022,995523,3908,969968,114,25555,1931,6,3773,79,0,35,216660.0,130000.0,-52.0,-50.0,-44.0,-46.0,-51.0,-48.0,-43.0,-47.0,-90.0,-92.0,-89.0,-93.0,38.0,42.0,45.0,47.0,0
5050,CC:2F:71:3F:1F:24,4454285,1180666265,629959,698328135,3824326,482338130,37,518079,563163248,517454,563088022,625,75226,500398,10,630196,59480,34,449,130000.0,43333.0,-67.0,-65.0,-70.0,-67.0,-67.0,-65.0,-70.0,-67.0,-90.0,-92.0,-89.0,-93.0,23.0,27.0,19.0,26.0,0
5051,CC:2F:71:3E:C5:1F,3825081,482430403,755,92273,3824326,482338130,0,3164,265617,2611,199919,553,65698,798,8,1087,18,0,34,144444.0,39000.0,-70.0,-71.0,-67.0,-60.0,-71.0,-72.0,-68.0,-61.0,-90.0,-92.0,-89.0,-93.0,20.0,21.0,22.0,33.0,0
5052,BA:8C:B9:54:50:24,3829047,488488399,4719,6150067,3824328,482338332,0,8298,1645810,8276,1642315,22,3495,2320,14,5094,36,0,53,216660.0,130000.0,-49.0,-35.0,-42.0,-45.0,-40.0,-35.0,-44.0,-50.0,-90.0,-92.0,-89.0,-93.0,41.0,57.0,47.0,48.0,0
5053,92:69:1D:31:68:E9,3827977,485848028,3646,3509221,3824331,482338807,0,4022,995523,3908,969968,114,25555,1931,6,3773,79,0,35,216660.0,130000.0,-52.0,-50.0,-44.0,-46.0,-51.0,-48.0,-43.0,-47.0,-90.0,-92.0,-89.0,-92.0,38.0,42.0,45.0,46.0,0
5054,CC:2F:71:3F:1F:24,4454332,1180681432,630001,698342625,3824331,482338807,37,518106,563168308,517481,563093082,625,75226,500425,10,630238,59501,34,449,130000.0,39000.0,-67.0,-65.0,-70.0,-67.0,-67.0,-65.0,-70.0,-67.0,-90.0,-92.0,-89.0,-92.0,23.0,27.0,19.0,25.0,0
5055,CC:2F:71:3E:C5:1F,3825086,482431080,755,92273,3824331,482338807,0,3164,265617,2611,199919,553,65698,798,8,1087,18,0,34,144444.0,39000.0,-70.0,-71.0,-67.0,-60.0,-71.0,-72.0,-68.0,-61.0,-90.0,-92.0,-89.0,-92.0,20.0,21.0,22.0,32.0,0
5056,BA:8C:B9:54:50:24,3829051,488488934,4719,6150067,3824332,482338867,0,8298,1645810,8276,1642315,22,3495,2320,14,5094,36,0,53,216660.0,130000.0,-49.0,-35.0,-42.0,-45.0,-40.0,-35.0,-44.0,-50.0,-90.0,-92.0,-89.0,-92.0,41.0,57.0,47.0,47.0,0
5057,92:69:1D:31:68:E9,3827982,485848492,3646,3509221,3824336,482339271,0,4022,995523,3908,969968,114,25555,1931,6,3773,79,0,35,216660.0,130000.0,-52.0,-50.0,-44.0,-46.0,-51.0,-48.0,-43.0,-47.0,-90.0,-92.0,-89.0,-92.0,38.0,42.0,45.0,46.0,0
5058,CC:2F:71:3F:1F:24,4454378,1180696194,630042,698356923,3824336,482339271,37,518131,563173112,517506,563097886,625,75226,500450,10,630279,59518,34,449,130000.0,39000.0,-67.0,-65.0,-71.0,-67.0,-67.0,-65.0,-70.0,-67.0,-90.0,-92.0,-89.0,-92.0,23.0,27.0,18.0,25.0,0
5059,CC:2F:71:3E:C5:1F,3825091,482431544,755,92273,3824336,482339271,0,3164,265617,2611,199919,553,65698,798,8,1087,18,0,34,144444.0,39000.0,-70.0,-71.0,-67.0,-60.0,-71.0,-72.0,-68.0,-61.0,-90.0,-92.0,-89.0,-92.0,20.0,21.0,22.0,32.0,0
5060,BA:8C:B9:54:50:24,3829057,488489540,4719,6150067,3824338,482339473,0,8298,1645810,8276,1642315,22,3495,2320,14,5094,36,0,53,216660.0,130000.0,-49.0,-35.0,-42.0,-45.0,-40.0,-35.0,-44.0,-50.0,-90.0,-92.0,-89.0,-92.0,41.0,57.0,47.0,47.0,0
5061,92:69:1D:31:68:E9,3827986,485848896,3646,3509221,3824340,482339675,0,4022,995523,3908,969968,114,25555,1931,6,3773,79,0,35,216660.0,130000.0,-52.0,-50.0,-44.0,-46.0,-51.0,-48.0,-43.0,-47.0,-90.0,-92.0,-89.0,-92.0,38.0,42.0,45.0,46.0,0
5062,CC:2F:71:3F:1F:24,4454424,1180711082,630084,698371407,3824340,482339675,37,518157,563178056,517532,563102830,625,75226,500476,10,630321,59524,34,449,130000.0,43333.0,-67.0,-65.0,-70.0,-67.0,-67.0,-65.0,-70.0,-67.0,-90.0,-92.0,-89.0,-92.0,23.0,27.0,19.0,25.0,0
5063,CC:2F:71:3E:C5:1F,3825095,482431948,755,92273,3824340,482339675,0,3164,265617,2611,199919,553,65698,798,8,1087,18,0,34,144444.0,39000.0,-70.0,-71.0,-67.0,-60.0,-71.0,-72.0,-68.0,-61.0,-90.0,-92.0,-89.0,-92.0,20.0,21.0,22.0,32.0,0
5064,BA:8C:B9:54:50:24,3829059,488489742,4719,6150067,3824340,482339675,0,8298,1645810,8276,1642315,22,3495,2320,14,5094,36,0,53,216660.0,130000.0,-49.0,-35.0,-42.0,-45.0,-40.0,-35.0,-44.0,-50.0,-90.0,-92.0,-89.0,-92.0,41.0,57.0,47.0,47.0,0
5065,92:69:1D:31:68:E9,3827993,485849728,3646,3509221,3824347,482340507,0,4022,995523,3908,969968,114,25555,1931,6,3773,79,0,35,216660.0,130000.0,-52.0,-50.0,-44.0,-46.0,-51.0,-48.0,-43.0,-47.0,-90.0,-92.0,-89.0,-92.0,38.0,42.0,45.0,46.0,0
5066,CC:2F:71:3F:1F:24,4454474,1180726522,630127,698386015,3824347,482340507,37,518184,563183140,517559,563107914,625,75226,500503,10,630364,59539,34,449,130000.0,39000.0,-67.0,-65.0,-70.0,-67.0,-67.0,-65.0,-70.0,-67.0,-90.0,-92.0,-89.0,-92.0,23.0,27.0,19.0,25.0,0
5067,CC:2F:71:3E:C5:1F,3825102,482432780,755,92273,3824347,482340507,0,3164,265617,2611,199919,553,65698,798,8,1087,18,0,34,144444.0,39000.0,-70.0,-71.0,-67.0,-60.0,-71.0,-72.0,-68.0,-61.0,-90.0,-92.0,-89.0,-92.0,20.0,21.0,22.0,32.0,0
5068,BA:8C:B9:54:50:24,3829068,488490776,4719,6150067,3824349,482340709,0,8298,1645810,8276,1642315,22,3495,2320,14,5094,36,0,53,216660.0,130000.0,-49.0,-35.0,-42.0,-45.0,-40.0,-35.0,-44.0,-50.0,-90.0,-92.0,-89.0,-92.0,41.0,57.0,47.0,47.0,0
5069,92:69:1D:31:68:E9,3827997,485850132,3646,3509221,3824351,482340911,0,4022,995523,3908,969968,114,25555,1931,6,3773,79,0,35,216660.0,130000.0,-52.0,-50.0,-44.0,-46.0,-51.0,-48.0,-43.0,-47.0,-90.0,-92.0,-89.0,-92.0,38.0,42.0,45.0,46.0,0
5070,CC:2F:71:3F:1F:24,4454519,1180741174,630168,698400263,3824351,482340911,37,518209,563187944,517584,563112718,625,75226,500528,10,630405,59565,34,449,130000.0,43333.0,-67.0,-65.0,-70.0,-68.0,-67.0,-65.0,-70.0,-67.0,-90.0,-92.0,-89.0,-92.0,23.0,27.0,19.0,24.0,0
5071,CC:2F:71:3E:C5:1F,3825106,482433184,755,92273,3824351,482340911,0,3166,265757,2613,200059,553,65698,798,8,1088,18,0,34,144444.0,39000.0,-79.0,-86.0,-75.0,-71.0,-72.0,-74.0,-69.0,-62.0,-90.0,-92.0,-89.0,-92.0,11.0,6.0,14.0,21.0,0
5072,BA:8C:B9:54:50:24,3829070,488490978,4719,6150067,3824351,482340911,0,8301,1646014,8279,1642519,22,3495,2320,14,5095,36,0,53,216660.0,130000.0,-39.0,-36.0,-45.0,-52.0,-42.0,-35.0,-43.0,-48.0,-90.0,-92.0,-89.0,-92.0,51.0,56.0,44.0,40.0,0
5073,92:69:1D:31:68:E9,3828001,485850536,3646,3509221,3824355,482341315,0,4027,995863,3913,970308,114,25555,1931,6,3774,79,0,35,216660.0,130000.0,-52.0,-50.0,-44.0,-46.0,-51.0,-48.0,-43.0,-47.0,-90.0,-92.0,-89.0,-92.0,38.0,42.0,45.0,46.0,0
5074,CC:2F:71:3F:1F:24,4454566,1180756248,630211,698414933,3824355,482341315,37,518235,563192888,517610,563117662,625,75226,500554,10,630448,59570,34,449,130000.0,43333.0,-67.0,-65.0,-71.0,-67.0,-67.0,-65.0,-70.0,-67.0,-90.0,-92.0,-89.0,-92.0,23.0,27.0,18.0,25.0,0
5075,CC:2F:71:3E:C5:1F,3825112,482433790,755,92273,3824357,482341517,0,3166,265757,2613,200059,553,65698,798,8,1088,18,0,34,144444.0,39000.0,-79.0,-86.0,-75.0,-71.0,-72.0,-74.0,-69.0,-62.0,-90.0,-92.0,-89.0,-92.0,11.0,6.0,14.0,21.0,0
5076,BA:8C:B9:54:50:24,3829076,488491584,4719,6150067,3824357,482341517,0,8301,1646014,8279,1642519,22,3495,2320,14,5095,36,0,53,216660.0,130000.0,-39.0,-36.0,-45.0,-52.0,-42.0,-35.0,-43.0,-48.0,-90.0,-92.0,-89.0,-92.0,51.0,56.0,44.0,40.0,0
5077,92:69:1D:31:68:E9,3828006,485851000,3646,3509221,3824360,482341779,0,4027,995863,3913,970308,114,25555,1931,6,3774,79,0,35,216660.0,130000.0,-52.0,-50.0,-44.0,-46.0,-51.0,-48.0,-43.0,-47.0,-90.0,-92.0,-89.0,-92.0,38.0,42.0,45.0,46.0,0
5078,CC:2F:71:3F:1F:24,4454613,1180771252,630253,698429473,3824360,482341779,37,518260,563197692,517635,563122466,625,75226,500579,10,630490,59575,34,449,130000.0,43333.0,-67.0,-65.0,-70.0,-68.0,-67.0,-65.0,-70.0,-67.0,-90.0,-92.0,-89.0,-92.0,23.0,27.0,19.0,24.0,0
5079,CC:2F:71:3E:C5:1F,3825115,482434052,755,92273,3824360,482341779,0,3166,265757,2613,200059,553,65698,798,8,1088,18,0,34,144444.0,39000.0,-79.0,-86.0,-75.0,-71.0,-72.0,-74.0,-69.0,-62.0,-90.0,-92.0,-89.0,-92.0,11.0,6.0,14.0,21.0,0
5080,BA:8C:B9:54:50:24,3829079,488491846,4719,6150067,3824360,482341779,0,8301,1646014,8279,1642519,22,3495,2320,14,5095,36,0,53,216660.0,130000.0,-39.0,-36.0,-45.0,-52.0,-42.0,-35.0,-43.0,-48.0,-90.0,-92.0,-89.0,-92.0,51.0,56.0,44.0,40.0,0
5081,92:69:1D:31:68:E9,3828010,485851404,3646,3509221,3824364,482342183,0,4027,995863,3913,970308,114,25555,1931,6,3774,79,0,35,216660.0,130000.0,-52.0,-50.0,-44.0,-46.0,-51.0,-48.0,-43.0,-47.0,-90.0,-92.0,-89.0,-92.0,38.0,42.0,45.0,46.0,0
5082,CC:2F:71:3F:1F:24,4454660,1180786214,630296,698444031,3824364,482342183,37,518285,563202496,517660,563127270,625,75226,500604,10,630533,59596,34,449,117000.0,39000.0,-67.0,-65.0,-70.0,-68.0,-67.0,-65.0,-70.0,-67.0,-90.0,-92.0,-89.0,-92.0,23.0,27.0,19.0,24.0,0
5083,CC:2F:71:3E:C5:1F,3825121,482434658,755,92273,3824366,482342385,0,3166,265757,2613,200059,553,65698,798,8,1088,18,0,34,144444.0,39000.0,-79.0,-86.0,-75.0,-71.0,-72.0,-74.0,-69.0,-62.0,-90.0,-92.0,-89.0,-92.0,11.0,6.0,14.0,21.0,0
5084,BA:8C:B9:54:50:24,3829085,488492452,4719,6150067,3824366,482342385,0,8301,1646014,8279,1642519,22,3495,2320,14,5095,36,0,53,216660.0,130000.0,-39.0,-36.0,-45.0,-52.0,-42.0,-35.0,-43.0,-48.0,-90.0,-92.0,-89.0,-92.0,51.0,56.0,44.0,40.0,0
5085,92:69:1D:31:68:E9,3828014,485851808,3646,3509221,3824368,482342587,0,4027,995863,3913,970308,114,25555,1931,6,3774,79,0,35,216660.0,130000.0,-52.0,-50.0,-44.0,-46.0,-51.0,-48.0,-43.0,-47.0,-90.0,-92.0,-89.0,-92.0,38.0,42.0,45.0,46.0,0
5086,CC:2F:71:3F:1F:24,4454705,1180800922,630337,698458335,3824368,482342587,37,518310,563207300,517685,563132074,625,75226,500629,10,630574,59598,34,449,130000.0,43333.0,-67.0,-65.0,-70.0,-67.0,-67.0,-65.0,-70.0,-67.0,-90.0,-92.0,-89.0,-92.0,23.0,27.0,19.0,25.0,0
5087,CC:2F:71:3E:C5:1F,3825124,482434920,755,92273,3824369,482342647,0,3166,265757,2613,200059,553,65698,798,8,1088,18,0,34,144444.0,39000.0,-79.0,-86.0,-75.0,-71.0,-72.0,-74.0,-69.0,-62.0,-90.0,-92.0,-89.0,-92.0,11.0,6.0,14.0,21.0,0
5088,BA:8C:B9:54:50:24,3829088,488492714,4719,6150067,3824369,482342647,0,8301,1646014,8279,1642519,22,3495,2320,14,5095,36,0,53,216660.0,130000.0,-39.0,-36.0,-45.0,-52.0,-42.0,-35.0,-43.0,-48.0,-90.0,-92.0,-89.0,-92.0,51.0,56.0,44.0,40.0,0
5089,92:69:1D:31:68:E9,3828020,485852334,3646,3509221,3824374,482343113,0,4027,995863,3913,970308,114,25555,1931,6,3774,79,0,35,216660.0,130000.0,-52.0,-50.0,-44.0,-46.0,-51.0,-48.0,-43.0,-47.0,-90.0,-92.0,-89.0,-92.0,38.0,42.0,45.0,46.0,0
5090,CC:2F:71:3F:1F:24,4454753,1180815988,630379,698472875,3824374,482343113,37,518335,563212104,517710,563136878,625,75226,500654,10,630616,59603,34,449,130000.0,43333.0,-67.0,-65.0,-70.0,-67.0,-67.0,-65.0,-70.0,-67.0,-90.0,-92.0,-89.0,-92.0,23.0,27.0,19.0,25.0,0
5091,CC:2F:71:3E:C5:1F,3825131,482435588,755,92273,3824376,482343315,0,3168,265945,2614,200129,554,65816,799,8,1088,18,0,35,144444.0,39000.0,-70.0,-71.0,-67.0,-60.0,-73.0,-76.0,-70.0,-64.0,-90.0,-92.0,-89.0,-92.0,20.0,21.0,22.0,32.0,0
5092,BA:8C:B9:54:50:24,3829095,488493382,4719,6150067,3824376,482343315,0,8301,1646014,8279,1642519,22,3495,2320,14,5095,36,0,53,216660.0,130000.0,-39.0,-36.0,-45.0,-52.0,-42.0,-35.0,-43.0,-48.0,-90.0,-92.0,-89.0,-92.0,51.0,56.0,44.0,40.0,0
5093,92:69:1D:31:68:E9,3828025,485852800,3646,3509221,3824379,482343579,0,4027,995863,3913,970308,114,25555,1931,6,3774,79,0,35,216660.0,130000.0,-52.0,-50.0,-44.0,-46.0,-51.0,-48.0,-43.0,-47.0,-90.0,-92.0,-89.0,-92.0,38.0,42.0,45.0,46.0,0
5094,CC:2F:71:3F:1F:24,4454801,1180831006,630422,698487427,3824379,482343579,37,518361,563217026,517735,563141682,626,75344,500680,10,630659,59637,34,450,144444.0,43333.0,-67.0,-65.0,-70.0,-67.0,-66.0,-65.0,-70.0,-67.0,-90.0,-92.0,-89.0,-92.0,23.0,27.0,19.0,25.0,0
5095,CC:2F:71:3E:C5:1F,3825134,482435852,755,92273,3824379,482343579,0,3168,265945,2614,200129,554,65816,799,8,1088,18,0,35,144444.0,39000.0,-70.0,-71.0,-67.0,-60.0,-73.0,-76.0,-70.0,-64.0,-90.0,-92.0,-89.0,-92.0,20.0,21.0,22.0,32.0,0
5096,BA:8C:B9:54:50:24,3829098,488493646,4719,6150067,3824379,482343579,0,8301,1646014,8279,1642519,22,3495,2320,14,5095,36,0,53,216660.0,130000.0,-39.0,-36.0,-45.0,-52.0,-42.0,-35.0,-43.0,-48.0,-90.0,-92.0,-89.0,-92.0,51.0,56.0,44.0,40.0,0
5097,92:69:1D:31:68:E9,3828030,485853264,3646,3509221,3824384,482344043,0,4027,995863,3913,970308,114,25555,1931,6,3774,79,0,35,216660.0,130000.0,-52.0,-50.0,-44.0,-46.0,-51.0,-48.0,-43.0,-47.0,-90.0,-92.0,-89.0,-92.0,38.0,42.0,45.0,46.0,0
5098,CC:2F:71:3F:1F:24,4454848,1180845898,630464,698501855,3824384,482344043,37,518387,563221946,517761,563146602,626,75344,500706,10,630700,59646,34,450,130000.0,43333.0,-67.0,-65.0,-70.0,-68.0,-67.0,-65.0,-70.0,-67.0,-90.0,-92.0,-89.0,-92.0,23.0,27.0,19.0,24.0,0
5099,CC:2F:71:3E:C5:1F,3825141,482436518,755,92273,3824386,482344245,0,3168,265945,2614,200129,554,65816,799,8,1088,18,0,35,144444.0,39000.0,-70.0,-71.0,-67.0,-60.0,-73.0,-76.0,-70.0,-64.0,-90.0,-92.0,-89.0,-92.0,20.0,21.0,22.0,32.0,0
5100,BA:8C:B9:54:50:24,3829105,488494312,4719,6150067,3824386,482344245,0,8301,1646014,8279,1642519,22,3495,2320,14,5095,36,0,53,216660.0,130000.0,-39.0,-36.0,-45.0,-52.0,-42.0,-35.0,-43.0,-48.0,-90.0,-92.0,-89.0,-92.0,51.0,56.0,44.0,40.0,0
5101,92:69:1D:31:68:E9,3828034,485853668,3646,3509221,3824388,482344447,0,4027,995863,3913,970308,114,25555,1931,6,3774,79,0,35,216660.0,130000.0,-52.0,-50.0,-44.0,-46.0,-51.0,-48.0,-43.0,-47.0,-90.0,-92.0,-89.0,-92.0,38.0,42.0,45.0,46.0,0
5102,CC:2F:71:3F:1F:24,4454895,1180861044,630507,698516597,3824388,482344447,37,518415,563227110,517789,563151766,626,75344,500734,10,630744,59671,34,450,130000.0,39000.0,-67.0,-65.0,-71.0,-68.0,-67.0,-65.0,-70.0,-67.0,-90.0,-92.0,-89.0,-92.0,23.0,27.0,18.0,24.0,0
5103,CC:2F:71:3E:C5:1F,3825143,482436720,755,92273,3824388,482344447,0,3168,265945,2614,200129,554,65816,799,8,1088,18,0,35,144444.0,39000.0,-70.0,-71.0,-67.0,-60.0,-73.0,-76.0,-70.0,-64.0,-90.0,-92.0,-89.0,-92.0,20.0,21.0,22.0,32.0,0
5104,BA:8C:B9:54:50:24,3829107,488494514,4719,6150067,3824388,482344447,0,8301,1646014,8279,1642519,22,3495,2320,14,5095,36,0,53,216660.0,130000.0,-39.0,-36.0,-45.0,-52.0,-42.0,-35.0,-43.0,-48.0,-90.0,-92.0,-89.0,-92.0,51.0,56.0,44.0,40.0,0
5105,92:69:1D:31:68:E9,3828039,485854345,3646,3509221,3824393,482345124,0,4027,995863,3913,970308,114,25555,1931,6,3774,79,0,35,216660.0,130000.0,-52.0,-50.0,-44.0,-46.0,-51.0,-48.0,-43.0,-47.0,-90.0,-92.0,-89.0,-92.0,38.0,42.0,45.0,46.0,0
5106,CC:2F:71:3F:1F:24,4454945,1180876419,630550,698531093,3824395,482345326,37,518440,563231914,517814,563156570,626,75344,500759,10,630787,59703,34,450,130000.0,43333.0,-67.0,-65.0,-70.0,-67.0,-67.0,-65.0,-70.0,-67.0,-90.0,-92.0,-89.0,-92.0,23.0,27.0,19.0,25.0,0
5107,CC:2F:71:3E:C5:1F,3825150,482437599,755,92273,3824395,482345326,0,3168,265945,2614,200129,554,65816,799,8,1088,18,0,35,144444.0,39000.0,-70.0,-71.0,-67.0,-60.0,-73.0,-76.0,-70.0,-64.0,-90.0,-92.0,-89.0,-92.0,20.0,21.0,22.0,32.0,0
5108,BA:8C:B9:54:50:24,3829114,488495393,4719,6150067,3824395,482345326,0,8301,1646014,8279,1642519,22,3495,2320,14,5095,36,0,53,216660.0,130000.0,-39.0,-36.0,-45.0,-52.0,-42.0,-35.0,-43.0,-48.0,-90.0,-92.0,-89.0,-92.0,51.0,56.0,44.0,40.0,0
5109,92:69:1D:31:68:E9,3828044,485854809,3646,3509221,3824398,482345588,0,4027,995863,3913,970308,114,25555,1931,6,3774,79,0,35,216660.0,130000.0,-52.0,-50.0,-44.0,-46.0,-51.0,-48.0,-43.0,-47.0,-90.0,-92.0,-89.0,-92.0,38.0,42.0,45.0,46.0,0
5110,CC:2F:71:3F:1F:24,4454989,1180891091,630591,698545503,3824398,482345588,37,518466,563236834,517840,563161490,626,75344,500785,10,630828,59708,34,450,130000.0,43333.0,-67.0,-65.0,-70.0,-68.0,-67.0,-65.0,-70.0,-67.0,-90.0,-92.0,-89.0,-92.0,23.0,27.0,19.0,24.0,0
5111,CC:2F:71:3E:C5:1F,3825153,482437861,755,92273,3824398,482345588,0,3168,265945,2614,200129,554,65816,799,8,1088,18,0,35,144444.0,39000.0,-70.0,-71.0,-67.0,-60.0,-73.0,-76.0,-70.0,-64.0,-90.0,-92.0,-89.0,-92.0,20.0,21.0,22.0,32.0,0
5112,BA:8C:B9:54:50:24,3829117,488495655,4719,6150067,3824398,482345588,0,8302,1646082,8280,1642587,22,3495,2320,14,5095,36,0,53,216660.0,130000.0,-39.0,-36.0,-44.0,-51.0,-42.0,-35.0,-43.0,-48.0,-90.0,-92.0,-89.0,-92.0,51.0,56.0,45.0,41.0,0
5113,92:69:1D:31:68:E9,3828048,485855213,3646,3509221,3824402,482345992,0,4027,995863,3913,970308,114,25555,1931,6,3774,79,0,35,216660.0,130000.0,-52.0,-50.0,-44.0,-46.0,-51.0,-48.0,-43.0,-47.0,-90.0,-92.0,-89.0,-92.0,38.0,42.0,45.0,46.0,0
5114,CC:2F:71:3F:1F:24,4455034,1180905799,630632,698559807,3824402,482345992,37,518493,563241894,517867,563166550,626,75344,500812,10,630869,59723,34,450,117000.0,39000.0,-67.0,-65.0,-71.0,-68.0,-67.0,-65.0,-70.0,-67.0,-90.0,-92.0,-89.0,-92.0,23.0,27.0,18.0,24.0,0
5115,CC:2F:71:3E:C5:1F,3825159,482438467,755,92273,3824404,482346194,0,3168,265945,2614,200129,554,65816,799,8,1088,18,0,35,144444.0,39000.0,-70.0,-71.0,-67.0,-60.0,-73.0,-76.0,-70.0,-64.0,-90.0,-92.0,-89.0,-92.0,20.0,21.0,22.0,32.0,0
5116,BA:8C:B9:54:50:24,3829123,488496261,4719,6150067,3824404,482346194,0,8302,1646082,8280,1642587,22,3495,2320,14,5095,36,0,53,216660.0,130000.0,-39.0,-36.0,-44.0,-51.0,-42.0,-35.0,-43.0,-48.0,-90.0,-92.0,-89.0,-92.0,51.0,56.0,45.0,41.0,0
5117,92:69:1D:31:68:E9,3828052,485855617,3646,3509221,3824406,482346396,0,4027,995863,3913,970308,114,25555,1931,6,3774,79,0,35,216660.0,130000.0,-52.0,-50.0,-44.0,-46.0,-51.0,-48.0,-43.0,-47.0,-90.0,-92.0,-89.0,-92.0,38.0,42.0,45.0,46.0,0
5118,CC:2F:71:3F:1F:24,4455082,1180920815,630675,698574359,3824407,482346456,37,518519,563246814,517893,563171470,626,75344,500838,10,630912,59724,34,450,130000.0,43333.0,-67.0,-65.0,-71.0,-68.0,-67.0,-65.0,-70.0,-67.0,-90.0,-92.0,-89.0,-92.0,23.0,27.0,18.0,24.0,0
5119,CC:2F:71:3E:C5:1F,3825162,482438729,755,92273,3824407,482346456,0,3168,265945,2614,200129,554,65816,799,8,1088,18,0,35,144444.0,39000.0,-70.0,-71.0,-67.0,-60.0,-73.0,-76.0,-70.0,-64.0,-90.0,-92.0,-89.0,-92.0,20.0,21.0,22.0,32.0,0
5120,BA:8C:B9:54:50:24,3829126,488496523,4719,6150067,3824407,482346456,0,8302,1646082,8280,1642587,22,3495,2320,14,5095,36,0,53,216660.0,130000.0,-39.0,-36.0,-44.0,-51.0,-42.0,-35.0,-43.0,-48.0,-90.0,-92.0,-89.0,-92.0,51.0,56.0,45.0,41.0,0
5121,92:69:1D:31:68:E9,3828057,485856081,3646,3509221,3824411,482346860,0,4027,995863,3913,970308,114,25555,1931,6,3774,79,0,35,216660.0,130000.0,-52.0,-50.0,-44.0,-46.0,-51.0,-48.0,-43.0,-47.0,-90.0,-92.0,-89.0,-92.0,38.0,42.0,45.0,46.0,0
5122,CC:2F:71:3F:1F:24,4455128,1180935703,630717,698588843,3824411,482346860,37,518545,563251758,517919,563176414,626,75344,500864,10,630954,59729,34,450,130000.0,39000.0,-67.0,-65.0,-70.0,-67.0,-67.0,-65.0,-70.0,-67.0,-90.0,-92.0,-89.0,-92.0,23.0,27.0,19.0,25.0,0
5123,CC:2F:71:3E:C5:1F,3825168,482439335,755,92273,3824413,482347062,0,3168,265945,2614,200129,554,65816,799,8,1088,18,0,35,144444.0,39000.0,-70.0,-71.0,-67.0,-60.0,-73.0,-76.0,-70.0,-64.0,-90.0,-92.0,-89.0,-92.0,20.0,21.0,22.0,32.0,0
5124,BA:8C:B9:54:50:24,3829132,488497129,4719,6150067,3824413,482347062,0,8302,1646082,8280,1642587,22,3495,2320,14,5095,36,0,53,216660.0,130000.0,-39.0,-36.0,-44.0,-51.0,-42.0,-35.0,-43.0,-48.0,-90.0,-92.0,-89.0,-92.0,51.0,56.0,45.0,41.0,0
5125,92:69:1D:31:68:E9,3828061,485856485,3646,3509221,3824415,482347264,0,4027,995863,3913,970308,114,25555,1931,6,3774,79,0,35,216660.0,130000.0,-52.0,-50.0,-44.0,-46.0,-51.0,-48.0,-43.0,-47.0,-90.0,-92.0,-89.0,-92.0,38.0,42.0,45.0,46.0,0
5126,CC:2F:71:3F:1F:24,4455173,1180950411,630758,698603147,3824415,482347264,37,518572,563256818,517946,563181474,626,75344,500891,10,630995,59742,34,450,130000.0,39000.0,-67.0,-65.0,-70.0,-67.0,-67.0,-65.0,-70.0,-67.0,-90.0,-92.0,-89.0,-92.0,23.0,27.0,19.0,25.0,0
5127,CC:2F:71:3E:C5:1F,3825170,482439537,755,92273,3824415,482347264,0,3168,265945,2614,200129,554,65816,799,8,1088,18,0,35,144444.0,39000.0,-70.0,-71.0,-67.0,-60.0,-73.0,-76.0,-70.0,-64.0,-90.0,-92.0,-89.0,-92.0,20.0,21.0,22.0,32.0,0
5128,BA:8C:B9:54:50:24,3829134,488497331,4719,6150067,3824415,482347264,0,8302,1646082,8280,1642587,22,3495,2320,14,5095,36,0,53,216660.0,130000.0,-39.0,-36.0,-44.0,-51.0,-42.0,-35.0,-43.0,-48.0,-90.0,-92.0,-89.0,-92.0,51.0,56.0,45.0,41.0,0
5129,92:69:1D:31:68:E9,3828066,485856949,3646,3509221,3824420,482347728,0,4027,995863,3913,970308,114,25555,1931,6,3774,79,0,35,216660.0,130000.0,-52.0,-50.0,-44.0,-46.0,-51.0,-48.0,-43.0,-47.0,-90.0,-92.0,-89.0,-92.0,38.0,42.0,45.0,46.0,0
5130,CC:2F:71:3F:1F:24,4455221,1180965489,630801,698617761,3824420,482347728,37,518598,563261762,517972,563186418,626,75344,500917,10,631038,59751,34,450,130000.0,43333.0,-67.0,-65.0,-70.0,-67.0,-67.0,-65.0,-70.0,-67.0,-90.0,-92.0,-89.0,-92.0,23.0,27.0,19.0,25.0,0
5131,CC:2F:71:3E:C5:1F,3825177,482440203,755,92273,3824422,482347930,0,3168,265945,2614,200129,554,65816,799,8,1088,18,0,35,144444.0,39000.0,-70.0,-71.0,-67.0,-60.0,-73.0,-76.0,-70.0,-64.0,-90.0,-92.0,-89.0,-92.0,20.0,21.0,22.0,32.0,0
5132,BA:8C:B9:54:50:24,3829141,488497997,4719,6150067,3824422,482347930,0,8302,1646082,8280,1642587,22,3495,2320,14,5095,36,0,53,216660.0,130000.0,-39.0,-36.0,-44.0,-51.0,-42.0,-35.0,-43.0,-48.0,-90.0,-92.0,-89.0,-92.0,51.0,56.0,45.0,41.0,0
5133,92:69:1D:31:68:E9,3828070,485857353,3646,3509221,3824424,482348132,0,4027,995863,3913,970308,114,25555,1931,6,3774,79,0,35,216660.0,130000.0,-52.0,-50.0,-44.0,-46.0,-51.0,-48.0,-43.0,-47.0,-90.0,-92.0,-89.0,-92.0,38.0,42.0,45.0,46.0,0
5134,CC:2F:71:3F:1F:24,4455266,1180980191,630842,698632059,3824424,482348132,37,518623,563266566,517997,563191222,626,75344,500942,10,631079,59765,34,450,117000.0,39000.0,-67.0,-65.0,-71.0,-68.0,-67.0,-65.0,-70.0,-67.0,-90.0,-92.0,-89.0,-92.0,23.0,27.0,18.0,24.0,0
5135,CC:2F:71:3E:C5:1F,3825179,482440405,755,92273,3824424,482348132,0,3168,265945,2614,200129,554,65816,799,8,1088,18,0,35,144444.0,39000.0,-70.0,-71.0,-67.0,-60.0,-73.0,-76.0,-70.0,-64.0,-90.0,-92.0,-89.0,-92.0,20.0,21.0,22.0,32.0,0
5136,BA:8C:B9:54:50:24,3829143,488498199,4719,6150067,3824424,482348132,0,8302,1646082,8280,1642587,22,3495,2320,14,5095,36,0,53,216660.0,130000.0,-39.0,-36.0,-44.0,-51.0,-42.0,-35.0,-43.0,-48.0,-90.0,-92.0,-89.0,-92.0,51.0,56.0,45.0,41.0,0
5137,92:69:1D:31:68:E9,3828074,485857757,3646,3509221,3824428,482348536,0,4027,995863,3913,970308,114,25555,1931,6,3774,79,0,35,216660.0,130000.0,-52.0,-50.0,-44.0,-46.0,-51.0,-48.0,-43.0,-47.0,-90.0,-92.0,-89.0,-92.0,38.0,42.0,45.0,46.0,0
5138,CC:2F:71:3F:1F:24,4455311,1180994899,630883,698646363,3824428,482348536,37,518648,563271370,518022,563196026,626,75344,500967,10,631120,59770,34,450,130000.0,43333.0,-67.0,-65.0,-70.0,-67.0,-67.0,-65.0,-70.0,-67.0,-90.0,-92.0,-89.0,-92.0,23.0,27.0,19.0,25.0,0
5139,CC:2F:71:3E:C5:1F,3825185,482441011,755,92273,3824430,482348738,0,3168,265945,2614,200129,554,65816,799,8,1088,18,0,35,144444.0,39000.0,-70.0,-71.0,-67.0,-60.0,-73.0,-76.0,-70.0,-64.0,-90.0,-92.0,-89.0,-92.0,20.0,21.0,22.0,32.0,0
5140,BA:8C:B9:54:50:24,3829149,488498805,4719,6150067,3824430,482348738,0,8302,1646082,8280,1642587,22,3495,2320,14,5095,36,0,53,216660.0,130000.0,-39.0,-36.0,-44.0,-51.0,-42.0,-35.0,-43.0,-48.0,-90.0,-92.0,-89.0,-92.0,51.0,56.0,45.0,41.0,0
5141,92:69:1D:31:68:E9,3828079,485858221,3646,3509221,3824433,482349000,0,4027,995863,3913,970308,114,25555,1931,6,3774,79,0,35,216660.0,130000.0,-52.0,-50.0,-44.0,-46.0,-51.0,-48.0,-43.0,-47.0,-90.0,-92.0,-89.0,-92.0,38.0,42.0,45.0,46.0,0
5142,CC:2F:71:3F:1F:24,4455356,1181009649,630923,698660649,3824433,482349000,37,518673,563276174,518047,563200830,626,75344,500992,10,631160,59771,34,450,130000.0,43333.0,-67.0,-65.0,-70.0,-67.0,-67.0,-65.0,-70.0,-67.0,-90.0,-92.0,-89.0,-92.0,23.0,27.0,19.0,25.0,0
5143,CC:2F:71:3E:C5:1F,3825188,482441273,755,92273,3824433,482349000,0,3168,265945,2614,200129,554,65816,799,8,1088,18,0,35,144444.0,39000.0,-70.0,-71.0,-67.0,-60.0,-73.0,-76.0,-70.0,-64.0,-90.0,-92.0,-89.0,-92.0,20.0,21.0,22.0,32.0,0
5144,BA:8C:B9:54:50:24,3829154,488499269,4719,6150067,3824435,482349202,0,8302,1646082,8280,1642587,22,3495,2320,14,5095,36,0,53,216660.0,130000.0,-39.0,-36.0,-44.0,-51.0,-42.0,-35.0,-43.0,-48.0,-90.0,-92.0,-89.0,-92.0,51.0,56.0,45.0,41.0,0
5145,92:69:1D:31:68:E9,3828083,485858625,3646,3509221,3824437,482349404,0,4027,995863,3913,970308,114,25555,1931,6,3774,79,0,35,216660.0,130000.0,-52.0,-50.0,-44.0,-46.0,-51.0,-48.0,-43.0,-47.0,-90.0,-92.0,-89.0,-92.0,38.0,42.0,45.0,46.0,0
5146,CC:2F:71:3F:1F:24,4455401,1181024413,630964,698675009,3824437,482349404,37,518701,563281374,518075,563206030,626,75344,501020,10,631201,59786,34,450,130000.0,39000.0,-67.0,-65.0,-71.0,-68.0,-67.0,-65.0,-70.0,-67.0,-90.0,-92.0,-89.0,-92.0,23.0,27.0,18.0,24.0,0
5147,CC:2F:71:3E:C5:1F,3825194,482441879,755,92273,3824439,482349606,0,3168,265945,2614,200129,554,65816,799,8,1088,18,0,35,144444.0,39000.0,-70.0,-71.0,-67.0,-60.0,-73.0,-76.0,-70.0,-64.0,-90.0,-92.0,-89.0,-92.0,20.0,21.0,22.0,32.0,0
5148,BA:8C:B9:54:50:24,3829158,488499673,4719,6150067,3824439,482349606,0,8302,1646082,8280,1642587,22,3495,2320,14,5095,36,0,53,216660.0,130000.0,-39.0,-36.0,-44.0,-51.0,-42.0,-35.0,-43.0,-48.0,-90.0,-92.0,-89.0,-92.0,51.0,56.0,45.0,41.0,0
5149,92:69:1D:31:68:E9,3828087,485859021,3646,3509221,3824441,482349800,0,4027,995863,3913,970308,114,25555,1931,6,3774,79,0,35,216660.0,130000.0,-52.0,-50.0,-44.0,-46.0,-51.0,-48.0,-43.0,-47.0,-90.0,-92.0,-89.0,-92.0,38.0,42.0,45.0,46.0,0
5150,CC:2F:71:3F:1F:24,4455447,1181039187,631005,698689319,3824442,482349868,37,518728,563286434,518102,563211090,626,75344,501047,10,631242,59798,34,450,130000.0,39000.0,-67.0,-65.0,-70.0,-68.0,-67.0,-65.0,-70.0,-67.0,-90.0,-92.0,-89.0,-92.0,23.0,27.0,19.0,24.0,0
5151,CC:2F:71:3E:C5:1F,3825197,482442141,755,92273,3824442,482349868,0,3168,265945,2614,200129,554,65816,799,8,1088,18,0,35,144444.0,39000.0,-70.0,-71.0,-67.0,-60.0,-73.0,-76.0,-70.0,-64.0,-90.0,-92.0,-89.0,-92.0,20.0,21.0,22.0,32.0,0
5152,BA:8C:B9:54:50:24,3829163,488500137,4719,6150067,3824444,482350070,0,8302,1646082,8280,1642587,22,3495,2320,14,5095,36,0,53,216660.0,130000.0,-39.0,-36.0,-44.0,-51.0,-42.0,-35.0,-43.0,-48.0,-90.0,-92.0,-89.0,-92.0,51.0,56.0,45.0,41.0,0
5153,92:69:1D:31:68:E9,3828093,485859609,3647,3509337,3824446,482350272,0,4029,995999,3915,970444,114,25555,1931,6,3775,79,0,35,216660.0,130000.0,-52.0,-50.0,-44.0,-46.0,-51.0,-49.0,-43.0,-47.0,-90.0,-92.0,-89.0,-92.0,38.0,42.0,45.0,46.0,0
5154,CC:2F:71:3F:1F:24,4455495,1181054259,631049,698703987,3824446,482350272,37,518753,563291238,518127,563215894,626,75344,501072,10,631286,59811,34,450,130000.0,39000.0,-67.0,-65.0,-70.0,-68.0,-67.0,-65.0,-70.0,-67.0,-90.0,-92.0,-89.0,-92.0,23.0,27.0,19.0,24.0,0
5155,CC:2F:71:3E:C5:1F,3825202,482442661,756,92389,3824446,482350272,0,3170,266085,2616,200269,554,65816,799,8,1089,18,0,35,144444.0,39000.0,-70.0,-71.0,-67.0,-60.0,-72.0,-74.0,-69.0,-62.0,-90.0,-92.0,-89.0,-92.0,20.0,21.0,22.0,32.0,0
5156,BA:8C:B9:54:50:24,3829168,488500657,4720,6150183,3824448,482350474,0,8304,1646218,8282,1642723,22,3495,2320,14,5096,36,0,53,216660.0,130000.0,-39.0,-36.0,-45.0,-52.0,-44.0,-35.0,-43.0,-48.0,-90.0,-92.0,-89.0,-92.0,51.0,56.0,44.0,40.0,0
5157,92:69:1D:31:68:E9,3828097,485860146,3647,3509337,3824450,482350809,0,4029,995999,3915,970444,114,25555,1931,6,3775,79,0,35,216660.0,130000.0,-52.0,-50.0,-44.0,-46.0,-51.0,-49.0,-43.0,-47.0,-90.0,-92.0,-89.0,-92.0,38.0,42.0,45.0,46.0,0
5158,CC:2F:71:3F:1F:24,4455542,1181069354,631092,698718545,3824450,482350809,37,518779,563296182,518153,563220838,626,75344,501098,10,631329,59829,34,450,130000.0,39000.0,-67.0,-65.0,-70.0,-67.0,-67.0,-65.0,-70.0,-67.0,-90.0,-92.0,-89.0,-92.0,23.0,27.0,19.0,25.0,0
5159,CC:2F:71:3E:C5:1F,3825208,482443400,756,92389,3824452,482351011,0,3172,266273,2617,200339,555,65934,800,8,1089,18,0,35,144444.0,39000.0,-70.0,-71.0,-67.0,-60.0,-72.0,-74.0,-69.0,-62.0,-90.0,-92.0,-89.0,-92.0,20.0,21.0,22.0,32.0,0
5160,BA:8C:B9:54:50:24,3829174,488501396,4720,6150183,3824454,482351213,0,8304,1646218,8282,1642723,22,3495,2320,14,5096,36,0,53,216660.0,130000.0,-39.0,-36.0,-45.0,-52.0,-44.0,-35.0,-43.0,-48.0,-90.0,-92.0,-89.0,-92.0,51.0,56.0,44.0,40.0,0
5161,92:69:1D:31:68:E9,3828104,485860812,3647,3509337,3824457,482351475,0,4029,995999,3915,970444,114,25555,1931,6,3775,79,0,35,216660.0,130000.0,-52.0,-50.0,-44.0,-46.0,-51.0,-49.0,-43.0,-47.0,-90.0,-92.0,-89.0,-92.0,38.0,42.0,45.0,46.0,0
5162,CC:2F:71:3F:1F:24,4455591,1181084504,631134,698733029,3824457,482351475,37,518805,563301102,518179,563225758,626,75344,501124,10,631370,59834,34,450,130000.0,43333.0,-67.0,-65.0,-70.0,-67.0,-67.0,-65.0,-70.0,-67.0,-90.0,-92.0,-89.0,-92.0,23.0,27.0,19.0,25.0,0
5163,CC:2F:71:3E:C5:1F,3825213,482443864,756,92389,3824457,482351475,0,3172,266273,2617,200339,555,65934,800,8,1089,18,0,35,144444.0,39000.0,-70.0,-71.0,-67.0,-60.0,-72.0,-74.0,-69.0,-62.0,-90.0,-92.0,-89.0,-92.0,20.0,21.0,22.0,32.0,0
5164,BA:8C:B9:54:50:24,3829179,488501860,4720,6150183,3824459,482351677,0,8304,1646218,8282,1642723,22,3495,2320,14,5096,36,0,53,216660.0,130000.0,-39.0,-36.0,-45.0,-52.0,-44.0,-35.0,-43.0,-48.0,-90.0,-92.0,-89.0,-92.0,51.0,56.0,44.0,40.0,0
5165,92:69:1D:31:68:E9,3828106,485861014,3647,3509337,3824459,482351677,0,4029,995999,3915,970444,114,25555,1931,6,3775,79,0,35,216660.0,130000.0,-52.0,-50.0,-44.0,-46.0,-51.0,-49.0,-43.0,-47.0,-90.0,-92.0,-89.0,-92.0,38.0,42.0,45.0,46.0,0
5166,CC:2F:71:3F:1F:24,4455633,1181098824,631174,698747147,3824459,482351677,37,518831,563306022,518205,563230678,626,75344,501150,10,631411,59861,34,450,144444.0,43333.0,-67.0,-65.0,-71.0,-68.0,-67.0,-65.0,-70.0,-67.0,-90.0,-92.0,-89.0,-92.0,23.0,27.0,18.0,24.0,0
5167,CC:2F:71:3E:C5:1F,3825217,482444268,756,92389,3824461,482351879,0,3172,266273,2617,200339,555,65934,800,8,1089,18,0,35,144444.0,39000.0,-70.0,-71.0,-67.0,-60.0,-72.0,-74.0,-69.0,-62.0,-90.0,-92.0,-89.0,-92.0,20.0,21.0,22.0,32.0,0
5168,BA:8C:B9:54:50:24,3829183,488502264,4720,6150183,3824463,482352081,0,8304,1646218,8282,1642723,22,3495,2320,14,5096,36,0,53,216660.0,130000.0,-39.0,-36.0,-45.0,-52.0,-44.0,-35.0,-43.0,-48.0,-90.0,-92.0,-89.0,-92.0,51.0,56.0,44.0,40.0,0
5169,92:69:1D:31:68:E9,3828112,485861620,3647,3509337,3824465,482352283,0,4029,995999,3915,970444,114,25555,1931,6,3775,79,0,35,216660.0,130000.0,-52.0,-50.0,-44.0,-46.0,-51.0,-49.0,-43.0,-47.0,-90.0,-93.0,-90.0,-93.0,38.0,43.0,46.0,47.0,0
5170,CC:2F:71:3F:1F:24,4455681,1181113914,631216,698761631,3824465,482352283,37,518857,563310966,518231,563235622,626,75344,501176,10,631453,59877,34,450,130000.0,43333.0,-67.0,-65.0,-70.0,-68.0,-67.0,-65.0,-70.0,-68.0,-90.0,-93.0,-90.0,-93.0,23.0,28.0,20.0,25.0,0
5171,CC:2F:71:3E:C5:1F,3825221,482444672,756,92389,3824465,482352283,0,3172,266273,2617,200339,555,65934,800,8,1089,18,0,35,144444.0,39000.0,-70.0,-71.0,-67.0,-60.0,-72.0,-74.0,-69.0,-62.0,-90.0,-93.0,-90.0,-93.0,20.0,22.0,23.0,33.0,0
5172,BA:8C:B9:54:50:24,3829188,488502728,4720,6150183,3824468,482352545,0,8304,1646218,8282,1642723,22,3495,2320,14,5096,36,0,53,216660.0,130000.0,-39.0,-36.0,-45.0,-52.0,-44.0,-35.0,-43.0,-48.0,-90.0,-93.0,-90.0,-93.0,51.0,57.0,45.0,41.0,0
5173,92:69:1D:31:68:E9,3828115,485861882,3647,3509337,3824468,482352545,0,4029,995999,3915,970444,114,25555,1931,6,3775,79,0,35,216660.0,130000.0,-52.0,-50.0,-44.0,-46.0,-51.0,-49.0,-43.0,-47.0,-90.0,-93.0,-90.0,-93.0,38.0,43.0,46.0,47.0,0
5174,CC:2F:71:3F:1F:24,4455726,1181128716,631258,698776171,3824468,482352545,37,518883,563315910,518257,563240566,626,75344,501202,10,631495,59882,34,450,130000.0,43333.0,-67.0,-65.0,-70.0,-68.0,-67.0,-65.0,-70.0,-67.0,-90.0,-93.0,-90.0,-93.0,23.0,28.0,20.0,25.0,0
5175,CC:2F:71:3E:C5:1F,3825226,482445136,756,92389,3824470,482352747,0,3172,266273,2617,200339,555,65934,800,8,1089,18,0,35,144444.0,39000.0,-70.0,-71.0,-67.0,-60.0,-72.0,-74.0,-69.0,-62.0,-90.0,-93.0,-90.0,-93.0,20.0,22.0,23.0,33.0,0
5176,BA:8C:B9:54:50:24,3829192,488503132,4720,6150183,3824472,482352949,0,8304,1646218,8282,1642723,22,3495,2320,14,5096,36,0,53,216660.0,130000.0,-39.0,-36.0,-45.0,-52.0,-44.0,-35.0,-43.0,-48.0,-90.0,-93.0,-90.0,-93.0,51.0,57.0,45.0,41.0,0
5177,92:69:1D:31:68:E9,3828119,485862286,3647,3509337,3824472,482352949,0,4031,996135,3917,970580,114,25555,1931,6,3776,79,0,35,216660.0,130000.0,-52.0,-51.0,-45.0,-46.0,-51.0,-49.0,-43.0,-47.0,-90.0,-93.0,-90.0,-93.0,38.0,42.0,45.0,47.0,0
5178,CC:2F:71:3F:1F:24,4455774,1181143750,631300,698790599,3824474,482353151,37,518912,563321202,518286,563245858,626,75344,501231,10,631537,59898,34,450,117000.0,39000.0,-67.0,-65.0,-71.0,-68.0,-67.0,-65.0,-70.0,-67.0,-90.0,-93.0,-90.0,-93.0,23.0,28.0,19.0,25.0,0
5179,CC:2F:71:3E:C5:1F,3825230,482445540,756,92389,3824474,482353151,0,3172,266273,2617,200339,555,65934,800,8,1089,18,0,35,144444.0,39000.0,-70.0,-71.0,-67.0,-60.0,-72.0,-74.0,-69.0,-62.0,-90.0,-93.0,-90.0,-93.0,20.0,22.0,23.0,33.0,0
5180,BA:8C:B9:54:50:24,3829196,488503536,4720,6150183,3824476,482353353,0,8307,1646422,8285,1642927,22,3495,2320,14,5097,36,0,53,216660.0,130000.0,-39.0,-36.0,-45.0,-52.0,-42.0,-35.0,-43.0,-48.0,-90.0,-93.0,-90.0,-93.0,51.0,57.0,45.0,41.0,0
5181,92:69:1D:31:68:E9,3828125,485862812,3647,3509337,3824478,482353475,0,4031,996135,3917,970580,114,25555,1931,6,3776,79,0,35,216660.0,130000.0,-52.0,-51.0,-45.0,-46.0,-51.0,-49.0,-43.0,-47.0,-90.0,-93.0,-90.0,-93.0,38.0,42.0,45.0,47.0,0
5182,CC:2F:71:3F:1F:24,4455819,1181158378,631341,698804903,3824478,482353475,37,518941,563326472,518314,563251010,627,75462,501260,10,631578,59903,34,450,130000.0,43333.0,-67.0,-65.0,-71.0,-67.0,-67.0,-65.0,-70.0,-67.0,-90.0,-93.0,-90.0,-93.0,23.0,28.0,19.0,26.0,0
5183,CC:2F:71:3E:C5:1F,3825238,482446268,756,92389,3824482,482353879,0,3172,266273,2617,200339,555,65934,800,8,1089,18,0,35,144444.0,39000.0,-70.0,-71.0,-67.0,-60.0,-72.0,-74.0,-69.0,-62.0,-90.0,-93.0,-90.0,-93.0,20.0,22.0,23.0,33.0,0
5184,BA:8C:B9:54:50:24,3829202,488504062,4720,6150183,3824482,482353879,0,8307,1646422,8285,1642927,22,3495,2320,14,5097,36,0,53,216660.0,130000.0,-39.0,-36.0,-45.0,-52.0,-42.0,-35.0,-43.0,-48.0,-90.0,-93.0,-90.0,-93.0,51.0,57.0,45.0,41.0,0
5185,92:69:1D:31:68:E9,3828131,485863418,3647,3509337,3824484,482354081,0,4031,996135,3917,970580,114,25555,1931,6,3776,79,0,35,216660.0,130000.0,-52.0,-51.0,-45.0,-46.0,-51.0,-49.0,-43.0,-47.0,-90.0,-93.0,-90.0,-93.0,38.0,42.0,45.0,47.0,0
5186,CC:2F:71:3F:1F:24,4455867,1181173468,631383,698819387,3824484,482354081,37,518966,563331276,518339,563255814,627,75462,501285,10,631620,59916,34,450,130000.0,39000.0,-67.0,-65.0,-70.0,-67.0,-67.0,-65.0,-70.0,-67.0,-90.0,-93.0,-90.0,-93.0,23.0,28.0,20.0,26.0,0
5187,CC:2F:71:3E:C5:1F,3825240,482446470,756,92389,3824484,482354081,0,3172,266273,2617,200339,555,65934,800,8,1089,18,0,35,144444.0,39000.0,-70.0,-71.0,-67.0,-60.0,-72.0,-74.0,-69.0,-62.0,-90.0,-93.0,-90.0,-93.0,20.0,22.0,23.0,33.0,0
5188,BA:8C:B9:54:50:24,3829206,488504466,4720,6150183,3824486,482354283,0,8307,1646422,8285,1642927,22,3495,2320,14,5097,36,0,53,216660.0,130000.0,-39.0,-36.0,-45.0,-52.0,-42.0,-35.0,-43.0,-48.0,-90.0,-93.0,-90.0,-93.0,51.0,57.0,45.0,41.0,0
5189,92:69:1D:31:68:E9,3828133,485863620,3647,3509337,3824486,482354283,0,4031,996135,3917,970580,114,25555,1931,6,3776,79,0,35,216660.0,130000.0,-52.0,-51.0,-45.0,-46.0,-51.0,-49.0,-43.0,-47.0,-90.0,-93.0,-90.0,-93.0,38.0,42.0,45.0,47.0,0
5190,CC:2F:71:3F:1F:24,4455911,1181188042,631425,698833759,3824486,482354283,37,518993,563336336,518366,563260874,627,75462,501312,10,631662,59929,34,450,130000.0,43333.0,-67.0,-65.0,-70.0,-68.0,-67.0,-65.0,-70.0,-67.0,-90.0,-93.0,-90.0,-93.0,23.0,28.0,20.0,25.0,0
5191,CC:2F:71:3E:C5:1F,3825246,482447076,756,92389,3824490,482354687,0,3172,266273,2617,200339,555,65934,800,8,1089,18,0,35,144444.0,39000.0,-70.0,-71.0,-67.0,-60.0,-72.0,-74.0,-69.0,-62.0,-90.0,-93.0,-90.0,-93.0,20.0,22.0,23.0,33.0,0
5192,BA:8C:B9:54:50:24,3829210,488504870,4720,6150183,3824490,482354687,0,8307,1646422,8285,1642927,22,3495,2320,14,5097,36,0,53,216660.0,130000.0,-39.0,-36.0,-45.0,-52.0,-42.0,-35.0,-43.0,-48.0,-90.0,-93.0,-90.0,-93.0,51.0,57.0,45.0,41.0,0
5193,92:69:1D:31:68:E9,3828140,485864286,3647,3509337,3824493,482354949,0,4032,996203,3918,970648,114,25555,1931,6,3776,79,0,35,216660.0,130000.0,-52.0,-50.0,-44.0,-46.0,-51.0,-49.0,-43.0,-46.0,-90.0,-93.0,-90.0,-93.0,38.0,43.0,46.0,47.0,0
5194,CC:2F:71:3F:1F:24,4455960,1181203080,631467,698848131,3824493,482354949,37,519021,563341536,518394,563266074,627,75462,501340,10,631704,59938,34,450,130000.0,39000.0,-67.0,-65.0,-70.0,-67.0,-67.0,-65.0,-70.0,-67.0,-90.0,-93.0,-90.0,-93.0,23.0,28.0,20.0,26.0,0
5195,CC:2F:71:3E:C5:1F,3825249,482447338,756,92389,3824493,482354949,0,3172,266273,2617,200339,555,65934,800,8,1089,18,0,35,144444.0,39000.0,-70.0,-71.0,-67.0,-60.0,-72.0,-74.0,-69.0,-62.0,-90.0,-93.0,-90.0,-93.0,20.0,22.0,23.0,33.0,0
5196,BA:8C:B9:54:50:24,3829215,488505334,4720,6150183,3824495,482355151,0,8307,1646422,8285,1642927,22,3495,2320,14,5097,36,0,53,216660.0,130000.0,-39.0,-36.0,-45.0,-52.0,-42.0,-35.0,-43.0,-48.0,-90.0,-93.0,-90.0,-93.0,51.0,57.0,45.0,41.0,0
5197,92:69:1D:31:68:E9,3828142,485864488,3647,3509337,3824495,482355151,0,4032,996203,3918,970648,114,25555,1931,6,3776,79,0,35,216660.0,130000.0,-52.0,-50.0,-44.0,-46.0,-51.0,-49.0,-43.0,-46.0,-90.0,-93.0,-90.0,-93.0,38.0,43.0,46.0,47.0,0
5198,CC:2F:71:3F:1F:24,4456004,1181217710,631509,698862559,3824495,482355151,37,519046,563346340,518419,563270878,627,75462,501365,10,631746,59953,34,450,130000.0,39000.0,-67.0,-66.0,-71.0,-68.0,-68.0,-66.0,-71.0,-68.0,-90.0,-93.0,-90.0,-93.0,23.0,27.0,19.0,25.0,0
5199,CC:2F:71:3E:C5:1F,3825255,482447944,756,92389,3824499,482355555,0,3172,266273,2617,200339,555,65934,800,8,1089,18,0,35,144444.0,39000.0,-70.0,-71.0,-67.0,-60.0,-72.0,-74.0,-69.0,-62.0,-90.0,-93.0,-90.0,-93.0,20.0,22.0,23.0,33.0,0
5200,BA:8C:B9:54:50:24,3829219,488505738,4720,6150183,3824499,482355555,0,8307,1646422,8285,1642927,22,3495,2320,14,5097,36,0,53,216660.0,130000.0,-39.0,-36.0,-45.0,-52.0,-42.0,-35.0,-43.0,-48.0,-90.0,-93.0,-90.0,-93.0,51.0,57.0,45.0,41.0,0
5201,92:69:1D:31:68:E9,3828146,485864892,3647,3509337,3824499,482355555,0,4032,996203,3918,970648,114,25555,1931,6,3776,79,0,35,216660.0,130000.0,-52.0,-50.0,-44.0,-46.0,-51.0,-49.0,-43.0,-46.0,-90.0,-93.0,-90.0,-93.0,38.0,43.0,46.0,47.0,0
5202,CC:2F:71:3F:1F:24,4456052,1181232688,631551,698876931,3824501,482355757,37,519071,563351144,518444,563275682,627,75462,501390,10,631788,59972,34,450,130000.0,43333.0,-67.0,-65.0,-70.0,-68.0,-67.0,-65.0,-70.0,-68.0,-90.0,-93.0,-90.0,-93.0,23.0,28.0,20.0,25.0,0
5203,CC:2F:71:3E:C5:1F,3825258,482448206,756,92389,3824502,482355817,0,3172,266273,2617,200339,555,65934,800,8,1089,18,0,35,144444.0,39000.0,-70.0,-71.0,-67.0,-60.0,-72.0,-74.0,-69.0,-62.0,-90.0,-93.0,-90.0,-93.0,20.0,22.0,23.0,33.0,0
5204,BA:8C:B9:54:50:24,3829224,488506202,4720,6150183,3824504,482356019,0,8307,1646422,8285,1642927,22,3495,2320,14,5097,36,0,53,216660.0,130000.0,-39.0,-36.0,-45.0,-52.0,-42.0,-35.0,-43.0,-48.0,-90.0,-93.0,-90.0,-93.0,51.0,57.0,45.0,41.0,0
5205,92:69:1D:31:68:E9,3828174,485876379,3647,3509337,3824527,482367042,0,4035,996574,3920,970784,115,25790,1932,6,3776,79,0,35,216660.0,130000.0,-52.0,-50.0,-45.0,-46.0,-52.0,-50.0,-44.0,-47.0,-90.0,-93.0,-90.0,-93.0,38.0,43.0,45.0,47.0,0
5206,CC:2F:71:3F:1F:24,4456124,1181258933,631593,698891487,3824531,482367446,37,519099,563356332,518472,563280870,627,75462,501418,10,631830,60003,34,450,144444.0,39000.0,-67.0,-65.0,-70.0,-68.0,-67.0,-65.0,-70.0,-67.0,-90.0,-93.0,-90.0,-93.0,23.0,28.0,20.0,25.0,0
5207,CC:2F:71:3E:C5:1F,3825287,482459835,756,92389,3824531,482367446,0,3172,266273,2617,200339,555,65934,800,8,1089,18,0,35,144444.0,39000.0,-70.0,-71.0,-67.0,-60.0,-72.0,-74.0,-69.0,-62.0,-91.0,-93.0,-90.0,-93.0,21.0,22.0,23.0,33.0,0
5208,BA:8C:B9:54:50:24,3829251,488517629,4720,6150183,3824531,482367446,0,8307,1646422,8285,1642927,22,3495,2320,14,5097,36,0,53,216660.0,130000.0,-39.0,-36.0,-45.0,-52.0,-42.0,-35.0,-43.0,-48.0,-91.0,-93.0,-90.0,-93.0,52.0,57.0,45.0,41.0,0
5209,92:69:1D:31:68:E9,3828181,485877258,3647,3509337,3824534,482367921,0,4035,996574,3920,970784,115,25790,1932,6,3776,79,0,35,216660.0,130000.0,-52.0,-50.0,-45.0,-46.0,-52.0,-50.0,-44.0,-47.0,-91.0,-93.0,-90.0,-93.0,39.0,43.0,45.0,47.0,0
5210,CC:2F:71:3F:1F:24,4456168,1181273712,631634,698905791,3824534,482367921,37,519125,563361252,518498,563285790,627,75462,501444,10,631871,60029,34,450,130000.0,43333.0,-67.0,-65.0,-70.0,-68.0,-67.0,-65.0,-70.0,-67.0,-91.0,-93.0,-90.0,-93.0,24.0,28.0,20.0,25.0,0
5211,CC:2F:71:3E:C5:1F,3825290,482460310,756,92389,3824534,482367921,0,3172,266273,2617,200339,555,65934,800,8,1089,18,0,35,144444.0,39000.0,-70.0,-71.0,-67.0,-60.0,-72.0,-74.0,-69.0,-62.0,-91.0,-93.0,-90.0,-93.0,21.0,22.0,23.0,33.0,0
5212,BA:8C:B9:54:50:24,3829256,488518306,4720,6150183,3824536,482368123,0,8307,1646422,8285,1642927,22,3495,2320,14,5097,36,0,53,216660.0,130000.0,-39.0,-36.0,-45.0,-52.0,-42.0,-35.0,-43.0,-48.0,-91.0,-93.0,-90.0,-93.0,52.0,57.0,45.0,41.0,0
5213,92:69:1D:31:68:E9,3828184,485877520,3647,3509337,3824537,482368183,0,4035,996574,3920,970784,115,25790,1932,6,3776,79,0,35,216660.0,130000.0,-52.0,-50.0,-45.0,-46.0,-52.0,-50.0,-44.0,-47.0,-91.0,-93.0,-90.0,-93.0,39.0,43.0,45.0,47.0,0
5214,CC:2F:71:3F:1F:24,4456217,1181288918,631676,698920331,3824541,482368587,37,519153,563366452,518526,563290990,627,75462,501472,10,631913,60036,34,450,130000.0,43333.0,-67.0,-65.0,-70.0,-68.0,-67.0,-65.0,-70.0,-68.0,-91.0,-93.0,-90.0,-93.0,24.0,28.0,20.0,25.0,0
5215,CC:2F:71:3E:C5:1F,3825297,482460976,756,92389,3824541,482368587,0,3172,266273,2617,200339,555,65934,800,8,1089,18,0,35,144444.0,39000.0,-70.0,-71.0,-67.0,-60.0,-72.0,-74.0,-69.0,-62.0,-91.0,-93.0,-90.0,-93.0,21.0,22.0,23.0,33.0,0
5216,BA:8C:B9:54:50:24,3829261,488518770,4720,6150183,3824541,482368587,0,8307,1646422,8285,1642927,22,3495,2320,14,5097,36,0,53,216660.0,130000.0,-39.0,-36.0,-45.0,-52.0,-42.0,-35.0,-43.0,-48.0,-91.0,-93.0,-90.0,-93.0,52.0,57.0,45.0,41.0,0
5217,92:69:1D:31:68:E9,3828190,485878126,3647,3509337,3824543,482368789,0,4035,996574,3920,970784,115,25790,1932,6,3776,79,0,35,216660.0,130000.0,-52.0,-50.0,-45.0,-46.0,-52.0,-50.0,-44.0,-47.0,-91.0,-93.0,-90.0,-93.0,39.0,43.0,45.0,47.0,0
5218,CC:2F:71:3F:1F:24,4456260,1181303424,631717,698934635,3824543,482368789,37,519180,563371488,518553,563296026,627,75462,501499,10,631954,60052,34,450,117000.0,39000.0,-67.0,-65.0,-71.0,-68.0,-67.0,-65.0,-70.0,-67.0,-91.0,-93.0,-90.0,-93.0,24.0,28.0,19.0,25.0,0
5219,CC:2F:71:3E:C5:1F,3825299,482461178,756,92389,3824543,482368789,0,3172,266273,2617,200339,555,65934,800,8,1089,18,0,35,144444.0,39000.0,-70.0,-71.0,-67.0,-60.0,-72.0,-74.0,-69.0,-62.0,-91.0,-93.0,-90.0,-93.0,21.0,22.0,23.0,33.0,0
5220,BA:8C:B9:54:50:24,3829263,488518972,4720,6150183,3824543,482368789,0,8307,1646422,8285,1642927,22,3495,2320,14,5097,36,0,53,216660.0,130000.0,-39.0,-36.0,-45.0,-52.0,-42.0,-35.0,-43.0,-48.0,-91.0,-93.0,-90.0,-93.0,52.0,57.0,45.0,41.0,0
5221,92:69:1D:31:68:E9,3828192,485878328,3647,3509337,3824545,482368991,0,4035,996574,3920,970784,115,25790,1932,6,3776,79,0,35,216660.0,130000.0,-52.0,-50.0,-45.0,-46.0,-52.0,-50.0,-44.0,-47.0,-91.0,-93.0,-90.0,-93.0,39.0,43.0,45.0,47.0,0
5222,CC:2F:71:3F:1F:24,4456308,1181318458,631759,698949063,3824549,482369395,37,519208,563376688,518581,563301226,627,75462,501527,10,631996,60056,34,450,130000.0,43333.0,-67.0,-65.0,-71.0,-68.0,-67.0,-65.0,-70.0,-67.0,-91.0,-93.0,-90.0,-93.0,24.0,28.0,19.0,25.0,0
5223,CC:2F:71:3E:C5:1F,3825307,482462152,756,92389,3824551,482369763,0,3172,266273,2617,200339,555,65934,800,8,1089,18,0,35,144444.0,39000.0,-70.0,-71.0,-67.0,-60.0,-72.0,-74.0,-69.0,-62.0,-91.0,-93.0,-90.0,-93.0,21.0,22.0,23.0,33.0,0
5224,BA:8C:B9:54:50:24,3829271,488519946,4720,6150183,3824551,482369763,0,8307,1646422,8285,1642927,22,3495,2320,14,5097,36,0,53,216660.0,130000.0,-39.0,-36.0,-45.0,-52.0,-42.0,-35.0,-43.0,-48.0,-91.0,-93.0,-90.0,-93.0,52.0,57.0,45.0,41.0,0
5225,92:69:1D:31:68:E9,3828201,485879362,3647,3509337,3824554,482370025,0,4035,996574,3920,970784,115,25790,1932,6,3776,79,0,35,216660.0,130000.0,-52.0,-50.0,-45.0,-46.0,-52.0,-50.0,-44.0,-47.0,-91.0,-93.0,-90.0,-93.0,39.0,43.0,45.0,47.0,0
5226,CC:2F:71:3F:1F:24,4456356,1181333758,631802,698963733,3824554,482370025,37,519233,563381492,518606,563306030,627,75462,501552,10,632039,60058,34,450,130000.0,43333.0,-68.0,-66.0,-72.0,-68.0,-67.0,-65.0,-71.0,-68.0,-91.0,-93.0,-90.0,-93.0,23.0,27.0,18.0,25.0,0
5227,CC:2F:71:3E:C5:1F,3825310,482462414,756,92389,3824554,482370025,0,3172,266273,2617,200339,555,65934,800,8,1089,18,0,35,144444.0,39000.0,-70.0,-71.0,-67.0,-60.0,-72.0,-74.0,-69.0,-62.0,-91.0,-93.0,-90.0,-93.0,21.0,22.0,23.0,33.0,0
5228,BA:8C:B9:54:50:24,3829274,488520208,4720,6150183,3824554,482370025,0,8307,1646422,8285,1642927,22,3495,2320,14,5097,36,0,53,216660.0,130000.0,-39.0,-36.0,-45.0,-52.0,-42.0,-35.0,-43.0,-48.0,-91.0,-93.0,-90.0,-93.0,52.0,57.0,45.0,41.0,0
5229,92:69:1D:31:68:E9,3828205,485879766,3647,3509337,3824558,482370429,0,4035,996574,3920,970784,115,25790,1932,6,3776,79,0,35,216660.0,130000.0,-52.0,-50.0,-45.0,-46.0,-52.0,-50.0,-44.0,-47.0,-91.0,-94.0,-90.0,-93.0,39.0,44.0,45.0,47.0,0
5230,CC:2F:71:3F:1F:24,4456405,1181348922,631845,698978291,3824560,482370631,37,519263,563386876,518636,563311414,627,75462,501582,10,632082,60071,34,450,117000.0,39000.0,-74.0,-72.0,-77.0,-74.0,-72.0,-70.0,-75.0,-72.0,-91.0,-94.0,-90.0,-93.0,17.0,22.0,13.0,19.0,0
5231,CC:2F:71:3E:C5:1F,3825316,482463020,756,92389,3824560,482370631,0,3172,266273,2617,200339,555,65934,800,8,1089,18,0,35,144444.0,39000.0,-70.0,-71.0,-67.0,-60.0,-72.0,-74.0,-69.0,-62.0,-91.0,-94.0,-90.0,-93.0,21.0,23.0,23.0,33.0,0
5232,BA:8C:B9:54:50:24,3829280,488520814,4720,6150183,3824560,482370631,0,8307,1646422,8285,1642927,22,3495,2320,14,5097,36,0,53,216660.0,130000.0,-39.0,-36.0,-45.0,-52.0,-42.0,-35.0,-43.0,-48.0,-91.0,-94.0,-90.0,-93.0,52.0,58.0,45.0,41.0,0
5233,92:69:1D:31:68:E9,3828208,485880028,3647,3509337,3824561,482370691,0,4035,996574,3920,970784,115,25790,1932,6,3776,79,0,35,216660.0,130000.0,-52.0,-50.0,-45.0,-46.0,-52.0,-50.0,-44.0,-47.0,-90.0,-94.0,-90.0,-93.0,38.0,44.0,45.0,47.0,0
5234,CC:2F:71:3F:1F:24,4456450,1181363612,631887,698992719,3824563,482370893,37,519289,563391856,518662,563316394,627,75462,501608,10,632124,60077,34,450,130000.0,43333.0,-68.0,-66.0,-71.0,-68.0,-67.0,-65.0,-70.0,-67.0,-90.0,-94.0,-90.0,-93.0,22.0,28.0,19.0,25.0,0
5235,CC:2F:71:3E:C5:1F,3825319,482463282,756,92389,3824563,482370893,0,3172,266273,2617,200339,555,65934,800,8,1089,18,0,35,144444.0,39000.0,-70.0,-71.0,-67.0,-60.0,-72.0,-74.0,-69.0,-62.0,-90.0,-94.0,-90.0,-93.0,20.0,23.0,23.0,33.0,0
5236,BA:8C:B9:54:50:24,3829283,488521076,4720,6150183,3824563,482370893,0,8307,1646422,8285,1642927,22,3495,2320,14,5097,36,0,53,216660.0,130000.0,-39.0,-36.0,-45.0,-52.0,-42.0,-35.0,-43.0,-48.0,-90.0,-94.0,-90.0,-93.0,51.0,58.0,45.0,41.0,0
5237,92:69:1D:31:68:E9,3828214,485880634,3647,3509337,3824567,482371297,0,4035,996574,3920,970784,115,25790,1932,6,3776,79,0,35,216660.0,130000.0,-52.0,-50.0,-45.0,-46.0,-52.0,-50.0,-44.0,-47.0,-90.0,-94.0,-90.0,-93.0,38.0,44.0,45.0,47.0,0
5238,CC:2F:71:3F:1F:24,4456498,1181378702,631929,699007203,3824569,482371499,37,519316,563396952,518689,563321490,627,75462,501635,10,632166,60082,34,450,130000.0,39000.0,-68.0,-66.0,-71.0,-68.0,-68.0,-66.0,-71.0,-68.0,-90.0,-94.0,-90.0,-93.0,22.0,28.0,19.0,25.0,0
5239,CC:2F:71:3E:C5:1F,3825325,482463888,756,92389,3824569,482371499,0,3172,266273,2617,200339,555,65934,800,8,1089,18,0,35,144444.0,39000.0,-70.0,-71.0,-67.0,-60.0,-72.0,-74.0,-69.0,-62.0,-90.0,-94.0,-90.0,-93.0,20.0,23.0,23.0,33.0,0
5240,BA:8C:B9:54:50:24,3829289,488521682,4720,6150183,3824569,482371499,0,8307,1646422,8285,1642927,22,3495,2320,14,5097,36,0,53,216660.0,130000.0,-39.0,-36.0,-45.0,-52.0,-42.0,-35.0,-43.0,-48.0,-90.0,-94.0,-90.0,-93.0,51.0,58.0,45.0,41.0,0
5241,92:69:1D:31:68:E9,3828218,485881122,3649,3509623,3824569,482371499,0,4039,996978,3924,971188,115,25790,1934,6,3778,79,0,35,216660.0,130000.0,-52.0,-51.0,-45.0,-46.0,-52.0,-50.0,-44.0,-47.0,-90.0,-94.0,-90.0,-93.0,38.0,43.0,45.0,47.0,0
5242,CC:2F:71:3F:1F:24,4456543,1181393456,631972,699021755,3824571,482371701,37,519341,563401756,518714,563326294,627,75462,501660,10,632209,60103,34,450,130000.0,39000.0,-71.0,-69.0,-74.0,-71.0,-70.0,-69.0,-74.0,-71.0,-90.0,-94.0,-90.0,-93.0,19.0,25.0,16.0,22.0,0
5243,CC:2F:71:3E:C5:1F,3825327,482464090,756,92389,3824571,482371701,0,3172,266273,2617,200339,555,65934,800,8,1089,18,0,35,144444.0,39000.0,-70.0,-71.0,-67.0,-60.0,-72.0,-74.0,-69.0,-62.0,-90.0,-94.0,-90.0,-93.0,20.0,23.0,23.0,33.0,0
5244,BA:8C:B9:54:50:24,3829291,488521884,4720,6150183,3824571,482371701,0,8307,1646422,8285,1642927,22,3495,2320,14,5097,36,0,53,216660.0,130000.0,-39.0,-36.0,-45.0,-52.0,-42.0,-35.0,-43.0,-48.0,-90.0,-94.0,-90.0,-93.0,51.0,58.0,45.0,41.0,0
5245,92:69:1D:31:68:E9,3828293,485942378,3717,3570213,3824576,482372165,0,4100,1021316,3985,995526,115,25790,1979,6,3846,79,0,35,229410.0,137640.0,-52.0,-51.0,-46.0,-50.0,-52.0,-51.0,-46.0,-50.0,-90.0,-94.0,-90.0,-93.0,38.0,43.0,44.0,43.0,0
5246,CC:2F:71:3F:1F:24,4456590,1181408420,632014,699036255,3824576,482372165,37,519367,563406700,518740,563331238,627,75462,501686,10,632251,60105,34,450,130000.0,43333.0,-71.0,-69.0,-74.0,-71.0,-70.0,-69.0,-74.0,-71.0,-90.0,-94.0,-90.0,-93.0,19.0,25.0,16.0,22.0,0
5247,CC:2F:71:3E:C5:1F,3825334,482464756,756,92389,3824578,482372367,0,3172,266273,2617,200339,555,65934,800,8,1089,18,0,35,144444.0,39000.0,-70.0,-71.0,-67.0,-60.0,-72.0,-74.0,-69.0,-62.0,-90.0,-94.0,-90.0,-93.0,20.0,23.0,23.0,33.0,0
5248,BA:8C:B9:54:50:24,3829298,488522550,4720,6150183,3824578,482372367,0,8307,1646422,8285,1642927,22,3495,2320,14,5097,36,0,53,216660.0,130000.0,-39.0,-36.0,-45.0,-52.0,-42.0,-35.0,-43.0,-48.0,-90.0,-94.0,-90.0,-93.0,51.0,58.0,45.0,41.0,0
5249,92:69:1D:31:68:E9,3828316,485951102,3738,3578735,3824578,482372367,0,4126,1037570,4011,1011780,115,25790,1997,6,3867,79,0,35,229410.0,137640.0,-52.0,-50.0,-44.0,-46.0,-52.0,-50.0,-45.0,-49.0,-90.0,-94.0,-90.0,-93.0,38.0,44.0,46.0,47.0,0
5250,CC:2F:71:3F:1F:24,4456634,1181423050,632056,699050683,3824578,482372367,37,519392,563411504,518765,563336042,627,75462,501711,10,632293,60120,34,450,117000.0,39000.0,-71.0,-69.0,-74.0,-71.0,-70.0,-69.0,-74.0,-71.0,-90.0,-94.0,-90.0,-93.0,19.0,25.0,16.0,22.0,0
5251,CC:2F:71:3E:C5:1F,3825336,482464958,756,92389,3824580,482372569,0,3172,266273,2617,200339,555,65934,800,8,1089,18,0,35,144444.0,39000.0,-70.0,-71.0,-67.0,-60.0,-72.0,-74.0,-69.0,-62.0,-90.0,-94.0,-90.0,-93.0,20.0,23.0,23.0,33.0,0
5252,BA:8C:B9:54:50:24,3829300,488522752,4720,6150183,3824580,482372569,0,8307,1646422,8285,1642927,22,3495,2320,14,5097,36,0,53,216660.0,130000.0,-39.0,-36.0,-45.0,-52.0,-42.0,-35.0,-43.0,-48.0,-90.0,-94.0,-90.0,-93.0,51.0,58.0,45.0,41.0,0
5253,92:69:1D:31:68:E9,3828322,485951708,3738,3578735,3824584,482372973,0,4126,1037570,4011,1011780,115,25790,1997,6,3867,79,0,35,229410.0,137640.0,-52.0,-50.0,-44.0,-46.0,-52.0,-50.0,-45.0,-49.0,-90.0,-94.0,-90.0,-93.0,38.0,44.0,46.0,47.0,0
5254,CC:2F:71:3F:1F:24,4456683,1181438152,632099,699065179,3824584,482372973,37,519418,563416448,518791,563340986,627,75462,501737,10,632336,60133,34,450,130000.0,39000.0,-71.0,-69.0,-74.0,-71.0,-70.0,-69.0,-74.0,-71.0,-90.0,-94.0,-90.0,-93.0,19.0,25.0,16.0,22.0,0
5255,CC:2F:71:3E:C5:1F,3825342,482465564,756,92389,3824586,482373175,0,3172,266273,2617,200339,555,65934,800,8,1089,18,0,35,144444.0,39000.0,-70.0,-71.0,-67.0,-60.0,-72.0,-74.0,-69.0,-62.0,-90.0,-94.0,-90.0,-93.0,20.0,23.0,23.0,33.0,0
5256,BA:8C:B9:54:50:24,3829307,488523418,4720,6150183,3824587,482373235,0,8307,1646422,8285,1642927,22,3495,2320,14,5097,36,0,53,216660.0,130000.0,-39.0,-36.0,-45.0,-52.0,-42.0,-35.0,-43.0,-48.0,-90.0,-94.0,-90.0,-93.0,51.0,58.0,45.0,41.0,0
5257,92:69:1D:31:68:E9,3828325,485951970,3738,3578735,3824587,482373235,0,4126,1037570,4011,1011780,115,25790,1997,6,3867,79,0,35,229410.0,137640.0,-52.0,-50.0,-44.0,-46.0,-52.0,-50.0,-45.0,-49.0,-90.0,-94.0,-90.0,-93.0,38.0,44.0,46.0,47.0,0
5258,CC:2F:71:3F:1F:24,4456728,1181452834,632141,699079599,3824587,482373235,37,519443,563421252,518816,563345790,627,75462,501762,10,632378,60173,34,450,144444.0,43333.0,-70.0,-68.0,-73.0,-70.0,-68.0,-66.0,-72.0,-69.0,-90.0,-94.0,-90.0,-93.0,20.0,26.0,17.0,23.0,0
5259,CC:2F:71:3E:C5:1F,3825346,482465942,757,92505,3824589,482373437,0,3173,266343,2618,200409,555,65934,800,8,1090,18,0,35,144444.0,39000.0,-70.0,-71.0,-67.0,-60.0,-72.0,-74.0,-69.0,-62.0,-90.0,-94.0,-90.0,-93.0,20.0,23.0,23.0,33.0,0
5260,BA:8C:B9:54:50:24,3829310,488523736,4721,6150299,3824589,482373437,0,8308,1646490,8286,1642995,22,3495,2320,14,5098,36,0,53,216660.0,130000.0,-39.0,-36.0,-45.0,-52.0,-41.0,-35.0,-44.0,-49.0,-90.0,-94.0,-90.0,-93.0,51.0,58.0,45.0,41.0,0
5261,92:69:1D:31:68:E9,3828334,485953816,3739,3578851,3824595,482374965,0,4128,1037706,4013,1011916,115,25790,1997,6,3868,79,0,35,229410.0,137640.0,-52.0,-51.0,-44.0,-48.0,-51.0,-50.0,-45.0,-49.0,-90.0,-94.0,-90.0,-93.0,38.0,43.0,46.0,45.0,0
5262,CC:2F:71:3F:1F:24,4456781,1181469523,632183,699094083,3824598,482375440,37,519468,563426056,518841,563350594,627,75462,501787,10,632420,60190,34,450,130000.0,43333.0,-67.0,-66.0,-71.0,-68.0,-67.0,-65.0,-70.0,-68.0,-90.0,-94.0,-90.0,-93.0,23.0,28.0,19.0,25.0,0
5263,CC:2F:71:3E:C5:1F,3825355,482467945,757,92505,3824598,482375440,0,3174,266413,2619,200479,555,65934,800,8,1090,18,0,35,144444.0,39000.0,-70.0,-71.0,-67.0,-60.0,-71.0,-72.0,-68.0,-61.0,-90.0,-94.0,-90.0,-93.0,20.0,23.0,23.0,33.0,0
5264,BA:8C:B9:54:50:24,3829319,488525739,4721,6150299,3824598,482375440,0,8309,1646558,8287,1643063,22,3495,2320,14,5098,36,0,53,216660.0,130000.0,-39.0,-36.0,-44.0,-51.0,-41.0,-35.0,-44.0,-49.0,-90.0,-94.0,-90.0,-93.0,51.0,58.0,46.0,42.0,0
5265,92:69:1D:31:68:E9,3828338,485954351,3739,3578851,3824599,482375500,0,4128,1037706,4013,1011916,115,25790,1997,6,3868,79,0,35,229410.0,137640.0,-52.0,-51.0,-44.0,-48.0,-51.0,-50.0,-45.0,-49.0,-90.0,-94.0,-90.0,-93.0,38.0,43.0,46.0,45.0,0
5266,CC:2F:71:3F:1F:24,4456823,1181483937,632224,699108437,3824599,482375500,37,519494,563431000,518867,563355538,627,75462,501813,10,632461,60206,34,450,130000.0,39000.0,-67.0,-65.0,-71.0,-67.0,-67.0,-65.0,-70.0,-67.0,-90.0,-94.0,-90.0,-93.0,23.0,29.0,19.0,26.0,0
5267,CC:2F:71:3E:C5:1F,3825358,482468207,757,92505,3824601,482375702,0,3174,266413,2619,200479,555,65934,800,8,1090,18,0,35,144444.0,39000.0,-70.0,-71.0,-67.0,-60.0,-71.0,-72.0,-68.0,-61.0,-90.0,-94.0,-90.0,-93.0,20.0,23.0,23.0,33.0,0
5268,BA:8C:B9:54:50:24,3829322,488526001,4721,6150299,3824601,482375702,0,8310,1646626,8288,1643131,22,3495,2320,14,5098,36,0,53,216660.0,130000.0,-49.0,-35.0,-42.0,-45.0,-42.0,-35.0,-43.0,-49.0,-90.0,-94.0,-90.0,-93.0,41.0,59.0,48.0,48.0,0
5269,92:69:1D:31:68:E9,3828348,485956259,3740,3578967,3824608,482377292,0,4131,1037952,4016,1012162,115,25790,1998,6,3869,79,0,35,229410.0,137640.0,-52.0,-50.0,-45.0,-46.0,-52.0,-50.0,-44.0,-48.0,-90.0,-94.0,-90.0,-93.0,38.0,44.0,45.0,47.0,0
5270,CC:2F:71:3F:1F:24,4456875,1181500287,632267,699122995,3824608,482377292,37,519522,563436178,518894,563360598,628,75580,501841,10,632504,60223,34,450,130000.0,39000.0,-67.0,-66.0,-71.0,-68.0,-67.0,-65.0,-70.0,-67.0,-90.0,-94.0,-90.0,-93.0,23.0,28.0,19.0,25.0,0
5271,CC:2F:71:3E:C5:1F,3825367,482469999,757,92505,3824610,482377494,0,3174,266413,2619,200479,555,65934,800,8,1090,18,0,35,144444.0,39000.0,-70.0,-71.0,-67.0,-60.0,-71.0,-72.0,-68.0,-61.0,-90.0,-94.0,-90.0,-93.0,20.0,23.0,23.0,33.0,0
5272,BA:8C:B9:54:50:24,3829331,488527793,4721,6150299,3824610,482377494,0,8310,1646626,8288,1643131,22,3495,2320,14,5098,36,0,53,216660.0,130000.0,-49.0,-35.0,-42.0,-45.0,-42.0,-35.0,-43.0,-49.0,-90.0,-94.0,-90.0,-93.0,41.0,59.0,48.0,48.0,0
5273,92:69:1D:31:68:E9,3828350,485956461,3740,3578967,3824610,482377494,0,4131,1037952,4016,1012162,115,25790,1998,6,3869,79,0,35,229410.0,137640.0,-52.0,-50.0,-45.0,-46.0,-52.0,-50.0,-44.0,-48.0,-90.0,-94.0,-90.0,-93.0,38.0,44.0,45.0,47.0,0
5274,CC:2F:71:3F:1F:24,4456920,1181515097,632310,699137603,3824610,482377494,37,519548,563441122,518920,563365542,628,75580,501867,10,632547,60227,34,450,130000.0,43333.0,-67.0,-65.0,-70.0,-68.0,-67.0,-65.0,-70.0,-67.0,-90.0,-94.0,-90.0,-93.0,23.0,29.0,20.0,25.0,0
5275,CC:2F:71:3E:C5:1F,3825369,482470201,757,92505,3824612,482377696,0,3174,266413,2619,200479,555,65934,800,8,1090,18,0,35,144444.0,39000.0,-70.0,-71.0,-67.0,-60.0,-71.0,-72.0,-68.0,-61.0,-90.0,-94.0,-90.0,-93.0,20.0,23.0,23.0,33.0,0
5276,BA:8C:B9:54:50:24,3829334,488528111,4722,6150415,3824612,482377696,0,8313,1646868,8291,1643373,22,3495,2321,14,5099,36,0,53,216660.0,130000.0,-40.0,-36.0,-45.0,-51.0,-41.0,-35.0,-43.0,-49.0,-90.0,-94.0,-90.0,-93.0,50.0,58.0,45.0,42.0,0
5277,92:69:1D:31:68:E9,3828359,485958251,3740,3578967,3824619,482379284,0,4131,1037952,4016,1012162,115,25790,1998,6,3869,79,0,35,229410.0,137640.0,-52.0,-50.0,-45.0,-46.0,-52.0,-50.0,-44.0,-48.0,-90.0,-94.0,-90.0,-93.0,38.0,44.0,45.0,47.0,0
5278,CC:2F:71:3F:1F:24,4456971,1181531371,632352,699152087,3824619,482379284,37,519575,563446182,518947,563370602,628,75580,501894,10,632589,60244,34,450,130000.0,39000.0,-68.0,-65.0,-71.0,-68.0,-67.0,-65.0,-70.0,-68.0,-90.0,-94.0,-90.0,-93.0,22.0,29.0,19.0,25.0,0
5279,CC:2F:71:3E:C5:1F,3825378,482471991,757,92505,3824621,482379486,0,3174,266413,2619,200479,555,65934,800,8,1090,18,0,35,144444.0,39000.0,-70.0,-71.0,-67.0,-60.0,-71.0,-72.0,-68.0,-61.0,-90.0,-94.0,-90.0,-93.0,20.0,23.0,23.0,33.0,0
5280,BA:8C:B9:54:50:24,3829343,488529901,4722,6150415,3824621,482379486,0,8313,1646868,8291,1643373,22,3495,2321,14,5099,36,0,53,216660.0,130000.0,-40.0,-36.0,-45.0,-51.0,-41.0,-35.0,-43.0,-49.0,-90.0,-94.0,-90.0,-93.0,50.0,58.0,45.0,42.0,0
5281,92:69:1D:31:68:E9,3828361,485958453,3740,3578967,3824621,482379486,0,4131,1037952,4016,1012162,115,25790,1998,6,3869,79,0,35,229410.0,137640.0,-52.0,-50.0,-45.0,-46.0,-52.0,-50.0,-44.0,-48.0,-90.0,-94.0,-90.0,-93.0,38.0,44.0,45.0,47.0,0
5282,CC:2F:71:3F:1F:24,4457016,1181546069,632395,699166583,3824621,482379486,37,519602,563451266,518974,563375686,628,75580,501921,10,632632,60268,34,450,130000.0,43333.0,-68.0,-66.0,-71.0,-68.0,-67.0,-65.0,-71.0,-67.0,-90.0,-94.0,-90.0,-93.0,22.0,28.0,19.0,25.0,0
5283,CC:2F:71:3E:C5:1F,3825378,482471991,757,92505,3824621,482379486,0,3176,266553,2621,200619,555,65934,800,8,1091,18,0,35,144444.0,39000.0,-71.0,-71.0,-67.0,-60.0,-70.0,-71.0,-67.0,-59.0,-90.0,-94.0,-90.0,-93.0,19.0,23.0,23.0,33.0,0
5284,BA:8C:B9:54:50:24,3829345,488530103,4722,6150415,3824623,482379688,0,8313,1646868,8291,1643373,22,3495,2321,14,5099,36,0,53,216660.0,130000.0,-40.0,-36.0,-45.0,-51.0,-41.0,-35.0,-43.0,-49.0,-90.0,-94.0,-90.0,-93.0,50.0,58.0,45.0,42.0,0
5285,92:69:1D:31:68:E9,3828367,485959059,3740,3578967,3824627,482380092,0,4131,1037952,4016,1012162,115,25790,1998,6,3869,79,0,35,229410.0,137640.0,-52.0,-50.0,-45.0,-46.0,-52.0,-50.0,-44.0,-48.0,-90.0,-94.0,-90.0,-93.0,38.0,44.0,45.0,47.0,0
5286,CC:2F:71:3F:1F:24,4457064,1181561159,632437,699181067,3824627,482380092,37,519629,563456326,519001,563380746,628,75580,501948,10,632674,60283,34,450,130000.0,39000.0,-68.0,-66.0,-70.0,-68.0,-67.0,-65.0,-70.0,-67.0,-90.0,-94.0,-90.0,-93.0,22.0,28.0,20.0,25.0,0
5287,CC:2F:71:3E:C5:1F,3825386,482472799,757,92505,3824629,482380294,0,3176,266553,2621,200619,555,65934,800,8,1091,18,0,35,144444.0,39000.0,-71.0,-71.0,-67.0,-60.0,-70.0,-71.0,-67.0,-59.0,-90.0,-94.0,-90.0,-93.0,19.0,23.0,23.0,33.0,0
5288,BA:8C:B9:54:50:24,3829352,488530769,4722,6150415,3824630,482380354,0,8313,1646868,8291,1643373,22,3495,2321,14,5099,36,0,53,216660.0,130000.0,-40.0,-36.0,-45.0,-51.0,-41.0,-35.0,-43.0,-49.0,-90.0,-94.0,-90.0,-93.0,50.0,58.0,45.0,42.0,0
5289,92:69:1D:31:68:E9,3828371,485959383,3740,3578967,3824631,482380416,0,4131,1037952,4016,1012162,115,25790,1998,6,3869,79,0,35,229410.0,137640.0,-52.0,-50.0,-45.0,-46.0,-52.0,-50.0,-44.0,-48.0,-90.0,-94.0,-90.0,-93.0,38.0,44.0,45.0,47.0,0
5290,CC:2F:71:3F:1F:24,4457109,1181575787,632478,699195371,3824631,482380416,37,519654,563461130,519026,563385550,628,75580,501973,10,632715,60295,34,450,130000.0,39000.0,-67.0,-66.0,-71.0,-68.0,-67.0,-65.0,-70.0,-68.0,-90.0,-94.0,-90.0,-93.0,23.0,28.0,19.0,25.0,0
5291,CC:2F:71:3E:C5:1F,3825388,482472921,757,92505,3824631,482380416,0,3178,266741,2622,200689,556,66052,801,8,1091,18,0,35,144444.0,39000.0,-71.0,-71.0,-68.0,-60.0,-70.0,-71.0,-67.0,-60.0,-90.0,-94.0,-90.0,-93.0,19.0,23.0,22.0,33.0,0
5292,BA:8C:B9:54:50:24,3829355,488531033,4722,6150415,3824633,482380618,0,8313,1646868,8291,1643373,22,3495,2321,14,5099,36,0,53,216660.0,130000.0,-40.0,-36.0,-45.0,-51.0,-41.0,-35.0,-43.0,-49.0,-90.0,-94.0,-90.0,-93.0,50.0,58.0,45.0,42.0,0
5293,92:69:1D:31:68:E9,3828377,485959989,3740,3578967,3824637,482381022,0,4131,1037952,4016,1012162,115,25790,1998,6,3869,79,0,35,229410.0,137640.0,-52.0,-50.0,-45.0,-46.0,-52.0,-50.0,-44.0,-48.0,-90.0,-94.0,-90.0,-93.0,38.0,44.0,45.0,47.0,0
5294,CC:2F:71:3F:1F:24,4457157,1181590827,632520,699209805,3824637,482381022,37,519681,563466190,519053,563390610,628,75580,502000,10,632757,60311,34,450,130000.0,39000.0,-67.0,-65.0,-71.0,-68.0,-67.0,-65.0,-71.0,-68.0,-90.0,-94.0,-90.0,-93.0,23.0,29.0,19.0,25.0,0
5295,CC:2F:71:3E:C5:1F,3825396,482473729,757,92505,3824639,482381224,0,3178,266741,2622,200689,556,66052,801,8,1091,18,0,35,144444.0,39000.0,-71.0,-71.0,-68.0,-60.0,-70.0,-71.0,-67.0,-60.0,-90.0,-94.0,-90.0,-93.0,19.0,23.0,22.0,33.0,0
5296,BA:8C:B9:54:50:24,3829361,488531639,4722,6150415,3824639,482381224,0,8313,1646868,8291,1643373,22,3495,2321,14,5099,36,0,53,216660.0,130000.0,-40.0,-36.0,-45.0,-51.0,-41.0,-35.0,-43.0,-49.0,-90.0,-94.0,-90.0,-93.0,50.0,58.0,45.0,42.0,0
5297,92:69:1D:31:68:E9,3828380,485960251,3740,3578967,3824640,482381284,0,4131,1037952,4016,1012162,115,25790,1998,6,3869,79,0,35,229410.0,137640.0,-52.0,-50.0,-45.0,-46.0,-52.0,-50.0,-44.0,-48.0,-90.0,-94.0,-90.0,-93.0,38.0,44.0,45.0,47.0,0
5298,CC:2F:71:3F:1F:24,4457202,1181605517,632562,699224233,3824640,482381284,37,519707,563471134,519079,563395554,628,75580,502026,10,632799,60336,34,450,130000.0,43333.0,-68.0,-66.0,-71.0,-68.0,-67.0,-65.0,-70.0,-68.0,-90.0,-94.0,-90.0,-93.0,22.0,28.0,19.0,25.0,0
5299,CC:2F:71:3E:C5:1F,3825397,482473789,757,92505,3824640,482381284,0,3178,266741,2622,200689,556,66052,801,8,1091,18,0,35,144444.0,39000.0,-71.0,-71.0,-68.0,-60.0,-70.0,-71.0,-67.0,-60.0,-90.0,-94.0,-90.0,-93.0,19.0,23.0,22.0,33.0,0
5300,BA:8C:B9:54:50:24,3829362,488531699,4722,6150415,3824640,482381284,0,8313,1646868,8291,1643373,22,3495,2321,14,5099,36,0,53,216660.0,130000.0,-40.0,-36.0,-45.0,-51.0,-41.0,-35.0,-43.0,-49.0,-90.0,-94.0,-90.0,-93.0,50.0,58.0,45.0,42.0,0
5301,92:69:1D:31:68:E9,3828386,485960857,3740,3578967,3824646,482381890,0,4131,1037952,4016,1012162,115,25790,1998,6,3869,79,0,35,229410.0,137640.0,-52.0,-50.0,-45.0,-46.0,-52.0,-50.0,-44.0,-48.0,-90.0,-94.0,-90.0,-93.0,38.0,44.0,45.0,47.0,0
5302,CC:2F:71:3F:1F:24,4457253,1181621047,632607,699239157,3824646,482381890,37,519733,563476078,519105,563400498,628,75580,502052,10,632844,60341,34,450,130000.0,43333.0,-67.0,-65.0,-71.0,-68.0,-67.0,-65.0,-70.0,-67.0,-90.0,-94.0,-90.0,-93.0,23.0,29.0,19.0,25.0,0
5303,CC:2F:71:3E:C5:1F,3825403,482474395,757,92505,3824646,482381890,0,3178,266741,2622,200689,556,66052,801,8,1091,18,0,35,144444.0,39000.0,-71.0,-71.0,-68.0,-60.0,-70.0,-71.0,-67.0,-60.0,-90.0,-94.0,-90.0,-93.0,19.0,23.0,22.0,33.0,0
5304,BA:8C:B9:54:50:24,3829370,488532507,4722,6150415,3824648,482382092,0,8313,1646868,8291,1643373,22,3495,2321,14,5099,36,0,53,216660.0,130000.0,-40.0,-36.0,-45.0,-51.0,-41.0,-35.0,-43.0,-49.0,-90.0,-94.0,-90.0,-93.0,50.0,58.0,45.0,42.0,0
5305,92:69:1D:31:68:E9,3828388,485961059,3740,3578967,3824648,482382092,0,4131,1037952,4016,1012162,115,25790,1998,6,3869,79,0,35,229410.0,137640.0,-52.0,-50.0,-45.0,-46.0,-52.0,-50.0,-44.0,-48.0,-90.0,-94.0,-90.0,-93.0,38.0,44.0,45.0,47.0,0
5306,CC:2F:71:3F:1F:24,4457296,1181635665,632648,699253573,3824648,482382092,37,519759,563480998,519131,563405418,628,75580,502078,10,632885,60348,34,450,130000.0,43333.0,-67.0,-65.0,-70.0,-67.0,-67.0,-65.0,-70.0,-67.0,-90.0,-94.0,-90.0,-93.0,23.0,29.0,20.0,26.0,0
5307,CC:2F:71:3E:C5:1F,3825405,482474597,757,92505,3824648,482382092,0,3178,266741,2622,200689,556,66052,801,8,1091,18,0,35,144444.0,39000.0,-71.0,-71.0,-68.0,-60.0,-70.0,-71.0,-67.0,-60.0,-90.0,-94.0,-90.0,-93.0,19.0,23.0,22.0,33.0,0
5308,BA:8C:B9:54:50:24,3829370,488532507,4722,6150415,3824648,482382092,0,8313,1646868,8291,1643373,22,3495,2321,14,5099,36,0,53,216660.0,130000.0,-40.0,-36.0,-45.0,-51.0,-41.0,-35.0,-43.0,-49.0,-90.0,-94.0,-90.0,-93.0,50.0,58.0,45.0,42.0,0
5309,92:69:1D:31:68:E9,3828396,485961851,3740,3578967,3824656,482382884,0,4131,1037952,4016,1012162,115,25790,1998,6,3869,79,0,35,229410.0,137640.0,-52.0,-50.0,-45.0,-46.0,-52.0,-50.0,-44.0,-48.0,-90.0,-94.0,-90.0,-93.0,38.0,44.0,45.0,47.0,0
5310,CC:2F:71:3F:1F:24,4457346,1181650885,632690,699268001,3824656,482382884,37,519785,563485942,519157,563410362,628,75580,502104,10,632927,60374,34,450,117000.0,39000.0,-67.0,-65.0,-70.0,-68.0,-67.0,-65.0,-70.0,-67.0,-90.0,-94.0,-90.0,-93.0,23.0,29.0,20.0,25.0,0
5311,CC:2F:71:3E:C5:1F,3825413,482475389,757,92505,3824656,482382884,0,3178,266741,2622,200689,556,66052,801,8,1091,18,0,35,144444.0,39000.0,-71.0,-71.0,-68.0,-60.0,-70.0,-71.0,-67.0,-60.0,-90.0,-94.0,-90.0,-93.0,19.0,23.0,22.0,33.0,0
5312,BA:8C:B9:54:50:24,3829378,488533299,4722,6150415,3824656,482382884,0,8313,1646868,8291,1643373,22,3495,2321,14,5099,36,0,53,216660.0,130000.0,-40.0,-36.0,-45.0,-51.0,-41.0,-35.0,-43.0,-49.0,-90.0,-94.0,-90.0,-93.0,50.0,58.0,45.0,42.0,0
5313,92:69:1D:31:68:E9,3828398,485962053,3740,3578967,3824658,482383086,0,4131,1037952,4016,1012162,115,25790,1998,6,3869,79,0,35,229410.0,137640.0,-52.0,-50.0,-45.0,-46.0,-52.0,-50.0,-44.0,-48.0,-90.0,-94.0,-90.0,-93.0,38.0,44.0,45.0,47.0,0
5314,CC:2F:71:3F:1F:24,4457393,1181665923,632735,699282837,3824658,482383086,37,519811,563490850,519183,563415270,628,75580,502130,10,632972,60374,34,450,130000.0,43333.0,-67.0,-65.0,-70.0,-68.0,-67.0,-65.0,-70.0,-67.0,-90.0,-94.0,-90.0,-93.0,23.0,29.0,20.0,25.0,0
5315,CC:2F:71:3E:C5:1F,3825415,482475591,757,92505,3824658,482383086,0,3178,266741,2622,200689,556,66052,801,8,1091,18,0,35,144444.0,39000.0,-71.0,-71.0,-68.0,-60.0,-70.0,-71.0,-67.0,-60.0,-90.0,-94.0,-90.0,-93.0,19.0,23.0,22.0,33.0,0
5316,BA:8C:B9:54:50:24,3829383,488533976,4722,6150415,3824661,482383561,0,8313,1646868,8291,1643373,22,3495,2321,14,5099,36,0,53,216660.0,130000.0,-40.0,-36.0,-45.0,-51.0,-41.0,-35.0,-43.0,-49.0,-90.0,-94.0,-90.0,-93.0,50.0,58.0,45.0,42.0,0
5317,92:69:1D:31:68:E9,3828406,485962992,3740,3578967,3824666,482384025,0,4131,1037952,4016,1012162,115,25790,1998,6,3869,79,0,35,229410.0,137640.0,-52.0,-50.0,-45.0,-46.0,-52.0,-50.0,-44.0,-48.0,-90.0,-94.0,-90.0,-93.0,38.0,44.0,45.0,47.0,0
5318,CC:2F:71:3F:1F:24,4457443,1181681296,632777,699297271,3824666,482384025,37,519836,563495654,519208,563420074,628,75580,502155,10,633014,60394,34,450,117000.0,39000.0,-67.0,-65.0,-71.0,-68.0,-67.0,-65.0,-70.0,-67.0,-90.0,-94.0,-90.0,-93.0,23.0,29.0,19.0,25.0,0
5319,CC:2F:71:3E:C5:1F,3825423,482476530,757,92505,3824666,482384025,0,3178,266741,2622,200689,556,66052,801,8,1091,18,0,35,144444.0,39000.0,-71.0,-71.0,-68.0,-60.0,-70.0,-71.0,-67.0,-60.0,-90.0,-94.0,-90.0,-93.0,19.0,23.0,22.0,33.0,0
5320,BA:8C:B9:54:50:24,3829388,488534440,4722,6150415,3824666,482384025,0,8313,1646868,8291,1643373,22,3495,2321,14,5099,36,0,53,216660.0,130000.0,-40.0,-36.0,-45.0,-51.0,-41.0,-35.0,-43.0,-49.0,-90.0,-94.0,-90.0,-93.0,50.0,58.0,45.0,42.0,0
5321,92:69:1D:31:68:E9,3828408,485963194,3740,3578967,3824668,482384227,0,4131,1037952,4016,1012162,115,25790,1998,6,3869,79,0,35,229410.0,137640.0,-52.0,-50.0,-45.0,-46.0,-52.0,-50.0,-44.0,-48.0,-90.0,-94.0,-90.0,-93.0,38.0,44.0,45.0,47.0,0
5322,CC:2F:71:3F:1F:24,4457488,1181696178,632820,699311951,3824668,482384227,37,519864,563500842,519236,563425262,628,75580,502183,10,633057,60399,34,450,130000.0,39000.0,-67.0,-65.0,-70.0,-67.0,-67.0,-65.0,-70.0,-67.0,-90.0,-94.0,-90.0,-93.0,23.0,29.0,20.0,26.0,0
5323,CC:2F:71:3E:C5:1F,3825425,482476732,757,92505,3824668,482384227,0,3178,266741,2622,200689,556,66052,801,8,1091,18,0,35,144444.0,39000.0,-71.0,-71.0,-68.0,-60.0,-70.0,-71.0,-67.0,-60.0,-90.0,-94.0,-90.0,-93.0,19.0,23.0,22.0,33.0,0
5324,BA:8C:B9:54:50:24,3829392,488534844,4722,6150415,3824670,482384429,0,8313,1646868,8291,1643373,22,3495,2321,14,5099,36,0,53,216660.0,130000.0,-40.0,-36.0,-45.0,-51.0,-41.0,-35.0,-43.0,-49.0,-90.0,-94.0,-90.0,-93.0,50.0,58.0,45.0,42.0,0
5325,92:69:1D:31:68:E9,3828414,485963800,3740,3578967,3824674,482384833,0,4131,1037952,4016,1012162,115,25790,1998,6,3869,79,0,35,229410.0,137640.0,-52.0,-50.0,-45.0,-46.0,-52.0,-50.0,-44.0,-48.0,-90.0,-94.0,-90.0,-93.0,38.0,44.0,45.0,47.0,0
5326,CC:2F:71:3F:1F:24,4457536,1181711156,632862,699326323,3824674,482384833,37,519892,563506018,519264,563430438,628,75580,502211,10,633099,60408,34,450,130000.0,39000.0,-67.0,-65.0,-70.0,-67.0,-67.0,-65.0,-70.0,-67.0,-90.0,-94.0,-90.0,-93.0,23.0,29.0,20.0,26.0,0
5327,CC:2F:71:3E:C5:1F,3825431,482477338,757,92505,3824674,482384833,0,3178,266741,2622,200689,556,66052,801,8,1091,18,0,35,144444.0,39000.0,-71.0,-71.0,-68.0,-60.0,-70.0,-71.0,-67.0,-60.0,-90.0,-94.0,-90.0,-93.0,19.0,23.0,22.0,33.0,0
5328,BA:8C:B9:54:50:24,3829396,488535248,4722,6150415,3824674,482384833,0,8313,1646868,8291,1643373,22,3495,2321,14,5099,36,0,53,216660.0,130000.0,-40.0,-36.0,-45.0,-51.0,-41.0,-35.0,-43.0,-49.0,-90.0,-94.0,-90.0,-93.0,50.0,58.0,45.0,42.0,0
5329,92:69:1D:31:68:E9,3828417,485964062,3740,3578967,3824677,482385095,0,4131,1037952,4016,1012162,115,25790,1998,6,3869,79,0,35,229410.0,137640.0,-52.0,-50.0,-45.0,-46.0,-52.0,-50.0,-44.0,-48.0,-90.0,-94.0,-90.0,-93.0,38.0,44.0,45.0,47.0,0
5330,CC:2F:71:3F:1F:24,4457584,1181726174,632907,699341079,3824677,482385095,37,519917,563510822,519289,563435242,628,75580,502236,10,633144,60426,34,450,117000.0,39000.0,-67.0,-65.0,-71.0,-68.0,-67.0,-65.0,-70.0,-67.0,-90.0,-94.0,-90.0,-93.0,23.0,29.0,19.0,25.0,0
5331,CC:2F:71:3E:C5:1F,3825434,482477600,757,92505,3824677,482385095,0,3178,266741,2622,200689,556,66052,801,8,1091,18,0,35,144444.0,39000.0,-71.0,-71.0,-68.0,-60.0,-70.0,-71.0,-67.0,-60.0,-90.0,-94.0,-90.0,-93.0,19.0,23.0,22.0,33.0,0
5332,BA:8C:B9:54:50:24,3829399,488535510,4722,6150415,3824677,482385095,0,8313,1646868,8291,1643373,22,3495,2321,14,5099,36,0,53,216660.0,130000.0,-40.0,-36.0,-45.0,-51.0,-41.0,-35.0,-43.0,-49.0,-90.0,-94.0,-90.0,-93.0,50.0,58.0,45.0,42.0,0
5333,92:69:1D:31:68:E9,3828423,485964668,3740,3578967,3824683,482385701,0,4131,1037952,4016,1012162,115,25790,1998,6,3869,79,0,35,229410.0,137640.0,-52.0,-50.0,-45.0,-46.0,-52.0,-50.0,-44.0,-48.0,-90.0,-94.0,-90.0,-93.0,38.0,44.0,45.0,47.0,0
5334,CC:2F:71:3F:1F:24,4457632,1181741214,632949,699355513,3824683,482385701,37,519942,563515626,519314,563440046,628,75580,502261,10,633186,60433,34,450,130000.0,43333.0,-67.0,-65.0,-70.0,-68.0,-67.0,-65.0,-70.0,-67.0,-90.0,-94.0,-90.0,-93.0,23.0,29.0,20.0,25.0,0
5335,CC:2F:71:3E:C5:1F,3825440,482478206,757,92505,3824683,482385701,0,3178,266741,2622,200689,556,66052,801,8,1091,18,0,35,144444.0,39000.0,-71.0,-71.0,-68.0,-60.0,-70.0,-71.0,-67.0,-60.0,-90.0,-94.0,-90.0,-93.0,19.0,23.0,22.0,33.0,0
5336,BA:8C:B9:54:50:24,3829405,488536116,4722,6150415,3824683,482385701,0,8313,1646868,8291,1643373,22,3495,2321,14,5099,36,0,53,216660.0,130000.0,-40.0,-36.0,-45.0,-51.0,-41.0,-35.0,-43.0,-49.0,-90.0,-94.0,-90.0,-93.0,50.0,58.0,45.0,42.0,0
5337,92:69:1D:31:68:E9,3828425,485964870,3740,3578967,3824685,482385903,0,4131,1037952,4016,1012162,115,25790,1998,6,3869,79,0,35,229410.0,137640.0,-52.0,-50.0,-45.0,-46.0,-52.0,-50.0,-44.0,-48.0,-90.0,-94.0,-90.0,-93.0,38.0,44.0,45.0,47.0,0
5338,CC:2F:71:3F:1F:24,4457677,1181756024,632992,699370121,3824685,482385903,37,519969,563520686,519341,563445106,628,75580,502288,10,633229,60436,34,450,130000.0,39000.0,-67.0,-65.0,-70.0,-67.0,-67.0,-65.0,-70.0,-67.0,-90.0,-94.0,-90.0,-93.0,23.0,29.0,20.0,26.0,0
5339,CC:2F:71:3E:C5:1F,3825442,482478408,757,92505,3824685,482385903,0,3178,266741,2622,200689,556,66052,801,8,1091,18,0,35,144444.0,39000.0,-71.0,-71.0,-68.0,-60.0,-70.0,-71.0,-67.0,-60.0,-90.0,-94.0,-90.0,-93.0,19.0,23.0,22.0,33.0,0
5340,BA:8C:B9:54:50:24,3829410,488536580,4722,6150415,3824688,482386165,0,8313,1646868,8291,1643373,22,3495,2321,14,5099,36,0,53,216660.0,130000.0,-40.0,-36.0,-45.0,-51.0,-41.0,-35.0,-43.0,-49.0,-90.0,-94.0,-90.0,-93.0,50.0,58.0,45.0,42.0,0
5341,92:69:1D:31:68:E9,3828432,485965536,3740,3578967,3824692,482386569,0,4131,1037952,4016,1012162,115,25790,1998,6,3869,79,0,35,229410.0,137640.0,-52.0,-50.0,-45.0,-46.0,-52.0,-50.0,-44.0,-48.0,-90.0,-94.0,-90.0,-93.0,38.0,44.0,45.0,47.0,0
5342,CC:2F:71:3F:1F:24,4457726,1181771252,633034,699384683,3824692,482386569,37,519999,563526130,519371,563450550,628,75580,502318,10,633271,60458,34,450,130000.0,39000.0,-67.0,-65.0,-71.0,-67.0,-67.0,-65.0,-70.0,-67.0,-90.0,-94.0,-90.0,-93.0,23.0,29.0,19.0,26.0,0
5343,CC:2F:71:3E:C5:1F,3825449,482479074,757,92505,3824692,482386569,0,3178,266741,2622,200689,556,66052,801,8,1091,18,0,35,144444.0,39000.0,-71.0,-71.0,-68.0,-60.0,-70.0,-71.0,-67.0,-60.0,-90.0,-94.0,-90.0,-93.0,19.0,23.0,22.0,33.0,0
5344,BA:8C:B9:54:50:24,3829414,488536984,4722,6150415,3824692,482386569,0,8313,1646868,8291,1643373,22,3495,2321,14,5099,36,0,53,216660.0,130000.0,-40.0,-36.0,-45.0,-51.0,-41.0,-35.0,-43.0,-49.0,-90.0,-94.0,-90.0,-93.0,50.0,58.0,45.0,42.0,0
5345,92:69:1D:31:68:E9,3828434,485965738,3740,3578967,3824694,482386771,0,4131,1037952,4016,1012162,115,25790,1998,6,3869,79,0,35,229410.0,137640.0,-52.0,-50.0,-45.0,-46.0,-52.0,-50.0,-44.0,-48.0,-90.0,-94.0,-90.0,-93.0,38.0,44.0,45.0,47.0,0
5346,CC:2F:71:3F:1F:24,4457771,1181785950,633077,699399179,3824694,482386771,37,520025,563531074,519397,563455494,628,75580,502344,10,633314,60467,34,450,117000.0,39000.0,-67.0,-65.0,-70.0,-68.0,-67.0,-65.0,-70.0,-67.0,-90.0,-94.0,-90.0,-93.0,23.0,29.0,20.0,25.0,0
5347,CC:2F:71:3E:C5:1F,3825451,482479276,757,92505,3824694,482386771,0,3178,266741,2622,200689,556,66052,801,8,1091,18,0,35,144444.0,39000.0,-71.0,-71.0,-68.0,-60.0,-70.0,-71.0,-67.0,-60.0,-90.0,-94.0,-90.0,-93.0,19.0,23.0,22.0,33.0,0
5348,BA:8C:B9:54:50:24,3829418,488537388,4722,6150415,3824696,482386973,0,8313,1646868,8291,1643373,22,3495,2321,14,5099,36,0,53,216660.0,130000.0,-40.0,-36.0,-45.0,-51.0,-41.0,-35.0,-43.0,-49.0,-90.0,-94.0,-90.0,-93.0,50.0,58.0,45.0,42.0,0
5349,92:69:1D:31:68:E9,3828441,485966404,3740,3578967,3824701,482387437,0,4132,1038020,4017,1012230,115,25790,1998,6,3869,79,0,35,229410.0,137640.0,-52.0,-50.0,-44.0,-46.0,-52.0,-50.0,-44.0,-47.0,-90.0,-94.0,-90.0,-93.0,38.0,44.0,46.0,47.0,0
5350,CC:2F:71:3F:1F:24,4457820,1181800932,633119,699413495,3824701,482387437,37,520051,563536018,519423,563460438,628,75580,502370,10,633356,60484,34,450,117000.0,39000.0,-67.0,-65.0,-70.0,-67.0,-67.0,-65.0,-70.0,-67.0,-90.0,-93.0,-90.0,-93.0,23.0,28.0,20.0,26.0,0
5351,CC:2F:71:3E:C5:1F,3825458,482479942,757,92505,3824701,482387437,0,3178,266741,2622,200689,556,66052,801,8,1091,18,0,35,144444.0,39000.0,-71.0,-71.0,-68.0,-60.0,-70.0,-71.0,-67.0,-60.0,-90.0,-93.0,-90.0,-93.0,19.0,22.0,22.0,33.0,0
5352,BA:8C:B9:54:50:24,3829423,488537852,4722,6150415,3824701,482387437,0,8313,1646868,8291,1643373,22,3495,2321,14,5099,36,0,53,216660.0,130000.0,-40.0,-36.0,-45.0,-51.0,-41.0,-35.0,-43.0,-49.0,-90.0,-93.0,-90.0,-93.0,50.0,57.0,45.0,42.0,0
5353,92:69:1D:31:68:E9,3828443,485966606,3740,3578967,3824703,482387639,0,4132,1038020,4017,1012230,115,25790,1998,6,3869,79,0,35,229410.0,137640.0,-52.0,-50.0,-44.0,-46.0,-52.0,-50.0,-44.0,-47.0,-90.0,-93.0,-90.0,-93.0,38.0,43.0,46.0,47.0,0
5354,CC:2F:71:3F:1F:24,4457865,1181815686,633162,699428047,3824703,482387639,37,520077,563540962,519449,563465382,628,75580,502396,10,633399,60487,34,450,130000.0,43333.0,-67.0,-65.0,-70.0,-67.0,-67.0,-65.0,-70.0,-67.0,-90.0,-93.0,-90.0,-93.0,23.0,28.0,20.0,26.0,0
5355,CC:2F:71:3E:C5:1F,3825460,482480144,757,92505,3824703,482387639,0,3178,266741,2622,200689,556,66052,801,8,1091,18,0,35,144444.0,39000.0,-71.0,-71.0,-68.0,-60.0,-70.0,-71.0,-67.0,-60.0,-90.0,-93.0,-90.0,-93.0,19.0,22.0,22.0,33.0,0
5356,BA:8C:B9:54:50:24,3829426,488538188,4722,6150415,3824704,482387773,0,8313,1646868,8291,1643373,22,3495,2321,14,5099,36,0,53,216660.0,130000.0,-40.0,-36.0,-45.0,-51.0,-41.0,-35.0,-43.0,-49.0,-90.0,-93.0,-90.0,-93.0,50.0,57.0,45.0,42.0,0
5357,92:69:1D:31:68:E9,3828449,485967212,3740,3578967,3824709,482388245,0,4132,1038020,4017,1012230,115,25790,1998,6,3869,79,0,35,229410.0,137640.0,-52.0,-50.0,-44.0,-46.0,-52.0,-50.0,-44.0,-47.0,-90.0,-93.0,-90.0,-93.0,38.0,43.0,46.0,47.0,0
5358,CC:2F:71:3F:1F:24,4457913,1181830832,633204,699442587,3824709,482388245,37,520103,563545882,519475,563470302,628,75580,502422,10,633441,60492,34,450,130000.0,43333.0,-67.0,-65.0,-71.0,-67.0,-67.0,-65.0,-70.0,-67.0,-90.0,-93.0,-90.0,-93.0,23.0,28.0,19.0,26.0,0
5359,CC:2F:71:3E:C5:1F,3825466,482480750,757,92505,3824709,482388245,0,3178,266741,2622,200689,556,66052,801,8,1091,18,0,35,144444.0,39000.0,-71.0,-71.0,-68.0,-60.0,-70.0,-71.0,-67.0,-60.0,-90.0,-93.0,-90.0,-93.0,19.0,22.0,22.0,33.0,0
5360,BA:8C:B9:54:50:24,3829431,488538660,4722,6150415,3824709,482388245,0,8313,1646868,8291,1643373,22,3495,2321,14,5099,36,0,53,216660.0,130000.0,-40.0,-36.0,-45.0,-51.0,-41.0,-35.0,-43.0,-49.0,-90.0,-93.0,-90.0,-93.0,50.0,57.0,45.0,42.0,0
5361,92:69:1D:31:68:E9,3828452,485967474,3740,3578967,3824712,482388507,0,4132,1038020,4017,1012230,115,25790,1998,6,3869,79,0,35,229410.0,137640.0,-52.0,-50.0,-44.0,-46.0,-52.0,-50.0,-44.0,-47.0,-90.0,-93.0,-90.0,-93.0,38.0,43.0,46.0,47.0,0
5362,CC:2F:71:3F:1F:24,4457968,1181851801,633256,699463294,3824712,482388507,37,520144,563560757,519516,563485177,628,75580,502463,10,633493,60516,34,450,117000.0,39000.0,-67.0,-65.0,-71.0,-67.0,-67.0,-65.0,-70.0,-67.0,-90.0,-93.0,-90.0,-93.0,23.0,28.0,19.0,26.0,0
5363,CC:2F:71:3E:C5:1F,3825469,482481012,757,92505,3824712,482388507,0,3178,266741,2622,200689,556,66052,801,8,1091,18,0,35,144444.0,39000.0,-71.0,-71.0,-68.0,-60.0,-70.0,-71.0,-67.0,-60.0,-90.0,-93.0,-90.0,-93.0,19.0,22.0,22.0,33.0,0
5364,BA:8C:B9:54:50:24,3829434,488538922,4722,6150415,3824712,482388507,0,8313,1646868,8291,1643373,22,3495,2321,14,5099,36,0,53,216660.0,130000.0,-40.0,-36.0,-45.0,-51.0,-41.0,-35.0,-43.0,-49.0,-90.0,-93.0,-90.0,-93.0,50.0,57.0,45.0,42.0,0
5365,92:69:1D:31:68:E9,3828459,485968196,3741,3579083,3824718,482389113,0,4134,1038156,4019,1012366,115,25790,1998,6,3870,79,0,35,216660.0,130000.0,-51.0,-47.0,-42.0,-49.0,-51.0,-49.0,-43.0,-47.0,-90.0,-93.0,-90.0,-93.0,39.0,46.0,48.0,44.0,0
5366,CC:2F:71:3F:1F:24,4458044,1181905020,633326,699515907,3824718,482389113,37,520180,563566933,519552,563491353,628,75580,502499,10,633563,60528,34,450,130000.0,43333.0,-68.0,-65.0,-71.0,-68.0,-67.0,-65.0,-70.0,-67.0,-90.0,-93.0,-90.0,-93.0,22.0,28.0,19.0,25.0,0
5367,CC:2F:71:3E:C5:1F,3825476,482481734,758,92621,3824718,482389113,0,3180,266881,2624,200829,556,66052,801,8,1092,18,0,35,144444.0,39000.0,-70.0,-71.0,-67.0,-60.0,-70.0,-71.0,-67.0,-60.0,-90.0,-93.0,-90.0,-93.0,20.0,22.0,23.0,33.0,0
5368,BA:8C:B9:54:50:24,3829441,488539644,4723,6150531,3824718,482389113,0,8318,1647208,8296,1643713,22,3495,2321,14,5100,36,0,53,216660.0,130000.0,-49.0,-35.0,-42.0,-44.0,-41.0,-35.0,-42.0,-48.0,-90.0,-93.0,-90.0,-93.0,41.0,58.0,48.0,49.0,0
5369,92:69:1D:31:68:E9,3828462,485968671,3741,3579083,3824721,482389588,0,4134,1038156,4019,1012366,115,25790,1998,6,3870,79,0,35,216660.0,130000.0,-51.0,-47.0,-42.0,-49.0,-51.0,-49.0,-43.0,-47.0,-90.0,-93.0,-90.0,-93.0,39.0,46.0,48.0,44.0,0
5370,CC:2F:71:3F:1F:24,4458088,1181919855,633367,699530267,3824721,482389588,37,520207,563571993,519579,563496413,628,75580,502526,10,633604,60544,34,450,117000.0,39000.0,-67.0,-65.0,-70.0,-68.0,-67.0,-65.0,-70.0,-67.0,-90.0,-93.0,-90.0,-93.0,23.0,28.0,20.0,25.0,0
5371,CC:2F:71:3E:C5:1F,3825480,482482269,758,92621,3824722,482389648,0,3180,266881,2624,200829,556,66052,801,8,1092,18,0,35,144444.0,39000.0,-70.0,-71.0,-67.0,-60.0,-70.0,-71.0,-67.0,-60.0,-90.0,-93.0,-90.0,-93.0,20.0,22.0,23.0,33.0,0
5372,BA:8C:B9:54:50:24,3829446,488540313,4723,6150531,3824723,482389782,0,8318,1647208,8296,1643713,22,3495,2321,14,5100,36,0,53,216660.0,130000.0,-49.0,-35.0,-42.0,-44.0,-41.0,-35.0,-42.0,-48.0,-90.0,-93.0,-90.0,-93.0,41.0,58.0,48.0,49.0,0
5373,92:69:1D:31:68:E9,3828470,485969399,3741,3579083,3824729,482390316,0,4134,1038156,4019,1012366,115,25790,1998,6,3870,79,0,35,216660.0,130000.0,-51.0,-47.0,-42.0,-49.0,-51.0,-49.0,-43.0,-47.0,-90.0,-93.0,-90.0,-93.0,39.0,46.0,48.0,44.0,0
5374,CC:2F:71:3F:1F:24,4458137,1181934831,633408,699544515,3824729,482390316,37,520235,563577195,519606,563501497,629,75698,502554,10,633645,60549,34,450,130000.0,43333.0,-67.0,-66.0,-71.0,-68.0,-67.0,-65.0,-70.0,-67.0,-90.0,-93.0,-90.0,-93.0,23.0,27.0,19.0,25.0,0
5375,CC:2F:71:3E:C5:1F,3825487,482482937,758,92621,3824729,482390316,0,3180,266881,2624,200829,556,66052,801,8,1092,18,0,35,144444.0,39000.0,-70.0,-71.0,-67.0,-60.0,-70.0,-71.0,-67.0,-60.0,-90.0,-93.0,-90.0,-93.0,20.0,22.0,23.0,33.0,0
5376,BA:8C:B9:54:50:24,3829452,488540847,4723,6150531,3824729,482390316,0,8318,1647208,8296,1643713,22,3495,2321,14,5100,36,0,53,216660.0,130000.0,-49.0,-35.0,-42.0,-44.0,-41.0,-35.0,-42.0,-48.0,-90.0,-93.0,-90.0,-93.0,41.0,58.0,48.0,49.0,0
5377,92:69:1D:31:68:E9,3828472,485969601,3741,3579083,3824731,482390518,0,4134,1038156,4019,1012366,115,25790,1998,6,3870,79,0,35,216660.0,130000.0,-51.0,-47.0,-42.0,-49.0,-51.0,-49.0,-43.0,-47.0,-90.0,-93.0,-90.0,-93.0,39.0,46.0,48.0,44.0,0
5378,CC:2F:71:3F:1F:24,4458180,1181949455,633449,699558937,3824731,482390518,37,520260,563581999,519631,563506301,629,75698,502579,10,633686,60555,34,450,130000.0,43333.0,-67.0,-65.0,-70.0,-68.0,-67.0,-65.0,-70.0,-68.0,-90.0,-93.0,-90.0,-93.0,23.0,28.0,20.0,25.0,0
5379,CC:2F:71:3E:C5:1F,3825489,482483139,758,92621,3824731,482390518,0,3180,266881,2624,200829,556,66052,801,8,1092,18,0,35,144444.0,39000.0,-70.0,-71.0,-67.0,-60.0,-70.0,-71.0,-67.0,-60.0,-90.0,-93.0,-90.0,-93.0,20.0,22.0,23.0,33.0,0
5380,BA:8C:B9:54:50:24,3829454,488541049,4723,6150531,3824731,482390518,0,8318,1647208,8296,1643713,22,3495,2321,14,5100,36,0,53,216660.0,130000.0,-49.0,-35.0,-42.0,-44.0,-41.0,-35.0,-42.0,-48.0,-90.0,-93.0,-90.0,-93.0,41.0,58.0,48.0,49.0,0
5381,92:69:1D:31:68:E9,3828479,485970433,3741,3579083,3824738,482391350,0,4134,1038156,4019,1012366,115,25790,1998,6,3870,79,0,35,216660.0,130000.0,-51.0,-47.0,-42.0,-49.0,-51.0,-49.0,-43.0,-47.0,-90.0,-93.0,-90.0,-93.0,39.0,46.0,48.0,44.0,0
5382,CC:2F:71:3F:1F:24,4458228,1181964591,633490,699573241,3824738,482391350,37,520285,563586803,519656,563511105,629,75698,502604,10,633727,60584,34,450,144444.0,39000.0,-67.0,-65.0,-71.0,-68.0,-67.0,-65.0,-70.0,-68.0,-90.0,-93.0,-90.0,-93.0,23.0,28.0,19.0,25.0,0
5383,CC:2F:71:3E:C5:1F,3825498,482484173,758,92621,3824740,482391552,0,3180,266881,2624,200829,556,66052,801,8,1092,18,0,35,144444.0,39000.0,-70.0,-71.0,-67.0,-60.0,-70.0,-71.0,-67.0,-60.0,-90.0,-93.0,-90.0,-93.0,20.0,22.0,23.0,33.0,0
5384,BA:8C:B9:54:50:24,3829463,488542083,4723,6150531,3824740,482391552,0,8318,1647208,8296,1643713,22,3495,2321,14,5100,36,0,53,216660.0,130000.0,-49.0,-35.0,-42.0,-44.0,-41.0,-35.0,-42.0,-48.0,-90.0,-93.0,-90.0,-93.0,41.0,58.0,48.0,49.0,0
5385,92:69:1D:31:68:E9,3828483,485970837,3741,3579083,3824742,482391754,0,4134,1038156,4019,1012366,115,25790,1998,6,3870,79,0,35,216660.0,130000.0,-51.0,-47.0,-42.0,-49.0,-51.0,-49.0,-43.0,-47.0,-90.0,-93.0,-90.0,-93.0,39.0,46.0,48.0,44.0,0
5386,CC:2F:71:3F:1F:24,4458273,1181979299,633531,699587545,3824742,482391754,37,520313,563592003,519684,563516305,629,75698,502632,10,633768,60600,34,450,130000.0,43333.0,-67.0,-66.0,-71.0,-68.0,-67.0,-65.0,-71.0,-68.0,-90.0,-93.0,-90.0,-93.0,23.0,27.0,19.0,25.0,0
5387,CC:2F:71:3E:C5:1F,3825500,482484375,758,92621,3824742,482391754,0,3182,267021,2626,200969,556,66052,801,8,1093,18,0,35,144444.0,39000.0,-71.0,-71.0,-68.0,-60.0,-70.0,-71.0,-67.0,-60.0,-90.0,-93.0,-90.0,-93.0,19.0,22.0,22.0,33.0,0
5388,BA:8C:B9:54:50:24,3829465,488542285,4723,6150531,3824742,482391754,0,8320,1647344,8298,1643849,22,3495,2321,14,5101,36,0,53,216660.0,130000.0,-39.0,-38.0,-39.0,-46.0,-42.0,-35.0,-42.0,-46.0,-90.0,-93.0,-90.0,-93.0,51.0,55.0,51.0,47.0,0
5389,92:69:1D:31:68:E9,3828487,485971241,3741,3579083,3824746,482392158,0,4136,1038292,4021,1012502,115,25790,1998,6,3871,79,0,36,216660.0,130000.0,-52.0,-50.0,-44.0,-46.0,-51.0,-49.0,-43.0,-47.0,-90.0,-93.0,-90.0,-93.0,38.0,43.0,46.0,47.0,0
5390,CC:2F:71:3F:1F:24,4458323,1181994763,633577,699602605,3824746,482392158,37,520340,563597063,519711,563521365,629,75698,502659,10,633814,60603,34,450,130000.0,43333.0,-68.0,-65.0,-71.0,-67.0,-67.0,-65.0,-70.0,-67.0,-90.0,-93.0,-90.0,-93.0,22.0,28.0,19.0,26.0,0
5391,CC:2F:71:3E:C5:1F,3825506,482484981,758,92621,3824748,482392360,0,3182,267021,2626,200969,556,66052,801,8,1093,18,0,35,144444.0,39000.0,-71.0,-71.0,-68.0,-60.0,-70.0,-71.0,-67.0,-60.0,-90.0,-93.0,-90.0,-93.0,19.0,22.0,22.0,33.0,0
5392,BA:8C:B9:54:50:24,3829471,488542891,4723,6150531,3824748,482392360,0,8320,1647344,8298,1643849,22,3495,2321,14,5101,36,0,53,216660.0,130000.0,-39.0,-38.0,-39.0,-46.0,-42.0,-35.0,-42.0,-46.0,-90.0,-93.0,-90.0,-93.0,51.0,55.0,51.0,47.0,0
5393,92:69:1D:31:68:E9,3828492,485971705,3741,3579083,3824751,482392622,0,4136,1038292,4021,1012502,115,25790,1998,6,3871,79,0,36,216660.0,130000.0,-52.0,-50.0,-44.0,-46.0,-51.0,-49.0,-43.0,-47.0,-90.0,-93.0,-90.0,-93.0,38.0,43.0,46.0,47.0,0
5394,CC:2F:71:3F:1F:24,4458369,1182009531,633618,699616909,3824751,482392622,37,520366,563602007,519737,563526309,629,75698,502685,10,633855,60619,34,450,117000.0,39000.0,-67.0,-65.0,-71.0,-68.0,-67.0,-65.0,-70.0,-67.0,-90.0,-93.0,-90.0,-93.0,23.0,28.0,19.0,25.0,0
5395,CC:2F:71:3E:C5:1F,3825509,482485243,758,92621,3824751,482392622,0,3182,267021,2626,200969,556,66052,801,8,1093,18,0,35,144444.0,39000.0,-71.0,-71.0,-68.0,-60.0,-70.0,-71.0,-67.0,-60.0,-90.0,-93.0,-90.0,-93.0,19.0,22.0,22.0,33.0,0
5396,BA:8C:B9:54:50:24,3829474,488543153,4723,6150531,3824751,482392622,0,8320,1647344,8298,1643849,22,3495,2321,14,5101,36,0,53,216660.0,130000.0,-39.0,-38.0,-39.0,-46.0,-42.0,-35.0,-42.0,-46.0,-90.0,-93.0,-90.0,-93.0,51.0,55.0,51.0,47.0,0
5397,92:69:1D:31:68:E9,3828496,485972109,3741,3579083,3824755,482393026,0,4136,1038292,4021,1012502,115,25790,1998,6,3871,79,0,36,216660.0,130000.0,-52.0,-50.0,-44.0,-46.0,-51.0,-49.0,-43.0,-47.0,-90.0,-93.0,-90.0,-93.0,38.0,43.0,46.0,47.0,0
5398,CC:2F:71:3F:1F:24,4458415,1182024307,633660,699631281,3824755,482393026,37,520391,563606811,519762,563531113,629,75698,502710,10,633897,60622,34,450,130000.0,39000.0,-68.0,-66.0,-71.0,-68.0,-67.0,-65.0,-70.0,-68.0,-90.0,-93.0,-90.0,-93.0,22.0,27.0,19.0,25.0,0
5399,CC:2F:71:3E:C5:1F,3825515,482485849,758,92621,3824757,482393228,0,3182,267021,2626,200969,556,66052,801,8,1093,18,0,35,144444.0,39000.0,-71.0,-71.0,-68.0,-60.0,-70.0,-71.0,-67.0,-60.0,-90.0,-93.0,-90.0,-93.0,19.0,22.0,22.0,33.0,0
5400,BA:8C:B9:54:50:24,3829480,488543759,4723,6150531,3824757,482393228,0,8320,1647344,8298,1643849,22,3495,2321,14,5101,36,0,53,216660.0,130000.0,-39.0,-38.0,-39.0,-46.0,-42.0,-35.0,-42.0,-46.0,-90.0,-93.0,-90.0,-93.0,51.0,55.0,51.0,47.0,0
5401,92:69:1D:31:68:E9,3828501,485972573,3741,3579083,3824760,482393490,0,4136,1038292,4021,1012502,115,25790,1998,6,3871,79,0,36,216660.0,130000.0,-52.0,-50.0,-44.0,-46.0,-51.0,-49.0,-43.0,-47.0,-90.0,-93.0,-90.0,-93.0,38.0,43.0,46.0,47.0,0
5402,CC:2F:71:3F:1F:24,4458462,1182039255,633702,699645765,3824760,482393490,37,520416,563611615,519787,563535917,629,75698,502735,10,633939,60649,34,450,130000.0,39000.0,-67.0,-66.0,-71.0,-68.0,-67.0,-65.0,-70.0,-68.0,-90.0,-93.0,-90.0,-93.0,23.0,27.0,19.0,25.0,0
5403,CC:2F:71:3E:C5:1F,3825518,482486111,758,92621,3824760,482393490,0,3182,267021,2626,200969,556,66052,801,8,1093,18,0,35,144444.0,39000.0,-71.0,-71.0,-68.0,-60.0,-70.0,-71.0,-67.0,-60.0,-90.0,-93.0,-90.0,-93.0,19.0,22.0,22.0,33.0,0
5404,BA:8C:B9:54:50:24,3829483,488544021,4723,6150531,3824760,482393490,0,8320,1647344,8298,1643849,22,3495,2321,14,5101,36,0,53,216660.0,130000.0,-39.0,-38.0,-39.0,-46.0,-42.0,-35.0,-42.0,-46.0,-90.0,-93.0,-90.0,-93.0,51.0,55.0,51.0,47.0,0
5405,92:69:1D:31:68:E9,3828506,485973039,3741,3579083,3824765,482393956,0,4136,1038292,4021,1012502,115,25790,1998,6,3871,79,0,36,216660.0,130000.0,-52.0,-50.0,-44.0,-46.0,-51.0,-49.0,-43.0,-47.0,-90.0,-93.0,-90.0,-93.0,38.0,43.0,46.0,47.0,0
5406,CC:2F:71:3F:1F:24,4458510,1182054273,633745,699660317,3824765,482393956,37,520444,563616791,519815,563541093,629,75698,502763,10,633982,60651,34,450,130000.0,43333.0,-67.0,-65.0,-71.0,-68.0,-67.0,-65.0,-70.0,-68.0,-90.0,-93.0,-90.0,-93.0,23.0,28.0,19.0,25.0,0
5407,CC:2F:71:3E:C5:1F,3825523,482486577,758,92621,3824765,482393956,0,3184,267209,2627,201039,557,66170,802,8,1093,18,0,36,144444.0,39000.0,-71.0,-71.0,-68.0,-60.0,-70.0,-71.0,-67.0,-60.0,-90.0,-93.0,-90.0,-93.0,19.0,22.0,22.0,33.0,0
5408,BA:8C:B9:54:50:24,3829490,488544689,4723,6150531,3824767,482394158,0,8320,1647344,8298,1643849,22,3495,2321,14,5101,36,0,53,216660.0,130000.0,-39.0,-38.0,-39.0,-46.0,-42.0,-35.0,-42.0,-46.0,-90.0,-93.0,-90.0,-93.0,51.0,55.0,51.0,47.0,0
5409,92:69:1D:31:68:E9,3828510,485973443,3741,3579083,3824769,482394360,0,4136,1038292,4021,1012502,115,25790,1998,6,3871,79,0,36,216660.0,130000.0,-52.0,-50.0,-44.0,-46.0,-51.0,-49.0,-43.0,-47.0,-90.0,-93.0,-90.0,-93.0,38.0,43.0,46.0,47.0,0
5410,CC:2F:71:3F:1F:24,4458557,1182069229,633788,699674869,3824769,482394360,37,520471,563621851,519842,563546153,629,75698,502790,10,634025,60666,34,450,117000.0,39000.0,-67.0,-65.0,-70.0,-67.0,-67.0,-65.0,-70.0,-67.0,-90.0,-93.0,-90.0,-93.0,23.0,28.0,20.0,26.0,0
5411,CC:2F:71:3E:C5:1F,3825527,482486981,758,92621,3824769,482394360,0,3184,267209,2627,201039,557,66170,802,8,1093,18,0,36,144444.0,39000.0,-71.0,-71.0,-68.0,-60.0,-70.0,-71.0,-67.0,-60.0,-90.0,-93.0,-90.0,-93.0,19.0,22.0,22.0,33.0,0
5412,BA:8C:B9:54:50:24,3829492,488544891,4723,6150531,3824769,482394360,0,8320,1647344,8298,1643849,22,3495,2321,14,5101,36,0,53,216660.0,130000.0,-39.0,-38.0,-39.0,-46.0,-42.0,-35.0,-42.0,-46.0,-90.0,-93.0,-90.0,-93.0,51.0,55.0,51.0,47.0,0
5413,92:69:1D:31:68:E9,3828515,485973907,3741,3579083,3824774,482394824,0,4136,1038292,4021,1012502,115,25790,1998,6,3871,79,0,36,216660.0,130000.0,-52.0,-50.0,-44.0,-46.0,-51.0,-49.0,-43.0,-47.0,-90.0,-93.0,-90.0,-93.0,38.0,43.0,46.0,47.0,0
5414,CC:2F:71:3F:1F:24,4458604,1182084249,633830,699689425,3824774,482394824,37,520498,563626899,519869,563551201,629,75698,502817,10,634067,60675,34,450,130000.0,43333.0,-67.0,-65.0,-70.0,-68.0,-67.0,-65.0,-70.0,-67.0,-90.0,-93.0,-90.0,-93.0,23.0,28.0,20.0,25.0,0
5415,CC:2F:71:3E:C5:1F,3825534,482487647,758,92621,3824776,482395026,0,3184,267209,2627,201039,557,66170,802,8,1093,18,0,36,144444.0,39000.0,-71.0,-71.0,-68.0,-60.0,-70.0,-71.0,-67.0,-60.0,-90.0,-93.0,-90.0,-93.0,19.0,22.0,22.0,33.0,0
5416,BA:8C:B9:54:50:24,3829499,488545557,4723,6150531,3824776,482395026,0,8323,1647548,8301,1644053,22,3495,2321,14,5101,36,0,53,216660.0,130000.0,-39.0,-36.0,-45.0,-52.0,-42.0,-35.0,-42.0,-47.0,-90.0,-93.0,-90.0,-93.0,51.0,57.0,45.0,41.0,0
5417,92:69:1D:31:68:E9,3828519,485974311,3741,3579083,3824778,482395228,0,4136,1038292,4021,1012502,115,25790,1998,6,3871,79,0,36,216660.0,130000.0,-52.0,-50.0,-44.0,-46.0,-51.0,-49.0,-43.0,-47.0,-90.0,-93.0,-90.0,-93.0,38.0,43.0,46.0,47.0,0
5418,CC:2F:71:3F:1F:24,4458650,1182099081,633872,699703853,3824778,482395228,37,520523,563631703,519894,563556005,629,75698,502842,10,634109,60700,34,450,117000.0,39000.0,-67.0,-65.0,-70.0,-67.0,-67.0,-65.0,-70.0,-67.0,-90.0,-93.0,-90.0,-93.0,23.0,28.0,20.0,26.0,0
5419,CC:2F:71:3E:C5:1F,3825536,482487849,758,92621,3824778,482395228,0,3184,267209,2627,201039,557,66170,802,8,1093,18,0,36,144444.0,39000.0,-71.0,-71.0,-68.0,-60.0,-70.0,-71.0,-67.0,-60.0,-90.0,-93.0,-90.0,-93.0,19.0,22.0,22.0,33.0,0
5420,BA:8C:B9:54:50:24,3829501,488545759,4723,6150531,3824778,482395228,0,8324,1647616,8302,1644121,22,3495,2321,14,5101,36,0,53,216660.0,130000.0,-51.0,-35.0,-44.0,-44.0,-43.0,-35.0,-42.0,-47.0,-90.0,-93.0,-90.0,-93.0,39.0,58.0,46.0,49.0,0
5421,92:69:1D:31:68:E9,3828524,485974988,3741,3579083,3824783,482395905,0,4136,1038292,4021,1012502,115,25790,1998,6,3871,79,0,36,216660.0,130000.0,-52.0,-50.0,-44.0,-46.0,-51.0,-49.0,-43.0,-47.0,-90.0,-93.0,-90.0,-93.0,38.0,43.0,46.0,47.0,0
5422,CC:2F:71:3F:1F:24,4458695,1182113932,633912,699718027,3824783,482395905,37,520549,563636647,519920,563560949,629,75698,502868,10,634149,60707,34,450,130000.0,43333.0,-67.0,-65.0,-71.0,-67.0,-67.0,-65.0,-70.0,-67.0,-90.0,-93.0,-90.0,-93.0,23.0,28.0,19.0,26.0,0
5423,CC:2F:71:3E:C5:1F,3825541,482488526,758,92621,3824783,482395905,0,3184,267209,2627,201039,557,66170,802,8,1093,18,0,36,144444.0,39000.0,-71.0,-71.0,-68.0,-60.0,-70.0,-71.0,-67.0,-60.0,-90.0,-93.0,-90.0,-93.0,19.0,22.0,22.0,33.0,0
5424,BA:8C:B9:54:50:24,3829508,488546638,4723,6150531,3824785,482396107,0,8324,1647616,8302,1644121,22,3495,2321,14,5101,36,0,53,216660.0,130000.0,-51.0,-35.0,-44.0,-44.0,-43.0,-35.0,-42.0,-47.0,-90.0,-93.0,-90.0,-93.0,39.0,58.0,46.0,49.0,0
5425,92:69:1D:31:68:E9,3828529,485975452,3741,3579083,3824788,482396369,0,4136,1038292,4021,1012502,115,25790,1998,6,3871,79,0,36,216660.0,130000.0,-52.0,-50.0,-44.0,-46.0,-51.0,-49.0,-43.0,-47.0,-90.0,-93.0,-90.0,-93.0,38.0,43.0,46.0,47.0,0
5426,CC:2F:71:3F:1F:24,4458742,1182128936,633954,699732567,3824788,482396369,37,520575,563641591,519946,563565893,629,75698,502894,10,634191,60713,34,450,130000.0,43333.0,-67.0,-65.0,-70.0,-68.0,-67.0,-65.0,-70.0,-67.0,-90.0,-93.0,-90.0,-93.0,23.0,28.0,20.0,25.0,0
5427,CC:2F:71:3E:C5:1F,3825546,482488990,758,92621,3824788,482396369,0,3184,267209,2627,201039,557,66170,802,8,1093,18,0,36,144444.0,39000.0,-71.0,-71.0,-68.0,-60.0,-70.0,-71.0,-67.0,-60.0,-90.0,-93.0,-90.0,-93.0,19.0,22.0,22.0,33.0,0
5428,BA:8C:B9:54:50:24,3829511,488546900,4723,6150531,3824788,482396369,0,8325,1647684,8303,1644189,22,3495,2321,14,5101,36,0,53,216660.0,130000.0,-39.0,-36.0,-45.0,-51.0,-43.0,-35.0,-43.0,-48.0,-90.0,-93.0,-90.0,-93.0,51.0,57.0,45.0,42.0,0
5429,92:69:1D:31:68:E9,3828533,485975856,3741,3579083,3824792,482396773,0,4136,1038292,4021,1012502,115,25790,1998,6,3871,79,0,36,216660.0,130000.0,-52.0,-50.0,-44.0,-46.0,-51.0,-49.0,-43.0,-47.0,-90.0,-93.0,-90.0,-93.0,38.0,43.0,46.0,47.0,0
5430,CC:2F:71:3F:1F:24,4458789,1182143948,633997,699747175,3824792,482396773,37,520600,563646395,519971,563570697,629,75698,502919,10,634234,60729,34,450,130000.0,39000.0,-67.0,-65.0,-70.0,-67.0,-67.0,-65.0,-70.0,-67.0,-90.0,-93.0,-90.0,-93.0,23.0,28.0,20.0,26.0,0
5431,CC:2F:71:3E:C5:1F,3825550,482489394,758,92621,3824792,482396773,0,3184,267209,2627,201039,557,66170,802,8,1093,18,0,36,144444.0,39000.0,-71.0,-71.0,-68.0,-60.0,-70.0,-71.0,-67.0,-60.0,-90.0,-93.0,-90.0,-93.0,19.0,22.0,22.0,33.0,0
5432,BA:8C:B9:54:50:24,3829517,488547506,4723,6150531,3824794,482396975,0,8325,1647684,8303,1644189,22,3495,2321,14,5101,36,0,53,216660.0,130000.0,-39.0,-36.0,-45.0,-51.0,-43.0,-35.0,-43.0,-48.0,-90.0,-93.0,-90.0,-93.0,51.0,57.0,45.0,42.0,0
5433,92:69:1D:31:68:E9,3828538,485976320,3741,3579083,3824797,482397237,0,4136,1038292,4021,1012502,115,25790,1998,6,3871,79,0,36,216660.0,130000.0,-52.0,-50.0,-44.0,-46.0,-51.0,-49.0,-43.0,-47.0,-90.0,-93.0,-90.0,-93.0,38.0,43.0,46.0,47.0,0
5434,CC:2F:71:3F:1F:24,4458836,1182158840,634039,699761603,3824797,482397237,37,520625,563651199,519996,563575501,629,75698,502944,10,634276,60740,34,450,130000.0,39000.0,-67.0,-65.0,-70.0,-68.0,-67.0,-65.0,-70.0,-67.0,-90.0,-93.0,-90.0,-93.0,23.0,28.0,20.0,25.0,0
5435,CC:2F:71:3E:C5:1F,3825555,482489858,758,92621,3824797,482397237,0,3184,267209,2627,201039,557,66170,802,8,1093,18,0,36,144444.0,39000.0,-71.0,-71.0,-68.0,-60.0,-70.0,-71.0,-67.0,-60.0,-90.0,-93.0,-90.0,-93.0,19.0,22.0,22.0,33.0,0
5436,BA:8C:B9:54:50:24,3829520,488547768,4723,6150531,3824797,482397237,0,8325,1647684,8303,1644189,22,3495,2321,14,5101,36,0,53,216660.0,130000.0,-39.0,-36.0,-45.0,-51.0,-43.0,-35.0,-43.0,-48.0,-90.0,-93.0,-90.0,-93.0,51.0,57.0,45.0,42.0,0
5437,92:69:1D:31:68:E9,3828542,485976724,3741,3579083,3824801,482397641,0,4136,1038292,4021,1012502,115,25790,1998,6,3871,79,0,36,216660.0,130000.0,-52.0,-50.0,-44.0,-46.0,-51.0,-49.0,-43.0,-47.0,-90.0,-93.0,-90.0,-93.0,38.0,43.0,46.0,47.0,0
5438,CC:2F:71:3F:1F:24,4458881,1182173548,634080,699775907,3824801,482397641,37,520651,563656143,520022,563580445,629,75698,502970,10,634317,60756,34,450,130000.0,39000.0,-67.0,-65.0,-70.0,-67.0,-67.0,-65.0,-70.0,-67.0,-90.0,-93.0,-90.0,-93.0,23.0,28.0,20.0,26.0,0
5439,CC:2F:71:3E:C5:1F,3825559,482490262,758,92621,3824801,482397641,0,3184,267209,2627,201039,557,66170,802,8,1093,18,0,36,144444.0,39000.0,-71.0,-71.0,-68.0,-60.0,-70.0,-71.0,-67.0,-60.0,-90.0,-93.0,-90.0,-93.0,19.0,22.0,22.0,33.0,0
5440,BA:8C:B9:54:50:24,3829524,488548172,4723,6150531,3824801,482397641,0,8325,1647684,8303,1644189,22,3495,2321,14,5101,36,0,53,216660.0,130000.0,-39.0,-36.0,-45.0,-51.0,-43.0,-35.0,-43.0,-48.0,-90.0,-93.0,-90.0,-93.0,51.0,57.0,45.0,42.0,0
5441,92:69:1D:31:68:E9,3828546,485977128,3741,3579083,3824805,482398045,0,4136,1038292,4021,1012502,115,25790,1998,6,3871,79,0,36,216660.0,130000.0,-52.0,-50.0,-44.0,-46.0,-51.0,-49.0,-43.0,-47.0,-90.0,-93.0,-90.0,-93.0,38.0,43.0,46.0,47.0,0
5442,CC:2F:71:3F:1F:24,4458927,1182188514,634122,699790469,3824805,482398045,37,520676,563660959,520047,563585261,629,75698,502995,10,634359,60771,34,450,130000.0,39000.0,-67.0,-65.0,-70.0,-67.0,-67.0,-65.0,-70.0,-67.0,-90.0,-93.0,-90.0,-93.0,23.0,28.0,20.0,26.0,0
5443,CC:2F:71:3E:C5:1F,3825563,482490666,758,92621,3824805,482398045,0,3184,267209,2627,201039,557,66170,802,8,1093,18,0,36,144444.0,39000.0,-71.0,-71.0,-68.0,-60.0,-70.0,-71.0,-67.0,-60.0,-90.0,-93.0,-90.0,-93.0,19.0,22.0,22.0,33.0,0
5444,BA:8C:B9:54:50:24,3829528,488548576,4723,6150531,3824805,482398045,0,8325,1647684,8303,1644189,22,3495,2321,14,5101,36,0,53,216660.0,130000.0,-39.0,-36.0,-45.0,-51.0,-43.0,-35.0,-43.0,-48.0,-90.0,-93.0,-90.0,-93.0,51.0,57.0,45.0,42.0,0
5445,92:69:1D:31:68:E9,3828551,485977592,3741,3579083,3824810,482398509,0,4136,1038292,4021,1012502,115,25790,1998,6,3871,79,0,36,216660.0,130000.0,-52.0,-50.0,-44.0,-46.0,-51.0,-49.0,-43.0,-47.0,-90.0,-93.0,-90.0,-93.0,38.0,43.0,46.0,47.0,0
5446,CC:2F:71:3F:1F:24,4458974,1182203462,634164,699804953,3824810,482398509,37,520702,563665903,520073,563590205,629,75698,503021,10,634401,60773,34,450,130000.0,43333.0,-67.0,-65.0,-70.0,-67.0,-67.0,-65.0,-70.0,-67.0,-90.0,-93.0,-90.0,-93.0,23.0,28.0,20.0,26.0,0
5447,CC:2F:71:3E:C5:1F,3825568,482491130,758,92621,3824810,482398509,0,3184,267209,2627,201039,557,66170,802,8,1093,18,0,36,144444.0,39000.0,-71.0,-71.0,-68.0,-60.0,-70.0,-71.0,-67.0,-60.0,-90.0,-93.0,-90.0,-93.0,19.0,22.0,22.0,33.0,0
5448,BA:8C:B9:54:50:24,3829533,488549040,4723,6150531,3824810,482398509,0,8325,1647684,8303,1644189,22,3495,2321,14,5101,36,0,53,216660.0,130000.0,-39.0,-36.0,-45.0,-51.0,-43.0,-35.0,-43.0,-48.0,-90.0,-93.0,-90.0,-93.0,51.0,57.0,45.0,42.0,0
5449,92:69:1D:31:68:E9,3828555,485977996,3741,3579083,3824814,482398913,0,4136,1038292,4021,1012502,115,25790,1998,6,3871,79,0,36,216660.0,130000.0,-52.0,-50.0,-44.0,-46.0,-51.0,-49.0,-43.0,-47.0,-90.0,-93.0,-90.0,-93.0,38.0,43.0,46.0,47.0,0
5450,CC:2F:71:3F:1F:24,4459021,1182218424,634207,699819511,3824814,482398913,37,520727,563670707,520098,563595009,629,75698,503046,10,634444,60790,34,450,117000.0,39000.0,-67.0,-65.0,-70.0,-68.0,-67.0,-65.0,-70.0,-67.0,-90.0,-93.0,-90.0,-93.0,23.0,28.0,20.0,25.0,0
5451,CC:2F:71:3E:C5:1F,3825572,482491534,758,92621,3824814,482398913,0,3184,267209,2627,201039,557,66170,802,8,1093,18,0,36,144444.0,39000.0,-71.0,-71.0,-68.0,-60.0,-70.0,-71.0,-67.0,-60.0,-90.0,-93.0,-90.0,-93.0,19.0,22.0,22.0,33.0,0
5452,BA:8C:B9:54:50:24,3829537,488549444,4723,6150531,3824814,482398913,0,8325,1647684,8303,1644189,22,3495,2321,14,5101,36,0,53,216660.0,130000.0,-39.0,-36.0,-45.0,-51.0,-43.0,-35.0,-43.0,-48.0,-90.0,-93.0,-90.0,-93.0,51.0,57.0,45.0,42.0,0
5453,92:69:1D:31:68:E9,3828559,485978400,3741,3579083,3824818,482399317,0,4136,1038292,4021,1012502,115,25790,1998,6,3871,79,0,36,216660.0,130000.0,-52.0,-50.0,-44.0,-46.0,-51.0,-49.0,-43.0,-47.0,-90.0,-93.0,-90.0,-93.0,38.0,43.0,46.0,47.0,0
5454,CC:2F:71:3F:1F:24,4459066,1182233132,634248,699833815,3824818,482399317,37,520754,563675767,520125,563600069,629,75698,503073,10,634485,60793,34,450,130000.0,43333.0,-67.0,-65.0,-70.0,-68.0,-67.0,-65.0,-70.0,-67.0,-90.0,-93.0,-90.0,-93.0,23.0,28.0,20.0,25.0,0
5455,CC:2F:71:3E:C5:1F,3825576,482491938,758,92621,3824818,482399317,0,3184,267209,2627,201039,557,66170,802,8,1093,18,0,36,144444.0,39000.0,-71.0,-71.0,-68.0,-60.0,-70.0,-71.0,-67.0,-60.0,-90.0,-93.0,-90.0,-93.0,19.0,22.0,22.0,33.0,0
5456,BA:8C:B9:54:50:24,3829542,488549908,4723,6150531,3824819,482399377,0,8325,1647684,8303,1644189,22,3495,2321,14,5101,36,0,53,216660.0,130000.0,-39.0,-36.0,-45.0,-51.0,-43.0,-35.0,-43.0,-48.0,-90.0,-93.0,-90.0,-93.0,51.0,57.0,45.0,42.0,0
5457,92:69:1D:31:68:E9,3828564,485978864,3741,3579083,3824823,482399781,0,4136,1038292,4021,1012502,115,25790,1998,6,3871,79,0,36,216660.0,130000.0,-52.0,-50.0,-44.0,-46.0,-51.0,-49.0,-43.0,-47.0,-90.0,-93.0,-90.0,-93.0,38.0,43.0,46.0,47.0,0
5458,CC:2F:71:3F:1F:24,4459112,1182247956,634289,699848175,3824823,482399781,37,520779,563680571,520150,563604873,629,75698,503098,10,634526,60814,34,450,130000.0,39000.0,-67.0,-65.0,-70.0,-67.0,-67.0,-65.0,-70.0,-67.0,-90.0,-93.0,-90.0,-93.0,23.0,28.0,20.0,26.0,0
5459,CC:2F:71:3E:C5:1F,3825581,482492402,758,92621,3824823,482399781,0,3184,267209,2627,201039,557,66170,802,8,1093,18,0,36,144444.0,39000.0,-71.0,-71.0,-68.0,-60.0,-70.0,-71.0,-67.0,-60.0,-90.0,-93.0,-90.0,-93.0,19.0,22.0,22.0,33.0,0
5460,BA:8C:B9:54:50:24,3829546,488550312,4723,6150531,3824823,482399781,0,8325,1647684,8303,1644189,22,3495,2321,14,5101,36,0,53,216660.0,130000.0,-39.0,-36.0,-45.0,-51.0,-43.0,-35.0,-43.0,-48.0,-90.0,-93.0,-90.0,-93.0,51.0,57.0,45.0,42.0,0
5461,92:69:1D:31:68:E9,3828568,485979268,3741,3579083,3824827,482400185,0,4136,1038292,4021,1012502,115,25790,1998,6,3871,79,0,36,216660.0,130000.0,-52.0,-50.0,-44.0,-46.0,-51.0,-49.0,-43.0,-47.0,-90.0,-93.0,-90.0,-93.0,38.0,43.0,46.0,47.0,0
5462,CC:2F:71:3F:1F:24,4459159,1182262856,634332,699862671,3824827,482400185,37,520805,563685491,520176,563609793,629,75698,503124,10,634569,60841,34,450,130000.0,43333.0,-67.0,-65.0,-70.0,-67.0,-67.0,-65.0,-70.0,-67.0,-90.0,-93.0,-90.0,-93.0,23.0,28.0,20.0,26.0,0
5463,CC:2F:71:3E:C5:1F,3825585,482492806,758,92621,3824827,482400185,0,3184,267209,2627,201039,557,66170,802,8,1093,18,0,36,144444.0,39000.0,-71.0,-71.0,-68.0,-60.0,-70.0,-71.0,-67.0,-60.0,-90.0,-93.0,-90.0,-93.0,19.0,22.0,22.0,33.0,0
5464,BA:8C:B9:54:50:24,3829550,488550716,4723,6150531,3824827,482400185,0,8325,1647684,8303,1644189,22,3495,2321,14,5101,36,0,53,216660.0,130000.0,-39.0,-36.0,-45.0,-51.0,-43.0,-35.0,-43.0,-48.0,-90.0,-93.0,-90.0,-93.0,51.0,57.0,45.0,42.0,0
5465,92:69:1D:31:68:E9,3828573,485979732,3741,3579083,3824832,482400649,0,4136,1038292,4021,1012502,115,25790,1998,6,3871,79,0,36,216660.0,130000.0,-52.0,-50.0,-44.0,-46.0,-51.0,-49.0,-43.0,-47.0,-90.0,-93.0,-90.0,-93.0,38.0,43.0,46.0,47.0,0
5466,CC:2F:71:3F:1F:24,4459206,1182277804,634374,699877155,3824832,482400649,37,520830,563690295,520201,563614597,629,75698,503149,10,634611,60864,34,450,130000.0,39000.0,-67.0,-65.0,-70.0,-68.0,-67.0,-65.0,-70.0,-67.0,-90.0,-93.0,-90.0,-93.0,23.0,28.0,20.0,25.0,0
5467,CC:2F:71:3E:C5:1F,3825590,482493270,758,92621,3824832,482400649,0,3184,267209,2627,201039,557,66170,802,8,1093,18,0,36,144444.0,39000.0,-71.0,-71.0,-68.0,-60.0,-70.0,-71.0,-67.0,-60.0,-90.0,-93.0,-90.0,-93.0,19.0,22.0,22.0,33.0,0
5468,BA:8C:B9:54:50:24,3829555,488551180,4723,6150531,3824832,482400649,0,8325,1647684,8303,1644189,22,3495,2321,14,5101,36,0,53,216660.0,130000.0,-39.0,-36.0,-45.0,-51.0,-43.0,-35.0,-43.0,-48.0,-90.0,-93.0,-90.0,-93.0,51.0,57.0,45.0,42.0,0
5469,92:69:1D:31:68:E9,3828578,485980196,3742,3579143,3824836,482401053,0,4138,1038428,4023,1012638,115,25790,1998,6,3872,79,0,36,216660.0,130000.0,-51.0,-47.0,-42.0,-49.0,-51.0,-48.0,-43.0,-47.0,-90.0,-93.0,-90.0,-93.0,39.0,46.0,48.0,44.0,0
5470,CC:2F:71:3F:1F:24,4459254,1182292820,634418,699891767,3824836,482401053,37,520856,563695239,520227,563619541,629,75698,503175,10,634655,60874,34,450,130000.0,43333.0,-67.0,-65.0,-70.0,-67.0,-67.0,-65.0,-70.0,-67.0,-90.0,-93.0,-90.0,-93.0,23.0,28.0,20.0,26.0,0
5471,CC:2F:71:3E:C5:1F,3825595,482493790,759,92737,3824836,482401053,0,3186,267349,2629,201179,557,66170,802,8,1094,18,0,36,144444.0,43333.0,-71.0,-71.0,-68.0,-60.0,-70.0,-71.0,-67.0,-60.0,-90.0,-93.0,-90.0,-93.0,19.0,22.0,22.0,33.0,0
5472,BA:8C:B9:54:50:24,3829560,488551700,4724,6150647,3824836,482401053,0,8327,1647820,8305,1644325,22,3495,2321,14,5102,36,0,53,216660.0,130000.0,-49.0,-35.0,-42.0,-45.0,-41.0,-36.0,-43.0,-49.0,-90.0,-93.0,-90.0,-93.0,41.0,58.0,48.0,48.0,0
5473,92:69:1D:31:68:E9,3828582,485980805,3742,3579143,3824840,482401662,0,4138,1038428,4023,1012638,115,25790,1998,6,3872,79,0,36,216660.0,130000.0,-51.0,-47.0,-42.0,-49.0,-51.0,-48.0,-43.0,-47.0,-90.0,-93.0,-90.0,-93.0,39.0,46.0,48.0,44.0,0
5474,CC:2F:71:3F:1F:24,4459308,1182309364,634467,699907634,3824841,482401730,37,520889,563701148,520260,563625450,629,75698,503208,10,634704,60885,34,450,130000.0,43333.0,-67.0,-65.0,-70.0,-67.0,-67.0,-65.0,-70.0,-67.0,-90.0,-93.0,-90.0,-93.0,23.0,28.0,20.0,26.0,0
5475,CC:2F:71:3E:C5:1F,3825600,482494467,759,92737,3824841,482401730,0,3186,267349,2629,201179,557,66170,802,8,1094,18,0,36,144444.0,43333.0,-71.0,-71.0,-68.0,-60.0,-70.0,-71.0,-67.0,-60.0,-90.0,-93.0,-90.0,-93.0,19.0,22.0,22.0,33.0,0
5476,BA:8C:B9:54:50:24,3829565,488552377,4724,6150647,3824841,482401730,0,8327,1647820,8305,1644325,22,3495,2321,14,5102,36,0,53,216660.0,130000.0,-49.0,-35.0,-42.0,-45.0,-41.0,-36.0,-43.0,-49.0,-90.0,-93.0,-90.0,-93.0,41.0,58.0,48.0,48.0,0
5477,92:69:1D:31:68:E9,3828588,485981337,3742,3579143,3824846,482402194,0,4138,1038428,4023,1012638,115,25790,1998,6,3872,79,0,36,216660.0,130000.0,-51.0,-47.0,-42.0,-49.0,-51.0,-48.0,-43.0,-47.0,-90.0,-93.0,-90.0,-93.0,39.0,46.0,48.0,44.0,0
5478,CC:2F:71:3F:1F:24,4459356,1182324386,634510,699922192,3824846,482402194,37,520916,563706208,520287,563630510,629,75698,503235,10,634747,60901,34,450,117000.0,39000.0,-67.0,-65.0,-70.0,-67.0,-67.0,-65.0,-70.0,-67.0,-90.0,-93.0,-90.0,-93.0,23.0,28.0,20.0,26.0,0
5479,CC:2F:71:3E:C5:1F,3825605,482494931,759,92737,3824846,482402194,0,3186,267349,2629,201179,557,66170,802,8,1094,18,0,36,144444.0,43333.0,-71.0,-71.0,-68.0,-60.0,-70.0,-71.0,-67.0,-60.0,-90.0,-93.0,-90.0,-93.0,19.0,22.0,22.0,33.0,0
5480,BA:8C:B9:54:50:24,3829570,488552841,4724,6150647,3824846,482402194,0,8327,1647820,8305,1644325,22,3495,2321,14,5102,36,0,53,216660.0,130000.0,-49.0,-35.0,-42.0,-45.0,-41.0,-36.0,-43.0,-49.0,-90.0,-93.0,-90.0,-93.0,41.0,58.0,48.0,48.0,0
5481,92:69:1D:31:68:E9,3828590,485981539,3742,3579143,3824848,482402396,0,4138,1038428,4023,1012638,115,25790,1998,6,3872,79,0,36,216660.0,130000.0,-51.0,-47.0,-42.0,-49.0,-51.0,-48.0,-43.0,-47.0,-90.0,-93.0,-90.0,-93.0,39.0,46.0,48.0,44.0,0
5482,CC:2F:71:3F:1F:24,4459402,1182339218,634552,699936620,3824850,482402598,37,520942,563711152,520313,563635454,629,75698,503261,10,634789,60911,34,450,130000.0,43333.0,-67.0,-65.0,-70.0,-68.0,-67.0,-65.0,-70.0,-67.0,-90.0,-93.0,-90.0,-93.0,23.0,28.0,20.0,25.0,0
5483,CC:2F:71:3E:C5:1F,3825609,482495335,759,92737,3824850,482402598,0,3186,267349,2629,201179,557,66170,802,8,1094,18,0,36,144444.0,43333.0,-71.0,-71.0,-68.0,-60.0,-70.0,-71.0,-67.0,-60.0,-90.0,-93.0,-90.0,-93.0,19.0,22.0,22.0,33.0,0
5484,BA:8C:B9:54:50:24,3829574,488553245,4724,6150647,3824850,482402598,0,8327,1647820,8305,1644325,22,3495,2321,14,5102,36,0,53,216660.0,130000.0,-49.0,-35.0,-42.0,-45.0,-41.0,-36.0,-43.0,-49.0,-90.0,-93.0,-90.0,-93.0,41.0,58.0,48.0,48.0,0
5485,92:69:1D:31:68:E9,3828596,485982145,3742,3579143,3824854,482403002,0,4138,1038428,4023,1012638,115,25790,1998,6,3872,79,0,36,216660.0,130000.0,-51.0,-47.0,-42.0,-49.0,-51.0,-48.0,-43.0,-47.0,-90.0,-93.0,-90.0,-93.0,39.0,46.0,48.0,44.0,0
5486,CC:2F:71:3F:1F:24,4459450,1182354290,634595,699951228,3824855,482403062,37,520968,563716072,520339,563640374,629,75698,503287,10,634832,60924,34,450,130000.0,39000.0,-67.0,-65.0,-70.0,-67.0,-67.0,-65.0,-70.0,-67.0,-90.0,-93.0,-90.0,-93.0,23.0,28.0,20.0,26.0,0
5487,CC:2F:71:3E:C5:1F,3825614,482495799,759,92737,3824855,482403062,0,3186,267349,2629,201179,557,66170,802,8,1094,18,0,36,144444.0,43333.0,-71.0,-71.0,-68.0,-60.0,-70.0,-71.0,-67.0,-60.0,-90.0,-93.0,-90.0,-93.0,19.0,22.0,22.0,33.0,0
5488,BA:8C:B9:54:50:24,3829579,488553709,4724,6150647,3824855,482403062,0,8327,1647820,8305,1644325,22,3495,2321,14,5102,36,0,53,216660.0,130000.0,-49.0,-35.0,-42.0,-45.0,-41.0,-36.0,-43.0,-49.0,-90.0,-93.0,-90.0,-93.0,41.0,58.0,48.0,48.0,0
5489,92:69:1D:31:68:E9,3828601,485982609,3742,3579143,3824859,482403466,0,4138,1038428,4023,1012638,115,25790,1998,6,3872,79,0,36,216660.0,130000.0,-51.0,-47.0,-42.0,-49.0,-51.0,-48.0,-43.0,-47.0,-90.0,-93.0,-90.0,-93.0,39.0,46.0,48.0,44.0,0
5490,CC:2F:71:3F:1F:24,4459497,1182369190,634638,699965724,3824859,482403466,37,520993,563720876,520364,563645178,629,75698,503312,10,634875,60956,34,450,130000.0,43333.0,-67.0,-65.0,-70.0,-68.0,-67.0,-65.0,-70.0,-67.0,-90.0,-93.0,-90.0,-93.0,23.0,28.0,20.0,25.0,0
5491,CC:2F:71:3E:C5:1F,3825618,482496203,759,92737,3824859,482403466,0,3186,267349,2629,201179,557,66170,802,8,1094,18,0,36,144444.0,43333.0,-71.0,-71.0,-68.0,-60.0,-70.0,-71.0,-67.0,-60.0,-90.0,-93.0,-90.0,-93.0,19.0,22.0,22.0,33.0,0
5492,BA:8C:B9:54:50:24,3829583,488554113,4724,6150647,3824859,482403466,0,8327,1647820,8305,1644325,22,3495,2321,14,5102,36,0,53,216660.0,130000.0,-49.0,-35.0,-42.0,-45.0,-41.0,-36.0,-43.0,-49.0,-90.0,-93.0,-90.0,-93.0,41.0,58.0,48.0,48.0,0
5493,92:69:1D:31:68:E9,3828605,485983013,3742,3579143,3824863,482403870,0,4141,1038632,4026,1012842,115,25790,1998,6,3872,79,0,36,216660.0,130000.0,-52.0,-50.0,-44.0,-46.0,-51.0,-48.0,-43.0,-47.0,-90.0,-93.0,-90.0,-93.0,38.0,43.0,46.0,47.0,0
5494,CC:2F:71:3F:1F:24,4459544,1182384264,634681,699980394,3824863,482403870,37,521019,563725856,520390,563650158,629,75698,503338,10,634918,60959,34,450,130000.0,43333.0,-67.0,-65.0,-71.0,-68.0,-67.0,-65.0,-70.0,-67.0,-90.0,-93.0,-90.0,-93.0,23.0,28.0,19.0,25.0,0
5495,CC:2F:71:3E:C5:1F,3825622,482496607,759,92737,3824863,482403870,0,3188,267489,2631,201319,557,66170,802,8,1095,18,0,36,144444.0,43333.0,-70.0,-71.0,-67.0,-60.0,-70.0,-71.0,-67.0,-60.0,-90.0,-93.0,-90.0,-93.0,20.0,22.0,23.0,33.0,0
5496,BA:8C:B9:54:50:24,3829587,488554517,4724,6150647,3824863,482403870,0,8331,1648092,8309,1644597,22,3495,2321,14,5103,36,0,53,216660.0,130000.0,-39.0,-36.0,-45.0,-52.0,-43.0,-35.0,-44.0,-48.0,-90.0,-93.0,-90.0,-93.0,51.0,57.0,45.0,41.0,0
5497,92:69:1D:31:68:E9,3828610,485983477,3742,3579143,3824868,482404334,0,4141,1038632,4026,1012842,115,25790,1998,6,3872,79,0,36,216660.0,130000.0,-52.0,-50.0,-44.0,-46.0,-51.0,-48.0,-43.0,-47.0,-90.0,-93.0,-90.0,-93.0,38.0,43.0,46.0,47.0,0
5498,CC:2F:71:3F:1F:24,4459589,1182398908,634721,699994574,3824868,482404334,37,521044,563730660,520415,563654962,629,75698,503363,10,634958,60976,34,450,117000.0,39000.0,-67.0,-65.0,-70.0,-67.0,-67.0,-65.0,-70.0,-67.0,-90.0,-93.0,-90.0,-93.0,23.0,28.0,20.0,26.0,0
5499,CC:2F:71:3E:C5:1F,3825627,482497071,759,92737,3824868,482404334,0,3188,267489,2631,201319,557,66170,802,8,1095,18,0,36,144444.0,43333.0,-70.0,-71.0,-67.0,-60.0,-70.0,-71.0,-67.0,-60.0,-90.0,-93.0,-90.0,-93.0,20.0,22.0,23.0,33.0,0
5500,BA:8C:B9:54:50:24,3829592,488554981,4724,6150647,3824868,482404334,0,8331,1648092,8309,1644597,22,3495,2321,14,5103,36,0,53,216660.0,130000.0,-39.0,-36.0,-45.0,-52.0,-43.0,-35.0,-44.0,-48.0,-90.0,-93.0,-90.0,-93.0,51.0,57.0,45.0,41.0,0
5501,92:69:1D:31:68:E9,3828615,485983943,3742,3579143,3824873,482404800,0,4141,1038632,4026,1012842,115,25790,1998,6,3872,79,0,36,216660.0,130000.0,-52.0,-50.0,-44.0,-46.0,-51.0,-48.0,-43.0,-47.0,-90.0,-93.0,-90.0,-93.0,38.0,43.0,46.0,47.0,0
5502,CC:2F:71:3F:1F:24,4459635,1182413678,634762,700008878,3824873,482404800,37,521070,563735604,520441,563659906,629,75698,503389,10,634999,60978,34,450,130000.0,43333.0,-67.0,-65.0,-71.0,-68.0,-67.0,-65.0,-70.0,-67.0,-90.0,-93.0,-90.0,-93.0,23.0,28.0,19.0,25.0,0
5503,CC:2F:71:3E:C5:1F,3825632,482497537,759,92737,3824873,482404800,0,3190,267677,2632,201389,558,66288,803,8,1095,18,0,36,144444.0,43333.0,-70.0,-71.0,-67.0,-60.0,-70.0,-71.0,-67.0,-60.0,-90.0,-93.0,-90.0,-93.0,20.0,22.0,23.0,33.0,0
5504,BA:8C:B9:54:50:24,3829597,488555447,4724,6150647,3824873,482404800,0,8331,1648092,8309,1644597,22,3495,2321,14,5103,36,0,53,216660.0,130000.0,-39.0,-36.0,-45.0,-52.0,-43.0,-35.0,-44.0,-48.0,-90.0,-93.0,-90.0,-93.0,51.0,57.0,45.0,41.0,0
5505,92:69:1D:31:68:E9,3828620,485984409,3742,3579143,3824878,482405266,0,4141,1038632,4026,1012842,115,25790,1998,6,3872,79,0,36,216660.0,130000.0,-52.0,-50.0,-44.0,-46.0,-51.0,-48.0,-43.0,-47.0,-90.0,-93.0,-90.0,-93.0,38.0,43.0,46.0,47.0,0
5506,CC:2F:71:3F:1F:24,4459683,1182428696,634805,700023430,3824878,482405266,37,521097,563740642,520467,563664826,630,75816,503416,10,635042,61002,34,450,117000.0,39000.0,-67.0,-65.0,-71.0,-68.0,-67.0,-65.0,-70.0,-67.0,-90.0,-93.0,-90.0,-93.0,23.0,28.0,19.0,25.0,0
5507,CC:2F:71:3E:C5:1F,3825637,482498003,759,92737,3824878,482405266,0,3190,267677,2632,201389,558,66288,803,8,1095,18,0,36,144444.0,43333.0,-70.0,-71.0,-67.0,-60.0,-70.0,-71.0,-67.0,-60.0,-90.0,-93.0,-90.0,-93.0,20.0,22.0,23.0,33.0,0
5508,BA:8C:B9:54:50:24,3829602,488555913,4724,6150647,3824878,482405266,0,8331,1648092,8309,1644597,22,3495,2321,14,5103,36,0,53,216660.0,130000.0,-39.0,-36.0,-45.0,-52.0,-43.0,-35.0,-44.0,-48.0,-90.0,-93.0,-90.0,-93.0,51.0,57.0,45.0,41.0,0
5509,92:69:1D:31:68:E9,3828623,485984671,3742,3579143,3824881,482405528,0,4142,1038700,4027,1012910,115,25790,1998,6,3872,79,0,36,216660.0,130000.0,-52.0,-50.0,-44.0,-46.0,-51.0,-49.0,-43.0,-46.0,-90.0,-93.0,-90.0,-93.0,38.0,43.0,46.0,47.0,0
5510,CC:2F:71:3F:1F:24,4459729,1182443408,634846,700037678,3824883,482405730,37,521122,563745446,520492,563669630,630,75816,503441,10,635083,61012,34,450,130000.0,39000.0,-67.0,-65.0,-70.0,-67.0,-67.0,-65.0,-70.0,-67.0,-90.0,-93.0,-90.0,-93.0,23.0,28.0,20.0,26.0,0
5511,CC:2F:71:3E:C5:1F,3825642,482498467,759,92737,3824883,482405730,0,3190,267677,2632,201389,558,66288,803,8,1095,18,0,36,144444.0,43333.0,-70.0,-71.0,-67.0,-60.0,-70.0,-71.0,-67.0,-60.0,-90.0,-93.0,-90.0,-93.0,20.0,22.0,23.0,33.0,0
5512,BA:8C:B9:54:50:24,3829607,488556377,4724,6150647,3824883,482405730,0,8331,1648092,8309,1644597,22,3495,2321,14,5103,36,0,53,216660.0,130000.0,-39.0,-36.0,-45.0,-52.0,-43.0,-35.0,-44.0,-48.0,-90.0,-93.0,-90.0,-93.0,51.0,57.0,45.0,41.0,0
5513,92:69:1D:31:68:E9,3828629,485985277,3742,3579143,3824887,482406134,0,4142,1038700,4027,1012910,115,25790,1998,6,3872,79,0,36,216660.0,130000.0,-52.0,-50.0,-44.0,-46.0,-51.0,-49.0,-43.0,-46.0,-90.0,-93.0,-90.0,-93.0,38.0,43.0,46.0,47.0,0
5514,CC:2F:71:3F:1F:24,4459775,1182458240,634888,700052106,3824887,482406134,37,521150,563750598,520520,563674782,630,75816,503469,10,635125,61046,34,450,144444.0,43333.0,-67.0,-65.0,-70.0,-67.0,-67.0,-65.0,-70.0,-67.0,-90.0,-93.0,-90.0,-93.0,23.0,28.0,20.0,26.0,0
5515,CC:2F:71:3E:C5:1F,3825646,482498871,759,92737,3824887,482406134,0,3190,267677,2632,201389,558,66288,803,8,1095,18,0,36,144444.0,43333.0,-70.0,-71.0,-67.0,-60.0,-70.0,-71.0,-67.0,-60.0,-90.0,-93.0,-90.0,-93.0,20.0,22.0,23.0,33.0,0
5516,BA:8C:B9:54:50:24,3829611,488556781,4724,6150647,3824887,482406134,0,8331,1648092,8309,1644597,22,3495,2321,14,5103,36,0,53,216660.0,130000.0,-39.0,-36.0,-45.0,-52.0,-43.0,-35.0,-44.0,-48.0,-90.0,-93.0,-90.0,-93.0,51.0,57.0,45.0,41.0,0
5517,92:69:1D:31:68:E9,3828632,485985539,3742,3579143,3824890,482406396,0,4142,1038700,4027,1012910,115,25790,1998,6,3872,79,0,36,216660.0,130000.0,-52.0,-50.0,-44.0,-46.0,-51.0,-49.0,-43.0,-46.0,-90.0,-93.0,-90.0,-93.0,38.0,43.0,46.0,47.0,0
5518,CC:2F:71:3F:1F:24,4459820,1182472992,634930,700066596,3824890,482406396,37,521177,563755658,520547,563679842,630,75816,503496,10,635167,61061,34,450,130000.0,43333.0,-67.0,-65.0,-70.0,-67.0,-67.0,-65.0,-70.0,-67.0,-90.0,-93.0,-90.0,-93.0,23.0,28.0,20.0,26.0,0
5519,CC:2F:71:3E:C5:1F,3825649,482499133,759,92737,3824890,482406396,0,3190,267677,2632,201389,558,66288,803,8,1095,18,0,36,144444.0,43333.0,-70.0,-71.0,-67.0,-60.0,-70.0,-71.0,-67.0,-60.0,-90.0,-93.0,-90.0,-93.0,20.0,22.0,23.0,33.0,0
5520,BA:8C:B9:54:50:24,3829616,488557245,4724,6150647,3824892,482406598,0,8331,1648092,8309,1644597,22,3495,2321,14,5103,36,0,53,216660.0,130000.0,-39.0,-36.0,-45.0,-52.0,-43.0,-35.0,-44.0,-48.0,-90.0,-93.0,-90.0,-93.0,51.0,57.0,45.0,41.0,0
5521,92:69:1D:31:68:E9,3828661,485997168,3742,3579143,3824919,482418025,0,4145,1039071,4029,1013046,116,26025,1999,6,3872,79,0,36,216660.0,130000.0,-52.0,-50.0,-44.0,-46.0,-52.0,-49.0,-44.0,-47.0,-90.0,-93.0,-90.0,-93.0,38.0,43.0,46.0,47.0,0
5522,CC:2F:71:3F:1F:24,4459891,1182499161,634972,700081136,3824919,482418025,37,521204,563760718,520574,563684902,630,75816,503523,10,635209,61064,34,450,130000.0,43333.0,-67.0,-65.0,-70.0,-68.0,-67.0,-65.0,-70.0,-67.0,-90.0,-93.0,-90.0,-93.0,23.0,28.0,20.0,25.0,0
5523,CC:2F:71:3E:C5:1F,3825678,482510762,759,92737,3824919,482418025,0,3190,267677,2632,201389,558,66288,803,8,1095,18,0,36,144444.0,43333.0,-70.0,-71.0,-67.0,-60.0,-70.0,-71.0,-67.0,-60.0,-90.0,-93.0,-90.0,-93.0,20.0,22.0,23.0,33.0,0
5524,BA:8C:B9:54:50:24,3829643,488568672,4724,6150647,3824919,482418025,0,8331,1648092,8309,1644597,22,3495,2321,14,5103,36,0,53,216660.0,130000.0,-39.0,-36.0,-45.0,-52.0,-43.0,-35.0,-44.0,-48.0,-90.0,-93.0,-90.0,-93.0,51.0,57.0,45.0,41.0,0
5525,92:69:1D:31:68:E9,3828664,485997643,3742,3579143,3824922,482418500,0,4145,1039071,4029,1013046,116,26025,1999,6,3872,79,0,36,216660.0,130000.0,-52.0,-50.0,-44.0,-46.0,-52.0,-49.0,-44.0,-47.0,-90.0,-93.0,-90.0,-93.0,38.0,43.0,46.0,47.0,0
5526,CC:2F:71:3F:1F:24,4459936,1182514064,635014,700095564,3824922,482418500,37,521230,563765638,520600,563689822,630,75816,503549,10,635251,61087,34,450,117000.0,39000.0,-67.0,-65.0,-70.0,-67.0,-67.0,-65.0,-70.0,-67.0,-90.0,-93.0,-90.0,-93.0,23.0,28.0,20.0,26.0,0
5527,CC:2F:71:3E:C5:1F,3825681,482511237,759,92737,3824922,482418500,0,3190,267677,2632,201389,558,66288,803,8,1095,18,0,36,144444.0,43333.0,-70.0,-71.0,-67.0,-60.0,-70.0,-71.0,-67.0,-60.0,-90.0,-93.0,-90.0,-93.0,20.0,22.0,23.0,33.0,0
5528,BA:8C:B9:54:50:24,3829648,488569349,4724,6150647,3824924,482418702,0,8331,1648092,8309,1644597,22,3495,2321,14,5103,36,0,53,216660.0,130000.0,-39.0,-36.0,-45.0,-52.0,-43.0,-35.0,-44.0,-48.0,-90.0,-93.0,-90.0,-93.0,51.0,57.0,45.0,41.0,0
5529,92:69:1D:31:68:E9,3828671,485998309,3742,3579143,3824929,482419166,0,4145,1039071,4029,1013046,116,26025,1999,6,3872,79,0,36,216660.0,130000.0,-52.0,-50.0,-44.0,-46.0,-52.0,-49.0,-44.0,-47.0,-90.0,-93.0,-90.0,-93.0,38.0,43.0,46.0,47.0,0
5530,CC:2F:71:3F:1F:24,4459987,1182529406,635058,700110240,3824929,482419166,37,521256,563770558,520626,563694742,630,75816,503575,10,635294,61093,34,450,130000.0,43333.0,-67.0,-65.0,-71.0,-68.0,-67.0,-65.0,-70.0,-67.0,-90.0,-93.0,-90.0,-93.0,23.0,28.0,19.0,25.0,0
5531,CC:2F:71:3E:C5:1F,3825688,482511903,759,92737,3824929,482419166,0,3190,267677,2632,201389,558,66288,803,8,1095,18,0,36,144444.0,43333.0,-70.0,-71.0,-67.0,-60.0,-70.0,-71.0,-67.0,-60.0,-90.0,-93.0,-90.0,-93.0,20.0,22.0,23.0,33.0,0
5532,BA:8C:B9:54:50:24,3829655,488570015,4724,6150647,3824931,482419368,0,8331,1648092,8309,1644597,22,3495,2321,14,5103,36,0,53,216660.0,130000.0,-39.0,-36.0,-45.0,-52.0,-43.0,-35.0,-44.0,-48.0,-90.0,-93.0,-90.0,-93.0,51.0,57.0,45.0,41.0,0
5533,92:69:1D:31:68:E9,3828673,485998511,3742,3579143,3824931,482419368,0,4145,1039071,4029,1013046,116,26025,1999,6,3872,79,0,36,216660.0,130000.0,-52.0,-50.0,-44.0,-46.0,-52.0,-49.0,-44.0,-47.0,-90.0,-93.0,-90.0,-93.0,38.0,43.0,46.0,47.0,0
5534,CC:2F:71:3F:1F:24,4460031,1182544036,635100,700124668,3824931,482419368,37,521281,563775362,520651,563699546,630,75816,503600,10,635337,61110,34,450,117000.0,39000.0,-71.0,-69.0,-74.0,-71.0,-68.0,-66.0,-71.0,-68.0,-90.0,-93.0,-90.0,-93.0,19.0,24.0,16.0,22.0,0
5535,CC:2F:71:3E:C5:1F,3825690,482512105,759,92737,3824931,482419368,0,3190,267677,2632,201389,558,66288,803,8,1095,18,0,36,144444.0,43333.0,-70.0,-71.0,-67.0,-60.0,-70.0,-71.0,-67.0,-60.0,-90.0,-93.0,-90.0,-93.0,20.0,22.0,23.0,33.0,0
5536,BA:8C:B9:54:50:24,3829655,488570015,4724,6150647,3824931,482419368,0,8331,1648092,8309,1644597,22,3495,2321,14,5103,36,0,53,216660.0,130000.0,-39.0,-36.0,-45.0,-52.0,-43.0,-35.0,-44.0,-48.0,-90.0,-93.0,-90.0,-93.0,51.0,57.0,45.0,41.0,0
5537,92:69:1D:31:68:E9,3828681,485999485,3742,3579143,3824939,482420342,0,4145,1039071,4029,1013046,116,26025,1999,6,3872,79,0,36,216660.0,130000.0,-52.0,-50.0,-44.0,-46.0,-52.0,-49.0,-44.0,-47.0,-90.0,-93.0,-90.0,-93.0,38.0,43.0,46.0,47.0,0
5538,CC:2F:71:3F:1F:24,4460081,1182559438,635142,700139096,3824939,482420342,37,521309,563780562,520679,563704746,630,75816,503628,10,635379,61112,34,450,130000.0,43333.0,-68.0,-66.0,-71.0,-68.0,-72.0,-70.0,-75.0,-72.0,-90.0,-93.0,-90.0,-93.0,22.0,27.0,19.0,25.0,0
5539,CC:2F:71:3E:C5:1F,3825698,482513079,759,92737,3824939,482420342,0,3190,267677,2632,201389,558,66288,803,8,1095,18,0,36,144444.0,43333.0,-70.0,-71.0,-67.0,-60.0,-70.0,-71.0,-67.0,-60.0,-90.0,-93.0,-90.0,-93.0,20.0,22.0,23.0,33.0,0
5540,BA:8C:B9:54:50:24,3829666,488571251,4724,6150647,3824942,482420604,0,8331,1648092,8309,1644597,22,3495,2321,14,5103,36,0,53,216660.0,130000.0,-39.0,-36.0,-45.0,-52.0,-43.0,-35.0,-44.0,-48.0,-90.0,-93.0,-90.0,-93.0,51.0,57.0,45.0,41.0,0
5541,92:69:1D:31:68:E9,3828684,485999747,3742,3579143,3824942,482420604,0,4145,1039071,4029,1013046,116,26025,1999,6,3872,79,0,36,216660.0,130000.0,-52.0,-50.0,-44.0,-46.0,-52.0,-49.0,-44.0,-47.0,-90.0,-93.0,-90.0,-93.0,38.0,43.0,46.0,47.0,0
5542,CC:2F:71:3F:1F:24,4460128,1182574494,635186,700153890,3824942,482420604,37,521337,563785762,520707,563709946,630,75816,503656,10,635423,61119,34,450,130000.0,43333.0,-68.0,-66.0,-71.0,-68.0,-68.0,-66.0,-71.0,-68.0,-90.0,-93.0,-90.0,-93.0,22.0,27.0,19.0,25.0,0
5543,CC:2F:71:3E:C5:1F,3825701,482513341,759,92737,3824942,482420604,0,3190,267677,2632,201389,558,66288,803,8,1095,18,0,36,144444.0,43333.0,-70.0,-71.0,-67.0,-60.0,-70.0,-71.0,-67.0,-60.0,-90.0,-93.0,-90.0,-93.0,20.0,22.0,23.0,33.0,0
5544,BA:8C:B9:54:50:24,3829668,488571453,4724,6150647,3824944,482420806,0,8331,1648092,8309,1644597,22,3495,2321,14,5103,36,0,53,216660.0,130000.0,-39.0,-36.0,-45.0,-52.0,-43.0,-35.0,-44.0,-48.0,-90.0,-93.0,-90.0,-93.0,51.0,57.0,45.0,41.0,0
5545,92:69:1D:31:68:E9,3828690,486000353,3742,3579143,3824948,482421210,0,4145,1039071,4029,1013046,116,26025,1999,6,3872,79,0,36,216660.0,130000.0,-52.0,-50.0,-44.0,-46.0,-52.0,-49.0,-44.0,-47.0,-90.0,-93.0,-90.0,-93.0,38.0,43.0,46.0,47.0,0
5546,CC:2F:71:3F:1F:24,4460178,1182589844,635230,700168634,3824948,482421210,37,521363,563790742,520733,563714926,630,75816,503682,10,635467,61138,34,450,130000.0,39000.0,-68.0,-66.0,-71.0,-68.0,-67.0,-66.0,-71.0,-68.0,-90.0,-93.0,-90.0,-93.0,22.0,27.0,19.0,25.0,0
5547,CC:2F:71:3E:C5:1F,3825707,482513947,759,92737,3824948,482421210,0,3190,267677,2632,201389,558,66288,803,8,1095,18,0,36,144444.0,43333.0,-70.0,-71.0,-67.0,-60.0,-70.0,-71.0,-67.0,-60.0,-90.0,-93.0,-90.0,-93.0,20.0,22.0,23.0,33.0,0
5548,BA:8C:B9:54:50:24,3829674,488572059,4724,6150647,3824950,482421412,0,8331,1648092,8309,1644597,22,3495,2321,14,5103,36,0,53,216660.0,130000.0,-39.0,-36.0,-45.0,-52.0,-43.0,-35.0,-44.0,-48.0,-90.0,-93.0,-90.0,-93.0,51.0,57.0,45.0,41.0,0
5549,92:69:1D:31:68:E9,3828693,486000615,3742,3579143,3824951,482421472,0,4145,1039071,4029,1013046,116,26025,1999,6,3872,79,0,36,216660.0,130000.0,-52.0,-50.0,-44.0,-46.0,-52.0,-49.0,-44.0,-47.0,-90.0,-93.0,-90.0,-93.0,38.0,43.0,46.0,47.0,0
5550,CC:2F:71:3F:1F:24,4460223,1182604534,635272,700183062,3824951,482421472,37,521389,563795662,520759,563719846,630,75816,503708,10,635509,61148,34,450,130000.0,43333.0,-68.0,-66.0,-71.0,-68.0,-68.0,-66.0,-71.0,-68.0,-90.0,-93.0,-90.0,-93.0,22.0,27.0,19.0,25.0,0
5551,CC:2F:71:3E:C5:1F,3825710,482514209,759,92737,3824951,482421472,0,3190,267677,2632,201389,558,66288,803,8,1095,18,0,36,144444.0,43333.0,-70.0,-71.0,-67.0,-60.0,-70.0,-71.0,-67.0,-60.0,-90.0,-93.0,-90.0,-93.0,20.0,22.0,23.0,33.0,0
5552,BA:8C:B9:54:50:24,3829675,488572119,4724,6150647,3824951,482421472,0,8331,1648092,8309,1644597,22,3495,2321,14,5103,36,0,53,216660.0,130000.0,-39.0,-36.0,-45.0,-52.0,-43.0,-35.0,-44.0,-48.0,-90.0,-93.0,-90.0,-93.0,51.0,57.0,45.0,41.0,0
5553,92:69:1D:31:68:E9,3828699,486001221,3742,3579143,3824957,482422078,0,4145,1039071,4029,1013046,116,26025,1999,6,3872,79,0,36,216660.0,130000.0,-52.0,-50.0,-44.0,-46.0,-52.0,-49.0,-44.0,-47.0,-90.0,-93.0,-90.0,-93.0,38.0,43.0,46.0,47.0,0
5554,CC:2F:71:3F:1F:24,4460270,1182619444,635313,700197366,3824957,482422078,37,521414,563800466,520784,563724650,630,75816,503733,10,635550,61173,34,450,130000.0,39000.0,-71.0,-69.0,-74.0,-71.0,-70.0,-69.0,-74.0,-71.0,-90.0,-93.0,-90.0,-93.0,19.0,24.0,16.0,22.0,0
5555,CC:2F:71:3E:C5:1F,3825718,482515017,759,92737,3824959,482422280,0,3190,267677,2632,201389,558,66288,803,8,1095,18,0,36,144444.0,43333.0,-70.0,-71.0,-67.0,-60.0,-70.0,-71.0,-67.0,-60.0,-90.0,-93.0,-90.0,-93.0,20.0,22.0,23.0,33.0,0
5556,BA:8C:B9:54:50:24,3829683,488572927,4724,6150647,3824959,482422280,0,8331,1648092,8309,1644597,22,3495,2321,14,5103,36,0,53,216660.0,130000.0,-39.0,-36.0,-45.0,-52.0,-43.0,-35.0,-44.0,-48.0,-90.0,-93.0,-90.0,-93.0,51.0,57.0,45.0,41.0,0
5557,92:69:1D:31:68:E9,3828701,486001423,3742,3579143,3824959,482422280,0,4145,1039071,4029,1013046,116,26025,1999,6,3872,79,0,36,216660.0,130000.0,-52.0,-50.0,-44.0,-46.0,-52.0,-49.0,-44.0,-47.0,-90.0,-93.0,-90.0,-93.0,38.0,43.0,46.0,47.0,0
5558,CC:2F:71:3F:1F:24,4460316,1182634406,635357,700212126,3824959,482422280,37,521439,563805282,520809,563729466,630,75816,503758,10,635594,61183,34,450,130000.0,43333.0,-71.0,-69.0,-74.0,-71.0,-70.0,-69.0,-74.0,-71.0,-90.0,-93.0,-90.0,-93.0,19.0,24.0,16.0,22.0,0
5559,CC:2F:71:3E:C5:1F,3825718,482515017,759,92737,3824959,482422280,0,3190,267677,2632,201389,558,66288,803,8,1095,18,0,36,144444.0,43333.0,-70.0,-71.0,-67.0,-60.0,-70.0,-71.0,-67.0,-60.0,-90.0,-93.0,-90.0,-93.0,20.0,22.0,23.0,33.0,0
5560,BA:8C:B9:54:50:24,3829685,488573129,4724,6150647,3824961,482422482,0,8331,1648092,8309,1644597,22,3495,2321,14,5103,36,0,53,216660.0,130000.0,-39.0,-36.0,-45.0,-52.0,-43.0,-35.0,-44.0,-48.0,-90.0,-93.0,-90.0,-93.0,51.0,57.0,45.0,41.0,0
5561,92:69:1D:31:68:E9,3828708,486002089,3742,3579143,3824966,482422946,0,4145,1039071,4029,1013046,116,26025,1999,6,3872,79,0,36,216660.0,130000.0,-52.0,-50.0,-44.0,-46.0,-52.0,-49.0,-44.0,-47.0,-90.0,-93.0,-90.0,-93.0,38.0,43.0,46.0,47.0,0
5562,CC:2F:71:3F:1F:24,4460368,1182649938,635400,700226790,3824968,482423148,37,521466,563810366,520836,563734550,630,75816,503785,10,635637,61189,34,450,130000.0,43333.0,-71.0,-69.0,-74.0,-71.0,-70.0,-69.0,-73.0,-71.0,-90.0,-93.0,-90.0,-93.0,19.0,24.0,16.0,22.0,0
5563,CC:2F:71:3E:C5:1F,3825727,482515885,759,92737,3824968,482423148,0,3190,267677,2632,201389,558,66288,803,8,1095,18,0,36,144444.0,43333.0,-70.0,-71.0,-67.0,-60.0,-70.0,-71.0,-67.0,-60.0,-90.0,-93.0,-90.0,-93.0,20.0,22.0,23.0,33.0,0
5564,BA:8C:B9:54:50:24,3829692,488573795,4724,6150647,3824968,482423148,0,8331,1648092,8309,1644597,22,3495,2321,14,5103,36,0,53,216660.0,130000.0,-39.0,-36.0,-45.0,-52.0,-43.0,-35.0,-44.0,-48.0,-90.0,-93.0,-90.0,-93.0,51.0,57.0,45.0,41.0,0
5565,92:69:1D:31:68:E9,3828710,486002291,3742,3579143,3824968,482423148,0,4145,1039071,4029,1013046,116,26025,1999,6,3872,79,0,36,216660.0,130000.0,-52.0,-50.0,-44.0,-46.0,-52.0,-49.0,-44.0,-47.0,-90.0,-93.0,-90.0,-93.0,38.0,43.0,46.0,47.0,0
5566,CC:2F:71:3F:1F:24,4460411,1182664490,635443,700241342,3824968,482423148,37,521492,563815346,520862,563739530,630,75816,503811,10,635680,61206,34,450,117000.0,39000.0,-70.0,-68.0,-73.0,-70.0,-70.0,-68.0,-73.0,-70.0,-90.0,-93.0,-90.0,-93.0,20.0,25.0,17.0,23.0,0
5567,CC:2F:71:3E:C5:1F,3825727,482515885,759,92737,3824968,482423148,0,3190,267677,2632,201389,558,66288,803,8,1095,18,0,36,144444.0,43333.0,-70.0,-71.0,-67.0,-60.0,-70.0,-71.0,-67.0,-60.0,-90.0,-93.0,-90.0,-93.0,20.0,22.0,23.0,33.0,0
5568,BA:8C:B9:54:50:24,3829692,488573795,4724,6150647,3824968,482423148,0,8331,1648092,8309,1644597,22,3495,2321,14,5103,36,0,53,216660.0,130000.0,-39.0,-36.0,-45.0,-52.0,-43.0,-35.0,-44.0,-48.0,-90.0,-93.0,-90.0,-93.0,51.0,57.0,45.0,41.0,0
5569,92:69:1D:31:68:E9,3828717,486002957,3742,3579143,3824975,482423814,0,4145,1039071,4029,1013046,116,26025,1999,6,3872,79,0,36,216660.0,130000.0,-52.0,-50.0,-44.0,-46.0,-52.0,-49.0,-44.0,-47.0,-90.0,-93.0,-90.0,-93.0,38.0,43.0,46.0,47.0,0
5570,CC:2F:71:3F:1F:24,4460462,1182679786,635485,700255770,3824977,482424016,37,521519,563820442,520889,563744626,630,75816,503838,10,635722,61206,34,450,130000.0,43333.0,-67.0,-65.0,-70.0,-67.0,-67.0,-65.0,-70.0,-67.0,-90.0,-93.0,-90.0,-93.0,23.0,28.0,20.0,26.0,0
5571,CC:2F:71:3E:C5:1F,3825736,482516753,759,92737,3824977,482424016,0,3190,267677,2632,201389,558,66288,803,8,1095,18,0,36,144444.0,43333.0,-70.0,-71.0,-67.0,-60.0,-70.0,-71.0,-67.0,-60.0,-90.0,-93.0,-90.0,-93.0,20.0,22.0,23.0,33.0,0
5572,BA:8C:B9:54:50:24,3829701,488574663,4724,6150647,3824977,482424016,0,8331,1648092,8309,1644597,22,3495,2321,14,5103,36,0,53,216660.0,130000.0,-39.0,-36.0,-45.0,-52.0,-43.0,-35.0,-44.0,-48.0,-90.0,-93.0,-90.0,-93.0,51.0,57.0,45.0,41.0,0
5573,92:69:1D:31:68:E9,3828720,486003275,3743,3579259,3824977,482424016,0,4147,1039207,4031,1013182,116,26025,1999,6,3873,79,0,36,216660.0,130000.0,-52.0,-50.0,-44.0,-46.0,-52.0,-50.0,-44.0,-46.0,-90.0,-93.0,-90.0,-93.0,38.0,43.0,46.0,47.0,0
5574,CC:2F:71:3F:1F:24,4460505,1182694386,635528,700270370,3824977,482424016,37,521545,563825386,520915,563749570,630,75816,503864,10,635765,61217,34,450,130000.0,39000.0,-67.0,-65.0,-70.0,-68.0,-67.0,-65.0,-70.0,-67.0,-90.0,-93.0,-90.0,-93.0,23.0,28.0,20.0,25.0,0
5575,CC:2F:71:3E:C5:1F,3825741,482517470,764,93454,3824977,482424016,0,3196,268492,2638,202204,558,66288,808,8,1100,18,0,36,130000.0,39000.0,-70.0,-71.0,-67.0,-60.0,-70.0,-71.0,-67.0,-60.0,-90.0,-93.0,-90.0,-93.0,20.0,22.0,23.0,33.0,0
5576,BA:8C:B9:54:50:24,3829702,488574779,4725,6150763,3824977,482424016,0,8333,1648228,8311,1644733,22,3495,2321,14,5104,36,0,53,216660.0,130000.0,-49.0,-35.0,-42.0,-45.0,-42.0,-35.0,-43.0,-49.0,-90.0,-93.0,-90.0,-93.0,41.0,58.0,48.0,48.0,0
5577,92:69:1D:31:68:E9,3828727,486004154,3743,3579259,3824984,482424895,0,4147,1039207,4031,1013182,116,26025,1999,6,3873,79,0,36,216660.0,130000.0,-52.0,-50.0,-44.0,-46.0,-52.0,-50.0,-44.0,-46.0,-90.0,-93.0,-90.0,-93.0,38.0,43.0,46.0,47.0,0
5578,CC:2F:71:3F:1F:24,4460558,1182710283,635572,700285186,3824986,482425097,37,521572,563830434,520942,563754618,630,75816,503891,10,635809,61236,34,450,130000.0,39000.0,-67.0,-65.0,-70.0,-67.0,-67.0,-65.0,-70.0,-67.0,-90.0,-93.0,-90.0,-93.0,23.0,28.0,20.0,26.0,0
5579,CC:2F:71:3E:C5:1F,3825750,482518551,764,93454,3824986,482425097,0,3196,268492,2638,202204,558,66288,808,8,1100,18,0,36,130000.0,39000.0,-70.0,-71.0,-67.0,-60.0,-70.0,-71.0,-67.0,-60.0,-90.0,-93.0,-90.0,-93.0,20.0,22.0,23.0,33.0,0
5580,BA:8C:B9:54:50:24,3829711,488575860,4725,6150763,3824986,482425097,0,8333,1648228,8311,1644733,22,3495,2321,14,5104,36,0,53,216660.0,130000.0,-49.0,-35.0,-42.0,-45.0,-42.0,-35.0,-43.0,-49.0,-90.0,-93.0,-90.0,-93.0,41.0,58.0,48.0,48.0,0
5581,92:69:1D:31:68:E9,3828730,486004416,3743,3579259,3824987,482425157,0,4147,1039207,4031,1013182,116,26025,1999,6,3873,79,0,36,216660.0,130000.0,-52.0,-50.0,-44.0,-46.0,-52.0,-50.0,-44.0,-46.0,-90.0,-93.0,-90.0,-93.0,38.0,43.0,46.0,47.0,0
5582,CC:2F:71:3F:1F:24,4460603,1182725019,635616,700299862,3824987,482425157,37,521599,563835494,520969,563759678,630,75816,503918,10,635853,61253,34,450,130000.0,39000.0,-67.0,-65.0,-71.0,-67.0,-67.0,-65.0,-70.0,-67.0,-90.0,-93.0,-90.0,-93.0,23.0,28.0,19.0,26.0,0
5583,CC:2F:71:3E:C5:1F,3825751,482518611,764,93454,3824987,482425157,0,3196,268492,2638,202204,558,66288,808,8,1100,18,0,36,130000.0,39000.0,-70.0,-71.0,-67.0,-60.0,-70.0,-71.0,-67.0,-60.0,-90.0,-93.0,-90.0,-93.0,20.0,22.0,23.0,33.0,0
5584,BA:8C:B9:54:50:24,3829712,488575920,4725,6150763,3824987,482425157,0,8334,1648296,8312,1644801,22,3495,2321,14,5104,36,0,53,216660.0,130000.0,-39.0,-36.0,-45.0,-52.0,-42.0,-35.0,-43.0,-49.0,-90.0,-93.0,-90.0,-93.0,51.0,57.0,45.0,41.0,0
5585,92:69:1D:31:68:E9,3828738,486005224,3743,3579259,3824995,482425965,0,4147,1039207,4031,1013182,116,26025,1999,6,3873,79,0,36,216660.0,130000.0,-52.0,-50.0,-44.0,-46.0,-52.0,-50.0,-44.0,-46.0,-90.0,-93.0,-90.0,-93.0,38.0,43.0,46.0,47.0,0
5586,CC:2F:71:3F:1F:24,4460652,1182740131,635657,700314166,3824995,482425965,37,521624,563840298,520994,563764482,630,75816,503943,10,635894,61268,34,450,130000.0,39000.0,-67.0,-65.0,-70.0,-68.0,-67.0,-65.0,-70.0,-67.0,-90.0,-93.0,-90.0,-93.0,23.0,28.0,20.0,25.0,0
5587,CC:2F:71:3E:C5:1F,3825759,482519419,764,93454,3824995,482425965,0,3196,268492,2638,202204,558,66288,808,8,1100,18,0,36,130000.0,39000.0,-70.0,-71.0,-67.0,-60.0,-70.0,-71.0,-67.0,-60.0,-90.0,-93.0,-90.0,-93.0,20.0,22.0,23.0,33.0,0
5588,BA:8C:B9:54:50:24,3829720,488576728,4725,6150763,3824995,482425965,0,8334,1648296,8312,1644801,22,3495,2321,14,5104,36,0,53,216660.0,130000.0,-39.0,-36.0,-45.0,-52.0,-42.0,-35.0,-43.0,-49.0,-90.0,-93.0,-90.0,-93.0,51.0,57.0,45.0,41.0,0
5589,92:69:1D:31:68:E9,3828738,486005224,3743,3579259,3824995,482425965,0,4147,1039207,4031,1013182,116,26025,1999,6,3873,79,0,36,216660.0,130000.0,-52.0,-50.0,-44.0,-46.0,-52.0,-50.0,-44.0,-46.0,-90.0,-93.0,-90.0,-93.0,38.0,43.0,46.0,47.0,0
5590,CC:2F:71:3F:1F:24,4460696,1182754863,635701,700328898,3824995,482425965,37,521650,563845242,521020,563769426,630,75816,503969,10,635938,61277,34,450,130000.0,43333.0,-67.0,-65.0,-70.0,-67.0,-67.0,-65.0,-70.0,-67.0,-90.0,-93.0,-90.0,-93.0,23.0,28.0,20.0,26.0,0
5591,CC:2F:71:3E:C5:1F,3825759,482519419,764,93454,3824995,482425965,0,3196,268492,2638,202204,558,66288,808,8,1100,18,0,36,130000.0,39000.0,-70.0,-71.0,-67.0,-60.0,-70.0,-71.0,-67.0,-60.0,-90.0,-93.0,-90.0,-93.0,20.0,22.0,23.0,33.0,0
5592,BA:8C:B9:54:50:24,3829721,488576788,4725,6150763,3824996,482426025,0,8334,1648296,8312,1644801,22,3495,2321,14,5104,36,0,53,216660.0,130000.0,-39.0,-36.0,-45.0,-52.0,-42.0,-35.0,-43.0,-49.0,-90.0,-93.0,-90.0,-93.0,51.0,57.0,45.0,41.0,0
5593,92:69:1D:31:68:E9,3828747,486006092,3743,3579259,3825004,482426833,0,4147,1039207,4031,1013182,116,26025,1999,6,3873,79,0,36,216660.0,130000.0,-52.0,-50.0,-44.0,-46.0,-52.0,-50.0,-44.0,-46.0,-90.0,-93.0,-90.0,-93.0,38.0,43.0,46.0,47.0,0
5594,CC:2F:71:3F:1F:24,4460746,1182770035,635742,700343202,3825004,482426833,37,521675,563850046,521045,563774230,630,75816,503994,10,635979,61306,34,450,144444.0,39000.0,-67.0,-65.0,-70.0,-67.0,-67.0,-65.0,-70.0,-67.0,-90.0,-93.0,-90.0,-93.0,23.0,28.0,20.0,26.0,0
5595,CC:2F:71:3E:C5:1F,3825768,482520287,764,93454,3825004,482426833,0,3196,268492,2638,202204,558,66288,808,8,1100,18,0,36,130000.0,39000.0,-70.0,-71.0,-67.0,-60.0,-70.0,-71.0,-67.0,-60.0,-90.0,-93.0,-90.0,-93.0,20.0,22.0,23.0,33.0,0
5596,BA:8C:B9:54:50:24,3829729,488577596,4725,6150763,3825004,482426833,0,8334,1648296,8312,1644801,22,3495,2321,14,5104,36,0,53,216660.0,130000.0,-39.0,-36.0,-45.0,-52.0,-42.0,-35.0,-43.0,-49.0,-90.0,-93.0,-90.0,-93.0,51.0,57.0,45.0,41.0,0
5597,92:69:1D:31:68:E9,3828748,486006154,3743,3579259,3825005,482426895,0,4149,1039343,4033,1013318,116,26025,1999,7,3874,80,0,36,216660.0,130000.0,-52.0,-50.0,-44.0,-46.0,-52.0,-50.0,-44.0,-46.0,-90.0,-93.0,-90.0,-93.0,38.0,43.0,46.0,47.0,0
5598,CC:2F:71:3F:1F:24,4460789,1182784525,635784,700357630,3825005,482426895,37,521703,563855260,521072,563779326,631,75934,504022,10,636021,61335,34,450,130000.0,43333.0,-67.0,-65.0,-71.0,-68.0,-67.0,-65.0,-70.0,-67.0,-90.0,-93.0,-90.0,-93.0,23.0,28.0,19.0,25.0,0
5599,CC:2F:71:3E:C5:1F,3825769,482520349,764,93454,3825005,482426895,0,3198,268632,2640,202344,558,66288,808,8,1101,18,0,36,130000.0,39000.0,-70.0,-71.0,-68.0,-60.0,-70.0,-71.0,-67.0,-60.0,-90.0,-93.0,-90.0,-93.0,20.0,22.0,22.0,33.0,0
5600,BA:8C:B9:54:50:24,3829730,488577658,4725,6150763,3825005,482426895,0,8334,1648296,8312,1644801,22,3495,2321,14,5104,36,0,53,216660.0,130000.0,-39.0,-36.0,-45.0,-52.0,-42.0,-35.0,-43.0,-49.0,-90.0,-93.0,-90.0,-93.0,51.0,57.0,45.0,41.0,0
5601,92:69:1D:31:68:E9,3828757,486007022,3743,3579259,3825014,482427763,0,4149,1039343,4033,1013318,116,26025,1999,7,3874,80,0,36,216660.0,130000.0,-52.0,-50.0,-44.0,-46.0,-52.0,-50.0,-44.0,-46.0,-90.0,-93.0,-90.0,-93.0,38.0,43.0,46.0,47.0,0
5602,CC:2F:71:3F:1F:24,4460841,1182800001,635827,700372238,3825014,482427763,37,521729,563860240,521098,563784306,631,75934,504048,10,636064,61353,34,450,130000.0,39000.0,-67.0,-65.0,-71.0,-68.0,-67.0,-65.0,-70.0,-67.0,-90.0,-93.0,-90.0,-93.0,23.0,28.0,19.0,25.0,0
5603,CC:2F:71:3E:C5:1F,3825780,482521449,766,93686,3825014,482427763,0,3202,268984,2644,202696,558,66288,810,8,1103,18,0,36,130000.0,39000.0,-79.0,-85.0,-75.0,-71.0,-71.0,-72.0,-68.0,-61.0,-90.0,-93.0,-90.0,-93.0,11.0,8.0,15.0,22.0,0
5604,BA:8C:B9:54:50:24,3829739,488578526,4725,6150763,3825014,482427763,0,8334,1648296,8312,1644801,22,3495,2321,14,5104,36,0,53,216660.0,130000.0,-39.0,-36.0,-45.0,-52.0,-42.0,-35.0,-43.0,-49.0,-90.0,-93.0,-90.0,-93.0,51.0,57.0,45.0,41.0,0
5605,92:69:1D:31:68:E9,3828757,486007022,3743,3579259,3825014,482427763,0,4149,1039343,4033,1013318,116,26025,1999,7,3874,80,0,36,216660.0,130000.0,-52.0,-50.0,-44.0,-46.0,-52.0,-50.0,-44.0,-46.0,-90.0,-93.0,-90.0,-93.0,38.0,43.0,46.0,47.0,0
5606,CC:2F:71:3F:1F:24,4460883,1182814373,635869,700386610,3825014,482427763,37,521755,563865184,521124,563789250,631,75934,504074,10,636106,61384,34,450,130000.0,43333.0,-67.0,-65.0,-70.0,-68.0,-67.0,-65.0,-70.0,-67.0,-90.0,-93.0,-90.0,-93.0,23.0,28.0,20.0,25.0,0
5607,CC:2F:71:3E:C5:1F,3825780,482521449,766,93686,3825014,482427763,0,3202,268984,2644,202696,558,66288,810,8,1103,18,0,36,130000.0,39000.0,-79.0,-85.0,-75.0,-71.0,-71.0,-72.0,-68.0,-61.0,-90.0,-93.0,-90.0,-93.0,11.0,8.0,15.0,22.0,0
5608,BA:8C:B9:54:50:24,3829739,488578526,4725,6150763,3825014,482427763,0,8334,1648296,8312,1644801,22,3495,2321,14,5104,36,0,53,216660.0,130000.0,-39.0,-36.0,-45.0,-52.0,-42.0,-35.0,-43.0,-49.0,-90.0,-93.0,-90.0,-93.0,51.0,57.0,45.0,41.0,0
5609,92:69:1D:31:68:E9,3828766,486007892,3743,3579259,3825023,482428633,0,4149,1039343,4033,1013318,116,26025,1999,7,3874,80,0,36,216660.0,130000.0,-52.0,-50.0,-44.0,-46.0,-52.0,-50.0,-44.0,-46.0,-90.0,-93.0,-90.0,-93.0,38.0,43.0,46.0,47.0,0
5610,CC:2F:71:3F:1F:24,4460933,1182829659,635910,700401026,3825023,482428633,37,521781,563870128,521150,563794194,631,75934,504100,10,636147,61390,34,450,130000.0,43333.0,-67.0,-65.0,-70.0,-67.0,-67.0,-65.0,-70.0,-67.0,-90.0,-93.0,-90.0,-93.0,23.0,28.0,20.0,26.0,0
5611,CC:2F:71:3E:C5:1F,3825789,482522319,766,93686,3825023,482428633,0,3204,269172,2645,202766,559,66406,811,8,1103,18,0,36,130000.0,39000.0,-70.0,-71.0,-67.0,-60.0,-71.0,-72.0,-68.0,-61.0,-90.0,-93.0,-90.0,-93.0,20.0,22.0,23.0,33.0,0
5612,BA:8C:B9:54:50:24,3829748,488579396,4725,6150763,3825023,482428633,0,8334,1648296,8312,1644801,22,3495,2321,14,5104,36,0,53,216660.0,130000.0,-39.0,-36.0,-45.0,-52.0,-42.0,-35.0,-43.0,-49.0,-90.0,-93.0,-90.0,-93.0,51.0,57.0,45.0,41.0,0
5613,92:69:1D:31:68:E9,3828767,486007952,3743,3579259,3825024,482428693,0,4149,1039343,4033,1013318,116,26025,1999,7,3874,80,0,36,216660.0,130000.0,-52.0,-50.0,-44.0,-46.0,-52.0,-50.0,-44.0,-46.0,-90.0,-93.0,-90.0,-93.0,38.0,43.0,46.0,47.0,0
5614,CC:2F:71:3F:1F:24,4460977,1182844327,635953,700415634,3825024,482428693,37,521806,563874932,521175,563798998,631,75934,504125,10,636190,61405,34,450,130000.0,39000.0,-67.0,-65.0,-70.0,-67.0,-67.0,-65.0,-70.0,-67.0,-90.0,-93.0,-90.0,-93.0,23.0,28.0,20.0,26.0,0
5615,CC:2F:71:3E:C5:1F,3825790,482522379,766,93686,3825024,482428693,0,3204,269172,2645,202766,559,66406,811,8,1103,18,0,36,130000.0,39000.0,-70.0,-71.0,-67.0,-60.0,-71.0,-72.0,-68.0,-61.0,-90.0,-93.0,-90.0,-93.0,20.0,22.0,23.0,33.0,0
5616,BA:8C:B9:54:50:24,3829753,488579860,4725,6150763,3825028,482429097,0,8334,1648296,8312,1644801,22,3495,2321,14,5104,36,0,53,216660.0,130000.0,-39.0,-36.0,-45.0,-52.0,-42.0,-35.0,-43.0,-49.0,-90.0,-93.0,-90.0,-93.0,51.0,57.0,45.0,41.0,0
5617,92:69:1D:31:68:E9,3828775,486008760,3743,3579259,3825032,482429501,0,4149,1039343,4033,1013318,116,26025,1999,7,3874,80,0,36,216660.0,130000.0,-52.0,-50.0,-44.0,-46.0,-52.0,-50.0,-44.0,-46.0,-90.0,-93.0,-90.0,-93.0,38.0,43.0,46.0,47.0,0
5618,CC:2F:71:3F:1F:24,4461024,1182859123,635992,700429622,3825032,482429501,37,521833,563880028,521202,563804094,631,75934,504152,10,636229,61415,34,450,130000.0,43333.0,-67.0,-65.0,-70.0,-67.0,-67.0,-65.0,-70.0,-67.0,-90.0,-93.0,-90.0,-93.0,23.0,28.0,20.0,26.0,0
5619,CC:2F:71:3E:C5:1F,3825798,482523187,766,93686,3825032,482429501,0,3204,269172,2645,202766,559,66406,811,8,1103,18,0,36,130000.0,39000.0,-70.0,-71.0,-67.0,-60.0,-71.0,-72.0,-68.0,-61.0,-90.0,-93.0,-90.0,-93.0,20.0,22.0,23.0,33.0,0
5620,BA:8C:B9:54:50:24,3829757,488580264,4725,6150763,3825032,482429501,0,8334,1648296,8312,1644801,22,3495,2321,14,5104,36,0,53,216660.0,130000.0,-39.0,-36.0,-45.0,-52.0,-42.0,-35.0,-43.0,-49.0,-90.0,-93.0,-90.0,-93.0,51.0,57.0,45.0,41.0,0
5621,92:69:1D:31:68:E9,3828775,486008760,3743,3579259,3825032,482429501,0,4149,1039343,4033,1013318,116,26025,1999,7,3874,80,0,36,216660.0,130000.0,-52.0,-50.0,-44.0,-46.0,-52.0,-50.0,-44.0,-46.0,-90.0,-93.0,-90.0,-93.0,38.0,43.0,46.0,47.0,0
5622,CC:2F:71:3F:1F:24,4461065,1182873357,636032,700443796,3825033,482429561,37,521860,563885088,521229,563809154,631,75934,504179,10,636269,61442,34,450,130000.0,39000.0,-67.0,-65.0,-71.0,-68.0,-67.0,-65.0,-70.0,-67.0,-90.0,-93.0,-90.0,-93.0,23.0,28.0,19.0,25.0,0
5623,CC:2F:71:3E:C5:1F,3825799,482523247,766,93686,3825033,482429561,0,3204,269172,2645,202766,559,66406,811,8,1103,18,0,36,130000.0,39000.0,-70.0,-71.0,-67.0,-60.0,-71.0,-72.0,-68.0,-61.0,-90.0,-93.0,-90.0,-93.0,20.0,22.0,23.0,33.0,0
5624,BA:8C:B9:54:50:24,3829762,488580728,4725,6150763,3825037,482429965,0,8334,1648296,8312,1644801,22,3495,2321,14,5104,36,0,53,216660.0,130000.0,-39.0,-36.0,-45.0,-52.0,-42.0,-35.0,-43.0,-49.0,-90.0,-93.0,-90.0,-93.0,51.0,57.0,45.0,41.0,0
5625,92:69:1D:31:68:E9,3828785,486009754,3743,3579259,3825042,482430495,0,4149,1039343,4033,1013318,116,26025,1999,7,3874,80,0,36,216660.0,130000.0,-52.0,-50.0,-44.0,-46.0,-52.0,-50.0,-44.0,-46.0,-90.0,-93.0,-90.0,-93.0,38.0,43.0,46.0,47.0,0
5626,CC:2F:71:3F:1F:24,4461117,1182888843,636075,700458348,3825042,482430495,37,521886,563890008,521255,563814074,631,75934,504205,10,636312,61444,34,450,130000.0,43333.0,-67.0,-65.0,-70.0,-67.0,-67.0,-65.0,-70.0,-67.0,-90.0,-93.0,-90.0,-93.0,23.0,28.0,20.0,26.0,0
5627,CC:2F:71:3E:C5:1F,3825808,482524181,766,93686,3825042,482430495,0,3204,269172,2645,202766,559,66406,811,8,1103,18,0,36,130000.0,39000.0,-70.0,-71.0,-67.0,-60.0,-71.0,-72.0,-68.0,-61.0,-90.0,-93.0,-90.0,-93.0,20.0,22.0,23.0,33.0,0
5628,BA:8C:B9:54:50:24,3829767,488581258,4725,6150763,3825042,482430495,0,8334,1648296,8312,1644801,22,3495,2321,14,5104,36,0,53,216660.0,130000.0,-39.0,-36.0,-45.0,-52.0,-42.0,-35.0,-43.0,-49.0,-90.0,-93.0,-90.0,-93.0,51.0,57.0,45.0,41.0,0
5629,92:69:1D:31:68:E9,3828786,486010027,3743,3579259,3825043,482430768,0,4149,1039343,4033,1013318,116,26025,1999,7,3874,80,0,36,216660.0,130000.0,-52.0,-50.0,-44.0,-46.0,-52.0,-50.0,-44.0,-46.0,-90.0,-93.0,-90.0,-93.0,38.0,43.0,46.0,47.0,0
5630,CC:2F:71:3F:1F:24,4461160,1182903538,636117,700472770,3825043,482430768,37,521911,563894812,521280,563818878,631,75934,504230,10,636354,61462,34,450,117000.0,39000.0,-67.0,-65.0,-71.0,-68.0,-67.0,-65.0,-70.0,-67.0,-90.0,-93.0,-90.0,-93.0,23.0,28.0,19.0,25.0,0
5631,CC:2F:71:3E:C5:1F,3825809,482524454,766,93686,3825043,482430768,0,3204,269172,2645,202766,559,66406,811,8,1103,18,0,36,130000.0,39000.0,-70.0,-71.0,-67.0,-60.0,-71.0,-72.0,-68.0,-61.0,-90.0,-93.0,-90.0,-93.0,20.0,22.0,23.0,33.0,0
5632,BA:8C:B9:54:50:24,3829770,488581733,4725,6150763,3825045,482430970,0,8338,1648568,8316,1645073,22,3495,2321,14,5104,36,0,53,216660.0,130000.0,-40.0,-37.0,-45.0,-51.0,-40.0,-36.0,-44.0,-50.0,-90.0,-93.0,-90.0,-93.0,50.0,56.0,45.0,42.0,0
5633,92:69:1D:31:68:E9,3828795,486010895,3743,3579259,3825052,482431636,0,4149,1039343,4033,1013318,116,26025,1999,7,3874,80,0,36,216660.0,130000.0,-52.0,-50.0,-44.0,-46.0,-52.0,-50.0,-44.0,-46.0,-90.0,-93.0,-89.0,-93.0,38.0,43.0,45.0,47.0,0
5634,CC:2F:71:3F:1F:24,4461213,1182919216,636161,700487580,3825052,482431636,37,521937,563899744,521306,563823810,631,75934,504256,10,636398,61464,34,450,130000.0,43333.0,-67.0,-65.0,-70.0,-68.0,-67.0,-65.0,-70.0,-67.0,-90.0,-93.0,-89.0,-93.0,23.0,28.0,19.0,25.0,0
5635,CC:2F:71:3E:C5:1F,3825818,482525322,766,93686,3825052,482431636,0,3204,269172,2645,202766,559,66406,811,8,1103,18,0,36,130000.0,39000.0,-70.0,-71.0,-67.0,-60.0,-71.0,-72.0,-68.0,-61.0,-90.0,-93.0,-89.0,-93.0,20.0,22.0,22.0,33.0,0
5636,BA:8C:B9:54:50:24,3829777,488582399,4725,6150763,3825052,482431636,0,8338,1648568,8316,1645073,22,3495,2321,14,5104,36,0,53,216660.0,130000.0,-40.0,-37.0,-45.0,-51.0,-40.0,-36.0,-44.0,-50.0,-90.0,-93.0,-89.0,-93.0,50.0,56.0,44.0,42.0,0
5637,92:69:1D:31:68:E9,3828795,486010895,3743,3579259,3825052,482431636,0,4149,1039343,4033,1013318,116,26025,1999,7,3874,80,0,36,216660.0,130000.0,-52.0,-50.0,-44.0,-46.0,-52.0,-50.0,-44.0,-46.0,-90.0,-93.0,-89.0,-93.0,38.0,43.0,45.0,47.0,0
5638,CC:2F:71:3F:1F:24,4461255,1182933706,636203,700502070,3825052,482431636,37,521962,563904548,521331,563828614,631,75934,504281,10,636440,61478,34,450,130000.0,39000.0,-67.0,-65.0,-70.0,-67.0,-67.0,-65.0,-70.0,-67.0,-90.0,-93.0,-89.0,-93.0,23.0,28.0,19.0,26.0,0
5639,CC:2F:71:3E:C5:1F,3825818,482525322,766,93686,3825052,482431636,0,3204,269172,2645,202766,559,66406,811,8,1103,18,0,36,130000.0,39000.0,-70.0,-71.0,-67.0,-60.0,-71.0,-72.0,-68.0,-61.0,-90.0,-93.0,-89.0,-93.0,20.0,22.0,22.0,33.0,0
5640,BA:8C:B9:54:50:24,3829779,488582601,4725,6150763,3825054,482431838,0,8338,1648568,8316,1645073,22,3495,2321,14,5104,36,0,53,216660.0,130000.0,-40.0,-37.0,-45.0,-51.0,-40.0,-36.0,-44.0,-50.0,-90.0,-93.0,-89.0,-93.0,50.0,56.0,44.0,42.0,0
5641,92:69:1D:31:68:E9,3828804,486011781,3743,3579259,3825061,482432522,0,4149,1039343,4033,1013318,116,26025,1999,7,3874,80,0,36,216660.0,130000.0,-52.0,-50.0,-44.0,-46.0,-52.0,-50.0,-44.0,-46.0,-90.0,-93.0,-89.0,-93.0,38.0,43.0,45.0,47.0,0
5642,CC:2F:71:3F:1F:24,4461306,1182949148,636245,700516626,3825061,482432522,37,521989,563909596,521358,563833662,631,75934,504308,10,636482,61486,34,450,130000.0,39000.0,-67.0,-65.0,-70.0,-68.0,-67.0,-65.0,-70.0,-67.0,-90.0,-93.0,-89.0,-93.0,23.0,28.0,19.0,25.0,0
5643,CC:2F:71:3E:C5:1F,3825827,482526208,766,93686,3825061,482432522,0,3204,269172,2645,202766,559,66406,811,8,1103,18,0,36,130000.0,39000.0,-70.0,-71.0,-67.0,-60.0,-71.0,-72.0,-68.0,-61.0,-90.0,-93.0,-89.0,-93.0,20.0,22.0,22.0,33.0,0
5644,BA:8C:B9:54:50:24,3829786,488583285,4725,6150763,3825061,482432522,0,8338,1648568,8316,1645073,22,3495,2321,14,5104,36,0,53,216660.0,130000.0,-40.0,-37.0,-45.0,-51.0,-40.0,-36.0,-44.0,-50.0,-90.0,-93.0,-90.0,-93.0,50.0,56.0,45.0,42.0,0
5645,92:69:1D:31:68:E9,3828805,486011841,3743,3579259,3825062,482432582,0,4149,1039343,4033,1013318,116,26025,1999,7,3874,80,0,36,216660.0,130000.0,-52.0,-50.0,-44.0,-46.0,-52.0,-50.0,-44.0,-46.0,-90.0,-93.0,-90.0,-93.0,38.0,43.0,46.0,47.0,0
5646,CC:2F:71:3F:1F:24,4461350,1182963816,636288,700531234,3825062,482432582,37,522016,563914680,521385,563838746,631,75934,504335,10,636525,61490,34,450,130000.0,43333.0,-67.0,-65.0,-70.0,-67.0,-67.0,-65.0,-70.0,-67.0,-90.0,-93.0,-90.0,-93.0,23.0,28.0,20.0,26.0,0
5647,CC:2F:71:3E:C5:1F,3825830,482526470,766,93686,3825064,482432784,0,3204,269172,2645,202766,559,66406,811,8,1103,18,0,36,130000.0,39000.0,-70.0,-71.0,-67.0,-60.0,-71.0,-72.0,-68.0,-61.0,-90.0,-93.0,-90.0,-93.0,20.0,22.0,23.0,33.0,0
5648,BA:8C:B9:54:50:24,3829791,488583749,4725,6150763,3825066,482432986,0,8338,1648568,8316,1645073,22,3495,2321,14,5104,36,0,53,216660.0,130000.0,-40.0,-37.0,-45.0,-51.0,-40.0,-36.0,-44.0,-50.0,-90.0,-93.0,-90.0,-93.0,50.0,56.0,45.0,42.0,0
5649,92:69:1D:31:68:E9,3828813,486012649,3743,3579259,3825070,482433390,0,4149,1039343,4033,1013318,116,26025,1999,7,3874,80,0,36,216660.0,130000.0,-52.0,-50.0,-44.0,-46.0,-52.0,-50.0,-44.0,-46.0,-90.0,-93.0,-90.0,-93.0,38.0,43.0,46.0,47.0,0
5650,CC:2F:71:3F:1F:24,4461400,1182979046,636330,700545656,3825070,482433390,37,522042,563919624,521411,563843690,631,75934,504361,10,636567,61507,34,450,117000.0,39000.0,-67.0,-65.0,-70.0,-67.0,-67.0,-65.0,-70.0,-67.0,-90.0,-93.0,-90.0,-93.0,23.0,28.0,20.0,26.0,0
5651,CC:2F:71:3E:C5:1F,3825836,482527076,766,93686,3825070,482433390,0,3204,269172,2645,202766,559,66406,811,8,1103,18,0,36,130000.0,39000.0,-70.0,-71.0,-67.0,-60.0,-71.0,-72.0,-68.0,-61.0,-90.0,-93.0,-90.0,-93.0,20.0,22.0,23.0,33.0,0
5652,BA:8C:B9:54:50:24,3829795,488584153,4725,6150763,3825070,482433390,0,8338,1648568,8316,1645073,22,3495,2321,14,5104,36,0,53,216660.0,130000.0,-40.0,-37.0,-45.0,-51.0,-40.0,-36.0,-44.0,-50.0,-90.0,-93.0,-90.0,-93.0,50.0,56.0,45.0,42.0,0
5653,92:69:1D:31:68:E9,3828814,486012709,3743,3579259,3825071,482433450,0,4149,1039343,4033,1013318,116,26025,1999,7,3874,80,0,36,216660.0,130000.0,-52.0,-50.0,-44.0,-46.0,-52.0,-50.0,-44.0,-46.0,-90.0,-93.0,-90.0,-93.0,38.0,43.0,46.0,47.0,0
5654,CC:2F:71:3F:1F:24,4461443,1182993534,636372,700560084,3825071,482433450,37,522067,563924428,521436,563848494,631,75934,504386,10,636609,61509,34,450,130000.0,43333.0,-67.0,-65.0,-70.0,-68.0,-67.0,-65.0,-70.0,-67.0,-90.0,-93.0,-90.0,-93.0,23.0,28.0,20.0,25.0,0
5655,CC:2F:71:3E:C5:1F,3825839,482527338,766,93686,3825073,482433652,0,3204,269172,2645,202766,559,66406,811,8,1103,18,0,36,130000.0,39000.0,-70.0,-71.0,-67.0,-60.0,-71.0,-72.0,-68.0,-61.0,-90.0,-93.0,-90.0,-93.0,20.0,22.0,23.0,33.0,0
5656,BA:8C:B9:54:50:24,3829800,488584617,4725,6150763,3825075,482433854,0,8338,1648568,8316,1645073,22,3495,2321,14,5104,36,0,53,216660.0,130000.0,-40.0,-37.0,-45.0,-51.0,-40.0,-36.0,-44.0,-50.0,-90.0,-93.0,-90.0,-93.0,50.0,56.0,45.0,42.0,0
5657,92:69:1D:31:68:E9,3828820,486013315,3743,3579259,3825077,482434056,0,4149,1039343,4033,1013318,116,26025,1999,7,3874,80,0,36,216660.0,130000.0,-52.0,-50.0,-44.0,-46.0,-52.0,-50.0,-44.0,-46.0,-90.0,-93.0,-90.0,-93.0,38.0,43.0,46.0,47.0,0
5658,CC:2F:71:3F:1F:24,4461493,1183008770,636414,700574512,3825079,482434258,37,522093,563929372,521462,563853438,631,75934,504412,10,636651,61533,34,450,144444.0,39000.0,-67.0,-65.0,-71.0,-68.0,-67.0,-65.0,-70.0,-67.0,-90.0,-93.0,-90.0,-93.0,23.0,28.0,19.0,25.0,0
5659,CC:2F:71:3E:C5:1F,3825845,482527944,766,93686,3825079,482434258,0,3204,269172,2645,202766,559,66406,811,8,1103,18,0,36,130000.0,39000.0,-70.0,-71.0,-67.0,-60.0,-71.0,-72.0,-68.0,-61.0,-90.0,-93.0,-90.0,-93.0,20.0,22.0,23.0,33.0,0
5660,BA:8C:B9:54:50:24,3829804,488585021,4725,6150763,3825079,482434258,0,8338,1648568,8316,1645073,22,3495,2321,14,5104,36,0,53,216660.0,130000.0,-40.0,-37.0,-45.0,-51.0,-40.0,-36.0,-44.0,-50.0,-90.0,-93.0,-90.0,-93.0,50.0,56.0,45.0,42.0,0
5661,92:69:1D:31:68:E9,3828822,486013517,3743,3579259,3825079,482434258,0,4149,1039343,4033,1013318,116,26025,1999,7,3874,80,0,36,216660.0,130000.0,-52.0,-50.0,-44.0,-46.0,-52.0,-50.0,-44.0,-46.0,-90.0,-93.0,-90.0,-93.0,38.0,43.0,46.0,47.0,0
5662,CC:2F:71:3F:1F:24,4461534,1183022962,636455,700588704,3825079,482434258,37,522119,563934316,521488,563858382,631,75934,504438,10,636692,61566,34,450,130000.0,43333.0,-67.0,-65.0,-71.0,-68.0,-67.0,-65.0,-70.0,-67.0,-90.0,-93.0,-90.0,-93.0,23.0,28.0,19.0,25.0,0
5663,CC:2F:71:3E:C5:1F,3825845,482527944,766,93686,3825079,482434258,0,3204,269172,2645,202766,559,66406,811,8,1103,18,0,36,130000.0,39000.0,-70.0,-71.0,-67.0,-60.0,-71.0,-72.0,-68.0,-61.0,-90.0,-93.0,-90.0,-93.0,20.0,22.0,23.0,33.0,0
5664,BA:8C:B9:54:50:24,3829808,488585425,4725,6150763,3825083,482434662,0,8338,1648568,8316,1645073,22,3495,2321,14,5104,36,0,53,216660.0,130000.0,-40.0,-37.0,-45.0,-51.0,-40.0,-36.0,-44.0,-50.0,-90.0,-93.0,-90.0,-93.0,50.0,56.0,45.0,42.0,0
5665,92:69:1D:31:68:E9,3828829,486014183,3743,3579259,3825086,482434924,0,4150,1039411,4034,1013386,116,26025,1999,7,3874,80,0,36,216660.0,130000.0,-52.0,-50.0,-44.0,-46.0,-52.0,-50.0,-44.0,-46.0,-90.0,-93.0,-90.0,-93.0,38.0,43.0,46.0,47.0,0
5666,CC:2F:71:3F:1F:24,4461585,1183038314,636497,700603188,3825088,482435126,37,522144,563939120,521513,563863186,631,75934,504463,10,636733,61570,34,450,117000.0,39000.0,-67.0,-65.0,-70.0,-68.0,-67.0,-65.0,-70.0,-67.0,-90.0,-93.0,-90.0,-93.0,23.0,28.0,20.0,25.0,0
5667,CC:2F:71:3E:C5:1F,3825854,482528812,766,93686,3825088,482435126,0,3204,269172,2645,202766,559,66406,811,8,1103,18,0,36,130000.0,39000.0,-70.0,-71.0,-67.0,-60.0,-71.0,-72.0,-68.0,-61.0,-90.0,-93.0,-90.0,-93.0,20.0,22.0,23.0,33.0,0
5668,BA:8C:B9:54:50:24,3829813,488585889,4725,6150763,3825088,482435126,0,8338,1648568,8316,1645073,22,3495,2321,14,5104,36,0,53,216660.0,130000.0,-40.0,-37.0,-45.0,-51.0,-40.0,-36.0,-44.0,-50.0,-90.0,-93.0,-90.0,-93.0,50.0,56.0,45.0,42.0,0
5669,92:69:1D:31:68:E9,3828831,486014385,3743,3579259,3825088,482435126,0,4150,1039411,4034,1013386,116,26025,1999,7,3874,80,0,36,216660.0,130000.0,-52.0,-50.0,-44.0,-46.0,-52.0,-50.0,-44.0,-46.0,-90.0,-93.0,-90.0,-93.0,38.0,43.0,46.0,47.0,0
5670,CC:2F:71:3F:1F:24,4461628,1183052810,636540,700617684,3825088,482435126,37,522171,563944180,521540,563868246,631,75934,504490,10,636777,61581,34,450,130000.0,39000.0,-67.0,-65.0,-70.0,-68.0,-67.0,-65.0,-70.0,-67.0,-90.0,-93.0,-90.0,-93.0,23.0,28.0,20.0,25.0,0
5671,CC:2F:71:3E:C5:1F,3825854,482528812,766,93686,3825088,482435126,0,3204,269172,2645,202766,559,66406,811,8,1103,18,0,36,130000.0,39000.0,-70.0,-71.0,-67.0,-60.0,-71.0,-72.0,-68.0,-61.0,-90.0,-93.0,-90.0,-93.0,20.0,22.0,23.0,33.0,0
5672,BA:8C:B9:54:50:24,3829815,488586091,4725,6150763,3825090,482435328,0,8338,1648568,8316,1645073,22,3495,2321,14,5104,36,0,53,216660.0,130000.0,-40.0,-37.0,-45.0,-51.0,-40.0,-36.0,-44.0,-50.0,-90.0,-93.0,-90.0,-93.0,50.0,56.0,45.0,42.0,0
5673,92:69:1D:31:68:E9,3828837,486014991,3743,3579259,3825094,482435732,0,4150,1039411,4034,1013386,116,26025,1999,7,3874,80,0,36,216660.0,130000.0,-52.0,-50.0,-44.0,-46.0,-52.0,-50.0,-44.0,-46.0,-90.0,-93.0,-90.0,-93.0,38.0,43.0,46.0,47.0,0
5674,CC:2F:71:3F:1F:24,4461678,1183067990,636582,700632056,3825096,482435934,37,522197,563949100,521566,563873166,631,75934,504516,10,636819,61591,34,450,130000.0,43333.0,-67.0,-65.0,-70.0,-67.0,-67.0,-65.0,-70.0,-67.0,-90.0,-93.0,-90.0,-93.0,23.0,28.0,20.0,26.0,0
5675,CC:2F:71:3E:C5:1F,3825863,482529680,766,93686,3825097,482435994,0,3204,269172,2645,202766,559,66406,811,8,1103,18,0,36,130000.0,39000.0,-70.0,-71.0,-67.0,-60.0,-71.0,-72.0,-68.0,-61.0,-90.0,-93.0,-90.0,-93.0,20.0,22.0,23.0,33.0,0
5676,BA:8C:B9:54:50:24,3829822,488586757,4725,6150763,3825097,482435994,0,8338,1648568,8316,1645073,22,3495,2321,14,5104,36,0,53,216660.0,130000.0,-40.0,-37.0,-45.0,-51.0,-40.0,-36.0,-44.0,-50.0,-90.0,-93.0,-90.0,-93.0,50.0,56.0,45.0,42.0,0
5677,92:69:1D:31:68:E9,3828840,486015253,3743,3579259,3825097,482435994,0,4150,1039411,4034,1013386,116,26025,1999,7,3874,80,0,36,216660.0,130000.0,-52.0,-50.0,-44.0,-46.0,-52.0,-50.0,-44.0,-46.0,-90.0,-93.0,-90.0,-93.0,38.0,43.0,46.0,47.0,0
5678,CC:2F:71:3F:1F:24,4461722,1183082594,636625,700646600,3825097,482435994,37,522222,563953904,521591,563877970,631,75934,504541,10,636862,61611,34,450,117000.0,39000.0,-67.0,-65.0,-70.0,-67.0,-67.0,-65.0,-70.0,-67.0,-90.0,-93.0,-90.0,-93.0,23.0,28.0,20.0,26.0,0
5679,CC:2F:71:3E:C5:1F,3825864,482529796,767,93802,3825097,482435994,0,3206,269312,2647,202906,559,66406,811,8,1104,18,0,36,130000.0,39000.0,-70.0,-71.0,-67.0,-60.0,-71.0,-72.0,-68.0,-61.0,-90.0,-93.0,-90.0,-93.0,20.0,22.0,23.0,33.0,0
5680,BA:8C:B9:54:50:24,3829825,488587075,4726,6150879,3825099,482436196,0,8340,1648704,8318,1645209,22,3495,2321,14,5105,36,0,53,216660.0,130000.0,-49.0,-35.0,-42.0,-45.0,-42.0,-36.0,-44.0,-49.0,-90.0,-93.0,-90.0,-93.0,41.0,58.0,48.0,48.0,0
5681,92:69:1D:31:68:E9,3828847,486015975,3744,3579375,3825103,482436600,0,4152,1039547,4036,1013522,116,26025,1999,7,3875,80,0,36,216660.0,130000.0,-51.0,-47.0,-42.0,-48.0,-51.0,-49.0,-43.0,-46.0,-90.0,-93.0,-90.0,-93.0,39.0,46.0,48.0,45.0,0
5682,CC:2F:71:3F:1F:24,4461772,1183097979,636666,700660904,3825106,482437075,37,522247,563958708,521616,563882774,631,75934,504566,10,636903,61612,34,450,130000.0,43333.0,-67.0,-65.0,-70.0,-67.0,-67.0,-65.0,-70.0,-67.0,-90.0,-93.0,-90.0,-93.0,23.0,28.0,20.0,26.0,0
5683,CC:2F:71:3E:C5:1F,3825873,482530877,767,93802,3825106,482437075,0,3206,269312,2647,202906,559,66406,811,8,1104,18,0,36,130000.0,39000.0,-70.0,-71.0,-67.0,-60.0,-71.0,-72.0,-68.0,-61.0,-90.0,-93.0,-90.0,-93.0,20.0,22.0,23.0,33.0,0
5684,BA:8C:B9:54:50:24,3829832,488587954,4726,6150879,3825106,482437075,0,8340,1648704,8318,1645209,22,3495,2321,14,5105,36,0,53,216660.0,130000.0,-49.0,-35.0,-42.0,-45.0,-42.0,-36.0,-44.0,-49.0,-90.0,-93.0,-90.0,-93.0,41.0,58.0,48.0,48.0,0
5685,92:69:1D:31:68:E9,3828851,486016510,3744,3579375,3825107,482437135,0,4152,1039547,4036,1013522,116,26025,1999,7,3875,80,0,36,216660.0,130000.0,-51.0,-47.0,-42.0,-48.0,-51.0,-49.0,-43.0,-46.0,-90.0,-93.0,-90.0,-93.0,39.0,46.0,48.0,45.0,0
5686,CC:2F:71:3F:1F:24,4461816,1183112653,636709,700675518,3825107,482437135,37,522272,563963512,521641,563887578,631,75934,504591,10,636946,61630,34,450,130000.0,39000.0,-67.0,-65.0,-70.0,-68.0,-67.0,-65.0,-70.0,-67.0,-90.0,-93.0,-90.0,-93.0,23.0,28.0,20.0,25.0,0
5687,CC:2F:71:3E:C5:1F,3825874,482530937,767,93802,3825107,482437135,0,3206,269312,2647,202906,559,66406,811,8,1104,18,0,36,130000.0,39000.0,-70.0,-71.0,-67.0,-60.0,-71.0,-72.0,-68.0,-61.0,-90.0,-93.0,-90.0,-93.0,20.0,22.0,23.0,33.0,0
5688,BA:8C:B9:54:50:24,3829835,488588216,4726,6150879,3825109,482437337,0,8340,1648704,8318,1645209,22,3495,2321,14,5105,36,0,53,216660.0,130000.0,-49.0,-35.0,-42.0,-45.0,-42.0,-36.0,-44.0,-49.0,-90.0,-93.0,-90.0,-93.0,41.0,58.0,48.0,48.0,0
5689,92:69:1D:31:68:E9,3828857,486017116,3744,3579375,3825113,482437741,0,4152,1039547,4036,1013522,116,26025,1999,7,3875,80,0,36,216660.0,130000.0,-51.0,-47.0,-42.0,-48.0,-51.0,-49.0,-43.0,-46.0,-90.0,-93.0,-90.0,-93.0,39.0,46.0,48.0,45.0,0
5690,CC:2F:71:3F:1F:24,4461867,1183127957,636752,700690014,3825115,482437943,37,522298,563968456,521667,563892522,631,75934,504617,10,636988,61642,34,450,130000.0,43333.0,-67.0,-65.0,-70.0,-68.0,-67.0,-65.0,-70.0,-67.0,-90.0,-93.0,-90.0,-93.0,23.0,28.0,20.0,25.0,0
5691,CC:2F:71:3E:C5:1F,3825882,482531745,767,93802,3825115,482437943,0,3206,269312,2647,202906,559,66406,811,8,1104,18,0,36,130000.0,39000.0,-70.0,-71.0,-67.0,-60.0,-71.0,-72.0,-68.0,-61.0,-90.0,-93.0,-90.0,-93.0,20.0,22.0,23.0,33.0,0
5692,BA:8C:B9:54:50:24,3829841,488588822,4726,6150879,3825115,482437943,0,8340,1648704,8318,1645209,22,3495,2321,14,5105,36,0,53,216660.0,130000.0,-49.0,-35.0,-42.0,-45.0,-42.0,-36.0,-44.0,-49.0,-90.0,-93.0,-90.0,-93.0,41.0,58.0,48.0,48.0,0
5693,92:69:1D:31:68:E9,3828860,486017380,3744,3579375,3825116,482438005,0,4152,1039547,4036,1013522,116,26025,1999,7,3875,80,0,36,216660.0,130000.0,-51.0,-47.0,-42.0,-48.0,-51.0,-49.0,-43.0,-46.0,-90.0,-93.0,-90.0,-93.0,39.0,46.0,48.0,45.0,0
5694,CC:2F:71:3F:1F:24,4461910,1183142559,636794,700704554,3825116,482438005,37,522324,563973436,521693,563897502,631,75934,504643,10,637031,61648,34,450,130000.0,43333.0,-67.0,-65.0,-71.0,-67.0,-67.0,-65.0,-70.0,-67.0,-90.0,-93.0,-90.0,-93.0,23.0,28.0,19.0,26.0,0
5695,CC:2F:71:3E:C5:1F,3825883,482531807,767,93802,3825116,482438005,0,3208,269500,2648,202976,560,66524,812,8,1104,18,0,37,130000.0,39000.0,-70.0,-71.0,-67.0,-60.0,-71.0,-72.0,-68.0,-61.0,-90.0,-93.0,-90.0,-93.0,20.0,22.0,23.0,33.0,0
5696,BA:8C:B9:54:50:24,3829844,488589086,4726,6150879,3825118,482438207,0,8340,1648704,8318,1645209,22,3495,2321,14,5105,36,0,53,216660.0,130000.0,-49.0,-35.0,-42.0,-45.0,-42.0,-36.0,-44.0,-49.0,-90.0,-93.0,-90.0,-93.0,41.0,58.0,48.0,48.0,0
5697,92:69:1D:31:68:E9,3828869,486018414,3744,3579375,3825125,482439039,0,4152,1039547,4036,1013522,116,26025,1999,7,3875,80,0,36,216660.0,130000.0,-51.0,-47.0,-42.0,-48.0,-51.0,-49.0,-43.0,-46.0,-90.0,-93.0,-90.0,-93.0,39.0,46.0,48.0,45.0,0
5698,CC:2F:71:3F:1F:24,4461964,1183158403,636837,700719162,3825127,482439241,37,522350,563978380,521719,563902446,631,75934,504669,10,637074,61658,34,450,130000.0,39000.0,-67.0,-65.0,-70.0,-67.0,-67.0,-65.0,-70.0,-67.0,-90.0,-93.0,-90.0,-93.0,23.0,28.0,20.0,26.0,0
5699,CC:2F:71:3E:C5:1F,3825894,482533043,767,93802,3825127,482439241,0,3208,269500,2648,202976,560,66524,812,8,1104,18,0,37,130000.0,39000.0,-70.0,-71.0,-67.0,-60.0,-71.0,-72.0,-68.0,-61.0,-90.0,-93.0,-90.0,-93.0,20.0,22.0,23.0,33.0,0
5700,BA:8C:B9:54:50:24,3829853,488590120,4726,6150879,3825127,482439241,0,8340,1648704,8318,1645209,22,3495,2321,14,5105,36,0,53,216660.0,130000.0,-49.0,-35.0,-42.0,-45.0,-42.0,-36.0,-44.0,-49.0,-90.0,-93.0,-90.0,-93.0,41.0,58.0,48.0,48.0,0
5701,92:69:1D:31:68:E9,3828871,486018616,3744,3579375,3825127,482439241,0,4154,1039683,4038,1013658,116,26025,1999,7,3876,80,0,36,216660.0,130000.0,-52.0,-50.0,-45.0,-46.0,-51.0,-49.0,-43.0,-46.0,-90.0,-93.0,-90.0,-93.0,38.0,43.0,45.0,47.0,0
5702,CC:2F:71:3F:1F:24,4462006,1183172831,636879,700733590,3825127,482439241,37,522378,563983592,521747,563907658,631,75934,504697,10,637116,61672,34,450,130000.0,39000.0,-67.0,-65.0,-71.0,-67.0,-67.0,-65.0,-70.0,-67.0,-90.0,-93.0,-90.0,-93.0,23.0,28.0,19.0,26.0,0
5703,CC:2F:71:3E:C5:1F,3825894,482533043,767,93802,3825127,482439241,0,3208,269500,2648,202976,560,66524,812,8,1104,18,0,37,130000.0,39000.0,-70.0,-71.0,-67.0,-60.0,-71.0,-72.0,-68.0,-61.0,-90.0,-93.0,-90.0,-93.0,20.0,22.0,23.0,33.0,0
5704,BA:8C:B9:54:50:24,3829853,488590120,4726,6150879,3825127,482439241,0,8342,1648840,8320,1645345,22,3495,2321,14,5106,36,0,53,216660.0,130000.0,-40.0,-37.0,-45.0,-52.0,-41.0,-36.0,-44.0,-50.0,-90.0,-93.0,-90.0,-93.0,50.0,56.0,45.0,41.0,0
5705,92:69:1D:31:68:E9,3828877,486019222,3744,3579375,3825133,482439847,0,4154,1039683,4038,1013658,116,26025,1999,7,3876,80,0,36,216660.0,130000.0,-52.0,-50.0,-45.0,-46.0,-51.0,-49.0,-43.0,-46.0,-90.0,-93.0,-90.0,-93.0,38.0,43.0,45.0,47.0,0
5706,CC:2F:71:3F:1F:24,4462056,1183188123,636922,700748142,3825134,482439981,37,522403,563988396,521772,563912462,631,75934,504722,10,637159,61688,34,450,144444.0,39000.0,-67.0,-65.0,-70.0,-67.0,-67.0,-65.0,-70.0,-67.0,-90.0,-93.0,-90.0,-93.0,23.0,28.0,20.0,26.0,0
5707,CC:2F:71:3E:C5:1F,3825902,482533843,767,93802,3825135,482440041,0,3208,269500,2648,202976,560,66524,812,8,1104,18,0,37,130000.0,39000.0,-70.0,-71.0,-67.0,-60.0,-71.0,-72.0,-68.0,-61.0,-90.0,-93.0,-90.0,-93.0,20.0,22.0,23.0,33.0,0
5708,BA:8C:B9:54:50:24,3829862,488590988,4726,6150879,3825136,482440109,0,8342,1648840,8320,1645345,22,3495,2321,14,5106,36,0,53,216660.0,130000.0,-40.0,-37.0,-45.0,-52.0,-41.0,-36.0,-44.0,-50.0,-90.0,-93.0,-90.0,-93.0,50.0,56.0,45.0,41.0,0
5709,92:69:1D:31:68:E9,3828880,486019484,3744,3579375,3825136,482440109,0,4154,1039683,4038,1013658,116,26025,1999,7,3876,80,0,36,216660.0,130000.0,-52.0,-50.0,-45.0,-46.0,-51.0,-49.0,-43.0,-46.0,-90.0,-93.0,-90.0,-93.0,38.0,43.0,45.0,47.0,0
5710,CC:2F:71:3F:1F:24,4462099,1183202443,636963,700762334,3825136,482440109,37,522429,563993340,521798,563917406,631,75934,504748,10,637200,61725,34,450,144444.0,43333.0,-67.0,-65.0,-70.0,-67.0,-67.0,-65.0,-70.0,-67.0,-90.0,-93.0,-90.0,-93.0,23.0,28.0,20.0,26.0,0
5711,CC:2F:71:3E:C5:1F,3825903,482533911,767,93802,3825136,482440109,0,3208,269500,2648,202976,560,66524,812,8,1104,18,0,37,130000.0,39000.0,-70.0,-71.0,-67.0,-60.0,-71.0,-72.0,-68.0,-61.0,-90.0,-93.0,-90.0,-93.0,20.0,22.0,23.0,33.0,0
5712,BA:8C:B9:54:50:24,3829862,488590988,4726,6150879,3825136,482440109,0,8342,1648840,8320,1645345,22,3495,2321,14,5106,36,0,53,216660.0,130000.0,-40.0,-37.0,-45.0,-52.0,-41.0,-36.0,-44.0,-50.0,-90.0,-93.0,-90.0,-93.0,50.0,56.0,45.0,41.0,0
5713,92:69:1D:31:68:E9,3828886,486020090,3744,3579375,3825142,482440715,0,4154,1039683,4038,1013658,116,26025,1999,7,3876,80,0,36,216660.0,130000.0,-52.0,-50.0,-45.0,-46.0,-51.0,-49.0,-43.0,-46.0,-90.0,-93.0,-90.0,-93.0,38.0,43.0,45.0,47.0,0
5714,CC:2F:71:3F:1F:24,4462146,1183217403,637004,700776688,3825142,482440715,37,522454,563998144,521823,563922210,631,75934,504773,10,637241,61758,34,450,130000.0,39000.0,-67.0,-65.0,-70.0,-67.0,-67.0,-65.0,-70.0,-67.0,-90.0,-93.0,-90.0,-93.0,23.0,28.0,20.0,26.0,0
5715,CC:2F:71:3E:C5:1F,3825909,482534517,767,93802,3825142,482440715,0,3208,269500,2648,202976,560,66524,812,8,1104,18,0,37,130000.0,39000.0,-70.0,-71.0,-67.0,-60.0,-71.0,-72.0,-68.0,-61.0,-90.0,-93.0,-90.0,-93.0,20.0,22.0,23.0,33.0,0
5716,BA:8C:B9:54:50:24,3829870,488591796,4726,6150879,3825144,482440917,0,8342,1648840,8320,1645345,22,3495,2321,14,5106,36,0,53,216660.0,130000.0,-40.0,-37.0,-45.0,-52.0,-41.0,-36.0,-44.0,-50.0,-90.0,-93.0,-90.0,-93.0,50.0,56.0,45.0,41.0,0
5717,92:69:1D:31:68:E9,3828889,486020352,3744,3579375,3825145,482440977,0,4154,1039683,4038,1013658,116,26025,1999,7,3876,80,0,36,216660.0,130000.0,-52.0,-50.0,-45.0,-46.0,-51.0,-49.0,-43.0,-46.0,-90.0,-93.0,-90.0,-93.0,38.0,43.0,45.0,47.0,0
5718,CC:2F:71:3F:1F:24,4462190,1183231969,637045,700790992,3825145,482440977,37,522480,564003088,521849,563927154,631,75934,504799,10,637282,61799,34,450,144444.0,43333.0,-67.0,-65.0,-70.0,-68.0,-67.0,-65.0,-70.0,-67.0,-90.0,-93.0,-90.0,-93.0,23.0,28.0,20.0,25.0,0
5719,CC:2F:71:3E:C5:1F,3825912,482534779,767,93802,3825145,482440977,0,3208,269500,2648,202976,560,66524,812,8,1104,18,0,37,130000.0,39000.0,-70.0,-71.0,-67.0,-60.0,-71.0,-72.0,-68.0,-61.0,-90.0,-93.0,-90.0,-93.0,20.0,22.0,23.0,33.0,0
5720,BA:8C:B9:54:50:24,3829871,488591856,4726,6150879,3825145,482440977,0,8342,1648840,8320,1645345,22,3495,2321,14,5106,36,0,53,216660.0,130000.0,-40.0,-37.0,-45.0,-52.0,-41.0,-36.0,-44.0,-50.0,-90.0,-93.0,-90.0,-93.0,50.0,56.0,45.0,41.0,0
5721,92:69:1D:31:68:E9,3828895,486020958,3744,3579375,3825151,482441583,0,4154,1039683,4038,1013658,116,26025,1999,7,3876,80,0,36,216660.0,130000.0,-52.0,-50.0,-45.0,-46.0,-51.0,-49.0,-43.0,-46.0,-90.0,-93.0,-90.0,-93.0,38.0,43.0,45.0,47.0,0
5722,CC:2F:71:3F:1F:24,4462238,1183247059,637087,700805476,3825151,482441583,37,522508,564008264,521877,563932330,631,75934,504827,10,637324,61841,34,450,130000.0,39000.0,-67.0,-65.0,-71.0,-67.0,-67.0,-65.0,-70.0,-67.0,-90.0,-93.0,-90.0,-93.0,23.0,28.0,19.0,26.0,0
5723,CC:2F:71:3E:C5:1F,3825918,482535385,767,93802,3825151,482441583,0,3208,269500,2648,202976,560,66524,812,8,1104,18,0,37,130000.0,39000.0,-70.0,-71.0,-67.0,-60.0,-71.0,-72.0,-68.0,-61.0,-90.0,-93.0,-90.0,-93.0,20.0,22.0,23.0,33.0,0
5724,BA:8C:B9:54:50:24,3829877,488592462,4726,6150879,3825151,482441583,0,8342,1648840,8320,1645345,22,3495,2321,14,5106,36,0,53,216660.0,130000.0,-40.0,-37.0,-45.0,-52.0,-41.0,-36.0,-44.0,-50.0,-90.0,-93.0,-90.0,-93.0,50.0,56.0,45.0,41.0,0
5725,92:69:1D:31:68:E9,3828897,486021160,3744,3579375,3825153,482441785,0,4154,1039683,4038,1013658,116,26025,1999,7,3876,80,0,36,216660.0,130000.0,-52.0,-50.0,-45.0,-46.0,-51.0,-49.0,-43.0,-46.0,-90.0,-93.0,-90.0,-93.0,38.0,43.0,45.0,47.0,0
5726,CC:2F:71:3F:1F:24,4462284,1183261881,637131,700820096,3825153,482441785,37,522534,564013208,521903,563937274,631,75934,504853,10,637368,61847,34,450,130000.0,43333.0,-67.0,-65.0,-70.0,-67.0,-67.0,-65.0,-70.0,-67.0,-90.0,-93.0,-90.0,-93.0,23.0,28.0,20.0,26.0,0
5727,CC:2F:71:3E:C5:1F,3825920,482535587,767,93802,3825153,482441785,0,3208,269500,2648,202976,560,66524,812,8,1104,18,0,37,130000.0,39000.0,-70.0,-71.0,-67.0,-60.0,-71.0,-72.0,-68.0,-61.0,-90.0,-93.0,-90.0,-93.0,20.0,22.0,23.0,33.0,0
5728,BA:8C:B9:54:50:24,3829879,488592664,4726,6150879,3825153,482441785,0,8342,1648840,8320,1645345,22,3495,2321,14,5106,36,0,53,216660.0,130000.0,-40.0,-37.0,-45.0,-52.0,-41.0,-36.0,-44.0,-50.0,-90.0,-93.0,-90.0,-93.0,50.0,56.0,45.0,41.0,0
5729,92:69:1D:31:68:E9,3828905,486021888,3744,3579375,3825161,482442513,0,4154,1039683,4038,1013658,116,26025,1999,7,3876,80,0,36,216660.0,130000.0,-52.0,-50.0,-45.0,-46.0,-51.0,-49.0,-43.0,-46.0,-90.0,-93.0,-89.0,-93.0,38.0,43.0,44.0,47.0,0
5730,CC:2F:71:3F:1F:24,4462334,1183277149,637173,700834636,3825161,482442513,37,522560,564018130,521928,563942078,632,76052,504879,10,637410,61850,34,450,130000.0,43333.0,-67.0,-65.0,-70.0,-68.0,-67.0,-65.0,-70.0,-67.0,-90.0,-93.0,-89.0,-93.0,23.0,28.0,19.0,25.0,0
5731,CC:2F:71:3E:C5:1F,3825928,482536315,767,93802,3825161,482442513,0,3208,269500,2648,202976,560,66524,812,8,1104,18,0,37,130000.0,39000.0,-70.0,-71.0,-67.0,-60.0,-71.0,-72.0,-68.0,-61.0,-90.0,-93.0,-89.0,-93.0,20.0,22.0,22.0,33.0,0
5732,BA:8C:B9:54:50:24,3829887,488593392,4726,6150879,3825161,482442513,0,8342,1648840,8320,1645345,22,3495,2321,14,5106,36,0,53,216660.0,130000.0,-40.0,-37.0,-45.0,-52.0,-41.0,-36.0,-44.0,-50.0,-90.0,-93.0,-89.0,-93.0,50.0,56.0,44.0,41.0,0
5733,92:69:1D:31:68:E9,3828907,486022090,3744,3579375,3825163,482442715,0,4154,1039683,4038,1013658,116,26025,1999,7,3876,80,0,36,216660.0,130000.0,-52.0,-50.0,-45.0,-46.0,-51.0,-49.0,-43.0,-46.0,-90.0,-93.0,-89.0,-93.0,38.0,43.0,44.0,47.0,0
5734,CC:2F:71:3F:1F:24,4462376,1183291587,637213,700848872,3825163,482442715,37,522587,564023190,521955,563947138,632,76052,504906,10,637450,61856,34,450,117000.0,39000.0,-67.0,-65.0,-70.0,-68.0,-67.0,-65.0,-70.0,-67.0,-90.0,-93.0,-89.0,-93.0,23.0,28.0,19.0,25.0,0
5735,CC:2F:71:3E:C5:1F,3825930,482536517,767,93802,3825163,482442715,0,3208,269500,2648,202976,560,66524,812,8,1104,18,0,37,130000.0,39000.0,-70.0,-71.0,-67.0,-60.0,-71.0,-72.0,-68.0,-61.0,-90.0,-93.0,-89.0,-93.0,20.0,22.0,22.0,33.0,0
5736,BA:8C:B9:54:50:24,3829890,488593867,4726,6150879,3825164,482442988,0,8342,1648840,8320,1645345,22,3495,2321,14,5106,36,0,53,216660.0,130000.0,-40.0,-37.0,-45.0,-52.0,-41.0,-36.0,-44.0,-50.0,-90.0,-93.0,-89.0,-93.0,50.0,56.0,44.0,41.0,0
5737,92:69:1D:31:68:E9,3828915,486023029,3744,3579375,3825171,482443654,0,4154,1039683,4038,1013658,116,26025,1999,7,3876,80,0,36,216660.0,130000.0,-52.0,-50.0,-45.0,-46.0,-51.0,-49.0,-43.0,-46.0,-90.0,-93.0,-90.0,-93.0,38.0,43.0,45.0,47.0,0
5738,CC:2F:71:3F:1F:24,4462427,1183306966,637256,700863312,3825171,482443654,37,522612,564027994,521980,563951942,632,76052,504931,10,637493,61872,34,450,117000.0,39000.0,-67.0,-65.0,-70.0,-68.0,-67.0,-65.0,-70.0,-67.0,-90.0,-93.0,-90.0,-93.0,23.0,28.0,20.0,25.0,0
5739,CC:2F:71:3E:C5:1F,3825938,482537456,767,93802,3825171,482443654,0,3208,269500,2648,202976,560,66524,812,8,1104,18,0,37,130000.0,39000.0,-70.0,-71.0,-67.0,-60.0,-71.0,-72.0,-68.0,-61.0,-90.0,-93.0,-90.0,-93.0,20.0,22.0,23.0,33.0,0
5740,BA:8C:B9:54:50:24,3829897,488594533,4726,6150879,3825171,482443654,0,8343,1648908,8321,1645413,22,3495,2321,14,5106,36,0,53,216660.0,130000.0,-39.0,-37.0,-44.0,-53.0,-41.0,-36.0,-44.0,-50.0,-90.0,-93.0,-90.0,-93.0,51.0,56.0,46.0,40.0,0
5741,92:69:1D:31:68:E9,3828917,486023231,3744,3579375,3825173,482443856,0,4154,1039683,4038,1013658,116,26025,1999,7,3876,80,0,36,216660.0,130000.0,-52.0,-50.0,-45.0,-46.0,-51.0,-49.0,-43.0,-46.0,-90.0,-93.0,-90.0,-93.0,38.0,43.0,45.0,47.0,0
5742,CC:2F:71:3F:1F:24,4462471,1183321596,637298,700877740,3825173,482443856,37,522638,564032938,522006,563956886,632,76052,504957,10,637535,61882,34,450,130000.0,43333.0,-67.0,-65.0,-70.0,-67.0,-67.0,-65.0,-70.0,-67.0,-90.0,-93.0,-90.0,-93.0,23.0,28.0,20.0,26.0,0
5743,CC:2F:71:3E:C5:1F,3825940,482537658,767,93802,3825173,482443856,0,3208,269500,2648,202976,560,66524,812,8,1104,18,0,37,130000.0,39000.0,-70.0,-71.0,-67.0,-60.0,-71.0,-72.0,-68.0,-61.0,-90.0,-93.0,-90.0,-93.0,20.0,22.0,23.0,33.0,0
5744,BA:8C:B9:54:50:24,3829899,488594735,4726,6150879,3825173,482443856,0,8343,1648908,8321,1645413,22,3495,2321,14,5106,36,0,53,216660.0,130000.0,-39.0,-37.0,-44.0,-53.0,-41.0,-36.0,-44.0,-50.0,-90.0,-93.0,-90.0,-93.0,51.0,56.0,46.0,40.0,0
5745,92:69:1D:31:68:E9,3828923,486023837,3744,3579375,3825179,482444462,0,4154,1039683,4038,1013658,116,26025,1999,7,3876,80,0,36,216660.0,130000.0,-52.0,-50.0,-45.0,-46.0,-51.0,-49.0,-43.0,-46.0,-90.0,-93.0,-90.0,-93.0,38.0,43.0,45.0,47.0,0
5746,CC:2F:71:3F:1F:24,4462520,1183336698,637341,700892236,3825179,482444462,37,522665,564037998,522033,563961946,632,76052,504984,10,637578,61897,34,450,130000.0,39000.0,-67.0,-65.0,-70.0,-68.0,-67.0,-65.0,-70.0,-67.0,-90.0,-93.0,-90.0,-93.0,23.0,28.0,20.0,25.0,0
5747,CC:2F:71:3E:C5:1F,3825946,482538264,767,93802,3825179,482444462,0,3208,269500,2648,202976,560,66524,812,8,1104,18,0,37,130000.0,39000.0,-70.0,-71.0,-67.0,-60.0,-71.0,-72.0,-68.0,-61.0,-90.0,-93.0,-90.0,-93.0,20.0,22.0,23.0,33.0,0
5748,BA:8C:B9:54:50:24,3829905,488595341,4726,6150879,3825179,482444462,0,8343,1648908,8321,1645413,22,3495,2321,14,5106,36,0,53,216660.0,130000.0,-39.0,-37.0,-44.0,-53.0,-41.0,-36.0,-44.0,-50.0,-90.0,-93.0,-90.0,-93.0,51.0,56.0,46.0,40.0,0
5749,92:69:1D:31:68:E9,3828926,486024099,3744,3579375,3825182,482444724,0,4154,1039683,4038,1013658,116,26025,1999,7,3876,80,0,36,216660.0,130000.0,-52.0,-50.0,-45.0,-46.0,-51.0,-49.0,-43.0,-46.0,-90.0,-93.0,-90.0,-93.0,38.0,43.0,45.0,47.0,0
5750,CC:2F:71:3F:1F:24,4462564,1183351208,637382,700906484,3825182,482444724,37,522690,564042802,522058,563966750,632,76052,505009,10,637619,61915,34,450,117000.0,39000.0,-67.0,-65.0,-70.0,-68.0,-67.0,-65.0,-70.0,-67.0,-90.0,-93.0,-90.0,-93.0,23.0,28.0,20.0,25.0,0
5751,CC:2F:71:3E:C5:1F,3825949,482538526,767,93802,3825182,482444724,0,3208,269500,2648,202976,560,66524,812,8,1104,18,0,37,130000.0,39000.0,-70.0,-71.0,-67.0,-60.0,-71.0,-72.0,-68.0,-61.0,-90.0,-93.0,-90.0,-93.0,20.0,22.0,23.0,33.0,0
5752,BA:8C:B9:54:50:24,3829908,488595603,4726,6150879,3825182,482444724,0,8343,1648908,8321,1645413,22,3495,2321,14,5106,36,0,53,216660.0,130000.0,-39.0,-37.0,-44.0,-53.0,-41.0,-36.0,-44.0,-50.0,-90.0,-93.0,-90.0,-93.0,51.0,56.0,46.0,40.0,0
5753,92:69:1D:31:68:E9,3828932,486024705,3744,3579375,3825188,482445330,0,4154,1039683,4038,1013658,116,26025,1999,7,3876,80,0,36,216660.0,130000.0,-52.0,-50.0,-45.0,-46.0,-51.0,-49.0,-43.0,-46.0,-90.0,-93.0,-90.0,-93.0,38.0,43.0,45.0,47.0,0
5754,CC:2F:71:3F:1F:24,4462613,1183366366,637425,700921036,3825188,482445330,37,522718,564048002,522086,563971950,632,76052,505037,10,637662,61916,34,450,130000.0,43333.0,-67.0,-65.0,-70.0,-67.0,-67.0,-65.0,-70.0,-67.0,-90.0,-93.0,-90.0,-93.0,23.0,28.0,20.0,26.0,0
5755,CC:2F:71:3E:C5:1F,3825955,482539132,767,93802,3825188,482445330,0,3208,269500,2648,202976,560,66524,812,8,1104,18,0,37,130000.0,39000.0,-70.0,-71.0,-67.0,-60.0,-71.0,-72.0,-68.0,-61.0,-90.0,-93.0,-90.0,-93.0,20.0,22.0,23.0,33.0,0
5756,BA:8C:B9:54:50:24,3829914,488596209,4726,6150879,3825188,482445330,0,8343,1648908,8321,1645413,22,3495,2321,14,5106,36,0,53,216660.0,130000.0,-39.0,-37.0,-44.0,-53.0,-41.0,-36.0,-44.0,-50.0,-90.0,-93.0,-90.0,-93.0,51.0,56.0,46.0,40.0,0
5757,92:69:1D:31:68:E9,3828934,486024907,3744,3579375,3825190,482445532,0,4154,1039683,4038,1013658,116,26025,1999,7,3876,80,0,36,216660.0,130000.0,-52.0,-50.0,-45.0,-46.0,-51.0,-49.0,-43.0,-46.0,-90.0,-93.0,-90.0,-93.0,38.0,43.0,45.0,47.0,0
5758,CC:2F:71:3F:1F:24,4462657,1183381138,637467,700935606,3825190,482445532,37,522745,564053050,522113,563976998,632,76052,505064,10,637704,61921,34,450,130000.0,43333.0,-67.0,-65.0,-71.0,-67.0,-67.0,-65.0,-70.0,-67.0,-90.0,-93.0,-90.0,-93.0,23.0,28.0,19.0,26.0,0
5759,CC:2F:71:3E:C5:1F,3825957,482539334,767,93802,3825190,482445532,0,3208,269500,2648,202976,560,66524,812,8,1104,18,0,37,130000.0,39000.0,-70.0,-71.0,-67.0,-60.0,-71.0,-72.0,-68.0,-61.0,-90.0,-93.0,-90.0,-93.0,20.0,22.0,23.0,33.0,0
5760,BA:8C:B9:54:50:24,3829916,488596411,4726,6150879,3825190,482445532,0,8343,1648908,8321,1645413,22,3495,2321,14,5106,36,0,53,216660.0,130000.0,-39.0,-37.0,-44.0,-53.0,-41.0,-36.0,-44.0,-50.0,-90.0,-93.0,-90.0,-93.0,51.0,56.0,46.0,40.0,0
5761,92:69:1D:31:68:E9,3828941,486025573,3744,3579375,3825197,482446198,0,4154,1039683,4038,1013658,116,26025,1999,7,3876,80,0,36,216660.0,130000.0,-52.0,-50.0,-45.0,-46.0,-51.0,-49.0,-43.0,-46.0,-90.0,-93.0,-90.0,-93.0,38.0,43.0,45.0,47.0,0
5762,CC:2F:71:3F:1F:24,4462706,1183396232,637509,700950034,3825197,482446198,37,522770,564057854,522138,563981802,632,76052,505089,10,637746,61946,34,450,117000.0,39000.0,-67.0,-65.0,-71.0,-67.0,-67.0,-65.0,-70.0,-67.0,-90.0,-93.0,-90.0,-93.0,23.0,28.0,19.0,26.0,0
5763,CC:2F:71:3E:C5:1F,3825964,482540000,767,93802,3825197,482446198,0,3208,269500,2648,202976,560,66524,812,8,1104,18,0,37,130000.0,39000.0,-70.0,-71.0,-67.0,-60.0,-71.0,-72.0,-68.0,-61.0,-90.0,-93.0,-90.0,-93.0,20.0,22.0,23.0,33.0,0
5764,BA:8C:B9:54:50:24,3829923,488597077,4726,6150879,3825197,482446198,0,8343,1648908,8321,1645413,22,3495,2321,14,5106,36,0,53,216660.0,130000.0,-39.0,-37.0,-44.0,-53.0,-41.0,-36.0,-44.0,-50.0,-90.0,-93.0,-90.0,-93.0,51.0,56.0,46.0,40.0,0
5765,92:69:1D:31:68:E9,3828943,486025775,3744,3579375,3825199,482446400,0,4154,1039683,4038,1013658,116,26025,1999,7,3876,80,0,36,216660.0,130000.0,-52.0,-50.0,-45.0,-46.0,-51.0,-49.0,-43.0,-46.0,-90.0,-93.0,-90.0,-93.0,38.0,43.0,45.0,47.0,0
5766,CC:2F:71:3F:1F:24,4462751,1183410986,637552,700964586,3825199,482446400,37,522795,564062658,522163,563986606,632,76052,505114,10,637789,61950,34,450,130000.0,43333.0,-67.0,-65.0,-71.0,-67.0,-67.0,-65.0,-70.0,-67.0,-90.0,-93.0,-90.0,-93.0,23.0,28.0,19.0,26.0,0
5767,CC:2F:71:3E:C5:1F,3825966,482540202,767,93802,3825199,482446400,0,3208,269500,2648,202976,560,66524,812,8,1104,18,0,37,130000.0,39000.0,-70.0,-71.0,-67.0,-60.0,-71.0,-72.0,-68.0,-61.0,-90.0,-93.0,-90.0,-93.0,20.0,22.0,23.0,33.0,0
5768,BA:8C:B9:54:50:24,3829925,488597279,4726,6150879,3825199,482446400,0,8343,1648908,8321,1645413,22,3495,2321,14,5106,36,0,53,216660.0,130000.0,-39.0,-37.0,-44.0,-53.0,-41.0,-36.0,-44.0,-50.0,-90.0,-93.0,-90.0,-93.0,51.0,56.0,46.0,40.0,0
5769,92:69:1D:31:68:E9,3828950,486026441,3744,3579375,3825206,482447066,0,4154,1039683,4038,1013658,116,26025,1999,7,3876,80,0,36,216660.0,130000.0,-52.0,-50.0,-45.0,-46.0,-51.0,-49.0,-43.0,-46.0,-90.0,-93.0,-90.0,-93.0,38.0,43.0,45.0,47.0,0
5770,CC:2F:71:3F:1F:24,4462799,1183425956,637593,700978890,3825206,482447066,37,522821,564067602,522189,563991550,632,76052,505140,10,637830,61966,34,450,117000.0,39000.0,-67.0,-65.0,-70.0,-67.0,-67.0,-65.0,-70.0,-67.0,-90.0,-93.0,-90.0,-93.0,23.0,28.0,20.0,26.0,0
5771,CC:2F:71:3E:C5:1F,3825973,482540868,767,93802,3825206,482447066,0,3208,269500,2648,202976,560,66524,812,8,1104,18,0,37,130000.0,39000.0,-70.0,-71.0,-67.0,-60.0,-71.0,-72.0,-68.0,-61.0,-90.0,-93.0,-90.0,-93.0,20.0,22.0,23.0,33.0,0
5772,BA:8C:B9:54:50:24,3829932,488597945,4726,6150879,3825206,482447066,0,8343,1648908,8321,1645413,22,3495,2321,14,5106,36,0,53,216660.0,130000.0,-39.0,-37.0,-44.0,-53.0,-41.0,-36.0,-44.0,-50.0,-90.0,-93.0,-90.0,-93.0,51.0,56.0,46.0,40.0,0
5773,92:69:1D:31:68:E9,3828952,486026643,3744,3579375,3825208,482447268,0,4154,1039683,4038,1013658,116,26025,1999,7,3876,80,0,36,216660.0,130000.0,-52.0,-50.0,-45.0,-46.0,-51.0,-49.0,-43.0,-46.0,-90.0,-93.0,-90.0,-93.0,38.0,43.0,45.0,47.0,0
5774,CC:2F:71:3F:1F:24,4462844,1183440710,637636,700993442,3825208,482447268,37,522846,564072406,522214,563996354,632,76052,505165,10,637873,61967,34,450,130000.0,43333.0,-67.0,-65.0,-70.0,-67.0,-67.0,-65.0,-70.0,-67.0,-90.0,-93.0,-90.0,-93.0,23.0,28.0,20.0,26.0,0
5775,CC:2F:71:3E:C5:1F,3825975,482541070,767,93802,3825208,482447268,0,3208,269500,2648,202976,560,66524,812,8,1104,18,0,37,130000.0,39000.0,-70.0,-71.0,-67.0,-60.0,-71.0,-72.0,-68.0,-61.0,-90.0,-93.0,-90.0,-93.0,20.0,22.0,23.0,33.0,0
5776,BA:8C:B9:54:50:24,3829934,488598147,4726,6150879,3825208,482447268,0,8343,1648908,8321,1645413,22,3495,2321,14,5106,36,0,53,216660.0,130000.0,-39.0,-37.0,-44.0,-53.0,-41.0,-36.0,-44.0,-50.0,-90.0,-93.0,-90.0,-93.0,51.0,56.0,46.0,40.0,0
5777,92:69:1D:31:68:E9,3828958,486027249,3744,3579375,3825214,482447874,0,4154,1039683,4038,1013658,116,26025,1999,7,3876,80,0,36,216660.0,130000.0,-52.0,-50.0,-45.0,-46.0,-51.0,-49.0,-43.0,-46.0,-90.0,-93.0,-90.0,-93.0,38.0,43.0,45.0,47.0,0
5778,CC:2F:71:3F:1F:24,4462893,1183455980,637679,701008106,3825214,482447874,37,522873,564077502,522241,564001450,632,76052,505192,10,637915,61969,34,450,130000.0,43333.0,-67.0,-65.0,-70.0,-68.0,-67.0,-65.0,-70.0,-67.0,-90.0,-93.0,-90.0,-93.0,23.0,28.0,20.0,25.0,0
5779,CC:2F:71:3E:C5:1F,3825981,482541676,767,93802,3825214,482447874,0,3208,269500,2648,202976,560,66524,812,8,1104,18,0,37,130000.0,39000.0,-70.0,-71.0,-67.0,-60.0,-71.0,-72.0,-68.0,-61.0,-90.0,-93.0,-90.0,-93.0,20.0,22.0,23.0,33.0,0
5780,BA:8C:B9:54:50:24,3829940,488598753,4726,6150879,3825214,482447874,0,8343,1648908,8321,1645413,22,3495,2321,14,5106,36,0,53,216660.0,130000.0,-39.0,-37.0,-44.0,-53.0,-41.0,-36.0,-44.0,-50.0,-90.0,-93.0,-90.0,-93.0,51.0,56.0,46.0,40.0,0
5781,92:69:1D:31:68:E9,3828961,486027511,3744,3579375,3825217,482448136,0,4154,1039683,4038,1013658,116,26025,1999,7,3876,80,0,36,216660.0,130000.0,-52.0,-50.0,-45.0,-46.0,-51.0,-49.0,-43.0,-46.0,-90.0,-93.0,-89.0,-92.0,38.0,43.0,44.0,46.0,0
5782,CC:2F:71:3F:1F:24,4462938,1183470670,637721,701022534,3825217,482448136,37,522900,564082586,522268,564006534,632,76052,505219,10,637958,61989,34,450,117000.0,39000.0,-67.0,-65.0,-70.0,-68.0,-67.0,-65.0,-70.0,-67.0,-90.0,-93.0,-89.0,-92.0,23.0,28.0,19.0,24.0,0
5783,CC:2F:71:3E:C5:1F,3825984,482541938,767,93802,3825217,482448136,0,3208,269500,2648,202976,560,66524,812,8,1104,18,0,37,130000.0,39000.0,-70.0,-71.0,-67.0,-60.0,-71.0,-72.0,-68.0,-61.0,-90.0,-93.0,-89.0,-92.0,20.0,22.0,22.0,32.0,0
5784,BA:8C:B9:54:50:24,3829943,488599015,4726,6150879,3825217,482448136,0,8344,1648976,8322,1645481,22,3495,2321,14,5106,36,0,53,216660.0,130000.0,-49.0,-35.0,-42.0,-44.0,-42.0,-36.0,-44.0,-49.0,-90.0,-93.0,-89.0,-92.0,41.0,58.0,47.0,48.0,0
5785,92:69:1D:31:68:E9,3828968,486028233,3745,3579491,3825223,482448742,0,4156,1039819,4040,1013794,116,26025,1999,7,3877,80,0,36,216660.0,130000.0,-52.0,-50.0,-44.0,-46.0,-51.0,-48.0,-43.0,-46.0,-90.0,-93.0,-89.0,-92.0,38.0,43.0,45.0,46.0,0
5786,CC:2F:71:3F:1F:24,4462988,1183485944,637765,701037202,3825223,482448742,37,522926,564087530,522294,564011478,632,76052,505245,10,638002,61994,34,450,130000.0,43333.0,-67.0,-65.0,-70.0,-67.0,-67.0,-65.0,-70.0,-67.0,-90.0,-93.0,-89.0,-92.0,23.0,28.0,19.0,25.0,0
5787,CC:2F:71:3E:C5:1F,3825991,482542660,768,93918,3825223,482448742,0,3210,269640,2650,203116,560,66524,812,8,1105,18,0,37,130000.0,39000.0,-70.0,-71.0,-67.0,-60.0,-70.0,-70.0,-67.0,-60.0,-90.0,-93.0,-89.0,-92.0,20.0,22.0,22.0,32.0,0
5788,BA:8C:B9:54:50:24,3829950,488599737,4727,6150995,3825223,482448742,0,8348,1649248,8326,1645753,22,3495,2321,14,5107,36,0,53,216660.0,130000.0,-49.0,-35.0,-42.0,-45.0,-43.0,-35.0,-42.0,-47.0,-90.0,-93.0,-89.0,-92.0,41.0,58.0,47.0,47.0,0
5789,92:69:1D:31:68:E9,3828971,486028708,3745,3579491,3825226,482449217,0,4156,1039819,4040,1013794,116,26025,1999,7,3877,80,0,36,216660.0,130000.0,-52.0,-50.0,-44.0,-46.0,-51.0,-48.0,-43.0,-46.0,-90.0,-93.0,-89.0,-92.0,38.0,43.0,45.0,46.0,0
5790,CC:2F:71:3F:1F:24,4463032,1183500723,637806,701051506,3825226,482449217,37,522951,564092334,522319,564016282,632,76052,505270,10,638043,62016,34,450,117000.0,39000.0,-67.0,-65.0,-70.0,-67.0,-67.0,-65.0,-70.0,-67.0,-90.0,-93.0,-89.0,-92.0,23.0,28.0,19.0,25.0,0
5791,CC:2F:71:3E:C5:1F,3825994,482543135,768,93918,3825226,482449217,0,3210,269640,2650,203116,560,66524,812,8,1105,18,0,37,130000.0,39000.0,-70.0,-71.0,-67.0,-60.0,-70.0,-70.0,-67.0,-60.0,-90.0,-93.0,-89.0,-92.0,20.0,22.0,22.0,32.0,0
5792,BA:8C:B9:54:50:24,3829954,488600272,4727,6150995,3825227,482449277,0,8348,1649248,8326,1645753,22,3495,2321,14,5107,36,0,53,216660.0,130000.0,-49.0,-35.0,-42.0,-45.0,-43.0,-35.0,-42.0,-47.0,-90.0,-93.0,-89.0,-92.0,41.0,58.0,47.0,47.0,0
5793,92:69:1D:31:68:E9,3828978,486029374,3745,3579491,3825233,482449883,0,4156,1039819,4040,1013794,116,26025,1999,7,3877,80,0,36,216660.0,130000.0,-52.0,-50.0,-44.0,-46.0,-51.0,-48.0,-43.0,-46.0,-90.0,-93.0,-89.0,-92.0,38.0,43.0,45.0,46.0,0
5794,CC:2F:71:3F:1F:24,4463081,1183515817,637848,701065934,3825233,482449883,37,522977,564097254,522345,564021202,632,76052,505296,10,638085,62023,34,450,130000.0,43333.0,-67.0,-65.0,-70.0,-67.0,-67.0,-65.0,-70.0,-67.0,-90.0,-93.0,-89.0,-92.0,23.0,28.0,19.0,25.0,0
5795,CC:2F:71:3E:C5:1F,3826001,482543801,768,93918,3825233,482449883,0,3210,269640,2650,203116,560,66524,812,8,1105,18,0,37,130000.0,39000.0,-70.0,-71.0,-67.0,-60.0,-70.0,-70.0,-67.0,-60.0,-90.0,-93.0,-89.0,-92.0,20.0,22.0,22.0,32.0,0
5796,BA:8C:B9:54:50:24,3829960,488600878,4727,6150995,3825233,482449883,0,8348,1649248,8326,1645753,22,3495,2321,14,5107,36,0,53,216660.0,130000.0,-49.0,-35.0,-42.0,-45.0,-43.0,-35.0,-42.0,-47.0,-90.0,-93.0,-89.0,-92.0,41.0,58.0,47.0,47.0,0
5797,92:69:1D:31:68:E9,3828981,486029638,3745,3579491,3825236,482450147,0,4156,1039819,4040,1013794,116,26025,1999,7,3877,80,0,36,216660.0,130000.0,-52.0,-50.0,-44.0,-46.0,-51.0,-48.0,-43.0,-46.0,-90.0,-93.0,-89.0,-92.0,38.0,43.0,45.0,46.0,0
5798,CC:2F:71:3F:1F:24,4463127,1183530633,637891,701080486,3825236,482450147,37,523005,564102406,522373,564026354,632,76052,505324,10,638128,62039,34,450,117000.0,39000.0,-67.0,-65.0,-70.0,-68.0,-67.0,-65.0,-70.0,-67.0,-90.0,-93.0,-89.0,-92.0,23.0,28.0,19.0,24.0,0
5799,CC:2F:71:3E:C5:1F,3826004,482544065,768,93918,3825236,482450147,0,3212,269828,2651,203186,561,66642,813,8,1105,18,0,37,130000.0,39000.0,-70.0,-71.0,-67.0,-60.0,-70.0,-70.0,-67.0,-60.0,-90.0,-93.0,-89.0,-92.0,20.0,22.0,22.0,32.0,0
5800,BA:8C:B9:54:50:24,3829963,488601142,4727,6150995,3825236,482450147,0,8348,1649248,8326,1645753,22,3495,2321,14,5107,36,0,53,216660.0,130000.0,-49.0,-35.0,-42.0,-45.0,-43.0,-35.0,-42.0,-47.0,-90.0,-93.0,-89.0,-92.0,41.0,58.0,47.0,47.0,0
5801,92:69:1D:31:68:E9,3828988,486030304,3745,3579491,3825243,482450813,0,4156,1039819,4040,1013794,116,26025,1999,7,3877,80,0,36,216660.0,130000.0,-52.0,-50.0,-44.0,-46.0,-51.0,-48.0,-43.0,-46.0,-90.0,-93.0,-89.0,-92.0,38.0,43.0,45.0,46.0,0
5802,CC:2F:71:3F:1F:24,4463175,1183545547,637932,701094734,3825243,482450813,37,523032,564107466,522400,564031414,632,76052,505351,10,638169,62050,34,450,130000.0,39000.0,-67.0,-65.0,-70.0,-67.0,-67.0,-65.0,-70.0,-67.0,-90.0,-93.0,-89.0,-92.0,23.0,28.0,19.0,25.0,0
5803,CC:2F:71:3E:C5:1F,3826011,482544731,768,93918,3825243,482450813,0,3212,269828,2651,203186,561,66642,813,8,1105,18,0,37,130000.0,39000.0,-70.0,-71.0,-67.0,-60.0,-70.0,-70.0,-67.0,-60.0,-90.0,-93.0,-89.0,-92.0,20.0,22.0,22.0,32.0,0
5804,BA:8C:B9:54:50:24,3829970,488601808,4727,6150995,3825243,482450813,0,8348,1649248,8326,1645753,22,3495,2321,14,5107,36,0,53,216660.0,130000.0,-49.0,-35.0,-42.0,-45.0,-43.0,-35.0,-42.0,-47.0,-90.0,-93.0,-89.0,-92.0,41.0,58.0,47.0,47.0,0
5805,92:69:1D:31:68:E9,3828990,486030506,3745,3579491,3825245,482451015,0,4156,1039819,4040,1013794,116,26025,1999,7,3877,80,0,36,216660.0,130000.0,-52.0,-50.0,-44.0,-46.0,-51.0,-48.0,-43.0,-46.0,-90.0,-93.0,-89.0,-92.0,38.0,43.0,45.0,46.0,0
5806,CC:2F:71:3F:1F:24,4463219,1183560177,637974,701109162,3825245,482451015,37,523058,564112386,522426,564036334,632,76052,505377,10,638211,62080,34,450,130000.0,39000.0,-67.0,-65.0,-70.0,-68.0,-67.0,-65.0,-70.0,-67.0,-90.0,-93.0,-89.0,-92.0,23.0,28.0,19.0,24.0,0
5807,CC:2F:71:3E:C5:1F,3826013,482544933,768,93918,3825245,482451015,0,3212,269828,2651,203186,561,66642,813,8,1105,18,0,37,130000.0,39000.0,-70.0,-71.0,-67.0,-60.0,-70.0,-70.0,-67.0,-60.0,-90.0,-93.0,-89.0,-92.0,20.0,22.0,22.0,32.0,0
5808,BA:8C:B9:54:50:24,3829972,488602010,4727,6150995,3825245,482451015,0,8348,1649248,8326,1645753,22,3495,2321,14,5107,36,0,53,216660.0,130000.0,-49.0,-35.0,-42.0,-45.0,-43.0,-35.0,-42.0,-47.0,-90.0,-93.0,-89.0,-92.0,41.0,58.0,47.0,47.0,0
5809,92:69:1D:31:68:E9,3828994,486030910,3745,3579491,3825249,482451419,0,4158,1039955,4042,1013930,116,26025,1999,7,3878,80,0,36,216660.0,130000.0,-52.0,-51.0,-45.0,-46.0,-51.0,-48.0,-43.0,-47.0,-90.0,-93.0,-89.0,-92.0,38.0,42.0,44.0,46.0,0
5810,CC:2F:71:3F:1F:24,4463265,1183575075,638015,701123522,3825250,482451553,37,523085,564117446,522453,564041394,632,76052,505404,10,638252,62081,34,450,130000.0,43333.0,-67.0,-65.0,-70.0,-67.0,-67.0,-65.0,-70.0,-67.0,-90.0,-93.0,-89.0,-92.0,23.0,28.0,19.0,25.0,0
5811,CC:2F:71:3E:C5:1F,3826019,482545533,768,93918,3825251,482451615,0,3212,269828,2651,203186,561,66642,813,8,1105,18,0,37,130000.0,39000.0,-70.0,-71.0,-67.0,-60.0,-70.0,-70.0,-67.0,-60.0,-90.0,-93.0,-89.0,-92.0,20.0,22.0,22.0,32.0,0
5812,BA:8C:B9:54:50:24,3829979,488602678,4727,6150995,3825252,482451683,0,8350,1649384,8328,1645889,22,3495,2321,14,5108,36,0,53,216660.0,130000.0,-39.0,-36.0,-44.0,-52.0,-44.0,-35.0,-42.0,-46.0,-90.0,-93.0,-89.0,-92.0,51.0,57.0,45.0,40.0,0
5813,92:69:1D:31:68:E9,3829000,486031436,3745,3579491,3825255,482451945,0,4158,1039955,4042,1013930,116,26025,1999,7,3878,80,0,36,216660.0,130000.0,-52.0,-51.0,-45.0,-46.0,-51.0,-48.0,-43.0,-47.0,-90.0,-93.0,-89.0,-92.0,38.0,42.0,44.0,46.0,0
5814,CC:2F:71:3F:1F:24,4463314,1183590149,638059,701138204,3825255,482451945,37,523111,564122368,522478,564046198,633,76170,505430,10,638296,62102,34,450,117000.0,39000.0,-67.0,-65.0,-70.0,-67.0,-67.0,-65.0,-70.0,-67.0,-90.0,-93.0,-89.0,-92.0,23.0,28.0,19.0,25.0,0
5815,CC:2F:71:3E:C5:1F,3826023,482545863,768,93918,3825255,482451945,0,3212,269828,2651,203186,561,66642,813,8,1105,18,0,37,130000.0,39000.0,-70.0,-71.0,-67.0,-60.0,-70.0,-70.0,-67.0,-60.0,-90.0,-93.0,-89.0,-92.0,20.0,22.0,22.0,32.0,0
5816,BA:8C:B9:54:50:24,3829982,488602940,4727,6150995,3825255,482451945,0,8350,1649384,8328,1645889,22,3495,2321,14,5108,36,0,53,216660.0,130000.0,-39.0,-36.0,-44.0,-52.0,-44.0,-35.0,-42.0,-46.0,-90.0,-93.0,-89.0,-92.0,51.0,57.0,45.0,40.0,0
5817,92:69:1D:31:68:E9,3829004,486031840,3745,3579491,3825259,482452349,0,4158,1039955,4042,1013930,116,26025,1999,7,3878,80,0,36,216660.0,130000.0,-52.0,-51.0,-45.0,-46.0,-51.0,-48.0,-43.0,-47.0,-90.0,-93.0,-89.0,-92.0,38.0,42.0,44.0,46.0,0
5818,CC:2F:71:3F:1F:24,4463360,1183604981,638101,701152632,3825259,482452349,37,523136,564127172,522503,564051002,633,76170,505455,10,638338,62109,34,450,130000.0,43333.0,-67.0,-65.0,-70.0,-68.0,-67.0,-65.0,-70.0,-67.0,-90.0,-93.0,-89.0,-92.0,23.0,28.0,19.0,24.0,0
5819,CC:2F:71:3E:C5:1F,3826027,482546267,768,93918,3825259,482452349,0,3212,269828,2651,203186,561,66642,813,8,1105,18,0,37,130000.0,39000.0,-70.0,-71.0,-67.0,-60.0,-70.0,-70.0,-67.0,-60.0,-90.0,-93.0,-89.0,-92.0,20.0,22.0,22.0,32.0,0
5820,BA:8C:B9:54:50:24,3829988,488603546,4727,6150995,3825261,482452551,0,8350,1649384,8328,1645889,22,3495,2321,14,5108,36,0,53,216660.0,130000.0,-39.0,-36.0,-44.0,-52.0,-44.0,-35.0,-42.0,-46.0,-90.0,-93.0,-89.0,-92.0,51.0,57.0,45.0,40.0,0
5821,92:69:1D:31:68:E9,3829008,486032244,3745,3579491,3825263,482452753,0,4159,1040023,4043,1013998,116,26025,1999,7,3878,80,0,36,216660.0,130000.0,-52.0,-50.0,-44.0,-46.0,-51.0,-49.0,-43.0,-46.0,-90.0,-93.0,-89.0,-92.0,38.0,43.0,45.0,46.0,0
5822,CC:2F:71:3F:1F:24,4463407,1183619985,638143,701167172,3825264,482452813,37,523164,564132372,522531,564056202,633,76170,505483,10,638380,62114,34,450,130000.0,43333.0,-67.0,-65.0,-70.0,-67.0,-67.0,-65.0,-70.0,-67.0,-90.0,-93.0,-89.0,-92.0,23.0,28.0,19.0,25.0,0
5823,CC:2F:71:3E:C5:1F,3826032,482546731,768,93918,3825264,482452813,0,3212,269828,2651,203186,561,66642,813,8,1105,18,0,37,130000.0,39000.0,-70.0,-71.0,-67.0,-60.0,-70.0,-70.0,-67.0,-60.0,-90.0,-93.0,-89.0,-92.0,20.0,22.0,22.0,32.0,0
5824,BA:8C:B9:54:50:24,3829991,488603808,4727,6150995,3825264,482452813,0,8350,1649384,8328,1645889,22,3495,2321,14,5108,36,0,53,216660.0,130000.0,-39.0,-36.0,-44.0,-52.0,-44.0,-35.0,-42.0,-46.0,-90.0,-93.0,-89.0,-92.0,51.0,57.0,45.0,40.0,0
5825,92:69:1D:31:68:E9,3829013,486032708,3745,3579491,3825268,482453217,0,4159,1040023,4043,1013998,116,26025,1999,7,3878,80,0,36,216660.0,130000.0,-52.0,-50.0,-44.0,-46.0,-51.0,-49.0,-43.0,-46.0,-90.0,-93.0,-89.0,-92.0,38.0,43.0,45.0,46.0,0
5826,CC:2F:71:3F:1F:24,4463453,1183634817,638185,701181600,3825268,482453217,37,523190,564137316,522557,564061146,633,76170,505509,10,638422,62145,34,450,144444.0,39000.0,-67.0,-65.0,-70.0,-67.0,-67.0,-65.0,-70.0,-67.0,-90.0,-93.0,-89.0,-92.0,23.0,28.0,19.0,25.0,0
5827,CC:2F:71:3E:C5:1F,3826036,482547135,768,93918,3825268,482453217,0,3212,269828,2651,203186,561,66642,813,8,1105,18,0,37,130000.0,39000.0,-70.0,-71.0,-67.0,-60.0,-70.0,-70.0,-67.0,-60.0,-90.0,-93.0,-89.0,-92.0,20.0,22.0,22.0,32.0,0
5828,BA:8C:B9:54:50:24,3829997,488604414,4727,6150995,3825270,482453419,0,8350,1649384,8328,1645889,22,3495,2321,14,5108,36,0,53,216660.0,130000.0,-39.0,-36.0,-44.0,-52.0,-44.0,-35.0,-42.0,-46.0,-90.0,-93.0,-89.0,-92.0,51.0,57.0,45.0,40.0,0
5829,92:69:1D:31:68:E9,3829017,486033112,3745,3579491,3825272,482453621,0,4159,1040023,4043,1013998,116,26025,1999,7,3878,80,0,36,216660.0,130000.0,-52.0,-50.0,-44.0,-46.0,-51.0,-49.0,-43.0,-46.0,-90.0,-93.0,-89.0,-92.0,38.0,43.0,45.0,46.0,0
5830,CC:2F:71:3F:1F:24,4463499,1183649649,638227,701196028,3825272,482453621,37,523216,564142236,522583,564066066,633,76170,505535,10,638464,62161,34,450,130000.0,43333.0,-67.0,-65.0,-71.0,-67.0,-67.0,-65.0,-70.0,-67.0,-90.0,-93.0,-89.0,-92.0,23.0,28.0,18.0,25.0,0
5831,CC:2F:71:3E:C5:1F,3826040,482547539,768,93918,3825272,482453621,0,3212,269828,2651,203186,561,66642,813,8,1105,18,0,37,130000.0,39000.0,-70.0,-71.0,-67.0,-60.0,-70.0,-70.0,-67.0,-60.0,-90.0,-93.0,-89.0,-92.0,20.0,22.0,22.0,32.0,0
5832,BA:8C:B9:54:50:24,3829999,488604616,4727,6150995,3825272,482453621,0,8350,1649384,8328,1645889,22,3495,2321,14,5108,36,0,53,216660.0,130000.0,-39.0,-36.0,-44.0,-52.0,-44.0,-35.0,-42.0,-46.0,-90.0,-93.0,-89.0,-92.0,51.0,57.0,45.0,40.0,0
5833,92:69:1D:31:68:E9,3829022,486033576,3745,3579491,3825277,482454085,0,4159,1040023,4043,1013998,116,26025,1999,7,3878,80,0,36,216660.0,130000.0,-52.0,-50.0,-44.0,-46.0,-51.0,-49.0,-43.0,-46.0,-90.0,-93.0,-89.0,-92.0,38.0,43.0,45.0,46.0,0
5834,CC:2F:71:3F:1F:24,4463545,1183664417,638268,701210332,3825277,482454085,37,523241,564147040,522608,564070870,633,76170,505560,10,638505,62187,34,450,144444.0,39000.0,-67.0,-65.0,-70.0,-67.0,-67.0,-65.0,-70.0,-67.0,-90.0,-93.0,-89.0,-92.0,23.0,28.0,19.0,25.0,0
5835,CC:2F:71:3E:C5:1F,3826045,482548003,768,93918,3825277,482454085,0,3212,269828,2651,203186,561,66642,813,8,1105,18,0,37,130000.0,39000.0,-70.0,-71.0,-67.0,-60.0,-70.0,-70.0,-67.0,-60.0,-90.0,-93.0,-89.0,-92.0,20.0,22.0,22.0,32.0,0
5836,BA:8C:B9:54:50:24,3830006,488605282,4727,6150995,3825279,482454287,0,8350,1649384,8328,1645889,22,3495,2321,14,5108,36,0,53,216660.0,130000.0,-39.0,-36.0,-44.0,-52.0,-44.0,-35.0,-42.0,-46.0,-90.0,-93.0,-89.0,-92.0,51.0,57.0,45.0,40.0,0
5837,92:69:1D:31:68:E9,3829049,486045003,3745,3579491,3825304,482465512,0,4162,1040394,4045,1014134,117,26260,2000,7,3878,80,0,36,216660.0,130000.0,-50.0,-47.0,-42.0,-48.0,-51.0,-49.0,-43.0,-47.0,-90.0,-93.0,-89.0,-92.0,40.0,46.0,47.0,44.0,0
5838,CC:2F:71:3F:1F:24,4463616,1183690526,638312,701225014,3825304,482465512,37,523267,564151960,522634,564075790,633,76170,505586,10,638549,62218,34,450,130000.0,43333.0,-67.0,-65.0,-70.0,-68.0,-67.0,-65.0,-70.0,-67.0,-90.0,-93.0,-89.0,-92.0,23.0,28.0,19.0,24.0,0
5839,CC:2F:71:3E:C5:1F,3826072,482559430,768,93918,3825304,482465512,0,3212,269828,2651,203186,561,66642,813,8,1105,18,0,37,130000.0,39000.0,-70.0,-71.0,-67.0,-60.0,-70.0,-70.0,-67.0,-60.0,-90.0,-93.0,-89.0,-92.0,20.0,22.0,22.0,32.0,0
5840,BA:8C:B9:54:50:24,3830031,488616507,4727,6150995,3825304,482465512,0,8350,1649384,8328,1645889,22,3495,2321,14,5108,36,0,53,216660.0,130000.0,-39.0,-36.0,-44.0,-52.0,-44.0,-35.0,-42.0,-46.0,-90.0,-93.0,-89.0,-92.0,51.0,57.0,45.0,40.0,0
5841,92:69:1D:31:68:E9,3829054,486045680,3745,3579491,3825309,482466189,0,4162,1040394,4045,1014134,117,26260,2000,7,3878,80,0,36,216660.0,130000.0,-50.0,-47.0,-42.0,-48.0,-51.0,-49.0,-43.0,-47.0,-90.0,-93.0,-89.0,-92.0,40.0,46.0,47.0,44.0,0
5842,CC:2F:71:3F:1F:24,4463664,1183706001,638355,701239812,3825309,482466189,37,523297,564157426,522664,564081256,633,76170,505616,10,638592,62229,34,450,130000.0,43333.0,-67.0,-65.0,-71.0,-68.0,-67.0,-65.0,-70.0,-67.0,-90.0,-93.0,-89.0,-92.0,23.0,28.0,18.0,24.0,0
5843,CC:2F:71:3E:C5:1F,3826079,482560309,768,93918,3825311,482466391,0,3212,269828,2651,203186,561,66642,813,8,1105,18,0,37,130000.0,39000.0,-70.0,-71.0,-67.0,-60.0,-70.0,-70.0,-67.0,-60.0,-90.0,-93.0,-89.0,-92.0,20.0,22.0,22.0,32.0,0
5844,BA:8C:B9:54:50:24,3830038,488617386,4727,6150995,3825311,482466391,0,8350,1649384,8328,1645889,22,3495,2321,14,5108,36,0,53,216660.0,130000.0,-39.0,-36.0,-44.0,-52.0,-44.0,-35.0,-42.0,-46.0,-90.0,-93.0,-89.0,-92.0,51.0,57.0,45.0,40.0,0
5845,92:69:1D:31:68:E9,3829059,486046144,3745,3579491,3825314,482466653,0,4162,1040394,4045,1014134,117,26260,2000,7,3878,80,0,36,216660.0,130000.0,-50.0,-47.0,-42.0,-48.0,-51.0,-49.0,-43.0,-47.0,-90.0,-93.0,-89.0,-92.0,40.0,46.0,47.0,44.0,0
5846,CC:2F:71:3F:1F:24,4463711,1183720949,638397,701254296,3825314,482466653,37,523322,564162230,522689,564086060,633,76170,505641,10,638634,62241,34,450,130000.0,39000.0,-67.0,-65.0,-71.0,-67.0,-67.0,-65.0,-70.0,-67.0,-90.0,-93.0,-89.0,-92.0,23.0,28.0,18.0,25.0,0
5847,CC:2F:71:3E:C5:1F,3826082,482560571,768,93918,3825314,482466653,0,3212,269828,2651,203186,561,66642,813,8,1105,18,0,37,130000.0,39000.0,-70.0,-71.0,-67.0,-60.0,-70.0,-70.0,-67.0,-60.0,-90.0,-93.0,-89.0,-92.0,20.0,22.0,22.0,32.0,0
5848,BA:8C:B9:54:50:24,3830041,488617648,4727,6150995,3825314,482466653,0,8350,1649384,8328,1645889,22,3495,2321,14,5108,36,0,53,216660.0,130000.0,-39.0,-36.0,-44.0,-52.0,-44.0,-35.0,-42.0,-46.0,-90.0,-93.0,-89.0,-92.0,51.0,57.0,45.0,40.0,0
5849,92:69:1D:31:68:E9,3829063,486046548,3745,3579491,3825318,482467057,0,4162,1040394,4045,1014134,117,26260,2000,7,3878,80,0,36,216660.0,130000.0,-50.0,-47.0,-42.0,-48.0,-51.0,-49.0,-43.0,-47.0,-90.0,-93.0,-89.0,-92.0,40.0,46.0,47.0,44.0,0
5850,CC:2F:71:3F:1F:24,4463758,1183735849,638440,701268792,3825318,482467057,37,523347,564167034,522714,564090864,633,76170,505666,10,638677,62266,34,450,130000.0,43333.0,-67.0,-65.0,-70.0,-67.0,-67.0,-65.0,-70.0,-67.0,-90.0,-93.0,-89.0,-92.0,23.0,28.0,19.0,25.0,0
5851,CC:2F:71:3E:C5:1F,3826088,482561177,768,93918,3825320,482467259,0,3212,269828,2651,203186,561,66642,813,8,1105,18,0,37,130000.0,39000.0,-70.0,-71.0,-67.0,-60.0,-70.0,-70.0,-67.0,-60.0,-90.0,-93.0,-89.0,-92.0,20.0,22.0,22.0,32.0,0
5852,BA:8C:B9:54:50:24,3830047,488618254,4727,6150995,3825320,482467259,0,8350,1649384,8328,1645889,22,3495,2321,14,5108,36,0,53,216660.0,130000.0,-39.0,-36.0,-44.0,-52.0,-44.0,-35.0,-42.0,-46.0,-90.0,-93.0,-89.0,-92.0,51.0,57.0,45.0,40.0,0
5853,92:69:1D:31:68:E9,3829070,486047380,3745,3579491,3825325,482467889,0,4162,1040394,4045,1014134,117,26260,2000,7,3878,80,0,36,216660.0,130000.0,-50.0,-47.0,-42.0,-48.0,-51.0,-49.0,-43.0,-47.0,-90.0,-93.0,-89.0,-92.0,40.0,46.0,47.0,44.0,0
5854,CC:2F:71:3F:1F:24,4463808,1183751289,638483,701283400,3825325,482467889,37,523373,564171978,522740,564095808,633,76170,505692,10,638720,62276,34,450,130000.0,39000.0,-67.0,-65.0,-71.0,-67.0,-67.0,-65.0,-70.0,-67.0,-90.0,-93.0,-89.0,-92.0,23.0,28.0,18.0,25.0,0
5855,CC:2F:71:3E:C5:1F,3826093,482561807,768,93918,3825325,482467889,0,3212,269828,2651,203186,561,66642,813,8,1105,18,0,37,130000.0,39000.0,-70.0,-71.0,-67.0,-60.0,-70.0,-70.0,-67.0,-60.0,-90.0,-93.0,-89.0,-92.0,20.0,22.0,22.0,32.0,0
5856,BA:8C:B9:54:50:24,3830052,488618884,4727,6150995,3825325,482467889,0,8350,1649384,8328,1645889,22,3495,2321,14,5108,36,0,53,216660.0,130000.0,-39.0,-36.0,-44.0,-52.0,-44.0,-35.0,-42.0,-46.0,-90.0,-93.0,-89.0,-92.0,51.0,57.0,45.0,40.0,0
5857,92:69:1D:31:68:E9,3829072,486047582,3745,3579491,3825327,482468091,0,4162,1040394,4045,1014134,117,26260,2000,7,3878,80,0,36,216660.0,130000.0,-50.0,-47.0,-42.0,-48.0,-51.0,-49.0,-43.0,-47.0,-90.0,-93.0,-89.0,-92.0,40.0,46.0,47.0,44.0,0
5858,CC:2F:71:3F:1F:24,4463856,1183766323,638525,701297828,3825331,482468495,37,523400,564177074,522767,564100904,633,76170,505719,10,638762,62296,34,450,130000.0,39000.0,-67.0,-65.0,-70.0,-67.0,-67.0,-65.0,-70.0,-67.0,-90.0,-93.0,-89.0,-92.0,23.0,28.0,19.0,25.0,0
5859,CC:2F:71:3E:C5:1F,3826099,482562413,768,93918,3825331,482468495,0,3212,269828,2651,203186,561,66642,813,8,1105,18,0,37,130000.0,39000.0,-70.0,-71.0,-67.0,-60.0,-70.0,-70.0,-67.0,-60.0,-90.0,-93.0,-89.0,-92.0,20.0,22.0,22.0,32.0,0
5860,BA:8C:B9:54:50:24,3830060,488619774,4729,6151279,3825331,482468495,0,8356,1649928,8334,1646433,22,3495,2323,14,5110,36,0,53,216660.0,130000.0,-51.0,-34.0,-43.0,-44.0,-43.0,-36.0,-44.0,-49.0,-90.0,-93.0,-89.0,-92.0,39.0,59.0,46.0,48.0,0
5861,92:69:1D:31:68:E9,3829078,486048188,3745,3579491,3825333,482468697,0,4162,1040394,4045,1014134,117,26260,2000,7,3878,80,0,36,216660.0,130000.0,-50.0,-47.0,-42.0,-48.0,-51.0,-49.0,-43.0,-47.0,-90.0,-93.0,-89.0,-92.0,40.0,46.0,47.0,44.0,0
5862,CC:2F:71:3F:1F:24,4463900,1183781009,638567,701312312,3825333,482468697,37,523426,564181994,522793,564105824,633,76170,505745,10,638804,62302,34,450,130000.0,43333.0,-67.0,-65.0,-70.0,-68.0,-67.0,-65.0,-70.0,-67.0,-90.0,-93.0,-89.0,-92.0,23.0,28.0,19.0,24.0,0
5863,CC:2F:71:3E:C5:1F,3826101,482562615,768,93918,3825333,482468697,0,3212,269828,2651,203186,561,66642,813,8,1105,18,0,37,130000.0,39000.0,-70.0,-71.0,-67.0,-60.0,-70.0,-70.0,-67.0,-60.0,-90.0,-93.0,-89.0,-92.0,20.0,22.0,22.0,32.0,0
5864,BA:8C:B9:54:50:24,3830062,488619976,4729,6151279,3825333,482468697,0,8356,1649928,8334,1646433,22,3495,2323,14,5110,36,0,53,216660.0,130000.0,-51.0,-34.0,-43.0,-44.0,-43.0,-36.0,-44.0,-49.0,-90.0,-93.0,-89.0,-92.0,39.0,59.0,46.0,48.0,0
5865,92:69:1D:31:68:E9,3829081,486048450,3745,3579491,3825336,482468959,0,4162,1040394,4045,1014134,117,26260,2000,7,3878,80,0,36,216660.0,130000.0,-50.0,-47.0,-42.0,-48.0,-51.0,-49.0,-43.0,-47.0,-90.0,-93.0,-89.0,-92.0,40.0,46.0,47.0,44.0,0
5866,CC:2F:71:3F:1F:24,4463948,1183796035,638608,701326672,3825340,482469363,37,523454,564187146,522821,564110976,633,76170,505773,10,638845,62314,34,450,130000.0,39000.0,-67.0,-65.0,-70.0,-68.0,-67.0,-65.0,-70.0,-67.0,-90.0,-93.0,-89.0,-92.0,23.0,28.0,19.0,24.0,0
5867,CC:2F:71:3E:C5:1F,3826108,482563281,768,93918,3825340,482469363,0,3212,269828,2651,203186,561,66642,813,8,1105,18,0,37,130000.0,39000.0,-70.0,-71.0,-67.0,-60.0,-70.0,-70.0,-67.0,-60.0,-90.0,-93.0,-89.0,-92.0,20.0,22.0,22.0,32.0,0
5868,BA:8C:B9:54:50:24,3830069,488620642,4729,6151279,3825340,482469363,0,8356,1649928,8334,1646433,22,3495,2323,14,5110,36,0,53,216660.0,130000.0,-51.0,-34.0,-43.0,-44.0,-43.0,-36.0,-44.0,-49.0,-90.0,-93.0,-89.0,-92.0,39.0,59.0,46.0,48.0,0
5869,92:69:1D:31:68:E9,3829087,486049056,3745,3579491,3825342,482469565,0,4162,1040394,4045,1014134,117,26260,2000,7,3878,80,0,36,216660.0,130000.0,-50.0,-47.0,-42.0,-48.0,-51.0,-49.0,-43.0,-47.0,-90.0,-93.0,-89.0,-92.0,40.0,46.0,47.0,44.0,0
5870,CC:2F:71:3F:1F:24,4463993,1183810795,638651,701341230,3825342,482469565,37,523480,564192090,522847,564115920,633,76170,505799,10,638888,62333,34,450,130000.0,39000.0,-67.0,-65.0,-70.0,-67.0,-67.0,-65.0,-70.0,-67.0,-90.0,-93.0,-89.0,-92.0,23.0,28.0,19.0,25.0,0
5871,CC:2F:71:3E:C5:1F,3826110,482563483,768,93918,3825342,482469565,0,3212,269828,2651,203186,561,66642,813,8,1105,18,0,37,130000.0,39000.0,-70.0,-71.0,-67.0,-60.0,-70.0,-70.0,-67.0,-60.0,-90.0,-93.0,-89.0,-92.0,20.0,22.0,22.0,32.0,0
5872,BA:8C:B9:54:50:24,3830073,488621046,4729,6151279,3825344,482469767,0,8356,1649928,8334,1646433,22,3495,2323,14,5110,36,0,53,216660.0,130000.0,-51.0,-34.0,-43.0,-44.0,-43.0,-36.0,-44.0,-49.0,-90.0,-93.0,-89.0,-92.0,39.0,59.0,46.0,48.0,0
5873,92:69:1D:31:68:E9,3829089,486049258,3745,3579491,3825344,482469767,0,4162,1040394,4045,1014134,117,26260,2000,7,3878,80,0,36,216660.0,130000.0,-50.0,-47.0,-42.0,-48.0,-51.0,-49.0,-43.0,-47.0,-90.0,-93.0,-89.0,-92.0,40.0,46.0,47.0,44.0,0
5874,CC:2F:71:3F:1F:24,4464039,1183825515,638692,701355478,3825347,482470037,37,523505,564196894,522872,564120724,633,76170,505824,10,638929,62356,34,450,117000.0,39000.0,-67.0,-65.0,-70.0,-68.0,-67.0,-65.0,-70.0,-67.0,-90.0,-93.0,-89.0,-92.0,23.0,28.0,19.0,24.0,0
5875,CC:2F:71:3E:C5:1F,3826116,482564089,768,93918,3825348,482470171,0,3212,269828,2651,203186,561,66642,813,8,1105,18,0,37,130000.0,39000.0,-70.0,-71.0,-67.0,-60.0,-70.0,-70.0,-67.0,-60.0,-90.0,-93.0,-89.0,-92.0,20.0,22.0,22.0,32.0,0
5876,BA:8C:B9:54:50:24,3830078,488621510,4729,6151279,3825349,482470231,0,8356,1649928,8334,1646433,22,3495,2323,14,5110,36,0,53,216660.0,130000.0,-51.0,-34.0,-43.0,-44.0,-43.0,-36.0,-44.0,-49.0,-90.0,-93.0,-89.0,-92.0,39.0,59.0,46.0,48.0,0
5877,92:69:1D:31:68:E9,3829096,486049924,3745,3579491,3825351,482470433,0,4162,1040394,4045,1014134,117,26260,2000,7,3878,80,0,36,216660.0,130000.0,-50.0,-47.0,-42.0,-48.0,-51.0,-49.0,-43.0,-47.0,-90.0,-93.0,-89.0,-92.0,40.0,46.0,47.0,44.0,0
5878,CC:2F:71:3F:1F:24,4464086,1183840463,638735,701370030,3825351,482470433,37,523530,564201698,522897,564125528,633,76170,505849,10,638972,62362,34,450,130000.0,43333.0,-67.0,-65.0,-71.0,-68.0,-67.0,-65.0,-70.0,-67.0,-90.0,-93.0,-89.0,-92.0,23.0,28.0,18.0,24.0,0
5879,CC:2F:71:3E:C5:1F,3826119,482564351,768,93918,3825351,482470433,0,3212,269828,2651,203186,561,66642,813,8,1105,18,0,37,130000.0,39000.0,-70.0,-71.0,-67.0,-60.0,-70.0,-70.0,-67.0,-60.0,-90.0,-93.0,-89.0,-92.0,20.0,22.0,22.0,32.0,0
5880,BA:8C:B9:54:50:24,3830082,488621914,4729,6151279,3825353,482470635,0,8356,1649928,8334,1646433,22,3495,2323,14,5110,36,0,53,216660.0,130000.0,-51.0,-34.0,-43.0,-44.0,-43.0,-36.0,-44.0,-49.0,-90.0,-93.0,-89.0,-92.0,39.0,59.0,46.0,48.0,0
5881,92:69:1D:31:68:E9,3829098,486050126,3745,3579491,3825353,482470635,0,4162,1040394,4045,1014134,117,26260,2000,7,3878,80,0,36,216660.0,130000.0,-50.0,-47.0,-42.0,-48.0,-51.0,-49.0,-43.0,-47.0,-90.0,-93.0,-89.0,-92.0,40.0,46.0,47.0,44.0,0
5882,CC:2F:71:3F:1F:24,4464131,1183855221,638776,701384384,3825355,482470837,37,523558,564206898,522925,564130728,633,76170,505877,10,639013,62381,34,450,130000.0,39000.0,-67.0,-65.0,-70.0,-67.0,-67.0,-65.0,-70.0,-67.0,-90.0,-93.0,-89.0,-92.0,23.0,28.0,19.0,25.0,0
5883,CC:2F:71:3E:C5:1F,3826127,482565167,768,93918,3825359,482471249,0,3212,269828,2651,203186,561,66642,813,8,1105,18,0,37,130000.0,39000.0,-70.0,-71.0,-67.0,-60.0,-70.0,-70.0,-67.0,-60.0,-90.0,-93.0,-89.0,-92.0,20.0,22.0,22.0,32.0,0
5884,BA:8C:B9:54:50:24,3830088,488622528,4729,6151279,3825359,482471249,0,8356,1649928,8334,1646433,22,3495,2323,14,5110,36,0,53,216660.0,130000.0,-51.0,-34.0,-43.0,-44.0,-43.0,-36.0,-44.0,-49.0,-90.0,-93.0,-89.0,-92.0,39.0,59.0,46.0,48.0,0
5885,92:69:1D:31:68:E9,3829107,486051002,3745,3579491,3825362,482471511,0,4162,1040394,4045,1014134,117,26260,2000,7,3878,80,0,36,216660.0,130000.0,-50.0,-47.0,-42.0,-48.0,-51.0,-49.0,-43.0,-47.0,-90.0,-93.0,-89.0,-92.0,40.0,46.0,47.0,44.0,0
5886,CC:2F:71:3F:1F:24,4464180,1183870323,638818,701398812,3825362,482471511,37,523585,564211958,522952,564135788,633,76170,505904,10,639055,62392,34,450,130000.0,43333.0,-67.0,-65.0,-71.0,-68.0,-67.0,-65.0,-70.0,-67.0,-90.0,-93.0,-89.0,-92.0,23.0,28.0,18.0,24.0,0
5887,CC:2F:71:3E:C5:1F,3826130,482565429,768,93918,3825362,482471511,0,3212,269828,2651,203186,561,66642,813,8,1105,18,0,37,130000.0,39000.0,-70.0,-71.0,-67.0,-60.0,-70.0,-70.0,-67.0,-60.0,-90.0,-93.0,-89.0,-92.0,20.0,22.0,22.0,32.0,0
5888,BA:8C:B9:54:50:24,3830094,488623108,4730,6151395,3825364,482471713,0,8359,1650174,8337,1646679,22,3495,2324,14,5111,36,0,53,229410.0,130000.0,-49.0,-35.0,-42.0,-45.0,-43.0,-36.0,-44.0,-49.0,-90.0,-93.0,-89.0,-92.0,41.0,58.0,47.0,47.0,0
5889,92:69:1D:31:68:E9,3829110,486051320,3746,3579607,3825364,482471713,0,4164,1040530,4047,1014270,117,26260,2000,7,3879,80,0,36,216660.0,130000.0,-51.0,-47.0,-42.0,-49.0,-51.0,-49.0,-43.0,-47.0,-90.0,-93.0,-89.0,-92.0,39.0,46.0,47.0,43.0,0
5890,CC:2F:71:3F:1F:24,4464227,1183885333,638861,701413418,3825366,482471915,37,523611,564216878,522978,564140708,633,76170,505930,10,639098,62397,34,450,130000.0,43333.0,-67.0,-65.0,-70.0,-68.0,-67.0,-65.0,-70.0,-67.0,-90.0,-93.0,-89.0,-92.0,23.0,28.0,19.0,24.0,0
5891,CC:2F:71:3E:C5:1F,3826137,482566151,769,94034,3825368,482472117,0,3214,269968,2653,203326,561,66642,813,8,1106,18,0,37,130000.0,39000.0,-70.0,-71.0,-67.0,-60.0,-70.0,-71.0,-67.0,-60.0,-90.0,-93.0,-89.0,-92.0,20.0,22.0,22.0,32.0,0
5892,BA:8C:B9:54:50:24,3830099,488623572,4731,6151455,3825368,482472117,0,8361,1650310,8339,1646815,22,3495,2324,14,5112,36,0,53,229410.0,130000.0,-49.0,-35.0,-42.0,-45.0,-45.0,-36.0,-44.0,-48.0,-90.0,-93.0,-89.0,-92.0,41.0,58.0,47.0,47.0,0
5893,92:69:1D:31:68:E9,3829117,486052199,3746,3579607,3825371,482472592,0,4164,1040530,4047,1014270,117,26260,2000,7,3879,80,0,36,216660.0,130000.0,-51.0,-47.0,-42.0,-49.0,-51.0,-49.0,-43.0,-47.0,-90.0,-93.0,-89.0,-92.0,39.0,46.0,47.0,43.0,0
5894,CC:2F:71:3F:1F:24,4464274,1183900438,638903,701427846,3825371,482472592,37,523640,564222170,523007,564146000,633,76170,505959,10,639140,62426,34,450,144444.0,39000.0,-67.0,-65.0,-70.0,-67.0,-67.0,-65.0,-70.0,-67.0,-90.0,-93.0,-89.0,-92.0,23.0,28.0,19.0,25.0,0
5895,CC:2F:71:3E:C5:1F,3826142,482566828,769,94034,3825373,482472794,0,3214,269968,2653,203326,561,66642,813,8,1106,18,0,37,130000.0,39000.0,-70.0,-71.0,-67.0,-60.0,-70.0,-71.0,-67.0,-60.0,-90.0,-93.0,-89.0,-92.0,20.0,22.0,22.0,32.0,0
5896,BA:8C:B9:54:50:24,3830104,488624249,4731,6151455,3825373,482472794,0,8361,1650310,8339,1646815,22,3495,2324,14,5112,36,0,53,229410.0,130000.0,-49.0,-35.0,-42.0,-45.0,-45.0,-36.0,-44.0,-48.0,-90.0,-93.0,-89.0,-92.0,41.0,58.0,47.0,47.0,0
5897,92:69:1D:31:68:E9,3829122,486052663,3746,3579607,3825376,482473056,0,4164,1040530,4047,1014270,117,26260,2000,7,3879,80,0,36,216660.0,130000.0,-51.0,-47.0,-42.0,-49.0,-51.0,-49.0,-43.0,-47.0,-90.0,-93.0,-89.0,-92.0,39.0,46.0,47.0,43.0,0
5898,CC:2F:71:3F:1F:24,4464321,1183915330,638945,701442274,3825376,482473056,37,523666,564227090,523033,564150920,633,76170,505985,10,639182,62439,34,450,130000.0,43333.0,-67.0,-65.0,-70.0,-67.0,-67.0,-65.0,-70.0,-67.0,-90.0,-93.0,-89.0,-92.0,23.0,28.0,19.0,25.0,0
5899,CC:2F:71:3E:C5:1F,3826147,482567292,769,94034,3825378,482473258,0,3214,269968,2653,203326,561,66642,813,8,1106,18,0,37,130000.0,39000.0,-70.0,-71.0,-67.0,-60.0,-70.0,-71.0,-67.0,-60.0,-90.0,-93.0,-89.0,-92.0,20.0,22.0,22.0,32.0,0
5900,BA:8C:B9:54:50:24,3830109,488624713,4731,6151455,3825378,482473258,0,8362,1650378,8340,1646883,22,3495,2324,14,5112,36,0,53,229410.0,130000.0,-40.0,-37.0,-45.0,-51.0,-44.0,-36.0,-44.0,-48.0,-90.0,-93.0,-89.0,-92.0,50.0,56.0,44.0,41.0,0
5901,92:69:1D:31:68:E9,3829126,486053067,3746,3579607,3825380,482473460,0,4164,1040530,4047,1014270,117,26260,2000,7,3879,80,0,36,216660.0,130000.0,-51.0,-47.0,-42.0,-49.0,-51.0,-49.0,-43.0,-47.0,-90.0,-93.0,-89.0,-92.0,39.0,46.0,47.0,43.0,0
5902,CC:2F:71:3F:1F:24,4464370,1183930488,638988,701456826,3825382,482473662,37,523694,564232290,523061,564156120,633,76170,506013,10,639225,62453,34,450,117000.0,39000.0,-67.0,-65.0,-70.0,-67.0,-67.0,-65.0,-70.0,-67.0,-90.0,-93.0,-89.0,-92.0,23.0,28.0,19.0,25.0,0
5903,CC:2F:71:3E:C5:1F,3826151,482567696,769,94034,3825382,482473662,0,3214,269968,2653,203326,561,66642,813,8,1106,18,0,37,130000.0,39000.0,-70.0,-71.0,-67.0,-60.0,-70.0,-71.0,-67.0,-60.0,-90.0,-93.0,-89.0,-92.0,20.0,22.0,22.0,32.0,0
5904,BA:8C:B9:54:50:24,3830113,488625117,4731,6151455,3825382,482473662,0,8362,1650378,8340,1646883,22,3495,2324,14,5112,36,0,53,229410.0,130000.0,-40.0,-37.0,-45.0,-51.0,-44.0,-36.0,-44.0,-48.0,-90.0,-93.0,-89.0,-92.0,50.0,56.0,44.0,41.0,0
5905,92:69:1D:31:68:E9,3829131,486053531,3746,3579607,3825385,482473924,0,4164,1040530,4047,1014270,117,26260,2000,7,3879,80,0,36,216660.0,130000.0,-51.0,-47.0,-42.0,-49.0,-51.0,-49.0,-43.0,-47.0,-90.0,-93.0,-89.0,-92.0,39.0,46.0,47.0,43.0,0
5906,CC:2F:71:3F:1F:24,4464415,1183945126,639028,701471000,3825387,482474126,37,523721,564237350,523088,564161180,633,76170,506040,10,639265,62463,34,450,130000.0,39000.0,-67.0,-65.0,-70.0,-67.0,-67.0,-65.0,-70.0,-67.0,-90.0,-93.0,-89.0,-92.0,23.0,28.0,19.0,25.0,0
5907,CC:2F:71:3E:C5:1F,3826156,482568160,769,94034,3825387,482474126,0,3214,269968,2653,203326,561,66642,813,8,1106,18,0,37,130000.0,39000.0,-70.0,-71.0,-67.0,-60.0,-70.0,-71.0,-67.0,-60.0,-90.0,-93.0,-89.0,-92.0,20.0,22.0,22.0,32.0,0
5908,BA:8C:B9:54:50:24,3830118,488625581,4731,6151455,3825387,482474126,0,8362,1650378,8340,1646883,22,3495,2324,14,5112,36,0,53,229410.0,130000.0,-40.0,-37.0,-45.0,-51.0,-44.0,-36.0,-44.0,-48.0,-90.0,-93.0,-89.0,-92.0,50.0,56.0,44.0,41.0,0
5909,92:69:1D:31:68:E9,3829135,486053935,3746,3579607,3825389,482474328,0,4164,1040530,4047,1014270,117,26260,2000,7,3879,80,0,36,216660.0,130000.0,-51.0,-47.0,-42.0,-49.0,-51.0,-49.0,-43.0,-47.0,-90.0,-93.0,-89.0,-92.0,39.0,46.0,47.0,43.0,0
5910,CC:2F:71:3F:1F:24,4464461,1183959968,639070,701485438,3825391,482474530,37,523750,564242746,523117,564166576,633,76170,506069,10,639307,62504,34,451,144444.0,39000.0,-67.0,-65.0,-71.0,-67.0,-67.0,-65.0,-70.0,-67.0,-90.0,-93.0,-89.0,-92.0,23.0,28.0,18.0,25.0,0
5911,CC:2F:71:3E:C5:1F,3826160,482568564,769,94034,3825391,482474530,0,3214,269968,2653,203326,561,66642,813,8,1106,18,0,37,130000.0,39000.0,-70.0,-71.0,-67.0,-60.0,-70.0,-71.0,-67.0,-60.0,-90.0,-93.0,-89.0,-92.0,20.0,22.0,22.0,32.0,0
5912,BA:8C:B9:54:50:24,3830122,488625985,4731,6151455,3825391,482474530,0,8362,1650378,8340,1646883,22,3495,2324,14,5112,36,0,53,229410.0,130000.0,-40.0,-37.0,-45.0,-51.0,-44.0,-36.0,-44.0,-48.0,-90.0,-93.0,-89.0,-92.0,50.0,56.0,44.0,41.0,0
5913,92:69:1D:31:68:E9,3829141,486054541,3746,3579607,3825395,482474934,0,4166,1040666,4049,1014406,117,26260,2000,7,3880,80,0,36,216660.0,130000.0,-52.0,-50.0,-44.0,-46.0,-51.0,-49.0,-43.0,-47.0,-90.0,-93.0,-89.0,-92.0,38.0,43.0,45.0,46.0,0
5914,CC:2F:71:3F:1F:24,4464507,1183974744,639112,701499810,3825395,482474934,37,523775,564247550,523142,564171380,633,76170,506094,10,639349,62526,34,451,117000.0,39000.0,-67.0,-65.0,-70.0,-67.0,-67.0,-65.0,-70.0,-67.0,-90.0,-93.0,-89.0,-92.0,23.0,28.0,19.0,25.0,0
5915,CC:2F:71:3E:C5:1F,3826164,482568968,769,94034,3825395,482474934,0,3216,270108,2655,203466,561,66642,813,8,1107,18,0,37,130000.0,39000.0,-70.0,-71.0,-67.0,-60.0,-70.0,-71.0,-67.0,-60.0,-90.0,-93.0,-89.0,-92.0,20.0,22.0,22.0,32.0,0
5916,BA:8C:B9:54:50:24,3830127,488626451,4731,6151455,3825396,482474996,0,8362,1650378,8340,1646883,22,3495,2324,14,5112,36,0,53,229410.0,130000.0,-40.0,-37.0,-45.0,-51.0,-44.0,-36.0,-44.0,-48.0,-90.0,-93.0,-89.0,-92.0,50.0,56.0,44.0,41.0,0
5917,92:69:1D:31:68:E9,3829147,486055067,3746,3579607,3825401,482475460,0,4166,1040666,4049,1014406,117,26260,2000,7,3880,80,0,36,216660.0,130000.0,-52.0,-50.0,-44.0,-46.0,-51.0,-49.0,-43.0,-47.0,-90.0,-93.0,-89.0,-92.0,38.0,43.0,45.0,46.0,0
5918,CC:2F:71:3F:1F:24,4464553,1183989388,639152,701513928,3825401,482475460,37,523801,564252472,523167,564176184,634,76288,506120,10,639389,62528,34,451,117000.0,39000.0,-67.0,-65.0,-70.0,-67.0,-67.0,-65.0,-70.0,-67.0,-90.0,-93.0,-89.0,-92.0,23.0,28.0,19.0,25.0,0
5919,CC:2F:71:3E:C5:1F,3826170,482569494,769,94034,3825401,482475460,0,3216,270108,2655,203466,561,66642,813,8,1107,18,0,37,130000.0,39000.0,-70.0,-71.0,-67.0,-60.0,-70.0,-71.0,-67.0,-60.0,-90.0,-93.0,-89.0,-92.0,20.0,22.0,22.0,32.0,0
5920,BA:8C:B9:54:50:24,3830132,488626915,4731,6151455,3825401,482475460,0,8362,1650378,8340,1646883,22,3495,2324,14,5112,36,0,53,229410.0,130000.0,-40.0,-37.0,-45.0,-51.0,-44.0,-36.0,-44.0,-48.0,-90.0,-93.0,-89.0,-92.0,50.0,56.0,44.0,41.0,0
5921,92:69:1D:31:68:E9,3829151,486055471,3746,3579607,3825405,482475864,0,4166,1040666,4049,1014406,117,26260,2000,7,3880,80,0,36,216660.0,130000.0,-52.0,-50.0,-44.0,-46.0,-51.0,-49.0,-43.0,-47.0,-90.0,-93.0,-89.0,-92.0,38.0,43.0,45.0,46.0,0
5922,CC:2F:71:3F:1F:24,4464599,1184004164,639194,701528300,3825405,482475864,37,523828,564257556,523194,564181268,634,76288,506147,10,639431,62540,34,451,130000.0,39000.0,-67.0,-65.0,-70.0,-68.0,-67.0,-65.0,-70.0,-67.0,-90.0,-93.0,-89.0,-92.0,23.0,28.0,19.0,24.0,0
5923,CC:2F:71:3E:C5:1F,3826174,482569898,769,94034,3825405,482475864,0,3216,270108,2655,203466,561,66642,813,8,1107,18,0,37,130000.0,39000.0,-70.0,-71.0,-67.0,-60.0,-70.0,-71.0,-67.0,-60.0,-90.0,-93.0,-89.0,-92.0,20.0,22.0,22.0,32.0,0
5924,BA:8C:B9:54:50:24,3830136,488627319,4731,6151455,3825405,482475864,0,8362,1650378,8340,1646883,22,3495,2324,14,5112,36,0,53,229410.0,130000.0,-40.0,-37.0,-45.0,-51.0,-44.0,-36.0,-44.0,-48.0,-90.0,-93.0,-89.0,-92.0,50.0,56.0,44.0,41.0,0
5925,92:69:1D:31:68:E9,3829155,486055875,3746,3579607,3825409,482476268,0,4166,1040666,4049,1014406,117,26260,2000,7,3880,80,0,36,216660.0,130000.0,-52.0,-50.0,-44.0,-46.0,-51.0,-49.0,-43.0,-47.0,-90.0,-93.0,-89.0,-92.0,38.0,43.0,45.0,46.0,0
5926,CC:2F:71:3F:1F:24,4464647,1184019194,639238,701542926,3825409,482476268,37,523856,564262768,523222,564186480,634,76288,506175,10,639475,62551,34,451,130000.0,43333.0,-67.0,-65.0,-70.0,-67.0,-67.0,-65.0,-70.0,-67.0,-90.0,-93.0,-89.0,-92.0,23.0,28.0,19.0,25.0,0
5927,CC:2F:71:3E:C5:1F,3826178,482570302,769,94034,3825409,482476268,0,3216,270108,2655,203466,561,66642,813,8,1107,18,0,37,130000.0,39000.0,-70.0,-71.0,-67.0,-60.0,-70.0,-71.0,-67.0,-60.0,-90.0,-93.0,-89.0,-92.0,20.0,22.0,22.0,32.0,0
5928,BA:8C:B9:54:50:24,3830142,488627845,4731,6151455,3825411,482476390,0,8362,1650378,8340,1646883,22,3495,2324,14,5112,36,0,53,229410.0,130000.0,-40.0,-37.0,-45.0,-51.0,-44.0,-36.0,-44.0,-48.0,-90.0,-93.0,-89.0,-92.0,50.0,56.0,44.0,41.0,0
5929,92:69:1D:31:68:E9,3829161,486056401,3746,3579607,3825415,482476794,0,4166,1040666,4049,1014406,117,26260,2000,7,3880,80,0,36,216660.0,130000.0,-52.0,-50.0,-44.0,-46.0,-51.0,-49.0,-43.0,-47.0,-90.0,-93.0,-89.0,-92.0,38.0,43.0,45.0,46.0,0
5930,CC:2F:71:3F:1F:24,4464694,1184034080,639279,701557286,3825415,482476794,37,523881,564267572,523247,564191284,634,76288,506200,10,639516,62569,34,451,130000.0,39000.0,-67.0,-65.0,-70.0,-68.0,-67.0,-65.0,-70.0,-67.0,-90.0,-93.0,-89.0,-92.0,23.0,28.0,19.0,24.0,0
5931,CC:2F:71:3E:C5:1F,3826184,482570828,769,94034,3825415,482476794,0,3218,270296,2656,203536,562,66760,814,8,1107,18,0,37,130000.0,39000.0,-70.0,-70.0,-67.0,-59.0,-70.0,-70.0,-67.0,-59.0,-90.0,-93.0,-89.0,-92.0,20.0,23.0,22.0,33.0,0
5932,BA:8C:B9:54:50:24,3830146,488628249,4731,6151455,3825415,482476794,0,8362,1650378,8340,1646883,22,3495,2324,14,5112,36,0,53,229410.0,130000.0,-40.0,-37.0,-45.0,-51.0,-44.0,-36.0,-44.0,-48.0,-90.0,-93.0,-89.0,-92.0,50.0,56.0,44.0,41.0,0
5933,92:69:1D:31:68:E9,3829165,486056805,3746,3579607,3825419,482477198,0,4166,1040666,4049,1014406,117,26260,2000,7,3880,80,0,36,216660.0,130000.0,-52.0,-50.0,-44.0,-46.0,-51.0,-49.0,-43.0,-47.0,-90.0,-93.0,-89.0,-92.0,38.0,43.0,45.0,46.0,0
5934,CC:2F:71:3F:1F:24,4464740,1184048912,639321,701571714,3825419,482477198,37,523906,564272376,523272,564196088,634,76288,506225,10,639558,62580,34,451,130000.0,43333.0,-67.0,-66.0,-71.0,-68.0,-67.0,-65.0,-70.0,-67.0,-90.0,-93.0,-89.0,-92.0,23.0,27.0,18.0,24.0,0
5935,CC:2F:71:3E:C5:1F,3826188,482571232,769,94034,3825419,482477198,0,3218,270296,2656,203536,562,66760,814,8,1107,18,0,37,130000.0,39000.0,-70.0,-70.0,-67.0,-59.0,-70.0,-70.0,-67.0,-59.0,-90.0,-93.0,-89.0,-92.0,20.0,23.0,22.0,33.0,0
5936,BA:8C:B9:54:50:24,3830150,488628653,4731,6151455,3825419,482477198,0,8362,1650378,8340,1646883,22,3495,2324,14,5112,36,0,53,229410.0,130000.0,-40.0,-37.0,-45.0,-51.0,-44.0,-36.0,-44.0,-48.0,-90.0,-93.0,-89.0,-92.0,50.0,56.0,44.0,41.0,0
5937,92:69:1D:31:68:E9,3829170,486057269,3746,3579607,3825424,482477662,0,4166,1040666,4049,1014406,117,26260,2000,7,3880,80,0,36,216660.0,130000.0,-52.0,-50.0,-44.0,-46.0,-51.0,-49.0,-43.0,-47.0,-90.0,-93.0,-89.0,-92.0,38.0,43.0,45.0,46.0,0
5938,CC:2F:71:3F:1F:24,4464786,1184063624,639362,701585962,3825424,482477662,37,523932,564277320,523298,564201032,634,76288,506251,10,639599,62597,34,451,117000.0,39000.0,-67.0,-65.0,-70.0,-67.0,-67.0,-65.0,-70.0,-67.0,-90.0,-93.0,-89.0,-92.0,23.0,28.0,19.0,25.0,0
5939,CC:2F:71:3E:C5:1F,3826193,482571696,769,94034,3825424,482477662,0,3218,270296,2656,203536,562,66760,814,8,1107,18,0,37,130000.0,39000.0,-70.0,-70.0,-67.0,-59.0,-70.0,-70.0,-67.0,-59.0,-90.0,-93.0,-89.0,-92.0,20.0,23.0,22.0,33.0,0
5940,BA:8C:B9:54:50:24,3830155,488629117,4731,6151455,3825424,482477662,0,8362,1650378,8340,1646883,22,3495,2324,14,5112,36,0,53,229410.0,130000.0,-40.0,-37.0,-45.0,-51.0,-44.0,-36.0,-44.0,-48.0,-90.0,-93.0,-89.0,-92.0,50.0,56.0,44.0,41.0,0
5941,92:69:1D:31:68:E9,3829175,486057799,3746,3579607,3825429,482478192,0,4166,1040666,4049,1014406,117,26260,2000,7,3880,80,0,36,216660.0,130000.0,-52.0,-50.0,-44.0,-46.0,-51.0,-49.0,-43.0,-47.0,-90.0,-93.0,-89.0,-92.0,38.0,43.0,45.0,46.0,0
5942,CC:2F:71:3F:1F:24,4464834,1184078706,639405,701600514,3825429,482478192,37,523959,564282498,523325,564206210,634,76288,506277,10,639642,62603,34,451,130000.0,43333.0,-67.0,-65.0,-70.0,-67.0,-67.0,-65.0,-70.0,-67.0,-90.0,-93.0,-89.0,-92.0,23.0,28.0,19.0,25.0,0
5943,CC:2F:71:3E:C5:1F,3826198,482572226,769,94034,3825429,482478192,0,3218,270296,2656,203536,562,66760,814,8,1107,18,0,37,130000.0,39000.0,-70.0,-70.0,-67.0,-59.0,-70.0,-70.0,-67.0,-59.0,-90.0,-93.0,-89.0,-92.0,20.0,23.0,22.0,33.0,0
5944,BA:8C:B9:54:50:24,3830160,488629647,4731,6151455,3825429,482478192,0,8362,1650378,8340,1646883,22,3495,2324,14,5112,36,0,53,229410.0,130000.0,-40.0,-37.0,-45.0,-51.0,-44.0,-36.0,-44.0,-48.0,-90.0,-93.0,-89.0,-92.0,50.0,56.0,44.0,41.0,0
5945,92:69:1D:31:68:E9,3829179,486058408,3746,3579607,3825433,482478801,0,4166,1040666,4049,1014406,117,26260,2000,7,3880,80,0,36,216660.0,130000.0,-52.0,-50.0,-44.0,-46.0,-51.0,-49.0,-43.0,-47.0,-90.0,-93.0,-89.0,-92.0,38.0,43.0,45.0,46.0,0
5946,CC:2F:71:3F:1F:24,4464882,1184094053,639448,701615184,3825434,482478869,37,523984,564287302,523350,564211014,634,76288,506302,10,639685,62606,34,451,130000.0,43333.0,-67.0,-65.0,-70.0,-67.0,-67.0,-65.0,-70.0,-67.0,-90.0,-93.0,-89.0,-92.0,23.0,28.0,19.0,25.0,0
5947,CC:2F:71:3E:C5:1F,3826203,482572903,769,94034,3825434,482478869,0,3218,270296,2656,203536,562,66760,814,8,1107,18,0,37,130000.0,39000.0,-70.0,-70.0,-67.0,-59.0,-70.0,-70.0,-67.0,-59.0,-90.0,-93.0,-89.0,-92.0,20.0,23.0,22.0,33.0,0
5948,BA:8C:B9:54:50:24,3830165,488630324,4731,6151455,3825434,482478869,0,8362,1650378,8340,1646883,22,3495,2324,14,5112,36,0,53,229410.0,130000.0,-40.0,-37.0,-45.0,-51.0,-44.0,-36.0,-44.0,-48.0,-90.0,-93.0,-89.0,-92.0,50.0,56.0,44.0,41.0,0
5949,92:69:1D:31:68:E9,3829183,486058738,3746,3579607,3825437,482479131,0,4166,1040666,4049,1014406,117,26260,2000,7,3880,80,0,36,216660.0,130000.0,-52.0,-50.0,-44.0,-46.0,-51.0,-49.0,-43.0,-47.0,-90.0,-93.0,-89.0,-92.0,38.0,43.0,45.0,46.0,0
5950,CC:2F:71:3F:1F:24,4464927,1184108743,639490,701629612,3825437,482479131,37,524011,564292386,523377,564216098,634,76288,506329,10,639727,62622,34,451,117000.0,39000.0,-67.0,-65.0,-70.0,-67.0,-67.0,-65.0,-70.0,-67.0,-90.0,-93.0,-89.0,-92.0,23.0,28.0,19.0,25.0,0
5951,CC:2F:71:3E:C5:1F,3826208,482573367,769,94034,3825439,482479333,0,3218,270296,2656,203536,562,66760,814,8,1107,18,0,37,130000.0,39000.0,-70.0,-70.0,-67.0,-59.0,-70.0,-70.0,-67.0,-59.0,-90.0,-93.0,-89.0,-92.0,20.0,23.0,22.0,33.0,0
5952,BA:8C:B9:54:50:24,3830170,488630788,4731,6151455,3825439,482479333,0,8362,1650378,8340,1646883,22,3495,2324,14,5112,36,0,53,229410.0,130000.0,-40.0,-37.0,-45.0,-51.0,-44.0,-36.0,-44.0,-48.0,-90.0,-93.0,-89.0,-92.0,50.0,56.0,44.0,41.0,0
5953,92:69:1D:31:68:E9,3829187,486059142,3746,3579607,3825441,482479535,0,4166,1040666,4049,1014406,117,26260,2000,7,3880,80,0,36,216660.0,130000.0,-52.0,-50.0,-44.0,-46.0,-51.0,-49.0,-43.0,-47.0,-90.0,-93.0,-89.0,-92.0,38.0,43.0,45.0,46.0,0
5954,CC:2F:71:3F:1F:24,4464974,1184123643,639532,701644040,3825442,482479603,37,524036,564297190,523402,564220902,634,76288,506354,10,639769,62626,34,451,130000.0,43333.0,-67.0,-65.0,-71.0,-68.0,-67.0,-65.0,-70.0,-67.0,-90.0,-93.0,-89.0,-92.0,23.0,28.0,18.0,24.0,0
5955,CC:2F:71:3E:C5:1F,3826212,482573771,769,94034,3825443,482479737,0,3218,270296,2656,203536,562,66760,814,8,1107,18,0,37,130000.0,39000.0,-70.0,-70.0,-67.0,-59.0,-70.0,-70.0,-67.0,-59.0,-90.0,-93.0,-89.0,-92.0,20.0,23.0,22.0,33.0,0
5956,BA:8C:B9:54:50:24,3830174,488631192,4731,6151455,3825443,482479737,0,8362,1650378,8340,1646883,22,3495,2324,14,5112,36,0,53,229410.0,130000.0,-40.0,-37.0,-45.0,-51.0,-44.0,-36.0,-44.0,-48.0,-90.0,-93.0,-89.0,-92.0,50.0,56.0,44.0,41.0,0
5957,92:69:1D:31:68:E9,3829191,486059546,3746,3579607,3825445,482479939,0,4166,1040666,4049,1014406,117,26260,2000,7,3880,80,0,36,216660.0,130000.0,-52.0,-50.0,-44.0,-46.0,-51.0,-49.0,-43.0,-47.0,-90.0,-93.0,-89.0,-92.0,38.0,43.0,45.0,46.0,0
5958,CC:2F:71:3F:1F:24,4465020,1184138587,639575,701658648,3825445,482479939,37,524061,564301994,523427,564225706,634,76288,506379,10,639812,62633,34,451,130000.0,39000.0,-67.0,-65.0,-70.0,-67.0,-67.0,-65.0,-70.0,-67.0,-90.0,-93.0,-89.0,-92.0,23.0,28.0,19.0,25.0,0
5959,CC:2F:71:3E:C5:1F,3826215,482574033,769,94034,3825446,482479999,0,3218,270296,2656,203536,562,66760,814,8,1107,18,0,37,130000.0,39000.0,-70.0,-70.0,-67.0,-59.0,-70.0,-70.0,-67.0,-59.0,-90.0,-93.0,-89.0,-92.0,20.0,23.0,22.0,33.0,0
5960,BA:8C:B9:54:50:24,3830179,488631656,4731,6151455,3825448,482480201,0,8362,1650378,8340,1646883,22,3495,2324,14,5112,36,0,53,229410.0,130000.0,-40.0,-37.0,-45.0,-51.0,-44.0,-36.0,-44.0,-48.0,-90.0,-93.0,-89.0,-92.0,50.0,56.0,44.0,41.0,0
5961,92:69:1D:31:68:E9,3829196,486060010,3746,3579607,3825450,482480403,0,4166,1040666,4049,1014406,117,26260,2000,7,3880,80,0,36,216660.0,130000.0,-52.0,-50.0,-44.0,-46.0,-51.0,-49.0,-43.0,-47.0,-90.0,-93.0,-89.0,-92.0,38.0,43.0,45.0,46.0,0
5962,CC:2F:71:3F:1F:24,4465069,1184153737,639617,701673132,3825452,482480605,37,524086,564306798,523452,564230510,634,76288,506404,10,639854,62658,34,451,130000.0,39000.0,-67.0,-65.0,-70.0,-67.0,-67.0,-65.0,-70.0,-67.0,-90.0,-93.0,-89.0,-92.0,23.0,28.0,19.0,25.0,0
5963,CC:2F:71:3E:C5:1F,3826221,482574639,769,94034,3825452,482480605,0,3218,270296,2656,203536,562,66760,814,8,1107,18,0,37,130000.0,39000.0,-70.0,-70.0,-67.0,-59.0,-70.0,-70.0,-67.0,-59.0,-90.0,-93.0,-89.0,-92.0,20.0,23.0,22.0,33.0,0
5964,BA:8C:B9:54:50:24,3830183,488632060,4731,6151455,3825452,482480605,0,8362,1650378,8340,1646883,22,3495,2324,14,5112,36,0,53,229410.0,130000.0,-40.0,-37.0,-45.0,-51.0,-44.0,-36.0,-44.0,-48.0,-90.0,-93.0,-89.0,-92.0,50.0,56.0,44.0,41.0,0
5965,92:69:1D:31:68:E9,3829200,486060414,3746,3579607,3825454,482480807,0,4166,1040666,4049,1014406,117,26260,2000,7,3880,80,0,36,216660.0,130000.0,-52.0,-50.0,-44.0,-46.0,-51.0,-49.0,-43.0,-47.0,-90.0,-93.0,-90.0,-93.0,38.0,43.0,46.0,47.0,0
5966,CC:2F:71:3F:1F:24,4465112,1184168243,639658,701687436,3825454,482480807,37,524112,564311742,523478,564235454,634,76288,506430,10,639895,62664,34,451,130000.0,43333.0,-67.0,-65.0,-70.0,-68.0,-67.0,-65.0,-70.0,-67.0,-90.0,-93.0,-90.0,-93.0,23.0,28.0,20.0,25.0,0
5967,CC:2F:71:3E:C5:1F,3826223,482574841,769,94034,3825454,482480807,0,3218,270296,2656,203536,562,66760,814,8,1107,18,0,37,130000.0,39000.0,-70.0,-70.0,-67.0,-59.0,-70.0,-70.0,-67.0,-59.0,-90.0,-93.0,-90.0,-93.0,20.0,23.0,23.0,34.0,0
5968,BA:8C:B9:54:50:24,3830187,488632464,4731,6151455,3825456,482481009,0,8362,1650378,8340,1646883,22,3495,2324,14,5112,36,0,53,229410.0,130000.0,-40.0,-37.0,-45.0,-51.0,-44.0,-36.0,-44.0,-48.0,-90.0,-93.0,-90.0,-93.0,50.0,56.0,45.0,42.0,0
5969,92:69:1D:31:68:E9,3829205,486060878,3746,3579607,3825459,482481271,0,4166,1040666,4049,1014406,117,26260,2000,7,3880,80,0,36,216660.0,130000.0,-52.0,-50.0,-44.0,-46.0,-51.0,-49.0,-43.0,-47.0,-90.0,-93.0,-90.0,-93.0,38.0,43.0,46.0,47.0,0
5970,CC:2F:71:3F:1F:24,4465161,1184183337,639700,701701864,3825461,482481473,37,524137,564316546,523503,564240258,634,76288,506455,10,639937,62682,34,451,117000.0,39000.0,-67.0,-65.0,-70.0,-67.0,-67.0,-65.0,-70.0,-67.0,-90.0,-93.0,-90.0,-93.0,23.0,28.0,20.0,26.0,0
5971,CC:2F:71:3E:C5:1F,3826230,482575507,769,94034,3825461,482481473,0,3218,270296,2656,203536,562,66760,814,8,1107,18,0,37,130000.0,39000.0,-70.0,-70.0,-67.0,-59.0,-70.0,-70.0,-67.0,-59.0,-90.0,-93.0,-90.0,-93.0,20.0,23.0,23.0,34.0,0
5972,BA:8C:B9:54:50:24,3830192,488632928,4731,6151455,3825461,482481473,0,8366,1650650,8344,1647155,22,3495,2324,14,5112,36,0,53,229410.0,130000.0,-40.0,-37.0,-45.0,-51.0,-43.0,-36.0,-43.0,-49.0,-90.0,-93.0,-90.0,-93.0,50.0,56.0,45.0,42.0,0
5973,92:69:1D:31:68:E9,3829209,486061282,3746,3579607,3825463,482481675,0,4166,1040666,4049,1014406,117,26260,2000,7,3880,80,0,36,216660.0,130000.0,-52.0,-50.0,-44.0,-46.0,-51.0,-49.0,-43.0,-47.0,-90.0,-93.0,-90.0,-93.0,38.0,43.0,46.0,47.0,0
5974,CC:2F:71:3F:1F:24,4465205,1184197967,639742,701716292,3825463,482481675,37,524162,564321350,523528,564245062,634,76288,506480,10,639979,62685,34,451,130000.0,43333.0,-67.0,-65.0,-70.0,-67.0,-67.0,-65.0,-70.0,-67.0,-90.0,-93.0,-90.0,-93.0,23.0,28.0,20.0,26.0,0
5975,CC:2F:71:3E:C5:1F,3826232,482575709,769,94034,3825463,482481675,0,3218,270296,2656,203536,562,66760,814,8,1107,18,0,37,130000.0,39000.0,-70.0,-70.0,-67.0,-59.0,-70.0,-70.0,-67.0,-59.0,-90.0,-93.0,-90.0,-93.0,20.0,23.0,23.0,34.0,0
5976,BA:8C:B9:54:50:24,3830196,488633332,4731,6151455,3825465,482481877,0,8366,1650650,8344,1647155,22,3495,2324,14,5112,36,0,53,229410.0,130000.0,-40.0,-37.0,-45.0,-51.0,-43.0,-36.0,-43.0,-49.0,-90.0,-93.0,-90.0,-93.0,50.0,56.0,45.0,42.0,0
5977,92:69:1D:31:68:E9,3829215,486061888,3746,3579607,3825469,482482281,0,4166,1040666,4049,1014406,117,26260,2000,7,3880,80,0,36,216660.0,130000.0,-52.0,-50.0,-44.0,-46.0,-51.0,-49.0,-43.0,-47.0,-90.0,-93.0,-90.0,-93.0,38.0,43.0,46.0,47.0,0
5978,CC:2F:71:3F:1F:24,4465253,1184213113,639784,701730832,3825469,482482281,37,524188,564326294,523554,564250006,634,76288,506506,10,640021,62688,34,451,130000.0,43333.0,-67.0,-65.0,-70.0,-67.0,-67.0,-65.0,-70.0,-67.0,-90.0,-93.0,-90.0,-93.0,23.0,28.0,20.0,26.0,0
5979,CC:2F:71:3E:C5:1F,3826238,482576315,769,94034,3825469,482482281,0,3218,270296,2656,203536,562,66760,814,8,1107,18,0,37,130000.0,39000.0,-70.0,-70.0,-67.0,-59.0,-70.0,-70.0,-67.0,-59.0,-90.0,-93.0,-90.0,-93.0,20.0,23.0,23.0,34.0,0
5980,BA:8C:B9:54:50:24,3830200,488633736,4731,6151455,3825469,482482281,0,8366,1650650,8344,1647155,22,3495,2324,14,5112,36,0,53,229410.0,130000.0,-40.0,-37.0,-45.0,-51.0,-43.0,-36.0,-43.0,-49.0,-90.0,-93.0,-90.0,-93.0,50.0,56.0,45.0,42.0,0
5981,92:69:1D:31:68:E9,3829218,486062150,3746,3579607,3825472,482482543,0,4167,1040734,4050,1014474,117,26260,2000,7,3880,80,0,36,216660.0,130000.0,-50.0,-47.0,-42.0,-48.0,-51.0,-48.0,-43.0,-48.0,-90.0,-93.0,-90.0,-93.0,40.0,46.0,48.0,45.0,0
5982,CC:2F:71:3F:1F:24,4465301,1184228129,639827,701745384,3825474,482482745,37,524214,564331214,523580,564254926,634,76288,506532,10,640064,62706,34,451,117000.0,39000.0,-67.0,-65.0,-70.0,-68.0,-67.0,-65.0,-70.0,-67.0,-90.0,-93.0,-90.0,-93.0,23.0,28.0,20.0,25.0,0
5983,CC:2F:71:3E:C5:1F,3826243,482576779,769,94034,3825474,482482745,0,3218,270296,2656,203536,562,66760,814,8,1107,18,0,37,130000.0,39000.0,-70.0,-70.0,-67.0,-59.0,-70.0,-70.0,-67.0,-59.0,-90.0,-93.0,-90.0,-93.0,20.0,23.0,23.0,34.0,0
5984,BA:8C:B9:54:50:24,3830205,488634200,4731,6151455,3825474,482482745,0,8366,1650650,8344,1647155,22,3495,2324,14,5112,36,0,53,229410.0,130000.0,-40.0,-37.0,-45.0,-51.0,-43.0,-36.0,-43.0,-49.0,-90.0,-93.0,-90.0,-93.0,50.0,56.0,45.0,42.0,0
5985,92:69:1D:31:68:E9,3829224,486062756,3746,3579607,3825478,482483149,0,4167,1040734,4050,1014474,117,26260,2000,7,3880,80,0,36,216660.0,130000.0,-50.0,-47.0,-42.0,-48.0,-51.0,-48.0,-43.0,-48.0,-90.0,-93.0,-90.0,-93.0,40.0,46.0,48.0,45.0,0
5986,CC:2F:71:3F:1F:24,4465347,1184242961,639869,701759812,3825478,482483149,37,524241,564336298,523607,564260010,634,76288,506559,10,640106,62715,34,451,130000.0,43333.0,-67.0,-65.0,-71.0,-67.0,-67.0,-65.0,-70.0,-67.0,-90.0,-93.0,-90.0,-93.0,23.0,28.0,19.0,26.0,0
5987,CC:2F:71:3E:C5:1F,3826247,482577183,769,94034,3825478,482483149,0,3218,270296,2656,203536,562,66760,814,8,1107,18,0,37,130000.0,39000.0,-70.0,-70.0,-67.0,-59.0,-70.0,-70.0,-67.0,-59.0,-90.0,-93.0,-90.0,-93.0,20.0,23.0,23.0,34.0,0
5988,BA:8C:B9:54:50:24,3830209,488634604,4731,6151455,3825478,482483149,0,8366,1650650,8344,1647155,22,3495,2324,14,5112,36,0,53,229410.0,130000.0,-40.0,-37.0,-45.0,-51.0,-43.0,-36.0,-43.0,-49.0,-90.0,-93.0,-90.0,-93.0,50.0,56.0,45.0,42.0,0
5989,92:69:1D:31:68:E9,3829227,486063018,3746,3579607,3825481,482483411,0,4167,1040734,4050,1014474,117,26260,2000,7,3880,80,0,36,216660.0,130000.0,-50.0,-47.0,-42.0,-48.0,-51.0,-48.0,-43.0,-48.0,-90.0,-93.0,-90.0,-93.0,40.0,46.0,48.0,45.0,0
5990,CC:2F:71:3F:1F:24,4465391,1184257527,639910,701774116,3825481,482483411,37,524267,564341242,523633,564264954,634,76288,506585,10,640147,62756,34,451,144444.0,39000.0,-67.0,-65.0,-70.0,-67.0,-67.0,-65.0,-70.0,-67.0,-90.0,-93.0,-90.0,-93.0,23.0,28.0,20.0,26.0,0
5991,CC:2F:71:3E:C5:1F,3826252,482577647,769,94034,3825483,482483613,0,3218,270296,2656,203536,562,66760,814,8,1107,18,0,37,130000.0,39000.0,-70.0,-70.0,-67.0,-59.0,-70.0,-70.0,-67.0,-59.0,-90.0,-93.0,-90.0,-93.0,20.0,23.0,23.0,34.0,0
5992,BA:8C:B9:54:50:24,3830214,488635068,4731,6151455,3825483,482483613,0,8366,1650650,8344,1647155,22,3495,2324,14,5112,36,0,53,229410.0,130000.0,-40.0,-37.0,-45.0,-51.0,-43.0,-36.0,-43.0,-49.0,-90.0,-93.0,-90.0,-93.0,50.0,56.0,45.0,42.0,0
5993,92:69:1D:31:68:E9,3829234,486063740,3747,3579723,3825487,482484017,0,4169,1040870,4052,1014610,117,26260,2000,7,3881,80,0,36,216660.0,130000.0,-52.0,-51.0,-44.0,-46.0,-51.0,-48.0,-42.0,-47.0,-90.0,-93.0,-90.0,-93.0,38.0,42.0,46.0,47.0,0
5994,CC:2F:71:3F:1F:24,4465440,1184272677,639953,701788660,3825487,482484017,37,524292,564346046,523658,564269758,634,76288,506610,10,640190,62768,34,451,130000.0,43333.0,-67.0,-65.0,-70.0,-67.0,-67.0,-65.0,-70.0,-67.0,-90.0,-93.0,-90.0,-93.0,23.0,28.0,20.0,26.0,0
5995,CC:2F:71:3E:C5:1F,3826257,482578167,770,94150,3825487,482484017,0,3220,270436,2658,203676,562,66760,814,8,1108,18,0,37,130000.0,39000.0,-70.0,-71.0,-68.0,-60.0,-70.0,-70.0,-67.0,-59.0,-90.0,-93.0,-90.0,-93.0,20.0,22.0,22.0,33.0,0
5996,BA:8C:B9:54:50:24,3830219,488635588,4732,6151571,3825487,482484017,0,8368,1650786,8346,1647291,22,3495,2324,14,5113,36,0,53,229410.0,130000.0,-40.0,-37.0,-45.0,-51.0,-43.0,-36.0,-43.0,-48.0,-90.0,-93.0,-90.0,-93.0,50.0,56.0,45.0,42.0,0
5997,92:69:1D:31:68:E9,3829237,486064215,3747,3579723,3825490,482484492,0,4169,1040870,4052,1014610,117,26260,2000,7,3881,80,0,36,216660.0,130000.0,-52.0,-51.0,-44.0,-46.0,-51.0,-48.0,-42.0,-47.0,-90.0,-93.0,-90.0,-93.0,38.0,42.0,46.0,47.0,0
5998,CC:2F:71:3F:1F:24,4465485,1184287692,639995,701803200,3825490,482484492,37,524317,564350850,523683,564274562,634,76288,506635,10,640232,62772,34,451,130000.0,43333.0,-67.0,-65.0,-71.0,-68.0,-67.0,-65.0,-70.0,-67.0,-90.0,-93.0,-90.0,-93.0,23.0,28.0,19.0,25.0,0
5999,CC:2F:71:3E:C5:1F,3826262,482578844,770,94150,3825492,482484694,0,3220,270436,2658,203676,562,66760,814,8,1108,18,0,37,130000.0,39000.0,-70.0,-71.0,-68.0,-60.0,-70.0,-70.0,-67.0,-59.0,-90.0,-93.0,-90.0,-93.0,20.0,22.0,22.0,33.0,0
6000,BA:8C:B9:54:50:24,3830224,488636265,4732,6151571,3825492,482484694,0,8368,1650786,8346,1647291,22,3495,2324,14,5113,36,0,53,229410.0,130000.0,-40.0,-37.0,-45.0,-51.0,-43.0,-36.0,-43.0,-48.0,-90.0,-93.0,-90.0,-93.0,50.0,56.0,45.0,42.0,0
6001,92:69:1D:31:68:E9,3829244,486064881,3747,3579723,3825497,482485158,0,4169,1040870,4052,1014610,117,26260,2000,7,3881,80,0,36,216660.0,130000.0,-52.0,-51.0,-44.0,-46.0,-51.0,-48.0,-42.0,-47.0,-90.0,-93.0,-90.0,-93.0,38.0,42.0,46.0,47.0,0
6002,CC:2F:71:3F:1F:24,4465534,1184302786,640037,701817628,3825497,482485158,37,524343,564355770,523709,564279482,634,76288,506661,10,640274,62782,34,451,117000.0,39000.0,-67.0,-65.0,-70.0,-67.0,-67.0,-65.0,-70.0,-67.0,-90.0,-93.0,-90.0,-93.0,23.0,28.0,20.0,26.0,0
6003,CC:2F:71:3E:C5:1F,3826268,482579368,770,94150,3825498,482485218,0,3220,270436,2658,203676,562,66760,814,8,1108,18,0,37,130000.0,39000.0,-70.0,-71.0,-68.0,-60.0,-70.0,-70.0,-67.0,-59.0,-90.0,-93.0,-90.0,-93.0,20.0,22.0,22.0,33.0,0
6004,BA:8C:B9:54:50:24,3830230,488636789,4732,6151571,3825498,482485218,0,8368,1650786,8346,1647291,22,3495,2324,14,5113,36,0,53,229410.0,130000.0,-40.0,-37.0,-45.0,-51.0,-43.0,-36.0,-43.0,-48.0,-90.0,-93.0,-90.0,-93.0,50.0,56.0,45.0,42.0,0
6005,92:69:1D:31:68:E9,3829247,486065143,3747,3579723,3825500,482485420,0,4169,1040870,4052,1014610,117,26260,2000,7,3881,80,0,36,216660.0,130000.0,-52.0,-51.0,-44.0,-46.0,-51.0,-48.0,-42.0,-47.0,-90.0,-93.0,-90.0,-93.0,38.0,42.0,46.0,47.0,0
6006,CC:2F:71:3F:1F:24,4465581,1184317668,640081,701832248,3825500,482485420,37,524371,564360994,523737,564284706,634,76288,506689,10,640318,62796,34,451,130000.0,39000.0,-67.0,-65.0,-70.0,-68.0,-67.0,-65.0,-70.0,-67.0,-90.0,-93.0,-90.0,-93.0,23.0,28.0,20.0,25.0,0
6007,CC:2F:71:3E:C5:1F,3826272,482579772,770,94150,3825502,482485622,0,3220,270436,2658,203676,562,66760,814,8,1108,18,0,37,130000.0,39000.0,-70.0,-71.0,-68.0,-60.0,-70.0,-70.0,-67.0,-59.0,-90.0,-93.0,-90.0,-93.0,20.0,22.0,22.0,33.0,0
6008,BA:8C:B9:54:50:24,3830234,488637193,4732,6151571,3825502,482485622,0,8368,1650786,8346,1647291,22,3495,2324,14,5113,36,0,53,229410.0,130000.0,-40.0,-37.0,-45.0,-51.0,-43.0,-36.0,-43.0,-48.0,-90.0,-93.0,-90.0,-93.0,50.0,56.0,45.0,42.0,0
6009,92:69:1D:31:68:E9,3829253,486065749,3747,3579723,3825506,482486026,0,4169,1040870,4052,1014610,117,26260,2000,7,3881,80,0,36,216660.0,130000.0,-52.0,-51.0,-44.0,-46.0,-51.0,-48.0,-42.0,-47.0,-90.0,-93.0,-90.0,-93.0,38.0,42.0,46.0,47.0,0
6010,CC:2F:71:3F:1F:24,4465629,1184332638,640122,701846552,3825507,482486086,37,524399,564366206,523765,564289918,634,76288,506717,10,640359,62811,34,451,130000.0,39000.0,-67.0,-65.0,-71.0,-68.0,-67.0,-65.0,-70.0,-67.0,-90.0,-93.0,-90.0,-93.0,23.0,28.0,19.0,25.0,0
6011,CC:2F:71:3E:C5:1F,3826277,482580236,770,94150,3825507,482486086,0,3220,270436,2658,203676,562,66760,814,8,1108,18,0,37,130000.0,39000.0,-70.0,-71.0,-68.0,-60.0,-70.0,-70.0,-67.0,-59.0,-90.0,-93.0,-89.0,-93.0,20.0,22.0,21.0,33.0,0
6012,BA:8C:B9:54:50:24,3830240,488637719,4732,6151571,3825508,482486148,0,8368,1650786,8346,1647291,22,3495,2324,14,5113,36,0,53,229410.0,130000.0,-40.0,-37.0,-45.0,-51.0,-43.0,-36.0,-43.0,-48.0,-90.0,-93.0,-89.0,-93.0,50.0,56.0,44.0,42.0,0
6013,92:69:1D:31:68:E9,3829260,486066841,3747,3579723,3825513,482487118,0,4169,1040870,4052,1014610,117,26260,2000,7,3881,80,0,36,216660.0,130000.0,-52.0,-51.0,-44.0,-46.0,-51.0,-48.0,-42.0,-47.0,-90.0,-93.0,-89.0,-93.0,38.0,42.0,45.0,47.0,0
6014,CC:2F:71:3F:1F:24,4465677,1184348154,640164,701861036,3825513,482487118,37,524425,564371128,523790,564294722,635,76406,506743,10,640401,62812,34,451,130000.0,43333.0,-67.0,-65.0,-70.0,-67.0,-67.0,-65.0,-70.0,-67.0,-90.0,-93.0,-89.0,-93.0,23.0,28.0,19.0,26.0,0
6015,CC:2F:71:3E:C5:1F,3826285,482581470,770,94150,3825515,482487320,0,3220,270436,2658,203676,562,66760,814,8,1108,18,0,37,130000.0,39000.0,-70.0,-71.0,-68.0,-60.0,-70.0,-70.0,-67.0,-59.0,-90.0,-93.0,-89.0,-93.0,20.0,22.0,21.0,33.0,0
6016,BA:8C:B9:54:50:24,3830248,488638951,4732,6151571,3825516,482487380,0,8368,1650786,8346,1647291,22,3495,2324,14,5113,36,0,53,229410.0,130000.0,-40.0,-37.0,-45.0,-51.0,-43.0,-36.0,-43.0,-48.0,-90.0,-93.0,-89.0,-93.0,50.0,56.0,44.0,42.0,0
6017,92:69:1D:31:68:E9,3829267,486067507,3747,3579723,3825520,482487784,0,4171,1041006,4054,1014746,117,26260,2000,7,3882,80,0,36,216660.0,130000.0,-52.0,-50.0,-44.0,-46.0,-51.0,-48.0,-43.0,-47.0,-90.0,-93.0,-89.0,-93.0,38.0,43.0,45.0,47.0,0
6018,CC:2F:71:3F:1F:24,4465726,1184363254,640206,701875470,3825520,482487784,37,524451,564376048,523816,564299642,635,76406,506769,10,640443,62821,34,451,117000.0,39000.0,-67.0,-65.0,-70.0,-68.0,-67.0,-65.0,-70.0,-67.0,-90.0,-93.0,-89.0,-93.0,23.0,28.0,19.0,25.0,0
6019,CC:2F:71:3E:C5:1F,3826290,482581934,770,94150,3825520,482487784,0,3222,270576,2660,203816,562,66760,814,8,1109,18,0,37,130000.0,39000.0,-70.0,-71.0,-67.0,-60.0,-70.0,-70.0,-67.0,-59.0,-90.0,-93.0,-89.0,-93.0,20.0,22.0,22.0,33.0,0
6020,BA:8C:B9:54:50:24,3830252,488639355,4732,6151571,3825520,482487784,0,8370,1650922,8348,1647427,22,3495,2324,14,5114,36,0,53,229410.0,130000.0,-40.0,-37.0,-45.0,-52.0,-43.0,-36.0,-43.0,-49.0,-90.0,-93.0,-89.0,-93.0,50.0,56.0,44.0,41.0,0
6021,92:69:1D:31:68:E9,3829270,486067769,3747,3579723,3825523,482488046,0,4171,1041006,4054,1014746,117,26260,2000,7,3882,80,0,36,216660.0,130000.0,-52.0,-50.0,-44.0,-46.0,-51.0,-48.0,-43.0,-47.0,-90.0,-93.0,-89.0,-93.0,38.0,43.0,45.0,47.0,0
6022,CC:2F:71:3F:1F:24,4465772,1184378068,640249,701890022,3825523,482488046,37,524480,564381364,523845,564304958,635,76406,506798,10,640486,62828,34,451,130000.0,43333.0,-67.0,-65.0,-70.0,-68.0,-67.0,-65.0,-70.0,-67.0,-90.0,-93.0,-89.0,-93.0,23.0,28.0,19.0,25.0,0
6023,CC:2F:71:3E:C5:1F,3826295,482582398,770,94150,3825525,482488248,0,3222,270576,2660,203816,562,66760,814,8,1109,18,0,37,130000.0,39000.0,-70.0,-71.0,-67.0,-60.0,-70.0,-70.0,-67.0,-59.0,-90.0,-93.0,-89.0,-93.0,20.0,22.0,22.0,33.0,0
6024,BA:8C:B9:54:50:24,3830257,488639819,4732,6151571,3825525,482488248,0,8370,1650922,8348,1647427,22,3495,2324,14,5114,36,0,53,229410.0,130000.0,-40.0,-37.0,-45.0,-52.0,-43.0,-36.0,-43.0,-49.0,-90.0,-93.0,-89.0,-93.0,50.0,56.0,44.0,41.0,0
6025,92:69:1D:31:68:E9,3829276,486068375,3747,3579723,3825529,482488652,0,4171,1041006,4054,1014746,117,26260,2000,7,3882,80,0,36,216660.0,130000.0,-52.0,-50.0,-44.0,-46.0,-51.0,-48.0,-43.0,-47.0,-90.0,-93.0,-89.0,-93.0,38.0,43.0,45.0,47.0,0
6026,CC:2F:71:3F:1F:24,4465820,1184393158,640291,701904506,3825529,482488652,37,524506,564386344,523871,564309938,635,76406,506824,10,640528,62832,34,451,130000.0,39000.0,-67.0,-65.0,-70.0,-68.0,-67.0,-65.0,-70.0,-67.0,-90.0,-93.0,-89.0,-93.0,23.0,28.0,19.0,25.0,0
6027,CC:2F:71:3E:C5:1F,3826299,482582802,770,94150,3825529,482488652,0,3222,270576,2660,203816,562,66760,814,8,1109,18,0,37,130000.0,39000.0,-70.0,-71.0,-67.0,-60.0,-70.0,-70.0,-67.0,-59.0,-90.0,-93.0,-89.0,-93.0,20.0,22.0,22.0,33.0,0
6028,BA:8C:B9:54:50:24,3830261,488640223,4732,6151571,3825529,482488652,0,8370,1650922,8348,1647427,22,3495,2324,14,5114,36,0,53,229410.0,130000.0,-40.0,-37.0,-45.0,-52.0,-43.0,-36.0,-43.0,-49.0,-90.0,-93.0,-89.0,-93.0,50.0,56.0,44.0,41.0,0
6029,92:69:1D:31:68:E9,3829278,486068577,3747,3579723,3825531,482488854,0,4171,1041006,4054,1014746,117,26260,2000,7,3882,80,0,36,216660.0,130000.0,-52.0,-50.0,-44.0,-46.0,-51.0,-48.0,-43.0,-47.0,-90.0,-93.0,-89.0,-93.0,38.0,43.0,45.0,47.0,0
6030,CC:2F:71:3F:1F:24,4465867,1184408172,640336,701919318,3825531,482488854,37,524532,564391288,523897,564314882,635,76406,506850,10,640573,62852,34,451,130000.0,39000.0,-67.0,-65.0,-70.0,-67.0,-67.0,-65.0,-70.0,-67.0,-90.0,-93.0,-89.0,-93.0,23.0,28.0,19.0,26.0,0
6031,CC:2F:71:3E:C5:1F,3826301,482583004,770,94150,3825531,482488854,0,3222,270576,2660,203816,562,66760,814,8,1109,18,0,37,130000.0,39000.0,-70.0,-71.0,-67.0,-60.0,-70.0,-70.0,-67.0,-59.0,-90.0,-93.0,-89.0,-93.0,20.0,22.0,22.0,33.0,0
6032,BA:8C:B9:54:50:24,3830263,488640425,4732,6151571,3825531,482488854,0,8370,1650922,8348,1647427,22,3495,2324,14,5114,36,0,53,229410.0,130000.0,-40.0,-37.0,-45.0,-52.0,-43.0,-36.0,-43.0,-49.0,-90.0,-93.0,-89.0,-93.0,50.0,56.0,44.0,41.0,0
6033,92:69:1D:31:68:E9,3829285,486069243,3747,3579723,3825538,482489520,0,4171,1041006,4054,1014746,117,26260,2000,7,3882,80,0,36,216660.0,130000.0,-52.0,-50.0,-44.0,-46.0,-51.0,-48.0,-43.0,-47.0,-90.0,-93.0,-90.0,-93.0,38.0,43.0,46.0,47.0,0
6034,CC:2F:71:3F:1F:24,4465917,1184423446,640379,701933926,3825538,482489520,37,524560,564396488,523925,564320082,635,76406,506878,10,640615,62856,34,451,130000.0,43333.0,-67.0,-65.0,-70.0,-67.0,-67.0,-65.0,-70.0,-67.0,-90.0,-93.0,-90.0,-93.0,23.0,28.0,20.0,26.0,0
6035,CC:2F:71:3E:C5:1F,3826308,482583670,770,94150,3825538,482489520,0,3222,270576,2660,203816,562,66760,814,8,1109,18,0,37,130000.0,39000.0,-70.0,-71.0,-67.0,-60.0,-70.0,-70.0,-67.0,-59.0,-90.0,-93.0,-90.0,-93.0,20.0,22.0,23.0,33.0,0
6036,BA:8C:B9:54:50:24,3830270,488641091,4732,6151571,3825538,482489520,0,8370,1650922,8348,1647427,22,3495,2324,14,5114,36,0,53,229410.0,130000.0,-40.0,-37.0,-45.0,-52.0,-43.0,-36.0,-43.0,-49.0,-90.0,-93.0,-90.0,-93.0,50.0,56.0,45.0,41.0,0
6037,92:69:1D:31:68:E9,3829287,486069445,3747,3579723,3825540,482489722,0,4171,1041006,4054,1014746,117,26260,2000,7,3882,80,0,36,216660.0,130000.0,-52.0,-50.0,-44.0,-46.0,-51.0,-48.0,-43.0,-47.0,-90.0,-93.0,-90.0,-93.0,38.0,43.0,46.0,47.0,0
6038,CC:2F:71:3F:1F:24,4465962,1184438340,640422,701948618,3825540,482489722,37,524587,564401536,523952,564325130,635,76406,506905,10,640659,62872,34,451,117000.0,39000.0,-67.0,-65.0,-70.0,-67.0,-67.0,-65.0,-70.0,-67.0,-90.0,-93.0,-90.0,-93.0,23.0,28.0,20.0,26.0,0
6039,CC:2F:71:3E:C5:1F,3826310,482583872,770,94150,3825540,482489722,0,3222,270576,2660,203816,562,66760,814,8,1109,18,0,37,130000.0,39000.0,-70.0,-71.0,-67.0,-60.0,-70.0,-70.0,-67.0,-59.0,-90.0,-93.0,-90.0,-93.0,20.0,22.0,23.0,33.0,0
6040,BA:8C:B9:54:50:24,3830274,488641495,4732,6151571,3825542,482489924,0,8370,1650922,8348,1647427,22,3495,2324,14,5114,36,0,53,229410.0,130000.0,-40.0,-37.0,-45.0,-52.0,-43.0,-36.0,-43.0,-49.0,-90.0,-93.0,-90.0,-93.0,50.0,56.0,45.0,41.0,0
6041,92:69:1D:31:68:E9,3829294,486070031,3747,3579723,3825547,482490308,0,4171,1041006,4054,1014746,117,26260,2000,7,3882,80,0,36,216660.0,130000.0,-52.0,-50.0,-44.0,-46.0,-51.0,-48.0,-43.0,-47.0,-90.0,-93.0,-89.0,-93.0,38.0,43.0,45.0,47.0,0
6042,CC:2F:71:3F:1F:24,4466013,1184453500,640464,701962990,3825549,482490510,37,524612,564406340,523977,564329934,635,76406,506930,10,640701,62879,34,451,130000.0,39000.0,-67.0,-65.0,-70.0,-67.0,-67.0,-65.0,-70.0,-67.0,-90.0,-93.0,-89.0,-93.0,23.0,28.0,19.0,26.0,0
6043,CC:2F:71:3E:C5:1F,3826319,482584660,770,94150,3825549,482490510,0,3224,270764,2661,203886,563,66878,815,8,1109,18,0,37,130000.0,39000.0,-70.0,-71.0,-67.0,-60.0,-70.0,-70.0,-67.0,-59.0,-90.0,-93.0,-89.0,-93.0,20.0,22.0,22.0,33.0,0
6044,BA:8C:B9:54:50:24,3830281,488642081,4732,6151571,3825549,482490510,0,8370,1650922,8348,1647427,22,3495,2324,14,5114,36,0,53,229410.0,130000.0,-40.0,-37.0,-45.0,-52.0,-43.0,-36.0,-43.0,-49.0,-90.0,-93.0,-89.0,-93.0,50.0,56.0,44.0,41.0,0
6045,92:69:1D:31:68:E9,3829298,486070435,3747,3579723,3825551,482490712,0,4171,1041006,4054,1014746,117,26260,2000,7,3882,80,0,36,216660.0,130000.0,-52.0,-50.0,-44.0,-46.0,-51.0,-48.0,-43.0,-47.0,-90.0,-93.0,-89.0,-93.0,38.0,43.0,45.0,47.0,0
6046,CC:2F:71:3F:1F:24,4466056,1184468006,640505,701977294,3825551,482490712,37,524638,564411284,524003,564334878,635,76406,506956,10,640742,62895,34,451,130000.0,39000.0,-67.0,-65.0,-70.0,-68.0,-67.0,-65.0,-70.0,-67.0,-90.0,-93.0,-89.0,-93.0,23.0,28.0,19.0,25.0,0
6047,CC:2F:71:3E:C5:1F,3826321,482584862,770,94150,3825551,482490712,0,3224,270764,2661,203886,563,66878,815,8,1109,18,0,37,130000.0,39000.0,-70.0,-71.0,-67.0,-60.0,-70.0,-70.0,-67.0,-59.0,-90.0,-93.0,-89.0,-93.0,20.0,22.0,22.0,33.0,0
6048,BA:8C:B9:54:50:24,3830283,488642283,4732,6151571,3825551,482490712,0,8370,1650922,8348,1647427,22,3495,2324,14,5114,36,0,53,229410.0,130000.0,-40.0,-37.0,-45.0,-52.0,-43.0,-36.0,-43.0,-49.0,-90.0,-93.0,-89.0,-93.0,50.0,56.0,44.0,41.0,0
6049,92:69:1D:31:68:E9,3829305,486071314,3747,3579723,3825558,482491591,0,4171,1041006,4054,1014746,117,26260,2000,7,3882,80,0,36,216660.0,130000.0,-52.0,-50.0,-44.0,-46.0,-51.0,-48.0,-43.0,-47.0,-90.0,-93.0,-89.0,-93.0,38.0,43.0,45.0,47.0,0
6050,CC:2F:71:3F:1F:24,4466105,1184483369,640547,701991778,3825558,482491591,37,524663,564416088,524028,564339682,635,76406,506981,10,640784,62903,34,451,130000.0,43333.0,-67.0,-65.0,-70.0,-67.0,-67.0,-65.0,-70.0,-67.0,-90.0,-93.0,-89.0,-93.0,23.0,28.0,19.0,26.0,0
6051,CC:2F:71:3E:C5:1F,3826328,482585741,770,94150,3825558,482491591,0,3224,270764,2661,203886,563,66878,815,8,1109,18,0,37,130000.0,39000.0,-70.0,-71.0,-67.0,-60.0,-70.0,-70.0,-67.0,-59.0,-90.0,-93.0,-89.0,-93.0,20.0,22.0,22.0,33.0,0
6052,BA:8C:B9:54:50:24,3830290,488643162,4732,6151571,3825558,482491591,0,8370,1650922,8348,1647427,22,3495,2324,14,5114,36,0,53,229410.0,130000.0,-40.0,-37.0,-45.0,-52.0,-43.0,-36.0,-43.0,-49.0,-90.0,-93.0,-89.0,-93.0,50.0,56.0,44.0,41.0,0
6053,92:69:1D:31:68:E9,3829308,486071576,3747,3579723,3825561,482491853,0,4171,1041006,4054,1014746,117,26260,2000,7,3882,80,0,36,216660.0,130000.0,-52.0,-50.0,-44.0,-46.0,-51.0,-48.0,-43.0,-47.0,-90.0,-93.0,-90.0,-93.0,38.0,43.0,46.0,47.0,0
6054,CC:2F:71:3F:1F:24,4466148,1184497811,640587,702005958,3825561,482491853,37,524691,564421240,524056,564344834,635,76406,507009,10,640824,62908,34,451,117000.0,39000.0,-67.0,-65.0,-70.0,-67.0,-67.0,-65.0,-70.0,-67.0,-90.0,-93.0,-90.0,-93.0,23.0,28.0,20.0,26.0,0
6055,CC:2F:71:3E:C5:1F,3826331,482586003,770,94150,3825561,482491853,0,3224,270764,2661,203886,563,66878,815,8,1109,18,0,37,130000.0,39000.0,-70.0,-71.0,-67.0,-60.0,-70.0,-70.0,-67.0,-59.0,-90.0,-93.0,-90.0,-93.0,20.0,22.0,23.0,33.0,0
6056,BA:8C:B9:54:50:24,3830293,488643424,4732,6151571,3825561,482491853,0,8371,1650990,8349,1647495,22,3495,2324,14,5114,36,0,53,229410.0,130000.0,-40.0,-36.0,-45.0,-52.0,-43.0,-36.0,-43.0,-49.0,-90.0,-93.0,-90.0,-93.0,50.0,57.0,45.0,41.0,0
6057,92:69:1D:31:68:E9,3829314,486072182,3747,3579723,3825567,482492459,0,4171,1041006,4054,1014746,117,26260,2000,7,3882,80,0,36,216660.0,130000.0,-52.0,-50.0,-44.0,-46.0,-51.0,-48.0,-43.0,-47.0,-90.0,-93.0,-90.0,-93.0,38.0,43.0,46.0,47.0,0
6058,CC:2F:71:3F:1F:24,4466196,1184512789,640629,702020330,3825567,482492459,37,524720,564426556,524085,564350150,635,76406,507038,10,640866,62916,34,451,130000.0,39000.0,-67.0,-65.0,-70.0,-67.0,-67.0,-65.0,-70.0,-67.0,-90.0,-93.0,-90.0,-93.0,23.0,28.0,20.0,26.0,0
6059,CC:2F:71:3E:C5:1F,3826337,482586609,770,94150,3825567,482492459,0,3224,270764,2661,203886,563,66878,815,8,1109,18,0,37,130000.0,39000.0,-70.0,-71.0,-67.0,-60.0,-70.0,-70.0,-67.0,-59.0,-90.0,-93.0,-90.0,-93.0,20.0,22.0,23.0,33.0,0
6060,BA:8C:B9:54:50:24,3830299,488644030,4732,6151571,3825567,482492459,0,8371,1650990,8349,1647495,22,3495,2324,14,5114,36,0,53,229410.0,130000.0,-40.0,-36.0,-45.0,-52.0,-43.0,-36.0,-43.0,-49.0,-90.0,-93.0,-90.0,-93.0,50.0,57.0,45.0,41.0,0
6061,92:69:1D:31:68:E9,3829316,486072384,3747,3579723,3825569,482492661,0,4171,1041006,4054,1014746,117,26260,2000,7,3882,80,0,36,216660.0,130000.0,-52.0,-50.0,-44.0,-46.0,-51.0,-48.0,-43.0,-47.0,-90.0,-93.0,-90.0,-93.0,38.0,43.0,46.0,47.0,0
6062,CC:2F:71:3F:1F:24,4466239,1184527239,640670,702034578,3825569,482492661,37,524748,564431756,524113,564355350,635,76406,507066,10,640907,62936,34,451,130000.0,43333.0,-67.0,-65.0,-70.0,-67.0,-67.0,-65.0,-70.0,-67.0,-90.0,-93.0,-90.0,-93.0,23.0,28.0,20.0,26.0,0
6063,CC:2F:71:3E:C5:1F,3826340,482586871,770,94150,3825570,482492721,0,3224,270764,2661,203886,563,66878,815,8,1109,18,0,37,130000.0,39000.0,-70.0,-71.0,-67.0,-60.0,-70.0,-70.0,-67.0,-59.0,-90.0,-93.0,-90.0,-93.0,20.0,22.0,23.0,33.0,0
6064,BA:8C:B9:54:50:24,3830302,488644292,4732,6151571,3825570,482492721,0,8371,1650990,8349,1647495,22,3495,2324,14,5114,36,0,53,229410.0,130000.0,-40.0,-36.0,-45.0,-52.0,-43.0,-36.0,-43.0,-49.0,-90.0,-93.0,-90.0,-93.0,50.0,57.0,45.0,41.0,0
6065,92:69:1D:31:68:E9,3829321,486072848,3747,3579723,3825574,482493125,0,4171,1041006,4054,1014746,117,26260,2000,7,3882,80,0,36,216660.0,130000.0,-52.0,-50.0,-44.0,-46.0,-51.0,-48.0,-43.0,-47.0,-90.0,-93.0,-90.0,-93.0,38.0,43.0,46.0,47.0,0
6066,CC:2F:71:3F:1F:24,4466288,1184542445,640712,702049118,3825576,482493327,37,524774,564436700,524139,564360294,635,76406,507092,10,640949,62942,34,451,130000.0,43333.0,-67.0,-65.0,-70.0,-67.0,-67.0,-65.0,-70.0,-67.0,-90.0,-93.0,-90.0,-93.0,23.0,28.0,20.0,26.0,0
6067,CC:2F:71:3E:C5:1F,3826346,482587477,770,94150,3825576,482493327,0,3224,270764,2661,203886,563,66878,815,8,1109,18,0,37,130000.0,39000.0,-70.0,-71.0,-67.0,-60.0,-70.0,-70.0,-67.0,-59.0,-90.0,-93.0,-90.0,-93.0,20.0,22.0,23.0,33.0,0
6068,BA:8C:B9:54:50:24,3830308,488644898,4732,6151571,3825576,482493327,0,8371,1650990,8349,1647495,22,3495,2324,14,5114,36,0,53,229410.0,130000.0,-40.0,-36.0,-45.0,-52.0,-43.0,-36.0,-43.0,-49.0,-90.0,-93.0,-90.0,-93.0,50.0,57.0,45.0,41.0,0
6069,92:69:1D:31:68:E9,3829325,486073252,3747,3579723,3825578,482493529,0,4171,1041006,4054,1014746,117,26260,2000,7,3882,80,0,36,216660.0,130000.0,-52.0,-50.0,-44.0,-46.0,-51.0,-48.0,-43.0,-47.0,-90.0,-93.0,-90.0,-93.0,38.0,43.0,46.0,47.0,0
6070,CC:2F:71:3F:1F:24,4466333,1184557255,640755,702063726,3825578,482493529,37,524799,564441504,524164,564365098,635,76406,507117,10,640992,62957,34,451,130000.0,39000.0,-67.0,-65.0,-70.0,-67.0,-67.0,-65.0,-70.0,-67.0,-90.0,-93.0,-90.0,-93.0,23.0,28.0,20.0,26.0,0
6071,CC:2F:71:3E:C5:1F,3826348,482587679,770,94150,3825578,482493529,0,3224,270764,2661,203886,563,66878,815,8,1109,18,0,37,130000.0,39000.0,-70.0,-71.0,-67.0,-60.0,-70.0,-70.0,-67.0,-59.0,-90.0,-93.0,-90.0,-93.0,20.0,22.0,23.0,33.0,0
6072,BA:8C:B9:54:50:24,3830310,488645100,4732,6151571,3825578,482493529,0,8371,1650990,8349,1647495,22,3495,2324,14,5114,36,0,53,229410.0,130000.0,-40.0,-36.0,-45.0,-52.0,-43.0,-36.0,-43.0,-49.0,-90.0,-93.0,-90.0,-93.0,50.0,57.0,45.0,41.0,0
6073,92:69:1D:31:68:E9,3829330,486073716,3747,3579723,3825583,482493993,0,4171,1041006,4054,1014746,117,26260,2000,7,3882,80,0,36,216660.0,130000.0,-52.0,-50.0,-44.0,-46.0,-51.0,-48.0,-43.0,-47.0,-90.0,-93.0,-90.0,-93.0,38.0,43.0,46.0,47.0,0
6074,CC:2F:71:3F:1F:24,4466381,1184572225,640796,702078030,3825585,482494195,37,524824,564446308,524189,564369902,635,76406,507142,10,641033,62968,34,451,130000.0,43333.0,-67.0,-65.0,-70.0,-68.0,-67.0,-65.0,-70.0,-67.0,-90.0,-93.0,-90.0,-93.0,23.0,28.0,20.0,25.0,0
6075,CC:2F:71:3E:C5:1F,3826355,482588345,770,94150,3825585,482494195,0,3224,270764,2661,203886,563,66878,815,8,1109,18,0,37,130000.0,39000.0,-70.0,-71.0,-67.0,-60.0,-70.0,-70.0,-67.0,-59.0,-90.0,-93.0,-90.0,-93.0,20.0,22.0,23.0,33.0,0
6076,BA:8C:B9:54:50:24,3830317,488645766,4732,6151571,3825585,482494195,0,8371,1650990,8349,1647495,22,3495,2324,14,5114,36,0,53,229410.0,130000.0,-40.0,-36.0,-45.0,-52.0,-43.0,-36.0,-43.0,-49.0,-90.0,-93.0,-90.0,-93.0,50.0,57.0,45.0,41.0,0
6077,92:69:1D:31:68:E9,3829334,486074120,3747,3579723,3825587,482494397,0,4171,1041006,4054,1014746,117,26260,2000,7,3882,80,0,36,216660.0,130000.0,-52.0,-50.0,-44.0,-46.0,-51.0,-48.0,-43.0,-47.0,-90.0,-93.0,-90.0,-93.0,38.0,43.0,46.0,47.0,0
6078,CC:2F:71:3F:1F:24,4466425,1184586911,640838,702092514,3825587,482494397,37,524851,564451344,524216,564374938,635,76406,507169,10,641075,62971,34,451,130000.0,43333.0,-67.0,-65.0,-71.0,-67.0,-67.0,-65.0,-70.0,-67.0,-90.0,-93.0,-90.0,-93.0,23.0,28.0,19.0,26.0,0
6079,CC:2F:71:3E:C5:1F,3826357,482588547,770,94150,3825587,482494397,0,3224,270764,2661,203886,563,66878,815,8,1109,18,0,37,130000.0,39000.0,-70.0,-71.0,-67.0,-60.0,-70.0,-70.0,-67.0,-59.0,-90.0,-93.0,-90.0,-93.0,20.0,22.0,23.0,33.0,0
6080,BA:8C:B9:54:50:24,3830319,488645968,4732,6151571,3825587,482494397,0,8371,1650990,8349,1647495,22,3495,2324,14,5114,36,0,53,229410.0,130000.0,-40.0,-36.0,-45.0,-52.0,-43.0,-36.0,-43.0,-49.0,-90.0,-93.0,-90.0,-93.0,50.0,57.0,45.0,41.0,0
6081,92:69:1D:31:68:E9,3829338,486074524,3747,3579723,3825591,482494801,0,4171,1041006,4054,1014746,117,26260,2000,7,3882,80,0,36,216660.0,130000.0,-52.0,-50.0,-44.0,-46.0,-51.0,-48.0,-43.0,-47.0,-90.0,-93.0,-90.0,-93.0,38.0,43.0,46.0,47.0,0
6082,CC:2F:71:3F:1F:24,4466474,1184602069,640881,702107066,3825593,482495003,37,524877,564456324,524242,564379918,635,76406,507195,10,641118,62996,34,451,117000.0,39000.0,-67.0,-65.0,-70.0,-68.0,-67.0,-65.0,-70.0,-67.0,-90.0,-93.0,-90.0,-93.0,23.0,28.0,20.0,25.0,0
6083,CC:2F:71:3E:C5:1F,3826363,482589153,770,94150,3825593,482495003,0,3224,270764,2661,203886,563,66878,815,8,1109,18,0,37,130000.0,39000.0,-70.0,-71.0,-67.0,-60.0,-70.0,-70.0,-67.0,-59.0,-90.0,-93.0,-90.0,-93.0,20.0,22.0,23.0,33.0,0
6084,BA:8C:B9:54:50:24,3830325,488646574,4732,6151571,3825593,482495003,0,8371,1650990,8349,1647495,22,3495,2324,14,5114,36,0,53,229410.0,130000.0,-40.0,-36.0,-45.0,-52.0,-43.0,-36.0,-43.0,-49.0,-90.0,-93.0,-90.0,-93.0,50.0,57.0,45.0,41.0,0
6085,92:69:1D:31:68:E9,3829343,486074988,3747,3579723,3825596,482495265,0,4171,1041006,4054,1014746,117,26260,2000,7,3882,80,0,36,216660.0,130000.0,-52.0,-50.0,-44.0,-46.0,-51.0,-48.0,-43.0,-47.0,-90.0,-93.0,-89.0,-93.0,38.0,43.0,45.0,47.0,0
6086,CC:2F:71:3F:1F:24,4466518,1184616635,640922,702121370,3825596,482495265,37,524903,564461244,524268,564384838,635,76406,507221,10,641159,63002,34,451,130000.0,43333.0,-67.0,-65.0,-71.0,-68.0,-67.0,-65.0,-70.0,-67.0,-90.0,-93.0,-89.0,-93.0,23.0,28.0,18.0,25.0,0
6087,CC:2F:71:3E:C5:1F,3826366,482589415,770,94150,3825596,482495265,0,3224,270764,2661,203886,563,66878,815,8,1109,18,0,37,130000.0,39000.0,-70.0,-71.0,-67.0,-60.0,-70.0,-70.0,-67.0,-59.0,-90.0,-93.0,-89.0,-93.0,20.0,22.0,22.0,33.0,0
6088,BA:8C:B9:54:50:24,3830328,488646836,4732,6151571,3825596,482495265,0,8371,1650990,8349,1647495,22,3495,2324,14,5114,36,0,53,229410.0,130000.0,-40.0,-36.0,-45.0,-52.0,-43.0,-36.0,-43.0,-49.0,-90.0,-93.0,-89.0,-93.0,50.0,57.0,44.0,41.0,0
6089,92:69:1D:31:68:E9,3829347,486075392,3747,3579723,3825600,482495669,0,4171,1041006,4054,1014746,117,26260,2000,7,3882,80,0,36,216660.0,130000.0,-52.0,-50.0,-44.0,-46.0,-51.0,-48.0,-43.0,-47.0,-90.0,-93.0,-89.0,-93.0,38.0,43.0,45.0,47.0,0
6090,CC:2F:71:3F:1F:24,4466566,1184631725,640964,702135854,3825602,482495871,37,524930,564466304,524295,564389898,635,76406,507248,10,641201,63018,34,451,130000.0,39000.0,-67.0,-65.0,-70.0,-67.0,-67.0,-65.0,-70.0,-67.0,-90.0,-93.0,-89.0,-93.0,23.0,28.0,19.0,26.0,0
6091,CC:2F:71:3E:C5:1F,3826372,482590021,770,94150,3825602,482495871,0,3224,270764,2661,203886,563,66878,815,8,1109,18,0,37,130000.0,39000.0,-70.0,-71.0,-67.0,-60.0,-70.0,-70.0,-67.0,-59.0,-90.0,-93.0,-89.0,-93.0,20.0,22.0,22.0,33.0,0
6092,BA:8C:B9:54:50:24,3830334,488647442,4732,6151571,3825602,482495871,0,8371,1650990,8349,1647495,22,3495,2324,14,5114,36,0,53,229410.0,130000.0,-40.0,-36.0,-45.0,-52.0,-43.0,-36.0,-43.0,-49.0,-90.0,-93.0,-89.0,-93.0,50.0,57.0,44.0,41.0,0
6093,92:69:1D:31:68:E9,3829351,486075796,3747,3579723,3825604,482496073,0,4171,1041006,4054,1014746,117,26260,2000,7,3882,80,0,36,216660.0,130000.0,-52.0,-50.0,-44.0,-46.0,-51.0,-48.0,-43.0,-47.0,-90.0,-93.0,-89.0,-93.0,38.0,43.0,45.0,47.0,0
6094,CC:2F:71:3F:1F:24,4466611,1184646479,641007,702150406,3825604,482496073,37,524955,564471108,524320,564394702,635,76406,507273,10,641244,63027,34,451,130000.0,43333.0,-67.0,-65.0,-70.0,-67.0,-67.0,-65.0,-70.0,-67.0,-90.0,-93.0,-89.0,-93.0,23.0,28.0,19.0,26.0,0
6095,CC:2F:71:3E:C5:1F,3826375,482590283,770,94150,3825605,482496133,0,3224,270764,2661,203886,563,66878,815,8,1109,18,0,37,130000.0,39000.0,-70.0,-71.0,-67.0,-60.0,-70.0,-70.0,-67.0,-59.0,-90.0,-93.0,-89.0,-93.0,20.0,22.0,22.0,33.0,0
6096,BA:8C:B9:54:50:24,3830337,488647704,4732,6151571,3825605,482496133,0,8371,1650990,8349,1647495,22,3495,2324,14,5114,36,0,53,229410.0,130000.0,-40.0,-36.0,-45.0,-52.0,-43.0,-36.0,-43.0,-49.0,-90.0,-93.0,-89.0,-93.0,50.0,57.0,44.0,41.0,0
6097,92:69:1D:31:68:E9,3829356,486076260,3747,3579723,3825609,482496537,0,4171,1041006,4054,1014746,117,26260,2000,7,3882,80,0,36,216660.0,130000.0,-52.0,-50.0,-44.0,-46.0,-51.0,-48.0,-43.0,-47.0,-90.0,-93.0,-89.0,-93.0,38.0,43.0,45.0,47.0,0
6098,CC:2F:71:3F:1F:24,4466660,1184661667,641051,702165130,3825609,482496537,37,524981,564476052,524346,564399646,635,76406,507299,10,641288,63030,34,451,130000.0,43333.0,-67.0,-65.0,-70.0,-67.0,-67.0,-65.0,-70.0,-67.0,-90.0,-93.0,-89.0,-93.0,23.0,28.0,19.0,26.0,0
6099,CC:2F:71:3E:C5:1F,3826382,482591005,771,94266,3825611,482496739,0,3226,270904,2663,204026,563,66878,815,8,1110,18,0,37,130000.0,39000.0,-70.0,-71.0,-67.0,-60.0,-70.0,-71.0,-67.0,-60.0,-90.0,-93.0,-89.0,-93.0,20.0,22.0,22.0,33.0,0
6100,BA:8C:B9:54:50:24,3830344,488648426,4733,6151687,3825611,482496739,0,8373,1651126,8351,1647631,22,3495,2324,14,5115,36,0,53,229410.0,130000.0,-49.0,-35.0,-42.0,-44.0,-43.0,-36.0,-43.0,-49.0,-90.0,-93.0,-89.0,-93.0,41.0,58.0,47.0,49.0,0
6101,92:69:1D:31:68:E9,3829362,486076840,3748,3579839,3825614,482497001,0,4173,1041142,4056,1014882,117,26260,2000,7,3883,80,0,36,216660.0,130000.0,-51.0,-47.0,-42.0,-49.0,-51.0,-49.0,-43.0,-46.0,-90.0,-93.0,-89.0,-93.0,39.0,46.0,47.0,44.0,0
6102,CC:2F:71:3F:1F:24,4466709,1184676956,641094,702179682,3825615,482497274,37,525008,564481112,524373,564404706,635,76406,507326,10,641331,63045,34,451,117000.0,39000.0,-67.0,-65.0,-70.0,-68.0,-67.0,-65.0,-70.0,-67.0,-90.0,-93.0,-89.0,-93.0,23.0,28.0,19.0,25.0,0
6103,CC:2F:71:3E:C5:1F,3826386,482591540,771,94266,3825615,482497274,0,3226,270904,2663,204026,563,66878,815,8,1110,18,0,37,130000.0,39000.0,-70.0,-71.0,-67.0,-60.0,-70.0,-71.0,-67.0,-60.0,-90.0,-93.0,-89.0,-93.0,20.0,22.0,22.0,33.0,0
6104,BA:8C:B9:54:50:24,3830348,488648961,4733,6151687,3825615,482497274,0,8373,1651126,8351,1647631,22,3495,2324,14,5115,36,0,53,229410.0,130000.0,-49.0,-35.0,-42.0,-44.0,-43.0,-36.0,-43.0,-49.0,-90.0,-93.0,-89.0,-93.0,41.0,58.0,47.0,49.0,0
6105,92:69:1D:31:68:E9,3829369,486077639,3748,3579839,3825621,482497800,0,4173,1041142,4056,1014882,117,26260,2000,7,3883,80,0,36,216660.0,130000.0,-51.0,-47.0,-42.0,-49.0,-51.0,-49.0,-43.0,-46.0,-90.0,-93.0,-90.0,-93.0,39.0,46.0,48.0,44.0,0
6106,CC:2F:71:3F:1F:24,4466756,1184691786,641135,702193986,3825621,482497800,37,525035,564486174,524399,564409650,636,76524,507353,10,641372,63049,34,451,130000.0,43333.0,-67.0,-65.0,-70.0,-67.0,-67.0,-65.0,-70.0,-67.0,-90.0,-93.0,-90.0,-93.0,23.0,28.0,20.0,26.0,0
6107,CC:2F:71:3E:C5:1F,3826393,482592134,771,94266,3825622,482497868,0,3226,270904,2663,204026,563,66878,815,8,1110,18,0,37,130000.0,39000.0,-70.0,-71.0,-67.0,-60.0,-70.0,-71.0,-67.0,-60.0,-90.0,-93.0,-90.0,-93.0,20.0,22.0,23.0,33.0,0
6108,BA:8C:B9:54:50:24,3830355,488649555,4733,6151687,3825622,482497868,0,8373,1651126,8351,1647631,22,3495,2324,14,5115,36,0,53,229410.0,130000.0,-49.0,-35.0,-42.0,-44.0,-43.0,-36.0,-43.0,-49.0,-90.0,-93.0,-90.0,-93.0,41.0,58.0,48.0,49.0,0
6109,92:69:1D:31:68:E9,3829373,486078043,3748,3579839,3825625,482498204,0,4173,1041142,4056,1014882,117,26260,2000,7,3883,80,0,36,216660.0,130000.0,-51.0,-47.0,-42.0,-49.0,-51.0,-49.0,-43.0,-46.0,-90.0,-93.0,-90.0,-93.0,39.0,46.0,48.0,44.0,0
6110,CC:2F:71:3F:1F:24,4466802,1184706506,641177,702208302,3825625,482498204,37,525061,564491094,524425,564414570,636,76524,507379,10,641414,63085,34,451,144444.0,39000.0,-67.0,-65.0,-70.0,-67.0,-67.0,-65.0,-70.0,-67.0,-90.0,-93.0,-90.0,-93.0,23.0,28.0,20.0,26.0,0
6111,CC:2F:71:3E:C5:1F,3826396,482592470,771,94266,3825625,482498204,0,3226,270904,2663,204026,563,66878,815,8,1110,18,0,37,130000.0,39000.0,-70.0,-71.0,-67.0,-60.0,-70.0,-71.0,-67.0,-60.0,-90.0,-93.0,-90.0,-93.0,20.0,22.0,23.0,33.0,0
6112,BA:8C:B9:54:50:24,3830358,488649891,4733,6151687,3825625,482498204,0,8373,1651126,8351,1647631,22,3495,2324,14,5115,36,0,53,229410.0,130000.0,-49.0,-35.0,-42.0,-44.0,-43.0,-36.0,-43.0,-49.0,-90.0,-93.0,-90.0,-93.0,41.0,58.0,48.0,49.0,0
6113,92:69:1D:31:68:E9,3829375,486078245,3748,3579839,3825627,482498406,0,4173,1041142,4056,1014882,117,26260,2000,7,3883,80,0,36,216660.0,130000.0,-51.0,-47.0,-42.0,-49.0,-51.0,-49.0,-43.0,-46.0,-90.0,-93.0,-90.0,-93.0,39.0,46.0,48.0,44.0,0
6114,CC:2F:71:3F:1F:24,4466848,1184721338,641219,702222730,3825629,482498608,37,525088,564496178,524452,564419654,636,76524,507406,10,641456,63106,34,451,130000.0,43333.0,-67.0,-65.0,-70.0,-67.0,-67.0,-65.0,-70.0,-67.0,-90.0,-93.0,-90.0,-93.0,23.0,28.0,20.0,26.0,0
6115,CC:2F:71:3E:C5:1F,3826400,482592874,771,94266,3825629,482498608,0,3226,270904,2663,204026,563,66878,815,8,1110,18,0,37,130000.0,39000.0,-70.0,-71.0,-67.0,-60.0,-70.0,-71.0,-67.0,-60.0,-90.0,-93.0,-90.0,-93.0,20.0,22.0,23.0,33.0,0
6116,BA:8C:B9:54:50:24,3830362,488650295,4733,6151687,3825629,482498608,0,8373,1651126,8351,1647631,22,3495,2324,14,5115,36,0,53,229410.0,130000.0,-49.0,-35.0,-42.0,-44.0,-43.0,-36.0,-43.0,-49.0,-90.0,-93.0,-90.0,-93.0,41.0,58.0,48.0,49.0,0
6117,92:69:1D:31:68:E9,3829382,486078911,3748,3579839,3825634,482499072,0,4173,1041142,4056,1014882,117,26260,2000,7,3883,80,0,36,216660.0,130000.0,-51.0,-47.0,-42.0,-49.0,-51.0,-49.0,-43.0,-46.0,-90.0,-93.0,-90.0,-93.0,39.0,46.0,48.0,44.0,0
6118,CC:2F:71:3F:1F:24,4466895,1184736286,641261,702237214,3825634,482499072,37,525114,564501122,524478,564424598,636,76524,507432,10,641498,63115,34,451,117000.0,39000.0,-67.0,-65.0,-70.0,-67.0,-67.0,-65.0,-70.0,-67.0,-90.0,-93.0,-90.0,-93.0,23.0,28.0,20.0,26.0,0
6119,CC:2F:71:3E:C5:1F,3826405,482593338,771,94266,3825634,482499072,0,3226,270904,2663,204026,563,66878,815,8,1110,18,0,37,130000.0,39000.0,-70.0,-71.0,-67.0,-60.0,-70.0,-71.0,-67.0,-60.0,-90.0,-93.0,-90.0,-93.0,20.0,22.0,23.0,33.0,0
6120,BA:8C:B9:54:50:24,3830367,488650759,4733,6151687,3825634,482499072,0,8373,1651126,8351,1647631,22,3495,2324,14,5115,36,0,53,229410.0,130000.0,-49.0,-35.0,-42.0,-44.0,-43.0,-36.0,-43.0,-49.0,-90.0,-93.0,-90.0,-93.0,41.0,58.0,48.0,49.0,0
6121,92:69:1D:31:68:E9,3829384,486079113,3748,3579839,3825636,482499274,0,4173,1041142,4056,1014882,117,26260,2000,7,3883,80,0,36,216660.0,130000.0,-51.0,-47.0,-42.0,-49.0,-51.0,-49.0,-43.0,-46.0,-90.0,-93.0,-90.0,-93.0,39.0,46.0,48.0,44.0,0
6122,CC:2F:71:3F:1F:24,4466940,1184750984,641304,702251710,3825636,482499274,37,525140,564506066,524504,564429542,636,76524,507458,10,641541,63130,34,451,130000.0,39000.0,-67.0,-65.0,-71.0,-67.0,-67.0,-65.0,-70.0,-67.0,-90.0,-93.0,-90.0,-93.0,23.0,28.0,19.0,26.0,0
6123,CC:2F:71:3E:C5:1F,3826409,482593742,771,94266,3825638,482499476,0,3228,271044,2665,204166,563,66878,815,8,1111,18,0,37,130000.0,39000.0,-70.0,-71.0,-67.0,-60.0,-70.0,-71.0,-67.0,-60.0,-90.0,-93.0,-90.0,-93.0,20.0,22.0,23.0,33.0,0
6124,BA:8C:B9:54:50:24,3830371,488651163,4733,6151687,3825638,482499476,0,8376,1651330,8354,1647835,22,3495,2324,14,5116,36,0,53,229410.0,130000.0,-49.0,-35.0,-42.0,-45.0,-45.0,-35.0,-43.0,-47.0,-90.0,-93.0,-90.0,-93.0,41.0,58.0,48.0,48.0,0
6125,92:69:1D:31:68:E9,3829390,486079719,3748,3579839,3825642,482499880,0,4175,1041278,4058,1015018,117,26260,2000,7,3884,80,0,36,216660.0,130000.0,-51.0,-47.0,-43.0,-49.0,-51.0,-49.0,-43.0,-47.0,-90.0,-93.0,-90.0,-93.0,39.0,46.0,47.0,44.0,0
6126,CC:2F:71:3F:1F:24,4466990,1184766202,641347,702266262,3825643,482499940,37,525166,564511010,524530,564434486,636,76524,507484,10,641584,63139,34,451,130000.0,39000.0,-67.0,-65.0,-70.0,-68.0,-67.0,-65.0,-70.0,-67.0,-90.0,-93.0,-90.0,-93.0,23.0,28.0,20.0,25.0,0
6127,CC:2F:71:3E:C5:1F,3826414,482594206,771,94266,3825643,482499940,0,3228,271044,2665,204166,563,66878,815,8,1111,18,0,37,130000.0,39000.0,-70.0,-71.0,-67.0,-60.0,-70.0,-71.0,-67.0,-60.0,-90.0,-93.0,-90.0,-93.0,20.0,22.0,23.0,33.0,0
6128,BA:8C:B9:54:50:24,3830376,488651627,4733,6151687,3825643,482499940,0,8376,1651330,8354,1647835,22,3495,2324,14,5116,36,0,53,229410.0,130000.0,-49.0,-35.0,-42.0,-45.0,-45.0,-35.0,-43.0,-47.0,-90.0,-93.0,-90.0,-93.0,41.0,58.0,48.0,48.0,0
6129,92:69:1D:31:68:E9,3829394,486080043,3748,3579839,3825646,482500204,0,4175,1041278,4058,1015018,117,26260,2000,7,3884,80,0,36,216660.0,130000.0,-51.0,-47.0,-43.0,-49.0,-51.0,-49.0,-43.0,-47.0,-90.0,-93.0,-90.0,-93.0,39.0,46.0,47.0,44.0,0
6130,CC:2F:71:3F:1F:24,4467038,1184781220,641390,702280814,3825648,482500406,37,525194,564516162,524558,564439638,636,76524,507512,10,641627,63153,34,451,130000.0,39000.0,-67.0,-65.0,-71.0,-67.0,-67.0,-65.0,-70.0,-67.0,-90.0,-93.0,-90.0,-93.0,23.0,28.0,19.0,26.0,0
6131,CC:2F:71:3E:C5:1F,3826419,482594672,771,94266,3825648,482500406,0,3230,271232,2666,204236,564,66996,816,8,1111,18,0,37,130000.0,39000.0,-70.0,-71.0,-67.0,-60.0,-70.0,-71.0,-67.0,-60.0,-90.0,-93.0,-90.0,-93.0,20.0,22.0,23.0,33.0,0
6132,BA:8C:B9:54:50:24,3830381,488652093,4733,6151687,3825648,482500406,0,8376,1651330,8354,1647835,22,3495,2324,14,5116,36,0,53,229410.0,130000.0,-49.0,-35.0,-42.0,-45.0,-45.0,-35.0,-43.0,-47.0,-90.0,-93.0,-90.0,-93.0,41.0,58.0,48.0,48.0,0
6133,92:69:1D:31:68:E9,3829402,486080935,3750,3580125,3825652,482500810,0,4179,1041682,4062,1015422,117,26260,2002,7,3886,80,0,36,216660.0,130000.0,-51.0,-47.0,-42.0,-49.0,-51.0,-48.0,-43.0,-48.0,-90.0,-93.0,-90.0,-93.0,39.0,46.0,48.0,44.0,0
6134,CC:2F:71:3F:1F:24,4467083,1184795928,641431,702295118,3825652,482500810,37,525219,564520966,524583,564444442,636,76524,507537,10,641668,63171,34,451,130000.0,39000.0,-67.0,-65.0,-70.0,-68.0,-67.0,-65.0,-70.0,-67.0,-90.0,-93.0,-90.0,-93.0,23.0,28.0,20.0,25.0,0
6135,CC:2F:71:3E:C5:1F,3826423,482595076,771,94266,3825652,482500810,0,3230,271232,2666,204236,564,66996,816,8,1111,18,0,37,130000.0,39000.0,-70.0,-71.0,-67.0,-60.0,-70.0,-71.0,-67.0,-60.0,-90.0,-93.0,-90.0,-93.0,20.0,22.0,23.0,33.0,0
6136,BA:8C:B9:54:50:24,3830385,488652497,4733,6151687,3825652,482500810,0,8376,1651330,8354,1647835,22,3495,2324,14,5116,36,0,53,229410.0,130000.0,-49.0,-35.0,-42.0,-45.0,-45.0,-35.0,-43.0,-47.0,-90.0,-93.0,-90.0,-93.0,41.0,58.0,48.0,48.0,0
6137,92:69:1D:31:68:E9,3829404,486081129,3750,3580125,3825654,482501004,0,4180,1041750,4063,1015490,117,26260,2002,7,3886,80,0,36,216660.0,130000.0,-52.0,-50.0,-44.0,-46.0,-51.0,-48.0,-43.0,-48.0,-90.0,-93.0,-90.0,-93.0,38.0,43.0,46.0,47.0,0
6138,CC:2F:71:3F:1F:24,4467127,1184810438,641472,702309366,3825655,482501072,37,525245,564525910,524609,564449386,636,76524,507563,10,641709,63192,34,451,117000.0,39000.0,-67.0,-65.0,-70.0,-67.0,-67.0,-65.0,-70.0,-67.0,-90.0,-93.0,-90.0,-93.0,23.0,28.0,20.0,26.0,0
6139,CC:2F:71:3E:C5:1F,3826428,482595540,771,94266,3825657,482501274,0,3230,271232,2666,204236,564,66996,816,8,1111,18,0,37,130000.0,39000.0,-70.0,-71.0,-67.0,-60.0,-70.0,-71.0,-67.0,-60.0,-90.0,-93.0,-90.0,-93.0,20.0,22.0,23.0,33.0,0
6140,BA:8C:B9:54:50:24,3830390,488652961,4733,6151687,3825657,482501274,0,8376,1651330,8354,1647835,22,3495,2324,14,5116,36,0,53,229410.0,130000.0,-49.0,-35.0,-42.0,-45.0,-45.0,-35.0,-43.0,-47.0,-90.0,-93.0,-90.0,-93.0,41.0,58.0,48.0,48.0,0
6141,92:69:1D:31:68:E9,3829411,486081803,3750,3580125,3825661,482501678,0,4182,1041886,4065,1015626,117,26260,2002,7,3886,80,0,36,216660.0,130000.0,-51.0,-47.0,-43.0,-49.0,-51.0,-48.0,-43.0,-49.0,-90.0,-93.0,-90.0,-93.0,39.0,46.0,47.0,44.0,0
6142,CC:2F:71:3F:1F:24,4467175,1184825472,641514,702323794,3825661,482501678,37,525270,564530714,524634,564454190,636,76524,507588,10,641751,63196,34,451,130000.0,43333.0,-67.0,-65.0,-70.0,-68.0,-67.0,-65.0,-70.0,-67.0,-90.0,-93.0,-90.0,-93.0,23.0,28.0,20.0,25.0,0
6143,CC:2F:71:3E:C5:1F,3826432,482595944,771,94266,3825661,482501678,0,3230,271232,2666,204236,564,66996,816,8,1111,18,0,37,130000.0,39000.0,-70.0,-71.0,-67.0,-60.0,-70.0,-71.0,-67.0,-60.0,-90.0,-93.0,-90.0,-93.0,20.0,22.0,23.0,33.0,0
6144,BA:8C:B9:54:50:24,3830394,488653365,4733,6151687,3825661,482501678,0,8376,1651330,8354,1647835,22,3495,2324,14,5116,36,0,53,229410.0,130000.0,-49.0,-35.0,-42.0,-45.0,-45.0,-35.0,-43.0,-47.0,-90.0,-93.0,-90.0,-93.0,41.0,58.0,48.0,48.0,0
6145,92:69:1D:31:68:E9,3829411,486081803,3750,3580125,3825661,482501678,0,4183,1041954,4066,1015694,117,26260,2002,7,3886,80,0,36,216660.0,130000.0,-52.0,-50.0,-44.0,-46.0,-51.0,-48.0,-43.0,-48.0,-90.0,-93.0,-90.0,-93.0,38.0,43.0,46.0,47.0,0
6146,CC:2F:71:3F:1F:24,4467218,1184840090,641555,702338210,3825663,482501880,37,525297,564535774,524661,564459250,636,76524,507615,10,641792,63197,34,451,130000.0,43333.0,-67.0,-65.0,-70.0,-67.0,-67.0,-65.0,-70.0,-67.0,-90.0,-93.0,-90.0,-93.0,23.0,28.0,20.0,26.0,0
6147,CC:2F:71:3E:C5:1F,3826436,482596348,771,94266,3825665,482502082,0,3230,271232,2666,204236,564,66996,816,8,1111,18,0,37,130000.0,39000.0,-70.0,-71.0,-67.0,-60.0,-70.0,-71.0,-67.0,-60.0,-90.0,-93.0,-90.0,-93.0,20.0,22.0,23.0,33.0,0
6148,BA:8C:B9:54:50:24,3830398,488653769,4733,6151687,3825665,482502082,0,8376,1651330,8354,1647835,22,3495,2324,14,5116,36,0,53,229410.0,130000.0,-49.0,-35.0,-42.0,-45.0,-45.0,-35.0,-43.0,-47.0,-90.0,-93.0,-90.0,-93.0,41.0,58.0,48.0,48.0,0
6149,92:69:1D:31:68:E9,3829432,486088270,3750,3580125,3825682,482508145,0,4186,1042325,4068,1015830,118,26495,2003,7,3886,80,0,36,216660.0,130000.0,-51.0,-47.0,-43.0,-49.0,-51.0,-48.0,-43.0,-48.0,-90.0,-93.0,-90.0,-93.0,39.0,46.0,47.0,44.0,0
6150,CC:2F:71:3F:1F:24,4467281,1184861031,641599,702352886,3825682,482508145,37,525324,564540834,524688,564464310,636,76524,507642,10,641836,63218,34,451,117000.0,39000.0,-67.0,-65.0,-70.0,-67.0,-67.0,-65.0,-70.0,-67.0,-90.0,-93.0,-90.0,-93.0,23.0,28.0,20.0,26.0,0
6151,CC:2F:71:3E:C5:1F,3826464,482607835,771,94266,3825693,482513569,0,3230,271232,2666,204236,564,66996,816,8,1111,18,0,37,130000.0,39000.0,-70.0,-71.0,-67.0,-60.0,-70.0,-71.0,-67.0,-60.0,-90.0,-93.0,-90.0,-93.0,20.0,22.0,23.0,33.0,0
6152,BA:8C:B9:54:50:24,3830426,488665256,4733,6151687,3825693,482513569,0,8376,1651330,8354,1647835,22,3495,2324,14,5116,36,0,53,229410.0,130000.0,-49.0,-35.0,-42.0,-45.0,-45.0,-35.0,-43.0,-47.0,-90.0,-93.0,-90.0,-93.0,41.0,58.0,48.0,48.0,0
6153,92:69:1D:31:68:E9,3829443,486093694,3750,3580125,3825693,482513569,0,4186,1042325,4068,1015830,118,26495,2003,7,3886,80,0,36,216660.0,130000.0,-51.0,-47.0,-43.0,-49.0,-51.0,-48.0,-43.0,-48.0,-90.0,-93.0,-90.0,-93.0,39.0,46.0,47.0,44.0,0
6154,CC:2F:71:3F:1F:24,4467337,1184881107,641640,702367134,3825697,482513973,37,525351,564545918,524715,564469394,636,76524,507669,10,641877,63233,34,451,130000.0,39000.0,-70.0,-69.0,-74.0,-71.0,-70.0,-68.0,-73.0,-70.0,-90.0,-93.0,-90.0,-93.0,20.0,24.0,16.0,22.0,0
6155,CC:2F:71:3E:C5:1F,3826468,482608239,771,94266,3825697,482513973,0,3230,271232,2666,204236,564,66996,816,8,1111,18,0,37,130000.0,39000.0,-70.0,-71.0,-67.0,-60.0,-70.0,-71.0,-67.0,-60.0,-90.0,-93.0,-90.0,-93.0,20.0,22.0,23.0,33.0,0
6156,BA:8C:B9:54:50:24,3830433,488666135,4733,6151687,3825700,482514448,0,8376,1651330,8354,1647835,22,3495,2324,14,5116,36,0,53,229410.0,130000.0,-49.0,-35.0,-42.0,-45.0,-45.0,-35.0,-43.0,-47.0,-90.0,-93.0,-90.0,-93.0,41.0,58.0,48.0,48.0,0
6157,92:69:1D:31:68:E9,3829453,486094835,3750,3580125,3825703,482514710,0,4186,1042325,4068,1015830,118,26495,2003,7,3886,80,0,36,216660.0,130000.0,-51.0,-47.0,-43.0,-49.0,-51.0,-48.0,-43.0,-48.0,-90.0,-93.0,-90.0,-93.0,39.0,46.0,47.0,44.0,0
6158,CC:2F:71:3F:1F:24,4467385,1184896272,641682,702381562,3825703,482514710,37,525377,564550898,524741,564474374,636,76524,507695,10,641919,63269,34,451,144444.0,43333.0,-79.0,-77.0,-82.0,-80.0,-71.0,-69.0,-74.0,-72.0,-90.0,-93.0,-90.0,-93.0,11.0,16.0,8.0,13.0,0
6159,CC:2F:71:3E:C5:1F,3826474,482608976,771,94266,3825703,482514710,0,3230,271232,2666,204236,564,66996,816,8,1111,18,0,37,130000.0,39000.0,-70.0,-71.0,-67.0,-60.0,-70.0,-71.0,-67.0,-60.0,-90.0,-93.0,-90.0,-93.0,20.0,22.0,23.0,33.0,0
6160,BA:8C:B9:54:50:24,3830436,488666397,4733,6151687,3825703,482514710,0,8376,1651330,8354,1647835,22,3495,2324,14,5116,36,0,53,229410.0,130000.0,-49.0,-35.0,-42.0,-45.0,-45.0,-35.0,-43.0,-47.0,-90.0,-93.0,-90.0,-93.0,41.0,58.0,48.0,48.0,0
6161,92:69:1D:31:68:E9,3829455,486095067,3752,3580357,3825703,482514710,0,4190,1042677,4072,1016182,118,26495,2005,7,3888,80,0,36,216660.0,130000.0,-51.0,-47.0,-42.0,-49.0,-51.0,-49.0,-44.0,-48.0,-90.0,-93.0,-90.0,-93.0,39.0,46.0,48.0,44.0,0
6162,CC:2F:71:3F:1F:24,4467431,1184911160,641724,702396046,3825707,482515114,37,525402,564555702,524766,564479178,636,76524,507720,10,641961,63295,34,451,130000.0,43333.0,-68.0,-66.0,-71.0,-68.0,-67.0,-65.0,-71.0,-68.0,-90.0,-93.0,-90.0,-93.0,22.0,27.0,19.0,25.0,0
6163,CC:2F:71:3E:C5:1F,3826480,482609582,771,94266,3825709,482515316,0,3230,271232,2666,204236,564,66996,816,8,1111,18,0,37,130000.0,39000.0,-70.0,-71.0,-67.0,-60.0,-70.0,-71.0,-67.0,-60.0,-90.0,-93.0,-90.0,-93.0,20.0,22.0,23.0,33.0,0
6164,BA:8C:B9:54:50:24,3830442,488667003,4733,6151687,3825709,482515316,0,8376,1651330,8354,1647835,22,3495,2324,14,5116,36,0,53,229410.0,130000.0,-49.0,-35.0,-42.0,-45.0,-45.0,-35.0,-43.0,-47.0,-90.0,-93.0,-90.0,-93.0,41.0,58.0,48.0,48.0,0
6165,92:69:1D:31:68:E9,3829463,486095875,3752,3580357,3825711,482515518,0,4190,1042677,4072,1016182,118,26495,2005,7,3888,80,0,36,216660.0,130000.0,-51.0,-47.0,-42.0,-49.0,-51.0,-49.0,-44.0,-48.0,-90.0,-93.0,-90.0,-93.0,39.0,46.0,48.0,44.0,0
6166,CC:2F:71:3F:1F:24,4467477,1184926104,641766,702410586,3825711,482515518,37,525427,564560506,524791,564483982,636,76524,507745,10,642003,63301,34,451,130000.0,43333.0,-67.0,-65.0,-70.0,-67.0,-67.0,-65.0,-70.0,-67.0,-90.0,-93.0,-90.0,-93.0,23.0,28.0,20.0,26.0,0
6167,CC:2F:71:3E:C5:1F,3826482,482609784,771,94266,3825711,482515518,0,3230,271232,2666,204236,564,66996,816,8,1111,18,0,37,130000.0,39000.0,-70.0,-71.0,-67.0,-60.0,-70.0,-71.0,-67.0,-60.0,-90.0,-93.0,-90.0,-93.0,20.0,22.0,23.0,33.0,0
6168,BA:8C:B9:54:50:24,3830445,488667265,4733,6151687,3825712,482515578,0,8376,1651330,8354,1647835,22,3495,2324,14,5116,36,0,53,229410.0,130000.0,-49.0,-35.0,-42.0,-45.0,-45.0,-35.0,-43.0,-47.0,-90.0,-93.0,-90.0,-93.0,41.0,58.0,48.0,48.0,0
6169,92:69:1D:31:68:E9,3829469,486096565,3752,3580357,3825717,482516208,0,4190,1042677,4072,1016182,118,26495,2005,7,3888,80,0,36,216660.0,130000.0,-51.0,-47.0,-42.0,-49.0,-51.0,-49.0,-44.0,-48.0,-90.0,-93.0,-90.0,-93.0,39.0,46.0,48.0,44.0,0
6170,CC:2F:71:3F:1F:24,4467528,1184941738,641809,702425328,3825719,482516410,37,525456,564565786,524820,564489262,636,76524,507774,10,642046,63315,34,451,130000.0,39000.0,-67.0,-65.0,-70.0,-68.0,-67.0,-65.0,-70.0,-67.0,-90.0,-93.0,-90.0,-93.0,23.0,28.0,20.0,25.0,0
6171,CC:2F:71:3E:C5:1F,3826492,482610878,771,94266,3825721,482516612,0,3230,271232,2666,204236,564,66996,816,8,1111,18,0,37,130000.0,39000.0,-70.0,-71.0,-67.0,-60.0,-70.0,-71.0,-67.0,-60.0,-90.0,-93.0,-90.0,-93.0,20.0,22.0,23.0,33.0,0
6172,BA:8C:B9:54:50:24,3830454,488668299,4733,6151687,3825721,482516612,0,8376,1651330,8354,1647835,22,3495,2324,14,5116,36,0,53,229410.0,130000.0,-49.0,-35.0,-42.0,-45.0,-45.0,-35.0,-43.0,-47.0,-90.0,-93.0,-90.0,-93.0,41.0,58.0,48.0,48.0,0
6173,92:69:1D:31:68:E9,3829475,486097171,3752,3580357,3825723,482516814,0,4190,1042677,4072,1016182,118,26495,2005,7,3888,80,0,36,216660.0,130000.0,-51.0,-47.0,-42.0,-49.0,-51.0,-49.0,-44.0,-48.0,-90.0,-93.0,-90.0,-93.0,39.0,46.0,48.0,44.0,0
6174,CC:2F:71:3F:1F:24,4467573,1184956446,641850,702439632,3825723,482516814,37,525481,564570590,524845,564494066,636,76524,507799,10,642087,63323,34,451,130000.0,39000.0,-67.0,-65.0,-70.0,-67.0,-67.0,-65.0,-70.0,-67.0,-90.0,-93.0,-90.0,-93.0,23.0,28.0,20.0,26.0,0
6175,CC:2F:71:3E:C5:1F,3826494,482611080,771,94266,3825723,482516814,0,3230,271232,2666,204236,564,66996,816,8,1111,18,0,37,130000.0,39000.0,-70.0,-71.0,-67.0,-60.0,-70.0,-71.0,-67.0,-60.0,-90.0,-93.0,-90.0,-93.0,20.0,22.0,23.0,33.0,0
6176,BA:8C:B9:54:50:24,3830456,488668501,4733,6151687,3825723,482516814,0,8376,1651330,8354,1647835,22,3495,2324,14,5116,36,0,53,229410.0,130000.0,-49.0,-35.0,-42.0,-45.0,-45.0,-35.0,-43.0,-47.0,-90.0,-93.0,-90.0,-93.0,41.0,58.0,48.0,48.0,0
6177,92:69:1D:31:68:E9,3829477,486097373,3752,3580357,3825725,482517016,0,4190,1042677,4072,1016182,118,26495,2005,7,3888,80,0,36,216660.0,130000.0,-51.0,-47.0,-42.0,-49.0,-51.0,-49.0,-44.0,-48.0,-90.0,-93.0,-90.0,-93.0,39.0,46.0,48.0,44.0,0
6178,CC:2F:71:3F:1F:24,4467621,1184971480,641892,702454060,3825729,482517420,37,525512,564576138,524876,564499614,636,76524,507830,10,642129,63337,34,451,130000.0,39000.0,-67.0,-65.0,-70.0,-67.0,-67.0,-65.0,-70.0,-67.0,-90.0,-93.0,-90.0,-93.0,23.0,28.0,20.0,26.0,0
6179,CC:2F:71:3E:C5:1F,3826501,482611746,771,94266,3825730,482517480,0,3230,271232,2666,204236,564,66996,816,8,1111,18,0,37,130000.0,39000.0,-70.0,-71.0,-67.0,-60.0,-70.0,-71.0,-67.0,-60.0,-90.0,-93.0,-90.0,-93.0,20.0,22.0,23.0,33.0,0
6180,BA:8C:B9:54:50:24,3830463,488669167,4733,6151687,3825730,482517480,0,8376,1651330,8354,1647835,22,3495,2324,14,5116,36,0,53,229410.0,130000.0,-49.0,-35.0,-42.0,-45.0,-45.0,-35.0,-43.0,-47.0,-90.0,-93.0,-90.0,-93.0,41.0,58.0,48.0,48.0,0
6181,92:69:1D:31:68:E9,3829484,486098039,3752,3580357,3825732,482517682,0,4190,1042677,4072,1016182,118,26495,2005,7,3888,80,0,36,216660.0,130000.0,-51.0,-47.0,-42.0,-49.0,-51.0,-49.0,-44.0,-48.0,-90.0,-93.0,-90.0,-93.0,39.0,46.0,48.0,44.0,0
6182,CC:2F:71:3F:1F:24,4467666,1184986114,641934,702468432,3825732,482517682,37,525537,564580942,524901,564504418,636,76524,507855,10,642171,63362,34,451,130000.0,43333.0,-67.0,-65.0,-71.0,-68.0,-67.0,-65.0,-70.0,-67.0,-90.0,-93.0,-90.0,-93.0,23.0,28.0,19.0,25.0,0
6183,CC:2F:71:3E:C5:1F,3826503,482611948,771,94266,3825732,482517682,0,3230,271232,2666,204236,564,66996,816,8,1111,18,0,37,130000.0,39000.0,-70.0,-71.0,-67.0,-60.0,-70.0,-71.0,-67.0,-60.0,-90.0,-93.0,-90.0,-93.0,20.0,22.0,23.0,33.0,0
6184,BA:8C:B9:54:50:24,3830465,488669369,4733,6151687,3825732,482517682,0,8376,1651330,8354,1647835,22,3495,2324,14,5116,36,0,53,229410.0,130000.0,-49.0,-35.0,-42.0,-45.0,-45.0,-35.0,-43.0,-47.0,-90.0,-93.0,-90.0,-93.0,41.0,58.0,48.0,48.0,0
6185,92:69:1D:31:68:E9,3829486,486098241,3752,3580357,3825734,482517884,0,4190,1042677,4072,1016182,118,26495,2005,7,3888,80,0,36,216660.0,130000.0,-51.0,-47.0,-42.0,-49.0,-51.0,-49.0,-44.0,-48.0,-90.0,-93.0,-90.0,-93.0,39.0,46.0,48.0,44.0,0
6186,CC:2F:71:3F:1F:24,4467715,1185001390,641977,702483102,3825738,482518288,37,525562,564585746,524926,564509222,636,76524,507880,10,642214,63368,34,451,130000.0,43333.0,-67.0,-65.0,-70.0,-68.0,-67.0,-65.0,-70.0,-67.0,-90.0,-93.0,-90.0,-93.0,23.0,28.0,20.0,25.0,0
6187,CC:2F:71:3E:C5:1F,3826509,482612554,771,94266,3825738,482518288,0,3230,271232,2666,204236,564,66996,816,8,1111,18,0,37,130000.0,39000.0,-70.0,-71.0,-67.0,-60.0,-70.0,-71.0,-67.0,-60.0,-90.0,-93.0,-90.0,-93.0,20.0,22.0,23.0,33.0,0
6188,BA:8C:B9:54:50:24,3830471,488669975,4733,6151687,3825738,482518288,0,8376,1651330,8354,1647835,22,3495,2324,14,5116,36,0,53,229410.0,130000.0,-49.0,-35.0,-42.0,-45.0,-45.0,-35.0,-43.0,-47.0,-90.0,-93.0,-90.0,-93.0,41.0,58.0,48.0,48.0,0
6189,92:69:1D:31:68:E9,3829493,486098907,3752,3580357,3825741,482518550,0,4190,1042677,4072,1016182,118,26495,2005,7,3888,80,0,36,216660.0,130000.0,-51.0,-47.0,-42.0,-49.0,-51.0,-49.0,-44.0,-48.0,-91.0,-94.0,-90.0,-93.0,40.0,47.0,48.0,44.0,0
6190,CC:2F:71:3F:1F:24,4467759,1185015956,642018,702497406,3825741,482518550,37,525588,564590690,524952,564514166,636,76524,507906,10,642255,63386,34,451,117000.0,39000.0,-67.0,-65.0,-71.0,-67.0,-67.0,-65.0,-70.0,-67.0,-91.0,-94.0,-90.0,-93.0,24.0,29.0,19.0,26.0,0
6191,CC:2F:71:3E:C5:1F,3826512,482612816,771,94266,3825741,482518550,0,3230,271232,2666,204236,564,66996,816,8,1111,18,0,37,130000.0,39000.0,-70.0,-71.0,-67.0,-60.0,-70.0,-71.0,-67.0,-60.0,-91.0,-94.0,-90.0,-93.0,21.0,23.0,23.0,33.0,0
6192,BA:8C:B9:54:50:24,3830474,488670237,4733,6151687,3825741,482518550,0,8376,1651330,8354,1647835,22,3495,2324,14,5116,36,0,53,229410.0,130000.0,-49.0,-35.0,-42.0,-45.0,-45.0,-35.0,-43.0,-47.0,-91.0,-94.0,-90.0,-93.0,42.0,59.0,48.0,48.0,0
6193,92:69:1D:31:68:E9,3829495,486099109,3752,3580357,3825743,482518752,0,4190,1042677,4072,1016182,118,26495,2005,7,3888,80,0,36,216660.0,130000.0,-51.0,-47.0,-42.0,-49.0,-51.0,-49.0,-44.0,-48.0,-91.0,-94.0,-90.0,-93.0,40.0,47.0,48.0,44.0,0
6194,CC:2F:71:3F:1F:24,4467805,1185030788,642060,702511834,3825745,482518954,37,525613,564595494,524977,564518970,636,76524,507931,10,642297,63388,34,451,130000.0,43333.0,-67.0,-65.0,-70.0,-68.0,-67.0,-65.0,-70.0,-67.0,-91.0,-94.0,-90.0,-93.0,24.0,29.0,20.0,25.0,0
6195,CC:2F:71:3E:C5:1F,3826518,482613422,771,94266,3825747,482519156,0,3230,271232,2666,204236,564,66996,816,8,1111,18,0,37,130000.0,39000.0,-70.0,-71.0,-67.0,-60.0,-70.0,-71.0,-67.0,-60.0,-91.0,-94.0,-90.0,-93.0,21.0,23.0,23.0,33.0,0
6196,BA:8C:B9:54:50:24,3830480,488670843,4733,6151687,3825747,482519156,0,8376,1651330,8354,1647835,22,3495,2324,14,5116,36,0,53,229410.0,130000.0,-49.0,-35.0,-42.0,-45.0,-45.0,-35.0,-43.0,-47.0,-91.0,-94.0,-90.0,-93.0,42.0,59.0,48.0,48.0,0
6197,92:69:1D:31:68:E9,3829501,486099715,3752,3580357,3825749,482519358,0,4190,1042677,4072,1016182,118,26495,2005,7,3888,80,0,36,216660.0,130000.0,-51.0,-47.0,-42.0,-49.0,-51.0,-49.0,-44.0,-48.0,-91.0,-94.0,-90.0,-93.0,40.0,47.0,48.0,44.0,0
6198,CC:2F:71:3F:1F:24,4467850,1185045496,642101,702526138,3825749,482519358,37,525640,564600554,525004,564524030,636,76524,507958,10,642338,63407,34,451,117000.0,39000.0,-67.0,-65.0,-71.0,-67.0,-67.0,-65.0,-70.0,-67.0,-91.0,-94.0,-90.0,-93.0,24.0,29.0,19.0,26.0,0
6199,CC:2F:71:3E:C5:1F,3826520,482613624,771,94266,3825749,482519358,0,3230,271232,2666,204236,564,66996,816,8,1111,18,0,37,130000.0,39000.0,-70.0,-71.0,-67.0,-60.0,-70.0,-71.0,-67.0,-60.0,-91.0,-94.0,-90.0,-93.0,21.0,23.0,23.0,33.0,0
6200,BA:8C:B9:54:50:24,3830482,488671045,4733,6151687,3825749,482519358,0,8376,1651330,8354,1647835,22,3495,2324,14,5116,36,0,53,229410.0,130000.0,-49.0,-35.0,-42.0,-45.0,-45.0,-35.0,-43.0,-47.0,-91.0,-94.0,-90.0,-93.0,42.0,59.0,48.0,48.0,0
6201,92:69:1D:31:68:E9,3829504,486099977,3752,3580357,3825752,482519620,0,4190,1042677,4072,1016182,118,26495,2005,7,3888,80,0,36,216660.0,130000.0,-51.0,-47.0,-42.0,-49.0,-51.0,-49.0,-44.0,-48.0,-90.0,-93.0,-89.0,-93.0,39.0,46.0,47.0,44.0,0
6202,CC:2F:71:3F:1F:24,4467898,1185060542,642144,702540720,3825754,482519822,37,525666,564605462,525030,564528938,636,76524,507984,10,642381,63412,34,451,130000.0,43333.0,-67.0,-65.0,-70.0,-68.0,-67.0,-65.0,-70.0,-67.0,-90.0,-93.0,-89.0,-93.0,23.0,28.0,19.0,25.0,0
6203,CC:2F:71:3E:C5:1F,3826527,482614290,771,94266,3825756,482520024,0,3230,271232,2666,204236,564,66996,816,8,1111,18,0,37,130000.0,39000.0,-70.0,-71.0,-67.0,-60.0,-70.0,-71.0,-67.0,-60.0,-90.0,-93.0,-89.0,-93.0,20.0,22.0,22.0,33.0,0
6204,BA:8C:B9:54:50:24,3830489,488671711,4733,6151687,3825756,482520024,0,8376,1651330,8354,1647835,22,3495,2324,14,5116,36,0,53,229410.0,130000.0,-49.0,-35.0,-42.0,-45.0,-45.0,-35.0,-43.0,-47.0,-90.0,-93.0,-89.0,-93.0,41.0,58.0,47.0,48.0,0
6205,92:69:1D:31:68:E9,3829511,486100699,3753,3580473,3825758,482520226,0,4192,1042813,4074,1016318,118,26495,2005,7,3889,80,0,36,216660.0,130000.0,-51.0,-47.0,-42.0,-49.0,-51.0,-49.0,-43.0,-48.0,-90.0,-93.0,-89.0,-93.0,39.0,46.0,47.0,44.0,0
6206,CC:2F:71:3F:1F:24,4467944,1185075422,642186,702555196,3825758,482520226,37,525691,564610266,525055,564533742,636,76524,508009,10,642423,63428,34,451,130000.0,39000.0,-67.0,-65.0,-70.0,-68.0,-67.0,-65.0,-70.0,-67.0,-90.0,-93.0,-89.0,-93.0,23.0,28.0,19.0,25.0,0
6207,CC:2F:71:3E:C5:1F,3826530,482614608,772,94382,3825758,482520226,0,3232,271372,2668,204376,564,66996,816,8,1112,18,0,37,130000.0,39000.0,-70.0,-71.0,-67.0,-60.0,-70.0,-71.0,-67.0,-60.0,-90.0,-93.0,-89.0,-93.0,20.0,22.0,22.0,33.0,0
6208,BA:8C:B9:54:50:24,3830492,488672029,4734,6151803,3825758,482520226,0,8378,1651466,8356,1647971,22,3495,2324,14,5117,36,0,53,229410.0,130000.0,-40.0,-37.0,-45.0,-52.0,-44.0,-35.0,-43.0,-48.0,-90.0,-93.0,-89.0,-93.0,50.0,56.0,44.0,41.0,0
6209,92:69:1D:31:68:E9,3829514,486101174,3753,3580473,3825761,482520701,0,4192,1042813,4074,1016318,118,26495,2005,7,3889,80,0,36,216660.0,130000.0,-51.0,-47.0,-42.0,-49.0,-51.0,-49.0,-43.0,-48.0,-90.0,-93.0,-89.0,-93.0,39.0,46.0,47.0,44.0,0
6210,CC:2F:71:3F:1F:24,4467992,1185090587,642228,702569624,3825764,482520963,37,525717,564615210,525081,564538686,636,76524,508035,10,642465,63441,34,451,130000.0,43333.0,-67.0,-65.0,-71.0,-67.0,-67.0,-65.0,-70.0,-67.0,-90.0,-93.0,-89.0,-93.0,23.0,28.0,18.0,26.0,0
6211,CC:2F:71:3E:C5:1F,3826538,482615547,772,94382,3825766,482521165,0,3232,271372,2668,204376,564,66996,816,8,1112,18,0,37,130000.0,39000.0,-70.0,-71.0,-67.0,-60.0,-70.0,-71.0,-67.0,-60.0,-90.0,-93.0,-89.0,-93.0,20.0,22.0,22.0,33.0,0
6212,BA:8C:B9:54:50:24,3830500,488672968,4734,6151803,3825766,482521165,0,8379,1651534,8357,1648039,22,3495,2324,14,5117,36,0,53,229410.0,130000.0,-40.0,-37.0,-45.0,-52.0,-44.0,-35.0,-43.0,-48.0,-90.0,-93.0,-89.0,-93.0,50.0,56.0,44.0,41.0,0
6213,92:69:1D:31:68:E9,3829521,486101840,3753,3580473,3825768,482521367,0,4192,1042813,4074,1016318,118,26495,2005,7,3889,80,0,36,216660.0,130000.0,-51.0,-47.0,-42.0,-49.0,-51.0,-49.0,-43.0,-48.0,-90.0,-93.0,-89.0,-93.0,39.0,46.0,47.0,44.0,0
6214,CC:2F:71:3F:1F:24,4468037,1185105351,642269,702583984,3825768,482521367,37,525742,564620014,525106,564543490,636,76524,508060,10,642506,63444,34,451,130000.0,43333.0,-67.0,-65.0,-70.0,-67.0,-67.0,-65.0,-70.0,-67.0,-90.0,-93.0,-89.0,-93.0,23.0,28.0,19.0,26.0,0
6215,CC:2F:71:3E:C5:1F,3826540,482615749,772,94382,3825768,482521367,0,3232,271372,2668,204376,564,66996,816,8,1112,18,0,37,130000.0,39000.0,-70.0,-71.0,-67.0,-60.0,-70.0,-71.0,-67.0,-60.0,-90.0,-93.0,-89.0,-93.0,20.0,22.0,22.0,33.0,0
6216,BA:8C:B9:54:50:24,3830502,488673170,4734,6151803,3825768,482521367,0,8379,1651534,8357,1648039,22,3495,2324,14,5117,36,0,53,229410.0,130000.0,-40.0,-37.0,-45.0,-52.0,-44.0,-35.0,-43.0,-48.0,-90.0,-93.0,-89.0,-93.0,50.0,56.0,44.0,41.0,0
6217,92:69:1D:31:68:E9,3829523,486102042,3753,3580473,3825770,482521569,0,4192,1042813,4074,1016318,118,26495,2005,7,3889,80,0,36,216660.0,130000.0,-51.0,-47.0,-42.0,-49.0,-51.0,-49.0,-43.0,-48.0,-90.0,-93.0,-89.0,-93.0,39.0,46.0,47.0,44.0,0
6218,CC:2F:71:3F:1F:24,4468083,1185120183,642311,702598412,3825772,482521771,37,525767,564624818,525131,564548294,636,76524,508085,10,642548,63462,34,451,117000.0,39000.0,-67.0,-65.0,-71.0,-68.0,-67.0,-65.0,-70.0,-67.0,-90.0,-93.0,-89.0,-93.0,23.0,28.0,18.0,25.0,0
6219,CC:2F:71:3E:C5:1F,3826546,482616355,772,94382,3825774,482521973,0,3232,271372,2668,204376,564,66996,816,8,1112,18,0,37,130000.0,39000.0,-70.0,-71.0,-67.0,-60.0,-70.0,-71.0,-67.0,-60.0,-90.0,-93.0,-89.0,-93.0,20.0,22.0,22.0,33.0,0
6220,BA:8C:B9:54:50:24,3830508,488673776,4734,6151803,3825774,482521973,0,8379,1651534,8357,1648039,22,3495,2324,14,5117,36,0,53,229410.0,130000.0,-40.0,-37.0,-45.0,-52.0,-44.0,-35.0,-43.0,-48.0,-90.0,-93.0,-89.0,-93.0,50.0,56.0,44.0,41.0,0
6221,92:69:1D:31:68:E9,3829530,486102708,3753,3580473,3825777,482522235,0,4192,1042813,4074,1016318,118,26495,2005,7,3889,80,0,36,216660.0,130000.0,-51.0,-47.0,-42.0,-49.0,-51.0,-49.0,-43.0,-48.0,-90.0,-93.0,-89.0,-93.0,39.0,46.0,47.0,44.0,0
6222,CC:2F:71:3F:1F:24,4468130,1185135131,642353,702612896,3825777,482522235,37,525793,564629762,525157,564553238,636,76524,508111,10,642590,63471,34,451,130000.0,43333.0,-67.0,-65.0,-70.0,-68.0,-67.0,-65.0,-70.0,-67.0,-90.0,-93.0,-89.0,-93.0,23.0,28.0,19.0,25.0,0
6223,CC:2F:71:3E:C5:1F,3826549,482616617,772,94382,3825777,482522235,0,3232,271372,2668,204376,564,66996,816,8,1112,18,0,37,130000.0,39000.0,-70.0,-71.0,-67.0,-60.0,-70.0,-71.0,-67.0,-60.0,-90.0,-93.0,-89.0,-93.0,20.0,22.0,22.0,33.0,0
6224,BA:8C:B9:54:50:24,3830511,488674038,4734,6151803,3825777,482522235,0,8379,1651534,8357,1648039,22,3495,2324,14,5117,36,0,53,229410.0,130000.0,-40.0,-37.0,-45.0,-52.0,-44.0,-35.0,-43.0,-48.0,-90.0,-93.0,-89.0,-93.0,50.0,56.0,44.0,41.0,0
6225,92:69:1D:31:68:E9,3829534,486103112,3753,3580473,3825781,482522639,0,4192,1042813,4074,1016318,118,26495,2005,7,3889,80,0,36,216660.0,130000.0,-51.0,-47.0,-42.0,-49.0,-51.0,-49.0,-43.0,-48.0,-90.0,-93.0,-89.0,-93.0,39.0,46.0,47.0,44.0,0
6226,CC:2F:71:3F:1F:24,4468177,1185150031,642396,702627392,3825781,482522639,37,525820,564634822,525184,564558298,636,76524,508138,10,642633,63501,34,451,144444.0,39000.0,-67.0,-65.0,-70.0,-68.0,-67.0,-65.0,-70.0,-67.0,-90.0,-93.0,-89.0,-93.0,23.0,28.0,19.0,25.0,0
6227,CC:2F:71:3E:C5:1F,3826553,482617021,772,94382,3825781,482522639,0,3233,271442,2669,204446,564,66996,816,8,1113,18,0,37,130000.0,39000.0,-70.0,-71.0,-67.0,-60.0,-70.0,-71.0,-67.0,-60.0,-90.0,-93.0,-89.0,-93.0,20.0,22.0,22.0,33.0,0
6228,BA:8C:B9:54:50:24,3830517,488674644,4734,6151803,3825783,482522841,0,8379,1651534,8357,1648039,22,3495,2324,14,5117,36,0,53,229410.0,130000.0,-40.0,-37.0,-45.0,-52.0,-44.0,-35.0,-43.0,-48.0,-90.0,-93.0,-89.0,-93.0,50.0,56.0,44.0,41.0,0
6229,92:69:1D:31:68:E9,3829539,486103578,3753,3580473,3825786,482523105,0,4194,1042949,4076,1016454,118,26495,2005,7,3890,80,0,36,216660.0,130000.0,-52.0,-50.0,-44.0,-46.0,-51.0,-49.0,-43.0,-47.0,-90.0,-93.0,-89.0,-93.0,38.0,43.0,45.0,47.0,0
6230,CC:2F:71:3F:1F:24,4468225,1185165425,642439,702642320,3825786,482523105,37,525848,564640034,525211,564563392,637,76642,508166,10,642676,63516,34,451,130000.0,43333.0,-67.0,-65.0,-70.0,-67.0,-67.0,-65.0,-70.0,-67.0,-90.0,-93.0,-89.0,-93.0,23.0,28.0,19.0,26.0,0
6231,CC:2F:71:3E:C5:1F,3826558,482617487,772,94382,3825786,482523105,0,3234,271512,2670,204516,564,66996,816,8,1113,18,0,37,130000.0,39000.0,-69.0,-71.0,-68.0,-60.0,-69.0,-71.0,-67.0,-60.0,-90.0,-93.0,-89.0,-93.0,21.0,22.0,21.0,33.0,0
6232,BA:8C:B9:54:50:24,3830521,488674968,4734,6151803,3825787,482523165,0,8379,1651534,8357,1648039,22,3495,2324,14,5117,36,0,53,229410.0,130000.0,-40.0,-37.0,-45.0,-52.0,-44.0,-35.0,-43.0,-48.0,-90.0,-93.0,-89.0,-93.0,50.0,56.0,44.0,41.0,0
6233,92:69:1D:31:68:E9,3829542,486103840,3753,3580473,3825789,482523367,0,4194,1042949,4076,1016454,118,26495,2005,7,3890,80,0,36,216660.0,130000.0,-52.0,-50.0,-44.0,-46.0,-51.0,-49.0,-43.0,-47.0,-90.0,-93.0,-89.0,-93.0,38.0,43.0,45.0,47.0,0
6234,CC:2F:71:3F:1F:24,4468274,1185180677,642483,702657108,3825791,482523569,37,525875,564645094,525238,564568452,637,76642,508193,10,642720,63520,34,451,130000.0,43333.0,-67.0,-65.0,-70.0,-68.0,-67.0,-65.0,-70.0,-67.0,-90.0,-93.0,-89.0,-93.0,23.0,28.0,19.0,25.0,0
6235,CC:2F:71:3E:C5:1F,3826565,482618153,772,94382,3825793,482523771,0,3234,271512,2670,204516,564,66996,816,8,1113,18,0,37,130000.0,39000.0,-69.0,-71.0,-68.0,-60.0,-69.0,-71.0,-67.0,-60.0,-90.0,-93.0,-89.0,-93.0,21.0,22.0,21.0,33.0,0
6236,BA:8C:B9:54:50:24,3830527,488675574,4734,6151803,3825793,482523771,0,8379,1651534,8357,1648039,22,3495,2324,14,5117,36,0,53,229410.0,130000.0,-40.0,-37.0,-45.0,-52.0,-44.0,-35.0,-43.0,-48.0,-90.0,-93.0,-89.0,-93.0,50.0,56.0,44.0,41.0,0
6237,92:69:1D:31:68:E9,3829548,486104446,3753,3580473,3825795,482523973,0,4194,1042949,4076,1016454,118,26495,2005,7,3890,80,0,36,216660.0,130000.0,-52.0,-50.0,-44.0,-46.0,-51.0,-49.0,-43.0,-47.0,-90.0,-93.0,-89.0,-93.0,38.0,43.0,45.0,47.0,0
6238,CC:2F:71:3F:1F:24,4468319,1185195385,642524,702671412,3825795,482523973,37,525900,564649898,525263,564573256,637,76642,508218,10,642761,63545,34,451,117000.0,39000.0,-67.0,-65.0,-70.0,-67.0,-67.0,-65.0,-70.0,-67.0,-90.0,-93.0,-89.0,-93.0,23.0,28.0,19.0,26.0,0
6239,CC:2F:71:3E:C5:1F,3826567,482618355,772,94382,3825795,482523973,0,3234,271512,2670,204516,564,66996,816,8,1113,18,0,37,130000.0,39000.0,-69.0,-71.0,-68.0,-60.0,-69.0,-71.0,-67.0,-60.0,-90.0,-93.0,-89.0,-93.0,21.0,22.0,21.0,33.0,0
6240,BA:8C:B9:54:50:24,3830529,488675776,4734,6151803,3825795,482523973,0,8379,1651534,8357,1648039,22,3495,2324,14,5117,36,0,53,229410.0,130000.0,-40.0,-37.0,-45.0,-52.0,-44.0,-35.0,-43.0,-48.0,-90.0,-93.0,-89.0,-93.0,50.0,56.0,44.0,41.0,0
6241,92:69:1D:31:68:E9,3829551,486104708,3753,3580473,3825798,482524235,0,4194,1042949,4076,1016454,118,26495,2005,7,3890,80,0,36,216660.0,130000.0,-52.0,-50.0,-44.0,-46.0,-51.0,-49.0,-43.0,-47.0,-90.0,-93.0,-89.0,-93.0,38.0,43.0,45.0,47.0,0
6242,CC:2F:71:3F:1F:24,4468369,1185210603,642567,702685964,3825802,482524639,37,525926,564654842,525289,564578200,637,76642,508244,10,642804,63551,34,451,130000.0,43333.0,-67.0,-65.0,-71.0,-67.0,-67.0,-65.0,-70.0,-67.0,-90.0,-93.0,-89.0,-93.0,23.0,28.0,18.0,26.0,0
6243,CC:2F:71:3E:C5:1F,3826574,482619021,772,94382,3825802,482524639,0,3234,271512,2670,204516,564,66996,816,8,1113,18,0,37,130000.0,39000.0,-69.0,-71.0,-68.0,-60.0,-69.0,-71.0,-67.0,-60.0,-90.0,-93.0,-89.0,-93.0,21.0,22.0,21.0,33.0,0
6244,BA:8C:B9:54:50:24,3830536,488676442,4734,6151803,3825802,482524639,0,8379,1651534,8357,1648039,22,3495,2324,14,5117,36,0,53,229410.0,130000.0,-40.0,-37.0,-45.0,-52.0,-44.0,-35.0,-43.0,-48.0,-90.0,-93.0,-89.0,-93.0,50.0,56.0,44.0,41.0,0
6245,92:69:1D:31:68:E9,3829557,486105314,3753,3580473,3825804,482524841,0,4194,1042949,4076,1016454,118,26495,2005,7,3890,80,0,36,216660.0,130000.0,-52.0,-50.0,-44.0,-46.0,-51.0,-49.0,-43.0,-47.0,-90.0,-93.0,-89.0,-93.0,38.0,43.0,45.0,47.0,0
6246,CC:2F:71:3F:1F:24,4468414,1185225419,642610,702700578,3825804,482524841,37,525952,564659786,525315,564583144,637,76642,508270,10,642847,63570,34,451,144444.0,39000.0,-67.0,-65.0,-70.0,-67.0,-67.0,-65.0,-70.0,-67.0,-90.0,-93.0,-89.0,-93.0,23.0,28.0,19.0,26.0,0
6247,CC:2F:71:3E:C5:1F,3826576,482619223,772,94382,3825804,482524841,0,3234,271512,2670,204516,564,66996,816,8,1113,18,0,37,130000.0,39000.0,-69.0,-71.0,-68.0,-60.0,-69.0,-71.0,-67.0,-60.0,-90.0,-93.0,-89.0,-93.0,21.0,22.0,21.0,33.0,0
6248,BA:8C:B9:54:50:24,3830538,488676644,4734,6151803,3825804,482524841,0,8379,1651534,8357,1648039,22,3495,2324,14,5117,36,0,53,229410.0,130000.0,-40.0,-37.0,-45.0,-52.0,-44.0,-35.0,-43.0,-48.0,-90.0,-93.0,-89.0,-93.0,50.0,56.0,44.0,41.0,0
6249,92:69:1D:31:68:E9,3829561,486105718,3753,3580473,3825808,482525245,0,4194,1042949,4076,1016454,118,26495,2005,7,3890,80,0,36,216660.0,130000.0,-52.0,-50.0,-44.0,-46.0,-51.0,-49.0,-43.0,-47.0,-90.0,-93.0,-89.0,-93.0,38.0,43.0,45.0,47.0,0
6250,CC:2F:71:3F:1F:24,4468463,1185240521,642653,702715074,3825810,482525447,37,525978,564664730,525341,564588088,637,76642,508296,10,642890,63598,34,451,130000.0,43333.0,-67.0,-65.0,-71.0,-68.0,-67.0,-65.0,-70.0,-67.0,-90.0,-93.0,-89.0,-93.0,23.0,28.0,18.0,25.0,0
6251,CC:2F:71:3E:C5:1F,3826582,482619829,772,94382,3825810,482525447,0,3234,271512,2670,204516,564,66996,816,8,1113,18,0,37,130000.0,39000.0,-69.0,-71.0,-68.0,-60.0,-69.0,-71.0,-67.0,-60.0,-90.0,-93.0,-89.0,-93.0,21.0,22.0,21.0,33.0,0
6252,BA:8C:B9:54:50:24,3830544,488677250,4734,6151803,3825810,482525447,0,8379,1651534,8357,1648039,22,3495,2324,14,5117,36,0,53,229410.0,130000.0,-40.0,-37.0,-45.0,-52.0,-44.0,-35.0,-43.0,-48.0,-90.0,-93.0,-89.0,-93.0,50.0,56.0,44.0,41.0,0
6253,92:69:1D:31:68:E9,3829567,486106244,3753,3580473,3825814,482525771,0,4194,1042949,4076,1016454,118,26495,2005,7,3890,80,0,36,216660.0,130000.0,-52.0,-50.0,-44.0,-46.0,-51.0,-49.0,-43.0,-47.0,-90.0,-93.0,-89.0,-93.0,38.0,43.0,45.0,47.0,0
6254,CC:2F:71:3F:1F:24,4468509,1185255385,642695,702729614,3825814,482525771,37,526005,564669790,525368,564593148,637,76642,508323,10,642932,63604,34,451,130000.0,43333.0,-67.0,-65.0,-70.0,-67.0,-67.0,-65.0,-70.0,-67.0,-90.0,-93.0,-89.0,-93.0,23.0,28.0,19.0,26.0,0
6255,CC:2F:71:3E:C5:1F,3826586,482620153,772,94382,3825814,482525771,0,3236,271700,2671,204586,565,67114,817,8,1113,18,0,37,130000.0,39000.0,-70.0,-71.0,-68.0,-60.0,-69.0,-71.0,-67.0,-60.0,-90.0,-93.0,-89.0,-93.0,20.0,22.0,21.0,33.0,0
6256,BA:8C:B9:54:50:24,3830549,488677700,4734,6151803,3825815,482525897,0,8379,1651534,8357,1648039,22,3495,2324,14,5117,36,0,53,229410.0,130000.0,-40.0,-37.0,-45.0,-52.0,-44.0,-35.0,-43.0,-48.0,-90.0,-93.0,-89.0,-93.0,50.0,56.0,44.0,41.0,0
6257,92:69:1D:31:68:E9,3829572,486106774,3753,3580473,3825819,482526301,0,4194,1042949,4076,1016454,118,26495,2005,7,3890,80,0,36,216660.0,130000.0,-52.0,-50.0,-44.0,-46.0,-51.0,-49.0,-43.0,-47.0,-90.0,-93.0,-89.0,-93.0,38.0,43.0,45.0,47.0,0
6258,CC:2F:71:3F:1F:24,4468556,1185270291,642735,702743788,3825821,482526503,37,526031,564674770,525394,564598128,637,76642,508349,10,642972,63621,34,451,117000.0,39000.0,-67.0,-65.0,-70.0,-68.0,-67.0,-65.0,-70.0,-67.0,-90.0,-93.0,-89.0,-93.0,23.0,28.0,19.0,25.0,0
6259,CC:2F:71:3E:C5:1F,3826593,482620885,772,94382,3825821,482526503,0,3236,271700,2671,204586,565,67114,817,8,1113,18,0,37,130000.0,39000.0,-70.0,-71.0,-68.0,-60.0,-69.0,-71.0,-67.0,-60.0,-90.0,-93.0,-89.0,-93.0,20.0,22.0,21.0,33.0,0
6260,BA:8C:B9:54:50:24,3830555,488678306,4734,6151803,3825821,482526503,0,8379,1651534,8357,1648039,22,3495,2324,14,5117,36,0,53,229410.0,130000.0,-40.0,-37.0,-45.0,-52.0,-44.0,-35.0,-43.0,-48.0,-90.0,-93.0,-89.0,-93.0,50.0,56.0,44.0,41.0,0
6261,92:69:1D:31:68:E9,3829578,486107511,3753,3580473,3825825,482527038,0,4194,1042949,4076,1016454,118,26495,2005,7,3890,80,0,36,216660.0,130000.0,-52.0,-50.0,-44.0,-46.0,-51.0,-49.0,-43.0,-47.0,-90.0,-93.0,-89.0,-93.0,38.0,43.0,45.0,47.0,0
6262,CC:2F:71:3F:1F:24,4468602,1185285254,642777,702758216,3825825,482527038,37,526056,564679574,525419,564602932,637,76642,508374,10,643014,63625,34,451,130000.0,43333.0,-67.0,-65.0,-70.0,-68.0,-67.0,-65.0,-70.0,-67.0,-90.0,-93.0,-89.0,-93.0,23.0,28.0,19.0,25.0,0
6263,CC:2F:71:3E:C5:1F,3826597,482621420,772,94382,3825825,482527038,0,3236,271700,2671,204586,565,67114,817,8,1113,18,0,37,130000.0,39000.0,-70.0,-71.0,-68.0,-60.0,-69.0,-71.0,-67.0,-60.0,-90.0,-93.0,-89.0,-93.0,20.0,22.0,21.0,33.0,0
6264,BA:8C:B9:54:50:24,3830559,488678841,4734,6151803,3825825,482527038,0,8379,1651534,8357,1648039,22,3495,2324,14,5117,36,0,53,229410.0,130000.0,-40.0,-37.0,-45.0,-52.0,-44.0,-35.0,-43.0,-48.0,-90.0,-93.0,-89.0,-93.0,50.0,56.0,44.0,41.0,0
6265,92:69:1D:31:68:E9,3829590,486110825,3753,3580473,3825837,482530352,0,4194,1042949,4076,1016454,118,26495,2005,7,3890,80,0,36,216660.0,130000.0,-52.0,-50.0,-44.0,-46.0,-51.0,-49.0,-43.0,-47.0,-90.0,-93.0,-89.0,-93.0,38.0,43.0,45.0,47.0,0
6266,CC:2F:71:3F:1F:24,4468658,1185303362,642821,702773010,3825837,482530352,37,526083,564684658,525446,564608016,637,76642,508401,10,643057,63629,34,451,130000.0,43333.0,-67.0,-65.0,-70.0,-67.0,-67.0,-65.0,-70.0,-67.0,-90.0,-93.0,-89.0,-93.0,23.0,28.0,19.0,26.0,0
6267,CC:2F:71:3E:C5:1F,3826611,482624936,772,94382,3825839,482530554,0,3236,271700,2671,204586,565,67114,817,8,1113,18,0,37,130000.0,39000.0,-70.0,-71.0,-68.0,-60.0,-69.0,-71.0,-67.0,-60.0,-90.0,-93.0,-89.0,-93.0,20.0,22.0,21.0,33.0,0
6268,BA:8C:B9:54:50:24,3830573,488682357,4734,6151803,3825839,482530554,0,8379,1651534,8357,1648039,22,3495,2324,14,5117,36,0,53,229410.0,130000.0,-40.0,-37.0,-45.0,-52.0,-44.0,-35.0,-43.0,-48.0,-90.0,-93.0,-89.0,-93.0,50.0,56.0,44.0,41.0,0
6269,92:69:1D:31:68:E9,3829594,486111229,3753,3580473,3825841,482530756,0,4194,1042949,4076,1016454,118,26495,2005,7,3890,80,0,36,216660.0,130000.0,-52.0,-50.0,-44.0,-46.0,-51.0,-49.0,-43.0,-47.0,-90.0,-93.0,-89.0,-93.0,38.0,43.0,45.0,47.0,0
6270,CC:2F:71:3F:1F:24,4468706,1185318504,642865,702787748,3825841,482530756,37,526110,564689718,525473,564613076,637,76642,508428,10,643102,63645,34,451,130000.0,39000.0,-67.0,-65.0,-70.0,-68.0,-67.0,-65.0,-70.0,-67.0,-90.0,-93.0,-89.0,-93.0,23.0,28.0,19.0,25.0,0
6271,CC:2F:71:3E:C5:1F,3826613,482625138,772,94382,3825841,482530756,0,3236,271700,2671,204586,565,67114,817,8,1113,18,0,37,130000.0,39000.0,-70.0,-71.0,-68.0,-60.0,-69.0,-71.0,-67.0,-60.0,-90.0,-93.0,-89.0,-93.0,20.0,22.0,21.0,33.0,0
6272,BA:8C:B9:54:50:24,3830575,488682559,4734,6151803,3825841,482530756,0,8379,1651534,8357,1648039,22,3495,2324,14,5117,36,0,53,229410.0,130000.0,-40.0,-37.0,-45.0,-52.0,-44.0,-35.0,-43.0,-48.0,-90.0,-93.0,-89.0,-93.0,50.0,56.0,44.0,41.0,0
6273,92:69:1D:31:68:E9,3829599,486111693,3753,3580473,3825846,482531220,0,4194,1042949,4076,1016454,118,26495,2005,7,3890,80,0,36,216660.0,130000.0,-52.0,-50.0,-44.0,-46.0,-51.0,-49.0,-43.0,-47.0,-90.0,-93.0,-89.0,-93.0,38.0,43.0,45.0,47.0,0
6274,CC:2F:71:3F:1F:24,4468754,1185333520,642908,702802300,3825846,482531220,37,526137,564694778,525500,564618136,637,76642,508455,10,643145,63658,34,451,130000.0,43333.0,-67.0,-65.0,-70.0,-68.0,-67.0,-65.0,-70.0,-67.0,-90.0,-93.0,-89.0,-93.0,23.0,28.0,19.0,25.0,0
6275,CC:2F:71:3E:C5:1F,3826620,482625804,772,94382,3825848,482531422,0,3236,271700,2671,204586,565,67114,817,8,1113,18,0,37,130000.0,39000.0,-70.0,-71.0,-68.0,-60.0,-69.0,-71.0,-67.0,-60.0,-90.0,-93.0,-89.0,-93.0,20.0,22.0,21.0,33.0,0
6276,BA:8C:B9:54:50:24,3830582,488683225,4734,6151803,3825848,482531422,0,8379,1651534,8357,1648039,22,3495,2324,14,5117,36,0,53,229410.0,130000.0,-40.0,-37.0,-45.0,-52.0,-44.0,-35.0,-43.0,-48.0,-90.0,-93.0,-89.0,-93.0,50.0,56.0,44.0,41.0,0
6277,92:69:1D:31:68:E9,3829603,486112097,3753,3580473,3825850,482531624,0,4194,1042949,4076,1016454,118,26495,2005,7,3890,80,0,36,216660.0,130000.0,-52.0,-50.0,-44.0,-46.0,-51.0,-49.0,-43.0,-47.0,-90.0,-93.0,-89.0,-93.0,38.0,43.0,45.0,47.0,0
6278,CC:2F:71:3F:1F:24,4468800,1185348408,642950,702816784,3825850,482531624,37,526162,564699582,525525,564622940,637,76642,508480,10,643187,63659,34,451,130000.0,43333.0,-67.0,-65.0,-70.0,-67.0,-67.0,-65.0,-70.0,-67.0,-90.0,-93.0,-89.0,-93.0,23.0,28.0,19.0,26.0,0
6279,CC:2F:71:3E:C5:1F,3826622,482626006,772,94382,3825850,482531624,0,3236,271700,2671,204586,565,67114,817,8,1113,18,0,37,130000.0,39000.0,-70.0,-71.0,-68.0,-60.0,-69.0,-71.0,-67.0,-60.0,-90.0,-93.0,-89.0,-93.0,20.0,22.0,21.0,33.0,0
6280,BA:8C:B9:54:50:24,3830584,488683427,4734,6151803,3825850,482531624,0,8379,1651534,8357,1648039,22,3495,2324,14,5117,36,0,53,229410.0,130000.0,-40.0,-37.0,-45.0,-52.0,-44.0,-35.0,-43.0,-48.0,-90.0,-93.0,-89.0,-93.0,50.0,56.0,44.0,41.0,0
6281,92:69:1D:31:68:E9,3829607,486112501,3753,3580473,3825854,482532028,0,4194,1042949,4076,1016454,118,26495,2005,7,3890,80,0,36,216660.0,130000.0,-52.0,-50.0,-44.0,-46.0,-51.0,-49.0,-43.0,-47.0,-90.0,-93.0,-89.0,-93.0,38.0,43.0,45.0,47.0,0
6282,CC:2F:71:3F:1F:24,4468850,1185363696,642994,702831466,3825856,482532230,37,526188,564704526,525551,564627884,637,76642,508506,10,643231,63690,34,451,144444.0,43333.0,-67.0,-65.0,-70.0,-67.0,-67.0,-65.0,-70.0,-67.0,-90.0,-93.0,-89.0,-93.0,23.0,28.0,19.0,26.0,0
6283,CC:2F:71:3E:C5:1F,3826629,482626672,772,94382,3825857,482532290,0,3236,271700,2671,204586,565,67114,817,8,1113,18,0,37,130000.0,39000.0,-70.0,-71.0,-68.0,-60.0,-69.0,-71.0,-67.0,-60.0,-90.0,-93.0,-89.0,-93.0,20.0,22.0,21.0,33.0,0
6284,BA:8C:B9:54:50:24,3830591,488684093,4734,6151803,3825857,482532290,0,8379,1651534,8357,1648039,22,3495,2324,14,5117,36,0,53,229410.0,130000.0,-40.0,-37.0,-45.0,-52.0,-44.0,-35.0,-43.0,-48.0,-90.0,-93.0,-89.0,-93.0,50.0,56.0,44.0,41.0,0
6285,92:69:1D:31:68:E9,3829612,486112965,3753,3580473,3825859,482532492,0,4194,1042949,4076,1016454,118,26495,2005,7,3890,80,0,36,216660.0,130000.0,-52.0,-50.0,-44.0,-46.0,-51.0,-49.0,-43.0,-47.0,-90.0,-91.0,-88.0,-91.0,38.0,41.0,44.0,45.0,0
6286,CC:2F:71:3F:1F:24,4468894,1185378262,643035,702845770,3825859,482532492,37,526214,564709470,525577,564632828,637,76642,508532,10,643272,63697,34,451,130000.0,43333.0,-67.0,-65.0,-70.0,-68.0,-67.0,-65.0,-70.0,-67.0,-90.0,-91.0,-88.0,-91.0,23.0,26.0,18.0,23.0,0
6287,CC:2F:71:3E:C5:1F,3826631,482626874,772,94382,3825859,482532492,0,3236,271700,2671,204586,565,67114,817,8,1113,18,0,37,130000.0,39000.0,-70.0,-71.0,-68.0,-60.0,-69.0,-71.0,-67.0,-60.0,-90.0,-91.0,-88.0,-91.0,20.0,20.0,20.0,31.0,0
6288,BA:8C:B9:54:50:24,3830593,488684295,4734,6151803,3825859,482532492,0,8379,1651534,8357,1648039,22,3495,2324,14,5117,36,0,53,229410.0,130000.0,-40.0,-37.0,-45.0,-52.0,-44.0,-35.0,-43.0,-48.0,-90.0,-91.0,-88.0,-91.0,50.0,54.0,43.0,39.0,0
6289,92:69:1D:31:68:E9,3829616,486113369,3753,3580473,3825863,482532896,0,4194,1042949,4076,1016454,118,26495,2005,7,3890,80,0,36,216660.0,130000.0,-52.0,-50.0,-44.0,-46.0,-51.0,-49.0,-43.0,-47.0,-90.0,-91.0,-88.0,-91.0,38.0,41.0,44.0,45.0,0
6290,CC:2F:71:3F:1F:24,4468942,1185393342,643078,702860378,3825864,482532964,37,526239,564714274,525602,564637632,637,76642,508557,10,643315,63721,34,451,130000.0,39000.0,-67.0,-65.0,-70.0,-68.0,-67.0,-65.0,-70.0,-67.0,-90.0,-91.0,-88.0,-91.0,23.0,26.0,18.0,23.0,0
6291,CC:2F:71:3E:C5:1F,3826637,482627480,772,94382,3825865,482533098,0,3236,271700,2671,204586,565,67114,817,8,1113,18,0,37,130000.0,39000.0,-70.0,-71.0,-68.0,-60.0,-69.0,-71.0,-67.0,-60.0,-90.0,-91.0,-88.0,-91.0,20.0,20.0,20.0,31.0,0
6292,BA:8C:B9:54:50:24,3830599,488684901,4734,6151803,3825865,482533098,0,8379,1651534,8357,1648039,22,3495,2324,14,5117,36,0,53,229410.0,130000.0,-40.0,-37.0,-45.0,-52.0,-44.0,-35.0,-43.0,-48.0,-90.0,-91.0,-88.0,-91.0,50.0,54.0,43.0,39.0,0
6293,92:69:1D:31:68:E9,3829621,486113833,3753,3580473,3825868,482533360,0,4195,1043017,4077,1016522,118,26495,2005,7,3890,80,0,36,216660.0,130000.0,-52.0,-50.0,-44.0,-46.0,-51.0,-49.0,-43.0,-47.0,-90.0,-91.0,-88.0,-91.0,38.0,41.0,44.0,45.0,0
6294,CC:2F:71:3F:1F:24,4468987,1185408042,643119,702874682,3825868,482533360,37,526265,564719194,525628,564642552,637,76642,508583,10,643356,63728,34,451,130000.0,39000.0,-67.0,-65.0,-70.0,-68.0,-67.0,-65.0,-70.0,-67.0,-90.0,-91.0,-89.0,-91.0,23.0,26.0,19.0,23.0,0
6295,CC:2F:71:3E:C5:1F,3826640,482627742,772,94382,3825868,482533360,0,3236,271700,2671,204586,565,67114,817,8,1113,18,0,37,130000.0,39000.0,-70.0,-71.0,-68.0,-60.0,-69.0,-71.0,-67.0,-60.0,-90.0,-91.0,-89.0,-91.0,20.0,20.0,21.0,31.0,0
6296,BA:8C:B9:54:50:24,3830602,488685163,4734,6151803,3825868,482533360,0,8379,1651534,8357,1648039,22,3495,2324,14,5117,36,0,53,229410.0,130000.0,-40.0,-37.0,-45.0,-52.0,-44.0,-35.0,-43.0,-48.0,-90.0,-91.0,-89.0,-91.0,50.0,54.0,44.0,39.0,0
6297,92:69:1D:31:68:E9,3829625,486114237,3753,3580473,3825872,482533764,0,4195,1043017,4077,1016522,118,26495,2005,7,3890,80,0,36,216660.0,130000.0,-52.0,-50.0,-44.0,-46.0,-51.0,-49.0,-43.0,-47.0,-90.0,-91.0,-89.0,-91.0,38.0,41.0,45.0,45.0,0
6298,CC:2F:71:3F:1F:24,4469032,1185422800,643160,702889036,3825872,482533764,37,526290,564723998,525653,564647356,637,76642,508608,10,643397,63732,34,451,130000.0,43333.0,-67.0,-65.0,-70.0,-68.0,-67.0,-65.0,-70.0,-67.0,-90.0,-91.0,-89.0,-91.0,23.0,26.0,19.0,23.0,0
6299,CC:2F:71:3E:C5:1F,3826646,482628348,772,94382,3825874,482533966,0,3236,271700,2671,204586,565,67114,817,8,1113,18,0,37,130000.0,39000.0,-70.0,-71.0,-68.0,-60.0,-69.0,-71.0,-67.0,-60.0,-90.0,-91.0,-89.0,-91.0,20.0,20.0,21.0,31.0,0
6300,BA:8C:B9:54:50:24,3830608,488685769,4734,6151803,3825874,482533966,0,8379,1651534,8357,1648039,22,3495,2324,14,5117,36,0,53,229410.0,130000.0,-40.0,-37.0,-45.0,-52.0,-44.0,-35.0,-43.0,-48.0,-90.0,-91.0,-89.0,-91.0,50.0,54.0,44.0,39.0,0
6301,92:69:1D:31:68:E9,3829629,486114641,3753,3580473,3825876,482534168,0,4195,1043017,4077,1016522,118,26495,2005,7,3890,80,0,36,216660.0,130000.0,-52.0,-50.0,-44.0,-46.0,-51.0,-49.0,-43.0,-47.0,-90.0,-91.0,-89.0,-91.0,38.0,41.0,45.0,45.0,0
6302,CC:2F:71:3F:1F:24,4469078,1185437632,643202,702903464,3825876,482534168,37,526315,564728802,525678,564652160,637,76642,508633,10,643439,63749,34,451,117000.0,39000.0,-67.0,-65.0,-70.0,-67.0,-67.0,-65.0,-70.0,-67.0,-90.0,-91.0,-89.0,-91.0,23.0,26.0,19.0,24.0,0
6303,CC:2F:71:3E:C5:1F,3826648,482628550,772,94382,3825876,482534168,0,3236,271700,2671,204586,565,67114,817,8,1113,18,0,37,130000.0,39000.0,-70.0,-71.0,-68.0,-60.0,-69.0,-71.0,-67.0,-60.0,-90.0,-91.0,-89.0,-91.0,20.0,20.0,21.0,31.0,0
6304,BA:8C:B9:54:50:24,3830610,488685971,4734,6151803,3825876,482534168,0,8379,1651534,8357,1648039,22,3495,2324,14,5117,36,0,53,229410.0,130000.0,-40.0,-37.0,-45.0,-52.0,-44.0,-35.0,-43.0,-48.0,-90.0,-91.0,-89.0,-91.0,50.0,54.0,44.0,39.0,0
6305,92:69:1D:31:68:E9,3829634,486115105,3753,3580473,3825881,482534632,0,4195,1043017,4077,1016522,118,26495,2005,7,3890,80,0,36,216660.0,130000.0,-52.0,-50.0,-44.0,-46.0,-51.0,-49.0,-43.0,-47.0,-90.0,-91.0,-88.0,-91.0,38.0,41.0,44.0,45.0,0
6306,CC:2F:71:3F:1F:24,4469125,1185452530,643244,702917898,3825881,482534632,37,526341,564733746,525704,564657104,637,76642,508659,10,643481,63757,34,451,130000.0,43333.0,-67.0,-65.0,-70.0,-67.0,-67.0,-65.0,-70.0,-67.0,-90.0,-91.0,-88.0,-91.0,23.0,26.0,18.0,24.0,0
6307,CC:2F:71:3E:C5:1F,3826655,482629216,772,94382,3825883,482534834,0,3236,271700,2671,204586,565,67114,817,8,1113,18,0,37,130000.0,39000.0,-70.0,-71.0,-68.0,-60.0,-69.0,-71.0,-67.0,-60.0,-90.0,-91.0,-88.0,-91.0,20.0,20.0,20.0,31.0,0
6308,BA:8C:B9:54:50:24,3830617,488686637,4734,6151803,3825883,482534834,0,8379,1651534,8357,1648039,22,3495,2324,14,5117,36,0,53,229410.0,130000.0,-40.0,-37.0,-45.0,-52.0,-44.0,-35.0,-43.0,-48.0,-90.0,-91.0,-88.0,-91.0,50.0,54.0,43.0,39.0,0
6309,92:69:1D:31:68:E9,3829639,486115625,3754,3580589,3825885,482535036,0,4197,1043153,4079,1016658,118,26495,2005,7,3891,80,0,36,216660.0,130000.0,-52.0,-50.0,-44.0,-46.0,-51.0,-49.0,-43.0,-47.0,-90.0,-91.0,-88.0,-91.0,38.0,41.0,44.0,45.0,0
6310,CC:2F:71:3F:1F:24,4469172,1185467366,643287,702932330,3825885,482535036,37,526366,564738550,525729,564661908,637,76642,508684,10,643524,63788,34,451,130000.0,43333.0,-67.0,-65.0,-70.0,-67.0,-67.0,-65.0,-70.0,-67.0,-90.0,-91.0,-88.0,-91.0,23.0,26.0,18.0,24.0,0
6311,CC:2F:71:3E:C5:1F,3826658,482629534,773,94498,3825885,482535036,0,3238,271840,2673,204726,565,67114,817,8,1114,18,0,37,130000.0,39000.0,-70.0,-70.0,-68.0,-60.0,-69.0,-70.0,-67.0,-60.0,-90.0,-91.0,-88.0,-91.0,20.0,21.0,20.0,31.0,0
6312,BA:8C:B9:54:50:24,3830620,488686955,4735,6151919,3825885,482535036,0,8381,1651670,8359,1648175,22,3495,2324,14,5118,36,0,53,229410.0,130000.0,-49.0,-35.0,-42.0,-44.0,-44.0,-35.0,-43.0,-48.0,-90.0,-91.0,-88.0,-91.0,41.0,56.0,46.0,47.0,0
6313,92:69:1D:31:68:E9,3829644,486116302,3754,3580589,3825890,482535713,0,4197,1043153,4079,1016658,118,26495,2005,7,3891,80,0,36,216660.0,130000.0,-52.0,-50.0,-44.0,-46.0,-51.0,-49.0,-43.0,-47.0,-90.0,-91.0,-88.0,-91.0,38.0,41.0,44.0,45.0,0
6314,CC:2F:71:3F:1F:24,4469220,1185482707,643330,702946994,3825890,482535713,37,526393,564743610,525756,564666968,637,76642,508711,10,643567,63794,34,451,130000.0,43333.0,-67.0,-65.0,-70.0,-67.0,-67.0,-65.0,-70.0,-67.0,-90.0,-91.0,-88.0,-91.0,23.0,26.0,18.0,24.0,0
6315,CC:2F:71:3E:C5:1F,3826666,482630473,773,94498,3825893,482535975,0,3238,271840,2673,204726,565,67114,817,8,1114,18,0,37,130000.0,39000.0,-70.0,-70.0,-68.0,-60.0,-69.0,-70.0,-67.0,-60.0,-90.0,-91.0,-88.0,-91.0,20.0,21.0,20.0,31.0,0
6316,BA:8C:B9:54:50:24,3830628,488687894,4735,6151919,3825893,482535975,0,8381,1651670,8359,1648175,22,3495,2324,14,5118,36,0,53,229410.0,130000.0,-49.0,-35.0,-42.0,-44.0,-44.0,-35.0,-43.0,-48.0,-90.0,-91.0,-88.0,-91.0,41.0,56.0,46.0,47.0,0
6317,92:69:1D:31:68:E9,3829649,486116766,3754,3580589,3825895,482536177,0,4197,1043153,4079,1016658,118,26495,2005,7,3891,80,0,36,216660.0,130000.0,-52.0,-50.0,-44.0,-46.0,-51.0,-49.0,-43.0,-47.0,-89.0,-91.0,-88.0,-91.0,37.0,41.0,44.0,45.0,0
6318,CC:2F:71:3F:1F:24,4469267,1185497711,643372,702961534,3825895,482536177,37,526419,564748554,525782,564671912,637,76642,508737,10,643609,63796,34,451,130000.0,43333.0,-67.0,-65.0,-70.0,-68.0,-67.0,-65.0,-70.0,-67.0,-89.0,-91.0,-88.0,-91.0,22.0,26.0,18.0,23.0,0
6319,CC:2F:71:3E:C5:1F,3826668,482630675,773,94498,3825895,482536177,0,3238,271840,2673,204726,565,67114,817,8,1114,18,0,37,130000.0,39000.0,-70.0,-70.0,-68.0,-60.0,-69.0,-70.0,-67.0,-60.0,-89.0,-91.0,-88.0,-91.0,19.0,21.0,20.0,31.0,0
6320,BA:8C:B9:54:50:24,3830630,488688096,4735,6151919,3825895,482536177,0,8381,1651670,8359,1648175,22,3495,2324,14,5118,36,0,53,229410.0,130000.0,-49.0,-35.0,-42.0,-44.0,-44.0,-35.0,-43.0,-48.0,-89.0,-91.0,-88.0,-91.0,40.0,56.0,46.0,47.0,0
6321,92:69:1D:31:68:E9,3829653,486117170,3754,3580589,3825899,482536581,0,4197,1043153,4079,1016658,118,26495,2005,7,3891,80,0,36,216660.0,130000.0,-52.0,-50.0,-44.0,-46.0,-51.0,-49.0,-43.0,-47.0,-89.0,-91.0,-88.0,-91.0,37.0,41.0,44.0,45.0,0
6322,CC:2F:71:3F:1F:24,4469314,1185512667,643415,702976086,3825899,482536581,37,526444,564753358,525807,564676716,637,76642,508762,10,643652,63817,34,451,117000.0,39000.0,-67.0,-65.0,-70.0,-67.0,-67.0,-65.0,-70.0,-67.0,-89.0,-91.0,-88.0,-91.0,22.0,26.0,18.0,24.0,0
6323,CC:2F:71:3E:C5:1F,3826675,482631343,773,94498,3825902,482536845,0,3239,271958,2673,204726,566,67232,818,8,1114,18,0,37,130000.0,39000.0,-70.0,-71.0,-67.0,-60.0,-69.0,-70.0,-67.0,-60.0,-89.0,-91.0,-88.0,-91.0,19.0,20.0,21.0,31.0,0
6324,BA:8C:B9:54:50:24,3830637,488688764,4735,6151919,3825902,482536845,0,8381,1651670,8359,1648175,22,3495,2324,14,5118,36,0,53,229410.0,130000.0,-49.0,-35.0,-42.0,-44.0,-44.0,-35.0,-43.0,-48.0,-89.0,-91.0,-88.0,-91.0,40.0,56.0,46.0,47.0,0
6325,92:69:1D:31:68:E9,3829661,486118064,3754,3580589,3825907,482537475,0,4197,1043153,4079,1016658,118,26495,2005,7,3891,80,0,36,216660.0,130000.0,-52.0,-50.0,-44.0,-46.0,-51.0,-49.0,-43.0,-47.0,-89.0,-91.0,-88.0,-91.0,37.0,41.0,44.0,45.0,0
6326,CC:2F:71:3F:1F:24,4469365,1185528113,643458,702990638,3825907,482537475,37,526472,564758534,525835,564681892,637,76642,508790,10,643695,63825,34,451,130000.0,43333.0,-67.0,-65.0,-70.0,-67.0,-67.0,-65.0,-70.0,-67.0,-89.0,-91.0,-88.0,-91.0,22.0,26.0,18.0,24.0,0
6327,CC:2F:71:3E:C5:1F,3826680,482631973,773,94498,3825907,482537475,0,3240,272028,2674,204796,566,67232,818,8,1114,18,0,37,130000.0,39000.0,-70.0,-71.0,-67.0,-60.0,-69.0,-70.0,-67.0,-60.0,-89.0,-91.0,-88.0,-91.0,19.0,20.0,21.0,31.0,0
6328,BA:8C:B9:54:50:24,3830642,488689394,4735,6151919,3825907,482537475,0,8381,1651670,8359,1648175,22,3495,2324,14,5118,36,0,53,229410.0,130000.0,-49.0,-35.0,-42.0,-44.0,-44.0,-35.0,-43.0,-48.0,-89.0,-91.0,-88.0,-91.0,40.0,56.0,46.0,47.0,0
6329,92:69:1D:31:68:E9,3829665,486118468,3754,3580589,3825911,482537879,0,4197,1043153,4079,1016658,118,26495,2005,7,3891,80,0,36,216660.0,130000.0,-52.0,-50.0,-44.0,-46.0,-51.0,-49.0,-43.0,-47.0,-89.0,-91.0,-88.0,-91.0,37.0,41.0,44.0,45.0,0
6330,CC:2F:71:3F:1F:24,4469411,1185542833,643500,703004954,3825911,482537879,37,526497,564763338,525860,564686696,637,76642,508815,10,643737,63858,34,451,144444.0,39000.0,-67.0,-65.0,-70.0,-68.0,-67.0,-65.0,-70.0,-67.0,-89.0,-91.0,-88.0,-91.0,22.0,26.0,18.0,23.0,0
6331,CC:2F:71:3E:C5:1F,3826686,482632579,773,94498,3825913,482538081,0,3240,272028,2674,204796,566,67232,818,8,1114,18,0,37,130000.0,39000.0,-70.0,-71.0,-67.0,-60.0,-69.0,-70.0,-67.0,-60.0,-89.0,-91.0,-88.0,-91.0,19.0,20.0,21.0,31.0,0
6332,BA:8C:B9:54:50:24,3830648,488690000,4735,6151919,3825913,482538081,0,8381,1651670,8359,1648175,22,3495,2324,14,5118,36,0,53,229410.0,130000.0,-49.0,-35.0,-42.0,-44.0,-44.0,-35.0,-43.0,-48.0,-89.0,-91.0,-88.0,-91.0,40.0,56.0,46.0,47.0,0
6333,92:69:1D:31:68:E9,3829669,486118872,3754,3580589,3825915,482538283,0,4199,1043289,4081,1016794,118,26495,2005,7,3892,80,0,36,216660.0,130000.0,-52.0,-50.0,-44.0,-46.0,-51.0,-49.0,-43.0,-46.0,-89.0,-91.0,-88.0,-91.0,37.0,41.0,44.0,45.0,0
6334,CC:2F:71:3F:1F:24,4469456,1185557485,643541,703019202,3825915,482538283,37,526522,564768142,525885,564691500,637,76642,508840,10,643778,63886,34,451,117000.0,39000.0,-67.0,-65.0,-70.0,-67.0,-67.0,-65.0,-70.0,-67.0,-89.0,-91.0,-88.0,-91.0,22.0,26.0,18.0,24.0,0
6335,CC:2F:71:3E:C5:1F,3826688,482632781,773,94498,3825915,482538283,0,3240,272028,2674,204796,566,67232,818,8,1114,18,0,37,130000.0,39000.0,-70.0,-71.0,-67.0,-60.0,-69.0,-70.0,-67.0,-60.0,-89.0,-91.0,-88.0,-91.0,19.0,20.0,21.0,31.0,0
6336,BA:8C:B9:54:50:24,3830650,488690202,4735,6151919,3825915,482538283,0,8383,1651806,8361,1648311,22,3495,2324,14,5119,36,0,53,229410.0,130000.0,-40.0,-37.0,-45.0,-52.0,-42.0,-36.0,-44.0,-50.0,-89.0,-91.0,-88.0,-91.0,49.0,54.0,43.0,39.0,0
6337,92:69:1D:31:68:E9,3829674,486119336,3754,3580589,3825920,482538747,0,4199,1043289,4081,1016794,118,26495,2005,7,3892,80,0,36,216660.0,130000.0,-52.0,-50.0,-44.0,-46.0,-51.0,-49.0,-43.0,-46.0,-89.0,-91.0,-88.0,-91.0,37.0,41.0,44.0,45.0,0
6338,CC:2F:71:3F:1F:24,4469504,1185572451,643584,703033704,3825920,482538747,37,526548,564773086,525911,564696444,637,76642,508866,10,643821,63888,34,451,117000.0,39000.0,-67.0,-65.0,-70.0,-67.0,-67.0,-65.0,-70.0,-67.0,-89.0,-91.0,-88.0,-91.0,22.0,26.0,18.0,24.0,0
6339,CC:2F:71:3E:C5:1F,3826695,482633447,773,94498,3825922,482538949,0,3240,272028,2674,204796,566,67232,818,8,1114,18,0,37,130000.0,39000.0,-70.0,-71.0,-67.0,-60.0,-69.0,-70.0,-67.0,-60.0,-89.0,-91.0,-88.0,-91.0,19.0,20.0,21.0,31.0,0
6340,BA:8C:B9:54:50:24,3830657,488690868,4735,6151919,3825922,482538949,0,8383,1651806,8361,1648311,22,3495,2324,14,5119,36,0,53,229410.0,130000.0,-40.0,-37.0,-45.0,-52.0,-42.0,-36.0,-44.0,-50.0,-89.0,-91.0,-88.0,-91.0,49.0,54.0,43.0,39.0,0
6341,92:69:1D:31:68:E9,3829678,486119740,3754,3580589,3825924,482539151,0,4199,1043289,4081,1016794,118,26495,2005,7,3892,80,0,36,216660.0,130000.0,-52.0,-50.0,-44.0,-46.0,-51.0,-49.0,-43.0,-46.0,-89.0,-91.0,-88.0,-91.0,37.0,41.0,44.0,45.0,0
6342,CC:2F:71:3F:1F:24,4469550,1185587227,643626,703048076,3825924,482539151,37,526576,564778238,525939,564701596,637,76642,508894,10,643863,63906,34,451,130000.0,39000.0,-67.0,-65.0,-70.0,-67.0,-67.0,-65.0,-70.0,-67.0,-89.0,-91.0,-88.0,-91.0,22.0,26.0,18.0,24.0,0
6343,CC:2F:71:3E:C5:1F,3826697,482633649,773,94498,3825924,482539151,0,3240,272028,2674,204796,566,67232,818,8,1114,18,0,37,130000.0,39000.0,-70.0,-71.0,-67.0,-60.0,-69.0,-70.0,-67.0,-60.0,-89.0,-91.0,-88.0,-91.0,19.0,20.0,21.0,31.0,0
6344,BA:8C:B9:54:50:24,3830659,488691070,4735,6151919,3825924,482539151,0,8383,1651806,8361,1648311,22,3495,2324,14,5119,36,0,53,229410.0,130000.0,-40.0,-37.0,-45.0,-52.0,-42.0,-36.0,-44.0,-50.0,-89.0,-91.0,-88.0,-91.0,49.0,54.0,43.0,39.0,0
6345,92:69:1D:31:68:E9,3829683,486120206,3754,3580589,3825929,482539617,0,4199,1043289,4081,1016794,118,26495,2005,7,3892,80,0,36,216660.0,130000.0,-52.0,-50.0,-44.0,-46.0,-51.0,-49.0,-43.0,-46.0,-89.0,-91.0,-88.0,-91.0,37.0,41.0,44.0,45.0,0
6346,CC:2F:71:3F:1F:24,4469598,1185602181,643668,703062504,3825930,482539677,37,526603,564783300,525965,564706540,638,76760,508921,10,643905,63919,34,451,130000.0,39000.0,-67.0,-65.0,-70.0,-67.0,-67.0,-65.0,-70.0,-67.0,-89.0,-91.0,-88.0,-91.0,22.0,26.0,18.0,24.0,0
6347,CC:2F:71:3E:C5:1F,3826705,482634377,773,94498,3825932,482539879,0,3240,272028,2674,204796,566,67232,818,8,1114,18,0,37,130000.0,39000.0,-70.0,-71.0,-67.0,-60.0,-69.0,-70.0,-67.0,-60.0,-89.0,-91.0,-88.0,-91.0,19.0,20.0,21.0,31.0,0
6348,BA:8C:B9:54:50:24,3830667,488691798,4735,6151919,3825932,482539879,0,8383,1651806,8361,1648311,22,3495,2324,14,5119,36,0,53,229410.0,130000.0,-40.0,-37.0,-45.0,-52.0,-42.0,-36.0,-44.0,-50.0,-89.0,-91.0,-88.0,-91.0,49.0,54.0,43.0,39.0,0
6349,92:69:1D:31:68:E9,3829688,486120670,3754,3580589,3825934,482540081,0,4199,1043289,4081,1016794,118,26495,2005,7,3892,80,0,36,216660.0,130000.0,-52.0,-50.0,-44.0,-46.0,-51.0,-49.0,-43.0,-46.0,-89.0,-91.0,-88.0,-91.0,37.0,41.0,44.0,45.0,0
6350,CC:2F:71:3F:1F:24,4469644,1185616901,643710,703076820,3825934,482540081,37,526628,564788104,525990,564711344,638,76760,508946,10,643947,63927,34,451,130000.0,39000.0,-67.0,-65.0,-70.0,-67.0,-67.0,-65.0,-70.0,-67.0,-89.0,-91.0,-88.0,-91.0,22.0,26.0,18.0,24.0,0
6351,CC:2F:71:3E:C5:1F,3826707,482634579,773,94498,3825934,482540081,0,3240,272028,2674,204796,566,67232,818,8,1114,18,0,37,130000.0,39000.0,-70.0,-71.0,-67.0,-60.0,-69.0,-70.0,-67.0,-60.0,-89.0,-91.0,-88.0,-91.0,19.0,20.0,21.0,31.0,0
6352,BA:8C:B9:54:50:24,3830669,488692000,4735,6151919,3825934,482540081,0,8383,1651806,8361,1648311,22,3495,2324,14,5119,36,0,53,229410.0,130000.0,-40.0,-37.0,-45.0,-52.0,-42.0,-36.0,-44.0,-50.0,-89.0,-91.0,-88.0,-91.0,49.0,54.0,43.0,39.0,0
6353,92:69:1D:31:68:E9,3829692,486121074,3754,3580589,3825938,482540485,0,4199,1043289,4081,1016794,118,26495,2005,7,3892,80,0,36,216660.0,130000.0,-52.0,-50.0,-44.0,-46.0,-51.0,-49.0,-43.0,-46.0,-89.0,-90.0,-88.0,-91.0,37.0,40.0,44.0,45.0,0
6354,CC:2F:71:3F:1F:24,4469692,1185631925,643754,703091440,3825938,482540485,37,526654,564793024,526016,564716264,638,76760,508972,10,643991,63940,34,451,117000.0,39000.0,-67.0,-65.0,-70.0,-68.0,-67.0,-65.0,-70.0,-67.0,-89.0,-90.0,-88.0,-91.0,22.0,25.0,18.0,23.0,0
6355,CC:2F:71:3E:C5:1F,3826711,482634983,773,94498,3825938,482540485,0,3240,272028,2674,204796,566,67232,818,8,1114,18,0,37,130000.0,39000.0,-70.0,-71.0,-67.0,-60.0,-69.0,-70.0,-67.0,-60.0,-89.0,-90.0,-88.0,-91.0,19.0,19.0,21.0,31.0,0
6356,BA:8C:B9:54:50:24,3830675,488692606,4735,6151919,3825940,482540687,0,8383,1651806,8361,1648311,22,3495,2324,14,5119,36,0,53,229410.0,130000.0,-40.0,-37.0,-45.0,-52.0,-42.0,-36.0,-44.0,-50.0,-89.0,-90.0,-88.0,-91.0,49.0,53.0,43.0,39.0,0
6357,92:69:1D:31:68:E9,3829697,486121538,3754,3580589,3825943,482540949,0,4199,1043289,4081,1016794,118,26495,2005,7,3892,80,0,36,216660.0,130000.0,-52.0,-50.0,-44.0,-46.0,-51.0,-49.0,-43.0,-46.0,-89.0,-90.0,-88.0,-91.0,37.0,40.0,44.0,45.0,0
6358,CC:2F:71:3F:1F:24,4469740,1185646885,643797,703105936,3825943,482540949,37,526681,564798108,526043,564721348,638,76760,508999,10,644034,63944,34,451,130000.0,39000.0,-67.0,-65.0,-70.0,-68.0,-67.0,-65.0,-70.0,-67.0,-89.0,-90.0,-88.0,-91.0,22.0,25.0,18.0,23.0,0
6359,CC:2F:71:3E:C5:1F,3826716,482635447,773,94498,3825943,482540949,0,3240,272028,2674,204796,566,67232,818,8,1114,18,0,37,130000.0,39000.0,-70.0,-71.0,-67.0,-60.0,-69.0,-70.0,-67.0,-60.0,-89.0,-90.0,-88.0,-91.0,19.0,19.0,21.0,31.0,0
6360,BA:8C:B9:54:50:24,3830678,488692868,4735,6151919,3825943,482540949,0,8383,1651806,8361,1648311,22,3495,2324,14,5119,36,0,53,229410.0,130000.0,-40.0,-37.0,-45.0,-52.0,-42.0,-36.0,-44.0,-50.0,-89.0,-90.0,-88.0,-91.0,49.0,53.0,43.0,39.0,0
6361,92:69:1D:31:68:E9,3829701,486121942,3754,3580589,3825947,482541353,0,4199,1043289,4081,1016794,118,26495,2005,7,3892,80,0,36,216660.0,130000.0,-52.0,-50.0,-44.0,-46.0,-51.0,-49.0,-43.0,-46.0,-89.0,-90.0,-88.0,-91.0,37.0,40.0,44.0,45.0,0
6362,CC:2F:71:3F:1F:24,4469785,1185661537,643838,703120184,3825947,482541353,37,526707,564803052,526069,564726292,638,76760,509025,10,644075,63975,34,451,130000.0,43333.0,-67.0,-65.0,-70.0,-68.0,-67.0,-65.0,-70.0,-67.0,-89.0,-90.0,-88.0,-91.0,22.0,25.0,18.0,23.0,0
6363,CC:2F:71:3E:C5:1F,3826720,482635851,773,94498,3825947,482541353,0,3240,272028,2674,204796,566,67232,818,8,1114,18,0,37,130000.0,39000.0,-70.0,-71.0,-67.0,-60.0,-69.0,-70.0,-67.0,-60.0,-89.0,-90.0,-88.0,-91.0,19.0,19.0,21.0,31.0,0
6364,BA:8C:B9:54:50:24,3830684,488693474,4735,6151919,3825949,482541555,0,8383,1651806,8361,1648311,22,3495,2324,14,5119,36,0,53,229410.0,130000.0,-40.0,-37.0,-45.0,-52.0,-42.0,-36.0,-44.0,-50.0,-89.0,-90.0,-88.0,-91.0,49.0,53.0,43.0,39.0,0
6365,92:69:1D:31:68:E9,3829706,486122619,3754,3580589,3825952,482542030,0,4199,1043289,4081,1016794,118,26495,2005,7,3892,80,0,36,216660.0,130000.0,-52.0,-50.0,-44.0,-46.0,-51.0,-49.0,-43.0,-46.0,-89.0,-90.0,-88.0,-91.0,37.0,40.0,44.0,45.0,0
6366,CC:2F:71:3F:1F:24,4469833,1185676878,643881,703134848,3825952,482542030,37,526733,564807996,526095,564731236,638,76760,509051,10,644118,63980,34,451,130000.0,43333.0,-67.0,-65.0,-70.0,-67.0,-67.0,-65.0,-70.0,-67.0,-89.0,-90.0,-88.0,-91.0,22.0,25.0,18.0,24.0,0
6367,CC:2F:71:3E:C5:1F,3826725,482636528,773,94498,3825952,482542030,0,3240,272028,2674,204796,566,67232,818,8,1114,18,0,37,130000.0,39000.0,-70.0,-71.0,-67.0,-60.0,-69.0,-70.0,-67.0,-60.0,-89.0,-90.0,-88.0,-91.0,19.0,19.0,21.0,31.0,0
6368,BA:8C:B9:54:50:24,3830688,488694009,4735,6151919,3825953,482542090,0,8383,1651806,8361,1648311,22,3495,2324,14,5119,36,0,53,229410.0,130000.0,-40.0,-37.0,-45.0,-52.0,-42.0,-36.0,-44.0,-50.0,-89.0,-90.0,-88.0,-91.0,49.0,53.0,43.0,39.0,0
6369,92:69:1D:31:68:E9,3829711,486123083,3754,3580589,3825957,482542494,0,4199,1043289,4081,1016794,118,26495,2005,7,3892,80,0,36,216660.0,130000.0,-52.0,-50.0,-44.0,-46.0,-51.0,-49.0,-43.0,-46.0,-90.0,-91.0,-88.0,-91.0,38.0,41.0,44.0,45.0,0
6370,CC:2F:71:3F:1F:24,4469879,1185691646,643922,703149152,3825957,482542494,37,526758,564812800,526120,564736040,638,76760,509076,10,644159,63996,34,451,117000.0,39000.0,-67.0,-65.0,-70.0,-67.0,-67.0,-65.0,-70.0,-67.0,-90.0,-91.0,-88.0,-91.0,23.0,26.0,18.0,24.0,0
6371,CC:2F:71:3E:C5:1F,3826730,482636992,773,94498,3825957,482542494,0,3240,272028,2674,204796,566,67232,818,8,1114,18,0,37,130000.0,39000.0,-70.0,-71.0,-67.0,-60.0,-69.0,-70.0,-67.0,-60.0,-90.0,-91.0,-88.0,-91.0,20.0,20.0,21.0,31.0,0
6372,BA:8C:B9:54:50:24,3830692,488694413,4735,6151919,3825957,482542494,0,8384,1651874,8362,1648379,22,3495,2324,14,5119,36,0,53,229410.0,130000.0,-40.0,-36.0,-45.0,-52.0,-41.0,-36.0,-44.0,-51.0,-90.0,-91.0,-88.0,-91.0,50.0,55.0,43.0,39.0,0
6373,92:69:1D:31:68:E9,3829715,486123487,3754,3580589,3825961,482542898,0,4199,1043289,4081,1016794,118,26495,2005,7,3892,80,0,36,216660.0,130000.0,-52.0,-50.0,-44.0,-46.0,-51.0,-49.0,-43.0,-46.0,-90.0,-91.0,-88.0,-91.0,38.0,41.0,44.0,45.0,0
6374,CC:2F:71:3F:1F:24,4469925,1185706478,643964,703163580,3825961,482542898,37,526783,564817604,526145,564740844,638,76760,509101,10,644201,63999,34,451,130000.0,43333.0,-67.0,-65.0,-70.0,-68.0,-67.0,-65.0,-70.0,-67.0,-90.0,-91.0,-88.0,-91.0,23.0,26.0,18.0,23.0,0
6375,CC:2F:71:3E:C5:1F,3826734,482637396,773,94498,3825961,482542898,0,3240,272028,2674,204796,566,67232,818,8,1114,18,0,37,130000.0,39000.0,-70.0,-71.0,-67.0,-60.0,-69.0,-70.0,-67.0,-60.0,-90.0,-91.0,-88.0,-91.0,20.0,20.0,21.0,31.0,0
6376,BA:8C:B9:54:50:24,3830696,488694817,4735,6151919,3825961,482542898,0,8384,1651874,8362,1648379,22,3495,2324,14,5119,36,0,53,229410.0,130000.0,-40.0,-36.0,-45.0,-52.0,-41.0,-36.0,-44.0,-51.0,-90.0,-91.0,-88.0,-91.0,50.0,55.0,43.0,39.0,0
6377,92:69:1D:31:68:E9,3829720,486123951,3754,3580589,3825966,482543362,0,4199,1043289,4081,1016794,118,26495,2005,7,3892,80,0,36,216660.0,130000.0,-52.0,-50.0,-44.0,-46.0,-51.0,-49.0,-43.0,-46.0,-90.0,-91.0,-88.0,-91.0,38.0,41.0,44.0,45.0,0
6378,CC:2F:71:3F:1F:24,4469972,1185721482,644006,703178120,3825966,482543362,37,526809,564822548,526171,564745788,638,76760,509127,10,644243,64002,34,451,130000.0,43333.0,-67.0,-65.0,-71.0,-68.0,-67.0,-65.0,-70.0,-67.0,-90.0,-91.0,-88.0,-91.0,23.0,26.0,17.0,23.0,0
6379,CC:2F:71:3E:C5:1F,3826739,482637860,773,94498,3825966,482543362,0,3240,272028,2674,204796,566,67232,818,8,1114,18,0,37,130000.0,39000.0,-70.0,-71.0,-67.0,-60.0,-69.0,-70.0,-67.0,-60.0,-90.0,-91.0,-89.0,-91.0,20.0,20.0,22.0,31.0,0
6380,BA:8C:B9:54:50:24,3830701,488695281,4735,6151919,3825966,482543362,0,8384,1651874,8362,1648379,22,3495,2324,14,5119,36,0,53,229410.0,130000.0,-40.0,-36.0,-45.0,-52.0,-41.0,-36.0,-44.0,-51.0,-90.0,-91.0,-89.0,-91.0,50.0,55.0,44.0,39.0,0
6381,92:69:1D:31:68:E9,3829724,486124355,3754,3580589,3825970,482543766,0,4199,1043289,4081,1016794,118,26495,2005,7,3892,80,0,36,216660.0,130000.0,-52.0,-50.0,-44.0,-46.0,-51.0,-49.0,-43.0,-46.0,-90.0,-91.0,-89.0,-91.0,38.0,41.0,45.0,45.0,0
6382,CC:2F:71:3F:1F:24,4470017,1185736190,644047,703192424,3825970,482543766,37,526834,564827352,526196,564750592,638,76760,509152,10,644284,64023,34,451,117000.0,39000.0,-67.0,-65.0,-71.0,-67.0,-67.0,-65.0,-70.0,-67.0,-90.0,-91.0,-89.0,-91.0,23.0,26.0,18.0,24.0,0
6383,CC:2F:71:3E:C5:1F,3826743,482638264,773,94498,3825970,482543766,0,3240,272028,2674,204796,566,67232,818,8,1114,18,0,37,130000.0,39000.0,-70.0,-71.0,-67.0,-60.0,-69.0,-70.0,-67.0,-60.0,-90.0,-91.0,-89.0,-91.0,20.0,20.0,22.0,31.0,0
6384,BA:8C:B9:54:50:24,3830705,488695685,4735,6151919,3825970,482543766,0,8384,1651874,8362,1648379,22,3495,2324,14,5119,36,0,53,229410.0,130000.0,-40.0,-36.0,-45.0,-52.0,-41.0,-36.0,-44.0,-51.0,-90.0,-91.0,-89.0,-91.0,50.0,55.0,44.0,39.0,0
6385,92:69:1D:31:68:E9,3829728,486124759,3754,3580589,3825974,482544170,0,4199,1043289,4081,1016794,118,26495,2005,7,3892,80,0,36,216660.0,130000.0,-52.0,-50.0,-44.0,-46.0,-51.0,-49.0,-43.0,-46.0,-90.0,-91.0,-89.0,-91.0,38.0,41.0,45.0,45.0,0
6386,CC:2F:71:3F:1F:24,4470065,1185751276,644091,703207106,3825974,482544170,37,526859,564832156,526221,564755396,638,76760,509177,10,644328,64029,34,451,130000.0,43333.0,-67.0,-65.0,-70.0,-67.0,-67.0,-65.0,-70.0,-67.0,-90.0,-91.0,-89.0,-91.0,23.0,26.0,19.0,24.0,0
6387,CC:2F:71:3E:C5:1F,3826747,482638668,773,94498,3825974,482544170,0,3240,272028,2674,204796,566,67232,818,8,1114,18,0,37,130000.0,39000.0,-70.0,-71.0,-67.0,-60.0,-69.0,-70.0,-67.0,-60.0,-90.0,-91.0,-89.0,-91.0,20.0,20.0,22.0,31.0,0
6388,BA:8C:B9:54:50:24,3830709,488696089,4735,6151919,3825974,482544170,0,8384,1651874,8362,1648379,22,3495,2324,14,5119,36,0,53,229410.0,130000.0,-40.0,-36.0,-45.0,-52.0,-41.0,-36.0,-44.0,-51.0,-90.0,-91.0,-89.0,-91.0,50.0,55.0,44.0,39.0,0
6389,92:69:1D:31:68:E9,3829733,486125223,3754,3580589,3825979,482544634,0,4199,1043289,4081,1016794,118,26495,2005,7,3892,80,0,36,216660.0,130000.0,-52.0,-50.0,-44.0,-46.0,-51.0,-49.0,-43.0,-46.0,-90.0,-91.0,-89.0,-91.0,38.0,41.0,45.0,45.0,0
6390,CC:2F:71:3F:1F:24,4470111,1185766044,644132,703221410,3825979,482544634,37,526884,564836960,526246,564760200,638,76760,509202,10,644369,64065,34,451,144444.0,39000.0,-67.0,-65.0,-70.0,-68.0,-67.0,-65.0,-70.0,-67.0,-90.0,-91.0,-89.0,-91.0,23.0,26.0,19.0,23.0,0
6391,CC:2F:71:3E:C5:1F,3826752,482639132,773,94498,3825979,482544634,0,3240,272028,2674,204796,566,67232,818,8,1114,18,0,37,130000.0,39000.0,-70.0,-71.0,-67.0,-60.0,-69.0,-70.0,-67.0,-60.0,-90.0,-91.0,-89.0,-91.0,20.0,20.0,22.0,31.0,0
6392,BA:8C:B9:54:50:24,3830714,488696553,4735,6151919,3825979,482544634,0,8384,1651874,8362,1648379,22,3495,2324,14,5119,36,0,53,229410.0,130000.0,-40.0,-36.0,-45.0,-52.0,-41.0,-36.0,-44.0,-51.0,-90.0,-91.0,-89.0,-91.0,50.0,55.0,44.0,39.0,0
6393,92:69:1D:31:68:E9,3829737,486125627,3754,3580589,3825983,482545038,0,4199,1043289,4081,1016794,118,26495,2005,7,3892,80,0,36,216660.0,130000.0,-52.0,-50.0,-44.0,-46.0,-51.0,-49.0,-43.0,-46.0,-90.0,-91.0,-89.0,-91.0,38.0,41.0,45.0,45.0,0
6394,CC:2F:71:3F:1F:24,4470158,1185781000,644175,703235962,3825983,482545038,37,526909,564841764,526271,564765004,638,76760,509227,10,644412,64078,34,451,130000.0,43333.0,-67.0,-65.0,-70.0,-67.0,-67.0,-65.0,-70.0,-67.0,-90.0,-91.0,-89.0,-91.0,23.0,26.0,19.0,24.0,0
6395,CC:2F:71:3E:C5:1F,3826756,482639536,773,94498,3825983,482545038,0,3240,272028,2674,204796,566,67232,818,8,1114,18,0,37,130000.0,39000.0,-70.0,-71.0,-67.0,-60.0,-69.0,-70.0,-67.0,-60.0,-90.0,-91.0,-89.0,-91.0,20.0,20.0,22.0,31.0,0
6396,BA:8C:B9:54:50:24,3830718,488696957,4735,6151919,3825983,482545038,0,8384,1651874,8362,1648379,22,3495,2324,14,5119,36,0,53,229410.0,130000.0,-40.0,-36.0,-45.0,-52.0,-41.0,-36.0,-44.0,-51.0,-90.0,-91.0,-89.0,-91.0,50.0,55.0,44.0,39.0,0
6397,92:69:1D:31:68:E9,3829741,486126031,3754,3580589,3825987,482545442,0,4199,1043289,4081,1016794,118,26495,2005,7,3892,80,0,36,216660.0,130000.0,-52.0,-50.0,-44.0,-46.0,-51.0,-49.0,-43.0,-46.0,-90.0,-91.0,-89.0,-91.0,38.0,41.0,45.0,45.0,0
6398,CC:2F:71:3F:1F:24,4470205,1185796068,644218,703250626,3825987,482545442,37,526935,564846708,526297,564769948,638,76760,509253,10,644455,64084,34,451,130000.0,43333.0,-67.0,-65.0,-70.0,-67.0,-67.0,-65.0,-70.0,-67.0,-90.0,-91.0,-89.0,-91.0,23.0,26.0,19.0,24.0,0
6399,CC:2F:71:3E:C5:1F,3826761,482640000,773,94498,3825988,482545502,0,3240,272028,2674,204796,566,67232,818,8,1114,18,0,37,130000.0,39000.0,-70.0,-71.0,-67.0,-60.0,-69.0,-70.0,-67.0,-60.0,-90.0,-91.0,-89.0,-91.0,20.0,20.0,22.0,31.0,0
6400,BA:8C:B9:54:50:24,3830723,488697421,4735,6151919,3825988,482545502,0,8384,1651874,8362,1648379,22,3495,2324,14,5119,36,0,53,229410.0,130000.0,-40.0,-36.0,-45.0,-52.0,-41.0,-36.0,-44.0,-51.0,-90.0,-91.0,-89.0,-91.0,50.0,55.0,44.0,39.0,0
6401,92:69:1D:31:68:E9,3829746,486126495,3754,3580589,3825992,482545906,0,4199,1043289,4081,1016794,118,26495,2005,7,3892,80,0,36,216660.0,130000.0,-52.0,-50.0,-44.0,-46.0,-51.0,-49.0,-43.0,-46.0,-90.0,-91.0,-89.0,-91.0,38.0,41.0,45.0,45.0,0
6402,CC:2F:71:3F:1F:24,4470251,1185810886,644259,703264980,3825992,482545906,37,526960,564851512,526322,564774752,638,76760,509278,10,644496,64099,34,451,130000.0,39000.0,-67.0,-65.0,-70.0,-67.0,-67.0,-65.0,-70.0,-67.0,-90.0,-91.0,-89.0,-91.0,23.0,26.0,19.0,24.0,0
6403,CC:2F:71:3E:C5:1F,3826765,482640404,773,94498,3825992,482545906,0,3240,272028,2674,204796,566,67232,818,8,1114,18,0,37,130000.0,39000.0,-70.0,-71.0,-67.0,-60.0,-69.0,-70.0,-67.0,-60.0,-90.0,-91.0,-89.0,-91.0,20.0,20.0,22.0,31.0,0
6404,BA:8C:B9:54:50:24,3830727,488697825,4735,6151919,3825992,482545906,0,8384,1651874,8362,1648379,22,3495,2324,14,5119,36,0,53,229410.0,130000.0,-40.0,-36.0,-45.0,-52.0,-41.0,-36.0,-44.0,-51.0,-90.0,-91.0,-89.0,-91.0,50.0,55.0,44.0,39.0,0
6405,92:69:1D:31:68:E9,3829750,486126899,3754,3580589,3825996,482546310,0,4199,1043289,4081,1016794,118,26495,2005,7,3892,80,0,36,216660.0,130000.0,-52.0,-50.0,-44.0,-46.0,-51.0,-49.0,-43.0,-46.0,-90.0,-91.0,-89.0,-91.0,38.0,41.0,45.0,45.0,0
6406,CC:2F:71:3F:1F:24,4470297,1185825718,644301,703279408,3825996,482546310,37,526985,564856316,526347,564779556,638,76760,509303,10,644538,64107,34,451,130000.0,43333.0,-67.0,-65.0,-70.0,-67.0,-67.0,-65.0,-70.0,-67.0,-90.0,-91.0,-89.0,-91.0,23.0,26.0,19.0,24.0,0
6407,CC:2F:71:3E:C5:1F,3826769,482640808,773,94498,3825996,482546310,0,3240,272028,2674,204796,566,67232,818,8,1114,18,0,37,130000.0,39000.0,-70.0,-71.0,-67.0,-60.0,-69.0,-70.0,-67.0,-60.0,-90.0,-91.0,-89.0,-91.0,20.0,20.0,22.0,31.0,0
6408,BA:8C:B9:54:50:24,3830731,488698229,4735,6151919,3825996,482546310,0,8384,1651874,8362,1648379,22,3495,2324,14,5119,36,0,53,229410.0,130000.0,-40.0,-36.0,-45.0,-52.0,-41.0,-36.0,-44.0,-51.0,-90.0,-91.0,-89.0,-91.0,50.0,55.0,44.0,39.0,0
6409,92:69:1D:31:68:E9,3829755,486127363,3754,3580589,3826001,482546774,0,4199,1043289,4081,1016794,118,26495,2005,7,3892,80,0,36,216660.0,130000.0,-52.0,-50.0,-44.0,-46.0,-51.0,-49.0,-43.0,-46.0,-90.0,-91.0,-89.0,-91.0,38.0,41.0,45.0,45.0,0
6410,CC:2F:71:3F:1F:24,4470345,1185840740,644344,703293966,3826001,482546774,37,527014,564861632,526376,564784872,638,76760,509332,10,644581,64118,34,451,130000.0,39000.0,-67.0,-65.0,-70.0,-67.0,-67.0,-65.0,-70.0,-67.0,-90.0,-91.0,-89.0,-91.0,23.0,26.0,19.0,24.0,0
6411,CC:2F:71:3E:C5:1F,3826774,482641272,773,94498,3826001,482546774,0,3240,272028,2674,204796,566,67232,818,8,1114,18,0,37,130000.0,39000.0,-70.0,-71.0,-67.0,-60.0,-69.0,-70.0,-67.0,-60.0,-90.0,-91.0,-89.0,-91.0,20.0,20.0,22.0,31.0,0
6412,BA:8C:B9:54:50:24,3830736,488698693,4735,6151919,3826001,482546774,0,8384,1651874,8362,1648379,22,3495,2324,14,5119,36,0,53,229410.0,130000.0,-40.0,-36.0,-45.0,-52.0,-41.0,-36.0,-44.0,-51.0,-90.0,-91.0,-89.0,-91.0,50.0,55.0,44.0,39.0,0
6413,92:69:1D:31:68:E9,3829760,486127883,3755,3580705,3826005,482547178,0,4201,1043425,4083,1016930,118,26495,2005,7,3893,80,0,36,216660.0,130000.0,-52.0,-50.0,-45.0,-46.0,-51.0,-50.0,-44.0,-46.0,-90.0,-91.0,-89.0,-91.0,38.0,41.0,44.0,45.0,0
6414,CC:2F:71:3F:1F:24,4470392,1185855688,644387,703308510,3826005,482547178,37,527039,564866436,526401,564789676,638,76760,509357,10,644624,64123,34,451,130000.0,43333.0,-67.0,-65.0,-70.0,-68.0,-67.0,-65.0,-70.0,-67.0,-90.0,-91.0,-89.0,-91.0,23.0,26.0,19.0,23.0,0
6415,CC:2F:71:3E:C5:1F,3826779,482641792,774,94614,3826005,482547178,0,3242,272168,2676,204936,566,67232,818,8,1115,18,0,37,130000.0,39000.0,-70.0,-71.0,-67.0,-60.0,-70.0,-70.0,-67.0,-60.0,-90.0,-91.0,-89.0,-91.0,20.0,20.0,22.0,31.0,0
6416,BA:8C:B9:54:50:24,3830741,488699213,4736,6152035,3826005,482547178,0,8386,1652010,8364,1648515,22,3495,2324,14,5120,36,0,53,229410.0,130000.0,-40.0,-37.0,-45.0,-51.0,-42.0,-36.0,-44.0,-49.0,-90.0,-91.0,-89.0,-91.0,50.0,54.0,44.0,40.0,0
6417,92:69:1D:31:68:E9,3829763,486128358,3755,3580705,3826008,482547653,0,4201,1043425,4083,1016930,118,26495,2005,7,3893,80,0,36,216660.0,130000.0,-52.0,-50.0,-45.0,-46.0,-51.0,-50.0,-44.0,-46.0,-90.0,-91.0,-89.0,-91.0,38.0,41.0,44.0,45.0,0
6418,CC:2F:71:3F:1F:24,4470437,1185870647,644429,703322994,3826008,482547653,37,527065,564871356,526427,564794596,638,76760,509383,10,644666,64130,34,451,130000.0,43333.0,-67.0,-65.0,-70.0,-67.0,-67.0,-65.0,-70.0,-67.0,-90.0,-91.0,-89.0,-91.0,23.0,26.0,19.0,24.0,0
6419,CC:2F:71:3E:C5:1F,3826784,482642469,774,94614,3826010,482547855,0,3242,272168,2676,204936,566,67232,818,8,1115,18,0,37,130000.0,39000.0,-70.0,-71.0,-67.0,-60.0,-70.0,-70.0,-67.0,-60.0,-90.0,-91.0,-89.0,-91.0,20.0,20.0,22.0,31.0,0
6420,BA:8C:B9:54:50:24,3830746,488699890,4736,6152035,3826010,482547855,0,8386,1652010,8364,1648515,22,3495,2324,14,5120,36,0,53,229410.0,130000.0,-40.0,-37.0,-45.0,-51.0,-42.0,-36.0,-44.0,-49.0,-90.0,-91.0,-89.0,-91.0,50.0,54.0,44.0,40.0,0
6421,92:69:1D:31:68:E9,3829770,486129024,3755,3580705,3826015,482548319,0,4201,1043425,4083,1016930,118,26495,2005,7,3893,80,0,36,216660.0,130000.0,-52.0,-50.0,-45.0,-46.0,-51.0,-50.0,-44.0,-46.0,-90.0,-91.0,-89.0,-91.0,38.0,41.0,44.0,45.0,0
6422,CC:2F:71:3F:1F:24,4470486,1185885797,644471,703337478,3826015,482548319,37,527090,564876160,526452,564799400,638,76760,509408,10,644708,64150,34,451,130000.0,39000.0,-67.0,-65.0,-70.0,-68.0,-67.0,-65.0,-70.0,-67.0,-90.0,-91.0,-89.0,-91.0,23.0,26.0,19.0,23.0,0
6423,CC:2F:71:3E:C5:1F,3826789,482642933,774,94614,3826015,482548319,0,3242,272168,2676,204936,566,67232,818,8,1115,18,0,37,130000.0,39000.0,-70.0,-71.0,-67.0,-60.0,-70.0,-70.0,-67.0,-60.0,-90.0,-91.0,-89.0,-91.0,20.0,20.0,22.0,31.0,0
6424,BA:8C:B9:54:50:24,3830751,488700354,4736,6152035,3826015,482548319,0,8386,1652010,8364,1648515,22,3495,2324,14,5120,36,0,53,229410.0,130000.0,-40.0,-37.0,-45.0,-51.0,-42.0,-36.0,-44.0,-49.0,-90.0,-91.0,-89.0,-91.0,50.0,54.0,44.0,40.0,0
6425,92:69:1D:31:68:E9,3829772,486129226,3755,3580705,3826017,482548521,0,4201,1043425,4083,1016930,118,26495,2005,7,3893,80,0,36,216660.0,130000.0,-52.0,-50.0,-45.0,-46.0,-51.0,-50.0,-44.0,-46.0,-90.0,-91.0,-89.0,-91.0,38.0,41.0,44.0,45.0,0
6426,CC:2F:71:3F:1F:24,4470531,1185900449,644512,703351726,3826019,482548723,37,527115,564880964,526477,564804204,638,76760,509433,10,644749,64176,34,451,130000.0,43333.0,-67.0,-65.0,-70.0,-68.0,-67.0,-65.0,-70.0,-67.0,-90.0,-91.0,-89.0,-91.0,23.0,26.0,19.0,23.0,0
6427,CC:2F:71:3E:C5:1F,3826793,482643337,774,94614,3826019,482548723,0,3242,272168,2676,204936,566,67232,818,8,1115,18,0,37,130000.0,39000.0,-70.0,-71.0,-67.0,-60.0,-70.0,-70.0,-67.0,-60.0,-90.0,-91.0,-89.0,-91.0,20.0,20.0,22.0,31.0,0
6428,BA:8C:B9:54:50:24,3830755,488700758,4736,6152035,3826019,482548723,0,8386,1652010,8364,1648515,22,3495,2324,14,5120,36,0,53,229410.0,130000.0,-40.0,-37.0,-45.0,-51.0,-42.0,-36.0,-44.0,-49.0,-90.0,-91.0,-89.0,-91.0,50.0,54.0,44.0,40.0,0
6429,92:69:1D:31:68:E9,3829778,486129832,3755,3580705,3826023,482549127,0,4201,1043425,4083,1016930,118,26495,2005,7,3893,80,0,36,216660.0,130000.0,-52.0,-50.0,-45.0,-46.0,-51.0,-50.0,-44.0,-46.0,-90.0,-91.0,-89.0,-91.0,38.0,41.0,44.0,45.0,0
6430,CC:2F:71:3F:1F:24,4470578,1185915453,644554,703366266,3826024,482549187,37,527140,564885768,526502,564809008,638,76760,509458,10,644791,64183,34,451,130000.0,43333.0,-67.0,-65.0,-70.0,-67.0,-67.0,-65.0,-70.0,-67.0,-90.0,-91.0,-89.0,-91.0,23.0,26.0,19.0,24.0,0
6431,CC:2F:71:3E:C5:1F,3826798,482643801,774,94614,3826024,482549187,0,3242,272168,2676,204936,566,67232,818,8,1115,18,0,37,130000.0,39000.0,-70.0,-71.0,-67.0,-60.0,-70.0,-70.0,-67.0,-60.0,-90.0,-91.0,-89.0,-91.0,20.0,20.0,22.0,31.0,0
6432,BA:8C:B9:54:50:24,3830760,488701222,4736,6152035,3826024,482549187,0,8386,1652010,8364,1648515,22,3495,2324,14,5120,36,0,53,229410.0,130000.0,-40.0,-37.0,-45.0,-51.0,-42.0,-36.0,-44.0,-49.0,-90.0,-91.0,-89.0,-91.0,50.0,54.0,44.0,40.0,0
6433,92:69:1D:31:68:E9,3829782,486130156,3755,3580705,3826027,482549451,0,4201,1043425,4083,1016930,118,26495,2005,7,3893,80,0,36,216660.0,130000.0,-52.0,-50.0,-45.0,-46.0,-51.0,-50.0,-44.0,-46.0,-90.0,-91.0,-89.0,-91.0,38.0,41.0,44.0,45.0,0
6434,CC:2F:71:3F:1F:24,4470625,1185930353,644596,703380700,3826029,482549653,37,527166,564890712,526528,564813952,638,76760,509484,10,644833,64203,34,451,117000.0,39000.0,-67.0,-65.0,-71.0,-68.0,-67.0,-65.0,-70.0,-67.0,-90.0,-91.0,-89.0,-91.0,23.0,26.0,18.0,23.0,0
6435,CC:2F:71:3E:C5:1F,3826803,482644267,774,94614,3826029,482549653,0,3244,272356,2677,205006,567,67350,819,8,1115,18,0,37,130000.0,39000.0,-70.0,-71.0,-67.0,-60.0,-70.0,-70.0,-67.0,-60.0,-90.0,-91.0,-89.0,-91.0,20.0,20.0,22.0,31.0,0
6436,BA:8C:B9:54:50:24,3830765,488701688,4736,6152035,3826029,482549653,0,8386,1652010,8364,1648515,22,3495,2324,14,5120,36,0,53,229410.0,130000.0,-40.0,-37.0,-45.0,-51.0,-42.0,-36.0,-44.0,-49.0,-90.0,-91.0,-89.0,-91.0,50.0,54.0,44.0,40.0,0
6437,92:69:1D:31:68:E9,3829788,486130762,3755,3580705,3826033,482550057,0,4203,1043561,4085,1017066,118,26495,2005,7,3894,80,0,36,216660.0,130000.0,-52.0,-50.0,-44.0,-46.0,-51.0,-50.0,-44.0,-46.0,-90.0,-91.0,-89.0,-91.0,38.0,41.0,45.0,45.0,0
6438,CC:2F:71:3F:1F:24,4470669,1185944925,644636,703394868,3826033,482550057,37,527191,564895516,526553,564818756,638,76760,509509,10,644873,64206,34,451,130000.0,43333.0,-67.0,-65.0,-70.0,-67.0,-67.0,-65.0,-70.0,-67.0,-90.0,-91.0,-89.0,-91.0,23.0,26.0,19.0,24.0,0
6439,CC:2F:71:3E:C5:1F,3826807,482644671,774,94614,3826033,482550057,0,3244,272356,2677,205006,567,67350,819,8,1115,18,0,37,130000.0,39000.0,-70.0,-71.0,-67.0,-60.0,-70.0,-70.0,-67.0,-60.0,-90.0,-91.0,-89.0,-91.0,20.0,20.0,22.0,31.0,0
6440,BA:8C:B9:54:50:24,3830771,488702294,4736,6152035,3826035,482550259,0,8388,1652146,8366,1648651,22,3495,2324,14,5121,36,0,53,229410.0,130000.0,-49.0,-35.0,-42.0,-44.0,-43.0,-36.0,-43.0,-48.0,-90.0,-91.0,-89.0,-91.0,41.0,56.0,47.0,47.0,0
6441,92:69:1D:31:68:E9,3829791,486131024,3755,3580705,3826036,482550319,0,4203,1043561,4085,1017066,118,26495,2005,7,3894,80,0,36,216660.0,130000.0,-52.0,-50.0,-44.0,-46.0,-51.0,-50.0,-44.0,-46.0,-90.0,-91.0,-89.0,-91.0,38.0,41.0,45.0,45.0,0
6442,CC:2F:71:3F:1F:24,4470715,1185959683,644678,703409296,3826037,482550387,37,527216,564900320,526578,564823560,638,76760,509534,10,644915,64224,34,451,117000.0,39000.0,-67.0,-65.0,-70.0,-68.0,-67.0,-65.0,-70.0,-67.0,-90.0,-91.0,-89.0,-91.0,23.0,26.0,19.0,23.0,0
6443,CC:2F:71:3E:C5:1F,3826812,482645135,774,94614,3826038,482550521,0,3244,272356,2677,205006,567,67350,819,8,1115,18,0,37,130000.0,39000.0,-70.0,-71.0,-67.0,-60.0,-70.0,-70.0,-67.0,-60.0,-90.0,-91.0,-89.0,-91.0,20.0,20.0,22.0,31.0,0
6444,BA:8C:B9:54:50:24,3830774,488702556,4736,6152035,3826038,482550521,0,8388,1652146,8366,1648651,22,3495,2324,14,5121,36,0,53,229410.0,130000.0,-49.0,-35.0,-42.0,-44.0,-43.0,-36.0,-43.0,-48.0,-90.0,-91.0,-89.0,-91.0,41.0,56.0,47.0,47.0,0
6445,92:69:1D:31:68:E9,3829797,486131630,3755,3580705,3826042,482550925,0,4203,1043561,4085,1017066,118,26495,2005,7,3894,80,0,36,216660.0,130000.0,-52.0,-50.0,-44.0,-46.0,-51.0,-50.0,-44.0,-46.0,-90.0,-91.0,-89.0,-91.0,38.0,41.0,45.0,45.0,0
6446,CC:2F:71:3F:1F:24,4470762,1185974649,644720,703423724,3826042,482550925,37,527241,564905124,526603,564828364,638,76760,509559,10,644957,64236,34,451,130000.0,43333.0,-67.0,-65.0,-70.0,-68.0,-67.0,-65.0,-70.0,-67.0,-90.0,-91.0,-89.0,-91.0,23.0,26.0,19.0,23.0,0
6447,CC:2F:71:3E:C5:1F,3826816,482645539,774,94614,3826042,482550925,0,3244,272356,2677,205006,567,67350,819,8,1115,18,0,37,130000.0,39000.0,-70.0,-71.0,-67.0,-60.0,-70.0,-70.0,-67.0,-60.0,-90.0,-91.0,-89.0,-91.0,20.0,20.0,22.0,31.0,0
6448,BA:8C:B9:54:50:24,3830780,488703162,4736,6152035,3826044,482551127,0,8388,1652146,8366,1648651,22,3495,2324,14,5121,36,0,53,229410.0,130000.0,-49.0,-35.0,-42.0,-44.0,-43.0,-36.0,-43.0,-48.0,-90.0,-92.0,-89.0,-92.0,41.0,57.0,47.0,48.0,0
6449,92:69:1D:31:68:E9,3829800,486131894,3755,3580705,3826045,482551189,0,4203,1043561,4085,1017066,118,26495,2005,7,3894,80,0,36,216660.0,130000.0,-52.0,-50.0,-44.0,-46.0,-51.0,-50.0,-44.0,-46.0,-90.0,-92.0,-89.0,-92.0,38.0,42.0,45.0,46.0,0
6450,CC:2F:71:3F:1F:24,4470807,1185989229,644762,703438040,3826045,482551189,37,527269,564910302,526630,564833424,639,76878,509587,10,644999,64268,34,452,130000.0,43333.0,-67.0,-65.0,-70.0,-67.0,-67.0,-65.0,-70.0,-67.0,-90.0,-92.0,-89.0,-92.0,23.0,27.0,19.0,25.0,0
6451,CC:2F:71:3E:C5:1F,3826821,482646005,774,94614,3826047,482551391,0,3244,272356,2677,205006,567,67350,819,8,1115,18,0,37,130000.0,39000.0,-70.0,-71.0,-67.0,-60.0,-70.0,-70.0,-67.0,-60.0,-90.0,-92.0,-89.0,-92.0,20.0,21.0,22.0,32.0,0
6452,BA:8C:B9:54:50:24,3830784,488703486,4736,6152035,3826048,482551451,0,8388,1652146,8366,1648651,22,3495,2324,14,5121,36,0,53,229410.0,130000.0,-49.0,-35.0,-42.0,-44.0,-43.0,-36.0,-43.0,-48.0,-90.0,-92.0,-89.0,-92.0,41.0,57.0,47.0,48.0,0
6453,92:69:1D:31:68:E9,3829807,486132560,3755,3580705,3826052,482551855,0,4204,1043629,4086,1017134,118,26495,2005,7,3894,80,0,36,216660.0,130000.0,-52.0,-50.0,-44.0,-46.0,-51.0,-50.0,-44.0,-46.0,-90.0,-92.0,-89.0,-92.0,38.0,42.0,45.0,46.0,0
6454,CC:2F:71:3F:1F:24,4470856,1186004435,644804,703452580,3826052,482551855,37,527294,564915106,526655,564838228,639,76878,509612,10,645041,64271,34,452,130000.0,43333.0,-67.0,-65.0,-70.0,-68.0,-67.0,-65.0,-70.0,-67.0,-90.0,-92.0,-89.0,-92.0,23.0,27.0,19.0,24.0,0
6455,CC:2F:71:3E:C5:1F,3826826,482646469,774,94614,3826052,482551855,0,3244,272356,2677,205006,567,67350,819,8,1115,18,0,37,130000.0,39000.0,-70.0,-71.0,-67.0,-60.0,-70.0,-70.0,-67.0,-60.0,-90.0,-92.0,-89.0,-92.0,20.0,21.0,22.0,32.0,0
6456,BA:8C:B9:54:50:24,3830790,488704092,4736,6152035,3826054,482552057,0,8388,1652146,8366,1648651,22,3495,2324,14,5121,36,0,53,229410.0,130000.0,-49.0,-35.0,-42.0,-44.0,-43.0,-36.0,-43.0,-48.0,-90.0,-92.0,-89.0,-92.0,41.0,57.0,47.0,48.0,0
6457,92:69:1D:31:68:E9,3829809,486132762,3755,3580705,3826054,482552057,0,4204,1043629,4086,1017134,118,26495,2005,7,3894,80,0,36,216660.0,130000.0,-52.0,-50.0,-44.0,-46.0,-51.0,-50.0,-44.0,-46.0,-90.0,-92.0,-89.0,-92.0,38.0,42.0,45.0,46.0,0
6458,CC:2F:71:3F:1F:24,4470900,1186019121,644846,703467064,3826054,482552057,37,527320,564920026,526681,564843148,639,76878,509638,10,645083,64296,34,452,130000.0,39000.0,-67.0,-65.0,-71.0,-67.0,-67.0,-65.0,-70.0,-67.0,-90.0,-92.0,-89.0,-92.0,23.0,27.0,18.0,25.0,0
6459,CC:2F:71:3E:C5:1F,3826830,482646873,774,94614,3826056,482552259,0,3244,272356,2677,205006,567,67350,819,8,1115,18,0,37,130000.0,39000.0,-70.0,-71.0,-67.0,-60.0,-70.0,-70.0,-67.0,-60.0,-90.0,-92.0,-89.0,-92.0,20.0,21.0,22.0,32.0,0
6460,BA:8C:B9:54:50:24,3830792,488704294,4736,6152035,3826056,482552259,0,8388,1652146,8366,1648651,22,3495,2324,14,5121,36,0,53,229410.0,130000.0,-49.0,-35.0,-42.0,-44.0,-43.0,-36.0,-43.0,-48.0,-90.0,-92.0,-89.0,-92.0,41.0,57.0,47.0,48.0,0
6461,92:69:1D:31:68:E9,3829816,486133428,3755,3580705,3826061,482552723,0,4204,1043629,4086,1017134,118,26495,2005,7,3894,80,0,36,216660.0,130000.0,-52.0,-50.0,-44.0,-46.0,-51.0,-50.0,-44.0,-46.0,-90.0,-92.0,-89.0,-92.0,38.0,42.0,45.0,46.0,0
6462,CC:2F:71:3F:1F:24,4470948,1186034091,644887,703481368,3826061,482552723,37,527347,564925110,526708,564848232,639,76878,509665,10,645124,64304,34,452,130000.0,39000.0,-67.0,-65.0,-70.0,-67.0,-67.0,-65.0,-70.0,-67.0,-90.0,-92.0,-89.0,-92.0,23.0,27.0,19.0,25.0,0
6463,CC:2F:71:3E:C5:1F,3826835,482647337,774,94614,3826061,482552723,0,3244,272356,2677,205006,567,67350,819,8,1115,18,0,37,130000.0,39000.0,-70.0,-71.0,-67.0,-60.0,-70.0,-70.0,-67.0,-60.0,-90.0,-92.0,-89.0,-92.0,20.0,21.0,22.0,32.0,0
6464,BA:8C:B9:54:50:24,3830799,488704960,4736,6152035,3826063,482552925,0,8388,1652146,8366,1648651,22,3495,2324,14,5121,36,0,53,229410.0,130000.0,-49.0,-35.0,-42.0,-44.0,-43.0,-36.0,-43.0,-48.0,-90.0,-92.0,-89.0,-92.0,41.0,57.0,47.0,48.0,0
6465,92:69:1D:31:68:E9,3829841,486144653,3755,3580705,3826086,482563948,0,4207,1044000,4088,1017270,119,26730,2006,7,3894,80,0,36,216660.0,130000.0,-51.0,-47.0,-42.0,-49.0,-51.0,-49.0,-44.0,-47.0,-90.0,-92.0,-89.0,-92.0,39.0,45.0,47.0,43.0,0
6466,CC:2F:71:3F:1F:24,4471016,1186059818,644930,703495870,3826086,482563948,37,527373,564930054,526734,564853176,639,76878,509691,10,645167,64323,34,452,117000.0,39000.0,-67.0,-65.0,-71.0,-68.0,-67.0,-65.0,-70.0,-67.0,-90.0,-92.0,-89.0,-92.0,23.0,27.0,18.0,24.0,0
6467,CC:2F:71:3E:C5:1F,3826860,482658562,774,94614,3826086,482563948,0,3244,272356,2677,205006,567,67350,819,8,1115,18,0,37,130000.0,39000.0,-70.0,-71.0,-67.0,-60.0,-70.0,-70.0,-67.0,-60.0,-90.0,-92.0,-89.0,-92.0,20.0,21.0,22.0,32.0,0
6468,BA:8C:B9:54:50:24,3830824,488716185,4736,6152035,3826088,482564150,0,8388,1652146,8366,1648651,22,3495,2324,14,5121,36,0,53,229410.0,130000.0,-49.0,-35.0,-42.0,-44.0,-43.0,-36.0,-43.0,-48.0,-90.0,-92.0,-89.0,-92.0,41.0,57.0,47.0,48.0,0
6469,92:69:1D:31:68:E9,3829848,486145532,3755,3580705,3826093,482564827,0,4207,1044000,4088,1017270,119,26730,2006,7,3894,80,0,36,216660.0,130000.0,-51.0,-47.0,-42.0,-49.0,-51.0,-49.0,-44.0,-47.0,-90.0,-92.0,-89.0,-92.0,39.0,45.0,47.0,43.0,0
6470,CC:2F:71:3F:1F:24,4471067,1186075379,644974,703510552,3826093,482564827,37,527399,564934974,526760,564858096,639,76878,509717,10,645211,64329,34,452,130000.0,43333.0,-67.0,-65.0,-71.0,-67.0,-67.0,-65.0,-70.0,-67.0,-90.0,-92.0,-89.0,-92.0,23.0,27.0,18.0,25.0,0
6471,CC:2F:71:3E:C5:1F,3826869,482659643,774,94614,3826095,482565029,0,3244,272356,2677,205006,567,67350,819,8,1115,18,0,37,130000.0,39000.0,-70.0,-71.0,-67.0,-60.0,-70.0,-70.0,-67.0,-60.0,-90.0,-92.0,-89.0,-92.0,20.0,21.0,22.0,32.0,0
6472,BA:8C:B9:54:50:24,3830831,488717064,4736,6152035,3826095,482565029,0,8388,1652146,8366,1648651,22,3495,2324,14,5121,36,0,53,229410.0,130000.0,-49.0,-35.0,-42.0,-44.0,-43.0,-36.0,-43.0,-48.0,-90.0,-92.0,-89.0,-92.0,41.0,57.0,47.0,48.0,0
6473,92:69:1D:31:68:E9,3829851,486145794,3755,3580705,3826096,482565089,0,4207,1044000,4088,1017270,119,26730,2006,7,3894,80,0,36,216660.0,130000.0,-51.0,-47.0,-42.0,-49.0,-51.0,-49.0,-44.0,-47.0,-90.0,-92.0,-89.0,-92.0,39.0,45.0,47.0,43.0,0
6474,CC:2F:71:3F:1F:24,4471111,1186090001,645015,703524912,3826096,482565089,37,527424,564939778,526785,564862900,639,76878,509742,10,645252,64346,34,452,144444.0,39000.0,-67.0,-65.0,-70.0,-68.0,-67.0,-65.0,-70.0,-67.0,-90.0,-92.0,-89.0,-92.0,23.0,27.0,19.0,24.0,0
6475,CC:2F:71:3E:C5:1F,3826872,482659905,774,94614,3826098,482565291,0,3244,272356,2677,205006,567,67350,819,8,1115,18,0,37,130000.0,39000.0,-70.0,-71.0,-67.0,-60.0,-70.0,-70.0,-67.0,-60.0,-90.0,-92.0,-89.0,-92.0,20.0,21.0,22.0,32.0,0
6476,BA:8C:B9:54:50:24,3830834,488717326,4736,6152035,3826098,482565291,0,8388,1652146,8366,1648651,22,3495,2324,14,5121,36,0,53,229410.0,130000.0,-49.0,-35.0,-42.0,-44.0,-43.0,-36.0,-43.0,-48.0,-90.0,-92.0,-89.0,-92.0,41.0,57.0,47.0,48.0,0
6477,92:69:1D:31:68:E9,3829857,486146400,3755,3580705,3826102,482565695,0,4207,1044000,4088,1017270,119,26730,2006,7,3894,80,0,36,216660.0,130000.0,-51.0,-47.0,-42.0,-49.0,-51.0,-49.0,-44.0,-47.0,-90.0,-92.0,-89.0,-92.0,39.0,45.0,47.0,43.0,0
6478,CC:2F:71:3F:1F:24,4471158,1186104855,645056,703539160,3826102,482565695,37,527450,564944698,526811,564867820,639,76878,509768,10,645293,64372,34,452,130000.0,43333.0,-67.0,-65.0,-71.0,-68.0,-67.0,-65.0,-70.0,-67.0,-90.0,-92.0,-89.0,-92.0,23.0,27.0,18.0,24.0,0
6479,CC:2F:71:3E:C5:1F,3826878,482660511,774,94614,3826104,482565897,0,3244,272356,2677,205006,567,67350,819,8,1115,18,0,37,130000.0,39000.0,-70.0,-71.0,-67.0,-60.0,-70.0,-70.0,-67.0,-60.0,-90.0,-92.0,-89.0,-92.0,20.0,21.0,22.0,32.0,0
6480,BA:8C:B9:54:50:24,3830840,488717932,4736,6152035,3826104,482565897,0,8388,1652146,8366,1648651,22,3495,2324,14,5121,36,0,53,229410.0,130000.0,-49.0,-35.0,-42.0,-44.0,-43.0,-36.0,-43.0,-48.0,-90.0,-92.0,-89.0,-92.0,41.0,57.0,47.0,48.0,0
6481,92:69:1D:31:68:E9,3829861,486146970,3755,3580705,3826106,482566265,0,4207,1044000,4088,1017270,119,26730,2006,7,3894,80,0,36,216660.0,130000.0,-51.0,-47.0,-42.0,-49.0,-51.0,-49.0,-44.0,-47.0,-90.0,-92.0,-89.0,-92.0,39.0,45.0,47.0,43.0,0
6482,CC:2F:71:3F:1F:24,4471207,1186120355,645098,703553828,3826109,482566527,37,527477,564949746,526838,564872868,639,76878,509795,10,645335,64374,34,452,130000.0,43333.0,-67.0,-65.0,-70.0,-67.0,-67.0,-65.0,-70.0,-67.0,-90.0,-92.0,-89.0,-92.0,23.0,27.0,19.0,25.0,0
6483,CC:2F:71:3E:C5:1F,3826883,482661141,774,94614,3826109,482566527,0,3244,272356,2677,205006,567,67350,819,8,1115,18,0,37,130000.0,39000.0,-70.0,-71.0,-67.0,-60.0,-70.0,-70.0,-67.0,-60.0,-90.0,-92.0,-89.0,-92.0,20.0,21.0,22.0,32.0,0
6484,BA:8C:B9:54:50:24,3830847,488718764,4736,6152035,3826111,482566729,0,8388,1652146,8366,1648651,22,3495,2324,14,5121,36,0,53,229410.0,130000.0,-49.0,-35.0,-42.0,-44.0,-43.0,-36.0,-43.0,-48.0,-90.0,-92.0,-89.0,-92.0,41.0,57.0,47.0,48.0,0
6485,92:69:1D:31:68:E9,3829868,486147636,3755,3580705,3826113,482566931,0,4207,1044000,4088,1017270,119,26730,2006,7,3894,80,0,36,216660.0,130000.0,-51.0,-47.0,-42.0,-49.0,-51.0,-49.0,-44.0,-47.0,-90.0,-93.0,-90.0,-93.0,39.0,46.0,48.0,44.0,0
6486,CC:2F:71:3F:1F:24,4471255,1186135445,645140,703568312,3826115,482567133,37,527504,564954806,526865,564877928,639,76878,509822,10,645377,64391,34,452,130000.0,39000.0,-67.0,-65.0,-70.0,-68.0,-67.0,-65.0,-70.0,-67.0,-90.0,-93.0,-90.0,-93.0,23.0,28.0,20.0,25.0,0
6487,CC:2F:71:3E:C5:1F,3826889,482661747,774,94614,3826115,482567133,0,3244,272356,2677,205006,567,67350,819,8,1115,18,0,37,130000.0,39000.0,-70.0,-71.0,-67.0,-60.0,-70.0,-70.0,-67.0,-60.0,-90.0,-93.0,-90.0,-93.0,20.0,22.0,23.0,33.0,0
6488,BA:8C:B9:54:50:24,3830851,488719168,4736,6152035,3826115,482567133,0,8388,1652146,8366,1648651,22,3495,2324,14,5121,36,0,53,229410.0,130000.0,-49.0,-35.0,-42.0,-44.0,-43.0,-36.0,-43.0,-48.0,-90.0,-93.0,-90.0,-93.0,41.0,58.0,48.0,49.0,0
6489,92:69:1D:31:68:E9,3829870,486147838,3755,3580705,3826115,482567133,0,4207,1044000,4088,1017270,119,26730,2006,7,3894,80,0,36,216660.0,130000.0,-51.0,-47.0,-42.0,-49.0,-51.0,-49.0,-44.0,-47.0,-90.0,-93.0,-90.0,-93.0,39.0,46.0,48.0,44.0,0
6490,CC:2F:71:3F:1F:24,4471300,1186150143,645183,703582808,3826117,482567335,37,527531,564959890,526892,564883012,639,76878,509849,10,645420,64422,34,452,130000.0,43333.0,-67.0,-65.0,-70.0,-67.0,-67.0,-65.0,-70.0,-67.0,-90.0,-93.0,-90.0,-93.0,23.0,28.0,20.0,26.0,0
6491,CC:2F:71:3E:C5:1F,3826891,482661949,774,94614,3826117,482567335,0,3244,272356,2677,205006,567,67350,819,8,1115,18,0,37,130000.0,39000.0,-70.0,-71.0,-67.0,-60.0,-70.0,-70.0,-67.0,-60.0,-90.0,-93.0,-90.0,-93.0,20.0,22.0,23.0,33.0,0
6492,BA:8C:B9:54:50:24,3830855,488719572,4736,6152035,3826119,482567537,0,8388,1652146,8366,1648651,22,3495,2324,14,5121,36,0,53,229410.0,130000.0,-49.0,-35.0,-42.0,-44.0,-43.0,-36.0,-43.0,-48.0,-90.0,-93.0,-90.0,-93.0,41.0,58.0,48.0,49.0,0
6493,92:69:1D:31:68:E9,3829879,486148706,3755,3580705,3826124,482568001,0,4207,1044000,4088,1017270,119,26730,2006,7,3894,80,0,36,216660.0,130000.0,-51.0,-47.0,-42.0,-49.0,-51.0,-49.0,-44.0,-47.0,-91.0,-93.0,-90.0,-93.0,40.0,46.0,48.0,44.0,0
6494,CC:2F:71:3F:1F:24,4471347,1186165101,645223,703597100,3826124,482568001,37,527558,564964950,526919,564888072,639,76878,509876,10,645460,64426,34,452,130000.0,43333.0,-67.0,-65.0,-70.0,-68.0,-67.0,-65.0,-70.0,-67.0,-91.0,-93.0,-90.0,-93.0,24.0,28.0,20.0,25.0,0
6495,CC:2F:71:3E:C5:1F,3826898,482662615,774,94614,3826124,482568001,0,3244,272356,2677,205006,567,67350,819,8,1115,18,0,37,130000.0,39000.0,-70.0,-71.0,-67.0,-60.0,-70.0,-70.0,-67.0,-60.0,-91.0,-93.0,-90.0,-93.0,21.0,22.0,23.0,33.0,0
6496,BA:8C:B9:54:50:24,3830860,488720036,4736,6152035,3826124,482568001,0,8388,1652146,8366,1648651,22,3495,2324,14,5121,36,0,53,229410.0,130000.0,-49.0,-35.0,-42.0,-44.0,-43.0,-36.0,-43.0,-48.0,-91.0,-93.0,-90.0,-93.0,42.0,58.0,48.0,49.0,0
6497,92:69:1D:31:68:E9,3829879,486148706,3755,3580705,3826124,482568001,0,4207,1044000,4088,1017270,119,26730,2006,7,3894,80,0,36,216660.0,130000.0,-51.0,-47.0,-42.0,-49.0,-51.0,-49.0,-44.0,-47.0,-91.0,-93.0,-90.0,-93.0,40.0,46.0,48.0,44.0,0
6498,CC:2F:71:3F:1F:24,4471389,1186179641,645265,703611640,3826124,482568001,37,527583,564969754,526944,564892876,639,76878,509901,10,645502,64430,34,452,130000.0,43333.0,-67.0,-65.0,-71.0,-68.0,-67.0,-65.0,-70.0,-67.0,-91.0,-93.0,-90.0,-93.0,24.0,28.0,19.0,25.0,0
6499,CC:2F:71:3E:C5:1F,3826900,482662817,774,94614,3826126,482568203,0,3244,272356,2677,205006,567,67350,819,8,1115,18,0,37,130000.0,39000.0,-70.0,-71.0,-67.0,-60.0,-70.0,-70.0,-67.0,-60.0,-91.0,-93.0,-90.0,-93.0,21.0,22.0,23.0,33.0,0
6500,BA:8C:B9:54:50:24,3830864,488720440,4736,6152035,3826128,482568405,0,8388,1652146,8366,1648651,22,3495,2324,14,5121,36,0,53,229410.0,130000.0,-49.0,-35.0,-42.0,-44.0,-43.0,-36.0,-43.0,-48.0,-91.0,-93.0,-90.0,-93.0,42.0,58.0,48.0,49.0,0
6501,92:69:1D:31:68:E9,3829887,486149514,3755,3580705,3826132,482568809,0,4207,1044000,4088,1017270,119,26730,2006,7,3894,80,0,36,216660.0,130000.0,-51.0,-47.0,-42.0,-49.0,-51.0,-49.0,-44.0,-47.0,-91.0,-93.0,-90.0,-93.0,40.0,46.0,48.0,44.0,0
6502,CC:2F:71:3F:1F:24,4471439,1186194877,645307,703626068,3826132,482568809,37,527609,564974698,526970,564897820,639,76878,509927,10,645544,64451,34,452,117000.0,39000.0,-68.0,-66.0,-71.0,-68.0,-67.0,-65.0,-70.0,-68.0,-91.0,-93.0,-90.0,-93.0,23.0,27.0,19.0,25.0,0
6503,CC:2F:71:3E:C5:1F,3826906,482663423,774,94614,3826132,482568809,0,3244,272356,2677,205006,567,67350,819,8,1115,18,0,37,130000.0,39000.0,-70.0,-71.0,-67.0,-60.0,-70.0,-70.0,-67.0,-60.0,-91.0,-93.0,-90.0,-93.0,21.0,22.0,23.0,33.0,0
6504,BA:8C:B9:54:50:24,3830868,488720844,4736,6152035,3826132,482568809,0,8388,1652146,8366,1648651,22,3495,2324,14,5121,36,0,53,229410.0,130000.0,-49.0,-35.0,-42.0,-44.0,-43.0,-36.0,-43.0,-48.0,-91.0,-93.0,-90.0,-93.0,42.0,58.0,48.0,49.0,0
6505,92:69:1D:31:68:E9,3829890,486149778,3757,3580909,3826133,482568869,0,4210,1044268,4091,1017538,119,26730,2007,7,3896,80,0,36,229410.0,130000.0,-52.0,-50.0,-44.0,-46.0,-52.0,-49.0,-44.0,-48.0,-91.0,-93.0,-90.0,-93.0,39.0,43.0,46.0,47.0,0
6506,CC:2F:71:3F:1F:24,4471481,1186209241,645348,703640372,3826133,482568869,37,527635,564979618,526996,564902740,639,76878,509953,10,645585,64452,34,452,130000.0,43333.0,-67.0,-65.0,-71.0,-68.0,-67.0,-65.0,-71.0,-68.0,-91.0,-93.0,-90.0,-93.0,24.0,28.0,19.0,25.0,0
6507,CC:2F:71:3E:C5:1F,3826907,482663483,774,94614,3826133,482568869,0,3244,272356,2677,205006,567,67350,819,8,1115,18,0,37,130000.0,39000.0,-70.0,-71.0,-67.0,-60.0,-70.0,-70.0,-67.0,-60.0,-91.0,-93.0,-90.0,-93.0,21.0,22.0,23.0,33.0,0
6508,BA:8C:B9:54:50:24,3830873,488721308,4736,6152035,3826137,482569273,0,8388,1652146,8366,1648651,22,3495,2324,14,5121,36,0,53,229410.0,130000.0,-49.0,-35.0,-42.0,-44.0,-43.0,-36.0,-43.0,-48.0,-91.0,-93.0,-90.0,-93.0,42.0,58.0,48.0,49.0,0
6509,92:69:1D:31:68:E9,3829898,486150586,3757,3580909,3826141,482569677,0,4210,1044268,4091,1017538,119,26730,2007,7,3896,80,0,36,229410.0,130000.0,-52.0,-50.0,-44.0,-46.0,-52.0,-49.0,-44.0,-48.0,-91.0,-93.0,-90.0,-93.0,39.0,43.0,46.0,47.0,0
6510,CC:2F:71:3F:1F:24,4471530,1186224409,645389,703654732,3826141,482569677,37,527662,564984702,527023,564907824,639,76878,509980,10,645626,64471,34,452,117000.0,39000.0,-67.0,-65.0,-71.0,-68.0,-67.0,-65.0,-70.0,-68.0,-91.0,-93.0,-90.0,-93.0,24.0,28.0,19.0,25.0,0
6511,CC:2F:71:3E:C5:1F,3826915,482664291,774,94614,3826141,482569677,0,3244,272356,2677,205006,567,67350,819,8,1115,18,0,37,130000.0,39000.0,-70.0,-71.0,-67.0,-60.0,-70.0,-70.0,-67.0,-60.0,-91.0,-93.0,-90.0,-93.0,21.0,22.0,23.0,33.0,0
6512,BA:8C:B9:54:50:24,3830877,488721712,4736,6152035,3826141,482569677,0,8388,1652146,8366,1648651,22,3495,2324,14,5121,36,0,53,229410.0,130000.0,-49.0,-35.0,-42.0,-44.0,-43.0,-36.0,-43.0,-48.0,-91.0,-93.0,-90.0,-93.0,42.0,58.0,48.0,49.0,0
6513,92:69:1D:31:68:E9,3829899,486150646,3757,3580909,3826142,482569737,0,4210,1044268,4091,1017538,119,26730,2007,7,3896,80,0,36,229410.0,130000.0,-52.0,-50.0,-44.0,-46.0,-52.0,-49.0,-44.0,-48.0,-91.0,-93.0,-90.0,-93.0,39.0,43.0,46.0,47.0,0
6514,CC:2F:71:3F:1F:24,4471573,1186238841,645431,703669104,3826142,482569737,37,527689,564989762,527050,564912884,639,76878,510007,10,645668,64473,34,452,130000.0,43333.0,-67.0,-65.0,-70.0,-68.0,-66.0,-65.0,-70.0,-68.0,-91.0,-93.0,-90.0,-93.0,24.0,28.0,20.0,25.0,0
6515,CC:2F:71:3E:C5:1F,3826916,482664351,774,94614,3826142,482569737,0,3244,272356,2677,205006,567,67350,819,8,1115,18,0,37,130000.0,39000.0,-70.0,-71.0,-67.0,-60.0,-70.0,-70.0,-67.0,-60.0,-91.0,-93.0,-90.0,-93.0,21.0,22.0,23.0,33.0,0
6516,BA:8C:B9:54:50:24,3830880,488721974,4736,6152035,3826144,482569939,0,8388,1652146,8366,1648651,22,3495,2324,14,5121,36,0,53,229410.0,130000.0,-49.0,-35.0,-42.0,-44.0,-43.0,-36.0,-43.0,-48.0,-91.0,-93.0,-90.0,-93.0,42.0,58.0,48.0,49.0,0
6517,92:69:1D:31:68:E9,3829908,486151570,3758,3581025,3826150,482570545,0,4212,1044404,4093,1017674,119,26730,2007,7,3897,80,0,36,229410.0,130000.0,-52.0,-50.0,-44.0,-46.0,-52.0,-49.0,-44.0,-48.0,-91.0,-93.0,-90.0,-93.0,39.0,43.0,46.0,47.0,0
6518,CC:2F:71:3F:1F:24,4471623,1186254119,645473,703683574,3826150,482570545,37,527714,564994566,527075,564917688,639,76878,510032,10,645710,64497,34,452,117000.0,39000.0,-67.0,-65.0,-71.0,-68.0,-67.0,-65.0,-70.0,-68.0,-91.0,-93.0,-90.0,-93.0,24.0,28.0,19.0,25.0,0
6519,CC:2F:71:3E:C5:1F,3826925,482665275,775,94730,3826150,482570545,0,3246,272496,2679,205146,567,67350,819,8,1116,18,0,37,130000.0,39000.0,-70.0,-70.0,-68.0,-60.0,-70.0,-70.0,-67.0,-59.0,-91.0,-93.0,-90.0,-93.0,21.0,23.0,22.0,33.0,0
6520,BA:8C:B9:54:50:24,3830887,488722696,4737,6152151,3826150,482570545,0,8390,1652282,8368,1648787,22,3495,2324,14,5122,36,0,53,229410.0,130000.0,-40.0,-37.0,-45.0,-52.0,-43.0,-36.0,-43.0,-49.0,-91.0,-93.0,-90.0,-93.0,51.0,56.0,45.0,41.0,0
6521,92:69:1D:31:68:E9,3829909,486151843,3758,3581025,3826151,482570818,0,4212,1044404,4093,1017674,119,26730,2007,7,3897,80,0,36,229410.0,130000.0,-52.0,-50.0,-44.0,-46.0,-52.0,-49.0,-44.0,-48.0,-91.0,-93.0,-90.0,-93.0,39.0,43.0,46.0,47.0,0
6522,CC:2F:71:3F:1F:24,4471665,1186268640,645514,703697822,3826151,482570818,37,527741,564999626,527102,564922748,639,76878,510059,10,645751,64507,34,452,130000.0,43333.0,-67.0,-65.0,-71.0,-68.0,-67.0,-65.0,-70.0,-68.0,-91.0,-93.0,-90.0,-93.0,24.0,28.0,19.0,25.0,0
6523,CC:2F:71:3E:C5:1F,3826926,482665548,775,94730,3826151,482570818,0,3246,272496,2679,205146,567,67350,819,8,1116,18,0,37,130000.0,39000.0,-70.0,-70.0,-68.0,-60.0,-70.0,-70.0,-67.0,-59.0,-91.0,-93.0,-90.0,-93.0,21.0,23.0,22.0,33.0,0
6524,BA:8C:B9:54:50:24,3830890,488723171,4737,6152151,3826153,482571020,0,8390,1652282,8368,1648787,22,3495,2324,14,5122,36,0,53,229410.0,130000.0,-40.0,-37.0,-45.0,-52.0,-43.0,-36.0,-43.0,-49.0,-91.0,-93.0,-90.0,-93.0,51.0,56.0,45.0,41.0,0
6525,92:69:1D:31:68:E9,3829916,486152509,3758,3581025,3826158,482571484,0,4212,1044404,4093,1017674,119,26730,2007,7,3897,80,0,36,229410.0,130000.0,-52.0,-50.0,-44.0,-46.0,-52.0,-49.0,-44.0,-48.0,-91.0,-93.0,-90.0,-93.0,39.0,43.0,46.0,47.0,0
6526,CC:2F:71:3F:1F:24,4471714,1186283734,645556,703712250,3826158,482571484,37,527766,565004430,527127,564927552,639,76878,510084,10,645793,64521,34,452,117000.0,39000.0,-67.0,-65.0,-71.0,-68.0,-67.0,-65.0,-70.0,-68.0,-91.0,-93.0,-90.0,-93.0,24.0,28.0,19.0,25.0,0
6527,CC:2F:71:3E:C5:1F,3826935,482666416,775,94730,3826160,482571686,0,3246,272496,2679,205146,567,67350,819,8,1116,18,0,37,130000.0,39000.0,-70.0,-70.0,-68.0,-60.0,-70.0,-70.0,-67.0,-59.0,-91.0,-93.0,-90.0,-93.0,21.0,23.0,22.0,33.0,0
6528,BA:8C:B9:54:50:24,3830897,488723837,4737,6152151,3826160,482571686,0,8391,1652350,8369,1648855,22,3495,2324,14,5122,36,0,53,229410.0,130000.0,-40.0,-37.0,-45.0,-52.0,-43.0,-36.0,-43.0,-49.0,-91.0,-93.0,-90.0,-93.0,51.0,56.0,45.0,41.0,0
6529,92:69:1D:31:68:E9,3829918,486152711,3758,3581025,3826160,482571686,0,4212,1044404,4093,1017674,119,26730,2007,7,3897,80,0,36,229410.0,130000.0,-52.0,-50.0,-44.0,-46.0,-52.0,-49.0,-44.0,-48.0,-91.0,-93.0,-90.0,-93.0,39.0,43.0,46.0,47.0,0
6530,CC:2F:71:3F:1F:24,4471758,1186298364,645598,703726678,3826160,482571686,37,527792,565009374,527153,564932496,639,76878,510110,10,645835,64524,34,452,130000.0,43333.0,-68.0,-66.0,-71.0,-68.0,-67.0,-65.0,-70.0,-68.0,-91.0,-93.0,-90.0,-93.0,23.0,27.0,19.0,25.0,0
6531,CC:2F:71:3E:C5:1F,3826935,482666416,775,94730,3826160,482571686,0,3246,272496,2679,205146,567,67350,819,8,1116,18,0,37,130000.0,39000.0,-70.0,-70.0,-68.0,-60.0,-70.0,-70.0,-67.0,-59.0,-91.0,-93.0,-90.0,-93.0,21.0,23.0,22.0,33.0,0
6532,BA:8C:B9:54:50:24,3830899,488724039,4737,6152151,3826162,482571888,0,8391,1652350,8369,1648855,22,3495,2324,14,5122,36,0,53,229410.0,130000.0,-40.0,-37.0,-45.0,-52.0,-43.0,-36.0,-43.0,-49.0,-91.0,-93.0,-90.0,-93.0,51.0,56.0,45.0,41.0,0
6533,92:69:1D:31:68:E9,3829929,486153821,3760,3581257,3826169,482572564,0,4216,1044756,4097,1018026,119,26730,2009,7,3899,80,0,36,229410.0,130000.0,-52.0,-47.0,-42.0,-49.0,-52.0,-49.0,-43.0,-48.0,-91.0,-93.0,-90.0,-93.0,39.0,46.0,48.0,44.0,0
6534,CC:2F:71:3F:1F:24,4471808,1186313658,645639,703741094,3826169,482572564,37,527817,565014178,527178,564937300,639,76878,510135,10,645876,64529,34,452,130000.0,43333.0,-67.0,-65.0,-70.0,-68.0,-67.0,-65.0,-70.0,-68.0,-91.0,-93.0,-90.0,-93.0,24.0,28.0,20.0,25.0,0
6535,CC:2F:71:3E:C5:1F,3826944,482667294,775,94730,3826169,482572564,0,3248,272684,2680,205216,568,67468,820,8,1116,18,0,37,130000.0,39000.0,-70.0,-71.0,-67.0,-60.0,-70.0,-70.0,-67.0,-59.0,-91.0,-93.0,-90.0,-93.0,21.0,22.0,23.0,33.0,0
6536,BA:8C:B9:54:50:24,3830909,488724977,4737,6152151,3826172,482572826,0,8391,1652350,8369,1648855,22,3495,2324,14,5122,36,0,53,229410.0,130000.0,-40.0,-37.0,-45.0,-52.0,-43.0,-36.0,-43.0,-49.0,-91.0,-93.0,-90.0,-93.0,51.0,56.0,45.0,41.0,0
6537,92:69:1D:31:68:E9,3829932,486154083,3760,3581257,3826172,482572826,0,4216,1044756,4097,1018026,119,26730,2009,7,3899,80,0,36,229410.0,130000.0,-52.0,-47.0,-42.0,-49.0,-52.0,-49.0,-43.0,-48.0,-91.0,-93.0,-90.0,-93.0,39.0,46.0,48.0,44.0,0
6538,CC:2F:71:3F:1F:24,4471853,1186328348,645681,703755522,3826172,482572826,37,527842,565018982,527203,564942104,639,76878,510160,10,645918,64556,34,452,117000.0,39000.0,-67.0,-65.0,-71.0,-68.0,-67.0,-65.0,-70.0,-68.0,-91.0,-93.0,-90.0,-93.0,24.0,28.0,19.0,25.0,0
6539,CC:2F:71:3E:C5:1F,3826947,482667556,775,94730,3826172,482572826,0,3248,272684,2680,205216,568,67468,820,8,1116,18,0,37,130000.0,39000.0,-70.0,-71.0,-67.0,-60.0,-70.0,-70.0,-67.0,-59.0,-91.0,-93.0,-90.0,-93.0,21.0,22.0,23.0,33.0,0
6540,BA:8C:B9:54:50:24,3830909,488724977,4737,6152151,3826172,482572826,0,8391,1652350,8369,1648855,22,3495,2324,14,5122,36,0,53,229410.0,130000.0,-40.0,-37.0,-45.0,-52.0,-43.0,-36.0,-43.0,-49.0,-91.0,-93.0,-90.0,-93.0,51.0,56.0,45.0,41.0,0
6541,92:69:1D:31:68:E9,3829938,486154689,3760,3581257,3826178,482573432,0,4216,1044756,4097,1018026,119,26730,2009,7,3899,80,0,36,229410.0,130000.0,-52.0,-47.0,-42.0,-49.0,-52.0,-49.0,-43.0,-48.0,-91.0,-93.0,-90.0,-93.0,39.0,46.0,48.0,44.0,0
6542,CC:2F:71:3F:1F:24,4471901,1186343382,645723,703769950,3826178,482573432,37,527867,565023786,527228,564946908,639,76878,510185,10,645960,64556,34,452,130000.0,43333.0,-67.0,-65.0,-71.0,-68.0,-67.0,-65.0,-70.0,-68.0,-91.0,-93.0,-90.0,-93.0,24.0,28.0,19.0,25.0,0
6543,CC:2F:71:3E:C5:1F,3826953,482668162,775,94730,3826178,482573432,0,3248,272684,2680,205216,568,67468,820,8,1116,18,0,37,130000.0,39000.0,-70.0,-71.0,-67.0,-60.0,-70.0,-70.0,-67.0,-59.0,-91.0,-93.0,-90.0,-93.0,21.0,22.0,23.0,33.0,0
6544,BA:8C:B9:54:50:24,3830915,488725583,4737,6152151,3826178,482573432,0,8391,1652350,8369,1648855,22,3495,2324,14,5122,36,0,53,229410.0,130000.0,-40.0,-37.0,-45.0,-52.0,-43.0,-36.0,-43.0,-49.0,-91.0,-93.0,-90.0,-93.0,51.0,56.0,45.0,41.0,0
6545,92:69:1D:31:68:E9,3829942,486155013,3760,3581257,3826182,482573756,0,4216,1044756,4097,1018026,119,26730,2009,7,3899,80,0,36,229410.0,130000.0,-52.0,-47.0,-42.0,-49.0,-52.0,-49.0,-43.0,-48.0,-91.0,-93.0,-90.0,-93.0,39.0,46.0,48.0,44.0,0
6546,CC:2F:71:3F:1F:24,4471947,1186358252,645765,703784496,3826182,482573756,37,527893,565028708,527253,564951712,640,76996,510211,10,646002,64559,34,452,130000.0,43333.0,-67.0,-65.0,-71.0,-68.0,-67.0,-65.0,-70.0,-68.0,-91.0,-93.0,-90.0,-93.0,24.0,28.0,19.0,25.0,0
6547,CC:2F:71:3E:C5:1F,3826957,482668486,775,94730,3826182,482573756,0,3248,272684,2680,205216,568,67468,820,8,1116,18,0,37,130000.0,39000.0,-70.0,-71.0,-67.0,-60.0,-70.0,-70.0,-67.0,-59.0,-91.0,-93.0,-90.0,-93.0,21.0,22.0,23.0,33.0,0
6548,BA:8C:B9:54:50:24,3830919,488725907,4737,6152151,3826182,482573756,0,8391,1652350,8369,1648855,22,3495,2324,14,5122,36,0,53,229410.0,130000.0,-40.0,-37.0,-45.0,-52.0,-43.0,-36.0,-43.0,-49.0,-91.0,-93.0,-90.0,-93.0,51.0,56.0,45.0,41.0,0
6549,92:69:1D:31:68:E9,3829948,486155619,3760,3581257,3826188,482574362,0,4216,1044756,4097,1018026,119,26730,2009,7,3899,80,0,36,229410.0,130000.0,-52.0,-47.0,-42.0,-49.0,-52.0,-49.0,-43.0,-48.0,-91.0,-93.0,-90.0,-93.0,39.0,46.0,48.0,44.0,0
6550,CC:2F:71:3F:1F:24,4471995,1186373286,645807,703798924,3826188,482574362,37,527918,565033512,527278,564956516,640,76996,510236,10,646044,64572,34,452,117000.0,39000.0,-67.0,-65.0,-70.0,-68.0,-67.0,-65.0,-70.0,-68.0,-91.0,-93.0,-90.0,-93.0,24.0,28.0,20.0,25.0,0
6551,CC:2F:71:3E:C5:1F,3826963,482669092,775,94730,3826188,482574362,0,3248,272684,2680,205216,568,67468,820,8,1116,18,0,37,130000.0,39000.0,-70.0,-71.0,-67.0,-60.0,-70.0,-70.0,-67.0,-59.0,-91.0,-93.0,-90.0,-93.0,21.0,22.0,23.0,33.0,0
6552,BA:8C:B9:54:50:24,3830925,488726513,4737,6152151,3826188,482574362,0,8391,1652350,8369,1648855,22,3495,2324,14,5122,36,0,53,229410.0,130000.0,-40.0,-37.0,-45.0,-52.0,-43.0,-36.0,-43.0,-49.0,-91.0,-93.0,-90.0,-93.0,51.0,56.0,45.0,41.0,0
6553,92:69:1D:31:68:E9,3829950,486155821,3760,3581257,3826190,482574564,0,4216,1044756,4097,1018026,119,26730,2009,7,3899,80,0,36,229410.0,130000.0,-52.0,-47.0,-42.0,-49.0,-52.0,-49.0,-43.0,-48.0,-91.0,-93.0,-90.0,-93.0,39.0,46.0,48.0,44.0,0
6554,CC:2F:71:3F:1F:24,4472038,1186387680,645848,703813116,3826190,482574564,37,527943,565038316,527303,564961320,640,76996,510261,10,646085,64578,34,452,117000.0,39000.0,-67.0,-65.0,-71.0,-68.0,-67.0,-65.0,-70.0,-68.0,-91.0,-93.0,-90.0,-93.0,24.0,28.0,19.0,25.0,0
6555,CC:2F:71:3E:C5:1F,3826965,482669294,775,94730,3826190,482574564,0,3248,272684,2680,205216,568,67468,820,8,1116,18,0,37,130000.0,39000.0,-70.0,-71.0,-67.0,-60.0,-70.0,-70.0,-67.0,-59.0,-91.0,-93.0,-90.0,-93.0,21.0,22.0,23.0,33.0,0
6556,BA:8C:B9:54:50:24,3830927,488726715,4737,6152151,3826190,482574564,0,8391,1652350,8369,1648855,22,3495,2324,14,5122,36,0,53,229410.0,130000.0,-40.0,-37.0,-45.0,-52.0,-43.0,-36.0,-43.0,-49.0,-91.0,-93.0,-90.0,-93.0,51.0,56.0,45.0,41.0,0
6557,92:69:1D:31:68:E9,3829957,486156487,3760,3581257,3826197,482575230,0,4216,1044756,4097,1018026,119,26730,2009,7,3899,80,0,36,229410.0,130000.0,-52.0,-47.0,-42.0,-49.0,-52.0,-49.0,-43.0,-48.0,-91.0,-93.0,-90.0,-93.0,39.0,46.0,48.0,44.0,0
6558,CC:2F:71:3F:1F:24,4472088,1186402792,645891,703827562,3826197,482575230,37,527971,565043468,527331,564966472,640,76996,510289,10,646128,64597,34,452,117000.0,39000.0,-68.0,-66.0,-71.0,-68.0,-67.0,-65.0,-71.0,-67.0,-91.0,-93.0,-90.0,-93.0,23.0,27.0,19.0,25.0,0
6559,CC:2F:71:3E:C5:1F,3826972,482669960,775,94730,3826197,482575230,0,3248,272684,2680,205216,568,67468,820,8,1116,18,0,37,130000.0,39000.0,-70.0,-71.0,-67.0,-60.0,-70.0,-70.0,-67.0,-59.0,-91.0,-93.0,-90.0,-93.0,21.0,22.0,23.0,33.0,0
6560,BA:8C:B9:54:50:24,3830934,488727381,4737,6152151,3826197,482575230,0,8391,1652350,8369,1648855,22,3495,2324,14,5122,36,0,53,229410.0,130000.0,-40.0,-37.0,-45.0,-52.0,-43.0,-36.0,-43.0,-49.0,-91.0,-93.0,-90.0,-93.0,51.0,56.0,45.0,41.0,0
6561,92:69:1D:31:68:E9,3829959,486156689,3760,3581257,3826199,482575432,0,4216,1044756,4097,1018026,119,26730,2009,7,3899,80,0,36,229410.0,130000.0,-52.0,-47.0,-42.0,-49.0,-52.0,-49.0,-43.0,-48.0,-91.0,-93.0,-90.0,-93.0,39.0,46.0,48.0,44.0,0
6562,CC:2F:71:3F:1F:24,4472132,1186417422,645933,703841990,3826199,482575432,37,527996,565048272,527356,564971276,640,76996,510314,10,646170,64606,34,452,130000.0,43333.0,-67.0,-65.0,-70.0,-67.0,-67.0,-65.0,-70.0,-67.0,-91.0,-93.0,-90.0,-93.0,24.0,28.0,20.0,26.0,0
6563,CC:2F:71:3E:C5:1F,3826974,482670162,775,94730,3826199,482575432,0,3248,272684,2680,205216,568,67468,820,8,1116,18,0,37,130000.0,39000.0,-70.0,-71.0,-67.0,-60.0,-70.0,-70.0,-67.0,-59.0,-91.0,-93.0,-90.0,-93.0,21.0,22.0,23.0,33.0,0
6564,BA:8C:B9:54:50:24,3830936,488727583,4737,6152151,3826199,482575432,0,8391,1652350,8369,1648855,22,3495,2324,14,5122,36,0,53,229410.0,130000.0,-40.0,-37.0,-45.0,-52.0,-43.0,-36.0,-43.0,-49.0,-91.0,-93.0,-90.0,-93.0,51.0,56.0,45.0,41.0,0
6565,92:69:1D:31:68:E9,3829965,486157295,3760,3581257,3826205,482576038,0,4216,1044756,4097,1018026,119,26730,2009,7,3899,80,0,36,229410.0,130000.0,-52.0,-47.0,-42.0,-49.0,-52.0,-49.0,-43.0,-48.0,-91.0,-93.0,-90.0,-93.0,39.0,46.0,48.0,44.0,0
6566,CC:2F:71:3F:1F:24,4472180,1186432568,645975,703856530,3826205,482576038,37,528022,565053216,527382,564976220,640,76996,510340,10,646212,64608,34,452,130000.0,43333.0,-67.0,-65.0,-70.0,-68.0,-67.0,-65.0,-70.0,-67.0,-91.0,-93.0,-90.0,-93.0,24.0,28.0,20.0,25.0,0
6567,CC:2F:71:3E:C5:1F,3826980,482670768,775,94730,3826205,482576038,0,3248,272684,2680,205216,568,67468,820,8,1116,18,0,37,130000.0,39000.0,-70.0,-71.0,-67.0,-60.0,-70.0,-70.0,-67.0,-59.0,-91.0,-93.0,-90.0,-93.0,21.0,22.0,23.0,33.0,0
6568,BA:8C:B9:54:50:24,3830943,488728249,4737,6152151,3826206,482576098,0,8391,1652350,8369,1648855,22,3495,2324,14,5122,36,0,53,229410.0,130000.0,-40.0,-37.0,-45.0,-52.0,-43.0,-36.0,-43.0,-49.0,-91.0,-93.0,-90.0,-93.0,51.0,56.0,45.0,41.0,0
6569,92:69:1D:31:68:E9,3829968,486157557,3760,3581257,3826208,482576300,0,4216,1044756,4097,1018026,119,26730,2009,7,3899,80,0,36,229410.0,130000.0,-52.0,-47.0,-42.0,-49.0,-52.0,-49.0,-43.0,-48.0,-91.0,-93.0,-90.0,-93.0,39.0,46.0,48.0,44.0,0
6570,CC:2F:71:3F:1F:24,4472225,1186447314,646017,703871014,3826208,482576300,37,528049,565058276,527409,564981280,640,76996,510367,10,646254,64623,34,452,130000.0,39000.0,-67.0,-65.0,-70.0,-67.0,-67.0,-65.0,-70.0,-67.0,-91.0,-93.0,-90.0,-93.0,24.0,28.0,20.0,26.0,0
6571,CC:2F:71:3E:C5:1F,3826983,482671030,775,94730,3826208,482576300,0,3248,272684,2680,205216,568,67468,820,8,1116,18,0,37,130000.0,39000.0,-70.0,-71.0,-67.0,-60.0,-70.0,-70.0,-67.0,-59.0,-91.0,-93.0,-90.0,-93.0,21.0,22.0,23.0,33.0,0
6572,BA:8C:B9:54:50:24,3830946,488728577,4737,6152151,3826209,482576426,0,8391,1652350,8369,1648855,22,3495,2324,14,5122,36,0,53,229410.0,130000.0,-40.0,-37.0,-45.0,-52.0,-43.0,-36.0,-43.0,-49.0,-91.0,-93.0,-90.0,-93.0,51.0,56.0,45.0,41.0,0
6573,92:69:1D:31:68:E9,3829975,486158289,3760,3581257,3826215,482577032,0,4216,1044756,4097,1018026,119,26730,2009,7,3899,80,0,36,229410.0,130000.0,-52.0,-47.0,-42.0,-49.0,-52.0,-49.0,-43.0,-48.0,-91.0,-93.0,-90.0,-93.0,39.0,46.0,48.0,44.0,0
6574,CC:2F:71:3F:1F:24,4472273,1186462350,646058,703885318,3826215,482577032,37,528074,565063080,527434,564986084,640,76996,510392,10,646295,64636,34,452,130000.0,39000.0,-67.0,-65.0,-70.0,-68.0,-67.0,-65.0,-70.0,-67.0,-91.0,-93.0,-90.0,-93.0,24.0,28.0,20.0,25.0,0
6575,CC:2F:71:3E:C5:1F,3826990,482671762,775,94730,3826215,482577032,0,3248,272684,2680,205216,568,67468,820,8,1116,18,0,37,130000.0,39000.0,-70.0,-71.0,-67.0,-60.0,-70.0,-70.0,-67.0,-59.0,-91.0,-93.0,-90.0,-93.0,21.0,22.0,23.0,33.0,0
6576,BA:8C:B9:54:50:24,3830953,488729456,4737,6152151,3826216,482577305,0,8391,1652350,8369,1648855,22,3495,2324,14,5122,36,0,53,229410.0,130000.0,-40.0,-37.0,-45.0,-52.0,-43.0,-36.0,-43.0,-49.0,-91.0,-93.0,-90.0,-93.0,51.0,56.0,45.0,41.0,0
6577,92:69:1D:31:68:E9,3829979,486158824,3760,3581257,3826219,482577567,0,4216,1044756,4097,1018026,119,26730,2009,7,3899,80,0,36,229410.0,130000.0,-52.0,-47.0,-42.0,-49.0,-52.0,-49.0,-43.0,-48.0,-91.0,-93.0,-90.0,-93.0,39.0,46.0,48.0,44.0,0
6578,CC:2F:71:3F:1F:24,4472319,1186477633,646100,703900066,3826219,482577567,37,528100,565068034,527460,564991038,640,76996,510418,10,646337,64663,34,452,144444.0,39000.0,-67.0,-65.0,-70.0,-67.0,-67.0,-65.0,-70.0,-67.0,-91.0,-93.0,-90.0,-93.0,24.0,28.0,20.0,26.0,0
6579,CC:2F:71:3E:C5:1F,3826994,482672297,775,94730,3826219,482577567,0,3248,272684,2680,205216,568,67468,820,8,1116,18,0,37,130000.0,39000.0,-70.0,-71.0,-67.0,-60.0,-70.0,-70.0,-67.0,-59.0,-91.0,-93.0,-90.0,-93.0,21.0,22.0,23.0,33.0,0
6580,BA:8C:B9:54:50:24,3830956,488729718,4737,6152151,3826219,482577567,0,8391,1652350,8369,1648855,22,3495,2324,14,5122,36,0,53,229410.0,130000.0,-40.0,-37.0,-45.0,-52.0,-43.0,-36.0,-43.0,-49.0,-91.0,-93.0,-90.0,-93.0,51.0,56.0,45.0,41.0,0
6581,92:69:1D:31:68:E9,3829985,486159430,3760,3581257,3826225,482578173,0,4216,1044756,4097,1018026,119,26730,2009,7,3899,80,0,36,229410.0,130000.0,-52.0,-47.0,-42.0,-49.0,-52.0,-49.0,-43.0,-48.0,-91.0,-93.0,-90.0,-93.0,39.0,46.0,48.0,44.0,0
6582,CC:2F:71:3F:1F:24,4472368,1186492679,646143,703914506,3826225,482578173,37,528129,565073326,527489,564996330,640,76996,510447,10,646380,64706,34,452,130000.0,43333.0,-67.0,-65.0,-70.0,-67.0,-66.0,-65.0,-70.0,-67.0,-91.0,-93.0,-90.0,-93.0,24.0,28.0,20.0,26.0,0
6583,CC:2F:71:3E:C5:1F,3827000,482672903,775,94730,3826225,482578173,0,3248,272684,2680,205216,568,67468,820,8,1116,18,0,37,130000.0,39000.0,-70.0,-71.0,-67.0,-60.0,-70.0,-70.0,-67.0,-59.0,-91.0,-93.0,-90.0,-93.0,21.0,22.0,23.0,33.0,0
6584,BA:8C:B9:54:50:24,3830962,488730324,4737,6152151,3826225,482578173,0,8391,1652350,8369,1648855,22,3495,2324,14,5122,36,0,53,229410.0,130000.0,-40.0,-37.0,-45.0,-52.0,-43.0,-36.0,-43.0,-49.0,-91.0,-93.0,-90.0,-93.0,51.0,56.0,45.0,41.0,0
6585,92:69:1D:31:68:E9,3829987,486159632,3760,3581257,3826227,482578375,0,4216,1044756,4097,1018026,119,26730,2009,7,3899,80,0,36,229410.0,130000.0,-52.0,-47.0,-42.0,-49.0,-52.0,-49.0,-43.0,-48.0,-91.0,-93.0,-90.0,-93.0,39.0,46.0,48.0,44.0,0
6586,CC:2F:71:3F:1F:24,4472414,1186507619,646187,703929244,3826227,482578375,37,528154,565078130,527514,565001134,640,76996,510472,10,646424,64712,34,452,117000.0,39000.0,-67.0,-65.0,-70.0,-68.0,-67.0,-65.0,-70.0,-67.0,-91.0,-93.0,-90.0,-93.0,24.0,28.0,20.0,25.0,0
6587,CC:2F:71:3E:C5:1F,3827002,482673105,775,94730,3826227,482578375,0,3248,272684,2680,205216,568,67468,820,8,1116,18,0,37,130000.0,39000.0,-70.0,-71.0,-67.0,-60.0,-70.0,-70.0,-67.0,-59.0,-91.0,-93.0,-90.0,-93.0,21.0,22.0,23.0,33.0,0
6588,BA:8C:B9:54:50:24,3830964,488730526,4737,6152151,3826227,482578375,0,8391,1652350,8369,1648855,22,3495,2324,14,5122,36,0,53,229410.0,130000.0,-40.0,-37.0,-45.0,-52.0,-43.0,-36.0,-43.0,-49.0,-91.0,-93.0,-90.0,-93.0,51.0,56.0,45.0,41.0,0
6589,92:69:1D:31:68:E9,3829994,486160298,3760,3581257,3826234,482579041,0,4216,1044756,4097,1018026,119,26730,2009,7,3899,80,0,36,229410.0,130000.0,-52.0,-47.0,-42.0,-49.0,-52.0,-49.0,-43.0,-48.0,-91.0,-93.0,-90.0,-93.0,39.0,46.0,48.0,44.0,0
6590,CC:2F:71:3F:1F:24,4472463,1186522657,646229,703943616,3826234,482579041,37,528180,565083074,527540,565006078,640,76996,510498,10,646466,64715,34,452,117000.0,39000.0,-67.0,-65.0,-70.0,-67.0,-67.0,-65.0,-70.0,-67.0,-91.0,-93.0,-90.0,-93.0,24.0,28.0,20.0,26.0,0
6591,CC:2F:71:3E:C5:1F,3827009,482673771,775,94730,3826234,482579041,0,3248,272684,2680,205216,568,67468,820,8,1116,18,0,37,130000.0,39000.0,-70.0,-71.0,-67.0,-60.0,-70.0,-70.0,-67.0,-59.0,-91.0,-93.0,-90.0,-93.0,21.0,22.0,23.0,33.0,0
6592,BA:8C:B9:54:50:24,3830971,488731192,4737,6152151,3826234,482579041,0,8391,1652350,8369,1648855,22,3495,2324,14,5122,36,0,53,229410.0,130000.0,-40.0,-37.0,-45.0,-52.0,-43.0,-36.0,-43.0,-49.0,-91.0,-93.0,-90.0,-93.0,51.0,56.0,45.0,41.0,0
6593,92:69:1D:31:68:E9,3829996,486160500,3760,3581257,3826236,482579243,0,4216,1044756,4097,1018026,119,26730,2009,7,3899,80,0,36,229410.0,130000.0,-52.0,-47.0,-42.0,-49.0,-52.0,-49.0,-43.0,-48.0,-91.0,-93.0,-90.0,-93.0,39.0,46.0,48.0,44.0,0
6594,CC:2F:71:3F:1F:24,4472507,1186537231,646271,703957988,3826236,482579243,37,528205,565087878,527565,565010882,640,76996,510523,10,646508,64730,34,452,130000.0,39000.0,-67.0,-65.0,-70.0,-67.0,-67.0,-65.0,-70.0,-67.0,-91.0,-93.0,-90.0,-93.0,24.0,28.0,20.0,26.0,0
6595,CC:2F:71:3E:C5:1F,3827011,482673973,775,94730,3826236,482579243,0,3248,272684,2680,205216,568,67468,820,8,1116,18,0,37,130000.0,39000.0,-70.0,-71.0,-67.0,-60.0,-70.0,-70.0,-67.0,-59.0,-91.0,-93.0,-90.0,-93.0,21.0,22.0,23.0,33.0,0
6596,BA:8C:B9:54:50:24,3830973,488731394,4737,6152151,3826236,482579243,0,8391,1652350,8369,1648855,22,3495,2324,14,5122,36,0,53,229410.0,130000.0,-40.0,-37.0,-45.0,-52.0,-43.0,-36.0,-43.0,-49.0,-91.0,-93.0,-90.0,-93.0,51.0,56.0,45.0,41.0,0
6597,92:69:1D:31:68:E9,3830002,486161106,3760,3581257,3826242,482579849,0,4216,1044756,4097,1018026,119,26730,2009,7,3899,80,0,36,229410.0,130000.0,-52.0,-47.0,-42.0,-49.0,-52.0,-49.0,-43.0,-48.0,-91.0,-93.0,-90.0,-93.0,39.0,46.0,48.0,44.0,0
6598,CC:2F:71:3F:1F:24,4472555,1186552265,646313,703972416,3826242,482579849,37,528232,565092938,527592,565015942,640,76996,510550,10,646550,64745,34,452,130000.0,39000.0,-67.0,-65.0,-70.0,-67.0,-67.0,-65.0,-70.0,-67.0,-91.0,-93.0,-90.0,-93.0,24.0,28.0,20.0,26.0,0
6599,CC:2F:71:3E:C5:1F,3827018,482674639,775,94730,3826243,482579909,0,3248,272684,2680,205216,568,67468,820,8,1116,18,0,37,130000.0,39000.0,-70.0,-71.0,-67.0,-60.0,-70.0,-70.0,-67.0,-59.0,-91.0,-93.0,-90.0,-93.0,21.0,22.0,23.0,33.0,0
6600,BA:8C:B9:54:50:24,3830980,488732060,4737,6152151,3826243,482579909,0,8391,1652350,8369,1648855,22,3495,2324,14,5122,36,0,53,229410.0,130000.0,-40.0,-37.0,-45.0,-52.0,-43.0,-36.0,-43.0,-49.0,-91.0,-93.0,-90.0,-93.0,51.0,56.0,45.0,41.0,0
6601,92:69:1D:31:68:E9,3830005,486161368,3760,3581257,3826245,482580111,0,4216,1044756,4097,1018026,119,26730,2009,7,3899,80,0,36,229410.0,130000.0,-52.0,-47.0,-42.0,-49.0,-52.0,-49.0,-43.0,-48.0,-91.0,-93.0,-90.0,-93.0,39.0,46.0,48.0,44.0,0
6602,CC:2F:71:3F:1F:24,4472600,1186567011,646355,703986900,3826245,482580111,37,528259,565097998,527619,565021002,640,76996,510577,10,646592,64746,34,452,130000.0,43333.0,-67.0,-65.0,-70.0,-67.0,-67.0,-65.0,-70.0,-67.0,-91.0,-93.0,-90.0,-93.0,24.0,28.0,20.0,26.0,0
6603,CC:2F:71:3E:C5:1F,3827020,482674841,775,94730,3826245,482580111,0,3248,272684,2680,205216,568,67468,820,8,1116,18,0,37,130000.0,39000.0,-70.0,-71.0,-67.0,-60.0,-70.0,-70.0,-67.0,-59.0,-91.0,-93.0,-90.0,-93.0,21.0,22.0,23.0,33.0,0
6604,BA:8C:B9:54:50:24,3830982,488732262,4737,6152151,3826245,482580111,0,8391,1652350,8369,1648855,22,3495,2324,14,5122,36,0,53,229410.0,130000.0,-40.0,-37.0,-45.0,-52.0,-43.0,-36.0,-43.0,-49.0,-91.0,-93.0,-90.0,-93.0,51.0,56.0,45.0,41.0,0
6605,92:69:1D:31:68:E9,3830011,486161974,3760,3581257,3826251,482580717,0,4216,1044756,4097,1018026,119,26730,2009,7,3899,80,0,36,229410.0,130000.0,-52.0,-47.0,-42.0,-49.0,-52.0,-49.0,-43.0,-48.0,-91.0,-93.0,-90.0,-93.0,39.0,46.0,48.0,44.0,0
6606,CC:2F:71:3F:1F:24,4472647,1186581971,646396,704001254,3826251,482580717,37,528285,565102942,527645,565025946,640,76996,510603,10,646633,64769,34,452,130000.0,39000.0,-67.0,-65.0,-70.0,-68.0,-67.0,-65.0,-70.0,-67.0,-91.0,-93.0,-90.0,-93.0,24.0,28.0,20.0,25.0,0
6607,CC:2F:71:3E:C5:1F,3827026,482675447,775,94730,3826251,482580717,0,3248,272684,2680,205216,568,67468,820,8,1116,18,0,37,130000.0,39000.0,-70.0,-71.0,-67.0,-60.0,-70.0,-70.0,-67.0,-59.0,-91.0,-93.0,-90.0,-93.0,21.0,22.0,23.0,33.0,0
6608,BA:8C:B9:54:50:24,3830988,488732868,4737,6152151,3826251,482580717,0,8391,1652350,8369,1648855,22,3495,2324,14,5122,36,0,53,229410.0,130000.0,-40.0,-37.0,-45.0,-52.0,-43.0,-36.0,-43.0,-49.0,-91.0,-93.0,-90.0,-93.0,51.0,56.0,45.0,41.0,0
6609,92:69:1D:31:68:E9,3830014,486162236,3760,3581257,3826254,482580979,0,4217,1044824,4098,1018094,119,26730,2009,7,3899,80,0,36,229410.0,130000.0,-52.0,-50.0,-44.0,-46.0,-52.0,-49.0,-43.0,-47.0,-91.0,-93.0,-90.0,-93.0,39.0,43.0,46.0,47.0,0
6610,CC:2F:71:3F:1F:24,4472690,1186596419,646436,704015440,3826254,482580979,37,528311,565107942,527671,565030946,640,76996,510629,10,646673,64784,34,452,130000.0,39000.0,-67.0,-65.0,-71.0,-67.0,-67.0,-65.0,-70.0,-67.0,-91.0,-93.0,-90.0,-93.0,24.0,28.0,19.0,26.0,0
6611,CC:2F:71:3E:C5:1F,3827029,482675709,775,94730,3826254,482580979,0,3248,272684,2680,205216,568,67468,820,8,1116,18,0,37,130000.0,39000.0,-70.0,-71.0,-67.0,-60.0,-70.0,-70.0,-67.0,-59.0,-91.0,-93.0,-90.0,-93.0,21.0,22.0,23.0,33.0,0
6612,BA:8C:B9:54:50:24,3830991,488733130,4737,6152151,3826254,482580979,0,8391,1652350,8369,1648855,22,3495,2324,14,5122,36,0,53,229410.0,130000.0,-40.0,-37.0,-45.0,-52.0,-43.0,-36.0,-43.0,-49.0,-91.0,-93.0,-90.0,-93.0,51.0,56.0,45.0,41.0,0
6613,92:69:1D:31:68:E9,3830020,486162842,3760,3581257,3826260,482581585,0,4217,1044824,4098,1018094,119,26730,2009,7,3899,80,0,36,229410.0,130000.0,-52.0,-50.0,-44.0,-46.0,-52.0,-49.0,-43.0,-47.0,-91.0,-93.0,-90.0,-93.0,39.0,43.0,46.0,47.0,0
6614,CC:2F:71:3F:1F:24,4472738,1186611509,646478,704029924,3826260,482581585,37,528338,565112978,527698,565035982,640,76996,510656,10,646715,64791,34,452,130000.0,43333.0,-67.0,-65.0,-70.0,-67.0,-67.0,-65.0,-70.0,-67.0,-91.0,-93.0,-90.0,-93.0,24.0,28.0,20.0,26.0,0
6615,CC:2F:71:3E:C5:1F,3827035,482676315,775,94730,3826260,482581585,0,3248,272684,2680,205216,568,67468,820,8,1116,18,0,37,130000.0,39000.0,-70.0,-71.0,-67.0,-60.0,-70.0,-70.0,-67.0,-59.0,-91.0,-93.0,-90.0,-93.0,21.0,22.0,23.0,33.0,0
6616,BA:8C:B9:54:50:24,3830997,488733736,4737,6152151,3826260,482581585,0,8391,1652350,8369,1648855,22,3495,2324,14,5122,36,0,53,229410.0,130000.0,-40.0,-37.0,-45.0,-52.0,-43.0,-36.0,-43.0,-49.0,-91.0,-93.0,-90.0,-93.0,51.0,56.0,45.0,41.0,0
6617,92:69:1D:31:68:E9,3830022,486163044,3760,3581257,3826262,482581787,0,4217,1044824,4098,1018094,119,26730,2009,7,3899,80,0,36,229410.0,130000.0,-52.0,-50.0,-44.0,-46.0,-52.0,-49.0,-43.0,-47.0,-91.0,-93.0,-90.0,-93.0,39.0,43.0,46.0,47.0,0
6618,CC:2F:71:3F:1F:24,4472782,1186626195,646520,704044408,3826262,482581787,37,528363,565117782,527723,565040786,640,76996,510681,10,646757,64810,34,452,130000.0,39000.0,-67.0,-65.0,-70.0,-67.0,-67.0,-65.0,-70.0,-67.0,-91.0,-93.0,-90.0,-93.0,24.0,28.0,20.0,26.0,0
6619,CC:2F:71:3E:C5:1F,3827037,482676517,775,94730,3826262,482581787,0,3248,272684,2680,205216,568,67468,820,8,1116,18,0,37,130000.0,39000.0,-70.0,-71.0,-67.0,-60.0,-70.0,-70.0,-67.0,-59.0,-91.0,-93.0,-90.0,-93.0,21.0,22.0,23.0,33.0,0
6620,BA:8C:B9:54:50:24,3830999,488733938,4737,6152151,3826262,482581787,0,8391,1652350,8369,1648855,22,3495,2324,14,5122,36,0,53,229410.0,130000.0,-40.0,-37.0,-45.0,-52.0,-43.0,-36.0,-43.0,-49.0,-91.0,-93.0,-90.0,-93.0,51.0,56.0,45.0,41.0,0
6621,92:69:1D:31:68:E9,3830029,486163710,3760,3581257,3826269,482582453,0,4217,1044824,4098,1018094,119,26730,2009,7,3899,80,0,36,229410.0,130000.0,-52.0,-50.0,-44.0,-46.0,-52.0,-49.0,-43.0,-47.0,-90.0,-93.0,-90.0,-93.0,38.0,43.0,46.0,47.0,0
6622,CC:2F:71:3F:1F:24,4472831,1186641233,646562,704058780,3826269,482582453,37,528389,565122726,527749,565045730,640,76996,510707,10,646799,64820,34,452,130000.0,43333.0,-67.0,-65.0,-71.0,-68.0,-67.0,-65.0,-70.0,-67.0,-90.0,-93.0,-90.0,-93.0,23.0,28.0,19.0,25.0,0
6623,CC:2F:71:3E:C5:1F,3827044,482677183,775,94730,3826269,482582453,0,3248,272684,2680,205216,568,67468,820,8,1116,18,0,37,130000.0,39000.0,-70.0,-71.0,-67.0,-60.0,-70.0,-70.0,-67.0,-59.0,-90.0,-93.0,-90.0,-93.0,20.0,22.0,23.0,33.0,0
6624,BA:8C:B9:54:50:24,3831006,488734604,4737,6152151,3826269,482582453,0,8391,1652350,8369,1648855,22,3495,2324,14,5122,36,0,53,229410.0,130000.0,-40.0,-37.0,-45.0,-52.0,-43.0,-36.0,-43.0,-49.0,-90.0,-93.0,-90.0,-93.0,50.0,56.0,45.0,41.0,0
6625,92:69:1D:31:68:E9,3830032,486164028,3761,3581373,3826271,482582655,0,4219,1044960,4100,1018230,119,26730,2009,7,3900,80,0,36,229410.0,130000.0,-51.0,-51.0,-45.0,-48.0,-51.0,-49.0,-43.0,-48.0,-90.0,-93.0,-90.0,-93.0,39.0,42.0,45.0,45.0,0
6626,CC:2F:71:3F:1F:24,4472875,1186655911,646604,704073256,3826271,482582655,37,528415,565127670,527775,565050674,640,76996,510733,10,646841,64827,34,452,130000.0,39000.0,-67.0,-65.0,-70.0,-67.0,-67.0,-65.0,-70.0,-67.0,-90.0,-93.0,-90.0,-93.0,23.0,28.0,20.0,26.0,0
6627,CC:2F:71:3E:C5:1F,3827047,482677501,776,94846,3826271,482582655,0,3250,272824,2682,205356,568,67468,820,8,1117,18,0,37,144444.0,39000.0,-79.0,-85.0,-76.0,-71.0,-71.0,-72.0,-68.0,-61.0,-90.0,-93.0,-90.0,-93.0,11.0,8.0,14.0,22.0,0
6628,BA:8C:B9:54:50:24,3831009,488734922,4738,6152267,3826271,482582655,0,8393,1652486,8371,1648991,22,3495,2324,14,5123,36,0,53,229410.0,130000.0,-40.0,-36.0,-45.0,-51.0,-42.0,-36.0,-44.0,-49.0,-90.0,-93.0,-90.0,-93.0,50.0,57.0,45.0,42.0,0
6629,92:69:1D:31:68:E9,3830039,486164907,3761,3581373,3826278,482583534,0,4219,1044960,4100,1018230,119,26730,2009,7,3900,80,0,36,229410.0,130000.0,-51.0,-51.0,-45.0,-48.0,-51.0,-49.0,-43.0,-48.0,-90.0,-93.0,-90.0,-93.0,39.0,42.0,45.0,45.0,0
6630,CC:2F:71:3F:1F:24,4472924,1186671210,646645,704087616,3826279,482583594,37,528440,565132474,527800,565055478,640,76996,510758,10,646882,64853,34,452,117000.0,39000.0,-67.0,-65.0,-71.0,-67.0,-67.0,-65.0,-70.0,-67.0,-90.0,-93.0,-90.0,-93.0,23.0,28.0,19.0,26.0,0
6631,CC:2F:71:3E:C5:1F,3827055,482678440,776,94846,3826279,482583594,0,3250,272824,2682,205356,568,67468,820,8,1117,18,0,37,144444.0,39000.0,-79.0,-85.0,-76.0,-71.0,-71.0,-72.0,-68.0,-61.0,-90.0,-93.0,-90.0,-93.0,11.0,8.0,14.0,22.0,0
6632,BA:8C:B9:54:50:24,3831017,488735861,4738,6152267,3826279,482583594,0,8393,1652486,8371,1648991,22,3495,2324,14,5123,36,0,53,229410.0,130000.0,-40.0,-36.0,-45.0,-51.0,-42.0,-36.0,-44.0,-49.0,-90.0,-93.0,-90.0,-93.0,50.0,57.0,45.0,42.0,0
6633,92:69:1D:31:68:E9,3830042,486165169,3761,3581373,3826281,482583796,0,4219,1044960,4100,1018230,119,26730,2009,7,3900,80,0,36,229410.0,130000.0,-51.0,-51.0,-45.0,-48.0,-51.0,-49.0,-43.0,-48.0,-90.0,-93.0,-90.0,-93.0,39.0,42.0,45.0,45.0,0
6634,CC:2F:71:3F:1F:24,4472968,1186685840,646687,704102044,3826281,482583796,37,528467,565137534,527827,565060538,640,76996,510785,10,646924,64857,34,452,130000.0,43333.0,-67.0,-65.0,-71.0,-68.0,-67.0,-65.0,-70.0,-67.0,-90.0,-93.0,-90.0,-93.0,23.0,28.0,19.0,25.0,0
6635,CC:2F:71:3E:C5:1F,3827057,482678642,776,94846,3826281,482583796,0,3250,272824,2682,205356,568,67468,820,8,1117,18,0,37,144444.0,39000.0,-79.0,-85.0,-76.0,-71.0,-71.0,-72.0,-68.0,-61.0,-90.0,-93.0,-90.0,-93.0,11.0,8.0,14.0,22.0,0
6636,BA:8C:B9:54:50:24,3831019,488736063,4738,6152267,3826281,482583796,0,8393,1652486,8371,1648991,22,3495,2324,14,5123,36,0,53,229410.0,130000.0,-40.0,-36.0,-45.0,-51.0,-42.0,-36.0,-44.0,-49.0,-90.0,-93.0,-90.0,-93.0,50.0,57.0,45.0,42.0,0
6637,92:69:1D:31:68:E9,3830049,486165837,3761,3581373,3826288,482584464,0,4219,1044960,4100,1018230,119,26730,2009,7,3900,80,0,36,229410.0,130000.0,-51.0,-51.0,-45.0,-48.0,-51.0,-49.0,-43.0,-48.0,-90.0,-93.0,-90.0,-93.0,39.0,42.0,45.0,45.0,0
6638,CC:2F:71:3F:1F:24,4473018,1186701060,646730,704116596,3826288,482584464,37,528494,565142570,527854,565065574,640,76996,510812,10,646967,64873,34,452,117000.0,39000.0,-67.0,-65.0,-70.0,-68.0,-67.0,-65.0,-70.0,-67.0,-90.0,-93.0,-90.0,-93.0,23.0,28.0,20.0,25.0,0
6639,CC:2F:71:3E:C5:1F,3827064,482679310,776,94846,3826288,482584464,0,3252,273012,2683,205426,569,67586,821,8,1117,18,0,37,144444.0,39000.0,-70.0,-71.0,-67.0,-60.0,-71.0,-72.0,-68.0,-61.0,-90.0,-93.0,-90.0,-93.0,20.0,22.0,23.0,33.0,0
6640,BA:8C:B9:54:50:24,3831026,488736731,4738,6152267,3826288,482584464,0,8393,1652486,8371,1648991,22,3495,2324,14,5123,36,0,53,229410.0,130000.0,-40.0,-36.0,-45.0,-51.0,-42.0,-36.0,-44.0,-49.0,-90.0,-93.0,-90.0,-93.0,50.0,57.0,45.0,42.0,0
6641,92:69:1D:31:68:E9,3830054,486166467,3761,3581373,3826293,482585094,0,4219,1044960,4100,1018230,119,26730,2009,7,3900,80,0,36,229410.0,130000.0,-51.0,-51.0,-45.0,-48.0,-51.0,-49.0,-43.0,-48.0,-90.0,-93.0,-90.0,-93.0,39.0,42.0,45.0,45.0,0
6642,CC:2F:71:3F:1F:24,4473065,1186716118,646772,704131024,3826293,482585094,37,528521,565147666,527881,565070670,640,76996,510839,10,647009,64879,34,452,130000.0,43333.0,-67.0,-65.0,-70.0,-67.0,-67.0,-65.0,-70.0,-67.0,-90.0,-93.0,-90.0,-93.0,23.0,28.0,20.0,26.0,0
6643,CC:2F:71:3E:C5:1F,3827069,482679940,776,94846,3826293,482585094,0,3252,273012,2683,205426,569,67586,821,8,1117,18,0,37,144444.0,39000.0,-70.0,-71.0,-67.0,-60.0,-71.0,-72.0,-68.0,-61.0,-90.0,-93.0,-90.0,-93.0,20.0,22.0,23.0,33.0,0
6644,BA:8C:B9:54:50:24,3831031,488737361,4738,6152267,3826293,482585094,0,8393,1652486,8371,1648991,22,3495,2324,14,5123,36,0,53,229410.0,130000.0,-40.0,-36.0,-45.0,-51.0,-42.0,-36.0,-44.0,-49.0,-90.0,-93.0,-90.0,-93.0,50.0,57.0,45.0,42.0,0
6645,92:69:1D:31:68:E9,3830060,486167073,3761,3581373,3826299,482585700,0,4219,1044960,4100,1018230,119,26730,2009,7,3900,80,0,36,229410.0,130000.0,-51.0,-51.0,-45.0,-48.0,-51.0,-49.0,-43.0,-48.0,-90.0,-93.0,-90.0,-93.0,39.0,42.0,45.0,45.0,0
6646,CC:2F:71:3F:1F:24,4473112,1186731084,646813,704145384,3826299,482585700,37,528547,565152610,527907,565075614,640,76996,510865,10,647050,64894,34,452,130000.0,39000.0,-67.0,-65.0,-70.0,-68.0,-67.0,-65.0,-70.0,-67.0,-90.0,-93.0,-90.0,-93.0,23.0,28.0,20.0,25.0,0
6647,CC:2F:71:3E:C5:1F,3827075,482680546,776,94846,3826299,482585700,0,3252,273012,2683,205426,569,67586,821,8,1117,18,0,37,144444.0,39000.0,-70.0,-71.0,-67.0,-60.0,-71.0,-72.0,-68.0,-61.0,-90.0,-93.0,-90.0,-93.0,20.0,22.0,23.0,33.0,0
6648,BA:8C:B9:54:50:24,3831037,488737967,4738,6152267,3826299,482585700,0,8393,1652486,8371,1648991,22,3495,2324,14,5123,36,0,53,229410.0,130000.0,-40.0,-36.0,-45.0,-51.0,-42.0,-36.0,-44.0,-49.0,-90.0,-93.0,-90.0,-93.0,50.0,57.0,45.0,42.0,0
6649,92:69:1D:31:68:E9,3830062,486167275,3761,3581373,3826301,482585902,0,4221,1045096,4102,1018366,119,26730,2009,7,3901,80,0,37,229410.0,130000.0,-52.0,-50.0,-44.0,-46.0,-51.0,-48.0,-43.0,-48.0,-90.0,-93.0,-90.0,-93.0,38.0,43.0,46.0,47.0,0
6650,CC:2F:71:3F:1F:24,4473158,1186745998,646857,704160096,3826301,482585902,37,528573,565157518,527933,565080522,640,76996,510891,10,647094,64928,34,452,144444.0,43333.0,-67.0,-65.0,-70.0,-67.0,-67.0,-65.0,-70.0,-67.0,-90.0,-93.0,-90.0,-93.0,23.0,28.0,20.0,26.0,0
6651,CC:2F:71:3E:C5:1F,3827077,482680748,776,94846,3826301,482585902,0,3252,273012,2683,205426,569,67586,821,8,1117,18,0,37,144444.0,39000.0,-70.0,-71.0,-67.0,-60.0,-71.0,-72.0,-68.0,-61.0,-90.0,-93.0,-90.0,-93.0,20.0,22.0,23.0,33.0,0
6652,BA:8C:B9:54:50:24,3831039,488738169,4738,6152267,3826301,482585902,0,8395,1652622,8373,1649127,22,3495,2324,14,5124,36,0,53,229410.0,130000.0,-40.0,-37.0,-45.0,-52.0,-42.0,-36.0,-43.0,-49.0,-90.0,-93.0,-90.0,-93.0,50.0,56.0,45.0,41.0,0
6653,92:69:1D:31:68:E9,3830069,486167941,3761,3581373,3826308,482586568,0,4221,1045096,4102,1018366,119,26730,2009,7,3901,80,0,37,229410.0,130000.0,-52.0,-50.0,-44.0,-46.0,-51.0,-48.0,-43.0,-48.0,-90.0,-93.0,-90.0,-93.0,38.0,43.0,46.0,47.0,0
6654,CC:2F:71:3F:1F:24,4473207,1186761148,646899,704174580,3826308,482586568,37,528600,565162578,527960,565085582,640,76996,510918,10,647136,64939,34,452,130000.0,43333.0,-67.0,-65.0,-70.0,-68.0,-67.0,-65.0,-70.0,-67.0,-90.0,-93.0,-90.0,-93.0,23.0,28.0,20.0,25.0,0
6655,CC:2F:71:3E:C5:1F,3827084,482681414,776,94846,3826308,482586568,0,3252,273012,2683,205426,569,67586,821,8,1117,18,0,37,144444.0,39000.0,-70.0,-71.0,-67.0,-60.0,-71.0,-72.0,-68.0,-61.0,-90.0,-93.0,-90.0,-93.0,20.0,22.0,23.0,33.0,0
6656,BA:8C:B9:54:50:24,3831046,488738835,4738,6152267,3826308,482586568,0,8395,1652622,8373,1649127,22,3495,2324,14,5124,36,0,53,229410.0,130000.0,-40.0,-37.0,-45.0,-52.0,-42.0,-36.0,-43.0,-49.0,-90.0,-93.0,-90.0,-93.0,50.0,56.0,45.0,41.0,0
6657,92:69:1D:31:68:E9,3830071,486168143,3761,3581373,3826310,482586770,0,4221,1045096,4102,1018366,119,26730,2009,7,3901,80,0,37,229410.0,130000.0,-52.0,-50.0,-44.0,-46.0,-51.0,-48.0,-43.0,-48.0,-90.0,-93.0,-90.0,-93.0,38.0,43.0,46.0,47.0,0
6658,CC:2F:71:3F:1F:24,4473250,1186775710,646940,704188940,3826310,482586770,37,528627,565167638,527987,565090642,640,76996,510945,10,647177,64949,34,452,130000.0,39000.0,-67.0,-65.0,-70.0,-68.0,-67.0,-65.0,-70.0,-67.0,-90.0,-93.0,-90.0,-93.0,23.0,28.0,20.0,25.0,0
6659,CC:2F:71:3E:C5:1F,3827086,482681616,776,94846,3826310,482586770,0,3252,273012,2683,205426,569,67586,821,8,1117,18,0,37,144444.0,39000.0,-70.0,-71.0,-67.0,-60.0,-71.0,-72.0,-68.0,-61.0,-90.0,-93.0,-90.0,-93.0,20.0,22.0,23.0,33.0,0
6660,BA:8C:B9:54:50:24,3831048,488739037,4738,6152267,3826310,482586770,0,8395,1652622,8373,1649127,22,3495,2324,14,5124,36,0,53,229410.0,130000.0,-40.0,-37.0,-45.0,-52.0,-42.0,-36.0,-43.0,-49.0,-90.0,-93.0,-90.0,-93.0,50.0,56.0,45.0,41.0,0
6661,92:69:1D:31:68:E9,3830078,486168809,3761,3581373,3826317,482587436,0,4221,1045096,4102,1018366,119,26730,2009,7,3901,80,0,37,229410.0,130000.0,-52.0,-50.0,-44.0,-46.0,-51.0,-48.0,-43.0,-48.0,-90.0,-93.0,-90.0,-93.0,38.0,43.0,46.0,47.0,0
6662,CC:2F:71:3F:1F:24,4473300,1186790934,646983,704203498,3826317,482587436,37,528653,565172582,528013,565095586,640,76996,510971,10,647220,64964,34,452,130000.0,43333.0,-67.0,-65.0,-70.0,-67.0,-67.0,-65.0,-70.0,-67.0,-90.0,-93.0,-90.0,-93.0,23.0,28.0,20.0,26.0,0
6663,CC:2F:71:3E:C5:1F,3827093,482682282,776,94846,3826317,482587436,0,3252,273012,2683,205426,569,67586,821,8,1117,18,0,37,144444.0,39000.0,-70.0,-71.0,-67.0,-60.0,-71.0,-72.0,-68.0,-61.0,-90.0,-93.0,-90.0,-93.0,20.0,22.0,23.0,33.0,0
6664,BA:8C:B9:54:50:24,3831055,488739703,4738,6152267,3826317,482587436,0,8395,1652622,8373,1649127,22,3495,2324,14,5124,36,0,53,229410.0,130000.0,-40.0,-37.0,-45.0,-52.0,-42.0,-36.0,-43.0,-49.0,-90.0,-93.0,-90.0,-93.0,50.0,56.0,45.0,41.0,0
6665,92:69:1D:31:68:E9,3830080,486169011,3761,3581373,3826319,482587638,0,4221,1045096,4102,1018366,119,26730,2009,7,3901,80,0,37,229410.0,130000.0,-52.0,-50.0,-44.0,-46.0,-51.0,-48.0,-43.0,-48.0,-90.0,-93.0,-90.0,-93.0,38.0,43.0,46.0,47.0,0
6666,CC:2F:71:3F:1F:24,4473343,1186805384,647024,704217746,3826319,482587638,37,528680,565177642,528040,565100646,640,76996,510998,10,647261,64980,34,452,130000.0,39000.0,-67.0,-65.0,-71.0,-67.0,-67.0,-65.0,-70.0,-67.0,-90.0,-93.0,-90.0,-93.0,23.0,28.0,19.0,26.0,0
6667,CC:2F:71:3E:C5:1F,3827095,482682484,776,94846,3826319,482587638,0,3252,273012,2683,205426,569,67586,821,8,1117,18,0,37,144444.0,39000.0,-70.0,-71.0,-67.0,-60.0,-71.0,-72.0,-68.0,-61.0,-90.0,-93.0,-90.0,-93.0,20.0,22.0,23.0,33.0,0
6668,BA:8C:B9:54:50:24,3831057,488739905,4738,6152267,3826319,482587638,0,8395,1652622,8373,1649127,22,3495,2324,14,5124,36,0,53,229410.0,130000.0,-40.0,-37.0,-45.0,-52.0,-42.0,-36.0,-43.0,-49.0,-90.0,-93.0,-90.0,-93.0,50.0,56.0,45.0,41.0,0
6669,92:69:1D:31:68:E9,3830087,486169679,3761,3581373,3826326,482588306,0,4221,1045096,4102,1018366,119,26730,2009,7,3901,80,0,37,229410.0,130000.0,-52.0,-50.0,-44.0,-46.0,-51.0,-48.0,-43.0,-48.0,-90.0,-93.0,-90.0,-93.0,38.0,43.0,46.0,47.0,0
6670,CC:2F:71:3F:1F:24,4473393,1186820548,647067,704232242,3826326,482588306,37,528706,565182564,528065,565105450,641,77114,511024,10,647304,64993,34,452,130000.0,39000.0,-67.0,-65.0,-70.0,-68.0,-67.0,-65.0,-70.0,-67.0,-90.0,-93.0,-90.0,-93.0,23.0,28.0,20.0,25.0,0
6671,CC:2F:71:3E:C5:1F,3827102,482683152,776,94846,3826326,482588306,0,3252,273012,2683,205426,569,67586,821,8,1117,18,0,37,144444.0,39000.0,-70.0,-71.0,-67.0,-60.0,-71.0,-72.0,-68.0,-61.0,-90.0,-93.0,-90.0,-93.0,20.0,22.0,23.0,33.0,0
6672,BA:8C:B9:54:50:24,3831064,488740573,4738,6152267,3826326,482588306,0,8395,1652622,8373,1649127,22,3495,2324,14,5124,36,0,53,229410.0,130000.0,-40.0,-37.0,-45.0,-52.0,-42.0,-36.0,-43.0,-49.0,-90.0,-93.0,-90.0,-93.0,50.0,56.0,45.0,41.0,0
6673,92:69:1D:31:68:E9,3830088,486169739,3761,3581373,3826327,482588366,0,4221,1045096,4102,1018366,119,26730,2009,7,3901,80,0,37,229410.0,130000.0,-52.0,-50.0,-44.0,-46.0,-51.0,-48.0,-43.0,-48.0,-90.0,-93.0,-90.0,-93.0,38.0,43.0,46.0,47.0,0
6674,CC:2F:71:3F:1F:24,4473438,1186835182,647109,704246614,3826329,482588568,37,528735,565187856,528094,565110742,641,77114,511053,10,647346,65010,34,452,130000.0,43333.0,-67.0,-65.0,-70.0,-68.0,-67.0,-65.0,-70.0,-67.0,-90.0,-93.0,-90.0,-93.0,23.0,28.0,20.0,25.0,0
6675,CC:2F:71:3E:C5:1F,3827105,482683414,776,94846,3826329,482588568,0,3252,273012,2683,205426,569,67586,821,8,1117,18,0,37,144444.0,39000.0,-70.0,-71.0,-67.0,-60.0,-71.0,-72.0,-68.0,-61.0,-90.0,-93.0,-90.0,-93.0,20.0,22.0,23.0,33.0,0
6676,BA:8C:B9:54:50:24,3831067,488740835,4738,6152267,3826329,482588568,0,8395,1652622,8373,1649127,22,3495,2324,14,5124,36,0,53,229410.0,130000.0,-40.0,-37.0,-45.0,-52.0,-42.0,-36.0,-43.0,-49.0,-90.0,-93.0,-90.0,-93.0,50.0,56.0,45.0,41.0,0
6677,92:69:1D:31:68:E9,3830096,486170547,3761,3581373,3826335,482589174,0,4221,1045096,4102,1018366,119,26730,2009,7,3901,80,0,37,229410.0,130000.0,-52.0,-50.0,-44.0,-46.0,-51.0,-48.0,-43.0,-48.0,-90.0,-93.0,-90.0,-93.0,38.0,43.0,46.0,47.0,0
6678,CC:2F:71:3F:1F:24,4473487,1186850452,647152,704261278,3826335,482589174,37,528760,565192660,528119,565115546,641,77114,511078,10,647389,65013,34,452,130000.0,43333.0,-67.0,-65.0,-71.0,-68.0,-67.0,-65.0,-70.0,-67.0,-90.0,-93.0,-90.0,-93.0,23.0,28.0,19.0,25.0,0
6679,CC:2F:71:3E:C5:1F,3827111,482684020,776,94846,3826335,482589174,0,3252,273012,2683,205426,569,67586,821,8,1117,18,0,37,144444.0,39000.0,-70.0,-71.0,-67.0,-60.0,-71.0,-72.0,-68.0,-61.0,-90.0,-93.0,-90.0,-93.0,20.0,22.0,23.0,33.0,0
6680,BA:8C:B9:54:50:24,3831073,488741441,4738,6152267,3826335,482589174,0,8395,1652622,8373,1649127,22,3495,2324,14,5124,36,0,53,229410.0,130000.0,-40.0,-37.0,-45.0,-52.0,-42.0,-36.0,-43.0,-49.0,-90.0,-93.0,-90.0,-93.0,50.0,56.0,45.0,41.0,0
6681,92:69:1D:31:68:E9,3830097,486170820,3761,3581373,3826336,482589447,0,4221,1045096,4102,1018366,119,26730,2009,7,3901,80,0,37,229410.0,130000.0,-52.0,-50.0,-44.0,-46.0,-51.0,-48.0,-43.0,-48.0,-90.0,-93.0,-90.0,-93.0,38.0,43.0,46.0,47.0,0
6682,CC:2F:71:3F:1F:24,4473529,1186865017,647193,704275570,3826336,482589447,37,528789,565198000,528148,565120886,641,77114,511107,10,647430,65026,34,452,117000.0,39000.0,-67.0,-65.0,-70.0,-67.0,-67.0,-65.0,-70.0,-67.0,-90.0,-93.0,-90.0,-93.0,23.0,28.0,20.0,26.0,0
6683,CC:2F:71:3E:C5:1F,3827114,482684495,776,94846,3826338,482589649,0,3252,273012,2683,205426,569,67586,821,8,1117,18,0,37,144444.0,39000.0,-70.0,-71.0,-67.0,-60.0,-71.0,-72.0,-68.0,-61.0,-90.0,-93.0,-90.0,-93.0,20.0,22.0,23.0,33.0,0
6684,BA:8C:B9:54:50:24,3831077,488741976,4738,6152267,3826339,482589709,0,8395,1652622,8373,1649127,22,3495,2324,14,5124,36,0,53,229410.0,130000.0,-40.0,-37.0,-45.0,-52.0,-42.0,-36.0,-43.0,-49.0,-90.0,-93.0,-90.0,-93.0,50.0,56.0,45.0,41.0,0
6685,92:69:1D:31:68:E9,3830106,486171688,3761,3581373,3826345,482590315,0,4221,1045096,4102,1018366,119,26730,2009,7,3901,80,0,37,229410.0,130000.0,-52.0,-50.0,-44.0,-46.0,-51.0,-48.0,-43.0,-48.0,-90.0,-93.0,-90.0,-93.0,38.0,43.0,46.0,47.0,0
6686,CC:2F:71:3F:1F:24,4473579,1186880189,647234,704289874,3826345,482590315,37,528816,565203060,528175,565125946,641,77114,511134,10,647471,65029,34,452,130000.0,43333.0,-67.0,-65.0,-70.0,-67.0,-67.0,-65.0,-70.0,-67.0,-90.0,-93.0,-90.0,-93.0,23.0,28.0,20.0,26.0,0
6687,CC:2F:71:3E:C5:1F,3827121,482685161,776,94846,3826345,482590315,0,3252,273012,2683,205426,569,67586,821,8,1117,18,0,37,144444.0,39000.0,-70.0,-71.0,-67.0,-60.0,-71.0,-72.0,-68.0,-61.0,-90.0,-93.0,-90.0,-93.0,20.0,22.0,23.0,33.0,0
6688,BA:8C:B9:54:50:24,3831083,488742582,4738,6152267,3826345,482590315,0,8396,1652690,8374,1649195,22,3495,2324,14,5124,36,0,53,229410.0,130000.0,-39.0,-36.0,-44.0,-52.0,-40.0,-36.0,-44.0,-50.0,-90.0,-93.0,-90.0,-93.0,51.0,57.0,46.0,41.0,0
6689,92:69:1D:31:68:E9,3830106,486171688,3761,3581373,3826345,482590315,0,4221,1045096,4102,1018366,119,26730,2009,7,3901,80,0,37,229410.0,130000.0,-52.0,-50.0,-44.0,-46.0,-51.0,-48.0,-43.0,-48.0,-90.0,-93.0,-90.0,-93.0,38.0,43.0,46.0,47.0,0
6690,CC:2F:71:3F:1F:24,4473622,1186894797,647277,704304482,3826345,482590315,37,528841,565207864,528200,565130750,641,77114,511159,10,647514,65046,34,452,130000.0,39000.0,-67.0,-65.0,-70.0,-68.0,-67.0,-65.0,-70.0,-67.0,-90.0,-93.0,-90.0,-93.0,23.0,28.0,20.0,25.0,0
6691,CC:2F:71:3E:C5:1F,3827123,482685363,776,94846,3826347,482590517,0,3252,273012,2683,205426,569,67586,821,8,1117,18,0,37,144444.0,39000.0,-70.0,-71.0,-67.0,-60.0,-71.0,-72.0,-68.0,-61.0,-90.0,-93.0,-90.0,-93.0,20.0,22.0,23.0,33.0,0
6692,BA:8C:B9:54:50:24,3831085,488742784,4738,6152267,3826347,482590517,0,8396,1652690,8374,1649195,22,3495,2324,14,5124,36,0,53,229410.0,130000.0,-39.0,-36.0,-44.0,-52.0,-40.0,-36.0,-44.0,-50.0,-90.0,-93.0,-90.0,-93.0,51.0,57.0,46.0,41.0,0
6693,92:69:1D:31:68:E9,3830115,486172556,3761,3581373,3826354,482591183,0,4221,1045096,4102,1018366,119,26730,2009,7,3901,80,0,37,229410.0,130000.0,-52.0,-50.0,-44.0,-46.0,-51.0,-48.0,-43.0,-48.0,-90.0,-93.0,-90.0,-93.0,38.0,43.0,46.0,47.0,0
6694,CC:2F:71:3F:1F:24,4473673,1186910093,647319,704318910,3826354,482591183,37,528866,565212668,528225,565135554,641,77114,511184,10,647556,65054,34,452,130000.0,43333.0,-67.0,-65.0,-70.0,-68.0,-67.0,-65.0,-70.0,-67.0,-90.0,-93.0,-90.0,-93.0,23.0,28.0,20.0,25.0,0
6695,CC:2F:71:3E:C5:1F,3827130,482686029,776,94846,3826354,482591183,0,3252,273012,2683,205426,569,67586,821,8,1117,18,0,37,144444.0,39000.0,-70.0,-71.0,-67.0,-60.0,-71.0,-72.0,-68.0,-61.0,-90.0,-93.0,-90.0,-93.0,20.0,22.0,23.0,33.0,0
6696,BA:8C:B9:54:50:24,3831092,488743450,4738,6152267,3826354,482591183,0,8396,1652690,8374,1649195,22,3495,2324,14,5124,36,0,53,229410.0,130000.0,-39.0,-36.0,-44.0,-52.0,-40.0,-36.0,-44.0,-50.0,-90.0,-93.0,-90.0,-93.0,51.0,57.0,46.0,41.0,0
6697,92:69:1D:31:68:E9,3830115,486172556,3761,3581373,3826354,482591183,0,4221,1045096,4102,1018366,119,26730,2009,7,3901,80,0,37,229410.0,130000.0,-52.0,-50.0,-44.0,-46.0,-51.0,-48.0,-43.0,-48.0,-90.0,-93.0,-90.0,-93.0,38.0,43.0,46.0,47.0,0
6698,CC:2F:71:3F:1F:24,4473714,1186924453,647360,704333270,3826354,482591183,37,528893,565217728,528252,565140614,641,77114,511211,10,647597,65057,34,452,130000.0,43333.0,-67.0,-65.0,-70.0,-67.0,-67.0,-65.0,-70.0,-67.0,-90.0,-93.0,-90.0,-93.0,23.0,28.0,20.0,26.0,0
6699,CC:2F:71:3E:C5:1F,3827132,482686231,776,94846,3826356,482591385,0,3252,273012,2683,205426,569,67586,821,8,1117,18,0,37,144444.0,39000.0,-70.0,-71.0,-67.0,-60.0,-71.0,-72.0,-68.0,-61.0,-90.0,-93.0,-90.0,-93.0,20.0,22.0,23.0,33.0,0
6700,BA:8C:B9:54:50:24,3831094,488743652,4738,6152267,3826356,482591385,0,8396,1652690,8374,1649195,22,3495,2324,14,5124,36,0,53,229410.0,130000.0,-39.0,-36.0,-44.0,-52.0,-40.0,-36.0,-44.0,-50.0,-90.0,-93.0,-90.0,-93.0,51.0,57.0,46.0,41.0,0
6701,92:69:1D:31:68:E9,3830123,486173364,3761,3581373,3826362,482591991,0,4221,1045096,4102,1018366,119,26730,2009,7,3901,80,0,37,229410.0,130000.0,-52.0,-50.0,-44.0,-46.0,-51.0,-48.0,-43.0,-48.0,-90.0,-93.0,-90.0,-93.0,38.0,43.0,46.0,47.0,0
6702,CC:2F:71:3F:1F:24,4473765,1186939813,647403,704347822,3826362,482591991,37,528919,565222672,528278,565145558,641,77114,511237,10,647640,65081,34,452,117000.0,39000.0,-67.0,-65.0,-70.0,-68.0,-67.0,-65.0,-70.0,-67.0,-90.0,-93.0,-90.0,-93.0,23.0,28.0,20.0,25.0,0
6703,CC:2F:71:3E:C5:1F,3827138,482686837,776,94846,3826362,482591991,0,3252,273012,2683,205426,569,67586,821,8,1117,18,0,37,144444.0,39000.0,-70.0,-71.0,-67.0,-60.0,-71.0,-72.0,-68.0,-61.0,-90.0,-93.0,-90.0,-93.0,20.0,22.0,23.0,33.0,0
6704,BA:8C:B9:54:50:24,3831100,488744258,4738,6152267,3826362,482591991,0,8396,1652690,8374,1649195,22,3495,2324,14,5124,36,0,53,229410.0,130000.0,-39.0,-36.0,-44.0,-52.0,-40.0,-36.0,-44.0,-50.0,-90.0,-93.0,-90.0,-93.0,51.0,57.0,46.0,41.0,0
6705,92:69:1D:31:68:E9,3830124,486173424,3761,3581373,3826363,482592051,0,4221,1045096,4102,1018366,119,26730,2009,7,3901,80,0,37,229410.0,130000.0,-52.0,-50.0,-44.0,-46.0,-51.0,-48.0,-43.0,-48.0,-90.0,-93.0,-90.0,-93.0,38.0,43.0,46.0,47.0,0
6706,CC:2F:71:3F:1F:24,4473809,1186954425,647446,704362374,3826363,482592051,37,528946,565227732,528305,565150618,641,77114,511264,10,647683,65091,34,452,130000.0,43333.0,-67.0,-65.0,-70.0,-67.0,-67.0,-65.0,-70.0,-67.0,-90.0,-93.0,-90.0,-93.0,23.0,28.0,20.0,26.0,0
6707,CC:2F:71:3E:C5:1F,3827141,482687099,776,94846,3826365,482592253,0,3252,273012,2683,205426,569,67586,821,8,1117,18,0,37,144444.0,39000.0,-70.0,-71.0,-67.0,-60.0,-71.0,-72.0,-68.0,-61.0,-90.0,-93.0,-90.0,-93.0,20.0,22.0,23.0,33.0,0
6708,BA:8C:B9:54:50:24,3831103,488744520,4738,6152267,3826365,482592253,0,8396,1652690,8374,1649195,22,3495,2324,14,5124,36,0,53,229410.0,130000.0,-39.0,-36.0,-44.0,-52.0,-40.0,-36.0,-44.0,-50.0,-90.0,-93.0,-90.0,-93.0,51.0,57.0,46.0,41.0,0
6709,92:69:1D:31:68:E9,3830132,486174232,3761,3581373,3826371,482592859,0,4221,1045096,4102,1018366,119,26730,2009,7,3901,80,0,37,229410.0,130000.0,-52.0,-50.0,-44.0,-46.0,-51.0,-48.0,-43.0,-48.0,-90.0,-93.0,-90.0,-93.0,38.0,43.0,46.0,47.0,0
6710,CC:2F:71:3F:1F:24,4473859,1186969661,647488,704376802,3826371,482592859,37,528973,565232792,528332,565155678,641,77114,511291,10,647725,65120,34,452,144444.0,39000.0,-67.0,-65.0,-70.0,-68.0,-67.0,-65.0,-70.0,-67.0,-90.0,-93.0,-90.0,-93.0,23.0,28.0,20.0,25.0,0
6711,CC:2F:71:3E:C5:1F,3827147,482687705,776,94846,3826371,482592859,0,3252,273012,2683,205426,569,67586,821,8,1117,18,0,37,144444.0,39000.0,-70.0,-71.0,-67.0,-60.0,-71.0,-72.0,-68.0,-61.0,-90.0,-93.0,-90.0,-93.0,20.0,22.0,23.0,33.0,0
6712,BA:8C:B9:54:50:24,3831109,488745126,4738,6152267,3826371,482592859,0,8396,1652690,8374,1649195,22,3495,2324,14,5124,36,0,53,229410.0,130000.0,-39.0,-36.0,-44.0,-52.0,-40.0,-36.0,-44.0,-50.0,-90.0,-93.0,-90.0,-93.0,51.0,57.0,46.0,41.0,0
6713,92:69:1D:31:68:E9,3830132,486174232,3761,3581373,3826371,482592859,0,4221,1045096,4102,1018366,119,26730,2009,7,3901,80,0,37,229410.0,130000.0,-52.0,-50.0,-44.0,-46.0,-51.0,-48.0,-43.0,-48.0,-90.0,-93.0,-90.0,-93.0,38.0,43.0,46.0,47.0,0
6714,CC:2F:71:3F:1F:24,4473904,1186984549,647531,704391488,3826373,482593061,37,529004,565238384,528363,565161270,641,77114,511322,10,647768,65142,34,454,130000.0,43333.0,-67.0,-65.0,-70.0,-67.0,-67.0,-65.0,-70.0,-67.0,-90.0,-93.0,-90.0,-93.0,23.0,28.0,20.0,26.0,0
6715,CC:2F:71:3E:C5:1F,3827150,482687967,776,94846,3826374,482593121,0,3252,273012,2683,205426,569,67586,821,8,1117,18,0,37,144444.0,39000.0,-70.0,-71.0,-67.0,-60.0,-71.0,-72.0,-68.0,-61.0,-90.0,-93.0,-90.0,-93.0,20.0,22.0,23.0,33.0,0
6716,BA:8C:B9:54:50:24,3831112,488745388,4738,6152267,3826374,482593121,0,8396,1652690,8374,1649195,22,3495,2324,14,5124,36,0,53,229410.0,130000.0,-39.0,-36.0,-44.0,-52.0,-40.0,-36.0,-44.0,-50.0,-90.0,-93.0,-90.0,-93.0,51.0,57.0,46.0,41.0,0
6717,92:69:1D:31:68:E9,3830143,486175310,3761,3581373,3826382,482593937,0,4221,1045096,4102,1018366,119,26730,2009,7,3901,80,0,37,229410.0,130000.0,-52.0,-50.0,-44.0,-46.0,-51.0,-48.0,-43.0,-48.0,-90.0,-93.0,-90.0,-93.0,38.0,43.0,46.0,47.0,0
6718,CC:2F:71:3F:1F:24,4473956,1187000089,647574,704406152,3826382,482593937,37,529031,565243468,528390,565166354,641,77114,511349,10,647811,65143,34,454,130000.0,43333.0,-67.0,-65.0,-70.0,-67.0,-67.0,-65.0,-70.0,-67.0,-90.0,-93.0,-90.0,-93.0,23.0,28.0,20.0,26.0,0
6719,CC:2F:71:3E:C5:1F,3827158,482688783,776,94846,3826382,482593937,0,3252,273012,2683,205426,569,67586,821,8,1117,18,0,37,144444.0,39000.0,-70.0,-71.0,-67.0,-60.0,-71.0,-72.0,-68.0,-61.0,-90.0,-93.0,-90.0,-93.0,20.0,22.0,23.0,33.0,0
6720,BA:8C:B9:54:50:24,3831120,488746204,4738,6152267,3826382,482593937,0,8396,1652690,8374,1649195,22,3495,2324,14,5124,36,0,53,229410.0,130000.0,-39.0,-36.0,-44.0,-52.0,-40.0,-36.0,-44.0,-50.0,-90.0,-93.0,-90.0,-93.0,51.0,57.0,46.0,41.0,0
6721,92:69:1D:31:68:E9,3830143,486175310,3761,3581373,3826382,482593937,0,4221,1045096,4102,1018366,119,26730,2009,7,3901,80,0,37,229410.0,130000.0,-52.0,-50.0,-44.0,-46.0,-51.0,-48.0,-43.0,-48.0,-90.0,-93.0,-90.0,-93.0,38.0,43.0,46.0,47.0,0
6722,CC:2F:71:3F:1F:24,4474000,1187014775,647616,704420636,3826384,482594139,37,529058,565248528,528417,565171414,641,77114,511376,10,647853,65155,34,454,130000.0,39000.0,-67.0,-65.0,-70.0,-68.0,-67.0,-65.0,-70.0,-67.0,-90.0,-93.0,-90.0,-93.0,23.0,28.0,20.0,25.0,0
6723,CC:2F:71:3E:C5:1F,3827160,482688985,776,94846,3826384,482594139,0,3252,273012,2683,205426,569,67586,821,8,1117,18,0,37,144444.0,39000.0,-70.0,-71.0,-67.0,-60.0,-71.0,-72.0,-68.0,-61.0,-90.0,-93.0,-90.0,-93.0,20.0,22.0,23.0,33.0,0
6724,BA:8C:B9:54:50:24,3831122,488746406,4738,6152267,3826384,482594139,0,8396,1652690,8374,1649195,22,3495,2324,14,5124,36,0,53,229410.0,130000.0,-39.0,-36.0,-44.0,-52.0,-40.0,-36.0,-44.0,-50.0,-90.0,-93.0,-90.0,-93.0,51.0,57.0,46.0,41.0,0
6725,92:69:1D:31:68:E9,3830152,486176178,3761,3581373,3826391,482594805,0,4221,1045096,4102,1018366,119,26730,2009,7,3901,80,0,37,229410.0,130000.0,-52.0,-50.0,-44.0,-46.0,-51.0,-48.0,-43.0,-48.0,-90.0,-93.0,-90.0,-93.0,38.0,43.0,46.0,47.0,0
6726,CC:2F:71:3F:1F:24,4474051,1187030067,647660,704435262,3826391,482594805,37,529085,565253588,528444,565176474,641,77114,511403,10,647897,65164,34,454,130000.0,43333.0,-67.0,-65.0,-70.0,-67.0,-67.0,-65.0,-70.0,-67.0,-90.0,-93.0,-90.0,-93.0,23.0,28.0,20.0,26.0,0
6727,CC:2F:71:3E:C5:1F,3827167,482689651,776,94846,3826391,482594805,0,3252,273012,2683,205426,569,67586,821,8,1117,18,0,37,144444.0,39000.0,-70.0,-71.0,-67.0,-60.0,-71.0,-72.0,-68.0,-61.0,-90.0,-93.0,-90.0,-93.0,20.0,22.0,23.0,33.0,0
6728,BA:8C:B9:54:50:24,3831129,488747072,4738,6152267,3826391,482594805,0,8396,1652690,8374,1649195,22,3495,2324,14,5124,36,0,53,229410.0,130000.0,-39.0,-36.0,-44.0,-52.0,-40.0,-36.0,-44.0,-50.0,-90.0,-93.0,-90.0,-93.0,51.0,57.0,46.0,41.0,0
6729,92:69:1D:31:68:E9,3830154,486176356,3762,3581489,3826392,482594867,0,4223,1045232,4104,1018502,119,26730,2009,7,3902,80,0,37,229410.0,130000.0,-51.0,-47.0,-42.0,-49.0,-51.0,-48.0,-43.0,-48.0,-90.0,-93.0,-90.0,-93.0,39.0,46.0,48.0,44.0,0
6730,CC:2F:71:3F:1F:24,4474096,1187044751,647702,704449682,3826394,482595069,37,529112,565258650,528470,565181418,642,77232,511430,10,647939,65186,34,454,117000.0,39000.0,-67.0,-65.0,-70.0,-67.0,-67.0,-65.0,-70.0,-67.0,-90.0,-93.0,-90.0,-93.0,23.0,28.0,20.0,26.0,0
6731,CC:2F:71:3E:C5:1F,3827171,482689975,777,94906,3826394,482595069,0,3254,273152,2685,205566,569,67586,821,8,1118,18,0,37,144444.0,39000.0,-70.0,-71.0,-67.0,-60.0,-71.0,-72.0,-68.0,-61.0,-90.0,-93.0,-90.0,-93.0,20.0,22.0,23.0,33.0,0
6732,BA:8C:B9:54:50:24,3831133,488747452,4739,6152383,3826394,482595069,0,8402,1653098,8380,1649603,22,3495,2324,14,5125,36,0,53,229410.0,130000.0,-39.0,-36.0,-45.0,-51.0,-40.0,-35.0,-42.0,-48.0,-90.0,-93.0,-90.0,-93.0,51.0,57.0,45.0,42.0,0
6733,92:69:1D:31:68:E9,3830163,486177437,3762,3581489,3826401,482595948,0,4223,1045232,4104,1018502,119,26730,2009,7,3902,80,0,37,229410.0,130000.0,-51.0,-47.0,-42.0,-49.0,-51.0,-48.0,-43.0,-48.0,-90.0,-93.0,-90.0,-93.0,39.0,46.0,48.0,44.0,0
6734,CC:2F:71:3F:1F:24,4474145,1187060058,647744,704464110,3826401,482595948,37,529140,565263862,528498,565186630,642,77232,511458,10,647981,65189,34,454,130000.0,43333.0,-67.0,-65.0,-71.0,-68.0,-67.0,-65.0,-70.0,-67.0,-90.0,-93.0,-90.0,-93.0,23.0,28.0,19.0,25.0,0
6735,CC:2F:71:3E:C5:1F,3827178,482690854,777,94906,3826401,482595948,0,3254,273152,2685,205566,569,67586,821,8,1118,18,0,37,144444.0,39000.0,-70.0,-71.0,-67.0,-60.0,-71.0,-72.0,-68.0,-61.0,-90.0,-93.0,-90.0,-93.0,20.0,22.0,23.0,33.0,0
6736,BA:8C:B9:54:50:24,3831140,488748331,4739,6152383,3826401,482595948,0,8402,1653098,8380,1649603,22,3495,2324,14,5125,36,0,53,229410.0,130000.0,-39.0,-36.0,-45.0,-51.0,-40.0,-35.0,-42.0,-48.0,-90.0,-93.0,-90.0,-93.0,51.0,57.0,45.0,42.0,0
6737,92:69:1D:31:68:E9,3830164,486177497,3762,3581489,3826402,482596008,0,4223,1045232,4104,1018502,119,26730,2009,7,3902,80,0,37,229410.0,130000.0,-51.0,-47.0,-42.0,-49.0,-51.0,-48.0,-43.0,-48.0,-90.0,-93.0,-90.0,-93.0,39.0,46.0,48.0,44.0,0
6738,CC:2F:71:3F:1F:24,4474192,1187075002,647788,704478792,3826404,482596210,37,529167,565268922,528525,565191690,642,77232,511485,10,648025,65198,34,454,117000.0,39000.0,-73.0,-72.0,-77.0,-74.0,-72.0,-70.0,-75.0,-72.0,-90.0,-93.0,-90.0,-93.0,17.0,21.0,13.0,19.0,0
6739,CC:2F:71:3E:C5:1F,3827181,482691116,777,94906,3826404,482596210,0,3254,273152,2685,205566,569,67586,821,8,1118,18,0,37,144444.0,39000.0,-70.0,-71.0,-67.0,-60.0,-71.0,-72.0,-68.0,-61.0,-90.0,-93.0,-90.0,-93.0,20.0,22.0,23.0,33.0,0
6740,BA:8C:B9:54:50:24,3831143,488748593,4739,6152383,3826404,482596210,0,8402,1653098,8380,1649603,22,3495,2324,14,5125,36,0,53,229410.0,130000.0,-39.0,-36.0,-45.0,-51.0,-40.0,-35.0,-42.0,-48.0,-90.0,-93.0,-90.0,-93.0,51.0,57.0,45.0,42.0,0
6741,92:69:1D:31:68:E9,3830172,486178305,3762,3581489,3826410,482596816,0,4223,1045232,4104,1018502,119,26730,2009,7,3902,80,0,37,229410.0,130000.0,-51.0,-47.0,-42.0,-49.0,-51.0,-48.0,-43.0,-48.0,-90.0,-93.0,-90.0,-93.0,39.0,46.0,48.0,44.0,0
6742,CC:2F:71:3F:1F:24,4474241,1187090048,647831,704493232,3826410,482596816,37,529192,565273726,528550,565196494,642,77232,511510,10,648068,65202,34,454,117000.0,39000.0,-67.0,-65.0,-71.0,-68.0,-70.0,-68.0,-73.0,-70.0,-90.0,-93.0,-90.0,-93.0,23.0,28.0,19.0,25.0,0
6743,CC:2F:71:3E:C5:1F,3827187,482691722,777,94906,3826410,482596816,0,3254,273152,2685,205566,569,67586,821,8,1118,18,0,37,144444.0,39000.0,-70.0,-71.0,-67.0,-60.0,-71.0,-72.0,-68.0,-61.0,-90.0,-93.0,-90.0,-93.0,20.0,22.0,23.0,33.0,0
6744,BA:8C:B9:54:50:24,3831149,488749199,4739,6152383,3826410,482596816,0,8402,1653098,8380,1649603,22,3495,2324,14,5125,36,0,53,229410.0,130000.0,-39.0,-36.0,-45.0,-51.0,-40.0,-35.0,-42.0,-48.0,-90.0,-93.0,-90.0,-93.0,51.0,57.0,45.0,42.0,0
6745,92:69:1D:31:68:E9,3830173,486178365,3762,3581489,3826411,482596876,0,4223,1045232,4104,1018502,119,26730,2009,7,3902,80,0,37,229410.0,130000.0,-51.0,-47.0,-42.0,-49.0,-51.0,-48.0,-43.0,-48.0,-90.0,-93.0,-90.0,-93.0,39.0,46.0,48.0,44.0,0
6746,CC:2F:71:3F:1F:24,4474286,1187104738,647873,704507660,3826413,482597078,37,529219,565278786,528577,565201554,642,77232,511537,10,648110,65205,34,454,130000.0,43333.0,-68.0,-66.0,-71.0,-68.0,-68.0,-66.0,-71.0,-68.0,-90.0,-93.0,-90.0,-93.0,22.0,27.0,19.0,25.0,0
6747,CC:2F:71:3E:C5:1F,3827190,482691984,777,94906,3826413,482597078,0,3254,273152,2685,205566,569,67586,821,8,1118,18,0,37,144444.0,39000.0,-70.0,-71.0,-67.0,-60.0,-71.0,-72.0,-68.0,-61.0,-90.0,-93.0,-90.0,-93.0,20.0,22.0,23.0,33.0,0
6748,BA:8C:B9:54:50:24,3831152,488749461,4739,6152383,3826413,482597078,0,8402,1653098,8380,1649603,22,3495,2324,14,5125,36,0,53,229410.0,130000.0,-39.0,-36.0,-45.0,-51.0,-40.0,-35.0,-42.0,-48.0,-90.0,-93.0,-90.0,-93.0,51.0,57.0,45.0,42.0,0
6749,92:69:1D:31:68:E9,3830181,486179173,3762,3581489,3826419,482597684,0,4223,1045232,4104,1018502,119,26730,2009,7,3902,80,0,37,229410.0,130000.0,-51.0,-47.0,-42.0,-49.0,-51.0,-48.0,-43.0,-48.0,-90.0,-93.0,-90.0,-93.0,39.0,46.0,48.0,44.0,0
6750,CC:2F:71:3F:1F:24,4474334,1187119884,647915,704522200,3826419,482597684,37,529244,565283590,528602,565206358,642,77232,511562,10,648151,65210,34,454,130000.0,43333.0,-70.0,-69.0,-74.0,-71.0,-68.0,-67.0,-72.0,-69.0,-90.0,-93.0,-90.0,-93.0,20.0,24.0,16.0,22.0,0
6751,CC:2F:71:3E:C5:1F,3827196,482692590,777,94906,3826419,482597684,0,3254,273152,2685,205566,569,67586,821,8,1118,18,0,37,144444.0,39000.0,-70.0,-71.0,-67.0,-60.0,-71.0,-72.0,-68.0,-61.0,-90.0,-93.0,-90.0,-93.0,20.0,22.0,23.0,33.0,0
6752,BA:8C:B9:54:50:24,3831158,488750067,4739,6152383,3826419,482597684,0,8402,1653098,8380,1649603,22,3495,2324,14,5125,36,0,53,229410.0,130000.0,-39.0,-36.0,-45.0,-51.0,-40.0,-35.0,-42.0,-48.0,-90.0,-93.0,-90.0,-93.0,51.0,57.0,45.0,42.0,0
6753,92:69:1D:31:68:E9,3830181,486179173,3762,3581489,3826419,482597684,0,4224,1045300,4105,1018570,119,26730,2009,7,3903,80,0,37,229410.0,130000.0,-52.0,-50.0,-44.0,-46.0,-51.0,-48.0,-43.0,-47.0,-90.0,-93.0,-90.0,-93.0,38.0,43.0,46.0,47.0,0
6754,CC:2F:71:3F:1F:24,4474379,1187134644,647958,704536758,3826421,482597886,37,529272,565288790,528630,565211558,642,77232,511590,10,648195,65235,34,454,117000.0,39000.0,-70.0,-69.0,-74.0,-71.0,-70.0,-68.0,-73.0,-70.0,-90.0,-93.0,-90.0,-93.0,20.0,24.0,16.0,22.0,0
6755,CC:2F:71:3E:C5:1F,3827198,482692792,777,94906,3826421,482597886,0,3256,273292,2687,205706,569,67586,821,8,1119,18,0,37,144444.0,39000.0,-70.0,-71.0,-67.0,-60.0,-71.0,-72.0,-68.0,-61.0,-90.0,-93.0,-90.0,-93.0,20.0,22.0,23.0,33.0,0
6756,BA:8C:B9:54:50:24,3831160,488750269,4739,6152383,3826421,482597886,0,8404,1653234,8382,1649739,22,3495,2324,14,5126,36,0,53,229410.0,130000.0,-39.0,-36.0,-45.0,-51.0,-40.0,-35.0,-42.0,-48.0,-90.0,-93.0,-90.0,-93.0,51.0,57.0,45.0,42.0,0
6757,92:69:1D:31:68:E9,3830190,486180041,3762,3581489,3826428,482598552,0,4225,1045368,4106,1018638,119,26730,2009,7,3903,80,0,37,229410.0,130000.0,-51.0,-47.0,-42.0,-49.0,-51.0,-48.0,-43.0,-48.0,-90.0,-93.0,-90.0,-93.0,39.0,46.0,48.0,44.0,0
6758,CC:2F:71:3F:1F:24,4474428,1187149744,648000,704551192,3826428,482598552,37,529297,565293594,528655,565216362,642,77232,511615,10,648237,65238,34,454,130000.0,43333.0,-70.0,-69.0,-74.0,-71.0,-70.0,-68.0,-73.0,-70.0,-90.0,-93.0,-90.0,-93.0,20.0,24.0,16.0,22.0,0
6759,CC:2F:71:3E:C5:1F,3827205,482693458,777,94906,3826428,482598552,0,3256,273292,2687,205706,569,67586,821,8,1119,18,0,37,144444.0,39000.0,-70.0,-71.0,-67.0,-60.0,-71.0,-72.0,-68.0,-61.0,-90.0,-93.0,-90.0,-93.0,20.0,22.0,23.0,33.0,0
6760,BA:8C:B9:54:50:24,3831167,488750935,4739,6152383,3826428,482598552,0,8404,1653234,8382,1649739,22,3495,2324,14,5126,36,0,53,229410.0,130000.0,-39.0,-36.0,-45.0,-51.0,-40.0,-35.0,-42.0,-48.0,-90.0,-93.0,-90.0,-93.0,51.0,57.0,45.0,42.0,0
6761,92:69:1D:31:68:E9,3830191,486180103,3762,3581489,3826429,482598614,0,4225,1045368,4106,1018638,119,26730,2009,7,3903,80,0,37,229410.0,130000.0,-51.0,-47.0,-42.0,-49.0,-51.0,-48.0,-43.0,-48.0,-90.0,-93.0,-90.0,-93.0,39.0,46.0,48.0,44.0,0
6762,CC:2F:71:3F:1F:24,4474475,1187164808,648044,704565992,3826431,482598816,37,529324,565298654,528682,565221422,642,77232,511642,10,648281,65247,34,454,130000.0,43333.0,-70.0,-68.0,-74.0,-71.0,-69.0,-68.0,-73.0,-70.0,-90.0,-93.0,-90.0,-93.0,20.0,25.0,16.0,22.0,0
6763,CC:2F:71:3E:C5:1F,3827208,482693722,777,94906,3826431,482598816,0,3258,273480,2688,205776,570,67704,822,8,1119,18,0,37,144444.0,39000.0,-70.0,-71.0,-67.0,-60.0,-69.0,-70.0,-66.0,-59.0,-90.0,-93.0,-90.0,-93.0,20.0,22.0,23.0,33.0,0
6764,BA:8C:B9:54:50:24,3831170,488751199,4739,6152383,3826431,482598816,0,8404,1653234,8382,1649739,22,3495,2324,14,5126,36,0,53,229410.0,130000.0,-39.0,-36.0,-45.0,-51.0,-40.0,-35.0,-42.0,-48.0,-90.0,-93.0,-90.0,-93.0,51.0,57.0,45.0,42.0,0
6765,92:69:1D:31:68:E9,3830199,486180911,3762,3581489,3826437,482599422,0,4225,1045368,4106,1018638,119,26730,2009,7,3903,80,0,37,229410.0,130000.0,-51.0,-47.0,-42.0,-49.0,-51.0,-48.0,-43.0,-48.0,-90.0,-93.0,-90.0,-93.0,39.0,46.0,48.0,44.0,0
6766,CC:2F:71:3F:1F:24,4474523,1187179898,648086,704580476,3826437,482599422,37,529349,565303458,528707,565226226,642,77232,511667,10,648323,65269,34,454,130000.0,39000.0,-74.0,-72.0,-77.0,-74.0,-69.0,-67.0,-73.0,-70.0,-90.0,-93.0,-90.0,-93.0,16.0,21.0,13.0,19.0,0
6767,CC:2F:71:3E:C5:1F,3827214,482694328,777,94906,3826437,482599422,0,3258,273480,2688,205776,570,67704,822,8,1119,18,0,37,144444.0,39000.0,-70.0,-71.0,-67.0,-60.0,-69.0,-70.0,-66.0,-59.0,-90.0,-93.0,-90.0,-93.0,20.0,22.0,23.0,33.0,0
6768,BA:8C:B9:54:50:24,3831176,488751805,4739,6152383,3826437,482599422,0,8404,1653234,8382,1649739,22,3495,2324,14,5126,36,0,53,229410.0,130000.0,-39.0,-36.0,-45.0,-51.0,-40.0,-35.0,-42.0,-48.0,-90.0,-93.0,-90.0,-93.0,51.0,57.0,45.0,42.0,0
6769,92:69:1D:31:68:E9,3830200,486180971,3762,3581489,3826438,482599482,0,4226,1045436,4107,1018706,119,26730,2009,7,3903,80,0,37,229410.0,130000.0,-52.0,-50.0,-44.0,-46.0,-51.0,-48.0,-43.0,-47.0,-90.0,-93.0,-90.0,-93.0,38.0,43.0,46.0,47.0,0
6770,CC:2F:71:3F:1F:24,4474571,1187194910,648131,704595226,3826440,482599684,37,529375,565308378,528733,565231146,642,77232,511693,10,648367,65282,34,454,130000.0,43333.0,-68.0,-66.0,-71.0,-68.0,-67.0,-65.0,-70.0,-68.0,-90.0,-93.0,-90.0,-93.0,22.0,27.0,19.0,25.0,0
6771,CC:2F:71:3E:C5:1F,3827217,482694590,777,94906,3826440,482599684,0,3258,273480,2688,205776,570,67704,822,8,1119,18,0,37,144444.0,39000.0,-70.0,-71.0,-67.0,-60.0,-69.0,-70.0,-66.0,-59.0,-90.0,-93.0,-90.0,-93.0,20.0,22.0,23.0,33.0,0
6772,BA:8C:B9:54:50:24,3831179,488752067,4739,6152383,3826440,482599684,0,8404,1653234,8382,1649739,22,3495,2324,14,5126,36,0,53,229410.0,130000.0,-39.0,-36.0,-45.0,-51.0,-40.0,-35.0,-42.0,-48.0,-90.0,-93.0,-90.0,-93.0,51.0,57.0,45.0,42.0,0
6773,92:69:1D:31:68:E9,3830208,486181779,3762,3581489,3826446,482600290,0,4226,1045436,4107,1018706,119,26730,2009,7,3903,80,0,37,229410.0,130000.0,-52.0,-50.0,-44.0,-46.0,-51.0,-48.0,-43.0,-47.0,-90.0,-93.0,-90.0,-93.0,38.0,43.0,46.0,47.0,0
6774,CC:2F:71:3F:1F:24,4474618,1187209870,648172,704609580,3826446,482600290,37,529401,565313322,528759,565236090,642,77232,511719,10,648409,65296,34,454,130000.0,39000.0,-68.0,-66.0,-71.0,-68.0,-67.0,-66.0,-71.0,-68.0,-90.0,-93.0,-90.0,-93.0,22.0,27.0,19.0,25.0,0
6775,CC:2F:71:3E:C5:1F,3827223,482695196,777,94906,3826446,482600290,0,3258,273480,2688,205776,570,67704,822,8,1119,18,0,37,144444.0,39000.0,-70.0,-71.0,-67.0,-60.0,-69.0,-70.0,-66.0,-59.0,-90.0,-93.0,-90.0,-93.0,20.0,22.0,23.0,33.0,0
6776,BA:8C:B9:54:50:24,3831185,488752673,4739,6152383,3826446,482600290,0,8404,1653234,8382,1649739,22,3495,2324,14,5126,36,0,53,229410.0,130000.0,-39.0,-36.0,-45.0,-51.0,-40.0,-35.0,-42.0,-48.0,-90.0,-93.0,-90.0,-93.0,51.0,57.0,45.0,42.0,0
6777,92:69:1D:31:68:E9,3830209,486181839,3762,3581489,3826447,482600350,0,4226,1045436,4107,1018706,119,26730,2009,7,3903,80,0,37,229410.0,130000.0,-52.0,-50.0,-44.0,-46.0,-51.0,-48.0,-43.0,-47.0,-90.0,-93.0,-90.0,-93.0,38.0,43.0,46.0,47.0,0
6778,CC:2F:71:3F:1F:24,4474661,1187224302,648214,704623952,3826447,482600350,37,529427,565318302,528785,565241070,642,77232,511745,10,648451,65332,34,454,130000.0,43333.0,-68.0,-66.0,-71.0,-69.0,-68.0,-66.0,-71.0,-68.0,-90.0,-93.0,-90.0,-93.0,22.0,27.0,19.0,24.0,0
6779,CC:2F:71:3E:C5:1F,3827226,482695458,777,94906,3826449,482600552,0,3258,273480,2688,205776,570,67704,822,8,1119,18,0,37,144444.0,39000.0,-70.0,-71.0,-67.0,-60.0,-69.0,-70.0,-66.0,-59.0,-90.0,-93.0,-90.0,-93.0,20.0,22.0,23.0,33.0,0
6780,BA:8C:B9:54:50:24,3831188,488752935,4739,6152383,3826449,482600552,0,8404,1653234,8382,1649739,22,3495,2324,14,5126,36,0,53,229410.0,130000.0,-39.0,-36.0,-45.0,-51.0,-40.0,-35.0,-42.0,-48.0,-90.0,-93.0,-90.0,-93.0,51.0,57.0,45.0,42.0,0
6781,92:69:1D:31:68:E9,3830238,486193468,3762,3581489,3826476,482611979,0,4229,1045807,4109,1018842,120,26965,2010,7,3903,80,0,37,229410.0,130000.0,-51.0,-47.0,-42.0,-49.0,-51.0,-48.0,-43.0,-48.0,-90.0,-93.0,-90.0,-93.0,39.0,46.0,48.0,44.0,0
6782,CC:2F:71:3F:1F:24,4474734,1187250673,648256,704638492,3826478,482612181,37,529453,565323246,528811,565246014,642,77232,511771,10,648493,65342,34,454,130000.0,43333.0,-71.0,-69.0,-74.0,-71.0,-70.0,-68.0,-73.0,-70.0,-90.0,-93.0,-90.0,-93.0,19.0,24.0,16.0,22.0,0
6783,CC:2F:71:3E:C5:1F,3827255,482707087,777,94906,3826478,482612181,0,3258,273480,2688,205776,570,67704,822,8,1119,18,0,37,144444.0,39000.0,-70.0,-71.0,-67.0,-60.0,-69.0,-70.0,-66.0,-59.0,-90.0,-93.0,-90.0,-93.0,20.0,22.0,23.0,33.0,0
6784,BA:8C:B9:54:50:24,3831217,488764564,4739,6152383,3826478,482612181,0,8404,1653234,8382,1649739,22,3495,2324,14,5126,36,0,53,229410.0,130000.0,-39.0,-36.0,-45.0,-51.0,-40.0,-35.0,-42.0,-48.0,-90.0,-93.0,-90.0,-93.0,51.0,57.0,45.0,42.0,0
6785,92:69:1D:31:68:E9,3830241,486193943,3762,3581489,3826479,482612454,0,4229,1045807,4109,1018842,120,26965,2010,7,3903,80,0,37,229410.0,130000.0,-51.0,-47.0,-42.0,-49.0,-51.0,-48.0,-43.0,-48.0,-90.0,-93.0,-90.0,-93.0,39.0,46.0,48.0,44.0,0
6786,CC:2F:71:3F:1F:24,4474778,1187265508,648297,704652852,3826481,482612656,37,529478,565328050,528836,565250818,642,77232,511796,10,648534,65363,34,454,130000.0,39000.0,-71.0,-69.0,-74.0,-71.0,-70.0,-68.0,-73.0,-70.0,-90.0,-93.0,-90.0,-93.0,19.0,24.0,16.0,22.0,0
6787,CC:2F:71:3E:C5:1F,3827258,482707562,777,94906,3826481,482612656,0,3258,273480,2688,205776,570,67704,822,8,1119,18,0,37,144444.0,39000.0,-70.0,-71.0,-67.0,-60.0,-69.0,-70.0,-66.0,-59.0,-90.0,-93.0,-90.0,-93.0,20.0,22.0,23.0,33.0,0
6788,BA:8C:B9:54:50:24,3831220,488765039,4739,6152383,3826481,482612656,0,8404,1653234,8382,1649739,22,3495,2324,14,5126,36,0,53,229410.0,130000.0,-39.0,-36.0,-45.0,-51.0,-40.0,-35.0,-42.0,-48.0,-90.0,-93.0,-90.0,-93.0,51.0,57.0,45.0,42.0,0
6789,92:69:1D:31:68:E9,3830250,486194811,3762,3581489,3826488,482613322,0,4229,1045807,4109,1018842,120,26965,2010,7,3903,80,0,37,229410.0,130000.0,-51.0,-47.0,-42.0,-49.0,-51.0,-48.0,-43.0,-48.0,-90.0,-93.0,-90.0,-93.0,39.0,46.0,48.0,44.0,0
6790,CC:2F:71:3F:1F:24,4474828,1187280670,648340,704667348,3826488,482613322,37,529504,565332970,528862,565255738,642,77232,511822,10,648577,65396,34,454,130000.0,43333.0,-71.0,-69.0,-74.0,-71.0,-70.0,-68.0,-73.0,-70.0,-90.0,-93.0,-90.0,-93.0,19.0,24.0,16.0,22.0,0
6791,CC:2F:71:3E:C5:1F,3827265,482708228,777,94906,3826488,482613322,0,3258,273480,2688,205776,570,67704,822,8,1119,18,0,37,144444.0,39000.0,-70.0,-71.0,-67.0,-60.0,-69.0,-70.0,-66.0,-59.0,-90.0,-93.0,-90.0,-93.0,20.0,22.0,23.0,33.0,0
6792,BA:8C:B9:54:50:24,3831227,488765705,4739,6152383,3826488,482613322,0,8404,1653234,8382,1649739,22,3495,2324,14,5126,36,0,53,229410.0,130000.0,-39.0,-36.0,-45.0,-51.0,-40.0,-35.0,-42.0,-48.0,-90.0,-93.0,-90.0,-93.0,51.0,57.0,45.0,42.0,0
6793,92:69:1D:31:68:E9,3830250,486194811,3762,3581489,3826488,482613322,0,4229,1045807,4109,1018842,120,26965,2010,7,3903,80,0,37,229410.0,130000.0,-51.0,-47.0,-42.0,-49.0,-51.0,-48.0,-43.0,-48.0,-90.0,-93.0,-90.0,-93.0,39.0,46.0,48.0,44.0,0
6794,CC:2F:71:3F:1F:24,4474871,1187295288,648381,704681764,3826490,482613524,37,529531,565338054,528889,565260822,642,77232,511849,10,648618,65400,34,454,130000.0,43333.0,-70.0,-68.0,-73.0,-70.0,-70.0,-68.0,-73.0,-70.0,-90.0,-93.0,-90.0,-93.0,20.0,25.0,17.0,23.0,0
6795,CC:2F:71:3E:C5:1F,3827267,482708430,777,94906,3826490,482613524,0,3258,273480,2688,205776,570,67704,822,8,1119,18,0,37,144444.0,39000.0,-70.0,-71.0,-67.0,-60.0,-69.0,-70.0,-66.0,-59.0,-90.0,-93.0,-90.0,-93.0,20.0,22.0,23.0,33.0,0
6796,BA:8C:B9:54:50:24,3831229,488765907,4739,6152383,3826490,482613524,0,8404,1653234,8382,1649739,22,3495,2324,14,5126,36,0,53,229410.0,130000.0,-39.0,-36.0,-45.0,-51.0,-40.0,-35.0,-42.0,-48.0,-90.0,-93.0,-90.0,-93.0,51.0,57.0,45.0,42.0,0
6797,92:69:1D:31:68:E9,3830258,486195619,3762,3581489,3826496,482614130,0,4229,1045807,4109,1018842,120,26965,2010,7,3903,80,0,37,229410.0,130000.0,-51.0,-47.0,-42.0,-49.0,-51.0,-48.0,-43.0,-48.0,-90.0,-93.0,-90.0,-93.0,39.0,46.0,48.0,44.0,0
6798,CC:2F:71:3F:1F:24,4474921,1187310746,648423,704696248,3826498,482614498,37,529557,565342998,528915,565265766,642,77232,511875,10,648660,65408,34,454,130000.0,39000.0,-76.0,-74.0,-79.0,-76.0,-75.0,-73.0,-78.0,-75.0,-90.0,-93.0,-90.0,-93.0,14.0,19.0,11.0,17.0,0
6799,CC:2F:71:3E:C5:1F,3827276,482709464,777,94906,3826499,482614558,0,3258,273480,2688,205776,570,67704,822,8,1119,18,0,37,144444.0,39000.0,-70.0,-71.0,-67.0,-60.0,-69.0,-70.0,-66.0,-59.0,-90.0,-93.0,-90.0,-93.0,20.0,22.0,23.0,33.0,0
6800,BA:8C:B9:54:50:24,3831238,488766941,4739,6152383,3826499,482614558,0,8404,1653234,8382,1649739,22,3495,2324,14,5126,36,0,53,229410.0,130000.0,-39.0,-36.0,-45.0,-51.0,-40.0,-35.0,-42.0,-48.0,-90.0,-93.0,-90.0,-93.0,51.0,57.0,45.0,42.0,0
6801,92:69:1D:31:68:E9,3830261,486196047,3762,3581489,3826499,482614558,0,4229,1045807,4109,1018842,120,26965,2010,7,3903,80,0,37,229410.0,130000.0,-51.0,-47.0,-42.0,-49.0,-51.0,-48.0,-43.0,-48.0,-90.0,-93.0,-90.0,-93.0,39.0,46.0,48.0,44.0,0
6802,CC:2F:71:3F:1F:24,4474969,1187325814,648468,704711054,3826501,482614760,37,529583,565347942,528941,565270710,642,77232,511901,10,648705,65448,34,454,144444.0,43333.0,-67.0,-66.0,-71.0,-68.0,-67.0,-66.0,-71.0,-68.0,-90.0,-93.0,-90.0,-93.0,23.0,27.0,19.0,25.0,0
6803,CC:2F:71:3E:C5:1F,3827278,482709666,777,94906,3826501,482614760,0,3258,273480,2688,205776,570,67704,822,8,1119,18,0,37,144444.0,39000.0,-70.0,-71.0,-67.0,-60.0,-69.0,-70.0,-66.0,-59.0,-90.0,-93.0,-90.0,-93.0,20.0,22.0,23.0,33.0,0
6804,BA:8C:B9:54:50:24,3831240,488767143,4739,6152383,3826501,482614760,0,8404,1653234,8382,1649739,22,3495,2324,14,5126,36,0,53,229410.0,130000.0,-39.0,-36.0,-45.0,-51.0,-40.0,-35.0,-42.0,-48.0,-90.0,-93.0,-90.0,-93.0,51.0,57.0,45.0,42.0,0
6805,92:69:1D:31:68:E9,3830267,486196653,3762,3581489,3826505,482615164,0,4229,1045807,4109,1018842,120,26965,2010,7,3903,80,0,37,229410.0,130000.0,-51.0,-47.0,-42.0,-49.0,-51.0,-48.0,-43.0,-48.0,-90.0,-93.0,-90.0,-93.0,39.0,46.0,48.0,44.0,0
6806,CC:2F:71:3F:1F:24,4475017,1187340910,648510,704725544,3826507,482615366,37,529611,565353142,528969,565275910,642,77232,511929,10,648747,65457,34,454,130000.0,43333.0,-71.0,-69.0,-74.0,-71.0,-69.0,-67.0,-72.0,-69.0,-90.0,-93.0,-90.0,-93.0,19.0,24.0,16.0,22.0,0
6807,CC:2F:71:3E:C5:1F,3827284,482710272,777,94906,3826507,482615366,0,3258,273480,2688,205776,570,67704,822,8,1119,18,0,37,144444.0,39000.0,-70.0,-71.0,-67.0,-60.0,-69.0,-70.0,-66.0,-59.0,-90.0,-93.0,-90.0,-93.0,20.0,22.0,23.0,33.0,0
6808,BA:8C:B9:54:50:24,3831246,488767749,4739,6152383,3826507,482615366,0,8404,1653234,8382,1649739,22,3495,2324,14,5126,36,0,53,229410.0,130000.0,-39.0,-36.0,-45.0,-51.0,-40.0,-35.0,-42.0,-48.0,-90.0,-93.0,-90.0,-93.0,51.0,57.0,45.0,42.0,0
6809,92:69:1D:31:68:E9,3830270,486196915,3762,3581489,3826508,482615426,0,4229,1045807,4109,1018842,120,26965,2010,7,3903,80,0,37,229410.0,130000.0,-51.0,-47.0,-42.0,-49.0,-51.0,-48.0,-43.0,-48.0,-90.0,-93.0,-90.0,-93.0,39.0,46.0,48.0,44.0,0
6810,CC:2F:71:3F:1F:24,4475061,1187355588,648551,704739960,3826510,482615628,37,529636,565357946,528994,565280714,642,77232,511954,10,648788,65457,34,454,130000.0,43333.0,-71.0,-69.0,-74.0,-71.0,-70.0,-68.0,-73.0,-70.0,-90.0,-93.0,-90.0,-93.0,19.0,24.0,16.0,22.0,0
6811,CC:2F:71:3E:C5:1F,3827287,482710534,777,94906,3826510,482615628,0,3258,273480,2688,205776,570,67704,822,8,1119,18,0,37,144444.0,39000.0,-70.0,-71.0,-67.0,-60.0,-69.0,-70.0,-66.0,-59.0,-90.0,-93.0,-90.0,-93.0,20.0,22.0,23.0,33.0,0
6812,BA:8C:B9:54:50:24,3831249,488768011,4739,6152383,3826510,482615628,0,8404,1653234,8382,1649739,22,3495,2324,14,5126,36,0,53,229410.0,130000.0,-39.0,-36.0,-45.0,-51.0,-40.0,-35.0,-42.0,-48.0,-90.0,-93.0,-90.0,-93.0,51.0,57.0,45.0,42.0,0
6813,92:69:1D:31:68:E9,3830278,486197723,3762,3581489,3826516,482616234,0,4229,1045807,4109,1018842,120,26965,2010,7,3903,80,0,37,229410.0,130000.0,-51.0,-47.0,-42.0,-49.0,-51.0,-48.0,-43.0,-48.0,-90.0,-93.0,-90.0,-93.0,39.0,46.0,48.0,44.0,0
6814,CC:2F:71:3F:1F:24,4475109,1187370566,648593,704754332,3826516,482616234,37,529663,565363042,529021,565285810,642,77232,511981,10,648830,65476,34,454,130000.0,39000.0,-67.0,-65.0,-71.0,-68.0,-69.0,-68.0,-73.0,-70.0,-90.0,-93.0,-90.0,-93.0,23.0,28.0,19.0,25.0,0
6815,CC:2F:71:3E:C5:1F,3827293,482711140,777,94906,3826516,482616234,0,3258,273480,2688,205776,570,67704,822,8,1119,18,0,37,144444.0,39000.0,-70.0,-71.0,-67.0,-60.0,-69.0,-70.0,-66.0,-59.0,-90.0,-93.0,-90.0,-93.0,20.0,22.0,23.0,33.0,0
6816,BA:8C:B9:54:50:24,3831255,488768617,4739,6152383,3826516,482616234,0,8404,1653234,8382,1649739,22,3495,2324,14,5126,36,0,53,229410.0,130000.0,-39.0,-36.0,-45.0,-51.0,-40.0,-35.0,-42.0,-48.0,-90.0,-93.0,-90.0,-93.0,51.0,57.0,45.0,42.0,0
6817,92:69:1D:31:68:E9,3830278,486197723,3762,3581489,3826516,482616234,0,4229,1045807,4109,1018842,120,26965,2010,7,3903,80,0,37,229410.0,130000.0,-51.0,-47.0,-42.0,-49.0,-51.0,-48.0,-43.0,-48.0,-90.0,-93.0,-90.0,-93.0,39.0,46.0,48.0,44.0,0
6818,CC:2F:71:3F:1F:24,4475155,1187385466,648637,704769030,3826518,482616436,37,529690,565368090,529048,565290858,642,77232,512008,10,648874,65508,34,454,117000.0,39000.0,-74.0,-72.0,-77.0,-74.0,-73.0,-71.0,-76.0,-73.0,-90.0,-93.0,-90.0,-93.0,16.0,21.0,13.0,19.0,0
6819,CC:2F:71:3E:C5:1F,3827295,482711342,777,94906,3826518,482616436,0,3258,273480,2688,205776,570,67704,822,8,1119,18,0,37,144444.0,39000.0,-70.0,-71.0,-67.0,-60.0,-69.0,-70.0,-66.0,-59.0,-90.0,-93.0,-90.0,-93.0,20.0,22.0,23.0,33.0,0
6820,BA:8C:B9:54:50:24,3831257,488768819,4739,6152383,3826518,482616436,0,8404,1653234,8382,1649739,22,3495,2324,14,5126,36,0,53,229410.0,130000.0,-39.0,-36.0,-45.0,-51.0,-40.0,-35.0,-42.0,-48.0,-90.0,-93.0,-90.0,-93.0,51.0,57.0,45.0,42.0,0
6821,92:69:1D:31:68:E9,3830288,486198787,3763,3581685,3826525,482617102,0,4233,1046219,4113,1019254,120,26965,2011,7,3904,80,0,37,229410.0,130000.0,-52.0,-50.0,-45.0,-46.0,-52.0,-49.0,-44.0,-48.0,-90.0,-93.0,-90.0,-93.0,38.0,43.0,45.0,47.0,0
6822,CC:2F:71:3F:1F:24,4475204,1187400560,648679,704783458,3826525,482617102,37,529715,565372894,529073,565295662,642,77232,512033,10,648916,65518,34,454,130000.0,43333.0,-73.0,-71.0,-76.0,-73.0,-72.0,-71.0,-76.0,-73.0,-90.0,-93.0,-90.0,-93.0,17.0,22.0,14.0,20.0,0
6823,CC:2F:71:3E:C5:1F,3827302,482712008,777,94906,3826525,482617102,0,3258,273480,2688,205776,570,67704,822,8,1119,18,0,37,144444.0,39000.0,-70.0,-71.0,-67.0,-60.0,-69.0,-70.0,-66.0,-59.0,-90.0,-93.0,-90.0,-93.0,20.0,22.0,23.0,33.0,0
6824,BA:8C:B9:54:50:24,3831264,488769485,4739,6152383,3826525,482617102,0,8404,1653234,8382,1649739,22,3495,2324,14,5126,36,0,53,229410.0,130000.0,-39.0,-36.0,-45.0,-51.0,-40.0,-35.0,-42.0,-48.0,-90.0,-93.0,-90.0,-93.0,51.0,57.0,45.0,42.0,0
6825,92:69:1D:31:68:E9,3830288,486198787,3763,3581685,3826525,482617102,0,4233,1046219,4113,1019254,120,26965,2011,7,3904,80,0,37,229410.0,130000.0,-52.0,-50.0,-45.0,-46.0,-52.0,-49.0,-44.0,-48.0,-90.0,-93.0,-90.0,-93.0,38.0,43.0,45.0,47.0,0
6826,CC:2F:71:3F:1F:24,4475248,1187415246,648721,704797942,3826527,482617304,37,529741,565377838,529099,565300606,642,77232,512059,10,648958,65535,34,454,117000.0,39000.0,-67.0,-65.0,-71.0,-68.0,-69.0,-68.0,-73.0,-70.0,-90.0,-93.0,-90.0,-93.0,23.0,28.0,19.0,25.0,0
6827,CC:2F:71:3E:C5:1F,3827304,482712210,777,94906,3826527,482617304,0,3258,273480,2688,205776,570,67704,822,8,1119,18,0,37,144444.0,39000.0,-70.0,-71.0,-67.0,-60.0,-69.0,-70.0,-66.0,-59.0,-90.0,-93.0,-90.0,-93.0,20.0,22.0,23.0,33.0,0
6828,BA:8C:B9:54:50:24,3831268,488769889,4739,6152383,3826529,482617506,0,8404,1653234,8382,1649739,22,3495,2324,14,5126,36,0,53,229410.0,130000.0,-39.0,-36.0,-45.0,-51.0,-40.0,-35.0,-42.0,-48.0,-90.0,-93.0,-90.0,-93.0,51.0,57.0,45.0,42.0,0
6829,92:69:1D:31:68:E9,3830297,486199655,3763,3581685,3826534,482617970,0,4233,1046219,4113,1019254,120,26965,2011,7,3904,80,0,37,229410.0,130000.0,-52.0,-50.0,-45.0,-46.0,-52.0,-49.0,-44.0,-48.0,-90.0,-93.0,-90.0,-93.0,38.0,43.0,45.0,47.0,0
6830,CC:2F:71:3F:1F:24,4475298,1187430414,648764,704812444,3826534,482617970,37,529767,565382782,529125,565305550,642,77232,512085,10,649001,65544,34,454,130000.0,43333.0,-67.0,-65.0,-70.0,-67.0,-67.0,-65.0,-70.0,-67.0,-90.0,-93.0,-90.0,-93.0,23.0,28.0,20.0,26.0,0
6831,CC:2F:71:3E:C5:1F,3827311,482712876,777,94906,3826534,482617970,0,3258,273480,2688,205776,570,67704,822,8,1119,18,0,37,144444.0,39000.0,-70.0,-71.0,-67.0,-60.0,-69.0,-70.0,-66.0,-59.0,-90.0,-93.0,-90.0,-93.0,20.0,22.0,23.0,33.0,0
6832,BA:8C:B9:54:50:24,3831273,488770353,4739,6152383,3826534,482617970,0,8404,1653234,8382,1649739,22,3495,2324,14,5126,36,0,53,229410.0,130000.0,-39.0,-36.0,-45.0,-51.0,-40.0,-35.0,-42.0,-48.0,-90.0,-93.0,-90.0,-93.0,51.0,57.0,45.0,42.0,0
6833,92:69:1D:31:68:E9,3830298,486199771,3764,3581801,3826534,482617970,0,4235,1046355,4115,1019390,120,26965,2011,7,3905,80,0,37,229410.0,130000.0,-52.0,-50.0,-44.0,-46.0,-52.0,-49.0,-44.0,-47.0,-90.0,-93.0,-90.0,-93.0,38.0,43.0,46.0,47.0,0
6834,CC:2F:71:3F:1F:24,4475341,1187444856,648805,704826684,3826536,482618172,37,529793,565387726,529151,565310494,642,77232,512111,10,649042,65555,34,454,130000.0,39000.0,-67.0,-65.0,-70.0,-67.0,-67.0,-65.0,-70.0,-67.0,-90.0,-93.0,-90.0,-93.0,23.0,28.0,20.0,26.0,0
6835,CC:2F:71:3E:C5:1F,3827314,482713194,778,95022,3826536,482618172,0,3260,273620,2690,205916,570,67704,822,8,1120,18,0,37,144444.0,39000.0,-70.0,-71.0,-67.0,-60.0,-69.0,-70.0,-66.0,-59.0,-90.0,-93.0,-90.0,-93.0,20.0,22.0,23.0,33.0,0
6836,BA:8C:B9:54:50:24,3831278,488770873,4740,6152499,3826538,482618374,0,8410,1653642,8388,1650147,22,3495,2324,14,5127,36,0,53,229410.0,137640.0,-49.0,-35.0,-42.0,-44.0,-41.0,-35.0,-43.0,-47.0,-90.0,-93.0,-90.0,-93.0,41.0,58.0,48.0,49.0,0
6837,92:69:1D:31:68:E9,3830307,486200852,3764,3581801,3826543,482619051,0,4235,1046355,4115,1019390,120,26965,2011,7,3905,80,0,37,229410.0,130000.0,-52.0,-50.0,-44.0,-46.0,-52.0,-49.0,-44.0,-47.0,-90.0,-93.0,-90.0,-93.0,38.0,43.0,46.0,47.0,0
6838,CC:2F:71:3F:1F:24,4475389,1187460039,648846,704840988,3826543,482619051,37,529818,565392530,529176,565315298,642,77232,512136,10,649083,65572,34,454,130000.0,39000.0,-67.0,-65.0,-70.0,-68.0,-67.0,-65.0,-70.0,-67.0,-90.0,-93.0,-90.0,-93.0,23.0,28.0,20.0,25.0,0
6839,CC:2F:71:3E:C5:1F,3827321,482714073,778,95022,3826543,482619051,0,3260,273620,2690,205916,570,67704,822,8,1120,18,0,37,144444.0,39000.0,-70.0,-71.0,-67.0,-60.0,-69.0,-70.0,-66.0,-59.0,-90.0,-93.0,-90.0,-93.0,20.0,22.0,23.0,33.0,0
6840,BA:8C:B9:54:50:24,3831283,488771550,4740,6152499,3826543,482619051,0,8410,1653642,8388,1650147,22,3495,2324,14,5127,36,0,53,229410.0,137640.0,-49.0,-35.0,-42.0,-44.0,-41.0,-35.0,-43.0,-47.0,-90.0,-93.0,-90.0,-93.0,41.0,58.0,48.0,49.0,0
6841,92:69:1D:31:68:E9,3830310,486202036,3764,3581801,3826546,482620235,0,4235,1046355,4115,1019390,120,26965,2011,7,3905,80,0,37,229410.0,130000.0,-52.0,-50.0,-44.0,-46.0,-52.0,-49.0,-44.0,-47.0,-90.0,-93.0,-90.0,-93.0,38.0,43.0,46.0,47.0,0
6842,CC:2F:71:3F:1F:24,4475436,1187475859,648888,704855422,3826548,482620437,37,529844,565397474,529202,565320242,642,77232,512162,10,649125,65592,34,454,130000.0,39000.0,-67.0,-65.0,-70.0,-68.0,-67.0,-65.0,-70.0,-67.0,-90.0,-93.0,-90.0,-93.0,23.0,28.0,20.0,25.0,0
6843,CC:2F:71:3E:C5:1F,3827326,482715459,778,95022,3826548,482620437,0,3260,273620,2690,205916,570,67704,822,8,1120,18,0,37,144444.0,39000.0,-70.0,-71.0,-67.0,-60.0,-69.0,-70.0,-66.0,-59.0,-90.0,-93.0,-90.0,-93.0,20.0,22.0,23.0,33.0,0
6844,BA:8C:B9:54:50:24,3831290,488773138,4740,6152499,3826550,482620639,0,8411,1653710,8389,1650215,22,3495,2324,14,5127,36,0,53,229410.0,137640.0,-39.0,-37.0,-44.0,-52.0,-41.0,-35.0,-43.0,-47.0,-90.0,-93.0,-90.0,-93.0,51.0,56.0,46.0,41.0,0
6845,92:69:1D:31:68:E9,3830316,486202642,3764,3581801,3826552,482620841,0,4235,1046355,4115,1019390,120,26965,2011,7,3905,80,0,37,229410.0,130000.0,-52.0,-50.0,-44.0,-46.0,-52.0,-49.0,-44.0,-47.0,-90.0,-93.0,-90.0,-93.0,38.0,43.0,46.0,47.0,0
6846,CC:2F:71:3F:1F:24,4475483,1187490825,648929,704869782,3826554,482621043,37,529870,565402394,529228,565325162,642,77232,512188,10,649166,65597,34,454,130000.0,43333.0,-67.0,-65.0,-70.0,-67.0,-67.0,-65.0,-70.0,-67.0,-90.0,-93.0,-90.0,-93.0,23.0,28.0,20.0,26.0,0
6847,CC:2F:71:3E:C5:1F,3827332,482716065,778,95022,3826554,482621043,0,3260,273620,2690,205916,570,67704,822,8,1120,18,0,37,144444.0,39000.0,-70.0,-71.0,-67.0,-60.0,-69.0,-70.0,-66.0,-59.0,-90.0,-93.0,-90.0,-93.0,20.0,22.0,23.0,33.0,0
6848,BA:8C:B9:54:50:24,3831294,488773542,4740,6152499,3826554,482621043,0,8411,1653710,8389,1650215,22,3495,2324,14,5127,36,0,53,229410.0,137640.0,-39.0,-37.0,-44.0,-52.0,-41.0,-35.0,-43.0,-47.0,-90.0,-93.0,-90.0,-93.0,51.0,56.0,46.0,41.0,0
6849,92:69:1D:31:68:E9,3830323,486204262,3766,3582033,3826557,482622229,0,4241,1046843,4121,1019878,120,26965,2013,7,3907,80,0,37,229410.0,137640.0,-52.0,-50.0,-44.0,-46.0,-52.0,-50.0,-44.0,-46.0,-90.0,-93.0,-90.0,-93.0,38.0,43.0,46.0,47.0,0
6850,CC:2F:71:3F:1F:24,4475529,1187506517,648970,704884086,3826559,482622431,37,529897,565407454,529255,565330222,642,77232,512215,10,649207,65617,34,454,117000.0,39000.0,-67.0,-65.0,-71.0,-67.0,-67.0,-65.0,-70.0,-67.0,-90.0,-93.0,-90.0,-93.0,23.0,28.0,19.0,26.0,0
6851,CC:2F:71:3E:C5:1F,3827340,482717715,778,95022,3826562,482622693,0,3262,273808,2691,205986,571,67822,823,8,1120,18,0,37,144444.0,39000.0,-68.0,-65.0,-66.0,-61.0,-69.0,-70.0,-66.0,-60.0,-90.0,-93.0,-90.0,-93.0,22.0,28.0,24.0,32.0,0
6852,BA:8C:B9:54:50:24,3831302,488775192,4740,6152499,3826562,482622693,0,8411,1653710,8389,1650215,22,3495,2324,14,5127,36,0,53,229410.0,137640.0,-39.0,-37.0,-44.0,-52.0,-41.0,-35.0,-43.0,-47.0,-90.0,-93.0,-90.0,-93.0,51.0,56.0,46.0,41.0,0
6853,92:69:1D:31:68:E9,3830330,486204928,3766,3582033,3826564,482622895,0,4241,1046843,4121,1019878,120,26965,2013,7,3907,80,0,37,229410.0,137640.0,-52.0,-50.0,-44.0,-46.0,-52.0,-50.0,-44.0,-46.0,-90.0,-93.0,-90.0,-93.0,38.0,43.0,46.0,47.0,0
6854,CC:2F:71:3F:1F:24,4475576,1187521409,649012,704898514,3826564,482622895,37,529923,565412398,529281,565335166,642,77232,512241,10,649249,65621,34,454,130000.0,43333.0,-67.0,-65.0,-71.0,-68.0,-67.0,-65.0,-70.0,-67.0,-90.0,-93.0,-90.0,-93.0,23.0,28.0,19.0,25.0,0
6855,CC:2F:71:3E:C5:1F,3827344,482718119,778,95022,3826566,482623097,0,3262,273808,2691,205986,571,67822,823,8,1120,18,0,37,144444.0,39000.0,-68.0,-65.0,-66.0,-61.0,-69.0,-70.0,-66.0,-60.0,-90.0,-93.0,-90.0,-93.0,22.0,28.0,24.0,32.0,0
6856,BA:8C:B9:54:50:24,3831306,488775596,4740,6152499,3826566,482623097,0,8411,1653710,8389,1650215,22,3495,2324,14,5127,36,0,53,229410.0,137640.0,-39.0,-37.0,-44.0,-52.0,-41.0,-35.0,-43.0,-47.0,-90.0,-93.0,-90.0,-93.0,51.0,56.0,46.0,41.0,0
6857,92:69:1D:31:68:E9,3830334,486206254,3766,3582033,3826568,482624221,0,4241,1046843,4121,1019878,120,26965,2013,7,3907,80,0,37,229410.0,137640.0,-52.0,-50.0,-44.0,-46.0,-52.0,-50.0,-44.0,-46.0,-90.0,-93.0,-90.0,-93.0,38.0,43.0,46.0,47.0,0
6858,CC:2F:71:3F:1F:24,4475623,1187537241,649053,704912818,3826570,482624423,37,529949,565417342,529307,565340110,642,77232,512267,10,649290,65637,34,454,117000.0,39000.0,-68.0,-66.0,-71.0,-68.0,-67.0,-65.0,-70.0,-68.0,-90.0,-93.0,-90.0,-93.0,22.0,27.0,19.0,25.0,0
6859,CC:2F:71:3E:C5:1F,3827350,482719647,778,95022,3826572,482624625,0,3262,273808,2691,205986,571,67822,823,8,1120,18,0,37,144444.0,39000.0,-68.0,-65.0,-66.0,-61.0,-69.0,-70.0,-66.0,-60.0,-90.0,-93.0,-90.0,-93.0,22.0,28.0,24.0,32.0,0
6860,BA:8C:B9:54:50:24,3831312,488777124,4740,6152499,3826572,482624625,0,8411,1653710,8389,1650215,22,3495,2324,14,5127,36,0,53,229410.0,137640.0,-39.0,-37.0,-44.0,-52.0,-41.0,-35.0,-43.0,-47.0,-90.0,-93.0,-90.0,-93.0,51.0,56.0,46.0,41.0,0
6861,92:69:1D:31:68:E9,3830341,486206920,3766,3582033,3826575,482624887,0,4241,1046843,4121,1019878,120,26965,2013,7,3907,80,0,37,229410.0,137640.0,-52.0,-50.0,-44.0,-46.0,-52.0,-50.0,-44.0,-46.0,-90.0,-93.0,-90.0,-93.0,38.0,43.0,46.0,47.0,0
6862,CC:2F:71:3F:1F:24,4475671,1187552263,649096,704927376,3826575,482624887,37,529975,565422262,529333,565345030,642,77232,512293,10,649333,65646,34,454,130000.0,43333.0,-77.0,-75.0,-80.0,-77.0,-74.0,-72.0,-77.0,-74.0,-90.0,-93.0,-90.0,-93.0,13.0,18.0,10.0,16.0,0
6863,CC:2F:71:3E:C5:1F,3827355,482720111,778,95022,3826577,482625089,0,3262,273808,2691,205986,571,67822,823,8,1120,18,0,37,144444.0,39000.0,-68.0,-65.0,-66.0,-61.0,-69.0,-70.0,-66.0,-60.0,-90.0,-93.0,-90.0,-93.0,22.0,28.0,24.0,32.0,0
6864,BA:8C:B9:54:50:24,3831317,488777588,4740,6152499,3826577,482625089,0,8411,1653710,8389,1650215,22,3495,2324,14,5127,36,0,53,229410.0,137640.0,-39.0,-37.0,-44.0,-52.0,-41.0,-35.0,-43.0,-47.0,-90.0,-93.0,-90.0,-93.0,51.0,56.0,46.0,41.0,0
6865,92:69:1D:31:68:E9,3830343,486207122,3766,3582033,3826577,482625089,0,4241,1046843,4121,1019878,120,26965,2013,7,3907,80,0,37,229410.0,137640.0,-52.0,-50.0,-44.0,-46.0,-52.0,-50.0,-44.0,-46.0,-90.0,-93.0,-90.0,-93.0,38.0,43.0,46.0,47.0,0
6866,CC:2F:71:3F:1F:24,4475717,1187567039,649138,704941748,3826579,482625291,37,530000,565427066,529358,565349834,642,77232,512318,10,649375,65661,34,454,130000.0,39000.0,-67.0,-65.0,-71.0,-68.0,-67.0,-65.0,-70.0,-68.0,-90.0,-93.0,-90.0,-93.0,23.0,28.0,19.0,25.0,0
6867,CC:2F:71:3E:C5:1F,3827359,482720515,778,95022,3826581,482625493,0,3262,273808,2691,205986,571,67822,823,8,1120,18,0,37,144444.0,39000.0,-68.0,-65.0,-66.0,-61.0,-69.0,-70.0,-66.0,-60.0,-90.0,-93.0,-90.0,-93.0,22.0,28.0,24.0,32.0,0
6868,BA:8C:B9:54:50:24,3831321,488777992,4740,6152499,3826581,482625493,0,8411,1653710,8389,1650215,22,3495,2324,14,5127,36,0,53,229410.0,137640.0,-39.0,-37.0,-44.0,-52.0,-41.0,-35.0,-43.0,-47.0,-90.0,-93.0,-90.0,-93.0,51.0,56.0,46.0,41.0,0
6869,92:69:1D:31:68:E9,3830349,486207728,3766,3582033,3826583,482625695,0,4241,1046843,4121,1019878,120,26965,2013,7,3907,80,0,37,229410.0,137640.0,-52.0,-50.0,-44.0,-46.0,-52.0,-50.0,-44.0,-46.0,-90.0,-93.0,-90.0,-93.0,38.0,43.0,46.0,47.0,0
6870,CC:2F:71:3F:1F:24,4475762,1187581803,649179,704956108,3826583,482625695,37,530025,565431870,529383,565354638,642,77232,512343,10,649416,65668,34,454,130000.0,43333.0,-67.0,-65.0,-70.0,-68.0,-67.0,-65.0,-70.0,-68.0,-90.0,-93.0,-90.0,-93.0,23.0,28.0,20.0,25.0,0
6871,CC:2F:71:3E:C5:1F,3827362,482720851,778,95022,3826584,482625829,0,3262,273808,2691,205986,571,67822,823,8,1120,18,0,37,144444.0,39000.0,-68.0,-65.0,-66.0,-61.0,-69.0,-70.0,-66.0,-60.0,-90.0,-93.0,-90.0,-93.0,22.0,28.0,24.0,32.0,0
6872,BA:8C:B9:54:50:24,3831325,488778396,4740,6152499,3826585,482625897,0,8411,1653710,8389,1650215,22,3495,2324,14,5127,36,0,53,229410.0,137640.0,-39.0,-37.0,-44.0,-52.0,-41.0,-35.0,-43.0,-47.0,-90.0,-93.0,-90.0,-93.0,51.0,56.0,46.0,41.0,0
6873,92:69:1D:31:68:E9,3830352,486207990,3766,3582033,3826586,482625957,0,4241,1046843,4121,1019878,120,26965,2013,7,3907,80,0,37,229410.0,137640.0,-52.0,-50.0,-44.0,-46.0,-52.0,-50.0,-44.0,-46.0,-90.0,-93.0,-90.0,-93.0,38.0,43.0,46.0,47.0,0
6874,CC:2F:71:3F:1F:24,4475810,1187596819,649222,704970660,3826588,482626159,37,530051,565436814,529409,565359582,642,77232,512369,10,649459,65687,34,454,117000.0,39000.0,-67.0,-65.0,-71.0,-68.0,-67.0,-65.0,-70.0,-67.0,-90.0,-93.0,-90.0,-93.0,23.0,28.0,19.0,25.0,0
6875,CC:2F:71:3E:C5:1F,3827368,482721383,778,95022,3826590,482626361,0,3262,273808,2691,205986,571,67822,823,8,1120,18,0,37,144444.0,39000.0,-68.0,-65.0,-66.0,-61.0,-69.0,-70.0,-66.0,-60.0,-90.0,-93.0,-90.0,-93.0,22.0,28.0,24.0,32.0,0
6876,BA:8C:B9:54:50:24,3831330,488778860,4740,6152499,3826590,482626361,0,8414,1653914,8392,1650419,22,3495,2324,14,5127,36,0,53,229410.0,137640.0,-39.0,-36.0,-45.0,-51.0,-42.0,-35.0,-42.0,-47.0,-90.0,-93.0,-90.0,-93.0,51.0,57.0,45.0,42.0,0
6877,92:69:1D:31:68:E9,3830359,486208658,3766,3582033,3826593,482626625,0,4241,1046843,4121,1019878,120,26965,2013,7,3907,80,0,37,229410.0,137640.0,-52.0,-50.0,-44.0,-46.0,-52.0,-50.0,-44.0,-46.0,-90.0,-93.0,-90.0,-93.0,38.0,43.0,46.0,47.0,0
6878,CC:2F:71:3F:1F:24,4475857,1187611713,649264,704985088,3826593,482626625,37,530077,565441736,529434,565364386,643,77350,512395,10,649501,65691,34,454,130000.0,43333.0,-67.0,-65.0,-70.0,-68.0,-67.0,-65.0,-70.0,-68.0,-90.0,-93.0,-90.0,-93.0,23.0,28.0,20.0,25.0,0
6879,CC:2F:71:3E:C5:1F,3827371,482721647,778,95022,3826593,482626625,0,3262,273808,2691,205986,571,67822,823,8,1120,18,0,37,144444.0,39000.0,-68.0,-65.0,-66.0,-61.0,-69.0,-70.0,-66.0,-60.0,-90.0,-93.0,-90.0,-93.0,22.0,28.0,24.0,32.0,0
6880,BA:8C:B9:54:50:24,3831335,488779326,4740,6152499,3826595,482626827,0,8417,1654118,8395,1650623,22,3495,2324,14,5127,36,0,53,229410.0,137640.0,-39.0,-36.0,-45.0,-52.0,-42.0,-35.0,-43.0,-48.0,-90.0,-93.0,-90.0,-93.0,51.0,57.0,45.0,41.0,0
6881,92:69:1D:31:68:E9,3830361,486208860,3766,3582033,3826595,482626827,0,4241,1046843,4121,1019878,120,26965,2013,7,3907,80,0,37,229410.0,137640.0,-52.0,-50.0,-44.0,-46.0,-52.0,-50.0,-44.0,-46.0,-90.0,-93.0,-90.0,-93.0,38.0,43.0,46.0,47.0,0
6882,CC:2F:71:3F:1F:24,4475906,1187626807,649306,704999516,3826600,482627291,37,530102,565446540,529459,565369190,643,77350,512420,10,649543,65715,34,454,144444.0,39000.0,-71.0,-69.0,-74.0,-71.0,-71.0,-69.0,-74.0,-71.0,-90.0,-93.0,-90.0,-93.0,19.0,24.0,16.0,22.0,0
6883,CC:2F:71:3E:C5:1F,3827378,482722313,778,95022,3826600,482627291,0,3262,273808,2691,205986,571,67822,823,8,1120,18,0,37,144444.0,39000.0,-68.0,-65.0,-66.0,-61.0,-69.0,-70.0,-66.0,-60.0,-90.0,-93.0,-90.0,-93.0,22.0,28.0,24.0,32.0,0
6884,BA:8C:B9:54:50:24,3831340,488779790,4740,6152499,3826600,482627291,0,8417,1654118,8395,1650623,22,3495,2324,14,5127,36,0,53,229410.0,137640.0,-39.0,-36.0,-45.0,-52.0,-42.0,-35.0,-43.0,-48.0,-90.0,-93.0,-90.0,-93.0,51.0,57.0,45.0,41.0,0
6885,92:69:1D:31:68:E9,3830368,486209526,3766,3582033,3826602,482627493,0,4241,1046843,4121,1019878,120,26965,2013,7,3907,80,0,37,229410.0,137640.0,-52.0,-50.0,-44.0,-46.0,-52.0,-50.0,-44.0,-46.0,-90.0,-93.0,-90.0,-93.0,38.0,43.0,46.0,47.0,0
6886,CC:2F:71:3F:1F:24,4475950,1187641437,649348,705013944,3826602,482627493,37,530129,565451600,529486,565374250,643,77350,512447,10,649585,65738,34,454,130000.0,43333.0,-70.0,-68.0,-73.0,-70.0,-70.0,-68.0,-73.0,-70.0,-90.0,-93.0,-90.0,-93.0,20.0,25.0,17.0,23.0,0
6887,CC:2F:71:3E:C5:1F,3827380,482722515,778,95022,3826602,482627493,0,3262,273808,2691,205986,571,67822,823,8,1120,18,0,37,144444.0,39000.0,-68.0,-65.0,-66.0,-61.0,-69.0,-70.0,-66.0,-60.0,-90.0,-93.0,-90.0,-93.0,22.0,28.0,24.0,32.0,0
6888,BA:8C:B9:54:50:24,3831343,488780118,4740,6152499,3826603,482627619,0,8417,1654118,8395,1650623,22,3495,2324,14,5127,36,0,53,229410.0,137640.0,-39.0,-36.0,-45.0,-52.0,-42.0,-35.0,-43.0,-48.0,-90.0,-93.0,-90.0,-93.0,51.0,57.0,45.0,41.0,0
6889,92:69:1D:31:68:E9,3830371,486209854,3766,3582033,3826605,482627821,0,4241,1046843,4121,1019878,120,26965,2013,7,3907,80,0,37,229410.0,137640.0,-52.0,-50.0,-44.0,-46.0,-52.0,-50.0,-44.0,-46.0,-90.0,-93.0,-90.0,-93.0,38.0,43.0,46.0,47.0,0
6890,CC:2F:71:3F:1F:24,4475998,1187656668,649390,705028372,3826608,482628296,37,530155,565456544,529512,565379194,643,77350,512473,10,649627,65756,34,454,117000.0,39000.0,-67.0,-65.0,-70.0,-67.0,-68.0,-66.0,-71.0,-68.0,-90.0,-93.0,-90.0,-93.0,23.0,28.0,20.0,26.0,0
6891,CC:2F:71:3E:C5:1F,3827386,482723318,778,95022,3826608,482628296,0,3262,273808,2691,205986,571,67822,823,8,1120,18,0,37,144444.0,39000.0,-68.0,-65.0,-66.0,-61.0,-69.0,-70.0,-66.0,-60.0,-90.0,-93.0,-90.0,-93.0,22.0,28.0,24.0,32.0,0
6892,BA:8C:B9:54:50:24,3831350,488780997,4740,6152499,3826610,482628498,0,8417,1654118,8395,1650623,22,3495,2324,14,5127,36,0,53,229410.0,137640.0,-39.0,-36.0,-45.0,-52.0,-42.0,-35.0,-43.0,-48.0,-90.0,-93.0,-90.0,-93.0,51.0,57.0,45.0,41.0,0
6893,92:69:1D:31:68:E9,3830379,486210793,3766,3582033,3826613,482628760,0,4241,1046843,4121,1019878,120,26965,2013,7,3907,80,0,37,229410.0,137640.0,-52.0,-50.0,-44.0,-46.0,-52.0,-50.0,-44.0,-46.0,-90.0,-93.0,-90.0,-93.0,38.0,43.0,46.0,47.0,0
6894,CC:2F:71:3F:1F:24,4476046,1187671690,649433,705042930,3826613,482628760,37,530180,565461348,529537,565383998,643,77350,512498,10,649670,65757,34,454,130000.0,43333.0,-67.0,-65.0,-70.0,-68.0,-67.0,-65.0,-70.0,-67.0,-90.0,-93.0,-90.0,-93.0,23.0,28.0,20.0,25.0,0
6895,CC:2F:71:3E:C5:1F,3827391,482723782,778,95022,3826613,482628760,0,3262,273808,2691,205986,571,67822,823,8,1120,18,0,37,144444.0,39000.0,-68.0,-65.0,-66.0,-61.0,-69.0,-70.0,-66.0,-60.0,-90.0,-93.0,-90.0,-93.0,22.0,28.0,24.0,32.0,0
6896,BA:8C:B9:54:50:24,3831353,488781259,4740,6152499,3826613,482628760,0,8417,1654118,8395,1650623,22,3495,2324,14,5127,36,0,53,229410.0,137640.0,-39.0,-36.0,-45.0,-52.0,-42.0,-35.0,-43.0,-48.0,-90.0,-93.0,-90.0,-93.0,51.0,57.0,45.0,41.0,0
6897,92:69:1D:31:68:E9,3830383,486211205,3766,3582033,3826617,482629172,0,4241,1046843,4121,1019878,120,26965,2013,7,3907,80,0,37,229410.0,137640.0,-52.0,-50.0,-44.0,-46.0,-52.0,-50.0,-44.0,-46.0,-90.0,-93.0,-90.0,-93.0,38.0,43.0,46.0,47.0,0
6898,CC:2F:71:3F:1F:24,4476094,1187686850,649475,705057476,3826619,482629374,37,530206,565466292,529563,565388942,643,77350,512524,10,649712,65763,34,454,130000.0,43333.0,-67.0,-65.0,-70.0,-68.0,-67.0,-65.0,-70.0,-67.0,-90.0,-93.0,-90.0,-93.0,23.0,28.0,20.0,25.0,0
6899,CC:2F:71:3E:C5:1F,3827397,482724396,778,95022,3826619,482629374,0,3262,273808,2691,205986,571,67822,823,8,1120,18,0,37,144444.0,39000.0,-68.0,-65.0,-66.0,-61.0,-69.0,-70.0,-66.0,-60.0,-90.0,-93.0,-90.0,-93.0,22.0,28.0,24.0,32.0,0
6900,BA:8C:B9:54:50:24,3831361,488782075,4740,6152499,3826621,482629576,0,8417,1654118,8395,1650623,22,3495,2324,14,5127,36,0,53,229410.0,137640.0,-39.0,-36.0,-45.0,-52.0,-42.0,-35.0,-43.0,-48.0,-90.0,-93.0,-90.0,-93.0,51.0,57.0,45.0,41.0,0
6901,92:69:1D:31:68:E9,3830389,486211811,3766,3582033,3826623,482629778,0,4241,1046843,4121,1019878,120,26965,2013,7,3907,80,0,37,229410.0,137640.0,-52.0,-50.0,-44.0,-46.0,-52.0,-50.0,-44.0,-46.0,-90.0,-93.0,-90.0,-93.0,38.0,43.0,46.0,47.0,0
6902,CC:2F:71:3F:1F:24,4476140,1187701682,649517,705071904,3826623,482629778,37,530231,565471096,529588,565393746,643,77350,512549,10,649754,65780,34,454,117000.0,39000.0,-67.0,-65.0,-70.0,-67.0,-67.0,-65.0,-70.0,-67.0,-90.0,-93.0,-90.0,-93.0,23.0,28.0,20.0,26.0,0
6903,CC:2F:71:3E:C5:1F,3827401,482724800,778,95022,3826623,482629778,0,3262,273808,2691,205986,571,67822,823,8,1120,18,0,37,144444.0,39000.0,-68.0,-65.0,-66.0,-61.0,-69.0,-70.0,-66.0,-60.0,-90.0,-93.0,-90.0,-93.0,22.0,28.0,24.0,32.0,0
6904,BA:8C:B9:54:50:24,3831364,488782337,4740,6152499,3826624,482629838,0,8417,1654118,8395,1650623,22,3495,2324,14,5127,36,0,53,229410.0,137640.0,-39.0,-36.0,-45.0,-52.0,-42.0,-35.0,-43.0,-48.0,-90.0,-93.0,-90.0,-93.0,51.0,57.0,45.0,41.0,0
6905,92:69:1D:31:68:E9,3830394,486212275,3766,3582033,3826628,482630242,0,4241,1046843,4121,1019878,120,26965,2013,7,3907,80,0,37,229410.0,137640.0,-52.0,-50.0,-44.0,-46.0,-52.0,-50.0,-44.0,-46.0,-90.0,-93.0,-90.0,-93.0,38.0,43.0,46.0,47.0,0
6906,CC:2F:71:3F:1F:24,4476187,1187716574,649559,705086332,3826628,482630242,37,530258,565476156,529615,565398806,643,77350,512576,10,649796,65786,34,454,130000.0,39000.0,-67.0,-65.0,-71.0,-67.0,-67.0,-65.0,-70.0,-67.0,-90.0,-93.0,-90.0,-93.0,23.0,28.0,19.0,26.0,0
6907,CC:2F:71:3E:C5:1F,3827406,482725264,778,95022,3826628,482630242,0,3262,273808,2691,205986,571,67822,823,8,1120,18,0,37,144444.0,39000.0,-68.0,-65.0,-66.0,-61.0,-69.0,-70.0,-66.0,-60.0,-90.0,-93.0,-90.0,-93.0,22.0,28.0,24.0,32.0,0
6908,BA:8C:B9:54:50:24,3831370,488782943,4740,6152499,3826630,482630444,0,8417,1654118,8395,1650623,22,3495,2324,14,5127,36,0,53,229410.0,137640.0,-39.0,-36.0,-45.0,-52.0,-42.0,-35.0,-43.0,-48.0,-90.0,-93.0,-90.0,-93.0,51.0,57.0,45.0,41.0,0
6909,92:69:1D:31:68:E9,3830398,486212679,3766,3582033,3826632,482630646,0,4241,1046843,4121,1019878,120,26965,2013,7,3907,80,0,37,229410.0,137640.0,-52.0,-50.0,-44.0,-46.0,-52.0,-50.0,-44.0,-46.0,-90.0,-93.0,-90.0,-93.0,38.0,43.0,46.0,47.0,0
6910,CC:2F:71:3F:1F:24,4476232,1187731282,649600,705100636,3826632,482630646,37,530284,565481100,529641,565403750,643,77350,512602,10,649837,65823,34,454,144444.0,43333.0,-67.0,-65.0,-70.0,-68.0,-67.0,-65.0,-70.0,-67.0,-90.0,-93.0,-90.0,-93.0,23.0,28.0,20.0,25.0,0
6911,CC:2F:71:3E:C5:1F,3827410,482725668,778,95022,3826632,482630646,0,3262,273808,2691,205986,571,67822,823,8,1120,18,0,37,144444.0,39000.0,-68.0,-65.0,-66.0,-61.0,-69.0,-70.0,-66.0,-60.0,-90.0,-93.0,-90.0,-93.0,22.0,28.0,24.0,32.0,0
6912,BA:8C:B9:54:50:24,3831372,488783145,4740,6152499,3826632,482630646,0,8417,1654118,8395,1650623,22,3495,2324,14,5127,36,0,53,229410.0,137640.0,-39.0,-36.0,-45.0,-52.0,-42.0,-35.0,-43.0,-48.0,-90.0,-93.0,-90.0,-93.0,51.0,57.0,45.0,41.0,0
6913,92:69:1D:31:68:E9,3830403,486213143,3766,3582033,3826637,482631110,0,4241,1046843,4121,1019878,120,26965,2013,7,3907,80,0,37,229410.0,137640.0,-52.0,-50.0,-44.0,-46.0,-52.0,-50.0,-44.0,-46.0,-90.0,-93.0,-90.0,-93.0,38.0,43.0,46.0,47.0,0
6914,CC:2F:71:3F:1F:24,4476279,1187746302,649642,705115192,3826637,482631110,37,530312,565486288,529669,565408938,643,77350,512630,10,649879,65831,34,454,130000.0,43333.0,-67.0,-65.0,-71.0,-67.0,-67.0,-65.0,-70.0,-67.0,-90.0,-93.0,-90.0,-93.0,23.0,28.0,19.0,26.0,0
6915,CC:2F:71:3E:C5:1F,3827415,482726132,778,95022,3826637,482631110,0,3262,273808,2691,205986,571,67822,823,8,1120,18,0,37,144444.0,39000.0,-68.0,-65.0,-66.0,-61.0,-69.0,-70.0,-66.0,-60.0,-90.0,-93.0,-90.0,-93.0,22.0,28.0,24.0,32.0,0
6916,BA:8C:B9:54:50:24,3831379,488783811,4740,6152499,3826639,482631312,0,8417,1654118,8395,1650623,22,3495,2324,14,5127,36,0,53,229410.0,137640.0,-39.0,-36.0,-45.0,-52.0,-42.0,-35.0,-43.0,-48.0,-90.0,-93.0,-90.0,-93.0,51.0,57.0,45.0,41.0,0
6917,92:69:1D:31:68:E9,3830407,486213547,3766,3582033,3826641,482631514,0,4241,1046843,4121,1019878,120,26965,2013,7,3907,80,0,37,229410.0,137640.0,-52.0,-50.0,-44.0,-46.0,-52.0,-50.0,-44.0,-46.0,-90.0,-93.0,-90.0,-93.0,38.0,43.0,46.0,47.0,0
6918,CC:2F:71:3F:1F:24,4476324,1187761122,649683,705129608,3826641,482631514,37,530339,565491384,529696,565414034,643,77350,512657,10,649920,65835,34,454,130000.0,43333.0,-67.0,-65.0,-70.0,-67.0,-67.0,-65.0,-70.0,-67.0,-90.0,-93.0,-90.0,-93.0,23.0,28.0,20.0,26.0,0
6919,CC:2F:71:3E:C5:1F,3827419,482726536,778,95022,3826641,482631514,0,3262,273808,2691,205986,571,67822,823,8,1120,18,0,37,144444.0,39000.0,-68.0,-65.0,-66.0,-61.0,-69.0,-70.0,-66.0,-60.0,-90.0,-93.0,-90.0,-93.0,22.0,28.0,24.0,32.0,0
6920,BA:8C:B9:54:50:24,3831381,488784013,4740,6152499,3826641,482631514,0,8417,1654118,8395,1650623,22,3495,2324,14,5127,36,0,53,229410.0,137640.0,-39.0,-36.0,-45.0,-52.0,-42.0,-35.0,-43.0,-48.0,-90.0,-93.0,-90.0,-93.0,51.0,57.0,45.0,41.0,0
6921,92:69:1D:31:68:E9,3830411,486213951,3766,3582033,3826645,482631918,0,4241,1046843,4121,1019878,120,26965,2013,7,3907,80,0,37,229410.0,137640.0,-52.0,-50.0,-44.0,-46.0,-52.0,-50.0,-44.0,-46.0,-90.0,-93.0,-90.0,-93.0,38.0,43.0,46.0,47.0,0
6922,CC:2F:71:3F:1F:24,4476371,1187776078,649726,705144160,3826645,482631918,37,530364,565496188,529721,565418838,643,77350,512682,10,649963,65853,34,454,117000.0,39000.0,-67.0,-65.0,-70.0,-67.0,-67.0,-65.0,-70.0,-67.0,-90.0,-93.0,-90.0,-93.0,23.0,28.0,20.0,26.0,0
6923,CC:2F:71:3E:C5:1F,3827423,482726940,778,95022,3826645,482631918,0,3262,273808,2691,205986,571,67822,823,8,1120,18,0,37,144444.0,39000.0,-68.0,-65.0,-66.0,-61.0,-69.0,-70.0,-66.0,-60.0,-90.0,-93.0,-90.0,-93.0,22.0,28.0,24.0,32.0,0
6924,BA:8C:B9:54:50:24,3831385,488784417,4740,6152499,3826645,482631918,0,8417,1654118,8395,1650623,22,3495,2324,14,5127,36,0,53,229410.0,137640.0,-39.0,-36.0,-45.0,-52.0,-42.0,-35.0,-43.0,-48.0,-90.0,-93.0,-90.0,-93.0,51.0,57.0,45.0,41.0,0
6925,92:69:1D:31:68:E9,3830416,486214415,3766,3582033,3826650,482632382,0,4242,1046911,4122,1019946,120,26965,2013,7,3907,80,0,37,229410.0,137640.0,-52.0,-50.0,-44.0,-46.0,-52.0,-50.0,-44.0,-46.0,-90.0,-93.0,-90.0,-93.0,38.0,43.0,46.0,47.0,0
6926,CC:2F:71:3F:1F:24,4476417,1187790846,649767,705158464,3826650,482632382,37,530392,565501388,529749,565424038,643,77350,512710,10,650004,65856,34,454,130000.0,43333.0,-67.0,-65.0,-70.0,-67.0,-67.0,-65.0,-70.0,-67.0,-90.0,-93.0,-90.0,-93.0,23.0,28.0,20.0,26.0,0
6927,CC:2F:71:3E:C5:1F,3827428,482727404,778,95022,3826650,482632382,0,3262,273808,2691,205986,571,67822,823,8,1120,18,0,37,144444.0,39000.0,-68.0,-65.0,-66.0,-61.0,-69.0,-70.0,-66.0,-60.0,-90.0,-93.0,-90.0,-93.0,22.0,28.0,24.0,32.0,0
6928,BA:8C:B9:54:50:24,3831390,488784881,4740,6152499,3826650,482632382,0,8417,1654118,8395,1650623,22,3495,2324,14,5127,36,0,53,229410.0,137640.0,-39.0,-36.0,-45.0,-52.0,-42.0,-35.0,-43.0,-48.0,-90.0,-93.0,-90.0,-93.0,51.0,57.0,45.0,41.0,0
6929,92:69:1D:31:68:E9,3830420,486214819,3766,3582033,3826654,482632786,0,4242,1046911,4122,1019946,120,26965,2013,7,3907,80,0,37,229410.0,137640.0,-52.0,-50.0,-44.0,-46.0,-52.0,-50.0,-44.0,-46.0,-90.0,-93.0,-90.0,-93.0,38.0,43.0,46.0,47.0,0
6930,CC:2F:71:3F:1F:24,4476462,1187805666,649808,705172880,3826654,482632786,37,530417,565506192,529774,565428842,643,77350,512735,10,650045,65856,34,454,130000.0,43333.0,-67.0,-65.0,-71.0,-68.0,-67.0,-65.0,-70.0,-67.0,-90.0,-93.0,-90.0,-93.0,23.0,28.0,19.0,25.0,0
6931,CC:2F:71:3E:C5:1F,3827432,482727808,778,95022,3826654,482632786,0,3262,273808,2691,205986,571,67822,823,8,1120,18,0,37,144444.0,39000.0,-68.0,-65.0,-66.0,-61.0,-69.0,-70.0,-66.0,-60.0,-90.0,-93.0,-90.0,-93.0,22.0,28.0,24.0,32.0,0
6932,BA:8C:B9:54:50:24,3831394,488785285,4740,6152499,3826654,482632786,0,8417,1654118,8395,1650623,22,3495,2324,14,5127,36,0,53,229410.0,137640.0,-39.0,-36.0,-45.0,-52.0,-42.0,-35.0,-43.0,-48.0,-90.0,-93.0,-90.0,-93.0,51.0,57.0,45.0,41.0,0
6933,92:69:1D:31:68:E9,3830424,486215223,3766,3582033,3826658,482633190,0,4242,1046911,4122,1019946,120,26965,2013,7,3907,80,0,37,229410.0,137640.0,-52.0,-50.0,-44.0,-46.0,-52.0,-50.0,-44.0,-46.0,-90.0,-93.0,-90.0,-93.0,38.0,43.0,46.0,47.0,0
6934,CC:2F:71:3F:1F:24,4476510,1187820688,649851,705187438,3826659,482633250,37,530443,565511112,529800,565433762,643,77350,512761,10,650088,65873,34,454,117000.0,39000.0,-67.0,-65.0,-70.0,-68.0,-67.0,-65.0,-70.0,-67.0,-90.0,-93.0,-90.0,-93.0,23.0,28.0,20.0,25.0,0
6935,CC:2F:71:3E:C5:1F,3827437,482728272,778,95022,3826659,482633250,0,3262,273808,2691,205986,571,67822,823,8,1120,18,0,37,144444.0,39000.0,-68.0,-65.0,-66.0,-61.0,-69.0,-70.0,-66.0,-60.0,-90.0,-93.0,-90.0,-93.0,22.0,28.0,24.0,32.0,0
6936,BA:8C:B9:54:50:24,3831399,488785749,4740,6152499,3826659,482633250,0,8417,1654118,8395,1650623,22,3495,2324,14,5127,36,0,53,229410.0,137640.0,-39.0,-36.0,-45.0,-52.0,-42.0,-35.0,-43.0,-48.0,-90.0,-93.0,-90.0,-93.0,51.0,57.0,45.0,41.0,0
6937,92:69:1D:31:68:E9,3830429,486215687,3766,3582033,3826663,482633654,0,4242,1046911,4122,1019946,120,26965,2013,7,3907,80,0,37,229410.0,137640.0,-52.0,-50.0,-44.0,-46.0,-52.0,-50.0,-44.0,-46.0,-90.0,-93.0,-90.0,-93.0,38.0,43.0,46.0,47.0,0
6938,CC:2F:71:3F:1F:24,4476557,1187835636,649894,705201982,3826663,482633654,37,530469,565516032,529826,565438682,643,77350,512787,10,650131,65876,34,454,130000.0,43333.0,-67.0,-65.0,-70.0,-67.0,-67.0,-65.0,-70.0,-67.0,-90.0,-93.0,-90.0,-93.0,23.0,28.0,20.0,26.0,0
6939,CC:2F:71:3E:C5:1F,3827442,482728792,779,95138,3826663,482633654,0,3264,273948,2693,206126,571,67822,823,8,1121,18,0,37,144444.0,39000.0,-70.0,-71.0,-67.0,-60.0,-69.0,-70.0,-66.0,-60.0,-90.0,-93.0,-90.0,-93.0,20.0,22.0,23.0,33.0,0
6940,BA:8C:B9:54:50:24,3831404,488786213,4741,6152559,3826663,482633654,0,8423,1654526,8401,1651031,22,3495,2324,14,5128,36,0,53,216660.0,130000.0,-49.0,-35.0,-42.0,-44.0,-42.0,-35.0,-42.0,-46.0,-90.0,-93.0,-90.0,-93.0,41.0,58.0,48.0,49.0,0
6941,92:69:1D:31:68:E9,3830436,486216361,3767,3582093,3826669,482634268,0,4244,1047047,4124,1020082,120,26965,2013,7,3908,80,0,37,216660.0,130000.0,-51.0,-47.0,-43.0,-49.0,-52.0,-49.0,-44.0,-47.0,-90.0,-93.0,-90.0,-93.0,39.0,46.0,47.0,44.0,0
6942,CC:2F:71:3F:1F:24,4476607,1187851081,649937,705216540,3826670,482634541,37,530495,565520976,529852,565443626,643,77350,512813,10,650174,65894,34,454,117000.0,39000.0,-67.0,-65.0,-70.0,-68.0,-67.0,-65.0,-70.0,-67.0,-90.0,-93.0,-90.0,-93.0,23.0,28.0,20.0,25.0,0
6943,CC:2F:71:3E:C5:1F,3827449,482729679,779,95138,3826670,482634541,0,3264,273948,2693,206126,571,67822,823,8,1121,18,0,37,144444.0,39000.0,-70.0,-71.0,-67.0,-60.0,-69.0,-70.0,-66.0,-60.0,-90.0,-93.0,-90.0,-93.0,20.0,22.0,23.0,33.0,0
6944,BA:8C:B9:54:50:24,3831411,488787100,4741,6152559,3826670,482634541,0,8423,1654526,8401,1651031,22,3495,2324,14,5128,36,0,53,216660.0,130000.0,-49.0,-35.0,-42.0,-44.0,-42.0,-35.0,-42.0,-46.0,-90.0,-93.0,-90.0,-93.0,41.0,58.0,48.0,49.0,0
6945,92:69:1D:31:68:E9,3830442,486217098,3767,3582093,3826675,482635005,0,4244,1047047,4124,1020082,120,26965,2013,7,3908,80,0,37,216660.0,130000.0,-51.0,-47.0,-43.0,-49.0,-52.0,-49.0,-44.0,-47.0,-90.0,-93.0,-90.0,-93.0,39.0,46.0,47.0,44.0,0
6946,CC:2F:71:3F:1F:24,4476653,1187865849,649978,705230844,3826675,482635005,37,530521,565525920,529878,565448570,643,77350,512839,10,650215,65897,34,454,130000.0,43333.0,-67.0,-65.0,-70.0,-67.0,-67.0,-65.0,-70.0,-67.0,-90.0,-93.0,-90.0,-93.0,23.0,28.0,20.0,26.0,0
6947,CC:2F:71:3E:C5:1F,3827454,482730143,779,95138,3826675,482635005,0,3264,273948,2693,206126,571,67822,823,8,1121,18,0,37,144444.0,39000.0,-70.0,-71.0,-67.0,-60.0,-69.0,-70.0,-66.0,-60.0,-90.0,-93.0,-90.0,-93.0,20.0,22.0,23.0,33.0,0
6948,BA:8C:B9:54:50:24,3831416,488787564,4741,6152559,3826675,482635005,0,8423,1654526,8401,1651031,22,3495,2324,14,5128,36,0,53,216660.0,130000.0,-49.0,-35.0,-42.0,-44.0,-42.0,-35.0,-42.0,-46.0,-90.0,-93.0,-90.0,-93.0,41.0,58.0,48.0,49.0,0
6949,92:69:1D:31:68:E9,3830446,486217502,3767,3582093,3826679,482635409,0,4244,1047047,4124,1020082,120,26965,2013,7,3908,80,0,37,216660.0,130000.0,-51.0,-47.0,-43.0,-49.0,-52.0,-49.0,-44.0,-47.0,-90.0,-93.0,-90.0,-93.0,39.0,46.0,47.0,44.0,0
6950,CC:2F:71:3F:1F:24,4476699,1187880737,650020,705245328,3826679,482635409,37,530548,565531004,529905,565453654,643,77350,512866,10,650257,65911,34,454,130000.0,39000.0,-67.0,-65.0,-70.0,-67.0,-67.0,-65.0,-70.0,-67.0,-90.0,-93.0,-90.0,-93.0,23.0,28.0,20.0,26.0,0
6951,CC:2F:71:3E:C5:1F,3827458,482730547,779,95138,3826679,482635409,0,3264,273948,2693,206126,571,67822,823,8,1121,18,0,37,144444.0,39000.0,-70.0,-71.0,-67.0,-60.0,-69.0,-70.0,-66.0,-60.0,-90.0,-93.0,-90.0,-93.0,20.0,22.0,23.0,33.0,0
6952,BA:8C:B9:54:50:24,3831420,488787968,4741,6152559,3826679,482635409,0,8423,1654526,8401,1651031,22,3495,2324,14,5128,36,0,53,216660.0,130000.0,-49.0,-35.0,-42.0,-44.0,-42.0,-35.0,-42.0,-46.0,-90.0,-93.0,-90.0,-93.0,41.0,58.0,48.0,49.0,0
6953,92:69:1D:31:68:E9,3830450,486217906,3767,3582093,3826683,482635813,0,4244,1047047,4124,1020082,120,26965,2013,7,3908,80,0,37,216660.0,130000.0,-51.0,-47.0,-43.0,-49.0,-52.0,-49.0,-44.0,-47.0,-90.0,-93.0,-90.0,-93.0,39.0,46.0,47.0,44.0,0
6954,CC:2F:71:3F:1F:24,4476746,1187895637,650063,705259824,3826683,482635813,37,530574,565535948,529931,565458598,643,77350,512892,10,650299,65940,34,454,130000.0,43333.0,-67.0,-65.0,-70.0,-67.0,-67.0,-65.0,-70.0,-67.0,-90.0,-93.0,-90.0,-93.0,23.0,28.0,20.0,26.0,0
6955,CC:2F:71:3E:C5:1F,3827462,482730951,779,95138,3826683,482635813,0,3264,273948,2693,206126,571,67822,823,8,1121,18,0,37,144444.0,39000.0,-70.0,-71.0,-67.0,-60.0,-69.0,-70.0,-66.0,-60.0,-90.0,-93.0,-90.0,-93.0,20.0,22.0,23.0,33.0,0
6956,BA:8C:B9:54:50:24,3831424,488788372,4741,6152559,3826683,482635813,0,8423,1654526,8401,1651031,22,3495,2324,14,5128,36,0,53,216660.0,130000.0,-49.0,-35.0,-42.0,-44.0,-42.0,-35.0,-42.0,-46.0,-90.0,-93.0,-90.0,-93.0,41.0,58.0,48.0,49.0,0
6957,92:69:1D:31:68:E9,3830457,486218738,3767,3582093,3826690,482636645,0,4244,1047047,4124,1020082,120,26965,2013,7,3908,80,0,37,216660.0,130000.0,-51.0,-47.0,-43.0,-49.0,-52.0,-49.0,-44.0,-47.0,-90.0,-93.0,-90.0,-93.0,39.0,46.0,47.0,44.0,0
6958,CC:2F:71:3F:1F:24,4476794,1187910879,650104,705274234,3826690,482636645,37,530600,565540892,529957,565463542,643,77350,512918,10,650341,65946,34,454,130000.0,43333.0,-67.0,-65.0,-70.0,-67.0,-67.0,-65.0,-70.0,-67.0,-90.0,-93.0,-90.0,-93.0,23.0,28.0,20.0,26.0,0
6959,CC:2F:71:3E:C5:1F,3827469,482731783,779,95138,3826690,482636645,0,3264,273948,2693,206126,571,67822,823,8,1121,18,0,37,144444.0,39000.0,-70.0,-71.0,-67.0,-60.0,-69.0,-70.0,-66.0,-60.0,-90.0,-93.0,-90.0,-93.0,20.0,22.0,23.0,33.0,0
6960,BA:8C:B9:54:50:24,3831431,488789204,4741,6152559,3826690,482636645,0,8423,1654526,8401,1651031,22,3495,2324,14,5128,36,0,53,216660.0,130000.0,-49.0,-35.0,-42.0,-44.0,-42.0,-35.0,-42.0,-46.0,-90.0,-93.0,-90.0,-93.0,41.0,58.0,48.0,49.0,0
6961,92:69:1D:31:68:E9,3830461,486219142,3767,3582093,3826694,482637049,0,4244,1047047,4124,1020082,120,26965,2013,7,3908,80,0,37,216660.0,130000.0,-51.0,-47.0,-43.0,-49.0,-52.0,-49.0,-44.0,-47.0,-90.0,-93.0,-90.0,-93.0,39.0,46.0,47.0,44.0,0
6962,CC:2F:71:3F:1F:24,4476841,1187925947,650147,705288898,3826694,482637049,37,530625,565545696,529982,565468346,643,77350,512943,10,650384,65948,34,454,130000.0,43333.0,-67.0,-65.0,-71.0,-67.0,-67.0,-65.0,-70.0,-67.0,-90.0,-93.0,-90.0,-93.0,23.0,28.0,19.0,26.0,0
6963,CC:2F:71:3E:C5:1F,3827473,482732187,779,95138,3826694,482637049,0,3264,273948,2693,206126,571,67822,823,8,1121,18,0,37,144444.0,39000.0,-70.0,-71.0,-67.0,-60.0,-69.0,-70.0,-66.0,-60.0,-90.0,-93.0,-90.0,-93.0,20.0,22.0,23.0,33.0,0
6964,BA:8C:B9:54:50:24,3831435,488789608,4741,6152559,3826694,482637049,0,8423,1654526,8401,1651031,22,3495,2324,14,5128,36,0,53,216660.0,130000.0,-49.0,-35.0,-42.0,-44.0,-42.0,-35.0,-42.0,-46.0,-90.0,-93.0,-90.0,-93.0,41.0,58.0,48.0,49.0,0
6965,92:69:1D:31:68:E9,3830466,486219606,3767,3582093,3826699,482637513,0,4246,1047183,4126,1020218,120,26965,2013,7,3909,80,0,37,216660.0,130000.0,-52.0,-50.0,-44.0,-46.0,-51.0,-49.0,-43.0,-47.0,-90.0,-93.0,-90.0,-93.0,38.0,43.0,46.0,47.0,0
6966,CC:2F:71:3F:1F:24,4476887,1187940715,650188,705303202,3826699,482637513,37,530651,565550640,530008,565473290,643,77350,512969,10,650425,65970,34,454,117000.0,39000.0,-67.0,-65.0,-70.0,-68.0,-67.0,-65.0,-70.0,-67.0,-90.0,-93.0,-90.0,-93.0,23.0,28.0,20.0,25.0,0
6967,CC:2F:71:3E:C5:1F,3827478,482732651,779,95138,3826699,482637513,0,3266,274088,2695,206266,571,67822,823,8,1122,18,0,37,144444.0,39000.0,-70.0,-71.0,-68.0,-60.0,-69.0,-70.0,-67.0,-60.0,-90.0,-93.0,-90.0,-93.0,20.0,22.0,22.0,33.0,0
6968,BA:8C:B9:54:50:24,3831440,488790072,4741,6152559,3826699,482637513,0,8425,1654662,8403,1651167,22,3495,2324,14,5129,36,0,53,216660.0,130000.0,-51.0,-35.0,-43.0,-43.0,-42.0,-35.0,-42.0,-46.0,-90.0,-93.0,-90.0,-93.0,39.0,58.0,47.0,50.0,0
6969,92:69:1D:31:68:E9,3830470,486220010,3767,3582093,3826703,482637917,0,4246,1047183,4126,1020218,120,26965,2013,7,3909,80,0,37,216660.0,130000.0,-52.0,-50.0,-44.0,-46.0,-51.0,-49.0,-43.0,-47.0,-90.0,-93.0,-90.0,-93.0,38.0,43.0,46.0,47.0,0
6970,CC:2F:71:3F:1F:24,4476933,1187955491,650230,705317574,3826703,482637917,37,530677,565555620,530034,565478270,643,77350,512995,10,650467,65983,34,454,130000.0,39000.0,-67.0,-65.0,-70.0,-68.0,-67.0,-65.0,-70.0,-67.0,-90.0,-93.0,-90.0,-93.0,23.0,28.0,20.0,25.0,0
6971,CC:2F:71:3E:C5:1F,3827482,482733055,779,95138,3826703,482637917,0,3266,274088,2695,206266,571,67822,823,8,1122,18,0,37,144444.0,39000.0,-70.0,-71.0,-68.0,-60.0,-69.0,-70.0,-67.0,-60.0,-90.0,-93.0,-90.0,-93.0,20.0,22.0,22.0,33.0,0
6972,BA:8C:B9:54:50:24,3831444,488790476,4741,6152559,3826703,482637917,0,8425,1654662,8403,1651167,22,3495,2324,14,5129,36,0,53,216660.0,130000.0,-51.0,-35.0,-43.0,-43.0,-42.0,-35.0,-42.0,-46.0,-90.0,-93.0,-90.0,-93.0,39.0,58.0,47.0,50.0,0
6973,92:69:1D:31:68:E9,3830475,486220476,3767,3582093,3826708,482638383,0,4246,1047183,4126,1020218,120,26965,2013,7,3909,80,0,37,216660.0,130000.0,-52.0,-50.0,-44.0,-46.0,-51.0,-49.0,-43.0,-47.0,-90.0,-93.0,-90.0,-93.0,38.0,43.0,46.0,47.0,0
6974,CC:2F:71:3F:1F:24,4476982,1187970639,650274,705332256,3826708,482638383,37,530704,565560682,530060,565483214,644,77468,513022,10,650511,66003,34,454,130000.0,39000.0,-67.0,-66.0,-71.0,-68.0,-67.0,-65.0,-70.0,-67.0,-90.0,-93.0,-90.0,-93.0,23.0,27.0,19.0,25.0,0
6975,CC:2F:71:3E:C5:1F,3827487,482733521,779,95138,3826708,482638383,0,3266,274088,2695,206266,571,67822,823,8,1122,18,0,37,144444.0,39000.0,-70.0,-71.0,-68.0,-60.0,-69.0,-70.0,-67.0,-60.0,-90.0,-93.0,-90.0,-93.0,20.0,22.0,22.0,33.0,0
6976,BA:8C:B9:54:50:24,3831449,488790942,4741,6152559,3826708,482638383,0,8425,1654662,8403,1651167,22,3495,2324,14,5129,36,0,53,216660.0,130000.0,-51.0,-35.0,-43.0,-43.0,-42.0,-35.0,-42.0,-46.0,-90.0,-93.0,-90.0,-93.0,39.0,58.0,47.0,50.0,0
6977,92:69:1D:31:68:E9,3830480,486220940,3767,3582093,3826713,482638847,0,4246,1047183,4126,1020218,120,26965,2013,7,3909,80,0,37,216660.0,130000.0,-52.0,-50.0,-44.0,-46.0,-51.0,-49.0,-43.0,-47.0,-90.0,-93.0,-90.0,-93.0,38.0,43.0,46.0,47.0,0
6978,CC:2F:71:3F:1F:24,4477029,1187985531,650316,705346684,3826713,482638847,37,530729,565565486,530085,565488018,644,77468,513047,10,650553,66006,34,454,130000.0,39000.0,-67.0,-65.0,-70.0,-67.0,-67.0,-65.0,-70.0,-67.0,-90.0,-93.0,-90.0,-93.0,23.0,28.0,20.0,26.0,0
6979,CC:2F:71:3E:C5:1F,3827492,482733985,779,95138,3826713,482638847,0,3266,274088,2695,206266,571,67822,823,8,1122,18,0,37,144444.0,39000.0,-70.0,-71.0,-68.0,-60.0,-69.0,-70.0,-67.0,-60.0,-90.0,-93.0,-90.0,-93.0,20.0,22.0,22.0,33.0,0
6980,BA:8C:B9:54:50:24,3831454,488791406,4741,6152559,3826713,482638847,0,8425,1654662,8403,1651167,22,3495,2324,14,5129,36,0,53,216660.0,130000.0,-51.0,-35.0,-43.0,-43.0,-42.0,-35.0,-42.0,-46.0,-90.0,-93.0,-90.0,-93.0,39.0,58.0,47.0,50.0,0
6981,92:69:1D:31:68:E9,3830484,486221344,3767,3582093,3826717,482639251,0,4246,1047183,4126,1020218,120,26965,2013,7,3909,80,0,37,216660.0,130000.0,-52.0,-50.0,-44.0,-46.0,-51.0,-49.0,-43.0,-47.0,-90.0,-93.0,-90.0,-93.0,38.0,43.0,46.0,47.0,0
6982,CC:2F:71:3F:1F:24,4477076,1188000487,650359,705361236,3826717,482639251,37,530756,565570570,530112,565493102,644,77468,513074,10,650596,66022,34,454,130000.0,39000.0,-67.0,-65.0,-70.0,-68.0,-67.0,-65.0,-70.0,-67.0,-90.0,-93.0,-90.0,-93.0,23.0,28.0,20.0,25.0,0
6983,CC:2F:71:3E:C5:1F,3827496,482734389,779,95138,3826717,482639251,0,3266,274088,2695,206266,571,67822,823,8,1122,18,0,37,144444.0,39000.0,-70.0,-71.0,-68.0,-60.0,-69.0,-70.0,-67.0,-60.0,-90.0,-93.0,-90.0,-93.0,20.0,22.0,22.0,33.0,0
6984,BA:8C:B9:54:50:24,3831459,488791872,4741,6152559,3826718,482639313,0,8425,1654662,8403,1651167,22,3495,2324,14,5129,36,0,53,216660.0,130000.0,-51.0,-35.0,-43.0,-43.0,-42.0,-35.0,-42.0,-46.0,-90.0,-93.0,-90.0,-93.0,39.0,58.0,47.0,50.0,0
6985,92:69:1D:31:68:E9,3830489,486221810,3767,3582093,3826722,482639717,0,4246,1047183,4126,1020218,120,26965,2013,7,3909,80,0,37,216660.0,130000.0,-52.0,-50.0,-44.0,-46.0,-51.0,-49.0,-43.0,-47.0,-90.0,-93.0,-90.0,-93.0,38.0,43.0,46.0,47.0,0
6986,CC:2F:71:3F:1F:24,4477123,1188015437,650401,705375720,3826722,482639717,37,530781,565575374,530137,565497906,644,77468,513099,10,650638,66024,34,454,130000.0,43333.0,-67.0,-65.0,-70.0,-68.0,-67.0,-65.0,-70.0,-67.0,-90.0,-93.0,-90.0,-93.0,23.0,28.0,20.0,25.0,0
6987,CC:2F:71:3E:C5:1F,3827501,482734855,779,95138,3826722,482639717,0,3268,274276,2696,206336,572,67940,824,8,1122,18,0,37,144444.0,39000.0,-70.0,-71.0,-68.0,-60.0,-69.0,-70.0,-67.0,-60.0,-90.0,-93.0,-90.0,-93.0,20.0,22.0,22.0,33.0,0
6988,BA:8C:B9:54:50:24,3831464,488792336,4741,6152559,3826723,482639777,0,8425,1654662,8403,1651167,22,3495,2324,14,5129,36,0,53,216660.0,130000.0,-51.0,-35.0,-43.0,-43.0,-42.0,-35.0,-42.0,-46.0,-90.0,-93.0,-90.0,-93.0,39.0,58.0,47.0,50.0,0
6989,92:69:1D:31:68:E9,3830494,486222274,3767,3582093,3826727,482640181,0,4246,1047183,4126,1020218,120,26965,2013,7,3909,80,0,37,216660.0,130000.0,-52.0,-50.0,-44.0,-46.0,-51.0,-49.0,-43.0,-47.0,-90.0,-93.0,-90.0,-93.0,38.0,43.0,46.0,47.0,0
6990,CC:2F:71:3F:1F:24,4477169,1188030199,650442,705390018,3826727,482640181,37,530808,565580434,530164,565502966,644,77468,513126,10,650679,66041,34,454,117000.0,39000.0,-67.0,-65.0,-70.0,-67.0,-67.0,-65.0,-70.0,-67.0,-90.0,-93.0,-90.0,-93.0,23.0,28.0,20.0,26.0,0
6991,CC:2F:71:3E:C5:1F,3827506,482735319,779,95138,3826727,482640181,0,3268,274276,2696,206336,572,67940,824,8,1122,18,0,37,144444.0,39000.0,-70.0,-71.0,-68.0,-60.0,-69.0,-70.0,-67.0,-60.0,-90.0,-93.0,-90.0,-93.0,20.0,22.0,22.0,33.0,0
6992,BA:8C:B9:54:50:24,3831468,488792740,4741,6152559,3826727,482640181,0,8425,1654662,8403,1651167,22,3495,2324,14,5129,36,0,53,216660.0,130000.0,-51.0,-35.0,-43.0,-43.0,-42.0,-35.0,-42.0,-46.0,-90.0,-93.0,-90.0,-93.0,39.0,58.0,47.0,50.0,0
6993,92:69:1D:31:68:E9,3830498,486222678,3767,3582093,3826731,482640585,0,4246,1047183,4126,1020218,120,26965,2013,7,3909,80,0,37,216660.0,130000.0,-52.0,-50.0,-44.0,-46.0,-51.0,-49.0,-43.0,-47.0,-90.0,-93.0,-90.0,-93.0,38.0,43.0,46.0,47.0,0
6994,CC:2F:71:3F:1F:24,4477214,1188045035,650483,705404450,3826731,482640585,37,530837,565585738,530193,565508270,644,77468,513155,10,650720,66043,34,454,130000.0,43333.0,-67.0,-65.0,-70.0,-67.0,-67.0,-65.0,-70.0,-67.0,-90.0,-93.0,-90.0,-93.0,23.0,28.0,20.0,26.0,0
6995,CC:2F:71:3E:C5:1F,3827510,482735723,779,95138,3826731,482640585,0,3268,274276,2696,206336,572,67940,824,8,1122,18,0,37,144444.0,39000.0,-70.0,-71.0,-68.0,-60.0,-69.0,-70.0,-67.0,-60.0,-90.0,-93.0,-90.0,-93.0,20.0,22.0,22.0,33.0,0
6996,BA:8C:B9:54:50:24,3831473,488793417,4741,6152559,3826732,482640858,0,8425,1654662,8403,1651167,22,3495,2324,14,5129,36,0,53,216660.0,130000.0,-51.0,-35.0,-43.0,-43.0,-42.0,-35.0,-42.0,-46.0,-90.0,-93.0,-90.0,-93.0,39.0,58.0,47.0,50.0,0
6997,92:69:1D:31:68:E9,3830504,486223415,3767,3582093,3826737,482641322,0,4246,1047183,4126,1020218,120,26965,2013,7,3909,80,0,37,216660.0,130000.0,-52.0,-50.0,-44.0,-46.0,-51.0,-49.0,-43.0,-47.0,-90.0,-93.0,-90.0,-93.0,38.0,43.0,46.0,47.0,0
6998,CC:2F:71:3F:1F:24,4477263,1188060324,650526,705419002,3826737,482641322,37,530864,565590774,530220,565513306,644,77468,513182,10,650763,66063,34,454,117000.0,39000.0,-67.0,-65.0,-70.0,-67.0,-67.0,-65.0,-70.0,-67.0,-90.0,-93.0,-90.0,-93.0,23.0,28.0,20.0,26.0,0
6999,CC:2F:71:3E:C5:1F,3827516,482736460,779,95138,3826737,482641322,0,3268,274276,2696,206336,572,67940,824,8,1122,18,0,37,144444.0,39000.0,-70.0,-71.0,-68.0,-60.0,-69.0,-70.0,-67.0,-60.0,-90.0,-93.0,-90.0,-93.0,20.0,22.0,22.0,33.0,0
7000,BA:8C:B9:54:50:24,3831478,488793881,4741,6152559,3826737,482641322,0,8426,1654730,8404,1651235,22,3495,2324,14,5129,36,0,53,216660.0,130000.0,-49.0,-35.0,-42.0,-44.0,-44.0,-35.0,-42.0,-45.0,-90.0,-93.0,-90.0,-93.0,41.0,58.0,48.0,49.0,0
7001,92:69:1D:31:68:E9,3830508,486223819,3767,3582093,3826741,482641726,0,4246,1047183,4126,1020218,120,26965,2013,7,3909,80,0,37,216660.0,130000.0,-52.0,-50.0,-44.0,-46.0,-51.0,-49.0,-43.0,-47.0,-90.0,-93.0,-90.0,-93.0,38.0,43.0,46.0,47.0,0
7002,CC:2F:71:3F:1F:24,4477311,1188075410,650570,705433684,3826741,482641726,37,530892,565595974,530248,565518506,644,77468,513210,10,650807,66070,34,454,130000.0,43333.0,-67.0,-65.0,-70.0,-68.0,-67.0,-65.0,-70.0,-67.0,-90.0,-93.0,-90.0,-93.0,23.0,28.0,20.0,25.0,0
7003,CC:2F:71:3E:C5:1F,3827520,482736864,779,95138,3826741,482641726,0,3268,274276,2696,206336,572,67940,824,8,1122,18,0,37,144444.0,39000.0,-70.0,-71.0,-68.0,-60.0,-69.0,-70.0,-67.0,-60.0,-90.0,-93.0,-90.0,-93.0,20.0,22.0,22.0,33.0,0
7004,BA:8C:B9:54:50:24,3831482,488794285,4741,6152559,3826741,482641726,0,8426,1654730,8404,1651235,22,3495,2324,14,5129,36,0,53,216660.0,130000.0,-49.0,-35.0,-42.0,-44.0,-44.0,-35.0,-42.0,-45.0,-90.0,-93.0,-90.0,-93.0,41.0,58.0,48.0,49.0,0
7005,92:69:1D:31:68:E9,3830512,486224223,3767,3582093,3826745,482642130,0,4246,1047183,4126,1020218,120,26965,2013,7,3909,80,0,37,216660.0,130000.0,-52.0,-50.0,-44.0,-46.0,-51.0,-49.0,-43.0,-47.0,-90.0,-93.0,-90.0,-93.0,38.0,43.0,46.0,47.0,0
7006,CC:2F:71:3F:1F:24,4477357,1188090242,650612,705448112,3826745,482642130,37,530922,565601406,530278,565523938,644,77468,513240,10,650849,66092,34,454,117000.0,39000.0,-67.0,-65.0,-70.0,-67.0,-67.0,-65.0,-70.0,-67.0,-90.0,-93.0,-90.0,-93.0,23.0,28.0,20.0,26.0,0
7007,CC:2F:71:3E:C5:1F,3827524,482737268,779,95138,3826745,482642130,0,3268,274276,2696,206336,572,67940,824,8,1122,18,0,37,144444.0,39000.0,-70.0,-71.0,-68.0,-60.0,-69.0,-70.0,-67.0,-60.0,-90.0,-93.0,-90.0,-93.0,20.0,22.0,22.0,33.0,0
7008,BA:8C:B9:54:50:24,3831486,488794689,4741,6152559,3826745,482642130,0,8426,1654730,8404,1651235,22,3495,2324,14,5129,36,0,53,216660.0,130000.0,-49.0,-35.0,-42.0,-44.0,-44.0,-35.0,-42.0,-45.0,-90.0,-93.0,-90.0,-93.0,41.0,58.0,48.0,49.0,0
7009,92:69:1D:31:68:E9,3830517,486224687,3767,3582093,3826750,482642594,0,4246,1047183,4126,1020218,120,26965,2013,7,3909,80,0,37,216660.0,130000.0,-52.0,-50.0,-44.0,-46.0,-51.0,-49.0,-43.0,-47.0,-90.0,-93.0,-90.0,-93.0,38.0,43.0,46.0,47.0,0
7010,CC:2F:71:3F:1F:24,4477408,1188105770,650658,705463176,3826750,482642594,37,530952,565606850,530308,565529382,644,77468,513270,10,650895,66098,34,454,130000.0,43333.0,-67.0,-65.0,-70.0,-68.0,-67.0,-65.0,-70.0,-67.0,-90.0,-93.0,-90.0,-93.0,23.0,28.0,20.0,25.0,0
7011,CC:2F:71:3E:C5:1F,3827529,482737732,779,95138,3826750,482642594,0,3268,274276,2696,206336,572,67940,824,8,1122,18,0,37,144444.0,39000.0,-70.0,-71.0,-68.0,-60.0,-69.0,-70.0,-67.0,-60.0,-90.0,-93.0,-90.0,-93.0,20.0,22.0,22.0,33.0,0
7012,BA:8C:B9:54:50:24,3831491,488795153,4741,6152559,3826750,482642594,0,8426,1654730,8404,1651235,22,3495,2324,14,5129,36,0,53,216660.0,130000.0,-49.0,-35.0,-42.0,-44.0,-44.0,-35.0,-42.0,-45.0,-90.0,-93.0,-90.0,-93.0,41.0,58.0,48.0,49.0,0
7013,92:69:1D:31:68:E9,3830521,486225091,3767,3582093,3826754,482642998,0,4246,1047183,4126,1020218,120,26965,2013,7,3909,80,0,37,216660.0,130000.0,-52.0,-50.0,-44.0,-46.0,-51.0,-49.0,-43.0,-47.0,-90.0,-93.0,-90.0,-93.0,38.0,43.0,46.0,47.0,0
7014,CC:2F:71:3F:1F:24,4477454,1188120714,650700,705477716,3826754,482642998,37,530977,565611654,530333,565534186,644,77468,513295,10,650937,66102,34,454,130000.0,43333.0,-67.0,-65.0,-70.0,-67.0,-67.0,-65.0,-70.0,-67.0,-90.0,-93.0,-90.0,-93.0,23.0,28.0,20.0,26.0,0
7015,CC:2F:71:3E:C5:1F,3827533,482738136,779,95138,3826754,482642998,0,3268,274276,2696,206336,572,67940,824,8,1122,18,0,37,144444.0,39000.0,-70.0,-71.0,-68.0,-60.0,-69.0,-70.0,-67.0,-60.0,-90.0,-93.0,-90.0,-93.0,20.0,22.0,22.0,33.0,0
7016,BA:8C:B9:54:50:24,3831495,488795557,4741,6152559,3826754,482642998,0,8426,1654730,8404,1651235,22,3495,2324,14,5129,36,0,53,216660.0,130000.0,-49.0,-35.0,-42.0,-44.0,-44.0,-35.0,-42.0,-45.0,-90.0,-93.0,-90.0,-93.0,41.0,58.0,48.0,49.0,0
7017,92:69:1D:31:68:E9,3830525,486225495,3767,3582093,3826758,482643402,0,4246,1047183,4126,1020218,120,26965,2013,7,3909,80,0,37,216660.0,130000.0,-52.0,-50.0,-44.0,-46.0,-51.0,-49.0,-43.0,-47.0,-90.0,-93.0,-90.0,-93.0,38.0,43.0,46.0,47.0,0
7018,CC:2F:71:3F:1F:24,4477500,1188135546,650742,705492144,3826758,482643402,37,531003,565616574,530359,565539106,644,77468,513321,10,650979,66115,34,454,117000.0,39000.0,-67.0,-65.0,-70.0,-68.0,-67.0,-65.0,-70.0,-67.0,-90.0,-93.0,-90.0,-93.0,23.0,28.0,20.0,25.0,0
7019,CC:2F:71:3E:C5:1F,3827538,482738600,779,95138,3826759,482643462,0,3268,274276,2696,206336,572,67940,824,8,1122,18,0,37,144444.0,39000.0,-70.0,-71.0,-68.0,-60.0,-69.0,-70.0,-67.0,-60.0,-90.0,-93.0,-90.0,-93.0,20.0,22.0,22.0,33.0,0
7020,BA:8C:B9:54:50:24,3831500,488796021,4741,6152559,3826759,482643462,0,8426,1654730,8404,1651235,22,3495,2324,14,5129,36,0,53,216660.0,130000.0,-49.0,-35.0,-42.0,-44.0,-44.0,-35.0,-42.0,-45.0,-90.0,-93.0,-90.0,-93.0,41.0,58.0,48.0,49.0,0
7021,92:69:1D:31:68:E9,3830530,486225959,3767,3582093,3826763,482643866,0,4246,1047183,4126,1020218,120,26965,2013,7,3909,80,0,37,216660.0,130000.0,-52.0,-50.0,-44.0,-46.0,-51.0,-49.0,-43.0,-47.0,-90.0,-93.0,-90.0,-93.0,38.0,43.0,46.0,47.0,0
7022,CC:2F:71:3F:1F:24,4477544,1188150066,650781,705506200,3826763,482643866,37,531029,565621574,530385,565544106,644,77468,513347,10,651018,66118,34,454,130000.0,43333.0,-67.0,-65.0,-70.0,-68.0,-67.0,-65.0,-70.0,-67.0,-90.0,-93.0,-90.0,-93.0,23.0,28.0,20.0,25.0,0
7023,CC:2F:71:3E:C5:1F,3827542,482739004,779,95138,3826763,482643866,0,3268,274276,2696,206336,572,67940,824,8,1122,18,0,37,144444.0,39000.0,-70.0,-71.0,-68.0,-60.0,-69.0,-70.0,-67.0,-60.0,-90.0,-93.0,-90.0,-93.0,20.0,22.0,22.0,33.0,0
7024,BA:8C:B9:54:50:24,3831504,488796425,4741,6152559,3826763,482643866,0,8426,1654730,8404,1651235,22,3495,2324,14,5129,36,0,53,216660.0,130000.0,-49.0,-35.0,-42.0,-44.0,-44.0,-35.0,-42.0,-45.0,-90.0,-93.0,-90.0,-93.0,41.0,58.0,48.0,49.0,0
7025,92:69:1D:31:68:E9,3830534,486226363,3767,3582093,3826767,482644270,0,4246,1047183,4126,1020218,120,26965,2013,7,3909,80,0,37,216660.0,130000.0,-52.0,-50.0,-44.0,-46.0,-51.0,-49.0,-43.0,-47.0,-90.0,-93.0,-90.0,-93.0,38.0,43.0,46.0,47.0,0
7026,CC:2F:71:3F:1F:24,4477590,1188164954,650823,705520684,3826767,482644270,37,531056,565626634,530412,565549166,644,77468,513374,10,651060,66127,34,454,130000.0,39000.0,-67.0,-65.0,-71.0,-68.0,-67.0,-65.0,-70.0,-67.0,-90.0,-93.0,-90.0,-93.0,23.0,28.0,19.0,25.0,0
7027,CC:2F:71:3E:C5:1F,3827546,482739408,779,95138,3826767,482644270,0,3268,274276,2696,206336,572,67940,824,8,1122,18,0,37,144444.0,39000.0,-70.0,-71.0,-68.0,-60.0,-69.0,-70.0,-67.0,-60.0,-90.0,-93.0,-90.0,-93.0,20.0,22.0,22.0,33.0,0
7028,BA:8C:B9:54:50:24,3831508,488796829,4741,6152559,3826767,482644270,0,8426,1654730,8404,1651235,22,3495,2324,14,5129,36,0,53,216660.0,130000.0,-49.0,-35.0,-42.0,-44.0,-44.0,-35.0,-42.0,-45.0,-90.0,-93.0,-90.0,-93.0,41.0,58.0,48.0,49.0,0
7029,92:69:1D:31:68:E9,3830541,486227057,3769,3582323,3826772,482644734,0,4250,1047587,4130,1020622,120,26965,2015,7,3911,80,0,37,216660.0,130000.0,-52.0,-50.0,-44.0,-46.0,-51.0,-49.0,-44.0,-48.0,-90.0,-93.0,-90.0,-93.0,38.0,43.0,46.0,47.0,0
7030,CC:2F:71:3F:1F:24,4477637,1188179790,650865,705535056,3826772,482644734,37,531081,565631438,530437,565553970,644,77468,513399,10,651102,66156,34,454,130000.0,43333.0,-67.0,-65.0,-71.0,-68.0,-67.0,-65.0,-70.0,-67.0,-90.0,-93.0,-90.0,-93.0,23.0,28.0,19.0,25.0,0
7031,CC:2F:71:3E:C5:1F,3827551,482739872,779,95138,3826772,482644734,0,3268,274276,2696,206336,572,67940,824,8,1122,18,0,37,144444.0,39000.0,-70.0,-71.0,-68.0,-60.0,-69.0,-70.0,-67.0,-60.0,-90.0,-93.0,-90.0,-93.0,20.0,22.0,22.0,33.0,0
7032,BA:8C:B9:54:50:24,3831513,488797293,4741,6152559,3826772,482644734,0,8426,1654730,8404,1651235,22,3495,2324,14,5129,36,0,53,216660.0,130000.0,-49.0,-35.0,-42.0,-44.0,-44.0,-35.0,-42.0,-45.0,-90.0,-93.0,-90.0,-93.0,41.0,58.0,48.0,49.0,0
7033,92:69:1D:31:68:E9,3830545,486227461,3769,3582323,3826776,482645138,0,4250,1047587,4130,1020622,120,26965,2015,7,3911,80,0,37,216660.0,130000.0,-52.0,-50.0,-44.0,-46.0,-51.0,-49.0,-44.0,-48.0,-90.0,-93.0,-90.0,-93.0,38.0,43.0,46.0,47.0,0
7034,CC:2F:71:3F:1F:24,4477683,1188194734,650907,705549596,3826776,482645138,37,531107,565636382,530463,565558914,644,77468,513425,10,651144,66159,34,454,130000.0,43333.0,-67.0,-65.0,-70.0,-67.0,-67.0,-65.0,-70.0,-67.0,-90.0,-93.0,-90.0,-93.0,23.0,28.0,20.0,26.0,0
7035,CC:2F:71:3E:C5:1F,3827555,482740276,779,95138,3826776,482645138,0,3268,274276,2696,206336,572,67940,824,8,1122,18,0,37,144444.0,39000.0,-70.0,-71.0,-68.0,-60.0,-69.0,-70.0,-67.0,-60.0,-90.0,-93.0,-90.0,-93.0,20.0,22.0,22.0,33.0,0
7036,BA:8C:B9:54:50:24,3831517,488797697,4741,6152559,3826776,482645138,0,8426,1654730,8404,1651235,22,3495,2324,14,5129,36,0,53,216660.0,130000.0,-49.0,-35.0,-42.0,-44.0,-44.0,-35.0,-42.0,-45.0,-90.0,-93.0,-90.0,-93.0,41.0,58.0,48.0,49.0,0
7037,92:69:1D:31:68:E9,3830549,486227865,3769,3582323,3826780,482645542,0,4250,1047587,4130,1020622,120,26965,2015,7,3911,80,0,37,216660.0,130000.0,-52.0,-50.0,-44.0,-46.0,-51.0,-49.0,-44.0,-48.0,-90.0,-93.0,-90.0,-93.0,38.0,43.0,46.0,47.0,0
7038,CC:2F:71:3F:1F:24,4477731,1188209814,650951,705564272,3826780,482645542,37,531133,565641326,530489,565563858,644,77468,513451,10,651188,66178,34,454,117000.0,39000.0,-67.0,-65.0,-70.0,-67.0,-67.0,-65.0,-70.0,-67.0,-90.0,-93.0,-90.0,-93.0,23.0,28.0,20.0,26.0,0
7039,CC:2F:71:3E:C5:1F,3827559,482740680,779,95138,3826780,482645542,0,3268,274276,2696,206336,572,67940,824,8,1122,18,0,37,144444.0,39000.0,-70.0,-71.0,-68.0,-60.0,-69.0,-70.0,-67.0,-60.0,-90.0,-93.0,-90.0,-93.0,20.0,22.0,22.0,33.0,0
7040,BA:8C:B9:54:50:24,3831521,488798101,4741,6152559,3826780,482645542,0,8426,1654730,8404,1651235,22,3495,2324,14,5129,36,0,53,216660.0,130000.0,-49.0,-35.0,-42.0,-44.0,-44.0,-35.0,-42.0,-45.0,-90.0,-93.0,-90.0,-93.0,41.0,58.0,48.0,49.0,0
7041,92:69:1D:31:68:E9,3830554,486228329,3769,3582323,3826785,482646006,0,4250,1047587,4130,1020622,120,26965,2015,7,3911,80,0,37,216660.0,130000.0,-52.0,-50.0,-44.0,-46.0,-51.0,-49.0,-44.0,-48.0,-90.0,-93.0,-90.0,-93.0,38.0,43.0,46.0,47.0,0
7042,CC:2F:71:3F:1F:24,4477779,1188224830,650994,705578824,3826785,482646006,37,531160,565646422,530516,565568954,644,77468,513478,10,651231,66185,34,454,130000.0,43333.0,-67.0,-65.0,-70.0,-67.0,-67.0,-65.0,-70.0,-67.0,-90.0,-93.0,-90.0,-93.0,23.0,28.0,20.0,26.0,0
7043,CC:2F:71:3E:C5:1F,3827564,482741144,779,95138,3826785,482646006,0,3268,274276,2696,206336,572,67940,824,8,1122,18,0,37,144444.0,39000.0,-70.0,-71.0,-68.0,-60.0,-69.0,-70.0,-67.0,-60.0,-90.0,-93.0,-90.0,-93.0,20.0,22.0,22.0,33.0,0
7044,BA:8C:B9:54:50:24,3831526,488798565,4741,6152559,3826785,482646006,0,8426,1654730,8404,1651235,22,3495,2324,14,5129,36,0,53,216660.0,130000.0,-49.0,-35.0,-42.0,-44.0,-44.0,-35.0,-42.0,-45.0,-90.0,-93.0,-90.0,-93.0,41.0,58.0,48.0,49.0,0
7045,92:69:1D:31:68:E9,3830559,486228849,3770,3582439,3826789,482646410,0,4252,1047723,4132,1020758,120,26965,2015,7,3912,80,0,37,216660.0,130000.0,-52.0,-50.0,-44.0,-46.0,-51.0,-49.0,-44.0,-48.0,-90.0,-93.0,-90.0,-93.0,38.0,43.0,46.0,47.0,0
7046,CC:2F:71:3F:1F:24,4477825,1188239710,651036,705593300,3826789,482646410,37,531186,565651366,530542,565573898,644,77468,513504,10,651273,66198,34,454,130000.0,39000.0,-67.0,-65.0,-70.0,-67.0,-67.0,-65.0,-70.0,-67.0,-90.0,-93.0,-90.0,-93.0,23.0,28.0,20.0,26.0,0
7047,CC:2F:71:3E:C5:1F,3827569,482741664,780,95254,3826789,482646410,0,3270,274416,2698,206476,572,67940,824,8,1123,18,0,37,144444.0,39000.0,-70.0,-70.0,-67.0,-60.0,-70.0,-70.0,-67.0,-60.0,-90.0,-93.0,-90.0,-93.0,20.0,23.0,23.0,33.0,0
7048,BA:8C:B9:54:50:24,3831531,488799029,4742,6152619,3826789,482646410,0,8432,1655138,8410,1651643,22,3495,2324,14,5130,36,0,53,216660.0,130000.0,-49.0,-35.0,-42.0,-44.0,-44.0,-34.0,-42.0,-45.0,-90.0,-93.0,-90.0,-93.0,41.0,58.0,48.0,49.0,0
7049,92:69:1D:31:68:E9,3830564,486229526,3770,3582439,3826794,482647087,0,4252,1047723,4132,1020758,120,26965,2015,7,3912,80,0,37,216660.0,130000.0,-52.0,-50.0,-44.0,-46.0,-51.0,-49.0,-44.0,-48.0,-90.0,-93.0,-90.0,-93.0,38.0,43.0,46.0,47.0,0
7050,CC:2F:71:3F:1F:24,4477878,1188255882,651083,705608735,3826795,482647147,37,531217,565656995,530573,565579527,644,77468,513535,10,651320,66239,34,454,130000.0,43333.0,-67.0,-65.0,-70.0,-67.0,-67.0,-65.0,-70.0,-67.0,-90.0,-93.0,-90.0,-93.0,23.0,28.0,20.0,26.0,0
7051,CC:2F:71:3E:C5:1F,3827575,482742401,780,95254,3826795,482647147,0,3270,274416,2698,206476,572,67940,824,8,1123,18,0,37,144444.0,39000.0,-70.0,-70.0,-67.0,-60.0,-70.0,-70.0,-67.0,-60.0,-90.0,-93.0,-90.0,-93.0,20.0,23.0,23.0,33.0,0
7052,BA:8C:B9:54:50:24,3831537,488799766,4742,6152619,3826795,482647147,0,8432,1655138,8410,1651643,22,3495,2324,14,5130,36,0,53,216660.0,130000.0,-49.0,-35.0,-42.0,-44.0,-44.0,-34.0,-42.0,-45.0,-90.0,-93.0,-90.0,-93.0,41.0,58.0,48.0,49.0,0
7053,92:69:1D:31:68:E9,3830569,486229990,3770,3582439,3826799,482647551,0,4252,1047723,4132,1020758,120,26965,2015,7,3912,80,0,37,216660.0,130000.0,-52.0,-50.0,-44.0,-46.0,-51.0,-49.0,-44.0,-48.0,-90.0,-93.0,-90.0,-93.0,38.0,43.0,46.0,47.0,0
7054,CC:2F:71:3F:1F:24,4477923,1188270702,651124,705623151,3826799,482647551,37,531243,565661939,530599,565584471,644,77468,513561,10,651361,66247,34,454,130000.0,43333.0,-67.0,-65.0,-70.0,-67.0,-67.0,-65.0,-70.0,-67.0,-90.0,-93.0,-90.0,-93.0,23.0,28.0,20.0,26.0,0
7055,CC:2F:71:3E:C5:1F,3827579,482742805,780,95254,3826799,482647551,0,3270,274416,2698,206476,572,67940,824,8,1123,18,0,37,144444.0,39000.0,-70.0,-70.0,-67.0,-60.0,-70.0,-70.0,-67.0,-60.0,-90.0,-93.0,-90.0,-93.0,20.0,23.0,23.0,33.0,0
7056,BA:8C:B9:54:50:24,3831541,488800170,4742,6152619,3826799,482647551,0,8432,1655138,8410,1651643,22,3495,2324,14,5130,36,0,53,216660.0,130000.0,-49.0,-35.0,-42.0,-44.0,-44.0,-34.0,-42.0,-45.0,-90.0,-93.0,-90.0,-93.0,41.0,58.0,48.0,49.0,0
7057,92:69:1D:31:68:E9,3830574,486230510,3771,3582555,3826803,482647955,0,4255,1047969,4135,1021004,120,26965,2016,7,3913,80,0,37,216660.0,130000.0,-51.0,-50.0,-44.0,-46.0,-51.0,-50.0,-44.0,-48.0,-90.0,-93.0,-90.0,-93.0,39.0,43.0,46.0,47.0,0
7058,CC:2F:71:3F:1F:24,4477970,1188285714,651167,705637759,3826803,482647955,37,531270,565667141,530626,565589673,644,77468,513587,10,651404,66266,34,454,130000.0,39000.0,-67.0,-65.0,-71.0,-68.0,-67.0,-65.0,-70.0,-67.0,-90.0,-93.0,-90.0,-93.0,23.0,28.0,19.0,25.0,0
7059,CC:2F:71:3E:C5:1F,3827583,482743209,780,95254,3826803,482647955,0,3270,274416,2698,206476,572,67940,824,8,1123,18,0,37,144444.0,39000.0,-70.0,-70.0,-67.0,-60.0,-70.0,-70.0,-67.0,-60.0,-90.0,-93.0,-90.0,-93.0,20.0,23.0,23.0,33.0,0
7060,BA:8C:B9:54:50:24,3831545,488800574,4742,6152619,3826803,482647955,0,8432,1655138,8410,1651643,22,3495,2324,14,5130,36,0,53,216660.0,130000.0,-49.0,-35.0,-42.0,-44.0,-44.0,-34.0,-42.0,-45.0,-90.0,-93.0,-90.0,-93.0,41.0,58.0,48.0,49.0,0
7061,92:69:1D:31:68:E9,3830575,486230570,3771,3582555,3826804,482648015,0,4255,1047969,4135,1021004,120,26965,2016,7,3913,80,0,37,216660.0,130000.0,-51.0,-50.0,-44.0,-46.0,-51.0,-50.0,-44.0,-48.0,-90.0,-93.0,-90.0,-93.0,39.0,43.0,46.0,47.0,0
7062,CC:2F:71:3F:1F:24,4478017,1188300438,651209,705652019,3826808,482648419,37,531295,565671945,530651,565594477,644,77468,513612,10,651446,66310,34,454,130000.0,43333.0,-67.0,-65.0,-70.0,-68.0,-67.0,-65.0,-70.0,-67.0,-90.0,-93.0,-90.0,-93.0,23.0,28.0,20.0,25.0,0
7063,CC:2F:71:3E:C5:1F,3827589,482743735,780,95254,3826809,482648481,0,3270,274416,2698,206476,572,67940,824,8,1123,18,0,37,144444.0,39000.0,-70.0,-70.0,-67.0,-60.0,-70.0,-70.0,-67.0,-60.0,-90.0,-93.0,-90.0,-93.0,20.0,23.0,23.0,33.0,0
7064,BA:8C:B9:54:50:24,3831551,488801100,4742,6152619,3826809,482648481,0,8432,1655138,8410,1651643,22,3495,2324,14,5130,36,0,53,216660.0,130000.0,-49.0,-35.0,-42.0,-44.0,-44.0,-34.0,-42.0,-45.0,-90.0,-93.0,-90.0,-93.0,41.0,58.0,48.0,49.0,0
7065,92:69:1D:31:68:E9,3830585,486231502,3771,3582555,3826814,482648947,0,4255,1047969,4135,1021004,120,26965,2016,7,3913,80,0,37,216660.0,130000.0,-51.0,-50.0,-44.0,-46.0,-51.0,-50.0,-44.0,-48.0,-90.0,-93.0,-90.0,-93.0,39.0,43.0,46.0,47.0,0
7066,CC:2F:71:3F:1F:24,4478065,1188315400,651251,705666453,3826814,482648947,37,531321,565676867,530676,565599281,645,77586,513638,10,651488,66315,34,454,130000.0,39000.0,-67.0,-65.0,-70.0,-67.0,-67.0,-65.0,-70.0,-67.0,-90.0,-93.0,-90.0,-93.0,23.0,28.0,20.0,26.0,0
7067,CC:2F:71:3E:C5:1F,3827594,482744201,780,95254,3826814,482648947,0,3272,274604,2699,206546,573,68058,825,8,1123,18,0,37,144444.0,39000.0,-70.0,-71.0,-68.0,-60.0,-70.0,-70.0,-67.0,-60.0,-90.0,-93.0,-90.0,-93.0,20.0,22.0,22.0,33.0,0
7068,BA:8C:B9:54:50:24,3831556,488801566,4742,6152619,3826814,482648947,0,8432,1655138,8410,1651643,22,3495,2324,14,5130,36,0,53,216660.0,130000.0,-49.0,-35.0,-42.0,-44.0,-44.0,-34.0,-42.0,-45.0,-90.0,-93.0,-90.0,-93.0,41.0,58.0,48.0,49.0,0
7069,92:69:1D:31:68:E9,3830585,486231502,3771,3582555,3826814,482648947,0,4255,1047969,4135,1021004,120,26965,2016,7,3913,80,0,37,216660.0,130000.0,-51.0,-50.0,-44.0,-46.0,-51.0,-50.0,-44.0,-48.0,-90.0,-93.0,-90.0,-93.0,39.0,43.0,46.0,47.0,0
7070,CC:2F:71:3F:1F:24,4478108,1188329900,651292,705680751,3826816,482649149,37,531348,565681927,530703,565604341,645,77586,513665,10,651529,66321,34,454,117000.0,39000.0,-67.0,-65.0,-71.0,-67.0,-67.0,-65.0,-70.0,-67.0,-90.0,-93.0,-90.0,-93.0,23.0,28.0,19.0,26.0,0
7071,CC:2F:71:3E:C5:1F,3827596,482744403,780,95254,3826816,482649149,0,3272,274604,2699,206546,573,68058,825,8,1123,18,0,37,144444.0,39000.0,-70.0,-71.0,-68.0,-60.0,-70.0,-70.0,-67.0,-60.0,-90.0,-93.0,-90.0,-93.0,20.0,22.0,22.0,33.0,0
7072,BA:8C:B9:54:50:24,3831560,488801970,4742,6152619,3826818,482649351,0,8435,1655342,8413,1651847,22,3495,2324,14,5131,36,0,53,216660.0,130000.0,-39.0,-36.0,-44.0,-51.0,-42.0,-34.0,-42.0,-46.0,-90.0,-93.0,-90.0,-93.0,51.0,57.0,46.0,42.0,0
7073,92:69:1D:31:68:E9,3830596,486232580,3771,3582555,3826825,482650025,0,4255,1047969,4135,1021004,120,26965,2016,7,3913,80,0,37,216660.0,130000.0,-51.0,-50.0,-44.0,-46.0,-51.0,-50.0,-44.0,-48.0,-90.0,-93.0,-90.0,-93.0,39.0,43.0,46.0,47.0,0
7074,CC:2F:71:3F:1F:24,4478160,1188345278,651335,705695253,3826825,482650025,37,531376,565687151,530731,565609565,645,77586,513693,10,651572,66336,34,454,130000.0,39000.0,-67.0,-65.0,-70.0,-67.0,-67.0,-65.0,-70.0,-67.0,-90.0,-93.0,-90.0,-93.0,23.0,28.0,20.0,26.0,0
7075,CC:2F:71:3E:C5:1F,3827605,482745279,780,95254,3826825,482650025,0,3272,274604,2699,206546,573,68058,825,8,1123,18,0,37,144444.0,39000.0,-70.0,-71.0,-68.0,-60.0,-70.0,-70.0,-67.0,-60.0,-90.0,-93.0,-90.0,-93.0,20.0,22.0,22.0,33.0,0
7076,BA:8C:B9:54:50:24,3831567,488802644,4742,6152619,3826825,482650025,0,8435,1655342,8413,1651847,22,3495,2324,14,5131,36,0,53,216660.0,130000.0,-39.0,-36.0,-44.0,-51.0,-42.0,-34.0,-42.0,-46.0,-90.0,-93.0,-90.0,-93.0,51.0,57.0,46.0,42.0,0
7077,92:69:1D:31:68:E9,3830596,486232580,3771,3582555,3826825,482650025,0,4255,1047969,4135,1021004,120,26965,2016,7,3913,80,0,37,216660.0,130000.0,-51.0,-50.0,-44.0,-46.0,-51.0,-50.0,-44.0,-48.0,-90.0,-93.0,-90.0,-93.0,39.0,43.0,46.0,47.0,0
7078,CC:2F:71:3F:1F:24,4478202,1188359778,651377,705709753,3826825,482650025,37,531405,565692483,530760,565614897,645,77586,513722,10,651614,66344,34,455,130000.0,43333.0,-67.0,-65.0,-70.0,-68.0,-67.0,-65.0,-70.0,-67.0,-90.0,-93.0,-90.0,-93.0,23.0,28.0,20.0,25.0,0
7079,CC:2F:71:3E:C5:1F,3827609,482745683,780,95254,3826829,482650429,0,3272,274604,2699,206546,573,68058,825,8,1123,18,0,37,144444.0,39000.0,-70.0,-71.0,-68.0,-60.0,-70.0,-70.0,-67.0,-60.0,-90.0,-93.0,-90.0,-93.0,20.0,22.0,22.0,33.0,0
7080,BA:8C:B9:54:50:24,3831571,488803048,4742,6152619,3826829,482650429,0,8435,1655342,8413,1651847,22,3495,2324,14,5131,36,0,53,216660.0,130000.0,-39.0,-36.0,-44.0,-51.0,-42.0,-34.0,-42.0,-46.0,-90.0,-93.0,-90.0,-93.0,51.0,57.0,46.0,42.0,0
7081,92:69:1D:31:68:E9,3830605,486233448,3771,3582555,3826834,482650893,0,4256,1048037,4136,1021072,120,26965,2016,7,3913,80,0,37,216660.0,130000.0,-51.0,-50.0,-44.0,-46.0,-51.0,-49.0,-44.0,-47.0,-90.0,-93.0,-90.0,-93.0,39.0,43.0,46.0,47.0,0
7082,CC:2F:71:3F:1F:24,4478254,1188375310,651420,705724417,3826834,482650893,37,531431,565697427,530786,565619841,645,77586,513748,10,651657,66349,34,455,130000.0,43333.0,-67.0,-65.0,-70.0,-67.0,-67.0,-65.0,-70.0,-67.0,-90.0,-93.0,-90.0,-93.0,23.0,28.0,20.0,26.0,0
7083,CC:2F:71:3E:C5:1F,3827614,482746147,780,95254,3826834,482650893,0,3272,274604,2699,206546,573,68058,825,8,1123,18,0,37,144444.0,39000.0,-70.0,-71.0,-68.0,-60.0,-70.0,-70.0,-67.0,-60.0,-90.0,-93.0,-90.0,-93.0,20.0,22.0,22.0,33.0,0
7084,BA:8C:B9:54:50:24,3831576,488803512,4742,6152619,3826834,482650893,0,8435,1655342,8413,1651847,22,3495,2324,14,5131,36,0,53,216660.0,130000.0,-39.0,-36.0,-44.0,-51.0,-42.0,-34.0,-42.0,-46.0,-90.0,-93.0,-90.0,-93.0,51.0,57.0,46.0,42.0,0
7085,92:69:1D:31:68:E9,3830605,486233448,3771,3582555,3826834,482650893,0,4256,1048037,4136,1021072,120,26965,2016,7,3913,80,0,37,216660.0,130000.0,-51.0,-50.0,-44.0,-46.0,-51.0,-49.0,-44.0,-47.0,-90.0,-93.0,-90.0,-93.0,39.0,43.0,46.0,47.0,0
7086,CC:2F:71:3F:1F:24,4478296,1188389794,651462,705738901,3826834,482650893,37,531456,565702231,530811,565624645,645,77586,513773,10,651699,66364,34,455,130000.0,39000.0,-67.0,-65.0,-70.0,-67.0,-67.0,-65.0,-70.0,-67.0,-90.0,-93.0,-90.0,-93.0,23.0,28.0,20.0,26.0,0
7087,CC:2F:71:3E:C5:1F,3827615,482746281,780,95254,3826835,482651027,0,3272,274604,2699,206546,573,68058,825,8,1123,18,0,37,144444.0,39000.0,-70.0,-71.0,-68.0,-60.0,-70.0,-70.0,-67.0,-60.0,-90.0,-93.0,-90.0,-93.0,20.0,22.0,22.0,33.0,0
7088,BA:8C:B9:54:50:24,3831580,488803916,4742,6152619,3826838,482651297,0,8435,1655342,8413,1651847,22,3495,2324,14,5131,36,0,53,216660.0,130000.0,-39.0,-36.0,-44.0,-51.0,-42.0,-34.0,-42.0,-46.0,-90.0,-93.0,-90.0,-93.0,51.0,57.0,46.0,42.0,0
7089,92:69:1D:31:68:E9,3830613,486234256,3771,3582555,3826842,482651701,0,4256,1048037,4136,1021072,120,26965,2016,7,3913,80,0,37,216660.0,130000.0,-51.0,-50.0,-44.0,-46.0,-51.0,-49.0,-44.0,-47.0,-90.0,-93.0,-90.0,-93.0,39.0,43.0,46.0,47.0,0
7090,CC:2F:71:3F:1F:24,4478348,1188405258,651506,705753557,3826842,482651701,37,531483,565707279,530838,565629693,645,77586,513800,10,651743,66368,34,455,130000.0,43333.0,-71.0,-69.0,-74.0,-71.0,-70.0,-68.0,-73.0,-70.0,-90.0,-93.0,-90.0,-93.0,19.0,24.0,16.0,22.0,0
7091,CC:2F:71:3E:C5:1F,3827622,482746955,780,95254,3826842,482651701,0,3272,274604,2699,206546,573,68058,825,8,1123,18,0,37,144444.0,39000.0,-70.0,-71.0,-68.0,-60.0,-70.0,-70.0,-67.0,-60.0,-90.0,-93.0,-90.0,-93.0,20.0,22.0,22.0,33.0,0
7092,BA:8C:B9:54:50:24,3831584,488804320,4742,6152619,3826842,482651701,0,8435,1655342,8413,1651847,22,3495,2324,14,5131,36,0,53,216660.0,130000.0,-39.0,-36.0,-44.0,-51.0,-42.0,-34.0,-42.0,-46.0,-90.0,-93.0,-90.0,-93.0,51.0,57.0,46.0,42.0,0
7093,92:69:1D:31:68:E9,3830614,486234316,3771,3582555,3826843,482651761,0,4256,1048037,4136,1021072,120,26965,2016,7,3913,80,0,37,216660.0,130000.0,-51.0,-50.0,-44.0,-46.0,-51.0,-49.0,-44.0,-47.0,-90.0,-93.0,-90.0,-93.0,39.0,43.0,46.0,47.0,0
7094,CC:2F:71:3F:1F:24,4478391,1188419858,651548,705768097,3826843,482651761,37,531509,565712199,530864,565634613,645,77586,513826,10,651785,66374,34,455,130000.0,39000.0,-74.0,-72.0,-77.0,-74.0,-73.0,-71.0,-76.0,-73.0,-90.0,-93.0,-90.0,-93.0,16.0,21.0,13.0,19.0,0
7095,CC:2F:71:3E:C5:1F,3827635,482752614,780,95254,3826855,482657360,0,3272,274604,2699,206546,573,68058,825,8,1123,18,0,37,144444.0,39000.0,-70.0,-71.0,-68.0,-60.0,-70.0,-70.0,-67.0,-60.0,-90.0,-93.0,-90.0,-93.0,20.0,22.0,22.0,33.0,0
7096,BA:8C:B9:54:50:24,3831599,488810181,4742,6152619,3826857,482657562,0,8435,1655342,8413,1651847,22,3495,2324,14,5131,36,0,53,216660.0,130000.0,-39.0,-36.0,-44.0,-51.0,-42.0,-34.0,-42.0,-46.0,-90.0,-93.0,-90.0,-93.0,51.0,57.0,46.0,42.0,0
7097,92:69:1D:31:68:E9,3830645,486246147,3771,3582555,3826874,482663592,0,4259,1048408,4138,1021208,121,27200,2017,7,3913,80,0,37,216660.0,130000.0,-51.0,-47.0,-42.0,-48.0,-51.0,-49.0,-44.0,-47.0,-90.0,-93.0,-90.0,-93.0,39.0,46.0,48.0,45.0,0
7098,CC:2F:71:3F:1F:24,4478465,1188446319,651591,705782727,3826874,482663592,37,531534,565717015,530889,565639429,645,77586,513851,10,651828,66399,34,455,130000.0,39000.0,-68.0,-66.0,-71.0,-68.0,-68.0,-67.0,-72.0,-69.0,-90.0,-93.0,-90.0,-93.0,22.0,27.0,19.0,25.0,0
7099,CC:2F:71:3E:C5:1F,3827654,482758846,780,95254,3826874,482663592,0,3272,274604,2699,206546,573,68058,825,8,1123,18,0,37,144444.0,39000.0,-70.0,-71.0,-68.0,-60.0,-70.0,-70.0,-67.0,-60.0,-90.0,-93.0,-90.0,-93.0,20.0,22.0,22.0,33.0,0
7100,BA:8C:B9:54:50:24,3831616,488816211,4742,6152619,3826874,482663592,0,8435,1655342,8413,1651847,22,3495,2324,14,5131,36,0,53,216660.0,130000.0,-39.0,-36.0,-44.0,-51.0,-42.0,-34.0,-42.0,-46.0,-90.0,-93.0,-90.0,-93.0,51.0,57.0,46.0,42.0,0
7101,92:69:1D:31:68:E9,3830646,486246420,3771,3582555,3826875,482663865,0,4259,1048408,4138,1021208,121,27200,2017,7,3913,80,0,37,216660.0,130000.0,-51.0,-47.0,-42.0,-48.0,-51.0,-49.0,-44.0,-47.0,-90.0,-93.0,-90.0,-93.0,39.0,46.0,48.0,45.0,0
7102,CC:2F:71:3F:1F:24,4478507,1188460840,651632,705796975,3826875,482663865,37,531559,565721819,530914,565644233,645,77586,513876,10,651869,66407,34,455,117000.0,39000.0,-68.0,-66.0,-71.0,-68.0,-68.0,-66.0,-71.0,-68.0,-90.0,-93.0,-90.0,-93.0,22.0,27.0,19.0,25.0,0
7103,CC:2F:71:3E:C5:1F,3827658,482759381,780,95254,3826878,482664127,0,3272,274604,2699,206546,573,68058,825,8,1123,18,0,37,144444.0,39000.0,-70.0,-71.0,-68.0,-60.0,-70.0,-70.0,-67.0,-60.0,-90.0,-93.0,-90.0,-93.0,20.0,22.0,22.0,33.0,0
7104,BA:8C:B9:54:50:24,3831620,488816746,4742,6152619,3826878,482664127,0,8435,1655342,8413,1651847,22,3495,2324,14,5131,36,0,53,216660.0,130000.0,-39.0,-36.0,-44.0,-51.0,-42.0,-34.0,-42.0,-46.0,-90.0,-93.0,-90.0,-93.0,51.0,57.0,46.0,42.0,0
7105,92:69:1D:31:68:E9,3830655,486247288,3771,3582555,3826884,482664733,0,4259,1048408,4138,1021208,121,27200,2017,7,3913,80,0,37,216660.0,130000.0,-51.0,-47.0,-42.0,-48.0,-51.0,-49.0,-44.0,-47.0,-90.0,-93.0,-90.0,-93.0,39.0,46.0,48.0,45.0,0
7106,CC:2F:71:3F:1F:24,4478557,1188476006,651673,705811273,3826884,482664733,37,531586,565726879,530941,565649293,645,77586,513903,10,651910,66416,34,455,130000.0,43333.0,-71.0,-69.0,-74.0,-71.0,-70.0,-69.0,-74.0,-71.0,-90.0,-93.0,-90.0,-93.0,19.0,24.0,16.0,22.0,0
7107,CC:2F:71:3E:C5:1F,3827664,482759987,780,95254,3826884,482664733,0,3272,274604,2699,206546,573,68058,825,8,1123,18,0,37,144444.0,39000.0,-70.0,-71.0,-68.0,-60.0,-70.0,-70.0,-67.0,-60.0,-90.0,-93.0,-90.0,-93.0,20.0,22.0,22.0,33.0,0
7108,BA:8C:B9:54:50:24,3831626,488817352,4742,6152619,3826884,482664733,0,8435,1655342,8413,1651847,22,3495,2324,14,5131,36,0,53,216660.0,130000.0,-39.0,-36.0,-44.0,-51.0,-42.0,-34.0,-42.0,-46.0,-90.0,-93.0,-90.0,-93.0,51.0,57.0,46.0,42.0,0
7109,92:69:1D:31:68:E9,3830655,486247288,3771,3582555,3826884,482664733,0,4259,1048408,4138,1021208,121,27200,2017,7,3913,80,0,37,216660.0,130000.0,-51.0,-47.0,-42.0,-48.0,-51.0,-49.0,-44.0,-47.0,-90.0,-93.0,-90.0,-93.0,39.0,46.0,48.0,45.0,0
7110,CC:2F:71:3F:1F:24,4478600,1188490614,651716,705825881,3826884,482664733,37,531611,565731683,530966,565654097,645,77586,513928,10,651953,66435,34,455,130000.0,39000.0,-71.0,-69.0,-74.0,-71.0,-70.0,-69.0,-74.0,-71.0,-90.0,-93.0,-90.0,-93.0,19.0,24.0,16.0,22.0,0
7111,CC:2F:71:3E:C5:1F,3827666,482760189,780,95254,3826886,482664935,0,3272,274604,2699,206546,573,68058,825,8,1123,18,0,37,144444.0,39000.0,-70.0,-71.0,-68.0,-60.0,-70.0,-70.0,-67.0,-60.0,-90.0,-93.0,-90.0,-93.0,20.0,22.0,22.0,33.0,0
7112,BA:8C:B9:54:50:24,3831628,488817554,4742,6152619,3826886,482664935,0,8435,1655342,8413,1651847,22,3495,2324,14,5131,36,0,53,216660.0,130000.0,-39.0,-36.0,-44.0,-51.0,-42.0,-34.0,-42.0,-46.0,-90.0,-93.0,-90.0,-93.0,51.0,57.0,46.0,42.0,0
7113,92:69:1D:31:68:E9,3830666,486248524,3771,3582555,3826895,482665969,0,4259,1048408,4138,1021208,121,27200,2017,7,3913,80,0,37,216660.0,130000.0,-51.0,-47.0,-42.0,-48.0,-51.0,-49.0,-44.0,-47.0,-90.0,-93.0,-90.0,-93.0,39.0,46.0,48.0,45.0,0
7114,CC:2F:71:3F:1F:24,4478653,1188506278,651758,705840309,3826895,482665969,37,531636,565736487,530991,565658901,645,77586,513953,10,651995,66453,34,455,130000.0,39000.0,-71.0,-69.0,-74.0,-71.0,-71.0,-69.0,-74.0,-71.0,-90.0,-93.0,-90.0,-93.0,19.0,24.0,16.0,22.0,0
7115,CC:2F:71:3E:C5:1F,3827675,482761223,780,95254,3826895,482665969,0,3272,274604,2699,206546,573,68058,825,8,1123,18,0,37,144444.0,39000.0,-70.0,-71.0,-68.0,-60.0,-70.0,-70.0,-67.0,-60.0,-90.0,-93.0,-90.0,-93.0,20.0,22.0,22.0,33.0,0
7116,BA:8C:B9:54:50:24,3831637,488818588,4742,6152619,3826895,482665969,0,8435,1655342,8413,1651847,22,3495,2324,14,5131,36,0,53,216660.0,130000.0,-39.0,-36.0,-44.0,-51.0,-42.0,-34.0,-42.0,-46.0,-90.0,-93.0,-90.0,-93.0,51.0,57.0,46.0,42.0,0
7117,92:69:1D:31:68:E9,3830666,486248524,3771,3582555,3826895,482665969,0,4259,1048408,4138,1021208,121,27200,2017,7,3913,80,0,37,216660.0,130000.0,-51.0,-47.0,-42.0,-48.0,-51.0,-49.0,-44.0,-47.0,-90.0,-93.0,-90.0,-93.0,39.0,46.0,48.0,45.0,0
7118,CC:2F:71:3F:1F:24,4478695,1188520762,651800,705854793,3826895,482665969,37,531665,565741779,531020,565664193,645,77586,513982,10,652037,66456,34,455,130000.0,43333.0,-70.0,-68.0,-73.0,-70.0,-69.0,-67.0,-72.0,-69.0,-90.0,-93.0,-90.0,-93.0,20.0,25.0,17.0,23.0,0
7119,CC:2F:71:3E:C5:1F,3827677,482761425,780,95254,3826897,482666171,0,3272,274604,2699,206546,573,68058,825,8,1123,18,0,37,144444.0,39000.0,-70.0,-71.0,-68.0,-60.0,-70.0,-70.0,-67.0,-60.0,-90.0,-93.0,-90.0,-93.0,20.0,22.0,22.0,33.0,0
7120,BA:8C:B9:54:50:24,3831639,488818790,4742,6152619,3826897,482666171,0,8435,1655342,8413,1651847,22,3495,2324,14,5131,36,0,53,216660.0,130000.0,-39.0,-36.0,-44.0,-51.0,-42.0,-34.0,-42.0,-46.0,-90.0,-93.0,-90.0,-93.0,51.0,57.0,46.0,42.0,0
7121,92:69:1D:31:68:E9,3830674,486249332,3771,3582555,3826903,482666777,0,4259,1048408,4138,1021208,121,27200,2017,7,3913,80,0,37,216660.0,130000.0,-51.0,-47.0,-42.0,-48.0,-51.0,-49.0,-44.0,-47.0,-90.0,-93.0,-90.0,-92.0,39.0,46.0,48.0,44.0,0
7122,CC:2F:71:3F:1F:24,4478746,1188536184,651843,705869407,3826903,482666777,37,531691,565746759,531046,565669173,645,77586,514008,10,652080,66471,34,455,130000.0,39000.0,-67.0,-65.0,-71.0,-68.0,-68.0,-66.0,-72.0,-69.0,-90.0,-93.0,-90.0,-92.0,23.0,28.0,19.0,24.0,0
7123,CC:2F:71:3E:C5:1F,3827683,482762031,780,95254,3826903,482666777,0,3272,274604,2699,206546,573,68058,825,8,1123,18,0,37,144444.0,39000.0,-70.0,-71.0,-68.0,-60.0,-70.0,-70.0,-67.0,-60.0,-90.0,-93.0,-90.0,-92.0,20.0,22.0,22.0,32.0,0
7124,BA:8C:B9:54:50:24,3831645,488819396,4742,6152619,3826903,482666777,0,8435,1655342,8413,1651847,22,3495,2324,14,5131,36,0,53,216660.0,130000.0,-39.0,-36.0,-44.0,-51.0,-42.0,-34.0,-42.0,-46.0,-90.0,-93.0,-90.0,-92.0,51.0,57.0,46.0,41.0,0
7125,92:69:1D:31:68:E9,3830675,486249392,3771,3582555,3826904,482666837,0,4259,1048408,4138,1021208,121,27200,2017,7,3913,80,0,37,216660.0,130000.0,-51.0,-47.0,-42.0,-48.0,-51.0,-49.0,-44.0,-47.0,-90.0,-93.0,-90.0,-92.0,39.0,46.0,48.0,44.0,0
7126,CC:2F:71:3F:1F:24,4478789,1188550678,651885,705883841,3826904,482666837,37,531718,565751819,531073,565674233,645,77586,514035,10,652122,66483,34,455,130000.0,39000.0,-67.0,-65.0,-71.0,-68.0,-67.0,-65.0,-70.0,-68.0,-90.0,-93.0,-90.0,-92.0,23.0,28.0,19.0,24.0,0
7127,CC:2F:71:3E:C5:1F,3827684,482762091,780,95254,3826904,482666837,0,3272,274604,2699,206546,573,68058,825,8,1123,18,0,37,144444.0,39000.0,-70.0,-71.0,-68.0,-60.0,-70.0,-70.0,-67.0,-60.0,-90.0,-93.0,-90.0,-92.0,20.0,22.0,22.0,32.0,0
7128,BA:8C:B9:54:50:24,3831648,488819658,4742,6152619,3826906,482667039,0,8435,1655342,8413,1651847,22,3495,2324,14,5131,36,0,53,216660.0,130000.0,-39.0,-36.0,-44.0,-51.0,-42.0,-34.0,-42.0,-46.0,-90.0,-93.0,-90.0,-92.0,51.0,57.0,46.0,41.0,0
7129,92:69:1D:31:68:E9,3830683,486250200,3771,3582555,3826912,482667645,0,4259,1048408,4138,1021208,121,27200,2017,7,3913,80,0,37,216660.0,130000.0,-51.0,-47.0,-42.0,-48.0,-51.0,-49.0,-44.0,-47.0,-90.0,-93.0,-90.0,-92.0,39.0,46.0,48.0,44.0,0
7130,CC:2F:71:3F:1F:24,4478839,1188565914,651927,705898269,3826912,482667645,37,531743,565756623,531098,565679037,645,77586,514060,10,652164,66497,34,455,130000.0,39000.0,-67.0,-65.0,-71.0,-68.0,-67.0,-65.0,-70.0,-67.0,-90.0,-93.0,-90.0,-92.0,23.0,28.0,19.0,24.0,0
7131,CC:2F:71:3E:C5:1F,3827692,482762899,780,95254,3826912,482667645,0,3272,274604,2699,206546,573,68058,825,8,1123,18,0,37,144444.0,39000.0,-70.0,-71.0,-68.0,-60.0,-70.0,-70.0,-67.0,-60.0,-90.0,-93.0,-90.0,-92.0,20.0,22.0,22.0,32.0,0
7132,BA:8C:B9:54:50:24,3831654,488820264,4742,6152619,3826912,482667645,0,8435,1655342,8413,1651847,22,3495,2324,14,5131,36,0,53,216660.0,130000.0,-39.0,-36.0,-44.0,-51.0,-42.0,-34.0,-42.0,-46.0,-90.0,-93.0,-90.0,-92.0,51.0,57.0,46.0,41.0,0
7133,92:69:1D:31:68:E9,3830683,486250200,3771,3582555,3826912,482667645,0,4259,1048408,4138,1021208,121,27200,2017,7,3913,80,0,37,216660.0,130000.0,-51.0,-47.0,-42.0,-48.0,-51.0,-49.0,-44.0,-47.0,-90.0,-93.0,-90.0,-92.0,39.0,46.0,48.0,44.0,0
7134,CC:2F:71:3F:1F:24,4478880,1188580154,651967,705912449,3826913,482667705,37,531769,565761543,531124,565683957,645,77586,514086,10,652204,66515,34,455,130000.0,39000.0,-67.0,-65.0,-71.0,-68.0,-67.0,-65.0,-70.0,-68.0,-90.0,-93.0,-90.0,-92.0,23.0,28.0,19.0,24.0,0
7135,CC:2F:71:3E:C5:1F,3827693,482762959,780,95254,3826913,482667705,0,3272,274604,2699,206546,573,68058,825,8,1123,18,0,37,144444.0,39000.0,-70.0,-71.0,-68.0,-60.0,-70.0,-70.0,-67.0,-60.0,-90.0,-93.0,-90.0,-92.0,20.0,22.0,22.0,32.0,0
7136,BA:8C:B9:54:50:24,3831657,488820526,4742,6152619,3826915,482667907,0,8435,1655342,8413,1651847,22,3495,2324,14,5131,36,0,53,216660.0,130000.0,-39.0,-36.0,-44.0,-51.0,-42.0,-34.0,-42.0,-46.0,-90.0,-93.0,-90.0,-92.0,51.0,57.0,46.0,41.0,0
7137,92:69:1D:31:68:E9,3830692,486251068,3771,3582555,3826921,482668513,0,4261,1048544,4140,1021344,121,27200,2017,7,3913,80,0,37,216660.0,130000.0,-51.0,-47.0,-42.0,-49.0,-51.0,-49.0,-43.0,-48.0,-90.0,-93.0,-90.0,-93.0,39.0,46.0,48.0,44.0,0
7138,CC:2F:71:3F:1F:24,4478931,1188595458,652010,705926945,3826921,482668513,37,531796,565766603,531151,565689017,645,77586,514113,10,652247,66538,34,455,144444.0,39000.0,-67.0,-65.0,-71.0,-68.0,-67.0,-65.0,-70.0,-68.0,-90.0,-93.0,-90.0,-93.0,23.0,28.0,19.0,25.0,0
7139,CC:2F:71:3E:C5:1F,3827701,482763767,780,95254,3826921,482668513,0,3272,274604,2699,206546,573,68058,825,8,1123,18,0,37,144444.0,39000.0,-70.0,-71.0,-68.0,-60.0,-70.0,-70.0,-67.0,-60.0,-90.0,-93.0,-90.0,-93.0,20.0,22.0,22.0,33.0,0
7140,BA:8C:B9:54:50:24,3831663,488821132,4742,6152619,3826921,482668513,0,8435,1655342,8413,1651847,22,3495,2324,14,5131,36,0,53,216660.0,130000.0,-39.0,-36.0,-44.0,-51.0,-42.0,-34.0,-42.0,-46.0,-90.0,-93.0,-90.0,-93.0,51.0,57.0,46.0,42.0,0
7141,92:69:1D:31:68:E9,3830692,486251068,3771,3582555,3826921,482668513,0,4262,1048612,4141,1021412,121,27200,2017,7,3913,80,0,37,216660.0,130000.0,-52.0,-50.0,-44.0,-46.0,-51.0,-49.0,-43.0,-47.0,-90.0,-93.0,-90.0,-93.0,38.0,43.0,46.0,47.0,0
7142,CC:2F:71:3F:1F:24,4478974,1188609892,652053,705941379,3826921,482668513,37,531822,565771547,531177,565693961,645,77586,514139,10,652290,66581,34,455,130000.0,39000.0,-67.0,-65.0,-70.0,-68.0,-67.0,-65.0,-70.0,-68.0,-90.0,-93.0,-90.0,-93.0,23.0,28.0,20.0,25.0,0
7143,CC:2F:71:3E:C5:1F,3827702,482763901,780,95254,3826922,482668647,0,3272,274604,2699,206546,573,68058,825,8,1123,18,0,37,144444.0,39000.0,-70.0,-71.0,-68.0,-60.0,-70.0,-70.0,-67.0,-60.0,-90.0,-93.0,-90.0,-93.0,20.0,22.0,22.0,33.0,0
7144,BA:8C:B9:54:50:24,3831665,488821334,4742,6152619,3826923,482668715,0,8435,1655342,8413,1651847,22,3495,2324,14,5131,36,0,53,216660.0,130000.0,-39.0,-36.0,-44.0,-51.0,-42.0,-34.0,-42.0,-46.0,-90.0,-93.0,-90.0,-93.0,51.0,57.0,46.0,42.0,0
7145,92:69:1D:31:68:E9,3830699,486251734,3771,3582555,3826928,482669179,0,4262,1048612,4141,1021412,121,27200,2017,7,3913,80,0,37,216660.0,130000.0,-52.0,-50.0,-44.0,-46.0,-51.0,-49.0,-43.0,-47.0,-90.0,-93.0,-90.0,-93.0,38.0,43.0,46.0,47.0,0
7146,CC:2F:71:3F:1F:24,4479024,1188625064,652094,705955683,3826930,482669381,37,531849,565776607,531204,565699021,645,77586,514166,10,652331,66622,34,455,144444.0,43333.0,-68.0,-66.0,-71.0,-68.0,-67.0,-65.0,-70.0,-68.0,-90.0,-93.0,-90.0,-93.0,22.0,27.0,19.0,25.0,0
7147,CC:2F:71:3E:C5:1F,3827710,482764635,780,95254,3826930,482669381,0,3272,274604,2699,206546,573,68058,825,8,1123,18,0,37,144444.0,39000.0,-70.0,-71.0,-68.0,-60.0,-70.0,-70.0,-67.0,-60.0,-90.0,-93.0,-90.0,-93.0,20.0,22.0,22.0,33.0,0
7148,BA:8C:B9:54:50:24,3831672,488822000,4742,6152619,3826930,482669381,0,8435,1655342,8413,1651847,22,3495,2324,14,5131,36,0,53,216660.0,130000.0,-39.0,-36.0,-44.0,-51.0,-42.0,-34.0,-42.0,-46.0,-90.0,-93.0,-90.0,-93.0,51.0,57.0,46.0,42.0,0
7149,92:69:1D:31:68:E9,3830703,486252114,3772,3582671,3826931,482669443,0,4264,1048748,4143,1021548,121,27200,2017,7,3914,80,0,38,216660.0,130000.0,-51.0,-50.0,-44.0,-46.0,-51.0,-48.0,-43.0,-47.0,-90.0,-93.0,-90.0,-93.0,39.0,43.0,46.0,47.0,0
7150,CC:2F:71:3F:1F:24,4479069,1188639794,652138,705970351,3826931,482669443,37,531874,565781411,531229,565703825,645,77586,514191,10,652375,66656,34,455,144444.0,39000.0,-67.0,-65.0,-70.0,-68.0,-67.0,-65.0,-70.0,-67.0,-90.0,-93.0,-90.0,-93.0,23.0,28.0,20.0,25.0,0
7151,CC:2F:71:3E:C5:1F,3827716,482765530,785,96087,3826931,482669443,0,3279,275537,2705,207361,574,68176,831,8,1128,18,0,37,144444.0,39000.0,-70.0,-71.0,-67.0,-60.0,-70.0,-71.0,-67.0,-60.0,-90.0,-93.0,-90.0,-93.0,20.0,22.0,23.0,33.0,0
7152,BA:8C:B9:54:50:24,3831676,488822380,4743,6152735,3826933,482669645,0,8440,1655682,8418,1652187,22,3495,2324,14,5132,36,0,53,216660.0,130000.0,-49.0,-35.0,-42.0,-45.0,-43.0,-35.0,-42.0,-46.0,-90.0,-93.0,-90.0,-93.0,41.0,58.0,48.0,48.0,0
7153,92:69:1D:31:68:E9,3830710,486252993,3772,3582671,3826938,482670322,0,4264,1048748,4143,1021548,121,27200,2017,7,3914,80,0,38,216660.0,130000.0,-51.0,-50.0,-44.0,-46.0,-51.0,-48.0,-43.0,-47.0,-90.0,-93.0,-90.0,-93.0,39.0,43.0,46.0,47.0,0
7154,CC:2F:71:3F:1F:24,4479119,1188655235,652179,705984711,3826940,482670524,37,531900,565786355,531255,565708769,645,77586,514217,10,652416,66696,34,455,144444.0,43333.0,-67.0,-65.0,-70.0,-68.0,-67.0,-65.0,-70.0,-67.0,-90.0,-93.0,-90.0,-93.0,23.0,28.0,20.0,25.0,0
7155,CC:2F:71:3E:C5:1F,3827725,482766611,785,96087,3826940,482670524,0,3279,275537,2705,207361,574,68176,831,8,1128,18,0,37,144444.0,39000.0,-70.0,-71.0,-67.0,-60.0,-70.0,-71.0,-67.0,-60.0,-90.0,-93.0,-90.0,-93.0,20.0,22.0,23.0,33.0,0
7156,BA:8C:B9:54:50:24,3831683,488823259,4743,6152735,3826940,482670524,0,8440,1655682,8418,1652187,22,3495,2324,14,5132,36,0,53,216660.0,130000.0,-49.0,-35.0,-42.0,-45.0,-43.0,-35.0,-42.0,-46.0,-90.0,-93.0,-90.0,-93.0,41.0,58.0,48.0,48.0,0
7157,92:69:1D:31:68:E9,3830713,486253255,3772,3582671,3826941,482670584,0,4264,1048748,4143,1021548,121,27200,2017,7,3914,80,0,38,216660.0,130000.0,-51.0,-50.0,-44.0,-46.0,-51.0,-48.0,-43.0,-47.0,-90.0,-93.0,-90.0,-93.0,39.0,43.0,46.0,47.0,0
7158,CC:2F:71:3F:1F:24,4479162,1188669779,652221,705999195,3826941,482670584,37,531926,565791299,531281,565713713,645,77586,514243,10,652458,66738,34,455,130000.0,39000.0,-67.0,-65.0,-70.0,-68.0,-67.0,-65.0,-70.0,-67.0,-90.0,-93.0,-90.0,-93.0,23.0,28.0,20.0,25.0,0
7159,CC:2F:71:3E:C5:1F,3827728,482766873,785,96087,3826943,482670786,0,3279,275537,2705,207361,574,68176,831,8,1128,18,0,37,144444.0,39000.0,-70.0,-71.0,-67.0,-60.0,-70.0,-71.0,-67.0,-60.0,-90.0,-93.0,-90.0,-93.0,20.0,22.0,23.0,33.0,0
7160,BA:8C:B9:54:50:24,3831688,488823723,4743,6152735,3826945,482670988,0,8441,1655750,8419,1652255,22,3495,2324,14,5132,36,0,53,216660.0,130000.0,-39.0,-36.0,-44.0,-51.0,-43.0,-34.0,-42.0,-46.0,-90.0,-93.0,-90.0,-93.0,51.0,57.0,46.0,42.0,0
7161,92:69:1D:31:68:E9,3830721,486254063,3772,3582671,3826949,482671392,0,4264,1048748,4143,1021548,121,27200,2017,7,3914,80,0,38,216660.0,130000.0,-51.0,-50.0,-44.0,-46.0,-51.0,-48.0,-43.0,-47.0,-90.0,-93.0,-90.0,-93.0,39.0,43.0,46.0,47.0,0
7162,CC:2F:71:3F:1F:24,4479213,1188685273,652264,706013881,3826949,482671392,37,531956,565796719,531311,565719133,645,77586,514273,10,652501,66778,34,455,144444.0,43333.0,-67.0,-65.0,-70.0,-67.0,-67.0,-65.0,-70.0,-67.0,-90.0,-93.0,-90.0,-93.0,23.0,28.0,20.0,26.0,0
7163,CC:2F:71:3E:C5:1F,3827734,482767479,785,96087,3826949,482671392,0,3279,275537,2705,207361,574,68176,831,8,1128,18,0,37,144444.0,39000.0,-70.0,-71.0,-67.0,-60.0,-70.0,-71.0,-67.0,-60.0,-90.0,-93.0,-90.0,-93.0,20.0,22.0,23.0,33.0,0
7164,BA:8C:B9:54:50:24,3831692,488824127,4743,6152735,3826949,482671392,0,8441,1655750,8419,1652255,22,3495,2324,14,5132,36,0,53,216660.0,130000.0,-39.0,-36.0,-44.0,-51.0,-43.0,-34.0,-42.0,-46.0,-90.0,-93.0,-90.0,-93.0,51.0,57.0,46.0,42.0,0
7165,92:69:1D:31:68:E9,3830722,486254123,3772,3582671,3826950,482671452,0,4264,1048748,4143,1021548,121,27200,2017,7,3914,80,0,38,216660.0,130000.0,-51.0,-50.0,-44.0,-46.0,-51.0,-48.0,-43.0,-47.0,-90.0,-93.0,-90.0,-93.0,39.0,43.0,46.0,47.0,0
7166,CC:2F:71:3F:1F:24,4479255,1188699749,652305,706028297,3826950,482671452,37,531984,565801919,531339,565724333,645,77586,514301,10,652542,66813,34,455,144444.0,43333.0,-67.0,-65.0,-70.0,-68.0,-67.0,-65.0,-70.0,-67.0,-90.0,-93.0,-90.0,-93.0,23.0,28.0,20.0,25.0,0
7167,CC:2F:71:3E:C5:1F,3827737,482767741,785,96087,3826952,482671654,0,3279,275537,2705,207361,574,68176,831,8,1128,18,0,37,144444.0,39000.0,-70.0,-71.0,-67.0,-60.0,-70.0,-71.0,-67.0,-60.0,-90.0,-93.0,-90.0,-93.0,20.0,22.0,23.0,33.0,0
7168,BA:8C:B9:54:50:24,3831697,488824591,4743,6152735,3826954,482671856,0,8441,1655750,8419,1652255,22,3495,2324,14,5132,36,0,53,216660.0,130000.0,-39.0,-36.0,-44.0,-51.0,-43.0,-34.0,-42.0,-46.0,-90.0,-93.0,-90.0,-93.0,51.0,57.0,46.0,42.0,0
7169,92:69:1D:31:68:E9,3830731,486254993,3772,3582671,3826959,482672322,0,4264,1048748,4143,1021548,121,27200,2017,7,3914,80,0,38,216660.0,130000.0,-51.0,-50.0,-44.0,-46.0,-51.0,-48.0,-43.0,-47.0,-90.0,-93.0,-90.0,-93.0,39.0,43.0,46.0,47.0,0
7170,CC:2F:71:3F:1F:24,4479306,1188715159,652347,706042837,3826959,482672322,37,532010,565806841,531364,565729137,646,77704,514327,10,652584,66854,34,456,144444.0,43333.0,-67.0,-65.0,-70.0,-67.0,-67.0,-65.0,-70.0,-67.0,-90.0,-93.0,-90.0,-93.0,23.0,28.0,20.0,26.0,0
7171,CC:2F:71:3E:C5:1F,3827744,482768409,785,96087,3826959,482672322,0,3279,275537,2705,207361,574,68176,831,8,1128,18,0,37,144444.0,39000.0,-70.0,-71.0,-67.0,-60.0,-70.0,-71.0,-67.0,-60.0,-90.0,-93.0,-90.0,-93.0,20.0,22.0,23.0,33.0,0
7172,BA:8C:B9:54:50:24,3831702,488825057,4743,6152735,3826959,482672322,0,8441,1655750,8419,1652255,22,3495,2324,14,5132,36,0,53,216660.0,130000.0,-39.0,-36.0,-44.0,-51.0,-43.0,-34.0,-42.0,-46.0,-90.0,-93.0,-90.0,-93.0,51.0,57.0,46.0,42.0,0
7173,92:69:1D:31:68:E9,3830731,486254993,3772,3582671,3826959,482672322,0,4266,1048884,4145,1021684,121,27200,2017,7,3915,80,0,38,216660.0,130000.0,-52.0,-50.0,-44.0,-46.0,-51.0,-48.0,-43.0,-47.0,-90.0,-93.0,-90.0,-93.0,38.0,43.0,46.0,47.0,0
7174,CC:2F:71:3F:1F:24,4479348,1188729699,652389,706057377,3826959,482672322,37,532035,565811645,531389,565733941,646,77704,514352,10,652626,66894,34,456,144444.0,43333.0,-67.0,-65.0,-71.0,-68.0,-67.0,-65.0,-70.0,-67.0,-90.0,-93.0,-90.0,-93.0,23.0,28.0,19.0,25.0,0
7175,CC:2F:71:3E:C5:1F,3827746,482768611,785,96087,3826961,482672524,0,3281,275677,2707,207501,574,68176,831,8,1129,18,0,37,144444.0,39000.0,-70.0,-71.0,-68.0,-60.0,-70.0,-71.0,-67.0,-60.0,-90.0,-93.0,-90.0,-93.0,20.0,22.0,22.0,33.0,0
7176,BA:8C:B9:54:50:24,3831706,488825461,4743,6152735,3826963,482672726,0,8441,1655750,8419,1652255,22,3495,2324,14,5132,36,0,53,216660.0,130000.0,-39.0,-36.0,-44.0,-51.0,-43.0,-34.0,-42.0,-46.0,-90.0,-93.0,-90.0,-93.0,51.0,57.0,46.0,42.0,0
7177,92:69:1D:31:68:E9,3830740,486255861,3772,3582671,3826968,482673190,0,4266,1048884,4145,1021684,121,27200,2017,7,3915,80,0,38,216660.0,130000.0,-52.0,-50.0,-44.0,-46.0,-51.0,-48.0,-43.0,-47.0,-90.0,-93.0,-90.0,-93.0,38.0,43.0,46.0,47.0,0
7178,CC:2F:71:3F:1F:24,4479400,1188745181,652432,706071991,3826968,482673190,37,532061,565816589,531415,565738885,646,77704,514378,10,652669,66934,34,456,130000.0,39000.0,-67.0,-65.0,-71.0,-68.0,-67.0,-65.0,-70.0,-67.0,-90.0,-93.0,-90.0,-93.0,23.0,28.0,19.0,25.0,0
7179,CC:2F:71:3E:C5:1F,3827755,482769509,787,96319,3826968,482673190,0,3285,276029,2711,207853,574,68176,833,8,1131,18,0,37,144444.0,43333.0,-70.0,-71.0,-67.0,-60.0,-70.0,-71.0,-67.0,-60.0,-90.0,-93.0,-90.0,-93.0,20.0,22.0,23.0,33.0,0
7180,BA:8C:B9:54:50:24,3831711,488825925,4743,6152735,3826968,482673190,0,8441,1655750,8419,1652255,22,3495,2324,14,5132,36,0,53,216660.0,130000.0,-39.0,-36.0,-44.0,-51.0,-43.0,-34.0,-42.0,-46.0,-90.0,-93.0,-90.0,-93.0,51.0,57.0,46.0,42.0,0
7181,92:69:1D:31:68:E9,3830740,486255861,3772,3582671,3826968,482673190,0,4266,1048884,4145,1021684,121,27200,2017,7,3915,80,0,38,216660.0,130000.0,-52.0,-50.0,-44.0,-46.0,-51.0,-48.0,-43.0,-47.0,-90.0,-93.0,-90.0,-93.0,38.0,43.0,46.0,47.0,0
7182,CC:2F:71:3F:1F:24,4479443,1188759739,652475,706086549,3826968,482673190,37,532086,565821393,531440,565743689,646,77704,514403,10,652712,66953,34,456,130000.0,39000.0,-67.0,-65.0,-70.0,-67.0,-67.0,-65.0,-70.0,-67.0,-90.0,-93.0,-90.0,-93.0,23.0,28.0,20.0,26.0,0
7183,CC:2F:71:3E:C5:1F,3827757,482769711,787,96319,3826970,482673392,0,3285,276029,2711,207853,574,68176,833,8,1131,18,0,37,144444.0,43333.0,-70.0,-71.0,-67.0,-60.0,-70.0,-71.0,-67.0,-60.0,-90.0,-93.0,-90.0,-93.0,20.0,22.0,23.0,33.0,0
7184,BA:8C:B9:54:50:24,3831715,488826329,4743,6152735,3826972,482673594,0,8441,1655750,8419,1652255,22,3495,2324,14,5132,36,0,53,216660.0,130000.0,-39.0,-36.0,-44.0,-51.0,-43.0,-34.0,-42.0,-46.0,-90.0,-93.0,-90.0,-93.0,51.0,57.0,46.0,42.0,0
7185,92:69:1D:31:68:E9,3830748,486256669,3772,3582671,3826976,482673998,0,4266,1048884,4145,1021684,121,27200,2017,7,3915,80,0,38,216660.0,130000.0,-52.0,-50.0,-44.0,-46.0,-51.0,-48.0,-43.0,-47.0,-90.0,-93.0,-90.0,-93.0,38.0,43.0,46.0,47.0,0
7186,CC:2F:71:3F:1F:24,4479492,1188774907,652516,706100909,3826976,482673998,37,532113,565826477,531467,565748773,646,77704,514430,10,652753,66958,34,456,130000.0,43333.0,-67.0,-65.0,-71.0,-67.0,-67.0,-65.0,-70.0,-67.0,-90.0,-93.0,-90.0,-93.0,23.0,28.0,19.0,26.0,0
7187,CC:2F:71:3E:C5:1F,3827764,482770377,787,96319,3826977,482674058,0,3285,276029,2711,207853,574,68176,833,8,1131,18,0,37,144444.0,43333.0,-70.0,-71.0,-67.0,-60.0,-70.0,-71.0,-67.0,-60.0,-90.0,-93.0,-90.0,-93.0,20.0,22.0,23.0,33.0,0
7188,BA:8C:B9:54:50:24,3831720,488826793,4743,6152735,3826977,482674058,0,8441,1655750,8419,1652255,22,3495,2324,14,5132,36,0,53,216660.0,130000.0,-39.0,-36.0,-44.0,-51.0,-43.0,-34.0,-42.0,-46.0,-90.0,-93.0,-90.0,-93.0,51.0,57.0,46.0,42.0,0
7189,92:69:1D:31:68:E9,3830749,486256729,3772,3582671,3826977,482674058,0,4266,1048884,4145,1021684,121,27200,2017,7,3915,80,0,38,216660.0,130000.0,-52.0,-50.0,-44.0,-46.0,-51.0,-48.0,-43.0,-47.0,-90.0,-93.0,-90.0,-93.0,38.0,43.0,46.0,47.0,0
7190,CC:2F:71:3F:1F:24,4479536,1188789525,652559,706115467,3826977,482674058,37,532139,565831397,531493,565753693,646,77704,514456,10,652796,66977,34,456,117000.0,39000.0,-67.0,-65.0,-70.0,-67.0,-67.0,-65.0,-70.0,-67.0,-90.0,-93.0,-90.0,-93.0,23.0,28.0,20.0,26.0,0
7191,CC:2F:71:3E:C5:1F,3827766,482770579,787,96319,3826979,482674260,0,3285,276029,2711,207853,574,68176,833,8,1131,18,0,37,144444.0,43333.0,-70.0,-71.0,-67.0,-60.0,-70.0,-71.0,-67.0,-60.0,-90.0,-93.0,-90.0,-93.0,20.0,22.0,23.0,33.0,0
7192,BA:8C:B9:54:50:24,3831722,488826995,4743,6152735,3826979,482674260,0,8441,1655750,8419,1652255,22,3495,2324,14,5132,36,0,53,216660.0,130000.0,-39.0,-36.0,-44.0,-51.0,-43.0,-34.0,-42.0,-46.0,-90.0,-93.0,-90.0,-93.0,51.0,57.0,46.0,42.0,0
7193,92:69:1D:31:68:E9,3830757,486257537,3772,3582671,3826985,482674866,0,4266,1048884,4145,1021684,121,27200,2017,7,3915,80,0,38,216660.0,130000.0,-52.0,-50.0,-44.0,-46.0,-51.0,-48.0,-43.0,-47.0,-90.0,-93.0,-90.0,-93.0,38.0,43.0,46.0,47.0,0
7194,CC:2F:71:3F:1F:24,4479587,1188804885,652602,706130019,3826985,482674866,37,532164,565836201,531518,565758497,646,77704,514481,10,652839,66984,34,456,130000.0,43333.0,-67.0,-65.0,-71.0,-67.0,-67.0,-65.0,-70.0,-67.0,-90.0,-93.0,-90.0,-93.0,23.0,28.0,19.0,26.0,0
7195,CC:2F:71:3E:C5:1F,3827772,482771185,787,96319,3826985,482674866,0,3285,276029,2711,207853,574,68176,833,8,1131,18,0,37,144444.0,43333.0,-70.0,-71.0,-67.0,-60.0,-70.0,-71.0,-67.0,-60.0,-90.0,-93.0,-90.0,-93.0,20.0,22.0,23.0,33.0,0
7196,BA:8C:B9:54:50:24,3831728,488827601,4743,6152735,3826985,482674866,0,8441,1655750,8419,1652255,22,3495,2324,14,5132,36,0,53,216660.0,130000.0,-39.0,-36.0,-44.0,-51.0,-43.0,-34.0,-42.0,-46.0,-90.0,-93.0,-90.0,-93.0,51.0,57.0,46.0,42.0,0
7197,92:69:1D:31:68:E9,3830758,486257597,3772,3582671,3826986,482674926,0,4266,1048884,4145,1021684,121,27200,2017,7,3915,80,0,38,216660.0,130000.0,-52.0,-50.0,-44.0,-46.0,-51.0,-48.0,-43.0,-47.0,-90.0,-93.0,-90.0,-93.0,38.0,43.0,46.0,47.0,0
7198,CC:2F:71:3F:1F:24,4479631,1188819497,652645,706144571,3826986,482674926,37,532191,565841297,531545,565763593,646,77704,514508,10,652882,67020,34,456,144444.0,39000.0,-67.0,-65.0,-70.0,-67.0,-67.0,-65.0,-70.0,-67.0,-90.0,-93.0,-90.0,-93.0,23.0,28.0,20.0,26.0,0
7199,CC:2F:71:3E:C5:1F,3827775,482771447,787,96319,3826988,482675128,0,3285,276029,2711,207853,574,68176,833,8,1131,18,0,37,144444.0,43333.0,-70.0,-71.0,-67.0,-60.0,-70.0,-71.0,-67.0,-60.0,-90.0,-93.0,-90.0,-93.0,20.0,22.0,23.0,33.0,0
7200,BA:8C:B9:54:50:24,3831731,488827863,4743,6152735,3826988,482675128,0,8441,1655750,8419,1652255,22,3495,2324,14,5132,36,0,53,216660.0,130000.0,-39.0,-36.0,-44.0,-51.0,-43.0,-34.0,-42.0,-46.0,-90.0,-93.0,-90.0,-93.0,51.0,57.0,46.0,42.0,0
7201,92:69:1D:31:68:E9,3830764,486258203,3772,3582671,3826992,482675532,0,4266,1048884,4145,1021684,121,27200,2017,7,3915,80,0,38,216660.0,130000.0,-52.0,-50.0,-44.0,-46.0,-51.0,-48.0,-43.0,-47.0,-90.0,-93.0,-90.0,-93.0,38.0,43.0,46.0,47.0,0
7202,CC:2F:71:3F:1F:24,4479680,1188834661,652688,706159129,3826992,482675532,37,532218,565846357,531572,565768653,646,77704,514535,10,652925,67031,34,456,130000.0,43333.0,-67.0,-65.0,-70.0,-67.0,-67.0,-65.0,-70.0,-67.0,-90.0,-93.0,-90.0,-93.0,23.0,28.0,20.0,26.0,0
7203,CC:2F:71:3E:C5:1F,3827782,482772179,787,96319,3826995,482675860,0,3285,276029,2711,207853,574,68176,833,8,1131,18,0,37,144444.0,43333.0,-70.0,-71.0,-67.0,-60.0,-70.0,-71.0,-67.0,-60.0,-90.0,-93.0,-90.0,-93.0,20.0,22.0,23.0,33.0,0
7204,BA:8C:B9:54:50:24,3831738,488828595,4743,6152735,3826995,482675860,0,8441,1655750,8419,1652255,22,3495,2324,14,5132,36,0,53,216660.0,130000.0,-39.0,-36.0,-44.0,-51.0,-43.0,-34.0,-42.0,-46.0,-90.0,-93.0,-90.0,-93.0,51.0,57.0,46.0,42.0,0
7205,92:69:1D:31:68:E9,3830768,486258804,3772,3582671,3826996,482676133,0,4266,1048884,4145,1021684,121,27200,2017,7,3915,80,0,38,216660.0,130000.0,-52.0,-50.0,-44.0,-46.0,-51.0,-48.0,-43.0,-47.0,-90.0,-93.0,-90.0,-93.0,38.0,43.0,46.0,47.0,0
7206,CC:2F:71:3F:1F:24,4479727,1188849768,652729,706173433,3826998,482676335,37,532243,565851161,531597,565773457,646,77704,514560,10,652966,67041,34,456,117000.0,39000.0,-67.0,-65.0,-70.0,-67.0,-67.0,-65.0,-70.0,-67.0,-90.0,-93.0,-90.0,-93.0,23.0,28.0,20.0,26.0,0
7207,CC:2F:71:3E:C5:1F,3827785,482772654,787,96319,3826998,482676335,0,3285,276029,2711,207853,574,68176,833,8,1131,18,0,37,144444.0,43333.0,-70.0,-71.0,-67.0,-60.0,-70.0,-71.0,-67.0,-60.0,-90.0,-93.0,-90.0,-93.0,20.0,22.0,23.0,33.0,0
7208,BA:8C:B9:54:50:24,3831742,488829138,4743,6152735,3826999,482676403,0,8441,1655750,8419,1652255,22,3495,2324,14,5132,36,0,53,216660.0,130000.0,-39.0,-36.0,-44.0,-51.0,-43.0,-34.0,-42.0,-46.0,-90.0,-93.0,-90.0,-93.0,51.0,57.0,46.0,42.0,0
7209,92:69:1D:31:68:E9,3830775,486259470,3772,3582671,3827003,482676799,0,4266,1048884,4145,1021684,121,27200,2017,7,3915,80,0,38,216660.0,130000.0,-52.0,-50.0,-44.0,-46.0,-51.0,-48.0,-43.0,-47.0,-90.0,-93.0,-90.0,-93.0,38.0,43.0,46.0,47.0,0
7210,CC:2F:71:3F:1F:24,4479774,1188864654,652771,706187855,3827003,482676799,37,532271,565856361,531625,565778657,646,77704,514588,10,653008,67043,34,456,130000.0,43333.0,-67.0,-65.0,-70.0,-68.0,-67.0,-65.0,-70.0,-67.0,-90.0,-93.0,-90.0,-93.0,23.0,28.0,20.0,25.0,0
7211,CC:2F:71:3E:C5:1F,3827792,482773320,787,96319,3827005,482677001,0,3285,276029,2711,207853,574,68176,833,8,1131,18,0,37,144444.0,43333.0,-70.0,-71.0,-67.0,-60.0,-70.0,-71.0,-67.0,-60.0,-90.0,-93.0,-90.0,-93.0,20.0,22.0,23.0,33.0,0
7212,BA:8C:B9:54:50:24,3831748,488829736,4743,6152735,3827005,482677001,0,8441,1655750,8419,1652255,22,3495,2324,14,5132,36,0,53,216660.0,130000.0,-39.0,-36.0,-44.0,-51.0,-43.0,-34.0,-42.0,-46.0,-90.0,-93.0,-90.0,-93.0,51.0,57.0,46.0,42.0,0
7213,92:69:1D:31:68:E9,3830777,486259672,3772,3582671,3827005,482677001,0,4266,1048884,4145,1021684,121,27200,2017,7,3915,80,0,38,216660.0,130000.0,-52.0,-50.0,-44.0,-46.0,-51.0,-48.0,-43.0,-47.0,-90.0,-93.0,-90.0,-93.0,38.0,43.0,46.0,47.0,0
7214,CC:2F:71:3F:1F:24,4479819,1188879362,652812,706202159,3827007,482677203,37,532297,565861305,531651,565783601,646,77704,514614,10,653049,67067,34,456,117000.0,39000.0,-67.0,-65.0,-70.0,-68.0,-67.0,-65.0,-70.0,-67.0,-90.0,-93.0,-90.0,-93.0,23.0,28.0,20.0,25.0,0
7215,CC:2F:71:3E:C5:1F,3827794,482773522,787,96319,3827007,482677203,0,3285,276029,2711,207853,574,68176,833,8,1131,18,0,37,144444.0,43333.0,-70.0,-71.0,-67.0,-60.0,-70.0,-71.0,-67.0,-60.0,-90.0,-93.0,-90.0,-93.0,20.0,22.0,23.0,33.0,0
7216,BA:8C:B9:54:50:24,3831750,488829938,4743,6152735,3827007,482677203,0,8441,1655750,8419,1652255,22,3495,2324,14,5132,36,0,53,216660.0,130000.0,-39.0,-36.0,-44.0,-51.0,-43.0,-34.0,-42.0,-46.0,-90.0,-93.0,-90.0,-93.0,51.0,57.0,46.0,42.0,0
7217,92:69:1D:31:68:E9,3830783,486260278,3772,3582671,3827011,482677607,0,4266,1048884,4145,1021684,121,27200,2017,7,3915,80,0,38,216660.0,130000.0,-52.0,-50.0,-44.0,-46.0,-51.0,-48.0,-43.0,-47.0,-90.0,-93.0,-90.0,-93.0,38.0,43.0,46.0,47.0,0
7218,CC:2F:71:3F:1F:24,4479866,1188894260,652854,706216593,3827012,482677667,37,532325,565866481,531679,565788777,646,77704,514642,10,653091,67077,34,456,130000.0,43333.0,-67.0,-65.0,-70.0,-67.0,-67.0,-65.0,-70.0,-67.0,-90.0,-93.0,-90.0,-93.0,23.0,28.0,20.0,26.0,0
7219,CC:2F:71:3E:C5:1F,3827801,482774188,787,96319,3827014,482677869,0,3285,276029,2711,207853,574,68176,833,8,1131,18,0,37,144444.0,43333.0,-70.0,-71.0,-67.0,-60.0,-70.0,-71.0,-67.0,-60.0,-90.0,-93.0,-90.0,-93.0,20.0,22.0,23.0,33.0,0
7220,BA:8C:B9:54:50:24,3831757,488830604,4743,6152735,3827014,482677869,0,8441,1655750,8419,1652255,22,3495,2324,14,5132,36,0,53,216660.0,130000.0,-39.0,-36.0,-44.0,-51.0,-43.0,-34.0,-42.0,-46.0,-90.0,-93.0,-90.0,-93.0,51.0,57.0,46.0,42.0,0
7221,92:69:1D:31:68:E9,3830786,486260540,3772,3582671,3827014,482677869,0,4266,1048884,4145,1021684,121,27200,2017,7,3915,80,0,38,216660.0,130000.0,-52.0,-50.0,-44.0,-46.0,-51.0,-48.0,-43.0,-47.0,-90.0,-93.0,-90.0,-93.0,38.0,43.0,46.0,47.0,0
7222,CC:2F:71:3F:1F:24,4479913,1188909216,652897,706231145,3827016,482678071,37,532351,565871425,531705,565793721,646,77704,514668,10,653134,67102,34,456,117000.0,39000.0,-67.0,-65.0,-71.0,-67.0,-67.0,-65.0,-70.0,-67.0,-90.0,-93.0,-90.0,-93.0,23.0,28.0,19.0,26.0,0
7223,CC:2F:71:3E:C5:1F,3827803,482774390,787,96319,3827016,482678071,0,3285,276029,2711,207853,574,68176,833,8,1131,18,0,37,144444.0,43333.0,-70.0,-71.0,-67.0,-60.0,-70.0,-71.0,-67.0,-60.0,-90.0,-93.0,-90.0,-93.0,20.0,22.0,23.0,33.0,0
7224,BA:8C:B9:54:50:24,3831759,488830806,4743,6152735,3827016,482678071,0,8441,1655750,8419,1652255,22,3495,2324,14,5132,36,0,53,216660.0,130000.0,-39.0,-36.0,-44.0,-51.0,-43.0,-34.0,-42.0,-46.0,-90.0,-93.0,-90.0,-93.0,51.0,57.0,46.0,42.0,0
7225,92:69:1D:31:68:E9,3830792,486261146,3772,3582671,3827020,482678475,0,4266,1048884,4145,1021684,121,27200,2017,7,3915,80,0,38,216660.0,130000.0,-52.0,-50.0,-44.0,-46.0,-51.0,-48.0,-43.0,-47.0,-90.0,-93.0,-90.0,-93.0,38.0,43.0,46.0,47.0,0
7226,CC:2F:71:3F:1F:24,4479959,1188924054,652939,706245579,3827020,482678475,37,532377,565876369,531731,565798665,646,77704,514694,10,653176,67111,34,456,130000.0,43333.0,-67.0,-65.0,-70.0,-68.0,-67.0,-65.0,-70.0,-67.0,-90.0,-93.0,-90.0,-93.0,23.0,28.0,20.0,25.0,0
7227,CC:2F:71:3E:C5:1F,3827807,482774794,787,96319,3827020,482678475,0,3285,276029,2711,207853,574,68176,833,8,1131,18,0,37,144444.0,43333.0,-70.0,-71.0,-67.0,-60.0,-70.0,-71.0,-67.0,-60.0,-90.0,-93.0,-90.0,-93.0,20.0,22.0,23.0,33.0,0
7228,BA:8C:B9:54:50:24,3831765,488831412,4743,6152735,3827022,482678677,0,8441,1655750,8419,1652255,22,3495,2324,14,5132,36,0,53,216660.0,130000.0,-39.0,-36.0,-44.0,-51.0,-43.0,-34.0,-42.0,-46.0,-90.0,-93.0,-90.0,-93.0,51.0,57.0,46.0,42.0,0
7229,92:69:1D:31:68:E9,3830795,486261408,3772,3582671,3827023,482678737,0,4266,1048884,4145,1021684,121,27200,2017,7,3915,80,0,38,216660.0,130000.0,-52.0,-50.0,-44.0,-46.0,-51.0,-48.0,-43.0,-47.0,-90.0,-93.0,-90.0,-93.0,38.0,43.0,46.0,47.0,0
7230,CC:2F:71:3F:1F:24,4480008,1188939306,652983,706260367,3827025,482678939,37,532404,565881453,531758,565803749,646,77704,514721,10,653219,67118,34,456,130000.0,43333.0,-67.0,-65.0,-70.0,-68.0,-67.0,-65.0,-70.0,-67.0,-90.0,-93.0,-90.0,-93.0,23.0,28.0,20.0,25.0,0
7231,CC:2F:71:3E:C5:1F,3827812,482775258,787,96319,3827025,482678939,0,3285,276029,2711,207853,574,68176,833,8,1131,18,0,37,144444.0,43333.0,-70.0,-71.0,-67.0,-60.0,-70.0,-71.0,-67.0,-60.0,-90.0,-93.0,-90.0,-93.0,20.0,22.0,23.0,33.0,0
7232,BA:8C:B9:54:50:24,3831768,488831674,4743,6152735,3827025,482678939,0,8441,1655750,8419,1652255,22,3495,2324,14,5132,36,0,53,216660.0,130000.0,-39.0,-36.0,-44.0,-51.0,-43.0,-34.0,-42.0,-46.0,-90.0,-93.0,-90.0,-93.0,51.0,57.0,46.0,42.0,0
7233,92:69:1D:31:68:E9,3830801,486262014,3772,3582671,3827029,482679343,0,4266,1048884,4145,1021684,121,27200,2017,7,3915,80,0,38,216660.0,130000.0,-52.0,-50.0,-44.0,-46.0,-51.0,-48.0,-43.0,-47.0,-90.0,-93.0,-90.0,-93.0,38.0,43.0,46.0,47.0,0
7234,CC:2F:71:3F:1F:24,4480053,1188954014,653024,706274671,3827029,482679343,37,532430,565886397,531784,565808693,646,77704,514747,10,653261,67153,34,456,117000.0,39000.0,-67.0,-65.0,-71.0,-67.0,-67.0,-65.0,-70.0,-67.0,-90.0,-93.0,-90.0,-93.0,23.0,28.0,19.0,26.0,0
7235,CC:2F:71:3E:C5:1F,3827816,482775662,787,96319,3827029,482679343,0,3285,276029,2711,207853,574,68176,833,8,1131,18,0,37,144444.0,43333.0,-70.0,-71.0,-67.0,-60.0,-70.0,-71.0,-67.0,-60.0,-90.0,-93.0,-90.0,-93.0,20.0,22.0,23.0,33.0,0
7236,BA:8C:B9:54:50:24,3831772,488832078,4743,6152735,3827029,482679343,0,8441,1655750,8419,1652255,22,3495,2324,14,5132,36,0,53,216660.0,130000.0,-39.0,-36.0,-44.0,-51.0,-43.0,-34.0,-42.0,-46.0,-90.0,-93.0,-90.0,-93.0,51.0,57.0,46.0,42.0,0
7237,92:69:1D:31:68:E9,3830803,486262216,3772,3582671,3827031,482679545,0,4266,1048884,4145,1021684,121,27200,2017,7,3915,80,0,38,216660.0,130000.0,-52.0,-50.0,-44.0,-46.0,-51.0,-48.0,-43.0,-47.0,-90.0,-93.0,-90.0,-93.0,38.0,43.0,46.0,47.0,0
7238,CC:2F:71:3F:1F:24,4480099,1188968846,653066,706289099,3827033,482679747,37,532456,565891377,531810,565813673,646,77704,514773,10,653303,67159,34,456,130000.0,43333.0,-67.0,-65.0,-71.0,-68.0,-67.0,-65.0,-70.0,-67.0,-90.0,-93.0,-90.0,-93.0,23.0,28.0,19.0,25.0,0
7239,CC:2F:71:3E:C5:1F,3827820,482776066,787,96319,3827033,482679747,0,3285,276029,2711,207853,574,68176,833,8,1131,18,0,37,144444.0,43333.0,-70.0,-71.0,-67.0,-60.0,-70.0,-71.0,-67.0,-60.0,-90.0,-93.0,-90.0,-93.0,20.0,22.0,23.0,33.0,0
7240,BA:8C:B9:54:50:24,3831776,488832482,4743,6152735,3827033,482679747,0,8441,1655750,8419,1652255,22,3495,2324,14,5132,36,0,53,216660.0,130000.0,-39.0,-36.0,-44.0,-51.0,-43.0,-34.0,-42.0,-46.0,-90.0,-93.0,-90.0,-93.0,51.0,57.0,46.0,42.0,0
7241,92:69:1D:31:68:E9,3830810,486262882,3772,3582671,3827038,482680211,0,4267,1048952,4146,1021752,121,27200,2017,7,3915,80,0,38,216660.0,130000.0,-52.0,-50.0,-44.0,-46.0,-51.0,-48.0,-43.0,-47.0,-90.0,-93.0,-90.0,-93.0,38.0,43.0,46.0,47.0,0
7242,CC:2F:71:3F:1F:24,4480148,1188984016,653110,706303805,3827038,482680211,37,532485,565896753,531839,565819049,646,77704,514802,10,653347,67177,34,456,117000.0,39000.0,-67.0,-65.0,-71.0,-68.0,-67.0,-65.0,-70.0,-67.0,-90.0,-93.0,-90.0,-93.0,23.0,28.0,19.0,25.0,0
7243,CC:2F:71:3E:C5:1F,3827825,482776530,787,96319,3827038,482680211,0,3285,276029,2711,207853,574,68176,833,8,1131,18,0,37,144444.0,43333.0,-70.0,-71.0,-67.0,-60.0,-70.0,-71.0,-67.0,-60.0,-90.0,-93.0,-90.0,-93.0,20.0,22.0,23.0,33.0,0
7244,BA:8C:B9:54:50:24,3831781,488832946,4743,6152735,3827038,482680211,0,8441,1655750,8419,1652255,22,3495,2324,14,5132,36,0,53,216660.0,130000.0,-39.0,-36.0,-44.0,-51.0,-43.0,-34.0,-42.0,-46.0,-90.0,-93.0,-90.0,-93.0,51.0,57.0,46.0,42.0,0
7245,92:69:1D:31:68:E9,3830812,486263084,3772,3582671,3827040,482680413,0,4267,1048952,4146,1021752,121,27200,2017,7,3915,80,0,38,216660.0,130000.0,-52.0,-50.0,-44.0,-46.0,-51.0,-48.0,-43.0,-47.0,-90.0,-93.0,-90.0,-93.0,38.0,43.0,46.0,47.0,0
7246,CC:2F:71:3F:1F:24,4480193,1188998724,653151,706318109,3827042,482680615,37,532514,565902105,531868,565824401,646,77704,514831,10,653388,67191,34,456,130000.0,39000.0,-67.0,-65.0,-70.0,-67.0,-67.0,-65.0,-70.0,-67.0,-90.0,-93.0,-90.0,-93.0,23.0,28.0,20.0,26.0,0
7247,CC:2F:71:3E:C5:1F,3827829,482776934,787,96319,3827042,482680615,0,3285,276029,2711,207853,574,68176,833,8,1131,18,0,37,144444.0,43333.0,-70.0,-71.0,-67.0,-60.0,-70.0,-71.0,-67.0,-60.0,-90.0,-93.0,-90.0,-93.0,20.0,22.0,23.0,33.0,0
7248,BA:8C:B9:54:50:24,3831785,488833350,4743,6152735,3827042,482680615,0,8441,1655750,8419,1652255,22,3495,2324,14,5132,36,0,53,216660.0,130000.0,-39.0,-36.0,-44.0,-51.0,-43.0,-34.0,-42.0,-46.0,-90.0,-93.0,-90.0,-93.0,51.0,57.0,46.0,42.0,0
7249,92:69:1D:31:68:E9,3830819,486263750,3772,3582671,3827047,482681079,0,4267,1048952,4146,1021752,121,27200,2017,7,3915,80,0,38,216660.0,130000.0,-52.0,-50.0,-44.0,-46.0,-51.0,-48.0,-43.0,-47.0,-90.0,-93.0,-90.0,-93.0,38.0,43.0,46.0,47.0,0
7250,CC:2F:71:3F:1F:24,4480240,1189013560,653193,706332481,3827047,482681079,37,532539,565906909,531893,565829205,646,77704,514856,10,653430,67198,34,456,130000.0,39000.0,-67.0,-65.0,-70.0,-67.0,-67.0,-65.0,-70.0,-67.0,-90.0,-93.0,-90.0,-93.0,23.0,28.0,20.0,26.0,0
7251,CC:2F:71:3E:C5:1F,3827834,482777398,787,96319,3827047,482681079,0,3285,276029,2711,207853,574,68176,833,8,1131,18,0,37,144444.0,43333.0,-70.0,-71.0,-67.0,-60.0,-70.0,-71.0,-67.0,-60.0,-90.0,-93.0,-90.0,-93.0,20.0,22.0,23.0,33.0,0
7252,BA:8C:B9:54:50:24,3831790,488833814,4743,6152735,3827047,482681079,0,8441,1655750,8419,1652255,22,3495,2324,14,5132,36,0,53,216660.0,130000.0,-39.0,-36.0,-44.0,-51.0,-43.0,-34.0,-42.0,-46.0,-90.0,-93.0,-90.0,-93.0,51.0,57.0,46.0,42.0,0
7253,92:69:1D:31:68:E9,3830824,486264270,3773,3582787,3827051,482681483,0,4269,1049088,4148,1021888,121,27200,2017,7,3916,80,0,38,216660.0,130000.0,-52.0,-50.0,-45.0,-46.0,-51.0,-48.0,-43.0,-46.0,-90.0,-93.0,-90.0,-93.0,38.0,43.0,45.0,47.0,0
7254,CC:2F:71:3F:1F:24,4480285,1189028198,653234,706346715,3827051,482681483,37,532566,565911969,531920,565834265,646,77704,514883,10,653471,67214,34,456,117000.0,39000.0,-67.0,-65.0,-70.0,-67.0,-67.0,-65.0,-70.0,-67.0,-90.0,-93.0,-90.0,-93.0,23.0,28.0,20.0,26.0,0
7255,CC:2F:71:3E:C5:1F,3827839,482777862,788,96379,3827051,482681483,0,3287,276169,2713,207993,574,68176,833,8,1132,18,0,37,144444.0,43333.0,-70.0,-71.0,-67.0,-60.0,-70.0,-70.0,-67.0,-60.0,-90.0,-93.0,-90.0,-93.0,20.0,22.0,23.0,33.0,0
7256,BA:8C:B9:54:50:24,3831795,488834334,4744,6152851,3827051,482681483,0,8443,1655886,8421,1652391,22,3495,2324,14,5133,36,0,53,216660.0,130000.0,-49.0,-35.0,-42.0,-44.0,-43.0,-34.0,-42.0,-46.0,-90.0,-93.0,-90.0,-93.0,41.0,58.0,48.0,49.0,0
7257,92:69:1D:31:68:E9,3830829,486264947,3773,3582787,3827056,482682160,0,4269,1049088,4148,1021888,121,27200,2017,7,3916,80,0,38,216660.0,130000.0,-52.0,-50.0,-45.0,-46.0,-51.0,-48.0,-43.0,-46.0,-90.0,-93.0,-90.0,-93.0,38.0,43.0,45.0,47.0,0
7258,CC:2F:71:3F:1F:24,4480332,1189043303,653276,706361143,3827056,482682160,37,532592,565916913,531946,565839209,646,77704,514909,10,653513,67217,34,456,130000.0,43333.0,-67.0,-65.0,-70.0,-68.0,-67.0,-65.0,-70.0,-67.0,-90.0,-93.0,-90.0,-93.0,23.0,28.0,20.0,25.0,0
7259,CC:2F:71:3E:C5:1F,3827844,482778539,788,96379,3827056,482682160,0,3287,276169,2713,207993,574,68176,833,8,1132,18,0,37,144444.0,43333.0,-70.0,-71.0,-67.0,-60.0,-70.0,-70.0,-67.0,-60.0,-90.0,-93.0,-90.0,-93.0,20.0,22.0,23.0,33.0,0
7260,BA:8C:B9:54:50:24,3831800,488835011,4744,6152851,3827056,482682160,0,8443,1655886,8421,1652391,22,3495,2324,14,5133,36,0,53,216660.0,130000.0,-49.0,-35.0,-42.0,-44.0,-43.0,-34.0,-42.0,-46.0,-90.0,-93.0,-90.0,-93.0,41.0,58.0,48.0,49.0,0
7261,92:69:1D:31:68:E9,3830834,486265411,3773,3582787,3827061,482682624,0,4269,1049088,4148,1021888,121,27200,2017,7,3916,80,0,38,216660.0,130000.0,-52.0,-50.0,-45.0,-46.0,-51.0,-48.0,-43.0,-46.0,-90.0,-93.0,-90.0,-93.0,38.0,43.0,45.0,47.0,0
7262,CC:2F:71:3F:1F:24,4480379,1189058307,653318,706375683,3827061,482682624,37,532617,565921717,531971,565844013,646,77704,514934,10,653555,67222,34,456,130000.0,43333.0,-67.0,-65.0,-70.0,-67.0,-67.0,-65.0,-70.0,-67.0,-90.0,-93.0,-90.0,-93.0,23.0,28.0,20.0,26.0,0
7263,CC:2F:71:3E:C5:1F,3827849,482779003,788,96379,3827061,482682624,0,3287,276169,2713,207993,574,68176,833,8,1132,18,0,37,144444.0,43333.0,-70.0,-71.0,-67.0,-60.0,-70.0,-70.0,-67.0,-60.0,-90.0,-93.0,-90.0,-93.0,20.0,22.0,23.0,33.0,0
7264,BA:8C:B9:54:50:24,3831805,488835475,4744,6152851,3827061,482682624,0,8443,1655886,8421,1652391,22,3495,2324,14,5133,36,0,53,216660.0,130000.0,-49.0,-35.0,-42.0,-44.0,-43.0,-34.0,-42.0,-46.0,-90.0,-93.0,-90.0,-93.0,41.0,58.0,48.0,49.0,0
7265,92:69:1D:31:68:E9,3830838,486265815,3773,3582787,3827065,482683028,0,4269,1049088,4148,1021888,121,27200,2017,7,3916,80,0,38,216660.0,130000.0,-52.0,-50.0,-45.0,-46.0,-51.0,-48.0,-43.0,-46.0,-90.0,-93.0,-90.0,-93.0,38.0,43.0,45.0,47.0,0
7266,CC:2F:71:3F:1F:24,4480425,1189073139,653360,706390111,3827065,482683028,37,532643,565926661,531997,565848957,646,77704,514960,10,653597,67246,34,456,117000.0,39000.0,-67.0,-65.0,-71.0,-68.0,-67.0,-65.0,-70.0,-67.0,-90.0,-93.0,-90.0,-93.0,23.0,28.0,19.0,25.0,0
7267,CC:2F:71:3E:C5:1F,3827853,482779407,788,96379,3827065,482683028,0,3287,276169,2713,207993,574,68176,833,8,1132,18,0,37,144444.0,43333.0,-70.0,-71.0,-67.0,-60.0,-70.0,-70.0,-67.0,-60.0,-90.0,-93.0,-90.0,-93.0,20.0,22.0,23.0,33.0,0
7268,BA:8C:B9:54:50:24,3831810,488835941,4744,6152851,3827066,482683090,0,8443,1655886,8421,1652391,22,3495,2324,14,5133,36,0,53,216660.0,130000.0,-49.0,-35.0,-42.0,-44.0,-43.0,-34.0,-42.0,-46.0,-90.0,-93.0,-90.0,-93.0,41.0,58.0,48.0,49.0,0
7269,92:69:1D:31:68:E9,3830843,486266281,3773,3582787,3827070,482683494,0,4269,1049088,4148,1021888,121,27200,2017,7,3916,80,0,38,216660.0,130000.0,-52.0,-50.0,-45.0,-46.0,-51.0,-48.0,-43.0,-46.0,-90.0,-93.0,-90.0,-93.0,38.0,43.0,45.0,47.0,0
7270,CC:2F:71:3F:1F:24,4480472,1189088033,653402,706404539,3827070,482683494,37,532669,565931583,532022,565853761,647,77822,514986,10,653639,67246,34,456,130000.0,43333.0,-67.0,-65.0,-70.0,-67.0,-67.0,-65.0,-70.0,-67.0,-90.0,-93.0,-90.0,-93.0,23.0,28.0,20.0,26.0,0
7271,CC:2F:71:3E:C5:1F,3827858,482779873,788,96379,3827070,482683494,0,3287,276169,2713,207993,574,68176,833,8,1132,18,0,37,144444.0,43333.0,-70.0,-71.0,-67.0,-60.0,-70.0,-70.0,-67.0,-60.0,-90.0,-93.0,-90.0,-93.0,20.0,22.0,23.0,33.0,0
7272,BA:8C:B9:54:50:24,3831817,488836773,4744,6152851,3827073,482683922,0,8443,1655886,8421,1652391,22,3495,2324,14,5133,36,0,53,216660.0,130000.0,-49.0,-35.0,-42.0,-44.0,-43.0,-34.0,-42.0,-46.0,-90.0,-93.0,-90.0,-93.0,41.0,58.0,48.0,49.0,0
7273,92:69:1D:31:68:E9,3830850,486267113,3773,3582787,3827077,482684326,0,4269,1049088,4148,1021888,121,27200,2017,7,3916,80,0,38,216660.0,130000.0,-52.0,-50.0,-45.0,-46.0,-51.0,-48.0,-43.0,-46.0,-90.0,-93.0,-90.0,-93.0,38.0,43.0,45.0,47.0,0
7274,CC:2F:71:3F:1F:24,4480521,1189103293,653444,706418967,3827077,482684326,37,532696,565936643,532049,565858821,647,77822,515013,10,653681,67262,34,456,117000.0,39000.0,-67.0,-65.0,-70.0,-67.0,-67.0,-65.0,-70.0,-67.0,-90.0,-93.0,-90.0,-93.0,23.0,28.0,20.0,26.0,0
7275,CC:2F:71:3E:C5:1F,3827865,482780705,788,96379,3827077,482684326,0,3287,276169,2713,207993,574,68176,833,8,1132,18,0,37,144444.0,43333.0,-70.0,-71.0,-67.0,-60.0,-70.0,-70.0,-67.0,-60.0,-90.0,-93.0,-90.0,-93.0,20.0,22.0,23.0,33.0,0
7276,BA:8C:B9:54:50:24,3831821,488837177,4744,6152851,3827077,482684326,0,8443,1655886,8421,1652391,22,3495,2324,14,5133,36,0,53,216660.0,130000.0,-49.0,-35.0,-42.0,-44.0,-43.0,-34.0,-42.0,-46.0,-90.0,-93.0,-90.0,-93.0,41.0,58.0,48.0,49.0,0
7277,92:69:1D:31:68:E9,3830854,486267517,3773,3582787,3827081,482684730,0,4269,1049088,4148,1021888,121,27200,2017,7,3916,80,0,38,216660.0,130000.0,-52.0,-50.0,-45.0,-46.0,-51.0,-48.0,-43.0,-46.0,-90.0,-93.0,-90.0,-93.0,38.0,43.0,45.0,47.0,0
7278,CC:2F:71:3F:1F:24,4480569,1189118507,653488,706433777,3827081,482684730,37,532724,565941831,532077,565864009,647,77822,515041,10,653725,67265,34,456,130000.0,43333.0,-67.0,-65.0,-70.0,-68.0,-67.0,-65.0,-70.0,-67.0,-90.0,-93.0,-90.0,-93.0,23.0,28.0,20.0,25.0,0
7279,CC:2F:71:3E:C5:1F,3827869,482781109,788,96379,3827081,482684730,0,3287,276169,2713,207993,574,68176,833,8,1132,18,0,37,144444.0,43333.0,-70.0,-71.0,-67.0,-60.0,-70.0,-70.0,-67.0,-60.0,-90.0,-93.0,-90.0,-93.0,20.0,22.0,23.0,33.0,0
7280,BA:8C:B9:54:50:24,3831825,488837581,4744,6152851,3827081,482684730,0,8443,1655886,8421,1652391,22,3495,2324,14,5133,36,0,53,216660.0,130000.0,-49.0,-35.0,-42.0,-44.0,-43.0,-34.0,-42.0,-46.0,-90.0,-93.0,-90.0,-93.0,41.0,58.0,48.0,49.0,0
7281,92:69:1D:31:68:E9,3830859,486267981,3773,3582787,3827086,482685194,0,4271,1049224,4150,1022024,121,27200,2017,7,3917,80,0,38,216660.0,130000.0,-52.0,-51.0,-45.0,-46.0,-51.0,-49.0,-43.0,-46.0,-90.0,-93.0,-90.0,-93.0,38.0,42.0,45.0,47.0,0
7282,CC:2F:71:3F:1F:24,4480617,1189133579,653531,706448385,3827086,482685194,37,532751,565946927,532104,565869105,647,77822,515068,10,653767,67275,34,456,130000.0,39000.0,-67.0,-65.0,-70.0,-67.0,-67.0,-65.0,-70.0,-67.0,-90.0,-93.0,-90.0,-93.0,23.0,28.0,20.0,26.0,0
7283,CC:2F:71:3E:C5:1F,3827874,482781573,788,96379,3827086,482685194,0,3289,276309,2715,208133,574,68176,833,8,1133,18,0,37,144444.0,43333.0,-71.0,-71.0,-67.0,-60.0,-70.0,-70.0,-67.0,-60.0,-90.0,-93.0,-90.0,-93.0,19.0,22.0,23.0,33.0,0
7284,BA:8C:B9:54:50:24,3831830,488838045,4744,6152851,3827086,482685194,0,8445,1656022,8423,1652527,22,3495,2324,14,5134,36,0,53,216660.0,130000.0,-39.0,-36.0,-44.0,-51.0,-42.0,-35.0,-43.0,-48.0,-90.0,-93.0,-90.0,-93.0,51.0,57.0,46.0,42.0,0
7285,92:69:1D:31:68:E9,3830863,486268385,3773,3582787,3827090,482685598,0,4271,1049224,4150,1022024,121,27200,2017,7,3917,80,0,38,216660.0,130000.0,-52.0,-51.0,-45.0,-46.0,-51.0,-49.0,-43.0,-46.0,-90.0,-93.0,-90.0,-93.0,38.0,42.0,45.0,47.0,0
7286,CC:2F:71:3F:1F:24,4480664,1189148541,653574,706462943,3827090,482685598,37,532777,565951871,532130,565874049,647,77822,515094,10,653811,67296,34,456,130000.0,39000.0,-67.0,-65.0,-70.0,-68.0,-67.0,-65.0,-70.0,-67.0,-90.0,-93.0,-90.0,-93.0,23.0,28.0,20.0,25.0,0
7287,CC:2F:71:3E:C5:1F,3827878,482781977,788,96379,3827090,482685598,0,3289,276309,2715,208133,574,68176,833,8,1133,18,0,37,144444.0,43333.0,-71.0,-71.0,-67.0,-60.0,-70.0,-70.0,-67.0,-60.0,-90.0,-93.0,-90.0,-93.0,19.0,22.0,23.0,33.0,0
7288,BA:8C:B9:54:50:24,3831834,488838449,4744,6152851,3827090,482685598,0,8445,1656022,8423,1652527,22,3495,2324,14,5134,36,0,53,216660.0,130000.0,-39.0,-36.0,-44.0,-51.0,-42.0,-35.0,-43.0,-48.0,-90.0,-93.0,-90.0,-93.0,51.0,57.0,46.0,42.0,0
7289,92:69:1D:31:68:E9,3830867,486268789,3773,3582787,3827094,482686002,0,4271,1049224,4150,1022024,121,27200,2017,7,3917,80,0,38,216660.0,130000.0,-52.0,-51.0,-45.0,-46.0,-51.0,-49.0,-43.0,-46.0,-90.0,-93.0,-90.0,-93.0,38.0,42.0,45.0,47.0,0
7290,CC:2F:71:3F:1F:24,4480710,1189163317,653616,706477315,3827094,482686002,37,532803,565956815,532156,565878993,647,77822,515120,10,653853,67307,34,456,117000.0,39000.0,-67.0,-65.0,-71.0,-67.0,-67.0,-65.0,-70.0,-67.0,-90.0,-93.0,-90.0,-93.0,23.0,28.0,19.0,26.0,0
7291,CC:2F:71:3E:C5:1F,3827882,482782381,788,96379,3827094,482686002,0,3289,276309,2715,208133,574,68176,833,8,1133,18,0,37,144444.0,43333.0,-71.0,-71.0,-67.0,-60.0,-70.0,-70.0,-67.0,-60.0,-90.0,-93.0,-90.0,-93.0,19.0,22.0,23.0,33.0,0
7292,BA:8C:B9:54:50:24,3831838,488838853,4744,6152851,3827094,482686002,0,8445,1656022,8423,1652527,22,3495,2324,14,5134,36,0,53,216660.0,130000.0,-39.0,-36.0,-44.0,-51.0,-42.0,-35.0,-43.0,-48.0,-90.0,-93.0,-90.0,-93.0,51.0,57.0,46.0,42.0,0
7293,92:69:1D:31:68:E9,3830872,486269253,3773,3582787,3827099,482686466,0,4271,1049224,4150,1022024,121,27200,2017,7,3917,80,0,38,216660.0,130000.0,-52.0,-51.0,-45.0,-46.0,-51.0,-49.0,-43.0,-46.0,-90.0,-93.0,-90.0,-93.0,38.0,42.0,45.0,47.0,0
7294,CC:2F:71:3F:1F:24,4480757,1189178209,653658,706491743,3827099,482686466,37,532830,565961875,532183,565884053,647,77822,515147,10,653895,67316,34,456,130000.0,43333.0,-67.0,-65.0,-70.0,-67.0,-67.0,-65.0,-70.0,-67.0,-90.0,-93.0,-90.0,-93.0,23.0,28.0,20.0,26.0,0
7295,CC:2F:71:3E:C5:1F,3827887,482782845,788,96379,3827099,482686466,0,3289,276309,2715,208133,574,68176,833,8,1133,18,0,37,144444.0,43333.0,-71.0,-71.0,-67.0,-60.0,-70.0,-70.0,-67.0,-60.0,-90.0,-93.0,-90.0,-93.0,19.0,22.0,23.0,33.0,0
7296,BA:8C:B9:54:50:24,3831843,488839317,4744,6152851,3827099,482686466,0,8445,1656022,8423,1652527,22,3495,2324,14,5134,36,0,53,216660.0,130000.0,-39.0,-36.0,-44.0,-51.0,-42.0,-35.0,-43.0,-48.0,-90.0,-93.0,-90.0,-93.0,51.0,57.0,46.0,42.0,0
7297,92:69:1D:31:68:E9,3830876,486269657,3773,3582787,3827103,482686870,0,4271,1049224,4150,1022024,121,27200,2017,7,3917,80,0,38,216660.0,130000.0,-52.0,-51.0,-45.0,-46.0,-51.0,-49.0,-43.0,-46.0,-90.0,-93.0,-90.0,-93.0,38.0,42.0,45.0,47.0,0
7298,CC:2F:71:3F:1F:24,4480803,1189193153,653700,706506283,3827103,482686870,37,532855,565966679,532208,565888857,647,77822,515172,10,653937,67320,34,456,130000.0,43333.0,-67.0,-65.0,-70.0,-68.0,-67.0,-65.0,-70.0,-67.0,-90.0,-93.0,-90.0,-93.0,23.0,28.0,20.0,25.0,0
7299,CC:2F:71:3E:C5:1F,3827891,482783249,788,96379,3827103,482686870,0,3289,276309,2715,208133,574,68176,833,8,1133,18,0,37,144444.0,43333.0,-71.0,-71.0,-67.0,-60.0,-70.0,-70.0,-67.0,-60.0,-90.0,-93.0,-90.0,-93.0,19.0,22.0,23.0,33.0,0
7300,BA:8C:B9:54:50:24,3831847,488839721,4744,6152851,3827103,482686870,0,8445,1656022,8423,1652527,22,3495,2324,14,5134,36,0,53,216660.0,130000.0,-39.0,-36.0,-44.0,-51.0,-42.0,-35.0,-43.0,-48.0,-90.0,-93.0,-90.0,-93.0,51.0,57.0,46.0,42.0,0
7301,92:69:1D:31:68:E9,3830880,486270061,3773,3582787,3827107,482687274,0,4271,1049224,4150,1022024,121,27200,2017,7,3917,80,0,38,216660.0,130000.0,-52.0,-51.0,-45.0,-46.0,-51.0,-49.0,-43.0,-46.0,-90.0,-93.0,-90.0,-93.0,38.0,42.0,45.0,47.0,0
7302,CC:2F:71:3F:1F:24,4480849,1189207985,653742,706520711,3827107,482687274,37,532880,565971483,532233,565893661,647,77822,515197,10,653979,67342,34,456,117000.0,39000.0,-67.0,-66.0,-71.0,-68.0,-67.0,-65.0,-70.0,-67.0,-90.0,-93.0,-90.0,-93.0,23.0,27.0,19.0,25.0,0
7303,CC:2F:71:3E:C5:1F,3827896,482783713,788,96379,3827108,482687334,0,3289,276309,2715,208133,574,68176,833,8,1133,18,0,37,144444.0,43333.0,-71.0,-71.0,-67.0,-60.0,-70.0,-70.0,-67.0,-60.0,-90.0,-93.0,-90.0,-93.0,19.0,22.0,23.0,33.0,0
7304,BA:8C:B9:54:50:24,3831852,488840185,4744,6152851,3827108,482687334,0,8445,1656022,8423,1652527,22,3495,2324,14,5134,36,0,53,216660.0,130000.0,-39.0,-36.0,-44.0,-51.0,-42.0,-35.0,-43.0,-48.0,-90.0,-93.0,-90.0,-93.0,51.0,57.0,46.0,42.0,0
7305,92:69:1D:31:68:E9,3830886,486270587,3773,3582787,3827113,482687800,0,4271,1049224,4150,1022024,121,27200,2017,7,3917,80,0,38,216660.0,130000.0,-52.0,-51.0,-45.0,-46.0,-51.0,-49.0,-43.0,-46.0,-90.0,-93.0,-90.0,-93.0,38.0,42.0,45.0,47.0,0
7306,CC:2F:71:3F:1F:24,4480898,1189223063,653785,706535263,3827113,482687800,37,532906,565976403,532259,565898581,647,77822,515223,10,654022,67352,34,456,130000.0,43333.0,-67.0,-65.0,-70.0,-67.0,-67.0,-65.0,-70.0,-67.0,-90.0,-93.0,-90.0,-93.0,23.0,28.0,20.0,26.0,0
7307,CC:2F:71:3E:C5:1F,3827901,482784179,788,96379,3827113,482687800,0,3291,276497,2716,208203,575,68294,834,8,1133,18,0,37,144444.0,43333.0,-78.0,-83.0,-75.0,-71.0,-71.0,-72.0,-68.0,-61.0,-90.0,-93.0,-90.0,-93.0,12.0,10.0,15.0,22.0,0
7308,BA:8C:B9:54:50:24,3831857,488840651,4744,6152851,3827113,482687800,0,8445,1656022,8423,1652527,22,3495,2324,14,5134,36,0,53,216660.0,130000.0,-39.0,-36.0,-44.0,-51.0,-42.0,-35.0,-43.0,-48.0,-90.0,-93.0,-90.0,-93.0,51.0,57.0,46.0,42.0,0
7309,92:69:1D:31:68:E9,3830890,486270991,3773,3582787,3827117,482688204,0,4271,1049224,4150,1022024,121,27200,2017,7,3917,80,0,38,216660.0,130000.0,-52.0,-51.0,-45.0,-46.0,-51.0,-49.0,-43.0,-46.0,-90.0,-93.0,-90.0,-93.0,38.0,42.0,45.0,47.0,0
7310,CC:2F:71:3F:1F:24,4480945,1189238091,653828,706549887,3827117,482688204,37,532933,565981451,532286,565903629,647,77822,515250,10,654064,67387,34,456,144444.0,43333.0,-67.0,-65.0,-70.0,-67.0,-67.0,-65.0,-70.0,-67.0,-90.0,-93.0,-90.0,-93.0,23.0,28.0,20.0,26.0,0
7311,CC:2F:71:3E:C5:1F,3827906,482784856,788,96379,3827118,482688477,0,3291,276497,2716,208203,575,68294,834,8,1133,18,0,37,144444.0,43333.0,-78.0,-83.0,-75.0,-71.0,-71.0,-72.0,-68.0,-61.0,-90.0,-93.0,-90.0,-93.0,12.0,10.0,15.0,22.0,0
7312,BA:8C:B9:54:50:24,3831862,488841328,4744,6152851,3827118,482688477,0,8445,1656022,8423,1652527,22,3495,2324,14,5134,36,0,53,216660.0,130000.0,-39.0,-36.0,-44.0,-51.0,-42.0,-35.0,-43.0,-48.0,-90.0,-93.0,-90.0,-93.0,51.0,57.0,46.0,42.0,0
7313,92:69:1D:31:68:E9,3830896,486271728,3773,3582787,3827123,482688941,0,4271,1049224,4150,1022024,121,27200,2017,7,3917,80,0,38,216660.0,130000.0,-52.0,-51.0,-45.0,-46.0,-51.0,-49.0,-43.0,-46.0,-90.0,-93.0,-90.0,-93.0,38.0,42.0,45.0,47.0,0
7314,CC:2F:71:3F:1F:24,4480992,1189253188,653869,706564247,3827123,482688941,37,532958,565986255,532311,565908433,647,77822,515275,10,654106,67392,34,456,130000.0,43333.0,-67.0,-65.0,-70.0,-67.0,-67.0,-65.0,-70.0,-67.0,-90.0,-93.0,-90.0,-93.0,23.0,28.0,20.0,26.0,0
7315,CC:2F:71:3E:C5:1F,3827911,482785320,788,96379,3827123,482688941,0,3291,276497,2716,208203,575,68294,834,8,1133,18,0,37,144444.0,43333.0,-78.0,-83.0,-75.0,-71.0,-71.0,-72.0,-68.0,-61.0,-90.0,-93.0,-90.0,-93.0,12.0,10.0,15.0,22.0,0
7316,BA:8C:B9:54:50:24,3831867,488841792,4744,6152851,3827123,482688941,0,8446,1656090,8424,1652595,22,3495,2324,14,5134,36,0,53,216660.0,130000.0,-39.0,-36.0,-44.0,-51.0,-41.0,-35.0,-43.0,-48.0,-90.0,-93.0,-90.0,-93.0,51.0,57.0,46.0,42.0,0
7317,92:69:1D:31:68:E9,3830900,486272132,3773,3582787,3827127,482689345,0,4271,1049224,4150,1022024,121,27200,2017,7,3917,80,0,38,216660.0,130000.0,-52.0,-51.0,-45.0,-46.0,-51.0,-49.0,-43.0,-46.0,-90.0,-93.0,-90.0,-93.0,38.0,42.0,45.0,47.0,0
7318,CC:2F:71:3F:1F:24,4481036,1189267878,653909,706578533,3827127,482689345,37,532984,565991241,532337,565913419,647,77822,515301,10,654146,67399,34,456,130000.0,43333.0,-67.0,-65.0,-71.0,-68.0,-67.0,-65.0,-70.0,-67.0,-90.0,-93.0,-90.0,-93.0,23.0,28.0,19.0,25.0,0
7319,CC:2F:71:3E:C5:1F,3827915,482785724,788,96379,3827127,482689345,0,3291,276497,2716,208203,575,68294,834,8,1133,18,0,37,144444.0,43333.0,-78.0,-83.0,-75.0,-71.0,-71.0,-72.0,-68.0,-61.0,-90.0,-93.0,-90.0,-93.0,12.0,10.0,15.0,22.0,0
7320,BA:8C:B9:54:50:24,3831871,488842196,4744,6152851,3827127,482689345,0,8446,1656090,8424,1652595,22,3495,2324,14,5134,36,0,53,216660.0,130000.0,-39.0,-36.0,-44.0,-51.0,-41.0,-35.0,-43.0,-48.0,-90.0,-93.0,-90.0,-93.0,51.0,57.0,46.0,42.0,0
7321,92:69:1D:31:68:E9,3830904,486272536,3773,3582787,3827131,482689749,0,4271,1049224,4150,1022024,121,27200,2017,7,3917,80,0,38,216660.0,130000.0,-52.0,-51.0,-45.0,-46.0,-51.0,-49.0,-43.0,-46.0,-90.0,-93.0,-90.0,-93.0,38.0,42.0,45.0,47.0,0
7322,CC:2F:71:3F:1F:24,4481082,1189282710,653951,706592961,3827131,482689749,37,533009,565996045,532362,565918223,647,77822,515326,10,654188,67418,34,456,117000.0,39000.0,-67.0,-65.0,-70.0,-67.0,-67.0,-65.0,-70.0,-67.0,-90.0,-93.0,-90.0,-93.0,23.0,28.0,20.0,26.0,0
7323,CC:2F:71:3E:C5:1F,3827919,482786128,788,96379,3827131,482689749,0,3291,276497,2716,208203,575,68294,834,8,1133,18,0,37,144444.0,43333.0,-78.0,-83.0,-75.0,-71.0,-71.0,-72.0,-68.0,-61.0,-90.0,-93.0,-90.0,-93.0,12.0,10.0,15.0,22.0,0
7324,BA:8C:B9:54:50:24,3831875,488842600,4744,6152851,3827131,482689749,0,8446,1656090,8424,1652595,22,3495,2324,14,5134,36,0,53,216660.0,130000.0,-39.0,-36.0,-44.0,-51.0,-41.0,-35.0,-43.0,-48.0,-90.0,-93.0,-90.0,-93.0,51.0,57.0,46.0,42.0,0
7325,92:69:1D:31:68:E9,3830909,486273000,3773,3582787,3827136,482690213,0,4271,1049224,4150,1022024,121,27200,2017,7,3917,80,0,38,216660.0,130000.0,-52.0,-51.0,-45.0,-46.0,-51.0,-49.0,-43.0,-46.0,-90.0,-93.0,-90.0,-93.0,38.0,42.0,45.0,47.0,0
7326,CC:2F:71:3F:1F:24,4481130,1189297726,653994,706607513,3827136,482690213,37,533036,566001105,532389,565923283,647,77822,515353,10,654231,67424,34,456,130000.0,43333.0,-67.0,-65.0,-70.0,-68.0,-67.0,-65.0,-70.0,-67.0,-90.0,-93.0,-90.0,-93.0,23.0,28.0,20.0,25.0,0
7327,CC:2F:71:3E:C5:1F,3827924,482786592,788,96379,3827136,482690213,0,3291,276497,2716,208203,575,68294,834,8,1133,18,0,37,144444.0,43333.0,-78.0,-83.0,-75.0,-71.0,-71.0,-72.0,-68.0,-61.0,-90.0,-93.0,-90.0,-93.0,12.0,10.0,15.0,22.0,0
7328,BA:8C:B9:54:50:24,3831880,488843064,4744,6152851,3827136,482690213,0,8446,1656090,8424,1652595,22,3495,2324,14,5134,36,0,53,216660.0,130000.0,-39.0,-36.0,-44.0,-51.0,-41.0,-35.0,-43.0,-48.0,-90.0,-93.0,-90.0,-93.0,51.0,57.0,46.0,42.0,0
7329,92:69:1D:31:68:E9,3830911,486273202,3773,3582787,3827138,482690415,0,4271,1049224,4150,1022024,121,27200,2017,7,3917,80,0,38,216660.0,130000.0,-52.0,-51.0,-45.0,-46.0,-51.0,-49.0,-43.0,-46.0,-90.0,-93.0,-90.0,-93.0,38.0,42.0,45.0,47.0,0
7330,CC:2F:71:3F:1F:24,4481175,1189312434,654035,706621817,3827140,482690617,37,533061,566005909,532414,565928087,647,77822,515378,10,654272,67442,34,456,117000.0,39000.0,-67.0,-65.0,-70.0,-67.0,-67.0,-65.0,-70.0,-67.0,-90.0,-93.0,-90.0,-93.0,23.0,28.0,20.0,26.0,0
7331,CC:2F:71:3E:C5:1F,3827928,482786996,788,96379,3827140,482690617,0,3291,276497,2716,208203,575,68294,834,8,1133,18,0,37,144444.0,43333.0,-78.0,-83.0,-75.0,-71.0,-71.0,-72.0,-68.0,-61.0,-90.0,-93.0,-90.0,-93.0,12.0,10.0,15.0,22.0,0
7332,BA:8C:B9:54:50:24,3831884,488843468,4744,6152851,3827140,482690617,0,8446,1656090,8424,1652595,22,3495,2324,14,5134,36,0,53,216660.0,130000.0,-39.0,-36.0,-44.0,-51.0,-41.0,-35.0,-43.0,-48.0,-90.0,-93.0,-90.0,-93.0,51.0,57.0,46.0,42.0,0
7333,92:69:1D:31:68:E9,3830918,486273868,3773,3582787,3827145,482691081,0,4271,1049224,4150,1022024,121,27200,2017,7,3917,80,0,38,216660.0,130000.0,-52.0,-51.0,-45.0,-46.0,-51.0,-49.0,-43.0,-46.0,-90.0,-93.0,-90.0,-93.0,38.0,42.0,45.0,47.0,0
7334,CC:2F:71:3F:1F:24,4481221,1189327146,654076,706636065,3827145,482691081,37,533086,566010713,532439,565932891,647,77822,515403,10,654313,67452,34,456,130000.0,39000.0,-67.0,-65.0,-70.0,-67.0,-67.0,-65.0,-70.0,-67.0,-90.0,-93.0,-90.0,-93.0,23.0,28.0,20.0,26.0,0
7335,CC:2F:71:3E:C5:1F,3827933,482787460,788,96379,3827145,482691081,0,3291,276497,2716,208203,575,68294,834,8,1133,18,0,37,144444.0,43333.0,-78.0,-83.0,-75.0,-71.0,-71.0,-72.0,-68.0,-61.0,-90.0,-93.0,-90.0,-93.0,12.0,10.0,15.0,22.0,0
7336,BA:8C:B9:54:50:24,3831889,488843932,4744,6152851,3827145,482691081,0,8446,1656090,8424,1652595,22,3495,2324,14,5134,36,0,53,216660.0,130000.0,-39.0,-36.0,-44.0,-51.0,-41.0,-35.0,-43.0,-48.0,-90.0,-93.0,-90.0,-93.0,51.0,57.0,46.0,42.0,0
7337,92:69:1D:31:68:E9,3830920,486274070,3773,3582787,3827147,482691283,0,4271,1049224,4150,1022024,121,27200,2017,7,3917,80,0,38,216660.0,130000.0,-52.0,-51.0,-45.0,-46.0,-51.0,-49.0,-43.0,-46.0,-90.0,-93.0,-90.0,-93.0,38.0,42.0,45.0,47.0,0
7338,CC:2F:71:3F:1F:24,4481266,1189341798,654117,706650313,3827149,482691485,37,533111,566015517,532464,565937695,647,77822,515428,10,654354,67490,34,456,130000.0,43333.0,-67.0,-65.0,-70.0,-67.0,-67.0,-65.0,-70.0,-67.0,-90.0,-93.0,-90.0,-93.0,23.0,28.0,20.0,26.0,0
7339,CC:2F:71:3E:C5:1F,3827937,482787864,788,96379,3827149,482691485,0,3291,276497,2716,208203,575,68294,834,8,1133,18,0,37,144444.0,43333.0,-78.0,-83.0,-75.0,-71.0,-71.0,-72.0,-68.0,-61.0,-90.0,-93.0,-90.0,-93.0,12.0,10.0,15.0,22.0,0
7340,BA:8C:B9:54:50:24,3831893,488844336,4744,6152851,3827149,482691485,0,8446,1656090,8424,1652595,22,3495,2324,14,5134,36,0,53,216660.0,130000.0,-39.0,-36.0,-44.0,-51.0,-41.0,-35.0,-43.0,-48.0,-90.0,-93.0,-90.0,-93.0,51.0,57.0,46.0,42.0,0
7341,92:69:1D:31:68:E9,3830926,486274676,3773,3582787,3827153,482691889,0,4271,1049224,4150,1022024,121,27200,2017,7,3917,80,0,38,216660.0,130000.0,-52.0,-51.0,-45.0,-46.0,-51.0,-49.0,-43.0,-46.0,-90.0,-93.0,-90.0,-93.0,38.0,42.0,45.0,47.0,0
7342,CC:2F:71:3F:1F:24,4481312,1189356742,654159,706664853,3827153,482691889,37,533136,566020321,532489,565942499,647,77822,515453,10,654396,67494,34,456,130000.0,43333.0,-67.0,-65.0,-70.0,-68.0,-67.0,-65.0,-70.0,-67.0,-90.0,-93.0,-90.0,-93.0,23.0,28.0,20.0,25.0,0
7343,CC:2F:71:3E:C5:1F,3827941,482788268,788,96379,3827153,482691889,0,3291,276497,2716,208203,575,68294,834,8,1133,18,0,37,144444.0,43333.0,-78.0,-83.0,-75.0,-71.0,-71.0,-72.0,-68.0,-61.0,-90.0,-93.0,-90.0,-93.0,12.0,10.0,15.0,22.0,0
7344,BA:8C:B9:54:50:24,3831897,488844740,4744,6152851,3827153,482691889,0,8446,1656090,8424,1652595,22,3495,2324,14,5134,36,0,53,216660.0,130000.0,-39.0,-36.0,-44.0,-51.0,-41.0,-35.0,-43.0,-48.0,-90.0,-93.0,-90.0,-93.0,51.0,57.0,46.0,42.0,0
7345,92:69:1D:31:68:E9,3830929,486274938,3773,3582787,3827156,482692151,0,4271,1049224,4150,1022024,121,27200,2017,7,3917,80,0,38,216660.0,130000.0,-52.0,-51.0,-45.0,-46.0,-51.0,-49.0,-43.0,-46.0,-90.0,-93.0,-90.0,-93.0,38.0,42.0,45.0,47.0,0
7346,CC:2F:71:3F:1F:24,4481359,1189371746,654201,706679393,3827158,482692353,37,533162,566025265,532515,565947443,647,77822,515479,10,654438,67500,34,456,130000.0,43333.0,-67.0,-65.0,-71.0,-67.0,-67.0,-65.0,-70.0,-67.0,-90.0,-93.0,-90.0,-93.0,23.0,28.0,19.0,26.0,0
7347,CC:2F:71:3E:C5:1F,3827946,482788732,788,96379,3827158,482692353,0,3291,276497,2716,208203,575,68294,834,8,1133,18,0,37,144444.0,43333.0,-78.0,-83.0,-75.0,-71.0,-71.0,-72.0,-68.0,-61.0,-90.0,-93.0,-90.0,-93.0,12.0,10.0,15.0,22.0,0
7348,BA:8C:B9:54:50:24,3831902,488845204,4744,6152851,3827158,482692353,0,8446,1656090,8424,1652595,22,3495,2324,14,5134,36,0,53,216660.0,130000.0,-39.0,-36.0,-44.0,-51.0,-41.0,-35.0,-43.0,-48.0,-90.0,-93.0,-90.0,-93.0,51.0,57.0,46.0,42.0,0
7349,92:69:1D:31:68:E9,3830935,486275544,3773,3582787,3827162,482692757,0,4271,1049224,4150,1022024,121,27200,2017,7,3917,80,0,38,216660.0,130000.0,-52.0,-51.0,-45.0,-46.0,-51.0,-49.0,-43.0,-46.0,-90.0,-93.0,-90.0,-93.0,38.0,42.0,45.0,47.0,0
7350,CC:2F:71:3F:1F:24,4481404,1189386448,654242,706693691,3827162,482692757,37,533187,566030069,532540,565952247,647,77822,515504,10,654479,67526,34,456,144444.0,39000.0,-67.0,-65.0,-70.0,-67.0,-67.0,-65.0,-70.0,-67.0,-90.0,-93.0,-90.0,-93.0,23.0,28.0,20.0,26.0,0
7351,CC:2F:71:3E:C5:1F,3827950,482789136,788,96379,3827162,482692757,0,3291,276497,2716,208203,575,68294,834,8,1133,18,0,37,144444.0,43333.0,-78.0,-83.0,-75.0,-71.0,-71.0,-72.0,-68.0,-61.0,-90.0,-93.0,-90.0,-93.0,12.0,10.0,15.0,22.0,0
7352,BA:8C:B9:54:50:24,3831906,488845608,4744,6152851,3827162,482692757,0,8446,1656090,8424,1652595,22,3495,2324,14,5134,36,0,53,216660.0,130000.0,-39.0,-36.0,-44.0,-51.0,-41.0,-35.0,-43.0,-48.0,-90.0,-93.0,-90.0,-93.0,51.0,57.0,46.0,42.0,0
7353,92:69:1D:31:68:E9,3830937,486275746,3773,3582787,3827164,482692959,0,4271,1049224,4150,1022024,121,27200,2017,7,3917,80,0,38,216660.0,130000.0,-52.0,-51.0,-45.0,-46.0,-51.0,-49.0,-43.0,-46.0,-90.0,-93.0,-90.0,-93.0,38.0,42.0,45.0,47.0,0
7354,CC:2F:71:3F:1F:24,4481451,1189401404,654285,706708243,3827166,482693161,37,533212,566034873,532565,565957051,647,77822,515529,10,654522,67546,34,456,130000.0,43333.0,-67.0,-65.0,-70.0,-67.0,-67.0,-65.0,-70.0,-67.0,-90.0,-93.0,-90.0,-93.0,23.0,28.0,20.0,26.0,0
7355,CC:2F:71:3E:C5:1F,3827954,482789540,788,96379,3827166,482693161,0,3291,276497,2716,208203,575,68294,834,8,1133,18,0,37,144444.0,43333.0,-78.0,-83.0,-75.0,-71.0,-71.0,-72.0,-68.0,-61.0,-90.0,-93.0,-90.0,-93.0,12.0,10.0,15.0,22.0,0
7356,BA:8C:B9:54:50:24,3831910,488846012,4744,6152851,3827166,482693161,0,8446,1656090,8424,1652595,22,3495,2324,14,5134,36,0,53,216660.0,130000.0,-39.0,-36.0,-44.0,-51.0,-41.0,-35.0,-43.0,-48.0,-90.0,-93.0,-90.0,-93.0,51.0,57.0,46.0,42.0,0
7357,92:69:1D:31:68:E9,3830945,486276528,3774,3582903,3827171,482693625,0,4272,1049292,4151,1022092,121,27200,2017,7,3918,80,0,38,216660.0,130000.0,-52.0,-50.0,-44.0,-46.0,-51.0,-49.0,-43.0,-46.0,-90.0,-92.0,-90.0,-92.0,38.0,42.0,46.0,46.0,0
7358,CC:2F:71:3F:1F:24,4481500,1189416536,654329,706722911,3827171,482693625,37,533237,566039677,532590,565961855,647,77822,515554,10,654566,67564,34,456,117000.0,39000.0,-67.0,-65.0,-70.0,-67.0,-67.0,-65.0,-70.0,-67.0,-90.0,-92.0,-90.0,-92.0,23.0,27.0,20.0,25.0,0
7359,CC:2F:71:3E:C5:1F,3827960,482790120,789,96495,3827171,482693625,0,3293,276637,2718,208343,575,68294,834,8,1134,18,0,37,130000.0,39000.0,-70.0,-70.0,-68.0,-60.0,-71.0,-72.0,-68.0,-61.0,-90.0,-92.0,-90.0,-92.0,20.0,22.0,22.0,32.0,0
7360,BA:8C:B9:54:50:24,3831916,488846592,4745,6152967,3827171,482693625,0,8452,1656498,8430,1653003,22,3495,2324,14,5135,36,0,53,216660.0,130000.0,-39.0,-36.0,-45.0,-52.0,-40.0,-35.0,-42.0,-48.0,-90.0,-92.0,-90.0,-92.0,51.0,56.0,45.0,40.0,0
7361,92:69:1D:31:68:E9,3830949,486276932,3774,3582903,3827175,482694029,0,4273,1049360,4152,1022160,121,27200,2017,7,3918,80,0,38,216660.0,130000.0,-51.0,-47.0,-42.0,-49.0,-51.0,-49.0,-43.0,-47.0,-90.0,-92.0,-90.0,-92.0,39.0,45.0,48.0,43.0,0
7362,CC:2F:71:3F:1F:24,4481546,1189431368,654371,706737339,3827175,482694029,37,533262,566044481,532615,565966659,647,77822,515579,10,654608,67566,34,456,130000.0,43333.0,-67.0,-65.0,-70.0,-68.0,-67.0,-65.0,-70.0,-67.0,-90.0,-92.0,-90.0,-92.0,23.0,27.0,20.0,24.0,0
7363,CC:2F:71:3E:C5:1F,3827964,482790524,789,96495,3827175,482694029,0,3293,276637,2718,208343,575,68294,834,8,1134,18,0,37,130000.0,39000.0,-70.0,-70.0,-68.0,-60.0,-71.0,-72.0,-68.0,-61.0,-90.0,-92.0,-90.0,-92.0,20.0,22.0,22.0,32.0,0
7364,BA:8C:B9:54:50:24,3831920,488846996,4745,6152967,3827175,482694029,0,8452,1656498,8430,1653003,22,3495,2324,14,5135,36,0,53,216660.0,130000.0,-39.0,-36.0,-45.0,-52.0,-40.0,-35.0,-42.0,-48.0,-90.0,-92.0,-90.0,-92.0,51.0,56.0,45.0,40.0,0
7365,92:69:1D:31:68:E9,3830955,486277669,3774,3582903,3827181,482694766,0,4273,1049360,4152,1022160,121,27200,2017,7,3918,80,0,38,216660.0,130000.0,-51.0,-47.0,-42.0,-49.0,-51.0,-49.0,-43.0,-47.0,-90.0,-92.0,-90.0,-92.0,39.0,45.0,48.0,43.0,0
7366,CC:2F:71:3F:1F:24,4481593,1189446465,654412,706751699,3827181,482694766,37,533287,566049285,532640,565971463,647,77822,515604,10,654649,67575,34,456,130000.0,39000.0,-67.0,-65.0,-70.0,-67.0,-67.0,-65.0,-70.0,-67.0,-90.0,-92.0,-90.0,-92.0,23.0,27.0,20.0,25.0,0
7367,CC:2F:71:3E:C5:1F,3827970,482791261,789,96495,3827181,482694766,0,3293,276637,2718,208343,575,68294,834,8,1134,18,0,37,130000.0,39000.0,-70.0,-70.0,-68.0,-60.0,-71.0,-72.0,-68.0,-61.0,-90.0,-92.0,-90.0,-92.0,20.0,22.0,22.0,32.0,0
7368,BA:8C:B9:54:50:24,3831926,488847733,4745,6152967,3827181,482694766,0,8452,1656498,8430,1653003,22,3495,2324,14,5135,36,0,53,216660.0,130000.0,-39.0,-36.0,-45.0,-52.0,-40.0,-35.0,-42.0,-48.0,-90.0,-92.0,-90.0,-92.0,51.0,56.0,45.0,40.0,0
7369,92:69:1D:31:68:E9,3830957,486277871,3774,3582903,3827183,482694968,0,4273,1049360,4152,1022160,121,27200,2017,7,3918,80,0,38,216660.0,130000.0,-51.0,-47.0,-42.0,-49.0,-51.0,-49.0,-43.0,-47.0,-90.0,-92.0,-90.0,-92.0,39.0,45.0,48.0,43.0,0
7370,CC:2F:71:3F:1F:24,4481639,1189461353,654454,706766183,3827185,482695170,37,533313,566054229,532666,565976407,647,77822,515630,10,654691,67596,34,456,117000.0,39000.0,-67.0,-65.0,-70.0,-68.0,-66.0,-65.0,-70.0,-67.0,-90.0,-92.0,-90.0,-92.0,23.0,27.0,20.0,24.0,0
7371,CC:2F:71:3E:C5:1F,3827974,482791665,789,96495,3827185,482695170,0,3293,276637,2718,208343,575,68294,834,8,1134,18,0,37,130000.0,39000.0,-70.0,-70.0,-68.0,-60.0,-71.0,-72.0,-68.0,-61.0,-90.0,-92.0,-90.0,-92.0,20.0,22.0,22.0,32.0,0
7372,BA:8C:B9:54:50:24,3831930,488848137,4745,6152967,3827185,482695170,0,8452,1656498,8430,1653003,22,3495,2324,14,5135,36,0,53,216660.0,130000.0,-39.0,-36.0,-45.0,-52.0,-40.0,-35.0,-42.0,-48.0,-90.0,-92.0,-90.0,-92.0,51.0,56.0,45.0,40.0,0
7373,92:69:1D:31:68:E9,3830963,486278477,3774,3582903,3827189,482695574,0,4273,1049360,4152,1022160,121,27200,2017,7,3918,80,0,38,216660.0,130000.0,-51.0,-47.0,-42.0,-49.0,-51.0,-49.0,-43.0,-47.0,-90.0,-92.0,-90.0,-92.0,39.0,45.0,48.0,43.0,0
7374,CC:2F:71:3F:1F:24,4481685,1189476129,654496,706780555,3827189,482695574,37,533338,566059033,532691,565981211,647,77822,515655,10,654733,67604,34,456,130000.0,39000.0,-67.0,-65.0,-70.0,-67.0,-67.0,-65.0,-70.0,-67.0,-90.0,-92.0,-90.0,-92.0,23.0,27.0,20.0,25.0,0
7375,CC:2F:71:3E:C5:1F,3827978,482792069,789,96495,3827189,482695574,0,3293,276637,2718,208343,575,68294,834,8,1134,18,0,37,130000.0,39000.0,-70.0,-70.0,-68.0,-60.0,-71.0,-72.0,-68.0,-61.0,-90.0,-92.0,-90.0,-92.0,20.0,22.0,22.0,32.0,0
7376,BA:8C:B9:54:50:24,3831934,488848541,4745,6152967,3827189,482695574,0,8452,1656498,8430,1653003,22,3495,2324,14,5135,36,0,53,216660.0,130000.0,-39.0,-36.0,-45.0,-52.0,-40.0,-35.0,-42.0,-48.0,-90.0,-92.0,-90.0,-92.0,51.0,56.0,45.0,40.0,0
7377,92:69:1D:31:68:E9,3830966,486278739,3774,3582903,3827192,482695836,0,4273,1049360,4152,1022160,121,27200,2017,7,3918,80,0,38,216660.0,130000.0,-51.0,-47.0,-42.0,-49.0,-51.0,-49.0,-43.0,-47.0,-90.0,-92.0,-90.0,-92.0,39.0,45.0,48.0,43.0,0
7378,CC:2F:71:3F:1F:24,4481733,1189491157,654539,706795119,3827194,482696038,37,533364,566063977,532717,565986155,647,77822,515681,10,654776,67620,34,456,130000.0,39000.0,-67.0,-65.0,-71.0,-68.0,-67.0,-65.0,-70.0,-67.0,-90.0,-92.0,-90.0,-92.0,23.0,27.0,19.0,24.0,0
7379,CC:2F:71:3E:C5:1F,3827983,482792533,789,96495,3827194,482696038,0,3293,276637,2718,208343,575,68294,834,8,1134,18,0,37,130000.0,39000.0,-70.0,-70.0,-68.0,-60.0,-71.0,-72.0,-68.0,-61.0,-90.0,-92.0,-90.0,-92.0,20.0,22.0,22.0,32.0,0
7380,BA:8C:B9:54:50:24,3831939,488849005,4745,6152967,3827194,482696038,0,8452,1656498,8430,1653003,22,3495,2324,14,5135,36,0,53,216660.0,130000.0,-39.0,-36.0,-45.0,-52.0,-40.0,-35.0,-42.0,-48.0,-90.0,-92.0,-90.0,-92.0,51.0,56.0,45.0,40.0,0
7381,92:69:1D:31:68:E9,3830972,486279345,3774,3582903,3827198,482696442,0,4273,1049360,4152,1022160,121,27200,2017,7,3918,80,0,38,216660.0,130000.0,-51.0,-47.0,-42.0,-49.0,-51.0,-49.0,-43.0,-47.0,-90.0,-92.0,-90.0,-92.0,39.0,45.0,48.0,43.0,0
7382,CC:2F:71:3F:1F:24,4481780,1189506057,654582,706809615,3827198,482696442,37,533389,566068781,532742,565990959,647,77822,515706,10,654819,67646,34,456,117000.0,39000.0,-67.0,-65.0,-70.0,-67.0,-67.0,-65.0,-70.0,-67.0,-90.0,-92.0,-90.0,-92.0,23.0,27.0,20.0,25.0,0
7383,CC:2F:71:3E:C5:1F,3827987,482792937,789,96495,3827198,482696442,0,3293,276637,2718,208343,575,68294,834,8,1134,18,0,37,130000.0,39000.0,-70.0,-70.0,-68.0,-60.0,-71.0,-72.0,-68.0,-61.0,-90.0,-92.0,-90.0,-92.0,20.0,22.0,22.0,32.0,0
7384,BA:8C:B9:54:50:24,3831943,488849409,4745,6152967,3827198,482696442,0,8452,1656498,8430,1653003,22,3495,2324,14,5135,36,0,53,216660.0,130000.0,-39.0,-36.0,-45.0,-52.0,-40.0,-35.0,-42.0,-48.0,-90.0,-92.0,-90.0,-92.0,51.0,56.0,45.0,40.0,0
7385,92:69:1D:31:68:E9,3830974,486279547,3774,3582903,3827200,482696644,0,4275,1049496,4154,1022296,121,27200,2017,7,3919,80,0,38,216660.0,130000.0,-52.0,-52.0,-45.0,-48.0,-51.0,-49.0,-43.0,-47.0,-90.0,-92.0,-90.0,-92.0,38.0,40.0,45.0,44.0,0
7386,CC:2F:71:3F:1F:24,4481823,1189520563,654623,706823919,3827200,482696644,37,533416,566073841,532769,565996019,647,77822,515733,10,654860,67650,34,456,130000.0,43333.0,-67.0,-65.0,-71.0,-67.0,-67.0,-65.0,-70.0,-67.0,-90.0,-92.0,-90.0,-92.0,23.0,27.0,19.0,25.0,0
7387,CC:2F:71:3E:C5:1F,3827991,482793341,789,96495,3827202,482696846,0,3295,276777,2720,208483,575,68294,834,8,1135,18,0,37,130000.0,39000.0,-70.0,-71.0,-68.0,-60.0,-71.0,-72.0,-68.0,-61.0,-90.0,-92.0,-90.0,-92.0,20.0,21.0,22.0,32.0,0
7388,BA:8C:B9:54:50:24,3831948,488849873,4745,6152967,3827203,482696906,0,8454,1656634,8432,1653139,22,3495,2324,14,5136,36,0,53,216660.0,130000.0,-39.0,-37.0,-44.0,-52.0,-40.0,-35.0,-43.0,-48.0,-90.0,-92.0,-90.0,-92.0,51.0,55.0,46.0,40.0,0
7389,92:69:1D:31:68:E9,3830981,486280213,3774,3582903,3827207,482697310,0,4275,1049496,4154,1022296,121,27200,2017,7,3919,80,0,38,216660.0,130000.0,-52.0,-52.0,-45.0,-48.0,-51.0,-49.0,-43.0,-47.0,-90.0,-92.0,-90.0,-92.0,38.0,40.0,45.0,44.0,0
7390,CC:2F:71:3F:1F:24,4481873,1189535781,654666,706838471,3827207,482697310,37,533441,566078645,532794,566000823,647,77822,515758,10,654903,67668,34,456,117000.0,39000.0,-68.0,-65.0,-71.0,-68.0,-67.0,-65.0,-70.0,-68.0,-90.0,-92.0,-90.0,-92.0,22.0,27.0,19.0,24.0,0
7391,CC:2F:71:3E:C5:1F,3827996,482793805,789,96495,3827207,482697310,0,3295,276777,2720,208483,575,68294,834,8,1135,18,0,37,130000.0,39000.0,-70.0,-71.0,-68.0,-60.0,-71.0,-72.0,-68.0,-61.0,-90.0,-92.0,-90.0,-92.0,20.0,21.0,22.0,32.0,0
7392,BA:8C:B9:54:50:24,3831952,488850277,4745,6152967,3827207,482697310,0,8454,1656634,8432,1653139,22,3495,2324,14,5136,36,0,53,216660.0,130000.0,-39.0,-37.0,-44.0,-52.0,-40.0,-35.0,-43.0,-48.0,-90.0,-92.0,-90.0,-92.0,51.0,55.0,46.0,40.0,0
7393,92:69:1D:31:68:E9,3830983,486280415,3774,3582903,3827209,482697512,0,4275,1049496,4154,1022296,121,27200,2017,7,3919,80,0,38,216660.0,130000.0,-52.0,-52.0,-45.0,-48.0,-51.0,-49.0,-43.0,-47.0,-90.0,-92.0,-90.0,-92.0,38.0,40.0,45.0,44.0,0
7394,CC:2F:71:3F:1F:24,4481918,1189550489,654707,706852775,3827211,482697714,37,533467,566083589,532820,566005767,647,77822,515784,10,654944,67675,34,456,130000.0,43333.0,-67.0,-65.0,-71.0,-68.0,-67.0,-65.0,-70.0,-67.0,-90.0,-92.0,-90.0,-93.0,23.0,27.0,19.0,25.0,0
7395,CC:2F:71:3E:C5:1F,3828000,482794209,789,96495,3827211,482697714,0,3295,276777,2720,208483,575,68294,834,8,1135,18,0,37,130000.0,39000.0,-70.0,-71.0,-68.0,-60.0,-71.0,-72.0,-68.0,-61.0,-90.0,-92.0,-90.0,-93.0,20.0,21.0,22.0,33.0,0
7396,BA:8C:B9:54:50:24,3831956,488850681,4745,6152967,3827211,482697714,0,8454,1656634,8432,1653139,22,3495,2324,14,5136,36,0,53,216660.0,130000.0,-39.0,-37.0,-44.0,-52.0,-40.0,-35.0,-43.0,-48.0,-90.0,-92.0,-90.0,-93.0,51.0,55.0,46.0,41.0,0
7397,92:69:1D:31:68:E9,3830990,486281081,3774,3582903,3827216,482698178,0,4276,1049564,4155,1022364,121,27200,2017,7,3919,80,0,38,216660.0,130000.0,-52.0,-50.0,-44.0,-46.0,-51.0,-49.0,-44.0,-47.0,-90.0,-92.0,-90.0,-93.0,38.0,42.0,46.0,47.0,0
7398,CC:2F:71:3F:1F:24,4481968,1189565765,654752,706867587,3827216,482698178,37,533494,566088719,532847,566010897,647,77822,515810,10,654989,67692,34,456,117000.0,39000.0,-67.0,-65.0,-71.0,-68.0,-67.0,-65.0,-70.0,-67.0,-90.0,-92.0,-90.0,-93.0,23.0,27.0,19.0,25.0,0
7399,CC:2F:71:3E:C5:1F,3828005,482794673,789,96495,3827216,482698178,0,3295,276777,2720,208483,575,68294,834,8,1135,18,0,37,130000.0,39000.0,-70.0,-71.0,-68.0,-60.0,-71.0,-72.0,-68.0,-61.0,-90.0,-92.0,-90.0,-93.0,20.0,21.0,22.0,33.0,0
7400,BA:8C:B9:54:50:24,3831961,488851145,4745,6152967,3827216,482698178,0,8454,1656634,8432,1653139,22,3495,2324,14,5136,36,0,53,216660.0,130000.0,-39.0,-37.0,-44.0,-52.0,-40.0,-35.0,-43.0,-48.0,-90.0,-92.0,-90.0,-93.0,51.0,55.0,46.0,41.0,0
7401,92:69:1D:31:68:E9,3830993,486281345,3774,3582903,3827219,482698442,0,4276,1049564,4155,1022364,121,27200,2017,7,3919,80,0,38,216660.0,130000.0,-52.0,-50.0,-44.0,-46.0,-51.0,-49.0,-44.0,-47.0,-90.0,-92.0,-90.0,-93.0,38.0,42.0,46.0,47.0,0
7402,CC:2F:71:3F:1F:24,4482015,1189580603,654794,706881959,3827221,482698644,37,533519,566093523,532872,566015701,647,77822,515835,10,655031,67708,34,456,130000.0,39000.0,-67.0,-65.0,-70.0,-67.0,-67.0,-65.0,-70.0,-67.0,-90.0,-92.0,-90.0,-93.0,23.0,27.0,20.0,26.0,0
7403,CC:2F:71:3E:C5:1F,3828010,482795139,789,96495,3827221,482698644,0,3297,276965,2721,208553,576,68412,835,8,1135,18,0,37,130000.0,39000.0,-70.0,-71.0,-67.0,-60.0,-71.0,-72.0,-68.0,-61.0,-90.0,-92.0,-90.0,-93.0,20.0,21.0,23.0,33.0,0
7404,BA:8C:B9:54:50:24,3831967,488851673,4745,6152967,3827222,482698706,0,8454,1656634,8432,1653139,22,3495,2324,14,5136,36,0,53,216660.0,130000.0,-39.0,-37.0,-44.0,-52.0,-40.0,-35.0,-43.0,-48.0,-90.0,-92.0,-90.0,-93.0,51.0,55.0,46.0,41.0,0
7405,92:69:1D:31:68:E9,3831000,486282013,3774,3582903,3827226,482699110,0,4276,1049564,4155,1022364,121,27200,2017,7,3919,80,0,38,216660.0,130000.0,-52.0,-50.0,-44.0,-46.0,-51.0,-49.0,-44.0,-47.0,-90.0,-92.0,-90.0,-93.0,38.0,42.0,46.0,47.0,0
7406,CC:2F:71:3F:1F:24,4482062,1189595497,654836,706896387,3827226,482699110,37,533545,566098445,532897,566020505,648,77940,515861,10,655073,67725,34,456,130000.0,39000.0,-67.0,-65.0,-70.0,-67.0,-67.0,-65.0,-70.0,-67.0,-90.0,-92.0,-90.0,-93.0,23.0,27.0,20.0,26.0,0
7407,CC:2F:71:3E:C5:1F,3828015,482795605,789,96495,3827226,482699110,0,3297,276965,2721,208553,576,68412,835,8,1135,18,0,37,130000.0,39000.0,-70.0,-71.0,-67.0,-60.0,-71.0,-72.0,-68.0,-61.0,-90.0,-92.0,-90.0,-93.0,20.0,21.0,23.0,33.0,0
7408,BA:8C:B9:54:50:24,3831971,488852077,4745,6152967,3827226,482699110,0,8454,1656634,8432,1653139,22,3495,2324,14,5136,36,0,53,216660.0,130000.0,-39.0,-37.0,-44.0,-52.0,-40.0,-35.0,-43.0,-48.0,-90.0,-92.0,-90.0,-93.0,51.0,55.0,46.0,41.0,0
7409,92:69:1D:31:68:E9,3831015,486287874,3774,3582903,3827241,482704971,0,4278,1049867,4156,1022432,122,27435,2018,7,3919,80,0,38,216660.0,130000.0,-53.0,-52.0,-46.0,-51.0,-51.0,-50.0,-44.0,-47.0,-90.0,-92.0,-90.0,-93.0,37.0,40.0,44.0,42.0,0
7410,CC:2F:71:3F:1F:24,4482121,1189616050,654880,706911079,3827241,482704971,37,533571,566103389,532923,566025449,648,77940,515887,10,655117,67731,34,456,130000.0,39000.0,-67.0,-65.0,-70.0,-68.0,-67.0,-65.0,-70.0,-67.0,-90.0,-92.0,-90.0,-93.0,23.0,27.0,20.0,25.0,0
7411,CC:2F:71:3E:C5:1F,3828032,482801668,789,96495,3827243,482705173,0,3297,276965,2721,208553,576,68412,835,8,1135,18,0,37,130000.0,39000.0,-70.0,-71.0,-67.0,-60.0,-71.0,-72.0,-68.0,-61.0,-90.0,-92.0,-90.0,-93.0,20.0,21.0,23.0,33.0,0
7412,BA:8C:B9:54:50:24,3831988,488858140,4745,6152967,3827243,482705173,0,8454,1656634,8432,1653139,22,3495,2324,14,5136,36,0,53,216660.0,130000.0,-39.0,-37.0,-44.0,-52.0,-40.0,-35.0,-43.0,-48.0,-90.0,-92.0,-90.0,-93.0,51.0,55.0,46.0,41.0,0
7413,92:69:1D:31:68:E9,3831032,486293904,3774,3582903,3827258,482711001,0,4279,1049935,4157,1022500,122,27435,2018,7,3919,80,0,38,216660.0,130000.0,-50.0,-47.0,-42.0,-48.0,-51.0,-50.0,-44.0,-47.0,-90.0,-92.0,-90.0,-93.0,40.0,45.0,48.0,45.0,0
7414,CC:2F:71:3F:1F:24,4482180,1189636452,654922,706925451,3827258,482711001,37,533597,566108333,532949,566030393,648,77940,515913,10,655159,67769,34,456,130000.0,43333.0,-67.0,-65.0,-71.0,-68.0,-67.0,-65.0,-70.0,-67.0,-90.0,-92.0,-90.0,-93.0,23.0,27.0,19.0,25.0,0
7415,CC:2F:71:3E:C5:1F,3828047,482807496,789,96495,3827258,482711001,0,3297,276965,2721,208553,576,68412,835,8,1135,18,0,37,130000.0,39000.0,-70.0,-71.0,-67.0,-60.0,-71.0,-72.0,-68.0,-61.0,-90.0,-92.0,-90.0,-93.0,20.0,21.0,23.0,33.0,0
7416,BA:8C:B9:54:50:24,3832003,488863968,4745,6152967,3827258,482711001,0,8454,1656634,8432,1653139,22,3495,2324,14,5136,36,0,53,216660.0,130000.0,-39.0,-37.0,-44.0,-52.0,-40.0,-35.0,-43.0,-48.0,-90.0,-92.0,-90.0,-93.0,51.0,55.0,46.0,41.0,0
7417,92:69:1D:31:68:E9,3831036,486294439,3774,3582903,3827262,482711536,0,4279,1049935,4157,1022500,122,27435,2018,7,3919,80,0,38,216660.0,130000.0,-50.0,-47.0,-42.0,-48.0,-51.0,-50.0,-44.0,-47.0,-90.0,-92.0,-90.0,-93.0,40.0,45.0,48.0,45.0,0
7418,CC:2F:71:3F:1F:24,4482226,1189651533,654964,706939997,3827262,482711536,37,533622,566113137,532974,566035197,648,77940,515938,10,655201,67775,34,456,130000.0,43333.0,-67.0,-65.0,-71.0,-67.0,-67.0,-65.0,-70.0,-67.0,-90.0,-92.0,-90.0,-93.0,23.0,27.0,19.0,26.0,0
7419,CC:2F:71:3E:C5:1F,3828053,482808233,789,96495,3827264,482711738,0,3297,276965,2721,208553,576,68412,835,8,1135,18,0,37,130000.0,39000.0,-70.0,-71.0,-67.0,-60.0,-71.0,-72.0,-68.0,-61.0,-90.0,-92.0,-90.0,-93.0,20.0,21.0,23.0,33.0,0
7420,BA:8C:B9:54:50:24,3832009,488864705,4745,6152967,3827264,482711738,0,8454,1656634,8432,1653139,22,3495,2324,14,5136,36,0,53,216660.0,130000.0,-39.0,-37.0,-44.0,-52.0,-40.0,-35.0,-43.0,-48.0,-90.0,-92.0,-90.0,-93.0,51.0,55.0,46.0,41.0,0
7421,92:69:1D:31:68:E9,3831042,486295045,3774,3582903,3827268,482712142,0,4279,1049935,4157,1022500,122,27435,2018,7,3919,80,0,38,216660.0,130000.0,-50.0,-47.0,-42.0,-48.0,-51.0,-50.0,-44.0,-47.0,-90.0,-92.0,-90.0,-93.0,40.0,45.0,48.0,45.0,0
7422,CC:2F:71:3F:1F:24,4482275,1189666697,655007,706954555,3827268,482712142,37,533648,566118057,533000,566040117,648,77940,515964,10,655244,67801,34,456,144444.0,43333.0,-67.0,-65.0,-70.0,-68.0,-67.0,-65.0,-70.0,-67.0,-90.0,-92.0,-90.0,-93.0,23.0,27.0,20.0,25.0,0
7423,CC:2F:71:3E:C5:1F,3828057,482808637,789,96495,3827268,482712142,0,3297,276965,2721,208553,576,68412,835,8,1135,18,0,37,130000.0,39000.0,-70.0,-71.0,-67.0,-60.0,-71.0,-72.0,-68.0,-61.0,-90.0,-92.0,-90.0,-93.0,20.0,21.0,23.0,33.0,0
7424,BA:8C:B9:54:50:24,3832013,488865109,4745,6152967,3827268,482712142,0,8454,1656634,8432,1653139,22,3495,2324,14,5136,36,0,53,216660.0,130000.0,-39.0,-37.0,-44.0,-52.0,-40.0,-35.0,-43.0,-48.0,-90.0,-92.0,-90.0,-93.0,51.0,55.0,46.0,41.0,0
7425,92:69:1D:31:68:E9,3831044,486295247,3774,3582903,3827270,482712344,0,4279,1049935,4157,1022500,122,27435,2018,7,3919,80,0,38,216660.0,130000.0,-50.0,-47.0,-42.0,-48.0,-51.0,-50.0,-44.0,-47.0,-90.0,-92.0,-90.0,-93.0,40.0,45.0,48.0,45.0,0
7426,CC:2F:71:3F:1F:24,4482319,1189681327,655049,706968983,3827270,482712344,37,533674,566123001,533026,566045061,648,77940,515990,10,655286,67816,34,456,130000.0,43333.0,-67.0,-65.0,-70.0,-68.0,-67.0,-65.0,-70.0,-67.0,-90.0,-92.0,-90.0,-93.0,23.0,27.0,20.0,25.0,0
7427,CC:2F:71:3E:C5:1F,3828059,482808839,789,96495,3827270,482712344,0,3297,276965,2721,208553,576,68412,835,8,1135,18,0,37,130000.0,39000.0,-70.0,-71.0,-67.0,-60.0,-71.0,-72.0,-68.0,-61.0,-90.0,-92.0,-90.0,-93.0,20.0,21.0,23.0,33.0,0
7428,BA:8C:B9:54:50:24,3832017,488865513,4745,6152967,3827272,482712546,0,8454,1656634,8432,1653139,22,3495,2324,14,5136,36,0,53,216660.0,130000.0,-39.0,-37.0,-44.0,-52.0,-40.0,-35.0,-43.0,-48.0,-90.0,-92.0,-90.0,-93.0,51.0,55.0,46.0,41.0,0
7429,92:69:1D:31:68:E9,3831053,486296281,3774,3582903,3827279,482713378,0,4279,1049935,4157,1022500,122,27435,2018,7,3919,80,0,38,216660.0,130000.0,-50.0,-47.0,-42.0,-48.0,-51.0,-50.0,-44.0,-47.0,-90.0,-92.0,-90.0,-93.0,40.0,45.0,48.0,45.0,0
7430,CC:2F:71:3F:1F:24,4482371,1189697159,655092,706983781,3827279,482713378,37,533705,566128537,533057,566050597,648,77940,516021,10,655329,67816,34,456,130000.0,43333.0,-67.0,-65.0,-70.0,-67.0,-67.0,-65.0,-70.0,-67.0,-90.0,-92.0,-90.0,-93.0,23.0,27.0,20.0,26.0,0
7431,CC:2F:71:3E:C5:1F,3828068,482809873,789,96495,3827279,482713378,0,3297,276965,2721,208553,576,68412,835,8,1135,18,0,37,130000.0,39000.0,-70.0,-71.0,-67.0,-60.0,-71.0,-72.0,-68.0,-61.0,-90.0,-92.0,-90.0,-93.0,20.0,21.0,23.0,33.0,0
7432,BA:8C:B9:54:50:24,3832024,488866345,4745,6152967,3827279,482713378,0,8454,1656634,8432,1653139,22,3495,2324,14,5136,36,0,53,216660.0,130000.0,-39.0,-37.0,-44.0,-52.0,-40.0,-35.0,-43.0,-48.0,-90.0,-92.0,-90.0,-93.0,51.0,55.0,46.0,41.0,0
7433,92:69:1D:31:68:E9,3831055,486296483,3774,3582903,3827281,482713580,0,4279,1049935,4157,1022500,122,27435,2018,7,3919,80,0,38,216660.0,130000.0,-50.0,-47.0,-42.0,-48.0,-51.0,-50.0,-44.0,-47.0,-90.0,-92.0,-90.0,-93.0,40.0,45.0,48.0,45.0,0
7434,CC:2F:71:3F:1F:24,4482414,1189711665,655133,706998085,3827281,482713580,37,533732,566133597,533084,566055657,648,77940,516048,10,655370,67834,34,456,117000.0,39000.0,-67.0,-65.0,-71.0,-68.0,-67.0,-65.0,-70.0,-67.0,-90.0,-92.0,-90.0,-93.0,23.0,27.0,19.0,25.0,0
7435,CC:2F:71:3E:C5:1F,3828071,482810209,789,96495,3827282,482713714,0,3297,276965,2721,208553,576,68412,835,8,1135,18,0,37,130000.0,39000.0,-70.0,-71.0,-67.0,-60.0,-71.0,-72.0,-68.0,-61.0,-90.0,-92.0,-90.0,-93.0,20.0,21.0,23.0,33.0,0
7436,BA:8C:B9:54:50:24,3832028,488866749,4745,6152967,3827283,482713782,0,8454,1656634,8432,1653139,22,3495,2324,14,5136,36,0,53,216660.0,130000.0,-39.0,-37.0,-44.0,-52.0,-40.0,-35.0,-43.0,-48.0,-90.0,-92.0,-90.0,-93.0,51.0,55.0,46.0,41.0,0
7437,92:69:1D:31:68:E9,3831061,486297089,3774,3582903,3827287,482714186,0,4279,1049935,4157,1022500,122,27435,2018,7,3919,80,0,38,216660.0,130000.0,-50.0,-47.0,-42.0,-48.0,-51.0,-50.0,-44.0,-47.0,-90.0,-92.0,-90.0,-93.0,40.0,45.0,48.0,45.0,0
7438,CC:2F:71:3F:1F:24,4482464,1189726903,655177,707012717,3827287,482714186,37,533758,566138541,533110,566060601,648,77940,516074,10,655414,67839,34,456,130000.0,39000.0,-67.0,-65.0,-71.0,-68.0,-67.0,-65.0,-70.0,-67.0,-90.0,-92.0,-90.0,-93.0,23.0,27.0,19.0,25.0,0
7439,CC:2F:71:3E:C5:1F,3828076,482810681,789,96495,3827287,482714186,0,3297,276965,2721,208553,576,68412,835,8,1135,18,0,37,130000.0,39000.0,-70.0,-71.0,-67.0,-60.0,-71.0,-72.0,-68.0,-61.0,-90.0,-92.0,-90.0,-93.0,20.0,21.0,23.0,33.0,0
7440,BA:8C:B9:54:50:24,3832033,488867213,4745,6152967,3827288,482714246,0,8454,1656634,8432,1653139,22,3495,2324,14,5136,36,0,53,216660.0,130000.0,-39.0,-37.0,-44.0,-52.0,-40.0,-35.0,-43.0,-48.0,-90.0,-92.0,-90.0,-93.0,51.0,55.0,46.0,41.0,0
7441,92:69:1D:31:68:E9,3831064,486297351,3774,3582903,3827290,482714448,0,4279,1049935,4157,1022500,122,27435,2018,7,3919,80,0,38,216660.0,130000.0,-50.0,-47.0,-42.0,-48.0,-51.0,-50.0,-44.0,-47.0,-90.0,-92.0,-90.0,-93.0,40.0,45.0,48.0,45.0,0
7442,CC:2F:71:3F:1F:24,4482510,1189741717,655220,707027269,3827290,482714448,37,533787,566143833,533139,566065893,648,77940,516103,10,655456,67868,34,456,130000.0,39000.0,-67.0,-65.0,-71.0,-68.0,-67.0,-65.0,-70.0,-67.0,-90.0,-92.0,-90.0,-93.0,23.0,27.0,19.0,25.0,0
7443,CC:2F:71:3E:C5:1F,3828079,482810943,789,96495,3827290,482714448,0,3297,276965,2721,208553,576,68412,835,8,1135,18,0,37,130000.0,39000.0,-70.0,-71.0,-67.0,-60.0,-71.0,-72.0,-68.0,-61.0,-90.0,-92.0,-90.0,-93.0,20.0,21.0,23.0,33.0,0
7444,BA:8C:B9:54:50:24,3832035,488867415,4745,6152967,3827290,482714448,0,8454,1656634,8432,1653139,22,3495,2324,14,5136,36,0,53,216660.0,130000.0,-39.0,-37.0,-44.0,-52.0,-40.0,-35.0,-43.0,-48.0,-90.0,-92.0,-90.0,-93.0,51.0,55.0,46.0,41.0,0
7445,92:69:1D:31:68:E9,3831070,486297957,3774,3582903,3827296,482715054,0,4279,1049935,4157,1022500,122,27435,2018,7,3919,80,0,38,216660.0,130000.0,-50.0,-47.0,-42.0,-48.0,-51.0,-50.0,-44.0,-47.0,-90.0,-92.0,-90.0,-93.0,40.0,45.0,48.0,45.0,0
7446,CC:2F:71:3F:1F:24,4482558,1189756751,655262,707041697,3827296,482715054,37,533816,566149125,533168,566071185,648,77940,516132,10,655499,67890,34,456,130000.0,39000.0,-67.0,-65.0,-70.0,-68.0,-67.0,-65.0,-70.0,-67.0,-90.0,-92.0,-90.0,-93.0,23.0,27.0,20.0,25.0,0
7447,CC:2F:71:3E:C5:1F,3828085,482811549,789,96495,3827296,482715054,0,3297,276965,2721,208553,576,68412,835,8,1135,18,0,37,130000.0,39000.0,-70.0,-71.0,-67.0,-60.0,-71.0,-72.0,-68.0,-61.0,-90.0,-92.0,-90.0,-93.0,20.0,21.0,23.0,33.0,0
7448,BA:8C:B9:54:50:24,3832041,488868021,4745,6152967,3827296,482715054,0,8454,1656634,8432,1653139,22,3495,2324,14,5136,36,0,53,216660.0,130000.0,-39.0,-37.0,-44.0,-52.0,-40.0,-35.0,-43.0,-48.0,-90.0,-92.0,-90.0,-93.0,51.0,55.0,46.0,41.0,0
7449,92:69:1D:31:68:E9,3831073,486298219,3774,3582903,3827299,482715316,0,4279,1049935,4157,1022500,122,27435,2018,7,3919,80,0,38,216660.0,130000.0,-50.0,-47.0,-42.0,-48.0,-51.0,-50.0,-44.0,-47.0,-90.0,-92.0,-90.0,-93.0,40.0,45.0,48.0,45.0,0
7450,CC:2F:71:3F:1F:24,4482603,1189771385,655304,707056069,3827299,482715316,37,533842,566154069,533194,566076129,648,77940,516158,10,655541,67923,34,456,130000.0,43333.0,-67.0,-65.0,-70.0,-67.0,-67.0,-65.0,-70.0,-67.0,-90.0,-92.0,-90.0,-93.0,23.0,27.0,20.0,26.0,0
7451,CC:2F:71:3E:C5:1F,3828088,482811811,789,96495,3827299,482715316,0,3297,276965,2721,208553,576,68412,835,8,1135,18,0,37,130000.0,39000.0,-70.0,-71.0,-67.0,-60.0,-71.0,-72.0,-68.0,-61.0,-90.0,-92.0,-90.0,-93.0,20.0,21.0,23.0,33.0,0
7452,BA:8C:B9:54:50:24,3832044,488868283,4745,6152967,3827299,482715316,0,8454,1656634,8432,1653139,22,3495,2324,14,5136,36,0,53,216660.0,130000.0,-39.0,-37.0,-44.0,-52.0,-40.0,-35.0,-43.0,-48.0,-90.0,-92.0,-90.0,-93.0,51.0,55.0,46.0,41.0,0
7453,92:69:1D:31:68:E9,3831079,486298825,3774,3582903,3827305,482715922,0,4279,1049935,4157,1022500,122,27435,2018,7,3919,80,0,38,216660.0,130000.0,-50.0,-47.0,-42.0,-48.0,-51.0,-50.0,-44.0,-47.0,-90.0,-92.0,-90.0,-93.0,40.0,45.0,48.0,45.0,0
7454,CC:2F:71:3F:1F:24,4482651,1189786531,655346,707070609,3827305,482715922,37,533870,566159269,533222,566081329,648,77940,516186,10,655583,67928,34,456,130000.0,43333.0,-67.0,-65.0,-70.0,-68.0,-67.0,-65.0,-70.0,-67.0,-90.0,-92.0,-90.0,-93.0,23.0,27.0,20.0,25.0,0
7455,CC:2F:71:3E:C5:1F,3828094,482812417,789,96495,3827305,482715922,0,3297,276965,2721,208553,576,68412,835,8,1135,18,0,37,130000.0,39000.0,-70.0,-71.0,-67.0,-60.0,-71.0,-72.0,-68.0,-61.0,-90.0,-92.0,-90.0,-93.0,20.0,21.0,23.0,33.0,0
7456,BA:8C:B9:54:50:24,3832050,488868889,4745,6152967,3827305,482715922,0,8454,1656634,8432,1653139,22,3495,2324,14,5136,36,0,53,216660.0,130000.0,-39.0,-37.0,-44.0,-52.0,-40.0,-35.0,-43.0,-48.0,-90.0,-92.0,-90.0,-93.0,51.0,55.0,46.0,41.0,0
7457,92:69:1D:31:68:E9,3831081,486299027,3774,3582903,3827307,482716124,0,4279,1049935,4157,1022500,122,27435,2018,7,3919,80,0,38,216660.0,130000.0,-50.0,-47.0,-42.0,-48.0,-51.0,-50.0,-44.0,-47.0,-90.0,-92.0,-90.0,-93.0,40.0,45.0,48.0,45.0,0
7458,CC:2F:71:3F:1F:24,4482696,1189801285,655389,707085161,3827307,482716124,37,533897,566164353,533249,566086413,648,77940,516213,10,655626,67946,34,456,117000.0,39000.0,-67.0,-65.0,-70.0,-68.0,-67.0,-65.0,-70.0,-67.0,-90.0,-92.0,-90.0,-93.0,23.0,27.0,20.0,25.0,0
7459,CC:2F:71:3E:C5:1F,3828096,482812619,789,96495,3827307,482716124,0,3297,276965,2721,208553,576,68412,835,8,1135,18,0,37,130000.0,39000.0,-70.0,-71.0,-67.0,-60.0,-71.0,-72.0,-68.0,-61.0,-90.0,-92.0,-90.0,-93.0,20.0,21.0,23.0,33.0,0
7460,BA:8C:B9:54:50:24,3832052,488869091,4745,6152967,3827307,482716124,0,8454,1656634,8432,1653139,22,3495,2324,14,5136,36,0,53,216660.0,130000.0,-39.0,-37.0,-44.0,-52.0,-40.0,-35.0,-43.0,-48.0,-90.0,-92.0,-90.0,-93.0,51.0,55.0,46.0,41.0,0
7461,92:69:1D:31:68:E9,3831088,486299693,3774,3582903,3827314,482716790,0,4279,1049935,4157,1022500,122,27435,2018,7,3919,80,0,38,216660.0,130000.0,-50.0,-47.0,-42.0,-48.0,-51.0,-50.0,-44.0,-47.0,-90.0,-92.0,-90.0,-93.0,40.0,45.0,48.0,45.0,0
7462,CC:2F:71:3F:1F:24,4482748,1189816763,655434,707099973,3827314,482716790,37,533924,566169413,533276,566091473,648,77940,516240,10,655671,67953,34,456,130000.0,43333.0,-67.0,-65.0,-71.0,-67.0,-67.0,-65.0,-70.0,-67.0,-90.0,-92.0,-90.0,-93.0,23.0,27.0,19.0,26.0,0
7463,CC:2F:71:3E:C5:1F,3828103,482813285,789,96495,3827314,482716790,0,3297,276965,2721,208553,576,68412,835,8,1135,18,0,37,130000.0,39000.0,-70.0,-71.0,-67.0,-60.0,-71.0,-72.0,-68.0,-61.0,-90.0,-92.0,-90.0,-93.0,20.0,21.0,23.0,33.0,0
7464,BA:8C:B9:54:50:24,3832059,488869757,4745,6152967,3827314,482716790,0,8454,1656634,8432,1653139,22,3495,2324,14,5136,36,0,53,216660.0,130000.0,-39.0,-37.0,-44.0,-52.0,-40.0,-35.0,-43.0,-48.0,-90.0,-92.0,-90.0,-93.0,51.0,55.0,46.0,41.0,0
7465,92:69:1D:31:68:E9,3831091,486300011,3775,3583019,3827316,482716992,0,4281,1050071,4159,1022636,122,27435,2018,7,3920,80,0,38,216660.0,130000.0,-52.0,-52.0,-45.0,-48.0,-51.0,-50.0,-44.0,-47.0,-90.0,-92.0,-90.0,-93.0,38.0,40.0,45.0,45.0,0
7466,CC:2F:71:3F:1F:24,4482795,1189831707,655479,707114715,3827316,482716992,37,533950,566174357,533302,566096417,648,77940,516266,10,655716,67964,34,456,130000.0,43333.0,-67.0,-65.0,-70.0,-67.0,-67.0,-65.0,-70.0,-67.0,-90.0,-92.0,-90.0,-93.0,23.0,27.0,20.0,26.0,0
7467,CC:2F:71:3E:C5:1F,3828106,482813547,790,96555,3827316,482716992,0,3299,277105,2723,208693,576,68412,835,8,1136,18,0,37,130000.0,39000.0,-70.0,-71.0,-67.0,-60.0,-70.0,-70.0,-67.0,-60.0,-90.0,-92.0,-90.0,-93.0,20.0,21.0,23.0,33.0,0
7468,BA:8C:B9:54:50:24,3832062,488870075,4746,6153083,3827316,482716992,0,8460,1657042,8438,1653547,22,3495,2324,14,5137,36,0,53,216660.0,130000.0,-49.0,-35.0,-42.0,-44.0,-41.0,-35.0,-42.0,-47.0,-90.0,-92.0,-90.0,-93.0,41.0,57.0,48.0,49.0,0
7469,92:69:1D:31:68:E9,3831098,486300890,3775,3583019,3827323,482717871,0,4281,1050071,4159,1022636,122,27435,2018,7,3920,80,0,38,216660.0,130000.0,-52.0,-52.0,-45.0,-48.0,-51.0,-50.0,-44.0,-47.0,-90.0,-92.0,-90.0,-92.0,38.0,40.0,45.0,44.0,0
7470,CC:2F:71:3F:1F:24,4482843,1189846876,655519,707128945,3827324,482717931,37,533975,566179161,533327,566101221,648,77940,516291,10,655756,67972,34,456,130000.0,43333.0,-67.0,-65.0,-70.0,-67.0,-67.0,-65.0,-70.0,-67.0,-90.0,-92.0,-90.0,-92.0,23.0,27.0,20.0,25.0,0
7471,CC:2F:71:3E:C5:1F,3828114,482814486,790,96555,3827324,482717931,0,3299,277105,2723,208693,576,68412,835,8,1136,18,0,37,130000.0,39000.0,-70.0,-71.0,-67.0,-60.0,-70.0,-70.0,-67.0,-60.0,-90.0,-92.0,-90.0,-92.0,20.0,21.0,23.0,32.0,0
7472,BA:8C:B9:54:50:24,3832071,488871076,4746,6153083,3827325,482717993,0,8461,1657110,8439,1653615,22,3495,2324,14,5137,36,0,53,216660.0,130000.0,-39.0,-36.0,-44.0,-51.0,-41.0,-35.0,-42.0,-47.0,-90.0,-92.0,-90.0,-92.0,51.0,56.0,46.0,41.0,0
7473,92:69:1D:31:68:E9,3831103,486301276,3775,3583019,3827328,482718257,0,4281,1050071,4159,1022636,122,27435,2018,7,3920,80,0,38,216660.0,130000.0,-52.0,-52.0,-45.0,-48.0,-51.0,-50.0,-44.0,-47.0,-90.0,-92.0,-90.0,-92.0,38.0,40.0,45.0,44.0,0
7474,CC:2F:71:3F:1F:24,4482888,1189861506,655560,707143249,3827328,482718257,37,534003,566184315,533354,566106257,649,78058,516319,10,655797,67994,34,456,117000.0,39000.0,-67.0,-65.0,-71.0,-67.0,-67.0,-65.0,-70.0,-67.0,-90.0,-92.0,-90.0,-92.0,23.0,27.0,19.0,25.0,0
7475,CC:2F:71:3E:C5:1F,3828118,482814812,790,96555,3827328,482718257,0,3301,277293,2724,208763,577,68530,836,8,1136,18,0,37,130000.0,39000.0,-69.0,-70.0,-67.0,-60.0,-69.0,-70.0,-67.0,-60.0,-90.0,-92.0,-90.0,-92.0,21.0,22.0,23.0,32.0,0
7476,BA:8C:B9:54:50:24,3832076,488871542,4746,6153083,3827330,482718459,0,8461,1657110,8439,1653615,22,3495,2324,14,5137,36,0,53,216660.0,130000.0,-39.0,-36.0,-44.0,-51.0,-41.0,-35.0,-42.0,-47.0,-90.0,-92.0,-90.0,-92.0,51.0,56.0,46.0,41.0,0
7477,92:69:1D:31:68:E9,3831109,486301882,3775,3583019,3827334,482718863,0,4281,1050071,4159,1022636,122,27435,2018,7,3920,80,0,38,216660.0,130000.0,-52.0,-52.0,-45.0,-48.0,-51.0,-50.0,-44.0,-47.0,-90.0,-92.0,-90.0,-92.0,38.0,40.0,45.0,44.0,0
7478,CC:2F:71:3F:1F:24,4482936,1189876540,655602,707157677,3827334,482718863,37,534028,566189119,533379,566111061,649,78058,516344,10,655839,68003,34,456,130000.0,43333.0,-67.0,-65.0,-70.0,-67.0,-67.0,-65.0,-70.0,-67.0,-90.0,-92.0,-90.0,-92.0,23.0,27.0,20.0,25.0,0
7479,CC:2F:71:3E:C5:1F,3828124,482815418,790,96555,3827334,482718863,0,3301,277293,2724,208763,577,68530,836,8,1136,18,0,37,130000.0,39000.0,-69.0,-70.0,-67.0,-60.0,-69.0,-70.0,-67.0,-60.0,-90.0,-92.0,-90.0,-92.0,21.0,22.0,23.0,32.0,0
7480,BA:8C:B9:54:50:24,3832080,488871946,4746,6153083,3827334,482718863,0,8461,1657110,8439,1653615,22,3495,2324,14,5137,36,0,53,216660.0,130000.0,-39.0,-36.0,-44.0,-51.0,-41.0,-35.0,-42.0,-47.0,-90.0,-92.0,-90.0,-92.0,51.0,56.0,46.0,41.0,0
7481,92:69:1D:31:68:E9,3831112,486302144,3775,3583019,3827337,482719125,0,4281,1050071,4159,1022636,122,27435,2018,7,3920,80,0,38,216660.0,130000.0,-52.0,-52.0,-45.0,-48.0,-51.0,-50.0,-44.0,-47.0,-90.0,-92.0,-90.0,-92.0,38.0,40.0,45.0,44.0,0
7482,CC:2F:71:3F:1F:24,4482979,1189891032,655642,707171907,3827337,482719125,37,534053,566193923,533404,566115865,649,78058,516369,10,655879,68015,34,456,130000.0,39000.0,-67.0,-65.0,-70.0,-67.0,-67.0,-65.0,-70.0,-67.0,-90.0,-92.0,-90.0,-92.0,23.0,27.0,20.0,25.0,0
7483,CC:2F:71:3E:C5:1F,3828127,482815680,790,96555,3827337,482719125,0,3301,277293,2724,208763,577,68530,836,8,1136,18,0,37,130000.0,39000.0,-69.0,-70.0,-67.0,-60.0,-69.0,-70.0,-67.0,-60.0,-90.0,-92.0,-90.0,-92.0,21.0,22.0,23.0,32.0,0
7484,BA:8C:B9:54:50:24,3832085,488872410,4746,6153083,3827339,482719327,0,8461,1657110,8439,1653615,22,3495,2324,14,5137,36,0,53,216660.0,130000.0,-39.0,-36.0,-44.0,-51.0,-41.0,-35.0,-42.0,-47.0,-90.0,-92.0,-90.0,-92.0,51.0,56.0,46.0,41.0,0
7485,92:69:1D:31:68:E9,3831118,486302750,3775,3583019,3827343,482719731,0,4281,1050071,4159,1022636,122,27435,2018,7,3920,80,0,38,216660.0,130000.0,-52.0,-52.0,-45.0,-48.0,-51.0,-50.0,-44.0,-47.0,-90.0,-92.0,-90.0,-92.0,38.0,40.0,45.0,44.0,0
7486,CC:2F:71:3F:1F:24,4483026,1189905942,655683,707186211,3827343,482719731,37,534078,566198727,533429,566120669,649,78058,516394,10,655920,68052,34,456,144444.0,43333.0,-67.0,-65.0,-71.0,-67.0,-67.0,-65.0,-70.0,-67.0,-90.0,-92.0,-90.0,-92.0,23.0,27.0,19.0,25.0,0
7487,CC:2F:71:3E:C5:1F,3828133,482816286,790,96555,3827343,482719731,0,3301,277293,2724,208763,577,68530,836,8,1136,18,0,37,130000.0,39000.0,-69.0,-70.0,-67.0,-60.0,-69.0,-70.0,-67.0,-60.0,-90.0,-92.0,-90.0,-92.0,21.0,22.0,23.0,32.0,0
7488,BA:8C:B9:54:50:24,3832089,488872814,4746,6153083,3827343,482719731,0,8461,1657110,8439,1653615,22,3495,2324,14,5137,36,0,53,216660.0,130000.0,-39.0,-36.0,-44.0,-51.0,-41.0,-35.0,-42.0,-47.0,-90.0,-92.0,-90.0,-92.0,51.0,56.0,46.0,41.0,0
7489,92:69:1D:31:68:E9,3831120,486302952,3775,3583019,3827345,482719933,0,4283,1050207,4161,1022772,122,27435,2018,7,3921,80,0,38,216660.0,130000.0,-52.0,-50.0,-45.0,-46.0,-51.0,-50.0,-44.0,-47.0,-90.0,-92.0,-90.0,-92.0,38.0,42.0,45.0,46.0,0
7490,CC:2F:71:3F:1F:24,4483070,1189920628,655725,707200695,3827345,482719933,37,534106,566203879,533457,566125821,649,78058,516422,10,655962,68062,34,456,130000.0,43333.0,-67.0,-65.0,-70.0,-67.0,-67.0,-65.0,-70.0,-67.0,-90.0,-92.0,-90.0,-92.0,23.0,27.0,20.0,25.0,0
7491,CC:2F:71:3E:C5:1F,3828135,482816488,790,96555,3827345,482719933,0,3301,277293,2724,208763,577,68530,836,8,1136,18,0,37,130000.0,39000.0,-69.0,-70.0,-67.0,-60.0,-69.0,-70.0,-67.0,-60.0,-90.0,-92.0,-90.0,-92.0,21.0,22.0,23.0,32.0,0
7492,BA:8C:B9:54:50:24,3832093,488873218,4746,6153083,3827347,482720135,0,8461,1657110,8439,1653615,22,3495,2324,14,5137,36,0,53,216660.0,130000.0,-39.0,-36.0,-44.0,-51.0,-41.0,-35.0,-42.0,-47.0,-90.0,-92.0,-90.0,-92.0,51.0,56.0,46.0,41.0,0
7493,92:69:1D:31:68:E9,3831127,486303618,3775,3583019,3827352,482720599,0,4283,1050207,4161,1022772,122,27435,2018,7,3921,80,0,38,216660.0,130000.0,-52.0,-50.0,-45.0,-46.0,-51.0,-50.0,-44.0,-47.0,-90.0,-92.0,-90.0,-92.0,38.0,42.0,45.0,46.0,0
7494,CC:2F:71:3F:1F:24,4483120,1189935902,655768,707215303,3827352,482720599,37,534133,566208939,533484,566130881,649,78058,516449,10,656005,68075,34,456,130000.0,39000.0,-67.0,-65.0,-70.0,-68.0,-67.0,-65.0,-70.0,-67.0,-90.0,-92.0,-90.0,-92.0,23.0,27.0,20.0,24.0,0
7495,CC:2F:71:3E:C5:1F,3828142,482817154,790,96555,3827352,482720599,0,3301,277293,2724,208763,577,68530,836,8,1136,18,0,37,130000.0,39000.0,-69.0,-70.0,-67.0,-60.0,-69.0,-70.0,-67.0,-60.0,-90.0,-92.0,-90.0,-92.0,21.0,22.0,23.0,32.0,0
7496,BA:8C:B9:54:50:24,3832098,488873682,4746,6153083,3827352,482720599,0,8461,1657110,8439,1653615,22,3495,2324,14,5137,36,0,53,216660.0,130000.0,-39.0,-36.0,-44.0,-51.0,-41.0,-35.0,-42.0,-47.0,-90.0,-92.0,-90.0,-92.0,51.0,56.0,46.0,41.0,0
7497,92:69:1D:31:68:E9,3831129,486303820,3775,3583019,3827354,482720801,0,4283,1050207,4161,1022772,122,27435,2018,7,3921,80,0,38,216660.0,130000.0,-52.0,-50.0,-45.0,-46.0,-51.0,-50.0,-44.0,-47.0,-90.0,-92.0,-90.0,-92.0,38.0,42.0,45.0,46.0,0
7498,CC:2F:71:3F:1F:24,4483163,1189950408,655809,707229607,3827354,482720801,37,534159,566213859,533510,566135801,649,78058,516475,10,656046,68084,34,456,130000.0,39000.0,-67.0,-65.0,-71.0,-68.0,-67.0,-65.0,-70.0,-67.0,-90.0,-92.0,-90.0,-92.0,23.0,27.0,19.0,24.0,0
7499,CC:2F:71:3E:C5:1F,3828144,482817356,790,96555,3827354,482720801,0,3301,277293,2724,208763,577,68530,836,8,1136,18,0,37,130000.0,39000.0,-69.0,-70.0,-67.0,-60.0,-69.0,-70.0,-67.0,-60.0,-90.0,-92.0,-90.0,-92.0,21.0,22.0,23.0,32.0,0
7500,BA:8C:B9:54:50:24,3832104,488874288,4746,6153083,3827358,482721205,0,8461,1657110,8439,1653615,22,3495,2324,14,5137,36,0,53,216660.0,130000.0,-39.0,-36.0,-44.0,-51.0,-41.0,-35.0,-42.0,-47.0,-90.0,-92.0,-90.0,-92.0,51.0,56.0,46.0,41.0,0
7501,92:69:1D:31:68:E9,3831136,486304486,3775,3583019,3827361,482721467,0,4283,1050207,4161,1022772,122,27435,2018,7,3921,80,0,38,216660.0,130000.0,-52.0,-50.0,-45.0,-46.0,-51.0,-50.0,-44.0,-47.0,-90.0,-92.0,-90.0,-92.0,38.0,42.0,45.0,46.0,0
7502,CC:2F:71:3F:1F:24,4483212,1189965390,655851,707243923,3827361,482721467,37,534184,566218663,533535,566140605,649,78058,516500,10,656088,68095,34,456,130000.0,39000.0,-67.0,-65.0,-70.0,-67.0,-67.0,-65.0,-70.0,-67.0,-90.0,-92.0,-90.0,-92.0,23.0,27.0,20.0,25.0,0
7503,CC:2F:71:3E:C5:1F,3828151,482818022,790,96555,3827361,482721467,0,3301,277293,2724,208763,577,68530,836,8,1136,18,0,37,130000.0,39000.0,-69.0,-70.0,-67.0,-60.0,-69.0,-70.0,-67.0,-60.0,-90.0,-92.0,-90.0,-92.0,21.0,22.0,23.0,32.0,0
7504,BA:8C:B9:54:50:24,3832107,488874550,4746,6153083,3827361,482721467,0,8461,1657110,8439,1653615,22,3495,2324,14,5137,36,0,53,216660.0,130000.0,-39.0,-36.0,-44.0,-51.0,-41.0,-35.0,-42.0,-47.0,-90.0,-92.0,-90.0,-92.0,51.0,56.0,46.0,41.0,0
7505,92:69:1D:31:68:E9,3831138,486304688,3775,3583019,3827363,482721669,0,4283,1050207,4161,1022772,122,27435,2018,7,3921,80,0,38,216660.0,130000.0,-52.0,-50.0,-45.0,-46.0,-51.0,-50.0,-44.0,-47.0,-90.0,-92.0,-90.0,-92.0,38.0,42.0,45.0,46.0,0
7506,CC:2F:71:3F:1F:24,4483256,1189980020,655893,707258351,3827363,482721669,37,534210,566223607,533561,566145549,649,78058,516526,10,656130,68111,34,456,117000.0,39000.0,-67.0,-65.0,-70.0,-67.0,-67.0,-65.0,-70.0,-67.0,-90.0,-92.0,-90.0,-92.0,23.0,27.0,20.0,25.0,0
7507,CC:2F:71:3E:C5:1F,3828153,482818224,790,96555,3827363,482721669,0,3301,277293,2724,208763,577,68530,836,8,1136,18,0,37,130000.0,39000.0,-69.0,-70.0,-67.0,-60.0,-69.0,-70.0,-67.0,-60.0,-90.0,-92.0,-90.0,-92.0,21.0,22.0,23.0,32.0,0
7508,BA:8C:B9:54:50:24,3832111,488874954,4746,6153083,3827365,482721871,0,8461,1657110,8439,1653615,22,3495,2324,14,5137,36,0,53,216660.0,130000.0,-39.0,-36.0,-44.0,-51.0,-41.0,-35.0,-42.0,-47.0,-90.0,-92.0,-90.0,-92.0,51.0,56.0,46.0,41.0,0
7509,92:69:1D:31:68:E9,3831144,486305294,3775,3583019,3827369,482722275,0,4283,1050207,4161,1022772,122,27435,2018,7,3921,80,0,38,216660.0,130000.0,-52.0,-50.0,-45.0,-46.0,-51.0,-50.0,-44.0,-47.0,-90.0,-92.0,-90.0,-93.0,38.0,42.0,45.0,47.0,0
7510,CC:2F:71:3F:1F:24,4483304,1189994998,655935,707272723,3827369,482722275,37,534235,566228411,533586,566150353,649,78058,516551,10,656172,68114,34,456,130000.0,43333.0,-67.0,-65.0,-70.0,-68.0,-67.0,-65.0,-70.0,-67.0,-90.0,-92.0,-90.0,-93.0,23.0,27.0,20.0,25.0,0
7511,CC:2F:71:3E:C5:1F,3828159,482818830,790,96555,3827369,482722275,0,3301,277293,2724,208763,577,68530,836,8,1136,18,0,37,130000.0,39000.0,-69.0,-70.0,-67.0,-60.0,-69.0,-70.0,-67.0,-60.0,-90.0,-92.0,-90.0,-93.0,21.0,22.0,23.0,33.0,0
7512,BA:8C:B9:54:50:24,3832115,488875358,4746,6153083,3827369,482722275,0,8461,1657110,8439,1653615,22,3495,2324,14,5137,36,0,53,216660.0,130000.0,-39.0,-36.0,-44.0,-51.0,-41.0,-35.0,-42.0,-47.0,-90.0,-92.0,-90.0,-93.0,51.0,56.0,46.0,42.0,0
7513,92:69:1D:31:68:E9,3831147,486305556,3775,3583019,3827372,482722537,0,4283,1050207,4161,1022772,122,27435,2018,7,3921,80,0,38,216660.0,130000.0,-52.0,-50.0,-45.0,-46.0,-51.0,-50.0,-44.0,-47.0,-90.0,-92.0,-90.0,-93.0,38.0,42.0,45.0,47.0,0
7514,CC:2F:71:3F:1F:24,4483350,1190009924,655978,707287387,3827372,482722537,37,534262,566233471,533613,566155413,649,78058,516578,10,656215,68120,34,456,130000.0,43333.0,-67.0,-65.0,-70.0,-68.0,-67.0,-65.0,-70.0,-67.0,-90.0,-92.0,-90.0,-93.0,23.0,27.0,20.0,25.0,0
7515,CC:2F:71:3E:C5:1F,3828162,482819092,790,96555,3827372,482722537,0,3301,277293,2724,208763,577,68530,836,8,1136,18,0,37,130000.0,39000.0,-69.0,-70.0,-67.0,-60.0,-69.0,-70.0,-67.0,-60.0,-90.0,-92.0,-90.0,-93.0,21.0,22.0,23.0,33.0,0
7516,BA:8C:B9:54:50:24,3832120,488875822,4746,6153083,3827374,482722739,0,8461,1657110,8439,1653615,22,3495,2324,14,5137,36,0,53,216660.0,130000.0,-39.0,-36.0,-44.0,-51.0,-41.0,-35.0,-42.0,-47.0,-90.0,-92.0,-90.0,-93.0,51.0,56.0,46.0,42.0,0
7517,92:69:1D:31:68:E9,3831153,486306162,3775,3583019,3827378,482723143,0,4283,1050207,4161,1022772,122,27435,2018,7,3921,80,0,38,216660.0,130000.0,-52.0,-50.0,-45.0,-46.0,-51.0,-50.0,-44.0,-47.0,-90.0,-92.0,-90.0,-93.0,38.0,42.0,45.0,47.0,0
7518,CC:2F:71:3F:1F:24,4483399,1190025082,656021,707301939,3827378,482723143,37,534287,566238275,533638,566160217,649,78058,516603,10,656258,68145,34,456,144444.0,39000.0,-67.0,-65.0,-70.0,-68.0,-67.0,-65.0,-70.0,-67.0,-90.0,-92.0,-90.0,-93.0,23.0,27.0,20.0,25.0,0
7519,CC:2F:71:3E:C5:1F,3828169,482819824,790,96555,3827379,482723269,0,3301,277293,2724,208763,577,68530,836,8,1136,18,0,37,130000.0,39000.0,-69.0,-70.0,-67.0,-60.0,-69.0,-70.0,-67.0,-60.0,-90.0,-92.0,-90.0,-93.0,21.0,22.0,23.0,33.0,0
7520,BA:8C:B9:54:50:24,3832125,488876352,4746,6153083,3827379,482723269,0,8461,1657110,8439,1653615,22,3495,2324,14,5137,36,0,53,216660.0,130000.0,-39.0,-36.0,-44.0,-51.0,-41.0,-35.0,-42.0,-47.0,-90.0,-92.0,-90.0,-93.0,51.0,56.0,46.0,42.0,0
7521,92:69:1D:31:68:E9,3831157,486306763,3775,3583019,3827382,482723744,0,4283,1050207,4161,1022772,122,27435,2018,7,3921,80,0,38,216660.0,130000.0,-52.0,-50.0,-45.0,-46.0,-51.0,-50.0,-44.0,-47.0,-90.0,-92.0,-90.0,-92.0,38.0,42.0,45.0,46.0,0
7522,CC:2F:71:3F:1F:24,4483445,1190040105,656063,707316361,3827382,482723744,37,534313,566243195,533664,566165137,649,78058,516629,10,656300,68162,34,456,130000.0,43333.0,-67.0,-65.0,-70.0,-67.0,-67.0,-65.0,-70.0,-67.0,-90.0,-92.0,-90.0,-92.0,23.0,27.0,20.0,25.0,0
7523,CC:2F:71:3E:C5:1F,3828172,482820299,790,96555,3827382,482723744,0,3301,277293,2724,208763,577,68530,836,8,1136,18,0,37,130000.0,39000.0,-69.0,-70.0,-67.0,-60.0,-69.0,-70.0,-67.0,-60.0,-90.0,-92.0,-90.0,-92.0,21.0,22.0,23.0,32.0,0
7524,BA:8C:B9:54:50:24,3832131,488877089,4746,6153083,3827385,482724006,0,8461,1657110,8439,1653615,22,3495,2324,14,5137,36,0,53,216660.0,130000.0,-39.0,-36.0,-44.0,-51.0,-41.0,-35.0,-42.0,-47.0,-90.0,-92.0,-90.0,-92.0,51.0,56.0,46.0,41.0,0
7525,92:69:1D:31:68:E9,3831164,486307429,3775,3583019,3827389,482724410,0,4283,1050207,4161,1022772,122,27435,2018,7,3921,80,0,38,216660.0,130000.0,-52.0,-50.0,-45.0,-46.0,-51.0,-50.0,-44.0,-47.0,-90.0,-92.0,-90.0,-92.0,38.0,42.0,45.0,46.0,0
7526,CC:2F:71:3F:1F:24,4483494,1190055199,656105,707330789,3827389,482724410,37,534340,566248279,533691,566170221,649,78058,516656,10,656342,68191,34,456,144444.0,39000.0,-67.0,-65.0,-70.0,-68.0,-67.0,-65.0,-70.0,-67.0,-90.0,-92.0,-90.0,-92.0,23.0,27.0,20.0,24.0,0
7527,CC:2F:71:3E:C5:1F,3828179,482820965,790,96555,3827389,482724410,0,3301,277293,2724,208763,577,68530,836,8,1136,18,0,37,130000.0,39000.0,-69.0,-70.0,-67.0,-60.0,-69.0,-70.0,-67.0,-60.0,-90.0,-92.0,-90.0,-92.0,21.0,22.0,23.0,32.0,0
7528,BA:8C:B9:54:50:24,3832135,488877493,4746,6153083,3827389,482724410,0,8461,1657110,8439,1653615,22,3495,2324,14,5137,36,0,53,216660.0,130000.0,-39.0,-36.0,-44.0,-51.0,-41.0,-35.0,-42.0,-47.0,-90.0,-92.0,-90.0,-92.0,51.0,56.0,46.0,41.0,0
7529,92:69:1D:31:68:E9,3831166,486307631,3775,3583019,3827391,482724612,0,4283,1050207,4161,1022772,122,27435,2018,7,3921,80,0,38,216660.0,130000.0,-52.0,-50.0,-45.0,-46.0,-51.0,-50.0,-44.0,-47.0,-90.0,-92.0,-90.0,-92.0,38.0,42.0,45.0,46.0,0
7530,CC:2F:71:3F:1F:24,4483539,1190069959,656148,707345347,3827391,482724612,37,534365,566253083,533716,566175025,649,78058,516681,10,656385,68208,34,456,130000.0,43333.0,-67.0,-65.0,-70.0,-68.0,-67.0,-65.0,-70.0,-67.0,-90.0,-92.0,-90.0,-92.0,23.0,27.0,20.0,24.0,0
7531,CC:2F:71:3E:C5:1F,3828181,482821167,790,96555,3827391,482724612,0,3301,277293,2724,208763,577,68530,836,8,1136,18,0,37,130000.0,39000.0,-69.0,-70.0,-67.0,-60.0,-69.0,-70.0,-67.0,-60.0,-90.0,-92.0,-90.0,-92.0,21.0,22.0,23.0,32.0,0
7532,BA:8C:B9:54:50:24,3832139,488877897,4746,6153083,3827393,482724814,0,8461,1657110,8439,1653615,22,3495,2324,14,5137,36,0,53,216660.0,130000.0,-39.0,-36.0,-44.0,-51.0,-41.0,-35.0,-42.0,-47.0,-90.0,-92.0,-90.0,-92.0,51.0,56.0,46.0,41.0,0
7533,92:69:1D:31:68:E9,3831173,486308297,3775,3583019,3827398,482725278,0,4283,1050207,4161,1022772,122,27435,2018,7,3921,80,0,38,216660.0,130000.0,-52.0,-50.0,-45.0,-46.0,-51.0,-50.0,-44.0,-47.0,-90.0,-92.0,-90.0,-92.0,38.0,42.0,45.0,46.0,0
7534,CC:2F:71:3F:1F:24,4483589,1190085295,656191,707360017,3827398,482725278,37,534392,566258143,533743,566180085,649,78058,516708,10,656428,68214,34,456,130000.0,43333.0,-67.0,-65.0,-70.0,-68.0,-67.0,-65.0,-70.0,-67.0,-90.0,-92.0,-90.0,-92.0,23.0,27.0,20.0,24.0,0
7535,CC:2F:71:3E:C5:1F,3828188,482821833,790,96555,3827398,482725278,0,3301,277293,2724,208763,577,68530,836,8,1136,18,0,37,130000.0,39000.0,-69.0,-70.0,-67.0,-60.0,-69.0,-70.0,-67.0,-60.0,-90.0,-92.0,-90.0,-92.0,21.0,22.0,23.0,32.0,0
7536,BA:8C:B9:54:50:24,3832144,488878361,4746,6153083,3827398,482725278,0,8461,1657110,8439,1653615,22,3495,2324,14,5137,36,0,53,216660.0,130000.0,-39.0,-36.0,-44.0,-51.0,-41.0,-35.0,-42.0,-47.0,-90.0,-92.0,-90.0,-92.0,51.0,56.0,46.0,41.0,0
7537,92:69:1D:31:68:E9,3831175,486308499,3775,3583019,3827400,482725480,0,4283,1050207,4161,1022772,122,27435,2018,7,3921,80,0,38,216660.0,130000.0,-52.0,-50.0,-45.0,-46.0,-51.0,-50.0,-44.0,-47.0,-90.0,-92.0,-90.0,-92.0,38.0,42.0,45.0,46.0,0
7538,CC:2F:71:3F:1F:24,4483632,1190099831,656232,707374351,3827400,482725480,37,534420,566263307,533771,566185249,649,78058,516736,10,656469,68236,34,456,117000.0,39000.0,-67.0,-65.0,-70.0,-67.0,-67.0,-65.0,-70.0,-67.0,-90.0,-92.0,-90.0,-92.0,23.0,27.0,20.0,25.0,0
7539,CC:2F:71:3E:C5:1F,3828190,482822035,790,96555,3827400,482725480,0,3301,277293,2724,208763,577,68530,836,8,1136,18,0,37,130000.0,39000.0,-69.0,-70.0,-67.0,-60.0,-69.0,-70.0,-67.0,-60.0,-90.0,-92.0,-90.0,-92.0,21.0,22.0,23.0,32.0,0
7540,BA:8C:B9:54:50:24,3832148,488878765,4746,6153083,3827402,482725682,0,8461,1657110,8439,1653615,22,3495,2324,14,5137,36,0,53,216660.0,130000.0,-39.0,-36.0,-44.0,-51.0,-41.0,-35.0,-42.0,-47.0,-90.0,-92.0,-90.0,-92.0,51.0,56.0,46.0,41.0,0
7541,92:69:1D:31:68:E9,3831181,486309105,3775,3583019,3827406,482726086,0,4283,1050207,4161,1022772,122,27435,2018,7,3921,80,0,38,216660.0,130000.0,-52.0,-50.0,-45.0,-46.0,-51.0,-50.0,-44.0,-47.0,-90.0,-93.0,-90.0,-93.0,38.0,43.0,45.0,47.0,0
7542,CC:2F:71:3F:1F:24,4483680,1190114865,656274,707388779,3827406,482726086,37,534446,566268251,533797,566190193,649,78058,516762,10,656511,68241,34,456,130000.0,43333.0,-67.0,-65.0,-70.0,-68.0,-67.0,-65.0,-70.0,-67.0,-90.0,-93.0,-90.0,-93.0,23.0,28.0,20.0,25.0,0
7543,CC:2F:71:3E:C5:1F,3828196,482822641,790,96555,3827406,482726086,0,3301,277293,2724,208763,577,68530,836,8,1136,18,0,37,130000.0,39000.0,-69.0,-70.0,-67.0,-60.0,-69.0,-70.0,-67.0,-60.0,-90.0,-93.0,-90.0,-93.0,21.0,23.0,23.0,33.0,0
7544,BA:8C:B9:54:50:24,3832152,488879169,4746,6153083,3827406,482726086,0,8461,1657110,8439,1653615,22,3495,2324,14,5137,36,0,53,216660.0,130000.0,-39.0,-36.0,-44.0,-51.0,-41.0,-35.0,-42.0,-47.0,-90.0,-93.0,-90.0,-93.0,51.0,57.0,46.0,42.0,0
7545,92:69:1D:31:68:E9,3831184,486309367,3775,3583019,3827409,482726348,0,4283,1050207,4161,1022772,122,27435,2018,7,3921,80,0,38,216660.0,130000.0,-52.0,-50.0,-45.0,-46.0,-51.0,-50.0,-44.0,-47.0,-90.0,-93.0,-90.0,-93.0,38.0,43.0,45.0,47.0,0
7546,CC:2F:71:3F:1F:24,4483726,1190129691,656317,707403343,3827409,482726348,37,534471,566273055,533822,566194997,649,78058,516787,10,656554,68265,34,456,144444.0,39000.0,-67.0,-65.0,-70.0,-67.0,-67.0,-65.0,-70.0,-67.0,-90.0,-93.0,-90.0,-93.0,23.0,28.0,20.0,26.0,0
7547,CC:2F:71:3E:C5:1F,3828201,482823105,790,96555,3827411,482726550,0,3301,277293,2724,208763,577,68530,836,8,1136,18,0,37,130000.0,39000.0,-69.0,-70.0,-67.0,-60.0,-69.0,-70.0,-67.0,-60.0,-90.0,-93.0,-90.0,-93.0,21.0,23.0,23.0,33.0,0
7548,BA:8C:B9:54:50:24,3832157,488879633,4746,6153083,3827411,482726550,0,8461,1657110,8439,1653615,22,3495,2324,14,5137,36,0,53,216660.0,130000.0,-39.0,-36.0,-44.0,-51.0,-41.0,-35.0,-42.0,-47.0,-90.0,-93.0,-90.0,-93.0,51.0,57.0,46.0,42.0,0
7549,92:69:1D:31:68:E9,3831190,486309973,3775,3583019,3827415,482726954,0,4283,1050207,4161,1022772,122,27435,2018,7,3921,80,0,38,216660.0,130000.0,-52.0,-50.0,-45.0,-46.0,-51.0,-50.0,-44.0,-47.0,-90.0,-93.0,-90.0,-93.0,38.0,43.0,45.0,47.0,0
7550,CC:2F:71:3F:1F:24,4483773,1190144601,656358,707417647,3827415,482726954,37,534496,566277859,533847,566199801,649,78058,516812,10,656595,68284,34,456,130000.0,43333.0,-67.0,-65.0,-70.0,-67.0,-67.0,-65.0,-70.0,-67.0,-90.0,-93.0,-90.0,-93.0,23.0,28.0,20.0,26.0,0
7551,CC:2F:71:3E:C5:1F,3828205,482823509,790,96555,3827415,482726954,0,3301,277293,2724,208763,577,68530,836,8,1136,18,0,37,130000.0,39000.0,-69.0,-70.0,-67.0,-60.0,-69.0,-70.0,-67.0,-60.0,-90.0,-93.0,-90.0,-93.0,21.0,23.0,23.0,33.0,0
7552,BA:8C:B9:54:50:24,3832161,488880037,4746,6153083,3827415,482726954,0,8461,1657110,8439,1653615,22,3495,2324,14,5137,36,0,53,216660.0,130000.0,-39.0,-36.0,-44.0,-51.0,-41.0,-35.0,-42.0,-47.0,-90.0,-93.0,-90.0,-93.0,51.0,57.0,46.0,42.0,0
7553,92:69:1D:31:68:E9,3831190,486309973,3775,3583019,3827415,482726954,0,4284,1050275,4162,1022840,122,27435,2018,7,3921,80,0,38,216660.0,130000.0,-52.0,-50.0,-44.0,-46.0,-51.0,-50.0,-44.0,-47.0,-90.0,-92.0,-90.0,-92.0,38.0,42.0,46.0,46.0,0
7554,CC:2F:71:3F:1F:24,4483818,1190159467,656401,707432311,3827417,482727156,37,534525,566283193,533876,566205135,649,78058,516841,10,656638,68289,34,456,130000.0,43333.0,-67.0,-65.0,-70.0,-67.0,-67.0,-65.0,-70.0,-67.0,-90.0,-92.0,-90.0,-92.0,23.0,27.0,20.0,25.0,0
7555,CC:2F:71:3E:C5:1F,3828210,482823973,790,96555,3827420,482727418,0,3301,277293,2724,208763,577,68530,836,8,1136,18,0,37,130000.0,39000.0,-69.0,-70.0,-67.0,-60.0,-69.0,-70.0,-67.0,-60.0,-90.0,-92.0,-90.0,-92.0,21.0,22.0,23.0,32.0,0
7556,BA:8C:B9:54:50:24,3832166,488880501,4746,6153083,3827420,482727418,0,8461,1657110,8439,1653615,22,3495,2324,14,5137,36,0,53,216660.0,130000.0,-39.0,-36.0,-44.0,-51.0,-41.0,-35.0,-42.0,-47.0,-90.0,-92.0,-90.0,-92.0,51.0,56.0,46.0,41.0,0
7557,92:69:1D:31:68:E9,3831199,486310841,3775,3583019,3827424,482727822,0,4284,1050275,4162,1022840,122,27435,2018,7,3921,80,0,38,216660.0,130000.0,-52.0,-50.0,-44.0,-46.0,-51.0,-50.0,-44.0,-47.0,-90.0,-92.0,-90.0,-92.0,38.0,42.0,46.0,46.0,0
7558,CC:2F:71:3F:1F:24,4483868,1190174747,656444,707446925,3827424,482727822,37,534552,566288289,533903,566210231,649,78058,516868,10,656681,68309,34,456,130000.0,39000.0,-67.0,-65.0,-71.0,-68.0,-67.0,-65.0,-70.0,-67.0,-90.0,-92.0,-90.0,-92.0,23.0,27.0,19.0,24.0,0
7559,CC:2F:71:3E:C5:1F,3828214,482824377,790,96555,3827424,482727822,0,3301,277293,2724,208763,577,68530,836,8,1136,18,0,37,130000.0,39000.0,-69.0,-70.0,-67.0,-60.0,-69.0,-70.0,-67.0,-60.0,-90.0,-92.0,-90.0,-92.0,21.0,22.0,23.0,32.0,0
7560,BA:8C:B9:54:50:24,3832170,488880905,4746,6153083,3827424,482727822,0,8461,1657110,8439,1653615,22,3495,2324,14,5137,36,0,53,216660.0,130000.0,-39.0,-36.0,-44.0,-51.0,-41.0,-35.0,-42.0,-47.0,-90.0,-92.0,-90.0,-92.0,51.0,56.0,46.0,41.0,0
7561,92:69:1D:31:68:E9,3831200,486310909,3775,3583019,3827425,482727890,0,4284,1050275,4162,1022840,122,27435,2018,7,3921,80,0,38,216660.0,130000.0,-52.0,-50.0,-44.0,-46.0,-51.0,-50.0,-44.0,-47.0,-90.0,-92.0,-90.0,-92.0,38.0,42.0,46.0,46.0,0
7562,CC:2F:71:3F:1F:24,4483912,1190189321,656486,707461297,3827426,482728024,37,534577,566293093,533928,566215035,649,78058,516893,10,656723,68318,34,456,130000.0,43333.0,-73.0,-72.0,-77.0,-74.0,-72.0,-70.0,-75.0,-72.0,-90.0,-92.0,-90.0,-92.0,17.0,20.0,13.0,18.0,0
7563,CC:2F:71:3E:C5:1F,3828218,482824781,790,96555,3827428,482728226,0,3301,277293,2724,208763,577,68530,836,8,1136,18,0,37,130000.0,39000.0,-69.0,-70.0,-67.0,-60.0,-69.0,-70.0,-67.0,-60.0,-91.0,-93.0,-90.0,-93.0,22.0,23.0,23.0,33.0,0
7564,BA:8C:B9:54:50:24,3832174,488881309,4746,6153083,3827428,482728226,0,8461,1657110,8439,1653615,22,3495,2324,14,5137,36,0,53,216660.0,130000.0,-39.0,-36.0,-44.0,-51.0,-41.0,-35.0,-42.0,-47.0,-91.0,-93.0,-90.0,-93.0,52.0,57.0,46.0,42.0,0
7565,92:69:1D:31:68:E9,3831208,486311709,3775,3583019,3827433,482728690,0,4284,1050275,4162,1022840,122,27435,2018,7,3921,80,0,38,216660.0,130000.0,-52.0,-50.0,-44.0,-46.0,-51.0,-50.0,-44.0,-47.0,-91.0,-93.0,-90.0,-93.0,39.0,43.0,46.0,47.0,0
7566,CC:2F:71:3F:1F:24,4483961,1190204471,656528,707475781,3827433,482728690,37,534604,566298189,533955,566220131,649,78058,516920,10,656765,68337,34,456,130000.0,39000.0,-68.0,-66.0,-71.0,-68.0,-70.0,-68.0,-73.0,-71.0,-91.0,-93.0,-90.0,-93.0,23.0,27.0,19.0,25.0,0
7567,CC:2F:71:3E:C5:1F,3828223,482825245,790,96555,3827433,482728690,0,3301,277293,2724,208763,577,68530,836,8,1136,18,0,37,130000.0,39000.0,-69.0,-70.0,-67.0,-60.0,-69.0,-70.0,-67.0,-60.0,-91.0,-93.0,-90.0,-93.0,22.0,23.0,23.0,33.0,0
7568,BA:8C:B9:54:50:24,3832179,488881773,4746,6153083,3827433,482728690,0,8461,1657110,8439,1653615,22,3495,2324,14,5137,36,0,53,216660.0,130000.0,-39.0,-36.0,-44.0,-51.0,-41.0,-35.0,-42.0,-47.0,-91.0,-93.0,-90.0,-93.0,52.0,57.0,46.0,42.0,0
7569,92:69:1D:31:68:E9,3831209,486311825,3776,3583135,3827433,482728690,0,4286,1050411,4164,1022976,122,27435,2018,7,3922,80,0,39,216660.0,130000.0,-52.0,-50.0,-45.0,-46.0,-51.0,-50.0,-44.0,-46.0,-91.0,-93.0,-90.0,-93.0,39.0,43.0,45.0,47.0,0
7570,CC:2F:71:3F:1F:24,4484009,1190219667,656574,707490775,3827435,482728892,37,534633,566303573,533984,566225515,649,78058,516949,10,656811,68366,34,456,130000.0,43333.0,-68.0,-66.0,-71.0,-68.0,-68.0,-66.0,-71.0,-68.0,-91.0,-93.0,-90.0,-93.0,23.0,27.0,19.0,25.0,0
7571,CC:2F:71:3E:C5:1F,3828228,482825765,791,96671,3827437,482729094,0,3303,277433,2726,208903,577,68530,836,8,1137,18,0,37,130000.0,39000.0,-70.0,-71.0,-67.0,-60.0,-69.0,-70.0,-67.0,-60.0,-91.0,-93.0,-90.0,-93.0,21.0,22.0,23.0,33.0,0
7572,BA:8C:B9:54:50:24,3832184,488882293,4747,6153199,3827437,482729094,0,8463,1657246,8441,1653751,22,3495,2324,14,5138,36,0,53,216660.0,130000.0,-39.0,-36.0,-45.0,-51.0,-42.0,-34.0,-42.0,-46.0,-91.0,-93.0,-90.0,-93.0,52.0,57.0,45.0,42.0,0
7573,92:69:1D:31:68:E9,3831218,486312906,3776,3583135,3827442,482729771,0,4286,1050411,4164,1022976,122,27435,2018,7,3922,80,0,39,216660.0,130000.0,-52.0,-50.0,-45.0,-46.0,-51.0,-50.0,-44.0,-46.0,-90.0,-93.0,-90.0,-93.0,38.0,43.0,45.0,47.0,0
7574,CC:2F:71:3F:1F:24,4484056,1190234726,656614,707504955,3827442,482729771,37,534658,566308377,534009,566230319,649,78058,516974,10,656851,68395,34,456,117000.0,39000.0,-71.0,-69.0,-74.0,-71.0,-70.0,-68.0,-73.0,-70.0,-90.0,-93.0,-90.0,-93.0,19.0,24.0,16.0,22.0,0
7575,CC:2F:71:3E:C5:1F,3828233,482826442,791,96671,3827442,482729771,0,3303,277433,2726,208903,577,68530,836,8,1137,18,0,37,130000.0,39000.0,-70.0,-71.0,-67.0,-60.0,-69.0,-70.0,-67.0,-60.0,-90.0,-93.0,-90.0,-93.0,20.0,22.0,23.0,33.0,0
7576,BA:8C:B9:54:50:24,3832189,488882970,4747,6153199,3827442,482729771,0,8463,1657246,8441,1653751,22,3495,2324,14,5138,36,0,53,216660.0,130000.0,-39.0,-36.0,-45.0,-51.0,-42.0,-34.0,-42.0,-46.0,-90.0,-93.0,-90.0,-93.0,51.0,57.0,45.0,42.0,0
7577,92:69:1D:31:68:E9,3831219,486312966,3776,3583135,3827443,482729831,0,4286,1050411,4164,1022976,122,27435,2018,7,3922,80,0,39,216660.0,130000.0,-52.0,-50.0,-45.0,-46.0,-51.0,-50.0,-44.0,-46.0,-90.0,-93.0,-90.0,-93.0,38.0,43.0,45.0,47.0,0
7578,CC:2F:71:3F:1F:24,4484100,1190249338,656657,707519507,3827443,482729831,37,534686,566313529,534037,566235471,649,78058,517002,10,656894,68401,34,456,130000.0,43333.0,-71.0,-69.0,-74.0,-71.0,-70.0,-69.0,-74.0,-71.0,-90.0,-93.0,-89.0,-93.0,19.0,24.0,15.0,22.0,0
7579,CC:2F:71:3E:C5:1F,3828238,482826906,791,96671,3827447,482730235,0,3303,277433,2726,208903,577,68530,836,8,1137,18,0,37,130000.0,39000.0,-70.0,-71.0,-67.0,-60.0,-69.0,-70.0,-67.0,-60.0,-90.0,-93.0,-89.0,-93.0,20.0,22.0,22.0,33.0,0
7580,BA:8C:B9:54:50:24,3832194,488883434,4747,6153199,3827447,482730235,0,8463,1657246,8441,1653751,22,3495,2324,14,5138,36,0,53,216660.0,130000.0,-39.0,-36.0,-45.0,-51.0,-42.0,-34.0,-42.0,-46.0,-90.0,-93.0,-89.0,-93.0,51.0,57.0,44.0,42.0,0
7581,92:69:1D:31:68:E9,3831227,486313774,3776,3583135,3827451,482730639,0,4286,1050411,4164,1022976,122,27435,2018,7,3922,80,0,39,216660.0,130000.0,-52.0,-50.0,-45.0,-46.0,-51.0,-50.0,-44.0,-46.0,-90.0,-93.0,-89.0,-93.0,38.0,43.0,44.0,47.0,0
7582,CC:2F:71:3F:1F:24,4484152,1190264940,656701,707534301,3827451,482730639,37,534713,566318589,534064,566240531,649,78058,517029,10,656938,68406,34,456,130000.0,43333.0,-71.0,-69.0,-74.0,-71.0,-70.0,-68.0,-73.0,-70.0,-90.0,-93.0,-89.0,-93.0,19.0,24.0,15.0,22.0,0
7583,CC:2F:71:3E:C5:1F,3828242,482827310,791,96671,3827451,482730639,0,3303,277433,2726,208903,577,68530,836,8,1137,18,0,37,130000.0,39000.0,-70.0,-71.0,-67.0,-60.0,-69.0,-70.0,-67.0,-60.0,-90.0,-93.0,-89.0,-93.0,20.0,22.0,22.0,33.0,0
7584,BA:8C:B9:54:50:24,3832198,488883838,4747,6153199,3827451,482730639,0,8463,1657246,8441,1653751,22,3495,2324,14,5138,36,0,53,216660.0,130000.0,-39.0,-36.0,-45.0,-51.0,-42.0,-34.0,-42.0,-46.0,-90.0,-93.0,-89.0,-93.0,51.0,57.0,44.0,42.0,0
7585,92:69:1D:31:68:E9,3831228,486313834,3776,3583135,3827452,482730699,0,4286,1050411,4164,1022976,122,27435,2018,7,3922,80,0,39,216660.0,130000.0,-52.0,-50.0,-45.0,-46.0,-51.0,-50.0,-44.0,-46.0,-90.0,-93.0,-89.0,-93.0,38.0,43.0,44.0,47.0,0
7586,CC:2F:71:3F:1F:24,4484198,1190279920,656744,707548853,3827454,482731067,37,534740,566323649,534091,566245591,649,78058,517056,10,656981,68434,34,456,117000.0,39000.0,-70.0,-68.0,-73.0,-70.0,-70.0,-68.0,-73.0,-70.0,-90.0,-93.0,-89.0,-93.0,20.0,25.0,16.0,23.0,0
7587,CC:2F:71:3E:C5:1F,3828247,482827940,791,96671,3827456,482731269,0,3303,277433,2726,208903,577,68530,836,8,1137,18,0,37,130000.0,39000.0,-70.0,-71.0,-67.0,-60.0,-69.0,-70.0,-67.0,-60.0,-90.0,-93.0,-89.0,-93.0,20.0,22.0,22.0,33.0,0
7588,BA:8C:B9:54:50:24,3832205,488884670,4747,6153199,3827458,482731471,0,8463,1657246,8441,1653751,22,3495,2324,14,5138,36,0,53,216660.0,130000.0,-39.0,-36.0,-45.0,-51.0,-42.0,-34.0,-42.0,-46.0,-90.0,-93.0,-89.0,-93.0,51.0,57.0,44.0,42.0,0
7589,92:69:1D:31:68:E9,3831238,486315010,3776,3583135,3827462,482731875,0,4286,1050411,4164,1022976,122,27435,2018,7,3922,80,0,39,216660.0,130000.0,-52.0,-50.0,-45.0,-46.0,-51.0,-50.0,-44.0,-46.0,-90.0,-93.0,-89.0,-93.0,38.0,43.0,44.0,47.0,0
7590,CC:2F:71:3F:1F:24,4484248,1190295156,656786,707563281,3827462,482731875,37,534767,566328709,534118,566250651,649,78058,517083,10,657023,68445,34,456,130000.0,43333.0,-76.0,-74.0,-79.0,-77.0,-71.0,-69.0,-75.0,-72.0,-90.0,-93.0,-89.0,-93.0,14.0,19.0,10.0,16.0,0
7591,CC:2F:71:3E:C5:1F,3828253,482828546,791,96671,3827462,482731875,0,3303,277433,2726,208903,577,68530,836,8,1137,18,0,37,130000.0,39000.0,-70.0,-71.0,-67.0,-60.0,-69.0,-70.0,-67.0,-60.0,-90.0,-93.0,-89.0,-93.0,20.0,22.0,22.0,33.0,0
7592,BA:8C:B9:54:50:24,3832209,488885074,4747,6153199,3827462,482731875,0,8463,1657246,8441,1653751,22,3495,2324,14,5138,36,0,53,216660.0,130000.0,-39.0,-36.0,-45.0,-51.0,-42.0,-34.0,-42.0,-46.0,-90.0,-93.0,-89.0,-93.0,51.0,57.0,44.0,42.0,0
7593,92:69:1D:31:68:E9,3831240,486315134,3776,3583135,3827464,482731999,0,4286,1050411,4164,1022976,122,27435,2018,7,3922,80,0,39,216660.0,130000.0,-52.0,-50.0,-45.0,-46.0,-51.0,-50.0,-44.0,-46.0,-90.0,-93.0,-89.0,-93.0,38.0,43.0,44.0,47.0,0
7594,CC:2F:71:3F:1F:24,4484294,1190309966,656828,707577765,3827466,482732201,37,534795,566333887,534145,566255711,650,78176,517111,10,657065,68461,34,456,130000.0,39000.0,-67.0,-65.0,-71.0,-68.0,-67.0,-65.0,-71.0,-68.0,-90.0,-93.0,-89.0,-93.0,23.0,28.0,18.0,25.0,0
7595,CC:2F:71:3E:C5:1F,3828257,482828872,791,96671,3827466,482732201,0,3305,277621,2727,208973,578,68648,837,8,1137,18,0,37,130000.0,39000.0,-70.0,-71.0,-67.0,-60.0,-69.0,-70.0,-67.0,-60.0,-90.0,-93.0,-89.0,-93.0,20.0,22.0,22.0,33.0,0
7596,BA:8C:B9:54:50:24,3832213,488885400,4747,6153199,3827466,482732201,0,8465,1657382,8443,1653887,22,3495,2324,14,5139,36,0,53,216660.0,130000.0,-39.0,-36.0,-45.0,-52.0,-41.0,-35.0,-42.0,-47.0,-90.0,-93.0,-89.0,-93.0,51.0,57.0,44.0,41.0,0
7597,92:69:1D:31:68:E9,3831247,486315800,3776,3583135,3827471,482732665,0,4288,1050547,4166,1023112,122,27435,2018,7,3923,80,0,39,216660.0,130000.0,-52.0,-51.0,-44.0,-46.0,-52.0,-50.0,-44.0,-46.0,-90.0,-93.0,-89.0,-93.0,38.0,42.0,45.0,47.0,0
7598,CC:2F:71:3F:1F:24,4484341,1190324802,656870,707592137,3827471,482732665,37,534820,566338691,534170,566260515,650,78176,517136,10,657107,68501,34,456,130000.0,43333.0,-67.0,-65.0,-70.0,-68.0,-67.0,-65.0,-70.0,-68.0,-90.0,-93.0,-89.0,-93.0,23.0,28.0,19.0,25.0,0
7599,CC:2F:71:3E:C5:1F,3828264,482829538,791,96671,3827473,482732867,0,3305,277621,2727,208973,578,68648,837,8,1137,18,0,37,130000.0,39000.0,-70.0,-71.0,-67.0,-60.0,-69.0,-70.0,-67.0,-60.0,-90.0,-93.0,-89.0,-93.0,20.0,22.0,22.0,33.0,0
7600,BA:8C:B9:54:50:24,3832220,488886066,4747,6153199,3827473,482732867,0,8465,1657382,8443,1653887,22,3495,2324,14,5139,36,0,53,216660.0,130000.0,-39.0,-36.0,-45.0,-52.0,-41.0,-35.0,-42.0,-47.0,-90.0,-93.0,-89.0,-93.0,51.0,57.0,44.0,41.0,0
7601,92:69:1D:31:68:E9,3831249,486316002,3776,3583135,3827473,482732867,0,4288,1050547,4166,1023112,122,27435,2018,7,3923,80,0,39,216660.0,130000.0,-52.0,-51.0,-44.0,-46.0,-52.0,-50.0,-44.0,-46.0,-90.0,-93.0,-89.0,-93.0,38.0,42.0,45.0,47.0,0
7602,CC:2F:71:3F:1F:24,4484388,1190339876,656913,707606807,3827475,482733069,37,534846,566343625,534196,566265449,650,78176,517161,10,657150,68508,34,456,130000.0,43333.0,-67.0,-65.0,-71.0,-68.0,-67.0,-65.0,-70.0,-68.0,-90.0,-93.0,-89.0,-93.0,23.0,28.0,18.0,25.0,0
7603,CC:2F:71:3E:C5:1F,3828266,482829740,791,96671,3827475,482733069,0,3305,277621,2727,208973,578,68648,837,8,1137,18,0,37,130000.0,39000.0,-70.0,-71.0,-67.0,-60.0,-69.0,-70.0,-67.0,-60.0,-90.0,-93.0,-89.0,-93.0,20.0,22.0,22.0,33.0,0
7604,BA:8C:B9:54:50:24,3832222,488886268,4747,6153199,3827475,482733069,0,8470,1657722,8448,1654227,22,3495,2324,14,5139,36,0,53,216660.0,130000.0,-39.0,-36.0,-45.0,-52.0,-41.0,-35.0,-44.0,-49.0,-90.0,-93.0,-89.0,-93.0,51.0,57.0,44.0,41.0,0
7605,92:69:1D:31:68:E9,3831255,486316608,3776,3583135,3827479,482733473,0,4288,1050547,4166,1023112,122,27435,2018,7,3923,80,0,39,216660.0,130000.0,-52.0,-51.0,-44.0,-46.0,-52.0,-50.0,-44.0,-46.0,-90.0,-93.0,-89.0,-93.0,38.0,42.0,45.0,47.0,0
7606,CC:2F:71:3F:1F:24,4484434,1190354708,656955,707621235,3827479,482733473,37,534872,566348569,534222,566270393,650,78176,517187,10,657192,68525,34,456,117000.0,39000.0,-67.0,-65.0,-70.0,-68.0,-67.0,-65.0,-70.0,-68.0,-90.0,-93.0,-89.0,-93.0,23.0,28.0,19.0,25.0,0
7607,CC:2F:71:3E:C5:1F,3828270,482830144,791,96671,3827479,482733473,0,3305,277621,2727,208973,578,68648,837,8,1137,18,0,37,130000.0,39000.0,-70.0,-71.0,-67.0,-60.0,-69.0,-70.0,-67.0,-60.0,-90.0,-93.0,-89.0,-93.0,20.0,22.0,22.0,33.0,0
7608,BA:8C:B9:54:50:24,3832228,488886874,4747,6153199,3827481,482733675,0,8470,1657722,8448,1654227,22,3495,2324,14,5139,36,0,53,216660.0,130000.0,-39.0,-36.0,-45.0,-52.0,-41.0,-35.0,-44.0,-49.0,-90.0,-93.0,-89.0,-93.0,51.0,57.0,44.0,41.0,0
7609,92:69:1D:31:68:E9,3831258,486316870,3776,3583135,3827482,482733735,0,4288,1050547,4166,1023112,122,27435,2018,7,3923,80,0,39,216660.0,130000.0,-52.0,-51.0,-44.0,-46.0,-52.0,-50.0,-44.0,-46.0,-90.0,-93.0,-89.0,-93.0,38.0,42.0,45.0,47.0,0
7610,CC:2F:71:3F:1F:24,4484480,1190369470,656996,707635533,3827484,482733937,37,534900,566353769,534250,566275593,650,78176,517215,10,657232,68528,34,456,130000.0,43333.0,-67.0,-65.0,-71.0,-68.0,-67.0,-65.0,-70.0,-68.0,-90.0,-93.0,-89.0,-93.0,23.0,28.0,18.0,25.0,0
7611,CC:2F:71:3E:C5:1F,3828275,482830608,791,96671,3827484,482733937,0,3305,277621,2727,208973,578,68648,837,8,1137,18,0,37,130000.0,39000.0,-70.0,-71.0,-67.0,-60.0,-69.0,-70.0,-67.0,-60.0,-90.0,-93.0,-89.0,-93.0,20.0,22.0,22.0,33.0,0
7612,BA:8C:B9:54:50:24,3832231,488887136,4747,6153199,3827484,482733937,0,8470,1657722,8448,1654227,22,3495,2324,14,5139,36,0,53,216660.0,130000.0,-39.0,-36.0,-45.0,-52.0,-41.0,-35.0,-44.0,-49.0,-90.0,-93.0,-89.0,-93.0,51.0,57.0,44.0,41.0,0
7613,92:69:1D:31:68:E9,3831264,486317476,3776,3583135,3827488,482734341,0,4288,1050547,4166,1023112,122,27435,2018,7,3923,80,0,39,216660.0,130000.0,-52.0,-51.0,-44.0,-46.0,-52.0,-50.0,-44.0,-46.0,-90.0,-93.0,-89.0,-93.0,38.0,42.0,45.0,47.0,0
7614,CC:2F:71:3F:1F:24,4484526,1190384358,657038,707650017,3827488,482734341,37,534926,566358713,534276,566280537,650,78176,517241,10,657275,68533,34,456,130000.0,39000.0,-68.0,-66.0,-71.0,-68.0,-67.0,-65.0,-70.0,-67.0,-90.0,-93.0,-89.0,-93.0,22.0,27.0,18.0,25.0,0
7615,CC:2F:71:3E:C5:1F,3828279,482831012,791,96671,3827488,482734341,0,3305,277621,2727,208973,578,68648,837,8,1137,18,0,37,130000.0,39000.0,-70.0,-71.0,-67.0,-60.0,-69.0,-70.0,-67.0,-60.0,-90.0,-93.0,-89.0,-93.0,20.0,22.0,22.0,33.0,0
7616,BA:8C:B9:54:50:24,3832237,488887742,4747,6153199,3827490,482734543,0,8470,1657722,8448,1654227,22,3495,2324,14,5139,36,0,53,216660.0,130000.0,-39.0,-36.0,-45.0,-52.0,-41.0,-35.0,-44.0,-49.0,-90.0,-93.0,-89.0,-93.0,51.0,57.0,44.0,41.0,0
7617,92:69:1D:31:68:E9,3831267,486317738,3776,3583135,3827491,482734603,0,4288,1050547,4166,1023112,122,27435,2018,7,3923,80,0,39,216660.0,130000.0,-52.0,-51.0,-44.0,-46.0,-52.0,-50.0,-44.0,-46.0,-90.0,-93.0,-89.0,-93.0,38.0,42.0,45.0,47.0,0
7618,CC:2F:71:3F:1F:24,4484574,1190399318,657081,707664513,3827493,482734805,37,534953,566363773,534303,566285597,650,78176,517268,10,657318,68566,34,456,130000.0,43333.0,-67.0,-65.0,-70.0,-67.0,-67.0,-65.0,-70.0,-67.0,-90.0,-93.0,-89.0,-93.0,23.0,28.0,19.0,26.0,0
7619,CC:2F:71:3E:C5:1F,3828284,482831476,791,96671,3827493,482734805,0,3305,277621,2727,208973,578,68648,837,8,1137,18,0,37,130000.0,39000.0,-70.0,-71.0,-67.0,-60.0,-69.0,-70.0,-67.0,-60.0,-90.0,-93.0,-89.0,-93.0,20.0,22.0,22.0,33.0,0
7620,BA:8C:B9:54:50:24,3832240,488888004,4747,6153199,3827493,482734805,0,8470,1657722,8448,1654227,22,3495,2324,14,5139,36,0,53,216660.0,130000.0,-39.0,-36.0,-45.0,-52.0,-41.0,-35.0,-44.0,-49.0,-90.0,-93.0,-89.0,-93.0,51.0,57.0,44.0,41.0,0
7621,92:69:1D:31:68:E9,3831273,486318344,3776,3583135,3827497,482735209,0,4288,1050547,4166,1023112,122,27435,2018,7,3923,80,0,39,216660.0,130000.0,-52.0,-51.0,-44.0,-46.0,-52.0,-50.0,-44.0,-46.0,-90.0,-93.0,-89.0,-93.0,38.0,42.0,45.0,47.0,0
7622,CC:2F:71:3F:1F:24,4484620,1190414262,657123,707679053,3827497,482735209,37,534979,566368717,534329,566290541,650,78176,517294,10,657360,68578,34,456,130000.0,43333.0,-67.0,-65.0,-70.0,-68.0,-67.0,-65.0,-70.0,-67.0,-90.0,-93.0,-89.0,-93.0,23.0,28.0,19.0,25.0,0
7623,CC:2F:71:3E:C5:1F,3828288,482831880,791,96671,3827497,482735209,0,3305,277621,2727,208973,578,68648,837,8,1137,18,0,37,130000.0,39000.0,-70.0,-71.0,-67.0,-60.0,-69.0,-70.0,-67.0,-60.0,-90.0,-93.0,-89.0,-93.0,20.0,22.0,22.0,33.0,0
7624,BA:8C:B9:54:50:24,3832246,488888610,4747,6153199,3827499,482735411,0,8470,1657722,8448,1654227,22,3495,2324,14,5139,36,0,53,216660.0,130000.0,-39.0,-36.0,-45.0,-52.0,-41.0,-35.0,-44.0,-49.0,-90.0,-93.0,-89.0,-93.0,51.0,57.0,44.0,41.0,0
7625,92:69:1D:31:68:E9,3831275,486318546,3776,3583135,3827499,482735411,0,4288,1050547,4166,1023112,122,27435,2018,7,3923,80,0,39,216660.0,130000.0,-52.0,-51.0,-44.0,-46.0,-52.0,-50.0,-44.0,-46.0,-90.0,-93.0,-89.0,-93.0,38.0,42.0,45.0,47.0,0
7626,CC:2F:71:3F:1F:24,4484667,1190429423,657165,707693537,3827502,482735886,37,535004,566373521,534354,566295345,650,78176,517319,10,657402,68588,34,456,130000.0,39000.0,-67.0,-65.0,-70.0,-67.0,-67.0,-65.0,-70.0,-67.0,-90.0,-93.0,-89.0,-93.0,23.0,28.0,19.0,26.0,0
7627,CC:2F:71:3E:C5:1F,3828293,482832557,791,96671,3827502,482735886,0,3305,277621,2727,208973,578,68648,837,8,1137,18,0,37,130000.0,39000.0,-70.0,-71.0,-67.0,-60.0,-69.0,-70.0,-67.0,-60.0,-90.0,-93.0,-89.0,-93.0,20.0,22.0,22.0,33.0,0
7628,BA:8C:B9:54:50:24,3832249,488889085,4747,6153199,3827502,482735886,0,8470,1657722,8448,1654227,22,3495,2324,14,5139,36,0,53,216660.0,130000.0,-39.0,-36.0,-45.0,-52.0,-41.0,-35.0,-44.0,-49.0,-90.0,-93.0,-89.0,-93.0,51.0,57.0,44.0,41.0,0
7629,92:69:1D:31:68:E9,3831283,486319485,3776,3583135,3827507,482736350,0,4288,1050547,4166,1023112,122,27435,2018,7,3923,80,0,39,216660.0,130000.0,-52.0,-51.0,-44.0,-46.0,-52.0,-50.0,-44.0,-46.0,-90.0,-93.0,-89.0,-93.0,38.0,42.0,45.0,47.0,0
7630,CC:2F:71:3F:1F:24,4484715,1190444439,657208,707708089,3827507,482736350,37,535031,566378557,534381,566300381,650,78176,517346,10,657445,68599,34,456,130000.0,43333.0,-67.0,-65.0,-70.0,-67.0,-67.0,-65.0,-70.0,-67.0,-90.0,-93.0,-89.0,-93.0,23.0,28.0,19.0,26.0,0
7631,CC:2F:71:3E:C5:1F,3828298,482833021,791,96671,3827507,482736350,0,3305,277621,2727,208973,578,68648,837,8,1137,18,0,37,130000.0,39000.0,-70.0,-71.0,-67.0,-60.0,-69.0,-70.0,-67.0,-60.0,-90.0,-93.0,-89.0,-93.0,20.0,22.0,22.0,33.0,0
7632,BA:8C:B9:54:50:24,3832254,488889549,4747,6153199,3827507,482736350,0,8471,1657790,8449,1654295,22,3495,2324,14,5139,36,0,53,216660.0,130000.0,-39.0,-36.0,-45.0,-52.0,-41.0,-35.0,-44.0,-50.0,-90.0,-93.0,-89.0,-93.0,51.0,57.0,44.0,41.0,0
7633,92:69:1D:31:68:E9,3831285,486319687,3776,3583135,3827509,482736552,0,4288,1050547,4166,1023112,122,27435,2018,7,3923,80,0,39,216660.0,130000.0,-52.0,-51.0,-44.0,-46.0,-52.0,-50.0,-44.0,-46.0,-90.0,-93.0,-89.0,-93.0,38.0,42.0,45.0,47.0,0
7634,CC:2F:71:3F:1F:24,4484759,1190459079,657248,707722325,3827511,482736754,37,535057,566383501,534407,566305325,650,78176,517372,10,657485,68606,34,456,130000.0,43333.0,-67.0,-65.0,-70.0,-68.0,-67.0,-65.0,-70.0,-67.0,-90.0,-93.0,-89.0,-93.0,23.0,28.0,19.0,25.0,0
7635,CC:2F:71:3E:C5:1F,3828302,482833425,791,96671,3827511,482736754,0,3305,277621,2727,208973,578,68648,837,8,1137,18,0,37,130000.0,39000.0,-70.0,-71.0,-67.0,-60.0,-69.0,-70.0,-67.0,-60.0,-90.0,-93.0,-89.0,-93.0,20.0,22.0,22.0,33.0,0
7636,BA:8C:B9:54:50:24,3832258,488889953,4747,6153199,3827511,482736754,0,8471,1657790,8449,1654295,22,3495,2324,14,5139,36,0,53,216660.0,130000.0,-39.0,-36.0,-45.0,-52.0,-41.0,-35.0,-44.0,-50.0,-90.0,-93.0,-89.0,-93.0,51.0,57.0,44.0,41.0,0
7637,92:69:1D:31:68:E9,3831291,486320293,3776,3583135,3827515,482737158,0,4288,1050547,4166,1023112,122,27435,2018,7,3923,80,0,39,216660.0,130000.0,-52.0,-51.0,-44.0,-46.0,-52.0,-50.0,-44.0,-46.0,-90.0,-93.0,-89.0,-93.0,38.0,42.0,45.0,47.0,0
7638,CC:2F:71:3F:1F:24,4484805,1190473911,657290,707736753,3827515,482737158,37,535083,566388445,534433,566310269,650,78176,517398,10,657527,68622,34,456,117000.0,39000.0,-67.0,-65.0,-70.0,-68.0,-67.0,-65.0,-70.0,-67.0,-90.0,-93.0,-89.0,-93.0,23.0,28.0,19.0,25.0,0
7639,CC:2F:71:3E:C5:1F,3828306,482833829,791,96671,3827515,482737158,0,3305,277621,2727,208973,578,68648,837,8,1137,18,0,37,130000.0,39000.0,-70.0,-71.0,-67.0,-60.0,-69.0,-70.0,-67.0,-60.0,-90.0,-93.0,-89.0,-93.0,20.0,22.0,22.0,33.0,0
7640,BA:8C:B9:54:50:24,3832263,488890417,4747,6153199,3827516,482737218,0,8471,1657790,8449,1654295,22,3495,2324,14,5139,36,0,53,216660.0,130000.0,-39.0,-36.0,-45.0,-52.0,-41.0,-35.0,-44.0,-50.0,-90.0,-93.0,-89.0,-93.0,51.0,57.0,44.0,41.0,0
7641,92:69:1D:31:68:E9,3831294,486320555,3776,3583135,3827518,482737420,0,4288,1050547,4166,1023112,122,27435,2018,7,3923,80,0,39,216660.0,130000.0,-52.0,-51.0,-44.0,-46.0,-52.0,-50.0,-44.0,-46.0,-90.0,-93.0,-89.0,-93.0,38.0,42.0,45.0,47.0,0
7642,CC:2F:71:3F:1F:24,4484853,1190488927,657333,707751305,3827520,482737622,37,535110,566393481,534460,566315305,650,78176,517425,10,657570,68627,34,456,130000.0,43333.0,-67.0,-65.0,-71.0,-68.0,-67.0,-65.0,-70.0,-67.0,-90.0,-93.0,-89.0,-93.0,23.0,28.0,18.0,25.0,0
7643,CC:2F:71:3E:C5:1F,3828311,482834293,791,96671,3827520,482737622,0,3305,277621,2727,208973,578,68648,837,8,1137,18,0,37,130000.0,39000.0,-70.0,-71.0,-67.0,-60.0,-69.0,-70.0,-67.0,-60.0,-90.0,-93.0,-89.0,-93.0,20.0,22.0,22.0,33.0,0
7644,BA:8C:B9:54:50:24,3832267,488890821,4747,6153199,3827520,482737622,0,8471,1657790,8449,1654295,22,3495,2324,14,5139,36,0,53,216660.0,130000.0,-39.0,-36.0,-45.0,-52.0,-41.0,-35.0,-44.0,-50.0,-90.0,-93.0,-89.0,-93.0,51.0,57.0,44.0,41.0,0
7645,92:69:1D:31:68:E9,3831300,486321161,3776,3583135,3827524,482738026,0,4288,1050547,4166,1023112,122,27435,2018,7,3923,80,0,39,216660.0,130000.0,-52.0,-51.0,-44.0,-46.0,-52.0,-50.0,-44.0,-46.0,-90.0,-93.0,-89.0,-93.0,38.0,42.0,45.0,47.0,0
7646,CC:2F:71:3F:1F:24,4484899,1190503759,657375,707765733,3827524,482738026,37,535135,566398285,534485,566320109,650,78176,517450,10,657612,68655,34,456,144444.0,39000.0,-67.0,-65.0,-70.0,-68.0,-67.0,-65.0,-70.0,-67.0,-90.0,-93.0,-89.0,-93.0,23.0,28.0,19.0,25.0,0
7647,CC:2F:71:3E:C5:1F,3828315,482834697,791,96671,3827524,482738026,0,3305,277621,2727,208973,578,68648,837,8,1137,18,0,37,130000.0,39000.0,-70.0,-71.0,-67.0,-60.0,-69.0,-70.0,-67.0,-60.0,-90.0,-93.0,-89.0,-93.0,20.0,22.0,22.0,33.0,0
7648,BA:8C:B9:54:50:24,3832271,488891225,4747,6153199,3827524,482738026,0,8471,1657790,8449,1654295,22,3495,2324,14,5139,36,0,53,216660.0,130000.0,-39.0,-36.0,-45.0,-52.0,-41.0,-35.0,-44.0,-50.0,-90.0,-93.0,-89.0,-93.0,51.0,57.0,44.0,41.0,0
7649,92:69:1D:31:68:E9,3831305,486321625,3776,3583135,3827529,482738490,0,4288,1050547,4166,1023112,122,27435,2018,7,3923,80,0,39,216660.0,130000.0,-52.0,-51.0,-44.0,-46.0,-52.0,-50.0,-44.0,-46.0,-90.0,-93.0,-89.0,-93.0,38.0,42.0,45.0,47.0,0
7650,CC:2F:71:3F:1F:24,4484946,1190518651,657417,707780161,3827529,482738490,37,535162,566403345,534512,566325169,650,78176,517477,10,657654,68664,34,456,130000.0,43333.0,-67.0,-65.0,-70.0,-68.0,-67.0,-65.0,-70.0,-67.0,-90.0,-93.0,-89.0,-93.0,23.0,28.0,19.0,25.0,0
7651,CC:2F:71:3E:C5:1F,3828320,482835161,791,96671,3827529,482738490,0,3305,277621,2727,208973,578,68648,837,8,1137,18,0,37,130000.0,39000.0,-70.0,-71.0,-67.0,-60.0,-69.0,-70.0,-67.0,-60.0,-90.0,-93.0,-89.0,-93.0,20.0,22.0,22.0,33.0,0
7652,BA:8C:B9:54:50:24,3832276,488891689,4747,6153199,3827529,482738490,0,8471,1657790,8449,1654295,22,3495,2324,14,5139,36,0,53,216660.0,130000.0,-39.0,-36.0,-45.0,-52.0,-41.0,-35.0,-44.0,-50.0,-90.0,-93.0,-89.0,-93.0,51.0,57.0,44.0,41.0,0
7653,92:69:1D:31:68:E9,3831309,486322029,3776,3583135,3827533,482738894,0,4288,1050547,4166,1023112,122,27435,2018,7,3923,80,0,39,216660.0,130000.0,-52.0,-51.0,-44.0,-46.0,-52.0,-50.0,-44.0,-46.0,-90.0,-93.0,-89.0,-93.0,38.0,42.0,45.0,47.0,0
7654,CC:2F:71:3F:1F:24,4484993,1190533607,657460,707794713,3827533,482738894,37,535188,566408289,534538,566330113,650,78176,517503,10,657697,68686,34,456,117000.0,39000.0,-67.0,-65.0,-70.0,-68.0,-67.0,-65.0,-70.0,-67.0,-90.0,-93.0,-89.0,-93.0,23.0,28.0,19.0,25.0,0
7655,CC:2F:71:3E:C5:1F,3828324,482835565,791,96671,3827533,482738894,0,3305,277621,2727,208973,578,68648,837,8,1137,18,0,37,130000.0,39000.0,-70.0,-71.0,-67.0,-60.0,-69.0,-70.0,-67.0,-60.0,-90.0,-93.0,-89.0,-93.0,20.0,22.0,22.0,33.0,0
7656,BA:8C:B9:54:50:24,3832280,488892093,4747,6153199,3827533,482738894,0,8471,1657790,8449,1654295,22,3495,2324,14,5139,36,0,53,216660.0,130000.0,-39.0,-36.0,-45.0,-52.0,-41.0,-35.0,-44.0,-50.0,-90.0,-93.0,-89.0,-93.0,51.0,57.0,44.0,41.0,0
7657,92:69:1D:31:68:E9,3831313,486322433,3776,3583135,3827537,482739298,0,4288,1050547,4166,1023112,122,27435,2018,7,3923,80,0,39,216660.0,130000.0,-52.0,-51.0,-44.0,-46.0,-52.0,-50.0,-44.0,-46.0,-90.0,-93.0,-89.0,-93.0,38.0,42.0,45.0,47.0,0
7658,CC:2F:71:3F:1F:24,4485040,1190548563,657503,707809265,3827537,482739298,37,535215,566413373,534565,566335197,650,78176,517530,10,657740,68693,34,456,130000.0,43333.0,-67.0,-65.0,-70.0,-67.0,-67.0,-65.0,-70.0,-67.0,-90.0,-93.0,-89.0,-93.0,23.0,28.0,19.0,26.0,0
7659,CC:2F:71:3E:C5:1F,3828328,482835969,791,96671,3827537,482739298,0,3305,277621,2727,208973,578,68648,837,8,1137,18,0,37,130000.0,39000.0,-70.0,-71.0,-67.0,-60.0,-69.0,-70.0,-67.0,-60.0,-90.0,-93.0,-89.0,-93.0,20.0,22.0,22.0,33.0,0
7660,BA:8C:B9:54:50:24,3832284,488892497,4747,6153199,3827537,482739298,0,8471,1657790,8449,1654295,22,3495,2324,14,5139,36,0,53,216660.0,130000.0,-39.0,-36.0,-45.0,-52.0,-41.0,-35.0,-44.0,-50.0,-90.0,-93.0,-89.0,-93.0,51.0,57.0,44.0,41.0,0
7661,92:69:1D:31:68:E9,3831318,486322897,3776,3583135,3827542,482739762,0,4288,1050547,4166,1023112,122,27435,2018,7,3923,80,0,39,216660.0,130000.0,-52.0,-51.0,-44.0,-46.0,-52.0,-50.0,-44.0,-46.0,-90.0,-93.0,-89.0,-93.0,38.0,42.0,45.0,47.0,0
7662,CC:2F:71:3F:1F:24,4485088,1190563697,657546,707823935,3827542,482739762,37,535243,566418573,534593,566340397,650,78176,517558,10,657783,68698,34,456,130000.0,43333.0,-67.0,-65.0,-70.0,-68.0,-67.0,-65.0,-70.0,-67.0,-90.0,-93.0,-89.0,-93.0,23.0,28.0,19.0,25.0,0
7663,CC:2F:71:3E:C5:1F,3828333,482836433,791,96671,3827542,482739762,0,3305,277621,2727,208973,578,68648,837,8,1137,18,0,37,130000.0,39000.0,-70.0,-71.0,-67.0,-60.0,-69.0,-70.0,-67.0,-60.0,-90.0,-93.0,-89.0,-93.0,20.0,22.0,22.0,33.0,0
7664,BA:8C:B9:54:50:24,3832289,488892961,4747,6153199,3827542,482739762,0,8471,1657790,8449,1654295,22,3495,2324,14,5139,36,0,53,216660.0,130000.0,-39.0,-36.0,-45.0,-52.0,-41.0,-35.0,-44.0,-50.0,-90.0,-93.0,-89.0,-93.0,51.0,57.0,44.0,41.0,0
7665,92:69:1D:31:68:E9,3831322,486323301,3776,3583135,3827546,482740166,0,4288,1050547,4166,1023112,122,27435,2018,7,3923,80,0,39,216660.0,130000.0,-52.0,-51.0,-44.0,-46.0,-52.0,-50.0,-44.0,-46.0,-90.0,-93.0,-89.0,-93.0,38.0,42.0,45.0,47.0,0
7666,CC:2F:71:3F:1F:24,4485134,1190578529,657588,707838363,3827546,482740166,37,535268,566423377,534618,566345201,650,78176,517583,10,657825,68721,34,456,117000.0,39000.0,-67.0,-65.0,-70.0,-67.0,-67.0,-65.0,-70.0,-67.0,-90.0,-93.0,-89.0,-93.0,23.0,28.0,19.0,26.0,0
7667,CC:2F:71:3E:C5:1F,3828337,482836837,791,96671,3827546,482740166,0,3305,277621,2727,208973,578,68648,837,8,1137,18,0,37,130000.0,39000.0,-70.0,-71.0,-67.0,-60.0,-69.0,-70.0,-67.0,-60.0,-90.0,-93.0,-89.0,-93.0,20.0,22.0,22.0,33.0,0
7668,BA:8C:B9:54:50:24,3832293,488893365,4747,6153199,3827546,482740166,0,8471,1657790,8449,1654295,22,3495,2324,14,5139,36,0,53,216660.0,130000.0,-39.0,-36.0,-45.0,-52.0,-41.0,-35.0,-44.0,-50.0,-90.0,-93.0,-89.0,-93.0,51.0,57.0,44.0,41.0,0
7669,92:69:1D:31:68:E9,3831326,486323705,3776,3583135,3827550,482740570,0,4288,1050547,4166,1023112,122,27435,2018,7,3923,80,0,39,216660.0,130000.0,-52.0,-51.0,-44.0,-46.0,-52.0,-50.0,-44.0,-46.0,-90.0,-93.0,-89.0,-93.0,38.0,42.0,45.0,47.0,0
7670,CC:2F:71:3F:1F:24,4485180,1190593297,657629,707852667,3827551,482740630,37,535293,566428181,534643,566350005,650,78176,517608,10,657866,68725,34,456,130000.0,43333.0,-67.0,-65.0,-70.0,-67.0,-67.0,-65.0,-70.0,-67.0,-90.0,-93.0,-89.0,-93.0,23.0,28.0,19.0,26.0,0
7671,CC:2F:71:3E:C5:1F,3828342,482837301,791,96671,3827551,482740630,0,3305,277621,2727,208973,578,68648,837,8,1137,18,0,37,130000.0,39000.0,-70.0,-71.0,-67.0,-60.0,-69.0,-70.0,-67.0,-60.0,-90.0,-93.0,-89.0,-93.0,20.0,22.0,22.0,33.0,0
7672,BA:8C:B9:54:50:24,3832298,488893829,4747,6153199,3827551,482740630,0,8471,1657790,8449,1654295,22,3495,2324,14,5139,36,0,53,216660.0,130000.0,-39.0,-36.0,-45.0,-52.0,-41.0,-35.0,-44.0,-50.0,-90.0,-93.0,-89.0,-93.0,51.0,57.0,44.0,41.0,0
7673,92:69:1D:31:68:E9,3831332,486324285,3777,3583251,3827555,482741034,0,4290,1050683,4168,1023248,122,27435,2018,7,3924,80,0,39,216660.0,130000.0,-51.0,-50.0,-44.0,-45.0,-51.0,-50.0,-44.0,-45.0,-89.0,-92.0,-89.0,-92.0,38.0,42.0,45.0,47.0,0
7674,CC:2F:71:3F:1F:24,4485227,1190608245,657672,707867211,3827555,482741034,37,535319,566433125,534669,566354949,650,78176,517634,10,657909,68742,34,456,117000.0,39000.0,-67.0,-65.0,-71.0,-68.0,-67.0,-65.0,-70.0,-67.0,-89.0,-92.0,-89.0,-92.0,22.0,27.0,18.0,24.0,0
7675,CC:2F:71:3E:C5:1F,3828347,482837821,792,96787,3827555,482741034,0,3307,277761,2729,209113,578,68648,837,8,1138,18,0,37,130000.0,39000.0,-70.0,-71.0,-67.0,-60.0,-69.0,-70.0,-67.0,-60.0,-89.0,-92.0,-89.0,-92.0,19.0,21.0,22.0,32.0,0
7676,BA:8C:B9:54:50:24,3832303,488894349,4748,6153315,3827555,482741034,0,8476,1658130,8454,1654635,22,3495,2324,14,5140,36,0,53,216660.0,130000.0,-40.0,-36.0,-45.0,-51.0,-39.0,-35.0,-43.0,-49.0,-89.0,-92.0,-89.0,-92.0,49.0,56.0,44.0,41.0,0
7677,92:69:1D:31:68:E9,3831336,486324689,3777,3583251,3827559,482741438,0,4290,1050683,4168,1023248,122,27435,2018,7,3924,80,0,39,216660.0,130000.0,-51.0,-50.0,-44.0,-45.0,-51.0,-50.0,-44.0,-45.0,-89.0,-92.0,-89.0,-92.0,38.0,42.0,45.0,47.0,0
7678,CC:2F:71:3F:1F:24,4485273,1190623077,657714,707881639,3827559,482741438,37,535344,566437929,534694,566359753,650,78176,517659,10,657951,68751,34,456,130000.0,39000.0,-67.0,-65.0,-71.0,-68.0,-67.0,-65.0,-70.0,-67.0,-89.0,-92.0,-89.0,-92.0,22.0,27.0,18.0,24.0,0
7679,CC:2F:71:3E:C5:1F,3828352,482838498,792,96787,3827560,482741711,0,3307,277761,2729,209113,578,68648,837,8,1138,18,0,37,130000.0,39000.0,-70.0,-71.0,-67.0,-60.0,-69.0,-70.0,-67.0,-60.0,-89.0,-92.0,-89.0,-92.0,19.0,21.0,22.0,32.0,0
7680,BA:8C:B9:54:50:24,3832308,488895026,4748,6153315,3827560,482741711,0,8476,1658130,8454,1654635,22,3495,2324,14,5140,36,0,53,216660.0,130000.0,-40.0,-36.0,-45.0,-51.0,-39.0,-35.0,-43.0,-49.0,-89.0,-92.0,-89.0,-92.0,49.0,56.0,44.0,41.0,0
7681,92:69:1D:31:68:E9,3831342,486325426,3777,3583251,3827565,482742175,0,4290,1050683,4168,1023248,122,27435,2018,7,3924,80,0,39,216660.0,130000.0,-51.0,-50.0,-44.0,-45.0,-51.0,-50.0,-44.0,-45.0,-89.0,-92.0,-89.0,-92.0,38.0,42.0,45.0,47.0,0
7682,CC:2F:71:3F:1F:24,4485322,1190638316,657757,707896141,3827565,482742175,37,535370,566442909,534720,566364733,650,78176,517685,10,657994,68762,34,456,130000.0,39000.0,-67.0,-65.0,-70.0,-67.0,-67.0,-65.0,-70.0,-67.0,-89.0,-92.0,-89.0,-92.0,22.0,27.0,19.0,25.0,0
7683,CC:2F:71:3E:C5:1F,3828357,482838962,792,96787,3827565,482742175,0,3307,277761,2729,209113,578,68648,837,8,1138,18,0,37,130000.0,39000.0,-70.0,-71.0,-67.0,-60.0,-69.0,-70.0,-67.0,-60.0,-89.0,-92.0,-89.0,-92.0,19.0,21.0,22.0,32.0,0
7684,BA:8C:B9:54:50:24,3832313,488895490,4748,6153315,3827565,482742175,0,8476,1658130,8454,1654635,22,3495,2324,14,5140,36,0,53,216660.0,130000.0,-40.0,-36.0,-45.0,-51.0,-39.0,-35.0,-43.0,-49.0,-89.0,-92.0,-89.0,-92.0,49.0,56.0,44.0,41.0,0
7685,92:69:1D:31:68:E9,3831346,486325830,3777,3583251,3827569,482742579,0,4290,1050683,4168,1023248,122,27435,2018,7,3924,80,0,39,216660.0,130000.0,-51.0,-50.0,-44.0,-45.0,-51.0,-50.0,-44.0,-45.0,-89.0,-92.0,-89.0,-92.0,38.0,42.0,45.0,47.0,0
7686,CC:2F:71:3F:1F:24,4485368,1190653092,657799,707910513,3827569,482742579,37,535396,566447853,534746,566369677,650,78176,517711,10,658036,68782,34,456,117000.0,39000.0,-67.0,-65.0,-70.0,-68.0,-67.0,-65.0,-70.0,-67.0,-89.0,-92.0,-89.0,-92.0,22.0,27.0,19.0,24.0,0
7687,CC:2F:71:3E:C5:1F,3828361,482839366,792,96787,3827569,482742579,0,3307,277761,2729,209113,578,68648,837,8,1138,18,0,37,130000.0,39000.0,-70.0,-71.0,-67.0,-60.0,-69.0,-70.0,-67.0,-60.0,-89.0,-92.0,-89.0,-92.0,19.0,21.0,22.0,32.0,0
7688,BA:8C:B9:54:50:24,3832317,488895894,4748,6153315,3827569,482742579,0,8476,1658130,8454,1654635,22,3495,2324,14,5140,36,0,53,216660.0,130000.0,-40.0,-36.0,-45.0,-51.0,-39.0,-35.0,-43.0,-49.0,-89.0,-92.0,-89.0,-92.0,49.0,56.0,44.0,41.0,0
7689,92:69:1D:31:68:E9,3831350,486326234,3777,3583251,3827573,482742983,0,4290,1050683,4168,1023248,122,27435,2018,7,3924,80,0,39,216660.0,130000.0,-51.0,-50.0,-44.0,-45.0,-51.0,-50.0,-44.0,-45.0,-89.0,-92.0,-89.0,-92.0,38.0,42.0,45.0,47.0,0
7690,CC:2F:71:3F:1F:24,4485415,1190667998,657842,707925015,3827573,482742983,37,535421,566452657,534771,566374481,650,78176,517736,10,658079,68789,34,456,130000.0,39000.0,-67.0,-65.0,-70.0,-68.0,-67.0,-65.0,-70.0,-67.0,-89.0,-92.0,-89.0,-92.0,22.0,27.0,19.0,24.0,0
7691,CC:2F:71:3E:C5:1F,3828365,482839770,792,96787,3827573,482742983,0,3307,277761,2729,209113,578,68648,837,8,1138,18,0,37,130000.0,39000.0,-70.0,-71.0,-67.0,-60.0,-69.0,-70.0,-67.0,-60.0,-89.0,-92.0,-89.0,-92.0,19.0,21.0,22.0,32.0,0
7692,BA:8C:B9:54:50:24,3832321,488896298,4748,6153315,3827573,482742983,0,8476,1658130,8454,1654635,22,3495,2324,14,5140,36,0,53,216660.0,130000.0,-40.0,-36.0,-45.0,-51.0,-39.0,-35.0,-43.0,-49.0,-89.0,-92.0,-89.0,-92.0,49.0,56.0,44.0,41.0,0
7693,92:69:1D:31:68:E9,3831355,486326698,3777,3583251,3827578,482743447,0,4290,1050683,4168,1023248,122,27435,2018,7,3924,80,0,39,216660.0,130000.0,-51.0,-50.0,-44.0,-45.0,-51.0,-50.0,-44.0,-45.0,-89.0,-92.0,-89.0,-92.0,38.0,42.0,45.0,47.0,0
7694,CC:2F:71:3F:1F:24,4485462,1190682946,657884,707939499,3827578,482743447,37,535447,566457601,534797,566379425,650,78176,517762,10,658121,68831,34,456,144444.0,43333.0,-67.0,-65.0,-71.0,-68.0,-67.0,-65.0,-70.0,-67.0,-89.0,-92.0,-89.0,-92.0,22.0,27.0,18.0,24.0,0
7695,CC:2F:71:3E:C5:1F,3828370,482840234,792,96787,3827578,482743447,0,3307,277761,2729,209113,578,68648,837,8,1138,18,0,37,130000.0,39000.0,-70.0,-71.0,-67.0,-60.0,-69.0,-70.0,-67.0,-60.0,-89.0,-92.0,-89.0,-92.0,19.0,21.0,22.0,32.0,0
7696,BA:8C:B9:54:50:24,3832326,488896762,4748,6153315,3827578,482743447,0,8476,1658130,8454,1654635,22,3495,2324,14,5140,36,0,53,216660.0,130000.0,-40.0,-36.0,-45.0,-51.0,-39.0,-35.0,-43.0,-49.0,-89.0,-92.0,-89.0,-92.0,49.0,56.0,44.0,41.0,0
7697,92:69:1D:31:68:E9,3831359,486327102,3777,3583251,3827582,482743851,0,4290,1050683,4168,1023248,122,27435,2018,7,3924,80,0,39,216660.0,130000.0,-51.0,-50.0,-44.0,-45.0,-51.0,-50.0,-44.0,-45.0,-89.0,-92.0,-89.0,-92.0,38.0,42.0,45.0,47.0,0
7698,CC:2F:71:3F:1F:24,4485509,1190697908,657927,707954057,3827582,482743851,37,535473,566462521,534823,566384345,650,78176,517788,10,658164,68837,34,456,130000.0,43333.0,-67.0,-65.0,-70.0,-67.0,-67.0,-65.0,-70.0,-67.0,-89.0,-92.0,-89.0,-92.0,22.0,27.0,19.0,25.0,0
7699,CC:2F:71:3E:C5:1F,3828374,482840638,792,96787,3827582,482743851,0,3307,277761,2729,209113,578,68648,837,8,1138,18,0,37,130000.0,39000.0,-70.0,-71.0,-67.0,-60.0,-69.0,-70.0,-67.0,-60.0,-89.0,-92.0,-89.0,-92.0,19.0,21.0,22.0,32.0,0
7700,BA:8C:B9:54:50:24,3832330,488897166,4748,6153315,3827582,482743851,0,8476,1658130,8454,1654635,22,3495,2324,14,5140,36,0,53,216660.0,130000.0,-40.0,-36.0,-45.0,-51.0,-39.0,-35.0,-43.0,-49.0,-89.0,-92.0,-89.0,-92.0,49.0,56.0,44.0,41.0,0
7701,92:69:1D:31:68:E9,3831365,486327628,3777,3583251,3827588,482744377,0,4292,1050819,4170,1023384,122,27435,2018,7,3925,80,0,39,216660.0,130000.0,-52.0,-51.0,-44.0,-46.0,-51.0,-50.0,-44.0,-45.0,-89.0,-92.0,-89.0,-92.0,37.0,41.0,45.0,46.0,0
7702,CC:2F:71:3F:1F:24,4485557,1190712974,657969,707968597,3827588,482744377,37,535498,566467325,534848,566389149,650,78176,517813,10,658206,68843,34,456,130000.0,43333.0,-67.0,-65.0,-70.0,-67.0,-67.0,-65.0,-70.0,-67.0,-89.0,-92.0,-89.0,-92.0,22.0,27.0,19.0,25.0,0
7703,CC:2F:71:3E:C5:1F,3828380,482841164,792,96787,3827588,482744377,0,3311,278089,2732,209323,579,68766,838,8,1139,18,0,37,130000.0,39000.0,-70.0,-71.0,-67.0,-60.0,-70.0,-71.0,-67.0,-60.0,-89.0,-92.0,-89.0,-92.0,19.0,21.0,22.0,32.0,0
7704,BA:8C:B9:54:50:24,3832336,488897692,4748,6153315,3827588,482744377,0,8478,1658266,8456,1654771,22,3495,2324,14,5141,36,0,53,216660.0,130000.0,-40.0,-36.0,-45.0,-51.0,-40.0,-35.0,-43.0,-49.0,-89.0,-92.0,-89.0,-92.0,49.0,56.0,44.0,41.0,0
7705,92:69:1D:31:68:E9,3831369,486328032,3777,3583251,3827592,482744781,0,4292,1050819,4170,1023384,122,27435,2018,7,3925,80,0,39,216660.0,130000.0,-52.0,-51.0,-44.0,-46.0,-51.0,-50.0,-44.0,-45.0,-89.0,-92.0,-89.0,-92.0,37.0,41.0,45.0,46.0,0
7706,CC:2F:71:3F:1F:24,4485604,1190727930,658012,707983149,3827592,482744781,37,535527,566472617,534877,566394441,650,78176,517842,10,658249,68856,34,456,117000.0,39000.0,-67.0,-65.0,-70.0,-68.0,-67.0,-65.0,-70.0,-67.0,-89.0,-92.0,-89.0,-92.0,22.0,27.0,19.0,24.0,0
7707,CC:2F:71:3E:C5:1F,3828384,482841568,792,96787,3827592,482744781,0,3311,278089,2732,209323,579,68766,838,8,1139,18,0,37,130000.0,39000.0,-70.0,-71.0,-67.0,-60.0,-70.0,-71.0,-67.0,-60.0,-89.0,-92.0,-89.0,-92.0,19.0,21.0,22.0,32.0,0
7708,BA:8C:B9:54:50:24,3832340,488898096,4748,6153315,3827592,482744781,0,8478,1658266,8456,1654771,22,3495,2324,14,5141,36,0,53,216660.0,130000.0,-40.0,-36.0,-45.0,-51.0,-40.0,-35.0,-43.0,-49.0,-89.0,-92.0,-89.0,-92.0,49.0,56.0,44.0,41.0,0
7709,92:69:1D:31:68:E9,3831373,486328436,3777,3583251,3827596,482745185,0,4292,1050819,4170,1023384,122,27435,2018,7,3925,80,0,39,216660.0,130000.0,-52.0,-51.0,-44.0,-46.0,-51.0,-50.0,-44.0,-45.0,-89.0,-92.0,-89.0,-92.0,37.0,41.0,45.0,46.0,0
7710,CC:2F:71:3F:1F:24,4485648,1190742514,658052,707997329,3827596,482745185,37,535552,566477421,534902,566399245,650,78176,517867,10,658289,68856,34,456,130000.0,43333.0,-67.0,-65.0,-70.0,-68.0,-67.0,-65.0,-70.0,-67.0,-89.0,-92.0,-89.0,-92.0,22.0,27.0,19.0,24.0,0
7711,CC:2F:71:3E:C5:1F,3828388,482841972,792,96787,3827596,482745185,0,3311,278089,2732,209323,579,68766,838,8,1139,18,0,37,130000.0,39000.0,-70.0,-71.0,-67.0,-60.0,-70.0,-71.0,-67.0,-60.0,-89.0,-92.0,-89.0,-92.0,19.0,21.0,22.0,32.0,0
7712,BA:8C:B9:54:50:24,3832344,488898500,4748,6153315,3827596,482745185,0,8478,1658266,8456,1654771,22,3495,2324,14,5141,36,0,53,216660.0,130000.0,-40.0,-36.0,-45.0,-51.0,-40.0,-35.0,-43.0,-49.0,-89.0,-92.0,-89.0,-92.0,49.0,56.0,44.0,41.0,0
7713,92:69:1D:31:68:E9,3831378,486328900,3777,3583251,3827601,482745649,0,4293,1050887,4171,1023452,122,27435,2018,7,3925,80,0,39,216660.0,130000.0,-52.0,-51.0,-45.0,-46.0,-51.0,-50.0,-44.0,-45.0,-89.0,-92.0,-89.0,-92.0,37.0,41.0,44.0,46.0,0
7714,CC:2F:71:3F:1F:24,4485694,1190757394,658093,708011745,3827601,482745649,37,535577,566482225,534927,566404049,650,78176,517892,10,658330,68861,34,456,130000.0,43333.0,-67.0,-65.0,-70.0,-67.0,-67.0,-65.0,-70.0,-67.0,-89.0,-92.0,-89.0,-92.0,22.0,27.0,19.0,25.0,0
7715,CC:2F:71:3E:C5:1F,3828393,482842436,792,96787,3827601,482745649,0,3311,278089,2732,209323,579,68766,838,8,1139,18,0,37,130000.0,39000.0,-70.0,-71.0,-67.0,-60.0,-70.0,-71.0,-67.0,-60.0,-89.0,-92.0,-89.0,-92.0,19.0,21.0,22.0,32.0,0
7716,BA:8C:B9:54:50:24,3832349,488898964,4748,6153315,3827601,482745649,0,8478,1658266,8456,1654771,22,3495,2324,14,5141,36,0,53,216660.0,130000.0,-40.0,-36.0,-45.0,-51.0,-40.0,-35.0,-43.0,-49.0,-89.0,-92.0,-89.0,-92.0,49.0,56.0,44.0,41.0,0
7717,92:69:1D:31:68:E9,3831382,486329304,3777,3583251,3827605,482746053,0,4293,1050887,4171,1023452,122,27435,2018,7,3925,80,0,39,216660.0,130000.0,-52.0,-51.0,-45.0,-46.0,-51.0,-50.0,-44.0,-45.0,-89.0,-92.0,-89.0,-92.0,37.0,41.0,44.0,46.0,0
7718,CC:2F:71:3F:1F:24,4485740,1190772226,658135,708026173,3827605,482746053,37,535602,566487029,534952,566408853,650,78176,517917,10,658372,68884,34,456,117000.0,39000.0,-67.0,-65.0,-70.0,-67.0,-67.0,-65.0,-70.0,-67.0,-89.0,-92.0,-89.0,-92.0,22.0,27.0,19.0,25.0,0
7719,CC:2F:71:3E:C5:1F,3828397,482842840,792,96787,3827605,482746053,0,3311,278089,2732,209323,579,68766,838,8,1139,18,0,37,130000.0,39000.0,-70.0,-71.0,-67.0,-60.0,-70.0,-71.0,-67.0,-60.0,-89.0,-92.0,-89.0,-92.0,19.0,21.0,22.0,32.0,0
7720,BA:8C:B9:54:50:24,3832353,488899368,4748,6153315,3827605,482746053,0,8478,1658266,8456,1654771,22,3495,2324,14,5141,36,0,53,216660.0,130000.0,-40.0,-36.0,-45.0,-51.0,-40.0,-35.0,-43.0,-49.0,-89.0,-92.0,-89.0,-92.0,49.0,56.0,44.0,41.0,0
7721,92:69:1D:31:68:E9,3831386,486329708,3777,3583251,3827609,482746457,0,4293,1050887,4171,1023452,122,27435,2018,7,3925,80,0,39,216660.0,130000.0,-52.0,-51.0,-45.0,-46.0,-51.0,-50.0,-44.0,-45.0,-89.0,-92.0,-89.0,-92.0,37.0,41.0,44.0,46.0,0
7722,CC:2F:71:3F:1F:24,4485787,1190787182,658178,708040725,3827609,482746457,37,535627,566491833,534977,566413657,650,78176,517942,10,658415,68890,34,456,130000.0,43333.0,-67.0,-65.0,-70.0,-67.0,-67.0,-65.0,-70.0,-67.0,-89.0,-92.0,-89.0,-92.0,22.0,27.0,19.0,25.0,0
7723,CC:2F:71:3E:C5:1F,3828401,482843244,792,96787,3827609,482746457,0,3311,278089,2732,209323,579,68766,838,8,1139,18,0,37,130000.0,39000.0,-70.0,-71.0,-67.0,-60.0,-70.0,-71.0,-67.0,-60.0,-89.0,-92.0,-89.0,-92.0,19.0,21.0,22.0,32.0,0
7724,BA:8C:B9:54:50:24,3832358,488899832,4748,6153315,3827610,482746517,0,8478,1658266,8456,1654771,22,3495,2324,14,5141,36,0,53,216660.0,130000.0,-40.0,-36.0,-45.0,-51.0,-40.0,-35.0,-43.0,-49.0,-89.0,-92.0,-89.0,-92.0,49.0,56.0,44.0,41.0,0
7725,92:69:1D:31:68:E9,3831404,486335833,3777,3583251,3827627,482752582,0,4296,1051258,4173,1023588,123,27670,2019,7,3925,80,0,39,216660.0,130000.0,-51.0,-47.0,-42.0,-48.0,-51.0,-50.0,-44.0,-46.0,-89.0,-92.0,-89.0,-92.0,38.0,45.0,47.0,44.0,0
7726,CC:2F:71:3F:1F:24,4485858,1190813159,658220,708055153,3827638,482758006,37,535654,566496895,535003,566418601,651,78294,517969,10,658457,68920,34,456,144444.0,43333.0,-67.0,-65.0,-70.0,-67.0,-67.0,-65.0,-70.0,-67.0,-89.0,-92.0,-89.0,-92.0,22.0,27.0,19.0,25.0,0
7727,CC:2F:71:3E:C5:1F,3828430,482854793,792,96787,3827638,482758006,0,3311,278089,2732,209323,579,68766,838,8,1139,18,0,37,130000.0,39000.0,-70.0,-71.0,-67.0,-60.0,-70.0,-71.0,-67.0,-60.0,-89.0,-92.0,-89.0,-92.0,19.0,21.0,22.0,32.0,0
7728,BA:8C:B9:54:50:24,3832386,488911321,4748,6153315,3827638,482758006,0,8478,1658266,8456,1654771,22,3495,2324,14,5141,36,0,53,216660.0,130000.0,-40.0,-36.0,-45.0,-51.0,-40.0,-35.0,-43.0,-49.0,-89.0,-92.0,-89.0,-92.0,49.0,56.0,44.0,41.0,0
7729,92:69:1D:31:68:E9,3831419,486341661,3777,3583251,3827642,482758410,0,4296,1051258,4173,1023588,123,27670,2019,7,3925,80,0,39,216660.0,130000.0,-51.0,-47.0,-42.0,-48.0,-51.0,-50.0,-44.0,-46.0,-89.0,-92.0,-89.0,-92.0,38.0,45.0,47.0,44.0,0
7730,CC:2F:71:3F:1F:24,4485902,1190827743,658260,708069333,3827642,482758410,37,535680,566501839,535029,566423545,651,78294,517995,10,658497,68930,34,456,130000.0,43333.0,-67.0,-65.0,-71.0,-68.0,-67.0,-65.0,-70.0,-67.0,-89.0,-92.0,-89.0,-92.0,22.0,27.0,18.0,24.0,0
7731,CC:2F:71:3E:C5:1F,3828434,482855197,792,96787,3827642,482758410,0,3311,278089,2732,209323,579,68766,838,8,1139,18,0,37,130000.0,39000.0,-70.0,-71.0,-67.0,-60.0,-70.0,-71.0,-67.0,-60.0,-89.0,-92.0,-89.0,-92.0,19.0,21.0,22.0,32.0,0
7732,BA:8C:B9:54:50:24,3832391,488911998,4748,6153315,3827643,482758683,0,8478,1658266,8456,1654771,22,3495,2324,14,5141,36,0,53,216660.0,130000.0,-40.0,-36.0,-45.0,-51.0,-40.0,-35.0,-43.0,-49.0,-89.0,-92.0,-89.0,-92.0,49.0,56.0,44.0,41.0,0
7733,92:69:1D:31:68:E9,3831425,486342398,3777,3583251,3827648,482759147,0,4296,1051258,4173,1023588,123,27670,2019,7,3925,80,0,39,216660.0,130000.0,-51.0,-47.0,-42.0,-48.0,-51.0,-50.0,-44.0,-46.0,-89.0,-92.0,-89.0,-92.0,38.0,45.0,47.0,44.0,0
7734,CC:2F:71:3F:1F:24,4485950,1190843020,658302,708083873,3827648,482759147,37,535706,566506783,535055,566428489,651,78294,518021,10,658539,68932,34,456,130000.0,43333.0,-67.0,-65.0,-71.0,-68.0,-67.0,-65.0,-70.0,-67.0,-89.0,-92.0,-89.0,-92.0,22.0,27.0,18.0,24.0,0
7735,CC:2F:71:3E:C5:1F,3828440,482855934,792,96787,3827648,482759147,0,3311,278089,2732,209323,579,68766,838,8,1139,18,0,37,130000.0,39000.0,-70.0,-71.0,-67.0,-60.0,-70.0,-71.0,-67.0,-60.0,-89.0,-92.0,-89.0,-92.0,19.0,21.0,22.0,32.0,0
7736,BA:8C:B9:54:50:24,3832396,488912462,4748,6153315,3827648,482759147,0,8478,1658266,8456,1654771,22,3495,2324,14,5141,36,0,53,216660.0,130000.0,-40.0,-36.0,-45.0,-51.0,-40.0,-35.0,-43.0,-49.0,-89.0,-92.0,-89.0,-92.0,49.0,56.0,44.0,41.0,0
7737,92:69:1D:31:68:E9,3831429,486342802,3777,3583251,3827652,482759551,0,4296,1051258,4173,1023588,123,27670,2019,7,3925,80,0,39,216660.0,130000.0,-51.0,-47.0,-42.0,-48.0,-51.0,-50.0,-44.0,-46.0,-89.0,-92.0,-89.0,-92.0,38.0,45.0,47.0,44.0,0
7738,CC:2F:71:3F:1F:24,4485997,1190858038,658345,708098487,3827652,482759551,37,535733,566511843,535082,566433549,651,78294,518048,10,658582,68954,34,456,130000.0,39000.0,-67.0,-65.0,-70.0,-68.0,-67.0,-65.0,-70.0,-67.0,-89.0,-92.0,-89.0,-92.0,22.0,27.0,19.0,24.0,0
7739,CC:2F:71:3E:C5:1F,3828444,482856338,792,96787,3827652,482759551,0,3311,278089,2732,209323,579,68766,838,8,1139,18,0,37,130000.0,39000.0,-70.0,-71.0,-67.0,-60.0,-70.0,-71.0,-67.0,-60.0,-89.0,-92.0,-89.0,-92.0,19.0,21.0,22.0,32.0,0
7740,BA:8C:B9:54:50:24,3832400,488912866,4748,6153315,3827652,482759551,0,8478,1658266,8456,1654771,22,3495,2324,14,5141,36,0,53,216660.0,130000.0,-40.0,-36.0,-45.0,-51.0,-40.0,-35.0,-43.0,-49.0,-89.0,-92.0,-89.0,-92.0,49.0,56.0,44.0,41.0,0
7741,92:69:1D:31:68:E9,3831433,486343206,3777,3583251,3827656,482759955,0,4296,1051258,4173,1023588,123,27670,2019,7,3925,80,0,39,216660.0,130000.0,-51.0,-47.0,-42.0,-48.0,-51.0,-50.0,-44.0,-46.0,-90.0,-92.0,-89.0,-92.0,39.0,45.0,47.0,44.0,0
7742,CC:2F:71:3F:1F:24,4486045,1190873068,658389,708113113,3827656,482759955,37,535761,566516995,535110,566438701,651,78294,518076,10,658626,68970,34,456,130000.0,43333.0,-67.0,-65.0,-70.0,-68.0,-67.0,-65.0,-70.0,-67.0,-90.0,-92.0,-89.0,-92.0,23.0,27.0,19.0,24.0,0
7743,CC:2F:71:3E:C5:1F,3828448,482856742,792,96787,3827656,482759955,0,3311,278089,2732,209323,579,68766,838,8,1139,18,0,37,130000.0,39000.0,-70.0,-71.0,-67.0,-60.0,-70.0,-71.0,-67.0,-60.0,-90.0,-92.0,-89.0,-92.0,20.0,21.0,22.0,32.0,0
7744,BA:8C:B9:54:50:24,3832404,488913270,4748,6153315,3827656,482759955,0,8478,1658266,8456,1654771,22,3495,2324,14,5141,36,0,53,216660.0,130000.0,-40.0,-36.0,-45.0,-51.0,-40.0,-35.0,-43.0,-49.0,-90.0,-92.0,-89.0,-92.0,50.0,56.0,44.0,41.0,0
7745,92:69:1D:31:68:E9,3831440,486344038,3777,3583251,3827663,482760787,0,4296,1051258,4173,1023588,123,27670,2019,7,3925,80,0,39,216660.0,130000.0,-51.0,-47.0,-42.0,-48.0,-51.0,-50.0,-44.0,-46.0,-90.0,-92.0,-89.0,-92.0,39.0,45.0,47.0,44.0,0
7746,CC:2F:71:3F:1F:24,4486094,1190888440,658431,708127653,3827663,482760787,37,535786,566521799,535135,566443505,651,78294,518101,10,658668,68978,34,456,130000.0,43333.0,-67.0,-65.0,-70.0,-68.0,-67.0,-65.0,-70.0,-67.0,-90.0,-92.0,-89.0,-92.0,23.0,27.0,19.0,24.0,0
7747,CC:2F:71:3E:C5:1F,3828455,482857574,792,96787,3827663,482760787,0,3311,278089,2732,209323,579,68766,838,8,1139,18,0,37,130000.0,39000.0,-70.0,-71.0,-67.0,-60.0,-70.0,-71.0,-67.0,-60.0,-90.0,-92.0,-89.0,-92.0,20.0,21.0,22.0,32.0,0
7748,BA:8C:B9:54:50:24,3832411,488914102,4748,6153315,3827663,482760787,0,8478,1658266,8456,1654771,22,3495,2324,14,5141,36,0,53,216660.0,130000.0,-40.0,-36.0,-45.0,-51.0,-40.0,-35.0,-43.0,-49.0,-90.0,-92.0,-89.0,-92.0,50.0,56.0,44.0,41.0,0
7749,92:69:1D:31:68:E9,3831444,486344442,3777,3583251,3827667,482761191,0,4296,1051258,4173,1023588,123,27670,2019,7,3925,80,0,39,216660.0,130000.0,-51.0,-47.0,-42.0,-48.0,-51.0,-50.0,-44.0,-46.0,-90.0,-92.0,-89.0,-92.0,39.0,45.0,47.0,44.0,0
7750,CC:2F:71:3F:1F:24,4486141,1190903402,658474,708142211,3827667,482761191,37,535813,566526883,535162,566448589,651,78294,518128,10,658711,69022,34,456,144444.0,39000.0,-67.0,-65.0,-71.0,-68.0,-67.0,-65.0,-70.0,-67.0,-90.0,-92.0,-89.0,-92.0,23.0,27.0,18.0,24.0,0
7751,CC:2F:71:3E:C5:1F,3828459,482857978,792,96787,3827667,482761191,0,3311,278089,2732,209323,579,68766,838,8,1139,18,0,37,130000.0,39000.0,-70.0,-71.0,-67.0,-60.0,-70.0,-71.0,-67.0,-60.0,-90.0,-92.0,-89.0,-92.0,20.0,21.0,22.0,32.0,0
7752,BA:8C:B9:54:50:24,3832415,488914506,4748,6153315,3827667,482761191,0,8478,1658266,8456,1654771,22,3495,2324,14,5141,36,0,53,216660.0,130000.0,-40.0,-36.0,-45.0,-51.0,-40.0,-35.0,-43.0,-49.0,-90.0,-92.0,-89.0,-92.0,50.0,56.0,44.0,41.0,0
7753,92:69:1D:31:68:E9,3831449,486344906,3777,3583251,3827672,482761655,0,4296,1051258,4173,1023588,123,27670,2019,7,3925,80,0,39,216660.0,130000.0,-51.0,-47.0,-42.0,-48.0,-51.0,-50.0,-44.0,-46.0,-90.0,-92.0,-89.0,-92.0,39.0,45.0,47.0,44.0,0
7754,CC:2F:71:3F:1F:24,4486188,1190918126,658516,708156471,3827672,482761655,37,535839,566531827,535188,566453533,651,78294,518154,10,658753,69047,34,456,117000.0,39000.0,-67.0,-65.0,-70.0,-68.0,-67.0,-65.0,-70.0,-67.0,-90.0,-92.0,-89.0,-92.0,23.0,27.0,19.0,24.0,0
7755,CC:2F:71:3E:C5:1F,3828464,482858442,792,96787,3827672,482761655,0,3311,278089,2732,209323,579,68766,838,8,1139,18,0,37,130000.0,39000.0,-70.0,-71.0,-67.0,-60.0,-70.0,-71.0,-67.0,-60.0,-90.0,-92.0,-89.0,-92.0,20.0,21.0,22.0,32.0,0
7756,BA:8C:B9:54:50:24,3832420,488914970,4748,6153315,3827672,482761655,0,8478,1658266,8456,1654771,22,3495,2324,14,5141,36,0,53,216660.0,130000.0,-40.0,-36.0,-45.0,-51.0,-40.0,-35.0,-43.0,-49.0,-90.0,-92.0,-89.0,-92.0,50.0,56.0,44.0,41.0,0
7757,92:69:1D:31:68:E9,3831453,486345310,3777,3583251,3827676,482762059,0,4296,1051258,4173,1023588,123,27670,2019,7,3925,80,0,39,216660.0,130000.0,-51.0,-47.0,-42.0,-48.0,-51.0,-50.0,-44.0,-46.0,-90.0,-92.0,-89.0,-92.0,39.0,45.0,47.0,44.0,0
7758,CC:2F:71:3F:1F:24,4486235,1190933032,658559,708170973,3827676,482762059,37,535864,566536631,535213,566458337,651,78294,518179,10,658796,69050,34,456,117000.0,39000.0,-67.0,-65.0,-70.0,-67.0,-67.0,-65.0,-70.0,-67.0,-90.0,-92.0,-89.0,-92.0,23.0,27.0,19.0,25.0,0
7759,CC:2F:71:3E:C5:1F,3828468,482858846,792,96787,3827676,482762059,0,3311,278089,2732,209323,579,68766,838,8,1139,18,0,37,130000.0,39000.0,-70.0,-71.0,-67.0,-60.0,-70.0,-71.0,-67.0,-60.0,-90.0,-92.0,-89.0,-92.0,20.0,21.0,22.0,32.0,0
7760,BA:8C:B9:54:50:24,3832424,488915374,4748,6153315,3827676,482762059,0,8478,1658266,8456,1654771,22,3495,2324,14,5141,36,0,53,216660.0,130000.0,-40.0,-36.0,-45.0,-51.0,-40.0,-35.0,-43.0,-49.0,-90.0,-92.0,-89.0,-92.0,50.0,56.0,44.0,41.0,0
7761,92:69:1D:31:68:E9,3831457,486345714,3777,3583251,3827680,482762463,0,4296,1051258,4173,1023588,123,27670,2019,7,3925,80,0,39,216660.0,130000.0,-51.0,-47.0,-42.0,-48.0,-51.0,-50.0,-44.0,-46.0,-90.0,-92.0,-89.0,-92.0,39.0,45.0,47.0,44.0,0
7762,CC:2F:71:3F:1F:24,4486282,1190947932,658602,708185469,3827680,482762463,37,535890,566541551,535239,566463257,651,78294,518205,10,658839,69059,34,456,130000.0,39000.0,-67.0,-65.0,-71.0,-68.0,-67.0,-65.0,-70.0,-67.0,-90.0,-92.0,-89.0,-92.0,23.0,27.0,18.0,24.0,0
7763,CC:2F:71:3E:C5:1F,3828472,482859250,792,96787,3827680,482762463,0,3311,278089,2732,209323,579,68766,838,8,1139,18,0,37,130000.0,39000.0,-70.0,-71.0,-67.0,-60.0,-70.0,-71.0,-67.0,-60.0,-90.0,-92.0,-89.0,-92.0,20.0,21.0,22.0,32.0,0
7764,BA:8C:B9:54:50:24,3832428,488915778,4748,6153315,3827680,482762463,0,8479,1658334,8457,1654839,22,3495,2324,14,5141,36,0,53,216660.0,130000.0,-40.0,-37.0,-45.0,-52.0,-40.0,-35.0,-43.0,-49.0,-90.0,-92.0,-89.0,-92.0,50.0,55.0,44.0,40.0,0
7765,92:69:1D:31:68:E9,3831462,486346178,3777,3583251,3827685,482762927,0,4296,1051258,4173,1023588,123,27670,2019,7,3925,80,0,39,216660.0,130000.0,-51.0,-47.0,-42.0,-48.0,-51.0,-50.0,-44.0,-46.0,-90.0,-92.0,-89.0,-92.0,39.0,45.0,47.0,44.0,0
7766,CC:2F:71:3F:1F:24,4486329,1190962830,658644,708199903,3827685,482762927,37,535915,566546355,535264,566468061,651,78294,518230,10,658881,69077,34,456,130000.0,39000.0,-67.0,-65.0,-71.0,-68.0,-67.0,-65.0,-70.0,-68.0,-90.0,-92.0,-89.0,-92.0,23.0,27.0,18.0,24.0,0
7767,CC:2F:71:3E:C5:1F,3828477,482859714,792,96787,3827685,482762927,0,3311,278089,2732,209323,579,68766,838,8,1139,18,0,37,130000.0,39000.0,-70.0,-71.0,-67.0,-60.0,-70.0,-71.0,-67.0,-60.0,-90.0,-92.0,-89.0,-92.0,20.0,21.0,22.0,32.0,0
7768,BA:8C:B9:54:50:24,3832433,488916242,4748,6153315,3827685,482762927,0,8482,1658538,8460,1655043,22,3495,2324,14,5141,36,0,53,216660.0,130000.0,-40.0,-36.0,-45.0,-51.0,-40.0,-36.0,-44.0,-50.0,-90.0,-92.0,-89.0,-92.0,50.0,56.0,44.0,41.0,0
7769,92:69:1D:31:68:E9,3831466,486346582,3777,3583251,3827689,482763331,0,4296,1051258,4173,1023588,123,27670,2019,7,3925,80,0,39,216660.0,130000.0,-51.0,-47.0,-42.0,-48.0,-51.0,-50.0,-44.0,-46.0,-90.0,-92.0,-89.0,-92.0,39.0,45.0,47.0,44.0,0
7770,CC:2F:71:3F:1F:24,4486374,1190977482,658685,708214151,3827689,482763331,37,535942,566551415,535291,566473121,651,78294,518257,10,658922,69091,34,456,117000.0,39000.0,-67.0,-65.0,-71.0,-68.0,-67.0,-65.0,-70.0,-67.0,-90.0,-92.0,-89.0,-92.0,23.0,27.0,18.0,24.0,0
7771,CC:2F:71:3E:C5:1F,3828481,482860118,792,96787,3827689,482763331,0,3311,278089,2732,209323,579,68766,838,8,1139,18,0,37,130000.0,39000.0,-70.0,-71.0,-67.0,-60.0,-70.0,-71.0,-67.0,-60.0,-90.0,-92.0,-89.0,-92.0,20.0,21.0,22.0,32.0,0
7772,BA:8C:B9:54:50:24,3832437,488916646,4748,6153315,3827689,482763331,0,8482,1658538,8460,1655043,22,3495,2324,14,5141,36,0,53,216660.0,130000.0,-40.0,-36.0,-45.0,-51.0,-40.0,-36.0,-44.0,-50.0,-90.0,-92.0,-89.0,-92.0,50.0,56.0,44.0,41.0,0
7773,92:69:1D:31:68:E9,3831470,486346986,3777,3583251,3827693,482763735,0,4296,1051258,4173,1023588,123,27670,2019,7,3925,80,0,39,216660.0,130000.0,-51.0,-47.0,-42.0,-48.0,-51.0,-50.0,-44.0,-46.0,-90.0,-92.0,-89.0,-92.0,39.0,45.0,47.0,44.0,0
7774,CC:2F:71:3F:1F:24,4486419,1190992184,658726,708228449,3827693,482763735,37,535967,566556219,535316,566477925,651,78294,518282,10,658963,69096,34,456,130000.0,43333.0,-73.0,-72.0,-77.0,-74.0,-73.0,-71.0,-76.0,-73.0,-90.0,-92.0,-89.0,-92.0,17.0,20.0,12.0,18.0,0
7775,CC:2F:71:3E:C5:1F,3828485,482860522,792,96787,3827693,482763735,0,3311,278089,2732,209323,579,68766,838,8,1139,18,0,37,130000.0,39000.0,-70.0,-71.0,-67.0,-60.0,-70.0,-71.0,-67.0,-60.0,-90.0,-92.0,-89.0,-92.0,20.0,21.0,22.0,32.0,0
7776,BA:8C:B9:54:50:24,3832441,488917050,4748,6153315,3827693,482763735,0,8482,1658538,8460,1655043,22,3495,2324,14,5141,36,0,53,216660.0,130000.0,-40.0,-36.0,-45.0,-51.0,-40.0,-36.0,-44.0,-50.0,-90.0,-92.0,-89.0,-92.0,50.0,56.0,44.0,41.0,0
7777,92:69:1D:31:68:E9,3831475,486347450,3777,3583251,3827698,482764199,0,4296,1051258,4173,1023588,123,27670,2019,7,3925,80,0,39,216660.0,130000.0,-51.0,-47.0,-42.0,-48.0,-51.0,-50.0,-44.0,-46.0,-90.0,-92.0,-89.0,-92.0,39.0,45.0,47.0,44.0,0
7778,CC:2F:71:3F:1F:24,4486467,1191007248,658769,708243049,3827698,482764199,37,535992,566561023,535341,566482729,651,78294,518307,10,659006,69108,34,456,130000.0,39000.0,-67.0,-65.0,-70.0,-68.0,-68.0,-66.0,-72.0,-69.0,-90.0,-92.0,-89.0,-92.0,23.0,27.0,19.0,24.0,0
7779,CC:2F:71:3E:C5:1F,3828491,482861102,793,96903,3827698,482764199,0,3312,278159,2733,209393,579,68766,838,8,1140,18,0,37,130000.0,39000.0,-70.0,-71.0,-67.0,-60.0,-70.0,-71.0,-67.0,-60.0,-90.0,-92.0,-89.0,-92.0,20.0,21.0,22.0,32.0,0
7780,BA:8C:B9:54:50:24,3832447,488917630,4749,6153431,3827698,482764199,0,8484,1658674,8462,1655179,22,3495,2324,14,5142,37,0,53,216660.0,130000.0,-49.0,-35.0,-42.0,-45.0,-42.0,-36.0,-44.0,-50.0,-90.0,-92.0,-89.0,-92.0,41.0,57.0,47.0,47.0,0
7781,92:69:1D:31:68:E9,3831480,486347970,3778,3583367,3827702,482764603,0,4298,1051394,4175,1023724,123,27670,2019,7,3926,80,0,40,216660.0,130000.0,-51.0,-47.0,-42.0,-49.0,-51.0,-49.0,-43.0,-47.0,-90.0,-92.0,-89.0,-92.0,39.0,45.0,47.0,43.0,0
7782,CC:2F:71:3F:1F:24,4486513,1191022080,658811,708257477,3827702,482764603,37,536018,566565943,535367,566487649,651,78294,518333,10,659048,69122,34,456,130000.0,39000.0,-67.0,-65.0,-71.0,-68.0,-67.0,-65.0,-70.0,-68.0,-90.0,-92.0,-89.0,-92.0,23.0,27.0,18.0,24.0,0
7783,CC:2F:71:3E:C5:1F,3828495,482861506,793,96903,3827702,482764603,0,3313,278229,2734,209463,579,68766,838,8,1140,18,0,37,130000.0,39000.0,-70.0,-71.0,-68.0,-60.0,-70.0,-71.0,-67.0,-60.0,-90.0,-92.0,-89.0,-92.0,20.0,21.0,21.0,32.0,0
7784,BA:8C:B9:54:50:24,3832451,488918034,4749,6153431,3827702,482764603,0,8484,1658674,8462,1655179,22,3495,2324,14,5142,37,0,53,216660.0,130000.0,-49.0,-35.0,-42.0,-45.0,-42.0,-36.0,-44.0,-50.0,-90.0,-92.0,-89.0,-92.0,41.0,57.0,47.0,47.0,0
7785,92:69:1D:31:68:E9,3831486,486348707,3778,3583367,3827708,482765340,0,4298,1051394,4175,1023724,123,27670,2019,7,3926,80,0,40,216660.0,130000.0,-51.0,-47.0,-42.0,-49.0,-51.0,-49.0,-43.0,-47.0,-90.0,-92.0,-89.0,-92.0,39.0,45.0,47.0,43.0,0
7786,CC:2F:71:3F:1F:24,4486560,1191037177,658852,708271837,3827708,482765340,37,536045,566571003,535394,566492709,651,78294,518360,10,659089,69123,34,456,130000.0,43333.0,-67.0,-65.0,-71.0,-68.0,-67.0,-65.0,-71.0,-68.0,-90.0,-92.0,-89.0,-92.0,23.0,27.0,18.0,24.0,0
7787,CC:2F:71:3E:C5:1F,3828501,482862243,793,96903,3827708,482765340,0,3313,278229,2734,209463,579,68766,838,8,1140,18,0,37,130000.0,39000.0,-70.0,-71.0,-68.0,-60.0,-70.0,-71.0,-67.0,-60.0,-90.0,-92.0,-89.0,-92.0,20.0,21.0,21.0,32.0,0
7788,BA:8C:B9:54:50:24,3832457,488918771,4749,6153431,3827708,482765340,0,8485,1658742,8463,1655247,22,3495,2324,14,5142,37,0,53,216660.0,130000.0,-39.0,-37.0,-44.0,-53.0,-42.0,-36.0,-44.0,-50.0,-90.0,-92.0,-89.0,-92.0,51.0,55.0,45.0,39.0,0
7789,92:69:1D:31:68:E9,3831490,486349111,3778,3583367,3827712,482765744,0,4298,1051394,4175,1023724,123,27670,2019,7,3926,80,0,40,216660.0,130000.0,-51.0,-47.0,-42.0,-49.0,-51.0,-49.0,-43.0,-47.0,-90.0,-92.0,-89.0,-92.0,39.0,45.0,47.0,43.0,0
7790,CC:2F:71:3F:1F:24,4486606,1191052071,658894,708286327,3827712,482765744,37,536073,566576179,535422,566497885,651,78294,518388,10,659131,69139,34,456,130000.0,39000.0,-67.0,-65.0,-71.0,-68.0,-67.0,-65.0,-70.0,-67.0,-90.0,-92.0,-89.0,-92.0,23.0,27.0,18.0,24.0,0
7791,CC:2F:71:3E:C5:1F,3828505,482862647,793,96903,3827712,482765744,0,3313,278229,2734,209463,579,68766,838,8,1140,18,0,37,130000.0,39000.0,-70.0,-71.0,-68.0,-60.0,-70.0,-71.0,-67.0,-60.0,-90.0,-92.0,-89.0,-92.0,20.0,21.0,21.0,32.0,0
7792,BA:8C:B9:54:50:24,3832461,488919175,4749,6153431,3827712,482765744,0,8485,1658742,8463,1655247,22,3495,2324,14,5142,37,0,53,216660.0,130000.0,-39.0,-37.0,-44.0,-53.0,-42.0,-36.0,-44.0,-50.0,-90.0,-92.0,-89.0,-92.0,51.0,55.0,45.0,39.0,0
7793,92:69:1D:31:68:E9,3831494,486349515,3778,3583367,3827716,482766148,0,4298,1051394,4175,1023724,123,27670,2019,7,3926,80,0,40,216660.0,130000.0,-51.0,-47.0,-42.0,-49.0,-51.0,-49.0,-43.0,-47.0,-90.0,-92.0,-89.0,-92.0,39.0,45.0,47.0,43.0,0
7794,CC:2F:71:3F:1F:24,4486653,1191066965,658936,708300755,3827717,482766210,37,536100,566581241,535448,566502829,652,78412,518415,10,659173,69150,34,456,130000.0,43333.0,-68.0,-66.0,-71.0,-68.0,-67.0,-65.0,-70.0,-68.0,-90.0,-92.0,-89.0,-92.0,22.0,26.0,18.0,24.0,0
7795,CC:2F:71:3E:C5:1F,3828510,482863113,793,96903,3827717,482766210,0,3313,278229,2734,209463,579,68766,838,8,1140,18,0,37,130000.0,39000.0,-70.0,-71.0,-68.0,-60.0,-70.0,-71.0,-67.0,-60.0,-90.0,-92.0,-89.0,-92.0,20.0,21.0,21.0,32.0,0
7796,BA:8C:B9:54:50:24,3832466,488919641,4749,6153431,3827717,482766210,0,8488,1658946,8466,1655451,22,3495,2324,14,5142,37,0,53,216660.0,130000.0,-40.0,-37.0,-45.0,-52.0,-43.0,-36.0,-43.0,-49.0,-90.0,-92.0,-89.0,-92.0,50.0,55.0,44.0,40.0,0
7797,92:69:1D:31:68:E9,3831500,486350041,3778,3583367,3827722,482766674,0,4298,1051394,4175,1023724,123,27670,2019,7,3926,80,0,40,216660.0,130000.0,-51.0,-47.0,-42.0,-49.0,-51.0,-49.0,-43.0,-47.0,-90.0,-92.0,-89.0,-92.0,39.0,45.0,47.0,43.0,0
7798,CC:2F:71:3F:1F:24,4486699,1191081727,658977,708315053,3827722,482766674,37,536126,566586185,535474,566507773,652,78412,518441,10,659214,69168,34,456,130000.0,39000.0,-67.0,-65.0,-70.0,-68.0,-67.0,-65.0,-70.0,-67.0,-90.0,-92.0,-89.0,-92.0,23.0,27.0,19.0,24.0,0
7799,CC:2F:71:3E:C5:1F,3828515,482863577,793,96903,3827722,482766674,0,3313,278229,2734,209463,579,68766,838,8,1140,18,0,37,130000.0,39000.0,-70.0,-71.0,-68.0,-60.0,-70.0,-71.0,-67.0,-60.0,-90.0,-92.0,-89.0,-92.0,20.0,21.0,21.0,32.0,0
7800,BA:8C:B9:54:50:24,3832471,488920105,4749,6153431,3827722,482766674,0,8490,1659082,8468,1655587,22,3495,2324,14,5142,37,0,53,216660.0,130000.0,-39.0,-37.0,-44.0,-53.0,-44.0,-35.0,-43.0,-48.0,-90.0,-92.0,-89.0,-92.0,51.0,55.0,45.0,39.0,0
7801,92:69:1D:31:68:E9,3831504,486350445,3778,3583367,3827726,482767078,0,4298,1051394,4175,1023724,123,27670,2019,7,3926,80,0,40,216660.0,130000.0,-51.0,-47.0,-42.0,-49.0,-51.0,-49.0,-43.0,-47.0,-90.0,-92.0,-89.0,-92.0,39.0,45.0,47.0,43.0,0
7802,CC:2F:71:3F:1F:24,4486746,1191096683,659020,708329605,3827726,482767078,37,536152,566591105,535500,566512693,652,78412,518467,10,659257,69183,34,456,130000.0,43333.0,-67.0,-65.0,-70.0,-67.0,-67.0,-65.0,-70.0,-67.0,-90.0,-92.0,-89.0,-92.0,23.0,27.0,19.0,25.0,0
7803,CC:2F:71:3E:C5:1F,3828519,482863981,793,96903,3827726,482767078,0,3313,278229,2734,209463,579,68766,838,8,1140,18,0,37,130000.0,39000.0,-70.0,-71.0,-68.0,-60.0,-70.0,-71.0,-67.0,-60.0,-90.0,-92.0,-89.0,-92.0,20.0,21.0,21.0,32.0,0
7804,BA:8C:B9:54:50:24,3832475,488920509,4749,6153431,3827726,482767078,0,8490,1659082,8468,1655587,22,3495,2324,14,5142,37,0,53,216660.0,130000.0,-39.0,-37.0,-44.0,-53.0,-44.0,-35.0,-43.0,-48.0,-90.0,-92.0,-89.0,-92.0,51.0,55.0,45.0,39.0,0
7805,92:69:1D:31:68:E9,3831508,486350849,3778,3583367,3827730,482767482,0,4300,1051530,4177,1023860,123,27670,2019,7,3927,80,0,40,216660.0,130000.0,-52.0,-50.0,-45.0,-46.0,-51.0,-49.0,-44.0,-47.0,-90.0,-92.0,-89.0,-92.0,38.0,42.0,44.0,46.0,0
7806,CC:2F:71:3F:1F:24,4486792,1191111835,659062,708344353,3827730,482767482,37,536179,566596199,535527,566517787,652,78412,518494,10,659299,69200,34,456,117000.0,39000.0,-67.0,-65.0,-70.0,-67.0,-67.0,-65.0,-70.0,-67.0,-90.0,-92.0,-89.0,-92.0,23.0,27.0,19.0,25.0,0
7807,CC:2F:71:3E:C5:1F,3828523,482864385,793,96903,3827730,482767482,0,3315,278369,2736,209603,579,68766,838,8,1141,18,0,37,130000.0,39000.0,-70.0,-71.0,-67.0,-60.0,-70.0,-71.0,-67.0,-60.0,-90.0,-92.0,-89.0,-92.0,20.0,21.0,22.0,32.0,0
7808,BA:8C:B9:54:50:24,3832480,488920973,4749,6153431,3827731,482767542,0,8490,1659082,8468,1655587,22,3495,2324,14,5142,37,0,53,216660.0,130000.0,-39.0,-37.0,-44.0,-53.0,-44.0,-35.0,-43.0,-48.0,-90.0,-92.0,-89.0,-92.0,51.0,55.0,45.0,39.0,0
7809,92:69:1D:31:68:E9,3831513,486351313,3778,3583367,3827735,482767946,0,4300,1051530,4177,1023860,123,27670,2019,7,3927,80,0,40,216660.0,130000.0,-52.0,-50.0,-45.0,-46.0,-51.0,-49.0,-44.0,-47.0,-90.0,-92.0,-89.0,-92.0,38.0,42.0,44.0,46.0,0
7810,CC:2F:71:3F:1F:24,4486841,1191126919,659106,708358973,3827735,482767946,37,536204,566601003,535552,566522591,652,78412,518519,10,659342,69208,34,456,130000.0,39000.0,-67.0,-65.0,-70.0,-67.0,-67.0,-65.0,-70.0,-67.0,-90.0,-92.0,-89.0,-92.0,23.0,27.0,19.0,25.0,0
7811,CC:2F:71:3E:C5:1F,3828528,482864849,793,96903,3827735,482767946,0,3315,278369,2736,209603,579,68766,838,8,1141,18,0,37,130000.0,39000.0,-70.0,-71.0,-67.0,-60.0,-70.0,-71.0,-67.0,-60.0,-90.0,-92.0,-89.0,-92.0,20.0,21.0,22.0,32.0,0
7812,BA:8C:B9:54:50:24,3832484,488921377,4749,6153431,3827735,482767946,0,8490,1659082,8468,1655587,22,3495,2324,14,5142,37,0,53,216660.0,130000.0,-39.0,-37.0,-44.0,-53.0,-44.0,-35.0,-43.0,-48.0,-90.0,-92.0,-89.0,-92.0,51.0,55.0,45.0,39.0,0
7813,92:69:1D:31:68:E9,3831517,486351717,3778,3583367,3827739,482768350,0,4300,1051530,4177,1023860,123,27670,2019,7,3927,80,0,40,216660.0,130000.0,-52.0,-50.0,-45.0,-46.0,-51.0,-49.0,-44.0,-47.0,-90.0,-92.0,-89.0,-92.0,38.0,42.0,44.0,46.0,0
7814,CC:2F:71:3F:1F:24,4486886,1191141565,659147,708373215,3827739,482768350,37,536229,566605807,535577,566527395,652,78412,518544,10,659384,69248,34,456,130000.0,43333.0,-67.0,-65.0,-70.0,-68.0,-67.0,-65.0,-70.0,-67.0,-90.0,-92.0,-89.0,-92.0,23.0,27.0,19.0,24.0,0
7815,CC:2F:71:3E:C5:1F,3828532,482865253,793,96903,3827739,482768350,0,3315,278369,2736,209603,579,68766,838,8,1141,18,0,37,130000.0,39000.0,-70.0,-71.0,-67.0,-60.0,-70.0,-71.0,-67.0,-60.0,-90.0,-92.0,-89.0,-92.0,20.0,21.0,22.0,32.0,0
7816,BA:8C:B9:54:50:24,3832488,488921781,4749,6153431,3827739,482768350,0,8490,1659082,8468,1655587,22,3495,2324,14,5142,37,0,53,216660.0,130000.0,-39.0,-37.0,-44.0,-53.0,-44.0,-35.0,-43.0,-48.0,-90.0,-92.0,-89.0,-92.0,51.0,55.0,45.0,39.0,0
7817,92:69:1D:31:68:E9,3831522,486352181,3778,3583367,3827744,482768814,0,4300,1051530,4177,1023860,123,27670,2019,7,3927,80,0,40,216660.0,130000.0,-52.0,-50.0,-45.0,-46.0,-51.0,-49.0,-44.0,-47.0,-90.0,-92.0,-89.0,-92.0,38.0,42.0,44.0,46.0,0
7818,CC:2F:71:3F:1F:24,4486933,1191156569,659189,708387755,3827744,482768814,37,536256,566610867,535604,566532455,652,78412,518571,10,659426,69254,34,456,130000.0,43333.0,-67.0,-65.0,-70.0,-68.0,-67.0,-65.0,-70.0,-67.0,-90.0,-92.0,-89.0,-92.0,23.0,27.0,19.0,24.0,0
7819,CC:2F:71:3E:C5:1F,3828537,482865717,793,96903,3827744,482768814,0,3315,278369,2736,209603,579,68766,838,8,1141,18,0,37,130000.0,39000.0,-70.0,-71.0,-67.0,-60.0,-70.0,-71.0,-67.0,-60.0,-90.0,-92.0,-89.0,-92.0,20.0,21.0,22.0,32.0,0
7820,BA:8C:B9:54:50:24,3832493,488922245,4749,6153431,3827744,482768814,0,8490,1659082,8468,1655587,22,3495,2324,14,5142,37,0,53,216660.0,130000.0,-39.0,-37.0,-44.0,-53.0,-44.0,-35.0,-43.0,-48.0,-90.0,-92.0,-89.0,-92.0,51.0,55.0,45.0,39.0,0
7821,92:69:1D:31:68:E9,3831524,486352383,3778,3583367,3827746,482769016,0,4300,1051530,4177,1023860,123,27670,2019,7,3927,80,0,40,216660.0,130000.0,-52.0,-50.0,-45.0,-46.0,-51.0,-49.0,-44.0,-47.0,-90.0,-92.0,-89.0,-92.0,38.0,42.0,44.0,46.0,0
7822,CC:2F:71:3F:1F:24,4486979,1191171457,659231,708402239,3827748,482769218,37,536281,566615671,535629,566537259,652,78412,518596,10,659468,69273,34,456,117000.0,39000.0,-67.0,-65.0,-70.0,-67.0,-67.0,-65.0,-70.0,-67.0,-90.0,-92.0,-89.0,-92.0,23.0,27.0,19.0,25.0,0
7823,CC:2F:71:3E:C5:1F,3828541,482866121,793,96903,3827748,482769218,0,3315,278369,2736,209603,579,68766,838,8,1141,18,0,37,130000.0,39000.0,-70.0,-71.0,-67.0,-60.0,-70.0,-71.0,-67.0,-60.0,-90.0,-92.0,-89.0,-92.0,20.0,21.0,22.0,32.0,0
7824,BA:8C:B9:54:50:24,3832497,488922649,4749,6153431,3827748,482769218,0,8490,1659082,8468,1655587,22,3495,2324,14,5142,37,0,53,216660.0,130000.0,-39.0,-37.0,-44.0,-53.0,-44.0,-35.0,-43.0,-48.0,-90.0,-92.0,-89.0,-92.0,51.0,55.0,45.0,39.0,0
7825,92:69:1D:31:68:E9,3831531,486353051,3778,3583367,3827753,482769684,0,4300,1051530,4177,1023860,123,27670,2019,7,3927,80,0,40,216660.0,130000.0,-52.0,-50.0,-45.0,-46.0,-51.0,-49.0,-44.0,-47.0,-90.0,-92.0,-89.0,-92.0,38.0,42.0,44.0,46.0,0
7826,CC:2F:71:3F:1F:24,4487026,1191186289,659273,708416605,3827753,482769684,37,536309,566620847,535657,566542435,652,78412,518624,10,659510,69277,34,456,130000.0,43333.0,-67.0,-65.0,-70.0,-68.0,-67.0,-65.0,-70.0,-67.0,-90.0,-92.0,-89.0,-92.0,23.0,27.0,19.0,24.0,0
7827,CC:2F:71:3E:C5:1F,3828546,482866587,793,96903,3827753,482769684,0,3317,278557,2737,209673,580,68884,839,8,1141,18,0,37,130000.0,39000.0,-70.0,-71.0,-67.0,-60.0,-70.0,-71.0,-67.0,-60.0,-90.0,-92.0,-89.0,-92.0,20.0,21.0,22.0,32.0,0
7828,BA:8C:B9:54:50:24,3832502,488923115,4749,6153431,3827753,482769684,0,8490,1659082,8468,1655587,22,3495,2324,14,5142,37,0,53,216660.0,130000.0,-39.0,-37.0,-44.0,-53.0,-44.0,-35.0,-43.0,-48.0,-90.0,-92.0,-89.0,-92.0,51.0,55.0,45.0,39.0,0
7829,92:69:1D:31:68:E9,3831532,486353111,3778,3583367,3827754,482769744,0,4300,1051530,4177,1023860,123,27670,2019,7,3927,80,0,40,216660.0,130000.0,-52.0,-50.0,-45.0,-46.0,-51.0,-49.0,-44.0,-47.0,-90.0,-92.0,-89.0,-92.0,38.0,42.0,44.0,46.0,0
7830,CC:2F:71:3F:1F:24,4487073,1191201293,659315,708431145,3827758,482770148,37,536335,566625767,535683,566547355,652,78412,518650,10,659552,69283,34,456,130000.0,43333.0,-67.0,-65.0,-70.0,-68.0,-67.0,-65.0,-70.0,-67.0,-90.0,-92.0,-89.0,-92.0,23.0,27.0,19.0,24.0,0
7831,CC:2F:71:3E:C5:1F,3828551,482867051,793,96903,3827758,482770148,0,3317,278557,2737,209673,580,68884,839,8,1141,18,0,37,130000.0,39000.0,-70.0,-71.0,-67.0,-60.0,-70.0,-71.0,-67.0,-60.0,-90.0,-92.0,-89.0,-92.0,20.0,21.0,22.0,32.0,0
7832,BA:8C:B9:54:50:24,3832507,488923579,4749,6153431,3827758,482770148,0,8490,1659082,8468,1655587,22,3495,2324,14,5142,37,0,53,216660.0,130000.0,-39.0,-37.0,-44.0,-53.0,-44.0,-35.0,-43.0,-48.0,-90.0,-92.0,-89.0,-92.0,51.0,55.0,45.0,39.0,0
7833,92:69:1D:31:68:E9,3831540,486353919,3778,3583367,3827762,482770552,0,4300,1051530,4177,1023860,123,27670,2019,7,3927,80,0,40,216660.0,130000.0,-52.0,-50.0,-45.0,-46.0,-51.0,-49.0,-44.0,-47.0,-90.0,-92.0,-89.0,-92.0,38.0,42.0,44.0,46.0,0
7834,CC:2F:71:3F:1F:24,4487120,1191216249,659358,708445697,3827762,482770552,37,536361,566630711,535709,566552299,652,78412,518676,10,659594,69312,34,456,144444.0,39000.0,-67.0,-65.0,-70.0,-67.0,-67.0,-65.0,-70.0,-67.0,-90.0,-92.0,-89.0,-92.0,23.0,27.0,19.0,25.0,0
7835,CC:2F:71:3E:C5:1F,3828555,482867455,793,96903,3827762,482770552,0,3317,278557,2737,209673,580,68884,839,8,1141,18,0,37,130000.0,39000.0,-70.0,-71.0,-67.0,-60.0,-70.0,-71.0,-67.0,-60.0,-90.0,-92.0,-89.0,-92.0,20.0,21.0,22.0,32.0,0
7836,BA:8C:B9:54:50:24,3832512,488924109,4749,6153431,3827763,482770678,0,8490,1659082,8468,1655587,22,3495,2324,14,5142,37,0,53,216660.0,130000.0,-39.0,-37.0,-44.0,-53.0,-44.0,-35.0,-43.0,-48.0,-90.0,-92.0,-89.0,-92.0,51.0,55.0,45.0,39.0,0
7837,92:69:1D:31:68:E9,3831542,486354318,3778,3583367,3827764,482770951,0,4300,1051530,4177,1023860,123,27670,2019,7,3927,80,0,40,216660.0,130000.0,-52.0,-50.0,-45.0,-46.0,-51.0,-49.0,-44.0,-47.0,-90.0,-92.0,-89.0,-92.0,38.0,42.0,44.0,46.0,0
7838,CC:2F:71:3F:1F:24,4487168,1191231410,659399,708459995,3827769,482771415,37,536386,566635515,535734,566557103,652,78412,518701,10,659636,69329,34,456,130000.0,43333.0,-68.0,-66.0,-71.0,-68.0,-67.0,-65.0,-70.0,-68.0,-90.0,-92.0,-89.0,-92.0,22.0,26.0,18.0,24.0,0
7839,CC:2F:71:3E:C5:1F,3828562,482868318,793,96903,3827769,482771415,0,3317,278557,2737,209673,580,68884,839,8,1141,18,0,37,130000.0,39000.0,-70.0,-71.0,-67.0,-60.0,-70.0,-71.0,-67.0,-60.0,-90.0,-92.0,-89.0,-92.0,20.0,21.0,22.0,32.0,0
7840,BA:8C:B9:54:50:24,3832518,488924846,4749,6153431,3827769,482771415,0,8490,1659082,8468,1655587,22,3495,2324,14,5142,37,0,53,216660.0,130000.0,-39.0,-37.0,-44.0,-53.0,-44.0,-35.0,-43.0,-48.0,-90.0,-92.0,-89.0,-92.0,51.0,55.0,45.0,39.0,0
7841,92:69:1D:31:68:E9,3831551,486355186,3778,3583367,3827773,482771819,0,4300,1051530,4177,1023860,123,27670,2019,7,3927,80,0,40,216660.0,130000.0,-52.0,-50.0,-45.0,-46.0,-51.0,-49.0,-44.0,-47.0,-90.0,-92.0,-89.0,-92.0,38.0,42.0,44.0,46.0,0
7842,CC:2F:71:3F:1F:24,4487213,1191246174,659440,708474355,3827773,482771819,37,536412,566640459,535760,566562047,652,78412,518727,10,659677,69344,34,456,130000.0,39000.0,-67.0,-65.0,-71.0,-68.0,-67.0,-65.0,-70.0,-68.0,-90.0,-92.0,-89.0,-92.0,23.0,27.0,18.0,24.0,0
7843,CC:2F:71:3E:C5:1F,3828566,482868722,793,96903,3827773,482771819,0,3317,278557,2737,209673,580,68884,839,8,1141,18,0,37,130000.0,39000.0,-70.0,-71.0,-67.0,-60.0,-70.0,-71.0,-67.0,-60.0,-90.0,-92.0,-89.0,-92.0,20.0,21.0,22.0,32.0,0
7844,BA:8C:B9:54:50:24,3832522,488925250,4749,6153431,3827773,482771819,0,8490,1659082,8468,1655587,22,3495,2324,14,5142,37,0,53,216660.0,130000.0,-39.0,-37.0,-44.0,-53.0,-44.0,-35.0,-43.0,-48.0,-90.0,-92.0,-89.0,-92.0,51.0,55.0,45.0,39.0,0
7845,92:69:1D:31:68:E9,3831551,486355186,3778,3583367,3827773,482771819,0,4300,1051530,4177,1023860,123,27670,2019,7,3927,80,0,40,216660.0,130000.0,-52.0,-50.0,-45.0,-46.0,-51.0,-49.0,-44.0,-47.0,-90.0,-92.0,-89.0,-92.0,38.0,42.0,44.0,46.0,0
7846,CC:2F:71:3F:1F:24,4487258,1191260934,659483,708488913,3827775,482772021,37,536438,566645403,535786,566566991,652,78412,518753,10,659720,69357,34,456,130000.0,39000.0,-67.0,-65.0,-71.0,-68.0,-67.0,-65.0,-70.0,-68.0,-90.0,-92.0,-89.0,-92.0,23.0,27.0,18.0,24.0,0
7847,CC:2F:71:3E:C5:1F,3828568,482868924,793,96903,3827775,482772021,0,3317,278557,2737,209673,580,68884,839,8,1141,18,0,37,130000.0,39000.0,-70.0,-71.0,-67.0,-60.0,-70.0,-71.0,-67.0,-60.0,-90.0,-92.0,-89.0,-92.0,20.0,21.0,22.0,32.0,0
7848,BA:8C:B9:54:50:24,3832524,488925452,4749,6153431,3827775,482772021,0,8490,1659082,8468,1655587,22,3495,2324,14,5142,37,0,53,216660.0,130000.0,-39.0,-37.0,-44.0,-53.0,-44.0,-35.0,-43.0,-48.0,-90.0,-92.0,-89.0,-92.0,51.0,55.0,45.0,39.0,0
7849,92:69:1D:31:68:E9,3831560,486356054,3778,3583367,3827782,482772687,0,4300,1051530,4177,1023860,123,27670,2019,7,3927,80,0,40,216660.0,130000.0,-52.0,-50.0,-45.0,-46.0,-51.0,-49.0,-44.0,-47.0,-90.0,-92.0,-89.0,-92.0,38.0,42.0,44.0,46.0,0
7850,CC:2F:71:3F:1F:24,4487307,1191275972,659525,708503285,3827782,482772687,37,536463,566650207,535811,566571795,652,78412,518778,10,659762,69377,34,456,117000.0,39000.0,-67.0,-65.0,-71.0,-68.0,-67.0,-65.0,-70.0,-68.0,-90.0,-92.0,-89.0,-92.0,23.0,27.0,18.0,24.0,0
7851,CC:2F:71:3E:C5:1F,3828575,482869590,793,96903,3827782,482772687,0,3317,278557,2737,209673,580,68884,839,8,1141,18,0,37,130000.0,39000.0,-70.0,-71.0,-67.0,-60.0,-70.0,-71.0,-67.0,-60.0,-90.0,-92.0,-89.0,-92.0,20.0,21.0,22.0,32.0,0
7852,BA:8C:B9:54:50:24,3832531,488926118,4749,6153431,3827782,482772687,0,8490,1659082,8468,1655587,22,3495,2324,14,5142,37,0,53,216660.0,130000.0,-39.0,-37.0,-44.0,-53.0,-44.0,-35.0,-43.0,-48.0,-90.0,-92.0,-89.0,-92.0,51.0,55.0,45.0,39.0,0
7853,92:69:1D:31:68:E9,3831560,486356054,3778,3583367,3827782,482772687,0,4300,1051530,4177,1023860,123,27670,2019,7,3927,80,0,40,216660.0,130000.0,-52.0,-50.0,-45.0,-46.0,-51.0,-49.0,-44.0,-47.0,-90.0,-92.0,-89.0,-92.0,38.0,42.0,44.0,46.0,0
7854,CC:2F:71:3F:1F:24,4487350,1191290478,659566,708517589,3827784,482772889,37,536488,566655011,535836,566576599,652,78412,518803,10,659803,69387,34,456,130000.0,43333.0,-67.0,-65.0,-70.0,-68.0,-67.0,-65.0,-70.0,-68.0,-90.0,-92.0,-89.0,-92.0,23.0,27.0,19.0,24.0,0
7855,CC:2F:71:3E:C5:1F,3828577,482869792,793,96903,3827784,482772889,0,3317,278557,2737,209673,580,68884,839,8,1141,18,0,37,130000.0,39000.0,-70.0,-71.0,-67.0,-60.0,-70.0,-71.0,-67.0,-60.0,-90.0,-92.0,-89.0,-92.0,20.0,21.0,22.0,32.0,0
7856,BA:8C:B9:54:50:24,3832535,488926604,4751,6153715,3827784,482772889,0,8496,1659570,8474,1656075,22,3495,2325,14,5144,37,0,53,216660.0,130000.0,-45.0,-38.0,-46.0,-49.0,-42.0,-35.0,-43.0,-49.0,-90.0,-92.0,-89.0,-92.0,45.0,54.0,43.0,43.0,0
7857,92:69:1D:31:68:E9,3831568,486356862,3778,3583367,3827790,482773495,0,4300,1051530,4177,1023860,123,27670,2019,7,3927,80,0,40,216660.0,130000.0,-52.0,-50.0,-45.0,-46.0,-51.0,-49.0,-44.0,-47.0,-90.0,-92.0,-89.0,-92.0,38.0,42.0,44.0,46.0,0
7858,CC:2F:71:3F:1F:24,4487399,1191305714,659609,708532219,3827790,482773495,37,536513,566659815,535861,566581403,652,78412,518828,10,659846,69407,34,456,130000.0,39000.0,-67.0,-65.0,-71.0,-67.0,-67.0,-65.0,-70.0,-67.0,-90.0,-92.0,-89.0,-92.0,23.0,27.0,18.0,25.0,0
7859,CC:2F:71:3E:C5:1F,3828583,482870398,793,96903,3827790,482773495,0,3317,278557,2737,209673,580,68884,839,8,1141,18,0,37,130000.0,39000.0,-70.0,-71.0,-67.0,-60.0,-70.0,-71.0,-67.0,-60.0,-90.0,-92.0,-89.0,-92.0,20.0,21.0,22.0,32.0,0
7860,BA:8C:B9:54:50:24,3832541,488927210,4751,6153715,3827790,482773495,0,8497,1659638,8475,1656143,22,3495,2325,14,5144,37,0,53,216660.0,130000.0,-40.0,-37.0,-45.0,-52.0,-40.0,-36.0,-44.0,-50.0,-90.0,-92.0,-89.0,-92.0,50.0,55.0,44.0,40.0,0
7861,92:69:1D:31:68:E9,3831569,486356922,3778,3583367,3827791,482773555,0,4300,1051530,4177,1023860,123,27670,2019,7,3927,80,0,40,216660.0,130000.0,-52.0,-50.0,-45.0,-46.0,-51.0,-49.0,-44.0,-47.0,-90.0,-92.0,-89.0,-92.0,38.0,42.0,44.0,46.0,0
7862,CC:2F:71:3F:1F:24,4487443,1191320270,659652,708546715,3827791,482773555,37,536539,566664759,535887,566586347,652,78412,518854,10,659889,69415,34,456,130000.0,43333.0,-67.0,-65.0,-71.0,-68.0,-67.0,-65.0,-70.0,-68.0,-90.0,-92.0,-89.0,-92.0,23.0,27.0,18.0,24.0,0
7863,CC:2F:71:3E:C5:1F,3828586,482870660,793,96903,3827793,482773757,0,3317,278557,2737,209673,580,68884,839,8,1141,18,0,37,130000.0,39000.0,-70.0,-71.0,-67.0,-60.0,-70.0,-71.0,-67.0,-60.0,-90.0,-93.0,-90.0,-93.0,20.0,22.0,23.0,33.0,0
7864,BA:8C:B9:54:50:24,3832544,488927472,4751,6153715,3827793,482773757,0,8497,1659638,8475,1656143,22,3495,2325,14,5144,37,0,53,216660.0,130000.0,-40.0,-37.0,-45.0,-52.0,-40.0,-36.0,-44.0,-50.0,-90.0,-93.0,-90.0,-93.0,50.0,56.0,45.0,41.0,0
7865,92:69:1D:31:68:E9,3831577,486357730,3778,3583367,3827799,482774363,0,4300,1051530,4177,1023860,123,27670,2019,7,3927,80,0,40,216660.0,130000.0,-52.0,-50.0,-45.0,-46.0,-51.0,-49.0,-44.0,-47.0,-90.0,-93.0,-90.0,-93.0,38.0,43.0,45.0,47.0,0
7866,CC:2F:71:3F:1F:24,4487494,1191335748,659695,708561385,3827799,482774363,37,536565,566669703,535913,566591291,652,78412,518880,10,659931,69423,34,456,130000.0,43333.0,-68.0,-66.0,-71.0,-69.0,-67.0,-65.0,-70.0,-68.0,-90.0,-93.0,-90.0,-93.0,22.0,27.0,19.0,24.0,0
7867,CC:2F:71:3E:C5:1F,3828592,482871266,793,96903,3827799,482774363,0,3317,278557,2737,209673,580,68884,839,8,1141,18,0,37,130000.0,39000.0,-70.0,-71.0,-67.0,-60.0,-70.0,-71.0,-67.0,-60.0,-90.0,-93.0,-90.0,-93.0,20.0,22.0,23.0,33.0,0
7868,BA:8C:B9:54:50:24,3832550,488928078,4751,6153715,3827799,482774363,0,8497,1659638,8475,1656143,22,3495,2325,14,5144,37,0,53,216660.0,130000.0,-40.0,-37.0,-45.0,-52.0,-40.0,-36.0,-44.0,-50.0,-90.0,-93.0,-90.0,-93.0,50.0,56.0,45.0,41.0,0
7869,92:69:1D:31:68:E9,3831578,486357790,3778,3583367,3827800,482774423,0,4301,1051598,4178,1023928,123,27670,2019,7,3927,80,0,40,216660.0,130000.0,-51.0,-47.0,-42.0,-49.0,-51.0,-48.0,-43.0,-48.0,-90.0,-93.0,-90.0,-93.0,39.0,46.0,48.0,44.0,0
7870,CC:2F:71:3F:1F:24,4487536,1191350112,659736,708575689,3827800,482774423,37,536592,566674763,535940,566596351,652,78412,518907,10,659973,69445,34,456,117000.0,39000.0,-67.0,-65.0,-70.0,-67.0,-67.0,-65.0,-70.0,-67.0,-90.0,-93.0,-90.0,-93.0,23.0,28.0,20.0,26.0,0
7871,CC:2F:71:3E:C5:1F,3828593,482871326,793,96903,3827800,482774423,0,3317,278557,2737,209673,580,68884,839,8,1141,18,0,37,130000.0,39000.0,-70.0,-71.0,-67.0,-60.0,-70.0,-71.0,-67.0,-60.0,-90.0,-93.0,-90.0,-93.0,20.0,22.0,23.0,33.0,0
7872,BA:8C:B9:54:50:24,3832553,488928340,4751,6153715,3827802,482774625,0,8497,1659638,8475,1656143,22,3495,2325,14,5144,37,0,53,216660.0,130000.0,-40.0,-37.0,-45.0,-52.0,-40.0,-36.0,-44.0,-50.0,-90.0,-93.0,-90.0,-93.0,50.0,56.0,45.0,41.0,0
7873,92:69:1D:31:68:E9,3831586,486358598,3778,3583367,3827808,482775231,0,4301,1051598,4178,1023928,123,27670,2019,7,3927,80,0,40,216660.0,130000.0,-51.0,-47.0,-42.0,-49.0,-51.0,-48.0,-43.0,-48.0,-90.0,-93.0,-90.0,-93.0,39.0,46.0,48.0,44.0,0
7874,CC:2F:71:3F:1F:24,4487585,1191365224,659777,708589993,3827808,482775231,37,536618,566679707,535966,566601295,652,78412,518933,10,660014,69447,34,456,130000.0,43333.0,-67.0,-65.0,-70.0,-67.0,-67.0,-65.0,-70.0,-67.0,-90.0,-93.0,-90.0,-93.0,23.0,28.0,20.0,26.0,0
7875,CC:2F:71:3E:C5:1F,3828601,482872134,793,96903,3827808,482775231,0,3317,278557,2737,209673,580,68884,839,8,1141,18,0,37,130000.0,39000.0,-70.0,-71.0,-67.0,-60.0,-70.0,-71.0,-67.0,-60.0,-90.0,-93.0,-90.0,-93.0,20.0,22.0,23.0,33.0,0
7876,BA:8C:B9:54:50:24,3832559,488928946,4751,6153715,3827808,482775231,0,8497,1659638,8475,1656143,22,3495,2325,14,5144,37,0,53,216660.0,130000.0,-40.0,-37.0,-45.0,-52.0,-40.0,-36.0,-44.0,-50.0,-90.0,-93.0,-90.0,-93.0,50.0,56.0,45.0,41.0,0
7877,92:69:1D:31:68:E9,3831586,486358598,3778,3583367,3827808,482775231,0,4301,1051598,4178,1023928,123,27670,2019,7,3927,80,0,40,216660.0,130000.0,-51.0,-47.0,-42.0,-49.0,-51.0,-48.0,-43.0,-48.0,-90.0,-93.0,-90.0,-93.0,39.0,46.0,48.0,44.0,0
7878,CC:2F:71:3F:1F:24,4487627,1191379764,659819,708604533,3827808,482775231,37,536645,566684767,535993,566606355,652,78412,518960,10,660056,69453,34,456,130000.0,43333.0,-67.0,-65.0,-70.0,-67.0,-67.0,-65.0,-70.0,-67.0,-90.0,-93.0,-90.0,-93.0,23.0,28.0,20.0,26.0,0
7879,CC:2F:71:3E:C5:1F,3828601,482872134,793,96903,3827808,482775231,0,3317,278557,2737,209673,580,68884,839,8,1141,18,0,37,130000.0,39000.0,-70.0,-71.0,-67.0,-60.0,-70.0,-71.0,-67.0,-60.0,-90.0,-93.0,-90.0,-93.0,20.0,22.0,23.0,33.0,0
7880,BA:8C:B9:54:50:24,3832560,488929080,4751,6153715,3827809,482775365,0,8497,1659638,8475,1656143,22,3495,2325,14,5144,37,0,53,216660.0,130000.0,-40.0,-37.0,-45.0,-52.0,-40.0,-36.0,-44.0,-50.0,-90.0,-93.0,-90.0,-93.0,50.0,56.0,45.0,41.0,0
7881,92:69:1D:31:68:E9,3831595,486359466,3778,3583367,3827817,482776099,0,4301,1051598,4178,1023928,123,27670,2019,7,3927,80,0,40,216660.0,130000.0,-51.0,-47.0,-42.0,-49.0,-51.0,-48.0,-43.0,-48.0,-90.0,-93.0,-90.0,-93.0,39.0,46.0,48.0,44.0,0
7882,CC:2F:71:3F:1F:24,4487680,1191395314,659863,708619215,3827817,482776099,37,536671,566689711,536019,566611299,652,78412,518986,10,660100,69470,34,456,130000.0,39000.0,-67.0,-65.0,-70.0,-67.0,-67.0,-65.0,-70.0,-67.0,-90.0,-93.0,-90.0,-93.0,23.0,28.0,20.0,26.0,0
7883,CC:2F:71:3E:C5:1F,3828610,482873002,793,96903,3827817,482776099,0,3317,278557,2737,209673,580,68884,839,8,1141,18,0,37,130000.0,39000.0,-70.0,-71.0,-67.0,-60.0,-70.0,-71.0,-67.0,-60.0,-90.0,-93.0,-90.0,-93.0,20.0,22.0,23.0,33.0,0
7884,BA:8C:B9:54:50:24,3832569,488929930,4752,6153831,3827817,482776099,0,8506,1660292,8484,1656797,22,3495,2326,14,5145,37,0,53,216660.0,1000.0,-49.0,-35.0,-42.0,-44.0,-44.0,-36.0,-44.0,-47.0,-90.0,-93.0,-90.0,-93.0,41.0,58.0,48.0,49.0,0
