sample,station,tx_total_pkts,tx_total_bytes,tx_ucast_pkts,tx_ucast_bytes,tx_mcast_bcast_pkts,tx_mcast_bcast_bytes,tx_failures,rx_data_pkts,rx_data_bytes,rx_ucast_pkts,rx_ucast_bytes,rx_mcast_bcast_pkts,rx_mcast_bcast_bytes,rx_decrypt_succeeds,tx_data_pkts_retried,tx_total_pkts_sent,tx_pkts_retries,tx_pkts_retry_exhausted,rx_total_pkts_retried,rate_last_tx_pkt_min,rate_last_tx_pkt_max,per_antenna_rssi_last_rx_data_frame_1,per_antenna_rssi_last_rx_data_frame_2,per_antenna_rssi_last_rx_data_frame_3,per_antenna_rssi_last_rx_data_frame_4,per_antenna_avg_rssi_rx_data_frames_1,per_antenna_avg_rssi_rx_data_frames_2,per_antenna_avg_rssi_rx_data_frames_3,per_antenna_avg_rssi_rx_data_frames_4,per_antenna_noise_floor_1,per_antenna_noise_floor_2,per_antenna_noise_floor_3,per_antenna_noise_floor_4,sinr_per_antenna_1,sinr_per_antenna_2,sinr_per_antenna_3,sinr_per_antenna_4,attack
1,92:69:1D:31:68:E9,3834479,486725900,3827,3595450,3830652,483130450,0,4474,1067225,4344,1037910,130,29315,2051,10,3996,83,0,41,229410.0,130000.0,-51.0,-45.0,-43.0,-48.0,-51.0,-49.0,-44.0,-48.0,-90.0,-93.0,-89.0,-93.0,39.0,48.0,46.0,45.0,1
2,CC:2F:71:3F:1F:24,4490848,1191807499,660196,708677049,3830652,483130450,37,538576,569020062,537902,568939054,674,81008,520818,15,660444,69617,34,458,144444.0,43333.0,-69.0,-65.0,-67.0,-68.0,-69.0,-65.0,-67.0,-68.0,-90.0,-93.0,-89.0,-93.0,21.0,28.0,22.0,25.0,1
3,CC:2F:71:3E:C5:1F,3831474,483230802,822,100352,3830652,483130450,0,3437,288480,2835,217000,602,71480,868,8,1181,18,0,37,130000.0,39000.0,-69.0,-70.0,-68.0,-60.0,-69.0,-70.0,-67.0,-61.0,-90.0,-93.0,-89.0,-93.0,21.0,23.0,21.0,33.0,1
4,BA:8C:B9:54:50:24,3835427,489286669,4775,6156219,3830652,483130450,0,8659,1670696,8637,1667201,22,3495,2326,14,5184,38,0,55,216660.0,130000.0,-40.0,-37.0,-46.0,-51.0,-41.0,-35.0,-43.0,-47.0,-90.0,-93.0,-89.0,-93.0,50.0,56.0,43.0,42.0,1
5,92:69:1D:31:68:E9,3834483,486726435,3827,3595450,3830656,483130985,0,4474,1067225,4344,1037910,130,29315,2051,10,3996,83,0,41,229410.0,130000.0,-51.0,-45.0,-43.0,-48.0,-51.0,-49.0,-44.0,-48.0,-90.0,-93.0,-89.0,-93.0,39.0,48.0,46.0,45.0,1
6,CC:2F:71:3F:1F:24,4490895,1191822925,660239,708691940,3830656,483130985,37,538602,569024463,537928,568943455,674,81008,520843,15,660487,69633,34,458,144444.0,43333.0,-70.0,-64.0,-67.0,-69.0,-69.0,-64.0,-67.0,-69.0,-90.0,-93.0,-89.0,-93.0,20.0,29.0,22.0,24.0,1
7,CC:2F:71:3E:C5:1F,3831478,483231337,822,100352,3830656,483130985,0,3437,288480,2835,217000,602,71480,868,8,1181,18,0,37,130000.0,39000.0,-69.0,-70.0,-68.0,-60.0,-69.0,-70.0,-67.0,-61.0,-90.0,-93.0,-89.0,-93.0,21.0,23.0,21.0,33.0,1
8,BA:8C:B9:54:50:24,3835431,489287204,4775,6156219,3830656,483130985,0,8659,1670696,8637,1667201,22,3495,2326,14,5184,38,0,55,216660.0,130000.0,-40.0,-37.0,-46.0,-51.0,-41.0,-35.0,-43.0,-47.0,-90.0,-93.0,-89.0,-93.0,50.0,56.0,43.0,42.0,1
9,92:69:1D:31:68:E9,3834489,486727041,3827,3595450,3830662,483131591,0,4474,1067225,4344,1037910,130,29315,2051,10,3996,83,0,41,229410.0,130000.0,-51.0,-45.0,-43.0,-48.0,-51.0,-49.0,-44.0,-48.0,-90.0,-93.0,-89.0,-93.0,39.0,48.0,46.0,45.0,1
10,CC:2F:71:3F:1F:24,4490941,1191837835,660279,708706244,3830662,483131591,37,538624,569028313,537950,568947305,674,81008,520864,15,660527,69675,34,458,144444.0,43333.0,-69.0,-64.0,-68.0,-70.0,-70.0,-64.0,-67.0,-70.0,-90.0,-93.0,-89.0,-93.0,21.0,29.0,21.0,23.0,1
11,CC:2F:71:3E:C5:1F,3831484,483231943,822,100352,3830662,483131591,0,3437,288480,2835,217000,602,71480,868,8,1181,18,0,37,130000.0,39000.0,-69.0,-70.0,-68.0,-60.0,-69.0,-70.0,-67.0,-61.0,-90.0,-93.0,-89.0,-93.0,21.0,23.0,21.0,33.0,1
12,BA:8C:B9:54:50:24,3835437,489287810,4775,6156219,3830662,483131591,0,8659,1670696,8637,1667201,22,3495,2326,14,5184,38,0,55,216660.0,130000.0,-40.0,-37.0,-46.0,-51.0,-41.0,-35.0,-43.0,-47.0,-90.0,-93.0,-89.0,-93.0,50.0,56.0,43.0,42.0,1
13,92:69:1D:31:68:E9,3834491,486727243,3827,3595450,3830664,483131793,0,4474,1067225,4344,1037910,130,29315,2051,10,3996,83,0,41,229410.0,130000.0,-51.0,-45.0,-43.0,-48.0,-51.0,-49.0,-44.0,-48.0,-90.0,-93.0,-89.0,-93.0,39.0,48.0,46.0,45.0,1
14,CC:2F:71:3F:1F:24,4490981,1191852025,660317,708720232,3830664,483131793,37,538645,569032047,537971,568951039,674,81008,520884,15,660565,69702,34,458,130000.0,43333.0,-72.0,-66.0,-69.0,-72.0,-72.0,-66.0,-69.0,-72.0,-90.0,-93.0,-89.0,-93.0,18.0,27.0,20.0,21.0,1
15,CC:2F:71:3E:C5:1F,3831486,483232145,822,100352,3830664,483131793,0,3437,288480,2835,217000,602,71480,868,8,1181,18,0,37,130000.0,39000.0,-69.0,-70.0,-68.0,-60.0,-69.0,-70.0,-67.0,-61.0,-90.0,-93.0,-89.0,-93.0,21.0,23.0,21.0,33.0,1
16,BA:8C:B9:54:50:24,3835439,489288012,4775,6156219,3830664,483131793,0,8659,1670696,8637,1667201,22,3495,2326,14,5184,38,0,55,216660.0,130000.0,-40.0,-37.0,-46.0,-51.0,-41.0,-35.0,-43.0,-47.0,-90.0,-93.0,-89.0,-93.0,50.0,56.0,43.0,42.0,1
17,92:69:1D:31:68:E9,3834498,486727909,3827,3595450,3830671,483132459,0,4474,1067225,4344,1037910,130,29315,2051,10,3996,83,0,41,229410.0,130000.0,-51.0,-45.0,-43.0,-48.0,-51.0,-49.0,-44.0,-48.0,-90.0,-93.0,-89.0,-93.0,39.0,48.0,46.0,45.0,1
18,CC:2F:71:3F:1F:24,4491026,1191866623,660355,708734164,3830671,483132459,37,538666,569035781,537992,568954773,674,81008,520904,15,660603,69716,34,458,117000.0,39000.0,-72.0,-67.0,-70.0,-73.0,-71.0,-66.0,-69.0,-72.0,-90.0,-93.0,-89.0,-93.0,18.0,26.0,19.0,20.0,1
19,CC:2F:71:3E:C5:1F,3831493,483232811,822,100352,3830671,483132459,0,3437,288480,2835,217000,602,71480,868,8,1181,18,0,37,130000.0,39000.0,-69.0,-70.0,-68.0,-60.0,-69.0,-70.0,-67.0,-61.0,-90.0,-93.0,-89.0,-93.0,21.0,23.0,21.0,33.0,1
20,BA:8C:B9:54:50:24,3835446,489288678,4775,6156219,3830671,483132459,0,8659,1670696,8637,1667201,22,3495,2326,14,5184,38,0,55,216660.0,130000.0,-40.0,-37.0,-46.0,-51.0,-41.0,-35.0,-43.0,-47.0,-90.0,-93.0,-89.0,-93.0,50.0,56.0,43.0,42.0,1
21,92:69:1D:31:68:E9,3834498,486727909,3827,3595450,3830671,483132459,0,4474,1067225,4344,1037910,130,29315,2051,10,3996,83,0,41,229410.0,130000.0,-51.0,-45.0,-43.0,-48.0,-51.0,-49.0,-44.0,-48.0,-90.0,-93.0,-89.0,-93.0,39.0,48.0,46.0,45.0,1
22,CC:2F:71:3F:1F:24,4491066,1191880757,660393,708748096,3830673,483132661,37,538688,569039631,538014,568958623,674,81008,520925,15,660641,69723,34,458,130000.0,43333.0,-72.0,-66.0,-70.0,-72.0,-72.0,-66.0,-69.0,-72.0,-90.0,-93.0,-89.0,-93.0,18.0,27.0,19.0,21.0,1
23,CC:2F:71:3E:C5:1F,3831495,483233013,822,100352,3830673,483132661,0,3437,288480,2835,217000,602,71480,868,8,1181,18,0,37,130000.0,39000.0,-69.0,-70.0,-68.0,-60.0,-69.0,-70.0,-67.0,-61.0,-90.0,-93.0,-89.0,-93.0,21.0,23.0,21.0,33.0,1
24,BA:8C:B9:54:50:24,3835448,489288880,4775,6156219,3830673,483132661,0,8659,1670696,8637,1667201,22,3495,2326,14,5184,38,0,55,216660.0,130000.0,-40.0,-37.0,-46.0,-51.0,-41.0,-35.0,-43.0,-47.0,-90.0,-93.0,-89.0,-92.0,50.0,56.0,43.0,41.0,1
25,92:69:1D:31:68:E9,3834507,486728777,3827,3595450,3830680,483133327,0,4474,1067225,4344,1037910,130,29315,2051,10,3996,83,0,41,229410.0,130000.0,-51.0,-45.0,-43.0,-48.0,-51.0,-49.0,-44.0,-48.0,-90.0,-93.0,-89.0,-92.0,39.0,48.0,46.0,44.0,1
26,CC:2F:71:3F:1F:24,4491111,1191895355,660431,708762028,3830680,483133327,37,538710,569043481,538036,568962473,674,81008,520946,15,660679,69751,34,458,117000.0,39000.0,-72.0,-67.0,-70.0,-73.0,-72.0,-66.0,-69.0,-73.0,-90.0,-93.0,-89.0,-92.0,18.0,26.0,19.0,19.0,1
27,CC:2F:71:3E:C5:1F,3831502,483233679,822,100352,3830680,483133327,0,3437,288480,2835,217000,602,71480,868,8,1181,18,0,37,130000.0,39000.0,-69.0,-70.0,-68.0,-60.0,-69.0,-70.0,-67.0,-61.0,-90.0,-93.0,-89.0,-92.0,21.0,23.0,21.0,32.0,1
28,BA:8C:B9:54:50:24,3835455,489289546,4775,6156219,3830680,483133327,0,8659,1670696,8637,1667201,22,3495,2326,14,5184,38,0,55,216660.0,130000.0,-40.0,-37.0,-46.0,-51.0,-41.0,-35.0,-43.0,-47.0,-90.0,-93.0,-89.0,-92.0,50.0,56.0,43.0,41.0,1
29,92:69:1D:31:68:E9,3834510,486729041,3827,3595450,3830683,483133591,0,4476,1067361,4346,1038046,130,29315,2051,10,3997,83,0,41,229410.0,130000.0,-51.0,-52.0,-44.0,-49.0,-51.0,-49.0,-43.0,-48.0,-90.0,-93.0,-89.0,-92.0,39.0,41.0,45.0,43.0,1
30,CC:2F:71:3F:1F:24,4491153,1191909681,660470,708776090,3830683,483133591,37,538733,569047509,538059,568966501,674,81008,520967,15,660718,69759,34,458,130000.0,43333.0,-72.0,-66.0,-70.0,-73.0,-72.0,-66.0,-69.0,-73.0,-90.0,-93.0,-89.0,-92.0,18.0,27.0,19.0,19.0,1
31,CC:2F:71:3E:C5:1F,3831505,483233943,822,100352,3830683,483133591,0,3441,288808,2838,217210,603,71598,869,8,1182,18,0,37,130000.0,39000.0,-69.0,-70.0,-68.0,-60.0,-70.0,-72.0,-68.0,-61.0,-90.0,-93.0,-89.0,-92.0,21.0,23.0,21.0,32.0,1
32,BA:8C:B9:54:50:24,3835458,489289810,4775,6156219,3830683,483133591,0,8661,1670832,8639,1667337,22,3495,2326,14,5185,38,0,55,216660.0,130000.0,-40.0,-37.0,-46.0,-51.0,-41.0,-35.0,-43.0,-47.0,-90.0,-93.0,-89.0,-92.0,50.0,56.0,43.0,41.0,1
33,92:69:1D:31:68:E9,3834516,486729647,3827,3595450,3830689,483134197,0,4476,1067361,4346,1038046,130,29315,2051,10,3997,83,0,41,229410.0,130000.0,-51.0,-52.0,-44.0,-49.0,-51.0,-49.0,-43.0,-48.0,-90.0,-93.0,-90.0,-93.0,39.0,41.0,46.0,44.0,1
34,CC:2F:71:3F:1F:24,4491198,1191924405,660509,708790208,3830689,483134197,37,538755,569051359,538081,568970351,674,81008,520988,15,660757,69770,34,458,130000.0,39000.0,-71.0,-66.0,-69.0,-71.0,-71.0,-66.0,-71.0,-72.0,-90.0,-93.0,-90.0,-93.0,19.0,27.0,21.0,22.0,1
35,CC:2F:71:3E:C5:1F,3831511,483234549,822,100352,3830689,483134197,0,3441,288808,2838,217210,603,71598,869,8,1182,18,0,37,130000.0,39000.0,-69.0,-70.0,-68.0,-60.0,-70.0,-72.0,-68.0,-61.0,-90.0,-93.0,-90.0,-93.0,21.0,23.0,22.0,33.0,1
36,BA:8C:B9:54:50:24,3835465,489290478,4775,6156219,3830690,483134259,0,8661,1670832,8639,1667337,22,3495,2326,14,5185,38,0,55,216660.0,130000.0,-40.0,-37.0,-46.0,-51.0,-41.0,-35.0,-43.0,-47.0,-90.0,-93.0,-90.0,-93.0,50.0,56.0,44.0,42.0,1
37,92:69:1D:31:68:E9,3834520,486729971,3827,3595450,3830693,483134521,0,4477,1067429,4347,1038114,130,29315,2051,10,3997,83,0,41,229410.0,130000.0,-51.0,-53.0,-47.0,-48.0,-51.0,-49.0,-44.0,-48.0,-90.0,-93.0,-90.0,-93.0,39.0,40.0,43.0,45.0,1
38,CC:2F:71:3F:1F:24,4491240,1191938661,660547,708804140,3830693,483134521,37,538777,569055211,538102,568974085,675,81126,521009,15,660795,69787,34,458,144444.0,43333.0,-72.0,-65.0,-72.0,-71.0,-70.0,-66.0,-71.0,-70.0,-90.0,-93.0,-90.0,-93.0,18.0,28.0,18.0,22.0,1
39,CC:2F:71:3E:C5:1F,3831515,483234873,822,100352,3830693,483134521,0,3441,288808,2838,217210,603,71598,869,8,1182,18,0,37,130000.0,39000.0,-69.0,-70.0,-68.0,-60.0,-70.0,-72.0,-68.0,-61.0,-90.0,-93.0,-90.0,-93.0,21.0,23.0,22.0,33.0,1
40,BA:8C:B9:54:50:24,3835468,489290740,4775,6156219,3830693,483134521,0,8661,1670832,8639,1667337,22,3495,2326,14,5185,38,0,55,216660.0,130000.0,-40.0,-37.0,-46.0,-51.0,-41.0,-35.0,-43.0,-47.0,-90.0,-93.0,-90.0,-93.0,50.0,56.0,44.0,42.0,1
41,92:69:1D:31:68:E9,3834526,486730577,3827,3595450,3830699,483135127,0,4477,1067429,4347,1038114,130,29315,2051,10,3997,83,0,41,229410.0,130000.0,-51.0,-53.0,-47.0,-48.0,-51.0,-49.0,-44.0,-48.0,-90.0,-93.0,-90.0,-93.0,39.0,40.0,43.0,45.0,1
42,CC:2F:71:3F:1F:24,4491284,1191953255,660585,708818128,3830699,483135127,37,538798,569058945,538123,568977819,675,81126,521029,15,660833,69807,34,458,130000.0,43333.0,-70.0,-66.0,-68.0,-68.0,-69.0,-66.0,-69.0,-68.0,-90.0,-93.0,-90.0,-93.0,20.0,27.0,22.0,25.0,1
43,CC:2F:71:3E:C5:1F,3831521,483235479,822,100352,3830699,483135127,0,3441,288808,2838,217210,603,71598,869,8,1182,18,0,37,130000.0,39000.0,-69.0,-70.0,-68.0,-60.0,-70.0,-72.0,-68.0,-61.0,-90.0,-93.0,-90.0,-93.0,21.0,23.0,22.0,33.0,1
44,BA:8C:B9:54:50:24,3835474,489291346,4775,6156219,3830699,483135127,0,8661,1670832,8639,1667337,22,3495,2326,14,5185,38,0,55,216660.0,130000.0,-40.0,-37.0,-46.0,-51.0,-41.0,-35.0,-43.0,-47.0,-90.0,-93.0,-90.0,-93.0,50.0,56.0,44.0,42.0,1
45,92:69:1D:31:68:E9,3834526,486730577,3827,3595450,3830699,483135127,0,4477,1067429,4347,1038114,130,29315,2051,10,3997,83,0,41,229410.0,130000.0,-51.0,-53.0,-47.0,-48.0,-51.0,-49.0,-44.0,-48.0,-90.0,-93.0,-90.0,-93.0,39.0,40.0,43.0,45.0,1
46,CC:2F:71:3F:1F:24,4491324,1191967445,660623,708832116,3830701,483135329,37,538821,569062911,538146,568981785,675,81126,521051,15,660871,69816,34,458,130000.0,39000.0,-74.0,-66.0,-68.0,-75.0,-73.0,-66.0,-68.0,-73.0,-90.0,-93.0,-90.0,-93.0,16.0,27.0,22.0,18.0,1
47,CC:2F:71:3E:C5:1F,3831523,483235681,822,100352,3830701,483135329,0,3441,288808,2838,217210,603,71598,869,8,1182,18,0,37,130000.0,39000.0,-69.0,-70.0,-68.0,-60.0,-70.0,-72.0,-68.0,-61.0,-90.0,-93.0,-90.0,-93.0,21.0,23.0,22.0,33.0,1
48,BA:8C:B9:54:50:24,3835476,489291548,4775,6156219,3830701,483135329,0,8661,1670832,8639,1667337,22,3495,2326,14,5185,38,0,55,216660.0,130000.0,-40.0,-37.0,-46.0,-51.0,-41.0,-35.0,-43.0,-47.0,-90.0,-93.0,-90.0,-93.0,50.0,56.0,44.0,42.0,1
49,92:69:1D:31:68:E9,3834547,486737044,3827,3595450,3830720,483141594,0,4480,1067800,4349,1038250,131,29550,2052,10,3997,83,0,41,229410.0,130000.0,-51.0,-53.0,-46.0,-51.0,-51.0,-51.0,-45.0,-49.0,-90.0,-93.0,-90.0,-93.0,39.0,40.0,44.0,42.0,1
50,CC:2F:71:3F:1F:24,4491381,1191987642,660661,708846048,3830720,483141594,37,538843,569066775,538168,568985649,675,81126,521071,15,660909,69844,34,458,130000.0,39000.0,-74.0,-65.0,-70.0,-77.0,-73.0,-65.0,-70.0,-76.0,-90.0,-93.0,-90.0,-93.0,16.0,28.0,20.0,16.0,1
51,CC:2F:71:3E:C5:1F,3831542,483241946,822,100352,3830720,483141594,0,3441,288808,2838,217210,603,71598,869,8,1182,18,0,37,130000.0,39000.0,-69.0,-70.0,-68.0,-60.0,-70.0,-72.0,-68.0,-61.0,-90.0,-93.0,-90.0,-93.0,21.0,23.0,22.0,33.0,1
52,BA:8C:B9:54:50:24,3835506,489303237,4775,6156219,3830731,483147018,0,8661,1670832,8639,1667337,22,3495,2326,14,5185,38,0,55,216660.0,130000.0,-40.0,-37.0,-46.0,-51.0,-41.0,-35.0,-43.0,-47.0,-90.0,-93.0,-90.0,-93.0,50.0,56.0,44.0,42.0,1
53,92:69:1D:31:68:E9,3834560,486742670,3827,3595450,3830733,483147220,0,4480,1067800,4349,1038250,131,29550,2052,10,3997,83,0,41,229410.0,130000.0,-51.0,-53.0,-46.0,-51.0,-51.0,-51.0,-45.0,-49.0,-90.0,-93.0,-90.0,-93.0,39.0,40.0,44.0,42.0,1
54,CC:2F:71:3F:1F:24,4491436,1192007850,660703,708860630,3830733,483147220,37,538869,569071147,538194,568990021,675,81126,521096,15,660951,69875,34,458,117000.0,39000.0,-74.0,-66.0,-70.0,-75.0,-73.0,-66.0,-70.0,-75.0,-90.0,-93.0,-90.0,-93.0,16.0,27.0,20.0,18.0,1
55,CC:2F:71:3E:C5:1F,3831555,483247572,822,100352,3830733,483147220,0,3441,288808,2838,217210,603,71598,869,8,1182,18,0,37,130000.0,39000.0,-69.0,-70.0,-68.0,-60.0,-70.0,-72.0,-68.0,-61.0,-90.0,-93.0,-90.0,-93.0,21.0,23.0,22.0,33.0,1
56,BA:8C:B9:54:50:24,3835510,489303641,4775,6156219,3830735,483147422,0,8661,1670832,8639,1667337,22,3495,2326,14,5185,38,0,55,216660.0,130000.0,-40.0,-37.0,-46.0,-51.0,-41.0,-35.0,-43.0,-47.0,-90.0,-93.0,-90.0,-93.0,50.0,56.0,44.0,42.0,1
57,92:69:1D:31:68:E9,3834568,486743609,3827,3595450,3830741,483148159,0,4480,1067800,4349,1038250,131,29550,2052,10,3997,83,0,41,229410.0,130000.0,-51.0,-53.0,-46.0,-51.0,-51.0,-51.0,-45.0,-49.0,-90.0,-93.0,-90.0,-93.0,39.0,40.0,44.0,42.0,1
58,CC:2F:71:3F:1F:24,4492288,1192501804,661547,709353645,3830741,483148159,37,539516,569227564,538841,569146438,675,81126,521739,15,661795,69931,34,459,115556.0,28889.0,-74.0,-66.0,-70.0,-74.0,-73.0,-65.0,-69.0,-73.0,-90.0,-93.0,-90.0,-93.0,16.0,27.0,20.0,19.0,1
59,CC:2F:71:3E:C5:1F,3831563,483248511,822,100352,3830741,483148159,0,3441,288808,2838,217210,603,71598,869,8,1182,18,0,37,130000.0,39000.0,-69.0,-70.0,-68.0,-60.0,-70.0,-72.0,-68.0,-61.0,-90.0,-93.0,-90.0,-93.0,21.0,23.0,22.0,33.0,1
60,BA:8C:B9:54:50:24,3835516,489304378,4775,6156219,3830741,483148159,0,8661,1670832,8639,1667337,22,3495,2326,14,5185,38,0,55,216660.0,130000.0,-40.0,-37.0,-46.0,-51.0,-41.0,-35.0,-43.0,-47.0,-90.0,-93.0,-90.0,-93.0,50.0,56.0,44.0,42.0,1
61,92:69:1D:31:68:E9,3834570,486743811,3827,3595450,3830743,483148361,0,4480,1067800,4349,1038250,131,29550,2052,10,3997,83,0,41,229410.0,130000.0,-51.0,-53.0,-46.0,-51.0,-51.0,-51.0,-45.0,-49.0,-90.0,-93.0,-90.0,-93.0,39.0,40.0,44.0,42.0,1
62,CC:2F:71:3F:1F:24,4492554,1192592433,661811,709444072,3830743,483148361,37,539698,569279344,539023,569198218,675,81126,521916,15,662059,69937,34,459,115556.0,28889.0,-73.0,-67.0,-71.0,-72.0,-72.0,-66.0,-70.0,-72.0,-90.0,-93.0,-90.0,-93.0,17.0,26.0,19.0,21.0,1
63,CC:2F:71:3E:C5:1F,3831565,483248713,822,100352,3830743,483148361,0,3441,288808,2838,217210,603,71598,869,8,1182,18,0,37,130000.0,39000.0,-69.0,-70.0,-68.0,-60.0,-70.0,-72.0,-68.0,-61.0,-90.0,-93.0,-90.0,-93.0,21.0,23.0,22.0,33.0,1
64,BA:8C:B9:54:50:24,3835520,489304782,4775,6156219,3830745,483148563,0,8661,1670832,8639,1667337,22,3495,2326,14,5185,38,0,55,216660.0,130000.0,-40.0,-37.0,-46.0,-51.0,-41.0,-35.0,-43.0,-47.0,-90.0,-93.0,-90.0,-93.0,50.0,56.0,44.0,42.0,1
65,92:69:1D:31:68:E9,3834576,486744417,3827,3595450,3830749,483148967,0,4480,1067800,4349,1038250,131,29550,2052,10,3997,83,0,41,229410.0,130000.0,-51.0,-53.0,-46.0,-51.0,-51.0,-51.0,-45.0,-49.0,-90.0,-93.0,-90.0,-93.0,39.0,40.0,44.0,42.0,1
66,CC:2F:71:3F:1F:24,4492772,1192710582,662023,709561615,3830749,483148967,37,539851,569317034,539176,569235908,675,81126,522063,15,662271,69960,34,459,130000.0,39000.0,-73.0,-66.0,-68.0,-73.0,-73.0,-66.0,-68.0,-72.0,-90.0,-93.0,-90.0,-93.0,17.0,27.0,22.0,20.0,1
67,CC:2F:71:3E:C5:1F,3831571,483249319,822,100352,3830749,483148967,0,3441,288808,2838,217210,603,71598,869,8,1182,18,0,37,130000.0,39000.0,-69.0,-70.0,-68.0,-60.0,-70.0,-72.0,-68.0,-61.0,-90.0,-93.0,-90.0,-93.0,21.0,23.0,22.0,33.0,1
68,BA:8C:B9:54:50:24,3835524,489305186,4775,6156219,3830749,483148967,0,8661,1670832,8639,1667337,22,3495,2326,14,5185,38,0,55,216660.0,130000.0,-40.0,-37.0,-46.0,-51.0,-41.0,-35.0,-43.0,-47.0,-90.0,-93.0,-90.0,-93.0,50.0,56.0,44.0,42.0,1
69,92:69:1D:31:68:E9,3834581,486745047,3827,3595450,3830754,483149597,0,4480,1067800,4349,1038250,131,29550,2052,10,3997,83,0,41,229410.0,130000.0,-51.0,-53.0,-46.0,-51.0,-51.0,-51.0,-45.0,-49.0,-90.0,-93.0,-90.0,-93.0,39.0,40.0,44.0,42.0,1
70,CC:2F:71:3F:1F:24,4492917,1192780930,662163,709631333,3830754,483149597,37,539971,569343797,539296,569262671,675,81126,522180,15,662411,69960,34,459,130000.0,43333.0,-74.0,-67.0,-70.0,-73.0,-74.0,-67.0,-69.0,-73.0,-90.0,-93.0,-90.0,-93.0,16.0,26.0,20.0,20.0,1
71,CC:2F:71:3E:C5:1F,3831576,483249949,822,100352,3830754,483149597,0,3441,288808,2838,217210,603,71598,869,8,1182,18,0,37,130000.0,39000.0,-69.0,-70.0,-68.0,-60.0,-70.0,-72.0,-68.0,-61.0,-90.0,-93.0,-90.0,-93.0,21.0,23.0,22.0,33.0,1
72,BA:8C:B9:54:50:24,3835531,489306018,4775,6156219,3830756,483149799,0,8661,1670832,8639,1667337,22,3495,2326,14,5185,38,0,55,216660.0,130000.0,-40.0,-37.0,-46.0,-51.0,-41.0,-35.0,-43.0,-47.0,-90.0,-93.0,-90.0,-93.0,50.0,56.0,44.0,42.0,1
73,92:69:1D:31:68:E9,3834587,486745653,3827,3595450,3830760,483150203,0,4480,1067800,4349,1038250,131,29550,2052,10,3997,83,0,41,229410.0,130000.0,-51.0,-53.0,-46.0,-51.0,-51.0,-51.0,-45.0,-49.0,-90.0,-93.0,-90.0,-93.0,39.0,40.0,44.0,42.0,1
74,CC:2F:71:3F:1F:24,4493285,1193142372,662525,709992169,3830760,483150203,37,540152,569378403,539477,569297277,675,81126,522358,15,662773,70072,34,459,130000.0,43333.0,-72.0,-67.0,-69.0,-70.0,-72.0,-67.0,-68.0,-70.0,-90.0,-93.0,-90.0,-93.0,18.0,26.0,21.0,23.0,1
75,CC:2F:71:3E:C5:1F,3831582,483250555,822,100352,3830760,483150203,0,3441,288808,2838,217210,603,71598,869,8,1182,18,0,37,130000.0,39000.0,-69.0,-70.0,-68.0,-60.0,-70.0,-72.0,-68.0,-61.0,-90.0,-93.0,-90.0,-93.0,21.0,23.0,22.0,33.0,1
76,BA:8C:B9:54:50:24,3835535,489306422,4775,6156219,3830760,483150203,0,8661,1670832,8639,1667337,22,3495,2326,14,5185,38,0,55,216660.0,130000.0,-40.0,-37.0,-46.0,-51.0,-41.0,-35.0,-43.0,-47.0,-90.0,-93.0,-90.0,-93.0,50.0,56.0,44.0,42.0,1
77,92:69:1D:31:68:E9,3834587,486745653,3827,3595450,3830760,483150203,0,4480,1067800,4349,1038250,131,29550,2052,10,3997,83,0,41,229410.0,130000.0,-51.0,-53.0,-46.0,-51.0,-51.0,-51.0,-45.0,-49.0,-90.0,-93.0,-90.0,-93.0,39.0,40.0,44.0,42.0,1
78,CC:2F:71:3F:1F:24,4493371,1193205531,662608,710055066,3830763,483150465,37,540198,569386013,539523,569304887,675,81126,522399,15,662856,70087,34,459,130000.0,43333.0,-72.0,-67.0,-69.0,-70.0,-71.0,-67.0,-68.0,-70.0,-90.0,-93.0,-90.0,-93.0,18.0,26.0,21.0,23.0,1
79,CC:2F:71:3E:C5:1F,3831587,483251019,822,100352,3830765,483150667,0,3441,288808,2838,217210,603,71598,869,8,1182,18,0,37,130000.0,39000.0,-69.0,-70.0,-68.0,-60.0,-70.0,-72.0,-68.0,-61.0,-90.0,-93.0,-90.0,-93.0,21.0,23.0,22.0,33.0,1
80,BA:8C:B9:54:50:24,3835540,489306886,4775,6156219,3830765,483150667,0,8661,1670832,8639,1667337,22,3495,2326,14,5185,38,0,55,216660.0,130000.0,-40.0,-37.0,-46.0,-51.0,-41.0,-35.0,-43.0,-47.0,-90.0,-93.0,-90.0,-93.0,50.0,56.0,44.0,42.0,1
81,92:69:1D:31:68:E9,3834594,486746319,3827,3595450,3830767,483150869,0,4480,1067800,4349,1038250,131,29550,2052,10,3997,83,0,41,229410.0,130000.0,-51.0,-53.0,-46.0,-51.0,-51.0,-51.0,-45.0,-49.0,-90.0,-93.0,-90.0,-93.0,39.0,40.0,44.0,42.0,1
82,CC:2F:71:3F:1F:24,4493416,1193220255,662647,710069184,3830769,483151071,37,540221,569389979,539546,569308853,675,81126,522421,15,662895,70098,34,459,130000.0,39000.0,-72.0,-66.0,-68.0,-72.0,-72.0,-65.0,-68.0,-71.0,-90.0,-93.0,-90.0,-93.0,18.0,27.0,22.0,21.0,1
83,CC:2F:71:3E:C5:1F,3831591,483251423,822,100352,3830769,483151071,0,3441,288808,2838,217210,603,71598,869,8,1182,18,0,37,130000.0,39000.0,-69.0,-70.0,-68.0,-60.0,-70.0,-72.0,-68.0,-61.0,-90.0,-93.0,-90.0,-93.0,21.0,23.0,22.0,33.0,1
84,BA:8C:B9:54:50:24,3835544,489307290,4775,6156219,3830769,483151071,0,8661,1670832,8639,1667337,22,3495,2326,14,5185,38,0,55,216660.0,130000.0,-40.0,-37.0,-46.0,-51.0,-41.0,-35.0,-43.0,-47.0,-90.0,-93.0,-90.0,-93.0,50.0,56.0,44.0,42.0,1
85,92:69:1D:31:68:E9,3834596,486746521,3827,3595450,3830769,483151071,0,4480,1067800,4349,1038250,131,29550,2052,10,3997,83,0,41,229410.0,130000.0,-51.0,-53.0,-46.0,-51.0,-51.0,-51.0,-45.0,-49.0,-90.0,-93.0,-90.0,-93.0,39.0,40.0,44.0,42.0,1
86,CC:2F:71:3F:1F:24,4493459,1193234779,662688,710083506,3830771,483151273,37,540251,569394711,539576,569313585,675,81126,522449,15,662936,70105,34,459,130000.0,39000.0,-72.0,-66.0,-70.0,-73.0,-72.0,-66.0,-69.0,-73.0,-90.0,-93.0,-90.0,-93.0,18.0,27.0,20.0,20.0,1
87,CC:2F:71:3E:C5:1F,3831595,483251827,822,100352,3830773,483151475,0,3441,288808,2838,217210,603,71598,869,8,1182,18,0,37,130000.0,39000.0,-69.0,-70.0,-68.0,-60.0,-70.0,-72.0,-68.0,-61.0,-90.0,-93.0,-90.0,-93.0,21.0,23.0,22.0,33.0,1
88,BA:8C:B9:54:50:24,3835548,489307694,4775,6156219,3830773,483151475,0,8661,1670832,8639,1667337,22,3495,2326,14,5185,38,0,55,216660.0,130000.0,-40.0,-37.0,-46.0,-51.0,-41.0,-35.0,-43.0,-47.0,-90.0,-93.0,-90.0,-93.0,50.0,56.0,44.0,42.0,1
89,92:69:1D:31:68:E9,3834603,486747187,3827,3595450,3830776,483151737,0,4480,1067800,4349,1038250,131,29550,2052,10,3997,83,0,41,229410.0,130000.0,-51.0,-53.0,-46.0,-51.0,-51.0,-51.0,-45.0,-49.0,-90.0,-93.0,-90.0,-93.0,39.0,40.0,44.0,42.0,1
90,CC:2F:71:3F:1F:24,4493503,1193249299,662726,710097494,3830777,483151805,37,540276,569398909,539601,569317783,675,81126,522473,15,662974,70105,34,459,130000.0,43333.0,-72.0,-65.0,-69.0,-70.0,-72.0,-65.0,-69.0,-70.0,-90.0,-93.0,-90.0,-93.0,18.0,28.0,21.0,23.0,1
91,CC:2F:71:3E:C5:1F,3831599,483252157,822,100352,3830777,483151805,0,3441,288808,2838,217210,603,71598,869,8,1182,18,0,37,130000.0,39000.0,-69.0,-70.0,-68.0,-60.0,-70.0,-72.0,-68.0,-61.0,-90.0,-93.0,-90.0,-93.0,21.0,23.0,22.0,33.0,1
92,BA:8C:B9:54:50:24,3835553,489308158,4775,6156219,3830778,483151939,0,8661,1670832,8639,1667337,22,3495,2326,14,5185,38,0,55,216660.0,130000.0,-40.0,-37.0,-46.0,-51.0,-41.0,-35.0,-43.0,-47.0,-90.0,-93.0,-90.0,-93.0,50.0,56.0,44.0,42.0,1
93,92:69:1D:31:68:E9,3834607,486747591,3827,3595450,3830780,483152141,0,4480,1067800,4349,1038250,131,29550,2052,10,3997,83,0,41,229410.0,130000.0,-51.0,-53.0,-46.0,-51.0,-51.0,-51.0,-45.0,-49.0,-90.0,-93.0,-90.0,-93.0,39.0,40.0,44.0,42.0,1
94,CC:2F:71:3F:1F:24,4493543,1193263437,662763,710111296,3830780,483152141,37,540298,569402759,539623,569321633,675,81126,522494,15,663011,70119,34,459,117000.0,39000.0,-71.0,-65.0,-69.0,-70.0,-71.0,-65.0,-69.0,-70.0,-90.0,-93.0,-90.0,-93.0,19.0,28.0,21.0,23.0,1
95,CC:2F:71:3E:C5:1F,3831604,483252695,822,100352,3830782,483152343,0,3441,288808,2838,217210,603,71598,869,8,1182,18,0,37,130000.0,39000.0,-69.0,-70.0,-68.0,-60.0,-70.0,-72.0,-68.0,-61.0,-90.0,-93.0,-90.0,-93.0,21.0,23.0,22.0,33.0,1
96,BA:8C:B9:54:50:24,3835557,489308562,4775,6156219,3830782,483152343,0,8661,1670832,8639,1667337,22,3495,2326,14,5185,38,0,55,216660.0,130000.0,-40.0,-37.0,-46.0,-51.0,-41.0,-35.0,-43.0,-47.0,-90.0,-93.0,-90.0,-93.0,50.0,56.0,44.0,42.0,1
97,92:69:1D:31:68:E9,3834611,486747995,3827,3595450,3830784,483152545,0,4480,1067800,4349,1038250,131,29550,2052,10,3997,83,0,41,229410.0,130000.0,-51.0,-53.0,-46.0,-51.0,-51.0,-51.0,-45.0,-49.0,-90.0,-93.0,-90.0,-93.0,39.0,40.0,44.0,42.0,1
98,CC:2F:71:3F:1F:24,4493587,1193277977,662803,710125432,3830784,483152545,37,540324,569407073,539649,569325947,675,81126,522519,15,663051,70124,34,459,130000.0,39000.0,-71.0,-65.0,-70.0,-70.0,-71.0,-65.0,-69.0,-69.0,-90.0,-93.0,-90.0,-93.0,19.0,28.0,20.0,23.0,1
99,CC:2F:71:3E:C5:1F,3831608,483253099,822,100352,3830786,483152747,0,3441,288808,2838,217210,603,71598,869,8,1182,18,0,37,130000.0,39000.0,-69.0,-70.0,-68.0,-60.0,-70.0,-72.0,-68.0,-61.0,-90.0,-93.0,-90.0,-93.0,21.0,23.0,22.0,33.0,1
100,BA:8C:B9:54:50:24,3835561,489308966,4775,6156219,3830786,483152747,0,8661,1670832,8639,1667337,22,3495,2326,14,5185,38,0,55,216660.0,130000.0,-40.0,-37.0,-46.0,-51.0,-41.0,-35.0,-43.0,-47.0,-90.0,-93.0,-90.0,-93.0,50.0,56.0,44.0,42.0,1
101,92:69:1D:31:68:E9,3834614,486748257,3827,3595450,3830787,483152807,0,4480,1067800,4349,1038250,131,29550,2052,10,3997,83,0,41,229410.0,130000.0,-51.0,-53.0,-46.0,-51.0,-51.0,-51.0,-45.0,-49.0,-90.0,-93.0,-90.0,-93.0,39.0,40.0,44.0,42.0,1
102,CC:2F:71:3F:1F:24,4493631,1193292489,662842,710139480,3830789,483153009,37,540345,569410807,539670,569329681,675,81126,522539,15,663089,70134,34,459,144444.0,43333.0,-72.0,-65.0,-72.0,-72.0,-72.0,-65.0,-71.0,-72.0,-90.0,-93.0,-90.0,-93.0,18.0,28.0,18.0,21.0,1
103,CC:2F:71:3E:C5:1F,3831618,483254396,827,101185,3830791,483153211,0,3446,289553,2843,217955,603,71598,874,8,1187,18,0,37,130000.0,39000.0,-69.0,-70.0,-66.0,-60.0,-69.0,-70.0,-66.0,-60.0,-90.0,-93.0,-90.0,-93.0,21.0,23.0,24.0,33.0,1
104,BA:8C:B9:54:50:24,3835567,489309546,4776,6156335,3830791,483153211,0,8663,1670968,8641,1667473,22,3495,2326,14,5186,38,0,55,216660.0,130000.0,-39.0,-36.0,-45.0,-50.0,-40.0,-36.0,-44.0,-49.0,-90.0,-93.0,-90.0,-93.0,51.0,57.0,45.0,43.0,1
105,92:69:1D:31:68:E9,3834621,486748979,3828,3595566,3830793,483153413,0,4482,1067936,4351,1038386,131,29550,2052,10,3998,83,0,41,229410.0,130000.0,-53.0,-46.0,-42.0,-48.0,-51.0,-51.0,-45.0,-49.0,-90.0,-93.0,-90.0,-93.0,37.0,47.0,48.0,45.0,1
106,CC:2F:71:3F:1F:24,4493685,1193318802,662892,710165389,3830793,483153413,37,540373,569415594,539698,569334468,675,81126,522566,15,663140,70141,34,459,144444.0,43333.0,-72.0,-65.0,-71.0,-71.0,-72.0,-65.0,-71.0,-71.0,-90.0,-93.0,-90.0,-93.0,18.0,28.0,19.0,22.0,1
107,CC:2F:71:3E:C5:1F,3831620,483254598,827,101185,3830793,483153413,0,3447,289623,2844,218025,603,71598,874,8,1187,18,0,37,130000.0,39000.0,-69.0,-70.0,-67.0,-60.0,-69.0,-70.0,-66.0,-60.0,-90.0,-93.0,-90.0,-93.0,21.0,23.0,23.0,33.0,1
108,BA:8C:B9:54:50:24,3835571,489309950,4776,6156335,3830795,483153615,0,8663,1670968,8641,1667473,22,3495,2326,14,5186,38,0,55,216660.0,130000.0,-39.0,-36.0,-45.0,-50.0,-40.0,-36.0,-44.0,-49.0,-90.0,-93.0,-90.0,-93.0,51.0,57.0,45.0,43.0,1
109,92:69:1D:31:68:E9,3834625,486749514,3828,3595566,3830797,483153948,0,4482,1067936,4351,1038386,131,29550,2052,10,3998,83,0,41,229410.0,130000.0,-53.0,-46.0,-42.0,-48.0,-51.0,-51.0,-45.0,-49.0,-90.0,-93.0,-90.0,-93.0,37.0,47.0,48.0,45.0,1
110,CC:2F:71:3F:1F:24,4493743,1193342926,662944,710188776,3830799,483154150,37,540404,569420654,539729,569339528,675,81126,522595,15,663192,70156,34,459,144444.0,43333.0,-72.0,-64.0,-70.0,-71.0,-71.0,-64.0,-70.0,-71.0,-90.0,-93.0,-90.0,-93.0,18.0,29.0,20.0,22.0,1
111,CC:2F:71:3E:C5:1F,3831628,483255537,827,101185,3830801,483154352,0,3447,289623,2844,218025,603,71598,874,8,1187,18,0,37,130000.0,39000.0,-69.0,-70.0,-67.0,-60.0,-69.0,-70.0,-66.0,-60.0,-90.0,-93.0,-90.0,-93.0,21.0,23.0,23.0,33.0,1
112,BA:8C:B9:54:50:24,3835577,489310687,4776,6156335,3830801,483154352,0,8664,1671036,8642,1667541,22,3495,2326,14,5186,38,0,55,216660.0,130000.0,-41.0,-39.0,-48.0,-51.0,-40.0,-36.0,-45.0,-49.0,-90.0,-93.0,-90.0,-93.0,49.0,54.0,42.0,42.0,1
113,92:69:1D:31:68:E9,3834631,486750120,3828,3595566,3830803,483154554,0,4482,1067936,4351,1038386,131,29550,2052,10,3998,83,0,41,229410.0,130000.0,-53.0,-46.0,-42.0,-48.0,-51.0,-51.0,-45.0,-49.0,-90.0,-93.0,-90.0,-93.0,37.0,47.0,48.0,45.0,1
114,CC:2F:71:3F:1F:24,4493814,1193376589,663011,710222035,3830803,483154554,37,540440,569427659,539765,569346533,675,81126,522630,15,663259,70227,34,459,144444.0,43333.0,-71.0,-67.0,-69.0,-72.0,-70.0,-66.0,-69.0,-71.0,-90.0,-93.0,-90.0,-93.0,19.0,26.0,21.0,21.0,1
115,CC:2F:71:3E:C5:1F,3831630,483255739,827,101185,3830803,483154554,0,3447,289623,2844,218025,603,71598,874,8,1187,18,0,37,130000.0,39000.0,-69.0,-70.0,-67.0,-60.0,-69.0,-70.0,-66.0,-60.0,-90.0,-93.0,-90.0,-93.0,21.0,23.0,23.0,33.0,1
116,BA:8C:B9:54:50:24,3835581,489311091,4776,6156335,3830805,483154756,0,8664,1671036,8642,1667541,22,3495,2326,14,5186,38,0,55,216660.0,130000.0,-41.0,-39.0,-48.0,-51.0,-40.0,-36.0,-45.0,-49.0,-90.0,-93.0,-90.0,-93.0,49.0,54.0,42.0,42.0,1
117,92:69:1D:31:68:E9,3834633,486750322,3828,3595566,3830805,483154756,0,4482,1067936,4351,1038386,131,29550,2052,10,3998,83,0,41,229410.0,130000.0,-53.0,-46.0,-42.0,-48.0,-51.0,-51.0,-45.0,-49.0,-90.0,-93.0,-90.0,-93.0,37.0,47.0,48.0,45.0,1
118,CC:2F:71:3F:1F:24,4495360,1195195811,664551,712040651,3830809,483155160,37,541159,569557249,540484,569476123,675,81126,523346,15,664799,70866,34,460,115556.0,28889.0,-71.0,-67.0,-72.0,-71.0,-71.0,-67.0,-72.0,-71.0,-90.0,-93.0,-90.0,-93.0,19.0,26.0,18.0,22.0,1
119,CC:2F:71:3E:C5:1F,3831636,483256345,827,101185,3830809,483155160,0,3447,289623,2844,218025,603,71598,874,8,1187,18,0,37,130000.0,39000.0,-69.0,-70.0,-67.0,-60.0,-69.0,-70.0,-66.0,-60.0,-90.0,-93.0,-90.0,-93.0,21.0,23.0,23.0,33.0,1
120,BA:8C:B9:54:50:24,3835585,489311495,4776,6156335,3830809,483155160,0,8664,1671036,8642,1667541,22,3495,2326,14,5186,38,0,55,216660.0,130000.0,-41.0,-39.0,-48.0,-51.0,-40.0,-36.0,-45.0,-49.0,-90.0,-93.0,-90.0,-93.0,49.0,54.0,42.0,42.0,1
121,92:69:1D:31:68:E9,3834641,486751050,3828,3595566,3830813,483155484,0,4482,1067936,4351,1038386,131,29550,2052,10,3998,83,0,41,229410.0,130000.0,-53.0,-46.0,-42.0,-48.0,-51.0,-51.0,-45.0,-49.0,-90.0,-93.0,-90.0,-93.0,37.0,47.0,48.0,45.0,1
122,CC:2F:71:3F:1F:24,4495501,1195302363,664688,712146879,3830813,483155484,37,541254,569575705,540578,569494461,676,81244,523438,15,664936,70868,34,460,117000.0,39000.0,-72.0,-68.0,-70.0,-72.0,-72.0,-67.0,-70.0,-71.0,-90.0,-93.0,-90.0,-93.0,18.0,25.0,20.0,21.0,1
123,CC:2F:71:3E:C5:1F,3831640,483256669,827,101185,3830813,483155484,0,3447,289623,2844,218025,603,71598,874,8,1187,18,0,37,130000.0,39000.0,-69.0,-70.0,-67.0,-60.0,-69.0,-70.0,-66.0,-60.0,-90.0,-93.0,-90.0,-93.0,21.0,23.0,23.0,33.0,1
124,BA:8C:B9:54:50:24,3835591,489312021,4776,6156335,3830815,483155686,0,8664,1671036,8642,1667541,22,3495,2326,14,5186,38,0,55,216660.0,130000.0,-41.0,-39.0,-48.0,-51.0,-40.0,-36.0,-45.0,-49.0,-90.0,-93.0,-90.0,-93.0,49.0,54.0,42.0,42.0,1
125,92:69:1D:31:68:E9,3834643,486751252,3828,3595566,3830815,483155686,0,4482,1067936,4351,1038386,131,29550,2052,10,3998,83,0,41,229410.0,130000.0,-53.0,-46.0,-42.0,-48.0,-51.0,-51.0,-45.0,-49.0,-90.0,-93.0,-90.0,-93.0,37.0,47.0,48.0,45.0,1
126,CC:2F:71:3F:1F:24,4495559,1195322068,664740,712165978,3830819,483156090,37,541283,569581639,540607,569500395,676,81244,523465,15,664988,70868,34,460,130000.0,43333.0,-73.0,-67.0,-71.0,-71.0,-73.0,-67.0,-70.0,-71.0,-90.0,-93.0,-90.0,-93.0,17.0,26.0,19.0,22.0,1
127,CC:2F:71:3E:C5:1F,3831646,483257275,827,101185,3830819,483156090,0,3447,289623,2844,218025,603,71598,874,8,1187,18,0,37,130000.0,39000.0,-69.0,-70.0,-67.0,-60.0,-69.0,-70.0,-66.0,-60.0,-90.0,-93.0,-90.0,-93.0,21.0,23.0,23.0,33.0,1
128,BA:8C:B9:54:50:24,3835595,489312425,4776,6156335,3830819,483156090,0,8664,1671036,8642,1667541,22,3495,2326,14,5186,38,0,55,216660.0,130000.0,-41.0,-39.0,-48.0,-51.0,-40.0,-36.0,-45.0,-49.0,-90.0,-93.0,-90.0,-93.0,49.0,54.0,42.0,42.0,1
129,92:69:1D:31:68:E9,3834649,486751858,3828,3595566,3830821,483156292,0,4482,1067936,4351,1038386,131,29550,2052,10,3998,83,0,41,229410.0,130000.0,-53.0,-46.0,-42.0,-48.0,-51.0,-51.0,-45.0,-49.0,-90.0,-93.0,-90.0,-93.0,37.0,47.0,48.0,45.0,1
130,CC:2F:71:3F:1F:24,4495643,1195394987,664821,712238633,3830822,483156354,37,541327,569588591,540651,569507347,676,81244,523507,15,665069,70890,34,460,130000.0,39000.0,-73.0,-66.0,-71.0,-72.0,-72.0,-66.0,-70.0,-71.0,-90.0,-93.0,-90.0,-93.0,17.0,27.0,19.0,21.0,1
131,CC:2F:71:3E:C5:1F,3831651,483257771,829,101417,3830822,483156354,0,3452,290093,2848,218377,604,71716,877,8,1189,18,0,37,130000.0,39000.0,-70.0,-70.0,-66.0,-60.0,-69.0,-70.0,-66.0,-60.0,-90.0,-93.0,-90.0,-93.0,20.0,23.0,24.0,33.0,1
132,BA:8C:B9:54:50:24,3835614,489329214,4791,6172800,3830823,483156414,0,8685,1677140,8663,1673645,22,3495,2335,14,5201,38,0,56,229410.0,130000.0,-48.0,-35.0,-43.0,-45.0,-43.0,-36.0,-45.0,-49.0,-90.0,-93.0,-90.0,-93.0,42.0,58.0,47.0,48.0,1
133,92:69:1D:31:68:E9,3834655,486752384,3828,3595566,3830827,483156818,0,4484,1068072,4353,1038522,131,29550,2052,10,3999,83,0,41,229410.0,130000.0,-52.0,-46.0,-42.0,-48.0,-51.0,-50.0,-44.0,-48.0,-90.0,-93.0,-90.0,-93.0,38.0,47.0,48.0,45.0,1
134,CC:2F:71:3F:1F:24,4495696,1195413132,664867,712256112,3830829,483157020,37,541357,569593845,540681,569512601,676,81244,523536,15,665115,70909,34,460,117000.0,39000.0,-73.0,-65.0,-70.0,-71.0,-73.0,-65.0,-70.0,-71.0,-90.0,-93.0,-90.0,-93.0,17.0,28.0,20.0,22.0,1
135,CC:2F:71:3E:C5:1F,3831658,483258437,829,101417,3830829,483157020,0,3453,290163,2849,218447,604,71716,877,8,1189,18,0,37,130000.0,39000.0,-70.0,-70.0,-66.0,-60.0,-69.0,-70.0,-66.0,-60.0,-90.0,-93.0,-90.0,-93.0,20.0,23.0,24.0,33.0,1
136,BA:8C:B9:54:50:24,3835625,489335373,4796,6178353,3830829,483157020,0,8702,1679327,8680,1675832,22,3495,2344,14,5206,38,0,56,229410.0,130000.0,-48.0,-35.0,-43.0,-45.0,-44.0,-37.0,-45.0,-49.0,-90.0,-93.0,-90.0,-93.0,42.0,58.0,47.0,48.0,1
137,92:69:1D:31:68:E9,3834659,486752788,3828,3595566,3830831,483157222,0,4484,1068072,4353,1038522,131,29550,2052,10,3999,83,0,41,229410.0,130000.0,-52.0,-46.0,-42.0,-48.0,-51.0,-50.0,-44.0,-48.0,-90.0,-93.0,-90.0,-93.0,38.0,47.0,48.0,45.0,1
138,CC:2F:71:3F:1F:24,4495751,1195432601,664920,712275379,3830831,483157222,37,541388,569600029,540712,569518785,676,81244,523566,15,665168,70910,34,460,130000.0,43333.0,-73.0,-66.0,-71.0,-72.0,-73.0,-66.0,-70.0,-72.0,-90.0,-93.0,-90.0,-93.0,17.0,27.0,19.0,21.0,1
139,CC:2F:71:3E:C5:1F,3831660,483258639,829,101417,3830831,483157222,0,3453,290163,2849,218447,604,71716,877,8,1189,18,0,37,130000.0,39000.0,-70.0,-70.0,-66.0,-60.0,-69.0,-70.0,-66.0,-60.0,-90.0,-93.0,-90.0,-93.0,20.0,23.0,24.0,33.0,1
140,BA:8C:B9:54:50:24,3835627,489335575,4796,6178353,3830831,483157222,0,8702,1679327,8680,1675832,22,3495,2344,14,5206,38,0,56,229410.0,130000.0,-48.0,-35.0,-43.0,-45.0,-44.0,-37.0,-45.0,-49.0,-90.0,-93.0,-90.0,-93.0,42.0,58.0,47.0,48.0,1
141,92:69:1D:31:68:E9,3834664,486753252,3828,3595566,3830836,483157686,0,4484,1068072,4353,1038522,131,29550,2052,10,3999,83,0,41,229410.0,130000.0,-52.0,-46.0,-42.0,-48.0,-51.0,-50.0,-44.0,-48.0,-90.0,-93.0,-90.0,-93.0,38.0,47.0,48.0,45.0,1
142,CC:2F:71:3F:1F:24,4495801,1195448574,664963,712290686,3830838,483157888,37,541413,569604442,540737,569523198,676,81244,523590,15,665211,70912,34,460,130000.0,43333.0,-73.0,-66.0,-70.0,-72.0,-73.0,-65.0,-70.0,-72.0,-90.0,-93.0,-90.0,-93.0,17.0,27.0,20.0,21.0,1
143,CC:2F:71:3E:C5:1F,3831667,483259305,829,101417,3830838,483157888,0,3453,290163,2849,218447,604,71716,877,8,1189,18,0,37,130000.0,39000.0,-70.0,-70.0,-66.0,-60.0,-69.0,-70.0,-66.0,-60.0,-90.0,-93.0,-90.0,-93.0,20.0,23.0,24.0,33.0,1
144,BA:8C:B9:54:50:24,3835634,489336241,4796,6178353,3830838,483157888,0,8702,1679327,8680,1675832,22,3495,2344,14,5206,38,0,56,229410.0,130000.0,-48.0,-35.0,-43.0,-45.0,-44.0,-37.0,-45.0,-49.0,-90.0,-93.0,-90.0,-93.0,42.0,58.0,47.0,48.0,1
145,92:69:1D:31:68:E9,3834668,486753656,3828,3595566,3830840,483158090,0,4484,1068072,4353,1038522,131,29550,2052,10,3999,83,0,41,229410.0,130000.0,-52.0,-46.0,-42.0,-48.0,-51.0,-50.0,-44.0,-48.0,-90.0,-93.0,-90.0,-93.0,38.0,47.0,48.0,45.0,1
146,CC:2F:71:3F:1F:24,4495884,1195491346,665044,712333256,3830840,483158090,37,541466,569615043,540790,569533799,676,81244,523641,15,665292,70926,34,460,130000.0,43333.0,-74.0,-66.0,-71.0,-72.0,-73.0,-66.0,-70.0,-71.0,-90.0,-93.0,-90.0,-93.0,16.0,27.0,19.0,21.0,1
147,CC:2F:71:3E:C5:1F,3831669,483259507,829,101417,3830840,483158090,0,3453,290163,2849,218447,604,71716,877,8,1189,18,0,37,130000.0,39000.0,-70.0,-70.0,-66.0,-60.0,-69.0,-70.0,-66.0,-60.0,-90.0,-93.0,-90.0,-93.0,20.0,23.0,24.0,33.0,1
148,BA:8C:B9:54:50:24,3835636,489336443,4796,6178353,3830840,483158090,0,8702,1679327,8680,1675832,22,3495,2344,14,5206,38,0,56,229410.0,130000.0,-48.0,-35.0,-43.0,-45.0,-44.0,-37.0,-45.0,-49.0,-90.0,-93.0,-90.0,-93.0,42.0,58.0,47.0,48.0,1
149,92:69:1D:31:68:E9,3834672,486754060,3828,3595566,3830844,483158494,0,4484,1068072,4353,1038522,131,29550,2052,10,3999,83,0,41,229410.0,130000.0,-52.0,-46.0,-42.0,-48.0,-51.0,-50.0,-44.0,-48.0,-90.0,-93.0,-90.0,-93.0,38.0,47.0,48.0,45.0,1
150,CC:2F:71:3F:1F:24,4496086,1195722013,665240,712563317,3830846,483158696,37,541551,569628017,540875,569546773,676,81244,523725,15,665488,71055,34,460,117000.0,39000.0,-79.0,-72.0,-77.0,-78.0,-78.0,-71.0,-77.0,-77.0,-90.0,-93.0,-90.0,-93.0,11.0,21.0,13.0,15.0,1
151,CC:2F:71:3E:C5:1F,3831675,483260113,829,101417,3830846,483158696,0,3453,290163,2849,218447,604,71716,877,8,1189,18,0,37,130000.0,39000.0,-70.0,-70.0,-66.0,-60.0,-69.0,-70.0,-66.0,-60.0,-90.0,-93.0,-90.0,-93.0,20.0,23.0,24.0,33.0,1
152,BA:8C:B9:54:50:24,3835642,489337049,4796,6178353,3830846,483158696,0,8702,1679327,8680,1675832,22,3495,2344,14,5206,38,0,56,229410.0,130000.0,-48.0,-35.0,-43.0,-45.0,-44.0,-37.0,-45.0,-49.0,-90.0,-93.0,-90.0,-93.0,42.0,58.0,47.0,48.0,1
153,92:69:1D:31:68:E9,3834677,486754524,3828,3595566,3830849,483158958,0,4484,1068072,4353,1038522,131,29550,2052,10,3999,83,0,41,229410.0,130000.0,-52.0,-46.0,-42.0,-48.0,-51.0,-50.0,-44.0,-48.0,-90.0,-93.0,-90.0,-93.0,38.0,47.0,48.0,45.0,1
154,CC:2F:71:3F:1F:24,4496358,1196072440,665509,712913482,3830849,483158958,37,541647,569642294,540971,569561050,676,81244,523819,15,665757,71233,34,460,130000.0,39000.0,-72.0,-66.0,-70.0,-72.0,-73.0,-66.0,-71.0,-72.0,-90.0,-93.0,-90.0,-93.0,18.0,27.0,20.0,21.0,1
155,CC:2F:71:3E:C5:1F,3831678,483260375,829,101417,3830849,483158958,0,3453,290163,2849,218447,604,71716,877,8,1189,18,0,37,130000.0,39000.0,-70.0,-70.0,-66.0,-60.0,-69.0,-70.0,-66.0,-60.0,-90.0,-93.0,-90.0,-93.0,20.0,23.0,24.0,33.0,1
156,BA:8C:B9:54:50:24,3835645,489337311,4796,6178353,3830849,483158958,0,8702,1679327,8680,1675832,22,3495,2344,14,5206,38,0,56,229410.0,130000.0,-48.0,-35.0,-43.0,-45.0,-44.0,-37.0,-45.0,-49.0,-90.0,-93.0,-90.0,-93.0,42.0,58.0,47.0,48.0,1
157,92:69:1D:31:68:E9,3834681,486754928,3828,3595566,3830853,483159362,0,4484,1068072,4353,1038522,131,29550,2052,10,3999,83,0,41,229410.0,130000.0,-52.0,-46.0,-42.0,-48.0,-51.0,-50.0,-44.0,-48.0,-90.0,-93.0,-90.0,-93.0,38.0,47.0,48.0,45.0,1
158,CC:2F:71:3F:1F:24,4496580,1196303784,665725,713144220,3830855,483159564,37,541745,569658785,541069,569577541,676,81244,523914,15,665973,71303,34,460,130000.0,43333.0,-73.0,-66.0,-71.0,-72.0,-73.0,-66.0,-71.0,-72.0,-90.0,-93.0,-90.0,-93.0,17.0,27.0,19.0,21.0,1
159,CC:2F:71:3E:C5:1F,3831684,483260981,829,101417,3830855,483159564,0,3453,290163,2849,218447,604,71716,877,8,1189,18,0,37,130000.0,39000.0,-70.0,-70.0,-66.0,-60.0,-69.0,-70.0,-66.0,-60.0,-90.0,-93.0,-90.0,-93.0,20.0,23.0,24.0,33.0,1
160,BA:8C:B9:54:50:24,3835652,489338033,4797,6178469,3830855,483159564,0,8707,1679709,8685,1676214,22,3495,2345,14,5207,38,0,56,229410.0,130000.0,-39.0,-37.0,-46.0,-51.0,-44.0,-37.0,-45.0,-49.0,-90.0,-93.0,-90.0,-93.0,51.0,56.0,44.0,42.0,1
161,92:69:1D:31:68:E9,3834686,486755605,3828,3595566,3830858,483160039,0,4484,1068072,4353,1038522,131,29550,2052,10,3999,83,0,41,229410.0,130000.0,-52.0,-46.0,-42.0,-48.0,-51.0,-50.0,-44.0,-48.0,-90.0,-93.0,-90.0,-93.0,38.0,47.0,48.0,45.0,1
162,CC:2F:71:3F:1F:24,4496655,1196354048,665796,713193949,3830859,483160099,37,541784,569664713,541108,569583469,676,81244,523951,15,666044,71329,34,460,130000.0,43333.0,-73.0,-66.0,-72.0,-72.0,-73.0,-66.0,-71.0,-72.0,-90.0,-93.0,-90.0,-93.0,17.0,27.0,18.0,21.0,1
163,CC:2F:71:3E:C5:1F,3831688,483261516,829,101417,3830859,483160099,0,3453,290163,2849,218447,604,71716,877,8,1189,18,0,37,130000.0,39000.0,-70.0,-70.0,-66.0,-60.0,-69.0,-70.0,-66.0,-60.0,-90.0,-93.0,-90.0,-93.0,20.0,23.0,24.0,33.0,1
164,BA:8C:B9:54:50:24,3835656,489338568,4797,6178469,3830859,483160099,0,8707,1679709,8685,1676214,22,3495,2345,14,5207,38,0,56,229410.0,130000.0,-39.0,-37.0,-46.0,-51.0,-44.0,-37.0,-45.0,-49.0,-90.0,-93.0,-90.0,-93.0,51.0,56.0,44.0,42.0,1
165,92:69:1D:31:68:E9,3834692,486756195,3828,3595566,3830864,483160629,0,4484,1068072,4353,1038522,131,29550,2052,10,3999,83,0,41,229410.0,130000.0,-52.0,-46.0,-42.0,-48.0,-51.0,-50.0,-44.0,-48.0,-90.0,-93.0,-90.0,-93.0,38.0,47.0,48.0,45.0,1
166,CC:2F:71:3F:1F:24,4496707,1196369622,665841,713208791,3830866,483160831,37,541815,569669561,541139,569588317,676,81244,523980,15,666088,71340,34,460,117000.0,39000.0,-73.0,-66.0,-71.0,-72.0,-73.0,-66.0,-71.0,-72.0,-90.0,-93.0,-90.0,-93.0,17.0,27.0,19.0,21.0,1
167,CC:2F:71:3E:C5:1F,3831695,483262248,829,101417,3830866,483160831,0,3453,290163,2849,218447,604,71716,877,8,1189,18,0,37,130000.0,39000.0,-70.0,-70.0,-66.0,-60.0,-69.0,-70.0,-66.0,-60.0,-90.0,-93.0,-90.0,-93.0,20.0,23.0,24.0,33.0,1
168,BA:8C:B9:54:50:24,3835663,489339300,4797,6178469,3830866,483160831,0,8707,1679709,8685,1676214,22,3495,2345,14,5207,38,0,56,229410.0,130000.0,-39.0,-37.0,-46.0,-51.0,-44.0,-37.0,-45.0,-49.0,-90.0,-93.0,-90.0,-93.0,51.0,56.0,44.0,42.0,1
169,92:69:1D:31:68:E9,3834696,486756599,3828,3595566,3830868,483161033,0,4484,1068072,4353,1038522,131,29550,2052,10,3999,83,0,41,229410.0,130000.0,-52.0,-46.0,-42.0,-48.0,-51.0,-50.0,-44.0,-48.0,-90.0,-93.0,-90.0,-93.0,38.0,47.0,48.0,45.0,1
170,CC:2F:71:3F:1F:24,4496989,1196646814,666121,713485781,3830868,483161033,37,541980,569697551,541304,569616307,676,81244,524135,15,666369,71409,34,461,130000.0,43333.0,-74.0,-66.0,-73.0,-72.0,-74.0,-66.0,-71.0,-72.0,-90.0,-93.0,-90.0,-93.0,16.0,27.0,17.0,21.0,1
171,CC:2F:71:3E:C5:1F,3831697,483262450,829,101417,3830868,483161033,0,3453,290163,2849,218447,604,71716,877,8,1189,18,0,37,130000.0,39000.0,-70.0,-70.0,-66.0,-60.0,-69.0,-70.0,-66.0,-60.0,-90.0,-93.0,-90.0,-93.0,20.0,23.0,24.0,33.0,1
172,BA:8C:B9:54:50:24,3835665,489339502,4797,6178469,3830868,483161033,0,8707,1679709,8685,1676214,22,3495,2345,14,5207,38,0,56,229410.0,130000.0,-39.0,-37.0,-46.0,-51.0,-44.0,-37.0,-45.0,-49.0,-90.0,-93.0,-90.0,-93.0,51.0,56.0,44.0,42.0,1
173,92:69:1D:31:68:E9,3834701,486757063,3828,3595566,3830873,483161497,0,4484,1068072,4353,1038522,131,29550,2052,10,3999,83,0,41,229410.0,130000.0,-52.0,-46.0,-42.0,-48.0,-51.0,-50.0,-44.0,-48.0,-90.0,-93.0,-90.0,-93.0,38.0,47.0,48.0,45.0,1
174,CC:2F:71:3F:1F:24,4497230,1196907644,666357,713746147,3830873,483161497,37,542098,569715202,541422,569633958,676,81244,524245,15,666605,71434,34,461,130000.0,39000.0,-73.0,-66.0,-72.0,-72.0,-73.0,-66.0,-71.0,-72.0,-90.0,-93.0,-90.0,-93.0,17.0,27.0,18.0,21.0,1
175,CC:2F:71:3E:C5:1F,3831704,483263116,829,101417,3830875,483161699,0,3453,290163,2849,218447,604,71716,877,8,1189,18,0,37,130000.0,39000.0,-70.0,-70.0,-66.0,-60.0,-69.0,-70.0,-66.0,-60.0,-90.0,-93.0,-90.0,-93.0,20.0,23.0,24.0,33.0,1
176,BA:8C:B9:54:50:24,3835672,489340168,4797,6178469,3830875,483161699,0,8707,1679709,8685,1676214,22,3495,2345,14,5207,38,0,56,229410.0,130000.0,-39.0,-37.0,-46.0,-51.0,-44.0,-37.0,-45.0,-49.0,-90.0,-93.0,-90.0,-93.0,51.0,56.0,44.0,42.0,1
177,92:69:1D:31:68:E9,3834705,486757467,3828,3595566,3830877,483161901,0,4484,1068072,4353,1038522,131,29550,2052,10,3999,83,0,41,229410.0,130000.0,-52.0,-46.0,-42.0,-48.0,-51.0,-50.0,-44.0,-48.0,-90.0,-93.0,-90.0,-93.0,38.0,47.0,48.0,45.0,1
178,CC:2F:71:3F:1F:24,4497290,1196927617,666413,713765716,3830877,483161901,37,542141,569722796,541465,569641552,676,81244,524284,15,666661,71452,34,461,130000.0,39000.0,-73.0,-66.0,-69.0,-72.0,-73.0,-66.0,-69.0,-72.0,-90.0,-93.0,-90.0,-93.0,17.0,27.0,21.0,21.0,1
179,CC:2F:71:3E:C5:1F,3831706,483263318,829,101417,3830877,483161901,0,3453,290163,2849,218447,604,71716,877,8,1189,18,0,37,130000.0,39000.0,-70.0,-70.0,-66.0,-60.0,-69.0,-70.0,-66.0,-60.0,-90.0,-93.0,-90.0,-93.0,20.0,23.0,24.0,33.0,1
180,BA:8C:B9:54:50:24,3835674,489340370,4797,6178469,3830877,483161901,0,8707,1679709,8685,1676214,22,3495,2345,14,5207,38,0,56,229410.0,130000.0,-39.0,-37.0,-46.0,-51.0,-44.0,-37.0,-45.0,-49.0,-90.0,-93.0,-90.0,-93.0,51.0,56.0,44.0,42.0,1
181,92:69:1D:31:68:E9,3834709,486757871,3828,3595566,3830881,483162305,0,4484,1068072,4353,1038522,131,29550,2052,10,3999,83,0,41,229410.0,130000.0,-52.0,-46.0,-42.0,-48.0,-51.0,-50.0,-44.0,-48.0,-90.0,-93.0,-90.0,-93.0,38.0,47.0,48.0,45.0,1
182,CC:2F:71:3F:1F:24,4497333,1196942139,666452,713779834,3830881,483162305,37,542166,569727102,541490,569645858,676,81244,524306,15,666700,71454,34,461,130000.0,43333.0,-72.0,-66.0,-69.0,-72.0,-72.0,-66.0,-69.0,-72.0,-90.0,-93.0,-90.0,-93.0,18.0,27.0,21.0,21.0,1
183,CC:2F:71:3E:C5:1F,3831712,483263924,829,101417,3830883,483162507,0,3453,290163,2849,218447,604,71716,877,8,1189,18,0,37,130000.0,39000.0,-70.0,-70.0,-66.0,-60.0,-69.0,-70.0,-66.0,-60.0,-90.0,-93.0,-90.0,-93.0,20.0,23.0,24.0,33.0,1
184,BA:8C:B9:54:50:24,3835680,489340976,4797,6178469,3830883,483162507,0,8707,1679709,8685,1676214,22,3495,2345,14,5207,38,0,56,229410.0,130000.0,-39.0,-37.0,-46.0,-51.0,-44.0,-37.0,-45.0,-49.0,-90.0,-93.0,-90.0,-93.0,51.0,56.0,44.0,42.0,1
185,92:69:1D:31:68:E9,3834714,486758335,3828,3595566,3830886,483162769,0,4484,1068072,4353,1038522,131,29550,2052,10,3999,83,0,41,229410.0,130000.0,-52.0,-46.0,-42.0,-48.0,-51.0,-50.0,-44.0,-48.0,-90.0,-93.0,-90.0,-93.0,38.0,47.0,48.0,45.0,1
186,CC:2F:71:3F:1F:24,4497379,1196957043,666493,713794274,3830886,483162769,37,542192,569731476,541516,569650232,676,81244,524330,15,666741,71465,34,461,130000.0,39000.0,-73.0,-66.0,-70.0,-72.0,-72.0,-66.0,-70.0,-71.0,-90.0,-93.0,-90.0,-93.0,17.0,27.0,20.0,21.0,1
187,CC:2F:71:3E:C5:1F,3831715,483264186,829,101417,3830886,483162769,0,3453,290163,2849,218447,604,71716,877,8,1189,18,0,37,130000.0,39000.0,-70.0,-70.0,-66.0,-60.0,-69.0,-70.0,-66.0,-60.0,-90.0,-93.0,-90.0,-93.0,20.0,23.0,24.0,33.0,1
188,BA:8C:B9:54:50:24,3835683,489341238,4797,6178469,3830886,483162769,0,8707,1679709,8685,1676214,22,3495,2345,14,5207,38,0,56,229410.0,130000.0,-39.0,-37.0,-46.0,-51.0,-44.0,-37.0,-45.0,-49.0,-90.0,-93.0,-90.0,-93.0,51.0,56.0,44.0,42.0,1
189,92:69:1D:31:68:E9,3834718,486758739,3828,3595566,3830890,483163173,0,4484,1068072,4353,1038522,131,29550,2052,10,3999,83,0,41,229410.0,130000.0,-52.0,-46.0,-42.0,-48.0,-51.0,-50.0,-44.0,-48.0,-90.0,-93.0,-90.0,-93.0,38.0,47.0,48.0,45.0,1
190,CC:2F:71:3F:1F:24,4497435,1196977392,666545,713814219,3830890,483163173,37,542234,569738778,541558,569657534,676,81244,524367,15,666793,71470,34,461,130000.0,43333.0,-72.0,-66.0,-70.0,-71.0,-72.0,-66.0,-69.0,-71.0,-90.0,-93.0,-90.0,-93.0,18.0,27.0,20.0,22.0,1
191,CC:2F:71:3E:C5:1F,3831721,483264792,829,101417,3830892,483163375,0,3453,290163,2849,218447,604,71716,877,8,1189,18,0,37,130000.0,39000.0,-70.0,-70.0,-66.0,-60.0,-69.0,-70.0,-66.0,-60.0,-90.0,-93.0,-90.0,-93.0,20.0,23.0,24.0,33.0,1
192,BA:8C:B9:54:50:24,3835689,489341844,4797,6178469,3830892,483163375,0,8707,1679709,8685,1676214,22,3495,2345,14,5207,38,0,56,229410.0,130000.0,-39.0,-37.0,-46.0,-51.0,-44.0,-37.0,-45.0,-49.0,-90.0,-93.0,-90.0,-93.0,51.0,56.0,44.0,42.0,1
193,92:69:1D:31:68:E9,3834723,486759203,3828,3595566,3830895,483163637,0,4485,1068140,4354,1038590,131,29550,2052,10,3999,83,0,41,229410.0,130000.0,-52.0,-50.0,-44.0,-47.0,-51.0,-50.0,-44.0,-48.0,-90.0,-93.0,-90.0,-93.0,38.0,43.0,46.0,46.0,1
194,CC:2F:71:3F:1F:24,4497480,1196992160,666585,713828523,3830895,483163637,37,542258,569742936,541582,569661692,676,81244,524388,15,666833,71470,34,461,130000.0,43333.0,-72.0,-66.0,-70.0,-71.0,-72.0,-66.0,-70.0,-71.0,-90.0,-93.0,-90.0,-93.0,18.0,27.0,20.0,22.0,1
195,CC:2F:71:3E:C5:1F,3831724,483265054,829,101417,3830895,483163637,0,3453,290163,2849,218447,604,71716,877,8,1189,18,0,37,130000.0,39000.0,-70.0,-70.0,-66.0,-60.0,-69.0,-70.0,-66.0,-60.0,-90.0,-93.0,-90.0,-93.0,20.0,23.0,24.0,33.0,1
196,BA:8C:B9:54:50:24,3835692,489342106,4797,6178469,3830895,483163637,0,8707,1679709,8685,1676214,22,3495,2345,14,5207,38,0,56,229410.0,130000.0,-39.0,-37.0,-46.0,-51.0,-44.0,-37.0,-45.0,-49.0,-90.0,-93.0,-90.0,-93.0,51.0,56.0,44.0,42.0,1
197,92:69:1D:31:68:E9,3834727,486759607,3828,3595566,3830899,483164041,0,4485,1068140,4354,1038590,131,29550,2052,10,3999,83,0,41,229410.0,130000.0,-52.0,-50.0,-44.0,-47.0,-51.0,-50.0,-44.0,-48.0,-90.0,-93.0,-90.0,-93.0,38.0,43.0,46.0,46.0,1
198,CC:2F:71:3F:1F:24,4497524,1197006812,666625,713842771,3830899,483164041,37,542281,569746902,541605,569665658,676,81244,524410,15,666873,71476,34,461,130000.0,39000.0,-72.0,-66.0,-70.0,-71.0,-72.0,-66.0,-70.0,-71.0,-90.0,-93.0,-90.0,-93.0,18.0,27.0,20.0,22.0,1
199,CC:2F:71:3E:C5:1F,3831730,483265660,829,101417,3830901,483164243,0,3453,290163,2849,218447,604,71716,877,8,1189,18,0,37,130000.0,39000.0,-70.0,-70.0,-66.0,-60.0,-69.0,-70.0,-66.0,-60.0,-90.0,-93.0,-90.0,-93.0,20.0,23.0,24.0,33.0,1
200,BA:8C:B9:54:50:24,3835698,489342712,4797,6178469,3830901,483164243,0,8707,1679709,8685,1676214,22,3495,2345,14,5207,38,0,56,229410.0,130000.0,-39.0,-37.0,-46.0,-51.0,-44.0,-37.0,-45.0,-49.0,-90.0,-93.0,-90.0,-93.0,51.0,56.0,44.0,42.0,1
201,92:69:1D:31:68:E9,3834731,486760011,3828,3595566,3830903,483164445,0,4485,1068140,4354,1038590,131,29550,2052,10,3999,83,0,41,229410.0,130000.0,-52.0,-50.0,-44.0,-47.0,-51.0,-50.0,-44.0,-48.0,-90.0,-93.0,-90.0,-93.0,38.0,43.0,46.0,46.0,1
202,CC:2F:71:3F:1F:24,4497568,1197021408,666665,713856963,3830903,483164445,37,542304,569750868,541628,569669624,676,81244,524432,15,666913,71482,34,461,130000.0,39000.0,-72.0,-66.0,-70.0,-71.0,-72.0,-66.0,-70.0,-71.0,-90.0,-93.0,-90.0,-93.0,18.0,27.0,20.0,22.0,1
203,CC:2F:71:3E:C5:1F,3831732,483265862,829,101417,3830903,483164445,0,3453,290163,2849,218447,604,71716,877,8,1189,18,0,37,130000.0,39000.0,-70.0,-70.0,-66.0,-60.0,-69.0,-70.0,-66.0,-60.0,-90.0,-93.0,-90.0,-93.0,20.0,23.0,24.0,33.0,1
204,BA:8C:B9:54:50:24,3835701,489342974,4797,6178469,3830904,483164505,0,8707,1679709,8685,1676214,22,3495,2345,14,5207,38,0,56,229410.0,130000.0,-39.0,-37.0,-46.0,-51.0,-44.0,-37.0,-45.0,-49.0,-90.0,-93.0,-90.0,-93.0,51.0,56.0,44.0,42.0,1
205,92:69:1D:31:68:E9,3834737,486760535,3828,3595566,3830909,483164969,0,4485,1068140,4354,1038590,131,29550,2052,10,3999,83,0,41,229410.0,130000.0,-52.0,-50.0,-44.0,-47.0,-51.0,-50.0,-44.0,-48.0,-90.0,-93.0,-90.0,-93.0,38.0,43.0,46.0,46.0,1
206,CC:2F:71:3F:1F:24,4497622,1197039683,666712,713874628,3830910,483165055,37,542339,569756742,541661,569675242,678,81500,524466,15,666960,71483,34,461,130000.0,39000.0,-72.0,-66.0,-71.0,-71.0,-72.0,-66.0,-70.0,-71.0,-90.0,-93.0,-90.0,-93.0,18.0,27.0,19.0,22.0,1
207,CC:2F:71:3E:C5:1F,3831739,483266472,829,101417,3830910,483165055,0,3453,290163,2849,218447,604,71716,877,8,1189,18,0,37,130000.0,39000.0,-70.0,-70.0,-66.0,-60.0,-69.0,-70.0,-66.0,-60.0,-90.0,-93.0,-90.0,-93.0,20.0,23.0,24.0,33.0,1
208,BA:8C:B9:54:50:24,3835710,489343792,4797,6178469,3830913,483165323,0,8707,1679709,8685,1676214,22,3495,2345,14,5207,38,0,56,229410.0,130000.0,-39.0,-37.0,-46.0,-51.0,-44.0,-37.0,-45.0,-49.0,-90.0,-93.0,-90.0,-93.0,51.0,56.0,44.0,42.0,1
209,92:69:1D:31:68:E9,3834745,486761341,3829,3595682,3830916,483165659,0,4487,1068276,4356,1038726,131,29550,2052,10,4000,83,0,41,229410.0,130000.0,-52.0,-50.0,-44.0,-47.0,-51.0,-49.0,-43.0,-47.0,-90.0,-93.0,-90.0,-93.0,38.0,43.0,46.0,46.0,1
210,CC:2F:71:3F:1F:24,4497669,1197054651,666753,713888992,3830916,483165659,37,542363,569760904,541683,569679092,680,81812,524489,15,667001,71499,34,461,117000.0,39000.0,-72.0,-66.0,-69.0,-71.0,-72.0,-66.0,-69.0,-71.0,-90.0,-93.0,-90.0,-93.0,18.0,27.0,21.0,22.0,1
211,CC:2F:71:3E:C5:1F,3831746,483267192,830,101533,3830916,483165659,0,3455,290303,2851,218587,604,71716,877,8,1190,18,0,37,130000.0,39000.0,-70.0,-71.0,-66.0,-60.0,-70.0,-70.0,-66.0,-60.0,-90.0,-93.0,-90.0,-93.0,20.0,22.0,24.0,33.0,1
212,BA:8C:B9:54:50:24,3835714,489344244,4798,6178585,3830916,483165659,0,8709,1679845,8687,1676350,22,3495,2345,14,5208,38,0,56,229410.0,130000.0,-40.0,-37.0,-45.0,-51.0,-43.0,-36.0,-44.0,-48.0,-90.0,-93.0,-90.0,-93.0,50.0,56.0,45.0,42.0,1
213,92:69:1D:31:68:E9,3834749,486761745,3829,3595682,3830920,483166063,0,4487,1068276,4356,1038726,131,29550,2052,10,4000,83,0,41,229410.0,130000.0,-52.0,-50.0,-44.0,-47.0,-51.0,-49.0,-43.0,-47.0,-90.0,-93.0,-90.0,-93.0,38.0,43.0,46.0,46.0,1
214,CC:2F:71:3F:1F:24,4497713,1197069247,666793,713903184,3830920,483166063,37,542387,569764986,541707,569683174,680,81812,524512,15,667041,71503,34,461,130000.0,43333.0,-72.0,-66.0,-70.0,-72.0,-72.0,-66.0,-70.0,-71.0,-90.0,-93.0,-90.0,-93.0,18.0,27.0,20.0,21.0,1
215,CC:2F:71:3E:C5:1F,3831751,483267869,830,101533,3830921,483166336,0,3455,290303,2851,218587,604,71716,877,8,1190,18,0,37,130000.0,39000.0,-70.0,-71.0,-66.0,-60.0,-70.0,-70.0,-66.0,-60.0,-90.0,-93.0,-90.0,-93.0,20.0,22.0,24.0,33.0,1
216,BA:8C:B9:54:50:24,3835719,489344921,4798,6178585,3830921,483166336,0,8709,1679845,8687,1676350,22,3495,2345,14,5208,38,0,56,229410.0,130000.0,-40.0,-37.0,-45.0,-51.0,-43.0,-36.0,-44.0,-48.0,-90.0,-93.0,-90.0,-93.0,50.0,56.0,45.0,42.0,1
217,92:69:1D:31:68:E9,3834755,486762482,3829,3595682,3830926,483166800,0,4487,1068276,4356,1038726,131,29550,2052,10,4000,83,0,41,229410.0,130000.0,-52.0,-50.0,-44.0,-47.0,-51.0,-49.0,-43.0,-47.0,-90.0,-93.0,-90.0,-93.0,38.0,43.0,46.0,46.0,1
218,CC:2F:71:3F:1F:24,4497765,1197085140,666839,713918340,3830926,483166800,37,542418,569769846,541738,569688034,680,81812,524541,15,667087,71510,34,461,130000.0,39000.0,-72.0,-66.0,-70.0,-71.0,-72.0,-66.0,-70.0,-71.0,-90.0,-93.0,-90.0,-93.0,18.0,27.0,20.0,22.0,1
219,CC:2F:71:3E:C5:1F,3831756,483268333,830,101533,3830926,483166800,0,3455,290303,2851,218587,604,71716,877,8,1190,18,0,37,130000.0,39000.0,-70.0,-71.0,-66.0,-60.0,-70.0,-70.0,-66.0,-60.0,-90.0,-93.0,-90.0,-93.0,20.0,22.0,24.0,33.0,1
220,BA:8C:B9:54:50:24,3835724,489345385,4798,6178585,3830926,483166800,0,8709,1679845,8687,1676350,22,3495,2345,14,5208,38,0,56,229410.0,130000.0,-40.0,-37.0,-45.0,-51.0,-43.0,-36.0,-44.0,-48.0,-90.0,-93.0,-90.0,-93.0,50.0,56.0,45.0,42.0,1
221,92:69:1D:31:68:E9,3834759,486762886,3829,3595682,3830930,483167204,0,4487,1068276,4356,1038726,131,29550,2052,10,4000,83,0,41,229410.0,130000.0,-52.0,-50.0,-44.0,-47.0,-51.0,-49.0,-43.0,-47.0,-90.0,-93.0,-90.0,-93.0,38.0,43.0,46.0,46.0,1
222,CC:2F:71:3F:1F:24,4497817,1197102043,666887,713934839,3830930,483167204,37,542451,569775464,541771,569693652,680,81812,524573,15,667135,71515,34,461,130000.0,43333.0,-72.0,-66.0,-69.0,-71.0,-72.0,-66.0,-69.0,-71.0,-90.0,-93.0,-90.0,-93.0,18.0,27.0,21.0,22.0,1
223,CC:2F:71:3E:C5:1F,3831760,483268737,830,101533,3830930,483167204,0,3455,290303,2851,218587,604,71716,877,8,1190,18,0,37,130000.0,39000.0,-70.0,-71.0,-66.0,-60.0,-70.0,-70.0,-66.0,-60.0,-90.0,-93.0,-90.0,-93.0,20.0,22.0,24.0,33.0,1
224,BA:8C:B9:54:50:24,3835728,489345789,4798,6178585,3830930,483167204,0,8709,1679845,8687,1676350,22,3495,2345,14,5208,38,0,56,229410.0,130000.0,-40.0,-37.0,-45.0,-51.0,-43.0,-36.0,-44.0,-48.0,-90.0,-93.0,-90.0,-93.0,50.0,56.0,45.0,42.0,1
225,92:69:1D:31:68:E9,3834764,486763350,3829,3595682,3830935,483167668,0,4487,1068276,4356,1038726,131,29550,2052,10,4000,83,0,41,229410.0,130000.0,-52.0,-50.0,-44.0,-47.0,-51.0,-49.0,-43.0,-47.0,-90.0,-93.0,-90.0,-93.0,38.0,43.0,46.0,46.0,1
226,CC:2F:71:3F:1F:24,4497868,1197118719,666933,713951051,3830935,483167668,37,542482,569780312,541802,569698500,680,81812,524602,15,667181,71535,34,461,144444.0,39000.0,-72.0,-66.0,-70.0,-71.0,-72.0,-66.0,-70.0,-71.0,-90.0,-93.0,-90.0,-93.0,18.0,27.0,20.0,22.0,1
227,CC:2F:71:3E:C5:1F,3831765,483269201,830,101533,3830935,483167668,0,3455,290303,2851,218587,604,71716,877,8,1190,18,0,37,130000.0,39000.0,-70.0,-71.0,-66.0,-60.0,-70.0,-70.0,-66.0,-60.0,-90.0,-93.0,-90.0,-93.0,20.0,22.0,24.0,33.0,1
228,BA:8C:B9:54:50:24,3835735,489346621,4798,6178585,3830937,483168036,0,8709,1679845,8687,1676350,22,3495,2345,14,5208,38,0,56,229410.0,130000.0,-40.0,-37.0,-45.0,-51.0,-43.0,-36.0,-44.0,-48.0,-90.0,-93.0,-90.0,-93.0,50.0,56.0,45.0,42.0,1
229,92:69:1D:31:68:E9,3834770,486764122,3829,3595682,3830941,483168440,0,4487,1068276,4356,1038726,131,29550,2052,10,4000,83,0,41,229410.0,130000.0,-52.0,-50.0,-44.0,-47.0,-51.0,-49.0,-43.0,-47.0,-90.0,-93.0,-90.0,-93.0,38.0,43.0,46.0,46.0,1
230,CC:2F:71:3F:1F:24,4497918,1197134203,666977,713965763,3830941,483168440,37,542513,569785236,541833,569703424,680,81812,524629,15,667225,71542,34,461,130000.0,43333.0,-72.0,-66.0,-70.0,-71.0,-72.0,-66.0,-69.0,-71.0,-90.0,-93.0,-90.0,-93.0,18.0,27.0,20.0,22.0,1
231,CC:2F:71:3E:C5:1F,3831771,483269973,830,101533,3830941,483168440,0,3455,290303,2851,218587,604,71716,877,8,1190,18,0,37,130000.0,39000.0,-70.0,-71.0,-66.0,-60.0,-70.0,-70.0,-66.0,-60.0,-90.0,-93.0,-90.0,-93.0,20.0,22.0,24.0,33.0,1
232,BA:8C:B9:54:50:24,3835739,489347025,4798,6178585,3830941,483168440,0,8709,1679845,8687,1676350,22,3495,2345,14,5208,38,0,56,229410.0,130000.0,-40.0,-37.0,-45.0,-51.0,-43.0,-36.0,-44.0,-48.0,-90.0,-93.0,-90.0,-93.0,50.0,56.0,45.0,42.0,1
233,92:69:1D:31:68:E9,3834774,486764526,3829,3595682,3830945,483168844,0,4487,1068276,4356,1038726,131,29550,2052,10,4000,83,0,41,229410.0,130000.0,-52.0,-50.0,-44.0,-47.0,-51.0,-49.0,-43.0,-47.0,-90.0,-93.0,-90.0,-93.0,38.0,43.0,46.0,46.0,1
234,CC:2F:71:3F:1F:24,4497962,1197148855,667017,713980011,3830945,483168844,37,542536,569789202,541856,569707390,680,81812,524651,15,667265,71552,34,461,130000.0,39000.0,-72.0,-66.0,-70.0,-71.0,-72.0,-66.0,-70.0,-71.0,-90.0,-93.0,-90.0,-93.0,18.0,27.0,20.0,22.0,1
235,CC:2F:71:3E:C5:1F,3831775,483270377,830,101533,3830945,483168844,0,3455,290303,2851,218587,604,71716,877,8,1190,18,0,37,130000.0,39000.0,-70.0,-71.0,-66.0,-60.0,-70.0,-70.0,-66.0,-60.0,-90.0,-93.0,-90.0,-93.0,20.0,22.0,24.0,33.0,1
236,BA:8C:B9:54:50:24,3835743,489347429,4798,6178585,3830945,483168844,0,8709,1679845,8687,1676350,22,3495,2345,14,5208,38,0,56,229410.0,130000.0,-40.0,-37.0,-45.0,-51.0,-43.0,-36.0,-44.0,-48.0,-90.0,-93.0,-90.0,-93.0,50.0,56.0,45.0,42.0,1
237,92:69:1D:31:68:E9,3834779,486764990,3829,3595682,3830950,483169308,0,4487,1068276,4356,1038726,131,29550,2052,10,4000,83,0,41,229410.0,130000.0,-52.0,-50.0,-44.0,-47.0,-51.0,-49.0,-43.0,-47.0,-90.0,-93.0,-90.0,-93.0,38.0,43.0,46.0,46.0,1
238,CC:2F:71:3F:1F:24,4498014,1197166928,667064,713997620,3830950,483169308,37,542568,569794717,541888,569712905,680,81812,524681,15,667312,71563,34,461,130000.0,43333.0,-72.0,-66.0,-70.0,-71.0,-72.0,-66.0,-69.0,-71.0,-90.0,-93.0,-90.0,-93.0,18.0,27.0,20.0,22.0,1
239,CC:2F:71:3E:C5:1F,3831780,483270841,830,101533,3830950,483169308,0,3456,290373,2852,218657,604,71716,877,8,1191,18,0,37,130000.0,39000.0,-70.0,-71.0,-66.0,-60.0,-70.0,-70.0,-66.0,-60.0,-90.0,-93.0,-90.0,-93.0,20.0,22.0,24.0,33.0,1
240,BA:8C:B9:54:50:24,3835748,489347893,4798,6178585,3830950,483169308,0,8709,1679845,8687,1676350,22,3495,2345,14,5208,38,0,56,229410.0,130000.0,-40.0,-37.0,-45.0,-51.0,-43.0,-36.0,-44.0,-48.0,-90.0,-93.0,-90.0,-93.0,50.0,56.0,45.0,42.0,1
241,92:69:1D:31:68:E9,3834783,486765394,3829,3595682,3830954,483169712,0,4489,1068412,4358,1038862,131,29550,2052,10,4001,83,0,41,229410.0,130000.0,-52.0,-50.0,-44.0,-47.0,-52.0,-49.0,-43.0,-47.0,-90.0,-93.0,-90.0,-93.0,38.0,43.0,46.0,46.0,1
242,CC:2F:71:3F:1F:24,4498058,1197181636,667104,714011924,3830954,483169712,37,542590,569798709,541910,569716897,680,81812,524701,15,667352,71565,34,461,130000.0,43333.0,-72.0,-66.0,-70.0,-71.0,-72.0,-66.0,-69.0,-71.0,-90.0,-93.0,-90.0,-93.0,18.0,27.0,20.0,22.0,1
243,CC:2F:71:3E:C5:1F,3831784,483271245,830,101533,3830954,483169712,0,3457,290443,2853,218727,604,71716,877,8,1191,18,0,37,130000.0,39000.0,-70.0,-71.0,-66.0,-60.0,-70.0,-70.0,-66.0,-60.0,-90.0,-93.0,-90.0,-93.0,20.0,22.0,24.0,33.0,1
244,BA:8C:B9:54:50:24,3835752,489348297,4798,6178585,3830954,483169712,0,8711,1679981,8689,1676486,22,3495,2345,14,5209,38,0,56,229410.0,130000.0,-40.0,-37.0,-45.0,-51.0,-42.0,-36.0,-45.0,-49.0,-90.0,-93.0,-90.0,-93.0,50.0,56.0,45.0,42.0,1
245,92:69:1D:31:68:E9,3834787,486765798,3829,3595682,3830958,483170116,0,4489,1068412,4358,1038862,131,29550,2052,10,4001,83,0,41,229410.0,130000.0,-52.0,-50.0,-44.0,-47.0,-52.0,-49.0,-43.0,-47.0,-90.0,-93.0,-90.0,-93.0,38.0,43.0,46.0,46.0,1
246,CC:2F:71:3F:1F:24,4498102,1197196176,667144,714026060,3830958,483170116,37,542612,569802559,541932,569720747,680,81812,524722,15,667392,71581,34,461,130000.0,39000.0,-73.0,-66.0,-71.0,-71.0,-72.0,-66.0,-70.0,-71.0,-90.0,-93.0,-90.0,-93.0,17.0,27.0,19.0,22.0,1
247,CC:2F:71:3E:C5:1F,3831789,483271709,830,101533,3830959,483170176,0,3457,290443,2853,218727,604,71716,877,8,1191,18,0,37,130000.0,39000.0,-70.0,-71.0,-66.0,-60.0,-70.0,-70.0,-66.0,-60.0,-90.0,-93.0,-90.0,-93.0,20.0,22.0,24.0,33.0,1
248,BA:8C:B9:54:50:24,3835757,489348761,4798,6178585,3830959,483170176,0,8711,1679981,8689,1676486,22,3495,2345,14,5209,38,0,56,229410.0,130000.0,-40.0,-37.0,-45.0,-51.0,-42.0,-36.0,-45.0,-49.0,-90.0,-93.0,-90.0,-93.0,50.0,56.0,45.0,42.0,1
249,92:69:1D:31:68:E9,3834793,486766324,3829,3595682,3830964,483170642,0,4489,1068412,4358,1038862,131,29550,2052,10,4001,83,0,41,229410.0,130000.0,-52.0,-50.0,-44.0,-47.0,-52.0,-49.0,-43.0,-47.0,-90.0,-93.0,-90.0,-93.0,38.0,43.0,46.0,46.0,1
250,CC:2F:71:3F:1F:24,4498148,1197210838,667184,714040196,3830964,483170642,37,542638,569806785,541956,569724737,682,82048,524744,15,667432,71611,34,463,130000.0,43333.0,-72.0,-65.0,-71.0,-71.0,-72.0,-65.0,-71.0,-71.0,-90.0,-93.0,-90.0,-93.0,18.0,28.0,19.0,22.0,1
251,CC:2F:71:3E:C5:1F,3831794,483272175,830,101533,3830964,483170642,0,3457,290443,2853,218727,604,71716,877,8,1191,18,0,37,130000.0,39000.0,-70.0,-71.0,-66.0,-60.0,-70.0,-70.0,-66.0,-60.0,-90.0,-93.0,-90.0,-93.0,20.0,22.0,24.0,33.0,1
252,BA:8C:B9:54:50:24,3835762,489349227,4798,6178585,3830964,483170642,0,8711,1679981,8689,1676486,22,3495,2345,14,5209,38,0,56,229410.0,130000.0,-40.0,-37.0,-45.0,-51.0,-42.0,-36.0,-45.0,-49.0,-90.0,-93.0,-90.0,-93.0,50.0,56.0,45.0,42.0,1
253,92:69:1D:31:68:E9,3834797,486766728,3829,3595682,3830968,483171046,0,4489,1068412,4358,1038862,131,29550,2052,10,4001,83,0,41,229410.0,130000.0,-52.0,-50.0,-44.0,-47.0,-52.0,-49.0,-43.0,-47.0,-90.0,-93.0,-90.0,-93.0,38.0,43.0,46.0,46.0,1
254,CC:2F:71:3F:1F:24,4498463,1197544507,667495,714373461,3830968,483171046,37,542807,569834647,542125,569752599,682,82048,524910,15,667743,71642,34,463,130000.0,43333.0,-72.0,-65.0,-71.0,-71.0,-72.0,-65.0,-71.0,-71.0,-90.0,-93.0,-90.0,-93.0,18.0,28.0,19.0,22.0,1
255,CC:2F:71:3E:C5:1F,3831798,483272579,830,101533,3830968,483171046,0,3457,290443,2853,218727,604,71716,877,8,1191,18,0,37,130000.0,39000.0,-70.0,-71.0,-66.0,-60.0,-70.0,-70.0,-66.0,-60.0,-90.0,-93.0,-90.0,-93.0,20.0,22.0,24.0,33.0,1
256,BA:8C:B9:54:50:24,3835766,489349631,4798,6178585,3830968,483171046,0,8711,1679981,8689,1676486,22,3495,2345,14,5209,38,0,56,229410.0,130000.0,-40.0,-37.0,-45.0,-51.0,-42.0,-36.0,-45.0,-49.0,-90.0,-93.0,-90.0,-93.0,50.0,56.0,45.0,42.0,1
257,92:69:1D:31:68:E9,3834802,486767192,3829,3595682,3830973,483171510,0,4489,1068412,4358,1038862,131,29550,2052,10,4001,83,0,41,229410.0,130000.0,-52.0,-50.0,-44.0,-47.0,-52.0,-49.0,-43.0,-47.0,-90.0,-93.0,-90.0,-93.0,38.0,43.0,46.0,46.0,1
258,CC:2F:71:3F:1F:24,4498997,1198194878,668023,715023306,3830974,483171572,37,543029,569868442,542347,569786394,682,82048,525127,15,668271,71654,34,463,130000.0,43333.0,-72.0,-66.0,-70.0,-71.0,-72.0,-66.0,-69.0,-71.0,-90.0,-93.0,-90.0,-93.0,18.0,27.0,20.0,22.0,1
259,CC:2F:71:3E:C5:1F,3831804,483273105,830,101533,3830974,483171572,0,3458,290561,2853,218727,605,71834,878,8,1191,18,0,37,130000.0,39000.0,-70.0,-70.0,-66.0,-59.0,-70.0,-70.0,-66.0,-59.0,-90.0,-93.0,-90.0,-93.0,20.0,23.0,24.0,34.0,1
260,BA:8C:B9:54:50:24,3835772,489350157,4798,6178585,3830974,483171572,0,8711,1679981,8689,1676486,22,3495,2345,14,5209,38,0,56,229410.0,130000.0,-40.0,-37.0,-45.0,-51.0,-42.0,-36.0,-45.0,-49.0,-90.0,-93.0,-90.0,-93.0,50.0,56.0,45.0,42.0,1
261,92:69:1D:31:68:E9,3834807,486767658,3829,3595682,3830978,483171976,0,4489,1068412,4358,1038862,131,29550,2052,10,4001,83,0,41,229410.0,130000.0,-52.0,-50.0,-44.0,-47.0,-52.0,-49.0,-43.0,-47.0,-90.0,-93.0,-90.0,-93.0,38.0,43.0,46.0,46.0,1
262,CC:2F:71:3F:1F:24,4499475,1198740008,668497,715568032,3830978,483171976,37,543266,569902554,542584,569820506,682,82048,525356,15,668745,71739,34,463,117000.0,39000.0,-74.0,-67.0,-70.0,-70.0,-73.0,-66.0,-69.0,-70.0,-90.0,-93.0,-90.0,-93.0,16.0,26.0,20.0,23.0,1
263,CC:2F:71:3E:C5:1F,3831808,483273509,830,101533,3830978,483171976,0,3459,290631,2854,218797,605,71834,878,8,1191,18,0,37,130000.0,39000.0,-69.0,-64.0,-63.0,-58.0,-69.0,-69.0,-65.0,-59.0,-90.0,-93.0,-90.0,-93.0,21.0,29.0,27.0,35.0,1
264,BA:8C:B9:54:50:24,3835776,489350561,4798,6178585,3830978,483171976,0,8711,1679981,8689,1676486,22,3495,2345,14,5209,38,0,56,229410.0,130000.0,-40.0,-37.0,-45.0,-51.0,-42.0,-36.0,-45.0,-49.0,-90.0,-93.0,-90.0,-93.0,50.0,56.0,45.0,42.0,1
265,92:69:1D:31:68:E9,3834811,486768062,3829,3595682,3830982,483172380,0,4489,1068412,4358,1038862,131,29550,2052,10,4001,83,0,41,229410.0,130000.0,-52.0,-50.0,-44.0,-47.0,-52.0,-49.0,-43.0,-47.0,-90.0,-93.0,-90.0,-93.0,38.0,43.0,46.0,46.0,1
266,CC:2F:71:3F:1F:24,4499519,1198754604,668537,715582224,3830982,483172380,37,543290,569906636,542608,569824588,682,82048,525379,15,668785,71744,34,463,130000.0,43333.0,-69.0,-68.0,-69.0,-70.0,-69.0,-66.0,-69.0,-70.0,-90.0,-93.0,-90.0,-93.0,21.0,25.0,21.0,23.0,1
267,CC:2F:71:3E:C5:1F,3831812,483273913,830,101533,3830982,483172380,0,3459,290631,2854,218797,605,71834,878,8,1191,18,0,37,130000.0,39000.0,-69.0,-64.0,-63.0,-58.0,-69.0,-69.0,-65.0,-59.0,-90.0,-93.0,-90.0,-93.0,21.0,29.0,27.0,35.0,1
268,BA:8C:B9:54:50:24,3835780,489350965,4798,6178585,3830982,483172380,0,8711,1679981,8689,1676486,22,3495,2345,14,5209,38,0,56,229410.0,130000.0,-40.0,-37.0,-45.0,-51.0,-42.0,-36.0,-45.0,-49.0,-90.0,-93.0,-90.0,-93.0,50.0,56.0,45.0,42.0,1
269,92:69:1D:31:68:E9,3834817,486768799,3829,3595682,3830988,483173117,0,4489,1068412,4358,1038862,131,29550,2052,10,4001,83,0,41,229410.0,130000.0,-52.0,-50.0,-44.0,-47.0,-52.0,-49.0,-43.0,-47.0,-90.0,-93.0,-90.0,-93.0,38.0,43.0,46.0,46.0,1
270,CC:2F:71:3F:1F:24,4499564,1198769459,668576,715596342,3830988,483173117,37,543313,569910602,542631,569828554,682,82048,525401,15,668824,71744,34,463,130000.0,39000.0,-67.0,-67.0,-71.0,-69.0,-68.0,-67.0,-70.0,-69.0,-90.0,-93.0,-90.0,-93.0,23.0,26.0,19.0,24.0,1
271,CC:2F:71:3E:C5:1F,3831818,483274650,830,101533,3830988,483173117,0,3459,290631,2854,218797,605,71834,878,8,1191,18,0,37,130000.0,39000.0,-69.0,-64.0,-63.0,-58.0,-69.0,-69.0,-65.0,-59.0,-90.0,-93.0,-90.0,-93.0,21.0,29.0,27.0,35.0,1
272,BA:8C:B9:54:50:24,3835786,489351702,4798,6178585,3830988,483173117,0,8712,1680049,8690,1676554,22,3495,2345,14,5209,38,0,56,229410.0,130000.0,-40.0,-37.0,-45.0,-51.0,-42.0,-36.0,-44.0,-49.0,-90.0,-93.0,-90.0,-93.0,50.0,56.0,45.0,42.0,1
273,92:69:1D:31:68:E9,3834819,486769001,3829,3595682,3830990,483173319,0,4489,1068412,4358,1038862,131,29550,2052,10,4001,83,0,41,229410.0,130000.0,-52.0,-50.0,-44.0,-47.0,-52.0,-49.0,-43.0,-47.0,-90.0,-93.0,-90.0,-93.0,38.0,43.0,46.0,46.0,1
274,CC:2F:71:3F:1F:24,4499614,1198784893,668624,715611574,3830990,483173319,37,543349,569916172,542667,569834124,682,82048,525434,15,668872,71760,34,463,144444.0,43333.0,-68.0,-67.0,-73.0,-69.0,-68.0,-67.0,-72.0,-68.0,-90.0,-93.0,-90.0,-93.0,22.0,26.0,17.0,24.0,1
275,CC:2F:71:3E:C5:1F,3831822,483275054,830,101533,3830992,483173521,0,3459,290631,2854,218797,605,71834,878,8,1191,18,0,37,130000.0,39000.0,-69.0,-64.0,-63.0,-58.0,-69.0,-69.0,-65.0,-59.0,-90.0,-93.0,-90.0,-93.0,21.0,29.0,27.0,35.0,1
276,BA:8C:B9:54:50:24,3835790,489352106,4798,6178585,3830992,483173521,0,8712,1680049,8690,1676554,22,3495,2345,14,5209,38,0,56,229410.0,130000.0,-40.0,-37.0,-45.0,-51.0,-42.0,-36.0,-44.0,-49.0,-90.0,-93.0,-90.0,-93.0,50.0,56.0,45.0,42.0,1
277,92:69:1D:31:68:E9,3834825,486769607,3829,3595682,3830996,483173925,0,4489,1068412,4358,1038862,131,29550,2052,10,4001,83,0,41,229410.0,130000.0,-52.0,-50.0,-44.0,-47.0,-52.0,-49.0,-43.0,-47.0,-90.0,-93.0,-90.0,-93.0,38.0,43.0,46.0,46.0,1
278,CC:2F:71:3F:1F:24,4499668,1198803768,668671,715629783,3830997,483173985,37,543387,569922664,542705,569840616,682,82048,525464,15,668919,71773,34,463,144444.0,43333.0,-69.0,-66.0,-70.0,-70.0,-69.0,-65.0,-70.0,-69.0,-90.0,-93.0,-90.0,-93.0,21.0,27.0,20.0,23.0,1
279,CC:2F:71:3E:C5:1F,3831827,483275518,830,101533,3830997,483173985,0,3459,290631,2854,218797,605,71834,878,8,1191,18,0,37,130000.0,39000.0,-69.0,-64.0,-63.0,-58.0,-69.0,-69.0,-65.0,-59.0,-90.0,-93.0,-90.0,-93.0,21.0,29.0,27.0,35.0,1
280,BA:8C:B9:54:50:24,3835795,489352570,4798,6178585,3830997,483173985,0,8712,1680049,8690,1676554,22,3495,2345,14,5209,38,0,56,229410.0,130000.0,-40.0,-37.0,-45.0,-51.0,-42.0,-36.0,-44.0,-49.0,-90.0,-93.0,-90.0,-93.0,50.0,56.0,45.0,42.0,1
281,92:69:1D:31:68:E9,3834828,486769869,3829,3595682,3830999,483174187,0,4489,1068412,4358,1038862,131,29550,2052,10,4001,83,0,41,229410.0,130000.0,-52.0,-50.0,-44.0,-47.0,-52.0,-49.0,-43.0,-47.0,-90.0,-93.0,-90.0,-93.0,38.0,43.0,46.0,46.0,1
282,CC:2F:71:3F:1F:24,4499713,1198818664,668714,715644477,3830999,483174187,37,543415,569927336,542733,569845288,682,82048,525488,15,668962,71787,34,463,144444.0,43333.0,-69.0,-67.0,-71.0,-68.0,-67.0,-67.0,-70.0,-68.0,-90.0,-93.0,-90.0,-93.0,21.0,26.0,19.0,25.0,1
283,CC:2F:71:3E:C5:1F,3831831,483275922,830,101533,3831001,483174389,0,3459,290631,2854,218797,605,71834,878,8,1191,18,0,37,130000.0,39000.0,-69.0,-64.0,-63.0,-58.0,-69.0,-69.0,-65.0,-59.0,-90.0,-93.0,-90.0,-93.0,21.0,29.0,27.0,35.0,1
284,BA:8C:B9:54:50:24,3835799,489352974,4798,6178585,3831001,483174389,0,8712,1680049,8690,1676554,22,3495,2345,14,5209,38,0,56,229410.0,130000.0,-40.0,-37.0,-45.0,-51.0,-42.0,-36.0,-44.0,-49.0,-90.0,-93.0,-90.0,-93.0,50.0,56.0,45.0,42.0,1
285,92:69:1D:31:68:E9,3834834,486770475,3829,3595682,3831005,483174793,0,4489,1068412,4358,1038862,131,29550,2052,10,4001,83,0,41,229410.0,130000.0,-52.0,-50.0,-44.0,-47.0,-52.0,-49.0,-43.0,-47.0,-90.0,-93.0,-90.0,-93.0,38.0,43.0,46.0,46.0,1
286,CC:2F:71:3F:1F:24,4499763,1198834094,668758,715659301,3831005,483174793,37,543442,569931908,542760,569849860,682,82048,525513,15,669006,71807,34,463,144444.0,43333.0,-68.0,-67.0,-71.0,-69.0,-68.0,-67.0,-71.0,-69.0,-90.0,-93.0,-90.0,-93.0,22.0,26.0,19.0,24.0,1
287,CC:2F:71:3E:C5:1F,3831835,483276326,830,101533,3831005,483174793,0,3459,290631,2854,218797,605,71834,878,8,1191,18,0,37,130000.0,39000.0,-69.0,-64.0,-63.0,-58.0,-69.0,-69.0,-65.0,-59.0,-90.0,-93.0,-90.0,-93.0,21.0,29.0,27.0,35.0,1
288,BA:8C:B9:54:50:24,3835803,489353378,4798,6178585,3831005,483174793,0,8712,1680049,8690,1676554,22,3495,2345,14,5209,38,0,56,229410.0,130000.0,-40.0,-37.0,-45.0,-51.0,-42.0,-36.0,-44.0,-49.0,-90.0,-93.0,-90.0,-93.0,50.0,56.0,45.0,42.0,1
289,92:69:1D:31:68:E9,3834837,486770737,3829,3595682,3831008,483175055,0,4489,1068412,4358,1038862,131,29550,2052,10,4001,83,0,41,229410.0,130000.0,-52.0,-50.0,-44.0,-47.0,-52.0,-49.0,-43.0,-47.0,-90.0,-93.0,-90.0,-93.0,38.0,43.0,46.0,46.0,1
290,CC:2F:71:3F:1F:24,4499806,1198848660,668798,715673605,3831008,483175055,37,543464,569935758,542782,569853710,682,82048,525534,15,669046,71825,34,463,144444.0,43333.0,-70.0,-66.0,-70.0,-67.0,-68.0,-65.0,-70.0,-66.0,-90.0,-93.0,-90.0,-93.0,20.0,27.0,20.0,26.0,1
291,CC:2F:71:3E:C5:1F,3831838,483276588,830,101533,3831008,483175055,0,3459,290631,2854,218797,605,71834,878,8,1191,18,0,37,130000.0,39000.0,-69.0,-64.0,-63.0,-58.0,-69.0,-69.0,-65.0,-59.0,-90.0,-93.0,-90.0,-93.0,21.0,29.0,27.0,35.0,1
292,BA:8C:B9:54:50:24,3835806,489353640,4798,6178585,3831008,483175055,0,8712,1680049,8690,1676554,22,3495,2345,14,5209,38,0,56,229410.0,130000.0,-40.0,-37.0,-45.0,-51.0,-42.0,-36.0,-44.0,-49.0,-90.0,-93.0,-90.0,-93.0,50.0,56.0,45.0,42.0,1
293,92:69:1D:31:68:E9,3834843,486771343,3829,3595682,3831014,483175661,0,4489,1068412,4358,1038862,131,29550,2052,10,4001,83,0,41,229410.0,130000.0,-52.0,-50.0,-44.0,-47.0,-52.0,-49.0,-43.0,-47.0,-90.0,-93.0,-89.0,-93.0,38.0,43.0,45.0,46.0,1
294,CC:2F:71:3F:1F:24,4499852,1198863570,668838,715687909,3831014,483175661,37,543492,569940490,542810,569858442,682,82048,525558,15,669086,71826,34,463,144444.0,43333.0,-69.0,-68.0,-71.0,-70.0,-67.0,-68.0,-72.0,-70.0,-90.0,-93.0,-89.0,-93.0,21.0,25.0,18.0,23.0,1
295,CC:2F:71:3E:C5:1F,3831844,483277194,830,101533,3831014,483175661,0,3459,290631,2854,218797,605,71834,878,8,1191,18,0,37,130000.0,39000.0,-69.0,-64.0,-63.0,-58.0,-69.0,-69.0,-65.0,-59.0,-90.0,-93.0,-89.0,-93.0,21.0,29.0,26.0,35.0,1
296,BA:8C:B9:54:50:24,3835812,489354246,4798,6178585,3831014,483175661,0,8712,1680049,8690,1676554,22,3495,2345,14,5209,38,0,56,229410.0,130000.0,-40.0,-37.0,-45.0,-51.0,-42.0,-36.0,-44.0,-49.0,-90.0,-93.0,-89.0,-93.0,50.0,56.0,44.0,42.0,1
297,92:69:1D:31:68:E9,3834845,486771545,3829,3595682,3831016,483175863,0,4489,1068412,4358,1038862,131,29550,2052,10,4001,83,0,41,229410.0,130000.0,-52.0,-50.0,-44.0,-47.0,-52.0,-49.0,-43.0,-47.0,-90.0,-93.0,-89.0,-93.0,38.0,43.0,45.0,46.0,1
298,CC:2F:71:3F:1F:24,4499901,1198881549,668885,715705686,3831016,483175863,37,543522,569945759,542840,569863711,682,82048,525587,15,669133,71833,34,463,144444.0,43333.0,-69.0,-68.0,-71.0,-68.0,-68.0,-67.0,-71.0,-68.0,-90.0,-93.0,-89.0,-93.0,21.0,25.0,18.0,25.0,1
299,CC:2F:71:3E:C5:1F,3831846,483277396,830,101533,3831016,483175863,0,3459,290631,2854,218797,605,71834,878,8,1191,18,0,37,130000.0,39000.0,-69.0,-64.0,-63.0,-58.0,-69.0,-69.0,-65.0,-59.0,-90.0,-93.0,-89.0,-93.0,21.0,29.0,26.0,35.0,1
300,BA:8C:B9:54:50:24,3835814,489354448,4798,6178585,3831016,483175863,0,8712,1680049,8690,1676554,22,3495,2345,14,5209,38,0,56,229410.0,130000.0,-40.0,-37.0,-45.0,-51.0,-42.0,-36.0,-44.0,-49.0,-90.0,-93.0,-89.0,-93.0,50.0,56.0,44.0,42.0,1
301,92:69:1D:31:68:E9,3834852,486772211,3829,3595682,3831023,483176529,0,4489,1068412,4358,1038862,131,29550,2052,10,4001,83,0,41,229410.0,130000.0,-52.0,-50.0,-44.0,-47.0,-52.0,-49.0,-43.0,-47.0,-90.0,-93.0,-89.0,-92.0,38.0,43.0,45.0,45.0,1
302,CC:2F:71:3F:1F:24,4499947,1198896389,668924,715719860,3831023,483176529,37,543543,569949493,542861,569867445,682,82048,525607,15,669172,71847,34,463,144444.0,43333.0,-69.0,-66.0,-72.0,-71.0,-67.0,-67.0,-69.0,-70.0,-90.0,-93.0,-89.0,-92.0,21.0,27.0,17.0,21.0,1
303,CC:2F:71:3E:C5:1F,3831853,483278062,830,101533,3831023,483176529,0,3459,290631,2854,218797,605,71834,878,8,1191,18,0,37,130000.0,39000.0,-69.0,-64.0,-63.0,-58.0,-69.0,-69.0,-65.0,-59.0,-90.0,-93.0,-89.0,-92.0,21.0,29.0,26.0,34.0,1
304,BA:8C:B9:54:50:24,3835821,489355114,4798,6178585,3831023,483176529,0,8712,1680049,8690,1676554,22,3495,2345,14,5209,38,0,56,229410.0,130000.0,-40.0,-37.0,-45.0,-51.0,-42.0,-36.0,-44.0,-49.0,-90.0,-93.0,-89.0,-92.0,50.0,56.0,44.0,41.0,1
305,92:69:1D:31:68:E9,3834854,486772413,3829,3595682,3831025,483176731,0,4489,1068412,4358,1038862,131,29550,2052,10,4001,83,0,41,229410.0,130000.0,-52.0,-50.0,-44.0,-47.0,-52.0,-49.0,-43.0,-47.0,-90.0,-93.0,-89.0,-92.0,38.0,43.0,45.0,45.0,1
306,CC:2F:71:3F:1F:24,4499989,1198910895,668964,715734164,3831025,483176731,37,543564,569953227,542882,569871179,682,82048,525627,15,669212,71890,34,463,144444.0,43333.0,-71.0,-67.0,-70.0,-69.0,-70.0,-66.0,-70.0,-70.0,-90.0,-93.0,-89.0,-92.0,19.0,26.0,19.0,23.0,1
307,CC:2F:71:3E:C5:1F,3831855,483278264,830,101533,3831025,483176731,0,3459,290631,2854,218797,605,71834,878,8,1191,18,0,37,130000.0,39000.0,-69.0,-64.0,-63.0,-58.0,-69.0,-69.0,-65.0,-59.0,-90.0,-93.0,-89.0,-92.0,21.0,29.0,26.0,34.0,1
308,BA:8C:B9:54:50:24,3835823,489355316,4798,6178585,3831025,483176731,0,8712,1680049,8690,1676554,22,3495,2345,14,5209,38,0,56,229410.0,130000.0,-40.0,-37.0,-45.0,-51.0,-42.0,-36.0,-44.0,-49.0,-90.0,-93.0,-89.0,-92.0,50.0,56.0,44.0,41.0,1
309,92:69:1D:31:68:E9,3834860,486773019,3829,3595682,3831031,483177337,0,4489,1068412,4358,1038862,131,29550,2052,10,4001,83,0,41,229410.0,130000.0,-52.0,-50.0,-44.0,-47.0,-52.0,-49.0,-43.0,-47.0,-90.0,-93.0,-89.0,-92.0,38.0,43.0,45.0,45.0,1
310,CC:2F:71:3F:1F:24,4500035,1198925805,669004,715748468,3831031,483177337,37,543586,569957139,542904,569875091,682,82048,525647,15,669252,71900,34,463,144444.0,43333.0,-69.0,-66.0,-70.0,-69.0,-69.0,-66.0,-70.0,-68.0,-90.0,-93.0,-89.0,-92.0,21.0,27.0,19.0,23.0,1
311,CC:2F:71:3E:C5:1F,3831861,483278870,830,101533,3831031,483177337,0,3459,290631,2854,218797,605,71834,878,8,1191,18,0,37,130000.0,39000.0,-69.0,-64.0,-63.0,-58.0,-69.0,-69.0,-65.0,-59.0,-90.0,-93.0,-89.0,-92.0,21.0,29.0,26.0,34.0,1
312,BA:8C:B9:54:50:24,3835830,489355982,4798,6178585,3831032,483177397,0,8712,1680049,8690,1676554,22,3495,2345,14,5209,38,0,56,229410.0,130000.0,-40.0,-37.0,-45.0,-51.0,-42.0,-36.0,-44.0,-49.0,-90.0,-93.0,-89.0,-92.0,50.0,56.0,44.0,41.0,1
313,92:69:1D:31:68:E9,3834863,486773281,3829,3595682,3831034,483177599,0,4489,1068412,4358,1038862,131,29550,2052,10,4001,83,0,41,229410.0,130000.0,-52.0,-50.0,-44.0,-47.0,-52.0,-49.0,-43.0,-47.0,-90.0,-93.0,-89.0,-92.0,38.0,43.0,45.0,45.0,1
314,CC:2F:71:3F:1F:24,4500278,1199166239,669244,715988640,3831034,483177599,37,543721,569980233,543039,569898185,682,82048,525772,15,669492,72039,34,463,130000.0,43333.0,-71.0,-65.0,-68.0,-69.0,-71.0,-65.0,-68.0,-68.0,-90.0,-93.0,-89.0,-92.0,19.0,28.0,21.0,23.0,1
315,CC:2F:71:3E:C5:1F,3831865,483279248,831,101649,3831034,483177599,0,3461,290771,2856,218937,605,71834,878,8,1192,18,0,37,130000.0,39000.0,-71.0,-72.0,-66.0,-60.0,-69.0,-69.0,-65.0,-59.0,-90.0,-93.0,-89.0,-92.0,19.0,21.0,23.0,32.0,1
316,BA:8C:B9:54:50:24,3835833,489356300,4799,6178701,3831034,483177599,0,8714,1680185,8692,1676690,22,3495,2345,14,5210,38,0,56,229410.0,130000.0,-48.0,-35.0,-43.0,-45.0,-41.0,-36.0,-44.0,-49.0,-90.0,-93.0,-89.0,-92.0,42.0,58.0,46.0,47.0,1
317,92:69:1D:31:68:E9,3834870,486774003,3830,3595798,3831040,483178205,0,4491,1068548,4360,1038998,131,29550,2052,10,4002,83,0,41,229410.0,137640.0,-51.0,-48.0,-44.0,-46.0,-51.0,-49.0,-43.0,-47.0,-90.0,-93.0,-89.0,-92.0,39.0,45.0,45.0,46.0,1
318,CC:2F:71:3F:1F:24,4500686,1199665814,669646,716487609,3831040,483178205,37,543905,570008418,543223,569926370,682,82048,525943,15,669894,72070,34,464,130000.0,43333.0,-70.0,-66.0,-68.0,-68.0,-70.0,-66.0,-68.0,-68.0,-90.0,-93.0,-89.0,-92.0,20.0,27.0,21.0,24.0,1
319,CC:2F:71:3E:C5:1F,3831871,483279854,831,101649,3831040,483178205,0,3461,290771,2856,218937,605,71834,878,8,1192,18,0,37,130000.0,39000.0,-71.0,-72.0,-66.0,-60.0,-69.0,-69.0,-65.0,-59.0,-90.0,-93.0,-89.0,-92.0,19.0,21.0,23.0,32.0,1
320,BA:8C:B9:54:50:24,3835839,489356906,4799,6178701,3831040,483178205,0,8714,1680185,8692,1676690,22,3495,2345,14,5210,38,0,56,229410.0,130000.0,-48.0,-35.0,-43.0,-45.0,-41.0,-36.0,-44.0,-49.0,-90.0,-93.0,-89.0,-92.0,42.0,58.0,46.0,47.0,1
321,92:69:1D:31:68:E9,3834874,486774538,3830,3595798,3831044,483178740,0,4491,1068548,4360,1038998,131,29550,2052,10,4002,83,0,41,229410.0,137640.0,-51.0,-48.0,-44.0,-46.0,-51.0,-49.0,-43.0,-47.0,-90.0,-93.0,-89.0,-92.0,39.0,45.0,45.0,46.0,1
322,CC:2F:71:3F:1F:24,4501011,1199978824,669967,716800084,3831044,483178740,37,544090,570038191,543408,569956143,682,82048,526125,15,670215,72094,34,464,130000.0,43333.0,-72.0,-65.0,-69.0,-71.0,-72.0,-65.0,-69.0,-70.0,-90.0,-93.0,-89.0,-92.0,18.0,28.0,20.0,21.0,1
323,CC:2F:71:3E:C5:1F,3831875,483280389,831,101649,3831044,483178740,0,3461,290771,2856,218937,605,71834,878,8,1192,18,0,37,130000.0,39000.0,-71.0,-72.0,-66.0,-60.0,-69.0,-69.0,-65.0,-59.0,-90.0,-93.0,-89.0,-92.0,19.0,21.0,23.0,32.0,1
324,BA:8C:B9:54:50:24,3835843,489357441,4799,6178701,3831044,483178740,0,8714,1680185,8692,1676690,22,3495,2345,14,5210,38,0,56,229410.0,130000.0,-48.0,-35.0,-43.0,-45.0,-41.0,-36.0,-44.0,-49.0,-90.0,-93.0,-89.0,-92.0,42.0,58.0,46.0,47.0,1
325,92:69:1D:31:68:E9,3834880,486775144,3830,3595798,3831050,483179346,0,4491,1068548,4360,1038998,131,29550,2052,10,4002,83,0,41,229410.0,137640.0,-51.0,-48.0,-44.0,-46.0,-51.0,-49.0,-43.0,-47.0,-90.0,-93.0,-89.0,-92.0,39.0,45.0,45.0,46.0,1
326,CC:2F:71:3F:1F:24,4501059,1199993938,670009,716814592,3831050,483179346,37,544116,570042505,543434,569960457,682,82048,526150,15,670257,72120,34,464,130000.0,39000.0,-71.0,-66.0,-69.0,-72.0,-70.0,-66.0,-68.0,-72.0,-90.0,-93.0,-89.0,-92.0,19.0,27.0,20.0,20.0,1
327,CC:2F:71:3E:C5:1F,3831881,483280995,831,101649,3831050,483179346,0,3461,290771,2856,218937,605,71834,878,8,1192,18,0,37,130000.0,39000.0,-71.0,-72.0,-66.0,-60.0,-69.0,-69.0,-65.0,-59.0,-90.0,-93.0,-89.0,-92.0,19.0,21.0,23.0,32.0,1
328,BA:8C:B9:54:50:24,3835849,489358047,4799,6178701,3831050,483179346,0,8714,1680185,8692,1676690,22,3495,2345,14,5210,38,0,56,229410.0,130000.0,-48.0,-35.0,-43.0,-45.0,-41.0,-36.0,-44.0,-49.0,-90.0,-93.0,-89.0,-92.0,42.0,58.0,46.0,47.0,1
329,92:69:1D:31:68:E9,3834882,486775346,3830,3595798,3831052,483179548,0,4491,1068548,4360,1038998,131,29550,2052,10,4002,83,0,41,229410.0,137640.0,-51.0,-48.0,-44.0,-46.0,-51.0,-49.0,-43.0,-47.0,-90.0,-93.0,-89.0,-92.0,39.0,45.0,45.0,46.0,1
330,CC:2F:71:3F:1F:24,4501107,1200009112,670055,716829564,3831052,483179548,37,544149,570047727,543467,569965679,682,82048,526180,15,670303,72137,34,464,144444.0,43333.0,-71.0,-66.0,-69.0,-72.0,-70.0,-66.0,-69.0,-72.0,-90.0,-93.0,-89.0,-92.0,19.0,27.0,20.0,20.0,1
331,CC:2F:71:3E:C5:1F,3831883,483281197,831,101649,3831052,483179548,0,3461,290771,2856,218937,605,71834,878,8,1192,18,0,37,130000.0,39000.0,-71.0,-72.0,-66.0,-60.0,-69.0,-69.0,-65.0,-59.0,-90.0,-93.0,-89.0,-92.0,19.0,21.0,23.0,32.0,1
332,BA:8C:B9:54:50:24,3835851,489358249,4799,6178701,3831052,483179548,0,8714,1680185,8692,1676690,22,3495,2345,14,5210,38,0,56,229410.0,130000.0,-48.0,-35.0,-43.0,-45.0,-41.0,-36.0,-44.0,-49.0,-90.0,-93.0,-89.0,-92.0,42.0,58.0,46.0,47.0,1
333,92:69:1D:31:68:E9,3834889,486776012,3830,3595798,3831059,483180214,0,4491,1068548,4360,1038998,131,29550,2052,10,4002,83,0,41,229410.0,137640.0,-51.0,-48.0,-44.0,-46.0,-51.0,-49.0,-43.0,-47.0,-90.0,-93.0,-89.0,-92.0,39.0,45.0,45.0,46.0,1
334,CC:2F:71:3F:1F:24,4501156,1200024342,670097,716844128,3831059,483180214,37,544176,570052171,543494,569970123,682,82048,526205,15,670345,72154,34,464,144444.0,43333.0,-71.0,-67.0,-69.0,-72.0,-70.0,-66.0,-69.0,-71.0,-90.0,-93.0,-89.0,-92.0,19.0,26.0,20.0,20.0,1
335,CC:2F:71:3E:C5:1F,3831890,483281863,831,101649,3831059,483180214,0,3461,290771,2856,218937,605,71834,878,8,1192,18,0,37,130000.0,39000.0,-71.0,-72.0,-66.0,-60.0,-69.0,-69.0,-65.0,-59.0,-90.0,-93.0,-89.0,-92.0,19.0,21.0,23.0,32.0,1
336,BA:8C:B9:54:50:24,3835858,489358915,4799,6178701,3831059,483180214,0,8714,1680185,8692,1676690,22,3495,2345,14,5210,38,0,56,229410.0,130000.0,-48.0,-35.0,-43.0,-45.0,-41.0,-36.0,-44.0,-49.0,-90.0,-93.0,-89.0,-92.0,42.0,58.0,46.0,47.0,1
337,92:69:1D:31:68:E9,3834891,486776214,3830,3595798,3831061,483180416,0,4491,1068548,4360,1038998,131,29550,2052,10,4002,83,0,41,229410.0,137640.0,-51.0,-48.0,-44.0,-46.0,-51.0,-49.0,-43.0,-47.0,-90.0,-93.0,-89.0,-92.0,39.0,45.0,45.0,46.0,1
338,CC:2F:71:3F:1F:24,4501210,1200042971,670149,716862555,3831061,483180416,37,544212,570058167,543530,569976119,682,82048,526237,15,670397,72173,34,464,144444.0,43333.0,-71.0,-66.0,-69.0,-72.0,-70.0,-66.0,-69.0,-71.0,-90.0,-93.0,-89.0,-92.0,19.0,27.0,20.0,20.0,1
339,CC:2F:71:3E:C5:1F,3831892,483282065,831,101649,3831061,483180416,0,3461,290771,2856,218937,605,71834,878,8,1192,18,0,37,130000.0,39000.0,-71.0,-72.0,-66.0,-60.0,-69.0,-69.0,-65.0,-59.0,-90.0,-93.0,-89.0,-92.0,19.0,21.0,23.0,32.0,1
340,BA:8C:B9:54:50:24,3835860,489359117,4799,6178701,3831061,483180416,0,8714,1680185,8692,1676690,22,3495,2345,14,5210,38,0,56,229410.0,130000.0,-48.0,-35.0,-43.0,-45.0,-41.0,-36.0,-44.0,-49.0,-90.0,-93.0,-89.0,-92.0,42.0,58.0,46.0,47.0,1
341,92:69:1D:31:68:E9,3834896,486776680,3830,3595798,3831066,483180882,0,4491,1068548,4360,1038998,131,29550,2052,10,4002,83,0,41,229410.0,137640.0,-51.0,-48.0,-44.0,-46.0,-51.0,-49.0,-43.0,-47.0,-90.0,-93.0,-89.0,-92.0,39.0,45.0,45.0,46.0,1
342,CC:2F:71:3F:1F:24,4501257,1200057943,670189,716876859,3831068,483181084,37,544237,570062385,543553,569980101,684,82284,526258,15,670437,72184,34,465,144444.0,43333.0,-71.0,-67.0,-69.0,-72.0,-71.0,-66.0,-69.0,-71.0,-90.0,-93.0,-89.0,-92.0,19.0,26.0,20.0,20.0,1
343,CC:2F:71:3E:C5:1F,3831900,483282793,831,101649,3831069,483181144,0,3461,290771,2856,218937,605,71834,878,8,1192,18,0,37,130000.0,39000.0,-71.0,-72.0,-66.0,-60.0,-69.0,-69.0,-65.0,-59.0,-90.0,-93.0,-89.0,-92.0,19.0,21.0,23.0,32.0,1
344,BA:8C:B9:54:50:24,3835868,489359845,4799,6178701,3831069,483181144,0,8714,1680185,8692,1676690,22,3495,2345,14,5210,38,0,56,229410.0,130000.0,-48.0,-35.0,-43.0,-45.0,-41.0,-36.0,-44.0,-49.0,-90.0,-93.0,-89.0,-92.0,42.0,58.0,46.0,47.0,1
345,92:69:1D:31:68:E9,3834899,486776942,3830,3595798,3831069,483181144,0,4493,1068684,4362,1039134,131,29550,2052,10,4003,83,0,41,229410.0,137640.0,-52.0,-49.0,-44.0,-46.0,-51.0,-49.0,-43.0,-47.0,-90.0,-93.0,-89.0,-92.0,38.0,44.0,45.0,46.0,1
346,CC:2F:71:3F:1F:24,4501300,1200072509,670229,716891163,3831071,483181346,37,544258,570066119,543574,569983835,684,82284,526278,15,670477,72193,34,465,144444.0,43333.0,-71.0,-66.0,-69.0,-72.0,-71.0,-66.0,-69.0,-71.0,-90.0,-93.0,-89.0,-92.0,19.0,27.0,20.0,20.0,1
347,CC:2F:71:3E:C5:1F,3831902,483282995,831,101649,3831071,483181346,0,3463,290911,2858,219077,605,71834,878,8,1193,18,0,37,130000.0,39000.0,-70.0,-70.0,-67.0,-60.0,-69.0,-68.0,-65.0,-59.0,-90.0,-93.0,-89.0,-92.0,20.0,23.0,22.0,32.0,1
348,BA:8C:B9:54:50:24,3835870,489360047,4799,6178701,3831071,483181346,0,8717,1680389,8695,1676894,22,3495,2345,14,5211,38,0,56,229410.0,130000.0,-40.0,-36.0,-45.0,-51.0,-41.0,-36.0,-44.0,-49.0,-90.0,-93.0,-89.0,-92.0,50.0,57.0,44.0,41.0,1
349,92:69:1D:31:68:E9,3834907,486777750,3830,3595798,3831077,483181952,0,4493,1068684,4362,1039134,131,29550,2052,10,4003,83,0,41,229410.0,137640.0,-52.0,-49.0,-44.0,-46.0,-51.0,-49.0,-43.0,-47.0,-90.0,-93.0,-89.0,-92.0,38.0,44.0,45.0,46.0,1
350,CC:2F:71:3F:1F:24,4501347,1200087677,670270,716905725,3831077,483181952,37,544281,570070097,543597,569987813,684,82284,526300,15,670518,72197,34,465,144444.0,43333.0,-71.0,-66.0,-69.0,-72.0,-71.0,-66.0,-69.0,-71.0,-90.0,-93.0,-89.0,-92.0,19.0,27.0,20.0,20.0,1
351,CC:2F:71:3E:C5:1F,3831908,483283601,831,101649,3831077,483181952,0,3463,290911,2858,219077,605,71834,878,8,1193,18,0,37,130000.0,39000.0,-70.0,-70.0,-67.0,-60.0,-69.0,-68.0,-65.0,-59.0,-90.0,-93.0,-89.0,-92.0,20.0,23.0,22.0,32.0,1
352,BA:8C:B9:54:50:24,3835876,489360653,4799,6178701,3831077,483181952,0,8717,1680389,8695,1676894,22,3495,2345,14,5211,38,0,56,229410.0,130000.0,-40.0,-36.0,-45.0,-51.0,-41.0,-36.0,-44.0,-49.0,-90.0,-93.0,-89.0,-92.0,50.0,57.0,44.0,41.0,1
353,92:69:1D:31:68:E9,3834910,486778012,3830,3595798,3831080,483182214,0,4494,1068752,4363,1039202,131,29550,2052,10,4003,83,0,41,229410.0,137640.0,-52.0,-49.0,-43.0,-46.0,-51.0,-48.0,-43.0,-47.0,-90.0,-93.0,-89.0,-92.0,38.0,44.0,46.0,46.0,1
354,CC:2F:71:3F:1F:24,4501399,1200106038,670319,716923824,3831080,483182214,37,544313,570075693,543629,569993409,684,82284,526329,15,670567,72229,34,465,144444.0,43333.0,-72.0,-66.0,-69.0,-72.0,-72.0,-66.0,-68.0,-72.0,-90.0,-93.0,-89.0,-92.0,18.0,27.0,20.0,20.0,1
355,CC:2F:71:3E:C5:1F,3831911,483283863,831,101649,3831080,483182214,0,3463,290911,2858,219077,605,71834,878,8,1193,18,0,37,130000.0,39000.0,-70.0,-70.0,-67.0,-60.0,-69.0,-68.0,-65.0,-59.0,-90.0,-93.0,-89.0,-92.0,20.0,23.0,22.0,32.0,1
356,BA:8C:B9:54:50:24,3835879,489360915,4799,6178701,3831080,483182214,0,8717,1680389,8695,1676894,22,3495,2345,14,5211,38,0,56,229410.0,130000.0,-40.0,-36.0,-45.0,-51.0,-41.0,-36.0,-44.0,-49.0,-90.0,-93.0,-89.0,-92.0,50.0,57.0,44.0,41.0,1
357,92:69:1D:31:68:E9,3834916,486778618,3830,3595798,3831086,483182820,0,4494,1068752,4363,1039202,131,29550,2052,10,4003,83,0,41,229410.0,137640.0,-52.0,-49.0,-43.0,-46.0,-51.0,-48.0,-43.0,-47.0,-90.0,-93.0,-89.0,-92.0,38.0,44.0,46.0,46.0,1
358,CC:2F:71:3F:1F:24,4501665,1200377312,670579,717194492,3831086,483182820,37,544445,570097693,543761,570015409,684,82284,526458,15,670827,72317,34,465,130000.0,43333.0,-72.0,-66.0,-69.0,-72.0,-71.0,-66.0,-68.0,-72.0,-90.0,-93.0,-89.0,-92.0,18.0,27.0,20.0,20.0,1
359,CC:2F:71:3E:C5:1F,3831917,483284469,831,101649,3831086,483182820,0,3463,290911,2858,219077,605,71834,878,8,1193,18,0,37,130000.0,39000.0,-70.0,-70.0,-67.0,-60.0,-69.0,-68.0,-65.0,-59.0,-90.0,-93.0,-89.0,-92.0,20.0,23.0,22.0,32.0,1
360,BA:8C:B9:54:50:24,3835886,489361583,4799,6178701,3831087,483182882,0,8717,1680389,8695,1676894,22,3495,2345,14,5211,38,0,56,229410.0,130000.0,-40.0,-36.0,-45.0,-51.0,-41.0,-36.0,-44.0,-49.0,-90.0,-93.0,-89.0,-92.0,50.0,57.0,44.0,41.0,1
361,92:69:1D:31:68:E9,3834919,486778882,3830,3595798,3831089,483183084,0,4494,1068752,4363,1039202,131,29550,2052,10,4003,83,0,41,229410.0,137640.0,-52.0,-49.0,-43.0,-46.0,-51.0,-48.0,-43.0,-47.0,-90.0,-93.0,-89.0,-92.0,38.0,44.0,46.0,46.0,1
362,CC:2F:71:3F:1F:24,4502065,1200860193,670976,717677109,3831089,483183084,37,544640,570127361,543956,570045077,684,82284,526648,15,671224,72455,34,465,115556.0,28889.0,-72.0,-65.0,-69.0,-71.0,-72.0,-65.0,-69.0,-71.0,-90.0,-93.0,-89.0,-92.0,18.0,28.0,20.0,21.0,1
363,CC:2F:71:3E:C5:1F,3831920,483284733,831,101649,3831089,483183084,0,3465,291099,2859,219147,606,71952,879,8,1193,18,0,37,130000.0,39000.0,-69.0,-69.0,-67.0,-60.0,-69.0,-68.0,-65.0,-59.0,-90.0,-93.0,-89.0,-92.0,21.0,24.0,22.0,32.0,1
364,BA:8C:B9:54:50:24,3835888,489361785,4799,6178701,3831089,483183084,0,8717,1680389,8695,1676894,22,3495,2345,14,5211,38,0,56,229410.0,130000.0,-40.0,-36.0,-45.0,-51.0,-41.0,-36.0,-44.0,-49.0,-90.0,-93.0,-89.0,-92.0,50.0,57.0,44.0,41.0,1
365,92:69:1D:31:68:E9,3834924,486779346,3830,3595798,3831094,483183548,0,4494,1068752,4363,1039202,131,29550,2052,10,4003,83,0,41,229410.0,137640.0,-52.0,-49.0,-43.0,-46.0,-51.0,-48.0,-43.0,-47.0,-90.0,-92.0,-89.0,-92.0,38.0,43.0,46.0,46.0,1
366,CC:2F:71:3F:1F:24,4502698,1201589247,671602,718405497,3831096,483183750,37,544943,570174619,544259,570092335,684,82284,526944,15,671850,72476,34,466,117000.0,39000.0,-77.0,-68.0,-73.0,-75.0,-76.0,-68.0,-72.0,-74.0,-90.0,-92.0,-89.0,-92.0,13.0,24.0,16.0,17.0,1
367,CC:2F:71:3E:C5:1F,3831939,483290998,831,101649,3831108,483189349,0,3465,291099,2859,219147,606,71952,879,8,1193,18,0,37,130000.0,39000.0,-69.0,-69.0,-67.0,-60.0,-69.0,-68.0,-65.0,-59.0,-90.0,-92.0,-89.0,-92.0,21.0,23.0,22.0,32.0,1
368,BA:8C:B9:54:50:24,3835907,489368050,4799,6178701,3831108,483189349,0,8717,1680389,8695,1676894,22,3495,2345,14,5211,38,0,56,229410.0,130000.0,-40.0,-36.0,-45.0,-51.0,-41.0,-36.0,-44.0,-49.0,-90.0,-92.0,-89.0,-92.0,50.0,56.0,44.0,41.0,1
369,92:69:1D:31:68:E9,3834949,486790571,3830,3595798,3831119,483194773,0,4497,1069123,4365,1039338,132,29785,2053,10,4003,83,0,41,229410.0,137640.0,-51.0,-47.0,-42.0,-48.0,-51.0,-48.0,-43.0,-47.0,-90.0,-92.0,-89.0,-92.0,39.0,45.0,47.0,44.0,1
370,CC:2F:71:3F:1F:24,4503268,1202162259,672149,718967486,3831119,483194773,37,545275,570255367,544591,570173083,684,82284,527267,15,672397,72542,34,467,130000.0,43333.0,-73.0,-66.0,-69.0,-73.0,-73.0,-65.0,-69.0,-72.0,-90.0,-92.0,-89.0,-92.0,17.0,26.0,20.0,19.0,1
371,CC:2F:71:3E:C5:1F,3831952,483296624,831,101649,3831121,483194975,0,3465,291099,2859,219147,606,71952,879,8,1193,18,0,37,130000.0,39000.0,-69.0,-69.0,-67.0,-60.0,-69.0,-68.0,-65.0,-59.0,-90.0,-92.0,-89.0,-92.0,21.0,23.0,22.0,32.0,1
372,BA:8C:B9:54:50:24,3835920,489373676,4799,6178701,3831121,483194975,0,8717,1680389,8695,1676894,22,3495,2345,14,5211,38,0,56,229410.0,130000.0,-40.0,-36.0,-45.0,-51.0,-41.0,-36.0,-44.0,-49.0,-90.0,-92.0,-89.0,-92.0,50.0,56.0,44.0,41.0,1
373,92:69:1D:31:68:E9,3834957,486791510,3830,3595798,3831127,483195712,0,4497,1069123,4365,1039338,132,29785,2053,10,4003,83,0,41,229410.0,137640.0,-51.0,-47.0,-42.0,-48.0,-51.0,-48.0,-43.0,-47.0,-90.0,-92.0,-89.0,-92.0,39.0,45.0,47.0,44.0,1
374,CC:2F:71:3F:1F:24,4503332,1202180468,672203,718984554,3831129,483195914,37,545317,570262658,544633,570180374,684,82284,527305,15,672451,72568,34,467,117000.0,39000.0,-73.0,-66.0,-69.0,-72.0,-73.0,-66.0,-69.0,-72.0,-90.0,-92.0,-89.0,-92.0,17.0,26.0,20.0,20.0,1
375,CC:2F:71:3E:C5:1F,3831960,483297563,831,101649,3831129,483195914,0,3465,291099,2859,219147,606,71952,879,8,1193,18,0,37,130000.0,39000.0,-69.0,-69.0,-67.0,-60.0,-69.0,-68.0,-65.0,-59.0,-90.0,-92.0,-89.0,-92.0,21.0,23.0,22.0,32.0,1
376,BA:8C:B9:54:50:24,3835928,489374615,4799,6178701,3831129,483195914,0,8717,1680389,8695,1676894,22,3495,2345,14,5211,38,0,56,229410.0,130000.0,-40.0,-36.0,-45.0,-51.0,-41.0,-36.0,-44.0,-49.0,-90.0,-92.0,-89.0,-92.0,50.0,56.0,44.0,41.0,1
377,92:69:1D:31:68:E9,3834959,486791712,3830,3595798,3831129,483195914,0,4497,1069123,4365,1039338,132,29785,2053,10,4003,83,0,41,229410.0,137640.0,-51.0,-47.0,-42.0,-48.0,-51.0,-48.0,-43.0,-47.0,-90.0,-92.0,-89.0,-91.0,39.0,45.0,47.0,43.0,1
378,CC:2F:71:3F:1F:24,4503370,1202194400,672241,718998486,3831129,483195914,37,545341,570266802,544657,570184518,684,82284,527327,15,672489,72576,34,467,130000.0,43333.0,-73.0,-66.0,-69.0,-73.0,-73.0,-66.0,-69.0,-72.0,-90.0,-92.0,-89.0,-91.0,17.0,26.0,20.0,18.0,1
379,CC:2F:71:3E:C5:1F,3831962,483297765,831,101649,3831131,483196116,0,3465,291099,2859,219147,606,71952,879,8,1193,18,0,37,130000.0,39000.0,-69.0,-69.0,-67.0,-60.0,-69.0,-68.0,-65.0,-59.0,-90.0,-92.0,-89.0,-91.0,21.0,23.0,22.0,31.0,1
380,BA:8C:B9:54:50:24,3835930,489374817,4799,6178701,3831131,483196116,0,8717,1680389,8695,1676894,22,3495,2345,14,5211,38,0,56,229410.0,130000.0,-40.0,-36.0,-45.0,-51.0,-41.0,-36.0,-44.0,-49.0,-90.0,-92.0,-89.0,-91.0,50.0,56.0,44.0,40.0,1
381,92:69:1D:31:68:E9,3834965,486792318,3830,3595798,3831135,483196520,0,4497,1069123,4365,1039338,132,29785,2053,10,4003,83,0,41,229410.0,137640.0,-51.0,-47.0,-42.0,-48.0,-51.0,-48.0,-43.0,-47.0,-90.0,-92.0,-89.0,-91.0,39.0,45.0,47.0,43.0,1
382,CC:2F:71:3F:1F:24,4503424,1202210277,672289,719013757,3831135,483196520,37,545383,570273049,544699,570190765,684,82284,527361,15,672537,72600,34,467,117000.0,39000.0,-74.0,-66.0,-69.0,-72.0,-73.0,-66.0,-69.0,-72.0,-90.0,-92.0,-89.0,-91.0,16.0,26.0,20.0,19.0,1
383,CC:2F:71:3E:C5:1F,3831968,483298371,831,101649,3831137,483196722,0,3465,291099,2859,219147,606,71952,879,8,1193,18,0,37,130000.0,39000.0,-69.0,-69.0,-67.0,-60.0,-69.0,-68.0,-65.0,-59.0,-90.0,-92.0,-89.0,-91.0,21.0,23.0,22.0,31.0,1
384,BA:8C:B9:54:50:24,3835936,489375423,4799,6178701,3831137,483196722,0,8717,1680389,8695,1676894,22,3495,2345,14,5211,38,0,56,229410.0,130000.0,-40.0,-36.0,-45.0,-51.0,-41.0,-36.0,-44.0,-49.0,-90.0,-92.0,-89.0,-91.0,50.0,56.0,44.0,40.0,1
385,92:69:1D:31:68:E9,3834970,486792948,3830,3595798,3831140,483197150,0,4497,1069123,4365,1039338,132,29785,2053,10,4003,83,0,41,229410.0,137640.0,-51.0,-47.0,-42.0,-48.0,-51.0,-48.0,-43.0,-47.0,-90.0,-92.0,-89.0,-91.0,39.0,45.0,47.0,43.0,1
386,CC:2F:71:3F:1F:24,4503477,1202228764,672337,719031614,3831140,483197150,37,545415,570278597,544731,570196313,684,82284,527392,15,672585,72613,34,467,130000.0,43333.0,-73.0,-66.0,-69.0,-72.0,-72.0,-65.0,-69.0,-72.0,-90.0,-92.0,-89.0,-91.0,17.0,26.0,20.0,19.0,1
387,CC:2F:71:3E:C5:1F,3831973,483299001,831,101649,3831142,483197352,0,3465,291099,2859,219147,606,71952,879,8,1193,18,0,37,130000.0,39000.0,-69.0,-69.0,-67.0,-60.0,-69.0,-68.0,-65.0,-59.0,-90.0,-92.0,-89.0,-91.0,21.0,23.0,22.0,31.0,1
388,BA:8C:B9:54:50:24,3835941,489376053,4799,6178701,3831142,483197352,0,8717,1680389,8695,1676894,22,3495,2345,14,5211,38,0,56,229410.0,130000.0,-40.0,-36.0,-45.0,-51.0,-41.0,-36.0,-44.0,-49.0,-90.0,-92.0,-89.0,-91.0,50.0,56.0,44.0,40.0,1
389,92:69:1D:31:68:E9,3834976,486793554,3830,3595798,3831146,483197756,0,4497,1069123,4365,1039338,132,29785,2053,10,4003,83,0,41,229410.0,137640.0,-51.0,-47.0,-42.0,-48.0,-51.0,-48.0,-43.0,-47.0,-90.0,-92.0,-89.0,-91.0,39.0,45.0,47.0,43.0,1
390,CC:2F:71:3F:1F:24,4503526,1202244008,672380,719046252,3831146,483197756,37,545444,570283213,544760,570200929,684,82284,527419,15,672628,72630,34,467,130000.0,39000.0,-74.0,-66.0,-70.0,-71.0,-73.0,-66.0,-69.0,-72.0,-90.0,-92.0,-89.0,-91.0,16.0,26.0,19.0,20.0,1
391,CC:2F:71:3E:C5:1F,3831977,483299405,831,101649,3831146,483197756,0,3465,291099,2859,219147,606,71952,879,8,1193,18,0,37,130000.0,39000.0,-69.0,-69.0,-67.0,-60.0,-69.0,-68.0,-65.0,-59.0,-90.0,-92.0,-89.0,-91.0,21.0,23.0,22.0,31.0,1
392,BA:8C:B9:54:50:24,3835947,489376659,4799,6178701,3831148,483197958,0,8717,1680389,8695,1676894,22,3495,2345,14,5211,38,0,56,229410.0,130000.0,-40.0,-36.0,-45.0,-51.0,-41.0,-36.0,-44.0,-49.0,-90.0,-92.0,-89.0,-91.0,50.0,56.0,44.0,40.0,1
393,92:69:1D:31:68:E9,3834978,486793756,3830,3595798,3831148,483197958,0,4497,1069123,4365,1039338,132,29785,2053,10,4003,83,0,41,229410.0,137640.0,-51.0,-47.0,-42.0,-48.0,-51.0,-48.0,-43.0,-47.0,-90.0,-92.0,-89.0,-91.0,39.0,45.0,47.0,43.0,1
394,CC:2F:71:3F:1F:24,4503570,1202258662,672422,719060704,3831148,483197958,37,545471,570287657,544787,570205373,684,82284,527444,15,672670,72645,34,467,130000.0,39000.0,-72.0,-64.0,-68.0,-72.0,-72.0,-64.0,-68.0,-72.0,-90.0,-92.0,-89.0,-91.0,18.0,28.0,21.0,19.0,1
395,CC:2F:71:3E:C5:1F,3831979,483299607,831,101649,3831148,483197958,0,3465,291099,2859,219147,606,71952,879,8,1193,18,0,37,130000.0,39000.0,-69.0,-69.0,-67.0,-60.0,-69.0,-68.0,-65.0,-59.0,-90.0,-92.0,-89.0,-91.0,21.0,23.0,22.0,31.0,1
396,BA:8C:B9:54:50:24,3835949,489376861,4799,6178701,3831150,483198160,0,8717,1680389,8695,1676894,22,3495,2345,14,5211,38,0,56,229410.0,130000.0,-40.0,-36.0,-45.0,-51.0,-41.0,-36.0,-44.0,-49.0,-90.0,-92.0,-89.0,-91.0,50.0,56.0,44.0,40.0,1
397,92:69:1D:31:68:E9,3834985,486794422,3830,3595798,3831155,483198624,0,4497,1069123,4365,1039338,132,29785,2053,10,4003,83,0,41,229410.0,137640.0,-51.0,-47.0,-42.0,-48.0,-51.0,-48.0,-43.0,-47.0,-90.0,-92.0,-89.0,-91.0,39.0,45.0,47.0,43.0,1
398,CC:2F:71:3F:1F:24,4503615,1202273260,672460,719074636,3831155,483198624,37,545493,570291507,544809,570209223,684,82284,527465,15,672708,72657,34,467,130000.0,39000.0,-70.0,-65.0,-67.0,-68.0,-70.0,-65.0,-67.0,-69.0,-90.0,-92.0,-89.0,-91.0,20.0,27.0,22.0,23.0,1
399,CC:2F:71:3E:C5:1F,3831986,483300273,831,101649,3831155,483198624,0,3465,291099,2859,219147,606,71952,879,8,1193,18,0,37,130000.0,39000.0,-69.0,-69.0,-67.0,-60.0,-69.0,-68.0,-65.0,-59.0,-90.0,-92.0,-89.0,-91.0,21.0,23.0,22.0,31.0,1
400,BA:8C:B9:54:50:24,3835954,489377325,4799,6178701,3831155,483198624,0,8717,1680389,8695,1676894,22,3495,2345,14,5211,38,0,56,229410.0,130000.0,-40.0,-36.0,-45.0,-51.0,-41.0,-36.0,-44.0,-49.0,-90.0,-92.0,-89.0,-91.0,50.0,56.0,44.0,40.0,1
401,92:69:1D:31:68:E9,3834987,486794624,3830,3595798,3831157,483198826,0,4500,1069327,4368,1039542,132,29785,2053,10,4003,83,0,41,229410.0,137640.0,-52.0,-49.0,-43.0,-46.0,-52.0,-48.0,-43.0,-47.0,-90.0,-92.0,-89.0,-91.0,38.0,43.0,46.0,45.0,1
402,CC:2F:71:3F:1F:24,4503676,1202294506,672519,719095680,3831157,483198826,37,545535,570298968,544851,570216684,684,82284,527506,15,672767,72690,34,467,130000.0,43333.0,-70.0,-66.0,-69.0,-70.0,-70.0,-66.0,-69.0,-69.0,-90.0,-92.0,-89.0,-91.0,20.0,26.0,20.0,21.0,1
403,CC:2F:71:3E:C5:1F,3831988,483300475,831,101649,3831157,483198826,0,3465,291099,2859,219147,606,71952,879,8,1193,18,0,37,130000.0,39000.0,-69.0,-69.0,-67.0,-60.0,-69.0,-68.0,-65.0,-59.0,-90.0,-92.0,-89.0,-91.0,21.0,23.0,22.0,31.0,1
404,BA:8C:B9:54:50:24,3835956,489377527,4799,6178701,3831157,483198826,0,8717,1680389,8695,1676894,22,3495,2345,14,5211,38,0,56,229410.0,130000.0,-40.0,-36.0,-45.0,-51.0,-41.0,-36.0,-44.0,-49.0,-90.0,-92.0,-89.0,-91.0,50.0,56.0,44.0,40.0,1
405,92:69:1D:31:68:E9,3834994,486795290,3830,3595798,3831164,483199492,0,4500,1069327,4368,1039542,132,29785,2053,10,4003,83,0,41,229410.0,137640.0,-52.0,-49.0,-43.0,-46.0,-52.0,-48.0,-43.0,-47.0,-90.0,-92.0,-89.0,-91.0,38.0,43.0,46.0,45.0,1
406,CC:2F:71:3F:1F:24,4503723,1202309476,672559,719109984,3831164,483199492,37,545559,570303050,544875,570220766,684,82284,527529,15,672807,72690,34,467,130000.0,43333.0,-71.0,-68.0,-70.0,-69.0,-70.0,-67.0,-68.0,-69.0,-90.0,-92.0,-89.0,-91.0,19.0,24.0,19.0,22.0,1
407,CC:2F:71:3E:C5:1F,3831995,483301141,831,101649,3831164,483199492,0,3465,291099,2859,219147,606,71952,879,8,1193,18,0,37,130000.0,39000.0,-69.0,-69.0,-67.0,-60.0,-69.0,-68.0,-65.0,-59.0,-90.0,-92.0,-89.0,-91.0,21.0,23.0,22.0,31.0,1
408,BA:8C:B9:54:50:24,3835963,489378193,4799,6178701,3831164,483199492,0,8717,1680389,8695,1676894,22,3495,2345,14,5211,38,0,56,229410.0,130000.0,-40.0,-36.0,-45.0,-51.0,-41.0,-36.0,-44.0,-49.0,-90.0,-92.0,-89.0,-91.0,50.0,56.0,44.0,40.0,1
409,92:69:1D:31:68:E9,3834996,486795492,3830,3595798,3831166,483199694,0,4500,1069327,4368,1039542,132,29785,2053,10,4003,83,0,41,229410.0,137640.0,-52.0,-49.0,-43.0,-46.0,-52.0,-48.0,-43.0,-47.0,-90.0,-92.0,-89.0,-91.0,38.0,43.0,46.0,45.0,1
410,CC:2F:71:3F:1F:24,4503764,1202323796,672598,719124102,3831166,483199694,37,545585,570307474,544901,570225190,684,82284,527553,15,672846,72692,34,467,130000.0,39000.0,-69.0,-67.0,-70.0,-69.0,-69.0,-67.0,-69.0,-69.0,-90.0,-92.0,-89.0,-91.0,21.0,25.0,19.0,22.0,1
411,CC:2F:71:3E:C5:1F,3831997,483301343,831,101649,3831166,483199694,0,3465,291099,2859,219147,606,71952,879,8,1193,18,0,37,130000.0,39000.0,-69.0,-69.0,-67.0,-60.0,-69.0,-68.0,-65.0,-59.0,-90.0,-92.0,-89.0,-91.0,21.0,23.0,22.0,31.0,1
412,BA:8C:B9:54:50:24,3835965,489378395,4799,6178701,3831166,483199694,0,8717,1680389,8695,1676894,22,3495,2345,14,5211,38,0,56,229410.0,130000.0,-40.0,-36.0,-45.0,-51.0,-41.0,-36.0,-44.0,-49.0,-90.0,-92.0,-89.0,-91.0,50.0,56.0,44.0,40.0,1
413,92:69:1D:31:68:E9,3835002,486796098,3830,3595798,3831172,483200300,0,4500,1069327,4368,1039542,132,29785,2053,10,4003,83,0,41,229410.0,137640.0,-52.0,-49.0,-43.0,-46.0,-52.0,-48.0,-43.0,-47.0,-90.0,-92.0,-89.0,-91.0,38.0,43.0,46.0,45.0,1
414,CC:2F:71:3F:1F:24,4503810,1202338594,672638,719138294,3831172,483200300,37,545609,570311556,544925,570229272,684,82284,527576,15,672886,72699,34,467,144444.0,43333.0,-71.0,-67.0,-69.0,-73.0,-71.0,-67.0,-68.0,-73.0,-90.0,-92.0,-89.0,-91.0,19.0,25.0,20.0,18.0,1
415,CC:2F:71:3E:C5:1F,3832003,483301949,831,101649,3831172,483200300,0,3465,291099,2859,219147,606,71952,879,8,1193,18,0,37,130000.0,39000.0,-69.0,-69.0,-67.0,-60.0,-69.0,-68.0,-65.0,-59.0,-90.0,-92.0,-89.0,-91.0,21.0,23.0,22.0,31.0,1
416,BA:8C:B9:54:50:24,3835971,489379001,4799,6178701,3831172,483200300,0,8717,1680389,8695,1676894,22,3495,2345,14,5211,38,0,56,229410.0,130000.0,-40.0,-36.0,-45.0,-51.0,-41.0,-36.0,-44.0,-49.0,-90.0,-92.0,-89.0,-91.0,50.0,56.0,44.0,40.0,1
417,92:69:1D:31:68:E9,3835005,486796360,3830,3595798,3831175,483200562,0,4500,1069327,4368,1039542,132,29785,2053,10,4003,83,0,41,229410.0,137640.0,-52.0,-49.0,-43.0,-46.0,-52.0,-48.0,-43.0,-47.0,-90.0,-92.0,-89.0,-91.0,38.0,43.0,46.0,45.0,1
418,CC:2F:71:3F:1F:24,4503860,1202356633,672685,719156071,3831175,483200562,37,545642,570317174,544958,570234890,684,82284,527608,15,672933,72715,34,467,144444.0,43333.0,-70.0,-67.0,-69.0,-72.0,-70.0,-67.0,-69.0,-72.0,-90.0,-92.0,-89.0,-91.0,20.0,25.0,20.0,19.0,1
419,CC:2F:71:3E:C5:1F,3832006,483302211,831,101649,3831175,483200562,0,3465,291099,2859,219147,606,71952,879,8,1193,18,0,37,130000.0,39000.0,-69.0,-69.0,-67.0,-60.0,-69.0,-68.0,-65.0,-59.0,-90.0,-92.0,-89.0,-91.0,21.0,23.0,22.0,31.0,1
420,BA:8C:B9:54:50:24,3835974,489379263,4799,6178701,3831175,483200562,0,8717,1680389,8695,1676894,22,3495,2345,14,5211,38,0,56,229410.0,130000.0,-40.0,-36.0,-45.0,-51.0,-41.0,-36.0,-44.0,-49.0,-90.0,-92.0,-89.0,-91.0,50.0,56.0,44.0,40.0,1
421,92:69:1D:31:68:E9,3835012,486797026,3831,3595858,3831181,483201168,0,4502,1069463,4370,1039678,132,29785,2053,10,4004,83,0,41,216660.0,130000.0,-51.0,-49.0,-44.0,-46.0,-52.0,-47.0,-42.0,-47.0,-90.0,-92.0,-88.0,-90.0,39.0,43.0,44.0,44.0,1
422,CC:2F:71:3F:1F:24,4503907,1202371603,672726,719170435,3831181,483201168,37,545669,570321512,544985,570239228,684,82284,527632,15,672974,72725,34,467,130000.0,43333.0,-70.0,-67.0,-69.0,-71.0,-69.0,-67.0,-69.0,-70.0,-90.0,-92.0,-88.0,-90.0,20.0,25.0,19.0,19.0,1
423,CC:2F:71:3E:C5:1F,3832013,483302933,832,101765,3831181,483201168,0,3467,291239,2861,219287,606,71952,879,8,1194,18,0,37,144444.0,39000.0,-72.0,-70.0,-66.0,-60.0,-69.0,-68.0,-66.0,-59.0,-90.0,-92.0,-88.0,-90.0,18.0,22.0,22.0,30.0,1
424,BA:8C:B9:54:50:24,3835981,489379985,4800,6178817,3831181,483201168,0,8719,1680525,8697,1677030,22,3495,2345,14,5212,38,0,56,229410.0,130000.0,-39.0,-37.0,-45.0,-51.0,-41.0,-36.0,-44.0,-49.0,-90.0,-92.0,-88.0,-90.0,51.0,55.0,43.0,39.0,1
425,92:69:1D:31:68:E9,3835014,486797228,3831,3595858,3831183,483201370,0,4502,1069463,4370,1039678,132,29785,2053,10,4004,83,0,41,216660.0,130000.0,-51.0,-49.0,-44.0,-46.0,-52.0,-47.0,-42.0,-47.0,-90.0,-92.0,-88.0,-90.0,39.0,43.0,44.0,44.0,1
426,CC:2F:71:3F:1F:24,4503952,1202386482,672769,719185112,3831183,483201370,37,545697,570326097,545013,570243813,684,82284,527659,15,673017,72731,34,467,130000.0,39000.0,-69.0,-67.0,-69.0,-71.0,-69.0,-67.0,-69.0,-71.0,-90.0,-92.0,-88.0,-90.0,21.0,25.0,19.0,19.0,1
427,CC:2F:71:3E:C5:1F,3832015,483303135,832,101765,3831183,483201370,0,3467,291239,2861,219287,606,71952,879,8,1194,18,0,37,144444.0,39000.0,-72.0,-70.0,-66.0,-60.0,-69.0,-68.0,-66.0,-59.0,-90.0,-92.0,-88.0,-90.0,18.0,22.0,22.0,30.0,1
428,BA:8C:B9:54:50:24,3835984,489380460,4800,6178817,3831184,483201643,0,8719,1680525,8697,1677030,22,3495,2345,14,5212,38,0,56,229410.0,130000.0,-39.0,-37.0,-45.0,-51.0,-41.0,-36.0,-44.0,-49.0,-90.0,-92.0,-88.0,-90.0,51.0,55.0,43.0,39.0,1
429,92:69:1D:31:68:E9,3835022,486798167,3831,3595858,3831191,483202309,0,4502,1069463,4370,1039678,132,29785,2053,10,4004,83,0,41,216660.0,130000.0,-51.0,-49.0,-44.0,-46.0,-52.0,-47.0,-42.0,-47.0,-90.0,-91.0,-88.0,-90.0,39.0,42.0,44.0,44.0,1
430,CC:2F:71:3F:1F:24,4504000,1202401557,672809,719199248,3831191,483202309,37,545725,570330643,545041,570248359,684,82284,527686,15,673057,72745,34,467,130000.0,43333.0,-70.0,-67.0,-69.0,-71.0,-69.0,-67.0,-69.0,-71.0,-90.0,-91.0,-88.0,-90.0,20.0,24.0,19.0,19.0,1
431,CC:2F:71:3E:C5:1F,3832023,483304074,832,101765,3831191,483202309,0,3467,291239,2861,219287,606,71952,879,8,1194,18,0,37,144444.0,39000.0,-72.0,-70.0,-66.0,-60.0,-69.0,-68.0,-66.0,-59.0,-90.0,-91.0,-88.0,-90.0,18.0,21.0,22.0,30.0,1
432,BA:8C:B9:54:50:24,3835991,489381126,4800,6178817,3831191,483202309,0,8720,1680593,8698,1677098,22,3495,2345,14,5212,38,0,56,229410.0,130000.0,-39.0,-37.0,-46.0,-51.0,-41.0,-36.0,-44.0,-49.0,-90.0,-91.0,-88.0,-90.0,51.0,54.0,42.0,39.0,1
433,92:69:1D:31:68:E9,3835024,486798369,3831,3595858,3831193,483202511,0,4502,1069463,4370,1039678,132,29785,2053,10,4004,83,0,41,216660.0,130000.0,-51.0,-49.0,-44.0,-46.0,-52.0,-47.0,-42.0,-47.0,-90.0,-91.0,-88.0,-90.0,39.0,42.0,44.0,44.0,1
434,CC:2F:71:3F:1F:24,4504050,1202419610,672857,719217099,3831193,483202511,37,545760,570336554,545076,570254270,684,82284,527719,15,673105,72749,34,467,130000.0,39000.0,-70.0,-67.0,-69.0,-71.0,-69.0,-67.0,-69.0,-71.0,-90.0,-91.0,-88.0,-90.0,20.0,24.0,19.0,19.0,1
435,CC:2F:71:3E:C5:1F,3832025,483304276,832,101765,3831193,483202511,0,3467,291239,2861,219287,606,71952,879,8,1194,18,0,37,144444.0,39000.0,-72.0,-70.0,-66.0,-60.0,-69.0,-68.0,-66.0,-59.0,-90.0,-91.0,-88.0,-90.0,18.0,21.0,22.0,30.0,1
436,BA:8C:B9:54:50:24,3835993,489381328,4800,6178817,3831193,483202511,0,8720,1680593,8698,1677098,22,3495,2345,14,5212,38,0,56,229410.0,130000.0,-39.0,-37.0,-46.0,-51.0,-41.0,-36.0,-44.0,-49.0,-90.0,-91.0,-88.0,-90.0,51.0,54.0,42.0,39.0,1
437,92:69:1D:31:68:E9,3835030,486798975,3831,3595858,3831199,483203117,0,4502,1069463,4370,1039678,132,29785,2053,10,4004,83,0,41,216660.0,130000.0,-51.0,-49.0,-44.0,-46.0,-52.0,-47.0,-42.0,-47.0,-90.0,-91.0,-88.0,-90.0,39.0,42.0,44.0,44.0,1
438,CC:2F:71:3F:1F:24,4504103,1202435248,672903,719232071,3831200,483203177,37,545791,570341402,545107,570259118,684,82284,527748,15,673151,72756,34,467,130000.0,39000.0,-69.0,-67.0,-69.0,-71.0,-69.0,-67.0,-69.0,-71.0,-90.0,-91.0,-88.0,-90.0,21.0,24.0,19.0,19.0,1
439,CC:2F:71:3E:C5:1F,3832032,483304942,832,101765,3831200,483203177,0,3467,291239,2861,219287,606,71952,879,8,1194,18,0,37,144444.0,39000.0,-72.0,-70.0,-66.0,-60.0,-69.0,-68.0,-66.0,-59.0,-90.0,-91.0,-88.0,-90.0,18.0,21.0,22.0,30.0,1
440,BA:8C:B9:54:50:24,3836000,489381994,4800,6178817,3831200,483203177,0,8720,1680593,8698,1677098,22,3495,2345,14,5212,38,0,56,229410.0,130000.0,-39.0,-37.0,-46.0,-51.0,-41.0,-36.0,-44.0,-49.0,-90.0,-91.0,-88.0,-90.0,51.0,54.0,42.0,39.0,1
441,92:69:1D:31:68:E9,3835034,486799299,3831,3595858,3831203,483203441,0,4502,1069463,4370,1039678,132,29785,2053,10,4004,83,0,41,216660.0,130000.0,-51.0,-49.0,-44.0,-46.0,-52.0,-47.0,-42.0,-47.0,-90.0,-91.0,-88.0,-90.0,39.0,42.0,44.0,44.0,1
442,CC:2F:71:3F:1F:24,4504146,1202449704,672943,719246263,3831203,483203441,37,545817,570345716,545133,570263432,684,82284,527773,15,673191,72761,34,467,130000.0,39000.0,-69.0,-67.0,-69.0,-71.0,-69.0,-67.0,-69.0,-71.0,-90.0,-91.0,-88.0,-90.0,21.0,24.0,19.0,19.0,1
443,CC:2F:71:3E:C5:1F,3832035,483305206,832,101765,3831203,483203441,0,3469,291427,2862,219357,607,72070,880,8,1194,18,0,37,144444.0,39000.0,-72.0,-70.0,-66.0,-59.0,-70.0,-68.0,-66.0,-59.0,-90.0,-91.0,-88.0,-90.0,18.0,21.0,22.0,31.0,1
444,BA:8C:B9:54:50:24,3836003,489382258,4800,6178817,3831203,483203441,0,8720,1680593,8698,1677098,22,3495,2345,14,5212,38,0,56,229410.0,130000.0,-39.0,-37.0,-46.0,-51.0,-41.0,-36.0,-44.0,-49.0,-90.0,-91.0,-88.0,-90.0,51.0,54.0,42.0,39.0,1
445,92:69:1D:31:68:E9,3835040,486799905,3831,3595858,3831209,483204047,0,4502,1069463,4370,1039678,132,29785,2053,10,4004,83,0,41,216660.0,130000.0,-51.0,-49.0,-44.0,-46.0,-52.0,-47.0,-42.0,-47.0,-90.0,-91.0,-88.0,-90.0,39.0,42.0,44.0,44.0,1
446,CC:2F:71:3F:1F:24,4504195,1202464836,672986,719260789,3831209,483204047,37,545846,570350378,545162,570268094,684,82284,527801,15,673234,72774,34,467,130000.0,43333.0,-69.0,-66.0,-70.0,-72.0,-69.0,-66.0,-69.0,-72.0,-90.0,-91.0,-88.0,-90.0,21.0,25.0,18.0,18.0,1
447,CC:2F:71:3E:C5:1F,3832041,483305812,832,101765,3831209,483204047,0,3469,291427,2862,219357,607,72070,880,8,1194,18,0,37,144444.0,39000.0,-72.0,-70.0,-66.0,-59.0,-70.0,-68.0,-66.0,-59.0,-90.0,-91.0,-88.0,-90.0,18.0,21.0,22.0,31.0,1
448,BA:8C:B9:54:50:24,3836009,489382864,4800,6178817,3831209,483204047,0,8720,1680593,8698,1677098,22,3495,2345,14,5212,38,0,56,229410.0,130000.0,-39.0,-37.0,-46.0,-51.0,-41.0,-36.0,-44.0,-49.0,-90.0,-91.0,-88.0,-90.0,51.0,54.0,42.0,39.0,1
449,92:69:1D:31:68:E9,3835044,486800229,3831,3595858,3831213,483204371,0,4502,1069463,4370,1039678,132,29785,2053,10,4004,83,0,41,216660.0,130000.0,-51.0,-49.0,-44.0,-46.0,-52.0,-47.0,-42.0,-47.0,-90.0,-91.0,-88.0,-90.0,39.0,42.0,44.0,44.0,1
450,CC:2F:71:3F:1F:24,4504249,1202483327,673036,719278956,3831213,483204371,37,545880,570356113,545195,570273711,685,82402,527834,15,673284,72774,34,467,130000.0,43333.0,-68.0,-66.0,-69.0,-72.0,-68.0,-65.0,-69.0,-71.0,-90.0,-91.0,-88.0,-90.0,22.0,25.0,19.0,18.0,1
451,CC:2F:71:3E:C5:1F,3832045,483306136,832,101765,3831213,483204371,0,3469,291427,2862,219357,607,72070,880,8,1194,18,0,37,144444.0,39000.0,-72.0,-70.0,-66.0,-59.0,-70.0,-68.0,-66.0,-59.0,-90.0,-91.0,-88.0,-90.0,18.0,21.0,22.0,31.0,1
452,BA:8C:B9:54:50:24,3836013,489383188,4800,6178817,3831213,483204371,0,8720,1680593,8698,1677098,22,3495,2345,14,5212,38,0,56,229410.0,130000.0,-39.0,-37.0,-46.0,-51.0,-41.0,-36.0,-44.0,-49.0,-90.0,-91.0,-88.0,-90.0,51.0,54.0,42.0,39.0,1
453,92:69:1D:31:68:E9,3835050,486800835,3831,3595858,3831219,483204977,0,4504,1069599,4372,1039814,132,29785,2053,10,4005,83,0,41,216660.0,130000.0,-51.0,-48.0,-44.0,-46.0,-51.0,-47.0,-42.0,-47.0,-90.0,-91.0,-88.0,-90.0,39.0,43.0,44.0,44.0,1
454,CC:2F:71:3F:1F:24,4504293,1202497865,673074,719292888,3831219,483204977,37,545902,570359963,545217,570277561,685,82402,527855,15,673322,72780,34,467,117000.0,39000.0,-69.0,-67.0,-69.0,-70.0,-69.0,-67.0,-69.0,-70.0,-90.0,-91.0,-88.0,-90.0,21.0,24.0,19.0,20.0,1
455,CC:2F:71:3E:C5:1F,3832051,483306742,832,101765,3831219,483204977,0,3469,291427,2862,219357,607,72070,880,8,1194,18,0,37,144444.0,39000.0,-72.0,-70.0,-66.0,-59.0,-70.0,-68.0,-66.0,-59.0,-90.0,-91.0,-88.0,-90.0,18.0,21.0,22.0,31.0,1
456,BA:8C:B9:54:50:24,3836019,489383794,4800,6178817,3831219,483204977,0,8722,1680729,8700,1677234,22,3495,2345,14,5213,38,0,56,229410.0,130000.0,-49.0,-35.0,-43.0,-45.0,-42.0,-36.0,-44.0,-48.0,-90.0,-91.0,-88.0,-90.0,41.0,56.0,45.0,45.0,1
457,92:69:1D:31:68:E9,3835052,486801037,3831,3595858,3831221,483205179,0,4504,1069599,4372,1039814,132,29785,2053,10,4005,83,0,41,216660.0,130000.0,-51.0,-48.0,-44.0,-46.0,-51.0,-47.0,-42.0,-47.0,-90.0,-91.0,-88.0,-90.0,39.0,43.0,44.0,44.0,1
458,CC:2F:71:3F:1F:24,4504334,1202512073,673113,719306894,3831221,483205179,37,545924,570363813,545239,570281411,685,82402,527876,15,673361,72780,34,467,130000.0,39000.0,-70.0,-67.0,-69.0,-70.0,-70.0,-67.0,-68.0,-70.0,-90.0,-91.0,-88.0,-90.0,20.0,24.0,19.0,20.0,1
459,CC:2F:71:3E:C5:1F,3832053,483306944,832,101765,3831221,483205179,0,3469,291427,2862,219357,607,72070,880,8,1194,18,0,37,144444.0,39000.0,-72.0,-70.0,-66.0,-59.0,-70.0,-68.0,-66.0,-59.0,-90.0,-91.0,-88.0,-90.0,18.0,21.0,22.0,31.0,1
460,BA:8C:B9:54:50:24,3836021,489383996,4800,6178817,3831221,483205179,0,8722,1680729,8700,1677234,22,3495,2345,14,5213,38,0,56,229410.0,130000.0,-49.0,-35.0,-43.0,-45.0,-42.0,-36.0,-44.0,-48.0,-90.0,-91.0,-88.0,-90.0,41.0,56.0,45.0,45.0,1
461,92:69:1D:31:68:E9,3835059,486801703,3831,3595858,3831228,483205845,0,4504,1069599,4372,1039814,132,29785,2053,10,4005,83,0,41,216660.0,130000.0,-51.0,-48.0,-44.0,-46.0,-51.0,-47.0,-42.0,-47.0,-90.0,-91.0,-88.0,-90.0,39.0,43.0,44.0,44.0,1
462,CC:2F:71:3F:1F:24,4504380,1202526801,673152,719320956,3831228,483205845,37,545945,570367547,545260,570285145,685,82402,527896,15,673400,72790,34,467,144444.0,43333.0,-70.0,-68.0,-68.0,-70.0,-70.0,-67.0,-68.0,-70.0,-90.0,-91.0,-88.0,-90.0,20.0,23.0,20.0,20.0,1
463,CC:2F:71:3E:C5:1F,3832060,483307610,832,101765,3831228,483205845,0,3469,291427,2862,219357,607,72070,880,8,1194,18,0,37,144444.0,39000.0,-72.0,-70.0,-66.0,-59.0,-70.0,-68.0,-66.0,-59.0,-90.0,-91.0,-88.0,-90.0,18.0,21.0,22.0,31.0,1
464,BA:8C:B9:54:50:24,3836028,489384662,4800,6178817,3831228,483205845,0,8722,1680729,8700,1677234,22,3495,2345,14,5213,38,0,56,229410.0,130000.0,-49.0,-35.0,-43.0,-45.0,-42.0,-36.0,-44.0,-48.0,-90.0,-91.0,-88.0,-90.0,41.0,56.0,45.0,45.0,1
465,92:69:1D:31:68:E9,3835061,486801905,3831,3595858,3831230,483206047,0,4504,1069599,4372,1039814,132,29785,2053,10,4005,83,0,41,216660.0,130000.0,-51.0,-48.0,-44.0,-46.0,-51.0,-47.0,-42.0,-47.0,-90.0,-91.0,-88.0,-90.0,39.0,43.0,44.0,44.0,1
466,CC:2F:71:3F:1F:24,4504422,1202541251,673192,719335204,3831230,483206047,37,545968,570371513,545283,570289111,685,82402,527918,15,673440,72805,34,467,130000.0,43333.0,-70.0,-68.0,-68.0,-69.0,-70.0,-68.0,-68.0,-69.0,-90.0,-91.0,-88.0,-90.0,20.0,23.0,20.0,21.0,1
467,CC:2F:71:3E:C5:1F,3832062,483307812,832,101765,3831230,483206047,0,3469,291427,2862,219357,607,72070,880,8,1194,18,0,37,144444.0,39000.0,-72.0,-70.0,-66.0,-59.0,-70.0,-68.0,-66.0,-59.0,-90.0,-91.0,-88.0,-90.0,18.0,21.0,22.0,31.0,1
468,BA:8C:B9:54:50:24,3836030,489384864,4800,6178817,3831230,483206047,0,8722,1680729,8700,1677234,22,3495,2345,14,5213,38,0,56,229410.0,130000.0,-49.0,-35.0,-43.0,-45.0,-42.0,-36.0,-44.0,-48.0,-90.0,-91.0,-88.0,-90.0,41.0,56.0,45.0,45.0,1
469,92:69:1D:31:68:E9,3835065,486802309,3831,3595858,3831234,483206451,0,4504,1069599,4372,1039814,132,29785,2053,10,4005,83,0,41,216660.0,130000.0,-51.0,-48.0,-44.0,-46.0,-51.0,-47.0,-42.0,-47.0,-90.0,-91.0,-88.0,-90.0,39.0,43.0,44.0,44.0,1
470,CC:2F:71:3F:1F:24,4504475,1202559634,673239,719352981,3831236,483206653,37,545997,570376666,545312,570294264,685,82402,527946,15,673487,72805,34,467,130000.0,43333.0,-70.0,-68.0,-68.0,-70.0,-70.0,-68.0,-68.0,-69.0,-90.0,-91.0,-88.0,-90.0,20.0,23.0,20.0,20.0,1
471,CC:2F:71:3E:C5:1F,3832069,483308478,832,101765,3831237,483206713,0,3469,291427,2862,219357,607,72070,880,8,1194,18,0,37,144444.0,39000.0,-72.0,-70.0,-66.0,-59.0,-70.0,-68.0,-66.0,-59.0,-90.0,-91.0,-88.0,-90.0,18.0,21.0,22.0,31.0,1
472,BA:8C:B9:54:50:24,3836037,489385530,4800,6178817,3831237,483206713,0,8722,1680729,8700,1677234,22,3495,2345,14,5213,38,0,56,229410.0,130000.0,-49.0,-35.0,-43.0,-45.0,-42.0,-36.0,-44.0,-48.0,-90.0,-91.0,-88.0,-90.0,41.0,56.0,45.0,45.0,1
473,92:69:1D:31:68:E9,3835070,486802773,3831,3595858,3831239,483206915,0,4504,1069599,4372,1039814,132,29785,2053,10,4005,83,0,41,216660.0,130000.0,-51.0,-48.0,-44.0,-46.0,-51.0,-47.0,-42.0,-47.0,-90.0,-91.0,-88.0,-90.0,39.0,43.0,44.0,44.0,1
474,CC:2F:71:3F:1F:24,4504516,1202573884,673277,719366969,3831239,483206915,37,546019,570380516,545334,570298114,685,82402,527967,15,673525,72808,34,467,130000.0,39000.0,-70.0,-68.0,-68.0,-69.0,-70.0,-68.0,-68.0,-69.0,-90.0,-91.0,-88.0,-90.0,20.0,23.0,20.0,21.0,1
475,CC:2F:71:3E:C5:1F,3832071,483308680,832,101765,3831239,483206915,0,3469,291427,2862,219357,607,72070,880,8,1194,18,0,37,144444.0,39000.0,-72.0,-70.0,-66.0,-59.0,-70.0,-68.0,-66.0,-59.0,-90.0,-91.0,-88.0,-90.0,18.0,21.0,22.0,31.0,1
476,BA:8C:B9:54:50:24,3836039,489385732,4800,6178817,3831239,483206915,0,8722,1680729,8700,1677234,22,3495,2345,14,5213,38,0,56,229410.0,130000.0,-49.0,-35.0,-43.0,-45.0,-42.0,-36.0,-44.0,-48.0,-90.0,-91.0,-88.0,-90.0,41.0,56.0,45.0,45.0,1
477,92:69:1D:31:68:E9,3835074,486803177,3831,3595858,3831243,483207319,0,4504,1069599,4372,1039814,132,29785,2053,10,4005,83,0,41,216660.0,130000.0,-51.0,-48.0,-44.0,-46.0,-51.0,-47.0,-42.0,-47.0,-90.0,-91.0,-88.0,-90.0,39.0,43.0,44.0,44.0,1
478,CC:2F:71:3F:1F:24,4504562,1202588682,673317,719381161,3831245,483207521,37,546041,570384366,545356,570301964,685,82402,527988,15,673565,72820,34,467,144444.0,43333.0,-70.0,-67.0,-70.0,-71.0,-70.0,-67.0,-69.0,-71.0,-90.0,-91.0,-88.0,-90.0,20.0,24.0,18.0,19.0,1
479,CC:2F:71:3E:C5:1F,3832077,483309286,832,101765,3831245,483207521,0,3469,291427,2862,219357,607,72070,880,8,1194,18,0,37,144444.0,39000.0,-72.0,-70.0,-66.0,-59.0,-70.0,-68.0,-66.0,-59.0,-90.0,-91.0,-88.0,-90.0,18.0,21.0,22.0,31.0,1
480,BA:8C:B9:54:50:24,3836045,489386338,4800,6178817,3831245,483207521,0,8722,1680729,8700,1677234,22,3495,2345,14,5213,38,0,56,229410.0,130000.0,-49.0,-35.0,-43.0,-45.0,-42.0,-36.0,-44.0,-48.0,-90.0,-91.0,-88.0,-90.0,41.0,56.0,45.0,45.0,1
481,92:69:1D:31:68:E9,3835080,486803914,3831,3595858,3831249,483208056,0,4504,1069599,4372,1039814,132,29785,2053,10,4005,83,0,41,216660.0,130000.0,-51.0,-48.0,-44.0,-46.0,-51.0,-47.0,-42.0,-47.0,-90.0,-91.0,-88.0,-90.0,39.0,43.0,44.0,44.0,1
482,CC:2F:71:3F:1F:24,4504606,1202603465,673357,719395409,3831249,483208056,37,546066,570388518,545381,570306116,685,82402,528011,15,673605,72836,34,467,130000.0,43333.0,-71.0,-66.0,-71.0,-73.0,-70.0,-66.0,-71.0,-72.0,-90.0,-91.0,-88.0,-90.0,19.0,25.0,17.0,17.0,1
483,CC:2F:71:3E:C5:1F,3832081,483309821,832,101765,3831249,483208056,0,3469,291427,2862,219357,607,72070,880,8,1194,18,0,37,144444.0,39000.0,-72.0,-70.0,-66.0,-59.0,-70.0,-68.0,-66.0,-59.0,-90.0,-91.0,-88.0,-90.0,18.0,21.0,22.0,31.0,1
484,BA:8C:B9:54:50:24,3836049,489386873,4800,6178817,3831249,483208056,0,8722,1680729,8700,1677234,22,3495,2345,14,5213,38,0,56,229410.0,130000.0,-49.0,-35.0,-43.0,-45.0,-42.0,-36.0,-44.0,-48.0,-90.0,-91.0,-88.0,-90.0,41.0,56.0,45.0,45.0,1
485,92:69:1D:31:68:E9,3835085,486804444,3831,3595858,3831254,483208586,0,4504,1069599,4372,1039814,132,29785,2053,10,4005,83,0,41,216660.0,130000.0,-51.0,-48.0,-44.0,-46.0,-51.0,-47.0,-42.0,-47.0,-90.0,-91.0,-88.0,-90.0,39.0,43.0,44.0,44.0,1
486,CC:2F:71:3F:1F:24,4504658,1202621656,673402,719412868,3831256,483208788,37,546094,570393553,545409,570311151,685,82402,528038,15,673650,72847,34,467,130000.0,39000.0,-70.0,-67.0,-71.0,-72.0,-70.0,-67.0,-70.0,-72.0,-90.0,-91.0,-88.0,-90.0,20.0,24.0,17.0,18.0,1
487,CC:2F:71:3E:C5:1F,3832088,483310553,832,101765,3831256,483208788,0,3469,291427,2862,219357,607,72070,880,8,1194,18,0,37,144444.0,39000.0,-72.0,-70.0,-66.0,-59.0,-70.0,-68.0,-66.0,-59.0,-90.0,-91.0,-88.0,-90.0,18.0,21.0,22.0,31.0,1
488,BA:8C:B9:54:50:24,3836056,489387605,4800,6178817,3831256,483208788,0,8722,1680729,8700,1677234,22,3495,2345,14,5213,38,0,56,229410.0,130000.0,-49.0,-35.0,-43.0,-45.0,-42.0,-36.0,-44.0,-48.0,-90.0,-91.0,-88.0,-90.0,41.0,56.0,45.0,45.0,1
489,92:69:1D:31:68:E9,3835089,486804848,3831,3595858,3831258,483208990,0,4504,1069599,4372,1039814,132,29785,2053,10,4005,83,0,41,216660.0,130000.0,-51.0,-48.0,-44.0,-46.0,-51.0,-47.0,-42.0,-47.0,-90.0,-91.0,-88.0,-90.0,39.0,43.0,44.0,44.0,1
490,CC:2F:71:3F:1F:24,4504704,1202636570,673446,719427580,3831258,483208990,37,546124,570398285,545439,570315883,685,82402,528066,15,673694,72856,34,467,130000.0,39000.0,-70.0,-67.0,-70.0,-71.0,-70.0,-67.0,-69.0,-71.0,-90.0,-91.0,-88.0,-90.0,20.0,24.0,18.0,19.0,1
491,CC:2F:71:3E:C5:1F,3832090,483310755,832,101765,3831258,483208990,0,3469,291427,2862,219357,607,72070,880,8,1194,18,0,37,144444.0,39000.0,-72.0,-70.0,-66.0,-59.0,-70.0,-68.0,-66.0,-59.0,-90.0,-91.0,-88.0,-90.0,18.0,21.0,22.0,31.0,1
492,BA:8C:B9:54:50:24,3836058,489387807,4800,6178817,3831258,483208990,0,8722,1680729,8700,1677234,22,3495,2345,14,5213,38,0,56,229410.0,130000.0,-49.0,-35.0,-43.0,-45.0,-42.0,-36.0,-44.0,-48.0,-90.0,-91.0,-88.0,-90.0,41.0,56.0,45.0,45.0,1
493,92:69:1D:31:68:E9,3835094,486805312,3831,3595858,3831263,483209454,0,4504,1069599,4372,1039814,132,29785,2053,10,4005,83,0,41,216660.0,130000.0,-51.0,-48.0,-44.0,-46.0,-51.0,-47.0,-42.0,-47.0,-90.0,-91.0,-88.0,-90.0,39.0,43.0,44.0,44.0,1
494,CC:2F:71:3F:1F:24,4504752,1202651558,673487,719441902,3831265,483209656,37,546151,570402715,545466,570320313,685,82402,528092,15,673735,72864,34,467,130000.0,39000.0,-70.0,-67.0,-70.0,-71.0,-70.0,-67.0,-69.0,-70.0,-90.0,-91.0,-88.0,-90.0,20.0,24.0,18.0,19.0,1
495,CC:2F:71:3E:C5:1F,3832097,483311421,832,101765,3831265,483209656,0,3469,291427,2862,219357,607,72070,880,8,1194,18,0,37,144444.0,39000.0,-72.0,-70.0,-66.0,-59.0,-70.0,-68.0,-66.0,-59.0,-90.0,-91.0,-88.0,-90.0,18.0,21.0,22.0,31.0,1
496,BA:8C:B9:54:50:24,3836065,489388473,4800,6178817,3831265,483209656,0,8722,1680729,8700,1677234,22,3495,2345,14,5213,38,0,56,229410.0,130000.0,-49.0,-35.0,-43.0,-45.0,-42.0,-36.0,-44.0,-48.0,-90.0,-91.0,-88.0,-90.0,41.0,56.0,45.0,45.0,1
497,92:69:1D:31:68:E9,3835098,486805716,3831,3595858,3831267,483209858,0,4504,1069599,4372,1039814,132,29785,2053,10,4005,83,0,41,216660.0,130000.0,-51.0,-48.0,-44.0,-46.0,-51.0,-47.0,-42.0,-47.0,-90.0,-91.0,-88.0,-90.0,39.0,43.0,44.0,44.0,1
498,CC:2F:71:3F:1F:24,4504795,1202666082,673528,719456224,3831267,483209858,37,546178,570407099,545493,570324697,685,82402,528117,15,673776,72872,34,467,130000.0,39000.0,-73.0,-70.0,-72.0,-75.0,-72.0,-69.0,-72.0,-73.0,-90.0,-91.0,-88.0,-90.0,17.0,21.0,16.0,15.0,1
499,CC:2F:71:3E:C5:1F,3832099,483311623,832,101765,3831267,483209858,0,3469,291427,2862,219357,607,72070,880,8,1194,18,0,37,144444.0,39000.0,-72.0,-70.0,-66.0,-59.0,-70.0,-68.0,-66.0,-59.0,-90.0,-91.0,-88.0,-90.0,18.0,21.0,22.0,31.0,1
500,BA:8C:B9:54:50:24,3836067,489388675,4800,6178817,3831267,483209858,0,8722,1680729,8700,1677234,22,3495,2345,14,5213,38,0,56,229410.0,130000.0,-49.0,-35.0,-43.0,-45.0,-42.0,-36.0,-44.0,-48.0,-90.0,-91.0,-88.0,-90.0,41.0,56.0,45.0,45.0,1
501,92:69:1D:31:68:E9,3835101,486805986,3831,3595858,3831270,483210128,0,4504,1069599,4372,1039814,132,29785,2053,10,4005,83,0,41,216660.0,130000.0,-51.0,-48.0,-44.0,-46.0,-51.0,-47.0,-42.0,-47.0,-90.0,-91.0,-88.0,-90.0,39.0,43.0,44.0,44.0,1
502,CC:2F:71:3F:1F:24,4504850,1202684655,673578,719474333,3831272,483210322,37,546212,570412832,545527,570330430,685,82402,528150,15,673826,72872,34,467,130000.0,43333.0,-68.0,-67.0,-69.0,-70.0,-68.0,-67.0,-69.0,-70.0,-90.0,-91.0,-88.0,-90.0,22.0,24.0,19.0,20.0,1
503,CC:2F:71:3E:C5:1F,3832106,483312289,832,101765,3831274,483210524,0,3469,291427,2862,219357,607,72070,880,8,1194,18,0,37,144444.0,39000.0,-72.0,-70.0,-66.0,-59.0,-70.0,-68.0,-66.0,-59.0,-90.0,-91.0,-88.0,-90.0,18.0,21.0,22.0,31.0,1
504,BA:8C:B9:54:50:24,3836074,489389341,4800,6178817,3831274,483210524,0,8722,1680729,8700,1677234,22,3495,2345,14,5213,38,0,56,229410.0,130000.0,-49.0,-35.0,-43.0,-45.0,-42.0,-36.0,-44.0,-48.0,-90.0,-91.0,-88.0,-90.0,41.0,56.0,45.0,45.0,1
505,92:69:1D:31:68:E9,3835107,486806584,3831,3595858,3831276,483210726,0,4504,1069599,4372,1039814,132,29785,2053,10,4005,83,0,41,216660.0,130000.0,-51.0,-48.0,-44.0,-46.0,-51.0,-47.0,-42.0,-47.0,-90.0,-91.0,-88.0,-90.0,39.0,43.0,44.0,44.0,1
506,CC:2F:71:3F:1F:24,4504893,1202699177,673617,719488451,3831276,483210726,37,546236,570416914,545551,570334512,685,82402,528173,15,673865,72876,34,467,130000.0,39000.0,-69.0,-67.0,-68.0,-69.0,-68.0,-67.0,-68.0,-69.0,-90.0,-91.0,-88.0,-90.0,21.0,24.0,20.0,21.0,1
507,CC:2F:71:3E:C5:1F,3832108,483312491,832,101765,3831276,483210726,0,3469,291427,2862,219357,607,72070,880,8,1194,18,0,37,144444.0,39000.0,-72.0,-70.0,-66.0,-59.0,-70.0,-68.0,-66.0,-59.0,-90.0,-91.0,-88.0,-90.0,18.0,21.0,22.0,31.0,1
508,BA:8C:B9:54:50:24,3836076,489389543,4800,6178817,3831276,483210726,0,8722,1680729,8700,1677234,22,3495,2345,14,5213,38,0,56,229410.0,130000.0,-49.0,-35.0,-43.0,-45.0,-42.0,-36.0,-44.0,-48.0,-90.0,-91.0,-88.0,-90.0,41.0,56.0,45.0,45.0,1
509,92:69:1D:31:68:E9,3835109,486806786,3831,3595858,3831278,483210928,0,4504,1069599,4372,1039814,132,29785,2053,10,4005,83,0,41,216660.0,130000.0,-51.0,-48.0,-44.0,-46.0,-51.0,-47.0,-42.0,-47.0,-90.0,-91.0,-88.0,-90.0,39.0,43.0,44.0,44.0,1
510,CC:2F:71:3F:1F:24,4504936,1202713643,673656,719502513,3831280,483211130,37,546259,570420880,545574,570338478,685,82402,528195,15,673904,72882,34,467,144444.0,43333.0,-69.0,-66.0,-68.0,-71.0,-68.0,-66.0,-68.0,-70.0,-90.0,-91.0,-88.0,-90.0,21.0,25.0,20.0,19.0,1
511,CC:2F:71:3E:C5:1F,3832114,483313097,832,101765,3831282,483211332,0,3469,291427,2862,219357,607,72070,880,8,1194,18,0,37,144444.0,39000.0,-72.0,-70.0,-66.0,-59.0,-70.0,-68.0,-66.0,-59.0,-90.0,-91.0,-88.0,-90.0,18.0,21.0,22.0,31.0,1
512,BA:8C:B9:54:50:24,3836082,489390149,4800,6178817,3831282,483211332,0,8722,1680729,8700,1677234,22,3495,2345,14,5213,38,0,56,229410.0,130000.0,-49.0,-35.0,-43.0,-45.0,-42.0,-36.0,-44.0,-48.0,-90.0,-91.0,-88.0,-90.0,41.0,56.0,45.0,45.0,1
513,92:69:1D:31:68:E9,3835116,486807452,3831,3595858,3831285,483211594,0,4505,1069667,4373,1039882,132,29785,2053,10,4005,83,0,41,216660.0,130000.0,-51.0,-48.0,-44.0,-47.0,-51.0,-47.0,-43.0,-47.0,-90.0,-91.0,-88.0,-90.0,39.0,43.0,44.0,43.0,1
514,CC:2F:71:3F:1F:24,4504981,1202728411,673696,719516817,3831285,483211594,37,546281,570424730,545596,570342328,685,82402,528216,15,673944,72882,34,467,144444.0,43333.0,-71.0,-66.0,-70.0,-71.0,-71.0,-66.0,-69.0,-71.0,-90.0,-91.0,-88.0,-90.0,19.0,25.0,18.0,19.0,1
515,CC:2F:71:3E:C5:1F,3832117,483313359,832,101765,3831285,483211594,0,3469,291427,2862,219357,607,72070,880,8,1194,18,0,37,144444.0,39000.0,-72.0,-70.0,-66.0,-59.0,-70.0,-68.0,-66.0,-59.0,-90.0,-91.0,-88.0,-90.0,18.0,21.0,22.0,31.0,1
516,BA:8C:B9:54:50:24,3836085,489390411,4800,6178817,3831285,483211594,0,8722,1680729,8700,1677234,22,3495,2345,14,5213,38,0,56,229410.0,130000.0,-49.0,-35.0,-43.0,-45.0,-42.0,-36.0,-44.0,-48.0,-90.0,-91.0,-88.0,-90.0,41.0,56.0,45.0,45.0,1
517,92:69:1D:31:68:E9,3835118,486807654,3831,3595858,3831287,483211796,0,4505,1069667,4373,1039882,132,29785,2053,10,4005,83,0,41,216660.0,130000.0,-51.0,-48.0,-44.0,-47.0,-51.0,-47.0,-43.0,-47.0,-90.0,-91.0,-88.0,-90.0,39.0,43.0,44.0,43.0,1
518,CC:2F:71:3F:1F:24,4505030,1202746330,673741,719534332,3831289,483211998,37,546310,570429883,545625,570347481,685,82402,528244,15,673989,72887,34,467,144444.0,43333.0,-69.0,-68.0,-68.0,-69.0,-69.0,-67.0,-68.0,-69.0,-90.0,-91.0,-88.0,-90.0,21.0,23.0,20.0,21.0,1
519,CC:2F:71:3E:C5:1F,3832121,483313763,832,101765,3831289,483211998,0,3469,291427,2862,219357,607,72070,880,8,1194,18,0,37,144444.0,39000.0,-72.0,-70.0,-66.0,-59.0,-70.0,-68.0,-66.0,-59.0,-90.0,-91.0,-88.0,-90.0,18.0,21.0,22.0,31.0,1
520,BA:8C:B9:54:50:24,3836091,489391017,4800,6178817,3831291,483212200,0,8722,1680729,8700,1677234,22,3495,2345,14,5213,38,0,56,229410.0,130000.0,-49.0,-35.0,-43.0,-45.0,-42.0,-36.0,-44.0,-48.0,-90.0,-91.0,-88.0,-90.0,41.0,56.0,45.0,45.0,1
521,92:69:1D:31:68:E9,3835122,486808058,3831,3595858,3831291,483212200,0,4505,1069667,4373,1039882,132,29785,2053,10,4005,83,0,41,216660.0,130000.0,-51.0,-48.0,-44.0,-47.0,-51.0,-47.0,-43.0,-47.0,-90.0,-91.0,-88.0,-90.0,39.0,43.0,44.0,43.0,1
522,CC:2F:71:3F:1F:24,4505072,1202760778,673779,719548376,3831293,483212402,37,546332,570433733,545647,570351331,685,82402,528265,15,674027,72900,34,467,144444.0,43333.0,-69.0,-68.0,-68.0,-69.0,-69.0,-67.0,-68.0,-69.0,-90.0,-91.0,-88.0,-90.0,21.0,23.0,20.0,21.0,1
523,CC:2F:71:3E:C5:1F,3832125,483314167,832,101765,3831293,483212402,0,3469,291427,2862,219357,607,72070,880,8,1194,18,0,37,144444.0,39000.0,-72.0,-70.0,-66.0,-59.0,-70.0,-68.0,-66.0,-59.0,-90.0,-91.0,-88.0,-90.0,18.0,21.0,22.0,31.0,1
524,BA:8C:B9:54:50:24,3836093,489391219,4800,6178817,3831293,483212402,0,8722,1680729,8700,1677234,22,3495,2345,14,5213,38,0,56,229410.0,130000.0,-49.0,-35.0,-43.0,-45.0,-42.0,-36.0,-44.0,-48.0,-90.0,-91.0,-88.0,-90.0,41.0,56.0,45.0,45.0,1
525,92:69:1D:31:68:E9,3835127,486808522,3831,3595858,3831296,483212664,0,4505,1069667,4373,1039882,132,29785,2053,10,4005,83,0,41,216660.0,130000.0,-51.0,-48.0,-44.0,-47.0,-51.0,-47.0,-43.0,-47.0,-90.0,-91.0,-88.0,-90.0,39.0,43.0,44.0,43.0,1
526,CC:2F:71:3F:1F:24,4505113,1202775084,673817,719562420,3831296,483212664,37,546353,570437467,545668,570355065,685,82402,528285,15,674065,72914,34,467,144444.0,43333.0,-69.0,-68.0,-68.0,-69.0,-69.0,-67.0,-68.0,-69.0,-90.0,-91.0,-88.0,-90.0,21.0,23.0,20.0,21.0,1
527,CC:2F:71:3E:C5:1F,3832130,483314631,832,101765,3831298,483212866,0,3469,291427,2862,219357,607,72070,880,8,1194,18,0,37,144444.0,39000.0,-72.0,-70.0,-66.0,-59.0,-70.0,-68.0,-66.0,-59.0,-90.0,-91.0,-88.0,-90.0,18.0,21.0,22.0,31.0,1
528,BA:8C:B9:54:50:24,3836100,489391885,4800,6178817,3831300,483213068,0,8722,1680729,8700,1677234,22,3495,2345,14,5213,38,0,56,229410.0,130000.0,-49.0,-35.0,-43.0,-45.0,-42.0,-36.0,-44.0,-48.0,-90.0,-91.0,-88.0,-90.0,41.0,56.0,45.0,45.0,1
529,92:69:1D:31:68:E9,3835132,486808986,3832,3595918,3831300,483213068,0,4507,1069803,4375,1040018,132,29785,2053,10,4006,84,0,41,216660.0,130000.0,-51.0,-47.0,-42.0,-49.0,-51.0,-48.0,-43.0,-46.0,-90.0,-91.0,-88.0,-90.0,39.0,44.0,46.0,41.0,1
530,CC:2F:71:3F:1F:24,4505158,1202789850,673856,719576580,3831302,483213270,37,546375,570441317,545690,570358915,685,82402,528306,15,674104,72930,34,467,144444.0,43333.0,-73.0,-71.0,-71.0,-73.0,-72.0,-70.0,-71.0,-72.0,-90.0,-91.0,-88.0,-90.0,17.0,20.0,17.0,17.0,1
531,CC:2F:71:3E:C5:1F,3832135,483315095,833,101825,3831302,483213270,0,3471,291567,2864,219497,607,72070,880,8,1195,18,0,37,144444.0,39000.0,-72.0,-69.0,-67.0,-60.0,-70.0,-68.0,-66.0,-59.0,-90.0,-91.0,-88.0,-90.0,18.0,22.0,21.0,30.0,1
532,BA:8C:B9:54:50:24,3836103,489392203,4801,6178933,3831302,483213270,0,8726,1681001,8704,1677506,22,3495,2345,14,5214,38,0,56,229410.0,130000.0,-49.0,-35.0,-43.0,-45.0,-44.0,-35.0,-43.0,-46.0,-90.0,-91.0,-88.0,-90.0,41.0,56.0,45.0,45.0,1
533,92:69:1D:31:68:E9,3835137,486809663,3832,3595918,3831305,483213745,0,4507,1069803,4375,1040018,132,29785,2053,10,4006,84,0,41,216660.0,130000.0,-51.0,-47.0,-42.0,-49.0,-51.0,-48.0,-43.0,-46.0,-90.0,-91.0,-88.0,-90.0,39.0,44.0,46.0,41.0,1
534,CC:2F:71:3F:1F:24,4505207,1202807900,673901,719594095,3831306,483213805,37,546403,570446354,545718,570363952,685,82402,528333,15,674149,72943,34,467,144444.0,43333.0,-69.0,-68.0,-68.0,-69.0,-69.0,-67.0,-67.0,-69.0,-90.0,-91.0,-88.0,-90.0,21.0,23.0,20.0,21.0,1
535,CC:2F:71:3E:C5:1F,3832141,483315832,833,101825,3831308,483214007,0,3471,291567,2864,219497,607,72070,880,8,1195,18,0,37,144444.0,39000.0,-72.0,-69.0,-67.0,-60.0,-70.0,-68.0,-66.0,-59.0,-90.0,-91.0,-88.0,-90.0,18.0,22.0,21.0,30.0,1
536,BA:8C:B9:54:50:24,3836111,489393142,4801,6178933,3831310,483214209,0,8726,1681001,8704,1677506,22,3495,2345,14,5214,38,0,56,229410.0,130000.0,-49.0,-35.0,-43.0,-45.0,-44.0,-35.0,-43.0,-46.0,-90.0,-91.0,-88.0,-90.0,41.0,56.0,45.0,45.0,1
537,92:69:1D:31:68:E9,3835142,486810127,3832,3595918,3831310,483214209,0,4507,1069803,4375,1040018,132,29785,2053,10,4006,84,0,41,216660.0,130000.0,-51.0,-47.0,-42.0,-49.0,-51.0,-48.0,-43.0,-46.0,-90.0,-91.0,-88.0,-90.0,39.0,44.0,46.0,41.0,1
538,CC:2F:71:3F:1F:24,4505253,1202822810,673941,719608399,3831312,483214411,37,546427,570450436,545742,570368034,685,82402,528356,15,674189,72959,34,467,144444.0,43333.0,-70.0,-68.0,-68.0,-69.0,-69.0,-68.0,-68.0,-69.0,-90.0,-91.0,-88.0,-90.0,20.0,23.0,20.0,21.0,1
539,CC:2F:71:3E:C5:1F,3832145,483316236,833,101825,3831312,483214411,0,3471,291567,2864,219497,607,72070,880,8,1195,18,0,37,144444.0,39000.0,-72.0,-69.0,-67.0,-60.0,-70.0,-68.0,-66.0,-59.0,-90.0,-91.0,-88.0,-90.0,18.0,22.0,21.0,30.0,1
540,BA:8C:B9:54:50:24,3836113,489393344,4801,6178933,3831312,483214411,0,8726,1681001,8704,1677506,22,3495,2345,14,5214,38,0,56,229410.0,130000.0,-49.0,-35.0,-43.0,-45.0,-44.0,-35.0,-43.0,-46.0,-90.0,-91.0,-88.0,-90.0,41.0,56.0,45.0,45.0,1
541,92:69:1D:31:68:E9,3835146,486810531,3832,3595918,3831314,483214613,0,4507,1069803,4375,1040018,132,29785,2053,10,4006,84,0,41,216660.0,130000.0,-51.0,-47.0,-42.0,-49.0,-51.0,-48.0,-43.0,-46.0,-90.0,-91.0,-88.0,-90.0,39.0,44.0,46.0,41.0,1
542,CC:2F:71:3F:1F:24,4505295,1202837316,673981,719622703,3831314,483214613,37,546453,570454750,545768,570372348,685,82402,528381,15,674229,72985,34,467,144444.0,43333.0,-70.0,-68.0,-67.0,-69.0,-70.0,-68.0,-67.0,-69.0,-90.0,-91.0,-88.0,-90.0,20.0,23.0,21.0,21.0,1
543,CC:2F:71:3E:C5:1F,3832149,483316640,833,101825,3831316,483214815,0,3471,291567,2864,219497,607,72070,880,8,1195,18,0,37,144444.0,39000.0,-72.0,-69.0,-67.0,-60.0,-70.0,-68.0,-66.0,-59.0,-90.0,-91.0,-88.0,-90.0,18.0,22.0,21.0,30.0,1
544,BA:8C:B9:54:50:24,3836119,489393950,4801,6178933,3831318,483215017,0,8726,1681001,8704,1677506,22,3495,2345,14,5214,38,0,56,229410.0,130000.0,-49.0,-35.0,-43.0,-45.0,-44.0,-35.0,-43.0,-46.0,-90.0,-91.0,-88.0,-90.0,41.0,56.0,45.0,45.0,1
545,92:69:1D:31:68:E9,3835151,486810995,3832,3595918,3831319,483215077,0,4507,1069803,4375,1040018,132,29785,2053,10,4006,84,0,41,216660.0,130000.0,-51.0,-47.0,-42.0,-49.0,-51.0,-48.0,-43.0,-46.0,-90.0,-91.0,-88.0,-90.0,39.0,44.0,46.0,41.0,1
546,CC:2F:71:3F:1F:24,4505344,1202852604,674025,719637527,3831319,483215077,37,546481,570459250,545796,570376848,685,82402,528407,15,674273,73016,34,467,144444.0,43333.0,-70.0,-68.0,-67.0,-69.0,-70.0,-68.0,-67.0,-69.0,-90.0,-91.0,-88.0,-90.0,20.0,23.0,21.0,21.0,1
547,CC:2F:71:3E:C5:1F,3832156,483317472,833,101825,3831323,483215647,0,3471,291567,2864,219497,607,72070,880,8,1195,18,0,37,144444.0,39000.0,-72.0,-69.0,-67.0,-60.0,-70.0,-68.0,-66.0,-59.0,-90.0,-91.0,-88.0,-90.0,18.0,22.0,21.0,30.0,1
548,BA:8C:B9:54:50:24,3836124,489394580,4801,6178933,3831323,483215647,0,8726,1681001,8704,1677506,22,3495,2345,14,5214,38,0,56,229410.0,130000.0,-49.0,-35.0,-43.0,-45.0,-44.0,-35.0,-43.0,-46.0,-90.0,-91.0,-88.0,-90.0,41.0,56.0,45.0,45.0,1
549,92:69:1D:31:68:E9,3835157,486811767,3832,3595918,3831325,483215849,0,4507,1069803,4375,1040018,132,29785,2053,10,4006,84,0,41,216660.0,130000.0,-51.0,-47.0,-42.0,-49.0,-51.0,-48.0,-43.0,-46.0,-90.0,-91.0,-88.0,-90.0,39.0,44.0,46.0,41.0,1
550,CC:2F:71:3F:1F:24,4505399,1202871411,674074,719655562,3831325,483215849,37,546513,570464751,545828,570382349,685,82402,528438,15,674322,73057,34,467,144444.0,43333.0,-73.0,-71.0,-70.0,-72.0,-71.0,-69.0,-68.0,-70.0,-90.0,-91.0,-88.0,-90.0,17.0,20.0,18.0,18.0,1
551,CC:2F:71:3E:C5:1F,3832160,483317876,833,101825,3831327,483216051,0,3471,291567,2864,219497,607,72070,880,8,1195,18,0,37,144444.0,39000.0,-72.0,-69.0,-67.0,-60.0,-70.0,-68.0,-66.0,-59.0,-90.0,-91.0,-88.0,-90.0,18.0,22.0,21.0,30.0,1
552,BA:8C:B9:54:50:24,3836128,489394984,4801,6178933,3831327,483216051,0,8726,1681001,8704,1677506,22,3495,2345,14,5214,38,0,56,229410.0,130000.0,-49.0,-35.0,-43.0,-45.0,-44.0,-35.0,-43.0,-46.0,-90.0,-91.0,-88.0,-90.0,41.0,56.0,45.0,45.0,1
553,92:69:1D:31:68:E9,3835161,486812171,3832,3595918,3831329,483216253,0,4507,1069803,4375,1040018,132,29785,2053,10,4006,84,0,41,216660.0,130000.0,-51.0,-47.0,-42.0,-49.0,-51.0,-48.0,-43.0,-46.0,-90.0,-91.0,-88.0,-90.0,39.0,44.0,46.0,41.0,1
554,CC:2F:71:3F:1F:24,4505443,1202886119,674114,719669866,3831329,483216253,37,546538,570468903,545853,570386501,685,82402,528461,15,674362,73094,34,467,144444.0,43333.0,-70.0,-68.0,-67.0,-69.0,-71.0,-69.0,-68.0,-70.0,-90.0,-91.0,-88.0,-90.0,20.0,23.0,21.0,21.0,1
555,CC:2F:71:3E:C5:1F,3832164,483318280,833,101825,3831331,483216455,0,3471,291567,2864,219497,607,72070,880,8,1195,18,0,37,144444.0,39000.0,-72.0,-69.0,-67.0,-60.0,-70.0,-68.0,-66.0,-59.0,-90.0,-91.0,-88.0,-90.0,18.0,22.0,21.0,30.0,1
556,BA:8C:B9:54:50:24,3836132,489395388,4801,6178933,3831331,483216455,0,8726,1681001,8704,1677506,22,3495,2345,14,5214,38,0,56,229410.0,130000.0,-49.0,-35.0,-43.0,-45.0,-44.0,-35.0,-43.0,-46.0,-90.0,-91.0,-88.0,-90.0,41.0,56.0,45.0,45.0,1
557,92:69:1D:31:68:E9,3835166,486812635,3832,3595918,3831334,483216717,0,4507,1069803,4375,1040018,132,29785,2053,10,4006,84,0,41,216660.0,130000.0,-51.0,-47.0,-42.0,-49.0,-51.0,-48.0,-43.0,-46.0,-90.0,-91.0,-88.0,-90.0,39.0,44.0,46.0,41.0,1
558,CC:2F:71:3F:1F:24,4505490,1202901147,674156,719684430,3831334,483216717,37,546565,570473287,545880,570390885,685,82402,528486,15,674404,73128,34,467,144444.0,43333.0,-71.0,-69.0,-68.0,-70.0,-70.0,-68.0,-67.0,-69.0,-89.0,-91.0,-87.0,-90.0,18.0,22.0,19.0,20.0,1
559,CC:2F:71:3E:C5:1F,3832169,483318744,833,101825,3831336,483216919,0,3472,291637,2865,219567,607,72070,880,8,1196,18,0,37,144444.0,39000.0,-72.0,-70.0,-67.0,-60.0,-71.0,-68.0,-66.0,-59.0,-89.0,-91.0,-87.0,-90.0,17.0,21.0,20.0,30.0,1
560,BA:8C:B9:54:50:24,3836137,489395852,4801,6178933,3831336,483216919,0,8730,1681273,8708,1677778,22,3495,2345,14,5215,38,0,56,229410.0,130000.0,-40.0,-37.0,-45.0,-51.0,-42.0,-35.0,-44.0,-48.0,-89.0,-91.0,-87.0,-90.0,49.0,54.0,42.0,39.0,1
561,92:69:1D:31:68:E9,3835170,486813039,3832,3595918,3831338,483217121,0,4509,1069939,4377,1040154,132,29785,2053,10,4007,84,0,41,216660.0,130000.0,-52.0,-48.0,-44.0,-47.0,-51.0,-48.0,-43.0,-46.0,-89.0,-91.0,-87.0,-90.0,37.0,43.0,43.0,43.0,1
562,CC:2F:71:3F:1F:24,4505532,1202915595,674194,719698474,3831338,483217121,37,546587,570477137,545902,570394735,685,82402,528507,15,674442,73157,34,467,144444.0,43333.0,-71.0,-69.0,-68.0,-70.0,-70.0,-68.0,-67.0,-69.0,-89.0,-91.0,-87.0,-90.0,18.0,22.0,19.0,20.0,1
563,CC:2F:71:3E:C5:1F,3832173,483319148,833,101825,3831340,483217323,0,3473,291707,2866,219637,607,72070,880,8,1196,18,0,37,144444.0,39000.0,-72.0,-70.0,-67.0,-60.0,-71.0,-68.0,-66.0,-59.0,-89.0,-91.0,-87.0,-90.0,17.0,21.0,20.0,30.0,1
564,BA:8C:B9:54:50:24,3836141,489396256,4801,6178933,3831340,483217323,0,8730,1681273,8708,1677778,22,3495,2345,14,5215,38,0,56,229410.0,130000.0,-40.0,-37.0,-45.0,-51.0,-42.0,-35.0,-44.0,-48.0,-89.0,-91.0,-87.0,-90.0,49.0,54.0,42.0,39.0,1
565,92:69:1D:31:68:E9,3835174,486813443,3832,3595918,3831342,483217525,0,4509,1069939,4377,1040154,132,29785,2053,10,4007,84,0,41,216660.0,130000.0,-52.0,-48.0,-44.0,-47.0,-51.0,-48.0,-43.0,-46.0,-89.0,-91.0,-87.0,-90.0,37.0,43.0,43.0,43.0,1
566,CC:2F:71:3F:1F:24,4505583,1202933774,674241,719716249,3831342,483217525,37,546618,570482522,545933,570400120,685,82402,528537,15,674489,73197,34,467,144444.0,43333.0,-70.0,-69.0,-68.0,-70.0,-70.0,-68.0,-67.0,-69.0,-89.0,-91.0,-87.0,-90.0,19.0,22.0,19.0,20.0,1
567,CC:2F:71:3E:C5:1F,3832178,483319612,833,101825,3831345,483217787,0,3473,291707,2866,219637,607,72070,880,8,1196,18,0,37,144444.0,39000.0,-72.0,-70.0,-67.0,-60.0,-71.0,-68.0,-66.0,-59.0,-89.0,-91.0,-87.0,-90.0,17.0,21.0,20.0,30.0,1
568,BA:8C:B9:54:50:24,3836146,489396720,4801,6178933,3831345,483217787,0,8730,1681273,8708,1677778,22,3495,2345,14,5215,38,0,56,229410.0,130000.0,-40.0,-37.0,-45.0,-51.0,-42.0,-35.0,-44.0,-48.0,-89.0,-91.0,-87.0,-90.0,49.0,54.0,42.0,39.0,1
569,92:69:1D:31:68:E9,3835179,486813907,3832,3595918,3831347,483217989,0,4509,1069939,4377,1040154,132,29785,2053,10,4007,84,0,41,216660.0,130000.0,-52.0,-48.0,-44.0,-47.0,-51.0,-48.0,-43.0,-46.0,-89.0,-91.0,-87.0,-90.0,37.0,43.0,43.0,43.0,1
570,CC:2F:71:3F:1F:24,4505627,1202948412,674280,719730423,3831347,483217989,37,546639,570486256,545954,570403854,685,82402,528557,15,674528,73232,34,467,144444.0,43333.0,-70.0,-69.0,-68.0,-70.0,-70.0,-69.0,-68.0,-70.0,-89.0,-91.0,-87.0,-90.0,19.0,22.0,19.0,20.0,1
571,CC:2F:71:3E:C5:1F,3832182,483320016,833,101825,3831349,483218191,0,3473,291707,2866,219637,607,72070,880,8,1196,18,0,37,144444.0,39000.0,-72.0,-70.0,-67.0,-60.0,-71.0,-68.0,-66.0,-59.0,-89.0,-91.0,-87.0,-90.0,17.0,21.0,20.0,30.0,1
572,BA:8C:B9:54:50:24,3836150,489397124,4801,6178933,3831349,483218191,0,8730,1681273,8708,1677778,22,3495,2345,14,5215,38,0,56,229410.0,130000.0,-40.0,-37.0,-45.0,-51.0,-42.0,-35.0,-44.0,-48.0,-89.0,-91.0,-87.0,-90.0,49.0,54.0,42.0,39.0,1
573,92:69:1D:31:68:E9,3835184,486814373,3832,3595918,3831352,483218455,0,4509,1069939,4377,1040154,132,29785,2053,10,4007,84,0,41,216660.0,130000.0,-52.0,-48.0,-44.0,-47.0,-51.0,-48.0,-43.0,-46.0,-89.0,-91.0,-87.0,-90.0,37.0,43.0,43.0,43.0,1
574,CC:2F:71:3F:1F:24,4505670,1202962922,674318,719744467,3831352,483218455,37,546660,570489990,545975,570407588,685,82402,528577,15,674566,73270,34,467,144444.0,43333.0,-70.0,-69.0,-68.0,-70.0,-70.0,-69.0,-68.0,-70.0,-89.0,-91.0,-87.0,-90.0,19.0,22.0,19.0,20.0,1
575,CC:2F:71:3E:C5:1F,3832185,483320280,833,101825,3831352,483218455,0,3475,291895,2867,219707,608,72188,881,8,1196,18,0,37,144444.0,39000.0,-72.0,-70.0,-67.0,-60.0,-72.0,-69.0,-66.0,-59.0,-89.0,-91.0,-87.0,-90.0,17.0,21.0,20.0,30.0,1
576,BA:8C:B9:54:50:24,3836155,489397590,4801,6178933,3831354,483218657,0,8730,1681273,8708,1677778,22,3495,2345,14,5215,38,0,56,229410.0,130000.0,-40.0,-37.0,-45.0,-51.0,-42.0,-35.0,-44.0,-48.0,-89.0,-91.0,-87.0,-90.0,49.0,54.0,42.0,39.0,1
577,92:69:1D:31:68:E9,3835189,486814837,3832,3595918,3831357,483218919,0,4509,1069939,4377,1040154,132,29785,2053,10,4007,84,0,41,216660.0,130000.0,-52.0,-48.0,-44.0,-47.0,-51.0,-48.0,-43.0,-46.0,-89.0,-91.0,-87.0,-90.0,37.0,43.0,43.0,43.0,1
578,CC:2F:71:3F:1F:24,4505713,1202977430,674356,719758511,3831357,483218919,37,546684,570494072,545999,570411670,685,82402,528600,15,674604,73299,34,467,144444.0,43333.0,-70.0,-69.0,-68.0,-70.0,-70.0,-69.0,-67.0,-70.0,-89.0,-91.0,-87.0,-90.0,19.0,22.0,19.0,20.0,1
579,CC:2F:71:3E:C5:1F,3832192,483320946,833,101825,3831359,483219121,0,3475,291895,2867,219707,608,72188,881,8,1196,18,0,37,144444.0,39000.0,-72.0,-70.0,-67.0,-60.0,-72.0,-69.0,-66.0,-59.0,-89.0,-91.0,-87.0,-90.0,17.0,21.0,20.0,30.0,1
580,BA:8C:B9:54:50:24,3836161,489398116,4801,6178933,3831360,483219183,0,8730,1681273,8708,1677778,22,3495,2345,14,5215,38,0,56,229410.0,130000.0,-40.0,-37.0,-45.0,-51.0,-42.0,-35.0,-44.0,-48.0,-89.0,-91.0,-87.0,-90.0,49.0,54.0,42.0,39.0,1
581,92:69:1D:31:68:E9,3835194,486815303,3832,3595918,3831362,483219385,0,4509,1069939,4377,1040154,132,29785,2053,10,4007,84,0,41,216660.0,130000.0,-52.0,-48.0,-44.0,-47.0,-51.0,-48.0,-43.0,-46.0,-89.0,-91.0,-87.0,-89.0,37.0,43.0,43.0,42.0,1
582,CC:2F:71:3F:1F:24,4505765,1202995671,674403,719776286,3831362,483219385,37,546713,570499227,546027,570416707,686,82520,528628,15,674651,73331,34,467,144444.0,43333.0,-71.0,-69.0,-68.0,-70.0,-70.0,-69.0,-67.0,-69.0,-89.0,-91.0,-87.0,-89.0,18.0,22.0,19.0,19.0,1
583,CC:2F:71:3E:C5:1F,3832195,483321210,833,101825,3831362,483219385,0,3475,291895,2867,219707,608,72188,881,8,1196,18,0,37,144444.0,39000.0,-72.0,-70.0,-67.0,-60.0,-72.0,-69.0,-66.0,-59.0,-89.0,-91.0,-87.0,-89.0,17.0,21.0,20.0,29.0,1
584,BA:8C:B9:54:50:24,3836163,489398318,4801,6178933,3831362,483219385,0,8730,1681273,8708,1677778,22,3495,2345,14,5215,38,0,56,229410.0,130000.0,-40.0,-37.0,-45.0,-51.0,-42.0,-35.0,-44.0,-48.0,-89.0,-91.0,-87.0,-89.0,49.0,54.0,42.0,38.0,1
585,92:69:1D:31:68:E9,3835198,486815707,3832,3595918,3831366,483219789,0,4509,1069939,4377,1040154,132,29785,2053,10,4007,84,0,41,216660.0,130000.0,-52.0,-48.0,-44.0,-47.0,-51.0,-48.0,-43.0,-46.0,-89.0,-91.0,-87.0,-89.0,37.0,43.0,43.0,42.0,1
586,CC:2F:71:3F:1F:24,4505807,1203010119,674441,719790330,3831366,483219789,37,546738,570503425,546052,570420905,686,82520,528652,15,674689,73350,34,467,144444.0,43333.0,-70.0,-67.0,-69.0,-73.0,-72.0,-69.0,-70.0,-74.0,-89.0,-91.0,-87.0,-89.0,19.0,24.0,18.0,16.0,1
587,CC:2F:71:3E:C5:1F,3832201,483321816,833,101825,3831368,483219991,0,3475,291895,2867,219707,608,72188,881,8,1196,18,0,37,144444.0,39000.0,-72.0,-70.0,-67.0,-60.0,-72.0,-69.0,-66.0,-59.0,-89.0,-91.0,-87.0,-89.0,17.0,21.0,20.0,29.0,1
588,BA:8C:B9:54:50:24,3836170,489399197,4801,6178933,3831369,483220264,0,8734,1681545,8712,1678050,22,3495,2345,14,5215,38,0,56,229410.0,130000.0,-40.0,-37.0,-46.0,-51.0,-40.0,-36.0,-44.0,-50.0,-89.0,-91.0,-87.0,-89.0,49.0,54.0,41.0,38.0,1
589,92:69:1D:31:68:E9,3835204,486816444,3832,3595918,3831372,483220526,0,4509,1069939,4377,1040154,132,29785,2053,10,4007,84,0,41,216660.0,130000.0,-52.0,-48.0,-44.0,-47.0,-51.0,-48.0,-43.0,-46.0,-89.0,-91.0,-87.0,-89.0,37.0,43.0,43.0,42.0,1
590,CC:2F:71:3F:1F:24,4505853,1203025104,674481,719804578,3831372,483220526,37,546762,570507601,546076,570425081,686,82520,528674,15,674729,73374,34,467,130000.0,39000.0,-76.0,-71.0,-74.0,-75.0,-76.0,-70.0,-74.0,-75.0,-89.0,-91.0,-87.0,-89.0,13.0,20.0,13.0,14.0,1
591,CC:2F:71:3E:C5:1F,3832205,483322351,833,101825,3831372,483220526,0,3475,291895,2867,219707,608,72188,881,8,1196,18,0,37,144444.0,39000.0,-72.0,-70.0,-67.0,-60.0,-72.0,-69.0,-66.0,-59.0,-89.0,-91.0,-87.0,-89.0,17.0,21.0,20.0,29.0,1
592,BA:8C:B9:54:50:24,3836173,489399459,4801,6178933,3831372,483220526,0,8736,1681681,8714,1678186,22,3495,2345,14,5215,38,0,56,229410.0,130000.0,-40.0,-37.0,-46.0,-51.0,-41.0,-36.0,-45.0,-50.0,-89.0,-91.0,-87.0,-89.0,49.0,54.0,41.0,38.0,1
593,92:69:1D:31:68:E9,3835208,486816848,3832,3595918,3831376,483220930,0,4509,1069939,4377,1040154,132,29785,2053,10,4007,84,0,41,216660.0,130000.0,-52.0,-48.0,-44.0,-47.0,-51.0,-48.0,-43.0,-46.0,-89.0,-91.0,-87.0,-89.0,37.0,43.0,43.0,42.0,1
594,CC:2F:71:3F:1F:24,4505896,1203039514,674520,719818584,3831376,483220930,37,546784,570511451,546098,570428931,686,82520,528695,15,674768,73408,34,467,144444.0,39000.0,-71.0,-68.0,-71.0,-73.0,-74.0,-71.0,-73.0,-75.0,-89.0,-91.0,-87.0,-89.0,18.0,23.0,16.0,16.0,1
595,CC:2F:71:3E:C5:1F,3832211,483322957,833,101825,3831378,483221132,0,3475,291895,2867,219707,608,72188,881,8,1196,18,0,37,144444.0,39000.0,-72.0,-70.0,-67.0,-60.0,-72.0,-69.0,-66.0,-59.0,-89.0,-91.0,-87.0,-89.0,17.0,21.0,20.0,29.0,1
596,BA:8C:B9:54:50:24,3836179,489400065,4801,6178933,3831378,483221132,0,8736,1681681,8714,1678186,22,3495,2345,14,5215,38,0,56,229410.0,130000.0,-40.0,-37.0,-46.0,-51.0,-41.0,-36.0,-45.0,-50.0,-89.0,-91.0,-87.0,-89.0,49.0,54.0,41.0,38.0,1
597,92:69:1D:31:68:E9,3835212,486817252,3832,3595918,3831380,483221334,0,4509,1069939,4377,1040154,132,29785,2053,10,4007,84,0,41,216660.0,130000.0,-52.0,-48.0,-44.0,-47.0,-51.0,-48.0,-43.0,-46.0,-89.0,-90.0,-87.0,-90.0,37.0,42.0,43.0,43.0,1
598,CC:2F:71:3F:1F:24,4505948,1203059055,674567,719837661,3831381,483221394,37,546817,570517080,546131,570434560,686,82520,528727,15,674815,73439,34,467,130000.0,39000.0,-70.0,-68.0,-68.0,-70.0,-69.0,-68.0,-68.0,-70.0,-89.0,-90.0,-87.0,-90.0,19.0,22.0,19.0,20.0,1
599,CC:2F:71:3E:C5:1F,3832214,483323219,833,101825,3831381,483221394,0,3475,291895,2867,219707,608,72188,881,8,1196,18,0,37,144444.0,39000.0,-72.0,-70.0,-67.0,-60.0,-72.0,-69.0,-66.0,-59.0,-89.0,-90.0,-87.0,-90.0,17.0,20.0,20.0,30.0,1
600,BA:8C:B9:54:50:24,3836182,489400327,4801,6178933,3831381,483221394,0,8736,1681681,8714,1678186,22,3495,2345,14,5215,38,0,56,229410.0,130000.0,-40.0,-37.0,-46.0,-51.0,-41.0,-36.0,-45.0,-50.0,-89.0,-90.0,-87.0,-90.0,49.0,53.0,41.0,39.0,1
601,92:69:1D:31:68:E9,3835217,486817716,3832,3595918,3831385,483221798,0,4509,1069939,4377,1040154,132,29785,2053,10,4007,84,0,41,216660.0,130000.0,-52.0,-48.0,-44.0,-47.0,-51.0,-48.0,-43.0,-46.0,-89.0,-90.0,-87.0,-90.0,37.0,42.0,43.0,43.0,1
602,CC:2F:71:3F:1F:24,4505996,1203074115,674611,719852317,3831385,483221798,37,546847,570521922,546161,570439402,686,82520,528754,15,674859,73462,34,467,130000.0,39000.0,-70.0,-69.0,-68.0,-70.0,-70.0,-69.0,-68.0,-70.0,-89.0,-90.0,-87.0,-90.0,19.0,21.0,19.0,20.0,1
603,CC:2F:71:3E:C5:1F,3832218,483323623,833,101825,3831385,483221798,0,3475,291895,2867,219707,608,72188,881,8,1196,18,0,37,144444.0,39000.0,-72.0,-70.0,-67.0,-60.0,-72.0,-69.0,-66.0,-59.0,-89.0,-90.0,-87.0,-90.0,17.0,20.0,20.0,30.0,1
604,BA:8C:B9:54:50:24,3836188,489400933,4801,6178933,3831387,483222000,0,8736,1681681,8714,1678186,22,3495,2345,14,5215,38,0,56,229410.0,130000.0,-40.0,-37.0,-46.0,-51.0,-41.0,-36.0,-45.0,-50.0,-89.0,-90.0,-87.0,-90.0,49.0,53.0,41.0,39.0,1
605,92:69:1D:31:68:E9,3835221,486818120,3832,3595918,3831389,483222202,0,4509,1069939,4377,1040154,132,29785,2053,10,4007,84,0,41,216660.0,130000.0,-52.0,-48.0,-44.0,-47.0,-51.0,-48.0,-43.0,-46.0,-89.0,-90.0,-87.0,-90.0,37.0,42.0,43.0,43.0,1
606,CC:2F:71:3F:1F:24,4506040,1203088711,674651,719866509,3831389,483222202,37,546871,570526004,546185,570443484,686,82520,528777,15,674899,73482,34,467,144444.0,43333.0,-69.0,-68.0,-68.0,-69.0,-73.0,-72.0,-72.0,-73.0,-89.0,-90.0,-87.0,-90.0,20.0,22.0,19.0,21.0,1
607,CC:2F:71:3E:C5:1F,3832222,483324027,833,101825,3831389,483222202,0,3475,291895,2867,219707,608,72188,881,8,1196,18,0,37,144444.0,39000.0,-72.0,-70.0,-67.0,-60.0,-72.0,-69.0,-66.0,-59.0,-89.0,-90.0,-87.0,-90.0,17.0,20.0,20.0,30.0,1
608,BA:8C:B9:54:50:24,3836190,489401135,4801,6178933,3831389,483222202,0,8736,1681681,8714,1678186,22,3495,2345,14,5215,38,0,56,229410.0,130000.0,-40.0,-37.0,-46.0,-51.0,-41.0,-36.0,-45.0,-50.0,-89.0,-90.0,-87.0,-90.0,49.0,53.0,41.0,39.0,1
609,92:69:1D:31:68:E9,3835226,486818584,3832,3595918,3831394,483222666,0,4509,1069939,4377,1040154,132,29785,2053,10,4007,84,0,41,216660.0,130000.0,-52.0,-48.0,-44.0,-47.0,-51.0,-48.0,-43.0,-46.0,-89.0,-90.0,-87.0,-90.0,37.0,42.0,43.0,43.0,1
610,CC:2F:71:3F:1F:24,4506084,1203103349,674690,719880683,3831394,483222666,37,546893,570529854,546207,570447334,686,82520,528798,15,674938,73514,34,467,144444.0,43333.0,-69.0,-68.0,-67.0,-69.0,-68.0,-67.0,-67.0,-69.0,-89.0,-90.0,-87.0,-90.0,20.0,22.0,20.0,21.0,1
611,CC:2F:71:3E:C5:1F,3832227,483324491,833,101825,3831394,483222666,0,3475,291895,2867,219707,608,72188,881,8,1196,18,0,37,144444.0,39000.0,-72.0,-70.0,-67.0,-60.0,-72.0,-69.0,-66.0,-59.0,-89.0,-90.0,-87.0,-90.0,17.0,20.0,20.0,30.0,1
612,BA:8C:B9:54:50:24,3836195,489401599,4801,6178933,3831394,483222666,0,8736,1681681,8714,1678186,22,3495,2345,14,5215,38,0,56,229410.0,130000.0,-40.0,-37.0,-46.0,-51.0,-41.0,-36.0,-45.0,-50.0,-89.0,-90.0,-87.0,-90.0,49.0,53.0,41.0,39.0,1
613,92:69:1D:31:68:E9,3835228,486818786,3832,3595918,3831396,483222868,0,4509,1069939,4377,1040154,132,29785,2053,10,4007,84,0,41,216660.0,130000.0,-52.0,-48.0,-44.0,-47.0,-51.0,-48.0,-43.0,-46.0,-89.0,-91.0,-87.0,-90.0,37.0,43.0,43.0,43.0,1
614,CC:2F:71:3F:1F:24,4506138,1203121862,674740,719898792,3831398,483223070,37,546926,570535471,546240,570452951,686,82520,528830,15,674988,73545,34,467,130000.0,39000.0,-69.0,-67.0,-67.0,-69.0,-69.0,-67.0,-67.0,-69.0,-89.0,-91.0,-87.0,-90.0,20.0,24.0,20.0,21.0,1
615,CC:2F:71:3E:C5:1F,3832231,483324895,833,101825,3831398,483223070,0,3475,291895,2867,219707,608,72188,881,8,1196,18,0,37,144444.0,39000.0,-72.0,-70.0,-67.0,-60.0,-72.0,-69.0,-66.0,-59.0,-89.0,-91.0,-87.0,-90.0,17.0,21.0,20.0,30.0,1
616,BA:8C:B9:54:50:24,3836199,489402003,4801,6178933,3831398,483223070,0,8736,1681681,8714,1678186,22,3495,2345,14,5215,38,0,56,229410.0,130000.0,-40.0,-37.0,-46.0,-51.0,-41.0,-36.0,-45.0,-50.0,-89.0,-91.0,-87.0,-90.0,49.0,54.0,41.0,39.0,1
617,92:69:1D:31:68:E9,3835234,486819392,3832,3595918,3831402,483223474,0,4509,1069939,4377,1040154,132,29785,2053,10,4007,84,0,41,216660.0,130000.0,-52.0,-48.0,-44.0,-47.0,-51.0,-48.0,-43.0,-46.0,-89.0,-91.0,-87.0,-90.0,37.0,43.0,43.0,43.0,1
618,CC:2F:71:3F:1F:24,4506179,1203136068,674777,719912594,3831402,483223474,37,546949,570539437,546263,570456917,686,82520,528852,15,675025,73566,34,467,144444.0,43333.0,-69.0,-68.0,-68.0,-69.0,-69.0,-67.0,-67.0,-69.0,-89.0,-91.0,-87.0,-90.0,20.0,23.0,19.0,21.0,1
619,CC:2F:71:3E:C5:1F,3832235,483325299,833,101825,3831402,483223474,0,3475,291895,2867,219707,608,72188,881,8,1196,18,0,37,144444.0,39000.0,-72.0,-70.0,-67.0,-60.0,-72.0,-69.0,-66.0,-59.0,-89.0,-91.0,-87.0,-90.0,17.0,21.0,20.0,30.0,1
620,BA:8C:B9:54:50:24,3836203,489402407,4801,6178933,3831402,483223474,0,8736,1681681,8714,1678186,22,3495,2345,14,5215,38,0,56,229410.0,130000.0,-40.0,-37.0,-46.0,-51.0,-41.0,-36.0,-45.0,-50.0,-89.0,-91.0,-87.0,-90.0,49.0,54.0,41.0,39.0,1
621,92:69:1D:31:68:E9,3835237,486819654,3832,3595918,3831405,483223736,0,4509,1069939,4377,1040154,132,29785,2053,10,4007,84,0,41,216660.0,130000.0,-52.0,-48.0,-44.0,-47.0,-51.0,-48.0,-43.0,-46.0,-89.0,-91.0,-87.0,-90.0,37.0,43.0,43.0,43.0,1
622,CC:2F:71:3F:1F:24,4506223,1203150706,674816,719926768,3831407,483223938,37,546971,570543287,546285,570460767,686,82520,528873,15,675064,73595,34,467,144444.0,43333.0,-69.0,-68.0,-68.0,-69.0,-69.0,-67.0,-67.0,-69.0,-89.0,-91.0,-87.0,-90.0,20.0,23.0,19.0,21.0,1
623,CC:2F:71:3E:C5:1F,3832240,483325763,833,101825,3831407,483223938,0,3475,291895,2867,219707,608,72188,881,8,1196,18,0,37,144444.0,39000.0,-72.0,-70.0,-67.0,-60.0,-72.0,-69.0,-66.0,-59.0,-89.0,-91.0,-87.0,-90.0,17.0,21.0,20.0,30.0,1
624,BA:8C:B9:54:50:24,3836208,489402871,4801,6178933,3831407,483223938,0,8736,1681681,8714,1678186,22,3495,2345,14,5215,38,0,56,229410.0,130000.0,-40.0,-37.0,-46.0,-51.0,-41.0,-36.0,-45.0,-50.0,-89.0,-91.0,-87.0,-90.0,49.0,54.0,41.0,39.0,1
625,92:69:1D:31:68:E9,3835243,486820260,3832,3595918,3831411,483224342,0,4509,1069939,4377,1040154,132,29785,2053,10,4007,84,0,41,216660.0,130000.0,-52.0,-48.0,-44.0,-47.0,-51.0,-48.0,-43.0,-46.0,-89.0,-91.0,-87.0,-90.0,37.0,43.0,43.0,43.0,1
626,CC:2F:71:3F:1F:24,4506267,1203165414,674856,719941072,3831411,483224342,37,546993,570547137,546307,570464617,686,82520,528894,15,675104,73634,34,467,144444.0,43333.0,-70.0,-69.0,-68.0,-70.0,-70.0,-68.0,-67.0,-69.0,-89.0,-91.0,-87.0,-90.0,19.0,22.0,19.0,20.0,1
627,CC:2F:71:3E:C5:1F,3832244,483326167,833,101825,3831411,483224342,0,3475,291895,2867,219707,608,72188,881,8,1196,18,0,37,144444.0,39000.0,-72.0,-70.0,-67.0,-60.0,-72.0,-69.0,-66.0,-59.0,-89.0,-91.0,-87.0,-90.0,17.0,21.0,20.0,30.0,1
628,BA:8C:B9:54:50:24,3836212,489403275,4801,6178933,3831411,483224342,0,8736,1681681,8714,1678186,22,3495,2345,14,5215,38,0,56,229410.0,130000.0,-40.0,-37.0,-46.0,-51.0,-41.0,-36.0,-45.0,-50.0,-89.0,-91.0,-87.0,-90.0,49.0,54.0,41.0,39.0,1
629,92:69:1D:31:68:E9,3835245,486820462,3832,3595918,3831413,483224544,0,4509,1069939,4377,1040154,132,29785,2053,10,4007,84,0,41,216660.0,130000.0,-52.0,-48.0,-44.0,-47.0,-51.0,-48.0,-43.0,-46.0,-89.0,-91.0,-87.0,-90.0,37.0,43.0,43.0,43.0,1
630,CC:2F:71:3F:1F:24,4506317,1203183393,674901,719958587,3831416,483224806,37,547022,570552290,546336,570469770,686,82520,528922,15,675149,73679,34,467,144444.0,43333.0,-70.0,-69.0,-68.0,-70.0,-73.0,-72.0,-71.0,-73.0,-89.0,-91.0,-87.0,-90.0,19.0,22.0,19.0,20.0,1
631,CC:2F:71:3E:C5:1F,3832249,483326631,833,101825,3831416,483224806,0,3475,291895,2867,219707,608,72188,881,8,1196,18,0,37,144444.0,39000.0,-72.0,-70.0,-67.0,-60.0,-72.0,-69.0,-66.0,-59.0,-89.0,-91.0,-87.0,-90.0,17.0,21.0,20.0,30.0,1
632,BA:8C:B9:54:50:24,3836217,489403739,4801,6178933,3831416,483224806,0,8736,1681681,8714,1678186,22,3495,2345,14,5215,38,0,56,229410.0,130000.0,-40.0,-37.0,-46.0,-51.0,-41.0,-36.0,-45.0,-50.0,-89.0,-91.0,-87.0,-90.0,49.0,54.0,41.0,39.0,1
633,92:69:1D:31:68:E9,3835253,486821244,3833,3596034,3831420,483225210,0,4510,1070007,4378,1040222,132,29785,2053,10,4008,84,0,41,216660.0,130000.0,-52.0,-46.0,-42.0,-49.0,-51.0,-47.0,-43.0,-47.0,-89.0,-91.0,-87.0,-90.0,37.0,45.0,45.0,41.0,1
634,CC:2F:71:3F:1F:24,4506361,1203198087,674941,719972877,3831420,483225210,37,547044,570556282,546358,570473762,686,82520,528942,15,675189,73721,34,467,144444.0,43333.0,-69.0,-68.0,-68.0,-69.0,-69.0,-68.0,-67.0,-69.0,-89.0,-91.0,-87.0,-90.0,20.0,23.0,19.0,21.0,1
635,CC:2F:71:3E:C5:1F,3832254,483327151,834,101941,3831420,483225210,0,3477,292035,2869,219847,608,72188,881,8,1197,18,0,37,144444.0,39000.0,-72.0,-70.0,-67.0,-60.0,-72.0,-69.0,-67.0,-60.0,-89.0,-91.0,-87.0,-90.0,17.0,21.0,20.0,30.0,1
636,BA:8C:B9:54:50:24,3836222,489404259,4802,6179049,3831420,483225210,0,8742,1682089,8720,1678594,22,3495,2345,14,5216,38,0,56,229410.0,130000.0,-48.0,-35.0,-43.0,-45.0,-41.0,-35.0,-44.0,-47.0,-89.0,-91.0,-87.0,-90.0,41.0,56.0,44.0,45.0,1
637,92:69:1D:31:68:E9,3835255,486821446,3833,3596034,3831422,483225412,0,4511,1070075,4379,1040290,132,29785,2053,10,4008,84,0,41,216660.0,130000.0,-50.0,-46.0,-42.0,-48.0,-51.0,-47.0,-43.0,-47.0,-89.0,-91.0,-87.0,-90.0,39.0,45.0,45.0,42.0,1
638,CC:2F:71:3F:1F:24,4506405,1203212683,674981,719987069,3831424,483225614,37,547065,570560016,546379,570477496,686,82520,528962,15,675229,73776,34,467,104000.0,26000.0,-72.0,-68.0,-69.0,-71.0,-72.0,-68.0,-68.0,-70.0,-89.0,-91.0,-87.0,-90.0,17.0,23.0,18.0,19.0,1
639,CC:2F:71:3E:C5:1F,3832258,483327555,834,101941,3831424,483225614,0,3477,292035,2869,219847,608,72188,881,8,1197,18,0,37,144444.0,39000.0,-72.0,-70.0,-67.0,-60.0,-72.0,-69.0,-67.0,-60.0,-89.0,-91.0,-87.0,-90.0,17.0,21.0,20.0,30.0,1
640,BA:8C:B9:54:50:24,3836226,489404663,4802,6179049,3831424,483225614,0,8742,1682089,8720,1678594,22,3495,2345,14,5216,38,0,56,229410.0,130000.0,-48.0,-35.0,-43.0,-45.0,-41.0,-35.0,-44.0,-47.0,-89.0,-91.0,-87.0,-90.0,41.0,56.0,44.0,45.0,1
641,92:69:1D:31:68:E9,3835263,486822385,3833,3596034,3831430,483226351,0,4511,1070075,4379,1040290,132,29785,2053,10,4008,84,0,41,216660.0,130000.0,-50.0,-46.0,-42.0,-48.0,-51.0,-47.0,-43.0,-47.0,-89.0,-91.0,-87.0,-90.0,39.0,45.0,45.0,42.0,1
642,CC:2F:71:3F:1F:24,4506459,1203230522,675021,720001261,3831438,483229261,37,547087,570563866,546401,570481346,686,82520,528983,15,675269,73789,34,467,115556.0,26000.0,-72.0,-67.0,-69.0,-73.0,-71.0,-67.0,-68.0,-71.0,-89.0,-91.0,-87.0,-90.0,17.0,24.0,18.0,17.0,1
643,CC:2F:71:3E:C5:1F,3832272,483331202,834,101941,3831438,483229261,0,3477,292035,2869,219847,608,72188,881,8,1197,18,0,37,144444.0,39000.0,-72.0,-70.0,-67.0,-60.0,-72.0,-69.0,-67.0,-60.0,-89.0,-91.0,-87.0,-90.0,17.0,21.0,20.0,30.0,1
644,BA:8C:B9:54:50:24,3836240,489408310,4802,6179049,3831438,483229261,0,8742,1682089,8720,1678594,22,3495,2345,14,5216,38,0,56,229410.0,130000.0,-48.0,-35.0,-43.0,-45.0,-41.0,-35.0,-44.0,-47.0,-89.0,-91.0,-87.0,-90.0,41.0,56.0,44.0,45.0,1
645,92:69:1D:31:68:E9,3835273,486825497,3833,3596034,3831440,483229463,0,4511,1070075,4379,1040290,132,29785,2053,10,4008,84,0,41,216660.0,130000.0,-50.0,-46.0,-42.0,-48.0,-51.0,-47.0,-43.0,-47.0,-89.0,-91.0,-87.0,-90.0,39.0,45.0,45.0,42.0,1
646,CC:2F:71:3F:1F:24,4506512,1203248905,675070,720019240,3831442,483229665,37,547119,570569321,546433,570486801,686,82520,529013,15,675318,73794,34,467,115556.0,28889.0,-68.0,-68.0,-70.0,-71.0,-68.0,-68.0,-70.0,-71.0,-89.0,-91.0,-87.0,-90.0,21.0,23.0,17.0,19.0,1
647,CC:2F:71:3E:C5:1F,3832276,483331606,834,101941,3831442,483229665,0,3477,292035,2869,219847,608,72188,881,8,1197,18,0,37,144444.0,39000.0,-72.0,-70.0,-67.0,-60.0,-72.0,-69.0,-67.0,-60.0,-89.0,-91.0,-87.0,-90.0,17.0,21.0,20.0,30.0,1
648,BA:8C:B9:54:50:24,3836244,489408714,4802,6179049,3831442,483229665,0,8742,1682089,8720,1678594,22,3495,2345,14,5216,38,0,56,229410.0,130000.0,-48.0,-35.0,-43.0,-45.0,-41.0,-35.0,-44.0,-47.0,-89.0,-91.0,-87.0,-90.0,41.0,56.0,44.0,45.0,1
649,92:69:1D:31:68:E9,3835279,486826103,3833,3596034,3831446,483230069,0,4511,1070075,4379,1040290,132,29785,2053,10,4008,84,0,41,216660.0,130000.0,-50.0,-46.0,-42.0,-48.0,-51.0,-47.0,-43.0,-47.0,-89.0,-91.0,-87.0,-90.0,39.0,45.0,45.0,42.0,1
650,CC:2F:71:3F:1F:24,4506554,1203263297,675108,720033228,3831446,483230069,37,547141,570573171,546455,570490651,686,82520,529034,15,675356,73795,34,467,117000.0,39000.0,-71.0,-71.0,-74.0,-74.0,-70.0,-69.0,-72.0,-73.0,-89.0,-91.0,-87.0,-90.0,18.0,20.0,13.0,16.0,1
651,CC:2F:71:3E:C5:1F,3832280,483332010,834,101941,3831446,483230069,0,3477,292035,2869,219847,608,72188,881,8,1197,18,0,37,144444.0,39000.0,-72.0,-70.0,-67.0,-60.0,-72.0,-69.0,-67.0,-60.0,-89.0,-91.0,-87.0,-90.0,17.0,21.0,20.0,30.0,1
652,BA:8C:B9:54:50:24,3836248,489409118,4802,6179049,3831446,483230069,0,8742,1682089,8720,1678594,22,3495,2345,14,5216,38,0,56,229410.0,130000.0,-48.0,-35.0,-43.0,-45.0,-41.0,-35.0,-44.0,-47.0,-89.0,-91.0,-87.0,-90.0,41.0,56.0,44.0,45.0,1
653,92:69:1D:31:68:E9,3835282,486826365,3833,3596034,3831449,483230331,0,4511,1070075,4379,1040290,132,29785,2053,10,4008,84,0,41,216660.0,130000.0,-50.0,-46.0,-42.0,-48.0,-51.0,-47.0,-43.0,-47.0,-89.0,-91.0,-87.0,-90.0,39.0,45.0,45.0,42.0,1
654,CC:2F:71:3F:1F:24,4506603,1203278361,675152,720047828,3831451,483230533,37,547169,570577671,546483,570495151,686,82520,529060,15,675400,73820,34,467,117000.0,39000.0,-73.0,-69.0,-73.0,-74.0,-73.0,-69.0,-72.0,-74.0,-89.0,-91.0,-87.0,-90.0,16.0,22.0,14.0,16.0,1
655,CC:2F:71:3E:C5:1F,3832285,483332474,834,101941,3831451,483230533,0,3477,292035,2869,219847,608,72188,881,8,1197,18,0,37,144444.0,39000.0,-72.0,-70.0,-67.0,-60.0,-72.0,-69.0,-67.0,-60.0,-89.0,-91.0,-87.0,-90.0,17.0,21.0,20.0,30.0,1
656,BA:8C:B9:54:50:24,3836253,489409582,4802,6179049,3831451,483230533,0,8742,1682089,8720,1678594,22,3495,2345,14,5216,38,0,56,229410.0,130000.0,-48.0,-35.0,-43.0,-45.0,-41.0,-35.0,-44.0,-47.0,-89.0,-91.0,-87.0,-90.0,41.0,56.0,44.0,45.0,1
657,92:69:1D:31:68:E9,3835288,486826971,3833,3596034,3831455,483230937,0,4511,1070075,4379,1040290,132,29785,2053,10,4008,84,0,41,216660.0,130000.0,-50.0,-46.0,-42.0,-48.0,-51.0,-47.0,-43.0,-47.0,-89.0,-91.0,-87.0,-90.0,39.0,45.0,45.0,42.0,1
658,CC:2F:71:3F:1F:24,4506650,1203293403,675195,720062466,3831455,483230937,37,547193,570581753,546507,570499233,686,82520,529083,15,675443,73831,34,467,130000.0,39000.0,-72.0,-70.0,-74.0,-73.0,-70.0,-68.0,-72.0,-71.0,-89.0,-91.0,-87.0,-90.0,17.0,21.0,13.0,17.0,1
659,CC:2F:71:3E:C5:1F,3832289,483332878,834,101941,3831455,483230937,0,3477,292035,2869,219847,608,72188,881,8,1197,18,0,37,144444.0,39000.0,-72.0,-70.0,-67.0,-60.0,-72.0,-69.0,-67.0,-60.0,-89.0,-91.0,-87.0,-90.0,17.0,21.0,20.0,30.0,1
660,BA:8C:B9:54:50:24,3836257,489409986,4802,6179049,3831455,483230937,0,8742,1682089,8720,1678594,22,3495,2345,14,5216,38,0,56,229410.0,130000.0,-48.0,-35.0,-43.0,-45.0,-41.0,-35.0,-44.0,-47.0,-89.0,-91.0,-87.0,-90.0,41.0,56.0,44.0,45.0,1
661,92:69:1D:31:68:E9,3835290,486827173,3833,3596034,3831457,483231139,0,4511,1070075,4379,1040290,132,29785,2053,10,4008,84,0,41,216660.0,130000.0,-50.0,-46.0,-42.0,-48.0,-51.0,-47.0,-43.0,-47.0,-89.0,-91.0,-87.0,-90.0,39.0,45.0,45.0,42.0,1
662,CC:2F:71:3F:1F:24,4506701,1203311584,675244,720080445,3831457,483231139,37,547225,570587207,546539,570504687,686,82520,529113,15,675492,73832,34,467,130000.0,43333.0,-70.0,-67.0,-70.0,-70.0,-70.0,-67.0,-70.0,-70.0,-89.0,-91.0,-87.0,-90.0,19.0,24.0,17.0,20.0,1
663,CC:2F:71:3E:C5:1F,3832294,483333342,834,101941,3831460,483231401,0,3477,292035,2869,219847,608,72188,881,8,1197,18,0,37,144444.0,39000.0,-72.0,-70.0,-67.0,-60.0,-72.0,-69.0,-67.0,-60.0,-89.0,-91.0,-87.0,-90.0,17.0,21.0,20.0,30.0,1
664,BA:8C:B9:54:50:24,3836262,489410450,4802,6179049,3831460,483231401,0,8742,1682089,8720,1678594,22,3495,2345,14,5216,38,0,56,229410.0,130000.0,-48.0,-35.0,-43.0,-45.0,-41.0,-35.0,-44.0,-47.0,-89.0,-91.0,-87.0,-90.0,41.0,56.0,44.0,45.0,1
665,92:69:1D:31:68:E9,3835295,486827637,3833,3596034,3831462,483231603,0,4513,1070211,4381,1040426,132,29785,2053,10,4009,84,0,41,216660.0,130000.0,-52.0,-48.0,-44.0,-46.0,-51.0,-47.0,-43.0,-47.0,-89.0,-91.0,-87.0,-90.0,37.0,43.0,43.0,44.0,1
666,CC:2F:71:3F:1F:24,4506750,1203326816,675288,720095213,3831462,483231603,37,547252,570591637,546566,570509117,686,82520,529139,15,675536,73841,34,467,130000.0,39000.0,-70.0,-67.0,-71.0,-70.0,-70.0,-67.0,-70.0,-70.0,-89.0,-91.0,-87.0,-90.0,19.0,24.0,16.0,20.0,1
667,CC:2F:71:3E:C5:1F,3832298,483333746,834,101941,3831464,483231805,0,3479,292175,2871,219987,608,72188,881,8,1198,18,0,37,144444.0,39000.0,-73.0,-71.0,-67.0,-60.0,-72.0,-70.0,-67.0,-60.0,-89.0,-91.0,-87.0,-90.0,16.0,20.0,20.0,30.0,1
668,BA:8C:B9:54:50:24,3836266,489410854,4802,6179049,3831464,483231805,0,8744,1682225,8722,1678730,22,3495,2345,14,5217,38,0,56,229410.0,130000.0,-40.0,-37.0,-45.0,-51.0,-41.0,-35.0,-43.0,-47.0,-89.0,-91.0,-87.0,-90.0,49.0,54.0,42.0,39.0,1
669,92:69:1D:31:68:E9,3835299,486828041,3833,3596034,3831466,483232007,0,4513,1070211,4381,1040426,132,29785,2053,10,4009,84,0,41,216660.0,130000.0,-52.0,-48.0,-44.0,-46.0,-51.0,-47.0,-43.0,-47.0,-89.0,-91.0,-87.0,-90.0,37.0,43.0,43.0,44.0,1
670,CC:2F:71:3F:1F:24,4506800,1203342136,675334,720110129,3831466,483232007,37,547288,570597111,546602,570514591,686,82520,529174,15,675582,73863,34,467,130000.0,43333.0,-70.0,-67.0,-71.0,-70.0,-70.0,-67.0,-70.0,-70.0,-89.0,-91.0,-87.0,-90.0,19.0,24.0,16.0,20.0,1
671,CC:2F:71:3E:C5:1F,3832302,483334150,834,101941,3831468,483232209,0,3479,292175,2871,219987,608,72188,881,8,1198,18,0,37,144444.0,39000.0,-73.0,-71.0,-67.0,-60.0,-72.0,-70.0,-67.0,-60.0,-89.0,-91.0,-87.0,-90.0,16.0,20.0,20.0,30.0,1
672,BA:8C:B9:54:50:24,3836270,489411258,4802,6179049,3831468,483232209,0,8744,1682225,8722,1678730,22,3495,2345,14,5217,38,0,56,229410.0,130000.0,-40.0,-37.0,-45.0,-51.0,-41.0,-35.0,-43.0,-47.0,-89.0,-91.0,-87.0,-90.0,49.0,54.0,42.0,39.0,1
673,92:69:1D:31:68:E9,3835305,486828567,3833,3596034,3831472,483232533,0,4514,1070279,4382,1040494,132,29785,2053,10,4009,84,0,41,216660.0,130000.0,-52.0,-48.0,-44.0,-46.0,-51.0,-47.0,-43.0,-47.0,-89.0,-91.0,-87.0,-90.0,37.0,43.0,43.0,44.0,1
674,CC:2F:71:3F:1F:24,4506847,1203357096,675375,720124563,3831472,483232533,37,547315,570601497,546628,570518859,687,82638,529199,15,675623,73863,34,467,130000.0,43333.0,-70.0,-67.0,-70.0,-70.0,-70.0,-67.0,-70.0,-70.0,-89.0,-91.0,-87.0,-90.0,19.0,24.0,17.0,20.0,1
675,CC:2F:71:3E:C5:1F,3832309,483334738,834,101941,3831475,483232797,0,3480,292293,2871,219987,609,72306,882,8,1198,18,0,37,144444.0,39000.0,-73.0,-71.0,-67.0,-60.0,-72.0,-70.0,-67.0,-60.0,-89.0,-91.0,-87.0,-90.0,16.0,20.0,20.0,30.0,1
676,BA:8C:B9:54:50:24,3836277,489411846,4802,6179049,3831475,483232797,0,8744,1682225,8722,1678730,22,3495,2345,14,5217,38,0,56,229410.0,130000.0,-40.0,-37.0,-45.0,-51.0,-41.0,-35.0,-43.0,-47.0,-89.0,-91.0,-87.0,-90.0,49.0,54.0,42.0,39.0,1
677,92:69:1D:31:68:E9,3835311,486829093,3833,3596034,3831478,483233059,0,4514,1070279,4382,1040494,132,29785,2053,10,4009,84,0,41,216660.0,130000.0,-52.0,-48.0,-44.0,-46.0,-51.0,-47.0,-43.0,-47.0,-89.0,-91.0,-87.0,-90.0,37.0,43.0,43.0,44.0,1
678,CC:2F:71:3F:1F:24,4506905,1203376059,675427,720143000,3831478,483233059,37,547355,570608049,546667,570525297,688,82752,529238,15,675675,73876,34,467,117000.0,39000.0,-70.0,-68.0,-70.0,-70.0,-70.0,-67.0,-70.0,-70.0,-89.0,-91.0,-87.0,-90.0,19.0,23.0,17.0,20.0,1
679,CC:2F:71:3E:C5:1F,3832314,483335202,834,101941,3831480,483233261,0,3481,292363,2872,220057,609,72306,882,8,1198,18,0,37,144444.0,39000.0,-73.0,-71.0,-67.0,-60.0,-72.0,-70.0,-67.0,-60.0,-89.0,-91.0,-87.0,-90.0,16.0,20.0,20.0,30.0,1
680,BA:8C:B9:54:50:24,3836282,489412310,4802,6179049,3831480,483233261,0,8744,1682225,8722,1678730,22,3495,2345,14,5217,38,0,56,229410.0,130000.0,-40.0,-37.0,-45.0,-51.0,-41.0,-35.0,-43.0,-47.0,-89.0,-91.0,-87.0,-90.0,49.0,54.0,42.0,39.0,1
681,92:69:1D:31:68:E9,3835318,486829783,3833,3596034,3831485,483233749,0,4514,1070279,4382,1040494,132,29785,2053,10,4009,84,0,41,216660.0,130000.0,-52.0,-48.0,-44.0,-46.0,-51.0,-47.0,-43.0,-47.0,-89.0,-91.0,-88.0,-90.0,37.0,43.0,44.0,44.0,1
682,CC:2F:71:3F:1F:24,4506963,1203392651,675478,720158902,3831485,483233749,37,547401,570615069,546710,570531863,691,83206,529283,15,675726,73878,34,467,130000.0,43333.0,-71.0,-68.0,-71.0,-70.0,-70.0,-67.0,-70.0,-70.0,-89.0,-91.0,-88.0,-90.0,18.0,23.0,17.0,20.0,1
683,CC:2F:71:3E:C5:1F,3832319,483335690,834,101941,3831485,483233749,0,3481,292363,2872,220057,609,72306,882,8,1198,18,0,37,144444.0,39000.0,-73.0,-71.0,-67.0,-60.0,-72.0,-70.0,-67.0,-60.0,-89.0,-91.0,-88.0,-90.0,16.0,20.0,21.0,30.0,1
684,BA:8C:B9:54:50:24,3836288,489412932,4802,6179049,3831486,483233883,0,8744,1682225,8722,1678730,22,3495,2345,14,5217,38,0,56,229410.0,130000.0,-40.0,-37.0,-45.0,-51.0,-41.0,-35.0,-43.0,-47.0,-89.0,-91.0,-88.0,-90.0,49.0,54.0,43.0,39.0,1
685,92:69:1D:31:68:E9,3835323,486830247,3833,3596034,3831490,483234213,0,4514,1070279,4382,1040494,132,29785,2053,10,4009,84,0,41,216660.0,130000.0,-52.0,-48.0,-44.0,-46.0,-51.0,-47.0,-43.0,-47.0,-89.0,-91.0,-88.0,-90.0,37.0,43.0,44.0,44.0,1
686,CC:2F:71:3F:1F:24,4507010,1203407757,675520,720173544,3831490,483234213,37,547427,570619461,546736,570536255,691,83206,529308,15,675768,73880,34,467,130000.0,43333.0,-71.0,-68.0,-71.0,-71.0,-70.0,-68.0,-70.0,-70.0,-89.0,-91.0,-88.0,-90.0,18.0,23.0,17.0,19.0,1
687,CC:2F:71:3E:C5:1F,3832326,483336356,834,101941,3831492,483234415,0,3481,292363,2872,220057,609,72306,882,8,1198,18,0,37,144444.0,39000.0,-73.0,-71.0,-67.0,-60.0,-72.0,-70.0,-67.0,-60.0,-89.0,-91.0,-88.0,-90.0,16.0,20.0,21.0,30.0,1
688,BA:8C:B9:54:50:24,3836306,489419063,4802,6179049,3831504,483240014,0,8744,1682225,8722,1678730,22,3495,2345,14,5217,38,0,56,229410.0,130000.0,-40.0,-37.0,-45.0,-51.0,-41.0,-35.0,-43.0,-47.0,-89.0,-91.0,-88.0,-90.0,49.0,54.0,43.0,39.0,1
689,92:69:1D:31:68:E9,3835350,486841674,3833,3596034,3831517,483245640,0,4517,1070650,4384,1040630,133,30020,2054,10,4009,84,0,41,216660.0,130000.0,-51.0,-48.0,-45.0,-46.0,-51.0,-47.0,-43.0,-47.0,-89.0,-91.0,-88.0,-90.0,38.0,43.0,43.0,44.0,1
690,CC:2F:71:3F:1F:24,4507075,1203433116,675558,720187476,3831517,483245640,37,547449,570623311,546758,570540105,691,83206,529329,15,675806,73895,34,467,144444.0,39000.0,-71.0,-68.0,-71.0,-71.0,-70.0,-67.0,-70.0,-70.0,-89.0,-91.0,-88.0,-90.0,18.0,23.0,17.0,19.0,1
691,CC:2F:71:3E:C5:1F,3832351,483347581,834,101941,3831517,483245640,0,3481,292363,2872,220057,609,72306,882,8,1198,18,0,37,144444.0,39000.0,-73.0,-71.0,-67.0,-60.0,-72.0,-70.0,-67.0,-60.0,-89.0,-91.0,-88.0,-90.0,16.0,20.0,21.0,30.0,1
692,BA:8C:B9:54:50:24,3836321,489424891,4802,6179049,3831519,483245842,0,8744,1682225,8722,1678730,22,3495,2345,14,5217,38,0,56,229410.0,130000.0,-40.0,-37.0,-45.0,-51.0,-41.0,-35.0,-43.0,-47.0,-89.0,-91.0,-88.0,-90.0,49.0,54.0,43.0,39.0,1
693,92:69:1D:31:68:E9,3835355,486842351,3833,3596034,3831522,483246317,0,4517,1070650,4384,1040630,133,30020,2054,10,4009,84,0,41,216660.0,130000.0,-51.0,-48.0,-45.0,-46.0,-51.0,-47.0,-43.0,-47.0,-90.0,-91.0,-88.0,-90.0,39.0,43.0,43.0,44.0,1
694,CC:2F:71:3F:1F:24,4507129,1203451627,675604,720205048,3831525,483246579,37,547479,570628619,546788,570545413,691,83206,529358,15,675852,73914,34,467,130000.0,43333.0,-76.0,-74.0,-76.0,-76.0,-75.0,-72.0,-74.0,-74.0,-90.0,-91.0,-88.0,-90.0,14.0,17.0,12.0,14.0,1
695,CC:2F:71:3E:C5:1F,3832359,483348520,834,101941,3831525,483246579,0,3481,292363,2872,220057,609,72306,882,8,1198,18,0,37,144444.0,39000.0,-73.0,-71.0,-67.0,-60.0,-72.0,-70.0,-67.0,-60.0,-90.0,-91.0,-88.0,-90.0,17.0,20.0,21.0,30.0,1
696,BA:8C:B9:54:50:24,3836327,489425628,4802,6179049,3831525,483246579,0,8744,1682225,8722,1678730,22,3495,2345,14,5217,38,0,56,229410.0,130000.0,-40.0,-37.0,-45.0,-51.0,-41.0,-35.0,-43.0,-47.0,-90.0,-91.0,-88.0,-90.0,50.0,54.0,43.0,39.0,1
697,92:69:1D:31:68:E9,3835360,486842815,3833,3596034,3831527,483246781,0,4517,1070650,4384,1040630,133,30020,2054,10,4009,84,0,41,216660.0,130000.0,-51.0,-48.0,-45.0,-46.0,-51.0,-47.0,-43.0,-47.0,-90.0,-91.0,-88.0,-90.0,39.0,43.0,43.0,44.0,1
698,CC:2F:71:3F:1F:24,4507169,1203465873,675642,720219092,3831527,483246781,37,547501,570632469,546810,570549263,691,83206,529379,15,675890,73919,34,467,130000.0,43333.0,-70.0,-68.0,-70.0,-70.0,-70.0,-67.0,-70.0,-70.0,-90.0,-91.0,-88.0,-90.0,20.0,23.0,18.0,20.0,1
699,CC:2F:71:3E:C5:1F,3832361,483348722,834,101941,3831527,483246781,0,3481,292363,2872,220057,609,72306,882,8,1198,18,0,37,144444.0,39000.0,-73.0,-71.0,-67.0,-60.0,-72.0,-70.0,-67.0,-60.0,-90.0,-91.0,-88.0,-90.0,17.0,20.0,21.0,30.0,1
700,BA:8C:B9:54:50:24,3836331,489426032,4802,6179049,3831529,483246983,0,8744,1682225,8722,1678730,22,3495,2345,14,5217,38,0,56,229410.0,130000.0,-40.0,-37.0,-45.0,-51.0,-41.0,-35.0,-43.0,-47.0,-90.0,-91.0,-88.0,-90.0,50.0,54.0,43.0,39.0,1
701,92:69:1D:31:68:E9,3835364,486843219,3833,3596034,3831531,483247185,0,4517,1070650,4384,1040630,133,30020,2054,10,4009,84,0,41,216660.0,130000.0,-51.0,-48.0,-45.0,-46.0,-51.0,-47.0,-43.0,-47.0,-90.0,-91.0,-88.0,-90.0,39.0,43.0,43.0,44.0,1
702,CC:2F:71:3F:1F:24,4507215,1203480727,675682,720233340,3831533,483247387,37,547524,570636435,546833,570553229,691,83206,529401,15,675930,73919,34,467,130000.0,39000.0,-70.0,-68.0,-70.0,-70.0,-70.0,-68.0,-70.0,-70.0,-90.0,-91.0,-88.0,-90.0,20.0,23.0,18.0,20.0,1
703,CC:2F:71:3E:C5:1F,3832367,483349328,834,101941,3831533,483247387,0,3481,292363,2872,220057,609,72306,882,8,1198,18,0,37,144444.0,39000.0,-73.0,-71.0,-67.0,-60.0,-72.0,-70.0,-67.0,-60.0,-90.0,-91.0,-88.0,-90.0,17.0,20.0,21.0,30.0,1
704,BA:8C:B9:54:50:24,3836335,489426436,4802,6179049,3831533,483247387,0,8744,1682225,8722,1678730,22,3495,2345,14,5217,38,0,56,229410.0,130000.0,-40.0,-37.0,-45.0,-51.0,-41.0,-35.0,-43.0,-47.0,-90.0,-91.0,-88.0,-90.0,50.0,54.0,43.0,39.0,1
705,92:69:1D:31:68:E9,3835369,486843683,3833,3596034,3831536,483247649,0,4517,1070650,4384,1040630,133,30020,2054,10,4009,84,0,41,216660.0,130000.0,-51.0,-48.0,-45.0,-46.0,-51.0,-47.0,-43.0,-47.0,-90.0,-91.0,-88.0,-90.0,39.0,43.0,43.0,44.0,1
706,CC:2F:71:3F:1F:24,4507258,1203495345,675720,720247328,3831538,483248017,37,547545,570640169,546854,570556963,691,83206,529421,15,675968,73936,34,467,117000.0,39000.0,-71.0,-68.0,-70.0,-70.0,-70.0,-68.0,-70.0,-70.0,-90.0,-91.0,-88.0,-90.0,19.0,23.0,18.0,20.0,1
707,CC:2F:71:3E:C5:1F,3832372,483349958,834,101941,3831538,483248017,0,3481,292363,2872,220057,609,72306,882,8,1198,18,0,37,144444.0,39000.0,-73.0,-71.0,-67.0,-60.0,-72.0,-70.0,-67.0,-60.0,-90.0,-91.0,-88.0,-90.0,17.0,20.0,21.0,30.0,1
708,BA:8C:B9:54:50:24,3836342,489427268,4802,6179049,3831540,483248219,0,8744,1682225,8722,1678730,22,3495,2345,14,5217,38,0,56,229410.0,130000.0,-40.0,-37.0,-45.0,-51.0,-41.0,-35.0,-43.0,-47.0,-90.0,-91.0,-88.0,-90.0,50.0,54.0,43.0,39.0,1
709,92:69:1D:31:68:E9,3835375,486844455,3833,3596034,3831542,483248421,0,4517,1070650,4384,1040630,133,30020,2054,10,4009,84,0,41,216660.0,130000.0,-51.0,-48.0,-45.0,-46.0,-51.0,-47.0,-43.0,-47.0,-90.0,-91.0,-88.0,-90.0,39.0,43.0,43.0,44.0,1
710,CC:2F:71:3F:1F:24,4507310,1203513548,675768,720265127,3831542,483248421,37,547577,570645810,546886,570562604,691,83206,529451,15,676016,73947,34,467,130000.0,39000.0,-70.0,-68.0,-70.0,-70.0,-70.0,-67.0,-70.0,-70.0,-90.0,-91.0,-88.0,-90.0,20.0,23.0,18.0,20.0,1
711,CC:2F:71:3E:C5:1F,3832378,483350564,834,101941,3831544,483248623,0,3481,292363,2872,220057,609,72306,882,8,1198,18,0,37,144444.0,39000.0,-73.0,-71.0,-67.0,-60.0,-72.0,-70.0,-67.0,-60.0,-90.0,-91.0,-88.0,-90.0,17.0,20.0,21.0,30.0,1
712,BA:8C:B9:54:50:24,3836346,489427672,4802,6179049,3831544,483248623,0,8744,1682225,8722,1678730,22,3495,2345,14,5217,38,0,56,229410.0,130000.0,-40.0,-37.0,-45.0,-51.0,-41.0,-35.0,-43.0,-47.0,-90.0,-91.0,-88.0,-90.0,50.0,54.0,43.0,39.0,1
713,92:69:1D:31:68:E9,3835379,486844859,3833,3596034,3831546,483248825,0,4517,1070650,4384,1040630,133,30020,2054,10,4009,84,0,41,216660.0,130000.0,-51.0,-48.0,-45.0,-46.0,-51.0,-47.0,-43.0,-47.0,-90.0,-91.0,-88.0,-90.0,39.0,43.0,43.0,44.0,1
714,CC:2F:71:3F:1F:24,4507353,1203528053,675807,720279228,3831546,483248825,37,547601,570650073,546910,570566867,691,83206,529473,15,676055,73962,34,467,144444.0,43333.0,-70.0,-68.0,-70.0,-71.0,-70.0,-67.0,-70.0,-70.0,-90.0,-91.0,-88.0,-90.0,20.0,23.0,18.0,19.0,1
715,CC:2F:71:3E:C5:1F,3832380,483350766,834,101941,3831546,483248825,0,3481,292363,2872,220057,609,72306,882,8,1198,18,0,37,144444.0,39000.0,-73.0,-71.0,-67.0,-60.0,-72.0,-70.0,-67.0,-60.0,-90.0,-91.0,-88.0,-90.0,17.0,20.0,21.0,30.0,1
716,BA:8C:B9:54:50:24,3836348,489427874,4802,6179049,3831546,483248825,0,8744,1682225,8722,1678730,22,3495,2345,14,5217,38,0,56,229410.0,130000.0,-40.0,-37.0,-45.0,-51.0,-41.0,-35.0,-43.0,-47.0,-90.0,-91.0,-88.0,-90.0,50.0,54.0,43.0,39.0,1
717,92:69:1D:31:68:E9,3835382,486845121,3833,3596034,3831549,483249087,0,4517,1070650,4384,1040630,133,30020,2054,10,4009,84,0,41,216660.0,130000.0,-51.0,-48.0,-45.0,-46.0,-51.0,-47.0,-43.0,-47.0,-90.0,-91.0,-88.0,-90.0,39.0,43.0,43.0,44.0,1
718,CC:2F:71:3F:1F:24,4507395,1203542489,675846,720293402,3831549,483249087,37,547628,570654691,546937,570571485,691,83206,529495,15,676094,73990,34,467,144444.0,43333.0,-70.0,-68.0,-72.0,-70.0,-70.0,-67.0,-71.0,-70.0,-90.0,-91.0,-88.0,-90.0,20.0,23.0,16.0,20.0,1
719,CC:2F:71:3E:C5:1F,3832387,483351432,834,101941,3831553,483249491,0,3481,292363,2872,220057,609,72306,882,8,1198,18,0,37,144444.0,39000.0,-73.0,-71.0,-67.0,-60.0,-72.0,-70.0,-67.0,-60.0,-90.0,-91.0,-88.0,-90.0,17.0,20.0,21.0,30.0,1
720,BA:8C:B9:54:50:24,3836355,489428540,4802,6179049,3831553,483249491,0,8744,1682225,8722,1678730,22,3495,2345,14,5217,38,0,56,229410.0,130000.0,-40.0,-37.0,-45.0,-51.0,-41.0,-35.0,-43.0,-47.0,-90.0,-91.0,-88.0,-90.0,50.0,54.0,43.0,39.0,1
721,92:69:1D:31:68:E9,3835388,486845727,3833,3596034,3831555,483249693,0,4517,1070650,4384,1040630,133,30020,2054,10,4009,84,0,41,216660.0,130000.0,-51.0,-48.0,-45.0,-46.0,-51.0,-47.0,-43.0,-47.0,-90.0,-91.0,-88.0,-90.0,39.0,43.0,43.0,44.0,1
722,CC:2F:71:3F:1F:24,4507439,1203557139,675884,720307446,3831555,483249693,37,547650,570658541,546959,570575335,691,83206,529516,15,676132,74014,34,467,144444.0,43333.0,-73.0,-70.0,-74.0,-72.0,-71.0,-68.0,-72.0,-71.0,-90.0,-91.0,-88.0,-90.0,17.0,21.0,14.0,18.0,1
723,CC:2F:71:3E:C5:1F,3832389,483351634,834,101941,3831555,483249693,0,3481,292363,2872,220057,609,72306,882,8,1198,18,0,37,144444.0,39000.0,-73.0,-71.0,-67.0,-60.0,-72.0,-70.0,-67.0,-60.0,-90.0,-91.0,-88.0,-90.0,17.0,20.0,21.0,30.0,1
724,BA:8C:B9:54:50:24,3836357,489428742,4802,6179049,3831555,483249693,0,8744,1682225,8722,1678730,22,3495,2345,14,5217,38,0,56,229410.0,130000.0,-40.0,-37.0,-45.0,-51.0,-41.0,-35.0,-43.0,-47.0,-90.0,-91.0,-88.0,-90.0,50.0,54.0,43.0,39.0,1
725,92:69:1D:31:68:E9,3835390,486845929,3833,3596034,3831557,483249895,0,4517,1070650,4384,1040630,133,30020,2054,10,4009,84,0,41,216660.0,130000.0,-51.0,-48.0,-45.0,-46.0,-51.0,-47.0,-43.0,-47.0,-90.0,-91.0,-88.0,-90.0,39.0,43.0,43.0,44.0,1
726,CC:2F:71:3F:1F:24,4507929,1204138555,676369,720888398,3831560,483250157,37,547883,570698958,547192,570615752,691,83206,529738,15,676616,74166,34,467,130000.0,43333.0,-71.0,-68.0,-71.0,-70.0,-70.0,-67.0,-71.0,-70.0,-90.0,-91.0,-88.0,-90.0,19.0,23.0,17.0,20.0,1
727,CC:2F:71:3E:C5:1F,3832396,483352300,834,101941,3831562,483250359,0,3481,292363,2872,220057,609,72306,882,8,1198,18,0,37,144444.0,39000.0,-73.0,-71.0,-67.0,-60.0,-72.0,-70.0,-67.0,-60.0,-90.0,-91.0,-88.0,-90.0,17.0,20.0,21.0,30.0,1
728,BA:8C:B9:54:50:24,3836364,489429408,4802,6179049,3831562,483250359,0,8744,1682225,8722,1678730,22,3495,2345,14,5217,38,0,56,229410.0,130000.0,-40.0,-37.0,-45.0,-51.0,-41.0,-35.0,-43.0,-47.0,-90.0,-91.0,-88.0,-90.0,50.0,54.0,43.0,39.0,1
729,92:69:1D:31:68:E9,3835397,486846595,3833,3596034,3831564,483250561,0,4517,1070650,4384,1040630,133,30020,2054,10,4009,84,0,41,216660.0,130000.0,-51.0,-48.0,-45.0,-46.0,-51.0,-47.0,-43.0,-47.0,-90.0,-91.0,-88.0,-90.0,39.0,43.0,43.0,44.0,1
730,CC:2F:71:3F:1F:24,4508324,1204605290,676760,721354729,3831564,483250561,37,548074,570727848,547383,570644642,691,83206,529917,15,677007,74225,34,467,130000.0,43333.0,-71.0,-68.0,-72.0,-70.0,-71.0,-67.0,-71.0,-70.0,-90.0,-91.0,-88.0,-90.0,19.0,23.0,16.0,20.0,1
731,CC:2F:71:3E:C5:1F,3832398,483352502,834,101941,3831564,483250561,0,3481,292363,2872,220057,609,72306,882,8,1198,18,0,37,144444.0,39000.0,-73.0,-71.0,-67.0,-60.0,-72.0,-70.0,-67.0,-60.0,-90.0,-91.0,-88.0,-90.0,17.0,20.0,21.0,30.0,1
732,BA:8C:B9:54:50:24,3836366,489429610,4802,6179049,3831564,483250561,0,8744,1682225,8722,1678730,22,3495,2345,14,5217,38,0,56,229410.0,130000.0,-40.0,-37.0,-45.0,-51.0,-41.0,-35.0,-43.0,-47.0,-90.0,-91.0,-88.0,-90.0,50.0,54.0,43.0,39.0,1
733,92:69:1D:31:68:E9,3835399,486846797,3833,3596034,3831566,483250763,0,4517,1070650,4384,1040630,133,30020,2054,10,4009,84,0,41,216660.0,130000.0,-51.0,-48.0,-45.0,-46.0,-51.0,-47.0,-43.0,-47.0,-90.0,-91.0,-88.0,-90.0,39.0,43.0,43.0,44.0,1
734,CC:2F:71:3F:1F:24,4508836,1205191739,677268,721940774,3831568,483250965,37,548357,570772039,547666,570688833,691,83206,530178,15,677515,74257,34,467,130000.0,43333.0,-71.0,-68.0,-71.0,-71.0,-71.0,-67.0,-71.0,-70.0,-90.0,-91.0,-88.0,-90.0,19.0,23.0,17.0,19.0,1
735,CC:2F:71:3E:C5:1F,3832402,483352906,834,101941,3831568,483250965,0,3481,292363,2872,220057,609,72306,882,8,1198,18,0,37,144444.0,39000.0,-73.0,-71.0,-67.0,-60.0,-72.0,-70.0,-67.0,-60.0,-90.0,-91.0,-88.0,-90.0,17.0,20.0,21.0,30.0,1
736,BA:8C:B9:54:50:24,3836370,489430014,4802,6179049,3831568,483250965,0,8744,1682225,8722,1678730,22,3495,2345,14,5217,38,0,56,229410.0,130000.0,-40.0,-37.0,-45.0,-51.0,-41.0,-35.0,-43.0,-47.0,-90.0,-91.0,-88.0,-90.0,50.0,54.0,43.0,39.0,1
737,92:69:1D:31:68:E9,3835406,486847463,3833,3596034,3831573,483251429,0,4517,1070650,4384,1040630,133,30020,2054,10,4009,84,0,41,216660.0,130000.0,-51.0,-48.0,-45.0,-46.0,-51.0,-47.0,-43.0,-47.0,-90.0,-91.0,-88.0,-90.0,39.0,43.0,43.0,44.0,1
738,CC:2F:71:3F:1F:24,4509419,1205884613,677846,722633184,3831573,483251429,37,548645,570814447,547954,570731241,691,83206,530449,15,678094,74283,34,467,130000.0,43333.0,-71.0,-68.0,-71.0,-70.0,-71.0,-67.0,-71.0,-70.0,-90.0,-91.0,-88.0,-90.0,19.0,23.0,17.0,20.0,1
739,CC:2F:71:3E:C5:1F,3832407,483353370,834,101941,3831573,483251429,0,3481,292363,2872,220057,609,72306,882,8,1198,18,0,37,144444.0,39000.0,-73.0,-71.0,-67.0,-60.0,-72.0,-70.0,-67.0,-60.0,-90.0,-91.0,-88.0,-90.0,17.0,20.0,21.0,30.0,1
740,BA:8C:B9:54:50:24,3836375,489430478,4802,6179049,3831573,483251429,0,8744,1682225,8722,1678730,22,3495,2345,14,5217,38,0,56,229410.0,130000.0,-40.0,-37.0,-45.0,-51.0,-41.0,-35.0,-43.0,-47.0,-90.0,-91.0,-88.0,-90.0,50.0,54.0,43.0,39.0,1
741,92:69:1D:31:68:E9,3835409,486847781,3834,3596150,3831575,483251631,0,4519,1070786,4386,1040766,133,30020,2054,10,4010,84,0,41,216660.0,130000.0,-51.0,-47.0,-42.0,-49.0,-51.0,-48.0,-43.0,-47.0,-90.0,-91.0,-88.0,-90.0,39.0,44.0,46.0,41.0,1
742,CC:2F:71:3F:1F:24,4509998,1206597798,678421,723345965,3831577,483251833,37,548898,570852008,548207,570768802,691,83206,530699,15,678669,74336,34,467,130000.0,43333.0,-71.0,-67.0,-72.0,-70.0,-70.0,-67.0,-71.0,-70.0,-90.0,-91.0,-88.0,-90.0,19.0,24.0,16.0,20.0,1
743,CC:2F:71:3E:C5:1F,3832412,483353890,835,102057,3831577,483251833,0,3483,292503,2874,220197,609,72306,882,8,1199,18,0,37,144444.0,39000.0,-71.0,-70.0,-67.0,-60.0,-72.0,-70.0,-67.0,-60.0,-90.0,-91.0,-88.0,-90.0,19.0,21.0,21.0,30.0,1
744,BA:8C:B9:54:50:24,3836380,489430998,4803,6179165,3831577,483251833,0,8746,1682361,8724,1678866,22,3495,2345,14,5218,38,0,56,229410.0,130000.0,-48.0,-35.0,-43.0,-46.0,-42.0,-35.0,-43.0,-47.0,-90.0,-91.0,-88.0,-90.0,42.0,56.0,45.0,44.0,1
745,92:69:1D:31:68:E9,3835415,486848387,3834,3596150,3831581,483252237,0,4519,1070786,4386,1040766,133,30020,2054,10,4010,84,0,41,216660.0,130000.0,-51.0,-47.0,-42.0,-49.0,-51.0,-48.0,-43.0,-47.0,-90.0,-91.0,-88.0,-90.0,39.0,44.0,46.0,41.0,1
746,CC:2F:71:3F:1F:24,4510275,1206883894,678694,723631657,3831581,483252237,37,549052,570875728,548361,570792522,691,83206,530846,15,678942,74385,34,467,117000.0,39000.0,-71.0,-68.0,-72.0,-70.0,-71.0,-67.0,-71.0,-69.0,-90.0,-91.0,-88.0,-90.0,19.0,23.0,16.0,20.0,1
747,CC:2F:71:3E:C5:1F,3832416,483354294,835,102057,3831581,483252237,0,3483,292503,2874,220197,609,72306,882,8,1199,18,0,37,144444.0,39000.0,-71.0,-70.0,-67.0,-60.0,-72.0,-70.0,-67.0,-60.0,-90.0,-91.0,-88.0,-90.0,19.0,21.0,21.0,30.0,1
748,BA:8C:B9:54:50:24,3836385,489431675,4803,6179165,3831582,483252510,0,8746,1682361,8724,1678866,22,3495,2345,14,5218,38,0,56,229410.0,130000.0,-48.0,-35.0,-43.0,-46.0,-42.0,-35.0,-43.0,-47.0,-90.0,-91.0,-88.0,-90.0,42.0,56.0,45.0,44.0,1
749,92:69:1D:31:68:E9,3835419,486848922,3834,3596150,3831585,483252772,0,4519,1070786,4386,1040766,133,30020,2054,10,4010,84,0,41,216660.0,130000.0,-51.0,-47.0,-42.0,-49.0,-51.0,-48.0,-43.0,-47.0,-90.0,-91.0,-88.0,-90.0,39.0,44.0,46.0,41.0,1
750,CC:2F:71:3F:1F:24,4510319,1206898507,678732,723645533,3831587,483252974,37,549076,570879824,548385,570796618,691,83206,530868,15,678980,74391,34,467,130000.0,39000.0,-73.0,-70.0,-73.0,-72.0,-72.0,-69.0,-73.0,-72.0,-90.0,-91.0,-88.0,-90.0,17.0,21.0,15.0,18.0,1
751,CC:2F:71:3E:C5:1F,3832422,483355031,835,102057,3831587,483252974,0,3483,292503,2874,220197,609,72306,882,8,1199,18,0,37,144444.0,39000.0,-71.0,-70.0,-67.0,-60.0,-72.0,-70.0,-67.0,-60.0,-90.0,-91.0,-88.0,-90.0,19.0,21.0,21.0,30.0,1
752,BA:8C:B9:54:50:24,3836390,489432139,4803,6179165,3831587,483252974,0,8747,1682429,8725,1678934,22,3495,2345,14,5218,38,0,56,229410.0,130000.0,-40.0,-37.0,-46.0,-51.0,-42.0,-35.0,-44.0,-48.0,-90.0,-91.0,-88.0,-90.0,50.0,54.0,42.0,39.0,1
753,92:69:1D:31:68:E9,3835425,486849528,3834,3596150,3831591,483253378,0,4519,1070786,4386,1040766,133,30020,2054,10,4010,84,0,41,216660.0,130000.0,-51.0,-47.0,-42.0,-49.0,-51.0,-48.0,-43.0,-47.0,-90.0,-91.0,-88.0,-90.0,39.0,44.0,46.0,41.0,1
754,CC:2F:71:3F:1F:24,4510365,1206913419,678774,723660041,3831591,483253378,37,549103,570884296,548412,570801090,691,83206,530891,15,679022,74407,34,467,117000.0,39000.0,-71.0,-67.0,-72.0,-70.0,-70.0,-67.0,-71.0,-70.0,-90.0,-91.0,-88.0,-90.0,19.0,24.0,16.0,20.0,1
755,CC:2F:71:3E:C5:1F,3832426,483355435,835,102057,3831591,483253378,0,3483,292503,2874,220197,609,72306,882,8,1199,18,0,37,144444.0,39000.0,-71.0,-70.0,-67.0,-60.0,-72.0,-70.0,-67.0,-60.0,-90.0,-91.0,-88.0,-90.0,19.0,21.0,21.0,30.0,1
756,BA:8C:B9:54:50:24,3836394,489432543,4803,6179165,3831591,483253378,0,8747,1682429,8725,1678934,22,3495,2345,14,5218,38,0,56,229410.0,130000.0,-40.0,-37.0,-46.0,-51.0,-42.0,-35.0,-44.0,-48.0,-90.0,-91.0,-88.0,-90.0,50.0,54.0,42.0,39.0,1
757,92:69:1D:31:68:E9,3835428,486849790,3834,3596150,3831594,483253640,0,4519,1070786,4386,1040766,133,30020,2054,10,4010,84,0,41,216660.0,130000.0,-51.0,-47.0,-42.0,-49.0,-51.0,-48.0,-43.0,-47.0,-90.0,-91.0,-88.0,-90.0,39.0,44.0,46.0,41.0,1
758,CC:2F:71:3F:1F:24,4510801,1207420065,679205,724166223,3831596,483253842,37,549308,570914823,548617,570831617,691,83206,531088,15,679453,74442,34,467,130000.0,43333.0,-71.0,-67.0,-72.0,-70.0,-70.0,-67.0,-71.0,-70.0,-90.0,-91.0,-88.0,-90.0,19.0,24.0,16.0,20.0,1
759,CC:2F:71:3E:C5:1F,3832431,483355899,835,102057,3831596,483253842,0,3483,292503,2874,220197,609,72306,882,8,1199,18,0,37,144444.0,39000.0,-71.0,-70.0,-67.0,-60.0,-72.0,-70.0,-67.0,-60.0,-90.0,-91.0,-88.0,-90.0,19.0,21.0,21.0,30.0,1
760,BA:8C:B9:54:50:24,3836400,489433069,4803,6179165,3831597,483253904,0,8747,1682429,8725,1678934,22,3495,2345,14,5218,38,0,56,229410.0,130000.0,-40.0,-37.0,-46.0,-51.0,-42.0,-35.0,-44.0,-48.0,-90.0,-91.0,-88.0,-90.0,50.0,54.0,42.0,39.0,1
761,92:69:1D:31:68:E9,3835433,486850256,3834,3596150,3831599,483254106,0,4519,1070786,4386,1040766,133,30020,2054,10,4010,84,0,41,216660.0,130000.0,-51.0,-47.0,-42.0,-49.0,-51.0,-48.0,-43.0,-47.0,-90.0,-91.0,-88.0,-90.0,39.0,44.0,46.0,41.0,1
762,CC:2F:71:3F:1F:24,4511038,1207680263,679437,724425955,3831601,483254308,37,549421,570931825,548729,570848501,692,83324,531198,15,679685,74478,34,467,117000.0,39000.0,-69.0,-68.0,-71.0,-70.0,-69.0,-68.0,-71.0,-70.0,-90.0,-91.0,-88.0,-90.0,21.0,23.0,17.0,20.0,1
763,CC:2F:71:3E:C5:1F,3832436,483356365,835,102057,3831601,483254308,0,3483,292503,2874,220197,609,72306,882,8,1199,18,0,37,144444.0,39000.0,-71.0,-70.0,-67.0,-60.0,-72.0,-70.0,-67.0,-60.0,-90.0,-91.0,-88.0,-90.0,19.0,21.0,21.0,30.0,1
764,BA:8C:B9:54:50:24,3836404,489433473,4803,6179165,3831601,483254308,0,8747,1682429,8725,1678934,22,3495,2345,14,5218,38,0,56,229410.0,130000.0,-40.0,-37.0,-46.0,-51.0,-42.0,-35.0,-44.0,-48.0,-90.0,-91.0,-88.0,-90.0,50.0,54.0,42.0,39.0,1
765,92:69:1D:31:68:E9,3835437,486850660,3834,3596150,3831603,483254510,0,4519,1070786,4386,1040766,133,30020,2054,10,4010,84,0,41,216660.0,130000.0,-51.0,-47.0,-42.0,-49.0,-51.0,-48.0,-43.0,-47.0,-90.0,-91.0,-88.0,-90.0,39.0,44.0,46.0,41.0,1
766,CC:2F:71:3F:1F:24,4511080,1207694543,679475,724439831,3831605,483254712,37,549443,570935737,548751,570852413,692,83324,531218,15,679723,74482,34,467,130000.0,39000.0,-69.0,-68.0,-69.0,-70.0,-69.0,-68.0,-69.0,-70.0,-90.0,-91.0,-88.0,-90.0,21.0,23.0,19.0,20.0,1
767,CC:2F:71:3E:C5:1F,3832440,483356769,835,102057,3831605,483254712,0,3483,292503,2874,220197,609,72306,882,8,1199,18,0,37,144444.0,39000.0,-71.0,-70.0,-67.0,-60.0,-72.0,-70.0,-67.0,-60.0,-90.0,-91.0,-88.0,-90.0,19.0,21.0,21.0,30.0,1
768,BA:8C:B9:54:50:24,3836408,489433877,4803,6179165,3831605,483254712,0,8747,1682429,8725,1678934,22,3495,2345,14,5218,38,0,56,229410.0,130000.0,-40.0,-37.0,-46.0,-51.0,-42.0,-35.0,-44.0,-48.0,-90.0,-91.0,-88.0,-90.0,50.0,54.0,42.0,39.0,1
769,92:69:1D:31:68:E9,3835443,486851186,3834,3596150,3831609,483255036,0,4519,1070786,4386,1040766,133,30020,2054,10,4010,84,0,41,216660.0,130000.0,-51.0,-47.0,-42.0,-49.0,-51.0,-48.0,-43.0,-47.0,-90.0,-91.0,-88.0,-90.0,39.0,44.0,46.0,41.0,1
770,CC:2F:71:3F:1F:24,4511125,1207709501,679514,724454263,3831611,483255238,37,549467,570939977,548775,570856653,692,83324,531239,15,679762,74487,34,467,144444.0,43333.0,-70.0,-68.0,-71.0,-70.0,-69.0,-68.0,-70.0,-70.0,-90.0,-91.0,-88.0,-90.0,20.0,23.0,17.0,20.0,1
771,CC:2F:71:3E:C5:1F,3832446,483357295,835,102057,3831611,483255238,0,3485,292691,2875,220267,610,72424,883,8,1199,18,0,37,144444.0,39000.0,-73.0,-70.0,-66.0,-60.0,-72.0,-70.0,-66.0,-60.0,-90.0,-91.0,-88.0,-90.0,17.0,21.0,22.0,30.0,1
772,BA:8C:B9:54:50:24,3836414,489434403,4803,6179165,3831611,483255238,0,8747,1682429,8725,1678934,22,3495,2345,14,5218,38,0,56,229410.0,130000.0,-40.0,-37.0,-46.0,-51.0,-42.0,-35.0,-44.0,-48.0,-90.0,-91.0,-88.0,-90.0,50.0,54.0,42.0,39.0,1
773,92:69:1D:31:68:E9,3835447,486851590,3834,3596150,3831613,483255440,0,4521,1070922,4388,1040902,133,30020,2054,10,4011,84,0,41,216660.0,130000.0,-52.0,-48.0,-44.0,-47.0,-51.0,-48.0,-44.0,-47.0,-89.0,-91.0,-88.0,-90.0,37.0,43.0,44.0,43.0,1
774,CC:2F:71:3F:1F:24,4511167,1207724069,679554,724468629,3831613,483255440,37,549490,570943989,548798,570860665,692,83324,531261,15,679802,74489,34,467,144444.0,43333.0,-69.0,-68.0,-69.0,-69.0,-68.0,-67.0,-68.0,-68.0,-89.0,-91.0,-88.0,-90.0,20.0,23.0,19.0,21.0,1
775,CC:2F:71:3E:C5:1F,3832450,483357699,835,102057,3831615,483255642,0,3485,292691,2875,220267,610,72424,883,8,1199,18,0,37,144444.0,39000.0,-73.0,-70.0,-66.0,-60.0,-72.0,-70.0,-66.0,-60.0,-89.0,-91.0,-88.0,-90.0,16.0,21.0,22.0,30.0,1
776,BA:8C:B9:54:50:24,3836418,489434807,4803,6179165,3831615,483255642,0,8749,1682565,8727,1679070,22,3495,2345,14,5219,38,0,56,229410.0,130000.0,-49.0,-35.0,-43.0,-45.0,-43.0,-36.0,-44.0,-48.0,-89.0,-91.0,-88.0,-90.0,40.0,56.0,45.0,45.0,1
777,92:69:1D:31:68:E9,3835451,486851994,3834,3596150,3831617,483255844,0,4521,1070922,4388,1040902,133,30020,2054,10,4011,84,0,41,216660.0,130000.0,-52.0,-48.0,-44.0,-47.0,-51.0,-48.0,-44.0,-47.0,-89.0,-91.0,-88.0,-90.0,37.0,43.0,44.0,43.0,1
778,CC:2F:71:3F:1F:24,4511218,1207742252,679600,724486274,3831618,483255978,37,549518,570949054,548826,570865730,692,83324,531288,15,679848,74506,34,468,144444.0,43333.0,-70.0,-67.0,-70.0,-69.0,-69.0,-67.0,-69.0,-69.0,-89.0,-91.0,-88.0,-90.0,19.0,24.0,18.0,21.0,1
779,CC:2F:71:3E:C5:1F,3832454,483358103,835,102057,3831619,483256046,0,3485,292691,2875,220267,610,72424,883,8,1199,18,0,37,144444.0,39000.0,-73.0,-70.0,-66.0,-60.0,-72.0,-70.0,-66.0,-60.0,-89.0,-91.0,-88.0,-90.0,16.0,21.0,22.0,30.0,1
780,BA:8C:B9:54:50:24,3836422,489435211,4803,6179165,3831619,483256046,0,8749,1682565,8727,1679070,22,3495,2345,14,5219,38,0,56,229410.0,130000.0,-49.0,-35.0,-43.0,-45.0,-43.0,-36.0,-44.0,-48.0,-89.0,-91.0,-88.0,-90.0,40.0,56.0,45.0,45.0,1
781,92:69:1D:31:68:E9,3835456,486852458,3834,3596150,3831622,483256308,0,4521,1070922,4388,1040902,133,30020,2054,10,4011,84,0,41,216660.0,130000.0,-52.0,-48.0,-44.0,-47.0,-51.0,-48.0,-44.0,-47.0,-89.0,-91.0,-88.0,-90.0,37.0,43.0,44.0,43.0,1
782,CC:2F:71:3F:1F:24,4511480,1208012730,679858,724756422,3831622,483256308,37,549655,570972330,548963,570889006,692,83324,531422,15,680106,74674,34,468,130000.0,43333.0,-69.0,-67.0,-69.0,-71.0,-69.0,-67.0,-68.0,-70.0,-89.0,-91.0,-88.0,-90.0,20.0,24.0,19.0,19.0,1
783,CC:2F:71:3E:C5:1F,3832459,483358567,835,102057,3831624,483256510,0,3485,292691,2875,220267,610,72424,883,8,1199,18,0,37,144444.0,39000.0,-73.0,-70.0,-66.0,-60.0,-72.0,-70.0,-66.0,-60.0,-89.0,-91.0,-88.0,-90.0,16.0,21.0,22.0,30.0,1
784,BA:8C:B9:54:50:24,3836427,489435675,4803,6179165,3831624,483256510,0,8749,1682565,8727,1679070,22,3495,2345,14,5219,38,0,56,229410.0,130000.0,-49.0,-35.0,-43.0,-45.0,-43.0,-36.0,-44.0,-48.0,-89.0,-91.0,-88.0,-90.0,40.0,56.0,45.0,45.0,1
785,92:69:1D:31:68:E9,3835460,486852862,3834,3596150,3831626,483256712,0,4521,1070922,4388,1040902,133,30020,2054,10,4011,84,0,41,216660.0,130000.0,-52.0,-48.0,-44.0,-47.0,-51.0,-48.0,-44.0,-47.0,-89.0,-91.0,-88.0,-90.0,37.0,43.0,44.0,43.0,1
786,CC:2F:71:3F:1F:24,4511861,1208478582,680235,725221870,3831626,483256712,37,549828,570997562,549136,570914238,692,83324,531588,15,680483,74701,34,468,130000.0,43333.0,-69.0,-68.0,-69.0,-71.0,-68.0,-67.0,-68.0,-70.0,-89.0,-91.0,-88.0,-90.0,20.0,23.0,19.0,19.0,1
787,CC:2F:71:3E:C5:1F,3832461,483358769,835,102057,3831626,483256712,0,3485,292691,2875,220267,610,72424,883,8,1199,18,0,37,144444.0,39000.0,-73.0,-70.0,-66.0,-60.0,-72.0,-70.0,-66.0,-60.0,-89.0,-91.0,-88.0,-90.0,16.0,21.0,22.0,30.0,1
788,BA:8C:B9:54:50:24,3836431,489436079,4803,6179165,3831628,483256914,0,8749,1682565,8727,1679070,22,3495,2345,14,5219,38,0,56,229410.0,130000.0,-49.0,-35.0,-43.0,-45.0,-43.0,-36.0,-44.0,-48.0,-89.0,-91.0,-88.0,-90.0,40.0,56.0,45.0,45.0,1
789,92:69:1D:31:68:E9,3835465,486853326,3834,3596150,3831631,483257176,0,4521,1070922,4388,1040902,133,30020,2054,10,4011,84,0,41,216660.0,130000.0,-52.0,-48.0,-44.0,-47.0,-51.0,-48.0,-44.0,-47.0,-89.0,-91.0,-88.0,-90.0,37.0,43.0,44.0,43.0,1
790,CC:2F:71:3F:1F:24,4512349,1209021235,680718,725764059,3831631,483257176,37,550087,571036605,549395,570953281,692,83324,531846,15,680966,74763,34,468,130000.0,43333.0,-69.0,-67.0,-69.0,-71.0,-69.0,-67.0,-68.0,-70.0,-89.0,-91.0,-88.0,-90.0,20.0,24.0,19.0,19.0,1
791,CC:2F:71:3E:C5:1F,3832468,483359435,835,102057,3831633,483257378,0,3485,292691,2875,220267,610,72424,883,8,1199,18,0,37,144444.0,39000.0,-73.0,-70.0,-66.0,-60.0,-72.0,-70.0,-66.0,-60.0,-89.0,-91.0,-88.0,-90.0,16.0,21.0,22.0,30.0,1
792,BA:8C:B9:54:50:24,3836436,489436543,4803,6179165,3831633,483257378,0,8749,1682565,8727,1679070,22,3495,2345,14,5219,38,0,56,229410.0,130000.0,-49.0,-35.0,-43.0,-45.0,-43.0,-36.0,-44.0,-48.0,-89.0,-91.0,-88.0,-90.0,40.0,56.0,45.0,45.0,1
793,92:69:1D:31:68:E9,3835469,486853730,3834,3596150,3831635,483257580,0,4521,1070922,4388,1040902,133,30020,2054,10,4011,84,0,41,216660.0,130000.0,-52.0,-48.0,-44.0,-47.0,-51.0,-48.0,-44.0,-47.0,-89.0,-91.0,-88.0,-90.0,37.0,43.0,44.0,43.0,1
794,CC:2F:71:3F:1F:24,4512783,1209527803,681148,726270223,3831635,483257580,37,550295,571067896,549603,570984572,692,83324,532043,15,681396,74790,34,468,130000.0,43333.0,-69.0,-67.0,-69.0,-71.0,-69.0,-67.0,-68.0,-70.0,-89.0,-91.0,-88.0,-90.0,20.0,24.0,19.0,19.0,1
795,CC:2F:71:3E:C5:1F,3832470,483359637,835,102057,3831635,483257580,0,3485,292691,2875,220267,610,72424,883,8,1199,18,0,37,144444.0,39000.0,-73.0,-70.0,-66.0,-60.0,-72.0,-70.0,-66.0,-60.0,-89.0,-91.0,-88.0,-90.0,16.0,21.0,22.0,30.0,1
796,BA:8C:B9:54:50:24,3836440,489436947,4803,6179165,3831637,483257782,0,8749,1682565,8727,1679070,22,3495,2345,14,5219,38,0,56,229410.0,130000.0,-49.0,-35.0,-43.0,-45.0,-43.0,-36.0,-44.0,-48.0,-89.0,-91.0,-88.0,-90.0,40.0,56.0,45.0,45.0,1
797,92:69:1D:31:68:E9,3835473,486854134,3834,3596150,3831639,483257984,0,4521,1070922,4388,1040902,133,30020,2054,10,4011,84,0,41,216660.0,130000.0,-52.0,-48.0,-44.0,-47.0,-51.0,-48.0,-44.0,-47.0,-89.0,-91.0,-88.0,-90.0,37.0,43.0,44.0,43.0,1
798,CC:2F:71:3F:1F:24,4513217,1210034315,681578,726776331,3831639,483257984,37,550506,571099414,549814,571016090,692,83324,532249,15,681826,74847,34,468,130000.0,39000.0,-69.0,-68.0,-69.0,-70.0,-69.0,-67.0,-69.0,-69.0,-89.0,-90.0,-87.0,-89.0,20.0,22.0,18.0,19.0,1
799,CC:2F:71:3E:C5:1F,3832474,483360041,835,102057,3831639,483257984,0,3485,292691,2875,220267,610,72424,883,8,1199,18,0,37,144444.0,39000.0,-73.0,-70.0,-66.0,-60.0,-72.0,-70.0,-66.0,-60.0,-89.0,-90.0,-87.0,-89.0,16.0,20.0,21.0,29.0,1
800,BA:8C:B9:54:50:24,3836444,489437351,4803,6179165,3831641,483258186,0,8749,1682565,8727,1679070,22,3495,2345,14,5219,38,0,56,229410.0,130000.0,-49.0,-35.0,-43.0,-45.0,-43.0,-36.0,-44.0,-48.0,-89.0,-90.0,-87.0,-89.0,40.0,55.0,44.0,44.0,1
801,92:69:1D:31:68:E9,3835479,486854871,3834,3596150,3831645,483258721,0,4521,1070922,4388,1040902,133,30020,2054,10,4011,84,0,41,216660.0,130000.0,-52.0,-48.0,-44.0,-47.0,-51.0,-48.0,-44.0,-47.0,-89.0,-90.0,-87.0,-89.0,37.0,42.0,43.0,42.0,1
802,CC:2F:71:3F:1F:24,4513262,1210049114,681617,726790393,3831645,483258721,37,550529,571103380,549837,571020056,692,83324,532271,15,681865,74871,34,468,144444.0,43333.0,-69.0,-67.0,-69.0,-70.0,-69.0,-67.0,-68.0,-70.0,-89.0,-90.0,-87.0,-89.0,20.0,23.0,18.0,19.0,1
803,CC:2F:71:3E:C5:1F,3832480,483360778,835,102057,3831645,483258721,0,3485,292691,2875,220267,610,72424,883,8,1199,18,0,37,144444.0,39000.0,-73.0,-70.0,-66.0,-60.0,-72.0,-70.0,-66.0,-60.0,-89.0,-90.0,-87.0,-89.0,16.0,20.0,21.0,29.0,1
804,BA:8C:B9:54:50:24,3836448,489437886,4803,6179165,3831645,483258721,0,8749,1682565,8727,1679070,22,3495,2345,14,5219,38,0,56,229410.0,130000.0,-49.0,-35.0,-43.0,-45.0,-43.0,-36.0,-44.0,-48.0,-89.0,-90.0,-87.0,-89.0,40.0,55.0,44.0,44.0,1
805,92:69:1D:31:68:E9,3835483,486855275,3834,3596150,3831649,483259125,0,4521,1070922,4388,1040902,133,30020,2054,10,4011,84,0,41,216660.0,130000.0,-52.0,-48.0,-44.0,-47.0,-51.0,-48.0,-44.0,-47.0,-89.0,-90.0,-87.0,-89.0,37.0,42.0,43.0,42.0,1
806,CC:2F:71:3F:1F:24,4513305,1210063632,681655,726804381,3831650,483259251,37,550550,571107114,549858,571023790,692,83324,532291,15,681903,74884,34,468,130000.0,43333.0,-69.0,-67.0,-69.0,-70.0,-69.0,-67.0,-68.0,-70.0,-89.0,-90.0,-87.0,-89.0,20.0,23.0,18.0,19.0,1
807,CC:2F:71:3E:C5:1F,3832487,483361510,835,102057,3831652,483259453,0,3485,292691,2875,220267,610,72424,883,8,1199,18,0,37,144444.0,39000.0,-73.0,-70.0,-66.0,-60.0,-72.0,-70.0,-66.0,-60.0,-89.0,-90.0,-87.0,-89.0,16.0,20.0,21.0,29.0,1
808,BA:8C:B9:54:50:24,3836455,489438618,4803,6179165,3831652,483259453,0,8749,1682565,8727,1679070,22,3495,2345,14,5219,38,0,56,229410.0,130000.0,-49.0,-35.0,-43.0,-45.0,-43.0,-36.0,-44.0,-48.0,-89.0,-90.0,-87.0,-89.0,40.0,55.0,44.0,44.0,1
809,92:69:1D:31:68:E9,3835488,486855805,3834,3596150,3831654,483259655,0,4521,1070922,4388,1040902,133,30020,2054,10,4011,84,0,41,216660.0,130000.0,-52.0,-48.0,-44.0,-47.0,-51.0,-48.0,-44.0,-47.0,-89.0,-90.0,-87.0,-89.0,37.0,42.0,43.0,42.0,1
810,CC:2F:71:3F:1F:24,4513349,1210078284,681695,726818629,3831654,483259655,37,550575,571111294,549883,571027970,692,83324,532314,15,681943,74898,34,469,130000.0,39000.0,-69.0,-68.0,-69.0,-70.0,-69.0,-67.0,-68.0,-70.0,-89.0,-90.0,-87.0,-89.0,20.0,22.0,18.0,19.0,1
811,CC:2F:71:3E:C5:1F,3832489,483361712,835,102057,3831654,483259655,0,3485,292691,2875,220267,610,72424,883,8,1199,18,0,37,144444.0,39000.0,-73.0,-70.0,-66.0,-60.0,-72.0,-70.0,-66.0,-60.0,-89.0,-90.0,-87.0,-89.0,16.0,20.0,21.0,29.0,1
812,BA:8C:B9:54:50:24,3836459,489439022,4803,6179165,3831656,483259857,0,8749,1682565,8727,1679070,22,3495,2345,14,5219,38,0,56,229410.0,130000.0,-49.0,-35.0,-43.0,-45.0,-43.0,-36.0,-44.0,-48.0,-89.0,-90.0,-87.0,-89.0,40.0,55.0,44.0,44.0,1
813,92:69:1D:31:68:E9,3835493,486856269,3834,3596150,3831659,483260119,0,4521,1070922,4388,1040902,133,30020,2054,10,4011,84,0,41,216660.0,130000.0,-52.0,-48.0,-44.0,-47.0,-51.0,-48.0,-44.0,-47.0,-89.0,-90.0,-87.0,-89.0,37.0,42.0,43.0,42.0,1
814,CC:2F:71:3F:1F:24,4513400,1210096225,681741,726836106,3831659,483260119,37,550605,571116563,549913,571033239,692,83324,532343,15,681989,74927,34,469,130000.0,43333.0,-68.0,-67.0,-68.0,-71.0,-68.0,-67.0,-68.0,-70.0,-89.0,-90.0,-87.0,-89.0,21.0,23.0,19.0,18.0,1
815,CC:2F:71:3E:C5:1F,3832496,483362378,835,102057,3831661,483260321,0,3485,292691,2875,220267,610,72424,883,8,1199,18,0,37,144444.0,39000.0,-73.0,-70.0,-66.0,-60.0,-72.0,-70.0,-66.0,-60.0,-89.0,-90.0,-87.0,-89.0,16.0,20.0,21.0,29.0,1
816,BA:8C:B9:54:50:24,3836464,489439486,4803,6179165,3831661,483260321,0,8749,1682565,8727,1679070,22,3495,2345,14,5219,38,0,56,229410.0,130000.0,-49.0,-35.0,-43.0,-45.0,-43.0,-36.0,-44.0,-48.0,-89.0,-90.0,-87.0,-89.0,40.0,55.0,44.0,44.0,1
817,92:69:1D:31:68:E9,3835497,486856673,3834,3596150,3831663,483260523,0,4521,1070922,4388,1040902,133,30020,2054,10,4011,84,0,41,216660.0,130000.0,-52.0,-48.0,-44.0,-47.0,-51.0,-48.0,-44.0,-47.0,-89.0,-90.0,-87.0,-89.0,37.0,42.0,43.0,42.0,1
818,CC:2F:71:3F:1F:24,4513442,1210110673,681779,726850150,3831663,483260523,37,550627,571120413,549935,571037089,692,83324,532364,15,682027,74932,34,469,130000.0,43333.0,-69.0,-67.0,-69.0,-70.0,-68.0,-67.0,-68.0,-70.0,-89.0,-90.0,-87.0,-89.0,20.0,23.0,18.0,19.0,1
819,CC:2F:71:3E:C5:1F,3832498,483362580,835,102057,3831663,483260523,0,3485,292691,2875,220267,610,72424,883,8,1199,18,0,37,144444.0,39000.0,-73.0,-70.0,-66.0,-60.0,-72.0,-70.0,-66.0,-60.0,-89.0,-90.0,-87.0,-89.0,16.0,20.0,21.0,29.0,1
820,BA:8C:B9:54:50:24,3836466,489439688,4803,6179165,3831663,483260523,0,8749,1682565,8727,1679070,22,3495,2345,14,5219,38,0,56,229410.0,130000.0,-49.0,-35.0,-43.0,-45.0,-43.0,-36.0,-44.0,-48.0,-89.0,-90.0,-87.0,-89.0,40.0,55.0,44.0,44.0,1
821,92:69:1D:31:68:E9,3835502,486857137,3834,3596150,3831668,483260987,0,4521,1070922,4388,1040902,133,30020,2054,10,4011,84,0,41,216660.0,130000.0,-52.0,-48.0,-44.0,-47.0,-51.0,-48.0,-44.0,-47.0,-89.0,-90.0,-87.0,-89.0,37.0,42.0,43.0,42.0,1
822,CC:2F:71:3F:1F:24,4513485,1210125125,681817,726864138,3831668,483260987,37,550649,571124325,549957,571041001,692,83324,532384,15,682065,74949,34,469,130000.0,39000.0,-69.0,-67.0,-69.0,-71.0,-69.0,-67.0,-68.0,-70.0,-89.0,-90.0,-87.0,-89.0,20.0,23.0,18.0,18.0,1
823,CC:2F:71:3E:C5:1F,3832505,483363246,835,102057,3831670,483261189,0,3485,292691,2875,220267,610,72424,883,8,1199,18,0,37,144444.0,39000.0,-73.0,-70.0,-66.0,-60.0,-72.0,-70.0,-66.0,-60.0,-89.0,-90.0,-87.0,-89.0,16.0,20.0,21.0,29.0,1
824,BA:8C:B9:54:50:24,3836473,489440354,4803,6179165,3831670,483261189,0,8749,1682565,8727,1679070,22,3495,2345,14,5219,38,0,56,229410.0,130000.0,-49.0,-35.0,-43.0,-45.0,-43.0,-36.0,-44.0,-48.0,-89.0,-90.0,-87.0,-89.0,40.0,55.0,44.0,44.0,1
825,92:69:1D:31:68:E9,3835506,486857541,3834,3596150,3831672,483261391,0,4521,1070922,4388,1040902,133,30020,2054,10,4011,84,0,41,216660.0,130000.0,-52.0,-48.0,-44.0,-47.0,-51.0,-48.0,-44.0,-47.0,-88.0,-89.0,-87.0,-88.0,36.0,41.0,43.0,41.0,1
826,CC:2F:71:3F:1F:24,4513527,1210139461,681855,726878070,3831672,483261391,37,550671,571128175,549979,571044851,692,83324,532405,15,682103,74957,34,469,130000.0,39000.0,-69.0,-67.0,-69.0,-70.0,-69.0,-67.0,-68.0,-70.0,-88.0,-89.0,-87.0,-88.0,19.0,22.0,18.0,18.0,1
827,CC:2F:71:3E:C5:1F,3832507,483363448,835,102057,3831672,483261391,0,3485,292691,2875,220267,610,72424,883,8,1199,18,0,37,144444.0,39000.0,-73.0,-70.0,-66.0,-60.0,-72.0,-70.0,-66.0,-60.0,-88.0,-89.0,-87.0,-88.0,15.0,19.0,21.0,28.0,1
828,BA:8C:B9:54:50:24,3836476,489440624,4803,6179165,3831673,483261459,0,8749,1682565,8727,1679070,22,3495,2345,14,5219,38,0,56,229410.0,130000.0,-49.0,-35.0,-43.0,-45.0,-43.0,-36.0,-44.0,-48.0,-88.0,-89.0,-87.0,-88.0,39.0,54.0,44.0,43.0,1
829,92:69:1D:31:68:E9,3835510,486857945,3834,3596150,3831676,483261795,0,4521,1070922,4388,1040902,133,30020,2054,10,4011,84,0,41,216660.0,130000.0,-52.0,-48.0,-44.0,-47.0,-51.0,-48.0,-44.0,-47.0,-88.0,-89.0,-87.0,-88.0,36.0,41.0,43.0,41.0,1
830,CC:2F:71:3F:1F:24,4513574,1210154768,681898,726892973,3831676,483261795,37,550699,571133354,550007,571050030,692,83324,532431,15,682145,74965,34,469,130000.0,39000.0,-69.0,-67.0,-68.0,-70.0,-68.0,-67.0,-68.0,-70.0,-88.0,-89.0,-87.0,-88.0,19.0,22.0,19.0,18.0,1
831,CC:2F:71:3E:C5:1F,3832513,483364054,835,102057,3831678,483261997,0,3485,292691,2875,220267,610,72424,883,8,1199,18,0,37,144444.0,39000.0,-73.0,-70.0,-66.0,-60.0,-72.0,-70.0,-66.0,-60.0,-88.0,-89.0,-87.0,-88.0,15.0,19.0,21.0,28.0,1
832,BA:8C:B9:54:50:24,3836481,489441162,4803,6179165,3831678,483261997,0,8749,1682565,8727,1679070,22,3495,2345,14,5219,38,0,56,229410.0,130000.0,-49.0,-35.0,-43.0,-45.0,-43.0,-36.0,-44.0,-48.0,-88.0,-89.0,-87.0,-88.0,39.0,54.0,44.0,43.0,1
833,92:69:1D:31:68:E9,3835515,486858409,3834,3596150,3831681,483262259,0,4522,1070990,4389,1040970,133,30020,2054,10,4011,84,0,41,216660.0,130000.0,-51.0,-47.0,-45.0,-46.0,-51.0,-47.0,-44.0,-47.0,-88.0,-89.0,-87.0,-88.0,37.0,42.0,42.0,42.0,1
834,CC:2F:71:3F:1F:24,4513622,1210172054,681941,726909795,3831681,483262259,37,550723,571137436,550031,571054112,692,83324,532454,15,682189,74975,34,469,130000.0,39000.0,-69.0,-68.0,-69.0,-70.0,-68.0,-67.0,-69.0,-70.0,-88.0,-89.0,-87.0,-88.0,19.0,21.0,18.0,18.0,1
835,CC:2F:71:3E:C5:1F,3832516,483364316,835,102057,3831681,483262259,0,3485,292691,2875,220267,610,72424,883,8,1199,18,0,37,144444.0,39000.0,-73.0,-70.0,-66.0,-60.0,-72.0,-70.0,-66.0,-60.0,-88.0,-89.0,-87.0,-88.0,15.0,19.0,21.0,28.0,1
836,BA:8C:B9:54:50:24,3836484,489441424,4803,6179165,3831681,483262259,0,8749,1682565,8727,1679070,22,3495,2345,14,5219,38,0,56,229410.0,130000.0,-49.0,-35.0,-43.0,-45.0,-43.0,-36.0,-44.0,-48.0,-88.0,-89.0,-87.0,-88.0,39.0,54.0,44.0,43.0,1
837,92:69:1D:31:68:E9,3835519,486858813,3834,3596150,3831685,483262663,0,4522,1070990,4389,1040970,133,30020,2054,10,4011,84,0,41,216660.0,130000.0,-51.0,-47.0,-45.0,-46.0,-51.0,-47.0,-44.0,-47.0,-88.0,-89.0,-87.0,-88.0,37.0,42.0,42.0,42.0,1
838,CC:2F:71:3F:1F:24,4513665,1210186576,681980,726923913,3831685,483262663,37,550747,571141674,550055,571058350,692,83324,532475,15,682228,74975,34,469,130000.0,43333.0,-69.0,-68.0,-69.0,-70.0,-69.0,-67.0,-68.0,-70.0,-88.0,-89.0,-87.0,-88.0,19.0,21.0,18.0,18.0,1
839,CC:2F:71:3E:C5:1F,3832522,483364922,835,102057,3831687,483262865,0,3485,292691,2875,220267,610,72424,883,8,1199,18,0,37,144444.0,39000.0,-73.0,-70.0,-66.0,-60.0,-72.0,-70.0,-66.0,-60.0,-88.0,-89.0,-87.0,-88.0,15.0,19.0,21.0,28.0,1
840,BA:8C:B9:54:50:24,3836490,489442030,4803,6179165,3831687,483262865,0,8749,1682565,8727,1679070,22,3495,2345,14,5219,38,0,56,229410.0,130000.0,-49.0,-35.0,-43.0,-45.0,-43.0,-36.0,-44.0,-48.0,-88.0,-89.0,-87.0,-88.0,39.0,54.0,44.0,43.0,1
841,92:69:1D:31:68:E9,3835523,486859217,3834,3596150,3831689,483263067,0,4522,1070990,4389,1040970,133,30020,2054,10,4011,84,0,41,216660.0,130000.0,-51.0,-47.0,-45.0,-46.0,-51.0,-47.0,-44.0,-47.0,-88.0,-89.0,-86.0,-88.0,37.0,42.0,41.0,42.0,1
842,CC:2F:71:3F:1F:24,4513708,1210201098,682019,726938031,3831689,483263067,37,550770,571145640,550078,571062316,692,83324,532497,15,682267,74990,34,469,130000.0,39000.0,-69.0,-68.0,-68.0,-70.0,-69.0,-67.0,-68.0,-70.0,-88.0,-89.0,-86.0,-88.0,19.0,21.0,18.0,18.0,1
843,CC:2F:71:3E:C5:1F,3832524,483365124,835,102057,3831689,483263067,0,3485,292691,2875,220267,610,72424,883,8,1199,18,0,37,144444.0,39000.0,-73.0,-70.0,-66.0,-60.0,-72.0,-70.0,-66.0,-60.0,-88.0,-89.0,-86.0,-88.0,15.0,19.0,20.0,28.0,1
844,BA:8C:B9:54:50:24,3836493,489442292,4803,6179165,3831690,483263127,0,8749,1682565,8727,1679070,22,3495,2345,14,5219,38,0,56,229410.0,130000.0,-49.0,-35.0,-43.0,-45.0,-43.0,-36.0,-44.0,-48.0,-88.0,-89.0,-86.0,-88.0,39.0,54.0,43.0,43.0,1
845,92:69:1D:31:68:E9,3835528,486859681,3834,3596150,3831694,483263531,0,4522,1070990,4389,1040970,133,30020,2054,10,4011,84,0,41,216660.0,130000.0,-51.0,-47.0,-45.0,-46.0,-51.0,-47.0,-44.0,-47.0,-88.0,-89.0,-86.0,-88.0,37.0,42.0,41.0,42.0,1
846,CC:2F:71:3F:1F:24,4513755,1210216008,682061,726952477,3831694,483263531,37,550797,571150330,550105,571067006,692,83324,532521,15,682308,75012,34,469,144444.0,43333.0,-69.0,-67.0,-69.0,-70.0,-69.0,-67.0,-68.0,-70.0,-88.0,-89.0,-86.0,-88.0,19.0,22.0,17.0,18.0,1
847,CC:2F:71:3E:C5:1F,3832532,483365906,836,102173,3831696,483263733,0,3486,292761,2876,220337,610,72424,883,8,1200,18,0,37,144444.0,39000.0,-78.0,-80.0,-73.0,-70.0,-73.0,-71.0,-67.0,-61.0,-88.0,-89.0,-86.0,-88.0,10.0,9.0,13.0,18.0,1
848,BA:8C:B9:54:50:24,3836500,489443014,4804,6179281,3831696,483263733,0,8751,1682701,8729,1679206,22,3495,2345,14,5220,38,0,56,229410.0,137640.0,-49.0,-35.0,-43.0,-45.0,-43.0,-36.0,-44.0,-48.0,-88.0,-89.0,-86.0,-88.0,39.0,54.0,43.0,43.0,1
849,92:69:1D:31:68:E9,3835533,486860201,3835,3596266,3831698,483263935,0,4524,1071126,4391,1041106,133,30020,2054,10,4012,84,0,41,216660.0,130000.0,-52.0,-47.0,-45.0,-46.0,-51.0,-47.0,-44.0,-47.0,-88.0,-89.0,-86.0,-88.0,36.0,42.0,41.0,42.0,1
850,CC:2F:71:3F:1F:24,4513802,1210233659,682104,726969724,3831698,483263935,37,550827,571155747,550135,571072423,692,83324,532548,15,682352,75042,34,469,144444.0,43333.0,-69.0,-68.0,-69.0,-70.0,-69.0,-68.0,-69.0,-70.0,-88.0,-89.0,-86.0,-88.0,19.0,21.0,17.0,18.0,1
851,CC:2F:71:3E:C5:1F,3832534,483366108,836,102173,3831698,483263935,0,3487,292831,2877,220407,610,72424,883,8,1200,18,0,37,144444.0,39000.0,-72.0,-71.0,-67.0,-60.0,-73.0,-71.0,-67.0,-61.0,-88.0,-89.0,-86.0,-88.0,16.0,18.0,19.0,28.0,1
852,BA:8C:B9:54:50:24,3836502,489443216,4804,6179281,3831698,483263935,0,8751,1682701,8729,1679206,22,3495,2345,14,5220,38,0,56,229410.0,137640.0,-49.0,-35.0,-43.0,-45.0,-43.0,-36.0,-44.0,-48.0,-87.0,-88.0,-86.0,-87.0,38.0,53.0,43.0,42.0,1
853,92:69:1D:31:68:E9,3835539,486860938,3835,3596266,3831704,483264672,0,4524,1071126,4391,1041106,133,30020,2054,10,4012,84,0,41,216660.0,130000.0,-52.0,-47.0,-45.0,-46.0,-51.0,-47.0,-44.0,-47.0,-87.0,-88.0,-86.0,-87.0,35.0,41.0,41.0,41.0,1
854,CC:2F:71:3F:1F:24,4513849,1210248660,682143,726983786,3831706,483264874,37,550853,571160389,550161,571077065,692,83324,532569,15,682391,75072,34,469,144444.0,43333.0,-69.0,-68.0,-70.0,-71.0,-69.0,-67.0,-69.0,-70.0,-87.0,-88.0,-86.0,-87.0,18.0,20.0,16.0,16.0,1
855,CC:2F:71:3E:C5:1F,3832542,483367047,836,102173,3831706,483264874,0,3487,292831,2877,220407,610,72424,883,8,1200,18,0,37,144444.0,39000.0,-72.0,-71.0,-67.0,-60.0,-73.0,-71.0,-67.0,-61.0,-87.0,-88.0,-86.0,-87.0,15.0,17.0,19.0,27.0,1
856,BA:8C:B9:54:50:24,3836510,489444155,4804,6179281,3831706,483264874,0,8751,1682701,8729,1679206,22,3495,2345,14,5220,38,0,56,229410.0,137640.0,-49.0,-35.0,-43.0,-45.0,-43.0,-36.0,-44.0,-48.0,-87.0,-88.0,-86.0,-87.0,38.0,53.0,43.0,42.0,1
857,92:69:1D:31:68:E9,3835543,486861342,3835,3596266,3831708,483265076,0,4524,1071126,4391,1041106,133,30020,2054,10,4012,84,0,41,216660.0,130000.0,-52.0,-47.0,-45.0,-46.0,-51.0,-47.0,-44.0,-47.0,-87.0,-88.0,-86.0,-87.0,35.0,41.0,41.0,41.0,1
858,CC:2F:71:3F:1F:24,4513891,1210263166,682183,726998090,3831708,483265076,37,550876,571164355,550184,571081031,692,83324,532591,15,682431,75108,34,469,144444.0,43333.0,-69.0,-68.0,-69.0,-71.0,-69.0,-68.0,-68.0,-71.0,-87.0,-88.0,-86.0,-87.0,18.0,20.0,17.0,16.0,1
859,CC:2F:71:3E:C5:1F,3832544,483367249,836,102173,3831708,483265076,0,3487,292831,2877,220407,610,72424,883,8,1200,18,0,37,144444.0,39000.0,-72.0,-71.0,-67.0,-60.0,-73.0,-71.0,-67.0,-61.0,-87.0,-88.0,-86.0,-87.0,15.0,17.0,19.0,27.0,1
860,BA:8C:B9:54:50:24,3836512,489444357,4804,6179281,3831708,483265076,0,8751,1682701,8729,1679206,22,3495,2345,14,5220,38,0,56,229410.0,137640.0,-49.0,-35.0,-43.0,-45.0,-43.0,-36.0,-44.0,-48.0,-87.0,-88.0,-86.0,-87.0,38.0,53.0,43.0,42.0,1
861,92:69:1D:31:68:E9,3835547,486861746,3835,3596266,3831712,483265480,0,4524,1071126,4391,1041106,133,30020,2054,10,4012,84,0,41,216660.0,130000.0,-52.0,-47.0,-45.0,-46.0,-51.0,-47.0,-44.0,-47.0,-87.0,-88.0,-86.0,-87.0,35.0,41.0,41.0,41.0,1
862,CC:2F:71:3F:1F:24,4513945,1210281679,682231,727015997,3831714,483265682,37,550909,571170565,550217,571087241,692,83324,532621,15,682479,75136,34,469,144444.0,43333.0,-69.0,-68.0,-68.0,-70.0,-68.0,-68.0,-68.0,-70.0,-87.0,-88.0,-86.0,-87.0,18.0,20.0,18.0,17.0,1
863,CC:2F:71:3E:C5:1F,3832550,483367855,836,102173,3831714,483265682,0,3487,292831,2877,220407,610,72424,883,8,1200,18,0,37,144444.0,39000.0,-72.0,-71.0,-67.0,-60.0,-73.0,-71.0,-67.0,-61.0,-87.0,-88.0,-86.0,-87.0,15.0,17.0,19.0,27.0,1
864,BA:8C:B9:54:50:24,3836518,489444963,4804,6179281,3831714,483265682,0,8751,1682701,8729,1679206,22,3495,2345,14,5220,38,0,56,229410.0,137640.0,-49.0,-35.0,-43.0,-45.0,-43.0,-36.0,-44.0,-48.0,-87.0,-88.0,-86.0,-87.0,38.0,53.0,43.0,42.0,1
865,92:69:1D:31:68:E9,3835554,486862578,3835,3596266,3831719,483266312,0,4524,1071126,4391,1041106,133,30020,2054,10,4012,84,0,41,216660.0,130000.0,-52.0,-47.0,-45.0,-46.0,-51.0,-47.0,-44.0,-47.0,-87.0,-88.0,-86.0,-87.0,35.0,41.0,41.0,41.0,1
866,CC:2F:71:3F:1F:24,4513990,1210296613,682271,727030301,3831719,483266312,37,550931,571174415,550239,571091091,692,83324,532642,15,682519,75139,34,469,144444.0,43333.0,-69.0,-68.0,-69.0,-72.0,-69.0,-67.0,-68.0,-71.0,-87.0,-88.0,-86.0,-87.0,18.0,20.0,17.0,15.0,1
867,CC:2F:71:3E:C5:1F,3832555,483368485,836,102173,3831719,483266312,0,3487,292831,2877,220407,610,72424,883,8,1200,18,0,37,144444.0,39000.0,-72.0,-71.0,-67.0,-60.0,-73.0,-71.0,-67.0,-61.0,-87.0,-88.0,-86.0,-87.0,15.0,17.0,19.0,27.0,1
868,BA:8C:B9:54:50:24,3836523,489445593,4804,6179281,3831719,483266312,0,8751,1682701,8729,1679206,22,3495,2345,14,5220,38,0,56,229410.0,137640.0,-49.0,-35.0,-43.0,-45.0,-43.0,-36.0,-44.0,-48.0,-87.0,-88.0,-86.0,-87.0,38.0,53.0,43.0,42.0,1
869,92:69:1D:31:68:E9,3835558,486862982,3835,3596266,3831723,483266716,0,4524,1071126,4391,1041106,133,30020,2054,10,4012,84,0,41,216660.0,130000.0,-52.0,-47.0,-45.0,-46.0,-51.0,-47.0,-44.0,-47.0,-87.0,-88.0,-85.0,-87.0,35.0,41.0,40.0,41.0,1
870,CC:2F:71:3F:1F:24,4514036,1210311523,682311,727044605,3831725,483266918,37,550954,571178491,550262,571095167,692,83324,532663,15,682559,75139,34,469,144444.0,43333.0,-70.0,-67.0,-68.0,-71.0,-69.0,-67.0,-68.0,-70.0,-87.0,-88.0,-85.0,-87.0,17.0,21.0,17.0,16.0,1
871,CC:2F:71:3E:C5:1F,3832561,483369091,836,102173,3831725,483266918,0,3487,292831,2877,220407,610,72424,883,8,1200,18,0,37,144444.0,39000.0,-72.0,-71.0,-67.0,-60.0,-73.0,-71.0,-67.0,-61.0,-87.0,-88.0,-85.0,-87.0,15.0,17.0,18.0,27.0,1
872,BA:8C:B9:54:50:24,3836529,489446199,4804,6179281,3831725,483266918,0,8751,1682701,8729,1679206,22,3495,2345,14,5220,38,0,56,229410.0,137640.0,-49.0,-35.0,-43.0,-45.0,-43.0,-36.0,-44.0,-48.0,-87.0,-88.0,-85.0,-87.0,38.0,53.0,42.0,42.0,1
873,92:69:1D:31:68:E9,3835562,486863386,3835,3596266,3831727,483267120,0,4524,1071126,4391,1041106,133,30020,2054,10,4012,84,0,41,216660.0,130000.0,-52.0,-47.0,-45.0,-46.0,-51.0,-47.0,-44.0,-47.0,-87.0,-88.0,-85.0,-87.0,35.0,41.0,40.0,41.0,1
874,CC:2F:71:3F:1F:24,4514077,1210325899,682350,727058779,3831727,483267120,37,550977,571182567,550285,571099243,692,83324,532684,15,682598,75143,34,469,144444.0,43333.0,-70.0,-67.0,-69.0,-70.0,-69.0,-67.0,-68.0,-70.0,-87.0,-88.0,-85.0,-87.0,17.0,21.0,16.0,17.0,1
875,CC:2F:71:3E:C5:1F,3832563,483369293,836,102173,3831727,483267120,0,3487,292831,2877,220407,610,72424,883,8,1200,18,0,37,144444.0,39000.0,-72.0,-71.0,-67.0,-60.0,-73.0,-71.0,-67.0,-61.0,-87.0,-88.0,-85.0,-87.0,15.0,17.0,18.0,27.0,1
876,BA:8C:B9:54:50:24,3836532,489446461,4804,6179281,3831728,483267180,0,8751,1682701,8729,1679206,22,3495,2345,14,5220,38,0,56,229410.0,137640.0,-49.0,-35.0,-43.0,-45.0,-43.0,-36.0,-44.0,-48.0,-87.0,-88.0,-85.0,-87.0,38.0,53.0,42.0,42.0,1
877,92:69:1D:31:68:E9,3835567,486863850,3835,3596266,3831732,483267584,0,4524,1071126,4391,1041106,133,30020,2054,10,4012,84,0,41,216660.0,130000.0,-52.0,-47.0,-45.0,-46.0,-51.0,-47.0,-44.0,-47.0,-87.0,-87.0,-85.0,-86.0,35.0,40.0,40.0,40.0,1
878,CC:2F:71:3F:1F:24,4514121,1210340537,682389,727072953,3831732,483267584,37,551000,571186627,550308,571103303,692,83324,532705,15,682637,75147,34,469,144444.0,43333.0,-70.0,-68.0,-68.0,-70.0,-69.0,-67.0,-68.0,-69.0,-87.0,-87.0,-85.0,-86.0,17.0,19.0,17.0,16.0,1
879,CC:2F:71:3E:C5:1F,3832570,483369959,836,102173,3831734,483267786,0,3488,292901,2878,220477,610,72424,883,8,1201,18,0,37,144444.0,39000.0,-70.0,-69.0,-67.0,-60.0,-72.0,-71.0,-67.0,-61.0,-87.0,-87.0,-85.0,-86.0,17.0,18.0,18.0,26.0,1
880,BA:8C:B9:54:50:24,3836538,489447067,4804,6179281,3831734,483267786,0,8753,1682837,8731,1679342,22,3495,2345,14,5221,38,0,56,229410.0,137640.0,-49.0,-35.0,-43.0,-45.0,-44.0,-36.0,-44.0,-48.0,-87.0,-87.0,-85.0,-86.0,38.0,52.0,42.0,41.0,1
881,92:69:1D:31:68:E9,3835572,486864316,3835,3596266,3831737,483268050,0,4526,1071262,4393,1041242,133,30020,2054,10,4013,84,0,41,216660.0,130000.0,-51.0,-46.0,-42.0,-49.0,-51.0,-47.0,-44.0,-47.0,-87.0,-87.0,-85.0,-86.0,36.0,41.0,43.0,37.0,1
882,CC:2F:71:3F:1F:24,4514173,1210358780,682436,727090730,3831737,483268050,37,551030,571191896,550338,571108572,692,83324,532734,15,682684,75170,34,469,144444.0,43333.0,-69.0,-67.0,-68.0,-69.0,-69.0,-67.0,-68.0,-69.0,-87.0,-87.0,-85.0,-86.0,18.0,20.0,17.0,17.0,1
883,CC:2F:71:3E:C5:1F,3832573,483370223,836,102173,3831737,483268050,0,3491,293159,2880,220617,611,72542,884,8,1201,18,0,37,144444.0,39000.0,-71.0,-71.0,-67.0,-60.0,-72.0,-71.0,-67.0,-61.0,-87.0,-87.0,-85.0,-86.0,16.0,16.0,18.0,26.0,1
884,BA:8C:B9:54:50:24,3836541,489447331,4804,6179281,3831737,483268050,0,8753,1682837,8731,1679342,22,3495,2345,14,5221,38,0,56,229410.0,137640.0,-49.0,-35.0,-43.0,-45.0,-44.0,-36.0,-44.0,-48.0,-87.0,-87.0,-85.0,-86.0,38.0,52.0,42.0,41.0,1
885,92:69:1D:31:68:E9,3835577,486864780,3835,3596266,3831742,483268514,0,4526,1071262,4393,1041242,133,30020,2054,10,4013,84,0,41,216660.0,130000.0,-51.0,-46.0,-42.0,-49.0,-51.0,-47.0,-44.0,-47.0,-87.0,-87.0,-85.0,-86.0,36.0,41.0,43.0,37.0,1
886,CC:2F:71:3F:1F:24,4514217,1210373418,682475,727104904,3831742,483268514,37,551053,571195876,550361,571112552,692,83324,532755,15,682723,75191,34,469,144444.0,43333.0,-70.0,-67.0,-68.0,-70.0,-69.0,-67.0,-68.0,-69.0,-87.0,-87.0,-85.0,-86.0,17.0,20.0,17.0,16.0,1
887,CC:2F:71:3E:C5:1F,3832580,483370889,836,102173,3831744,483268716,0,3491,293159,2880,220617,611,72542,884,8,1201,18,0,37,144444.0,39000.0,-71.0,-71.0,-67.0,-60.0,-72.0,-71.0,-67.0,-61.0,-87.0,-87.0,-85.0,-86.0,16.0,16.0,18.0,26.0,1
888,BA:8C:B9:54:50:24,3836548,489447997,4804,6179281,3831744,483268716,0,8753,1682837,8731,1679342,22,3495,2345,14,5221,38,0,56,229410.0,137640.0,-49.0,-35.0,-43.0,-45.0,-44.0,-36.0,-44.0,-48.0,-87.0,-87.0,-85.0,-86.0,38.0,52.0,42.0,41.0,1
889,92:69:1D:31:68:E9,3835582,486865246,3835,3596266,3831747,483268980,0,4526,1071262,4393,1041242,133,30020,2054,10,4013,84,0,41,216660.0,130000.0,-51.0,-46.0,-42.0,-49.0,-51.0,-47.0,-44.0,-47.0,-87.0,-87.0,-85.0,-86.0,36.0,41.0,43.0,37.0,1
890,CC:2F:71:3F:1F:24,4514260,1210387928,682513,727118948,3831747,483268980,37,551076,571199844,550383,571116402,693,83442,532777,15,682761,75192,34,470,144444.0,43333.0,-69.0,-67.0,-68.0,-70.0,-68.0,-66.0,-68.0,-70.0,-87.0,-87.0,-85.0,-86.0,18.0,20.0,17.0,16.0,1
891,CC:2F:71:3E:C5:1F,3832583,483371153,836,102173,3831747,483268980,0,3491,293159,2880,220617,611,72542,884,8,1201,18,0,37,144444.0,39000.0,-71.0,-71.0,-67.0,-60.0,-72.0,-71.0,-67.0,-61.0,-87.0,-87.0,-85.0,-86.0,16.0,16.0,18.0,26.0,1
892,BA:8C:B9:54:50:24,3836551,489448261,4804,6179281,3831747,483268980,0,8753,1682837,8731,1679342,22,3495,2345,14,5221,38,0,56,229410.0,137640.0,-49.0,-35.0,-43.0,-45.0,-44.0,-36.0,-44.0,-48.0,-87.0,-87.0,-85.0,-86.0,38.0,52.0,42.0,41.0,1
893,92:69:1D:31:68:E9,3835586,486865650,3835,3596266,3831751,483269384,0,4526,1071262,4393,1041242,133,30020,2054,10,4013,84,0,41,216660.0,130000.0,-51.0,-46.0,-42.0,-49.0,-51.0,-47.0,-44.0,-47.0,-86.0,-87.0,-84.0,-86.0,35.0,41.0,42.0,37.0,1
894,CC:2F:71:3F:1F:24,4514303,1210402506,682552,727133122,3831751,483269384,37,551098,571203694,550405,571120252,693,83442,532798,15,682800,75195,34,470,144444.0,43333.0,-69.0,-67.0,-68.0,-70.0,-69.0,-66.0,-68.0,-69.0,-86.0,-87.0,-84.0,-86.0,17.0,20.0,16.0,16.0,1
895,CC:2F:71:3E:C5:1F,3832589,483371759,836,102173,3831753,483269586,0,3491,293159,2880,220617,611,72542,884,8,1201,18,0,37,144444.0,39000.0,-71.0,-71.0,-67.0,-60.0,-72.0,-71.0,-67.0,-61.0,-86.0,-87.0,-84.0,-86.0,15.0,16.0,17.0,26.0,1
896,BA:8C:B9:54:50:24,3836557,489448867,4804,6179281,3831753,483269586,0,8753,1682837,8731,1679342,22,3495,2345,14,5221,38,0,56,229410.0,137640.0,-49.0,-35.0,-43.0,-45.0,-44.0,-36.0,-44.0,-48.0,-86.0,-87.0,-84.0,-86.0,37.0,52.0,41.0,41.0,1
897,92:69:1D:31:68:E9,3835589,486865912,3835,3596266,3831754,483269646,0,4526,1071262,4393,1041242,133,30020,2054,10,4013,84,0,41,216660.0,130000.0,-51.0,-46.0,-42.0,-49.0,-51.0,-47.0,-44.0,-47.0,-86.0,-87.0,-84.0,-86.0,35.0,41.0,42.0,37.0,1
898,CC:2F:71:3F:1F:24,4514356,1210421005,682600,727151157,3831756,483269848,37,551129,571209092,550436,571125650,693,83442,532828,15,682848,75195,34,470,144444.0,43333.0,-69.0,-66.0,-69.0,-71.0,-69.0,-66.0,-68.0,-70.0,-86.0,-87.0,-84.0,-86.0,17.0,21.0,15.0,15.0,1
899,CC:2F:71:3E:C5:1F,3832592,483372021,836,102173,3831756,483269848,0,3491,293159,2880,220617,611,72542,884,8,1201,18,0,37,144444.0,39000.0,-71.0,-71.0,-67.0,-60.0,-72.0,-71.0,-67.0,-61.0,-86.0,-87.0,-84.0,-86.0,15.0,16.0,17.0,26.0,1
900,BA:8C:B9:54:50:24,3836560,489449129,4804,6179281,3831756,483269848,0,8753,1682837,8731,1679342,22,3495,2345,14,5221,38,0,56,229410.0,137640.0,-49.0,-35.0,-43.0,-45.0,-44.0,-36.0,-44.0,-48.0,-86.0,-87.0,-84.0,-86.0,37.0,52.0,41.0,41.0,1
901,92:69:1D:31:68:E9,3835595,486866518,3835,3596266,3831760,483270252,0,4526,1071262,4393,1041242,133,30020,2054,10,4013,84,0,41,216660.0,130000.0,-51.0,-46.0,-42.0,-49.0,-51.0,-47.0,-44.0,-47.0,-86.0,-87.0,-84.0,-86.0,35.0,41.0,42.0,37.0,1
902,CC:2F:71:3F:1F:24,4514400,1210435713,682640,727165461,3831760,483270252,37,551151,571212942,550458,571129500,693,83442,532849,15,682888,75204,34,470,144444.0,43333.0,-69.0,-67.0,-68.0,-69.0,-69.0,-67.0,-68.0,-69.0,-86.0,-87.0,-84.0,-86.0,17.0,20.0,16.0,17.0,1
903,CC:2F:71:3E:C5:1F,3832598,483372627,836,102173,3831762,483270454,0,3491,293159,2880,220617,611,72542,884,8,1201,18,0,37,144444.0,39000.0,-71.0,-71.0,-67.0,-60.0,-72.0,-71.0,-67.0,-61.0,-86.0,-87.0,-84.0,-86.0,15.0,16.0,17.0,26.0,1
904,BA:8C:B9:54:50:24,3836566,489449735,4804,6179281,3831762,483270454,0,8753,1682837,8731,1679342,22,3495,2345,14,5221,38,0,56,229410.0,137640.0,-49.0,-35.0,-43.0,-45.0,-44.0,-36.0,-44.0,-48.0,-86.0,-87.0,-84.0,-86.0,37.0,52.0,41.0,41.0,1
905,92:69:1D:31:68:E9,3835597,486866720,3835,3596266,3831762,483270454,0,4526,1071262,4393,1041242,133,30020,2054,10,4013,84,0,41,216660.0,130000.0,-51.0,-46.0,-42.0,-49.0,-51.0,-47.0,-44.0,-47.0,-86.0,-87.0,-84.0,-86.0,35.0,41.0,42.0,37.0,1
906,CC:2F:71:3F:1F:24,4514445,1210450679,682681,727180023,3831764,483270656,37,551175,571217036,550482,571133594,693,83442,532872,15,682929,75206,34,470,144444.0,43333.0,-69.0,-66.0,-68.0,-70.0,-69.0,-66.0,-68.0,-70.0,-86.0,-87.0,-84.0,-86.0,17.0,21.0,16.0,16.0,1
907,CC:2F:71:3E:C5:1F,3832601,483373102,836,102173,3831765,483270929,0,3491,293159,2880,220617,611,72542,884,8,1201,18,0,37,144444.0,39000.0,-71.0,-71.0,-67.0,-60.0,-72.0,-71.0,-67.0,-61.0,-86.0,-87.0,-84.0,-86.0,15.0,16.0,17.0,26.0,1
908,BA:8C:B9:54:50:24,3836570,489450270,4804,6179281,3831766,483270989,0,8753,1682837,8731,1679342,22,3495,2345,14,5221,38,0,56,229410.0,137640.0,-49.0,-35.0,-43.0,-45.0,-44.0,-36.0,-44.0,-48.0,-86.0,-87.0,-84.0,-86.0,37.0,52.0,41.0,41.0,1
909,92:69:1D:31:68:E9,3835603,486867457,3835,3596266,3831768,483271191,0,4526,1071262,4393,1041242,133,30020,2054,10,4013,84,0,41,216660.0,130000.0,-51.0,-46.0,-42.0,-49.0,-51.0,-47.0,-44.0,-47.0,-86.0,-86.0,-84.0,-85.0,35.0,40.0,42.0,36.0,1
910,CC:2F:71:3F:1F:24,4514488,1210465388,682720,727194197,3831768,483271191,37,551200,571221376,550507,571137934,693,83442,532895,15,682968,75218,34,470,144444.0,43333.0,-69.0,-67.0,-69.0,-70.0,-69.0,-67.0,-68.0,-70.0,-86.0,-86.0,-84.0,-85.0,17.0,19.0,15.0,15.0,1
911,CC:2F:71:3E:C5:1F,3832608,483373768,836,102173,3831772,483271595,0,3491,293159,2880,220617,611,72542,884,8,1201,18,0,37,144444.0,39000.0,-71.0,-71.0,-67.0,-60.0,-72.0,-71.0,-67.0,-61.0,-86.0,-86.0,-84.0,-85.0,15.0,15.0,17.0,25.0,1
912,BA:8C:B9:54:50:24,3836576,489450876,4804,6179281,3831772,483271595,0,8754,1682905,8732,1679410,22,3495,2345,14,5221,38,0,56,229410.0,137640.0,-40.0,-37.0,-46.0,-51.0,-43.0,-36.0,-44.0,-48.0,-86.0,-86.0,-84.0,-85.0,46.0,49.0,38.0,34.0,1
913,92:69:1D:31:68:E9,3835607,486867861,3835,3596266,3831772,483271595,0,4526,1071262,4393,1041242,133,30020,2054,10,4013,84,0,41,216660.0,130000.0,-51.0,-46.0,-42.0,-49.0,-51.0,-47.0,-44.0,-47.0,-86.0,-86.0,-84.0,-85.0,35.0,40.0,42.0,36.0,1
914,CC:2F:71:3F:1F:24,4514539,1210484001,682767,727212406,3831772,483271595,37,551234,571227075,550541,571143633,693,83442,532927,15,683015,75231,34,470,144444.0,43333.0,-70.0,-67.0,-69.0,-71.0,-69.0,-67.0,-68.0,-70.0,-86.0,-86.0,-84.0,-85.0,16.0,19.0,15.0,14.0,1
915,CC:2F:71:3E:C5:1F,3832610,483373970,836,102173,3831774,483271797,0,3491,293159,2880,220617,611,72542,884,8,1201,18,0,37,144444.0,39000.0,-71.0,-71.0,-67.0,-60.0,-72.0,-71.0,-67.0,-61.0,-86.0,-86.0,-84.0,-85.0,15.0,15.0,17.0,25.0,1
916,BA:8C:B9:54:50:24,3836578,489451078,4804,6179281,3831774,483271797,0,8754,1682905,8732,1679410,22,3495,2345,14,5221,38,0,56,229410.0,137640.0,-40.0,-37.0,-46.0,-51.0,-43.0,-36.0,-44.0,-48.0,-86.0,-86.0,-84.0,-85.0,46.0,49.0,38.0,34.0,1
917,92:69:1D:31:68:E9,3835612,486868325,3835,3596266,3831777,483272059,0,4526,1071262,4393,1041242,133,30020,2054,10,4013,84,0,41,216660.0,130000.0,-51.0,-46.0,-42.0,-49.0,-51.0,-47.0,-44.0,-47.0,-86.0,-86.0,-84.0,-85.0,35.0,40.0,42.0,36.0,1
918,CC:2F:71:3F:1F:24,4514585,1210498899,682808,727226840,3831777,483272059,37,551260,571231343,550567,571147901,693,83442,532951,15,683056,75243,34,470,144444.0,43333.0,-69.0,-67.0,-69.0,-70.0,-69.0,-67.0,-68.0,-70.0,-86.0,-86.0,-84.0,-85.0,17.0,19.0,15.0,15.0,1
919,CC:2F:71:3E:C5:1F,3832615,483374434,836,102173,3831779,483272261,0,3491,293159,2880,220617,611,72542,884,8,1201,18,0,37,144444.0,39000.0,-71.0,-71.0,-67.0,-60.0,-72.0,-71.0,-67.0,-61.0,-86.0,-86.0,-84.0,-85.0,15.0,15.0,17.0,25.0,1
920,BA:8C:B9:54:50:24,3836585,489451744,4804,6179281,3831781,483272463,0,8754,1682905,8732,1679410,22,3495,2345,14,5221,38,0,56,229410.0,137640.0,-40.0,-37.0,-46.0,-51.0,-43.0,-36.0,-44.0,-48.0,-86.0,-86.0,-84.0,-85.0,46.0,49.0,38.0,34.0,1
921,92:69:1D:31:68:E9,3835616,486868729,3835,3596266,3831781,483272463,0,4526,1071262,4393,1041242,133,30020,2054,10,4013,84,0,41,216660.0,130000.0,-51.0,-46.0,-42.0,-49.0,-51.0,-47.0,-44.0,-47.0,-86.0,-86.0,-84.0,-85.0,35.0,40.0,42.0,36.0,1
922,CC:2F:71:3F:1F:24,4514628,1210513477,682847,727241014,3831781,483272463,37,551285,571235727,550592,571152285,693,83442,532972,15,683095,75245,34,470,144444.0,43333.0,-69.0,-67.0,-69.0,-70.0,-69.0,-67.0,-68.0,-69.0,-86.0,-86.0,-84.0,-85.0,17.0,19.0,15.0,15.0,1
923,CC:2F:71:3E:C5:1F,3832617,483374636,836,102173,3831781,483272463,0,3491,293159,2880,220617,611,72542,884,8,1201,18,0,37,144444.0,39000.0,-71.0,-71.0,-67.0,-60.0,-72.0,-71.0,-67.0,-61.0,-86.0,-86.0,-84.0,-85.0,15.0,15.0,17.0,25.0,1
924,BA:8C:B9:54:50:24,3836585,489451744,4804,6179281,3831781,483272463,0,8754,1682905,8732,1679410,22,3495,2345,14,5221,38,0,56,229410.0,137640.0,-40.0,-37.0,-46.0,-51.0,-43.0,-36.0,-44.0,-48.0,-86.0,-86.0,-84.0,-85.0,46.0,49.0,38.0,34.0,1
925,92:69:1D:31:68:E9,3835620,486869133,3835,3596266,3831785,483272867,0,4526,1071262,4393,1041242,133,30020,2054,10,4013,84,0,41,216660.0,130000.0,-51.0,-46.0,-42.0,-49.0,-51.0,-47.0,-44.0,-47.0,-86.0,-86.0,-84.0,-85.0,35.0,40.0,42.0,36.0,1
926,CC:2F:71:3F:1F:24,4514673,1210528329,682886,727255260,3831787,483273069,37,551312,571240169,550619,571156727,693,83442,532998,15,683134,75253,34,470,130000.0,39000.0,-69.0,-67.0,-68.0,-69.0,-69.0,-66.0,-67.0,-69.0,-86.0,-86.0,-84.0,-85.0,17.0,19.0,16.0,16.0,1
927,CC:2F:71:3E:C5:1F,3832623,483375242,836,102173,3831787,483273069,0,3491,293159,2880,220617,611,72542,884,8,1201,18,0,37,144444.0,39000.0,-71.0,-71.0,-67.0,-60.0,-72.0,-71.0,-67.0,-61.0,-86.0,-86.0,-84.0,-85.0,15.0,15.0,17.0,25.0,1
928,BA:8C:B9:54:50:24,3836593,489452552,4804,6179281,3831789,483273271,0,8754,1682905,8732,1679410,22,3495,2345,14,5221,38,0,56,229410.0,137640.0,-40.0,-37.0,-46.0,-51.0,-43.0,-36.0,-44.0,-48.0,-86.0,-86.0,-84.0,-85.0,46.0,49.0,38.0,34.0,1
929,92:69:1D:31:68:E9,3835625,486869597,3835,3596266,3831790,483273331,0,4526,1071262,4393,1041242,133,30020,2054,10,4013,84,0,41,216660.0,130000.0,-51.0,-46.0,-42.0,-49.0,-51.0,-47.0,-44.0,-47.0,-86.0,-86.0,-84.0,-85.0,35.0,40.0,42.0,36.0,1
930,CC:2F:71:3F:1F:24,4514723,1210546256,682933,727272925,3831790,483273331,37,551345,571246006,550652,571162564,693,83442,533026,15,683181,75259,34,470,144444.0,43333.0,-70.0,-66.0,-65.0,-69.0,-69.0,-66.0,-67.0,-69.0,-86.0,-86.0,-84.0,-85.0,16.0,20.0,19.0,16.0,1
931,CC:2F:71:3E:C5:1F,3832626,483375504,836,102173,3831790,483273331,0,3491,293159,2880,220617,611,72542,884,8,1201,18,0,37,144444.0,39000.0,-71.0,-71.0,-67.0,-60.0,-72.0,-71.0,-67.0,-61.0,-86.0,-86.0,-84.0,-85.0,15.0,15.0,17.0,25.0,1
932,BA:8C:B9:54:50:24,3836594,489452612,4804,6179281,3831790,483273331,0,8754,1682905,8732,1679410,22,3495,2345,14,5221,38,0,56,229410.0,137640.0,-40.0,-37.0,-46.0,-51.0,-43.0,-36.0,-44.0,-48.0,-86.0,-86.0,-84.0,-85.0,46.0,49.0,38.0,34.0,1
933,92:69:1D:31:68:E9,3835629,486870001,3835,3596266,3831794,483273735,0,4526,1071262,4393,1041242,133,30020,2054,10,4013,84,0,41,216660.0,130000.0,-51.0,-46.0,-42.0,-49.0,-51.0,-47.0,-44.0,-47.0,-86.0,-86.0,-84.0,-85.0,35.0,40.0,42.0,36.0,1
934,CC:2F:71:3F:1F:24,4514768,1210561036,682972,727287099,3831796,483273937,37,551368,571250192,550675,571166750,693,83442,533046,15,683220,75277,34,470,144444.0,43333.0,-69.0,-66.0,-68.0,-70.0,-69.0,-66.0,-67.0,-70.0,-86.0,-86.0,-84.0,-85.0,17.0,20.0,16.0,15.0,1
935,CC:2F:71:3E:C5:1F,3832632,483376110,836,102173,3831796,483273937,0,3491,293159,2880,220617,611,72542,884,8,1201,18,0,37,144444.0,39000.0,-71.0,-71.0,-67.0,-60.0,-72.0,-71.0,-67.0,-61.0,-86.0,-86.0,-84.0,-85.0,15.0,15.0,17.0,25.0,1
936,BA:8C:B9:54:50:24,3836602,489453420,4804,6179281,3831798,483274139,0,8754,1682905,8732,1679410,22,3495,2345,14,5221,38,0,56,229410.0,137640.0,-40.0,-37.0,-46.0,-51.0,-43.0,-36.0,-44.0,-48.0,-86.0,-86.0,-84.0,-85.0,46.0,49.0,38.0,34.0,1
937,92:69:1D:31:68:E9,3835633,486870405,3835,3596266,3831798,483274139,0,4526,1071262,4393,1041242,133,30020,2054,10,4013,84,0,41,216660.0,130000.0,-51.0,-46.0,-42.0,-49.0,-51.0,-47.0,-44.0,-47.0,-86.0,-86.0,-84.0,-85.0,35.0,40.0,42.0,36.0,1
938,CC:2F:71:3F:1F:24,4515007,1210822811,683209,727548672,3831798,483274139,37,551490,571269272,550797,571185830,693,83442,533162,15,683457,75408,34,470,130000.0,43333.0,-69.0,-66.0,-67.0,-71.0,-69.0,-66.0,-68.0,-69.0,-86.0,-86.0,-84.0,-85.0,17.0,20.0,17.0,14.0,1
939,CC:2F:71:3E:C5:1F,3832635,483376372,836,102173,3831799,483274199,0,3491,293159,2880,220617,611,72542,884,8,1201,18,0,37,144444.0,39000.0,-71.0,-71.0,-67.0,-60.0,-72.0,-71.0,-67.0,-61.0,-86.0,-86.0,-84.0,-85.0,15.0,15.0,17.0,25.0,1
940,BA:8C:B9:54:50:24,3836603,489453480,4804,6179281,3831799,483274199,0,8754,1682905,8732,1679410,22,3495,2345,14,5221,38,0,56,229410.0,137640.0,-40.0,-37.0,-46.0,-51.0,-43.0,-36.0,-44.0,-48.0,-86.0,-86.0,-84.0,-85.0,46.0,49.0,38.0,34.0,1
941,92:69:1D:31:68:E9,3835638,486870869,3835,3596266,3831803,483274603,0,4526,1071262,4393,1041242,133,30020,2054,10,4013,84,0,41,216660.0,130000.0,-51.0,-46.0,-42.0,-49.0,-51.0,-47.0,-44.0,-47.0,-86.0,-86.0,-84.0,-85.0,35.0,40.0,42.0,36.0,1
942,CC:2F:71:3F:1F:24,4515390,1211288573,683585,728013768,3831805,483274805,37,551646,571292487,550953,571209045,693,83442,533316,15,683833,75425,34,470,130000.0,43333.0,-69.0,-66.0,-64.0,-70.0,-69.0,-66.0,-66.0,-70.0,-86.0,-86.0,-84.0,-85.0,17.0,20.0,20.0,15.0,1
943,CC:2F:71:3E:C5:1F,3832641,483376978,836,102173,3831805,483274805,0,3491,293159,2880,220617,611,72542,884,8,1201,18,0,37,144444.0,39000.0,-71.0,-71.0,-67.0,-60.0,-72.0,-71.0,-67.0,-61.0,-86.0,-86.0,-84.0,-85.0,15.0,15.0,17.0,25.0,1
944,BA:8C:B9:54:50:24,3836611,489454288,4804,6179281,3831807,483275007,0,8754,1682905,8732,1679410,22,3495,2345,14,5221,38,0,56,229410.0,137640.0,-40.0,-37.0,-46.0,-51.0,-43.0,-36.0,-44.0,-48.0,-86.0,-86.0,-84.0,-85.0,46.0,49.0,38.0,34.0,1
945,92:69:1D:31:68:E9,3835642,486871273,3835,3596266,3831807,483275007,0,4526,1071262,4393,1041242,133,30020,2054,10,4013,84,0,41,216660.0,130000.0,-51.0,-46.0,-42.0,-49.0,-51.0,-47.0,-44.0,-47.0,-86.0,-86.0,-84.0,-85.0,35.0,40.0,42.0,36.0,1
946,CC:2F:71:3F:1F:24,4515674,1211588949,683867,728313942,3831807,483275007,37,551794,571315187,551101,571231745,693,83442,533457,15,684115,75427,34,471,130000.0,43333.0,-69.0,-66.0,-66.0,-70.0,-68.0,-66.0,-67.0,-70.0,-86.0,-86.0,-84.0,-85.0,17.0,20.0,18.0,15.0,1
947,CC:2F:71:3E:C5:1F,3832643,483377180,836,102173,3831807,483275007,0,3491,293159,2880,220617,611,72542,884,8,1201,18,0,37,144444.0,39000.0,-71.0,-71.0,-67.0,-60.0,-72.0,-71.0,-67.0,-61.0,-86.0,-86.0,-84.0,-85.0,15.0,15.0,17.0,25.0,1
948,BA:8C:B9:54:50:24,3836611,489454288,4804,6179281,3831807,483275007,0,8754,1682905,8732,1679410,22,3495,2345,14,5221,38,0,56,229410.0,137640.0,-40.0,-37.0,-46.0,-51.0,-43.0,-36.0,-44.0,-48.0,-85.0,-85.0,-83.0,-84.0,45.0,48.0,37.0,33.0,1
949,92:69:1D:31:68:E9,3835647,486871737,3835,3596266,3831812,483275471,0,4526,1071262,4393,1041242,133,30020,2054,10,4013,84,0,41,216660.0,130000.0,-51.0,-46.0,-42.0,-49.0,-51.0,-47.0,-44.0,-47.0,-85.0,-85.0,-83.0,-84.0,34.0,39.0,41.0,35.0,1
950,CC:2F:71:3F:1F:24,4515719,1211603717,683907,728328246,3831812,483275471,37,551817,571319295,551124,571235853,693,83442,533478,15,684155,75427,34,471,130000.0,43333.0,-69.0,-66.0,-68.0,-69.0,-68.0,-66.0,-67.0,-69.0,-85.0,-85.0,-83.0,-84.0,16.0,19.0,15.0,15.0,1
951,CC:2F:71:3E:C5:1F,3832650,483377846,836,102173,3831814,483275673,0,3491,293159,2880,220617,611,72542,884,8,1201,18,0,37,144444.0,39000.0,-71.0,-71.0,-67.0,-60.0,-72.0,-71.0,-67.0,-61.0,-85.0,-85.0,-83.0,-84.0,14.0,14.0,16.0,24.0,1
952,BA:8C:B9:54:50:24,3836620,489455156,4804,6179281,3831816,483275875,0,8754,1682905,8732,1679410,22,3495,2345,14,5221,38,0,56,229410.0,137640.0,-40.0,-37.0,-46.0,-51.0,-43.0,-36.0,-44.0,-48.0,-85.0,-85.0,-83.0,-84.0,45.0,48.0,37.0,33.0,1
953,92:69:1D:31:68:E9,3835652,486872257,3836,3596382,3831816,483275875,0,4528,1071398,4395,1041378,133,30020,2054,10,4014,84,0,41,216660.0,130000.0,-52.0,-48.0,-44.0,-46.0,-51.0,-47.0,-44.0,-46.0,-85.0,-85.0,-83.0,-84.0,33.0,37.0,39.0,38.0,1
954,CC:2F:71:3F:1F:24,4515763,1211618287,683946,728342350,3831817,483275937,37,551841,571323287,551147,571239727,694,83560,533499,15,684194,75428,34,472,130000.0,39000.0,-69.0,-66.0,-68.0,-69.0,-68.0,-66.0,-67.0,-69.0,-85.0,-85.0,-83.0,-84.0,16.0,19.0,15.0,15.0,1
955,CC:2F:71:3E:C5:1F,3832654,483378226,837,102289,3831817,483275937,0,3493,293299,2882,220757,611,72542,884,8,1202,18,0,37,144444.0,39000.0,-71.0,-70.0,-68.0,-60.0,-72.0,-71.0,-67.0,-61.0,-85.0,-85.0,-83.0,-84.0,14.0,15.0,15.0,24.0,1
956,BA:8C:B9:54:50:24,3836622,489455278,4805,6179341,3831817,483275937,0,8756,1683041,8734,1679546,22,3495,2345,14,5222,38,0,56,216660.0,130000.0,-49.0,-35.0,-43.0,-45.0,-45.0,-35.0,-44.0,-47.0,-85.0,-85.0,-83.0,-84.0,36.0,50.0,40.0,39.0,1
957,92:69:1D:31:68:E9,3835658,486872785,3836,3596382,3831822,483276403,0,4528,1071398,4395,1041378,133,30020,2054,10,4014,84,0,41,216660.0,130000.0,-52.0,-48.0,-44.0,-46.0,-51.0,-47.0,-44.0,-46.0,-85.0,-85.0,-83.0,-84.0,33.0,37.0,39.0,38.0,1
958,CC:2F:71:3F:1F:24,4515806,1211632685,683984,728356282,3831822,483276403,37,551864,571327253,551170,571243693,694,83560,533521,15,684232,75440,34,472,144444.0,43333.0,-69.0,-67.0,-68.0,-70.0,-68.0,-66.0,-68.0,-69.0,-85.0,-85.0,-83.0,-84.0,16.0,18.0,15.0,14.0,1
959,CC:2F:71:3E:C5:1F,3832661,483378894,837,102289,3831824,483276605,0,3495,293487,2883,220827,612,72660,885,8,1202,18,0,37,144444.0,39000.0,-72.0,-70.0,-67.0,-60.0,-71.0,-70.0,-67.0,-60.0,-85.0,-85.0,-83.0,-84.0,13.0,15.0,16.0,24.0,1
960,BA:8C:B9:54:50:24,3836629,489455946,4805,6179341,3831824,483276605,0,8756,1683041,8734,1679546,22,3495,2345,14,5222,38,0,56,216660.0,130000.0,-49.0,-35.0,-43.0,-45.0,-45.0,-35.0,-44.0,-47.0,-85.0,-85.0,-83.0,-84.0,36.0,50.0,40.0,39.0,1
961,92:69:1D:31:68:E9,3835664,486873522,3836,3596382,3831828,483277140,0,4528,1071398,4395,1041378,133,30020,2054,10,4014,84,0,41,216660.0,130000.0,-52.0,-48.0,-44.0,-46.0,-51.0,-47.0,-44.0,-46.0,-85.0,-85.0,-83.0,-84.0,33.0,37.0,39.0,38.0,1
962,CC:2F:71:3F:1F:24,4515867,1211651316,684039,728374176,3831828,483277140,37,551912,571335185,551218,571251625,694,83560,533566,15,684287,75453,34,472,130000.0,43333.0,-69.0,-67.0,-65.0,-69.0,-69.0,-66.0,-67.0,-69.0,-85.0,-85.0,-83.0,-84.0,16.0,18.0,18.0,15.0,1
963,CC:2F:71:3E:C5:1F,3832665,483379429,837,102289,3831828,483277140,0,3495,293487,2883,220827,612,72660,885,8,1202,18,0,37,144444.0,39000.0,-72.0,-70.0,-67.0,-60.0,-71.0,-70.0,-67.0,-60.0,-85.0,-85.0,-83.0,-84.0,13.0,15.0,16.0,24.0,1
964,BA:8C:B9:54:50:24,3836633,489456481,4805,6179341,3831828,483277140,0,8756,1683041,8734,1679546,22,3495,2345,14,5222,38,0,56,216660.0,130000.0,-49.0,-35.0,-43.0,-45.0,-45.0,-35.0,-44.0,-47.0,-85.0,-85.0,-83.0,-84.0,36.0,50.0,40.0,39.0,1
965,92:69:1D:31:68:E9,3835668,486873926,3836,3596382,3831832,483277544,0,4528,1071398,4395,1041378,133,30020,2054,10,4014,84,0,41,216660.0,130000.0,-52.0,-48.0,-44.0,-46.0,-51.0,-47.0,-44.0,-46.0,-85.0,-85.0,-82.0,-84.0,33.0,37.0,38.0,38.0,1
966,CC:2F:71:3F:1F:24,4515918,1211667745,684086,728390201,3831832,483277544,37,551947,571340854,551253,571257294,694,83560,533598,15,684334,75464,34,472,130000.0,39000.0,-70.0,-67.0,-69.0,-71.0,-70.0,-67.0,-69.0,-71.0,-85.0,-85.0,-82.0,-84.0,15.0,18.0,13.0,13.0,1
967,CC:2F:71:3E:C5:1F,3832671,483380035,837,102289,3831834,483277746,0,3495,293487,2883,220827,612,72660,885,8,1202,18,0,37,144444.0,39000.0,-72.0,-70.0,-67.0,-60.0,-71.0,-70.0,-67.0,-60.0,-85.0,-85.0,-82.0,-84.0,13.0,15.0,15.0,24.0,1
968,BA:8C:B9:54:50:24,3836639,489457087,4805,6179341,3831834,483277746,0,8756,1683041,8734,1679546,22,3495,2345,14,5222,38,0,56,216660.0,130000.0,-49.0,-35.0,-43.0,-45.0,-45.0,-35.0,-44.0,-47.0,-85.0,-85.0,-82.0,-84.0,36.0,50.0,39.0,39.0,1
969,92:69:1D:31:68:E9,3835672,486874330,3836,3596382,3831836,483277948,0,4528,1071398,4395,1041378,133,30020,2054,10,4014,84,0,41,216660.0,130000.0,-52.0,-48.0,-44.0,-46.0,-51.0,-47.0,-44.0,-46.0,-85.0,-85.0,-82.0,-84.0,33.0,37.0,38.0,38.0,1
970,CC:2F:71:3F:1F:24,4515960,1211682081,684124,728404133,3831836,483277948,37,551972,571345006,551278,571261446,694,83560,533621,15,684372,75471,34,472,144444.0,43333.0,-71.0,-68.0,-70.0,-72.0,-70.0,-67.0,-70.0,-72.0,-85.0,-85.0,-82.0,-84.0,14.0,17.0,12.0,12.0,1
971,CC:2F:71:3E:C5:1F,3832674,483380297,837,102289,3831837,483278008,0,3495,293487,2883,220827,612,72660,885,8,1202,18,0,37,144444.0,39000.0,-72.0,-70.0,-67.0,-60.0,-71.0,-70.0,-67.0,-60.0,-85.0,-85.0,-82.0,-84.0,13.0,15.0,15.0,24.0,1
972,BA:8C:B9:54:50:24,3836642,489457349,4805,6179341,3831837,483278008,0,8756,1683041,8734,1679546,22,3495,2345,14,5222,38,0,56,216660.0,130000.0,-49.0,-35.0,-43.0,-45.0,-45.0,-35.0,-44.0,-47.0,-85.0,-85.0,-82.0,-84.0,36.0,50.0,39.0,39.0,1
973,92:69:1D:31:68:E9,3835675,486874592,3836,3596382,3831839,483278210,0,4528,1071398,4395,1041378,133,30020,2054,10,4014,84,0,41,216660.0,130000.0,-52.0,-48.0,-44.0,-46.0,-51.0,-47.0,-44.0,-46.0,-84.0,-85.0,-82.0,-83.0,32.0,37.0,38.0,37.0,1
974,CC:2F:71:3F:1F:24,4516012,1211697783,684171,728419371,3831841,483278412,37,552004,571350118,551310,571266558,694,83560,533652,15,684419,75475,34,472,144444.0,43333.0,-74.0,-71.0,-73.0,-75.0,-73.0,-70.0,-73.0,-75.0,-84.0,-85.0,-82.0,-83.0,10.0,14.0,9.0,8.0,1
975,CC:2F:71:3E:C5:1F,3832680,483380903,837,102289,3831843,483278614,0,3495,293487,2883,220827,612,72660,885,8,1202,18,0,37,144444.0,39000.0,-72.0,-70.0,-67.0,-60.0,-71.0,-70.0,-67.0,-60.0,-84.0,-85.0,-82.0,-83.0,12.0,15.0,15.0,23.0,1
976,BA:8C:B9:54:50:24,3836648,489457955,4805,6179341,3831843,483278614,0,8756,1683041,8734,1679546,22,3495,2345,14,5222,38,0,56,216660.0,130000.0,-49.0,-35.0,-43.0,-45.0,-45.0,-35.0,-44.0,-47.0,-84.0,-85.0,-82.0,-83.0,35.0,50.0,39.0,38.0,1
977,92:69:1D:31:68:E9,3835681,486875198,3836,3596382,3831845,483278816,0,4528,1071398,4395,1041378,133,30020,2054,10,4014,84,0,41,216660.0,130000.0,-52.0,-48.0,-44.0,-46.0,-51.0,-47.0,-44.0,-46.0,-84.0,-85.0,-82.0,-83.0,32.0,37.0,38.0,37.0,1
978,CC:2F:71:3F:1F:24,4516056,1211712491,684211,728433675,3831845,483278816,37,552030,571354449,551336,571270889,694,83560,533676,15,684459,75484,34,472,144444.0,43333.0,-73.0,-70.0,-72.0,-74.0,-73.0,-69.0,-72.0,-74.0,-84.0,-85.0,-82.0,-83.0,11.0,15.0,10.0,9.0,1
979,CC:2F:71:3E:C5:1F,3832682,483381105,837,102289,3831845,483278816,0,3495,293487,2883,220827,612,72660,885,8,1202,18,0,37,144444.0,39000.0,-72.0,-70.0,-67.0,-60.0,-71.0,-70.0,-67.0,-60.0,-84.0,-85.0,-82.0,-83.0,12.0,15.0,15.0,23.0,1
980,BA:8C:B9:54:50:24,3836650,489458157,4805,6179341,3831845,483278816,0,8756,1683041,8734,1679546,22,3495,2345,14,5222,38,0,56,216660.0,130000.0,-49.0,-35.0,-43.0,-45.0,-45.0,-35.0,-44.0,-47.0,-84.0,-85.0,-82.0,-83.0,35.0,50.0,39.0,38.0,1
981,92:69:1D:31:68:E9,3835684,486875460,3836,3596382,3831848,483279078,0,4528,1071398,4395,1041378,133,30020,2054,10,4014,84,0,41,216660.0,130000.0,-52.0,-48.0,-44.0,-46.0,-51.0,-47.0,-44.0,-46.0,-84.0,-85.0,-82.0,-83.0,32.0,37.0,38.0,37.0,1
982,CC:2F:71:3F:1F:24,4516107,1211730490,684257,728451210,3831850,483279280,37,552058,571359485,551364,571275925,694,83560,533703,15,684505,75510,34,472,144444.0,43333.0,-77.0,-72.0,-73.0,-74.0,-76.0,-71.0,-71.0,-73.0,-84.0,-85.0,-82.0,-83.0,7.0,13.0,9.0,9.0,1
983,CC:2F:71:3E:C5:1F,3832689,483381771,837,102289,3831852,483279482,0,3495,293487,2883,220827,612,72660,885,8,1202,18,0,37,144444.0,39000.0,-72.0,-70.0,-67.0,-60.0,-71.0,-70.0,-67.0,-60.0,-84.0,-85.0,-82.0,-83.0,12.0,15.0,15.0,23.0,1
984,BA:8C:B9:54:50:24,3836657,489458823,4805,6179341,3831852,483279482,0,8756,1683041,8734,1679546,22,3495,2345,14,5222,38,0,56,216660.0,130000.0,-49.0,-35.0,-43.0,-45.0,-45.0,-35.0,-44.0,-47.0,-84.0,-85.0,-82.0,-83.0,35.0,50.0,39.0,38.0,1
985,92:69:1D:31:68:E9,3835690,486876066,3836,3596382,3831854,483279684,0,4530,1071534,4397,1041514,133,30020,2054,10,4015,84,0,41,216660.0,130000.0,-51.0,-47.0,-45.0,-47.0,-51.0,-47.0,-44.0,-46.0,-84.0,-84.0,-82.0,-83.0,33.0,37.0,37.0,36.0,1
986,CC:2F:71:3F:1F:24,4516149,1211744938,684295,728465254,3831854,483279684,37,552079,571363219,551385,571279659,694,83560,533723,15,684543,75560,34,472,130000.0,43333.0,-76.0,-71.0,-72.0,-75.0,-76.0,-71.0,-71.0,-74.0,-84.0,-84.0,-82.0,-83.0,8.0,13.0,10.0,8.0,1
987,CC:2F:71:3E:C5:1F,3832691,483381973,837,102289,3831854,483279684,0,3497,293627,2885,220967,612,72660,885,8,1203,18,0,37,144444.0,39000.0,-71.0,-70.0,-67.0,-60.0,-71.0,-70.0,-67.0,-60.0,-84.0,-84.0,-82.0,-83.0,13.0,14.0,15.0,23.0,1
988,BA:8C:B9:54:50:24,3836659,489459025,4805,6179341,3831854,483279684,0,8758,1683177,8736,1679682,22,3495,2345,14,5223,38,0,56,216660.0,130000.0,-40.0,-37.0,-46.0,-52.0,-45.0,-35.0,-44.0,-47.0,-84.0,-84.0,-82.0,-83.0,44.0,47.0,36.0,31.0,1
989,92:69:1D:31:68:E9,3835692,486876268,3836,3596382,3831856,483279886,0,4530,1071534,4397,1041514,133,30020,2054,10,4015,84,0,41,216660.0,130000.0,-51.0,-47.0,-45.0,-47.0,-51.0,-47.0,-44.0,-46.0,-84.0,-84.0,-82.0,-83.0,33.0,37.0,37.0,36.0,1
990,CC:2F:71:3F:1F:24,4516192,1211759518,684336,728479632,3831856,483279886,37,552106,571367649,551412,571284089,694,83560,533749,15,684584,75580,34,472,130000.0,43333.0,-75.0,-71.0,-72.0,-75.0,-75.0,-70.0,-71.0,-74.0,-84.0,-84.0,-82.0,-83.0,9.0,13.0,10.0,8.0,1
991,CC:2F:71:3E:C5:1F,3832695,483382377,837,102289,3831858,483280088,0,3497,293627,2885,220967,612,72660,885,8,1203,18,0,37,144444.0,39000.0,-71.0,-70.0,-67.0,-60.0,-71.0,-70.0,-67.0,-60.0,-84.0,-84.0,-82.0,-83.0,13.0,14.0,15.0,23.0,1
992,BA:8C:B9:54:50:24,3836663,489459429,4805,6179341,3831858,483280088,0,8758,1683177,8736,1679682,22,3495,2345,14,5223,38,0,56,216660.0,130000.0,-40.0,-37.0,-46.0,-52.0,-45.0,-35.0,-44.0,-47.0,-84.0,-84.0,-82.0,-83.0,44.0,47.0,36.0,31.0,1
993,92:69:1D:31:68:E9,3835699,486876934,3836,3596382,3831863,483280552,0,4531,1071602,4398,1041582,133,30020,2054,10,4015,84,0,41,216660.0,130000.0,-52.0,-46.0,-42.0,-49.0,-51.0,-47.0,-44.0,-47.0,-84.0,-84.0,-82.0,-83.0,32.0,38.0,40.0,34.0,1
994,CC:2F:71:3F:1F:24,4516628,1212267131,684765,728986579,3831863,483280552,37,552311,571398163,551617,571314603,694,83560,533947,15,685013,75791,34,472,115556.0,28889.0,-76.0,-73.0,-72.0,-73.0,-74.0,-71.0,-71.0,-71.0,-84.0,-84.0,-82.0,-83.0,8.0,11.0,10.0,10.0,1
995,CC:2F:71:3E:C5:1F,3832700,483382841,837,102289,3831863,483280552,0,3497,293627,2885,220967,612,72660,885,8,1203,18,0,37,144444.0,39000.0,-71.0,-70.0,-67.0,-60.0,-71.0,-70.0,-67.0,-60.0,-84.0,-84.0,-82.0,-83.0,13.0,14.0,15.0,23.0,1
996,BA:8C:B9:54:50:24,3836668,489459893,4805,6179341,3831863,483280552,0,8758,1683177,8736,1679682,22,3495,2345,14,5223,38,0,56,216660.0,130000.0,-40.0,-37.0,-46.0,-52.0,-45.0,-35.0,-44.0,-47.0,-84.0,-84.0,-82.0,-83.0,44.0,47.0,36.0,31.0,1
997,92:69:1D:31:68:E9,3835701,486877136,3836,3596382,3831865,483280754,0,4531,1071602,4398,1041582,133,30020,2054,10,4015,84,0,41,216660.0,130000.0,-52.0,-46.0,-42.0,-49.0,-51.0,-47.0,-44.0,-47.0,-84.0,-84.0,-82.0,-83.0,32.0,38.0,40.0,34.0,1
998,CC:2F:71:3F:1F:24,4517030,1212739339,685163,729458383,3831867,483280956,37,552489,571425453,551795,571341893,694,83560,534121,15,685410,75801,34,472,115556.0,28889.0,-71.0,-68.0,-69.0,-74.0,-71.0,-68.0,-69.0,-74.0,-84.0,-84.0,-82.0,-83.0,13.0,16.0,13.0,9.0,1
999,CC:2F:71:3E:C5:1F,3832704,483383245,837,102289,3831867,483280956,0,3497,293627,2885,220967,612,72660,885,8,1203,18,0,37,144444.0,39000.0,-71.0,-70.0,-67.0,-60.0,-71.0,-70.0,-67.0,-60.0,-84.0,-84.0,-82.0,-83.0,13.0,14.0,15.0,23.0,1
1000,BA:8C:B9:54:50:24,3836674,489460499,4805,6179341,3831869,483281158,0,8758,1683177,8736,1679682,22,3495,2345,14,5223,38,0,56,216660.0,130000.0,-40.0,-37.0,-46.0,-52.0,-45.0,-35.0,-44.0,-47.0,-84.0,-84.0,-82.0,-83.0,44.0,47.0,36.0,31.0,1
1001,92:69:1D:31:68:E9,3835707,486877742,3836,3596382,3831871,483281360,0,4531,1071602,4398,1041582,133,30020,2054,10,4015,84,0,41,216660.0,130000.0,-52.0,-46.0,-42.0,-49.0,-51.0,-47.0,-44.0,-47.0,-84.0,-84.0,-82.0,-83.0,32.0,38.0,40.0,34.0,1
1002,CC:2F:71:3F:1F:24,4517507,1213283393,685635,730001973,3831872,483281420,37,552731,571462436,552037,571378876,694,83560,534355,15,685883,75885,34,472,130000.0,43333.0,-72.0,-69.0,-69.0,-75.0,-71.0,-68.0,-69.0,-74.0,-84.0,-84.0,-82.0,-83.0,12.0,15.0,13.0,8.0,1
1003,CC:2F:71:3E:C5:1F,3832709,483383709,837,102289,3831872,483281420,0,3497,293627,2885,220967,612,72660,885,8,1203,18,0,37,144444.0,39000.0,-71.0,-70.0,-67.0,-60.0,-71.0,-70.0,-67.0,-60.0,-84.0,-84.0,-82.0,-83.0,13.0,14.0,15.0,23.0,1
1004,BA:8C:B9:54:50:24,3836677,489460761,4805,6179341,3831872,483281420,0,8758,1683177,8736,1679682,22,3495,2345,14,5223,38,0,56,216660.0,130000.0,-40.0,-37.0,-46.0,-52.0,-45.0,-35.0,-44.0,-47.0,-84.0,-84.0,-82.0,-83.0,44.0,47.0,36.0,31.0,1
1005,92:69:1D:31:68:E9,3835722,486883603,3836,3596382,3831886,483287221,0,4534,1071973,4400,1041718,134,30255,2055,10,4015,84,0,41,216660.0,130000.0,-51.0,-47.0,-42.0,-48.0,-51.0,-47.0,-44.0,-47.0,-84.0,-84.0,-82.0,-83.0,33.0,37.0,40.0,35.0,1
1006,CC:2F:71:3F:1F:24,4517757,1213549502,685869,730262079,3831888,483287423,37,552844,571479450,552150,571395890,694,83560,534464,15,686117,75910,34,472,130000.0,43333.0,-71.0,-68.0,-68.0,-74.0,-71.0,-68.0,-68.0,-74.0,-84.0,-84.0,-82.0,-83.0,13.0,16.0,14.0,9.0,1
1007,CC:2F:71:3E:C5:1F,3832725,483389712,837,102289,3831888,483287423,0,3497,293627,2885,220967,612,72660,885,8,1203,18,0,37,144444.0,39000.0,-71.0,-70.0,-67.0,-60.0,-71.0,-70.0,-67.0,-60.0,-84.0,-84.0,-82.0,-83.0,13.0,14.0,15.0,23.0,1
1008,BA:8C:B9:54:50:24,3836704,489472188,4805,6179341,3831899,483292847,0,8758,1683177,8736,1679682,22,3495,2345,14,5223,38,0,56,216660.0,130000.0,-40.0,-37.0,-46.0,-52.0,-45.0,-35.0,-44.0,-47.0,-84.0,-84.0,-82.0,-83.0,44.0,47.0,36.0,31.0,1
1009,92:69:1D:31:68:E9,3835739,486889633,3836,3596382,3831903,483293251,0,4534,1071973,4400,1041718,134,30255,2055,10,4015,84,0,41,216660.0,130000.0,-51.0,-47.0,-42.0,-48.0,-51.0,-47.0,-44.0,-47.0,-84.0,-84.0,-82.0,-83.0,33.0,37.0,40.0,35.0,1
1010,CC:2F:71:3F:1F:24,4517811,1213569504,685908,730276253,3831903,483293251,37,552865,571483184,552171,571399624,694,83560,534484,15,686156,75912,34,472,130000.0,43333.0,-70.0,-67.0,-68.0,-72.0,-70.0,-67.0,-68.0,-73.0,-84.0,-84.0,-82.0,-83.0,14.0,17.0,14.0,11.0,1
1011,CC:2F:71:3E:C5:1F,3832740,483395540,837,102289,3831903,483293251,0,3497,293627,2885,220967,612,72660,885,8,1203,18,0,37,144444.0,39000.0,-71.0,-70.0,-67.0,-60.0,-71.0,-70.0,-67.0,-60.0,-84.0,-84.0,-82.0,-83.0,13.0,14.0,15.0,23.0,1
1012,BA:8C:B9:54:50:24,3836708,489472592,4805,6179341,3831903,483293251,0,8758,1683177,8736,1679682,22,3495,2345,14,5223,38,0,56,216660.0,130000.0,-40.0,-37.0,-46.0,-52.0,-45.0,-35.0,-44.0,-47.0,-84.0,-84.0,-82.0,-83.0,44.0,47.0,36.0,31.0,1
1013,92:69:1D:31:68:E9,3835743,486890168,3836,3596382,3831907,483293786,0,4534,1071973,4400,1041718,134,30255,2055,10,4015,84,0,41,216660.0,130000.0,-51.0,-47.0,-42.0,-48.0,-51.0,-47.0,-44.0,-47.0,-84.0,-84.0,-82.0,-83.0,33.0,37.0,40.0,35.0,1
1014,CC:2F:71:3F:1F:24,4517856,1213584303,685947,730290315,3831909,483293988,37,552888,571487150,552194,571403590,694,83560,534506,15,686195,75917,34,472,144444.0,39000.0,-73.0,-69.0,-70.0,-75.0,-73.0,-68.0,-70.0,-75.0,-84.0,-84.0,-82.0,-83.0,11.0,15.0,12.0,8.0,1
1015,CC:2F:71:3E:C5:1F,3832746,483396277,837,102289,3831909,483293988,0,3497,293627,2885,220967,612,72660,885,8,1203,18,0,37,144444.0,39000.0,-71.0,-70.0,-67.0,-60.0,-71.0,-70.0,-67.0,-60.0,-84.0,-84.0,-82.0,-83.0,13.0,14.0,15.0,23.0,1
1016,BA:8C:B9:54:50:24,3836714,489473329,4805,6179341,3831909,483293988,0,8758,1683177,8736,1679682,22,3495,2345,14,5223,38,0,56,216660.0,130000.0,-40.0,-37.0,-46.0,-52.0,-45.0,-35.0,-44.0,-47.0,-84.0,-84.0,-82.0,-83.0,44.0,47.0,36.0,31.0,1
1017,92:69:1D:31:68:E9,3835749,486890774,3836,3596382,3831913,483294392,0,4534,1071973,4400,1041718,134,30255,2055,10,4015,84,0,41,216660.0,130000.0,-51.0,-47.0,-42.0,-48.0,-51.0,-47.0,-44.0,-47.0,-84.0,-84.0,-82.0,-83.0,33.0,37.0,40.0,35.0,1
1018,CC:2F:71:3F:1F:24,4517902,1213599215,685989,730304823,3831913,483294392,37,552917,571491982,552223,571408422,694,83560,534530,15,686237,75934,34,472,144444.0,43333.0,-69.0,-68.0,-69.0,-70.0,-69.0,-68.0,-68.0,-70.0,-84.0,-84.0,-82.0,-83.0,15.0,16.0,13.0,13.0,1
1019,CC:2F:71:3E:C5:1F,3832750,483396681,837,102289,3831913,483294392,0,3497,293627,2885,220967,612,72660,885,8,1203,18,0,37,144444.0,39000.0,-71.0,-70.0,-67.0,-60.0,-71.0,-70.0,-67.0,-60.0,-84.0,-84.0,-82.0,-83.0,13.0,14.0,15.0,23.0,1
1020,BA:8C:B9:54:50:24,3836718,489473733,4805,6179341,3831913,483294392,0,8758,1683177,8736,1679682,22,3495,2345,14,5223,38,0,56,216660.0,130000.0,-40.0,-37.0,-46.0,-52.0,-45.0,-35.0,-44.0,-47.0,-84.0,-84.0,-82.0,-83.0,44.0,47.0,36.0,31.0,1
1021,92:69:1D:31:68:E9,3835749,486890774,3836,3596382,3831913,483294392,0,4534,1071973,4400,1041718,134,30255,2055,10,4015,84,0,41,216660.0,130000.0,-51.0,-47.0,-42.0,-48.0,-51.0,-47.0,-44.0,-47.0,-84.0,-84.0,-82.0,-83.0,33.0,37.0,40.0,35.0,1
1022,CC:2F:71:3F:1F:24,4517950,1213617064,686035,730322470,3831915,483294594,37,552947,571497252,552253,571413692,694,83560,534559,15,686283,75961,34,472,144444.0,43333.0,-69.0,-67.0,-69.0,-71.0,-69.0,-67.0,-68.0,-70.0,-84.0,-84.0,-82.0,-83.0,15.0,17.0,13.0,12.0,1
1023,CC:2F:71:3E:C5:1F,3832754,483397085,837,102289,3831917,483294796,0,3497,293627,2885,220967,612,72660,885,8,1203,18,0,37,144444.0,39000.0,-71.0,-70.0,-67.0,-60.0,-71.0,-70.0,-67.0,-60.0,-84.0,-84.0,-82.0,-83.0,13.0,14.0,15.0,23.0,1
1024,BA:8C:B9:54:50:24,3836722,489474137,4805,6179341,3831917,483294796,0,8758,1683177,8736,1679682,22,3495,2345,14,5223,38,0,56,216660.0,130000.0,-40.0,-37.0,-46.0,-52.0,-45.0,-35.0,-44.0,-47.0,-84.0,-84.0,-82.0,-83.0,44.0,47.0,36.0,31.0,1
1025,92:69:1D:31:68:E9,3835760,486892010,3836,3596382,3831924,483295628,0,4534,1071973,4400,1041718,134,30255,2055,10,4015,84,0,41,216660.0,130000.0,-51.0,-47.0,-42.0,-48.0,-51.0,-47.0,-44.0,-47.0,-84.0,-84.0,-82.0,-83.0,33.0,37.0,40.0,35.0,1
1026,CC:2F:71:3F:1F:24,4517999,1213632346,686075,730336718,3831924,483295628,37,552970,571501232,552276,571417672,694,83560,534580,15,686323,76010,34,472,130000.0,43333.0,-71.0,-68.0,-70.0,-72.0,-71.0,-67.0,-70.0,-71.0,-84.0,-84.0,-82.0,-83.0,13.0,16.0,12.0,11.0,1
1027,CC:2F:71:3E:C5:1F,3832761,483397917,837,102289,3831924,483295628,0,3497,293627,2885,220967,612,72660,885,8,1203,18,0,37,144444.0,39000.0,-71.0,-70.0,-67.0,-60.0,-71.0,-70.0,-67.0,-60.0,-84.0,-84.0,-82.0,-83.0,13.0,14.0,15.0,23.0,1
1028,BA:8C:B9:54:50:24,3836729,489474969,4805,6179341,3831924,483295628,0,8758,1683177,8736,1679682,22,3495,2345,14,5223,38,0,56,216660.0,130000.0,-40.0,-37.0,-46.0,-52.0,-45.0,-35.0,-44.0,-47.0,-84.0,-84.0,-82.0,-83.0,44.0,47.0,36.0,31.0,1
1029,92:69:1D:31:68:E9,3835760,486892010,3836,3596382,3831924,483295628,0,4534,1071973,4400,1041718,134,30255,2055,10,4015,84,0,41,216660.0,130000.0,-51.0,-47.0,-42.0,-48.0,-51.0,-47.0,-44.0,-47.0,-84.0,-84.0,-82.0,-83.0,33.0,37.0,40.0,35.0,1
1030,CC:2F:71:3F:1F:24,4518037,1213646390,686113,730350762,3831924,483295628,37,552992,571505082,552298,571421522,694,83560,534601,15,686361,76018,34,472,130000.0,43333.0,-70.0,-67.0,-69.0,-71.0,-69.0,-66.0,-68.0,-71.0,-84.0,-84.0,-82.0,-83.0,14.0,17.0,13.0,12.0,1
1031,CC:2F:71:3E:C5:1F,3832763,483398119,837,102289,3831926,483295830,0,3497,293627,2885,220967,612,72660,885,8,1203,18,0,37,144444.0,39000.0,-71.0,-70.0,-67.0,-60.0,-71.0,-70.0,-67.0,-60.0,-84.0,-84.0,-82.0,-83.0,13.0,14.0,15.0,23.0,1
1032,BA:8C:B9:54:50:24,3836731,489475171,4805,6179341,3831926,483295830,0,8758,1683177,8736,1679682,22,3495,2345,14,5223,38,0,56,216660.0,130000.0,-40.0,-37.0,-46.0,-52.0,-45.0,-35.0,-44.0,-47.0,-84.0,-84.0,-82.0,-83.0,44.0,47.0,36.0,31.0,1
1033,92:69:1D:31:68:E9,3835768,486892818,3836,3596382,3831932,483296436,0,4534,1071973,4400,1041718,134,30255,2055,10,4015,84,0,41,216660.0,130000.0,-51.0,-47.0,-42.0,-48.0,-51.0,-47.0,-44.0,-47.0,-84.0,-84.0,-82.0,-83.0,33.0,37.0,40.0,35.0,1
1034,CC:2F:71:3F:1F:24,4518084,1213661316,686152,730364880,3831932,483296436,37,553016,571509288,552322,571425728,694,83560,534622,15,686400,76035,34,472,130000.0,39000.0,-72.0,-71.0,-71.0,-73.0,-70.0,-70.0,-70.0,-71.0,-84.0,-84.0,-82.0,-83.0,12.0,13.0,11.0,10.0,1
1035,CC:2F:71:3E:C5:1F,3832770,483398785,837,102289,3831933,483296496,0,3497,293627,2885,220967,612,72660,885,8,1203,18,0,37,144444.0,39000.0,-71.0,-70.0,-67.0,-60.0,-71.0,-70.0,-67.0,-60.0,-84.0,-84.0,-82.0,-83.0,13.0,14.0,15.0,23.0,1
1036,BA:8C:B9:54:50:24,3836738,489475837,4805,6179341,3831933,483296496,0,8758,1683177,8736,1679682,22,3495,2345,14,5223,38,0,56,216660.0,130000.0,-40.0,-37.0,-46.0,-52.0,-45.0,-35.0,-44.0,-47.0,-84.0,-84.0,-82.0,-83.0,44.0,47.0,36.0,31.0,1
1037,92:69:1D:31:68:E9,3835769,486892878,3836,3596382,3831933,483296496,0,4534,1071973,4400,1041718,134,30255,2055,10,4015,84,0,41,216660.0,130000.0,-51.0,-47.0,-42.0,-48.0,-51.0,-47.0,-44.0,-47.0,-85.0,-85.0,-82.0,-83.0,34.0,38.0,40.0,35.0,1
1038,CC:2F:71:3F:1F:24,4518131,1213678911,686198,730382415,3831933,483296496,37,553051,571515705,552357,571432145,694,83560,534650,15,686446,76056,34,472,144444.0,43333.0,-69.0,-67.0,-68.0,-71.0,-68.0,-67.0,-68.0,-71.0,-85.0,-85.0,-82.0,-83.0,16.0,18.0,14.0,12.0,1
1039,CC:2F:71:3E:C5:1F,3832772,483398987,837,102289,3831935,483296698,0,3497,293627,2885,220967,612,72660,885,8,1203,18,0,37,144444.0,39000.0,-71.0,-70.0,-67.0,-60.0,-71.0,-70.0,-67.0,-60.0,-85.0,-85.0,-82.0,-83.0,14.0,15.0,15.0,23.0,1
1040,BA:8C:B9:54:50:24,3836740,489476039,4805,6179341,3831935,483296698,0,8758,1683177,8736,1679682,22,3495,2345,14,5223,38,0,56,216660.0,130000.0,-40.0,-37.0,-46.0,-52.0,-45.0,-35.0,-44.0,-47.0,-85.0,-85.0,-82.0,-83.0,45.0,48.0,36.0,31.0,1
1041,92:69:1D:31:68:E9,3835777,486893686,3836,3596382,3831941,483297304,0,4534,1071973,4400,1041718,134,30255,2055,10,4015,84,0,41,216660.0,130000.0,-51.0,-47.0,-42.0,-48.0,-51.0,-47.0,-44.0,-47.0,-85.0,-85.0,-82.0,-83.0,34.0,38.0,40.0,35.0,1
1042,CC:2F:71:3F:1F:24,4518178,1213693893,686237,730396589,3831941,483297304,37,553073,571519555,552379,571435995,694,83560,534671,15,686485,76072,34,472,144444.0,43333.0,-66.0,-65.0,-69.0,-71.0,-66.0,-65.0,-69.0,-71.0,-85.0,-85.0,-82.0,-83.0,19.0,20.0,13.0,12.0,1
1043,CC:2F:71:3E:C5:1F,3832778,483399593,837,102289,3831941,483297304,0,3497,293627,2885,220967,612,72660,885,8,1203,18,0,37,144444.0,39000.0,-71.0,-70.0,-67.0,-60.0,-71.0,-70.0,-67.0,-60.0,-85.0,-85.0,-82.0,-83.0,14.0,15.0,15.0,23.0,1
1044,BA:8C:B9:54:50:24,3836746,489476645,4805,6179341,3831941,483297304,0,8758,1683177,8736,1679682,22,3495,2345,14,5223,38,0,56,216660.0,130000.0,-40.0,-37.0,-46.0,-52.0,-45.0,-35.0,-44.0,-47.0,-85.0,-85.0,-82.0,-83.0,45.0,48.0,36.0,31.0,1
1045,92:69:1D:31:68:E9,3835778,486893746,3836,3596382,3831942,483297364,0,4534,1071973,4400,1041718,134,30255,2055,10,4015,84,0,41,216660.0,130000.0,-51.0,-47.0,-42.0,-48.0,-51.0,-47.0,-44.0,-47.0,-85.0,-85.0,-82.0,-83.0,34.0,38.0,40.0,35.0,1
1046,CC:2F:71:3F:1F:24,4518219,1213708257,686277,730410893,3831942,483297364,37,553098,571524005,552404,571440445,694,83560,534693,15,686525,76084,34,472,144444.0,43333.0,-70.0,-66.0,-68.0,-70.0,-69.0,-66.0,-68.0,-71.0,-85.0,-85.0,-82.0,-83.0,15.0,19.0,14.0,13.0,1
1047,CC:2F:71:3E:C5:1F,3832779,483399653,837,102289,3831942,483297364,0,3497,293627,2885,220967,612,72660,885,8,1203,18,0,37,144444.0,39000.0,-71.0,-70.0,-67.0,-60.0,-71.0,-70.0,-67.0,-60.0,-85.0,-85.0,-82.0,-83.0,14.0,15.0,15.0,23.0,1
1048,BA:8C:B9:54:50:24,3836749,489476907,4805,6179341,3831944,483297566,0,8758,1683177,8736,1679682,22,3495,2345,14,5223,38,0,56,216660.0,130000.0,-40.0,-37.0,-46.0,-52.0,-45.0,-35.0,-44.0,-47.0,-85.0,-85.0,-82.0,-83.0,45.0,48.0,36.0,31.0,1
1049,92:69:1D:31:68:E9,3835786,486894554,3836,3596382,3831950,483298172,0,4536,1072189,4402,1041934,134,30255,2056,10,4015,84,0,41,216660.0,130000.0,-52.0,-50.0,-46.0,-52.0,-51.0,-47.0,-44.0,-48.0,-85.0,-85.0,-83.0,-84.0,33.0,35.0,37.0,32.0,1
1050,CC:2F:71:3F:1F:24,4518266,1213723255,686316,730425083,3831950,483298172,37,553120,571527809,552426,571444249,694,83560,534713,15,686564,76130,34,472,144444.0,43333.0,-70.0,-69.0,-68.0,-70.0,-70.0,-68.0,-68.0,-70.0,-85.0,-85.0,-83.0,-84.0,15.0,16.0,15.0,14.0,1
1051,CC:2F:71:3E:C5:1F,3832787,483400461,837,102289,3831950,483298172,0,3497,293627,2885,220967,612,72660,885,8,1203,18,0,37,144444.0,39000.0,-71.0,-70.0,-67.0,-60.0,-71.0,-70.0,-67.0,-60.0,-85.0,-85.0,-83.0,-84.0,14.0,15.0,16.0,24.0,1
1052,BA:8C:B9:54:50:24,3836755,489477513,4805,6179341,3831950,483298172,0,8758,1683177,8736,1679682,22,3495,2345,14,5223,38,0,56,216660.0,130000.0,-40.0,-37.0,-46.0,-52.0,-45.0,-35.0,-44.0,-47.0,-85.0,-85.0,-83.0,-84.0,45.0,48.0,37.0,32.0,1
1053,92:69:1D:31:68:E9,3835803,486903464,3853,3605292,3831950,483298172,0,4560,1076332,4426,1046077,134,30255,2075,10,4032,84,0,41,229410.0,130000.0,-52.0,-47.0,-42.0,-48.0,-52.0,-49.0,-45.0,-50.0,-85.0,-85.0,-83.0,-84.0,33.0,38.0,41.0,36.0,1
1054,CC:2F:71:3F:1F:24,4518323,1213744000,686373,730445828,3831950,483298172,37,553161,571535022,552467,571451462,694,83560,534753,15,686621,76166,34,472,130000.0,43333.0,-69.0,-65.0,-70.0,-72.0,-69.0,-65.0,-70.0,-71.0,-85.0,-85.0,-83.0,-84.0,16.0,20.0,13.0,12.0,1
1055,CC:2F:71:3E:C5:1F,3832787,483400461,837,102289,3831950,483298172,0,3497,293627,2885,220967,612,72660,885,8,1203,18,0,37,144444.0,39000.0,-71.0,-70.0,-67.0,-60.0,-71.0,-70.0,-67.0,-60.0,-85.0,-85.0,-83.0,-84.0,14.0,15.0,16.0,24.0,1
1056,BA:8C:B9:54:50:24,3836757,489477715,4805,6179341,3831952,483298374,0,8758,1683177,8736,1679682,22,3495,2345,14,5223,38,0,56,216660.0,130000.0,-40.0,-37.0,-46.0,-52.0,-45.0,-35.0,-44.0,-47.0,-85.0,-85.0,-83.0,-84.0,45.0,48.0,37.0,32.0,1
1057,92:69:1D:31:68:E9,3835812,486904332,3853,3605292,3831959,483299040,0,4560,1076332,4426,1046077,134,30255,2075,10,4032,84,0,41,229410.0,130000.0,-52.0,-47.0,-42.0,-48.0,-52.0,-49.0,-45.0,-50.0,-85.0,-85.0,-83.0,-84.0,33.0,38.0,41.0,36.0,1
1058,CC:2F:71:3F:1F:24,4518370,1213758912,686411,730459872,3831959,483299040,37,553192,571540288,552498,571456728,694,83560,534777,15,686659,76171,34,472,130000.0,43333.0,-69.0,-68.0,-70.0,-71.0,-69.0,-67.0,-69.0,-71.0,-85.0,-85.0,-83.0,-84.0,16.0,17.0,13.0,13.0,1
1059,CC:2F:71:3E:C5:1F,3832796,483401329,837,102289,3831959,483299040,0,3497,293627,2885,220967,612,72660,885,8,1203,18,0,37,144444.0,39000.0,-71.0,-70.0,-67.0,-60.0,-71.0,-70.0,-67.0,-60.0,-85.0,-85.0,-83.0,-84.0,14.0,15.0,16.0,24.0,1
1060,BA:8C:B9:54:50:24,3836764,489478381,4805,6179341,3831959,483299040,0,8758,1683177,8736,1679682,22,3495,2345,14,5223,38,0,56,216660.0,130000.0,-40.0,-37.0,-46.0,-52.0,-45.0,-35.0,-44.0,-47.0,-85.0,-85.0,-83.0,-84.0,45.0,48.0,37.0,32.0,1
1061,92:69:1D:31:68:E9,3835813,486904448,3854,3605408,3831959,483299040,0,4562,1076468,4428,1046213,134,30255,2075,10,4033,84,0,41,229410.0,130000.0,-51.0,-47.0,-45.0,-46.0,-52.0,-48.0,-45.0,-49.0,-85.0,-86.0,-83.0,-84.0,34.0,39.0,38.0,38.0,1
1062,CC:2F:71:3F:1F:24,4518409,1213773016,686450,730473976,3831959,483299040,37,553216,571544590,552522,571461030,694,83560,534798,15,686698,76178,34,472,130000.0,39000.0,-69.0,-67.0,-68.0,-71.0,-69.0,-67.0,-68.0,-71.0,-85.0,-86.0,-83.0,-84.0,16.0,19.0,15.0,13.0,1
1063,CC:2F:71:3E:C5:1F,3832797,483401445,838,102405,3831959,483299040,0,3499,293767,2887,221107,612,72660,885,8,1204,18,0,37,144444.0,39000.0,-71.0,-70.0,-67.0,-60.0,-71.0,-70.0,-67.0,-60.0,-85.0,-86.0,-83.0,-84.0,14.0,16.0,16.0,24.0,1
1064,BA:8C:B9:54:50:24,3836765,489478441,4806,6179401,3831959,483299040,0,8760,1683313,8738,1679818,22,3495,2345,14,5224,38,0,56,216660.0,130000.0,-40.0,-37.0,-45.0,-51.0,-44.0,-36.0,-44.0,-48.0,-85.0,-86.0,-83.0,-84.0,45.0,49.0,38.0,33.0,1
1065,92:69:1D:31:68:E9,3835819,486905054,3854,3605408,3831965,483299646,0,4562,1076468,4428,1046213,134,30255,2075,10,4033,84,0,41,229410.0,130000.0,-51.0,-47.0,-45.0,-46.0,-52.0,-48.0,-45.0,-49.0,-85.0,-86.0,-83.0,-84.0,34.0,39.0,38.0,38.0,1
1066,CC:2F:71:3F:1F:24,4518455,1213787700,686488,730487852,3831967,483299848,37,553238,571548440,552544,571464880,694,83560,534819,15,686736,76197,34,472,130000.0,43333.0,-68.0,-66.0,-68.0,-70.0,-68.0,-66.0,-68.0,-69.0,-85.0,-86.0,-83.0,-84.0,17.0,20.0,15.0,14.0,1
1067,CC:2F:71:3E:C5:1F,3832806,483402526,838,102405,3831968,483300121,0,3499,293767,2887,221107,612,72660,885,8,1204,18,0,37,144444.0,39000.0,-71.0,-70.0,-67.0,-60.0,-71.0,-70.0,-67.0,-60.0,-85.0,-86.0,-83.0,-84.0,14.0,16.0,16.0,24.0,1
1068,BA:8C:B9:54:50:24,3836775,489479582,4806,6179401,3831969,483300181,0,8760,1683313,8738,1679818,22,3495,2345,14,5224,38,0,56,216660.0,130000.0,-40.0,-37.0,-45.0,-51.0,-44.0,-36.0,-44.0,-48.0,-85.0,-86.0,-83.0,-84.0,45.0,49.0,38.0,33.0,1
1069,92:69:1D:31:68:E9,3835824,486905651,3854,3605408,3831970,483300243,0,4562,1076468,4428,1046213,134,30255,2075,10,4033,84,0,41,229410.0,130000.0,-51.0,-47.0,-45.0,-46.0,-52.0,-48.0,-45.0,-49.0,-85.0,-86.0,-83.0,-84.0,34.0,39.0,38.0,38.0,1
1070,CC:2F:71:3F:1F:24,4518503,1213805556,686533,730505313,3831970,483300243,37,553270,571554070,552575,571470392,695,83678,534847,15,686781,76209,34,472,130000.0,39000.0,-68.0,-68.0,-69.0,-67.0,-68.0,-68.0,-69.0,-68.0,-85.0,-86.0,-83.0,-84.0,17.0,18.0,14.0,17.0,1
1071,CC:2F:71:3E:C5:1F,3832808,483402648,838,102405,3831970,483300243,0,3499,293767,2887,221107,612,72660,885,8,1204,18,0,37,144444.0,39000.0,-71.0,-70.0,-67.0,-60.0,-71.0,-70.0,-67.0,-60.0,-85.0,-86.0,-83.0,-84.0,14.0,16.0,16.0,24.0,1
1072,BA:8C:B9:54:50:24,3836778,489479846,4806,6179401,3831972,483300445,0,8761,1683381,8739,1679886,22,3495,2345,14,5224,38,0,56,216660.0,130000.0,-40.0,-37.0,-46.0,-51.0,-43.0,-36.0,-44.0,-48.0,-85.0,-86.0,-83.0,-84.0,45.0,49.0,37.0,33.0,1
1073,92:69:1D:31:68:E9,3835830,486906257,3854,3605408,3831976,483300849,0,4562,1076468,4428,1046213,134,30255,2075,10,4033,84,0,41,229410.0,130000.0,-51.0,-47.0,-45.0,-46.0,-52.0,-48.0,-45.0,-49.0,-85.0,-86.0,-83.0,-84.0,34.0,39.0,38.0,38.0,1
1074,CC:2F:71:3F:1F:24,4518547,1213820038,686571,730519189,3831976,483300849,37,553293,571558098,552598,571474420,695,83678,534868,15,686819,76238,34,472,130000.0,43333.0,-70.0,-66.0,-69.0,-69.0,-69.0,-66.0,-69.0,-69.0,-85.0,-86.0,-83.0,-84.0,15.0,20.0,14.0,15.0,1
1075,CC:2F:71:3E:C5:1F,3832816,483403456,838,102405,3831978,483301051,0,3499,293767,2887,221107,612,72660,885,8,1204,18,0,37,144444.0,39000.0,-71.0,-70.0,-67.0,-60.0,-71.0,-70.0,-67.0,-60.0,-85.0,-86.0,-83.0,-84.0,14.0,16.0,16.0,24.0,1
1076,BA:8C:B9:54:50:24,3836784,489480452,4806,6179401,3831978,483301051,0,8761,1683381,8739,1679886,22,3495,2345,14,5224,38,0,56,216660.0,130000.0,-40.0,-37.0,-46.0,-51.0,-43.0,-36.0,-44.0,-48.0,-85.0,-86.0,-83.0,-84.0,45.0,49.0,37.0,33.0,1
1077,92:69:1D:31:68:E9,3835834,486906635,3855,3605524,3831979,483301111,0,4564,1076646,4430,1046391,134,30255,2076,10,4034,84,0,41,229410.0,130000.0,-52.0,-50.0,-46.0,-51.0,-52.0,-48.0,-45.0,-48.0,-86.0,-86.0,-83.0,-84.0,34.0,36.0,37.0,33.0,1
1078,CC:2F:71:3F:1F:24,4518588,1213834360,686609,730533249,3831979,483301111,37,553314,571561832,552619,571478154,695,83678,534888,15,686857,76245,34,472,130000.0,43333.0,-72.0,-68.0,-69.0,-71.0,-72.0,-68.0,-68.0,-70.0,-86.0,-86.0,-83.0,-84.0,14.0,18.0,14.0,13.0,1
1079,CC:2F:71:3E:C5:1F,3832817,483403516,838,102405,3831979,483301111,0,3499,293767,2887,221107,612,72660,885,8,1204,18,0,37,144444.0,39000.0,-71.0,-70.0,-67.0,-60.0,-71.0,-70.0,-67.0,-60.0,-86.0,-86.0,-83.0,-84.0,15.0,16.0,16.0,24.0,1
1080,BA:8C:B9:54:50:24,3836787,489480714,4806,6179401,3831981,483301313,0,8761,1683381,8739,1679886,22,3495,2345,14,5224,38,0,56,216660.0,130000.0,-40.0,-37.0,-46.0,-51.0,-43.0,-36.0,-44.0,-48.0,-86.0,-86.0,-83.0,-84.0,46.0,49.0,37.0,33.0,1
1081,92:69:1D:31:68:E9,3835840,486907241,3855,3605524,3831985,483301717,0,4565,1076714,4431,1046459,134,30255,2076,10,4034,84,0,41,229410.0,130000.0,-52.0,-48.0,-44.0,-45.0,-52.0,-48.0,-44.0,-48.0,-86.0,-86.0,-83.0,-84.0,34.0,38.0,39.0,39.0,1
1082,CC:2F:71:3F:1F:24,4518632,1213848954,686647,730547237,3831985,483301717,37,553337,571566082,552642,571482404,695,83678,534908,15,686895,76249,34,472,130000.0,39000.0,-73.0,-68.0,-71.0,-72.0,-71.0,-67.0,-70.0,-71.0,-86.0,-86.0,-83.0,-84.0,13.0,18.0,12.0,12.0,1
1083,CC:2F:71:3E:C5:1F,3832823,483404122,838,102405,3831985,483301717,0,3499,293767,2887,221107,612,72660,885,8,1204,18,0,37,144444.0,39000.0,-71.0,-70.0,-67.0,-60.0,-71.0,-70.0,-67.0,-60.0,-86.0,-86.0,-83.0,-84.0,15.0,16.0,16.0,24.0,1
1084,BA:8C:B9:54:50:24,3836793,489481320,4806,6179401,3831987,483301919,0,8761,1683381,8739,1679886,22,3495,2345,14,5224,38,0,56,216660.0,130000.0,-40.0,-37.0,-46.0,-51.0,-43.0,-36.0,-44.0,-48.0,-86.0,-86.0,-83.0,-84.0,46.0,49.0,37.0,33.0,1
1085,92:69:1D:31:68:E9,3835842,486907443,3855,3605524,3831987,483301919,0,4565,1076714,4431,1046459,134,30255,2076,10,4034,84,0,41,229410.0,130000.0,-52.0,-48.0,-44.0,-45.0,-52.0,-48.0,-44.0,-48.0,-86.0,-86.0,-83.0,-84.0,34.0,38.0,39.0,39.0,1
1086,CC:2F:71:3F:1F:24,4519086,1214405423,687099,731103504,3831987,483301919,37,553547,571598361,552852,571514683,695,83678,535112,15,687347,76321,34,472,130000.0,43333.0,-71.0,-68.0,-71.0,-69.0,-70.0,-67.0,-70.0,-69.0,-86.0,-86.0,-83.0,-84.0,15.0,18.0,12.0,15.0,1
1087,CC:2F:71:3E:C5:1F,3832825,483404324,838,102405,3831987,483301919,0,3499,293767,2887,221107,612,72660,885,8,1204,18,0,37,144444.0,39000.0,-71.0,-70.0,-67.0,-60.0,-71.0,-70.0,-67.0,-60.0,-86.0,-86.0,-83.0,-84.0,15.0,16.0,16.0,24.0,1
1088,BA:8C:B9:54:50:24,3836793,489481320,4806,6179401,3831987,483301919,0,8761,1683381,8739,1679886,22,3495,2345,14,5224,38,0,56,216660.0,130000.0,-40.0,-37.0,-46.0,-51.0,-43.0,-36.0,-44.0,-48.0,-86.0,-86.0,-83.0,-84.0,46.0,49.0,37.0,33.0,1
1089,92:69:1D:31:68:E9,3835849,486908109,3855,3605524,3831994,483302585,0,4565,1076714,4431,1046459,134,30255,2076,10,4034,84,0,41,229410.0,130000.0,-52.0,-48.0,-44.0,-45.0,-52.0,-48.0,-44.0,-48.0,-86.0,-86.0,-83.0,-84.0,34.0,38.0,39.0,39.0,1
1090,CC:2F:71:3F:1F:24,4519339,1214676582,687345,731373997,3831994,483302585,37,553667,571616852,552972,571533174,695,83678,535229,15,687593,76411,34,472,130000.0,43333.0,-71.0,-69.0,-70.0,-73.0,-70.0,-69.0,-70.0,-72.0,-86.0,-86.0,-83.0,-84.0,15.0,17.0,13.0,11.0,1
1091,CC:2F:71:3E:C5:1F,3832832,483404990,838,102405,3831994,483302585,0,3499,293767,2887,221107,612,72660,885,8,1204,18,0,37,144444.0,39000.0,-71.0,-70.0,-67.0,-60.0,-71.0,-70.0,-67.0,-60.0,-86.0,-86.0,-83.0,-84.0,15.0,16.0,16.0,24.0,1
1092,BA:8C:B9:54:50:24,3836800,489481986,4806,6179401,3831994,483302585,0,8761,1683381,8739,1679886,22,3495,2345,14,5224,38,0,56,216660.0,130000.0,-40.0,-37.0,-46.0,-51.0,-43.0,-36.0,-44.0,-48.0,-86.0,-86.0,-83.0,-84.0,46.0,49.0,37.0,33.0,1
1093,92:69:1D:31:68:E9,3835851,486908311,3855,3605524,3831996,483302787,0,4565,1076714,4431,1046459,134,30255,2076,10,4034,84,0,41,229410.0,130000.0,-52.0,-48.0,-44.0,-45.0,-52.0,-48.0,-44.0,-48.0,-86.0,-86.0,-83.0,-84.0,34.0,38.0,39.0,39.0,1
1094,CC:2F:71:3F:1F:24,4519773,1215183162,687777,731880375,3831996,483302787,37,553870,571646974,553175,571563296,695,83678,535431,15,688025,76449,34,472,130000.0,43333.0,-71.0,-68.0,-69.0,-71.0,-70.0,-68.0,-69.0,-71.0,-86.0,-86.0,-83.0,-84.0,15.0,18.0,14.0,13.0,1
1095,CC:2F:71:3E:C5:1F,3832834,483405192,838,102405,3831996,483302787,0,3501,293907,2889,221247,612,72660,885,8,1205,18,0,37,144444.0,39000.0,-72.0,-70.0,-66.0,-60.0,-71.0,-70.0,-66.0,-60.0,-86.0,-86.0,-83.0,-84.0,14.0,16.0,17.0,24.0,1
1096,BA:8C:B9:54:50:24,3836802,489482188,4806,6179401,3831996,483302787,0,8763,1683517,8741,1680022,22,3495,2345,14,5225,38,0,56,216660.0,130000.0,-49.0,-35.0,-43.0,-45.0,-43.0,-36.0,-44.0,-48.0,-86.0,-86.0,-83.0,-84.0,37.0,51.0,40.0,39.0,1
1097,92:69:1D:31:68:E9,3835857,486908917,3855,3605524,3832002,483303393,0,4565,1076714,4431,1046459,134,30255,2076,10,4034,84,0,41,229410.0,130000.0,-52.0,-48.0,-44.0,-45.0,-52.0,-48.0,-44.0,-48.0,-86.0,-86.0,-83.0,-84.0,34.0,38.0,39.0,39.0,1
1098,CC:2F:71:3F:1F:24,4519817,1215197756,687815,731894363,3832002,483303393,37,553892,571650966,553197,571567288,695,83678,535451,15,688063,76450,34,472,130000.0,39000.0,-70.0,-68.0,-69.0,-71.0,-69.0,-67.0,-68.0,-71.0,-86.0,-86.0,-83.0,-84.0,16.0,18.0,14.0,13.0,1
1099,CC:2F:71:3E:C5:1F,3832841,483405858,838,102405,3832003,483303453,0,3501,293907,2889,221247,612,72660,885,8,1205,18,0,37,144444.0,39000.0,-72.0,-70.0,-66.0,-60.0,-71.0,-70.0,-66.0,-60.0,-86.0,-86.0,-83.0,-84.0,14.0,16.0,17.0,24.0,1
1100,BA:8C:B9:54:50:24,3836809,489482854,4806,6179401,3832003,483303453,0,8763,1683517,8741,1680022,22,3495,2345,14,5225,38,0,56,216660.0,130000.0,-49.0,-35.0,-43.0,-45.0,-43.0,-36.0,-44.0,-48.0,-86.0,-86.0,-83.0,-84.0,37.0,51.0,40.0,39.0,1
1101,92:69:1D:31:68:E9,3835860,486909179,3855,3605524,3832005,483303655,0,4565,1076714,4431,1046459,134,30255,2076,10,4034,84,0,41,229410.0,130000.0,-52.0,-48.0,-44.0,-45.0,-52.0,-48.0,-44.0,-48.0,-86.0,-86.0,-83.0,-84.0,34.0,38.0,39.0,39.0,1
1102,CC:2F:71:3F:1F:24,4519859,1215212080,687854,731908425,3832005,483303655,37,553922,571656354,553227,571572676,695,83678,535473,15,688102,76454,34,472,144444.0,43333.0,-70.0,-68.0,-69.0,-71.0,-69.0,-68.0,-68.0,-71.0,-86.0,-86.0,-83.0,-84.0,16.0,18.0,14.0,13.0,1
1103,CC:2F:71:3E:C5:1F,3832843,483406060,838,102405,3832005,483303655,0,3501,293907,2889,221247,612,72660,885,8,1205,18,0,37,144444.0,39000.0,-72.0,-70.0,-66.0,-60.0,-71.0,-70.0,-66.0,-60.0,-86.0,-86.0,-83.0,-84.0,14.0,16.0,17.0,24.0,1
1104,BA:8C:B9:54:50:24,3836811,489483056,4806,6179401,3832005,483303655,0,8763,1683517,8741,1680022,22,3495,2345,14,5225,38,0,56,216660.0,130000.0,-49.0,-35.0,-43.0,-45.0,-43.0,-36.0,-44.0,-48.0,-86.0,-86.0,-83.0,-84.0,37.0,51.0,40.0,39.0,1
1105,92:69:1D:31:68:E9,3835866,486909785,3855,3605524,3832011,483304261,0,4565,1076714,4431,1046459,134,30255,2076,10,4034,84,0,41,229410.0,130000.0,-52.0,-48.0,-44.0,-45.0,-52.0,-48.0,-44.0,-48.0,-86.0,-86.0,-83.0,-84.0,34.0,38.0,39.0,39.0,1
1106,CC:2F:71:3F:1F:24,4519904,1215226860,687893,731922599,3832011,483304261,37,553945,571660320,553250,571576642,695,83678,535495,15,688141,76455,34,472,144444.0,43333.0,-70.0,-68.0,-69.0,-71.0,-70.0,-68.0,-69.0,-71.0,-86.0,-86.0,-83.0,-84.0,16.0,18.0,14.0,13.0,1
1107,CC:2F:71:3E:C5:1F,3832849,483406666,838,102405,3832011,483304261,0,3501,293907,2889,221247,612,72660,885,8,1205,18,0,37,144444.0,39000.0,-72.0,-70.0,-66.0,-60.0,-71.0,-70.0,-66.0,-60.0,-86.0,-86.0,-83.0,-84.0,14.0,16.0,17.0,24.0,1
1108,BA:8C:B9:54:50:24,3836817,489483662,4806,6179401,3832011,483304261,0,8763,1683517,8741,1680022,22,3495,2345,14,5225,38,0,56,216660.0,130000.0,-49.0,-35.0,-43.0,-45.0,-43.0,-36.0,-44.0,-48.0,-86.0,-86.0,-83.0,-84.0,37.0,51.0,40.0,39.0,1
1109,92:69:1D:31:68:E9,3835870,486910109,3855,3605524,3832015,483304585,0,4565,1076714,4431,1046459,134,30255,2076,10,4034,84,0,41,229410.0,130000.0,-52.0,-48.0,-44.0,-45.0,-52.0,-48.0,-44.0,-48.0,-86.0,-86.0,-83.0,-84.0,34.0,38.0,39.0,39.0,1
1110,CC:2F:71:3F:1F:24,4519955,1215244961,687940,731940376,3832015,483304585,37,553975,571665543,553280,571581865,695,83678,535523,15,688188,76468,34,472,144444.0,43333.0,-70.0,-68.0,-69.0,-71.0,-70.0,-68.0,-69.0,-71.0,-86.0,-86.0,-83.0,-84.0,16.0,18.0,14.0,13.0,1
1111,CC:2F:71:3E:C5:1F,3832853,483406990,838,102405,3832015,483304585,0,3503,294095,2890,221317,613,72778,886,8,1205,18,0,37,144444.0,39000.0,-72.0,-70.0,-66.0,-60.0,-71.0,-70.0,-66.0,-60.0,-86.0,-86.0,-83.0,-84.0,14.0,16.0,17.0,24.0,1
1112,BA:8C:B9:54:50:24,3836821,489483986,4806,6179401,3832015,483304585,0,8763,1683517,8741,1680022,22,3495,2345,14,5225,38,0,56,216660.0,130000.0,-49.0,-35.0,-43.0,-45.0,-43.0,-36.0,-44.0,-48.0,-86.0,-86.0,-83.0,-84.0,37.0,51.0,40.0,39.0,1
1113,92:69:1D:31:68:E9,3835874,486910513,3855,3605524,3832019,483304989,0,4565,1076714,4431,1046459,134,30255,2076,10,4034,84,0,41,229410.0,130000.0,-52.0,-48.0,-44.0,-45.0,-52.0,-48.0,-44.0,-48.0,-86.0,-86.0,-83.0,-84.0,34.0,38.0,39.0,39.0,1
1114,CC:2F:71:3F:1F:24,4519998,1215259543,687978,731954420,3832020,483305123,37,553997,571669393,553302,571585715,695,83678,535544,15,688226,76472,34,472,144444.0,43333.0,-70.0,-68.0,-69.0,-72.0,-70.0,-68.0,-69.0,-71.0,-86.0,-86.0,-83.0,-84.0,16.0,18.0,14.0,12.0,1
1115,CC:2F:71:3E:C5:1F,3832859,483407596,838,102405,3832021,483305191,0,3503,294095,2890,221317,613,72778,886,8,1205,18,0,37,144444.0,39000.0,-72.0,-70.0,-66.0,-60.0,-71.0,-70.0,-66.0,-60.0,-86.0,-86.0,-83.0,-84.0,14.0,16.0,17.0,24.0,1
1116,BA:8C:B9:54:50:24,3836827,489484592,4806,6179401,3832021,483305191,0,8763,1683517,8741,1680022,22,3495,2345,14,5225,38,0,56,216660.0,130000.0,-49.0,-35.0,-43.0,-45.0,-43.0,-36.0,-44.0,-48.0,-86.0,-86.0,-83.0,-84.0,37.0,51.0,40.0,39.0,1
1117,92:69:1D:31:68:E9,3835878,486910917,3855,3605524,3832023,483305393,0,4565,1076714,4431,1046459,134,30255,2076,10,4034,84,0,41,229410.0,130000.0,-52.0,-48.0,-44.0,-45.0,-52.0,-48.0,-44.0,-48.0,-86.0,-86.0,-83.0,-84.0,34.0,38.0,39.0,39.0,1
1118,CC:2F:71:3F:1F:24,4520042,1215274617,688019,731969224,3832023,483305393,37,554022,571673763,553327,571590085,695,83678,535565,15,688267,76481,34,472,144444.0,43333.0,-69.0,-68.0,-69.0,-73.0,-69.0,-68.0,-69.0,-73.0,-86.0,-86.0,-83.0,-84.0,17.0,18.0,14.0,11.0,1
1119,CC:2F:71:3E:C5:1F,3832861,483407798,838,102405,3832023,483305393,0,3503,294095,2890,221317,613,72778,886,8,1205,18,0,37,144444.0,39000.0,-72.0,-70.0,-66.0,-60.0,-71.0,-70.0,-66.0,-60.0,-86.0,-86.0,-83.0,-84.0,14.0,16.0,17.0,24.0,1
1120,BA:8C:B9:54:50:24,3836829,489484794,4806,6179401,3832023,483305393,0,8763,1683517,8741,1680022,22,3495,2345,14,5225,38,0,56,216660.0,130000.0,-49.0,-35.0,-43.0,-45.0,-43.0,-36.0,-44.0,-48.0,-86.0,-86.0,-83.0,-84.0,37.0,51.0,40.0,39.0,1
1121,92:69:1D:31:68:E9,3835882,486911452,3855,3605524,3832027,483305928,0,4565,1076714,4431,1046459,134,30255,2076,10,4034,84,0,41,229410.0,130000.0,-52.0,-48.0,-44.0,-45.0,-52.0,-48.0,-44.0,-48.0,-86.0,-86.0,-83.0,-84.0,34.0,38.0,39.0,39.0,1
1122,CC:2F:71:3F:1F:24,4520088,1215289658,688059,731983528,3832029,483306130,37,554044,571677613,553349,571593935,695,83678,535586,15,688307,76495,34,472,144444.0,43333.0,-70.0,-68.0,-69.0,-71.0,-70.0,-68.0,-68.0,-71.0,-86.0,-86.0,-83.0,-84.0,16.0,18.0,14.0,13.0,1
1123,CC:2F:71:3E:C5:1F,3832867,483408535,838,102405,3832029,483306130,0,3503,294095,2890,221317,613,72778,886,8,1205,18,0,37,144444.0,39000.0,-72.0,-70.0,-66.0,-60.0,-71.0,-70.0,-66.0,-60.0,-86.0,-86.0,-83.0,-84.0,14.0,16.0,17.0,24.0,1
1124,BA:8C:B9:54:50:24,3836837,489485733,4806,6179401,3832031,483306332,0,8763,1683517,8741,1680022,22,3495,2345,14,5225,38,0,56,216660.0,130000.0,-49.0,-35.0,-43.0,-45.0,-43.0,-36.0,-44.0,-48.0,-86.0,-86.0,-83.0,-84.0,37.0,51.0,40.0,39.0,1
1125,92:69:1D:31:68:E9,3835888,486912058,3855,3605524,3832033,483306534,0,4565,1076714,4431,1046459,134,30255,2076,10,4034,84,0,41,229410.0,130000.0,-52.0,-48.0,-44.0,-45.0,-52.0,-48.0,-44.0,-48.0,-86.0,-87.0,-84.0,-85.0,34.0,39.0,40.0,40.0,1
1126,CC:2F:71:3F:1F:24,4520141,1215308095,688107,732001435,3832034,483306660,37,554075,571683012,553380,571599334,695,83678,535615,15,688355,76499,34,472,144444.0,43333.0,-71.0,-68.0,-69.0,-72.0,-71.0,-68.0,-69.0,-72.0,-86.0,-87.0,-84.0,-85.0,15.0,19.0,15.0,13.0,1
1127,CC:2F:71:3E:C5:1F,3832872,483409065,838,102405,3832034,483306660,0,3503,294095,2890,221317,613,72778,886,8,1205,18,0,37,144444.0,39000.0,-72.0,-70.0,-66.0,-60.0,-71.0,-70.0,-66.0,-60.0,-86.0,-87.0,-84.0,-85.0,14.0,17.0,18.0,25.0,1
1128,BA:8C:B9:54:50:24,3836840,489486061,4806,6179401,3832034,483306660,0,8763,1683517,8741,1680022,22,3495,2345,14,5225,38,0,56,216660.0,130000.0,-49.0,-35.0,-43.0,-45.0,-43.0,-36.0,-44.0,-48.0,-86.0,-87.0,-84.0,-85.0,37.0,52.0,41.0,40.0,1
1129,92:69:1D:31:68:E9,3835891,486912386,3855,3605524,3832036,483306862,0,4565,1076714,4431,1046459,134,30255,2076,10,4034,84,0,41,229410.0,130000.0,-52.0,-48.0,-44.0,-45.0,-52.0,-48.0,-44.0,-48.0,-86.0,-87.0,-84.0,-85.0,34.0,39.0,40.0,40.0,1
1130,CC:2F:71:3F:1F:24,4520180,1215322211,688144,732015349,3832036,483306862,37,554098,571687120,553403,571603442,695,83678,535636,15,688392,76507,34,472,144444.0,43333.0,-70.0,-68.0,-70.0,-72.0,-70.0,-68.0,-69.0,-72.0,-86.0,-87.0,-84.0,-85.0,16.0,19.0,14.0,13.0,1
1131,CC:2F:71:3E:C5:1F,3832876,483409469,838,102405,3832038,483307064,0,3503,294095,2890,221317,613,72778,886,8,1205,18,0,37,144444.0,39000.0,-72.0,-70.0,-66.0,-60.0,-71.0,-70.0,-66.0,-60.0,-86.0,-87.0,-84.0,-85.0,14.0,17.0,18.0,25.0,1
1132,BA:8C:B9:54:50:24,3836847,489486727,4806,6179401,3832041,483307326,0,8763,1683517,8741,1680022,22,3495,2345,14,5225,38,0,56,216660.0,130000.0,-49.0,-35.0,-43.0,-45.0,-43.0,-36.0,-44.0,-48.0,-86.0,-87.0,-84.0,-85.0,37.0,52.0,41.0,40.0,1
1133,92:69:1D:31:68:E9,3835898,486913052,3855,3605524,3832043,483307528,0,4565,1076714,4431,1046459,134,30255,2076,10,4034,84,0,41,229410.0,130000.0,-52.0,-48.0,-44.0,-45.0,-52.0,-48.0,-44.0,-48.0,-86.0,-87.0,-84.0,-85.0,34.0,39.0,40.0,40.0,1
1134,CC:2F:71:3F:1F:24,4520225,1215336921,688182,732029393,3832043,483307528,37,554121,571691086,553426,571607408,695,83678,535658,15,688430,76511,34,472,144444.0,43333.0,-70.0,-68.0,-70.0,-72.0,-70.0,-68.0,-69.0,-71.0,-86.0,-87.0,-84.0,-85.0,16.0,19.0,14.0,13.0,1
1135,CC:2F:71:3E:C5:1F,3832881,483409933,838,102405,3832043,483307528,0,3503,294095,2890,221317,613,72778,886,8,1205,18,0,37,144444.0,39000.0,-72.0,-70.0,-66.0,-60.0,-71.0,-70.0,-66.0,-60.0,-86.0,-87.0,-84.0,-85.0,14.0,17.0,18.0,25.0,1
1136,BA:8C:B9:54:50:24,3836849,489486929,4806,6179401,3832043,483307528,0,8763,1683517,8741,1680022,22,3495,2345,14,5225,38,0,56,216660.0,130000.0,-49.0,-35.0,-43.0,-45.0,-43.0,-36.0,-44.0,-48.0,-86.0,-87.0,-84.0,-85.0,37.0,52.0,41.0,40.0,1
1137,92:69:1D:31:68:E9,3835900,486913254,3855,3605524,3832045,483307730,0,4565,1076714,4431,1046459,134,30255,2076,10,4034,84,0,41,229410.0,130000.0,-52.0,-48.0,-44.0,-45.0,-52.0,-48.0,-44.0,-48.0,-86.0,-87.0,-84.0,-85.0,34.0,39.0,40.0,40.0,1
1138,CC:2F:71:3F:1F:24,4520267,1215351427,688222,732043697,3832045,483307730,37,554144,571695052,553449,571611374,695,83678,535680,15,688470,76511,34,472,144444.0,43333.0,-70.0,-68.0,-70.0,-72.0,-69.0,-68.0,-70.0,-72.0,-86.0,-87.0,-84.0,-85.0,16.0,19.0,14.0,13.0,1
1139,CC:2F:71:3E:C5:1F,3832883,483410135,838,102405,3832045,483307730,0,3503,294095,2890,221317,613,72778,886,8,1205,18,0,37,144444.0,39000.0,-72.0,-70.0,-66.0,-60.0,-71.0,-70.0,-66.0,-60.0,-86.0,-87.0,-84.0,-85.0,14.0,17.0,18.0,25.0,1
1140,BA:8C:B9:54:50:24,3836855,489487535,4806,6179401,3832049,483308134,0,8763,1683517,8741,1680022,22,3495,2345,14,5225,38,0,56,216660.0,130000.0,-49.0,-35.0,-43.0,-45.0,-43.0,-36.0,-44.0,-48.0,-86.0,-87.0,-84.0,-85.0,37.0,52.0,41.0,40.0,1
1141,92:69:1D:31:68:E9,3835907,486913920,3855,3605524,3832052,483308396,0,4565,1076714,4431,1046459,134,30255,2076,10,4034,84,0,41,229410.0,130000.0,-52.0,-48.0,-44.0,-45.0,-52.0,-48.0,-44.0,-48.0,-86.0,-87.0,-84.0,-85.0,34.0,39.0,40.0,40.0,1
1142,CC:2F:71:3F:1F:24,4520321,1215369930,688269,732061534,3832052,483308396,37,554176,571700597,553481,571616919,695,83678,535711,15,688517,76514,34,472,144444.0,43333.0,-70.0,-69.0,-71.0,-74.0,-70.0,-68.0,-70.0,-73.0,-86.0,-87.0,-84.0,-85.0,16.0,18.0,13.0,11.0,1
1143,CC:2F:71:3E:C5:1F,3832890,483410801,838,102405,3832052,483308396,0,3503,294095,2890,221317,613,72778,886,8,1205,18,0,37,144444.0,39000.0,-72.0,-70.0,-66.0,-60.0,-71.0,-70.0,-66.0,-60.0,-86.0,-87.0,-84.0,-85.0,14.0,17.0,18.0,25.0,1
1144,BA:8C:B9:54:50:24,3836858,489487797,4806,6179401,3832052,483308396,0,8763,1683517,8741,1680022,22,3495,2345,14,5225,38,0,56,216660.0,130000.0,-49.0,-35.0,-43.0,-45.0,-43.0,-36.0,-44.0,-48.0,-86.0,-87.0,-84.0,-85.0,37.0,52.0,41.0,40.0,1
1145,92:69:1D:31:68:E9,3835909,486914122,3855,3605524,3832054,483308598,0,4565,1076714,4431,1046459,134,30255,2076,10,4034,84,0,41,229410.0,130000.0,-52.0,-48.0,-44.0,-45.0,-52.0,-48.0,-44.0,-48.0,-86.0,-87.0,-84.0,-85.0,34.0,39.0,40.0,40.0,1
1146,CC:2F:71:3F:1F:24,4520361,1215384176,688307,732075578,3832054,483308598,37,554200,571704633,553505,571620955,695,83678,535733,15,688555,76519,34,472,144444.0,43333.0,-70.0,-68.0,-70.0,-72.0,-70.0,-68.0,-70.0,-72.0,-86.0,-87.0,-84.0,-85.0,16.0,19.0,14.0,13.0,1
1147,CC:2F:71:3E:C5:1F,3832892,483411003,838,102405,3832054,483308598,0,3503,294095,2890,221317,613,72778,886,8,1205,18,0,37,144444.0,39000.0,-72.0,-70.0,-66.0,-60.0,-71.0,-70.0,-66.0,-60.0,-86.0,-87.0,-84.0,-85.0,14.0,17.0,18.0,25.0,1
1148,BA:8C:B9:54:50:24,3836862,489488201,4806,6179401,3832056,483308800,0,8763,1683517,8741,1680022,22,3495,2345,14,5225,38,0,56,216660.0,130000.0,-49.0,-35.0,-43.0,-45.0,-43.0,-36.0,-44.0,-48.0,-86.0,-87.0,-84.0,-85.0,37.0,52.0,41.0,40.0,1
1149,92:69:1D:31:68:E9,3835915,486914728,3855,3605524,3832060,483309204,0,4565,1076714,4431,1046459,134,30255,2076,10,4034,84,0,41,229410.0,130000.0,-52.0,-48.0,-44.0,-45.0,-52.0,-48.0,-44.0,-48.0,-86.0,-87.0,-84.0,-85.0,34.0,39.0,40.0,40.0,1
1150,CC:2F:71:3F:1F:24,4520407,1215399086,688347,732089882,3832060,483309204,37,554222,571708483,553527,571624805,695,83678,535754,15,688595,76522,34,472,144444.0,43333.0,-70.0,-68.0,-71.0,-72.0,-70.0,-68.0,-70.0,-72.0,-86.0,-87.0,-84.0,-85.0,16.0,19.0,13.0,13.0,1
1151,CC:2F:71:3E:C5:1F,3832898,483411609,838,102405,3832060,483309204,0,3503,294095,2890,221317,613,72778,886,8,1205,18,0,37,144444.0,39000.0,-72.0,-70.0,-66.0,-60.0,-71.0,-70.0,-66.0,-60.0,-86.0,-87.0,-84.0,-85.0,14.0,17.0,18.0,25.0,1
1152,BA:8C:B9:54:50:24,3836866,489488605,4806,6179401,3832060,483309204,0,8763,1683517,8741,1680022,22,3495,2345,14,5225,38,0,56,216660.0,130000.0,-49.0,-35.0,-43.0,-45.0,-43.0,-36.0,-44.0,-48.0,-86.0,-87.0,-84.0,-85.0,37.0,52.0,41.0,40.0,1
1153,92:69:1D:31:68:E9,3835918,486914990,3855,3605524,3832063,483309466,0,4566,1076782,4432,1046527,134,30255,2076,10,4034,84,0,41,229410.0,130000.0,-52.0,-49.0,-44.0,-46.0,-51.0,-48.0,-44.0,-47.0,-86.0,-87.0,-84.0,-85.0,34.0,38.0,40.0,39.0,1
1154,CC:2F:71:3F:1F:24,4520450,1215413652,688387,732104186,3832063,483309466,37,554250,571713217,553555,571629539,695,83678,535779,15,688635,76532,34,472,144444.0,43333.0,-70.0,-68.0,-71.0,-73.0,-69.0,-68.0,-70.0,-72.0,-86.0,-87.0,-84.0,-85.0,16.0,19.0,13.0,12.0,1
1155,CC:2F:71:3E:C5:1F,3832901,483411871,838,102405,3832063,483309466,0,3503,294095,2890,221317,613,72778,886,8,1205,18,0,37,144444.0,39000.0,-72.0,-70.0,-66.0,-60.0,-71.0,-70.0,-66.0,-60.0,-86.0,-87.0,-84.0,-85.0,14.0,17.0,18.0,25.0,1
1156,BA:8C:B9:54:50:24,3836869,489488867,4806,6179401,3832063,483309466,0,8763,1683517,8741,1680022,22,3495,2345,14,5225,38,0,56,216660.0,130000.0,-49.0,-35.0,-43.0,-45.0,-43.0,-36.0,-44.0,-48.0,-86.0,-87.0,-84.0,-85.0,37.0,52.0,41.0,40.0,1
1157,92:69:1D:31:68:E9,3835924,486915596,3855,3605524,3832069,483310072,0,4566,1076782,4432,1046527,134,30255,2076,10,4034,84,0,41,229410.0,130000.0,-52.0,-49.0,-44.0,-46.0,-51.0,-48.0,-44.0,-47.0,-86.0,-87.0,-84.0,-85.0,34.0,38.0,40.0,39.0,1
1158,CC:2F:71:3F:1F:24,4520502,1215431903,688433,732121831,3832069,483310072,37,554284,571718951,553589,571635273,695,83678,535812,15,688681,76556,34,472,144444.0,43333.0,-70.0,-68.0,-70.0,-71.0,-70.0,-68.0,-69.0,-70.0,-86.0,-87.0,-84.0,-85.0,16.0,19.0,14.0,14.0,1
1159,CC:2F:71:3E:C5:1F,3832907,483412477,838,102405,3832069,483310072,0,3503,294095,2890,221317,613,72778,886,8,1205,18,0,37,144444.0,39000.0,-72.0,-70.0,-66.0,-60.0,-71.0,-70.0,-66.0,-60.0,-86.0,-87.0,-84.0,-85.0,14.0,17.0,18.0,25.0,1
1160,BA:8C:B9:54:50:24,3836875,489489473,4806,6179401,3832069,483310072,0,8763,1683517,8741,1680022,22,3495,2345,14,5225,38,0,56,216660.0,130000.0,-49.0,-35.0,-43.0,-45.0,-43.0,-36.0,-44.0,-48.0,-86.0,-87.0,-84.0,-85.0,37.0,52.0,41.0,40.0,1
1161,92:69:1D:31:68:E9,3835926,486915798,3855,3605524,3832071,483310274,0,4566,1076782,4432,1046527,134,30255,2076,10,4034,84,0,41,229410.0,130000.0,-52.0,-49.0,-44.0,-46.0,-51.0,-48.0,-44.0,-47.0,-87.0,-87.0,-85.0,-86.0,35.0,38.0,41.0,40.0,1
1162,CC:2F:71:3F:1F:24,4520543,1215446167,688472,732135893,3832071,483310274,37,554306,571722801,553611,571639123,695,83678,535833,15,688720,76594,34,472,144444.0,43333.0,-69.0,-66.0,-71.0,-71.0,-68.0,-66.0,-70.0,-70.0,-87.0,-87.0,-85.0,-86.0,18.0,21.0,14.0,15.0,1
1163,CC:2F:71:3E:C5:1F,3832909,483412679,838,102405,3832071,483310274,0,3503,294095,2890,221317,613,72778,886,8,1205,18,0,37,144444.0,39000.0,-72.0,-70.0,-66.0,-60.0,-71.0,-70.0,-66.0,-60.0,-87.0,-87.0,-85.0,-86.0,15.0,17.0,19.0,26.0,1
1164,BA:8C:B9:54:50:24,3836878,489489735,4806,6179401,3832072,483310334,0,8763,1683517,8741,1680022,22,3495,2345,14,5225,38,0,56,216660.0,130000.0,-49.0,-35.0,-43.0,-45.0,-43.0,-36.0,-44.0,-48.0,-87.0,-87.0,-85.0,-86.0,38.0,52.0,42.0,41.0,1
1165,92:69:1D:31:68:E9,3835933,486916464,3855,3605524,3832078,483310940,0,4566,1076782,4432,1046527,134,30255,2076,10,4034,84,0,41,229410.0,130000.0,-52.0,-49.0,-44.0,-46.0,-51.0,-48.0,-44.0,-47.0,-87.0,-87.0,-85.0,-86.0,35.0,38.0,41.0,40.0,1
1166,CC:2F:71:3F:1F:24,4520591,1215461253,688513,732150313,3832078,483310940,37,554329,571726767,553634,571643089,695,83678,535855,15,688761,76620,34,472,144444.0,43333.0,-69.0,-68.0,-69.0,-71.0,-68.0,-67.0,-69.0,-71.0,-87.0,-87.0,-85.0,-86.0,18.0,19.0,16.0,15.0,1
1167,CC:2F:71:3E:C5:1F,3832917,483413461,839,102521,3832078,483310940,0,3505,294235,2892,221457,613,72778,886,8,1206,18,0,37,144444.0,39000.0,-71.0,-70.0,-66.0,-60.0,-71.0,-70.0,-66.0,-60.0,-87.0,-87.0,-85.0,-86.0,16.0,17.0,19.0,26.0,1
1168,BA:8C:B9:54:50:24,3836885,489490457,4807,6179517,3832078,483310940,0,8765,1683653,8743,1680158,22,3495,2345,14,5226,38,0,56,216660.0,130000.0,-39.0,-37.0,-45.0,-51.0,-42.0,-36.0,-44.0,-49.0,-87.0,-87.0,-85.0,-86.0,48.0,50.0,40.0,35.0,1
1169,92:69:1D:31:68:E9,3835936,486916782,3856,3605640,3832080,483311142,0,4568,1076918,4434,1046663,134,30255,2076,10,4035,84,0,41,229410.0,130000.0,-51.0,-47.0,-42.0,-49.0,-51.0,-48.0,-44.0,-47.0,-87.0,-87.0,-85.0,-86.0,36.0,40.0,43.0,37.0,1
1170,CC:2F:71:3F:1F:24,4520633,1215475759,688553,732164617,3832080,483311142,37,554351,571730617,553656,571646939,695,83678,535876,15,688801,76662,34,472,144444.0,43333.0,-72.0,-71.0,-76.0,-76.0,-70.0,-70.0,-74.0,-73.0,-87.0,-87.0,-85.0,-86.0,15.0,16.0,9.0,10.0,1
1171,CC:2F:71:3E:C5:1F,3832919,483413663,839,102521,3832080,483311142,0,3505,294235,2892,221457,613,72778,886,8,1206,18,0,37,144444.0,39000.0,-71.0,-70.0,-66.0,-60.0,-71.0,-70.0,-66.0,-60.0,-87.0,-87.0,-85.0,-86.0,16.0,17.0,19.0,26.0,1
1172,BA:8C:B9:54:50:24,3836887,489490659,4807,6179517,3832080,483311142,0,8765,1683653,8743,1680158,22,3495,2345,14,5226,38,0,56,216660.0,130000.0,-39.0,-37.0,-45.0,-51.0,-42.0,-36.0,-44.0,-49.0,-87.0,-87.0,-85.0,-86.0,48.0,50.0,40.0,35.0,1
1173,92:69:1D:31:68:E9,3835944,486917721,3856,3605640,3832088,483312081,0,4568,1076918,4434,1046663,134,30255,2076,10,4035,84,0,41,229410.0,130000.0,-51.0,-47.0,-42.0,-49.0,-51.0,-48.0,-44.0,-47.0,-87.0,-88.0,-85.0,-86.0,36.0,41.0,43.0,37.0,1
1174,CC:2F:71:3F:1F:24,4520689,1215494605,688601,732182524,3832088,483312081,37,554385,571736584,553690,571652906,695,83678,535906,15,688849,76685,34,472,144444.0,43333.0,-69.0,-69.0,-70.0,-71.0,-69.0,-68.0,-70.0,-70.0,-87.0,-88.0,-85.0,-86.0,18.0,19.0,15.0,15.0,1
1175,CC:2F:71:3E:C5:1F,3832927,483414602,839,102521,3832088,483312081,0,3505,294235,2892,221457,613,72778,886,8,1206,18,0,37,144444.0,39000.0,-71.0,-70.0,-66.0,-60.0,-71.0,-70.0,-66.0,-60.0,-87.0,-88.0,-85.0,-86.0,16.0,18.0,19.0,26.0,1
1176,BA:8C:B9:54:50:24,3836895,489491598,4807,6179517,3832088,483312081,0,8765,1683653,8743,1680158,22,3495,2345,14,5226,38,0,56,216660.0,130000.0,-39.0,-37.0,-45.0,-51.0,-42.0,-36.0,-44.0,-49.0,-87.0,-88.0,-85.0,-86.0,48.0,51.0,40.0,35.0,1
1177,92:69:1D:31:68:E9,3835947,486917985,3856,3605640,3832091,483312345,0,4568,1076918,4434,1046663,134,30255,2076,10,4035,84,0,41,229410.0,130000.0,-51.0,-47.0,-42.0,-49.0,-51.0,-48.0,-44.0,-47.0,-87.0,-88.0,-85.0,-86.0,36.0,41.0,43.0,37.0,1
1178,CC:2F:71:3F:1F:24,4520731,1215509043,688640,732196698,3832091,483312345,37,554412,571741032,553716,571657236,696,83796,535930,15,688888,76716,34,472,144444.0,43333.0,-70.0,-66.0,-71.0,-70.0,-69.0,-66.0,-71.0,-69.0,-87.0,-88.0,-85.0,-86.0,17.0,22.0,14.0,16.0,1
1179,CC:2F:71:3E:C5:1F,3832930,483414866,839,102521,3832091,483312345,0,3505,294235,2892,221457,613,72778,886,8,1206,18,0,37,144444.0,39000.0,-71.0,-70.0,-66.0,-60.0,-71.0,-70.0,-66.0,-60.0,-87.0,-88.0,-85.0,-86.0,16.0,18.0,19.0,26.0,1
1180,BA:8C:B9:54:50:24,3836898,489491862,4807,6179517,3832091,483312345,0,8765,1683653,8743,1680158,22,3495,2345,14,5226,38,0,56,216660.0,130000.0,-39.0,-37.0,-45.0,-51.0,-42.0,-36.0,-44.0,-49.0,-87.0,-88.0,-85.0,-86.0,48.0,51.0,40.0,35.0,1
1181,92:69:1D:31:68:E9,3835953,486918591,3856,3605640,3832097,483312951,0,4568,1076918,4434,1046663,134,30255,2076,10,4035,84,0,41,229410.0,130000.0,-51.0,-47.0,-42.0,-49.0,-51.0,-48.0,-44.0,-47.0,-87.0,-88.0,-85.0,-86.0,36.0,41.0,43.0,37.0,1
1182,CC:2F:71:3F:1F:24,4520776,1215523767,688679,732210816,3832097,483312951,37,554437,571745354,553741,571661558,696,83796,535952,15,688927,76748,34,472,130000.0,39000.0,-68.0,-66.0,-69.0,-70.0,-68.0,-66.0,-69.0,-69.0,-87.0,-88.0,-85.0,-86.0,19.0,22.0,16.0,16.0,1
1183,CC:2F:71:3E:C5:1F,3832936,483415472,839,102521,3832097,483312951,0,3505,294235,2892,221457,613,72778,886,8,1206,18,0,37,144444.0,39000.0,-71.0,-70.0,-66.0,-60.0,-71.0,-70.0,-66.0,-60.0,-87.0,-88.0,-85.0,-86.0,16.0,18.0,19.0,26.0,1
1184,BA:8C:B9:54:50:24,3836904,489492468,4807,6179517,3832097,483312951,0,8765,1683653,8743,1680158,22,3495,2345,14,5226,38,0,56,216660.0,130000.0,-39.0,-37.0,-45.0,-51.0,-42.0,-36.0,-44.0,-49.0,-87.0,-88.0,-85.0,-86.0,48.0,51.0,40.0,35.0,1
1185,92:69:1D:31:68:E9,3835958,486919221,3856,3605640,3832102,483313581,0,4568,1076918,4434,1046663,134,30255,2076,10,4035,84,0,41,229410.0,130000.0,-51.0,-47.0,-42.0,-49.0,-51.0,-48.0,-44.0,-47.0,-87.0,-88.0,-85.0,-86.0,36.0,41.0,43.0,37.0,1
1186,CC:2F:71:3F:1F:24,4520821,1215538589,688719,732225008,3832102,483313581,37,554460,571749320,553764,571665524,696,83796,535974,15,688967,76764,34,472,130000.0,39000.0,-72.0,-69.0,-71.0,-72.0,-71.0,-68.0,-70.0,-71.0,-87.0,-88.0,-85.0,-86.0,15.0,19.0,14.0,14.0,1
1187,CC:2F:71:3E:C5:1F,3832941,483416102,839,102521,3832102,483313581,0,3505,294235,2892,221457,613,72778,886,8,1206,18,0,37,144444.0,39000.0,-71.0,-70.0,-66.0,-60.0,-71.0,-70.0,-66.0,-60.0,-87.0,-88.0,-85.0,-86.0,16.0,18.0,19.0,26.0,1
1188,BA:8C:B9:54:50:24,3836909,489493098,4807,6179517,3832102,483313581,0,8765,1683653,8743,1680158,22,3495,2345,14,5226,38,0,56,216660.0,130000.0,-39.0,-37.0,-45.0,-51.0,-42.0,-36.0,-44.0,-49.0,-87.0,-88.0,-85.0,-86.0,48.0,51.0,40.0,35.0,1
1189,92:69:1D:31:68:E9,3835964,486919827,3856,3605640,3832108,483314187,0,4568,1076918,4434,1046663,134,30255,2076,10,4035,84,0,41,229410.0,130000.0,-51.0,-47.0,-42.0,-49.0,-51.0,-48.0,-44.0,-47.0,-88.0,-88.0,-85.0,-86.0,37.0,41.0,43.0,37.0,1
1190,CC:2F:71:3F:1F:24,4520894,1215562651,688786,732248464,3832108,483314187,37,554508,571759397,553812,571675601,696,83796,536021,15,689034,76766,34,472,130000.0,43333.0,-69.0,-66.0,-69.0,-69.0,-69.0,-66.0,-68.0,-69.0,-88.0,-88.0,-85.0,-86.0,19.0,22.0,16.0,17.0,1
1191,CC:2F:71:3E:C5:1F,3832947,483416708,839,102521,3832108,483314187,0,3505,294235,2892,221457,613,72778,886,8,1206,18,0,37,144444.0,39000.0,-71.0,-70.0,-66.0,-60.0,-71.0,-70.0,-66.0,-60.0,-88.0,-88.0,-85.0,-86.0,17.0,18.0,19.0,26.0,1
1192,BA:8C:B9:54:50:24,3836915,489493704,4807,6179517,3832108,483314187,0,8765,1683653,8743,1680158,22,3495,2345,14,5226,38,0,56,216660.0,130000.0,-39.0,-37.0,-45.0,-51.0,-42.0,-36.0,-44.0,-49.0,-88.0,-88.0,-85.0,-86.0,49.0,51.0,40.0,35.0,1
1193,92:69:1D:31:68:E9,3835966,486920029,3856,3605640,3832110,483314389,0,4568,1076918,4434,1046663,134,30255,2076,10,4035,84,0,41,229410.0,130000.0,-51.0,-47.0,-42.0,-49.0,-51.0,-48.0,-44.0,-47.0,-88.0,-88.0,-85.0,-86.0,37.0,41.0,43.0,37.0,1
1194,CC:2F:71:3F:1F:24,4520936,1215577101,688826,732262712,3832110,483314389,37,554530,571763247,553834,571679451,696,83796,536042,15,689074,76784,34,472,117000.0,39000.0,-72.0,-69.0,-71.0,-72.0,-69.0,-66.0,-69.0,-69.0,-88.0,-88.0,-85.0,-86.0,16.0,19.0,14.0,14.0,1
1195,CC:2F:71:3E:C5:1F,3832949,483416910,839,102521,3832110,483314389,0,3505,294235,2892,221457,613,72778,886,8,1206,18,0,37,144444.0,39000.0,-71.0,-70.0,-66.0,-60.0,-71.0,-70.0,-66.0,-60.0,-88.0,-88.0,-85.0,-86.0,17.0,18.0,19.0,26.0,1
1196,BA:8C:B9:54:50:24,3836917,489493906,4807,6179517,3832110,483314389,0,8765,1683653,8743,1680158,22,3495,2345,14,5226,38,0,56,216660.0,130000.0,-39.0,-37.0,-45.0,-51.0,-42.0,-36.0,-44.0,-49.0,-88.0,-88.0,-85.0,-86.0,49.0,51.0,40.0,35.0,1
1197,92:69:1D:31:68:E9,3835974,486920757,3856,3605640,3832118,483315117,0,4568,1076918,4434,1046663,134,30255,2076,10,4035,84,0,41,229410.0,130000.0,-51.0,-47.0,-42.0,-49.0,-51.0,-48.0,-44.0,-47.0,-88.0,-88.0,-85.0,-86.0,37.0,41.0,43.0,37.0,1
1198,CC:2F:71:3F:1F:24,4520984,1215592021,688866,732276904,3832118,483315117,37,554555,571767697,553859,571683901,696,83796,536064,15,689114,76787,34,472,130000.0,39000.0,-69.0,-66.0,-69.0,-69.0,-71.0,-67.0,-71.0,-71.0,-88.0,-88.0,-85.0,-86.0,19.0,22.0,16.0,17.0,1
1199,CC:2F:71:3E:C5:1F,3832957,483417638,839,102521,3832118,483315117,0,3507,294423,2893,221527,614,72896,887,8,1206,18,0,37,144444.0,39000.0,-72.0,-70.0,-67.0,-60.0,-71.0,-69.0,-66.0,-60.0,-88.0,-88.0,-85.0,-86.0,16.0,18.0,18.0,26.0,1
1200,BA:8C:B9:54:50:24,3836925,489494634,4807,6179517,3832118,483315117,0,8765,1683653,8743,1680158,22,3495,2345,14,5226,38,0,56,216660.0,130000.0,-39.0,-37.0,-45.0,-51.0,-42.0,-36.0,-44.0,-49.0,-88.0,-88.0,-85.0,-86.0,49.0,51.0,40.0,35.0,1
1201,92:69:1D:31:68:E9,3835976,486920959,3856,3605640,3832120,483315319,0,4570,1077054,4436,1046799,134,30255,2076,10,4036,84,0,41,229410.0,130000.0,-51.0,-48.0,-44.0,-46.0,-51.0,-48.0,-43.0,-47.0,-88.0,-88.0,-85.0,-86.0,37.0,40.0,41.0,40.0,1
1202,CC:2F:71:3F:1F:24,4521026,1215606359,688906,732291040,3832120,483315319,37,554580,571771923,553884,571688127,696,83796,536086,15,689154,76808,34,472,117000.0,39000.0,-72.0,-69.0,-72.0,-72.0,-72.0,-68.0,-72.0,-72.0,-88.0,-88.0,-85.0,-86.0,16.0,19.0,13.0,14.0,1
1203,CC:2F:71:3E:C5:1F,3832959,483417840,839,102521,3832120,483315319,0,3507,294423,2893,221527,614,72896,887,8,1206,18,0,37,144444.0,39000.0,-72.0,-70.0,-67.0,-60.0,-71.0,-69.0,-66.0,-60.0,-88.0,-88.0,-85.0,-86.0,16.0,18.0,18.0,26.0,1
1204,BA:8C:B9:54:50:24,3836927,489494836,4807,6179517,3832120,483315319,0,8769,1683925,8747,1680430,22,3495,2345,14,5227,38,0,56,216660.0,130000.0,-40.0,-37.0,-46.0,-51.0,-43.0,-36.0,-44.0,-48.0,-88.0,-88.0,-85.0,-86.0,48.0,51.0,39.0,35.0,1
1205,92:69:1D:31:68:E9,3835983,486921625,3856,3605640,3832127,483315985,0,4570,1077054,4436,1046799,134,30255,2076,10,4036,84,0,41,229410.0,130000.0,-51.0,-48.0,-44.0,-46.0,-51.0,-48.0,-43.0,-47.0,-88.0,-89.0,-86.0,-87.0,37.0,41.0,42.0,41.0,1
1206,CC:2F:71:3F:1F:24,4521079,1215624560,688952,732308575,3832127,483315985,37,554619,571778794,553923,571694998,696,83796,536115,15,689200,76809,34,472,130000.0,43333.0,-69.0,-65.0,-68.0,-70.0,-69.0,-66.0,-69.0,-70.0,-88.0,-89.0,-86.0,-87.0,19.0,24.0,18.0,17.0,1
1207,CC:2F:71:3E:C5:1F,3832966,483418506,839,102521,3832127,483315985,0,3507,294423,2893,221527,614,72896,887,8,1206,18,0,37,144444.0,39000.0,-72.0,-70.0,-67.0,-60.0,-71.0,-69.0,-66.0,-60.0,-88.0,-89.0,-86.0,-87.0,16.0,19.0,19.0,27.0,1
1208,BA:8C:B9:54:50:24,3836934,489495502,4807,6179517,3832127,483315985,0,8769,1683925,8747,1680430,22,3495,2345,14,5227,38,0,56,216660.0,130000.0,-40.0,-37.0,-46.0,-51.0,-43.0,-36.0,-44.0,-48.0,-88.0,-89.0,-86.0,-87.0,48.0,52.0,40.0,36.0,1
1209,92:69:1D:31:68:E9,3835985,486921827,3856,3605640,3832129,483316187,0,4570,1077054,4436,1046799,134,30255,2076,10,4036,84,0,41,229410.0,130000.0,-51.0,-48.0,-44.0,-46.0,-51.0,-48.0,-43.0,-47.0,-88.0,-89.0,-86.0,-87.0,37.0,41.0,42.0,41.0,1
1210,CC:2F:71:3F:1F:24,4521121,1215639010,688992,732322823,3832129,483316187,37,554643,571782876,553947,571699080,696,83796,536138,15,689240,76819,34,472,130000.0,39000.0,-69.0,-66.0,-68.0,-70.0,-69.0,-66.0,-68.0,-69.0,-88.0,-89.0,-86.0,-87.0,19.0,23.0,18.0,17.0,1
1211,CC:2F:71:3E:C5:1F,3832968,483418708,839,102521,3832129,483316187,0,3507,294423,2893,221527,614,72896,887,8,1206,18,0,37,144444.0,39000.0,-72.0,-70.0,-67.0,-60.0,-71.0,-69.0,-66.0,-60.0,-88.0,-89.0,-86.0,-87.0,16.0,19.0,19.0,27.0,1
1212,BA:8C:B9:54:50:24,3836936,489495704,4807,6179517,3832129,483316187,0,8769,1683925,8747,1680430,22,3495,2345,14,5227,38,0,56,216660.0,130000.0,-40.0,-37.0,-46.0,-51.0,-43.0,-36.0,-44.0,-48.0,-88.0,-89.0,-86.0,-87.0,48.0,52.0,40.0,36.0,1
1213,92:69:1D:31:68:E9,3835991,486922433,3856,3605640,3832135,483316793,0,4570,1077054,4436,1046799,134,30255,2076,10,4036,84,0,41,229410.0,130000.0,-51.0,-48.0,-44.0,-46.0,-51.0,-48.0,-43.0,-47.0,-88.0,-89.0,-86.0,-87.0,37.0,41.0,42.0,41.0,1
1214,CC:2F:71:3F:1F:24,4521166,1215653678,689031,732336885,3832135,483316793,37,554677,571788630,553981,571704834,696,83796,536163,15,689279,76825,34,472,130000.0,39000.0,-68.0,-65.0,-72.0,-71.0,-67.0,-64.0,-71.0,-70.0,-88.0,-89.0,-86.0,-87.0,20.0,24.0,14.0,16.0,1
1215,CC:2F:71:3E:C5:1F,3832974,483419314,839,102521,3832135,483316793,0,3507,294423,2893,221527,614,72896,887,8,1206,18,0,37,144444.0,39000.0,-72.0,-70.0,-67.0,-60.0,-71.0,-69.0,-66.0,-60.0,-88.0,-89.0,-86.0,-87.0,16.0,19.0,19.0,27.0,1
1216,BA:8C:B9:54:50:24,3836942,489496310,4807,6179517,3832135,483316793,0,8769,1683925,8747,1680430,22,3495,2345,14,5227,38,0,56,216660.0,130000.0,-40.0,-37.0,-46.0,-51.0,-43.0,-36.0,-44.0,-48.0,-88.0,-89.0,-86.0,-87.0,48.0,52.0,40.0,36.0,1
1217,92:69:1D:31:68:E9,3835994,486922695,3856,3605640,3832138,483317055,0,4570,1077054,4436,1046799,134,30255,2076,10,4036,84,0,41,229410.0,130000.0,-51.0,-48.0,-44.0,-46.0,-51.0,-48.0,-43.0,-47.0,-88.0,-89.0,-86.0,-87.0,37.0,41.0,42.0,41.0,1
1218,CC:2F:71:3F:1F:24,4521208,1215667946,689070,732350891,3832138,483317055,37,554707,571793344,554011,571709548,696,83796,536188,15,689318,76833,34,472,144444.0,39000.0,-68.0,-68.0,-71.0,-72.0,-68.0,-66.0,-70.0,-70.0,-88.0,-89.0,-86.0,-87.0,20.0,21.0,15.0,15.0,1
1219,CC:2F:71:3E:C5:1F,3832977,483419576,839,102521,3832138,483317055,0,3507,294423,2893,221527,614,72896,887,8,1206,18,0,37,144444.0,39000.0,-72.0,-70.0,-67.0,-60.0,-71.0,-69.0,-66.0,-60.0,-88.0,-89.0,-86.0,-87.0,16.0,19.0,19.0,27.0,1
1220,BA:8C:B9:54:50:24,3836945,489496572,4807,6179517,3832138,483317055,0,8769,1683925,8747,1680430,22,3495,2345,14,5227,38,0,56,216660.0,130000.0,-40.0,-37.0,-46.0,-51.0,-43.0,-36.0,-44.0,-48.0,-88.0,-89.0,-86.0,-87.0,48.0,52.0,40.0,36.0,1
1221,92:69:1D:31:68:E9,3836000,486923301,3856,3605640,3832144,483317661,0,4570,1077054,4436,1046799,134,30255,2076,10,4036,84,0,41,229410.0,130000.0,-51.0,-48.0,-44.0,-46.0,-51.0,-48.0,-43.0,-47.0,-89.0,-90.0,-87.0,-88.0,38.0,42.0,43.0,42.0,1
1222,CC:2F:71:3F:1F:24,4521261,1215686273,689117,732368612,3832144,483317661,37,554738,571798798,554042,571715002,696,83796,536218,15,689365,76836,34,472,144444.0,43333.0,-72.0,-71.0,-74.0,-72.0,-71.0,-71.0,-72.0,-71.0,-89.0,-90.0,-87.0,-88.0,17.0,19.0,13.0,16.0,1
1223,CC:2F:71:3E:C5:1F,3832983,483420182,839,102521,3832144,483317661,0,3507,294423,2893,221527,614,72896,887,8,1206,18,0,37,144444.0,39000.0,-72.0,-70.0,-67.0,-60.0,-71.0,-69.0,-66.0,-60.0,-89.0,-90.0,-87.0,-88.0,17.0,20.0,20.0,28.0,1
1224,BA:8C:B9:54:50:24,3836951,489497178,4807,6179517,3832144,483317661,0,8769,1683925,8747,1680430,22,3495,2345,14,5227,38,0,56,216660.0,130000.0,-40.0,-37.0,-46.0,-51.0,-43.0,-36.0,-44.0,-48.0,-89.0,-90.0,-87.0,-88.0,49.0,53.0,41.0,37.0,1
1225,92:69:1D:31:68:E9,3836002,486923503,3856,3605640,3832146,483317863,0,4570,1077054,4436,1046799,134,30255,2076,10,4036,84,0,41,229410.0,130000.0,-51.0,-48.0,-44.0,-46.0,-51.0,-48.0,-43.0,-47.0,-89.0,-90.0,-87.0,-88.0,38.0,42.0,43.0,42.0,1
1226,CC:2F:71:3F:1F:24,4521302,1215700649,689156,732382786,3832146,483317863,37,554762,571802942,554066,571719146,696,83796,536240,15,689404,76838,34,472,144444.0,43333.0,-69.0,-68.0,-70.0,-72.0,-71.0,-69.0,-72.0,-73.0,-89.0,-90.0,-87.0,-88.0,20.0,22.0,17.0,16.0,1
1227,CC:2F:71:3E:C5:1F,3832985,483420384,839,102521,3832146,483317863,0,3507,294423,2893,221527,614,72896,887,8,1206,18,0,37,144444.0,39000.0,-72.0,-70.0,-67.0,-60.0,-71.0,-69.0,-66.0,-60.0,-89.0,-90.0,-87.0,-88.0,17.0,20.0,20.0,28.0,1
1228,BA:8C:B9:54:50:24,3836955,489497713,4807,6179517,3832148,483318196,0,8769,1683925,8747,1680430,22,3495,2345,14,5227,38,0,56,216660.0,130000.0,-40.0,-37.0,-46.0,-51.0,-43.0,-36.0,-44.0,-48.0,-89.0,-90.0,-87.0,-88.0,49.0,53.0,41.0,37.0,1
1229,92:69:1D:31:68:E9,3836010,486924442,3856,3605640,3832154,483318802,0,4570,1077054,4436,1046799,134,30255,2076,10,4036,84,0,41,229410.0,130000.0,-51.0,-48.0,-44.0,-46.0,-51.0,-48.0,-43.0,-47.0,-89.0,-90.0,-87.0,-88.0,38.0,42.0,43.0,42.0,1
1230,CC:2F:71:3F:1F:24,4521350,1215715892,689196,732397090,3832154,483318802,37,554784,571806792,554088,571722996,696,83796,536261,15,689444,76839,34,472,144444.0,43333.0,-70.0,-67.0,-73.0,-70.0,-70.0,-67.0,-72.0,-71.0,-89.0,-90.0,-87.0,-88.0,19.0,23.0,14.0,18.0,1
1231,CC:2F:71:3E:C5:1F,3832993,483421323,839,102521,3832154,483318802,0,3507,294423,2893,221527,614,72896,887,8,1206,18,0,37,144444.0,39000.0,-72.0,-70.0,-67.0,-60.0,-71.0,-69.0,-66.0,-60.0,-89.0,-90.0,-87.0,-88.0,17.0,20.0,20.0,28.0,1
1232,BA:8C:B9:54:50:24,3836961,489498319,4807,6179517,3832154,483318802,0,8770,1683993,8748,1680498,22,3495,2345,14,5227,38,0,56,216660.0,130000.0,-40.0,-37.0,-46.0,-51.0,-43.0,-36.0,-44.0,-48.0,-89.0,-90.0,-87.0,-88.0,49.0,53.0,41.0,37.0,1
1233,92:69:1D:31:68:E9,3836012,486924644,3856,3605640,3832156,483319004,0,4570,1077054,4436,1046799,134,30255,2076,10,4036,84,0,41,229410.0,130000.0,-51.0,-48.0,-44.0,-46.0,-51.0,-48.0,-43.0,-47.0,-89.0,-90.0,-87.0,-88.0,38.0,42.0,43.0,42.0,1
1234,CC:2F:71:3F:1F:24,4521392,1215730398,689236,732411394,3832156,483319004,37,554807,571810758,554111,571726962,696,83796,536283,15,689484,76840,34,472,144444.0,43333.0,-70.0,-69.0,-72.0,-71.0,-70.0,-69.0,-71.0,-71.0,-89.0,-90.0,-87.0,-88.0,19.0,21.0,15.0,17.0,1
1235,CC:2F:71:3E:C5:1F,3832995,483421525,839,102521,3832156,483319004,0,3507,294423,2893,221527,614,72896,887,8,1206,18,0,37,144444.0,39000.0,-72.0,-70.0,-67.0,-60.0,-71.0,-69.0,-66.0,-60.0,-89.0,-90.0,-87.0,-88.0,17.0,20.0,20.0,28.0,1
1236,BA:8C:B9:54:50:24,3836963,489498521,4807,6179517,3832156,483319004,0,8770,1683993,8748,1680498,22,3495,2345,14,5227,38,0,56,216660.0,130000.0,-40.0,-37.0,-46.0,-51.0,-43.0,-36.0,-44.0,-48.0,-89.0,-90.0,-87.0,-88.0,49.0,53.0,41.0,37.0,1
1237,92:69:1D:31:68:E9,3836019,486925310,3856,3605640,3832163,483319670,0,4570,1077054,4436,1046799,134,30255,2076,10,4036,84,0,41,229410.0,130000.0,-51.0,-48.0,-44.0,-46.0,-51.0,-48.0,-43.0,-47.0,-89.0,-90.0,-87.0,-88.0,38.0,42.0,43.0,42.0,1
1238,CC:2F:71:3F:1F:24,4521446,1215748841,689283,732429171,3832163,483319670,37,554837,571816027,554141,571732231,696,83796,536312,15,689531,76844,34,472,144444.0,43333.0,-74.0,-70.0,-74.0,-76.0,-74.0,-70.0,-74.0,-75.0,-89.0,-90.0,-87.0,-88.0,15.0,20.0,13.0,12.0,1
1239,CC:2F:71:3E:C5:1F,3833002,483422191,839,102521,3832163,483319670,0,3507,294423,2893,221527,614,72896,887,8,1206,18,0,37,144444.0,39000.0,-72.0,-70.0,-67.0,-60.0,-71.0,-69.0,-66.0,-60.0,-89.0,-90.0,-87.0,-88.0,17.0,20.0,20.0,28.0,1
1240,BA:8C:B9:54:50:24,3836970,489499187,4807,6179517,3832163,483319670,0,8770,1683993,8748,1680498,22,3495,2345,14,5227,38,0,56,216660.0,130000.0,-40.0,-37.0,-46.0,-51.0,-43.0,-36.0,-44.0,-48.0,-89.0,-90.0,-87.0,-88.0,49.0,53.0,41.0,37.0,1
1241,92:69:1D:31:68:E9,3836021,486925512,3856,3605640,3832165,483319872,0,4570,1077054,4436,1046799,134,30255,2076,10,4036,84,0,41,229410.0,130000.0,-51.0,-48.0,-44.0,-46.0,-51.0,-48.0,-43.0,-47.0,-89.0,-90.0,-87.0,-88.0,38.0,42.0,43.0,42.0,1
1242,CC:2F:71:3F:1F:24,4521488,1215763347,689323,732443475,3832165,483319872,37,554861,571820109,554165,571736313,696,83796,536335,15,689571,76851,34,472,144444.0,43333.0,-75.0,-72.0,-75.0,-73.0,-74.0,-71.0,-75.0,-72.0,-89.0,-90.0,-87.0,-88.0,14.0,18.0,12.0,15.0,1
1243,CC:2F:71:3E:C5:1F,3833004,483422393,839,102521,3832165,483319872,0,3507,294423,2893,221527,614,72896,887,8,1206,18,0,37,144444.0,39000.0,-72.0,-70.0,-67.0,-60.0,-71.0,-69.0,-66.0,-60.0,-89.0,-90.0,-87.0,-88.0,17.0,20.0,20.0,28.0,1
1244,BA:8C:B9:54:50:24,3836972,489499389,4807,6179517,3832165,483319872,0,8770,1683993,8748,1680498,22,3495,2345,14,5227,38,0,56,216660.0,130000.0,-40.0,-37.0,-46.0,-51.0,-43.0,-36.0,-44.0,-48.0,-89.0,-90.0,-87.0,-88.0,49.0,53.0,41.0,37.0,1
1245,92:69:1D:31:68:E9,3836027,486926118,3856,3605640,3832171,483320478,0,4570,1077054,4436,1046799,134,30255,2076,10,4036,84,0,41,229410.0,130000.0,-51.0,-48.0,-44.0,-46.0,-51.0,-48.0,-43.0,-47.0,-89.0,-90.0,-87.0,-88.0,38.0,42.0,43.0,42.0,1
1246,CC:2F:71:3F:1F:24,4521534,1215778257,689363,732457779,3832171,483320478,37,554883,571823959,554187,571740163,696,83796,536356,15,689611,76856,34,472,144444.0,43333.0,-74.0,-71.0,-75.0,-73.0,-74.0,-71.0,-74.0,-73.0,-89.0,-90.0,-87.0,-88.0,15.0,19.0,12.0,15.0,1
1247,CC:2F:71:3E:C5:1F,3833010,483422999,839,102521,3832171,483320478,0,3507,294423,2893,221527,614,72896,887,8,1206,18,0,37,144444.0,39000.0,-72.0,-70.0,-67.0,-60.0,-71.0,-69.0,-66.0,-60.0,-89.0,-90.0,-87.0,-88.0,17.0,20.0,20.0,28.0,1
1248,BA:8C:B9:54:50:24,3836978,489499995,4807,6179517,3832171,483320478,0,8770,1683993,8748,1680498,22,3495,2345,14,5227,38,0,56,216660.0,130000.0,-40.0,-37.0,-46.0,-51.0,-43.0,-36.0,-44.0,-48.0,-89.0,-90.0,-87.0,-88.0,49.0,53.0,41.0,37.0,1
1249,92:69:1D:31:68:E9,3836030,486926380,3856,3605640,3832174,483320740,0,4570,1077054,4436,1046799,134,30255,2076,10,4036,84,0,41,229410.0,130000.0,-51.0,-48.0,-44.0,-46.0,-51.0,-48.0,-43.0,-47.0,-89.0,-90.0,-87.0,-88.0,38.0,42.0,43.0,42.0,1
1250,CC:2F:71:3F:1F:24,4521576,1215792693,689402,732471953,3832174,483320740,37,554911,571828519,554215,571744723,696,83796,536382,15,689650,76858,34,472,144444.0,43333.0,-73.0,-70.0,-75.0,-72.0,-72.0,-70.0,-73.0,-71.0,-89.0,-90.0,-87.0,-88.0,16.0,20.0,12.0,16.0,1
1251,CC:2F:71:3E:C5:1F,3833013,483423261,839,102521,3832174,483320740,0,3507,294423,2893,221527,614,72896,887,8,1206,18,0,37,144444.0,39000.0,-72.0,-70.0,-67.0,-60.0,-71.0,-69.0,-66.0,-60.0,-89.0,-90.0,-87.0,-88.0,17.0,20.0,20.0,28.0,1
1252,BA:8C:B9:54:50:24,3836981,489500257,4807,6179517,3832174,483320740,0,8770,1683993,8748,1680498,22,3495,2345,14,5227,38,0,56,216660.0,130000.0,-40.0,-37.0,-46.0,-51.0,-43.0,-36.0,-44.0,-48.0,-89.0,-90.0,-87.0,-88.0,49.0,53.0,41.0,37.0,1
1253,92:69:1D:31:68:E9,3836036,486926986,3856,3605640,3832180,483321346,0,4570,1077054,4436,1046799,134,30255,2076,10,4036,84,0,41,229410.0,130000.0,-51.0,-48.0,-44.0,-46.0,-51.0,-48.0,-43.0,-47.0,-89.0,-90.0,-87.0,-88.0,38.0,42.0,43.0,42.0,1
1254,CC:2F:71:3F:1F:24,4521628,1215810946,689448,732489600,3832180,483321346,37,554944,571834288,554248,571750492,696,83796,536410,15,689696,76861,34,472,144444.0,43333.0,-74.0,-71.0,-74.0,-72.0,-73.0,-70.0,-73.0,-71.0,-89.0,-90.0,-87.0,-88.0,15.0,19.0,13.0,16.0,1
1255,CC:2F:71:3E:C5:1F,3833019,483423867,839,102521,3832180,483321346,0,3507,294423,2893,221527,614,72896,887,8,1206,18,0,37,144444.0,39000.0,-72.0,-70.0,-67.0,-60.0,-71.0,-69.0,-66.0,-60.0,-89.0,-90.0,-87.0,-88.0,17.0,20.0,20.0,28.0,1
1256,BA:8C:B9:54:50:24,3836987,489500863,4807,6179517,3832180,483321346,0,8770,1683993,8748,1680498,22,3495,2345,14,5227,38,0,56,216660.0,130000.0,-40.0,-37.0,-46.0,-51.0,-43.0,-36.0,-44.0,-48.0,-89.0,-90.0,-87.0,-88.0,49.0,53.0,41.0,37.0,1
1257,92:69:1D:31:68:E9,3836040,486927398,3856,3605640,3832184,483321758,0,4570,1077054,4436,1046799,134,30255,2076,10,4036,84,0,41,229410.0,130000.0,-51.0,-48.0,-44.0,-46.0,-51.0,-48.0,-43.0,-47.0,-89.0,-90.0,-87.0,-88.0,38.0,42.0,43.0,42.0,1
1258,CC:2F:71:3F:1F:24,4521672,1215825662,689488,732503904,3832184,483321758,37,554968,571838370,554272,571754574,696,83796,536433,15,689736,76861,34,472,144444.0,43333.0,-71.0,-69.0,-72.0,-71.0,-71.0,-68.0,-72.0,-70.0,-89.0,-90.0,-87.0,-88.0,18.0,21.0,15.0,17.0,1
1259,CC:2F:71:3E:C5:1F,3833023,483424279,839,102521,3832184,483321758,0,3507,294423,2893,221527,614,72896,887,8,1206,18,0,37,144444.0,39000.0,-72.0,-70.0,-67.0,-60.0,-71.0,-69.0,-66.0,-60.0,-89.0,-90.0,-87.0,-88.0,17.0,20.0,20.0,28.0,1
1260,BA:8C:B9:54:50:24,3836992,489501335,4807,6179517,3832185,483321818,0,8770,1683993,8748,1680498,22,3495,2345,14,5227,38,0,56,216660.0,130000.0,-40.0,-37.0,-46.0,-51.0,-43.0,-36.0,-44.0,-48.0,-89.0,-90.0,-87.0,-88.0,49.0,53.0,41.0,37.0,1
1261,92:69:1D:31:68:E9,3836045,486927862,3856,3605640,3832189,483322222,0,4570,1077054,4436,1046799,134,30255,2076,10,4036,84,0,41,229410.0,130000.0,-51.0,-48.0,-44.0,-46.0,-51.0,-48.0,-43.0,-47.0,-89.0,-90.0,-87.0,-88.0,38.0,42.0,43.0,42.0,1
1262,CC:2F:71:3F:1F:24,4521716,1215840300,689527,732518078,3832189,483322222,37,554992,571842466,554296,571758670,696,83796,536455,15,689775,76861,34,472,144444.0,43333.0,-71.0,-68.0,-71.0,-70.0,-71.0,-68.0,-71.0,-70.0,-89.0,-90.0,-87.0,-88.0,18.0,22.0,16.0,18.0,1
1263,CC:2F:71:3E:C5:1F,3833030,483424945,839,102521,3832191,483322424,0,3507,294423,2893,221527,614,72896,887,8,1206,18,0,37,144444.0,39000.0,-72.0,-70.0,-67.0,-60.0,-71.0,-69.0,-66.0,-60.0,-89.0,-90.0,-87.0,-88.0,17.0,20.0,20.0,28.0,1
1264,BA:8C:B9:54:50:24,3836998,489501941,4807,6179517,3832191,483322424,0,8770,1683993,8748,1680498,22,3495,2345,14,5227,38,0,56,216660.0,130000.0,-40.0,-37.0,-46.0,-51.0,-43.0,-36.0,-44.0,-48.0,-89.0,-90.0,-87.0,-88.0,49.0,53.0,41.0,37.0,1
1265,92:69:1D:31:68:E9,3836049,486928266,3856,3605640,3832193,483322626,0,4570,1077054,4436,1046799,134,30255,2076,10,4036,84,0,41,229410.0,130000.0,-51.0,-48.0,-44.0,-46.0,-51.0,-48.0,-43.0,-47.0,-89.0,-90.0,-87.0,-88.0,38.0,42.0,43.0,42.0,1
1266,CC:2F:71:3F:1F:24,4521760,1215855008,689567,732532382,3832193,483322626,37,555014,571846316,554318,571762520,696,83796,536476,15,689815,76881,34,472,144444.0,43333.0,-71.0,-67.0,-73.0,-73.0,-71.0,-66.0,-72.0,-72.0,-89.0,-90.0,-87.0,-88.0,18.0,23.0,14.0,15.0,1
1267,CC:2F:71:3E:C5:1F,3833032,483425147,839,102521,3832193,483322626,0,3507,294423,2893,221527,614,72896,887,8,1206,18,0,37,144444.0,39000.0,-72.0,-70.0,-67.0,-60.0,-71.0,-69.0,-66.0,-60.0,-89.0,-90.0,-87.0,-88.0,17.0,20.0,20.0,28.0,1
1268,BA:8C:B9:54:50:24,3837000,489502143,4807,6179517,3832193,483322626,0,8770,1683993,8748,1680498,22,3495,2345,14,5227,38,0,56,216660.0,130000.0,-40.0,-37.0,-46.0,-51.0,-43.0,-36.0,-44.0,-48.0,-89.0,-90.0,-87.0,-88.0,49.0,53.0,41.0,37.0,1
1269,92:69:1D:31:68:E9,3836054,486928730,3856,3605640,3832198,483323090,0,4570,1077054,4436,1046799,134,30255,2076,10,4036,84,0,41,229410.0,130000.0,-51.0,-48.0,-44.0,-46.0,-51.0,-48.0,-43.0,-47.0,-89.0,-90.0,-87.0,-88.0,38.0,42.0,43.0,42.0,1
1270,CC:2F:71:3F:1F:24,4521805,1215869776,689607,732546686,3832198,483323090,37,555037,571850282,554341,571766486,696,83796,536498,15,689855,76883,34,472,144444.0,43333.0,-71.0,-66.0,-73.0,-73.0,-71.0,-66.0,-72.0,-72.0,-89.0,-90.0,-87.0,-88.0,18.0,24.0,14.0,15.0,1
1271,CC:2F:71:3E:C5:1F,3833037,483425611,839,102521,3832198,483323090,0,3507,294423,2893,221527,614,72896,887,8,1206,18,0,37,144444.0,39000.0,-72.0,-70.0,-67.0,-60.0,-71.0,-69.0,-66.0,-60.0,-89.0,-90.0,-87.0,-88.0,17.0,20.0,20.0,28.0,1
1272,BA:8C:B9:54:50:24,3837007,489502809,4807,6179517,3832200,483323292,0,8770,1683993,8748,1680498,22,3495,2345,14,5227,38,0,56,216660.0,130000.0,-40.0,-37.0,-46.0,-51.0,-43.0,-36.0,-44.0,-48.0,-89.0,-90.0,-87.0,-88.0,49.0,53.0,41.0,37.0,1
1273,92:69:1D:31:68:E9,3836059,486929250,3857,3605756,3832202,483323494,0,4572,1077190,4438,1046935,134,30255,2076,10,4037,84,0,41,229410.0,130000.0,-52.0,-47.0,-43.0,-48.0,-51.0,-47.0,-43.0,-46.0,-89.0,-90.0,-87.0,-88.0,37.0,43.0,44.0,40.0,1
1274,CC:2F:71:3F:1F:24,4521857,1215888089,689655,732564595,3832202,483323494,37,555072,571856350,554376,571772554,696,83796,536527,15,689903,76902,34,472,144444.0,43333.0,-73.0,-67.0,-72.0,-71.0,-73.0,-66.0,-71.0,-71.0,-89.0,-90.0,-87.0,-88.0,16.0,23.0,15.0,17.0,1
1275,CC:2F:71:3E:C5:1F,3833042,483426131,840,102637,3832202,483323494,0,3509,294563,2895,221667,614,72896,887,8,1207,18,0,37,144444.0,39000.0,-71.0,-70.0,-66.0,-60.0,-70.0,-69.0,-66.0,-60.0,-89.0,-90.0,-87.0,-88.0,18.0,20.0,21.0,28.0,1
1276,BA:8C:B9:54:50:24,3837010,489503127,4808,6179633,3832202,483323494,0,8772,1684129,8750,1680634,22,3495,2345,14,5228,38,0,56,216660.0,130000.0,-40.0,-37.0,-46.0,-51.0,-40.0,-36.0,-45.0,-50.0,-89.0,-90.0,-87.0,-88.0,49.0,53.0,41.0,37.0,1
1277,92:69:1D:31:68:E9,3836062,486929586,3857,3605756,3832205,483323830,0,4572,1077190,4438,1046935,134,30255,2076,10,4037,84,0,41,229410.0,130000.0,-52.0,-47.0,-43.0,-48.0,-51.0,-47.0,-43.0,-46.0,-89.0,-90.0,-87.0,-88.0,37.0,43.0,44.0,40.0,1
1278,CC:2F:71:3F:1F:24,4521900,1215902729,689695,732578899,3832205,483323830,37,555095,571860316,554399,571776520,696,83796,536549,15,689943,76914,34,472,144444.0,43333.0,-72.0,-67.0,-72.0,-72.0,-72.0,-67.0,-71.0,-72.0,-89.0,-90.0,-87.0,-88.0,17.0,23.0,15.0,16.0,1
1279,CC:2F:71:3E:C5:1F,3833046,483426535,840,102637,3832206,483323898,0,3509,294563,2895,221667,614,72896,887,8,1207,18,0,37,144444.0,39000.0,-71.0,-70.0,-66.0,-60.0,-70.0,-69.0,-66.0,-60.0,-89.0,-90.0,-87.0,-88.0,18.0,20.0,21.0,28.0,1
1280,BA:8C:B9:54:50:24,3837014,489503531,4808,6179633,3832206,483323898,0,8772,1684129,8750,1680634,22,3495,2345,14,5228,38,0,56,216660.0,130000.0,-40.0,-37.0,-46.0,-51.0,-40.0,-36.0,-45.0,-50.0,-89.0,-90.0,-87.0,-88.0,49.0,53.0,41.0,37.0,1
1281,92:69:1D:31:68:E9,3836069,486930391,3857,3605756,3832212,483324635,0,4572,1077190,4438,1046935,134,30255,2076,10,4037,84,0,41,229410.0,130000.0,-52.0,-47.0,-43.0,-48.0,-51.0,-47.0,-43.0,-46.0,-89.0,-90.0,-87.0,-88.0,37.0,43.0,44.0,40.0,1
1282,CC:2F:71:3F:1F:24,4521947,1215917838,689735,732593203,3832212,483324635,37,555119,571864398,554423,571780602,696,83796,536572,15,689983,76937,34,472,144444.0,43333.0,-73.0,-67.0,-72.0,-72.0,-72.0,-67.0,-71.0,-71.0,-89.0,-90.0,-87.0,-88.0,16.0,23.0,15.0,16.0,1
1283,CC:2F:71:3E:C5:1F,3833052,483427272,840,102637,3832212,483324635,0,3509,294563,2895,221667,614,72896,887,8,1207,18,0,37,144444.0,39000.0,-71.0,-70.0,-66.0,-60.0,-70.0,-69.0,-66.0,-60.0,-89.0,-90.0,-87.0,-88.0,18.0,20.0,21.0,28.0,1
1284,BA:8C:B9:54:50:24,3837020,489504268,4808,6179633,3832212,483324635,0,8772,1684129,8750,1680634,22,3495,2345,14,5228,38,0,56,216660.0,130000.0,-40.0,-37.0,-46.0,-51.0,-40.0,-36.0,-45.0,-50.0,-89.0,-90.0,-87.0,-88.0,49.0,53.0,41.0,37.0,1
1285,92:69:1D:31:68:E9,3836069,486930391,3857,3605756,3832212,483324635,0,4572,1077190,4438,1046935,134,30255,2076,10,4037,84,0,41,229410.0,130000.0,-52.0,-47.0,-43.0,-48.0,-51.0,-47.0,-43.0,-46.0,-89.0,-90.0,-87.0,-88.0,37.0,43.0,44.0,40.0,1
1286,CC:2F:71:3F:1F:24,4521987,1215932142,689775,732607507,3832212,483324635,37,555141,571868248,554445,571784452,696,83796,536593,15,690023,76965,34,472,144444.0,43333.0,-73.0,-67.0,-72.0,-71.0,-72.0,-67.0,-71.0,-71.0,-89.0,-90.0,-87.0,-88.0,16.0,23.0,15.0,17.0,1
1287,CC:2F:71:3E:C5:1F,3833056,483427676,840,102637,3832216,483325039,0,3509,294563,2895,221667,614,72896,887,8,1207,18,0,37,144444.0,39000.0,-71.0,-70.0,-66.0,-60.0,-70.0,-69.0,-66.0,-60.0,-89.0,-90.0,-87.0,-88.0,18.0,20.0,21.0,28.0,1
1288,BA:8C:B9:54:50:24,3837024,489504672,4808,6179633,3832216,483325039,0,8772,1684129,8750,1680634,22,3495,2345,14,5228,38,0,56,216660.0,130000.0,-40.0,-37.0,-46.0,-51.0,-40.0,-36.0,-45.0,-50.0,-89.0,-90.0,-87.0,-88.0,49.0,53.0,41.0,37.0,1
1289,92:69:1D:31:68:E9,3836077,486931199,3857,3605756,3832220,483325443,0,4572,1077190,4438,1046935,134,30255,2076,10,4037,84,0,41,229410.0,130000.0,-52.0,-47.0,-43.0,-48.0,-51.0,-47.0,-43.0,-46.0,-89.0,-90.0,-87.0,-88.0,37.0,43.0,44.0,40.0,1
1290,CC:2F:71:3F:1F:24,4522041,1215950541,689821,732625098,3832220,483325443,37,555170,571873415,554474,571789619,696,83796,536620,15,690069,76999,34,472,130000.0,43333.0,-72.0,-67.0,-72.0,-71.0,-72.0,-67.0,-71.0,-71.0,-89.0,-90.0,-87.0,-88.0,17.0,23.0,15.0,17.0,1
1291,CC:2F:71:3E:C5:1F,3833060,483428080,840,102637,3832220,483325443,0,3509,294563,2895,221667,614,72896,887,8,1207,18,0,37,144444.0,39000.0,-71.0,-70.0,-66.0,-60.0,-70.0,-69.0,-66.0,-60.0,-89.0,-90.0,-87.0,-88.0,18.0,20.0,21.0,28.0,1
1292,BA:8C:B9:54:50:24,3837029,489505136,4808,6179633,3832221,483325503,0,8772,1684129,8750,1680634,22,3495,2345,14,5228,38,0,56,216660.0,130000.0,-40.0,-37.0,-46.0,-51.0,-40.0,-36.0,-45.0,-50.0,-89.0,-90.0,-87.0,-88.0,49.0,53.0,41.0,37.0,1
1293,92:69:1D:31:68:E9,3836078,486931259,3857,3605756,3832221,483325503,0,4572,1077190,4438,1046935,134,30255,2076,10,4037,84,0,41,229410.0,130000.0,-52.0,-47.0,-43.0,-48.0,-51.0,-47.0,-43.0,-46.0,-89.0,-90.0,-87.0,-88.0,37.0,43.0,44.0,40.0,1
1294,CC:2F:71:3F:1F:24,4522081,1215964775,689860,732639272,3832221,483325503,37,555195,571877737,554499,571793941,696,83796,536642,15,690108,77004,34,472,130000.0,43333.0,-72.0,-67.0,-72.0,-71.0,-72.0,-67.0,-72.0,-70.0,-89.0,-90.0,-87.0,-88.0,17.0,23.0,15.0,17.0,1
1295,CC:2F:71:3E:C5:1F,3833065,483428544,840,102637,3832225,483325907,0,3509,294563,2895,221667,614,72896,887,8,1207,18,0,37,144444.0,39000.0,-71.0,-70.0,-66.0,-60.0,-70.0,-69.0,-66.0,-60.0,-89.0,-90.0,-87.0,-88.0,18.0,20.0,21.0,28.0,1
1296,BA:8C:B9:54:50:24,3837033,489505540,4808,6179633,3832225,483325907,0,8772,1684129,8750,1680634,22,3495,2345,14,5228,38,0,56,216660.0,130000.0,-40.0,-37.0,-46.0,-51.0,-40.0,-36.0,-45.0,-50.0,-89.0,-90.0,-87.0,-88.0,49.0,53.0,41.0,37.0,1
1297,92:69:1D:31:68:E9,3836086,486932067,3857,3605756,3832229,483326311,0,4572,1077190,4438,1046935,134,30255,2076,10,4037,84,0,41,229410.0,130000.0,-52.0,-47.0,-43.0,-48.0,-51.0,-47.0,-43.0,-46.0,-89.0,-90.0,-87.0,-88.0,37.0,43.0,44.0,40.0,1
1298,CC:2F:71:3F:1F:24,4522127,1215979627,689898,732653316,3832229,483326311,37,555218,571881703,554522,571797907,696,83796,536664,15,690146,77014,34,472,130000.0,43333.0,-72.0,-67.0,-71.0,-71.0,-72.0,-67.0,-71.0,-71.0,-89.0,-90.0,-87.0,-88.0,17.0,23.0,16.0,17.0,1
1299,CC:2F:71:3E:C5:1F,3833069,483428948,840,102637,3832229,483326311,0,3509,294563,2895,221667,614,72896,887,8,1207,18,0,37,144444.0,39000.0,-71.0,-70.0,-66.0,-60.0,-70.0,-69.0,-66.0,-60.0,-89.0,-90.0,-87.0,-88.0,18.0,20.0,21.0,28.0,1
1300,BA:8C:B9:54:50:24,3837037,489505944,4808,6179633,3832229,483326311,0,8772,1684129,8750,1680634,22,3495,2345,14,5228,38,0,56,216660.0,130000.0,-40.0,-37.0,-46.0,-51.0,-40.0,-36.0,-45.0,-50.0,-89.0,-90.0,-87.0,-88.0,49.0,53.0,41.0,37.0,1
1301,92:69:1D:31:68:E9,3836087,486932127,3857,3605756,3832230,483326371,0,4572,1077190,4438,1046935,134,30255,2076,10,4037,84,0,41,229410.0,130000.0,-52.0,-47.0,-43.0,-48.0,-51.0,-47.0,-43.0,-46.0,-89.0,-90.0,-87.0,-88.0,37.0,43.0,44.0,40.0,1
1302,CC:2F:71:3F:1F:24,4522176,1215997608,689944,732671035,3832232,483326573,37,555248,571886984,554552,571803188,696,83796,536693,15,690192,77019,34,472,130000.0,39000.0,-72.0,-67.0,-71.0,-71.0,-71.0,-67.0,-71.0,-71.0,-89.0,-90.0,-87.0,-88.0,17.0,23.0,16.0,17.0,1
1303,CC:2F:71:3E:C5:1F,3833074,483429412,840,102637,3832234,483326775,0,3509,294563,2895,221667,614,72896,887,8,1207,18,0,37,144444.0,39000.0,-71.0,-70.0,-66.0,-60.0,-70.0,-69.0,-66.0,-60.0,-89.0,-90.0,-87.0,-88.0,18.0,20.0,21.0,28.0,1
1304,BA:8C:B9:54:50:24,3837042,489506408,4808,6179633,3832234,483326775,0,8772,1684129,8750,1680634,22,3495,2345,14,5228,38,0,56,216660.0,130000.0,-40.0,-37.0,-46.0,-51.0,-40.0,-36.0,-45.0,-50.0,-89.0,-90.0,-87.0,-88.0,49.0,53.0,41.0,37.0,1
1305,92:69:1D:31:68:E9,3836096,486932997,3857,3605756,3832239,483327241,0,4574,1077326,4440,1047071,134,30255,2076,10,4038,84,0,41,229410.0,130000.0,-51.0,-48.0,-43.0,-46.0,-51.0,-47.0,-43.0,-47.0,-89.0,-90.0,-87.0,-88.0,38.0,42.0,44.0,42.0,1
1306,CC:2F:71:3F:1F:24,4522222,1216012226,689983,732684985,3832239,483327241,37,555273,571891182,554577,571807386,696,83796,536717,15,690231,77031,34,472,117000.0,39000.0,-72.0,-67.0,-72.0,-71.0,-72.0,-67.0,-71.0,-71.0,-89.0,-90.0,-87.0,-88.0,17.0,23.0,15.0,17.0,1
1307,CC:2F:71:3E:C5:1F,3833079,483429878,840,102637,3832239,483327241,0,3512,294821,2897,221807,615,73014,888,8,1208,18,0,37,144444.0,39000.0,-71.0,-70.0,-66.0,-60.0,-70.0,-69.0,-66.0,-60.0,-89.0,-90.0,-87.0,-88.0,18.0,20.0,21.0,28.0,1
1308,BA:8C:B9:54:50:24,3837047,489506874,4808,6179633,3832239,483327241,0,8774,1684265,8752,1680770,22,3495,2345,14,5229,38,0,56,216660.0,130000.0,-40.0,-37.0,-46.0,-51.0,-40.0,-37.0,-46.0,-51.0,-89.0,-90.0,-87.0,-88.0,49.0,53.0,41.0,37.0,1
1309,92:69:1D:31:68:E9,3836096,486932997,3857,3605756,3832239,483327241,0,4574,1077326,4440,1047071,134,30255,2076,10,4038,84,0,41,229410.0,130000.0,-51.0,-48.0,-43.0,-46.0,-51.0,-47.0,-43.0,-47.0,-89.0,-90.0,-87.0,-88.0,38.0,42.0,44.0,42.0,1
1310,CC:2F:71:3F:1F:24,4522262,1216026418,690023,732699177,3832239,483327241,37,555296,571895290,554600,571811494,696,83796,536738,15,690271,77046,34,472,130000.0,43333.0,-72.0,-67.0,-72.0,-71.0,-72.0,-67.0,-71.0,-70.0,-89.0,-90.0,-87.0,-88.0,17.0,23.0,15.0,17.0,1
1311,CC:2F:71:3E:C5:1F,3833083,483430282,840,102637,3832243,483327645,0,3512,294821,2897,221807,615,73014,888,8,1208,18,0,37,144444.0,39000.0,-71.0,-70.0,-66.0,-60.0,-70.0,-69.0,-66.0,-60.0,-89.0,-90.0,-87.0,-88.0,18.0,20.0,21.0,28.0,1
1312,BA:8C:B9:54:50:24,3837051,489507278,4808,6179633,3832243,483327645,0,8774,1684265,8752,1680770,22,3495,2345,14,5229,38,0,56,216660.0,130000.0,-40.0,-37.0,-46.0,-51.0,-40.0,-37.0,-46.0,-51.0,-89.0,-90.0,-87.0,-88.0,49.0,53.0,41.0,37.0,1
1313,92:69:1D:31:68:E9,3836105,486933865,3857,3605756,3832248,483328109,0,4575,1077394,4441,1047139,134,30255,2076,10,4038,84,0,41,229410.0,130000.0,-51.0,-48.0,-43.0,-46.0,-51.0,-47.0,-43.0,-46.0,-89.0,-90.0,-87.0,-88.0,38.0,42.0,44.0,42.0,1
1314,CC:2F:71:3F:1F:24,4522313,1216041777,690065,732713668,3832248,483328109,37,555322,571899597,554626,571815801,696,83796,536762,15,690313,77078,34,472,117000.0,39000.0,-72.0,-67.0,-72.0,-71.0,-72.0,-67.0,-72.0,-70.0,-89.0,-90.0,-87.0,-88.0,17.0,23.0,15.0,17.0,1
1315,CC:2F:71:3E:C5:1F,3833088,483430746,840,102637,3832248,483328109,0,3512,294821,2897,221807,615,73014,888,8,1208,18,0,37,144444.0,39000.0,-71.0,-70.0,-66.0,-60.0,-70.0,-69.0,-66.0,-60.0,-89.0,-90.0,-87.0,-88.0,18.0,20.0,21.0,28.0,1
1316,BA:8C:B9:54:50:24,3837056,489507742,4808,6179633,3832248,483328109,0,8774,1684265,8752,1680770,22,3495,2345,14,5229,38,0,56,216660.0,130000.0,-40.0,-37.0,-46.0,-51.0,-40.0,-37.0,-46.0,-51.0,-89.0,-90.0,-87.0,-88.0,49.0,53.0,41.0,37.0,1
1317,92:69:1D:31:68:E9,3836105,486933865,3857,3605756,3832248,483328109,0,4575,1077394,4441,1047139,134,30255,2076,10,4038,84,0,41,229410.0,130000.0,-51.0,-48.0,-43.0,-46.0,-51.0,-47.0,-43.0,-46.0,-89.0,-90.0,-87.0,-88.0,38.0,42.0,44.0,42.0,1
1318,CC:2F:71:3F:1F:24,4522359,1216059200,690111,732731091,3832248,483328109,37,555356,571905358,554660,571821562,696,83796,536793,15,690359,77123,34,472,117000.0,39000.0,-72.0,-67.0,-72.0,-71.0,-72.0,-67.0,-72.0,-71.0,-89.0,-90.0,-87.0,-88.0,17.0,23.0,15.0,17.0,1
1319,CC:2F:71:3E:C5:1F,3833090,483430948,840,102637,3832250,483328311,0,3512,294821,2897,221807,615,73014,888,8,1208,18,0,37,144444.0,39000.0,-71.0,-70.0,-66.0,-60.0,-70.0,-69.0,-66.0,-60.0,-89.0,-90.0,-87.0,-88.0,18.0,20.0,21.0,28.0,1
1320,BA:8C:B9:54:50:24,3837058,489507944,4808,6179633,3832250,483328311,0,8774,1684265,8752,1680770,22,3495,2345,14,5229,38,0,56,216660.0,130000.0,-40.0,-37.0,-46.0,-51.0,-40.0,-37.0,-46.0,-51.0,-89.0,-90.0,-87.0,-88.0,49.0,53.0,41.0,37.0,1
1321,92:69:1D:31:68:E9,3836114,486934735,3857,3605756,3832257,483328979,0,4575,1077394,4441,1047139,134,30255,2076,10,4038,84,0,41,229410.0,130000.0,-51.0,-48.0,-43.0,-46.0,-51.0,-47.0,-43.0,-46.0,-89.0,-90.0,-87.0,-88.0,38.0,42.0,44.0,42.0,1
1322,CC:2F:71:3F:1F:24,4522407,1216074132,690150,732745153,3832257,483328979,37,555381,571909558,554684,571825644,697,83914,536817,15,690398,77153,34,473,130000.0,43333.0,-72.0,-67.0,-72.0,-71.0,-72.0,-67.0,-72.0,-71.0,-89.0,-90.0,-87.0,-88.0,17.0,23.0,15.0,17.0,1
1323,CC:2F:71:3E:C5:1F,3833098,483431676,840,102637,3832258,483329039,0,3512,294821,2897,221807,615,73014,888,8,1208,18,0,37,144444.0,39000.0,-71.0,-70.0,-66.0,-60.0,-70.0,-69.0,-66.0,-60.0,-89.0,-90.0,-87.0,-88.0,18.0,20.0,21.0,28.0,1
1324,BA:8C:B9:54:50:24,3837066,489508672,4808,6179633,3832258,483329039,0,8774,1684265,8752,1680770,22,3495,2345,14,5229,38,0,56,216660.0,130000.0,-40.0,-37.0,-46.0,-51.0,-40.0,-37.0,-46.0,-51.0,-89.0,-90.0,-87.0,-88.0,49.0,53.0,41.0,37.0,1
1325,92:69:1D:31:68:E9,3836127,486940394,3857,3605756,3832270,483334638,0,4578,1077765,4443,1047275,135,30490,2077,10,4038,84,0,41,229410.0,130000.0,-51.0,-48.0,-43.0,-49.0,-51.0,-48.0,-43.0,-47.0,-89.0,-90.0,-87.0,-88.0,38.0,42.0,44.0,39.0,1
1326,CC:2F:71:3F:1F:24,4522460,1216093983,690190,732759345,3832270,483334638,37,555404,571913538,554707,571829624,697,83914,536838,15,690438,77195,34,473,144444.0,39000.0,-72.0,-67.0,-72.0,-71.0,-72.0,-67.0,-72.0,-70.0,-89.0,-90.0,-87.0,-88.0,17.0,23.0,15.0,17.0,1
1327,CC:2F:71:3E:C5:1F,3833112,483437477,840,102637,3832272,483334840,0,3512,294821,2897,221807,615,73014,888,8,1208,18,0,37,144444.0,39000.0,-71.0,-70.0,-66.0,-60.0,-70.0,-69.0,-66.0,-60.0,-89.0,-90.0,-87.0,-88.0,18.0,20.0,21.0,28.0,1
1328,BA:8C:B9:54:50:24,3837093,489520099,4808,6179633,3832285,483340466,0,8774,1684265,8752,1680770,22,3495,2345,14,5229,38,0,56,216660.0,130000.0,-40.0,-37.0,-46.0,-51.0,-40.0,-37.0,-46.0,-51.0,-89.0,-90.0,-87.0,-88.0,49.0,53.0,41.0,37.0,1
1329,92:69:1D:31:68:E9,3836146,486946626,3857,3605756,3832289,483340870,0,4578,1077765,4443,1047275,135,30490,2077,10,4038,84,0,41,229410.0,130000.0,-51.0,-48.0,-43.0,-49.0,-51.0,-48.0,-43.0,-47.0,-89.0,-90.0,-87.0,-88.0,38.0,42.0,44.0,39.0,1
1330,CC:2F:71:3F:1F:24,4522519,1216114351,690230,732773481,3832289,483340870,37,555429,571918020,554732,571834106,697,83914,536860,15,690478,77241,34,473,144444.0,43333.0,-72.0,-66.0,-71.0,-71.0,-72.0,-66.0,-71.0,-71.0,-89.0,-90.0,-87.0,-88.0,17.0,24.0,16.0,17.0,1
1331,CC:2F:71:3E:C5:1F,3833129,483443507,840,102637,3832289,483340870,0,3512,294821,2897,221807,615,73014,888,8,1208,18,0,37,144444.0,39000.0,-71.0,-70.0,-66.0,-60.0,-70.0,-69.0,-66.0,-60.0,-89.0,-90.0,-87.0,-88.0,18.0,20.0,21.0,28.0,1
1332,BA:8C:B9:54:50:24,3837097,489520503,4808,6179633,3832289,483340870,0,8774,1684265,8752,1680770,22,3495,2345,14,5229,38,0,56,216660.0,130000.0,-40.0,-37.0,-46.0,-51.0,-40.0,-37.0,-46.0,-51.0,-89.0,-90.0,-87.0,-88.0,49.0,53.0,41.0,37.0,1
1333,92:69:1D:31:68:E9,3836148,486946959,3857,3605756,3832291,483341203,0,4578,1077765,4443,1047275,135,30490,2077,10,4038,84,0,41,229410.0,130000.0,-51.0,-48.0,-43.0,-49.0,-51.0,-48.0,-43.0,-47.0,-89.0,-90.0,-87.0,-88.0,38.0,42.0,44.0,39.0,1
1334,CC:2F:71:3F:1F:24,4522569,1216132551,690278,732791348,3832291,483341203,37,555460,571923417,554763,571839503,697,83914,536890,15,690526,77258,34,473,130000.0,39000.0,-72.0,-66.0,-71.0,-71.0,-72.0,-66.0,-71.0,-71.0,-89.0,-90.0,-87.0,-88.0,17.0,24.0,16.0,17.0,1
1335,CC:2F:71:3E:C5:1F,3833131,483443840,840,102637,3832291,483341203,0,3512,294821,2897,221807,615,73014,888,8,1208,18,0,37,144444.0,39000.0,-71.0,-70.0,-66.0,-60.0,-70.0,-69.0,-66.0,-60.0,-89.0,-90.0,-87.0,-88.0,18.0,20.0,21.0,28.0,1
1336,BA:8C:B9:54:50:24,3837103,489521240,4808,6179633,3832295,483341607,0,8774,1684265,8752,1680770,22,3495,2345,14,5229,38,0,56,216660.0,130000.0,-40.0,-37.0,-46.0,-51.0,-40.0,-37.0,-46.0,-51.0,-89.0,-90.0,-87.0,-88.0,49.0,53.0,41.0,37.0,1
1337,92:69:1D:31:68:E9,3836156,486947767,3857,3605756,3832299,483342011,0,4578,1077765,4443,1047275,135,30490,2077,10,4038,84,0,41,229410.0,130000.0,-51.0,-48.0,-43.0,-49.0,-51.0,-48.0,-43.0,-47.0,-89.0,-90.0,-87.0,-88.0,38.0,42.0,44.0,39.0,1
1338,CC:2F:71:3F:1F:24,4522617,1216147551,690318,732805540,3832299,483342011,37,555482,571927267,554785,571843353,697,83914,536911,15,690566,77264,34,473,117000.0,39000.0,-73.0,-66.0,-71.0,-71.0,-72.0,-66.0,-71.0,-70.0,-89.0,-90.0,-87.0,-88.0,16.0,24.0,16.0,17.0,1
1339,CC:2F:71:3E:C5:1F,3833139,483444648,840,102637,3832299,483342011,0,3512,294821,2897,221807,615,73014,888,8,1208,18,0,37,144444.0,39000.0,-71.0,-70.0,-66.0,-60.0,-70.0,-69.0,-66.0,-60.0,-89.0,-90.0,-87.0,-88.0,18.0,20.0,21.0,28.0,1
1340,BA:8C:B9:54:50:24,3837107,489521644,4808,6179633,3832299,483342011,0,8774,1684265,8752,1680770,22,3495,2345,14,5229,38,0,56,216660.0,130000.0,-40.0,-37.0,-46.0,-51.0,-40.0,-37.0,-46.0,-51.0,-89.0,-90.0,-87.0,-88.0,49.0,53.0,41.0,37.0,1
1341,92:69:1D:31:68:E9,3836156,486947767,3857,3605756,3832299,483342011,0,4578,1077765,4443,1047275,135,30490,2077,10,4038,84,0,41,229410.0,130000.0,-51.0,-48.0,-43.0,-49.0,-51.0,-48.0,-43.0,-47.0,-89.0,-90.0,-87.0,-88.0,38.0,42.0,44.0,39.0,1
1342,CC:2F:71:3F:1F:24,4522657,1216161687,690358,732819676,3832299,483342011,37,555505,571931343,554808,571847429,697,83914,536932,15,690606,77264,34,473,130000.0,39000.0,-71.0,-66.0,-70.0,-70.0,-69.0,-65.0,-70.0,-71.0,-89.0,-90.0,-87.0,-88.0,18.0,24.0,17.0,18.0,1
1343,CC:2F:71:3E:C5:1F,3833140,483444782,840,102637,3832300,483342145,0,3512,294821,2897,221807,615,73014,888,8,1208,18,0,37,144444.0,39000.0,-71.0,-70.0,-66.0,-60.0,-70.0,-69.0,-66.0,-60.0,-89.0,-90.0,-87.0,-88.0,18.0,20.0,21.0,28.0,1
1344,BA:8C:B9:54:50:24,3837108,489521778,4808,6179633,3832300,483342145,0,8774,1684265,8752,1680770,22,3495,2345,14,5229,38,0,56,216660.0,130000.0,-40.0,-37.0,-46.0,-51.0,-40.0,-37.0,-46.0,-51.0,-89.0,-90.0,-87.0,-88.0,49.0,53.0,41.0,37.0,1
1345,92:69:1D:31:68:E9,3836167,486949003,3857,3605756,3832310,483343247,0,4578,1077765,4443,1047275,135,30490,2077,10,4038,84,0,41,229410.0,130000.0,-51.0,-48.0,-43.0,-49.0,-51.0,-48.0,-43.0,-47.0,-89.0,-90.0,-87.0,-88.0,38.0,42.0,44.0,39.0,1
1346,CC:2F:71:3F:1F:24,4522764,1216199485,690454,732856238,3832310,483343247,37,555580,571946538,554883,571862624,697,83914,537006,15,690702,77305,34,473,115556.0,28889.0,-71.0,-67.0,-70.0,-74.0,-70.0,-66.0,-69.0,-73.0,-89.0,-90.0,-87.0,-88.0,18.0,23.0,17.0,14.0,1
1347,CC:2F:71:3E:C5:1F,3833150,483445884,840,102637,3832310,483343247,0,3512,294821,2897,221807,615,73014,888,8,1208,18,0,37,144444.0,39000.0,-71.0,-70.0,-66.0,-60.0,-70.0,-69.0,-66.0,-60.0,-89.0,-90.0,-87.0,-88.0,18.0,20.0,21.0,28.0,1
1348,BA:8C:B9:54:50:24,3837118,489522880,4808,6179633,3832310,483343247,0,8774,1684265,8752,1680770,22,3495,2345,14,5229,38,0,56,216660.0,130000.0,-40.0,-37.0,-46.0,-51.0,-40.0,-37.0,-46.0,-51.0,-89.0,-90.0,-87.0,-88.0,49.0,53.0,41.0,37.0,1
1349,92:69:1D:31:68:E9,3836167,486949003,3857,3605756,3832310,483343247,0,4578,1077765,4443,1047275,135,30490,2077,10,4038,84,0,41,229410.0,130000.0,-51.0,-48.0,-43.0,-49.0,-51.0,-48.0,-43.0,-47.0,-89.0,-90.0,-87.0,-88.0,38.0,42.0,44.0,39.0,1
1350,CC:2F:71:3F:1F:24,4522809,1216217004,690499,732873757,3832310,483343247,37,555609,571951691,554912,571867777,697,83914,537034,15,690747,77305,34,473,115556.0,28889.0,-71.0,-67.0,-70.0,-72.0,-71.0,-66.0,-70.0,-72.0,-89.0,-90.0,-87.0,-88.0,18.0,23.0,17.0,16.0,1
1351,CC:2F:71:3E:C5:1F,3833150,483445884,840,102637,3832310,483343247,0,3512,294821,2897,221807,615,73014,888,8,1208,18,0,37,144444.0,39000.0,-71.0,-70.0,-66.0,-60.0,-70.0,-69.0,-66.0,-60.0,-89.0,-90.0,-87.0,-88.0,18.0,20.0,21.0,28.0,1
1352,BA:8C:B9:54:50:24,3837118,489522880,4808,6179633,3832310,483343247,0,8774,1684265,8752,1680770,22,3495,2345,14,5229,38,0,56,216660.0,130000.0,-40.0,-37.0,-46.0,-51.0,-40.0,-37.0,-46.0,-51.0,-89.0,-90.0,-87.0,-88.0,49.0,53.0,41.0,37.0,1
1353,92:69:1D:31:68:E9,3836176,486949871,3857,3605756,3832319,483344115,0,4578,1077765,4443,1047275,135,30490,2077,10,4038,84,0,41,229410.0,130000.0,-51.0,-48.0,-43.0,-49.0,-51.0,-48.0,-43.0,-47.0,-89.0,-90.0,-87.0,-88.0,38.0,42.0,44.0,39.0,1
1354,CC:2F:71:3F:1F:24,4522858,1216232120,690539,732888005,3832319,483344115,37,555632,571955767,554935,571871853,697,83914,537055,15,690787,77305,34,473,117000.0,39000.0,-70.0,-66.0,-71.0,-72.0,-70.0,-66.0,-70.0,-72.0,-89.0,-90.0,-87.0,-88.0,19.0,24.0,16.0,16.0,1
1355,CC:2F:71:3E:C5:1F,3833159,483446752,840,102637,3832319,483344115,0,3512,294821,2897,221807,615,73014,888,8,1208,18,0,37,144444.0,39000.0,-71.0,-70.0,-66.0,-60.0,-70.0,-69.0,-66.0,-60.0,-89.0,-90.0,-87.0,-88.0,18.0,20.0,21.0,28.0,1
1356,BA:8C:B9:54:50:24,3837127,489523748,4808,6179633,3832319,483344115,0,8774,1684265,8752,1680770,22,3495,2345,14,5229,38,0,56,216660.0,130000.0,-40.0,-37.0,-46.0,-51.0,-40.0,-37.0,-46.0,-51.0,-89.0,-90.0,-87.0,-88.0,49.0,53.0,41.0,37.0,1
1357,92:69:1D:31:68:E9,3836176,486949871,3857,3605756,3832319,483344115,0,4578,1077765,4443,1047275,135,30490,2077,10,4038,84,0,41,229410.0,130000.0,-51.0,-48.0,-43.0,-49.0,-51.0,-48.0,-43.0,-47.0,-89.0,-90.0,-87.0,-88.0,38.0,42.0,44.0,39.0,1
1358,CC:2F:71:3F:1F:24,4522898,1216246256,690579,732902141,3832319,483344115,37,555654,571959617,554957,571875703,697,83914,537076,15,690827,77307,34,473,130000.0,39000.0,-70.0,-67.0,-70.0,-72.0,-70.0,-66.0,-70.0,-72.0,-89.0,-90.0,-87.0,-88.0,19.0,23.0,17.0,16.0,1
1359,CC:2F:71:3E:C5:1F,3833159,483446752,840,102637,3832319,483344115,0,3512,294821,2897,221807,615,73014,888,8,1208,18,0,37,144444.0,39000.0,-71.0,-70.0,-66.0,-60.0,-70.0,-69.0,-66.0,-60.0,-89.0,-90.0,-87.0,-88.0,18.0,20.0,21.0,28.0,1
1360,BA:8C:B9:54:50:24,3837127,489523748,4808,6179633,3832319,483344115,0,8774,1684265,8752,1680770,22,3495,2345,14,5229,38,0,56,216660.0,130000.0,-40.0,-37.0,-46.0,-51.0,-40.0,-37.0,-46.0,-51.0,-89.0,-90.0,-87.0,-88.0,49.0,53.0,41.0,37.0,1
1361,92:69:1D:31:68:E9,3836184,486950679,3857,3605756,3832327,483344923,0,4578,1077765,4443,1047275,135,30490,2077,10,4038,84,0,41,229410.0,130000.0,-51.0,-48.0,-43.0,-49.0,-51.0,-48.0,-43.0,-47.0,-89.0,-90.0,-87.0,-88.0,38.0,42.0,44.0,39.0,1
1362,CC:2F:71:3F:1F:24,4522946,1216261256,690619,732916333,3832327,483344923,37,555677,571963583,554980,571879669,697,83914,537098,15,690867,77321,34,473,130000.0,39000.0,-71.0,-66.0,-70.0,-73.0,-71.0,-66.0,-69.0,-72.0,-89.0,-90.0,-87.0,-88.0,18.0,24.0,17.0,15.0,1
1363,CC:2F:71:3E:C5:1F,3833167,483447560,840,102637,3832327,483344923,0,3512,294821,2897,221807,615,73014,888,8,1208,18,0,37,144444.0,39000.0,-71.0,-70.0,-66.0,-60.0,-70.0,-69.0,-66.0,-60.0,-89.0,-90.0,-87.0,-88.0,18.0,20.0,21.0,28.0,1
1364,BA:8C:B9:54:50:24,3837135,489524556,4808,6179633,3832327,483344923,0,8774,1684265,8752,1680770,22,3495,2345,14,5229,38,0,56,216660.0,130000.0,-40.0,-37.0,-46.0,-51.0,-40.0,-37.0,-46.0,-51.0,-89.0,-90.0,-87.0,-88.0,49.0,53.0,41.0,37.0,1
1365,92:69:1D:31:68:E9,3836185,486950739,3857,3605756,3832328,483344983,0,4578,1077765,4443,1047275,135,30490,2077,10,4038,84,0,41,229410.0,130000.0,-51.0,-48.0,-43.0,-49.0,-51.0,-48.0,-43.0,-47.0,-89.0,-90.0,-87.0,-88.0,38.0,42.0,44.0,39.0,1
1366,CC:2F:71:3F:1F:24,4522993,1216278795,690665,732933812,3832328,483344983,37,555713,571969847,555016,571885933,697,83914,537130,15,690913,77343,34,473,117000.0,39000.0,-70.0,-67.0,-70.0,-72.0,-70.0,-66.0,-70.0,-72.0,-89.0,-90.0,-87.0,-88.0,19.0,23.0,17.0,16.0,1
1367,CC:2F:71:3E:C5:1F,3833168,483447620,840,102637,3832328,483344983,0,3512,294821,2897,221807,615,73014,888,8,1208,18,0,37,144444.0,39000.0,-71.0,-70.0,-66.0,-60.0,-70.0,-69.0,-66.0,-60.0,-89.0,-90.0,-87.0,-88.0,18.0,20.0,21.0,28.0,1
1368,BA:8C:B9:54:50:24,3837136,489524616,4808,6179633,3832328,483344983,0,8774,1684265,8752,1680770,22,3495,2345,14,5229,38,0,56,216660.0,130000.0,-40.0,-37.0,-46.0,-51.0,-40.0,-37.0,-46.0,-51.0,-89.0,-90.0,-87.0,-88.0,49.0,53.0,41.0,37.0,1
1369,92:69:1D:31:68:E9,3836193,486951547,3857,3605756,3832336,483345791,0,4578,1077765,4443,1047275,135,30490,2077,10,4038,84,0,41,229410.0,130000.0,-51.0,-48.0,-43.0,-49.0,-51.0,-48.0,-43.0,-47.0,-89.0,-90.0,-87.0,-88.0,38.0,42.0,44.0,39.0,1
1370,CC:2F:71:3F:1F:24,4523040,1216293665,690704,732947874,3832336,483345791,37,555737,571973929,555040,571890015,697,83914,537153,15,690952,77348,34,473,130000.0,43333.0,-71.0,-67.0,-70.0,-72.0,-70.0,-66.0,-69.0,-72.0,-89.0,-90.0,-87.0,-88.0,18.0,23.0,17.0,16.0,1
1371,CC:2F:71:3E:C5:1F,3833176,483448428,840,102637,3832336,483345791,0,3512,294821,2897,221807,615,73014,888,8,1208,18,0,37,144444.0,39000.0,-71.0,-70.0,-66.0,-60.0,-70.0,-69.0,-66.0,-60.0,-89.0,-90.0,-87.0,-88.0,18.0,20.0,21.0,28.0,1
1372,BA:8C:B9:54:50:24,3837144,489525424,4808,6179633,3832336,483345791,0,8774,1684265,8752,1680770,22,3495,2345,14,5229,38,0,56,216660.0,130000.0,-40.0,-37.0,-46.0,-51.0,-40.0,-37.0,-46.0,-51.0,-89.0,-90.0,-87.0,-88.0,49.0,53.0,41.0,37.0,1
1373,92:69:1D:31:68:E9,3836193,486951547,3857,3605756,3832336,483345791,0,4578,1077765,4443,1047275,135,30490,2077,10,4038,84,0,41,229410.0,130000.0,-51.0,-48.0,-43.0,-49.0,-51.0,-48.0,-43.0,-47.0,-89.0,-90.0,-87.0,-88.0,38.0,42.0,44.0,39.0,1
1374,CC:2F:71:3F:1F:24,4523080,1216307913,690744,732962122,3832336,483345791,37,555759,571977779,555062,571893865,697,83914,537174,15,690992,77369,34,473,130000.0,39000.0,-70.0,-66.0,-70.0,-73.0,-70.0,-66.0,-70.0,-72.0,-89.0,-90.0,-87.0,-88.0,19.0,24.0,17.0,15.0,1
1375,CC:2F:71:3E:C5:1F,3833176,483448428,840,102637,3832336,483345791,0,3512,294821,2897,221807,615,73014,888,8,1208,18,0,37,144444.0,39000.0,-71.0,-70.0,-66.0,-60.0,-70.0,-69.0,-66.0,-60.0,-89.0,-90.0,-87.0,-88.0,18.0,20.0,21.0,28.0,1
1376,BA:8C:B9:54:50:24,3837144,489525424,4808,6179633,3832336,483345791,0,8774,1684265,8752,1680770,22,3495,2345,14,5229,38,0,56,216660.0,130000.0,-40.0,-37.0,-46.0,-51.0,-40.0,-37.0,-46.0,-51.0,-89.0,-90.0,-87.0,-88.0,49.0,53.0,41.0,37.0,1
1377,92:69:1D:31:68:E9,3836202,486952415,3857,3605756,3832345,483346659,0,4578,1077765,4443,1047275,135,30490,2077,10,4038,84,0,41,229410.0,130000.0,-51.0,-48.0,-43.0,-49.0,-51.0,-48.0,-43.0,-47.0,-89.0,-90.0,-87.0,-88.0,38.0,42.0,44.0,39.0,1
1378,CC:2F:71:3F:1F:24,4523128,1216322843,690783,732976184,3832345,483346659,37,555781,571981629,555084,571897715,697,83914,537195,15,691031,77400,34,473,144444.0,43333.0,-71.0,-67.0,-70.0,-72.0,-70.0,-67.0,-70.0,-72.0,-89.0,-90.0,-87.0,-88.0,18.0,23.0,17.0,16.0,1
1379,CC:2F:71:3E:C5:1F,3833185,483449296,840,102637,3832345,483346659,0,3512,294821,2897,221807,615,73014,888,8,1208,18,0,37,144444.0,39000.0,-71.0,-70.0,-66.0,-60.0,-70.0,-69.0,-66.0,-60.0,-89.0,-90.0,-87.0,-88.0,18.0,20.0,21.0,28.0,1
1380,BA:8C:B9:54:50:24,3837153,489526292,4808,6179633,3832345,483346659,0,8774,1684265,8752,1680770,22,3495,2345,14,5229,38,0,56,216660.0,130000.0,-40.0,-37.0,-46.0,-51.0,-40.0,-37.0,-46.0,-51.0,-89.0,-90.0,-87.0,-88.0,49.0,53.0,41.0,37.0,1
1381,92:69:1D:31:68:E9,3836203,486952531,3858,3605872,3832345,483346659,0,4580,1077901,4445,1047411,135,30490,2077,10,4039,84,0,41,229410.0,130000.0,-53.0,-47.0,-42.0,-48.0,-52.0,-48.0,-43.0,-47.0,-89.0,-90.0,-87.0,-88.0,36.0,43.0,45.0,40.0,1
1382,CC:2F:71:3F:1F:24,4523170,1216337269,690824,732990548,3832346,483346721,37,555806,571985843,555108,571901811,698,84032,537218,15,691072,77416,34,473,130000.0,43333.0,-72.0,-66.0,-70.0,-72.0,-72.0,-66.0,-70.0,-72.0,-89.0,-90.0,-87.0,-88.0,17.0,24.0,17.0,16.0,1
1383,CC:2F:71:3E:C5:1F,3833187,483449474,841,102753,3832346,483346721,0,3514,294961,2899,221947,615,73014,888,8,1209,18,0,37,144444.0,39000.0,-71.0,-69.0,-67.0,-60.0,-71.0,-69.0,-66.0,-60.0,-89.0,-90.0,-87.0,-88.0,18.0,21.0,20.0,28.0,1
1384,BA:8C:B9:54:50:24,3837155,489526470,4809,6179749,3832346,483346721,0,8778,1684537,8756,1681042,22,3495,2345,14,5230,38,0,56,216660.0,130000.0,-49.0,-35.0,-42.0,-45.0,-41.0,-36.0,-44.0,-49.0,-89.0,-90.0,-87.0,-88.0,40.0,55.0,45.0,43.0,1
1385,92:69:1D:31:68:E9,3836212,486953401,3858,3605872,3832354,483347529,0,4580,1077901,4445,1047411,135,30490,2077,10,4039,84,0,41,229410.0,130000.0,-53.0,-47.0,-42.0,-48.0,-52.0,-48.0,-43.0,-47.0,-89.0,-90.0,-87.0,-88.0,36.0,43.0,45.0,40.0,1
1386,CC:2F:71:3F:1F:24,4523236,1216359060,690880,733011198,3832356,483347862,37,555844,571992736,555146,571908704,698,84032,537255,15,691128,77418,34,473,130000.0,39000.0,-69.0,-66.0,-70.0,-71.0,-70.0,-66.0,-69.0,-71.0,-89.0,-90.0,-87.0,-88.0,20.0,24.0,17.0,17.0,1
1387,CC:2F:71:3E:C5:1F,3833197,483450615,841,102753,3832356,483347862,0,3514,294961,2899,221947,615,73014,888,8,1209,18,0,37,144444.0,39000.0,-71.0,-69.0,-67.0,-60.0,-71.0,-69.0,-66.0,-60.0,-89.0,-90.0,-87.0,-88.0,18.0,21.0,20.0,28.0,1
1388,BA:8C:B9:54:50:24,3837165,489527611,4809,6179749,3832356,483347862,0,8778,1684537,8756,1681042,22,3495,2345,14,5230,38,0,56,216660.0,130000.0,-49.0,-35.0,-42.0,-45.0,-41.0,-36.0,-44.0,-49.0,-89.0,-90.0,-87.0,-88.0,40.0,55.0,45.0,43.0,1
1389,92:69:1D:31:68:E9,3836214,486953734,3858,3605872,3832356,483347862,0,4580,1077901,4445,1047411,135,30490,2077,10,4039,84,0,41,229410.0,130000.0,-53.0,-47.0,-42.0,-48.0,-52.0,-48.0,-43.0,-47.0,-89.0,-90.0,-87.0,-88.0,36.0,43.0,45.0,40.0,1
1390,CC:2F:71:3F:1F:24,4523276,1216373252,690920,733025390,3832356,483347862,37,555868,571996880,555170,571912848,698,84032,537277,15,691168,77418,34,473,144444.0,43333.0,-73.0,-67.0,-70.0,-71.0,-72.0,-67.0,-69.0,-71.0,-89.0,-90.0,-87.0,-88.0,16.0,23.0,17.0,17.0,1
1391,CC:2F:71:3E:C5:1F,3833197,483450615,841,102753,3832356,483347862,0,3514,294961,2899,221947,615,73014,888,8,1209,18,0,37,144444.0,39000.0,-71.0,-69.0,-67.0,-60.0,-71.0,-69.0,-66.0,-60.0,-89.0,-90.0,-87.0,-88.0,18.0,21.0,20.0,28.0,1
1392,BA:8C:B9:54:50:24,3837165,489527611,4809,6179749,3832356,483347862,0,8779,1684605,8757,1681110,22,3495,2345,14,5230,38,0,56,216660.0,130000.0,-40.0,-37.0,-46.0,-51.0,-41.0,-36.0,-44.0,-49.0,-89.0,-90.0,-87.0,-88.0,49.0,53.0,41.0,37.0,1
1393,92:69:1D:31:68:E9,3836222,486954542,3858,3605872,3832364,483348670,0,4580,1077901,4445,1047411,135,30490,2077,10,4039,84,0,41,229410.0,130000.0,-53.0,-47.0,-42.0,-48.0,-52.0,-48.0,-43.0,-47.0,-89.0,-90.0,-87.0,-88.0,36.0,43.0,45.0,40.0,1
1394,CC:2F:71:3F:1F:24,4523322,1216388104,690958,733039434,3832364,483348670,37,555892,572001104,555194,571917072,698,84032,537299,15,691206,77419,34,473,144444.0,43333.0,-74.0,-67.0,-69.0,-70.0,-73.0,-66.0,-69.0,-70.0,-89.0,-90.0,-87.0,-88.0,15.0,23.0,18.0,18.0,1
1395,CC:2F:71:3E:C5:1F,3833205,483451423,841,102753,3832364,483348670,0,3514,294961,2899,221947,615,73014,888,8,1209,18,0,37,144444.0,39000.0,-71.0,-69.0,-67.0,-60.0,-71.0,-69.0,-66.0,-60.0,-89.0,-90.0,-87.0,-88.0,18.0,21.0,20.0,28.0,1
1396,BA:8C:B9:54:50:24,3837173,489528419,4809,6179749,3832364,483348670,0,8779,1684605,8757,1681110,22,3495,2345,14,5230,38,0,56,216660.0,130000.0,-40.0,-37.0,-46.0,-51.0,-41.0,-36.0,-44.0,-49.0,-89.0,-90.0,-87.0,-88.0,49.0,53.0,41.0,37.0,1
1397,92:69:1D:31:68:E9,3836223,486954602,3858,3605872,3832365,483348730,0,4580,1077901,4445,1047411,135,30490,2077,10,4039,84,0,41,229410.0,130000.0,-53.0,-47.0,-42.0,-48.0,-52.0,-48.0,-43.0,-47.0,-89.0,-90.0,-87.0,-88.0,36.0,43.0,45.0,40.0,1
1398,CC:2F:71:3F:1F:24,4523363,1216402476,690998,733053746,3832365,483348730,37,555918,572005923,555220,571921891,698,84032,537323,15,691246,77439,34,473,144444.0,43333.0,-71.0,-66.0,-69.0,-70.0,-71.0,-66.0,-68.0,-69.0,-89.0,-90.0,-87.0,-88.0,18.0,24.0,18.0,18.0,1
1399,CC:2F:71:3E:C5:1F,3833206,483451483,841,102753,3832365,483348730,0,3514,294961,2899,221947,615,73014,888,8,1209,18,0,37,144444.0,39000.0,-71.0,-69.0,-67.0,-60.0,-71.0,-69.0,-66.0,-60.0,-89.0,-90.0,-87.0,-88.0,18.0,21.0,20.0,28.0,1
1400,BA:8C:B9:54:50:24,3837174,489528479,4809,6179749,3832365,483348730,0,8779,1684605,8757,1681110,22,3495,2345,14,5230,38,0,56,216660.0,130000.0,-40.0,-37.0,-46.0,-51.0,-41.0,-36.0,-44.0,-49.0,-89.0,-90.0,-87.0,-88.0,49.0,53.0,41.0,37.0,1
1401,92:69:1D:31:68:E9,3836231,486955410,3858,3605872,3832373,483349538,0,4580,1077901,4445,1047411,135,30490,2077,10,4039,84,0,41,229410.0,130000.0,-53.0,-47.0,-42.0,-48.0,-52.0,-48.0,-43.0,-47.0,-89.0,-90.0,-87.0,-88.0,36.0,43.0,45.0,40.0,1
1402,CC:2F:71:3F:1F:24,4523416,1216420681,691043,733071143,3832373,483349538,37,555947,572010837,555249,571926805,698,84032,537349,15,691291,77465,34,473,144444.0,43333.0,-73.0,-65.0,-71.0,-78.0,-72.0,-65.0,-71.0,-77.0,-89.0,-90.0,-87.0,-88.0,16.0,25.0,16.0,10.0,1
1403,CC:2F:71:3E:C5:1F,3833214,483452291,841,102753,3832373,483349538,0,3514,294961,2899,221947,615,73014,888,8,1209,18,0,37,144444.0,39000.0,-71.0,-69.0,-67.0,-60.0,-71.0,-69.0,-66.0,-60.0,-89.0,-90.0,-87.0,-88.0,18.0,21.0,20.0,28.0,1
1404,BA:8C:B9:54:50:24,3837182,489529287,4809,6179749,3832373,483349538,0,8779,1684605,8757,1681110,22,3495,2345,14,5230,38,0,56,216660.0,130000.0,-40.0,-37.0,-46.0,-51.0,-41.0,-36.0,-44.0,-49.0,-89.0,-90.0,-87.0,-88.0,49.0,53.0,41.0,37.0,1
1405,92:69:1D:31:68:E9,3836233,486956534,3858,3605872,3832375,483350662,0,4580,1077901,4445,1047411,135,30490,2077,10,4039,84,0,41,229410.0,130000.0,-53.0,-47.0,-42.0,-48.0,-52.0,-48.0,-43.0,-47.0,-89.0,-90.0,-87.0,-88.0,36.0,43.0,45.0,40.0,1
1406,CC:2F:71:3F:1F:24,4523456,1216435849,691081,733085187,3832375,483350662,37,555971,572014933,555273,571930901,698,84032,537371,15,691329,77478,34,473,144444.0,43333.0,-73.0,-67.0,-71.0,-72.0,-73.0,-67.0,-70.0,-72.0,-89.0,-90.0,-87.0,-88.0,16.0,23.0,16.0,16.0,1
1407,CC:2F:71:3E:C5:1F,3833216,483453415,841,102753,3832375,483350662,0,3514,294961,2899,221947,615,73014,888,8,1209,18,0,37,144444.0,39000.0,-71.0,-69.0,-67.0,-60.0,-71.0,-69.0,-66.0,-60.0,-89.0,-90.0,-87.0,-88.0,18.0,21.0,20.0,28.0,1
1408,BA:8C:B9:54:50:24,3837184,489530411,4809,6179749,3832375,483350662,0,8779,1684605,8757,1681110,22,3495,2345,14,5230,38,0,56,216660.0,130000.0,-40.0,-37.0,-46.0,-51.0,-41.0,-36.0,-44.0,-49.0,-89.0,-90.0,-87.0,-88.0,49.0,53.0,41.0,37.0,1
1409,92:69:1D:31:68:E9,3836242,486957402,3858,3605872,3832384,483351530,0,4580,1077901,4445,1047411,135,30490,2077,10,4039,84,0,41,229410.0,130000.0,-53.0,-47.0,-42.0,-48.0,-52.0,-48.0,-43.0,-47.0,-89.0,-90.0,-87.0,-88.0,36.0,43.0,45.0,40.0,1
1410,CC:2F:71:3F:1F:24,4523503,1216450761,691119,733099231,3832384,483351530,37,555994,572018853,555296,571934821,698,84032,537392,15,691367,77502,34,473,144444.0,43333.0,-71.0,-68.0,-72.0,-72.0,-72.0,-67.0,-71.0,-73.0,-89.0,-90.0,-87.0,-88.0,18.0,22.0,15.0,16.0,1
1411,CC:2F:71:3E:C5:1F,3833225,483454283,841,102753,3832384,483351530,0,3514,294961,2899,221947,615,73014,888,8,1209,18,0,37,144444.0,39000.0,-71.0,-69.0,-67.0,-60.0,-71.0,-69.0,-66.0,-60.0,-89.0,-90.0,-87.0,-88.0,18.0,21.0,20.0,28.0,1
1412,BA:8C:B9:54:50:24,3837193,489531279,4809,6179749,3832384,483351530,0,8779,1684605,8757,1681110,22,3495,2345,14,5230,38,0,56,216660.0,130000.0,-40.0,-37.0,-46.0,-51.0,-41.0,-36.0,-44.0,-49.0,-89.0,-90.0,-87.0,-88.0,49.0,53.0,41.0,37.0,1
1413,92:69:1D:31:68:E9,3836244,486958526,3858,3605872,3832386,483352654,0,4582,1078037,4447,1047547,135,30490,2077,10,4040,84,0,41,229410.0,130000.0,-52.0,-47.0,-44.0,-46.0,-52.0,-48.0,-43.0,-47.0,-89.0,-90.0,-87.0,-88.0,37.0,43.0,43.0,42.0,1
1414,CC:2F:71:3F:1F:24,4523544,1216466059,691158,733113405,3832386,483352654,37,556015,572022587,555317,571938555,698,84032,537412,15,691406,77517,34,473,144444.0,43333.0,-75.0,-67.0,-71.0,-77.0,-73.0,-66.0,-70.0,-77.0,-89.0,-90.0,-87.0,-88.0,14.0,23.0,16.0,11.0,1
1415,CC:2F:71:3E:C5:1F,3833227,483455407,841,102753,3832386,483352654,0,3516,295101,2901,222087,615,73014,888,8,1210,18,0,37,144444.0,39000.0,-71.0,-71.0,-66.0,-60.0,-71.0,-69.0,-66.0,-60.0,-89.0,-90.0,-87.0,-88.0,18.0,19.0,21.0,28.0,1
1416,BA:8C:B9:54:50:24,3837195,489532403,4809,6179749,3832386,483352654,0,8781,1684741,8759,1681246,22,3495,2345,15,5231,39,0,56,216660.0,130000.0,-49.0,-35.0,-43.0,-45.0,-42.0,-35.0,-44.0,-48.0,-89.0,-90.0,-87.0,-88.0,40.0,55.0,44.0,43.0,1
1417,92:69:1D:31:68:E9,3836252,486959334,3858,3605872,3832394,483353462,0,4582,1078037,4447,1047547,135,30490,2077,10,4040,84,0,41,229410.0,130000.0,-52.0,-47.0,-44.0,-46.0,-52.0,-48.0,-43.0,-47.0,-89.0,-90.0,-87.0,-88.0,37.0,43.0,43.0,42.0,1
1418,CC:2F:71:3F:1F:24,4523600,1216484648,691205,733131126,3832395,483353522,37,556045,572027855,555347,571943823,698,84032,537441,15,691453,77550,34,473,130000.0,43333.0,-73.0,-68.0,-70.0,-75.0,-73.0,-68.0,-70.0,-75.0,-89.0,-90.0,-87.0,-88.0,16.0,22.0,17.0,13.0,1
1419,CC:2F:71:3E:C5:1F,3833236,483456275,841,102753,3832395,483353522,0,3516,295101,2901,222087,615,73014,888,8,1210,18,0,37,144444.0,39000.0,-71.0,-71.0,-66.0,-60.0,-71.0,-69.0,-66.0,-60.0,-89.0,-90.0,-87.0,-88.0,18.0,19.0,21.0,28.0,1
1420,BA:8C:B9:54:50:24,3837204,489533271,4809,6179749,3832395,483353522,0,8781,1684741,8759,1681246,22,3495,2345,15,5231,39,0,56,216660.0,130000.0,-49.0,-35.0,-43.0,-45.0,-42.0,-35.0,-44.0,-48.0,-89.0,-90.0,-87.0,-88.0,40.0,55.0,44.0,43.0,1
1421,92:69:1D:31:68:E9,3836255,486960518,3858,3605872,3832397,483354646,0,4582,1078037,4447,1047547,135,30490,2077,10,4040,84,0,41,229410.0,130000.0,-52.0,-47.0,-44.0,-46.0,-52.0,-48.0,-43.0,-47.0,-89.0,-90.0,-87.0,-88.0,37.0,43.0,43.0,42.0,1
1422,CC:2F:71:3F:1F:24,4523642,1216500020,691245,733145374,3832397,483354646,37,556069,572031999,555371,571947967,698,84032,537463,15,691493,77551,34,473,130000.0,39000.0,-73.0,-69.0,-71.0,-74.0,-73.0,-68.0,-70.0,-73.0,-89.0,-90.0,-87.0,-88.0,16.0,21.0,16.0,14.0,1
1423,CC:2F:71:3E:C5:1F,3833238,483457399,841,102753,3832397,483354646,0,3516,295101,2901,222087,615,73014,888,8,1210,18,0,37,144444.0,39000.0,-71.0,-71.0,-66.0,-60.0,-71.0,-69.0,-66.0,-60.0,-89.0,-90.0,-87.0,-88.0,18.0,19.0,21.0,28.0,1
1424,BA:8C:B9:54:50:24,3837206,489534395,4809,6179749,3832397,483354646,0,8781,1684741,8759,1681246,22,3495,2345,15,5231,39,0,56,216660.0,130000.0,-49.0,-35.0,-43.0,-45.0,-42.0,-35.0,-44.0,-48.0,-89.0,-90.0,-87.0,-88.0,40.0,55.0,44.0,43.0,1
1425,92:69:1D:31:68:E9,3836264,486961388,3858,3605872,3832406,483355516,0,4582,1078037,4447,1047547,135,30490,2077,10,4040,84,0,41,229410.0,130000.0,-52.0,-47.0,-44.0,-46.0,-52.0,-48.0,-43.0,-47.0,-89.0,-90.0,-87.0,-88.0,37.0,43.0,43.0,42.0,1
1426,CC:2F:71:3F:1F:24,4523690,1216514952,691284,733159436,3832406,483355516,37,556091,572035959,555393,571951927,698,84032,537483,15,691532,77564,34,473,144444.0,43333.0,-74.0,-68.0,-70.0,-76.0,-74.0,-68.0,-70.0,-76.0,-89.0,-90.0,-87.0,-88.0,15.0,22.0,17.0,12.0,1
1427,CC:2F:71:3E:C5:1F,3833247,483458269,841,102753,3832406,483355516,0,3518,295289,2902,222157,616,73132,889,8,1210,18,0,37,144444.0,39000.0,-71.0,-69.0,-66.0,-60.0,-71.0,-69.0,-66.0,-60.0,-89.0,-90.0,-87.0,-88.0,18.0,21.0,21.0,28.0,1
1428,BA:8C:B9:54:50:24,3837215,489535265,4809,6179749,3832406,483355516,0,8781,1684741,8759,1681246,22,3495,2345,15,5231,39,0,56,216660.0,130000.0,-49.0,-35.0,-43.0,-45.0,-42.0,-35.0,-44.0,-48.0,-89.0,-90.0,-87.0,-88.0,40.0,55.0,44.0,43.0,1
1429,92:69:1D:31:68:E9,3836265,486961448,3858,3605872,3832407,483355576,0,4582,1078037,4447,1047547,135,30490,2077,10,4040,84,0,41,229410.0,130000.0,-52.0,-47.0,-44.0,-46.0,-52.0,-48.0,-43.0,-47.0,-89.0,-90.0,-87.0,-88.0,37.0,43.0,43.0,42.0,1
1430,CC:2F:71:3F:1F:24,4523729,1216529056,691322,733173480,3832407,483355576,37,556115,572040041,555417,571956009,698,84032,537506,15,691570,77576,34,473,144444.0,43333.0,-74.0,-68.0,-70.0,-77.0,-74.0,-68.0,-70.0,-76.0,-89.0,-90.0,-87.0,-88.0,15.0,22.0,17.0,11.0,1
1431,CC:2F:71:3E:C5:1F,3833248,483458329,841,102753,3832407,483355576,0,3518,295289,2902,222157,616,73132,889,8,1210,18,0,37,144444.0,39000.0,-71.0,-69.0,-66.0,-60.0,-71.0,-69.0,-66.0,-60.0,-89.0,-90.0,-87.0,-88.0,18.0,21.0,21.0,28.0,1
1432,BA:8C:B9:54:50:24,3837216,489535325,4809,6179749,3832407,483355576,0,8781,1684741,8759,1681246,22,3495,2345,15,5231,39,0,56,216660.0,130000.0,-49.0,-35.0,-43.0,-45.0,-42.0,-35.0,-44.0,-48.0,-89.0,-90.0,-87.0,-88.0,40.0,55.0,44.0,43.0,1
1433,92:69:1D:31:68:E9,3836271,486962054,3858,3605872,3832413,483356182,0,4582,1078037,4447,1047547,135,30490,2077,10,4040,84,0,41,229410.0,130000.0,-52.0,-47.0,-44.0,-46.0,-52.0,-48.0,-43.0,-47.0,-89.0,-90.0,-87.0,-88.0,37.0,43.0,43.0,42.0,1
1434,CC:2F:71:3F:1F:24,4523783,1216547511,691368,733191127,3832415,483356384,37,556144,572045194,555446,571961162,698,84032,537534,15,691616,77600,34,473,144444.0,43333.0,-77.0,-71.0,-72.0,-79.0,-76.0,-70.0,-72.0,-78.0,-89.0,-90.0,-87.0,-88.0,12.0,19.0,15.0,9.0,1
1435,CC:2F:71:3E:C5:1F,3833256,483459137,841,102753,3832415,483356384,0,3518,295289,2902,222157,616,73132,889,8,1210,18,0,37,144444.0,39000.0,-71.0,-69.0,-66.0,-60.0,-71.0,-69.0,-66.0,-60.0,-89.0,-90.0,-87.0,-88.0,18.0,21.0,21.0,28.0,1
1436,BA:8C:B9:54:50:24,3837224,489536133,4809,6179749,3832415,483356384,0,8781,1684741,8759,1681246,22,3495,2345,15,5231,39,0,56,216660.0,130000.0,-49.0,-35.0,-43.0,-45.0,-42.0,-35.0,-44.0,-48.0,-89.0,-90.0,-87.0,-88.0,40.0,55.0,44.0,43.0,1
1437,92:69:1D:31:68:E9,3836273,486962256,3858,3605872,3832415,483356384,0,4582,1078037,4447,1047547,135,30490,2077,10,4040,84,0,41,229410.0,130000.0,-52.0,-47.0,-44.0,-46.0,-52.0,-48.0,-43.0,-47.0,-89.0,-90.0,-87.0,-88.0,37.0,43.0,43.0,42.0,1
1438,CC:2F:71:3F:1F:24,4523821,1216561555,691406,733205171,3832415,483356384,37,556169,572049534,555471,571965502,698,84032,537557,15,691654,77630,34,473,144444.0,43333.0,-76.0,-71.0,-72.0,-78.0,-75.0,-70.0,-71.0,-77.0,-89.0,-90.0,-87.0,-88.0,13.0,19.0,15.0,10.0,1
1439,CC:2F:71:3E:C5:1F,3833256,483459137,841,102753,3832415,483356384,0,3518,295289,2902,222157,616,73132,889,8,1210,18,0,37,144444.0,39000.0,-71.0,-69.0,-66.0,-60.0,-71.0,-69.0,-66.0,-60.0,-89.0,-90.0,-87.0,-88.0,18.0,21.0,21.0,28.0,1
1440,BA:8C:B9:54:50:24,3837224,489536133,4809,6179749,3832415,483356384,0,8781,1684741,8759,1681246,22,3495,2345,15,5231,39,0,56,216660.0,130000.0,-49.0,-35.0,-43.0,-45.0,-42.0,-35.0,-44.0,-48.0,-89.0,-90.0,-87.0,-88.0,40.0,55.0,44.0,43.0,1
1441,92:69:1D:31:68:E9,3836281,486963195,3858,3605872,3832423,483357323,0,4582,1078037,4447,1047547,135,30490,2077,10,4040,84,0,41,229410.0,130000.0,-52.0,-47.0,-44.0,-46.0,-52.0,-48.0,-43.0,-47.0,-89.0,-90.0,-87.0,-88.0,37.0,43.0,43.0,42.0,1
1442,CC:2F:71:3F:1F:24,4523871,1216577128,691446,733219603,3832425,483357525,37,556197,572054092,555499,571970060,698,84032,537584,15,691694,77655,34,473,144444.0,43333.0,-77.0,-71.0,-72.0,-78.0,-76.0,-70.0,-71.0,-78.0,-89.0,-90.0,-87.0,-88.0,12.0,19.0,15.0,10.0,1
1443,CC:2F:71:3E:C5:1F,3833266,483460278,841,102753,3832425,483357525,0,3518,295289,2902,222157,616,73132,889,8,1210,18,0,37,144444.0,39000.0,-71.0,-69.0,-66.0,-60.0,-71.0,-69.0,-66.0,-60.0,-89.0,-90.0,-87.0,-88.0,18.0,21.0,21.0,28.0,1
1444,BA:8C:B9:54:50:24,3837234,489537274,4809,6179749,3832425,483357525,0,8781,1684741,8759,1681246,22,3495,2345,15,5231,39,0,56,216660.0,130000.0,-49.0,-35.0,-43.0,-45.0,-42.0,-35.0,-44.0,-48.0,-89.0,-90.0,-87.0,-88.0,40.0,55.0,44.0,43.0,1
1445,92:69:1D:31:68:E9,3836283,486963397,3858,3605872,3832425,483357525,0,4582,1078037,4447,1047547,135,30490,2077,10,4040,84,0,41,229410.0,130000.0,-52.0,-47.0,-44.0,-46.0,-52.0,-48.0,-43.0,-47.0,-89.0,-90.0,-87.0,-88.0,37.0,43.0,43.0,42.0,1
1446,CC:2F:71:3F:1F:24,4523910,1216591298,691484,733233647,3832426,483357651,37,556221,572058316,555523,571974284,698,84032,537606,15,691732,77689,34,473,144444.0,43333.0,-77.0,-71.0,-72.0,-78.0,-76.0,-70.0,-71.0,-77.0,-89.0,-90.0,-87.0,-88.0,12.0,19.0,15.0,10.0,1
1447,CC:2F:71:3E:C5:1F,3833267,483460404,841,102753,3832426,483357651,0,3518,295289,2902,222157,616,73132,889,8,1210,18,0,37,144444.0,39000.0,-71.0,-69.0,-66.0,-60.0,-71.0,-69.0,-66.0,-60.0,-89.0,-90.0,-87.0,-88.0,18.0,21.0,21.0,28.0,1
1448,BA:8C:B9:54:50:24,3837235,489537400,4809,6179749,3832426,483357651,0,8781,1684741,8759,1681246,22,3495,2345,15,5231,39,0,56,216660.0,130000.0,-49.0,-35.0,-43.0,-45.0,-42.0,-35.0,-44.0,-48.0,-89.0,-90.0,-87.0,-88.0,40.0,55.0,44.0,43.0,1
1449,92:69:1D:31:68:E9,3836290,486964129,3858,3605872,3832432,483358257,0,4582,1078037,4447,1047547,135,30490,2077,10,4040,84,0,41,229410.0,130000.0,-52.0,-47.0,-44.0,-46.0,-52.0,-48.0,-43.0,-47.0,-89.0,-90.0,-87.0,-88.0,37.0,43.0,43.0,42.0,1
1450,CC:2F:71:3F:1F:24,4523965,1216609813,691530,733251294,3832435,483358519,37,556253,572063911,555555,571979879,698,84032,537636,15,691778,77721,34,473,144444.0,43333.0,-74.0,-68.0,-69.0,-75.0,-73.0,-67.0,-69.0,-75.0,-89.0,-90.0,-87.0,-88.0,15.0,22.0,18.0,13.0,1
1451,CC:2F:71:3E:C5:1F,3833276,483461272,841,102753,3832435,483358519,0,3518,295289,2902,222157,616,73132,889,8,1210,18,0,37,144444.0,39000.0,-71.0,-69.0,-66.0,-60.0,-71.0,-69.0,-66.0,-60.0,-89.0,-90.0,-87.0,-88.0,18.0,21.0,21.0,28.0,1
1452,BA:8C:B9:54:50:24,3837244,489538268,4809,6179749,3832435,483358519,0,8781,1684741,8759,1681246,22,3495,2345,15,5231,39,0,56,216660.0,130000.0,-49.0,-35.0,-43.0,-45.0,-42.0,-35.0,-44.0,-48.0,-89.0,-90.0,-87.0,-88.0,40.0,55.0,44.0,43.0,1
1453,92:69:1D:31:68:E9,3836293,486964391,3858,3605872,3832435,483358519,0,4582,1078037,4447,1047547,135,30490,2077,10,4040,84,0,41,229410.0,130000.0,-52.0,-47.0,-44.0,-46.0,-52.0,-48.0,-43.0,-47.0,-89.0,-90.0,-87.0,-88.0,37.0,43.0,43.0,42.0,1
1454,CC:2F:71:3F:1F:24,4524005,1216624117,691570,733265598,3832435,483358519,37,556277,572067993,555579,571983961,698,84032,537659,15,691818,77728,34,473,144444.0,43333.0,-74.0,-68.0,-69.0,-75.0,-74.0,-68.0,-69.0,-75.0,-89.0,-90.0,-87.0,-88.0,15.0,22.0,18.0,13.0,1
1455,CC:2F:71:3E:C5:1F,3833276,483461272,841,102753,3832435,483358519,0,3518,295289,2902,222157,616,73132,889,8,1210,18,0,37,144444.0,39000.0,-71.0,-69.0,-66.0,-60.0,-71.0,-69.0,-66.0,-60.0,-89.0,-90.0,-87.0,-88.0,18.0,21.0,21.0,28.0,1
1456,BA:8C:B9:54:50:24,3837244,489538268,4809,6179749,3832435,483358519,0,8781,1684741,8759,1681246,22,3495,2345,15,5231,39,0,56,216660.0,130000.0,-49.0,-35.0,-43.0,-45.0,-42.0,-35.0,-44.0,-48.0,-89.0,-90.0,-87.0,-88.0,40.0,55.0,44.0,43.0,1
1457,92:69:1D:31:68:E9,3836299,486964997,3858,3605872,3832441,483359125,0,4582,1078037,4447,1047547,135,30490,2077,10,4040,84,0,41,229410.0,130000.0,-52.0,-47.0,-44.0,-46.0,-52.0,-48.0,-43.0,-47.0,-89.0,-90.0,-87.0,-88.0,37.0,43.0,43.0,42.0,1
1458,CC:2F:71:3F:1F:24,4524050,1216638897,691609,733279772,3832441,483359125,37,556300,572071959,555602,571987927,698,84032,537681,15,691857,77750,34,473,144444.0,43333.0,-74.0,-68.0,-69.0,-75.0,-74.0,-68.0,-69.0,-74.0,-89.0,-90.0,-87.0,-88.0,15.0,22.0,18.0,13.0,1
1459,CC:2F:71:3E:C5:1F,3833284,483462080,841,102753,3832443,483359327,0,3518,295289,2902,222157,616,73132,889,8,1210,18,0,37,144444.0,39000.0,-71.0,-69.0,-66.0,-60.0,-71.0,-69.0,-66.0,-60.0,-89.0,-90.0,-87.0,-88.0,18.0,21.0,21.0,28.0,1
1460,BA:8C:B9:54:50:24,3837252,489539076,4809,6179749,3832443,483359327,0,8781,1684741,8759,1681246,22,3495,2345,15,5231,39,0,56,216660.0,130000.0,-49.0,-35.0,-43.0,-45.0,-42.0,-35.0,-44.0,-48.0,-89.0,-90.0,-87.0,-88.0,40.0,55.0,44.0,43.0,1
1461,92:69:1D:31:68:E9,3836302,486965259,3858,3605872,3832444,483359387,0,4582,1078037,4447,1047547,135,30490,2077,10,4040,84,0,41,229410.0,130000.0,-52.0,-47.0,-44.0,-46.0,-52.0,-48.0,-43.0,-47.0,-89.0,-90.0,-87.0,-88.0,37.0,43.0,43.0,42.0,1
1462,CC:2F:71:3F:1F:24,4524091,1216653203,691647,733293816,3832444,483359387,37,556322,572075809,555624,571991777,698,84032,537702,15,691895,77775,34,473,144444.0,43333.0,-77.0,-71.0,-72.0,-78.0,-76.0,-70.0,-71.0,-77.0,-89.0,-90.0,-87.0,-88.0,12.0,19.0,15.0,10.0,1
1463,CC:2F:71:3E:C5:1F,3833285,483462140,841,102753,3832444,483359387,0,3518,295289,2902,222157,616,73132,889,8,1210,18,0,37,144444.0,39000.0,-71.0,-69.0,-66.0,-60.0,-71.0,-69.0,-66.0,-60.0,-89.0,-90.0,-87.0,-88.0,18.0,21.0,21.0,28.0,1
1464,BA:8C:B9:54:50:24,3837253,489539136,4809,6179749,3832444,483359387,0,8781,1684741,8759,1681246,22,3495,2345,15,5231,39,0,56,216660.0,130000.0,-49.0,-35.0,-43.0,-45.0,-42.0,-35.0,-44.0,-48.0,-89.0,-90.0,-87.0,-88.0,40.0,55.0,44.0,43.0,1
1465,92:69:1D:31:68:E9,3836307,486965797,3858,3605872,3832449,483359925,0,4582,1078037,4447,1047547,135,30490,2077,10,4040,84,0,41,229410.0,130000.0,-52.0,-47.0,-44.0,-46.0,-52.0,-48.0,-43.0,-47.0,-89.0,-89.0,-86.0,-87.0,37.0,42.0,42.0,41.0,1
1466,CC:2F:71:3F:1F:24,4524145,1216671778,691695,733311785,3832450,483359993,37,556354,572081499,555656,571997467,698,84032,537732,15,691943,77807,34,473,144444.0,43333.0,-77.0,-71.0,-72.0,-77.0,-76.0,-70.0,-71.0,-77.0,-89.0,-89.0,-86.0,-87.0,12.0,18.0,14.0,10.0,1
1467,CC:2F:71:3E:C5:1F,3833291,483462746,841,102753,3832450,483359993,0,3518,295289,2902,222157,616,73132,889,8,1210,18,0,37,144444.0,39000.0,-71.0,-69.0,-66.0,-60.0,-71.0,-69.0,-66.0,-60.0,-89.0,-89.0,-86.0,-87.0,18.0,20.0,20.0,27.0,1
1468,BA:8C:B9:54:50:24,3837259,489539742,4809,6179749,3832450,483359993,0,8781,1684741,8759,1681246,22,3495,2345,15,5231,39,0,56,216660.0,130000.0,-49.0,-35.0,-43.0,-45.0,-42.0,-35.0,-44.0,-48.0,-89.0,-89.0,-86.0,-87.0,40.0,54.0,43.0,42.0,1
1469,92:69:1D:31:68:E9,3836310,486966067,3858,3605872,3832452,483360195,0,4582,1078037,4447,1047547,135,30490,2077,10,4040,84,0,41,229410.0,130000.0,-52.0,-47.0,-44.0,-46.0,-52.0,-48.0,-43.0,-47.0,-89.0,-89.0,-86.0,-87.0,37.0,42.0,42.0,41.0,1
1470,CC:2F:71:3F:1F:24,4524187,1216686284,691735,733326089,3832452,483360195,37,556380,572085969,555682,572001937,698,84032,537755,15,691983,77831,34,473,144444.0,43333.0,-77.0,-71.0,-73.0,-77.0,-76.0,-70.0,-71.0,-77.0,-89.0,-89.0,-86.0,-87.0,12.0,18.0,13.0,10.0,1
1471,CC:2F:71:3E:C5:1F,3833293,483462948,841,102753,3832452,483360195,0,3518,295289,2902,222157,616,73132,889,8,1210,18,0,37,144444.0,39000.0,-71.0,-69.0,-66.0,-60.0,-71.0,-69.0,-66.0,-60.0,-89.0,-89.0,-86.0,-87.0,18.0,20.0,20.0,27.0,1
1472,BA:8C:B9:54:50:24,3837261,489539944,4809,6179749,3832452,483360195,0,8781,1684741,8759,1681246,22,3495,2345,15,5231,39,0,56,216660.0,130000.0,-49.0,-35.0,-43.0,-45.0,-42.0,-35.0,-44.0,-48.0,-89.0,-89.0,-86.0,-87.0,40.0,54.0,43.0,42.0,1
1473,92:69:1D:31:68:E9,3836315,486966531,3858,3605872,3832457,483360659,0,4583,1078105,4448,1047615,135,30490,2077,10,4040,84,0,41,229410.0,130000.0,-52.0,-47.0,-44.0,-46.0,-52.0,-47.0,-43.0,-47.0,-89.0,-89.0,-86.0,-87.0,37.0,42.0,42.0,41.0,1
1474,CC:2F:71:3F:1F:24,4524232,1216701052,691775,733340393,3832457,483360659,37,556403,572089935,555705,572005903,698,84032,537777,15,692023,77856,34,473,144444.0,43333.0,-77.0,-71.0,-73.0,-77.0,-76.0,-70.0,-72.0,-77.0,-89.0,-89.0,-86.0,-87.0,12.0,18.0,13.0,10.0,1
1475,CC:2F:71:3E:C5:1F,3833300,483463614,841,102753,3832459,483360861,0,3518,295289,2902,222157,616,73132,889,8,1210,18,0,37,144444.0,39000.0,-71.0,-69.0,-66.0,-60.0,-71.0,-69.0,-66.0,-60.0,-89.0,-89.0,-86.0,-87.0,18.0,20.0,20.0,27.0,1
1476,BA:8C:B9:54:50:24,3837268,489540610,4809,6179749,3832459,483360861,0,8781,1684741,8759,1681246,22,3495,2345,15,5231,39,0,56,216660.0,130000.0,-49.0,-35.0,-43.0,-45.0,-42.0,-35.0,-44.0,-48.0,-89.0,-89.0,-86.0,-87.0,40.0,54.0,43.0,42.0,1
1477,92:69:1D:31:68:E9,3836319,486966935,3858,3605872,3832461,483361063,0,4583,1078105,4448,1047615,135,30490,2077,10,4040,84,0,41,229410.0,130000.0,-52.0,-47.0,-44.0,-46.0,-52.0,-47.0,-43.0,-47.0,-89.0,-89.0,-86.0,-87.0,37.0,42.0,42.0,41.0,1
1478,CC:2F:71:3F:1F:24,4524275,1216715630,691814,733354567,3832461,483361063,37,556426,572093901,555728,572009869,698,84032,537799,15,692062,77905,34,473,144444.0,43333.0,-78.0,-70.0,-72.0,-77.0,-76.0,-69.0,-71.0,-76.0,-89.0,-89.0,-86.0,-87.0,11.0,19.0,14.0,10.0,1
1479,CC:2F:71:3E:C5:1F,3833302,483463816,841,102753,3832461,483361063,0,3518,295289,2902,222157,616,73132,889,8,1210,18,0,37,144444.0,39000.0,-71.0,-69.0,-66.0,-60.0,-71.0,-69.0,-66.0,-60.0,-89.0,-89.0,-86.0,-87.0,18.0,20.0,20.0,27.0,1
1480,BA:8C:B9:54:50:24,3837270,489540812,4809,6179749,3832461,483361063,0,8781,1684741,8759,1681246,22,3495,2345,15,5231,39,0,56,216660.0,130000.0,-49.0,-35.0,-43.0,-45.0,-42.0,-35.0,-44.0,-48.0,-89.0,-89.0,-86.0,-87.0,40.0,54.0,43.0,42.0,1
1481,92:69:1D:31:68:E9,3836324,486967399,3858,3605872,3832466,483361527,0,4583,1078105,4448,1047615,135,30490,2077,10,4040,84,0,41,229410.0,130000.0,-52.0,-47.0,-44.0,-46.0,-52.0,-47.0,-43.0,-47.0,-89.0,-89.0,-86.0,-87.0,37.0,42.0,42.0,41.0,1
1482,CC:2F:71:3F:1F:24,4524327,1216733815,691861,733372288,3832466,483361527,37,556460,572099840,555762,572015808,698,84032,537829,15,692109,77937,34,473,130000.0,43333.0,-75.0,-68.0,-70.0,-76.0,-75.0,-67.0,-69.0,-75.0,-89.0,-89.0,-86.0,-87.0,14.0,21.0,16.0,11.0,1
1483,CC:2F:71:3E:C5:1F,3833307,483464280,841,102753,3832466,483361527,0,3518,295289,2902,222157,616,73132,889,8,1210,18,0,37,144444.0,39000.0,-71.0,-69.0,-66.0,-60.0,-71.0,-69.0,-66.0,-60.0,-89.0,-89.0,-86.0,-87.0,18.0,20.0,20.0,27.0,1
1484,BA:8C:B9:54:50:24,3837277,489541478,4809,6179749,3832468,483361729,0,8781,1684741,8759,1681246,22,3495,2345,15,5231,39,0,56,216660.0,130000.0,-49.0,-35.0,-43.0,-45.0,-42.0,-35.0,-44.0,-48.0,-89.0,-89.0,-86.0,-87.0,40.0,54.0,43.0,42.0,1
1485,92:69:1D:31:68:E9,3836329,486967919,3859,3605988,3832470,483361931,0,4585,1078241,4450,1047751,135,30490,2077,10,4041,84,0,41,229410.0,130000.0,-52.0,-48.0,-43.0,-46.0,-52.0,-47.0,-43.0,-47.0,-89.0,-89.0,-86.0,-87.0,37.0,41.0,43.0,41.0,1
1486,CC:2F:71:3F:1F:24,4524371,1216748453,691901,733386522,3832470,483361931,37,556486,572104016,555788,572019984,698,84032,537851,15,692149,77952,34,473,130000.0,39000.0,-76.0,-68.0,-71.0,-75.0,-75.0,-67.0,-70.0,-75.0,-89.0,-89.0,-86.0,-87.0,13.0,21.0,15.0,12.0,1
1487,CC:2F:71:3E:C5:1F,3833312,483464800,842,102869,3832470,483361931,0,3520,295429,2904,222297,616,73132,889,8,1211,18,0,37,144444.0,43333.0,-71.0,-70.0,-67.0,-60.0,-70.0,-69.0,-66.0,-60.0,-89.0,-89.0,-86.0,-87.0,18.0,19.0,19.0,27.0,1
1488,BA:8C:B9:54:50:24,3837280,489541796,4810,6179865,3832470,483361931,0,8783,1684877,8761,1681382,22,3495,2345,15,5232,39,0,56,216660.0,130000.0,-40.0,-37.0,-45.0,-51.0,-42.0,-35.0,-43.0,-48.0,-89.0,-89.0,-86.0,-87.0,49.0,52.0,41.0,36.0,1
1489,92:69:1D:31:68:E9,3836333,486968323,3859,3605988,3832474,483362335,0,4585,1078241,4450,1047751,135,30490,2077,10,4041,84,0,41,229410.0,130000.0,-52.0,-48.0,-43.0,-46.0,-52.0,-47.0,-43.0,-47.0,-89.0,-89.0,-86.0,-87.0,37.0,41.0,43.0,41.0,1
1490,CC:2F:71:3F:1F:24,4524414,1216762919,691940,733400584,3832474,483362335,37,556510,572108112,555812,572024080,698,84032,537873,15,692188,77965,34,473,130000.0,39000.0,-75.0,-68.0,-70.0,-75.0,-75.0,-67.0,-70.0,-75.0,-89.0,-89.0,-86.0,-87.0,14.0,21.0,16.0,12.0,1
1491,CC:2F:71:3E:C5:1F,3833316,483465204,842,102869,3832474,483362335,0,3520,295429,2904,222297,616,73132,889,8,1211,18,0,37,144444.0,43333.0,-71.0,-70.0,-67.0,-60.0,-70.0,-69.0,-66.0,-60.0,-89.0,-89.0,-86.0,-87.0,18.0,19.0,19.0,27.0,1
1492,BA:8C:B9:54:50:24,3837286,489542402,4810,6179865,3832476,483362537,0,8783,1684877,8761,1681382,22,3495,2345,15,5232,39,0,56,216660.0,130000.0,-40.0,-37.0,-45.0,-51.0,-42.0,-35.0,-43.0,-48.0,-89.0,-89.0,-86.0,-87.0,49.0,52.0,41.0,36.0,1
1493,92:69:1D:31:68:E9,3836339,486969060,3859,3605988,3832480,483363072,0,4585,1078241,4450,1047751,135,30490,2077,10,4041,84,0,41,229410.0,130000.0,-52.0,-48.0,-43.0,-46.0,-52.0,-47.0,-43.0,-47.0,-89.0,-89.0,-86.0,-87.0,37.0,41.0,43.0,41.0,1
1494,CC:2F:71:3F:1F:24,4524460,1216777904,691980,733414832,3832480,483363072,37,556539,572112760,555841,572028728,698,84032,537896,15,692228,77977,34,473,130000.0,43333.0,-75.0,-68.0,-70.0,-76.0,-74.0,-67.0,-69.0,-75.0,-89.0,-89.0,-86.0,-87.0,14.0,21.0,16.0,11.0,1
1495,CC:2F:71:3E:C5:1F,3833322,483465941,842,102869,3832480,483363072,0,3520,295429,2904,222297,616,73132,889,8,1211,18,0,37,144444.0,43333.0,-71.0,-70.0,-67.0,-60.0,-70.0,-69.0,-66.0,-60.0,-89.0,-89.0,-86.0,-87.0,18.0,19.0,19.0,27.0,1
1496,BA:8C:B9:54:50:24,3837290,489542937,4810,6179865,3832480,483363072,0,8783,1684877,8761,1681382,22,3495,2345,15,5232,39,0,56,216660.0,130000.0,-40.0,-37.0,-45.0,-51.0,-42.0,-35.0,-43.0,-48.0,-89.0,-89.0,-86.0,-87.0,49.0,52.0,41.0,36.0,1
1497,92:69:1D:31:68:E9,3836341,486969262,3859,3605988,3832482,483363274,0,4585,1078241,4450,1047751,135,30490,2077,10,4041,84,0,41,229410.0,130000.0,-52.0,-48.0,-43.0,-46.0,-52.0,-47.0,-43.0,-47.0,-89.0,-89.0,-86.0,-87.0,37.0,41.0,43.0,41.0,1
1498,CC:2F:71:3F:1F:24,4524866,1217295096,692382,733931620,3832484,483363476,37,556713,572142198,556015,572058166,698,84032,538065,15,692627,78218,34,473,115556.0,26000.0,-75.0,-68.0,-69.0,-75.0,-75.0,-68.0,-69.0,-75.0,-89.0,-89.0,-86.0,-87.0,14.0,21.0,17.0,12.0,1
1499,CC:2F:71:3E:C5:1F,3833326,483466345,842,102869,3832484,483363476,0,3520,295429,2904,222297,616,73132,889,8,1211,18,0,37,144444.0,43333.0,-71.0,-70.0,-67.0,-60.0,-70.0,-69.0,-66.0,-60.0,-89.0,-89.0,-86.0,-87.0,18.0,19.0,19.0,27.0,1
1500,BA:8C:B9:54:50:24,3837296,489543543,4810,6179865,3832486,483363678,0,8783,1684877,8761,1681382,22,3495,2345,15,5232,39,0,56,216660.0,130000.0,-40.0,-37.0,-45.0,-51.0,-42.0,-35.0,-43.0,-48.0,-89.0,-89.0,-86.0,-87.0,49.0,52.0,41.0,36.0,1
1501,92:69:1D:31:68:E9,3836347,486969868,3859,3605988,3832488,483363880,0,4585,1078241,4450,1047751,135,30490,2077,10,4041,84,0,41,229410.0,130000.0,-52.0,-48.0,-43.0,-46.0,-52.0,-47.0,-43.0,-47.0,-89.0,-89.0,-86.0,-87.0,37.0,41.0,43.0,41.0,1
1502,CC:2F:71:3F:1F:24,4525202,1217618575,692714,734254695,3832488,483363880,37,556893,572168957,556195,572084925,698,84032,538238,15,692962,78230,34,473,115556.0,28889.0,-75.0,-68.0,-70.0,-76.0,-75.0,-68.0,-69.0,-76.0,-89.0,-89.0,-86.0,-87.0,14.0,21.0,16.0,11.0,1
1503,CC:2F:71:3E:C5:1F,3833330,483466749,842,102869,3832488,483363880,0,3520,295429,2904,222297,616,73132,889,8,1211,18,0,37,144444.0,43333.0,-71.0,-70.0,-67.0,-60.0,-70.0,-69.0,-66.0,-60.0,-89.0,-89.0,-86.0,-87.0,18.0,19.0,19.0,27.0,1
1504,BA:8C:B9:54:50:24,3837298,489543745,4810,6179865,3832488,483363880,0,8783,1684877,8761,1681382,22,3495,2345,15,5232,39,0,56,216660.0,130000.0,-40.0,-37.0,-45.0,-51.0,-42.0,-35.0,-43.0,-48.0,-89.0,-89.0,-86.0,-87.0,49.0,52.0,41.0,36.0,1
1505,92:69:1D:31:68:E9,3836352,486970498,3859,3605988,3832493,483364510,0,4585,1078241,4450,1047751,135,30490,2077,10,4041,84,0,41,229410.0,130000.0,-52.0,-48.0,-43.0,-46.0,-52.0,-47.0,-43.0,-47.0,-89.0,-89.0,-86.0,-87.0,37.0,41.0,43.0,41.0,1
1506,CC:2F:71:3F:1F:24,4525583,1218084477,693088,734719765,3832495,483364712,37,557051,572192329,556353,572108297,698,84032,538392,15,693336,78230,34,473,115556.0,28889.0,-74.0,-67.0,-69.0,-75.0,-74.0,-67.0,-69.0,-74.0,-89.0,-89.0,-86.0,-87.0,15.0,22.0,17.0,12.0,1
1507,CC:2F:71:3E:C5:1F,3833337,483467581,842,102869,3832495,483364712,0,3520,295429,2904,222297,616,73132,889,8,1211,18,0,37,144444.0,43333.0,-71.0,-70.0,-67.0,-60.0,-70.0,-69.0,-66.0,-60.0,-89.0,-89.0,-86.0,-87.0,18.0,19.0,19.0,27.0,1
1508,BA:8C:B9:54:50:24,3837307,489544779,4810,6179865,3832497,483364914,0,8783,1684877,8761,1681382,22,3495,2345,15,5232,39,0,56,216660.0,130000.0,-40.0,-37.0,-45.0,-51.0,-42.0,-35.0,-43.0,-48.0,-89.0,-89.0,-86.0,-87.0,49.0,52.0,41.0,36.0,1
1509,92:69:1D:31:68:E9,3836358,486971104,3859,3605988,3832499,483365116,0,4585,1078241,4450,1047751,135,30490,2077,10,4041,84,0,41,229410.0,130000.0,-52.0,-48.0,-43.0,-46.0,-52.0,-47.0,-43.0,-47.0,-89.0,-89.0,-86.0,-87.0,37.0,41.0,43.0,41.0,1
1510,CC:2F:71:3F:1F:24,4526073,1218633022,693574,735267906,3832499,483365116,37,557306,572230459,556608,572146427,698,84032,538640,15,693821,78273,34,474,117000.0,39000.0,-74.0,-67.0,-69.0,-75.0,-74.0,-67.0,-69.0,-74.0,-89.0,-89.0,-86.0,-87.0,15.0,22.0,17.0,12.0,1
1511,CC:2F:71:3E:C5:1F,3833341,483467985,842,102869,3832499,483365116,0,3520,295429,2904,222297,616,73132,889,8,1211,18,0,37,144444.0,43333.0,-71.0,-70.0,-67.0,-60.0,-70.0,-69.0,-66.0,-60.0,-89.0,-89.0,-86.0,-87.0,18.0,19.0,19.0,27.0,1
1512,BA:8C:B9:54:50:24,3837309,489544981,4810,6179865,3832499,483365116,0,8783,1684877,8761,1681382,22,3495,2345,15,5232,39,0,56,216660.0,130000.0,-40.0,-37.0,-45.0,-51.0,-42.0,-35.0,-43.0,-48.0,-89.0,-89.0,-86.0,-87.0,49.0,52.0,41.0,36.0,1
1513,92:69:1D:31:68:E9,3836363,486971568,3859,3605988,3832504,483365580,0,4585,1078241,4450,1047751,135,30490,2077,10,4041,84,0,41,229410.0,130000.0,-52.0,-48.0,-43.0,-46.0,-52.0,-47.0,-43.0,-47.0,-89.0,-89.0,-86.0,-87.0,37.0,41.0,43.0,41.0,1
1514,CC:2F:71:3F:1F:24,4526117,1218647548,693613,735281968,3832504,483365580,37,557334,572235319,556636,572151287,698,84032,538664,15,693861,78279,34,474,115556.0,26000.0,-74.0,-67.0,-69.0,-74.0,-73.0,-67.0,-69.0,-74.0,-89.0,-89.0,-86.0,-87.0,15.0,22.0,17.0,13.0,1
1515,CC:2F:71:3E:C5:1F,3833346,483468449,842,102869,3832504,483365580,0,3520,295429,2904,222297,616,73132,889,8,1211,18,0,37,144444.0,43333.0,-71.0,-70.0,-67.0,-60.0,-70.0,-69.0,-66.0,-60.0,-89.0,-89.0,-86.0,-87.0,18.0,19.0,19.0,27.0,1
1516,BA:8C:B9:54:50:24,3837316,489545647,4810,6179865,3832506,483365782,0,8783,1684877,8761,1681382,22,3495,2345,15,5232,39,0,56,216660.0,130000.0,-40.0,-37.0,-45.0,-51.0,-42.0,-35.0,-43.0,-48.0,-89.0,-89.0,-86.0,-87.0,49.0,52.0,41.0,36.0,1
1517,92:69:1D:31:68:E9,3836367,486971972,3859,3605988,3832508,483365984,0,4585,1078241,4450,1047751,135,30490,2077,10,4041,84,0,41,229410.0,130000.0,-52.0,-48.0,-43.0,-46.0,-52.0,-47.0,-43.0,-47.0,-89.0,-89.0,-86.0,-87.0,37.0,41.0,43.0,41.0,1
1518,CC:2F:71:3F:1F:24,4526161,1218662144,693653,735296160,3832508,483365984,37,557359,572239753,556661,572155721,698,84032,538686,15,693901,78281,34,474,117000.0,39000.0,-74.0,-67.0,-69.0,-75.0,-74.0,-67.0,-68.0,-74.0,-89.0,-89.0,-86.0,-87.0,15.0,22.0,17.0,12.0,1
1519,CC:2F:71:3E:C5:1F,3833350,483468853,842,102869,3832508,483365984,0,3521,295499,2905,222367,616,73132,889,8,1212,18,0,37,144444.0,43333.0,-69.0,-70.0,-66.0,-60.0,-70.0,-69.0,-66.0,-60.0,-89.0,-89.0,-86.0,-87.0,20.0,19.0,20.0,27.0,1
1520,BA:8C:B9:54:50:24,3837318,489545849,4810,6179865,3832508,483365984,0,8785,1685013,8763,1681518,22,3495,2345,15,5233,39,0,56,216660.0,130000.0,-40.0,-37.0,-46.0,-52.0,-42.0,-36.0,-44.0,-49.0,-89.0,-89.0,-86.0,-87.0,49.0,52.0,40.0,35.0,1
1521,92:69:1D:31:68:E9,3836369,486972174,3859,3605988,3832510,483366186,0,4587,1078377,4452,1047887,135,30490,2077,10,4042,84,0,41,229410.0,130000.0,-52.0,-47.0,-43.0,-48.0,-52.0,-47.0,-43.0,-46.0,-89.0,-89.0,-86.0,-87.0,37.0,42.0,43.0,39.0,1
1522,CC:2F:71:3F:1F:24,4526205,1218676740,693693,735310352,3832512,483366388,37,557381,572243603,556683,572159571,698,84032,538707,15,693941,78281,34,474,130000.0,39000.0,-74.0,-67.0,-69.0,-74.0,-74.0,-67.0,-68.0,-74.0,-89.0,-89.0,-86.0,-87.0,15.0,22.0,17.0,13.0,1
1523,CC:2F:71:3E:C5:1F,3833354,483469257,842,102869,3832512,483366388,0,3522,295569,2906,222437,616,73132,889,8,1212,18,0,37,144444.0,43333.0,-72.0,-70.0,-67.0,-60.0,-70.0,-69.0,-66.0,-60.0,-89.0,-89.0,-86.0,-87.0,17.0,19.0,19.0,27.0,1
1524,BA:8C:B9:54:50:24,3837322,489546253,4810,6179865,3832512,483366388,0,8785,1685013,8763,1681518,22,3495,2345,15,5233,39,0,56,216660.0,130000.0,-40.0,-37.0,-46.0,-52.0,-42.0,-36.0,-44.0,-49.0,-89.0,-89.0,-86.0,-87.0,49.0,52.0,40.0,35.0,1
1525,92:69:1D:31:68:E9,3836377,486972902,3859,3605988,3832518,483366914,0,4587,1078377,4452,1047887,135,30490,2077,10,4042,84,0,41,229410.0,130000.0,-52.0,-47.0,-43.0,-48.0,-52.0,-47.0,-43.0,-46.0,-89.0,-89.0,-86.0,-87.0,37.0,42.0,43.0,39.0,1
1526,CC:2F:71:3F:1F:24,4526249,1218691198,693731,735324284,3832518,483366914,37,557404,572247525,556705,572163375,699,84150,538728,15,693979,78294,34,475,117000.0,39000.0,-74.0,-67.0,-69.0,-74.0,-74.0,-67.0,-69.0,-74.0,-89.0,-89.0,-86.0,-87.0,15.0,22.0,17.0,13.0,1
1527,CC:2F:71:3E:C5:1F,3833360,483469783,842,102869,3832518,483366914,0,3522,295569,2906,222437,616,73132,889,8,1212,18,0,37,144444.0,43333.0,-72.0,-70.0,-67.0,-60.0,-70.0,-69.0,-66.0,-60.0,-89.0,-89.0,-86.0,-87.0,17.0,19.0,19.0,27.0,1
1528,BA:8C:B9:54:50:24,3837328,489546779,4810,6179865,3832518,483366914,0,8785,1685013,8763,1681518,22,3495,2345,15,5233,39,0,56,216660.0,130000.0,-40.0,-37.0,-46.0,-52.0,-42.0,-36.0,-44.0,-49.0,-89.0,-89.0,-86.0,-87.0,49.0,52.0,40.0,35.0,1
1529,92:69:1D:31:68:E9,3836379,486973104,3859,3605988,3832520,483367116,0,4587,1078377,4452,1047887,135,30490,2077,10,4042,84,0,41,229410.0,130000.0,-52.0,-47.0,-43.0,-48.0,-52.0,-47.0,-43.0,-46.0,-89.0,-89.0,-86.0,-87.0,37.0,42.0,43.0,39.0,1
1530,CC:2F:71:3F:1F:24,4526298,1218708895,693776,735341577,3832522,483367318,37,557438,572253605,556739,572169455,699,84150,538758,15,694024,78297,34,475,117000.0,39000.0,-74.0,-67.0,-69.0,-74.0,-74.0,-67.0,-68.0,-74.0,-89.0,-89.0,-86.0,-87.0,15.0,22.0,17.0,13.0,1
1531,CC:2F:71:3E:C5:1F,3833364,483470187,842,102869,3832522,483367318,0,3522,295569,2906,222437,616,73132,889,8,1212,18,0,37,144444.0,43333.0,-72.0,-70.0,-67.0,-60.0,-70.0,-69.0,-66.0,-60.0,-89.0,-89.0,-86.0,-87.0,17.0,19.0,19.0,27.0,1
1532,BA:8C:B9:54:50:24,3837332,489547183,4810,6179865,3832522,483367318,0,8785,1685013,8763,1681518,22,3495,2345,15,5233,39,0,56,216660.0,130000.0,-40.0,-37.0,-46.0,-52.0,-42.0,-36.0,-44.0,-49.0,-89.0,-89.0,-86.0,-87.0,49.0,52.0,40.0,35.0,1
1533,92:69:1D:31:68:E9,3836385,486973710,3859,3605988,3832526,483367722,0,4587,1078377,4452,1047887,135,30490,2077,10,4042,84,0,41,229410.0,130000.0,-52.0,-47.0,-43.0,-48.0,-52.0,-47.0,-43.0,-46.0,-89.0,-89.0,-86.0,-87.0,37.0,42.0,43.0,39.0,1
1534,CC:2F:71:3F:1F:24,4526340,1218723231,693814,735355509,3832526,483367722,37,557460,572257455,556761,572173305,699,84150,538779,15,694062,78299,34,475,130000.0,43333.0,-74.0,-67.0,-69.0,-74.0,-74.0,-67.0,-69.0,-74.0,-89.0,-89.0,-86.0,-87.0,15.0,22.0,17.0,13.0,1
1535,CC:2F:71:3E:C5:1F,3833368,483470591,842,102869,3832526,483367722,0,3522,295569,2906,222437,616,73132,889,8,1212,18,0,37,144444.0,43333.0,-72.0,-70.0,-67.0,-60.0,-70.0,-69.0,-66.0,-60.0,-89.0,-89.0,-86.0,-87.0,17.0,19.0,19.0,27.0,1
1536,BA:8C:B9:54:50:24,3837337,489547647,4810,6179865,3832527,483367782,0,8785,1685013,8763,1681518,22,3495,2345,15,5233,39,0,56,216660.0,130000.0,-40.0,-37.0,-46.0,-52.0,-42.0,-36.0,-44.0,-49.0,-89.0,-89.0,-86.0,-87.0,49.0,52.0,40.0,35.0,1
1537,92:69:1D:31:68:E9,3836389,486974034,3859,3605988,3832530,483368046,0,4587,1078377,4452,1047887,135,30490,2077,10,4042,84,0,41,229410.0,130000.0,-52.0,-47.0,-43.0,-48.0,-52.0,-47.0,-43.0,-46.0,-89.0,-89.0,-86.0,-87.0,37.0,42.0,43.0,39.0,1
1538,CC:2F:71:3F:1F:24,4526383,1218737617,693853,735369571,3832530,483368046,37,557483,572261593,556784,572177443,699,84150,538799,15,694101,78312,34,475,117000.0,39000.0,-74.0,-68.0,-69.0,-75.0,-74.0,-67.0,-68.0,-74.0,-89.0,-89.0,-86.0,-87.0,15.0,21.0,17.0,12.0,1
1539,CC:2F:71:3E:C5:1F,3833372,483470915,842,102869,3832530,483368046,0,3524,295757,2907,222507,617,73250,890,8,1212,18,0,37,144444.0,43333.0,-71.0,-70.0,-67.0,-60.0,-70.0,-69.0,-66.0,-60.0,-89.0,-89.0,-86.0,-87.0,18.0,19.0,19.0,27.0,1
1540,BA:8C:B9:54:50:24,3837342,489548113,4810,6179865,3832532,483368248,0,8785,1685013,8763,1681518,22,3495,2345,15,5233,39,0,56,216660.0,130000.0,-40.0,-37.0,-46.0,-52.0,-42.0,-36.0,-44.0,-49.0,-89.0,-89.0,-86.0,-87.0,49.0,52.0,40.0,35.0,1
1541,92:69:1D:31:68:E9,3836395,486974640,3859,3605988,3832536,483368652,0,4587,1078377,4452,1047887,135,30490,2077,10,4042,84,0,41,229410.0,130000.0,-52.0,-47.0,-43.0,-48.0,-52.0,-47.0,-43.0,-46.0,-89.0,-89.0,-86.0,-87.0,37.0,42.0,43.0,39.0,1
1542,CC:2F:71:3F:1F:24,4526655,1219009603,694119,735640951,3832536,483368652,37,557616,572284023,556917,572199873,699,84150,538929,15,694367,78419,34,475,130000.0,43333.0,-74.0,-67.0,-69.0,-74.0,-73.0,-66.0,-68.0,-74.0,-89.0,-89.0,-86.0,-87.0,15.0,22.0,17.0,13.0,1
1543,CC:2F:71:3E:C5:1F,3833378,483471521,842,102869,3832536,483368652,0,3524,295757,2907,222507,617,73250,890,8,1212,18,0,37,144444.0,43333.0,-71.0,-70.0,-67.0,-60.0,-70.0,-69.0,-66.0,-60.0,-89.0,-89.0,-86.0,-87.0,18.0,19.0,19.0,27.0,1
1544,BA:8C:B9:54:50:24,3837346,489548517,4810,6179865,3832536,483368652,0,8785,1685013,8763,1681518,22,3495,2345,15,5233,39,0,56,216660.0,130000.0,-40.0,-37.0,-46.0,-52.0,-42.0,-36.0,-44.0,-49.0,-89.0,-89.0,-86.0,-87.0,49.0,52.0,40.0,35.0,1
1545,92:69:1D:31:68:E9,3836399,486975175,3859,3605988,3832540,483369187,0,4587,1078377,4452,1047887,135,30490,2077,10,4042,84,0,41,229410.0,130000.0,-52.0,-47.0,-43.0,-48.0,-52.0,-47.0,-43.0,-46.0,-89.0,-89.0,-86.0,-87.0,37.0,42.0,43.0,39.0,1
1546,CC:2F:71:3F:1F:24,4526894,1219270374,694354,735901187,3832540,483369187,37,557736,572301901,557037,572217751,699,84150,539039,15,694602,78432,34,475,130000.0,43333.0,-74.0,-67.0,-69.0,-75.0,-73.0,-67.0,-68.0,-74.0,-89.0,-89.0,-86.0,-87.0,15.0,22.0,17.0,12.0,1
1547,CC:2F:71:3E:C5:1F,3833382,483472056,842,102869,3832540,483369187,0,3524,295757,2907,222507,617,73250,890,8,1212,18,0,37,144444.0,43333.0,-71.0,-70.0,-67.0,-60.0,-70.0,-69.0,-66.0,-60.0,-89.0,-89.0,-86.0,-87.0,18.0,19.0,19.0,27.0,1
1548,BA:8C:B9:54:50:24,3837352,489549254,4810,6179865,3832542,483369389,0,8786,1685081,8764,1681586,22,3495,2345,15,5233,39,0,56,216660.0,130000.0,-40.0,-37.0,-45.0,-52.0,-41.0,-36.0,-45.0,-50.0,-89.0,-89.0,-86.0,-87.0,49.0,52.0,41.0,35.0,1
1549,92:69:1D:31:68:E9,3836405,486975781,3859,3605988,3832546,483369793,0,4587,1078377,4452,1047887,135,30490,2077,10,4042,84,0,41,229410.0,130000.0,-52.0,-47.0,-43.0,-48.0,-52.0,-47.0,-43.0,-46.0,-89.0,-89.0,-86.0,-87.0,37.0,42.0,43.0,39.0,1
1550,CC:2F:71:3F:1F:24,4527136,1219531234,694590,736161441,3832546,483369793,37,557846,572318567,557147,572234417,699,84150,539145,15,694838,78461,34,475,117000.0,39000.0,-74.0,-67.0,-69.0,-74.0,-74.0,-67.0,-69.0,-74.0,-89.0,-89.0,-86.0,-87.0,15.0,22.0,17.0,13.0,1
1551,CC:2F:71:3E:C5:1F,3833388,483472662,842,102869,3832546,483369793,0,3524,295757,2907,222507,617,73250,890,8,1212,18,0,37,144444.0,43333.0,-71.0,-70.0,-67.0,-60.0,-70.0,-69.0,-66.0,-60.0,-89.0,-89.0,-86.0,-87.0,18.0,19.0,19.0,27.0,1
1552,BA:8C:B9:54:50:24,3837356,489549658,4810,6179865,3832546,483369793,0,8786,1685081,8764,1681586,22,3495,2345,15,5233,39,0,56,216660.0,130000.0,-40.0,-37.0,-45.0,-52.0,-41.0,-36.0,-45.0,-50.0,-89.0,-89.0,-86.0,-87.0,49.0,52.0,41.0,35.0,1
1553,92:69:1D:31:68:E9,3836407,486975983,3859,3605988,3832548,483369995,0,4587,1078377,4452,1047887,135,30490,2077,10,4042,84,0,41,229410.0,130000.0,-52.0,-47.0,-43.0,-48.0,-52.0,-47.0,-43.0,-46.0,-89.0,-89.0,-86.0,-87.0,37.0,42.0,43.0,39.0,1
1554,CC:2F:71:3F:1F:24,4527400,1219829244,694852,736459249,3832548,483369995,37,557971,572338040,557272,572253890,699,84150,539267,15,695100,78523,34,475,130000.0,43333.0,-74.0,-67.0,-69.0,-74.0,-74.0,-67.0,-68.0,-74.0,-89.0,-89.0,-86.0,-87.0,15.0,22.0,17.0,13.0,1
1555,CC:2F:71:3E:C5:1F,3833390,483472864,842,102869,3832548,483369995,0,3524,295757,2907,222507,617,73250,890,8,1212,18,0,37,144444.0,43333.0,-71.0,-70.0,-67.0,-60.0,-70.0,-69.0,-66.0,-60.0,-89.0,-89.0,-86.0,-87.0,18.0,19.0,19.0,27.0,1
1556,BA:8C:B9:54:50:24,3837358,489549860,4810,6179865,3832548,483369995,0,8786,1685081,8764,1681586,22,3495,2345,15,5233,39,0,56,216660.0,130000.0,-40.0,-37.0,-45.0,-52.0,-41.0,-36.0,-45.0,-50.0,-89.0,-89.0,-86.0,-87.0,49.0,52.0,41.0,35.0,1
1557,92:69:1D:31:68:E9,3836414,486976649,3859,3605988,3832555,483370661,0,4587,1078377,4452,1047887,135,30490,2077,10,4042,84,0,41,229410.0,130000.0,-52.0,-47.0,-43.0,-48.0,-52.0,-47.0,-43.0,-46.0,-89.0,-89.0,-86.0,-87.0,37.0,42.0,43.0,39.0,1
1558,CC:2F:71:3F:1F:24,4527802,1220297130,695247,736926469,3832555,483370661,37,558149,572364116,557450,572279966,699,84150,539439,15,695495,78588,34,475,130000.0,43333.0,-74.0,-67.0,-69.0,-74.0,-74.0,-67.0,-68.0,-74.0,-89.0,-89.0,-86.0,-87.0,15.0,22.0,17.0,13.0,1
1559,CC:2F:71:3E:C5:1F,3833397,483473530,842,102869,3832555,483370661,0,3524,295757,2907,222507,617,73250,890,8,1212,18,0,37,144444.0,43333.0,-71.0,-70.0,-67.0,-60.0,-70.0,-69.0,-66.0,-60.0,-89.0,-89.0,-86.0,-87.0,18.0,19.0,19.0,27.0,1
1560,BA:8C:B9:54:50:24,3837365,489550526,4810,6179865,3832555,483370661,0,8786,1685081,8764,1681586,22,3495,2345,15,5233,39,0,56,216660.0,130000.0,-40.0,-37.0,-45.0,-52.0,-41.0,-36.0,-45.0,-50.0,-89.0,-89.0,-86.0,-87.0,49.0,52.0,41.0,35.0,1
1561,92:69:1D:31:68:E9,3836416,486976851,3859,3605988,3832557,483370863,0,4587,1078377,4452,1047887,135,30490,2077,10,4042,84,0,41,229410.0,130000.0,-52.0,-47.0,-43.0,-48.0,-52.0,-47.0,-43.0,-46.0,-89.0,-89.0,-86.0,-87.0,37.0,42.0,43.0,39.0,1
1562,CC:2F:71:3F:1F:24,4527842,1220311320,695285,736940457,3832557,483370863,37,558172,572368224,557473,572284074,699,84150,539460,15,695533,78609,34,475,130000.0,39000.0,-74.0,-67.0,-68.0,-74.0,-74.0,-67.0,-68.0,-73.0,-89.0,-89.0,-86.0,-87.0,15.0,22.0,18.0,13.0,1
1563,CC:2F:71:3E:C5:1F,3833399,483473732,842,102869,3832557,483370863,0,3524,295757,2907,222507,617,73250,890,8,1212,18,0,37,144444.0,43333.0,-71.0,-70.0,-67.0,-60.0,-70.0,-69.0,-66.0,-60.0,-89.0,-89.0,-86.0,-87.0,18.0,19.0,19.0,27.0,1
1564,BA:8C:B9:54:50:24,3837367,489550728,4810,6179865,3832557,483370863,0,8786,1685081,8764,1681586,22,3495,2345,15,5233,39,0,56,216660.0,130000.0,-40.0,-37.0,-45.0,-52.0,-41.0,-36.0,-45.0,-50.0,-89.0,-89.0,-86.0,-87.0,49.0,52.0,41.0,35.0,1
1565,92:69:1D:31:68:E9,3836422,486977457,3859,3605988,3832563,483371469,0,4587,1078377,4452,1047887,135,30490,2077,10,4042,84,0,41,229410.0,130000.0,-52.0,-47.0,-43.0,-48.0,-52.0,-47.0,-43.0,-46.0,-89.0,-89.0,-86.0,-87.0,37.0,42.0,43.0,39.0,1
1566,CC:2F:71:3F:1F:24,4527889,1220326248,695326,736954779,3832563,483371469,37,558199,572372716,557500,572288566,699,84150,539485,15,695574,78623,34,475,130000.0,39000.0,-74.0,-67.0,-69.0,-74.0,-74.0,-67.0,-69.0,-73.0,-89.0,-89.0,-86.0,-87.0,15.0,22.0,17.0,13.0,1
1567,CC:2F:71:3E:C5:1F,3833406,483474398,842,102869,3832564,483371529,0,3524,295757,2907,222507,617,73250,890,8,1212,18,0,37,144444.0,43333.0,-71.0,-70.0,-67.0,-60.0,-70.0,-69.0,-66.0,-60.0,-89.0,-89.0,-86.0,-87.0,18.0,19.0,19.0,27.0,1
1568,BA:8C:B9:54:50:24,3837374,489551394,4810,6179865,3832564,483371529,0,8786,1685081,8764,1681586,22,3495,2345,15,5233,39,0,56,216660.0,130000.0,-40.0,-37.0,-45.0,-52.0,-41.0,-36.0,-45.0,-50.0,-89.0,-89.0,-86.0,-87.0,49.0,52.0,41.0,35.0,1
1569,92:69:1D:31:68:E9,3836425,486977719,3859,3605988,3832566,483371731,0,4587,1078377,4452,1047887,135,30490,2077,10,4042,84,0,41,229410.0,130000.0,-52.0,-47.0,-43.0,-48.0,-52.0,-47.0,-43.0,-46.0,-89.0,-89.0,-86.0,-87.0,37.0,42.0,43.0,39.0,1
1570,CC:2F:71:3F:1F:24,4527934,1220341080,695368,736969349,3832566,483371731,37,558226,572377430,557527,572293280,699,84150,539508,15,695616,78631,34,475,130000.0,43333.0,-74.0,-67.0,-69.0,-74.0,-74.0,-67.0,-69.0,-74.0,-89.0,-89.0,-86.0,-87.0,15.0,22.0,17.0,13.0,1
1571,CC:2F:71:3E:C5:1F,3833408,483474600,842,102869,3832566,483371731,0,3524,295757,2907,222507,617,73250,890,8,1212,18,0,37,144444.0,43333.0,-71.0,-70.0,-67.0,-60.0,-70.0,-69.0,-66.0,-60.0,-89.0,-89.0,-86.0,-87.0,18.0,19.0,19.0,27.0,1
1572,BA:8C:B9:54:50:24,3837376,489551596,4810,6179865,3832566,483371731,0,8786,1685081,8764,1681586,22,3495,2345,15,5233,39,0,56,216660.0,130000.0,-40.0,-37.0,-45.0,-52.0,-41.0,-36.0,-45.0,-50.0,-89.0,-89.0,-86.0,-87.0,49.0,52.0,41.0,35.0,1
1573,92:69:1D:31:68:E9,3836429,486978123,3859,3605988,3832570,483372135,0,4587,1078377,4452,1047887,135,30490,2077,10,4042,84,0,41,229410.0,130000.0,-52.0,-47.0,-43.0,-48.0,-52.0,-47.0,-43.0,-46.0,-89.0,-89.0,-86.0,-87.0,37.0,42.0,43.0,39.0,1
1574,CC:2F:71:3F:1F:24,4527978,1220355736,695407,736983467,3832571,483372269,37,558253,572382048,557554,572297898,699,84150,539530,15,695655,78650,34,475,144444.0,39000.0,-74.0,-67.0,-69.0,-74.0,-74.0,-67.0,-68.0,-74.0,-89.0,-89.0,-86.0,-87.0,15.0,22.0,17.0,13.0,1
1575,CC:2F:71:3E:C5:1F,3833414,483475206,842,102869,3832572,483372337,0,3524,295757,2907,222507,617,73250,890,8,1212,18,0,37,144444.0,43333.0,-71.0,-70.0,-67.0,-60.0,-70.0,-69.0,-66.0,-60.0,-89.0,-89.0,-86.0,-87.0,18.0,19.0,19.0,27.0,1
1576,BA:8C:B9:54:50:24,3837382,489552202,4810,6179865,3832572,483372337,0,8786,1685081,8764,1681586,22,3495,2345,15,5233,39,0,56,216660.0,130000.0,-40.0,-37.0,-45.0,-52.0,-41.0,-36.0,-45.0,-50.0,-89.0,-89.0,-86.0,-87.0,49.0,52.0,41.0,35.0,1
1577,92:69:1D:31:68:E9,3836434,486978587,3859,3605988,3832575,483372599,0,4587,1078377,4452,1047887,135,30490,2077,10,4042,84,0,41,229410.0,130000.0,-52.0,-47.0,-43.0,-48.0,-52.0,-47.0,-43.0,-46.0,-89.0,-89.0,-86.0,-87.0,37.0,42.0,43.0,39.0,1
1578,CC:2F:71:3F:1F:24,4528029,1220373619,695454,737001020,3832575,483372599,37,558288,572388594,557589,572304444,699,84150,539559,15,695702,78689,34,475,144444.0,43333.0,-74.0,-67.0,-69.0,-74.0,-74.0,-67.0,-68.0,-73.0,-89.0,-89.0,-86.0,-87.0,15.0,22.0,17.0,13.0,1
1579,CC:2F:71:3E:C5:1F,3833417,483475468,842,102869,3832575,483372599,0,3524,295757,2907,222507,617,73250,890,8,1212,18,0,37,144444.0,43333.0,-71.0,-70.0,-67.0,-60.0,-70.0,-69.0,-66.0,-60.0,-89.0,-89.0,-86.0,-87.0,18.0,19.0,19.0,27.0,1
1580,BA:8C:B9:54:50:24,3837385,489552464,4810,6179865,3832575,483372599,0,8786,1685081,8764,1681586,22,3495,2345,15,5233,39,0,56,216660.0,130000.0,-40.0,-37.0,-45.0,-52.0,-41.0,-36.0,-45.0,-50.0,-89.0,-89.0,-86.0,-87.0,49.0,52.0,41.0,35.0,1
1581,92:69:1D:31:68:E9,3836438,486978991,3859,3605988,3832579,483373003,0,4587,1078377,4452,1047887,135,30490,2077,10,4042,84,0,41,229410.0,130000.0,-52.0,-47.0,-43.0,-48.0,-52.0,-47.0,-43.0,-46.0,-89.0,-89.0,-86.0,-87.0,37.0,42.0,43.0,39.0,1
1582,CC:2F:71:3F:1F:24,4528073,1220388215,695494,737015212,3832579,483373003,37,558312,572392928,557613,572308778,699,84150,539580,15,695742,78699,34,475,117000.0,39000.0,-74.0,-67.0,-69.0,-74.0,-74.0,-67.0,-69.0,-73.0,-89.0,-89.0,-86.0,-87.0,15.0,22.0,17.0,13.0,1
1583,CC:2F:71:3E:C5:1F,3833421,483475872,842,102869,3832579,483373003,0,3524,295757,2907,222507,617,73250,890,8,1212,18,0,37,144444.0,43333.0,-71.0,-70.0,-67.0,-60.0,-70.0,-69.0,-66.0,-60.0,-89.0,-89.0,-86.0,-87.0,18.0,19.0,19.0,27.0,1
1584,BA:8C:B9:54:50:24,3837389,489552868,4810,6179865,3832579,483373003,0,8786,1685081,8764,1681586,22,3495,2345,15,5233,39,0,56,216660.0,130000.0,-40.0,-37.0,-45.0,-52.0,-41.0,-36.0,-45.0,-50.0,-89.0,-89.0,-86.0,-87.0,49.0,52.0,41.0,35.0,1
1585,92:69:1D:31:68:E9,3836442,486979395,3859,3605988,3832583,483373407,0,4587,1078377,4452,1047887,135,30490,2077,10,4042,84,0,41,229410.0,130000.0,-52.0,-47.0,-43.0,-48.0,-52.0,-47.0,-43.0,-46.0,-89.0,-89.0,-86.0,-87.0,37.0,42.0,43.0,39.0,1
1586,CC:2F:71:3F:1F:24,4528338,1220659186,695755,737285779,3832583,483373407,37,558437,572414101,557738,572329951,699,84150,539703,15,696003,78789,34,475,117000.0,39000.0,-74.0,-67.0,-69.0,-73.0,-74.0,-67.0,-69.0,-73.0,-89.0,-89.0,-86.0,-87.0,15.0,22.0,17.0,14.0,1
1587,CC:2F:71:3E:C5:1F,3833425,483476276,842,102869,3832583,483373407,0,3524,295757,2907,222507,617,73250,890,8,1212,18,0,37,144444.0,43333.0,-71.0,-70.0,-67.0,-60.0,-70.0,-69.0,-66.0,-60.0,-89.0,-89.0,-86.0,-87.0,18.0,19.0,19.0,27.0,1
1588,BA:8C:B9:54:50:24,3837393,489553272,4810,6179865,3832583,483373407,0,8786,1685081,8764,1681586,22,3495,2345,15,5233,39,0,56,216660.0,130000.0,-40.0,-37.0,-45.0,-52.0,-41.0,-36.0,-45.0,-50.0,-89.0,-89.0,-86.0,-87.0,49.0,52.0,41.0,35.0,1
1589,92:69:1D:31:68:E9,3836447,486979859,3859,3605988,3832588,483373871,0,4587,1078377,4452,1047887,135,30490,2077,10,4042,84,0,41,229410.0,130000.0,-52.0,-47.0,-43.0,-48.0,-52.0,-47.0,-43.0,-46.0,-89.0,-89.0,-86.0,-87.0,37.0,42.0,43.0,39.0,1
1590,CC:2F:71:3F:1F:24,4528746,1221135296,696158,737761425,3832588,483373871,37,558599,572440823,557900,572356673,699,84150,539860,15,696406,78972,34,475,130000.0,43333.0,-74.0,-67.0,-69.0,-74.0,-74.0,-67.0,-68.0,-74.0,-89.0,-89.0,-86.0,-87.0,15.0,22.0,17.0,13.0,1
1591,CC:2F:71:3E:C5:1F,3833430,483476740,842,102869,3832588,483373871,0,3524,295757,2907,222507,617,73250,890,8,1212,18,0,37,144444.0,43333.0,-71.0,-70.0,-67.0,-60.0,-70.0,-69.0,-66.0,-60.0,-89.0,-89.0,-86.0,-87.0,18.0,19.0,19.0,27.0,1
1592,BA:8C:B9:54:50:24,3837398,489553736,4810,6179865,3832588,483373871,0,8786,1685081,8764,1681586,22,3495,2345,15,5233,39,0,56,216660.0,130000.0,-40.0,-37.0,-45.0,-52.0,-41.0,-36.0,-45.0,-50.0,-89.0,-89.0,-86.0,-87.0,49.0,52.0,41.0,35.0,1
1593,92:69:1D:31:68:E9,3836452,486980379,3860,3606104,3832592,483374275,0,4589,1078513,4454,1048023,135,30490,2077,10,4043,84,0,41,229410.0,130000.0,-52.0,-47.0,-42.0,-48.0,-51.0,-47.0,-43.0,-46.0,-89.0,-89.0,-86.0,-87.0,37.0,42.0,44.0,39.0,1
1594,CC:2F:71:3F:1F:24,4528842,1221191917,696250,737817642,3832592,483374275,37,558667,572451671,557968,572367521,699,84150,539927,15,696498,78991,34,475,130000.0,43333.0,-74.0,-66.0,-68.0,-74.0,-74.0,-66.0,-68.0,-74.0,-89.0,-89.0,-86.0,-87.0,15.0,23.0,18.0,13.0,1
1595,CC:2F:71:3E:C5:1F,3833435,483477204,843,102929,3832592,483374275,0,3526,295897,2909,222647,617,73250,890,8,1213,18,0,37,130000.0,39000.0,-72.0,-70.0,-67.0,-60.0,-70.0,-69.0,-66.0,-60.0,-89.0,-89.0,-86.0,-87.0,17.0,19.0,19.0,27.0,1
1596,BA:8C:B9:54:50:24,3837403,489554256,4811,6179981,3832592,483374275,0,8792,1685489,8770,1681994,22,3495,2345,15,5234,39,0,56,216660.0,130000.0,-49.0,-35.0,-42.0,-45.0,-42.0,-35.0,-42.0,-47.0,-89.0,-89.0,-86.0,-87.0,40.0,54.0,44.0,42.0,1
1597,92:69:1D:31:68:E9,3836456,486980783,3860,3606104,3832596,483374679,0,4589,1078513,4454,1048023,135,30490,2077,10,4043,84,0,41,229410.0,130000.0,-52.0,-47.0,-42.0,-48.0,-51.0,-47.0,-43.0,-46.0,-89.0,-89.0,-86.0,-87.0,37.0,42.0,44.0,39.0,1
1598,CC:2F:71:3F:1F:24,4528890,1221207512,696294,737832833,3832596,483374679,37,558694,572456230,557995,572372080,699,84150,539953,15,696542,79005,34,475,130000.0,39000.0,-74.0,-66.0,-69.0,-74.0,-74.0,-66.0,-69.0,-74.0,-89.0,-89.0,-86.0,-87.0,15.0,23.0,17.0,13.0,1
1599,CC:2F:71:3E:C5:1F,3833441,483477941,843,102929,3832598,483375012,0,3526,295897,2909,222647,617,73250,890,8,1213,18,0,37,130000.0,39000.0,-72.0,-70.0,-67.0,-60.0,-70.0,-69.0,-66.0,-60.0,-89.0,-89.0,-86.0,-87.0,17.0,19.0,19.0,27.0,1
1600,BA:8C:B9:54:50:24,3837409,489554993,4811,6179981,3832598,483375012,0,8792,1685489,8770,1681994,22,3495,2345,15,5234,39,0,56,216660.0,130000.0,-49.0,-35.0,-42.0,-45.0,-42.0,-35.0,-42.0,-47.0,-89.0,-89.0,-86.0,-87.0,40.0,54.0,44.0,42.0,1
1601,92:69:1D:31:68:E9,3836462,486981520,3860,3606104,3832602,483375416,0,4589,1078513,4454,1048023,135,30490,2077,10,4043,84,0,41,229410.0,130000.0,-52.0,-47.0,-42.0,-48.0,-51.0,-47.0,-43.0,-46.0,-89.0,-89.0,-86.0,-87.0,37.0,42.0,44.0,39.0,1
1602,CC:2F:71:3F:1F:24,4528934,1221222125,696332,737846709,3832602,483375416,37,558716,572460142,558017,572375992,699,84150,539973,15,696580,79032,34,475,130000.0,43333.0,-74.0,-66.0,-69.0,-74.0,-74.0,-66.0,-69.0,-74.0,-89.0,-89.0,-86.0,-87.0,15.0,23.0,17.0,13.0,1
1603,CC:2F:71:3E:C5:1F,3833445,483478345,843,102929,3832602,483375416,0,3526,295897,2909,222647,617,73250,890,8,1213,18,0,37,130000.0,39000.0,-72.0,-70.0,-67.0,-60.0,-70.0,-69.0,-66.0,-60.0,-89.0,-89.0,-86.0,-87.0,17.0,19.0,19.0,27.0,1
1604,BA:8C:B9:54:50:24,3837413,489555397,4811,6179981,3832602,483375416,0,8792,1685489,8770,1681994,22,3495,2345,15,5234,39,0,56,216660.0,130000.0,-49.0,-35.0,-42.0,-45.0,-42.0,-35.0,-42.0,-47.0,-89.0,-89.0,-86.0,-87.0,40.0,54.0,44.0,42.0,1
1605,92:69:1D:31:68:E9,3836466,486981924,3860,3606104,3832606,483375820,0,4589,1078513,4454,1048023,135,30490,2077,10,4043,84,0,41,229410.0,130000.0,-52.0,-47.0,-42.0,-48.0,-51.0,-47.0,-43.0,-46.0,-89.0,-89.0,-86.0,-87.0,37.0,42.0,44.0,39.0,1
1606,CC:2F:71:3F:1F:24,4528976,1221236573,696370,737860753,3832606,483375820,37,558740,572464380,558041,572380230,699,84150,539994,15,696618,79033,34,475,130000.0,43333.0,-74.0,-66.0,-69.0,-74.0,-74.0,-65.0,-69.0,-74.0,-89.0,-89.0,-86.0,-87.0,15.0,23.0,17.0,13.0,1
1607,CC:2F:71:3E:C5:1F,3833449,483478749,843,102929,3832606,483375820,0,3526,295897,2909,222647,617,73250,890,8,1213,18,0,37,130000.0,39000.0,-72.0,-70.0,-67.0,-60.0,-70.0,-69.0,-66.0,-60.0,-89.0,-89.0,-86.0,-87.0,17.0,19.0,19.0,27.0,1
1608,BA:8C:B9:54:50:24,3837417,489555801,4811,6179981,3832606,483375820,0,8792,1685489,8770,1681994,22,3495,2345,15,5234,39,0,56,216660.0,130000.0,-49.0,-35.0,-42.0,-45.0,-42.0,-35.0,-42.0,-47.0,-89.0,-89.0,-86.0,-87.0,40.0,54.0,44.0,42.0,1
1609,92:69:1D:31:68:E9,3836471,486982388,3860,3606104,3832611,483376284,0,4589,1078513,4454,1048023,135,30490,2077,10,4043,84,0,41,229410.0,130000.0,-52.0,-47.0,-42.0,-48.0,-51.0,-47.0,-43.0,-46.0,-89.0,-89.0,-86.0,-87.0,37.0,42.0,44.0,39.0,1
1610,CC:2F:71:3F:1F:24,4529025,1221254368,696414,737878084,3832611,483376284,37,558768,572469417,558069,572385267,699,84150,540021,15,696662,79040,34,475,130000.0,39000.0,-73.0,-67.0,-69.0,-74.0,-73.0,-67.0,-69.0,-74.0,-89.0,-89.0,-86.0,-87.0,16.0,22.0,17.0,13.0,1
1611,CC:2F:71:3E:C5:1F,3833454,483479213,843,102929,3832611,483376284,0,3526,295897,2909,222647,617,73250,890,8,1213,18,0,37,130000.0,39000.0,-72.0,-70.0,-67.0,-60.0,-70.0,-69.0,-66.0,-60.0,-89.0,-89.0,-86.0,-87.0,17.0,19.0,19.0,27.0,1
1612,BA:8C:B9:54:50:24,3837422,489556265,4811,6179981,3832611,483376284,0,8792,1685489,8770,1681994,22,3495,2345,15,5234,39,0,56,216660.0,130000.0,-49.0,-35.0,-42.0,-45.0,-42.0,-35.0,-42.0,-47.0,-89.0,-89.0,-86.0,-87.0,40.0,54.0,44.0,42.0,1
1613,92:69:1D:31:68:E9,3836475,486982792,3860,3606104,3832615,483376688,0,4589,1078513,4454,1048023,135,30490,2077,10,4043,84,0,41,229410.0,130000.0,-52.0,-47.0,-42.0,-48.0,-51.0,-47.0,-43.0,-46.0,-89.0,-89.0,-86.0,-87.0,37.0,42.0,44.0,39.0,1
1614,CC:2F:71:3F:1F:24,4529067,1221268704,696452,737892016,3832615,483376688,37,558791,572473383,558092,572389233,699,84150,540043,15,696700,79048,34,475,130000.0,39000.0,-73.0,-66.0,-70.0,-74.0,-72.0,-66.0,-69.0,-73.0,-89.0,-89.0,-86.0,-87.0,16.0,23.0,16.0,13.0,1
1615,CC:2F:71:3E:C5:1F,3833458,483479617,843,102929,3832615,483376688,0,3526,295897,2909,222647,617,73250,890,8,1213,18,0,37,130000.0,39000.0,-72.0,-70.0,-67.0,-60.0,-70.0,-69.0,-66.0,-60.0,-89.0,-89.0,-86.0,-87.0,17.0,19.0,19.0,27.0,1
1616,BA:8C:B9:54:50:24,3837426,489556669,4811,6179981,3832615,483376688,0,8792,1685489,8770,1681994,22,3495,2345,15,5234,39,0,56,216660.0,130000.0,-49.0,-35.0,-42.0,-45.0,-42.0,-35.0,-42.0,-47.0,-89.0,-89.0,-86.0,-87.0,40.0,54.0,44.0,42.0,1
1617,92:69:1D:31:68:E9,3836479,486983196,3860,3606104,3832619,483377092,0,4589,1078513,4454,1048023,135,30490,2077,10,4043,84,0,41,229410.0,130000.0,-52.0,-47.0,-42.0,-48.0,-51.0,-47.0,-43.0,-46.0,-89.0,-89.0,-86.0,-87.0,37.0,42.0,44.0,39.0,1
1618,CC:2F:71:3F:1F:24,4529111,1221283356,696492,737906264,3832619,483377092,37,558817,572477807,558118,572393657,699,84150,540067,15,696740,79048,34,475,130000.0,43333.0,-73.0,-66.0,-68.0,-74.0,-72.0,-66.0,-68.0,-74.0,-89.0,-89.0,-86.0,-87.0,16.0,23.0,18.0,13.0,1
1619,CC:2F:71:3E:C5:1F,3833463,483480083,843,102929,3832620,483377154,0,3527,296015,2909,222647,618,73368,891,8,1213,18,0,37,130000.0,39000.0,-71.0,-71.0,-67.0,-60.0,-71.0,-70.0,-66.0,-60.0,-89.0,-89.0,-86.0,-87.0,18.0,18.0,19.0,27.0,1
1620,BA:8C:B9:54:50:24,3837431,489557135,4811,6179981,3832620,483377154,0,8792,1685489,8770,1681994,22,3495,2345,15,5234,39,0,56,216660.0,130000.0,-49.0,-35.0,-42.0,-45.0,-42.0,-35.0,-42.0,-47.0,-89.0,-89.0,-86.0,-87.0,40.0,54.0,44.0,42.0,1
1621,92:69:1D:31:68:E9,3836485,486983722,3860,3606104,3832625,483377618,0,4589,1078513,4454,1048023,135,30490,2077,10,4043,84,0,41,229410.0,130000.0,-52.0,-47.0,-42.0,-48.0,-51.0,-47.0,-43.0,-46.0,-89.0,-89.0,-86.0,-87.0,37.0,42.0,44.0,39.0,1
1622,CC:2F:71:3F:1F:24,4529155,1221297814,696530,737920196,3832625,483377618,37,558842,572482067,558143,572397917,699,84150,540090,15,696778,79053,34,475,144444.0,39000.0,-72.0,-66.0,-71.0,-73.0,-72.0,-66.0,-70.0,-73.0,-89.0,-89.0,-86.0,-87.0,17.0,23.0,15.0,14.0,1
1623,CC:2F:71:3E:C5:1F,3833468,483480547,843,102929,3832625,483377618,0,3528,296085,2910,222717,618,73368,891,8,1213,18,0,37,130000.0,39000.0,-71.0,-71.0,-67.0,-60.0,-71.0,-70.0,-66.0,-60.0,-89.0,-89.0,-86.0,-87.0,18.0,18.0,19.0,27.0,1
1624,BA:8C:B9:54:50:24,3837436,489557599,4811,6179981,3832625,483377618,0,8792,1685489,8770,1681994,22,3495,2345,15,5234,39,0,56,216660.0,130000.0,-49.0,-35.0,-42.0,-45.0,-42.0,-35.0,-42.0,-47.0,-89.0,-89.0,-86.0,-87.0,40.0,54.0,44.0,42.0,1
1625,92:69:1D:31:68:E9,3836489,486984126,3860,3606104,3832629,483378022,0,4591,1078649,4456,1048159,135,30490,2077,10,4044,84,0,41,229410.0,130000.0,-53.0,-48.0,-44.0,-46.0,-52.0,-47.0,-43.0,-47.0,-89.0,-89.0,-87.0,-87.0,36.0,41.0,43.0,41.0,1
1626,CC:2F:71:3F:1F:24,4529206,1221315984,696577,737937962,3832629,483378022,37,558879,572488467,558180,572404317,699,84150,540123,15,696825,79064,34,475,130000.0,43333.0,-71.0,-66.0,-71.0,-74.0,-71.0,-66.0,-71.0,-73.0,-89.0,-89.0,-87.0,-87.0,18.0,23.0,16.0,13.0,1
1627,CC:2F:71:3E:C5:1F,3833472,483480951,843,102929,3832629,483378022,0,3528,296085,2910,222717,618,73368,891,8,1213,18,0,37,130000.0,39000.0,-71.0,-71.0,-67.0,-60.0,-71.0,-70.0,-66.0,-60.0,-89.0,-89.0,-87.0,-87.0,18.0,18.0,20.0,27.0,1
1628,BA:8C:B9:54:50:24,3837440,489558003,4811,6179981,3832629,483378022,0,8794,1685625,8772,1682130,22,3495,2345,15,5235,39,0,56,216660.0,130000.0,-40.0,-37.0,-46.0,-51.0,-42.0,-35.0,-43.0,-47.0,-89.0,-89.0,-87.0,-87.0,49.0,52.0,41.0,36.0,1
1629,92:69:1D:31:68:E9,3836494,486984592,3860,3606104,3832634,483378488,0,4591,1078649,4456,1048159,135,30490,2077,10,4044,84,0,41,229410.0,130000.0,-53.0,-48.0,-44.0,-46.0,-52.0,-47.0,-43.0,-47.0,-89.0,-89.0,-87.0,-87.0,36.0,41.0,43.0,41.0,1
1630,CC:2F:71:3F:1F:24,4529249,1221330438,696615,737951950,3832634,483378488,37,558903,572492459,558203,572408191,700,84268,540144,15,696863,79070,34,475,144444.0,39000.0,-72.0,-66.0,-69.0,-73.0,-72.0,-66.0,-69.0,-73.0,-89.0,-89.0,-87.0,-87.0,17.0,23.0,18.0,14.0,1
1631,CC:2F:71:3E:C5:1F,3833478,483481477,843,102929,3832635,483378548,0,3528,296085,2910,222717,618,73368,891,8,1213,18,0,37,130000.0,39000.0,-71.0,-71.0,-67.0,-60.0,-71.0,-70.0,-66.0,-60.0,-89.0,-89.0,-87.0,-87.0,18.0,18.0,20.0,27.0,1
1632,BA:8C:B9:54:50:24,3837446,489558529,4811,6179981,3832635,483378548,0,8794,1685625,8772,1682130,22,3495,2345,15,5235,39,0,56,216660.0,130000.0,-40.0,-37.0,-46.0,-51.0,-42.0,-35.0,-43.0,-47.0,-89.0,-89.0,-87.0,-87.0,49.0,52.0,41.0,36.0,1
1633,92:69:1D:31:68:E9,3836499,486985056,3860,3606104,3832639,483378952,0,4592,1078717,4457,1048227,135,30490,2077,10,4044,84,0,41,229410.0,130000.0,-53.0,-48.0,-44.0,-46.0,-52.0,-47.0,-43.0,-46.0,-89.0,-89.0,-87.0,-87.0,36.0,41.0,43.0,41.0,1
1634,CC:2F:71:3F:1F:24,4529294,1221344982,696655,737966030,3832639,483378952,37,558926,572496501,558226,572412233,700,84268,540164,15,696903,79093,34,475,144444.0,43333.0,-72.0,-66.0,-70.0,-73.0,-72.0,-66.0,-70.0,-74.0,-89.0,-89.0,-87.0,-87.0,17.0,23.0,17.0,14.0,1
1635,CC:2F:71:3E:C5:1F,3833482,483481881,843,102929,3832639,483378952,0,3528,296085,2910,222717,618,73368,891,8,1213,18,0,37,130000.0,39000.0,-71.0,-71.0,-67.0,-60.0,-71.0,-70.0,-66.0,-60.0,-89.0,-89.0,-87.0,-87.0,18.0,18.0,20.0,27.0,1
1636,BA:8C:B9:54:50:24,3837450,489558933,4811,6179981,3832639,483378952,0,8794,1685625,8772,1682130,22,3495,2345,15,5235,39,0,56,216660.0,130000.0,-40.0,-37.0,-46.0,-51.0,-42.0,-35.0,-43.0,-47.0,-89.0,-89.0,-87.0,-87.0,49.0,52.0,41.0,36.0,1
1637,92:69:1D:31:68:E9,3836503,486985460,3860,3606104,3832643,483379356,0,4592,1078717,4457,1048227,135,30490,2077,10,4044,84,0,41,229410.0,130000.0,-53.0,-48.0,-44.0,-46.0,-52.0,-47.0,-43.0,-46.0,-89.0,-89.0,-87.0,-87.0,36.0,41.0,43.0,41.0,1
1638,CC:2F:71:3F:1F:24,4529336,1221359430,696693,737980074,3832643,483379356,37,558949,572500543,558249,572416275,700,84268,540184,15,696941,79105,34,475,144444.0,43333.0,-71.0,-66.0,-69.0,-71.0,-72.0,-66.0,-69.0,-72.0,-89.0,-89.0,-87.0,-87.0,18.0,23.0,18.0,16.0,1
1639,CC:2F:71:3E:C5:1F,3833486,483482285,843,102929,3832643,483379356,0,3528,296085,2910,222717,618,73368,891,8,1213,18,0,37,130000.0,39000.0,-71.0,-71.0,-67.0,-60.0,-71.0,-70.0,-66.0,-60.0,-89.0,-89.0,-87.0,-87.0,18.0,18.0,20.0,27.0,1
1640,BA:8C:B9:54:50:24,3837454,489559337,4811,6179981,3832643,483379356,0,8794,1685625,8772,1682130,22,3495,2345,15,5235,39,0,56,216660.0,130000.0,-40.0,-37.0,-46.0,-51.0,-42.0,-35.0,-43.0,-47.0,-89.0,-89.0,-87.0,-87.0,49.0,52.0,41.0,36.0,1
1641,92:69:1D:31:68:E9,3836508,486985924,3860,3606104,3832648,483379820,0,4592,1078717,4457,1048227,135,30490,2077,10,4044,84,0,41,229410.0,130000.0,-53.0,-48.0,-44.0,-46.0,-52.0,-47.0,-43.0,-46.0,-89.0,-89.0,-87.0,-87.0,36.0,41.0,43.0,41.0,1
1642,CC:2F:71:3F:1F:24,4529389,1221377801,696741,737997981,3832648,483379820,37,558982,572506126,558282,572421858,700,84268,540215,15,696989,79107,34,475,144444.0,43333.0,-73.0,-67.0,-68.0,-73.0,-73.0,-66.0,-68.0,-72.0,-89.0,-89.0,-87.0,-87.0,16.0,22.0,19.0,14.0,1
1643,CC:2F:71:3E:C5:1F,3833491,483482749,843,102929,3832648,483379820,0,3528,296085,2910,222717,618,73368,891,8,1213,18,0,37,130000.0,39000.0,-71.0,-71.0,-67.0,-60.0,-71.0,-70.0,-66.0,-60.0,-89.0,-89.0,-87.0,-87.0,18.0,18.0,20.0,27.0,1
1644,BA:8C:B9:54:50:24,3837459,489559801,4811,6179981,3832648,483379820,0,8794,1685625,8772,1682130,22,3495,2345,15,5235,39,0,56,216660.0,130000.0,-40.0,-37.0,-46.0,-51.0,-42.0,-35.0,-43.0,-47.0,-89.0,-89.0,-87.0,-87.0,49.0,52.0,41.0,36.0,1
1645,92:69:1D:31:68:E9,3836535,486997351,3860,3606104,3832675,483391247,0,4595,1079088,4459,1048363,136,30725,2078,10,4044,84,0,41,229410.0,130000.0,-52.0,-48.0,-44.0,-46.0,-52.0,-48.0,-43.0,-47.0,-89.0,-89.0,-87.0,-87.0,37.0,41.0,43.0,41.0,1
1646,CC:2F:71:3F:1F:24,4529455,1221403530,696780,738012283,3832675,483391247,37,559005,572510118,558305,572425850,700,84268,540236,15,697028,79107,34,475,144444.0,43333.0,-73.0,-67.0,-69.0,-73.0,-73.0,-67.0,-68.0,-72.0,-89.0,-89.0,-87.0,-87.0,16.0,22.0,18.0,14.0,1
1647,CC:2F:71:3E:C5:1F,3833518,483494176,843,102929,3832675,483391247,0,3528,296085,2910,222717,618,73368,891,8,1213,18,0,37,130000.0,39000.0,-71.0,-71.0,-67.0,-60.0,-71.0,-70.0,-66.0,-60.0,-89.0,-89.0,-87.0,-87.0,18.0,18.0,20.0,27.0,1
1648,BA:8C:B9:54:50:24,3837486,489571228,4811,6179981,3832675,483391247,0,8794,1685625,8772,1682130,22,3495,2345,15,5235,39,0,56,216660.0,130000.0,-40.0,-37.0,-46.0,-51.0,-42.0,-35.0,-43.0,-47.0,-89.0,-89.0,-87.0,-87.0,49.0,52.0,41.0,36.0,1
1649,92:69:1D:31:68:E9,3836539,486997755,3860,3606104,3832679,483391651,0,4595,1079088,4459,1048363,136,30725,2078,10,4044,84,0,41,229410.0,130000.0,-52.0,-48.0,-44.0,-46.0,-52.0,-48.0,-43.0,-47.0,-89.0,-89.0,-87.0,-87.0,37.0,41.0,43.0,41.0,1
1650,CC:2F:71:3F:1F:24,4529497,1221417978,696818,738026327,3832679,483391651,37,559026,572513852,558326,572429584,700,84268,540256,15,697066,79109,34,475,144444.0,43333.0,-73.0,-67.0,-69.0,-72.0,-72.0,-67.0,-69.0,-72.0,-89.0,-89.0,-87.0,-87.0,16.0,22.0,18.0,15.0,1
1651,CC:2F:71:3E:C5:1F,3833522,483494580,843,102929,3832679,483391651,0,3528,296085,2910,222717,618,73368,891,8,1213,18,0,37,130000.0,39000.0,-71.0,-71.0,-67.0,-60.0,-71.0,-70.0,-66.0,-60.0,-89.0,-89.0,-87.0,-87.0,18.0,18.0,20.0,27.0,1
1652,BA:8C:B9:54:50:24,3837490,489571632,4811,6179981,3832679,483391651,0,8794,1685625,8772,1682130,22,3495,2345,15,5235,39,0,56,216660.0,130000.0,-40.0,-37.0,-46.0,-51.0,-42.0,-35.0,-43.0,-47.0,-89.0,-89.0,-87.0,-87.0,49.0,52.0,41.0,36.0,1
1653,92:69:1D:31:68:E9,3836545,486998492,3860,3606104,3832685,483392388,0,4595,1079088,4459,1048363,136,30725,2078,10,4044,84,0,41,229410.0,130000.0,-52.0,-48.0,-44.0,-46.0,-52.0,-48.0,-43.0,-47.0,-89.0,-89.0,-87.0,-87.0,37.0,41.0,43.0,41.0,1
1654,CC:2F:71:3F:1F:24,4529601,1221483603,696916,738091215,3832685,483392388,37,559092,572526889,558392,572442621,700,84268,540316,15,697164,79120,34,476,144444.0,43333.0,-73.0,-67.0,-69.0,-73.0,-72.0,-67.0,-68.0,-72.0,-89.0,-89.0,-87.0,-87.0,16.0,22.0,18.0,14.0,1
1655,CC:2F:71:3E:C5:1F,3833528,483495317,843,102929,3832685,483392388,0,3528,296085,2910,222717,618,73368,891,8,1213,18,0,37,130000.0,39000.0,-71.0,-71.0,-67.0,-60.0,-71.0,-70.0,-66.0,-60.0,-89.0,-89.0,-87.0,-87.0,18.0,18.0,20.0,27.0,1
1656,BA:8C:B9:54:50:24,3837496,489572369,4811,6179981,3832685,483392388,0,8794,1685625,8772,1682130,22,3495,2345,15,5235,39,0,56,216660.0,130000.0,-40.0,-37.0,-46.0,-51.0,-42.0,-35.0,-43.0,-47.0,-89.0,-89.0,-87.0,-87.0,49.0,52.0,41.0,36.0,1
1657,92:69:1D:31:68:E9,3836549,486998896,3860,3606104,3832689,483392792,0,4595,1079088,4459,1048363,136,30725,2078,10,4044,84,0,41,229410.0,130000.0,-52.0,-48.0,-44.0,-46.0,-52.0,-48.0,-43.0,-47.0,-89.0,-89.0,-87.0,-87.0,37.0,41.0,43.0,41.0,1
1658,CC:2F:71:3F:1F:24,4529662,1221506521,696973,738113729,3832689,483392792,37,559132,572533920,558432,572449652,700,84268,540354,15,697221,79121,34,476,144444.0,43333.0,-73.0,-67.0,-69.0,-72.0,-73.0,-66.0,-69.0,-72.0,-89.0,-89.0,-87.0,-87.0,16.0,22.0,18.0,15.0,1
1659,CC:2F:71:3E:C5:1F,3833532,483495721,843,102929,3832689,483392792,0,3528,296085,2910,222717,618,73368,891,8,1213,18,0,37,130000.0,39000.0,-71.0,-71.0,-67.0,-60.0,-71.0,-70.0,-66.0,-60.0,-89.0,-89.0,-87.0,-87.0,18.0,18.0,20.0,27.0,1
1660,BA:8C:B9:54:50:24,3837500,489572773,4811,6179981,3832689,483392792,0,8794,1685625,8772,1682130,22,3495,2345,15,5235,39,0,56,216660.0,130000.0,-40.0,-37.0,-46.0,-51.0,-42.0,-35.0,-43.0,-47.0,-89.0,-89.0,-87.0,-87.0,49.0,52.0,41.0,36.0,1
1661,92:69:1D:31:68:E9,3836553,486999300,3860,3606104,3832693,483393196,0,4595,1079088,4459,1048363,136,30725,2078,10,4044,84,0,41,229410.0,130000.0,-52.0,-48.0,-44.0,-46.0,-52.0,-48.0,-43.0,-47.0,-89.0,-89.0,-87.0,-87.0,37.0,41.0,43.0,41.0,1
1662,CC:2F:71:3F:1F:24,4529708,1221521465,697014,738128209,3832694,483393256,37,559157,572538164,558457,572453896,700,84268,540378,15,697262,79121,34,476,144444.0,43333.0,-73.0,-67.0,-68.0,-73.0,-72.0,-67.0,-68.0,-73.0,-89.0,-89.0,-87.0,-87.0,16.0,22.0,19.0,14.0,1
1663,CC:2F:71:3E:C5:1F,3833537,483496185,843,102929,3832694,483393256,0,3528,296085,2910,222717,618,73368,891,8,1213,18,0,37,130000.0,39000.0,-71.0,-71.0,-67.0,-60.0,-71.0,-70.0,-66.0,-60.0,-89.0,-89.0,-87.0,-87.0,18.0,18.0,20.0,27.0,1
1664,BA:8C:B9:54:50:24,3837505,489573237,4811,6179981,3832694,483393256,0,8794,1685625,8772,1682130,22,3495,2345,15,5235,39,0,56,216660.0,130000.0,-40.0,-37.0,-46.0,-51.0,-42.0,-35.0,-43.0,-47.0,-89.0,-89.0,-87.0,-87.0,49.0,52.0,41.0,36.0,1
1665,92:69:1D:31:68:E9,3836560,487000132,3860,3606104,3832700,483394028,0,4595,1079088,4459,1048363,136,30725,2078,10,4044,84,0,41,229410.0,130000.0,-52.0,-48.0,-44.0,-46.0,-52.0,-48.0,-43.0,-47.0,-89.0,-89.0,-87.0,-87.0,37.0,41.0,43.0,41.0,1
1666,CC:2F:71:3F:1F:24,4529752,1221536281,697052,738142253,3832700,483394028,37,559180,572542254,558480,572457986,700,84268,540398,15,697300,79123,34,476,144444.0,43333.0,-73.0,-67.0,-69.0,-73.0,-73.0,-67.0,-69.0,-73.0,-89.0,-89.0,-87.0,-87.0,16.0,22.0,18.0,14.0,1
1667,CC:2F:71:3E:C5:1F,3833543,483496957,843,102929,3832700,483394028,0,3528,296085,2910,222717,618,73368,891,8,1213,18,0,37,130000.0,39000.0,-71.0,-71.0,-67.0,-60.0,-71.0,-70.0,-66.0,-60.0,-89.0,-89.0,-87.0,-87.0,18.0,18.0,20.0,27.0,1
1668,BA:8C:B9:54:50:24,3837511,489574009,4811,6179981,3832700,483394028,0,8794,1685625,8772,1682130,22,3495,2345,15,5235,39,0,56,216660.0,130000.0,-40.0,-37.0,-46.0,-51.0,-42.0,-35.0,-43.0,-47.0,-89.0,-89.0,-87.0,-87.0,49.0,52.0,41.0,36.0,1
1669,92:69:1D:31:68:E9,3836564,487000536,3860,3606104,3832704,483394432,0,4595,1079088,4459,1048363,136,30725,2078,10,4044,84,0,41,229410.0,130000.0,-52.0,-48.0,-44.0,-46.0,-52.0,-48.0,-43.0,-47.0,-89.0,-89.0,-87.0,-87.0,37.0,41.0,43.0,41.0,1
1670,CC:2F:71:3F:1F:24,4529794,1221550729,697090,738156297,3832704,483394432,37,559201,572545988,558501,572461720,700,84268,540418,15,697338,79124,34,476,144444.0,43333.0,-73.0,-67.0,-69.0,-73.0,-73.0,-67.0,-68.0,-72.0,-89.0,-89.0,-87.0,-87.0,16.0,22.0,18.0,14.0,1
1671,CC:2F:71:3E:C5:1F,3833547,483497361,843,102929,3832704,483394432,0,3528,296085,2910,222717,618,73368,891,8,1213,18,0,37,130000.0,39000.0,-71.0,-71.0,-67.0,-60.0,-71.0,-70.0,-66.0,-60.0,-89.0,-89.0,-87.0,-87.0,18.0,18.0,20.0,27.0,1
1672,BA:8C:B9:54:50:24,3837515,489574413,4811,6179981,3832704,483394432,0,8794,1685625,8772,1682130,22,3495,2345,15,5235,39,0,56,216660.0,130000.0,-40.0,-37.0,-46.0,-51.0,-42.0,-35.0,-43.0,-47.0,-89.0,-89.0,-87.0,-87.0,49.0,52.0,41.0,36.0,1
1673,92:69:1D:31:68:E9,3836569,487001000,3860,3606104,3832709,483394896,0,4595,1079088,4459,1048363,136,30725,2078,10,4044,84,0,41,229410.0,130000.0,-52.0,-48.0,-44.0,-46.0,-52.0,-48.0,-43.0,-47.0,-89.0,-89.0,-87.0,-87.0,37.0,41.0,43.0,41.0,1
1674,CC:2F:71:3F:1F:24,4529839,1221565497,697130,738170601,3832709,483394896,37,559226,572550186,558526,572465918,700,84268,540442,15,697378,79126,34,476,144444.0,43333.0,-73.0,-67.0,-69.0,-72.0,-73.0,-67.0,-69.0,-72.0,-89.0,-89.0,-87.0,-87.0,16.0,22.0,18.0,15.0,1
1675,CC:2F:71:3E:C5:1F,3833552,483497825,843,102929,3832709,483394896,0,3528,296085,2910,222717,618,73368,891,8,1213,18,0,37,130000.0,39000.0,-71.0,-71.0,-67.0,-60.0,-71.0,-70.0,-66.0,-60.0,-89.0,-89.0,-87.0,-87.0,18.0,18.0,20.0,27.0,1
1676,BA:8C:B9:54:50:24,3837520,489574877,4811,6179981,3832709,483394896,0,8794,1685625,8772,1682130,22,3495,2345,15,5235,39,0,56,216660.0,130000.0,-40.0,-37.0,-46.0,-51.0,-42.0,-35.0,-43.0,-47.0,-89.0,-89.0,-87.0,-87.0,49.0,52.0,41.0,36.0,1
1677,92:69:1D:31:68:E9,3836573,487001404,3860,3606104,3832713,483395300,0,4595,1079088,4459,1048363,136,30725,2078,10,4044,84,0,41,229410.0,130000.0,-52.0,-48.0,-44.0,-46.0,-52.0,-48.0,-43.0,-47.0,-89.0,-89.0,-87.0,-87.0,37.0,41.0,43.0,41.0,1
1678,CC:2F:71:3F:1F:24,4529893,1221584646,697180,738189346,3832713,483395300,37,559259,572556079,558559,572471811,700,84268,540473,15,697428,79128,34,476,144444.0,43333.0,-71.0,-65.0,-70.0,-72.0,-72.0,-65.0,-70.0,-71.0,-89.0,-89.0,-87.0,-87.0,18.0,24.0,17.0,15.0,1
1679,CC:2F:71:3E:C5:1F,3833556,483498229,843,102929,3832713,483395300,0,3528,296085,2910,222717,618,73368,891,8,1213,18,0,37,130000.0,39000.0,-71.0,-71.0,-67.0,-60.0,-71.0,-70.0,-66.0,-60.0,-89.0,-89.0,-87.0,-87.0,18.0,18.0,20.0,27.0,1
1680,BA:8C:B9:54:50:24,3837524,489575281,4811,6179981,3832713,483395300,0,8794,1685625,8772,1682130,22,3495,2345,15,5235,39,0,56,216660.0,130000.0,-40.0,-37.0,-46.0,-51.0,-42.0,-35.0,-43.0,-47.0,-89.0,-89.0,-87.0,-87.0,49.0,52.0,41.0,36.0,1
1681,92:69:1D:31:68:E9,3836577,487001808,3860,3606104,3832717,483395704,0,4595,1079088,4459,1048363,136,30725,2078,10,4044,84,0,41,229410.0,130000.0,-52.0,-48.0,-44.0,-46.0,-52.0,-48.0,-43.0,-47.0,-89.0,-89.0,-87.0,-87.0,37.0,41.0,43.0,41.0,1
1682,CC:2F:71:3F:1F:24,4529936,1221599224,697219,738203520,3832717,483395704,37,559282,572560187,558582,572475919,700,84268,540494,15,697467,79139,34,476,144444.0,43333.0,-71.0,-66.0,-70.0,-72.0,-70.0,-66.0,-70.0,-71.0,-89.0,-89.0,-87.0,-87.0,18.0,23.0,17.0,15.0,1
1683,CC:2F:71:3E:C5:1F,3833560,483498633,843,102929,3832717,483395704,0,3528,296085,2910,222717,618,73368,891,8,1213,18,0,37,130000.0,39000.0,-71.0,-71.0,-67.0,-60.0,-71.0,-70.0,-66.0,-60.0,-89.0,-89.0,-87.0,-87.0,18.0,18.0,20.0,27.0,1
1684,BA:8C:B9:54:50:24,3837528,489575685,4811,6179981,3832717,483395704,0,8794,1685625,8772,1682130,22,3495,2345,15,5235,39,0,56,216660.0,130000.0,-40.0,-37.0,-46.0,-51.0,-42.0,-35.0,-43.0,-47.0,-89.0,-89.0,-87.0,-87.0,49.0,52.0,41.0,36.0,1
1685,92:69:1D:31:68:E9,3836582,487002272,3860,3606104,3832722,483396168,0,4595,1079088,4459,1048363,136,30725,2078,10,4044,84,0,41,229410.0,130000.0,-52.0,-48.0,-44.0,-46.0,-52.0,-48.0,-43.0,-47.0,-89.0,-89.0,-87.0,-87.0,37.0,41.0,43.0,41.0,1
1686,CC:2F:71:3F:1F:24,4529980,1221613862,697258,738217694,3832722,483396168,37,559309,572564617,558609,572480349,700,84268,540520,15,697506,79139,34,476,144444.0,43333.0,-70.0,-66.0,-70.0,-72.0,-70.0,-66.0,-70.0,-72.0,-89.0,-89.0,-87.0,-87.0,19.0,23.0,17.0,15.0,1
1687,CC:2F:71:3E:C5:1F,3833565,483499097,843,102929,3832722,483396168,0,3528,296085,2910,222717,618,73368,891,8,1213,18,0,37,130000.0,39000.0,-71.0,-71.0,-67.0,-60.0,-71.0,-70.0,-66.0,-60.0,-89.0,-89.0,-87.0,-87.0,18.0,18.0,20.0,27.0,1
1688,BA:8C:B9:54:50:24,3837533,489576149,4811,6179981,3832722,483396168,0,8794,1685625,8772,1682130,22,3495,2345,15,5235,39,0,56,216660.0,130000.0,-40.0,-37.0,-46.0,-51.0,-42.0,-35.0,-43.0,-47.0,-89.0,-89.0,-87.0,-87.0,49.0,52.0,41.0,36.0,1
1689,92:69:1D:31:68:E9,3836586,487002676,3860,3606104,3832726,483396572,0,4595,1079088,4459,1048363,136,30725,2078,10,4044,84,0,41,229410.0,130000.0,-52.0,-48.0,-44.0,-46.0,-52.0,-48.0,-43.0,-47.0,-89.0,-89.0,-87.0,-87.0,37.0,41.0,43.0,41.0,1
1690,CC:2F:71:3F:1F:24,4530024,1221628698,697298,738232126,3832726,483396572,37,559335,572568943,558635,572484675,700,84268,540545,15,697546,79139,34,476,144444.0,43333.0,-70.0,-67.0,-70.0,-72.0,-70.0,-67.0,-70.0,-72.0,-89.0,-89.0,-87.0,-87.0,19.0,22.0,17.0,15.0,1
1691,CC:2F:71:3E:C5:1F,3833569,483499501,843,102929,3832726,483396572,0,3528,296085,2910,222717,618,73368,891,8,1213,18,0,37,130000.0,39000.0,-71.0,-71.0,-67.0,-60.0,-71.0,-70.0,-66.0,-60.0,-89.0,-89.0,-87.0,-87.0,18.0,18.0,20.0,27.0,1
1692,BA:8C:B9:54:50:24,3837537,489576553,4811,6179981,3832726,483396572,0,8794,1685625,8772,1682130,22,3495,2345,15,5235,39,0,56,216660.0,130000.0,-40.0,-37.0,-46.0,-51.0,-42.0,-35.0,-43.0,-47.0,-89.0,-89.0,-87.0,-87.0,49.0,52.0,41.0,36.0,1
1693,92:69:1D:31:68:E9,3836591,487003140,3860,3606104,3832731,483397036,0,4595,1079088,4459,1048363,136,30725,2078,10,4044,84,0,41,229410.0,130000.0,-52.0,-48.0,-44.0,-46.0,-52.0,-48.0,-43.0,-47.0,-89.0,-89.0,-87.0,-87.0,37.0,41.0,43.0,41.0,1
1694,CC:2F:71:3F:1F:24,4530075,1221646809,697344,738249773,3832731,483397036,37,559367,572574506,558667,572490238,700,84268,540575,15,697592,79139,34,476,144444.0,43333.0,-70.0,-67.0,-70.0,-72.0,-70.0,-67.0,-70.0,-72.0,-89.0,-89.0,-87.0,-87.0,19.0,22.0,17.0,15.0,1
1695,CC:2F:71:3E:C5:1F,3833574,483499965,843,102929,3832731,483397036,0,3528,296085,2910,222717,618,73368,891,8,1213,18,0,37,130000.0,39000.0,-71.0,-71.0,-67.0,-60.0,-71.0,-70.0,-66.0,-60.0,-89.0,-89.0,-87.0,-87.0,18.0,18.0,20.0,27.0,1
1696,BA:8C:B9:54:50:24,3837542,489577017,4811,6179981,3832731,483397036,0,8794,1685625,8772,1682130,22,3495,2345,15,5235,39,0,56,216660.0,130000.0,-40.0,-37.0,-46.0,-51.0,-42.0,-35.0,-43.0,-47.0,-89.0,-89.0,-87.0,-87.0,49.0,52.0,41.0,36.0,1
1697,92:69:1D:31:68:E9,3836596,487003660,3861,3606220,3832735,483397440,0,4596,1079156,4460,1048431,136,30725,2078,10,4045,84,0,41,229410.0,137640.0,-52.0,-48.0,-44.0,-47.0,-52.0,-48.0,-43.0,-47.0,-89.0,-89.0,-87.0,-87.0,37.0,41.0,43.0,40.0,1
1698,CC:2F:71:3F:1F:24,4530119,1221661503,697384,738264063,3832735,483397440,37,559389,572578310,558689,572494042,700,84268,540595,15,697632,79139,34,476,144444.0,43333.0,-71.0,-67.0,-70.0,-72.0,-70.0,-66.0,-70.0,-72.0,-89.0,-89.0,-87.0,-87.0,18.0,22.0,17.0,15.0,1
1699,CC:2F:71:3E:C5:1F,3833583,483501142,848,103702,3832735,483397440,0,3535,297042,2917,223674,618,73368,897,8,1218,19,0,37,130000.0,39000.0,-72.0,-70.0,-67.0,-60.0,-71.0,-70.0,-67.0,-60.0,-89.0,-89.0,-87.0,-87.0,17.0,19.0,20.0,27.0,1
1700,BA:8C:B9:54:50:24,3837547,489577537,4812,6180097,3832735,483397440,0,8800,1686033,8778,1682538,22,3495,2345,15,5236,39,0,56,216660.0,130000.0,-49.0,-35.0,-43.0,-45.0,-41.0,-35.0,-43.0,-47.0,-89.0,-89.0,-87.0,-87.0,40.0,54.0,44.0,42.0,1
1701,92:69:1D:31:68:E9,3836600,487004064,3861,3606220,3832739,483397844,0,4597,1079224,4461,1048499,136,30725,2078,10,4045,84,0,41,229410.0,137640.0,-52.0,-48.0,-44.0,-47.0,-52.0,-48.0,-44.0,-47.0,-89.0,-89.0,-87.0,-87.0,37.0,41.0,43.0,40.0,1
1702,CC:2F:71:3F:1F:24,4530161,1221675951,697422,738278107,3832739,483397844,37,559414,572582678,558714,572498410,700,84268,540616,15,697670,79139,34,476,144444.0,43333.0,-70.0,-67.0,-70.0,-72.0,-70.0,-67.0,-70.0,-72.0,-89.0,-89.0,-87.0,-87.0,19.0,22.0,17.0,15.0,1
1703,CC:2F:71:3E:C5:1F,3833587,483501546,848,103702,3832739,483397844,0,3535,297042,2917,223674,618,73368,897,8,1218,19,0,37,130000.0,39000.0,-72.0,-70.0,-67.0,-60.0,-71.0,-70.0,-67.0,-60.0,-89.0,-89.0,-87.0,-87.0,17.0,19.0,20.0,27.0,1
1704,BA:8C:B9:54:50:24,3837551,489577941,4812,6180097,3832739,483397844,0,8800,1686033,8778,1682538,22,3495,2345,15,5236,39,0,56,216660.0,130000.0,-49.0,-35.0,-43.0,-45.0,-41.0,-35.0,-43.0,-47.0,-89.0,-89.0,-87.0,-87.0,40.0,54.0,44.0,42.0,1
1705,92:69:1D:31:68:E9,3836606,487004801,3861,3606220,3832745,483398581,0,4597,1079224,4461,1048499,136,30725,2078,10,4045,84,0,41,229410.0,137640.0,-52.0,-48.0,-44.0,-47.0,-52.0,-48.0,-44.0,-47.0,-89.0,-89.0,-87.0,-87.0,37.0,41.0,43.0,40.0,1
1706,CC:2F:71:3F:1F:24,4530205,1221690732,697460,738292151,3832745,483398581,37,559438,572586774,558738,572502506,700,84268,540638,15,697708,79139,34,476,144444.0,43333.0,-70.0,-67.0,-70.0,-72.0,-70.0,-67.0,-70.0,-72.0,-89.0,-89.0,-87.0,-87.0,19.0,22.0,17.0,15.0,1
1707,CC:2F:71:3E:C5:1F,3833593,483502283,848,103702,3832745,483398581,0,3535,297042,2917,223674,618,73368,897,8,1218,19,0,37,130000.0,39000.0,-72.0,-70.0,-67.0,-60.0,-71.0,-70.0,-67.0,-60.0,-89.0,-89.0,-87.0,-87.0,17.0,19.0,20.0,27.0,1
1708,BA:8C:B9:54:50:24,3837557,489578678,4812,6180097,3832745,483398581,0,8801,1686101,8779,1682606,22,3495,2345,15,5236,39,0,56,216660.0,130000.0,-48.0,-35.0,-43.0,-45.0,-42.0,-34.0,-43.0,-47.0,-89.0,-89.0,-87.0,-87.0,41.0,54.0,44.0,42.0,1
1709,92:69:1D:31:68:E9,3836610,487005205,3861,3606220,3832749,483398985,0,4597,1079224,4461,1048499,136,30725,2078,10,4045,84,0,41,229410.0,137640.0,-52.0,-48.0,-44.0,-47.0,-52.0,-48.0,-44.0,-47.0,-89.0,-89.0,-87.0,-87.0,37.0,41.0,43.0,40.0,1
1710,CC:2F:71:3F:1F:24,4530265,1221711895,697516,738312910,3832749,483398985,37,559478,572593902,558778,572509634,700,84268,540677,15,697764,79139,34,476,144444.0,43333.0,-71.0,-66.0,-69.0,-73.0,-71.0,-66.0,-69.0,-73.0,-89.0,-89.0,-87.0,-87.0,18.0,23.0,18.0,14.0,1
1711,CC:2F:71:3E:C5:1F,3833597,483502687,848,103702,3832749,483398985,0,3535,297042,2917,223674,618,73368,897,8,1218,19,0,37,130000.0,39000.0,-72.0,-70.0,-67.0,-60.0,-71.0,-70.0,-67.0,-60.0,-89.0,-89.0,-87.0,-87.0,17.0,19.0,20.0,27.0,1
1712,BA:8C:B9:54:50:24,3837561,489579082,4812,6180097,3832749,483398985,0,8801,1686101,8779,1682606,22,3495,2345,15,5236,39,0,56,216660.0,130000.0,-48.0,-35.0,-43.0,-45.0,-42.0,-34.0,-43.0,-47.0,-89.0,-89.0,-87.0,-87.0,41.0,54.0,44.0,42.0,1
1713,92:69:1D:31:68:E9,3836614,487005609,3861,3606220,3832753,483399389,0,4597,1079224,4461,1048499,136,30725,2078,10,4045,84,0,41,229410.0,137640.0,-52.0,-48.0,-44.0,-47.0,-52.0,-48.0,-44.0,-47.0,-89.0,-89.0,-87.0,-87.0,37.0,41.0,43.0,40.0,1
1714,CC:2F:71:3F:1F:24,4530307,1221726287,697554,738326898,3832753,483399389,37,559502,572597984,558802,572513716,700,84268,540700,15,697802,79141,34,476,130000.0,39000.0,-71.0,-66.0,-70.0,-73.0,-71.0,-66.0,-70.0,-73.0,-89.0,-89.0,-87.0,-87.0,18.0,23.0,17.0,14.0,1
1715,CC:2F:71:3E:C5:1F,3833601,483503091,848,103702,3832753,483399389,0,3535,297042,2917,223674,618,73368,897,8,1218,19,0,37,130000.0,39000.0,-72.0,-70.0,-67.0,-60.0,-71.0,-70.0,-67.0,-60.0,-89.0,-89.0,-87.0,-87.0,17.0,19.0,20.0,27.0,1
1716,BA:8C:B9:54:50:24,3837565,489579486,4812,6180097,3832753,483399389,0,8801,1686101,8779,1682606,22,3495,2345,15,5236,39,0,56,216660.0,130000.0,-48.0,-35.0,-43.0,-45.0,-42.0,-34.0,-43.0,-47.0,-89.0,-89.0,-87.0,-87.0,41.0,54.0,44.0,42.0,1
1717,92:69:1D:31:68:E9,3836619,487006073,3861,3606220,3832758,483399853,0,4597,1079224,4461,1048499,136,30725,2078,10,4045,84,0,41,229410.0,137640.0,-52.0,-48.0,-44.0,-47.0,-52.0,-48.0,-44.0,-47.0,-89.0,-89.0,-87.0,-87.0,37.0,41.0,43.0,40.0,1
1718,CC:2F:71:3F:1F:24,4530350,1221740811,697592,738340958,3832758,483399853,37,559527,572602398,558827,572518130,700,84268,540722,15,697840,79141,34,476,144444.0,43333.0,-71.0,-66.0,-70.0,-73.0,-71.0,-66.0,-69.0,-72.0,-89.0,-89.0,-87.0,-87.0,18.0,23.0,17.0,14.0,1
1719,CC:2F:71:3E:C5:1F,3833606,483503555,848,103702,3832758,483399853,0,3535,297042,2917,223674,618,73368,897,8,1218,19,0,37,130000.0,39000.0,-72.0,-70.0,-67.0,-60.0,-71.0,-70.0,-67.0,-60.0,-89.0,-89.0,-87.0,-87.0,17.0,19.0,20.0,27.0,1
1720,BA:8C:B9:54:50:24,3837570,489579950,4812,6180097,3832758,483399853,0,8801,1686101,8779,1682606,22,3495,2345,15,5236,39,0,56,216660.0,130000.0,-48.0,-35.0,-43.0,-45.0,-42.0,-34.0,-43.0,-47.0,-89.0,-89.0,-87.0,-87.0,41.0,54.0,44.0,42.0,1
1721,92:69:1D:31:68:E9,3836621,487006275,3861,3606220,3832760,483400055,0,4597,1079224,4461,1048499,136,30725,2078,10,4045,84,0,41,229410.0,137640.0,-52.0,-48.0,-44.0,-47.0,-52.0,-48.0,-44.0,-47.0,-89.0,-89.0,-87.0,-87.0,37.0,41.0,43.0,40.0,1
1722,CC:2F:71:3F:1F:24,4530390,1221755057,697630,738355002,3832760,483400055,37,559549,572606248,558849,572521980,700,84268,540743,15,697878,79141,34,476,144444.0,43333.0,-71.0,-66.0,-70.0,-72.0,-71.0,-66.0,-69.0,-72.0,-89.0,-89.0,-87.0,-87.0,18.0,23.0,17.0,15.0,1
1723,CC:2F:71:3E:C5:1F,3833610,483503959,848,103702,3832762,483400257,0,3535,297042,2917,223674,618,73368,897,8,1218,19,0,37,130000.0,39000.0,-72.0,-70.0,-67.0,-60.0,-71.0,-70.0,-67.0,-60.0,-89.0,-89.0,-87.0,-87.0,17.0,19.0,20.0,27.0,1
1724,BA:8C:B9:54:50:24,3837574,489580354,4812,6180097,3832762,483400257,0,8801,1686101,8779,1682606,22,3495,2345,15,5236,39,0,56,216660.0,130000.0,-48.0,-35.0,-43.0,-45.0,-42.0,-34.0,-43.0,-47.0,-89.0,-89.0,-87.0,-87.0,41.0,54.0,44.0,42.0,1
1725,92:69:1D:31:68:E9,3836626,487006739,3861,3606220,3832765,483400519,0,4597,1079224,4461,1048499,136,30725,2078,10,4045,84,0,41,229410.0,137640.0,-52.0,-48.0,-44.0,-47.0,-52.0,-48.0,-44.0,-47.0,-89.0,-89.0,-87.0,-87.0,37.0,41.0,43.0,40.0,1
1726,CC:2F:71:3F:1F:24,4530445,1221773630,697678,738372909,3832767,483400721,37,559582,572612059,558882,572527791,700,84268,540772,15,697926,79141,34,476,144444.0,43333.0,-71.0,-66.0,-70.0,-73.0,-71.0,-66.0,-69.0,-72.0,-89.0,-89.0,-87.0,-87.0,18.0,23.0,17.0,14.0,1
1727,CC:2F:71:3E:C5:1F,3833617,483504655,850,103934,3832767,483400721,0,3540,297464,2922,224096,618,73368,899,8,1220,19,0,37,130000.0,39000.0,-72.0,-70.0,-67.0,-60.0,-71.0,-70.0,-66.0,-60.0,-89.0,-89.0,-87.0,-87.0,17.0,19.0,20.0,27.0,1
1728,BA:8C:B9:54:50:24,3837579,489580818,4812,6180097,3832767,483400721,0,8801,1686101,8779,1682606,22,3495,2345,15,5236,39,0,56,216660.0,130000.0,-48.0,-35.0,-43.0,-45.0,-42.0,-34.0,-43.0,-47.0,-89.0,-89.0,-87.0,-87.0,41.0,54.0,44.0,42.0,1
1729,92:69:1D:31:68:E9,3836630,487007143,3861,3606220,3832769,483400923,0,4597,1079224,4461,1048499,136,30725,2078,10,4045,84,0,41,229410.0,137640.0,-52.0,-48.0,-44.0,-47.0,-52.0,-48.0,-44.0,-47.0,-89.0,-89.0,-87.0,-87.0,37.0,41.0,43.0,40.0,1
1730,CC:2F:71:3F:1F:24,4530484,1221787746,697715,738386823,3832769,483400923,37,559604,572615909,558904,572531641,700,84268,540793,15,697963,79141,34,476,144444.0,43333.0,-71.0,-66.0,-70.0,-73.0,-71.0,-66.0,-69.0,-73.0,-89.0,-89.0,-87.0,-87.0,18.0,23.0,17.0,14.0,1
1731,CC:2F:71:3E:C5:1F,3833621,483505059,850,103934,3832771,483401125,0,3540,297464,2922,224096,618,73368,899,8,1220,19,0,37,130000.0,39000.0,-72.0,-70.0,-67.0,-60.0,-71.0,-70.0,-66.0,-60.0,-89.0,-89.0,-87.0,-87.0,17.0,19.0,20.0,27.0,1
1732,BA:8C:B9:54:50:24,3837583,489581222,4812,6180097,3832771,483401125,0,8801,1686101,8779,1682606,22,3495,2345,15,5236,39,0,56,216660.0,130000.0,-48.0,-35.0,-43.0,-45.0,-42.0,-34.0,-43.0,-47.0,-89.0,-89.0,-87.0,-87.0,41.0,54.0,44.0,42.0,1
1733,92:69:1D:31:68:E9,3836634,487007547,3861,3606220,3832773,483401327,0,4599,1079360,4463,1048635,136,30725,2078,10,4046,84,0,41,229410.0,137640.0,-52.0,-48.0,-44.0,-47.0,-52.0,-48.0,-44.0,-47.0,-89.0,-89.0,-87.0,-87.0,37.0,41.0,43.0,40.0,1
1734,CC:2F:71:3F:1F:24,4530528,1221802396,697753,738400867,3832775,483401529,37,559625,572619643,558925,572535375,700,84268,540813,15,698001,79141,34,476,144444.0,43333.0,-71.0,-66.0,-69.0,-73.0,-71.0,-66.0,-69.0,-73.0,-89.0,-89.0,-87.0,-87.0,18.0,23.0,18.0,14.0,1
1735,CC:2F:71:3E:C5:1F,3833625,483505463,850,103934,3832775,483401529,0,3540,297464,2922,224096,618,73368,899,8,1220,19,0,37,130000.0,39000.0,-72.0,-70.0,-67.0,-60.0,-71.0,-70.0,-66.0,-60.0,-89.0,-89.0,-87.0,-87.0,17.0,19.0,20.0,27.0,1
1736,BA:8C:B9:54:50:24,3837587,489581626,4812,6180097,3832775,483401529,0,8803,1686237,8781,1682742,22,3495,2345,15,5237,39,0,56,216660.0,130000.0,-48.0,-35.0,-43.0,-45.0,-43.0,-34.0,-42.0,-46.0,-89.0,-89.0,-87.0,-87.0,41.0,54.0,44.0,42.0,1
1737,92:69:1D:31:68:E9,3836640,487008073,3861,3606220,3832779,483401853,0,4599,1079360,4463,1048635,136,30725,2078,10,4046,84,0,41,229410.0,137640.0,-52.0,-48.0,-44.0,-47.0,-52.0,-48.0,-44.0,-47.0,-89.0,-89.0,-87.0,-87.0,37.0,41.0,43.0,40.0,1
1738,CC:2F:71:3F:1F:24,4530570,1221816764,697791,738414911,3832779,483401853,37,559648,572623565,558947,572539179,701,84386,540834,15,698039,79141,34,476,144444.0,43333.0,-71.0,-66.0,-70.0,-72.0,-71.0,-66.0,-69.0,-72.0,-89.0,-89.0,-87.0,-87.0,18.0,23.0,17.0,15.0,1
1739,CC:2F:71:3E:C5:1F,3833631,483505989,850,103934,3832781,483402055,0,3540,297464,2922,224096,618,73368,899,8,1220,19,0,37,130000.0,39000.0,-72.0,-70.0,-67.0,-60.0,-71.0,-70.0,-66.0,-60.0,-89.0,-89.0,-87.0,-87.0,17.0,19.0,20.0,27.0,1
1740,BA:8C:B9:54:50:24,3837593,489582152,4812,6180097,3832781,483402055,0,8805,1686373,8783,1682878,22,3495,2345,15,5237,39,0,56,216660.0,130000.0,-41.0,-38.0,-47.0,-51.0,-43.0,-35.0,-43.0,-47.0,-89.0,-89.0,-87.0,-87.0,48.0,51.0,40.0,36.0,1
1741,92:69:1D:31:68:E9,3836645,487008539,3861,3606220,3832784,483402319,0,4599,1079360,4463,1048635,136,30725,2078,10,4046,84,0,41,229410.0,137640.0,-52.0,-48.0,-44.0,-47.0,-52.0,-48.0,-44.0,-47.0,-89.0,-89.0,-87.0,-87.0,37.0,41.0,43.0,40.0,1
1742,CC:2F:71:3F:1F:24,4530621,1221834881,697836,738432428,3832785,483402453,37,559676,572628602,558975,572544216,701,84386,540861,15,698084,79141,34,476,144444.0,43333.0,-71.0,-66.0,-69.0,-73.0,-71.0,-66.0,-69.0,-73.0,-89.0,-89.0,-87.0,-87.0,18.0,23.0,18.0,14.0,1
1743,CC:2F:71:3E:C5:1F,3833635,483506387,850,103934,3832785,483402453,0,3542,297652,2923,224166,619,73486,900,8,1220,19,0,37,130000.0,39000.0,-72.0,-70.0,-67.0,-60.0,-71.0,-70.0,-66.0,-60.0,-89.0,-89.0,-87.0,-87.0,17.0,19.0,20.0,27.0,1
1744,BA:8C:B9:54:50:24,3837598,489582618,4812,6180097,3832786,483402521,0,8807,1686509,8785,1683014,22,3495,2345,15,5237,39,0,56,216660.0,130000.0,-41.0,-38.0,-47.0,-51.0,-45.0,-36.0,-44.0,-47.0,-89.0,-89.0,-87.0,-87.0,48.0,51.0,40.0,36.0,1
1745,92:69:1D:31:68:E9,3836649,487008943,3861,3606220,3832788,483402723,0,4599,1079360,4463,1048635,136,30725,2078,10,4046,84,0,41,229410.0,137640.0,-52.0,-48.0,-44.0,-47.0,-52.0,-48.0,-44.0,-47.0,-89.0,-89.0,-87.0,-87.0,37.0,41.0,43.0,40.0,1
1746,CC:2F:71:3F:1F:24,4530662,1221849195,697874,738446472,3832788,483402723,37,559697,572632336,558996,572547950,701,84386,540881,15,698122,79141,34,476,144444.0,43333.0,-71.0,-66.0,-69.0,-73.0,-71.0,-66.0,-69.0,-72.0,-89.0,-89.0,-87.0,-87.0,18.0,23.0,18.0,14.0,1
1747,CC:2F:71:3E:C5:1F,3833638,483506657,850,103934,3832788,483402723,0,3542,297652,2923,224166,619,73486,900,8,1220,19,0,37,130000.0,39000.0,-72.0,-70.0,-67.0,-60.0,-71.0,-70.0,-66.0,-60.0,-89.0,-89.0,-87.0,-87.0,17.0,19.0,20.0,27.0,1
1748,BA:8C:B9:54:50:24,3837602,489583022,4812,6180097,3832790,483402925,0,8807,1686509,8785,1683014,22,3495,2345,15,5237,39,0,56,216660.0,130000.0,-41.0,-38.0,-47.0,-51.0,-45.0,-36.0,-44.0,-47.0,-89.0,-89.0,-87.0,-87.0,48.0,51.0,40.0,36.0,1
1749,92:69:1D:31:68:E9,3836654,487009407,3861,3606220,3832793,483403187,0,4599,1079360,4463,1048635,136,30725,2078,10,4046,84,0,41,229410.0,137640.0,-52.0,-48.0,-44.0,-47.0,-52.0,-48.0,-44.0,-47.0,-89.0,-89.0,-87.0,-87.0,37.0,41.0,43.0,40.0,1
1750,CC:2F:71:3F:1F:24,4530704,1221863573,697911,738460386,3832793,483403187,37,559720,572636412,559019,572552026,701,84386,540902,15,698159,79143,34,476,144444.0,43333.0,-71.0,-66.0,-70.0,-72.0,-71.0,-66.0,-69.0,-72.0,-89.0,-89.0,-87.0,-87.0,18.0,23.0,17.0,15.0,1
1751,CC:2F:71:3E:C5:1F,3833643,483507121,850,103934,3832793,483403187,0,3542,297652,2923,224166,619,73486,900,8,1220,19,0,37,130000.0,39000.0,-72.0,-70.0,-67.0,-60.0,-71.0,-70.0,-66.0,-60.0,-89.0,-89.0,-87.0,-87.0,17.0,19.0,20.0,27.0,1
1752,BA:8C:B9:54:50:24,3837607,489583486,4812,6180097,3832795,483403389,0,8807,1686509,8785,1683014,22,3495,2345,15,5237,39,0,56,216660.0,130000.0,-41.0,-38.0,-47.0,-51.0,-45.0,-36.0,-44.0,-47.0,-89.0,-89.0,-87.0,-87.0,48.0,51.0,40.0,36.0,1
1753,92:69:1D:31:68:E9,3836658,487009811,3861,3606220,3832797,483403591,0,4599,1079360,4463,1048635,136,30725,2078,10,4046,84,0,41,229410.0,137640.0,-52.0,-48.0,-44.0,-47.0,-52.0,-48.0,-44.0,-47.0,-89.0,-89.0,-87.0,-87.0,37.0,41.0,43.0,40.0,1
1754,CC:2F:71:3F:1F:24,4530747,1221878151,697950,738474560,3832797,483403591,37,559745,572640846,559044,572556460,701,84386,540924,15,698198,79146,34,476,144444.0,43333.0,-71.0,-66.0,-70.0,-73.0,-71.0,-66.0,-70.0,-72.0,-89.0,-89.0,-87.0,-87.0,18.0,23.0,17.0,14.0,1
1755,CC:2F:71:3E:C5:1F,3833647,483507525,850,103934,3832797,483403591,0,3542,297652,2923,224166,619,73486,900,8,1220,19,0,37,130000.0,39000.0,-72.0,-70.0,-67.0,-60.0,-71.0,-70.0,-66.0,-60.0,-89.0,-89.0,-87.0,-87.0,17.0,19.0,20.0,27.0,1
1756,BA:8C:B9:54:50:24,3837611,489583890,4812,6180097,3832799,483403793,0,8807,1686509,8785,1683014,22,3495,2345,15,5237,39,0,56,216660.0,130000.0,-41.0,-38.0,-47.0,-51.0,-45.0,-36.0,-44.0,-47.0,-89.0,-89.0,-87.0,-87.0,48.0,51.0,40.0,36.0,1
1757,92:69:1D:31:68:E9,3836664,487010548,3861,3606220,3832803,483404328,0,4599,1079360,4463,1048635,136,30725,2078,10,4046,84,0,41,229410.0,137640.0,-52.0,-48.0,-44.0,-47.0,-52.0,-48.0,-44.0,-47.0,-89.0,-89.0,-87.0,-87.0,37.0,41.0,43.0,40.0,1
1758,CC:2F:71:3F:1F:24,4530799,1221896535,697996,738492207,3832803,483404328,37,559775,572646257,559074,572561871,701,84386,540952,15,698244,79159,34,476,144444.0,43333.0,-73.0,-67.0,-70.0,-73.0,-72.0,-67.0,-69.0,-73.0,-89.0,-89.0,-87.0,-87.0,16.0,22.0,17.0,14.0,1
1759,CC:2F:71:3E:C5:1F,3833653,483508262,850,103934,3832803,483404328,0,3542,297652,2923,224166,619,73486,900,8,1220,19,0,37,130000.0,39000.0,-72.0,-70.0,-67.0,-60.0,-71.0,-70.0,-66.0,-60.0,-89.0,-89.0,-87.0,-87.0,17.0,19.0,20.0,27.0,1
1760,BA:8C:B9:54:50:24,3837615,489584425,4812,6180097,3832803,483404328,0,8807,1686509,8785,1683014,22,3495,2345,15,5237,39,0,56,216660.0,130000.0,-41.0,-38.0,-47.0,-51.0,-45.0,-36.0,-44.0,-47.0,-89.0,-89.0,-87.0,-87.0,48.0,51.0,40.0,36.0,1
1761,92:69:1D:31:68:E9,3836668,487010952,3861,3606220,3832807,483404732,0,4599,1079360,4463,1048635,136,30725,2078,10,4046,84,0,41,229410.0,137640.0,-52.0,-48.0,-44.0,-47.0,-52.0,-48.0,-44.0,-47.0,-89.0,-89.0,-87.0,-87.0,37.0,41.0,43.0,40.0,1
1762,CC:2F:71:3F:1F:24,4530841,1221910983,698034,738506251,3832807,483404732,37,559801,572650661,559100,572566275,701,84386,540974,15,698282,79187,34,476,144444.0,43333.0,-74.0,-68.0,-70.0,-74.0,-74.0,-67.0,-70.0,-73.0,-89.0,-89.0,-87.0,-87.0,15.0,21.0,17.0,13.0,1
1763,CC:2F:71:3E:C5:1F,3833657,483508666,850,103934,3832807,483404732,0,3542,297652,2923,224166,619,73486,900,8,1220,19,0,37,130000.0,39000.0,-72.0,-70.0,-67.0,-60.0,-71.0,-70.0,-66.0,-60.0,-89.0,-89.0,-87.0,-87.0,17.0,19.0,20.0,27.0,1
1764,BA:8C:B9:54:50:24,3837619,489584829,4812,6180097,3832807,483404732,0,8807,1686509,8785,1683014,22,3495,2345,15,5237,39,0,56,216660.0,130000.0,-41.0,-38.0,-47.0,-51.0,-45.0,-36.0,-44.0,-47.0,-89.0,-89.0,-87.0,-87.0,48.0,51.0,40.0,36.0,1
1765,92:69:1D:31:68:E9,3836673,487011482,3861,3606220,3832812,483405262,0,4599,1079360,4463,1048635,136,30725,2078,10,4046,84,0,41,229410.0,137640.0,-52.0,-48.0,-44.0,-47.0,-52.0,-48.0,-44.0,-47.0,-89.0,-89.0,-87.0,-87.0,37.0,41.0,43.0,40.0,1
1766,CC:2F:71:3F:1F:24,4530885,1221925687,698073,738520425,3832812,483405262,37,559825,572654773,559124,572570387,701,84386,540994,15,698321,79205,34,476,144444.0,43333.0,-74.0,-68.0,-70.0,-73.0,-74.0,-68.0,-69.0,-73.0,-89.0,-89.0,-87.0,-87.0,15.0,21.0,17.0,14.0,1
1767,CC:2F:71:3E:C5:1F,3833662,483509196,850,103934,3832812,483405262,0,3542,297652,2923,224166,619,73486,900,8,1220,19,0,37,130000.0,39000.0,-72.0,-70.0,-67.0,-60.0,-71.0,-70.0,-66.0,-60.0,-89.0,-89.0,-87.0,-87.0,17.0,19.0,20.0,27.0,1
1768,BA:8C:B9:54:50:24,3837624,489585359,4812,6180097,3832812,483405262,0,8807,1686509,8785,1683014,22,3495,2345,15,5237,39,0,56,216660.0,130000.0,-41.0,-38.0,-47.0,-51.0,-45.0,-36.0,-44.0,-47.0,-89.0,-89.0,-87.0,-87.0,48.0,51.0,40.0,36.0,1
1769,92:69:1D:31:68:E9,3836678,487011946,3861,3606220,3832817,483405726,0,4599,1079360,4463,1048635,136,30725,2078,10,4046,84,0,41,229410.0,137640.0,-52.0,-48.0,-44.0,-47.0,-52.0,-48.0,-44.0,-47.0,-89.0,-89.0,-87.0,-87.0,37.0,41.0,43.0,40.0,1
1770,CC:2F:71:3F:1F:24,4530929,1221940325,698112,738534599,3832817,483405726,37,559851,572659417,559150,572575031,701,84386,541016,15,698360,79238,34,476,144444.0,43333.0,-73.0,-68.0,-70.0,-74.0,-72.0,-67.0,-70.0,-74.0,-89.0,-89.0,-87.0,-87.0,16.0,21.0,17.0,13.0,1
1771,CC:2F:71:3E:C5:1F,3833667,483509660,850,103934,3832817,483405726,0,3542,297652,2923,224166,619,73486,900,8,1220,19,0,37,130000.0,39000.0,-72.0,-70.0,-67.0,-60.0,-71.0,-70.0,-66.0,-60.0,-89.0,-89.0,-87.0,-87.0,17.0,19.0,20.0,27.0,1
1772,BA:8C:B9:54:50:24,3837629,489585823,4812,6180097,3832817,483405726,0,8807,1686509,8785,1683014,22,3495,2345,15,5237,39,0,56,216660.0,130000.0,-41.0,-38.0,-47.0,-51.0,-45.0,-36.0,-44.0,-47.0,-89.0,-89.0,-87.0,-87.0,48.0,51.0,40.0,36.0,1
1773,92:69:1D:31:68:E9,3836682,487012350,3861,3606220,3832821,483406130,0,4599,1079360,4463,1048635,136,30725,2078,10,4046,84,0,41,229410.0,137640.0,-52.0,-48.0,-44.0,-47.0,-52.0,-48.0,-44.0,-47.0,-89.0,-89.0,-87.0,-87.0,37.0,41.0,43.0,40.0,1
1774,CC:2F:71:3F:1F:24,4530980,1221958450,698159,738552320,3832821,483406130,37,559884,572665252,559183,572580866,701,84386,541045,15,698407,79255,34,476,130000.0,43333.0,-73.0,-68.0,-71.0,-73.0,-73.0,-68.0,-71.0,-73.0,-89.0,-89.0,-87.0,-87.0,16.0,21.0,16.0,14.0,1
1775,CC:2F:71:3E:C5:1F,3833671,483510064,850,103934,3832821,483406130,0,3542,297652,2923,224166,619,73486,900,8,1220,19,0,37,130000.0,39000.0,-72.0,-70.0,-67.0,-60.0,-71.0,-70.0,-66.0,-60.0,-89.0,-89.0,-87.0,-87.0,17.0,19.0,20.0,27.0,1
1776,BA:8C:B9:54:50:24,3837633,489586227,4812,6180097,3832821,483406130,0,8807,1686509,8785,1683014,22,3495,2345,15,5237,39,0,56,216660.0,130000.0,-41.0,-38.0,-47.0,-51.0,-45.0,-36.0,-44.0,-47.0,-89.0,-89.0,-87.0,-87.0,48.0,51.0,40.0,36.0,1
1777,92:69:1D:31:68:E9,3836686,487012754,3861,3606220,3832825,483406534,0,4599,1079360,4463,1048635,136,30725,2078,10,4046,84,0,41,229410.0,137640.0,-52.0,-48.0,-44.0,-47.0,-52.0,-48.0,-44.0,-47.0,-89.0,-89.0,-87.0,-87.0,37.0,41.0,43.0,40.0,1
1778,CC:2F:71:3F:1F:24,4531024,1221973102,698199,738566568,3832825,483406534,37,559908,572669618,559207,572585232,701,84386,541066,15,698447,79261,34,476,130000.0,39000.0,-72.0,-69.0,-70.0,-73.0,-72.0,-68.0,-70.0,-73.0,-89.0,-89.0,-87.0,-87.0,17.0,20.0,17.0,14.0,1
1779,CC:2F:71:3E:C5:1F,3833675,483510468,850,103934,3832825,483406534,0,3542,297652,2923,224166,619,73486,900,8,1220,19,0,37,130000.0,39000.0,-72.0,-70.0,-67.0,-60.0,-71.0,-70.0,-66.0,-60.0,-89.0,-89.0,-87.0,-87.0,17.0,19.0,20.0,27.0,1
1780,BA:8C:B9:54:50:24,3837638,489586691,4812,6180097,3832826,483406594,0,8807,1686509,8785,1683014,22,3495,2345,15,5237,39,0,56,216660.0,130000.0,-41.0,-38.0,-47.0,-51.0,-45.0,-36.0,-44.0,-47.0,-89.0,-89.0,-87.0,-87.0,48.0,51.0,40.0,36.0,1
1781,92:69:1D:31:68:E9,3836691,487013218,3861,3606220,3832830,483406998,0,4599,1079360,4463,1048635,136,30725,2078,10,4046,84,0,41,229410.0,137640.0,-52.0,-48.0,-44.0,-47.0,-52.0,-48.0,-44.0,-47.0,-89.0,-89.0,-87.0,-87.0,37.0,41.0,43.0,40.0,1
1782,CC:2F:71:3F:1F:24,4531069,1221987758,698239,738580760,3832830,483406998,37,559932,572673682,559231,572589296,701,84386,541088,15,698487,79272,34,477,144444.0,43333.0,-73.0,-69.0,-70.0,-73.0,-73.0,-69.0,-70.0,-73.0,-89.0,-89.0,-87.0,-87.0,16.0,20.0,17.0,14.0,1
1783,CC:2F:71:3E:C5:1F,3833680,483510932,850,103934,3832830,483406998,0,3542,297652,2923,224166,619,73486,900,8,1220,19,0,37,130000.0,39000.0,-72.0,-70.0,-67.0,-60.0,-71.0,-70.0,-66.0,-60.0,-89.0,-89.0,-87.0,-87.0,17.0,19.0,20.0,27.0,1
1784,BA:8C:B9:54:50:24,3837642,489587095,4812,6180097,3832830,483406998,0,8807,1686509,8785,1683014,22,3495,2345,15,5237,39,0,56,216660.0,130000.0,-41.0,-38.0,-47.0,-51.0,-45.0,-36.0,-44.0,-47.0,-89.0,-89.0,-87.0,-87.0,48.0,51.0,40.0,36.0,1
1785,92:69:1D:31:68:E9,3836695,487013622,3861,3606220,3832834,483407402,0,4599,1079360,4463,1048635,136,30725,2078,10,4046,84,0,41,229410.0,137640.0,-52.0,-48.0,-44.0,-47.0,-52.0,-48.0,-44.0,-47.0,-89.0,-90.0,-88.0,-88.0,37.0,42.0,44.0,41.0,1
1786,CC:2F:71:3F:1F:24,4531112,1222002408,698278,738595006,3832834,483407402,37,559958,572678008,559257,572593622,701,84386,541113,15,698526,79293,34,477,130000.0,43333.0,-74.0,-69.0,-71.0,-74.0,-74.0,-70.0,-72.0,-75.0,-89.0,-90.0,-88.0,-88.0,15.0,21.0,17.0,14.0,1
1787,CC:2F:71:3E:C5:1F,3833684,483511336,850,103934,3832834,483407402,0,3542,297652,2923,224166,619,73486,900,8,1220,19,0,37,130000.0,39000.0,-72.0,-70.0,-67.0,-60.0,-71.0,-70.0,-66.0,-60.0,-89.0,-90.0,-88.0,-88.0,17.0,20.0,21.0,28.0,1
1788,BA:8C:B9:54:50:24,3837646,489587499,4812,6180097,3832834,483407402,0,8807,1686509,8785,1683014,22,3495,2345,15,5237,39,0,56,216660.0,130000.0,-41.0,-38.0,-47.0,-51.0,-45.0,-36.0,-44.0,-47.0,-89.0,-90.0,-88.0,-88.0,48.0,52.0,41.0,37.0,1
1789,92:69:1D:31:68:E9,3836700,487014086,3861,3606220,3832839,483407866,0,4600,1079428,4464,1048703,136,30725,2078,10,4046,84,0,41,229410.0,137640.0,-52.0,-47.0,-44.0,-47.0,-52.0,-48.0,-44.0,-47.0,-89.0,-90.0,-88.0,-88.0,37.0,43.0,44.0,41.0,1
1790,CC:2F:71:3F:1F:24,4531162,1222020389,698323,738612523,3832839,483407866,37,559991,572683503,559290,572599117,701,84386,541140,15,698571,79293,34,477,130000.0,43333.0,-72.0,-69.0,-70.0,-74.0,-72.0,-68.0,-70.0,-73.0,-89.0,-90.0,-88.0,-88.0,17.0,21.0,18.0,14.0,1
1791,CC:2F:71:3E:C5:1F,3833689,483511800,850,103934,3832839,483407866,0,3542,297652,2923,224166,619,73486,900,8,1220,19,0,37,130000.0,39000.0,-72.0,-70.0,-67.0,-60.0,-71.0,-70.0,-66.0,-60.0,-89.0,-90.0,-88.0,-88.0,17.0,20.0,21.0,28.0,1
1792,BA:8C:B9:54:50:24,3837651,489587963,4812,6180097,3832839,483407866,0,8807,1686509,8785,1683014,22,3495,2345,15,5237,39,0,56,216660.0,130000.0,-41.0,-38.0,-47.0,-51.0,-45.0,-36.0,-44.0,-47.0,-89.0,-90.0,-88.0,-88.0,48.0,52.0,41.0,37.0,1
1793,92:69:1D:31:68:E9,3836704,487014490,3861,3606220,3832843,483408270,0,4600,1079428,4464,1048703,136,30725,2078,10,4046,84,0,41,229410.0,137640.0,-52.0,-47.0,-44.0,-47.0,-52.0,-48.0,-44.0,-47.0,-89.0,-90.0,-88.0,-88.0,37.0,43.0,44.0,41.0,1
1794,CC:2F:71:3F:1F:24,4531206,1222035041,698363,738626771,3832843,483408270,37,560013,572687495,559312,572603109,701,84386,541160,15,698611,79299,34,477,130000.0,39000.0,-75.0,-71.0,-73.0,-76.0,-75.0,-71.0,-73.0,-76.0,-89.0,-90.0,-88.0,-88.0,14.0,19.0,15.0,12.0,1
1795,CC:2F:71:3E:C5:1F,3833693,483512204,850,103934,3832843,483408270,0,3542,297652,2923,224166,619,73486,900,8,1220,19,0,37,130000.0,39000.0,-72.0,-70.0,-67.0,-60.0,-71.0,-70.0,-66.0,-60.0,-89.0,-90.0,-88.0,-88.0,17.0,20.0,21.0,28.0,1
1796,BA:8C:B9:54:50:24,3837655,489588367,4812,6180097,3832843,483408270,0,8807,1686509,8785,1683014,22,3495,2345,15,5237,39,0,56,216660.0,130000.0,-41.0,-38.0,-47.0,-51.0,-45.0,-36.0,-44.0,-47.0,-89.0,-90.0,-88.0,-88.0,48.0,52.0,41.0,37.0,1
1797,92:69:1D:31:68:E9,3836708,487014894,3861,3606220,3832847,483408674,0,4600,1079428,4464,1048703,136,30725,2078,10,4046,84,0,41,229410.0,137640.0,-52.0,-47.0,-44.0,-47.0,-52.0,-48.0,-44.0,-47.0,-89.0,-90.0,-88.0,-88.0,37.0,43.0,44.0,41.0,1
1798,CC:2F:71:3F:1F:24,4531248,1222049377,698401,738640703,3832847,483408674,37,560037,572691719,559336,572607333,701,84386,541182,15,698649,79303,34,477,130000.0,39000.0,-74.0,-69.0,-70.0,-74.0,-73.0,-68.0,-69.0,-74.0,-89.0,-90.0,-88.0,-88.0,15.0,21.0,18.0,14.0,1
1799,CC:2F:71:3E:C5:1F,3833697,483512608,850,103934,3832847,483408674,0,3542,297652,2923,224166,619,73486,900,8,1220,19,0,37,130000.0,39000.0,-72.0,-70.0,-67.0,-60.0,-71.0,-70.0,-66.0,-60.0,-89.0,-90.0,-88.0,-88.0,17.0,20.0,21.0,28.0,1
1800,BA:8C:B9:54:50:24,3837659,489588771,4812,6180097,3832847,483408674,0,8807,1686509,8785,1683014,22,3495,2345,15,5237,39,0,56,216660.0,130000.0,-41.0,-38.0,-47.0,-51.0,-45.0,-36.0,-44.0,-47.0,-89.0,-90.0,-88.0,-88.0,48.0,52.0,41.0,37.0,1
1801,92:69:1D:31:68:E9,3836713,487015358,3861,3606220,3832852,483409138,0,4600,1079428,4464,1048703,136,30725,2078,10,4046,84,0,41,229410.0,137640.0,-52.0,-47.0,-44.0,-47.0,-52.0,-48.0,-44.0,-47.0,-89.0,-90.0,-88.0,-88.0,37.0,43.0,44.0,41.0,1
1802,CC:2F:71:3F:1F:24,4531292,1222063847,698440,738654709,3832852,483409138,37,560060,572695685,559359,572611299,701,84386,541204,15,698688,79314,34,477,117000.0,39000.0,-72.0,-68.0,-70.0,-75.0,-72.0,-68.0,-69.0,-74.0,-89.0,-90.0,-88.0,-88.0,17.0,22.0,18.0,13.0,1
1803,CC:2F:71:3E:C5:1F,3833702,483513072,850,103934,3832852,483409138,0,3542,297652,2923,224166,619,73486,900,8,1220,19,0,37,130000.0,39000.0,-72.0,-70.0,-67.0,-60.0,-71.0,-70.0,-66.0,-60.0,-89.0,-90.0,-88.0,-88.0,17.0,20.0,21.0,28.0,1
1804,BA:8C:B9:54:50:24,3837664,489589235,4812,6180097,3832852,483409138,0,8807,1686509,8785,1683014,22,3495,2345,15,5237,39,0,56,216660.0,130000.0,-41.0,-38.0,-47.0,-51.0,-45.0,-36.0,-44.0,-47.0,-89.0,-90.0,-88.0,-88.0,48.0,52.0,41.0,37.0,1
1805,92:69:1D:31:68:E9,3836718,487015822,3862,3606280,3832856,483409542,0,4602,1079564,4466,1048839,136,30725,2078,10,4047,84,0,41,216660.0,130000.0,-52.0,-48.0,-44.0,-48.0,-52.0,-47.0,-44.0,-47.0,-89.0,-90.0,-88.0,-88.0,37.0,42.0,44.0,40.0,1
1806,CC:2F:71:3F:1F:24,4531344,1222082032,698488,738672490,3832856,483409542,37,560096,572702345,559395,572617959,701,84386,541232,15,698736,79319,34,477,130000.0,43333.0,-72.0,-68.0,-72.0,-74.0,-72.0,-68.0,-71.0,-74.0,-89.0,-90.0,-88.0,-88.0,17.0,22.0,16.0,14.0,1
1807,CC:2F:71:3E:C5:1F,3833707,483513592,851,104050,3832856,483409542,0,3544,297792,2925,224306,619,73486,900,8,1221,19,0,37,130000.0,39000.0,-73.0,-71.0,-67.0,-61.0,-72.0,-70.0,-66.0,-60.0,-89.0,-90.0,-88.0,-88.0,16.0,19.0,21.0,27.0,1
1808,BA:8C:B9:54:50:24,3837669,489589755,4813,6180213,3832856,483409542,0,8809,1686645,8787,1683150,22,3495,2345,15,5238,39,0,56,216660.0,130000.0,-48.0,-35.0,-42.0,-46.0,-45.0,-36.0,-44.0,-48.0,-89.0,-90.0,-88.0,-88.0,41.0,55.0,46.0,42.0,1
1809,92:69:1D:31:68:E9,3836723,487016288,3862,3606280,3832861,483410008,0,4602,1079564,4466,1048839,136,30725,2078,10,4047,84,0,41,216660.0,130000.0,-52.0,-48.0,-44.0,-48.0,-52.0,-47.0,-44.0,-47.0,-89.0,-90.0,-88.0,-88.0,37.0,42.0,44.0,40.0,1
1810,CC:2F:71:3F:1F:24,4531388,1222096616,698527,738686608,3832861,483410008,37,560120,572706337,559418,572621833,702,84504,541253,15,698775,79319,34,477,130000.0,39000.0,-71.0,-68.0,-70.0,-73.0,-71.0,-68.0,-70.0,-73.0,-89.0,-90.0,-88.0,-88.0,18.0,22.0,18.0,15.0,1
1811,CC:2F:71:3E:C5:1F,3833712,483514058,851,104050,3832861,483410008,0,3544,297792,2925,224306,619,73486,900,8,1221,19,0,37,130000.0,39000.0,-73.0,-71.0,-67.0,-61.0,-72.0,-70.0,-66.0,-60.0,-89.0,-90.0,-88.0,-88.0,16.0,19.0,21.0,27.0,1
1812,BA:8C:B9:54:50:24,3837675,489590281,4813,6180213,3832862,483410068,0,8809,1686645,8787,1683150,22,3495,2345,15,5238,39,0,56,216660.0,130000.0,-48.0,-35.0,-42.0,-46.0,-45.0,-36.0,-44.0,-48.0,-89.0,-90.0,-88.0,-88.0,41.0,55.0,46.0,42.0,1
1813,92:69:1D:31:68:E9,3836727,487016823,3862,3606280,3832865,483410543,0,4602,1079564,4466,1048839,136,30725,2078,10,4047,84,0,41,216660.0,130000.0,-52.0,-48.0,-44.0,-48.0,-52.0,-47.0,-44.0,-47.0,-89.0,-90.0,-88.0,-88.0,37.0,42.0,44.0,40.0,1
1814,CC:2F:71:3F:1F:24,4531432,1222111403,698566,738700726,3832866,483410677,37,560141,572710071,559439,572625567,702,84504,541273,15,698814,79336,34,477,117000.0,39000.0,-73.0,-68.0,-71.0,-74.0,-72.0,-68.0,-70.0,-73.0,-89.0,-90.0,-88.0,-88.0,16.0,22.0,17.0,14.0,1
1815,CC:2F:71:3E:C5:1F,3833719,483514857,851,104050,3832868,483410807,0,3545,297910,2925,224306,620,73604,901,8,1221,19,0,37,130000.0,39000.0,-72.0,-71.0,-67.0,-60.0,-72.0,-70.0,-66.0,-60.0,-89.0,-90.0,-88.0,-88.0,17.0,19.0,21.0,28.0,1
1816,BA:8C:B9:54:50:24,3837681,489591020,4813,6180213,3832868,483410807,0,8809,1686645,8787,1683150,22,3495,2345,15,5238,39,0,56,216660.0,130000.0,-48.0,-35.0,-42.0,-46.0,-45.0,-36.0,-44.0,-48.0,-89.0,-90.0,-88.0,-88.0,41.0,55.0,46.0,42.0,1
1817,92:69:1D:31:68:E9,3836734,487017491,3862,3606280,3832872,483411211,0,4602,1079564,4466,1048839,136,30725,2078,10,4047,84,0,41,216660.0,130000.0,-52.0,-48.0,-44.0,-48.0,-52.0,-47.0,-44.0,-47.0,-89.0,-90.0,-88.0,-88.0,37.0,42.0,44.0,40.0,1
1818,CC:2F:71:3F:1F:24,4531477,1222125999,698605,738714788,3832872,483411211,37,560166,572714581,559464,572630077,702,84504,541293,15,698853,79340,34,477,130000.0,43333.0,-72.0,-67.0,-70.0,-73.0,-72.0,-67.0,-70.0,-73.0,-89.0,-90.0,-88.0,-88.0,17.0,23.0,18.0,15.0,1
1819,CC:2F:71:3E:C5:1F,3833723,483515261,851,104050,3832872,483411211,0,3546,297980,2926,224376,620,73604,901,8,1221,19,0,37,130000.0,39000.0,-72.0,-70.0,-68.0,-60.0,-72.0,-70.0,-67.0,-60.0,-89.0,-90.0,-88.0,-88.0,17.0,20.0,20.0,28.0,1
1820,BA:8C:B9:54:50:24,3837685,489591424,4813,6180213,3832872,483411211,0,8809,1686645,8787,1683150,22,3495,2345,15,5238,39,0,56,216660.0,130000.0,-48.0,-35.0,-42.0,-46.0,-45.0,-36.0,-44.0,-48.0,-89.0,-90.0,-88.0,-88.0,41.0,55.0,46.0,42.0,1
1821,92:69:1D:31:68:E9,3836737,487017753,3862,3606280,3832875,483411473,0,4602,1079564,4466,1048839,136,30725,2078,10,4047,84,0,41,216660.0,130000.0,-52.0,-48.0,-44.0,-48.0,-52.0,-47.0,-44.0,-47.0,-89.0,-90.0,-88.0,-88.0,37.0,42.0,44.0,40.0,1
1822,CC:2F:71:3F:1F:24,4531527,1222143926,698652,738732453,3832875,483411473,37,560199,572720356,559497,572635852,702,84504,541322,15,698900,79347,34,477,144444.0,39000.0,-73.0,-68.0,-70.0,-74.0,-72.0,-67.0,-69.0,-73.0,-89.0,-90.0,-88.0,-88.0,16.0,22.0,18.0,14.0,1
1823,CC:2F:71:3E:C5:1F,3833728,483515725,851,104050,3832877,483411675,0,3546,297980,2926,224376,620,73604,901,8,1221,19,0,37,130000.0,39000.0,-72.0,-70.0,-68.0,-60.0,-72.0,-70.0,-67.0,-60.0,-89.0,-90.0,-88.0,-88.0,17.0,20.0,20.0,28.0,1
1824,BA:8C:B9:54:50:24,3837690,489591888,4813,6180213,3832877,483411675,0,8809,1686645,8787,1683150,22,3495,2345,15,5238,39,0,56,216660.0,130000.0,-48.0,-35.0,-42.0,-46.0,-45.0,-36.0,-44.0,-48.0,-89.0,-90.0,-88.0,-88.0,41.0,55.0,46.0,42.0,1
1825,92:69:1D:31:68:E9,3836745,487018727,3862,3606280,3832883,483412447,0,4602,1079564,4466,1048839,136,30725,2078,10,4047,84,0,41,216660.0,130000.0,-52.0,-48.0,-44.0,-48.0,-52.0,-47.0,-44.0,-47.0,-89.0,-89.0,-87.0,-88.0,37.0,41.0,43.0,40.0,1
1826,CC:2F:71:3F:1F:24,4531575,1222159676,698692,738747229,3832883,483412447,37,560227,572724976,559525,572640472,702,84504,541346,15,698940,79363,34,477,144444.0,43333.0,-72.0,-68.0,-69.0,-74.0,-73.0,-68.0,-70.0,-74.0,-89.0,-89.0,-87.0,-88.0,17.0,21.0,18.0,14.0,1
1827,CC:2F:71:3E:C5:1F,3833736,483516699,851,104050,3832885,483412649,0,3546,297980,2926,224376,620,73604,901,8,1221,19,0,37,130000.0,39000.0,-72.0,-70.0,-68.0,-60.0,-72.0,-70.0,-67.0,-60.0,-89.0,-89.0,-87.0,-88.0,17.0,19.0,19.0,28.0,1
1828,BA:8C:B9:54:50:24,3837698,489592862,4813,6180213,3832885,483412649,0,8814,1686985,8792,1683490,22,3495,2345,15,5238,39,0,56,216660.0,130000.0,-48.0,-35.0,-42.0,-45.0,-44.0,-35.0,-43.0,-47.0,-89.0,-89.0,-87.0,-88.0,41.0,54.0,45.0,43.0,1
1829,92:69:1D:31:68:E9,3836751,487019333,3862,3606280,3832889,483413053,0,4602,1079564,4466,1048839,136,30725,2078,10,4047,84,0,41,216660.0,130000.0,-52.0,-48.0,-44.0,-48.0,-52.0,-47.0,-44.0,-47.0,-89.0,-89.0,-87.0,-88.0,37.0,41.0,43.0,40.0,1
1830,CC:2F:71:3F:1F:24,4531623,1222174904,698733,738761791,3832890,483413113,37,560267,572730766,559565,572646262,702,84504,541369,15,698981,79369,34,477,144444.0,43333.0,-72.0,-67.0,-69.0,-73.0,-72.0,-67.0,-69.0,-73.0,-89.0,-89.0,-87.0,-88.0,17.0,22.0,18.0,15.0,1
1831,CC:2F:71:3E:C5:1F,3833741,483517163,851,104050,3832890,483413113,0,3546,297980,2926,224376,620,73604,901,8,1221,19,0,37,130000.0,39000.0,-72.0,-70.0,-68.0,-60.0,-72.0,-70.0,-67.0,-60.0,-89.0,-89.0,-87.0,-88.0,17.0,19.0,19.0,28.0,1
1832,BA:8C:B9:54:50:24,3837705,489593528,4813,6180213,3832892,483413315,0,8815,1687053,8793,1683558,22,3495,2345,15,5238,39,0,56,216660.0,130000.0,-48.0,-35.0,-42.0,-45.0,-45.0,-35.0,-42.0,-46.0,-89.0,-89.0,-87.0,-88.0,41.0,54.0,45.0,43.0,1
1833,92:69:1D:31:68:E9,3836756,487019797,3862,3606280,3832894,483413517,0,4602,1079564,4466,1048839,136,30725,2078,10,4047,84,0,41,216660.0,130000.0,-52.0,-48.0,-44.0,-48.0,-52.0,-47.0,-44.0,-47.0,-89.0,-89.0,-87.0,-88.0,37.0,41.0,43.0,40.0,1
1834,CC:2F:71:3F:1F:24,4531668,1222189742,698774,738776225,3832894,483413517,37,560294,572735402,559592,572650898,702,84504,541392,15,699022,79389,34,477,144444.0,43333.0,-72.0,-67.0,-69.0,-74.0,-72.0,-67.0,-69.0,-73.0,-89.0,-89.0,-87.0,-88.0,17.0,22.0,18.0,14.0,1
1835,CC:2F:71:3E:C5:1F,3833745,483517567,851,104050,3832894,483413517,0,3547,298050,2927,224446,620,73604,901,8,1222,19,0,37,130000.0,39000.0,-72.0,-70.0,-68.0,-61.0,-72.0,-70.0,-67.0,-60.0,-89.0,-89.0,-87.0,-88.0,17.0,19.0,19.0,27.0,1
1836,BA:8C:B9:54:50:24,3837707,489593730,4813,6180213,3832894,483413517,0,8815,1687053,8793,1683558,22,3495,2345,15,5238,39,0,56,216660.0,130000.0,-48.0,-35.0,-42.0,-45.0,-45.0,-35.0,-42.0,-46.0,-89.0,-89.0,-87.0,-88.0,41.0,54.0,45.0,43.0,1
1837,92:69:1D:31:68:E9,3836760,487020201,3862,3606280,3832898,483413921,0,4604,1079700,4468,1048975,136,30725,2078,10,4048,84,0,41,216660.0,130000.0,-52.0,-48.0,-44.0,-47.0,-52.0,-47.0,-44.0,-47.0,-89.0,-89.0,-87.0,-88.0,37.0,41.0,43.0,41.0,1
1838,CC:2F:71:3F:1F:24,4531718,1222207793,698820,738793872,3832898,483413921,37,560323,572740665,559621,572656161,702,84504,541419,15,699068,79406,34,477,144444.0,43333.0,-74.0,-67.0,-70.0,-74.0,-74.0,-67.0,-70.0,-73.0,-89.0,-89.0,-87.0,-88.0,15.0,22.0,17.0,14.0,1
1839,CC:2F:71:3E:C5:1F,3833749,483517971,851,104050,3832898,483413921,0,3548,298120,2928,224516,620,73604,901,8,1222,19,0,37,130000.0,39000.0,-72.0,-70.0,-68.0,-61.0,-72.0,-70.0,-67.0,-60.0,-89.0,-89.0,-87.0,-88.0,17.0,19.0,19.0,27.0,1
1840,BA:8C:B9:54:50:24,3837711,489594134,4813,6180213,3832898,483413921,0,8815,1687053,8793,1683558,22,3495,2345,15,5238,39,0,56,216660.0,130000.0,-48.0,-35.0,-42.0,-45.0,-45.0,-35.0,-42.0,-46.0,-89.0,-89.0,-87.0,-88.0,41.0,54.0,45.0,43.0,1
1841,92:69:1D:31:68:E9,3836763,487020463,3862,3606280,3832901,483414183,0,4604,1079700,4468,1048975,136,30725,2078,10,4048,84,0,41,216660.0,130000.0,-52.0,-48.0,-44.0,-47.0,-52.0,-47.0,-44.0,-47.0,-89.0,-89.0,-87.0,-88.0,37.0,41.0,43.0,41.0,1
1842,CC:2F:71:3F:1F:24,4531762,1222222431,698859,738808046,3832903,483414385,37,560346,572744631,559644,572660127,702,84504,541441,15,699107,79436,34,477,144444.0,43333.0,-74.0,-67.0,-70.0,-74.0,-74.0,-67.0,-69.0,-73.0,-89.0,-89.0,-87.0,-88.0,15.0,22.0,17.0,14.0,1
1843,CC:2F:71:3E:C5:1F,3833754,483518435,851,104050,3832903,483414385,0,3548,298120,2928,224516,620,73604,901,8,1222,19,0,37,130000.0,39000.0,-72.0,-70.0,-68.0,-61.0,-72.0,-70.0,-67.0,-60.0,-89.0,-89.0,-87.0,-88.0,17.0,19.0,19.0,27.0,1
1844,BA:8C:B9:54:50:24,3837716,489594598,4813,6180213,3832903,483414385,0,8815,1687053,8793,1683558,22,3495,2345,15,5238,39,0,56,216660.0,130000.0,-48.0,-35.0,-42.0,-45.0,-45.0,-35.0,-42.0,-46.0,-89.0,-89.0,-87.0,-88.0,41.0,54.0,45.0,43.0,1
1845,92:69:1D:31:68:E9,3836769,487021069,3862,3606280,3832907,483414789,0,4604,1079700,4468,1048975,136,30725,2078,10,4048,84,0,41,216660.0,130000.0,-52.0,-48.0,-44.0,-47.0,-52.0,-47.0,-44.0,-47.0,-89.0,-89.0,-87.0,-88.0,37.0,41.0,43.0,41.0,1
1846,CC:2F:71:3F:1F:24,4531805,1222237137,698898,738822348,3832907,483414789,37,560372,572749067,559670,572664563,702,84504,541465,15,699146,79476,34,477,144444.0,43333.0,-74.0,-67.0,-70.0,-74.0,-73.0,-67.0,-69.0,-74.0,-89.0,-89.0,-87.0,-88.0,15.0,22.0,17.0,14.0,1
1847,CC:2F:71:3E:C5:1F,3833758,483518839,851,104050,3832907,483414789,0,3548,298120,2928,224516,620,73604,901,8,1222,19,0,37,130000.0,39000.0,-72.0,-70.0,-68.0,-61.0,-72.0,-70.0,-67.0,-60.0,-89.0,-89.0,-87.0,-88.0,17.0,19.0,19.0,27.0,1
1848,BA:8C:B9:54:50:24,3837720,489595002,4813,6180213,3832907,483414789,0,8821,1687461,8799,1683966,22,3495,2345,15,5238,39,0,56,216660.0,130000.0,-41.0,-39.0,-47.0,-52.0,-42.0,-36.0,-44.0,-48.0,-89.0,-89.0,-87.0,-88.0,48.0,50.0,40.0,36.0,1
1849,92:69:1D:31:68:E9,3836773,487021473,3862,3606280,3832911,483415193,0,4604,1079700,4468,1048975,136,30725,2078,10,4048,84,0,41,216660.0,130000.0,-52.0,-48.0,-44.0,-47.0,-52.0,-47.0,-44.0,-47.0,-89.0,-89.0,-87.0,-88.0,37.0,41.0,43.0,41.0,1
1850,CC:2F:71:3F:1F:24,4531847,1222251529,698936,738836336,3832911,483415193,37,560397,572753279,559695,572668775,702,84504,541488,15,699184,79499,34,477,130000.0,43333.0,-73.0,-67.0,-70.0,-74.0,-73.0,-67.0,-69.0,-73.0,-89.0,-89.0,-87.0,-88.0,16.0,22.0,17.0,14.0,1
1851,CC:2F:71:3E:C5:1F,3833762,483519243,851,104050,3832911,483415193,0,3548,298120,2928,224516,620,73604,901,8,1222,19,0,37,130000.0,39000.0,-72.0,-70.0,-68.0,-61.0,-72.0,-70.0,-67.0,-60.0,-89.0,-89.0,-87.0,-88.0,17.0,19.0,19.0,27.0,1
1852,BA:8C:B9:54:50:24,3837724,489595406,4813,6180213,3832911,483415193,0,8821,1687461,8799,1683966,22,3495,2345,15,5238,39,0,56,216660.0,130000.0,-41.0,-39.0,-47.0,-52.0,-42.0,-36.0,-44.0,-48.0,-89.0,-89.0,-87.0,-88.0,48.0,50.0,40.0,36.0,1
1853,92:69:1D:31:68:E9,3836778,487021937,3862,3606280,3832916,483415657,0,4604,1079700,4468,1048975,136,30725,2078,10,4048,84,0,41,216660.0,130000.0,-52.0,-48.0,-44.0,-47.0,-52.0,-47.0,-44.0,-47.0,-89.0,-89.0,-87.0,-88.0,37.0,41.0,43.0,41.0,1
1854,CC:2F:71:3F:1F:24,4531898,1222269640,698982,738853983,3832916,483415657,37,560426,572758508,559724,572674004,702,84504,541514,15,699230,79504,34,477,130000.0,43333.0,-72.0,-67.0,-71.0,-74.0,-72.0,-67.0,-70.0,-73.0,-89.0,-89.0,-87.0,-88.0,17.0,22.0,16.0,14.0,1
1855,CC:2F:71:3E:C5:1F,3833767,483519707,851,104050,3832916,483415657,0,3548,298120,2928,224516,620,73604,901,8,1222,19,0,37,130000.0,39000.0,-72.0,-70.0,-68.0,-61.0,-72.0,-70.0,-67.0,-60.0,-89.0,-89.0,-87.0,-88.0,17.0,19.0,19.0,27.0,1
1856,BA:8C:B9:54:50:24,3837729,489595870,4813,6180213,3832916,483415657,0,8821,1687461,8799,1683966,22,3495,2345,15,5238,39,0,56,216660.0,130000.0,-41.0,-39.0,-47.0,-52.0,-42.0,-36.0,-44.0,-48.0,-89.0,-89.0,-87.0,-88.0,48.0,50.0,40.0,36.0,1
1857,92:69:1D:31:68:E9,3836780,487022139,3862,3606280,3832918,483415859,0,4604,1079700,4468,1048975,136,30725,2078,10,4048,84,0,41,216660.0,130000.0,-52.0,-48.0,-44.0,-47.0,-52.0,-47.0,-44.0,-47.0,-89.0,-89.0,-87.0,-88.0,37.0,41.0,43.0,41.0,1
1858,CC:2F:71:3F:1F:24,4532289,1222782363,699369,739366302,3832920,483416061,37,560587,572783335,559885,572698831,702,84504,541659,15,699617,79658,34,479,130000.0,39000.0,-72.0,-67.0,-71.0,-73.0,-72.0,-66.0,-70.0,-73.0,-89.0,-89.0,-87.0,-88.0,17.0,22.0,16.0,15.0,1
1859,CC:2F:71:3E:C5:1F,3833771,483520111,851,104050,3832920,483416061,0,3548,298120,2928,224516,620,73604,901,8,1222,19,0,37,130000.0,39000.0,-72.0,-70.0,-68.0,-61.0,-72.0,-70.0,-67.0,-60.0,-89.0,-89.0,-87.0,-88.0,17.0,19.0,19.0,27.0,1
1860,BA:8C:B9:54:50:24,3837733,489596274,4813,6180213,3832920,483416061,0,8821,1687461,8799,1683966,22,3495,2345,15,5238,39,0,56,216660.0,130000.0,-41.0,-39.0,-47.0,-52.0,-42.0,-36.0,-44.0,-48.0,-89.0,-89.0,-87.0,-88.0,48.0,50.0,40.0,36.0,1
1861,92:69:1D:31:68:E9,3836788,487023078,3862,3606280,3832926,483416798,0,4604,1079700,4468,1048975,136,30725,2078,10,4048,84,0,41,216660.0,130000.0,-52.0,-48.0,-44.0,-47.0,-52.0,-47.0,-44.0,-47.0,-89.0,-89.0,-87.0,-88.0,37.0,41.0,43.0,41.0,1
1862,CC:2F:71:3F:1F:24,4532628,1223106024,699702,739689226,3832926,483416798,37,560772,572814014,560070,572729510,702,84504,541835,15,699950,79777,34,479,117000.0,39000.0,-73.0,-67.0,-70.0,-73.0,-72.0,-67.0,-70.0,-73.0,-89.0,-89.0,-87.0,-88.0,16.0,22.0,17.0,15.0,1
1863,CC:2F:71:3E:C5:1F,3833777,483520848,851,104050,3832926,483416798,0,3548,298120,2928,224516,620,73604,901,8,1222,19,0,37,130000.0,39000.0,-72.0,-70.0,-68.0,-61.0,-72.0,-70.0,-67.0,-60.0,-89.0,-89.0,-87.0,-88.0,17.0,19.0,19.0,27.0,1
1864,BA:8C:B9:54:50:24,3837741,489597213,4813,6180213,3832928,483417000,0,8822,1687529,8800,1684034,22,3495,2345,15,5238,39,0,56,216660.0,130000.0,-39.0,-37.0,-45.0,-52.0,-41.0,-36.0,-44.0,-49.0,-89.0,-89.0,-87.0,-88.0,50.0,52.0,42.0,36.0,1
1865,92:69:1D:31:68:E9,3836792,487023482,3862,3606280,3832930,483417202,0,4604,1079700,4468,1048975,136,30725,2078,10,4048,84,0,41,216660.0,130000.0,-52.0,-48.0,-44.0,-47.0,-52.0,-47.0,-44.0,-47.0,-89.0,-89.0,-87.0,-88.0,37.0,41.0,43.0,41.0,1
1866,CC:2F:71:3F:1F:24,4532867,1223366497,699937,739949295,3832930,483417202,37,560898,572832594,560196,572748090,702,84504,541953,15,700185,79858,34,479,117000.0,39000.0,-73.0,-67.0,-71.0,-73.0,-73.0,-67.0,-70.0,-73.0,-89.0,-89.0,-87.0,-88.0,16.0,22.0,16.0,15.0,1
1867,CC:2F:71:3E:C5:1F,3833781,483521252,851,104050,3832930,483417202,0,3548,298120,2928,224516,620,73604,901,8,1222,19,0,37,130000.0,39000.0,-72.0,-70.0,-68.0,-61.0,-72.0,-70.0,-67.0,-60.0,-89.0,-89.0,-87.0,-88.0,17.0,19.0,19.0,27.0,1
1868,BA:8C:B9:54:50:24,3837743,489597415,4813,6180213,3832930,483417202,0,8822,1687529,8800,1684034,22,3495,2345,15,5238,39,0,56,216660.0,130000.0,-39.0,-37.0,-45.0,-52.0,-41.0,-36.0,-44.0,-49.0,-89.0,-89.0,-87.0,-88.0,50.0,52.0,42.0,36.0,1
1869,92:69:1D:31:68:E9,3836796,487023886,3862,3606280,3832934,483417606,0,4604,1079700,4468,1048975,136,30725,2078,10,4048,84,0,41,216660.0,130000.0,-52.0,-48.0,-44.0,-47.0,-52.0,-47.0,-44.0,-47.0,-89.0,-89.0,-87.0,-88.0,37.0,41.0,43.0,41.0,1
1870,CC:2F:71:3F:1F:24,4532910,1223380963,699976,739963357,3832934,483417606,37,560920,572836444,560218,572751940,702,84504,541974,15,700224,79861,34,479,130000.0,43333.0,-73.0,-67.0,-71.0,-74.0,-73.0,-67.0,-70.0,-73.0,-89.0,-89.0,-87.0,-88.0,16.0,22.0,16.0,14.0,1
1871,CC:2F:71:3E:C5:1F,3833785,483521656,851,104050,3832934,483417606,0,3548,298120,2928,224516,620,73604,901,8,1222,19,0,37,130000.0,39000.0,-72.0,-70.0,-68.0,-61.0,-72.0,-70.0,-67.0,-60.0,-89.0,-89.0,-87.0,-88.0,17.0,19.0,19.0,27.0,1
1872,BA:8C:B9:54:50:24,3837747,489597819,4813,6180213,3832934,483417606,0,8822,1687529,8800,1684034,22,3495,2345,15,5238,39,0,56,216660.0,130000.0,-39.0,-37.0,-45.0,-52.0,-41.0,-36.0,-44.0,-49.0,-89.0,-89.0,-87.0,-88.0,50.0,52.0,42.0,36.0,1
1873,92:69:1D:31:68:E9,3836799,487024148,3862,3606280,3832937,483417868,0,4604,1079700,4468,1048975,136,30725,2078,10,4048,84,0,41,216660.0,130000.0,-52.0,-48.0,-44.0,-47.0,-52.0,-47.0,-44.0,-47.0,-89.0,-89.0,-87.0,-88.0,37.0,41.0,43.0,41.0,1
1874,CC:2F:71:3F:1F:24,4532953,1223395473,700016,739977605,3832937,483417868,37,560945,572840656,560243,572756152,702,84504,541997,15,700264,79867,34,479,130000.0,39000.0,-74.0,-67.0,-70.0,-74.0,-73.0,-67.0,-70.0,-74.0,-89.0,-89.0,-87.0,-88.0,15.0,22.0,17.0,14.0,1
1875,CC:2F:71:3E:C5:1F,3833790,483522120,851,104050,3832939,483418070,0,3548,298120,2928,224516,620,73604,901,8,1222,19,0,37,130000.0,39000.0,-72.0,-70.0,-68.0,-61.0,-72.0,-70.0,-67.0,-60.0,-89.0,-89.0,-87.0,-88.0,17.0,19.0,19.0,27.0,1
1876,BA:8C:B9:54:50:24,3837752,489598283,4813,6180213,3832939,483418070,0,8822,1687529,8800,1684034,22,3495,2345,15,5238,39,0,56,216660.0,130000.0,-39.0,-37.0,-45.0,-52.0,-41.0,-36.0,-44.0,-49.0,-89.0,-89.0,-87.0,-88.0,50.0,52.0,42.0,36.0,1
1877,92:69:1D:31:68:E9,3836805,487024754,3862,3606280,3832943,483418474,0,4604,1079700,4468,1048975,136,30725,2078,10,4048,84,0,41,216660.0,130000.0,-52.0,-48.0,-44.0,-47.0,-52.0,-47.0,-44.0,-47.0,-89.0,-89.0,-87.0,-88.0,37.0,41.0,43.0,41.0,1
1878,CC:2F:71:3F:1F:24,4532998,1223409973,700055,739991499,3832943,483418474,37,560970,572844868,560268,572760364,702,84504,542020,15,700303,79896,34,479,130000.0,39000.0,-73.0,-67.0,-71.0,-74.0,-73.0,-67.0,-70.0,-74.0,-89.0,-89.0,-87.0,-88.0,16.0,22.0,16.0,14.0,1
1879,CC:2F:71:3E:C5:1F,3833794,483522524,851,104050,3832943,483418474,0,3548,298120,2928,224516,620,73604,901,8,1222,19,0,37,130000.0,39000.0,-72.0,-70.0,-68.0,-61.0,-72.0,-70.0,-67.0,-60.0,-89.0,-89.0,-87.0,-88.0,17.0,19.0,19.0,27.0,1
1880,BA:8C:B9:54:50:24,3837756,489598687,4813,6180213,3832943,483418474,0,8822,1687529,8800,1684034,22,3495,2345,15,5238,39,0,56,216660.0,130000.0,-39.0,-37.0,-45.0,-52.0,-41.0,-36.0,-44.0,-49.0,-89.0,-89.0,-87.0,-88.0,50.0,52.0,42.0,36.0,1
1881,92:69:1D:31:68:E9,3836807,487024956,3862,3606280,3832945,483418676,0,4604,1079700,4468,1048975,136,30725,2078,10,4048,84,0,41,216660.0,130000.0,-52.0,-48.0,-44.0,-47.0,-52.0,-47.0,-44.0,-47.0,-89.0,-89.0,-87.0,-88.0,37.0,41.0,43.0,41.0,1
1882,CC:2F:71:3F:1F:24,4533047,1223427784,700102,740009108,3832945,483418676,37,561000,572850091,560298,572765587,702,84504,542048,15,700350,79922,34,479,130000.0,43333.0,-73.0,-67.0,-70.0,-74.0,-73.0,-67.0,-70.0,-74.0,-89.0,-89.0,-87.0,-88.0,16.0,22.0,17.0,14.0,1
1883,CC:2F:71:3E:C5:1F,3833798,483522928,851,104050,3832947,483418878,0,3548,298120,2928,224516,620,73604,901,8,1222,19,0,37,130000.0,39000.0,-72.0,-70.0,-68.0,-61.0,-72.0,-70.0,-67.0,-60.0,-89.0,-89.0,-87.0,-88.0,17.0,19.0,19.0,27.0,1
1884,BA:8C:B9:54:50:24,3837761,489599151,4813,6180213,3832948,483418938,0,8822,1687529,8800,1684034,22,3495,2345,15,5238,39,0,56,216660.0,130000.0,-39.0,-37.0,-45.0,-52.0,-41.0,-36.0,-44.0,-49.0,-89.0,-89.0,-87.0,-88.0,50.0,52.0,42.0,36.0,1
1885,92:69:1D:31:68:E9,3836814,487025622,3862,3606280,3832952,483419342,0,4604,1079700,4468,1048975,136,30725,2078,10,4048,84,0,41,216660.0,130000.0,-52.0,-48.0,-44.0,-47.0,-52.0,-47.0,-44.0,-47.0,-89.0,-89.0,-87.0,-88.0,37.0,41.0,43.0,41.0,1
1886,CC:2F:71:3F:1F:24,4533096,1223443014,700144,740023672,3832952,483419342,37,561024,572854173,560322,572769669,702,84504,542071,15,700392,79939,34,479,130000.0,43333.0,-73.0,-67.0,-70.0,-75.0,-73.0,-67.0,-70.0,-74.0,-89.0,-89.0,-87.0,-88.0,16.0,22.0,17.0,13.0,1
1887,CC:2F:71:3E:C5:1F,3833803,483523392,851,104050,3832952,483419342,0,3548,298120,2928,224516,620,73604,901,8,1222,19,0,37,130000.0,39000.0,-72.0,-70.0,-68.0,-61.0,-72.0,-70.0,-67.0,-60.0,-89.0,-89.0,-87.0,-88.0,17.0,19.0,19.0,27.0,1
1888,BA:8C:B9:54:50:24,3837765,489599555,4813,6180213,3832952,483419342,0,8822,1687529,8800,1684034,22,3495,2345,15,5238,39,0,56,216660.0,130000.0,-39.0,-37.0,-45.0,-52.0,-41.0,-36.0,-44.0,-49.0,-89.0,-89.0,-87.0,-88.0,50.0,52.0,42.0,36.0,1
1889,92:69:1D:31:68:E9,3836816,487025824,3862,3606280,3832954,483419544,0,4604,1079700,4468,1048975,136,30725,2078,10,4048,84,0,41,216660.0,130000.0,-52.0,-48.0,-44.0,-47.0,-52.0,-47.0,-44.0,-47.0,-89.0,-89.0,-87.0,-88.0,37.0,41.0,43.0,41.0,1
1890,CC:2F:71:3F:1F:24,4533138,1223457408,700184,740037864,3832954,483419544,37,561047,572858139,560345,572773635,702,84504,542093,15,700432,79964,34,479,117000.0,39000.0,-74.0,-68.0,-72.0,-75.0,-74.0,-67.0,-71.0,-75.0,-89.0,-89.0,-87.0,-88.0,15.0,21.0,15.0,13.0,1
1891,CC:2F:71:3E:C5:1F,3833805,483523594,851,104050,3832954,483419544,0,3548,298120,2928,224516,620,73604,901,8,1222,19,0,37,130000.0,39000.0,-72.0,-70.0,-68.0,-61.0,-72.0,-70.0,-67.0,-60.0,-89.0,-89.0,-87.0,-88.0,17.0,19.0,19.0,27.0,1
1892,BA:8C:B9:54:50:24,3837767,489599757,4813,6180213,3832954,483419544,0,8822,1687529,8800,1684034,22,3495,2345,15,5238,39,0,56,216660.0,130000.0,-39.0,-37.0,-45.0,-52.0,-41.0,-36.0,-44.0,-49.0,-89.0,-89.0,-87.0,-88.0,50.0,52.0,42.0,36.0,1
1893,92:69:1D:31:68:E9,3836823,487026490,3862,3606280,3832961,483420210,0,4604,1079700,4468,1048975,136,30725,2078,10,4048,84,0,41,216660.0,130000.0,-52.0,-48.0,-44.0,-47.0,-52.0,-47.0,-44.0,-47.0,-89.0,-89.0,-87.0,-88.0,37.0,41.0,43.0,41.0,1
1894,CC:2F:71:3F:1F:24,4533183,1223472006,700222,740051796,3832961,483420210,37,561070,572862325,560368,572777821,702,84504,542113,15,700470,79994,34,479,130000.0,43333.0,-73.0,-67.0,-70.0,-74.0,-73.0,-67.0,-70.0,-74.0,-89.0,-89.0,-87.0,-88.0,16.0,22.0,17.0,14.0,1
1895,CC:2F:71:3E:C5:1F,3833812,483524260,851,104050,3832961,483420210,0,3548,298120,2928,224516,620,73604,901,8,1222,19,0,37,130000.0,39000.0,-72.0,-70.0,-68.0,-61.0,-72.0,-70.0,-67.0,-60.0,-89.0,-89.0,-87.0,-88.0,17.0,19.0,19.0,27.0,1
1896,BA:8C:B9:54:50:24,3837774,489600423,4813,6180213,3832961,483420210,0,8822,1687529,8800,1684034,22,3495,2345,15,5238,39,0,56,216660.0,130000.0,-39.0,-37.0,-45.0,-52.0,-41.0,-36.0,-44.0,-49.0,-89.0,-89.0,-87.0,-88.0,50.0,52.0,42.0,36.0,1
1897,92:69:1D:31:68:E9,3836825,487026692,3862,3606280,3832963,483420412,0,4604,1079700,4468,1048975,136,30725,2078,10,4048,84,0,41,216660.0,130000.0,-52.0,-48.0,-44.0,-47.0,-52.0,-47.0,-44.0,-47.0,-89.0,-89.0,-87.0,-88.0,37.0,41.0,43.0,41.0,1
1898,CC:2F:71:3F:1F:24,4533231,1223489743,700268,740069331,3832963,483420412,37,561099,572867431,560397,572782927,702,84504,542140,15,700516,80016,34,479,144444.0,39000.0,-73.0,-68.0,-69.0,-72.0,-73.0,-67.0,-69.0,-71.0,-89.0,-89.0,-87.0,-88.0,16.0,21.0,18.0,16.0,1
1899,CC:2F:71:3E:C5:1F,3833814,483524462,851,104050,3832963,483420412,0,3548,298120,2928,224516,620,73604,901,8,1222,19,0,37,130000.0,39000.0,-72.0,-70.0,-68.0,-61.0,-72.0,-70.0,-67.0,-60.0,-89.0,-89.0,-87.0,-88.0,17.0,19.0,19.0,27.0,1
1900,BA:8C:B9:54:50:24,3837776,489600625,4813,6180213,3832963,483420412,0,8822,1687529,8800,1684034,22,3495,2345,15,5238,39,0,56,216660.0,130000.0,-39.0,-37.0,-45.0,-52.0,-41.0,-36.0,-44.0,-49.0,-89.0,-89.0,-87.0,-88.0,50.0,52.0,42.0,36.0,1
1901,92:69:1D:31:68:E9,3836831,487027298,3862,3606280,3832969,483421018,0,4604,1079700,4468,1048975,136,30725,2078,10,4048,84,0,41,216660.0,130000.0,-52.0,-48.0,-44.0,-47.0,-52.0,-47.0,-44.0,-47.0,-89.0,-89.0,-87.0,-88.0,37.0,41.0,43.0,41.0,1
1902,CC:2F:71:3F:1F:24,4533276,1223504467,700307,740083449,3832969,483421018,37,561122,572871491,560420,572786987,702,84504,542161,15,700555,80016,34,479,144444.0,43333.0,-73.0,-66.0,-70.0,-74.0,-73.0,-65.0,-69.0,-73.0,-89.0,-89.0,-87.0,-88.0,16.0,23.0,17.0,14.0,1
1903,CC:2F:71:3E:C5:1F,3833820,483525068,851,104050,3832969,483421018,0,3548,298120,2928,224516,620,73604,901,8,1222,19,0,37,130000.0,39000.0,-72.0,-70.0,-68.0,-61.0,-72.0,-70.0,-67.0,-60.0,-89.0,-89.0,-87.0,-88.0,17.0,19.0,19.0,27.0,1
1904,BA:8C:B9:54:50:24,3837782,489601231,4813,6180213,3832969,483421018,0,8822,1687529,8800,1684034,22,3495,2345,15,5238,39,0,56,216660.0,130000.0,-39.0,-37.0,-45.0,-52.0,-41.0,-36.0,-44.0,-49.0,-89.0,-89.0,-87.0,-88.0,50.0,52.0,42.0,36.0,1
1905,92:69:1D:31:68:E9,3836834,487027560,3862,3606280,3832972,483421280,0,4604,1079700,4468,1048975,136,30725,2078,10,4048,84,0,41,216660.0,130000.0,-52.0,-48.0,-44.0,-47.0,-52.0,-47.0,-44.0,-47.0,-89.0,-89.0,-87.0,-88.0,37.0,41.0,43.0,41.0,1
1906,CC:2F:71:3F:1F:24,4533320,1223519163,700348,740097883,3832972,483421280,37,561155,572876936,560453,572792432,702,84504,542189,15,700596,80017,34,479,144444.0,43333.0,-71.0,-65.0,-71.0,-73.0,-71.0,-66.0,-70.0,-72.0,-89.0,-89.0,-87.0,-88.0,18.0,24.0,16.0,15.0,1
1907,CC:2F:71:3E:C5:1F,3833823,483525330,851,104050,3832972,483421280,0,3548,298120,2928,224516,620,73604,901,8,1222,19,0,37,130000.0,39000.0,-72.0,-70.0,-68.0,-61.0,-72.0,-70.0,-67.0,-60.0,-89.0,-89.0,-87.0,-88.0,17.0,19.0,19.0,27.0,1
1908,BA:8C:B9:54:50:24,3837785,489601493,4813,6180213,3832972,483421280,0,8822,1687529,8800,1684034,22,3495,2345,15,5238,39,0,56,216660.0,130000.0,-39.0,-37.0,-45.0,-52.0,-41.0,-36.0,-44.0,-49.0,-89.0,-89.0,-87.0,-88.0,50.0,52.0,42.0,36.0,1
1909,92:69:1D:31:68:E9,3836842,487028288,3863,3606340,3832979,483421948,0,4606,1079836,4470,1049111,136,30725,2078,10,4049,84,0,41,216660.0,130000.0,-52.0,-47.0,-42.0,-49.0,-52.0,-47.0,-43.0,-47.0,-89.0,-90.0,-87.0,-88.0,37.0,43.0,45.0,39.0,1
1910,CC:2F:71:3F:1F:24,4533367,1223534121,700388,740112173,3832979,483421948,37,561177,572880786,560475,572796282,702,84504,542210,15,700636,80024,34,479,144444.0,43333.0,-70.0,-67.0,-70.0,-74.0,-70.0,-66.0,-70.0,-74.0,-89.0,-90.0,-87.0,-88.0,19.0,23.0,17.0,14.0,1
1911,CC:2F:71:3E:C5:1F,3833831,483526114,852,104166,3832979,483421948,0,3552,298448,2931,224726,621,73722,902,8,1223,19,0,37,130000.0,39000.0,-72.0,-70.0,-67.0,-60.0,-71.0,-70.0,-67.0,-60.0,-89.0,-90.0,-87.0,-88.0,17.0,20.0,20.0,28.0,1
1912,BA:8C:B9:54:50:24,3837793,489602277,4814,6180329,3832979,483421948,0,8824,1687665,8802,1684170,22,3495,2345,15,5239,39,0,56,216660.0,130000.0,-48.0,-35.0,-42.0,-45.0,-42.0,-36.0,-44.0,-48.0,-89.0,-90.0,-87.0,-88.0,41.0,55.0,45.0,43.0,1
1913,92:69:1D:31:68:E9,3836844,487028490,3863,3606340,3832981,483422150,0,4606,1079836,4470,1049111,136,30725,2078,10,4049,84,0,41,216660.0,130000.0,-52.0,-47.0,-42.0,-49.0,-52.0,-47.0,-43.0,-47.0,-89.0,-90.0,-87.0,-88.0,37.0,43.0,45.0,39.0,1
1914,CC:2F:71:3F:1F:24,4533417,1223552292,700436,740130142,3832981,483422150,37,561209,572886429,560507,572801925,702,84504,542239,15,700684,80055,34,479,144444.0,43333.0,-69.0,-67.0,-70.0,-73.0,-69.0,-67.0,-70.0,-72.0,-89.0,-90.0,-87.0,-88.0,20.0,23.0,17.0,15.0,1
1915,CC:2F:71:3E:C5:1F,3833833,483526316,852,104166,3832981,483422150,0,3552,298448,2931,224726,621,73722,902,8,1223,19,0,37,130000.0,39000.0,-72.0,-70.0,-67.0,-60.0,-71.0,-70.0,-67.0,-60.0,-89.0,-90.0,-87.0,-88.0,17.0,20.0,20.0,28.0,1
1916,BA:8C:B9:54:50:24,3837797,489602812,4814,6180329,3832983,483422483,0,8824,1687665,8802,1684170,22,3495,2345,15,5239,39,0,56,216660.0,130000.0,-48.0,-35.0,-42.0,-45.0,-42.0,-36.0,-44.0,-48.0,-89.0,-90.0,-87.0,-88.0,41.0,55.0,45.0,43.0,1
1917,92:69:1D:31:68:E9,3836852,487029429,3863,3606340,3832989,483423089,0,4606,1079836,4470,1049111,136,30725,2078,10,4049,84,0,41,216660.0,130000.0,-52.0,-47.0,-42.0,-49.0,-52.0,-47.0,-43.0,-47.0,-89.0,-90.0,-87.0,-88.0,37.0,43.0,45.0,39.0,1
1918,CC:2F:71:3F:1F:24,4533465,1223567423,700476,740144334,3832989,483423089,37,561235,572890915,560533,572806411,702,84504,542262,15,700724,80104,34,479,144444.0,43333.0,-70.0,-67.0,-70.0,-72.0,-70.0,-67.0,-70.0,-72.0,-89.0,-90.0,-87.0,-88.0,19.0,23.0,17.0,16.0,1
1919,CC:2F:71:3E:C5:1F,3833841,483527255,852,104166,3832989,483423089,0,3552,298448,2931,224726,621,73722,902,8,1223,19,0,37,130000.0,39000.0,-72.0,-70.0,-67.0,-60.0,-71.0,-70.0,-67.0,-60.0,-89.0,-90.0,-87.0,-88.0,17.0,20.0,20.0,28.0,1
1920,BA:8C:B9:54:50:24,3837803,489603418,4814,6180329,3832989,483423089,0,8824,1687665,8802,1684170,22,3495,2345,15,5239,39,0,56,216660.0,130000.0,-48.0,-35.0,-42.0,-45.0,-42.0,-36.0,-44.0,-48.0,-89.0,-90.0,-87.0,-88.0,41.0,55.0,45.0,43.0,1
1921,92:69:1D:31:68:E9,3836854,487029631,3863,3606340,3832991,483423291,0,4606,1079836,4470,1049111,136,30725,2078,10,4049,84,0,41,216660.0,130000.0,-52.0,-47.0,-42.0,-49.0,-52.0,-47.0,-43.0,-47.0,-89.0,-90.0,-87.0,-88.0,37.0,43.0,45.0,39.0,1
1922,CC:2F:71:3F:1F:24,4533505,1223581557,700514,740158266,3832991,483423291,37,561261,572895685,560559,572811181,702,84504,542283,15,700762,80140,34,479,144444.0,43333.0,-70.0,-67.0,-70.0,-72.0,-70.0,-67.0,-70.0,-72.0,-89.0,-90.0,-87.0,-88.0,19.0,23.0,17.0,16.0,1
1923,CC:2F:71:3E:C5:1F,3833843,483527457,852,104166,3832991,483423291,0,3552,298448,2931,224726,621,73722,902,8,1223,19,0,37,130000.0,39000.0,-72.0,-70.0,-67.0,-60.0,-71.0,-70.0,-67.0,-60.0,-89.0,-90.0,-87.0,-88.0,17.0,20.0,20.0,28.0,1
1924,BA:8C:B9:54:50:24,3837806,489603682,4814,6180329,3832992,483423353,0,8824,1687665,8802,1684170,22,3495,2345,15,5239,39,0,56,216660.0,130000.0,-48.0,-35.0,-42.0,-45.0,-42.0,-36.0,-44.0,-48.0,-89.0,-90.0,-87.0,-88.0,41.0,55.0,45.0,43.0,1
1925,92:69:1D:31:68:E9,3836860,487030157,3863,3606340,3832997,483423817,0,4606,1079836,4470,1049111,136,30725,2078,10,4049,84,0,41,216660.0,130000.0,-52.0,-47.0,-42.0,-49.0,-52.0,-47.0,-43.0,-47.0,-89.0,-90.0,-87.0,-88.0,37.0,43.0,45.0,39.0,1
1926,CC:2F:71:3F:1F:24,4533770,1223850678,700771,740426659,3832999,483424019,37,561383,572917174,560680,572832552,703,84622,542400,15,701019,80194,34,479,130000.0,43333.0,-75.0,-71.0,-73.0,-78.0,-73.0,-69.0,-72.0,-75.0,-89.0,-90.0,-87.0,-88.0,14.0,19.0,14.0,10.0,1
1927,CC:2F:71:3E:C5:1F,3833851,483528185,852,104166,3832999,483424019,0,3552,298448,2931,224726,621,73722,902,8,1223,19,0,37,130000.0,39000.0,-72.0,-70.0,-67.0,-60.0,-71.0,-70.0,-67.0,-60.0,-89.0,-90.0,-87.0,-88.0,17.0,20.0,20.0,28.0,1
1928,BA:8C:B9:54:50:24,3837813,489604348,4814,6180329,3832999,483424019,0,8824,1687665,8802,1684170,22,3495,2345,15,5239,39,0,56,216660.0,130000.0,-48.0,-35.0,-42.0,-45.0,-42.0,-36.0,-44.0,-48.0,-89.0,-90.0,-87.0,-88.0,41.0,55.0,45.0,43.0,1
1929,92:69:1D:31:68:E9,3836863,487030493,3863,3606340,3833000,483424153,0,4606,1079836,4470,1049111,136,30725,2078,10,4049,84,0,41,216660.0,130000.0,-52.0,-47.0,-42.0,-49.0,-52.0,-47.0,-43.0,-47.0,-89.0,-90.0,-87.0,-88.0,37.0,43.0,45.0,39.0,1
1930,CC:2F:71:3F:1F:24,4534038,1224124303,701037,740700082,3833001,483424221,37,561510,572938625,560807,572854003,703,84622,542525,15,701285,80215,34,479,130000.0,43333.0,-76.0,-71.0,-73.0,-78.0,-75.0,-70.0,-73.0,-77.0,-89.0,-90.0,-87.0,-88.0,13.0,19.0,14.0,10.0,1
1931,CC:2F:71:3E:C5:1F,3833853,483528387,852,104166,3833001,483424221,0,3552,298448,2931,224726,621,73722,902,8,1223,19,0,37,130000.0,39000.0,-72.0,-70.0,-67.0,-60.0,-71.0,-70.0,-67.0,-60.0,-89.0,-90.0,-87.0,-88.0,17.0,20.0,20.0,28.0,1
1932,BA:8C:B9:54:50:24,3837815,489604550,4814,6180329,3833001,483424221,0,8824,1687665,8802,1684170,22,3495,2345,15,5239,39,0,56,216660.0,130000.0,-48.0,-35.0,-42.0,-45.0,-42.0,-36.0,-44.0,-48.0,-89.0,-90.0,-87.0,-88.0,41.0,55.0,45.0,43.0,1
1933,92:69:1D:31:68:E9,3836868,487030965,3863,3606340,3833005,483424625,0,4606,1079836,4470,1049111,136,30725,2078,10,4049,84,0,41,216660.0,130000.0,-52.0,-47.0,-42.0,-49.0,-52.0,-47.0,-43.0,-47.0,-89.0,-90.0,-87.0,-88.0,37.0,43.0,45.0,39.0,1
1934,CC:2F:71:3F:1F:24,4534421,1224590359,701414,741165532,3833007,483424827,37,561660,572961039,560957,572876417,703,84622,542674,15,701662,80236,34,479,130000.0,43333.0,-76.0,-70.0,-74.0,-79.0,-76.0,-70.0,-73.0,-77.0,-89.0,-90.0,-87.0,-88.0,13.0,20.0,13.0,9.0,1
1935,CC:2F:71:3E:C5:1F,3833859,483528993,852,104166,3833007,483424827,0,3552,298448,2931,224726,621,73722,902,8,1223,19,0,37,130000.0,39000.0,-72.0,-70.0,-67.0,-60.0,-71.0,-70.0,-67.0,-60.0,-89.0,-90.0,-87.0,-88.0,17.0,20.0,20.0,28.0,1
1936,BA:8C:B9:54:50:24,3837821,489605156,4814,6180329,3833007,483424827,0,8824,1687665,8802,1684170,22,3495,2345,15,5239,39,0,56,216660.0,130000.0,-48.0,-35.0,-42.0,-45.0,-42.0,-36.0,-44.0,-48.0,-89.0,-90.0,-87.0,-88.0,41.0,55.0,45.0,43.0,1
1937,92:69:1D:31:68:E9,3836871,487031227,3863,3606340,3833008,483424887,0,4606,1079836,4470,1049111,136,30725,2078,10,4049,84,0,41,216660.0,130000.0,-52.0,-47.0,-42.0,-49.0,-52.0,-47.0,-43.0,-47.0,-89.0,-90.0,-87.0,-88.0,37.0,43.0,45.0,39.0,1
1938,CC:2F:71:3F:1F:24,4534711,1224892522,701703,741467635,3833008,483424887,37,561815,572984704,561112,572900082,703,84622,542824,15,701951,80256,34,479,130000.0,43333.0,-73.0,-67.0,-70.0,-75.0,-72.0,-67.0,-70.0,-74.0,-89.0,-90.0,-87.0,-88.0,16.0,23.0,17.0,13.0,1
1939,CC:2F:71:3E:C5:1F,3833862,483529255,852,104166,3833010,483425089,0,3552,298448,2931,224726,621,73722,902,8,1223,19,0,37,130000.0,39000.0,-72.0,-70.0,-67.0,-60.0,-71.0,-70.0,-67.0,-60.0,-89.0,-90.0,-87.0,-88.0,17.0,20.0,20.0,28.0,1
1940,BA:8C:B9:54:50:24,3837824,489605418,4814,6180329,3833010,483425089,0,8824,1687665,8802,1684170,22,3495,2345,15,5239,39,0,56,216660.0,130000.0,-48.0,-35.0,-42.0,-45.0,-42.0,-36.0,-44.0,-48.0,-89.0,-90.0,-87.0,-88.0,41.0,55.0,45.0,43.0,1
1941,92:69:1D:31:68:E9,3836877,487031833,3863,3606340,3833014,483425493,0,4608,1079972,4472,1049247,136,30725,2078,10,4050,84,0,41,216660.0,130000.0,-52.0,-47.0,-43.0,-48.0,-52.0,-47.0,-43.0,-47.0,-89.0,-90.0,-87.0,-88.0,37.0,43.0,44.0,40.0,1
1942,CC:2F:71:3F:1F:24,4535170,1225405306,702154,741979611,3833016,483425695,37,562045,573022327,561342,572937705,703,84622,543040,15,702402,80261,34,479,130000.0,43333.0,-73.0,-68.0,-71.0,-76.0,-73.0,-68.0,-71.0,-74.0,-89.0,-90.0,-87.0,-88.0,16.0,22.0,16.0,12.0,1
1943,CC:2F:71:3E:C5:1F,3833868,483529861,852,104166,3833016,483425695,0,3554,298588,2933,224866,621,73722,902,8,1224,19,0,37,130000.0,39000.0,-71.0,-71.0,-67.0,-60.0,-71.0,-70.0,-67.0,-60.0,-89.0,-90.0,-87.0,-88.0,18.0,19.0,20.0,28.0,1
1944,BA:8C:B9:54:50:24,3837830,489606024,4814,6180329,3833016,483425695,0,8828,1687937,8806,1684442,22,3495,2345,15,5240,39,0,56,216660.0,130000.0,-39.0,-36.0,-45.0,-51.0,-42.0,-36.0,-44.0,-49.0,-89.0,-90.0,-87.0,-88.0,50.0,54.0,42.0,37.0,1
1945,92:69:1D:31:68:E9,3836879,487032035,3863,3606340,3833016,483425695,0,4608,1079972,4472,1049247,136,30725,2078,10,4050,84,0,41,216660.0,130000.0,-52.0,-47.0,-43.0,-48.0,-52.0,-47.0,-43.0,-47.0,-89.0,-90.0,-87.0,-88.0,37.0,43.0,44.0,40.0,1
1946,CC:2F:71:3F:1F:24,4535549,1225871679,702533,742445984,3833016,483425695,37,562213,573046992,561510,572962370,703,84622,543200,15,702781,80275,34,479,117000.0,39000.0,-73.0,-68.0,-71.0,-75.0,-72.0,-67.0,-71.0,-74.0,-89.0,-90.0,-87.0,-88.0,16.0,22.0,16.0,13.0,1
1947,CC:2F:71:3E:C5:1F,3833869,483529921,852,104166,3833017,483425755,0,3554,298588,2933,224866,621,73722,902,8,1224,19,0,37,130000.0,39000.0,-71.0,-71.0,-67.0,-60.0,-71.0,-70.0,-67.0,-60.0,-89.0,-90.0,-87.0,-88.0,18.0,19.0,20.0,28.0,1
1948,BA:8C:B9:54:50:24,3837833,489606286,4814,6180329,3833019,483425957,0,8828,1687937,8806,1684442,22,3495,2345,15,5240,39,0,56,216660.0,130000.0,-39.0,-36.0,-45.0,-51.0,-42.0,-36.0,-44.0,-49.0,-89.0,-90.0,-87.0,-88.0,50.0,54.0,42.0,37.0,1
1949,92:69:1D:31:68:E9,3836886,487032701,3863,3606340,3833023,483426361,0,4609,1080040,4473,1049315,136,30725,2078,10,4050,84,0,41,216660.0,130000.0,-52.0,-48.0,-44.0,-47.0,-52.0,-47.0,-43.0,-47.0,-89.0,-90.0,-87.0,-88.0,37.0,42.0,43.0,41.0,1
1950,CC:2F:71:3F:1F:24,4535650,1225927271,702625,742500708,3833025,483426563,37,562277,573057245,561574,572972623,703,84622,543260,15,702873,80279,34,479,130000.0,39000.0,-73.0,-68.0,-71.0,-74.0,-72.0,-67.0,-70.0,-74.0,-89.0,-90.0,-87.0,-88.0,16.0,22.0,16.0,14.0,1
1951,CC:2F:71:3E:C5:1F,3833877,483530729,852,104166,3833025,483426563,0,3554,298588,2933,224866,621,73722,902,8,1224,19,0,37,130000.0,39000.0,-71.0,-71.0,-67.0,-60.0,-71.0,-70.0,-67.0,-60.0,-89.0,-90.0,-87.0,-88.0,18.0,19.0,20.0,28.0,1
1952,BA:8C:B9:54:50:24,3837839,489606892,4814,6180329,3833025,483426563,0,8828,1687937,8806,1684442,22,3495,2345,15,5240,39,0,56,216660.0,130000.0,-39.0,-36.0,-45.0,-51.0,-42.0,-36.0,-44.0,-49.0,-89.0,-90.0,-87.0,-88.0,50.0,54.0,42.0,37.0,1
1953,92:69:1D:31:68:E9,3836888,487032903,3863,3606340,3833025,483426563,0,4609,1080040,4473,1049315,136,30725,2078,10,4050,84,0,41,216660.0,130000.0,-52.0,-48.0,-44.0,-47.0,-52.0,-47.0,-43.0,-47.0,-89.0,-90.0,-87.0,-88.0,37.0,42.0,43.0,41.0,1
1954,CC:2F:71:3F:1F:24,4535689,1225941333,702664,742514770,3833025,483426563,37,562300,573061211,561597,572976589,703,84622,543282,15,702912,80280,34,479,144444.0,43333.0,-72.0,-67.0,-70.0,-74.0,-72.0,-67.0,-70.0,-74.0,-89.0,-90.0,-87.0,-88.0,17.0,23.0,17.0,14.0,1
1955,CC:2F:71:3E:C5:1F,3833877,483530729,852,104166,3833025,483426563,0,3554,298588,2933,224866,621,73722,902,8,1224,19,0,37,130000.0,39000.0,-71.0,-71.0,-67.0,-60.0,-71.0,-70.0,-67.0,-60.0,-89.0,-90.0,-87.0,-88.0,18.0,19.0,20.0,28.0,1
1956,BA:8C:B9:54:50:24,3837839,489606892,4814,6180329,3833025,483426563,0,8828,1687937,8806,1684442,22,3495,2345,15,5240,39,0,56,216660.0,130000.0,-39.0,-36.0,-45.0,-51.0,-42.0,-36.0,-44.0,-49.0,-89.0,-90.0,-87.0,-88.0,50.0,54.0,42.0,37.0,1
1957,92:69:1D:31:68:E9,3836895,487033569,3863,3606340,3833032,483427229,0,4609,1080040,4473,1049315,136,30725,2078,10,4050,84,0,41,216660.0,130000.0,-52.0,-48.0,-44.0,-47.0,-52.0,-47.0,-43.0,-47.0,-89.0,-90.0,-87.0,-88.0,37.0,42.0,43.0,41.0,1
1958,CC:2F:71:3F:1F:24,4535739,1225956755,702707,742529526,3833032,483427229,37,562333,573066500,561630,572981878,703,84622,543309,15,702955,80285,34,479,144444.0,43333.0,-73.0,-68.0,-71.0,-74.0,-75.0,-70.0,-73.0,-75.0,-89.0,-90.0,-87.0,-88.0,16.0,22.0,16.0,14.0,1
1959,CC:2F:71:3E:C5:1F,3833886,483531597,852,104166,3833034,483427431,0,3554,298588,2933,224866,621,73722,902,8,1224,19,0,37,130000.0,39000.0,-71.0,-71.0,-67.0,-60.0,-71.0,-70.0,-67.0,-60.0,-89.0,-90.0,-87.0,-88.0,18.0,19.0,20.0,28.0,1
1960,BA:8C:B9:54:50:24,3837848,489607760,4814,6180329,3833034,483427431,0,8828,1687937,8806,1684442,22,3495,2345,15,5240,39,0,56,216660.0,130000.0,-39.0,-36.0,-45.0,-51.0,-42.0,-36.0,-44.0,-49.0,-89.0,-90.0,-87.0,-88.0,50.0,54.0,42.0,37.0,1
1961,92:69:1D:31:68:E9,3836920,487044794,3863,3606340,3833057,483438454,0,4612,1080411,4475,1049451,137,30960,2079,10,4050,84,0,41,216660.0,130000.0,-51.0,-48.0,-44.0,-46.0,-52.0,-48.0,-44.0,-47.0,-89.0,-90.0,-87.0,-88.0,38.0,42.0,43.0,42.0,1
1962,CC:2F:71:3F:1F:24,4535808,1225982896,702751,742544442,3833057,483438454,37,562360,573071022,561657,572986400,703,84622,543335,15,702999,80286,34,479,144444.0,43333.0,-72.0,-68.0,-71.0,-74.0,-72.0,-68.0,-71.0,-73.0,-89.0,-90.0,-87.0,-88.0,17.0,22.0,16.0,14.0,1
1963,CC:2F:71:3E:C5:1F,3833909,483542620,852,104166,3833057,483438454,0,3554,298588,2933,224866,621,73722,902,8,1224,19,0,37,130000.0,39000.0,-71.0,-71.0,-67.0,-60.0,-71.0,-70.0,-67.0,-60.0,-89.0,-90.0,-87.0,-88.0,18.0,19.0,20.0,28.0,1
1964,BA:8C:B9:54:50:24,3837871,489618783,4814,6180329,3833057,483438454,0,8828,1687937,8806,1684442,22,3495,2345,15,5240,39,0,56,216660.0,130000.0,-39.0,-36.0,-45.0,-51.0,-42.0,-36.0,-44.0,-49.0,-89.0,-90.0,-87.0,-88.0,50.0,54.0,42.0,37.0,1
1965,92:69:1D:31:68:E9,3836926,487045400,3863,3606340,3833063,483439060,0,4612,1080411,4475,1049451,137,30960,2079,10,4050,84,0,41,216660.0,130000.0,-51.0,-48.0,-44.0,-46.0,-52.0,-48.0,-44.0,-47.0,-89.0,-90.0,-87.0,-88.0,38.0,42.0,43.0,42.0,1
1966,CC:2F:71:3F:1F:24,4535861,1226001407,702798,742562347,3833063,483439060,37,562398,573077544,561695,572992922,703,84622,543368,15,703046,80288,34,479,144444.0,43333.0,-72.0,-68.0,-72.0,-73.0,-71.0,-67.0,-71.0,-73.0,-89.0,-90.0,-87.0,-88.0,17.0,22.0,15.0,15.0,1
1967,CC:2F:71:3E:C5:1F,3833917,483543428,852,104166,3833065,483439262,0,3554,298588,2933,224866,621,73722,902,8,1224,19,0,37,130000.0,39000.0,-71.0,-71.0,-67.0,-60.0,-71.0,-70.0,-67.0,-60.0,-89.0,-90.0,-87.0,-88.0,18.0,19.0,20.0,28.0,1
1968,BA:8C:B9:54:50:24,3837879,489619591,4814,6180329,3833065,483439262,0,8828,1687937,8806,1684442,22,3495,2345,15,5240,39,0,56,216660.0,130000.0,-39.0,-36.0,-45.0,-51.0,-42.0,-36.0,-44.0,-49.0,-89.0,-90.0,-87.0,-88.0,50.0,54.0,42.0,37.0,1
1969,92:69:1D:31:68:E9,3836930,487045935,3863,3606340,3833067,483439595,0,4612,1080411,4475,1049451,137,30960,2079,10,4050,84,0,41,216660.0,130000.0,-51.0,-48.0,-44.0,-46.0,-52.0,-48.0,-44.0,-47.0,-89.0,-90.0,-87.0,-88.0,38.0,42.0,43.0,42.0,1
1970,CC:2F:71:3F:1F:24,4535905,1226016292,702838,742576697,3833067,483439595,37,562423,573081898,561720,572997276,703,84622,543391,15,703086,80288,34,479,144444.0,43333.0,-73.0,-68.0,-71.0,-74.0,-74.0,-69.0,-73.0,-76.0,-89.0,-90.0,-87.0,-88.0,16.0,22.0,16.0,14.0,1
1971,CC:2F:71:3E:C5:1F,3833919,483543761,852,104166,3833067,483439595,0,3554,298588,2933,224866,621,73722,902,8,1224,19,0,37,130000.0,39000.0,-71.0,-71.0,-67.0,-60.0,-71.0,-70.0,-67.0,-60.0,-89.0,-90.0,-87.0,-88.0,18.0,19.0,20.0,28.0,1
1972,BA:8C:B9:54:50:24,3837881,489619924,4814,6180329,3833067,483439595,0,8828,1687937,8806,1684442,22,3495,2345,15,5240,39,0,56,216660.0,130000.0,-39.0,-36.0,-45.0,-51.0,-42.0,-36.0,-44.0,-49.0,-89.0,-90.0,-87.0,-88.0,50.0,54.0,42.0,37.0,1
1973,92:69:1D:31:68:E9,3836936,487046541,3863,3606340,3833073,483440201,0,4612,1080411,4475,1049451,137,30960,2079,10,4050,84,0,41,216660.0,130000.0,-51.0,-48.0,-44.0,-46.0,-52.0,-48.0,-44.0,-47.0,-89.0,-90.0,-87.0,-88.0,38.0,42.0,43.0,42.0,1
1974,CC:2F:71:3F:1F:24,4536172,1226287739,703099,742847538,3833073,483440201,37,562545,573102912,561842,573018290,703,84622,543510,15,703347,80401,34,479,144444.0,43333.0,-76.0,-71.0,-74.0,-77.0,-75.0,-71.0,-74.0,-77.0,-89.0,-90.0,-87.0,-88.0,13.0,19.0,13.0,11.0,1
1975,CC:2F:71:3E:C5:1F,3833926,483544435,852,104166,3833074,483440269,0,3554,298588,2933,224866,621,73722,902,8,1224,19,0,37,130000.0,39000.0,-71.0,-71.0,-67.0,-60.0,-71.0,-70.0,-67.0,-60.0,-89.0,-90.0,-87.0,-88.0,18.0,19.0,20.0,28.0,1
1976,BA:8C:B9:54:50:24,3837888,489620598,4814,6180329,3833074,483440269,0,8828,1687937,8806,1684442,22,3495,2345,15,5240,39,0,56,216660.0,130000.0,-39.0,-36.0,-45.0,-51.0,-42.0,-36.0,-44.0,-49.0,-89.0,-90.0,-87.0,-88.0,50.0,54.0,42.0,37.0,1
1977,92:69:1D:31:68:E9,3836938,487046743,3863,3606340,3833075,483440403,0,4612,1080411,4475,1049451,137,30960,2079,10,4050,84,0,41,216660.0,130000.0,-51.0,-48.0,-44.0,-46.0,-52.0,-48.0,-44.0,-47.0,-89.0,-90.0,-87.0,-88.0,38.0,42.0,43.0,42.0,1
1978,CC:2F:71:3F:1F:24,4536602,1226794308,703526,743353845,3833076,483440463,37,562750,573133962,562047,573049340,703,84622,543706,15,703774,80514,34,479,144444.0,43333.0,-72.0,-67.0,-70.0,-74.0,-72.0,-67.0,-70.0,-74.0,-89.0,-90.0,-87.0,-88.0,17.0,23.0,17.0,14.0,1
1979,CC:2F:71:3E:C5:1F,3833928,483544629,852,104166,3833076,483440463,0,3554,298588,2933,224866,621,73722,902,8,1224,19,0,37,130000.0,39000.0,-71.0,-71.0,-67.0,-60.0,-71.0,-70.0,-67.0,-60.0,-89.0,-90.0,-87.0,-88.0,18.0,19.0,20.0,28.0,1
1980,BA:8C:B9:54:50:24,3837890,489620792,4814,6180329,3833076,483440463,0,8828,1687937,8806,1684442,22,3495,2345,15,5240,39,0,56,216660.0,130000.0,-39.0,-36.0,-45.0,-51.0,-42.0,-36.0,-44.0,-49.0,-89.0,-90.0,-87.0,-88.0,50.0,54.0,42.0,37.0,1
1981,92:69:1D:31:68:E9,3836947,487047777,3863,3606340,3833084,483441437,0,4612,1080411,4475,1049451,137,30960,2079,10,4050,84,0,41,216660.0,130000.0,-51.0,-48.0,-44.0,-46.0,-52.0,-48.0,-44.0,-47.0,-89.0,-90.0,-87.0,-88.0,38.0,42.0,43.0,42.0,1
1982,CC:2F:71:3F:1F:24,4536649,1226809456,703565,743368019,3833084,483441437,37,562773,573138022,562070,573053400,703,84622,543727,15,703813,80517,34,479,144444.0,43333.0,-71.0,-67.0,-70.0,-72.0,-71.0,-67.0,-70.0,-72.0,-89.0,-90.0,-87.0,-88.0,18.0,23.0,17.0,16.0,1
1983,CC:2F:71:3E:C5:1F,3833936,483545603,852,104166,3833084,483441437,0,3554,298588,2933,224866,621,73722,902,8,1224,19,0,37,130000.0,39000.0,-71.0,-71.0,-67.0,-60.0,-71.0,-70.0,-67.0,-60.0,-89.0,-90.0,-87.0,-88.0,18.0,19.0,20.0,28.0,1
1984,BA:8C:B9:54:50:24,3837898,489621766,4814,6180329,3833084,483441437,0,8828,1687937,8806,1684442,22,3495,2345,15,5240,39,0,56,216660.0,130000.0,-39.0,-36.0,-45.0,-51.0,-42.0,-36.0,-44.0,-49.0,-89.0,-90.0,-87.0,-88.0,50.0,54.0,42.0,37.0,1
1985,92:69:1D:31:68:E9,3836949,487047979,3863,3606340,3833086,483441639,0,4612,1080411,4475,1049451,137,30960,2079,10,4050,84,0,41,216660.0,130000.0,-51.0,-48.0,-44.0,-46.0,-52.0,-48.0,-44.0,-47.0,-89.0,-90.0,-87.0,-88.0,38.0,42.0,43.0,42.0,1
1986,CC:2F:71:3F:1F:24,4536689,1226823702,703603,743382063,3833086,483441639,37,562795,573141872,562092,573057250,703,84622,543748,15,703851,80521,34,479,144444.0,43333.0,-71.0,-67.0,-71.0,-73.0,-71.0,-67.0,-70.0,-73.0,-89.0,-90.0,-87.0,-88.0,18.0,23.0,16.0,15.0,1
1987,CC:2F:71:3E:C5:1F,3833938,483545805,852,104166,3833086,483441639,0,3554,298588,2933,224866,621,73722,902,8,1224,19,0,37,130000.0,39000.0,-71.0,-71.0,-67.0,-60.0,-71.0,-70.0,-67.0,-60.0,-89.0,-90.0,-87.0,-88.0,18.0,19.0,20.0,28.0,1
1988,BA:8C:B9:54:50:24,3837900,489621968,4814,6180329,3833086,483441639,0,8828,1687937,8806,1684442,22,3495,2345,15,5240,39,0,56,216660.0,130000.0,-39.0,-36.0,-45.0,-51.0,-42.0,-36.0,-44.0,-49.0,-89.0,-90.0,-87.0,-88.0,50.0,54.0,42.0,37.0,1
1989,92:69:1D:31:68:E9,3836956,487048645,3863,3606340,3833093,483442305,0,4612,1080411,4475,1049451,137,30960,2079,10,4050,84,0,41,216660.0,130000.0,-51.0,-48.0,-44.0,-46.0,-52.0,-48.0,-44.0,-47.0,-89.0,-90.0,-87.0,-88.0,38.0,42.0,43.0,42.0,1
1990,CC:2F:71:3F:1F:24,4536734,1226838540,703641,743396235,3833093,483442305,37,562829,573146818,562126,573062196,703,84622,543773,15,703889,80521,34,479,144444.0,43333.0,-75.0,-71.0,-73.0,-77.0,-75.0,-71.0,-73.0,-75.0,-89.0,-90.0,-87.0,-88.0,14.0,19.0,14.0,11.0,1
1991,CC:2F:71:3E:C5:1F,3833947,483546673,852,104166,3833095,483442507,0,3554,298588,2933,224866,621,73722,902,8,1224,19,0,37,130000.0,39000.0,-71.0,-71.0,-67.0,-60.0,-71.0,-70.0,-67.0,-60.0,-89.0,-90.0,-87.0,-88.0,18.0,19.0,20.0,28.0,1
1992,BA:8C:B9:54:50:24,3837909,489622836,4814,6180329,3833095,483442507,0,8828,1687937,8806,1684442,22,3495,2345,15,5240,39,0,56,216660.0,130000.0,-39.0,-36.0,-45.0,-51.0,-42.0,-36.0,-44.0,-49.0,-89.0,-90.0,-87.0,-88.0,50.0,54.0,42.0,37.0,1
1993,92:69:1D:31:68:E9,3836958,487048847,3863,3606340,3833095,483442507,0,4612,1080411,4475,1049451,137,30960,2079,10,4050,84,0,41,216660.0,130000.0,-51.0,-48.0,-44.0,-46.0,-52.0,-48.0,-44.0,-47.0,-89.0,-90.0,-87.0,-88.0,38.0,42.0,43.0,42.0,1
1994,CC:2F:71:3F:1F:24,4536784,1226856777,703689,743414270,3833095,483442507,37,562863,573152577,562160,573067955,703,84622,543805,15,703937,80525,34,479,144444.0,43333.0,-72.0,-68.0,-71.0,-74.0,-72.0,-67.0,-71.0,-73.0,-89.0,-90.0,-87.0,-88.0,17.0,22.0,16.0,14.0,1
1995,CC:2F:71:3E:C5:1F,3833949,483546875,852,104166,3833097,483442709,0,3554,298588,2933,224866,621,73722,902,8,1224,19,0,37,130000.0,39000.0,-71.0,-71.0,-67.0,-60.0,-71.0,-70.0,-67.0,-60.0,-89.0,-90.0,-87.0,-88.0,18.0,19.0,20.0,28.0,1
1996,BA:8C:B9:54:50:24,3837911,489623038,4814,6180329,3833097,483442709,0,8828,1687937,8806,1684442,22,3495,2345,15,5240,39,0,56,216660.0,130000.0,-39.0,-36.0,-45.0,-51.0,-42.0,-36.0,-44.0,-49.0,-89.0,-90.0,-87.0,-88.0,50.0,54.0,42.0,37.0,1
1997,92:69:1D:31:68:E9,3836964,487049453,3863,3606340,3833101,483443113,0,4612,1080411,4475,1049451,137,30960,2079,10,4050,84,0,41,216660.0,130000.0,-51.0,-48.0,-44.0,-46.0,-52.0,-48.0,-44.0,-47.0,-89.0,-89.0,-87.0,-87.0,38.0,41.0,43.0,41.0,1
1998,CC:2F:71:3F:1F:24,4537024,1227117489,703923,743674376,3833101,483443113,37,562973,573169271,562270,573084649,703,84622,543912,15,704171,80624,34,479,144444.0,43333.0,-72.0,-68.0,-71.0,-73.0,-72.0,-68.0,-71.0,-73.0,-89.0,-89.0,-87.0,-87.0,17.0,21.0,16.0,14.0,1
1999,CC:2F:71:3E:C5:1F,3833955,483547481,852,104166,3833103,483443315,0,3554,298588,2933,224866,621,73722,902,8,1224,19,0,37,130000.0,39000.0,-71.0,-71.0,-67.0,-60.0,-71.0,-70.0,-67.0,-60.0,-89.0,-89.0,-87.0,-87.0,18.0,18.0,20.0,27.0,1
2000,BA:8C:B9:54:50:24,3837918,489623704,4814,6180329,3833104,483443375,0,8828,1687937,8806,1684442,22,3495,2345,15,5240,39,0,56,216660.0,130000.0,-39.0,-36.0,-45.0,-51.0,-42.0,-36.0,-44.0,-49.0,-89.0,-89.0,-87.0,-87.0,50.0,53.0,42.0,36.0,1
2001,92:69:1D:31:68:E9,3836967,487049715,3863,3606340,3833104,483443375,0,4612,1080411,4475,1049451,137,30960,2079,10,4050,84,0,41,216660.0,130000.0,-51.0,-48.0,-44.0,-46.0,-52.0,-48.0,-44.0,-47.0,-89.0,-89.0,-87.0,-87.0,38.0,41.0,43.0,41.0,1
2002,CC:2F:71:3F:1F:24,4537408,1227583722,704304,744140347,3833104,483443375,37,563140,573193775,562437,573109153,703,84622,544071,15,704552,80747,34,479,144444.0,43333.0,-71.0,-67.0,-70.0,-72.0,-71.0,-66.0,-70.0,-72.0,-89.0,-89.0,-87.0,-87.0,18.0,22.0,17.0,15.0,1
2003,CC:2F:71:3E:C5:1F,3833956,483547541,852,104166,3833104,483443375,0,3554,298588,2933,224866,621,73722,902,8,1224,19,0,37,130000.0,39000.0,-71.0,-71.0,-67.0,-60.0,-71.0,-70.0,-67.0,-60.0,-89.0,-89.0,-87.0,-87.0,18.0,18.0,20.0,27.0,1
2004,BA:8C:B9:54:50:24,3837920,489623906,4814,6180329,3833106,483443577,0,8828,1687937,8806,1684442,22,3495,2345,15,5240,39,0,56,216660.0,130000.0,-39.0,-36.0,-45.0,-51.0,-42.0,-36.0,-44.0,-49.0,-89.0,-89.0,-87.0,-87.0,50.0,53.0,42.0,36.0,1
2005,92:69:1D:31:68:E9,3836973,487050321,3863,3606340,3833110,483443981,0,4612,1080411,4475,1049451,137,30960,2079,10,4050,84,0,41,216660.0,130000.0,-51.0,-48.0,-44.0,-46.0,-52.0,-48.0,-44.0,-47.0,-89.0,-89.0,-87.0,-87.0,38.0,41.0,43.0,41.0,1
2006,CC:2F:71:3F:1F:24,4537902,1228132981,704792,744689000,3833110,483443981,37,563392,573231466,562689,573146844,703,84622,544318,15,705040,80890,34,479,144444.0,43333.0,-72.0,-68.0,-71.0,-73.0,-72.0,-67.0,-71.0,-73.0,-89.0,-89.0,-87.0,-87.0,17.0,21.0,16.0,14.0,1
2007,CC:2F:71:3E:C5:1F,3833964,483548349,852,104166,3833112,483444183,0,3554,298588,2933,224866,621,73722,902,8,1224,19,0,37,130000.0,39000.0,-71.0,-71.0,-67.0,-60.0,-71.0,-70.0,-67.0,-60.0,-89.0,-89.0,-87.0,-87.0,18.0,18.0,20.0,27.0,1
2008,BA:8C:B9:54:50:24,3837926,489624512,4814,6180329,3833112,483444183,0,8828,1687937,8806,1684442,22,3495,2345,15,5240,39,0,56,216660.0,130000.0,-39.0,-36.0,-45.0,-51.0,-42.0,-36.0,-44.0,-49.0,-89.0,-89.0,-87.0,-87.0,50.0,53.0,42.0,36.0,1
2009,92:69:1D:31:68:E9,3836976,487050583,3863,3606340,3833113,483444243,0,4612,1080411,4475,1049451,137,30960,2079,10,4050,84,0,41,216660.0,130000.0,-51.0,-48.0,-44.0,-46.0,-52.0,-48.0,-44.0,-47.0,-89.0,-89.0,-87.0,-87.0,38.0,41.0,43.0,41.0,1
2010,CC:2F:71:3F:1F:24,4538406,1228734550,705293,745290307,3833113,483444243,37,563634,573268512,562931,573183890,703,84622,544538,15,705524,81004,34,479,144444.0,43333.0,-72.0,-68.0,-71.0,-75.0,-72.0,-67.0,-70.0,-74.0,-89.0,-89.0,-87.0,-87.0,17.0,21.0,16.0,12.0,1
2011,CC:2F:71:3E:C5:1F,3833965,483548409,852,104166,3833113,483444243,0,3554,298588,2933,224866,621,73722,902,8,1224,19,0,37,130000.0,39000.0,-71.0,-71.0,-67.0,-60.0,-71.0,-70.0,-67.0,-60.0,-89.0,-89.0,-87.0,-87.0,18.0,18.0,20.0,27.0,1
2012,BA:8C:B9:54:50:24,3837927,489624572,4814,6180329,3833113,483444243,0,8828,1687937,8806,1684442,22,3495,2345,15,5240,39,0,56,216660.0,130000.0,-39.0,-36.0,-45.0,-51.0,-42.0,-36.0,-44.0,-49.0,-89.0,-89.0,-87.0,-87.0,50.0,53.0,42.0,36.0,1
2013,92:69:1D:31:68:E9,3836983,487051305,3864,3606456,3833119,483444849,0,4614,1080547,4477,1049587,137,30960,2079,10,4051,84,0,41,216660.0,130000.0,-52.0,-47.0,-43.0,-48.0,-52.0,-48.0,-44.0,-47.0,-89.0,-89.0,-87.0,-87.0,37.0,42.0,44.0,39.0,1
2014,CC:2F:71:3F:1F:24,4538924,1229342326,705805,745897477,3833119,483444849,37,563871,573304159,563168,573219537,703,84622,544770,15,706053,81134,34,479,144444.0,43333.0,-72.0,-68.0,-70.0,-74.0,-72.0,-68.0,-70.0,-73.0,-89.0,-89.0,-87.0,-87.0,17.0,21.0,17.0,13.0,1
2015,CC:2F:71:3E:C5:1F,3833972,483549131,853,104282,3833119,483444849,0,3556,298728,2935,225006,621,73722,902,8,1225,19,0,37,130000.0,39000.0,-70.0,-71.0,-67.0,-60.0,-70.0,-70.0,-67.0,-60.0,-89.0,-89.0,-87.0,-87.0,19.0,18.0,20.0,27.0,1
2016,BA:8C:B9:54:50:24,3837936,489625496,4815,6180445,3833121,483445051,0,8830,1688073,8808,1684578,22,3495,2345,15,5241,39,0,56,216660.0,130000.0,-39.0,-37.0,-45.0,-52.0,-42.0,-35.0,-44.0,-49.0,-89.0,-89.0,-87.0,-87.0,50.0,52.0,42.0,35.0,1
2017,92:69:1D:31:68:E9,3836985,487051507,3864,3606456,3833121,483445051,0,4614,1080547,4477,1049587,137,30960,2079,10,4051,84,0,41,216660.0,130000.0,-52.0,-47.0,-43.0,-48.0,-52.0,-48.0,-44.0,-47.0,-89.0,-89.0,-87.0,-87.0,37.0,42.0,44.0,39.0,1
2018,CC:2F:71:3F:1F:24,4539524,1230047648,706403,746602597,3833121,483445051,37,564152,573347527,563449,573262905,703,84622,545036,15,706651,81299,34,479,144444.0,43333.0,-72.0,-67.0,-70.0,-74.0,-72.0,-67.0,-70.0,-73.0,-89.0,-89.0,-87.0,-87.0,17.0,22.0,17.0,13.0,1
2019,CC:2F:71:3E:C5:1F,3833974,483549333,853,104282,3833121,483445051,0,3556,298728,2935,225006,621,73722,902,8,1225,19,0,37,130000.0,39000.0,-70.0,-71.0,-67.0,-60.0,-70.0,-70.0,-67.0,-60.0,-89.0,-89.0,-87.0,-87.0,19.0,18.0,20.0,27.0,1
2020,BA:8C:B9:54:50:24,3837936,489625496,4815,6180445,3833121,483445051,0,8830,1688073,8808,1684578,22,3495,2345,15,5241,39,0,56,216660.0,130000.0,-39.0,-37.0,-45.0,-52.0,-42.0,-35.0,-44.0,-49.0,-89.0,-89.0,-87.0,-87.0,50.0,52.0,42.0,35.0,1
2021,92:69:1D:31:68:E9,3836993,487052446,3864,3606456,3833129,483445990,0,4614,1080547,4477,1049587,137,30960,2079,10,4051,84,0,41,216660.0,130000.0,-52.0,-47.0,-43.0,-48.0,-52.0,-48.0,-44.0,-47.0,-89.0,-89.0,-87.0,-87.0,37.0,42.0,44.0,39.0,1
2022,CC:2F:71:3F:1F:24,4540241,1230870014,707112,747424024,3833129,483445990,37,564502,573402189,563799,573317567,703,84622,545371,15,707360,81423,34,479,144444.0,43333.0,-72.0,-67.0,-70.0,-73.0,-71.0,-67.0,-70.0,-72.0,-89.0,-89.0,-87.0,-87.0,17.0,22.0,17.0,14.0,1
2023,CC:2F:71:3E:C5:1F,3833982,483550272,853,104282,3833129,483445990,0,3556,298728,2935,225006,621,73722,902,8,1225,19,0,37,130000.0,39000.0,-70.0,-71.0,-67.0,-60.0,-70.0,-70.0,-67.0,-60.0,-89.0,-89.0,-87.0,-87.0,19.0,18.0,20.0,27.0,1
2024,BA:8C:B9:54:50:24,3837946,489626637,4815,6180445,3833131,483446192,0,8831,1688141,8809,1684646,22,3495,2345,15,5241,39,0,56,216660.0,130000.0,-39.0,-36.0,-45.0,-51.0,-41.0,-36.0,-44.0,-49.0,-89.0,-89.0,-87.0,-87.0,50.0,53.0,42.0,36.0,1
2025,92:69:1D:31:68:E9,3836995,487052648,3864,3606456,3833131,483446192,0,4614,1080547,4477,1049587,137,30960,2079,10,4051,84,0,41,216660.0,130000.0,-52.0,-47.0,-43.0,-48.0,-52.0,-48.0,-44.0,-47.0,-89.0,-89.0,-87.0,-87.0,37.0,42.0,44.0,39.0,1
2026,CC:2F:71:3F:1F:24,4540836,1231603664,707705,748157472,3833131,483446192,37,564778,573444180,564075,573359558,703,84622,545632,15,707953,81494,34,479,144444.0,43333.0,-72.0,-67.0,-70.0,-73.0,-72.0,-67.0,-70.0,-73.0,-89.0,-89.0,-87.0,-87.0,17.0,22.0,17.0,14.0,1
2027,CC:2F:71:3E:C5:1F,3833984,483550474,853,104282,3833131,483446192,0,3556,298728,2935,225006,621,73722,902,8,1225,19,0,37,130000.0,39000.0,-70.0,-71.0,-67.0,-60.0,-70.0,-70.0,-67.0,-60.0,-89.0,-89.0,-87.0,-87.0,19.0,18.0,20.0,27.0,1
2028,BA:8C:B9:54:50:24,3837946,489626637,4815,6180445,3833131,483446192,0,8831,1688141,8809,1684646,22,3495,2345,15,5241,39,0,56,216660.0,130000.0,-39.0,-36.0,-45.0,-51.0,-41.0,-36.0,-44.0,-49.0,-89.0,-89.0,-87.0,-87.0,50.0,53.0,42.0,36.0,1
2029,92:69:1D:31:68:E9,3837001,487053254,3864,3606456,3833137,483446798,0,4614,1080547,4477,1049587,137,30960,2079,10,4051,84,0,41,216660.0,130000.0,-52.0,-47.0,-43.0,-48.0,-52.0,-48.0,-44.0,-47.0,-89.0,-89.0,-87.0,-87.0,37.0,42.0,44.0,39.0,1
2030,CC:2F:71:3F:1F:24,4541318,1232150120,708180,748703262,3833138,483446858,37,565006,573478619,564303,573393997,703,84622,545858,15,708428,81567,34,479,130000.0,39000.0,-72.0,-67.0,-70.0,-74.0,-72.0,-67.0,-69.0,-74.0,-89.0,-89.0,-87.0,-87.0,17.0,22.0,17.0,13.0,1
2031,CC:2F:71:3E:C5:1F,3833991,483551140,853,104282,3833138,483446858,0,3556,298728,2935,225006,621,73722,902,8,1225,19,0,37,130000.0,39000.0,-70.0,-71.0,-67.0,-60.0,-70.0,-70.0,-67.0,-60.0,-89.0,-89.0,-87.0,-87.0,19.0,18.0,20.0,27.0,1
2032,BA:8C:B9:54:50:24,3837953,489627303,4815,6180445,3833138,483446858,0,8831,1688141,8809,1684646,22,3495,2345,15,5241,39,0,56,216660.0,130000.0,-39.0,-36.0,-45.0,-51.0,-41.0,-36.0,-44.0,-49.0,-89.0,-89.0,-87.0,-87.0,50.0,53.0,42.0,36.0,1
2033,92:69:1D:31:68:E9,3837004,487053516,3864,3606456,3833140,483447060,0,4614,1080547,4477,1049587,137,30960,2079,10,4051,84,0,41,216660.0,130000.0,-52.0,-47.0,-43.0,-48.0,-52.0,-48.0,-44.0,-47.0,-89.0,-89.0,-87.0,-87.0,37.0,42.0,44.0,39.0,1
2034,CC:2F:71:3F:1F:24,4541358,1232164142,708218,748717082,3833140,483447060,37,565032,573483309,564329,573398687,703,84622,545879,15,708466,81590,34,479,130000.0,39000.0,-72.0,-67.0,-70.0,-72.0,-71.0,-67.0,-69.0,-70.0,-89.0,-89.0,-87.0,-87.0,17.0,22.0,17.0,15.0,1
2035,CC:2F:71:3E:C5:1F,3833993,483551342,853,104282,3833140,483447060,0,3556,298728,2935,225006,621,73722,902,8,1225,19,0,37,130000.0,39000.0,-70.0,-71.0,-67.0,-60.0,-70.0,-70.0,-67.0,-60.0,-89.0,-89.0,-87.0,-87.0,19.0,18.0,20.0,27.0,1
2036,BA:8C:B9:54:50:24,3837956,489627567,4815,6180445,3833141,483447122,0,8831,1688141,8809,1684646,22,3495,2345,15,5241,39,0,56,216660.0,130000.0,-39.0,-36.0,-45.0,-51.0,-41.0,-36.0,-44.0,-49.0,-89.0,-89.0,-87.0,-87.0,50.0,53.0,42.0,36.0,1
2037,92:69:1D:31:68:E9,3837011,487054184,3864,3606456,3833147,483447728,0,4614,1080547,4477,1049587,137,30960,2079,10,4051,84,0,41,216660.0,130000.0,-52.0,-47.0,-43.0,-48.0,-52.0,-48.0,-44.0,-47.0,-88.0,-89.0,-86.0,-87.0,36.0,42.0,43.0,39.0,1
2038,CC:2F:71:3F:1F:24,4541402,1232178668,708255,748730940,3833147,483447728,37,565055,573487277,564351,573402537,704,84740,545901,15,708503,81590,34,479,130000.0,43333.0,-69.0,-68.0,-70.0,-71.0,-69.0,-68.0,-70.0,-70.0,-88.0,-89.0,-86.0,-87.0,19.0,21.0,16.0,16.0,1
2039,CC:2F:71:3E:C5:1F,3834000,483552010,853,104282,3833147,483447728,0,3556,298728,2935,225006,621,73722,902,8,1225,19,0,37,130000.0,39000.0,-70.0,-71.0,-67.0,-60.0,-70.0,-70.0,-67.0,-60.0,-88.0,-89.0,-86.0,-87.0,18.0,18.0,19.0,27.0,1
2040,BA:8C:B9:54:50:24,3837962,489628173,4815,6180445,3833147,483447728,0,8831,1688141,8809,1684646,22,3495,2345,15,5241,39,0,56,216660.0,130000.0,-39.0,-36.0,-45.0,-51.0,-41.0,-36.0,-44.0,-49.0,-88.0,-89.0,-86.0,-87.0,49.0,53.0,41.0,36.0,1
2041,92:69:1D:31:68:E9,3837014,487054446,3864,3606456,3833150,483447990,0,4614,1080547,4477,1049587,137,30960,2079,10,4051,84,0,41,216660.0,130000.0,-52.0,-47.0,-43.0,-48.0,-52.0,-48.0,-44.0,-47.0,-88.0,-89.0,-86.0,-87.0,36.0,42.0,43.0,39.0,1
2042,CC:2F:71:3F:1F:24,4541672,1232450437,708522,749002447,3833150,483447990,37,565180,573508592,564476,573423852,704,84740,546024,15,708770,81609,34,479,130000.0,43333.0,-71.0,-68.0,-70.0,-71.0,-70.0,-67.0,-70.0,-70.0,-88.0,-89.0,-86.0,-87.0,17.0,21.0,16.0,16.0,1
2043,CC:2F:71:3E:C5:1F,3834003,483552272,853,104282,3833150,483447990,0,3556,298728,2935,225006,621,73722,902,8,1225,19,0,37,130000.0,39000.0,-70.0,-71.0,-67.0,-60.0,-70.0,-70.0,-67.0,-60.0,-88.0,-89.0,-86.0,-87.0,18.0,18.0,19.0,27.0,1
2044,BA:8C:B9:54:50:24,3837965,489628435,4815,6180445,3833150,483447990,0,8831,1688141,8809,1684646,22,3495,2345,15,5241,39,0,56,216660.0,130000.0,-39.0,-36.0,-45.0,-51.0,-41.0,-36.0,-44.0,-49.0,-88.0,-89.0,-86.0,-87.0,49.0,53.0,41.0,36.0,1
2045,92:69:1D:31:68:E9,3837020,487055052,3864,3606456,3833156,483448596,0,4614,1080547,4477,1049587,137,30960,2079,10,4051,84,0,41,216660.0,130000.0,-52.0,-47.0,-43.0,-48.0,-52.0,-48.0,-44.0,-47.0,-88.0,-89.0,-86.0,-87.0,36.0,42.0,43.0,39.0,1
2046,CC:2F:71:3F:1F:24,4541716,1232465087,708560,749016491,3833156,483448596,37,565201,573512326,564497,573427586,704,84740,546044,15,708808,81611,34,479,130000.0,43333.0,-71.0,-68.0,-71.0,-70.0,-71.0,-68.0,-70.0,-71.0,-88.0,-89.0,-86.0,-87.0,17.0,21.0,15.0,17.0,1
2047,CC:2F:71:3E:C5:1F,3834009,483552878,853,104282,3833156,483448596,0,3557,298798,2936,225076,621,73722,902,8,1226,19,0,37,130000.0,39000.0,-71.0,-70.0,-67.0,-60.0,-70.0,-70.0,-67.0,-60.0,-88.0,-89.0,-86.0,-87.0,17.0,19.0,19.0,27.0,1
2048,BA:8C:B9:54:50:24,3837971,489629041,4815,6180445,3833156,483448596,0,8834,1688345,8812,1684850,22,3495,2345,15,5242,39,0,56,216660.0,130000.0,-48.0,-35.0,-43.0,-45.0,-41.0,-36.0,-44.0,-49.0,-88.0,-89.0,-86.0,-87.0,40.0,54.0,43.0,42.0,1
2049,92:69:1D:31:68:E9,3837022,487055254,3864,3606456,3833158,483448798,0,4616,1080683,4479,1049723,137,30960,2079,10,4052,84,0,41,216660.0,130000.0,-52.0,-48.0,-44.0,-47.0,-52.0,-48.0,-44.0,-47.0,-88.0,-89.0,-86.0,-87.0,36.0,41.0,42.0,40.0,1
2050,CC:2F:71:3F:1F:24,4541757,1232479591,708599,749030793,3833158,483448798,37,565225,573516420,564521,573431680,704,84740,546067,15,708847,81612,34,479,130000.0,43333.0,-71.0,-68.0,-70.0,-71.0,-70.0,-67.0,-70.0,-70.0,-88.0,-89.0,-86.0,-87.0,17.0,21.0,16.0,16.0,1
2051,CC:2F:71:3E:C5:1F,3834011,483553080,853,104282,3833158,483448798,0,3558,298868,2937,225146,621,73722,902,8,1226,19,0,37,130000.0,39000.0,-70.0,-70.0,-67.0,-60.0,-70.0,-70.0,-67.0,-60.0,-88.0,-89.0,-86.0,-87.0,18.0,19.0,19.0,27.0,1
2052,BA:8C:B9:54:50:24,3837973,489629243,4815,6180445,3833158,483448798,0,8834,1688345,8812,1684850,22,3495,2345,15,5242,39,0,56,216660.0,130000.0,-48.0,-35.0,-43.0,-45.0,-41.0,-36.0,-44.0,-49.0,-88.0,-89.0,-86.0,-87.0,40.0,54.0,43.0,42.0,1
2053,92:69:1D:31:68:E9,3837030,487055982,3864,3606456,3833166,483449526,0,4616,1080683,4479,1049723,137,30960,2079,10,4052,84,0,41,216660.0,130000.0,-52.0,-48.0,-44.0,-47.0,-52.0,-48.0,-44.0,-47.0,-88.0,-89.0,-86.0,-86.0,36.0,41.0,42.0,39.0,1
2054,CC:2F:71:3F:1F:24,4541807,1232494889,708641,749045363,3833166,483449526,37,565248,573520432,564544,573435692,704,84740,546089,15,708889,81615,34,479,130000.0,39000.0,-70.0,-68.0,-70.0,-71.0,-70.0,-68.0,-70.0,-71.0,-88.0,-89.0,-86.0,-86.0,18.0,21.0,16.0,15.0,1
2055,CC:2F:71:3E:C5:1F,3834019,483553808,853,104282,3833166,483449526,0,3560,299056,2938,225216,622,73840,903,8,1226,19,0,37,130000.0,39000.0,-70.0,-70.0,-66.0,-60.0,-70.0,-70.0,-66.0,-60.0,-88.0,-89.0,-86.0,-86.0,18.0,19.0,20.0,26.0,1
2056,BA:8C:B9:54:50:24,3837981,489629971,4815,6180445,3833166,483449526,0,8834,1688345,8812,1684850,22,3495,2345,15,5242,39,0,56,216660.0,130000.0,-48.0,-35.0,-43.0,-45.0,-41.0,-36.0,-44.0,-49.0,-88.0,-89.0,-86.0,-86.0,40.0,54.0,43.0,41.0,1
2057,92:69:1D:31:68:E9,3837032,487056184,3864,3606456,3833168,483449728,0,4616,1080683,4479,1049723,137,30960,2079,10,4052,84,0,41,216660.0,130000.0,-52.0,-48.0,-44.0,-47.0,-52.0,-48.0,-44.0,-47.0,-88.0,-89.0,-86.0,-86.0,36.0,41.0,42.0,39.0,1
2058,CC:2F:71:3F:1F:24,4541854,1232512440,708686,749062712,3833168,483449728,37,565281,573526276,564577,573441536,704,84740,546118,15,708934,81635,34,479,130000.0,43333.0,-71.0,-68.0,-70.0,-71.0,-71.0,-68.0,-70.0,-70.0,-88.0,-89.0,-86.0,-86.0,17.0,21.0,16.0,15.0,1
2059,CC:2F:71:3E:C5:1F,3834021,483554010,853,104282,3833168,483449728,0,3560,299056,2938,225216,622,73840,903,8,1226,19,0,37,130000.0,39000.0,-70.0,-70.0,-66.0,-60.0,-70.0,-70.0,-66.0,-60.0,-88.0,-89.0,-86.0,-86.0,18.0,19.0,20.0,26.0,1
2060,BA:8C:B9:54:50:24,3837983,489630173,4815,6180445,3833168,483449728,0,8834,1688345,8812,1684850,22,3495,2345,15,5242,39,0,56,216660.0,130000.0,-48.0,-35.0,-43.0,-45.0,-41.0,-36.0,-44.0,-49.0,-88.0,-89.0,-86.0,-86.0,40.0,54.0,43.0,41.0,1
2061,92:69:1D:31:68:E9,3837037,487056722,3864,3606456,3833173,483450266,0,4616,1080683,4479,1049723,137,30960,2079,10,4052,84,0,41,216660.0,130000.0,-52.0,-48.0,-44.0,-47.0,-52.0,-48.0,-44.0,-47.0,-88.0,-89.0,-86.0,-86.0,36.0,41.0,42.0,39.0,1
2062,CC:2F:71:3F:1F:24,4541897,1232527022,708724,749076756,3833173,483450266,37,565302,573530010,564598,573445270,704,84740,546138,15,708972,81637,34,479,130000.0,43333.0,-71.0,-68.0,-70.0,-72.0,-71.0,-67.0,-70.0,-72.0,-88.0,-89.0,-86.0,-86.0,17.0,21.0,16.0,14.0,1
2063,CC:2F:71:3E:C5:1F,3834028,483554676,853,104282,3833175,483450394,0,3560,299056,2938,225216,622,73840,903,8,1226,19,0,37,130000.0,39000.0,-70.0,-70.0,-66.0,-60.0,-70.0,-70.0,-66.0,-60.0,-88.0,-89.0,-86.0,-86.0,18.0,19.0,20.0,26.0,1
2064,BA:8C:B9:54:50:24,3837990,489630839,4815,6180445,3833175,483450394,0,8834,1688345,8812,1684850,22,3495,2345,15,5242,39,0,56,216660.0,130000.0,-48.0,-35.0,-43.0,-45.0,-41.0,-36.0,-44.0,-49.0,-88.0,-89.0,-86.0,-86.0,40.0,54.0,43.0,41.0,1
2065,92:69:1D:31:68:E9,3837041,487057052,3864,3606456,3833177,483450596,0,4616,1080683,4479,1049723,137,30960,2079,10,4052,84,0,41,216660.0,130000.0,-52.0,-48.0,-44.0,-47.0,-52.0,-48.0,-44.0,-47.0,-88.0,-89.0,-86.0,-86.0,36.0,41.0,42.0,39.0,1
2066,CC:2F:71:3F:1F:24,4542163,1232798099,708986,749347503,3833177,483450596,37,565438,573554921,564734,573470181,704,84740,546260,15,709234,81721,34,479,130000.0,43333.0,-71.0,-68.0,-70.0,-72.0,-71.0,-68.0,-70.0,-71.0,-88.0,-89.0,-86.0,-86.0,17.0,21.0,16.0,14.0,1
2067,CC:2F:71:3E:C5:1F,3834030,483554878,853,104282,3833177,483450596,0,3560,299056,2938,225216,622,73840,903,8,1226,19,0,37,130000.0,39000.0,-70.0,-70.0,-66.0,-60.0,-70.0,-70.0,-66.0,-60.0,-88.0,-89.0,-86.0,-86.0,18.0,19.0,20.0,26.0,1
2068,BA:8C:B9:54:50:24,3837992,489631041,4815,6180445,3833177,483450596,0,8834,1688345,8812,1684850,22,3495,2345,15,5242,39,0,56,216660.0,130000.0,-48.0,-35.0,-43.0,-45.0,-41.0,-36.0,-44.0,-49.0,-88.0,-89.0,-86.0,-86.0,40.0,54.0,43.0,41.0,1
2069,92:69:1D:31:68:E9,3837045,487057456,3864,3606456,3833181,483451000,0,4616,1080683,4479,1049723,137,30960,2079,10,4052,84,0,41,216660.0,130000.0,-52.0,-48.0,-44.0,-47.0,-52.0,-48.0,-44.0,-47.0,-88.0,-89.0,-86.0,-86.0,36.0,41.0,42.0,39.0,1
2070,CC:2F:71:3F:1F:24,4542402,1233058739,709221,749607739,3833181,483451000,37,565555,573572449,564851,573487709,704,84740,546370,15,709469,81723,34,479,130000.0,43333.0,-72.0,-68.0,-71.0,-72.0,-72.0,-68.0,-71.0,-71.0,-88.0,-89.0,-86.0,-86.0,16.0,21.0,15.0,14.0,1
2071,CC:2F:71:3E:C5:1F,3834036,483555484,853,104282,3833183,483451202,0,3560,299056,2938,225216,622,73840,903,8,1226,19,0,37,130000.0,39000.0,-70.0,-70.0,-66.0,-60.0,-70.0,-70.0,-66.0,-60.0,-88.0,-89.0,-86.0,-86.0,18.0,19.0,20.0,26.0,1
2072,BA:8C:B9:54:50:24,3837998,489631647,4815,6180445,3833183,483451202,0,8834,1688345,8812,1684850,22,3495,2345,15,5242,39,0,56,216660.0,130000.0,-48.0,-35.0,-43.0,-45.0,-41.0,-36.0,-44.0,-49.0,-88.0,-89.0,-86.0,-86.0,40.0,54.0,43.0,41.0,1
2073,92:69:1D:31:68:E9,3837051,487058193,3864,3606456,3833187,483451737,0,4616,1080683,4479,1049723,137,30960,2079,10,4052,84,0,41,216660.0,130000.0,-52.0,-48.0,-44.0,-47.0,-52.0,-48.0,-44.0,-47.0,-88.0,-89.0,-86.0,-86.0,36.0,41.0,42.0,39.0,1
2074,CC:2F:71:3F:1F:24,4542811,1233533025,709624,750081288,3833187,483451737,37,565731,573601802,565027,573517062,704,84740,546544,15,709871,81742,34,479,130000.0,43333.0,-72.0,-68.0,-71.0,-73.0,-71.0,-68.0,-71.0,-72.0,-88.0,-89.0,-86.0,-86.0,16.0,21.0,15.0,13.0,1
2075,CC:2F:71:3E:C5:1F,3834040,483556019,853,104282,3833187,483451737,0,3560,299056,2938,225216,622,73840,903,8,1226,19,0,37,130000.0,39000.0,-70.0,-70.0,-66.0,-60.0,-70.0,-70.0,-66.0,-60.0,-88.0,-89.0,-86.0,-86.0,18.0,19.0,20.0,26.0,1
2076,BA:8C:B9:54:50:24,3838002,489632182,4815,6180445,3833187,483451737,0,8834,1688345,8812,1684850,22,3495,2345,15,5242,39,0,56,216660.0,130000.0,-48.0,-35.0,-43.0,-45.0,-41.0,-36.0,-44.0,-49.0,-88.0,-89.0,-86.0,-86.0,40.0,54.0,43.0,41.0,1
2077,92:69:1D:31:68:E9,3837055,487058597,3864,3606456,3833191,483452141,0,4616,1080683,4479,1049723,137,30960,2079,10,4052,84,0,41,216660.0,130000.0,-52.0,-48.0,-44.0,-47.0,-52.0,-48.0,-44.0,-47.0,-88.0,-89.0,-86.0,-86.0,36.0,41.0,42.0,39.0,1
2078,CC:2F:71:3F:1F:24,4542897,1233583965,709704,750131622,3833193,483452343,37,565778,573608552,565074,573523812,704,84740,546590,15,709952,81742,34,479,130000.0,43333.0,-72.0,-69.0,-71.0,-72.0,-71.0,-68.0,-70.0,-71.0,-88.0,-89.0,-86.0,-86.0,16.0,20.0,15.0,14.0,1
2079,CC:2F:71:3E:C5:1F,3834046,483556625,853,104282,3833193,483452343,0,3560,299056,2938,225216,622,73840,903,8,1226,19,0,37,130000.0,39000.0,-70.0,-70.0,-66.0,-60.0,-70.0,-70.0,-66.0,-60.0,-88.0,-89.0,-86.0,-86.0,18.0,19.0,20.0,26.0,1
2080,BA:8C:B9:54:50:24,3838008,489632788,4815,6180445,3833193,483452343,0,8834,1688345,8812,1684850,22,3495,2345,15,5242,39,0,56,216660.0,130000.0,-48.0,-35.0,-43.0,-45.0,-41.0,-36.0,-44.0,-49.0,-88.0,-89.0,-86.0,-86.0,40.0,54.0,43.0,41.0,1
2081,92:69:1D:31:68:E9,3837060,487059127,3864,3606456,3833196,483452671,0,4616,1080683,4479,1049723,137,30960,2079,10,4052,84,0,41,216660.0,130000.0,-52.0,-48.0,-44.0,-47.0,-52.0,-48.0,-44.0,-47.0,-88.0,-89.0,-86.0,-86.0,36.0,41.0,42.0,39.0,1
2082,CC:2F:71:3F:1F:24,4542938,1233598465,709742,750145794,3833196,483452671,37,565805,573613012,565101,573528272,704,84740,546613,15,709990,81742,34,479,130000.0,43333.0,-71.0,-68.0,-70.0,-71.0,-71.0,-68.0,-70.0,-71.0,-88.0,-89.0,-86.0,-86.0,17.0,21.0,16.0,15.0,1
2083,CC:2F:71:3E:C5:1F,3834049,483556953,853,104282,3833196,483452671,0,3560,299056,2938,225216,622,73840,903,8,1226,19,0,37,130000.0,39000.0,-70.0,-70.0,-66.0,-60.0,-70.0,-70.0,-66.0,-60.0,-88.0,-89.0,-86.0,-86.0,18.0,19.0,20.0,26.0,1
2084,BA:8C:B9:54:50:24,3838011,489633116,4815,6180445,3833196,483452671,0,8834,1688345,8812,1684850,22,3495,2345,15,5242,39,0,56,216660.0,130000.0,-48.0,-35.0,-43.0,-45.0,-41.0,-36.0,-44.0,-49.0,-88.0,-89.0,-86.0,-86.0,40.0,54.0,43.0,41.0,1
2085,92:69:1D:31:68:E9,3837065,487059591,3864,3606456,3833201,483453135,0,4616,1080683,4479,1049723,137,30960,2079,10,4052,84,0,41,216660.0,130000.0,-52.0,-48.0,-44.0,-47.0,-52.0,-48.0,-44.0,-47.0,-88.0,-89.0,-86.0,-86.0,36.0,41.0,42.0,39.0,1
2086,CC:2F:71:3F:1F:24,4542985,1233613379,709782,750160042,3833203,483453337,37,565828,573616978,565124,573532238,704,84740,546635,15,710030,81750,34,479,130000.0,39000.0,-70.0,-68.0,-70.0,-71.0,-70.0,-68.0,-70.0,-71.0,-88.0,-89.0,-86.0,-86.0,18.0,21.0,16.0,15.0,1
2087,CC:2F:71:3E:C5:1F,3834056,483557619,853,104282,3833203,483453337,0,3560,299056,2938,225216,622,73840,903,8,1226,19,0,37,130000.0,39000.0,-70.0,-70.0,-66.0,-60.0,-70.0,-70.0,-66.0,-60.0,-88.0,-89.0,-86.0,-86.0,18.0,19.0,20.0,26.0,1
2088,BA:8C:B9:54:50:24,3838018,489633782,4815,6180445,3833203,483453337,0,8834,1688345,8812,1684850,22,3495,2345,15,5242,39,0,56,216660.0,130000.0,-48.0,-35.0,-43.0,-45.0,-41.0,-36.0,-44.0,-49.0,-88.0,-89.0,-86.0,-86.0,40.0,54.0,43.0,41.0,1
2089,92:69:1D:31:68:E9,3837069,487059995,3864,3606456,3833205,483453539,0,4616,1080683,4479,1049723,137,30960,2079,10,4052,84,0,41,216660.0,130000.0,-52.0,-48.0,-44.0,-47.0,-52.0,-48.0,-44.0,-47.0,-88.0,-89.0,-86.0,-86.0,36.0,41.0,42.0,39.0,1
2090,CC:2F:71:3F:1F:24,4543031,1233629016,709826,750175477,3833205,483453539,37,565858,573622559,565154,573537819,704,84740,546662,15,710073,81750,34,479,144444.0,43333.0,-71.0,-69.0,-71.0,-71.0,-71.0,-68.0,-71.0,-71.0,-88.0,-89.0,-86.0,-86.0,17.0,20.0,15.0,15.0,1
2091,CC:2F:71:3E:C5:1F,3834058,483557821,853,104282,3833205,483453539,0,3560,299056,2938,225216,622,73840,903,8,1226,19,0,37,130000.0,39000.0,-70.0,-70.0,-66.0,-60.0,-70.0,-70.0,-66.0,-60.0,-88.0,-89.0,-86.0,-86.0,18.0,19.0,20.0,26.0,1
2092,BA:8C:B9:54:50:24,3838020,489633984,4815,6180445,3833205,483453539,0,8834,1688345,8812,1684850,22,3495,2345,15,5242,39,0,56,216660.0,130000.0,-48.0,-35.0,-43.0,-45.0,-41.0,-36.0,-44.0,-49.0,-88.0,-89.0,-86.0,-86.0,40.0,54.0,43.0,41.0,1
2093,92:69:1D:31:68:E9,3837073,487060399,3864,3606456,3833209,483453943,0,4616,1080683,4479,1049723,137,30960,2079,10,4052,84,0,41,216660.0,130000.0,-52.0,-48.0,-44.0,-47.0,-52.0,-48.0,-44.0,-47.0,-88.0,-89.0,-86.0,-86.0,36.0,41.0,42.0,39.0,1
2094,CC:2F:71:3F:1F:24,4543081,1233646216,709869,750192011,3833212,483454205,37,565886,573627105,565182,573542365,704,84740,546689,15,710117,81762,34,479,144444.0,43333.0,-71.0,-69.0,-71.0,-72.0,-72.0,-70.0,-72.0,-73.0,-88.0,-89.0,-86.0,-86.0,17.0,20.0,15.0,14.0,1
2095,CC:2F:71:3E:C5:1F,3834065,483558487,853,104282,3833212,483454205,0,3560,299056,2938,225216,622,73840,903,8,1226,19,0,37,130000.0,39000.0,-70.0,-70.0,-66.0,-60.0,-70.0,-70.0,-66.0,-60.0,-88.0,-89.0,-86.0,-86.0,18.0,19.0,20.0,26.0,1
2096,BA:8C:B9:54:50:24,3838027,489634650,4815,6180445,3833212,483454205,0,8834,1688345,8812,1684850,22,3495,2345,15,5242,39,0,56,216660.0,130000.0,-48.0,-35.0,-43.0,-45.0,-41.0,-36.0,-44.0,-49.0,-88.0,-89.0,-86.0,-86.0,40.0,54.0,43.0,41.0,1
2097,92:69:1D:31:68:E9,3837078,487060863,3864,3606456,3833214,483454407,0,4616,1080683,4479,1049723,137,30960,2079,10,4052,84,0,41,216660.0,130000.0,-52.0,-48.0,-44.0,-47.0,-52.0,-48.0,-44.0,-47.0,-88.0,-89.0,-86.0,-86.0,36.0,41.0,42.0,39.0,1
2098,CC:2F:71:3F:1F:24,4543123,1233660722,709909,750206315,3833214,483454407,37,565913,573631673,565209,573546933,704,84740,546712,15,710156,81763,34,479,144444.0,43333.0,-71.0,-68.0,-71.0,-71.0,-71.0,-68.0,-70.0,-71.0,-88.0,-89.0,-86.0,-86.0,17.0,21.0,15.0,15.0,1
2099,CC:2F:71:3E:C5:1F,3834067,483558689,853,104282,3833214,483454407,0,3560,299056,2938,225216,622,73840,903,8,1226,19,0,37,130000.0,39000.0,-70.0,-70.0,-66.0,-60.0,-70.0,-70.0,-66.0,-60.0,-88.0,-89.0,-86.0,-86.0,18.0,19.0,20.0,26.0,1
2100,BA:8C:B9:54:50:24,3838029,489634852,4815,6180445,3833214,483454407,0,8834,1688345,8812,1684850,22,3495,2345,15,5242,39,0,56,216660.0,130000.0,-48.0,-35.0,-43.0,-45.0,-41.0,-36.0,-44.0,-49.0,-88.0,-89.0,-86.0,-86.0,40.0,54.0,43.0,41.0,1
2101,92:69:1D:31:68:E9,3837084,487061469,3864,3606456,3833220,483455013,0,4620,1080955,4483,1049995,137,30960,2079,10,4052,84,0,41,216660.0,130000.0,-52.0,-48.0,-45.0,-46.0,-51.0,-47.0,-43.0,-47.0,-88.0,-89.0,-86.0,-86.0,36.0,41.0,41.0,40.0,1
2102,CC:2F:71:3F:1F:24,4543333,1233891284,710112,750436211,3833221,483455073,37,566021,573648795,565317,573564055,704,84740,546813,15,710368,81883,34,480,144444.0,43333.0,-71.0,-69.0,-71.0,-72.0,-71.0,-68.0,-70.0,-71.0,-88.0,-89.0,-86.0,-86.0,17.0,20.0,15.0,14.0,1
2103,CC:2F:71:3E:C5:1F,3834074,483559355,853,104282,3833221,483455073,0,3560,299056,2938,225216,622,73840,903,8,1226,19,0,37,130000.0,39000.0,-70.0,-70.0,-66.0,-60.0,-70.0,-70.0,-66.0,-60.0,-88.0,-89.0,-86.0,-86.0,18.0,19.0,20.0,26.0,1
2104,BA:8C:B9:54:50:24,3838038,489635720,4815,6180445,3833223,483455275,0,8840,1688753,8818,1685258,22,3495,2345,15,5242,39,0,56,216660.0,130000.0,-40.0,-37.0,-46.0,-51.0,-43.0,-36.0,-44.0,-48.0,-88.0,-89.0,-86.0,-86.0,48.0,52.0,40.0,35.0,1
2105,92:69:1D:31:68:E9,3837089,487061933,3864,3606456,3833225,483455477,0,4620,1080955,4483,1049995,137,30960,2079,10,4052,84,0,41,216660.0,130000.0,-52.0,-48.0,-45.0,-46.0,-51.0,-47.0,-43.0,-47.0,-88.0,-89.0,-86.0,-86.0,36.0,41.0,41.0,40.0,1
2106,CC:2F:71:3F:1F:24,4543602,1234186610,710377,750731133,3833225,483455477,37,566161,573669134,565457,573584394,704,84740,546945,15,710633,81966,34,480,130000.0,43333.0,-71.0,-68.0,-71.0,-71.0,-71.0,-68.0,-70.0,-71.0,-88.0,-89.0,-86.0,-86.0,17.0,21.0,15.0,15.0,1
2107,CC:2F:71:3E:C5:1F,3834078,483559759,853,104282,3833225,483455477,0,3560,299056,2938,225216,622,73840,903,8,1226,19,0,37,130000.0,39000.0,-70.0,-70.0,-66.0,-60.0,-70.0,-70.0,-66.0,-60.0,-88.0,-89.0,-86.0,-86.0,18.0,19.0,20.0,26.0,1
2108,BA:8C:B9:54:50:24,3838042,489636124,4815,6180445,3833227,483455679,0,8840,1688753,8818,1685258,22,3495,2345,15,5242,39,0,56,216660.0,130000.0,-40.0,-37.0,-46.0,-51.0,-43.0,-36.0,-44.0,-48.0,-88.0,-89.0,-86.0,-86.0,48.0,52.0,40.0,35.0,1
2109,92:69:1D:31:68:E9,3837093,487062337,3864,3606456,3833229,483455881,0,4620,1080955,4483,1049995,137,30960,2079,10,4052,84,0,41,216660.0,130000.0,-52.0,-48.0,-45.0,-46.0,-51.0,-47.0,-43.0,-47.0,-88.0,-89.0,-86.0,-86.0,36.0,41.0,41.0,40.0,1
2110,CC:2F:71:3F:1F:24,4543872,1234458615,710643,751002734,3833229,483455881,37,566298,573692324,565594,573607584,704,84740,547077,15,710899,81968,34,480,130000.0,43333.0,-72.0,-68.0,-71.0,-71.0,-71.0,-67.0,-70.0,-71.0,-88.0,-89.0,-86.0,-86.0,16.0,21.0,15.0,15.0,1
2111,CC:2F:71:3E:C5:1F,3834082,483560163,853,104282,3833229,483455881,0,3560,299056,2938,225216,622,73840,903,8,1226,19,0,37,130000.0,39000.0,-70.0,-70.0,-66.0,-60.0,-70.0,-70.0,-66.0,-60.0,-88.0,-89.0,-86.0,-86.0,18.0,19.0,20.0,26.0,1
2112,BA:8C:B9:54:50:24,3838044,489636326,4815,6180445,3833229,483455881,0,8840,1688753,8818,1685258,22,3495,2345,15,5242,39,0,56,216660.0,130000.0,-40.0,-37.0,-46.0,-51.0,-43.0,-36.0,-44.0,-48.0,-88.0,-89.0,-86.0,-86.0,48.0,52.0,40.0,35.0,1
2113,92:69:1D:31:68:E9,3837098,487062801,3864,3606456,3833234,483456345,0,4620,1080955,4483,1049995,137,30960,2079,10,4052,84,0,41,216660.0,130000.0,-52.0,-48.0,-45.0,-46.0,-51.0,-47.0,-43.0,-47.0,-88.0,-89.0,-86.0,-86.0,36.0,41.0,41.0,40.0,1
2114,CC:2F:71:3F:1F:24,4544111,1234718961,710877,751262616,3833234,483456345,37,566419,573710313,565715,573625573,704,84740,547187,15,711133,81975,34,480,130000.0,43333.0,-71.0,-67.0,-71.0,-72.0,-71.0,-67.0,-70.0,-71.0,-88.0,-89.0,-86.0,-86.0,17.0,22.0,15.0,14.0,1
2115,CC:2F:71:3E:C5:1F,3834087,483560627,853,104282,3833234,483456345,0,3560,299056,2938,225216,622,73840,903,8,1226,19,0,37,130000.0,39000.0,-70.0,-70.0,-66.0,-60.0,-70.0,-70.0,-66.0,-60.0,-88.0,-89.0,-86.0,-86.0,18.0,19.0,20.0,26.0,1
2116,BA:8C:B9:54:50:24,3838049,489636790,4815,6180445,3833234,483456345,0,8840,1688753,8818,1685258,22,3495,2345,15,5242,39,0,56,216660.0,130000.0,-40.0,-37.0,-46.0,-51.0,-43.0,-36.0,-44.0,-48.0,-88.0,-89.0,-86.0,-86.0,48.0,52.0,40.0,35.0,1
2117,92:69:1D:31:68:E9,3837103,487063321,3865,3606572,3833238,483456749,0,4622,1081091,4485,1050131,137,30960,2079,10,4053,84,0,41,216660.0,130000.0,-52.0,-48.0,-45.0,-47.0,-51.0,-47.0,-44.0,-47.0,-88.0,-89.0,-86.0,-86.0,36.0,41.0,41.0,39.0,1
2118,CC:2F:71:3F:1F:24,4544159,1234735637,710919,751278686,3833240,483456951,37,566453,573715707,565749,573630967,704,84740,547216,15,711174,81977,34,480,130000.0,39000.0,-70.0,-68.0,-70.0,-71.0,-70.0,-68.0,-70.0,-70.0,-88.0,-89.0,-86.0,-86.0,18.0,21.0,16.0,15.0,1
2119,CC:2F:71:3E:C5:1F,3834096,483561551,854,104398,3833242,483457153,0,3562,299196,2940,225356,622,73840,903,8,1227,19,0,37,130000.0,39000.0,-70.0,-70.0,-67.0,-60.0,-70.0,-70.0,-66.0,-60.0,-88.0,-89.0,-86.0,-86.0,18.0,19.0,19.0,26.0,1
2120,BA:8C:B9:54:50:24,3838065,489638513,4816,6180561,3833249,483457952,0,8842,1688889,8820,1685394,22,3495,2345,15,5243,39,0,56,216660.0,130000.0,-40.0,-37.0,-46.0,-51.0,-41.0,-36.0,-45.0,-49.0,-88.0,-89.0,-86.0,-86.0,48.0,52.0,40.0,35.0,1
2121,92:69:1D:31:68:E9,3837116,487064726,3865,3606572,3833251,483458154,0,4622,1081091,4485,1050131,137,30960,2079,10,4053,84,0,41,216660.0,130000.0,-52.0,-48.0,-45.0,-47.0,-51.0,-47.0,-44.0,-47.0,-88.0,-89.0,-86.0,-86.0,36.0,41.0,41.0,39.0,1
2122,CC:2F:71:3F:1F:24,4544209,1234750902,710958,751292748,3833251,483458154,37,566487,573720979,565782,573636121,705,84858,547245,15,711214,81981,34,480,144444.0,43333.0,-70.0,-68.0,-70.0,-71.0,-70.0,-67.0,-70.0,-71.0,-88.0,-89.0,-86.0,-86.0,18.0,21.0,16.0,15.0,1
2123,CC:2F:71:3E:C5:1F,3834107,483562754,854,104398,3833253,483458356,0,3562,299196,2940,225356,622,73840,903,8,1227,19,0,37,130000.0,39000.0,-70.0,-70.0,-67.0,-60.0,-70.0,-70.0,-66.0,-60.0,-88.0,-89.0,-86.0,-86.0,18.0,19.0,19.0,26.0,1
2124,BA:8C:B9:54:50:24,3838069,489638917,4816,6180561,3833253,483458356,0,8847,1689229,8825,1685734,22,3495,2345,15,5243,39,0,56,216660.0,130000.0,-40.0,-37.0,-46.0,-51.0,-43.0,-36.0,-44.0,-48.0,-88.0,-89.0,-86.0,-86.0,48.0,52.0,40.0,35.0,1
2125,92:69:1D:31:68:E9,3837123,487065394,3865,3606572,3833258,483458822,0,4622,1081091,4485,1050131,137,30960,2079,10,4053,84,0,41,216660.0,130000.0,-52.0,-48.0,-45.0,-47.0,-51.0,-47.0,-44.0,-47.0,-88.0,-89.0,-86.0,-86.0,36.0,41.0,41.0,39.0,1
2126,CC:2F:71:3F:1F:24,4544263,1234769347,711005,751310525,3833258,483458822,37,566517,573726248,565812,573641390,705,84858,547274,15,711261,81990,34,480,144444.0,43333.0,-71.0,-68.0,-70.0,-71.0,-70.0,-68.0,-70.0,-70.0,-88.0,-89.0,-86.0,-86.0,17.0,21.0,16.0,15.0,1
2127,CC:2F:71:3E:C5:1F,3834112,483563220,854,104398,3833258,483458822,0,3564,299384,2941,225426,623,73958,904,8,1227,19,0,37,130000.0,39000.0,-71.0,-70.0,-67.0,-60.0,-70.0,-70.0,-66.0,-60.0,-88.0,-89.0,-86.0,-86.0,17.0,19.0,19.0,26.0,1
2128,BA:8C:B9:54:50:24,3838074,489639383,4816,6180561,3833258,483458822,0,8848,1689297,8826,1685802,22,3495,2345,15,5243,39,0,56,216660.0,130000.0,-40.0,-37.0,-46.0,-51.0,-43.0,-36.0,-44.0,-48.0,-88.0,-89.0,-86.0,-86.0,48.0,52.0,40.0,35.0,1
2129,92:69:1D:31:68:E9,3837128,487066024,3865,3606572,3833263,483459452,0,4622,1081091,4485,1050131,137,30960,2079,10,4053,84,0,41,216660.0,130000.0,-52.0,-48.0,-45.0,-47.0,-51.0,-47.0,-44.0,-47.0,-88.0,-89.0,-86.0,-86.0,36.0,41.0,41.0,39.0,1
2130,CC:2F:71:3F:1F:24,4544529,1235040932,711266,751581480,3833263,483459452,37,566648,573748349,565943,573663491,705,84858,547400,15,711522,82097,34,480,144444.0,43333.0,-71.0,-68.0,-71.0,-71.0,-71.0,-68.0,-70.0,-70.0,-88.0,-89.0,-86.0,-86.0,17.0,21.0,15.0,15.0,1
2131,CC:2F:71:3E:C5:1F,3834119,483564052,854,104398,3833265,483459654,0,3564,299384,2941,225426,623,73958,904,8,1227,19,0,37,130000.0,39000.0,-71.0,-70.0,-67.0,-60.0,-70.0,-70.0,-66.0,-60.0,-88.0,-89.0,-86.0,-86.0,17.0,19.0,19.0,26.0,1
2132,BA:8C:B9:54:50:24,3838081,489640215,4816,6180561,3833265,483459654,0,8848,1689297,8826,1685802,22,3495,2345,15,5243,39,0,56,216660.0,130000.0,-40.0,-37.0,-46.0,-51.0,-43.0,-36.0,-44.0,-48.0,-88.0,-89.0,-86.0,-86.0,48.0,52.0,40.0,35.0,1
2133,92:69:1D:31:68:E9,3837134,487066630,3865,3606572,3833269,483460058,0,4622,1081091,4485,1050131,137,30960,2079,10,4053,84,0,41,216660.0,130000.0,-52.0,-48.0,-45.0,-47.0,-51.0,-47.0,-44.0,-47.0,-88.0,-89.0,-86.0,-86.0,36.0,41.0,41.0,39.0,1
2134,CC:2F:71:3F:1F:24,4544967,1235549776,711690,752086808,3833277,483462968,37,566840,573777121,566135,573692263,705,84858,547586,15,711946,82207,34,480,130000.0,43333.0,-71.0,-67.0,-70.0,-72.0,-71.0,-67.0,-70.0,-71.0,-88.0,-89.0,-86.0,-86.0,17.0,22.0,16.0,14.0,1
2135,CC:2F:71:3E:C5:1F,3834131,483567366,854,104398,3833277,483462968,0,3564,299384,2941,225426,623,73958,904,8,1227,19,0,37,130000.0,39000.0,-71.0,-70.0,-67.0,-60.0,-70.0,-70.0,-66.0,-60.0,-88.0,-89.0,-86.0,-86.0,17.0,19.0,19.0,26.0,1
2136,BA:8C:B9:54:50:24,3838093,489643529,4816,6180561,3833277,483462968,0,8848,1689297,8826,1685802,22,3495,2345,15,5243,39,0,56,216660.0,130000.0,-40.0,-37.0,-46.0,-51.0,-43.0,-36.0,-44.0,-48.0,-88.0,-89.0,-86.0,-86.0,48.0,52.0,40.0,35.0,1
2137,92:69:1D:31:68:E9,3837145,487069802,3865,3606572,3833280,483463230,0,4622,1081091,4485,1050131,137,30960,2079,10,4053,84,0,41,216660.0,130000.0,-52.0,-48.0,-45.0,-47.0,-51.0,-47.0,-44.0,-47.0,-88.0,-89.0,-86.0,-86.0,36.0,41.0,41.0,39.0,1
2138,CC:2F:71:3F:1F:24,4545009,1235564212,711729,752100982,3833280,483463230,37,566862,573780971,566157,573696113,705,84858,547607,15,711985,82211,34,480,130000.0,43333.0,-71.0,-68.0,-70.0,-71.0,-71.0,-68.0,-69.0,-70.0,-88.0,-89.0,-86.0,-86.0,17.0,21.0,16.0,15.0,1
2139,CC:2F:71:3E:C5:1F,3834136,483567830,854,104398,3833282,483463432,0,3564,299384,2941,225426,623,73958,904,8,1227,19,0,37,130000.0,39000.0,-71.0,-70.0,-67.0,-60.0,-70.0,-70.0,-66.0,-60.0,-88.0,-89.0,-86.0,-86.0,17.0,19.0,19.0,26.0,1
2140,BA:8C:B9:54:50:24,3838098,489643993,4816,6180561,3833282,483463432,0,8848,1689297,8826,1685802,22,3495,2345,15,5243,39,0,56,216660.0,130000.0,-40.0,-37.0,-46.0,-51.0,-43.0,-36.0,-44.0,-48.0,-88.0,-89.0,-86.0,-86.0,48.0,52.0,40.0,35.0,1
2141,92:69:1D:31:68:E9,3837149,487070206,3865,3606572,3833284,483463634,0,4622,1081091,4485,1050131,137,30960,2079,10,4053,84,0,41,216660.0,130000.0,-52.0,-48.0,-45.0,-47.0,-51.0,-47.0,-44.0,-47.0,-88.0,-89.0,-86.0,-86.0,36.0,41.0,41.0,39.0,1
2142,CC:2F:71:3F:1F:24,4545052,1235578732,711766,752114896,3833286,483463836,37,566886,573785053,566181,573700195,705,84858,547630,15,712022,82211,34,480,130000.0,43333.0,-71.0,-68.0,-71.0,-71.0,-70.0,-68.0,-70.0,-70.0,-88.0,-89.0,-86.0,-86.0,17.0,21.0,15.0,15.0,1
2143,CC:2F:71:3E:C5:1F,3834140,483568234,854,104398,3833286,483463836,0,3564,299384,2941,225426,623,73958,904,8,1227,19,0,37,130000.0,39000.0,-71.0,-70.0,-67.0,-60.0,-70.0,-70.0,-66.0,-60.0,-88.0,-89.0,-86.0,-86.0,17.0,19.0,19.0,26.0,1
2144,BA:8C:B9:54:50:24,3838102,489644397,4816,6180561,3833286,483463836,0,8848,1689297,8826,1685802,22,3495,2345,15,5243,39,0,56,216660.0,130000.0,-40.0,-37.0,-46.0,-51.0,-43.0,-36.0,-44.0,-48.0,-88.0,-89.0,-86.0,-86.0,48.0,52.0,40.0,35.0,1
2145,92:69:1D:31:68:E9,3837153,487070610,3865,3606572,3833288,483464038,0,4624,1081227,4487,1050267,137,30960,2079,10,4054,84,0,41,216660.0,130000.0,-52.0,-48.0,-45.0,-46.0,-51.0,-47.0,-44.0,-46.0,-88.0,-89.0,-86.0,-86.0,36.0,41.0,41.0,40.0,1
2146,CC:2F:71:3F:1F:24,4545093,1235593052,711805,752129014,3833288,483464038,37,566908,573788903,566203,573704045,705,84858,547651,15,712061,82211,34,480,130000.0,39000.0,-71.0,-68.0,-71.0,-70.0,-70.0,-68.0,-70.0,-70.0,-88.0,-89.0,-86.0,-86.0,17.0,21.0,15.0,16.0,1
2147,CC:2F:71:3E:C5:1F,3834144,483568638,854,104398,3833290,483464240,0,3564,299384,2941,225426,623,73958,904,8,1227,19,0,37,130000.0,39000.0,-71.0,-70.0,-67.0,-60.0,-70.0,-70.0,-66.0,-60.0,-88.0,-89.0,-86.0,-86.0,17.0,19.0,19.0,26.0,1
2148,BA:8C:B9:54:50:24,3838106,489644801,4816,6180561,3833290,483464240,0,8848,1689297,8826,1685802,22,3495,2345,15,5243,39,0,56,216660.0,130000.0,-40.0,-37.0,-46.0,-51.0,-43.0,-36.0,-44.0,-48.0,-88.0,-89.0,-86.0,-86.0,48.0,52.0,40.0,35.0,1
2149,92:69:1D:31:68:E9,3837158,487071074,3865,3606572,3833293,483464502,0,4624,1081227,4487,1050267,137,30960,2079,10,4054,84,0,41,216660.0,130000.0,-52.0,-48.0,-45.0,-46.0,-51.0,-47.0,-44.0,-46.0,-88.0,-89.0,-86.0,-86.0,36.0,41.0,41.0,40.0,1
2150,CC:2F:71:3F:1F:24,4545138,1235607650,711843,752142946,3833295,483464704,37,566933,573793383,566228,573708525,705,84858,547672,15,712099,82215,34,480,144444.0,43333.0,-71.0,-68.0,-70.0,-70.0,-70.0,-68.0,-70.0,-70.0,-88.0,-89.0,-86.0,-86.0,17.0,21.0,16.0,16.0,1
2151,CC:2F:71:3E:C5:1F,3834149,483569102,854,104398,3833295,483464704,0,3564,299384,2941,225426,623,73958,904,8,1227,19,0,37,130000.0,39000.0,-71.0,-70.0,-67.0,-60.0,-70.0,-70.0,-66.0,-60.0,-88.0,-89.0,-86.0,-86.0,17.0,19.0,19.0,26.0,1
2152,BA:8C:B9:54:50:24,3838111,489645265,4816,6180561,3833295,483464704,0,8848,1689297,8826,1685802,22,3495,2345,15,5243,39,0,56,216660.0,130000.0,-40.0,-37.0,-46.0,-51.0,-43.0,-36.0,-44.0,-48.0,-88.0,-89.0,-86.0,-86.0,48.0,52.0,40.0,35.0,1
2153,92:69:1D:31:68:E9,3837162,487071478,3865,3606572,3833297,483464906,0,4624,1081227,4487,1050267,137,30960,2079,10,4054,84,0,41,216660.0,130000.0,-52.0,-48.0,-45.0,-46.0,-51.0,-47.0,-44.0,-46.0,-88.0,-89.0,-86.0,-86.0,36.0,41.0,41.0,40.0,1
2154,CC:2F:71:3F:1F:24,4545189,1235625949,711892,752161043,3833297,483464906,37,566965,573799040,566260,573714182,705,84858,547702,15,712148,82223,34,480,144444.0,43333.0,-71.0,-68.0,-71.0,-71.0,-70.0,-68.0,-70.0,-70.0,-88.0,-89.0,-86.0,-86.0,17.0,21.0,15.0,15.0,1
2155,CC:2F:71:3E:C5:1F,3834151,483569304,854,104398,3833297,483464906,0,3564,299384,2941,225426,623,73958,904,8,1227,19,0,37,130000.0,39000.0,-71.0,-70.0,-67.0,-60.0,-70.0,-70.0,-66.0,-60.0,-88.0,-89.0,-86.0,-86.0,17.0,19.0,19.0,26.0,1
2156,BA:8C:B9:54:50:24,3838115,489645669,4816,6180561,3833299,483465108,0,8848,1689297,8826,1685802,22,3495,2345,15,5243,39,0,56,216660.0,130000.0,-40.0,-37.0,-46.0,-51.0,-43.0,-36.0,-44.0,-48.0,-88.0,-89.0,-86.0,-86.0,48.0,52.0,40.0,35.0,1
2157,92:69:1D:31:68:E9,3837166,487071882,3865,3606572,3833301,483465310,0,4624,1081227,4487,1050267,137,30960,2079,10,4054,84,0,41,216660.0,130000.0,-52.0,-48.0,-45.0,-46.0,-51.0,-47.0,-44.0,-46.0,-88.0,-89.0,-86.0,-86.0,36.0,41.0,41.0,40.0,1
2158,CC:2F:71:3F:1F:24,4545459,1235902192,712158,752436882,3833301,483465310,37,567095,573821407,566390,573736549,705,84858,547830,15,712412,82427,34,480,144444.0,43333.0,-71.0,-68.0,-70.0,-71.0,-70.0,-68.0,-70.0,-71.0,-88.0,-89.0,-86.0,-86.0,17.0,21.0,16.0,15.0,1
2159,CC:2F:71:3E:C5:1F,3834155,483569708,854,104398,3833301,483465310,0,3564,299384,2941,225426,623,73958,904,8,1227,19,0,37,130000.0,39000.0,-71.0,-70.0,-67.0,-60.0,-70.0,-70.0,-66.0,-60.0,-88.0,-89.0,-86.0,-86.0,17.0,19.0,19.0,26.0,1
2160,BA:8C:B9:54:50:24,3838119,489646073,4816,6180561,3833303,483465512,0,8848,1689297,8826,1685802,22,3495,2345,15,5243,39,0,56,216660.0,130000.0,-40.0,-37.0,-46.0,-51.0,-43.0,-36.0,-44.0,-48.0,-88.0,-89.0,-86.0,-86.0,48.0,52.0,40.0,35.0,1
2161,92:69:1D:31:68:E9,3837171,487072346,3865,3606572,3833306,483465774,0,4624,1081227,4487,1050267,137,30960,2079,10,4054,84,0,41,216660.0,130000.0,-52.0,-48.0,-45.0,-46.0,-51.0,-47.0,-44.0,-46.0,-88.0,-89.0,-86.0,-86.0,36.0,41.0,41.0,40.0,1
2162,CC:2F:71:3F:1F:24,4545852,1236368724,712546,752902950,3833306,483465774,37,567272,573848098,566567,573763240,705,84858,548001,15,712801,82467,34,480,130000.0,43333.0,-71.0,-68.0,-70.0,-72.0,-71.0,-68.0,-70.0,-71.0,-88.0,-89.0,-86.0,-86.0,17.0,21.0,16.0,14.0,1
2163,CC:2F:71:3E:C5:1F,3834160,483570172,854,104398,3833306,483465774,0,3564,299384,2941,225426,623,73958,904,8,1227,19,0,37,130000.0,39000.0,-71.0,-70.0,-67.0,-60.0,-70.0,-70.0,-66.0,-60.0,-88.0,-89.0,-86.0,-86.0,17.0,19.0,19.0,26.0,1
2164,BA:8C:B9:54:50:24,3838124,489646537,4816,6180561,3833308,483465976,0,8848,1689297,8826,1685802,22,3495,2345,15,5243,39,0,56,216660.0,130000.0,-40.0,-37.0,-46.0,-51.0,-43.0,-36.0,-44.0,-48.0,-88.0,-89.0,-86.0,-86.0,48.0,52.0,40.0,35.0,1
2165,92:69:1D:31:68:E9,3837175,487072750,3865,3606572,3833310,483466178,0,4624,1081227,4487,1050267,137,30960,2079,10,4054,84,0,41,216660.0,130000.0,-52.0,-48.0,-45.0,-46.0,-51.0,-47.0,-44.0,-46.0,-88.0,-89.0,-86.0,-86.0,36.0,41.0,41.0,40.0,1
2166,CC:2F:71:3F:1F:24,4546133,1236672654,712823,753206476,3833310,483466178,37,567421,573870052,566716,573785194,705,84858,548143,15,713079,82499,34,480,130000.0,43333.0,-71.0,-68.0,-71.0,-71.0,-71.0,-68.0,-70.0,-70.0,-88.0,-89.0,-86.0,-86.0,17.0,21.0,15.0,15.0,1
2167,CC:2F:71:3E:C5:1F,3834164,483570576,854,104398,3833310,483466178,0,3564,299384,2941,225426,623,73958,904,8,1227,19,0,37,130000.0,39000.0,-71.0,-70.0,-67.0,-60.0,-70.0,-70.0,-66.0,-60.0,-88.0,-89.0,-86.0,-86.0,17.0,19.0,19.0,26.0,1
2168,BA:8C:B9:54:50:24,3838128,489646941,4816,6180561,3833312,483466380,0,8848,1689297,8826,1685802,22,3495,2345,15,5243,39,0,56,216660.0,130000.0,-40.0,-37.0,-46.0,-51.0,-43.0,-36.0,-44.0,-48.0,-88.0,-89.0,-86.0,-86.0,48.0,52.0,40.0,35.0,1
2169,92:69:1D:31:68:E9,3837180,487073214,3865,3606572,3833315,483466642,0,4624,1081227,4487,1050267,137,30960,2079,10,4054,84,0,41,216660.0,130000.0,-52.0,-48.0,-45.0,-46.0,-51.0,-47.0,-44.0,-46.0,-88.0,-89.0,-86.0,-86.0,36.0,41.0,41.0,40.0,1
2170,CC:2F:71:3F:1F:24,4546178,1236687565,712862,753220650,3833316,483466915,37,567445,573874182,566740,573789324,705,84858,548164,15,713118,82501,34,480,130000.0,43333.0,-72.0,-68.0,-71.0,-72.0,-72.0,-68.0,-71.0,-71.0,-88.0,-89.0,-86.0,-86.0,16.0,21.0,15.0,14.0,1
2171,CC:2F:71:3E:C5:1F,3834172,483571515,854,104398,3833318,483467117,0,3564,299384,2941,225426,623,73958,904,8,1227,19,0,37,130000.0,39000.0,-71.0,-70.0,-67.0,-60.0,-70.0,-70.0,-66.0,-60.0,-88.0,-89.0,-86.0,-86.0,17.0,19.0,19.0,26.0,1
2172,BA:8C:B9:54:50:24,3838134,489647678,4816,6180561,3833318,483467117,0,8849,1689365,8827,1685870,22,3495,2345,15,5243,39,0,56,216660.0,130000.0,-40.0,-37.0,-45.0,-51.0,-43.0,-36.0,-44.0,-48.0,-88.0,-89.0,-86.0,-86.0,48.0,52.0,41.0,35.0,1
2173,92:69:1D:31:68:E9,3837185,487073891,3865,3606572,3833320,483467319,0,4624,1081227,4487,1050267,137,30960,2079,10,4054,84,0,41,216660.0,130000.0,-52.0,-48.0,-45.0,-46.0,-51.0,-47.0,-44.0,-46.0,-88.0,-89.0,-86.0,-86.0,36.0,41.0,41.0,40.0,1
2174,CC:2F:71:3F:1F:24,4546220,1236702013,712900,753234694,3833320,483467319,37,567467,573878032,566762,573793174,705,84858,548185,15,713156,82502,34,480,130000.0,43333.0,-72.0,-68.0,-71.0,-71.0,-72.0,-68.0,-71.0,-71.0,-88.0,-89.0,-86.0,-86.0,16.0,21.0,15.0,15.0,1
2175,CC:2F:71:3E:C5:1F,3834176,483571919,854,104398,3833322,483467521,0,3564,299384,2941,225426,623,73958,904,8,1227,19,0,37,130000.0,39000.0,-71.0,-70.0,-67.0,-60.0,-70.0,-70.0,-66.0,-60.0,-88.0,-89.0,-86.0,-86.0,17.0,19.0,19.0,26.0,1
2176,BA:8C:B9:54:50:24,3838138,489648082,4816,6180561,3833322,483467521,0,8849,1689365,8827,1685870,22,3495,2345,15,5243,39,0,56,216660.0,130000.0,-40.0,-37.0,-45.0,-51.0,-43.0,-36.0,-44.0,-48.0,-88.0,-89.0,-86.0,-86.0,48.0,52.0,41.0,35.0,1
2177,92:69:1D:31:68:E9,3837189,487074295,3865,3606572,3833324,483467723,0,4624,1081227,4487,1050267,137,30960,2079,10,4054,84,0,41,216660.0,130000.0,-52.0,-48.0,-45.0,-46.0,-51.0,-47.0,-44.0,-46.0,-88.0,-89.0,-86.0,-86.0,36.0,41.0,41.0,40.0,1
2178,CC:2F:71:3F:1F:24,4546266,1236716931,712942,753249208,3833324,483467723,37,567491,573882160,566786,573797302,705,84858,548208,15,713198,82516,34,480,117000.0,39000.0,-71.0,-67.0,-71.0,-68.0,-71.0,-67.0,-70.0,-70.0,-88.0,-89.0,-86.0,-86.0,17.0,22.0,15.0,18.0,1
2179,CC:2F:71:3E:C5:1F,3834180,483572323,854,104398,3833326,483467925,0,3564,299384,2941,225426,623,73958,904,8,1227,19,0,37,130000.0,39000.0,-71.0,-70.0,-67.0,-60.0,-70.0,-70.0,-66.0,-60.0,-88.0,-89.0,-86.0,-86.0,17.0,19.0,19.0,26.0,1
2180,BA:8C:B9:54:50:24,3838142,489648486,4816,6180561,3833326,483467925,0,8849,1689365,8827,1685870,22,3495,2345,15,5243,39,0,56,216660.0,130000.0,-40.0,-37.0,-45.0,-51.0,-43.0,-36.0,-44.0,-48.0,-88.0,-89.0,-86.0,-86.0,48.0,52.0,41.0,35.0,1
2181,92:69:1D:31:68:E9,3837194,487074759,3865,3606572,3833329,483468187,0,4624,1081227,4487,1050267,137,30960,2079,10,4054,84,0,41,216660.0,130000.0,-52.0,-48.0,-45.0,-46.0,-51.0,-47.0,-44.0,-46.0,-88.0,-89.0,-86.0,-86.0,36.0,41.0,41.0,40.0,1
2182,CC:2F:71:3F:1F:24,4546316,1236734742,712987,753266555,3833329,483468187,37,567521,573887429,566816,573802571,705,84858,548237,15,713243,82523,34,480,130000.0,39000.0,-71.0,-67.0,-70.0,-71.0,-70.0,-67.0,-70.0,-71.0,-88.0,-89.0,-86.0,-86.0,17.0,22.0,16.0,15.0,1
2183,CC:2F:71:3E:C5:1F,3834183,483572585,854,104398,3833329,483468187,0,3564,299384,2941,225426,623,73958,904,8,1227,19,0,37,130000.0,39000.0,-71.0,-70.0,-67.0,-60.0,-70.0,-70.0,-66.0,-60.0,-88.0,-89.0,-86.0,-86.0,17.0,19.0,19.0,26.0,1
2184,BA:8C:B9:54:50:24,3838147,489648950,4816,6180561,3833331,483468389,0,8849,1689365,8827,1685870,22,3495,2345,15,5243,39,0,56,216660.0,130000.0,-40.0,-37.0,-45.0,-51.0,-43.0,-36.0,-44.0,-48.0,-88.0,-89.0,-86.0,-86.0,48.0,52.0,41.0,35.0,1
2185,92:69:1D:31:68:E9,3837198,487075163,3865,3606572,3833333,483468591,0,4624,1081227,4487,1050267,137,30960,2079,10,4054,84,0,41,216660.0,130000.0,-52.0,-48.0,-45.0,-46.0,-51.0,-47.0,-44.0,-46.0,-88.0,-88.0,-86.0,-85.0,36.0,40.0,41.0,39.0,1
2186,CC:2F:71:3F:1F:24,4546362,1236749540,713027,753280747,3833335,483468793,37,567543,573891279,566838,573806421,705,84858,548258,15,713283,82527,34,480,144444.0,43333.0,-71.0,-68.0,-70.0,-69.0,-70.0,-67.0,-70.0,-71.0,-88.0,-88.0,-86.0,-85.0,17.0,20.0,16.0,16.0,1
2187,CC:2F:71:3E:C5:1F,3834189,483573191,854,104398,3833335,483468793,0,3564,299384,2941,225426,623,73958,904,8,1227,19,0,37,130000.0,39000.0,-71.0,-70.0,-67.0,-60.0,-70.0,-70.0,-66.0,-60.0,-88.0,-88.0,-86.0,-85.0,17.0,18.0,19.0,25.0,1
2188,BA:8C:B9:54:50:24,3838151,489649354,4816,6180561,3833335,483468793,0,8849,1689365,8827,1685870,22,3495,2345,15,5243,39,0,56,216660.0,130000.0,-40.0,-37.0,-45.0,-51.0,-43.0,-36.0,-44.0,-48.0,-88.0,-88.0,-86.0,-85.0,48.0,51.0,41.0,34.0,1
2189,92:69:1D:31:68:E9,3837202,487075567,3865,3606572,3833337,483468995,0,4624,1081227,4487,1050267,137,30960,2079,10,4054,84,0,41,216660.0,130000.0,-52.0,-48.0,-45.0,-46.0,-51.0,-47.0,-44.0,-46.0,-88.0,-88.0,-86.0,-85.0,36.0,40.0,41.0,39.0,1
2190,CC:2F:71:3F:1F:24,4546404,1236764046,713067,753295051,3833337,483468995,37,567568,573895553,566863,573810695,705,84858,548280,15,713323,82528,34,480,144444.0,43333.0,-70.0,-67.0,-70.0,-71.0,-70.0,-67.0,-70.0,-71.0,-88.0,-88.0,-86.0,-85.0,18.0,21.0,16.0,14.0,1
2191,CC:2F:71:3E:C5:1F,3834191,483573393,854,104398,3833337,483468995,0,3564,299384,2941,225426,623,73958,904,8,1227,19,0,37,130000.0,39000.0,-71.0,-70.0,-67.0,-60.0,-70.0,-70.0,-66.0,-60.0,-88.0,-88.0,-86.0,-85.0,17.0,18.0,19.0,25.0,1
2192,BA:8C:B9:54:50:24,3838155,489649758,4816,6180561,3833339,483469197,0,8849,1689365,8827,1685870,22,3495,2345,15,5243,39,0,56,216660.0,130000.0,-40.0,-37.0,-45.0,-51.0,-43.0,-36.0,-44.0,-48.0,-88.0,-88.0,-86.0,-85.0,48.0,51.0,41.0,34.0,1
2193,92:69:1D:31:68:E9,3837207,487076031,3865,3606572,3833342,483469459,0,4624,1081227,4487,1050267,137,30960,2079,10,4054,84,0,41,216660.0,130000.0,-52.0,-48.0,-45.0,-46.0,-51.0,-47.0,-44.0,-46.0,-88.0,-88.0,-86.0,-85.0,36.0,40.0,41.0,39.0,1
2194,CC:2F:71:3F:1F:24,4546449,1236778814,713107,753309355,3833342,483469459,37,567590,573899403,566885,573814545,705,84858,548301,15,713363,82538,34,480,144444.0,43333.0,-71.0,-68.0,-72.0,-71.0,-71.0,-68.0,-71.0,-71.0,-88.0,-88.0,-86.0,-85.0,17.0,20.0,14.0,14.0,1
2195,CC:2F:71:3E:C5:1F,3834198,483574059,854,104398,3833344,483469661,0,3564,299384,2941,225426,623,73958,904,8,1227,19,0,37,130000.0,39000.0,-71.0,-70.0,-67.0,-60.0,-70.0,-70.0,-66.0,-60.0,-88.0,-88.0,-86.0,-85.0,17.0,18.0,19.0,25.0,1
2196,BA:8C:B9:54:50:24,3838160,489650222,4816,6180561,3833344,483469661,0,8849,1689365,8827,1685870,22,3495,2345,15,5243,39,0,56,216660.0,130000.0,-40.0,-37.0,-45.0,-51.0,-43.0,-36.0,-44.0,-48.0,-88.0,-88.0,-86.0,-85.0,48.0,51.0,41.0,34.0,1
2197,92:69:1D:31:68:E9,3837211,487076435,3865,3606572,3833346,483469863,0,4624,1081227,4487,1050267,137,30960,2079,10,4054,84,0,41,216660.0,130000.0,-52.0,-48.0,-45.0,-46.0,-51.0,-47.0,-44.0,-46.0,-88.0,-88.0,-86.0,-85.0,36.0,40.0,41.0,39.0,1
2198,CC:2F:71:3F:1F:24,4546491,1236793262,713145,753323399,3833346,483469863,37,567612,573903253,566907,573818395,705,84858,548322,15,713401,82556,34,480,144444.0,43333.0,-70.0,-68.0,-71.0,-71.0,-70.0,-68.0,-70.0,-71.0,-88.0,-88.0,-86.0,-85.0,18.0,20.0,15.0,14.0,1
2199,CC:2F:71:3E:C5:1F,3834200,483574261,854,104398,3833346,483469863,0,3564,299384,2941,225426,623,73958,904,8,1227,19,0,37,130000.0,39000.0,-71.0,-70.0,-67.0,-60.0,-70.0,-70.0,-66.0,-60.0,-88.0,-88.0,-86.0,-85.0,17.0,18.0,19.0,25.0,1
2200,BA:8C:B9:54:50:24,3838162,489650424,4816,6180561,3833346,483469863,0,8849,1689365,8827,1685870,22,3495,2345,15,5243,39,0,56,216660.0,130000.0,-40.0,-37.0,-45.0,-51.0,-43.0,-36.0,-44.0,-48.0,-88.0,-88.0,-86.0,-85.0,48.0,51.0,41.0,34.0,1
2201,92:69:1D:31:68:E9,3837214,487076697,3865,3606572,3833349,483470125,0,4624,1081227,4487,1050267,137,30960,2079,10,4054,84,0,41,216660.0,130000.0,-52.0,-48.0,-45.0,-46.0,-51.0,-47.0,-44.0,-46.0,-88.0,-88.0,-86.0,-85.0,36.0,40.0,41.0,39.0,1
2202,CC:2F:71:3F:1F:24,4546543,1236811501,713192,753341174,3833351,483470327,37,567644,573908880,566939,573824022,705,84858,548351,15,713448,82594,34,480,144444.0,43333.0,-70.0,-68.0,-70.0,-71.0,-70.0,-68.0,-70.0,-71.0,-88.0,-88.0,-86.0,-85.0,18.0,20.0,16.0,14.0,1
2203,CC:2F:71:3E:C5:1F,3834207,483574927,854,104398,3833353,483470529,0,3564,299384,2941,225426,623,73958,904,8,1227,19,0,37,130000.0,39000.0,-71.0,-70.0,-67.0,-60.0,-70.0,-70.0,-66.0,-60.0,-88.0,-88.0,-86.0,-85.0,17.0,18.0,19.0,25.0,1
2204,BA:8C:B9:54:50:24,3838169,489651090,4816,6180561,3833353,483470529,0,8849,1689365,8827,1685870,22,3495,2345,15,5243,39,0,56,216660.0,130000.0,-40.0,-37.0,-45.0,-51.0,-43.0,-36.0,-44.0,-48.0,-88.0,-88.0,-86.0,-85.0,48.0,51.0,41.0,34.0,1
2205,92:69:1D:31:68:E9,3837220,487077303,3865,3606572,3833355,483470731,0,4624,1081227,4487,1050267,137,30960,2079,10,4054,84,0,41,216660.0,130000.0,-52.0,-48.0,-45.0,-46.0,-51.0,-47.0,-44.0,-46.0,-88.0,-88.0,-86.0,-85.0,36.0,40.0,41.0,39.0,1
2206,CC:2F:71:3F:1F:24,4546585,1236825949,713230,753355218,3833355,483470731,37,567669,573913202,566964,573828344,705,84858,548373,15,713486,82621,34,480,144444.0,43333.0,-70.0,-68.0,-70.0,-71.0,-70.0,-68.0,-70.0,-71.0,-88.0,-88.0,-86.0,-85.0,18.0,20.0,16.0,14.0,1
2207,CC:2F:71:3E:C5:1F,3834209,483575129,854,104398,3833355,483470731,0,3564,299384,2941,225426,623,73958,904,8,1227,19,0,37,130000.0,39000.0,-71.0,-70.0,-67.0,-60.0,-70.0,-70.0,-66.0,-60.0,-88.0,-88.0,-86.0,-85.0,17.0,18.0,19.0,25.0,1
2208,BA:8C:B9:54:50:24,3838171,489651292,4816,6180561,3833355,483470731,0,8849,1689365,8827,1685870,22,3495,2345,15,5243,39,0,56,216660.0,130000.0,-40.0,-37.0,-45.0,-51.0,-43.0,-36.0,-44.0,-48.0,-88.0,-88.0,-86.0,-85.0,48.0,51.0,41.0,34.0,1
2209,92:69:1D:31:68:E9,3837222,487077505,3865,3606572,3833357,483470933,0,4624,1081227,4487,1050267,137,30960,2079,10,4054,84,0,41,216660.0,130000.0,-52.0,-48.0,-45.0,-46.0,-51.0,-47.0,-44.0,-46.0,-88.0,-88.0,-86.0,-85.0,36.0,40.0,41.0,39.0,1
2210,CC:2F:71:3F:1F:24,4546629,1236840657,713270,753369522,3833359,483471135,37,567698,573918158,566993,573833300,705,84858,548396,15,713526,82652,34,480,144444.0,43333.0,-70.0,-68.0,-71.0,-71.0,-70.0,-68.0,-70.0,-71.0,-88.0,-88.0,-86.0,-85.0,18.0,20.0,15.0,14.0,1
2211,CC:2F:71:3E:C5:1F,3834215,483575735,854,104398,3833361,483471337,0,3564,299384,2941,225426,623,73958,904,8,1227,19,0,37,130000.0,39000.0,-71.0,-70.0,-67.0,-60.0,-70.0,-70.0,-66.0,-60.0,-88.0,-88.0,-86.0,-85.0,17.0,18.0,19.0,25.0,1
2212,BA:8C:B9:54:50:24,3838177,489651898,4816,6180561,3833361,483471337,0,8849,1689365,8827,1685870,22,3495,2345,15,5243,39,0,56,216660.0,130000.0,-40.0,-37.0,-45.0,-51.0,-43.0,-36.0,-44.0,-48.0,-88.0,-88.0,-86.0,-85.0,48.0,51.0,41.0,34.0,1
2213,92:69:1D:31:68:E9,3837229,487078171,3865,3606572,3833364,483471599,0,4624,1081227,4487,1050267,137,30960,2079,10,4054,84,0,41,216660.0,130000.0,-52.0,-48.0,-45.0,-46.0,-51.0,-47.0,-44.0,-46.0,-88.0,-88.0,-85.0,-85.0,36.0,40.0,40.0,39.0,1
2214,CC:2F:71:3F:1F:24,4546673,1236855295,713309,753383696,3833364,483471599,37,567722,573922302,567017,573837444,705,84858,548418,15,713565,82679,34,480,144444.0,43333.0,-73.0,-68.0,-69.0,-73.0,-72.0,-68.0,-69.0,-72.0,-88.0,-88.0,-85.0,-85.0,15.0,20.0,16.0,12.0,1
2215,CC:2F:71:3E:C5:1F,3834218,483575997,854,104398,3833364,483471599,0,3564,299384,2941,225426,623,73958,904,8,1227,19,0,37,130000.0,39000.0,-71.0,-70.0,-67.0,-60.0,-70.0,-70.0,-66.0,-60.0,-88.0,-88.0,-85.0,-85.0,17.0,18.0,18.0,25.0,1
2216,BA:8C:B9:54:50:24,3838180,489652160,4816,6180561,3833364,483471599,0,8849,1689365,8827,1685870,22,3495,2345,15,5243,39,0,56,216660.0,130000.0,-40.0,-37.0,-45.0,-51.0,-43.0,-36.0,-44.0,-48.0,-88.0,-88.0,-85.0,-85.0,48.0,51.0,40.0,34.0,1
2217,92:69:1D:31:68:E9,3837232,487078489,3866,3606688,3833366,483471801,0,4626,1081363,4489,1050403,137,30960,2079,10,4055,84,0,41,216660.0,130000.0,-52.0,-48.0,-44.0,-47.0,-52.0,-48.0,-44.0,-46.0,-88.0,-88.0,-85.0,-85.0,36.0,40.0,41.0,38.0,1
2218,CC:2F:71:3F:1F:24,4546723,1236873388,713357,753401587,3833366,483471801,37,567755,573927936,567050,573843078,705,84858,548447,15,713613,82704,34,480,144444.0,43333.0,-72.0,-69.0,-70.0,-72.0,-72.0,-69.0,-69.0,-70.0,-88.0,-88.0,-85.0,-85.0,16.0,19.0,15.0,13.0,1
2219,CC:2F:71:3E:C5:1F,3834225,483576719,855,104514,3833370,483472205,0,3566,299524,2943,225566,623,73958,904,8,1228,19,0,37,130000.0,39000.0,-71.0,-71.0,-67.0,-60.0,-70.0,-70.0,-66.0,-60.0,-88.0,-88.0,-85.0,-85.0,17.0,17.0,18.0,25.0,1
2220,BA:8C:B9:54:50:24,3838187,489652882,4817,6180677,3833370,483472205,0,8851,1689501,8829,1686006,22,3495,2345,15,5244,39,0,56,216660.0,130000.0,-48.0,-35.0,-43.0,-45.0,-43.0,-36.0,-44.0,-48.0,-88.0,-88.0,-85.0,-85.0,40.0,53.0,42.0,40.0,1
2221,92:69:1D:31:68:E9,3837238,487079095,3866,3606688,3833372,483472407,0,4626,1081363,4489,1050403,137,30960,2079,10,4055,84,0,41,216660.0,130000.0,-52.0,-48.0,-44.0,-47.0,-52.0,-48.0,-44.0,-46.0,-88.0,-88.0,-85.0,-85.0,36.0,40.0,41.0,38.0,1
2222,CC:2F:71:3F:1F:24,4546768,1236888168,713396,753415761,3833372,483472407,37,567777,573931786,567072,573846928,705,84858,548468,15,713652,82743,34,480,144444.0,43333.0,-72.0,-69.0,-69.0,-71.0,-71.0,-68.0,-69.0,-71.0,-88.0,-88.0,-85.0,-85.0,16.0,19.0,16.0,14.0,1
2223,CC:2F:71:3E:C5:1F,3834227,483576921,855,104514,3833372,483472407,0,3566,299524,2943,225566,623,73958,904,8,1228,19,0,37,130000.0,39000.0,-71.0,-71.0,-67.0,-60.0,-70.0,-70.0,-66.0,-60.0,-88.0,-88.0,-85.0,-85.0,17.0,17.0,18.0,25.0,1
2224,BA:8C:B9:54:50:24,3838189,489653084,4817,6180677,3833372,483472407,0,8851,1689501,8829,1686006,22,3495,2345,15,5244,39,0,56,216660.0,130000.0,-48.0,-35.0,-43.0,-45.0,-43.0,-36.0,-44.0,-48.0,-88.0,-88.0,-85.0,-85.0,40.0,53.0,42.0,40.0,1
2225,92:69:1D:31:68:E9,3837242,487079630,3866,3606688,3833376,483472942,0,4626,1081363,4489,1050403,137,30960,2079,10,4055,84,0,41,216660.0,130000.0,-52.0,-48.0,-44.0,-47.0,-52.0,-48.0,-44.0,-46.0,-88.0,-88.0,-85.0,-85.0,36.0,40.0,41.0,38.0,1
2226,CC:2F:71:3F:1F:24,4546810,1236902747,713434,753429805,3833376,483472942,37,567804,573936358,567099,573851500,705,84858,548493,15,713690,82773,34,480,144444.0,43333.0,-73.0,-69.0,-69.0,-72.0,-72.0,-68.0,-69.0,-71.0,-88.0,-88.0,-85.0,-85.0,15.0,19.0,16.0,13.0,1
2227,CC:2F:71:3E:C5:1F,3834235,483577860,855,104514,3833380,483473346,0,3566,299524,2943,225566,623,73958,904,8,1228,19,0,37,130000.0,39000.0,-71.0,-71.0,-67.0,-60.0,-70.0,-70.0,-66.0,-60.0,-88.0,-88.0,-85.0,-85.0,17.0,17.0,18.0,25.0,1
2228,BA:8C:B9:54:50:24,3838197,489654023,4817,6180677,3833380,483473346,0,8851,1689501,8829,1686006,22,3495,2345,15,5244,39,0,56,216660.0,130000.0,-48.0,-35.0,-43.0,-45.0,-43.0,-36.0,-44.0,-48.0,-88.0,-88.0,-85.0,-85.0,40.0,53.0,42.0,40.0,1
2229,92:69:1D:31:68:E9,3837248,487080236,3866,3606688,3833382,483473548,0,4626,1081363,4489,1050403,137,30960,2079,10,4055,84,0,41,216660.0,130000.0,-52.0,-48.0,-44.0,-47.0,-52.0,-48.0,-44.0,-46.0,-88.0,-88.0,-85.0,-85.0,36.0,40.0,41.0,38.0,1
2230,CC:2F:71:3F:1F:24,4546855,1236917527,713473,753443979,3833382,483473548,37,567826,573940208,567121,573855350,705,84858,548514,15,713729,82808,34,480,144444.0,43333.0,-73.0,-68.0,-69.0,-72.0,-72.0,-68.0,-69.0,-71.0,-88.0,-88.0,-85.0,-85.0,15.0,20.0,16.0,13.0,1
2231,CC:2F:71:3E:C5:1F,3834237,483578062,855,104514,3833382,483473548,0,3566,299524,2943,225566,623,73958,904,8,1228,19,0,37,130000.0,39000.0,-71.0,-71.0,-67.0,-60.0,-70.0,-70.0,-66.0,-60.0,-88.0,-88.0,-85.0,-85.0,17.0,17.0,18.0,25.0,1
2232,BA:8C:B9:54:50:24,3838199,489654225,4817,6180677,3833382,483473548,0,8851,1689501,8829,1686006,22,3495,2345,15,5244,39,0,56,216660.0,130000.0,-48.0,-35.0,-43.0,-45.0,-43.0,-36.0,-44.0,-48.0,-88.0,-88.0,-85.0,-85.0,40.0,53.0,42.0,40.0,1
2233,92:69:1D:31:68:E9,3837251,487080498,3866,3606688,3833385,483473810,0,4626,1081363,4489,1050403,137,30960,2079,10,4055,84,0,41,216660.0,130000.0,-52.0,-48.0,-44.0,-47.0,-52.0,-48.0,-44.0,-46.0,-88.0,-88.0,-85.0,-85.0,36.0,40.0,41.0,38.0,1
2234,CC:2F:71:3F:1F:24,4546902,1236934950,713517,753461140,3833385,483473810,37,567860,573946030,567155,573861172,705,84858,548546,15,713773,82849,34,480,144444.0,43333.0,-72.0,-69.0,-70.0,-72.0,-72.0,-68.0,-69.0,-71.0,-88.0,-88.0,-85.0,-85.0,16.0,19.0,15.0,13.0,1
2235,CC:2F:71:3E:C5:1F,3834244,483578728,855,104514,3833389,483474214,0,3566,299524,2943,225566,623,73958,904,8,1228,19,0,37,130000.0,39000.0,-71.0,-71.0,-67.0,-60.0,-70.0,-70.0,-66.0,-60.0,-88.0,-88.0,-85.0,-85.0,17.0,17.0,18.0,25.0,1
2236,BA:8C:B9:54:50:24,3838206,489654891,4817,6180677,3833389,483474214,0,8851,1689501,8829,1686006,22,3495,2345,15,5244,39,0,56,216660.0,130000.0,-48.0,-35.0,-43.0,-45.0,-43.0,-36.0,-44.0,-48.0,-88.0,-88.0,-85.0,-85.0,40.0,53.0,42.0,40.0,1
2237,92:69:1D:31:68:E9,3837255,487080902,3866,3606688,3833389,483474214,0,4626,1081363,4489,1050403,137,30960,2079,10,4055,84,0,41,216660.0,130000.0,-52.0,-48.0,-44.0,-47.0,-52.0,-48.0,-44.0,-46.0,-88.0,-88.0,-85.0,-85.0,36.0,40.0,41.0,38.0,1
2238,CC:2F:71:3F:1F:24,4546946,1236949658,713557,753475444,3833389,483474214,37,567890,573950839,567185,573865981,705,84858,548574,15,713813,82873,34,480,144444.0,43333.0,-72.0,-69.0,-70.0,-72.0,-72.0,-68.0,-69.0,-71.0,-88.0,-88.0,-85.0,-85.0,16.0,19.0,15.0,13.0,1
2239,CC:2F:71:3E:C5:1F,3834246,483578930,855,104514,3833391,483474416,0,3566,299524,2943,225566,623,73958,904,8,1228,19,0,37,130000.0,39000.0,-71.0,-71.0,-67.0,-60.0,-70.0,-70.0,-66.0,-60.0,-88.0,-88.0,-85.0,-85.0,17.0,17.0,18.0,25.0,1
2240,BA:8C:B9:54:50:24,3838208,489655093,4817,6180677,3833391,483474416,0,8851,1689501,8829,1686006,22,3495,2345,15,5244,39,0,56,216660.0,130000.0,-48.0,-35.0,-43.0,-45.0,-43.0,-36.0,-44.0,-48.0,-88.0,-88.0,-85.0,-85.0,40.0,53.0,42.0,40.0,1
2241,92:69:1D:31:68:E9,3837259,487081306,3866,3606688,3833393,483474618,0,4626,1081363,4489,1050403,137,30960,2079,10,4055,84,0,41,216660.0,130000.0,-52.0,-48.0,-44.0,-47.0,-52.0,-48.0,-44.0,-46.0,-88.0,-88.0,-85.0,-85.0,36.0,40.0,41.0,38.0,1
2242,CC:2F:71:3F:1F:24,4546988,1236964106,713595,753489488,3833393,483474618,37,567918,573955541,567213,573870683,705,84858,548599,15,713851,82901,34,480,144444.0,43333.0,-72.0,-69.0,-69.0,-68.0,-72.0,-68.0,-69.0,-70.0,-88.0,-88.0,-85.0,-85.0,16.0,19.0,16.0,17.0,1
2243,CC:2F:71:3E:C5:1F,3834250,483579334,855,104514,3833395,483474820,0,3566,299524,2943,225566,623,73958,904,8,1228,19,0,37,130000.0,39000.0,-71.0,-71.0,-67.0,-60.0,-70.0,-70.0,-66.0,-60.0,-88.0,-88.0,-85.0,-85.0,17.0,17.0,18.0,25.0,1
2244,BA:8C:B9:54:50:24,3838214,489655699,4817,6180677,3833397,483475022,0,8851,1689501,8829,1686006,22,3495,2345,15,5244,39,0,56,216660.0,130000.0,-48.0,-35.0,-43.0,-45.0,-43.0,-36.0,-44.0,-48.0,-88.0,-88.0,-85.0,-85.0,40.0,53.0,42.0,40.0,1
2245,92:69:1D:31:68:E9,3837265,487081830,3866,3606688,3833399,483475142,0,4626,1081363,4489,1050403,137,30960,2079,10,4055,84,0,41,216660.0,130000.0,-52.0,-48.0,-44.0,-47.0,-52.0,-48.0,-44.0,-46.0,-88.0,-88.0,-85.0,-85.0,36.0,40.0,41.0,38.0,1
2246,CC:2F:71:3F:1F:24,4547047,1236982500,713648,753507358,3833399,483475142,37,567956,573962968,567251,573878110,705,84858,548631,15,713904,82955,34,480,144444.0,43333.0,-72.0,-68.0,-69.0,-71.0,-71.0,-68.0,-69.0,-70.0,-88.0,-88.0,-85.0,-85.0,16.0,20.0,16.0,14.0,1
2247,CC:2F:71:3E:C5:1F,3834254,483579656,855,104514,3833399,483475142,0,3566,299524,2943,225566,623,73958,904,8,1228,19,0,37,130000.0,39000.0,-71.0,-71.0,-67.0,-60.0,-70.0,-70.0,-66.0,-60.0,-88.0,-88.0,-85.0,-85.0,17.0,17.0,18.0,25.0,1
2248,BA:8C:B9:54:50:24,3838216,489655819,4817,6180677,3833399,483475142,0,8851,1689501,8829,1686006,22,3495,2345,15,5244,39,0,56,216660.0,130000.0,-48.0,-35.0,-43.0,-45.0,-43.0,-36.0,-44.0,-48.0,-88.0,-88.0,-85.0,-85.0,40.0,53.0,42.0,40.0,1
2249,92:69:1D:31:68:E9,3837269,487082234,3866,3606688,3833403,483475546,0,4626,1081363,4489,1050403,137,30960,2079,10,4055,84,0,41,216660.0,130000.0,-52.0,-48.0,-44.0,-47.0,-52.0,-48.0,-44.0,-46.0,-88.0,-88.0,-85.0,-85.0,36.0,40.0,41.0,38.0,1
2250,CC:2F:71:3F:1F:24,4547097,1237000425,713693,753524817,3833404,483475608,37,567987,573968430,567282,573883572,705,84858,548659,15,713949,82974,34,480,130000.0,43333.0,-72.0,-68.0,-69.0,-72.0,-72.0,-68.0,-69.0,-71.0,-88.0,-88.0,-85.0,-85.0,16.0,20.0,16.0,13.0,1
2251,CC:2F:71:3E:C5:1F,3834259,483580122,855,104514,3833404,483475608,0,3569,299782,2945,225706,624,74076,905,8,1229,19,0,37,130000.0,39000.0,-71.0,-71.0,-68.0,-60.0,-70.0,-70.0,-67.0,-60.0,-88.0,-88.0,-85.0,-85.0,17.0,17.0,17.0,25.0,1
2252,BA:8C:B9:54:50:24,3838225,489656689,4817,6180677,3833408,483476012,0,8855,1689773,8833,1686278,22,3495,2345,15,5244,39,0,56,216660.0,130000.0,-48.0,-35.0,-43.0,-45.0,-43.0,-36.0,-44.0,-48.0,-88.0,-88.0,-85.0,-85.0,40.0,53.0,42.0,40.0,1
2253,92:69:1D:31:68:E9,3837274,487082700,3866,3606688,3833408,483476012,0,4628,1081499,4491,1050539,137,30960,2079,10,4056,84,0,41,216660.0,130000.0,-52.0,-47.0,-42.0,-48.0,-52.0,-47.0,-44.0,-47.0,-88.0,-88.0,-85.0,-85.0,36.0,41.0,43.0,37.0,1
2254,CC:2F:71:3F:1F:24,4547186,1237075079,713778,753599067,3833408,483476012,37,568062,574034225,567357,573949367,705,84858,548727,15,714034,82974,34,480,130000.0,43333.0,-72.0,-68.0,-69.0,-71.0,-72.0,-68.0,-69.0,-71.0,-88.0,-88.0,-85.0,-85.0,16.0,20.0,16.0,14.0,1
2255,CC:2F:71:3E:C5:1F,3834263,483580526,855,104514,3833408,483476012,0,3569,299782,2945,225706,624,74076,905,8,1229,19,0,37,130000.0,39000.0,-71.0,-71.0,-68.0,-60.0,-70.0,-70.0,-67.0,-60.0,-88.0,-88.0,-85.0,-85.0,17.0,17.0,17.0,25.0,1
2256,BA:8C:B9:54:50:24,3838225,489656689,4817,6180677,3833408,483476012,0,8855,1689773,8833,1686278,22,3495,2345,15,5244,39,0,56,216660.0,130000.0,-48.0,-35.0,-43.0,-45.0,-43.0,-36.0,-44.0,-48.0,-88.0,-88.0,-85.0,-85.0,40.0,53.0,42.0,40.0,1
2257,92:69:1D:31:68:E9,3837280,487083226,3866,3606688,3833414,483476538,0,4629,1081567,4492,1050607,137,30960,2079,10,4056,84,0,41,216660.0,130000.0,-51.0,-48.0,-45.0,-50.0,-51.0,-47.0,-44.0,-47.0,-88.0,-88.0,-85.0,-84.0,37.0,40.0,40.0,34.0,1
2258,CC:2F:71:3F:1F:24,4547298,1237193561,713884,753717023,3833414,483476538,37,568154,574145965,567448,574060989,706,84976,548816,15,714140,82994,34,480,117000.0,39000.0,-72.0,-68.0,-69.0,-71.0,-72.0,-68.0,-69.0,-71.0,-88.0,-88.0,-85.0,-84.0,16.0,20.0,16.0,13.0,1
2259,CC:2F:71:3E:C5:1F,3834269,483581052,855,104514,3833414,483476538,0,3569,299782,2945,225706,624,74076,905,8,1229,19,0,37,130000.0,39000.0,-71.0,-71.0,-68.0,-60.0,-70.0,-70.0,-67.0,-60.0,-88.0,-88.0,-85.0,-84.0,17.0,17.0,17.0,24.0,1
2260,BA:8C:B9:54:50:24,3838233,489657417,4817,6180677,3833416,483476740,0,8855,1689773,8833,1686278,22,3495,2345,15,5244,39,0,56,216660.0,130000.0,-48.0,-35.0,-43.0,-45.0,-43.0,-36.0,-44.0,-48.0,-88.0,-88.0,-85.0,-84.0,40.0,53.0,42.0,39.0,1
2261,92:69:1D:31:68:E9,3837286,487083916,3868,3606974,3833418,483476942,0,4633,1081971,4496,1051011,137,30960,2081,10,4058,84,0,41,216660.0,130000.0,-52.0,-47.0,-43.0,-48.0,-51.0,-48.0,-44.0,-48.0,-88.0,-88.0,-85.0,-84.0,36.0,41.0,42.0,36.0,1
2262,CC:2F:71:3F:1F:24,4547409,1237312275,713991,753835333,3833418,483476942,37,568243,574254479,567537,574169503,706,84976,548904,15,714247,83000,34,480,130000.0,43333.0,-72.0,-68.0,-69.0,-71.0,-71.0,-68.0,-69.0,-71.0,-88.0,-88.0,-85.0,-84.0,16.0,20.0,16.0,13.0,1
2263,CC:2F:71:3E:C5:1F,3834273,483581456,855,104514,3833418,483476942,0,3569,299782,2945,225706,624,74076,905,8,1229,19,0,37,130000.0,39000.0,-71.0,-71.0,-68.0,-60.0,-70.0,-70.0,-67.0,-60.0,-88.0,-88.0,-85.0,-84.0,17.0,17.0,17.0,24.0,1
2264,BA:8C:B9:54:50:24,3838235,489657619,4817,6180677,3833418,483476942,0,8855,1689773,8833,1686278,22,3495,2345,15,5244,39,0,56,216660.0,130000.0,-48.0,-35.0,-43.0,-45.0,-43.0,-36.0,-44.0,-48.0,-88.0,-88.0,-85.0,-84.0,40.0,53.0,42.0,39.0,1
2265,92:69:1D:31:68:E9,3837291,487084380,3868,3606974,3833423,483477406,0,4633,1081971,4496,1051011,137,30960,2081,10,4058,84,0,41,216660.0,130000.0,-52.0,-47.0,-43.0,-48.0,-51.0,-48.0,-44.0,-48.0,-88.0,-88.0,-85.0,-84.0,36.0,41.0,42.0,36.0,1
2266,CC:2F:71:3F:1F:24,4547533,1237439534,714110,753962128,3833423,483477406,37,568348,574370022,567642,574285046,706,84976,549005,15,714366,83009,34,480,117000.0,39000.0,-70.0,-67.0,-70.0,-72.0,-70.0,-67.0,-69.0,-71.0,-88.0,-88.0,-85.0,-84.0,18.0,21.0,15.0,12.0,1
2267,CC:2F:71:3E:C5:1F,3834278,483581920,855,104514,3833423,483477406,0,3569,299782,2945,225706,624,74076,905,8,1229,19,0,37,130000.0,39000.0,-71.0,-71.0,-68.0,-60.0,-70.0,-70.0,-67.0,-60.0,-88.0,-88.0,-85.0,-84.0,17.0,17.0,17.0,24.0,1
2268,BA:8C:B9:54:50:24,3838242,489658285,4817,6180677,3833425,483477608,0,8855,1689773,8833,1686278,22,3495,2345,15,5244,39,0,56,216660.0,130000.0,-48.0,-35.0,-43.0,-45.0,-43.0,-36.0,-44.0,-48.0,-88.0,-88.0,-85.0,-84.0,40.0,53.0,42.0,39.0,1
2269,92:69:1D:31:68:E9,3837307,487090383,3868,3606974,3833439,483483409,0,4636,1082342,4498,1051147,138,31195,2082,10,4058,84,0,41,216660.0,130000.0,-52.0,-47.0,-43.0,-49.0,-52.0,-48.0,-44.0,-49.0,-88.0,-88.0,-85.0,-84.0,36.0,41.0,42.0,35.0,1
2270,CC:2F:71:3F:1F:24,4547657,1237566769,714218,754083360,3833439,483483409,37,568441,574484842,567735,574399866,706,84976,549094,15,714474,83014,34,480,130000.0,39000.0,-70.0,-67.0,-69.0,-71.0,-70.0,-67.0,-69.0,-71.0,-88.0,-88.0,-85.0,-84.0,18.0,21.0,16.0,13.0,1
2271,CC:2F:71:3E:C5:1F,3834305,483593347,855,104514,3833450,483488833,0,3569,299782,2945,225706,624,74076,905,8,1229,19,0,37,130000.0,39000.0,-71.0,-71.0,-68.0,-60.0,-70.0,-70.0,-67.0,-60.0,-88.0,-88.0,-85.0,-84.0,17.0,17.0,17.0,24.0,1
2272,BA:8C:B9:54:50:24,3838267,489669510,4817,6180677,3833450,483488833,0,8855,1689773,8833,1686278,22,3495,2345,15,5244,39,0,56,216660.0,130000.0,-48.0,-35.0,-43.0,-45.0,-43.0,-36.0,-44.0,-48.0,-87.0,-87.0,-85.0,-84.0,39.0,52.0,42.0,39.0,1
2273,92:69:1D:31:68:E9,3837322,487096211,3868,3606974,3833454,483489237,0,4636,1082342,4498,1051147,138,31195,2082,10,4058,84,0,41,216660.0,130000.0,-52.0,-47.0,-43.0,-49.0,-52.0,-48.0,-44.0,-49.0,-87.0,-87.0,-85.0,-84.0,35.0,40.0,42.0,35.0,1
2274,CC:2F:71:3F:1F:24,4547785,1237700231,714331,754210994,3833454,483489237,37,568544,574606400,567838,574521424,706,84976,549194,15,714587,83015,34,480,144444.0,43333.0,-70.0,-67.0,-70.0,-71.0,-70.0,-66.0,-69.0,-70.0,-87.0,-87.0,-85.0,-84.0,17.0,20.0,15.0,13.0,1
2275,CC:2F:71:3E:C5:1F,3834311,483593953,855,104514,3833456,483489439,0,3569,299782,2945,225706,624,74076,905,8,1229,19,0,37,130000.0,39000.0,-71.0,-71.0,-68.0,-60.0,-70.0,-70.0,-67.0,-60.0,-87.0,-87.0,-85.0,-84.0,16.0,16.0,17.0,24.0,1
2276,BA:8C:B9:54:50:24,3838273,489670116,4817,6180677,3833456,483489439,0,8855,1689773,8833,1686278,22,3495,2345,15,5244,39,0,56,216660.0,130000.0,-48.0,-35.0,-43.0,-45.0,-43.0,-36.0,-44.0,-48.0,-87.0,-87.0,-85.0,-84.0,39.0,52.0,42.0,39.0,1
2277,92:69:1D:31:68:E9,3837328,487096948,3868,3606974,3833460,483489974,0,4636,1082342,4498,1051147,138,31195,2082,10,4058,84,0,41,216660.0,130000.0,-52.0,-47.0,-43.0,-49.0,-52.0,-48.0,-44.0,-49.0,-87.0,-87.0,-85.0,-84.0,35.0,40.0,42.0,35.0,1
2278,CC:2F:71:3F:1F:24,4547899,1237822368,714439,754332394,3833460,483489974,37,568638,574722656,567932,574637680,706,84976,549284,15,714695,83015,34,480,144444.0,43333.0,-71.0,-66.0,-70.0,-71.0,-70.0,-66.0,-70.0,-70.0,-87.0,-87.0,-85.0,-84.0,16.0,21.0,15.0,13.0,1
2279,CC:2F:71:3E:C5:1F,3834315,483594488,855,104514,3833460,483489974,0,3569,299782,2945,225706,624,74076,905,8,1229,19,0,37,130000.0,39000.0,-71.0,-71.0,-68.0,-60.0,-70.0,-70.0,-67.0,-60.0,-87.0,-87.0,-85.0,-84.0,16.0,16.0,17.0,24.0,1
2280,BA:8C:B9:54:50:24,3838277,489670651,4817,6180677,3833460,483489974,0,8855,1689773,8833,1686278,22,3495,2345,15,5244,39,0,56,216660.0,130000.0,-48.0,-35.0,-43.0,-45.0,-43.0,-36.0,-44.0,-48.0,-87.0,-87.0,-85.0,-84.0,39.0,52.0,42.0,39.0,1
2281,92:69:1D:31:68:E9,3837332,487097352,3868,3606974,3833464,483490378,0,4636,1082342,4498,1051147,138,31195,2082,10,4058,84,0,41,216660.0,130000.0,-52.0,-47.0,-43.0,-49.0,-52.0,-48.0,-44.0,-49.0,-87.0,-87.0,-84.0,-84.0,35.0,40.0,41.0,35.0,1
2282,CC:2F:71:3F:1F:24,4548017,1237944665,714553,754454287,3833464,483490378,37,568737,574837136,568031,574752160,706,84976,549379,15,714809,83017,34,480,144444.0,43333.0,-71.0,-66.0,-70.0,-72.0,-71.0,-66.0,-70.0,-71.0,-87.0,-87.0,-84.0,-84.0,16.0,21.0,14.0,12.0,1
2283,CC:2F:71:3E:C5:1F,3834321,483595094,855,104514,3833466,483490580,0,3569,299782,2945,225706,624,74076,905,8,1229,19,0,37,130000.0,39000.0,-71.0,-71.0,-68.0,-60.0,-70.0,-70.0,-67.0,-60.0,-87.0,-87.0,-84.0,-84.0,16.0,16.0,16.0,24.0,1
2284,BA:8C:B9:54:50:24,3838283,489671257,4817,6180677,3833466,483490580,0,8855,1689773,8833,1686278,22,3495,2345,15,5244,39,0,56,216660.0,130000.0,-48.0,-35.0,-43.0,-45.0,-43.0,-36.0,-44.0,-48.0,-87.0,-87.0,-84.0,-84.0,39.0,52.0,41.0,39.0,1
2285,92:69:1D:31:68:E9,3837336,487097756,3868,3606974,3833468,483490782,0,4636,1082342,4498,1051147,138,31195,2082,10,4058,84,0,41,216660.0,130000.0,-52.0,-47.0,-43.0,-49.0,-52.0,-48.0,-44.0,-49.0,-87.0,-87.0,-84.0,-84.0,35.0,40.0,41.0,35.0,1
2286,CC:2F:71:3F:1F:24,4548126,1238063231,714658,754572449,3833468,483490782,37,568826,574945650,568120,574860674,706,84976,549467,15,714914,83044,34,480,144444.0,43333.0,-69.0,-67.0,-70.0,-70.0,-68.0,-67.0,-70.0,-70.0,-87.0,-87.0,-84.0,-84.0,18.0,20.0,14.0,14.0,1
2287,CC:2F:71:3E:C5:1F,3834323,483595296,855,104514,3833468,483490782,0,3569,299782,2945,225706,624,74076,905,8,1229,19,0,37,130000.0,39000.0,-71.0,-71.0,-68.0,-60.0,-70.0,-70.0,-67.0,-60.0,-87.0,-87.0,-84.0,-84.0,16.0,16.0,16.0,24.0,1
2288,BA:8C:B9:54:50:24,3838285,489671459,4817,6180677,3833468,483490782,0,8855,1689773,8833,1686278,22,3495,2345,15,5244,39,0,56,216660.0,130000.0,-48.0,-35.0,-43.0,-45.0,-43.0,-36.0,-44.0,-48.0,-87.0,-87.0,-84.0,-84.0,39.0,52.0,41.0,39.0,1
2289,92:69:1D:31:68:E9,3837345,487098820,3870,3607206,3833475,483491614,0,4642,1082830,4504,1051635,138,31195,2084,10,4060,84,0,41,216660.0,130000.0,-51.0,-47.0,-43.0,-48.0,-51.0,-48.0,-44.0,-48.0,-87.0,-87.0,-84.0,-84.0,36.0,40.0,41.0,36.0,1
2290,CC:2F:71:3F:1F:24,4548239,1238182299,714764,754690685,3833475,483491614,37,568917,575057272,568211,574972296,706,84976,549555,15,715020,83073,34,480,130000.0,43333.0,-70.0,-68.0,-70.0,-71.0,-69.0,-67.0,-70.0,-71.0,-87.0,-87.0,-84.0,-84.0,17.0,19.0,14.0,13.0,1
2291,CC:2F:71:3E:C5:1F,3834332,483596330,855,104514,3833477,483491816,0,3569,299782,2945,225706,624,74076,905,8,1229,19,0,37,130000.0,39000.0,-71.0,-71.0,-68.0,-60.0,-70.0,-70.0,-67.0,-60.0,-87.0,-87.0,-84.0,-84.0,16.0,16.0,16.0,24.0,1
2292,BA:8C:B9:54:50:24,3838294,489672493,4817,6180677,3833477,483491816,0,8855,1689773,8833,1686278,22,3495,2345,15,5244,39,0,56,216660.0,130000.0,-48.0,-35.0,-43.0,-45.0,-43.0,-36.0,-44.0,-48.0,-87.0,-87.0,-84.0,-84.0,39.0,52.0,41.0,39.0,1
2293,92:69:1D:31:68:E9,3837349,487099224,3870,3607206,3833479,483492018,0,4642,1082830,4504,1051635,138,31195,2084,10,4060,84,0,41,216660.0,130000.0,-51.0,-47.0,-43.0,-48.0,-51.0,-48.0,-44.0,-48.0,-87.0,-87.0,-84.0,-84.0,36.0,40.0,41.0,36.0,1
2294,CC:2F:71:3F:1F:24,4548349,1238302195,714870,754810177,3833479,483492018,37,569005,575165656,568299,575080680,706,84976,549643,15,715126,83092,34,480,130000.0,43333.0,-70.0,-66.0,-68.0,-71.0,-70.0,-66.0,-68.0,-70.0,-87.0,-87.0,-84.0,-84.0,17.0,21.0,16.0,13.0,1
2295,CC:2F:71:3E:C5:1F,3834334,483596532,855,104514,3833479,483492018,0,3569,299782,2945,225706,624,74076,905,8,1229,19,0,37,130000.0,39000.0,-71.0,-71.0,-68.0,-60.0,-70.0,-70.0,-67.0,-60.0,-87.0,-87.0,-84.0,-84.0,16.0,16.0,16.0,24.0,1
2296,BA:8C:B9:54:50:24,3838296,489672695,4817,6180677,3833479,483492018,0,8855,1689773,8833,1686278,22,3495,2345,15,5244,39,0,56,216660.0,130000.0,-48.0,-35.0,-43.0,-45.0,-43.0,-36.0,-44.0,-48.0,-87.0,-87.0,-84.0,-84.0,39.0,52.0,41.0,39.0,1
2297,92:69:1D:31:68:E9,3837354,487099688,3870,3607206,3833484,483492482,0,4642,1082830,4504,1051635,138,31195,2084,10,4060,84,0,41,216660.0,130000.0,-51.0,-47.0,-43.0,-48.0,-51.0,-48.0,-44.0,-48.0,-87.0,-87.0,-84.0,-84.0,36.0,40.0,41.0,36.0,1
2298,CC:2F:71:3F:1F:24,4548467,1238424422,714983,754931940,3833484,483492482,37,569106,575281961,568400,575196985,706,84976,549737,15,715239,83098,34,480,130000.0,43333.0,-71.0,-67.0,-69.0,-71.0,-71.0,-67.0,-69.0,-70.0,-87.0,-87.0,-84.0,-84.0,16.0,20.0,15.0,13.0,1
2299,CC:2F:71:3E:C5:1F,3834339,483596996,855,104514,3833484,483492482,0,3569,299782,2945,225706,624,74076,905,8,1229,19,0,37,130000.0,39000.0,-71.0,-71.0,-68.0,-60.0,-70.0,-70.0,-67.0,-60.0,-87.0,-87.0,-84.0,-84.0,16.0,16.0,16.0,24.0,1
2300,BA:8C:B9:54:50:24,3838303,489673361,4817,6180677,3833486,483492684,0,8855,1689773,8833,1686278,22,3495,2345,15,5244,39,0,56,216660.0,130000.0,-48.0,-35.0,-43.0,-45.0,-43.0,-36.0,-44.0,-48.0,-87.0,-87.0,-84.0,-84.0,39.0,52.0,41.0,39.0,1
2301,92:69:1D:31:68:E9,3837358,487100092,3870,3607206,3833488,483492886,0,4642,1082830,4504,1051635,138,31195,2084,10,4060,84,0,41,216660.0,130000.0,-51.0,-47.0,-43.0,-48.0,-51.0,-48.0,-44.0,-48.0,-87.0,-87.0,-84.0,-84.0,36.0,40.0,41.0,36.0,1
2302,CC:2F:71:3F:1F:24,4548577,1238544430,715089,755051544,3833488,483492886,37,569196,575392029,568490,575307053,706,84976,549825,15,715345,83102,34,480,130000.0,43333.0,-71.0,-67.0,-69.0,-71.0,-70.0,-67.0,-69.0,-71.0,-87.0,-87.0,-84.0,-84.0,16.0,20.0,15.0,13.0,1
2303,CC:2F:71:3E:C5:1F,3834343,483597400,855,104514,3833488,483492886,0,3569,299782,2945,225706,624,74076,905,8,1229,19,0,37,130000.0,39000.0,-71.0,-71.0,-68.0,-60.0,-70.0,-70.0,-67.0,-60.0,-87.0,-87.0,-84.0,-84.0,16.0,16.0,16.0,24.0,1
2304,BA:8C:B9:54:50:24,3838305,489673563,4817,6180677,3833488,483492886,0,8855,1689773,8833,1686278,22,3495,2345,15,5244,39,0,56,216660.0,130000.0,-48.0,-35.0,-43.0,-45.0,-43.0,-36.0,-44.0,-48.0,-87.0,-87.0,-84.0,-84.0,39.0,52.0,41.0,39.0,1
2305,92:69:1D:31:68:E9,3837362,487100496,3870,3607206,3833492,483493290,0,4642,1082830,4504,1051635,138,31195,2084,10,4060,84,0,41,216660.0,130000.0,-51.0,-47.0,-43.0,-48.0,-51.0,-48.0,-44.0,-48.0,-87.0,-87.0,-84.0,-84.0,36.0,40.0,41.0,36.0,1
2306,CC:2F:71:3F:1F:24,4548687,1238664326,715195,755171036,3833492,483493290,37,569287,575502227,568581,575417251,706,84976,549913,15,715450,83111,34,480,130000.0,43333.0,-72.0,-68.0,-69.0,-71.0,-71.0,-67.0,-69.0,-70.0,-87.0,-87.0,-84.0,-84.0,15.0,19.0,15.0,13.0,1
2307,CC:2F:71:3E:C5:1F,3834347,483597804,855,104514,3833492,483493290,0,3569,299782,2945,225706,624,74076,905,8,1229,19,0,37,130000.0,39000.0,-71.0,-71.0,-68.0,-60.0,-70.0,-70.0,-67.0,-60.0,-87.0,-87.0,-84.0,-84.0,16.0,16.0,16.0,24.0,1
2308,BA:8C:B9:54:50:24,3838311,489674169,4817,6180677,3833494,483493492,0,8855,1689773,8833,1686278,22,3495,2345,15,5244,39,0,56,216660.0,130000.0,-48.0,-35.0,-43.0,-45.0,-43.0,-36.0,-44.0,-48.0,-87.0,-87.0,-84.0,-84.0,39.0,52.0,41.0,39.0,1
2309,92:69:1D:31:68:E9,3837367,487100960,3870,3607206,3833497,483493754,0,4642,1082830,4504,1051635,138,31195,2084,10,4060,84,0,41,216660.0,130000.0,-51.0,-47.0,-43.0,-48.0,-51.0,-48.0,-44.0,-48.0,-87.0,-87.0,-84.0,-84.0,36.0,40.0,41.0,36.0,1
2310,CC:2F:71:3F:1F:24,4548797,1238782952,715300,755289198,3833497,483493754,37,569384,575615983,568678,575531007,706,84976,550006,15,715556,83113,34,480,130000.0,43333.0,-71.0,-67.0,-69.0,-71.0,-71.0,-67.0,-69.0,-70.0,-87.0,-87.0,-84.0,-84.0,16.0,20.0,15.0,13.0,1
2311,CC:2F:71:3E:C5:1F,3834352,483598268,855,104514,3833497,483493754,0,3569,299782,2945,225706,624,74076,905,8,1229,19,0,37,130000.0,39000.0,-71.0,-71.0,-68.0,-60.0,-70.0,-70.0,-67.0,-60.0,-87.0,-87.0,-84.0,-84.0,16.0,16.0,16.0,24.0,1
2312,BA:8C:B9:54:50:24,3838314,489674431,4817,6180677,3833497,483493754,0,8855,1689773,8833,1686278,22,3495,2345,15,5244,39,0,56,216660.0,130000.0,-48.0,-35.0,-43.0,-45.0,-43.0,-36.0,-44.0,-48.0,-87.0,-87.0,-84.0,-84.0,39.0,52.0,41.0,39.0,1
2313,92:69:1D:31:68:E9,3837371,487101364,3870,3607206,3833501,483494158,0,4642,1082830,4504,1051635,138,31195,2084,10,4060,84,0,41,216660.0,130000.0,-51.0,-47.0,-43.0,-48.0,-51.0,-48.0,-44.0,-48.0,-87.0,-87.0,-84.0,-84.0,36.0,40.0,41.0,36.0,1
2314,CC:2F:71:3F:1F:24,4549317,1239421768,715816,755927610,3833501,483494158,37,569663,575757479,568957,575672503,706,84976,550277,15,716072,83163,34,480,130000.0,43333.0,-71.0,-67.0,-69.0,-71.0,-71.0,-67.0,-69.0,-70.0,-87.0,-87.0,-84.0,-84.0,16.0,20.0,15.0,13.0,1
2315,CC:2F:71:3E:C5:1F,3834356,483598672,855,104514,3833501,483494158,0,3569,299782,2945,225706,624,74076,905,8,1229,19,0,37,130000.0,39000.0,-71.0,-71.0,-68.0,-60.0,-70.0,-70.0,-67.0,-60.0,-87.0,-87.0,-84.0,-84.0,16.0,16.0,16.0,24.0,1
2316,BA:8C:B9:54:50:24,3838320,489675037,4817,6180677,3833503,483494360,0,8855,1689773,8833,1686278,22,3495,2345,15,5244,39,0,56,216660.0,130000.0,-48.0,-35.0,-43.0,-45.0,-43.0,-36.0,-44.0,-48.0,-87.0,-87.0,-84.0,-84.0,39.0,52.0,41.0,39.0,1
2317,92:69:1D:31:68:E9,3837375,487101768,3870,3607206,3833505,483494562,0,4642,1082830,4504,1051635,138,31195,2084,10,4060,84,0,41,216660.0,130000.0,-51.0,-47.0,-43.0,-48.0,-51.0,-48.0,-44.0,-48.0,-87.0,-87.0,-84.0,-84.0,36.0,40.0,41.0,36.0,1
2318,CC:2F:71:3F:1F:24,4549465,1239578593,715960,756084031,3833505,483494562,37,569780,575875581,569074,575790605,706,84976,550389,15,716216,83181,34,480,144444.0,39000.0,-72.0,-68.0,-69.0,-71.0,-71.0,-68.0,-69.0,-71.0,-87.0,-87.0,-84.0,-84.0,15.0,19.0,15.0,13.0,1
2319,CC:2F:71:3E:C5:1F,3834360,483599076,855,104514,3833505,483494562,0,3569,299782,2945,225706,624,74076,905,8,1229,19,0,37,130000.0,39000.0,-71.0,-71.0,-68.0,-60.0,-70.0,-70.0,-67.0,-60.0,-87.0,-87.0,-84.0,-84.0,16.0,16.0,16.0,24.0,1
2320,BA:8C:B9:54:50:24,3838323,489675299,4817,6180677,3833506,483494622,0,8855,1689773,8833,1686278,22,3495,2345,15,5244,39,0,56,216660.0,130000.0,-48.0,-35.0,-43.0,-45.0,-43.0,-36.0,-44.0,-48.0,-87.0,-87.0,-84.0,-84.0,39.0,52.0,41.0,39.0,1
2321,92:69:1D:31:68:E9,3837380,487102232,3870,3607206,3833510,483495026,0,4642,1082830,4504,1051635,138,31195,2084,10,4060,84,0,41,216660.0,130000.0,-51.0,-47.0,-43.0,-48.0,-51.0,-48.0,-44.0,-48.0,-87.0,-87.0,-84.0,-84.0,36.0,40.0,41.0,36.0,1
2322,CC:2F:71:3F:1F:24,4549582,1239703547,716072,756208521,3833510,483495026,37,569878,575992335,569172,575907359,706,84976,550482,15,716328,83197,34,480,130000.0,43333.0,-71.0,-68.0,-69.0,-72.0,-71.0,-67.0,-69.0,-71.0,-87.0,-87.0,-84.0,-84.0,16.0,19.0,15.0,12.0,1
2323,CC:2F:71:3E:C5:1F,3834368,483599858,856,104630,3833512,483495228,0,3570,299852,2946,225776,624,74076,905,8,1230,19,0,37,130000.0,39000.0,-70.0,-71.0,-68.0,-60.0,-70.0,-70.0,-67.0,-60.0,-87.0,-87.0,-84.0,-84.0,17.0,16.0,16.0,24.0,1
2324,BA:8C:B9:54:50:24,3838329,489675905,4817,6180677,3833512,483495228,0,8855,1689773,8833,1686278,22,3495,2345,15,5244,39,0,56,216660.0,130000.0,-48.0,-35.0,-43.0,-45.0,-43.0,-36.0,-44.0,-48.0,-87.0,-87.0,-84.0,-84.0,39.0,52.0,41.0,39.0,1
2325,92:69:1D:31:68:E9,3837385,487102752,3871,3607322,3833514,483495430,0,4644,1082966,4506,1051771,138,31195,2084,10,4061,84,0,41,216660.0,130000.0,-52.0,-47.0,-43.0,-48.0,-51.0,-47.0,-43.0,-48.0,-87.0,-87.0,-84.0,-84.0,35.0,40.0,41.0,36.0,1
2326,CC:2F:71:3F:1F:24,4549691,1239821889,716177,756326459,3833514,483495430,37,569971,576102815,569265,576017839,706,84976,550569,15,716433,83206,34,480,130000.0,39000.0,-71.0,-67.0,-69.0,-71.0,-71.0,-67.0,-69.0,-71.0,-87.0,-87.0,-84.0,-84.0,16.0,20.0,15.0,13.0,1
2327,CC:2F:71:3E:C5:1F,3834370,483600060,856,104630,3833514,483495430,0,3571,299922,2947,225846,624,74076,905,8,1230,19,0,37,130000.0,39000.0,-70.0,-71.0,-68.0,-60.0,-70.0,-70.0,-67.0,-60.0,-87.0,-87.0,-84.0,-84.0,17.0,16.0,16.0,24.0,1
2328,BA:8C:B9:54:50:24,3838332,489676223,4818,6180793,3833514,483495430,0,8861,1690181,8839,1686686,22,3495,2345,15,5245,39,0,56,216660.0,130000.0,-48.0,-35.0,-43.0,-45.0,-42.0,-35.0,-43.0,-47.0,-87.0,-87.0,-84.0,-84.0,39.0,52.0,41.0,39.0,1
2329,92:69:1D:31:68:E9,3837391,487103489,3871,3607322,3833520,483496167,0,4644,1082966,4506,1051771,138,31195,2084,10,4061,84,0,41,216660.0,130000.0,-52.0,-47.0,-43.0,-48.0,-51.0,-47.0,-43.0,-48.0,-87.0,-86.0,-84.0,-83.0,35.0,39.0,41.0,35.0,1
2330,CC:2F:71:3F:1F:24,4549803,1239941950,716283,756445783,3833520,483496167,37,570065,576219141,569359,576134165,706,84976,550658,15,716539,83219,34,480,130000.0,43333.0,-71.0,-68.0,-69.0,-71.0,-71.0,-67.0,-69.0,-71.0,-87.0,-86.0,-84.0,-83.0,16.0,18.0,15.0,12.0,1
2331,CC:2F:71:3E:C5:1F,3834376,483600797,856,104630,3833520,483496167,0,3571,299922,2947,225846,624,74076,905,8,1230,19,0,37,130000.0,39000.0,-70.0,-71.0,-68.0,-60.0,-70.0,-70.0,-67.0,-60.0,-87.0,-86.0,-84.0,-83.0,17.0,15.0,16.0,23.0,1
2332,BA:8C:B9:54:50:24,3838340,489677162,4818,6180793,3833522,483496369,0,8862,1690249,8840,1686754,22,3495,2345,15,5245,39,0,56,216660.0,130000.0,-40.0,-37.0,-46.0,-51.0,-42.0,-35.0,-43.0,-47.0,-87.0,-86.0,-84.0,-83.0,47.0,49.0,38.0,32.0,1
2333,92:69:1D:31:68:E9,3837395,487103893,3871,3607322,3833524,483496571,0,4644,1082966,4506,1051771,138,31195,2084,10,4061,84,0,41,216660.0,130000.0,-52.0,-47.0,-43.0,-48.0,-51.0,-47.0,-43.0,-48.0,-87.0,-86.0,-84.0,-83.0,35.0,39.0,41.0,35.0,1
2334,CC:2F:71:3F:1F:24,4549921,1240067095,716397,756570524,3833524,483496571,37,570167,576335534,569461,576250558,706,84976,550755,15,716652,83219,34,480,130000.0,43333.0,-71.0,-67.0,-69.0,-71.0,-71.0,-67.0,-69.0,-71.0,-87.0,-86.0,-84.0,-83.0,16.0,19.0,15.0,12.0,1
2335,CC:2F:71:3E:C5:1F,3834380,483601201,856,104630,3833524,483496571,0,3571,299922,2947,225846,624,74076,905,8,1230,19,0,37,130000.0,39000.0,-70.0,-71.0,-68.0,-60.0,-70.0,-70.0,-67.0,-60.0,-87.0,-86.0,-84.0,-83.0,17.0,15.0,16.0,23.0,1
2336,BA:8C:B9:54:50:24,3838342,489677364,4818,6180793,3833524,483496571,0,8862,1690249,8840,1686754,22,3495,2345,15,5245,39,0,56,216660.0,130000.0,-40.0,-37.0,-46.0,-51.0,-42.0,-35.0,-43.0,-47.0,-87.0,-86.0,-84.0,-83.0,47.0,49.0,38.0,32.0,1
2337,92:69:1D:31:68:E9,3837399,487104297,3871,3607322,3833528,483496975,0,4644,1082966,4506,1051771,138,31195,2084,10,4061,84,0,41,216660.0,130000.0,-52.0,-47.0,-43.0,-48.0,-51.0,-47.0,-43.0,-48.0,-87.0,-86.0,-84.0,-83.0,35.0,39.0,41.0,35.0,1
2338,CC:2F:71:3F:1F:24,4550031,1240185567,716503,756688592,3833528,483496975,37,570264,576450934,569558,576365958,706,84976,550846,15,716759,83229,34,480,130000.0,43333.0,-72.0,-68.0,-69.0,-72.0,-71.0,-67.0,-69.0,-71.0,-87.0,-86.0,-84.0,-83.0,15.0,18.0,15.0,11.0,1
2339,CC:2F:71:3E:C5:1F,3834384,483601605,856,104630,3833528,483496975,0,3571,299922,2947,225846,624,74076,905,8,1230,19,0,37,130000.0,39000.0,-70.0,-71.0,-68.0,-60.0,-70.0,-70.0,-67.0,-60.0,-87.0,-86.0,-84.0,-83.0,17.0,15.0,16.0,23.0,1
2340,BA:8C:B9:54:50:24,3838348,489677970,4818,6180793,3833530,483497177,0,8862,1690249,8840,1686754,22,3495,2345,15,5245,39,0,56,216660.0,130000.0,-40.0,-37.0,-46.0,-51.0,-42.0,-35.0,-43.0,-47.0,-87.0,-86.0,-84.0,-83.0,47.0,49.0,38.0,32.0,1
2341,92:69:1D:31:68:E9,3837404,487104761,3871,3607322,3833533,483497439,0,4644,1082966,4506,1051771,138,31195,2084,10,4061,84,0,41,216660.0,130000.0,-52.0,-47.0,-43.0,-48.0,-51.0,-47.0,-43.0,-48.0,-87.0,-86.0,-84.0,-83.0,35.0,39.0,41.0,35.0,1
2342,CC:2F:71:3F:1F:24,4550142,1240305523,716609,756808084,3833533,483497439,37,570357,576560054,569651,576475078,706,84976,550937,15,716865,83236,34,480,130000.0,43333.0,-72.0,-67.0,-69.0,-72.0,-71.0,-66.0,-69.0,-72.0,-87.0,-86.0,-84.0,-83.0,15.0,19.0,15.0,11.0,1
2343,CC:2F:71:3E:C5:1F,3834389,483602069,856,104630,3833533,483497439,0,3571,299922,2947,225846,624,74076,905,8,1230,19,0,37,130000.0,39000.0,-70.0,-71.0,-68.0,-60.0,-70.0,-70.0,-67.0,-60.0,-87.0,-86.0,-84.0,-83.0,17.0,15.0,16.0,23.0,1
2344,BA:8C:B9:54:50:24,3838351,489678232,4818,6180793,3833533,483497439,0,8866,1690521,8844,1687026,22,3495,2345,15,5245,39,0,56,216660.0,130000.0,-40.0,-37.0,-46.0,-52.0,-41.0,-36.0,-44.0,-49.0,-87.0,-86.0,-84.0,-83.0,47.0,49.0,38.0,31.0,1
2345,92:69:1D:31:68:E9,3837406,487104963,3871,3607322,3833535,483497641,0,4644,1082966,4506,1051771,138,31195,2084,10,4061,84,0,41,216660.0,130000.0,-52.0,-47.0,-43.0,-48.0,-51.0,-47.0,-43.0,-48.0,-87.0,-86.0,-84.0,-83.0,35.0,39.0,41.0,35.0,1
2346,CC:2F:71:3F:1F:24,4550250,1240422423,716713,756924580,3833537,483497843,37,570450,576674860,569744,576589884,706,84976,551023,15,716969,83237,34,480,144444.0,39000.0,-72.0,-67.0,-69.0,-72.0,-72.0,-67.0,-69.0,-72.0,-87.0,-86.0,-84.0,-83.0,15.0,19.0,15.0,11.0,1
2347,CC:2F:71:3E:C5:1F,3834393,483602473,856,104630,3833537,483497843,0,3571,299922,2947,225846,624,74076,905,8,1230,19,0,37,130000.0,39000.0,-70.0,-71.0,-68.0,-60.0,-70.0,-70.0,-67.0,-60.0,-87.0,-86.0,-84.0,-83.0,17.0,15.0,16.0,23.0,1
2348,BA:8C:B9:54:50:24,3838358,489678900,4818,6180793,3833540,483498107,0,8866,1690521,8844,1687026,22,3495,2345,15,5245,39,0,56,216660.0,130000.0,-40.0,-37.0,-46.0,-52.0,-41.0,-36.0,-44.0,-49.0,-87.0,-86.0,-84.0,-83.0,47.0,49.0,38.0,31.0,1
2349,92:69:1D:31:68:E9,3837414,487105693,3871,3607322,3833543,483498371,0,4644,1082966,4506,1051771,138,31195,2084,10,4061,84,0,41,216660.0,130000.0,-52.0,-47.0,-43.0,-48.0,-51.0,-47.0,-43.0,-48.0,-87.0,-86.0,-84.0,-83.0,35.0,39.0,41.0,35.0,1
2350,CC:2F:71:3F:1F:24,4550382,1240549813,716839,757051442,3833543,483498371,37,570566,576789923,569859,576704829,707,85094,551130,15,717094,83250,34,480,130000.0,43333.0,-72.0,-66.0,-69.0,-73.0,-72.0,-66.0,-69.0,-73.0,-87.0,-86.0,-84.0,-83.0,15.0,20.0,15.0,10.0,1
2351,CC:2F:71:3E:C5:1F,3834399,483603001,856,104630,3833543,483498371,0,3573,300110,2948,225916,625,74194,906,8,1230,19,0,37,130000.0,39000.0,-71.0,-71.0,-67.0,-60.0,-70.0,-71.0,-67.0,-60.0,-87.0,-86.0,-84.0,-83.0,16.0,15.0,17.0,23.0,1
2352,BA:8C:B9:54:50:24,3838361,489679164,4818,6180793,3833543,483498371,0,8866,1690521,8844,1687026,22,3495,2345,15,5245,39,0,56,216660.0,130000.0,-40.0,-37.0,-46.0,-52.0,-41.0,-36.0,-44.0,-49.0,-87.0,-86.0,-84.0,-83.0,47.0,49.0,38.0,31.0,1
2353,92:69:1D:31:68:E9,3837417,487105955,3871,3607322,3833546,483498633,0,4644,1082966,4506,1051771,138,31195,2084,10,4061,84,0,41,216660.0,130000.0,-52.0,-47.0,-43.0,-48.0,-51.0,-47.0,-43.0,-48.0,-87.0,-86.0,-84.0,-83.0,35.0,39.0,41.0,35.0,1
2354,CC:2F:71:3F:1F:24,4550493,1240668569,716945,757169734,3833548,483498835,37,570656,576899977,569949,576814883,707,85094,551219,15,717201,83250,34,480,130000.0,43333.0,-71.0,-67.0,-69.0,-72.0,-71.0,-67.0,-68.0,-71.0,-87.0,-86.0,-84.0,-83.0,16.0,19.0,15.0,11.0,1
2355,CC:2F:71:3E:C5:1F,3834404,483603465,856,104630,3833548,483498835,0,3573,300110,2948,225916,625,74194,906,8,1230,19,0,37,130000.0,39000.0,-71.0,-71.0,-67.0,-60.0,-70.0,-71.0,-67.0,-60.0,-87.0,-86.0,-84.0,-83.0,16.0,15.0,17.0,23.0,1
2356,BA:8C:B9:54:50:24,3838366,489679628,4818,6180793,3833548,483498835,0,8866,1690521,8844,1687026,22,3495,2345,15,5245,39,0,56,216660.0,130000.0,-40.0,-37.0,-46.0,-52.0,-41.0,-36.0,-44.0,-49.0,-87.0,-86.0,-84.0,-83.0,47.0,49.0,38.0,31.0,1
2357,92:69:1D:31:68:E9,3837423,487106561,3871,3607322,3833552,483499239,0,4646,1083102,4508,1051907,138,31195,2084,10,4062,84,0,41,216660.0,130000.0,-51.0,-47.0,-42.0,-48.0,-51.0,-47.0,-43.0,-48.0,-87.0,-86.0,-84.0,-83.0,36.0,39.0,42.0,35.0,1
2358,CC:2F:71:3F:1F:24,4550603,1240788465,717051,757289226,3833552,483499239,37,570750,577017685,570043,576932591,707,85094,551307,15,717307,83256,34,480,130000.0,43333.0,-71.0,-67.0,-69.0,-72.0,-71.0,-67.0,-68.0,-71.0,-87.0,-86.0,-84.0,-83.0,16.0,19.0,15.0,11.0,1
2359,CC:2F:71:3E:C5:1F,3834408,483603869,856,104630,3833552,483499239,0,3573,300110,2948,225916,625,74194,906,8,1230,19,0,37,130000.0,39000.0,-71.0,-71.0,-67.0,-60.0,-70.0,-71.0,-67.0,-60.0,-87.0,-86.0,-84.0,-83.0,16.0,15.0,17.0,23.0,1
2360,BA:8C:B9:54:50:24,3838370,489680032,4818,6180793,3833552,483499239,0,8866,1690521,8844,1687026,22,3495,2345,15,5245,39,0,56,216660.0,130000.0,-40.0,-37.0,-46.0,-52.0,-41.0,-36.0,-44.0,-49.0,-87.0,-86.0,-84.0,-83.0,47.0,49.0,38.0,31.0,1
2361,92:69:1D:31:68:E9,3837426,487106823,3871,3607322,3833555,483499501,0,4646,1083102,4508,1051907,138,31195,2084,10,4062,84,0,41,216660.0,130000.0,-51.0,-47.0,-42.0,-48.0,-51.0,-47.0,-43.0,-48.0,-87.0,-86.0,-84.0,-83.0,36.0,39.0,42.0,35.0,1
2362,CC:2F:71:3F:1F:24,4550712,1240905537,717155,757405834,3833557,483499703,37,570839,577124789,570132,577039695,707,85094,551394,15,717411,83256,34,480,130000.0,43333.0,-71.0,-67.0,-69.0,-72.0,-71.0,-67.0,-69.0,-72.0,-87.0,-86.0,-84.0,-83.0,16.0,19.0,15.0,11.0,1
2363,CC:2F:71:3E:C5:1F,3834413,483604333,856,104630,3833557,483499703,0,3573,300110,2948,225916,625,74194,906,8,1230,19,0,37,130000.0,39000.0,-71.0,-71.0,-67.0,-60.0,-70.0,-71.0,-67.0,-60.0,-87.0,-86.0,-84.0,-83.0,16.0,15.0,17.0,23.0,1
2364,BA:8C:B9:54:50:24,3838377,489680698,4818,6180793,3833559,483499905,0,8866,1690521,8844,1687026,22,3495,2345,15,5245,39,0,56,216660.0,130000.0,-40.0,-37.0,-46.0,-52.0,-41.0,-36.0,-44.0,-49.0,-87.0,-86.0,-84.0,-83.0,47.0,49.0,38.0,31.0,1
2365,92:69:1D:31:68:E9,3837432,487107429,3871,3607322,3833561,483500107,0,4646,1083102,4508,1051907,138,31195,2084,10,4062,84,0,41,216660.0,130000.0,-51.0,-47.0,-42.0,-48.0,-51.0,-47.0,-43.0,-48.0,-87.0,-86.0,-84.0,-83.0,36.0,39.0,42.0,35.0,1
2366,CC:2F:71:3F:1F:24,4550836,1241034052,717275,757533945,3833561,483500107,37,570947,577244812,570240,577159718,707,85094,551497,15,717531,83277,34,480,130000.0,43333.0,-71.0,-67.0,-69.0,-72.0,-71.0,-67.0,-69.0,-71.0,-87.0,-86.0,-84.0,-83.0,16.0,19.0,15.0,11.0,1
2367,CC:2F:71:3E:C5:1F,3834417,483604737,856,104630,3833561,483500107,0,3573,300110,2948,225916,625,74194,906,8,1230,19,0,37,130000.0,39000.0,-71.0,-71.0,-67.0,-60.0,-70.0,-71.0,-67.0,-60.0,-87.0,-86.0,-84.0,-83.0,16.0,15.0,17.0,23.0,1
2368,BA:8C:B9:54:50:24,3838379,489680900,4818,6180793,3833561,483500107,0,8870,1690793,8848,1687298,22,3495,2345,15,5245,39,0,56,216660.0,130000.0,-49.0,-35.0,-42.0,-45.0,-43.0,-36.0,-44.0,-48.0,-87.0,-86.0,-84.0,-83.0,38.0,51.0,42.0,38.0,1
2369,92:69:1D:31:68:E9,3837434,487107631,3871,3607322,3833563,483500309,0,4646,1083102,4508,1051907,138,31195,2084,10,4062,84,0,41,216660.0,130000.0,-51.0,-47.0,-42.0,-48.0,-51.0,-47.0,-43.0,-48.0,-87.0,-86.0,-84.0,-83.0,36.0,39.0,42.0,35.0,1
2370,CC:2F:71:3F:1F:24,4550944,1241152550,717380,757652107,3833564,483500443,37,571039,577356722,570332,577271628,707,85094,551584,15,717636,83281,34,480,130000.0,43333.0,-71.0,-67.0,-69.0,-72.0,-71.0,-67.0,-69.0,-71.0,-87.0,-86.0,-84.0,-83.0,16.0,19.0,15.0,11.0,1
2371,CC:2F:71:3E:C5:1F,3834421,483605141,856,104630,3833565,483500511,0,3573,300110,2948,225916,625,74194,906,8,1230,19,0,37,130000.0,39000.0,-71.0,-71.0,-67.0,-60.0,-70.0,-71.0,-67.0,-60.0,-87.0,-86.0,-84.0,-83.0,16.0,15.0,17.0,23.0,1
2372,BA:8C:B9:54:50:24,3838383,489681304,4818,6180793,3833565,483500511,0,8870,1690793,8848,1687298,22,3495,2345,15,5245,39,0,56,216660.0,130000.0,-49.0,-35.0,-42.0,-45.0,-43.0,-36.0,-44.0,-48.0,-87.0,-86.0,-84.0,-83.0,38.0,51.0,42.0,38.0,1
2373,92:69:1D:31:68:E9,3837441,487108297,3871,3607322,3833570,483500975,0,4646,1083102,4508,1051907,138,31195,2084,10,4062,84,0,41,216660.0,130000.0,-51.0,-47.0,-42.0,-48.0,-51.0,-47.0,-43.0,-48.0,-87.0,-86.0,-83.0,-83.0,36.0,39.0,41.0,35.0,1
2374,CC:2F:71:3F:1F:24,4551055,1241271020,717485,757770045,3833570,483500975,37,571133,577469052,570426,577383958,707,85094,551671,15,717741,83285,34,480,130000.0,43333.0,-71.0,-67.0,-69.0,-72.0,-71.0,-67.0,-69.0,-71.0,-87.0,-86.0,-83.0,-83.0,16.0,19.0,14.0,11.0,1
2375,CC:2F:71:3E:C5:1F,3834426,483605605,856,104630,3833570,483500975,0,3573,300110,2948,225916,625,74194,906,8,1230,19,0,37,130000.0,39000.0,-71.0,-71.0,-67.0,-60.0,-70.0,-71.0,-67.0,-60.0,-87.0,-86.0,-83.0,-83.0,16.0,15.0,16.0,23.0,1
2376,BA:8C:B9:54:50:24,3838388,489681768,4818,6180793,3833570,483500975,0,8870,1690793,8848,1687298,22,3495,2345,15,5245,39,0,56,216660.0,130000.0,-49.0,-35.0,-42.0,-45.0,-43.0,-36.0,-44.0,-48.0,-87.0,-86.0,-83.0,-83.0,38.0,51.0,41.0,38.0,1
2377,92:69:1D:31:68:E9,3837441,487108297,3871,3607322,3833570,483500975,0,4646,1083102,4508,1051907,138,31195,2084,10,4062,84,0,41,216660.0,130000.0,-51.0,-47.0,-42.0,-48.0,-51.0,-47.0,-43.0,-48.0,-87.0,-86.0,-83.0,-83.0,36.0,39.0,41.0,35.0,1
2378,CC:2F:71:3F:1F:24,4551165,1241391237,717593,757890060,3833572,483501177,37,571227,577583923,570520,577498829,707,85094,551761,15,717849,83285,34,480,130000.0,43333.0,-71.0,-67.0,-69.0,-72.0,-71.0,-67.0,-68.0,-71.0,-87.0,-86.0,-83.0,-83.0,16.0,19.0,14.0,11.0,1
2379,CC:2F:71:3E:C5:1F,3834428,483605807,856,104630,3833572,483501177,0,3573,300110,2948,225916,625,74194,906,8,1230,19,0,37,130000.0,39000.0,-71.0,-71.0,-67.0,-60.0,-70.0,-71.0,-67.0,-60.0,-87.0,-86.0,-83.0,-83.0,16.0,15.0,16.0,23.0,1
2380,BA:8C:B9:54:50:24,3838390,489681970,4818,6180793,3833572,483501177,0,8870,1690793,8848,1687298,22,3495,2345,15,5245,39,0,56,216660.0,130000.0,-49.0,-35.0,-42.0,-45.0,-43.0,-36.0,-44.0,-48.0,-87.0,-86.0,-83.0,-83.0,38.0,51.0,41.0,38.0,1
2381,92:69:1D:31:68:E9,3837447,487108903,3871,3607322,3833576,483501581,0,4646,1083102,4508,1051907,138,31195,2084,10,4062,84,0,41,216660.0,130000.0,-51.0,-47.0,-42.0,-48.0,-51.0,-47.0,-43.0,-48.0,-87.0,-86.0,-83.0,-83.0,36.0,39.0,41.0,35.0,1
2382,CC:2F:71:3F:1F:24,4551283,1241512052,717705,758010269,3833578,483501783,37,571324,577691294,570617,577606200,707,85094,551855,15,717961,83287,34,480,130000.0,43333.0,-70.0,-67.0,-68.0,-72.0,-70.0,-66.0,-68.0,-70.0,-87.0,-86.0,-83.0,-83.0,17.0,19.0,15.0,11.0,1
2383,CC:2F:71:3E:C5:1F,3834434,483606413,856,104630,3833578,483501783,0,3573,300110,2948,225916,625,74194,906,8,1230,19,0,37,130000.0,39000.0,-71.0,-71.0,-67.0,-60.0,-70.0,-71.0,-67.0,-60.0,-87.0,-86.0,-83.0,-83.0,16.0,15.0,16.0,23.0,1
2384,BA:8C:B9:54:50:24,3838396,489682576,4818,6180793,3833578,483501783,0,8870,1690793,8848,1687298,22,3495,2345,15,5245,39,0,56,216660.0,130000.0,-49.0,-35.0,-42.0,-45.0,-43.0,-36.0,-44.0,-48.0,-87.0,-86.0,-83.0,-83.0,38.0,51.0,41.0,38.0,1
2385,92:69:1D:31:68:E9,3837451,487109438,3871,3607322,3833580,483502116,0,4646,1083102,4508,1051907,138,31195,2084,10,4062,84,0,41,216660.0,130000.0,-51.0,-47.0,-42.0,-48.0,-51.0,-47.0,-43.0,-48.0,-87.0,-86.0,-83.0,-83.0,36.0,39.0,41.0,35.0,1
2386,CC:2F:71:3F:1F:24,4551390,1241630323,717810,758128207,3833580,483502116,37,571415,577804354,570708,577719260,707,85094,551942,15,718066,83291,34,480,130000.0,43333.0,-71.0,-67.0,-69.0,-72.0,-71.0,-67.0,-69.0,-71.0,-87.0,-86.0,-83.0,-83.0,16.0,19.0,14.0,11.0,1
2387,CC:2F:71:3E:C5:1F,3834436,483606746,856,104630,3833580,483502116,0,3573,300110,2948,225916,625,74194,906,8,1230,19,0,37,130000.0,39000.0,-71.0,-71.0,-67.0,-60.0,-70.0,-71.0,-67.0,-60.0,-87.0,-86.0,-83.0,-83.0,16.0,15.0,16.0,23.0,1
2388,BA:8C:B9:54:50:24,3838400,489683111,4818,6180793,3833582,483502318,0,8870,1690793,8848,1687298,22,3495,2345,15,5245,39,0,56,216660.0,130000.0,-49.0,-35.0,-42.0,-45.0,-43.0,-36.0,-44.0,-48.0,-87.0,-86.0,-83.0,-83.0,38.0,51.0,41.0,38.0,1
2389,92:69:1D:31:68:E9,3837457,487110044,3871,3607322,3833586,483502722,0,4646,1083102,4508,1051907,138,31195,2084,10,4062,84,0,41,216660.0,130000.0,-51.0,-47.0,-42.0,-48.0,-51.0,-47.0,-43.0,-48.0,-87.0,-86.0,-83.0,-83.0,36.0,39.0,41.0,35.0,1
2390,CC:2F:71:3F:1F:24,4551504,1241750847,717916,758247923,3833588,483502924,37,571508,577919070,570801,577833976,707,85094,552031,15,718172,83292,34,480,130000.0,43333.0,-71.0,-67.0,-69.0,-72.0,-71.0,-67.0,-69.0,-71.0,-87.0,-86.0,-83.0,-83.0,16.0,19.0,14.0,11.0,1
2391,CC:2F:71:3E:C5:1F,3834444,483607554,856,104630,3833588,483502924,0,3573,300110,2948,225916,625,74194,906,8,1230,19,0,37,130000.0,39000.0,-71.0,-71.0,-67.0,-60.0,-70.0,-71.0,-67.0,-60.0,-87.0,-86.0,-83.0,-83.0,16.0,15.0,16.0,23.0,1
2392,BA:8C:B9:54:50:24,3838406,489683717,4818,6180793,3833588,483502924,0,8870,1690793,8848,1687298,22,3495,2345,15,5245,39,0,56,216660.0,130000.0,-49.0,-35.0,-42.0,-45.0,-43.0,-36.0,-44.0,-48.0,-87.0,-86.0,-83.0,-83.0,38.0,51.0,41.0,38.0,1
2393,92:69:1D:31:68:E9,3837461,487110432,3871,3607322,3833590,483503110,0,4646,1083102,4508,1051907,138,31195,2084,10,4062,84,0,41,216660.0,130000.0,-51.0,-47.0,-42.0,-48.0,-51.0,-47.0,-43.0,-48.0,-87.0,-86.0,-83.0,-83.0,36.0,39.0,41.0,35.0,1
2394,CC:2F:71:3F:1F:24,4551614,1241873633,718024,758370523,3833590,483503110,37,571602,578036750,570895,577951656,707,85094,552121,15,718280,83300,34,480,130000.0,43333.0,-71.0,-67.0,-69.0,-69.0,-71.0,-67.0,-68.0,-71.0,-87.0,-86.0,-83.0,-83.0,16.0,19.0,14.0,14.0,1
2395,CC:2F:71:3E:C5:1F,3834446,483607740,856,104630,3833590,483503110,0,3573,300110,2948,225916,625,74194,906,8,1230,19,0,37,130000.0,39000.0,-71.0,-71.0,-67.0,-60.0,-70.0,-71.0,-67.0,-60.0,-87.0,-86.0,-83.0,-83.0,16.0,15.0,16.0,23.0,1
2396,BA:8C:B9:54:50:24,3838410,489684105,4818,6180793,3833592,483503312,0,8870,1690793,8848,1687298,22,3495,2345,15,5245,39,0,56,216660.0,130000.0,-49.0,-35.0,-42.0,-45.0,-43.0,-36.0,-44.0,-48.0,-87.0,-86.0,-83.0,-83.0,38.0,51.0,41.0,38.0,1
2397,92:69:1D:31:68:E9,3837467,487111038,3871,3607322,3833596,483503716,0,4646,1083102,4508,1051907,138,31195,2084,10,4062,84,0,41,216660.0,130000.0,-51.0,-47.0,-42.0,-48.0,-51.0,-47.0,-43.0,-48.0,-87.0,-86.0,-83.0,-83.0,36.0,39.0,41.0,35.0,1
2398,CC:2F:71:3F:1F:24,4551735,1241997628,718137,758493710,3833598,483503918,37,571702,578151345,570995,578066251,707,85094,552217,15,718393,83301,34,480,130000.0,43333.0,-71.0,-67.0,-69.0,-72.0,-71.0,-67.0,-69.0,-72.0,-87.0,-86.0,-83.0,-83.0,16.0,19.0,14.0,11.0,1
2399,CC:2F:71:3E:C5:1F,3834454,483608548,856,104630,3833598,483503918,0,3573,300110,2948,225916,625,74194,906,8,1230,19,0,37,130000.0,39000.0,-71.0,-71.0,-67.0,-60.0,-70.0,-71.0,-67.0,-60.0,-87.0,-86.0,-83.0,-83.0,16.0,15.0,16.0,23.0,1
2400,BA:8C:B9:54:50:24,3838416,489684711,4818,6180793,3833598,483503918,0,8870,1690793,8848,1687298,22,3495,2345,15,5245,39,0,56,216660.0,130000.0,-49.0,-35.0,-42.0,-45.0,-43.0,-36.0,-44.0,-48.0,-87.0,-86.0,-83.0,-83.0,38.0,51.0,41.0,38.0,1
2401,92:69:1D:31:68:E9,3837469,487111240,3871,3607322,3833598,483503918,0,4646,1083102,4508,1051907,138,31195,2084,10,4062,84,0,41,216660.0,130000.0,-51.0,-47.0,-42.0,-48.0,-51.0,-47.0,-43.0,-48.0,-87.0,-86.0,-83.0,-83.0,36.0,39.0,41.0,35.0,1
2402,CC:2F:71:3F:1F:24,4551841,1242117120,718243,758613202,3833598,483503918,37,571795,578267527,571088,578182433,707,85094,552305,15,718499,83309,34,480,130000.0,43333.0,-71.0,-67.0,-69.0,-72.0,-71.0,-67.0,-69.0,-71.0,-87.0,-86.0,-83.0,-83.0,16.0,19.0,14.0,11.0,1
2403,CC:2F:71:3E:C5:1F,3834454,483608548,856,104630,3833598,483503918,0,3573,300110,2948,225916,625,74194,906,8,1230,19,0,37,130000.0,39000.0,-71.0,-71.0,-67.0,-60.0,-70.0,-71.0,-67.0,-60.0,-87.0,-86.0,-83.0,-83.0,16.0,15.0,16.0,23.0,1
2404,BA:8C:B9:54:50:24,3838418,489684913,4818,6180793,3833600,483504120,0,8870,1690793,8848,1687298,22,3495,2345,15,5245,39,0,56,216660.0,130000.0,-49.0,-35.0,-42.0,-45.0,-43.0,-36.0,-44.0,-48.0,-87.0,-86.0,-83.0,-83.0,38.0,51.0,41.0,38.0,1
2405,3C:55:76:E8:8F:1F,3833607,483504882,2,298,3833605,483504584,0,2,362,2,362,0,0,0,3,4,9,0,0,1000.0,1000.0,-46.0,-49.0,-39.0,-37.0,-47.0,-49.0,-39.0,-39.0,-87.0,-86.0,-83.0,-83.0,41.0,37.0,44.0,46.0,1
2406,92:69:1D:31:68:E9,3837476,487111906,3871,3607322,3833605,483504584,0,4646,1083102,4508,1051907,138,31195,2084,10,4062,84,0,41,216660.0,130000.0,-51.0,-47.0,-42.0,-48.0,-51.0,-47.0,-43.0,-48.0,-87.0,-86.0,-83.0,-83.0,36.0,39.0,41.0,35.0,1
2407,CC:2F:71:3F:1F:24,4551971,1242248914,718361,758743854,3833610,483505060,37,571896,578387701,571189,578302607,707,85094,552403,15,718617,83311,34,480,130000.0,43333.0,-71.0,-67.0,-69.0,-72.0,-71.0,-67.0,-69.0,-71.0,-87.0,-86.0,-83.0,-83.0,16.0,19.0,14.0,11.0,1
2408,CC:2F:71:3E:C5:1F,3834466,483609690,856,104630,3833610,483505060,0,3573,300110,2948,225916,625,74194,906,8,1230,19,0,37,130000.0,39000.0,-71.0,-71.0,-67.0,-60.0,-70.0,-71.0,-67.0,-60.0,-87.0,-86.0,-83.0,-83.0,16.0,15.0,16.0,23.0,1
2409,BA:8C:B9:54:50:24,3838433,489686556,4818,6180793,3833615,483505763,0,8874,1691065,8852,1687570,22,3495,2345,15,5245,39,0,56,216660.0,130000.0,-40.0,-37.0,-46.0,-52.0,-43.0,-36.0,-44.0,-49.0,-87.0,-86.0,-83.0,-83.0,47.0,49.0,37.0,31.0,1
2410,3C:55:76:E8:8F:1F,3833620,483506475,2,298,3833618,483506177,0,21,2865,11,974,10,1891,10,3,4,9,0,1,1000.0,1000.0,-54.0,-48.0,-43.0,-44.0,-51.0,-50.0,-42.0,-42.0,-87.0,-86.0,-83.0,-83.0,33.0,38.0,40.0,39.0,1
2411,92:69:1D:31:68:E9,3837489,487113499,3871,3607322,3833618,483506177,0,4646,1083102,4508,1051907,138,31195,2084,10,4062,84,0,41,216660.0,130000.0,-51.0,-47.0,-42.0,-48.0,-51.0,-47.0,-43.0,-48.0,-87.0,-86.0,-83.0,-83.0,36.0,39.0,41.0,35.0,1
2412,CC:2F:71:3F:1F:24,4552103,1242386893,718483,758880514,3833620,483506379,37,572008,578519571,571301,578434477,707,85094,552506,15,718739,83322,34,480,130000.0,39000.0,-71.0,-67.0,-69.0,-72.0,-71.0,-66.0,-69.0,-72.0,-87.0,-86.0,-83.0,-83.0,16.0,19.0,14.0,11.0,1
2413,CC:2F:71:3E:C5:1F,3834478,483611211,856,104630,3833622,483506581,0,3573,300110,2948,225916,625,74194,906,8,1230,19,0,37,130000.0,39000.0,-71.0,-71.0,-67.0,-60.0,-70.0,-71.0,-67.0,-60.0,-87.0,-86.0,-83.0,-83.0,16.0,15.0,16.0,23.0,1
2414,BA:8C:B9:54:50:24,3838440,489687374,4818,6180793,3833622,483506581,0,8874,1691065,8852,1687570,22,3495,2345,15,5245,39,0,56,216660.0,130000.0,-40.0,-37.0,-46.0,-52.0,-43.0,-36.0,-44.0,-49.0,-87.0,-86.0,-83.0,-83.0,47.0,49.0,37.0,31.0,1
2415,3C:55:76:E8:8F:1F,3833638,483508369,2,298,3833636,483508071,0,36,4981,15,1246,21,3735,21,4,5,13,0,2,1000.0,1000.0,-55.0,-58.0,-48.0,-45.0,-53.0,-53.0,-46.0,-44.0,-87.0,-86.0,-83.0,-83.0,32.0,28.0,35.0,38.0,1
2416,92:69:1D:31:68:E9,3837509,487115649,3871,3607322,3833638,483508327,0,4647,1083170,4509,1051975,138,31195,2084,10,4062,84,0,41,216660.0,130000.0,-52.0,-47.0,-44.0,-47.0,-51.0,-47.0,-43.0,-48.0,-87.0,-86.0,-83.0,-83.0,35.0,39.0,39.0,36.0,1
2417,CC:2F:71:3F:1F:24,4552252,1242523256,718611,759014667,3833641,483508589,37,572116,578641034,571409,578555940,707,85094,552612,15,718867,83346,34,480,144444.0,43333.0,-73.0,-67.0,-70.0,-74.0,-72.0,-66.0,-69.0,-73.0,-87.0,-86.0,-83.0,-83.0,14.0,19.0,13.0,9.0,1
2418,CC:2F:71:3E:C5:1F,3834497,483613219,856,104630,3833641,483508589,0,3573,300110,2948,225916,625,74194,906,8,1230,19,0,37,130000.0,39000.0,-71.0,-71.0,-67.0,-60.0,-70.0,-71.0,-67.0,-60.0,-87.0,-86.0,-83.0,-83.0,16.0,15.0,16.0,23.0,1
2419,BA:8C:B9:54:50:24,3838459,489689382,4818,6180793,3833641,483508589,0,8874,1691065,8852,1687570,22,3495,2345,15,5245,39,0,56,216660.0,130000.0,-40.0,-37.0,-46.0,-52.0,-43.0,-36.0,-44.0,-49.0,-87.0,-86.0,-83.0,-83.0,47.0,49.0,37.0,31.0,1
2420,3C:55:76:E8:8F:1F,3833650,483509772,2,298,3833648,483509474,0,60,7598,31,2334,29,5264,29,4,5,13,0,4,1000.0,1000.0,-55.0,-50.0,-44.0,-44.0,-55.0,-52.0,-45.0,-44.0,-87.0,-86.0,-83.0,-83.0,32.0,36.0,39.0,39.0,1
2421,92:69:1D:31:68:E9,3837523,487117200,3871,3607322,3833652,483509878,0,4647,1083170,4509,1051975,138,31195,2084,10,4062,84,0,41,216660.0,130000.0,-52.0,-47.0,-44.0,-47.0,-51.0,-47.0,-43.0,-48.0,-87.0,-86.0,-83.0,-83.0,35.0,39.0,39.0,36.0,1
2422,CC:2F:71:3F:1F:24,4552383,1242656897,718731,759147019,3833652,483509878,37,572224,578772200,571517,578687106,707,85094,552711,15,718987,83348,34,480,144444.0,43333.0,-73.0,-67.0,-70.0,-73.0,-72.0,-67.0,-69.0,-73.0,-87.0,-86.0,-83.0,-83.0,14.0,19.0,13.0,10.0,1
2423,CC:2F:71:3E:C5:1F,3834508,483614508,856,104630,3833652,483509878,0,3573,300110,2948,225916,625,74194,906,8,1230,19,0,37,130000.0,39000.0,-71.0,-71.0,-67.0,-60.0,-70.0,-71.0,-67.0,-60.0,-87.0,-86.0,-83.0,-83.0,16.0,15.0,16.0,23.0,1
2424,BA:8C:B9:54:50:24,3838470,489690671,4818,6180793,3833652,483509878,0,8874,1691065,8852,1687570,22,3495,2345,15,5245,39,0,56,216660.0,130000.0,-40.0,-37.0,-46.0,-52.0,-43.0,-36.0,-44.0,-49.0,-87.0,-86.0,-83.0,-83.0,47.0,49.0,37.0,31.0,1
2425,3C:55:76:E8:8F:1F,3833659,483510856,2,298,3833657,483510558,0,62,8054,31,2334,31,5720,31,4,5,13,0,4,1000.0,1000.0,-53.0,-55.0,-48.0,-45.0,-54.0,-52.0,-45.0,-44.0,-87.0,-86.0,-83.0,-83.0,34.0,31.0,35.0,38.0,1
2426,92:69:1D:31:68:E9,3837529,487118039,3871,3607322,3833658,483510717,0,4647,1083170,4509,1051975,138,31195,2084,10,4062,84,0,41,216660.0,130000.0,-52.0,-47.0,-44.0,-47.0,-51.0,-47.0,-43.0,-48.0,-87.0,-86.0,-83.0,-83.0,35.0,39.0,39.0,36.0,1
2427,CC:2F:71:3F:1F:24,4552509,1242788618,718850,759277833,3833659,483510785,37,572331,578903184,571624,578818090,707,85094,552808,15,719105,83355,34,480,144444.0,43333.0,-72.0,-67.0,-69.0,-74.0,-72.0,-67.0,-69.0,-73.0,-87.0,-86.0,-83.0,-83.0,15.0,19.0,14.0,9.0,1
2428,CC:2F:71:3E:C5:1F,3834515,483615415,856,104630,3833659,483510785,0,3573,300110,2948,225916,625,74194,906,8,1230,19,0,37,130000.0,39000.0,-71.0,-71.0,-67.0,-60.0,-70.0,-71.0,-67.0,-60.0,-87.0,-86.0,-83.0,-83.0,16.0,15.0,16.0,23.0,1
2429,BA:8C:B9:54:50:24,3838477,489691578,4818,6180793,3833659,483510785,0,8874,1691065,8852,1687570,22,3495,2345,15,5245,39,0,56,216660.0,130000.0,-40.0,-37.0,-46.0,-52.0,-43.0,-36.0,-44.0,-49.0,-87.0,-86.0,-83.0,-83.0,47.0,49.0,37.0,31.0,1
2430,3C:55:76:E8:8F:1F,3833667,483511897,2,298,3833665,483511599,0,67,8541,35,2606,32,5935,32,4,5,13,0,4,1000.0,1000.0,-55.0,-50.0,-44.0,-44.0,-54.0,-52.0,-45.0,-44.0,-87.0,-86.0,-83.0,-83.0,32.0,36.0,39.0,39.0,1
2431,92:69:1D:31:68:E9,3837536,487118921,3871,3607322,3833665,483511599,0,4647,1083170,4509,1051975,138,31195,2084,10,4062,84,0,41,216660.0,130000.0,-52.0,-47.0,-44.0,-47.0,-51.0,-47.0,-43.0,-48.0,-87.0,-86.0,-83.0,-83.0,35.0,39.0,39.0,36.0,1
2432,CC:2F:71:3F:1F:24,4552633,1242918676,718968,759407077,3833665,483511599,37,572434,579029342,571727,578944248,707,85094,552904,15,719224,83360,34,480,144444.0,43333.0,-72.0,-66.0,-70.0,-73.0,-72.0,-66.0,-69.0,-73.0,-87.0,-86.0,-83.0,-83.0,15.0,20.0,13.0,10.0,1
2433,CC:2F:71:3E:C5:1F,3834527,483618329,856,104630,3833671,483513699,0,3573,300110,2948,225916,625,74194,906,8,1230,19,0,37,130000.0,39000.0,-71.0,-71.0,-67.0,-60.0,-70.0,-71.0,-67.0,-60.0,-87.0,-86.0,-83.0,-83.0,16.0,15.0,16.0,23.0,1
2434,BA:8C:B9:54:50:24,3838489,489694492,4818,6180793,3833671,483513699,0,8874,1691065,8852,1687570,22,3495,2345,15,5245,39,0,56,216660.0,130000.0,-40.0,-37.0,-46.0,-52.0,-43.0,-36.0,-44.0,-49.0,-87.0,-86.0,-83.0,-83.0,47.0,49.0,37.0,31.0,1
2435,3C:55:76:E8:8F:1F,3833700,483518175,3,358,3833697,483517817,0,90,12273,50,4544,40,7729,44,6,8,16,0,10,243750.0,1000.0,-52.0,-48.0,-42.0,-42.0,-53.0,-51.0,-44.0,-44.0,-87.0,-86.0,-83.0,-83.0,35.0,38.0,41.0,41.0,1
2436,92:69:1D:31:68:E9,3837569,487125255,3872,3607438,3833697,483517817,0,4649,1083306,4511,1052111,138,31195,2084,10,4063,84,0,41,216660.0,130000.0,-52.0,-47.0,-42.0,-48.0,-51.0,-47.0,-42.0,-47.0,-87.0,-86.0,-83.0,-83.0,35.0,39.0,41.0,35.0,1
2437,CC:2F:71:3F:1F:24,4552789,1243057481,719092,759539664,3833697,483517817,37,572542,579153695,571835,579068601,707,85094,553007,15,719348,83362,34,480,144444.0,43333.0,-72.0,-66.0,-70.0,-74.0,-71.0,-66.0,-69.0,-73.0,-87.0,-86.0,-83.0,-83.0,15.0,20.0,13.0,9.0,1
2438,CC:2F:71:3E:C5:1F,3834554,483622563,857,104746,3833697,483517817,0,3575,300250,2950,226056,625,74194,906,8,1231,19,0,37,130000.0,39000.0,-71.0,-72.0,-67.0,-60.0,-70.0,-71.0,-67.0,-60.0,-87.0,-86.0,-83.0,-83.0,16.0,14.0,16.0,23.0,1
2439,BA:8C:B9:54:50:24,3838516,489698726,4819,6180909,3833697,483517817,0,8879,1691405,8857,1687910,22,3495,2345,15,5246,39,0,56,216660.0,130000.0,-49.0,-35.0,-43.0,-45.0,-42.0,-35.0,-43.0,-47.0,-87.0,-86.0,-83.0,-83.0,38.0,51.0,40.0,38.0,1
2440,3C:55:76:E8:8F:1F,3833712,483519593,3,358,3833709,483519235,0,102,14007,54,4816,48,9191,52,7,9,18,0,13,243750.0,1000.0,-53.0,-55.0,-47.0,-45.0,-53.0,-54.0,-46.0,-44.0,-87.0,-86.0,-83.0,-83.0,34.0,31.0,36.0,38.0,1
2441,92:69:1D:31:68:E9,3837582,487126733,3872,3607438,3833710,483519295,0,4649,1083306,4511,1052111,138,31195,2084,10,4063,84,0,41,216660.0,130000.0,-52.0,-47.0,-42.0,-48.0,-51.0,-47.0,-42.0,-47.0,-87.0,-86.0,-83.0,-83.0,35.0,39.0,41.0,35.0,1
2442,CC:2F:71:3F:1F:24,4552921,1243188524,719210,759668956,3833711,483519568,37,572641,579270963,571934,579185869,707,85094,553102,15,719465,83368,34,480,144444.0,43333.0,-72.0,-66.0,-69.0,-73.0,-72.0,-66.0,-69.0,-73.0,-87.0,-86.0,-83.0,-83.0,15.0,20.0,14.0,10.0,1
2443,CC:2F:71:3E:C5:1F,3834568,483624314,857,104746,3833711,483519568,0,3575,300250,2950,226056,625,74194,906,8,1231,19,0,37,130000.0,39000.0,-71.0,-72.0,-67.0,-60.0,-70.0,-71.0,-67.0,-60.0,-87.0,-86.0,-83.0,-83.0,16.0,14.0,16.0,23.0,1
2444,BA:8C:B9:54:50:24,3838530,489700477,4819,6180909,3833711,483519568,0,8879,1691405,8857,1687910,22,3495,2345,15,5246,39,0,56,216660.0,130000.0,-49.0,-35.0,-43.0,-45.0,-42.0,-35.0,-43.0,-47.0,-87.0,-86.0,-83.0,-83.0,38.0,51.0,40.0,38.0,1
2445,3C:55:76:E8:8F:1F,3833719,483520392,3,358,3833716,483520034,0,109,14483,61,5292,48,9191,52,7,9,18,0,14,243750.0,1000.0,-53.0,-49.0,-43.0,-43.0,-53.0,-50.0,-44.0,-43.0,-87.0,-86.0,-83.0,-83.0,34.0,37.0,40.0,40.0,1
2446,92:69:1D:31:68:E9,3837588,487127472,3872,3607438,3833716,483520034,0,4649,1083306,4511,1052111,138,31195,2084,10,4063,84,0,41,216660.0,130000.0,-52.0,-47.0,-42.0,-48.0,-51.0,-47.0,-42.0,-47.0,-87.0,-86.0,-83.0,-83.0,35.0,39.0,41.0,35.0,1
2447,CC:2F:71:3F:1F:24,4553044,1243316826,719328,759796792,3833716,483520034,37,572743,579392835,572035,579307623,708,85212,553199,15,719584,83377,34,480,144444.0,43333.0,-72.0,-67.0,-69.0,-73.0,-71.0,-66.0,-69.0,-73.0,-87.0,-86.0,-83.0,-83.0,15.0,19.0,14.0,10.0,1
2448,CC:2F:71:3E:C5:1F,3834574,483624840,857,104746,3833717,483520094,0,3575,300250,2950,226056,625,74194,906,8,1231,19,0,37,130000.0,39000.0,-71.0,-72.0,-67.0,-60.0,-70.0,-71.0,-67.0,-60.0,-87.0,-86.0,-83.0,-83.0,16.0,14.0,16.0,23.0,1
2449,BA:8C:B9:54:50:24,3838542,489703149,4819,6180909,3833723,483522240,0,8879,1691405,8857,1687910,22,3495,2345,15,5246,39,0,56,216660.0,130000.0,-49.0,-35.0,-43.0,-45.0,-42.0,-35.0,-43.0,-47.0,-87.0,-86.0,-83.0,-83.0,38.0,51.0,40.0,38.0,1
2450,3C:55:76:E8:8F:1F,3833773,483537639,21,12857,3833752,483524782,0,164,23982,94,11437,70,12545,92,7,27,18,0,15,243750.0,146250.0,-52.0,-54.0,-47.0,-45.0,-52.0,-53.0,-46.0,-45.0,-87.0,-86.0,-83.0,-83.0,35.0,32.0,36.0,38.0,1
2451,92:69:1D:31:68:E9,3837625,487132379,3872,3607438,3833753,483524941,0,4649,1083306,4511,1052111,138,31195,2084,10,4063,84,0,41,216660.0,130000.0,-52.0,-47.0,-42.0,-48.0,-51.0,-47.0,-42.0,-47.0,-87.0,-86.0,-83.0,-83.0,35.0,39.0,41.0,35.0,1
2452,CC:2F:71:3F:1F:24,4553205,1243456049,719452,759931108,3833753,483524941,37,572847,579516199,572139,579430987,708,85212,553299,15,719707,83386,34,480,144444.0,43333.0,-72.0,-67.0,-70.0,-73.0,-72.0,-66.0,-69.0,-73.0,-87.0,-86.0,-83.0,-83.0,15.0,19.0,13.0,10.0,1
2453,CC:2F:71:3E:C5:1F,3834610,483629687,857,104746,3833753,483524941,0,3575,300250,2950,226056,625,74194,906,8,1231,19,0,37,130000.0,39000.0,-71.0,-72.0,-67.0,-60.0,-70.0,-71.0,-67.0,-60.0,-87.0,-86.0,-83.0,-83.0,16.0,14.0,16.0,23.0,1
2454,BA:8C:B9:54:50:24,3838583,489706968,4819,6180909,3833764,483526059,0,8879,1691405,8857,1687910,22,3495,2345,15,5246,39,0,56,216660.0,130000.0,-49.0,-35.0,-43.0,-45.0,-42.0,-35.0,-43.0,-47.0,-87.0,-86.0,-83.0,-83.0,38.0,51.0,40.0,38.0,1
2455,3C:55:76:E8:8F:1F,3833879,483715108,110,188419,3833769,483526689,0,269,39785,189,25615,80,14170,176,9,117,32,0,17,286760.0,162500.0,-52.0,-54.0,-47.0,-45.0,-52.0,-52.0,-46.0,-44.0,-87.0,-86.0,-83.0,-83.0,35.0,32.0,36.0,38.0,1
2456,92:69:1D:31:68:E9,3837646,487134930,3872,3607438,3833774,483527492,0,4649,1083306,4511,1052111,138,31195,2084,10,4063,84,0,41,216660.0,130000.0,-52.0,-47.0,-42.0,-48.0,-51.0,-47.0,-42.0,-47.0,-87.0,-86.0,-83.0,-83.0,35.0,39.0,41.0,35.0,1
2457,CC:2F:71:3F:1F:24,4553401,1243658148,719623,760130252,3833778,483527896,37,573031,579714717,572323,579629505,708,85212,553456,15,719879,83390,34,480,144444.0,43333.0,-72.0,-67.0,-69.0,-74.0,-71.0,-66.0,-69.0,-73.0,-87.0,-86.0,-83.0,-83.0,15.0,19.0,14.0,9.0,1
2458,CC:2F:71:3E:C5:1F,3834635,483632642,857,104746,3833778,483527896,0,3575,300250,2950,226056,625,74194,906,8,1231,19,0,37,130000.0,39000.0,-71.0,-72.0,-67.0,-60.0,-70.0,-71.0,-67.0,-60.0,-87.0,-86.0,-83.0,-83.0,16.0,14.0,16.0,23.0,1
2459,BA:8C:B9:54:50:24,3838597,489708805,4819,6180909,3833778,483527896,0,8879,1691405,8857,1687910,22,3495,2345,15,5246,39,0,56,216660.0,130000.0,-49.0,-35.0,-43.0,-45.0,-42.0,-35.0,-43.0,-47.0,-87.0,-86.0,-83.0,-83.0,38.0,51.0,40.0,38.0,1
2460,3C:55:76:E8:8F:1F,3834024,483846994,219,316230,3833805,483530764,0,441,88885,350,72575,91,16310,308,9,227,34,0,17,146250.0,48750.0,-52.0,-54.0,-47.0,-45.0,-52.0,-52.0,-45.0,-44.0,-87.0,-86.0,-83.0,-83.0,35.0,32.0,36.0,38.0,1
2461,92:69:1D:31:68:E9,3837677,487138202,3872,3607438,3833805,483530764,0,4649,1083306,4511,1052111,138,31195,2084,10,4063,84,0,41,216660.0,130000.0,-52.0,-47.0,-42.0,-48.0,-51.0,-47.0,-42.0,-47.0,-87.0,-86.0,-83.0,-83.0,35.0,39.0,41.0,35.0,1
2462,CC:2F:71:3F:1F:24,4553573,1243830772,719767,760299948,3833806,483530824,37,573164,579872291,572456,579787079,708,85212,553578,15,720023,83396,34,480,144444.0,43333.0,-72.0,-66.0,-70.0,-73.0,-71.0,-66.0,-69.0,-74.0,-87.0,-86.0,-83.0,-83.0,15.0,20.0,13.0,10.0,1
2463,CC:2F:71:3E:C5:1F,3834665,483635821,857,104746,3833808,483531075,0,3575,300250,2950,226056,625,74194,906,8,1231,19,0,37,130000.0,39000.0,-71.0,-72.0,-67.0,-60.0,-70.0,-71.0,-67.0,-60.0,-87.0,-86.0,-83.0,-83.0,16.0,14.0,16.0,23.0,1
2464,BA:8C:B9:54:50:24,3838633,489712779,4819,6180909,3833814,483531870,0,8879,1691405,8857,1687910,22,3495,2345,15,5246,39,0,56,216660.0,130000.0,-49.0,-35.0,-43.0,-45.0,-42.0,-35.0,-43.0,-47.0,-87.0,-86.0,-83.0,-83.0,38.0,51.0,40.0,38.0,1
2465,3C:55:76:E8:8F:1F,3834173,484023781,346,490470,3833827,483533311,0,654,130952,548,111941,106,19011,434,10,354,39,0,24,172050.0,48750.0,-55.0,-53.0,-46.0,-44.0,-52.0,-53.0,-46.0,-45.0,-87.0,-86.0,-83.0,-83.0,32.0,33.0,37.0,39.0,1
2466,92:69:1D:31:68:E9,3837699,487140749,3872,3607438,3833827,483533311,0,4650,1083374,4512,1052179,138,31195,2084,10,4064,84,0,41,216660.0,130000.0,-51.0,-48.0,-44.0,-47.0,-51.0,-47.0,-43.0,-47.0,-87.0,-86.0,-83.0,-83.0,36.0,38.0,39.0,36.0,1
2467,CC:2F:71:3F:1F:24,4553782,1244054039,719950,760520062,3833832,483533977,37,573347,580078341,572639,579993129,708,85212,553742,15,720206,83416,34,481,144444.0,43333.0,-73.0,-66.0,-69.0,-74.0,-74.0,-69.0,-71.0,-74.0,-87.0,-86.0,-83.0,-83.0,14.0,20.0,14.0,9.0,1
2468,CC:2F:71:3E:C5:1F,3834689,483638723,857,104746,3833832,483533977,0,3577,300390,2952,226196,625,74194,906,8,1232,19,0,37,130000.0,39000.0,-71.0,-70.0,-67.0,-60.0,-70.0,-70.0,-67.0,-60.0,-87.0,-86.0,-83.0,-83.0,16.0,16.0,16.0,23.0,1
2469,BA:8C:B9:54:50:24,3838651,489714886,4819,6180909,3833832,483533977,0,8881,1691541,8859,1688046,22,3495,2345,15,5247,39,0,56,216660.0,130000.0,-51.0,-35.0,-43.0,-44.0,-43.0,-34.0,-43.0,-46.0,-87.0,-86.0,-83.0,-83.0,36.0,51.0,40.0,39.0,1
2470,3C:55:76:E8:8F:1F,3834232,484045458,381,509139,3833851,483536319,0,733,149925,615,128496,118,21429,480,10,390,39,0,30,195000.0,1000.0,-53.0,-55.0,-48.0,-45.0,-52.0,-50.0,-44.0,-42.0,-87.0,-86.0,-83.0,-83.0,34.0,31.0,35.0,38.0,1
2471,92:69:1D:31:68:E9,3837723,487143757,3872,3607438,3833851,483536319,0,4651,1083442,4513,1052247,138,31195,2084,10,4064,84,0,41,216660.0,130000.0,-51.0,-47.0,-42.0,-48.0,-51.0,-47.0,-43.0,-47.0,-87.0,-86.0,-83.0,-83.0,36.0,39.0,41.0,35.0,1
2472,CC:2F:71:3F:1F:24,4554278,1244648476,720427,761112157,3833851,483536319,37,573595,580231531,572887,580146319,708,85212,553976,15,720683,83429,34,481,144444.0,43333.0,-73.0,-67.0,-69.0,-75.0,-73.0,-66.0,-69.0,-74.0,-87.0,-86.0,-83.0,-83.0,14.0,19.0,14.0,8.0,1
2473,CC:2F:71:3E:C5:1F,3834708,483641065,857,104746,3833851,483536319,0,3579,300578,2953,226266,626,74312,907,8,1232,19,0,37,130000.0,39000.0,-71.0,-70.0,-67.0,-60.0,-70.0,-70.0,-66.0,-60.0,-87.0,-86.0,-83.0,-83.0,16.0,16.0,16.0,23.0,1
2474,BA:8C:B9:54:50:24,3838672,489717430,4819,6180909,3833853,483536521,0,8881,1691541,8859,1688046,22,3495,2345,15,5247,39,0,56,216660.0,130000.0,-51.0,-35.0,-43.0,-44.0,-43.0,-34.0,-43.0,-46.0,-87.0,-86.0,-83.0,-83.0,36.0,51.0,40.0,39.0,1
2475,3C:55:76:E8:8F:1F,3834284,484078446,413,540337,3833871,483538109,0,795,166510,671,144263,124,22247,514,10,422,39,0,31,162500.0,1000.0,-52.0,-54.0,-47.0,-45.0,-52.0,-51.0,-44.0,-42.0,-87.0,-86.0,-83.0,-83.0,35.0,32.0,36.0,38.0,1
2476,92:69:1D:31:68:E9,3837745,487145996,3872,3607438,3833873,483538558,0,4651,1083442,4513,1052247,138,31195,2084,10,4064,84,0,41,216660.0,130000.0,-51.0,-47.0,-42.0,-48.0,-51.0,-47.0,-43.0,-47.0,-87.0,-86.0,-83.0,-83.0,36.0,39.0,41.0,35.0,1
2477,CC:2F:71:3F:1F:24,4554476,1244824349,720603,761285791,3833873,483538558,37,573752,580365719,573044,580280507,708,85212,554122,15,720859,83434,34,481,144444.0,43333.0,-73.0,-66.0,-70.0,-74.0,-72.0,-66.0,-69.0,-74.0,-87.0,-86.0,-83.0,-83.0,14.0,20.0,13.0,9.0,1
2478,CC:2F:71:3E:C5:1F,3834730,483643304,857,104746,3833873,483538558,0,3579,300578,2953,226266,626,74312,907,8,1232,19,0,37,130000.0,39000.0,-71.0,-70.0,-67.0,-60.0,-70.0,-70.0,-66.0,-60.0,-87.0,-86.0,-83.0,-83.0,16.0,16.0,16.0,23.0,1
2479,BA:8C:B9:54:50:24,3838693,489719697,4819,6180909,3833874,483538788,0,8881,1691541,8859,1688046,22,3495,2345,15,5247,39,0,56,216660.0,130000.0,-51.0,-35.0,-43.0,-44.0,-43.0,-34.0,-43.0,-46.0,-87.0,-86.0,-83.0,-83.0,36.0,51.0,40.0,39.0,1
2480,3C:55:76:E8:8F:1F,3834296,484080371,413,540337,3833883,483540034,0,818,169523,688,145868,130,23655,521,10,422,39,0,32,162500.0,1000.0,-58.0,-47.0,-42.0,-40.0,-53.0,-51.0,-44.0,-43.0,-87.0,-86.0,-83.0,-83.0,29.0,39.0,41.0,43.0,1
2481,92:69:1D:31:68:E9,3837755,487147472,3872,3607438,3833883,483540034,0,4651,1083442,4513,1052247,138,31195,2084,10,4064,84,0,41,216660.0,130000.0,-51.0,-47.0,-42.0,-48.0,-51.0,-47.0,-43.0,-47.0,-87.0,-86.0,-83.0,-83.0,36.0,39.0,41.0,35.0,1
2482,CC:2F:71:3F:1F:24,4554606,1244956727,720721,761416491,3833885,483540236,37,573855,580489001,573147,580403789,708,85212,554220,15,720977,83438,34,481,144444.0,43333.0,-72.0,-66.0,-69.0,-74.0,-72.0,-66.0,-69.0,-73.0,-87.0,-86.0,-83.0,-83.0,15.0,20.0,14.0,9.0,1
2483,CC:2F:71:3E:C5:1F,3834742,483644982,857,104746,3833885,483540236,0,3579,300578,2953,226266,626,74312,907,8,1232,19,0,37,130000.0,39000.0,-71.0,-70.0,-67.0,-60.0,-70.0,-70.0,-66.0,-60.0,-87.0,-86.0,-83.0,-83.0,16.0,16.0,16.0,23.0,1
2484,BA:8C:B9:54:50:24,3838705,489721205,4819,6180909,3833886,483540296,0,8881,1691541,8859,1688046,22,3495,2345,15,5247,39,0,56,216660.0,130000.0,-51.0,-35.0,-43.0,-44.0,-43.0,-34.0,-43.0,-46.0,-87.0,-86.0,-83.0,-83.0,36.0,51.0,40.0,39.0,1
2485,3C:55:76:E8:8F:1F,3834305,484081484,413,540337,3833892,483541147,0,839,171576,707,147609,132,23967,524,10,422,39,0,33,162500.0,1000.0,-48.0,-52.0,-45.0,-37.0,-49.0,-52.0,-45.0,-38.0,-87.0,-86.0,-83.0,-83.0,39.0,34.0,38.0,46.0,1
2486,92:69:1D:31:68:E9,3837764,487148585,3872,3607438,3833892,483541147,0,4651,1083442,4513,1052247,138,31195,2084,10,4064,84,0,41,216660.0,130000.0,-51.0,-47.0,-42.0,-48.0,-51.0,-47.0,-43.0,-47.0,-87.0,-86.0,-83.0,-83.0,36.0,39.0,41.0,35.0,1
2487,CC:2F:71:3F:1F:24,4554730,1245086784,720838,761545637,3833892,483541147,37,573960,580612809,573252,580527597,708,85212,554317,15,721094,83440,34,481,144444.0,43333.0,-72.0,-66.0,-69.0,-73.0,-72.0,-66.0,-69.0,-72.0,-87.0,-86.0,-83.0,-83.0,15.0,20.0,14.0,10.0,1
2488,CC:2F:71:3E:C5:1F,3834750,483646123,857,104746,3833893,483541377,0,3579,300578,2953,226266,626,74312,907,8,1232,19,0,37,130000.0,39000.0,-71.0,-70.0,-67.0,-60.0,-70.0,-70.0,-66.0,-60.0,-87.0,-86.0,-83.0,-83.0,16.0,16.0,16.0,23.0,1
2489,BA:8C:B9:54:50:24,3838712,489722286,4819,6180909,3833893,483541377,0,8881,1691541,8859,1688046,22,3495,2345,15,5247,39,0,56,216660.0,130000.0,-51.0,-35.0,-43.0,-44.0,-43.0,-34.0,-43.0,-46.0,-87.0,-86.0,-83.0,-83.0,36.0,51.0,40.0,39.0,1
2490,3C:55:76:E8:8F:1F,3834329,484088154,420,544922,3833909,483543232,0,879,176298,740,151109,139,25189,541,10,429,39,0,39,162500.0,1000.0,-59.0,-51.0,-43.0,-44.0,-58.0,-51.0,-43.0,-43.0,-87.0,-86.0,-83.0,-83.0,28.0,35.0,40.0,39.0,1
2491,92:69:1D:31:68:E9,3837781,487150670,3872,3607438,3833909,483543232,0,4651,1083442,4513,1052247,138,31195,2084,10,4064,84,0,41,216660.0,130000.0,-51.0,-47.0,-42.0,-48.0,-51.0,-47.0,-43.0,-47.0,-87.0,-86.0,-83.0,-83.0,36.0,39.0,41.0,35.0,1
2492,CC:2F:71:3F:1F:24,4554877,1245226538,720968,761683306,3833909,483543232,37,574071,580738907,573363,580653695,708,85212,554425,15,721224,83448,34,481,144444.0,43333.0,-72.0,-67.0,-69.0,-73.0,-71.0,-66.0,-69.0,-72.0,-87.0,-86.0,-83.0,-83.0,15.0,19.0,14.0,10.0,1
2493,CC:2F:71:3E:C5:1F,3834766,483647978,857,104746,3833909,483543232,0,3579,300578,2953,226266,626,74312,907,8,1232,19,0,37,130000.0,39000.0,-71.0,-70.0,-67.0,-60.0,-70.0,-70.0,-66.0,-60.0,-87.0,-86.0,-83.0,-83.0,16.0,16.0,16.0,23.0,1
2494,BA:8C:B9:54:50:24,3838729,489724300,4819,6180909,3833910,483543391,0,8881,1691541,8859,1688046,22,3495,2345,15,5247,39,0,56,216660.0,130000.0,-51.0,-35.0,-43.0,-44.0,-43.0,-34.0,-43.0,-46.0,-87.0,-86.0,-83.0,-83.0,36.0,51.0,40.0,39.0,1
2495,3C:55:76:E8:8F:1F,3834346,484098008,424,553282,3833922,483544726,0,904,179741,759,153567,145,26174,552,10,432,39,0,40,162500.0,1000.0,-53.0,-54.0,-46.0,-44.0,-54.0,-51.0,-43.0,-41.0,-87.0,-86.0,-83.0,-83.0,34.0,32.0,37.0,39.0,1
2496,92:69:1D:31:68:E9,3837795,487152394,3872,3607438,3833923,483544956,0,4651,1083442,4513,1052247,138,31195,2084,10,4064,84,0,41,216660.0,130000.0,-51.0,-47.0,-42.0,-48.0,-51.0,-47.0,-43.0,-47.0,-87.0,-86.0,-83.0,-83.0,36.0,39.0,41.0,35.0,1
2497,CC:2F:71:3F:1F:24,4555008,1245357440,721085,761812484,3833923,483544956,37,574170,580857521,573462,580772309,708,85212,554521,15,721341,83449,34,481,144444.0,43333.0,-72.0,-66.0,-69.0,-72.0,-72.0,-66.0,-69.0,-72.0,-87.0,-86.0,-83.0,-83.0,15.0,20.0,14.0,11.0,1
2498,CC:2F:71:3E:C5:1F,3834783,483649964,857,104746,3833926,483545218,0,3579,300578,2953,226266,626,74312,907,8,1232,19,0,37,130000.0,39000.0,-71.0,-70.0,-67.0,-60.0,-70.0,-70.0,-66.0,-60.0,-87.0,-86.0,-83.0,-83.0,16.0,16.0,16.0,23.0,1
2499,BA:8C:B9:54:50:24,3838745,489726127,4819,6180909,3833926,483545218,0,8882,1691609,8860,1688114,22,3495,2345,15,5247,39,0,56,216660.0,130000.0,-41.0,-39.0,-48.0,-52.0,-43.0,-35.0,-43.0,-46.0,-87.0,-86.0,-83.0,-83.0,46.0,47.0,35.0,31.0,1
2500,3C:55:76:E8:8F:1F,3834363,484106149,432,560467,3833931,483545682,0,938,183643,790,156971,148,26672,566,10,441,39,0,40,162500.0,48750.0,-51.0,-51.0,-43.0,-40.0,-52.0,-49.0,-43.0,-42.0,-87.0,-86.0,-83.0,-83.0,36.0,35.0,40.0,43.0,1
2501,92:69:1D:31:68:E9,3837803,487153120,3872,3607438,3833931,483545682,0,4651,1083442,4513,1052247,138,31195,2084,10,4064,84,0,41,216660.0,130000.0,-51.0,-47.0,-42.0,-48.0,-51.0,-47.0,-43.0,-47.0,-87.0,-85.0,-83.0,-83.0,36.0,38.0,41.0,35.0,1
2502,CC:2F:71:3F:1F:24,4555134,1245488810,721203,761943128,3833931,483545682,37,574273,580981007,573565,580895795,708,85212,554617,15,721458,83449,34,481,130000.0,39000.0,-71.0,-66.0,-70.0,-72.0,-71.0,-66.0,-69.0,-72.0,-87.0,-85.0,-83.0,-83.0,16.0,19.0,13.0,11.0,1
2503,CC:2F:71:3E:C5:1F,3834788,483650428,857,104746,3833931,483545682,0,3579,300578,2953,226266,626,74312,907,8,1232,19,0,37,130000.0,39000.0,-71.0,-70.0,-67.0,-60.0,-70.0,-70.0,-66.0,-60.0,-87.0,-85.0,-83.0,-83.0,16.0,15.0,16.0,23.0,1
2504,BA:8C:B9:54:50:24,3838750,489726591,4819,6180909,3833931,483545682,0,8882,1691609,8860,1688114,22,3495,2345,15,5247,39,0,56,216660.0,130000.0,-41.0,-39.0,-48.0,-52.0,-43.0,-35.0,-43.0,-46.0,-87.0,-85.0,-83.0,-83.0,46.0,46.0,35.0,31.0,1
2505,3C:55:76:E8:8F:1F,3834367,484106845,432,560467,3833935,483546378,0,957,185411,807,158133,150,27278,568,10,441,39,0,41,162500.0,48750.0,-54.0,-50.0,-43.0,-45.0,-53.0,-50.0,-43.0,-44.0,-87.0,-85.0,-83.0,-83.0,33.0,35.0,40.0,38.0,1
2506,92:69:1D:31:68:E9,3837809,487154018,3872,3607438,3833937,483546580,0,4651,1083442,4513,1052247,138,31195,2084,10,4064,84,0,41,216660.0,130000.0,-51.0,-47.0,-42.0,-48.0,-51.0,-47.0,-43.0,-47.0,-87.0,-85.0,-83.0,-83.0,36.0,38.0,41.0,35.0,1
2507,CC:2F:71:3F:1F:24,4555258,1245617464,721321,762070884,3833937,483546580,37,574371,581097957,573663,581012745,708,85212,554714,15,721577,83450,34,481,144444.0,43333.0,-72.0,-67.0,-69.0,-71.0,-71.0,-67.0,-69.0,-72.0,-87.0,-85.0,-83.0,-83.0,15.0,18.0,14.0,12.0,1
2508,CC:2F:71:3E:C5:1F,3834795,483651386,857,104746,3833938,483546640,0,3579,300578,2953,226266,626,74312,907,8,1232,19,0,37,130000.0,39000.0,-71.0,-70.0,-67.0,-60.0,-70.0,-70.0,-66.0,-60.0,-87.0,-85.0,-83.0,-83.0,16.0,15.0,16.0,23.0,1
2509,BA:8C:B9:54:50:24,3838765,489728349,4819,6180909,3833946,483547440,0,8882,1691609,8860,1688114,22,3495,2345,15,5247,39,0,56,216660.0,130000.0,-41.0,-39.0,-48.0,-52.0,-43.0,-35.0,-43.0,-46.0,-87.0,-85.0,-83.0,-83.0,46.0,46.0,35.0,31.0,1
2510,3C:55:76:E8:8F:1F,3834395,484115874,444,567970,3833951,483547904,0,998,195841,843,167833,155,28008,587,10,455,39,0,41,172050.0,48750.0,-48.0,-54.0,-47.0,-41.0,-50.0,-53.0,-46.0,-43.0,-87.0,-85.0,-83.0,-83.0,39.0,31.0,36.0,42.0,1
2511,92:69:1D:31:68:E9,3837823,487155342,3872,3607438,3833951,483547904,0,4651,1083442,4513,1052247,138,31195,2084,10,4064,84,0,41,216660.0,130000.0,-51.0,-47.0,-42.0,-48.0,-51.0,-47.0,-43.0,-47.0,-87.0,-85.0,-83.0,-83.0,36.0,38.0,41.0,35.0,1
2512,CC:2F:71:3F:1F:24,4555398,1245751665,721447,762203761,3833951,483547904,37,574481,581222650,573773,581137438,708,85212,554817,15,721703,83451,34,481,144444.0,43333.0,-73.0,-67.0,-70.0,-73.0,-72.0,-67.0,-69.0,-73.0,-87.0,-85.0,-83.0,-83.0,14.0,18.0,13.0,10.0,1
2513,CC:2F:71:3E:C5:1F,3834808,483652650,857,104746,3833951,483547904,0,3579,300578,2953,226266,626,74312,907,8,1232,19,0,37,130000.0,39000.0,-71.0,-70.0,-67.0,-60.0,-70.0,-70.0,-66.0,-60.0,-87.0,-85.0,-83.0,-83.0,16.0,15.0,16.0,23.0,1
2514,BA:8C:B9:54:50:24,3838770,489728813,4819,6180909,3833951,483547904,0,8886,1691881,8864,1688386,22,3495,2345,15,5247,39,0,56,216660.0,130000.0,-40.0,-37.0,-46.0,-51.0,-42.0,-36.0,-45.0,-49.0,-87.0,-85.0,-83.0,-83.0,47.0,48.0,37.0,32.0,1
2515,3C:55:76:E8:8F:1F,3834413,484125655,457,577105,3833956,483548550,0,1028,203963,872,175657,156,28306,603,10,468,39,0,41,162500.0,48750.0,-50.0,-51.0,-44.0,-42.0,-49.0,-51.0,-44.0,-41.0,-87.0,-85.0,-83.0,-83.0,37.0,34.0,39.0,41.0,1
2516,92:69:1D:31:68:E9,3837828,487155988,3872,3607438,3833956,483548550,0,4651,1083442,4513,1052247,138,31195,2084,10,4064,84,0,41,216660.0,130000.0,-51.0,-47.0,-42.0,-48.0,-51.0,-47.0,-43.0,-47.0,-87.0,-85.0,-83.0,-83.0,36.0,38.0,41.0,35.0,1
2517,CC:2F:71:3F:1F:24,4555522,1245881749,721566,762333199,3833956,483548550,37,574584,581347480,573876,581262268,708,85212,554913,15,721822,83457,34,481,144444.0,43333.0,-72.0,-67.0,-70.0,-73.0,-72.0,-67.0,-69.0,-73.0,-87.0,-85.0,-83.0,-83.0,15.0,18.0,13.0,10.0,1
2518,CC:2F:71:3E:C5:1F,3834813,483653296,857,104746,3833956,483548550,0,3579,300578,2953,226266,626,74312,907,8,1232,19,0,37,130000.0,39000.0,-71.0,-70.0,-67.0,-60.0,-70.0,-70.0,-66.0,-60.0,-87.0,-85.0,-83.0,-83.0,16.0,15.0,16.0,23.0,1
2519,BA:8C:B9:54:50:24,3838775,489729459,4819,6180909,3833956,483548550,0,8886,1691881,8864,1688386,22,3495,2345,15,5247,39,0,56,216660.0,130000.0,-40.0,-37.0,-46.0,-51.0,-42.0,-36.0,-45.0,-49.0,-87.0,-85.0,-83.0,-83.0,47.0,48.0,37.0,32.0,1
2520,3C:55:76:E8:8F:1F,3834418,484126119,457,577105,3833961,483549014,0,1035,204441,879,176135,156,28306,603,10,468,39,0,41,162500.0,48750.0,-54.0,-50.0,-43.0,-44.0,-53.0,-49.0,-43.0,-43.0,-86.0,-85.0,-83.0,-82.0,32.0,35.0,40.0,38.0,1
2521,92:69:1D:31:68:E9,3837834,487156694,3872,3607438,3833962,483549256,0,4651,1083442,4513,1052247,138,31195,2084,10,4064,84,0,41,216660.0,130000.0,-51.0,-47.0,-42.0,-48.0,-51.0,-47.0,-43.0,-47.0,-86.0,-85.0,-83.0,-82.0,35.0,38.0,41.0,34.0,1
2522,CC:2F:71:3F:1F:24,4555649,1246014985,721687,762465729,3833962,483549256,37,574693,581475916,573985,581390704,708,85212,555014,15,721943,83465,34,481,144444.0,43333.0,-72.0,-67.0,-70.0,-73.0,-72.0,-67.0,-70.0,-73.0,-86.0,-85.0,-83.0,-82.0,14.0,18.0,13.0,9.0,1
2523,CC:2F:71:3E:C5:1F,3834819,483654002,857,104746,3833962,483549256,0,3579,300578,2953,226266,626,74312,907,8,1232,19,0,37,130000.0,39000.0,-71.0,-70.0,-67.0,-60.0,-70.0,-70.0,-66.0,-60.0,-86.0,-85.0,-83.0,-82.0,15.0,15.0,16.0,22.0,1
2524,BA:8C:B9:54:50:24,3838781,489730165,4819,6180909,3833962,483549256,0,8886,1691881,8864,1688386,22,3495,2345,15,5247,39,0,56,216660.0,130000.0,-40.0,-37.0,-46.0,-51.0,-42.0,-36.0,-45.0,-49.0,-86.0,-85.0,-83.0,-82.0,46.0,48.0,37.0,31.0,1
2525,3C:55:76:E8:8F:1F,3834426,484127141,459,577421,3833967,483549720,0,1051,205927,893,177217,158,28710,607,10,470,39,0,41,162500.0,1000.0,-57.0,-62.0,-49.0,-44.0,-52.0,-51.0,-44.0,-43.0,-86.0,-85.0,-83.0,-82.0,29.0,23.0,34.0,38.0,1
2526,92:69:1D:31:68:E9,3837839,487157158,3872,3607438,3833967,483549720,0,4651,1083442,4513,1052247,138,31195,2084,10,4064,84,0,41,216660.0,130000.0,-51.0,-47.0,-42.0,-48.0,-51.0,-47.0,-43.0,-47.0,-86.0,-85.0,-83.0,-82.0,35.0,38.0,41.0,34.0,1
2527,CC:2F:71:3F:1F:24,4555773,1246144871,721806,762595151,3833967,483549720,37,574798,581599554,574090,581514342,708,85212,555112,15,722062,83468,34,481,144444.0,43333.0,-72.0,-67.0,-70.0,-74.0,-72.0,-67.0,-69.0,-73.0,-86.0,-85.0,-83.0,-82.0,14.0,18.0,13.0,8.0,1
2528,CC:2F:71:3E:C5:1F,3834824,483654466,857,104746,3833967,483549720,0,3579,300578,2953,226266,626,74312,907,8,1232,19,0,37,130000.0,39000.0,-71.0,-70.0,-67.0,-60.0,-70.0,-70.0,-66.0,-60.0,-86.0,-85.0,-83.0,-82.0,15.0,15.0,16.0,22.0,1
2529,BA:8C:B9:54:50:24,3838786,489730629,4819,6180909,3833967,483549720,0,8890,1692153,8868,1688658,22,3495,2345,15,5247,39,0,56,216660.0,130000.0,-40.0,-37.0,-46.0,-52.0,-40.0,-37.0,-46.0,-51.0,-86.0,-85.0,-83.0,-82.0,46.0,48.0,37.0,30.0,1
2530,3C:55:76:E8:8F:1F,3834439,484128467,459,577421,3833980,483551046,0,1070,208121,910,178979,160,29142,611,10,470,39,0,41,162500.0,1000.0,-49.0,-54.0,-47.0,-41.0,-48.0,-53.0,-46.0,-41.0,-86.0,-85.0,-83.0,-82.0,37.0,31.0,36.0,41.0,1
2531,92:69:1D:31:68:E9,3837852,487158484,3872,3607438,3833980,483551046,0,4651,1083442,4513,1052247,138,31195,2084,10,4064,84,0,41,216660.0,130000.0,-51.0,-47.0,-42.0,-48.0,-51.0,-47.0,-43.0,-47.0,-86.0,-85.0,-83.0,-82.0,35.0,38.0,41.0,34.0,1
2532,CC:2F:71:3F:1F:24,4555916,1246279656,721936,762728610,3833980,483551046,37,574906,581716840,574198,581631628,708,85212,555218,15,722192,83475,34,481,144444.0,43333.0,-72.0,-67.0,-70.0,-73.0,-72.0,-66.0,-70.0,-73.0,-86.0,-85.0,-83.0,-82.0,14.0,18.0,13.0,9.0,1
2533,CC:2F:71:3E:C5:1F,3834843,483656320,857,104746,3833986,483551574,0,3579,300578,2953,226266,626,74312,907,8,1232,19,0,37,130000.0,39000.0,-71.0,-70.0,-67.0,-60.0,-70.0,-70.0,-66.0,-60.0,-86.0,-85.0,-83.0,-82.0,15.0,15.0,16.0,22.0,1
2534,BA:8C:B9:54:50:24,3838806,489732543,4819,6180909,3833987,483551634,0,8890,1692153,8868,1688658,22,3495,2345,15,5247,39,0,56,216660.0,130000.0,-40.0,-37.0,-46.0,-52.0,-40.0,-37.0,-46.0,-51.0,-86.0,-85.0,-83.0,-82.0,46.0,48.0,37.0,30.0,1
2535,3C:55:76:E8:8F:1F,3834456,484130180,459,577421,3833997,483552759,0,1094,210968,931,181211,163,29757,617,10,470,39,0,42,162500.0,1000.0,-50.0,-51.0,-44.0,-42.0,-50.0,-51.0,-44.0,-41.0,-86.0,-85.0,-83.0,-82.0,36.0,34.0,39.0,40.0,1
2536,92:69:1D:31:68:E9,3837869,487160197,3872,3607438,3833997,483552759,0,4651,1083442,4513,1052247,138,31195,2084,10,4064,84,0,41,216660.0,130000.0,-51.0,-47.0,-42.0,-48.0,-51.0,-47.0,-43.0,-47.0,-86.0,-85.0,-83.0,-82.0,35.0,38.0,41.0,34.0,1
2537,CC:2F:71:3F:1F:24,4556054,1246412491,722057,762859732,3833997,483552759,37,575008,581838554,574300,581753342,708,85212,555317,15,722313,83479,34,481,144444.0,43333.0,-72.0,-67.0,-70.0,-73.0,-72.0,-67.0,-69.0,-73.0,-86.0,-85.0,-83.0,-82.0,14.0,18.0,13.0,9.0,1
2538,CC:2F:71:3E:C5:1F,3834856,483657705,857,104746,3833999,483552959,0,3579,300578,2953,226266,626,74312,907,8,1232,19,0,37,130000.0,39000.0,-71.0,-70.0,-67.0,-60.0,-70.0,-70.0,-66.0,-60.0,-86.0,-85.0,-83.0,-82.0,15.0,15.0,16.0,22.0,1
2539,BA:8C:B9:54:50:24,3838818,489733868,4819,6180909,3833999,483552959,0,8890,1692153,8868,1688658,22,3495,2345,15,5247,39,0,56,216660.0,130000.0,-40.0,-37.0,-46.0,-52.0,-40.0,-37.0,-46.0,-51.0,-86.0,-85.0,-83.0,-82.0,46.0,48.0,37.0,30.0,1
2540,3C:55:76:E8:8F:1F,3834463,484130902,459,577421,3834004,483553481,0,1119,212954,953,182711,166,30243,620,10,470,39,0,42,162500.0,1000.0,-49.0,-54.0,-48.0,-41.0,-48.0,-53.0,-47.0,-41.0,-86.0,-85.0,-83.0,-82.0,37.0,31.0,35.0,41.0,1
2541,92:69:1D:31:68:E9,3837876,487160919,3872,3607438,3834004,483553481,0,4651,1083442,4513,1052247,138,31195,2084,10,4064,84,0,41,216660.0,130000.0,-51.0,-47.0,-42.0,-48.0,-51.0,-47.0,-43.0,-47.0,-86.0,-85.0,-83.0,-82.0,35.0,38.0,41.0,34.0,1
2542,CC:2F:71:3F:1F:24,4556181,1246542689,722175,762989008,3834006,483553681,37,575109,581960308,574401,581875096,708,85212,555413,15,722431,83482,34,481,144444.0,43333.0,-72.0,-67.0,-70.0,-73.0,-72.0,-66.0,-69.0,-73.0,-86.0,-85.0,-83.0,-82.0,14.0,18.0,13.0,9.0,1
2543,CC:2F:71:3E:C5:1F,3834863,483658427,857,104746,3834006,483553681,0,3579,300578,2953,226266,626,74312,907,8,1232,19,0,37,130000.0,39000.0,-71.0,-70.0,-67.0,-60.0,-70.0,-70.0,-66.0,-60.0,-86.0,-85.0,-83.0,-82.0,15.0,15.0,16.0,22.0,1
2544,BA:8C:B9:54:50:24,3838827,489734792,4819,6180909,3834008,483553883,0,8890,1692153,8868,1688658,22,3495,2345,15,5247,39,0,56,216660.0,130000.0,-40.0,-37.0,-46.0,-52.0,-40.0,-37.0,-46.0,-51.0,-86.0,-85.0,-83.0,-82.0,46.0,48.0,37.0,30.0,1
2545,3C:55:76:E8:8F:1F,3834472,484132166,460,577903,3834012,483554263,0,1137,214518,968,183789,169,30729,624,10,471,39,0,43,172050.0,48750.0,-50.0,-52.0,-44.0,-42.0,-52.0,-49.0,-41.0,-41.0,-86.0,-85.0,-83.0,-82.0,36.0,33.0,39.0,40.0,1
2546,92:69:1D:31:68:E9,3837884,487161701,3872,3607438,3834012,483554263,0,4651,1083442,4513,1052247,138,31195,2084,10,4064,84,0,41,216660.0,130000.0,-51.0,-47.0,-42.0,-48.0,-51.0,-47.0,-43.0,-47.0,-86.0,-85.0,-83.0,-82.0,35.0,38.0,41.0,34.0,1
2547,CC:2F:71:3F:1F:24,4556309,1246674651,722297,763120388,3834012,483554263,37,575212,582080774,574504,581995562,708,85212,555513,15,722553,83484,34,481,144444.0,43333.0,-72.0,-67.0,-70.0,-74.0,-72.0,-67.0,-70.0,-74.0,-86.0,-85.0,-83.0,-82.0,14.0,18.0,13.0,8.0,1
2548,CC:2F:71:3E:C5:1F,3834869,483659009,857,104746,3834012,483554263,0,3579,300578,2953,226266,626,74312,907,8,1232,19,0,37,130000.0,39000.0,-71.0,-70.0,-67.0,-60.0,-70.0,-70.0,-66.0,-60.0,-86.0,-85.0,-83.0,-82.0,15.0,15.0,16.0,22.0,1
2549,BA:8C:B9:54:50:24,3838833,489735374,4819,6180909,3834014,483554465,0,8890,1692153,8868,1688658,22,3495,2345,15,5247,39,0,56,216660.0,130000.0,-40.0,-37.0,-46.0,-52.0,-40.0,-37.0,-46.0,-51.0,-86.0,-85.0,-83.0,-82.0,46.0,48.0,37.0,30.0,1
2550,3C:55:76:E8:8F:1F,3834487,484142778,469,587931,3834018,483554847,0,1161,219157,991,188254,170,30903,631,10,480,39,0,44,172050.0,48750.0,-54.0,-50.0,-43.0,-44.0,-53.0,-52.0,-44.0,-44.0,-86.0,-85.0,-83.0,-82.0,32.0,35.0,40.0,38.0,1
2551,92:69:1D:31:68:E9,3837891,487162401,3873,3607554,3834018,483554847,0,4653,1083578,4515,1052383,138,31195,2084,10,4065,84,0,41,216660.0,130000.0,-51.0,-47.0,-43.0,-48.0,-51.0,-47.0,-42.0,-47.0,-86.0,-85.0,-83.0,-82.0,35.0,38.0,40.0,34.0,1
2552,CC:2F:71:3F:1F:24,4556442,1246806820,722424,763251973,3834018,483554847,37,575321,582201083,574612,582115753,709,85330,555616,15,722680,83489,34,481,144444.0,43333.0,-72.0,-67.0,-70.0,-74.0,-72.0,-67.0,-70.0,-74.0,-86.0,-85.0,-83.0,-82.0,14.0,18.0,13.0,8.0,1
2553,CC:2F:71:3E:C5:1F,3834878,483659911,858,104862,3834020,483555049,0,3581,300718,2955,226406,626,74312,907,8,1233,19,0,37,144444.0,39000.0,-71.0,-71.0,-67.0,-60.0,-72.0,-72.0,-67.0,-61.0,-86.0,-85.0,-83.0,-82.0,15.0,14.0,16.0,22.0,1
2554,BA:8C:B9:54:50:24,3838840,489736074,4820,6181025,3834020,483555049,0,8892,1692289,8870,1688794,22,3495,2345,15,5248,39,0,56,229410.0,130000.0,-49.0,-35.0,-43.0,-45.0,-41.0,-36.0,-45.0,-50.0,-86.0,-85.0,-83.0,-82.0,37.0,50.0,40.0,37.0,1
2555,3C:55:76:E8:8F:1F,3834493,484143564,469,587931,3834024,483555633,0,1173,220339,1001,188942,172,31397,633,10,480,39,0,45,172050.0,48750.0,-57.0,-62.0,-49.0,-45.0,-53.0,-51.0,-44.0,-43.0,-86.0,-85.0,-83.0,-82.0,29.0,23.0,34.0,37.0,1
2556,92:69:1D:31:68:E9,3837897,487163187,3873,3607554,3834024,483555633,0,4653,1083578,4515,1052383,138,31195,2084,10,4065,84,0,41,216660.0,130000.0,-51.0,-47.0,-43.0,-48.0,-51.0,-47.0,-42.0,-47.0,-86.0,-85.0,-83.0,-82.0,35.0,38.0,40.0,34.0,1
2557,CC:2F:71:3F:1F:24,4556567,1246937028,722543,763381395,3834024,483555633,37,575423,582324249,574714,582238919,709,85330,555713,15,722799,83490,34,481,144444.0,43333.0,-72.0,-67.0,-70.0,-74.0,-71.0,-67.0,-70.0,-73.0,-86.0,-85.0,-83.0,-82.0,14.0,18.0,13.0,8.0,1
2558,CC:2F:71:3E:C5:1F,3834884,483660697,858,104862,3834026,483555835,0,3581,300718,2955,226406,626,74312,907,8,1233,19,0,37,144444.0,39000.0,-71.0,-71.0,-67.0,-60.0,-72.0,-72.0,-67.0,-61.0,-86.0,-85.0,-83.0,-82.0,15.0,14.0,16.0,22.0,1
2559,BA:8C:B9:54:50:24,3838846,489736860,4820,6181025,3834026,483555835,0,8892,1692289,8870,1688794,22,3495,2345,15,5248,39,0,56,229410.0,130000.0,-49.0,-35.0,-43.0,-45.0,-41.0,-36.0,-45.0,-50.0,-86.0,-85.0,-83.0,-82.0,37.0,50.0,40.0,37.0,1
2560,3C:55:76:E8:8F:1F,3834501,484144481,469,587931,3834032,483556550,0,1183,221179,1009,189490,174,31689,635,10,480,39,0,45,172050.0,48750.0,-55.0,-50.0,-44.0,-45.0,-52.0,-49.0,-42.0,-42.0,-86.0,-85.0,-83.0,-82.0,31.0,35.0,39.0,37.0,1
2561,92:69:1D:31:68:E9,3837905,487164104,3873,3607554,3834032,483556550,0,4653,1083578,4515,1052383,138,31195,2084,10,4065,84,0,41,216660.0,130000.0,-51.0,-47.0,-43.0,-48.0,-51.0,-47.0,-42.0,-47.0,-86.0,-85.0,-83.0,-82.0,35.0,38.0,40.0,34.0,1
2562,CC:2F:71:3F:1F:24,4556695,1247067439,722661,763510687,3834034,483556752,37,575524,582441829,574815,582356499,709,85330,555810,15,722917,83495,34,481,144444.0,43333.0,-71.0,-67.0,-68.0,-71.0,-70.0,-66.0,-68.0,-71.0,-86.0,-85.0,-83.0,-82.0,15.0,18.0,15.0,11.0,1
2563,CC:2F:71:3E:C5:1F,3834892,483661614,858,104862,3834034,483556752,0,3581,300718,2955,226406,626,74312,907,8,1233,19,0,37,144444.0,39000.0,-71.0,-71.0,-67.0,-60.0,-72.0,-72.0,-67.0,-61.0,-86.0,-85.0,-83.0,-82.0,15.0,14.0,16.0,22.0,1
2564,BA:8C:B9:54:50:24,3838854,489737777,4820,6181025,3834034,483556752,0,8892,1692289,8870,1688794,22,3495,2345,15,5248,39,0,56,229410.0,130000.0,-49.0,-35.0,-43.0,-45.0,-41.0,-36.0,-45.0,-50.0,-86.0,-85.0,-83.0,-82.0,37.0,50.0,40.0,37.0,1
2565,3C:55:76:E8:8F:1F,3834507,484145127,470,588055,3834037,483557072,0,1193,222005,1018,190142,175,31863,637,10,481,39,0,45,172050.0,48750.0,-45.0,-61.0,-48.0,-41.0,-42.0,-57.0,-46.0,-39.0,-87.0,-85.0,-83.0,-83.0,42.0,24.0,35.0,42.0,1
2566,92:69:1D:31:68:E9,3837913,487164890,3873,3607554,3834040,483557336,0,4653,1083578,4515,1052383,138,31195,2084,10,4065,84,0,41,216660.0,130000.0,-51.0,-47.0,-43.0,-48.0,-51.0,-47.0,-42.0,-47.0,-87.0,-85.0,-83.0,-83.0,36.0,38.0,40.0,35.0,1
2567,CC:2F:71:3F:1F:24,4556825,1247199519,722785,763642183,3834040,483557336,37,575636,582564975,574927,582479645,709,85330,555915,15,723041,83510,34,481,144444.0,43333.0,-72.0,-66.0,-72.0,-71.0,-72.0,-65.0,-72.0,-71.0,-87.0,-85.0,-83.0,-83.0,15.0,19.0,11.0,12.0,1
2568,CC:2F:71:3E:C5:1F,3834898,483662198,858,104862,3834040,483557336,0,3581,300718,2955,226406,626,74312,907,8,1233,19,0,37,144444.0,39000.0,-71.0,-71.0,-67.0,-60.0,-72.0,-72.0,-67.0,-61.0,-87.0,-85.0,-83.0,-83.0,16.0,14.0,16.0,23.0,1
2569,BA:8C:B9:54:50:24,3838860,489738361,4820,6181025,3834040,483557336,0,8892,1692289,8870,1688794,22,3495,2345,15,5248,39,0,56,229410.0,130000.0,-49.0,-35.0,-43.0,-45.0,-41.0,-36.0,-45.0,-50.0,-87.0,-85.0,-83.0,-83.0,38.0,50.0,40.0,38.0,1
2570,3C:55:76:E8:8F:1F,3834515,484145944,471,588228,3834044,483557716,0,1207,223173,1030,191018,177,32155,640,10,482,39,0,46,172050.0,48750.0,-45.0,-53.0,-48.0,-40.0,-45.0,-52.0,-49.0,-40.0,-87.0,-85.0,-83.0,-83.0,42.0,32.0,35.0,43.0,1
2571,92:69:1D:31:68:E9,3837917,487165270,3873,3607554,3834044,483557716,0,4653,1083578,4515,1052383,138,31195,2084,10,4065,84,0,41,216660.0,130000.0,-51.0,-47.0,-43.0,-48.0,-51.0,-47.0,-42.0,-47.0,-87.0,-85.0,-83.0,-83.0,36.0,38.0,40.0,35.0,1
2572,CC:2F:71:3F:1F:24,4556956,1247332696,722910,763774778,3834046,483557918,37,575748,582691386,575039,582606056,709,85330,556019,15,723165,83549,34,481,130000.0,43333.0,-71.0,-66.0,-69.0,-71.0,-71.0,-66.0,-69.0,-71.0,-87.0,-85.0,-83.0,-83.0,16.0,19.0,14.0,12.0,1
2573,CC:2F:71:3E:C5:1F,3834904,483662780,858,104862,3834046,483557918,0,3581,300718,2955,226406,626,74312,907,8,1233,19,0,37,144444.0,39000.0,-71.0,-71.0,-67.0,-60.0,-72.0,-72.0,-67.0,-61.0,-87.0,-85.0,-83.0,-83.0,16.0,14.0,16.0,23.0,1
2574,BA:8C:B9:54:50:24,3838868,489739145,4820,6181025,3834048,483558120,0,8892,1692289,8870,1688794,22,3495,2345,15,5248,39,0,56,229410.0,130000.0,-49.0,-35.0,-43.0,-45.0,-41.0,-36.0,-45.0,-50.0,-87.0,-85.0,-83.0,-83.0,38.0,50.0,40.0,38.0,1
2575,3C:55:76:E8:8F:1F,3834524,484146891,472,588389,3834052,483558502,0,1231,225096,1052,192649,179,32447,644,10,483,39,0,47,172050.0,48750.0,-45.0,-54.0,-53.0,-41.0,-44.0,-48.0,-49.0,-39.0,-87.0,-85.0,-83.0,-83.0,42.0,31.0,30.0,42.0,1
2576,92:69:1D:31:68:E9,3837925,487166056,3873,3607554,3834052,483558502,0,4653,1083578,4515,1052383,138,31195,2084,10,4065,84,0,41,216660.0,130000.0,-51.0,-47.0,-43.0,-48.0,-51.0,-47.0,-42.0,-47.0,-87.0,-85.0,-83.0,-83.0,36.0,38.0,40.0,35.0,1
2577,CC:2F:71:3F:1F:24,4557081,1247462630,723029,763904128,3834052,483558502,37,575855,582813944,575146,582728614,709,85330,556119,15,723285,83551,34,481,130000.0,39000.0,-71.0,-67.0,-71.0,-71.0,-71.0,-67.0,-71.0,-71.0,-87.0,-85.0,-83.0,-83.0,16.0,18.0,12.0,12.0,1
2578,CC:2F:71:3E:C5:1F,3834910,483663364,858,104862,3834052,483558502,0,3581,300718,2955,226406,626,74312,907,8,1233,19,0,37,144444.0,39000.0,-71.0,-71.0,-67.0,-60.0,-72.0,-72.0,-67.0,-61.0,-87.0,-85.0,-83.0,-83.0,16.0,14.0,16.0,23.0,1
2579,BA:8C:B9:54:50:24,3838872,489739527,4820,6181025,3834052,483558502,0,8892,1692289,8870,1688794,22,3495,2345,15,5248,39,0,56,229410.0,130000.0,-49.0,-35.0,-43.0,-45.0,-41.0,-36.0,-45.0,-50.0,-87.0,-85.0,-83.0,-83.0,38.0,50.0,40.0,38.0,1
2580,3C:55:76:E8:8F:1F,3834539,484160025,482,600601,3834057,483559424,0,1262,233083,1082,200320,180,32763,654,10,493,39,0,47,172050.0,48750.0,-47.0,-58.0,-46.0,-45.0,-48.0,-54.0,-45.0,-43.0,-87.0,-85.0,-83.0,-83.0,40.0,27.0,37.0,38.0,1
2581,92:69:1D:31:68:E9,3837930,487166978,3873,3607554,3834057,483559424,0,4653,1083578,4515,1052383,138,31195,2084,10,4065,84,0,41,216660.0,130000.0,-51.0,-47.0,-43.0,-48.0,-51.0,-47.0,-42.0,-47.0,-87.0,-85.0,-83.0,-83.0,36.0,38.0,40.0,35.0,1
2582,CC:2F:71:3F:1F:24,4557208,1247594338,723149,764034712,3834059,483559626,37,575958,582935898,575249,582850568,709,85330,556217,15,723405,83563,34,481,130000.0,43333.0,-69.0,-67.0,-70.0,-72.0,-69.0,-67.0,-70.0,-71.0,-87.0,-85.0,-83.0,-83.0,18.0,18.0,13.0,11.0,1
2583,CC:2F:71:3E:C5:1F,3834919,483664690,858,104862,3834061,483559828,0,3581,300718,2955,226406,626,74312,907,8,1233,19,0,37,144444.0,39000.0,-71.0,-71.0,-67.0,-60.0,-72.0,-72.0,-67.0,-61.0,-87.0,-85.0,-83.0,-83.0,16.0,14.0,16.0,23.0,1
2584,BA:8C:B9:54:50:24,3838882,489740913,4820,6181025,3834062,483559888,0,8892,1692289,8870,1688794,22,3495,2345,15,5248,39,0,56,229410.0,130000.0,-49.0,-35.0,-43.0,-45.0,-41.0,-36.0,-45.0,-50.0,-87.0,-85.0,-83.0,-83.0,38.0,50.0,40.0,38.0,1
2585,3C:55:76:E8:8F:1F,3834552,484162609,488,602519,3834064,483560090,0,1289,237968,1109,205205,180,32763,662,10,499,39,0,48,162500.0,48750.0,-44.0,-53.0,-47.0,-42.0,-45.0,-54.0,-46.0,-41.0,-87.0,-85.0,-83.0,-83.0,43.0,32.0,36.0,41.0,1
2586,92:69:1D:31:68:E9,3837937,487167644,3873,3607554,3834064,483560090,0,4653,1083578,4515,1052383,138,31195,2084,10,4065,84,0,41,216660.0,130000.0,-51.0,-47.0,-43.0,-48.0,-51.0,-47.0,-42.0,-47.0,-87.0,-85.0,-83.0,-83.0,36.0,38.0,40.0,35.0,1
2587,CC:2F:71:3F:1F:24,4557340,1247727825,723276,764167735,3834064,483560090,37,576068,583056170,575359,582970840,709,85330,556325,15,723532,83564,34,481,130000.0,43333.0,-69.0,-66.0,-70.0,-72.0,-68.0,-66.0,-70.0,-72.0,-87.0,-85.0,-83.0,-83.0,18.0,19.0,13.0,11.0,1
2588,CC:2F:71:3E:C5:1F,3834922,483664952,858,104862,3834064,483560090,0,3581,300718,2955,226406,626,74312,907,8,1233,19,0,37,144444.0,39000.0,-71.0,-71.0,-67.0,-60.0,-72.0,-72.0,-67.0,-61.0,-87.0,-85.0,-83.0,-83.0,16.0,14.0,16.0,23.0,1
2589,BA:8C:B9:54:50:24,3838884,489741115,4820,6181025,3834064,483560090,0,8892,1692289,8870,1688794,22,3495,2345,15,5248,39,0,56,229410.0,130000.0,-49.0,-35.0,-43.0,-45.0,-41.0,-36.0,-45.0,-50.0,-87.0,-85.0,-83.0,-83.0,38.0,50.0,40.0,38.0,1
2590,3C:55:76:E8:8F:1F,3834555,484162873,488,602519,3834067,483560354,0,1294,238310,1114,205547,180,32763,662,10,499,39,0,48,162500.0,48750.0,-43.0,-56.0,-47.0,-42.0,-44.0,-54.0,-47.0,-41.0,-87.0,-85.0,-83.0,-83.0,44.0,29.0,36.0,41.0,1
2591,92:69:1D:31:68:E9,3837944,487168312,3873,3607554,3834071,483560758,0,4655,1083714,4517,1052519,138,31195,2084,10,4066,84,0,41,216660.0,130000.0,-51.0,-48.0,-43.0,-47.0,-51.0,-47.0,-42.0,-47.0,-87.0,-85.0,-83.0,-83.0,36.0,37.0,40.0,36.0,1
2592,CC:2F:71:3F:1F:24,4557466,1247857747,723395,764296989,3834071,483560758,37,576168,583176228,575459,583090898,709,85330,556422,15,723651,83568,34,481,144444.0,43333.0,-69.0,-67.0,-69.0,-71.0,-68.0,-66.0,-69.0,-71.0,-87.0,-85.0,-83.0,-83.0,18.0,18.0,14.0,12.0,1
2593,CC:2F:71:3E:C5:1F,3834929,483665620,858,104862,3834071,483560758,0,3584,300976,2957,226546,627,74430,908,8,1234,19,0,37,144444.0,39000.0,-70.0,-72.0,-65.0,-60.0,-71.0,-72.0,-67.0,-61.0,-87.0,-85.0,-83.0,-83.0,17.0,13.0,18.0,23.0,1
2594,BA:8C:B9:54:50:24,3838891,489741783,4820,6181025,3834071,483560758,0,8894,1692425,8872,1688930,22,3495,2345,15,5249,39,0,56,229410.0,130000.0,-40.0,-37.0,-46.0,-51.0,-41.0,-36.0,-45.0,-50.0,-87.0,-85.0,-83.0,-83.0,47.0,48.0,37.0,32.0,1
2595,3C:55:76:E8:8F:1F,3834563,484163698,488,602519,3834075,483561179,0,1305,239209,1124,206231,181,32978,663,10,499,39,0,48,162500.0,48750.0,-46.0,-48.0,-45.0,-44.0,-46.0,-46.0,-42.0,-41.0,-87.0,-85.0,-83.0,-83.0,41.0,37.0,38.0,39.0,1
2596,92:69:1D:31:68:E9,3837948,487168733,3873,3607554,3834075,483561179,0,4656,1083782,4518,1052587,138,31195,2084,10,4066,84,0,41,216660.0,130000.0,-51.0,-48.0,-44.0,-49.0,-51.0,-47.0,-43.0,-47.0,-87.0,-85.0,-83.0,-83.0,36.0,37.0,39.0,34.0,1
2597,CC:2F:71:3F:1F:24,4557590,1247989144,723515,764427965,3834075,483561179,37,576270,583299380,575561,583214050,709,85330,556520,15,723771,83568,34,481,144444.0,43333.0,-69.0,-66.0,-74.0,-69.0,-69.0,-66.0,-73.0,-68.0,-87.0,-85.0,-83.0,-83.0,18.0,19.0,9.0,14.0,1
2598,CC:2F:71:3E:C5:1F,3834933,483666041,858,104862,3834075,483561179,0,3584,300976,2957,226546,627,74430,908,8,1234,19,0,37,144444.0,39000.0,-70.0,-72.0,-65.0,-60.0,-71.0,-72.0,-67.0,-61.0,-87.0,-85.0,-83.0,-83.0,17.0,13.0,18.0,23.0,1
2599,BA:8C:B9:54:50:24,3838897,489742406,4820,6181025,3834077,483561381,0,8894,1692425,8872,1688930,22,3495,2345,15,5249,39,0,56,229410.0,130000.0,-40.0,-37.0,-46.0,-51.0,-41.0,-36.0,-45.0,-50.0,-87.0,-85.0,-83.0,-83.0,47.0,48.0,37.0,32.0,1
2600,3C:55:76:E8:8F:1F,3834569,484164304,488,602519,3834081,483561785,0,1305,239209,1124,206231,181,32978,663,10,499,39,0,48,162500.0,48750.0,-46.0,-48.0,-45.0,-44.0,-46.0,-46.0,-42.0,-41.0,-87.0,-85.0,-83.0,-83.0,41.0,37.0,38.0,39.0,1
2601,92:69:1D:31:68:E9,3837954,487169339,3873,3607554,3834081,483561785,0,4659,1083986,4521,1052791,138,31195,2084,10,4066,84,0,41,216660.0,130000.0,-52.0,-47.0,-43.0,-49.0,-51.0,-47.0,-42.0,-48.0,-87.0,-85.0,-83.0,-83.0,35.0,38.0,40.0,34.0,1
2602,CC:2F:71:3F:1F:24,4557715,1248120372,723634,764558587,3834081,483561785,37,576374,583424374,575665,583339044,709,85330,556617,15,723890,83578,34,481,144444.0,43333.0,-70.0,-65.0,-68.0,-70.0,-70.0,-65.0,-68.0,-69.0,-87.0,-85.0,-83.0,-83.0,17.0,20.0,15.0,13.0,1
2603,CC:2F:71:3E:C5:1F,3834939,483666647,858,104862,3834081,483561785,0,3584,300976,2957,226546,627,74430,908,8,1234,19,0,37,144444.0,39000.0,-70.0,-72.0,-65.0,-60.0,-71.0,-72.0,-67.0,-61.0,-87.0,-85.0,-83.0,-83.0,17.0,13.0,18.0,23.0,1
2604,BA:8C:B9:54:50:24,3838901,489742810,4820,6181025,3834081,483561785,0,8894,1692425,8872,1688930,22,3495,2345,15,5249,39,0,56,229410.0,130000.0,-40.0,-37.0,-46.0,-51.0,-41.0,-36.0,-45.0,-50.0,-87.0,-85.0,-83.0,-83.0,47.0,48.0,37.0,32.0,1
2605,3C:55:76:E8:8F:1F,3834571,484164506,488,602519,3834083,483561987,0,1305,239209,1124,206231,181,32978,663,10,499,39,0,48,162500.0,48750.0,-46.0,-48.0,-45.0,-44.0,-46.0,-46.0,-42.0,-41.0,-87.0,-85.0,-83.0,-83.0,41.0,37.0,38.0,39.0,1
2606,92:69:1D:31:68:E9,3837956,487169541,3873,3607554,3834083,483561987,0,4660,1084054,4522,1052859,138,31195,2084,10,4066,84,0,41,216660.0,130000.0,-52.0,-47.0,-43.0,-49.0,-51.0,-47.0,-42.0,-48.0,-87.0,-85.0,-83.0,-83.0,35.0,38.0,40.0,34.0,1
2607,CC:2F:71:3F:1F:24,4557844,1248255023,723761,764693036,3834083,483561987,37,576489,583552695,575780,583467365,709,85330,556721,15,724016,83579,34,481,144444.0,43333.0,-68.0,-66.0,-68.0,-69.0,-68.0,-66.0,-68.0,-69.0,-87.0,-85.0,-83.0,-83.0,19.0,19.0,15.0,14.0,1
2608,CC:2F:71:3E:C5:1F,3834943,483667051,858,104862,3834085,483562189,0,3584,300976,2957,226546,627,74430,908,8,1234,19,0,37,144444.0,39000.0,-70.0,-72.0,-65.0,-60.0,-71.0,-72.0,-67.0,-61.0,-87.0,-85.0,-83.0,-83.0,17.0,13.0,18.0,23.0,1
2609,BA:8C:B9:54:50:24,3838905,489743214,4820,6181025,3834085,483562189,0,8894,1692425,8872,1688930,22,3495,2345,15,5249,39,0,56,229410.0,130000.0,-40.0,-37.0,-46.0,-51.0,-41.0,-36.0,-45.0,-50.0,-87.0,-85.0,-83.0,-83.0,47.0,48.0,37.0,32.0,1
2610,3C:55:76:E8:8F:1F,3834578,484165172,488,602519,3834090,483562653,0,1305,239209,1124,206231,181,32978,663,10,499,39,0,48,162500.0,48750.0,-46.0,-48.0,-45.0,-44.0,-46.0,-46.0,-42.0,-41.0,-87.0,-85.0,-83.0,-83.0,41.0,37.0,38.0,39.0,1
2611,92:69:1D:31:68:E9,3837975,487175806,3873,3607554,3834102,483568252,0,4663,1084425,4524,1052995,139,31430,2085,10,4066,84,0,41,216660.0,130000.0,-53.0,-50.0,-46.0,-51.0,-52.0,-47.0,-43.0,-49.0,-87.0,-85.0,-83.0,-83.0,34.0,35.0,37.0,32.0,1
2612,CC:2F:71:3F:1F:24,4557983,1248392280,723881,764824028,3834102,483568252,37,576591,583675833,575882,583590503,709,85330,556820,15,724137,83581,34,481,144444.0,43333.0,-69.0,-66.0,-69.0,-70.0,-69.0,-66.0,-69.0,-70.0,-87.0,-85.0,-83.0,-83.0,18.0,19.0,14.0,13.0,1
2613,CC:2F:71:3E:C5:1F,3834960,483673114,858,104862,3834102,483568252,0,3584,300976,2957,226546,627,74430,908,8,1234,19,0,37,144444.0,39000.0,-70.0,-72.0,-65.0,-60.0,-71.0,-72.0,-67.0,-61.0,-87.0,-85.0,-83.0,-83.0,17.0,13.0,18.0,23.0,1
2614,BA:8C:B9:54:50:24,3838922,489749277,4820,6181025,3834102,483568252,0,8894,1692425,8872,1688930,22,3495,2345,15,5249,39,0,56,229410.0,130000.0,-40.0,-37.0,-46.0,-51.0,-41.0,-36.0,-45.0,-50.0,-87.0,-85.0,-83.0,-83.0,47.0,48.0,37.0,32.0,1
2615,3C:55:76:E8:8F:1F,3834606,484176922,491,603044,3834115,483573878,0,1312,241057,1131,208079,181,32978,666,10,502,39,0,48,162500.0,48750.0,-47.0,-48.0,-44.0,-45.0,-46.0,-48.0,-44.0,-43.0,-87.0,-85.0,-83.0,-83.0,40.0,37.0,39.0,38.0,1
2616,92:69:1D:31:68:E9,3837990,487181634,3873,3607554,3834117,483574080,0,4664,1084493,4525,1053063,139,31430,2085,10,4066,84,0,41,216660.0,130000.0,-52.0,-49.0,-45.0,-51.0,-52.0,-47.0,-43.0,-49.0,-87.0,-85.0,-83.0,-83.0,35.0,36.0,38.0,32.0,1
2617,CC:2F:71:3F:1F:24,4558120,1248533616,724003,764959536,3834117,483574080,37,576697,583802495,575988,583717165,709,85330,556922,15,724259,83581,34,481,144444.0,43333.0,-69.0,-65.0,-69.0,-70.0,-69.0,-65.0,-69.0,-69.0,-87.0,-85.0,-83.0,-83.0,18.0,20.0,14.0,13.0,1
2618,CC:2F:71:3E:C5:1F,3834975,483678942,858,104862,3834117,483574080,0,3584,300976,2957,226546,627,74430,908,8,1234,19,0,37,144444.0,39000.0,-70.0,-72.0,-65.0,-60.0,-71.0,-72.0,-67.0,-61.0,-87.0,-85.0,-83.0,-83.0,17.0,13.0,18.0,23.0,1
2619,BA:8C:B9:54:50:24,3838937,489755105,4820,6181025,3834117,483574080,0,8894,1692425,8872,1688930,22,3495,2345,15,5249,39,0,56,229410.0,130000.0,-40.0,-37.0,-46.0,-51.0,-41.0,-36.0,-45.0,-50.0,-87.0,-85.0,-83.0,-83.0,47.0,48.0,37.0,32.0,1
2620,3C:55:76:E8:8F:1F,3834614,484177861,491,603044,3834123,483574817,0,1319,241535,1138,208557,181,32978,666,10,502,39,0,48,162500.0,48750.0,-47.0,-48.0,-45.0,-45.0,-47.0,-47.0,-44.0,-44.0,-87.0,-85.0,-83.0,-83.0,40.0,37.0,38.0,38.0,1
2621,92:69:1D:31:68:E9,3837996,487182371,3873,3607554,3834123,483574817,0,4664,1084493,4525,1053063,139,31430,2085,10,4066,84,0,41,216660.0,130000.0,-52.0,-49.0,-45.0,-51.0,-52.0,-47.0,-43.0,-49.0,-87.0,-85.0,-83.0,-83.0,35.0,36.0,38.0,32.0,1
2622,CC:2F:71:3F:1F:24,4558245,1248665199,724122,765090382,3834123,483574817,37,576800,583924449,576091,583839119,709,85330,557020,15,724377,83582,34,481,144444.0,43333.0,-70.0,-66.0,-69.0,-70.0,-70.0,-66.0,-69.0,-70.0,-87.0,-85.0,-83.0,-83.0,17.0,19.0,14.0,13.0,1
2623,CC:2F:71:3E:C5:1F,3834981,483679679,858,104862,3834123,483574817,0,3584,300976,2957,226546,627,74430,908,8,1234,19,0,37,144444.0,39000.0,-70.0,-72.0,-65.0,-60.0,-71.0,-72.0,-67.0,-61.0,-87.0,-85.0,-83.0,-83.0,17.0,13.0,18.0,23.0,1
2624,BA:8C:B9:54:50:24,3838943,489755842,4820,6181025,3834123,483574817,0,8894,1692425,8872,1688930,22,3495,2345,15,5249,39,0,56,229410.0,130000.0,-40.0,-37.0,-46.0,-51.0,-41.0,-36.0,-45.0,-50.0,-87.0,-85.0,-83.0,-83.0,47.0,48.0,37.0,32.0,1
2625,3C:55:76:E8:8F:1F,3834618,484178265,491,603044,3834127,483575221,0,1319,241535,1138,208557,181,32978,666,10,502,39,0,48,162500.0,48750.0,-47.0,-48.0,-45.0,-45.0,-47.0,-47.0,-44.0,-44.0,-87.0,-85.0,-83.0,-83.0,40.0,37.0,38.0,38.0,1
2626,92:69:1D:31:68:E9,3838000,487182775,3873,3607554,3834127,483575221,0,4664,1084493,4525,1053063,139,31430,2085,10,4066,84,0,41,216660.0,130000.0,-52.0,-49.0,-45.0,-51.0,-52.0,-47.0,-43.0,-49.0,-87.0,-85.0,-83.0,-83.0,35.0,36.0,38.0,32.0,1
2627,CC:2F:71:3F:1F:24,4558377,1248800180,724250,765224959,3834127,483575221,37,576908,584043060,576199,583957730,709,85330,557127,15,724506,83584,34,481,144444.0,43333.0,-68.0,-67.0,-71.0,-70.0,-68.0,-67.0,-71.0,-69.0,-87.0,-85.0,-83.0,-83.0,19.0,18.0,12.0,13.0,1
2628,CC:2F:71:3E:C5:1F,3834985,483680083,858,104862,3834127,483575221,0,3584,300976,2957,226546,627,74430,908,8,1234,19,0,37,144444.0,39000.0,-70.0,-72.0,-65.0,-60.0,-71.0,-72.0,-67.0,-61.0,-87.0,-85.0,-83.0,-83.0,17.0,13.0,18.0,23.0,1
2629,BA:8C:B9:54:50:24,3838947,489756246,4820,6181025,3834127,483575221,0,8894,1692425,8872,1688930,22,3495,2345,15,5249,39,0,56,229410.0,130000.0,-40.0,-37.0,-46.0,-51.0,-41.0,-36.0,-45.0,-50.0,-87.0,-85.0,-83.0,-83.0,47.0,48.0,37.0,32.0,1
2630,3C:55:76:E8:8F:1F,3834622,484178669,491,603044,3834131,483575625,0,1319,241535,1138,208557,181,32978,666,10,502,39,0,48,162500.0,48750.0,-47.0,-48.0,-45.0,-45.0,-47.0,-47.0,-44.0,-44.0,-87.0,-85.0,-83.0,-83.0,40.0,37.0,38.0,38.0,1
2631,92:69:1D:31:68:E9,3838004,487183179,3873,3607554,3834131,483575625,0,4664,1084493,4525,1053063,139,31430,2085,10,4066,84,0,41,216660.0,130000.0,-52.0,-49.0,-45.0,-51.0,-52.0,-47.0,-43.0,-49.0,-87.0,-85.0,-83.0,-83.0,35.0,36.0,38.0,32.0,1
2632,CC:2F:71:3F:1F:24,4558500,1248932854,724369,765357229,3834131,483575625,37,577013,584170922,576304,584085592,709,85330,557225,15,724625,83585,34,481,144444.0,43333.0,-70.0,-66.0,-69.0,-71.0,-70.0,-66.0,-69.0,-70.0,-87.0,-85.0,-83.0,-83.0,17.0,19.0,14.0,12.0,1
2633,CC:2F:71:3E:C5:1F,3834990,483680547,858,104862,3834132,483575685,0,3584,300976,2957,226546,627,74430,908,8,1234,19,0,37,144444.0,39000.0,-70.0,-72.0,-65.0,-60.0,-71.0,-72.0,-67.0,-61.0,-87.0,-85.0,-83.0,-83.0,17.0,13.0,18.0,23.0,1
2634,BA:8C:B9:54:50:24,3838952,489756710,4820,6181025,3834132,483575685,0,8894,1692425,8872,1688930,22,3495,2345,15,5249,39,0,56,229410.0,130000.0,-40.0,-37.0,-46.0,-51.0,-41.0,-36.0,-45.0,-50.0,-87.0,-85.0,-83.0,-83.0,47.0,48.0,37.0,32.0,1
2635,3C:55:76:E8:8F:1F,3834633,484182203,494,605495,3834139,483576708,0,1339,245481,1157,212196,182,33285,671,10,505,39,0,48,162500.0,48750.0,-47.0,-48.0,-45.0,-43.0,-46.0,-48.0,-43.0,-43.0,-87.0,-86.0,-83.0,-83.0,40.0,38.0,38.0,40.0,1
2636,92:69:1D:31:68:E9,3838012,487184262,3873,3607554,3834139,483576708,0,4664,1084493,4525,1053063,139,31430,2085,10,4066,84,0,41,216660.0,130000.0,-52.0,-49.0,-45.0,-51.0,-52.0,-47.0,-43.0,-49.0,-87.0,-86.0,-83.0,-83.0,35.0,37.0,38.0,32.0,1
2637,CC:2F:71:3F:1F:24,4558625,1249063099,724486,765486391,3834139,483576708,37,577119,584294752,576410,584209422,709,85330,557322,15,724742,83585,34,481,144444.0,43333.0,-70.0,-66.0,-70.0,-71.0,-70.0,-66.0,-69.0,-71.0,-87.0,-86.0,-83.0,-83.0,17.0,20.0,13.0,12.0,1
2638,CC:2F:71:3E:C5:1F,3834997,483681570,858,104862,3834139,483576708,0,3584,300976,2957,226546,627,74430,908,8,1234,19,0,37,144444.0,39000.0,-70.0,-72.0,-65.0,-60.0,-71.0,-72.0,-67.0,-61.0,-87.0,-86.0,-83.0,-83.0,17.0,14.0,18.0,23.0,1
2639,BA:8C:B9:54:50:24,3838959,489757733,4820,6181025,3834139,483576708,0,8894,1692425,8872,1688930,22,3495,2345,15,5249,39,0,56,229410.0,130000.0,-40.0,-37.0,-46.0,-51.0,-41.0,-36.0,-45.0,-50.0,-87.0,-86.0,-83.0,-83.0,47.0,49.0,37.0,32.0,1
2640,3C:55:76:E8:8F:1F,3834638,484182731,495,605619,3834143,483577112,0,1354,246635,1172,213350,182,33285,673,10,506,39,0,48,162500.0,48750.0,-46.0,-51.0,-44.0,-42.0,-45.0,-50.0,-43.0,-40.0,-87.0,-86.0,-83.0,-83.0,41.0,35.0,39.0,41.0,1
2641,92:69:1D:31:68:E9,3838016,487184666,3873,3607554,3834143,483577112,0,4664,1084493,4525,1053063,139,31430,2085,10,4066,84,0,41,216660.0,130000.0,-52.0,-49.0,-45.0,-51.0,-52.0,-47.0,-43.0,-49.0,-87.0,-86.0,-83.0,-83.0,35.0,37.0,38.0,32.0,1
2642,CC:2F:71:3F:1F:24,4558749,1249193055,724606,765615943,3834143,483577112,37,577223,584418212,576514,584332882,709,85330,557420,15,724862,83585,34,481,144444.0,43333.0,-71.0,-66.0,-68.0,-72.0,-70.0,-66.0,-68.0,-71.0,-87.0,-86.0,-83.0,-83.0,16.0,20.0,15.0,11.0,1
2643,CC:2F:71:3E:C5:1F,3835001,483681974,858,104862,3834143,483577112,0,3584,300976,2957,226546,627,74430,908,8,1234,19,0,37,144444.0,39000.0,-70.0,-72.0,-65.0,-60.0,-71.0,-72.0,-67.0,-61.0,-87.0,-86.0,-83.0,-83.0,17.0,14.0,18.0,23.0,1
2644,BA:8C:B9:54:50:24,3838963,489758137,4820,6181025,3834143,483577112,0,8894,1692425,8872,1688930,22,3495,2345,15,5249,39,0,56,229410.0,130000.0,-40.0,-37.0,-46.0,-51.0,-41.0,-36.0,-45.0,-50.0,-87.0,-86.0,-83.0,-83.0,47.0,49.0,37.0,32.0,1
2645,3C:55:76:E8:8F:1F,3834643,484183195,495,605619,3834148,483577576,0,1354,246635,1172,213350,182,33285,673,10,506,39,0,48,162500.0,48750.0,-46.0,-51.0,-44.0,-42.0,-45.0,-50.0,-43.0,-40.0,-87.0,-86.0,-83.0,-83.0,41.0,35.0,39.0,41.0,1
2646,92:69:1D:31:68:E9,3838021,487185130,3873,3607554,3834148,483577576,0,4664,1084493,4525,1053063,139,31430,2085,10,4066,84,0,41,216660.0,130000.0,-52.0,-49.0,-45.0,-51.0,-52.0,-47.0,-43.0,-49.0,-87.0,-86.0,-83.0,-83.0,35.0,37.0,38.0,32.0,1
2647,CC:2F:71:3F:1F:24,4558881,1249326542,724733,765748966,3834148,483577576,37,577331,584541127,576622,584455797,709,85330,557524,15,724989,83585,34,481,144444.0,43333.0,-70.0,-66.0,-69.0,-72.0,-70.0,-66.0,-68.0,-71.0,-87.0,-86.0,-83.0,-83.0,17.0,20.0,14.0,11.0,1
2648,CC:2F:71:3E:C5:1F,3835006,483682438,858,104862,3834148,483577576,0,3584,300976,2957,226546,627,74430,908,8,1234,19,0,37,144444.0,39000.0,-70.0,-72.0,-65.0,-60.0,-71.0,-72.0,-67.0,-61.0,-87.0,-86.0,-83.0,-83.0,17.0,14.0,18.0,23.0,1
2649,BA:8C:B9:54:50:24,3838970,489758803,4820,6181025,3834150,483577778,0,8894,1692425,8872,1688930,22,3495,2345,15,5249,39,0,56,229410.0,130000.0,-40.0,-37.0,-46.0,-51.0,-41.0,-36.0,-45.0,-50.0,-87.0,-86.0,-83.0,-83.0,47.0,49.0,37.0,32.0,1
2650,3C:55:76:E8:8F:1F,3834649,484183897,497,605917,3834152,483577980,0,1368,247717,1186,214432,182,33285,675,10,508,39,0,48,162500.0,48750.0,-47.0,-49.0,-45.0,-45.0,-46.0,-48.0,-44.0,-44.0,-87.0,-86.0,-83.0,-83.0,40.0,37.0,38.0,38.0,1
2651,92:69:1D:31:68:E9,3838025,487185534,3873,3607554,3834152,483577980,0,4664,1084493,4525,1053063,139,31430,2085,10,4066,84,0,41,216660.0,130000.0,-52.0,-49.0,-45.0,-51.0,-52.0,-47.0,-43.0,-49.0,-87.0,-86.0,-83.0,-83.0,35.0,37.0,38.0,32.0,1
2652,CC:2F:71:3F:1F:24,4559005,1249459346,724853,765881366,3834152,483577980,37,577441,584668069,576732,584582739,709,85330,557629,15,725109,83586,34,481,144444.0,43333.0,-70.0,-66.0,-69.0,-71.0,-70.0,-66.0,-68.0,-71.0,-87.0,-86.0,-83.0,-83.0,17.0,20.0,14.0,12.0,1
2653,CC:2F:71:3E:C5:1F,3835010,483682842,858,104862,3834152,483577980,0,3584,300976,2957,226546,627,74430,908,8,1234,19,0,37,144444.0,39000.0,-70.0,-72.0,-65.0,-60.0,-71.0,-72.0,-67.0,-61.0,-87.0,-86.0,-83.0,-83.0,17.0,14.0,18.0,23.0,1
2654,BA:8C:B9:54:50:24,3838974,489759207,4820,6181025,3834154,483578182,0,8894,1692425,8872,1688930,22,3495,2345,15,5249,39,0,56,229410.0,130000.0,-40.0,-37.0,-46.0,-51.0,-41.0,-36.0,-45.0,-50.0,-87.0,-86.0,-83.0,-83.0,47.0,49.0,37.0,32.0,1
2655,3C:55:76:E8:8F:1F,3834654,484184565,497,605917,3834157,483578648,0,1375,248449,1192,214844,183,33605,676,10,508,39,0,48,162500.0,48750.0,-47.0,-49.0,-45.0,-45.0,-45.0,-47.0,-43.0,-42.0,-87.0,-86.0,-83.0,-83.0,40.0,37.0,38.0,38.0,1
2656,92:69:1D:31:68:E9,3838030,487186202,3873,3607554,3834157,483578648,0,4664,1084493,4525,1053063,139,31430,2085,10,4066,84,0,41,216660.0,130000.0,-52.0,-49.0,-45.0,-51.0,-52.0,-47.0,-43.0,-49.0,-87.0,-86.0,-83.0,-83.0,35.0,37.0,38.0,32.0,1
2657,CC:2F:71:3F:1F:24,4559133,1249589884,724974,766011034,3834159,483578850,37,577546,584791793,576837,584706463,709,85330,557727,15,725230,83587,34,481,144444.0,43333.0,-70.0,-66.0,-68.0,-70.0,-70.0,-65.0,-68.0,-70.0,-87.0,-86.0,-83.0,-83.0,17.0,20.0,15.0,13.0,1
2658,CC:2F:71:3E:C5:1F,3835018,483683772,858,104862,3834160,483578910,0,3584,300976,2957,226546,627,74430,908,8,1234,19,0,37,144444.0,39000.0,-70.0,-72.0,-65.0,-60.0,-71.0,-72.0,-67.0,-61.0,-87.0,-86.0,-83.0,-83.0,17.0,14.0,18.0,23.0,1
2659,BA:8C:B9:54:50:24,3838980,489759935,4820,6181025,3834160,483578910,0,8894,1692425,8872,1688930,22,3495,2345,15,5249,39,0,56,229410.0,130000.0,-40.0,-37.0,-46.0,-51.0,-41.0,-36.0,-45.0,-50.0,-87.0,-86.0,-83.0,-83.0,47.0,49.0,37.0,32.0,1
2660,3C:55:76:E8:8F:1F,3834659,484185029,497,605917,3834162,483579112,0,1375,248449,1192,214844,183,33605,676,10,508,39,0,48,162500.0,48750.0,-47.0,-49.0,-45.0,-45.0,-45.0,-47.0,-43.0,-42.0,-87.0,-86.0,-83.0,-83.0,40.0,37.0,38.0,38.0,1
2661,92:69:1D:31:68:E9,3838035,487186666,3873,3607554,3834162,483579112,0,4664,1084493,4525,1053063,139,31430,2085,10,4066,84,0,41,216660.0,130000.0,-52.0,-49.0,-45.0,-51.0,-52.0,-47.0,-43.0,-49.0,-87.0,-86.0,-83.0,-83.0,35.0,37.0,38.0,32.0,1
2662,CC:2F:71:3F:1F:24,4559264,1249724723,725102,766145611,3834162,483579112,37,577662,584918874,576953,584833544,709,85330,557834,15,725358,83589,34,481,144444.0,43333.0,-70.0,-65.0,-68.0,-71.0,-69.0,-65.0,-68.0,-71.0,-87.0,-86.0,-83.0,-83.0,17.0,21.0,15.0,12.0,1
2663,CC:2F:71:3E:C5:1F,3835022,483684176,858,104862,3834164,483579314,0,3584,300976,2957,226546,627,74430,908,8,1234,19,0,37,144444.0,39000.0,-70.0,-72.0,-65.0,-60.0,-71.0,-72.0,-67.0,-61.0,-87.0,-86.0,-83.0,-83.0,17.0,14.0,18.0,23.0,1
2664,BA:8C:B9:54:50:24,3838984,489760339,4820,6181025,3834164,483579314,0,8894,1692425,8872,1688930,22,3495,2345,15,5249,39,0,56,229410.0,130000.0,-40.0,-37.0,-46.0,-51.0,-41.0,-36.0,-45.0,-50.0,-87.0,-86.0,-83.0,-83.0,47.0,49.0,37.0,32.0,1
2665,3C:55:76:E8:8F:1F,3834666,484185759,498,606041,3834168,483579718,0,1386,249239,1203,215634,183,33605,677,10,509,39,0,49,162500.0,48750.0,-49.0,-49.0,-46.0,-45.0,-48.0,-48.0,-44.0,-44.0,-87.0,-86.0,-83.0,-83.0,38.0,37.0,37.0,38.0,1
2666,92:69:1D:31:68:E9,3838041,487187272,3873,3607554,3834168,483579718,0,4664,1084493,4525,1053063,139,31430,2085,10,4066,84,0,41,216660.0,130000.0,-52.0,-49.0,-45.0,-51.0,-52.0,-47.0,-43.0,-49.0,-87.0,-86.0,-83.0,-83.0,35.0,37.0,38.0,32.0,1
2667,CC:2F:71:3F:1F:24,4559389,1249854751,725221,766275033,3834168,483579718,37,577766,585040848,577057,584955518,709,85330,557933,15,725477,83593,34,481,144444.0,43333.0,-70.0,-65.0,-68.0,-71.0,-69.0,-65.0,-68.0,-71.0,-87.0,-86.0,-83.0,-83.0,17.0,21.0,15.0,12.0,1
2668,CC:2F:71:3E:C5:1F,3835026,483684580,858,104862,3834168,483579718,0,3584,300976,2957,226546,627,74430,908,8,1234,19,0,37,144444.0,39000.0,-70.0,-72.0,-65.0,-60.0,-71.0,-72.0,-67.0,-61.0,-87.0,-86.0,-83.0,-83.0,17.0,14.0,18.0,23.0,1
2669,BA:8C:B9:54:50:24,3838990,489760945,4820,6181025,3834170,483579920,0,8894,1692425,8872,1688930,22,3495,2345,15,5249,39,0,56,229410.0,130000.0,-40.0,-37.0,-46.0,-51.0,-41.0,-36.0,-45.0,-50.0,-87.0,-86.0,-83.0,-83.0,47.0,49.0,37.0,32.0,1
2670,3C:55:76:E8:8F:1F,3834670,484188400,499,608420,3834171,483579980,0,1397,250039,1214,216434,183,33605,678,10,510,39,0,49,162500.0,48750.0,-47.0,-51.0,-46.0,-41.0,-46.0,-50.0,-45.0,-41.0,-87.0,-86.0,-84.0,-84.0,40.0,35.0,38.0,43.0,1
2671,92:69:1D:31:68:E9,3838046,487187736,3873,3607554,3834173,483580182,0,4664,1084493,4525,1053063,139,31430,2085,10,4066,84,0,41,216660.0,130000.0,-52.0,-49.0,-45.0,-51.0,-52.0,-47.0,-43.0,-49.0,-87.0,-86.0,-84.0,-84.0,35.0,37.0,39.0,33.0,1
2672,CC:2F:71:3F:1F:24,4559516,1249989285,725343,766409103,3834173,483580182,37,577879,585176742,577170,585091412,709,85330,558036,15,725599,83594,34,481,144444.0,43333.0,-69.0,-65.0,-68.0,-72.0,-69.0,-65.0,-68.0,-71.0,-87.0,-86.0,-84.0,-84.0,18.0,21.0,16.0,12.0,1
2673,CC:2F:71:3E:C5:1F,3835031,483685044,858,104862,3834173,483580182,0,3584,300976,2957,226546,627,74430,908,8,1234,19,0,37,144444.0,39000.0,-70.0,-72.0,-65.0,-60.0,-71.0,-72.0,-67.0,-61.0,-87.0,-86.0,-84.0,-84.0,17.0,14.0,19.0,24.0,1
2674,BA:8C:B9:54:50:24,3838993,489761207,4820,6181025,3834173,483580182,0,8894,1692425,8872,1688930,22,3495,2345,15,5249,39,0,56,229410.0,130000.0,-40.0,-37.0,-46.0,-51.0,-41.0,-36.0,-45.0,-50.0,-87.0,-86.0,-84.0,-84.0,47.0,49.0,38.0,33.0,1
2675,3C:55:76:E8:8F:1F,3834677,484189204,500,608618,3834177,483580586,0,1403,250487,1220,216882,183,33605,679,10,511,39,0,49,162500.0,1000.0,-49.0,-49.0,-46.0,-45.0,-47.0,-48.0,-44.0,-42.0,-87.0,-86.0,-84.0,-84.0,38.0,37.0,38.0,39.0,1
2676,92:69:1D:31:68:E9,3838051,487188256,3874,3607670,3834177,483580586,0,4666,1084629,4527,1053199,139,31430,2085,10,4067,84,0,41,216660.0,130000.0,-54.0,-48.0,-42.0,-49.0,-52.0,-48.0,-43.0,-49.0,-87.0,-86.0,-84.0,-84.0,33.0,38.0,42.0,35.0,1
2677,CC:2F:71:3F:1F:24,4559642,1250119429,725463,766538641,3834179,483580788,37,577986,585297902,577277,585212572,709,85330,558138,15,725719,83595,34,481,144444.0,43333.0,-70.0,-65.0,-68.0,-71.0,-70.0,-65.0,-68.0,-71.0,-87.0,-86.0,-84.0,-84.0,17.0,21.0,16.0,13.0,1
2678,CC:2F:71:3E:C5:1F,3835038,483685710,859,104922,3834179,483580788,0,3586,301116,2959,226686,627,74430,908,8,1235,19,0,37,144444.0,39000.0,-67.0,-72.0,-65.0,-64.0,-70.0,-73.0,-67.0,-62.0,-87.0,-86.0,-84.0,-84.0,20.0,14.0,19.0,20.0,1
2679,BA:8C:B9:54:50:24,3839000,489761873,4821,6181085,3834179,483580788,0,8898,1692697,8876,1689202,22,3495,2345,15,5250,39,0,56,229410.0,130000.0,-40.0,-37.0,-46.0,-51.0,-41.0,-36.0,-44.0,-49.0,-87.0,-86.0,-84.0,-84.0,47.0,49.0,38.0,33.0,1
2680,3C:55:76:E8:8F:1F,3834681,484189608,500,608618,3834181,483580990,0,1403,250487,1220,216882,183,33605,679,10,511,39,0,49,162500.0,1000.0,-49.0,-49.0,-46.0,-45.0,-47.0,-48.0,-44.0,-42.0,-87.0,-86.0,-84.0,-84.0,38.0,37.0,38.0,39.0,1
2681,92:69:1D:31:68:E9,3838055,487188660,3874,3607670,3834181,483580990,0,4666,1084629,4527,1053199,139,31430,2085,10,4067,84,0,41,216660.0,130000.0,-54.0,-48.0,-42.0,-49.0,-52.0,-48.0,-43.0,-49.0,-87.0,-86.0,-84.0,-84.0,33.0,38.0,42.0,35.0,1
2682,CC:2F:71:3F:1F:24,4559769,1250252328,725587,766671276,3834182,483581052,37,578099,585420303,577390,585334973,709,85330,558244,15,725843,83595,34,481,144444.0,43333.0,-70.0,-65.0,-68.0,-72.0,-69.0,-65.0,-68.0,-72.0,-87.0,-86.0,-84.0,-84.0,17.0,21.0,16.0,12.0,1
2683,CC:2F:71:3E:C5:1F,3835042,483686034,859,104922,3834183,483581112,0,3586,301116,2959,226686,627,74430,908,8,1235,19,0,37,144444.0,39000.0,-67.0,-72.0,-65.0,-64.0,-70.0,-73.0,-67.0,-62.0,-87.0,-86.0,-84.0,-84.0,20.0,14.0,19.0,20.0,1
2684,BA:8C:B9:54:50:24,3839007,489762672,4821,6181085,3834186,483581587,0,8898,1692697,8876,1689202,22,3495,2345,15,5250,39,0,56,229410.0,130000.0,-40.0,-37.0,-46.0,-51.0,-41.0,-36.0,-44.0,-49.0,-87.0,-86.0,-84.0,-84.0,47.0,49.0,38.0,33.0,1
2685,3C:55:76:E8:8F:1F,3834688,484190407,500,608618,3834188,483581789,0,1411,251085,1227,217362,184,33723,680,10,511,39,0,49,162500.0,1000.0,-48.0,-51.0,-47.0,-42.0,-46.0,-49.0,-44.0,-40.0,-87.0,-86.0,-84.0,-84.0,39.0,35.0,37.0,42.0,1
2686,92:69:1D:31:68:E9,3838064,487189661,3874,3607670,3834190,483581991,0,4666,1084629,4527,1053199,139,31430,2085,10,4067,84,0,41,216660.0,130000.0,-54.0,-48.0,-42.0,-49.0,-52.0,-48.0,-43.0,-49.0,-87.0,-86.0,-84.0,-84.0,33.0,38.0,42.0,35.0,1
2687,CC:2F:71:3F:1F:24,4559898,1250388645,725708,766806654,3834190,483581991,37,578201,585542163,577492,585456833,709,85330,558344,15,725964,83596,34,481,144444.0,43333.0,-70.0,-65.0,-68.0,-71.0,-69.0,-65.0,-68.0,-71.0,-87.0,-86.0,-84.0,-84.0,17.0,21.0,16.0,13.0,1
2688,CC:2F:71:3E:C5:1F,3835049,483686913,859,104922,3834190,483581991,0,3586,301116,2959,226686,627,74430,908,8,1235,19,0,37,144444.0,39000.0,-67.0,-72.0,-65.0,-64.0,-70.0,-73.0,-67.0,-62.0,-87.0,-86.0,-84.0,-84.0,20.0,14.0,19.0,20.0,1
2689,BA:8C:B9:54:50:24,3839011,489763076,4821,6181085,3834190,483581991,0,8899,1692765,8877,1689270,22,3495,2345,15,5250,39,0,56,229410.0,130000.0,-40.0,-37.0,-45.0,-51.0,-41.0,-36.0,-44.0,-49.0,-87.0,-86.0,-84.0,-84.0,47.0,49.0,39.0,33.0,1
2690,3C:55:76:E8:8F:1F,3834692,484190811,500,608618,3834192,483582193,0,1411,251085,1227,217362,184,33723,680,10,511,39,0,49,162500.0,1000.0,-48.0,-51.0,-47.0,-42.0,-46.0,-49.0,-44.0,-40.0,-87.0,-86.0,-84.0,-84.0,39.0,35.0,37.0,42.0,1
2691,92:69:1D:31:68:E9,3838066,487189863,3874,3607670,3834192,483582193,0,4666,1084629,4527,1053199,139,31430,2085,10,4067,84,0,41,216660.0,130000.0,-54.0,-48.0,-42.0,-49.0,-52.0,-48.0,-43.0,-49.0,-87.0,-86.0,-84.0,-84.0,33.0,38.0,42.0,35.0,1
2692,CC:2F:71:3F:1F:24,4560019,1250518207,725826,766935946,3834193,483582261,37,578299,585660551,577590,585575221,709,85330,558440,15,726082,83597,34,481,144444.0,43333.0,-69.0,-65.0,-68.0,-71.0,-69.0,-65.0,-68.0,-71.0,-87.0,-86.0,-84.0,-84.0,18.0,21.0,16.0,13.0,1
2693,CC:2F:71:3E:C5:1F,3835053,483687317,859,104922,3834194,483582395,0,3586,301116,2959,226686,627,74430,908,8,1235,19,0,37,144444.0,39000.0,-67.0,-72.0,-65.0,-64.0,-70.0,-73.0,-67.0,-62.0,-87.0,-86.0,-84.0,-84.0,20.0,14.0,19.0,20.0,1
2694,BA:8C:B9:54:50:24,3839015,489763480,4821,6181085,3834194,483582395,0,8899,1692765,8877,1689270,22,3495,2345,15,5250,39,0,56,229410.0,130000.0,-40.0,-37.0,-45.0,-51.0,-41.0,-36.0,-44.0,-49.0,-87.0,-86.0,-84.0,-84.0,47.0,49.0,39.0,33.0,1
2695,3C:55:76:E8:8F:1F,3834700,484191587,501,608728,3834199,483582859,0,1421,251900,1237,218177,184,33723,682,10,512,39,0,49,162500.0,48750.0,-47.0,-51.0,-47.0,-42.0,-46.0,-49.0,-45.0,-41.0,-87.0,-86.0,-84.0,-84.0,40.0,35.0,37.0,42.0,1
2696,92:69:1D:31:68:E9,3838073,487190529,3874,3607670,3834199,483582859,0,4666,1084629,4527,1053199,139,31430,2085,10,4067,84,0,41,216660.0,130000.0,-54.0,-48.0,-42.0,-49.0,-52.0,-48.0,-43.0,-49.0,-87.0,-86.0,-84.0,-84.0,33.0,38.0,42.0,35.0,1
2697,CC:2F:71:3F:1F:24,4560145,1250649613,725946,767066754,3834199,483582859,37,578402,585783833,577693,585698503,709,85330,558538,15,726202,83597,34,481,144444.0,43333.0,-70.0,-66.0,-68.0,-72.0,-70.0,-66.0,-68.0,-71.0,-87.0,-86.0,-84.0,-84.0,17.0,20.0,16.0,12.0,1
2698,CC:2F:71:3E:C5:1F,3835058,483687781,859,104922,3834199,483582859,0,3586,301116,2959,226686,627,74430,908,8,1235,19,0,37,144444.0,39000.0,-67.0,-72.0,-65.0,-64.0,-70.0,-73.0,-67.0,-62.0,-87.0,-86.0,-84.0,-84.0,20.0,14.0,19.0,20.0,1
2699,BA:8C:B9:54:50:24,3839020,489763944,4821,6181085,3834199,483582859,0,8899,1692765,8877,1689270,22,3495,2345,15,5250,39,0,56,229410.0,130000.0,-40.0,-37.0,-45.0,-51.0,-41.0,-36.0,-44.0,-49.0,-87.0,-86.0,-84.0,-84.0,47.0,49.0,39.0,33.0,1
2700,3C:55:76:E8:8F:1F,3834702,484191789,501,608728,3834201,483583061,0,1421,251900,1237,218177,184,33723,682,10,512,39,0,49,162500.0,48750.0,-47.0,-51.0,-47.0,-42.0,-46.0,-49.0,-45.0,-41.0,-87.0,-86.0,-84.0,-84.0,40.0,35.0,37.0,42.0,1
2701,92:69:1D:31:68:E9,3838077,487190933,3874,3607670,3834203,483583263,0,4666,1084629,4527,1053199,139,31430,2085,10,4067,84,0,41,216660.0,130000.0,-54.0,-48.0,-42.0,-49.0,-52.0,-48.0,-43.0,-49.0,-87.0,-86.0,-84.0,-84.0,33.0,38.0,42.0,35.0,1
2702,CC:2F:71:3F:1F:24,4560276,1250784464,726073,767201201,3834203,483583263,37,578515,585911725,577806,585826395,709,85330,558645,15,726329,83597,34,481,144444.0,43333.0,-68.0,-66.0,-70.0,-70.0,-68.0,-65.0,-69.0,-70.0,-87.0,-86.0,-84.0,-84.0,19.0,20.0,14.0,14.0,1
2703,CC:2F:71:3E:C5:1F,3835062,483688185,859,104922,3834203,483583263,0,3586,301116,2959,226686,627,74430,908,8,1235,19,0,37,144444.0,39000.0,-67.0,-72.0,-65.0,-64.0,-70.0,-73.0,-67.0,-62.0,-87.0,-86.0,-84.0,-84.0,20.0,14.0,19.0,20.0,1
2704,BA:8C:B9:54:50:24,3839024,489764348,4821,6181085,3834203,483583263,0,8899,1692765,8877,1689270,22,3495,2345,15,5250,39,0,56,229410.0,130000.0,-40.0,-37.0,-45.0,-51.0,-41.0,-36.0,-44.0,-49.0,-87.0,-86.0,-84.0,-84.0,47.0,49.0,39.0,33.0,1
2705,3C:55:76:E8:8F:1F,3834710,484192584,501,608728,3834209,483583856,0,1429,252613,1243,218589,186,34024,684,10,512,39,0,50,162500.0,48750.0,-46.0,-51.0,-43.0,-41.0,-45.0,-50.0,-42.0,-41.0,-87.0,-86.0,-84.0,-84.0,41.0,35.0,41.0,43.0,1
2706,92:69:1D:31:68:E9,3838083,487191526,3874,3607670,3834209,483583856,0,4666,1084629,4527,1053199,139,31430,2085,10,4067,84,0,41,216660.0,130000.0,-54.0,-48.0,-42.0,-49.0,-52.0,-48.0,-43.0,-49.0,-87.0,-86.0,-84.0,-84.0,33.0,38.0,42.0,35.0,1
2707,CC:2F:71:3F:1F:24,4560402,1250915963,726192,767332047,3834210,483583916,37,578619,586033875,577910,585948545,709,85330,558744,15,726448,83597,34,481,144444.0,43333.0,-68.0,-65.0,-69.0,-71.0,-68.0,-65.0,-69.0,-70.0,-87.0,-86.0,-84.0,-84.0,19.0,21.0,15.0,13.0,1
2708,CC:2F:71:3E:C5:1F,3835069,483688838,859,104922,3834210,483583916,0,3586,301116,2959,226686,627,74430,908,8,1235,19,0,37,144444.0,39000.0,-67.0,-72.0,-65.0,-64.0,-70.0,-73.0,-67.0,-62.0,-87.0,-86.0,-84.0,-84.0,20.0,14.0,19.0,20.0,1
2709,BA:8C:B9:54:50:24,3839031,489765001,4821,6181085,3834210,483583916,0,8899,1692765,8877,1689270,22,3495,2345,15,5250,39,0,56,229410.0,130000.0,-40.0,-37.0,-45.0,-51.0,-41.0,-36.0,-44.0,-49.0,-87.0,-86.0,-84.0,-84.0,47.0,49.0,39.0,33.0,1
2710,3C:55:76:E8:8F:1F,3834720,484194606,505,610232,3834215,483584374,0,1447,258076,1260,223934,187,34142,691,10,516,39,0,50,162500.0,48750.0,-46.0,-49.0,-42.0,-43.0,-47.0,-49.0,-44.0,-44.0,-87.0,-86.0,-84.0,-84.0,41.0,37.0,42.0,41.0,1
2711,92:69:1D:31:68:E9,3838090,487192112,3874,3607670,3834216,483584442,0,4666,1084629,4527,1053199,139,31430,2085,10,4067,84,0,41,216660.0,130000.0,-54.0,-48.0,-42.0,-49.0,-52.0,-48.0,-43.0,-49.0,-87.0,-86.0,-84.0,-84.0,33.0,38.0,42.0,35.0,1
2712,CC:2F:71:3F:1F:24,4560549,1251068884,726333,767484442,3834216,483584442,37,578754,586186727,578045,586101397,709,85330,558869,15,726587,83598,34,481,144444.0,43333.0,-68.0,-66.0,-69.0,-71.0,-68.0,-65.0,-69.0,-70.0,-87.0,-86.0,-84.0,-84.0,19.0,20.0,15.0,13.0,1
2713,CC:2F:71:3E:C5:1F,3835075,483689364,859,104922,3834216,483584442,0,3586,301116,2959,226686,627,74430,908,8,1235,19,0,37,144444.0,39000.0,-67.0,-72.0,-65.0,-64.0,-70.0,-73.0,-67.0,-62.0,-87.0,-86.0,-84.0,-84.0,20.0,14.0,19.0,20.0,1
2714,BA:8C:B9:54:50:24,3839037,489765527,4821,6181085,3834216,483584442,0,8899,1692765,8877,1689270,22,3495,2345,15,5250,39,0,56,229410.0,130000.0,-40.0,-37.0,-45.0,-51.0,-41.0,-36.0,-44.0,-49.0,-87.0,-86.0,-84.0,-84.0,47.0,49.0,39.0,33.0,1
2715,3C:55:76:E8:8F:1F,3834726,484195140,505,610232,3834221,483584908,0,1454,258554,1267,224412,187,34142,691,10,516,39,0,51,162500.0,48750.0,-49.0,-49.0,-47.0,-45.0,-47.0,-48.0,-45.0,-44.0,-87.0,-86.0,-84.0,-84.0,38.0,37.0,37.0,39.0,1
2716,92:69:1D:31:68:E9,3838095,487192578,3874,3607670,3834221,483584908,0,4668,1084765,4529,1053335,139,31430,2085,10,4068,84,0,41,216660.0,130000.0,-53.0,-48.0,-43.0,-49.0,-52.0,-48.0,-43.0,-49.0,-87.0,-86.0,-84.0,-84.0,34.0,38.0,41.0,35.0,1
2717,CC:2F:71:3F:1F:24,4560746,1251312214,726525,767727306,3834221,483584908,37,578940,586435315,578231,586349985,709,85330,559041,15,726781,83599,34,481,144444.0,43333.0,-68.0,-66.0,-69.0,-70.0,-68.0,-65.0,-69.0,-70.0,-87.0,-86.0,-84.0,-84.0,19.0,20.0,15.0,14.0,1
2718,CC:2F:71:3E:C5:1F,3835080,483689830,859,104922,3834221,483584908,0,3590,301444,2962,226896,628,74548,909,8,1236,19,0,37,144444.0,39000.0,-67.0,-73.0,-69.0,-63.0,-67.0,-72.0,-67.0,-62.0,-87.0,-86.0,-84.0,-84.0,20.0,13.0,15.0,21.0,1
2719,BA:8C:B9:54:50:24,3839042,489765993,4821,6181085,3834221,483584908,0,8903,1693037,8881,1689542,22,3495,2345,15,5251,39,0,56,229410.0,130000.0,-49.0,-35.0,-43.0,-45.0,-41.0,-35.0,-44.0,-49.0,-87.0,-86.0,-84.0,-84.0,38.0,51.0,41.0,39.0,1
2720,3C:55:76:E8:8F:1F,3834732,484195753,506,610381,3834226,483585372,0,1459,258969,1272,224827,187,34142,692,10,517,39,0,51,172050.0,48750.0,-42.0,-48.0,-45.0,-39.0,-44.0,-48.0,-45.0,-41.0,-87.0,-86.0,-84.0,-84.0,45.0,38.0,39.0,45.0,1
2721,92:69:1D:31:68:E9,3838100,487193042,3874,3607670,3834226,483585372,0,4668,1084765,4529,1053335,139,31430,2085,10,4068,84,0,41,216660.0,130000.0,-53.0,-48.0,-43.0,-49.0,-52.0,-48.0,-43.0,-49.0,-87.0,-86.0,-84.0,-84.0,34.0,38.0,41.0,35.0,1
2722,CC:2F:71:3F:1F:24,4560964,1251565392,726738,767980020,3834226,483585372,37,579145,586691442,578436,586606112,709,85330,559232,15,726994,83599,34,481,144444.0,43333.0,-70.0,-66.0,-69.0,-71.0,-69.0,-65.0,-68.0,-70.0,-87.0,-86.0,-84.0,-84.0,17.0,20.0,15.0,13.0,1
2723,CC:2F:71:3E:C5:1F,3835087,483690496,859,104922,3834228,483585574,0,3590,301444,2962,226896,628,74548,909,8,1236,19,0,37,144444.0,39000.0,-67.0,-73.0,-69.0,-63.0,-67.0,-72.0,-67.0,-62.0,-87.0,-86.0,-84.0,-84.0,20.0,13.0,15.0,21.0,1
2724,BA:8C:B9:54:50:24,3839049,489766659,4821,6181085,3834228,483585574,0,8903,1693037,8881,1689542,22,3495,2345,15,5251,39,0,56,229410.0,130000.0,-49.0,-35.0,-43.0,-45.0,-41.0,-35.0,-44.0,-49.0,-87.0,-86.0,-84.0,-84.0,38.0,51.0,41.0,39.0,1
2725,3C:55:76:E8:8F:1F,3834737,484196219,506,610381,3834231,483585838,0,1475,260095,1288,225953,187,34142,693,10,517,39,0,51,172050.0,48750.0,-45.0,-51.0,-48.0,-41.0,-45.0,-51.0,-46.0,-41.0,-87.0,-86.0,-84.0,-84.0,42.0,35.0,36.0,43.0,1
2726,92:69:1D:31:68:E9,3838105,487193508,3874,3607670,3834231,483585838,0,4668,1084765,4529,1053335,139,31430,2085,10,4068,84,0,41,216660.0,130000.0,-53.0,-48.0,-43.0,-49.0,-52.0,-48.0,-43.0,-49.0,-87.0,-86.0,-84.0,-84.0,34.0,38.0,41.0,35.0,1
2727,CC:2F:71:3F:1F:24,4561163,1251811869,726932,768226031,3834231,483585838,37,579326,586930627,578616,586845179,710,85448,559407,15,727187,83599,34,481,144444.0,43333.0,-69.0,-66.0,-71.0,-71.0,-69.0,-66.0,-71.0,-71.0,-87.0,-86.0,-84.0,-84.0,18.0,20.0,13.0,13.0,1
2728,CC:2F:71:3E:C5:1F,3835090,483690760,859,104922,3834231,483585838,0,3590,301444,2962,226896,628,74548,909,8,1236,19,0,37,144444.0,39000.0,-67.0,-73.0,-69.0,-63.0,-67.0,-72.0,-67.0,-62.0,-87.0,-86.0,-84.0,-84.0,20.0,13.0,15.0,21.0,1
2729,BA:8C:B9:54:50:24,3839052,489766923,4821,6181085,3834231,483585838,0,8906,1693241,8884,1689746,22,3495,2345,15,5251,39,0,56,229410.0,130000.0,-48.0,-35.0,-42.0,-46.0,-42.0,-36.0,-44.0,-48.0,-87.0,-86.0,-84.0,-84.0,39.0,51.0,42.0,38.0,1
2730,3C:55:76:E8:8F:1F,3834743,484196815,508,610573,3834235,483586242,0,1485,260881,1298,226739,187,34142,695,10,519,39,0,51,172050.0,1000.0,-42.0,-53.0,-43.0,-43.0,-44.0,-50.0,-44.0,-42.0,-87.0,-86.0,-84.0,-84.0,45.0,33.0,41.0,41.0,1
2731,92:69:1D:31:68:E9,3838112,487194174,3874,3607670,3834238,483586504,0,4668,1084765,4529,1053335,139,31430,2085,10,4068,84,0,41,216660.0,130000.0,-53.0,-48.0,-43.0,-49.0,-52.0,-48.0,-43.0,-49.0,-87.0,-86.0,-84.0,-84.0,34.0,38.0,41.0,35.0,1
2732,CC:2F:71:3F:1F:24,4561362,1252055399,727124,768468895,3834238,483586504,37,579513,587178049,578803,587092601,710,85448,559579,15,727380,83619,34,481,144444.0,43333.0,-71.0,-65.0,-70.0,-70.0,-70.0,-65.0,-70.0,-69.0,-87.0,-86.0,-84.0,-84.0,16.0,21.0,14.0,14.0,1
2733,CC:2F:71:3E:C5:1F,3835097,483691426,859,104922,3834238,483586504,0,3590,301444,2962,226896,628,74548,909,8,1236,19,0,37,144444.0,39000.0,-67.0,-73.0,-69.0,-63.0,-67.0,-72.0,-67.0,-62.0,-87.0,-86.0,-84.0,-85.0,20.0,13.0,15.0,22.0,1
2734,BA:8C:B9:54:50:24,3839059,489767589,4821,6181085,3834238,483586504,0,8907,1693309,8885,1689814,22,3495,2345,15,5251,39,0,56,229410.0,130000.0,-48.0,-35.0,-43.0,-45.0,-43.0,-35.0,-44.0,-48.0,-87.0,-86.0,-84.0,-85.0,39.0,51.0,41.0,40.0,1
2735,3C:55:76:E8:8F:1F,3834748,484197279,508,610573,3834240,483586706,0,1485,260881,1298,226739,187,34142,695,10,519,39,0,51,172050.0,1000.0,-42.0,-53.0,-43.0,-43.0,-44.0,-50.0,-44.0,-42.0,-87.0,-86.0,-84.0,-85.0,45.0,33.0,41.0,42.0,1
2736,92:69:1D:31:68:E9,3838114,487194376,3874,3607670,3834240,483586706,0,4668,1084765,4529,1053335,139,31430,2085,10,4068,84,0,41,216660.0,130000.0,-53.0,-48.0,-43.0,-49.0,-52.0,-48.0,-43.0,-49.0,-87.0,-86.0,-84.0,-85.0,34.0,38.0,41.0,36.0,1
2737,CC:2F:71:3F:1F:24,4561568,1252309706,727328,768723000,3834240,483586706,37,579712,587439932,579002,587354484,710,85448,559761,15,727584,83620,34,482,144444.0,43333.0,-70.0,-66.0,-72.0,-70.0,-70.0,-66.0,-72.0,-69.0,-87.0,-86.0,-84.0,-85.0,17.0,20.0,12.0,15.0,1
2738,CC:2F:71:3E:C5:1F,3835099,483691628,859,104922,3834240,483586706,0,3590,301444,2962,226896,628,74548,909,8,1236,19,0,37,144444.0,39000.0,-67.0,-73.0,-69.0,-63.0,-67.0,-72.0,-67.0,-62.0,-87.0,-86.0,-84.0,-85.0,20.0,13.0,15.0,22.0,1
2739,BA:8C:B9:54:50:24,3839063,489767993,4821,6181085,3834242,483586908,0,8907,1693309,8885,1689814,22,3495,2345,15,5251,39,0,56,229410.0,130000.0,-48.0,-35.0,-43.0,-45.0,-43.0,-35.0,-44.0,-48.0,-87.0,-86.0,-84.0,-85.0,39.0,51.0,41.0,40.0,1
2740,3C:55:76:E8:8F:1F,3834754,484197885,508,610573,3834246,483587312,0,1485,260881,1298,226739,187,34142,695,10,519,39,0,51,172050.0,1000.0,-42.0,-53.0,-43.0,-43.0,-44.0,-50.0,-44.0,-42.0,-87.0,-86.0,-84.0,-85.0,45.0,33.0,41.0,42.0,1
2741,92:69:1D:31:68:E9,3838120,487194982,3874,3607670,3834246,483587312,0,4668,1084765,4529,1053335,139,31430,2085,10,4068,84,0,41,216660.0,130000.0,-53.0,-48.0,-43.0,-49.0,-52.0,-48.0,-43.0,-49.0,-87.0,-86.0,-84.0,-85.0,34.0,38.0,41.0,36.0,1
2742,CC:2F:71:3F:1F:24,4561767,1252555100,727521,768967788,3834246,483587312,37,579899,587685776,579189,587600328,710,85448,559935,15,727777,83620,34,482,144444.0,43333.0,-70.0,-66.0,-73.0,-71.0,-70.0,-66.0,-73.0,-70.0,-87.0,-86.0,-84.0,-85.0,17.0,20.0,11.0,14.0,1
2743,CC:2F:71:3E:C5:1F,3835105,483692234,859,104922,3834246,483587312,0,3590,301444,2962,226896,628,74548,909,8,1236,19,0,37,144444.0,39000.0,-67.0,-73.0,-69.0,-63.0,-67.0,-72.0,-67.0,-62.0,-87.0,-86.0,-84.0,-85.0,20.0,13.0,15.0,22.0,1
2744,BA:8C:B9:54:50:24,3839067,489768397,4821,6181085,3834246,483587312,0,8907,1693309,8885,1689814,22,3495,2345,15,5251,39,0,56,229410.0,130000.0,-48.0,-35.0,-43.0,-45.0,-43.0,-35.0,-44.0,-48.0,-87.0,-86.0,-84.0,-85.0,39.0,51.0,41.0,40.0,1
2745,3C:55:76:E8:8F:1F,3834758,484198420,508,610573,3834250,483587847,0,1485,260881,1298,226739,187,34142,695,10,519,39,0,51,172050.0,1000.0,-42.0,-53.0,-43.0,-43.0,-44.0,-50.0,-44.0,-42.0,-87.0,-86.0,-84.0,-85.0,45.0,33.0,41.0,42.0,1
2746,92:69:1D:31:68:E9,3838124,487195517,3874,3607670,3834250,483587847,0,4668,1084765,4529,1053335,139,31430,2085,10,4068,84,0,41,216660.0,130000.0,-53.0,-48.0,-43.0,-49.0,-52.0,-48.0,-43.0,-49.0,-87.0,-86.0,-84.0,-85.0,34.0,38.0,41.0,36.0,1
2747,CC:2F:71:3F:1F:24,4561967,1252800371,727715,769212322,3834252,483588049,37,580079,587926302,579369,587840854,710,85448,560107,15,727971,83622,34,483,144444.0,43333.0,-71.0,-67.0,-74.0,-71.0,-70.0,-66.0,-73.0,-71.0,-87.0,-86.0,-84.0,-85.0,16.0,19.0,10.0,14.0,1
2748,CC:2F:71:3E:C5:1F,3835111,483692971,859,104922,3834252,483588049,0,3590,301444,2962,226896,628,74548,909,8,1236,19,0,37,144444.0,39000.0,-67.0,-73.0,-69.0,-63.0,-67.0,-72.0,-67.0,-62.0,-87.0,-86.0,-84.0,-85.0,20.0,13.0,15.0,22.0,1
2749,BA:8C:B9:54:50:24,3839073,489769134,4821,6181085,3834252,483588049,0,8907,1693309,8885,1689814,22,3495,2345,15,5251,39,0,56,229410.0,130000.0,-48.0,-35.0,-43.0,-45.0,-43.0,-35.0,-44.0,-48.0,-87.0,-86.0,-84.0,-85.0,39.0,51.0,41.0,40.0,1
2750,3C:55:76:E8:8F:1F,3834765,484199088,509,610635,3834256,483588453,0,1493,261464,1306,227322,187,34142,696,10,520,39,0,52,172050.0,48750.0,-46.0,-52.0,-42.0,-42.0,-45.0,-51.0,-42.0,-41.0,-87.0,-86.0,-84.0,-85.0,41.0,34.0,42.0,43.0,1
2751,92:69:1D:31:68:E9,3838130,487196123,3874,3607670,3834256,483588453,0,4668,1084765,4529,1053335,139,31430,2085,10,4068,84,0,41,216660.0,130000.0,-53.0,-48.0,-43.0,-49.0,-52.0,-48.0,-43.0,-49.0,-87.0,-86.0,-84.0,-85.0,34.0,38.0,41.0,36.0,1
2752,CC:2F:71:3F:1F:24,4562164,1253045193,727908,769456740,3834256,483588453,37,580257,588163660,579547,588078212,710,85448,560280,15,728164,83622,34,483,144444.0,43333.0,-71.0,-67.0,-73.0,-72.0,-71.0,-67.0,-73.0,-71.0,-87.0,-86.0,-84.0,-85.0,16.0,19.0,11.0,13.0,1
2753,CC:2F:71:3E:C5:1F,3835115,483693375,859,104922,3834256,483588453,0,3590,301444,2962,226896,628,74548,909,8,1236,19,0,37,144444.0,39000.0,-67.0,-73.0,-69.0,-63.0,-67.0,-72.0,-67.0,-62.0,-87.0,-86.0,-84.0,-85.0,20.0,13.0,15.0,22.0,1
2754,BA:8C:B9:54:50:24,3839079,489769740,4821,6181085,3834258,483588655,0,8907,1693309,8885,1689814,22,3495,2345,15,5251,39,0,56,229410.0,130000.0,-48.0,-35.0,-43.0,-45.0,-43.0,-35.0,-44.0,-48.0,-87.0,-86.0,-84.0,-85.0,39.0,51.0,41.0,40.0,1
2755,3C:55:76:E8:8F:1F,3834771,484199744,512,610963,3834259,483588781,0,1508,262600,1321,228458,187,34142,699,10,523,39,0,52,172050.0,48750.0,-42.0,-52.0,-43.0,-41.0,-43.0,-52.0,-43.0,-41.0,-87.0,-86.0,-84.0,-85.0,45.0,34.0,41.0,44.0,1
2756,92:69:1D:31:68:E9,3838136,487196713,3874,3607670,3834262,483589043,0,4668,1084765,4529,1053335,139,31430,2085,10,4068,84,0,41,216660.0,130000.0,-53.0,-48.0,-43.0,-49.0,-52.0,-48.0,-43.0,-49.0,-87.0,-86.0,-84.0,-85.0,34.0,38.0,41.0,36.0,1
2757,CC:2F:71:3F:1F:24,4562367,1253293282,728105,769704239,3834262,483589043,37,580440,588400755,579730,588315307,710,85448,560458,15,728361,83623,34,483,144444.0,43333.0,-69.0,-66.0,-73.0,-72.0,-69.0,-66.0,-72.0,-71.0,-87.0,-86.0,-84.0,-85.0,18.0,20.0,11.0,13.0,1
2758,CC:2F:71:3E:C5:1F,3835121,483693965,859,104922,3834262,483589043,0,3590,301444,2962,226896,628,74548,909,8,1236,19,0,37,144444.0,39000.0,-67.0,-73.0,-69.0,-63.0,-67.0,-72.0,-67.0,-62.0,-87.0,-86.0,-84.0,-85.0,20.0,13.0,15.0,22.0,1
2759,BA:8C:B9:54:50:24,3839083,489770128,4821,6181085,3834262,483589043,0,8907,1693309,8885,1689814,22,3495,2345,15,5251,39,0,56,229410.0,130000.0,-48.0,-35.0,-43.0,-45.0,-43.0,-35.0,-44.0,-48.0,-87.0,-86.0,-84.0,-85.0,39.0,51.0,41.0,40.0,1
2760,3C:55:76:E8:8F:1F,3834778,484200410,512,610963,3834266,483589447,0,1508,262600,1321,228458,187,34142,699,10,523,39,0,52,172050.0,48750.0,-42.0,-52.0,-43.0,-41.0,-43.0,-52.0,-43.0,-41.0,-87.0,-86.0,-84.0,-85.0,45.0,34.0,41.0,44.0,1
2761,92:69:1D:31:68:E9,3838140,487197117,3874,3607670,3834266,483589447,0,4668,1084765,4529,1053335,139,31430,2085,10,4068,84,0,41,216660.0,130000.0,-53.0,-48.0,-43.0,-49.0,-52.0,-48.0,-43.0,-49.0,-87.0,-86.0,-84.0,-85.0,34.0,38.0,41.0,36.0,1
2762,CC:2F:71:3F:1F:24,4562562,1253534996,728296,769945549,3834266,483589447,37,580613,588631951,579903,588546503,710,85448,560627,15,728552,83623,34,483,144444.0,43333.0,-70.0,-65.0,-72.0,-70.0,-70.0,-65.0,-72.0,-69.0,-87.0,-86.0,-84.0,-85.0,17.0,21.0,12.0,15.0,1
2763,CC:2F:71:3E:C5:1F,3835127,483694571,859,104922,3834268,483589649,0,3590,301444,2962,226896,628,74548,909,8,1236,19,0,37,144444.0,39000.0,-67.0,-73.0,-69.0,-63.0,-67.0,-72.0,-67.0,-62.0,-87.0,-86.0,-84.0,-85.0,20.0,13.0,15.0,22.0,1
2764,BA:8C:B9:54:50:24,3839089,489770734,4821,6181085,3834268,483589649,0,8907,1693309,8885,1689814,22,3495,2345,15,5251,39,0,56,229410.0,130000.0,-48.0,-35.0,-43.0,-45.0,-43.0,-35.0,-44.0,-48.0,-87.0,-86.0,-84.0,-85.0,39.0,51.0,41.0,40.0,1
2765,3C:55:76:E8:8F:1F,3834782,484200814,512,610963,3834270,483589851,0,1508,262600,1321,228458,187,34142,699,10,523,39,0,52,172050.0,48750.0,-42.0,-52.0,-43.0,-41.0,-43.0,-52.0,-43.0,-41.0,-87.0,-86.0,-84.0,-85.0,45.0,34.0,41.0,44.0,1
2766,92:69:1D:31:68:E9,3838144,487197521,3874,3607670,3834270,483589851,0,4668,1084765,4529,1053335,139,31430,2085,10,4068,84,0,41,216660.0,130000.0,-53.0,-48.0,-43.0,-49.0,-52.0,-48.0,-43.0,-49.0,-87.0,-86.0,-84.0,-85.0,34.0,38.0,41.0,36.0,1
2767,CC:2F:71:3F:1F:24,4562760,1253782796,728490,770192945,3834270,483589851,37,580788,588868947,580078,588783499,710,85448,560798,15,728746,83624,34,483,144444.0,43333.0,-70.0,-65.0,-73.0,-70.0,-70.0,-65.0,-72.0,-70.0,-87.0,-86.0,-84.0,-85.0,17.0,21.0,11.0,15.0,1
2768,CC:2F:71:3E:C5:1F,3835129,483694773,859,104922,3834270,483589851,0,3590,301444,2962,226896,628,74548,909,8,1236,19,0,37,144444.0,39000.0,-67.0,-73.0,-69.0,-63.0,-67.0,-72.0,-67.0,-62.0,-87.0,-86.0,-84.0,-85.0,20.0,13.0,15.0,22.0,1
2769,BA:8C:B9:54:50:24,3839091,489770936,4821,6181085,3834270,483589851,0,8907,1693309,8885,1689814,22,3495,2345,15,5251,39,0,56,229410.0,130000.0,-48.0,-35.0,-43.0,-45.0,-43.0,-35.0,-44.0,-48.0,-87.0,-86.0,-84.0,-85.0,39.0,51.0,41.0,40.0,1
2770,3C:55:76:E8:8F:1F,3834789,484201576,514,611261,3834275,483590315,0,1514,263172,1327,229030,187,34142,702,10,525,39,0,52,172050.0,48750.0,-46.0,-49.0,-41.0,-45.0,-46.0,-51.0,-41.0,-43.0,-87.0,-86.0,-84.0,-85.0,41.0,37.0,43.0,40.0,1
2771,92:69:1D:31:68:E9,3838151,487198187,3874,3607670,3834277,483590517,0,4668,1084765,4529,1053335,139,31430,2085,10,4068,84,0,41,216660.0,130000.0,-53.0,-48.0,-43.0,-49.0,-52.0,-48.0,-43.0,-49.0,-87.0,-86.0,-84.0,-85.0,34.0,38.0,41.0,36.0,1
2772,CC:2F:71:3F:1F:24,4562958,1254027636,728681,770437119,3834277,483590517,37,580962,589104389,580252,589018941,710,85448,560969,15,728937,83624,34,483,144444.0,43333.0,-70.0,-67.0,-72.0,-68.0,-69.0,-67.0,-71.0,-68.0,-87.0,-86.0,-84.0,-85.0,17.0,19.0,12.0,17.0,1
2773,CC:2F:71:3E:C5:1F,3835136,483695439,859,104922,3834277,483590517,0,3590,301444,2962,226896,628,74548,909,8,1236,19,0,37,144444.0,39000.0,-67.0,-73.0,-69.0,-63.0,-67.0,-72.0,-67.0,-62.0,-87.0,-86.0,-84.0,-85.0,20.0,13.0,15.0,22.0,1
2774,BA:8C:B9:54:50:24,3839098,489771602,4821,6181085,3834277,483590517,0,8907,1693309,8885,1689814,22,3495,2345,15,5251,39,0,56,229410.0,130000.0,-48.0,-35.0,-43.0,-45.0,-43.0,-35.0,-44.0,-48.0,-87.0,-86.0,-84.0,-85.0,39.0,51.0,41.0,40.0,1
2775,3C:55:76:E8:8F:1F,3834793,484201980,514,611261,3834279,483590719,0,1523,263786,1336,229644,187,34142,702,10,525,39,0,52,172050.0,48750.0,-46.0,-57.0,-45.0,-43.0,-45.0,-55.0,-44.0,-42.0,-87.0,-86.0,-84.0,-85.0,41.0,29.0,39.0,42.0,1
2776,92:69:1D:31:68:E9,3838153,487198389,3874,3607670,3834279,483590719,0,4668,1084765,4529,1053335,139,31430,2085,10,4068,84,0,41,216660.0,130000.0,-53.0,-48.0,-43.0,-49.0,-52.0,-48.0,-43.0,-49.0,-87.0,-86.0,-84.0,-85.0,34.0,38.0,41.0,36.0,1
2777,CC:2F:71:3F:1F:24,4563161,1254279202,728882,770688483,3834279,483590719,37,581148,589347533,580438,589262085,710,85448,561148,15,729138,83627,34,483,144444.0,43333.0,-71.0,-66.0,-70.0,-70.0,-71.0,-66.0,-70.0,-70.0,-87.0,-86.0,-84.0,-85.0,16.0,20.0,14.0,15.0,1
2778,CC:2F:71:3E:C5:1F,3835138,483695641,859,104922,3834279,483590719,0,3590,301444,2962,226896,628,74548,909,8,1236,19,0,37,144444.0,39000.0,-67.0,-73.0,-69.0,-63.0,-67.0,-72.0,-67.0,-62.0,-87.0,-86.0,-84.0,-85.0,20.0,13.0,15.0,22.0,1
2779,BA:8C:B9:54:50:24,3839100,489771804,4821,6181085,3834279,483590719,0,8907,1693309,8885,1689814,22,3495,2345,15,5251,39,0,56,229410.0,130000.0,-48.0,-35.0,-43.0,-45.0,-43.0,-35.0,-44.0,-48.0,-87.0,-86.0,-84.0,-85.0,39.0,51.0,41.0,40.0,1
2780,3C:55:76:E8:8F:1F,3834800,484202646,514,611261,3834286,483591385,0,1523,263786,1336,229644,187,34142,702,10,525,39,0,52,172050.0,48750.0,-46.0,-57.0,-45.0,-43.0,-45.0,-55.0,-44.0,-42.0,-87.0,-86.0,-84.0,-85.0,41.0,29.0,39.0,42.0,1
2781,92:69:1D:31:68:E9,3838160,487199055,3874,3607670,3834286,483591385,0,4669,1084833,4530,1053403,139,31430,2085,10,4068,84,0,41,216660.0,130000.0,-53.0,-49.0,-43.0,-49.0,-52.0,-48.0,-43.0,-49.0,-87.0,-86.0,-84.0,-85.0,34.0,37.0,41.0,36.0,1
2782,CC:2F:71:3F:1F:24,4563363,1254527338,729077,770935953,3834286,483591385,37,581335,589597637,580625,589512189,710,85448,561323,15,729333,83658,34,483,130000.0,43333.0,-68.0,-67.0,-71.0,-74.0,-68.0,-67.0,-71.0,-74.0,-87.0,-86.0,-84.0,-85.0,19.0,19.0,13.0,11.0,1
2783,CC:2F:71:3E:C5:1F,3835145,483696307,859,104922,3834286,483591385,0,3590,301444,2962,226896,628,74548,909,8,1236,19,0,37,144444.0,39000.0,-67.0,-73.0,-69.0,-63.0,-67.0,-72.0,-67.0,-62.0,-87.0,-86.0,-84.0,-85.0,20.0,13.0,15.0,22.0,1
2784,BA:8C:B9:54:50:24,3839107,489772470,4821,6181085,3834286,483591385,0,8907,1693309,8885,1689814,22,3495,2345,15,5251,39,0,56,229410.0,130000.0,-48.0,-35.0,-43.0,-45.0,-43.0,-35.0,-44.0,-48.0,-87.0,-86.0,-84.0,-85.0,39.0,51.0,41.0,40.0,1
2785,3C:55:76:E8:8F:1F,3834803,484202964,515,611377,3834288,483591587,0,1535,264642,1348,230500,187,34142,703,10,526,39,0,52,172050.0,48750.0,-46.0,-51.0,-46.0,-43.0,-47.0,-54.0,-45.0,-42.0,-87.0,-86.0,-84.0,-85.0,41.0,35.0,38.0,42.0,1
2786,92:69:1D:31:68:E9,3838162,487199257,3874,3607670,3834288,483591587,0,4669,1084833,4530,1053403,139,31430,2085,10,4068,84,0,41,216660.0,130000.0,-53.0,-49.0,-43.0,-49.0,-52.0,-48.0,-43.0,-49.0,-87.0,-86.0,-84.0,-85.0,34.0,37.0,41.0,36.0,1
2787,CC:2F:71:3F:1F:24,4563554,1254768590,729266,771177003,3834288,483591587,37,581506,589827115,580796,589741667,710,85448,561491,15,729522,83661,34,483,130000.0,43333.0,-70.0,-66.0,-70.0,-73.0,-69.0,-66.0,-70.0,-72.0,-87.0,-86.0,-84.0,-85.0,17.0,20.0,14.0,12.0,1
2788,CC:2F:71:3E:C5:1F,3835149,483696711,859,104922,3834290,483591789,0,3590,301444,2962,226896,628,74548,909,8,1236,19,0,37,144444.0,39000.0,-67.0,-73.0,-69.0,-63.0,-67.0,-72.0,-67.0,-62.0,-87.0,-86.0,-84.0,-85.0,20.0,13.0,15.0,22.0,1
2789,BA:8C:B9:54:50:24,3839113,489773076,4821,6181085,3834292,483591991,0,8907,1693309,8885,1689814,22,3495,2345,15,5251,39,0,56,229410.0,130000.0,-48.0,-35.0,-43.0,-45.0,-43.0,-35.0,-44.0,-48.0,-87.0,-86.0,-84.0,-85.0,39.0,51.0,41.0,40.0,1
2790,3C:55:76:E8:8F:1F,3834810,484203729,515,611377,3834295,483592352,0,1540,265133,1352,230776,188,34357,704,10,526,39,0,52,172050.0,48750.0,-44.0,-49.0,-44.0,-42.0,-45.0,-50.0,-44.0,-42.0,-87.0,-86.0,-84.0,-85.0,43.0,37.0,40.0,43.0,1
2791,92:69:1D:31:68:E9,3838169,487200022,3874,3607670,3834295,483592352,0,4669,1084833,4530,1053403,139,31430,2085,10,4068,84,0,41,216660.0,130000.0,-53.0,-49.0,-43.0,-49.0,-52.0,-48.0,-43.0,-49.0,-87.0,-86.0,-84.0,-85.0,34.0,37.0,41.0,36.0,1
2792,CC:2F:71:3F:1F:24,4563765,1255032027,729470,771439675,3834295,483592352,37,581706,590097317,580996,590011869,710,85448,561676,15,729726,83684,34,484,130000.0,39000.0,-71.0,-67.0,-71.0,-70.0,-71.0,-66.0,-70.0,-70.0,-87.0,-86.0,-84.0,-85.0,16.0,19.0,13.0,15.0,1
2793,CC:2F:71:3E:C5:1F,3835154,483697274,859,104922,3834295,483592352,0,3590,301444,2962,226896,628,74548,909,8,1236,19,0,37,144444.0,39000.0,-67.0,-73.0,-69.0,-63.0,-67.0,-72.0,-67.0,-62.0,-87.0,-86.0,-84.0,-85.0,20.0,13.0,15.0,22.0,1
2794,BA:8C:B9:54:50:24,3839117,489773497,4821,6181085,3834296,483592412,0,8907,1693309,8885,1689814,22,3495,2345,15,5251,39,0,56,229410.0,130000.0,-48.0,-35.0,-43.0,-45.0,-43.0,-35.0,-44.0,-48.0,-87.0,-86.0,-84.0,-85.0,39.0,51.0,41.0,40.0,1
2795,3C:55:76:E8:8F:1F,3834815,484204193,515,611377,3834300,483592816,0,1543,265339,1355,230982,188,34357,704,10,526,39,0,52,172050.0,48750.0,-48.0,-52.0,-48.0,-45.0,-45.0,-49.0,-44.0,-42.0,-87.0,-86.0,-84.0,-85.0,39.0,34.0,36.0,40.0,1
2796,92:69:1D:31:68:E9,3838174,487200486,3874,3607670,3834300,483592816,0,4669,1084833,4530,1053403,139,31430,2085,10,4068,84,0,41,216660.0,130000.0,-53.0,-49.0,-43.0,-49.0,-52.0,-48.0,-43.0,-49.0,-87.0,-86.0,-84.0,-85.0,34.0,37.0,41.0,36.0,1
2797,CC:2F:71:3F:1F:24,4563978,1255289612,729676,771696594,3834302,483593018,37,581893,590343330,581183,590257882,710,85448,561858,15,729932,83697,34,484,130000.0,43333.0,-71.0,-67.0,-70.0,-70.0,-71.0,-66.0,-69.0,-70.0,-87.0,-86.0,-84.0,-85.0,16.0,19.0,14.0,15.0,1
2798,CC:2F:71:3E:C5:1F,3835162,483698056,860,105038,3834302,483593018,0,3592,301584,2964,227036,628,74548,909,8,1237,19,0,37,144444.0,39000.0,-72.0,-71.0,-69.0,-60.0,-67.0,-72.0,-68.0,-62.0,-87.0,-86.0,-84.0,-85.0,15.0,15.0,15.0,25.0,1
2799,BA:8C:B9:54:50:24,3839124,489774219,4822,6181201,3834302,483593018,0,8911,1693581,8889,1690086,22,3495,2345,15,5252,39,0,56,229410.0,130000.0,-39.0,-36.0,-46.0,-52.0,-43.0,-35.0,-43.0,-47.0,-87.0,-86.0,-84.0,-85.0,48.0,50.0,38.0,33.0,1
2800,3C:55:76:E8:8F:1F,3834821,484204775,516,611493,3834305,483593282,0,1550,265869,1361,231394,189,34475,705,10,527,39,0,52,172050.0,48750.0,-45.0,-52.0,-52.0,-40.0,-44.0,-50.0,-48.0,-40.0,-87.0,-86.0,-84.0,-85.0,42.0,34.0,32.0,45.0,1
2801,92:69:1D:31:68:E9,3838181,487201130,3875,3607786,3834306,483593344,0,4671,1084969,4532,1053539,139,31430,2085,10,4069,84,0,41,216660.0,130000.0,-53.0,-47.0,-42.0,-48.0,-53.0,-48.0,-42.0,-49.0,-87.0,-86.0,-84.0,-85.0,34.0,39.0,42.0,37.0,1
2802,CC:2F:71:3F:1F:24,4564174,1255535426,729868,771942082,3834306,483593344,37,582076,590588634,581366,590503186,710,85448,562031,15,730124,83704,34,484,130000.0,43333.0,-72.0,-66.0,-69.0,-75.0,-71.0,-65.0,-68.0,-74.0,-87.0,-86.0,-84.0,-85.0,15.0,20.0,15.0,10.0,1
2803,CC:2F:71:3E:C5:1F,3835166,483698382,860,105038,3834306,483593344,0,3592,301584,2964,227036,628,74548,909,8,1237,19,0,37,144444.0,39000.0,-72.0,-71.0,-69.0,-60.0,-67.0,-72.0,-68.0,-62.0,-87.0,-86.0,-84.0,-85.0,15.0,15.0,15.0,25.0,1
2804,BA:8C:B9:54:50:24,3839128,489774545,4822,6181201,3834306,483593344,0,8911,1693581,8889,1690086,22,3495,2345,15,5252,39,0,56,229410.0,130000.0,-39.0,-36.0,-46.0,-52.0,-43.0,-35.0,-43.0,-47.0,-87.0,-86.0,-84.0,-85.0,48.0,50.0,38.0,33.0,1
2805,3C:55:76:E8:8F:1F,3834828,484205574,516,611493,3834312,483594081,0,1557,266399,1367,231806,190,34593,706,10,527,39,0,52,172050.0,48750.0,-47.0,-46.0,-45.0,-43.0,-46.0,-47.0,-46.0,-41.0,-88.0,-87.0,-84.0,-85.0,41.0,41.0,39.0,42.0,1
2806,92:69:1D:31:68:E9,3838187,487201867,3875,3607786,3834312,483594081,0,4671,1084969,4532,1053539,139,31430,2085,10,4069,84,0,41,216660.0,130000.0,-53.0,-47.0,-42.0,-48.0,-53.0,-48.0,-42.0,-49.0,-88.0,-87.0,-84.0,-85.0,35.0,40.0,42.0,37.0,1
2807,CC:2F:71:3F:1F:24,4564376,1255784737,730062,772190454,3834314,483594283,37,582256,590832058,581546,590746610,710,85448,562203,15,730317,83719,34,484,130000.0,43333.0,-71.0,-66.0,-70.0,-76.0,-71.0,-66.0,-70.0,-76.0,-88.0,-87.0,-84.0,-85.0,17.0,21.0,14.0,9.0,1
2808,CC:2F:71:3E:C5:1F,3835174,483699321,860,105038,3834314,483594283,0,3592,301584,2964,227036,628,74548,909,8,1237,19,0,37,144444.0,39000.0,-72.0,-71.0,-69.0,-60.0,-67.0,-72.0,-68.0,-62.0,-88.0,-87.0,-84.0,-85.0,16.0,16.0,15.0,25.0,1
2809,BA:8C:B9:54:50:24,3839136,489775484,4822,6181201,3834314,483594283,0,8911,1693581,8889,1690086,22,3495,2345,15,5252,39,0,56,229410.0,130000.0,-39.0,-36.0,-46.0,-52.0,-43.0,-35.0,-43.0,-47.0,-88.0,-87.0,-84.0,-85.0,49.0,51.0,38.0,33.0,1
2810,3C:55:76:E8:8F:1F,3834832,484205978,516,611493,3834316,483594485,0,1557,266399,1367,231806,190,34593,706,10,527,39,0,52,172050.0,48750.0,-47.0,-46.0,-45.0,-43.0,-46.0,-47.0,-46.0,-41.0,-88.0,-87.0,-84.0,-85.0,41.0,41.0,39.0,42.0,1
2811,92:69:1D:31:68:E9,3838191,487202271,3875,3607786,3834316,483594485,0,4671,1084969,4532,1053539,139,31430,2085,10,4069,84,0,41,216660.0,130000.0,-53.0,-47.0,-42.0,-48.0,-53.0,-48.0,-42.0,-49.0,-88.0,-87.0,-84.0,-85.0,35.0,40.0,42.0,37.0,1
2812,CC:2F:71:3F:1F:24,4564583,1256038896,730267,772444411,3834316,483594485,37,582450,591080557,581740,590995109,710,85448,562389,15,730523,83764,34,485,115556.0,28889.0,-74.0,-67.0,-70.0,-74.0,-73.0,-66.0,-70.0,-74.0,-88.0,-87.0,-84.0,-85.0,14.0,20.0,14.0,11.0,1
2813,CC:2F:71:3E:C5:1F,3835176,483699523,860,105038,3834316,483594485,0,3592,301584,2964,227036,628,74548,909,8,1237,19,0,37,144444.0,39000.0,-72.0,-71.0,-69.0,-60.0,-67.0,-72.0,-68.0,-62.0,-88.0,-87.0,-84.0,-85.0,16.0,16.0,15.0,25.0,1
2814,BA:8C:B9:54:50:24,3839138,489775686,4822,6181201,3834316,483594485,0,8911,1693581,8889,1690086,22,3495,2345,15,5252,39,0,56,229410.0,130000.0,-39.0,-36.0,-46.0,-52.0,-43.0,-35.0,-43.0,-47.0,-88.0,-87.0,-84.0,-85.0,49.0,51.0,38.0,33.0,1
2815,3C:55:76:E8:8F:1F,3834836,484206382,516,611493,3834320,483594889,0,1557,266399,1367,231806,190,34593,706,10,527,39,0,52,172050.0,48750.0,-47.0,-46.0,-45.0,-43.0,-46.0,-47.0,-46.0,-41.0,-88.0,-87.0,-84.0,-85.0,41.0,41.0,39.0,42.0,1
2816,92:69:1D:31:68:E9,3838197,487202877,3875,3607786,3834322,483595091,0,4671,1084969,4532,1053539,139,31430,2085,10,4069,84,0,41,216660.0,130000.0,-53.0,-47.0,-42.0,-48.0,-53.0,-48.0,-42.0,-49.0,-88.0,-87.0,-84.0,-85.0,35.0,40.0,42.0,37.0,1
2817,CC:2F:71:3F:1F:24,4564781,1256283678,730459,772688587,3834322,483595091,37,582630,591324009,581920,591238561,710,85448,562559,15,730715,83793,34,485,115556.0,28889.0,-72.0,-66.0,-69.0,-73.0,-72.0,-66.0,-68.0,-73.0,-88.0,-87.0,-84.0,-85.0,16.0,21.0,15.0,12.0,1
2818,CC:2F:71:3E:C5:1F,3835183,483700189,860,105038,3834323,483595151,0,3592,301584,2964,227036,628,74548,909,8,1237,19,0,37,144444.0,39000.0,-72.0,-71.0,-69.0,-60.0,-67.0,-72.0,-68.0,-62.0,-88.0,-87.0,-84.0,-85.0,16.0,16.0,15.0,25.0,1
2819,BA:8C:B9:54:50:24,3839145,489776352,4822,6181201,3834323,483595151,0,8911,1693581,8889,1690086,22,3495,2345,15,5252,39,0,56,229410.0,130000.0,-39.0,-36.0,-46.0,-52.0,-43.0,-35.0,-43.0,-47.0,-88.0,-87.0,-84.0,-85.0,49.0,51.0,38.0,33.0,1
2820,3C:55:76:E8:8F:1F,3834843,484207214,516,611493,3834327,483595721,0,1557,266399,1367,231806,190,34593,706,10,527,39,0,52,172050.0,48750.0,-47.0,-46.0,-45.0,-43.0,-46.0,-47.0,-46.0,-41.0,-88.0,-87.0,-84.0,-85.0,41.0,41.0,39.0,42.0,1
2821,92:69:1D:31:68:E9,3838202,487203507,3875,3607786,3834327,483595721,0,4671,1084969,4532,1053539,139,31430,2085,10,4069,84,0,41,216660.0,130000.0,-53.0,-47.0,-42.0,-48.0,-53.0,-48.0,-42.0,-49.0,-88.0,-87.0,-84.0,-85.0,35.0,40.0,42.0,37.0,1
2822,CC:2F:71:3F:1F:24,4564980,1256531368,730653,772935647,3834327,483595721,37,582810,591567433,582100,591481985,710,85448,562731,15,730909,83822,34,485,117000.0,39000.0,-73.0,-66.0,-67.0,-75.0,-73.0,-66.0,-67.0,-75.0,-88.0,-87.0,-84.0,-85.0,15.0,21.0,17.0,10.0,1
2823,CC:2F:71:3E:C5:1F,3835188,483700893,860,105038,3834328,483595855,0,3592,301584,2964,227036,628,74548,909,8,1237,19,0,37,144444.0,39000.0,-72.0,-71.0,-69.0,-60.0,-67.0,-72.0,-68.0,-62.0,-88.0,-87.0,-84.0,-85.0,16.0,16.0,15.0,25.0,1
2824,BA:8C:B9:54:50:24,3839151,489777124,4822,6181201,3834329,483595923,0,8911,1693581,8889,1690086,22,3495,2345,15,5252,39,0,56,229410.0,130000.0,-39.0,-36.0,-46.0,-52.0,-43.0,-35.0,-43.0,-47.0,-88.0,-87.0,-84.0,-85.0,49.0,51.0,38.0,33.0,1
2825,3C:55:76:E8:8F:1F,3834852,484208415,518,612026,3834334,483596389,0,1572,267762,1382,233169,190,34593,709,10,529,39,0,52,172050.0,48750.0,-50.0,-52.0,-46.0,-45.0,-49.0,-52.0,-45.0,-44.0,-88.0,-87.0,-84.0,-85.0,38.0,35.0,38.0,40.0,1
2826,92:69:1D:31:68:E9,3838209,487204175,3875,3607786,3834334,483596389,0,4671,1084969,4532,1053539,139,31430,2085,10,4069,84,0,41,216660.0,130000.0,-53.0,-47.0,-42.0,-48.0,-53.0,-48.0,-42.0,-49.0,-88.0,-87.0,-84.0,-85.0,35.0,40.0,42.0,37.0,1
2827,CC:2F:71:3F:1F:24,4565179,1256778332,730845,773181943,3834334,483596389,37,582994,591812867,582282,591727183,712,85684,562904,15,731101,83882,34,486,104000.0,26000.0,-73.0,-67.0,-69.0,-75.0,-73.0,-66.0,-68.0,-75.0,-88.0,-87.0,-84.0,-85.0,15.0,20.0,15.0,10.0,1
2828,CC:2F:71:3E:C5:1F,3835194,483701427,860,105038,3834334,483596389,0,3592,301584,2964,227036,628,74548,909,8,1237,19,0,37,144444.0,39000.0,-72.0,-71.0,-69.0,-60.0,-67.0,-72.0,-68.0,-62.0,-88.0,-87.0,-84.0,-85.0,16.0,16.0,15.0,25.0,1
2829,BA:8C:B9:54:50:24,3839156,489777590,4822,6181201,3834334,483596389,0,8911,1693581,8889,1690086,22,3495,2345,15,5252,39,0,56,229410.0,130000.0,-39.0,-36.0,-46.0,-52.0,-43.0,-35.0,-43.0,-47.0,-88.0,-87.0,-84.0,-85.0,49.0,51.0,38.0,33.0,1
2830,3C:55:76:E8:8F:1F,3834858,484209142,521,612491,3834337,483596651,0,1577,269222,1387,234629,190,34593,713,10,532,39,0,52,172050.0,1000.0,-49.0,-52.0,-47.0,-46.0,-47.0,-51.0,-46.0,-44.0,-88.0,-87.0,-84.0,-85.0,39.0,35.0,37.0,39.0,1
2831,92:69:1D:31:68:E9,3838214,487204639,3875,3607786,3834339,483596853,0,4671,1084969,4532,1053539,139,31430,2085,10,4069,84,0,41,216660.0,130000.0,-53.0,-47.0,-42.0,-48.0,-53.0,-48.0,-42.0,-49.0,-88.0,-87.0,-84.0,-85.0,35.0,40.0,42.0,37.0,1
2832,CC:2F:71:3F:1F:24,4565388,1257034061,731049,773437208,3834339,483596853,37,583181,592058894,582469,591973210,712,85684,563085,15,731304,83883,34,486,115556.0,28889.0,-71.0,-66.0,-69.0,-75.0,-71.0,-66.0,-68.0,-74.0,-88.0,-87.0,-84.0,-85.0,17.0,21.0,15.0,10.0,1
2833,CC:2F:71:3E:C5:1F,3835199,483701891,860,105038,3834339,483596853,0,3592,301584,2964,227036,628,74548,909,8,1237,19,0,37,144444.0,39000.0,-72.0,-71.0,-69.0,-60.0,-67.0,-72.0,-68.0,-62.0,-88.0,-87.0,-84.0,-85.0,16.0,16.0,15.0,25.0,1
2834,BA:8C:B9:54:50:24,3839163,489778338,4824,6181485,3834339,483596853,0,8917,1694121,8895,1690626,22,3495,2347,15,5254,39,0,56,229410.0,130000.0,-48.0,-35.0,-43.0,-45.0,-44.0,-35.0,-44.0,-48.0,-88.0,-87.0,-84.0,-85.0,40.0,52.0,41.0,40.0,1
2835,3C:55:76:E8:8F:1F,3834866,484210018,523,612761,3834343,483597257,0,1589,270202,1399,235609,190,34593,716,10,534,39,0,52,172050.0,51610.0,-46.0,-57.0,-56.0,-41.0,-45.0,-55.0,-56.0,-40.0,-88.0,-87.0,-84.0,-85.0,42.0,30.0,28.0,44.0,1
2836,92:69:1D:31:68:E9,3838218,487205043,3875,3607786,3834343,483597257,0,4671,1084969,4532,1053539,139,31430,2085,10,4069,84,0,41,216660.0,130000.0,-53.0,-47.0,-42.0,-48.0,-53.0,-48.0,-42.0,-49.0,-88.0,-87.0,-84.0,-85.0,35.0,40.0,42.0,37.0,1
2837,CC:2F:71:3F:1F:24,4565584,1257280065,731241,773682808,3834343,483597257,37,583357,592296068,582645,592210384,712,85684,563256,15,731497,83890,34,486,115556.0,26000.0,-71.0,-67.0,-69.0,-73.0,-71.0,-66.0,-68.0,-72.0,-88.0,-87.0,-84.0,-85.0,17.0,20.0,15.0,12.0,1
2838,CC:2F:71:3E:C5:1F,3835203,483702295,860,105038,3834343,483597257,0,3594,301724,2966,227176,628,74548,909,8,1238,19,0,37,144444.0,39000.0,-71.0,-73.0,-69.0,-60.0,-68.0,-72.0,-69.0,-61.0,-88.0,-87.0,-84.0,-85.0,17.0,14.0,15.0,25.0,1
2839,BA:8C:B9:54:50:24,3839167,489778742,4824,6181485,3834343,483597257,0,8917,1694121,8895,1690626,22,3495,2347,15,5254,39,0,56,229410.0,130000.0,-48.0,-35.0,-43.0,-45.0,-44.0,-35.0,-44.0,-48.0,-88.0,-87.0,-84.0,-85.0,40.0,52.0,41.0,40.0,1
2840,3C:55:76:E8:8F:1F,3834871,484210484,523,612761,3834348,483597723,0,1591,270390,1400,235679,191,34711,717,10,534,39,0,53,172050.0,51610.0,-44.0,-50.0,-47.0,-36.0,-45.0,-54.0,-53.0,-39.0,-88.0,-87.0,-84.0,-85.0,44.0,37.0,37.0,49.0,1
2841,92:69:1D:31:68:E9,3838224,487205569,3875,3607786,3834349,483597783,0,4673,1085105,4534,1053675,139,31430,2085,10,4070,84,0,41,216660.0,130000.0,-53.0,-47.0,-42.0,-48.0,-53.0,-47.0,-42.0,-48.0,-88.0,-87.0,-84.0,-85.0,35.0,40.0,42.0,37.0,1
2842,CC:2F:71:3F:1F:24,4565782,1257521567,731433,773923784,3834349,483597783,37,583547,592552338,582835,592466654,712,85684,563425,15,731689,83912,34,486,130000.0,43333.0,-73.0,-67.0,-69.0,-73.0,-73.0,-66.0,-68.0,-73.0,-88.0,-87.0,-84.0,-85.0,15.0,20.0,15.0,12.0,1
2843,CC:2F:71:3E:C5:1F,3835211,483703023,860,105038,3834351,483597985,0,3594,301724,2966,227176,628,74548,909,8,1238,19,0,37,144444.0,39000.0,-71.0,-73.0,-69.0,-60.0,-68.0,-72.0,-69.0,-61.0,-88.0,-87.0,-84.0,-85.0,17.0,14.0,15.0,25.0,1
2844,BA:8C:B9:54:50:24,3839175,489779470,4824,6181485,3834351,483597985,0,8917,1694121,8895,1690626,22,3495,2347,15,5254,39,0,56,229410.0,130000.0,-48.0,-35.0,-43.0,-45.0,-44.0,-35.0,-44.0,-48.0,-88.0,-87.0,-85.0,-85.0,40.0,52.0,42.0,40.0,1
2845,3C:55:76:E8:8F:1F,3834876,484210948,523,612761,3834353,483598187,0,1596,270732,1405,236021,191,34711,717,10,534,39,0,55,172050.0,51610.0,-44.0,-49.0,-45.0,-37.0,-44.0,-50.0,-47.0,-37.0,-88.0,-87.0,-85.0,-85.0,44.0,38.0,40.0,48.0,1
2846,92:69:1D:31:68:E9,3838228,487205973,3875,3607786,3834353,483598187,0,4673,1085105,4534,1053675,139,31430,2085,10,4070,84,0,41,216660.0,130000.0,-53.0,-47.0,-42.0,-48.0,-53.0,-47.0,-42.0,-48.0,-88.0,-87.0,-85.0,-85.0,35.0,40.0,43.0,37.0,1
2847,CC:2F:71:3F:1F:24,4565980,1257767943,731627,774169756,3834353,483598187,37,583724,592791154,583012,592705470,712,85684,563596,15,731883,83915,34,486,130000.0,43333.0,-73.0,-67.0,-69.0,-74.0,-73.0,-67.0,-68.0,-74.0,-88.0,-87.0,-85.0,-85.0,15.0,20.0,16.0,11.0,1
2848,CC:2F:71:3E:C5:1F,3835213,483703225,860,105038,3834353,483598187,0,3594,301724,2966,227176,628,74548,909,8,1238,19,0,37,144444.0,39000.0,-71.0,-73.0,-69.0,-60.0,-68.0,-72.0,-69.0,-61.0,-88.0,-87.0,-85.0,-85.0,17.0,14.0,16.0,25.0,1
2849,BA:8C:B9:54:50:24,3839179,489779874,4824,6181485,3834355,483598389,0,8917,1694121,8895,1690626,22,3495,2347,15,5254,39,0,56,229410.0,130000.0,-48.0,-35.0,-43.0,-45.0,-44.0,-35.0,-44.0,-48.0,-88.0,-87.0,-85.0,-85.0,40.0,52.0,42.0,40.0,1
2850,3C:55:76:E8:8F:1F,3834883,484211746,524,612829,3834359,483598917,0,1603,271498,1411,236467,192,35031,719,10,535,39,0,56,162500.0,48750.0,-51.0,-50.0,-45.0,-42.0,-48.0,-49.0,-44.0,-40.0,-88.0,-87.0,-85.0,-85.0,37.0,37.0,40.0,43.0,1
2851,92:69:1D:31:68:E9,3838236,487206905,3875,3607786,3834361,483599119,0,4673,1085105,4534,1053675,139,31430,2085,10,4070,84,0,41,216660.0,130000.0,-53.0,-47.0,-42.0,-48.0,-53.0,-47.0,-42.0,-48.0,-88.0,-87.0,-85.0,-85.0,35.0,40.0,43.0,37.0,1
2852,CC:2F:71:3F:1F:24,4566186,1258014856,731825,774415737,3834361,483599119,37,583907,593028283,583195,592942599,712,85684,563772,15,732081,83927,34,486,130000.0,43333.0,-73.0,-67.0,-68.0,-74.0,-73.0,-67.0,-68.0,-74.0,-88.0,-87.0,-85.0,-85.0,15.0,20.0,17.0,11.0,1
2853,CC:2F:71:3E:C5:1F,3835221,483704157,860,105038,3834361,483599119,0,3596,301912,2967,227246,629,74666,910,8,1238,19,0,37,144444.0,39000.0,-71.0,-72.0,-69.0,-60.0,-69.0,-72.0,-69.0,-60.0,-88.0,-87.0,-85.0,-85.0,17.0,15.0,16.0,25.0,1
2854,BA:8C:B9:54:50:24,3839185,489780604,4824,6181485,3834361,483599119,0,8917,1694121,8895,1690626,22,3495,2347,15,5254,39,0,56,229410.0,130000.0,-48.0,-35.0,-43.0,-45.0,-44.0,-35.0,-44.0,-48.0,-88.0,-87.0,-85.0,-85.0,40.0,52.0,42.0,40.0,1
2855,3C:55:76:E8:8F:1F,3834888,484212210,524,612829,3834364,483599381,0,1604,271568,1412,236537,192,35031,719,10,535,39,0,56,162500.0,48750.0,-52.0,-50.0,-45.0,-43.0,-49.0,-49.0,-44.0,-41.0,-88.0,-87.0,-85.0,-85.0,36.0,37.0,40.0,42.0,1
2856,92:69:1D:31:68:E9,3838239,487207167,3875,3607786,3834364,483599381,0,4673,1085105,4534,1053675,139,31430,2085,10,4070,84,0,41,216660.0,130000.0,-53.0,-47.0,-42.0,-48.0,-53.0,-47.0,-42.0,-48.0,-88.0,-87.0,-85.0,-85.0,35.0,40.0,43.0,37.0,1
2857,CC:2F:71:3F:1F:24,4566390,1258271744,732026,774672363,3834364,483599381,37,584096,593285513,583384,593199829,712,85684,563950,15,732282,83935,34,486,130000.0,43333.0,-73.0,-66.0,-68.0,-74.0,-73.0,-66.0,-68.0,-73.0,-88.0,-87.0,-85.0,-85.0,15.0,21.0,17.0,11.0,1
2858,CC:2F:71:3E:C5:1F,3835224,483704419,860,105038,3834364,483599381,0,3596,301912,2967,227246,629,74666,910,8,1238,19,0,37,144444.0,39000.0,-71.0,-72.0,-69.0,-60.0,-69.0,-72.0,-69.0,-60.0,-88.0,-87.0,-85.0,-85.0,17.0,15.0,16.0,25.0,1
2859,BA:8C:B9:54:50:24,3839190,489781068,4824,6181485,3834366,483599583,0,8920,1694325,8898,1690830,22,3495,2347,15,5254,39,0,56,229410.0,130000.0,-41.0,-38.0,-48.0,-52.0,-45.0,-36.0,-44.0,-48.0,-88.0,-87.0,-85.0,-85.0,47.0,49.0,37.0,33.0,1
2860,3C:55:76:E8:8F:1F,3834895,484212890,525,612903,3834370,483599987,0,1611,272085,1419,237054,192,35031,720,10,536,39,0,56,162500.0,48750.0,-53.0,-51.0,-45.0,-42.0,-50.0,-49.0,-43.0,-39.0,-88.0,-87.0,-85.0,-85.0,35.0,36.0,40.0,43.0,1
2861,92:69:1D:31:68:E9,3838245,487207773,3875,3607786,3834370,483599987,0,4673,1085105,4534,1053675,139,31430,2085,10,4070,84,0,41,216660.0,130000.0,-53.0,-47.0,-42.0,-48.0,-53.0,-47.0,-42.0,-48.0,-88.0,-87.0,-85.0,-85.0,35.0,40.0,43.0,37.0,1
2862,CC:2F:71:3F:1F:24,4566592,1258519782,732222,774919795,3834370,483599987,37,584275,593526005,583563,593440321,712,85684,564121,15,732477,83953,34,486,130000.0,43333.0,-74.0,-66.0,-70.0,-74.0,-73.0,-66.0,-70.0,-74.0,-88.0,-87.0,-85.0,-85.0,14.0,21.0,15.0,11.0,1
2863,CC:2F:71:3E:C5:1F,3835230,483705025,860,105038,3834370,483599987,0,3596,301912,2967,227246,629,74666,910,8,1238,19,0,37,144444.0,39000.0,-71.0,-72.0,-69.0,-60.0,-69.0,-72.0,-69.0,-60.0,-88.0,-87.0,-85.0,-85.0,17.0,15.0,16.0,25.0,1
2864,BA:8C:B9:54:50:24,3839195,489781588,4825,6181601,3834370,483599987,0,8927,1694839,8905,1691344,22,3495,2348,15,5255,39,0,56,229410.0,130000.0,-48.0,-35.0,-43.0,-45.0,-42.0,-36.0,-45.0,-50.0,-88.0,-87.0,-85.0,-85.0,40.0,52.0,42.0,40.0,1
2865,3C:55:76:E8:8F:1F,3834902,484213689,529,613440,3834373,483600249,0,1625,274221,1433,239190,192,35031,724,10,540,39,0,56,162500.0,48750.0,-50.0,-58.0,-45.0,-39.0,-50.0,-56.0,-46.0,-39.0,-88.0,-87.0,-85.0,-85.0,38.0,29.0,40.0,46.0,1
2866,92:69:1D:31:68:E9,3838249,487208308,3875,3607786,3834374,483600522,0,4673,1085105,4534,1053675,139,31430,2085,10,4070,84,0,41,216660.0,130000.0,-53.0,-47.0,-42.0,-48.0,-53.0,-47.0,-42.0,-48.0,-88.0,-87.0,-85.0,-85.0,35.0,40.0,43.0,37.0,1
2867,CC:2F:71:3F:1F:24,4566816,1258793548,732440,775192824,3834376,483600724,37,584476,593787979,583764,593702295,712,85684,564318,15,732696,83956,34,489,144444.0,39000.0,-71.0,-66.0,-69.0,-72.0,-71.0,-66.0,-69.0,-72.0,-88.0,-87.0,-85.0,-85.0,17.0,21.0,16.0,13.0,1
2868,CC:2F:71:3E:C5:1F,3835236,483705762,860,105038,3834376,483600724,0,3596,301912,2967,227246,629,74666,910,8,1238,19,0,37,144444.0,39000.0,-71.0,-72.0,-69.0,-60.0,-69.0,-72.0,-69.0,-60.0,-88.0,-87.0,-85.0,-85.0,17.0,15.0,16.0,25.0,1
2869,BA:8C:B9:54:50:24,3839201,489782325,4825,6181601,3834376,483600724,0,8928,1694907,8906,1691412,22,3495,2348,15,5255,39,0,56,229410.0,130000.0,-48.0,-35.0,-43.0,-45.0,-42.0,-35.0,-44.0,-49.0,-88.0,-87.0,-85.0,-85.0,40.0,52.0,42.0,40.0,1
2870,3C:55:76:E8:8F:1F,3834936,484237553,556,636425,3834380,483601128,0,1665,287464,1473,252433,192,35031,744,10,567,39,0,56,162500.0,48750.0,-49.0,-55.0,-47.0,-45.0,-48.0,-55.0,-47.0,-45.0,-88.0,-87.0,-85.0,-85.0,39.0,32.0,38.0,40.0,1
2871,92:69:1D:31:68:E9,3838255,487208914,3875,3607786,3834380,483601128,0,4673,1085105,4534,1053675,139,31430,2085,10,4070,84,0,41,216660.0,130000.0,-53.0,-47.0,-42.0,-48.0,-53.0,-47.0,-42.0,-48.0,-88.0,-87.0,-85.0,-85.0,35.0,40.0,43.0,37.0,1
2872,CC:2F:71:3F:1F:24,4567016,1259041482,732636,775440354,3834380,483601128,37,584654,594024145,583942,593938461,712,85684,564492,15,732892,83969,34,489,130000.0,43333.0,-70.0,-67.0,-69.0,-74.0,-70.0,-66.0,-68.0,-73.0,-88.0,-87.0,-85.0,-85.0,18.0,20.0,16.0,11.0,1
2873,CC:2F:71:3E:C5:1F,3835242,483706368,860,105038,3834382,483601330,0,3596,301912,2967,227246,629,74666,910,8,1238,19,0,37,144444.0,39000.0,-71.0,-72.0,-69.0,-60.0,-69.0,-72.0,-69.0,-60.0,-88.0,-87.0,-85.0,-85.0,17.0,15.0,16.0,25.0,1
2874,BA:8C:B9:54:50:24,3839207,489782931,4825,6181601,3834382,483601330,0,8928,1694907,8906,1691412,22,3495,2348,15,5255,39,0,56,229410.0,130000.0,-48.0,-35.0,-43.0,-45.0,-42.0,-35.0,-44.0,-49.0,-88.0,-87.0,-85.0,-86.0,40.0,52.0,42.0,41.0,1
2875,3C:55:76:E8:8F:1F,3835025,484413859,641,812327,3834384,483601532,0,1726,300408,1534,265377,192,35031,782,10,652,39,0,56,195000.0,97500.0,-51.0,-52.0,-49.0,-46.0,-49.0,-51.0,-50.0,-45.0,-88.0,-87.0,-85.0,-86.0,37.0,35.0,36.0,40.0,1
2876,92:69:1D:31:68:E9,3838259,487209318,3875,3607786,3834384,483601532,0,4673,1085105,4534,1053675,139,31430,2085,10,4070,84,0,41,216660.0,130000.0,-53.0,-47.0,-42.0,-48.0,-53.0,-47.0,-42.0,-48.0,-88.0,-87.0,-85.0,-86.0,35.0,40.0,43.0,38.0,1
2877,CC:2F:71:3F:1F:24,4567215,1259289428,732831,775687896,3834384,483601532,37,584833,594263185,584121,594177501,712,85684,564665,15,733087,83972,34,489,130000.0,43333.0,-71.0,-66.0,-69.0,-76.0,-71.0,-66.0,-69.0,-75.0,-88.0,-87.0,-85.0,-86.0,17.0,21.0,16.0,10.0,1
2878,CC:2F:71:3E:C5:1F,3835244,483706570,860,105038,3834384,483601532,0,3596,301912,2967,227246,629,74666,910,8,1238,19,0,37,144444.0,39000.0,-71.0,-72.0,-69.0,-60.0,-69.0,-72.0,-69.0,-60.0,-88.0,-87.0,-85.0,-86.0,17.0,15.0,16.0,26.0,1
2879,BA:8C:B9:54:50:24,3839209,489783133,4825,6181601,3834384,483601532,0,8928,1694907,8906,1691412,22,3495,2348,15,5255,39,0,56,229410.0,130000.0,-48.0,-35.0,-43.0,-45.0,-42.0,-35.0,-44.0,-49.0,-88.0,-87.0,-85.0,-86.0,40.0,52.0,42.0,41.0,1
2880,3C:55:76:E8:8F:1F,3835069,484448699,680,846703,3834389,483601996,0,1814,349288,1622,314257,192,35031,837,10,691,39,0,56,216660.0,130000.0,-52.0,-54.0,-48.0,-45.0,-51.0,-53.0,-48.0,-45.0,-88.0,-87.0,-85.0,-86.0,36.0,33.0,37.0,41.0,1
2881,92:69:1D:31:68:E9,3838264,487209782,3875,3607786,3834389,483601996,0,4673,1085105,4534,1053675,139,31430,2085,10,4070,84,0,41,216660.0,130000.0,-53.0,-47.0,-42.0,-48.0,-53.0,-47.0,-42.0,-48.0,-88.0,-87.0,-85.0,-86.0,35.0,40.0,43.0,38.0,1
2882,CC:2F:71:3F:1F:24,4567412,1259533972,733023,775931976,3834389,483601996,37,585013,594505255,584301,594419571,712,85684,564835,15,733279,83983,34,489,130000.0,43333.0,-69.0,-67.0,-69.0,-75.0,-69.0,-67.0,-69.0,-74.0,-88.0,-87.0,-85.0,-86.0,19.0,20.0,16.0,11.0,1
2883,CC:2F:71:3E:C5:1F,3835251,483707236,860,105038,3834391,483602198,0,3596,301912,2967,227246,629,74666,910,8,1238,19,0,37,144444.0,39000.0,-71.0,-72.0,-69.0,-60.0,-69.0,-72.0,-69.0,-60.0,-88.0,-87.0,-85.0,-86.0,17.0,15.0,16.0,26.0,1
2884,BA:8C:B9:54:50:24,3839216,489783799,4825,6181601,3834391,483602198,0,8928,1694907,8906,1691412,22,3495,2348,15,5255,39,0,56,229410.0,130000.0,-48.0,-35.0,-43.0,-45.0,-42.0,-35.0,-44.0,-49.0,-88.0,-87.0,-85.0,-86.0,40.0,52.0,42.0,41.0,1
2885,3C:55:76:E8:8F:1F,3835198,484568998,805,966598,3834393,483602400,0,1997,456461,1805,421430,192,35031,960,10,815,45,0,57,270830.0,162500.0,-52.0,-54.0,-48.0,-44.0,-52.0,-54.0,-48.0,-44.0,-88.0,-87.0,-85.0,-86.0,36.0,33.0,37.0,42.0,1
2886,92:69:1D:31:68:E9,3838268,487210186,3875,3607786,3834393,483602400,0,4673,1085105,4534,1053675,139,31430,2085,10,4070,84,0,41,216660.0,130000.0,-53.0,-47.0,-42.0,-48.0,-53.0,-47.0,-42.0,-48.0,-88.0,-87.0,-85.0,-86.0,35.0,40.0,43.0,38.0,1
2887,CC:2F:71:3F:1F:24,4567617,1259785035,733224,776182635,3834393,483602400,37,585198,594748299,584486,594662615,712,85684,565014,15,733480,83992,34,489,130000.0,43333.0,-70.0,-67.0,-68.0,-72.0,-70.0,-67.0,-67.0,-71.0,-88.0,-87.0,-85.0,-86.0,18.0,20.0,17.0,14.0,1
2888,CC:2F:71:3E:C5:1F,3835253,483707438,860,105038,3834393,483602400,0,3596,301912,2967,227246,629,74666,910,8,1238,19,0,37,144444.0,39000.0,-71.0,-72.0,-69.0,-60.0,-69.0,-72.0,-69.0,-60.0,-88.0,-87.0,-85.0,-86.0,17.0,15.0,16.0,26.0,1
2889,BA:8C:B9:54:50:24,3839220,489784203,4825,6181601,3834395,483602602,0,8928,1694907,8906,1691412,22,3495,2348,15,5255,39,0,56,229410.0,130000.0,-48.0,-35.0,-43.0,-45.0,-42.0,-35.0,-44.0,-49.0,-88.0,-87.0,-85.0,-86.0,40.0,52.0,42.0,41.0,1
2890,3C:55:76:E8:8F:1F,3835382,484810635,982,1207393,3834400,483603242,0,2213,596785,2019,561264,194,35521,1105,10,993,55,0,58,258080.0,154850.0,-51.0,-54.0,-47.0,-44.0,-49.0,-53.0,-46.0,-43.0,-88.0,-87.0,-85.0,-86.0,37.0,33.0,38.0,42.0,1
2891,92:69:1D:31:68:E9,3838276,487211096,3875,3607786,3834401,483603310,0,4673,1085105,4534,1053675,139,31430,2085,10,4070,84,0,41,216660.0,130000.0,-53.0,-47.0,-42.0,-48.0,-53.0,-47.0,-42.0,-48.0,-88.0,-87.0,-85.0,-86.0,35.0,40.0,43.0,38.0,1
2892,CC:2F:71:3F:1F:24,4567821,1260033397,733419,776429953,3834402,483603444,37,585382,594993715,584670,594908031,712,85684,565186,15,733675,83999,34,489,130000.0,43333.0,-71.0,-67.0,-71.0,-74.0,-71.0,-67.0,-70.0,-74.0,-88.0,-87.0,-85.0,-86.0,17.0,20.0,14.0,12.0,1
2893,CC:2F:71:3E:C5:1F,3835262,483708482,860,105038,3834402,483603444,0,3596,301912,2967,227246,629,74666,910,8,1238,19,0,37,144444.0,39000.0,-71.0,-72.0,-69.0,-60.0,-69.0,-72.0,-69.0,-60.0,-88.0,-87.0,-85.0,-86.0,17.0,15.0,16.0,26.0,1
2894,BA:8C:B9:54:50:24,3839227,489785045,4825,6181601,3834402,483603444,0,8928,1694907,8906,1691412,22,3495,2348,15,5255,39,0,56,229410.0,130000.0,-48.0,-35.0,-43.0,-45.0,-42.0,-35.0,-44.0,-49.0,-88.0,-87.0,-85.0,-86.0,40.0,52.0,42.0,41.0,1
2895,3C:55:76:E8:8F:1F,3835453,484903052,1049,1299406,3834404,483603646,0,2281,615997,2087,580476,194,35521,1149,12,1062,61,0,59,258080.0,1000.0,-47.0,-51.0,-47.0,-44.0,-46.0,-50.0,-47.0,-43.0,-88.0,-87.0,-85.0,-86.0,41.0,36.0,38.0,42.0,1
2896,92:69:1D:31:68:E9,3838279,487211432,3875,3607786,3834404,483603646,0,4673,1085105,4534,1053675,139,31430,2085,10,4070,84,0,41,216660.0,130000.0,-53.0,-47.0,-42.0,-48.0,-53.0,-47.0,-42.0,-48.0,-88.0,-87.0,-85.0,-86.0,35.0,40.0,43.0,38.0,1
2897,CC:2F:71:3F:1F:24,4568017,1260278075,733611,776674227,3834406,483603848,37,585560,595233939,584848,595148255,712,85684,565357,15,733867,84002,34,489,130000.0,43333.0,-71.0,-67.0,-70.0,-74.0,-71.0,-67.0,-70.0,-73.0,-88.0,-87.0,-85.0,-86.0,17.0,20.0,15.0,12.0,1
2898,CC:2F:71:3E:C5:1F,3835268,483709264,860,105038,3834408,483604226,0,3596,301912,2967,227246,629,74666,910,8,1238,19,0,37,144444.0,39000.0,-71.0,-72.0,-69.0,-60.0,-69.0,-72.0,-69.0,-60.0,-88.0,-87.0,-85.0,-86.0,17.0,15.0,16.0,26.0,1
2899,BA:8C:B9:54:50:24,3839233,489785827,4825,6181601,3834408,483604226,0,8928,1694907,8906,1691412,22,3495,2348,15,5255,39,0,56,229410.0,130000.0,-48.0,-35.0,-43.0,-45.0,-42.0,-35.0,-44.0,-49.0,-88.0,-87.0,-85.0,-86.0,40.0,52.0,42.0,41.0,1
2900,3C:55:76:E8:8F:1F,3835532,484970058,1120,1365428,3834412,483604630,0,2386,669828,2190,633817,196,36011,1207,12,1133,64,0,60,258080.0,146250.0,-52.0,-53.0,-48.0,-46.0,-49.0,-51.0,-46.0,-43.0,-88.0,-87.0,-85.0,-86.0,36.0,34.0,37.0,40.0,1
2901,92:69:1D:31:68:E9,3838287,487212416,3875,3607786,3834412,483604630,0,4673,1085105,4534,1053675,139,31430,2085,10,4070,84,0,41,216660.0,130000.0,-53.0,-47.0,-42.0,-48.0,-53.0,-47.0,-42.0,-48.0,-88.0,-87.0,-85.0,-86.0,35.0,40.0,43.0,38.0,1
2902,CC:2F:71:3F:1F:24,4568217,1260526101,733805,776921471,3834412,483604630,37,585741,595476321,585029,595390637,712,85684,565529,15,734061,84008,34,489,144444.0,43333.0,-70.0,-67.0,-69.0,-74.0,-70.0,-67.0,-69.0,-73.0,-88.0,-87.0,-85.0,-86.0,18.0,20.0,16.0,12.0,1
2903,CC:2F:71:3E:C5:1F,3835272,483709668,860,105038,3834412,483604630,0,3596,301912,2967,227246,629,74666,910,8,1238,19,0,37,144444.0,39000.0,-71.0,-72.0,-69.0,-60.0,-69.0,-72.0,-69.0,-60.0,-88.0,-87.0,-85.0,-86.0,17.0,15.0,16.0,26.0,1
2904,BA:8C:B9:54:50:24,3839238,489786291,4825,6181601,3834413,483604690,0,8928,1694907,8906,1691412,22,3495,2348,15,5255,39,0,56,229410.0,130000.0,-48.0,-35.0,-43.0,-45.0,-42.0,-35.0,-44.0,-49.0,-88.0,-87.0,-85.0,-86.0,40.0,52.0,42.0,41.0,1
2905,3C:55:76:E8:8F:1F,3835583,485003272,1164,1397770,3834419,483605502,0,2461,713609,2263,677078,198,36531,1249,12,1177,64,0,61,243750.0,146250.0,-50.0,-50.0,-45.0,-39.0,-50.0,-52.0,-45.0,-41.0,-88.0,-87.0,-85.0,-86.0,38.0,37.0,40.0,47.0,1
2906,92:69:1D:31:68:E9,3838294,487213288,3875,3607786,3834419,483605502,0,4673,1085105,4534,1053675,139,31430,2085,10,4070,84,0,41,216660.0,130000.0,-53.0,-47.0,-42.0,-48.0,-53.0,-47.0,-42.0,-48.0,-88.0,-87.0,-85.0,-86.0,35.0,40.0,43.0,38.0,1
2907,CC:2F:71:3F:1F:24,4568426,1260778032,734007,777172530,3834419,483605502,37,585937,595729436,585225,595643752,712,85684,565710,15,734263,84008,34,489,144444.0,43333.0,-70.0,-66.0,-70.0,-75.0,-70.0,-66.0,-70.0,-74.0,-88.0,-87.0,-85.0,-86.0,18.0,21.0,15.0,11.0,1
2908,CC:2F:71:3E:C5:1F,3835279,483710540,860,105038,3834419,483605502,0,3596,301912,2967,227246,629,74666,910,8,1238,19,0,37,144444.0,39000.0,-71.0,-72.0,-69.0,-60.0,-69.0,-72.0,-69.0,-60.0,-88.0,-87.0,-85.0,-86.0,17.0,15.0,16.0,26.0,1
2909,BA:8C:B9:54:50:24,3839244,489787103,4825,6181601,3834419,483605502,0,8928,1694907,8906,1691412,22,3495,2348,15,5255,39,0,56,229410.0,130000.0,-48.0,-35.0,-43.0,-45.0,-42.0,-35.0,-44.0,-49.0,-88.0,-87.0,-85.0,-86.0,40.0,52.0,42.0,41.0,1
2910,3C:55:76:E8:8F:1F,3835589,485004084,1164,1397770,3834425,483606314,0,2478,715155,2278,678104,200,37051,1251,12,1177,64,0,61,243750.0,146250.0,-49.0,-50.0,-46.0,-41.0,-47.0,-48.0,-44.0,-39.0,-88.0,-87.0,-85.0,-86.0,39.0,37.0,39.0,45.0,1
2911,92:69:1D:31:68:E9,3838300,487214100,3875,3607786,3834425,483606314,0,4673,1085105,4534,1053675,139,31430,2085,10,4070,84,0,41,216660.0,130000.0,-53.0,-47.0,-42.0,-48.0,-53.0,-47.0,-42.0,-48.0,-88.0,-87.0,-85.0,-86.0,35.0,40.0,43.0,38.0,1
2912,CC:2F:71:3F:1F:24,4568623,1261023002,734198,777416688,3834425,483606314,37,586111,595964892,585399,595879208,712,85684,565880,15,734454,84009,34,489,144444.0,43333.0,-70.0,-67.0,-70.0,-75.0,-70.0,-66.0,-70.0,-74.0,-88.0,-87.0,-85.0,-86.0,18.0,20.0,15.0,11.0,1
2913,CC:2F:71:3E:C5:1F,3835285,483711352,860,105038,3834425,483606314,0,3596,301912,2967,227246,629,74666,910,8,1238,19,0,37,144444.0,39000.0,-71.0,-72.0,-69.0,-60.0,-69.0,-72.0,-69.0,-60.0,-88.0,-87.0,-85.0,-86.0,17.0,15.0,16.0,26.0,1
2914,BA:8C:B9:54:50:24,3839250,489787915,4825,6181601,3834425,483606314,0,8928,1694907,8906,1691412,22,3495,2348,15,5255,39,0,56,229410.0,130000.0,-48.0,-35.0,-43.0,-45.0,-42.0,-35.0,-44.0,-49.0,-88.0,-87.0,-85.0,-86.0,40.0,52.0,42.0,41.0,1
2915,3C:55:76:E8:8F:1F,3835612,485009193,1180,1402037,3834432,483607156,0,2553,795251,2351,757710,202,37541,1286,12,1193,70,0,62,216660.0,130000.0,-50.0,-55.0,-47.0,-43.0,-50.0,-54.0,-47.0,-43.0,-88.0,-87.0,-85.0,-86.0,38.0,32.0,38.0,43.0,1
2916,92:69:1D:31:68:E9,3838307,487214942,3875,3607786,3834432,483607156,0,4673,1085105,4534,1053675,139,31430,2085,10,4070,84,0,41,216660.0,130000.0,-53.0,-47.0,-42.0,-48.0,-53.0,-47.0,-42.0,-48.0,-88.0,-87.0,-85.0,-86.0,35.0,40.0,43.0,38.0,1
2917,CC:2F:71:3F:1F:24,4568822,1261265284,734390,777658128,3834432,483607156,37,586289,596205154,585577,596119470,712,85684,566049,15,734646,84011,34,489,144444.0,43333.0,-70.0,-66.0,-71.0,-74.0,-70.0,-66.0,-70.0,-74.0,-88.0,-87.0,-85.0,-86.0,18.0,21.0,14.0,12.0,1
2918,CC:2F:71:3E:C5:1F,3835292,483712194,860,105038,3834432,483607156,0,3596,301912,2967,227246,629,74666,910,8,1238,19,0,37,144444.0,39000.0,-71.0,-72.0,-69.0,-60.0,-69.0,-72.0,-69.0,-60.0,-88.0,-87.0,-85.0,-86.0,17.0,15.0,16.0,26.0,1
2919,BA:8C:B9:54:50:24,3839257,489788757,4825,6181601,3834432,483607156,0,8928,1694907,8906,1691412,22,3495,2348,15,5255,39,0,56,229410.0,130000.0,-48.0,-35.0,-43.0,-45.0,-42.0,-35.0,-44.0,-49.0,-88.0,-87.0,-85.0,-86.0,40.0,52.0,42.0,41.0,1
2920,3C:55:76:E8:8F:1F,3835618,485009837,1182,1402277,3834436,483607560,0,2567,796245,2365,758704,202,37541,1287,12,1195,70,0,62,216660.0,130000.0,-48.0,-48.0,-46.0,-40.0,-46.0,-48.0,-45.0,-40.0,-88.0,-87.0,-85.0,-86.0,40.0,39.0,39.0,46.0,1
2921,92:69:1D:31:68:E9,3838312,487215462,3876,3607902,3834436,483607560,0,4675,1085241,4536,1053811,139,31430,2085,10,4071,84,0,41,216660.0,130000.0,-51.0,-47.0,-43.0,-48.0,-52.0,-47.0,-42.0,-48.0,-88.0,-87.0,-85.0,-86.0,37.0,40.0,42.0,38.0,1
2922,CC:2F:71:3F:1F:24,4569026,1261511208,734590,777903648,3834436,483607560,37,586468,596437463,585756,596351779,712,85684,566225,15,734846,84073,34,489,130000.0,43333.0,-70.0,-66.0,-69.0,-73.0,-70.0,-66.0,-69.0,-73.0,-88.0,-87.0,-85.0,-86.0,18.0,21.0,16.0,13.0,1
2923,CC:2F:71:3E:C5:1F,3835299,483713092,861,105154,3834438,483607938,0,3598,302052,2969,227386,629,74666,910,8,1239,19,0,37,144444.0,39000.0,-71.0,-72.0,-68.0,-60.0,-70.0,-72.0,-68.0,-60.0,-88.0,-88.0,-85.0,-86.0,17.0,16.0,17.0,26.0,1
2924,BA:8C:B9:54:50:24,3839264,489789655,4826,6181717,3834438,483607938,0,8930,1695043,8908,1691548,22,3495,2348,15,5256,39,0,56,229410.0,130000.0,-48.0,-35.0,-43.0,-45.0,-44.0,-35.0,-43.0,-47.0,-88.0,-88.0,-85.0,-86.0,40.0,53.0,42.0,41.0,1
2925,3C:55:76:E8:8F:1F,3835627,485011143,1185,1402801,3834442,483608342,0,2584,799348,2380,761317,204,38031,1294,12,1198,70,0,63,216660.0,130000.0,-51.0,-59.0,-48.0,-43.0,-50.0,-57.0,-48.0,-42.0,-88.0,-88.0,-85.0,-86.0,37.0,29.0,37.0,43.0,1
2926,92:69:1D:31:68:E9,3838318,487216244,3876,3607902,3834442,483608342,0,4675,1085241,4536,1053811,139,31430,2085,10,4071,84,0,41,216660.0,130000.0,-51.0,-47.0,-43.0,-48.0,-52.0,-47.0,-42.0,-48.0,-88.0,-88.0,-85.0,-86.0,37.0,41.0,42.0,38.0,1
2927,CC:2F:71:3F:1F:24,4569225,1261756408,734783,778148066,3834442,483608342,37,586644,596676027,585932,596590343,712,85684,566395,15,735039,84075,34,489,130000.0,43333.0,-71.0,-66.0,-70.0,-74.0,-70.0,-66.0,-70.0,-74.0,-88.0,-88.0,-85.0,-86.0,17.0,22.0,15.0,12.0,1
2928,CC:2F:71:3E:C5:1F,3835304,483713556,861,105154,3834443,483608402,0,3598,302052,2969,227386,629,74666,910,8,1239,19,0,37,144444.0,39000.0,-71.0,-72.0,-68.0,-60.0,-70.0,-72.0,-68.0,-60.0,-88.0,-88.0,-85.0,-86.0,17.0,16.0,17.0,26.0,1
2929,BA:8C:B9:54:50:24,3839271,489790321,4826,6181717,3834445,483608604,0,8930,1695043,8908,1691548,22,3495,2348,15,5256,39,0,56,229410.0,130000.0,-48.0,-35.0,-43.0,-45.0,-44.0,-35.0,-43.0,-47.0,-88.0,-88.0,-85.0,-86.0,40.0,53.0,42.0,41.0,1
2930,3C:55:76:E8:8F:1F,3835674,485109888,1225,1500747,3834449,483609141,0,2614,809763,2409,771614,205,38149,1312,12,1223,70,0,64,229410.0,130000.0,-51.0,-56.0,-46.0,-42.0,-51.0,-54.0,-46.0,-42.0,-88.0,-88.0,-85.0,-86.0,37.0,32.0,39.0,44.0,1
2931,92:69:1D:31:68:E9,3838325,487217043,3876,3607902,3834449,483609141,0,4675,1085241,4536,1053811,139,31430,2085,10,4071,84,0,41,216660.0,130000.0,-51.0,-47.0,-43.0,-48.0,-52.0,-47.0,-42.0,-48.0,-88.0,-88.0,-85.0,-86.0,37.0,41.0,42.0,38.0,1
2932,CC:2F:71:3F:1F:24,4569423,1262001197,734974,778392056,3834449,483609141,37,586820,596914633,586108,596828949,712,85684,566565,15,735230,84075,34,489,144444.0,43333.0,-71.0,-66.0,-70.0,-74.0,-71.0,-66.0,-70.0,-74.0,-88.0,-88.0,-85.0,-86.0,17.0,22.0,15.0,12.0,1
2933,CC:2F:71:3E:C5:1F,3835310,483714295,861,105154,3834449,483609141,0,3598,302052,2969,227386,629,74666,910,8,1239,19,0,37,144444.0,39000.0,-71.0,-72.0,-68.0,-60.0,-70.0,-72.0,-68.0,-60.0,-88.0,-88.0,-85.0,-86.0,17.0,16.0,17.0,26.0,1
2934,BA:8C:B9:54:50:24,3839275,489790858,4826,6181717,3834449,483609141,0,8930,1695043,8908,1691548,22,3495,2348,15,5256,39,0,56,229410.0,130000.0,-48.0,-35.0,-43.0,-45.0,-44.0,-35.0,-43.0,-47.0,-88.0,-88.0,-85.0,-86.0,40.0,53.0,42.0,41.0,1
2935,3C:55:76:E8:8F:1F,3836050,486222970,1597,2613425,3834453,483609545,0,2726,821706,2521,783557,205,38149,1394,12,1610,108,0,65,243750.0,146250.0,-50.0,-56.0,-46.0,-42.0,-51.0,-55.0,-46.0,-43.0,-88.0,-88.0,-85.0,-86.0,38.0,32.0,39.0,44.0,1
2936,92:69:1D:31:68:E9,3838329,487217447,3876,3607902,3834453,483609545,0,4675,1085241,4536,1053811,139,31430,2085,10,4071,84,0,41,216660.0,130000.0,-51.0,-47.0,-43.0,-48.0,-52.0,-47.0,-42.0,-48.0,-88.0,-88.0,-85.0,-86.0,37.0,41.0,42.0,38.0,1
2937,CC:2F:71:3F:1F:24,4569620,1262245961,735165,778636214,3834455,483609747,37,587000,597158051,586288,597072367,712,85684,566734,15,735419,84075,34,489,144444.0,43333.0,-71.0,-67.0,-71.0,-75.0,-71.0,-67.0,-71.0,-74.0,-88.0,-88.0,-85.0,-86.0,17.0,21.0,14.0,11.0,1
2938,CC:2F:71:3E:C5:1F,3835316,483714901,861,105154,3834455,483609747,0,3598,302052,2969,227386,629,74666,910,8,1239,19,0,37,144444.0,39000.0,-71.0,-72.0,-68.0,-60.0,-70.0,-72.0,-68.0,-60.0,-88.0,-88.0,-85.0,-86.0,17.0,16.0,17.0,26.0,1
2939,BA:8C:B9:54:50:24,3839281,489791464,4826,6181717,3834455,483609747,0,8930,1695043,8908,1691548,22,3495,2348,15,5256,39,0,56,229410.0,130000.0,-48.0,-35.0,-43.0,-45.0,-44.0,-35.0,-43.0,-47.0,-88.0,-88.0,-85.0,-86.0,40.0,53.0,42.0,41.0,1
2940,3C:55:76:E8:8F:1F,3836287,486896152,1828,3286081,3834459,483610071,0,2808,843883,2603,805734,205,38149,1448,12,1836,121,0,65,270830.0,162500.0,-51.0,-55.0,-46.0,-43.0,-51.0,-55.0,-45.0,-43.0,-88.0,-88.0,-85.0,-86.0,37.0,33.0,39.0,43.0,1
2941,92:69:1D:31:68:E9,3838335,487217973,3876,3607902,3834459,483610071,0,4675,1085241,4536,1053811,139,31430,2085,10,4071,84,0,41,216660.0,130000.0,-51.0,-47.0,-43.0,-48.0,-52.0,-47.0,-42.0,-48.0,-88.0,-88.0,-85.0,-86.0,37.0,41.0,42.0,38.0,1
2942,CC:2F:71:3F:1F:24,4569825,1262495112,735366,778885041,3834459,483610071,37,587193,597410774,586481,597325090,712,85684,566913,15,735622,84076,34,489,144444.0,43333.0,-70.0,-67.0,-71.0,-75.0,-71.0,-68.0,-72.0,-75.0,-88.0,-88.0,-85.0,-86.0,18.0,21.0,14.0,11.0,1
2943,CC:2F:71:3E:C5:1F,3835320,483715225,861,105154,3834459,483610071,0,3600,302240,2970,227456,630,74784,911,8,1239,19,0,37,144444.0,39000.0,-81.0,-84.0,-75.0,-72.0,-72.0,-73.0,-69.0,-61.0,-88.0,-88.0,-85.0,-86.0,7.0,4.0,10.0,14.0,1
2944,BA:8C:B9:54:50:24,3839287,489791990,4826,6181717,3834461,483610273,0,8930,1695043,8908,1691548,22,3495,2348,15,5256,39,0,56,229410.0,130000.0,-48.0,-35.0,-43.0,-45.0,-44.0,-35.0,-43.0,-47.0,-88.0,-88.0,-85.0,-86.0,40.0,53.0,42.0,41.0,1
2945,3C:55:76:E8:8F:1F,3836698,487994675,2233,4383998,3834465,483610677,0,2962,889427,2757,851278,205,38149,1562,12,2246,127,0,65,229410.0,130000.0,-49.0,-53.0,-45.0,-43.0,-50.0,-53.0,-45.0,-43.0,-88.0,-88.0,-85.0,-86.0,39.0,35.0,40.0,43.0,1
2946,92:69:1D:31:68:E9,3838341,487218579,3876,3607902,3834465,483610677,0,4675,1085241,4536,1053811,139,31430,2085,10,4071,84,0,41,216660.0,130000.0,-51.0,-47.0,-43.0,-48.0,-52.0,-47.0,-42.0,-48.0,-88.0,-88.0,-85.0,-86.0,37.0,41.0,42.0,38.0,1
2947,CC:2F:71:3F:1F:24,4570026,1262743244,735561,779132567,3834465,483610677,37,587376,597656040,586664,597570356,712,85684,567085,15,735817,84078,34,489,144444.0,43333.0,-70.0,-67.0,-70.0,-74.0,-70.0,-67.0,-70.0,-74.0,-88.0,-88.0,-85.0,-86.0,18.0,21.0,15.0,12.0,1
2948,CC:2F:71:3E:C5:1F,3835326,483715831,861,105154,3834465,483610677,0,3600,302240,2970,227456,630,74784,911,8,1239,19,0,37,144444.0,39000.0,-81.0,-84.0,-75.0,-72.0,-72.0,-73.0,-69.0,-61.0,-88.0,-88.0,-85.0,-86.0,7.0,4.0,10.0,14.0,1
2949,BA:8C:B9:54:50:24,3839291,489792394,4826,6181717,3834465,483610677,0,8930,1695043,8908,1691548,22,3495,2348,15,5256,39,0,56,229410.0,130000.0,-48.0,-35.0,-43.0,-45.0,-44.0,-35.0,-43.0,-47.0,-88.0,-88.0,-85.0,-86.0,40.0,53.0,42.0,41.0,1
2950,3C:55:76:E8:8F:1F,3836787,488153782,2319,4542643,3834468,483611139,0,3068,921048,2862,882583,206,38465,1612,12,2310,128,0,65,243750.0,146250.0,-50.0,-52.0,-45.0,-43.0,-51.0,-54.0,-46.0,-43.0,-88.0,-88.0,-85.0,-86.0,38.0,36.0,40.0,43.0,1
2951,92:69:1D:31:68:E9,3838344,487219041,3876,3607902,3834468,483611139,0,4675,1085241,4536,1053811,139,31430,2085,10,4071,84,0,41,216660.0,130000.0,-51.0,-47.0,-43.0,-48.0,-52.0,-47.0,-42.0,-48.0,-88.0,-88.0,-85.0,-86.0,37.0,41.0,42.0,38.0,1
2952,CC:2F:71:3F:1F:24,4570224,1262988326,735754,779376985,3834470,483611341,37,587552,597894590,586840,597808906,712,85684,567256,15,736010,84079,34,489,144444.0,43333.0,-70.0,-67.0,-71.0,-74.0,-70.0,-67.0,-70.0,-73.0,-88.0,-88.0,-85.0,-86.0,18.0,21.0,14.0,12.0,1
2953,CC:2F:71:3E:C5:1F,3835332,483716555,861,105154,3834471,483611401,0,3600,302240,2970,227456,630,74784,911,8,1239,19,0,37,144444.0,39000.0,-81.0,-84.0,-75.0,-72.0,-72.0,-73.0,-69.0,-61.0,-88.0,-88.0,-85.0,-86.0,7.0,4.0,10.0,14.0,1
2954,BA:8C:B9:54:50:24,3839297,489793118,4826,6181717,3834471,483611401,0,8930,1695043,8908,1691548,22,3495,2348,15,5256,39,0,56,229410.0,130000.0,-48.0,-35.0,-43.0,-45.0,-44.0,-35.0,-43.0,-47.0,-88.0,-88.0,-85.0,-86.0,40.0,53.0,42.0,41.0,1
2955,3C:55:76:E8:8F:1F,3836900,488457791,2424,4845924,3834476,483611867,0,3125,929604,2919,891139,206,38465,1637,12,2437,139,0,65,258080.0,154850.0,-49.0,-54.0,-45.0,-43.0,-50.0,-53.0,-45.0,-43.0,-88.0,-88.0,-85.0,-86.0,39.0,34.0,40.0,43.0,1
2956,92:69:1D:31:68:E9,3838352,487219769,3876,3607902,3834476,483611867,0,4675,1085241,4536,1053811,139,31430,2085,10,4071,84,0,41,216660.0,130000.0,-51.0,-47.0,-43.0,-48.0,-52.0,-47.0,-42.0,-48.0,-88.0,-88.0,-85.0,-86.0,37.0,41.0,42.0,38.0,1
2957,CC:2F:71:3F:1F:24,4570426,1263239356,735950,779627489,3834476,483611867,37,587732,598136570,587020,598050886,712,85684,567430,15,736206,84080,34,489,144444.0,43333.0,-70.0,-67.0,-70.0,-73.0,-70.0,-67.0,-70.0,-73.0,-88.0,-88.0,-85.0,-86.0,18.0,21.0,15.0,13.0,1
2958,CC:2F:71:3E:C5:1F,3835337,483717021,861,105154,3834476,483611867,0,3600,302240,2970,227456,630,74784,911,8,1239,19,0,37,144444.0,39000.0,-81.0,-84.0,-75.0,-72.0,-72.0,-73.0,-69.0,-61.0,-88.0,-88.0,-85.0,-86.0,7.0,4.0,10.0,14.0,1
2959,BA:8C:B9:54:50:24,3839302,489793584,4826,6181717,3834476,483611867,0,8930,1695043,8908,1691548,22,3495,2348,15,5256,39,0,56,229410.0,130000.0,-48.0,-35.0,-43.0,-45.0,-44.0,-35.0,-43.0,-47.0,-88.0,-88.0,-85.0,-86.0,40.0,53.0,42.0,41.0,1
2960,3C:55:76:E8:8F:1F,3836969,488614472,2489,5002201,3834480,483612271,0,3179,957823,2973,919358,206,38465,1663,12,2502,153,0,65,243750.0,1000.0,-49.0,-53.0,-46.0,-44.0,-49.0,-53.0,-45.0,-43.0,-88.0,-88.0,-85.0,-86.0,39.0,35.0,39.0,42.0,1
2961,92:69:1D:31:68:E9,3838356,487220173,3876,3607902,3834480,483612271,0,4677,1085377,4538,1053947,139,31430,2085,10,4072,84,0,42,216660.0,130000.0,-52.0,-47.0,-42.0,-48.0,-52.0,-47.0,-42.0,-48.0,-88.0,-88.0,-85.0,-86.0,36.0,41.0,43.0,38.0,1
2962,CC:2F:71:3F:1F:24,4570630,1263485573,736150,779873302,3834480,483612271,37,587916,598372473,587204,598286789,712,85684,567607,15,736406,84082,34,489,144444.0,43333.0,-70.0,-67.0,-71.0,-73.0,-69.0,-66.0,-70.0,-73.0,-88.0,-88.0,-85.0,-86.0,18.0,21.0,14.0,13.0,1
2963,CC:2F:71:3E:C5:1F,3835343,483717627,861,105154,3834482,483612473,0,3600,302240,2970,227456,630,74784,911,8,1239,19,0,37,144444.0,39000.0,-81.0,-84.0,-75.0,-72.0,-72.0,-73.0,-69.0,-61.0,-88.0,-88.0,-85.0,-86.0,7.0,4.0,10.0,14.0,1
2964,BA:8C:B9:54:50:24,3839308,489794190,4826,6181717,3834482,483612473,0,8932,1695179,8910,1691684,22,3495,2348,15,5257,39,0,56,229410.0,130000.0,-39.0,-36.0,-45.0,-51.0,-43.0,-35.0,-44.0,-48.0,-88.0,-88.0,-85.0,-86.0,49.0,52.0,40.0,35.0,1
2965,3C:55:76:E8:8F:1F,3836977,488615647,2492,5002912,3834485,483612735,0,3196,963995,2990,925530,206,38465,1667,12,2505,153,0,65,243750.0,146250.0,-48.0,-51.0,-47.0,-39.0,-47.0,-50.0,-47.0,-39.0,-88.0,-88.0,-86.0,-87.0,40.0,37.0,39.0,48.0,1
2966,92:69:1D:31:68:E9,3838361,487220637,3876,3607902,3834485,483612735,0,4678,1085445,4539,1054015,139,31430,2085,10,4072,84,0,42,216660.0,130000.0,-52.0,-47.0,-44.0,-47.0,-52.0,-47.0,-42.0,-47.0,-88.0,-88.0,-86.0,-87.0,36.0,41.0,42.0,40.0,1
2967,CC:2F:71:3F:1F:24,4570824,1263727087,736339,780114352,3834485,483612735,37,588097,598617477,587385,598531793,712,85684,567776,15,736595,84083,34,489,144444.0,43333.0,-70.0,-67.0,-70.0,-74.0,-70.0,-67.0,-70.0,-73.0,-88.0,-88.0,-86.0,-87.0,18.0,21.0,16.0,13.0,1
2968,CC:2F:71:3E:C5:1F,3835346,483717889,861,105154,3834485,483612735,0,3600,302240,2970,227456,630,74784,911,8,1239,19,0,37,144444.0,39000.0,-81.0,-84.0,-75.0,-72.0,-72.0,-73.0,-69.0,-61.0,-88.0,-88.0,-86.0,-87.0,7.0,4.0,11.0,15.0,1
2969,BA:8C:B9:54:50:24,3839311,489794452,4826,6181717,3834485,483612735,0,8932,1695179,8910,1691684,22,3495,2348,15,5257,39,0,56,229410.0,130000.0,-39.0,-36.0,-45.0,-51.0,-43.0,-35.0,-44.0,-48.0,-88.0,-88.0,-86.0,-87.0,49.0,52.0,41.0,36.0,1
2970,3C:55:76:E8:8F:1F,3836991,488619146,2502,5006007,3834489,483613139,0,3237,987687,3031,949222,206,38465,1679,12,2515,153,0,65,243750.0,146250.0,-46.0,-49.0,-45.0,-37.0,-47.0,-50.0,-46.0,-39.0,-88.0,-88.0,-86.0,-87.0,42.0,39.0,41.0,50.0,1
2971,92:69:1D:31:68:E9,3838367,487221243,3876,3607902,3834491,483613341,0,4678,1085445,4539,1054015,139,31430,2085,10,4072,84,0,42,216660.0,130000.0,-52.0,-47.0,-44.0,-47.0,-52.0,-47.0,-42.0,-47.0,-88.0,-88.0,-86.0,-87.0,36.0,41.0,42.0,40.0,1
2972,CC:2F:71:3F:1F:24,4571025,1263975219,736534,780361878,3834491,483613341,37,588278,598858231,587566,598772547,712,85684,567948,15,736790,84084,34,489,144444.0,43333.0,-70.0,-67.0,-70.0,-73.0,-70.0,-67.0,-70.0,-73.0,-88.0,-88.0,-86.0,-87.0,18.0,21.0,16.0,14.0,1
2973,CC:2F:71:3E:C5:1F,3835352,483718495,861,105154,3834491,483613341,0,3600,302240,2970,227456,630,74784,911,8,1239,19,0,37,144444.0,39000.0,-81.0,-84.0,-75.0,-72.0,-72.0,-73.0,-69.0,-61.0,-88.0,-88.0,-86.0,-87.0,7.0,4.0,11.0,15.0,1
2974,BA:8C:B9:54:50:24,3839317,489795058,4826,6181717,3834491,483613341,0,8932,1695179,8910,1691684,22,3495,2348,15,5257,39,0,56,229410.0,130000.0,-39.0,-36.0,-45.0,-51.0,-43.0,-35.0,-44.0,-48.0,-88.0,-88.0,-86.0,-87.0,49.0,52.0,41.0,36.0,1
2975,3C:55:76:E8:8F:1F,3836999,488620003,2505,5006398,3834494,483613605,0,3255,992737,3048,954154,207,38583,1684,12,2518,153,0,66,243750.0,146250.0,-49.0,-52.0,-44.0,-41.0,-47.0,-50.0,-45.0,-39.0,-88.0,-88.0,-86.0,-87.0,39.0,36.0,42.0,46.0,1
2976,92:69:1D:31:68:E9,3838370,487221507,3876,3607902,3834494,483613605,0,4678,1085445,4539,1054015,139,31430,2085,10,4072,84,0,42,216660.0,130000.0,-52.0,-47.0,-44.0,-47.0,-52.0,-47.0,-42.0,-47.0,-88.0,-88.0,-86.0,-87.0,36.0,41.0,42.0,40.0,1
2977,CC:2F:71:3F:1F:24,4571219,1264216739,736724,780603074,3834495,483613665,37,588459,599101813,587747,599016129,712,85684,568118,15,736980,84085,34,489,144444.0,43333.0,-70.0,-67.0,-71.0,-74.0,-70.0,-67.0,-70.0,-73.0,-88.0,-88.0,-86.0,-87.0,18.0,21.0,15.0,13.0,1
2978,CC:2F:71:3E:C5:1F,3835356,483718819,861,105154,3834495,483613665,0,3600,302240,2970,227456,630,74784,911,8,1239,19,0,37,144444.0,39000.0,-81.0,-84.0,-75.0,-72.0,-72.0,-73.0,-69.0,-61.0,-88.0,-88.0,-86.0,-87.0,7.0,4.0,11.0,15.0,1
2979,BA:8C:B9:54:50:24,3839323,489795584,4826,6181717,3834497,483613867,0,8932,1695179,8910,1691684,22,3495,2348,15,5257,39,0,56,229410.0,130000.0,-39.0,-36.0,-45.0,-51.0,-43.0,-35.0,-44.0,-48.0,-88.0,-88.0,-86.0,-87.0,49.0,52.0,41.0,36.0,1
2980,3C:55:76:E8:8F:1F,3837062,488705904,2549,5086034,3834513,483619870,0,3329,1007900,3122,969317,207,38583,1719,12,2562,154,0,66,258080.0,1000.0,-47.0,-51.0,-47.0,-39.0,-48.0,-51.0,-46.0,-41.0,-88.0,-88.0,-86.0,-87.0,41.0,37.0,39.0,48.0,1
2981,92:69:1D:31:68:E9,3838390,487227834,3876,3607902,3834514,483619932,0,4681,1085816,4541,1054151,140,31665,2086,10,4072,84,0,42,216660.0,130000.0,-51.0,-47.0,-42.0,-48.0,-51.0,-47.0,-43.0,-48.0,-88.0,-88.0,-86.0,-87.0,37.0,41.0,44.0,39.0,1
2982,CC:2F:71:3F:1F:24,4571444,1264485915,736930,780865983,3834514,483619932,37,588658,599357951,587945,599272149,713,85802,568309,15,737186,84087,34,489,144444.0,43333.0,-70.0,-67.0,-71.0,-73.0,-70.0,-67.0,-70.0,-73.0,-88.0,-88.0,-86.0,-87.0,18.0,21.0,15.0,14.0,1
2983,CC:2F:71:3E:C5:1F,3835386,483730510,861,105154,3834525,483625356,0,3600,302240,2970,227456,630,74784,911,8,1239,19,0,37,144444.0,39000.0,-81.0,-84.0,-75.0,-72.0,-72.0,-73.0,-69.0,-61.0,-88.0,-88.0,-86.0,-87.0,7.0,4.0,11.0,15.0,1
2984,BA:8C:B9:54:50:24,3839351,489807073,4826,6181717,3834525,483625356,0,8932,1695179,8910,1691684,22,3495,2348,15,5257,39,0,56,229410.0,130000.0,-39.0,-36.0,-45.0,-51.0,-43.0,-35.0,-44.0,-48.0,-88.0,-88.0,-86.0,-87.0,49.0,52.0,41.0,36.0,1
2985,3C:55:76:E8:8F:1F,3837117,488735851,2588,5110091,3834529,483625760,0,3409,1038168,3202,999585,207,38583,1765,12,2601,158,0,67,286760.0,162500.0,-46.0,-51.0,-48.0,-39.0,-52.0,-54.0,-51.0,-46.0,-88.0,-88.0,-86.0,-87.0,42.0,37.0,38.0,48.0,1
2986,92:69:1D:31:68:E9,3838405,487233662,3876,3607902,3834529,483625760,0,4681,1085816,4541,1054151,140,31665,2086,10,4072,84,0,42,216660.0,130000.0,-51.0,-47.0,-42.0,-48.0,-51.0,-47.0,-43.0,-48.0,-88.0,-88.0,-86.0,-87.0,37.0,41.0,44.0,39.0,1
2987,CC:2F:71:3F:1F:24,4571663,1264751959,737134,781126199,3834529,483625760,37,588854,599618901,588141,599533099,713,85802,568494,15,737390,84088,34,489,144444.0,43333.0,-71.0,-68.0,-71.0,-74.0,-70.0,-67.0,-70.0,-73.0,-88.0,-88.0,-86.0,-87.0,17.0,20.0,15.0,13.0,1
2988,CC:2F:71:3E:C5:1F,3835390,483730914,861,105154,3834529,483625760,0,3600,302240,2970,227456,630,74784,911,8,1239,19,0,37,144444.0,39000.0,-81.0,-84.0,-75.0,-72.0,-72.0,-73.0,-69.0,-61.0,-88.0,-88.0,-86.0,-87.0,7.0,4.0,11.0,15.0,1
2989,BA:8C:B9:54:50:24,3839355,489807477,4826,6181717,3834529,483625760,0,8932,1695179,8910,1691684,22,3495,2348,15,5257,39,0,56,229410.0,130000.0,-39.0,-36.0,-45.0,-51.0,-43.0,-35.0,-44.0,-48.0,-88.0,-88.0,-86.0,-87.0,49.0,52.0,41.0,36.0,1
2990,3C:55:76:E8:8F:1F,3838525,492393612,3990,8767115,3834535,483626497,0,3849,1109499,3642,1070916,207,38583,1997,13,4001,385,0,67,258080.0,1000.0,-50.0,-54.0,-45.0,-44.0,-50.0,-54.0,-47.0,-44.0,-88.0,-88.0,-86.0,-87.0,38.0,34.0,41.0,43.0,1
2991,92:69:1D:31:68:E9,3838411,487234399,3876,3607902,3834535,483626497,0,4681,1085816,4541,1054151,140,31665,2086,10,4072,84,0,42,216660.0,130000.0,-51.0,-47.0,-42.0,-48.0,-51.0,-47.0,-43.0,-48.0,-88.0,-88.0,-86.0,-87.0,37.0,41.0,44.0,39.0,1
2992,CC:2F:71:3F:1F:24,4571881,1265026640,737346,781400143,3834535,483626497,37,589055,599890979,588342,599805177,713,85802,568683,15,737602,84092,34,489,144444.0,43333.0,-70.0,-67.0,-72.0,-74.0,-70.0,-67.0,-71.0,-73.0,-88.0,-88.0,-86.0,-87.0,18.0,21.0,14.0,13.0,1
2993,CC:2F:71:3E:C5:1F,3835396,483731651,861,105154,3834535,483626497,0,3600,302240,2970,227456,630,74784,911,8,1239,19,0,37,144444.0,39000.0,-81.0,-84.0,-75.0,-72.0,-72.0,-73.0,-69.0,-61.0,-88.0,-88.0,-86.0,-87.0,7.0,4.0,11.0,15.0,1
2994,BA:8C:B9:54:50:24,3839361,489808214,4826,6181717,3834535,483626497,0,8932,1695179,8910,1691684,22,3495,2348,15,5257,39,0,56,229410.0,130000.0,-39.0,-36.0,-45.0,-51.0,-43.0,-35.0,-44.0,-48.0,-88.0,-88.0,-86.0,-87.0,49.0,52.0,41.0,36.0,1
2995,3C:55:76:E8:8F:1F,3838815,492695754,4276,9068853,3834539,483626901,0,4123,1202922,3916,1164339,207,38583,2170,13,4290,396,0,68,258080.0,154850.0,-51.0,-54.0,-48.0,-44.0,-51.0,-54.0,-47.0,-44.0,-88.0,-88.0,-86.0,-87.0,37.0,34.0,38.0,43.0,1
2996,92:69:1D:31:68:E9,3838415,487234803,3876,3607902,3834539,483626901,0,4681,1085816,4541,1054151,140,31665,2086,10,4072,84,0,42,216660.0,130000.0,-51.0,-47.0,-42.0,-48.0,-51.0,-47.0,-43.0,-48.0,-88.0,-88.0,-86.0,-87.0,37.0,41.0,44.0,39.0,1
2997,CC:2F:71:3F:1F:24,4572083,1265273267,737544,781646366,3834539,483626901,37,589247,600140626,588534,600054824,713,85802,568862,15,737800,84095,34,489,144444.0,43333.0,-71.0,-67.0,-71.0,-74.0,-70.0,-66.0,-71.0,-73.0,-88.0,-88.0,-86.0,-87.0,17.0,21.0,15.0,13.0,1
2998,CC:2F:71:3E:C5:1F,3835400,483732055,861,105154,3834539,483626901,0,3600,302240,2970,227456,630,74784,911,8,1239,19,0,37,144444.0,39000.0,-81.0,-84.0,-75.0,-72.0,-72.0,-73.0,-69.0,-61.0,-88.0,-88.0,-86.0,-87.0,7.0,4.0,11.0,15.0,1
2999,BA:8C:B9:54:50:24,3839365,489808618,4826,6181717,3834539,483626901,0,8932,1695179,8910,1691684,22,3495,2348,15,5257,39,0,56,229410.0,130000.0,-39.0,-36.0,-45.0,-51.0,-43.0,-35.0,-44.0,-48.0,-88.0,-88.0,-86.0,-87.0,49.0,52.0,41.0,36.0,1
3000,3C:55:76:E8:8F:1F,3838911,492838993,4367,9211628,3834544,483627365,0,4224,1246901,4017,1208318,207,38583,2236,13,4381,396,0,68,258080.0,154850.0,-51.0,-54.0,-44.0,-43.0,-50.0,-54.0,-44.0,-43.0,-88.0,-88.0,-86.0,-87.0,37.0,34.0,42.0,44.0,1
3001,92:69:1D:31:68:E9,3838420,487235267,3876,3607902,3834544,483627365,0,4681,1085816,4541,1054151,140,31665,2086,10,4072,84,0,42,216660.0,130000.0,-51.0,-47.0,-42.0,-48.0,-51.0,-47.0,-43.0,-48.0,-88.0,-88.0,-86.0,-87.0,37.0,41.0,44.0,39.0,1
3002,CC:2F:71:3F:1F:24,4572278,1265514911,737734,781887546,3834544,483627365,37,589429,600383016,588716,600297214,713,85802,569031,15,737990,84095,34,490,144444.0,43333.0,-70.0,-67.0,-71.0,-72.0,-70.0,-67.0,-70.0,-72.0,-88.0,-88.0,-86.0,-87.0,18.0,21.0,15.0,15.0,1
3003,CC:2F:71:3E:C5:1F,3835405,483732519,861,105154,3834544,483627365,0,3600,302240,2970,227456,630,74784,911,8,1239,19,0,37,144444.0,39000.0,-81.0,-84.0,-75.0,-72.0,-72.0,-73.0,-69.0,-61.0,-88.0,-88.0,-86.0,-87.0,7.0,4.0,11.0,15.0,1
3004,BA:8C:B9:54:50:24,3839370,489809082,4826,6181717,3834544,483627365,0,8932,1695179,8910,1691684,22,3495,2348,15,5257,39,0,56,229410.0,130000.0,-39.0,-36.0,-45.0,-51.0,-43.0,-35.0,-44.0,-48.0,-88.0,-88.0,-86.0,-87.0,49.0,52.0,41.0,36.0,1
3005,3C:55:76:E8:8F:1F,3838924,492841538,4374,9213401,3834550,483628137,0,4246,1249964,4039,1211381,207,38583,2244,13,4388,397,0,68,270830.0,162500.0,-46.0,-51.0,-49.0,-39.0,-47.0,-51.0,-47.0,-39.0,-88.0,-88.0,-86.0,-87.0,42.0,37.0,37.0,48.0,1
3006,92:69:1D:31:68:E9,3838426,487236039,3876,3607902,3834550,483628137,0,4681,1085816,4541,1054151,140,31665,2086,10,4072,84,0,42,216660.0,130000.0,-51.0,-47.0,-42.0,-48.0,-51.0,-47.0,-43.0,-48.0,-88.0,-88.0,-86.0,-87.0,37.0,41.0,44.0,39.0,1
3007,CC:2F:71:3F:1F:24,4572472,1265753755,737922,782125618,3834550,483628137,37,589606,600617686,588893,600531884,713,85802,569197,15,738178,84095,34,490,144444.0,43333.0,-71.0,-67.0,-71.0,-72.0,-70.0,-67.0,-70.0,-72.0,-88.0,-88.0,-86.0,-87.0,17.0,21.0,15.0,15.0,1
3008,CC:2F:71:3E:C5:1F,3835411,483733291,861,105154,3834550,483628137,0,3600,302240,2970,227456,630,74784,911,8,1239,19,0,37,144444.0,39000.0,-81.0,-84.0,-75.0,-72.0,-72.0,-73.0,-69.0,-61.0,-88.0,-88.0,-86.0,-87.0,7.0,4.0,11.0,15.0,1
3009,BA:8C:B9:54:50:24,3839376,489809854,4826,6181717,3834550,483628137,0,8932,1695179,8910,1691684,22,3495,2348,15,5257,39,0,56,229410.0,130000.0,-39.0,-36.0,-45.0,-51.0,-43.0,-35.0,-44.0,-48.0,-88.0,-88.0,-86.0,-87.0,49.0,52.0,41.0,36.0,1
3010,3C:55:76:E8:8F:1F,3838945,492845119,4391,9216578,3834554,483628541,0,4296,1257044,4089,1218461,207,38583,2266,13,4405,399,0,68,286760.0,162500.0,-47.0,-51.0,-51.0,-39.0,-47.0,-51.0,-49.0,-39.0,-88.0,-88.0,-86.0,-87.0,41.0,37.0,35.0,48.0,1
3011,92:69:1D:31:68:E9,3838430,487236443,3876,3607902,3834554,483628541,0,4681,1085816,4541,1054151,140,31665,2086,10,4072,84,0,42,216660.0,130000.0,-51.0,-47.0,-42.0,-48.0,-51.0,-47.0,-43.0,-48.0,-88.0,-88.0,-86.0,-87.0,37.0,41.0,44.0,39.0,1
3012,CC:2F:71:3F:1F:24,4572676,1266008103,738122,782379562,3834554,483628541,37,589796,600869540,589083,600783738,713,85802,569375,15,738378,84134,34,490,130000.0,43333.0,-72.0,-66.0,-70.0,-74.0,-72.0,-66.0,-70.0,-73.0,-88.0,-88.0,-86.0,-87.0,16.0,22.0,16.0,13.0,1
3013,CC:2F:71:3E:C5:1F,3835415,483733695,861,105154,3834554,483628541,0,3600,302240,2970,227456,630,74784,911,8,1239,19,0,37,144444.0,39000.0,-81.0,-84.0,-75.0,-72.0,-72.0,-73.0,-69.0,-61.0,-88.0,-88.0,-86.0,-87.0,7.0,4.0,11.0,15.0,1
3014,BA:8C:B9:54:50:24,3839382,489810460,4826,6181717,3834556,483628743,0,8932,1695179,8910,1691684,22,3495,2348,15,5257,39,0,56,229410.0,130000.0,-39.0,-36.0,-45.0,-51.0,-43.0,-35.0,-44.0,-48.0,-88.0,-88.0,-86.0,-87.0,49.0,52.0,41.0,36.0,1
3015,3C:55:76:E8:8F:1F,3839128,493300852,4569,9671847,3834559,483629005,0,4367,1270346,4160,1231763,207,38583,2304,13,4583,414,0,69,286760.0,172050.0,-45.0,-51.0,-52.0,-39.0,-45.0,-51.0,-50.0,-40.0,-88.0,-88.0,-86.0,-87.0,43.0,37.0,34.0,48.0,1
3016,92:69:1D:31:68:E9,3838435,487236907,3876,3607902,3834559,483629005,0,4681,1085816,4541,1054151,140,31665,2086,10,4072,84,0,42,216660.0,130000.0,-51.0,-47.0,-42.0,-48.0,-51.0,-47.0,-43.0,-48.0,-88.0,-88.0,-86.0,-87.0,37.0,41.0,44.0,39.0,1
3017,CC:2F:71:3F:1F:24,4572880,1266253482,738321,782624477,3834559,483629005,37,589982,601108332,589269,601022530,713,85802,569555,15,738577,84134,34,490,130000.0,43333.0,-72.0,-66.0,-70.0,-73.0,-72.0,-66.0,-70.0,-73.0,-88.0,-88.0,-86.0,-87.0,16.0,22.0,16.0,14.0,1
3018,CC:2F:71:3E:C5:1F,3835422,483734361,861,105154,3834561,483629207,0,3600,302240,2970,227456,630,74784,911,8,1239,19,0,37,144444.0,39000.0,-81.0,-84.0,-75.0,-72.0,-72.0,-73.0,-69.0,-61.0,-88.0,-88.0,-86.0,-87.0,7.0,4.0,11.0,15.0,1
3019,BA:8C:B9:54:50:24,3839389,489811126,4826,6181717,3834563,483629409,0,8932,1695179,8910,1691684,22,3495,2348,15,5257,39,0,56,229410.0,130000.0,-39.0,-36.0,-45.0,-51.0,-43.0,-35.0,-44.0,-48.0,-88.0,-88.0,-86.0,-87.0,49.0,52.0,41.0,36.0,1
3020,3C:55:76:E8:8F:1F,3839132,493301256,4569,9671847,3834563,483629409,0,4371,1270620,4164,1232037,207,38583,2304,13,4583,414,0,69,286760.0,172050.0,-46.0,-52.0,-51.0,-40.0,-45.0,-51.0,-51.0,-39.0,-88.0,-88.0,-86.0,-87.0,42.0,36.0,35.0,47.0,1
3021,92:69:1D:31:68:E9,3838439,487237311,3876,3607902,3834563,483629409,0,4681,1085816,4541,1054151,140,31665,2086,10,4072,84,0,42,216660.0,130000.0,-51.0,-47.0,-42.0,-48.0,-51.0,-47.0,-43.0,-48.0,-88.0,-88.0,-86.0,-87.0,37.0,41.0,44.0,39.0,1
3022,CC:2F:71:3F:1F:24,4573086,1266510656,738521,782881045,3834565,483629611,37,590167,601358060,589454,601272258,713,85802,569735,15,738777,84139,34,492,144444.0,43333.0,-72.0,-66.0,-70.0,-73.0,-71.0,-66.0,-70.0,-73.0,-88.0,-88.0,-86.0,-87.0,16.0,22.0,16.0,14.0,1
3023,CC:2F:71:3E:C5:1F,3835426,483734765,861,105154,3834565,483629611,0,3600,302240,2970,227456,630,74784,911,8,1239,19,0,37,144444.0,39000.0,-81.0,-84.0,-75.0,-72.0,-72.0,-73.0,-69.0,-61.0,-88.0,-88.0,-86.0,-87.0,7.0,4.0,11.0,15.0,1
3024,BA:8C:B9:54:50:24,3839391,489811328,4826,6181717,3834565,483629611,0,8932,1695179,8910,1691684,22,3495,2348,15,5257,39,0,56,229410.0,130000.0,-39.0,-36.0,-45.0,-51.0,-43.0,-35.0,-44.0,-48.0,-88.0,-88.0,-86.0,-87.0,49.0,52.0,41.0,36.0,1
3025,3C:55:76:E8:8F:1F,3839146,493303485,4576,9673410,3834570,483630075,0,4392,1277229,4185,1238646,207,38583,2311,13,4590,414,0,69,286760.0,172050.0,-46.0,-53.0,-52.0,-40.0,-45.0,-52.0,-51.0,-39.0,-88.0,-88.0,-86.0,-87.0,42.0,35.0,34.0,47.0,1
3026,92:69:1D:31:68:E9,3838446,487237977,3876,3607902,3834570,483630075,0,4681,1085816,4541,1054151,140,31665,2086,10,4072,84,0,42,216660.0,130000.0,-51.0,-47.0,-42.0,-48.0,-51.0,-47.0,-43.0,-48.0,-88.0,-88.0,-86.0,-87.0,37.0,41.0,44.0,39.0,1
3027,CC:2F:71:3F:1F:24,4573285,1266755596,738713,783125319,3834572,483630277,37,590347,601601392,589634,601515590,713,85802,569906,15,738969,84144,34,492,144444.0,43333.0,-74.0,-69.0,-74.0,-76.0,-72.0,-67.0,-71.0,-74.0,-88.0,-88.0,-86.0,-87.0,14.0,19.0,12.0,11.0,1
3028,CC:2F:71:3E:C5:1F,3835433,483735431,861,105154,3834572,483630277,0,3600,302240,2970,227456,630,74784,911,8,1239,19,0,37,144444.0,39000.0,-81.0,-84.0,-75.0,-72.0,-72.0,-73.0,-69.0,-61.0,-88.0,-88.0,-86.0,-87.0,7.0,4.0,11.0,15.0,1
3029,BA:8C:B9:54:50:24,3839398,489811994,4826,6181717,3834572,483630277,0,8932,1695179,8910,1691684,22,3495,2348,15,5257,39,0,56,229410.0,130000.0,-39.0,-36.0,-45.0,-51.0,-43.0,-35.0,-44.0,-48.0,-88.0,-88.0,-86.0,-87.0,49.0,52.0,41.0,36.0,1
3030,3C:55:76:E8:8F:1F,3839274,493431141,4700,9800662,3834574,483630479,0,4470,1304306,4263,1265723,207,38583,2364,13,4714,419,0,69,286760.0,172050.0,-51.0,-57.0,-47.0,-45.0,-50.0,-56.0,-47.0,-44.0,-88.0,-88.0,-86.0,-87.0,37.0,31.0,39.0,42.0,1
3031,92:69:1D:31:68:E9,3838450,487238381,3876,3607902,3834574,483630479,0,4681,1085816,4541,1054151,140,31665,2086,10,4072,84,0,42,216660.0,130000.0,-51.0,-47.0,-42.0,-48.0,-51.0,-47.0,-43.0,-48.0,-88.0,-88.0,-86.0,-87.0,37.0,41.0,44.0,39.0,1
3032,CC:2F:71:3F:1F:24,4573479,1267000102,738905,783369623,3834574,483630479,37,590522,601837048,589809,601751246,713,85802,570076,15,739160,84148,34,492,144444.0,43333.0,-71.0,-66.0,-70.0,-73.0,-71.0,-66.0,-70.0,-73.0,-88.0,-88.0,-86.0,-87.0,17.0,22.0,16.0,14.0,1
3033,CC:2F:71:3E:C5:1F,3835435,483735633,861,105154,3834574,483630479,0,3600,302240,2970,227456,630,74784,911,8,1239,19,0,37,144444.0,39000.0,-81.0,-84.0,-75.0,-72.0,-72.0,-73.0,-69.0,-61.0,-88.0,-88.0,-86.0,-87.0,7.0,4.0,11.0,15.0,1
3034,BA:8C:B9:54:50:24,3839402,489812398,4826,6181717,3834576,483630681,0,8932,1695179,8910,1691684,22,3495,2348,15,5257,39,0,56,229410.0,130000.0,-39.0,-36.0,-45.0,-51.0,-43.0,-35.0,-44.0,-48.0,-88.0,-88.0,-86.0,-87.0,49.0,52.0,41.0,36.0,1
3035,62:47:05:9D:EB:15,3834582,483631393,2,298,3834580,483631095,0,8,970,6,638,2,332,2,0,6,0,0,2,1000.0,1000.0,-64.0,-53.0,-52.0,-63.0,-62.0,-51.0,-50.0,-62.0,-88.0,-88.0,-86.0,-87.0,24.0,35.0,34.0,24.0,1
3036,3C:55:76:E8:8F:1F,3839295,493436249,4713,9804952,3834582,483631297,0,4503,1319962,4296,1281379,207,38583,2377,13,4727,419,0,69,286760.0,172050.0,-49.0,-56.0,-43.0,-44.0,-47.0,-55.0,-43.0,-42.0,-88.0,-88.0,-86.0,-87.0,39.0,32.0,43.0,43.0,1
3037,92:69:1D:31:68:E9,3838458,487239199,3876,3607902,3834582,483631297,0,4681,1085816,4541,1054151,140,31665,2086,10,4072,84,0,42,216660.0,130000.0,-51.0,-47.0,-42.0,-48.0,-51.0,-47.0,-43.0,-48.0,-88.0,-88.0,-86.0,-87.0,37.0,41.0,44.0,39.0,1
3038,CC:2F:71:3F:1F:24,4573707,1267273643,739124,783642286,3834583,483631357,37,590726,602100983,590013,602015181,713,85802,570274,15,739380,84148,34,492,144444.0,43333.0,-72.0,-67.0,-71.0,-74.0,-72.0,-66.0,-70.0,-73.0,-88.0,-88.0,-86.0,-87.0,16.0,21.0,15.0,13.0,1
3039,CC:2F:71:3E:C5:1F,3835445,483736865,861,105154,3834584,483631711,0,3600,302240,2970,227456,630,74784,911,8,1239,19,0,37,144444.0,39000.0,-81.0,-84.0,-75.0,-72.0,-72.0,-73.0,-69.0,-61.0,-88.0,-88.0,-86.0,-87.0,7.0,4.0,11.0,15.0,1
3040,BA:8C:B9:54:50:24,3839410,489813428,4826,6181717,3834584,483631711,0,8932,1695179,8910,1691684,22,3495,2348,15,5257,39,0,56,229410.0,130000.0,-39.0,-36.0,-45.0,-51.0,-43.0,-35.0,-44.0,-48.0,-88.0,-88.0,-86.0,-87.0,49.0,52.0,41.0,36.0,1
3041,62:47:05:9D:EB:15,3834593,483632915,4,708,3834589,483632207,0,14,1990,8,774,6,1216,6,0,12,0,0,2,216660.0,130000.0,-61.0,-50.0,-49.0,-61.0,-61.0,-51.0,-50.0,-61.0,-89.0,-89.0,-86.0,-87.0,28.0,39.0,37.0,26.0,1
3042,3C:55:76:E8:8F:1F,3839306,493437601,4715,9805192,3834591,483632409,0,4516,1320922,4309,1282339,207,38583,2379,13,4729,419,0,69,286760.0,172050.0,-49.0,-56.0,-44.0,-45.0,-47.0,-55.0,-43.0,-43.0,-89.0,-89.0,-86.0,-87.0,40.0,33.0,42.0,42.0,1
3043,92:69:1D:31:68:E9,3838468,487240427,3877,3608018,3834591,483632409,0,4683,1085952,4543,1054287,140,31665,2086,10,4073,84,0,42,229410.0,130000.0,-52.0,-47.0,-42.0,-49.0,-51.0,-47.0,-43.0,-48.0,-89.0,-89.0,-86.0,-87.0,37.0,42.0,44.0,38.0,1
3044,CC:2F:71:3F:1F:24,4573925,1267537949,739334,783905540,3834591,483632409,37,590926,602365641,590213,602279839,713,85802,570459,15,739589,84150,34,492,144444.0,43333.0,-72.0,-66.0,-70.0,-74.0,-71.0,-66.0,-70.0,-73.0,-89.0,-89.0,-86.0,-87.0,17.0,23.0,16.0,13.0,1
3045,CC:2F:71:3E:C5:1F,3835453,483737679,862,105270,3834591,483632409,0,3602,302380,2972,227596,630,74784,911,8,1240,19,0,37,144444.0,39000.0,-71.0,-72.0,-69.0,-61.0,-72.0,-73.0,-69.0,-62.0,-89.0,-89.0,-86.0,-87.0,18.0,17.0,17.0,26.0,1
3046,BA:8C:B9:54:50:24,3839418,489814242,4827,6181833,3834591,483632409,0,8937,1695519,8915,1692024,22,3495,2348,15,5258,39,0,56,229410.0,130000.0,-48.0,-35.0,-43.0,-45.0,-42.0,-35.0,-43.0,-47.0,-89.0,-89.0,-86.0,-87.0,41.0,54.0,43.0,42.0,1
3047,62:47:05:9D:EB:15,3834624,483639659,26,6334,3834598,483633325,0,36,6015,27,4125,9,1890,25,0,37,0,0,2,229410.0,130000.0,-62.0,-53.0,-52.0,-64.0,-61.0,-53.0,-52.0,-63.0,-89.0,-89.0,-86.0,-87.0,27.0,36.0,34.0,23.0,1
3048,3C:55:76:E8:8F:1F,3839332,493445026,4734,9811701,3834598,483633325,0,4559,1343333,4352,1304750,207,38583,2398,13,4748,419,0,70,286760.0,172050.0,-51.0,-57.0,-47.0,-45.0,-48.0,-55.0,-47.0,-42.0,-89.0,-89.0,-86.0,-87.0,38.0,32.0,39.0,42.0,1
3049,92:69:1D:31:68:E9,3838475,487241343,3877,3608018,3834598,483633325,0,4683,1085952,4543,1054287,140,31665,2086,10,4073,84,0,42,229410.0,130000.0,-52.0,-47.0,-42.0,-49.0,-51.0,-47.0,-43.0,-48.0,-89.0,-89.0,-86.0,-87.0,37.0,42.0,44.0,38.0,1
3050,CC:2F:71:3F:1F:24,4574140,1267801889,739542,784168564,3834598,483633325,37,591121,602623887,590408,602538085,713,85802,570645,15,739798,84155,34,492,144444.0,43333.0,-72.0,-66.0,-70.0,-74.0,-71.0,-66.0,-70.0,-73.0,-89.0,-89.0,-86.0,-87.0,17.0,23.0,16.0,13.0,1
3051,CC:2F:71:3E:C5:1F,3835460,483738595,862,105270,3834598,483633325,0,3602,302380,2972,227596,630,74784,911,8,1240,19,0,37,144444.0,39000.0,-71.0,-72.0,-69.0,-61.0,-72.0,-73.0,-69.0,-62.0,-89.0,-89.0,-86.0,-87.0,18.0,17.0,17.0,26.0,1
3052,BA:8C:B9:54:50:24,3839425,489815158,4827,6181833,3834598,483633325,0,8937,1695519,8915,1692024,22,3495,2348,15,5258,39,0,56,229410.0,130000.0,-48.0,-35.0,-43.0,-45.0,-42.0,-35.0,-43.0,-47.0,-89.0,-89.0,-86.0,-87.0,41.0,54.0,43.0,42.0,1
3053,62:47:05:9D:EB:15,3834639,483642765,35,8703,3834604,483634062,0,49,8373,40,6483,9,1890,35,0,46,0,0,2,229410.0,137640.0,-56.0,-50.0,-48.0,-60.0,-60.0,-52.0,-51.0,-63.0,-89.0,-89.0,-86.0,-87.0,33.0,39.0,38.0,27.0,1
3054,3C:55:76:E8:8F:1F,3839416,493539998,4812,9905936,3834604,483634062,0,4655,1371153,4448,1332570,207,38583,2457,13,4826,424,0,70,286760.0,172050.0,-46.0,-55.0,-52.0,-39.0,-47.0,-55.0,-50.0,-40.0,-89.0,-89.0,-86.0,-87.0,43.0,34.0,34.0,48.0,1
3055,92:69:1D:31:68:E9,3838481,487242080,3877,3608018,3834604,483634062,0,4683,1085952,4543,1054287,140,31665,2086,10,4073,84,0,42,229410.0,130000.0,-52.0,-47.0,-42.0,-49.0,-51.0,-47.0,-43.0,-48.0,-89.0,-89.0,-86.0,-87.0,37.0,42.0,44.0,38.0,1
3056,CC:2F:71:3F:1F:24,4574363,1268066503,739759,784432441,3834604,483634062,37,591323,602879251,590610,602793449,713,85802,570840,15,740015,84158,34,492,144444.0,43333.0,-71.0,-66.0,-70.0,-73.0,-71.0,-66.0,-70.0,-73.0,-89.0,-89.0,-86.0,-87.0,18.0,23.0,16.0,14.0,1
3057,CC:2F:71:3E:C5:1F,3835466,483739332,862,105270,3834604,483634062,0,3602,302380,2972,227596,630,74784,911,8,1240,19,0,37,144444.0,39000.0,-71.0,-72.0,-69.0,-61.0,-72.0,-73.0,-69.0,-62.0,-89.0,-89.0,-86.0,-87.0,18.0,17.0,17.0,26.0,1
3058,BA:8C:B9:54:50:24,3839433,489816097,4827,6181833,3834606,483634264,0,8938,1695587,8916,1692092,22,3495,2348,15,5258,39,0,56,229410.0,130000.0,-40.0,-37.0,-46.0,-52.0,-41.0,-35.0,-44.0,-48.0,-89.0,-89.0,-86.0,-87.0,49.0,52.0,40.0,35.0,1
3059,62:47:05:9D:EB:15,3834643,483643169,35,8703,3834608,483634466,0,49,8373,40,6483,9,1890,35,0,46,0,0,2,229410.0,137640.0,-56.0,-50.0,-48.0,-60.0,-60.0,-52.0,-51.0,-63.0,-89.0,-89.0,-86.0,-87.0,33.0,39.0,38.0,27.0,1
3060,3C:55:76:E8:8F:1F,3839541,493728717,4933,10094251,3834608,483634466,0,4798,1417476,4591,1378893,207,38583,2549,13,4947,424,0,71,286760.0,172050.0,-50.0,-58.0,-46.0,-45.0,-49.0,-57.0,-47.0,-43.0,-89.0,-89.0,-86.0,-87.0,39.0,31.0,40.0,42.0,1
3061,92:69:1D:31:68:E9,3838485,487242484,3877,3608018,3834608,483634466,0,4683,1085952,4543,1054287,140,31665,2086,10,4073,84,0,42,229410.0,130000.0,-52.0,-47.0,-42.0,-49.0,-51.0,-47.0,-43.0,-48.0,-89.0,-89.0,-86.0,-87.0,37.0,42.0,44.0,38.0,1
3062,CC:2F:71:3F:1F:24,4574582,1268339369,739974,784704903,3834608,483634466,37,591517,603140167,590804,603054365,713,85802,571028,15,740230,84162,34,492,144444.0,43333.0,-72.0,-66.0,-70.0,-74.0,-71.0,-66.0,-70.0,-73.0,-89.0,-89.0,-86.0,-87.0,17.0,23.0,16.0,13.0,1
3063,CC:2F:71:3E:C5:1F,3835470,483739736,862,105270,3834608,483634466,0,3602,302380,2972,227596,630,74784,911,8,1240,19,0,37,144444.0,39000.0,-71.0,-72.0,-69.0,-61.0,-72.0,-73.0,-69.0,-62.0,-89.0,-89.0,-86.0,-87.0,18.0,17.0,17.0,26.0,1
3064,BA:8C:B9:54:50:24,3839435,489816299,4827,6181833,3834608,483634466,0,8938,1695587,8916,1692092,22,3495,2348,15,5258,39,0,56,229410.0,130000.0,-40.0,-37.0,-46.0,-52.0,-41.0,-35.0,-44.0,-48.0,-89.0,-89.0,-86.0,-87.0,49.0,52.0,40.0,35.0,1
3065,62:47:05:9D:EB:15,3834649,483643695,35,8703,3834614,483634992,0,49,8373,40,6483,9,1890,35,0,46,0,0,2,229410.0,137640.0,-56.0,-50.0,-48.0,-60.0,-60.0,-52.0,-51.0,-63.0,-89.0,-89.0,-86.0,-87.0,33.0,39.0,38.0,27.0,1
3066,3C:55:76:E8:8F:1F,3840569,496189256,5953,12554062,3834616,483635194,0,5252,1560313,5045,1521730,207,38583,2800,13,5967,469,0,75,286760.0,172050.0,-51.0,-57.0,-47.0,-46.0,-49.0,-56.0,-48.0,-43.0,-89.0,-89.0,-86.0,-87.0,38.0,32.0,39.0,41.0,1
3067,92:69:1D:31:68:E9,3838493,487243212,3877,3608018,3834616,483635194,0,4683,1085952,4543,1054287,140,31665,2086,10,4073,84,0,42,229410.0,130000.0,-52.0,-47.0,-42.0,-49.0,-51.0,-47.0,-43.0,-48.0,-89.0,-89.0,-86.0,-87.0,37.0,42.0,44.0,38.0,1
3068,CC:2F:71:3F:1F:24,4574802,1268606489,740186,784971295,3834616,483635194,37,591707,603392025,590994,603306223,713,85802,571215,15,740441,84164,34,492,144444.0,43333.0,-71.0,-66.0,-70.0,-73.0,-71.0,-66.0,-69.0,-73.0,-89.0,-89.0,-86.0,-87.0,18.0,23.0,16.0,14.0,1
3069,CC:2F:71:3E:C5:1F,3835480,483740666,862,105270,3834618,483635396,0,3604,302568,2973,227666,631,74902,912,8,1240,19,0,37,144444.0,39000.0,-80.0,-83.0,-76.0,-71.0,-73.0,-74.0,-70.0,-63.0,-89.0,-89.0,-86.0,-87.0,9.0,6.0,10.0,16.0,1
3070,BA:8C:B9:54:50:24,3839446,489817307,4827,6181833,3834619,483635474,0,8938,1695587,8916,1692092,22,3495,2348,15,5258,39,0,56,229410.0,130000.0,-40.0,-37.0,-46.0,-52.0,-41.0,-35.0,-44.0,-48.0,-89.0,-89.0,-86.0,-87.0,49.0,52.0,40.0,35.0,1
3071,62:47:05:9D:EB:15,3834654,483644177,35,8703,3834619,483635474,0,52,8647,42,6619,10,2028,36,0,46,0,0,2,229410.0,137640.0,-58.0,-50.0,-49.0,-61.0,-59.0,-51.0,-50.0,-62.0,-89.0,-89.0,-86.0,-87.0,31.0,39.0,37.0,26.0,1
3072,3C:55:76:E8:8F:1F,3840950,496991493,6331,13356019,3834619,483635474,0,5477,1644473,5270,1605890,207,38583,2944,13,6345,489,0,75,286760.0,172050.0,-46.0,-54.0,-52.0,-39.0,-48.0,-55.0,-49.0,-42.0,-89.0,-89.0,-86.0,-87.0,43.0,35.0,34.0,48.0,1
3073,92:69:1D:31:68:E9,3838496,487243492,3877,3608018,3834619,483635474,0,4683,1085952,4543,1054287,140,31665,2086,10,4073,84,0,42,229410.0,130000.0,-52.0,-47.0,-42.0,-49.0,-51.0,-47.0,-43.0,-48.0,-89.0,-89.0,-86.0,-87.0,37.0,42.0,44.0,38.0,1
3074,CC:2F:71:3F:1F:24,4575023,1268873564,740402,785237888,3834621,483635676,37,591909,603652907,591196,603567105,713,85802,571409,15,740658,84165,34,492,144444.0,43333.0,-71.0,-66.0,-70.0,-73.0,-71.0,-66.0,-70.0,-73.0,-89.0,-89.0,-86.0,-87.0,18.0,23.0,16.0,14.0,1
3075,CC:2F:71:3E:C5:1F,3835485,483741148,862,105270,3834623,483635878,0,3604,302568,2973,227666,631,74902,912,8,1240,19,0,37,144444.0,39000.0,-80.0,-83.0,-76.0,-71.0,-73.0,-74.0,-70.0,-63.0,-89.0,-89.0,-86.0,-87.0,9.0,6.0,10.0,16.0,1
3076,BA:8C:B9:54:50:24,3839450,489817711,4827,6181833,3834623,483635878,0,8938,1695587,8916,1692092,22,3495,2348,15,5258,39,0,56,229410.0,130000.0,-40.0,-37.0,-46.0,-52.0,-41.0,-35.0,-44.0,-48.0,-89.0,-89.0,-86.0,-87.0,49.0,52.0,40.0,35.0,1
3077,62:47:05:9D:EB:15,3834661,483644845,35,8703,3834626,483636142,0,52,8647,42,6619,10,2028,36,0,46,0,0,2,229410.0,137640.0,-58.0,-50.0,-49.0,-61.0,-59.0,-51.0,-50.0,-62.0,-89.0,-89.0,-86.0,-87.0,31.0,39.0,37.0,26.0,1
3078,3C:55:76:E8:8F:1F,3841063,497132291,6435,13495947,3834628,483636344,0,5598,1688680,5391,1650097,207,38583,3019,13,6449,490,0,75,286760.0,172050.0,-51.0,-58.0,-47.0,-45.0,-49.0,-56.0,-48.0,-43.0,-89.0,-89.0,-86.0,-87.0,38.0,31.0,39.0,42.0,1
3079,92:69:1D:31:68:E9,3838506,487244422,3877,3608018,3834629,483636404,0,4683,1085952,4543,1054287,140,31665,2086,10,4073,84,0,42,229410.0,130000.0,-52.0,-47.0,-42.0,-49.0,-51.0,-47.0,-43.0,-48.0,-89.0,-89.0,-86.0,-87.0,37.0,42.0,44.0,38.0,1
3080,CC:2F:71:3F:1F:24,4575239,1269135892,740610,785499488,3834629,483636404,37,592104,603911343,591391,603825541,713,85802,571592,15,740866,84168,34,492,144444.0,43333.0,-71.0,-66.0,-69.0,-74.0,-71.0,-66.0,-69.0,-73.0,-89.0,-89.0,-86.0,-87.0,18.0,23.0,17.0,13.0,1
3081,CC:2F:71:3E:C5:1F,3835493,483742798,862,105270,3834631,483637528,0,3604,302568,2973,227666,631,74902,912,8,1240,19,0,37,144444.0,39000.0,-80.0,-83.0,-76.0,-71.0,-73.0,-74.0,-70.0,-63.0,-89.0,-89.0,-86.0,-87.0,9.0,6.0,10.0,16.0,1
3082,BA:8C:B9:54:50:24,3839458,489819361,4827,6181833,3834631,483637528,0,8938,1695587,8916,1692092,22,3495,2348,15,5258,39,0,56,229410.0,130000.0,-40.0,-37.0,-46.0,-52.0,-41.0,-35.0,-44.0,-48.0,-89.0,-89.0,-86.0,-87.0,49.0,52.0,40.0,35.0,1
3083,62:47:05:9D:EB:15,3834669,483646549,36,8819,3834633,483637730,0,55,8893,45,6865,10,2028,37,0,47,0,0,3,216660.0,130000.0,-57.0,-51.0,-49.0,-61.0,-58.0,-51.0,-50.0,-61.0,-89.0,-89.0,-86.0,-87.0,32.0,38.0,37.0,26.0,1
3084,3C:55:76:E8:8F:1F,3841102,497154806,6469,13517076,3834633,483637730,0,5661,1706837,5454,1668254,207,38583,3063,13,6483,490,0,76,286760.0,172050.0,-51.0,-58.0,-47.0,-45.0,-50.0,-57.0,-46.0,-45.0,-89.0,-89.0,-86.0,-87.0,38.0,31.0,39.0,42.0,1
3085,92:69:1D:31:68:E9,3838512,487245950,3877,3608018,3834635,483637932,0,4683,1085952,4543,1054287,140,31665,2086,10,4073,84,0,42,229410.0,130000.0,-52.0,-47.0,-42.0,-49.0,-51.0,-47.0,-43.0,-48.0,-89.0,-89.0,-86.0,-87.0,37.0,42.0,44.0,38.0,1
3086,CC:2F:71:3F:1F:24,4575460,1269408513,740825,785770581,3834635,483637932,37,592300,604169740,591587,604083938,713,85802,571783,15,741079,84168,34,492,144444.0,43333.0,-71.0,-66.0,-70.0,-73.0,-71.0,-66.0,-69.0,-73.0,-89.0,-89.0,-86.0,-87.0,18.0,23.0,16.0,14.0,1
3087,CC:2F:71:3E:C5:1F,3835497,483743202,862,105270,3834635,483637932,0,3604,302568,2973,227666,631,74902,912,8,1240,19,0,37,144444.0,39000.0,-80.0,-83.0,-76.0,-71.0,-73.0,-74.0,-70.0,-63.0,-89.0,-89.0,-86.0,-87.0,9.0,6.0,10.0,16.0,1
3088,BA:8C:B9:54:50:24,3839462,489819765,4827,6181833,3834635,483637932,0,8938,1695587,8916,1692092,22,3495,2348,15,5258,39,0,56,229410.0,130000.0,-40.0,-37.0,-46.0,-52.0,-41.0,-35.0,-44.0,-48.0,-89.0,-89.0,-86.0,-87.0,49.0,52.0,40.0,35.0,1
3089,62:47:05:9D:EB:15,3834677,483648279,36,8819,3834641,483639460,0,55,8893,45,6865,10,2028,37,0,47,0,0,3,216660.0,130000.0,-57.0,-51.0,-49.0,-61.0,-58.0,-51.0,-50.0,-61.0,-89.0,-89.0,-86.0,-87.0,32.0,38.0,37.0,26.0,1
3090,3C:55:76:E8:8F:1F,3841501,497956290,6860,14316830,3834641,483639460,0,5921,1786439,5714,1747856,207,38583,3229,13,6863,542,0,76,286760.0,172050.0,-51.0,-56.0,-47.0,-46.0,-50.0,-56.0,-46.0,-45.0,-89.0,-89.0,-86.0,-87.0,38.0,33.0,39.0,41.0,1
3091,92:69:1D:31:68:E9,3838518,487247478,3877,3608018,3834641,483639460,0,4685,1086088,4545,1054423,140,31665,2086,10,4074,84,0,42,229410.0,130000.0,-52.0,-47.0,-42.0,-49.0,-51.0,-47.0,-43.0,-48.0,-89.0,-89.0,-86.0,-87.0,37.0,42.0,44.0,38.0,1
3092,CC:2F:71:3F:1F:24,4575685,1269684449,741044,786044989,3834641,483639460,37,592498,604431012,591785,604345210,713,85802,571978,15,741299,84172,34,492,144444.0,43333.0,-70.0,-66.0,-69.0,-74.0,-70.0,-66.0,-69.0,-73.0,-89.0,-89.0,-86.0,-87.0,19.0,23.0,17.0,13.0,1
3093,CC:2F:71:3E:C5:1F,3835504,483744792,862,105270,3834642,483639522,0,3604,302568,2973,227666,631,74902,912,8,1240,19,0,37,144444.0,39000.0,-80.0,-83.0,-76.0,-71.0,-73.0,-74.0,-70.0,-63.0,-89.0,-89.0,-86.0,-87.0,9.0,6.0,10.0,16.0,1
3094,BA:8C:B9:54:50:24,3839470,489821415,4827,6181833,3834643,483639582,0,8940,1695723,8918,1692228,22,3495,2348,15,5259,39,0,56,229410.0,130000.0,-40.0,-37.0,-46.0,-52.0,-41.0,-35.0,-44.0,-48.0,-89.0,-89.0,-86.0,-87.0,49.0,52.0,40.0,35.0,1
3095,62:47:05:9D:EB:15,3834683,483648805,36,8819,3834647,483639986,0,55,8893,45,6865,10,2028,37,0,47,0,0,3,216660.0,130000.0,-57.0,-51.0,-49.0,-61.0,-58.0,-51.0,-50.0,-61.0,-89.0,-89.0,-86.0,-87.0,32.0,38.0,37.0,26.0,1
3096,3C:55:76:E8:8F:1F,3842799,501261027,8152,17621041,3834647,483639986,0,6326,1857660,6119,1819077,207,38583,3430,13,8166,576,0,82,258080.0,154850.0,-46.0,-53.0,-52.0,-39.0,-47.0,-53.0,-50.0,-40.0,-89.0,-89.0,-86.0,-87.0,43.0,36.0,34.0,48.0,1
3097,92:69:1D:31:68:E9,3838526,487248206,3877,3608018,3834649,483640188,0,4685,1086088,4545,1054423,140,31665,2086,10,4074,84,0,42,229410.0,130000.0,-52.0,-47.0,-42.0,-49.0,-51.0,-47.0,-43.0,-48.0,-89.0,-89.0,-86.0,-87.0,37.0,42.0,44.0,38.0,1
3098,CC:2F:71:3F:1F:24,4575930,1269971924,741281,786331736,3834649,483640188,37,592714,604699909,592001,604614107,713,85802,572191,15,741537,84174,34,492,144444.0,43333.0,-70.0,-67.0,-70.0,-73.0,-70.0,-66.0,-70.0,-73.0,-89.0,-89.0,-86.0,-87.0,19.0,22.0,16.0,14.0,1
3099,CC:2F:71:3E:C5:1F,3835511,483745458,862,105270,3834649,483640188,0,3604,302568,2973,227666,631,74902,912,8,1240,19,0,37,144444.0,39000.0,-80.0,-83.0,-76.0,-71.0,-73.0,-74.0,-70.0,-63.0,-89.0,-89.0,-86.0,-87.0,9.0,6.0,10.0,16.0,1
3100,BA:8C:B9:54:50:24,3839476,489822021,4827,6181833,3834649,483640188,0,8940,1695723,8918,1692228,22,3495,2348,15,5259,39,0,56,229410.0,130000.0,-40.0,-37.0,-46.0,-52.0,-41.0,-35.0,-44.0,-48.0,-89.0,-89.0,-86.0,-87.0,49.0,52.0,40.0,35.0,1
3101,62:47:05:9D:EB:15,3834689,483650333,36,8819,3834653,483641514,0,55,8893,45,6865,10,2028,37,0,47,0,0,3,216660.0,130000.0,-57.0,-51.0,-49.0,-61.0,-58.0,-51.0,-50.0,-61.0,-89.0,-89.0,-86.0,-87.0,32.0,38.0,37.0,26.0,1
3102,3C:55:76:E8:8F:1F,3842805,501262555,8152,17621041,3834653,483641514,0,6333,1858138,6126,1819555,207,38583,3430,13,8166,576,0,83,258080.0,154850.0,-47.0,-54.0,-52.0,-40.0,-46.0,-53.0,-52.0,-39.0,-89.0,-89.0,-86.0,-87.0,42.0,35.0,34.0,47.0,1
3103,92:69:1D:31:68:E9,3838530,487249532,3877,3608018,3834653,483641514,0,4685,1086088,4545,1054423,140,31665,2086,10,4074,84,0,42,229410.0,130000.0,-52.0,-47.0,-42.0,-49.0,-51.0,-47.0,-43.0,-48.0,-89.0,-89.0,-86.0,-87.0,37.0,42.0,44.0,38.0,1
3104,CC:2F:71:3F:1F:24,4576144,1270236502,741491,786594988,3834653,483641514,37,592910,604959619,592197,604873817,713,85802,572378,15,741747,84178,34,492,144444.0,43333.0,-70.0,-66.0,-70.0,-74.0,-70.0,-66.0,-70.0,-73.0,-89.0,-89.0,-86.0,-87.0,19.0,23.0,16.0,13.0,1
3105,CC:2F:71:3E:C5:1F,3835516,483746846,862,105270,3834654,483641576,0,3604,302568,2973,227666,631,74902,912,8,1240,19,0,37,144444.0,39000.0,-80.0,-83.0,-76.0,-71.0,-73.0,-74.0,-70.0,-63.0,-89.0,-89.0,-86.0,-87.0,9.0,6.0,10.0,16.0,1
3106,BA:8C:B9:54:50:24,3839483,489823611,4827,6181833,3834656,483641778,0,8940,1695723,8918,1692228,22,3495,2348,15,5259,39,0,56,229410.0,130000.0,-40.0,-37.0,-46.0,-52.0,-41.0,-35.0,-44.0,-48.0,-89.0,-89.0,-86.0,-87.0,49.0,52.0,40.0,35.0,1
3107,62:47:05:9D:EB:15,3834698,483651123,36,8819,3834662,483642304,0,55,8893,45,6865,10,2028,37,0,47,0,0,3,216660.0,130000.0,-57.0,-51.0,-49.0,-61.0,-58.0,-51.0,-50.0,-61.0,-89.0,-89.0,-86.0,-87.0,32.0,38.0,37.0,26.0,1
3108,3C:55:76:E8:8F:1F,3842819,501264136,8157,17621832,3834662,483642304,0,6356,1865706,6148,1827005,208,38701,3437,13,8171,576,0,84,270830.0,162500.0,-49.0,-53.0,-43.0,-44.0,-48.0,-52.0,-43.0,-43.0,-89.0,-89.0,-86.0,-87.0,40.0,36.0,43.0,43.0,1
3109,92:69:1D:31:68:E9,3838539,487250322,3877,3608018,3834662,483642304,0,4685,1086088,4545,1054423,140,31665,2086,10,4074,84,0,42,229410.0,130000.0,-52.0,-47.0,-42.0,-49.0,-51.0,-47.0,-43.0,-48.0,-89.0,-89.0,-86.0,-87.0,37.0,42.0,44.0,38.0,1
3110,CC:2F:71:3F:1F:24,4576363,1270497638,741699,786855132,3834664,483642506,37,593098,605206927,592384,605121007,714,85920,572563,15,741955,84184,34,492,144444.0,43333.0,-70.0,-67.0,-70.0,-73.0,-70.0,-66.0,-70.0,-73.0,-89.0,-89.0,-86.0,-87.0,19.0,22.0,16.0,14.0,1
3111,CC:2F:71:3E:C5:1F,3835526,483747776,862,105270,3834664,483642506,0,3604,302568,2973,227666,631,74902,912,8,1240,19,0,37,144444.0,39000.0,-80.0,-83.0,-76.0,-71.0,-73.0,-74.0,-70.0,-63.0,-89.0,-89.0,-86.0,-87.0,9.0,6.0,10.0,16.0,1
3112,BA:8C:B9:54:50:24,3839491,489824339,4827,6181833,3834664,483642506,0,8940,1695723,8918,1692228,22,3495,2348,15,5259,39,0,56,229410.0,130000.0,-40.0,-37.0,-46.0,-52.0,-41.0,-35.0,-44.0,-48.0,-89.0,-89.0,-86.0,-87.0,49.0,52.0,40.0,35.0,1
3113,62:47:05:9D:EB:15,3834700,483651325,36,8819,3834664,483642506,0,55,8893,45,6865,10,2028,37,0,47,0,0,3,216660.0,130000.0,-57.0,-51.0,-49.0,-61.0,-58.0,-51.0,-50.0,-61.0,-89.0,-89.0,-86.0,-87.0,32.0,38.0,37.0,26.0,1
3114,3C:55:76:E8:8F:1F,3843901,504134557,9237,20492051,3834664,483642506,0,6612,1902473,6404,1863772,208,38701,3557,13,9251,636,0,88,286760.0,172050.0,-49.0,-52.0,-43.0,-44.0,-48.0,-52.0,-43.0,-44.0,-89.0,-89.0,-86.0,-87.0,40.0,37.0,43.0,43.0,1
3115,92:69:1D:31:68:E9,3838543,487250726,3877,3608018,3834666,483642708,0,4685,1086088,4545,1054423,140,31665,2086,10,4074,84,0,42,229410.0,130000.0,-52.0,-47.0,-42.0,-49.0,-51.0,-47.0,-43.0,-48.0,-89.0,-89.0,-86.0,-87.0,37.0,42.0,44.0,38.0,1
3116,CC:2F:71:3F:1F:24,4576584,1270769095,741918,787126387,3834666,483642708,37,593300,605464982,592586,605379062,714,85920,572759,15,742174,84188,34,492,144444.0,43333.0,-70.0,-67.0,-70.0,-74.0,-70.0,-66.0,-70.0,-73.0,-89.0,-89.0,-86.0,-87.0,19.0,22.0,16.0,13.0,1
3117,CC:2F:71:3E:C5:1F,3835530,483748180,862,105270,3834668,483642910,0,3604,302568,2973,227666,631,74902,912,8,1240,19,0,37,144444.0,39000.0,-80.0,-83.0,-76.0,-71.0,-73.0,-74.0,-70.0,-63.0,-89.0,-89.0,-86.0,-87.0,9.0,6.0,10.0,16.0,1
3118,BA:8C:B9:54:50:24,3839495,489824743,4827,6181833,3834668,483642910,0,8940,1695723,8918,1692228,22,3495,2348,15,5259,39,0,56,229410.0,130000.0,-40.0,-37.0,-46.0,-52.0,-41.0,-35.0,-44.0,-48.0,-89.0,-89.0,-86.0,-87.0,49.0,52.0,40.0,35.0,1
3119,62:47:05:9D:EB:15,3834709,483652193,36,8819,3834673,483643374,0,55,8893,45,6865,10,2028,37,0,47,0,0,3,216660.0,130000.0,-57.0,-51.0,-49.0,-61.0,-58.0,-51.0,-50.0,-61.0,-89.0,-89.0,-86.0,-87.0,32.0,38.0,37.0,26.0,1
3120,3C:55:76:E8:8F:1F,3844495,505549873,9821,21906226,3834674,483643647,0,6824,1964006,6616,1925305,208,38701,3694,13,9835,661,0,89,286760.0,172050.0,-48.0,-52.0,-44.0,-44.0,-48.0,-52.0,-43.0,-44.0,-89.0,-89.0,-86.0,-87.0,41.0,37.0,42.0,43.0,1
3121,92:69:1D:31:68:E9,3838551,487251665,3877,3608018,3834674,483643647,0,4685,1086088,4545,1054423,140,31665,2086,10,4074,84,0,42,229410.0,130000.0,-52.0,-47.0,-42.0,-49.0,-51.0,-47.0,-43.0,-48.0,-89.0,-89.0,-86.0,-87.0,37.0,42.0,44.0,38.0,1
3122,CC:2F:71:3F:1F:24,4576805,1271039372,742131,787395725,3834674,483643647,37,593492,605719872,592778,605633952,714,85920,572948,15,742386,84188,34,492,144444.0,43333.0,-70.0,-67.0,-70.0,-73.0,-70.0,-66.0,-70.0,-73.0,-89.0,-89.0,-86.0,-87.0,19.0,22.0,16.0,14.0,1
3123,CC:2F:71:3E:C5:1F,3835536,483748917,862,105270,3834674,483643647,0,3604,302568,2973,227666,631,74902,912,8,1240,19,0,37,144444.0,39000.0,-80.0,-83.0,-76.0,-71.0,-73.0,-74.0,-70.0,-63.0,-89.0,-89.0,-86.0,-87.0,9.0,6.0,10.0,16.0,1
3124,BA:8C:B9:54:50:24,3839501,489825480,4827,6181833,3834674,483643647,0,8940,1695723,8918,1692228,22,3495,2348,15,5259,39,0,56,229410.0,130000.0,-40.0,-37.0,-46.0,-52.0,-41.0,-35.0,-44.0,-48.0,-89.0,-89.0,-86.0,-87.0,49.0,52.0,40.0,35.0,1
3125,62:47:05:9D:EB:15,3834714,483652870,36,8819,3834678,483644051,0,55,8893,45,6865,10,2028,37,0,47,0,0,3,216660.0,130000.0,-57.0,-51.0,-49.0,-61.0,-58.0,-51.0,-50.0,-61.0,-89.0,-89.0,-86.0,-87.0,32.0,38.0,37.0,26.0,1
3126,3C:55:76:E8:8F:1F,3844501,505551161,9823,21907110,3834678,483644051,0,6838,1965026,6630,1926325,208,38701,3695,13,9837,661,0,89,286760.0,172050.0,-51.0,-65.0,-50.0,-45.0,-48.0,-54.0,-44.0,-44.0,-89.0,-89.0,-86.0,-87.0,38.0,24.0,36.0,42.0,1
3127,92:69:1D:31:68:E9,3838555,487252069,3877,3608018,3834678,483644051,0,4685,1086088,4545,1054423,140,31665,2086,10,4074,84,0,42,229410.0,130000.0,-52.0,-47.0,-42.0,-49.0,-51.0,-47.0,-43.0,-48.0,-89.0,-89.0,-86.0,-87.0,37.0,42.0,44.0,38.0,1
3128,CC:2F:71:3F:1F:24,4577024,1271307950,742346,787663899,3834678,483644051,37,593679,605970022,592965,605884102,714,85920,573135,15,742602,84191,34,492,144444.0,43333.0,-70.0,-67.0,-70.0,-74.0,-70.0,-67.0,-70.0,-73.0,-89.0,-89.0,-86.0,-87.0,19.0,22.0,16.0,13.0,1
3129,CC:2F:71:3E:C5:1F,3835540,483749321,862,105270,3834678,483644051,0,3604,302568,2973,227666,631,74902,912,8,1240,19,0,37,144444.0,39000.0,-80.0,-83.0,-76.0,-71.0,-73.0,-74.0,-70.0,-63.0,-89.0,-89.0,-86.0,-87.0,9.0,6.0,10.0,16.0,1
3130,BA:8C:B9:54:50:24,3839507,489826086,4827,6181833,3834680,483644253,0,8940,1695723,8918,1692228,22,3495,2348,15,5259,39,0,56,229410.0,130000.0,-40.0,-37.0,-46.0,-52.0,-41.0,-35.0,-44.0,-48.0,-89.0,-89.0,-86.0,-87.0,49.0,52.0,40.0,35.0,1
3131,62:47:05:9D:EB:15,3834718,483653274,36,8819,3834682,483644455,0,55,8893,45,6865,10,2028,37,0,47,0,0,3,216660.0,130000.0,-57.0,-51.0,-49.0,-61.0,-58.0,-51.0,-50.0,-61.0,-89.0,-89.0,-86.0,-87.0,32.0,38.0,37.0,26.0,1
3132,3C:55:76:E8:8F:1F,3844505,505551565,9823,21907110,3834682,483644455,0,6838,1965026,6630,1926325,208,38701,3695,13,9837,661,0,89,286760.0,172050.0,-51.0,-65.0,-50.0,-45.0,-48.0,-54.0,-44.0,-44.0,-89.0,-89.0,-86.0,-87.0,38.0,24.0,36.0,42.0,1
3133,92:69:1D:31:68:E9,3838559,487252473,3877,3608018,3834682,483644455,0,4685,1086088,4545,1054423,140,31665,2086,10,4074,84,0,42,229410.0,130000.0,-52.0,-47.0,-42.0,-49.0,-51.0,-47.0,-43.0,-48.0,-89.0,-89.0,-86.0,-87.0,37.0,42.0,44.0,38.0,1
3134,CC:2F:71:3F:1F:24,4577242,1271571874,742559,787927359,3834683,483644515,37,593868,606218872,593154,606132952,714,85920,573322,15,742815,84195,34,493,144444.0,43333.0,-70.0,-66.0,-70.0,-73.0,-70.0,-66.0,-70.0,-73.0,-89.0,-89.0,-86.0,-87.0,19.0,23.0,16.0,14.0,1
3135,CC:2F:71:3E:C5:1F,3835545,483749785,862,105270,3834683,483644515,0,3604,302568,2973,227666,631,74902,912,8,1240,19,0,37,144444.0,39000.0,-80.0,-83.0,-76.0,-71.0,-73.0,-74.0,-70.0,-63.0,-89.0,-89.0,-86.0,-87.0,9.0,6.0,10.0,16.0,1
3136,BA:8C:B9:54:50:24,3839511,489826474,4827,6181833,3834684,483644641,0,8940,1695723,8918,1692228,22,3495,2348,15,5259,39,0,56,229410.0,130000.0,-40.0,-37.0,-46.0,-52.0,-41.0,-35.0,-44.0,-48.0,-89.0,-89.0,-86.0,-87.0,49.0,52.0,40.0,35.0,1
3137,62:47:05:9D:EB:15,3834724,483653864,36,8819,3834688,483645045,0,55,8893,45,6865,10,2028,37,0,47,0,0,3,216660.0,130000.0,-57.0,-51.0,-49.0,-61.0,-58.0,-51.0,-50.0,-61.0,-89.0,-89.0,-86.0,-87.0,32.0,38.0,37.0,26.0,1
3138,3C:55:76:E8:8F:1F,3844513,505552357,9823,21907110,3834690,483645247,0,6838,1965026,6630,1926325,208,38701,3695,13,9837,661,0,89,286760.0,172050.0,-51.0,-65.0,-50.0,-45.0,-48.0,-54.0,-44.0,-44.0,-89.0,-89.0,-86.0,-87.0,38.0,24.0,36.0,42.0,1
3139,92:69:1D:31:68:E9,3838567,487253265,3877,3608018,3834690,483645247,0,4685,1086088,4545,1054423,140,31665,2086,10,4074,84,0,42,229410.0,130000.0,-52.0,-47.0,-42.0,-49.0,-51.0,-47.0,-43.0,-48.0,-89.0,-89.0,-86.0,-87.0,37.0,42.0,44.0,38.0,1
3140,CC:2F:71:3F:1F:24,4577468,1271842437,742778,788197190,3834690,483645247,37,594076,606483713,593362,606397793,714,85920,573518,15,743034,84199,34,494,144444.0,43333.0,-70.0,-66.0,-70.0,-72.0,-70.0,-66.0,-70.0,-72.0,-89.0,-89.0,-86.0,-87.0,19.0,23.0,16.0,15.0,1
3141,CC:2F:71:3E:C5:1F,3835552,483750517,862,105270,3834690,483645247,0,3604,302568,2973,227666,631,74902,912,8,1240,19,0,37,144444.0,39000.0,-80.0,-83.0,-76.0,-71.0,-73.0,-74.0,-70.0,-63.0,-89.0,-89.0,-86.0,-87.0,9.0,6.0,10.0,16.0,1
3142,BA:8C:B9:54:50:24,3839517,489827080,4827,6181833,3834690,483645247,0,8940,1695723,8918,1692228,22,3495,2348,15,5259,39,0,56,229410.0,130000.0,-40.0,-37.0,-46.0,-52.0,-41.0,-35.0,-44.0,-48.0,-89.0,-89.0,-86.0,-87.0,49.0,52.0,40.0,35.0,1
3143,62:47:05:9D:EB:15,3834728,483654268,36,8819,3834692,483645449,0,55,8893,45,6865,10,2028,37,0,47,0,0,3,216660.0,130000.0,-57.0,-51.0,-49.0,-61.0,-58.0,-51.0,-50.0,-61.0,-89.0,-89.0,-86.0,-87.0,32.0,38.0,37.0,26.0,1
3144,3C:55:76:E8:8F:1F,3844525,505555512,9833,21910063,3834692,483645449,0,6885,1982982,6677,1944281,208,38701,3714,13,9847,662,0,89,286760.0,172050.0,-47.0,-55.0,-51.0,-39.0,-48.0,-55.0,-50.0,-40.0,-89.0,-89.0,-86.0,-87.0,42.0,34.0,35.0,48.0,1
3145,92:69:1D:31:68:E9,3838569,487253467,3877,3608018,3834692,483645449,0,4685,1086088,4545,1054423,140,31665,2086,10,4074,84,0,42,229410.0,130000.0,-52.0,-47.0,-42.0,-49.0,-51.0,-47.0,-43.0,-48.0,-89.0,-89.0,-86.0,-87.0,37.0,42.0,44.0,38.0,1
3146,CC:2F:71:3F:1F:24,4577680,1272105891,742988,788460442,3834692,483645449,37,594268,606736151,593554,606650231,714,85920,573703,15,743244,84202,34,494,144444.0,43333.0,-70.0,-66.0,-70.0,-73.0,-70.0,-66.0,-70.0,-73.0,-89.0,-89.0,-86.0,-87.0,19.0,23.0,16.0,14.0,1
3147,CC:2F:71:3E:C5:1F,3835554,483750719,862,105270,3834692,483645449,0,3604,302568,2973,227666,631,74902,912,8,1240,19,0,37,144444.0,39000.0,-80.0,-83.0,-76.0,-71.0,-73.0,-74.0,-70.0,-63.0,-89.0,-89.0,-86.0,-87.0,9.0,6.0,10.0,16.0,1
3148,BA:8C:B9:54:50:24,3839521,489827484,4827,6181833,3834694,483645651,0,8940,1695723,8918,1692228,22,3495,2348,15,5259,39,0,56,229410.0,130000.0,-40.0,-37.0,-46.0,-52.0,-41.0,-35.0,-44.0,-48.0,-89.0,-89.0,-86.0,-87.0,49.0,52.0,40.0,35.0,1
3149,62:47:05:9D:EB:15,3834735,483654934,36,8819,3834699,483646115,0,55,8893,45,6865,10,2028,37,0,47,0,0,3,216660.0,130000.0,-57.0,-51.0,-49.0,-61.0,-58.0,-51.0,-50.0,-61.0,-89.0,-89.0,-86.0,-87.0,32.0,38.0,37.0,26.0,1
3150,3C:55:76:E8:8F:1F,3844535,505556798,9836,21910683,3834699,483646115,0,6912,1985022,6704,1946321,208,38701,3717,13,9850,664,0,89,286760.0,172050.0,-48.0,-59.0,-46.0,-41.0,-47.0,-54.0,-44.0,-41.0,-89.0,-89.0,-86.0,-87.0,41.0,30.0,40.0,46.0,1
3151,92:69:1D:31:68:E9,3838576,487254133,3877,3608018,3834699,483646115,0,4685,1086088,4545,1054423,140,31665,2086,10,4074,84,0,42,229410.0,130000.0,-52.0,-47.0,-42.0,-49.0,-51.0,-47.0,-43.0,-48.0,-89.0,-89.0,-86.0,-87.0,37.0,42.0,44.0,38.0,1
3152,CC:2F:71:3F:1F:24,4577911,1272388915,743210,788742598,3834701,483646317,37,594484,607021203,593770,606935283,714,85920,573904,15,743466,84208,34,494,144444.0,43333.0,-70.0,-66.0,-70.0,-74.0,-70.0,-66.0,-70.0,-73.0,-89.0,-89.0,-86.0,-87.0,19.0,23.0,16.0,13.0,1
3153,CC:2F:71:3E:C5:1F,3835563,483751587,862,105270,3834701,483646317,0,3604,302568,2973,227666,631,74902,912,8,1240,19,0,37,144444.0,39000.0,-80.0,-83.0,-76.0,-71.0,-73.0,-74.0,-70.0,-63.0,-89.0,-89.0,-86.0,-87.0,9.0,6.0,10.0,16.0,1
3154,BA:8C:B9:54:50:24,3839528,489828150,4827,6181833,3834701,483646317,0,8940,1695723,8918,1692228,22,3495,2348,15,5259,39,0,56,229410.0,130000.0,-40.0,-37.0,-46.0,-52.0,-41.0,-35.0,-44.0,-48.0,-89.0,-89.0,-86.0,-87.0,49.0,52.0,40.0,35.0,1
3155,62:47:05:9D:EB:15,3834737,483655136,36,8819,3834701,483646317,0,55,8893,45,6865,10,2028,37,0,47,0,0,3,216660.0,130000.0,-57.0,-51.0,-49.0,-61.0,-58.0,-51.0,-50.0,-61.0,-89.0,-89.0,-86.0,-87.0,32.0,38.0,37.0,26.0,1
3156,3C:55:76:E8:8F:1F,3844543,505557872,9840,21911353,3834703,483646519,0,6942,1988149,6734,1949448,208,38701,3722,13,9854,664,0,89,286760.0,172050.0,-45.0,-54.0,-51.0,-37.0,-47.0,-54.0,-45.0,-40.0,-89.0,-89.0,-86.0,-87.0,44.0,35.0,35.0,50.0,1
3157,92:69:1D:31:68:E9,3838580,487254537,3877,3608018,3834703,483646519,0,4685,1086088,4545,1054423,140,31665,2086,10,4074,84,0,42,229410.0,130000.0,-52.0,-47.0,-42.0,-49.0,-51.0,-47.0,-43.0,-48.0,-89.0,-89.0,-86.0,-87.0,37.0,42.0,44.0,38.0,1
3158,CC:2F:71:3F:1F:24,4578129,1272655710,743426,789009191,3834703,483646519,37,594681,607275770,593967,607189850,714,85920,574096,15,743682,84210,34,494,144444.0,43333.0,-70.0,-67.0,-70.0,-73.0,-70.0,-66.0,-70.0,-72.0,-89.0,-89.0,-86.0,-87.0,19.0,22.0,16.0,14.0,1
3159,CC:2F:71:3E:C5:1F,3835565,483751789,862,105270,3834703,483646519,0,3604,302568,2973,227666,631,74902,912,8,1240,19,0,37,144444.0,39000.0,-80.0,-83.0,-76.0,-71.0,-73.0,-74.0,-70.0,-63.0,-89.0,-89.0,-86.0,-87.0,9.0,6.0,10.0,16.0,1
3160,BA:8C:B9:54:50:24,3839530,489828352,4827,6181833,3834703,483646519,0,8940,1695723,8918,1692228,22,3495,2348,15,5259,39,0,56,229410.0,130000.0,-40.0,-37.0,-46.0,-52.0,-41.0,-35.0,-44.0,-48.0,-89.0,-89.0,-86.0,-87.0,49.0,52.0,40.0,35.0,1
3161,62:47:05:9D:EB:15,3834746,483656004,36,8819,3834710,483647185,0,55,8893,45,6865,10,2028,37,0,47,0,0,3,216660.0,130000.0,-57.0,-51.0,-49.0,-61.0,-58.0,-51.0,-50.0,-61.0,-89.0,-89.0,-86.0,-87.0,32.0,38.0,37.0,26.0,1
3162,3C:55:76:E8:8F:1F,3845236,507270688,10526,23623503,3834710,483647185,3,7161,2067960,6953,2029259,208,38701,3803,14,10528,882,3,90,286760.0,172050.0,-45.0,-53.0,-50.0,-37.0,-47.0,-53.0,-48.0,-40.0,-89.0,-89.0,-86.0,-87.0,44.0,36.0,36.0,50.0,1
3163,92:69:1D:31:68:E9,3838587,487255203,3877,3608018,3834710,483647185,0,4686,1086156,4546,1054491,140,31665,2086,10,4074,84,0,42,229410.0,130000.0,-52.0,-47.0,-44.0,-47.0,-51.0,-47.0,-43.0,-48.0,-89.0,-89.0,-86.0,-87.0,37.0,42.0,42.0,40.0,1
3164,CC:2F:71:3F:1F:24,4578368,1272953944,743658,789306759,3834710,483647185,37,594897,607566306,594183,607480386,714,85920,574305,15,743914,84217,34,494,144444.0,43333.0,-70.0,-67.0,-70.0,-73.0,-70.0,-66.0,-70.0,-72.0,-89.0,-89.0,-86.0,-87.0,19.0,22.0,16.0,14.0,1
3165,CC:2F:71:3E:C5:1F,3835572,483752455,862,105270,3834710,483647185,0,3604,302568,2973,227666,631,74902,912,8,1240,19,0,37,144444.0,39000.0,-80.0,-83.0,-76.0,-71.0,-73.0,-74.0,-70.0,-63.0,-89.0,-89.0,-86.0,-87.0,9.0,6.0,10.0,16.0,1
3166,BA:8C:B9:54:50:24,3839537,489829018,4827,6181833,3834710,483647185,0,8940,1695723,8918,1692228,22,3495,2348,15,5259,39,0,56,229410.0,130000.0,-40.0,-37.0,-46.0,-52.0,-41.0,-35.0,-44.0,-48.0,-89.0,-89.0,-86.0,-87.0,49.0,52.0,40.0,35.0,1
3167,62:47:05:9D:EB:15,3834750,483656408,36,8819,3834714,483647589,0,55,8893,45,6865,10,2028,37,0,47,0,0,3,216660.0,130000.0,-57.0,-51.0,-49.0,-61.0,-58.0,-51.0,-50.0,-61.0,-89.0,-89.0,-86.0,-87.0,32.0,38.0,37.0,26.0,1
3168,3C:55:76:E8:8F:1F,3845643,508281883,10927,24634092,3834716,483647791,7,7369,2100039,7161,2061338,208,38701,3867,15,10943,987,7,90,286760.0,172050.0,-46.0,-51.0,-40.0,-40.0,-45.0,-53.0,-48.0,-38.0,-89.0,-90.0,-86.0,-87.0,43.0,39.0,46.0,47.0,1
3169,92:69:1D:31:68:E9,3838593,487255809,3877,3608018,3834716,483647791,0,4686,1086156,4546,1054491,140,31665,2086,10,4074,84,0,42,229410.0,130000.0,-52.0,-47.0,-44.0,-47.0,-51.0,-47.0,-43.0,-48.0,-89.0,-90.0,-86.0,-87.0,37.0,43.0,42.0,40.0,1
3170,CC:2F:71:3F:1F:24,4578586,1273223758,743870,789575967,3834716,483647791,37,595096,607830720,594382,607744800,714,85920,574496,15,744126,84221,34,495,144444.0,43333.0,-70.0,-66.0,-70.0,-73.0,-70.0,-66.0,-70.0,-73.0,-89.0,-90.0,-86.0,-87.0,19.0,24.0,16.0,14.0,1
3171,CC:2F:71:3E:C5:1F,3835578,483753061,862,105270,3834716,483647791,0,3604,302568,2973,227666,631,74902,912,8,1240,19,0,37,144444.0,39000.0,-80.0,-83.0,-76.0,-71.0,-73.0,-74.0,-70.0,-63.0,-89.0,-90.0,-86.0,-87.0,9.0,7.0,10.0,16.0,1
3172,BA:8C:B9:54:50:24,3839543,489829624,4827,6181833,3834716,483647791,0,8940,1695723,8918,1692228,22,3495,2348,15,5259,39,0,56,229410.0,130000.0,-40.0,-37.0,-46.0,-52.0,-41.0,-35.0,-44.0,-48.0,-89.0,-90.0,-86.0,-87.0,49.0,53.0,40.0,35.0,1
3173,62:47:05:9D:EB:15,3834755,483656872,36,8819,3834719,483648053,0,55,8893,45,6865,10,2028,37,0,47,0,0,3,216660.0,130000.0,-57.0,-51.0,-49.0,-61.0,-58.0,-51.0,-50.0,-61.0,-89.0,-90.0,-86.0,-87.0,32.0,39.0,37.0,26.0,1
3174,3C:55:76:E8:8F:1F,3845649,508282662,10930,24634609,3834719,483648053,7,7395,2105920,7187,2067219,208,38701,3872,15,10946,990,7,90,286760.0,1000.0,-46.0,-52.0,-41.0,-41.0,-46.0,-52.0,-44.0,-40.0,-89.0,-90.0,-86.0,-87.0,43.0,38.0,45.0,46.0,1
3175,92:69:1D:31:68:E9,3838596,487256071,3877,3608018,3834719,483648053,0,4686,1086156,4546,1054491,140,31665,2086,10,4074,84,0,42,229410.0,130000.0,-52.0,-47.0,-44.0,-47.0,-51.0,-47.0,-43.0,-48.0,-89.0,-90.0,-86.0,-87.0,37.0,43.0,42.0,40.0,1
3176,CC:2F:71:3F:1F:24,4578799,1273490120,744080,789842067,3834719,483648053,37,595296,608089688,594582,608003768,714,85920,574684,15,744336,84230,34,495,144444.0,43333.0,-70.0,-66.0,-70.0,-73.0,-70.0,-66.0,-69.0,-73.0,-89.0,-90.0,-86.0,-87.0,19.0,24.0,16.0,14.0,1
3177,CC:2F:71:3E:C5:1F,3835581,483753323,862,105270,3834719,483648053,0,3604,302568,2973,227666,631,74902,912,8,1240,19,0,37,144444.0,39000.0,-80.0,-83.0,-76.0,-71.0,-73.0,-74.0,-70.0,-63.0,-89.0,-90.0,-86.0,-87.0,9.0,7.0,10.0,16.0,1
3178,BA:8C:B9:54:50:24,3839546,489829886,4827,6181833,3834719,483648053,0,8940,1695723,8918,1692228,22,3495,2348,15,5259,39,0,56,229410.0,130000.0,-40.0,-37.0,-46.0,-52.0,-41.0,-35.0,-44.0,-48.0,-89.0,-90.0,-86.0,-87.0,49.0,53.0,40.0,35.0,1
3179,62:47:05:9D:EB:15,3834762,483657538,37,8879,3834725,483648659,0,57,9029,47,7001,10,2028,37,0,48,0,0,3,216660.0,130000.0,-55.0,-51.0,-49.0,-62.0,-57.0,-51.0,-49.0,-61.0,-89.0,-90.0,-86.0,-87.0,34.0,39.0,37.0,25.0,1
3180,3C:55:76:E8:8F:1F,3845658,508283542,10933,24634883,3834725,483648659,7,7407,2106848,7199,2068147,208,38701,3874,15,10949,990,7,90,286760.0,172050.0,-48.0,-53.0,-43.0,-44.0,-47.0,-52.0,-42.0,-42.0,-89.0,-90.0,-86.0,-87.0,41.0,37.0,43.0,43.0,1
3181,92:69:1D:31:68:E9,3838603,487256737,3878,3608078,3834725,483648659,0,4688,1086292,4548,1054627,140,31665,2086,10,4075,84,0,42,229410.0,130000.0,-51.0,-47.0,-42.0,-48.0,-51.0,-47.0,-42.0,-48.0,-89.0,-90.0,-86.0,-87.0,38.0,43.0,44.0,39.0,1
3182,CC:2F:71:3F:1F:24,4579021,1273754457,744296,790105798,3834725,483648659,37,595495,608344562,594781,608258642,714,85920,574876,15,744552,84240,34,495,144444.0,43333.0,-70.0,-66.0,-70.0,-73.0,-70.0,-66.0,-70.0,-73.0,-89.0,-90.0,-86.0,-87.0,19.0,24.0,16.0,14.0,1
3183,CC:2F:71:3E:C5:1F,3835588,483754045,863,105386,3834725,483648659,0,3606,302708,2975,227806,631,74902,912,8,1241,19,0,37,144444.0,39000.0,-71.0,-72.0,-68.0,-61.0,-73.0,-74.0,-70.0,-63.0,-89.0,-90.0,-86.0,-87.0,18.0,18.0,18.0,26.0,1
3184,BA:8C:B9:54:50:24,3839555,489830810,4828,6181949,3834727,483648861,0,8944,1695995,8922,1692500,22,3495,2348,15,5260,39,0,56,229410.0,130000.0,-48.0,-35.0,-43.0,-45.0,-42.0,-35.0,-44.0,-48.0,-89.0,-90.0,-86.0,-87.0,41.0,55.0,43.0,42.0,1
3185,62:47:05:9D:EB:15,3834764,483657740,37,8879,3834727,483648861,0,57,9029,47,7001,10,2028,37,0,48,0,0,3,216660.0,130000.0,-55.0,-51.0,-49.0,-62.0,-57.0,-51.0,-49.0,-61.0,-89.0,-90.0,-86.0,-87.0,34.0,39.0,37.0,25.0,1
3186,3C:55:76:E8:8F:1F,3845660,508283744,10933,24634883,3834727,483648861,7,7407,2106848,7199,2068147,208,38701,3874,15,10949,990,7,90,286760.0,172050.0,-48.0,-53.0,-43.0,-44.0,-47.0,-52.0,-42.0,-42.0,-89.0,-90.0,-86.0,-87.0,41.0,37.0,43.0,43.0,1
3187,92:69:1D:31:68:E9,3838605,487256939,3878,3608078,3834727,483648861,0,4688,1086292,4548,1054627,140,31665,2086,10,4075,84,0,42,229410.0,130000.0,-51.0,-47.0,-42.0,-48.0,-51.0,-47.0,-42.0,-48.0,-89.0,-90.0,-86.0,-87.0,38.0,43.0,44.0,39.0,1
3188,CC:2F:71:3F:1F:24,4579232,1274014919,744505,790366058,3834727,483648861,37,595689,608601172,594975,608515252,714,85920,575060,15,744761,84248,34,495,144444.0,43333.0,-70.0,-67.0,-70.0,-73.0,-70.0,-66.0,-70.0,-73.0,-89.0,-90.0,-86.0,-87.0,19.0,23.0,16.0,14.0,1
3189,CC:2F:71:3E:C5:1F,3835593,483754509,863,105386,3834730,483649123,0,3606,302708,2975,227806,631,74902,912,8,1241,19,0,37,144444.0,39000.0,-71.0,-72.0,-68.0,-61.0,-73.0,-74.0,-70.0,-63.0,-89.0,-90.0,-86.0,-87.0,18.0,18.0,18.0,26.0,1
3190,BA:8C:B9:54:50:24,3839558,489831072,4828,6181949,3834730,483649123,0,8944,1695995,8922,1692500,22,3495,2348,15,5260,39,0,56,229410.0,130000.0,-48.0,-35.0,-43.0,-45.0,-42.0,-35.0,-44.0,-48.0,-89.0,-90.0,-86.0,-87.0,41.0,55.0,43.0,42.0,1
3191,62:47:05:9D:EB:15,3834772,483658679,37,8879,3834735,483649800,0,57,9029,47,7001,10,2028,37,0,48,0,0,3,216660.0,130000.0,-55.0,-51.0,-49.0,-62.0,-57.0,-51.0,-49.0,-61.0,-89.0,-90.0,-86.0,-87.0,34.0,39.0,37.0,25.0,1
3192,3C:55:76:E8:8F:1F,3846293,509877406,11556,26227404,3834737,483650002,7,7594,2136308,7386,2097607,208,38701,3959,15,11572,1181,7,96,258080.0,154850.0,-48.0,-52.0,-43.0,-44.0,-48.0,-53.0,-43.0,-43.0,-89.0,-90.0,-86.0,-87.0,41.0,38.0,43.0,43.0,1
3193,92:69:1D:31:68:E9,3838615,487258080,3878,3608078,3834737,483650002,0,4688,1086292,4548,1054627,140,31665,2086,10,4075,84,0,42,229410.0,130000.0,-51.0,-47.0,-42.0,-48.0,-51.0,-47.0,-42.0,-48.0,-89.0,-90.0,-86.0,-87.0,38.0,43.0,44.0,39.0,1
3194,CC:2F:71:3F:1F:24,4579452,1274280736,744715,790630734,3834737,483650002,37,595881,608854742,595167,608768822,714,85920,575247,15,744971,84255,34,495,144444.0,43333.0,-70.0,-66.0,-70.0,-72.0,-70.0,-66.0,-70.0,-72.0,-89.0,-90.0,-86.0,-87.0,19.0,24.0,16.0,15.0,1
3195,CC:2F:71:3E:C5:1F,3835600,483755388,863,105386,3834737,483650002,0,3606,302708,2975,227806,631,74902,912,8,1241,19,0,37,144444.0,39000.0,-71.0,-72.0,-68.0,-61.0,-73.0,-74.0,-70.0,-63.0,-89.0,-90.0,-86.0,-87.0,18.0,18.0,18.0,26.0,1
3196,BA:8C:B9:54:50:24,3839565,489831951,4828,6181949,3834737,483650002,0,8944,1695995,8922,1692500,22,3495,2348,15,5260,39,0,56,229410.0,130000.0,-48.0,-35.0,-43.0,-45.0,-42.0,-35.0,-44.0,-48.0,-89.0,-90.0,-86.0,-87.0,41.0,55.0,43.0,42.0,1
3197,62:47:05:9D:EB:15,3834776,483659083,37,8879,3834739,483650204,0,57,9029,47,7001,10,2028,37,0,48,0,0,3,216660.0,130000.0,-55.0,-51.0,-49.0,-62.0,-57.0,-51.0,-49.0,-61.0,-89.0,-90.0,-86.0,-87.0,34.0,39.0,37.0,25.0,1
3198,3C:55:76:E8:8F:1F,3846366,509986284,11627,26336080,3834739,483650204,7,7674,2173842,7466,2135141,208,38701,4009,15,11643,1182,7,97,270830.0,162500.0,-50.0,-56.0,-47.0,-44.0,-49.0,-54.0,-44.0,-44.0,-89.0,-90.0,-86.0,-87.0,39.0,34.0,39.0,43.0,1
3199,92:69:1D:31:68:E9,3838617,487258282,3878,3608078,3834739,483650204,0,4688,1086292,4548,1054627,140,31665,2086,10,4075,84,0,42,229410.0,130000.0,-51.0,-47.0,-42.0,-48.0,-51.0,-47.0,-42.0,-48.0,-89.0,-90.0,-86.0,-87.0,38.0,43.0,44.0,39.0,1
3200,CC:2F:71:3F:1F:24,4579681,1274561809,744942,790911605,3834739,483650204,37,596093,609127019,595379,609041099,714,85920,575450,15,745198,84260,34,495,144444.0,43333.0,-70.0,-66.0,-70.0,-73.0,-70.0,-66.0,-69.0,-73.0,-89.0,-90.0,-86.0,-87.0,19.0,24.0,16.0,14.0,1
3201,CC:2F:71:3E:C5:1F,3835604,483755792,863,105386,3834741,483650406,0,3606,302708,2975,227806,631,74902,912,8,1241,19,0,37,144444.0,39000.0,-71.0,-72.0,-68.0,-61.0,-73.0,-74.0,-70.0,-63.0,-89.0,-90.0,-86.0,-87.0,18.0,18.0,18.0,26.0,1
3202,BA:8C:B9:54:50:24,3839569,489832355,4828,6181949,3834741,483650406,0,8944,1695995,8922,1692500,22,3495,2348,15,5260,39,0,56,229410.0,130000.0,-48.0,-35.0,-43.0,-45.0,-42.0,-35.0,-44.0,-48.0,-89.0,-90.0,-86.0,-87.0,41.0,55.0,43.0,42.0,1
3203,62:47:05:9D:EB:15,3834784,483659811,37,8879,3834747,483650932,0,57,9029,47,7001,10,2028,37,0,48,0,0,3,216660.0,130000.0,-55.0,-51.0,-49.0,-62.0,-57.0,-51.0,-49.0,-61.0,-89.0,-90.0,-86.0,-87.0,34.0,39.0,37.0,25.0,1
3204,3C:55:76:E8:8F:1F,3846378,509987850,11629,26336550,3834749,483651300,7,7699,2175776,7490,2136957,209,38819,4015,15,11645,1182,7,97,270830.0,162500.0,-46.0,-51.0,-40.0,-41.0,-47.0,-52.0,-41.0,-42.0,-89.0,-90.0,-86.0,-87.0,43.0,39.0,46.0,46.0,1
3205,92:69:1D:31:68:E9,3838627,487259378,3878,3608078,3834749,483651300,0,4688,1086292,4548,1054627,140,31665,2086,10,4075,84,0,42,229410.0,130000.0,-51.0,-47.0,-42.0,-48.0,-51.0,-47.0,-42.0,-48.0,-89.0,-90.0,-86.0,-87.0,38.0,43.0,44.0,39.0,1
3206,CC:2F:71:3F:1F:24,4579900,1274825915,745151,791174615,3834749,483651300,37,596289,609386981,595575,609301061,714,85920,575635,15,745407,84265,34,495,144444.0,43333.0,-71.0,-67.0,-71.0,-74.0,-71.0,-67.0,-70.0,-73.0,-89.0,-90.0,-86.0,-87.0,18.0,23.0,15.0,13.0,1
3207,CC:2F:71:3E:C5:1F,3835612,483756686,863,105386,3834749,483651300,0,3606,302708,2975,227806,631,74902,912,8,1241,19,0,37,144444.0,39000.0,-71.0,-72.0,-68.0,-61.0,-73.0,-74.0,-70.0,-63.0,-89.0,-90.0,-86.0,-87.0,18.0,18.0,18.0,26.0,1
3208,BA:8C:B9:54:50:24,3839577,489833249,4828,6181949,3834749,483651300,0,8948,1696267,8926,1692772,22,3495,2348,15,5260,39,0,56,229410.0,130000.0,-40.0,-36.0,-45.0,-51.0,-41.0,-35.0,-44.0,-49.0,-89.0,-90.0,-86.0,-87.0,49.0,54.0,41.0,36.0,1
3209,62:47:05:9D:EB:15,3834790,483660583,37,8879,3834753,483651704,0,57,9029,47,7001,10,2028,37,0,48,0,0,3,216660.0,130000.0,-55.0,-51.0,-49.0,-62.0,-57.0,-51.0,-49.0,-61.0,-89.0,-90.0,-86.0,-87.0,34.0,39.0,37.0,25.0,1
3210,3C:55:76:E8:8F:1F,3846384,509988699,11631,26336995,3834753,483651704,7,7715,2177211,7506,2138392,209,38819,4018,15,11646,1182,7,97,270830.0,162500.0,-45.0,-54.0,-51.0,-37.0,-47.0,-52.0,-45.0,-42.0,-89.0,-90.0,-86.0,-87.0,44.0,36.0,35.0,50.0,1
3211,92:69:1D:31:68:E9,3838631,487259782,3878,3608078,3834753,483651704,0,4688,1086292,4548,1054627,140,31665,2086,10,4075,84,0,42,229410.0,130000.0,-51.0,-47.0,-42.0,-48.0,-51.0,-47.0,-42.0,-48.0,-89.0,-90.0,-86.0,-87.0,38.0,43.0,44.0,39.0,1
3212,CC:2F:71:3F:1F:24,4580119,1275093027,745364,791441121,3834755,483651906,37,596481,609643337,595767,609557417,714,85920,575821,15,745620,84273,34,495,144444.0,43333.0,-71.0,-67.0,-71.0,-74.0,-70.0,-67.0,-70.0,-73.0,-89.0,-90.0,-86.0,-87.0,18.0,23.0,15.0,13.0,1
3213,CC:2F:71:3E:C5:1F,3835618,483757292,863,105386,3834755,483651906,0,3606,302708,2975,227806,631,74902,912,8,1241,19,0,37,144444.0,39000.0,-71.0,-72.0,-68.0,-61.0,-73.0,-74.0,-70.0,-63.0,-89.0,-90.0,-86.0,-87.0,18.0,18.0,18.0,26.0,1
3214,BA:8C:B9:54:50:24,3839583,489833855,4828,6181949,3834755,483651906,0,8948,1696267,8926,1692772,22,3495,2348,15,5260,39,0,56,229410.0,130000.0,-40.0,-36.0,-45.0,-51.0,-41.0,-35.0,-44.0,-49.0,-89.0,-90.0,-86.0,-87.0,49.0,54.0,41.0,36.0,1
3215,62:47:05:9D:EB:15,3834796,483661109,37,8879,3834759,483652230,0,57,9029,47,7001,10,2028,37,0,48,0,0,3,216660.0,130000.0,-55.0,-51.0,-49.0,-62.0,-57.0,-51.0,-49.0,-61.0,-89.0,-90.0,-86.0,-87.0,34.0,39.0,37.0,25.0,1
3216,3C:55:76:E8:8F:1F,3846396,509991478,11637,26339248,3834759,483652230,7,7746,2189036,7536,2150099,210,38937,4030,15,11653,1183,7,97,270830.0,162500.0,-47.0,-55.0,-53.0,-40.0,-47.0,-54.0,-51.0,-40.0,-89.0,-90.0,-86.0,-87.0,42.0,35.0,33.0,47.0,1
3217,92:69:1D:31:68:E9,3838665,487274985,3906,3622755,3834759,483652230,0,4718,1097605,4578,1065940,140,31665,2110,10,4103,84,0,42,229410.0,137640.0,-52.0,-50.0,-46.0,-51.0,-51.0,-49.0,-45.0,-50.0,-89.0,-90.0,-86.0,-87.0,37.0,40.0,40.0,36.0,1
3218,CC:2F:71:3F:1F:24,4580339,1275359976,745580,791707746,3834759,483652230,37,596676,609892103,595962,609806183,714,85920,576011,15,745836,84287,34,495,144444.0,43333.0,-71.0,-67.0,-71.0,-74.0,-70.0,-67.0,-70.0,-73.0,-89.0,-90.0,-86.0,-87.0,18.0,23.0,15.0,13.0,1
3219,CC:2F:71:3E:C5:1F,3835622,483757616,863,105386,3834759,483652230,0,3606,302708,2975,227806,631,74902,912,8,1241,19,0,37,144444.0,39000.0,-71.0,-72.0,-68.0,-61.0,-73.0,-74.0,-70.0,-63.0,-89.0,-90.0,-86.0,-87.0,18.0,18.0,18.0,26.0,1
3220,BA:8C:B9:54:50:24,3839587,489834179,4828,6181949,3834759,483652230,0,8948,1696267,8926,1692772,22,3495,2348,15,5260,39,0,56,229410.0,130000.0,-40.0,-36.0,-45.0,-51.0,-41.0,-35.0,-44.0,-49.0,-89.0,-90.0,-86.0,-87.0,49.0,54.0,41.0,36.0,1
3221,62:47:05:9D:EB:15,3834805,483661966,37,8879,3834768,483653087,0,57,9029,47,7001,10,2028,37,0,48,0,0,3,216660.0,130000.0,-55.0,-51.0,-49.0,-62.0,-57.0,-51.0,-49.0,-61.0,-89.0,-90.0,-86.0,-87.0,34.0,39.0,37.0,25.0,1
3222,3C:55:76:E8:8F:1F,3846408,509992659,11640,26339572,3834768,483653087,7,7768,2190907,7556,2151669,212,39238,4036,15,11656,1184,7,97,270830.0,1000.0,-49.0,-54.0,-43.0,-44.0,-48.0,-53.0,-43.0,-43.0,-89.0,-90.0,-86.0,-87.0,40.0,36.0,43.0,43.0,1
3223,92:69:1D:31:68:E9,3838674,487275842,3906,3622755,3834768,483653087,0,4719,1097673,4579,1066008,140,31665,2110,10,4103,84,0,42,229410.0,137640.0,-51.0,-47.0,-42.0,-48.0,-51.0,-49.0,-45.0,-50.0,-89.0,-90.0,-86.0,-87.0,38.0,43.0,44.0,39.0,1
3224,CC:2F:71:3F:1F:24,4580557,1275623955,745789,791970868,3834768,483653087,37,596869,610147139,596154,610061101,715,86038,576199,15,746045,84296,34,495,144444.0,43333.0,-71.0,-67.0,-71.0,-73.0,-70.0,-67.0,-70.0,-73.0,-89.0,-90.0,-86.0,-87.0,18.0,23.0,15.0,14.0,1
3225,CC:2F:71:3E:C5:1F,3835631,483758473,863,105386,3834768,483653087,0,3606,302708,2975,227806,631,74902,912,8,1241,19,0,37,144444.0,39000.0,-71.0,-72.0,-68.0,-61.0,-73.0,-74.0,-70.0,-63.0,-89.0,-90.0,-86.0,-87.0,18.0,18.0,18.0,26.0,1
3226,BA:8C:B9:54:50:24,3839598,489835238,4828,6181949,3834770,483653289,0,8948,1696267,8926,1692772,22,3495,2348,15,5260,39,0,56,229410.0,130000.0,-40.0,-36.0,-45.0,-51.0,-41.0,-35.0,-44.0,-49.0,-89.0,-90.0,-86.0,-87.0,49.0,54.0,41.0,36.0,1
3227,62:47:05:9D:EB:15,3834807,483662168,37,8879,3834770,483653289,0,59,9165,49,7137,10,2028,37,0,49,0,0,3,216660.0,130000.0,-55.0,-51.0,-49.0,-62.0,-56.0,-51.0,-49.0,-61.0,-89.0,-90.0,-86.0,-87.0,34.0,39.0,37.0,25.0,1
3228,3C:55:76:E8:8F:1F,3847089,511774448,12319,28121159,3834770,483653289,7,7959,2218216,7747,2178978,212,39238,4137,15,12335,1244,7,97,286760.0,172050.0,-46.0,-51.0,-40.0,-41.0,-48.0,-53.0,-43.0,-42.0,-89.0,-90.0,-86.0,-87.0,43.0,39.0,46.0,46.0,1
3229,92:69:1D:31:68:E9,3838678,487276493,3906,3622755,3834772,483653738,0,4719,1097673,4579,1066008,140,31665,2110,10,4103,84,0,42,229410.0,137640.0,-51.0,-47.0,-42.0,-48.0,-51.0,-49.0,-45.0,-50.0,-89.0,-90.0,-86.0,-87.0,38.0,43.0,44.0,39.0,1
3230,CC:2F:71:3F:1F:24,4580775,1275891156,746002,792237358,3834773,483653798,37,597061,610405003,596346,610318965,715,86038,576384,15,746258,84304,34,495,144444.0,43333.0,-71.0,-67.0,-71.0,-74.0,-70.0,-67.0,-70.0,-73.0,-89.0,-90.0,-86.0,-87.0,18.0,23.0,15.0,13.0,1
3231,CC:2F:71:3E:C5:1F,3835636,483759184,863,105386,3834773,483653798,0,3608,302848,2977,227946,631,74902,912,8,1242,19,0,37,144444.0,39000.0,-71.0,-72.0,-68.0,-60.0,-73.0,-74.0,-70.0,-63.0,-89.0,-90.0,-86.0,-87.0,18.0,18.0,18.0,27.0,1
3232,BA:8C:B9:54:50:24,3839603,489835949,4828,6181949,3834775,483654000,0,8948,1696267,8926,1692772,22,3495,2348,15,5260,39,0,56,229410.0,130000.0,-40.0,-36.0,-45.0,-51.0,-41.0,-35.0,-44.0,-49.0,-89.0,-90.0,-86.0,-87.0,49.0,54.0,41.0,36.0,1
3233,62:47:05:9D:EB:15,3834817,483663345,37,8879,3834780,483654466,0,59,9165,49,7137,10,2028,37,0,49,0,0,3,216660.0,130000.0,-55.0,-51.0,-49.0,-62.0,-56.0,-51.0,-49.0,-61.0,-89.0,-90.0,-86.0,-87.0,34.0,39.0,37.0,25.0,1
3234,3C:55:76:E8:8F:1F,3847102,511775976,12320,28121308,3834782,483654668,7,7975,2219840,7761,2180041,214,39799,4141,15,12337,1244,7,99,286760.0,1000.0,-47.0,-56.0,-53.0,-40.0,-47.0,-55.0,-49.0,-40.0,-89.0,-90.0,-86.0,-87.0,42.0,34.0,33.0,47.0,1
3235,92:69:1D:31:68:E9,3838688,487277423,3906,3622755,3834782,483654668,0,4719,1097673,4579,1066008,140,31665,2110,10,4103,84,0,42,229410.0,137640.0,-51.0,-47.0,-42.0,-48.0,-51.0,-49.0,-45.0,-50.0,-89.0,-90.0,-86.0,-87.0,38.0,43.0,44.0,39.0,1
3236,CC:2F:71:3F:1F:24,4580993,1276153724,746211,792499056,3834782,483654668,37,597255,610661845,596540,610575807,715,86038,576569,15,746466,84308,34,495,144444.0,43333.0,-71.0,-67.0,-70.0,-74.0,-70.0,-67.0,-70.0,-73.0,-89.0,-90.0,-86.0,-87.0,18.0,23.0,16.0,13.0,1
3237,CC:2F:71:3E:C5:1F,3835647,483760503,863,105386,3834784,483655117,0,3610,303036,2978,228016,632,75020,913,8,1242,19,0,37,144444.0,39000.0,-71.0,-72.0,-69.0,-60.0,-73.0,-74.0,-70.0,-63.0,-89.0,-90.0,-86.0,-87.0,18.0,18.0,17.0,27.0,1
3238,BA:8C:B9:54:50:24,3839612,489837066,4828,6181949,3834784,483655117,0,8948,1696267,8926,1692772,22,3495,2348,15,5260,39,0,56,229410.0,130000.0,-40.0,-36.0,-45.0,-51.0,-41.0,-35.0,-44.0,-49.0,-89.0,-90.0,-86.0,-87.0,49.0,54.0,41.0,36.0,1
3239,62:47:05:9D:EB:15,3834821,483663996,37,8879,3834784,483655117,0,60,9233,50,7205,10,2028,37,0,49,0,0,3,216660.0,130000.0,-55.0,-51.0,-49.0,-61.0,-56.0,-51.0,-49.0,-61.0,-89.0,-90.0,-86.0,-87.0,34.0,39.0,37.0,26.0,1
3240,3C:55:76:E8:8F:1F,3847104,511776425,12320,28121308,3834784,483655117,7,7995,2228332,7779,2187972,216,40360,4147,15,12337,1244,7,99,286760.0,1000.0,-47.0,-53.0,-44.0,-41.0,-47.0,-54.0,-51.0,-40.0,-89.0,-90.0,-86.0,-87.0,42.0,37.0,42.0,46.0,1
3241,92:69:1D:31:68:E9,3838690,487277872,3906,3622755,3834784,483655117,0,4719,1097673,4579,1066008,140,31665,2110,10,4103,84,0,42,229410.0,137640.0,-51.0,-47.0,-42.0,-48.0,-51.0,-49.0,-45.0,-50.0,-89.0,-90.0,-86.0,-87.0,38.0,43.0,44.0,39.0,1
3242,CC:2F:71:3F:1F:24,4581214,1276422386,746428,792767067,3834786,483655319,37,597457,610925590,596742,610839552,715,86038,576762,15,746684,84311,34,495,144444.0,43333.0,-70.0,-67.0,-70.0,-73.0,-70.0,-67.0,-70.0,-73.0,-89.0,-90.0,-86.0,-87.0,19.0,23.0,16.0,14.0,1
3243,CC:2F:71:3E:C5:1F,3835651,483760907,863,105386,3834788,483655521,0,3610,303036,2978,228016,632,75020,913,8,1242,19,0,37,144444.0,39000.0,-71.0,-72.0,-69.0,-60.0,-73.0,-74.0,-70.0,-63.0,-89.0,-90.0,-86.0,-87.0,18.0,18.0,17.0,27.0,1
3244,BA:8C:B9:54:50:24,3839616,489837470,4828,6181949,3834788,483655521,0,8948,1696267,8926,1692772,22,3495,2348,15,5260,39,0,56,229410.0,130000.0,-40.0,-36.0,-45.0,-51.0,-41.0,-35.0,-44.0,-49.0,-89.0,-90.0,-86.0,-87.0,49.0,54.0,41.0,36.0,1
3245,62:47:05:9D:EB:15,3834832,483665313,37,8879,3834795,483656434,0,60,9233,50,7205,10,2028,37,0,49,0,0,3,216660.0,130000.0,-55.0,-51.0,-49.0,-61.0,-56.0,-51.0,-49.0,-61.0,-89.0,-90.0,-86.0,-87.0,34.0,39.0,37.0,26.0,1
3246,3C:55:76:E8:8F:1F,3847169,511873321,12374,28216887,3834795,483656434,7,8045,2243445,7827,2202524,218,40921,4176,15,12391,1245,7,99,258080.0,154850.0,-48.0,-53.0,-43.0,-44.0,-48.0,-53.0,-43.0,-44.0,-89.0,-90.0,-86.0,-87.0,41.0,37.0,43.0,43.0,1
3247,92:69:1D:31:68:E9,3838701,487279189,3906,3622755,3834795,483656434,0,4719,1097673,4579,1066008,140,31665,2110,10,4103,84,0,42,229410.0,137640.0,-51.0,-47.0,-42.0,-48.0,-51.0,-49.0,-45.0,-50.0,-89.0,-90.0,-86.0,-87.0,38.0,43.0,44.0,39.0,1
3248,CC:2F:71:3F:1F:24,4581437,1276695817,746642,793039383,3834795,483656434,37,597657,611191508,596942,611105470,715,86038,576953,15,746898,84326,34,495,144444.0,43333.0,-71.0,-67.0,-71.0,-73.0,-70.0,-67.0,-70.0,-73.0,-89.0,-90.0,-86.0,-87.0,18.0,23.0,15.0,14.0,1
3249,CC:2F:71:3E:C5:1F,3835658,483761820,863,105386,3834795,483656434,0,3610,303036,2978,228016,632,75020,913,8,1242,19,0,37,144444.0,39000.0,-71.0,-72.0,-69.0,-60.0,-73.0,-74.0,-70.0,-63.0,-89.0,-90.0,-86.0,-87.0,18.0,18.0,17.0,27.0,1
3250,BA:8C:B9:54:50:24,3839623,489838383,4828,6181949,3834795,483656434,0,8948,1696267,8926,1692772,22,3495,2348,15,5260,39,0,56,229410.0,130000.0,-40.0,-36.0,-45.0,-51.0,-41.0,-35.0,-44.0,-49.0,-89.0,-90.0,-86.0,-87.0,49.0,54.0,41.0,36.0,1
3251,62:47:05:9D:EB:15,3834838,483666166,37,8879,3834801,483657287,0,60,9233,50,7205,10,2028,37,0,49,0,0,3,216660.0,130000.0,-55.0,-51.0,-49.0,-61.0,-56.0,-51.0,-49.0,-61.0,-89.0,-90.0,-86.0,-87.0,34.0,39.0,37.0,26.0,1
3252,3C:55:76:E8:8F:1F,3847189,511878180,12388,28220893,3834801,483657287,7,8083,2253326,7863,2211844,220,41482,4194,15,12405,1249,7,100,258080.0,1000.0,-49.0,-53.0,-44.0,-44.0,-50.0,-55.0,-46.0,-44.0,-89.0,-90.0,-86.0,-87.0,40.0,37.0,42.0,43.0,1
3253,92:69:1D:31:68:E9,3838709,487280274,3908,3622987,3834801,483657287,0,4724,1098093,4584,1066428,140,31665,2112,10,4105,84,0,42,229410.0,137640.0,-52.0,-47.0,-44.0,-47.0,-51.0,-48.0,-44.0,-48.0,-89.0,-90.0,-86.0,-87.0,37.0,43.0,42.0,40.0,1
3254,CC:2F:71:3F:1F:24,4581671,1276987894,746870,793330607,3834801,483657287,37,597868,611475798,597153,611389760,715,86038,577157,15,747126,84333,34,495,144444.0,43333.0,-70.0,-67.0,-70.0,-73.0,-69.0,-66.0,-69.0,-72.0,-89.0,-90.0,-86.0,-87.0,19.0,23.0,16.0,14.0,1
3255,CC:2F:71:3E:C5:1F,3835664,483762673,863,105386,3834801,483657287,0,3610,303036,2978,228016,632,75020,913,8,1242,19,0,37,144444.0,39000.0,-71.0,-72.0,-69.0,-60.0,-73.0,-74.0,-70.0,-63.0,-89.0,-90.0,-86.0,-87.0,18.0,18.0,17.0,27.0,1
3256,BA:8C:B9:54:50:24,3839629,489839236,4828,6181949,3834801,483657287,0,8948,1696267,8926,1692772,22,3495,2348,15,5260,39,0,56,229410.0,130000.0,-40.0,-36.0,-45.0,-51.0,-41.0,-35.0,-44.0,-49.0,-89.0,-90.0,-86.0,-87.0,49.0,54.0,41.0,36.0,1
3257,62:47:05:9D:EB:15,3834844,483666903,37,8879,3834807,483658024,0,60,9233,50,7205,10,2028,37,0,49,0,0,3,216660.0,130000.0,-55.0,-51.0,-49.0,-61.0,-56.0,-51.0,-49.0,-61.0,-89.0,-90.0,-86.0,-87.0,34.0,39.0,37.0,26.0,1
3258,3C:55:76:E8:8F:1F,3847198,511879405,12391,28221381,3834807,483658024,7,8097,2255537,7877,2214055,220,41482,4197,15,12408,1249,7,100,258080.0,154850.0,-48.0,-52.0,-42.0,-44.0,-47.0,-52.0,-42.0,-42.0,-89.0,-90.0,-86.0,-87.0,41.0,38.0,44.0,43.0,1
3259,92:69:1D:31:68:E9,3838715,487281011,3908,3622987,3834807,483658024,0,4726,1098229,4586,1066564,140,31665,2112,10,4105,84,0,42,229410.0,137640.0,-51.0,-47.0,-42.0,-48.0,-51.0,-47.0,-43.0,-48.0,-89.0,-90.0,-86.0,-87.0,38.0,43.0,44.0,39.0,1
3260,CC:2F:71:3F:1F:24,4581893,1277255240,747086,793597216,3834807,483658024,37,598063,611725831,597348,611639793,715,86038,577349,15,747342,84351,34,495,144444.0,43333.0,-70.0,-66.0,-70.0,-73.0,-69.0,-66.0,-69.0,-73.0,-89.0,-90.0,-86.0,-87.0,19.0,24.0,16.0,14.0,1
3261,CC:2F:71:3E:C5:1F,3835670,483763410,863,105386,3834807,483658024,0,3610,303036,2978,228016,632,75020,913,8,1242,19,0,37,144444.0,39000.0,-71.0,-72.0,-69.0,-60.0,-73.0,-74.0,-70.0,-63.0,-89.0,-90.0,-86.0,-87.0,18.0,18.0,17.0,27.0,1
3262,BA:8C:B9:54:50:24,3839635,489839973,4828,6181949,3834807,483658024,0,8949,1696335,8927,1692840,22,3495,2348,15,5260,39,0,56,229410.0,130000.0,-40.0,-36.0,-45.0,-51.0,-41.0,-35.0,-44.0,-49.0,-89.0,-90.0,-86.0,-87.0,49.0,54.0,41.0,36.0,1
3263,62:47:05:9D:EB:15,3834848,483667307,37,8879,3834811,483658428,0,60,9233,50,7205,10,2028,37,0,49,0,0,3,216660.0,130000.0,-55.0,-51.0,-49.0,-61.0,-56.0,-51.0,-49.0,-61.0,-89.0,-90.0,-86.0,-87.0,34.0,39.0,37.0,26.0,1
3264,3C:55:76:E8:8F:1F,3847901,513720899,13087,30062005,3834814,483658894,7,8281,2283854,8060,2242052,221,41802,4282,15,13104,1303,7,101,286760.0,172050.0,-50.0,-55.0,-47.0,-44.0,-50.0,-55.0,-47.0,-44.0,-89.0,-90.0,-86.0,-87.0,39.0,35.0,39.0,43.0,1
3265,92:69:1D:31:68:E9,3838724,487282083,3908,3622987,3834816,483659096,0,4727,1098297,4587,1066632,140,31665,2112,10,4105,84,0,42,229410.0,137640.0,-51.0,-47.0,-42.0,-48.0,-51.0,-47.0,-43.0,-48.0,-89.0,-90.0,-86.0,-87.0,38.0,43.0,44.0,39.0,1
3266,CC:2F:71:3F:1F:24,4582125,1277541222,747309,793882126,3834816,483659096,37,598269,612002309,597554,611916271,715,86038,577550,15,747565,84372,34,495,144444.0,43333.0,-70.0,-66.0,-70.0,-72.0,-70.0,-66.0,-70.0,-72.0,-89.0,-90.0,-86.0,-87.0,19.0,24.0,16.0,15.0,1
3267,CC:2F:71:3E:C5:1F,3835680,483764542,863,105386,3834817,483659156,0,3610,303036,2978,228016,632,75020,913,8,1242,19,0,37,144444.0,39000.0,-71.0,-72.0,-69.0,-60.0,-73.0,-74.0,-70.0,-63.0,-89.0,-90.0,-86.0,-87.0,18.0,18.0,17.0,27.0,1
3268,BA:8C:B9:54:50:24,3839645,489841105,4828,6181949,3834817,483659156,0,8949,1696335,8927,1692840,22,3495,2348,15,5260,39,0,56,229410.0,130000.0,-40.0,-36.0,-45.0,-51.0,-41.0,-35.0,-44.0,-49.0,-89.0,-90.0,-86.0,-87.0,49.0,54.0,41.0,36.0,1
3269,62:47:05:9D:EB:15,3834855,483668095,37,8879,3834818,483659216,0,60,9233,50,7205,10,2028,37,0,49,0,0,3,216660.0,130000.0,-55.0,-51.0,-49.0,-61.0,-56.0,-51.0,-49.0,-61.0,-89.0,-90.0,-86.0,-87.0,34.0,39.0,37.0,26.0,1
3270,3C:55:76:E8:8F:1F,3848042,513984933,13224,30325717,3834818,483659216,7,8373,2312291,8151,2270383,222,41908,4342,15,13241,1313,7,101,286760.0,172050.0,-51.0,-57.0,-47.0,-44.0,-49.0,-54.0,-43.0,-44.0,-89.0,-90.0,-86.0,-87.0,38.0,33.0,39.0,43.0,1
3271,92:69:1D:31:68:E9,3838726,487282203,3908,3622987,3834818,483659216,0,4727,1098297,4587,1066632,140,31665,2112,10,4105,84,0,42,229410.0,137640.0,-51.0,-47.0,-42.0,-48.0,-51.0,-47.0,-43.0,-48.0,-89.0,-90.0,-86.0,-87.0,38.0,43.0,44.0,39.0,1
3272,CC:2F:71:3F:1F:24,4582341,1277807878,747519,794148258,3834822,483659620,37,598461,612260089,597746,612174051,715,86038,577736,15,747775,84393,34,495,144444.0,43333.0,-70.0,-66.0,-70.0,-72.0,-69.0,-66.0,-69.0,-72.0,-89.0,-90.0,-86.0,-87.0,19.0,24.0,16.0,15.0,1
3273,CC:2F:71:3E:C5:1F,3835685,483765006,863,105386,3834822,483659620,0,3610,303036,2978,228016,632,75020,913,8,1242,19,0,37,144444.0,39000.0,-71.0,-72.0,-69.0,-60.0,-73.0,-74.0,-70.0,-63.0,-89.0,-90.0,-86.0,-87.0,18.0,18.0,17.0,27.0,1
3274,BA:8C:B9:54:50:24,3839651,489841629,4828,6181949,3834823,483659680,0,8949,1696335,8927,1692840,22,3495,2348,15,5260,39,0,56,229410.0,130000.0,-40.0,-36.0,-45.0,-51.0,-41.0,-35.0,-44.0,-49.0,-89.0,-90.0,-86.0,-87.0,49.0,54.0,41.0,36.0,1
3275,62:47:05:9D:EB:15,3834864,483668963,37,8879,3834827,483660084,0,60,9233,50,7205,10,2028,37,0,49,0,0,3,216660.0,130000.0,-55.0,-51.0,-49.0,-61.0,-56.0,-51.0,-49.0,-61.0,-89.0,-90.0,-86.0,-87.0,34.0,39.0,37.0,26.0,1
3276,3C:55:76:E8:8F:1F,3848060,513987733,13233,30327649,3834827,483660084,7,8396,2321570,8173,2279556,223,42014,4352,15,13250,1316,7,101,286760.0,1000.0,-46.0,-51.0,-40.0,-40.0,-47.0,-52.0,-42.0,-42.0,-89.0,-90.0,-86.0,-87.0,43.0,39.0,46.0,47.0,1
3277,92:69:1D:31:68:E9,3838735,487283071,3908,3622987,3834827,483660084,0,4727,1098297,4587,1066632,140,31665,2112,10,4105,84,0,42,229410.0,137640.0,-51.0,-47.0,-42.0,-48.0,-51.0,-47.0,-43.0,-48.0,-89.0,-90.0,-86.0,-87.0,38.0,43.0,44.0,39.0,1
3278,CC:2F:71:3F:1F:24,4582563,1278081048,747736,794420964,3834827,483660084,37,598655,612519581,597940,612433543,715,86038,577927,15,747992,84407,34,496,144444.0,43333.0,-70.0,-67.0,-70.0,-74.0,-70.0,-67.0,-70.0,-74.0,-89.0,-90.0,-86.0,-87.0,19.0,23.0,16.0,13.0,1
3279,CC:2F:71:3E:C5:1F,3835690,483765470,863,105386,3834827,483660084,0,3610,303036,2978,228016,632,75020,913,8,1242,19,0,37,144444.0,39000.0,-71.0,-72.0,-69.0,-60.0,-73.0,-74.0,-70.0,-63.0,-89.0,-90.0,-86.0,-87.0,18.0,18.0,17.0,27.0,1
3280,BA:8C:B9:54:50:24,3839655,489842033,4828,6181949,3834827,483660084,0,8949,1696335,8927,1692840,22,3495,2348,15,5260,39,0,56,229410.0,130000.0,-40.0,-36.0,-45.0,-51.0,-41.0,-35.0,-44.0,-49.0,-89.0,-90.0,-86.0,-87.0,49.0,54.0,41.0,36.0,1
3281,62:47:05:9D:EB:15,3834869,483669427,37,8879,3834832,483660548,0,60,9233,50,7205,10,2028,37,0,49,0,0,3,216660.0,130000.0,-55.0,-51.0,-49.0,-61.0,-56.0,-51.0,-49.0,-61.0,-89.0,-90.0,-86.0,-87.0,34.0,39.0,37.0,26.0,1
3282,3C:55:76:E8:8F:1F,3848073,513993328,13241,30332780,3834832,483660548,7,8430,2327092,8206,2284972,224,42120,4364,15,13258,1316,7,101,286760.0,172050.0,-49.0,-53.0,-43.0,-44.0,-48.0,-52.0,-43.0,-44.0,-89.0,-90.0,-86.0,-87.0,40.0,37.0,43.0,43.0,1
3283,92:69:1D:31:68:E9,3838741,487283595,3908,3622987,3834833,483660608,0,4727,1098297,4587,1066632,140,31665,2112,10,4105,84,0,42,229410.0,137640.0,-51.0,-47.0,-42.0,-48.0,-51.0,-47.0,-43.0,-48.0,-89.0,-90.0,-86.0,-87.0,38.0,43.0,44.0,39.0,1
3284,CC:2F:71:3F:1F:24,4582787,1278348441,747954,794687833,3834833,483660608,37,598853,612770118,598138,612684080,715,86038,578120,15,748210,84422,34,496,144444.0,43333.0,-70.0,-66.0,-70.0,-73.0,-70.0,-66.0,-70.0,-73.0,-89.0,-90.0,-86.0,-87.0,19.0,24.0,16.0,14.0,1
3285,CC:2F:71:3E:C5:1F,3835696,483765994,863,105386,3834833,483660608,0,3610,303036,2978,228016,632,75020,913,8,1242,19,0,37,144444.0,39000.0,-71.0,-72.0,-69.0,-60.0,-73.0,-74.0,-70.0,-63.0,-89.0,-90.0,-86.0,-87.0,18.0,18.0,17.0,27.0,1
3286,BA:8C:B9:54:50:24,3839661,489842557,4828,6181949,3834833,483660608,0,8949,1696335,8927,1692840,22,3495,2348,15,5260,39,0,56,229410.0,130000.0,-40.0,-36.0,-45.0,-51.0,-41.0,-35.0,-44.0,-49.0,-89.0,-90.0,-86.0,-87.0,49.0,54.0,41.0,36.0,1
3287,62:47:05:9D:EB:15,3834874,483669891,37,8879,3834837,483661012,0,60,9233,50,7205,10,2028,37,0,49,0,0,3,216660.0,130000.0,-55.0,-51.0,-49.0,-61.0,-56.0,-51.0,-49.0,-61.0,-89.0,-90.0,-86.0,-87.0,34.0,39.0,37.0,26.0,1
3288,3C:55:76:E8:8F:1F,3849022,516328868,14185,32667856,3834837,483661012,7,8738,2400880,8514,2358760,224,42120,4533,15,14202,1456,7,101,286760.0,172050.0,-46.0,-55.0,-52.0,-39.0,-49.0,-55.0,-47.0,-43.0,-89.0,-90.0,-86.0,-87.0,43.0,35.0,34.0,48.0,1
3289,92:69:1D:31:68:E9,3838745,487283999,3908,3622987,3834837,483661012,0,4727,1098297,4587,1066632,140,31665,2112,10,4105,84,0,42,229410.0,137640.0,-51.0,-47.0,-42.0,-48.0,-51.0,-47.0,-43.0,-48.0,-89.0,-90.0,-86.0,-87.0,38.0,43.0,44.0,39.0,1
3290,CC:2F:71:3F:1F:24,4583013,1278627913,748176,794966901,3834837,483661012,37,599057,613042182,598342,612956144,715,86038,578316,15,748432,84446,34,496,144444.0,43333.0,-70.0,-66.0,-70.0,-73.0,-70.0,-66.0,-70.0,-72.0,-89.0,-90.0,-86.0,-87.0,19.0,24.0,16.0,14.0,1
3291,CC:2F:71:3E:C5:1F,3835700,483766398,863,105386,3834837,483661012,0,3610,303036,2978,228016,632,75020,913,8,1242,19,0,37,144444.0,39000.0,-71.0,-72.0,-69.0,-60.0,-73.0,-74.0,-70.0,-63.0,-89.0,-90.0,-86.0,-87.0,18.0,18.0,17.0,27.0,1
3292,BA:8C:B9:54:50:24,3839665,489842961,4828,6181949,3834837,483661012,0,8949,1696335,8927,1692840,22,3495,2348,15,5260,39,0,56,229410.0,130000.0,-40.0,-36.0,-45.0,-51.0,-41.0,-35.0,-44.0,-49.0,-89.0,-90.0,-86.0,-87.0,49.0,54.0,41.0,36.0,1
3293,62:47:05:9D:EB:15,3834878,483670295,37,8879,3834841,483661416,0,60,9233,50,7205,10,2028,37,0,49,0,0,3,216660.0,130000.0,-55.0,-51.0,-49.0,-61.0,-56.0,-51.0,-49.0,-61.0,-89.0,-90.0,-86.0,-87.0,34.0,39.0,37.0,26.0,1
3294,3C:55:76:E8:8F:1F,3849089,516446791,14248,32785375,3834841,483661416,7,8780,2427773,8556,2385653,224,42120,4561,15,14251,1457,7,109,286760.0,172050.0,-50.0,-56.0,-47.0,-44.0,-50.0,-56.0,-47.0,-44.0,-89.0,-90.0,-86.0,-87.0,39.0,34.0,39.0,43.0,1
3295,92:69:1D:31:68:E9,3838749,487284403,3908,3622987,3834841,483661416,0,4727,1098297,4587,1066632,140,31665,2112,10,4105,84,0,42,229410.0,137640.0,-51.0,-47.0,-42.0,-48.0,-51.0,-47.0,-43.0,-48.0,-89.0,-90.0,-86.0,-87.0,38.0,43.0,44.0,39.0,1
3296,CC:2F:71:3F:1F:24,4583232,1278895041,748389,795233423,3834843,483661618,37,599252,613298996,598537,613212958,715,86038,578504,15,748645,84473,34,496,144444.0,43333.0,-70.0,-66.0,-70.0,-72.0,-70.0,-66.0,-70.0,-73.0,-89.0,-90.0,-86.0,-87.0,19.0,24.0,16.0,15.0,1
3297,CC:2F:71:3E:C5:1F,3835706,483767004,863,105386,3834843,483661618,0,3610,303036,2978,228016,632,75020,913,8,1242,19,0,37,144444.0,39000.0,-71.0,-72.0,-69.0,-60.0,-73.0,-74.0,-70.0,-63.0,-89.0,-90.0,-86.0,-87.0,18.0,18.0,17.0,27.0,1
3298,BA:8C:B9:54:50:24,3839674,489843829,4828,6181949,3834846,483661880,0,8949,1696335,8927,1692840,22,3495,2348,15,5260,39,0,56,229410.0,130000.0,-40.0,-36.0,-45.0,-51.0,-41.0,-35.0,-44.0,-49.0,-89.0,-90.0,-86.0,-87.0,49.0,54.0,41.0,36.0,1
3299,62:47:05:9D:EB:15,3834883,483670759,37,8879,3834846,483661880,0,60,9233,50,7205,10,2028,37,0,49,0,0,3,216660.0,130000.0,-55.0,-51.0,-49.0,-61.0,-56.0,-51.0,-49.0,-61.0,-89.0,-90.0,-86.0,-87.0,34.0,39.0,37.0,26.0,1
3300,3C:55:76:E8:8F:1F,3849683,517954044,14837,34292164,3834846,483661880,7,8986,2463075,8762,2420955,224,42120,4663,15,14854,1479,7,109,286760.0,172050.0,-48.0,-52.0,-42.0,-43.0,-49.0,-54.0,-44.0,-43.0,-89.0,-90.0,-86.0,-87.0,41.0,38.0,44.0,44.0,1
3301,92:69:1D:31:68:E9,3838754,487284867,3908,3622987,3834846,483661880,0,4727,1098297,4587,1066632,140,31665,2112,10,4105,84,0,42,229410.0,137640.0,-51.0,-47.0,-42.0,-48.0,-51.0,-47.0,-43.0,-48.0,-89.0,-90.0,-86.0,-87.0,38.0,43.0,44.0,39.0,1
3302,CC:2F:71:3F:1F:24,4583455,1279165344,748609,795503464,3834846,483661880,37,599455,613557269,598740,613471231,715,86038,578699,15,748865,84485,34,496,144444.0,43333.0,-70.0,-67.0,-70.0,-74.0,-70.0,-66.0,-70.0,-73.0,-89.0,-90.0,-86.0,-87.0,19.0,23.0,16.0,13.0,1
3303,CC:2F:71:3E:C5:1F,3835709,483767266,863,105386,3834846,483661880,0,3610,303036,2978,228016,632,75020,913,8,1242,19,0,37,144444.0,39000.0,-71.0,-72.0,-69.0,-60.0,-73.0,-74.0,-70.0,-63.0,-89.0,-90.0,-86.0,-87.0,18.0,18.0,17.0,27.0,1
3304,BA:8C:B9:54:50:24,3839676,489844031,4828,6181949,3834848,483662082,0,8949,1696335,8927,1692840,22,3495,2348,15,5260,39,0,56,229410.0,130000.0,-40.0,-36.0,-45.0,-51.0,-41.0,-35.0,-44.0,-49.0,-89.0,-90.0,-86.0,-87.0,49.0,54.0,41.0,36.0,1
3305,62:47:05:9D:EB:15,3834889,483671365,37,8879,3834852,483662486,0,60,9233,50,7205,10,2028,37,0,49,0,0,3,216660.0,130000.0,-55.0,-51.0,-49.0,-61.0,-56.0,-51.0,-49.0,-61.0,-89.0,-90.0,-86.0,-87.0,34.0,39.0,37.0,26.0,1
3306,3C:55:76:E8:8F:1F,3849690,517954774,14838,34292288,3834852,483662486,7,8999,2463961,8775,2421841,224,42120,4663,15,14855,1479,7,109,286760.0,172050.0,-49.0,-53.0,-43.0,-45.0,-48.0,-52.0,-42.0,-44.0,-89.0,-90.0,-86.0,-87.0,40.0,37.0,43.0,42.0,1
3307,92:69:1D:31:68:E9,3838760,487285473,3908,3622987,3834852,483662486,0,4727,1098297,4587,1066632,140,31665,2112,10,4105,84,0,42,229410.0,137640.0,-51.0,-47.0,-42.0,-48.0,-51.0,-47.0,-43.0,-48.0,-89.0,-90.0,-86.0,-87.0,38.0,43.0,44.0,39.0,1
3308,CC:2F:71:3F:1F:24,4583675,1279432528,748821,795769840,3834854,483662688,37,599641,613805725,598926,613719687,715,86038,578885,15,749077,84493,34,496,144444.0,43333.0,-70.0,-67.0,-70.0,-73.0,-70.0,-67.0,-70.0,-73.0,-89.0,-90.0,-86.0,-87.0,19.0,23.0,16.0,14.0,1
3309,CC:2F:71:3E:C5:1F,3835717,483768074,863,105386,3834854,483662688,0,3610,303036,2978,228016,632,75020,913,8,1242,19,0,37,144444.0,39000.0,-71.0,-72.0,-69.0,-60.0,-73.0,-74.0,-70.0,-63.0,-89.0,-90.0,-86.0,-87.0,18.0,18.0,17.0,27.0,1
3310,BA:8C:B9:54:50:24,3839682,489844637,4828,6181949,3834854,483662688,0,8949,1696335,8927,1692840,22,3495,2348,15,5260,39,0,56,229410.0,130000.0,-40.0,-36.0,-45.0,-51.0,-41.0,-35.0,-44.0,-49.0,-89.0,-90.0,-86.0,-87.0,49.0,54.0,41.0,36.0,1
3311,62:47:05:9D:EB:15,3834892,483671627,37,8879,3834855,483662748,0,60,9233,50,7205,10,2028,37,0,49,0,0,3,216660.0,130000.0,-55.0,-51.0,-49.0,-61.0,-56.0,-51.0,-49.0,-61.0,-89.0,-90.0,-86.0,-87.0,34.0,39.0,37.0,26.0,1
3312,3C:55:76:E8:8F:1F,3849697,517955480,14840,34292530,3834857,483662950,7,9011,2464849,8787,2422729,224,42120,4664,15,14857,1479,7,109,286760.0,172050.0,-46.0,-51.0,-40.0,-41.0,-46.0,-52.0,-44.0,-39.0,-89.0,-90.0,-86.0,-87.0,43.0,39.0,46.0,46.0,1
3313,92:69:1D:31:68:E9,3838767,487286139,3908,3622987,3834859,483663152,0,4727,1098297,4587,1066632,140,31665,2112,10,4105,84,0,42,229410.0,137640.0,-51.0,-47.0,-42.0,-48.0,-51.0,-47.0,-43.0,-48.0,-89.0,-90.0,-86.0,-87.0,38.0,43.0,44.0,39.0,1
3314,CC:2F:71:3F:1F:24,4583888,1279696000,749029,796032848,3834859,483663152,37,599832,614059103,599117,613973065,715,86038,579071,15,749285,84511,34,496,144444.0,43333.0,-70.0,-67.0,-70.0,-73.0,-70.0,-66.0,-70.0,-73.0,-89.0,-90.0,-86.0,-87.0,19.0,23.0,16.0,14.0,1
3315,CC:2F:71:3E:C5:1F,3835722,483768538,863,105386,3834859,483663152,0,3610,303036,2978,228016,632,75020,913,8,1242,19,0,37,144444.0,39000.0,-71.0,-72.0,-69.0,-60.0,-73.0,-74.0,-70.0,-63.0,-89.0,-90.0,-86.0,-87.0,18.0,18.0,17.0,27.0,1
3316,BA:8C:B9:54:50:24,3839687,489845101,4828,6181949,3834859,483663152,0,8949,1696335,8927,1692840,22,3495,2348,15,5260,39,0,56,229410.0,130000.0,-40.0,-36.0,-45.0,-51.0,-41.0,-35.0,-44.0,-49.0,-89.0,-90.0,-86.0,-87.0,49.0,54.0,41.0,36.0,1
3317,62:47:05:9D:EB:15,3834902,483672613,38,8995,3834864,483663618,0,62,9369,52,7341,10,2028,37,0,50,0,0,4,216660.0,130000.0,-55.0,-51.0,-49.0,-61.0,-55.0,-50.0,-49.0,-61.0,-89.0,-90.0,-86.0,-87.0,34.0,39.0,37.0,26.0,1
3318,3C:55:76:E8:8F:1F,3849807,518154170,14943,34490552,3834864,483663618,7,9094,2495974,8870,2453854,224,42120,4709,15,14960,1505,7,109,258080.0,154850.0,-48.0,-52.0,-42.0,-44.0,-49.0,-54.0,-45.0,-44.0,-89.0,-90.0,-86.0,-87.0,41.0,38.0,44.0,43.0,1
3319,92:69:1D:31:68:E9,3838773,487286721,3909,3623103,3834864,483663618,0,4729,1098433,4589,1066768,140,31665,2112,10,4106,84,0,42,229410.0,137640.0,-51.0,-47.0,-42.0,-48.0,-51.0,-47.0,-43.0,-48.0,-89.0,-90.0,-86.0,-87.0,38.0,43.0,44.0,39.0,1
3320,CC:2F:71:3F:1F:24,4584111,1279969192,749247,796305574,3834864,483663618,37,600036,614328533,599320,614242377,716,86156,579263,15,749503,84524,34,497,144444.0,43333.0,-70.0,-66.0,-70.0,-73.0,-70.0,-66.0,-69.0,-72.0,-89.0,-90.0,-86.0,-87.0,19.0,24.0,16.0,14.0,1
3321,CC:2F:71:3E:C5:1F,3835728,483769120,864,105502,3834864,483663618,0,3612,303176,2980,228156,632,75020,913,8,1243,19,0,37,144444.0,39000.0,-71.0,-72.0,-69.0,-61.0,-71.0,-72.0,-69.0,-62.0,-89.0,-90.0,-86.0,-87.0,18.0,18.0,17.0,26.0,1
3322,BA:8C:B9:54:50:24,3839693,489845683,4829,6182065,3834864,483663618,0,8955,1696743,8933,1693248,22,3495,2348,15,5261,39,0,56,229410.0,130000.0,-49.0,-35.0,-43.0,-45.0,-41.0,-35.0,-43.0,-47.0,-89.0,-90.0,-86.0,-87.0,40.0,55.0,43.0,42.0,1
3323,62:47:05:9D:EB:15,3834907,483673077,38,8995,3834869,483664082,0,62,9369,52,7341,10,2028,37,0,50,0,0,4,216660.0,130000.0,-55.0,-51.0,-49.0,-61.0,-55.0,-50.0,-49.0,-61.0,-89.0,-90.0,-86.0,-87.0,34.0,39.0,37.0,26.0,1
3324,3C:55:76:E8:8F:1F,3849874,518231626,15005,34567544,3834869,483664082,7,9177,2529297,8953,2487177,224,42120,4763,16,15023,1520,7,110,258080.0,154850.0,-48.0,-51.0,-43.0,-44.0,-48.0,-52.0,-44.0,-44.0,-89.0,-90.0,-86.0,-87.0,41.0,39.0,43.0,43.0,1
3325,92:69:1D:31:68:E9,3838779,487287458,3909,3623103,3834870,483664355,0,4729,1098433,4589,1066768,140,31665,2112,10,4106,84,0,42,229410.0,137640.0,-51.0,-47.0,-42.0,-48.0,-51.0,-47.0,-43.0,-48.0,-89.0,-90.0,-86.0,-87.0,38.0,43.0,44.0,39.0,1
3326,CC:2F:71:3F:1F:24,4584342,1280239537,749472,796575182,3834870,483664355,37,600242,614584346,599526,614498190,716,86156,579462,15,749727,84531,34,497,144444.0,43333.0,-70.0,-66.0,-70.0,-73.0,-70.0,-66.0,-70.0,-73.0,-89.0,-90.0,-86.0,-87.0,19.0,24.0,16.0,14.0,1
3327,CC:2F:71:3E:C5:1F,3835734,483769857,864,105502,3834870,483664355,0,3612,303176,2980,228156,632,75020,913,8,1243,19,0,37,144444.0,39000.0,-71.0,-72.0,-69.0,-61.0,-71.0,-72.0,-69.0,-62.0,-89.0,-90.0,-86.0,-87.0,18.0,18.0,17.0,26.0,1
3328,BA:8C:B9:54:50:24,3839699,489846420,4829,6182065,3834870,483664355,0,8955,1696743,8933,1693248,22,3495,2348,15,5261,39,0,56,229410.0,130000.0,-49.0,-35.0,-43.0,-45.0,-41.0,-35.0,-43.0,-47.0,-89.0,-90.0,-86.0,-87.0,40.0,55.0,43.0,42.0,1
3329,62:47:05:9D:EB:15,3834913,483673816,38,8995,3834875,483664821,0,62,9369,52,7341,10,2028,37,0,50,0,0,4,216660.0,130000.0,-55.0,-51.0,-49.0,-61.0,-55.0,-50.0,-49.0,-61.0,-89.0,-90.0,-86.0,-87.0,34.0,39.0,37.0,26.0,1
3330,3C:55:76:E8:8F:1F,3851034,521150317,16159,37485496,3834875,483664821,7,9519,2611185,9294,2568947,225,42238,4922,16,16177,1560,7,111,286760.0,172050.0,-51.0,-56.0,-47.0,-45.0,-50.0,-55.0,-46.0,-45.0,-89.0,-90.0,-86.0,-87.0,38.0,34.0,39.0,42.0,1
3331,92:69:1D:31:68:E9,3838784,487287924,3909,3623103,3834875,483664821,0,4729,1098433,4589,1066768,140,31665,2112,10,4106,84,0,42,229410.0,137640.0,-51.0,-47.0,-42.0,-48.0,-51.0,-47.0,-43.0,-48.0,-89.0,-90.0,-86.0,-87.0,38.0,43.0,44.0,39.0,1
3332,CC:2F:71:3F:1F:24,4584562,1280511057,749687,796846236,3834875,483664821,37,600441,614850166,599725,614764010,716,86156,579653,15,749943,84553,34,497,144444.0,43333.0,-70.0,-67.0,-69.0,-73.0,-70.0,-67.0,-69.0,-72.0,-89.0,-90.0,-86.0,-87.0,19.0,23.0,17.0,14.0,1
3333,CC:2F:71:3E:C5:1F,3835739,483770323,864,105502,3834875,483664821,0,3612,303176,2980,228156,632,75020,913,8,1243,19,0,37,144444.0,39000.0,-71.0,-72.0,-69.0,-61.0,-71.0,-72.0,-69.0,-62.0,-89.0,-90.0,-86.0,-87.0,18.0,18.0,17.0,26.0,1
3334,BA:8C:B9:54:50:24,3839704,489846886,4829,6182065,3834875,483664821,0,8955,1696743,8933,1693248,22,3495,2348,15,5261,39,0,56,229410.0,130000.0,-49.0,-35.0,-43.0,-45.0,-41.0,-35.0,-43.0,-47.0,-89.0,-90.0,-86.0,-87.0,40.0,55.0,43.0,42.0,1
3335,62:47:05:9D:EB:15,3834917,483674220,38,8995,3834879,483665225,0,62,9369,52,7341,10,2028,37,0,50,0,0,4,216660.0,130000.0,-55.0,-51.0,-49.0,-61.0,-55.0,-50.0,-49.0,-61.0,-89.0,-90.0,-86.0,-87.0,34.0,39.0,37.0,26.0,1
3336,3C:55:76:E8:8F:1F,3852821,525764749,17942,42099524,3834879,483665225,7,9959,2674014,9734,2631776,225,42238,5114,16,17960,1686,7,111,270830.0,162500.0,-46.0,-54.0,-52.0,-39.0,-47.0,-54.0,-50.0,-40.0,-89.0,-90.0,-86.0,-87.0,43.0,36.0,34.0,48.0,1
3337,92:69:1D:31:68:E9,3838791,487288590,3909,3623103,3834882,483665487,0,4729,1098433,4589,1066768,140,31665,2112,10,4106,84,0,42,229410.0,137640.0,-51.0,-47.0,-42.0,-48.0,-51.0,-47.0,-43.0,-48.0,-89.0,-90.0,-86.0,-87.0,38.0,43.0,44.0,39.0,1
3338,CC:2F:71:3F:1F:24,4584796,1280799985,749914,797134498,3834882,483665487,37,600651,615131554,599935,615045398,716,86156,579854,15,750170,84568,34,497,144444.0,43333.0,-70.0,-67.0,-69.0,-73.0,-70.0,-66.0,-69.0,-72.0,-89.0,-90.0,-86.0,-87.0,19.0,23.0,17.0,14.0,1
3339,CC:2F:71:3E:C5:1F,3835746,483770989,864,105502,3834882,483665487,0,3612,303176,2980,228156,632,75020,913,8,1243,19,0,37,144444.0,39000.0,-71.0,-72.0,-69.0,-61.0,-71.0,-72.0,-69.0,-62.0,-89.0,-90.0,-86.0,-87.0,18.0,18.0,17.0,26.0,1
3340,BA:8C:B9:54:50:24,3839713,489847754,4829,6182065,3834884,483665689,0,8955,1696743,8933,1693248,22,3495,2348,15,5261,39,0,56,229410.0,130000.0,-49.0,-35.0,-43.0,-45.0,-41.0,-35.0,-43.0,-47.0,-89.0,-90.0,-86.0,-87.0,40.0,55.0,43.0,42.0,1
3341,62:47:05:9D:EB:15,3834922,483674684,38,8995,3834884,483665689,0,62,9369,52,7341,10,2028,37,0,50,0,0,4,216660.0,130000.0,-55.0,-51.0,-49.0,-61.0,-55.0,-50.0,-49.0,-61.0,-89.0,-90.0,-86.0,-87.0,34.0,39.0,37.0,26.0,1
3342,3C:55:76:E8:8F:1F,3852834,525766379,17950,42100690,3834884,483665689,7,9984,2681016,9759,2638778,225,42238,5123,16,17968,1686,7,111,286760.0,162500.0,-47.0,-55.0,-52.0,-39.0,-46.0,-54.0,-50.0,-39.0,-89.0,-90.0,-86.0,-87.0,42.0,35.0,34.0,48.0,1
3343,92:69:1D:31:68:E9,3838795,487288994,3909,3623103,3834886,483665891,0,4729,1098433,4589,1066768,140,31665,2112,10,4106,84,0,42,229410.0,137640.0,-51.0,-47.0,-42.0,-48.0,-51.0,-47.0,-43.0,-48.0,-89.0,-90.0,-86.0,-87.0,38.0,43.0,44.0,39.0,1
3344,CC:2F:71:3F:1F:24,4585020,1281073214,750134,797407323,3834886,483665891,37,600851,615388101,600135,615301945,716,86156,580050,15,750390,84578,34,497,144444.0,43333.0,-70.0,-67.0,-70.0,-73.0,-69.0,-66.0,-69.0,-72.0,-89.0,-90.0,-86.0,-87.0,19.0,23.0,16.0,14.0,1
3345,CC:2F:71:3E:C5:1F,3835750,483771393,864,105502,3834886,483665891,0,3612,303176,2980,228156,632,75020,913,8,1243,19,0,37,144444.0,39000.0,-71.0,-72.0,-69.0,-61.0,-71.0,-72.0,-69.0,-62.0,-89.0,-90.0,-86.0,-87.0,18.0,18.0,17.0,26.0,1
3346,BA:8C:B9:54:50:24,3839715,489847956,4829,6182065,3834886,483665891,0,8955,1696743,8933,1693248,22,3495,2348,15,5261,39,0,56,229410.0,130000.0,-49.0,-35.0,-43.0,-45.0,-41.0,-35.0,-43.0,-47.0,-89.0,-90.0,-86.0,-87.0,40.0,55.0,43.0,42.0,1
3347,62:47:05:9D:EB:15,3834929,483675550,38,8995,3834891,483666555,0,62,9369,52,7341,10,2028,37,0,50,0,0,4,216660.0,130000.0,-55.0,-51.0,-49.0,-61.0,-55.0,-50.0,-49.0,-61.0,-89.0,-90.0,-86.0,-87.0,34.0,39.0,37.0,26.0,1
3348,3C:55:76:E8:8F:1F,3852850,525770074,17959,42103519,3834891,483666555,7,10017,2700191,9791,2657637,226,42554,5138,16,17977,1686,7,111,286760.0,172050.0,-48.0,-52.0,-42.0,-44.0,-48.0,-52.0,-43.0,-43.0,-89.0,-90.0,-86.0,-87.0,41.0,38.0,44.0,43.0,1
3349,92:69:1D:31:68:E9,3838802,487289860,3909,3623103,3834893,483666757,0,4729,1098433,4589,1066768,140,31665,2112,10,4106,84,0,42,229410.0,137640.0,-51.0,-47.0,-42.0,-48.0,-51.0,-47.0,-43.0,-48.0,-89.0,-90.0,-86.0,-87.0,38.0,43.0,44.0,39.0,1
3350,CC:2F:71:3F:1F:24,4585236,1281336938,750343,797670181,3834893,483666757,37,601039,615639735,600323,615553579,716,86156,580233,15,750599,84588,34,497,144444.0,43333.0,-70.0,-67.0,-70.0,-73.0,-70.0,-67.0,-70.0,-73.0,-89.0,-90.0,-86.0,-87.0,19.0,23.0,16.0,14.0,1
3351,CC:2F:71:3E:C5:1F,3835757,483772259,864,105502,3834893,483666757,0,3612,303176,2980,228156,632,75020,913,8,1243,19,0,37,144444.0,39000.0,-71.0,-72.0,-69.0,-61.0,-71.0,-72.0,-69.0,-62.0,-89.0,-90.0,-86.0,-87.0,18.0,18.0,17.0,26.0,1
3352,BA:8C:B9:54:50:24,3839722,489848822,4829,6182065,3834893,483666757,0,8955,1696743,8933,1693248,22,3495,2348,15,5261,39,0,56,229410.0,130000.0,-49.0,-35.0,-43.0,-45.0,-41.0,-35.0,-43.0,-47.0,-89.0,-90.0,-86.0,-87.0,40.0,55.0,43.0,42.0,1
3353,62:47:05:9D:EB:15,3834934,483676014,38,8995,3834896,483667019,0,62,9369,52,7341,10,2028,37,0,50,0,0,4,216660.0,130000.0,-55.0,-51.0,-49.0,-61.0,-55.0,-50.0,-49.0,-61.0,-89.0,-90.0,-86.0,-87.0,34.0,39.0,37.0,26.0,1
3354,3C:55:76:E8:8F:1F,3852876,525776486,17980,42109467,3834896,483667019,7,10067,2721722,9841,2679168,226,42554,5165,16,17998,1686,7,111,286760.0,172050.0,-51.0,-56.0,-46.0,-45.0,-47.0,-55.0,-50.0,-40.0,-89.0,-90.0,-86.0,-87.0,38.0,34.0,40.0,42.0,1
3355,92:69:1D:31:68:E9,3838805,487290122,3909,3623103,3834896,483667019,0,4729,1098433,4589,1066768,140,31665,2112,10,4106,84,0,42,229410.0,137640.0,-51.0,-47.0,-42.0,-48.0,-51.0,-47.0,-43.0,-48.0,-89.0,-90.0,-86.0,-87.0,38.0,43.0,44.0,39.0,1
3356,CC:2F:71:3F:1F:24,4585450,1281603462,750554,797936443,3834896,483667019,37,601242,615909277,600526,615823121,716,86156,580421,15,750810,84602,34,497,144444.0,43333.0,-70.0,-67.0,-70.0,-73.0,-70.0,-67.0,-70.0,-72.0,-89.0,-90.0,-86.0,-87.0,19.0,23.0,16.0,14.0,1
3357,CC:2F:71:3E:C5:1F,3835762,483772723,864,105502,3834898,483667221,0,3612,303176,2980,228156,632,75020,913,8,1243,19,0,37,144444.0,39000.0,-71.0,-72.0,-69.0,-61.0,-71.0,-72.0,-69.0,-62.0,-89.0,-90.0,-86.0,-87.0,18.0,18.0,17.0,26.0,1
3358,BA:8C:B9:54:50:24,3839727,489849286,4829,6182065,3834898,483667221,0,8955,1696743,8933,1693248,22,3495,2348,15,5261,39,0,56,229410.0,130000.0,-49.0,-35.0,-43.0,-45.0,-41.0,-35.0,-43.0,-47.0,-89.0,-90.0,-86.0,-87.0,40.0,55.0,43.0,42.0,1
3359,62:47:05:9D:EB:15,3834941,483676682,38,8995,3834903,483667687,0,63,9437,53,7409,10,2028,37,0,51,0,0,4,216660.0,130000.0,-55.0,-50.0,-49.0,-61.0,-55.0,-50.0,-49.0,-61.0,-89.0,-90.0,-86.0,-87.0,34.0,40.0,37.0,26.0,1
3360,3C:55:76:E8:8F:1F,3852883,525777154,17980,42109467,3834903,483667687,7,10079,2722594,9852,2679922,227,42672,5166,16,17998,1686,7,112,286760.0,172050.0,-47.0,-55.0,-52.0,-40.0,-46.0,-54.0,-51.0,-39.0,-89.0,-90.0,-86.0,-87.0,42.0,35.0,34.0,47.0,1
3361,92:69:1D:31:68:E9,3838812,487290790,3909,3623103,3834903,483667687,0,4731,1098569,4591,1066904,140,31665,2112,10,4107,84,0,42,229410.0,137640.0,-51.0,-47.0,-42.0,-49.0,-51.0,-47.0,-42.0,-47.0,-89.0,-90.0,-86.0,-87.0,38.0,43.0,44.0,38.0,1
3362,CC:2F:71:3F:1F:24,4585677,1281878507,750774,798210820,3834903,483667687,37,601456,616186127,600740,616099971,716,86156,580619,15,751030,84620,34,499,144444.0,43333.0,-70.0,-67.0,-71.0,-73.0,-70.0,-67.0,-70.0,-73.0,-89.0,-90.0,-86.0,-87.0,19.0,23.0,15.0,14.0,1
3363,CC:2F:71:3E:C5:1F,3835767,483773189,864,105502,3834903,483667687,0,3614,303316,2982,228296,632,75020,913,8,1244,19,0,37,144444.0,39000.0,-71.0,-72.0,-69.0,-61.0,-71.0,-72.0,-69.0,-62.0,-89.0,-90.0,-86.0,-87.0,18.0,18.0,17.0,26.0,1
3364,BA:8C:B9:54:50:24,3839732,489849752,4829,6182065,3834903,483667687,0,8957,1696879,8935,1693384,22,3495,2348,15,5262,39,0,56,229410.0,130000.0,-48.0,-35.0,-43.0,-46.0,-42.0,-34.0,-43.0,-47.0,-89.0,-90.0,-86.0,-87.0,41.0,55.0,43.0,41.0,1
3365,62:47:05:9D:EB:15,3834946,483677146,38,8995,3834908,483668151,0,64,9505,54,7477,10,2028,37,0,51,0,0,4,216660.0,130000.0,-55.0,-51.0,-49.0,-61.0,-55.0,-50.0,-49.0,-61.0,-89.0,-90.0,-86.0,-87.0,34.0,39.0,37.0,26.0,1
3366,3C:55:76:E8:8F:1F,3852901,525785531,17993,42117380,3834908,483668151,7,10113,2754698,9886,2712026,227,42672,5180,16,18011,1686,7,113,286760.0,172050.0,-50.0,-56.0,-47.0,-44.0,-49.0,-55.0,-44.0,-44.0,-89.0,-90.0,-86.0,-87.0,39.0,34.0,39.0,43.0,1
3367,92:69:1D:31:68:E9,3838817,487291254,3909,3623103,3834908,483668151,0,4732,1098637,4592,1066972,140,31665,2112,10,4107,84,0,42,229410.0,137640.0,-52.0,-47.0,-44.0,-47.0,-51.0,-47.0,-42.0,-47.0,-89.0,-90.0,-86.0,-87.0,37.0,43.0,42.0,40.0,1
3368,CC:2F:71:3F:1F:24,4585891,1282143549,750983,798475398,3834908,483668151,37,601651,616440283,600935,616354127,716,86156,580806,15,751239,84646,34,499,144444.0,43333.0,-70.0,-67.0,-70.0,-74.0,-70.0,-67.0,-70.0,-73.0,-89.0,-90.0,-86.0,-87.0,19.0,23.0,16.0,13.0,1
3369,CC:2F:71:3E:C5:1F,3835772,483773653,864,105502,3834908,483668151,0,3614,303316,2982,228296,632,75020,913,8,1244,19,0,37,144444.0,39000.0,-71.0,-72.0,-69.0,-61.0,-71.0,-72.0,-69.0,-62.0,-89.0,-90.0,-86.0,-87.0,18.0,18.0,17.0,26.0,1
3370,BA:8C:B9:54:50:24,3839739,489850418,4829,6182065,3834910,483668353,0,8957,1696879,8935,1693384,22,3495,2348,15,5262,39,0,56,229410.0,130000.0,-48.0,-35.0,-43.0,-46.0,-42.0,-34.0,-43.0,-47.0,-89.0,-90.0,-86.0,-87.0,41.0,55.0,43.0,41.0,1
3371,62:47:05:9D:EB:15,3834950,483677550,38,8995,3834912,483668555,0,64,9505,54,7477,10,2028,37,0,51,0,0,4,216660.0,130000.0,-55.0,-51.0,-49.0,-61.0,-55.0,-50.0,-49.0,-61.0,-89.0,-90.0,-86.0,-87.0,34.0,39.0,37.0,26.0,1
3372,3C:55:76:E8:8F:1F,3852924,525827480,18012,42158925,3834912,483668555,7,10141,2763089,9914,2720417,227,42672,5190,16,18030,1686,7,113,286760.0,172050.0,-47.0,-53.0,-44.0,-41.0,-47.0,-52.0,-42.0,-42.0,-89.0,-90.0,-86.0,-87.0,42.0,37.0,42.0,46.0,1
3373,92:69:1D:31:68:E9,3838821,487291658,3909,3623103,3834912,483668555,0,4732,1098637,4592,1066972,140,31665,2112,10,4107,84,0,42,229410.0,137640.0,-52.0,-47.0,-44.0,-47.0,-51.0,-47.0,-42.0,-47.0,-89.0,-90.0,-86.0,-87.0,37.0,43.0,42.0,40.0,1
3374,CC:2F:71:3F:1F:24,4586111,1282416547,751199,798747992,3834912,483668555,37,601860,616718881,601144,616632725,716,86156,580997,15,751455,84668,34,499,144444.0,43333.0,-70.0,-67.0,-71.0,-74.0,-70.0,-67.0,-70.0,-73.0,-89.0,-90.0,-86.0,-87.0,19.0,23.0,15.0,13.0,1
3375,CC:2F:71:3E:C5:1F,3835778,483774259,864,105502,3834914,483668757,0,3614,303316,2982,228296,632,75020,913,8,1244,19,0,37,144444.0,39000.0,-71.0,-72.0,-69.0,-61.0,-71.0,-72.0,-69.0,-62.0,-89.0,-90.0,-86.0,-87.0,18.0,18.0,17.0,26.0,1
3376,BA:8C:B9:54:50:24,3839743,489850822,4829,6182065,3834914,483668757,0,8957,1696879,8935,1693384,22,3495,2348,15,5262,39,0,56,229410.0,130000.0,-48.0,-35.0,-43.0,-46.0,-42.0,-34.0,-43.0,-47.0,-89.0,-90.0,-86.0,-87.0,41.0,55.0,43.0,41.0,1
3377,62:47:05:9D:EB:15,3834957,483678138,38,8995,3834919,483669143,0,64,9505,54,7477,10,2028,37,0,51,0,0,4,216660.0,130000.0,-55.0,-51.0,-49.0,-61.0,-55.0,-50.0,-49.0,-61.0,-89.0,-90.0,-86.0,-87.0,34.0,39.0,37.0,26.0,1
3378,3C:55:76:E8:8F:1F,3853924,528411975,19003,44742630,3834921,483669345,7,10446,2842747,10218,2799957,228,42790,5342,16,18991,1726,7,113,286760.0,172050.0,-50.0,-56.0,-47.0,-44.0,-50.0,-56.0,-47.0,-44.0,-89.0,-90.0,-86.0,-87.0,39.0,34.0,39.0,43.0,1
3379,92:69:1D:31:68:E9,3838830,487292448,3909,3623103,3834921,483669345,0,4732,1098637,4592,1066972,140,31665,2112,10,4107,84,0,42,229410.0,137640.0,-52.0,-47.0,-44.0,-47.0,-51.0,-47.0,-42.0,-47.0,-89.0,-90.0,-86.0,-87.0,37.0,43.0,42.0,40.0,1
3380,CC:2F:71:3F:1F:24,4586343,1282702247,751422,799032902,3834921,483669345,37,602073,617006341,601357,616920185,716,86156,581194,15,751678,84698,34,499,144444.0,43333.0,-70.0,-67.0,-70.0,-73.0,-70.0,-67.0,-69.0,-73.0,-89.0,-90.0,-86.0,-87.0,19.0,23.0,16.0,14.0,1
3381,CC:2F:71:3E:C5:1F,3835785,483774847,864,105502,3834921,483669345,0,3616,303504,2983,228366,633,75138,914,8,1244,19,0,37,144444.0,39000.0,-71.0,-72.0,-69.0,-60.0,-70.0,-71.0,-68.0,-61.0,-89.0,-90.0,-86.0,-87.0,18.0,18.0,17.0,27.0,1
3382,BA:8C:B9:54:50:24,3839752,489851612,4829,6182065,3834923,483669547,0,8957,1696879,8935,1693384,22,3495,2348,15,5262,39,0,56,229410.0,130000.0,-48.0,-35.0,-43.0,-46.0,-42.0,-34.0,-43.0,-47.0,-89.0,-90.0,-86.0,-87.0,41.0,55.0,43.0,41.0,1
3383,62:47:05:9D:EB:15,3834986,483689767,38,8995,3834948,483680772,0,64,9505,54,7477,10,2028,37,0,51,0,0,4,216660.0,130000.0,-55.0,-51.0,-49.0,-61.0,-55.0,-50.0,-49.0,-61.0,-89.0,-90.0,-86.0,-87.0,34.0,39.0,37.0,26.0,1
3384,3C:55:76:E8:8F:1F,3854332,529586165,19384,45905393,3834948,483680772,7,10559,2861007,10331,2818217,228,42790,5390,16,19402,1743,7,116,286760.0,172050.0,-49.0,-53.0,-43.0,-45.0,-48.0,-51.0,-42.0,-44.0,-89.0,-90.0,-86.0,-87.0,40.0,37.0,43.0,42.0,1
3385,92:69:1D:31:68:E9,3838857,487303875,3909,3623103,3834948,483680772,0,4735,1099008,4594,1067108,141,31900,2113,10,4107,84,0,42,229410.0,137640.0,-51.0,-47.0,-44.0,-47.0,-51.0,-47.0,-43.0,-48.0,-89.0,-90.0,-86.0,-87.0,38.0,43.0,42.0,40.0,1
3386,CC:2F:71:3F:1F:24,4586598,1282996071,751650,799315299,3834948,483680772,37,602284,617281074,601568,617194918,716,86156,581397,15,751906,84720,34,500,144444.0,43333.0,-70.0,-67.0,-70.0,-74.0,-70.0,-67.0,-70.0,-73.0,-89.0,-90.0,-86.0,-87.0,19.0,23.0,16.0,13.0,1
3387,CC:2F:71:3E:C5:1F,3835812,483786274,864,105502,3834948,483680772,0,3616,303504,2983,228366,633,75138,914,8,1244,19,0,37,144444.0,39000.0,-71.0,-72.0,-69.0,-60.0,-70.0,-71.0,-68.0,-61.0,-89.0,-90.0,-86.0,-87.0,18.0,18.0,17.0,27.0,1
3388,BA:8C:B9:54:50:24,3839777,489862837,4829,6182065,3834948,483680772,0,8957,1696879,8935,1693384,22,3495,2348,15,5262,39,0,56,229410.0,130000.0,-48.0,-35.0,-43.0,-46.0,-42.0,-34.0,-43.0,-47.0,-89.0,-90.0,-86.0,-87.0,41.0,55.0,43.0,41.0,1
3389,62:47:05:9D:EB:15,3834990,483690171,38,8995,3834952,483681176,0,64,9505,54,7477,10,2028,37,0,51,0,0,4,216660.0,130000.0,-55.0,-51.0,-49.0,-61.0,-55.0,-50.0,-49.0,-61.0,-89.0,-90.0,-86.0,-87.0,34.0,39.0,37.0,26.0,1
3390,3C:55:76:E8:8F:1F,3854354,529600986,19400,45919608,3834954,483681378,7,10611,2889214,10383,2846424,228,42790,5413,16,19418,1743,7,116,286760.0,1000.0,-46.0,-54.0,-53.0,-39.0,-47.0,-54.0,-50.0,-41.0,-89.0,-90.0,-86.0,-87.0,43.0,36.0,33.0,48.0,1
3391,92:69:1D:31:68:E9,3838864,487304541,3909,3623103,3834955,483681438,0,4735,1099008,4594,1067108,141,31900,2113,10,4107,84,0,42,229410.0,137640.0,-51.0,-47.0,-44.0,-47.0,-51.0,-47.0,-43.0,-48.0,-89.0,-90.0,-86.0,-87.0,38.0,43.0,42.0,40.0,1
3392,CC:2F:71:3F:1F:24,4586820,1283269327,751865,799587889,3834955,483681438,37,602492,617559472,601776,617473316,716,86156,581590,15,752121,84750,34,501,144444.0,43333.0,-70.0,-67.0,-70.0,-73.0,-70.0,-67.0,-70.0,-72.0,-89.0,-90.0,-86.0,-87.0,19.0,23.0,16.0,14.0,1
3393,CC:2F:71:3E:C5:1F,3835820,483787213,864,105502,3834956,483681711,0,3616,303504,2983,228366,633,75138,914,8,1244,19,0,37,144444.0,39000.0,-71.0,-72.0,-69.0,-60.0,-70.0,-71.0,-68.0,-61.0,-89.0,-90.0,-86.0,-87.0,18.0,18.0,17.0,27.0,1
3394,BA:8C:B9:54:50:24,3839785,489863776,4829,6182065,3834956,483681711,0,8957,1696879,8935,1693384,22,3495,2348,15,5262,39,0,56,229410.0,130000.0,-48.0,-35.0,-43.0,-46.0,-42.0,-34.0,-43.0,-47.0,-89.0,-90.0,-86.0,-87.0,41.0,55.0,43.0,41.0,1
3395,62:47:05:9D:EB:15,3834996,483690908,38,8995,3834958,483681913,0,64,9505,54,7477,10,2028,37,0,51,0,0,4,216660.0,130000.0,-55.0,-51.0,-49.0,-61.0,-55.0,-50.0,-49.0,-61.0,-89.0,-90.0,-86.0,-87.0,34.0,39.0,37.0,26.0,1
3396,3C:55:76:E8:8F:1F,3854358,529601521,19400,45919608,3834958,483681913,7,10623,2890032,10395,2847242,228,42790,5413,16,19418,1743,7,116,286760.0,1000.0,-47.0,-55.0,-53.0,-40.0,-46.0,-54.0,-52.0,-39.0,-89.0,-90.0,-86.0,-87.0,42.0,35.0,33.0,47.0,1
3397,92:69:1D:31:68:E9,3838869,487305218,3909,3623103,3834960,483682115,0,4735,1099008,4594,1067108,141,31900,2113,10,4107,84,0,42,229410.0,137640.0,-51.0,-47.0,-44.0,-47.0,-51.0,-47.0,-43.0,-48.0,-89.0,-90.0,-86.0,-87.0,38.0,43.0,42.0,40.0,1
3398,CC:2F:71:3F:1F:24,4587039,1283536664,752079,799854549,3834960,483682115,37,602687,617814828,601971,617728672,716,86156,581779,15,752335,84786,34,501,144444.0,43333.0,-70.0,-67.0,-70.0,-73.0,-70.0,-66.0,-70.0,-73.0,-89.0,-90.0,-86.0,-87.0,19.0,23.0,16.0,14.0,1
3399,CC:2F:71:3E:C5:1F,3835824,483787617,864,105502,3834960,483682115,0,3616,303504,2983,228366,633,75138,914,8,1244,19,0,37,144444.0,39000.0,-71.0,-72.0,-69.0,-60.0,-70.0,-71.0,-68.0,-61.0,-89.0,-90.0,-86.0,-87.0,18.0,18.0,17.0,27.0,1
3400,BA:8C:B9:54:50:24,3839791,489864382,4829,6182065,3834962,483682317,0,8957,1696879,8935,1693384,22,3495,2348,15,5262,39,0,56,229410.0,130000.0,-48.0,-35.0,-43.0,-46.0,-42.0,-34.0,-43.0,-47.0,-89.0,-90.0,-86.0,-87.0,41.0,55.0,43.0,41.0,1
3401,62:47:05:9D:EB:15,3835002,483691514,38,8995,3834964,483682519,0,64,9505,54,7477,10,2028,37,0,51,0,0,4,216660.0,130000.0,-55.0,-51.0,-49.0,-61.0,-55.0,-50.0,-49.0,-61.0,-89.0,-90.0,-86.0,-87.0,34.0,39.0,37.0,26.0,1
3402,3C:55:76:E8:8F:1F,3854364,529602127,19400,45919608,3834964,483682519,7,10623,2890032,10395,2847242,228,42790,5413,16,19418,1743,7,116,286760.0,1000.0,-47.0,-55.0,-53.0,-40.0,-46.0,-54.0,-52.0,-39.0,-89.0,-90.0,-86.0,-87.0,42.0,35.0,33.0,47.0,1
3403,92:69:1D:31:68:E9,3838873,487305622,3909,3623103,3834964,483682519,0,4735,1099008,4594,1067108,141,31900,2113,10,4107,84,0,42,229410.0,137640.0,-51.0,-47.0,-44.0,-47.0,-51.0,-47.0,-43.0,-48.0,-89.0,-90.0,-86.0,-87.0,38.0,43.0,42.0,40.0,1
3404,CC:2F:71:3F:1F:24,4587272,1283819551,752308,800137032,3834964,483682519,37,602895,618082061,602179,617995905,716,86156,581982,15,752564,84847,34,501,130000.0,43333.0,-70.0,-66.0,-68.0,-73.0,-70.0,-66.0,-68.0,-73.0,-89.0,-90.0,-86.0,-87.0,19.0,24.0,18.0,14.0,1
3405,CC:2F:71:3E:C5:1F,3835830,483788223,864,105502,3834966,483682721,0,3616,303504,2983,228366,633,75138,914,8,1244,19,0,37,144444.0,39000.0,-71.0,-72.0,-69.0,-60.0,-70.0,-71.0,-68.0,-61.0,-89.0,-90.0,-86.0,-87.0,18.0,18.0,17.0,27.0,1
3406,BA:8C:B9:54:50:24,3839796,489864846,4829,6182065,3834967,483682781,0,8957,1696879,8935,1693384,22,3495,2348,15,5262,39,0,56,229410.0,130000.0,-48.0,-35.0,-43.0,-46.0,-42.0,-34.0,-43.0,-47.0,-89.0,-90.0,-86.0,-87.0,41.0,55.0,43.0,41.0,1
3407,62:47:05:9D:EB:15,3835009,483692346,38,8995,3834971,483683351,0,64,9505,54,7477,10,2028,37,0,51,0,0,4,216660.0,130000.0,-55.0,-51.0,-49.0,-61.0,-55.0,-50.0,-49.0,-61.0,-89.0,-90.0,-86.0,-87.0,34.0,39.0,37.0,26.0,1
3408,3C:55:76:E8:8F:1F,3854373,529603161,19400,45919608,3834973,483683553,7,10623,2890032,10395,2847242,228,42790,5413,16,19418,1743,7,116,286760.0,1000.0,-47.0,-55.0,-53.0,-40.0,-46.0,-54.0,-52.0,-39.0,-89.0,-90.0,-86.0,-87.0,42.0,35.0,33.0,47.0,1
3409,92:69:1D:31:68:E9,3838882,487306656,3909,3623103,3834973,483683553,0,4735,1099008,4594,1067108,141,31900,2113,10,4107,84,0,42,229410.0,137640.0,-51.0,-47.0,-44.0,-47.0,-51.0,-47.0,-43.0,-48.0,-89.0,-90.0,-86.0,-87.0,38.0,43.0,42.0,40.0,1
3410,CC:2F:71:3F:1F:24,4587492,1284086831,752519,800403278,3834973,483683553,37,603094,618346703,602378,618260547,716,86156,582168,15,752775,84848,34,501,130000.0,43333.0,-70.0,-67.0,-69.0,-74.0,-70.0,-66.0,-69.0,-74.0,-89.0,-90.0,-86.0,-87.0,19.0,23.0,17.0,13.0,1
3411,CC:2F:71:3E:C5:1F,3835837,483789055,864,105502,3834973,483683553,0,3616,303504,2983,228366,633,75138,914,8,1244,19,0,37,144444.0,39000.0,-71.0,-72.0,-69.0,-60.0,-70.0,-71.0,-68.0,-61.0,-89.0,-90.0,-86.0,-87.0,18.0,18.0,17.0,27.0,1
3412,BA:8C:B9:54:50:24,3839802,489865618,4829,6182065,3834973,483683553,0,8957,1696879,8935,1693384,22,3495,2348,15,5262,39,0,56,229410.0,130000.0,-48.0,-35.0,-43.0,-46.0,-42.0,-34.0,-43.0,-47.0,-89.0,-90.0,-86.0,-87.0,41.0,55.0,43.0,41.0,1
3413,62:47:05:9D:EB:15,3835015,483692952,38,8995,3834977,483683957,0,64,9505,54,7477,10,2028,37,0,51,0,0,4,216660.0,130000.0,-55.0,-51.0,-49.0,-61.0,-55.0,-50.0,-49.0,-61.0,-89.0,-90.0,-86.0,-87.0,34.0,39.0,37.0,26.0,1
3414,3C:55:76:E8:8F:1F,3854962,531117172,19985,47433215,3834977,483683957,7,10790,2917377,10562,2874587,228,42790,5487,16,20001,1852,7,116,286760.0,1000.0,-48.0,-48.0,-42.0,-43.0,-47.0,-50.0,-45.0,-44.0,-89.0,-90.0,-86.0,-87.0,41.0,42.0,44.0,44.0,1
3415,92:69:1D:31:68:E9,3838886,487307060,3909,3623103,3834977,483683957,0,4735,1099008,4594,1067108,141,31900,2113,10,4107,84,0,42,229410.0,137640.0,-51.0,-47.0,-44.0,-47.0,-51.0,-47.0,-43.0,-48.0,-89.0,-90.0,-86.0,-87.0,38.0,43.0,42.0,40.0,1
3416,CC:2F:71:3F:1F:24,4587714,1284362839,752737,800678882,3834977,483683957,37,603294,618612619,602578,618526463,716,86156,582363,15,752993,84869,34,501,130000.0,43333.0,-75.0,-70.0,-73.0,-77.0,-73.0,-68.0,-71.0,-75.0,-89.0,-90.0,-86.0,-87.0,14.0,20.0,13.0,10.0,1
3417,CC:2F:71:3E:C5:1F,3835841,483789459,864,105502,3834977,483683957,0,3616,303504,2983,228366,633,75138,914,8,1244,19,0,37,144444.0,39000.0,-71.0,-72.0,-69.0,-60.0,-70.0,-71.0,-68.0,-61.0,-89.0,-90.0,-86.0,-87.0,18.0,18.0,17.0,27.0,1
3418,BA:8C:B9:54:50:24,3839806,489866022,4829,6182065,3834977,483683957,0,8957,1696879,8935,1693384,22,3495,2348,15,5262,39,0,56,229410.0,130000.0,-48.0,-35.0,-43.0,-46.0,-42.0,-34.0,-43.0,-47.0,-89.0,-90.0,-86.0,-87.0,41.0,55.0,43.0,41.0,1
3419,62:47:05:9D:EB:15,3835020,483693416,38,8995,3834982,483684421,0,64,9505,54,7477,10,2028,37,0,51,0,0,4,216660.0,130000.0,-55.0,-51.0,-49.0,-61.0,-55.0,-50.0,-49.0,-61.0,-89.0,-90.0,-86.0,-87.0,34.0,39.0,37.0,26.0,1
3420,3C:55:76:E8:8F:1F,3854970,531118213,19988,47433792,3834982,483684421,7,10819,2923836,10591,2881046,228,42790,5496,16,20006,1852,7,116,286760.0,172050.0,-44.0,-52.0,-52.0,-41.0,-44.0,-51.0,-50.0,-40.0,-89.0,-90.0,-86.0,-87.0,45.0,38.0,34.0,46.0,1
3421,92:69:1D:31:68:E9,3838891,487307524,3909,3623103,3834982,483684421,0,4735,1099008,4594,1067108,141,31900,2113,10,4107,84,0,42,229410.0,137640.0,-51.0,-47.0,-44.0,-47.0,-51.0,-47.0,-43.0,-48.0,-89.0,-90.0,-86.0,-87.0,38.0,43.0,42.0,40.0,1
3422,CC:2F:71:3F:1F:24,4587953,1284648367,752969,800963744,3834984,483684623,37,603508,618888053,602792,618801897,716,86156,582568,15,753224,84889,34,501,130000.0,39000.0,-71.0,-67.0,-70.0,-74.0,-71.0,-67.0,-70.0,-73.0,-89.0,-90.0,-86.0,-87.0,18.0,23.0,16.0,13.0,1
3423,CC:2F:71:3E:C5:1F,3835848,483790125,864,105502,3834984,483684623,0,3616,303504,2983,228366,633,75138,914,8,1244,19,0,37,144444.0,39000.0,-71.0,-72.0,-69.0,-60.0,-70.0,-71.0,-68.0,-61.0,-89.0,-90.0,-86.0,-87.0,18.0,18.0,17.0,27.0,1
3424,BA:8C:B9:54:50:24,3839813,489866688,4829,6182065,3834984,483684623,0,8957,1696879,8935,1693384,22,3495,2348,15,5262,39,0,56,229410.0,130000.0,-48.0,-35.0,-43.0,-46.0,-42.0,-34.0,-43.0,-47.0,-89.0,-90.0,-86.0,-87.0,41.0,55.0,43.0,41.0,1
3425,62:47:05:9D:EB:15,3835024,483693820,38,8995,3834986,483684825,0,64,9505,54,7477,10,2028,37,0,51,0,0,4,216660.0,130000.0,-55.0,-51.0,-49.0,-61.0,-55.0,-50.0,-49.0,-61.0,-89.0,-90.0,-86.0,-87.0,34.0,39.0,37.0,26.0,1
3426,3C:55:76:E8:8F:1F,3854979,531119439,19993,47434614,3834986,483684825,7,10835,2925146,10607,2882356,228,42790,5500,16,20011,1852,7,116,286760.0,172050.0,-44.0,-52.0,-52.0,-41.0,-44.0,-51.0,-50.0,-40.0,-89.0,-90.0,-86.0,-87.0,45.0,38.0,34.0,46.0,1
3427,92:69:1D:31:68:E9,3838895,487307928,3909,3623103,3834986,483684825,0,4735,1099008,4594,1067108,141,31900,2113,10,4107,84,0,42,229410.0,137640.0,-51.0,-47.0,-44.0,-47.0,-51.0,-47.0,-43.0,-48.0,-89.0,-90.0,-86.0,-87.0,38.0,43.0,42.0,40.0,1
3428,CC:2F:71:3F:1F:24,4588168,1284913425,753180,801228398,3834988,483685027,37,603705,619150945,602989,619064789,716,86156,582753,15,753436,84903,34,501,130000.0,43333.0,-72.0,-67.0,-70.0,-74.0,-71.0,-67.0,-69.0,-73.0,-89.0,-90.0,-86.0,-87.0,17.0,23.0,16.0,13.0,1
3429,CC:2F:71:3E:C5:1F,3835852,483790529,864,105502,3834988,483685027,0,3616,303504,2983,228366,633,75138,914,8,1244,19,0,37,144444.0,39000.0,-71.0,-72.0,-69.0,-60.0,-70.0,-71.0,-68.0,-61.0,-89.0,-90.0,-86.0,-87.0,18.0,18.0,17.0,27.0,1
3430,BA:8C:B9:54:50:24,3839817,489867092,4829,6182065,3834988,483685027,0,8957,1696879,8935,1693384,22,3495,2348,15,5262,39,0,56,229410.0,130000.0,-48.0,-35.0,-43.0,-46.0,-42.0,-34.0,-43.0,-47.0,-89.0,-90.0,-86.0,-87.0,41.0,55.0,43.0,41.0,1
3431,62:47:05:9D:EB:15,3835031,483694486,38,8995,3834993,483685491,0,64,9505,54,7477,10,2028,37,0,51,0,0,4,216660.0,130000.0,-55.0,-51.0,-49.0,-61.0,-55.0,-50.0,-49.0,-61.0,-89.0,-90.0,-86.0,-87.0,34.0,39.0,37.0,26.0,1
3432,3C:55:76:E8:8F:1F,3854987,531120229,19994,47434738,3834993,483685491,7,10839,2928476,10611,2885686,228,42790,5503,16,20011,1852,7,116,286760.0,172050.0,-46.0,-46.0,-41.0,-40.0,-44.0,-50.0,-48.0,-40.0,-89.0,-90.0,-86.0,-87.0,43.0,44.0,45.0,47.0,1
3433,92:69:1D:31:68:E9,3838902,487308594,3909,3623103,3834993,483685491,0,4735,1099008,4594,1067108,141,31900,2113,10,4107,84,0,42,229410.0,137640.0,-51.0,-47.0,-44.0,-47.0,-51.0,-47.0,-43.0,-48.0,-89.0,-90.0,-86.0,-87.0,38.0,43.0,42.0,40.0,1
3434,CC:2F:71:3F:1F:24,4588383,1285175621,753390,801490130,3834993,483685491,37,603899,619411889,603183,619325733,716,86156,582937,15,753646,84929,34,502,117000.0,39000.0,-72.0,-67.0,-70.0,-73.0,-72.0,-67.0,-69.0,-73.0,-89.0,-90.0,-86.0,-87.0,17.0,23.0,16.0,14.0,1
3435,CC:2F:71:3E:C5:1F,3835857,483790993,864,105502,3834993,483685491,0,3616,303504,2983,228366,633,75138,914,8,1244,19,0,37,144444.0,39000.0,-71.0,-72.0,-69.0,-60.0,-70.0,-71.0,-68.0,-61.0,-89.0,-90.0,-86.0,-87.0,18.0,18.0,17.0,27.0,1
3436,BA:8C:B9:54:50:24,3839824,489867758,4829,6182065,3834995,483685693,0,8957,1696879,8935,1693384,22,3495,2348,15,5262,39,0,56,229410.0,130000.0,-48.0,-35.0,-43.0,-46.0,-42.0,-34.0,-43.0,-47.0,-89.0,-90.0,-86.0,-87.0,41.0,55.0,43.0,41.0,1
3437,62:47:05:9D:EB:15,3835035,483694890,38,8995,3834997,483685895,0,64,9505,54,7477,10,2028,37,0,51,0,0,4,216660.0,130000.0,-55.0,-51.0,-49.0,-61.0,-55.0,-50.0,-49.0,-61.0,-89.0,-90.0,-86.0,-87.0,34.0,39.0,37.0,26.0,1
3438,3C:55:76:E8:8F:1F,3854994,531121257,19997,47435362,3834997,483685895,7,10858,2929884,10630,2887094,228,42790,5505,16,20015,1855,7,116,258080.0,154850.0,-48.0,-49.0,-43.0,-44.0,-48.0,-48.0,-43.0,-43.0,-89.0,-90.0,-86.0,-87.0,41.0,41.0,43.0,43.0,1
3439,92:69:1D:31:68:E9,3838906,487308998,3909,3623103,3834997,483685895,0,4735,1099008,4594,1067108,141,31900,2113,10,4107,84,0,42,229410.0,137640.0,-51.0,-47.0,-44.0,-47.0,-51.0,-47.0,-43.0,-48.0,-89.0,-90.0,-86.0,-87.0,38.0,43.0,42.0,40.0,1
3440,CC:2F:71:3F:1F:24,4588606,1285447413,753607,801761316,3834999,483686097,37,604109,619693499,603393,619607343,716,86156,583126,15,753863,84939,34,502,130000.0,43333.0,-72.0,-67.0,-70.0,-73.0,-71.0,-67.0,-69.0,-73.0,-89.0,-90.0,-86.0,-87.0,17.0,23.0,16.0,14.0,1
3441,CC:2F:71:3E:C5:1F,3835863,483791599,864,105502,3834999,483686097,0,3616,303504,2983,228366,633,75138,914,8,1244,19,0,37,144444.0,39000.0,-71.0,-72.0,-69.0,-60.0,-70.0,-71.0,-68.0,-61.0,-89.0,-90.0,-86.0,-87.0,18.0,18.0,17.0,27.0,1
3442,BA:8C:B9:54:50:24,3839828,489868162,4829,6182065,3834999,483686097,0,8957,1696879,8935,1693384,22,3495,2348,15,5262,39,0,56,229410.0,130000.0,-48.0,-35.0,-43.0,-46.0,-42.0,-34.0,-43.0,-47.0,-89.0,-90.0,-86.0,-87.0,41.0,55.0,43.0,41.0,1
3443,62:47:05:9D:EB:15,3835039,483695294,38,8995,3835001,483686299,0,65,9573,55,7545,10,2028,37,0,51,0,0,4,216660.0,130000.0,-54.0,-52.0,-49.0,-56.0,-54.0,-51.0,-49.0,-60.0,-89.0,-90.0,-86.0,-87.0,35.0,38.0,37.0,31.0,1
3444,3C:55:76:E8:8F:1F,3855345,532016368,20342,48329867,3835003,483686501,8,10963,2947163,10735,2904373,228,42790,5548,16,20359,2066,8,116,172050.0,1000.0,-48.0,-52.0,-47.0,-46.0,-45.0,-51.0,-49.0,-43.0,-89.0,-90.0,-86.0,-87.0,41.0,38.0,39.0,41.0,1
3445,92:69:1D:31:68:E9,3838913,487309664,3909,3623103,3835004,483686561,0,4735,1099008,4594,1067108,141,31900,2113,10,4107,84,0,42,229410.0,137640.0,-51.0,-47.0,-44.0,-47.0,-51.0,-47.0,-43.0,-48.0,-89.0,-90.0,-86.0,-87.0,38.0,43.0,42.0,40.0,1
3446,CC:2F:71:3F:1F:24,4588828,1285717256,753824,802030695,3835004,483686561,37,604316,619965085,603600,619878929,716,86156,583319,15,754080,84970,34,502,130000.0,43333.0,-71.0,-67.0,-70.0,-74.0,-71.0,-67.0,-69.0,-73.0,-89.0,-90.0,-86.0,-87.0,18.0,23.0,16.0,13.0,1
3447,CC:2F:71:3E:C5:1F,3835868,483792063,864,105502,3835004,483686561,0,3616,303504,2983,228366,633,75138,914,8,1244,19,0,37,144444.0,39000.0,-71.0,-72.0,-69.0,-60.0,-70.0,-71.0,-68.0,-61.0,-89.0,-90.0,-86.0,-87.0,18.0,18.0,17.0,27.0,1
3448,BA:8C:B9:54:50:24,3839833,489868626,4829,6182065,3835004,483686561,0,8957,1696879,8935,1693384,22,3495,2348,15,5262,39,0,56,229410.0,130000.0,-48.0,-35.0,-43.0,-46.0,-42.0,-34.0,-43.0,-47.0,-89.0,-90.0,-86.0,-87.0,41.0,55.0,43.0,41.0,1
3449,62:47:05:9D:EB:15,3835047,483696076,39,9111,3835008,483686965,0,66,9641,56,7613,10,2028,37,0,52,0,0,4,216660.0,130000.0,-55.0,-51.0,-48.0,-55.0,-54.0,-51.0,-48.0,-59.0,-89.0,-90.0,-86.0,-87.0,34.0,39.0,38.0,32.0,1
3450,3C:55:76:E8:8F:1F,3855351,532016959,20343,48329994,3835008,483686965,8,10971,2947766,10743,2904976,228,42790,5549,16,20361,2066,8,116,172050.0,51610.0,-44.0,-52.0,-52.0,-40.0,-44.0,-51.0,-51.0,-40.0,-89.0,-90.0,-86.0,-87.0,45.0,38.0,34.0,47.0,1
3451,92:69:1D:31:68:E9,3838918,487310184,3910,3623219,3835008,483686965,0,4737,1099144,4596,1067244,141,31900,2113,10,4108,84,0,42,216660.0,130000.0,-52.0,-47.0,-42.0,-49.0,-51.0,-47.0,-43.0,-48.0,-89.0,-90.0,-86.0,-87.0,37.0,43.0,44.0,38.0,1
3452,CC:2F:71:3F:1F:24,4589056,1285999486,754048,802312521,3835008,483686965,37,604516,620235367,603800,620149211,716,86156,583515,15,754304,85009,34,502,130000.0,43333.0,-71.0,-67.0,-69.0,-73.0,-71.0,-66.0,-69.0,-72.0,-89.0,-90.0,-86.0,-87.0,18.0,23.0,17.0,14.0,1
3453,CC:2F:71:3E:C5:1F,3835877,483793296,869,106331,3835008,483686965,0,3622,304319,2989,229181,633,75138,919,8,1249,19,0,37,144444.0,43333.0,-70.0,-71.0,-68.0,-60.0,-70.0,-71.0,-68.0,-60.0,-89.0,-90.0,-86.0,-87.0,19.0,19.0,18.0,27.0,1
3454,BA:8C:B9:54:50:24,3839838,489869146,4830,6182181,3835008,483686965,0,8963,1697287,8941,1693792,22,3495,2348,15,5263,39,0,56,229410.0,137640.0,-48.0,-35.0,-43.0,-46.0,-43.0,-35.0,-43.0,-46.0,-89.0,-90.0,-86.0,-87.0,41.0,55.0,43.0,41.0,1
3455,62:47:05:9D:EB:15,3835052,483696542,39,9111,3835013,483687431,0,67,9709,57,7681,10,2028,37,0,52,0,0,4,216660.0,130000.0,-55.0,-52.0,-50.0,-56.0,-54.0,-51.0,-49.0,-59.0,-89.0,-90.0,-86.0,-87.0,34.0,38.0,36.0,31.0,1
3456,3C:55:76:E8:8F:1F,3855358,532017553,20345,48330122,3835013,483687431,8,10988,2949012,10759,2906104,229,42908,5551,16,20363,2066,8,116,162500.0,48750.0,-44.0,-52.0,-52.0,-40.0,-44.0,-51.0,-51.0,-40.0,-89.0,-90.0,-86.0,-87.0,45.0,38.0,34.0,47.0,1
3457,92:69:1D:31:68:E9,3838923,487310650,3910,3623219,3835013,483687431,0,4737,1099144,4596,1067244,141,31900,2113,10,4108,84,0,42,216660.0,130000.0,-52.0,-47.0,-42.0,-49.0,-51.0,-47.0,-43.0,-48.0,-89.0,-90.0,-86.0,-87.0,37.0,43.0,44.0,38.0,1
3458,CC:2F:71:3F:1F:24,4589726,1286833851,754713,803146420,3835013,483687431,37,604914,620532220,604198,620446064,716,86156,583900,15,754969,85073,34,502,130000.0,43333.0,-72.0,-67.0,-70.0,-73.0,-72.0,-67.0,-69.0,-73.0,-89.0,-90.0,-86.0,-87.0,17.0,23.0,16.0,14.0,1
3459,CC:2F:71:3E:C5:1F,3835882,483793762,869,106331,3835013,483687431,0,3622,304319,2989,229181,633,75138,919,8,1249,19,0,37,144444.0,43333.0,-70.0,-71.0,-68.0,-60.0,-70.0,-71.0,-68.0,-60.0,-89.0,-90.0,-86.0,-87.0,19.0,19.0,18.0,27.0,1
3460,BA:8C:B9:54:50:24,3839846,489869874,4830,6182181,3835016,483687693,0,8963,1697287,8941,1693792,22,3495,2348,15,5263,39,0,56,229410.0,137640.0,-48.0,-35.0,-43.0,-46.0,-43.0,-35.0,-43.0,-46.0,-89.0,-90.0,-86.0,-87.0,41.0,55.0,43.0,41.0,1
3461,62:47:05:9D:EB:15,3835059,483697341,39,9111,3835020,483688230,0,67,9709,57,7681,10,2028,37,0,52,0,0,4,216660.0,130000.0,-55.0,-52.0,-50.0,-56.0,-54.0,-51.0,-49.0,-59.0,-89.0,-90.0,-86.0,-87.0,34.0,38.0,36.0,31.0,1
3462,3C:55:76:E8:8F:1F,3855370,532019230,20348,48330798,3835022,483688432,8,11007,2953516,10777,2910490,230,43026,5555,16,20366,2066,8,117,162500.0,1000.0,-44.0,-52.0,-52.0,-41.0,-43.0,-52.0,-52.0,-40.0,-89.0,-90.0,-86.0,-87.0,45.0,38.0,34.0,46.0,1
3463,92:69:1D:31:68:E9,3838932,487311651,3910,3623219,3835022,483688432,0,4737,1099144,4596,1067244,141,31900,2113,10,4108,84,0,42,216660.0,130000.0,-52.0,-47.0,-42.0,-49.0,-51.0,-47.0,-43.0,-48.0,-89.0,-90.0,-86.0,-87.0,37.0,43.0,44.0,38.0,1
3464,CC:2F:71:3F:1F:24,4590450,1287787691,755428,804099259,3835022,483688432,37,605341,620863014,604625,620776858,716,86156,584304,15,755684,85229,34,503,130000.0,43333.0,-71.0,-67.0,-69.0,-73.0,-71.0,-66.0,-69.0,-73.0,-89.0,-90.0,-86.0,-87.0,18.0,23.0,17.0,14.0,1
3465,CC:2F:71:3E:C5:1F,3835893,483794965,869,106331,3835024,483688634,0,3622,304319,2989,229181,633,75138,919,8,1249,19,0,37,144444.0,43333.0,-70.0,-71.0,-68.0,-60.0,-70.0,-71.0,-68.0,-60.0,-89.0,-90.0,-86.0,-87.0,19.0,19.0,18.0,27.0,1
3466,BA:8C:B9:54:50:24,3839854,489870815,4830,6182181,3835024,483688634,0,8964,1697355,8942,1693860,22,3495,2348,15,5263,39,0,56,229410.0,137640.0,-40.0,-36.0,-45.0,-51.0,-43.0,-35.0,-43.0,-46.0,-89.0,-90.0,-86.0,-87.0,49.0,54.0,41.0,36.0,1
3467,62:47:05:9D:EB:15,3835065,483697947,39,9111,3835026,483688836,0,67,9709,57,7681,10,2028,37,0,52,0,0,4,216660.0,130000.0,-55.0,-52.0,-50.0,-56.0,-54.0,-51.0,-49.0,-59.0,-88.0,-90.0,-86.0,-87.0,33.0,38.0,36.0,31.0,1
3468,3C:55:76:E8:8F:1F,3855376,532019868,20350,48331032,3835026,483688836,8,11010,2953853,10780,2910827,230,43026,5557,16,20368,2066,8,117,162500.0,48750.0,-45.0,-50.0,-45.0,-41.0,-44.0,-50.0,-48.0,-40.0,-88.0,-90.0,-86.0,-87.0,43.0,40.0,41.0,46.0,1
3469,92:69:1D:31:68:E9,3838938,487312257,3910,3623219,3835028,483689038,0,4737,1099144,4596,1067244,141,31900,2113,10,4108,84,0,42,216660.0,130000.0,-52.0,-47.0,-42.0,-49.0,-51.0,-47.0,-43.0,-48.0,-88.0,-90.0,-86.0,-87.0,36.0,43.0,44.0,38.0,1
3470,CC:2F:71:3F:1F:24,4590752,1288144274,755724,804455236,3835028,483689038,37,605586,621129908,604870,621043752,716,86156,584539,15,755980,85342,34,503,104000.0,26000.0,-71.0,-67.0,-69.0,-72.0,-71.0,-66.0,-68.0,-73.0,-88.0,-90.0,-86.0,-87.0,17.0,23.0,17.0,15.0,1
3471,CC:2F:71:3E:C5:1F,3835897,483795369,869,106331,3835028,483689038,0,3622,304319,2989,229181,633,75138,919,8,1249,19,0,37,144444.0,43333.0,-70.0,-71.0,-68.0,-60.0,-70.0,-71.0,-68.0,-60.0,-88.0,-90.0,-86.0,-87.0,18.0,19.0,18.0,27.0,1
3472,BA:8C:B9:54:50:24,3839858,489871219,4830,6182181,3835028,483689038,0,8964,1697355,8942,1693860,22,3495,2348,15,5263,39,0,56,229410.0,137640.0,-40.0,-36.0,-45.0,-51.0,-43.0,-35.0,-43.0,-46.0,-88.0,-90.0,-86.0,-87.0,48.0,54.0,41.0,36.0,1
3473,62:47:05:9D:EB:15,3835080,483701523,39,9111,3835041,483692412,0,67,9709,57,7681,10,2028,37,0,52,0,0,4,216660.0,130000.0,-55.0,-52.0,-50.0,-56.0,-54.0,-51.0,-49.0,-59.0,-88.0,-90.0,-86.0,-87.0,33.0,38.0,36.0,31.0,1
3474,3C:55:76:E8:8F:1F,3855393,532023814,20352,48331402,3835041,483692412,8,11032,2955543,10802,2912517,230,43026,5560,16,20370,2066,8,118,162500.0,48750.0,-48.0,-49.0,-43.0,-43.0,-47.0,-48.0,-42.0,-42.0,-88.0,-90.0,-86.0,-87.0,40.0,41.0,43.0,44.0,1
3475,92:69:1D:31:68:E9,3838951,487315631,3910,3623219,3835041,483692412,0,4737,1099144,4596,1067244,141,31900,2113,10,4108,84,0,42,216660.0,130000.0,-52.0,-47.0,-42.0,-49.0,-51.0,-47.0,-43.0,-48.0,-88.0,-90.0,-86.0,-87.0,36.0,43.0,44.0,38.0,1
3476,CC:2F:71:3F:1F:24,4590973,1288410544,755932,804718132,3835041,483692412,37,605780,621389542,605064,621303386,716,86156,584722,15,756188,85348,34,503,115556.0,28889.0,-70.0,-66.0,-69.0,-74.0,-70.0,-66.0,-68.0,-73.0,-88.0,-90.0,-86.0,-87.0,18.0,24.0,17.0,13.0,1
3477,CC:2F:71:3E:C5:1F,3835910,483798743,869,106331,3835041,483692412,0,3622,304319,2989,229181,633,75138,919,8,1249,19,0,37,144444.0,43333.0,-70.0,-71.0,-68.0,-60.0,-70.0,-71.0,-68.0,-60.0,-88.0,-90.0,-86.0,-87.0,18.0,19.0,18.0,27.0,1
3478,BA:8C:B9:54:50:24,3839871,489874593,4830,6182181,3835041,483692412,0,8964,1697355,8942,1693860,22,3495,2348,15,5263,39,0,56,229410.0,137640.0,-40.0,-36.0,-45.0,-51.0,-43.0,-35.0,-43.0,-46.0,-88.0,-90.0,-86.0,-87.0,48.0,54.0,41.0,36.0,1
3479,62:47:05:9D:EB:15,3835084,483701927,39,9111,3835045,483692816,0,67,9709,57,7681,10,2028,37,0,52,0,0,4,216660.0,130000.0,-55.0,-52.0,-50.0,-56.0,-54.0,-51.0,-49.0,-59.0,-88.0,-90.0,-86.0,-87.0,33.0,38.0,36.0,31.0,1
3480,3C:55:76:E8:8F:1F,3855505,532307766,20460,48614950,3835045,483692816,8,11044,2959388,10814,2916362,230,43026,5565,16,20446,2066,8,118,162500.0,48750.0,-46.0,-56.0,-44.0,-42.0,-46.0,-53.0,-46.0,-40.0,-88.0,-90.0,-86.0,-87.0,42.0,34.0,42.0,45.0,1
3481,92:69:1D:31:68:E9,3838955,487316035,3910,3623219,3835045,483692816,0,4737,1099144,4596,1067244,141,31900,2113,10,4108,84,0,42,216660.0,130000.0,-52.0,-47.0,-42.0,-49.0,-51.0,-47.0,-43.0,-48.0,-88.0,-90.0,-86.0,-87.0,36.0,43.0,44.0,38.0,1
3482,CC:2F:71:3F:1F:24,4591193,1288686180,756148,804993364,3835045,483692816,37,605982,621661450,605266,621575294,716,86156,584914,15,756404,85353,34,503,130000.0,39000.0,-71.0,-67.0,-70.0,-72.0,-71.0,-67.0,-69.0,-72.0,-88.0,-90.0,-86.0,-87.0,17.0,23.0,16.0,15.0,1
3483,CC:2F:71:3E:C5:1F,3835914,483799147,869,106331,3835045,483692816,0,3622,304319,2989,229181,633,75138,919,8,1249,19,0,37,144444.0,43333.0,-70.0,-71.0,-68.0,-60.0,-70.0,-71.0,-68.0,-60.0,-88.0,-90.0,-86.0,-87.0,18.0,19.0,18.0,27.0,1
3484,BA:8C:B9:54:50:24,3839875,489874997,4830,6182181,3835045,483692816,0,8964,1697355,8942,1693860,22,3495,2348,15,5263,39,0,56,229410.0,137640.0,-40.0,-36.0,-45.0,-51.0,-43.0,-35.0,-43.0,-46.0,-88.0,-90.0,-86.0,-87.0,48.0,54.0,41.0,36.0,1
3485,62:47:05:9D:EB:15,3835089,483702391,39,9111,3835050,483693280,0,67,9709,57,7681,10,2028,37,0,52,0,0,4,216660.0,130000.0,-55.0,-52.0,-50.0,-56.0,-54.0,-51.0,-49.0,-59.0,-88.0,-90.0,-86.0,-87.0,33.0,38.0,36.0,31.0,1
3486,3C:55:76:E8:8F:1F,3855626,532606121,20576,48912841,3835050,483693280,8,11117,2971361,10887,2928335,230,43026,5596,16,20594,2068,8,118,146250.0,48750.0,-47.0,-54.0,-51.0,-40.0,-47.0,-54.0,-50.0,-38.0,-88.0,-90.0,-86.0,-86.0,41.0,36.0,35.0,46.0,1
3487,92:69:1D:31:68:E9,3838960,487316499,3910,3623219,3835050,483693280,0,4737,1099144,4596,1067244,141,31900,2113,10,4108,84,0,42,216660.0,130000.0,-52.0,-47.0,-42.0,-49.0,-51.0,-47.0,-43.0,-48.0,-88.0,-90.0,-86.0,-86.0,36.0,43.0,44.0,37.0,1
3488,CC:2F:71:3F:1F:24,4591417,1288953463,756366,805260121,3835051,483693342,37,606188,621925674,605472,621839518,716,86156,585110,15,756622,85363,34,503,144444.0,43333.0,-71.0,-67.0,-70.0,-72.0,-71.0,-66.0,-70.0,-72.0,-88.0,-90.0,-86.0,-86.0,17.0,23.0,16.0,14.0,1
3489,CC:2F:71:3E:C5:1F,3835922,483799849,871,106507,3835051,483693342,0,3627,304741,2994,229603,633,75138,921,8,1251,19,0,38,144444.0,43333.0,-71.0,-72.0,-69.0,-60.0,-71.0,-72.0,-69.0,-61.0,-88.0,-90.0,-86.0,-86.0,17.0,18.0,17.0,26.0,1
3490,BA:8C:B9:54:50:24,3839881,489875523,4830,6182181,3835051,483693342,0,8964,1697355,8942,1693860,22,3495,2348,15,5263,39,0,56,229410.0,137640.0,-40.0,-36.0,-45.0,-51.0,-43.0,-35.0,-43.0,-46.0,-88.0,-90.0,-86.0,-86.0,48.0,54.0,41.0,35.0,1
3491,62:47:05:9D:EB:15,3835094,483702857,39,9111,3835055,483693746,0,67,9709,57,7681,10,2028,37,0,52,0,0,4,216660.0,130000.0,-55.0,-52.0,-50.0,-56.0,-54.0,-51.0,-49.0,-59.0,-88.0,-90.0,-86.0,-86.0,33.0,38.0,36.0,30.0,1
3492,3C:55:76:E8:8F:1F,3855634,532607247,20579,48913501,3835055,483693746,8,11138,2973282,10907,2930138,231,43144,5602,16,20597,2068,8,118,146250.0,48750.0,-47.0,-56.0,-52.0,-40.0,-46.0,-56.0,-52.0,-39.0,-88.0,-90.0,-86.0,-86.0,41.0,34.0,34.0,46.0,1
3493,92:69:1D:31:68:E9,3838965,487316965,3910,3623219,3835055,483693746,0,4737,1099144,4596,1067244,141,31900,2113,10,4108,84,0,42,216660.0,130000.0,-52.0,-47.0,-42.0,-49.0,-51.0,-47.0,-43.0,-48.0,-88.0,-90.0,-86.0,-86.0,36.0,43.0,44.0,37.0,1
3494,CC:2F:71:3F:1F:24,4591633,1289219963,756578,805526217,3835055,483693746,37,606384,622184016,605668,622097860,716,86156,585299,15,756834,85377,34,505,130000.0,43333.0,-72.0,-67.0,-71.0,-73.0,-71.0,-67.0,-70.0,-73.0,-88.0,-90.0,-86.0,-86.0,16.0,23.0,15.0,13.0,1
3495,CC:2F:71:3E:C5:1F,3835926,483800253,871,106507,3835055,483693746,0,3627,304741,2994,229603,633,75138,921,8,1251,19,0,38,144444.0,43333.0,-71.0,-72.0,-69.0,-60.0,-71.0,-72.0,-69.0,-61.0,-88.0,-90.0,-86.0,-86.0,17.0,18.0,17.0,26.0,1
3496,BA:8C:B9:54:50:24,3839887,489876129,4830,6182181,3835057,483693948,0,8964,1697355,8942,1693860,22,3495,2348,15,5263,39,0,56,229410.0,137640.0,-40.0,-36.0,-45.0,-51.0,-43.0,-35.0,-43.0,-46.0,-88.0,-90.0,-86.0,-86.0,48.0,54.0,41.0,35.0,1
3497,62:47:05:9D:EB:15,3835099,483703321,39,9111,3835060,483694210,0,69,9845,59,7817,10,2028,37,0,53,0,0,4,216660.0,130000.0,-56.0,-51.0,-50.0,-63.0,-55.0,-51.0,-49.0,-59.0,-88.0,-90.0,-86.0,-86.0,32.0,39.0,36.0,23.0,1
3498,3C:55:76:E8:8F:1F,3855951,533469733,20891,49775523,3835060,483694210,8,11207,3002362,10976,2959218,231,43144,5636,16,20848,2068,8,118,154850.0,48750.0,-46.0,-56.0,-52.0,-40.0,-45.0,-54.0,-50.0,-40.0,-88.0,-90.0,-86.0,-86.0,42.0,34.0,34.0,46.0,1
3499,92:69:1D:31:68:E9,3838973,487317693,3910,3623219,3835063,483694474,0,4739,1099280,4598,1067380,141,31900,2113,10,4109,84,0,42,216660.0,130000.0,-51.0,-47.0,-42.0,-49.0,-51.0,-47.0,-43.0,-48.0,-88.0,-90.0,-86.0,-86.0,37.0,43.0,44.0,37.0,1
3500,CC:2F:71:3F:1F:24,4591882,1289533501,756819,805839027,3835063,483694474,37,606617,622503906,605901,622417750,716,86156,585516,15,757075,85380,34,505,130000.0,39000.0,-70.0,-67.0,-70.0,-72.0,-70.0,-67.0,-70.0,-72.0,-88.0,-90.0,-86.0,-86.0,18.0,23.0,16.0,14.0,1
3501,CC:2F:71:3E:C5:1F,3835936,483801183,871,106507,3835065,483694676,0,3629,304929,2995,229673,634,75256,922,8,1251,19,0,38,144444.0,43333.0,-71.0,-72.0,-69.0,-60.0,-72.0,-73.0,-69.0,-61.0,-88.0,-90.0,-86.0,-86.0,17.0,18.0,17.0,26.0,1
3502,BA:8C:B9:54:50:24,3839895,489876857,4830,6182181,3835065,483694676,0,8966,1697491,8944,1693996,22,3495,2348,15,5264,39,0,56,229410.0,137640.0,-40.0,-36.0,-46.0,-52.0,-41.0,-35.0,-44.0,-48.0,-88.0,-90.0,-86.0,-86.0,48.0,54.0,40.0,34.0,1
3503,62:47:05:9D:EB:15,3835108,483704191,39,9111,3835069,483695080,0,69,9845,59,7817,10,2028,37,0,53,0,0,4,216660.0,130000.0,-56.0,-51.0,-50.0,-63.0,-55.0,-51.0,-49.0,-59.0,-88.0,-90.0,-86.0,-86.0,32.0,39.0,36.0,23.0,1
3504,3C:55:76:E8:8F:1F,3856933,536358127,21864,52663047,3835069,483695080,8,11528,3050596,11297,3007452,231,43144,5761,16,21869,2081,8,118,172050.0,51610.0,-50.0,-55.0,-46.0,-45.0,-48.0,-55.0,-47.0,-43.0,-88.0,-90.0,-86.0,-86.0,38.0,35.0,40.0,41.0,1
3505,92:69:1D:31:68:E9,3838979,487318299,3910,3623219,3835069,483695080,0,4739,1099280,4598,1067380,141,31900,2113,10,4109,84,0,42,216660.0,130000.0,-51.0,-47.0,-42.0,-49.0,-51.0,-47.0,-43.0,-48.0,-88.0,-90.0,-86.0,-86.0,37.0,43.0,44.0,37.0,1
3506,CC:2F:71:3F:1F:24,4592124,1289819047,757055,806123967,3835069,483695080,37,606838,622780592,606122,622694436,716,86156,585729,15,757311,85433,34,506,130000.0,39000.0,-71.0,-67.0,-69.0,-73.0,-71.0,-66.0,-69.0,-72.0,-88.0,-90.0,-86.0,-86.0,17.0,23.0,17.0,13.0,1
3507,CC:2F:71:3E:C5:1F,3835941,483801649,871,106507,3835070,483695142,0,3629,304929,2995,229673,634,75256,922,8,1251,19,0,38,144444.0,43333.0,-71.0,-72.0,-69.0,-60.0,-72.0,-73.0,-69.0,-61.0,-88.0,-90.0,-86.0,-86.0,17.0,18.0,17.0,26.0,1
3508,BA:8C:B9:54:50:24,3839900,489877323,4830,6182181,3835070,483695142,0,8966,1697491,8944,1693996,22,3495,2348,15,5264,39,0,56,229410.0,137640.0,-40.0,-36.0,-46.0,-52.0,-41.0,-35.0,-44.0,-48.0,-88.0,-90.0,-86.0,-86.0,48.0,54.0,40.0,34.0,1
3509,62:47:05:9D:EB:15,3835114,483704717,39,9111,3835075,483695606,0,69,9845,59,7817,10,2028,37,0,53,0,0,4,216660.0,130000.0,-56.0,-51.0,-50.0,-63.0,-55.0,-51.0,-49.0,-59.0,-88.0,-90.0,-86.0,-86.0,32.0,39.0,36.0,23.0,1
3510,3C:55:76:E8:8F:1F,3857499,538014050,22424,54318444,3835075,483695606,8,11700,3090270,11469,3047126,231,43144,5873,16,22442,2083,8,119,162500.0,48750.0,-50.0,-55.0,-46.0,-45.0,-49.0,-55.0,-47.0,-44.0,-88.0,-90.0,-86.0,-86.0,38.0,35.0,40.0,41.0,1
3511,92:69:1D:31:68:E9,3838985,487318825,3910,3623219,3835075,483695606,0,4739,1099280,4598,1067380,141,31900,2113,10,4109,84,0,42,216660.0,130000.0,-51.0,-47.0,-42.0,-49.0,-51.0,-47.0,-43.0,-48.0,-88.0,-90.0,-86.0,-86.0,37.0,43.0,44.0,37.0,1
3512,CC:2F:71:3F:1F:24,4592362,1290119965,757287,806424359,3835075,483695606,37,607058,623074494,606341,622988220,717,86274,585941,15,757543,85439,34,506,130000.0,43333.0,-70.0,-67.0,-70.0,-72.0,-70.0,-66.0,-69.0,-72.0,-88.0,-90.0,-86.0,-86.0,18.0,23.0,16.0,14.0,1
3513,CC:2F:71:3E:C5:1F,3835946,483802113,871,106507,3835075,483695606,0,3629,304929,2995,229673,634,75256,922,8,1251,19,0,38,144444.0,43333.0,-71.0,-72.0,-69.0,-60.0,-72.0,-73.0,-69.0,-61.0,-88.0,-90.0,-86.0,-86.0,17.0,18.0,17.0,26.0,1
3514,BA:8C:B9:54:50:24,3839905,489877787,4830,6182181,3835075,483695606,0,8966,1697491,8944,1693996,22,3495,2348,15,5264,39,0,56,229410.0,137640.0,-40.0,-36.0,-46.0,-52.0,-41.0,-35.0,-44.0,-48.0,-88.0,-90.0,-86.0,-86.0,48.0,54.0,40.0,34.0,1
3515,62:47:05:9D:EB:15,3835118,483705121,39,9111,3835079,483696010,0,69,9845,59,7817,10,2028,37,0,53,0,0,4,216660.0,130000.0,-56.0,-51.0,-50.0,-63.0,-55.0,-51.0,-49.0,-59.0,-88.0,-90.0,-86.0,-86.0,32.0,39.0,36.0,23.0,1
3516,3C:55:76:E8:8F:1F,3857863,539101768,22784,55405758,3835079,483696010,8,11810,3117999,11579,3074855,231,43144,5944,16,22800,2096,8,119,195000.0,97500.0,-50.0,-56.0,-46.0,-46.0,-49.0,-55.0,-47.0,-44.0,-88.0,-90.0,-86.0,-86.0,38.0,34.0,40.0,40.0,1
3517,92:69:1D:31:68:E9,3838989,487319229,3910,3623219,3835079,483696010,0,4739,1099280,4598,1067380,141,31900,2113,10,4109,84,0,42,216660.0,130000.0,-51.0,-47.0,-42.0,-49.0,-51.0,-47.0,-43.0,-48.0,-88.0,-90.0,-86.0,-86.0,37.0,43.0,44.0,37.0,1
3518,CC:2F:71:3F:1F:24,4592577,1290388871,757498,806692861,3835079,483696010,37,607261,623345158,606544,623258884,717,86274,586133,15,757754,85468,34,506,130000.0,43333.0,-72.0,-67.0,-70.0,-74.0,-71.0,-67.0,-69.0,-73.0,-88.0,-90.0,-86.0,-86.0,16.0,23.0,16.0,12.0,1
3519,CC:2F:71:3E:C5:1F,3835950,483802517,871,106507,3835079,483696010,0,3629,304929,2995,229673,634,75256,922,8,1251,19,0,38,144444.0,43333.0,-71.0,-72.0,-69.0,-60.0,-72.0,-73.0,-69.0,-61.0,-88.0,-90.0,-86.0,-86.0,17.0,18.0,17.0,26.0,1
3520,BA:8C:B9:54:50:24,3839911,489878393,4830,6182181,3835081,483696212,0,8966,1697491,8944,1693996,22,3495,2348,15,5264,39,0,56,229410.0,137640.0,-40.0,-36.0,-46.0,-52.0,-41.0,-35.0,-44.0,-48.0,-88.0,-90.0,-86.0,-86.0,48.0,54.0,40.0,34.0,1
3521,62:47:05:9D:EB:15,3835122,483705525,39,9111,3835083,483696414,0,69,9845,59,7817,10,2028,37,0,53,0,0,4,216660.0,130000.0,-56.0,-51.0,-50.0,-63.0,-55.0,-51.0,-49.0,-59.0,-88.0,-90.0,-86.0,-86.0,32.0,39.0,36.0,23.0,1
3522,3C:55:76:E8:8F:1F,3858124,539877382,23041,56180968,3835083,483696414,8,11894,3132661,11663,3089517,231,43144,6002,16,23059,2096,8,119,216660.0,1000.0,-46.0,-56.0,-52.0,-40.0,-45.0,-55.0,-51.0,-40.0,-88.0,-90.0,-86.0,-86.0,42.0,34.0,34.0,46.0,1
3523,92:69:1D:31:68:E9,3838998,487320097,3910,3623219,3835088,483696878,0,4739,1099280,4598,1067380,141,31900,2113,10,4109,84,0,42,216660.0,130000.0,-51.0,-47.0,-42.0,-49.0,-51.0,-47.0,-43.0,-48.0,-88.0,-90.0,-86.0,-86.0,37.0,43.0,44.0,37.0,1
3524,CC:2F:71:3F:1F:24,4592810,1290674939,757722,806978061,3835088,483696878,37,607465,623614598,606748,623528324,717,86274,586330,15,757978,85470,34,506,130000.0,43333.0,-71.0,-67.0,-70.0,-72.0,-70.0,-66.0,-69.0,-72.0,-88.0,-90.0,-86.0,-86.0,17.0,23.0,16.0,14.0,1
3525,CC:2F:71:3E:C5:1F,3835959,483803385,871,106507,3835088,483696878,0,3629,304929,2995,229673,634,75256,922,8,1251,19,0,38,144444.0,43333.0,-71.0,-72.0,-69.0,-60.0,-72.0,-73.0,-69.0,-61.0,-88.0,-90.0,-86.0,-86.0,17.0,18.0,17.0,26.0,1
3526,BA:8C:B9:54:50:24,3839919,489879332,4830,6182181,3835089,483697151,0,8966,1697491,8944,1693996,22,3495,2348,15,5264,39,0,56,229410.0,137640.0,-40.0,-36.0,-46.0,-52.0,-41.0,-35.0,-44.0,-48.0,-88.0,-90.0,-86.0,-86.0,48.0,54.0,40.0,34.0,1
3527,62:47:05:9D:EB:15,3835128,483706262,39,9111,3835089,483697151,0,69,9845,59,7817,10,2028,37,0,53,0,0,4,216660.0,130000.0,-56.0,-51.0,-50.0,-63.0,-55.0,-51.0,-49.0,-59.0,-88.0,-90.0,-86.0,-86.0,32.0,39.0,36.0,23.0,1
3528,3C:55:76:E8:8F:1F,3858136,539878882,23045,56181529,3835091,483697353,8,11910,3135043,11679,3091899,231,43144,6006,17,23064,2102,8,119,195000.0,1000.0,-48.0,-54.0,-43.0,-45.0,-47.0,-53.0,-43.0,-43.0,-88.0,-90.0,-86.0,-86.0,40.0,36.0,43.0,41.0,1
3529,92:69:1D:31:68:E9,3839001,487320572,3910,3623219,3835091,483697353,0,4739,1099280,4598,1067380,141,31900,2113,10,4109,84,0,42,216660.0,130000.0,-51.0,-47.0,-42.0,-49.0,-51.0,-47.0,-43.0,-48.0,-88.0,-90.0,-86.0,-86.0,37.0,43.0,44.0,37.0,1
3530,CC:2F:71:3F:1F:24,4593039,1290955113,757946,807257558,3835093,483697555,37,607675,623887856,606958,623801582,717,86274,586532,15,758202,85482,34,506,130000.0,43333.0,-70.0,-66.0,-70.0,-71.0,-70.0,-66.0,-69.0,-72.0,-88.0,-90.0,-86.0,-86.0,18.0,24.0,16.0,15.0,1
3531,CC:2F:71:3E:C5:1F,3835964,483804062,871,106507,3835093,483697555,0,3629,304929,2995,229673,634,75256,922,8,1251,19,0,38,144444.0,43333.0,-71.0,-72.0,-69.0,-60.0,-72.0,-73.0,-69.0,-61.0,-88.0,-90.0,-86.0,-86.0,17.0,18.0,17.0,26.0,1
3532,BA:8C:B9:54:50:24,3839923,489879736,4830,6182181,3835093,483697555,0,8966,1697491,8944,1693996,22,3495,2348,15,5264,39,0,56,229410.0,137640.0,-40.0,-36.0,-46.0,-52.0,-41.0,-35.0,-44.0,-48.0,-88.0,-90.0,-86.0,-86.0,48.0,54.0,40.0,34.0,1
3533,62:47:05:9D:EB:15,3835136,483707070,39,9111,3835097,483697959,0,69,9845,59,7817,10,2028,37,0,53,0,0,4,216660.0,130000.0,-56.0,-51.0,-50.0,-63.0,-55.0,-51.0,-49.0,-59.0,-88.0,-90.0,-86.0,-86.0,32.0,39.0,36.0,23.0,1
3534,3C:55:76:E8:8F:1F,3858176,539961978,23079,56264019,3835097,483697959,8,11936,3143866,11705,3100722,231,43144,6019,17,23098,2102,8,120,195000.0,97500.0,-44.0,-53.0,-51.0,-38.0,-45.0,-53.0,-49.0,-40.0,-88.0,-90.0,-86.0,-86.0,44.0,37.0,35.0,48.0,1
3535,92:69:1D:31:68:E9,3839007,487321178,3910,3623219,3835097,483697959,0,4739,1099280,4598,1067380,141,31900,2113,10,4109,84,0,42,216660.0,130000.0,-51.0,-47.0,-42.0,-49.0,-51.0,-47.0,-43.0,-48.0,-88.0,-90.0,-86.0,-86.0,37.0,43.0,44.0,37.0,1
3536,CC:2F:71:3F:1F:24,4593252,1291218655,758155,807520696,3835097,483697959,37,607864,624139564,607147,624053290,717,86274,586717,15,758411,85485,34,506,130000.0,43333.0,-71.0,-66.0,-69.0,-73.0,-71.0,-66.0,-69.0,-72.0,-88.0,-90.0,-86.0,-86.0,17.0,24.0,17.0,13.0,1
3537,CC:2F:71:3E:C5:1F,3835968,483804466,871,106507,3835097,483697959,0,3629,304929,2995,229673,634,75256,922,8,1251,19,0,38,144444.0,43333.0,-71.0,-72.0,-69.0,-60.0,-72.0,-73.0,-69.0,-61.0,-88.0,-90.0,-86.0,-86.0,17.0,18.0,17.0,26.0,1
3538,BA:8C:B9:54:50:24,3839927,489880140,4830,6182181,3835097,483697959,0,8966,1697491,8944,1693996,22,3495,2348,15,5264,39,0,56,229410.0,137640.0,-40.0,-36.0,-46.0,-52.0,-41.0,-35.0,-44.0,-48.0,-88.0,-90.0,-86.0,-86.0,48.0,54.0,40.0,34.0,1
3539,62:47:05:9D:EB:15,3835142,483707660,39,9111,3835103,483698549,0,69,9845,59,7817,10,2028,37,0,53,0,0,4,216660.0,130000.0,-56.0,-51.0,-50.0,-63.0,-55.0,-51.0,-49.0,-59.0,-88.0,-90.0,-86.0,-86.0,32.0,39.0,36.0,23.0,1
3540,3C:55:76:E8:8F:1F,3858896,541863190,23793,58164641,3835103,483698549,8,12118,3170759,11887,3127615,231,43144,6097,17,23812,2103,8,121,216660.0,130000.0,-47.0,-53.0,-42.0,-44.0,-48.0,-55.0,-45.0,-44.0,-88.0,-90.0,-86.0,-86.0,41.0,37.0,44.0,42.0,1
3541,92:69:1D:31:68:E9,3839013,487321768,3910,3623219,3835103,483698549,0,4739,1099280,4598,1067380,141,31900,2113,10,4109,84,0,42,216660.0,130000.0,-51.0,-47.0,-42.0,-49.0,-51.0,-47.0,-43.0,-48.0,-88.0,-90.0,-86.0,-86.0,37.0,43.0,44.0,37.0,1
3542,CC:2F:71:3F:1F:24,4593471,1291491223,758368,807792674,3835103,483698549,37,608067,624410366,607350,624324092,717,86274,586907,15,758624,85490,34,506,130000.0,43333.0,-71.0,-66.0,-70.0,-73.0,-71.0,-66.0,-69.0,-72.0,-88.0,-90.0,-86.0,-86.0,17.0,24.0,16.0,13.0,1
3543,CC:2F:71:3E:C5:1F,3835974,483805056,871,106507,3835103,483698549,0,3629,304929,2995,229673,634,75256,922,8,1251,19,0,38,144444.0,43333.0,-71.0,-72.0,-69.0,-60.0,-72.0,-73.0,-69.0,-61.0,-88.0,-90.0,-86.0,-86.0,17.0,18.0,17.0,26.0,1
3544,BA:8C:B9:54:50:24,3839933,489880730,4830,6182181,3835103,483698549,0,8966,1697491,8944,1693996,22,3495,2348,15,5264,39,0,56,229410.0,137640.0,-40.0,-36.0,-46.0,-52.0,-41.0,-35.0,-44.0,-48.0,-88.0,-90.0,-86.0,-86.0,48.0,54.0,40.0,34.0,1
3545,62:47:05:9D:EB:15,3835146,483708064,39,9111,3835107,483698953,0,69,9845,59,7817,10,2028,37,0,53,0,0,4,216660.0,130000.0,-56.0,-51.0,-50.0,-63.0,-55.0,-51.0,-49.0,-59.0,-88.0,-90.0,-86.0,-86.0,32.0,39.0,36.0,23.0,1
3546,3C:55:76:E8:8F:1F,3858902,541863914,23795,58164961,3835107,483698953,8,12142,3172635,11911,3129491,231,43144,6102,17,23814,2103,8,121,216660.0,130000.0,-48.0,-54.0,-43.0,-44.0,-47.0,-53.0,-43.0,-42.0,-88.0,-90.0,-86.0,-86.0,40.0,36.0,43.0,42.0,1
3547,92:69:1D:31:68:E9,3839017,487322172,3910,3623219,3835107,483698953,0,4739,1099280,4598,1067380,141,31900,2113,10,4109,84,0,42,216660.0,130000.0,-51.0,-47.0,-42.0,-49.0,-51.0,-47.0,-43.0,-48.0,-88.0,-90.0,-86.0,-86.0,37.0,43.0,44.0,37.0,1
3548,CC:2F:71:3F:1F:24,4593689,1291754904,758582,808055951,3835107,483698953,37,608276,624677965,607559,624591691,717,86274,587100,15,758838,85495,34,506,130000.0,43333.0,-70.0,-66.0,-69.0,-73.0,-70.0,-66.0,-69.0,-72.0,-88.0,-90.0,-86.0,-86.0,18.0,24.0,17.0,13.0,1
3549,CC:2F:71:3E:C5:1F,3835978,483805460,871,106507,3835107,483698953,0,3629,304929,2995,229673,634,75256,922,8,1251,19,0,38,144444.0,43333.0,-71.0,-72.0,-69.0,-60.0,-72.0,-73.0,-69.0,-61.0,-88.0,-90.0,-86.0,-86.0,17.0,18.0,17.0,26.0,1
3550,BA:8C:B9:54:50:24,3839937,489881134,4830,6182181,3835107,483698953,0,8966,1697491,8944,1693996,22,3495,2348,15,5264,39,0,56,229410.0,137640.0,-40.0,-36.0,-46.0,-52.0,-41.0,-35.0,-44.0,-48.0,-88.0,-90.0,-86.0,-86.0,48.0,54.0,40.0,34.0,1
3551,62:47:05:9D:EB:15,3835151,483708528,39,9111,3835112,483699417,0,69,9845,59,7817,10,2028,37,0,53,0,0,4,216660.0,130000.0,-56.0,-51.0,-50.0,-63.0,-55.0,-51.0,-49.0,-59.0,-88.0,-90.0,-86.0,-86.0,32.0,39.0,36.0,23.0,1
3552,3C:55:76:E8:8F:1F,3858907,541864378,23795,58164961,3835112,483699417,8,12153,3173389,11922,3130245,231,43144,6102,17,23814,2103,8,121,216660.0,130000.0,-46.0,-51.0,-41.0,-41.0,-47.0,-52.0,-42.0,-43.0,-88.0,-90.0,-86.0,-86.0,42.0,39.0,45.0,45.0,1
3553,92:69:1D:31:68:E9,3839022,487322636,3910,3623219,3835112,483699417,0,4739,1099280,4598,1067380,141,31900,2113,10,4109,84,0,42,216660.0,130000.0,-51.0,-47.0,-42.0,-49.0,-51.0,-47.0,-43.0,-48.0,-88.0,-90.0,-86.0,-86.0,37.0,43.0,44.0,37.0,1
3554,CC:2F:71:3F:1F:24,4593904,1292021316,758792,808321899,3835112,483699417,37,608470,624932195,607753,624845921,717,86274,587285,15,759048,85516,34,506,130000.0,39000.0,-73.0,-69.0,-72.0,-76.0,-72.0,-67.0,-70.0,-73.0,-88.0,-90.0,-86.0,-86.0,15.0,21.0,14.0,10.0,1
3555,CC:2F:71:3E:C5:1F,3835985,483806126,871,106507,3835114,483699619,0,3629,304929,2995,229673,634,75256,922,8,1251,19,0,38,144444.0,43333.0,-71.0,-72.0,-69.0,-60.0,-72.0,-73.0,-69.0,-61.0,-88.0,-90.0,-86.0,-86.0,17.0,18.0,17.0,26.0,1
3556,BA:8C:B9:54:50:24,3839944,489881800,4830,6182181,3835114,483699619,0,8966,1697491,8944,1693996,22,3495,2348,15,5264,39,0,56,229410.0,137640.0,-40.0,-36.0,-46.0,-52.0,-41.0,-35.0,-44.0,-48.0,-88.0,-90.0,-86.0,-86.0,48.0,54.0,40.0,34.0,1
3557,62:47:05:9D:EB:15,3835155,483708932,39,9111,3835116,483699821,0,69,9845,59,7817,10,2028,37,0,53,0,0,4,216660.0,130000.0,-56.0,-51.0,-50.0,-63.0,-55.0,-51.0,-49.0,-59.0,-88.0,-90.0,-86.0,-86.0,32.0,39.0,36.0,23.0,1
3558,3C:55:76:E8:8F:1F,3858914,541865300,23798,58165479,3835116,483699821,8,12174,3175057,11943,3131913,231,43144,6106,17,23817,2103,8,122,216660.0,130000.0,-47.0,-59.0,-47.0,-41.0,-45.0,-55.0,-49.0,-39.0,-88.0,-90.0,-86.0,-86.0,41.0,31.0,39.0,45.0,1
3559,92:69:1D:31:68:E9,3839026,487323040,3910,3623219,3835116,483699821,0,4739,1099280,4598,1067380,141,31900,2113,10,4109,84,0,42,216660.0,130000.0,-51.0,-47.0,-42.0,-49.0,-51.0,-47.0,-43.0,-48.0,-88.0,-90.0,-86.0,-86.0,37.0,43.0,44.0,37.0,1
3560,CC:2F:71:3F:1F:24,4594117,1292284564,759001,808584743,3835116,483699821,37,608668,625191033,607951,625104759,717,86274,587472,15,759257,85529,34,506,130000.0,43333.0,-71.0,-67.0,-70.0,-73.0,-71.0,-67.0,-70.0,-72.0,-88.0,-90.0,-86.0,-86.0,17.0,23.0,16.0,13.0,1
3561,CC:2F:71:3E:C5:1F,3835989,483806530,871,106507,3835118,483700023,0,3629,304929,2995,229673,634,75256,922,8,1251,19,0,38,144444.0,43333.0,-71.0,-72.0,-69.0,-60.0,-72.0,-73.0,-69.0,-61.0,-88.0,-90.0,-86.0,-86.0,17.0,18.0,17.0,26.0,1
3562,BA:8C:B9:54:50:24,3839948,489882204,4830,6182181,3835118,483700023,0,8966,1697491,8944,1693996,22,3495,2348,15,5264,39,0,56,229410.0,137640.0,-40.0,-36.0,-46.0,-52.0,-41.0,-35.0,-44.0,-48.0,-88.0,-90.0,-86.0,-86.0,48.0,54.0,40.0,34.0,1
3563,62:47:05:9D:EB:15,3835161,483709538,39,9111,3835122,483700427,0,69,9845,59,7817,10,2028,37,0,53,0,0,4,216660.0,130000.0,-56.0,-51.0,-50.0,-63.0,-55.0,-51.0,-49.0,-59.0,-88.0,-90.0,-86.0,-86.0,32.0,39.0,36.0,23.0,1
3564,3C:55:76:E8:8F:1F,3858921,541865966,23798,58165479,3835123,483700487,8,12190,3176177,11959,3133033,231,43144,6106,17,23817,2103,8,122,216660.0,130000.0,-44.0,-55.0,-51.0,-37.0,-45.0,-54.0,-45.0,-40.0,-88.0,-90.0,-86.0,-86.0,44.0,35.0,35.0,49.0,1
3565,92:69:1D:31:68:E9,3839033,487323706,3910,3623219,3835123,483700487,0,4740,1099348,4599,1067448,141,31900,2113,10,4109,84,0,43,216660.0,130000.0,-51.0,-47.0,-42.0,-49.0,-51.0,-47.0,-43.0,-48.0,-88.0,-90.0,-86.0,-86.0,37.0,43.0,44.0,37.0,1
3566,CC:2F:71:3F:1F:24,4594330,1292545130,759207,808844643,3835123,483700487,37,608864,625448053,608147,625361779,717,86274,587658,15,759463,85532,34,506,130000.0,43333.0,-71.0,-67.0,-70.0,-73.0,-71.0,-67.0,-70.0,-72.0,-88.0,-90.0,-86.0,-86.0,17.0,23.0,16.0,13.0,1
3567,CC:2F:71:3E:C5:1F,3835996,483807196,871,106507,3835125,483700689,0,3629,304929,2995,229673,634,75256,922,8,1251,19,0,38,144444.0,43333.0,-71.0,-72.0,-69.0,-60.0,-72.0,-73.0,-69.0,-61.0,-88.0,-90.0,-86.0,-86.0,17.0,18.0,17.0,26.0,1
3568,BA:8C:B9:54:50:24,3839955,489882870,4830,6182181,3835125,483700689,0,8966,1697491,8944,1693996,22,3495,2348,15,5264,39,0,56,229410.0,137640.0,-40.0,-36.0,-46.0,-52.0,-41.0,-35.0,-44.0,-48.0,-88.0,-90.0,-86.0,-86.0,48.0,54.0,40.0,34.0,1
3569,62:47:05:9D:EB:15,3835166,483710002,39,9111,3835127,483700891,0,69,9845,59,7817,10,2028,37,0,53,0,0,4,216660.0,130000.0,-56.0,-51.0,-50.0,-63.0,-55.0,-51.0,-49.0,-59.0,-88.0,-90.0,-86.0,-86.0,32.0,39.0,36.0,23.0,1
3570,3C:55:76:E8:8F:1F,3859346,542981555,24219,59280664,3835127,483700891,12,12254,3186167,12023,3143023,231,43144,6125,17,24206,2224,12,122,216660.0,1000.0,-45.0,-55.0,-53.0,-40.0,-46.0,-53.0,-44.0,-42.0,-88.0,-90.0,-86.0,-86.0,43.0,35.0,33.0,46.0,1
3571,92:69:1D:31:68:E9,3839037,487324110,3910,3623219,3835127,483700891,0,4740,1099348,4599,1067448,141,31900,2113,10,4109,84,0,43,216660.0,130000.0,-51.0,-47.0,-42.0,-49.0,-51.0,-47.0,-43.0,-48.0,-88.0,-90.0,-86.0,-86.0,37.0,43.0,44.0,37.0,1
3572,CC:2F:71:3F:1F:24,4594566,1292833653,759437,809132560,3835129,483701093,37,609082,625728168,608365,625641894,717,86274,587867,15,759693,85547,34,507,130000.0,43333.0,-71.0,-67.0,-70.0,-73.0,-71.0,-67.0,-69.0,-73.0,-88.0,-90.0,-86.0,-86.0,17.0,23.0,16.0,13.0,1
3573,CC:2F:71:3E:C5:1F,3836000,483807600,871,106507,3835129,483701093,0,3629,304929,2995,229673,634,75256,922,8,1251,19,0,38,144444.0,43333.0,-71.0,-72.0,-69.0,-60.0,-72.0,-73.0,-69.0,-61.0,-88.0,-90.0,-86.0,-86.0,17.0,18.0,17.0,26.0,1
3574,BA:8C:B9:54:50:24,3839959,489883274,4830,6182181,3835129,483701093,0,8966,1697491,8944,1693996,22,3495,2348,15,5264,39,0,56,229410.0,137640.0,-40.0,-36.0,-46.0,-52.0,-41.0,-35.0,-44.0,-48.0,-88.0,-90.0,-86.0,-86.0,48.0,54.0,40.0,34.0,1
3575,62:47:05:9D:EB:15,3835172,483710608,39,9111,3835133,483701497,0,69,9845,59,7817,10,2028,37,0,53,0,0,4,216660.0,130000.0,-56.0,-51.0,-50.0,-63.0,-55.0,-51.0,-49.0,-59.0,-88.0,-90.0,-86.0,-86.0,32.0,39.0,36.0,23.0,1
3576,3C:55:76:E8:8F:1F,3859570,543548826,24437,59847329,3835133,483701497,20,12412,3213160,12181,3170016,231,43144,6168,17,24457,2290,20,125,229410.0,130000.0,-46.0,-52.0,-41.0,-41.0,-44.0,-53.0,-48.0,-39.0,-88.0,-90.0,-86.0,-86.0,42.0,38.0,45.0,45.0,1
3577,92:69:1D:31:68:E9,3839044,487324776,3910,3623219,3835134,483701557,0,4740,1099348,4599,1067448,141,31900,2113,10,4109,84,0,43,216660.0,130000.0,-51.0,-47.0,-42.0,-49.0,-51.0,-47.0,-43.0,-48.0,-88.0,-90.0,-86.0,-86.0,37.0,43.0,44.0,37.0,1
3578,CC:2F:71:3F:1F:24,4594800,1293129759,759666,809428202,3835134,483701557,37,609292,626012414,608575,625926140,717,86274,588072,15,759922,85549,34,507,130000.0,43333.0,-71.0,-67.0,-70.0,-73.0,-71.0,-67.0,-69.0,-72.0,-88.0,-90.0,-86.0,-86.0,17.0,23.0,16.0,13.0,1
3579,CC:2F:71:3E:C5:1F,3836005,483808064,871,106507,3835134,483701557,0,3629,304929,2995,229673,634,75256,922,8,1251,19,0,38,144444.0,43333.0,-71.0,-72.0,-69.0,-60.0,-72.0,-73.0,-69.0,-61.0,-88.0,-90.0,-86.0,-86.0,17.0,18.0,17.0,26.0,1
3580,BA:8C:B9:54:50:24,3839964,489883738,4830,6182181,3835134,483701557,0,8966,1697491,8944,1693996,22,3495,2348,15,5264,39,0,56,229410.0,137640.0,-40.0,-36.0,-46.0,-52.0,-41.0,-35.0,-44.0,-48.0,-88.0,-90.0,-86.0,-86.0,48.0,54.0,40.0,34.0,1
3581,62:47:05:9D:EB:15,3835178,483711188,40,9227,3835138,483701961,0,70,9913,60,7885,10,2028,37,0,54,0,0,4,216660.0,130000.0,-51.0,-51.0,-51.0,-58.0,-54.0,-51.0,-49.0,-59.0,-88.0,-90.0,-86.0,-86.0,37.0,39.0,35.0,28.0,1
3582,3C:55:76:E8:8F:1F,3859576,543549406,24438,59847445,3835138,483701961,20,12426,3214140,12195,3170996,231,43144,6168,17,24458,2290,20,125,229410.0,130000.0,-46.0,-52.0,-41.0,-41.0,-45.0,-53.0,-45.0,-39.0,-88.0,-90.0,-86.0,-86.0,42.0,38.0,45.0,45.0,1
3583,92:69:1D:31:68:E9,3839049,487325240,3911,3623279,3835138,483701961,0,4742,1099484,4601,1067584,141,31900,2113,10,4110,84,0,43,216660.0,130000.0,-52.0,-47.0,-42.0,-49.0,-51.0,-47.0,-42.0,-48.0,-88.0,-90.0,-86.0,-86.0,36.0,43.0,44.0,37.0,1
3584,CC:2F:71:3F:1F:24,4595013,1293391347,759874,809689324,3835139,483702023,37,609486,626267748,608769,626181474,717,86274,588257,15,760130,85577,34,507,130000.0,43333.0,-71.0,-67.0,-70.0,-73.0,-71.0,-67.0,-70.0,-72.0,-88.0,-90.0,-86.0,-86.0,17.0,23.0,16.0,13.0,1
3585,CC:2F:71:3E:C5:1F,3836011,483808646,872,106623,3835139,483702023,0,3631,305069,2997,229813,634,75256,922,8,1252,19,0,38,130000.0,39000.0,-71.0,-72.0,-68.0,-61.0,-71.0,-72.0,-68.0,-60.0,-88.0,-90.0,-86.0,-86.0,17.0,18.0,18.0,25.0,1
3586,BA:8C:B9:54:50:24,3839972,489884466,4831,6182241,3835141,483702225,0,8968,1697627,8946,1694132,22,3495,2348,15,5265,39,0,56,216660.0,130000.0,-48.0,-35.0,-43.0,-46.0,-43.0,-35.0,-44.0,-47.0,-88.0,-90.0,-86.0,-86.0,40.0,55.0,43.0,40.0,1
3587,62:47:05:9D:EB:15,3835183,483711654,40,9227,3835143,483702427,0,71,9981,61,7953,10,2028,37,0,54,0,0,4,216660.0,130000.0,-50.0,-51.0,-52.0,-58.0,-54.0,-51.0,-49.0,-58.0,-88.0,-90.0,-86.0,-86.0,38.0,39.0,34.0,28.0,1
3588,3C:55:76:E8:8F:1F,3859598,543561649,24455,59859222,3835143,483702427,20,12480,3247327,12248,3204065,232,43262,6197,17,24475,2290,20,125,229410.0,137640.0,-44.0,-54.0,-52.0,-38.0,-45.0,-53.0,-46.0,-41.0,-88.0,-90.0,-86.0,-86.0,44.0,36.0,34.0,48.0,1
3589,92:69:1D:31:68:E9,3839054,487325706,3911,3623279,3835143,483702427,0,4742,1099484,4601,1067584,141,31900,2113,10,4110,84,0,43,216660.0,130000.0,-52.0,-47.0,-42.0,-49.0,-51.0,-47.0,-42.0,-48.0,-88.0,-90.0,-86.0,-86.0,36.0,43.0,44.0,37.0,1
3590,CC:2F:71:3F:1F:24,4595232,1293658230,760089,809955803,3835143,483702427,37,609687,626527093,608970,626440819,717,86274,588450,15,760345,85588,34,507,130000.0,43333.0,-71.0,-67.0,-69.0,-74.0,-71.0,-67.0,-69.0,-73.0,-88.0,-90.0,-86.0,-86.0,17.0,23.0,17.0,12.0,1
3591,CC:2F:71:3E:C5:1F,3836015,483809050,872,106623,3835143,483702427,0,3631,305069,2997,229813,634,75256,922,8,1252,19,0,38,130000.0,39000.0,-71.0,-72.0,-68.0,-61.0,-71.0,-72.0,-68.0,-60.0,-88.0,-90.0,-86.0,-86.0,17.0,18.0,18.0,25.0,1
3592,BA:8C:B9:54:50:24,3839976,489884870,4831,6182241,3835145,483702629,0,8968,1697627,8946,1694132,22,3495,2348,15,5265,39,0,56,216660.0,130000.0,-48.0,-35.0,-43.0,-46.0,-43.0,-35.0,-44.0,-47.0,-88.0,-90.0,-86.0,-86.0,40.0,55.0,43.0,40.0,1
3593,62:47:05:9D:EB:15,3835191,483712907,40,9227,3835151,483703680,0,71,9981,61,7953,10,2028,37,0,54,0,0,4,216660.0,130000.0,-50.0,-51.0,-52.0,-58.0,-54.0,-51.0,-49.0,-58.0,-88.0,-90.0,-86.0,-86.0,38.0,39.0,34.0,28.0,1
3594,3C:55:76:E8:8F:1F,3859608,543563104,24455,59859222,3835153,483703882,20,12500,3249193,12266,3205303,234,43890,6199,17,24475,2290,20,128,229410.0,137640.0,-46.0,-56.0,-53.0,-41.0,-44.0,-53.0,-51.0,-38.0,-88.0,-90.0,-86.0,-86.0,42.0,34.0,33.0,45.0,1
3595,92:69:1D:31:68:E9,3839064,487327161,3911,3623279,3835153,483703882,0,4742,1099484,4601,1067584,141,31900,2113,10,4110,84,0,43,216660.0,130000.0,-52.0,-47.0,-42.0,-49.0,-51.0,-47.0,-42.0,-48.0,-88.0,-90.0,-86.0,-86.0,36.0,43.0,44.0,37.0,1
3596,CC:2F:71:3F:1F:24,4595450,1293922469,760297,810218587,3835153,483703882,37,609895,626798645,609178,626712371,717,86274,588638,15,760553,85593,34,507,130000.0,43333.0,-71.0,-67.0,-70.0,-74.0,-71.0,-67.0,-70.0,-73.0,-88.0,-90.0,-86.0,-86.0,17.0,23.0,16.0,12.0,1
3597,CC:2F:71:3E:C5:1F,3836025,483810505,872,106623,3835153,483703882,0,3631,305069,2997,229813,634,75256,922,8,1252,19,0,38,130000.0,39000.0,-71.0,-72.0,-68.0,-61.0,-71.0,-72.0,-68.0,-60.0,-88.0,-90.0,-86.0,-86.0,17.0,18.0,18.0,25.0,1
3598,BA:8C:B9:54:50:24,3839984,489886123,4831,6182241,3835153,483703882,0,8968,1697627,8946,1694132,22,3495,2348,15,5265,39,0,56,216660.0,130000.0,-48.0,-35.0,-43.0,-46.0,-43.0,-35.0,-44.0,-47.0,-88.0,-90.0,-86.0,-86.0,40.0,55.0,43.0,40.0,1
3599,62:47:05:9D:EB:15,3835196,483713373,40,9227,3835156,483704146,0,71,9981,61,7953,10,2028,37,0,54,0,0,4,216660.0,130000.0,-50.0,-51.0,-52.0,-58.0,-54.0,-51.0,-49.0,-58.0,-88.0,-90.0,-86.0,-86.0,38.0,39.0,34.0,28.0,1
3600,3C:55:76:E8:8F:1F,3859622,543565993,24464,59861645,3835158,483704348,20,12518,3261384,12284,3217494,234,43890,6212,17,24484,2292,20,128,243750.0,146250.0,-50.0,-57.0,-48.0,-46.0,-47.0,-54.0,-45.0,-42.0,-88.0,-90.0,-86.0,-86.0,38.0,33.0,38.0,40.0,1
3601,92:69:1D:31:68:E9,3839069,487327627,3911,3623279,3835158,483704348,0,4742,1099484,4601,1067584,141,31900,2113,10,4110,84,0,43,216660.0,130000.0,-52.0,-47.0,-42.0,-49.0,-51.0,-47.0,-42.0,-48.0,-88.0,-90.0,-86.0,-86.0,36.0,43.0,44.0,37.0,1
3602,CC:2F:71:3F:1F:24,4595667,1294192175,760509,810487827,3835158,483704348,37,610091,627058313,609374,626972039,717,86274,588828,15,760763,85593,34,507,130000.0,43333.0,-70.0,-67.0,-69.0,-72.0,-70.0,-66.0,-69.0,-72.0,-88.0,-90.0,-86.0,-86.0,18.0,23.0,17.0,14.0,1
3603,CC:2F:71:3E:C5:1F,3836030,483810971,872,106623,3835158,483704348,0,3633,305257,2998,229883,635,75374,923,8,1252,19,0,38,130000.0,39000.0,-71.0,-73.0,-69.0,-60.0,-70.0,-71.0,-68.0,-60.0,-88.0,-90.0,-86.0,-86.0,17.0,17.0,17.0,26.0,1
3604,BA:8C:B9:54:50:24,3839989,489886589,4831,6182241,3835158,483704348,0,8968,1697627,8946,1694132,22,3495,2348,15,5265,39,0,56,216660.0,130000.0,-48.0,-35.0,-43.0,-46.0,-43.0,-35.0,-44.0,-47.0,-88.0,-90.0,-86.0,-86.0,40.0,55.0,43.0,40.0,1
3605,62:47:05:9D:EB:15,3835203,483714039,40,9227,3835163,483704812,0,71,9981,61,7953,10,2028,37,0,54,0,0,4,216660.0,130000.0,-50.0,-51.0,-52.0,-58.0,-54.0,-51.0,-49.0,-58.0,-88.0,-90.0,-86.0,-86.0,38.0,39.0,34.0,28.0,1
3606,3C:55:76:E8:8F:1F,3859629,543566733,24466,59861921,3835163,483704812,20,12535,3265313,12301,3221423,234,43890,6216,17,24486,2292,20,129,243750.0,146250.0,-46.0,-52.0,-41.0,-42.0,-47.0,-52.0,-41.0,-43.0,-88.0,-90.0,-86.0,-86.0,42.0,38.0,45.0,44.0,1
3607,92:69:1D:31:68:E9,3839074,487328091,3911,3623279,3835163,483704812,0,4742,1099484,4601,1067584,141,31900,2113,10,4110,84,0,43,216660.0,130000.0,-52.0,-47.0,-42.0,-49.0,-51.0,-47.0,-42.0,-48.0,-88.0,-90.0,-86.0,-86.0,36.0,43.0,44.0,37.0,1
3608,CC:2F:71:3F:1F:24,4595886,1294455858,760721,810750844,3835165,483705014,37,610294,627313947,609577,627227673,717,86274,589020,15,760977,85603,34,507,130000.0,43333.0,-72.0,-67.0,-70.0,-73.0,-71.0,-66.0,-70.0,-73.0,-88.0,-90.0,-86.0,-86.0,16.0,23.0,16.0,13.0,1
3609,CC:2F:71:3E:C5:1F,3836037,483811637,872,106623,3835165,483705014,0,3633,305257,2998,229883,635,75374,923,8,1252,19,0,38,130000.0,39000.0,-71.0,-73.0,-69.0,-60.0,-70.0,-71.0,-68.0,-60.0,-88.0,-90.0,-86.0,-86.0,17.0,17.0,17.0,26.0,1
3610,BA:8C:B9:54:50:24,3839998,489887623,4831,6182241,3835167,483705382,0,8968,1697627,8946,1694132,22,3495,2348,15,5265,39,0,56,216660.0,130000.0,-48.0,-35.0,-43.0,-46.0,-43.0,-35.0,-44.0,-47.0,-88.0,-90.0,-86.0,-86.0,40.0,55.0,43.0,40.0,1
3611,62:47:05:9D:EB:15,3835209,483714811,40,9227,3835169,483705584,0,71,9981,61,7953,10,2028,37,0,54,0,0,4,216660.0,130000.0,-50.0,-51.0,-52.0,-58.0,-54.0,-51.0,-49.0,-58.0,-88.0,-90.0,-86.0,-86.0,38.0,39.0,34.0,28.0,1
3612,3C:55:76:E8:8F:1F,3859691,543632602,24522,59927018,3835169,483705584,20,12618,3289740,12384,3245850,234,43890,6261,17,24542,2292,20,129,162500.0,48750.0,-49.0,-56.0,-46.0,-45.0,-48.0,-55.0,-45.0,-44.0,-88.0,-90.0,-86.0,-86.0,39.0,34.0,40.0,41.0,1
3613,92:69:1D:31:68:E9,3839082,487329065,3911,3623279,3835171,483705786,0,4742,1099484,4601,1067584,141,31900,2113,10,4110,84,0,43,216660.0,130000.0,-52.0,-47.0,-42.0,-49.0,-51.0,-47.0,-42.0,-48.0,-88.0,-90.0,-86.0,-86.0,36.0,43.0,44.0,37.0,1
3614,CC:2F:71:3F:1F:24,4596101,1294722632,760930,811016846,3835171,483705786,37,610489,627575187,609772,627488913,717,86274,589205,15,761186,85615,34,507,130000.0,43333.0,-71.0,-66.0,-69.0,-73.0,-71.0,-66.0,-69.0,-72.0,-88.0,-90.0,-86.0,-86.0,17.0,24.0,17.0,13.0,1
3615,CC:2F:71:3E:C5:1F,3836043,483812409,872,106623,3835171,483705786,0,3633,305257,2998,229883,635,75374,923,8,1252,19,0,38,130000.0,39000.0,-71.0,-73.0,-69.0,-60.0,-70.0,-71.0,-68.0,-60.0,-88.0,-90.0,-86.0,-86.0,17.0,17.0,17.0,26.0,1
3616,BA:8C:B9:54:50:24,3840002,489888027,4831,6182241,3835171,483705786,0,8968,1697627,8946,1694132,22,3495,2348,15,5265,39,0,56,216660.0,130000.0,-48.0,-35.0,-43.0,-46.0,-43.0,-35.0,-44.0,-47.0,-88.0,-90.0,-86.0,-86.0,40.0,55.0,43.0,40.0,1
3617,62:47:05:9D:EB:15,3835214,483715277,40,9227,3835174,483706050,0,71,9981,61,7953,10,2028,37,0,54,0,0,4,216660.0,130000.0,-50.0,-51.0,-52.0,-58.0,-54.0,-51.0,-49.0,-58.0,-88.0,-90.0,-86.0,-86.0,38.0,39.0,34.0,28.0,1
3618,3C:55:76:E8:8F:1F,3859777,543717712,24600,60011400,3835177,483706312,20,12711,3325517,12476,3281509,235,44008,6307,17,24620,2295,20,134,154850.0,48750.0,-50.0,-56.0,-47.0,-45.0,-49.0,-55.0,-45.0,-44.0,-88.0,-90.0,-86.0,-86.0,38.0,34.0,39.0,41.0,1
3619,92:69:1D:31:68:E9,3839088,487329591,3911,3623279,3835177,483706312,0,4744,1099620,4603,1067720,141,31900,2113,10,4110,84,0,43,216660.0,130000.0,-51.0,-47.0,-44.0,-48.0,-51.0,-47.0,-42.0,-48.0,-88.0,-90.0,-86.0,-86.0,37.0,43.0,42.0,38.0,1
3620,CC:2F:71:3F:1F:24,4596317,1294989066,761140,811282754,3835177,483706312,37,610684,627833521,609967,627747247,717,86274,589392,15,761395,85647,34,507,130000.0,43333.0,-71.0,-67.0,-70.0,-73.0,-71.0,-66.0,-69.0,-72.0,-88.0,-90.0,-86.0,-86.0,17.0,23.0,16.0,13.0,1
3621,CC:2F:71:3E:C5:1F,3836049,483812935,872,106623,3835177,483706312,0,3633,305257,2998,229883,635,75374,923,8,1252,19,0,38,130000.0,39000.0,-71.0,-73.0,-69.0,-60.0,-70.0,-71.0,-68.0,-60.0,-88.0,-90.0,-86.0,-86.0,17.0,17.0,17.0,26.0,1
3622,BA:8C:B9:54:50:24,3840008,489888553,4831,6182241,3835177,483706312,0,8972,1697899,8950,1694404,22,3495,2348,15,5265,39,0,57,216660.0,130000.0,-48.0,-35.0,-43.0,-45.0,-46.0,-35.0,-43.0,-46.0,-88.0,-90.0,-86.0,-86.0,40.0,55.0,43.0,41.0,1
3623,62:47:05:9D:EB:15,3835221,483715943,40,9227,3835181,483706716,0,71,9981,61,7953,10,2028,37,0,54,0,0,4,216660.0,130000.0,-50.0,-51.0,-52.0,-58.0,-54.0,-51.0,-49.0,-58.0,-88.0,-90.0,-86.0,-86.0,38.0,39.0,34.0,28.0,1
3624,3C:55:76:E8:8F:1F,3859854,543817857,24673,60111141,3835181,483706716,20,12797,3364445,12562,3320437,235,44008,6361,17,24693,2295,20,135,146250.0,1000.0,-48.0,-54.0,-45.0,-42.0,-48.0,-54.0,-43.0,-43.0,-88.0,-90.0,-86.0,-86.0,40.0,36.0,41.0,44.0,1
3625,92:69:1D:31:68:E9,3839096,487331748,3915,3625032,3835181,483706716,0,4753,1102821,4612,1070921,141,31900,2118,10,4114,87,0,43,216660.0,130000.0,-52.0,-47.0,-42.0,-49.0,-51.0,-48.0,-44.0,-50.0,-88.0,-90.0,-86.0,-86.0,36.0,43.0,44.0,37.0,1
3626,CC:2F:71:3F:1F:24,4596533,1295257286,761352,811550570,3835181,483706716,37,610881,628093605,610164,628007331,717,86274,589581,15,761607,85654,34,507,130000.0,43333.0,-71.0,-66.0,-70.0,-73.0,-71.0,-66.0,-69.0,-73.0,-88.0,-90.0,-86.0,-86.0,17.0,24.0,16.0,13.0,1
3627,CC:2F:71:3E:C5:1F,3836055,483813541,872,106623,3835183,483706918,0,3633,305257,2998,229883,635,75374,923,8,1252,19,0,38,130000.0,39000.0,-71.0,-73.0,-69.0,-60.0,-70.0,-71.0,-68.0,-60.0,-88.0,-90.0,-86.0,-86.0,17.0,17.0,17.0,26.0,1
3628,BA:8C:B9:54:50:24,3840014,489889159,4831,6182241,3835183,483706918,0,8972,1697899,8950,1694404,22,3495,2348,15,5265,39,0,57,216660.0,130000.0,-48.0,-35.0,-43.0,-45.0,-46.0,-35.0,-43.0,-46.0,-88.0,-90.0,-86.0,-86.0,40.0,55.0,43.0,41.0,1
3629,62:47:05:9D:EB:15,3835225,483716347,40,9227,3835185,483707120,0,73,10117,63,8089,10,2028,37,0,55,0,0,4,216660.0,130000.0,-50.0,-51.0,-51.0,-58.0,-53.0,-51.0,-50.0,-58.0,-88.0,-89.0,-86.0,-86.0,38.0,38.0,35.0,28.0,1
3630,3C:55:76:E8:8F:1F,3860249,544429001,25064,60721881,3835185,483707120,20,13046,3418323,12811,3374315,235,44008,6472,17,25084,2295,20,137,154850.0,51610.0,-50.0,-56.0,-47.0,-46.0,-48.0,-56.0,-48.0,-44.0,-88.0,-89.0,-86.0,-86.0,38.0,33.0,39.0,40.0,1
3631,92:69:1D:31:68:E9,3839100,487332152,3915,3625032,3835185,483707120,0,4753,1102821,4612,1070921,141,31900,2118,10,4114,87,0,43,216660.0,130000.0,-52.0,-47.0,-42.0,-49.0,-51.0,-48.0,-44.0,-50.0,-88.0,-89.0,-86.0,-86.0,36.0,42.0,44.0,37.0,1
3632,CC:2F:71:3F:1F:24,4596761,1295537709,761576,811830589,3835185,483707120,37,611100,628382284,610383,628296010,717,86274,589781,15,761832,85672,34,507,130000.0,43333.0,-71.0,-67.0,-70.0,-73.0,-71.0,-66.0,-70.0,-72.0,-88.0,-89.0,-86.0,-86.0,17.0,22.0,16.0,13.0,1
3633,CC:2F:71:3E:C5:1F,3836058,483813803,872,106623,3835186,483707180,0,3635,305397,3000,230023,635,75374,923,8,1253,19,0,38,130000.0,39000.0,-71.0,-72.0,-69.0,-61.0,-70.0,-71.0,-68.0,-60.0,-88.0,-89.0,-86.0,-86.0,17.0,17.0,17.0,25.0,1
3634,BA:8C:B9:54:50:24,3840017,489889421,4831,6182241,3835186,483707180,0,8972,1697899,8950,1694404,22,3495,2348,15,5265,39,0,57,216660.0,130000.0,-48.0,-35.0,-43.0,-45.0,-46.0,-35.0,-43.0,-46.0,-88.0,-89.0,-86.0,-86.0,40.0,54.0,43.0,41.0,1
3635,62:47:05:9D:EB:15,3835233,483717075,40,9227,3835193,483707848,0,73,10117,63,8089,10,2028,37,0,55,0,0,4,216660.0,130000.0,-50.0,-51.0,-51.0,-58.0,-53.0,-51.0,-50.0,-58.0,-88.0,-89.0,-86.0,-86.0,38.0,38.0,35.0,28.0,1
3636,3C:55:76:E8:8F:1F,3860407,544675797,25214,60967949,3835193,483707848,20,13196,3467986,12961,3423978,235,44008,6567,17,25234,2297,20,140,172050.0,48750.0,-50.0,-56.0,-47.0,-45.0,-48.0,-55.0,-48.0,-43.0,-88.0,-89.0,-86.0,-86.0,38.0,33.0,39.0,41.0,1
3637,92:69:1D:31:68:E9,3839108,487332880,3915,3625032,3835193,483707848,0,4753,1102821,4612,1070921,141,31900,2118,10,4114,87,0,43,216660.0,130000.0,-52.0,-47.0,-42.0,-49.0,-51.0,-48.0,-44.0,-50.0,-88.0,-89.0,-86.0,-86.0,36.0,42.0,44.0,37.0,1
3638,CC:2F:71:3F:1F:24,4596978,1295801591,761785,812093743,3835193,483707848,37,611290,628635618,610572,628549226,718,86392,589966,15,762041,85680,34,507,130000.0,43333.0,-71.0,-67.0,-70.0,-73.0,-71.0,-66.0,-69.0,-72.0,-88.0,-89.0,-86.0,-86.0,17.0,22.0,16.0,13.0,1
3639,CC:2F:71:3E:C5:1F,3836065,483814471,872,106623,3835193,483707848,0,3635,305397,3000,230023,635,75374,923,8,1253,19,0,38,130000.0,39000.0,-71.0,-72.0,-69.0,-61.0,-70.0,-71.0,-68.0,-60.0,-88.0,-89.0,-86.0,-86.0,17.0,17.0,17.0,25.0,1
3640,BA:8C:B9:54:50:24,3840024,489890089,4831,6182241,3835193,483707848,0,8972,1697899,8950,1694404,22,3495,2348,15,5265,39,0,57,216660.0,130000.0,-48.0,-35.0,-43.0,-45.0,-46.0,-35.0,-43.0,-46.0,-88.0,-89.0,-86.0,-86.0,40.0,54.0,43.0,41.0,1
3641,62:47:05:9D:EB:15,3835235,483717277,40,9227,3835195,483708050,0,74,10185,64,8157,10,2028,37,0,55,0,0,4,216660.0,130000.0,-51.0,-52.0,-58.0,-51.0,-52.0,-51.0,-51.0,-58.0,-88.0,-89.0,-86.0,-86.0,37.0,37.0,28.0,35.0,1
3642,3C:55:76:E8:8F:1F,3860978,545870206,25783,62162156,3835195,483708050,20,13470,3548738,13235,3504730,235,44008,6724,17,25803,2301,20,141,137640.0,32500.0,-46.0,-51.0,-45.0,-44.0,-49.0,-51.0,-46.0,-46.0,-88.0,-89.0,-86.0,-86.0,42.0,38.0,41.0,42.0,1
3643,92:69:1D:31:68:E9,3839110,487333082,3915,3625032,3835195,483708050,0,4755,1102957,4614,1071057,141,31900,2118,10,4114,87,0,43,216660.0,130000.0,-52.0,-47.0,-42.0,-49.0,-51.0,-48.0,-44.0,-50.0,-88.0,-89.0,-86.0,-86.0,36.0,42.0,44.0,37.0,1
3644,CC:2F:71:3F:1F:24,4597208,1296087183,762011,812378931,3835197,483708252,37,611503,628914740,610785,628828348,718,86392,590168,15,762267,85711,34,507,130000.0,43333.0,-72.0,-66.0,-70.0,-73.0,-71.0,-66.0,-69.0,-74.0,-88.0,-89.0,-86.0,-86.0,16.0,23.0,16.0,13.0,1
3645,CC:2F:71:3E:C5:1F,3836071,483815077,872,106623,3835199,483708454,0,3635,305397,3000,230023,635,75374,923,8,1253,19,0,38,130000.0,39000.0,-71.0,-72.0,-69.0,-61.0,-70.0,-71.0,-68.0,-60.0,-88.0,-89.0,-86.0,-86.0,17.0,17.0,17.0,25.0,1
3646,BA:8C:B9:54:50:24,3840031,489890757,4831,6182241,3835200,483708516,0,8972,1697899,8950,1694404,22,3495,2348,15,5265,39,0,57,216660.0,130000.0,-48.0,-35.0,-43.0,-45.0,-46.0,-35.0,-43.0,-46.0,-88.0,-89.0,-86.0,-86.0,40.0,54.0,43.0,41.0,1
3647,62:47:05:9D:EB:15,3835243,483718005,40,9227,3835203,483708778,0,74,10185,64,8157,10,2028,37,0,55,0,0,4,216660.0,130000.0,-51.0,-52.0,-58.0,-51.0,-52.0,-51.0,-51.0,-58.0,-88.0,-89.0,-86.0,-86.0,37.0,37.0,28.0,35.0,1
3648,3C:55:76:E8:8F:1F,3862540,549820129,27335,66111149,3835205,483708980,20,13963,3635235,13728,3591227,235,44008,6976,17,27356,2302,20,144,172050.0,48750.0,-52.0,-53.0,-47.0,-48.0,-52.0,-52.0,-47.0,-45.0,-88.0,-89.0,-86.0,-86.0,36.0,36.0,39.0,38.0,1
3649,92:69:1D:31:68:E9,3839120,487334012,3915,3625032,3835205,483708980,0,4756,1103025,4615,1071125,141,31900,2118,10,4114,87,0,43,216660.0,130000.0,-52.0,-47.0,-42.0,-49.0,-51.0,-48.0,-44.0,-50.0,-88.0,-89.0,-86.0,-86.0,36.0,42.0,44.0,37.0,1
3650,CC:2F:71:3F:1F:24,4597458,1296391868,762253,812682888,3835205,483708980,37,611720,629200447,611002,629114055,718,86392,590383,15,762509,85734,34,507,130000.0,43333.0,-71.0,-66.0,-68.0,-74.0,-70.0,-65.0,-67.0,-74.0,-88.0,-89.0,-86.0,-86.0,17.0,23.0,18.0,12.0,1
3651,CC:2F:71:3E:C5:1F,3836077,483815603,872,106623,3835205,483708980,0,3635,305397,3000,230023,635,75374,923,8,1253,19,0,38,130000.0,39000.0,-71.0,-72.0,-69.0,-61.0,-70.0,-71.0,-68.0,-60.0,-88.0,-89.0,-86.0,-86.0,17.0,17.0,17.0,25.0,1
3652,BA:8C:B9:54:50:24,3840036,489891221,4831,6182241,3835205,483708980,0,8972,1697899,8950,1694404,22,3495,2348,15,5265,39,0,57,216660.0,130000.0,-48.0,-35.0,-43.0,-45.0,-46.0,-35.0,-43.0,-46.0,-88.0,-89.0,-86.0,-86.0,40.0,54.0,43.0,41.0,1
3653,62:47:05:9D:EB:15,3835249,483718611,40,9227,3835209,483709384,0,74,10185,64,8157,10,2028,37,0,55,0,0,4,216660.0,130000.0,-51.0,-52.0,-58.0,-51.0,-52.0,-51.0,-51.0,-58.0,-88.0,-89.0,-85.0,-85.0,37.0,37.0,27.0,34.0,1
3654,3C:55:76:E8:8F:1F,3862550,549821528,27339,66111942,3835211,483709586,20,13982,3636788,13747,3592780,235,44008,6980,17,27360,2302,20,145,172050.0,48750.0,-45.0,-50.0,-51.0,-41.0,-45.0,-51.0,-49.0,-42.0,-88.0,-89.0,-85.0,-85.0,43.0,39.0,34.0,44.0,1
3655,92:69:1D:31:68:E9,3839127,487334734,3916,3625148,3835211,483709586,0,4758,1103199,4617,1071299,141,31900,2119,10,4114,87,0,43,216660.0,130000.0,-51.0,-48.0,-45.0,-46.0,-51.0,-48.0,-43.0,-49.0,-88.0,-89.0,-85.0,-85.0,37.0,41.0,40.0,39.0,1
3656,CC:2F:71:3F:1F:24,4597690,1296677872,762479,812968286,3835211,483709586,37,611929,629474469,611211,629388077,718,86392,590588,15,762735,85743,34,508,130000.0,43333.0,-68.0,-69.0,-64.0,-74.0,-68.0,-69.0,-64.0,-74.0,-88.0,-89.0,-85.0,-85.0,20.0,20.0,21.0,11.0,1
3657,CC:2F:71:3E:C5:1F,3836083,483816209,872,106623,3835211,483709586,0,3635,305397,3000,230023,635,75374,923,8,1253,19,0,38,130000.0,39000.0,-71.0,-72.0,-69.0,-61.0,-70.0,-71.0,-68.0,-60.0,-88.0,-89.0,-85.0,-85.0,17.0,17.0,16.0,24.0,1
3658,BA:8C:B9:54:50:24,3840042,489891827,4831,6182241,3835211,483709586,0,8972,1697899,8950,1694404,22,3495,2348,15,5265,39,0,57,216660.0,130000.0,-48.0,-35.0,-43.0,-45.0,-46.0,-35.0,-43.0,-46.0,-88.0,-89.0,-85.0,-85.0,40.0,54.0,42.0,40.0,1
3659,62:47:05:9D:EB:15,3835255,483719348,40,9227,3835215,483710121,0,74,10185,64,8157,10,2028,37,0,55,0,0,4,216660.0,130000.0,-51.0,-52.0,-58.0,-51.0,-52.0,-51.0,-51.0,-58.0,-88.0,-89.0,-85.0,-85.0,37.0,37.0,27.0,34.0,1
3660,3C:55:76:E8:8F:1F,3862557,549823002,27342,66112881,3835215,483710121,20,13998,3639067,13763,3595059,235,44008,6984,17,27363,2302,20,145,172050.0,51610.0,-48.0,-49.0,-49.0,-45.0,-48.0,-47.0,-45.0,-44.0,-88.0,-89.0,-85.0,-85.0,40.0,40.0,36.0,40.0,1
3661,92:69:1D:31:68:E9,3839132,487335385,3917,3625264,3835215,483710121,0,4761,1103445,4620,1071545,141,31900,2120,10,4116,87,0,43,216660.0,130000.0,-52.0,-47.0,-42.0,-49.0,-51.0,-47.0,-43.0,-48.0,-88.0,-89.0,-85.0,-85.0,36.0,42.0,43.0,36.0,1
3662,CC:2F:71:3F:1F:24,4597904,1296941227,762689,813231106,3835215,483710121,37,612120,629729285,611402,629642893,718,86392,590773,15,762944,85772,34,508,144444.0,43333.0,-69.0,-66.0,-68.0,-70.0,-69.0,-66.0,-68.0,-70.0,-88.0,-89.0,-85.0,-85.0,19.0,23.0,17.0,15.0,1
3663,CC:2F:71:3E:C5:1F,3836087,483816744,872,106623,3835215,483710121,0,3635,305397,3000,230023,635,75374,923,8,1253,19,0,38,130000.0,39000.0,-71.0,-72.0,-69.0,-61.0,-70.0,-71.0,-68.0,-60.0,-88.0,-89.0,-85.0,-85.0,17.0,17.0,16.0,24.0,1
3664,BA:8C:B9:54:50:24,3840046,489892362,4831,6182241,3835215,483710121,0,8973,1697967,8951,1694472,22,3495,2348,15,5265,39,0,57,216660.0,130000.0,-48.0,-35.0,-43.0,-46.0,-47.0,-35.0,-43.0,-46.0,-88.0,-89.0,-85.0,-85.0,40.0,54.0,42.0,39.0,1
3665,62:47:05:9D:EB:15,3835261,483719954,40,9227,3835221,483710727,0,74,10185,64,8157,10,2028,37,0,55,0,0,4,216660.0,130000.0,-51.0,-52.0,-58.0,-51.0,-52.0,-51.0,-51.0,-58.0,-88.0,-89.0,-85.0,-85.0,37.0,37.0,27.0,34.0,1
3666,3C:55:76:E8:8F:1F,3862569,549829645,27348,66118918,3835221,483710727,20,14017,3641853,13782,3597845,235,44008,6990,17,27369,2302,20,145,195000.0,97500.0,-45.0,-50.0,-46.0,-43.0,-45.0,-49.0,-45.0,-42.0,-88.0,-89.0,-85.0,-85.0,43.0,39.0,39.0,42.0,1
3667,92:69:1D:31:68:E9,3839138,487335991,3917,3625264,3835221,483710727,0,4761,1103445,4620,1071545,141,31900,2120,10,4116,87,0,43,216660.0,130000.0,-52.0,-47.0,-42.0,-49.0,-51.0,-47.0,-43.0,-48.0,-88.0,-89.0,-85.0,-85.0,36.0,42.0,43.0,36.0,1
3668,CC:2F:71:3F:1F:24,4598120,1297204845,762899,813494118,3835221,483710727,37,612317,629989744,611599,629903352,718,86392,590960,15,763155,85781,34,508,130000.0,43333.0,-69.0,-67.0,-69.0,-73.0,-68.0,-66.0,-69.0,-73.0,-88.0,-89.0,-85.0,-85.0,19.0,22.0,16.0,12.0,1
3669,CC:2F:71:3E:C5:1F,3836093,483817350,872,106623,3835221,483710727,0,3635,305397,3000,230023,635,75374,923,8,1253,19,0,38,130000.0,39000.0,-71.0,-72.0,-69.0,-61.0,-70.0,-71.0,-68.0,-60.0,-88.0,-89.0,-85.0,-85.0,17.0,17.0,16.0,24.0,1
3670,BA:8C:B9:54:50:24,3840052,489892968,4831,6182241,3835221,483710727,0,8976,1698171,8954,1694676,22,3495,2348,15,5265,39,0,57,216660.0,130000.0,-39.0,-37.0,-45.0,-52.0,-46.0,-35.0,-43.0,-46.0,-88.0,-89.0,-85.0,-85.0,49.0,52.0,40.0,33.0,1
3671,62:47:05:9D:EB:15,3835264,483720216,40,9227,3835224,483710989,0,74,10185,64,8157,10,2028,37,0,55,0,0,4,216660.0,130000.0,-51.0,-52.0,-58.0,-51.0,-52.0,-51.0,-51.0,-58.0,-88.0,-89.0,-85.0,-85.0,37.0,37.0,27.0,34.0,1
3672,3C:55:76:E8:8F:1F,3862576,549830440,27352,66119451,3835224,483710989,20,14029,3642886,13794,3598878,235,44008,6994,17,27373,2302,20,146,195000.0,1000.0,-47.0,-55.0,-52.0,-48.0,-47.0,-51.0,-47.0,-44.0,-88.0,-89.0,-85.0,-85.0,41.0,34.0,33.0,37.0,1
3673,92:69:1D:31:68:E9,3839141,487336253,3917,3625264,3835224,483710989,0,4761,1103445,4620,1071545,141,31900,2120,10,4116,87,0,43,216660.0,130000.0,-52.0,-47.0,-42.0,-49.0,-51.0,-47.0,-43.0,-48.0,-88.0,-89.0,-85.0,-85.0,36.0,42.0,43.0,36.0,1
3674,CC:2F:71:3F:1F:24,4598332,1297467950,763108,813756961,3835224,483710989,37,612521,630250642,611803,630164250,718,86392,591149,15,763364,85781,34,508,130000.0,43333.0,-68.0,-66.0,-69.0,-72.0,-68.0,-66.0,-68.0,-71.0,-88.0,-89.0,-85.0,-85.0,20.0,23.0,16.0,13.0,1
3675,CC:2F:71:3E:C5:1F,3836098,483817814,872,106623,3835226,483711191,0,3635,305397,3000,230023,635,75374,923,8,1253,19,0,38,130000.0,39000.0,-71.0,-72.0,-69.0,-61.0,-70.0,-71.0,-68.0,-60.0,-88.0,-89.0,-85.0,-85.0,17.0,17.0,16.0,24.0,1
3676,BA:8C:B9:54:50:24,3840057,489893432,4831,6182241,3835226,483711191,0,8977,1698239,8955,1694744,22,3495,2348,15,5265,39,0,57,216660.0,130000.0,-40.0,-36.0,-45.0,-52.0,-45.0,-35.0,-43.0,-47.0,-88.0,-89.0,-85.0,-85.0,48.0,53.0,40.0,33.0,1
3677,62:47:05:9D:EB:15,3835271,483720900,40,9227,3835231,483711673,0,77,10459,66,8293,11,2166,38,0,55,0,0,4,216660.0,130000.0,-49.0,-51.0,-44.0,-50.0,-50.0,-51.0,-50.0,-54.0,-88.0,-89.0,-85.0,-85.0,39.0,38.0,41.0,35.0,1
3678,3C:55:76:E8:8F:1F,3863189,551424089,27958,67712416,3835231,483711673,20,14189,3670181,13954,3626173,235,44008,7064,17,27908,2306,20,146,146250.0,48750.0,-48.0,-52.0,-50.0,-46.0,-45.0,-51.0,-49.0,-42.0,-88.0,-89.0,-85.0,-85.0,40.0,37.0,35.0,39.0,1
3679,92:69:1D:31:68:E9,3839148,487336937,3917,3625264,3835231,483711673,0,4761,1103445,4620,1071545,141,31900,2120,10,4116,87,0,43,216660.0,130000.0,-52.0,-47.0,-42.0,-49.0,-51.0,-47.0,-43.0,-48.0,-88.0,-89.0,-85.0,-85.0,36.0,42.0,43.0,36.0,1
3680,CC:2F:71:3F:1F:24,4598574,1297774816,763343,814063143,3835231,483711673,37,612744,630552130,612026,630465738,718,86392,591362,15,763599,85804,34,508,130000.0,43333.0,-68.0,-66.0,-68.0,-71.0,-68.0,-66.0,-68.0,-70.0,-88.0,-89.0,-85.0,-85.0,20.0,23.0,17.0,14.0,1
3681,CC:2F:71:3E:C5:1F,3836105,483818498,872,106623,3835233,483711875,0,3635,305397,3000,230023,635,75374,923,8,1253,19,0,38,130000.0,39000.0,-71.0,-72.0,-69.0,-61.0,-70.0,-71.0,-68.0,-60.0,-88.0,-89.0,-85.0,-85.0,17.0,17.0,16.0,24.0,1
3682,BA:8C:B9:54:50:24,3840064,489894116,4831,6182241,3835233,483711875,0,8977,1698239,8955,1694744,22,3495,2348,15,5265,39,0,57,216660.0,130000.0,-40.0,-36.0,-45.0,-52.0,-45.0,-35.0,-43.0,-47.0,-88.0,-89.0,-85.0,-85.0,48.0,53.0,40.0,33.0,1
3683,62:47:05:9D:EB:15,3835277,483721506,40,9227,3835237,483712279,0,77,10459,66,8293,11,2166,38,0,55,0,0,4,216660.0,130000.0,-49.0,-51.0,-44.0,-50.0,-50.0,-51.0,-50.0,-54.0,-88.0,-89.0,-85.0,-85.0,39.0,38.0,41.0,35.0,1
3684,3C:55:76:E8:8F:1F,3863370,551877428,28132,68165089,3835238,483712339,20,14247,3680974,14012,3636966,235,44008,7094,17,28153,2306,20,147,154850.0,1000.0,-43.0,-52.0,-52.0,-40.0,-42.0,-51.0,-50.0,-39.0,-88.0,-89.0,-85.0,-85.0,45.0,37.0,33.0,45.0,1
3685,92:69:1D:31:68:E9,3839155,487337603,3917,3625264,3835238,483712339,0,4761,1103445,4620,1071545,141,31900,2120,10,4116,87,0,43,216660.0,130000.0,-52.0,-47.0,-42.0,-49.0,-51.0,-47.0,-43.0,-48.0,-88.0,-89.0,-85.0,-85.0,36.0,42.0,43.0,36.0,1
3686,CC:2F:71:3F:1F:24,4598792,1298038822,763552,814326281,3835240,483712541,37,612936,630808500,612218,630722108,718,86392,591547,15,763808,85806,34,508,130000.0,43333.0,-69.0,-66.0,-69.0,-71.0,-68.0,-65.0,-68.0,-71.0,-88.0,-89.0,-85.0,-85.0,19.0,23.0,16.0,14.0,1
3687,CC:2F:71:3E:C5:1F,3836112,483819164,872,106623,3835240,483712541,0,3635,305397,3000,230023,635,75374,923,8,1253,19,0,38,130000.0,39000.0,-71.0,-72.0,-69.0,-61.0,-70.0,-71.0,-68.0,-60.0,-88.0,-89.0,-85.0,-85.0,17.0,17.0,16.0,24.0,1
3688,BA:8C:B9:54:50:24,3840071,489894782,4831,6182241,3835240,483712541,0,8977,1698239,8955,1694744,22,3495,2348,15,5265,39,0,57,216660.0,130000.0,-40.0,-36.0,-45.0,-52.0,-45.0,-35.0,-43.0,-47.0,-88.0,-89.0,-85.0,-85.0,48.0,53.0,40.0,33.0,1
3689,62:47:05:9D:EB:15,3835280,483721768,40,9227,3835240,483712541,0,77,10459,66,8293,11,2166,38,0,55,0,0,4,216660.0,130000.0,-49.0,-51.0,-44.0,-50.0,-50.0,-51.0,-50.0,-54.0,-88.0,-89.0,-85.0,-85.0,39.0,38.0,41.0,35.0,1
3690,3C:55:76:E8:8F:1F,3863390,551888243,28150,68175702,3835240,483712541,20,14279,3687829,14044,3643821,235,44008,7109,17,28171,2306,20,147,162500.0,48750.0,-44.0,-51.0,-52.0,-39.0,-43.0,-51.0,-52.0,-39.0,-88.0,-89.0,-85.0,-85.0,44.0,38.0,33.0,46.0,1
3691,92:69:1D:31:68:E9,3839159,487338007,3917,3625264,3835242,483712743,0,4761,1103445,4620,1071545,141,31900,2120,10,4116,87,0,43,216660.0,130000.0,-52.0,-47.0,-42.0,-49.0,-51.0,-47.0,-43.0,-48.0,-88.0,-89.0,-85.0,-85.0,36.0,42.0,43.0,36.0,1
3692,CC:2F:71:3F:1F:24,4599010,1298305465,763768,814592722,3835242,483712743,37,613141,631074201,612423,630987809,718,86392,591739,15,764024,85807,34,508,144444.0,43333.0,-70.0,-66.0,-68.0,-73.0,-69.0,-65.0,-68.0,-73.0,-88.0,-89.0,-85.0,-85.0,18.0,23.0,17.0,12.0,1
3693,CC:2F:71:3E:C5:1F,3836114,483819366,872,106623,3835242,483712743,0,3635,305397,3000,230023,635,75374,923,8,1253,19,0,38,130000.0,39000.0,-71.0,-72.0,-69.0,-61.0,-70.0,-71.0,-68.0,-60.0,-88.0,-89.0,-85.0,-85.0,17.0,17.0,16.0,24.0,1
3694,BA:8C:B9:54:50:24,3840073,489894984,4831,6182241,3835242,483712743,0,8977,1698239,8955,1694744,22,3495,2348,15,5265,39,0,57,216660.0,130000.0,-40.0,-36.0,-45.0,-52.0,-45.0,-35.0,-43.0,-47.0,-88.0,-89.0,-85.0,-85.0,48.0,53.0,40.0,33.0,1
3695,62:47:05:9D:EB:15,3835288,483722576,40,9227,3835248,483713349,0,77,10459,66,8293,11,2166,38,0,55,0,0,4,216660.0,130000.0,-49.0,-51.0,-44.0,-50.0,-50.0,-51.0,-50.0,-54.0,-88.0,-89.0,-85.0,-85.0,39.0,38.0,41.0,35.0,1
3696,3C:55:76:E8:8F:1F,3863398,551889051,28150,68175702,3835248,483713349,20,14279,3687829,14044,3643821,235,44008,7109,17,28171,2306,20,147,162500.0,48750.0,-44.0,-51.0,-52.0,-39.0,-43.0,-51.0,-52.0,-39.0,-88.0,-89.0,-85.0,-85.0,44.0,38.0,33.0,46.0,1
3697,92:69:1D:31:68:E9,3839165,487338613,3917,3625264,3835248,483713349,0,4761,1103445,4620,1071545,141,31900,2120,10,4116,87,0,43,216660.0,130000.0,-52.0,-47.0,-42.0,-49.0,-51.0,-47.0,-43.0,-48.0,-88.0,-89.0,-85.0,-85.0,36.0,42.0,43.0,36.0,1
3698,CC:2F:71:3F:1F:24,4599226,1298569283,763978,814855934,3835248,483713349,37,613331,631327463,612613,631241071,718,86392,591924,15,764234,85820,34,508,130000.0,43333.0,-69.0,-65.0,-69.0,-72.0,-69.0,-65.0,-68.0,-72.0,-88.0,-89.0,-85.0,-85.0,19.0,24.0,16.0,13.0,1
3699,CC:2F:71:3E:C5:1F,3836120,483819972,872,106623,3835248,483713349,0,3635,305397,3000,230023,635,75374,923,8,1253,19,0,38,130000.0,39000.0,-71.0,-72.0,-69.0,-61.0,-70.0,-71.0,-68.0,-60.0,-88.0,-89.0,-85.0,-85.0,17.0,17.0,16.0,24.0,1
3700,BA:8C:B9:54:50:24,3840079,489895590,4831,6182241,3835248,483713349,0,8977,1698239,8955,1694744,22,3495,2348,15,5265,39,0,57,216660.0,130000.0,-40.0,-36.0,-45.0,-52.0,-45.0,-35.0,-43.0,-47.0,-88.0,-89.0,-85.0,-85.0,48.0,53.0,40.0,33.0,1
3701,62:47:05:9D:EB:15,3835291,483722838,40,9227,3835251,483713611,0,77,10459,66,8293,11,2166,38,0,55,0,0,4,216660.0,130000.0,-49.0,-51.0,-44.0,-50.0,-50.0,-51.0,-50.0,-54.0,-88.0,-89.0,-85.0,-85.0,39.0,38.0,41.0,35.0,1
3702,3C:55:76:E8:8F:1F,3863401,551889313,28150,68175702,3835251,483713611,20,14279,3687829,14044,3643821,235,44008,7109,17,28171,2306,20,147,162500.0,48750.0,-44.0,-51.0,-52.0,-39.0,-43.0,-51.0,-52.0,-39.0,-88.0,-89.0,-85.0,-85.0,44.0,38.0,33.0,46.0,1
3703,92:69:1D:31:68:E9,3839168,487338875,3917,3625264,3835251,483713611,0,4761,1103445,4620,1071545,141,31900,2120,10,4116,87,0,43,216660.0,130000.0,-52.0,-47.0,-42.0,-49.0,-51.0,-47.0,-43.0,-48.0,-88.0,-89.0,-85.0,-85.0,36.0,42.0,43.0,36.0,1
3704,CC:2F:71:3F:1F:24,4599437,1298832329,764186,815118718,3835251,483713611,37,613526,631587057,612808,631500665,718,86392,592110,15,764442,85828,34,508,130000.0,43333.0,-67.0,-68.0,-67.0,-74.0,-66.0,-68.0,-67.0,-73.0,-88.0,-89.0,-85.0,-85.0,21.0,21.0,18.0,11.0,1
3705,CC:2F:71:3E:C5:1F,3836123,483820234,872,106623,3835251,483713611,0,3635,305397,3000,230023,635,75374,923,8,1253,19,0,38,130000.0,39000.0,-71.0,-72.0,-69.0,-61.0,-70.0,-71.0,-68.0,-60.0,-88.0,-89.0,-85.0,-85.0,17.0,17.0,16.0,24.0,1
3706,BA:8C:B9:54:50:24,3840082,489895852,4831,6182241,3835251,483713611,0,8977,1698239,8955,1694744,22,3495,2348,15,5265,39,0,57,216660.0,130000.0,-40.0,-36.0,-45.0,-52.0,-45.0,-35.0,-43.0,-47.0,-88.0,-89.0,-85.0,-85.0,48.0,53.0,40.0,33.0,1
3707,62:47:05:9D:EB:15,3835297,483723444,40,9227,3835257,483714217,0,77,10459,66,8293,11,2166,38,0,55,0,0,4,216660.0,130000.0,-49.0,-51.0,-44.0,-50.0,-50.0,-51.0,-50.0,-54.0,-88.0,-89.0,-85.0,-85.0,39.0,38.0,41.0,35.0,1
3708,3C:55:76:E8:8F:1F,3863410,551890421,28153,68176204,3835257,483714217,20,14288,3689860,14053,3645852,235,44008,7113,17,28174,2306,20,147,162500.0,48750.0,-44.0,-49.0,-54.0,-41.0,-44.0,-48.0,-50.0,-40.0,-88.0,-89.0,-85.0,-85.0,44.0,40.0,31.0,44.0,1
3709,92:69:1D:31:68:E9,3839174,487339481,3917,3625264,3835257,483714217,0,4761,1103445,4620,1071545,141,31900,2120,10,4116,87,0,43,216660.0,130000.0,-52.0,-47.0,-42.0,-49.0,-51.0,-47.0,-43.0,-48.0,-88.0,-89.0,-85.0,-85.0,36.0,42.0,43.0,36.0,1
3710,CC:2F:71:3F:1F:24,4599659,1299096534,764402,815382317,3835257,483714217,37,613736,631856284,613018,631769892,718,86392,592301,15,764658,85834,34,508,130000.0,43333.0,-69.0,-67.0,-67.0,-70.0,-68.0,-67.0,-66.0,-70.0,-88.0,-89.0,-85.0,-85.0,19.0,22.0,18.0,15.0,1
3711,CC:2F:71:3E:C5:1F,3836129,483820840,872,106623,3835257,483714217,0,3635,305397,3000,230023,635,75374,923,8,1253,19,0,38,130000.0,39000.0,-71.0,-72.0,-69.0,-61.0,-70.0,-71.0,-68.0,-60.0,-88.0,-89.0,-85.0,-85.0,17.0,17.0,16.0,24.0,1
3712,BA:8C:B9:54:50:24,3840088,489896458,4831,6182241,3835257,483714217,0,8977,1698239,8955,1694744,22,3495,2348,15,5265,39,0,57,216660.0,130000.0,-40.0,-36.0,-45.0,-52.0,-45.0,-35.0,-43.0,-47.0,-88.0,-89.0,-85.0,-85.0,48.0,53.0,40.0,33.0,1
3713,62:47:05:9D:EB:15,3835300,483723706,40,9227,3835260,483714479,0,77,10459,66,8293,11,2166,38,0,55,0,0,4,216660.0,130000.0,-49.0,-51.0,-44.0,-50.0,-50.0,-51.0,-50.0,-54.0,-88.0,-89.0,-85.0,-85.0,39.0,38.0,41.0,35.0,1
3714,3C:55:76:E8:8F:1F,3863413,551890683,28153,68176204,3835260,483714479,20,14295,3690338,14060,3646330,235,44008,7113,17,28174,2306,20,147,162500.0,48750.0,-45.0,-52.0,-51.0,-42.0,-43.0,-50.0,-52.0,-41.0,-88.0,-89.0,-85.0,-85.0,43.0,37.0,34.0,43.0,1
3715,92:69:1D:31:68:E9,3839177,487339743,3917,3625264,3835260,483714479,0,4761,1103445,4620,1071545,141,31900,2120,10,4116,87,0,43,216660.0,130000.0,-52.0,-47.0,-42.0,-49.0,-51.0,-47.0,-43.0,-48.0,-88.0,-89.0,-85.0,-85.0,36.0,42.0,43.0,36.0,1
3716,CC:2F:71:3F:1F:24,4599874,1299360086,764614,815645607,3835260,483714479,37,613929,632107220,613211,632020828,718,86392,592485,15,764870,85850,34,508,130000.0,43333.0,-68.0,-67.0,-69.0,-70.0,-68.0,-67.0,-69.0,-70.0,-88.0,-88.0,-85.0,-85.0,20.0,21.0,16.0,15.0,1
3717,CC:2F:71:3E:C5:1F,3836132,483821102,872,106623,3835260,483714479,0,3635,305397,3000,230023,635,75374,923,8,1253,19,0,38,130000.0,39000.0,-71.0,-72.0,-69.0,-61.0,-70.0,-71.0,-68.0,-60.0,-88.0,-88.0,-85.0,-85.0,17.0,16.0,16.0,24.0,1
3718,BA:8C:B9:54:50:24,3840093,489896922,4831,6182241,3835262,483714681,0,8977,1698239,8955,1694744,22,3495,2348,15,5265,39,0,57,216660.0,130000.0,-40.0,-36.0,-45.0,-52.0,-45.0,-35.0,-43.0,-47.0,-88.0,-88.0,-85.0,-85.0,48.0,52.0,40.0,33.0,1
3719,62:47:05:9D:EB:15,3835307,483724428,41,9343,3835266,483715085,0,79,10595,68,8429,11,2166,38,0,56,0,0,4,216660.0,130000.0,-62.0,-52.0,-56.0,-56.0,-52.0,-51.0,-51.0,-53.0,-88.0,-88.0,-85.0,-85.0,26.0,36.0,29.0,29.0,1
3720,3C:55:76:E8:8F:1F,3863512,552013248,28245,68298101,3835267,483715147,20,14316,3692794,14081,3648786,235,44008,7121,17,28266,2307,20,147,172050.0,48750.0,-46.0,-52.0,-49.0,-40.0,-48.0,-50.0,-47.0,-40.0,-88.0,-88.0,-85.0,-85.0,42.0,36.0,36.0,45.0,1
3721,92:69:1D:31:68:E9,3839185,487340527,3918,3625380,3835267,483715147,0,4763,1103581,4622,1071681,141,31900,2120,10,4117,87,0,43,216660.0,130000.0,-51.0,-46.0,-42.0,-49.0,-51.0,-47.0,-43.0,-47.0,-88.0,-88.0,-85.0,-85.0,37.0,42.0,43.0,36.0,1
3722,CC:2F:71:3F:1F:24,4600089,1299620900,764822,815905753,3835267,483715147,37,614122,632363750,613403,632277240,719,86510,592670,15,765078,85856,34,508,130000.0,43333.0,-70.0,-67.0,-70.0,-69.0,-70.0,-67.0,-70.0,-69.0,-88.0,-88.0,-85.0,-85.0,18.0,21.0,15.0,16.0,1
3723,CC:2F:71:3E:C5:1F,3836140,483821830,873,106683,3835267,483715147,0,3637,305537,3002,230163,635,75374,923,8,1254,19,0,38,130000.0,39000.0,-68.0,-65.0,-66.0,-60.0,-70.0,-70.0,-68.0,-60.0,-88.0,-88.0,-85.0,-85.0,20.0,23.0,19.0,25.0,1
3724,BA:8C:B9:54:50:24,3840099,489897448,4832,6182301,3835267,483715147,0,8979,1698375,8957,1694880,22,3495,2348,15,5266,39,0,57,216660.0,130000.0,-40.0,-36.0,-45.0,-52.0,-43.0,-35.0,-44.0,-48.0,-88.0,-88.0,-85.0,-85.0,48.0,52.0,40.0,33.0,1
3725,62:47:05:9D:EB:15,3835311,483724754,41,9343,3835270,483715411,0,79,10595,68,8429,11,2166,38,0,56,0,0,4,216660.0,130000.0,-62.0,-52.0,-56.0,-56.0,-52.0,-51.0,-51.0,-53.0,-88.0,-88.0,-85.0,-85.0,26.0,36.0,29.0,29.0,1
3726,3C:55:76:E8:8F:1F,3864172,553740400,28899,70024727,3835273,483715673,20,14491,3720360,14256,3676352,235,44008,7210,17,28920,2307,20,147,195000.0,97500.0,-48.0,-51.0,-49.0,-46.0,-45.0,-51.0,-48.0,-43.0,-88.0,-88.0,-85.0,-85.0,40.0,37.0,36.0,39.0,1
3727,92:69:1D:31:68:E9,3839191,487341053,3918,3625380,3835273,483715673,0,4763,1103581,4622,1071681,141,31900,2120,10,4117,87,0,43,216660.0,130000.0,-51.0,-46.0,-42.0,-49.0,-51.0,-47.0,-43.0,-47.0,-88.0,-88.0,-85.0,-85.0,37.0,42.0,43.0,36.0,1
3728,CC:2F:71:3F:1F:24,4600307,1299884464,765032,816168589,3835275,483715875,37,614321,632629786,613602,632543276,719,86510,592855,15,765288,85865,34,508,130000.0,43333.0,-72.0,-66.0,-67.0,-71.0,-71.0,-66.0,-67.0,-71.0,-88.0,-88.0,-85.0,-85.0,16.0,22.0,18.0,14.0,1
3729,CC:2F:71:3E:C5:1F,3836151,483823033,873,106683,3835278,483716350,0,3639,305725,3003,230233,636,75492,924,8,1254,19,0,38,130000.0,39000.0,-72.0,-72.0,-70.0,-60.0,-70.0,-70.0,-68.0,-60.0,-88.0,-88.0,-85.0,-85.0,16.0,16.0,15.0,25.0,1
3730,BA:8C:B9:54:50:24,3840110,489898651,4832,6182301,3835278,483716350,0,8979,1698375,8957,1694880,22,3495,2348,15,5266,39,0,57,216660.0,130000.0,-40.0,-36.0,-45.0,-52.0,-43.0,-35.0,-44.0,-48.0,-88.0,-88.0,-85.0,-85.0,48.0,52.0,40.0,33.0,1
3731,62:47:05:9D:EB:15,3835319,483725693,41,9343,3835278,483716350,0,79,10595,68,8429,11,2166,38,0,56,0,0,4,216660.0,130000.0,-62.0,-52.0,-56.0,-56.0,-52.0,-51.0,-51.0,-53.0,-88.0,-88.0,-85.0,-85.0,26.0,36.0,29.0,29.0,1
3732,3C:55:76:E8:8F:1F,3864197,553766146,28919,70049796,3835278,483716350,20,14501,3721214,14266,3677206,235,44008,7213,17,28940,2307,20,147,195000.0,97500.0,-46.0,-55.0,-49.0,-39.0,-44.0,-53.0,-48.0,-40.0,-88.0,-88.0,-85.0,-85.0,42.0,33.0,36.0,46.0,1
3733,92:69:1D:31:68:E9,3839198,487341932,3918,3625380,3835280,483716552,0,4763,1103581,4622,1071681,141,31900,2120,10,4117,87,0,43,216660.0,130000.0,-51.0,-46.0,-42.0,-49.0,-51.0,-47.0,-43.0,-47.0,-88.0,-88.0,-85.0,-85.0,37.0,42.0,43.0,36.0,1
3734,CC:2F:71:3F:1F:24,4600528,1300151750,765248,816435198,3835280,483716552,37,614528,632894451,613809,632807941,719,86510,593046,15,765504,85865,34,508,130000.0,43333.0,-70.0,-66.0,-68.0,-72.0,-70.0,-66.0,-67.0,-72.0,-88.0,-88.0,-85.0,-85.0,18.0,22.0,17.0,13.0,1
3735,CC:2F:71:3E:C5:1F,3836153,483823235,873,106683,3835280,483716552,0,3639,305725,3003,230233,636,75492,924,8,1254,19,0,38,130000.0,39000.0,-72.0,-72.0,-70.0,-60.0,-70.0,-70.0,-68.0,-60.0,-88.0,-88.0,-85.0,-85.0,16.0,16.0,15.0,25.0,1
3736,BA:8C:B9:54:50:24,3840112,489898853,4832,6182301,3835280,483716552,0,8979,1698375,8957,1694880,22,3495,2348,15,5266,39,0,57,216660.0,130000.0,-40.0,-36.0,-45.0,-52.0,-43.0,-35.0,-44.0,-48.0,-88.0,-88.0,-85.0,-85.0,48.0,52.0,40.0,33.0,1
3737,62:47:05:9D:EB:15,3835325,483726299,41,9343,3835284,483716956,0,79,10595,68,8429,11,2166,38,0,56,0,0,4,216660.0,130000.0,-62.0,-52.0,-56.0,-56.0,-52.0,-51.0,-51.0,-53.0,-88.0,-88.0,-85.0,-85.0,26.0,36.0,29.0,29.0,1
3738,3C:55:76:E8:8F:1F,3864207,553767244,28921,70050086,3835286,483717158,20,14512,3722095,14277,3678087,235,44008,7215,17,28942,2307,20,147,206470.0,97500.0,-46.0,-53.0,-45.0,-42.0,-44.0,-51.0,-50.0,-39.0,-88.0,-88.0,-85.0,-85.0,42.0,35.0,40.0,43.0,1
3739,92:69:1D:31:68:E9,3839204,487342538,3918,3625380,3835286,483717158,0,4763,1103581,4622,1071681,141,31900,2120,10,4117,87,0,43,216660.0,130000.0,-51.0,-46.0,-42.0,-49.0,-51.0,-47.0,-43.0,-47.0,-88.0,-88.0,-85.0,-85.0,37.0,42.0,43.0,36.0,1
3740,CC:2F:71:3F:1F:24,4600743,1300415342,765457,816698184,3835286,483717158,37,614719,633149315,614000,633062805,719,86510,593231,15,765713,85866,34,508,144444.0,43333.0,-70.0,-66.0,-69.0,-71.0,-69.0,-66.0,-68.0,-71.0,-88.0,-88.0,-85.0,-85.0,18.0,22.0,16.0,14.0,1
3741,CC:2F:71:3E:C5:1F,3836159,483823841,873,106683,3835286,483717158,0,3639,305725,3003,230233,636,75492,924,8,1254,19,0,38,130000.0,39000.0,-72.0,-72.0,-70.0,-60.0,-70.0,-70.0,-68.0,-60.0,-88.0,-88.0,-85.0,-85.0,16.0,16.0,15.0,25.0,1
3742,BA:8C:B9:54:50:24,3840118,489899459,4832,6182301,3835286,483717158,0,8979,1698375,8957,1694880,22,3495,2348,15,5266,39,0,57,216660.0,130000.0,-40.0,-36.0,-45.0,-52.0,-43.0,-35.0,-44.0,-48.0,-88.0,-88.0,-85.0,-85.0,48.0,52.0,40.0,33.0,1
3743,62:47:05:9D:EB:15,3835331,483726825,41,9343,3835290,483717482,0,79,10595,68,8429,11,2166,38,0,56,0,0,4,216660.0,130000.0,-62.0,-52.0,-56.0,-56.0,-52.0,-51.0,-51.0,-53.0,-88.0,-88.0,-85.0,-85.0,26.0,36.0,29.0,29.0,1
3744,3C:55:76:E8:8F:1F,3864218,553768800,28928,70051318,3835290,483717482,20,14547,3730016,14311,3685890,236,44126,7226,17,28949,2307,20,149,206470.0,97500.0,-45.0,-58.0,-44.0,-44.0,-46.0,-57.0,-45.0,-45.0,-88.0,-88.0,-85.0,-85.0,43.0,30.0,41.0,41.0,1
3745,92:69:1D:31:68:E9,3839208,487342862,3918,3625380,3835290,483717482,0,4763,1103581,4622,1071681,141,31900,2120,10,4117,87,0,43,216660.0,130000.0,-51.0,-46.0,-42.0,-49.0,-51.0,-47.0,-43.0,-47.0,-88.0,-88.0,-85.0,-85.0,37.0,42.0,43.0,36.0,1
3746,CC:2F:71:3F:1F:24,4600957,1300681446,765667,816963964,3835290,483717482,37,614920,633415529,614201,633329019,719,86510,593417,15,765923,85896,34,508,130000.0,39000.0,-71.0,-67.0,-67.0,-72.0,-70.0,-66.0,-66.0,-71.0,-88.0,-88.0,-85.0,-85.0,17.0,21.0,18.0,13.0,1
3747,CC:2F:71:3E:C5:1F,3836163,483824165,873,106683,3835290,483717482,0,3639,305725,3003,230233,636,75492,924,8,1254,19,0,38,130000.0,39000.0,-72.0,-72.0,-70.0,-60.0,-70.0,-70.0,-68.0,-60.0,-88.0,-88.0,-85.0,-85.0,16.0,16.0,15.0,25.0,1
3748,BA:8C:B9:54:50:24,3840122,489899783,4832,6182301,3835290,483717482,0,8979,1698375,8957,1694880,22,3495,2348,15,5266,39,0,57,216660.0,130000.0,-40.0,-36.0,-45.0,-52.0,-43.0,-35.0,-44.0,-48.0,-88.0,-88.0,-85.0,-85.0,48.0,52.0,40.0,33.0,1
3749,62:47:05:9D:EB:15,3835338,483727493,41,9343,3835297,483718150,0,79,10595,68,8429,11,2166,38,0,56,0,0,4,216660.0,130000.0,-62.0,-52.0,-56.0,-56.0,-52.0,-51.0,-51.0,-53.0,-88.0,-88.0,-85.0,-85.0,26.0,36.0,29.0,29.0,1
3750,3C:55:76:E8:8F:1F,3864229,553770022,28932,70051872,3835297,483718150,20,14570,3731994,14333,3687750,237,44244,7231,17,28953,2307,20,149,206470.0,97500.0,-46.0,-55.0,-46.0,-45.0,-46.0,-53.0,-44.0,-43.0,-88.0,-88.0,-85.0,-85.0,42.0,33.0,39.0,40.0,1
3751,92:69:1D:31:68:E9,3839215,487343530,3918,3625380,3835297,483718150,0,4763,1103581,4622,1071681,141,31900,2120,10,4117,87,0,43,216660.0,130000.0,-51.0,-46.0,-42.0,-49.0,-51.0,-47.0,-43.0,-47.0,-88.0,-88.0,-85.0,-85.0,37.0,42.0,43.0,36.0,1
3752,CC:2F:71:3F:1F:24,4601182,1300948929,765885,817230779,3835297,483718150,37,615125,633675378,614406,633588868,719,86510,593611,15,766141,85901,34,508,130000.0,43333.0,-69.0,-66.0,-68.0,-72.0,-69.0,-66.0,-67.0,-72.0,-88.0,-88.0,-85.0,-85.0,19.0,22.0,17.0,13.0,1
3753,CC:2F:71:3E:C5:1F,3836170,483824833,873,106683,3835297,483718150,0,3639,305725,3003,230233,636,75492,924,8,1254,19,0,38,130000.0,39000.0,-72.0,-72.0,-70.0,-60.0,-70.0,-70.0,-68.0,-60.0,-88.0,-88.0,-85.0,-85.0,16.0,16.0,15.0,25.0,1
3754,BA:8C:B9:54:50:24,3840129,489900451,4832,6182301,3835297,483718150,0,8979,1698375,8957,1694880,22,3495,2348,15,5266,39,0,57,216660.0,130000.0,-40.0,-36.0,-45.0,-52.0,-43.0,-35.0,-44.0,-48.0,-88.0,-88.0,-85.0,-85.0,48.0,52.0,40.0,33.0,1
3755,62:47:05:9D:EB:15,3835341,483727755,41,9343,3835300,483718412,0,79,10595,68,8429,11,2166,38,0,56,0,0,4,216660.0,130000.0,-62.0,-52.0,-56.0,-56.0,-52.0,-51.0,-51.0,-53.0,-88.0,-88.0,-85.0,-85.0,26.0,36.0,29.0,29.0,1
3756,3C:55:76:E8:8F:1F,3864232,553770284,28932,70051872,3835300,483718412,20,14579,3732608,14342,3688364,237,44244,7231,17,28953,2307,20,149,206470.0,97500.0,-47.0,-56.0,-47.0,-47.0,-46.0,-54.0,-46.0,-45.0,-88.0,-88.0,-85.0,-85.0,41.0,32.0,38.0,38.0,1
3757,92:69:1D:31:68:E9,3839218,487343792,3918,3625380,3835300,483718412,0,4763,1103581,4622,1071681,141,31900,2120,10,4117,87,0,43,216660.0,130000.0,-51.0,-46.0,-42.0,-49.0,-51.0,-47.0,-43.0,-47.0,-88.0,-88.0,-85.0,-85.0,37.0,42.0,43.0,36.0,1
3758,CC:2F:71:3F:1F:24,4601391,1301209035,766091,817490623,3835300,483718412,37,615317,633929052,614598,633842542,719,86510,593796,15,766347,85902,34,509,130000.0,39000.0,-69.0,-66.0,-67.0,-73.0,-69.0,-66.0,-67.0,-73.0,-88.0,-88.0,-85.0,-85.0,19.0,22.0,18.0,12.0,1
3759,CC:2F:71:3E:C5:1F,3836173,483825095,873,106683,3835300,483718412,0,3639,305725,3003,230233,636,75492,924,8,1254,19,0,38,130000.0,39000.0,-72.0,-72.0,-70.0,-60.0,-70.0,-70.0,-68.0,-60.0,-88.0,-88.0,-85.0,-85.0,16.0,16.0,15.0,25.0,1
3760,BA:8C:B9:54:50:24,3840132,489900713,4832,6182301,3835300,483718412,0,8979,1698375,8957,1694880,22,3495,2348,15,5266,39,0,57,216660.0,130000.0,-40.0,-36.0,-45.0,-52.0,-43.0,-35.0,-44.0,-48.0,-88.0,-88.0,-85.0,-85.0,48.0,52.0,40.0,33.0,1
3761,62:47:05:9D:EB:15,3835347,483728361,41,9343,3835306,483719018,0,79,10595,68,8429,11,2166,38,0,56,0,0,4,216660.0,130000.0,-62.0,-52.0,-56.0,-56.0,-52.0,-51.0,-51.0,-53.0,-88.0,-88.0,-85.0,-85.0,26.0,36.0,29.0,29.0,1
3762,3C:55:76:E8:8F:1F,3864239,553771064,28933,70052046,3835306,483719018,20,14589,3733418,14352,3689174,237,44244,7233,17,28954,2307,20,149,206470.0,97500.0,-51.0,-63.0,-45.0,-41.0,-50.0,-60.0,-44.0,-41.0,-88.0,-88.0,-85.0,-85.0,37.0,25.0,40.0,44.0,1
3763,92:69:1D:31:68:E9,3839224,487344398,3918,3625380,3835306,483719018,0,4763,1103581,4622,1071681,141,31900,2120,10,4117,87,0,43,216660.0,130000.0,-51.0,-46.0,-42.0,-49.0,-51.0,-47.0,-43.0,-47.0,-88.0,-88.0,-85.0,-85.0,37.0,42.0,43.0,36.0,1
3764,CC:2F:71:3F:1F:24,4601605,1301472537,766299,817753519,3835306,483719018,37,615503,634176188,614784,634089678,719,86510,593978,15,766555,85905,34,509,144444.0,43333.0,-69.0,-66.0,-68.0,-72.0,-68.0,-65.0,-67.0,-72.0,-88.0,-88.0,-85.0,-85.0,19.0,22.0,17.0,13.0,1
3765,CC:2F:71:3E:C5:1F,3836179,483825701,873,106683,3835306,483719018,0,3639,305725,3003,230233,636,75492,924,8,1254,19,0,38,130000.0,39000.0,-72.0,-72.0,-70.0,-60.0,-70.0,-70.0,-68.0,-60.0,-88.0,-88.0,-85.0,-85.0,16.0,16.0,15.0,25.0,1
3766,BA:8C:B9:54:50:24,3840138,489901319,4832,6182301,3835306,483719018,0,8979,1698375,8957,1694880,22,3495,2348,15,5266,39,0,57,216660.0,130000.0,-40.0,-36.0,-45.0,-52.0,-43.0,-35.0,-44.0,-48.0,-88.0,-88.0,-85.0,-85.0,48.0,52.0,40.0,33.0,1
3767,62:47:05:9D:EB:15,3835349,483728563,41,9343,3835308,483719220,0,81,10731,70,8565,11,2166,38,0,57,0,0,4,216660.0,130000.0,-50.0,-51.0,-45.0,-45.0,-53.0,-52.0,-51.0,-52.0,-88.0,-88.0,-85.0,-85.0,38.0,37.0,40.0,40.0,1
3768,3C:55:76:E8:8F:1F,3864243,553771450,28934,70052170,3835309,483719280,20,14595,3733864,14358,3689620,237,44244,7234,17,28955,2307,20,149,206470.0,97500.0,-46.0,-58.0,-48.0,-46.0,-46.0,-57.0,-45.0,-42.0,-88.0,-88.0,-85.0,-85.0,42.0,30.0,37.0,39.0,1
3769,92:69:1D:31:68:E9,3839227,487344660,3918,3625380,3835309,483719280,0,4766,1103785,4625,1071885,141,31900,2120,10,4118,87,0,43,216660.0,130000.0,-52.0,-48.0,-43.0,-46.0,-51.0,-47.0,-43.0,-48.0,-88.0,-88.0,-85.0,-85.0,36.0,40.0,42.0,39.0,1
3770,CC:2F:71:3F:1F:24,4601816,1301735749,766505,818016267,3835311,483719482,37,615698,634432906,614979,634346396,719,86510,594166,15,766761,85907,34,509,144444.0,43333.0,-69.0,-66.0,-68.0,-73.0,-69.0,-66.0,-67.0,-73.0,-88.0,-88.0,-85.0,-85.0,19.0,22.0,17.0,12.0,1
3771,CC:2F:71:3E:C5:1F,3836186,483826367,873,106683,3835313,483719684,0,3641,305865,3005,230373,636,75492,924,8,1255,19,0,38,130000.0,39000.0,-72.0,-71.0,-71.0,-60.0,-71.0,-70.0,-69.0,-60.0,-88.0,-88.0,-85.0,-85.0,16.0,17.0,14.0,25.0,1
3772,BA:8C:B9:54:50:24,3840145,489901985,4832,6182301,3835313,483719684,0,8981,1698511,8959,1695016,22,3495,2348,15,5267,39,0,57,216660.0,130000.0,-48.0,-35.0,-43.0,-45.0,-43.0,-35.0,-44.0,-48.0,-88.0,-88.0,-85.0,-85.0,40.0,53.0,42.0,40.0,1
3773,62:47:05:9D:EB:15,3835356,483729229,41,9343,3835315,483719886,0,81,10731,70,8565,11,2166,38,0,57,0,0,4,216660.0,130000.0,-50.0,-51.0,-45.0,-45.0,-53.0,-52.0,-51.0,-52.0,-88.0,-88.0,-84.0,-85.0,38.0,37.0,39.0,40.0,1
3774,3C:55:76:E8:8F:1F,3864249,553772056,28934,70052170,3835315,483719886,20,14610,3734886,14373,3690642,237,44244,7234,17,28955,2307,20,151,206470.0,97500.0,-47.0,-57.0,-48.0,-46.0,-46.0,-57.0,-48.0,-46.0,-88.0,-88.0,-84.0,-85.0,41.0,31.0,36.0,39.0,1
3775,92:69:1D:31:68:E9,3839233,487345266,3918,3625380,3835315,483719886,0,4766,1103785,4625,1071885,141,31900,2120,10,4118,87,0,43,216660.0,130000.0,-52.0,-48.0,-43.0,-46.0,-51.0,-47.0,-43.0,-48.0,-88.0,-88.0,-84.0,-85.0,36.0,40.0,41.0,39.0,1
3776,CC:2F:71:3F:1F:24,4602040,1302006072,766723,818285984,3835317,483720088,37,615903,634695685,615184,634609175,719,86510,594361,15,766979,85915,34,509,144444.0,43333.0,-69.0,-67.0,-68.0,-73.0,-68.0,-66.0,-68.0,-72.0,-88.0,-88.0,-84.0,-85.0,19.0,21.0,16.0,12.0,1
3777,CC:2F:71:3E:C5:1F,3836190,483826771,873,106683,3835317,483720088,0,3641,305865,3005,230373,636,75492,924,8,1255,19,0,38,130000.0,39000.0,-72.0,-71.0,-71.0,-60.0,-71.0,-70.0,-69.0,-60.0,-88.0,-88.0,-84.0,-85.0,16.0,17.0,13.0,25.0,1
3778,BA:8C:B9:54:50:24,3840149,489902389,4832,6182301,3835317,483720088,0,8981,1698511,8959,1695016,22,3495,2348,15,5267,39,0,57,216660.0,130000.0,-48.0,-35.0,-43.0,-45.0,-43.0,-35.0,-44.0,-48.0,-88.0,-88.0,-84.0,-85.0,40.0,53.0,41.0,40.0,1
3779,62:47:05:9D:EB:15,3835362,483729835,41,9343,3835321,483720492,0,81,10731,70,8565,11,2166,38,0,57,0,0,4,216660.0,130000.0,-50.0,-51.0,-45.0,-45.0,-53.0,-52.0,-51.0,-52.0,-88.0,-88.0,-84.0,-85.0,38.0,37.0,39.0,40.0,1
3780,3C:55:76:E8:8F:1F,3864264,553776950,28943,70056458,3835321,483720492,20,14641,3743574,14404,3699330,237,44244,7247,17,28964,2307,20,151,216660.0,130000.0,-48.0,-55.0,-48.0,-45.0,-47.0,-53.0,-45.0,-43.0,-88.0,-88.0,-84.0,-85.0,40.0,33.0,36.0,40.0,1
3781,92:69:1D:31:68:E9,3839239,487345872,3918,3625380,3835321,483720492,0,4766,1103785,4625,1071885,141,31900,2120,10,4118,87,0,43,216660.0,130000.0,-52.0,-48.0,-43.0,-46.0,-51.0,-47.0,-43.0,-48.0,-88.0,-88.0,-84.0,-85.0,36.0,40.0,41.0,39.0,1
3782,CC:2F:71:3F:1F:24,4602253,1302269578,766931,818548952,3835322,483720626,37,616096,634953595,615377,634867085,719,86510,594547,15,767187,85948,34,509,130000.0,43333.0,-69.0,-66.0,-67.0,-71.0,-69.0,-66.0,-67.0,-71.0,-88.0,-88.0,-84.0,-85.0,19.0,22.0,17.0,14.0,1
3783,CC:2F:71:3E:C5:1F,3836196,483827371,873,106683,3835323,483720688,0,3641,305865,3005,230373,636,75492,924,8,1255,19,0,38,130000.0,39000.0,-72.0,-71.0,-71.0,-60.0,-71.0,-70.0,-69.0,-60.0,-88.0,-88.0,-84.0,-85.0,16.0,17.0,13.0,25.0,1
3784,BA:8C:B9:54:50:24,3840157,489903117,4832,6182301,3835325,483720816,0,8981,1698511,8959,1695016,22,3495,2348,15,5267,39,0,57,216660.0,130000.0,-48.0,-35.0,-43.0,-45.0,-43.0,-35.0,-44.0,-48.0,-88.0,-88.0,-84.0,-85.0,40.0,53.0,41.0,40.0,1
3785,62:47:05:9D:EB:15,3835368,483730361,41,9343,3835327,483721018,0,81,10731,70,8565,11,2166,38,0,57,0,0,4,216660.0,130000.0,-50.0,-51.0,-45.0,-45.0,-53.0,-52.0,-51.0,-52.0,-88.0,-88.0,-84.0,-85.0,38.0,37.0,39.0,40.0,1
3786,3C:55:76:E8:8F:1F,3864282,553783075,28943,70056458,3835339,483726617,20,14651,3744306,14413,3699944,238,44362,7248,17,28964,2307,20,151,216660.0,130000.0,-49.0,-53.0,-45.0,-46.0,-48.0,-53.0,-45.0,-45.0,-88.0,-88.0,-84.0,-85.0,39.0,35.0,39.0,39.0,1
3787,92:69:1D:31:68:E9,3839257,487351997,3918,3625380,3835339,483726617,0,4769,1104156,4627,1072021,142,32135,2121,10,4118,87,0,43,216660.0,130000.0,-51.0,-47.0,-42.0,-49.0,-51.0,-47.0,-42.0,-48.0,-88.0,-88.0,-84.0,-85.0,37.0,41.0,42.0,36.0,1
3788,CC:2F:71:3F:1F:24,4602494,1302557873,767155,818831256,3835339,483726617,37,616304,635229255,615585,635142745,719,86510,594746,15,767411,85948,34,509,130000.0,43333.0,-70.0,-67.0,-69.0,-71.0,-69.0,-67.0,-68.0,-71.0,-88.0,-88.0,-84.0,-85.0,18.0,21.0,15.0,14.0,1
3789,CC:2F:71:3E:C5:1F,3836212,483833300,873,106683,3835339,483726617,0,3641,305865,3005,230373,636,75492,924,8,1255,19,0,38,130000.0,39000.0,-72.0,-71.0,-71.0,-60.0,-71.0,-70.0,-69.0,-60.0,-88.0,-88.0,-84.0,-85.0,16.0,17.0,13.0,25.0,1
3790,BA:8C:B9:54:50:24,3840182,489914342,4832,6182301,3835350,483732041,0,8981,1698511,8959,1695016,22,3495,2348,15,5267,39,0,57,216660.0,130000.0,-48.0,-35.0,-43.0,-45.0,-43.0,-35.0,-44.0,-48.0,-88.0,-88.0,-84.0,-85.0,40.0,53.0,41.0,40.0,1
3791,62:47:05:9D:EB:15,3835397,483741990,41,9343,3835356,483732647,0,81,10731,70,8565,11,2166,38,0,57,0,0,4,216660.0,130000.0,-50.0,-51.0,-45.0,-45.0,-53.0,-52.0,-51.0,-52.0,-88.0,-88.0,-84.0,-85.0,38.0,37.0,39.0,40.0,1
3792,3C:55:76:E8:8F:1F,3864299,553789105,28943,70056458,3835356,483732647,20,14651,3744306,14413,3699944,238,44362,7248,17,28964,2307,20,151,216660.0,130000.0,-49.0,-53.0,-45.0,-46.0,-48.0,-53.0,-45.0,-45.0,-88.0,-88.0,-84.0,-85.0,39.0,35.0,39.0,39.0,1
3793,92:69:1D:31:68:E9,3839274,487358027,3918,3625380,3835356,483732647,0,4769,1104156,4627,1072021,142,32135,2121,10,4118,87,0,43,216660.0,130000.0,-51.0,-47.0,-42.0,-49.0,-51.0,-47.0,-42.0,-48.0,-88.0,-88.0,-84.0,-85.0,37.0,41.0,42.0,36.0,1
3794,CC:2F:71:3F:1F:24,4602739,1302847568,767383,819114921,3835356,483732647,37,616525,635511717,615806,635425207,719,86510,594952,15,767639,85960,34,509,144444.0,43333.0,-69.0,-67.0,-67.0,-71.0,-68.0,-66.0,-67.0,-70.0,-88.0,-88.0,-84.0,-85.0,19.0,21.0,17.0,14.0,1
3795,CC:2F:71:3E:C5:1F,3836229,483839330,873,106683,3835356,483732647,0,3641,305865,3005,230373,636,75492,924,8,1255,19,0,38,130000.0,39000.0,-72.0,-71.0,-71.0,-60.0,-71.0,-70.0,-69.0,-60.0,-88.0,-88.0,-84.0,-85.0,16.0,17.0,13.0,25.0,1
3796,BA:8C:B9:54:50:24,3840188,489914948,4832,6182301,3835356,483732647,0,8981,1698511,8959,1695016,22,3495,2348,15,5267,39,0,57,216660.0,130000.0,-48.0,-35.0,-43.0,-45.0,-43.0,-35.0,-44.0,-48.0,-88.0,-88.0,-84.0,-85.0,40.0,53.0,41.0,40.0,1
3797,62:47:05:9D:EB:15,3835401,483742525,41,9343,3835360,483733182,0,81,10731,70,8565,11,2166,38,0,57,0,0,4,216660.0,130000.0,-50.0,-51.0,-45.0,-45.0,-53.0,-52.0,-51.0,-52.0,-88.0,-88.0,-84.0,-85.0,38.0,37.0,39.0,40.0,1
3798,3C:55:76:E8:8F:1F,3864303,553789640,28943,70056458,3835360,483733182,20,14651,3744306,14413,3699944,238,44362,7248,17,28964,2307,20,151,216660.0,130000.0,-49.0,-53.0,-45.0,-46.0,-48.0,-53.0,-45.0,-45.0,-88.0,-88.0,-84.0,-85.0,39.0,35.0,39.0,39.0,1
3799,92:69:1D:31:68:E9,3839278,487358562,3918,3625380,3835360,483733182,0,4769,1104156,4627,1072021,142,32135,2121,10,4118,87,0,43,216660.0,130000.0,-51.0,-47.0,-42.0,-49.0,-51.0,-47.0,-42.0,-48.0,-88.0,-88.0,-84.0,-85.0,37.0,41.0,42.0,36.0,1
3800,CC:2F:71:3F:1F:24,4602952,1303112665,767592,819379483,3835360,483733182,37,616714,635762115,615995,635675605,719,86510,595138,15,767848,85962,34,509,144444.0,43333.0,-69.0,-66.0,-68.0,-71.0,-69.0,-66.0,-68.0,-71.0,-88.0,-88.0,-84.0,-85.0,19.0,22.0,16.0,14.0,1
3801,CC:2F:71:3E:C5:1F,3836235,483840067,873,106683,3835362,483733384,0,3641,305865,3005,230373,636,75492,924,8,1255,19,0,38,130000.0,39000.0,-72.0,-71.0,-71.0,-60.0,-71.0,-70.0,-69.0,-60.0,-88.0,-88.0,-84.0,-85.0,16.0,17.0,13.0,25.0,1
3802,BA:8C:B9:54:50:24,3840196,489915887,4832,6182301,3835364,483733586,0,8981,1698511,8959,1695016,22,3495,2348,15,5267,39,0,57,216660.0,130000.0,-48.0,-35.0,-43.0,-45.0,-43.0,-35.0,-44.0,-48.0,-88.0,-88.0,-84.0,-85.0,40.0,53.0,41.0,40.0,1
3803,62:47:05:9D:EB:15,3835407,483743131,41,9343,3835366,483733788,0,81,10731,70,8565,11,2166,38,0,57,0,0,4,216660.0,130000.0,-50.0,-51.0,-45.0,-45.0,-53.0,-52.0,-51.0,-52.0,-88.0,-88.0,-84.0,-85.0,38.0,37.0,39.0,40.0,1
3804,3C:55:76:E8:8F:1F,3864312,553790740,28946,70056952,3835366,483733788,20,14658,3746124,14420,3701762,238,44362,7252,17,28967,2308,20,151,216660.0,1000.0,-49.0,-53.0,-45.0,-46.0,-48.0,-52.0,-44.0,-43.0,-88.0,-88.0,-84.0,-85.0,39.0,35.0,39.0,39.0,1
3805,92:69:1D:31:68:E9,3839284,487359168,3918,3625380,3835366,483733788,0,4769,1104156,4627,1072021,142,32135,2121,10,4118,87,0,43,216660.0,130000.0,-51.0,-47.0,-42.0,-49.0,-51.0,-47.0,-42.0,-48.0,-87.0,-88.0,-84.0,-84.0,36.0,41.0,42.0,35.0,1
3806,CC:2F:71:3F:1F:24,4603165,1303376149,767799,819642361,3835366,483733788,37,616904,636016829,616185,635930319,719,86510,595321,15,768055,85962,34,509,144444.0,43333.0,-69.0,-67.0,-69.0,-71.0,-69.0,-67.0,-68.0,-71.0,-87.0,-88.0,-84.0,-84.0,18.0,21.0,15.0,13.0,1
3807,CC:2F:71:3E:C5:1F,3836239,483840471,873,106683,3835366,483733788,0,3641,305865,3005,230373,636,75492,924,8,1255,19,0,38,130000.0,39000.0,-72.0,-71.0,-71.0,-60.0,-71.0,-70.0,-69.0,-60.0,-87.0,-88.0,-84.0,-84.0,15.0,17.0,13.0,24.0,1
3808,BA:8C:B9:54:50:24,3840200,489916291,4832,6182301,3835368,483733990,0,8981,1698511,8959,1695016,22,3495,2348,15,5267,39,0,57,216660.0,130000.0,-48.0,-35.0,-43.0,-45.0,-43.0,-35.0,-44.0,-48.0,-87.0,-88.0,-84.0,-84.0,39.0,53.0,41.0,39.0,1
3809,62:47:05:9D:EB:15,3835412,483743595,41,9343,3835371,483734252,0,81,10731,70,8565,11,2166,38,0,57,0,0,4,216660.0,130000.0,-50.0,-51.0,-45.0,-45.0,-53.0,-52.0,-51.0,-52.0,-87.0,-88.0,-84.0,-84.0,37.0,37.0,39.0,39.0,1
3810,3C:55:76:E8:8F:1F,3864319,553791406,28946,70056952,3835373,483734454,20,14668,3746806,14430,3702444,238,44362,7252,17,28967,2308,20,151,216660.0,1000.0,-49.0,-54.0,-46.0,-46.0,-48.0,-53.0,-45.0,-45.0,-87.0,-88.0,-84.0,-84.0,38.0,34.0,38.0,38.0,1
3811,92:69:1D:31:68:E9,3839291,487359834,3918,3625380,3835373,483734454,0,4769,1104156,4627,1072021,142,32135,2121,10,4118,87,0,43,216660.0,130000.0,-51.0,-47.0,-42.0,-49.0,-51.0,-47.0,-42.0,-48.0,-87.0,-88.0,-84.0,-84.0,36.0,41.0,42.0,35.0,1
3812,CC:2F:71:3F:1F:24,4603380,1303639823,768007,819905369,3835373,483734454,37,617097,636273627,616378,636187117,719,86510,595506,15,768263,85962,34,509,144444.0,43333.0,-69.0,-67.0,-67.0,-71.0,-69.0,-67.0,-67.0,-70.0,-87.0,-88.0,-84.0,-84.0,18.0,21.0,17.0,13.0,1
3813,CC:2F:71:3E:C5:1F,3836246,483841137,873,106683,3835373,483734454,0,3641,305865,3005,230373,636,75492,924,8,1255,19,0,38,130000.0,39000.0,-72.0,-71.0,-71.0,-60.0,-71.0,-70.0,-69.0,-60.0,-87.0,-88.0,-84.0,-84.0,15.0,17.0,13.0,24.0,1
3814,BA:8C:B9:54:50:24,3840205,489916755,4832,6182301,3835373,483734454,0,8981,1698511,8959,1695016,22,3495,2348,15,5267,39,0,57,216660.0,130000.0,-48.0,-35.0,-43.0,-45.0,-43.0,-35.0,-44.0,-48.0,-87.0,-88.0,-84.0,-84.0,39.0,53.0,41.0,39.0,1
3815,62:47:05:9D:EB:15,3835418,483744367,41,9343,3835377,483735024,0,81,10731,70,8565,11,2166,38,0,57,0,0,4,216660.0,130000.0,-50.0,-51.0,-45.0,-45.0,-53.0,-52.0,-51.0,-52.0,-87.0,-88.0,-84.0,-84.0,37.0,37.0,39.0,39.0,1
3816,3C:55:76:E8:8F:1F,3864852,555176591,29473,71441365,3835379,483735226,20,14801,3770015,14563,3725653,238,44362,7308,17,29494,2500,20,151,206470.0,103230.0,-51.0,-55.0,-48.0,-47.0,-50.0,-54.0,-47.0,-46.0,-87.0,-88.0,-84.0,-84.0,36.0,33.0,36.0,37.0,1
3817,92:69:1D:31:68:E9,3839297,487360606,3918,3625380,3835379,483735226,0,4769,1104156,4627,1072021,142,32135,2121,10,4118,87,0,43,216660.0,130000.0,-51.0,-47.0,-42.0,-49.0,-51.0,-47.0,-42.0,-48.0,-87.0,-88.0,-84.0,-84.0,36.0,41.0,42.0,35.0,1
3818,CC:2F:71:3F:1F:24,4603609,1303919522,768230,820184296,3835379,483735226,37,617310,636553006,616591,636466496,719,86510,595705,15,768486,85963,34,509,144444.0,43333.0,-69.0,-67.0,-68.0,-71.0,-69.0,-67.0,-67.0,-70.0,-87.0,-88.0,-84.0,-84.0,18.0,21.0,16.0,13.0,1
3819,CC:2F:71:3E:C5:1F,3836252,483841909,873,106683,3835379,483735226,0,3641,305865,3005,230373,636,75492,924,8,1255,19,0,38,130000.0,39000.0,-72.0,-71.0,-71.0,-60.0,-71.0,-70.0,-69.0,-60.0,-87.0,-88.0,-84.0,-84.0,15.0,17.0,13.0,24.0,1
3820,BA:8C:B9:54:50:24,3840211,489917527,4832,6182301,3835379,483735226,0,8981,1698511,8959,1695016,22,3495,2348,15,5267,39,0,57,216660.0,130000.0,-48.0,-35.0,-43.0,-45.0,-43.0,-35.0,-44.0,-48.0,-87.0,-88.0,-84.0,-84.0,39.0,53.0,41.0,39.0,1
3821,62:47:05:9D:EB:15,3835424,483744973,41,9343,3835383,483735630,0,81,10731,70,8565,11,2166,38,0,57,0,0,4,216660.0,130000.0,-50.0,-51.0,-45.0,-45.0,-53.0,-52.0,-51.0,-52.0,-87.0,-88.0,-84.0,-84.0,37.0,37.0,39.0,39.0,1
3822,3C:55:76:E8:8F:1F,3864857,555177322,29474,71441692,3835383,483735630,20,14811,3770733,14573,3726371,238,44362,7309,17,29495,2500,20,151,206470.0,103230.0,-47.0,-56.0,-45.0,-40.0,-46.0,-55.0,-45.0,-41.0,-87.0,-88.0,-84.0,-84.0,40.0,32.0,39.0,44.0,1
3823,92:69:1D:31:68:E9,3839302,487361070,3918,3625380,3835384,483735690,0,4769,1104156,4627,1072021,142,32135,2121,10,4118,87,0,43,216660.0,130000.0,-51.0,-47.0,-42.0,-49.0,-51.0,-47.0,-42.0,-48.0,-87.0,-88.0,-84.0,-84.0,36.0,41.0,42.0,35.0,1
3824,CC:2F:71:3F:1F:24,4603824,1304183196,768438,820447304,3835386,483735892,37,617501,636807964,616782,636721454,719,86510,595889,15,768694,85964,34,509,144444.0,43333.0,-69.0,-67.0,-68.0,-72.0,-69.0,-67.0,-68.0,-71.0,-87.0,-88.0,-84.0,-84.0,18.0,21.0,16.0,12.0,1
3825,CC:2F:71:3E:C5:1F,3836259,483842575,873,106683,3835386,483735892,0,3641,305865,3005,230373,636,75492,924,8,1255,19,0,38,130000.0,39000.0,-72.0,-71.0,-71.0,-60.0,-71.0,-70.0,-69.0,-60.0,-87.0,-88.0,-84.0,-84.0,15.0,17.0,13.0,24.0,1
3826,BA:8C:B9:54:50:24,3840218,489918193,4832,6182301,3835386,483735892,0,8981,1698511,8959,1695016,22,3495,2348,15,5267,39,0,57,216660.0,130000.0,-48.0,-35.0,-43.0,-45.0,-43.0,-35.0,-44.0,-48.0,-87.0,-88.0,-84.0,-84.0,39.0,53.0,41.0,39.0,1
3827,62:47:05:9D:EB:15,3835429,483745437,41,9343,3835388,483736094,0,81,10731,70,8565,11,2166,38,0,57,0,0,4,216660.0,130000.0,-50.0,-51.0,-45.0,-45.0,-53.0,-52.0,-51.0,-52.0,-87.0,-88.0,-84.0,-84.0,37.0,37.0,39.0,39.0,1
3828,3C:55:76:E8:8F:1F,3864864,555178084,29476,71441990,3835388,483736094,20,14827,3771951,14589,3727589,238,44362,7311,17,29497,2500,20,151,206470.0,103230.0,-46.0,-56.0,-45.0,-41.0,-46.0,-56.0,-44.0,-40.0,-87.0,-88.0,-84.0,-84.0,41.0,32.0,39.0,43.0,1
3829,92:69:1D:31:68:E9,3839306,487361474,3918,3625380,3835388,483736094,0,4769,1104156,4627,1072021,142,32135,2121,10,4118,87,0,43,216660.0,130000.0,-51.0,-47.0,-42.0,-49.0,-51.0,-47.0,-42.0,-48.0,-87.0,-88.0,-84.0,-84.0,36.0,41.0,42.0,35.0,1
3830,CC:2F:71:3F:1F:24,4604034,1304446406,768646,820710312,3835388,483736094,37,617697,637067770,616978,636981260,719,86510,596076,15,768902,85966,34,509,144444.0,43333.0,-69.0,-67.0,-68.0,-71.0,-69.0,-67.0,-68.0,-71.0,-87.0,-88.0,-84.0,-84.0,18.0,21.0,16.0,13.0,1
3831,CC:2F:71:3E:C5:1F,3836261,483842777,873,106683,3835388,483736094,0,3641,305865,3005,230373,636,75492,924,8,1255,19,0,38,130000.0,39000.0,-72.0,-71.0,-71.0,-60.0,-71.0,-70.0,-69.0,-60.0,-87.0,-88.0,-84.0,-84.0,15.0,17.0,13.0,24.0,1
3832,BA:8C:B9:54:50:24,3840220,489918395,4832,6182301,3835388,483736094,0,8981,1698511,8959,1695016,22,3495,2348,15,5267,39,0,57,216660.0,130000.0,-48.0,-35.0,-43.0,-45.0,-43.0,-35.0,-44.0,-48.0,-87.0,-88.0,-84.0,-84.0,39.0,53.0,41.0,39.0,1
3833,62:47:05:9D:EB:15,3835435,483746043,41,9343,3835394,483736700,0,81,10731,70,8565,11,2166,38,0,57,0,0,4,216660.0,130000.0,-50.0,-51.0,-45.0,-45.0,-53.0,-52.0,-51.0,-52.0,-87.0,-88.0,-84.0,-84.0,37.0,37.0,39.0,39.0,1
3834,3C:55:76:E8:8F:1F,3864870,555178690,29476,71441990,3835394,483736700,20,14827,3771951,14589,3727589,238,44362,7311,17,29497,2500,20,151,206470.0,103230.0,-46.0,-56.0,-45.0,-41.0,-46.0,-56.0,-44.0,-40.0,-87.0,-88.0,-84.0,-84.0,41.0,32.0,39.0,43.0,1
3835,92:69:1D:31:68:E9,3839312,487362080,3918,3625380,3835394,483736700,0,4769,1104156,4627,1072021,142,32135,2121,10,4118,87,0,43,216660.0,130000.0,-51.0,-47.0,-42.0,-49.0,-51.0,-47.0,-42.0,-48.0,-87.0,-88.0,-84.0,-84.0,36.0,41.0,42.0,35.0,1
3836,CC:2F:71:3F:1F:24,4604257,1304716615,768863,820979915,3835394,483736700,37,617894,637319713,617175,637233203,719,86510,596268,15,769119,85967,34,509,144444.0,43333.0,-69.0,-67.0,-68.0,-71.0,-69.0,-67.0,-68.0,-71.0,-87.0,-88.0,-84.0,-84.0,18.0,21.0,16.0,13.0,1
3837,CC:2F:71:3E:C5:1F,3836267,483843383,873,106683,3835394,483736700,0,3641,305865,3005,230373,636,75492,924,8,1255,19,0,38,130000.0,39000.0,-72.0,-71.0,-71.0,-60.0,-71.0,-70.0,-69.0,-60.0,-87.0,-88.0,-84.0,-84.0,15.0,17.0,13.0,24.0,1
3838,BA:8C:B9:54:50:24,3840226,489919001,4832,6182301,3835394,483736700,0,8981,1698511,8959,1695016,22,3495,2348,15,5267,39,0,57,216660.0,130000.0,-48.0,-35.0,-43.0,-45.0,-43.0,-35.0,-44.0,-48.0,-87.0,-88.0,-84.0,-84.0,39.0,53.0,41.0,39.0,1
3839,62:47:05:9D:EB:15,3835438,483746305,41,9343,3835397,483736962,0,81,10731,70,8565,11,2166,38,0,57,0,0,4,216660.0,130000.0,-50.0,-51.0,-45.0,-45.0,-53.0,-52.0,-51.0,-52.0,-87.0,-88.0,-84.0,-84.0,37.0,37.0,39.0,39.0,1
3840,3C:55:76:E8:8F:1F,3865495,556775773,30098,73038811,3835397,483736962,20,15017,3808468,14779,3764106,238,44362,7417,17,30119,2506,20,151,258080.0,1000.0,-51.0,-55.0,-47.0,-46.0,-50.0,-54.0,-46.0,-45.0,-87.0,-88.0,-84.0,-84.0,36.0,33.0,37.0,38.0,1
3841,92:69:1D:31:68:E9,3839315,487362342,3918,3625380,3835397,483736962,0,4769,1104156,4627,1072021,142,32135,2121,10,4118,87,0,43,216660.0,130000.0,-51.0,-47.0,-42.0,-49.0,-51.0,-47.0,-42.0,-48.0,-87.0,-88.0,-84.0,-84.0,36.0,41.0,42.0,35.0,1
3842,CC:2F:71:3F:1F:24,4604472,1304980379,769073,821243215,3835399,483737164,37,618091,637583963,617372,637497453,719,86510,596452,15,769329,85974,34,509,144444.0,43333.0,-69.0,-67.0,-68.0,-72.0,-68.0,-66.0,-68.0,-71.0,-87.0,-88.0,-84.0,-84.0,18.0,21.0,16.0,12.0,1
3843,CC:2F:71:3E:C5:1F,3836272,483843847,873,106683,3835399,483737164,0,3641,305865,3005,230373,636,75492,924,8,1255,19,0,38,130000.0,39000.0,-72.0,-71.0,-71.0,-60.0,-71.0,-70.0,-69.0,-60.0,-87.0,-88.0,-84.0,-84.0,15.0,17.0,13.0,24.0,1
3844,BA:8C:B9:54:50:24,3840231,489919465,4832,6182301,3835399,483737164,0,8981,1698511,8959,1695016,22,3495,2348,15,5267,39,0,57,216660.0,130000.0,-48.0,-35.0,-43.0,-45.0,-43.0,-35.0,-44.0,-48.0,-87.0,-88.0,-84.0,-84.0,39.0,53.0,41.0,39.0,1
3845,62:47:05:9D:EB:15,3835444,483746911,41,9343,3835403,483737568,0,82,10799,71,8633,11,2166,38,0,57,0,0,4,216660.0,130000.0,-49.0,-50.0,-48.0,-46.0,-52.0,-52.0,-50.0,-52.0,-87.0,-88.0,-84.0,-84.0,38.0,38.0,36.0,38.0,1
3846,3C:55:76:E8:8F:1F,3865511,556778971,30108,73041403,3835403,483737568,20,15049,3815964,14811,3771602,238,44362,7429,17,30129,2506,20,152,258080.0,1000.0,-46.0,-56.0,-45.0,-41.0,-46.0,-54.0,-44.0,-41.0,-87.0,-88.0,-84.0,-84.0,41.0,32.0,39.0,43.0,1
3847,92:69:1D:31:68:E9,3839321,487362948,3918,3625380,3835403,483737568,0,4769,1104156,4627,1072021,142,32135,2121,10,4118,87,0,43,216660.0,130000.0,-51.0,-47.0,-42.0,-49.0,-51.0,-47.0,-42.0,-48.0,-87.0,-88.0,-84.0,-84.0,36.0,41.0,42.0,35.0,1
3848,CC:2F:71:3F:1F:24,4604688,1305247033,769285,821509465,3835403,483737568,37,618289,637845653,617570,637759143,719,86510,596640,15,769541,85979,34,509,144444.0,43333.0,-69.0,-67.0,-68.0,-71.0,-69.0,-67.0,-67.0,-71.0,-87.0,-88.0,-84.0,-84.0,18.0,21.0,16.0,13.0,1
3849,CC:2F:71:3E:C5:1F,3836276,483844251,873,106683,3835403,483737568,0,3641,305865,3005,230373,636,75492,924,8,1255,19,0,38,130000.0,39000.0,-72.0,-71.0,-71.0,-60.0,-71.0,-70.0,-69.0,-60.0,-87.0,-88.0,-84.0,-84.0,15.0,17.0,13.0,24.0,1
3850,BA:8C:B9:54:50:24,3840235,489919869,4832,6182301,3835403,483737568,0,8981,1698511,8959,1695016,22,3495,2348,15,5267,39,0,57,216660.0,130000.0,-48.0,-35.0,-43.0,-45.0,-43.0,-35.0,-44.0,-48.0,-87.0,-88.0,-84.0,-84.0,39.0,53.0,41.0,39.0,1
3851,62:47:05:9D:EB:15,3835449,483747375,41,9343,3835408,483738032,0,82,10799,71,8633,11,2166,38,0,57,0,0,4,216660.0,130000.0,-49.0,-50.0,-48.0,-46.0,-52.0,-52.0,-50.0,-52.0,-87.0,-88.0,-84.0,-84.0,38.0,38.0,36.0,38.0,1
3852,3C:55:76:E8:8F:1F,3865516,556779435,30108,73041403,3835408,483738032,20,15056,3816442,14818,3772080,238,44362,7429,17,30129,2506,20,152,258080.0,1000.0,-46.0,-57.0,-45.0,-41.0,-45.0,-56.0,-44.0,-40.0,-87.0,-88.0,-84.0,-84.0,41.0,31.0,39.0,43.0,1
3853,92:69:1D:31:68:E9,3839326,487363412,3918,3625380,3835408,483738032,0,4769,1104156,4627,1072021,142,32135,2121,10,4118,87,0,43,216660.0,130000.0,-51.0,-47.0,-42.0,-49.0,-51.0,-47.0,-42.0,-48.0,-87.0,-88.0,-84.0,-84.0,36.0,41.0,42.0,35.0,1
3854,CC:2F:71:3F:1F:24,4604899,1305503067,769489,821764833,3835410,483738234,37,618478,638096183,617759,638009673,719,86510,596820,15,769745,85980,34,509,144444.0,43333.0,-69.0,-67.0,-68.0,-71.0,-68.0,-67.0,-67.0,-70.0,-87.0,-88.0,-84.0,-84.0,18.0,21.0,16.0,13.0,1
3855,CC:2F:71:3E:C5:1F,3836283,483844917,873,106683,3835410,483738234,0,3641,305865,3005,230373,636,75492,924,8,1255,19,0,38,130000.0,39000.0,-72.0,-71.0,-71.0,-60.0,-71.0,-70.0,-69.0,-60.0,-87.0,-88.0,-84.0,-84.0,15.0,17.0,13.0,24.0,1
3856,BA:8C:B9:54:50:24,3840242,489920535,4832,6182301,3835410,483738234,0,8981,1698511,8959,1695016,22,3495,2348,15,5267,39,0,57,216660.0,130000.0,-48.0,-35.0,-43.0,-45.0,-43.0,-35.0,-44.0,-48.0,-87.0,-88.0,-84.0,-84.0,39.0,53.0,41.0,39.0,1
3857,62:47:05:9D:EB:15,3835454,483747895,42,9459,3835412,483738436,0,84,10935,73,8769,11,2166,38,0,58,0,0,4,216660.0,130000.0,-49.0,-50.0,-47.0,-46.0,-52.0,-52.0,-50.0,-50.0,-87.0,-88.0,-84.0,-84.0,38.0,38.0,37.0,38.0,1
3858,3C:55:76:E8:8F:1F,3865521,556779899,30109,73041463,3835412,483738436,20,15064,3816990,14826,3772628,238,44362,7429,17,30130,2508,20,152,229410.0,1000.0,-49.0,-54.0,-45.0,-45.0,-47.0,-52.0,-44.0,-43.0,-87.0,-88.0,-84.0,-84.0,38.0,34.0,39.0,39.0,1
3859,92:69:1D:31:68:E9,3839331,487363932,3919,3625496,3835412,483738436,0,4771,1104292,4629,1072157,142,32135,2121,10,4119,87,0,43,216660.0,130000.0,-51.0,-46.0,-42.0,-49.0,-51.0,-47.0,-42.0,-48.0,-87.0,-88.0,-84.0,-84.0,36.0,42.0,42.0,35.0,1
3860,CC:2F:71:3F:1F:24,4605117,1305768440,769705,822030004,3835412,483738436,37,618681,638355891,617962,638269381,719,86510,597009,15,769961,85980,34,509,144444.0,43333.0,-69.0,-67.0,-68.0,-72.0,-69.0,-67.0,-67.0,-71.0,-87.0,-88.0,-84.0,-84.0,18.0,21.0,16.0,12.0,1
3861,CC:2F:71:3E:C5:1F,3836288,483845437,874,106799,3835414,483738638,0,3643,306005,3007,230513,636,75492,924,8,1256,19,0,38,130000.0,39000.0,-71.0,-70.0,-70.0,-60.0,-71.0,-70.0,-69.0,-60.0,-87.0,-88.0,-84.0,-84.0,16.0,18.0,14.0,24.0,1
3862,BA:8C:B9:54:50:24,3840247,489921055,4833,6182417,3835414,483738638,0,8983,1698647,8961,1695152,22,3495,2348,15,5268,39,0,57,216660.0,130000.0,-48.0,-35.0,-43.0,-46.0,-44.0,-35.0,-43.0,-48.0,-87.0,-88.0,-84.0,-84.0,39.0,53.0,41.0,38.0,1
3863,62:47:05:9D:EB:15,3835458,483748299,42,9459,3835416,483738840,0,84,10935,73,8769,11,2166,38,0,58,0,0,4,216660.0,130000.0,-49.0,-50.0,-47.0,-46.0,-52.0,-52.0,-50.0,-50.0,-87.0,-88.0,-84.0,-84.0,38.0,38.0,37.0,38.0,1
3864,3C:55:76:E8:8F:1F,3865527,556780505,30109,73041463,3835418,483739042,20,15064,3816990,14826,3772628,238,44362,7429,17,30130,2508,20,152,229410.0,1000.0,-49.0,-54.0,-45.0,-45.0,-47.0,-52.0,-44.0,-43.0,-87.0,-88.0,-84.0,-84.0,38.0,34.0,39.0,39.0,1
3865,92:69:1D:31:68:E9,3839338,487364598,3919,3625496,3835419,483739102,0,4771,1104292,4629,1072157,142,32135,2121,10,4119,87,0,43,216660.0,130000.0,-51.0,-46.0,-42.0,-49.0,-51.0,-47.0,-42.0,-48.0,-87.0,-88.0,-84.0,-84.0,36.0,42.0,42.0,35.0,1
3866,CC:2F:71:3F:1F:24,4605330,1306029006,769911,822289904,3835419,483739102,37,618872,638606733,618153,638520223,719,86510,597191,15,770166,85985,34,509,144444.0,43333.0,-68.0,-67.0,-68.0,-71.0,-68.0,-67.0,-67.0,-70.0,-87.0,-88.0,-84.0,-84.0,19.0,21.0,16.0,13.0,1
3867,CC:2F:71:3E:C5:1F,3836295,483846103,874,106799,3835421,483739304,0,3643,306005,3007,230513,636,75492,924,8,1256,19,0,38,130000.0,39000.0,-71.0,-70.0,-70.0,-60.0,-71.0,-70.0,-69.0,-60.0,-87.0,-88.0,-84.0,-84.0,16.0,18.0,14.0,24.0,1
3868,BA:8C:B9:54:50:24,3840255,489921994,4833,6182417,3835422,483739577,0,8984,1698715,8962,1695220,22,3495,2348,15,5268,39,0,57,216660.0,130000.0,-51.0,-35.0,-43.0,-44.0,-46.0,-35.0,-43.0,-47.0,-87.0,-88.0,-84.0,-84.0,36.0,53.0,41.0,40.0,1
3869,62:47:05:9D:EB:15,3835464,483749036,42,9459,3835422,483739577,0,84,10935,73,8769,11,2166,38,0,58,0,0,4,216660.0,130000.0,-49.0,-50.0,-47.0,-46.0,-52.0,-52.0,-50.0,-50.0,-87.0,-87.0,-84.0,-84.0,38.0,37.0,37.0,38.0,1
3870,3C:55:76:E8:8F:1F,3865533,556781242,30109,73041463,3835424,483739779,20,15064,3816990,14826,3772628,238,44362,7429,17,30130,2508,20,152,229410.0,1000.0,-49.0,-54.0,-45.0,-45.0,-47.0,-52.0,-44.0,-43.0,-87.0,-87.0,-84.0,-84.0,38.0,33.0,39.0,39.0,1
3871,92:69:1D:31:68:E9,3839343,487365275,3919,3625496,3835424,483739779,0,4771,1104292,4629,1072157,142,32135,2121,10,4119,87,0,43,216660.0,130000.0,-51.0,-46.0,-42.0,-49.0,-51.0,-47.0,-42.0,-48.0,-87.0,-87.0,-84.0,-84.0,36.0,41.0,42.0,35.0,1
3872,CC:2F:71:3F:1F:24,4605542,1306289713,770118,822549934,3835424,483739779,37,619063,638857571,618344,638771061,719,86510,597374,15,770374,85988,34,509,144444.0,43333.0,-69.0,-67.0,-68.0,-70.0,-69.0,-67.0,-68.0,-70.0,-87.0,-87.0,-84.0,-84.0,18.0,20.0,16.0,14.0,1
3873,CC:2F:71:3E:C5:1F,3836298,483846578,874,106799,3835424,483739779,0,3643,306005,3007,230513,636,75492,924,8,1256,19,0,38,130000.0,39000.0,-71.0,-70.0,-70.0,-60.0,-71.0,-70.0,-69.0,-60.0,-87.0,-87.0,-84.0,-84.0,16.0,17.0,14.0,24.0,1
3874,BA:8C:B9:54:50:24,3840257,489922196,4833,6182417,3835424,483739779,0,8984,1698715,8962,1695220,22,3495,2348,15,5268,39,0,57,216660.0,130000.0,-51.0,-35.0,-43.0,-44.0,-46.0,-35.0,-43.0,-47.0,-87.0,-87.0,-84.0,-84.0,36.0,52.0,41.0,40.0,1
3875,62:47:05:9D:EB:15,3835470,483749642,42,9459,3835428,483740183,0,84,10935,73,8769,11,2166,38,0,58,0,0,4,216660.0,130000.0,-49.0,-50.0,-47.0,-46.0,-52.0,-52.0,-50.0,-50.0,-87.0,-87.0,-84.0,-84.0,38.0,37.0,37.0,38.0,1
3876,3C:55:76:E8:8F:1F,3865540,556781916,30110,73041531,3835430,483740385,20,15071,3817506,14833,3773144,238,44362,7430,17,30131,2508,20,152,229410.0,137640.0,-46.0,-55.0,-47.0,-41.0,-46.0,-53.0,-45.0,-40.0,-87.0,-87.0,-84.0,-84.0,41.0,32.0,37.0,43.0,1
3877,92:69:1D:31:68:E9,3839349,487365881,3919,3625496,3835430,483740385,0,4771,1104292,4629,1072157,142,32135,2121,10,4119,87,0,43,216660.0,130000.0,-51.0,-46.0,-42.0,-49.0,-51.0,-47.0,-42.0,-48.0,-87.0,-87.0,-84.0,-84.0,36.0,41.0,42.0,35.0,1
3878,CC:2F:71:3F:1F:24,4605765,1306559906,770335,822819521,3835430,483740385,37,619261,639113662,618542,639027152,719,86510,597568,15,770591,85989,34,509,144444.0,43333.0,-69.0,-67.0,-68.0,-71.0,-68.0,-66.0,-67.0,-70.0,-87.0,-87.0,-84.0,-84.0,18.0,20.0,16.0,13.0,1
3879,CC:2F:71:3E:C5:1F,3836304,483847184,874,106799,3835430,483740385,0,3643,306005,3007,230513,636,75492,924,8,1256,19,0,38,130000.0,39000.0,-71.0,-70.0,-70.0,-60.0,-71.0,-70.0,-69.0,-60.0,-87.0,-87.0,-84.0,-84.0,16.0,17.0,14.0,24.0,1
3880,BA:8C:B9:54:50:24,3840263,489922802,4833,6182417,3835430,483740385,0,8984,1698715,8962,1695220,22,3495,2348,15,5268,39,0,57,216660.0,130000.0,-51.0,-35.0,-43.0,-44.0,-46.0,-35.0,-43.0,-47.0,-87.0,-87.0,-84.0,-84.0,36.0,52.0,41.0,40.0,1
3881,62:47:05:9D:EB:15,3835475,483750106,42,9459,3835433,483740647,0,84,10935,73,8769,11,2166,38,0,58,0,0,4,216660.0,130000.0,-49.0,-50.0,-47.0,-46.0,-52.0,-52.0,-50.0,-50.0,-87.0,-87.0,-84.0,-84.0,38.0,37.0,37.0,38.0,1
3882,3C:55:76:E8:8F:1F,3865543,556782178,30110,73041531,3835433,483740647,20,15071,3817506,14833,3773144,238,44362,7430,17,30131,2508,20,152,229410.0,137640.0,-46.0,-55.0,-47.0,-41.0,-46.0,-53.0,-45.0,-40.0,-87.0,-87.0,-84.0,-84.0,41.0,32.0,37.0,43.0,1
3883,92:69:1D:31:68:E9,3839352,487366143,3919,3625496,3835433,483740647,0,4771,1104292,4629,1072157,142,32135,2121,10,4119,87,0,43,216660.0,130000.0,-51.0,-46.0,-42.0,-49.0,-51.0,-47.0,-42.0,-48.0,-87.0,-87.0,-84.0,-84.0,36.0,41.0,42.0,35.0,1
3884,CC:2F:71:3F:1F:24,4605978,1306823378,770543,823082529,3835435,483740849,37,619450,639365370,618731,639278860,719,86510,597753,15,770799,85991,34,509,144444.0,43333.0,-69.0,-66.0,-67.0,-70.0,-69.0,-66.0,-67.0,-70.0,-87.0,-87.0,-84.0,-84.0,18.0,21.0,17.0,14.0,1
3885,CC:2F:71:3E:C5:1F,3836309,483847648,874,106799,3835435,483740849,0,3643,306005,3007,230513,636,75492,924,8,1256,19,0,38,130000.0,39000.0,-71.0,-70.0,-70.0,-60.0,-71.0,-70.0,-69.0,-60.0,-87.0,-87.0,-84.0,-84.0,16.0,17.0,14.0,24.0,1
3886,BA:8C:B9:54:50:24,3840268,489923266,4833,6182417,3835435,483740849,0,8984,1698715,8962,1695220,22,3495,2348,15,5268,39,0,57,216660.0,130000.0,-51.0,-35.0,-43.0,-44.0,-46.0,-35.0,-43.0,-47.0,-87.0,-87.0,-84.0,-84.0,36.0,52.0,41.0,40.0,1
3887,62:47:05:9D:EB:15,3835481,483750712,42,9459,3835439,483741253,0,84,10935,73,8769,11,2166,38,0,58,0,0,4,216660.0,130000.0,-49.0,-50.0,-47.0,-46.0,-52.0,-52.0,-50.0,-50.0,-87.0,-87.0,-84.0,-84.0,38.0,37.0,37.0,38.0,1
3888,3C:55:76:E8:8F:1F,3865550,556782852,30111,73041599,3835439,483741253,20,15079,3818090,14841,3773728,238,44362,7431,17,30132,2508,20,152,229410.0,137640.0,-46.0,-57.0,-45.0,-41.0,-45.0,-55.0,-43.0,-40.0,-87.0,-87.0,-84.0,-84.0,41.0,30.0,39.0,43.0,1
3889,92:69:1D:31:68:E9,3839358,487366749,3919,3625496,3835439,483741253,0,4771,1104292,4629,1072157,142,32135,2121,10,4119,87,0,43,216660.0,130000.0,-51.0,-46.0,-42.0,-49.0,-51.0,-47.0,-42.0,-48.0,-87.0,-87.0,-84.0,-84.0,36.0,41.0,42.0,35.0,1
3890,CC:2F:71:3F:1F:24,4606193,1307087180,770754,823345927,3835439,483741253,37,619646,639626826,618927,639540316,719,86510,597936,15,771010,85993,34,509,144444.0,43333.0,-69.0,-67.0,-67.0,-71.0,-69.0,-66.0,-67.0,-70.0,-87.0,-87.0,-84.0,-84.0,18.0,20.0,17.0,13.0,1
3891,CC:2F:71:3E:C5:1F,3836313,483848052,874,106799,3835439,483741253,0,3643,306005,3007,230513,636,75492,924,8,1256,19,0,38,130000.0,39000.0,-71.0,-70.0,-70.0,-60.0,-71.0,-70.0,-69.0,-60.0,-87.0,-87.0,-84.0,-84.0,16.0,17.0,14.0,24.0,1
3892,BA:8C:B9:54:50:24,3840272,489923670,4833,6182417,3835439,483741253,0,8984,1698715,8962,1695220,22,3495,2348,15,5268,39,0,57,216660.0,130000.0,-51.0,-35.0,-43.0,-44.0,-46.0,-35.0,-43.0,-47.0,-87.0,-87.0,-84.0,-84.0,36.0,52.0,41.0,40.0,1
3893,62:47:05:9D:EB:15,3835486,483751176,42,9459,3835444,483741717,0,84,10935,73,8769,11,2166,38,0,58,0,0,4,216660.0,130000.0,-49.0,-50.0,-47.0,-46.0,-52.0,-52.0,-50.0,-50.0,-87.0,-87.0,-84.0,-84.0,38.0,37.0,37.0,38.0,1
3894,3C:55:76:E8:8F:1F,3866198,558460178,30754,74718461,3835444,483741717,20,15268,3848829,15030,3804467,238,44362,7518,17,30775,2567,20,154,206470.0,1000.0,-49.0,-53.0,-44.0,-46.0,-49.0,-53.0,-45.0,-45.0,-87.0,-87.0,-84.0,-84.0,38.0,34.0,40.0,38.0,1
3895,92:69:1D:31:68:E9,3839363,487367213,3919,3625496,3835444,483741717,0,4771,1104292,4629,1072157,142,32135,2121,10,4119,87,0,43,216660.0,130000.0,-51.0,-46.0,-42.0,-49.0,-51.0,-47.0,-42.0,-48.0,-87.0,-87.0,-84.0,-84.0,36.0,41.0,42.0,35.0,1
3896,CC:2F:71:3F:1F:24,4606406,1307350638,770962,823608921,3835444,483741717,37,619848,639891988,619129,639805478,719,86510,598121,15,771218,86000,34,509,144444.0,43333.0,-70.0,-67.0,-69.0,-71.0,-69.0,-67.0,-68.0,-71.0,-87.0,-87.0,-84.0,-84.0,17.0,20.0,15.0,13.0,1
3897,CC:2F:71:3E:C5:1F,3836318,483848516,874,106799,3835444,483741717,0,3643,306005,3007,230513,636,75492,924,8,1256,19,0,38,130000.0,39000.0,-71.0,-70.0,-70.0,-60.0,-71.0,-70.0,-69.0,-60.0,-87.0,-87.0,-84.0,-84.0,16.0,17.0,14.0,24.0,1
3898,BA:8C:B9:54:50:24,3840277,489924134,4833,6182417,3835444,483741717,0,8984,1698715,8962,1695220,22,3495,2348,15,5268,39,0,57,216660.0,130000.0,-51.0,-35.0,-43.0,-44.0,-46.0,-35.0,-43.0,-47.0,-87.0,-87.0,-84.0,-84.0,36.0,52.0,41.0,40.0,1
3899,62:47:05:9D:EB:15,3835492,483751704,42,9459,3835450,483742245,0,84,10935,73,8769,11,2166,38,0,58,0,0,4,216660.0,130000.0,-49.0,-50.0,-47.0,-46.0,-52.0,-52.0,-50.0,-50.0,-87.0,-87.0,-84.0,-84.0,38.0,37.0,37.0,38.0,1
3900,3C:55:76:E8:8F:1F,3866205,558460824,30755,74718579,3835450,483742245,20,15284,3850099,15045,3805619,239,44480,7521,17,30776,2567,20,154,206470.0,103230.0,-49.0,-53.0,-45.0,-46.0,-48.0,-51.0,-43.0,-43.0,-87.0,-87.0,-84.0,-84.0,38.0,34.0,39.0,38.0,1
3901,92:69:1D:31:68:E9,3839369,487367741,3919,3625496,3835450,483742245,0,4771,1104292,4629,1072157,142,32135,2121,10,4119,87,0,43,216660.0,130000.0,-51.0,-46.0,-42.0,-49.0,-51.0,-47.0,-42.0,-48.0,-87.0,-87.0,-84.0,-84.0,36.0,41.0,42.0,35.0,1
3902,CC:2F:71:3F:1F:24,4606624,1307612983,771174,823870738,3835450,483742245,37,620051,640156001,619332,640069491,719,86510,598311,15,771430,86004,34,509,144444.0,43333.0,-68.0,-67.0,-68.0,-72.0,-68.0,-66.0,-68.0,-72.0,-87.0,-87.0,-84.0,-84.0,19.0,20.0,16.0,12.0,1
3903,CC:2F:71:3E:C5:1F,3836324,483849044,874,106799,3835450,483742245,0,3645,306193,3008,230583,637,75610,925,8,1256,19,0,39,130000.0,39000.0,-71.0,-71.0,-70.0,-60.0,-72.0,-72.0,-70.0,-61.0,-87.0,-87.0,-84.0,-84.0,16.0,16.0,14.0,24.0,1
3904,BA:8C:B9:54:50:24,3840285,489924864,4833,6182417,3835452,483742447,0,8984,1698715,8962,1695220,22,3495,2348,15,5268,39,0,57,216660.0,130000.0,-51.0,-35.0,-43.0,-44.0,-46.0,-35.0,-43.0,-47.0,-87.0,-87.0,-84.0,-84.0,36.0,52.0,41.0,40.0,1
3905,62:47:05:9D:EB:15,3835497,483752170,42,9459,3835455,483742711,0,86,11071,75,8905,11,2166,38,0,59,0,0,4,216660.0,130000.0,-48.0,-51.0,-47.0,-45.0,-52.0,-53.0,-50.0,-50.0,-87.0,-87.0,-84.0,-84.0,39.0,36.0,37.0,39.0,1
3906,3C:55:76:E8:8F:1F,3866211,558461350,30755,74718579,3835456,483742771,20,15291,3850629,15051,3806031,240,44598,7522,17,30776,2567,20,155,206470.0,103230.0,-44.0,-56.0,-48.0,-42.0,-44.0,-52.0,-45.0,-40.0,-87.0,-87.0,-84.0,-84.0,43.0,31.0,36.0,42.0,1
3907,92:69:1D:31:68:E9,3839375,487368267,3919,3625496,3835456,483742771,0,4773,1104428,4631,1072293,142,32135,2121,10,4120,87,0,43,216660.0,130000.0,-47.0,-34.0,-40.0,-44.0,-51.0,-45.0,-42.0,-47.0,-87.0,-87.0,-84.0,-84.0,40.0,53.0,44.0,40.0,1
3908,CC:2F:71:3F:1F:24,4606838,1307874964,771382,824132193,3835456,483742771,37,620249,640413334,619530,640326824,719,86510,598496,15,771638,86009,34,509,144444.0,43333.0,-69.0,-66.0,-67.0,-70.0,-69.0,-66.0,-67.0,-70.0,-87.0,-87.0,-84.0,-84.0,18.0,21.0,17.0,14.0,1
3909,CC:2F:71:3E:C5:1F,3836332,483849772,874,106799,3835458,483742973,0,3645,306193,3008,230583,637,75610,925,8,1256,19,0,39,130000.0,39000.0,-71.0,-71.0,-70.0,-60.0,-72.0,-72.0,-70.0,-61.0,-87.0,-87.0,-84.0,-84.0,16.0,16.0,14.0,24.0,1
3910,BA:8C:B9:54:50:24,3840293,489925592,4833,6182417,3835460,483743175,0,8986,1698851,8964,1695356,22,3495,2348,15,5269,39,0,58,216660.0,130000.0,-39.0,-37.0,-45.0,-52.0,-45.0,-35.0,-43.0,-47.0,-87.0,-87.0,-84.0,-84.0,48.0,50.0,39.0,32.0,1
3911,62:47:05:9D:EB:15,3835503,483752696,42,9459,3835461,483743237,0,86,11071,75,8905,11,2166,38,0,59,0,0,4,216660.0,130000.0,-48.0,-51.0,-47.0,-45.0,-52.0,-53.0,-50.0,-50.0,-87.0,-87.0,-84.0,-84.0,39.0,36.0,37.0,39.0,1
3912,3C:55:76:E8:8F:1F,3866592,559448784,31129,75705345,3835463,483743439,20,15379,3864795,15139,3820197,240,44598,7565,17,31150,2573,20,155,229410.0,130000.0,-44.0,-55.0,-48.0,-42.0,-48.0,-52.0,-48.0,-46.0,-87.0,-87.0,-84.0,-84.0,43.0,32.0,36.0,42.0,1
3913,92:69:1D:31:68:E9,3839382,487368935,3919,3625496,3835463,483743439,0,4773,1104428,4631,1072293,142,32135,2121,10,4120,87,0,43,216660.0,130000.0,-47.0,-34.0,-40.0,-44.0,-51.0,-45.0,-42.0,-47.0,-87.0,-87.0,-84.0,-84.0,40.0,53.0,44.0,40.0,1
3914,CC:2F:71:3F:1F:24,4607061,1308151072,771598,824407633,3835463,483743439,37,620455,640691350,619735,640604722,720,86628,598689,15,771854,86032,34,509,144444.0,43333.0,-69.0,-67.0,-67.0,-71.0,-69.0,-66.0,-67.0,-71.0,-87.0,-87.0,-84.0,-84.0,18.0,20.0,17.0,13.0,1
3915,CC:2F:71:3E:C5:1F,3836337,483850238,874,106799,3835463,483743439,0,3645,306193,3008,230583,637,75610,925,8,1256,19,0,39,130000.0,39000.0,-71.0,-71.0,-70.0,-60.0,-72.0,-72.0,-70.0,-61.0,-87.0,-87.0,-84.0,-84.0,16.0,16.0,14.0,24.0,1
3916,BA:8C:B9:54:50:24,3840296,489925856,4833,6182417,3835463,483743439,0,8986,1698851,8964,1695356,22,3495,2348,15,5269,39,0,58,216660.0,130000.0,-39.0,-37.0,-45.0,-52.0,-45.0,-35.0,-43.0,-47.0,-87.0,-87.0,-84.0,-84.0,48.0,50.0,39.0,32.0,1
3917,62:47:05:9D:EB:15,3835511,483753498,42,9459,3835469,483744039,0,86,11071,75,8905,11,2166,38,0,59,0,0,4,216660.0,130000.0,-48.0,-51.0,-47.0,-45.0,-52.0,-53.0,-50.0,-50.0,-87.0,-87.0,-84.0,-84.0,39.0,36.0,37.0,39.0,1
3918,3C:55:76:E8:8F:1F,3866970,560404194,31500,76660087,3835470,483744107,20,15500,3889768,15259,3845052,241,44716,7618,17,31521,2579,20,155,216660.0,130000.0,-46.0,-51.0,-45.0,-45.0,-45.0,-52.0,-47.0,-43.0,-87.0,-87.0,-84.0,-84.0,41.0,36.0,39.0,39.0,1
3919,92:69:1D:31:68:E9,3839391,487369887,3921,3625780,3835470,483744107,0,4781,1105108,4639,1072973,142,32135,2123,10,4122,87,0,43,216660.0,130000.0,-52.0,-47.0,-42.0,-49.0,-51.0,-47.0,-43.0,-49.0,-87.0,-87.0,-84.0,-84.0,35.0,40.0,42.0,35.0,1
3920,CC:2F:71:3F:1F:24,4607305,1308432973,771835,824688866,3835470,483744107,37,620679,640967134,619959,640880506,720,86628,598900,15,772091,86056,34,510,144444.0,43333.0,-69.0,-66.0,-68.0,-71.0,-69.0,-66.0,-67.0,-71.0,-87.0,-87.0,-84.0,-84.0,18.0,21.0,16.0,13.0,1
3921,CC:2F:71:3E:C5:1F,3836344,483850906,874,106799,3835470,483744107,0,3645,306193,3008,230583,637,75610,925,8,1256,19,0,39,130000.0,39000.0,-71.0,-71.0,-70.0,-60.0,-72.0,-72.0,-70.0,-61.0,-87.0,-87.0,-84.0,-84.0,16.0,16.0,14.0,24.0,1
3922,BA:8C:B9:54:50:24,3840304,489926584,4833,6182417,3835471,483744167,0,8986,1698851,8964,1695356,22,3495,2348,15,5269,39,0,58,216660.0,130000.0,-39.0,-37.0,-45.0,-52.0,-45.0,-35.0,-43.0,-47.0,-87.0,-87.0,-84.0,-84.0,48.0,50.0,39.0,32.0,1
3923,62:47:05:9D:EB:15,3835515,483753828,42,9459,3835473,483744369,0,86,11071,75,8905,11,2166,38,0,59,0,0,4,216660.0,130000.0,-48.0,-51.0,-47.0,-45.0,-52.0,-53.0,-50.0,-50.0,-87.0,-87.0,-84.0,-84.0,39.0,36.0,37.0,39.0,1
3924,3C:55:76:E8:8F:1F,3866976,560407164,31503,76662795,3835473,483744369,20,15512,3890706,15271,3845990,241,44716,7620,17,31524,2579,20,155,216660.0,130000.0,-45.0,-58.0,-51.0,-41.0,-44.0,-57.0,-50.0,-41.0,-87.0,-87.0,-84.0,-84.0,42.0,29.0,33.0,43.0,1
3925,92:69:1D:31:68:E9,3839396,487370351,3921,3625780,3835475,483744571,0,4781,1105108,4639,1072973,142,32135,2123,10,4122,87,0,43,216660.0,130000.0,-52.0,-47.0,-42.0,-49.0,-51.0,-47.0,-43.0,-49.0,-87.0,-87.0,-84.0,-84.0,35.0,40.0,42.0,35.0,1
3926,CC:2F:71:3F:1F:24,4607519,1308695137,772044,824950566,3835475,483744571,37,620869,641218962,620149,641132334,720,86628,599085,15,772300,86075,34,510,144444.0,43333.0,-69.0,-66.0,-67.0,-71.0,-69.0,-66.0,-67.0,-70.0,-87.0,-87.0,-84.0,-84.0,18.0,21.0,17.0,13.0,1
3927,CC:2F:71:3E:C5:1F,3836349,483851370,874,106799,3835475,483744571,0,3645,306193,3008,230583,637,75610,925,8,1256,19,0,39,130000.0,39000.0,-71.0,-71.0,-70.0,-60.0,-72.0,-72.0,-70.0,-61.0,-87.0,-87.0,-84.0,-84.0,16.0,16.0,14.0,24.0,1
3928,BA:8C:B9:54:50:24,3840308,489926988,4833,6182417,3835475,483744571,0,8986,1698851,8964,1695356,22,3495,2348,15,5269,39,0,58,216660.0,130000.0,-39.0,-37.0,-45.0,-52.0,-45.0,-35.0,-43.0,-47.0,-87.0,-87.0,-84.0,-84.0,48.0,50.0,39.0,32.0,1
3929,62:47:05:9D:EB:15,3835521,483754434,42,9459,3835479,483744975,0,86,11071,75,8905,11,2166,38,0,59,0,0,4,216660.0,130000.0,-48.0,-51.0,-47.0,-45.0,-52.0,-53.0,-50.0,-50.0,-87.0,-87.0,-84.0,-84.0,39.0,36.0,37.0,39.0,1
3930,3C:55:76:E8:8F:1F,3866985,560408720,31506,76663745,3835479,483744975,20,15529,3892824,15288,3848108,241,44716,7623,17,31527,2579,20,155,216660.0,130000.0,-49.0,-53.0,-45.0,-45.0,-48.0,-52.0,-44.0,-45.0,-87.0,-87.0,-84.0,-84.0,38.0,34.0,39.0,39.0,1
3931,92:69:1D:31:68:E9,3839400,487370755,3921,3625780,3835479,483744975,0,4781,1105108,4639,1072973,142,32135,2123,10,4122,87,0,43,216660.0,130000.0,-52.0,-47.0,-42.0,-49.0,-51.0,-47.0,-43.0,-49.0,-87.0,-87.0,-84.0,-84.0,35.0,40.0,42.0,35.0,1
3932,CC:2F:71:3F:1F:24,4607732,1308955831,772253,825210856,3835479,483744975,37,621070,641479480,620350,641392852,720,86628,599271,15,772509,86077,34,510,144444.0,43333.0,-69.0,-67.0,-68.0,-71.0,-69.0,-67.0,-67.0,-71.0,-87.0,-87.0,-84.0,-84.0,18.0,20.0,16.0,13.0,1
3933,CC:2F:71:3E:C5:1F,3836353,483851774,874,106799,3835479,483744975,0,3645,306193,3008,230583,637,75610,925,8,1256,19,0,39,130000.0,39000.0,-71.0,-71.0,-70.0,-60.0,-72.0,-72.0,-70.0,-61.0,-87.0,-87.0,-84.0,-84.0,16.0,16.0,14.0,24.0,1
3934,BA:8C:B9:54:50:24,3840312,489927392,4833,6182417,3835479,483744975,0,8986,1698851,8964,1695356,22,3495,2348,15,5269,39,0,58,216660.0,130000.0,-39.0,-37.0,-45.0,-52.0,-45.0,-35.0,-43.0,-47.0,-87.0,-87.0,-84.0,-84.0,48.0,50.0,39.0,32.0,1
3935,62:47:05:9D:EB:15,3835527,483755171,42,9459,3835485,483745712,0,86,11071,75,8905,11,2166,38,0,59,0,0,4,216660.0,130000.0,-48.0,-51.0,-47.0,-45.0,-52.0,-53.0,-50.0,-50.0,-87.0,-87.0,-84.0,-84.0,39.0,36.0,37.0,39.0,1
3936,3C:55:76:E8:8F:1F,3866991,560409457,31506,76663745,3835485,483745712,20,15533,3893098,15292,3848382,241,44716,7623,17,31527,2579,20,155,216660.0,130000.0,-49.0,-53.0,-45.0,-45.0,-48.0,-52.0,-44.0,-45.0,-87.0,-87.0,-84.0,-84.0,38.0,34.0,39.0,39.0,1
3937,92:69:1D:31:68:E9,3839406,487371492,3921,3625780,3835485,483745712,0,4781,1105108,4639,1072973,142,32135,2123,10,4122,87,0,43,216660.0,130000.0,-52.0,-47.0,-42.0,-49.0,-51.0,-47.0,-43.0,-49.0,-87.0,-87.0,-84.0,-84.0,35.0,40.0,42.0,35.0,1
3938,CC:2F:71:3F:1F:24,4607946,1309216728,772461,825471016,3835485,483745712,37,621262,641733112,620542,641646484,720,86628,599455,15,772717,86077,34,510,144444.0,43333.0,-69.0,-67.0,-68.0,-72.0,-69.0,-67.0,-67.0,-72.0,-87.0,-87.0,-84.0,-84.0,18.0,20.0,16.0,12.0,1
3939,CC:2F:71:3E:C5:1F,3836359,483852511,874,106799,3835485,483745712,0,3645,306193,3008,230583,637,75610,925,8,1256,19,0,39,130000.0,39000.0,-71.0,-71.0,-70.0,-60.0,-72.0,-72.0,-70.0,-61.0,-87.0,-87.0,-84.0,-84.0,16.0,16.0,14.0,24.0,1
3940,BA:8C:B9:54:50:24,3840318,489928129,4833,6182417,3835485,483745712,0,8986,1698851,8964,1695356,22,3495,2348,15,5269,39,0,58,216660.0,130000.0,-39.0,-37.0,-45.0,-52.0,-45.0,-35.0,-43.0,-47.0,-87.0,-87.0,-84.0,-84.0,48.0,50.0,39.0,32.0,1
3941,62:47:05:9D:EB:15,3835531,483755575,42,9459,3835489,483746116,0,86,11071,75,8905,11,2166,38,0,59,0,0,4,216660.0,130000.0,-48.0,-51.0,-47.0,-45.0,-52.0,-53.0,-50.0,-50.0,-87.0,-87.0,-84.0,-84.0,39.0,36.0,37.0,39.0,1
3942,3C:55:76:E8:8F:1F,3866995,560409861,31506,76663745,3835489,483746116,20,15533,3893098,15292,3848382,241,44716,7623,17,31527,2579,20,155,216660.0,130000.0,-49.0,-53.0,-45.0,-45.0,-48.0,-52.0,-44.0,-45.0,-87.0,-87.0,-84.0,-84.0,38.0,34.0,39.0,39.0,1
3943,92:69:1D:31:68:E9,3839410,487371896,3921,3625780,3835489,483746116,0,4781,1105108,4639,1072973,142,32135,2123,10,4122,87,0,43,216660.0,130000.0,-52.0,-47.0,-42.0,-49.0,-51.0,-47.0,-43.0,-49.0,-87.0,-87.0,-84.0,-84.0,35.0,40.0,42.0,35.0,1
3944,CC:2F:71:3F:1F:24,4608164,1309477833,772675,825731717,3835489,483746116,37,621464,641987194,620744,641900566,720,86628,599646,15,772931,86083,34,510,144444.0,43333.0,-67.0,-66.0,-67.0,-70.0,-67.0,-66.0,-66.0,-70.0,-87.0,-87.0,-84.0,-84.0,20.0,21.0,17.0,14.0,1
3945,CC:2F:71:3E:C5:1F,3836363,483852915,874,106799,3835489,483746116,0,3645,306193,3008,230583,637,75610,925,8,1256,19,0,39,130000.0,39000.0,-71.0,-71.0,-70.0,-60.0,-72.0,-72.0,-70.0,-61.0,-87.0,-87.0,-84.0,-84.0,16.0,16.0,14.0,24.0,1
3946,BA:8C:B9:54:50:24,3840322,489928533,4833,6182417,3835489,483746116,0,8986,1698851,8964,1695356,22,3495,2348,15,5269,39,0,58,216660.0,130000.0,-39.0,-37.0,-45.0,-52.0,-45.0,-35.0,-43.0,-47.0,-87.0,-87.0,-84.0,-84.0,48.0,50.0,39.0,32.0,1
3947,62:47:05:9D:EB:15,3835536,483756039,42,9459,3835494,483746580,0,86,11071,75,8905,11,2166,38,0,59,0,0,4,216660.0,130000.0,-48.0,-51.0,-47.0,-45.0,-52.0,-53.0,-50.0,-50.0,-87.0,-87.0,-84.0,-84.0,39.0,36.0,37.0,39.0,1
3948,3C:55:76:E8:8F:1F,3867002,560410613,31508,76664033,3835494,483746580,20,15547,3894162,15306,3849446,241,44716,7626,17,31529,2581,20,155,216660.0,130000.0,-44.0,-54.0,-51.0,-39.0,-43.0,-54.0,-50.0,-39.0,-87.0,-87.0,-84.0,-84.0,43.0,33.0,33.0,45.0,1
3949,92:69:1D:31:68:E9,3839415,487372360,3921,3625780,3835494,483746580,0,4781,1105108,4639,1072973,142,32135,2123,10,4122,87,0,43,216660.0,130000.0,-52.0,-47.0,-42.0,-49.0,-51.0,-47.0,-43.0,-49.0,-87.0,-87.0,-84.0,-84.0,35.0,40.0,42.0,35.0,1
3950,CC:2F:71:3F:1F:24,4608377,1309741305,772883,825994725,3835494,483746580,37,621651,642237330,620931,642150702,720,86628,599829,15,773139,86095,34,512,144444.0,43333.0,-67.0,-66.0,-67.0,-69.0,-66.0,-66.0,-66.0,-69.0,-87.0,-87.0,-84.0,-84.0,20.0,21.0,17.0,15.0,1
3951,CC:2F:71:3E:C5:1F,3836368,483853379,874,106799,3835494,483746580,0,3645,306193,3008,230583,637,75610,925,8,1256,19,0,39,130000.0,39000.0,-71.0,-71.0,-70.0,-60.0,-72.0,-72.0,-70.0,-61.0,-87.0,-87.0,-84.0,-84.0,16.0,16.0,14.0,24.0,1
3952,BA:8C:B9:54:50:24,3840327,489928997,4833,6182417,3835494,483746580,0,8986,1698851,8964,1695356,22,3495,2348,15,5269,39,0,58,216660.0,130000.0,-39.0,-37.0,-45.0,-52.0,-45.0,-35.0,-43.0,-47.0,-87.0,-87.0,-84.0,-84.0,48.0,50.0,39.0,32.0,1
3953,62:47:05:9D:EB:15,3835541,483756569,42,9459,3835499,483747110,0,86,11071,75,8905,11,2166,38,0,59,0,0,4,216660.0,130000.0,-48.0,-51.0,-47.0,-45.0,-52.0,-53.0,-50.0,-50.0,-87.0,-87.0,-84.0,-84.0,39.0,36.0,37.0,39.0,1
3954,3C:55:76:E8:8F:1F,3867007,560411143,31508,76664033,3835499,483747110,20,15548,3894232,15307,3849516,241,44716,7626,17,31529,2581,20,155,216660.0,130000.0,-45.0,-55.0,-51.0,-40.0,-44.0,-54.0,-50.0,-39.0,-87.0,-87.0,-84.0,-84.0,42.0,32.0,33.0,44.0,1
3955,92:69:1D:31:68:E9,3839422,487373122,3923,3626012,3835499,483747110,0,4787,1105596,4645,1073461,142,32135,2125,10,4124,87,0,43,216660.0,130000.0,-51.0,-48.0,-44.0,-46.0,-51.0,-47.0,-43.0,-48.0,-87.0,-87.0,-84.0,-84.0,36.0,39.0,40.0,38.0,1
3956,CC:2F:71:3F:1F:24,4608592,1310004991,773093,826257881,3835499,483747110,37,621840,642490490,621120,642403862,720,86628,600014,15,773350,86115,34,512,144444.0,43333.0,-66.0,-67.0,-67.0,-69.0,-66.0,-66.0,-67.0,-69.0,-87.0,-87.0,-84.0,-84.0,21.0,20.0,17.0,15.0,1
3957,CC:2F:71:3E:C5:1F,3836373,483853909,874,106799,3835499,483747110,0,3645,306193,3008,230583,637,75610,925,8,1256,19,0,39,130000.0,39000.0,-71.0,-71.0,-70.0,-60.0,-72.0,-72.0,-70.0,-61.0,-87.0,-87.0,-84.0,-84.0,16.0,16.0,14.0,24.0,1
3958,BA:8C:B9:54:50:24,3840332,489929527,4833,6182417,3835499,483747110,0,8986,1698851,8964,1695356,22,3495,2348,15,5269,39,0,58,216660.0,130000.0,-39.0,-37.0,-45.0,-52.0,-45.0,-35.0,-43.0,-47.0,-87.0,-87.0,-84.0,-84.0,48.0,50.0,39.0,32.0,1
3959,62:47:05:9D:EB:15,3835545,483756973,42,9459,3835503,483747514,0,86,11071,75,8905,11,2166,38,0,59,0,0,4,216660.0,130000.0,-48.0,-51.0,-47.0,-45.0,-52.0,-53.0,-50.0,-50.0,-87.0,-87.0,-84.0,-84.0,39.0,36.0,37.0,39.0,1
3960,3C:55:76:E8:8F:1F,3867011,560411547,31508,76664033,3835503,483747514,20,15548,3894232,15307,3849516,241,44716,7626,17,31529,2581,20,155,216660.0,130000.0,-45.0,-55.0,-51.0,-40.0,-44.0,-54.0,-50.0,-39.0,-87.0,-87.0,-84.0,-84.0,42.0,32.0,33.0,44.0,1
3961,92:69:1D:31:68:E9,3839426,487373526,3923,3626012,3835503,483747514,0,4787,1105596,4645,1073461,142,32135,2125,10,4124,87,0,43,216660.0,130000.0,-51.0,-48.0,-44.0,-46.0,-51.0,-47.0,-43.0,-48.0,-87.0,-87.0,-84.0,-84.0,36.0,39.0,40.0,38.0,1
3962,CC:2F:71:3F:1F:24,4608817,1310272596,773312,826524880,3835505,483747716,37,622038,642745233,621318,642658605,720,86628,600206,15,773569,86129,34,512,144444.0,43333.0,-67.0,-66.0,-66.0,-69.0,-66.0,-66.0,-66.0,-69.0,-87.0,-87.0,-84.0,-84.0,20.0,21.0,18.0,15.0,1
3963,CC:2F:71:3E:C5:1F,3836382,483854777,874,106799,3835508,483747978,0,3645,306193,3008,230583,637,75610,925,8,1256,19,0,39,130000.0,39000.0,-71.0,-71.0,-70.0,-60.0,-72.0,-72.0,-70.0,-61.0,-87.0,-87.0,-84.0,-84.0,16.0,16.0,14.0,24.0,1
3964,BA:8C:B9:54:50:24,3840341,489930395,4833,6182417,3835508,483747978,0,8986,1698851,8964,1695356,22,3495,2348,15,5269,39,0,58,216660.0,130000.0,-39.0,-37.0,-45.0,-52.0,-45.0,-35.0,-43.0,-47.0,-87.0,-87.0,-84.0,-84.0,48.0,50.0,39.0,32.0,1
3965,62:47:05:9D:EB:15,3835550,483757437,42,9459,3835508,483747978,0,86,11071,75,8905,11,2166,38,0,59,0,0,4,216660.0,130000.0,-48.0,-51.0,-47.0,-45.0,-52.0,-53.0,-50.0,-50.0,-87.0,-87.0,-84.0,-84.0,39.0,36.0,37.0,39.0,1
3966,3C:55:76:E8:8F:1F,3867848,562608191,32338,78860011,3835510,483748180,20,15772,3926707,15531,3881991,241,44716,7720,17,32359,2860,20,155,206470.0,103230.0,-51.0,-57.0,-52.0,-45.0,-47.0,-51.0,-46.0,-43.0,-87.0,-87.0,-84.0,-84.0,36.0,30.0,32.0,39.0,1
3967,92:69:1D:31:68:E9,3839435,487374394,3923,3626012,3835512,483748382,0,4787,1105596,4645,1073461,142,32135,2125,10,4124,87,0,43,216660.0,130000.0,-51.0,-48.0,-44.0,-46.0,-51.0,-47.0,-43.0,-48.0,-87.0,-87.0,-84.0,-84.0,36.0,39.0,40.0,38.0,1
3968,CC:2F:71:3F:1F:24,4609054,1310564706,773542,826816324,3835512,483748382,37,622245,643020713,621525,642934085,720,86628,600409,15,773797,86163,34,512,144444.0,43333.0,-67.0,-67.0,-66.0,-69.0,-66.0,-66.0,-66.0,-69.0,-87.0,-87.0,-84.0,-84.0,20.0,20.0,18.0,15.0,1
3969,CC:2F:71:3E:C5:1F,3836386,483855181,874,106799,3835512,483748382,0,3645,306193,3008,230583,637,75610,925,8,1256,19,0,39,130000.0,39000.0,-71.0,-71.0,-70.0,-60.0,-72.0,-72.0,-70.0,-61.0,-87.0,-87.0,-84.0,-84.0,16.0,16.0,14.0,24.0,1
3970,BA:8C:B9:54:50:24,3840345,489930799,4833,6182417,3835512,483748382,0,8986,1698851,8964,1695356,22,3495,2348,15,5269,39,0,58,216660.0,130000.0,-39.0,-37.0,-45.0,-52.0,-45.0,-35.0,-43.0,-47.0,-87.0,-87.0,-84.0,-84.0,48.0,50.0,39.0,32.0,1
3971,62:47:05:9D:EB:15,3835558,483758245,42,9459,3835516,483748786,0,86,11071,75,8905,11,2166,38,0,59,0,0,4,216660.0,130000.0,-48.0,-51.0,-47.0,-45.0,-52.0,-53.0,-50.0,-50.0,-87.0,-87.0,-84.0,-84.0,39.0,36.0,37.0,39.0,1
3972,3C:55:76:E8:8F:1F,3867854,562608797,32338,78860011,3835516,483748786,20,15772,3926707,15531,3881991,241,44716,7720,17,32359,2860,20,155,206470.0,103230.0,-51.0,-57.0,-52.0,-45.0,-47.0,-51.0,-46.0,-43.0,-87.0,-87.0,-84.0,-84.0,36.0,30.0,32.0,39.0,1
3973,92:69:1D:31:68:E9,3839439,487374798,3923,3626012,3835516,483748786,0,4787,1105596,4645,1073461,142,32135,2125,10,4124,87,0,43,216660.0,130000.0,-51.0,-48.0,-44.0,-46.0,-51.0,-47.0,-43.0,-48.0,-87.0,-87.0,-84.0,-84.0,36.0,39.0,40.0,38.0,1
3974,CC:2F:71:3F:1F:24,4609267,1310825416,773751,827076630,3835516,483748786,37,622441,643275253,621721,643188625,720,86628,600595,15,774008,86173,34,512,144444.0,43333.0,-68.0,-66.0,-66.0,-70.0,-67.0,-66.0,-66.0,-70.0,-87.0,-87.0,-84.0,-84.0,19.0,21.0,18.0,14.0,1
3975,CC:2F:71:3E:C5:1F,3836390,483855585,874,106799,3835516,483748786,0,3645,306193,3008,230583,637,75610,925,8,1256,19,0,39,130000.0,39000.0,-71.0,-71.0,-70.0,-60.0,-72.0,-72.0,-70.0,-61.0,-87.0,-87.0,-84.0,-84.0,16.0,16.0,14.0,24.0,1
3976,BA:8C:B9:54:50:24,3840349,489931203,4833,6182417,3835516,483748786,0,8986,1698851,8964,1695356,22,3495,2348,15,5269,39,0,58,216660.0,130000.0,-39.0,-37.0,-45.0,-52.0,-45.0,-35.0,-43.0,-47.0,-87.0,-87.0,-84.0,-84.0,48.0,50.0,39.0,32.0,1
3977,62:47:05:9D:EB:15,3835563,483758709,42,9459,3835521,483749250,0,86,11071,75,8905,11,2166,38,0,59,0,0,4,216660.0,130000.0,-48.0,-51.0,-47.0,-45.0,-52.0,-53.0,-50.0,-50.0,-87.0,-87.0,-84.0,-84.0,39.0,36.0,37.0,39.0,1
3978,3C:55:76:E8:8F:1F,3867860,562609385,32339,78860135,3835521,483749250,20,15780,3927289,15539,3882573,241,44716,7721,17,32360,2860,20,155,206470.0,103230.0,-45.0,-55.0,-55.0,-42.0,-44.0,-52.0,-53.0,-41.0,-87.0,-87.0,-84.0,-84.0,42.0,32.0,29.0,42.0,1
3979,92:69:1D:31:68:E9,3839444,487375262,3923,3626012,3835521,483749250,0,4788,1105664,4646,1073529,142,32135,2125,10,4124,87,0,43,216660.0,130000.0,-51.0,-48.0,-44.0,-46.0,-51.0,-47.0,-43.0,-48.0,-87.0,-87.0,-84.0,-84.0,36.0,39.0,40.0,38.0,1
3980,CC:2F:71:3F:1F:24,4609480,1311086056,773959,827336806,3835521,483749250,37,622639,643540989,621919,643454361,720,86628,600777,15,774216,86185,34,512,144444.0,43333.0,-70.0,-67.0,-66.0,-71.0,-70.0,-67.0,-66.0,-71.0,-87.0,-87.0,-84.0,-84.0,17.0,20.0,18.0,13.0,1
3981,CC:2F:71:3E:C5:1F,3836395,483856049,874,106799,3835521,483749250,0,3645,306193,3008,230583,637,75610,925,8,1256,19,0,39,130000.0,39000.0,-71.0,-71.0,-70.0,-60.0,-72.0,-72.0,-70.0,-61.0,-87.0,-87.0,-84.0,-84.0,16.0,16.0,14.0,24.0,1
3982,BA:8C:B9:54:50:24,3840354,489931667,4833,6182417,3835521,483749250,0,8986,1698851,8964,1695356,22,3495,2348,15,5269,39,0,58,216660.0,130000.0,-39.0,-37.0,-45.0,-52.0,-45.0,-35.0,-43.0,-47.0,-87.0,-87.0,-84.0,-84.0,48.0,50.0,39.0,32.0,1
3983,62:47:05:9D:EB:15,3835567,483759113,42,9459,3835525,483749654,0,86,11071,75,8905,11,2166,38,0,59,0,0,4,216660.0,130000.0,-48.0,-51.0,-47.0,-45.0,-52.0,-53.0,-50.0,-50.0,-87.0,-87.0,-84.0,-84.0,39.0,36.0,37.0,39.0,1
3984,3C:55:76:E8:8F:1F,3867864,562609789,32339,78860135,3835525,483749654,20,15787,3927767,15546,3883051,241,44716,7721,17,32360,2860,20,155,206470.0,103230.0,-46.0,-55.0,-55.0,-43.0,-46.0,-54.0,-54.0,-42.0,-87.0,-87.0,-84.0,-84.0,41.0,32.0,29.0,41.0,1
3985,92:69:1D:31:68:E9,3839448,487375666,3923,3626012,3835525,483749654,0,4788,1105664,4646,1073529,142,32135,2125,10,4124,87,0,43,216660.0,130000.0,-51.0,-48.0,-44.0,-46.0,-51.0,-47.0,-43.0,-48.0,-87.0,-87.0,-84.0,-84.0,36.0,39.0,40.0,38.0,1
3986,CC:2F:71:3F:1F:24,4609713,1311371879,774188,827622225,3835525,483749654,37,622857,643823914,622137,643737286,720,86628,600984,15,774445,86256,34,513,144444.0,43333.0,-69.0,-65.0,-66.0,-72.0,-69.0,-64.0,-66.0,-71.0,-87.0,-87.0,-84.0,-84.0,18.0,22.0,18.0,12.0,1
3987,CC:2F:71:3E:C5:1F,3836399,483856453,874,106799,3835525,483749654,0,3645,306193,3008,230583,637,75610,925,8,1256,19,0,39,130000.0,39000.0,-71.0,-71.0,-70.0,-60.0,-72.0,-72.0,-70.0,-61.0,-87.0,-87.0,-84.0,-84.0,16.0,16.0,14.0,24.0,1
3988,BA:8C:B9:54:50:24,3840358,489932071,4833,6182417,3835525,483749654,0,8990,1699123,8968,1695628,22,3495,2348,15,5269,39,0,58,216660.0,130000.0,-39.0,-37.0,-45.0,-52.0,-41.0,-36.0,-44.0,-50.0,-87.0,-87.0,-84.0,-84.0,48.0,50.0,39.0,32.0,1
3989,62:47:05:9D:EB:15,3835572,483759577,42,9459,3835530,483750118,0,86,11071,75,8905,11,2166,38,0,59,0,0,4,216660.0,130000.0,-48.0,-51.0,-47.0,-45.0,-52.0,-53.0,-50.0,-50.0,-87.0,-87.0,-84.0,-84.0,39.0,36.0,37.0,39.0,1
3990,3C:55:76:E8:8F:1F,3867869,562610253,32339,78860135,3835530,483750118,20,15787,3927767,15546,3883051,241,44716,7721,17,32360,2860,20,155,206470.0,103230.0,-46.0,-55.0,-55.0,-43.0,-46.0,-54.0,-54.0,-42.0,-87.0,-87.0,-84.0,-84.0,41.0,32.0,29.0,41.0,1
3991,92:69:1D:31:68:E9,3839453,487376130,3923,3626012,3835530,483750118,0,4788,1105664,4646,1073529,142,32135,2125,10,4124,87,0,43,216660.0,130000.0,-51.0,-48.0,-44.0,-46.0,-51.0,-47.0,-43.0,-48.0,-87.0,-87.0,-84.0,-84.0,36.0,39.0,40.0,38.0,1
3992,CC:2F:71:3F:1F:24,4609927,1311634017,774397,827883899,3835530,483750118,37,623053,644081010,622333,643994382,720,86628,601168,15,774654,86303,34,513,130000.0,43333.0,-69.0,-66.0,-66.0,-72.0,-69.0,-66.0,-66.0,-71.0,-87.0,-87.0,-84.0,-84.0,18.0,21.0,18.0,12.0,1
3993,CC:2F:71:3E:C5:1F,3836404,483856917,874,106799,3835530,483750118,0,3645,306193,3008,230583,637,75610,925,8,1256,19,0,39,130000.0,39000.0,-71.0,-71.0,-70.0,-60.0,-72.0,-72.0,-70.0,-61.0,-87.0,-87.0,-84.0,-84.0,16.0,16.0,14.0,24.0,1
3994,BA:8C:B9:54:50:24,3840365,489932737,4833,6182417,3835532,483750320,0,8990,1699123,8968,1695628,22,3495,2348,15,5269,39,0,58,216660.0,130000.0,-39.0,-37.0,-45.0,-52.0,-41.0,-36.0,-44.0,-50.0,-87.0,-87.0,-84.0,-83.0,48.0,50.0,39.0,31.0,1
3995,62:47:05:9D:EB:15,3835578,483760159,43,9575,3835535,483750584,0,88,11207,77,9041,11,2166,38,0,60,0,0,4,216660.0,130000.0,-49.0,-50.0,-49.0,-45.0,-50.0,-51.0,-48.0,-47.0,-87.0,-87.0,-84.0,-83.0,38.0,37.0,35.0,38.0,1
3996,3C:55:76:E8:8F:1F,3868507,564287749,32972,80537165,3835535,483750584,20,15970,3954789,15728,3909955,242,44834,7788,17,33005,3011,20,157,146250.0,48750.0,-49.0,-55.0,-51.0,-47.0,-47.0,-52.0,-46.0,-45.0,-87.0,-87.0,-84.0,-83.0,38.0,32.0,33.0,36.0,1
3997,92:69:1D:31:68:E9,3839459,487376712,3924,3626128,3835535,483750584,0,4790,1105800,4648,1073665,142,32135,2125,10,4125,87,0,43,216660.0,130000.0,-51.0,-48.0,-44.0,-46.0,-51.0,-47.0,-43.0,-47.0,-87.0,-87.0,-84.0,-83.0,36.0,39.0,40.0,37.0,1
3998,CC:2F:71:3F:1F:24,4610144,1311899309,774609,828148725,3835535,483750584,37,623247,644340558,622527,644253930,720,86628,601354,15,774866,86307,34,513,130000.0,43333.0,-69.0,-66.0,-67.0,-71.0,-69.0,-66.0,-66.0,-71.0,-87.0,-87.0,-84.0,-83.0,18.0,21.0,17.0,12.0,1
3999,CC:2F:71:3E:C5:1F,3836412,483857701,875,106915,3835537,483750786,0,3647,306333,3010,230723,637,75610,925,8,1257,19,0,39,130000.0,39000.0,-71.0,-72.0,-70.0,-61.0,-73.0,-73.0,-71.0,-63.0,-87.0,-87.0,-84.0,-83.0,16.0,15.0,14.0,22.0,1
4000,BA:8C:B9:54:50:24,3840371,489933319,4834,6182533,3835537,483750786,0,8992,1699259,8970,1695764,22,3495,2348,15,5270,39,0,58,216660.0,130000.0,-40.0,-36.0,-46.0,-52.0,-39.0,-36.0,-45.0,-52.0,-87.0,-87.0,-84.0,-83.0,47.0,51.0,38.0,31.0,1
4001,62:47:05:9D:EB:15,3835582,483760563,43,9575,3835539,483750988,0,88,11207,77,9041,11,2166,38,0,60,0,0,4,216660.0,130000.0,-49.0,-50.0,-49.0,-45.0,-50.0,-51.0,-48.0,-47.0,-87.0,-87.0,-84.0,-83.0,38.0,37.0,35.0,38.0,1
4002,3C:55:76:E8:8F:1F,3868514,564288485,32973,80537295,3835541,483751190,20,15984,3955782,15742,3910948,242,44834,7789,17,33006,3011,20,157,146250.0,48750.0,-52.0,-59.0,-52.0,-45.0,-45.0,-56.0,-49.0,-41.0,-87.0,-87.0,-84.0,-83.0,35.0,28.0,32.0,38.0,1
4003,92:69:1D:31:68:E9,3839466,487377378,3924,3626128,3835542,483751250,0,4790,1105800,4648,1073665,142,32135,2125,10,4125,87,0,43,216660.0,130000.0,-51.0,-48.0,-44.0,-46.0,-51.0,-47.0,-43.0,-47.0,-87.0,-87.0,-84.0,-83.0,36.0,39.0,40.0,37.0,1
4004,CC:2F:71:3F:1F:24,4610368,1312163584,774824,828412132,3835544,483751452,37,623452,644604945,622732,644518317,720,86628,601545,15,775081,86324,34,513,130000.0,43333.0,-69.0,-66.0,-68.0,-71.0,-69.0,-66.0,-67.0,-71.0,-87.0,-87.0,-84.0,-83.0,18.0,21.0,16.0,12.0,1
4005,CC:2F:71:3E:C5:1F,3836419,483858367,875,106915,3835544,483751452,0,3647,306333,3010,230723,637,75610,925,8,1257,19,0,39,130000.0,39000.0,-71.0,-72.0,-70.0,-61.0,-73.0,-73.0,-71.0,-63.0,-87.0,-87.0,-84.0,-83.0,16.0,15.0,14.0,22.0,1
4006,BA:8C:B9:54:50:24,3840378,489933985,4834,6182533,3835544,483751452,0,8992,1699259,8970,1695764,22,3495,2348,15,5270,39,0,58,216660.0,130000.0,-40.0,-36.0,-46.0,-52.0,-39.0,-36.0,-45.0,-52.0,-87.0,-87.0,-84.0,-83.0,47.0,51.0,38.0,31.0,1
4007,62:47:05:9D:EB:15,3835590,483761502,43,9575,3835547,483751927,0,88,11207,77,9041,11,2166,38,0,60,0,0,4,216660.0,130000.0,-49.0,-50.0,-49.0,-45.0,-50.0,-51.0,-48.0,-47.0,-87.0,-87.0,-84.0,-83.0,38.0,37.0,35.0,38.0,1
4008,3C:55:76:E8:8F:1F,3868520,564289222,32973,80537295,3835547,483751927,20,15984,3955782,15742,3910948,242,44834,7789,17,33006,3011,20,157,146250.0,48750.0,-52.0,-59.0,-52.0,-45.0,-45.0,-56.0,-49.0,-41.0,-87.0,-87.0,-84.0,-83.0,35.0,28.0,32.0,38.0,1
4009,92:69:1D:31:68:E9,3839471,487378055,3924,3626128,3835547,483751927,0,4790,1105800,4648,1073665,142,32135,2125,10,4125,87,0,43,216660.0,130000.0,-51.0,-48.0,-44.0,-46.0,-51.0,-47.0,-43.0,-47.0,-87.0,-87.0,-84.0,-83.0,36.0,39.0,40.0,37.0,1
4010,CC:2F:71:3F:1F:24,4610583,1312433059,775036,828681132,3835547,483751927,37,623652,644868221,622932,644781593,720,86628,601735,15,775293,86328,34,513,130000.0,43333.0,-70.0,-66.0,-68.0,-72.0,-69.0,-66.0,-67.0,-71.0,-87.0,-87.0,-84.0,-83.0,17.0,21.0,16.0,11.0,1
4011,CC:2F:71:3E:C5:1F,3836424,483859044,875,106915,3835549,483752129,0,3647,306333,3010,230723,637,75610,925,8,1257,19,0,39,130000.0,39000.0,-71.0,-72.0,-70.0,-61.0,-73.0,-73.0,-71.0,-63.0,-87.0,-87.0,-84.0,-83.0,16.0,15.0,14.0,22.0,1
4012,BA:8C:B9:54:50:24,3840383,489934662,4834,6182533,3835549,483752129,0,8992,1699259,8970,1695764,22,3495,2348,15,5270,39,0,58,216660.0,130000.0,-40.0,-36.0,-46.0,-52.0,-39.0,-36.0,-45.0,-52.0,-87.0,-87.0,-84.0,-83.0,47.0,51.0,38.0,31.0,1
4013,62:47:05:9D:EB:15,3835596,483762108,43,9575,3835553,483752533,0,88,11207,77,9041,11,2166,38,0,60,0,0,4,216660.0,130000.0,-49.0,-50.0,-49.0,-45.0,-50.0,-51.0,-48.0,-47.0,-87.0,-87.0,-84.0,-83.0,38.0,37.0,35.0,38.0,1
4014,3C:55:76:E8:8F:1F,3868527,564289994,32974,80537461,3835553,483752533,20,15987,3956083,15745,3911249,242,44834,7790,17,33007,3011,20,157,146250.0,48750.0,-47.0,-50.0,-43.0,-42.0,-46.0,-53.0,-47.0,-41.0,-87.0,-87.0,-84.0,-83.0,40.0,37.0,41.0,41.0,1
4015,92:69:1D:31:68:E9,3839477,487378661,3924,3626128,3835553,483752533,0,4790,1105800,4648,1073665,142,32135,2125,10,4125,87,0,43,216660.0,130000.0,-51.0,-48.0,-44.0,-46.0,-51.0,-47.0,-43.0,-47.0,-87.0,-87.0,-84.0,-83.0,36.0,39.0,40.0,37.0,1
4016,CC:2F:71:3F:1F:24,4610806,1312709011,775253,828956478,3835553,483752533,37,623857,645142155,623137,645055527,720,86628,601928,15,775510,86335,34,513,130000.0,43333.0,-69.0,-65.0,-67.0,-71.0,-68.0,-65.0,-67.0,-71.0,-87.0,-87.0,-84.0,-83.0,18.0,22.0,17.0,12.0,1
4017,CC:2F:71:3E:C5:1F,3836429,483859510,875,106915,3835554,483752595,0,3647,306333,3010,230723,637,75610,925,8,1257,19,0,39,130000.0,39000.0,-71.0,-72.0,-70.0,-61.0,-73.0,-73.0,-71.0,-63.0,-87.0,-87.0,-84.0,-83.0,16.0,15.0,14.0,22.0,1
4018,BA:8C:B9:54:50:24,3840388,489935128,4834,6182533,3835554,483752595,0,8992,1699259,8970,1695764,22,3495,2348,15,5270,39,0,58,216660.0,130000.0,-40.0,-36.0,-46.0,-52.0,-39.0,-36.0,-45.0,-52.0,-87.0,-87.0,-84.0,-83.0,47.0,51.0,38.0,31.0,1
4019,62:47:05:9D:EB:15,3835604,483763002,43,9575,3835561,483753427,0,88,11207,77,9041,11,2166,38,0,60,0,0,4,216660.0,130000.0,-49.0,-50.0,-49.0,-45.0,-50.0,-51.0,-48.0,-47.0,-87.0,-87.0,-84.0,-83.0,38.0,37.0,35.0,38.0,1
4020,3C:55:76:E8:8F:1F,3868535,564290888,32974,80537461,3835561,483753427,20,15999,3956987,15756,3912035,243,44952,7792,17,33007,3011,20,157,146250.0,48750.0,-48.0,-52.0,-45.0,-45.0,-47.0,-52.0,-45.0,-44.0,-87.0,-87.0,-84.0,-83.0,39.0,35.0,39.0,38.0,1
4021,92:69:1D:31:68:E9,3839485,487379555,3924,3626128,3835561,483753427,0,4790,1105800,4648,1073665,142,32135,2125,10,4125,87,0,43,216660.0,130000.0,-51.0,-48.0,-44.0,-46.0,-51.0,-47.0,-43.0,-47.0,-87.0,-87.0,-84.0,-83.0,36.0,39.0,40.0,37.0,1
4022,CC:2F:71:3F:1F:24,4611043,1313003955,775482,829250528,3835561,483753427,37,624071,645424185,623351,645337557,720,86628,602133,15,775739,86347,34,513,130000.0,39000.0,-68.0,-66.0,-67.0,-71.0,-68.0,-65.0,-67.0,-71.0,-87.0,-87.0,-84.0,-83.0,19.0,21.0,17.0,12.0,1
4023,CC:2F:71:3E:C5:1F,3836436,483860342,875,106915,3835561,483753427,0,3647,306333,3010,230723,637,75610,925,8,1257,19,0,39,130000.0,39000.0,-71.0,-72.0,-70.0,-61.0,-73.0,-73.0,-71.0,-63.0,-87.0,-87.0,-84.0,-83.0,16.0,15.0,14.0,22.0,1
4024,BA:8C:B9:54:50:24,3840395,489935960,4834,6182533,3835561,483753427,0,8992,1699259,8970,1695764,22,3495,2348,15,5270,39,0,58,216660.0,130000.0,-40.0,-36.0,-46.0,-52.0,-39.0,-36.0,-45.0,-52.0,-87.0,-87.0,-84.0,-83.0,47.0,51.0,38.0,31.0,1
4025,62:47:05:9D:EB:15,3835608,483763406,43,9575,3835565,483753831,0,88,11207,77,9041,11,2166,38,0,60,0,0,4,216660.0,130000.0,-49.0,-50.0,-49.0,-45.0,-50.0,-51.0,-48.0,-47.0,-87.0,-87.0,-84.0,-83.0,38.0,37.0,35.0,38.0,1
4026,3C:55:76:E8:8F:1F,3868541,564291743,32976,80537912,3835565,483753831,20,16014,3958312,15771,3913360,243,44952,7794,17,33009,3011,20,157,146250.0,48750.0,-48.0,-52.0,-45.0,-45.0,-47.0,-51.0,-45.0,-45.0,-87.0,-87.0,-84.0,-83.0,39.0,35.0,39.0,38.0,1
4027,92:69:1D:31:68:E9,3839489,487379959,3924,3626128,3835565,483753831,0,4790,1105800,4648,1073665,142,32135,2125,10,4125,87,0,43,216660.0,130000.0,-51.0,-48.0,-44.0,-46.0,-51.0,-47.0,-43.0,-47.0,-87.0,-87.0,-84.0,-83.0,36.0,39.0,40.0,37.0,1
4028,CC:2F:71:3F:1F:24,4611263,1313270912,775698,829517081,3835565,483753831,37,624271,645676172,623551,645589544,720,86628,602327,15,775955,86350,34,513,130000.0,43333.0,-69.0,-66.0,-68.0,-71.0,-69.0,-66.0,-67.0,-70.0,-87.0,-87.0,-84.0,-83.0,18.0,21.0,16.0,12.0,1
4029,CC:2F:71:3E:C5:1F,3836440,483860746,875,106915,3835565,483753831,0,3647,306333,3010,230723,637,75610,925,8,1257,19,0,39,130000.0,39000.0,-71.0,-72.0,-70.0,-61.0,-73.0,-73.0,-71.0,-63.0,-87.0,-87.0,-84.0,-83.0,16.0,15.0,14.0,22.0,1
4030,BA:8C:B9:54:50:24,3840401,489936566,4834,6182533,3835567,483754033,0,8992,1699259,8970,1695764,22,3495,2348,15,5270,39,0,58,216660.0,130000.0,-40.0,-36.0,-46.0,-52.0,-39.0,-36.0,-45.0,-52.0,-87.0,-87.0,-84.0,-83.0,47.0,51.0,38.0,31.0,1
4031,62:47:05:9D:EB:15,3835615,483763994,43,9575,3835572,483754419,0,88,11207,77,9041,11,2166,38,0,60,0,0,4,216660.0,130000.0,-49.0,-50.0,-49.0,-45.0,-50.0,-51.0,-48.0,-47.0,-87.0,-87.0,-84.0,-83.0,38.0,37.0,35.0,38.0,1
4032,3C:55:76:E8:8F:1F,3868552,564292824,32980,80538405,3835572,483754419,20,16032,3959789,15789,3914837,243,44952,7798,17,33013,3011,20,158,146250.0,48750.0,-45.0,-54.0,-48.0,-40.0,-45.0,-53.0,-47.0,-40.0,-87.0,-87.0,-84.0,-83.0,42.0,33.0,36.0,43.0,1
4033,92:69:1D:31:68:E9,3839498,487380749,3924,3626128,3835574,483754621,0,4790,1105800,4648,1073665,142,32135,2125,10,4125,87,0,43,216660.0,130000.0,-51.0,-48.0,-44.0,-46.0,-51.0,-47.0,-43.0,-47.0,-87.0,-87.0,-84.0,-83.0,36.0,39.0,40.0,37.0,1
4034,CC:2F:71:3F:1F:24,4611480,1313534542,775906,829779921,3835574,483754621,37,624464,645931208,623743,645844462,721,86746,602515,15,776163,86362,34,513,144444.0,43333.0,-69.0,-66.0,-68.0,-71.0,-69.0,-66.0,-67.0,-71.0,-87.0,-87.0,-84.0,-83.0,18.0,21.0,16.0,12.0,1
4035,CC:2F:71:3E:C5:1F,3836451,483861738,875,106915,3835576,483754823,0,3649,306521,3011,230793,638,75728,926,8,1257,19,0,39,130000.0,39000.0,-71.0,-71.0,-70.0,-60.0,-72.0,-72.0,-70.0,-62.0,-87.0,-87.0,-84.0,-83.0,16.0,16.0,14.0,23.0,1
4036,BA:8C:B9:54:50:24,3840410,489937356,4834,6182533,3835576,483754823,0,8992,1699259,8970,1695764,22,3495,2348,15,5270,39,0,58,216660.0,130000.0,-40.0,-36.0,-46.0,-52.0,-39.0,-36.0,-45.0,-52.0,-87.0,-87.0,-84.0,-83.0,47.0,51.0,38.0,31.0,1
4037,62:47:05:9D:EB:15,3835619,483764398,43,9575,3835576,483754823,0,88,11207,77,9041,11,2166,38,0,60,0,0,4,216660.0,130000.0,-49.0,-50.0,-49.0,-45.0,-50.0,-51.0,-48.0,-47.0,-87.0,-87.0,-84.0,-83.0,38.0,37.0,35.0,38.0,1
4038,3C:55:76:E8:8F:1F,3869202,565981165,33624,82226140,3835578,483755025,20,16201,3988014,15958,3943062,243,44952,7869,17,33657,3047,20,158,146250.0,48750.0,-44.0,-53.0,-47.0,-40.0,-46.0,-53.0,-47.0,-42.0,-87.0,-87.0,-84.0,-83.0,43.0,34.0,37.0,43.0,1
4039,92:69:1D:31:68:E9,3839502,487381153,3924,3626128,3835578,483755025,0,4790,1105800,4648,1073665,142,32135,2125,10,4125,87,0,43,216660.0,130000.0,-51.0,-48.0,-44.0,-46.0,-51.0,-47.0,-43.0,-47.0,-87.0,-87.0,-84.0,-83.0,36.0,39.0,40.0,37.0,1
4040,CC:2F:71:3F:1F:24,4611694,1313798158,776116,830043133,3835578,483755025,37,624664,646195752,623943,646109006,721,86746,602701,15,776373,86368,34,513,130000.0,43333.0,-69.0,-66.0,-67.0,-72.0,-69.0,-65.0,-67.0,-71.0,-87.0,-87.0,-84.0,-83.0,18.0,21.0,17.0,11.0,1
4041,CC:2F:71:3E:C5:1F,3836453,483861940,875,106915,3835578,483755025,0,3649,306521,3011,230793,638,75728,926,8,1257,19,0,39,130000.0,39000.0,-71.0,-71.0,-70.0,-60.0,-72.0,-72.0,-70.0,-62.0,-87.0,-87.0,-84.0,-83.0,16.0,16.0,14.0,23.0,1
4042,BA:8C:B9:54:50:24,3840412,489937558,4834,6182533,3835578,483755025,0,8992,1699259,8970,1695764,22,3495,2348,15,5270,39,0,58,216660.0,130000.0,-40.0,-36.0,-46.0,-52.0,-39.0,-36.0,-45.0,-52.0,-87.0,-87.0,-84.0,-83.0,47.0,51.0,38.0,31.0,1
4043,62:47:05:9D:EB:15,3835628,483765513,43,9575,3835585,483755938,0,90,11343,79,9177,11,2166,38,0,61,0,0,4,216660.0,130000.0,-50.0,-50.0,-49.0,-46.0,-50.0,-51.0,-48.0,-47.0,-87.0,-87.0,-84.0,-83.0,37.0,37.0,35.0,37.0,1
4044,3C:55:76:E8:8F:1F,3869212,565982457,33625,82226317,3835587,483756140,20,16213,3989361,15968,3943848,245,45513,7872,17,33658,3047,20,158,146250.0,48750.0,-48.0,-52.0,-45.0,-45.0,-45.0,-51.0,-45.0,-42.0,-87.0,-87.0,-84.0,-83.0,39.0,35.0,39.0,38.0,1
4045,92:69:1D:31:68:E9,3839511,487382268,3924,3626128,3835587,483756140,0,4792,1105936,4650,1073801,142,32135,2125,10,4126,87,0,43,216660.0,130000.0,-51.0,-47.0,-42.0,-49.0,-51.0,-47.0,-43.0,-47.0,-87.0,-87.0,-84.0,-83.0,36.0,40.0,42.0,34.0,1
4046,CC:2F:71:3F:1F:24,4611921,1314067566,776334,830311426,3835587,483756140,37,624871,646463480,624150,646376734,721,86746,602894,15,776591,86373,34,513,130000.0,43333.0,-69.0,-67.0,-67.0,-70.0,-68.0,-67.0,-66.0,-70.0,-87.0,-87.0,-84.0,-83.0,18.0,20.0,17.0,13.0,1
4047,CC:2F:71:3E:C5:1F,3836462,483863055,875,106915,3835587,483756140,0,3649,306521,3011,230793,638,75728,926,8,1257,19,0,39,130000.0,39000.0,-71.0,-71.0,-70.0,-60.0,-72.0,-72.0,-70.0,-62.0,-87.0,-87.0,-84.0,-83.0,16.0,16.0,14.0,23.0,1
4048,BA:8C:B9:54:50:24,3840421,489938673,4834,6182533,3835587,483756140,0,8994,1699395,8972,1695900,22,3495,2348,15,5271,39,0,58,216660.0,130000.0,-48.0,-35.0,-43.0,-45.0,-40.0,-36.0,-45.0,-51.0,-87.0,-87.0,-84.0,-83.0,39.0,52.0,41.0,38.0,1
4049,62:47:05:9D:EB:15,3835635,483766428,43,9575,3835592,483756853,0,90,11343,79,9177,11,2166,38,0,61,0,0,4,216660.0,130000.0,-50.0,-50.0,-49.0,-46.0,-50.0,-51.0,-48.0,-47.0,-87.0,-87.0,-84.0,-83.0,37.0,37.0,35.0,37.0,1
4050,3C:55:76:E8:8F:1F,3869219,565983514,33627,82226661,3835592,483756853,20,16232,3991220,15986,3945589,246,45631,7876,17,33660,3047,20,159,146250.0,48750.0,-43.0,-55.0,-45.0,-38.0,-45.0,-53.0,-45.0,-40.0,-87.0,-87.0,-84.0,-83.0,44.0,32.0,39.0,45.0,1
4051,92:69:1D:31:68:E9,3839516,487382981,3924,3626128,3835592,483756853,0,4792,1105936,4650,1073801,142,32135,2125,10,4126,87,0,43,216660.0,130000.0,-51.0,-47.0,-42.0,-49.0,-51.0,-47.0,-43.0,-47.0,-87.0,-87.0,-84.0,-83.0,36.0,40.0,42.0,34.0,1
4052,CC:2F:71:3F:1F:24,4612133,1314329509,776541,830572656,3835592,483756853,37,625072,646732584,624351,646645838,721,86746,603077,15,776798,86383,34,513,130000.0,43333.0,-69.0,-67.0,-67.0,-71.0,-68.0,-66.0,-67.0,-71.0,-87.0,-87.0,-84.0,-83.0,18.0,20.0,17.0,12.0,1
4053,CC:2F:71:3E:C5:1F,3836469,483863970,875,106915,3835594,483757055,0,3649,306521,3011,230793,638,75728,926,8,1257,19,0,39,130000.0,39000.0,-71.0,-71.0,-70.0,-60.0,-72.0,-72.0,-70.0,-62.0,-87.0,-87.0,-84.0,-83.0,16.0,16.0,14.0,23.0,1
4054,BA:8C:B9:54:50:24,3840428,489939588,4834,6182533,3835594,483757055,0,8994,1699395,8972,1695900,22,3495,2348,15,5271,39,0,58,216660.0,130000.0,-48.0,-35.0,-43.0,-45.0,-40.0,-36.0,-45.0,-51.0,-87.0,-87.0,-84.0,-83.0,39.0,52.0,41.0,38.0,1
4055,62:47:05:9D:EB:15,3835641,483767034,43,9575,3835598,483757459,0,91,11411,80,9245,11,2166,38,0,61,0,0,4,216660.0,130000.0,-50.0,-50.0,-47.0,-45.0,-50.0,-50.0,-48.0,-47.0,-87.0,-87.0,-83.0,-83.0,37.0,37.0,36.0,38.0,1
4056,3C:55:76:E8:8F:1F,3869227,565984393,33629,82226934,3835598,483757459,20,16250,3992593,16004,3946962,246,45631,7879,17,33662,3047,20,159,146250.0,48750.0,-45.0,-57.0,-48.0,-40.0,-44.0,-56.0,-47.0,-40.0,-87.0,-87.0,-83.0,-83.0,42.0,30.0,35.0,43.0,1
4057,92:69:1D:31:68:E9,3839522,487383587,3924,3626128,3835598,483757459,0,4792,1105936,4650,1073801,142,32135,2125,10,4126,87,0,43,216660.0,130000.0,-51.0,-47.0,-42.0,-49.0,-51.0,-47.0,-43.0,-47.0,-87.0,-87.0,-83.0,-83.0,36.0,40.0,41.0,34.0,1
4058,CC:2F:71:3F:1F:24,4612353,1314595446,776752,830837478,3835601,483757968,37,625272,646997120,624551,646910374,721,86746,603265,15,777009,86383,34,513,130000.0,43333.0,-69.0,-66.0,-67.0,-72.0,-68.0,-66.0,-67.0,-71.0,-87.0,-87.0,-83.0,-83.0,18.0,21.0,16.0,11.0,1
4059,CC:2F:71:3E:C5:1F,3836476,483864883,875,106915,3835601,483757968,0,3649,306521,3011,230793,638,75728,926,8,1257,19,0,39,130000.0,39000.0,-71.0,-71.0,-70.0,-60.0,-72.0,-72.0,-70.0,-62.0,-87.0,-87.0,-83.0,-83.0,16.0,16.0,13.0,23.0,1
4060,BA:8C:B9:54:50:24,3840435,489940501,4834,6182533,3835601,483757968,0,8994,1699395,8972,1695900,22,3495,2348,15,5271,39,0,58,216660.0,130000.0,-48.0,-35.0,-43.0,-45.0,-40.0,-36.0,-45.0,-51.0,-87.0,-87.0,-83.0,-83.0,39.0,52.0,40.0,38.0,1
4061,62:47:05:9D:EB:15,3835648,483767947,43,9575,3835605,483758372,0,91,11411,80,9245,11,2166,38,0,61,0,0,4,216660.0,130000.0,-50.0,-50.0,-47.0,-45.0,-50.0,-50.0,-48.0,-47.0,-87.0,-87.0,-83.0,-83.0,37.0,37.0,36.0,38.0,1
4062,3C:55:76:E8:8F:1F,3869238,565988908,33633,82230536,3835605,483758372,20,16270,3998055,16022,3951863,248,46192,7886,17,33666,3047,20,159,154850.0,48750.0,-49.0,-52.0,-45.0,-45.0,-48.0,-51.0,-44.0,-44.0,-87.0,-87.0,-83.0,-83.0,38.0,35.0,38.0,38.0,1
4063,92:69:1D:31:68:E9,3839529,487384500,3924,3626128,3835605,483758372,0,4792,1105936,4650,1073801,142,32135,2125,10,4126,87,0,43,216660.0,130000.0,-51.0,-47.0,-42.0,-49.0,-51.0,-47.0,-43.0,-47.0,-87.0,-87.0,-83.0,-83.0,36.0,40.0,41.0,34.0,1
4064,CC:2F:71:3F:1F:24,4612566,1314857340,776961,831098968,3835605,483758372,37,625467,647252602,624746,647165856,721,86746,603452,15,777218,86387,34,513,130000.0,43333.0,-69.0,-66.0,-67.0,-72.0,-68.0,-66.0,-67.0,-71.0,-87.0,-87.0,-83.0,-83.0,18.0,21.0,16.0,11.0,1
4065,CC:2F:71:3E:C5:1F,3836480,483865287,875,106915,3835605,483758372,0,3649,306521,3011,230793,638,75728,926,8,1257,19,0,39,130000.0,39000.0,-71.0,-71.0,-70.0,-60.0,-72.0,-72.0,-70.0,-62.0,-87.0,-87.0,-83.0,-83.0,16.0,16.0,13.0,23.0,1
4066,BA:8C:B9:54:50:24,3840439,489940905,4834,6182533,3835605,483758372,0,8994,1699395,8972,1695900,22,3495,2348,15,5271,39,0,58,216660.0,130000.0,-48.0,-35.0,-43.0,-45.0,-40.0,-36.0,-45.0,-51.0,-87.0,-87.0,-83.0,-83.0,39.0,52.0,40.0,38.0,1
4067,62:47:05:9D:EB:15,3835654,483768800,43,9575,3835611,483759225,0,91,11411,80,9245,11,2166,38,0,61,0,0,4,216660.0,130000.0,-50.0,-50.0,-47.0,-45.0,-50.0,-50.0,-48.0,-47.0,-87.0,-87.0,-83.0,-83.0,37.0,37.0,36.0,38.0,1
4068,3C:55:76:E8:8F:1F,3869988,567939429,34377,84180204,3835611,483759225,20,16459,4025543,16209,3978790,250,46753,7984,17,34410,3066,20,160,195000.0,97500.0,-44.0,-55.0,-47.0,-39.0,-46.0,-54.0,-47.0,-40.0,-87.0,-87.0,-83.0,-83.0,43.0,32.0,36.0,44.0,1
4069,92:69:1D:31:68:E9,3839535,487385353,3924,3626128,3835611,483759225,0,4792,1105936,4650,1073801,142,32135,2125,10,4126,87,0,43,216660.0,130000.0,-51.0,-47.0,-42.0,-49.0,-51.0,-47.0,-43.0,-47.0,-87.0,-87.0,-83.0,-83.0,36.0,40.0,41.0,34.0,1
4070,CC:2F:71:3F:1F:24,4612792,1315127946,777181,831368721,3835611,483759225,37,625674,647510040,624953,647423294,721,86746,603650,15,777438,86403,34,513,130000.0,43333.0,-69.0,-66.0,-67.0,-71.0,-68.0,-66.0,-67.0,-71.0,-87.0,-87.0,-83.0,-83.0,18.0,21.0,16.0,12.0,1
4071,CC:2F:71:3E:C5:1F,3836488,483866342,875,106915,3835613,483759427,0,3649,306521,3011,230793,638,75728,926,8,1257,19,0,39,130000.0,39000.0,-71.0,-71.0,-70.0,-60.0,-72.0,-72.0,-70.0,-62.0,-87.0,-87.0,-83.0,-83.0,16.0,16.0,13.0,23.0,1
4072,BA:8C:B9:54:50:24,3840447,489941960,4834,6182533,3835613,483759427,0,8994,1699395,8972,1695900,22,3495,2348,15,5271,39,0,58,216660.0,130000.0,-48.0,-35.0,-43.0,-45.0,-40.0,-36.0,-45.0,-51.0,-87.0,-87.0,-83.0,-83.0,39.0,52.0,40.0,38.0,1
4073,62:47:05:9D:EB:15,3835660,483769537,43,9575,3835617,483759962,0,91,11411,80,9245,11,2166,38,0,61,0,0,4,216660.0,130000.0,-50.0,-50.0,-47.0,-45.0,-50.0,-50.0,-48.0,-47.0,-87.0,-87.0,-83.0,-83.0,37.0,37.0,36.0,38.0,1
4074,3C:55:76:E8:8F:1F,3869994,567940166,34377,84180204,3835617,483759962,20,16463,4025817,16213,3979064,250,46753,7984,17,34410,3066,20,160,195000.0,97500.0,-45.0,-56.0,-48.0,-39.0,-44.0,-55.0,-47.0,-39.0,-87.0,-87.0,-83.0,-83.0,42.0,31.0,35.0,44.0,1
4075,92:69:1D:31:68:E9,3839541,487386090,3924,3626128,3835617,483759962,0,4792,1105936,4650,1073801,142,32135,2125,10,4126,87,0,43,216660.0,130000.0,-51.0,-47.0,-42.0,-49.0,-51.0,-47.0,-43.0,-47.0,-87.0,-87.0,-83.0,-83.0,36.0,40.0,41.0,34.0,1
4076,CC:2F:71:3F:1F:24,4613006,1315391467,777389,831631505,3835617,483759962,37,625868,647769518,625147,647682772,721,86746,603835,15,777646,86409,34,513,130000.0,43333.0,-68.0,-66.0,-67.0,-71.0,-68.0,-65.0,-66.0,-71.0,-87.0,-87.0,-83.0,-83.0,19.0,21.0,16.0,12.0,1
4077,CC:2F:71:3E:C5:1F,3836492,483866877,875,106915,3835617,483759962,0,3649,306521,3011,230793,638,75728,926,8,1257,19,0,39,130000.0,39000.0,-71.0,-71.0,-70.0,-60.0,-72.0,-72.0,-70.0,-62.0,-87.0,-87.0,-83.0,-83.0,16.0,16.0,13.0,23.0,1
4078,BA:8C:B9:54:50:24,3840453,489942697,4834,6182533,3835619,483760164,0,8995,1699463,8973,1695968,22,3495,2348,15,5271,39,0,58,216660.0,130000.0,-39.0,-37.0,-46.0,-52.0,-40.0,-36.0,-45.0,-51.0,-87.0,-87.0,-83.0,-83.0,48.0,50.0,37.0,31.0,1
4079,62:47:05:9D:EB:15,3835664,483769941,43,9575,3835621,483760366,0,91,11411,80,9245,11,2166,38,0,61,0,0,4,216660.0,130000.0,-50.0,-50.0,-47.0,-45.0,-50.0,-50.0,-48.0,-47.0,-87.0,-87.0,-83.0,-83.0,37.0,37.0,36.0,38.0,1
4080,3C:55:76:E8:8F:1F,3870002,567941110,34379,84180542,3835623,483760568,20,16475,4026709,16225,3979956,250,46753,7986,17,34412,3066,20,160,195000.0,97500.0,-49.0,-52.0,-44.0,-45.0,-47.0,-51.0,-44.0,-44.0,-87.0,-87.0,-83.0,-83.0,38.0,35.0,39.0,38.0,1
4081,92:69:1D:31:68:E9,3839547,487386696,3924,3626128,3835623,483760568,0,4792,1105936,4650,1073801,142,32135,2125,10,4126,87,0,43,216660.0,130000.0,-51.0,-47.0,-42.0,-49.0,-51.0,-47.0,-43.0,-47.0,-87.0,-87.0,-83.0,-83.0,36.0,40.0,41.0,34.0,1
4082,CC:2F:71:3F:1F:24,4613219,1315651879,777596,831891311,3835623,483760568,37,626060,648023150,625339,647936404,721,86746,604019,15,777853,86413,34,513,130000.0,43333.0,-69.0,-65.0,-67.0,-71.0,-68.0,-65.0,-66.0,-71.0,-87.0,-87.0,-83.0,-83.0,18.0,22.0,16.0,12.0,1
4083,CC:2F:71:3E:C5:1F,3836498,483867483,875,106915,3835623,483760568,0,3649,306521,3011,230793,638,75728,926,8,1257,19,0,39,130000.0,39000.0,-71.0,-71.0,-70.0,-60.0,-72.0,-72.0,-70.0,-62.0,-87.0,-87.0,-83.0,-83.0,16.0,16.0,13.0,23.0,1
4084,BA:8C:B9:54:50:24,3840457,489943101,4834,6182533,3835623,483760568,0,8995,1699463,8973,1695968,22,3495,2348,15,5271,39,0,58,216660.0,130000.0,-39.0,-37.0,-46.0,-52.0,-40.0,-36.0,-45.0,-51.0,-87.0,-87.0,-83.0,-83.0,48.0,50.0,37.0,31.0,1
4085,62:47:05:9D:EB:15,3835669,483770405,43,9575,3835626,483760830,0,91,11411,80,9245,11,2166,38,0,61,0,0,4,216660.0,130000.0,-50.0,-50.0,-47.0,-45.0,-50.0,-50.0,-48.0,-47.0,-87.0,-87.0,-83.0,-83.0,37.0,37.0,36.0,38.0,1
4086,3C:55:76:E8:8F:1F,3870009,567941758,34381,84180726,3835628,483761032,20,16489,4027739,16239,3980986,250,46753,7988,17,34414,3066,20,160,195000.0,97500.0,-45.0,-55.0,-48.0,-39.0,-44.0,-55.0,-48.0,-39.0,-87.0,-87.0,-83.0,-83.0,42.0,32.0,35.0,44.0,1
4087,92:69:1D:31:68:E9,3839552,487387160,3924,3626128,3835628,483761032,0,4792,1105936,4650,1073801,142,32135,2125,10,4126,87,0,43,216660.0,130000.0,-51.0,-47.0,-42.0,-49.0,-51.0,-47.0,-43.0,-47.0,-87.0,-87.0,-83.0,-83.0,36.0,40.0,41.0,34.0,1
4088,CC:2F:71:3F:1F:24,4613441,1315919024,777811,832157790,3835630,483761234,37,626262,648281309,625541,648194563,721,86746,604211,15,778067,86413,34,513,130000.0,43333.0,-69.0,-66.0,-67.0,-71.0,-68.0,-66.0,-66.0,-71.0,-87.0,-87.0,-83.0,-83.0,18.0,21.0,16.0,12.0,1
4089,CC:2F:71:3E:C5:1F,3836505,483868149,875,106915,3835630,483761234,0,3649,306521,3011,230793,638,75728,926,8,1257,19,0,39,130000.0,39000.0,-71.0,-71.0,-70.0,-60.0,-72.0,-72.0,-70.0,-62.0,-87.0,-87.0,-83.0,-83.0,16.0,16.0,13.0,23.0,1
4090,BA:8C:B9:54:50:24,3840464,489943767,4834,6182533,3835630,483761234,0,8995,1699463,8973,1695968,22,3495,2348,15,5271,39,0,58,216660.0,130000.0,-39.0,-37.0,-46.0,-52.0,-40.0,-36.0,-45.0,-51.0,-87.0,-87.0,-83.0,-83.0,48.0,50.0,37.0,31.0,1
4091,62:47:05:9D:EB:15,3835676,483771071,43,9575,3835633,483761496,0,91,11411,80,9245,11,2166,38,0,61,0,0,4,216660.0,130000.0,-50.0,-50.0,-47.0,-45.0,-50.0,-50.0,-48.0,-47.0,-87.0,-86.0,-83.0,-83.0,37.0,36.0,36.0,38.0,1
4092,3C:55:76:E8:8F:1F,3870014,567942222,34381,84180726,3835633,483761496,20,16499,4028459,16248,3981600,251,46859,7989,17,34414,3066,20,160,195000.0,97500.0,-45.0,-55.0,-48.0,-40.0,-43.0,-53.0,-46.0,-37.0,-87.0,-86.0,-83.0,-83.0,42.0,31.0,35.0,43.0,1
4093,92:69:1D:31:68:E9,3839557,487387624,3924,3626128,3835633,483761496,0,4792,1105936,4650,1073801,142,32135,2125,10,4126,87,0,43,216660.0,130000.0,-51.0,-47.0,-42.0,-49.0,-51.0,-47.0,-43.0,-47.0,-87.0,-86.0,-83.0,-83.0,36.0,39.0,41.0,34.0,1
4094,CC:2F:71:3F:1F:24,4613658,1316188506,778025,832427010,3835633,483761496,37,626472,648557413,625751,648470667,721,86746,604402,15,778280,86428,34,515,130000.0,39000.0,-69.0,-66.0,-67.0,-71.0,-68.0,-66.0,-67.0,-71.0,-87.0,-86.0,-83.0,-83.0,18.0,20.0,16.0,12.0,1
4095,CC:2F:71:3E:C5:1F,3836508,483868411,875,106915,3835633,483761496,0,3649,306521,3011,230793,638,75728,926,8,1257,19,0,39,130000.0,39000.0,-71.0,-71.0,-70.0,-60.0,-72.0,-72.0,-70.0,-62.0,-87.0,-86.0,-83.0,-83.0,16.0,15.0,13.0,23.0,1
4096,BA:8C:B9:54:50:24,3840469,489944231,4834,6182533,3835635,483761698,0,8995,1699463,8973,1695968,22,3495,2348,15,5271,39,0,58,216660.0,130000.0,-39.0,-37.0,-46.0,-52.0,-40.0,-36.0,-45.0,-51.0,-87.0,-86.0,-83.0,-83.0,48.0,49.0,37.0,31.0,1
4097,62:47:05:9D:EB:15,3835683,483771737,43,9575,3835640,483762162,0,91,11411,80,9245,11,2166,38,0,61,0,0,4,216660.0,130000.0,-50.0,-50.0,-47.0,-45.0,-50.0,-50.0,-48.0,-47.0,-87.0,-86.0,-83.0,-83.0,37.0,36.0,36.0,38.0,1
4098,3C:55:76:E8:8F:1F,3870028,567947476,34388,84185314,3835640,483762162,20,16519,4032775,16267,3985810,252,46965,7996,17,34421,3069,20,160,195000.0,1000.0,-52.0,-59.0,-50.0,-43.0,-46.0,-55.0,-48.0,-40.0,-87.0,-86.0,-83.0,-83.0,35.0,27.0,33.0,40.0,1
4099,92:69:1D:31:68:E9,3839564,487388290,3924,3626128,3835640,483762162,0,4792,1105936,4650,1073801,142,32135,2125,10,4126,87,0,43,216660.0,130000.0,-51.0,-47.0,-42.0,-49.0,-51.0,-47.0,-43.0,-47.0,-87.0,-86.0,-83.0,-83.0,36.0,39.0,41.0,34.0,1
4100,CC:2F:71:3F:1F:24,4613872,1316449076,778231,832686854,3835641,483762222,37,626668,648818655,625947,648731909,721,86746,604587,15,778488,86429,34,515,130000.0,43333.0,-69.0,-66.0,-67.0,-72.0,-68.0,-66.0,-67.0,-71.0,-87.0,-86.0,-83.0,-83.0,18.0,20.0,16.0,11.0,1
4101,CC:2F:71:3E:C5:1F,3836516,483869137,875,106915,3835641,483762222,0,3649,306521,3011,230793,638,75728,926,8,1257,19,0,39,130000.0,39000.0,-71.0,-71.0,-70.0,-60.0,-72.0,-72.0,-70.0,-62.0,-87.0,-86.0,-83.0,-83.0,16.0,15.0,13.0,23.0,1
4102,BA:8C:B9:54:50:24,3840475,489944755,4834,6182533,3835641,483762222,0,8995,1699463,8973,1695968,22,3495,2348,15,5271,39,0,58,216660.0,130000.0,-39.0,-37.0,-46.0,-52.0,-40.0,-36.0,-45.0,-51.0,-87.0,-86.0,-83.0,-83.0,48.0,49.0,37.0,31.0,1
4103,62:47:05:9D:EB:15,3835687,483772059,43,9575,3835644,483762484,0,91,11411,80,9245,11,2166,38,0,61,0,0,4,216660.0,130000.0,-50.0,-50.0,-47.0,-45.0,-50.0,-50.0,-48.0,-47.0,-87.0,-86.0,-83.0,-83.0,37.0,36.0,36.0,38.0,1
4104,3C:55:76:E8:8F:1F,3870051,567959743,34407,84197259,3835644,483762484,20,16551,4040503,16298,3993432,253,47071,8015,17,34440,3069,20,160,206470.0,103230.0,-45.0,-54.0,-47.0,-39.0,-46.0,-53.0,-47.0,-40.0,-87.0,-86.0,-83.0,-83.0,42.0,32.0,36.0,44.0,1
4105,92:69:1D:31:68:E9,3839570,487388814,3924,3626128,3835646,483762686,0,4792,1105936,4650,1073801,142,32135,2125,10,4126,87,0,43,216660.0,130000.0,-51.0,-47.0,-42.0,-49.0,-51.0,-47.0,-43.0,-47.0,-87.0,-86.0,-83.0,-83.0,36.0,39.0,41.0,34.0,1
4106,CC:2F:71:3F:1F:24,4614085,1316712324,778439,832949638,3835646,483762686,37,626867,649086045,626146,648999299,721,86746,604771,15,778696,86437,34,515,130000.0,43333.0,-69.0,-66.0,-67.0,-71.0,-68.0,-66.0,-67.0,-71.0,-87.0,-86.0,-83.0,-83.0,18.0,20.0,16.0,12.0,1
4107,CC:2F:71:3E:C5:1F,3836521,483869601,875,106915,3835646,483762686,0,3649,306521,3011,230793,638,75728,926,8,1257,19,0,39,130000.0,39000.0,-71.0,-71.0,-70.0,-60.0,-72.0,-72.0,-70.0,-62.0,-87.0,-86.0,-83.0,-83.0,16.0,15.0,13.0,23.0,1
4108,BA:8C:B9:54:50:24,3840480,489945219,4834,6182533,3835646,483762686,0,8995,1699463,8973,1695968,22,3495,2348,15,5271,39,0,58,216660.0,130000.0,-39.0,-37.0,-46.0,-52.0,-40.0,-36.0,-45.0,-51.0,-87.0,-86.0,-83.0,-83.0,48.0,49.0,37.0,31.0,1
4109,62:47:05:9D:EB:15,3835693,483772665,43,9575,3835650,483763090,0,91,11411,80,9245,11,2166,38,0,61,0,0,4,216660.0,130000.0,-50.0,-50.0,-47.0,-45.0,-50.0,-50.0,-48.0,-47.0,-87.0,-86.0,-83.0,-83.0,37.0,36.0,36.0,38.0,1
4110,3C:55:76:E8:8F:1F,3870778,569864791,35128,86101701,3835650,483763090,20,16732,4067902,16479,4020831,253,47071,8081,17,35161,3092,20,160,195000.0,97500.0,-49.0,-52.0,-44.0,-45.0,-48.0,-51.0,-44.0,-44.0,-87.0,-86.0,-83.0,-83.0,38.0,34.0,39.0,38.0,1
4111,92:69:1D:31:68:E9,3839574,487389218,3924,3626128,3835650,483763090,0,4792,1105936,4650,1073801,142,32135,2125,10,4126,87,0,43,216660.0,130000.0,-51.0,-47.0,-42.0,-49.0,-51.0,-47.0,-43.0,-47.0,-87.0,-86.0,-83.0,-83.0,36.0,39.0,41.0,34.0,1
4112,CC:2F:71:3F:1F:24,4614305,1316981739,778655,833218649,3835650,483763090,37,627075,649357822,626354,649271076,721,86746,604964,15,778912,86454,34,515,130000.0,43333.0,-69.0,-66.0,-67.0,-71.0,-69.0,-66.0,-67.0,-71.0,-87.0,-86.0,-83.0,-83.0,18.0,20.0,16.0,12.0,1
4113,CC:2F:71:3E:C5:1F,3836527,483870207,875,106915,3835652,483763292,0,3649,306521,3011,230793,638,75728,926,8,1257,19,0,39,130000.0,39000.0,-71.0,-71.0,-70.0,-60.0,-72.0,-72.0,-70.0,-62.0,-87.0,-86.0,-83.0,-83.0,16.0,15.0,13.0,23.0,1
4114,BA:8C:B9:54:50:24,3840486,489945825,4834,6182533,3835652,483763292,0,8999,1699735,8977,1696240,22,3495,2348,15,5271,39,0,58,216660.0,130000.0,-40.0,-36.0,-45.0,-52.0,-43.0,-35.0,-44.0,-48.0,-87.0,-86.0,-83.0,-83.0,47.0,50.0,38.0,31.0,1
4115,62:47:05:9D:EB:15,3835698,483773129,43,9575,3835655,483763554,0,91,11411,80,9245,11,2166,38,0,61,0,0,4,216660.0,130000.0,-50.0,-50.0,-47.0,-45.0,-50.0,-50.0,-48.0,-47.0,-87.0,-86.0,-83.0,-83.0,37.0,36.0,36.0,38.0,1
4116,3C:55:76:E8:8F:1F,3870783,569865255,35128,86101701,3835655,483763554,20,16732,4067902,16479,4020831,253,47071,8081,17,35161,3092,20,160,195000.0,97500.0,-49.0,-52.0,-44.0,-45.0,-48.0,-51.0,-44.0,-44.0,-87.0,-86.0,-83.0,-83.0,38.0,34.0,39.0,38.0,1
4117,92:69:1D:31:68:E9,3839579,487389682,3924,3626128,3835655,483763554,0,4792,1105936,4650,1073801,142,32135,2125,10,4126,87,0,43,216660.0,130000.0,-51.0,-47.0,-42.0,-49.0,-51.0,-47.0,-43.0,-47.0,-87.0,-86.0,-83.0,-83.0,36.0,39.0,41.0,34.0,1
4118,CC:2F:71:3F:1F:24,4614519,1317245189,778864,833481635,3835655,483763554,37,627270,649617588,626549,649530842,721,86746,605148,15,779121,86465,34,515,144444.0,43333.0,-69.0,-66.0,-67.0,-72.0,-69.0,-66.0,-67.0,-71.0,-87.0,-86.0,-83.0,-83.0,18.0,20.0,16.0,11.0,1
4119,CC:2F:71:3E:C5:1F,3836530,483870469,875,106915,3835655,483763554,0,3649,306521,3011,230793,638,75728,926,8,1257,19,0,39,130000.0,39000.0,-71.0,-71.0,-70.0,-60.0,-72.0,-72.0,-70.0,-62.0,-87.0,-86.0,-83.0,-83.0,16.0,15.0,13.0,23.0,1
4120,BA:8C:B9:54:50:24,3840489,489946087,4834,6182533,3835655,483763554,0,8999,1699735,8977,1696240,22,3495,2348,15,5271,39,0,58,216660.0,130000.0,-40.0,-36.0,-45.0,-52.0,-43.0,-35.0,-44.0,-48.0,-87.0,-86.0,-83.0,-83.0,47.0,50.0,38.0,31.0,1
4121,62:47:05:9D:EB:15,3835704,483773735,43,9575,3835661,483764160,0,91,11411,80,9245,11,2166,38,0,61,0,0,4,216660.0,130000.0,-50.0,-50.0,-47.0,-45.0,-50.0,-50.0,-48.0,-47.0,-87.0,-86.0,-83.0,-83.0,37.0,36.0,36.0,38.0,1
4122,3C:55:76:E8:8F:1F,3870792,569866307,35131,86102147,3835661,483764160,20,16739,4069687,16486,4022616,253,47071,8085,17,35164,3092,20,160,206470.0,97500.0,-46.0,-51.0,-45.0,-41.0,-46.0,-50.0,-43.0,-41.0,-87.0,-86.0,-83.0,-83.0,41.0,35.0,38.0,42.0,1
4123,92:69:1D:31:68:E9,3839585,487390288,3924,3626128,3835661,483764160,0,4792,1105936,4650,1073801,142,32135,2125,10,4126,87,0,43,216660.0,130000.0,-51.0,-47.0,-42.0,-49.0,-51.0,-47.0,-43.0,-47.0,-87.0,-86.0,-83.0,-83.0,36.0,39.0,41.0,34.0,1
4124,CC:2F:71:3F:1F:24,4614735,1317509039,779074,833744879,3835661,483764160,37,627461,649869652,626740,649782906,721,86746,605333,15,779331,86467,34,515,130000.0,43333.0,-69.0,-66.0,-67.0,-72.0,-69.0,-66.0,-67.0,-70.0,-87.0,-86.0,-83.0,-83.0,18.0,20.0,16.0,11.0,1
4125,CC:2F:71:3E:C5:1F,3836536,483871075,875,106915,3835661,483764160,0,3649,306521,3011,230793,638,75728,926,8,1257,19,0,39,130000.0,39000.0,-71.0,-71.0,-70.0,-60.0,-72.0,-72.0,-70.0,-62.0,-87.0,-86.0,-83.0,-83.0,16.0,15.0,13.0,23.0,1
4126,BA:8C:B9:54:50:24,3840495,489946693,4834,6182533,3835661,483764160,0,8999,1699735,8977,1696240,22,3495,2348,15,5271,39,0,58,216660.0,130000.0,-40.0,-36.0,-45.0,-52.0,-43.0,-35.0,-44.0,-48.0,-87.0,-86.0,-83.0,-83.0,47.0,50.0,38.0,31.0,1
4127,62:47:05:9D:EB:15,3835707,483773997,43,9575,3835664,483764422,0,91,11411,80,9245,11,2166,38,0,61,0,0,4,216660.0,130000.0,-50.0,-50.0,-47.0,-45.0,-50.0,-50.0,-48.0,-47.0,-87.0,-86.0,-83.0,-83.0,37.0,36.0,36.0,38.0,1
4128,3C:55:76:E8:8F:1F,3870795,569866569,35131,86102147,3835664,483764422,20,16748,4070301,16495,4023230,253,47071,8085,17,35164,3092,20,160,206470.0,97500.0,-49.0,-52.0,-45.0,-45.0,-48.0,-51.0,-44.0,-44.0,-87.0,-86.0,-83.0,-83.0,38.0,34.0,38.0,38.0,1
4129,92:69:1D:31:68:E9,3839588,487390550,3924,3626128,3835664,483764422,0,4792,1105936,4650,1073801,142,32135,2125,10,4126,87,0,43,216660.0,130000.0,-51.0,-47.0,-42.0,-49.0,-51.0,-47.0,-43.0,-47.0,-87.0,-86.0,-83.0,-83.0,36.0,39.0,41.0,34.0,1
4130,CC:2F:71:3F:1F:24,4614953,1317775796,779289,834011374,3835664,483764422,37,627667,650135404,626946,650048658,721,86746,605525,15,779546,86468,34,515,130000.0,43333.0,-69.0,-66.0,-67.0,-72.0,-68.0,-66.0,-67.0,-71.0,-87.0,-86.0,-83.0,-83.0,18.0,20.0,16.0,11.0,1
4131,CC:2F:71:3E:C5:1F,3836541,483871539,875,106915,3835666,483764624,0,3649,306521,3011,230793,638,75728,926,8,1257,19,0,39,130000.0,39000.0,-71.0,-71.0,-70.0,-60.0,-72.0,-72.0,-70.0,-62.0,-87.0,-86.0,-83.0,-83.0,16.0,15.0,13.0,23.0,1
4132,BA:8C:B9:54:50:24,3840500,489947157,4834,6182533,3835666,483764624,0,8999,1699735,8977,1696240,22,3495,2348,15,5271,39,0,58,216660.0,130000.0,-40.0,-36.0,-45.0,-52.0,-43.0,-35.0,-44.0,-48.0,-87.0,-86.0,-83.0,-83.0,47.0,50.0,38.0,31.0,1
4133,62:47:05:9D:EB:15,3835714,483774719,44,9691,3835670,483765028,0,93,11547,82,9381,11,2166,38,0,62,0,0,4,216660.0,130000.0,-60.0,-56.0,-56.0,-63.0,-52.0,-51.0,-50.0,-49.0,-87.0,-86.0,-83.0,-83.0,27.0,30.0,27.0,20.0,1
4134,3C:55:76:E8:8F:1F,3870801,569867175,35131,86102147,3835670,483765028,20,16748,4070301,16495,4023230,253,47071,8085,17,35164,3092,20,160,206470.0,97500.0,-49.0,-52.0,-45.0,-45.0,-48.0,-51.0,-44.0,-44.0,-87.0,-86.0,-83.0,-83.0,38.0,34.0,38.0,38.0,1
4135,92:69:1D:31:68:E9,3839595,487391272,3925,3626244,3835670,483765028,0,4794,1106072,4652,1073937,142,32135,2125,10,4127,87,0,43,229410.0,130000.0,-52.0,-46.0,-42.0,-49.0,-51.0,-47.0,-43.0,-47.0,-87.0,-86.0,-83.0,-83.0,35.0,40.0,41.0,34.0,1
4136,CC:2F:71:3F:1F:24,4615169,1318039418,779499,834274390,3835670,483765028,37,627866,650399856,627145,650313110,721,86746,605711,15,779756,86481,34,515,130000.0,43333.0,-68.0,-65.0,-67.0,-71.0,-68.0,-65.0,-67.0,-71.0,-87.0,-86.0,-83.0,-83.0,19.0,21.0,16.0,12.0,1
4137,CC:2F:71:3E:C5:1F,3836546,483872059,876,107031,3835670,483765028,0,3651,306661,3013,230933,638,75728,926,8,1258,19,0,39,130000.0,39000.0,-71.0,-71.0,-69.0,-61.0,-72.0,-72.0,-70.0,-63.0,-87.0,-86.0,-83.0,-83.0,16.0,15.0,14.0,22.0,1
4138,BA:8C:B9:54:50:24,3840507,489947879,4835,6182649,3835672,483765230,0,9001,1699871,8979,1696376,22,3495,2348,15,5272,39,0,58,216660.0,130000.0,-39.0,-37.0,-45.0,-52.0,-44.0,-35.0,-43.0,-47.0,-87.0,-86.0,-83.0,-83.0,48.0,49.0,38.0,31.0,1
4139,62:47:05:9D:EB:15,3835717,483774991,44,9691,3835673,483765300,0,93,11547,82,9381,11,2166,38,0,62,0,0,4,216660.0,130000.0,-60.0,-56.0,-56.0,-63.0,-52.0,-51.0,-50.0,-49.0,-87.0,-86.0,-83.0,-83.0,27.0,30.0,27.0,20.0,1
4140,3C:55:76:E8:8F:1F,3871458,571595470,35783,87829968,3835675,483765502,20,16913,4093926,16659,4046729,254,47197,8163,17,35816,3097,20,160,243750.0,146250.0,-48.0,-51.0,-44.0,-45.0,-48.0,-51.0,-44.0,-44.0,-87.0,-86.0,-83.0,-83.0,39.0,35.0,39.0,38.0,1
4141,92:69:1D:31:68:E9,3839603,487392008,3925,3626244,3835678,483765764,0,4794,1106072,4652,1073937,142,32135,2125,10,4127,87,0,43,229410.0,130000.0,-52.0,-46.0,-42.0,-49.0,-51.0,-47.0,-43.0,-47.0,-87.0,-86.0,-83.0,-83.0,35.0,40.0,41.0,34.0,1
4142,CC:2F:71:3F:1F:24,4615385,1318303148,779707,834537384,3835678,483765764,37,628060,650653780,627339,650567034,721,86746,605898,15,779964,86481,34,515,130000.0,43333.0,-69.0,-66.0,-67.0,-71.0,-68.0,-65.0,-67.0,-71.0,-87.0,-86.0,-83.0,-83.0,18.0,20.0,16.0,12.0,1
4143,CC:2F:71:3E:C5:1F,3836554,483872795,876,107031,3835678,483765764,0,3651,306661,3013,230933,638,75728,926,8,1258,19,0,39,130000.0,39000.0,-71.0,-71.0,-69.0,-61.0,-72.0,-72.0,-70.0,-63.0,-87.0,-86.0,-83.0,-83.0,16.0,15.0,14.0,22.0,1
4144,BA:8C:B9:54:50:24,3840514,489948686,4835,6182649,3835679,483766037,0,9001,1699871,8979,1696376,22,3495,2348,15,5272,39,0,58,216660.0,130000.0,-39.0,-37.0,-45.0,-52.0,-44.0,-35.0,-43.0,-47.0,-87.0,-86.0,-83.0,-83.0,48.0,49.0,38.0,31.0,1
4145,62:47:05:9D:EB:15,3835725,483775930,44,9691,3835681,483766239,0,93,11547,82,9381,11,2166,38,0,62,0,0,4,216660.0,130000.0,-60.0,-56.0,-56.0,-63.0,-52.0,-51.0,-50.0,-49.0,-87.0,-86.0,-83.0,-83.0,27.0,30.0,27.0,20.0,1
4146,3C:55:76:E8:8F:1F,3871464,571596207,35783,87829968,3835681,483766239,20,16922,4094540,16668,4047343,254,47197,8163,17,35816,3097,20,161,243750.0,146250.0,-49.0,-52.0,-45.0,-45.0,-48.0,-51.0,-44.0,-45.0,-87.0,-86.0,-83.0,-83.0,38.0,34.0,38.0,38.0,1
4147,92:69:1D:31:68:E9,3839608,487392685,3925,3626244,3835683,483766441,0,4794,1106072,4652,1073937,142,32135,2125,10,4127,87,0,43,229410.0,130000.0,-52.0,-46.0,-42.0,-49.0,-51.0,-47.0,-43.0,-47.0,-87.0,-86.0,-83.0,-83.0,35.0,40.0,41.0,34.0,1
4148,CC:2F:71:3F:1F:24,4615599,1318566671,779915,834800168,3835684,483766503,37,628255,650914922,627534,650828176,721,86746,606082,15,780172,86492,34,515,130000.0,43333.0,-68.0,-65.0,-67.0,-71.0,-68.0,-65.0,-67.0,-71.0,-87.0,-86.0,-83.0,-83.0,19.0,21.0,16.0,12.0,1
4149,CC:2F:71:3E:C5:1F,3836560,483873534,876,107031,3835684,483766503,0,3651,306661,3013,230933,638,75728,926,8,1258,19,0,39,130000.0,39000.0,-71.0,-71.0,-69.0,-61.0,-72.0,-72.0,-70.0,-63.0,-87.0,-86.0,-83.0,-83.0,16.0,15.0,14.0,22.0,1
4150,BA:8C:B9:54:50:24,3840519,489949152,4835,6182649,3835684,483766503,0,9001,1699871,8979,1696376,22,3495,2348,15,5272,39,0,58,216660.0,130000.0,-39.0,-37.0,-45.0,-52.0,-44.0,-35.0,-43.0,-47.0,-87.0,-86.0,-83.0,-83.0,48.0,49.0,38.0,31.0,1
4151,62:47:05:9D:EB:15,3835732,483776598,44,9691,3835688,483766907,0,93,11547,82,9381,11,2166,38,0,62,0,0,4,216660.0,130000.0,-60.0,-56.0,-56.0,-63.0,-52.0,-51.0,-50.0,-49.0,-87.0,-86.0,-83.0,-83.0,27.0,30.0,27.0,20.0,1
4152,3C:55:76:E8:8F:1F,3871475,571598172,35787,87831265,3835688,483766907,20,16941,4102806,16686,4055491,255,47315,8170,17,35820,3097,20,161,243750.0,1000.0,-46.0,-51.0,-44.0,-42.0,-44.0,-53.0,-45.0,-39.0,-87.0,-86.0,-83.0,-83.0,41.0,35.0,39.0,41.0,1
4153,92:69:1D:31:68:E9,3839613,487393151,3925,3626244,3835688,483766907,0,4794,1106072,4652,1073937,142,32135,2125,10,4127,87,0,43,229410.0,130000.0,-52.0,-46.0,-42.0,-49.0,-51.0,-47.0,-43.0,-47.0,-87.0,-86.0,-83.0,-83.0,35.0,40.0,41.0,34.0,1
4154,CC:2F:71:3F:1F:24,4615822,1318836938,780134,835070031,3835688,483766907,37,628459,651176289,627738,651089543,721,86746,606276,15,780391,86493,34,515,130000.0,43333.0,-69.0,-66.0,-67.0,-71.0,-68.0,-65.0,-66.0,-71.0,-87.0,-86.0,-83.0,-83.0,18.0,20.0,16.0,12.0,1
4155,CC:2F:71:3E:C5:1F,3836566,483874140,876,107031,3835690,483767109,0,3651,306661,3013,230933,638,75728,926,8,1258,19,0,39,130000.0,39000.0,-71.0,-71.0,-69.0,-61.0,-72.0,-72.0,-70.0,-63.0,-87.0,-86.0,-83.0,-83.0,16.0,15.0,14.0,22.0,1
4156,BA:8C:B9:54:50:24,3840525,489949758,4835,6182649,3835690,483767109,0,9001,1699871,8979,1696376,22,3495,2348,15,5272,39,0,58,216660.0,130000.0,-39.0,-37.0,-45.0,-52.0,-44.0,-35.0,-43.0,-47.0,-87.0,-86.0,-83.0,-83.0,48.0,49.0,38.0,31.0,1
4157,62:47:05:9D:EB:15,3835737,483777062,44,9691,3835693,483767371,0,93,11547,82,9381,11,2166,38,0,62,0,0,4,216660.0,130000.0,-60.0,-56.0,-56.0,-63.0,-52.0,-51.0,-50.0,-49.0,-87.0,-86.0,-83.0,-83.0,27.0,30.0,27.0,20.0,1
4158,3C:55:76:E8:8F:1F,3871480,571598636,35787,87831265,3835693,483767371,20,16951,4103488,16696,4056173,255,47315,8170,17,35820,3097,20,161,243750.0,1000.0,-45.0,-55.0,-48.0,-39.0,-44.0,-55.0,-48.0,-39.0,-87.0,-86.0,-83.0,-83.0,42.0,31.0,35.0,44.0,1
4159,92:69:1D:31:68:E9,3839618,487393615,3925,3626244,3835693,483767371,0,4794,1106072,4652,1073937,142,32135,2125,10,4127,87,0,43,229410.0,130000.0,-52.0,-46.0,-42.0,-49.0,-51.0,-47.0,-43.0,-47.0,-87.0,-86.0,-83.0,-83.0,35.0,40.0,41.0,34.0,1
4160,CC:2F:71:3F:1F:24,4616036,1319100316,780343,835332945,3835693,483767371,37,628660,651443927,627939,651357181,721,86746,606462,15,780600,86504,34,515,130000.0,43333.0,-68.0,-67.0,-68.0,-72.0,-67.0,-66.0,-67.0,-71.0,-87.0,-86.0,-83.0,-83.0,19.0,19.0,15.0,11.0,1
4161,CC:2F:71:3E:C5:1F,3836569,483874402,876,107031,3835693,483767371,0,3651,306661,3013,230933,638,75728,926,8,1258,19,0,39,130000.0,39000.0,-71.0,-71.0,-69.0,-61.0,-72.0,-72.0,-70.0,-63.0,-87.0,-86.0,-83.0,-83.0,16.0,15.0,14.0,22.0,1
4162,BA:8C:B9:54:50:24,3840528,489950020,4835,6182649,3835693,483767371,0,9001,1699871,8979,1696376,22,3495,2348,15,5272,39,0,58,216660.0,130000.0,-39.0,-37.0,-45.0,-52.0,-44.0,-35.0,-43.0,-47.0,-87.0,-86.0,-83.0,-83.0,48.0,49.0,38.0,31.0,1
4163,62:47:05:9D:EB:15,3835744,483777730,44,9691,3835700,483768039,0,93,11547,82,9381,11,2166,38,0,62,0,0,4,216660.0,130000.0,-60.0,-56.0,-56.0,-63.0,-52.0,-51.0,-50.0,-49.0,-87.0,-86.0,-83.0,-83.0,27.0,30.0,27.0,20.0,1
4164,3C:55:76:E8:8F:1F,3871488,571599428,35788,87831389,3835700,483768039,20,16960,4104140,16705,4056825,255,47315,8171,17,35821,3097,20,161,243750.0,146250.0,-47.0,-49.0,-49.0,-45.0,-47.0,-49.0,-47.0,-44.0,-87.0,-86.0,-83.0,-83.0,40.0,37.0,34.0,38.0,1
4165,92:69:1D:31:68:E9,3839625,487394283,3925,3626244,3835700,483768039,0,4794,1106072,4652,1073937,142,32135,2125,10,4127,87,0,43,229410.0,130000.0,-52.0,-46.0,-42.0,-49.0,-51.0,-47.0,-43.0,-47.0,-87.0,-86.0,-83.0,-83.0,35.0,40.0,41.0,34.0,1
4166,CC:2F:71:3F:1F:24,4616255,1319364498,780555,835596459,3835700,483768039,37,628859,651702897,628138,651616151,721,86746,606649,15,780812,86504,34,515,130000.0,43333.0,-68.0,-65.0,-67.0,-69.0,-68.0,-65.0,-66.0,-69.0,-87.0,-86.0,-83.0,-83.0,19.0,21.0,16.0,14.0,1
4167,CC:2F:71:3E:C5:1F,3836576,483875070,876,107031,3835700,483768039,0,3653,306849,3014,231003,639,75846,927,8,1258,19,0,39,130000.0,39000.0,-72.0,-72.0,-70.0,-60.0,-71.0,-71.0,-69.0,-61.0,-87.0,-86.0,-83.0,-83.0,15.0,14.0,13.0,23.0,1
4168,BA:8C:B9:54:50:24,3840535,489950688,4835,6182649,3835700,483768039,0,9001,1699871,8979,1696376,22,3495,2348,15,5272,39,0,58,216660.0,130000.0,-39.0,-37.0,-45.0,-52.0,-44.0,-35.0,-43.0,-47.0,-87.0,-86.0,-83.0,-83.0,48.0,49.0,38.0,31.0,1
4169,62:47:05:9D:EB:15,3835747,483777992,44,9691,3835703,483768301,0,93,11547,82,9381,11,2166,38,0,62,0,0,4,216660.0,130000.0,-60.0,-56.0,-56.0,-63.0,-52.0,-51.0,-50.0,-49.0,-87.0,-86.0,-83.0,-83.0,27.0,30.0,27.0,20.0,1
4170,3C:55:76:E8:8F:1F,3871491,571599690,35788,87831389,3835703,483768301,20,16960,4104140,16705,4056825,255,47315,8171,17,35821,3097,20,161,243750.0,146250.0,-47.0,-49.0,-49.0,-45.0,-47.0,-49.0,-47.0,-44.0,-87.0,-86.0,-83.0,-83.0,40.0,37.0,34.0,38.0,1
4171,92:69:1D:31:68:E9,3839628,487394545,3925,3626244,3835703,483768301,0,4794,1106072,4652,1073937,142,32135,2125,10,4127,87,0,43,229410.0,130000.0,-52.0,-46.0,-42.0,-49.0,-51.0,-47.0,-43.0,-47.0,-87.0,-86.0,-83.0,-83.0,35.0,40.0,41.0,34.0,1
4172,CC:2F:71:3F:1F:24,4616473,1319628391,780770,835860090,3835703,483768301,37,629055,651954611,628334,651867865,721,86746,606840,15,781027,86504,34,516,130000.0,43333.0,-68.0,-66.0,-67.0,-69.0,-68.0,-66.0,-67.0,-69.0,-87.0,-86.0,-83.0,-83.0,19.0,20.0,16.0,14.0,1
4173,CC:2F:71:3E:C5:1F,3836579,483875332,876,107031,3835703,483768301,0,3653,306849,3014,231003,639,75846,927,8,1258,19,0,39,130000.0,39000.0,-72.0,-72.0,-70.0,-60.0,-71.0,-71.0,-69.0,-61.0,-87.0,-86.0,-83.0,-83.0,15.0,14.0,13.0,23.0,1
4174,BA:8C:B9:54:50:24,3840540,489951152,4835,6182649,3835705,483768503,0,9001,1699871,8979,1696376,22,3495,2348,15,5272,39,0,58,216660.0,130000.0,-39.0,-37.0,-45.0,-52.0,-44.0,-35.0,-43.0,-47.0,-87.0,-86.0,-83.0,-83.0,48.0,49.0,38.0,31.0,1
4175,62:47:05:9D:EB:15,3835754,483778660,44,9691,3835710,483768969,0,93,11547,82,9381,11,2166,38,0,62,0,0,4,216660.0,130000.0,-60.0,-56.0,-56.0,-63.0,-52.0,-51.0,-50.0,-49.0,-87.0,-86.0,-83.0,-83.0,27.0,30.0,27.0,20.0,1
4176,3C:55:76:E8:8F:1F,3871499,571600476,35789,87831507,3835710,483768969,20,16968,4104814,16713,4057499,255,47315,8173,17,35822,3097,20,161,243750.0,146250.0,-46.0,-47.0,-50.0,-43.0,-45.0,-45.0,-48.0,-42.0,-87.0,-86.0,-83.0,-83.0,41.0,39.0,33.0,40.0,1
4177,92:69:1D:31:68:E9,3839635,487395213,3925,3626244,3835710,483768969,0,4794,1106072,4652,1073937,142,32135,2125,10,4127,87,0,43,229410.0,130000.0,-52.0,-46.0,-42.0,-49.0,-51.0,-47.0,-43.0,-47.0,-87.0,-86.0,-83.0,-83.0,35.0,40.0,41.0,34.0,1
4178,CC:2F:71:3F:1F:24,4616688,1319891899,780978,836122930,3835710,483768969,37,629249,652214105,628527,652127241,722,86864,607024,15,781233,86504,34,516,144444.0,43333.0,-67.0,-66.0,-67.0,-68.0,-67.0,-66.0,-67.0,-68.0,-87.0,-86.0,-83.0,-83.0,20.0,20.0,16.0,15.0,1
4179,CC:2F:71:3E:C5:1F,3836586,483876000,876,107031,3835710,483768969,0,3653,306849,3014,231003,639,75846,927,8,1258,19,0,39,130000.0,39000.0,-72.0,-72.0,-70.0,-60.0,-71.0,-71.0,-69.0,-61.0,-87.0,-86.0,-83.0,-83.0,15.0,14.0,13.0,23.0,1
4180,BA:8C:B9:54:50:24,3840545,489951618,4835,6182649,3835710,483768969,0,9001,1699871,8979,1696376,22,3495,2348,15,5272,39,0,58,216660.0,130000.0,-39.0,-37.0,-45.0,-52.0,-44.0,-35.0,-43.0,-47.0,-87.0,-86.0,-83.0,-83.0,48.0,49.0,38.0,31.0,1
4181,62:47:05:9D:EB:15,3835756,483778862,44,9691,3835712,483769171,0,95,11683,84,9517,11,2166,38,0,63,0,0,4,216660.0,130000.0,-49.0,-51.0,-50.0,-44.0,-52.0,-51.0,-50.0,-49.0,-87.0,-86.0,-83.0,-83.0,38.0,35.0,33.0,39.0,1
4182,3C:55:76:E8:8F:1F,3871502,571600738,35789,87831507,3835713,483769231,20,16968,4104814,16713,4057499,255,47315,8173,17,35822,3097,20,161,243750.0,146250.0,-46.0,-47.0,-50.0,-43.0,-45.0,-45.0,-48.0,-42.0,-87.0,-86.0,-83.0,-83.0,41.0,39.0,33.0,40.0,1
4183,92:69:1D:31:68:E9,3839640,487395677,3925,3626244,3835715,483769433,0,4797,1106276,4655,1074141,142,32135,2125,10,4128,87,0,43,229410.0,130000.0,-52.0,-47.0,-42.0,-48.0,-51.0,-47.0,-43.0,-47.0,-87.0,-86.0,-83.0,-83.0,35.0,39.0,41.0,35.0,1
4184,CC:2F:71:3F:1F:24,4616899,1320152263,781184,836382830,3835715,483769433,37,629450,652476191,628728,652389327,722,86864,607210,15,781441,86509,34,516,144444.0,43333.0,-69.0,-66.0,-67.0,-69.0,-69.0,-66.0,-66.0,-69.0,-87.0,-86.0,-83.0,-83.0,18.0,20.0,16.0,14.0,1
4185,CC:2F:71:3E:C5:1F,3836593,483876666,876,107031,3835717,483769635,0,3653,306849,3014,231003,639,75846,927,8,1258,19,0,39,130000.0,39000.0,-72.0,-72.0,-70.0,-60.0,-71.0,-71.0,-69.0,-61.0,-87.0,-86.0,-83.0,-83.0,15.0,14.0,13.0,23.0,1
4186,BA:8C:B9:54:50:24,3840552,489952284,4835,6182649,3835717,483769635,0,9003,1700007,8981,1696512,22,3495,2348,15,5273,39,0,58,216660.0,130000.0,-40.0,-36.0,-45.0,-52.0,-43.0,-35.0,-44.0,-48.0,-87.0,-86.0,-83.0,-83.0,47.0,50.0,38.0,31.0,1
4187,62:47:05:9D:EB:15,3835763,483779528,44,9691,3835719,483769837,0,95,11683,84,9517,11,2166,38,0,63,0,0,4,216660.0,130000.0,-49.0,-51.0,-50.0,-44.0,-52.0,-51.0,-50.0,-49.0,-87.0,-86.0,-83.0,-83.0,38.0,35.0,33.0,39.0,1
4188,3C:55:76:E8:8F:1F,3871508,571601344,35789,87831507,3835719,483769837,20,16968,4104814,16713,4057499,255,47315,8173,17,35822,3097,20,161,243750.0,146250.0,-46.0,-47.0,-50.0,-43.0,-45.0,-45.0,-48.0,-42.0,-87.0,-86.0,-83.0,-83.0,41.0,39.0,33.0,40.0,1
4189,92:69:1D:31:68:E9,3839644,487396081,3925,3626244,3835719,483769837,0,4797,1106276,4655,1074141,142,32135,2125,10,4128,87,0,43,229410.0,130000.0,-52.0,-47.0,-42.0,-48.0,-51.0,-47.0,-43.0,-47.0,-87.0,-86.0,-83.0,-83.0,35.0,39.0,41.0,35.0,1
4190,CC:2F:71:3F:1F:24,4617114,1320415951,781393,836645912,3835721,483770039,37,629649,652737763,628927,652650899,722,86864,607397,15,781650,86520,34,516,130000.0,43333.0,-69.0,-66.0,-67.0,-71.0,-68.0,-66.0,-67.0,-71.0,-87.0,-86.0,-83.0,-83.0,18.0,20.0,16.0,12.0,1
4191,CC:2F:71:3E:C5:1F,3836597,483877070,876,107031,3835721,483770039,0,3653,306849,3014,231003,639,75846,927,8,1258,19,0,39,130000.0,39000.0,-72.0,-72.0,-70.0,-60.0,-71.0,-71.0,-69.0,-61.0,-87.0,-86.0,-83.0,-83.0,15.0,14.0,13.0,23.0,1
4192,BA:8C:B9:54:50:24,3840556,489952688,4835,6182649,3835721,483770039,0,9003,1700007,8981,1696512,22,3495,2348,15,5273,39,0,58,216660.0,130000.0,-40.0,-36.0,-45.0,-52.0,-43.0,-35.0,-44.0,-48.0,-87.0,-86.0,-83.0,-83.0,47.0,50.0,38.0,31.0,1
4193,62:47:05:9D:EB:15,3835767,483779932,44,9691,3835723,483770241,0,95,11683,84,9517,11,2166,38,0,63,0,0,4,216660.0,130000.0,-49.0,-51.0,-50.0,-44.0,-52.0,-51.0,-50.0,-49.0,-87.0,-86.0,-83.0,-83.0,38.0,35.0,33.0,39.0,1
4194,3C:55:76:E8:8F:1F,3871517,571602564,35794,87832323,3835723,483770241,20,16986,4107907,16731,4060592,255,47315,8179,17,35827,3097,20,161,243750.0,146250.0,-48.0,-53.0,-47.0,-45.0,-47.0,-52.0,-45.0,-43.0,-87.0,-86.0,-83.0,-83.0,39.0,33.0,36.0,38.0,1
4195,92:69:1D:31:68:E9,3839650,487396687,3925,3626244,3835725,483770443,0,4797,1106276,4655,1074141,142,32135,2125,10,4128,87,0,43,229410.0,130000.0,-52.0,-47.0,-42.0,-48.0,-51.0,-47.0,-43.0,-47.0,-87.0,-86.0,-83.0,-83.0,35.0,39.0,41.0,35.0,1
4196,CC:2F:71:3F:1F:24,4617331,1320682350,781606,836911907,3835725,483770443,37,629853,653000550,629131,652913686,722,86864,607589,15,781863,86524,34,516,130000.0,43333.0,-69.0,-66.0,-67.0,-72.0,-68.0,-66.0,-67.0,-72.0,-87.0,-86.0,-83.0,-83.0,18.0,20.0,16.0,11.0,1
4197,CC:2F:71:3E:C5:1F,3836603,483877676,876,107031,3835727,483770645,0,3653,306849,3014,231003,639,75846,927,8,1258,19,0,39,130000.0,39000.0,-72.0,-72.0,-70.0,-60.0,-71.0,-71.0,-69.0,-61.0,-87.0,-86.0,-83.0,-83.0,15.0,14.0,13.0,23.0,1
4198,BA:8C:B9:54:50:24,3840562,489953294,4835,6182649,3835727,483770645,0,9003,1700007,8981,1696512,22,3495,2348,15,5273,39,0,58,216660.0,130000.0,-40.0,-36.0,-45.0,-52.0,-43.0,-35.0,-44.0,-48.0,-87.0,-86.0,-83.0,-83.0,47.0,50.0,38.0,31.0,1
4199,62:47:05:9D:EB:15,3835774,483780598,44,9691,3835730,483770907,0,95,11683,84,9517,11,2166,38,0,63,0,0,4,216660.0,130000.0,-49.0,-51.0,-50.0,-44.0,-52.0,-51.0,-50.0,-49.0,-87.0,-87.0,-84.0,-83.0,38.0,36.0,34.0,39.0,1
4200,3C:55:76:E8:8F:1F,3871528,571606227,35798,87835320,3835730,483770907,20,17004,4112594,16749,4065279,255,47315,8184,17,35831,3097,20,161,258080.0,146250.0,-49.0,-53.0,-47.0,-45.0,-48.0,-52.0,-46.0,-45.0,-87.0,-87.0,-84.0,-83.0,38.0,34.0,37.0,38.0,1
4201,92:69:1D:31:68:E9,3839655,487397151,3925,3626244,3835730,483770907,0,4797,1106276,4655,1074141,142,32135,2125,10,4128,87,0,43,229410.0,130000.0,-52.0,-47.0,-42.0,-48.0,-51.0,-47.0,-43.0,-47.0,-87.0,-87.0,-84.0,-83.0,35.0,40.0,42.0,35.0,1
4202,CC:2F:71:3F:1F:24,4617557,1320951551,781815,837175045,3835742,483776506,37,630049,653260322,629327,653173458,722,86864,607775,15,782072,86524,34,516,130000.0,43333.0,-70.0,-66.0,-67.0,-72.0,-69.0,-66.0,-67.0,-71.0,-87.0,-87.0,-84.0,-83.0,17.0,21.0,17.0,11.0,1
4203,CC:2F:71:3E:C5:1F,3836618,483883537,876,107031,3835742,483776506,0,3653,306849,3014,231003,639,75846,927,8,1258,19,0,39,130000.0,39000.0,-72.0,-72.0,-70.0,-60.0,-71.0,-71.0,-69.0,-61.0,-87.0,-87.0,-84.0,-83.0,15.0,15.0,14.0,23.0,1
4204,BA:8C:B9:54:50:24,3840577,489959155,4835,6182649,3835742,483776506,0,9003,1700007,8981,1696512,22,3495,2348,15,5273,39,0,58,216660.0,130000.0,-40.0,-36.0,-45.0,-52.0,-43.0,-35.0,-44.0,-48.0,-87.0,-87.0,-84.0,-83.0,47.0,51.0,39.0,31.0,1
4205,62:47:05:9D:EB:15,3835803,483792227,44,9691,3835759,483782536,0,95,11683,84,9517,11,2166,38,0,63,0,0,4,216660.0,130000.0,-49.0,-51.0,-50.0,-44.0,-52.0,-51.0,-50.0,-49.0,-87.0,-87.0,-84.0,-83.0,38.0,36.0,34.0,39.0,1
4206,3C:55:76:E8:8F:1F,3871558,571617924,35799,87835388,3835759,483782536,20,17005,4112664,16750,4065349,255,47315,8184,17,35832,3097,20,161,258080.0,146250.0,-43.0,-51.0,-49.0,-37.0,-47.0,-52.0,-47.0,-44.0,-87.0,-87.0,-84.0,-83.0,44.0,36.0,35.0,46.0,1
4207,92:69:1D:31:68:E9,3839684,487408780,3925,3626244,3835759,483782536,0,4800,1106647,4657,1074277,143,32370,2126,10,4128,87,0,43,229410.0,130000.0,-51.0,-47.0,-42.0,-49.0,-51.0,-47.0,-43.0,-48.0,-87.0,-87.0,-84.0,-83.0,36.0,40.0,42.0,34.0,1
4208,CC:2F:71:3F:1F:24,4617797,1321242379,782038,837459843,3835759,483782536,37,630261,653544754,629539,653457890,722,86864,607976,15,782295,86540,34,516,144444.0,43333.0,-69.0,-66.0,-67.0,-71.0,-69.0,-65.0,-67.0,-71.0,-87.0,-87.0,-84.0,-83.0,18.0,21.0,17.0,12.0,1
4209,CC:2F:71:3E:C5:1F,3836635,483889567,876,107031,3835759,483782536,0,3653,306849,3014,231003,639,75846,927,8,1258,19,0,39,130000.0,39000.0,-72.0,-72.0,-70.0,-60.0,-71.0,-71.0,-69.0,-61.0,-87.0,-87.0,-84.0,-83.0,15.0,15.0,14.0,23.0,1
4210,BA:8C:B9:54:50:24,3840594,489965185,4835,6182649,3835759,483782536,0,9003,1700007,8981,1696512,22,3495,2348,15,5273,39,0,58,216660.0,130000.0,-40.0,-36.0,-45.0,-52.0,-43.0,-35.0,-44.0,-48.0,-87.0,-87.0,-84.0,-83.0,47.0,51.0,39.0,31.0,1
4211,62:47:05:9D:EB:15,3835807,483792762,44,9691,3835763,483783071,0,95,11683,84,9517,11,2166,38,0,63,0,0,4,216660.0,130000.0,-49.0,-51.0,-50.0,-44.0,-52.0,-51.0,-50.0,-49.0,-87.0,-87.0,-84.0,-83.0,38.0,36.0,34.0,39.0,1
4212,3C:55:76:E8:8F:1F,3871562,571618459,35799,87835388,3835763,483783071,20,17017,4113518,16762,4066203,255,47315,8185,17,35832,3097,20,161,258080.0,146250.0,-44.0,-53.0,-50.0,-40.0,-44.0,-52.0,-50.0,-40.0,-87.0,-87.0,-84.0,-83.0,43.0,34.0,34.0,43.0,1
4213,92:69:1D:31:68:E9,3839688,487409315,3925,3626244,3835763,483783071,0,4800,1106647,4657,1074277,143,32370,2126,10,4128,87,0,43,229410.0,130000.0,-51.0,-47.0,-42.0,-49.0,-51.0,-47.0,-43.0,-48.0,-87.0,-87.0,-84.0,-83.0,36.0,40.0,42.0,34.0,1
4214,CC:2F:71:3F:1F:24,4618017,1321509131,782254,837726060,3835763,483783071,37,630469,653813110,629747,653726246,722,86864,608168,15,782511,86552,34,516,117000.0,39000.0,-69.0,-66.0,-67.0,-71.0,-69.0,-66.0,-66.0,-71.0,-87.0,-87.0,-84.0,-83.0,18.0,21.0,17.0,12.0,1
4215,CC:2F:71:3E:C5:1F,3836639,483890102,876,107031,3835763,483783071,0,3653,306849,3014,231003,639,75846,927,8,1258,19,0,39,130000.0,39000.0,-72.0,-72.0,-70.0,-60.0,-71.0,-71.0,-69.0,-61.0,-87.0,-87.0,-84.0,-83.0,15.0,15.0,14.0,23.0,1
4216,BA:8C:B9:54:50:24,3840600,489965922,4835,6182649,3835765,483783273,0,9003,1700007,8981,1696512,22,3495,2348,15,5273,39,0,58,216660.0,130000.0,-40.0,-36.0,-45.0,-52.0,-43.0,-35.0,-44.0,-48.0,-87.0,-87.0,-84.0,-83.0,47.0,51.0,39.0,31.0,1
4217,62:47:05:9D:EB:15,3835813,483793368,44,9691,3835769,483783677,0,95,11683,84,9517,11,2166,38,0,63,0,0,4,216660.0,130000.0,-49.0,-51.0,-50.0,-44.0,-52.0,-51.0,-50.0,-49.0,-87.0,-87.0,-84.0,-83.0,38.0,36.0,34.0,39.0,1
4218,3C:55:76:E8:8F:1F,3871568,571619065,35799,87835388,3835769,483783677,20,17017,4113518,16762,4066203,255,47315,8185,17,35832,3097,20,161,258080.0,146250.0,-44.0,-53.0,-50.0,-40.0,-44.0,-52.0,-50.0,-40.0,-87.0,-87.0,-84.0,-83.0,43.0,34.0,34.0,43.0,1
4219,92:69:1D:31:68:E9,3839694,487409921,3925,3626244,3835769,483783677,0,4800,1106647,4657,1074277,143,32370,2126,10,4128,87,0,43,229410.0,130000.0,-51.0,-47.0,-42.0,-49.0,-51.0,-47.0,-43.0,-48.0,-87.0,-87.0,-84.0,-83.0,36.0,40.0,42.0,34.0,1
4220,CC:2F:71:3F:1F:24,4618231,1321772633,782462,837988956,3835769,483783677,37,630665,654072944,629943,653986080,722,86864,608353,15,782719,86556,34,516,130000.0,43333.0,-69.0,-66.0,-67.0,-71.0,-69.0,-66.0,-66.0,-71.0,-87.0,-87.0,-84.0,-83.0,18.0,21.0,17.0,12.0,1
4221,CC:2F:71:3E:C5:1F,3836645,483890708,876,107031,3835769,483783677,0,3653,306849,3014,231003,639,75846,927,8,1258,19,0,39,130000.0,39000.0,-72.0,-72.0,-70.0,-60.0,-71.0,-71.0,-69.0,-61.0,-87.0,-87.0,-84.0,-83.0,15.0,15.0,14.0,23.0,1
4222,BA:8C:B9:54:50:24,3840604,489966326,4835,6182649,3835769,483783677,0,9003,1700007,8981,1696512,22,3495,2348,15,5273,39,0,58,216660.0,130000.0,-40.0,-36.0,-45.0,-52.0,-43.0,-35.0,-44.0,-48.0,-87.0,-87.0,-84.0,-83.0,47.0,51.0,39.0,31.0,1
4223,62:47:05:9D:EB:15,3835816,483793630,44,9691,3835772,483783939,0,95,11683,84,9517,11,2166,38,0,63,0,0,4,216660.0,130000.0,-49.0,-51.0,-50.0,-44.0,-52.0,-51.0,-50.0,-49.0,-87.0,-87.0,-84.0,-83.0,38.0,36.0,34.0,39.0,1
4224,3C:55:76:E8:8F:1F,3871573,571619529,35799,87835388,3835774,483784141,20,17017,4113518,16762,4066203,255,47315,8185,17,35832,3097,20,161,258080.0,146250.0,-44.0,-53.0,-50.0,-40.0,-44.0,-52.0,-50.0,-40.0,-87.0,-87.0,-84.0,-83.0,43.0,34.0,34.0,43.0,1
4225,92:69:1D:31:68:E9,3839699,487410385,3925,3626244,3835774,483784141,0,4800,1106647,4657,1074277,143,32370,2126,10,4128,87,0,43,229410.0,130000.0,-51.0,-47.0,-42.0,-49.0,-51.0,-47.0,-43.0,-48.0,-87.0,-87.0,-84.0,-83.0,36.0,40.0,42.0,34.0,1
4226,CC:2F:71:3F:1F:24,4618443,1322035751,782669,838251610,3835774,483784141,37,630859,654331108,630137,654244244,722,86864,608537,15,782926,86571,34,516,130000.0,43333.0,-69.0,-66.0,-66.0,-72.0,-69.0,-66.0,-66.0,-71.0,-87.0,-87.0,-84.0,-83.0,18.0,21.0,18.0,11.0,1
4227,CC:2F:71:3E:C5:1F,3836650,483891172,876,107031,3835774,483784141,0,3653,306849,3014,231003,639,75846,927,8,1258,19,0,39,130000.0,39000.0,-72.0,-72.0,-70.0,-60.0,-71.0,-71.0,-69.0,-61.0,-87.0,-87.0,-84.0,-83.0,15.0,15.0,14.0,23.0,1
4228,BA:8C:B9:54:50:24,3840611,489966992,4835,6182649,3835776,483784343,0,9003,1700007,8981,1696512,22,3495,2348,15,5273,39,0,58,216660.0,130000.0,-40.0,-36.0,-45.0,-52.0,-43.0,-35.0,-44.0,-48.0,-87.0,-87.0,-84.0,-83.0,47.0,51.0,39.0,31.0,1
4229,62:47:05:9D:EB:15,3835824,483794604,44,9691,3835780,483784913,0,95,11683,84,9517,11,2166,38,0,63,0,0,4,216660.0,130000.0,-49.0,-51.0,-50.0,-44.0,-52.0,-51.0,-50.0,-49.0,-87.0,-87.0,-84.0,-83.0,38.0,36.0,34.0,39.0,1
4230,3C:55:76:E8:8F:1F,3871580,571620425,35800,87835512,3835780,483784913,20,17024,4114062,16769,4066747,255,47315,8186,17,35833,3097,20,161,258080.0,146250.0,-44.0,-53.0,-50.0,-40.0,-44.0,-53.0,-49.0,-39.0,-87.0,-87.0,-84.0,-83.0,43.0,34.0,34.0,43.0,1
4231,92:69:1D:31:68:E9,3839705,487411157,3925,3626244,3835780,483784913,0,4800,1106647,4657,1074277,143,32370,2126,10,4128,87,0,43,229410.0,130000.0,-51.0,-47.0,-42.0,-49.0,-51.0,-47.0,-43.0,-48.0,-87.0,-87.0,-84.0,-83.0,36.0,40.0,42.0,34.0,1
4232,CC:2F:71:3F:1F:24,4618661,1322302617,782879,838517502,3835782,483785115,37,631054,654592236,630332,654505372,722,86864,608722,15,783136,86575,34,516,130000.0,43333.0,-69.0,-66.0,-67.0,-68.0,-69.0,-66.0,-66.0,-70.0,-87.0,-87.0,-84.0,-83.0,18.0,21.0,17.0,15.0,1
4233,CC:2F:71:3E:C5:1F,3836658,483892146,876,107031,3835782,483785115,0,3653,306849,3014,231003,639,75846,927,8,1258,19,0,39,130000.0,39000.0,-72.0,-72.0,-70.0,-60.0,-71.0,-71.0,-69.0,-61.0,-87.0,-87.0,-84.0,-83.0,15.0,15.0,14.0,23.0,1
4234,BA:8C:B9:54:50:24,3840617,489967764,4835,6182649,3835782,483785115,0,9003,1700007,8981,1696512,22,3495,2348,15,5273,39,0,58,216660.0,130000.0,-40.0,-36.0,-45.0,-52.0,-43.0,-35.0,-44.0,-48.0,-87.0,-87.0,-84.0,-83.0,47.0,51.0,39.0,31.0,1
4235,62:47:05:9D:EB:15,3835828,483795008,44,9691,3835784,483785317,0,95,11683,84,9517,11,2166,38,0,63,0,0,4,216660.0,130000.0,-49.0,-51.0,-50.0,-44.0,-52.0,-51.0,-50.0,-49.0,-87.0,-87.0,-84.0,-83.0,38.0,36.0,34.0,39.0,1
4236,3C:55:76:E8:8F:1F,3871587,571621496,35802,87836045,3835785,483785451,20,17039,4115485,16784,4068170,255,47315,8189,17,35835,3097,20,161,258080.0,146250.0,-49.0,-53.0,-47.0,-45.0,-47.0,-52.0,-46.0,-43.0,-87.0,-87.0,-84.0,-83.0,38.0,34.0,37.0,38.0,1
4237,92:69:1D:31:68:E9,3839713,487411965,3925,3626244,3835788,483785721,0,4800,1106647,4657,1074277,143,32370,2126,10,4128,87,0,43,229410.0,130000.0,-51.0,-47.0,-42.0,-49.0,-51.0,-47.0,-43.0,-48.0,-87.0,-87.0,-84.0,-83.0,36.0,40.0,42.0,34.0,1
4238,CC:2F:71:3F:1F:24,4618884,1322569724,783096,838784003,3835788,483785721,37,631262,654861072,630540,654774208,722,86864,608915,15,783353,86583,34,516,130000.0,43333.0,-69.0,-66.0,-67.0,-72.0,-68.0,-66.0,-66.0,-72.0,-87.0,-87.0,-84.0,-83.0,18.0,21.0,17.0,11.0,1
4239,CC:2F:71:3E:C5:1F,3836665,483892812,876,107031,3835789,483785781,0,3653,306849,3014,231003,639,75846,927,8,1258,19,0,39,130000.0,39000.0,-72.0,-72.0,-70.0,-60.0,-71.0,-71.0,-69.0,-61.0,-87.0,-87.0,-84.0,-83.0,15.0,15.0,14.0,23.0,1
4240,BA:8C:B9:54:50:24,3840624,489968430,4835,6182649,3835789,483785781,0,9003,1700007,8981,1696512,22,3495,2348,15,5273,39,0,58,216660.0,130000.0,-40.0,-36.0,-45.0,-52.0,-43.0,-35.0,-44.0,-48.0,-87.0,-87.0,-84.0,-83.0,47.0,51.0,39.0,31.0,1
4241,62:47:05:9D:EB:15,3835835,483795674,44,9691,3835791,483785983,0,95,11683,84,9517,11,2166,38,0,63,0,0,4,216660.0,130000.0,-49.0,-51.0,-50.0,-44.0,-52.0,-51.0,-50.0,-49.0,-87.0,-87.0,-84.0,-83.0,38.0,36.0,34.0,39.0,1
4242,3C:55:76:E8:8F:1F,3871595,571622326,35804,87836343,3835791,483785983,20,17052,4116497,16797,4069182,255,47315,8191,17,35837,3097,20,161,258080.0,146250.0,-49.0,-53.0,-47.0,-44.0,-48.0,-52.0,-46.0,-44.0,-87.0,-87.0,-84.0,-83.0,38.0,34.0,37.0,39.0,1
4243,92:69:1D:31:68:E9,3839716,487412227,3925,3626244,3835791,483785983,0,4800,1106647,4657,1074277,143,32370,2126,10,4128,87,0,43,229410.0,130000.0,-51.0,-47.0,-42.0,-49.0,-51.0,-47.0,-43.0,-48.0,-87.0,-87.0,-84.0,-83.0,36.0,40.0,42.0,34.0,1
4244,CC:2F:71:3F:1F:24,4619094,1322832864,783303,839046881,3835791,483785983,37,631461,655124478,630739,655037614,722,86864,609099,15,783560,86585,34,516,130000.0,43333.0,-69.0,-66.0,-67.0,-68.0,-69.0,-66.0,-67.0,-71.0,-87.0,-87.0,-84.0,-83.0,18.0,21.0,17.0,15.0,1
4245,CC:2F:71:3E:C5:1F,3836667,483893014,876,107031,3835791,483785983,0,3653,306849,3014,231003,639,75846,927,8,1258,19,0,39,130000.0,39000.0,-72.0,-72.0,-70.0,-60.0,-71.0,-71.0,-69.0,-61.0,-87.0,-87.0,-84.0,-83.0,15.0,15.0,14.0,23.0,1
4246,BA:8C:B9:54:50:24,3840626,489968632,4835,6182649,3835791,483785983,0,9003,1700007,8981,1696512,22,3495,2348,15,5273,39,0,58,216660.0,130000.0,-40.0,-36.0,-45.0,-52.0,-43.0,-35.0,-44.0,-48.0,-87.0,-87.0,-84.0,-83.0,47.0,51.0,39.0,31.0,1
4247,62:47:05:9D:EB:15,3835841,483796280,44,9691,3835797,483786589,0,95,11683,84,9517,11,2166,38,0,63,0,0,4,216660.0,130000.0,-49.0,-51.0,-50.0,-44.0,-52.0,-51.0,-50.0,-49.0,-87.0,-87.0,-84.0,-83.0,38.0,36.0,34.0,39.0,1
4248,3C:55:76:E8:8F:1F,3871601,571622932,35804,87836343,3835797,483786589,20,17057,4116839,16802,4069524,255,47315,8191,17,35837,3097,20,161,258080.0,146250.0,-49.0,-53.0,-48.0,-45.0,-48.0,-52.0,-47.0,-44.0,-87.0,-87.0,-84.0,-83.0,38.0,34.0,36.0,38.0,1
4249,92:69:1D:31:68:E9,3839722,487412833,3925,3626244,3835797,483786589,0,4800,1106647,4657,1074277,143,32370,2126,10,4128,87,0,43,229410.0,130000.0,-51.0,-47.0,-42.0,-49.0,-51.0,-47.0,-43.0,-48.0,-87.0,-87.0,-84.0,-83.0,36.0,40.0,42.0,34.0,1
4250,CC:2F:71:3F:1F:24,4619309,1323099248,783512,839312659,3835797,483786589,37,631659,655388912,630937,655302048,722,86864,609286,15,783769,86601,34,516,130000.0,43333.0,-69.0,-66.0,-67.0,-70.0,-69.0,-66.0,-67.0,-71.0,-87.0,-87.0,-84.0,-83.0,18.0,21.0,17.0,13.0,1
4251,CC:2F:71:3E:C5:1F,3836673,483893620,876,107031,3835797,483786589,0,3653,306849,3014,231003,639,75846,927,8,1258,19,0,39,130000.0,39000.0,-72.0,-72.0,-70.0,-60.0,-71.0,-71.0,-69.0,-61.0,-87.0,-87.0,-84.0,-83.0,15.0,15.0,14.0,23.0,1
4252,BA:8C:B9:54:50:24,3840632,489969238,4835,6182649,3835797,483786589,0,9003,1700007,8981,1696512,22,3495,2348,15,5273,39,0,58,216660.0,130000.0,-40.0,-36.0,-45.0,-52.0,-43.0,-35.0,-44.0,-48.0,-87.0,-87.0,-84.0,-83.0,47.0,51.0,39.0,31.0,1
4253,62:47:05:9D:EB:15,3835844,483796542,44,9691,3835800,483786851,0,95,11683,84,9517,11,2166,38,0,63,0,0,4,216660.0,130000.0,-49.0,-51.0,-50.0,-44.0,-52.0,-51.0,-50.0,-49.0,-87.0,-87.0,-84.0,-83.0,38.0,36.0,34.0,39.0,1
4254,3C:55:76:E8:8F:1F,3871607,571623918,35807,87837067,3835800,483786851,20,17068,4120655,16813,4073340,255,47315,8195,17,35840,3101,20,161,258080.0,146250.0,-44.0,-54.0,-50.0,-39.0,-45.0,-54.0,-50.0,-40.0,-87.0,-87.0,-84.0,-83.0,43.0,33.0,34.0,44.0,1
4255,92:69:1D:31:68:E9,3839725,487413095,3925,3626244,3835800,483786851,0,4800,1106647,4657,1074277,143,32370,2126,10,4128,87,0,43,229410.0,130000.0,-51.0,-47.0,-42.0,-49.0,-51.0,-47.0,-43.0,-48.0,-87.0,-87.0,-84.0,-83.0,36.0,40.0,42.0,34.0,1
4256,CC:2F:71:3F:1F:24,4619528,1323367447,783728,839580596,3835800,483786851,37,631865,655654677,631143,655567813,722,86864,609477,15,783984,86614,34,516,117000.0,39000.0,-69.0,-66.0,-66.0,-72.0,-68.0,-66.0,-66.0,-71.0,-87.0,-87.0,-84.0,-83.0,18.0,21.0,18.0,11.0,1
4257,CC:2F:71:3E:C5:1F,3836676,483893882,876,107031,3835800,483786851,0,3653,306849,3014,231003,639,75846,927,8,1258,19,0,39,130000.0,39000.0,-72.0,-72.0,-70.0,-60.0,-71.0,-71.0,-69.0,-61.0,-87.0,-87.0,-84.0,-83.0,15.0,15.0,14.0,23.0,1
4258,BA:8C:B9:54:50:24,3840635,489969500,4835,6182649,3835800,483786851,0,9003,1700007,8981,1696512,22,3495,2348,15,5273,39,0,58,216660.0,130000.0,-40.0,-36.0,-45.0,-52.0,-43.0,-35.0,-44.0,-48.0,-87.0,-87.0,-84.0,-83.0,47.0,51.0,39.0,31.0,1
4259,62:47:05:9D:EB:15,3835850,483797148,44,9691,3835806,483787457,0,95,11683,84,9517,11,2166,38,0,63,0,0,4,216660.0,130000.0,-49.0,-51.0,-50.0,-44.0,-52.0,-51.0,-50.0,-49.0,-87.0,-87.0,-84.0,-83.0,38.0,36.0,34.0,39.0,1
4260,3C:55:76:E8:8F:1F,3871615,571624874,35809,87837417,3835806,483787457,20,17093,4122468,16838,4075153,255,47315,8198,17,35842,3101,20,161,258080.0,154850.0,-48.0,-52.0,-47.0,-44.0,-47.0,-52.0,-47.0,-43.0,-87.0,-87.0,-84.0,-83.0,39.0,35.0,37.0,39.0,1
4261,92:69:1D:31:68:E9,3839731,487413701,3925,3626244,3835806,483787457,0,4800,1106647,4657,1074277,143,32370,2126,10,4128,87,0,43,229410.0,130000.0,-51.0,-47.0,-42.0,-49.0,-51.0,-47.0,-43.0,-48.0,-87.0,-87.0,-84.0,-83.0,36.0,40.0,42.0,34.0,1
4262,CC:2F:71:3F:1F:24,4619744,1323632649,783938,839845192,3835806,483787457,37,632058,655912635,631336,655825771,722,86864,609663,15,784195,86616,34,516,130000.0,43333.0,-68.0,-66.0,-66.0,-72.0,-68.0,-66.0,-66.0,-71.0,-87.0,-87.0,-84.0,-83.0,19.0,21.0,18.0,11.0,1
4263,CC:2F:71:3E:C5:1F,3836682,483894488,876,107031,3835806,483787457,0,3653,306849,3014,231003,639,75846,927,8,1258,19,0,39,130000.0,39000.0,-72.0,-72.0,-70.0,-60.0,-71.0,-71.0,-69.0,-61.0,-87.0,-87.0,-84.0,-83.0,15.0,15.0,14.0,23.0,1
4264,BA:8C:B9:54:50:24,3840641,489970106,4835,6182649,3835806,483787457,0,9003,1700007,8981,1696512,22,3495,2348,15,5273,39,0,58,216660.0,130000.0,-40.0,-36.0,-45.0,-52.0,-43.0,-35.0,-44.0,-48.0,-87.0,-87.0,-84.0,-83.0,47.0,51.0,39.0,31.0,1
4265,62:47:05:9D:EB:15,3835853,483797410,44,9691,3835809,483787719,0,96,11751,85,9585,11,2166,38,0,63,0,0,4,216660.0,130000.0,-50.0,-51.0,-49.0,-45.0,-52.0,-51.0,-50.0,-49.0,-87.0,-87.0,-84.0,-83.0,37.0,36.0,35.0,38.0,1
4266,3C:55:76:E8:8F:1F,3871620,571626417,35811,87838698,3835809,483787719,20,17103,4123228,16848,4075913,255,47315,8200,17,35844,3101,20,161,258080.0,154850.0,-46.0,-52.0,-46.0,-42.0,-44.0,-52.0,-48.0,-39.0,-87.0,-87.0,-84.0,-83.0,41.0,35.0,38.0,41.0,1
4267,92:69:1D:31:68:E9,3839734,487413963,3925,3626244,3835809,483787719,0,4800,1106647,4657,1074277,143,32370,2126,10,4128,87,0,43,229410.0,130000.0,-51.0,-47.0,-42.0,-49.0,-51.0,-47.0,-43.0,-48.0,-87.0,-87.0,-84.0,-83.0,36.0,40.0,42.0,34.0,1
4268,CC:2F:71:3F:1F:24,4619959,1323897821,784148,840109900,3835811,483787921,37,632247,656164499,631525,656077635,722,86864,609848,15,784405,86618,34,516,130000.0,43333.0,-68.0,-66.0,-67.0,-72.0,-68.0,-66.0,-66.0,-71.0,-87.0,-87.0,-84.0,-83.0,19.0,21.0,17.0,11.0,1
4269,CC:2F:71:3E:C5:1F,3836687,483894952,876,107031,3835811,483787921,0,3653,306849,3014,231003,639,75846,927,8,1258,19,0,39,130000.0,39000.0,-72.0,-72.0,-70.0,-60.0,-71.0,-71.0,-69.0,-61.0,-87.0,-87.0,-84.0,-83.0,15.0,15.0,14.0,23.0,1
4270,BA:8C:B9:54:50:24,3840648,489970772,4835,6182649,3835813,483788123,0,9003,1700007,8981,1696512,22,3495,2348,15,5273,39,0,58,216660.0,130000.0,-40.0,-36.0,-45.0,-52.0,-43.0,-35.0,-44.0,-48.0,-87.0,-87.0,-84.0,-83.0,47.0,51.0,39.0,31.0,1
4271,62:47:05:9D:EB:15,3835860,483798132,45,9807,3835815,483788325,0,98,11887,87,9721,11,2166,38,0,64,0,0,4,216660.0,130000.0,-50.0,-51.0,-49.0,-45.0,-52.0,-51.0,-50.0,-49.0,-87.0,-87.0,-84.0,-83.0,37.0,36.0,35.0,38.0,1
4272,3C:55:76:E8:8F:1F,3871627,571627085,35811,87838698,3835816,483788387,20,17106,4123434,16851,4076119,255,47315,8200,17,35844,3101,20,161,258080.0,154850.0,-44.0,-54.0,-50.0,-40.0,-43.0,-53.0,-49.0,-39.0,-87.0,-87.0,-84.0,-83.0,43.0,33.0,34.0,43.0,1
4273,92:69:1D:31:68:E9,3839742,487414691,3926,3626304,3835816,483788387,0,4802,1106783,4659,1074413,143,32370,2126,10,4129,87,0,43,229410.0,130000.0,-50.0,-47.0,-42.0,-49.0,-51.0,-47.0,-43.0,-48.0,-87.0,-87.0,-84.0,-83.0,37.0,40.0,42.0,34.0,1
4274,CC:2F:71:3F:1F:24,4620176,1324165849,784360,840377462,3835816,483788387,37,632443,656425717,631720,656338735,723,86982,610036,15,784617,86624,34,516,130000.0,43333.0,-69.0,-66.0,-67.0,-72.0,-68.0,-66.0,-66.0,-71.0,-87.0,-87.0,-84.0,-83.0,18.0,21.0,17.0,11.0,1
4275,CC:2F:71:3E:C5:1F,3836693,483895534,877,107147,3835816,483788387,0,3655,306989,3016,231143,639,75846,927,8,1259,19,0,39,130000.0,39000.0,-70.0,-73.0,-69.0,-61.0,-71.0,-71.0,-69.0,-61.0,-87.0,-87.0,-84.0,-83.0,17.0,14.0,15.0,22.0,1
4276,BA:8C:B9:54:50:24,3840654,489971354,4836,6182765,3835818,483788589,0,9005,1700143,8983,1696648,22,3495,2348,15,5274,39,0,58,216660.0,130000.0,-48.0,-35.0,-43.0,-46.0,-42.0,-35.0,-44.0,-49.0,-87.0,-87.0,-84.0,-83.0,39.0,52.0,41.0,37.0,1
4277,62:47:05:9D:EB:15,3835865,483798598,45,9807,3835820,483788791,0,98,11887,87,9721,11,2166,38,0,64,0,0,4,216660.0,130000.0,-50.0,-51.0,-49.0,-45.0,-52.0,-51.0,-50.0,-49.0,-87.0,-87.0,-84.0,-83.0,37.0,36.0,35.0,38.0,1
4278,3C:55:76:E8:8F:1F,3871634,571627807,35812,87838814,3835822,483788993,20,17114,4123982,16859,4076667,255,47315,8200,17,35845,3101,20,161,258080.0,154850.0,-45.0,-55.0,-50.0,-40.0,-43.0,-53.0,-48.0,-38.0,-87.0,-87.0,-84.0,-83.0,42.0,32.0,34.0,43.0,1
4279,92:69:1D:31:68:E9,3839748,487415297,3926,3626304,3835822,483788993,0,4802,1106783,4659,1074413,143,32370,2126,10,4129,87,0,43,229410.0,130000.0,-50.0,-47.0,-42.0,-49.0,-51.0,-47.0,-43.0,-48.0,-87.0,-87.0,-84.0,-83.0,37.0,40.0,42.0,34.0,1
4280,CC:2F:71:3F:1F:24,4620399,1324433124,784576,840644071,3835823,483789053,37,632644,656681042,631921,656594060,723,86982,610228,15,784833,86627,34,516,130000.0,43333.0,-69.0,-66.0,-68.0,-72.0,-68.0,-66.0,-67.0,-71.0,-87.0,-87.0,-84.0,-83.0,18.0,21.0,16.0,11.0,1
4281,CC:2F:71:3E:C5:1F,3836702,483896402,877,107147,3835825,483789255,0,3655,306989,3016,231143,639,75846,927,8,1259,19,0,39,130000.0,39000.0,-70.0,-73.0,-69.0,-61.0,-71.0,-71.0,-69.0,-61.0,-87.0,-87.0,-84.0,-83.0,17.0,14.0,15.0,22.0,1
4282,BA:8C:B9:54:50:24,3840661,489972020,4836,6182765,3835825,483789255,0,9005,1700143,8983,1696648,22,3495,2348,15,5274,39,0,58,216660.0,130000.0,-48.0,-35.0,-43.0,-46.0,-42.0,-35.0,-44.0,-49.0,-87.0,-87.0,-84.0,-83.0,39.0,52.0,41.0,37.0,1
4283,62:47:05:9D:EB:15,3835871,483799335,45,9807,3835826,483789528,0,98,11887,87,9721,11,2166,38,0,64,0,0,4,216660.0,130000.0,-50.0,-51.0,-49.0,-45.0,-52.0,-51.0,-50.0,-49.0,-87.0,-87.0,-84.0,-83.0,37.0,36.0,35.0,38.0,1
4284,3C:55:76:E8:8F:1F,3871638,571628342,35812,87838814,3835826,483789528,20,17114,4123982,16859,4076667,255,47315,8200,17,35845,3101,20,161,258080.0,154850.0,-45.0,-55.0,-50.0,-40.0,-43.0,-53.0,-48.0,-38.0,-87.0,-87.0,-84.0,-83.0,42.0,32.0,34.0,43.0,1
4285,92:69:1D:31:68:E9,3839752,487415832,3926,3626304,3835826,483789528,0,4802,1106783,4659,1074413,143,32370,2126,10,4129,87,0,43,229410.0,130000.0,-50.0,-47.0,-42.0,-49.0,-51.0,-47.0,-43.0,-48.0,-87.0,-87.0,-84.0,-83.0,37.0,40.0,42.0,34.0,1
4286,CC:2F:71:3F:1F:24,4620616,1324699953,784788,840910223,3835828,483789730,37,632838,656942000,632115,656855018,723,86982,610413,15,785045,86643,34,516,130000.0,43333.0,-69.0,-66.0,-67.0,-72.0,-69.0,-66.0,-67.0,-72.0,-87.0,-87.0,-84.0,-83.0,18.0,21.0,17.0,11.0,1
4287,CC:2F:71:3E:C5:1F,3836705,483896877,877,107147,3835828,483789730,0,3655,306989,3016,231143,639,75846,927,8,1259,19,0,39,130000.0,39000.0,-70.0,-73.0,-69.0,-61.0,-71.0,-71.0,-69.0,-61.0,-87.0,-87.0,-84.0,-83.0,17.0,14.0,15.0,22.0,1
4288,BA:8C:B9:54:50:24,3840664,489972495,4836,6182765,3835828,483789730,0,9006,1700211,8984,1696716,22,3495,2348,15,5274,39,0,58,216660.0,130000.0,-39.0,-37.0,-45.0,-53.0,-41.0,-36.0,-44.0,-50.0,-87.0,-87.0,-84.0,-83.0,48.0,50.0,39.0,30.0,1
4289,62:47:05:9D:EB:15,3835879,483800143,45,9807,3835834,483790336,0,98,11887,87,9721,11,2166,38,0,64,0,0,4,216660.0,130000.0,-50.0,-51.0,-49.0,-45.0,-52.0,-51.0,-50.0,-49.0,-87.0,-87.0,-84.0,-83.0,37.0,36.0,35.0,38.0,1
4290,3C:55:76:E8:8F:1F,3871646,571629150,35812,87838814,3835834,483790336,20,17114,4123982,16859,4076667,255,47315,8200,17,35845,3101,20,161,258080.0,154850.0,-45.0,-55.0,-50.0,-40.0,-43.0,-53.0,-48.0,-38.0,-87.0,-87.0,-84.0,-83.0,42.0,32.0,34.0,43.0,1
4291,92:69:1D:31:68:E9,3839760,487416640,3926,3626304,3835834,483790336,0,4802,1106783,4659,1074413,143,32370,2126,10,4129,87,0,43,229410.0,130000.0,-50.0,-47.0,-42.0,-49.0,-51.0,-47.0,-43.0,-48.0,-87.0,-87.0,-84.0,-83.0,37.0,40.0,42.0,34.0,1
4292,CC:2F:71:3F:1F:24,4620830,1324963567,784996,841173231,3835834,483790336,37,633027,657192440,632304,657105458,723,86982,610596,15,785251,86643,34,516,130000.0,43333.0,-69.0,-66.0,-67.0,-73.0,-69.0,-66.0,-67.0,-71.0,-87.0,-87.0,-84.0,-83.0,18.0,21.0,17.0,10.0,1
4293,CC:2F:71:3E:C5:1F,3836711,483897483,877,107147,3835834,483790336,0,3655,306989,3016,231143,639,75846,927,8,1259,19,0,39,130000.0,39000.0,-70.0,-73.0,-69.0,-61.0,-71.0,-71.0,-69.0,-61.0,-87.0,-87.0,-84.0,-83.0,17.0,14.0,15.0,22.0,1
4294,BA:8C:B9:54:50:24,3840670,489973101,4836,6182765,3835834,483790336,0,9006,1700211,8984,1696716,22,3495,2348,15,5274,39,0,58,216660.0,130000.0,-39.0,-37.0,-45.0,-53.0,-41.0,-36.0,-44.0,-50.0,-87.0,-87.0,-84.0,-83.0,48.0,50.0,39.0,30.0,1
4295,62:47:05:9D:EB:15,3835882,483800405,45,9807,3835837,483790598,0,98,11887,87,9721,11,2166,38,0,64,0,0,4,216660.0,130000.0,-50.0,-51.0,-49.0,-45.0,-52.0,-51.0,-50.0,-49.0,-87.0,-87.0,-84.0,-83.0,37.0,36.0,35.0,38.0,1
4296,3C:55:76:E8:8F:1F,3871651,571629646,35814,87839048,3835837,483790598,20,17126,4124971,16871,4077656,255,47315,8203,17,35847,3101,20,161,258080.0,1000.0,-46.0,-51.0,-46.0,-41.0,-47.0,-51.0,-46.0,-43.0,-87.0,-87.0,-84.0,-83.0,41.0,36.0,38.0,42.0,1
4297,92:69:1D:31:68:E9,3839763,487416902,3926,3626304,3835837,483790598,0,4802,1106783,4659,1074413,143,32370,2126,10,4129,87,0,43,229410.0,130000.0,-50.0,-47.0,-42.0,-49.0,-51.0,-47.0,-43.0,-48.0,-87.0,-87.0,-84.0,-83.0,37.0,40.0,42.0,34.0,1
4298,CC:2F:71:3F:1F:24,4621053,1325233654,785216,841443056,3835837,483790598,37,633229,657451856,632506,657364874,723,86982,610793,15,785473,86656,34,516,130000.0,39000.0,-69.0,-66.0,-67.0,-72.0,-68.0,-66.0,-66.0,-72.0,-87.0,-87.0,-84.0,-83.0,18.0,21.0,17.0,11.0,1
4299,CC:2F:71:3E:C5:1F,3836714,483897745,877,107147,3835837,483790598,0,3655,306989,3016,231143,639,75846,927,8,1259,19,0,39,130000.0,39000.0,-70.0,-73.0,-69.0,-61.0,-71.0,-71.0,-69.0,-61.0,-87.0,-87.0,-84.0,-83.0,17.0,14.0,15.0,22.0,1
4300,BA:8C:B9:54:50:24,3840673,489973363,4836,6182765,3835837,483790598,0,9006,1700211,8984,1696716,22,3495,2348,15,5274,39,0,58,216660.0,130000.0,-39.0,-37.0,-45.0,-53.0,-41.0,-36.0,-44.0,-50.0,-87.0,-87.0,-84.0,-83.0,48.0,50.0,39.0,30.0,1
4301,62:47:05:9D:EB:15,3835889,483801073,45,9807,3835844,483791266,0,98,11887,87,9721,11,2166,38,0,64,0,0,4,216660.0,130000.0,-50.0,-51.0,-49.0,-45.0,-52.0,-51.0,-50.0,-49.0,-87.0,-87.0,-84.0,-83.0,37.0,36.0,35.0,38.0,1
4302,3C:55:76:E8:8F:1F,3871658,571630314,35814,87839048,3835844,483791266,20,17143,4126181,16887,4078748,256,47433,8204,17,35847,3101,20,162,258080.0,1000.0,-49.0,-53.0,-47.0,-45.0,-50.0,-53.0,-48.0,-45.0,-87.0,-87.0,-84.0,-83.0,38.0,34.0,37.0,38.0,1
4303,92:69:1D:31:68:E9,3839770,487417570,3926,3626304,3835844,483791266,0,4802,1106783,4659,1074413,143,32370,2126,10,4129,87,0,43,229410.0,130000.0,-50.0,-47.0,-42.0,-49.0,-51.0,-47.0,-43.0,-48.0,-87.0,-87.0,-84.0,-83.0,37.0,40.0,42.0,34.0,1
4304,CC:2F:71:3F:1F:24,4621269,1325497404,785425,841706138,3835844,483791266,37,633427,657714596,632704,657627614,723,86982,610977,15,785682,86662,34,516,130000.0,43333.0,-69.0,-66.0,-67.0,-72.0,-68.0,-66.0,-66.0,-71.0,-87.0,-87.0,-84.0,-83.0,18.0,21.0,17.0,11.0,1
4305,CC:2F:71:3E:C5:1F,3836721,483898413,877,107147,3835844,483791266,0,3655,306989,3016,231143,639,75846,927,8,1259,19,0,39,130000.0,39000.0,-70.0,-73.0,-69.0,-61.0,-71.0,-71.0,-69.0,-61.0,-87.0,-87.0,-84.0,-83.0,17.0,14.0,15.0,22.0,1
4306,BA:8C:B9:54:50:24,3840680,489974031,4836,6182765,3835844,483791266,0,9006,1700211,8984,1696716,22,3495,2348,15,5274,39,0,58,216660.0,130000.0,-39.0,-37.0,-45.0,-53.0,-41.0,-36.0,-44.0,-50.0,-87.0,-87.0,-84.0,-83.0,48.0,50.0,39.0,30.0,1
4307,62:47:05:9D:EB:15,3835893,483801397,45,9807,3835848,483791590,0,98,11887,87,9721,11,2166,38,0,64,0,0,4,216660.0,130000.0,-50.0,-51.0,-49.0,-45.0,-52.0,-51.0,-50.0,-49.0,-87.0,-87.0,-84.0,-83.0,37.0,36.0,35.0,38.0,1
4308,3C:55:76:E8:8F:1F,3871662,571630638,35814,87839048,3835848,483791590,20,17160,4127391,16903,4079840,257,47551,8205,17,35847,3101,20,163,258080.0,1000.0,-45.0,-55.0,-50.0,-40.0,-44.0,-55.0,-49.0,-40.0,-87.0,-87.0,-84.0,-83.0,42.0,32.0,34.0,43.0,1
4309,92:69:1D:31:68:E9,3839774,487417894,3926,3626304,3835848,483791590,0,4802,1106783,4659,1074413,143,32370,2126,10,4129,87,0,43,229410.0,130000.0,-50.0,-47.0,-42.0,-49.0,-51.0,-47.0,-43.0,-48.0,-87.0,-87.0,-84.0,-83.0,37.0,40.0,42.0,34.0,1
4310,CC:2F:71:3F:1F:24,4621490,1325770820,785642,841979230,3835848,483791590,37,633628,657984902,632905,657897920,723,86982,611168,15,785899,86666,34,516,130000.0,43333.0,-69.0,-66.0,-67.0,-71.0,-69.0,-66.0,-66.0,-70.0,-87.0,-87.0,-84.0,-83.0,18.0,21.0,17.0,12.0,1
4311,CC:2F:71:3E:C5:1F,3836728,483899001,877,107147,3835851,483791854,0,3655,306989,3016,231143,639,75846,927,8,1259,19,0,39,130000.0,39000.0,-70.0,-73.0,-69.0,-61.0,-71.0,-71.0,-69.0,-61.0,-87.0,-87.0,-84.0,-83.0,17.0,14.0,15.0,22.0,1
4312,BA:8C:B9:54:50:24,3840689,489974821,4836,6182765,3835853,483792056,0,9006,1700211,8984,1696716,22,3495,2348,15,5274,39,0,58,216660.0,130000.0,-39.0,-37.0,-45.0,-53.0,-41.0,-36.0,-44.0,-50.0,-87.0,-87.0,-83.0,-83.0,48.0,50.0,38.0,30.0,1
4313,62:47:05:9D:EB:15,3835900,483802065,45,9807,3835855,483792258,0,98,11887,87,9721,11,2166,38,0,64,0,0,4,216660.0,130000.0,-50.0,-51.0,-49.0,-45.0,-52.0,-51.0,-50.0,-49.0,-87.0,-87.0,-83.0,-83.0,37.0,36.0,34.0,38.0,1
4314,3C:55:76:E8:8F:1F,3871671,571631604,35816,87839346,3835855,483792258,20,17180,4128969,16922,4081300,258,47669,8209,17,35849,3103,20,163,270830.0,162500.0,-45.0,-55.0,-50.0,-40.0,-44.0,-54.0,-49.0,-39.0,-87.0,-87.0,-83.0,-83.0,42.0,32.0,33.0,43.0,1
4315,92:69:1D:31:68:E9,3839781,487418562,3926,3626304,3835855,483792258,0,4802,1106783,4659,1074413,143,32370,2126,10,4129,87,0,43,229410.0,130000.0,-50.0,-47.0,-42.0,-49.0,-51.0,-47.0,-43.0,-48.0,-87.0,-87.0,-83.0,-83.0,37.0,40.0,41.0,34.0,1
4316,CC:2F:71:3F:1F:24,4621717,1326044089,785862,842251831,3835855,483792258,37,633832,658247571,633109,658160589,723,86982,611364,15,786119,86674,34,516,130000.0,43333.0,-69.0,-66.0,-67.0,-72.0,-68.0,-66.0,-66.0,-71.0,-87.0,-87.0,-83.0,-83.0,18.0,21.0,16.0,11.0,1
4317,CC:2F:71:3E:C5:1F,3836732,483899405,877,107147,3835855,483792258,0,3655,306989,3016,231143,639,75846,927,8,1259,19,0,39,130000.0,39000.0,-70.0,-73.0,-69.0,-61.0,-71.0,-71.0,-69.0,-61.0,-87.0,-87.0,-83.0,-83.0,17.0,14.0,14.0,22.0,1
4318,BA:8C:B9:54:50:24,3840691,489975023,4836,6182765,3835855,483792258,0,9006,1700211,8984,1696716,22,3495,2348,15,5274,39,0,58,216660.0,130000.0,-39.0,-37.0,-45.0,-53.0,-41.0,-36.0,-44.0,-50.0,-87.0,-87.0,-83.0,-83.0,48.0,50.0,38.0,30.0,1
4319,62:47:05:9D:EB:15,3835905,483802531,45,9807,3835860,483792724,0,100,12023,89,9857,11,2166,38,0,65,0,0,4,216660.0,130000.0,-50.0,-50.0,-49.0,-45.0,-51.0,-51.0,-50.0,-47.0,-87.0,-87.0,-83.0,-83.0,37.0,37.0,34.0,38.0,1
4320,3C:55:76:E8:8F:1F,3871680,571632428,35817,87839442,3835863,483792986,20,17190,4129776,16932,4082107,258,47669,8211,17,35850,3103,20,163,270830.0,162500.0,-45.0,-55.0,-50.0,-40.0,-44.0,-53.0,-48.0,-39.0,-87.0,-87.0,-83.0,-83.0,42.0,32.0,33.0,43.0,1
4321,92:69:1D:31:68:E9,3839789,487419290,3926,3626304,3835863,483792986,0,4804,1106919,4661,1074549,143,32370,2126,10,4130,87,0,43,229410.0,130000.0,-51.0,-48.0,-44.0,-47.0,-51.0,-47.0,-43.0,-48.0,-87.0,-87.0,-83.0,-83.0,36.0,39.0,39.0,36.0,1
4322,CC:2F:71:3F:1F:24,4621936,1326311079,786073,842518093,3835863,483792986,37,634032,658516407,633309,658429425,723,86982,611550,15,786330,86676,34,516,130000.0,43333.0,-68.0,-66.0,-67.0,-72.0,-68.0,-66.0,-67.0,-71.0,-87.0,-87.0,-83.0,-83.0,19.0,21.0,16.0,11.0,1
4323,CC:2F:71:3E:C5:1F,3836740,483900133,877,107147,3835863,483792986,0,3658,307247,3018,231283,640,75964,928,9,1260,20,0,39,130000.0,39000.0,-71.0,-72.0,-70.0,-60.0,-72.0,-73.0,-70.0,-61.0,-87.0,-87.0,-83.0,-83.0,16.0,15.0,13.0,23.0,1
4324,BA:8C:B9:54:50:24,3840701,489975953,4836,6182765,3835865,483793188,0,9009,1700415,8987,1696920,22,3495,2348,15,5275,39,0,58,216660.0,130000.0,-51.0,-35.0,-44.0,-44.0,-43.0,-36.0,-44.0,-49.0,-87.0,-87.0,-83.0,-83.0,36.0,52.0,39.0,39.0,1
4325,62:47:05:9D:EB:15,3835910,483802995,45,9807,3835865,483793188,0,100,12023,89,9857,11,2166,38,0,65,0,0,4,216660.0,130000.0,-50.0,-50.0,-49.0,-45.0,-51.0,-51.0,-50.0,-47.0,-87.0,-87.0,-83.0,-83.0,37.0,37.0,34.0,38.0,1
4326,3C:55:76:E8:8F:1F,3871682,571632630,35817,87839442,3835865,483793188,20,17190,4129776,16932,4082107,258,47669,8211,17,35850,3103,20,163,270830.0,162500.0,-45.0,-55.0,-50.0,-40.0,-44.0,-53.0,-48.0,-39.0,-87.0,-87.0,-83.0,-83.0,42.0,32.0,33.0,43.0,1
4327,92:69:1D:31:68:E9,3839791,487419492,3926,3626304,3835865,483793188,0,4804,1106919,4661,1074549,143,32370,2126,10,4130,87,0,43,229410.0,130000.0,-51.0,-48.0,-44.0,-47.0,-51.0,-47.0,-43.0,-48.0,-87.0,-87.0,-83.0,-83.0,36.0,39.0,39.0,36.0,1
4328,CC:2F:71:3F:1F:24,4622156,1326583906,786289,842790516,3835867,483793390,37,634238,658788916,633515,658701934,723,86982,611742,15,786546,86684,34,516,130000.0,43333.0,-69.0,-66.0,-66.0,-72.0,-68.0,-66.0,-66.0,-71.0,-87.0,-87.0,-83.0,-83.0,18.0,21.0,17.0,11.0,1
4329,CC:2F:71:3E:C5:1F,3836744,483900537,877,107147,3835867,483793390,0,3658,307247,3018,231283,640,75964,928,9,1260,20,0,39,130000.0,39000.0,-71.0,-72.0,-70.0,-60.0,-72.0,-73.0,-70.0,-61.0,-87.0,-87.0,-83.0,-83.0,16.0,15.0,13.0,23.0,1
4330,BA:8C:B9:54:50:24,3840703,489976155,4836,6182765,3835867,483793390,0,9009,1700415,8987,1696920,22,3495,2348,15,5275,39,0,58,216660.0,130000.0,-51.0,-35.0,-44.0,-44.0,-43.0,-36.0,-44.0,-49.0,-87.0,-87.0,-83.0,-83.0,36.0,52.0,39.0,39.0,1
4331,62:47:05:9D:EB:15,3835916,483803601,45,9807,3835871,483793794,0,100,12023,89,9857,11,2166,38,0,65,0,0,4,216660.0,130000.0,-50.0,-50.0,-49.0,-45.0,-51.0,-51.0,-50.0,-47.0,-87.0,-87.0,-83.0,-83.0,37.0,37.0,34.0,38.0,1
4332,3C:55:76:E8:8F:1F,3871691,571633587,35818,87839591,3835873,483793996,20,17204,4130837,16946,4083168,258,47669,8213,17,35851,3106,20,163,270830.0,1000.0,-49.0,-53.0,-47.0,-45.0,-48.0,-52.0,-46.0,-44.0,-87.0,-87.0,-83.0,-83.0,38.0,34.0,36.0,38.0,1
4333,92:69:1D:31:68:E9,3839799,487420300,3926,3626304,3835873,483793996,0,4804,1106919,4661,1074549,143,32370,2126,10,4130,87,0,43,229410.0,130000.0,-51.0,-48.0,-44.0,-47.0,-51.0,-47.0,-43.0,-48.0,-87.0,-87.0,-83.0,-83.0,36.0,39.0,39.0,36.0,1
4334,CC:2F:71:3F:1F:24,4622372,1326847796,786499,843053800,3835873,483793996,37,634435,659050386,633712,658963404,723,86982,611928,15,786756,86686,34,516,130000.0,43333.0,-68.0,-66.0,-66.0,-72.0,-68.0,-66.0,-66.0,-72.0,-87.0,-87.0,-83.0,-83.0,19.0,21.0,17.0,11.0,1
4335,CC:2F:71:3E:C5:1F,3836750,483901143,877,107147,3835873,483793996,0,3658,307247,3018,231283,640,75964,928,9,1260,20,0,39,130000.0,39000.0,-71.0,-72.0,-70.0,-60.0,-72.0,-73.0,-70.0,-61.0,-87.0,-87.0,-83.0,-83.0,16.0,15.0,13.0,23.0,1
4336,BA:8C:B9:54:50:24,3840710,489976821,4836,6182765,3835874,483794056,0,9009,1700415,8987,1696920,22,3495,2348,15,5275,39,0,58,216660.0,130000.0,-51.0,-35.0,-44.0,-44.0,-43.0,-36.0,-44.0,-49.0,-87.0,-87.0,-83.0,-83.0,36.0,52.0,39.0,39.0,1
4337,62:47:05:9D:EB:15,3835921,483804065,45,9807,3835876,483794258,0,100,12023,89,9857,11,2166,38,0,65,0,0,4,216660.0,130000.0,-50.0,-50.0,-49.0,-45.0,-51.0,-51.0,-50.0,-47.0,-87.0,-87.0,-83.0,-83.0,37.0,37.0,34.0,38.0,1
4338,3C:55:76:E8:8F:1F,3871709,571643700,35833,87849442,3835876,483794258,20,17238,4141595,16980,4093926,258,47669,8226,17,35866,3121,20,164,243750.0,1000.0,-49.0,-53.0,-47.0,-45.0,-48.0,-53.0,-47.0,-44.0,-87.0,-87.0,-83.0,-83.0,38.0,34.0,36.0,38.0,1
4339,92:69:1D:31:68:E9,3839802,487420562,3926,3626304,3835876,483794258,0,4804,1106919,4661,1074549,143,32370,2126,10,4130,87,0,43,229410.0,130000.0,-51.0,-48.0,-44.0,-47.0,-51.0,-47.0,-43.0,-48.0,-87.0,-87.0,-83.0,-83.0,36.0,39.0,39.0,36.0,1
4340,CC:2F:71:3F:1F:24,4622603,1327120592,786727,843326334,3835876,483794258,37,634651,659316486,633928,659229504,723,86982,612134,15,786984,86693,34,516,130000.0,43333.0,-68.0,-66.0,-67.0,-71.0,-68.0,-66.0,-66.0,-71.0,-87.0,-87.0,-83.0,-83.0,19.0,21.0,16.0,12.0,1
4341,CC:2F:71:3E:C5:1F,3836753,483901405,877,107147,3835876,483794258,0,3658,307247,3018,231283,640,75964,928,9,1260,20,0,39,130000.0,39000.0,-71.0,-72.0,-70.0,-60.0,-72.0,-73.0,-70.0,-61.0,-87.0,-87.0,-83.0,-83.0,16.0,15.0,13.0,23.0,1
4342,BA:8C:B9:54:50:24,3840712,489977023,4836,6182765,3835876,483794258,0,9009,1700415,8987,1696920,22,3495,2348,15,5275,39,0,58,216660.0,130000.0,-51.0,-35.0,-44.0,-44.0,-43.0,-36.0,-44.0,-49.0,-87.0,-87.0,-83.0,-83.0,36.0,52.0,39.0,39.0,1
4343,62:47:05:9D:EB:15,3835927,483804671,45,9807,3835882,483794864,0,100,12023,89,9857,11,2166,38,0,65,0,0,4,216660.0,130000.0,-50.0,-50.0,-49.0,-45.0,-51.0,-51.0,-50.0,-47.0,-87.0,-87.0,-83.0,-83.0,37.0,37.0,34.0,38.0,1
4344,3C:55:76:E8:8F:1F,3871715,571644306,35833,87849442,3835882,483794864,20,17241,4141801,16983,4094132,258,47669,8226,17,35866,3121,20,164,243750.0,1000.0,-49.0,-53.0,-47.0,-45.0,-48.0,-53.0,-46.0,-44.0,-87.0,-87.0,-83.0,-83.0,38.0,34.0,36.0,38.0,1
4345,92:69:1D:31:68:E9,3839808,487421168,3926,3626304,3835882,483794864,0,4804,1106919,4661,1074549,143,32370,2126,10,4130,87,0,43,229410.0,130000.0,-51.0,-48.0,-44.0,-47.0,-51.0,-47.0,-43.0,-48.0,-87.0,-87.0,-83.0,-83.0,36.0,39.0,39.0,36.0,1
4346,CC:2F:71:3F:1F:24,4622822,1327386296,786940,843591432,3835882,483794864,37,634846,659572112,634123,659485130,723,86982,612320,15,787196,86695,34,516,130000.0,43333.0,-69.0,-66.0,-67.0,-72.0,-68.0,-66.0,-67.0,-72.0,-87.0,-87.0,-83.0,-83.0,18.0,21.0,16.0,11.0,1
4347,CC:2F:71:3E:C5:1F,3836759,483902011,877,107147,3835882,483794864,0,3658,307247,3018,231283,640,75964,928,9,1260,20,0,39,130000.0,39000.0,-71.0,-72.0,-70.0,-60.0,-72.0,-73.0,-70.0,-61.0,-87.0,-87.0,-83.0,-83.0,16.0,15.0,13.0,23.0,1
4348,BA:8C:B9:54:50:24,3840718,489977629,4836,6182765,3835882,483794864,0,9009,1700415,8987,1696920,22,3495,2348,15,5275,39,0,58,216660.0,130000.0,-51.0,-35.0,-44.0,-44.0,-43.0,-36.0,-44.0,-49.0,-87.0,-87.0,-83.0,-83.0,36.0,52.0,39.0,39.0,1
4349,62:47:05:9D:EB:15,3835931,483805206,45,9807,3835886,483795399,0,100,12023,89,9857,11,2166,38,0,65,0,0,4,216660.0,130000.0,-50.0,-50.0,-49.0,-45.0,-51.0,-51.0,-50.0,-47.0,-87.0,-87.0,-83.0,-83.0,37.0,37.0,34.0,38.0,1
4350,3C:55:76:E8:8F:1F,3871719,571644841,35833,87849442,3835886,483795399,20,17241,4141801,16983,4094132,258,47669,8226,17,35866,3121,20,164,243750.0,1000.0,-49.0,-53.0,-47.0,-45.0,-48.0,-53.0,-46.0,-44.0,-87.0,-87.0,-83.0,-83.0,38.0,34.0,36.0,38.0,1
4351,92:69:1D:31:68:E9,3839812,487421703,3926,3626304,3835886,483795399,0,4804,1106919,4661,1074549,143,32370,2126,10,4130,87,0,43,229410.0,130000.0,-51.0,-48.0,-44.0,-47.0,-51.0,-47.0,-43.0,-48.0,-87.0,-87.0,-83.0,-83.0,36.0,39.0,39.0,36.0,1
4352,CC:2F:71:3F:1F:24,4623038,1327648879,787150,843853278,3835888,483795601,37,635041,659828952,634318,659741970,723,86982,612506,15,787407,86698,34,516,130000.0,43333.0,-69.0,-66.0,-67.0,-72.0,-68.0,-66.0,-66.0,-71.0,-87.0,-87.0,-83.0,-83.0,18.0,21.0,16.0,11.0,1
4353,CC:2F:71:3E:C5:1F,3836767,483902950,877,107147,3835890,483795803,0,3658,307247,3018,231283,640,75964,928,9,1260,20,0,39,130000.0,39000.0,-71.0,-72.0,-70.0,-60.0,-72.0,-73.0,-70.0,-61.0,-87.0,-87.0,-83.0,-83.0,16.0,15.0,13.0,23.0,1
4354,BA:8C:B9:54:50:24,3840726,489978568,4836,6182765,3835890,483795803,0,9009,1700415,8987,1696920,22,3495,2348,15,5275,39,0,58,216660.0,130000.0,-51.0,-35.0,-44.0,-44.0,-43.0,-36.0,-44.0,-49.0,-87.0,-87.0,-83.0,-83.0,36.0,52.0,39.0,39.0,1
4355,62:47:05:9D:EB:15,3835937,483805812,45,9807,3835892,483796005,0,100,12023,89,9857,11,2166,38,0,65,0,0,4,216660.0,130000.0,-50.0,-50.0,-49.0,-45.0,-51.0,-51.0,-50.0,-47.0,-87.0,-87.0,-83.0,-83.0,37.0,37.0,34.0,38.0,1
4356,3C:55:76:E8:8F:1F,3871726,571645521,35834,87849516,3835892,483796005,20,17245,4142112,16987,4094443,258,47669,8227,17,35867,3121,20,164,243750.0,146250.0,-43.0,-52.0,-49.0,-37.0,-46.0,-52.0,-47.0,-41.0,-87.0,-87.0,-83.0,-83.0,44.0,35.0,34.0,46.0,1
4357,92:69:1D:31:68:E9,3839818,487422309,3926,3626304,3835892,483796005,0,4804,1106919,4661,1074549,143,32370,2126,10,4130,87,0,43,229410.0,130000.0,-51.0,-48.0,-44.0,-47.0,-51.0,-47.0,-43.0,-48.0,-87.0,-87.0,-83.0,-83.0,36.0,39.0,39.0,36.0,1
4358,CC:2F:71:3F:1F:24,4623261,1327916136,787369,844120131,3835892,483796005,37,635253,660094588,634530,660007606,723,86982,612700,15,787626,86703,34,516,130000.0,43333.0,-70.0,-66.0,-67.0,-71.0,-69.0,-66.0,-67.0,-70.0,-87.0,-87.0,-83.0,-83.0,17.0,21.0,16.0,12.0,1
4359,CC:2F:71:3E:C5:1F,3836769,483903152,877,107147,3835892,483796005,0,3658,307247,3018,231283,640,75964,928,9,1260,20,0,39,130000.0,39000.0,-71.0,-72.0,-70.0,-60.0,-72.0,-73.0,-70.0,-61.0,-87.0,-87.0,-83.0,-83.0,16.0,15.0,13.0,23.0,1
4360,BA:8C:B9:54:50:24,3840728,489978770,4836,6182765,3835892,483796005,0,9009,1700415,8987,1696920,22,3495,2348,15,5275,39,0,58,216660.0,130000.0,-51.0,-35.0,-44.0,-44.0,-43.0,-36.0,-44.0,-49.0,-87.0,-87.0,-83.0,-83.0,36.0,52.0,39.0,39.0,1
4361,62:47:05:9D:EB:15,3835944,483806478,45,9807,3835899,483796671,0,100,12023,89,9857,11,2166,38,0,65,0,0,4,216660.0,130000.0,-50.0,-50.0,-49.0,-45.0,-51.0,-51.0,-50.0,-47.0,-87.0,-87.0,-83.0,-83.0,37.0,37.0,34.0,38.0,1
4362,3C:55:76:E8:8F:1F,3871733,571646187,35834,87849516,3835899,483796671,20,17250,4142454,16992,4094785,258,47669,8227,17,35867,3121,20,164,243750.0,146250.0,-45.0,-54.0,-51.0,-40.0,-43.0,-52.0,-50.0,-38.0,-87.0,-87.0,-83.0,-83.0,42.0,33.0,32.0,43.0,1
4363,92:69:1D:31:68:E9,3839825,487422975,3926,3626304,3835899,483796671,0,4804,1106919,4661,1074549,143,32370,2126,10,4130,87,0,43,229410.0,130000.0,-51.0,-48.0,-44.0,-47.0,-51.0,-47.0,-43.0,-48.0,-87.0,-87.0,-83.0,-83.0,36.0,39.0,39.0,36.0,1
4364,CC:2F:71:3F:1F:24,4623481,1328183324,787582,844386653,3835899,483796671,37,635457,660368126,634734,660281144,723,86982,612889,15,787839,86703,34,516,130000.0,43333.0,-70.0,-66.0,-66.0,-72.0,-69.0,-66.0,-66.0,-71.0,-87.0,-87.0,-83.0,-83.0,17.0,21.0,17.0,11.0,1
4365,CC:2F:71:3E:C5:1F,3836776,483903818,877,107147,3835899,483796671,0,3658,307247,3018,231283,640,75964,928,9,1260,20,0,39,130000.0,39000.0,-71.0,-72.0,-70.0,-60.0,-72.0,-73.0,-70.0,-61.0,-87.0,-87.0,-83.0,-83.0,16.0,15.0,13.0,23.0,1
4366,BA:8C:B9:54:50:24,3840735,489979436,4836,6182765,3835899,483796671,0,9009,1700415,8987,1696920,22,3495,2348,15,5275,39,0,58,216660.0,130000.0,-51.0,-35.0,-44.0,-44.0,-43.0,-36.0,-44.0,-49.0,-87.0,-87.0,-83.0,-83.0,36.0,52.0,39.0,39.0,1
4367,62:47:05:9D:EB:15,3835947,483806806,45,9807,3835902,483796999,0,100,12023,89,9857,11,2166,38,0,65,0,0,4,216660.0,130000.0,-50.0,-50.0,-49.0,-45.0,-51.0,-51.0,-50.0,-47.0,-87.0,-87.0,-83.0,-83.0,37.0,37.0,34.0,38.0,1
4368,3C:55:76:E8:8F:1F,3871736,571646515,35834,87849516,3835902,483796999,20,17250,4142454,16992,4094785,258,47669,8227,17,35867,3121,20,164,243750.0,146250.0,-45.0,-54.0,-51.0,-40.0,-43.0,-52.0,-50.0,-38.0,-87.0,-87.0,-83.0,-83.0,42.0,33.0,32.0,43.0,1
4369,92:69:1D:31:68:E9,3839828,487423303,3926,3626304,3835902,483796999,0,4804,1106919,4661,1074549,143,32370,2126,10,4130,87,0,43,229410.0,130000.0,-51.0,-48.0,-44.0,-47.0,-51.0,-47.0,-43.0,-48.0,-87.0,-87.0,-83.0,-83.0,36.0,39.0,39.0,36.0,1
4370,CC:2F:71:3F:1F:24,4623696,1328449876,787794,844652877,3835902,483796999,37,635654,660626624,634931,660539642,723,86982,613077,15,788049,86708,34,516,144444.0,43333.0,-71.0,-67.0,-66.0,-71.0,-71.0,-66.0,-66.0,-71.0,-87.0,-87.0,-83.0,-83.0,16.0,20.0,17.0,12.0,1
4371,CC:2F:71:3E:C5:1F,3836779,483904146,877,107147,3835902,483796999,0,3658,307247,3018,231283,640,75964,928,9,1260,20,0,39,130000.0,39000.0,-71.0,-72.0,-70.0,-60.0,-72.0,-73.0,-70.0,-61.0,-87.0,-87.0,-83.0,-83.0,16.0,15.0,13.0,23.0,1
4372,BA:8C:B9:54:50:24,3840740,489979966,4836,6182765,3835904,483797201,0,9009,1700415,8987,1696920,22,3495,2348,15,5275,39,0,58,216660.0,130000.0,-51.0,-35.0,-44.0,-44.0,-43.0,-36.0,-44.0,-49.0,-87.0,-87.0,-83.0,-83.0,36.0,52.0,39.0,39.0,1
4373,62:47:05:9D:EB:15,3835953,483807412,45,9807,3835908,483797605,0,100,12023,89,9857,11,2166,38,0,65,0,0,4,216660.0,130000.0,-50.0,-50.0,-49.0,-45.0,-51.0,-51.0,-50.0,-47.0,-87.0,-86.0,-83.0,-83.0,37.0,36.0,34.0,38.0,1
4374,3C:55:76:E8:8F:1F,3871746,571648269,35838,87850664,3835908,483797605,20,17268,4144668,17010,4096999,258,47669,8232,17,35871,3121,20,164,243750.0,146250.0,-46.0,-53.0,-46.0,-44.0,-44.0,-55.0,-47.0,-42.0,-87.0,-86.0,-83.0,-83.0,41.0,33.0,37.0,39.0,1
4375,92:69:1D:31:68:E9,3839836,487424111,3926,3626304,3835910,483797807,0,4804,1106919,4661,1074549,143,32370,2126,10,4130,87,0,43,229410.0,130000.0,-51.0,-48.0,-44.0,-47.0,-51.0,-47.0,-43.0,-48.0,-87.0,-86.0,-83.0,-83.0,36.0,38.0,39.0,36.0,1
4376,CC:2F:71:3F:1F:24,4623913,1328713854,788003,844916047,3835910,483797807,37,635847,660885972,635124,660798990,723,86982,613262,15,788260,86709,34,516,144444.0,43333.0,-70.0,-67.0,-66.0,-71.0,-70.0,-67.0,-66.0,-70.0,-87.0,-86.0,-83.0,-83.0,17.0,19.0,17.0,12.0,1
4377,CC:2F:71:3E:C5:1F,3836788,483905014,877,107147,3835911,483797867,0,3658,307247,3018,231283,640,75964,928,9,1260,20,0,39,130000.0,39000.0,-71.0,-72.0,-70.0,-60.0,-72.0,-73.0,-70.0,-61.0,-87.0,-86.0,-83.0,-83.0,16.0,14.0,13.0,23.0,1
4378,BA:8C:B9:54:50:24,3840747,489980632,4836,6182765,3835911,483797867,0,9009,1700415,8987,1696920,22,3495,2348,15,5275,39,0,58,216660.0,130000.0,-51.0,-35.0,-44.0,-44.0,-43.0,-36.0,-44.0,-49.0,-87.0,-86.0,-83.0,-83.0,36.0,51.0,39.0,39.0,1
4379,62:47:05:9D:EB:15,3835956,483807674,45,9807,3835911,483797867,0,100,12023,89,9857,11,2166,38,0,65,0,0,4,216660.0,130000.0,-50.0,-50.0,-49.0,-45.0,-51.0,-51.0,-50.0,-47.0,-87.0,-86.0,-83.0,-83.0,37.0,36.0,34.0,38.0,1
4380,3C:55:76:E8:8F:1F,3871752,571648907,35839,87850838,3835913,483798069,20,17287,4146092,17029,4098423,258,47669,8234,17,35872,3121,20,164,243750.0,146250.0,-48.0,-55.0,-46.0,-46.0,-46.0,-53.0,-46.0,-44.0,-87.0,-86.0,-83.0,-83.0,39.0,31.0,37.0,37.0,1
4381,92:69:1D:31:68:E9,3839839,487424373,3926,3626304,3835913,483798069,0,4804,1106919,4661,1074549,143,32370,2126,10,4130,87,0,43,229410.0,130000.0,-51.0,-48.0,-44.0,-47.0,-51.0,-47.0,-43.0,-48.0,-87.0,-86.0,-83.0,-83.0,36.0,38.0,39.0,36.0,1
4382,CC:2F:71:3F:1F:24,4624132,1328980741,788219,845182672,3835913,483798069,37,636046,661140973,635323,661053991,723,86982,613454,15,788476,86712,34,516,144444.0,43333.0,-70.0,-67.0,-66.0,-71.0,-70.0,-67.0,-66.0,-70.0,-87.0,-86.0,-83.0,-83.0,17.0,19.0,17.0,12.0,1
4383,CC:2F:71:3E:C5:1F,3836790,483905216,877,107147,3835913,483798069,0,3658,307247,3018,231283,640,75964,928,9,1260,20,0,39,130000.0,39000.0,-71.0,-72.0,-70.0,-60.0,-72.0,-73.0,-70.0,-61.0,-87.0,-86.0,-83.0,-83.0,16.0,14.0,13.0,23.0,1
4384,BA:8C:B9:54:50:24,3840749,489980834,4836,6182765,3835913,483798069,0,9009,1700415,8987,1696920,22,3495,2348,15,5275,39,0,58,216660.0,130000.0,-51.0,-35.0,-44.0,-44.0,-43.0,-36.0,-44.0,-49.0,-87.0,-86.0,-83.0,-83.0,36.0,51.0,39.0,39.0,1
4385,62:47:05:9D:EB:15,3835964,483808482,45,9807,3835919,483798675,0,100,12023,89,9857,11,2166,38,0,65,0,0,4,216660.0,130000.0,-50.0,-50.0,-49.0,-45.0,-51.0,-51.0,-50.0,-47.0,-87.0,-86.0,-83.0,-83.0,37.0,36.0,34.0,38.0,1
4386,3C:55:76:E8:8F:1F,3871762,571650106,35843,87851431,3835919,483798675,20,17302,4149117,17044,4101448,258,47669,8239,17,35876,3123,20,164,243750.0,146250.0,-46.0,-50.0,-47.0,-44.0,-44.0,-51.0,-51.0,-41.0,-87.0,-86.0,-83.0,-83.0,41.0,36.0,36.0,39.0,1
4387,92:69:1D:31:68:E9,3839845,487424979,3926,3626304,3835919,483798675,0,4804,1106919,4661,1074549,143,32370,2126,10,4130,87,0,43,229410.0,130000.0,-51.0,-48.0,-44.0,-47.0,-51.0,-47.0,-43.0,-48.0,-87.0,-86.0,-83.0,-83.0,36.0,38.0,39.0,36.0,1
4388,CC:2F:71:3F:1F:24,4624348,1329244647,788429,845445972,3835919,483798675,37,636238,661397357,635515,661310375,723,86982,613638,15,788686,86716,34,516,144444.0,43333.0,-68.0,-66.0,-68.0,-69.0,-68.0,-66.0,-68.0,-69.0,-87.0,-86.0,-83.0,-83.0,19.0,20.0,15.0,14.0,1
4389,CC:2F:71:3E:C5:1F,3836796,483905822,877,107147,3835919,483798675,0,3658,307247,3018,231283,640,75964,928,9,1260,20,0,39,130000.0,39000.0,-71.0,-72.0,-70.0,-60.0,-72.0,-73.0,-70.0,-61.0,-87.0,-86.0,-83.0,-83.0,16.0,14.0,13.0,23.0,1
4390,BA:8C:B9:54:50:24,3840755,489981440,4836,6182765,3835919,483798675,0,9009,1700415,8987,1696920,22,3495,2348,15,5275,39,0,58,216660.0,130000.0,-51.0,-35.0,-44.0,-44.0,-43.0,-36.0,-44.0,-49.0,-87.0,-86.0,-83.0,-83.0,36.0,51.0,39.0,39.0,1
4391,62:47:05:9D:EB:15,3835967,483808744,45,9807,3835922,483798937,0,100,12023,89,9857,11,2166,38,0,65,0,0,4,216660.0,130000.0,-50.0,-50.0,-49.0,-45.0,-51.0,-51.0,-50.0,-47.0,-87.0,-86.0,-83.0,-83.0,37.0,36.0,34.0,38.0,1
4392,3C:55:76:E8:8F:1F,3871768,571651414,35846,87852477,3835922,483798937,20,17314,4150055,17056,4102386,258,47669,8241,17,35879,3125,20,164,216660.0,1000.0,-45.0,-52.0,-52.0,-41.0,-44.0,-51.0,-51.0,-41.0,-87.0,-86.0,-83.0,-83.0,42.0,34.0,31.0,42.0,1
4393,92:69:1D:31:68:E9,3839850,487425443,3926,3626304,3835924,483799139,0,4805,1106987,4662,1074617,143,32370,2126,10,4130,87,0,43,229410.0,130000.0,-51.0,-48.0,-44.0,-47.0,-51.0,-47.0,-43.0,-48.0,-87.0,-86.0,-83.0,-83.0,36.0,38.0,39.0,36.0,1
4394,CC:2F:71:3F:1F:24,4624563,1329505547,788639,845706408,3835924,483799139,37,636438,661662139,635715,661575157,723,86982,613821,15,788896,86718,34,516,144444.0,43333.0,-67.0,-67.0,-67.0,-69.0,-67.0,-67.0,-66.0,-68.0,-87.0,-86.0,-83.0,-83.0,20.0,19.0,16.0,14.0,1
4395,CC:2F:71:3E:C5:1F,3836803,483906488,877,107147,3835926,483799341,0,3658,307247,3018,231283,640,75964,928,9,1260,20,0,39,130000.0,39000.0,-71.0,-72.0,-70.0,-60.0,-72.0,-73.0,-70.0,-61.0,-87.0,-86.0,-83.0,-83.0,16.0,14.0,13.0,23.0,1
4396,BA:8C:B9:54:50:24,3840762,489982106,4836,6182765,3835926,483799341,0,9009,1700415,8987,1696920,22,3495,2348,15,5275,39,0,58,216660.0,130000.0,-51.0,-35.0,-44.0,-44.0,-43.0,-36.0,-44.0,-49.0,-87.0,-86.0,-83.0,-83.0,36.0,51.0,39.0,39.0,1
4397,62:47:05:9D:EB:15,3835973,483809350,45,9807,3835928,483799543,0,100,12023,89,9857,11,2166,38,0,65,0,0,4,216660.0,130000.0,-50.0,-50.0,-49.0,-45.0,-51.0,-51.0,-50.0,-47.0,-87.0,-86.0,-83.0,-83.0,37.0,36.0,34.0,38.0,1
4398,3C:55:76:E8:8F:1F,3871774,571652020,35846,87852477,3835928,483799543,20,17314,4150055,17056,4102386,258,47669,8241,17,35879,3125,20,164,216660.0,1000.0,-45.0,-52.0,-52.0,-41.0,-44.0,-51.0,-51.0,-41.0,-87.0,-86.0,-83.0,-83.0,42.0,34.0,31.0,42.0,1
4399,92:69:1D:31:68:E9,3839854,487425847,3926,3626304,3835928,483799543,0,4805,1106987,4662,1074617,143,32370,2126,10,4130,87,0,43,229410.0,130000.0,-51.0,-48.0,-44.0,-47.0,-51.0,-47.0,-43.0,-48.0,-87.0,-86.0,-83.0,-83.0,36.0,38.0,39.0,36.0,1
4400,CC:2F:71:3F:1F:24,4624784,1329772706,788856,845973163,3835928,483799543,37,636638,661921479,635915,661834497,723,86982,614013,15,789113,86737,34,517,144444.0,43333.0,-68.0,-67.0,-66.0,-69.0,-68.0,-67.0,-66.0,-69.0,-87.0,-86.0,-83.0,-83.0,19.0,19.0,17.0,14.0,1
4401,CC:2F:71:3E:C5:1F,3836805,483906690,877,107147,3835928,483799543,0,3658,307247,3018,231283,640,75964,928,9,1260,20,0,39,130000.0,39000.0,-71.0,-72.0,-70.0,-60.0,-72.0,-73.0,-70.0,-61.0,-87.0,-86.0,-83.0,-83.0,16.0,14.0,13.0,23.0,1
4402,BA:8C:B9:54:50:24,3840764,489982308,4836,6182765,3835928,483799543,0,9009,1700415,8987,1696920,22,3495,2348,15,5275,39,0,58,216660.0,130000.0,-51.0,-35.0,-44.0,-44.0,-43.0,-36.0,-44.0,-49.0,-87.0,-86.0,-83.0,-82.0,36.0,51.0,39.0,38.0,1
4403,62:47:05:9D:EB:15,3835980,483810016,45,9807,3835935,483800209,0,100,12023,89,9857,11,2166,38,0,65,0,0,4,216660.0,130000.0,-50.0,-50.0,-49.0,-45.0,-51.0,-51.0,-50.0,-47.0,-87.0,-86.0,-83.0,-82.0,37.0,36.0,34.0,37.0,1
4404,3C:55:76:E8:8F:1F,3871782,571652754,35847,87852545,3835935,483800209,20,17322,4150637,17064,4102968,258,47669,8242,17,35880,3125,20,164,216660.0,130000.0,-44.0,-53.0,-51.0,-40.0,-43.0,-52.0,-50.0,-39.0,-87.0,-86.0,-83.0,-82.0,43.0,33.0,32.0,42.0,1
4405,92:69:1D:31:68:E9,3839861,487426513,3926,3626304,3835935,483800209,0,4805,1106987,4662,1074617,143,32370,2126,10,4130,87,0,43,229410.0,130000.0,-51.0,-48.0,-44.0,-47.0,-51.0,-47.0,-43.0,-48.0,-87.0,-86.0,-83.0,-82.0,36.0,38.0,39.0,35.0,1
4406,CC:2F:71:3F:1F:24,4625450,1330600872,789515,846800663,3835935,483800209,37,637041,662210934,636318,662123952,723,86982,614399,15,789772,86995,34,517,144444.0,43333.0,-68.0,-67.0,-67.0,-69.0,-68.0,-67.0,-66.0,-69.0,-87.0,-86.0,-83.0,-82.0,19.0,19.0,16.0,13.0,1
4407,CC:2F:71:3E:C5:1F,3836812,483907356,877,107147,3835935,483800209,0,3658,307247,3018,231283,640,75964,928,9,1260,20,0,39,130000.0,39000.0,-71.0,-72.0,-70.0,-60.0,-72.0,-73.0,-70.0,-61.0,-87.0,-86.0,-83.0,-82.0,16.0,14.0,13.0,22.0,1
4408,BA:8C:B9:54:50:24,3840771,489982974,4836,6182765,3835935,483800209,0,9009,1700415,8987,1696920,22,3495,2348,15,5275,39,0,58,216660.0,130000.0,-51.0,-35.0,-44.0,-44.0,-43.0,-36.0,-44.0,-49.0,-87.0,-86.0,-83.0,-82.0,36.0,51.0,39.0,38.0,1
4409,62:47:05:9D:EB:15,3835985,483810540,46,9923,3835939,483800617,0,102,12159,91,9993,11,2166,38,0,66,0,0,4,216660.0,130000.0,-51.0,-51.0,-50.0,-44.0,-50.0,-50.0,-49.0,-44.0,-87.0,-86.0,-83.0,-82.0,36.0,35.0,33.0,38.0,1
4410,3C:55:76:E8:8F:1F,3871787,571653222,35848,87852605,3835939,483800617,20,17337,4151845,17077,4103858,260,47987,8244,17,35881,3125,20,166,216660.0,130000.0,-44.0,-52.0,-51.0,-40.0,-43.0,-51.0,-49.0,-39.0,-87.0,-86.0,-83.0,-82.0,43.0,34.0,32.0,42.0,1
4411,92:69:1D:31:68:E9,3839866,487427037,3927,3626420,3835939,483800617,0,4807,1107123,4664,1074753,143,32370,2126,10,4131,87,0,43,229410.0,130000.0,-51.0,-47.0,-42.0,-49.0,-50.0,-47.0,-43.0,-48.0,-87.0,-86.0,-83.0,-82.0,36.0,39.0,41.0,33.0,1
4412,CC:2F:71:3F:1F:24,4625858,1331107800,789919,847307183,3835939,483800617,37,637325,662482272,636602,662395290,723,86982,614671,15,790176,87109,34,518,144444.0,43333.0,-68.0,-67.0,-67.0,-69.0,-67.0,-67.0,-66.0,-69.0,-87.0,-86.0,-83.0,-82.0,19.0,19.0,16.0,13.0,1
4413,CC:2F:71:3E:C5:1F,3836817,483907880,878,107263,3835939,483800617,0,3660,307387,3020,231423,640,75964,928,9,1261,20,0,39,130000.0,39000.0,-72.0,-73.0,-69.0,-60.0,-72.0,-73.0,-70.0,-61.0,-87.0,-86.0,-83.0,-82.0,15.0,13.0,14.0,22.0,1
4414,BA:8C:B9:54:50:24,3840776,489983498,4837,6182881,3835939,483800617,0,9011,1700551,8989,1697056,22,3495,2348,15,5276,39,0,58,216660.0,130000.0,-49.0,-35.0,-43.0,-45.0,-44.0,-35.0,-44.0,-48.0,-87.0,-86.0,-83.0,-82.0,38.0,51.0,40.0,37.0,1
4415,62:47:05:9D:EB:15,3835993,483811352,46,9923,3835947,483801429,0,102,12159,91,9993,11,2166,38,0,66,0,0,4,216660.0,130000.0,-51.0,-51.0,-50.0,-44.0,-50.0,-50.0,-49.0,-44.0,-87.0,-86.0,-83.0,-82.0,36.0,35.0,33.0,38.0,1
4416,3C:55:76:E8:8F:1F,3871796,571654158,35849,87852729,3835947,483801429,20,17350,4152949,17088,4104644,262,48305,8247,17,35882,3125,20,166,216660.0,130000.0,-44.0,-53.0,-51.0,-40.0,-43.0,-52.0,-50.0,-40.0,-87.0,-86.0,-83.0,-82.0,43.0,33.0,32.0,42.0,1
4417,92:69:1D:31:68:E9,3839874,487427849,3927,3626420,3835947,483801429,0,4807,1107123,4664,1074753,143,32370,2126,10,4131,87,0,43,229410.0,130000.0,-51.0,-47.0,-42.0,-49.0,-50.0,-47.0,-43.0,-48.0,-87.0,-86.0,-83.0,-82.0,36.0,39.0,41.0,33.0,1
4418,CC:2F:71:3F:1F:24,4626075,1331368918,790128,847567489,3835947,483801429,37,637519,662737730,636796,662650748,723,86982,614854,15,790385,87119,34,518,144444.0,43333.0,-67.0,-67.0,-67.0,-69.0,-67.0,-67.0,-67.0,-68.0,-87.0,-86.0,-83.0,-82.0,20.0,19.0,16.0,13.0,1
4419,CC:2F:71:3E:C5:1F,3836826,483908752,878,107263,3835948,483801489,0,3660,307387,3020,231423,640,75964,928,9,1261,20,0,39,130000.0,39000.0,-72.0,-73.0,-69.0,-60.0,-72.0,-73.0,-70.0,-61.0,-87.0,-86.0,-83.0,-82.0,15.0,13.0,14.0,22.0,1
4420,BA:8C:B9:54:50:24,3840785,489984370,4837,6182881,3835948,483801489,0,9011,1700551,8989,1697056,22,3495,2348,15,5276,39,0,58,216660.0,130000.0,-49.0,-35.0,-43.0,-45.0,-44.0,-35.0,-44.0,-48.0,-87.0,-86.0,-83.0,-82.0,38.0,51.0,40.0,37.0,1
4421,62:47:05:9D:EB:15,3835997,483811887,46,9923,3835951,483801964,0,102,12159,91,9993,11,2166,38,0,66,0,0,4,216660.0,130000.0,-51.0,-51.0,-50.0,-44.0,-50.0,-50.0,-49.0,-44.0,-87.0,-86.0,-83.0,-82.0,36.0,35.0,33.0,38.0,1
4422,3C:55:76:E8:8F:1F,3871800,571654693,35849,87852729,3835951,483801964,20,17351,4153019,17089,4104714,262,48305,8247,17,35882,3125,20,166,216660.0,130000.0,-44.0,-53.0,-52.0,-40.0,-44.0,-52.0,-50.0,-40.0,-87.0,-86.0,-83.0,-82.0,43.0,33.0,31.0,42.0,1
4423,92:69:1D:31:68:E9,3839878,487428384,3927,3626420,3835951,483801964,0,4807,1107123,4664,1074753,143,32370,2126,10,4131,87,0,43,229410.0,130000.0,-51.0,-47.0,-42.0,-49.0,-50.0,-47.0,-43.0,-48.0,-87.0,-86.0,-83.0,-82.0,36.0,39.0,41.0,33.0,1
4424,CC:2F:71:3F:1F:24,4626292,1331634493,790339,847832327,3835953,483802166,37,637709,662989758,636986,662902776,723,86982,615038,15,790596,87137,34,518,144444.0,43333.0,-71.0,-70.0,-70.0,-72.0,-68.0,-68.0,-67.0,-69.0,-87.0,-86.0,-83.0,-82.0,16.0,16.0,13.0,10.0,1
4425,CC:2F:71:3E:C5:1F,3836831,483909429,878,107263,3835953,483802166,0,3660,307387,3020,231423,640,75964,928,9,1261,20,0,39,130000.0,39000.0,-72.0,-73.0,-69.0,-60.0,-72.0,-73.0,-70.0,-61.0,-87.0,-86.0,-83.0,-82.0,15.0,13.0,14.0,22.0,1
4426,BA:8C:B9:54:50:24,3840790,489985047,4837,6182881,3835953,483802166,0,9011,1700551,8989,1697056,22,3495,2348,15,5276,39,0,58,216660.0,130000.0,-49.0,-35.0,-43.0,-45.0,-44.0,-35.0,-44.0,-48.0,-87.0,-86.0,-83.0,-82.0,38.0,51.0,40.0,37.0,1
4427,62:47:05:9D:EB:15,3836003,483812493,46,9923,3835957,483802570,0,102,12159,91,9993,11,2166,38,0,66,0,0,4,216660.0,130000.0,-51.0,-51.0,-50.0,-44.0,-50.0,-50.0,-49.0,-44.0,-87.0,-86.0,-83.0,-82.0,36.0,35.0,33.0,38.0,1
4428,3C:55:76:E8:8F:1F,3871806,571655299,35849,87852729,3835957,483802570,20,17351,4153019,17089,4104714,262,48305,8247,17,35882,3125,20,166,216660.0,130000.0,-44.0,-53.0,-52.0,-40.0,-44.0,-52.0,-50.0,-40.0,-87.0,-86.0,-83.0,-82.0,43.0,33.0,31.0,42.0,1
4429,92:69:1D:31:68:E9,3839884,487428990,3927,3626420,3835957,483802570,0,4807,1107123,4664,1074753,143,32370,2126,10,4131,87,0,43,229410.0,130000.0,-51.0,-47.0,-42.0,-49.0,-50.0,-47.0,-43.0,-48.0,-87.0,-86.0,-83.0,-82.0,36.0,39.0,41.0,33.0,1
4430,CC:2F:71:3F:1F:24,4626512,1331901522,790555,848098952,3835957,483802570,37,637911,663252079,637188,663165097,723,86982,615231,15,790811,87149,34,518,144444.0,43333.0,-68.0,-67.0,-67.0,-69.0,-67.0,-67.0,-66.0,-69.0,-87.0,-86.0,-83.0,-82.0,19.0,19.0,16.0,13.0,1
4431,CC:2F:71:3E:C5:1F,3836837,483910035,878,107263,3835959,483802772,0,3660,307387,3020,231423,640,75964,928,9,1261,20,0,39,130000.0,39000.0,-72.0,-73.0,-69.0,-60.0,-72.0,-73.0,-70.0,-61.0,-87.0,-86.0,-83.0,-82.0,15.0,13.0,14.0,22.0,1
4432,BA:8C:B9:54:50:24,3840796,489985653,4837,6182881,3835959,483802772,0,9011,1700551,8989,1697056,22,3495,2348,15,5276,39,0,58,216660.0,130000.0,-49.0,-35.0,-43.0,-45.0,-44.0,-35.0,-44.0,-48.0,-87.0,-86.0,-83.0,-82.0,38.0,51.0,40.0,37.0,1
4433,62:47:05:9D:EB:15,3836008,483812957,46,9923,3835962,483803034,0,102,12159,91,9993,11,2166,38,0,66,0,0,4,216660.0,130000.0,-51.0,-51.0,-50.0,-44.0,-50.0,-50.0,-49.0,-44.0,-87.0,-86.0,-83.0,-82.0,36.0,35.0,33.0,38.0,1
4434,3C:55:76:E8:8F:1F,3871811,571655763,35849,87852729,3835962,483803034,20,17351,4153019,17089,4104714,262,48305,8247,17,35882,3125,20,166,216660.0,130000.0,-44.0,-53.0,-52.0,-40.0,-44.0,-52.0,-50.0,-40.0,-87.0,-86.0,-83.0,-82.0,43.0,33.0,31.0,42.0,1
4435,92:69:1D:31:68:E9,3839893,487430024,3927,3626420,3835966,483803604,0,4807,1107123,4664,1074753,143,32370,2126,10,4131,87,0,43,229410.0,130000.0,-51.0,-47.0,-42.0,-49.0,-50.0,-47.0,-43.0,-48.0,-87.0,-86.0,-83.0,-82.0,36.0,39.0,41.0,33.0,1
4436,CC:2F:71:3F:1F:24,4626735,1332167756,790769,848364152,3835966,483803604,37,638117,663527285,637394,663440303,723,86982,615418,15,791026,87151,34,518,144444.0,43333.0,-68.0,-69.0,-67.0,-69.0,-68.0,-69.0,-67.0,-69.0,-87.0,-86.0,-83.0,-82.0,19.0,17.0,16.0,13.0,1
4437,CC:2F:71:3E:C5:1F,3836844,483910867,878,107263,3835966,483803604,0,3660,307387,3020,231423,640,75964,928,9,1261,20,0,39,130000.0,39000.0,-72.0,-73.0,-69.0,-60.0,-72.0,-73.0,-70.0,-61.0,-87.0,-86.0,-83.0,-82.0,15.0,13.0,14.0,22.0,1
4438,BA:8C:B9:54:50:24,3840805,489986687,4837,6182881,3835968,483803806,0,9011,1700551,8989,1697056,22,3495,2348,15,5276,39,0,58,216660.0,130000.0,-49.0,-35.0,-43.0,-45.0,-44.0,-35.0,-44.0,-48.0,-87.0,-86.0,-83.0,-82.0,38.0,51.0,40.0,37.0,1
4439,62:47:05:9D:EB:15,3836014,483813729,46,9923,3835968,483803806,0,102,12159,91,9993,11,2166,38,0,66,0,0,4,216660.0,130000.0,-51.0,-51.0,-50.0,-44.0,-50.0,-50.0,-49.0,-44.0,-87.0,-86.0,-83.0,-82.0,36.0,35.0,33.0,38.0,1
4440,3C:55:76:E8:8F:1F,3871819,571656737,35849,87852729,3835970,483804008,20,17351,4153019,17089,4104714,262,48305,8247,17,35882,3125,20,166,216660.0,130000.0,-44.0,-53.0,-52.0,-40.0,-44.0,-52.0,-50.0,-40.0,-87.0,-86.0,-83.0,-82.0,43.0,33.0,31.0,42.0,1
4441,92:69:1D:31:68:E9,3839897,487430428,3927,3626420,3835970,483804008,0,4807,1107123,4664,1074753,143,32370,2126,10,4131,87,0,43,229410.0,130000.0,-51.0,-47.0,-42.0,-49.0,-50.0,-47.0,-43.0,-48.0,-87.0,-86.0,-83.0,-82.0,36.0,39.0,41.0,33.0,1
4442,CC:2F:71:3F:1F:24,4626946,1332431054,790976,848627046,3835970,483804008,37,638311,663785599,637588,663698617,723,86982,615601,15,791232,87151,34,518,144444.0,43333.0,-67.0,-68.0,-67.0,-70.0,-67.0,-68.0,-67.0,-69.0,-87.0,-86.0,-83.0,-82.0,20.0,18.0,16.0,12.0,1
4443,CC:2F:71:3E:C5:1F,3836848,483911271,878,107263,3835970,483804008,0,3660,307387,3020,231423,640,75964,928,9,1261,20,0,39,130000.0,39000.0,-72.0,-73.0,-69.0,-60.0,-72.0,-73.0,-70.0,-61.0,-87.0,-86.0,-83.0,-82.0,15.0,13.0,14.0,22.0,1
4444,BA:8C:B9:54:50:24,3840807,489986889,4837,6182881,3835970,483804008,0,9011,1700551,8989,1697056,22,3495,2348,15,5276,39,0,58,216660.0,130000.0,-49.0,-35.0,-43.0,-45.0,-44.0,-35.0,-44.0,-48.0,-87.0,-86.0,-83.0,-82.0,38.0,51.0,40.0,37.0,1
4445,62:47:05:9D:EB:15,3836023,483814519,46,9923,3835977,483804596,0,102,12159,91,9993,11,2166,38,0,66,0,0,4,216660.0,130000.0,-51.0,-51.0,-50.0,-44.0,-50.0,-50.0,-49.0,-44.0,-87.0,-86.0,-83.0,-82.0,36.0,35.0,33.0,38.0,1
4446,3C:55:76:E8:8F:1F,3871828,571657527,35849,87852729,3835979,483804798,20,17356,4154260,17092,4105719,264,48541,8252,17,35882,3125,20,168,216660.0,130000.0,-50.0,-53.0,-51.0,-45.0,-45.0,-52.0,-50.0,-41.0,-87.0,-86.0,-83.0,-82.0,37.0,33.0,32.0,37.0,1
4447,92:69:1D:31:68:E9,3839906,487431218,3927,3626420,3835979,483804798,0,4807,1107123,4664,1074753,143,32370,2126,10,4131,87,0,43,229410.0,130000.0,-51.0,-47.0,-42.0,-49.0,-50.0,-47.0,-43.0,-48.0,-87.0,-86.0,-83.0,-82.0,36.0,39.0,41.0,33.0,1
4448,CC:2F:71:3F:1F:24,4627166,1332698122,791187,848893324,3835979,483804798,37,638510,664052915,637787,663965933,723,86982,615788,15,791444,87152,34,518,144444.0,43333.0,-67.0,-67.0,-68.0,-69.0,-67.0,-67.0,-67.0,-69.0,-87.0,-86.0,-83.0,-82.0,20.0,19.0,15.0,13.0,1
4449,CC:2F:71:3E:C5:1F,3836857,483912061,878,107263,3835979,483804798,0,3660,307387,3020,231423,640,75964,928,9,1261,20,0,39,130000.0,39000.0,-72.0,-73.0,-69.0,-60.0,-72.0,-73.0,-70.0,-61.0,-87.0,-86.0,-83.0,-82.0,15.0,13.0,14.0,22.0,1
4450,BA:8C:B9:54:50:24,3840816,489987679,4837,6182881,3835979,483804798,0,9011,1700551,8989,1697056,22,3495,2348,15,5276,39,0,58,216660.0,130000.0,-49.0,-35.0,-43.0,-45.0,-44.0,-35.0,-44.0,-48.0,-87.0,-86.0,-83.0,-82.0,38.0,51.0,40.0,37.0,1
4451,62:47:05:9D:EB:15,3836027,483814923,46,9923,3835981,483805000,0,102,12159,91,9993,11,2166,38,0,66,0,0,4,216660.0,130000.0,-51.0,-51.0,-50.0,-44.0,-50.0,-50.0,-49.0,-44.0,-87.0,-86.0,-83.0,-82.0,36.0,35.0,33.0,38.0,1
4452,3C:55:76:E8:8F:1F,3871836,571659212,35855,87854212,3835981,483805000,20,17374,4157790,17106,4108777,268,49013,8257,17,35889,3158,20,168,135410.0,1000.0,-47.0,-50.0,-47.0,-43.0,-46.0,-52.0,-50.0,-42.0,-87.0,-86.0,-83.0,-82.0,40.0,36.0,36.0,39.0,1
4453,92:69:1D:31:68:E9,3839908,487431420,3927,3626420,3835981,483805000,0,4807,1107123,4664,1074753,143,32370,2126,10,4131,87,0,43,229410.0,130000.0,-51.0,-47.0,-42.0,-49.0,-50.0,-47.0,-43.0,-48.0,-87.0,-86.0,-83.0,-82.0,36.0,39.0,41.0,33.0,1
4454,CC:2F:71:3F:1F:24,4627384,1332964965,791403,849159965,3835981,483805000,37,638710,664309570,637987,664222588,723,86982,615978,15,791660,87152,34,518,144444.0,43333.0,-68.0,-67.0,-66.0,-70.0,-68.0,-67.0,-66.0,-69.0,-87.0,-86.0,-83.0,-82.0,19.0,19.0,17.0,12.0,1
4455,CC:2F:71:3E:C5:1F,3836859,483912263,878,107263,3835981,483805000,0,3660,307387,3020,231423,640,75964,928,9,1261,20,0,39,130000.0,39000.0,-72.0,-73.0,-69.0,-60.0,-72.0,-73.0,-70.0,-61.0,-87.0,-86.0,-83.0,-82.0,15.0,13.0,14.0,22.0,1
4456,BA:8C:B9:54:50:24,3840818,489987881,4837,6182881,3835981,483805000,0,9011,1700551,8989,1697056,22,3495,2348,15,5276,39,0,58,216660.0,130000.0,-49.0,-35.0,-43.0,-45.0,-44.0,-35.0,-44.0,-48.0,-87.0,-86.0,-83.0,-82.0,38.0,51.0,40.0,37.0,1
4457,62:47:05:9D:EB:15,3836034,483815591,46,9923,3835988,483805668,0,104,12295,93,10129,11,2166,38,0,67,0,0,4,216660.0,130000.0,-50.0,-50.0,-49.0,-45.0,-50.0,-50.0,-49.0,-44.0,-87.0,-86.0,-83.0,-82.0,37.0,36.0,34.0,37.0,1
4458,3C:55:76:E8:8F:1F,3871845,571660228,35857,87854560,3835988,483805668,20,17374,4157790,17106,4108777,268,49013,8257,17,35891,3163,20,168,135410.0,1000.0,-47.0,-50.0,-47.0,-43.0,-46.0,-52.0,-50.0,-42.0,-87.0,-86.0,-83.0,-82.0,40.0,36.0,36.0,39.0,1
4459,92:69:1D:31:68:E9,3839916,487432148,3927,3626420,3835989,483805728,0,4809,1107259,4666,1074889,143,32370,2126,10,4132,87,0,43,229410.0,130000.0,-52.0,-48.0,-44.0,-47.0,-51.0,-47.0,-43.0,-47.0,-87.0,-86.0,-83.0,-82.0,35.0,38.0,39.0,35.0,1
4460,CC:2F:71:3F:1F:24,4627604,1333232045,791615,849426317,3835989,483805728,37,638909,664571068,638185,664483968,724,87100,616167,15,791870,87182,34,518,130000.0,43333.0,-69.0,-67.0,-68.0,-71.0,-69.0,-67.0,-67.0,-72.0,-87.0,-86.0,-83.0,-82.0,18.0,19.0,15.0,11.0,1
4461,CC:2F:71:3E:C5:1F,3836867,483912991,878,107263,3835989,483805728,0,3662,307527,3022,231563,640,75964,928,9,1262,20,0,39,130000.0,39000.0,-71.0,-73.0,-70.0,-60.0,-71.0,-72.0,-69.0,-60.0,-87.0,-86.0,-83.0,-82.0,16.0,13.0,13.0,22.0,1
4462,BA:8C:B9:54:50:24,3840826,489988609,4837,6182881,3835989,483805728,0,9013,1700687,8991,1697192,22,3495,2348,15,5277,39,0,58,216660.0,130000.0,-48.0,-35.0,-43.0,-45.0,-44.0,-35.0,-44.0,-48.0,-87.0,-86.0,-83.0,-82.0,39.0,51.0,40.0,37.0,1
4463,62:47:05:9D:EB:15,3836037,483815853,46,9923,3835991,483805930,0,104,12295,93,10129,11,2166,38,0,67,0,0,4,216660.0,130000.0,-50.0,-50.0,-49.0,-45.0,-50.0,-50.0,-49.0,-44.0,-87.0,-86.0,-83.0,-82.0,37.0,36.0,34.0,37.0,1
4464,3C:55:76:E8:8F:1F,3871849,571660664,35858,87854734,3835991,483805930,20,17377,4158000,17109,4108987,268,49013,8257,17,35892,3163,20,168,135410.0,81250.0,-49.0,-54.0,-48.0,-41.0,-47.0,-52.0,-48.0,-42.0,-87.0,-86.0,-83.0,-82.0,38.0,32.0,35.0,41.0,1
4465,92:69:1D:31:68:E9,3839918,487432350,3927,3626420,3835991,483805930,0,4809,1107259,4666,1074889,143,32370,2126,10,4132,87,0,43,229410.0,130000.0,-52.0,-48.0,-44.0,-47.0,-51.0,-47.0,-43.0,-47.0,-87.0,-86.0,-83.0,-82.0,35.0,38.0,39.0,35.0,1
4466,CC:2F:71:3F:1F:24,4627816,1333495531,791825,849689601,3835991,483805930,37,639108,664834224,638384,664747124,724,87100,616354,15,792082,87185,34,518,130000.0,43333.0,-69.0,-66.0,-67.0,-71.0,-69.0,-66.0,-67.0,-71.0,-87.0,-86.0,-83.0,-82.0,18.0,20.0,16.0,11.0,1
4467,CC:2F:71:3E:C5:1F,3836871,483913395,878,107263,3835993,483806132,0,3662,307527,3022,231563,640,75964,928,9,1262,20,0,39,130000.0,39000.0,-71.0,-73.0,-70.0,-60.0,-71.0,-72.0,-69.0,-60.0,-87.0,-86.0,-83.0,-82.0,16.0,13.0,13.0,22.0,1
4468,BA:8C:B9:54:50:24,3840832,489989215,4837,6182881,3835995,483806334,0,9013,1700687,8991,1697192,22,3495,2348,15,5277,39,0,58,216660.0,130000.0,-48.0,-35.0,-43.0,-45.0,-44.0,-35.0,-44.0,-48.0,-87.0,-86.0,-83.0,-82.0,39.0,51.0,40.0,37.0,1
4469,62:47:05:9D:EB:15,3836043,483816459,46,9923,3835997,483806536,0,105,12363,94,10197,11,2166,38,0,67,0,0,4,216660.0,130000.0,-51.0,-51.0,-50.0,-45.0,-50.0,-50.0,-49.0,-44.0,-87.0,-86.0,-83.0,-82.0,36.0,35.0,33.0,37.0,1
4470,3C:55:76:E8:8F:1F,3871856,571661388,35859,87854852,3835997,483806536,20,17380,4158210,17112,4109197,268,49013,8257,17,35893,3163,20,168,135410.0,81250.0,-46.0,-54.0,-50.0,-40.0,-48.0,-52.0,-47.0,-41.0,-87.0,-86.0,-83.0,-82.0,41.0,32.0,33.0,42.0,1
4471,92:69:1D:31:68:E9,3839924,487432956,3927,3626420,3835997,483806536,0,4809,1107259,4666,1074889,143,32370,2126,10,4132,87,0,43,229410.0,130000.0,-52.0,-48.0,-44.0,-47.0,-51.0,-47.0,-43.0,-47.0,-87.0,-86.0,-83.0,-82.0,35.0,38.0,39.0,35.0,1
4472,CC:2F:71:3F:1F:24,4628033,1333759327,792036,849952791,3835997,483806536,37,639301,665086630,638577,664999530,724,87100,616540,15,792293,87195,34,518,130000.0,43333.0,-69.0,-66.0,-67.0,-71.0,-69.0,-66.0,-66.0,-70.0,-87.0,-86.0,-83.0,-82.0,18.0,20.0,16.0,11.0,1
4473,CC:2F:71:3E:C5:1F,3836875,483913799,878,107263,3835997,483806536,0,3662,307527,3022,231563,640,75964,928,9,1262,20,0,39,130000.0,39000.0,-71.0,-73.0,-70.0,-60.0,-71.0,-72.0,-69.0,-60.0,-87.0,-86.0,-83.0,-82.0,16.0,13.0,13.0,22.0,1
4474,BA:8C:B9:54:50:24,3840836,489989619,4837,6182881,3835999,483806738,0,9013,1700687,8991,1697192,22,3495,2348,15,5277,39,0,58,216660.0,130000.0,-48.0,-35.0,-43.0,-45.0,-44.0,-35.0,-44.0,-48.0,-87.0,-86.0,-83.0,-82.0,39.0,51.0,40.0,37.0,1
4475,62:47:05:9D:EB:15,3836047,483816783,46,9923,3836001,483806860,0,105,12363,94,10197,11,2166,38,0,67,0,0,4,216660.0,130000.0,-51.0,-51.0,-50.0,-45.0,-50.0,-50.0,-49.0,-44.0,-87.0,-86.0,-83.0,-82.0,36.0,35.0,33.0,37.0,1
4476,3C:55:76:E8:8F:1F,3871862,571661914,35859,87854852,3836003,483807062,20,17383,4158420,17115,4109407,268,49013,8257,17,35893,3163,20,169,135410.0,81250.0,-48.0,-50.0,-43.0,-43.0,-47.0,-52.0,-46.0,-41.0,-87.0,-86.0,-83.0,-82.0,39.0,36.0,40.0,39.0,1
4477,92:69:1D:31:68:E9,3839932,487433684,3927,3626420,3836005,483807264,0,4809,1107259,4666,1074889,143,32370,2126,10,4132,87,0,43,229410.0,130000.0,-52.0,-48.0,-44.0,-47.0,-51.0,-47.0,-43.0,-47.0,-87.0,-86.0,-83.0,-82.0,35.0,38.0,39.0,35.0,1
4478,CC:2F:71:3F:1F:24,4628258,1334022600,792253,850215336,3836005,483807264,37,639503,665342085,638779,665254985,724,87100,616732,15,792509,87195,34,518,130000.0,43333.0,-69.0,-66.0,-67.0,-70.0,-69.0,-66.0,-67.0,-70.0,-87.0,-86.0,-83.0,-82.0,18.0,20.0,16.0,12.0,1
4479,CC:2F:71:3E:C5:1F,3836883,483914527,878,107263,3836005,483807264,0,3664,307715,3023,231633,641,76082,929,9,1262,20,0,40,130000.0,39000.0,-71.0,-73.0,-70.0,-60.0,-71.0,-72.0,-69.0,-60.0,-87.0,-86.0,-83.0,-82.0,16.0,13.0,13.0,22.0,1
4480,BA:8C:B9:54:50:24,3840843,489990279,4837,6182881,3836006,483807398,0,9013,1700687,8991,1697192,22,3495,2348,15,5277,39,0,58,216660.0,130000.0,-48.0,-35.0,-43.0,-45.0,-44.0,-35.0,-44.0,-48.0,-87.0,-86.0,-83.0,-82.0,39.0,51.0,40.0,37.0,1
4481,62:47:05:9D:EB:15,3836053,483817389,46,9923,3836007,483807466,0,105,12363,94,10197,11,2166,38,0,67,0,0,4,216660.0,130000.0,-51.0,-51.0,-50.0,-45.0,-50.0,-50.0,-49.0,-44.0,-87.0,-86.0,-83.0,-82.0,36.0,35.0,33.0,37.0,1
4482,3C:55:76:E8:8F:1F,3871869,571662644,35860,87854976,3836009,483807668,20,17388,4158770,17120,4109757,268,49013,8257,17,35894,3163,20,169,135410.0,81250.0,-48.0,-50.0,-43.0,-41.0,-46.0,-52.0,-47.0,-40.0,-87.0,-86.0,-83.0,-82.0,39.0,36.0,40.0,41.0,1
4483,92:69:1D:31:68:E9,3839936,487434088,3927,3626420,3836009,483807668,0,4809,1107259,4666,1074889,143,32370,2126,10,4132,87,0,43,229410.0,130000.0,-52.0,-48.0,-44.0,-47.0,-51.0,-47.0,-43.0,-47.0,-87.0,-86.0,-83.0,-82.0,35.0,38.0,39.0,35.0,1
4484,CC:2F:71:3F:1F:24,4628479,1334294318,792470,850486650,3836009,483807668,37,639704,665608133,638980,665521033,724,87100,616923,15,792727,87197,34,518,130000.0,43333.0,-69.0,-66.0,-67.0,-71.0,-69.0,-66.0,-67.0,-71.0,-87.0,-86.0,-83.0,-82.0,18.0,20.0,16.0,11.0,1
4485,CC:2F:71:3E:C5:1F,3836887,483914931,878,107263,3836009,483807668,0,3664,307715,3023,231633,641,76082,929,9,1262,20,0,40,130000.0,39000.0,-71.0,-73.0,-70.0,-60.0,-71.0,-72.0,-69.0,-60.0,-87.0,-87.0,-83.0,-83.0,16.0,14.0,13.0,23.0,1
4486,BA:8C:B9:54:50:24,3840846,489990549,4837,6182881,3836009,483807668,0,9013,1700687,8991,1697192,22,3495,2348,15,5277,39,0,58,216660.0,130000.0,-48.0,-35.0,-43.0,-45.0,-44.0,-35.0,-44.0,-48.0,-87.0,-87.0,-83.0,-83.0,39.0,52.0,40.0,38.0,1
4487,62:47:05:9D:EB:15,3836060,483818055,46,9923,3836014,483808132,0,105,12363,94,10197,11,2166,38,0,67,0,0,4,216660.0,130000.0,-51.0,-51.0,-50.0,-45.0,-50.0,-50.0,-49.0,-44.0,-87.0,-87.0,-83.0,-83.0,36.0,36.0,33.0,38.0,1
4488,3C:55:76:E8:8F:1F,3871876,571663555,35861,87855150,3836015,483808405,20,17392,4159050,17124,4110037,268,49013,8257,17,35895,3163,20,169,135410.0,81250.0,-48.0,-50.0,-44.0,-42.0,-47.0,-51.0,-46.0,-41.0,-87.0,-87.0,-83.0,-83.0,39.0,37.0,39.0,41.0,1
4489,92:69:1D:31:68:E9,3839943,487434893,3927,3626420,3836016,483808473,0,4809,1107259,4666,1074889,143,32370,2126,10,4132,87,0,43,229410.0,130000.0,-52.0,-48.0,-44.0,-47.0,-51.0,-47.0,-43.0,-47.0,-87.0,-87.0,-83.0,-83.0,35.0,39.0,39.0,36.0,1
4490,CC:2F:71:3F:1F:24,4628697,1334558313,792681,850749840,3836016,483808473,37,639909,665870857,639185,665783757,724,87100,617112,15,792938,87202,34,518,130000.0,43333.0,-69.0,-66.0,-67.0,-71.0,-69.0,-66.0,-67.0,-71.0,-87.0,-87.0,-83.0,-83.0,18.0,21.0,16.0,12.0,1
4491,CC:2F:71:3E:C5:1F,3836895,483915870,878,107263,3836017,483808607,0,3664,307715,3023,231633,641,76082,929,9,1262,20,0,40,130000.0,39000.0,-71.0,-73.0,-70.0,-60.0,-71.0,-72.0,-69.0,-60.0,-87.0,-87.0,-83.0,-83.0,16.0,14.0,13.0,23.0,1
4492,BA:8C:B9:54:50:24,3840854,489991488,4837,6182881,3836017,483808607,0,9014,1700755,8992,1697260,22,3495,2348,15,5277,39,0,58,216660.0,130000.0,-40.0,-36.0,-45.0,-52.0,-44.0,-35.0,-44.0,-48.0,-87.0,-87.0,-83.0,-83.0,47.0,51.0,38.0,31.0,1
4493,62:47:05:9D:EB:15,3836065,483818732,46,9923,3836019,483808809,0,105,12363,94,10197,11,2166,38,0,67,0,0,4,216660.0,130000.0,-51.0,-51.0,-50.0,-45.0,-50.0,-50.0,-49.0,-44.0,-87.0,-87.0,-83.0,-83.0,36.0,36.0,33.0,38.0,1
4494,3C:55:76:E8:8F:1F,3871880,571663959,35861,87855150,3836019,483808809,20,17402,4159750,17134,4110737,268,49013,8257,17,35895,3163,20,169,135410.0,81250.0,-51.0,-58.0,-53.0,-45.0,-48.0,-54.0,-49.0,-42.0,-87.0,-87.0,-83.0,-83.0,36.0,29.0,30.0,38.0,1
4495,92:69:1D:31:68:E9,3839946,487435229,3927,3626420,3836019,483808809,0,4809,1107259,4666,1074889,143,32370,2126,10,4132,87,0,43,229410.0,130000.0,-52.0,-48.0,-44.0,-47.0,-51.0,-47.0,-43.0,-47.0,-87.0,-87.0,-83.0,-83.0,35.0,39.0,39.0,36.0,1
4496,CC:2F:71:3F:1F:24,4628917,1334825180,792898,851016371,3836019,483808809,37,640112,666130418,639388,666043318,724,87100,617308,15,793155,87210,34,518,130000.0,43333.0,-69.0,-66.0,-67.0,-71.0,-69.0,-66.0,-67.0,-71.0,-87.0,-87.0,-83.0,-83.0,18.0,21.0,16.0,12.0,1
4497,CC:2F:71:3E:C5:1F,3836897,483916072,878,107263,3836019,483808809,0,3664,307715,3023,231633,641,76082,929,9,1262,20,0,40,130000.0,39000.0,-71.0,-73.0,-70.0,-60.0,-71.0,-72.0,-69.0,-60.0,-87.0,-87.0,-83.0,-83.0,16.0,14.0,13.0,23.0,1
4498,BA:8C:B9:54:50:24,3840856,489991690,4837,6182881,3836019,483808809,0,9014,1700755,8992,1697260,22,3495,2348,15,5277,39,0,58,216660.0,130000.0,-40.0,-36.0,-45.0,-52.0,-44.0,-35.0,-44.0,-48.0,-87.0,-87.0,-83.0,-83.0,47.0,51.0,38.0,31.0,1
4499,62:47:05:9D:EB:15,3836072,483819400,46,9923,3836026,483809477,0,105,12363,94,10197,11,2166,38,0,67,0,0,4,216660.0,130000.0,-51.0,-51.0,-50.0,-45.0,-50.0,-50.0,-49.0,-44.0,-87.0,-87.0,-83.0,-83.0,36.0,36.0,33.0,38.0,1
4500,3C:55:76:E8:8F:1F,3871907,571674487,35881,87865010,3836026,483809477,20,17453,4179923,17184,4130792,269,49131,8278,17,35916,3173,20,170,135410.0,1000.0,-50.0,-57.0,-52.0,-45.0,-50.0,-55.0,-50.0,-44.0,-87.0,-87.0,-83.0,-83.0,37.0,30.0,31.0,38.0,1
4501,92:69:1D:31:68:E9,3839954,487435957,3927,3626420,3836027,483809537,0,4809,1107259,4666,1074889,143,32370,2126,10,4132,87,0,43,229410.0,130000.0,-52.0,-48.0,-44.0,-47.0,-51.0,-47.0,-43.0,-47.0,-87.0,-87.0,-83.0,-83.0,35.0,39.0,39.0,36.0,1
4502,CC:2F:71:3F:1F:24,4629133,1335088708,793106,851279171,3836027,483809537,37,640310,666394812,639586,666307712,724,87100,617491,15,793363,87222,34,518,130000.0,43333.0,-70.0,-67.0,-68.0,-71.0,-69.0,-67.0,-67.0,-71.0,-87.0,-87.0,-83.0,-83.0,17.0,20.0,15.0,12.0,1
4503,CC:2F:71:3E:C5:1F,3836905,483916800,878,107263,3836027,483809537,0,3664,307715,3023,231633,641,76082,929,9,1262,20,0,40,130000.0,39000.0,-71.0,-73.0,-70.0,-60.0,-71.0,-72.0,-69.0,-60.0,-87.0,-87.0,-83.0,-83.0,16.0,14.0,13.0,23.0,1
4504,BA:8C:B9:54:50:24,3840864,489992418,4837,6182881,3836027,483809537,0,9014,1700755,8992,1697260,22,3495,2348,15,5277,39,0,58,216660.0,130000.0,-40.0,-36.0,-45.0,-52.0,-44.0,-35.0,-44.0,-48.0,-87.0,-87.0,-83.0,-83.0,47.0,51.0,38.0,31.0,1
4505,62:47:05:9D:EB:15,3836075,483819662,46,9923,3836029,483809739,0,105,12363,94,10197,11,2166,38,0,67,0,0,4,216660.0,130000.0,-51.0,-51.0,-50.0,-45.0,-50.0,-50.0,-49.0,-44.0,-87.0,-87.0,-83.0,-83.0,36.0,36.0,33.0,38.0,1
4506,3C:55:76:E8:8F:1F,3871910,571674749,35881,87865010,3836029,483809739,20,17457,4180197,17188,4131066,269,49131,8278,17,35916,3173,20,170,135410.0,1000.0,-50.0,-51.0,-45.0,-45.0,-49.0,-52.0,-47.0,-44.0,-87.0,-87.0,-83.0,-83.0,37.0,36.0,38.0,38.0,1
4507,92:69:1D:31:68:E9,3839956,487436159,3927,3626420,3836029,483809739,0,4809,1107259,4666,1074889,143,32370,2126,10,4132,87,0,43,229410.0,130000.0,-52.0,-48.0,-44.0,-47.0,-51.0,-47.0,-43.0,-47.0,-87.0,-87.0,-83.0,-83.0,35.0,39.0,39.0,36.0,1
4508,CC:2F:71:3F:1F:24,4629346,1335352324,793317,851542585,3836029,483809739,37,640509,666656592,639785,666569492,724,87100,617678,15,793574,87222,34,518,130000.0,43333.0,-69.0,-66.0,-67.0,-70.0,-68.0,-65.0,-66.0,-70.0,-87.0,-87.0,-83.0,-83.0,18.0,21.0,16.0,13.0,1
4509,CC:2F:71:3E:C5:1F,3836907,483917002,878,107263,3836029,483809739,0,3664,307715,3023,231633,641,76082,929,9,1262,20,0,40,130000.0,39000.0,-71.0,-73.0,-70.0,-60.0,-71.0,-72.0,-69.0,-60.0,-87.0,-87.0,-83.0,-83.0,16.0,14.0,13.0,23.0,1
4510,BA:8C:B9:54:50:24,3840870,489993024,4837,6182881,3836033,483810143,0,9014,1700755,8992,1697260,22,3495,2348,15,5277,39,0,58,216660.0,130000.0,-40.0,-36.0,-45.0,-52.0,-44.0,-35.0,-44.0,-48.0,-87.0,-87.0,-83.0,-83.0,47.0,51.0,38.0,31.0,1
4511,62:47:05:9D:EB:15,3836081,483820268,46,9923,3836035,483810345,0,105,12363,94,10197,11,2166,38,0,67,0,0,4,216660.0,130000.0,-51.0,-51.0,-50.0,-45.0,-50.0,-50.0,-49.0,-44.0,-87.0,-87.0,-83.0,-83.0,36.0,36.0,33.0,38.0,1
4512,3C:55:76:E8:8F:1F,3871917,571675423,35882,87865078,3836035,483810345,20,17460,4180405,17191,4131274,269,49131,8278,17,35917,3176,20,170,135410.0,1000.0,-50.0,-52.0,-45.0,-45.0,-49.0,-51.0,-45.0,-44.0,-87.0,-87.0,-83.0,-83.0,37.0,35.0,38.0,38.0,1
4513,92:69:1D:31:68:E9,3839962,487436765,3927,3626420,3836035,483810345,0,4809,1107259,4666,1074889,143,32370,2126,10,4132,87,0,43,229410.0,130000.0,-52.0,-48.0,-44.0,-47.0,-51.0,-47.0,-43.0,-47.0,-87.0,-87.0,-83.0,-83.0,35.0,39.0,39.0,36.0,1
4514,CC:2F:71:3F:1F:24,4629563,1335618968,793528,851808623,3836035,483810345,37,640707,666922410,639983,666835310,724,87100,617864,15,793785,87226,34,518,130000.0,43333.0,-69.0,-66.0,-67.0,-71.0,-69.0,-66.0,-67.0,-71.0,-87.0,-87.0,-83.0,-83.0,18.0,21.0,16.0,12.0,1
4515,CC:2F:71:3E:C5:1F,3836913,483917608,878,107263,3836035,483810345,0,3664,307715,3023,231633,641,76082,929,9,1262,20,0,40,130000.0,39000.0,-71.0,-73.0,-70.0,-60.0,-71.0,-72.0,-69.0,-60.0,-87.0,-87.0,-83.0,-83.0,16.0,14.0,13.0,23.0,1
4516,BA:8C:B9:54:50:24,3840874,489993428,4837,6182881,3836037,483810547,0,9014,1700755,8992,1697260,22,3495,2348,15,5277,39,0,58,216660.0,130000.0,-40.0,-36.0,-45.0,-52.0,-44.0,-35.0,-44.0,-48.0,-87.0,-87.0,-83.0,-83.0,47.0,51.0,38.0,31.0,1
4517,62:47:05:9D:EB:15,3836084,483820530,46,9923,3836038,483810607,0,105,12363,94,10197,11,2166,38,0,67,0,0,4,216660.0,130000.0,-51.0,-51.0,-50.0,-45.0,-50.0,-50.0,-49.0,-44.0,-87.0,-87.0,-83.0,-83.0,36.0,36.0,33.0,38.0,1
4518,3C:55:76:E8:8F:1F,3871922,571675887,35882,87865078,3836040,483810809,20,17460,4180405,17191,4131274,269,49131,8278,17,35917,3176,20,170,135410.0,1000.0,-50.0,-52.0,-45.0,-45.0,-49.0,-51.0,-45.0,-44.0,-87.0,-87.0,-83.0,-83.0,37.0,35.0,38.0,38.0,1
4519,92:69:1D:31:68:E9,3839969,487437431,3927,3626420,3836042,483811011,0,4809,1107259,4666,1074889,143,32370,2126,10,4132,87,0,43,229410.0,130000.0,-52.0,-48.0,-44.0,-47.0,-51.0,-47.0,-43.0,-47.0,-87.0,-87.0,-83.0,-83.0,35.0,39.0,39.0,36.0,1
4520,CC:2F:71:3F:1F:24,4629786,1335883411,793744,852072400,3836042,483811011,37,640910,667182104,640186,667095004,724,87100,618054,15,794001,87229,34,518,130000.0,43333.0,-69.0,-66.0,-67.0,-71.0,-69.0,-66.0,-67.0,-70.0,-87.0,-87.0,-83.0,-83.0,18.0,21.0,16.0,12.0,1
4521,CC:2F:71:3E:C5:1F,3836920,483918274,878,107263,3836042,483811011,0,3664,307715,3023,231633,641,76082,929,9,1262,20,0,40,130000.0,39000.0,-71.0,-73.0,-70.0,-60.0,-71.0,-72.0,-69.0,-60.0,-87.0,-87.0,-83.0,-83.0,16.0,14.0,13.0,23.0,1
4522,BA:8C:B9:54:50:24,3840879,489993892,4837,6182881,3836042,483811011,0,9014,1700755,8992,1697260,22,3495,2348,15,5277,39,0,58,216660.0,130000.0,-40.0,-36.0,-45.0,-52.0,-44.0,-35.0,-44.0,-48.0,-87.0,-87.0,-83.0,-83.0,47.0,51.0,38.0,31.0,1
4523,62:47:05:9D:EB:15,3836090,483821136,46,9923,3836044,483811213,0,105,12363,94,10197,11,2166,38,0,67,0,0,4,216660.0,130000.0,-51.0,-51.0,-50.0,-45.0,-50.0,-50.0,-49.0,-44.0,-87.0,-87.0,-83.0,-83.0,36.0,36.0,33.0,38.0,1
4524,3C:55:76:E8:8F:1F,3871927,571676415,35883,87865202,3836044,483811213,20,17460,4180405,17191,4131274,269,49131,8278,17,35918,3180,20,170,121870.0,1000.0,-50.0,-52.0,-45.0,-45.0,-49.0,-51.0,-45.0,-44.0,-87.0,-87.0,-83.0,-83.0,37.0,35.0,38.0,38.0,1
4525,92:69:1D:31:68:E9,3839973,487437835,3927,3626420,3836046,483811415,0,4809,1107259,4666,1074889,143,32370,2126,10,4132,87,0,43,229410.0,130000.0,-52.0,-48.0,-44.0,-47.0,-51.0,-47.0,-43.0,-47.0,-87.0,-87.0,-83.0,-83.0,35.0,39.0,39.0,36.0,1
4526,CC:2F:71:3F:1F:24,4629999,1336145545,793953,852334130,3836046,483811415,37,641101,667432634,640377,667345534,724,87100,618240,15,794210,87230,34,518,130000.0,43333.0,-69.0,-66.0,-67.0,-71.0,-69.0,-66.0,-66.0,-70.0,-87.0,-87.0,-83.0,-83.0,18.0,21.0,16.0,12.0,1
4527,CC:2F:71:3E:C5:1F,3836924,483918678,878,107263,3836046,483811415,0,3664,307715,3023,231633,641,76082,929,9,1262,20,0,40,130000.0,39000.0,-71.0,-73.0,-70.0,-60.0,-71.0,-72.0,-69.0,-60.0,-87.0,-87.0,-83.0,-83.0,16.0,14.0,13.0,23.0,1
4528,BA:8C:B9:54:50:24,3840883,489994296,4837,6182881,3836046,483811415,0,9014,1700755,8992,1697260,22,3495,2348,15,5277,39,0,58,216660.0,130000.0,-40.0,-36.0,-45.0,-52.0,-44.0,-35.0,-44.0,-48.0,-87.0,-87.0,-83.0,-83.0,47.0,51.0,38.0,31.0,1
4529,62:47:05:9D:EB:15,3836097,483821802,46,9923,3836051,483811879,0,105,12363,94,10197,11,2166,38,0,67,0,0,4,216660.0,130000.0,-51.0,-51.0,-50.0,-45.0,-50.0,-50.0,-49.0,-44.0,-87.0,-87.0,-83.0,-83.0,36.0,36.0,33.0,38.0,1
4530,3C:55:76:E8:8F:1F,3871941,571679174,35890,87867295,3836051,483811879,20,17473,4186245,17204,4137114,269,49131,8291,17,35925,3207,20,178,108330.0,1000.0,-48.0,-53.0,-50.0,-41.0,-49.0,-51.0,-45.0,-43.0,-87.0,-87.0,-83.0,-83.0,39.0,34.0,33.0,42.0,1
4531,92:69:1D:31:68:E9,3839980,487438501,3927,3626420,3836053,483812081,0,4809,1107259,4666,1074889,143,32370,2126,10,4132,87,0,43,229410.0,130000.0,-52.0,-48.0,-44.0,-47.0,-51.0,-47.0,-43.0,-47.0,-87.0,-87.0,-83.0,-83.0,35.0,39.0,39.0,36.0,1
4532,CC:2F:71:3F:1F:24,4630318,1336554806,794265,852742725,3836053,483812081,37,641401,667845378,640677,667758278,724,87100,618525,15,794522,87245,34,518,130000.0,43333.0,-69.0,-66.0,-67.0,-71.0,-69.0,-66.0,-67.0,-71.0,-87.0,-87.0,-83.0,-83.0,18.0,21.0,16.0,12.0,1
4533,CC:2F:71:3E:C5:1F,3836931,483919344,878,107263,3836053,483812081,0,3664,307715,3023,231633,641,76082,929,9,1262,20,0,40,130000.0,39000.0,-71.0,-73.0,-70.0,-60.0,-71.0,-72.0,-69.0,-60.0,-87.0,-87.0,-83.0,-83.0,16.0,14.0,13.0,23.0,1
4534,BA:8C:B9:54:50:24,3840892,489995164,4837,6182881,3836055,483812283,0,9014,1700755,8992,1697260,22,3495,2348,15,5277,39,0,58,216660.0,130000.0,-40.0,-36.0,-45.0,-52.0,-44.0,-35.0,-44.0,-48.0,-87.0,-87.0,-83.0,-83.0,47.0,51.0,38.0,31.0,1
4535,62:47:05:9D:EB:15,3836103,483822408,46,9923,3836057,483812485,0,105,12363,94,10197,11,2166,38,0,67,0,0,4,216660.0,130000.0,-51.0,-51.0,-50.0,-45.0,-50.0,-50.0,-49.0,-44.0,-87.0,-87.0,-83.0,-83.0,36.0,36.0,33.0,38.0,1
4536,3C:55:76:E8:8F:1F,3871954,571683273,35897,87870788,3836057,483812485,20,17518,4203625,17249,4154494,269,49131,8297,20,35937,3264,20,178,97500.0,1000.0,-52.0,-53.0,-47.0,-46.0,-49.0,-53.0,-49.0,-43.0,-87.0,-87.0,-83.0,-83.0,35.0,34.0,36.0,37.0,1
4537,92:69:1D:31:68:E9,3839986,487439107,3927,3626420,3836059,483812687,0,4809,1107259,4666,1074889,143,32370,2126,10,4132,87,0,43,229410.0,130000.0,-52.0,-48.0,-44.0,-47.0,-51.0,-47.0,-43.0,-47.0,-87.0,-87.0,-83.0,-83.0,35.0,39.0,39.0,36.0,1
4538,CC:2F:71:3F:1F:24,4630532,1336815364,794473,853002677,3836059,483812687,37,641594,668100454,640870,668013354,724,87100,618710,15,794730,87256,34,518,130000.0,43333.0,-69.0,-66.0,-67.0,-71.0,-69.0,-66.0,-67.0,-71.0,-87.0,-87.0,-83.0,-83.0,18.0,21.0,16.0,12.0,1
4539,CC:2F:71:3E:C5:1F,3836937,483919950,878,107263,3836059,483812687,0,3664,307715,3023,231633,641,76082,929,9,1262,20,0,40,130000.0,39000.0,-71.0,-73.0,-70.0,-60.0,-71.0,-72.0,-69.0,-60.0,-87.0,-87.0,-83.0,-83.0,16.0,14.0,13.0,23.0,1
4540,BA:8C:B9:54:50:24,3840896,489995568,4837,6182881,3836059,483812687,0,9014,1700755,8992,1697260,22,3495,2348,15,5277,39,0,58,216660.0,130000.0,-40.0,-36.0,-45.0,-52.0,-44.0,-35.0,-44.0,-48.0,-87.0,-87.0,-83.0,-83.0,47.0,51.0,38.0,31.0,1
4541,62:47:05:9D:EB:15,3836108,483822872,46,9923,3836062,483812949,0,105,12363,94,10197,11,2166,38,0,67,0,0,4,216660.0,130000.0,-51.0,-51.0,-50.0,-45.0,-50.0,-50.0,-49.0,-44.0,-87.0,-87.0,-83.0,-83.0,36.0,36.0,33.0,38.0,1
4542,3C:55:76:E8:8F:1F,3871959,571683737,35897,87870788,3836062,483812949,20,17518,4203625,17249,4154494,269,49131,8297,20,35937,3264,20,178,97500.0,1000.0,-52.0,-53.0,-47.0,-46.0,-49.0,-53.0,-49.0,-43.0,-87.0,-87.0,-83.0,-83.0,35.0,34.0,36.0,37.0,1
4543,92:69:1D:31:68:E9,3839991,487439571,3927,3626420,3836064,483813151,0,4809,1107259,4666,1074889,143,32370,2126,10,4132,87,0,43,229410.0,130000.0,-52.0,-48.0,-44.0,-47.0,-51.0,-47.0,-43.0,-47.0,-87.0,-87.0,-83.0,-83.0,35.0,39.0,39.0,36.0,1
4544,CC:2F:71:3F:1F:24,4630746,1337075992,794682,853262841,3836064,483813151,37,641791,668366046,641067,668278946,724,87100,618893,15,794938,87264,34,518,117000.0,39000.0,-69.0,-66.0,-67.0,-71.0,-68.0,-66.0,-67.0,-71.0,-87.0,-87.0,-83.0,-83.0,18.0,21.0,16.0,12.0,1
4545,CC:2F:71:3E:C5:1F,3836943,483920530,879,107379,3836064,483813151,0,3665,307785,3024,231703,641,76082,929,9,1263,20,0,40,130000.0,39000.0,-72.0,-72.0,-70.0,-60.0,-71.0,-72.0,-69.0,-60.0,-87.0,-87.0,-83.0,-83.0,15.0,15.0,13.0,23.0,1
4546,BA:8C:B9:54:50:24,3840901,489996032,4837,6182881,3836064,483813151,0,9014,1700755,8992,1697260,22,3495,2348,15,5277,39,0,58,216660.0,130000.0,-40.0,-36.0,-45.0,-52.0,-44.0,-35.0,-44.0,-48.0,-87.0,-87.0,-83.0,-83.0,47.0,51.0,38.0,31.0,1
4547,62:47:05:9D:EB:15,3836115,483823594,47,10039,3836068,483813555,0,107,12499,96,10333,11,2166,38,0,68,0,0,4,216660.0,130000.0,-50.0,-52.0,-50.0,-45.0,-50.0,-51.0,-49.0,-44.0,-87.0,-87.0,-83.0,-83.0,37.0,35.0,33.0,38.0,1
4548,3C:55:76:E8:8F:1F,3871967,571684679,35899,87871124,3836068,483813555,20,17526,4204369,17257,4155238,269,49131,8300,20,35939,3271,20,178,81250.0,1000.0,-43.0,-55.0,-50.0,-40.0,-46.0,-54.0,-51.0,-41.0,-87.0,-87.0,-83.0,-83.0,44.0,32.0,33.0,43.0,1
4549,92:69:1D:31:68:E9,3839996,487440091,3928,3626536,3836068,483813555,0,4811,1107395,4668,1075025,143,32370,2126,10,4133,87,0,44,229410.0,130000.0,-51.0,-47.0,-42.0,-49.0,-51.0,-47.0,-43.0,-47.0,-87.0,-87.0,-83.0,-83.0,36.0,40.0,41.0,34.0,1
4550,CC:2F:71:3F:1F:24,4630960,1337342416,794892,853528861,3836068,483813555,37,641988,668627452,641264,668540352,724,87100,619079,15,795149,87264,34,518,130000.0,43333.0,-68.0,-66.0,-67.0,-70.0,-68.0,-66.0,-67.0,-70.0,-87.0,-87.0,-83.0,-83.0,19.0,21.0,16.0,13.0,1
4551,CC:2F:71:3E:C5:1F,3836947,483920934,879,107379,3836068,483813555,0,3666,307855,3025,231773,641,76082,929,9,1263,20,0,40,130000.0,39000.0,-72.0,-74.0,-69.0,-61.0,-71.0,-72.0,-69.0,-60.0,-87.0,-87.0,-83.0,-83.0,15.0,13.0,14.0,22.0,1
4552,BA:8C:B9:54:50:24,3840906,489996552,4838,6182997,3836068,483813555,0,9016,1700891,8994,1697396,22,3495,2348,15,5278,39,0,58,216660.0,130000.0,-39.0,-36.0,-46.0,-52.0,-43.0,-35.0,-44.0,-49.0,-87.0,-87.0,-83.0,-83.0,48.0,51.0,37.0,31.0,1
4553,62:47:05:9D:EB:15,3836120,483824058,47,10039,3836073,483814019,0,107,12499,96,10333,11,2166,38,0,68,0,0,4,216660.0,130000.0,-50.0,-52.0,-50.0,-45.0,-50.0,-51.0,-49.0,-44.0,-87.0,-87.0,-83.0,-83.0,37.0,35.0,33.0,38.0,1
4554,3C:55:76:E8:8F:1F,3871977,571693228,35903,87878936,3836074,483814292,20,17542,4216473,17273,4167342,269,49131,8303,22,35947,3324,20,178,73120.0,1000.0,-47.0,-53.0,-53.0,-43.0,-45.0,-54.0,-51.0,-41.0,-87.0,-87.0,-83.0,-83.0,40.0,34.0,30.0,40.0,1
4555,92:69:1D:31:68:E9,3840002,487440828,3928,3626536,3836074,483814292,0,4811,1107395,4668,1075025,143,32370,2126,10,4133,87,0,44,229410.0,130000.0,-51.0,-47.0,-42.0,-49.0,-51.0,-47.0,-43.0,-47.0,-87.0,-87.0,-83.0,-83.0,36.0,40.0,41.0,34.0,1
4556,CC:2F:71:3F:1F:24,4631196,1337627406,795122,853813114,3836074,483814292,37,642206,668906319,641482,668819219,724,87100,619286,15,795379,87265,34,518,130000.0,43333.0,-69.0,-66.0,-67.0,-70.0,-69.0,-66.0,-67.0,-69.0,-87.0,-87.0,-83.0,-83.0,18.0,21.0,16.0,13.0,1
4557,CC:2F:71:3E:C5:1F,3836953,483921671,879,107379,3836074,483814292,0,3666,307855,3025,231773,641,76082,929,9,1263,20,0,40,130000.0,39000.0,-72.0,-74.0,-69.0,-61.0,-71.0,-72.0,-69.0,-60.0,-87.0,-87.0,-83.0,-83.0,15.0,13.0,14.0,22.0,1
4558,BA:8C:B9:54:50:24,3840912,489997289,4838,6182997,3836074,483814292,0,9016,1700891,8994,1697396,22,3495,2348,15,5278,39,0,58,216660.0,130000.0,-39.0,-36.0,-46.0,-52.0,-43.0,-35.0,-44.0,-49.0,-87.0,-87.0,-83.0,-83.0,48.0,51.0,37.0,31.0,1
4559,62:47:05:9D:EB:15,3836125,483824735,47,10039,3836078,483814696,0,107,12499,96,10333,11,2166,38,0,68,0,0,4,216660.0,130000.0,-50.0,-52.0,-50.0,-45.0,-50.0,-51.0,-49.0,-44.0,-87.0,-87.0,-83.0,-83.0,37.0,35.0,33.0,38.0,1
4560,3C:55:76:E8:8F:1F,3871983,571694581,35905,87879885,3836078,483814696,20,17551,4225255,17282,4176124,269,49131,8307,22,35947,3324,20,181,73120.0,1000.0,-48.0,-53.0,-49.0,-42.0,-46.0,-54.0,-50.0,-41.0,-87.0,-87.0,-83.0,-83.0,39.0,34.0,34.0,41.0,1
4561,92:69:1D:31:68:E9,3840008,487441434,3928,3626536,3836080,483814898,0,4811,1107395,4668,1075025,143,32370,2126,10,4133,87,0,44,229410.0,130000.0,-51.0,-47.0,-42.0,-49.0,-51.0,-47.0,-43.0,-47.0,-87.0,-87.0,-83.0,-83.0,36.0,40.0,41.0,34.0,1
4562,CC:2F:71:3F:1F:24,4631414,1337892886,795334,854077988,3836080,483814898,37,642418,669183891,641694,669096791,724,87100,619475,15,795591,87275,34,518,130000.0,43333.0,-70.0,-67.0,-68.0,-70.0,-69.0,-66.0,-67.0,-69.0,-87.0,-87.0,-83.0,-83.0,17.0,20.0,15.0,13.0,1
4563,CC:2F:71:3E:C5:1F,3836959,483922277,879,107379,3836080,483814898,0,3666,307855,3025,231773,641,76082,929,9,1263,20,0,40,130000.0,39000.0,-72.0,-74.0,-69.0,-61.0,-71.0,-72.0,-69.0,-60.0,-87.0,-87.0,-83.0,-83.0,15.0,13.0,14.0,22.0,1
4564,BA:8C:B9:54:50:24,3840918,489997895,4838,6182997,3836080,483814898,0,9016,1700891,8994,1697396,22,3495,2348,15,5278,39,0,58,216660.0,130000.0,-39.0,-36.0,-46.0,-52.0,-43.0,-35.0,-44.0,-49.0,-87.0,-87.0,-83.0,-83.0,48.0,51.0,37.0,31.0,1
4565,62:47:05:9D:EB:15,3836129,483825139,47,10039,3836082,483815100,0,107,12499,96,10333,11,2166,38,0,68,0,0,4,216660.0,130000.0,-50.0,-52.0,-50.0,-45.0,-50.0,-51.0,-49.0,-44.0,-87.0,-87.0,-84.0,-83.0,37.0,35.0,34.0,38.0,1
4566,3C:55:76:E8:8F:1F,3871989,571695178,35906,87880018,3836083,483815160,20,17557,4225663,17288,4176532,269,49131,8307,22,35950,3339,20,182,65000.0,1000.0,-44.0,-53.0,-48.0,-39.0,-45.0,-54.0,-49.0,-40.0,-87.0,-87.0,-84.0,-83.0,43.0,34.0,36.0,44.0,1
4567,92:69:1D:31:68:E9,3840011,487441696,3928,3626536,3836083,483815160,0,4811,1107395,4668,1075025,143,32370,2126,10,4133,87,0,44,229410.0,130000.0,-51.0,-47.0,-42.0,-49.0,-51.0,-47.0,-43.0,-47.0,-87.0,-87.0,-84.0,-83.0,36.0,40.0,42.0,34.0,1
4568,CC:2F:71:3F:1F:24,4631629,1338156634,795544,854341272,3836085,483815362,37,642612,669440649,641888,669353549,724,87100,619660,15,795801,87277,34,518,130000.0,43333.0,-69.0,-66.0,-67.0,-70.0,-69.0,-66.0,-67.0,-70.0,-87.0,-87.0,-84.0,-83.0,18.0,21.0,17.0,13.0,1
4569,CC:2F:71:3E:C5:1F,3836964,483922741,879,107379,3836085,483815362,0,3666,307855,3025,231773,641,76082,929,9,1263,20,0,40,130000.0,39000.0,-72.0,-74.0,-69.0,-61.0,-71.0,-72.0,-69.0,-60.0,-87.0,-87.0,-84.0,-83.0,15.0,13.0,15.0,22.0,1
4570,BA:8C:B9:54:50:24,3840923,489998359,4838,6182997,3836085,483815362,0,9016,1700891,8994,1697396,22,3495,2348,15,5278,39,0,58,216660.0,130000.0,-39.0,-36.0,-46.0,-52.0,-43.0,-35.0,-44.0,-49.0,-87.0,-87.0,-84.0,-83.0,48.0,51.0,38.0,31.0,1
4571,62:47:05:9D:EB:15,3836135,483825737,47,10039,3836088,483815698,0,107,12499,96,10333,11,2166,38,0,68,0,0,4,216660.0,130000.0,-50.0,-52.0,-50.0,-45.0,-50.0,-51.0,-49.0,-44.0,-87.0,-87.0,-84.0,-83.0,37.0,35.0,34.0,38.0,1
4572,3C:55:76:E8:8F:1F,3871995,571695784,35906,87880018,3836089,483815766,20,17557,4225663,17288,4176532,269,49131,8307,22,35950,3339,20,182,65000.0,1000.0,-44.0,-53.0,-48.0,-39.0,-45.0,-54.0,-49.0,-40.0,-87.0,-87.0,-84.0,-83.0,43.0,34.0,36.0,44.0,1
4573,92:69:1D:31:68:E9,3840017,487442302,3928,3626536,3836089,483815766,0,4811,1107395,4668,1075025,143,32370,2126,10,4133,87,0,44,229410.0,130000.0,-51.0,-47.0,-42.0,-49.0,-51.0,-47.0,-43.0,-47.0,-87.0,-87.0,-84.0,-83.0,36.0,40.0,42.0,34.0,1
4574,CC:2F:71:3F:1F:24,4631849,1338423327,795760,854607561,3836089,483815766,37,642812,669698500,642088,669611400,724,87100,619852,15,796017,87288,34,518,117000.0,39000.0,-69.0,-66.0,-67.0,-70.0,-69.0,-66.0,-67.0,-69.0,-87.0,-87.0,-84.0,-83.0,18.0,21.0,17.0,13.0,1
4575,CC:2F:71:3E:C5:1F,3836968,483923145,879,107379,3836089,483815766,0,3666,307855,3025,231773,641,76082,929,9,1263,20,0,40,130000.0,39000.0,-72.0,-74.0,-69.0,-61.0,-71.0,-72.0,-69.0,-60.0,-87.0,-87.0,-84.0,-83.0,15.0,13.0,15.0,22.0,1
4576,BA:8C:B9:54:50:24,3840930,489999027,4838,6182997,3836092,483816030,0,9016,1700891,8994,1697396,22,3495,2348,15,5278,39,0,58,216660.0,130000.0,-39.0,-36.0,-46.0,-52.0,-43.0,-35.0,-44.0,-49.0,-87.0,-87.0,-84.0,-83.0,48.0,51.0,38.0,31.0,1
4577,62:47:05:9D:EB:15,3836141,483826271,47,10039,3836094,483816232,0,109,12635,98,10469,11,2166,38,0,68,0,0,4,216660.0,130000.0,-51.0,-52.0,-52.0,-45.0,-50.0,-51.0,-50.0,-44.0,-87.0,-87.0,-84.0,-83.0,36.0,35.0,32.0,38.0,1
4578,3C:55:76:E8:8F:1F,3872033,571755486,35937,87939052,3836096,483816434,21,17580,4232765,17309,4183398,271,49367,8316,24,35985,3471,21,190,32500.0,1000.0,-43.0,-53.0,-48.0,-39.0,-45.0,-54.0,-49.0,-40.0,-87.0,-87.0,-84.0,-83.0,44.0,34.0,36.0,44.0,1
4579,92:69:1D:31:68:E9,3840024,487442970,3928,3626536,3836096,483816434,0,4811,1107395,4668,1075025,143,32370,2126,10,4133,87,0,44,229410.0,130000.0,-51.0,-47.0,-42.0,-49.0,-51.0,-47.0,-43.0,-47.0,-87.0,-87.0,-84.0,-83.0,36.0,40.0,42.0,34.0,1
4580,CC:2F:71:3F:1F:24,4632091,1338727425,795995,854910991,3836096,483816434,37,643051,670027738,642327,669940638,724,87100,620061,15,796252,87291,34,518,130000.0,43333.0,-69.0,-66.0,-67.0,-70.0,-69.0,-66.0,-67.0,-69.0,-87.0,-87.0,-84.0,-83.0,18.0,21.0,17.0,13.0,1
4581,CC:2F:71:3E:C5:1F,3836976,483923873,879,107379,3836097,483816494,0,3666,307855,3025,231773,641,76082,929,9,1263,20,0,40,130000.0,39000.0,-72.0,-74.0,-69.0,-61.0,-71.0,-72.0,-69.0,-60.0,-87.0,-87.0,-84.0,-83.0,15.0,13.0,15.0,22.0,1
4582,BA:8C:B9:54:50:24,3840935,489999491,4838,6182997,3836097,483816494,0,9016,1700891,8994,1697396,22,3495,2348,15,5278,39,0,58,216660.0,130000.0,-39.0,-36.0,-46.0,-52.0,-43.0,-35.0,-44.0,-49.0,-87.0,-87.0,-84.0,-83.0,48.0,51.0,38.0,31.0,1
4583,62:47:05:9D:EB:15,3836149,483826999,47,10039,3836102,483816960,0,110,12703,99,10537,11,2166,38,0,68,0,0,4,216660.0,130000.0,-50.0,-52.0,-52.0,-45.0,-50.0,-51.0,-50.0,-45.0,-87.0,-87.0,-84.0,-83.0,37.0,35.0,32.0,38.0,1
4584,3C:55:76:E8:8F:1F,3872040,571756122,35938,87939162,3836102,483816960,21,17583,4232969,17312,4183602,271,49367,8316,24,35986,3472,21,190,32500.0,1000.0,-44.0,-54.0,-48.0,-39.0,-45.0,-54.0,-49.0,-40.0,-87.0,-87.0,-84.0,-83.0,43.0,33.0,36.0,44.0,1
4585,92:69:1D:31:68:E9,3840030,487443496,3928,3626536,3836102,483816960,0,4811,1107395,4668,1075025,143,32370,2126,10,4133,87,0,44,229410.0,130000.0,-51.0,-47.0,-42.0,-49.0,-51.0,-47.0,-43.0,-47.0,-87.0,-87.0,-84.0,-83.0,36.0,40.0,42.0,34.0,1
4586,CC:2F:71:3F:1F:24,4632325,1339018983,796223,855202023,3836102,483816960,37,643281,670333110,642556,670245892,725,87218,620268,15,796480,87297,34,518,130000.0,43333.0,-70.0,-67.0,-68.0,-70.0,-69.0,-67.0,-68.0,-70.0,-87.0,-87.0,-84.0,-83.0,17.0,20.0,16.0,13.0,1
4587,CC:2F:71:3E:C5:1F,3836981,483924339,879,107379,3836102,483816960,0,3666,307855,3025,231773,641,76082,929,9,1263,20,0,40,130000.0,39000.0,-72.0,-74.0,-69.0,-61.0,-71.0,-72.0,-69.0,-60.0,-87.0,-87.0,-84.0,-83.0,15.0,13.0,15.0,22.0,1
4588,BA:8C:B9:54:50:24,3840940,489999957,4838,6182997,3836102,483816960,0,9016,1700891,8994,1697396,22,3495,2348,15,5278,39,0,58,216660.0,130000.0,-39.0,-36.0,-46.0,-52.0,-43.0,-35.0,-44.0,-49.0,-87.0,-87.0,-84.0,-83.0,48.0,51.0,38.0,31.0,1
4589,62:47:05:9D:EB:15,3836153,483827403,47,10039,3836106,483817364,0,110,12703,99,10537,11,2166,38,0,68,0,0,4,216660.0,130000.0,-50.0,-52.0,-52.0,-45.0,-50.0,-51.0,-50.0,-45.0,-87.0,-87.0,-84.0,-83.0,37.0,35.0,32.0,38.0,1
4590,3C:55:76:E8:8F:1F,3872045,571756692,35939,87939328,3836106,483817364,21,17583,4232969,17312,4183602,271,49367,8316,24,35987,3472,21,190,32500.0,1000.0,-44.0,-54.0,-48.0,-39.0,-45.0,-54.0,-49.0,-40.0,-87.0,-87.0,-84.0,-83.0,43.0,33.0,36.0,44.0,1
4591,92:69:1D:31:68:E9,3840034,487443900,3928,3626536,3836106,483817364,0,4813,1107531,4670,1075161,143,32370,2126,10,4134,87,0,44,229410.0,130000.0,-51.0,-47.0,-42.0,-49.0,-51.0,-47.0,-42.0,-48.0,-87.0,-87.0,-84.0,-83.0,36.0,40.0,42.0,34.0,1
4592,CC:2F:71:3F:1F:24,4632540,1339282577,796434,855465213,3836106,483817364,37,643473,670589480,642748,670502262,725,87218,620453,15,796691,87300,34,518,130000.0,43333.0,-70.0,-67.0,-68.0,-70.0,-69.0,-67.0,-68.0,-70.0,-87.0,-87.0,-84.0,-83.0,17.0,20.0,16.0,13.0,1
4593,CC:2F:71:3E:C5:1F,3836985,483924743,879,107379,3836106,483817364,0,3668,307995,3027,231913,641,76082,929,9,1264,20,0,40,130000.0,39000.0,-71.0,-73.0,-69.0,-60.0,-71.0,-72.0,-69.0,-60.0,-87.0,-87.0,-84.0,-83.0,16.0,14.0,15.0,23.0,1
4594,BA:8C:B9:54:50:24,3840944,490000361,4838,6182997,3836106,483817364,0,9018,1701027,8996,1697532,22,3495,2348,15,5279,39,0,58,216660.0,130000.0,-39.0,-36.0,-45.0,-52.0,-43.0,-35.0,-44.0,-49.0,-87.0,-87.0,-84.0,-83.0,48.0,51.0,39.0,31.0,1
4595,62:47:05:9D:EB:15,3836159,483827929,47,10039,3836112,483817890,0,110,12703,99,10537,11,2166,38,0,68,0,0,4,216660.0,130000.0,-50.0,-52.0,-52.0,-45.0,-50.0,-51.0,-50.0,-45.0,-87.0,-87.0,-84.0,-83.0,37.0,35.0,32.0,38.0,1
4596,3C:55:76:E8:8F:1F,3872053,571758698,35941,87940808,3836112,483817890,21,17583,4232969,17312,4183602,271,49367,8316,24,35989,3475,21,190,24370.0,1000.0,-44.0,-54.0,-48.0,-39.0,-45.0,-54.0,-49.0,-40.0,-87.0,-87.0,-84.0,-83.0,43.0,33.0,36.0,44.0,1
4597,92:69:1D:31:68:E9,3840042,487444628,3928,3626536,3836114,483818092,0,4814,1107599,4671,1075229,143,32370,2126,10,4134,87,0,44,229410.0,130000.0,-51.0,-47.0,-42.0,-49.0,-51.0,-47.0,-42.0,-48.0,-87.0,-87.0,-84.0,-83.0,36.0,40.0,42.0,34.0,1
4598,CC:2F:71:3F:1F:24,4632761,1339543732,796647,855725640,3836114,483818092,37,643673,670844544,642948,670757326,725,87218,620643,15,796904,87304,34,518,117000.0,39000.0,-69.0,-66.0,-67.0,-69.0,-68.0,-66.0,-67.0,-69.0,-87.0,-87.0,-84.0,-83.0,18.0,21.0,17.0,14.0,1
4599,CC:2F:71:3E:C5:1F,3836993,483925471,879,107379,3836114,483818092,0,3670,308183,3028,231983,642,76200,930,9,1264,20,0,40,130000.0,39000.0,-80.0,-82.0,-76.0,-71.0,-72.0,-74.0,-70.0,-61.0,-87.0,-87.0,-84.0,-83.0,7.0,5.0,8.0,12.0,1
4600,BA:8C:B9:54:50:24,3840952,490001089,4838,6182997,3836114,483818092,0,9018,1701027,8996,1697532,22,3495,2348,15,5279,39,0,58,216660.0,130000.0,-39.0,-36.0,-45.0,-52.0,-43.0,-35.0,-44.0,-49.0,-87.0,-87.0,-84.0,-83.0,48.0,51.0,39.0,31.0,1
4601,62:47:05:9D:EB:15,3836163,483828333,47,10039,3836116,483818294,0,110,12703,99,10537,11,2166,38,0,68,0,0,4,216660.0,130000.0,-50.0,-52.0,-52.0,-45.0,-50.0,-51.0,-50.0,-45.0,-87.0,-87.0,-84.0,-83.0,37.0,35.0,32.0,38.0,1
4602,3C:55:76:E8:8F:1F,3872057,571759102,35941,87940808,3836116,483818294,21,17583,4232969,17312,4183602,271,49367,8316,24,35989,3475,21,190,24370.0,1000.0,-44.0,-54.0,-48.0,-39.0,-45.0,-54.0,-49.0,-40.0,-87.0,-87.0,-84.0,-83.0,43.0,33.0,36.0,44.0,1
4603,92:69:1D:31:68:E9,3840044,487444830,3928,3626536,3836116,483818294,0,4814,1107599,4671,1075229,143,32370,2126,10,4134,87,0,44,229410.0,130000.0,-51.0,-47.0,-42.0,-49.0,-51.0,-47.0,-42.0,-48.0,-87.0,-87.0,-84.0,-83.0,36.0,40.0,42.0,34.0,1
4604,CC:2F:71:3F:1F:24,4632972,1339804128,796856,855985834,3836116,483818294,37,643872,671103480,643147,671016262,725,87218,620827,15,797113,87304,34,519,130000.0,43333.0,-67.0,-68.0,-67.0,-72.0,-67.0,-68.0,-67.0,-71.0,-87.0,-87.0,-84.0,-83.0,20.0,19.0,17.0,11.0,1
4605,CC:2F:71:3E:C5:1F,3836995,483925673,879,107379,3836116,483818294,0,3670,308183,3028,231983,642,76200,930,9,1264,20,0,40,130000.0,39000.0,-80.0,-82.0,-76.0,-71.0,-72.0,-74.0,-70.0,-61.0,-87.0,-87.0,-84.0,-83.0,7.0,5.0,8.0,12.0,1
4606,BA:8C:B9:54:50:24,3840956,490001493,4838,6182997,3836118,483818496,0,9018,1701027,8996,1697532,22,3495,2348,15,5279,39,0,58,216660.0,130000.0,-39.0,-36.0,-45.0,-52.0,-43.0,-35.0,-44.0,-49.0,-87.0,-87.0,-84.0,-83.0,48.0,51.0,39.0,31.0,1
4607,62:47:05:9D:EB:15,3836172,483829123,47,10039,3836125,483819084,0,110,12703,99,10537,11,2166,38,0,68,0,0,4,216660.0,130000.0,-50.0,-52.0,-52.0,-45.0,-50.0,-51.0,-50.0,-45.0,-87.0,-87.0,-84.0,-83.0,37.0,35.0,32.0,38.0,1
4608,3C:55:76:E8:8F:1F,3872109,571814705,35984,87995621,3836125,483819084,21,17691,4252077,17414,4202002,277,50075,8356,24,36031,3508,21,212,17200.0,2000.0,-48.0,-55.0,-53.0,-45.0,-45.0,-53.0,-49.0,-41.0,-87.0,-87.0,-84.0,-83.0,39.0,32.0,31.0,38.0,1
4609,92:69:1D:31:68:E9,3840053,487445620,3928,3626536,3836125,483819084,0,4814,1107599,4671,1075229,143,32370,2126,10,4134,87,0,44,229410.0,130000.0,-51.0,-47.0,-42.0,-49.0,-51.0,-47.0,-42.0,-48.0,-87.0,-87.0,-84.0,-83.0,36.0,40.0,42.0,34.0,1
4610,CC:2F:71:3F:1F:24,4633199,1340077520,797072,856258234,3836127,483819286,37,644077,671371772,643352,671284554,725,87218,621020,15,797329,87311,34,519,130000.0,43333.0,-68.0,-69.0,-68.0,-70.0,-67.0,-68.0,-67.0,-69.0,-87.0,-87.0,-84.0,-83.0,19.0,18.0,16.0,13.0,1
4611,CC:2F:71:3E:C5:1F,3837006,483926665,879,107379,3836127,483819286,0,3670,308183,3028,231983,642,76200,930,9,1264,20,0,40,130000.0,39000.0,-80.0,-82.0,-76.0,-71.0,-72.0,-74.0,-70.0,-61.0,-87.0,-87.0,-84.0,-83.0,7.0,5.0,8.0,12.0,1
4612,BA:8C:B9:54:50:24,3840965,490002283,4838,6182997,3836127,483819286,0,9018,1701027,8996,1697532,22,3495,2348,15,5279,39,0,58,216660.0,130000.0,-39.0,-36.0,-45.0,-52.0,-43.0,-35.0,-44.0,-49.0,-87.0,-87.0,-84.0,-83.0,48.0,51.0,39.0,31.0,1
4613,62:47:05:9D:EB:15,3836197,483840348,47,10039,3836150,483830309,0,110,12703,99,10537,11,2166,38,0,68,0,0,4,216660.0,130000.0,-50.0,-52.0,-52.0,-45.0,-50.0,-51.0,-50.0,-45.0,-87.0,-87.0,-84.0,-83.0,37.0,35.0,32.0,38.0,1
4614,3C:55:76:E8:8F:1F,3872181,571913040,36029,88082529,3836152,483830511,21,17697,4252485,17420,4202410,277,50075,8356,24,36077,3528,21,213,24370.0,2000.0,-48.0,-57.0,-54.0,-45.0,-46.0,-54.0,-52.0,-43.0,-87.0,-87.0,-84.0,-83.0,39.0,30.0,30.0,38.0,1
4615,92:69:1D:31:68:E9,3840080,487457047,3928,3626536,3836152,483830511,0,4817,1107970,4673,1075365,144,32605,2127,10,4134,87,0,44,229410.0,130000.0,-51.0,-47.0,-42.0,-49.0,-51.0,-47.0,-43.0,-48.0,-87.0,-87.0,-84.0,-83.0,36.0,40.0,42.0,34.0,1
4616,CC:2F:71:3F:1F:24,4633442,1340355630,797290,856525119,3836152,483830511,37,644279,671627137,643554,671539919,725,87218,621215,15,797547,87313,34,519,130000.0,43333.0,-68.0,-68.0,-67.0,-70.0,-68.0,-68.0,-67.0,-70.0,-87.0,-87.0,-84.0,-83.0,19.0,19.0,17.0,13.0,1
4617,CC:2F:71:3E:C5:1F,3837033,483938092,879,107379,3836154,483830713,0,3670,308183,3028,231983,642,76200,930,9,1264,20,0,40,130000.0,39000.0,-80.0,-82.0,-76.0,-71.0,-72.0,-74.0,-70.0,-61.0,-87.0,-87.0,-84.0,-83.0,7.0,5.0,8.0,12.0,1
4618,BA:8C:B9:54:50:24,3840992,490013710,4838,6182997,3836154,483830713,0,9018,1701027,8996,1697532,22,3495,2348,15,5279,39,0,58,216660.0,130000.0,-39.0,-36.0,-45.0,-52.0,-43.0,-35.0,-44.0,-49.0,-87.0,-87.0,-84.0,-83.0,48.0,51.0,39.0,31.0,1
4619,62:47:05:9D:EB:15,3836205,483841156,47,10039,3836158,483831117,0,110,12703,99,10537,11,2166,38,0,68,0,0,4,216660.0,130000.0,-50.0,-52.0,-52.0,-45.0,-50.0,-51.0,-50.0,-45.0,-87.0,-87.0,-84.0,-83.0,37.0,35.0,32.0,38.0,1
4620,3C:55:76:E8:8F:1F,3872188,571913706,36029,88082529,3836159,483831177,21,17701,4252757,17424,4202682,277,50075,8356,24,36077,3528,21,213,24370.0,2000.0,-49.0,-57.0,-55.0,-45.0,-45.0,-54.0,-52.0,-42.0,-87.0,-87.0,-84.0,-83.0,38.0,30.0,29.0,38.0,1
4621,92:69:1D:31:68:E9,3840087,487457713,3928,3626536,3836159,483831177,0,4817,1107970,4673,1075365,144,32605,2127,10,4134,87,0,44,229410.0,130000.0,-51.0,-47.0,-42.0,-49.0,-51.0,-47.0,-43.0,-48.0,-87.0,-87.0,-84.0,-83.0,36.0,40.0,42.0,34.0,1
4622,CC:2F:71:3F:1F:24,4633659,1340619412,797500,856788235,3836159,483831177,37,644477,671888923,643752,671801705,725,87218,621400,15,797757,87325,34,519,144444.0,43333.0,-68.0,-68.0,-67.0,-70.0,-68.0,-68.0,-67.0,-69.0,-87.0,-87.0,-84.0,-83.0,19.0,19.0,17.0,13.0,1
4623,CC:2F:71:3E:C5:1F,3837038,483938556,879,107379,3836159,483831177,0,3670,308183,3028,231983,642,76200,930,9,1264,20,0,40,130000.0,39000.0,-80.0,-82.0,-76.0,-71.0,-72.0,-74.0,-70.0,-61.0,-87.0,-87.0,-84.0,-83.0,7.0,5.0,8.0,12.0,1
4624,BA:8C:B9:54:50:24,3840997,490014174,4838,6182997,3836159,483831177,0,9018,1701027,8996,1697532,22,3495,2348,15,5279,39,0,58,216660.0,130000.0,-39.0,-36.0,-45.0,-52.0,-43.0,-35.0,-44.0,-49.0,-87.0,-87.0,-84.0,-83.0,48.0,51.0,39.0,31.0,1
4625,62:47:05:9D:EB:15,3836211,483841893,47,10039,3836164,483831854,0,110,12703,99,10537,11,2166,38,0,68,0,0,4,216660.0,130000.0,-50.0,-52.0,-52.0,-45.0,-50.0,-51.0,-50.0,-45.0,-87.0,-87.0,-84.0,-83.0,37.0,35.0,32.0,38.0,1
4626,3C:55:76:E8:8F:1F,3872194,571914507,36030,88082653,3836164,483831854,21,17701,4252757,17424,4202682,277,50075,8356,24,36078,3528,21,213,24370.0,2000.0,-49.0,-57.0,-55.0,-45.0,-45.0,-54.0,-52.0,-42.0,-87.0,-87.0,-84.0,-83.0,38.0,30.0,29.0,38.0,1
4627,92:69:1D:31:68:E9,3840092,487458390,3928,3626536,3836164,483831854,0,4817,1107970,4673,1075365,144,32605,2127,10,4134,87,0,44,229410.0,130000.0,-51.0,-47.0,-42.0,-49.0,-51.0,-47.0,-43.0,-48.0,-87.0,-87.0,-84.0,-83.0,36.0,40.0,42.0,34.0,1
4628,CC:2F:71:3F:1F:24,4633875,1340886239,797711,857054385,3836164,483831854,37,644670,672148411,643945,672061193,725,87218,621586,15,797968,87340,34,520,130000.0,43333.0,-69.0,-67.0,-66.0,-70.0,-69.0,-67.0,-66.0,-70.0,-87.0,-87.0,-84.0,-83.0,18.0,20.0,18.0,13.0,1
4629,CC:2F:71:3E:C5:1F,3837043,483939233,879,107379,3836164,483831854,0,3670,308183,3028,231983,642,76200,930,9,1264,20,0,40,130000.0,39000.0,-80.0,-82.0,-76.0,-71.0,-72.0,-74.0,-70.0,-61.0,-87.0,-87.0,-84.0,-83.0,7.0,5.0,8.0,12.0,1
4630,BA:8C:B9:54:50:24,3841004,490015053,4838,6182997,3836166,483832056,0,9018,1701027,8996,1697532,22,3495,2348,15,5279,39,0,58,216660.0,130000.0,-39.0,-36.0,-45.0,-52.0,-43.0,-35.0,-44.0,-49.0,-87.0,-87.0,-84.0,-83.0,48.0,51.0,39.0,31.0,1
4631,62:47:05:9D:EB:15,3836215,483842297,47,10039,3836168,483832258,0,110,12703,99,10537,11,2166,38,0,68,0,0,4,216660.0,130000.0,-50.0,-52.0,-52.0,-45.0,-50.0,-51.0,-50.0,-45.0,-87.0,-87.0,-84.0,-83.0,37.0,35.0,32.0,38.0,1
4632,3C:55:76:E8:8F:1F,3872203,571917578,36035,88085320,3836168,483832258,21,17741,4258066,17464,4207991,277,50075,8382,24,36083,3528,21,213,24370.0,2000.0,-50.0,-54.0,-50.0,-46.0,-46.0,-54.0,-52.0,-42.0,-87.0,-87.0,-84.0,-83.0,37.0,33.0,34.0,37.0,1
4633,92:69:1D:31:68:E9,3840096,487458794,3928,3626536,3836168,483832258,0,4817,1107970,4673,1075365,144,32605,2127,10,4134,87,0,44,229410.0,130000.0,-51.0,-47.0,-42.0,-49.0,-51.0,-47.0,-43.0,-48.0,-87.0,-87.0,-84.0,-83.0,36.0,40.0,42.0,34.0,1
4634,CC:2F:71:3F:1F:24,4634101,1341168271,797933,857336013,3836168,483832258,37,644887,672437751,644162,672350533,725,87218,621787,15,798190,87353,34,521,130000.0,43333.0,-69.0,-67.0,-66.0,-70.0,-69.0,-67.0,-66.0,-70.0,-87.0,-87.0,-84.0,-83.0,18.0,20.0,18.0,13.0,1
4635,CC:2F:71:3E:C5:1F,3837047,483939637,879,107379,3836168,483832258,0,3670,308183,3028,231983,642,76200,930,9,1264,20,0,40,130000.0,39000.0,-80.0,-82.0,-76.0,-71.0,-72.0,-74.0,-70.0,-61.0,-87.0,-87.0,-84.0,-83.0,7.0,5.0,8.0,12.0,1
4636,BA:8C:B9:54:50:24,3841007,490015315,4838,6182997,3836169,483832318,0,9018,1701027,8996,1697532,22,3495,2348,15,5279,39,0,58,216660.0,130000.0,-39.0,-36.0,-45.0,-52.0,-43.0,-35.0,-44.0,-49.0,-87.0,-87.0,-84.0,-83.0,48.0,51.0,39.0,31.0,1
4637,62:47:05:9D:EB:15,3836224,483843331,47,10039,3836177,483833292,0,110,12703,99,10537,11,2166,38,0,68,0,0,4,216660.0,130000.0,-50.0,-52.0,-52.0,-45.0,-50.0,-51.0,-50.0,-45.0,-87.0,-87.0,-84.0,-83.0,37.0,35.0,32.0,38.0,1
4638,3C:55:76:E8:8F:1F,3872212,571918612,36035,88085320,3836177,483833292,21,17741,4258066,17464,4207991,277,50075,8382,24,36083,3528,21,213,24370.0,2000.0,-50.0,-54.0,-50.0,-46.0,-46.0,-54.0,-52.0,-42.0,-87.0,-87.0,-84.0,-83.0,37.0,33.0,34.0,37.0,1
4639,92:69:1D:31:68:E9,3840105,487459828,3928,3626536,3836177,483833292,0,4817,1107970,4673,1075365,144,32605,2127,10,4134,87,0,44,229410.0,130000.0,-51.0,-47.0,-42.0,-49.0,-51.0,-47.0,-43.0,-48.0,-87.0,-87.0,-84.0,-83.0,36.0,40.0,42.0,34.0,1
4640,CC:2F:71:3F:1F:24,4634334,1341448154,798157,857614862,3836177,483833292,37,645098,672712613,644373,672625395,725,87218,621987,15,798414,87358,34,521,130000.0,43333.0,-69.0,-67.0,-66.0,-70.0,-69.0,-67.0,-66.0,-70.0,-87.0,-87.0,-84.0,-83.0,18.0,20.0,18.0,13.0,1
4641,CC:2F:71:3E:C5:1F,3837056,483940671,879,107379,3836177,483833292,0,3670,308183,3028,231983,642,76200,930,9,1264,20,0,40,130000.0,39000.0,-80.0,-82.0,-76.0,-71.0,-72.0,-74.0,-70.0,-61.0,-87.0,-87.0,-84.0,-83.0,7.0,5.0,8.0,12.0,1
4642,BA:8C:B9:54:50:24,3841017,490016491,4838,6182997,3836179,483833494,0,9018,1701027,8996,1697532,22,3495,2348,15,5279,39,0,58,216660.0,130000.0,-39.0,-36.0,-45.0,-52.0,-43.0,-35.0,-44.0,-49.0,-87.0,-87.0,-84.0,-83.0,48.0,51.0,39.0,31.0,1
4643,62:47:05:9D:EB:15,3836226,483843533,47,10039,3836179,483833494,0,110,12703,99,10537,11,2166,38,0,68,0,0,4,216660.0,130000.0,-50.0,-52.0,-52.0,-45.0,-50.0,-51.0,-50.0,-45.0,-87.0,-87.0,-84.0,-83.0,37.0,35.0,32.0,38.0,1
4644,3C:55:76:E8:8F:1F,3872232,571939404,36053,88105910,3836179,483833494,21,17823,4288724,17546,4238649,277,50075,8393,24,36101,3537,21,213,25800.0,2000.0,-42.0,-51.0,-49.0,-38.0,-44.0,-53.0,-50.0,-41.0,-87.0,-87.0,-84.0,-83.0,45.0,36.0,35.0,45.0,1
4645,92:69:1D:31:68:E9,3840107,487460030,3928,3626536,3836179,483833494,0,4817,1107970,4673,1075365,144,32605,2127,10,4134,87,0,44,229410.0,130000.0,-51.0,-47.0,-42.0,-49.0,-51.0,-47.0,-43.0,-48.0,-87.0,-87.0,-84.0,-83.0,36.0,40.0,42.0,34.0,1
4646,CC:2F:71:3F:1F:24,4634543,1341708178,798364,857874684,3836179,483833494,37,645294,672962423,644569,672875205,725,87218,622176,15,798621,87361,34,521,130000.0,43333.0,-69.0,-67.0,-66.0,-70.0,-69.0,-67.0,-66.0,-70.0,-87.0,-87.0,-84.0,-83.0,18.0,20.0,18.0,13.0,1
4647,CC:2F:71:3E:C5:1F,3837060,483941075,879,107379,3836181,483833696,0,3670,308183,3028,231983,642,76200,930,9,1264,20,0,40,130000.0,39000.0,-80.0,-82.0,-76.0,-71.0,-72.0,-74.0,-70.0,-61.0,-87.0,-87.0,-84.0,-83.0,7.0,5.0,8.0,12.0,1
4648,BA:8C:B9:54:50:24,3841021,490016895,4838,6182997,3836183,483833898,0,9018,1701027,8996,1697532,22,3495,2348,15,5279,39,0,58,216660.0,130000.0,-39.0,-36.0,-45.0,-52.0,-43.0,-35.0,-44.0,-49.0,-87.0,-87.0,-84.0,-83.0,48.0,51.0,39.0,31.0,1
4649,62:47:05:9D:EB:15,3836233,483844199,47,10039,3836186,483834160,0,110,12703,99,10537,11,2166,38,0,68,0,0,4,216660.0,130000.0,-50.0,-52.0,-52.0,-45.0,-50.0,-51.0,-50.0,-45.0,-87.0,-87.0,-84.0,-83.0,37.0,35.0,32.0,38.0,1
4650,3C:55:76:E8:8F:1F,3872289,572004523,36101,88170161,3836188,483834362,21,17855,4298124,17578,4248049,277,50075,8410,24,36149,3582,21,213,24370.0,1000.0,-48.0,-57.0,-55.0,-45.0,-44.0,-53.0,-51.0,-40.0,-87.0,-87.0,-84.0,-83.0,39.0,30.0,29.0,38.0,1
4651,92:69:1D:31:68:E9,3840116,487460898,3928,3626536,3836188,483834362,0,4817,1107970,4673,1075365,144,32605,2127,10,4134,87,0,44,229410.0,130000.0,-51.0,-47.0,-42.0,-49.0,-51.0,-47.0,-43.0,-48.0,-87.0,-87.0,-84.0,-83.0,36.0,40.0,42.0,34.0,1
4652,CC:2F:71:3F:1F:24,4634768,1341981654,798580,858147292,3836188,483834362,37,645494,673226937,644769,673139719,725,87218,622369,15,798837,87362,34,521,130000.0,43333.0,-69.0,-67.0,-66.0,-71.0,-69.0,-66.0,-65.0,-70.0,-87.0,-87.0,-84.0,-83.0,18.0,20.0,18.0,12.0,1
4653,CC:2F:71:3E:C5:1F,3837067,483941741,879,107379,3836188,483834362,0,3670,308183,3028,231983,642,76200,930,9,1264,20,0,40,130000.0,39000.0,-80.0,-82.0,-76.0,-71.0,-72.0,-74.0,-70.0,-61.0,-87.0,-87.0,-84.0,-83.0,7.0,5.0,8.0,12.0,1
4654,BA:8C:B9:54:50:24,3841026,490017359,4838,6182997,3836188,483834362,0,9018,1701027,8996,1697532,22,3495,2348,15,5279,39,0,58,216660.0,130000.0,-39.0,-36.0,-45.0,-52.0,-43.0,-35.0,-44.0,-49.0,-87.0,-87.0,-84.0,-83.0,48.0,51.0,39.0,31.0,1
4655,62:47:05:9D:EB:15,3836237,483844603,47,10039,3836190,483834564,0,110,12703,99,10537,11,2166,38,0,68,0,0,4,216660.0,130000.0,-50.0,-52.0,-52.0,-45.0,-50.0,-51.0,-50.0,-45.0,-87.0,-87.0,-84.0,-83.0,37.0,35.0,32.0,38.0,1
4656,3C:55:76:E8:8F:1F,3872295,572006997,36105,88172433,3836190,483834564,21,17862,4298602,17585,4248527,277,50075,8410,24,36153,3585,21,214,24370.0,2000.0,-49.0,-57.0,-56.0,-46.0,-46.0,-55.0,-53.0,-42.0,-87.0,-87.0,-84.0,-83.0,38.0,30.0,28.0,37.0,1
4657,92:69:1D:31:68:E9,3840120,487461302,3928,3626536,3836192,483834766,0,4817,1107970,4673,1075365,144,32605,2127,10,4134,87,0,44,229410.0,130000.0,-51.0,-47.0,-42.0,-49.0,-51.0,-47.0,-43.0,-48.0,-87.0,-87.0,-84.0,-83.0,36.0,40.0,42.0,34.0,1
4658,CC:2F:71:3F:1F:24,4634987,1342248089,798795,858413323,3836192,483834766,37,645695,673484857,644970,673397639,725,87218,622562,15,799052,87379,34,521,130000.0,43333.0,-69.0,-67.0,-66.0,-70.0,-69.0,-67.0,-65.0,-70.0,-87.0,-87.0,-84.0,-83.0,18.0,20.0,18.0,13.0,1
4659,CC:2F:71:3E:C5:1F,3837071,483942145,879,107379,3836192,483834766,0,3670,308183,3028,231983,642,76200,930,9,1264,20,0,40,130000.0,39000.0,-80.0,-82.0,-76.0,-71.0,-72.0,-74.0,-70.0,-61.0,-87.0,-87.0,-84.0,-83.0,7.0,5.0,8.0,12.0,1
4660,BA:8C:B9:54:50:24,3841030,490017763,4838,6182997,3836192,483834766,0,9018,1701027,8996,1697532,22,3495,2348,15,5279,39,0,58,216660.0,130000.0,-39.0,-36.0,-45.0,-52.0,-43.0,-35.0,-44.0,-49.0,-87.0,-87.0,-84.0,-83.0,48.0,51.0,39.0,31.0,1
4661,62:47:05:9D:EB:15,3836244,483845269,47,10039,3836197,483835230,0,110,12703,99,10537,11,2166,38,0,68,0,0,4,216660.0,130000.0,-50.0,-52.0,-52.0,-45.0,-50.0,-51.0,-50.0,-45.0,-87.0,-87.0,-84.0,-83.0,37.0,35.0,32.0,38.0,1
4662,3C:55:76:E8:8F:1F,3872341,572065036,36144,88229806,3836197,483835230,21,17923,4314089,17646,4264014,277,50075,8443,24,36191,3630,21,214,25800.0,1000.0,-49.0,-53.0,-50.0,-45.0,-46.0,-54.0,-52.0,-42.0,-87.0,-87.0,-84.0,-83.0,38.0,34.0,34.0,38.0,1
4663,92:69:1D:31:68:E9,3840125,487461766,3928,3626536,3836197,483835230,0,4817,1107970,4673,1075365,144,32605,2127,10,4134,87,0,44,229410.0,130000.0,-51.0,-47.0,-42.0,-49.0,-51.0,-47.0,-43.0,-48.0,-87.0,-87.0,-84.0,-83.0,36.0,40.0,42.0,34.0,1
4664,CC:2F:71:3F:1F:24,4635215,1342530631,799018,858695401,3836197,483835230,37,645904,673764985,645179,673677767,725,87218,622758,15,799275,87385,34,521,130000.0,43333.0,-72.0,-71.0,-70.0,-72.0,-70.0,-69.0,-68.0,-71.0,-87.0,-87.0,-84.0,-83.0,15.0,16.0,14.0,11.0,1
4665,CC:2F:71:3E:C5:1F,3837076,483942609,879,107379,3836197,483835230,0,3670,308183,3028,231983,642,76200,930,9,1264,20,0,40,130000.0,39000.0,-80.0,-82.0,-76.0,-71.0,-72.0,-74.0,-70.0,-61.0,-87.0,-87.0,-84.0,-83.0,7.0,5.0,8.0,12.0,1
4666,BA:8C:B9:54:50:24,3841035,490018227,4838,6182997,3836197,483835230,0,9018,1701027,8996,1697532,22,3495,2348,15,5279,39,0,58,216660.0,130000.0,-39.0,-36.0,-45.0,-52.0,-43.0,-35.0,-44.0,-49.0,-87.0,-87.0,-84.0,-83.0,48.0,51.0,39.0,31.0,1
4667,62:47:05:9D:EB:15,3836248,483845673,47,10039,3836201,483835634,0,110,12703,99,10537,11,2166,38,0,68,0,0,4,216660.0,130000.0,-50.0,-52.0,-52.0,-45.0,-50.0,-51.0,-50.0,-45.0,-87.0,-87.0,-84.0,-83.0,37.0,35.0,32.0,38.0,1
4668,3C:55:76:E8:8F:1F,3872407,572166144,36206,88330510,3836201,483835634,21,18060,4350339,17783,4300264,277,50075,8457,25,36248,3716,21,214,32500.0,1000.0,-48.0,-57.0,-55.0,-45.0,-47.0,-54.0,-51.0,-43.0,-87.0,-87.0,-84.0,-83.0,39.0,30.0,29.0,38.0,1
4669,92:69:1D:31:68:E9,3840131,487462372,3928,3626536,3836203,483835836,0,4819,1108106,4675,1075501,144,32605,2127,10,4134,87,0,44,229410.0,130000.0,-51.0,-49.0,-45.0,-49.0,-51.0,-47.0,-43.0,-48.0,-87.0,-87.0,-84.0,-83.0,36.0,38.0,39.0,34.0,1
4670,CC:2F:71:3F:1F:24,4635433,1342797293,799230,858961457,3836203,483835836,37,646099,674021893,645374,673934675,725,87218,622945,15,799487,87394,34,521,130000.0,43333.0,-67.0,-67.0,-66.0,-69.0,-67.0,-67.0,-66.0,-69.0,-87.0,-87.0,-84.0,-83.0,20.0,20.0,18.0,14.0,1
4671,CC:2F:71:3E:C5:1F,3837082,483943215,879,107379,3836203,483835836,0,3670,308183,3028,231983,642,76200,930,9,1264,20,0,40,130000.0,39000.0,-80.0,-82.0,-76.0,-71.0,-72.0,-74.0,-70.0,-61.0,-87.0,-87.0,-84.0,-83.0,7.0,5.0,8.0,12.0,1
4672,BA:8C:B9:54:50:24,3841043,490019035,4838,6182997,3836205,483836038,0,9018,1701027,8996,1697532,22,3495,2348,15,5279,39,0,58,216660.0,130000.0,-39.0,-36.0,-45.0,-52.0,-43.0,-35.0,-44.0,-49.0,-87.0,-87.0,-84.0,-83.0,48.0,51.0,39.0,31.0,1
4673,62:47:05:9D:EB:15,3836253,483846137,47,10039,3836206,483836098,0,111,12771,100,10605,11,2166,38,0,68,0,0,4,216660.0,130000.0,-56.0,-58.0,-53.0,-66.0,-51.0,-52.0,-51.0,-47.0,-87.0,-87.0,-84.0,-83.0,31.0,29.0,31.0,17.0,1
4674,3C:55:76:E8:8F:1F,3872414,572169264,36208,88333166,3836206,483836098,21,18069,4350957,17792,4300882,277,50075,8457,25,36258,3750,21,214,24370.0,1000.0,-48.0,-57.0,-57.0,-45.0,-45.0,-53.0,-53.0,-42.0,-87.0,-87.0,-84.0,-83.0,39.0,30.0,27.0,38.0,1
4675,92:69:1D:31:68:E9,3840134,487462634,3928,3626536,3836206,483836098,0,4820,1108174,4676,1075569,144,32605,2127,10,4134,87,0,44,229410.0,130000.0,-52.0,-48.0,-45.0,-47.0,-51.0,-48.0,-43.0,-48.0,-87.0,-87.0,-84.0,-83.0,35.0,39.0,39.0,36.0,1
4676,CC:2F:71:3F:1F:24,4635672,1343101227,799466,859265129,3836206,483836098,37,646323,674322277,645598,674235059,725,87218,623156,15,799723,87416,34,521,130000.0,43333.0,-67.0,-67.0,-67.0,-69.0,-67.0,-67.0,-66.0,-69.0,-87.0,-87.0,-84.0,-83.0,20.0,20.0,17.0,14.0,1
4677,CC:2F:71:3E:C5:1F,3837087,483943679,879,107379,3836208,483836300,0,3670,308183,3028,231983,642,76200,930,9,1264,20,0,40,130000.0,39000.0,-80.0,-82.0,-76.0,-71.0,-72.0,-74.0,-70.0,-61.0,-87.0,-87.0,-84.0,-83.0,7.0,5.0,8.0,12.0,1
4678,BA:8C:B9:54:50:24,3841046,490019297,4838,6182997,3836208,483836300,0,9018,1701027,8996,1697532,22,3495,2348,15,5279,39,0,58,216660.0,130000.0,-39.0,-36.0,-45.0,-52.0,-43.0,-35.0,-44.0,-49.0,-87.0,-87.0,-84.0,-83.0,48.0,51.0,39.0,31.0,1
4679,62:47:05:9D:EB:15,3836260,483846859,48,10155,3836212,483836704,0,113,12907,102,10741,11,2166,38,0,69,0,0,4,216660.0,130000.0,-58.0,-57.0,-54.0,-64.0,-52.0,-53.0,-51.0,-49.0,-87.0,-87.0,-84.0,-83.0,29.0,30.0,30.0,19.0,1
4680,3C:55:76:E8:8F:1F,3872423,572170132,36209,88333226,3836214,483836906,21,18069,4350957,17792,4300882,277,50075,8457,25,36259,3750,21,214,24370.0,2000.0,-48.0,-57.0,-57.0,-45.0,-45.0,-53.0,-53.0,-42.0,-87.0,-87.0,-84.0,-83.0,39.0,30.0,27.0,38.0,1
4681,92:69:1D:31:68:E9,3840143,487463558,3929,3626652,3836214,483836906,0,4822,1108310,4678,1075705,144,32605,2127,10,4135,87,0,44,229410.0,130000.0,-51.0,-47.0,-42.0,-49.0,-51.0,-48.0,-44.0,-47.0,-87.0,-87.0,-84.0,-83.0,36.0,40.0,42.0,34.0,1
4682,CC:2F:71:3F:1F:24,4635898,1343370090,799684,859533184,3836214,483836906,37,646522,674577074,645797,674489856,725,87218,623350,15,799941,87433,34,521,130000.0,43333.0,-67.0,-67.0,-67.0,-70.0,-67.0,-67.0,-66.0,-69.0,-87.0,-87.0,-84.0,-83.0,20.0,20.0,17.0,13.0,1
4683,CC:2F:71:3E:C5:1F,3837094,483944401,880,107495,3836214,483836906,0,3672,308323,3030,232123,642,76200,930,9,1265,20,0,40,130000.0,39000.0,-71.0,-73.0,-69.0,-60.0,-72.0,-74.0,-70.0,-61.0,-87.0,-87.0,-84.0,-83.0,16.0,14.0,15.0,23.0,1
4684,BA:8C:B9:54:50:24,3841053,490020019,4839,6183113,3836214,483836906,0,9020,1701163,8998,1697668,22,3495,2348,15,5280,39,0,58,216660.0,130000.0,-40.0,-37.0,-46.0,-52.0,-41.0,-35.0,-44.0,-50.0,-87.0,-87.0,-84.0,-83.0,47.0,50.0,38.0,31.0,1
4685,62:47:05:9D:EB:15,3836264,483847263,48,10155,3836216,483837108,0,113,12907,102,10741,11,2166,38,0,69,0,0,4,216660.0,130000.0,-58.0,-57.0,-54.0,-64.0,-52.0,-53.0,-51.0,-49.0,-87.0,-87.0,-84.0,-83.0,29.0,30.0,30.0,19.0,1
4686,3C:55:76:E8:8F:1F,3872425,572170334,36209,88333226,3836216,483837108,21,18069,4350957,17792,4300882,277,50075,8457,25,36259,3750,21,214,24370.0,2000.0,-48.0,-57.0,-57.0,-45.0,-45.0,-53.0,-53.0,-42.0,-87.0,-87.0,-84.0,-83.0,39.0,30.0,27.0,38.0,1
4687,92:69:1D:31:68:E9,3840145,487463760,3929,3626652,3836216,483837108,0,4822,1108310,4678,1075705,144,32605,2127,10,4135,87,0,44,229410.0,130000.0,-51.0,-47.0,-42.0,-49.0,-51.0,-48.0,-44.0,-47.0,-87.0,-87.0,-84.0,-83.0,36.0,40.0,42.0,34.0,1
4688,CC:2F:71:3F:1F:24,4636112,1343634962,799894,859797652,3836218,483837310,37,646721,674840260,645996,674753042,725,87218,623536,15,800150,87450,34,521,130000.0,43333.0,-68.0,-67.0,-66.0,-69.0,-67.0,-67.0,-66.0,-69.0,-87.0,-87.0,-84.0,-83.0,19.0,20.0,18.0,14.0,1
4689,CC:2F:71:3E:C5:1F,3837099,483944865,880,107495,3836219,483837370,0,3672,308323,3030,232123,642,76200,930,9,1265,20,0,40,130000.0,39000.0,-71.0,-73.0,-69.0,-60.0,-72.0,-74.0,-70.0,-61.0,-87.0,-87.0,-84.0,-83.0,16.0,14.0,15.0,23.0,1
4690,BA:8C:B9:54:50:24,3841058,490020483,4839,6183113,3836219,483837370,0,9020,1701163,8998,1697668,22,3495,2348,15,5280,39,0,58,216660.0,130000.0,-40.0,-37.0,-46.0,-52.0,-41.0,-35.0,-44.0,-50.0,-87.0,-87.0,-84.0,-83.0,47.0,50.0,38.0,31.0,1
4691,62:47:05:9D:EB:15,3836272,483848202,48,10155,3836224,483838047,0,113,12907,102,10741,11,2166,38,0,69,0,0,4,216660.0,130000.0,-58.0,-57.0,-54.0,-64.0,-52.0,-53.0,-51.0,-49.0,-87.0,-87.0,-84.0,-83.0,29.0,30.0,30.0,19.0,1
4692,3C:55:76:E8:8F:1F,3872434,572172573,36210,88334526,3836224,483838047,21,18069,4350957,17792,4300882,277,50075,8457,25,36260,3750,21,214,24370.0,2000.0,-48.0,-57.0,-57.0,-45.0,-45.0,-53.0,-53.0,-42.0,-87.0,-87.0,-84.0,-83.0,39.0,30.0,27.0,38.0,1
4693,92:69:1D:31:68:E9,3840153,487464699,3929,3626652,3836224,483838047,0,4822,1108310,4678,1075705,144,32605,2127,10,4135,87,0,44,229410.0,130000.0,-51.0,-47.0,-42.0,-49.0,-51.0,-48.0,-44.0,-47.0,-87.0,-87.0,-84.0,-83.0,36.0,40.0,42.0,34.0,1
4694,CC:2F:71:3F:1F:24,4636345,1343926809,800121,860088762,3836224,483838047,37,646934,675127560,646209,675040342,725,87218,623741,15,800378,87453,34,521,130000.0,43333.0,-68.0,-67.0,-66.0,-70.0,-67.0,-67.0,-66.0,-69.0,-87.0,-87.0,-84.0,-83.0,19.0,20.0,18.0,13.0,1
4695,CC:2F:71:3E:C5:1F,3837104,483945542,880,107495,3836224,483838047,0,3672,308323,3030,232123,642,76200,930,9,1265,20,0,40,130000.0,39000.0,-71.0,-73.0,-69.0,-60.0,-72.0,-74.0,-70.0,-61.0,-87.0,-87.0,-84.0,-83.0,16.0,14.0,15.0,23.0,1
4696,BA:8C:B9:54:50:24,3841063,490021160,4839,6183113,3836224,483838047,0,9021,1701231,8999,1697736,22,3495,2348,15,5280,39,0,58,216660.0,130000.0,-40.0,-37.0,-45.0,-52.0,-40.0,-36.0,-45.0,-51.0,-87.0,-87.0,-84.0,-83.0,47.0,50.0,39.0,31.0,1
4697,62:47:05:9D:EB:15,3836279,483848870,48,10155,3836231,483838715,0,113,12907,102,10741,11,2166,38,0,69,0,0,4,216660.0,130000.0,-58.0,-57.0,-54.0,-64.0,-52.0,-53.0,-51.0,-49.0,-87.0,-87.0,-84.0,-83.0,29.0,30.0,30.0,19.0,1
4698,3C:55:76:E8:8F:1F,3872549,572401355,36318,88562640,3836231,483838715,21,18180,4393477,17900,4343048,280,50429,8496,25,36368,3882,21,215,16250.0,2000.0,-48.0,-53.0,-52.0,-45.0,-47.0,-53.0,-52.0,-43.0,-87.0,-87.0,-84.0,-83.0,39.0,34.0,32.0,38.0,1
4699,92:69:1D:31:68:E9,3840160,487465367,3929,3626652,3836231,483838715,0,4822,1108310,4678,1075705,144,32605,2127,10,4135,87,0,44,229410.0,130000.0,-51.0,-47.0,-42.0,-49.0,-51.0,-48.0,-44.0,-47.0,-87.0,-87.0,-84.0,-83.0,36.0,40.0,42.0,34.0,1
4700,CC:2F:71:3F:1F:24,4636593,1344228358,800361,860389581,3836232,483838777,37,647164,675427392,646439,675340174,725,87218,623961,15,800618,87495,34,521,117000.0,39000.0,-70.0,-66.0,-66.0,-71.0,-70.0,-66.0,-66.0,-71.0,-87.0,-87.0,-84.0,-83.0,17.0,21.0,18.0,12.0,1
4701,CC:2F:71:3E:C5:1F,3837112,483946272,880,107495,3836232,483838777,0,3674,308511,3031,232193,643,76318,931,9,1265,20,0,40,130000.0,39000.0,-72.0,-72.0,-70.0,-61.0,-72.0,-73.0,-70.0,-61.0,-87.0,-87.0,-84.0,-83.0,15.0,15.0,14.0,22.0,1
4702,BA:8C:B9:54:50:24,3841074,490022152,4839,6183113,3836235,483839039,0,9021,1701231,8999,1697736,22,3495,2348,15,5280,39,0,58,216660.0,130000.0,-40.0,-37.0,-45.0,-52.0,-40.0,-36.0,-45.0,-51.0,-87.0,-87.0,-84.0,-83.0,47.0,50.0,39.0,31.0,1
4703,62:47:05:9D:EB:15,3836283,483849194,48,10155,3836235,483839039,0,117,13179,106,11013,11,2166,38,0,69,0,0,4,216660.0,130000.0,-59.0,-56.0,-54.0,-65.0,-53.0,-52.0,-51.0,-52.0,-87.0,-87.0,-84.0,-83.0,28.0,31.0,30.0,18.0,1
4704,3C:55:76:E8:8F:1F,3872601,572519047,36366,88680008,3836235,483839039,21,18243,4413070,17962,4362523,281,50547,8508,25,36416,3898,21,215,17200.0,2000.0,-44.0,-53.0,-51.0,-40.0,-47.0,-53.0,-51.0,-43.0,-87.0,-87.0,-84.0,-83.0,43.0,34.0,33.0,43.0,1
4705,92:69:1D:31:68:E9,3840164,487465691,3929,3626652,3836235,483839039,0,4822,1108310,4678,1075705,144,32605,2127,10,4135,87,0,44,229410.0,130000.0,-51.0,-47.0,-42.0,-49.0,-51.0,-48.0,-44.0,-47.0,-87.0,-87.0,-84.0,-83.0,36.0,40.0,42.0,34.0,1
4706,CC:2F:71:3F:1F:24,4637043,1344764935,800806,860925694,3836237,483839241,37,647466,675704827,646741,675617609,725,87218,624259,15,801063,87521,34,521,130000.0,43333.0,-69.0,-67.0,-67.0,-72.0,-69.0,-67.0,-66.0,-70.0,-87.0,-87.0,-84.0,-83.0,18.0,20.0,17.0,11.0,1
4707,CC:2F:71:3E:C5:1F,3837117,483946736,880,107495,3836237,483839241,0,3674,308511,3031,232193,643,76318,931,9,1265,20,0,40,130000.0,39000.0,-72.0,-72.0,-70.0,-61.0,-72.0,-73.0,-70.0,-61.0,-87.0,-87.0,-84.0,-83.0,15.0,15.0,14.0,22.0,1
4708,BA:8C:B9:54:50:24,3841076,490022354,4839,6183113,3836237,483839241,0,9021,1701231,8999,1697736,22,3495,2348,15,5280,39,0,58,216660.0,130000.0,-40.0,-37.0,-45.0,-52.0,-40.0,-36.0,-45.0,-51.0,-87.0,-87.0,-84.0,-83.0,47.0,50.0,39.0,31.0,1
4709,62:47:05:9D:EB:15,3836289,483849800,48,10155,3836241,483839645,0,117,13179,106,11013,11,2166,38,0,69,0,0,4,216660.0,130000.0,-59.0,-56.0,-54.0,-65.0,-53.0,-52.0,-51.0,-52.0,-87.0,-87.0,-84.0,-83.0,28.0,31.0,30.0,18.0,1
4710,3C:55:76:E8:8F:1F,3872609,572521133,36368,88681488,3836241,483839645,21,18243,4413070,17962,4362523,281,50547,8508,25,36418,3898,21,215,17200.0,2000.0,-44.0,-53.0,-51.0,-40.0,-47.0,-53.0,-51.0,-43.0,-87.0,-87.0,-84.0,-83.0,43.0,34.0,33.0,43.0,1
4711,92:69:1D:31:68:E9,3840170,487466297,3929,3626652,3836241,483839645,0,4822,1108310,4678,1075705,144,32605,2127,10,4135,87,0,44,229410.0,130000.0,-51.0,-47.0,-42.0,-49.0,-51.0,-48.0,-44.0,-47.0,-87.0,-87.0,-84.0,-83.0,36.0,40.0,42.0,34.0,1
4712,CC:2F:71:3F:1F:24,4637659,1345528372,801416,861688525,3836243,483839847,37,647842,675984798,647117,675897580,725,87218,624631,15,801671,87563,34,521,130000.0,43333.0,-69.0,-67.0,-67.0,-71.0,-69.0,-67.0,-66.0,-71.0,-87.0,-87.0,-84.0,-83.0,18.0,20.0,17.0,12.0,1
4713,CC:2F:71:3E:C5:1F,3837123,483947342,880,107495,3836243,483839847,0,3674,308511,3031,232193,643,76318,931,9,1265,20,0,40,130000.0,39000.0,-72.0,-72.0,-70.0,-61.0,-72.0,-73.0,-70.0,-61.0,-87.0,-87.0,-84.0,-83.0,15.0,15.0,14.0,22.0,1
4714,BA:8C:B9:54:50:24,3841082,490022960,4839,6183113,3836243,483839847,0,9021,1701231,8999,1697736,22,3495,2348,15,5280,39,0,58,216660.0,130000.0,-40.0,-37.0,-45.0,-52.0,-40.0,-36.0,-45.0,-51.0,-87.0,-87.0,-84.0,-83.0,47.0,50.0,39.0,31.0,1
4715,62:47:05:9D:EB:15,3836294,483850264,48,10155,3836246,483840109,0,117,13179,106,11013,11,2166,38,0,69,0,0,4,216660.0,130000.0,-59.0,-56.0,-54.0,-65.0,-53.0,-52.0,-51.0,-52.0,-87.0,-87.0,-84.0,-83.0,28.0,31.0,30.0,18.0,1
4716,3C:55:76:E8:8F:1F,3872614,572521597,36368,88681488,3836246,483840109,21,18243,4413070,17962,4362523,281,50547,8508,25,36418,3898,21,215,17200.0,2000.0,-44.0,-53.0,-51.0,-40.0,-47.0,-53.0,-51.0,-43.0,-87.0,-87.0,-84.0,-83.0,43.0,34.0,33.0,43.0,1
4717,92:69:1D:31:68:E9,3840175,487466761,3929,3626652,3836246,483840109,0,4822,1108310,4678,1075705,144,32605,2127,10,4135,87,0,44,229410.0,130000.0,-51.0,-47.0,-42.0,-49.0,-51.0,-48.0,-44.0,-47.0,-87.0,-87.0,-84.0,-83.0,36.0,40.0,42.0,34.0,1
4718,CC:2F:71:3F:1F:24,4638286,1346301962,802038,862461651,3836248,483840311,37,648260,676275149,647535,676187931,725,87218,625024,15,802294,87571,34,521,130000.0,43333.0,-69.0,-67.0,-67.0,-67.0,-69.0,-67.0,-66.0,-70.0,-87.0,-87.0,-84.0,-83.0,18.0,20.0,17.0,16.0,1
4719,CC:2F:71:3E:C5:1F,3837128,483947806,880,107495,3836248,483840311,0,3674,308511,3031,232193,643,76318,931,9,1265,20,0,40,130000.0,39000.0,-72.0,-72.0,-70.0,-61.0,-72.0,-73.0,-70.0,-61.0,-87.0,-87.0,-84.0,-83.0,15.0,15.0,14.0,22.0,1
4720,BA:8C:B9:54:50:24,3841089,490023626,4839,6183113,3836250,483840513,0,9021,1701231,8999,1697736,22,3495,2348,15,5280,39,0,58,216660.0,130000.0,-40.0,-37.0,-45.0,-52.0,-40.0,-36.0,-45.0,-51.0,-87.0,-87.0,-84.0,-83.0,47.0,50.0,39.0,31.0,1
4721,62:47:05:9D:EB:15,3836300,483850870,48,10155,3836252,483840715,0,117,13179,106,11013,11,2166,38,0,69,0,0,4,216660.0,130000.0,-59.0,-56.0,-54.0,-65.0,-53.0,-52.0,-51.0,-52.0,-87.0,-87.0,-84.0,-83.0,28.0,31.0,30.0,18.0,1
4722,3C:55:76:E8:8F:1F,3872621,572523559,36369,88682844,3836252,483840715,21,18243,4413070,17962,4362523,281,50547,8508,25,36419,3898,21,215,17200.0,2000.0,-44.0,-53.0,-51.0,-40.0,-47.0,-53.0,-51.0,-43.0,-87.0,-87.0,-84.0,-83.0,43.0,34.0,33.0,43.0,1
4723,92:69:1D:31:68:E9,3840181,487467367,3929,3626652,3836252,483840715,0,4822,1108310,4678,1075705,144,32605,2127,10,4135,87,0,44,229410.0,130000.0,-51.0,-47.0,-42.0,-49.0,-51.0,-48.0,-44.0,-47.0,-87.0,-87.0,-84.0,-83.0,36.0,40.0,42.0,34.0,1
4724,CC:2F:71:3F:1F:24,4638678,1346797973,802426,862957258,3836252,483840715,37,648540,676544705,647815,676457487,725,87218,625295,15,802683,87585,34,521,130000.0,43333.0,-69.0,-67.0,-66.0,-70.0,-69.0,-67.0,-66.0,-71.0,-87.0,-87.0,-84.0,-83.0,18.0,20.0,18.0,13.0,1
4725,CC:2F:71:3E:C5:1F,3837133,483948272,880,107495,3836253,483840777,0,3674,308511,3031,232193,643,76318,931,9,1265,20,0,40,130000.0,39000.0,-72.0,-72.0,-70.0,-61.0,-72.0,-73.0,-70.0,-61.0,-87.0,-87.0,-84.0,-83.0,15.0,15.0,14.0,22.0,1
4726,BA:8C:B9:54:50:24,3841092,490023890,4839,6183113,3836253,483840777,0,9021,1701231,8999,1697736,22,3495,2348,15,5280,39,0,58,216660.0,130000.0,-40.0,-37.0,-45.0,-52.0,-40.0,-36.0,-45.0,-51.0,-87.0,-87.0,-84.0,-83.0,47.0,50.0,39.0,31.0,1
4727,62:47:05:9D:EB:15,3836306,483851396,48,10155,3836258,483841241,0,117,13179,106,11013,11,2166,38,0,69,0,0,4,216660.0,130000.0,-59.0,-56.0,-54.0,-65.0,-53.0,-52.0,-51.0,-52.0,-87.0,-87.0,-84.0,-83.0,28.0,31.0,30.0,18.0,1
4728,3C:55:76:E8:8F:1F,3872629,572524287,36369,88682844,3836260,483841443,21,18243,4413070,17962,4362523,281,50547,8508,25,36419,3898,21,215,17200.0,2000.0,-44.0,-53.0,-51.0,-40.0,-47.0,-53.0,-51.0,-43.0,-87.0,-87.0,-84.0,-83.0,43.0,34.0,33.0,43.0,1
4729,92:69:1D:31:68:E9,3840189,487468095,3929,3626652,3836260,483841443,0,4824,1108446,4680,1075841,144,32605,2127,10,4136,87,0,44,229410.0,130000.0,-50.0,-47.0,-42.0,-49.0,-51.0,-47.0,-43.0,-47.0,-87.0,-87.0,-84.0,-83.0,37.0,40.0,42.0,34.0,1
4730,CC:2F:71:3F:1F:24,4638894,1347061333,802634,863219890,3836260,483841443,37,648735,676803005,648009,676715669,726,87336,625481,15,802891,87599,34,521,130000.0,39000.0,-69.0,-67.0,-67.0,-71.0,-69.0,-67.0,-66.0,-71.0,-87.0,-87.0,-84.0,-83.0,18.0,20.0,17.0,12.0,1
4731,CC:2F:71:3E:C5:1F,3837140,483948938,880,107495,3836260,483841443,0,3674,308511,3031,232193,643,76318,931,9,1265,20,0,40,130000.0,39000.0,-72.0,-72.0,-70.0,-61.0,-72.0,-73.0,-70.0,-61.0,-87.0,-87.0,-84.0,-83.0,15.0,15.0,14.0,22.0,1
4732,BA:8C:B9:54:50:24,3841099,490024556,4839,6183113,3836260,483841443,0,9023,1701367,9001,1697872,22,3495,2348,15,5281,39,0,58,216660.0,130000.0,-40.0,-37.0,-46.0,-52.0,-40.0,-36.0,-45.0,-51.0,-87.0,-87.0,-84.0,-83.0,47.0,50.0,38.0,31.0,1
4733,62:47:05:9D:EB:15,3836310,483851800,48,10155,3836262,483841645,0,117,13179,106,11013,11,2166,38,0,69,0,0,4,216660.0,130000.0,-59.0,-56.0,-54.0,-65.0,-53.0,-52.0,-51.0,-52.0,-87.0,-87.0,-84.0,-83.0,28.0,31.0,30.0,18.0,1
4734,3C:55:76:E8:8F:1F,3872633,572524681,36371,88683036,3836262,483841645,21,18243,4413070,17962,4362523,281,50547,8508,25,36421,3898,21,215,17200.0,2000.0,-44.0,-53.0,-51.0,-40.0,-47.0,-53.0,-51.0,-43.0,-87.0,-87.0,-84.0,-83.0,43.0,34.0,33.0,43.0,1
4735,92:69:1D:31:68:E9,3840191,487468297,3929,3626652,3836262,483841645,0,4824,1108446,4680,1075841,144,32605,2127,10,4136,87,0,44,229410.0,130000.0,-50.0,-47.0,-42.0,-49.0,-51.0,-47.0,-43.0,-47.0,-87.0,-87.0,-84.0,-83.0,37.0,40.0,42.0,34.0,1
4736,CC:2F:71:3F:1F:24,4639176,1347418083,802914,863576438,3836262,483841645,37,648956,677061568,648230,676974232,726,87336,625695,15,803160,87611,34,521,130000.0,43333.0,-70.0,-68.0,-67.0,-72.0,-69.0,-67.0,-67.0,-71.0,-87.0,-87.0,-84.0,-83.0,17.0,19.0,17.0,11.0,1
4737,CC:2F:71:3E:C5:1F,3837142,483949140,880,107495,3836262,483841645,0,3674,308511,3031,232193,643,76318,931,9,1265,20,0,40,130000.0,39000.0,-72.0,-72.0,-70.0,-61.0,-72.0,-73.0,-70.0,-61.0,-87.0,-87.0,-84.0,-83.0,15.0,15.0,14.0,22.0,1
4738,BA:8C:B9:54:50:24,3841101,490024758,4839,6183113,3836262,483841645,0,9023,1701367,9001,1697872,22,3495,2348,15,5281,39,0,58,216660.0,130000.0,-40.0,-37.0,-46.0,-52.0,-40.0,-36.0,-45.0,-51.0,-87.0,-87.0,-84.0,-83.0,47.0,50.0,38.0,31.0,1
4739,62:47:05:9D:EB:15,3836316,483852406,48,10155,3836268,483842251,0,117,13179,106,11013,11,2166,38,0,69,0,0,4,216660.0,130000.0,-59.0,-56.0,-54.0,-65.0,-53.0,-52.0,-51.0,-52.0,-87.0,-87.0,-84.0,-83.0,28.0,31.0,30.0,18.0,1
4740,3C:55:76:E8:8F:1F,3872639,572525287,36371,88683036,3836268,483842251,21,18243,4413070,17962,4362523,281,50547,8508,25,36421,3898,21,215,17200.0,2000.0,-44.0,-53.0,-51.0,-40.0,-47.0,-53.0,-51.0,-43.0,-87.0,-87.0,-84.0,-83.0,43.0,34.0,33.0,43.0,1
4741,92:69:1D:31:68:E9,3840197,487468903,3929,3626652,3836268,483842251,0,4824,1108446,4680,1075841,144,32605,2127,10,4136,87,0,44,229410.0,130000.0,-50.0,-47.0,-42.0,-49.0,-51.0,-47.0,-43.0,-47.0,-87.0,-87.0,-84.0,-83.0,37.0,40.0,42.0,34.0,1
4742,CC:2F:71:3F:1F:24,4639855,1348287657,803586,864445346,3836269,483842311,37,649350,677345281,648624,677257945,726,87336,626076,15,803843,87714,34,521,130000.0,43333.0,-70.0,-68.0,-67.0,-72.0,-69.0,-67.0,-67.0,-70.0,-87.0,-87.0,-84.0,-83.0,17.0,19.0,17.0,11.0,1
4743,CC:2F:71:3E:C5:1F,3837149,483949806,880,107495,3836269,483842311,0,3674,308511,3031,232193,643,76318,931,9,1265,20,0,40,130000.0,39000.0,-72.0,-72.0,-70.0,-61.0,-72.0,-73.0,-70.0,-61.0,-87.0,-87.0,-84.0,-83.0,15.0,15.0,14.0,22.0,1
4744,BA:8C:B9:54:50:24,3841110,490025548,4839,6183113,3836271,483842435,0,9023,1701367,9001,1697872,22,3495,2348,15,5281,39,0,58,216660.0,130000.0,-40.0,-37.0,-46.0,-52.0,-40.0,-36.0,-45.0,-51.0,-87.0,-87.0,-84.0,-83.0,47.0,50.0,38.0,31.0,1
4745,62:47:05:9D:EB:15,3836321,483852792,48,10155,3836273,483842637,0,117,13179,106,11013,11,2166,38,0,69,0,0,4,216660.0,130000.0,-59.0,-56.0,-54.0,-65.0,-53.0,-52.0,-51.0,-52.0,-87.0,-87.0,-84.0,-83.0,28.0,31.0,30.0,18.0,1
4746,3C:55:76:E8:8F:1F,3872723,572671092,36450,88828455,3836273,483842637,21,18395,4457253,18108,4405998,287,51255,8560,25,36499,3961,21,216,17200.0,2000.0,-49.0,-53.0,-49.0,-46.0,-47.0,-52.0,-50.0,-43.0,-87.0,-87.0,-84.0,-83.0,38.0,34.0,35.0,37.0,1
4747,92:69:1D:31:68:E9,3840204,487469491,3929,3626652,3836275,483842839,0,4824,1108446,4680,1075841,144,32605,2127,10,4136,87,0,44,229410.0,130000.0,-50.0,-47.0,-42.0,-49.0,-51.0,-47.0,-43.0,-47.0,-87.0,-87.0,-84.0,-83.0,37.0,40.0,42.0,34.0,1
4748,CC:2F:71:3F:1F:24,4640160,1348619522,803885,864776683,3836275,483842839,37,649616,677630347,648890,677543011,726,87336,626338,15,804142,87726,34,521,130000.0,43333.0,-69.0,-67.0,-67.0,-71.0,-69.0,-67.0,-66.0,-71.0,-87.0,-87.0,-84.0,-83.0,18.0,20.0,17.0,12.0,1
4749,CC:2F:71:3E:C5:1F,3837155,483950334,880,107495,3836275,483842839,0,3674,308511,3031,232193,643,76318,931,9,1265,20,0,40,130000.0,39000.0,-72.0,-72.0,-70.0,-61.0,-72.0,-73.0,-70.0,-61.0,-87.0,-87.0,-84.0,-83.0,15.0,15.0,14.0,22.0,1
4750,BA:8C:B9:54:50:24,3841114,490025952,4839,6183113,3836275,483842839,0,9023,1701367,9001,1697872,22,3495,2348,15,5281,39,0,58,216660.0,130000.0,-40.0,-37.0,-46.0,-52.0,-40.0,-36.0,-45.0,-51.0,-87.0,-87.0,-84.0,-83.0,47.0,50.0,38.0,31.0,1
4751,62:47:05:9D:EB:15,3836327,483853398,48,10155,3836279,483843243,0,117,13179,106,11013,11,2166,38,0,69,0,0,4,216660.0,130000.0,-59.0,-56.0,-54.0,-65.0,-53.0,-52.0,-51.0,-52.0,-88.0,-87.0,-84.0,-83.0,29.0,31.0,30.0,18.0,1
4752,3C:55:76:E8:8F:1F,3872748,572706492,36469,88863249,3836279,483843243,21,18395,4457253,18108,4405998,287,51255,8560,25,36518,3965,21,216,24370.0,2000.0,-49.0,-53.0,-49.0,-46.0,-47.0,-52.0,-50.0,-43.0,-88.0,-87.0,-84.0,-83.0,39.0,34.0,35.0,37.0,1
4753,92:69:1D:31:68:E9,3840208,487469895,3929,3626652,3836279,483843243,0,4824,1108446,4680,1075841,144,32605,2127,10,4136,87,0,44,229410.0,130000.0,-50.0,-47.0,-42.0,-49.0,-51.0,-47.0,-43.0,-47.0,-88.0,-87.0,-84.0,-83.0,38.0,40.0,42.0,34.0,1
4754,CC:2F:71:3F:1F:24,4640377,1348883704,804096,865040259,3836281,483843445,37,649805,677876441,649079,677789105,726,87336,626525,15,804353,87740,34,521,130000.0,43333.0,-70.0,-67.0,-67.0,-72.0,-69.0,-67.0,-67.0,-70.0,-88.0,-87.0,-84.0,-83.0,18.0,20.0,17.0,11.0,1
4755,CC:2F:71:3E:C5:1F,3837161,483950940,880,107495,3836281,483843445,0,3674,308511,3031,232193,643,76318,931,9,1265,20,0,40,130000.0,39000.0,-72.0,-72.0,-70.0,-61.0,-72.0,-73.0,-70.0,-61.0,-88.0,-87.0,-84.0,-83.0,16.0,15.0,14.0,22.0,1
4756,BA:8C:B9:54:50:24,3841120,490026558,4839,6183113,3836281,483843445,0,9023,1701367,9001,1697872,22,3495,2348,15,5281,39,0,58,216660.0,130000.0,-40.0,-37.0,-46.0,-52.0,-40.0,-36.0,-45.0,-51.0,-88.0,-87.0,-84.0,-83.0,48.0,50.0,38.0,31.0,1
4757,62:47:05:9D:EB:15,3836333,483854135,48,10155,3836285,483843980,0,117,13179,106,11013,11,2166,38,0,69,0,0,4,216660.0,130000.0,-59.0,-56.0,-54.0,-65.0,-53.0,-52.0,-51.0,-52.0,-88.0,-87.0,-84.0,-83.0,29.0,31.0,30.0,18.0,1
4758,3C:55:76:E8:8F:1F,3872754,572707229,36469,88863249,3836285,483843980,21,18395,4457253,18108,4405998,287,51255,8560,25,36519,3966,21,216,24370.0,2000.0,-49.0,-53.0,-49.0,-46.0,-47.0,-52.0,-50.0,-43.0,-88.0,-87.0,-84.0,-83.0,39.0,34.0,35.0,37.0,1
4759,92:69:1D:31:68:E9,3840216,487470834,3929,3626652,3836287,483844182,0,4824,1108446,4680,1075841,144,32605,2127,10,4136,87,0,44,229410.0,130000.0,-50.0,-47.0,-42.0,-49.0,-51.0,-47.0,-43.0,-47.0,-88.0,-87.0,-84.0,-83.0,38.0,40.0,42.0,34.0,1
4760,CC:2F:71:3F:1F:24,4640606,1349149676,804317,865305292,3836289,483844384,37,650005,678128885,649279,678041549,726,87336,626719,15,804574,87740,34,521,130000.0,43333.0,-70.0,-68.0,-67.0,-70.0,-70.0,-68.0,-67.0,-70.0,-88.0,-87.0,-84.0,-83.0,18.0,19.0,17.0,13.0,1
4761,CC:2F:71:3E:C5:1F,3837169,483951879,880,107495,3836289,483844384,0,3674,308511,3031,232193,643,76318,931,9,1265,20,0,40,130000.0,39000.0,-72.0,-72.0,-70.0,-61.0,-72.0,-73.0,-70.0,-61.0,-88.0,-87.0,-84.0,-83.0,16.0,15.0,14.0,22.0,1
4762,BA:8C:B9:54:50:24,3841128,490027497,4839,6183113,3836289,483844384,0,9023,1701367,9001,1697872,22,3495,2348,15,5281,39,0,58,216660.0,130000.0,-40.0,-37.0,-46.0,-52.0,-40.0,-36.0,-45.0,-51.0,-88.0,-87.0,-84.0,-83.0,48.0,50.0,38.0,31.0,1
4763,62:47:05:9D:EB:15,3836341,483855097,48,10155,3836293,483844942,0,117,13179,106,11013,11,2166,38,0,69,0,0,4,216660.0,130000.0,-59.0,-56.0,-54.0,-65.0,-53.0,-52.0,-51.0,-52.0,-88.0,-87.0,-84.0,-83.0,29.0,31.0,30.0,18.0,1
4764,3C:55:76:E8:8F:1F,3872763,572709547,36470,88864605,3836293,483844942,21,18395,4457253,18108,4405998,287,51255,8560,25,36520,3966,21,216,24370.0,2000.0,-49.0,-53.0,-49.0,-46.0,-47.0,-52.0,-50.0,-43.0,-88.0,-87.0,-84.0,-83.0,39.0,34.0,35.0,37.0,1
4765,92:69:1D:31:68:E9,3840222,487471594,3929,3626652,3836293,483844942,0,4824,1108446,4680,1075841,144,32605,2127,10,4136,87,0,44,229410.0,130000.0,-50.0,-47.0,-42.0,-49.0,-51.0,-47.0,-43.0,-47.0,-88.0,-87.0,-84.0,-83.0,38.0,40.0,42.0,34.0,1
4766,CC:2F:71:3F:1F:24,4640828,1349418173,804535,865573231,3836293,483844942,37,650207,678389926,649481,678302590,726,87336,626914,15,804792,87768,34,522,130000.0,43333.0,-68.0,-67.0,-68.0,-71.0,-68.0,-66.0,-68.0,-71.0,-88.0,-87.0,-84.0,-83.0,20.0,20.0,16.0,12.0,1
4767,CC:2F:71:3E:C5:1F,3837173,483952437,880,107495,3836293,483844942,0,3674,308511,3031,232193,643,76318,931,9,1265,20,0,40,130000.0,39000.0,-72.0,-72.0,-70.0,-61.0,-72.0,-73.0,-70.0,-61.0,-88.0,-87.0,-84.0,-83.0,16.0,15.0,14.0,22.0,1
4768,BA:8C:B9:54:50:24,3841132,490028055,4839,6183113,3836293,483844942,0,9023,1701367,9001,1697872,22,3495,2348,15,5281,39,0,58,216660.0,130000.0,-40.0,-37.0,-46.0,-52.0,-40.0,-36.0,-45.0,-51.0,-88.0,-87.0,-84.0,-83.0,48.0,50.0,38.0,31.0,1
4769,62:47:05:9D:EB:15,3836348,483855763,48,10155,3836300,483845608,0,117,13179,106,11013,11,2166,38,0,69,0,0,4,216660.0,130000.0,-59.0,-56.0,-54.0,-65.0,-53.0,-52.0,-51.0,-52.0,-88.0,-87.0,-84.0,-83.0,29.0,31.0,30.0,18.0,1
4770,3C:55:76:E8:8F:1F,3872816,572801217,36516,88955609,3836300,483845608,21,18458,4468390,18171,4417135,287,51255,8572,25,36566,3991,21,216,32500.0,5500.0,-48.0,-52.0,-48.0,-43.0,-47.0,-52.0,-49.0,-43.0,-88.0,-87.0,-84.0,-83.0,40.0,35.0,36.0,40.0,1
4771,92:69:1D:31:68:E9,3840229,487472260,3929,3626652,3836300,483845608,0,4824,1108446,4680,1075841,144,32605,2127,10,4136,87,0,44,229410.0,130000.0,-50.0,-47.0,-42.0,-49.0,-51.0,-47.0,-43.0,-47.0,-88.0,-87.0,-84.0,-83.0,38.0,40.0,42.0,34.0,1
4772,CC:2F:71:3F:1F:24,4641048,1349688115,804748,865842507,3836300,483845608,37,650408,678657352,649682,678570016,726,87336,627105,15,805005,87800,34,522,130000.0,43333.0,-70.0,-66.0,-67.0,-70.0,-70.0,-66.0,-67.0,-70.0,-88.0,-87.0,-84.0,-83.0,18.0,21.0,17.0,13.0,1
4773,CC:2F:71:3E:C5:1F,3837180,483953103,880,107495,3836300,483845608,0,3674,308511,3031,232193,643,76318,931,9,1265,20,0,40,130000.0,39000.0,-72.0,-72.0,-70.0,-61.0,-72.0,-73.0,-70.0,-61.0,-88.0,-87.0,-84.0,-83.0,16.0,15.0,14.0,22.0,1
4774,BA:8C:B9:54:50:24,3841139,490028721,4839,6183113,3836300,483845608,0,9023,1701367,9001,1697872,22,3495,2348,15,5281,39,0,58,216660.0,130000.0,-40.0,-37.0,-46.0,-52.0,-40.0,-36.0,-45.0,-51.0,-88.0,-87.0,-84.0,-83.0,48.0,50.0,38.0,31.0,1
4775,62:47:05:9D:EB:15,3836351,483856091,48,10155,3836303,483845936,0,117,13179,106,11013,11,2166,38,0,69,0,0,4,216660.0,130000.0,-59.0,-56.0,-54.0,-65.0,-53.0,-52.0,-51.0,-52.0,-88.0,-87.0,-84.0,-83.0,29.0,31.0,30.0,18.0,1
4776,3C:55:76:E8:8F:1F,3872852,572881659,36549,89035723,3836303,483845936,21,18755,4562794,18458,4510359,297,52435,8576,25,36582,4037,21,216,32500.0,1000.0,-44.0,-55.0,-48.0,-39.0,-46.0,-53.0,-45.0,-40.0,-88.0,-87.0,-84.0,-83.0,44.0,32.0,36.0,44.0,1
4777,92:69:1D:31:68:E9,3840234,487472790,3929,3626652,3836305,483846138,0,4824,1108446,4680,1075841,144,32605,2127,10,4136,87,0,44,229410.0,130000.0,-50.0,-47.0,-42.0,-49.0,-51.0,-47.0,-43.0,-47.0,-88.0,-87.0,-84.0,-83.0,38.0,40.0,42.0,34.0,1
4778,CC:2F:71:3F:1F:24,4641324,1350043835,805019,866197697,3836305,483846138,37,650670,679015168,649944,678927832,726,87336,627350,15,805275,87810,34,522,130000.0,39000.0,-69.0,-66.0,-67.0,-71.0,-69.0,-66.0,-66.0,-72.0,-88.0,-87.0,-84.0,-83.0,19.0,21.0,17.0,12.0,1
4779,CC:2F:71:3E:C5:1F,3837189,483954037,880,107495,3836309,483846542,0,3674,308511,3031,232193,643,76318,931,9,1265,20,0,40,130000.0,39000.0,-72.0,-72.0,-70.0,-61.0,-72.0,-73.0,-70.0,-61.0,-88.0,-87.0,-84.0,-83.0,16.0,15.0,14.0,22.0,1
4780,BA:8C:B9:54:50:24,3841148,490029655,4839,6183113,3836309,483846542,0,9023,1701367,9001,1697872,22,3495,2348,15,5281,39,0,58,216660.0,130000.0,-40.0,-37.0,-46.0,-52.0,-40.0,-36.0,-45.0,-51.0,-88.0,-87.0,-84.0,-83.0,48.0,50.0,38.0,31.0,1
4781,62:47:05:9D:EB:15,3836358,483856757,48,10155,3836310,483846602,0,117,13179,106,11013,11,2166,38,0,69,0,0,4,216660.0,130000.0,-59.0,-56.0,-54.0,-65.0,-53.0,-52.0,-51.0,-52.0,-88.0,-87.0,-84.0,-83.0,29.0,31.0,30.0,18.0,1
4782,3C:55:76:E8:8F:1F,3872920,573029153,36610,89182551,3836310,483846602,21,18821,4584364,18524,4531929,297,52435,8586,25,36662,4225,21,216,24370.0,1000.0,-45.0,-54.0,-46.0,-39.0,-45.0,-54.0,-47.0,-39.0,-88.0,-87.0,-84.0,-83.0,43.0,33.0,38.0,44.0,1
4783,92:69:1D:31:68:E9,3840241,487473456,3929,3626652,3836312,483846804,0,4824,1108446,4680,1075841,144,32605,2127,10,4136,87,0,44,229410.0,130000.0,-50.0,-47.0,-42.0,-49.0,-51.0,-47.0,-43.0,-47.0,-88.0,-87.0,-84.0,-83.0,38.0,40.0,42.0,34.0,1
4784,CC:2F:71:3F:1F:24,4641558,1350325150,805246,866478346,3836312,483846804,37,650885,679293535,650159,679206199,726,87336,627553,15,805503,87840,34,522,115556.0,28889.0,-72.0,-67.0,-67.0,-71.0,-72.0,-66.0,-67.0,-70.0,-88.0,-87.0,-84.0,-83.0,16.0,20.0,17.0,12.0,1
4785,CC:2F:71:3E:C5:1F,3837192,483954299,880,107495,3836312,483846804,0,3674,308511,3031,232193,643,76318,931,9,1265,20,0,40,130000.0,39000.0,-72.0,-72.0,-70.0,-61.0,-72.0,-73.0,-70.0,-61.0,-88.0,-87.0,-84.0,-83.0,16.0,15.0,14.0,22.0,1
4786,BA:8C:B9:54:50:24,3841151,490029917,4839,6183113,3836312,483846804,0,9023,1701367,9001,1697872,22,3495,2348,15,5281,39,0,58,216660.0,130000.0,-40.0,-37.0,-46.0,-52.0,-40.0,-36.0,-45.0,-51.0,-88.0,-87.0,-84.0,-83.0,48.0,50.0,38.0,31.0,1
4787,62:47:05:9D:EB:15,3836364,483857363,48,10155,3836316,483847208,0,117,13179,106,11013,11,2166,38,0,69,0,0,4,216660.0,130000.0,-59.0,-56.0,-54.0,-65.0,-53.0,-52.0,-51.0,-52.0,-88.0,-87.0,-84.0,-83.0,29.0,31.0,30.0,18.0,1
4788,3C:55:76:E8:8F:1F,3872978,573142557,36660,89295147,3836318,483847410,21,18885,4603251,18588,4550816,297,52435,8599,25,36712,4299,21,216,32500.0,1000.0,-47.0,-50.0,-43.0,-42.0,-45.0,-53.0,-47.0,-40.0,-88.0,-87.0,-84.0,-83.0,41.0,37.0,41.0,41.0,1
4789,92:69:1D:31:68:E9,3840247,487474062,3929,3626652,3836318,483847410,0,4824,1108446,4680,1075841,144,32605,2127,10,4136,87,0,44,229410.0,130000.0,-50.0,-47.0,-42.0,-49.0,-51.0,-47.0,-43.0,-47.0,-88.0,-87.0,-84.0,-83.0,38.0,40.0,42.0,34.0,1
4790,CC:2F:71:3F:1F:24,4641772,1350585948,805454,866738538,3836318,483847410,37,651075,679545591,650349,679458255,726,87336,627735,15,805711,87842,34,522,115556.0,28889.0,-68.0,-66.0,-67.0,-70.0,-68.0,-66.0,-67.0,-70.0,-88.0,-87.0,-84.0,-83.0,20.0,21.0,17.0,13.0,1
4791,CC:2F:71:3E:C5:1F,3837198,483954905,880,107495,3836318,483847410,0,3674,308511,3031,232193,643,76318,931,9,1265,20,0,40,130000.0,39000.0,-72.0,-72.0,-70.0,-61.0,-72.0,-73.0,-70.0,-61.0,-88.0,-87.0,-84.0,-83.0,16.0,15.0,14.0,22.0,1
4792,BA:8C:B9:54:50:24,3841157,490030523,4839,6183113,3836318,483847410,0,9023,1701367,9001,1697872,22,3495,2348,15,5281,39,0,58,216660.0,130000.0,-40.0,-37.0,-46.0,-52.0,-40.0,-36.0,-45.0,-51.0,-88.0,-87.0,-84.0,-83.0,48.0,50.0,38.0,31.0,1
4793,62:47:05:9D:EB:15,3836369,483857827,48,10155,3836321,483847672,0,117,13179,106,11013,11,2166,38,0,69,0,0,4,216660.0,130000.0,-59.0,-56.0,-54.0,-65.0,-53.0,-52.0,-51.0,-52.0,-88.0,-87.0,-84.0,-83.0,29.0,31.0,30.0,18.0,1
4794,3C:55:76:E8:8F:1F,3872988,573156461,36667,89308789,3836321,483847672,21,19019,4670872,18722,4618437,297,52435,8600,25,36720,4318,21,216,32500.0,1000.0,-49.0,-54.0,-53.0,-44.0,-48.0,-52.0,-46.0,-41.0,-88.0,-87.0,-84.0,-83.0,39.0,33.0,31.0,39.0,1
4795,92:69:1D:31:68:E9,3840250,487474324,3929,3626652,3836321,483847672,0,4825,1108514,4681,1075909,144,32605,2127,10,4136,87,0,44,229410.0,130000.0,-52.0,-47.0,-44.0,-48.0,-51.0,-47.0,-43.0,-47.0,-88.0,-87.0,-84.0,-83.0,36.0,40.0,40.0,35.0,1
4796,CC:2F:71:3F:1F:24,4641995,1350867490,805674,867019818,3836321,483847672,37,651286,679828485,650560,679741149,726,87336,627934,15,805931,87850,34,522,130000.0,43333.0,-71.0,-66.0,-69.0,-69.0,-70.0,-66.0,-69.0,-69.0,-88.0,-87.0,-84.0,-83.0,17.0,21.0,15.0,14.0,1
4797,CC:2F:71:3E:C5:1F,3837201,483955167,880,107495,3836321,483847672,0,3674,308511,3031,232193,643,76318,931,9,1265,20,0,40,130000.0,39000.0,-72.0,-72.0,-70.0,-61.0,-72.0,-73.0,-70.0,-61.0,-88.0,-87.0,-84.0,-83.0,16.0,15.0,14.0,22.0,1
4798,BA:8C:B9:54:50:24,3841160,490030785,4839,6183113,3836321,483847672,0,9023,1701367,9001,1697872,22,3495,2348,15,5281,39,0,58,216660.0,130000.0,-40.0,-37.0,-46.0,-52.0,-40.0,-36.0,-45.0,-51.0,-88.0,-87.0,-84.0,-83.0,48.0,50.0,38.0,31.0,1
4799,62:47:05:9D:EB:15,3836375,483858433,48,10155,3836327,483848278,0,117,13179,106,11013,11,2166,38,0,69,0,0,4,216660.0,130000.0,-59.0,-56.0,-54.0,-65.0,-53.0,-52.0,-51.0,-52.0,-88.0,-88.0,-84.0,-83.0,29.0,32.0,30.0,18.0,1
4800,3C:55:76:E8:8F:1F,3872996,573158541,36669,89310263,3836327,483848278,21,19019,4670872,18722,4618437,297,52435,8600,25,36722,4319,21,216,24370.0,2000.0,-49.0,-54.0,-53.0,-44.0,-48.0,-52.0,-46.0,-41.0,-88.0,-88.0,-84.0,-83.0,39.0,34.0,31.0,39.0,1
4801,92:69:1D:31:68:E9,3840256,487474930,3929,3626652,3836327,483848278,0,4825,1108514,4681,1075909,144,32605,2127,10,4136,87,0,44,229410.0,130000.0,-52.0,-47.0,-44.0,-48.0,-51.0,-47.0,-43.0,-47.0,-88.0,-88.0,-84.0,-83.0,36.0,41.0,40.0,35.0,1
4802,CC:2F:71:3F:1F:24,4642208,1351127918,805881,867279640,3836327,483848278,37,651471,680074033,650745,679986697,726,87336,628115,15,806138,87861,34,522,130000.0,43333.0,-69.0,-66.0,-67.0,-70.0,-69.0,-65.0,-67.0,-69.0,-88.0,-88.0,-84.0,-83.0,19.0,22.0,17.0,13.0,1
4803,CC:2F:71:3E:C5:1F,3837207,483955773,880,107495,3836327,483848278,0,3674,308511,3031,232193,643,76318,931,9,1265,20,0,40,130000.0,39000.0,-72.0,-72.0,-70.0,-61.0,-72.0,-73.0,-70.0,-61.0,-88.0,-88.0,-84.0,-83.0,16.0,16.0,14.0,22.0,1
4804,BA:8C:B9:54:50:24,3841166,490031391,4839,6183113,3836327,483848278,0,9023,1701367,9001,1697872,22,3495,2348,15,5281,39,0,58,216660.0,130000.0,-40.0,-37.0,-46.0,-52.0,-40.0,-36.0,-45.0,-51.0,-88.0,-88.0,-84.0,-83.0,48.0,51.0,38.0,31.0,1
4805,62:47:05:9D:EB:15,3836377,483858635,48,10155,3836329,483848480,0,117,13179,106,11013,11,2166,38,0,69,0,0,4,216660.0,130000.0,-59.0,-56.0,-54.0,-65.0,-53.0,-52.0,-51.0,-52.0,-88.0,-88.0,-84.0,-83.0,29.0,32.0,30.0,18.0,1
4806,3C:55:76:E8:8F:1F,3872998,573158743,36669,89310263,3836329,483848480,21,19019,4670872,18722,4618437,297,52435,8600,25,36722,4319,21,216,24370.0,2000.0,-49.0,-54.0,-53.0,-44.0,-48.0,-52.0,-46.0,-41.0,-88.0,-88.0,-84.0,-83.0,39.0,34.0,31.0,39.0,1
4807,92:69:1D:31:68:E9,3840258,487475132,3929,3626652,3836329,483848480,0,4825,1108514,4681,1075909,144,32605,2127,10,4136,87,0,44,229410.0,130000.0,-52.0,-47.0,-44.0,-48.0,-51.0,-47.0,-43.0,-47.0,-88.0,-88.0,-84.0,-83.0,36.0,41.0,40.0,35.0,1
4808,CC:2F:71:3F:1F:24,4642427,1351394805,806097,867546265,3836330,483848540,37,651674,680335033,650948,680247697,726,87336,628310,15,806354,87861,34,522,130000.0,43333.0,-70.0,-67.0,-67.0,-70.0,-69.0,-66.0,-67.0,-70.0,-88.0,-88.0,-84.0,-83.0,18.0,21.0,17.0,13.0,1
4809,CC:2F:71:3E:C5:1F,3837212,483956237,880,107495,3836332,483848742,0,3674,308511,3031,232193,643,76318,931,9,1265,20,0,40,130000.0,39000.0,-72.0,-72.0,-70.0,-61.0,-72.0,-73.0,-70.0,-61.0,-88.0,-88.0,-84.0,-83.0,16.0,16.0,14.0,22.0,1
4810,BA:8C:B9:54:50:24,3841171,490031855,4839,6183113,3836332,483848742,0,9023,1701367,9001,1697872,22,3495,2348,15,5281,39,0,58,216660.0,130000.0,-40.0,-37.0,-46.0,-52.0,-40.0,-36.0,-45.0,-51.0,-88.0,-88.0,-84.0,-83.0,48.0,51.0,38.0,31.0,1
4811,62:47:05:9D:EB:15,3836385,483859417,49,10271,3836336,483849146,0,118,13247,107,11081,11,2166,38,0,70,0,0,4,216660.0,130000.0,-52.0,-48.0,-42.0,-57.0,-53.0,-52.0,-49.0,-53.0,-88.0,-88.0,-84.0,-83.0,36.0,40.0,42.0,26.0,1
4812,3C:55:76:E8:8F:1F,3873006,573159469,36670,89310323,3836336,483849146,21,19019,4670872,18722,4618437,297,52435,8600,25,36723,4319,21,216,24370.0,2000.0,-49.0,-54.0,-53.0,-44.0,-48.0,-52.0,-46.0,-41.0,-88.0,-88.0,-84.0,-83.0,39.0,34.0,31.0,39.0,1
4813,92:69:1D:31:68:E9,3840266,487475914,3930,3626768,3836336,483849146,0,4827,1108650,4683,1076045,144,32605,2127,10,4137,87,0,44,229410.0,130000.0,-52.0,-47.0,-42.0,-49.0,-51.0,-47.0,-43.0,-47.0,-88.0,-88.0,-84.0,-83.0,36.0,41.0,42.0,34.0,1
4814,CC:2F:71:3F:1F:24,4642644,1351658643,806308,867809497,3836336,483849146,37,651866,680591403,651140,680504067,726,87336,628495,15,806565,87864,34,522,144444.0,43333.0,-70.0,-66.0,-67.0,-71.0,-70.0,-66.0,-67.0,-70.0,-88.0,-88.0,-84.0,-83.0,18.0,22.0,17.0,12.0,1
4815,CC:2F:71:3E:C5:1F,3837217,483956757,881,107611,3836336,483849146,0,3676,308651,3033,232333,643,76318,931,9,1266,20,0,40,130000.0,39000.0,-71.0,-70.0,-69.0,-60.0,-72.0,-72.0,-70.0,-61.0,-88.0,-88.0,-84.0,-83.0,17.0,18.0,15.0,23.0,1
4816,BA:8C:B9:54:50:24,3841176,490032375,4840,6183229,3836336,483849146,0,9027,1701639,9005,1698144,22,3495,2348,15,5282,39,0,58,216660.0,130000.0,-49.0,-35.0,-43.0,-46.0,-42.0,-35.0,-44.0,-48.0,-88.0,-88.0,-84.0,-83.0,39.0,53.0,41.0,37.0,1
4817,62:47:05:9D:EB:15,3836389,483859821,49,10271,3836340,483849550,0,119,13315,108,11149,11,2166,38,0,70,0,0,4,216660.0,130000.0,-52.0,-48.0,-42.0,-57.0,-52.0,-51.0,-48.0,-52.0,-88.0,-88.0,-84.0,-83.0,36.0,40.0,42.0,26.0,1
4818,3C:55:76:E8:8F:1F,3873053,573271999,36713,89422449,3836340,483849550,21,19221,4737538,18924,4685103,297,52435,8606,25,36766,4377,21,216,24370.0,1000.0,-46.0,-53.0,-43.0,-43.0,-47.0,-53.0,-46.0,-41.0,-88.0,-88.0,-84.0,-83.0,42.0,35.0,41.0,40.0,1
4819,92:69:1D:31:68:E9,3840270,487476318,3930,3626768,3836340,483849550,0,4827,1108650,4683,1076045,144,32605,2127,10,4137,87,0,44,229410.0,130000.0,-52.0,-47.0,-42.0,-49.0,-51.0,-47.0,-43.0,-47.0,-88.0,-88.0,-84.0,-83.0,36.0,41.0,42.0,34.0,1
4820,CC:2F:71:3F:1F:24,4642861,1351922665,806519,868072913,3836342,483849752,37,652068,680850943,651342,680763607,726,87336,628682,15,806776,87866,34,522,144444.0,43333.0,-70.0,-66.0,-67.0,-70.0,-70.0,-66.0,-66.0,-70.0,-88.0,-88.0,-84.0,-83.0,18.0,22.0,17.0,13.0,1
4821,CC:2F:71:3E:C5:1F,3837223,483957363,881,107611,3836342,483849752,0,3676,308651,3033,232333,643,76318,931,9,1266,20,0,40,130000.0,39000.0,-71.0,-70.0,-69.0,-60.0,-72.0,-72.0,-70.0,-61.0,-88.0,-88.0,-84.0,-83.0,17.0,18.0,15.0,23.0,1
4822,BA:8C:B9:54:50:24,3841184,490033183,4840,6183229,3836344,483849954,0,9027,1701639,9005,1698144,22,3495,2348,15,5282,39,0,58,216660.0,130000.0,-49.0,-35.0,-43.0,-46.0,-42.0,-35.0,-44.0,-48.0,-88.0,-88.0,-84.0,-83.0,39.0,53.0,41.0,37.0,1
4823,62:47:05:9D:EB:15,3836395,483860558,49,10271,3836346,483850287,0,119,13315,108,11149,11,2166,38,0,70,0,0,4,216660.0,130000.0,-52.0,-48.0,-42.0,-57.0,-52.0,-51.0,-48.0,-52.0,-88.0,-88.0,-84.0,-83.0,36.0,40.0,42.0,26.0,1
4824,3C:55:76:E8:8F:1F,3873059,573272736,36713,89422449,3836346,483850287,21,19285,4759608,18988,4707173,297,52435,8606,25,36766,4377,21,216,24370.0,1000.0,-47.0,-54.0,-45.0,-45.0,-47.0,-53.0,-46.0,-42.0,-88.0,-88.0,-84.0,-83.0,41.0,34.0,39.0,38.0,1
4825,92:69:1D:31:68:E9,3840278,487477257,3930,3626768,3836348,483850489,0,4827,1108650,4683,1076045,144,32605,2127,10,4137,87,0,44,229410.0,130000.0,-52.0,-47.0,-42.0,-49.0,-51.0,-47.0,-43.0,-47.0,-88.0,-88.0,-84.0,-83.0,36.0,41.0,42.0,34.0,1
4826,CC:2F:71:3F:1F:24,4643087,1352191987,806739,868341498,3836348,483850489,37,652271,681107926,651545,681020590,726,87336,628877,15,806996,87869,34,522,144444.0,43333.0,-71.0,-66.0,-67.0,-70.0,-70.0,-66.0,-66.0,-70.0,-88.0,-88.0,-84.0,-83.0,17.0,22.0,17.0,13.0,1
4827,CC:2F:71:3E:C5:1F,3837229,483958100,881,107611,3836348,483850489,0,3676,308651,3033,232333,643,76318,931,9,1266,20,0,40,130000.0,39000.0,-71.0,-70.0,-69.0,-60.0,-72.0,-72.0,-70.0,-61.0,-88.0,-88.0,-84.0,-83.0,17.0,18.0,15.0,23.0,1
4828,BA:8C:B9:54:50:24,3841188,490033718,4840,6183229,3836348,483850489,0,9027,1701639,9005,1698144,22,3495,2348,15,5282,39,0,58,216660.0,130000.0,-49.0,-35.0,-43.0,-46.0,-42.0,-35.0,-44.0,-48.0,-88.0,-88.0,-84.0,-83.0,39.0,53.0,41.0,37.0,1
4829,62:47:05:9D:EB:15,3836401,483861164,49,10271,3836352,483850893,0,119,13315,108,11149,11,2166,38,0,70,0,0,4,216660.0,130000.0,-52.0,-48.0,-42.0,-57.0,-52.0,-51.0,-48.0,-52.0,-88.0,-88.0,-84.0,-83.0,36.0,40.0,42.0,26.0,1
4830,3C:55:76:E8:8F:1F,3873065,573273342,36713,89422449,3836352,483850893,21,19334,4777719,19037,4725284,297,52435,8606,25,36766,4377,21,216,24370.0,1000.0,-45.0,-55.0,-52.0,-41.0,-45.0,-54.0,-46.0,-42.0,-88.0,-88.0,-84.0,-83.0,43.0,33.0,32.0,42.0,1
4831,92:69:1D:31:68:E9,3840284,487477863,3930,3626768,3836354,483851095,0,4827,1108650,4683,1076045,144,32605,2127,10,4137,87,0,44,229410.0,130000.0,-52.0,-47.0,-42.0,-49.0,-51.0,-47.0,-43.0,-47.0,-88.0,-88.0,-84.0,-83.0,36.0,41.0,42.0,34.0,1
4832,CC:2F:71:3F:1F:24,4643303,1352455821,806949,868604726,3836354,483851095,37,652463,681363156,651737,681275820,726,87336,629060,15,807206,87920,34,522,130000.0,43333.0,-70.0,-67.0,-67.0,-70.0,-69.0,-66.0,-67.0,-69.0,-88.0,-88.0,-84.0,-83.0,18.0,21.0,17.0,13.0,1
4833,CC:2F:71:3E:C5:1F,3837235,483958706,881,107611,3836354,483851095,0,3676,308651,3033,232333,643,76318,931,9,1266,20,0,40,130000.0,39000.0,-71.0,-70.0,-69.0,-60.0,-72.0,-72.0,-70.0,-61.0,-88.0,-88.0,-84.0,-83.0,17.0,18.0,15.0,23.0,1
4834,BA:8C:B9:54:50:24,3841194,490034324,4840,6183229,3836354,483851095,0,9027,1701639,9005,1698144,22,3495,2348,15,5282,39,0,58,216660.0,130000.0,-49.0,-35.0,-43.0,-46.0,-42.0,-35.0,-44.0,-48.0,-88.0,-88.0,-84.0,-83.0,39.0,53.0,41.0,37.0,1
4835,62:47:05:9D:EB:15,3836407,483861690,49,10271,3836358,483851419,0,119,13315,108,11149,11,2166,38,0,70,0,0,4,216660.0,130000.0,-52.0,-48.0,-42.0,-57.0,-52.0,-51.0,-48.0,-52.0,-88.0,-88.0,-84.0,-83.0,36.0,40.0,42.0,26.0,1
4836,3C:55:76:E8:8F:1F,3873081,573290721,36723,89439302,3836358,483851419,21,19419,4811997,19119,4759208,300,52789,8618,25,36774,4378,21,217,24370.0,2000.0,-46.0,-50.0,-46.0,-41.0,-46.0,-53.0,-48.0,-42.0,-88.0,-88.0,-84.0,-83.0,42.0,38.0,38.0,42.0,1
4837,92:69:1D:31:68:E9,3840288,487478187,3930,3626768,3836358,483851419,0,4827,1108650,4683,1076045,144,32605,2127,10,4137,87,0,44,229410.0,130000.0,-52.0,-47.0,-42.0,-49.0,-51.0,-47.0,-43.0,-47.0,-88.0,-88.0,-84.0,-83.0,36.0,41.0,42.0,34.0,1
4838,CC:2F:71:3F:1F:24,4643527,1352730617,807169,868879198,3836358,483851419,37,652662,681623170,651936,681535834,726,87336,629257,15,807426,87969,34,522,130000.0,43333.0,-71.0,-67.0,-66.0,-70.0,-71.0,-66.0,-65.0,-70.0,-88.0,-88.0,-84.0,-83.0,17.0,21.0,18.0,13.0,1
4839,CC:2F:71:3E:C5:1F,3837239,483959030,881,107611,3836358,483851419,0,3676,308651,3033,232333,643,76318,931,9,1266,20,0,40,130000.0,39000.0,-71.0,-70.0,-69.0,-60.0,-72.0,-72.0,-70.0,-61.0,-88.0,-88.0,-84.0,-83.0,17.0,18.0,15.0,23.0,1
4840,BA:8C:B9:54:50:24,3841198,490034648,4840,6183229,3836358,483851419,0,9027,1701639,9005,1698144,22,3495,2348,15,5282,39,0,58,216660.0,130000.0,-49.0,-35.0,-43.0,-46.0,-42.0,-35.0,-44.0,-48.0,-88.0,-88.0,-84.0,-83.0,39.0,53.0,41.0,37.0,1
4841,62:47:05:9D:EB:15,3836415,483862664,49,10271,3836366,483852393,0,119,13315,108,11149,11,2166,38,0,70,0,0,4,216660.0,130000.0,-52.0,-48.0,-42.0,-57.0,-52.0,-51.0,-48.0,-52.0,-88.0,-88.0,-84.0,-83.0,36.0,40.0,42.0,26.0,1
4842,3C:55:76:E8:8F:1F,3873178,573513443,36811,89660988,3836367,483852455,22,19431,4813479,19131,4760690,300,52789,8625,26,36865,4433,22,222,32500.0,1000.0,-45.0,-51.0,-50.0,-40.0,-46.0,-51.0,-49.0,-41.0,-88.0,-88.0,-84.0,-83.0,43.0,37.0,34.0,43.0,1
4843,92:69:1D:31:68:E9,3840297,487479223,3930,3626768,3836367,483852455,0,4827,1108650,4683,1076045,144,32605,2127,10,4137,87,0,44,229410.0,130000.0,-52.0,-47.0,-42.0,-49.0,-51.0,-47.0,-43.0,-47.0,-88.0,-88.0,-84.0,-83.0,36.0,41.0,42.0,34.0,1
4844,CC:2F:71:3F:1F:24,4643743,1352991699,807376,869139244,3836367,483852455,37,652858,681878996,652132,681791660,726,87336,629442,15,807633,87970,34,522,130000.0,43333.0,-71.0,-67.0,-66.0,-69.0,-71.0,-67.0,-66.0,-69.0,-88.0,-88.0,-84.0,-83.0,17.0,21.0,18.0,14.0,1
4845,CC:2F:71:3E:C5:1F,3837248,483960066,881,107611,3836367,483852455,0,3678,308839,3034,232403,644,76436,932,9,1266,20,0,41,130000.0,39000.0,-80.0,-84.0,-76.0,-71.0,-73.0,-74.0,-70.0,-62.0,-88.0,-88.0,-84.0,-83.0,8.0,4.0,8.0,12.0,1
4846,BA:8C:B9:54:50:24,3841207,490035684,4840,6183229,3836367,483852455,0,9027,1701639,9005,1698144,22,3495,2348,15,5282,39,0,58,216660.0,130000.0,-49.0,-35.0,-43.0,-46.0,-42.0,-35.0,-44.0,-48.0,-88.0,-88.0,-84.0,-83.0,39.0,53.0,41.0,37.0,1
4847,62:47:05:9D:EB:15,3836418,483862928,49,10271,3836369,483852657,0,119,13315,108,11149,11,2166,38,0,70,0,0,4,216660.0,130000.0,-52.0,-48.0,-42.0,-57.0,-52.0,-51.0,-48.0,-52.0,-88.0,-88.0,-84.0,-83.0,36.0,40.0,42.0,26.0,1
4848,3C:55:76:E8:8F:1F,3873183,573513961,36814,89661304,3836369,483852657,22,19433,4813615,19133,4760826,300,52789,8625,26,36868,4443,22,222,24370.0,1000.0,-47.0,-53.0,-48.0,-41.0,-46.0,-52.0,-50.0,-41.0,-88.0,-88.0,-84.0,-83.0,41.0,35.0,36.0,42.0,1
4849,92:69:1D:31:68:E9,3840300,487479485,3930,3626768,3836370,483852717,0,4827,1108650,4683,1076045,144,32605,2127,10,4137,87,0,44,229410.0,130000.0,-52.0,-47.0,-42.0,-49.0,-51.0,-47.0,-43.0,-47.0,-88.0,-88.0,-84.0,-83.0,36.0,41.0,42.0,34.0,1
4850,CC:2F:71:3F:1F:24,4643965,1353258752,807595,869406035,3836370,483852717,37,653069,682146855,652343,682059519,726,87336,629635,15,807852,87976,34,522,130000.0,43333.0,-70.0,-66.0,-67.0,-71.0,-70.0,-66.0,-67.0,-71.0,-88.0,-88.0,-84.0,-83.0,18.0,22.0,17.0,12.0,1
4851,CC:2F:71:3E:C5:1F,3837251,483960328,881,107611,3836370,483852717,0,3678,308839,3034,232403,644,76436,932,9,1266,20,0,41,130000.0,39000.0,-80.0,-84.0,-76.0,-71.0,-73.0,-74.0,-70.0,-62.0,-88.0,-88.0,-84.0,-83.0,8.0,4.0,8.0,12.0,1
4852,BA:8C:B9:54:50:24,3841210,490035946,4840,6183229,3836370,483852717,0,9027,1701639,9005,1698144,22,3495,2348,15,5282,39,0,58,216660.0,130000.0,-49.0,-35.0,-43.0,-46.0,-42.0,-35.0,-44.0,-48.0,-88.0,-88.0,-84.0,-83.0,39.0,53.0,41.0,37.0,1
4853,62:47:05:9D:EB:15,3836425,483863594,49,10271,3836376,483853323,0,119,13315,108,11149,11,2166,38,0,70,0,0,4,216660.0,130000.0,-52.0,-48.0,-42.0,-57.0,-52.0,-51.0,-48.0,-52.0,-88.0,-88.0,-84.0,-83.0,36.0,40.0,42.0,26.0,1
4854,3C:55:76:E8:8F:1F,3873190,573514627,36814,89661304,3836376,483853323,22,19433,4813615,19133,4760826,300,52789,8625,26,36868,4443,22,222,24370.0,1000.0,-47.0,-53.0,-48.0,-41.0,-46.0,-52.0,-50.0,-41.0,-88.0,-88.0,-84.0,-83.0,41.0,35.0,36.0,42.0,1
4855,92:69:1D:31:68:E9,3840306,487480091,3930,3626768,3836376,483853323,0,4827,1108650,4683,1076045,144,32605,2127,10,4137,87,0,44,229410.0,130000.0,-52.0,-47.0,-42.0,-49.0,-51.0,-47.0,-43.0,-47.0,-88.0,-88.0,-84.0,-83.0,36.0,41.0,42.0,34.0,1
4856,CC:2F:71:3F:1F:24,4644185,1353526010,807809,869672687,3836376,483853323,37,653269,682415629,652543,682328293,726,87336,629822,15,808066,87977,34,522,130000.0,43333.0,-69.0,-66.0,-67.0,-69.0,-68.0,-66.0,-66.0,-69.0,-88.0,-88.0,-84.0,-83.0,19.0,22.0,17.0,14.0,1
4857,CC:2F:71:3E:C5:1F,3837257,483960934,881,107611,3836376,483853323,0,3678,308839,3034,232403,644,76436,932,9,1266,20,0,41,130000.0,39000.0,-80.0,-84.0,-76.0,-71.0,-73.0,-74.0,-70.0,-62.0,-88.0,-88.0,-84.0,-83.0,8.0,4.0,8.0,12.0,1
4858,BA:8C:B9:54:50:24,3841216,490036552,4840,6183229,3836376,483853323,0,9027,1701639,9005,1698144,22,3495,2348,15,5282,39,0,58,216660.0,130000.0,-49.0,-35.0,-43.0,-46.0,-42.0,-35.0,-44.0,-48.0,-88.0,-88.0,-84.0,-83.0,39.0,53.0,41.0,37.0,1
4859,62:47:05:9D:EB:15,3836428,483863858,49,10271,3836379,483853587,0,119,13315,108,11149,11,2166,38,0,70,0,0,4,216660.0,130000.0,-52.0,-48.0,-42.0,-57.0,-52.0,-51.0,-48.0,-52.0,-88.0,-88.0,-84.0,-83.0,36.0,40.0,42.0,26.0,1
4860,3C:55:76:E8:8F:1F,3873275,573669253,36892,89815262,3836383,483853991,22,19477,4824038,19177,4771249,300,52789,8644,26,36946,4541,22,222,24370.0,1000.0,-47.0,-54.0,-45.0,-43.0,-47.0,-52.0,-49.0,-42.0,-88.0,-88.0,-84.0,-83.0,41.0,34.0,39.0,40.0,1
4861,92:69:1D:31:68:E9,3840313,487480759,3930,3626768,3836383,483853991,0,4827,1108650,4683,1076045,144,32605,2127,10,4137,87,0,44,229410.0,130000.0,-52.0,-47.0,-42.0,-49.0,-51.0,-47.0,-43.0,-47.0,-88.0,-88.0,-84.0,-83.0,36.0,41.0,42.0,34.0,1
4862,CC:2F:71:3F:1F:24,4644426,1353827282,808043,869973291,3836383,483853991,37,653485,682704763,652758,682617309,727,87454,630033,15,808300,87982,34,522,144444.0,43333.0,-69.0,-67.0,-67.0,-69.0,-69.0,-66.0,-66.0,-69.0,-88.0,-88.0,-84.0,-83.0,19.0,21.0,17.0,14.0,1
4863,CC:2F:71:3E:C5:1F,3837267,483961864,881,107611,3836386,483854253,0,3678,308839,3034,232403,644,76436,932,9,1266,20,0,41,130000.0,39000.0,-80.0,-84.0,-76.0,-71.0,-73.0,-74.0,-70.0,-62.0,-88.0,-88.0,-84.0,-83.0,8.0,4.0,8.0,12.0,1
4864,BA:8C:B9:54:50:24,3841226,490037482,4840,6183229,3836386,483854253,0,9029,1701775,9007,1698280,22,3495,2348,15,5283,39,0,58,216660.0,130000.0,-40.0,-37.0,-46.0,-52.0,-43.0,-35.0,-43.0,-48.0,-88.0,-88.0,-84.0,-83.0,48.0,51.0,38.0,31.0,1
4865,62:47:05:9D:EB:15,3836435,483864524,49,10271,3836386,483854253,0,121,13451,110,11285,11,2166,38,0,71,0,0,5,216660.0,130000.0,-46.0,-44.0,-47.0,-54.0,-51.0,-48.0,-47.0,-52.0,-88.0,-88.0,-84.0,-84.0,42.0,44.0,37.0,30.0,1
4866,3C:55:76:E8:8F:1F,3873282,573670162,36894,89815707,3836388,483854455,22,19477,4824038,19177,4771249,300,52789,8644,26,36948,4541,22,222,24370.0,2000.0,-47.0,-54.0,-45.0,-43.0,-47.0,-52.0,-49.0,-42.0,-88.0,-88.0,-84.0,-84.0,41.0,34.0,39.0,41.0,1
4867,92:69:1D:31:68:E9,3840318,487481223,3930,3626768,3836388,483854455,0,4829,1108786,4685,1076181,144,32605,2127,10,4138,87,0,44,229410.0,130000.0,-52.0,-48.0,-44.0,-46.0,-51.0,-47.0,-43.0,-47.0,-88.0,-88.0,-84.0,-84.0,36.0,40.0,40.0,38.0,1
4868,CC:2F:71:3F:1F:24,4644648,1354094517,808260,870240062,3836388,483854455,37,653686,682964183,652959,682876729,727,87454,630224,15,808517,87987,34,522,144444.0,43333.0,-68.0,-66.0,-67.0,-69.0,-68.0,-66.0,-66.0,-69.0,-88.0,-88.0,-84.0,-84.0,20.0,22.0,17.0,15.0,1
4869,CC:2F:71:3E:C5:1F,3837273,483962639,881,107611,3836392,483855028,0,3678,308839,3034,232403,644,76436,932,9,1266,20,0,41,130000.0,39000.0,-80.0,-84.0,-76.0,-71.0,-73.0,-74.0,-70.0,-62.0,-88.0,-88.0,-84.0,-84.0,8.0,4.0,8.0,13.0,1
4870,BA:8C:B9:54:50:24,3841232,490038257,4840,6183229,3836392,483855028,0,9029,1701775,9007,1698280,22,3495,2348,15,5283,39,0,58,216660.0,130000.0,-40.0,-37.0,-46.0,-52.0,-43.0,-35.0,-43.0,-48.0,-88.0,-88.0,-84.0,-84.0,48.0,51.0,38.0,32.0,1
4871,62:47:05:9D:EB:15,3836447,483865905,49,10271,3836398,483855634,0,122,13519,111,11353,11,2166,38,0,71,0,0,5,216660.0,130000.0,-47.0,-44.0,-46.0,-54.0,-50.0,-48.0,-47.0,-53.0,-88.0,-88.0,-84.0,-84.0,41.0,44.0,38.0,30.0,1
4872,3C:55:76:E8:8F:1F,3873405,573946316,37007,90090682,3836398,483855634,23,19702,4889385,19390,4834205,312,55180,8670,27,37057,4771,23,222,24370.0,1000.0,-45.0,-63.0,-47.0,-42.0,-45.0,-60.0,-45.0,-41.0,-88.0,-88.0,-84.0,-84.0,43.0,25.0,37.0,42.0,1
4873,92:69:1D:31:68:E9,3840328,487482402,3930,3626768,3836398,483855634,0,4829,1108786,4685,1076181,144,32605,2127,10,4138,87,0,44,229410.0,130000.0,-52.0,-48.0,-44.0,-46.0,-51.0,-47.0,-43.0,-47.0,-88.0,-88.0,-84.0,-84.0,36.0,40.0,40.0,38.0,1
4874,CC:2F:71:3F:1F:24,4644907,1354418418,808509,870562784,3836398,483855634,37,653927,683285049,653200,683197595,727,87454,630453,15,808766,88003,34,522,144444.0,43333.0,-69.0,-66.0,-66.0,-69.0,-68.0,-66.0,-66.0,-69.0,-88.0,-88.0,-84.0,-84.0,19.0,22.0,18.0,15.0,1
4875,CC:2F:71:3E:C5:1F,3837279,483963245,881,107611,3836398,483855634,0,3678,308839,3034,232403,644,76436,932,9,1266,20,0,41,130000.0,39000.0,-80.0,-84.0,-76.0,-71.0,-73.0,-74.0,-70.0,-62.0,-88.0,-88.0,-84.0,-84.0,8.0,4.0,8.0,13.0,1
4876,BA:8C:B9:54:50:24,3841239,490038923,4840,6183229,3836399,483855694,0,9029,1701775,9007,1698280,22,3495,2348,15,5283,39,0,58,216660.0,130000.0,-40.0,-37.0,-46.0,-52.0,-43.0,-35.0,-43.0,-48.0,-88.0,-88.0,-84.0,-84.0,48.0,51.0,38.0,32.0,1
4877,62:47:05:9D:EB:15,3836450,483866167,49,10271,3836401,483855896,0,122,13519,111,11353,11,2166,38,0,71,0,0,5,216660.0,130000.0,-47.0,-44.0,-46.0,-54.0,-50.0,-48.0,-47.0,-53.0,-88.0,-88.0,-84.0,-84.0,41.0,44.0,38.0,30.0,1
4878,3C:55:76:E8:8F:1F,3873422,573977310,37021,90121414,3836401,483855896,23,19705,4889591,19393,4834411,312,55180,8670,27,37078,4788,23,222,24370.0,2000.0,-45.0,-61.0,-46.0,-41.0,-45.0,-62.0,-46.0,-41.0,-88.0,-88.0,-84.0,-84.0,43.0,27.0,38.0,43.0,1
4879,92:69:1D:31:68:E9,3840331,487482664,3930,3626768,3836401,483855896,0,4829,1108786,4685,1076181,144,32605,2127,10,4138,87,0,44,229410.0,130000.0,-52.0,-48.0,-44.0,-46.0,-51.0,-47.0,-43.0,-47.0,-88.0,-88.0,-84.0,-84.0,36.0,40.0,40.0,38.0,1
4880,CC:2F:71:3F:1F:24,4645124,1354685218,808721,870829120,3836403,483856098,37,654119,683539967,653392,683452513,727,87454,630640,15,808978,88058,34,522,130000.0,43333.0,-69.0,-67.0,-67.0,-71.0,-69.0,-67.0,-67.0,-71.0,-88.0,-88.0,-84.0,-84.0,19.0,21.0,17.0,13.0,1
4881,CC:2F:71:3E:C5:1F,3837284,483963709,881,107611,3836403,483856098,0,3678,308839,3034,232403,644,76436,932,9,1266,20,0,41,130000.0,39000.0,-80.0,-84.0,-76.0,-71.0,-73.0,-74.0,-70.0,-62.0,-88.0,-88.0,-84.0,-84.0,8.0,4.0,8.0,13.0,1
4882,BA:8C:B9:54:50:24,3841245,490039529,4840,6183229,3836405,483856300,0,9029,1701775,9007,1698280,22,3495,2348,15,5283,39,0,58,216660.0,130000.0,-40.0,-37.0,-46.0,-52.0,-43.0,-35.0,-43.0,-48.0,-88.0,-88.0,-84.0,-84.0,48.0,51.0,38.0,32.0,1
4883,62:47:05:9D:EB:15,3836456,483866773,49,10271,3836407,483856502,0,122,13519,111,11353,11,2166,38,0,71,0,0,5,216660.0,130000.0,-47.0,-44.0,-46.0,-54.0,-50.0,-48.0,-47.0,-53.0,-88.0,-88.0,-84.0,-84.0,41.0,44.0,38.0,30.0,1
4884,3C:55:76:E8:8F:1F,3873429,573979216,37022,90122714,3836407,483856502,23,19705,4889591,19393,4834411,312,55180,8670,27,37079,4791,23,222,24370.0,1000.0,-45.0,-61.0,-46.0,-41.0,-45.0,-62.0,-46.0,-41.0,-88.0,-88.0,-84.0,-84.0,43.0,27.0,38.0,43.0,1
4885,92:69:1D:31:68:E9,3840337,487483270,3930,3626768,3836407,483856502,0,4829,1108786,4685,1076181,144,32605,2127,10,4138,87,0,44,229410.0,130000.0,-52.0,-48.0,-44.0,-46.0,-51.0,-47.0,-43.0,-47.0,-88.0,-88.0,-84.0,-84.0,36.0,40.0,40.0,38.0,1
4886,CC:2F:71:3F:1F:24,4645345,1354957072,808938,871100570,3836407,483856502,37,654317,683798785,653590,683711331,727,87454,630833,15,809193,88065,34,522,130000.0,43333.0,-68.0,-66.0,-67.0,-70.0,-68.0,-66.0,-66.0,-70.0,-88.0,-88.0,-84.0,-84.0,20.0,22.0,17.0,14.0,1
4887,CC:2F:71:3E:C5:1F,3837288,483964113,881,107611,3836407,483856502,0,3678,308839,3034,232403,644,76436,932,9,1266,20,0,41,130000.0,39000.0,-80.0,-84.0,-76.0,-71.0,-73.0,-74.0,-70.0,-62.0,-88.0,-88.0,-84.0,-84.0,8.0,4.0,8.0,13.0,1
4888,BA:8C:B9:54:50:24,3841249,490039933,4840,6183229,3836409,483856704,0,9029,1701775,9007,1698280,22,3495,2348,15,5283,39,0,58,216660.0,130000.0,-40.0,-37.0,-46.0,-52.0,-43.0,-35.0,-43.0,-48.0,-88.0,-88.0,-84.0,-84.0,48.0,51.0,38.0,32.0,1
4889,62:47:05:9D:EB:15,3836462,483867510,49,10271,3836413,483857239,0,122,13519,111,11353,11,2166,38,0,71,0,0,5,216660.0,130000.0,-47.0,-44.0,-46.0,-54.0,-50.0,-48.0,-47.0,-53.0,-88.0,-88.0,-84.0,-84.0,41.0,44.0,38.0,30.0,1
4890,3C:55:76:E8:8F:1F,3873437,573980155,37022,90122714,3836415,483857441,23,19705,4889591,19393,4834411,312,55180,8670,27,37079,4791,23,222,24370.0,1000.0,-45.0,-61.0,-46.0,-41.0,-45.0,-62.0,-46.0,-41.0,-88.0,-88.0,-84.0,-84.0,43.0,27.0,38.0,43.0,1
4891,92:69:1D:31:68:E9,3840345,487484209,3930,3626768,3836415,483857441,0,4829,1108786,4685,1076181,144,32605,2127,10,4138,87,0,44,229410.0,130000.0,-52.0,-48.0,-44.0,-46.0,-51.0,-47.0,-43.0,-47.0,-88.0,-88.0,-84.0,-84.0,36.0,40.0,40.0,38.0,1
4892,CC:2F:71:3F:1F:24,4645566,1355222814,809151,871365373,3836415,483857441,37,654513,684051788,653786,683964334,727,87454,631025,15,809408,88090,34,522,130000.0,43333.0,-70.0,-66.0,-67.0,-71.0,-69.0,-65.0,-67.0,-71.0,-88.0,-88.0,-84.0,-84.0,18.0,22.0,17.0,13.0,1
4893,CC:2F:71:3E:C5:1F,3837298,483965254,881,107611,3836417,483857643,0,3678,308839,3034,232403,644,76436,932,9,1266,20,0,41,130000.0,39000.0,-80.0,-84.0,-76.0,-71.0,-73.0,-74.0,-70.0,-62.0,-88.0,-88.0,-84.0,-84.0,8.0,4.0,8.0,13.0,1
4894,BA:8C:B9:54:50:24,3841257,490040872,4840,6183229,3836417,483857643,0,9030,1701843,9008,1698348,22,3495,2348,15,5283,39,0,58,216660.0,130000.0,-40.0,-37.0,-45.0,-52.0,-43.0,-35.0,-43.0,-48.0,-88.0,-88.0,-84.0,-84.0,48.0,51.0,39.0,32.0,1
4895,62:47:05:9D:EB:15,3836466,483867914,49,10271,3836417,483857643,0,122,13519,111,11353,11,2166,38,0,71,0,0,5,216660.0,130000.0,-47.0,-44.0,-46.0,-54.0,-50.0,-48.0,-47.0,-53.0,-88.0,-88.0,-84.0,-84.0,41.0,44.0,38.0,30.0,1
4896,3C:55:76:E8:8F:1F,3873441,573980559,37022,90122714,3836419,483857845,23,19705,4889591,19393,4834411,312,55180,8670,27,37079,4791,23,222,24370.0,1000.0,-45.0,-61.0,-46.0,-41.0,-45.0,-62.0,-46.0,-41.0,-88.0,-88.0,-84.0,-84.0,43.0,27.0,38.0,43.0,1
4897,92:69:1D:31:68:E9,3840349,487484613,3930,3626768,3836419,483857845,0,4829,1108786,4685,1076181,144,32605,2127,10,4138,87,0,44,229410.0,130000.0,-52.0,-48.0,-44.0,-46.0,-51.0,-47.0,-43.0,-47.0,-88.0,-88.0,-84.0,-84.0,36.0,40.0,40.0,38.0,1
4898,CC:2F:71:3F:1F:24,4645779,1355484444,809360,871626599,3836419,483857845,37,654705,684308266,653978,684220812,727,87454,631208,15,809617,88116,34,522,130000.0,43333.0,-69.0,-66.0,-67.0,-70.0,-69.0,-66.0,-67.0,-70.0,-88.0,-88.0,-84.0,-84.0,19.0,22.0,17.0,14.0,1
4899,CC:2F:71:3E:C5:1F,3837300,483965456,881,107611,3836419,483857845,0,3678,308839,3034,232403,644,76436,932,9,1266,20,0,41,130000.0,39000.0,-80.0,-84.0,-76.0,-71.0,-73.0,-74.0,-70.0,-62.0,-88.0,-88.0,-84.0,-84.0,8.0,4.0,8.0,13.0,1
4900,BA:8C:B9:54:50:24,3841259,490041074,4840,6183229,3836419,483857845,0,9030,1701843,9008,1698348,22,3495,2348,15,5283,39,0,58,216660.0,130000.0,-40.0,-37.0,-45.0,-52.0,-43.0,-35.0,-43.0,-48.0,-88.0,-88.0,-84.0,-84.0,48.0,51.0,39.0,32.0,1
4901,62:47:05:9D:EB:15,3836480,483869807,49,10271,3836431,483859536,0,122,13519,111,11353,11,2166,38,0,71,0,0,5,216660.0,130000.0,-47.0,-44.0,-46.0,-54.0,-50.0,-48.0,-47.0,-53.0,-88.0,-88.0,-84.0,-84.0,41.0,44.0,38.0,30.0,1
4902,3C:55:76:E8:8F:1F,3873605,574316997,37174,90457461,3836431,483859536,23,19792,4905820,19473,4849002,319,56818,8711,27,37226,4962,23,227,17200.0,1000.0,-48.0,-60.0,-42.0,-39.0,-48.0,-59.0,-42.0,-39.0,-88.0,-88.0,-84.0,-84.0,40.0,28.0,42.0,45.0,1
4903,92:69:1D:31:68:E9,3840361,487486304,3930,3626768,3836431,483859536,0,4829,1108786,4685,1076181,144,32605,2127,10,4138,87,0,44,229410.0,130000.0,-52.0,-48.0,-44.0,-46.0,-51.0,-47.0,-43.0,-47.0,-88.0,-88.0,-84.0,-84.0,36.0,40.0,40.0,38.0,1
4904,CC:2F:71:3F:1F:24,4646036,1355803921,809605,871944385,3836431,483859536,37,654933,684613112,654206,684525658,727,87454,631431,15,809862,88128,34,522,130000.0,43333.0,-69.0,-66.0,-68.0,-70.0,-69.0,-66.0,-67.0,-70.0,-88.0,-88.0,-84.0,-84.0,19.0,22.0,16.0,14.0,1
4905,CC:2F:71:3E:C5:1F,3837312,483967147,881,107611,3836431,483859536,0,3678,308839,3034,232403,644,76436,932,9,1266,20,0,41,130000.0,39000.0,-80.0,-84.0,-76.0,-71.0,-73.0,-74.0,-70.0,-62.0,-88.0,-88.0,-84.0,-84.0,8.0,4.0,8.0,13.0,1
4906,BA:8C:B9:54:50:24,3841271,490042765,4840,6183229,3836431,483859536,0,9030,1701843,9008,1698348,22,3495,2348,15,5283,39,0,58,216660.0,130000.0,-40.0,-37.0,-45.0,-52.0,-43.0,-35.0,-43.0,-48.0,-88.0,-88.0,-84.0,-84.0,48.0,51.0,39.0,32.0,1
4907,62:47:05:9D:EB:15,3836484,483870458,49,10271,3836435,483860187,0,122,13519,111,11353,11,2166,38,0,71,0,0,5,216660.0,130000.0,-47.0,-44.0,-46.0,-54.0,-50.0,-48.0,-47.0,-53.0,-88.0,-88.0,-84.0,-84.0,41.0,44.0,38.0,30.0,1
4908,3C:55:76:E8:8F:1F,3873686,574463291,37249,90602902,3836437,483860389,23,20092,4982275,19773,4925457,319,56818,8766,27,37302,5034,23,228,24370.0,1000.0,-49.0,-54.0,-40.0,-40.0,-48.0,-57.0,-41.0,-39.0,-88.0,-88.0,-84.0,-84.0,39.0,34.0,44.0,44.0,1
4909,92:69:1D:31:68:E9,3840369,487487359,3930,3626768,3836439,483860591,0,4829,1108786,4685,1076181,144,32605,2127,10,4138,87,0,44,229410.0,130000.0,-52.0,-48.0,-44.0,-46.0,-51.0,-47.0,-43.0,-47.0,-88.0,-88.0,-84.0,-84.0,36.0,40.0,40.0,38.0,1
4910,CC:2F:71:3F:1F:24,4646330,1356177267,809889,872316474,3836441,483860793,37,655209,684982681,654482,684895227,727,87454,631693,15,810139,88142,34,523,130000.0,43333.0,-69.0,-66.0,-68.0,-70.0,-69.0,-66.0,-67.0,-69.0,-88.0,-88.0,-84.0,-84.0,19.0,22.0,16.0,14.0,1
4911,CC:2F:71:3E:C5:1F,3837322,483968404,881,107611,3836441,483860793,0,3678,308839,3034,232403,644,76436,932,9,1266,20,0,41,130000.0,39000.0,-80.0,-84.0,-76.0,-71.0,-73.0,-74.0,-70.0,-62.0,-88.0,-88.0,-84.0,-84.0,8.0,4.0,8.0,13.0,1
4912,BA:8C:B9:54:50:24,3841281,490044022,4840,6183229,3836441,483860793,0,9030,1701843,9008,1698348,22,3495,2348,15,5283,39,0,58,216660.0,130000.0,-40.0,-37.0,-45.0,-52.0,-43.0,-35.0,-43.0,-48.0,-88.0,-88.0,-84.0,-84.0,48.0,51.0,39.0,32.0,1
4913,62:47:05:9D:EB:15,3836494,483871386,49,10271,3836445,483861115,0,122,13519,111,11353,11,2166,38,0,71,0,0,5,216660.0,130000.0,-47.0,-44.0,-46.0,-54.0,-50.0,-48.0,-47.0,-53.0,-88.0,-88.0,-84.0,-84.0,41.0,44.0,38.0,30.0,1
4914,3C:55:76:E8:8F:1F,3874949,577722730,38504,93861615,3836445,483861115,23,20463,5039894,20143,4982970,320,56924,9011,27,38549,5142,23,228,130000.0,48750.0,-51.0,-56.0,-42.0,-42.0,-51.0,-55.0,-42.0,-42.0,-88.0,-88.0,-84.0,-84.0,37.0,32.0,42.0,42.0,1
4915,92:69:1D:31:68:E9,3840375,487487883,3930,3626768,3836445,483861115,0,4829,1108786,4685,1076181,144,32605,2127,10,4138,87,0,44,229410.0,130000.0,-52.0,-48.0,-44.0,-46.0,-51.0,-47.0,-43.0,-47.0,-88.0,-88.0,-84.0,-84.0,36.0,40.0,40.0,38.0,1
4916,CC:2F:71:3F:1F:24,4646592,1356511055,810145,872649738,3836447,483861317,37,655443,685302837,654716,685215383,727,87454,631924,15,810402,88194,34,523,130000.0,43333.0,-69.0,-66.0,-68.0,-69.0,-68.0,-66.0,-67.0,-69.0,-88.0,-88.0,-84.0,-84.0,19.0,22.0,16.0,15.0,1
4917,CC:2F:71:3E:C5:1F,3837329,483968988,881,107611,3836448,483861377,0,3678,308839,3034,232403,644,76436,932,9,1266,20,0,41,130000.0,39000.0,-80.0,-84.0,-76.0,-71.0,-73.0,-74.0,-70.0,-62.0,-88.0,-88.0,-84.0,-84.0,8.0,4.0,8.0,13.0,1
4918,BA:8C:B9:54:50:24,3841288,490044606,4840,6183229,3836448,483861377,0,9030,1701843,9008,1698348,22,3495,2348,15,5283,39,0,58,216660.0,130000.0,-40.0,-37.0,-45.0,-52.0,-43.0,-35.0,-43.0,-48.0,-88.0,-88.0,-84.0,-84.0,48.0,51.0,39.0,32.0,1
4919,62:47:05:9D:EB:15,3836501,483872052,49,10271,3836452,483861781,0,122,13519,111,11353,11,2166,38,0,71,0,0,5,216660.0,130000.0,-47.0,-44.0,-46.0,-54.0,-50.0,-48.0,-47.0,-53.0,-88.0,-88.0,-84.0,-84.0,41.0,44.0,38.0,30.0,1
4920,3C:55:76:E8:8F:1F,3876842,582699701,40390,98837920,3836452,483861781,23,20946,5110487,20625,5053457,321,57030,9255,27,40418,5321,23,228,143380.0,86020.0,-49.0,-55.0,-46.0,-44.0,-47.0,-55.0,-47.0,-42.0,-88.0,-88.0,-84.0,-84.0,39.0,33.0,38.0,40.0,1
4921,92:69:1D:31:68:E9,3840384,487488751,3930,3626768,3836454,483861983,0,4829,1108786,4685,1076181,144,32605,2127,10,4138,87,0,44,229410.0,130000.0,-52.0,-48.0,-44.0,-46.0,-51.0,-47.0,-43.0,-47.0,-88.0,-88.0,-84.0,-84.0,36.0,40.0,40.0,38.0,1
4922,CC:2F:71:3F:1F:24,4646884,1356879664,810428,873017561,3836456,483862103,37,655712,685667629,654985,685580175,727,87454,632183,15,810685,88202,34,523,144444.0,43333.0,-68.0,-65.0,-68.0,-70.0,-68.0,-65.0,-67.0,-70.0,-88.0,-88.0,-84.0,-84.0,20.0,23.0,16.0,14.0,1
4923,CC:2F:71:3E:C5:1F,3837337,483969714,881,107611,3836456,483862103,0,3678,308839,3034,232403,644,76436,932,9,1266,20,0,41,130000.0,39000.0,-80.0,-84.0,-76.0,-71.0,-73.0,-74.0,-70.0,-62.0,-88.0,-88.0,-84.0,-84.0,8.0,4.0,8.0,13.0,1
4924,BA:8C:B9:54:50:24,3841296,490045332,4840,6183229,3836456,483862103,0,9030,1701843,9008,1698348,22,3495,2348,15,5283,39,0,58,216660.0,130000.0,-40.0,-37.0,-45.0,-52.0,-43.0,-35.0,-43.0,-48.0,-88.0,-88.0,-84.0,-84.0,48.0,51.0,39.0,32.0,1
4925,62:47:05:9D:EB:15,3836511,483872980,49,10271,3836462,483862709,0,122,13519,111,11353,11,2166,38,0,71,0,0,5,216660.0,130000.0,-47.0,-44.0,-46.0,-54.0,-50.0,-48.0,-47.0,-53.0,-88.0,-88.0,-84.0,-84.0,41.0,44.0,38.0,30.0,1
4926,3C:55:76:E8:8F:1F,3878272,586472720,41810,102610011,3836462,483862709,23,21324,5160011,21002,5102875,322,57136,9449,27,41870,5588,23,228,143380.0,81250.0,-44.0,-53.0,-49.0,-38.0,-45.0,-53.0,-49.0,-39.0,-88.0,-88.0,-84.0,-84.0,44.0,35.0,35.0,46.0,1
4927,92:69:1D:31:68:E9,3840392,487489477,3930,3626768,3836462,483862709,0,4829,1108786,4685,1076181,144,32605,2127,10,4138,87,0,44,229410.0,130000.0,-52.0,-48.0,-44.0,-46.0,-51.0,-47.0,-43.0,-47.0,-88.0,-88.0,-84.0,-84.0,36.0,40.0,40.0,38.0,1
4928,CC:2F:71:3F:1F:24,4647122,1357174942,810660,873312233,3836462,483862709,37,655924,685950881,655197,685863427,727,87454,632387,15,810917,88205,34,523,144444.0,43333.0,-68.0,-66.0,-67.0,-70.0,-68.0,-66.0,-67.0,-70.0,-88.0,-88.0,-84.0,-84.0,20.0,22.0,17.0,14.0,1
4929,CC:2F:71:3E:C5:1F,3837343,483970320,881,107611,3836462,483862709,0,3678,308839,3034,232403,644,76436,932,9,1266,20,0,41,130000.0,39000.0,-80.0,-84.0,-76.0,-71.0,-73.0,-74.0,-70.0,-62.0,-88.0,-88.0,-84.0,-84.0,8.0,4.0,8.0,13.0,1
4930,BA:8C:B9:54:50:24,3841302,490045938,4840,6183229,3836462,483862709,0,9030,1701843,9008,1698348,22,3495,2348,15,5283,39,0,58,216660.0,130000.0,-40.0,-37.0,-45.0,-52.0,-43.0,-35.0,-43.0,-48.0,-88.0,-88.0,-84.0,-84.0,48.0,51.0,39.0,32.0,1
4931,62:47:05:9D:EB:15,3836513,483873182,49,10271,3836464,483862911,0,122,13519,111,11353,11,2166,38,0,71,0,0,5,216660.0,130000.0,-47.0,-44.0,-46.0,-54.0,-50.0,-48.0,-47.0,-53.0,-88.0,-88.0,-84.0,-84.0,41.0,44.0,38.0,30.0,1
4932,3C:55:76:E8:8F:1F,3878277,586473424,41813,102610513,3836464,483862911,23,21344,5162807,21022,5105671,322,57136,9454,27,41873,5588,23,228,143380.0,81250.0,-51.0,-60.0,-46.0,-45.0,-50.0,-58.0,-45.0,-45.0,-88.0,-88.0,-84.0,-84.0,37.0,28.0,38.0,39.0,1
4933,92:69:1D:31:68:E9,3840396,487489881,3930,3626768,3836466,483863113,0,4829,1108786,4685,1076181,144,32605,2127,10,4138,87,0,44,229410.0,130000.0,-52.0,-48.0,-44.0,-46.0,-51.0,-47.0,-43.0,-47.0,-88.0,-88.0,-84.0,-84.0,36.0,40.0,40.0,38.0,1
4934,CC:2F:71:3F:1F:24,4647339,1357444716,810873,873581603,3836466,483863113,37,656119,686210517,655392,686123063,727,87454,632576,15,811130,88207,34,523,144444.0,43333.0,-68.0,-66.0,-68.0,-70.0,-68.0,-66.0,-67.0,-70.0,-88.0,-88.0,-84.0,-84.0,20.0,22.0,16.0,14.0,1
4935,CC:2F:71:3E:C5:1F,3837347,483970724,881,107611,3836466,483863113,0,3678,308839,3034,232403,644,76436,932,9,1266,20,0,41,130000.0,39000.0,-80.0,-84.0,-76.0,-71.0,-73.0,-74.0,-70.0,-62.0,-88.0,-88.0,-84.0,-84.0,8.0,4.0,8.0,13.0,1
4936,BA:8C:B9:54:50:24,3841306,490046342,4840,6183229,3836466,483863113,0,9030,1701843,9008,1698348,22,3495,2348,15,5283,39,0,58,216660.0,130000.0,-40.0,-37.0,-45.0,-52.0,-43.0,-35.0,-43.0,-48.0,-88.0,-88.0,-84.0,-84.0,48.0,51.0,39.0,32.0,1
4937,62:47:05:9D:EB:15,3836520,483873848,49,10271,3836471,483863577,0,122,13519,111,11353,11,2166,38,0,71,0,0,5,216660.0,130000.0,-47.0,-44.0,-46.0,-54.0,-50.0,-48.0,-47.0,-53.0,-88.0,-88.0,-84.0,-84.0,41.0,44.0,38.0,30.0,1
4938,3C:55:76:E8:8F:1F,3878286,586474322,41815,102610745,3836471,483863577,23,21350,5163255,21028,5106119,322,57136,9455,27,41875,5592,23,229,143380.0,81250.0,-45.0,-55.0,-50.0,-40.0,-46.0,-56.0,-48.0,-40.0,-88.0,-88.0,-84.0,-84.0,43.0,33.0,34.0,44.0,1
4939,92:69:1D:31:68:E9,3840401,487490345,3930,3626768,3836471,483863577,0,4829,1108786,4685,1076181,144,32605,2127,10,4138,87,0,44,229410.0,130000.0,-52.0,-48.0,-44.0,-46.0,-51.0,-47.0,-43.0,-47.0,-88.0,-88.0,-84.0,-84.0,36.0,40.0,40.0,38.0,1
4940,CC:2F:71:3F:1F:24,4647563,1357721012,811092,873857435,3836471,483863577,37,656316,686476193,655589,686388739,727,87454,632768,15,811349,88211,34,524,144444.0,43333.0,-68.0,-66.0,-67.0,-70.0,-68.0,-65.0,-67.0,-70.0,-88.0,-88.0,-84.0,-84.0,20.0,22.0,17.0,14.0,1
4941,CC:2F:71:3E:C5:1F,3837353,483971304,882,107727,3836471,483863577,0,3679,308909,3035,232473,644,76436,932,9,1267,20,0,41,130000.0,39000.0,-70.0,-71.0,-69.0,-60.0,-73.0,-74.0,-70.0,-62.0,-88.0,-88.0,-84.0,-84.0,18.0,17.0,15.0,24.0,1
4942,BA:8C:B9:54:50:24,3841314,490047124,4841,6183345,3836473,483863779,0,9032,1701979,9010,1698484,22,3495,2348,15,5284,39,0,58,216660.0,130000.0,-48.0,-35.0,-43.0,-46.0,-44.0,-35.0,-43.0,-47.0,-88.0,-88.0,-84.0,-84.0,40.0,53.0,41.0,38.0,1
4943,62:47:05:9D:EB:15,3836524,483874252,49,10271,3836475,483863981,0,122,13519,111,11353,11,2166,38,0,71,0,0,5,216660.0,130000.0,-47.0,-44.0,-46.0,-54.0,-50.0,-48.0,-47.0,-53.0,-88.0,-88.0,-84.0,-84.0,41.0,44.0,38.0,30.0,1
4944,3C:55:76:E8:8F:1F,3878291,586474856,41816,102610875,3836475,483863981,23,21364,5164308,21042,5107172,322,57136,9457,27,41876,5594,23,231,143380.0,81250.0,-45.0,-55.0,-49.0,-39.0,-45.0,-55.0,-48.0,-38.0,-88.0,-88.0,-84.0,-84.0,43.0,33.0,35.0,45.0,1
4945,92:69:1D:31:68:E9,3840406,487490865,3931,3626884,3836475,483863981,0,4831,1108922,4687,1076317,144,32605,2127,10,4139,87,0,44,229410.0,130000.0,-52.0,-47.0,-43.0,-49.0,-51.0,-47.0,-43.0,-47.0,-88.0,-88.0,-84.0,-84.0,36.0,41.0,41.0,35.0,1
4946,CC:2F:71:3F:1F:24,4647792,1357995035,811317,874131054,3836475,483863981,37,656518,686732888,655791,686645434,727,87454,632966,15,811574,88225,34,524,144444.0,43333.0,-69.0,-65.0,-68.0,-70.0,-69.0,-65.0,-67.0,-69.0,-88.0,-88.0,-84.0,-84.0,19.0,23.0,16.0,14.0,1
4947,CC:2F:71:3E:C5:1F,3837361,483972112,882,107727,3836479,483864385,0,3680,308979,3036,232543,644,76436,932,9,1267,20,0,41,130000.0,39000.0,-79.0,-80.0,-74.0,-70.0,-74.0,-75.0,-71.0,-64.0,-88.0,-88.0,-84.0,-84.0,9.0,8.0,10.0,14.0,1
4948,BA:8C:B9:54:50:24,3841320,490047730,4841,6183345,3836479,483864385,0,9032,1701979,9010,1698484,22,3495,2348,15,5284,39,0,58,216660.0,130000.0,-48.0,-35.0,-43.0,-46.0,-44.0,-35.0,-43.0,-47.0,-88.0,-88.0,-84.0,-84.0,40.0,53.0,41.0,38.0,1
4949,62:47:05:9D:EB:15,3836532,483875167,50,10387,3836482,483864780,0,124,13655,113,11489,11,2166,38,0,72,0,0,5,216660.0,130000.0,-49.0,-45.0,-51.0,-51.0,-50.0,-46.0,-47.0,-55.0,-88.0,-88.0,-84.0,-84.0,39.0,43.0,33.0,33.0,1
4950,3C:55:76:E8:8F:1F,3878300,586475857,41816,102610875,3836484,483864982,23,21374,5164990,21052,5107854,322,57136,9457,27,41876,5594,23,232,143380.0,81250.0,-45.0,-55.0,-49.0,-38.0,-44.0,-55.0,-49.0,-38.0,-88.0,-88.0,-84.0,-84.0,43.0,33.0,35.0,46.0,1
4951,92:69:1D:31:68:E9,3840415,487491866,3931,3626884,3836484,483864982,0,4831,1108922,4687,1076317,144,32605,2127,10,4139,87,0,44,229410.0,130000.0,-52.0,-47.0,-43.0,-49.0,-51.0,-47.0,-43.0,-47.0,-88.0,-88.0,-84.0,-84.0,36.0,41.0,41.0,35.0,1
4952,CC:2F:71:3F:1F:24,4648012,1358258012,811528,874393030,3836484,483864982,37,656715,686987268,655987,686899696,728,87572,633155,15,811785,88227,34,524,144444.0,43333.0,-69.0,-66.0,-68.0,-70.0,-68.0,-65.0,-67.0,-70.0,-88.0,-88.0,-84.0,-84.0,19.0,22.0,16.0,14.0,1
4953,CC:2F:71:3E:C5:1F,3837366,483972709,882,107727,3836484,483864982,0,3680,308979,3036,232543,644,76436,932,9,1267,20,0,41,130000.0,39000.0,-79.0,-80.0,-74.0,-70.0,-74.0,-75.0,-71.0,-64.0,-88.0,-88.0,-84.0,-84.0,9.0,8.0,10.0,14.0,1
4954,BA:8C:B9:54:50:24,3841325,490048327,4841,6183345,3836484,483864982,0,9032,1701979,9010,1698484,22,3495,2348,15,5284,39,0,58,216660.0,130000.0,-48.0,-35.0,-43.0,-46.0,-44.0,-35.0,-43.0,-47.0,-88.0,-88.0,-84.0,-84.0,40.0,53.0,41.0,38.0,1
4955,62:47:05:9D:EB:15,3836538,483875773,50,10387,3836488,483865386,0,124,13655,113,11489,11,2166,38,0,72,0,0,5,216660.0,130000.0,-49.0,-45.0,-51.0,-51.0,-50.0,-46.0,-47.0,-55.0,-88.0,-88.0,-84.0,-84.0,39.0,43.0,33.0,33.0,1
4956,3C:55:76:E8:8F:1F,3878305,586476391,41817,102611005,3836488,483865386,23,21380,5165437,21058,5108301,322,57136,9458,27,41877,5596,23,232,135410.0,81250.0,-51.0,-58.0,-46.0,-45.0,-48.0,-56.0,-46.0,-42.0,-88.0,-88.0,-84.0,-84.0,37.0,30.0,38.0,39.0,1
4957,92:69:1D:31:68:E9,3840421,487492472,3931,3626884,3836490,483865588,0,4831,1108922,4687,1076317,144,32605,2127,10,4139,87,0,44,229410.0,130000.0,-52.0,-47.0,-43.0,-49.0,-51.0,-47.0,-43.0,-47.0,-88.0,-88.0,-84.0,-84.0,36.0,41.0,41.0,35.0,1
4958,CC:2F:71:3F:1F:24,4648231,1358523844,811741,874658256,3836490,483865588,37,656911,687245600,656183,687158028,728,87572,633343,15,811998,88229,34,524,144444.0,43333.0,-69.0,-65.0,-67.0,-71.0,-69.0,-65.0,-67.0,-70.0,-88.0,-88.0,-84.0,-84.0,19.0,23.0,17.0,13.0,1
4959,CC:2F:71:3E:C5:1F,3837372,483973315,882,107727,3836490,483865588,0,3680,308979,3036,232543,644,76436,932,9,1267,20,0,41,130000.0,39000.0,-79.0,-80.0,-74.0,-70.0,-74.0,-75.0,-71.0,-64.0,-88.0,-88.0,-84.0,-84.0,9.0,8.0,10.0,14.0,1
4960,BA:8C:B9:54:50:24,3841331,490048933,4841,6183345,3836490,483865588,0,9032,1701979,9010,1698484,22,3495,2348,15,5284,39,0,58,216660.0,130000.0,-48.0,-35.0,-43.0,-46.0,-44.0,-35.0,-43.0,-47.0,-88.0,-88.0,-84.0,-84.0,40.0,53.0,41.0,38.0,1
4961,62:47:05:9D:EB:15,3836544,483876299,50,10387,3836494,483865912,0,124,13655,113,11489,11,2166,38,0,72,0,0,5,216660.0,130000.0,-49.0,-45.0,-51.0,-51.0,-50.0,-46.0,-47.0,-55.0,-88.0,-88.0,-84.0,-84.0,39.0,43.0,33.0,33.0,1
4962,3C:55:76:E8:8F:1F,3878311,586476917,41817,102611005,3836494,483865912,23,21403,5167272,21080,5110018,323,57254,9461,27,41877,5596,23,234,135410.0,81250.0,-45.0,-52.0,-48.0,-40.0,-45.0,-52.0,-47.0,-39.0,-88.0,-88.0,-84.0,-84.0,43.0,36.0,36.0,44.0,1
4963,92:69:1D:31:68:E9,3840425,487492796,3931,3626884,3836494,483865912,0,4831,1108922,4687,1076317,144,32605,2127,10,4139,87,0,44,229410.0,130000.0,-52.0,-47.0,-43.0,-49.0,-51.0,-47.0,-43.0,-47.0,-88.0,-88.0,-84.0,-84.0,36.0,41.0,41.0,35.0,1
4964,CC:2F:71:3F:1F:24,4648450,1358787815,811956,874921903,3836494,483865912,37,657107,687495870,656379,687408298,728,87572,633534,15,812213,88232,34,524,144444.0,43333.0,-69.0,-65.0,-67.0,-70.0,-68.0,-65.0,-67.0,-70.0,-88.0,-88.0,-84.0,-84.0,19.0,23.0,17.0,14.0,1
4965,CC:2F:71:3E:C5:1F,3837376,483973639,882,107727,3836494,483865912,0,3680,308979,3036,232543,644,76436,932,9,1267,20,0,41,130000.0,39000.0,-79.0,-80.0,-74.0,-70.0,-74.0,-75.0,-71.0,-64.0,-88.0,-88.0,-84.0,-84.0,9.0,8.0,10.0,14.0,1
4966,BA:8C:B9:54:50:24,3841338,490049521,4841,6183345,3836497,483866176,0,9032,1701979,9010,1698484,22,3495,2348,15,5284,39,0,58,216660.0,130000.0,-48.0,-35.0,-43.0,-46.0,-44.0,-35.0,-43.0,-47.0,-88.0,-88.0,-84.0,-84.0,40.0,53.0,41.0,38.0,1
4967,62:47:05:9D:EB:15,3836551,483876967,50,10387,3836501,483866580,0,124,13655,113,11489,11,2166,38,0,72,0,0,5,216660.0,130000.0,-49.0,-45.0,-51.0,-51.0,-50.0,-46.0,-47.0,-55.0,-88.0,-88.0,-84.0,-84.0,39.0,43.0,33.0,33.0,1
4968,3C:55:76:E8:8F:1F,3878318,586477585,41817,102611005,3836501,483866580,23,21404,5167342,21081,5110088,323,57254,9461,27,41877,5596,23,234,135410.0,81250.0,-46.0,-53.0,-48.0,-40.0,-45.0,-52.0,-48.0,-39.0,-88.0,-88.0,-84.0,-84.0,42.0,35.0,36.0,44.0,1
4969,92:69:1D:31:68:E9,3840432,487493464,3931,3626884,3836501,483866580,0,4831,1108922,4687,1076317,144,32605,2127,10,4139,87,0,44,229410.0,130000.0,-52.0,-47.0,-43.0,-49.0,-51.0,-47.0,-43.0,-47.0,-88.0,-88.0,-84.0,-84.0,36.0,41.0,41.0,35.0,1
4970,CC:2F:71:3F:1F:24,4648672,1359058099,812171,875191519,3836501,483866580,37,657301,687753906,656573,687666334,728,87572,633723,15,812428,88236,34,524,144444.0,43333.0,-69.0,-65.0,-68.0,-69.0,-68.0,-65.0,-67.0,-70.0,-88.0,-88.0,-84.0,-84.0,19.0,23.0,16.0,15.0,1
4971,CC:2F:71:3E:C5:1F,3837383,483974307,882,107727,3836501,483866580,0,3682,309167,3037,232613,645,76554,933,9,1267,20,0,41,130000.0,39000.0,-70.0,-71.0,-69.0,-60.0,-74.0,-74.0,-71.0,-63.0,-88.0,-88.0,-84.0,-84.0,18.0,17.0,15.0,24.0,1
4972,BA:8C:B9:54:50:24,3841342,490049925,4841,6183345,3836501,483866580,0,9032,1701979,9010,1698484,22,3495,2348,15,5284,39,0,58,216660.0,130000.0,-48.0,-35.0,-43.0,-46.0,-44.0,-35.0,-43.0,-47.0,-88.0,-88.0,-84.0,-84.0,40.0,53.0,41.0,38.0,1
4973,62:47:05:9D:EB:15,3836554,483877231,50,10387,3836504,483866844,0,124,13655,113,11489,11,2166,38,0,72,0,0,5,216660.0,130000.0,-49.0,-45.0,-51.0,-51.0,-50.0,-46.0,-47.0,-55.0,-88.0,-88.0,-84.0,-84.0,39.0,43.0,33.0,33.0,1
4974,3C:55:76:E8:8F:1F,3878323,586478051,41817,102611005,3836506,483867046,23,21414,5168076,21090,5110704,324,57372,9462,27,41877,5596,23,234,135410.0,81250.0,-51.0,-59.0,-47.0,-45.0,-49.0,-58.0,-46.0,-43.0,-88.0,-88.0,-84.0,-84.0,37.0,29.0,37.0,39.0,1
4975,92:69:1D:31:68:E9,3840437,487493930,3931,3626884,3836506,483867046,0,4831,1108922,4687,1076317,144,32605,2127,10,4139,87,0,44,229410.0,130000.0,-52.0,-47.0,-43.0,-49.0,-51.0,-47.0,-43.0,-47.0,-88.0,-88.0,-84.0,-84.0,36.0,41.0,41.0,35.0,1
4976,CC:2F:71:3F:1F:24,4648889,1359324957,812383,875457911,3836506,483867046,37,657500,688018358,656772,687930786,728,87572,633910,15,812640,88238,34,524,144444.0,43333.0,-69.0,-65.0,-68.0,-70.0,-68.0,-65.0,-67.0,-70.0,-88.0,-88.0,-84.0,-84.0,19.0,23.0,16.0,14.0,1
4977,CC:2F:71:3E:C5:1F,3837389,483974833,882,107727,3836507,483867106,0,3682,309167,3037,232613,645,76554,933,9,1267,20,0,41,130000.0,39000.0,-70.0,-71.0,-69.0,-60.0,-74.0,-74.0,-71.0,-63.0,-88.0,-88.0,-84.0,-84.0,18.0,17.0,15.0,24.0,1
4978,BA:8C:B9:54:50:24,3841348,490050451,4841,6183345,3836507,483867106,0,9032,1701979,9010,1698484,22,3495,2348,15,5284,39,0,58,216660.0,130000.0,-48.0,-35.0,-43.0,-46.0,-44.0,-35.0,-43.0,-47.0,-88.0,-88.0,-84.0,-84.0,40.0,53.0,41.0,38.0,1
4979,62:47:05:9D:EB:15,3836562,483877959,50,10387,3836512,483867572,0,124,13655,113,11489,11,2166,38,0,72,0,0,5,216660.0,130000.0,-49.0,-45.0,-51.0,-51.0,-50.0,-46.0,-47.0,-55.0,-88.0,-88.0,-84.0,-84.0,39.0,43.0,33.0,33.0,1
4980,3C:55:76:E8:8F:1F,3878330,586478695,41818,102611123,3836512,483867572,23,21432,5169544,21107,5112054,325,57490,9466,27,41878,5596,23,234,143380.0,81250.0,-46.0,-55.0,-49.0,-40.0,-46.0,-54.0,-48.0,-40.0,-88.0,-88.0,-84.0,-84.0,42.0,33.0,35.0,44.0,1
4981,92:69:1D:31:68:E9,3840443,487494456,3931,3626884,3836512,483867572,0,4831,1108922,4687,1076317,144,32605,2127,10,4139,87,0,44,229410.0,130000.0,-52.0,-47.0,-43.0,-49.0,-51.0,-47.0,-43.0,-47.0,-88.0,-88.0,-84.0,-84.0,36.0,41.0,41.0,35.0,1
4982,CC:2F:71:3F:1F:24,4649107,1359591875,812595,875724303,3836512,483867572,37,657695,688280842,656967,688193270,728,87572,634096,15,812852,88240,34,525,144444.0,43333.0,-69.0,-66.0,-68.0,-70.0,-68.0,-65.0,-67.0,-70.0,-88.0,-88.0,-84.0,-84.0,19.0,22.0,16.0,14.0,1
4983,CC:2F:71:3E:C5:1F,3837394,483975299,882,107727,3836512,483867572,0,3682,309167,3037,232613,645,76554,933,9,1267,20,0,41,130000.0,39000.0,-70.0,-71.0,-69.0,-60.0,-74.0,-74.0,-71.0,-63.0,-88.0,-88.0,-84.0,-84.0,18.0,17.0,15.0,24.0,1
4984,BA:8C:B9:54:50:24,3841353,490050917,4841,6183345,3836512,483867572,0,9032,1701979,9010,1698484,22,3495,2348,15,5284,39,0,58,216660.0,130000.0,-48.0,-35.0,-43.0,-46.0,-44.0,-35.0,-43.0,-47.0,-88.0,-88.0,-84.0,-84.0,40.0,53.0,41.0,38.0,1
4985,62:47:05:9D:EB:15,3836566,483878363,50,10387,3836516,483867976,0,124,13655,113,11489,11,2166,38,0,72,0,0,5,216660.0,130000.0,-49.0,-45.0,-51.0,-51.0,-50.0,-46.0,-47.0,-55.0,-88.0,-88.0,-84.0,-84.0,39.0,43.0,33.0,33.0,1
4986,3C:55:76:E8:8F:1F,3878334,586479099,41818,102611123,3836516,483867976,23,21432,5169544,21107,5112054,325,57490,9466,27,41878,5596,23,234,143380.0,81250.0,-46.0,-55.0,-49.0,-40.0,-46.0,-54.0,-48.0,-40.0,-88.0,-88.0,-84.0,-84.0,42.0,33.0,35.0,44.0,1
4987,92:69:1D:31:68:E9,3840447,487494860,3931,3626884,3836516,483867976,0,4831,1108922,4687,1076317,144,32605,2127,10,4139,87,0,44,229410.0,130000.0,-52.0,-47.0,-43.0,-49.0,-51.0,-47.0,-43.0,-47.0,-88.0,-88.0,-84.0,-84.0,36.0,41.0,41.0,35.0,1
4988,CC:2F:71:3F:1F:24,4649325,1359855796,812809,875987820,3836516,483867976,37,657899,688542128,657171,688454556,728,87572,634289,15,813066,88246,34,525,144444.0,43333.0,-68.0,-66.0,-67.0,-70.0,-68.0,-66.0,-67.0,-70.0,-88.0,-88.0,-84.0,-84.0,20.0,22.0,17.0,14.0,1
4989,CC:2F:71:3E:C5:1F,3837398,483975703,882,107727,3836516,483867976,0,3682,309167,3037,232613,645,76554,933,9,1267,20,0,41,130000.0,39000.0,-70.0,-71.0,-69.0,-60.0,-74.0,-74.0,-71.0,-63.0,-88.0,-88.0,-84.0,-84.0,18.0,17.0,15.0,24.0,1
4990,BA:8C:B9:54:50:24,3841357,490051321,4841,6183345,3836516,483867976,0,9036,1702251,9014,1698756,22,3495,2348,15,5285,39,0,58,216660.0,130000.0,-48.0,-35.0,-43.0,-46.0,-43.0,-35.0,-44.0,-48.0,-88.0,-88.0,-84.0,-84.0,40.0,53.0,41.0,38.0,1
4991,62:47:05:9D:EB:15,3836571,483878827,50,10387,3836521,483868440,0,126,13791,115,11625,11,2166,38,0,73,0,0,5,216660.0,130000.0,-49.0,-45.0,-52.0,-53.0,-48.0,-45.0,-48.0,-53.0,-88.0,-88.0,-84.0,-84.0,39.0,43.0,32.0,31.0,1
4992,3C:55:76:E8:8F:1F,3878340,586479637,41819,102611197,3836521,483868440,23,21437,5169923,21112,5112433,325,57490,9467,27,41879,5598,23,234,143380.0,81250.0,-46.0,-55.0,-50.0,-40.0,-45.0,-54.0,-48.0,-39.0,-88.0,-88.0,-84.0,-84.0,42.0,33.0,34.0,44.0,1
4993,92:69:1D:31:68:E9,3840454,487495526,3931,3626884,3836523,483868642,0,4834,1109126,4690,1076521,144,32605,2127,10,4140,87,0,45,229410.0,130000.0,-52.0,-47.0,-42.0,-49.0,-51.0,-47.0,-43.0,-48.0,-88.0,-88.0,-84.0,-84.0,36.0,41.0,42.0,35.0,1
4994,CC:2F:71:3F:1F:24,4649543,1360119876,813020,876251234,3836523,483868642,37,658089,688794236,657361,688706664,728,87572,634473,15,813277,88250,34,525,144444.0,43333.0,-69.0,-66.0,-68.0,-69.0,-68.0,-66.0,-67.0,-69.0,-88.0,-88.0,-84.0,-84.0,19.0,22.0,16.0,15.0,1
4995,CC:2F:71:3E:C5:1F,3837405,483976369,882,107727,3836523,483868642,0,3682,309167,3037,232613,645,76554,933,9,1267,20,0,41,130000.0,39000.0,-70.0,-71.0,-69.0,-60.0,-74.0,-74.0,-71.0,-63.0,-88.0,-88.0,-84.0,-84.0,18.0,17.0,15.0,24.0,1
4996,BA:8C:B9:54:50:24,3841364,490051987,4841,6183345,3836523,483868642,0,9036,1702251,9014,1698756,22,3495,2348,15,5285,39,0,58,216660.0,130000.0,-48.0,-35.0,-43.0,-46.0,-43.0,-35.0,-44.0,-48.0,-88.0,-88.0,-84.0,-84.0,40.0,53.0,41.0,38.0,1
4997,62:47:05:9D:EB:15,3836575,483879231,50,10387,3836525,483868844,0,126,13791,115,11625,11,2166,38,0,73,0,0,5,216660.0,130000.0,-49.0,-45.0,-52.0,-53.0,-48.0,-45.0,-48.0,-53.0,-88.0,-88.0,-84.0,-84.0,39.0,43.0,32.0,31.0,1
4998,3C:55:76:E8:8F:1F,3878344,586480041,41819,102611197,3836525,483868844,23,21440,5170129,21115,5112639,325,57490,9467,27,41879,5598,23,234,143380.0,81250.0,-48.0,-58.0,-45.0,-42.0,-45.0,-55.0,-48.0,-39.0,-88.0,-88.0,-84.0,-84.0,40.0,30.0,39.0,42.0,1
4999,92:69:1D:31:68:E9,3840456,487495728,3931,3626884,3836525,483868844,0,4834,1109126,4690,1076521,144,32605,2127,10,4140,87,0,45,229410.0,130000.0,-52.0,-47.0,-42.0,-49.0,-51.0,-47.0,-43.0,-48.0,-88.0,-88.0,-84.0,-84.0,36.0,41.0,42.0,35.0,1
5000,CC:2F:71:3F:1F:24,4649759,1360383766,813230,876514518,3836529,483869248,37,658286,689056938,657558,688969366,728,87572,634659,15,813487,88251,34,525,144444.0,43333.0,-68.0,-66.0,-68.0,-70.0,-68.0,-66.0,-67.0,-70.0,-88.0,-88.0,-84.0,-84.0,20.0,22.0,16.0,14.0,1
5001,CC:2F:71:3E:C5:1F,3837411,483976975,882,107727,3836529,483869248,0,3682,309167,3037,232613,645,76554,933,9,1267,20,0,41,130000.0,39000.0,-70.0,-71.0,-69.0,-60.0,-74.0,-74.0,-71.0,-63.0,-88.0,-88.0,-84.0,-84.0,18.0,17.0,15.0,24.0,1
5002,BA:8C:B9:54:50:24,3841370,490052593,4841,6183345,3836529,483869248,0,9036,1702251,9014,1698756,22,3495,2348,15,5285,39,0,58,216660.0,130000.0,-48.0,-35.0,-43.0,-46.0,-43.0,-35.0,-44.0,-48.0,-88.0,-88.0,-84.0,-84.0,40.0,53.0,41.0,38.0,1
5003,62:47:05:9D:EB:15,3836582,483879897,50,10387,3836532,483869510,0,126,13791,115,11625,11,2166,38,0,73,0,0,5,216660.0,130000.0,-49.0,-45.0,-52.0,-53.0,-48.0,-45.0,-48.0,-53.0,-88.0,-88.0,-84.0,-84.0,39.0,43.0,32.0,31.0,1
5004,3C:55:76:E8:8F:1F,3878351,586480707,41819,102611197,3836532,483869510,23,21440,5170129,21115,5112639,325,57490,9467,27,41879,5598,23,234,143380.0,81250.0,-48.0,-58.0,-45.0,-42.0,-45.0,-55.0,-48.0,-39.0,-88.0,-88.0,-84.0,-84.0,40.0,30.0,39.0,42.0,1
5005,92:69:1D:31:68:E9,3840463,487496394,3931,3626884,3836532,483869510,0,4834,1109126,4690,1076521,144,32605,2127,10,4140,87,0,45,229410.0,130000.0,-52.0,-47.0,-42.0,-49.0,-51.0,-47.0,-43.0,-48.0,-88.0,-88.0,-84.0,-84.0,36.0,41.0,42.0,35.0,1
5006,CC:2F:71:3F:1F:24,4649983,1360655689,813451,876786179,3836532,483869510,37,658490,689316604,657762,689229032,728,87572,634857,15,813707,88258,34,525,144444.0,43333.0,-68.0,-66.0,-68.0,-70.0,-68.0,-66.0,-67.0,-70.0,-88.0,-88.0,-84.0,-84.0,20.0,22.0,16.0,14.0,1
5007,CC:2F:71:3E:C5:1F,3837416,483977439,882,107727,3836534,483869712,0,3682,309167,3037,232613,645,76554,933,9,1267,20,0,41,130000.0,39000.0,-70.0,-71.0,-69.0,-60.0,-74.0,-74.0,-71.0,-63.0,-88.0,-88.0,-84.0,-84.0,18.0,17.0,15.0,24.0,1
5008,BA:8C:B9:54:50:24,3841375,490053057,4841,6183345,3836534,483869712,0,9036,1702251,9014,1698756,22,3495,2348,15,5285,39,0,58,216660.0,130000.0,-48.0,-35.0,-43.0,-46.0,-43.0,-35.0,-44.0,-48.0,-88.0,-88.0,-84.0,-84.0,40.0,53.0,41.0,38.0,1
5009,62:47:05:9D:EB:15,3836611,483891526,50,10387,3836561,483881139,0,126,13791,115,11625,11,2166,38,0,73,0,0,5,216660.0,130000.0,-49.0,-45.0,-52.0,-53.0,-48.0,-45.0,-48.0,-53.0,-88.0,-88.0,-84.0,-84.0,39.0,43.0,32.0,31.0,1
5010,3C:55:76:E8:8F:1F,3878380,586492336,41819,102611197,3836561,483881139,23,21440,5170129,21115,5112639,325,57490,9467,27,41879,5598,23,234,143380.0,81250.0,-48.0,-58.0,-45.0,-42.0,-45.0,-55.0,-48.0,-39.0,-88.0,-88.0,-84.0,-84.0,40.0,30.0,39.0,42.0,1
5011,92:69:1D:31:68:E9,3840492,487508023,3931,3626884,3836561,483881139,0,4837,1109497,4692,1076657,145,32840,2128,10,4140,87,0,45,229410.0,130000.0,-52.0,-47.0,-43.0,-49.0,-51.0,-47.0,-43.0,-49.0,-88.0,-88.0,-84.0,-84.0,36.0,41.0,41.0,35.0,1
5012,CC:2F:71:3F:1F:24,4650235,1360949380,813674,877068241,3836561,483881139,37,658701,689592746,657973,689505174,728,87572,635055,15,813931,88258,34,525,144444.0,43333.0,-68.0,-66.0,-67.0,-71.0,-68.0,-66.0,-67.0,-70.0,-88.0,-88.0,-84.0,-84.0,20.0,22.0,17.0,13.0,1
5013,CC:2F:71:3E:C5:1F,3837443,483988866,882,107727,3836561,483881139,0,3682,309167,3037,232613,645,76554,933,9,1267,20,0,41,130000.0,39000.0,-70.0,-71.0,-69.0,-60.0,-74.0,-74.0,-71.0,-63.0,-88.0,-88.0,-84.0,-84.0,18.0,17.0,15.0,24.0,1
5014,BA:8C:B9:54:50:24,3841402,490064484,4841,6183345,3836561,483881139,0,9036,1702251,9014,1698756,22,3495,2348,15,5285,39,0,58,216660.0,130000.0,-48.0,-35.0,-43.0,-46.0,-43.0,-35.0,-44.0,-48.0,-88.0,-88.0,-84.0,-84.0,40.0,53.0,41.0,38.0,1
5015,62:47:05:9D:EB:15,3836615,483891930,50,10387,3836565,483881543,0,126,13791,115,11625,11,2166,38,0,73,0,0,5,216660.0,130000.0,-49.0,-45.0,-52.0,-53.0,-48.0,-45.0,-48.0,-53.0,-88.0,-88.0,-84.0,-84.0,39.0,43.0,32.0,31.0,1
5016,3C:55:76:E8:8F:1F,3878384,586492740,41819,102611197,3836565,483881543,23,21440,5170129,21115,5112639,325,57490,9467,27,41879,5598,23,234,143380.0,81250.0,-48.0,-58.0,-45.0,-42.0,-45.0,-55.0,-48.0,-39.0,-88.0,-88.0,-84.0,-84.0,40.0,30.0,39.0,42.0,1
5017,92:69:1D:31:68:E9,3840497,487508487,3931,3626884,3836566,483881603,0,4837,1109497,4692,1076657,145,32840,2128,10,4140,87,0,45,229410.0,130000.0,-52.0,-47.0,-43.0,-49.0,-51.0,-47.0,-43.0,-49.0,-88.0,-88.0,-84.0,-84.0,36.0,41.0,41.0,35.0,1
5018,CC:2F:71:3F:1F:24,4650449,1361211574,813883,877329971,3836566,483881603,37,658897,689851212,658169,689763640,728,87572,635241,15,814140,88260,34,525,144444.0,43333.0,-68.0,-66.0,-68.0,-70.0,-68.0,-66.0,-67.0,-69.0,-88.0,-88.0,-84.0,-84.0,20.0,22.0,16.0,14.0,1
5019,CC:2F:71:3E:C5:1F,3837448,483989330,882,107727,3836566,483881603,0,3682,309167,3037,232613,645,76554,933,9,1267,20,0,41,130000.0,39000.0,-70.0,-71.0,-69.0,-60.0,-74.0,-74.0,-71.0,-63.0,-88.0,-88.0,-84.0,-84.0,18.0,17.0,15.0,24.0,1
5020,BA:8C:B9:54:50:24,3841407,490064948,4841,6183345,3836566,483881603,0,9036,1702251,9014,1698756,22,3495,2348,15,5285,39,0,58,216660.0,130000.0,-48.0,-35.0,-43.0,-46.0,-43.0,-35.0,-44.0,-48.0,-88.0,-88.0,-84.0,-84.0,40.0,53.0,41.0,38.0,1
5021,62:47:05:9D:EB:15,3836621,483892667,50,10387,3836571,483882280,0,126,13791,115,11625,11,2166,38,0,73,0,0,5,216660.0,130000.0,-49.0,-45.0,-52.0,-53.0,-48.0,-45.0,-48.0,-53.0,-88.0,-88.0,-84.0,-84.0,39.0,43.0,32.0,31.0,1
5022,3C:55:76:E8:8F:1F,3878390,586493477,41819,102611197,3836571,483882280,23,21440,5170129,21115,5112639,325,57490,9467,27,41879,5598,23,234,143380.0,81250.0,-48.0,-58.0,-45.0,-42.0,-45.0,-55.0,-48.0,-39.0,-88.0,-88.0,-84.0,-84.0,40.0,30.0,39.0,42.0,1
5023,92:69:1D:31:68:E9,3840502,487509164,3931,3626884,3836571,483882280,0,4837,1109497,4692,1076657,145,32840,2128,10,4140,87,0,45,229410.0,130000.0,-52.0,-47.0,-43.0,-49.0,-51.0,-47.0,-43.0,-49.0,-88.0,-88.0,-84.0,-84.0,36.0,41.0,41.0,35.0,1
5024,CC:2F:71:3F:1F:24,4650670,1361479779,814099,877597499,3836571,483882280,37,659096,690111856,658368,690024284,728,87572,635431,15,814354,88260,34,525,144444.0,43333.0,-68.0,-66.0,-68.0,-70.0,-68.0,-66.0,-67.0,-70.0,-88.0,-88.0,-84.0,-84.0,20.0,22.0,16.0,14.0,1
5025,CC:2F:71:3E:C5:1F,3837453,483990007,882,107727,3836571,483882280,0,3682,309167,3037,232613,645,76554,933,9,1267,20,0,41,130000.0,39000.0,-70.0,-71.0,-69.0,-60.0,-74.0,-74.0,-71.0,-63.0,-88.0,-88.0,-84.0,-84.0,18.0,17.0,15.0,24.0,1
5026,BA:8C:B9:54:50:24,3841412,490065625,4841,6183345,3836571,483882280,0,9036,1702251,9014,1698756,22,3495,2348,15,5285,39,0,58,216660.0,130000.0,-48.0,-35.0,-43.0,-46.0,-43.0,-35.0,-44.0,-48.0,-88.0,-88.0,-84.0,-84.0,40.0,53.0,41.0,38.0,1
5027,62:47:05:9D:EB:15,3836625,483893071,50,10387,3836575,483882684,0,126,13791,115,11625,11,2166,38,0,73,0,0,5,216660.0,130000.0,-49.0,-45.0,-52.0,-53.0,-48.0,-45.0,-48.0,-53.0,-88.0,-88.0,-84.0,-84.0,39.0,43.0,32.0,31.0,1
5028,3C:55:76:E8:8F:1F,3878394,586493881,41819,102611197,3836575,483882684,23,21458,5171463,21133,5113973,325,57490,9470,27,41879,5598,23,235,143380.0,81250.0,-46.0,-56.0,-50.0,-40.0,-46.0,-55.0,-50.0,-40.0,-88.0,-88.0,-84.0,-84.0,42.0,32.0,34.0,44.0,1
5029,92:69:1D:31:68:E9,3840506,487509568,3931,3626884,3836575,483882684,0,4837,1109497,4692,1076657,145,32840,2128,10,4140,87,0,45,229410.0,130000.0,-52.0,-47.0,-43.0,-49.0,-51.0,-47.0,-43.0,-49.0,-88.0,-88.0,-84.0,-84.0,36.0,41.0,41.0,35.0,1
5030,CC:2F:71:3F:1F:24,4650886,1361744136,814311,877861452,3836575,483882684,37,659289,690362788,658561,690275216,728,87572,635619,15,814567,88260,34,525,144444.0,39000.0,-68.0,-66.0,-68.0,-70.0,-68.0,-66.0,-68.0,-70.0,-88.0,-88.0,-84.0,-84.0,20.0,22.0,16.0,14.0,1
5031,CC:2F:71:3E:C5:1F,3837457,483990411,882,107727,3836575,483882684,0,3682,309167,3037,232613,645,76554,933,9,1267,20,0,41,130000.0,39000.0,-70.0,-71.0,-69.0,-60.0,-74.0,-74.0,-71.0,-63.0,-88.0,-88.0,-84.0,-84.0,18.0,17.0,15.0,24.0,1
5032,BA:8C:B9:54:50:24,3841418,490066231,4841,6183345,3836577,483882886,0,9036,1702251,9014,1698756,22,3495,2348,15,5285,39,0,58,216660.0,130000.0,-48.0,-35.0,-43.0,-46.0,-43.0,-35.0,-44.0,-48.0,-88.0,-88.0,-84.0,-84.0,40.0,53.0,41.0,38.0,1
5033,62:47:05:9D:EB:15,3836630,483893535,50,10387,3836580,483883148,0,126,13791,115,11625,11,2166,38,0,73,0,0,5,216660.0,130000.0,-49.0,-45.0,-52.0,-53.0,-48.0,-45.0,-48.0,-53.0,-88.0,-88.0,-84.0,-84.0,39.0,43.0,32.0,31.0,1
5034,3C:55:76:E8:8F:1F,3878401,586494713,41819,102611197,3836582,483883516,23,21463,5171805,21138,5114315,325,57490,9470,27,41879,5598,23,235,143380.0,81250.0,-46.0,-57.0,-50.0,-40.0,-46.0,-56.0,-50.0,-40.0,-88.0,-88.0,-84.0,-84.0,42.0,31.0,34.0,44.0,1
5035,92:69:1D:31:68:E9,3840513,487510400,3931,3626884,3836582,483883516,0,4837,1109497,4692,1076657,145,32840,2128,10,4140,87,0,45,229410.0,130000.0,-52.0,-47.0,-43.0,-49.0,-51.0,-47.0,-43.0,-49.0,-88.0,-88.0,-84.0,-84.0,36.0,41.0,41.0,35.0,1
5036,CC:2F:71:3F:1F:24,4651100,1362006382,814518,878122866,3836582,483883516,37,659479,690616112,658751,690528540,728,87572,635803,15,814775,88260,34,525,144444.0,43333.0,-68.0,-66.0,-67.0,-71.0,-68.0,-66.0,-67.0,-70.0,-88.0,-88.0,-84.0,-84.0,20.0,22.0,17.0,13.0,1
5037,CC:2F:71:3E:C5:1F,3837464,483991243,882,107727,3836582,483883516,0,3682,309167,3037,232613,645,76554,933,9,1267,20,0,41,130000.0,39000.0,-70.0,-71.0,-69.0,-60.0,-74.0,-74.0,-71.0,-63.0,-88.0,-88.0,-84.0,-84.0,18.0,17.0,15.0,24.0,1
5038,BA:8C:B9:54:50:24,3841424,490066995,4841,6183345,3836583,483883650,0,9036,1702251,9014,1698756,22,3495,2348,15,5285,39,0,58,216660.0,130000.0,-48.0,-35.0,-43.0,-46.0,-43.0,-35.0,-44.0,-48.0,-88.0,-88.0,-84.0,-84.0,40.0,53.0,41.0,38.0,1
5039,62:47:05:9D:EB:15,3836636,483894307,50,10387,3836586,483883920,0,126,13791,115,11625,11,2166,38,0,73,0,0,5,216660.0,130000.0,-49.0,-45.0,-52.0,-53.0,-48.0,-45.0,-48.0,-53.0,-88.0,-88.0,-84.0,-84.0,39.0,43.0,32.0,31.0,1
5040,3C:55:76:E8:8F:1F,3878407,586495584,41821,102611664,3836586,483883920,23,21473,5172826,21148,5115336,325,57490,9473,27,41881,5598,23,235,143380.0,1000.0,-50.0,-57.0,-47.0,-43.0,-46.0,-56.0,-48.0,-39.0,-88.0,-88.0,-84.0,-84.0,38.0,31.0,37.0,41.0,1
5041,92:69:1D:31:68:E9,3840519,487511006,3931,3626884,3836588,483884122,0,4837,1109497,4692,1076657,145,32840,2128,10,4140,87,0,45,229410.0,130000.0,-52.0,-47.0,-43.0,-49.0,-51.0,-47.0,-43.0,-49.0,-88.0,-88.0,-84.0,-84.0,36.0,41.0,41.0,35.0,1
5042,CC:2F:71:3F:1F:24,4651322,1362276706,814732,878392382,3836590,483884324,37,659677,690877592,658949,690790020,728,87572,635993,15,814989,88261,34,525,144444.0,43333.0,-68.0,-66.0,-68.0,-70.0,-68.0,-66.0,-67.0,-70.0,-88.0,-88.0,-84.0,-84.0,20.0,22.0,16.0,14.0,1
5043,CC:2F:71:3E:C5:1F,3837472,483992051,882,107727,3836590,483884324,0,3682,309167,3037,232613,645,76554,933,9,1267,20,0,41,130000.0,39000.0,-70.0,-71.0,-69.0,-60.0,-74.0,-74.0,-71.0,-63.0,-88.0,-88.0,-84.0,-84.0,18.0,17.0,15.0,24.0,1
5044,BA:8C:B9:54:50:24,3841431,490067669,4841,6183345,3836590,483884324,0,9036,1702251,9014,1698756,22,3495,2348,15,5285,39,0,58,216660.0,130000.0,-48.0,-35.0,-43.0,-46.0,-43.0,-35.0,-44.0,-48.0,-88.0,-88.0,-84.0,-84.0,40.0,53.0,41.0,38.0,1
5045,62:47:05:9D:EB:15,3836641,483894771,50,10387,3836591,483884384,0,126,13791,115,11625,11,2166,38,0,73,0,0,5,216660.0,130000.0,-49.0,-45.0,-52.0,-53.0,-48.0,-45.0,-48.0,-53.0,-88.0,-88.0,-84.0,-84.0,39.0,43.0,32.0,31.0,1
5046,3C:55:76:E8:8F:1F,3878424,586504722,41833,102620338,3836591,483884384,23,21506,5183267,21181,5125777,325,57490,9487,28,41894,5603,23,236,143380.0,86020.0,-50.0,-60.0,-47.0,-44.0,-49.0,-57.0,-47.0,-43.0,-88.0,-88.0,-84.0,-84.0,38.0,28.0,37.0,40.0,1
5047,92:69:1D:31:68:E9,3840522,487511268,3931,3626884,3836591,483884384,0,4837,1109497,4692,1076657,145,32840,2128,10,4140,87,0,45,229410.0,130000.0,-52.0,-47.0,-43.0,-49.0,-51.0,-47.0,-43.0,-49.0,-88.0,-88.0,-84.0,-84.0,36.0,41.0,41.0,35.0,1
5048,CC:2F:71:3F:1F:24,4651545,1362544055,814950,878659267,3836595,483884788,37,659876,691132388,659148,691044816,728,87572,636187,15,815207,88261,34,525,144444.0,43333.0,-68.0,-66.0,-68.0,-70.0,-68.0,-66.0,-67.0,-70.0,-88.0,-88.0,-84.0,-84.0,20.0,22.0,16.0,14.0,1
5049,CC:2F:71:3E:C5:1F,3837477,483992515,882,107727,3836595,483884788,0,3682,309167,3037,232613,645,76554,933,9,1267,20,0,41,130000.0,39000.0,-70.0,-71.0,-69.0,-60.0,-74.0,-74.0,-71.0,-63.0,-88.0,-88.0,-84.0,-84.0,18.0,17.0,15.0,24.0,1
5050,BA:8C:B9:54:50:24,3841436,490068133,4841,6183345,3836595,483884788,0,9036,1702251,9014,1698756,22,3495,2348,15,5285,39,0,58,216660.0,130000.0,-48.0,-35.0,-43.0,-46.0,-43.0,-35.0,-44.0,-48.0,-88.0,-88.0,-84.0,-84.0,40.0,53.0,41.0,38.0,1
5051,62:47:05:9D:EB:15,3836649,483895579,50,10387,3836599,483885192,0,126,13791,115,11625,11,2166,38,0,73,0,0,5,216660.0,130000.0,-49.0,-45.0,-52.0,-53.0,-48.0,-45.0,-48.0,-53.0,-88.0,-88.0,-84.0,-84.0,39.0,43.0,32.0,31.0,1
5052,3C:55:76:E8:8F:1F,3878433,586505704,41834,102620512,3836599,483885192,23,21523,5184551,21198,5127061,325,57490,9489,28,41895,5603,23,236,143380.0,86020.0,-51.0,-61.0,-47.0,-45.0,-50.0,-60.0,-47.0,-45.0,-88.0,-88.0,-84.0,-84.0,37.0,27.0,37.0,39.0,1
5053,92:69:1D:31:68:E9,3840530,487512076,3931,3626884,3836599,483885192,0,4837,1109497,4692,1076657,145,32840,2128,10,4140,87,0,45,229410.0,130000.0,-52.0,-47.0,-43.0,-49.0,-51.0,-47.0,-43.0,-49.0,-88.0,-88.0,-84.0,-84.0,36.0,41.0,41.0,35.0,1
5054,CC:2F:71:3F:1F:24,4651765,1362817195,815166,878932003,3836599,483885192,37,660072,691393464,659344,691305892,728,87572,636379,15,815423,88263,34,525,144444.0,43333.0,-68.0,-66.0,-68.0,-70.0,-68.0,-66.0,-68.0,-70.0,-88.0,-88.0,-84.0,-84.0,20.0,22.0,16.0,14.0,1
5055,CC:2F:71:3E:C5:1F,3837481,483992919,882,107727,3836599,483885192,0,3682,309167,3037,232613,645,76554,933,9,1267,20,0,41,130000.0,39000.0,-70.0,-71.0,-69.0,-60.0,-74.0,-74.0,-71.0,-63.0,-88.0,-88.0,-84.0,-84.0,18.0,17.0,15.0,24.0,1
5056,BA:8C:B9:54:50:24,3841440,490068537,4841,6183345,3836599,483885192,0,9036,1702251,9014,1698756,22,3495,2348,15,5285,39,0,58,216660.0,130000.0,-48.0,-35.0,-43.0,-46.0,-43.0,-35.0,-44.0,-48.0,-88.0,-88.0,-84.0,-84.0,40.0,53.0,41.0,38.0,1
5057,62:47:05:9D:EB:15,3836653,483895983,50,10387,3836603,483885596,0,126,13791,115,11625,11,2166,38,0,73,0,0,5,216660.0,130000.0,-49.0,-45.0,-52.0,-53.0,-48.0,-45.0,-48.0,-53.0,-88.0,-88.0,-84.0,-84.0,39.0,43.0,32.0,31.0,1
5058,3C:55:76:E8:8F:1F,3878438,586506168,41834,102620512,3836604,483885656,23,21523,5184551,21198,5127061,325,57490,9489,28,41895,5603,23,236,143380.0,86020.0,-51.0,-61.0,-47.0,-45.0,-50.0,-60.0,-47.0,-45.0,-88.0,-88.0,-84.0,-84.0,37.0,27.0,37.0,39.0,1
5059,92:69:1D:31:68:E9,3840535,487512540,3931,3626884,3836604,483885656,0,4837,1109497,4692,1076657,145,32840,2128,10,4140,87,0,45,229410.0,130000.0,-52.0,-47.0,-43.0,-49.0,-51.0,-47.0,-43.0,-49.0,-88.0,-88.0,-84.0,-84.0,36.0,41.0,41.0,35.0,1
5060,CC:2F:71:3F:1F:24,4651982,1363081203,815378,879195547,3836604,483885656,37,660265,691646062,659537,691558490,728,87572,636565,15,815635,88265,34,525,144444.0,43333.0,-69.0,-65.0,-67.0,-70.0,-69.0,-65.0,-67.0,-70.0,-88.0,-88.0,-84.0,-84.0,19.0,23.0,17.0,14.0,1
5061,CC:2F:71:3E:C5:1F,3837486,483993383,882,107727,3836604,483885656,0,3682,309167,3037,232613,645,76554,933,9,1267,20,0,41,130000.0,39000.0,-70.0,-71.0,-69.0,-60.0,-74.0,-74.0,-71.0,-63.0,-88.0,-88.0,-84.0,-84.0,18.0,17.0,15.0,24.0,1
5062,BA:8C:B9:54:50:24,3841445,490069001,4841,6183345,3836604,483885656,0,9036,1702251,9014,1698756,22,3495,2348,15,5285,39,0,58,216660.0,130000.0,-48.0,-35.0,-43.0,-46.0,-43.0,-35.0,-44.0,-48.0,-88.0,-88.0,-84.0,-84.0,40.0,53.0,41.0,38.0,1
5063,62:47:05:9D:EB:15,3836658,483896447,50,10387,3836608,483886060,0,126,13791,115,11625,11,2166,38,0,73,0,0,5,216660.0,130000.0,-49.0,-45.0,-52.0,-53.0,-48.0,-45.0,-48.0,-53.0,-88.0,-88.0,-84.0,-84.0,39.0,43.0,32.0,31.0,1
5064,3C:55:76:E8:8F:1F,3878442,586506572,41834,102620512,3836608,483886060,23,21523,5184551,21198,5127061,325,57490,9489,28,41895,5603,23,236,143380.0,86020.0,-51.0,-61.0,-47.0,-45.0,-50.0,-60.0,-47.0,-45.0,-88.0,-88.0,-84.0,-84.0,37.0,27.0,37.0,39.0,1
5065,92:69:1D:31:68:E9,3840539,487512944,3931,3626884,3836608,483886060,0,4837,1109497,4692,1076657,145,32840,2128,10,4140,87,0,45,229410.0,130000.0,-52.0,-47.0,-43.0,-49.0,-51.0,-47.0,-43.0,-49.0,-88.0,-88.0,-84.0,-84.0,36.0,41.0,41.0,35.0,1
5066,CC:2F:71:3F:1F:24,4652207,1363351730,815599,879465670,3836608,483886060,37,660466,691904050,659738,691816478,728,87572,636759,15,815856,88266,34,525,144444.0,43333.0,-69.0,-65.0,-68.0,-70.0,-69.0,-65.0,-68.0,-70.0,-88.0,-88.0,-84.0,-84.0,19.0,23.0,16.0,14.0,1
5067,CC:2F:71:3E:C5:1F,3837490,483993787,882,107727,3836608,483886060,0,3682,309167,3037,232613,645,76554,933,9,1267,20,0,41,130000.0,39000.0,-70.0,-71.0,-69.0,-60.0,-74.0,-74.0,-71.0,-63.0,-88.0,-88.0,-84.0,-84.0,18.0,17.0,15.0,24.0,1
5068,BA:8C:B9:54:50:24,3841449,490069405,4841,6183345,3836608,483886060,0,9036,1702251,9014,1698756,22,3495,2348,15,5285,39,0,58,216660.0,130000.0,-48.0,-35.0,-43.0,-46.0,-43.0,-35.0,-44.0,-48.0,-88.0,-88.0,-84.0,-84.0,40.0,53.0,41.0,38.0,1
5069,62:47:05:9D:EB:15,3836662,483896851,50,10387,3836612,483886464,0,127,13859,116,11693,11,2166,38,0,73,0,0,5,216660.0,130000.0,-49.0,-45.0,-52.0,-54.0,-48.0,-44.0,-49.0,-53.0,-88.0,-88.0,-84.0,-84.0,39.0,43.0,32.0,30.0,1
5070,3C:55:76:E8:8F:1F,3878447,586508189,41835,102621725,3836612,483886464,23,21534,5185339,21209,5127849,325,57490,9490,28,41896,5605,23,236,135410.0,81250.0,-46.0,-57.0,-51.0,-40.0,-45.0,-56.0,-50.0,-40.0,-88.0,-88.0,-84.0,-84.0,42.0,31.0,33.0,44.0,1
5071,92:69:1D:31:68:E9,3840543,487513348,3931,3626884,3836612,483886464,0,4837,1109497,4692,1076657,145,32840,2128,10,4140,87,0,45,229410.0,130000.0,-52.0,-47.0,-43.0,-49.0,-51.0,-47.0,-43.0,-49.0,-88.0,-88.0,-84.0,-84.0,36.0,41.0,41.0,35.0,1
5072,CC:2F:71:3F:1F:24,4652423,1363618526,815811,879732062,3836612,483886464,37,660667,692169032,659939,692081460,728,87572,636947,15,816068,88266,34,525,144444.0,43333.0,-68.0,-65.0,-68.0,-70.0,-68.0,-65.0,-67.0,-70.0,-88.0,-88.0,-84.0,-84.0,20.0,23.0,16.0,14.0,1
5073,CC:2F:71:3E:C5:1F,3837494,483994191,882,107727,3836612,483886464,0,3682,309167,3037,232613,645,76554,933,9,1267,20,0,41,130000.0,39000.0,-70.0,-71.0,-69.0,-60.0,-74.0,-74.0,-71.0,-63.0,-88.0,-88.0,-84.0,-84.0,18.0,17.0,15.0,24.0,1
5074,BA:8C:B9:54:50:24,3841454,490069869,4841,6183345,3836613,483886524,0,9036,1702251,9014,1698756,22,3495,2348,15,5285,39,0,58,216660.0,130000.0,-48.0,-35.0,-43.0,-46.0,-43.0,-35.0,-44.0,-48.0,-88.0,-88.0,-84.0,-84.0,40.0,53.0,41.0,38.0,1
5075,62:47:05:9D:EB:15,3836667,483897315,50,10387,3836617,483886928,0,127,13859,116,11693,11,2166,38,0,73,0,0,5,216660.0,130000.0,-49.0,-45.0,-52.0,-54.0,-48.0,-44.0,-49.0,-53.0,-88.0,-88.0,-84.0,-84.0,39.0,43.0,32.0,30.0,1
5076,3C:55:76:E8:8F:1F,3878452,586508653,41835,102621725,3836617,483886928,23,21534,5185339,21209,5127849,325,57490,9490,28,41896,5605,23,236,135410.0,81250.0,-46.0,-57.0,-51.0,-40.0,-45.0,-56.0,-50.0,-40.0,-88.0,-88.0,-84.0,-84.0,42.0,31.0,33.0,44.0,1
5077,92:69:1D:31:68:E9,3840549,487513928,3932,3627000,3836617,483886928,0,4838,1109565,4693,1076725,145,32840,2128,10,4141,87,0,45,229410.0,130000.0,-52.0,-47.0,-44.0,-48.0,-52.0,-47.0,-43.0,-49.0,-88.0,-88.0,-84.0,-84.0,36.0,41.0,40.0,36.0,1
5078,CC:2F:71:3F:1F:24,4652639,1363882390,816022,879995462,3836617,483886928,37,660860,692420112,660132,692332540,728,87572,637134,15,816279,88268,34,525,144444.0,43333.0,-69.0,-65.0,-67.0,-70.0,-69.0,-65.0,-67.0,-70.0,-88.0,-88.0,-84.0,-84.0,19.0,23.0,17.0,14.0,1
5079,CC:2F:71:3E:C5:1F,3837500,483994771,883,107843,3836617,483886928,0,3684,309307,3039,232753,645,76554,933,9,1268,20,0,41,130000.0,39000.0,-71.0,-71.0,-69.0,-60.0,-73.0,-75.0,-71.0,-63.0,-88.0,-88.0,-84.0,-84.0,17.0,17.0,15.0,24.0,1
5080,BA:8C:B9:54:50:24,3841462,490070653,4842,6183461,3836620,483887192,0,9038,1702387,9016,1698892,22,3495,2348,15,5286,39,0,58,216660.0,130000.0,-51.0,-35.0,-43.0,-45.0,-45.0,-35.0,-43.0,-47.0,-88.0,-88.0,-84.0,-84.0,37.0,53.0,41.0,39.0,1
5081,62:47:05:9D:EB:15,3836674,483897959,51,10503,3836623,483887456,0,129,13995,118,11829,11,2166,38,0,74,0,0,5,229410.0,130000.0,-50.0,-45.0,-51.0,-54.0,-48.0,-44.0,-50.0,-53.0,-88.0,-88.0,-84.0,-84.0,38.0,43.0,33.0,30.0,1
5082,3C:55:76:E8:8F:1F,3878459,586509241,41836,102621785,3836623,483887456,23,21549,5186413,21223,5128805,326,57608,9491,28,41897,5607,23,237,121870.0,73120.0,-52.0,-60.0,-46.0,-45.0,-51.0,-59.0,-45.0,-44.0,-88.0,-88.0,-84.0,-84.0,36.0,28.0,38.0,39.0,1
5083,92:69:1D:31:68:E9,3840557,487514658,3932,3627000,3836625,483887658,0,4839,1109633,4694,1076793,145,32840,2128,10,4141,87,0,45,229410.0,130000.0,-52.0,-47.0,-42.0,-49.0,-52.0,-47.0,-43.0,-49.0,-88.0,-88.0,-84.0,-84.0,36.0,41.0,42.0,35.0,1
5084,CC:2F:71:3F:1F:24,4652856,1364146274,816231,880258616,3836625,483887658,37,661054,692681028,660326,692593456,728,87572,637318,15,816488,88268,34,525,144444.0,43333.0,-69.0,-66.0,-67.0,-70.0,-69.0,-65.0,-67.0,-69.0,-88.0,-88.0,-84.0,-84.0,19.0,22.0,17.0,14.0,1
5085,CC:2F:71:3E:C5:1F,3837510,483995703,883,107843,3836627,483887860,0,3686,309495,3040,232823,646,76672,934,9,1268,20,0,41,130000.0,39000.0,-71.0,-71.0,-70.0,-60.0,-71.0,-72.0,-69.0,-61.0,-88.0,-88.0,-84.0,-84.0,17.0,17.0,14.0,24.0,1
5086,BA:8C:B9:54:50:24,3841469,490071321,4842,6183461,3836627,483887860,0,9038,1702387,9016,1698892,22,3495,2348,15,5286,39,0,58,216660.0,130000.0,-51.0,-35.0,-43.0,-45.0,-45.0,-35.0,-43.0,-47.0,-87.0,-88.0,-84.0,-83.0,36.0,53.0,41.0,38.0,1
5087,62:47:05:9D:EB:15,3836680,483898696,51,10503,3836629,483888193,0,129,13995,118,11829,11,2166,38,0,74,0,0,5,229410.0,130000.0,-50.0,-45.0,-51.0,-54.0,-48.0,-44.0,-50.0,-53.0,-87.0,-88.0,-84.0,-83.0,37.0,43.0,33.0,29.0,1
5088,3C:55:76:E8:8F:1F,3878465,586509978,41836,102621785,3836629,483888193,23,21549,5186413,21223,5128805,326,57608,9491,28,41897,5607,23,237,121870.0,73120.0,-52.0,-60.0,-46.0,-45.0,-51.0,-59.0,-45.0,-44.0,-87.0,-88.0,-84.0,-83.0,35.0,28.0,38.0,38.0,1
5089,92:69:1D:31:68:E9,3840564,487515457,3932,3627000,3836632,483888457,0,4839,1109633,4694,1076793,145,32840,2128,10,4141,87,0,45,229410.0,130000.0,-52.0,-47.0,-42.0,-49.0,-52.0,-47.0,-43.0,-49.0,-87.0,-88.0,-84.0,-83.0,35.0,41.0,42.0,34.0,1
5090,CC:2F:71:3F:1F:24,4653079,1364413698,816447,880525241,3836632,483888457,37,661253,692938700,660525,692851128,728,87572,637510,15,816704,88270,34,525,144444.0,43333.0,-68.0,-65.0,-68.0,-70.0,-68.0,-65.0,-67.0,-69.0,-87.0,-88.0,-84.0,-83.0,19.0,23.0,16.0,13.0,1
5091,CC:2F:71:3E:C5:1F,3837517,483996502,883,107843,3836634,483888659,0,3686,309495,3040,232823,646,76672,934,9,1268,20,0,41,130000.0,39000.0,-71.0,-71.0,-70.0,-60.0,-71.0,-72.0,-69.0,-61.0,-87.0,-88.0,-84.0,-83.0,16.0,17.0,14.0,23.0,1
5092,BA:8C:B9:54:50:24,3841476,490072120,4842,6183461,3836634,483888659,0,9039,1702455,9017,1698960,22,3495,2348,15,5286,39,0,58,216660.0,130000.0,-48.0,-35.0,-43.0,-45.0,-45.0,-35.0,-43.0,-47.0,-87.0,-88.0,-84.0,-83.0,39.0,53.0,41.0,38.0,1
5093,62:47:05:9D:EB:15,3836689,483899566,51,10503,3836638,483889063,0,129,13995,118,11829,11,2166,38,0,74,0,0,5,229410.0,130000.0,-50.0,-45.0,-51.0,-54.0,-48.0,-44.0,-50.0,-53.0,-87.0,-88.0,-84.0,-83.0,37.0,43.0,33.0,29.0,1
5094,3C:55:76:E8:8F:1F,3878474,586510848,41836,102621785,3836638,483889063,23,21555,5186875,21228,5129149,327,57726,9492,28,41897,5607,23,237,121870.0,73120.0,-52.0,-61.0,-46.0,-46.0,-49.0,-58.0,-45.0,-42.0,-87.0,-88.0,-84.0,-83.0,35.0,27.0,38.0,37.0,1
5095,92:69:1D:31:68:E9,3840570,487516063,3932,3627000,3836638,483889063,0,4839,1109633,4694,1076793,145,32840,2128,10,4141,87,0,45,229410.0,130000.0,-52.0,-47.0,-42.0,-49.0,-52.0,-47.0,-43.0,-49.0,-87.0,-88.0,-84.0,-83.0,35.0,41.0,42.0,34.0,1
5096,CC:2F:71:3F:1F:24,4653297,1364677848,816659,880788785,3836638,483889063,37,661444,693186506,660716,693098934,728,87572,637696,15,816916,88270,34,525,144444.0,43333.0,-69.0,-66.0,-68.0,-70.0,-68.0,-65.0,-67.0,-70.0,-87.0,-88.0,-84.0,-83.0,18.0,22.0,16.0,13.0,1
5097,CC:2F:71:3E:C5:1F,3837521,483996906,883,107843,3836638,483889063,0,3686,309495,3040,232823,646,76672,934,9,1268,20,0,41,130000.0,39000.0,-71.0,-71.0,-70.0,-60.0,-71.0,-72.0,-69.0,-61.0,-87.0,-88.0,-84.0,-83.0,16.0,17.0,14.0,23.0,1
5098,BA:8C:B9:54:50:24,3841480,490072524,4842,6183461,3836638,483889063,0,9039,1702455,9017,1698960,22,3495,2348,15,5286,39,0,58,216660.0,130000.0,-48.0,-35.0,-43.0,-45.0,-45.0,-35.0,-43.0,-47.0,-87.0,-88.0,-84.0,-83.0,39.0,53.0,41.0,38.0,1
5099,62:47:05:9D:EB:15,3836694,483900030,51,10503,3836643,483889527,0,129,13995,118,11829,11,2166,38,0,74,0,0,5,229410.0,130000.0,-50.0,-45.0,-51.0,-54.0,-48.0,-44.0,-50.0,-53.0,-87.0,-88.0,-84.0,-83.0,37.0,43.0,33.0,29.0,1
5100,3C:55:76:E8:8F:1F,3880137,590904522,43494,107014995,3836643,483889527,23,21947,5241437,21620,5183711,327,57726,9695,28,43555,5633,23,238,195000.0,97500.0,-49.0,-56.0,-46.0,-42.0,-48.0,-55.0,-46.0,-41.0,-87.0,-88.0,-84.0,-83.0,38.0,32.0,38.0,41.0,1
5101,92:69:1D:31:68:E9,3840575,487516527,3932,3627000,3836643,483889527,0,4839,1109633,4694,1076793,145,32840,2128,10,4141,87,0,45,229410.0,130000.0,-52.0,-47.0,-42.0,-49.0,-52.0,-47.0,-43.0,-49.0,-87.0,-88.0,-84.0,-83.0,35.0,41.0,42.0,34.0,1
5102,CC:2F:71:3F:1F:24,4653523,1364957410,816880,881067883,3836643,483889527,37,661648,693452898,660920,693365326,728,87572,637892,15,817137,88274,34,525,144444.0,43333.0,-68.0,-66.0,-67.0,-71.0,-68.0,-66.0,-67.0,-70.0,-87.0,-88.0,-84.0,-83.0,19.0,22.0,17.0,12.0,1
5103,CC:2F:71:3E:C5:1F,3837526,483997370,883,107843,3836643,483889527,0,3686,309495,3040,232823,646,76672,934,9,1268,20,0,41,130000.0,39000.0,-71.0,-71.0,-70.0,-60.0,-71.0,-72.0,-69.0,-61.0,-87.0,-88.0,-84.0,-83.0,16.0,17.0,14.0,23.0,1
5104,BA:8C:B9:54:50:24,3841485,490072988,4842,6183461,3836643,483889527,0,9039,1702455,9017,1698960,22,3495,2348,15,5286,39,0,58,216660.0,130000.0,-48.0,-35.0,-43.0,-45.0,-45.0,-35.0,-43.0,-47.0,-87.0,-88.0,-84.0,-83.0,39.0,53.0,41.0,38.0,1
5105,62:47:05:9D:EB:15,3836699,483900496,51,10503,3836648,483889993,0,129,13995,118,11829,11,2166,38,0,74,0,0,5,229410.0,130000.0,-50.0,-45.0,-51.0,-54.0,-48.0,-44.0,-50.0,-53.0,-87.0,-88.0,-84.0,-83.0,37.0,43.0,33.0,29.0,1
5106,3C:55:76:E8:8F:1F,3883651,600211630,47003,116321637,3836648,483889993,23,22785,5357739,22458,5300013,327,57726,10173,28,47050,6049,23,239,229410.0,1000.0,-48.0,-56.0,-47.0,-42.0,-49.0,-56.0,-45.0,-42.0,-87.0,-88.0,-84.0,-83.0,39.0,32.0,37.0,41.0,1
5107,92:69:1D:31:68:E9,3840580,487516993,3932,3627000,3836648,483889993,0,4839,1109633,4694,1076793,145,32840,2128,10,4141,87,0,45,229410.0,130000.0,-52.0,-47.0,-42.0,-49.0,-52.0,-47.0,-43.0,-49.0,-87.0,-88.0,-84.0,-83.0,35.0,41.0,42.0,34.0,1
5108,CC:2F:71:3F:1F:24,4653802,1365304233,817152,881414038,3836650,483890195,37,661905,693790275,661176,693702585,729,87690,638142,15,817409,88280,34,525,144444.0,43333.0,-69.0,-66.0,-67.0,-70.0,-69.0,-66.0,-67.0,-70.0,-87.0,-88.0,-84.0,-83.0,18.0,22.0,17.0,13.0,1
5109,CC:2F:71:3E:C5:1F,3837533,483998038,883,107843,3836650,483890195,0,3686,309495,3040,232823,646,76672,934,9,1268,20,0,41,130000.0,39000.0,-71.0,-71.0,-70.0,-60.0,-71.0,-72.0,-69.0,-61.0,-87.0,-88.0,-84.0,-83.0,16.0,17.0,14.0,23.0,1
5110,BA:8C:B9:54:50:24,3841494,490073858,4842,6183461,3836652,483890397,0,9039,1702455,9017,1698960,22,3495,2348,15,5286,39,0,58,216660.0,130000.0,-48.0,-35.0,-43.0,-45.0,-45.0,-35.0,-43.0,-47.0,-87.0,-88.0,-84.0,-83.0,39.0,53.0,41.0,38.0,1
5111,62:47:05:9D:EB:15,3836708,483901364,51,10503,3836657,483890861,0,129,13995,118,11829,11,2166,38,0,74,0,0,5,229410.0,130000.0,-50.0,-45.0,-51.0,-54.0,-48.0,-44.0,-50.0,-53.0,-87.0,-88.0,-84.0,-83.0,37.0,43.0,33.0,29.0,1
5112,3C:55:76:E8:8F:1F,3885897,606151087,49240,122260226,3836657,483890861,23,23334,5434564,23007,5376838,327,57726,10409,29,49303,6061,23,240,172050.0,51610.0,-50.0,-56.0,-47.0,-44.0,-50.0,-58.0,-46.0,-44.0,-87.0,-88.0,-84.0,-83.0,37.0,32.0,37.0,39.0,1
5113,92:69:1D:31:68:E9,3840589,487517861,3932,3627000,3836657,483890861,0,4842,1109837,4697,1076997,145,32840,2128,10,4141,87,0,45,229410.0,130000.0,-52.0,-47.0,-42.0,-49.0,-52.0,-47.0,-43.0,-49.0,-87.0,-88.0,-84.0,-83.0,35.0,41.0,42.0,34.0,1
5114,CC:2F:71:3F:1F:24,4654053,1365621035,817396,881730174,3836657,483890861,37,662128,694090329,661399,694002639,729,87690,638363,15,817653,88283,34,525,144444.0,43333.0,-69.0,-66.0,-67.0,-70.0,-68.0,-66.0,-67.0,-70.0,-87.0,-88.0,-84.0,-83.0,18.0,22.0,17.0,13.0,1
5115,CC:2F:71:3E:C5:1F,3837540,483998704,883,107843,3836657,483890861,0,3686,309495,3040,232823,646,76672,934,9,1268,20,0,41,130000.0,39000.0,-71.0,-71.0,-70.0,-60.0,-71.0,-72.0,-69.0,-61.0,-87.0,-88.0,-84.0,-83.0,16.0,17.0,14.0,23.0,1
5116,BA:8C:B9:54:50:24,3841499,490074322,4842,6183461,3836657,483890861,0,9039,1702455,9017,1698960,22,3495,2348,15,5286,39,0,58,216660.0,130000.0,-48.0,-35.0,-43.0,-45.0,-45.0,-35.0,-43.0,-47.0,-87.0,-88.0,-84.0,-83.0,39.0,53.0,41.0,38.0,1
5117,62:47:05:9D:EB:15,3836713,483902824,51,10503,3836662,483892321,0,129,13995,118,11829,11,2166,38,0,74,0,0,5,229410.0,130000.0,-50.0,-45.0,-51.0,-54.0,-48.0,-44.0,-50.0,-53.0,-87.0,-87.0,-84.0,-83.0,37.0,42.0,33.0,29.0,1
5118,3C:55:76:E8:8F:1F,3885903,606152615,49240,122260226,3836663,483892389,23,23342,5435146,23015,5377420,327,57726,10410,29,49303,6061,23,240,172050.0,51610.0,-51.0,-61.0,-46.0,-45.0,-51.0,-60.0,-46.0,-44.0,-87.0,-87.0,-84.0,-83.0,36.0,26.0,38.0,38.0,1
5119,92:69:1D:31:68:E9,3840595,487519389,3932,3627000,3836663,483892389,0,4842,1109837,4697,1076997,145,32840,2128,10,4141,87,0,45,229410.0,130000.0,-52.0,-47.0,-42.0,-49.0,-52.0,-47.0,-43.0,-49.0,-87.0,-87.0,-84.0,-83.0,35.0,40.0,42.0,34.0,1
5120,CC:2F:71:3F:1F:24,4654270,1365887401,817607,881995012,3836663,483892389,37,662317,694343461,661588,694255771,729,87690,638548,15,817864,88283,34,525,144444.0,43333.0,-69.0,-66.0,-68.0,-69.0,-68.0,-66.0,-67.0,-69.0,-87.0,-87.0,-84.0,-83.0,18.0,21.0,16.0,14.0,1
5121,CC:2F:71:3E:C5:1F,3837546,484000232,883,107843,3836663,483892389,0,3686,309495,3040,232823,646,76672,934,9,1268,20,0,41,130000.0,39000.0,-71.0,-71.0,-70.0,-60.0,-71.0,-72.0,-69.0,-61.0,-87.0,-87.0,-84.0,-83.0,16.0,16.0,14.0,23.0,1
5122,BA:8C:B9:54:50:24,3841505,490075850,4842,6183461,3836663,483892389,0,9039,1702455,9017,1698960,22,3495,2348,15,5286,39,0,58,216660.0,130000.0,-48.0,-35.0,-43.0,-45.0,-45.0,-35.0,-43.0,-47.0,-87.0,-87.0,-84.0,-83.0,39.0,52.0,41.0,38.0,1
5123,62:47:05:9D:EB:15,3836719,483903356,51,10503,3836668,483892853,0,129,13995,118,11829,11,2166,38,0,74,0,0,5,229410.0,130000.0,-50.0,-45.0,-51.0,-54.0,-48.0,-44.0,-50.0,-53.0,-87.0,-87.0,-84.0,-83.0,37.0,42.0,33.0,29.0,1
5124,3C:55:76:E8:8F:1F,3885909,606153245,49241,122260392,3836668,483892853,23,23350,5435825,23023,5378099,327,57726,10412,29,49304,6061,23,240,195000.0,97500.0,-46.0,-58.0,-50.0,-39.0,-46.0,-56.0,-48.0,-39.0,-87.0,-87.0,-84.0,-83.0,41.0,29.0,34.0,44.0,1
5125,92:69:1D:31:68:E9,3840600,487519853,3932,3627000,3836668,483892853,0,4842,1109837,4697,1076997,145,32840,2128,10,4141,87,0,45,229410.0,130000.0,-52.0,-47.0,-42.0,-49.0,-52.0,-47.0,-43.0,-49.0,-87.0,-87.0,-84.0,-83.0,35.0,40.0,42.0,34.0,1
5126,CC:2F:71:3F:1F:24,4654492,1366153198,817824,882260345,3836668,483892853,37,662515,694598156,661786,694510466,729,87690,638740,15,818081,88283,34,525,144444.0,43333.0,-68.0,-66.0,-67.0,-70.0,-68.0,-66.0,-67.0,-70.0,-87.0,-87.0,-84.0,-83.0,19.0,21.0,17.0,13.0,1
5127,CC:2F:71:3E:C5:1F,3837551,484000696,883,107843,3836668,483892853,0,3688,309635,3042,232963,646,76672,934,9,1269,20,0,41,130000.0,39000.0,-71.0,-71.0,-70.0,-60.0,-70.0,-71.0,-69.0,-60.0,-87.0,-87.0,-84.0,-83.0,16.0,16.0,14.0,23.0,1
5128,BA:8C:B9:54:50:24,3841510,490076314,4842,6183461,3836668,483892853,0,9042,1702659,9020,1699164,22,3495,2348,15,5287,39,0,58,216660.0,130000.0,-48.0,-35.0,-43.0,-46.0,-45.0,-35.0,-43.0,-47.0,-87.0,-87.0,-84.0,-83.0,39.0,52.0,41.0,37.0,1
5129,62:47:05:9D:EB:15,3836725,483904884,51,10503,3836674,483894381,0,131,14131,120,11965,11,2166,38,0,75,0,0,5,229410.0,130000.0,-50.0,-46.0,-52.0,-54.0,-49.0,-45.0,-51.0,-53.0,-87.0,-87.0,-84.0,-83.0,37.0,41.0,32.0,29.0,1
5130,3C:55:76:E8:8F:1F,3885915,606154773,49241,122260392,3836674,483894381,23,23350,5435825,23023,5378099,327,57726,10412,29,49304,6061,23,240,195000.0,97500.0,-46.0,-58.0,-50.0,-39.0,-46.0,-56.0,-48.0,-39.0,-87.0,-87.0,-84.0,-83.0,41.0,29.0,34.0,44.0,1
5131,92:69:1D:31:68:E9,3840606,487521381,3932,3627000,3836674,483894381,0,4842,1109837,4697,1076997,145,32840,2128,10,4141,87,0,45,229410.0,130000.0,-52.0,-47.0,-42.0,-49.0,-52.0,-47.0,-43.0,-49.0,-87.0,-87.0,-84.0,-83.0,35.0,40.0,42.0,34.0,1
5132,CC:2F:71:3F:1F:24,4654707,1366415032,818033,882520651,3836674,483894381,37,662703,694848478,661974,694760788,729,87690,638923,15,818290,88283,34,525,144444.0,43333.0,-68.0,-66.0,-68.0,-69.0,-68.0,-66.0,-67.0,-69.0,-87.0,-87.0,-84.0,-83.0,19.0,21.0,16.0,14.0,1
5133,CC:2F:71:3E:C5:1F,3837557,484002224,883,107843,3836674,483894381,0,3688,309635,3042,232963,646,76672,934,9,1269,20,0,41,130000.0,39000.0,-71.0,-71.0,-70.0,-60.0,-70.0,-71.0,-69.0,-60.0,-87.0,-87.0,-84.0,-83.0,16.0,16.0,14.0,23.0,1
5134,BA:8C:B9:54:50:24,3841516,490077842,4842,6183461,3836674,483894381,0,9042,1702659,9020,1699164,22,3495,2348,15,5287,39,0,58,216660.0,130000.0,-48.0,-35.0,-43.0,-46.0,-45.0,-35.0,-43.0,-47.0,-87.0,-87.0,-84.0,-83.0,39.0,52.0,41.0,37.0,1
5135,62:47:05:9D:EB:15,3836729,483905288,51,10503,3836678,483894785,0,131,14131,120,11965,11,2166,38,0,75,0,0,5,229410.0,130000.0,-50.0,-46.0,-52.0,-54.0,-49.0,-45.0,-51.0,-53.0,-87.0,-87.0,-84.0,-83.0,37.0,41.0,32.0,29.0,1
5136,3C:55:76:E8:8F:1F,3885919,606155177,49241,122260392,3836678,483894785,23,23350,5435825,23023,5378099,327,57726,10412,29,49304,6061,23,240,195000.0,97500.0,-46.0,-58.0,-50.0,-39.0,-46.0,-56.0,-48.0,-39.0,-87.0,-87.0,-84.0,-83.0,41.0,29.0,34.0,44.0,1
5137,92:69:1D:31:68:E9,3840610,487521785,3932,3627000,3836678,483894785,0,4842,1109837,4697,1076997,145,32840,2128,10,4141,87,0,45,229410.0,130000.0,-52.0,-47.0,-42.0,-49.0,-52.0,-47.0,-43.0,-49.0,-87.0,-87.0,-84.0,-83.0,35.0,40.0,42.0,34.0,1
5138,CC:2F:71:3F:1F:24,4654921,1366675675,818242,882780828,3836679,483894847,37,662893,695098931,662164,695011241,729,87690,639108,15,818499,88286,34,525,144444.0,43333.0,-68.0,-66.0,-67.0,-70.0,-68.0,-66.0,-67.0,-70.0,-87.0,-87.0,-84.0,-83.0,19.0,21.0,17.0,13.0,1
5139,CC:2F:71:3E:C5:1F,3837564,484002892,883,107843,3836681,483895049,0,3688,309635,3042,232963,646,76672,934,9,1269,20,0,41,130000.0,39000.0,-71.0,-71.0,-70.0,-60.0,-70.0,-71.0,-69.0,-60.0,-87.0,-87.0,-84.0,-83.0,16.0,16.0,14.0,23.0,1
5140,BA:8C:B9:54:50:24,3841524,490078570,4842,6183461,3836682,483895109,0,9042,1702659,9020,1699164,22,3495,2348,15,5287,39,0,58,216660.0,130000.0,-48.0,-35.0,-43.0,-46.0,-45.0,-35.0,-43.0,-47.0,-87.0,-87.0,-84.0,-83.0,39.0,52.0,41.0,37.0,1
5141,62:47:05:9D:EB:15,3836737,483906938,51,10503,3836686,483896435,0,131,14131,120,11965,11,2166,38,0,75,0,0,5,229410.0,130000.0,-50.0,-46.0,-52.0,-54.0,-49.0,-45.0,-51.0,-53.0,-87.0,-87.0,-84.0,-83.0,37.0,41.0,32.0,29.0,1
5142,3C:55:76:E8:8F:1F,3885928,606156895,49242,122260460,3836686,483896435,23,23371,5437373,23043,5379529,328,57844,10414,29,49305,6061,23,243,195000.0,97500.0,-48.0,-56.0,-44.0,-39.0,-48.0,-59.0,-44.0,-40.0,-87.0,-87.0,-84.0,-83.0,39.0,31.0,40.0,44.0,1
5143,92:69:1D:31:68:E9,3840618,487523435,3932,3627000,3836686,483896435,0,4842,1109837,4697,1076997,145,32840,2128,10,4141,87,0,45,229410.0,130000.0,-52.0,-47.0,-42.0,-49.0,-52.0,-47.0,-43.0,-49.0,-87.0,-87.0,-84.0,-83.0,35.0,40.0,42.0,34.0,1
5144,CC:2F:71:3F:1F:24,4655140,1366940693,818452,883044056,3836688,483896637,37,663081,695346361,662352,695258671,729,87690,639293,15,818709,88362,34,525,130000.0,43333.0,-68.0,-66.0,-68.0,-70.0,-68.0,-66.0,-67.0,-69.0,-87.0,-87.0,-84.0,-83.0,19.0,21.0,16.0,13.0,1
5145,CC:2F:71:3E:C5:1F,3837573,484004682,883,107843,3836690,483896839,0,3688,309635,3042,232963,646,76672,934,9,1269,20,0,41,130000.0,39000.0,-71.0,-71.0,-70.0,-60.0,-70.0,-71.0,-69.0,-60.0,-87.0,-87.0,-84.0,-83.0,16.0,16.0,14.0,23.0,1
5146,BA:8C:B9:54:50:24,3841532,490080300,4842,6183461,3836690,483896839,0,9042,1702659,9020,1699164,22,3495,2348,15,5287,39,0,58,216660.0,130000.0,-48.0,-35.0,-43.0,-46.0,-45.0,-35.0,-43.0,-47.0,-87.0,-87.0,-84.0,-83.0,39.0,52.0,41.0,37.0,1
5147,62:47:05:9D:EB:15,3836743,483907544,51,10503,3836692,483897041,0,131,14131,120,11965,11,2166,38,0,75,0,0,5,229410.0,130000.0,-50.0,-46.0,-52.0,-54.0,-49.0,-45.0,-51.0,-53.0,-87.0,-87.0,-84.0,-83.0,37.0,41.0,32.0,29.0,1
5148,3C:55:76:E8:8F:1F,3885936,606157777,49244,122260736,3836692,483897041,23,23380,5438110,23052,5380266,328,57844,10416,29,49307,6061,23,243,195000.0,97500.0,-47.0,-54.0,-45.0,-40.0,-48.0,-54.0,-46.0,-41.0,-87.0,-87.0,-84.0,-83.0,40.0,33.0,39.0,43.0,1
5149,92:69:1D:31:68:E9,3840624,487524041,3932,3627000,3836692,483897041,0,4842,1109837,4697,1076997,145,32840,2128,10,4141,87,0,45,229410.0,130000.0,-52.0,-47.0,-42.0,-49.0,-52.0,-47.0,-43.0,-49.0,-87.0,-87.0,-84.0,-83.0,35.0,40.0,42.0,34.0,1
5150,CC:2F:71:3F:1F:24,4655362,1367207741,818670,883310700,3836692,483897041,37,663279,695599773,662550,695512083,729,87690,639487,15,818927,88417,34,525,115556.0,28889.0,-68.0,-66.0,-66.0,-71.0,-68.0,-66.0,-66.0,-70.0,-87.0,-87.0,-84.0,-83.0,19.0,21.0,18.0,12.0,1
5151,CC:2F:71:3E:C5:1F,3837575,484004884,883,107843,3836692,483897041,0,3688,309635,3042,232963,646,76672,934,9,1269,20,0,41,130000.0,39000.0,-71.0,-71.0,-70.0,-60.0,-70.0,-71.0,-69.0,-60.0,-87.0,-87.0,-84.0,-83.0,16.0,16.0,14.0,23.0,1
5152,BA:8C:B9:54:50:24,3841536,490080704,4842,6183461,3836694,483897243,0,9042,1702659,9020,1699164,22,3495,2348,15,5287,39,0,58,216660.0,130000.0,-48.0,-35.0,-43.0,-46.0,-45.0,-35.0,-43.0,-47.0,-87.0,-87.0,-84.0,-83.0,39.0,52.0,41.0,37.0,1
5153,62:47:05:9D:EB:15,3836749,483908281,51,10503,3836698,483897778,0,131,14131,120,11965,11,2166,38,0,75,0,0,5,229410.0,130000.0,-50.0,-46.0,-52.0,-54.0,-49.0,-45.0,-51.0,-53.0,-87.0,-87.0,-84.0,-83.0,37.0,41.0,32.0,29.0,1
5154,3C:55:76:E8:8F:1F,3885942,606158514,49244,122260736,3836698,483897778,23,23387,5438588,23059,5380744,328,57844,10416,29,49307,6061,23,243,195000.0,97500.0,-46.0,-55.0,-46.0,-41.0,-46.0,-54.0,-45.0,-40.0,-87.0,-87.0,-84.0,-83.0,41.0,32.0,38.0,42.0,1
5155,92:69:1D:31:68:E9,3840632,487524980,3932,3627000,3836700,483897980,0,4842,1109837,4697,1076997,145,32840,2128,10,4141,87,0,45,229410.0,130000.0,-52.0,-47.0,-42.0,-49.0,-52.0,-47.0,-43.0,-49.0,-87.0,-87.0,-84.0,-83.0,35.0,40.0,42.0,34.0,1
5156,CC:2F:71:3F:1F:24,4655576,1367465748,818876,883567768,3836700,483897980,37,663463,695842329,662734,695754639,729,87690,639669,15,819133,88417,34,525,115556.0,28889.0,-68.0,-65.0,-67.0,-70.0,-68.0,-65.0,-66.0,-69.0,-87.0,-87.0,-84.0,-83.0,19.0,22.0,17.0,13.0,1
5157,CC:2F:71:3E:C5:1F,3837583,484005823,883,107843,3836700,483897980,0,3688,309635,3042,232963,646,76672,934,9,1269,20,0,41,130000.0,39000.0,-71.0,-71.0,-70.0,-60.0,-70.0,-71.0,-69.0,-60.0,-87.0,-87.0,-84.0,-83.0,16.0,16.0,14.0,23.0,1
5158,BA:8C:B9:54:50:24,3841542,490081441,4842,6183461,3836700,483897980,0,9042,1702659,9020,1699164,22,3495,2348,15,5287,39,0,58,216660.0,130000.0,-48.0,-35.0,-43.0,-46.0,-45.0,-35.0,-43.0,-47.0,-87.0,-87.0,-84.0,-83.0,39.0,52.0,41.0,37.0,1
5159,62:47:05:9D:EB:15,3836753,483908685,51,10503,3836702,483898182,0,131,14131,120,11965,11,2166,38,0,75,0,0,5,229410.0,130000.0,-50.0,-46.0,-52.0,-54.0,-49.0,-45.0,-51.0,-53.0,-87.0,-87.0,-84.0,-83.0,37.0,41.0,32.0,29.0,1
5160,3C:55:76:E8:8F:1F,3885946,606158918,49244,122260736,3836702,483898182,23,23387,5438588,23059,5380744,328,57844,10416,29,49307,6061,23,243,195000.0,97500.0,-46.0,-55.0,-46.0,-41.0,-46.0,-54.0,-45.0,-40.0,-87.0,-87.0,-84.0,-83.0,41.0,32.0,38.0,42.0,1
5161,92:69:1D:31:68:E9,3840636,487525384,3932,3627000,3836704,483898384,0,4842,1109837,4697,1076997,145,32840,2128,10,4141,87,0,45,229410.0,130000.0,-52.0,-47.0,-42.0,-49.0,-52.0,-47.0,-43.0,-49.0,-87.0,-87.0,-84.0,-83.0,35.0,40.0,42.0,34.0,1
5162,CC:2F:71:3F:1F:24,4656219,1368283727,819515,884385343,3836704,483898384,37,663865,696132938,663136,696045248,729,87690,640049,15,819766,88426,34,525,115556.0,28889.0,-69.0,-66.0,-67.0,-71.0,-68.0,-65.0,-67.0,-70.0,-87.0,-87.0,-84.0,-83.0,18.0,21.0,17.0,12.0,1
5163,CC:2F:71:3E:C5:1F,3837587,484006227,883,107843,3836704,483898384,0,3688,309635,3042,232963,646,76672,934,9,1269,20,0,41,130000.0,39000.0,-71.0,-71.0,-70.0,-60.0,-70.0,-71.0,-69.0,-60.0,-87.0,-87.0,-84.0,-83.0,16.0,16.0,14.0,23.0,1
5164,BA:8C:B9:54:50:24,3841546,490081845,4842,6183461,3836704,483898384,0,9042,1702659,9020,1699164,22,3495,2348,15,5287,39,0,58,216660.0,130000.0,-48.0,-35.0,-43.0,-46.0,-45.0,-35.0,-43.0,-47.0,-87.0,-87.0,-84.0,-83.0,39.0,52.0,41.0,37.0,1
5165,62:47:05:9D:EB:15,3836759,483909291,51,10503,3836708,483898788,0,131,14131,120,11965,11,2166,38,0,75,0,0,5,229410.0,130000.0,-50.0,-46.0,-52.0,-54.0,-49.0,-45.0,-51.0,-53.0,-87.0,-87.0,-84.0,-83.0,37.0,41.0,32.0,29.0,1
5166,3C:55:76:E8:8F:1F,3885954,606159815,49245,122260967,3836709,483898848,23,23398,5439445,23070,5381601,328,57844,10418,29,49308,6061,23,243,195000.0,97500.0,-45.0,-56.0,-45.0,-42.0,-45.0,-55.0,-45.0,-41.0,-87.0,-87.0,-84.0,-83.0,42.0,31.0,39.0,41.0,1
5167,92:69:1D:31:68:E9,3840641,487525848,3932,3627000,3836709,483898848,0,4842,1109837,4697,1076997,145,32840,2128,10,4141,87,0,45,229410.0,130000.0,-52.0,-47.0,-42.0,-49.0,-52.0,-47.0,-43.0,-49.0,-87.0,-87.0,-84.0,-83.0,35.0,40.0,42.0,34.0,1
5168,CC:2F:71:3F:1F:24,4656642,1368806962,819933,884908114,3836709,483898848,37,664163,696404924,663434,696317234,729,87690,640338,15,820190,88441,34,526,115556.0,28889.0,-68.0,-65.0,-67.0,-71.0,-68.0,-65.0,-67.0,-70.0,-87.0,-87.0,-84.0,-83.0,19.0,22.0,17.0,12.0,1
5169,CC:2F:71:3E:C5:1F,3837592,484006691,883,107843,3836709,483898848,0,3688,309635,3042,232963,646,76672,934,9,1269,20,0,41,130000.0,39000.0,-71.0,-71.0,-70.0,-60.0,-70.0,-71.0,-69.0,-60.0,-87.0,-87.0,-84.0,-83.0,16.0,16.0,14.0,23.0,1
5170,BA:8C:B9:54:50:24,3841551,490082309,4842,6183461,3836709,483898848,0,9042,1702659,9020,1699164,22,3495,2348,15,5287,39,0,58,216660.0,130000.0,-48.0,-35.0,-43.0,-46.0,-45.0,-35.0,-43.0,-47.0,-87.0,-87.0,-84.0,-83.0,39.0,52.0,41.0,37.0,1
5171,62:47:05:9D:EB:15,3836765,483909881,51,10503,3836714,483899378,0,131,14131,120,11965,11,2166,38,0,75,0,0,5,229410.0,130000.0,-50.0,-46.0,-52.0,-54.0,-49.0,-45.0,-51.0,-53.0,-87.0,-87.0,-84.0,-83.0,37.0,41.0,32.0,29.0,1
5172,3C:55:76:E8:8F:1F,3885959,606160345,49245,122260967,3836714,483899378,23,23407,5440059,23079,5382215,328,57844,10418,29,49308,6061,23,243,195000.0,97500.0,-46.0,-57.0,-46.0,-42.0,-45.0,-56.0,-46.0,-42.0,-87.0,-87.0,-84.0,-83.0,41.0,30.0,38.0,41.0,1
5173,92:69:1D:31:68:E9,3840646,487526378,3932,3627000,3836714,483899378,0,4842,1109837,4697,1076997,145,32840,2128,10,4141,87,0,45,229410.0,130000.0,-52.0,-47.0,-42.0,-49.0,-52.0,-47.0,-43.0,-49.0,-87.0,-87.0,-84.0,-83.0,35.0,40.0,42.0,34.0,1
5174,CC:2F:71:3F:1F:24,4656860,1369074000,820146,885174622,3836714,483899378,37,664360,696663182,663631,696575492,729,87690,640527,15,820403,88442,34,526,115556.0,28889.0,-67.0,-65.0,-67.0,-72.0,-67.0,-65.0,-67.0,-71.0,-87.0,-87.0,-84.0,-83.0,20.0,22.0,17.0,11.0,1
5175,CC:2F:71:3E:C5:1F,3837597,484007221,883,107843,3836714,483899378,0,3688,309635,3042,232963,646,76672,934,9,1269,20,0,41,130000.0,39000.0,-71.0,-71.0,-70.0,-60.0,-70.0,-71.0,-69.0,-60.0,-87.0,-87.0,-84.0,-83.0,16.0,16.0,14.0,23.0,1
5176,BA:8C:B9:54:50:24,3841556,490082839,4842,6183461,3836714,483899378,0,9042,1702659,9020,1699164,22,3495,2348,15,5287,39,0,58,216660.0,130000.0,-48.0,-35.0,-43.0,-46.0,-45.0,-35.0,-43.0,-47.0,-87.0,-87.0,-84.0,-83.0,39.0,52.0,41.0,37.0,1
5177,62:47:05:9D:EB:15,3836769,483910285,51,10503,3836718,483899782,0,131,14131,120,11965,11,2166,38,0,75,0,0,5,229410.0,130000.0,-50.0,-46.0,-52.0,-54.0,-49.0,-45.0,-51.0,-53.0,-87.0,-87.0,-84.0,-83.0,37.0,41.0,32.0,29.0,1
5178,3C:55:76:E8:8F:1F,3885963,606160749,49245,122260967,3836718,483899782,23,23407,5440059,23079,5382215,328,57844,10418,29,49308,6061,23,243,195000.0,97500.0,-46.0,-57.0,-46.0,-42.0,-45.0,-56.0,-46.0,-42.0,-87.0,-87.0,-84.0,-83.0,41.0,30.0,38.0,41.0,1
5179,92:69:1D:31:68:E9,3840650,487526782,3932,3627000,3836718,483899782,0,4842,1109837,4697,1076997,145,32840,2128,10,4141,87,0,45,229410.0,130000.0,-52.0,-47.0,-42.0,-49.0,-52.0,-47.0,-43.0,-49.0,-87.0,-87.0,-84.0,-83.0,35.0,40.0,42.0,34.0,1
5180,CC:2F:71:3F:1F:24,4657073,1369334430,820355,885434648,3836718,483899782,37,664555,696912722,663826,696825032,729,87690,640714,15,820612,88459,34,526,117000.0,39000.0,-67.0,-65.0,-67.0,-72.0,-67.0,-65.0,-67.0,-70.0,-87.0,-87.0,-84.0,-83.0,20.0,22.0,17.0,11.0,1
5181,CC:2F:71:3E:C5:1F,3837603,484007827,883,107843,3836720,483899984,0,3688,309635,3042,232963,646,76672,934,9,1269,20,0,41,130000.0,39000.0,-71.0,-71.0,-70.0,-60.0,-70.0,-71.0,-69.0,-60.0,-87.0,-87.0,-84.0,-83.0,16.0,16.0,14.0,23.0,1
5182,BA:8C:B9:54:50:24,3841563,490083505,4842,6183461,3836721,483900044,0,9042,1702659,9020,1699164,22,3495,2348,15,5287,39,0,58,216660.0,130000.0,-48.0,-35.0,-43.0,-46.0,-45.0,-35.0,-43.0,-47.0,-87.0,-87.0,-84.0,-83.0,39.0,52.0,41.0,37.0,1
5183,62:47:05:9D:EB:15,3836774,483910749,51,10503,3836723,483900246,0,131,14131,120,11965,11,2166,38,0,75,0,0,5,229410.0,130000.0,-50.0,-46.0,-52.0,-54.0,-49.0,-45.0,-51.0,-53.0,-87.0,-87.0,-84.0,-83.0,37.0,41.0,32.0,29.0,1
5184,3C:55:76:E8:8F:1F,3885973,606164993,49250,122264747,3836723,483900246,23,23432,5445576,23104,5387732,328,57844,10425,29,49313,6061,23,243,195000.0,97500.0,-49.0,-54.0,-47.0,-45.0,-49.0,-53.0,-46.0,-45.0,-87.0,-87.0,-84.0,-83.0,38.0,33.0,37.0,38.0,1
5185,92:69:1D:31:68:E9,3840655,487527246,3932,3627000,3836723,483900246,0,4842,1109837,4697,1076997,145,32840,2128,10,4141,87,0,45,229410.0,130000.0,-52.0,-47.0,-42.0,-49.0,-52.0,-47.0,-43.0,-49.0,-87.0,-87.0,-83.0,-83.0,35.0,40.0,41.0,34.0,1
5186,CC:2F:71:3F:1F:24,4657290,1369600730,820566,885700350,3836724,483900380,37,664749,697170796,664020,697083106,729,87690,640901,15,820823,88485,34,526,130000.0,43333.0,-68.0,-66.0,-67.0,-69.0,-68.0,-66.0,-67.0,-69.0,-87.0,-87.0,-83.0,-83.0,19.0,21.0,16.0,14.0,1
5187,CC:2F:71:3E:C5:1F,3837608,484008291,883,107843,3836725,483900448,0,3688,309635,3042,232963,646,76672,934,9,1269,20,0,41,130000.0,39000.0,-71.0,-71.0,-70.0,-60.0,-70.0,-71.0,-69.0,-60.0,-87.0,-87.0,-83.0,-83.0,16.0,16.0,13.0,23.0,1
5188,BA:8C:B9:54:50:24,3841567,490083909,4842,6183461,3836725,483900448,0,9042,1702659,9020,1699164,22,3495,2348,15,5287,39,0,58,216660.0,130000.0,-48.0,-35.0,-43.0,-46.0,-45.0,-35.0,-43.0,-47.0,-87.0,-87.0,-83.0,-83.0,39.0,52.0,40.0,37.0,1
5189,62:47:05:9D:EB:15,3836780,483911355,51,10503,3836729,483900852,0,131,14131,120,11965,11,2166,38,0,75,0,0,5,229410.0,130000.0,-50.0,-46.0,-52.0,-54.0,-49.0,-45.0,-51.0,-53.0,-87.0,-87.0,-83.0,-83.0,37.0,41.0,31.0,29.0,1
5190,3C:55:76:E8:8F:1F,3885982,606165985,49253,122265133,3836729,483900852,23,23445,5447619,23117,5389775,328,57844,10428,29,49316,6061,23,243,195000.0,97500.0,-48.0,-54.0,-46.0,-40.0,-49.0,-52.0,-45.0,-41.0,-87.0,-87.0,-83.0,-83.0,39.0,33.0,37.0,43.0,1
5191,92:69:1D:31:68:E9,3840661,487527852,3932,3627000,3836729,483900852,0,4842,1109837,4697,1076997,145,32840,2128,10,4141,87,0,45,229410.0,130000.0,-52.0,-47.0,-42.0,-49.0,-52.0,-47.0,-43.0,-49.0,-87.0,-87.0,-83.0,-83.0,35.0,40.0,41.0,34.0,1
5192,CC:2F:71:3F:1F:24,4657529,1369893153,820800,885992301,3836729,483900852,37,664973,697455955,664244,697368265,729,87690,641113,15,821057,88489,34,526,130000.0,39000.0,-69.0,-65.0,-70.0,-69.0,-69.0,-65.0,-69.0,-69.0,-87.0,-87.0,-83.0,-83.0,18.0,22.0,13.0,14.0,1
5193,CC:2F:71:3E:C5:1F,3837612,484008695,883,107843,3836729,483900852,0,3688,309635,3042,232963,646,76672,934,9,1269,20,0,41,130000.0,39000.0,-71.0,-71.0,-70.0,-60.0,-70.0,-71.0,-69.0,-60.0,-87.0,-87.0,-83.0,-83.0,16.0,16.0,13.0,23.0,1
5194,BA:8C:B9:54:50:24,3841571,490084313,4842,6183461,3836729,483900852,0,9042,1702659,9020,1699164,22,3495,2348,15,5287,39,0,58,216660.0,130000.0,-48.0,-35.0,-43.0,-46.0,-45.0,-35.0,-43.0,-47.0,-87.0,-87.0,-83.0,-83.0,39.0,52.0,40.0,37.0,1
5195,62:47:05:9D:EB:15,3836785,483911819,51,10503,3836734,483901316,0,131,14131,120,11965,11,2166,38,0,75,0,0,5,229410.0,130000.0,-50.0,-46.0,-52.0,-54.0,-49.0,-45.0,-51.0,-53.0,-87.0,-87.0,-83.0,-83.0,37.0,41.0,31.0,29.0,1
5196,3C:55:76:E8:8F:1F,3885987,606166449,49253,122265133,3836734,483901316,23,23454,5448233,23126,5390389,328,57844,10428,29,49316,6061,23,243,195000.0,97500.0,-50.0,-54.0,-46.0,-40.0,-48.0,-53.0,-46.0,-39.0,-87.0,-87.0,-83.0,-83.0,37.0,33.0,37.0,43.0,1
5197,92:69:1D:31:68:E9,3840666,487528316,3932,3627000,3836734,483901316,0,4843,1109905,4698,1077065,145,32840,2128,10,4141,87,0,45,229410.0,130000.0,-53.0,-47.0,-42.0,-49.0,-52.0,-47.0,-43.0,-49.0,-87.0,-87.0,-83.0,-83.0,34.0,40.0,41.0,34.0,1
5198,CC:2F:71:3F:1F:24,4657743,1370154955,821009,886253639,3836734,483901316,37,665171,697721711,664442,697634021,729,87690,641297,15,821266,88510,34,526,130000.0,43333.0,-68.0,-65.0,-68.0,-70.0,-68.0,-65.0,-68.0,-70.0,-87.0,-87.0,-83.0,-83.0,19.0,22.0,15.0,13.0,1
5199,CC:2F:71:3E:C5:1F,3837617,484009159,883,107843,3836734,483901316,0,3688,309635,3042,232963,646,76672,934,9,1269,20,0,41,130000.0,39000.0,-71.0,-71.0,-70.0,-60.0,-70.0,-71.0,-69.0,-60.0,-87.0,-87.0,-83.0,-83.0,16.0,16.0,13.0,23.0,1
5200,BA:8C:B9:54:50:24,3841578,490084979,4842,6183461,3836736,483901518,0,9042,1702659,9020,1699164,22,3495,2348,15,5287,39,0,58,216660.0,130000.0,-48.0,-35.0,-43.0,-46.0,-45.0,-35.0,-43.0,-47.0,-87.0,-87.0,-83.0,-83.0,39.0,52.0,40.0,37.0,1
5201,62:47:05:9D:EB:15,3836789,483912223,51,10503,3836738,483901720,0,131,14131,120,11965,11,2166,38,0,75,0,0,5,229410.0,130000.0,-50.0,-46.0,-52.0,-54.0,-49.0,-45.0,-51.0,-53.0,-87.0,-87.0,-83.0,-83.0,37.0,41.0,31.0,29.0,1
5202,3C:55:76:E8:8F:1F,3885995,606167473,49257,122265753,3836738,483901720,23,23472,5450834,23144,5392990,328,57844,10433,29,49320,6061,23,243,162500.0,1000.0,-52.0,-53.0,-45.0,-44.0,-50.0,-52.0,-44.0,-41.0,-87.0,-87.0,-83.0,-83.0,35.0,34.0,38.0,39.0,1
5203,92:69:1D:31:68:E9,3840672,487528922,3932,3627000,3836740,483901922,0,4843,1109905,4698,1077065,145,32840,2128,10,4141,87,0,45,229410.0,130000.0,-53.0,-47.0,-42.0,-49.0,-52.0,-47.0,-43.0,-49.0,-87.0,-87.0,-83.0,-83.0,34.0,40.0,41.0,34.0,1
5204,CC:2F:71:3F:1F:24,4657962,1370426371,821222,886524449,3836740,483901922,37,665371,697987903,664642,697900213,729,87690,641486,15,821479,88512,34,527,130000.0,43333.0,-69.0,-65.0,-69.0,-70.0,-68.0,-65.0,-68.0,-69.0,-87.0,-87.0,-83.0,-83.0,18.0,22.0,14.0,13.0,1
5205,CC:2F:71:3E:C5:1F,3837623,484009765,883,107843,3836740,483901922,0,3688,309635,3042,232963,646,76672,934,9,1269,20,0,41,130000.0,39000.0,-71.0,-71.0,-70.0,-60.0,-70.0,-71.0,-69.0,-60.0,-87.0,-87.0,-83.0,-83.0,16.0,16.0,13.0,23.0,1
5206,BA:8C:B9:54:50:24,3841582,490085383,4842,6183461,3836740,483901922,0,9042,1702659,9020,1699164,22,3495,2348,15,5287,39,0,58,216660.0,130000.0,-48.0,-35.0,-43.0,-46.0,-45.0,-35.0,-43.0,-47.0,-87.0,-87.0,-83.0,-83.0,39.0,52.0,40.0,37.0,1
5207,62:47:05:9D:EB:15,3836796,483912889,51,10503,3836745,483902386,0,131,14131,120,11965,11,2166,38,0,75,0,0,5,229410.0,130000.0,-50.0,-46.0,-52.0,-54.0,-49.0,-45.0,-51.0,-53.0,-87.0,-87.0,-83.0,-83.0,37.0,41.0,31.0,29.0,1
5208,3C:55:76:E8:8F:1F,3887813,610973107,51068,127070721,3836745,483902386,23,23897,5512426,23569,5454582,328,57844,10582,29,51131,6102,23,245,172050.0,51610.0,-52.0,-52.0,-43.0,-45.0,-52.0,-52.0,-44.0,-43.0,-87.0,-87.0,-83.0,-83.0,35.0,35.0,40.0,38.0,1
5209,92:69:1D:31:68:E9,3840677,487529386,3932,3627000,3836745,483902386,0,4843,1109905,4698,1077065,145,32840,2128,10,4141,87,0,45,229410.0,130000.0,-53.0,-47.0,-42.0,-49.0,-52.0,-47.0,-43.0,-49.0,-87.0,-87.0,-83.0,-83.0,34.0,40.0,41.0,34.0,1
5210,CC:2F:71:3F:1F:24,4658203,1370721468,821458,886819082,3836745,483902386,37,665608,698294982,664879,698207292,729,87690,641697,15,821715,88516,34,527,130000.0,43333.0,-69.0,-65.0,-69.0,-69.0,-69.0,-65.0,-68.0,-69.0,-87.0,-87.0,-83.0,-83.0,18.0,22.0,14.0,14.0,1
5211,CC:2F:71:3E:C5:1F,3837630,484010431,883,107843,3836747,483902588,0,3688,309635,3042,232963,646,76672,934,9,1269,20,0,41,130000.0,39000.0,-71.0,-71.0,-70.0,-60.0,-70.0,-71.0,-69.0,-60.0,-87.0,-87.0,-83.0,-83.0,16.0,16.0,13.0,23.0,1
5212,BA:8C:B9:54:50:24,3841589,490086049,4842,6183461,3836747,483902588,0,9042,1702659,9020,1699164,22,3495,2348,15,5287,39,0,58,216660.0,130000.0,-48.0,-35.0,-43.0,-46.0,-45.0,-35.0,-43.0,-47.0,-87.0,-87.0,-83.0,-83.0,39.0,52.0,40.0,37.0,1
5213,62:47:05:9D:EB:15,3836800,483913293,51,10503,3836749,483902790,0,131,14131,120,11965,11,2166,38,0,75,0,0,5,229410.0,130000.0,-50.0,-46.0,-52.0,-54.0,-49.0,-45.0,-51.0,-53.0,-87.0,-87.0,-83.0,-83.0,37.0,41.0,31.0,29.0,1
5214,3C:55:76:E8:8F:1F,3887818,610973627,51069,127070837,3836749,483902790,23,23906,5513040,23578,5455196,328,57844,10582,29,51132,6102,23,245,172050.0,51610.0,-53.0,-53.0,-44.0,-45.0,-52.0,-52.0,-43.0,-44.0,-87.0,-87.0,-83.0,-83.0,34.0,34.0,39.0,38.0,1
5215,92:69:1D:31:68:E9,3840682,487529906,3933,3627116,3836749,483902790,0,4845,1110041,4700,1077201,145,32840,2128,10,4142,87,0,45,229410.0,130000.0,-52.0,-46.0,-42.0,-49.0,-51.0,-46.0,-43.0,-48.0,-87.0,-87.0,-83.0,-83.0,35.0,41.0,41.0,34.0,1
5216,CC:2F:71:3F:1F:24,4658420,1370985294,821671,887082504,3836749,483902790,37,665805,698549324,665076,698461634,729,87690,641884,15,821928,88529,34,527,130000.0,43333.0,-69.0,-65.0,-68.0,-70.0,-69.0,-65.0,-68.0,-69.0,-87.0,-87.0,-83.0,-83.0,18.0,22.0,15.0,13.0,1
5217,CC:2F:71:3E:C5:1F,3837633,484010749,884,107959,3836749,483902790,0,3690,309775,3044,233103,646,76672,934,9,1270,20,0,41,130000.0,39000.0,-71.0,-71.0,-69.0,-61.0,-70.0,-71.0,-69.0,-60.0,-87.0,-87.0,-83.0,-83.0,16.0,16.0,14.0,22.0,1
5218,BA:8C:B9:54:50:24,3841592,490086367,4843,6183577,3836749,483902790,0,9047,1702999,9025,1699504,22,3495,2348,15,5288,39,0,58,216660.0,130000.0,-48.0,-35.0,-43.0,-45.0,-42.0,-35.0,-43.0,-47.0,-87.0,-87.0,-83.0,-83.0,39.0,52.0,40.0,38.0,1
5219,62:47:05:9D:EB:15,3836807,483913959,52,10563,3836755,483903396,0,133,14267,122,12101,11,2166,38,0,76,0,0,5,229410.0,130000.0,-53.0,-45.0,-53.0,-63.0,-50.0,-45.0,-51.0,-56.0,-87.0,-87.0,-83.0,-83.0,34.0,42.0,30.0,20.0,1
5220,3C:55:76:E8:8F:1F,3887825,610974293,51069,127070837,3836756,483903456,23,23906,5513040,23578,5455196,328,57844,10582,29,51132,6102,23,245,172050.0,51610.0,-53.0,-53.0,-44.0,-45.0,-52.0,-52.0,-43.0,-44.0,-87.0,-87.0,-83.0,-83.0,34.0,34.0,39.0,38.0,1
5221,92:69:1D:31:68:E9,3840689,487530572,3933,3627116,3836756,483903456,0,4845,1110041,4700,1077201,145,32840,2128,10,4142,87,0,45,229410.0,130000.0,-52.0,-46.0,-42.0,-49.0,-51.0,-46.0,-43.0,-48.0,-87.0,-87.0,-83.0,-83.0,35.0,41.0,41.0,34.0,1
5222,CC:2F:71:3F:1F:24,4658638,1371252222,821882,887348766,3836756,483903456,37,666000,698809102,665271,698721412,729,87690,642072,15,822139,88530,34,527,130000.0,43333.0,-69.0,-65.0,-68.0,-70.0,-69.0,-65.0,-67.0,-69.0,-87.0,-87.0,-83.0,-83.0,18.0,22.0,15.0,13.0,1
5223,CC:2F:71:3E:C5:1F,3837640,484011415,884,107959,3836756,483903456,0,3690,309775,3044,233103,646,76672,934,9,1270,20,0,41,130000.0,39000.0,-71.0,-71.0,-69.0,-61.0,-70.0,-71.0,-69.0,-60.0,-87.0,-87.0,-83.0,-83.0,16.0,16.0,14.0,22.0,1
5224,BA:8C:B9:54:50:24,3841600,490087306,4843,6183577,3836757,483903729,0,9047,1702999,9025,1699504,22,3495,2348,15,5288,39,0,58,216660.0,130000.0,-48.0,-35.0,-43.0,-45.0,-42.0,-35.0,-43.0,-47.0,-87.0,-87.0,-83.0,-83.0,39.0,52.0,40.0,38.0,1
5225,62:47:05:9D:EB:15,3836814,483914932,55,11001,3836759,483903931,0,137,14747,126,12581,11,2166,40,0,79,0,0,5,229410.0,130000.0,-53.0,-51.0,-57.0,-56.0,-51.0,-46.0,-53.0,-56.0,-87.0,-87.0,-83.0,-83.0,34.0,36.0,26.0,27.0,1
5226,3C:55:76:E8:8F:1F,3887828,610974768,51069,127070837,3836759,483903931,23,23906,5513040,23578,5455196,328,57844,10582,29,51132,6102,23,245,172050.0,51610.0,-53.0,-53.0,-44.0,-45.0,-52.0,-52.0,-43.0,-44.0,-87.0,-87.0,-83.0,-83.0,34.0,34.0,39.0,38.0,1
5227,92:69:1D:31:68:E9,3840694,487531249,3933,3627116,3836761,483904133,0,4845,1110041,4700,1077201,145,32840,2128,10,4142,87,0,45,229410.0,130000.0,-52.0,-46.0,-42.0,-49.0,-51.0,-46.0,-43.0,-48.0,-87.0,-87.0,-83.0,-83.0,35.0,41.0,41.0,34.0,1
5228,CC:2F:71:3F:1F:24,4658855,1371516363,822094,887612230,3836761,483904133,37,666195,699060278,665466,698972588,729,87690,642261,15,822351,88539,34,527,130000.0,43333.0,-71.0,-66.0,-68.0,-68.0,-70.0,-66.0,-68.0,-68.0,-87.0,-87.0,-83.0,-83.0,16.0,21.0,15.0,15.0,1
5229,CC:2F:71:3E:C5:1F,3837645,484012092,884,107959,3836761,483904133,0,3690,309775,3044,233103,646,76672,934,9,1270,20,0,41,130000.0,39000.0,-71.0,-71.0,-69.0,-61.0,-70.0,-71.0,-69.0,-60.0,-87.0,-87.0,-83.0,-83.0,16.0,16.0,14.0,22.0,1
5230,BA:8C:B9:54:50:24,3841604,490087710,4843,6183577,3836761,483904133,0,9047,1702999,9025,1699504,22,3495,2348,15,5288,39,0,58,216660.0,130000.0,-48.0,-35.0,-43.0,-45.0,-42.0,-35.0,-43.0,-47.0,-87.0,-87.0,-83.0,-83.0,39.0,52.0,40.0,38.0,1
5231,62:47:05:9D:EB:15,3836820,483915538,55,11001,3836765,483904537,0,138,14815,127,12649,11,2166,40,0,79,0,0,5,229410.0,130000.0,-51.0,-47.0,-57.0,-53.0,-51.0,-47.0,-54.0,-56.0,-87.0,-87.0,-83.0,-83.0,36.0,40.0,26.0,30.0,1
5232,3C:55:76:E8:8F:1F,3887834,610975374,51069,127070837,3836765,483904537,23,23906,5513040,23578,5455196,328,57844,10582,29,51132,6102,23,245,172050.0,51610.0,-53.0,-53.0,-44.0,-45.0,-52.0,-52.0,-43.0,-44.0,-87.0,-87.0,-83.0,-83.0,34.0,34.0,39.0,38.0,1
5233,92:69:1D:31:68:E9,3840698,487531653,3933,3627116,3836765,483904537,0,4845,1110041,4700,1077201,145,32840,2128,10,4142,87,0,45,229410.0,130000.0,-52.0,-46.0,-42.0,-49.0,-51.0,-46.0,-43.0,-48.0,-87.0,-87.0,-83.0,-83.0,35.0,41.0,41.0,34.0,1
5234,CC:2F:71:3F:1F:24,4659078,1371783844,822313,887879307,3836765,483904537,37,666403,699322136,665674,699234446,729,87690,642457,15,822570,88542,34,527,130000.0,43333.0,-69.0,-66.0,-68.0,-69.0,-69.0,-66.0,-68.0,-68.0,-87.0,-87.0,-83.0,-83.0,18.0,21.0,15.0,14.0,1
5235,CC:2F:71:3E:C5:1F,3837651,484012698,884,107959,3836767,483904739,0,3690,309775,3044,233103,646,76672,934,9,1270,20,0,41,130000.0,39000.0,-71.0,-71.0,-69.0,-61.0,-70.0,-71.0,-69.0,-60.0,-87.0,-87.0,-83.0,-83.0,16.0,16.0,14.0,22.0,1
5236,BA:8C:B9:54:50:24,3841611,490088376,4843,6183577,3836768,483904799,0,9047,1702999,9025,1699504,22,3495,2348,15,5288,39,0,58,216660.0,130000.0,-48.0,-35.0,-43.0,-45.0,-42.0,-35.0,-43.0,-47.0,-87.0,-87.0,-83.0,-83.0,39.0,52.0,40.0,38.0,1
5237,62:47:05:9D:EB:15,3836828,483916432,55,11001,3836773,483905431,0,138,14815,127,12649,11,2166,40,0,79,0,0,5,229410.0,130000.0,-51.0,-47.0,-57.0,-53.0,-51.0,-47.0,-54.0,-56.0,-87.0,-87.0,-83.0,-83.0,36.0,40.0,26.0,30.0,1
5238,3C:55:76:E8:8F:1F,3887842,610976268,51069,127070837,3836773,483905431,23,23913,5513570,23584,5455608,329,57962,10583,29,51132,6102,23,245,172050.0,51610.0,-53.0,-52.0,-44.0,-45.0,-51.0,-49.0,-42.0,-41.0,-87.0,-87.0,-83.0,-83.0,34.0,35.0,39.0,38.0,1
5239,92:69:1D:31:68:E9,3840706,487532547,3933,3627116,3836773,483905431,0,4845,1110041,4700,1077201,145,32840,2128,10,4142,87,0,45,229410.0,130000.0,-52.0,-46.0,-42.0,-49.0,-51.0,-46.0,-43.0,-48.0,-87.0,-87.0,-83.0,-83.0,35.0,41.0,41.0,34.0,1
5240,CC:2F:71:3F:1F:24,4659297,1372048096,822524,888142665,3836773,483905431,37,666597,699578766,665868,699491076,729,87690,642642,15,822781,88546,34,527,130000.0,39000.0,-69.0,-65.0,-68.0,-70.0,-69.0,-65.0,-68.0,-69.0,-87.0,-87.0,-83.0,-83.0,18.0,22.0,15.0,13.0,1
5241,CC:2F:71:3E:C5:1F,3837657,484013390,884,107959,3836773,483905431,0,3690,309775,3044,233103,646,76672,934,9,1270,20,0,41,130000.0,39000.0,-71.0,-71.0,-69.0,-61.0,-70.0,-71.0,-69.0,-60.0,-87.0,-87.0,-83.0,-83.0,16.0,16.0,14.0,22.0,1
5242,BA:8C:B9:54:50:24,3841618,490089210,4843,6183577,3836775,483905633,0,9047,1702999,9025,1699504,22,3495,2348,15,5288,39,0,58,216660.0,130000.0,-48.0,-35.0,-43.0,-45.0,-42.0,-35.0,-43.0,-47.0,-87.0,-87.0,-83.0,-83.0,39.0,52.0,40.0,38.0,1
5243,62:47:05:9D:EB:15,3836835,483917108,55,11001,3836780,483906107,0,138,14815,127,12649,11,2166,40,0,79,0,0,5,229410.0,130000.0,-51.0,-47.0,-57.0,-53.0,-51.0,-47.0,-54.0,-56.0,-87.0,-87.0,-83.0,-83.0,36.0,40.0,26.0,30.0,1
5244,3C:55:76:E8:8F:1F,3887852,610977463,51072,127071356,3836780,483906107,23,23931,5515253,23601,5457165,330,58088,10587,29,51135,6102,23,245,195000.0,1000.0,-52.0,-53.0,-46.0,-44.0,-50.0,-52.0,-45.0,-41.0,-87.0,-87.0,-83.0,-83.0,35.0,34.0,37.0,39.0,1
5245,92:69:1D:31:68:E9,3840713,487533223,3933,3627116,3836780,483906107,0,4845,1110041,4700,1077201,145,32840,2128,10,4142,87,0,45,229410.0,130000.0,-52.0,-46.0,-42.0,-49.0,-51.0,-46.0,-43.0,-48.0,-87.0,-87.0,-83.0,-83.0,35.0,41.0,41.0,34.0,1
5246,CC:2F:71:3F:1F:24,4659511,1372307242,822731,888401135,3836780,483906107,37,666786,699829206,666057,699741516,729,87690,642825,15,822988,88552,34,527,130000.0,43333.0,-69.0,-65.0,-69.0,-69.0,-69.0,-65.0,-68.0,-70.0,-87.0,-87.0,-83.0,-83.0,18.0,22.0,14.0,14.0,1
5247,CC:2F:71:3E:C5:1F,3837664,484014066,884,107959,3836780,483906107,0,3690,309775,3044,233103,646,76672,934,9,1270,20,0,41,130000.0,39000.0,-71.0,-71.0,-69.0,-61.0,-70.0,-71.0,-69.0,-60.0,-87.0,-87.0,-83.0,-83.0,16.0,16.0,14.0,22.0,1
5248,BA:8C:B9:54:50:24,3841623,490089684,4843,6183577,3836780,483906107,0,9047,1702999,9025,1699504,22,3495,2348,15,5288,39,0,58,216660.0,130000.0,-48.0,-35.0,-43.0,-45.0,-42.0,-35.0,-43.0,-47.0,-87.0,-87.0,-83.0,-83.0,39.0,52.0,40.0,38.0,1
5249,62:47:05:9D:EB:15,3836839,483917432,55,11001,3836784,483906431,0,138,14815,127,12649,11,2166,40,0,79,0,0,5,229410.0,130000.0,-51.0,-47.0,-57.0,-53.0,-51.0,-47.0,-54.0,-56.0,-87.0,-87.0,-83.0,-83.0,36.0,40.0,26.0,30.0,1
5250,3C:55:76:E8:8F:1F,3887858,610977973,51074,127071542,3836784,483906431,23,23942,5516095,23612,5458007,330,58088,10588,29,51137,6102,23,245,195000.0,97500.0,-50.0,-50.0,-42.0,-42.0,-51.0,-51.0,-43.0,-43.0,-87.0,-87.0,-83.0,-83.0,37.0,37.0,41.0,41.0,1
5251,92:69:1D:31:68:E9,3840719,487533749,3933,3627116,3836786,483906633,0,4845,1110041,4700,1077201,145,32840,2128,10,4142,87,0,45,229410.0,130000.0,-52.0,-46.0,-42.0,-49.0,-51.0,-46.0,-43.0,-48.0,-87.0,-87.0,-83.0,-83.0,35.0,41.0,41.0,34.0,1
5252,CC:2F:71:3F:1F:24,4659734,1372573099,822948,888666466,3836786,483906633,37,666984,700081247,666254,699993439,730,87808,643017,15,823205,88552,34,527,130000.0,43333.0,-70.0,-66.0,-69.0,-70.0,-69.0,-65.0,-68.0,-70.0,-87.0,-87.0,-83.0,-83.0,17.0,21.0,14.0,13.0,1
5253,CC:2F:71:3E:C5:1F,3837672,484014794,884,107959,3836788,483906835,0,3690,309775,3044,233103,646,76672,934,9,1270,20,0,41,130000.0,39000.0,-71.0,-71.0,-69.0,-61.0,-70.0,-71.0,-69.0,-60.0,-87.0,-87.0,-83.0,-83.0,16.0,16.0,14.0,22.0,1
5254,BA:8C:B9:54:50:24,3841631,490090412,4843,6183577,3836788,483906835,0,9047,1702999,9025,1699504,22,3495,2348,15,5288,39,0,58,216660.0,130000.0,-48.0,-35.0,-43.0,-45.0,-42.0,-35.0,-43.0,-47.0,-87.0,-87.0,-83.0,-83.0,39.0,52.0,40.0,38.0,1
5255,62:47:05:9D:EB:15,3836845,483918038,55,11001,3836790,483907037,0,138,14815,127,12649,11,2166,40,0,79,0,0,5,229410.0,130000.0,-51.0,-47.0,-57.0,-53.0,-51.0,-47.0,-54.0,-56.0,-87.0,-87.0,-83.0,-83.0,36.0,40.0,26.0,30.0,1
5256,3C:55:76:E8:8F:1F,3887864,610978579,51074,127071542,3836790,483907037,23,23954,5516949,23624,5458861,330,58088,10589,29,51137,6102,23,245,195000.0,97500.0,-53.0,-52.0,-44.0,-45.0,-52.0,-51.0,-44.0,-44.0,-87.0,-87.0,-83.0,-83.0,34.0,35.0,39.0,38.0,1
5257,92:69:1D:31:68:E9,3840723,487534153,3933,3627116,3836790,483907037,0,4849,1110365,4704,1077525,145,32840,2129,10,4142,87,0,45,229410.0,130000.0,-51.0,-47.0,-45.0,-49.0,-51.0,-47.0,-44.0,-49.0,-87.0,-87.0,-83.0,-83.0,36.0,40.0,38.0,34.0,1
5258,CC:2F:71:3F:1F:24,4659948,1372836619,823158,888929582,3836790,483907037,37,667183,700348703,666453,700260895,730,87808,643201,15,823415,88564,34,527,144444.0,43333.0,-69.0,-65.0,-68.0,-70.0,-69.0,-65.0,-68.0,-70.0,-87.0,-87.0,-83.0,-83.0,18.0,22.0,15.0,13.0,1
5259,CC:2F:71:3E:C5:1F,3837674,484014996,884,107959,3836790,483907037,0,3690,309775,3044,233103,646,76672,934,9,1270,20,0,41,130000.0,39000.0,-71.0,-71.0,-69.0,-61.0,-70.0,-71.0,-69.0,-60.0,-87.0,-87.0,-83.0,-83.0,16.0,16.0,14.0,22.0,1
5260,BA:8C:B9:54:50:24,3841633,490090614,4843,6183577,3836790,483907037,0,9047,1702999,9025,1699504,22,3495,2348,15,5288,39,0,58,216660.0,130000.0,-48.0,-35.0,-43.0,-45.0,-42.0,-35.0,-43.0,-47.0,-87.0,-87.0,-83.0,-83.0,39.0,52.0,40.0,38.0,1
5261,62:47:05:9D:EB:15,3836852,483918704,55,11001,3836797,483907703,0,138,14815,127,12649,11,2166,40,0,79,0,0,5,229410.0,130000.0,-51.0,-47.0,-57.0,-53.0,-51.0,-47.0,-54.0,-56.0,-87.0,-87.0,-83.0,-83.0,36.0,40.0,26.0,30.0,1
5262,3C:55:76:E8:8F:1F,3887871,610979245,51074,127071542,3836797,483907703,23,23954,5516949,23624,5458861,330,58088,10589,29,51137,6102,23,245,195000.0,97500.0,-53.0,-52.0,-44.0,-45.0,-52.0,-51.0,-44.0,-44.0,-87.0,-87.0,-83.0,-83.0,34.0,35.0,39.0,38.0,1
5263,92:69:1D:31:68:E9,3840730,487534819,3933,3627116,3836797,483907703,0,4849,1110365,4704,1077525,145,32840,2129,10,4142,87,0,45,229410.0,130000.0,-51.0,-47.0,-45.0,-49.0,-51.0,-47.0,-44.0,-49.0,-87.0,-87.0,-83.0,-83.0,36.0,40.0,38.0,34.0,1
5264,CC:2F:71:3F:1F:24,4660163,1373097461,823366,889189758,3836797,483907703,37,667374,700602171,666644,700514363,730,87808,643384,15,823623,88575,34,527,144444.0,43333.0,-69.0,-65.0,-68.0,-70.0,-69.0,-65.0,-68.0,-70.0,-87.0,-87.0,-83.0,-83.0,18.0,22.0,15.0,13.0,1
5265,CC:2F:71:3E:C5:1F,3837681,484015662,884,107959,3836797,483907703,0,3692,309915,3046,233243,646,76672,934,9,1271,20,0,41,130000.0,39000.0,-71.0,-71.0,-69.0,-61.0,-70.0,-71.0,-69.0,-60.0,-87.0,-87.0,-83.0,-83.0,16.0,16.0,14.0,22.0,1
5266,BA:8C:B9:54:50:24,3841640,490091280,4843,6183577,3836797,483907703,0,9049,1703135,9027,1699640,22,3495,2348,15,5289,39,0,58,216660.0,130000.0,-39.0,-36.0,-45.0,-51.0,-42.0,-35.0,-43.0,-48.0,-87.0,-87.0,-83.0,-83.0,48.0,51.0,38.0,32.0,1
5267,62:47:05:9D:EB:15,3836855,483919022,56,11117,3836799,483907905,0,141,15061,130,12895,11,2166,41,0,81,0,0,6,229410.0,130000.0,-53.0,-45.0,-52.0,-63.0,-52.0,-47.0,-55.0,-58.0,-86.0,-87.0,-83.0,-82.0,33.0,42.0,31.0,19.0,1
5268,3C:55:76:E8:8F:1F,3887873,610979447,51074,127071542,3836799,483907905,23,23954,5516949,23624,5458861,330,58088,10589,29,51137,6102,23,245,195000.0,97500.0,-53.0,-52.0,-44.0,-45.0,-52.0,-51.0,-44.0,-44.0,-86.0,-87.0,-83.0,-82.0,33.0,35.0,39.0,37.0,1
5269,92:69:1D:31:68:E9,3840732,487535021,3933,3627116,3836799,483907905,0,4849,1110365,4704,1077525,145,32840,2129,10,4142,87,0,45,229410.0,130000.0,-51.0,-47.0,-45.0,-49.0,-51.0,-47.0,-44.0,-49.0,-86.0,-87.0,-83.0,-82.0,35.0,40.0,38.0,33.0,1
5270,CC:2F:71:3F:1F:24,4660376,1373361019,823575,889452912,3836801,483908107,37,667564,700852791,666834,700764983,730,87808,643568,15,823832,88587,34,527,144444.0,43333.0,-69.0,-65.0,-65.0,-70.0,-68.0,-65.0,-67.0,-70.0,-86.0,-87.0,-83.0,-82.0,17.0,22.0,18.0,12.0,1
5271,CC:2F:71:3E:C5:1F,3837685,484016066,884,107959,3836801,483908107,0,3692,309915,3046,233243,646,76672,934,9,1271,20,0,41,130000.0,39000.0,-71.0,-71.0,-69.0,-61.0,-70.0,-71.0,-69.0,-60.0,-86.0,-87.0,-83.0,-82.0,15.0,16.0,14.0,21.0,1
5272,BA:8C:B9:54:50:24,3841644,490091684,4843,6183577,3836801,483908107,0,9049,1703135,9027,1699640,22,3495,2348,15,5289,39,0,58,216660.0,130000.0,-39.0,-36.0,-45.0,-51.0,-42.0,-35.0,-43.0,-48.0,-86.0,-87.0,-83.0,-82.0,47.0,51.0,38.0,31.0,1
5273,62:47:05:9D:EB:15,3836861,483919628,56,11117,3836805,483908511,0,142,15129,131,12963,11,2166,41,0,81,0,0,6,229410.0,130000.0,-52.0,-45.0,-52.0,-61.0,-52.0,-47.0,-55.0,-58.0,-86.0,-87.0,-83.0,-82.0,34.0,42.0,31.0,21.0,1
5274,3C:55:76:E8:8F:1F,3887879,610980053,51074,127071542,3836805,483908511,23,23954,5516949,23624,5458861,330,58088,10589,29,51137,6102,23,245,195000.0,97500.0,-53.0,-52.0,-44.0,-45.0,-52.0,-51.0,-44.0,-44.0,-86.0,-87.0,-83.0,-82.0,33.0,35.0,39.0,37.0,1
5275,92:69:1D:31:68:E9,3840738,487535627,3933,3627116,3836805,483908511,0,4849,1110365,4704,1077525,145,32840,2129,10,4142,87,0,45,229410.0,130000.0,-51.0,-47.0,-45.0,-49.0,-51.0,-47.0,-44.0,-49.0,-86.0,-87.0,-83.0,-82.0,35.0,40.0,38.0,33.0,1
5276,CC:2F:71:3F:1F:24,4660598,1373628308,823793,889719797,3836805,483908511,37,667765,701107911,667035,701020103,730,87808,643763,15,824050,88603,34,527,144444.0,43333.0,-69.0,-65.0,-68.0,-70.0,-69.0,-65.0,-68.0,-70.0,-86.0,-87.0,-83.0,-82.0,17.0,22.0,15.0,12.0,1
5277,CC:2F:71:3E:C5:1F,3837689,484016470,884,107959,3836805,483908511,0,3692,309915,3046,233243,646,76672,934,9,1271,20,0,41,130000.0,39000.0,-71.0,-71.0,-69.0,-61.0,-70.0,-71.0,-69.0,-60.0,-86.0,-87.0,-83.0,-82.0,15.0,16.0,14.0,21.0,1
5278,BA:8C:B9:54:50:24,3841650,490092290,4843,6183577,3836807,483908713,0,9049,1703135,9027,1699640,22,3495,2348,15,5289,39,0,58,216660.0,130000.0,-39.0,-36.0,-45.0,-51.0,-42.0,-35.0,-43.0,-48.0,-86.0,-87.0,-83.0,-82.0,47.0,51.0,38.0,31.0,1
5279,62:47:05:9D:EB:15,3836867,483920154,56,11117,3836811,483909037,0,142,15129,131,12963,11,2166,41,0,81,0,0,6,229410.0,130000.0,-52.0,-45.0,-52.0,-61.0,-52.0,-47.0,-55.0,-58.0,-86.0,-87.0,-83.0,-82.0,34.0,42.0,31.0,21.0,1
5280,3C:55:76:E8:8F:1F,3887885,610980579,51074,127071542,3836811,483909037,23,23954,5516949,23624,5458861,330,58088,10589,29,51137,6102,23,245,195000.0,97500.0,-53.0,-52.0,-44.0,-45.0,-52.0,-51.0,-44.0,-44.0,-86.0,-87.0,-83.0,-82.0,33.0,35.0,39.0,37.0,1
5281,92:69:1D:31:68:E9,3840746,487536437,3935,3627400,3836811,483909037,0,4855,1110905,4710,1078065,145,32840,2131,10,4144,89,0,45,229410.0,137640.0,-51.0,-47.0,-42.0,-49.0,-51.0,-47.0,-44.0,-49.0,-86.0,-87.0,-83.0,-82.0,35.0,40.0,41.0,33.0,1
5282,CC:2F:71:3F:1F:24,4660819,1373898464,824008,889989427,3836811,483909037,37,667966,701379831,667236,701292023,730,87808,643951,15,824265,88614,34,529,144444.0,43333.0,-70.0,-66.0,-69.0,-71.0,-69.0,-65.0,-68.0,-70.0,-86.0,-87.0,-83.0,-82.0,16.0,21.0,14.0,11.0,1
5283,CC:2F:71:3E:C5:1F,3837695,484016996,884,107959,3836811,483909037,0,3694,310103,3047,233313,647,76790,935,9,1271,20,0,41,130000.0,39000.0,-71.0,-70.0,-69.0,-61.0,-70.0,-69.0,-68.0,-60.0,-86.0,-87.0,-83.0,-82.0,15.0,17.0,14.0,21.0,1
5284,BA:8C:B9:54:50:24,3841654,490092614,4843,6183577,3836811,483909037,0,9049,1703135,9027,1699640,22,3495,2348,15,5289,39,0,58,216660.0,130000.0,-39.0,-36.0,-45.0,-51.0,-42.0,-35.0,-43.0,-48.0,-86.0,-87.0,-83.0,-82.0,47.0,51.0,38.0,31.0,1
5285,62:47:05:9D:EB:15,3836871,483920558,56,11117,3836815,483909441,0,142,15129,131,12963,11,2166,41,0,81,0,0,6,229410.0,130000.0,-52.0,-45.0,-52.0,-61.0,-52.0,-47.0,-55.0,-58.0,-86.0,-87.0,-83.0,-82.0,34.0,42.0,31.0,21.0,1
5286,3C:55:76:E8:8F:1F,3887891,610981185,51074,127071542,3836817,483909643,23,23954,5516949,23624,5458861,330,58088,10589,29,51137,6102,23,245,195000.0,97500.0,-53.0,-52.0,-44.0,-45.0,-52.0,-51.0,-44.0,-44.0,-86.0,-87.0,-83.0,-82.0,33.0,35.0,39.0,37.0,1
5287,92:69:1D:31:68:E9,3840752,487537043,3935,3627400,3836817,483909643,0,4855,1110905,4710,1078065,145,32840,2131,10,4144,89,0,45,229410.0,137640.0,-51.0,-47.0,-42.0,-49.0,-51.0,-47.0,-44.0,-49.0,-86.0,-87.0,-83.0,-82.0,35.0,40.0,41.0,33.0,1
5288,CC:2F:71:3F:1F:24,4661036,1374161060,824219,890251417,3836817,483909643,37,668159,701632173,667429,701544365,730,87808,644137,15,824476,88627,34,529,144444.0,43333.0,-69.0,-65.0,-68.0,-71.0,-69.0,-65.0,-68.0,-70.0,-86.0,-87.0,-83.0,-82.0,17.0,22.0,15.0,11.0,1
5289,CC:2F:71:3E:C5:1F,3837701,484017602,884,107959,3836817,483909643,0,3694,310103,3047,233313,647,76790,935,9,1271,20,0,41,130000.0,39000.0,-71.0,-70.0,-69.0,-61.0,-70.0,-69.0,-68.0,-60.0,-86.0,-87.0,-83.0,-82.0,15.0,17.0,14.0,21.0,1
5290,BA:8C:B9:54:50:24,3841660,490093220,4843,6183577,3836817,483909643,0,9049,1703135,9027,1699640,22,3495,2348,15,5289,39,0,58,216660.0,130000.0,-39.0,-36.0,-45.0,-51.0,-42.0,-35.0,-43.0,-48.0,-86.0,-87.0,-83.0,-82.0,47.0,51.0,38.0,31.0,1
5291,62:47:05:9D:EB:15,3836877,483921295,56,11117,3836821,483910178,0,142,15129,131,12963,11,2166,41,0,81,0,0,6,229410.0,130000.0,-52.0,-45.0,-52.0,-61.0,-52.0,-47.0,-55.0,-58.0,-86.0,-87.0,-83.0,-82.0,34.0,42.0,31.0,21.0,1
5292,3C:55:76:E8:8F:1F,3887895,610981720,51074,127071542,3836821,483910178,23,23954,5516949,23624,5458861,330,58088,10589,29,51137,6102,23,245,195000.0,97500.0,-53.0,-52.0,-44.0,-45.0,-52.0,-51.0,-44.0,-44.0,-86.0,-87.0,-83.0,-82.0,33.0,35.0,39.0,37.0,1
5293,92:69:1D:31:68:E9,3840756,487537578,3935,3627400,3836821,483910178,0,4855,1110905,4710,1078065,145,32840,2131,10,4144,89,0,45,229410.0,137640.0,-51.0,-47.0,-42.0,-49.0,-51.0,-47.0,-44.0,-49.0,-86.0,-87.0,-83.0,-82.0,35.0,40.0,41.0,33.0,1
5294,CC:2F:71:3F:1F:24,4661260,1374430048,824435,890519466,3836825,483910582,37,668360,701895844,667630,701808036,730,87808,644329,15,824692,88648,34,529,144444.0,43333.0,-69.0,-65.0,-68.0,-69.0,-68.0,-65.0,-67.0,-68.0,-86.0,-87.0,-83.0,-82.0,17.0,22.0,15.0,13.0,1
5295,CC:2F:71:3E:C5:1F,3837709,484018541,884,107959,3836825,483910582,0,3694,310103,3047,233313,647,76790,935,9,1271,20,0,41,130000.0,39000.0,-71.0,-70.0,-69.0,-61.0,-70.0,-69.0,-68.0,-60.0,-86.0,-87.0,-83.0,-82.0,15.0,17.0,14.0,21.0,1
5296,BA:8C:B9:54:50:24,3841668,490094159,4843,6183577,3836825,483910582,0,9050,1703203,9028,1699708,22,3495,2348,15,5289,39,0,58,216660.0,130000.0,-39.0,-36.0,-43.0,-45.0,-41.0,-35.0,-43.0,-47.0,-86.0,-87.0,-83.0,-82.0,47.0,51.0,40.0,37.0,1
5297,62:47:05:9D:EB:15,3836883,483921901,56,11117,3836827,483910784,0,142,15129,131,12963,11,2166,41,0,81,0,0,6,229410.0,130000.0,-52.0,-45.0,-52.0,-61.0,-52.0,-47.0,-55.0,-58.0,-86.0,-87.0,-83.0,-82.0,34.0,42.0,31.0,21.0,1
5298,3C:55:76:E8:8F:1F,3887901,610982326,51074,127071542,3836827,483910784,23,23954,5516949,23624,5458861,330,58088,10589,29,51137,6102,23,245,195000.0,97500.0,-53.0,-52.0,-44.0,-45.0,-52.0,-51.0,-44.0,-44.0,-86.0,-87.0,-83.0,-82.0,33.0,35.0,39.0,37.0,1
5299,92:69:1D:31:68:E9,3840762,487538184,3935,3627400,3836827,483910784,0,4855,1110905,4710,1078065,145,32840,2131,10,4144,89,0,45,229410.0,137640.0,-51.0,-47.0,-42.0,-49.0,-51.0,-47.0,-44.0,-49.0,-86.0,-87.0,-83.0,-82.0,35.0,40.0,41.0,33.0,1
5300,CC:2F:71:3F:1F:24,4661473,1374693538,824646,890782754,3836827,483910784,37,668558,702155980,667828,702068172,730,87808,644516,15,824903,88705,34,529,115556.0,28889.0,-69.0,-65.0,-67.0,-71.0,-68.0,-65.0,-67.0,-71.0,-86.0,-87.0,-83.0,-82.0,17.0,22.0,16.0,11.0,1
5301,CC:2F:71:3E:C5:1F,3837711,484018743,884,107959,3836827,483910784,0,3694,310103,3047,233313,647,76790,935,9,1271,20,0,41,130000.0,39000.0,-71.0,-70.0,-69.0,-61.0,-70.0,-69.0,-68.0,-60.0,-86.0,-87.0,-83.0,-82.0,15.0,17.0,14.0,21.0,1
5302,BA:8C:B9:54:50:24,3841670,490094361,4843,6183577,3836827,483910784,0,9050,1703203,9028,1699708,22,3495,2348,15,5289,39,0,58,216660.0,130000.0,-39.0,-36.0,-43.0,-45.0,-41.0,-35.0,-43.0,-47.0,-86.0,-87.0,-83.0,-82.0,47.0,51.0,40.0,37.0,1
5303,62:47:05:9D:EB:15,3836888,483922365,56,11117,3836832,483911248,0,142,15129,131,12963,11,2166,41,0,81,0,0,6,229410.0,130000.0,-52.0,-45.0,-52.0,-61.0,-52.0,-47.0,-55.0,-58.0,-86.0,-87.0,-83.0,-82.0,34.0,42.0,31.0,21.0,1
5304,3C:55:76:E8:8F:1F,3887909,610983122,51075,127071672,3836834,483911450,23,23961,5517466,23631,5459378,330,58088,10590,29,51138,6102,23,245,195000.0,97500.0,-47.0,-55.0,-45.0,-41.0,-47.0,-53.0,-44.0,-41.0,-86.0,-87.0,-83.0,-82.0,39.0,32.0,38.0,41.0,1
5305,92:69:1D:31:68:E9,3840769,487538850,3935,3627400,3836834,483911450,0,4855,1110905,4710,1078065,145,32840,2131,10,4144,89,0,45,229410.0,137640.0,-51.0,-47.0,-42.0,-49.0,-51.0,-47.0,-44.0,-49.0,-86.0,-87.0,-83.0,-82.0,35.0,40.0,41.0,33.0,1
5306,CC:2F:71:3F:1F:24,4661688,1374954380,824854,891042930,3836834,483911450,37,668756,702416338,668026,702328530,730,87808,644699,15,825111,88705,34,529,115556.0,28889.0,-68.0,-65.0,-66.0,-71.0,-68.0,-65.0,-66.0,-70.0,-86.0,-87.0,-83.0,-82.0,18.0,22.0,17.0,11.0,1
5307,CC:2F:71:3E:C5:1F,3837718,484019409,884,107959,3836834,483911450,0,3694,310103,3047,233313,647,76790,935,9,1271,20,0,41,130000.0,39000.0,-71.0,-70.0,-69.0,-61.0,-70.0,-69.0,-68.0,-60.0,-86.0,-87.0,-83.0,-82.0,15.0,17.0,14.0,21.0,1
5308,BA:8C:B9:54:50:24,3841677,490095027,4843,6183577,3836834,483911450,0,9050,1703203,9028,1699708,22,3495,2348,15,5289,39,0,58,216660.0,130000.0,-39.0,-36.0,-43.0,-45.0,-41.0,-35.0,-43.0,-47.0,-86.0,-87.0,-83.0,-82.0,47.0,51.0,40.0,37.0,1
5309,62:47:05:9D:EB:15,3836892,483922769,56,11117,3836836,483911652,0,142,15129,131,12963,11,2166,41,0,81,0,0,6,229410.0,130000.0,-52.0,-45.0,-52.0,-61.0,-52.0,-47.0,-55.0,-58.0,-86.0,-87.0,-83.0,-82.0,34.0,42.0,31.0,21.0,1
5310,3C:55:76:E8:8F:1F,3887911,610983324,51075,127071672,3836836,483911652,23,23961,5517466,23631,5459378,330,58088,10590,29,51138,6102,23,245,195000.0,97500.0,-47.0,-55.0,-45.0,-41.0,-47.0,-53.0,-44.0,-41.0,-86.0,-87.0,-83.0,-82.0,39.0,32.0,38.0,41.0,1
5311,92:69:1D:31:68:E9,3840771,487539052,3935,3627400,3836836,483911652,0,4855,1110905,4710,1078065,145,32840,2131,10,4144,89,0,45,229410.0,137640.0,-51.0,-47.0,-42.0,-49.0,-51.0,-47.0,-44.0,-49.0,-86.0,-87.0,-83.0,-82.0,35.0,40.0,41.0,33.0,1
5312,CC:2F:71:3F:1F:24,4661908,1375229906,825072,891318254,3836836,483911652,37,668960,702682850,668230,702595042,730,87808,644895,15,825329,88712,34,529,130000.0,43333.0,-68.0,-65.0,-66.0,-71.0,-68.0,-65.0,-66.0,-70.0,-86.0,-87.0,-83.0,-82.0,18.0,22.0,17.0,11.0,1
5313,CC:2F:71:3E:C5:1F,3837720,484019611,884,107959,3836836,483911652,0,3694,310103,3047,233313,647,76790,935,9,1271,20,0,41,130000.0,39000.0,-71.0,-70.0,-69.0,-61.0,-70.0,-69.0,-68.0,-60.0,-86.0,-87.0,-83.0,-82.0,15.0,17.0,14.0,21.0,1
5314,BA:8C:B9:54:50:24,3841679,490095229,4843,6183577,3836836,483911652,0,9050,1703203,9028,1699708,22,3495,2348,15,5289,39,0,58,216660.0,130000.0,-39.0,-36.0,-43.0,-45.0,-41.0,-35.0,-43.0,-47.0,-86.0,-87.0,-83.0,-82.0,47.0,51.0,40.0,37.0,1
5315,62:47:05:9D:EB:15,3836898,483923375,56,11117,3836842,483912258,0,142,15129,131,12963,11,2166,41,0,81,0,0,6,229410.0,130000.0,-52.0,-45.0,-52.0,-61.0,-52.0,-47.0,-55.0,-58.0,-86.0,-87.0,-83.0,-82.0,34.0,42.0,31.0,21.0,1
5316,3C:55:76:E8:8F:1F,3887918,610984060,51076,127071802,3836842,483912258,23,23974,5518391,23644,5460303,330,58088,10591,29,51139,6102,23,245,195000.0,97500.0,-51.0,-51.0,-44.0,-45.0,-49.0,-51.0,-43.0,-44.0,-86.0,-87.0,-83.0,-82.0,35.0,36.0,39.0,37.0,1
5317,92:69:1D:31:68:E9,3840778,487539718,3936,3627460,3836842,483912258,0,4858,1111151,4713,1078311,145,32840,2132,10,4145,89,0,45,229410.0,137640.0,-53.0,-46.0,-42.0,-49.0,-52.0,-47.0,-43.0,-50.0,-86.0,-87.0,-83.0,-82.0,33.0,41.0,41.0,33.0,1
5318,CC:2F:71:3F:1F:24,4662132,1375497327,825289,891585009,3836843,483912318,37,669162,702938202,668432,702850394,730,87808,645091,15,825546,88714,34,529,130000.0,43333.0,-68.0,-65.0,-66.0,-72.0,-68.0,-65.0,-66.0,-71.0,-86.0,-87.0,-83.0,-82.0,18.0,22.0,17.0,10.0,1
5319,CC:2F:71:3E:C5:1F,3837727,484020277,884,107959,3836843,483912318,0,3694,310103,3047,233313,647,76790,935,9,1271,20,0,41,130000.0,39000.0,-71.0,-70.0,-69.0,-61.0,-70.0,-69.0,-68.0,-60.0,-86.0,-87.0,-83.0,-82.0,15.0,17.0,14.0,21.0,1
5320,BA:8C:B9:54:50:24,3841688,490096097,4843,6183577,3836845,483912520,0,9050,1703203,9028,1699708,22,3495,2348,15,5289,39,0,58,216660.0,130000.0,-39.0,-36.0,-43.0,-45.0,-41.0,-35.0,-43.0,-47.0,-86.0,-87.0,-83.0,-82.0,47.0,51.0,40.0,37.0,1
5321,62:47:05:9D:EB:15,3836901,483923637,56,11117,3836845,483912520,0,142,15129,131,12963,11,2166,41,0,81,0,0,6,229410.0,130000.0,-52.0,-45.0,-52.0,-61.0,-52.0,-47.0,-55.0,-58.0,-86.0,-87.0,-83.0,-82.0,34.0,42.0,31.0,21.0,1
5322,3C:55:76:E8:8F:1F,3887926,610987317,51081,127074797,3836845,483912520,23,23994,5523348,23664,5465260,330,58088,10598,29,51144,6102,23,246,195000.0,97500.0,-50.0,-51.0,-44.0,-45.0,-50.0,-51.0,-44.0,-44.0,-86.0,-87.0,-83.0,-82.0,36.0,36.0,39.0,37.0,1
5323,92:69:1D:31:68:E9,3840783,487540182,3936,3627460,3836847,483912722,0,4858,1111151,4713,1078311,145,32840,2132,10,4145,89,0,45,229410.0,137640.0,-53.0,-46.0,-42.0,-49.0,-52.0,-47.0,-43.0,-50.0,-86.0,-87.0,-83.0,-82.0,33.0,41.0,41.0,33.0,1
5324,CC:2F:71:3F:1F:24,4662344,1375757739,825497,891845017,3836847,483912722,37,669349,703185534,668619,703097726,730,87808,645274,15,825754,88719,34,529,130000.0,39000.0,-69.0,-66.0,-68.0,-71.0,-68.0,-65.0,-66.0,-70.0,-86.0,-87.0,-83.0,-82.0,17.0,21.0,15.0,11.0,1
5325,CC:2F:71:3E:C5:1F,3837731,484020681,884,107959,3836847,483912722,0,3694,310103,3047,233313,647,76790,935,9,1271,20,0,41,130000.0,39000.0,-71.0,-70.0,-69.0,-61.0,-70.0,-69.0,-68.0,-60.0,-86.0,-87.0,-83.0,-82.0,15.0,17.0,14.0,21.0,1
5326,BA:8C:B9:54:50:24,3841690,490096299,4843,6183577,3836847,483912722,0,9050,1703203,9028,1699708,22,3495,2348,15,5289,39,0,58,216660.0,130000.0,-39.0,-36.0,-43.0,-45.0,-41.0,-35.0,-43.0,-47.0,-86.0,-87.0,-83.0,-82.0,47.0,51.0,40.0,37.0,1
5327,62:47:05:9D:EB:15,3836907,483924243,56,11117,3836851,483913126,0,142,15129,131,12963,11,2166,41,0,81,0,0,6,229410.0,130000.0,-52.0,-45.0,-52.0,-61.0,-52.0,-47.0,-55.0,-58.0,-86.0,-87.0,-83.0,-82.0,34.0,42.0,31.0,21.0,1
5328,3C:55:76:E8:8F:1F,3887932,610987923,51081,127074797,3836851,483913126,23,23994,5523348,23664,5465260,330,58088,10598,29,51144,6102,23,246,195000.0,97500.0,-50.0,-51.0,-44.0,-45.0,-50.0,-51.0,-44.0,-44.0,-86.0,-87.0,-83.0,-82.0,36.0,36.0,39.0,37.0,1
5329,92:69:1D:31:68:E9,3840789,487540788,3936,3627460,3836853,483913328,0,4858,1111151,4713,1078311,145,32840,2132,10,4145,89,0,45,229410.0,137640.0,-53.0,-46.0,-42.0,-49.0,-52.0,-47.0,-43.0,-50.0,-86.0,-87.0,-83.0,-82.0,33.0,41.0,41.0,33.0,1
5330,CC:2F:71:3F:1F:24,4662563,1376026011,825710,892112683,3836853,483913328,37,669543,703440684,668813,703352876,730,87808,645463,15,825967,88735,34,529,130000.0,43333.0,-70.0,-65.0,-69.0,-69.0,-70.0,-65.0,-68.0,-70.0,-86.0,-87.0,-83.0,-82.0,16.0,22.0,14.0,13.0,1
5331,CC:2F:71:3E:C5:1F,3837737,484021287,884,107959,3836853,483913328,0,3694,310103,3047,233313,647,76790,935,9,1271,20,0,41,130000.0,39000.0,-71.0,-70.0,-69.0,-61.0,-70.0,-69.0,-68.0,-60.0,-86.0,-87.0,-83.0,-82.0,15.0,17.0,14.0,21.0,1
5332,BA:8C:B9:54:50:24,3841696,490096905,4843,6183577,3836853,483913328,0,9050,1703203,9028,1699708,22,3495,2348,15,5289,39,0,58,216660.0,130000.0,-39.0,-36.0,-43.0,-45.0,-41.0,-35.0,-43.0,-47.0,-86.0,-87.0,-83.0,-82.0,47.0,51.0,40.0,37.0,1
5333,62:47:05:9D:EB:15,3836912,483924707,56,11117,3836856,483913590,0,142,15129,131,12963,11,2166,41,0,81,0,0,6,229410.0,130000.0,-52.0,-45.0,-52.0,-61.0,-52.0,-47.0,-55.0,-58.0,-86.0,-87.0,-83.0,-82.0,34.0,42.0,31.0,21.0,1
5334,3C:55:76:E8:8F:1F,3887937,610988387,51081,127074797,3836856,483913590,23,23994,5523348,23664,5465260,330,58088,10598,29,51144,6102,23,246,195000.0,97500.0,-50.0,-51.0,-44.0,-45.0,-50.0,-51.0,-44.0,-44.0,-86.0,-87.0,-83.0,-82.0,36.0,36.0,39.0,37.0,1
5335,92:69:1D:31:68:E9,3840792,487541050,3936,3627460,3836856,483913590,0,4858,1111151,4713,1078311,145,32840,2132,10,4145,89,0,45,229410.0,137640.0,-53.0,-46.0,-42.0,-49.0,-52.0,-47.0,-43.0,-50.0,-86.0,-87.0,-83.0,-82.0,33.0,41.0,41.0,33.0,1
5336,CC:2F:71:3F:1F:24,4662776,1376286651,825918,892372859,3836858,483913792,37,669736,703693022,669006,703605214,730,87808,645647,15,826175,88735,34,529,130000.0,43333.0,-69.0,-65.0,-69.0,-71.0,-69.0,-65.0,-68.0,-70.0,-86.0,-87.0,-83.0,-82.0,17.0,22.0,14.0,11.0,1
5337,CC:2F:71:3E:C5:1F,3837742,484021751,884,107959,3836858,483913792,0,3694,310103,3047,233313,647,76790,935,9,1271,20,0,41,130000.0,39000.0,-71.0,-70.0,-69.0,-61.0,-70.0,-69.0,-68.0,-60.0,-86.0,-87.0,-83.0,-82.0,15.0,17.0,14.0,21.0,1
5338,BA:8C:B9:54:50:24,3841703,490097571,4843,6183577,3836860,483913994,0,9050,1703203,9028,1699708,22,3495,2348,15,5289,39,0,58,216660.0,130000.0,-39.0,-36.0,-43.0,-45.0,-41.0,-35.0,-43.0,-47.0,-86.0,-87.0,-83.0,-82.0,47.0,51.0,40.0,37.0,1
5339,62:47:05:9D:EB:15,3836918,483925313,56,11117,3836862,483914196,0,142,15129,131,12963,11,2166,41,0,81,0,0,6,229410.0,130000.0,-52.0,-45.0,-52.0,-61.0,-52.0,-47.0,-55.0,-58.0,-86.0,-87.0,-83.0,-82.0,34.0,42.0,31.0,21.0,1
5340,3C:55:76:E8:8F:1F,3887943,610988993,51081,127074797,3836862,483914196,23,23994,5523348,23664,5465260,330,58088,10598,29,51144,6102,23,246,195000.0,97500.0,-50.0,-51.0,-44.0,-45.0,-50.0,-51.0,-44.0,-44.0,-86.0,-87.0,-83.0,-82.0,36.0,36.0,39.0,37.0,1
5341,92:69:1D:31:68:E9,3840798,487541656,3936,3627460,3836862,483914196,0,4858,1111151,4713,1078311,145,32840,2132,10,4145,89,0,45,229410.0,137640.0,-53.0,-46.0,-42.0,-49.0,-52.0,-47.0,-43.0,-50.0,-86.0,-87.0,-83.0,-82.0,33.0,41.0,41.0,33.0,1
5342,CC:2F:71:3F:1F:24,4662995,1376551958,826133,892637762,3836862,483914196,37,669933,703946225,669203,703858417,730,87808,645838,15,826390,88741,34,529,144444.0,43333.0,-69.0,-65.0,-69.0,-70.0,-69.0,-64.0,-68.0,-70.0,-86.0,-87.0,-83.0,-82.0,17.0,22.0,14.0,12.0,1
5343,CC:2F:71:3E:C5:1F,3837746,484022155,884,107959,3836862,483914196,0,3694,310103,3047,233313,647,76790,935,9,1271,20,0,41,130000.0,39000.0,-71.0,-70.0,-69.0,-61.0,-70.0,-69.0,-68.0,-60.0,-86.0,-87.0,-83.0,-82.0,15.0,17.0,14.0,21.0,1
5344,BA:8C:B9:54:50:24,3841705,490097773,4843,6183577,3836862,483914196,0,9050,1703203,9028,1699708,22,3495,2348,15,5289,39,0,58,216660.0,130000.0,-39.0,-36.0,-43.0,-45.0,-41.0,-35.0,-43.0,-47.0,-86.0,-87.0,-83.0,-82.0,47.0,51.0,40.0,37.0,1
5345,62:47:05:9D:EB:15,3836923,483925777,56,11117,3836867,483914660,0,142,15129,131,12963,11,2166,41,0,81,0,0,6,229410.0,130000.0,-52.0,-45.0,-52.0,-61.0,-52.0,-47.0,-55.0,-58.0,-86.0,-86.0,-82.0,-82.0,34.0,41.0,30.0,21.0,1
5346,3C:55:76:E8:8F:1F,3887948,610989457,51081,127074797,3836867,483914660,23,23994,5523348,23664,5465260,330,58088,10598,29,51144,6102,23,246,195000.0,97500.0,-50.0,-51.0,-44.0,-45.0,-50.0,-51.0,-44.0,-44.0,-86.0,-86.0,-82.0,-82.0,36.0,35.0,38.0,37.0,1
5347,92:69:1D:31:68:E9,3840805,487542322,3936,3627460,3836869,483914862,0,4858,1111151,4713,1078311,145,32840,2132,10,4145,89,0,45,229410.0,137640.0,-53.0,-46.0,-42.0,-49.0,-52.0,-47.0,-43.0,-50.0,-86.0,-86.0,-82.0,-82.0,33.0,40.0,40.0,33.0,1
5348,CC:2F:71:3F:1F:24,4663212,1376813060,826343,892898198,3836869,483914862,37,670126,704201301,669396,704113493,730,87808,646023,15,826600,88750,34,529,144444.0,43333.0,-69.0,-65.0,-68.0,-70.0,-69.0,-65.0,-68.0,-69.0,-86.0,-86.0,-82.0,-82.0,17.0,21.0,14.0,12.0,1
5349,CC:2F:71:3E:C5:1F,3837753,484022821,884,107959,3836869,483914862,0,3694,310103,3047,233313,647,76790,935,9,1271,20,0,41,130000.0,39000.0,-71.0,-70.0,-69.0,-61.0,-70.0,-69.0,-68.0,-60.0,-86.0,-86.0,-82.0,-82.0,15.0,16.0,13.0,21.0,1
5350,BA:8C:B9:54:50:24,3841712,490098439,4843,6183577,3836869,483914862,0,9050,1703203,9028,1699708,22,3495,2348,15,5289,39,0,58,216660.0,130000.0,-39.0,-36.0,-43.0,-45.0,-41.0,-35.0,-43.0,-47.0,-86.0,-86.0,-82.0,-82.0,47.0,50.0,39.0,37.0,1
5351,62:47:05:9D:EB:15,3836927,483926181,56,11117,3836871,483915064,0,142,15129,131,12963,11,2166,41,0,81,0,0,6,229410.0,130000.0,-52.0,-45.0,-52.0,-61.0,-52.0,-47.0,-55.0,-58.0,-86.0,-86.0,-82.0,-82.0,34.0,41.0,30.0,21.0,1
5352,3C:55:76:E8:8F:1F,3887955,610990157,51084,127075093,3836871,483915064,23,24010,5524530,23680,5466442,330,58088,10599,29,51147,6102,23,246,195000.0,1000.0,-52.0,-51.0,-44.0,-45.0,-51.0,-50.0,-44.0,-45.0,-86.0,-86.0,-82.0,-82.0,34.0,35.0,38.0,37.0,1
5353,92:69:1D:31:68:E9,3840808,487542640,3937,3627576,3836871,483915064,0,4860,1111287,4715,1078447,145,32840,2132,10,4146,89,0,45,229410.0,137640.0,-52.0,-46.0,-42.0,-49.0,-52.0,-47.0,-43.0,-50.0,-86.0,-86.0,-82.0,-82.0,34.0,40.0,40.0,33.0,1
5354,CC:2F:71:3F:1F:24,4663427,1377079770,826556,893164706,3836871,483915064,37,670316,704453201,669586,704365393,730,87808,646209,15,826813,88754,34,530,144444.0,43333.0,-69.0,-64.0,-68.0,-70.0,-69.0,-64.0,-68.0,-70.0,-86.0,-86.0,-82.0,-82.0,17.0,22.0,14.0,12.0,1
5355,CC:2F:71:3E:C5:1F,3837756,484023139,885,108075,3836871,483915064,0,3696,310243,3049,233453,647,76790,935,9,1272,20,0,41,130000.0,39000.0,-79.0,-80.0,-73.0,-70.0,-71.0,-70.0,-68.0,-61.0,-86.0,-86.0,-82.0,-82.0,7.0,6.0,9.0,12.0,1
5356,BA:8C:B9:54:50:24,3841715,490098757,4844,6183693,3836871,483915064,0,9054,1703475,9032,1699980,22,3495,2348,15,5290,39,0,58,216660.0,130000.0,-39.0,-36.0,-45.0,-52.0,-40.0,-35.0,-44.0,-48.0,-86.0,-86.0,-82.0,-82.0,47.0,50.0,37.0,30.0,1
5357,62:47:05:9D:EB:15,3836936,483927027,57,11233,3836879,483915794,0,144,15265,133,13099,11,2166,41,0,82,0,0,6,229410.0,130000.0,-52.0,-45.0,-53.0,-62.0,-52.0,-46.0,-54.0,-60.0,-86.0,-86.0,-82.0,-82.0,34.0,41.0,29.0,20.0,1
5358,3C:55:76:E8:8F:1F,3888775,613135903,51895,129220047,3836880,483915856,23,24157,5547299,23826,5489093,331,58206,10656,29,51795,6124,23,247,216660.0,1000.0,-51.0,-50.0,-44.0,-44.0,-51.0,-52.0,-45.0,-43.0,-86.0,-86.0,-82.0,-82.0,35.0,36.0,38.0,38.0,1
5359,92:69:1D:31:68:E9,3840818,487543492,3937,3627576,3836881,483915916,0,4860,1111287,4715,1078447,145,32840,2132,10,4146,89,0,45,229410.0,137640.0,-52.0,-46.0,-42.0,-49.0,-52.0,-47.0,-43.0,-50.0,-86.0,-86.0,-82.0,-82.0,34.0,40.0,40.0,33.0,1
5360,CC:2F:71:3F:1F:24,4663711,1377426807,826829,893510618,3836882,483916189,37,670576,704788070,669845,704700144,731,87926,646463,15,827086,88762,34,530,144444.0,43333.0,-69.0,-64.0,-68.0,-70.0,-69.0,-64.0,-68.0,-70.0,-86.0,-86.0,-82.0,-82.0,17.0,22.0,14.0,12.0,1
5361,CC:2F:71:3E:C5:1F,3837769,484024466,885,108075,3836884,483916391,0,3696,310243,3049,233453,647,76790,935,9,1272,20,0,41,130000.0,39000.0,-79.0,-80.0,-73.0,-70.0,-71.0,-70.0,-68.0,-61.0,-86.0,-86.0,-82.0,-82.0,7.0,6.0,9.0,12.0,1
5362,BA:8C:B9:54:50:24,3841728,490100084,4844,6183693,3836884,483916391,0,9054,1703475,9032,1699980,22,3495,2348,15,5290,39,0,58,216660.0,130000.0,-39.0,-36.0,-45.0,-52.0,-40.0,-35.0,-44.0,-48.0,-86.0,-86.0,-82.0,-82.0,47.0,50.0,37.0,30.0,1
5363,62:47:05:9D:EB:15,3836943,483927826,57,11233,3836886,483916593,0,144,15265,133,13099,11,2166,41,0,82,0,0,6,229410.0,130000.0,-52.0,-45.0,-53.0,-62.0,-52.0,-46.0,-54.0,-60.0,-86.0,-86.0,-82.0,-82.0,34.0,41.0,29.0,20.0,1
5364,3C:55:76:E8:8F:1F,3889625,615369089,52737,131452294,3836888,483916795,23,24421,5583183,24090,5524977,331,58206,10756,29,52800,6359,23,247,162500.0,48750.0,-51.0,-51.0,-44.0,-45.0,-51.0,-51.0,-44.0,-44.0,-86.0,-86.0,-82.0,-82.0,35.0,35.0,38.0,37.0,1
5365,92:69:1D:31:68:E9,3840825,487544371,3937,3627576,3836888,483916795,0,4860,1111287,4715,1078447,145,32840,2132,10,4146,89,0,45,229410.0,137640.0,-52.0,-46.0,-42.0,-49.0,-52.0,-47.0,-43.0,-50.0,-86.0,-86.0,-82.0,-82.0,34.0,40.0,40.0,33.0,1
5366,CC:2F:71:3F:1F:24,4663951,1377725215,827061,893808218,3836890,483916997,37,670788,705071080,670057,704983154,731,87926,646670,15,827318,88782,34,530,144444.0,43333.0,-69.0,-65.0,-68.0,-70.0,-69.0,-64.0,-68.0,-70.0,-86.0,-86.0,-82.0,-82.0,17.0,21.0,14.0,12.0,1
5367,CC:2F:71:3E:C5:1F,3837775,484025072,885,108075,3836890,483916997,0,3696,310243,3049,233453,647,76790,935,9,1272,20,0,41,130000.0,39000.0,-79.0,-80.0,-73.0,-70.0,-71.0,-70.0,-68.0,-61.0,-86.0,-86.0,-82.0,-82.0,7.0,6.0,9.0,12.0,1
5368,BA:8C:B9:54:50:24,3841734,490100690,4844,6183693,3836890,483916997,0,9054,1703475,9032,1699980,22,3495,2348,15,5290,39,0,58,216660.0,130000.0,-39.0,-36.0,-45.0,-52.0,-40.0,-35.0,-44.0,-48.0,-86.0,-86.0,-82.0,-82.0,47.0,50.0,37.0,30.0,1
5369,62:47:05:9D:EB:15,3836950,483928492,57,11233,3836893,483917259,0,144,15265,133,13099,11,2166,41,0,82,0,0,6,229410.0,130000.0,-52.0,-45.0,-53.0,-62.0,-52.0,-46.0,-54.0,-60.0,-86.0,-86.0,-82.0,-82.0,34.0,41.0,29.0,20.0,1
5370,3C:55:76:E8:8F:1F,3889630,615369553,52737,131452294,3836893,483917259,23,24421,5583183,24090,5524977,331,58206,10756,29,52800,6359,23,247,162500.0,48750.0,-51.0,-51.0,-44.0,-45.0,-51.0,-51.0,-44.0,-44.0,-86.0,-86.0,-82.0,-82.0,35.0,35.0,38.0,37.0,1
5371,92:69:1D:31:68:E9,3840830,487544835,3937,3627576,3836893,483917259,0,4860,1111287,4715,1078447,145,32840,2132,10,4146,89,0,45,229410.0,137640.0,-52.0,-46.0,-42.0,-49.0,-52.0,-47.0,-43.0,-50.0,-86.0,-86.0,-82.0,-82.0,34.0,40.0,40.0,33.0,1
5372,CC:2F:71:3F:1F:24,4664182,1378015437,827289,894098178,3836893,483917259,37,671005,705360712,670274,705272786,731,87926,646876,15,827546,88823,34,531,144444.0,43333.0,-69.0,-65.0,-69.0,-70.0,-69.0,-65.0,-68.0,-69.0,-86.0,-86.0,-82.0,-82.0,17.0,21.0,13.0,12.0,1
5373,CC:2F:71:3E:C5:1F,3837778,484025334,885,108075,3836893,483917259,0,3696,310243,3049,233453,647,76790,935,9,1272,20,0,41,130000.0,39000.0,-79.0,-80.0,-73.0,-70.0,-71.0,-70.0,-68.0,-61.0,-86.0,-86.0,-82.0,-82.0,7.0,6.0,9.0,12.0,1
5374,BA:8C:B9:54:50:24,3841737,490100952,4844,6183693,3836893,483917259,0,9054,1703475,9032,1699980,22,3495,2348,15,5290,39,0,58,216660.0,130000.0,-39.0,-36.0,-45.0,-52.0,-40.0,-35.0,-44.0,-48.0,-86.0,-86.0,-82.0,-82.0,47.0,50.0,37.0,30.0,1
5375,62:47:05:9D:EB:15,3836956,483929098,57,11233,3836899,483917865,0,144,15265,133,13099,11,2166,41,0,82,0,0,6,229410.0,130000.0,-52.0,-45.0,-53.0,-62.0,-52.0,-46.0,-54.0,-60.0,-86.0,-86.0,-82.0,-82.0,34.0,41.0,29.0,20.0,1
5376,3C:55:76:E8:8F:1F,3889636,615370159,52737,131452294,3836899,483917865,23,24421,5583183,24090,5524977,331,58206,10756,29,52800,6359,23,247,162500.0,48750.0,-51.0,-51.0,-44.0,-45.0,-51.0,-51.0,-44.0,-44.0,-86.0,-86.0,-82.0,-82.0,35.0,35.0,38.0,37.0,1
5377,92:69:1D:31:68:E9,3840836,487545441,3937,3627576,3836899,483917865,0,4860,1111287,4715,1078447,145,32840,2132,10,4146,89,0,45,229410.0,137640.0,-52.0,-46.0,-42.0,-49.0,-52.0,-47.0,-43.0,-50.0,-86.0,-86.0,-82.0,-82.0,34.0,40.0,40.0,33.0,1
5378,CC:2F:71:3F:1F:24,4664413,1378297334,827514,894379469,3836899,483917865,37,671212,705629447,670481,705541521,731,87926,647078,15,827771,88844,34,531,144444.0,43333.0,-69.0,-65.0,-68.0,-70.0,-68.0,-64.0,-68.0,-70.0,-86.0,-86.0,-82.0,-82.0,17.0,21.0,14.0,12.0,1
5379,CC:2F:71:3E:C5:1F,3837784,484025940,885,108075,3836899,483917865,0,3696,310243,3049,233453,647,76790,935,9,1272,20,0,41,130000.0,39000.0,-79.0,-80.0,-73.0,-70.0,-71.0,-70.0,-68.0,-61.0,-86.0,-86.0,-82.0,-82.0,7.0,6.0,9.0,12.0,1
5380,BA:8C:B9:54:50:24,3841743,490101558,4844,6183693,3836899,483917865,0,9054,1703475,9032,1699980,22,3495,2348,15,5290,39,0,58,216660.0,130000.0,-39.0,-36.0,-45.0,-52.0,-40.0,-35.0,-44.0,-48.0,-86.0,-86.0,-82.0,-82.0,47.0,50.0,37.0,30.0,1
5381,62:47:05:9D:EB:15,3836959,483929560,57,11233,3836902,483918327,0,144,15265,133,13099,11,2166,41,0,82,0,0,6,229410.0,130000.0,-52.0,-45.0,-53.0,-62.0,-52.0,-46.0,-54.0,-60.0,-86.0,-86.0,-82.0,-82.0,34.0,41.0,29.0,20.0,1
5382,3C:55:76:E8:8F:1F,3889640,615370737,52738,131452410,3836902,483918327,23,24436,5584493,24104,5525971,332,58522,10758,29,52801,6359,23,247,162500.0,1000.0,-50.0,-52.0,-50.0,-39.0,-51.0,-50.0,-44.0,-43.0,-86.0,-86.0,-82.0,-82.0,36.0,34.0,32.0,43.0,1
5383,92:69:1D:31:68:E9,3840839,487545903,3937,3627576,3836902,483918327,0,4860,1111287,4715,1078447,145,32840,2132,10,4146,89,0,45,229410.0,137640.0,-52.0,-46.0,-42.0,-49.0,-52.0,-47.0,-43.0,-50.0,-86.0,-86.0,-82.0,-82.0,34.0,40.0,40.0,33.0,1
5384,CC:2F:71:3F:1F:24,4664624,1378557958,827722,894639631,3836902,483918327,37,671406,705883429,670675,705795503,731,87926,647264,15,827979,88847,34,531,144444.0,43333.0,-69.0,-65.0,-68.0,-71.0,-68.0,-64.0,-68.0,-70.0,-86.0,-86.0,-82.0,-82.0,17.0,21.0,14.0,11.0,1
5385,CC:2F:71:3E:C5:1F,3837788,484026462,885,108075,3836903,483918387,0,3696,310243,3049,233453,647,76790,935,9,1272,20,0,41,130000.0,39000.0,-79.0,-80.0,-73.0,-70.0,-71.0,-70.0,-68.0,-61.0,-86.0,-86.0,-82.0,-82.0,7.0,6.0,9.0,12.0,1
5386,BA:8C:B9:54:50:24,3841751,490102484,4844,6183693,3836907,483918791,0,9058,1703747,9036,1700252,22,3495,2348,15,5290,39,0,58,216660.0,130000.0,-39.0,-36.0,-46.0,-52.0,-40.0,-35.0,-44.0,-49.0,-86.0,-86.0,-82.0,-82.0,47.0,50.0,36.0,30.0,1
5387,62:47:05:9D:EB:15,3836967,483930288,57,11233,3836910,483919055,0,144,15265,133,13099,11,2166,41,0,82,0,0,6,229410.0,130000.0,-52.0,-45.0,-53.0,-62.0,-52.0,-46.0,-54.0,-60.0,-86.0,-86.0,-82.0,-82.0,34.0,41.0,29.0,20.0,1
5388,3C:55:76:E8:8F:1F,3889649,615371583,52739,131452528,3836910,483919055,23,24450,5585575,24118,5527053,332,58522,10760,29,52802,6359,23,249,162500.0,1000.0,-53.0,-51.0,-44.0,-45.0,-52.0,-50.0,-44.0,-45.0,-86.0,-86.0,-82.0,-82.0,33.0,35.0,38.0,37.0,1
5389,92:69:1D:31:68:E9,3840847,487546631,3937,3627576,3836910,483919055,0,4860,1111287,4715,1078447,145,32840,2132,10,4146,89,0,45,229410.0,137640.0,-52.0,-46.0,-42.0,-49.0,-52.0,-47.0,-43.0,-50.0,-86.0,-86.0,-82.0,-82.0,34.0,40.0,40.0,33.0,1
5390,CC:2F:71:3F:1F:24,4664844,1378825078,827934,894906023,3836910,483919055,37,671603,706143493,670872,706055567,731,87926,647451,15,828191,88858,34,531,144444.0,43333.0,-68.0,-65.0,-69.0,-71.0,-68.0,-65.0,-68.0,-70.0,-86.0,-86.0,-82.0,-82.0,18.0,21.0,13.0,11.0,1
5391,CC:2F:71:3E:C5:1F,3837798,484027394,885,108075,3836913,483919319,0,3698,310431,3050,233523,648,76908,936,9,1272,20,0,41,130000.0,39000.0,-71.0,-71.0,-68.0,-60.0,-71.0,-70.0,-68.0,-61.0,-86.0,-86.0,-82.0,-82.0,15.0,15.0,14.0,22.0,1
5392,BA:8C:B9:54:50:24,3841757,490103012,4844,6183693,3836913,483919319,0,9059,1703815,9037,1700320,22,3495,2348,15,5290,39,0,58,216660.0,130000.0,-50.0,-35.0,-43.0,-45.0,-42.0,-35.0,-44.0,-48.0,-86.0,-86.0,-82.0,-82.0,36.0,51.0,39.0,37.0,1
5393,62:47:05:9D:EB:15,3836970,483930552,57,11233,3836913,483919319,0,144,15265,133,13099,11,2166,41,0,82,0,0,6,229410.0,130000.0,-52.0,-45.0,-53.0,-62.0,-52.0,-46.0,-54.0,-60.0,-86.0,-86.0,-82.0,-82.0,34.0,41.0,29.0,20.0,1
5394,3C:55:76:E8:8F:1F,3889657,615372417,52740,131452694,3836917,483919723,23,24455,5586066,24122,5527426,333,58640,10762,29,52803,6359,23,249,162500.0,1000.0,-47.0,-52.0,-46.0,-37.0,-50.0,-51.0,-44.0,-40.0,-86.0,-86.0,-82.0,-82.0,39.0,34.0,36.0,45.0,1
5395,92:69:1D:31:68:E9,3840854,487547299,3937,3627576,3836917,483919723,0,4860,1111287,4715,1078447,145,32840,2132,10,4146,89,0,45,229410.0,137640.0,-52.0,-46.0,-42.0,-49.0,-52.0,-47.0,-43.0,-50.0,-86.0,-86.0,-82.0,-82.0,34.0,40.0,40.0,33.0,1
5396,CC:2F:71:3F:1F:24,4665070,1379092747,828153,895173024,3836917,483919723,37,671804,706399951,671073,706312025,731,87926,647646,15,828410,88866,34,531,144444.0,43333.0,-69.0,-65.0,-69.0,-69.0,-69.0,-65.0,-69.0,-69.0,-86.0,-86.0,-82.0,-82.0,17.0,21.0,13.0,13.0,1
5397,CC:2F:71:3E:C5:1F,3837802,484027798,885,108075,3836917,483919723,0,3698,310431,3050,233523,648,76908,936,9,1272,20,0,41,130000.0,39000.0,-71.0,-71.0,-68.0,-60.0,-71.0,-70.0,-68.0,-61.0,-86.0,-86.0,-82.0,-82.0,15.0,15.0,14.0,22.0,1
5398,BA:8C:B9:54:50:24,3841761,490103416,4844,6183693,3836917,483919723,0,9059,1703815,9037,1700320,22,3495,2348,15,5290,39,0,58,216660.0,130000.0,-50.0,-35.0,-43.0,-45.0,-42.0,-35.0,-44.0,-48.0,-86.0,-86.0,-82.0,-82.0,36.0,51.0,39.0,37.0,1
5399,62:47:05:9D:EB:15,3836979,483931420,57,11233,3836922,483920187,0,144,15265,133,13099,11,2166,41,0,82,0,0,6,229410.0,130000.0,-52.0,-45.0,-53.0,-62.0,-52.0,-46.0,-54.0,-60.0,-86.0,-86.0,-82.0,-82.0,34.0,41.0,29.0,20.0,1
5400,3C:55:76:E8:8F:1F,3889662,615372881,52740,131452694,3836922,483920187,23,24469,5587056,24136,5528416,333,58640,10763,29,52803,6359,23,249,162500.0,1000.0,-50.0,-54.0,-48.0,-39.0,-49.0,-54.0,-47.0,-39.0,-86.0,-86.0,-82.0,-82.0,36.0,32.0,34.0,43.0,1
5401,92:69:1D:31:68:E9,3840859,487547763,3937,3627576,3836922,483920187,0,4863,1111491,4718,1078651,145,32840,2132,11,4147,90,0,45,229410.0,137640.0,-51.0,-46.0,-44.0,-48.0,-51.0,-46.0,-43.0,-49.0,-86.0,-86.0,-82.0,-82.0,35.0,40.0,38.0,34.0,1
5402,CC:2F:71:3F:1F:24,4665284,1379353517,828362,895433330,3836922,483920187,37,671995,706649057,671264,706561131,731,87926,647832,15,828619,88878,34,531,144444.0,43333.0,-69.0,-65.0,-68.0,-70.0,-68.0,-64.0,-68.0,-69.0,-86.0,-86.0,-82.0,-82.0,17.0,21.0,14.0,12.0,1
5403,CC:2F:71:3E:C5:1F,3837807,484028262,885,108075,3836922,483920187,0,3698,310431,3050,233523,648,76908,936,9,1272,20,0,41,130000.0,39000.0,-71.0,-71.0,-68.0,-60.0,-71.0,-70.0,-68.0,-61.0,-86.0,-86.0,-82.0,-82.0,15.0,15.0,14.0,22.0,1
5404,BA:8C:B9:54:50:24,3841766,490103880,4844,6183693,3836922,483920187,0,9059,1703815,9037,1700320,22,3495,2348,15,5290,39,0,58,216660.0,130000.0,-50.0,-35.0,-43.0,-45.0,-42.0,-35.0,-44.0,-48.0,-86.0,-86.0,-82.0,-82.0,36.0,51.0,39.0,37.0,1
5405,62:47:05:9D:EB:15,3836983,483931824,57,11233,3836926,483920591,0,146,15401,135,13235,11,2166,41,0,83,0,0,6,229410.0,130000.0,-52.0,-45.0,-53.0,-62.0,-52.0,-45.0,-53.0,-61.0,-86.0,-86.0,-82.0,-82.0,34.0,41.0,29.0,20.0,1
5406,3C:55:76:E8:8F:1F,3889668,615373635,52742,131453044,3836926,483920591,23,24475,5588955,24142,5530315,333,58640,10766,29,52805,6359,23,249,162500.0,48750.0,-49.0,-54.0,-46.0,-39.0,-49.0,-53.0,-46.0,-39.0,-86.0,-86.0,-82.0,-82.0,37.0,32.0,36.0,43.0,1
5407,92:69:1D:31:68:E9,3840863,487548167,3937,3627576,3836926,483920591,0,4863,1111491,4718,1078651,145,32840,2132,11,4147,90,0,45,229410.0,137640.0,-51.0,-46.0,-44.0,-48.0,-51.0,-46.0,-43.0,-49.0,-86.0,-86.0,-82.0,-82.0,35.0,40.0,38.0,34.0,1
5408,CC:2F:71:3F:1F:24,4665501,1379616113,828573,895695320,3836928,483920793,37,672186,706901025,671455,706813099,731,87926,648017,15,828830,88882,34,531,144444.0,43333.0,-69.0,-65.0,-69.0,-70.0,-69.0,-65.0,-68.0,-70.0,-86.0,-86.0,-82.0,-82.0,17.0,21.0,13.0,12.0,1
5409,CC:2F:71:3E:C5:1F,3837813,484028868,885,108075,3836928,483920793,0,3698,310431,3050,233523,648,76908,936,9,1272,20,0,41,130000.0,39000.0,-71.0,-71.0,-68.0,-60.0,-71.0,-70.0,-68.0,-61.0,-86.0,-86.0,-82.0,-82.0,15.0,15.0,14.0,22.0,1
5410,BA:8C:B9:54:50:24,3841772,490104486,4844,6183693,3836928,483920793,0,9059,1703815,9037,1700320,22,3495,2348,15,5290,39,0,58,216660.0,130000.0,-50.0,-35.0,-43.0,-45.0,-42.0,-35.0,-44.0,-48.0,-86.0,-86.0,-82.0,-82.0,36.0,51.0,39.0,37.0,1
5411,62:47:05:9D:EB:15,3836988,483932288,57,11233,3836931,483921055,0,146,15401,135,13235,11,2166,41,0,83,0,0,6,229410.0,130000.0,-52.0,-45.0,-53.0,-62.0,-52.0,-45.0,-53.0,-61.0,-86.0,-86.0,-82.0,-82.0,34.0,41.0,29.0,20.0,1
5412,3C:55:76:E8:8F:1F,3889674,615374231,52743,131453176,3836931,483921055,23,24486,5589825,24153,5531185,333,58640,10768,29,52806,6359,23,249,162500.0,1000.0,-49.0,-55.0,-47.0,-39.0,-49.0,-54.0,-46.0,-39.0,-86.0,-86.0,-82.0,-82.0,37.0,31.0,35.0,43.0,1
5413,92:69:1D:31:68:E9,3840868,487548631,3937,3627576,3836931,483921055,0,4863,1111491,4718,1078651,145,32840,2132,11,4147,90,0,45,229410.0,137640.0,-51.0,-46.0,-44.0,-48.0,-51.0,-46.0,-43.0,-49.0,-86.0,-86.0,-82.0,-82.0,35.0,40.0,38.0,34.0,1
5414,CC:2F:71:3F:1F:24,4665711,1379877845,828780,895956790,3836931,483921055,37,672374,707148549,671643,707060623,731,87926,648199,15,829037,88889,34,531,144444.0,43333.0,-69.0,-65.0,-69.0,-70.0,-69.0,-64.0,-68.0,-70.0,-86.0,-86.0,-82.0,-82.0,17.0,21.0,13.0,12.0,1
5415,CC:2F:71:3E:C5:1F,3837816,484029130,885,108075,3836931,483921055,0,3698,310431,3050,233523,648,76908,936,9,1272,20,0,41,130000.0,39000.0,-71.0,-71.0,-68.0,-60.0,-71.0,-70.0,-68.0,-61.0,-86.0,-86.0,-82.0,-82.0,15.0,15.0,14.0,22.0,1
5416,BA:8C:B9:54:50:24,3841775,490104748,4844,6183693,3836931,483921055,0,9059,1703815,9037,1700320,22,3495,2348,15,5290,39,0,58,216660.0,130000.0,-50.0,-35.0,-43.0,-45.0,-42.0,-35.0,-44.0,-48.0,-86.0,-86.0,-82.0,-82.0,36.0,51.0,39.0,37.0,1
5417,62:47:05:9D:EB:15,3837017,483943917,57,11233,3836960,483932684,0,146,15401,135,13235,11,2166,41,0,83,0,0,6,229410.0,130000.0,-52.0,-45.0,-53.0,-62.0,-52.0,-45.0,-53.0,-61.0,-86.0,-86.0,-82.0,-81.0,34.0,41.0,29.0,19.0,1
5418,3C:55:76:E8:8F:1F,3889703,615385860,52743,131453176,3836960,483932684,23,24486,5589825,24153,5531185,333,58640,10768,29,52806,6359,23,249,162500.0,1000.0,-49.0,-55.0,-47.0,-39.0,-49.0,-54.0,-46.0,-39.0,-86.0,-86.0,-82.0,-81.0,37.0,31.0,35.0,42.0,1
5419,92:69:1D:31:68:E9,3840897,487560260,3937,3627576,3836960,483932684,0,4866,1111862,4720,1078787,146,33075,2133,11,4147,90,0,45,229410.0,137640.0,-52.0,-46.0,-42.0,-49.0,-51.0,-46.0,-43.0,-49.0,-86.0,-86.0,-82.0,-81.0,34.0,40.0,40.0,32.0,1
5420,CC:2F:71:3F:1F:24,4665969,1380174877,829009,896242193,3836960,483932684,37,672589,707424025,671858,707336099,731,87926,648406,15,829266,88904,34,531,144444.0,43333.0,-69.0,-65.0,-69.0,-70.0,-69.0,-65.0,-68.0,-69.0,-86.0,-86.0,-82.0,-81.0,17.0,21.0,13.0,11.0,1
5421,CC:2F:71:3E:C5:1F,3837845,484040759,885,108075,3836960,483932684,0,3698,310431,3050,233523,648,76908,936,9,1272,20,0,41,130000.0,39000.0,-71.0,-71.0,-68.0,-60.0,-71.0,-70.0,-68.0,-61.0,-86.0,-86.0,-82.0,-81.0,15.0,15.0,14.0,21.0,1
5422,BA:8C:B9:54:50:24,3841804,490116377,4844,6183693,3836960,483932684,0,9059,1703815,9037,1700320,22,3495,2348,15,5290,39,0,58,216660.0,130000.0,-50.0,-35.0,-43.0,-45.0,-42.0,-35.0,-44.0,-48.0,-86.0,-86.0,-82.0,-81.0,36.0,51.0,39.0,36.0,1
5423,62:47:05:9D:EB:15,3837019,483944119,57,11233,3836962,483932886,0,146,15401,135,13235,11,2166,41,0,83,0,0,6,229410.0,130000.0,-52.0,-45.0,-53.0,-62.0,-52.0,-45.0,-53.0,-61.0,-86.0,-86.0,-82.0,-81.0,34.0,41.0,29.0,19.0,1
5424,3C:55:76:E8:8F:1F,3889708,615386610,52746,131453724,3836962,483932886,23,24496,5590655,24163,5532015,333,58640,10770,29,52809,6359,23,249,162500.0,48750.0,-49.0,-54.0,-47.0,-39.0,-48.0,-52.0,-46.0,-38.0,-86.0,-86.0,-82.0,-81.0,37.0,32.0,35.0,42.0,1
5425,92:69:1D:31:68:E9,3840900,487560522,3937,3627576,3836963,483932946,0,4866,1111862,4720,1078787,146,33075,2133,11,4147,90,0,45,229410.0,137640.0,-52.0,-46.0,-42.0,-49.0,-51.0,-46.0,-43.0,-49.0,-86.0,-86.0,-82.0,-81.0,34.0,40.0,40.0,32.0,1
5426,CC:2F:71:3F:1F:24,4666181,1380438293,829218,896505347,3836963,483932946,37,672785,707682311,672054,707594385,731,87926,648593,15,829475,88913,34,531,144444.0,43333.0,-69.0,-65.0,-68.0,-71.0,-69.0,-64.0,-68.0,-69.0,-86.0,-86.0,-82.0,-81.0,17.0,21.0,14.0,10.0,1
5427,CC:2F:71:3E:C5:1F,3837850,484041223,885,108075,3836965,483933148,0,3698,310431,3050,233523,648,76908,936,9,1272,20,0,41,130000.0,39000.0,-71.0,-71.0,-68.0,-60.0,-71.0,-70.0,-68.0,-61.0,-86.0,-86.0,-82.0,-81.0,15.0,15.0,14.0,21.0,1
5428,BA:8C:B9:54:50:24,3841811,490117043,4844,6183693,3836967,483933350,0,9059,1703815,9037,1700320,22,3495,2348,15,5290,39,0,58,216660.0,130000.0,-50.0,-35.0,-43.0,-45.0,-42.0,-35.0,-44.0,-48.0,-86.0,-86.0,-82.0,-81.0,36.0,51.0,39.0,36.0,1
5429,62:47:05:9D:EB:15,3837027,483945058,57,11233,3836970,483933825,0,146,15401,135,13235,11,2166,41,0,83,0,0,6,229410.0,130000.0,-52.0,-45.0,-53.0,-62.0,-52.0,-45.0,-53.0,-61.0,-86.0,-86.0,-82.0,-81.0,34.0,41.0,29.0,19.0,1
5430,3C:55:76:E8:8F:1F,3889716,615387549,52746,131453724,3836970,483933825,23,24501,5590997,24168,5532357,333,58640,10770,29,52809,6359,23,249,162500.0,48750.0,-49.0,-54.0,-48.0,-39.0,-49.0,-54.0,-47.0,-39.0,-86.0,-86.0,-82.0,-81.0,37.0,32.0,34.0,42.0,1
5431,92:69:1D:31:68:E9,3840907,487561401,3937,3627576,3836970,483933825,0,4866,1111862,4720,1078787,146,33075,2133,11,4147,90,0,45,229410.0,137640.0,-52.0,-46.0,-42.0,-49.0,-51.0,-46.0,-43.0,-49.0,-86.0,-86.0,-82.0,-81.0,34.0,40.0,40.0,32.0,1
5432,CC:2F:71:3F:1F:24,4666402,1380702942,829430,896768915,3836972,483934027,37,672979,707936237,672248,707848311,731,87926,648780,15,829687,88918,34,531,144444.0,43333.0,-69.0,-64.0,-68.0,-70.0,-69.0,-64.0,-68.0,-69.0,-86.0,-86.0,-82.0,-81.0,17.0,22.0,14.0,11.0,1
5433,CC:2F:71:3E:C5:1F,3837857,484042102,885,108075,3836972,483934027,0,3698,310431,3050,233523,648,76908,936,9,1272,20,0,41,130000.0,39000.0,-71.0,-71.0,-68.0,-60.0,-71.0,-70.0,-68.0,-61.0,-86.0,-86.0,-82.0,-81.0,15.0,15.0,14.0,21.0,1
5434,BA:8C:B9:54:50:24,3841816,490117720,4844,6183693,3836972,483934027,0,9059,1703815,9037,1700320,22,3495,2348,15,5290,39,0,58,216660.0,130000.0,-50.0,-35.0,-43.0,-45.0,-42.0,-35.0,-44.0,-48.0,-86.0,-86.0,-82.0,-81.0,36.0,51.0,39.0,36.0,1
5435,62:47:05:9D:EB:15,3837031,483945462,57,11233,3836974,483934229,0,146,15401,135,13235,11,2166,41,0,83,0,0,6,229410.0,130000.0,-52.0,-45.0,-53.0,-62.0,-52.0,-45.0,-53.0,-61.0,-86.0,-86.0,-82.0,-81.0,34.0,41.0,29.0,19.0,1
5436,3C:55:76:E8:8F:1F,3889728,615390007,52752,131455576,3836976,483934431,23,24524,5594508,24191,5535868,333,58640,10778,30,52816,6363,23,249,162500.0,48750.0,-51.0,-49.0,-43.0,-44.0,-52.0,-51.0,-46.0,-44.0,-86.0,-86.0,-82.0,-81.0,35.0,37.0,39.0,37.0,1
5437,92:69:1D:31:68:E9,3840913,487562007,3937,3627576,3836976,483934431,0,4866,1111862,4720,1078787,146,33075,2133,11,4147,90,0,45,229410.0,137640.0,-52.0,-46.0,-42.0,-49.0,-51.0,-46.0,-43.0,-49.0,-86.0,-86.0,-82.0,-81.0,34.0,40.0,40.0,32.0,1
5438,CC:2F:71:3F:1F:24,4666627,1380976317,829651,897041886,3836976,483934431,37,673181,708197078,672450,708109152,731,87926,648977,15,829908,88942,34,531,144444.0,43333.0,-69.0,-65.0,-69.0,-70.0,-69.0,-64.0,-68.0,-69.0,-86.0,-86.0,-82.0,-81.0,17.0,21.0,13.0,11.0,1
5439,CC:2F:71:3E:C5:1F,3837861,484042506,885,108075,3836976,483934431,0,3698,310431,3050,233523,648,76908,936,9,1272,20,0,41,130000.0,39000.0,-71.0,-71.0,-68.0,-60.0,-71.0,-70.0,-68.0,-61.0,-86.0,-86.0,-82.0,-81.0,15.0,15.0,14.0,21.0,1
5440,BA:8C:B9:54:50:24,3841820,490118124,4844,6183693,3836976,483934431,0,9059,1703815,9037,1700320,22,3495,2348,15,5290,39,0,58,216660.0,130000.0,-50.0,-35.0,-43.0,-45.0,-42.0,-35.0,-44.0,-48.0,-86.0,-86.0,-82.0,-81.0,36.0,51.0,39.0,36.0,1
5441,62:47:05:9D:EB:15,3837038,483946128,57,11233,3836981,483934895,0,146,15401,135,13235,11,2166,41,0,83,0,0,6,229410.0,130000.0,-52.0,-45.0,-53.0,-62.0,-52.0,-45.0,-53.0,-61.0,-86.0,-86.0,-82.0,-81.0,34.0,41.0,29.0,19.0,1
5442,3C:55:76:E8:8F:1F,3889736,615390988,52753,131455725,3836983,483935263,23,24542,5595845,24209,5537205,333,58640,10780,30,52817,6363,23,249,162500.0,48750.0,-49.0,-54.0,-48.0,-39.0,-47.0,-51.0,-46.0,-37.0,-86.0,-86.0,-82.0,-81.0,37.0,32.0,34.0,42.0,1
5443,92:69:1D:31:68:E9,3840920,487562839,3937,3627576,3836983,483935263,0,4866,1111862,4720,1078787,146,33075,2133,11,4147,90,0,45,229410.0,137640.0,-52.0,-46.0,-42.0,-49.0,-51.0,-46.0,-43.0,-49.0,-86.0,-86.0,-82.0,-81.0,34.0,40.0,40.0,32.0,1
5444,CC:2F:71:3F:1F:24,4666843,1381238879,829860,897303616,3836983,483935263,37,673378,708455556,672647,708367630,731,87926,649163,15,830117,88974,34,531,144444.0,43333.0,-69.0,-65.0,-68.0,-70.0,-69.0,-64.0,-68.0,-69.0,-86.0,-86.0,-82.0,-81.0,17.0,21.0,14.0,11.0,1
5445,CC:2F:71:3E:C5:1F,3837868,484043338,885,108075,3836983,483935263,0,3698,310431,3050,233523,648,76908,936,9,1272,20,0,41,130000.0,39000.0,-71.0,-71.0,-68.0,-60.0,-71.0,-70.0,-68.0,-61.0,-86.0,-86.0,-82.0,-81.0,15.0,15.0,14.0,21.0,1
5446,BA:8C:B9:54:50:24,3841827,490118956,4844,6183693,3836983,483935263,0,9059,1703815,9037,1700320,22,3495,2348,15,5290,39,0,58,216660.0,130000.0,-50.0,-35.0,-43.0,-45.0,-42.0,-35.0,-44.0,-48.0,-86.0,-86.0,-82.0,-81.0,36.0,51.0,39.0,36.0,1
5447,62:47:05:9D:EB:15,3837044,483946900,57,11233,3836987,483935667,0,146,15401,135,13235,11,2166,41,0,83,0,0,6,229410.0,130000.0,-52.0,-45.0,-53.0,-62.0,-52.0,-45.0,-53.0,-61.0,-86.0,-86.0,-82.0,-81.0,34.0,41.0,29.0,19.0,1
5448,3C:55:76:E8:8F:1F,3889741,615391516,52754,131455849,3836987,483935667,23,24550,5596459,24217,5537819,333,58640,10781,30,52818,6363,23,249,162500.0,1000.0,-52.0,-50.0,-44.0,-45.0,-50.0,-49.0,-43.0,-41.0,-86.0,-86.0,-82.0,-81.0,34.0,36.0,38.0,36.0,1
5449,92:69:1D:31:68:E9,3840926,487563445,3937,3627576,3836989,483935869,0,4866,1111862,4720,1078787,146,33075,2133,11,4147,90,0,45,229410.0,137640.0,-52.0,-46.0,-42.0,-49.0,-51.0,-46.0,-43.0,-49.0,-86.0,-86.0,-82.0,-81.0,34.0,40.0,40.0,32.0,1
5450,CC:2F:71:3F:1F:24,4667075,1381527465,830086,897591596,3836989,483935869,37,673584,708732116,672853,708644190,731,87926,649365,15,830343,88982,34,531,144444.0,43333.0,-69.0,-65.0,-69.0,-69.0,-69.0,-64.0,-68.0,-69.0,-86.0,-86.0,-82.0,-81.0,17.0,21.0,13.0,12.0,1
5451,CC:2F:71:3E:C5:1F,3837874,484043944,885,108075,3836989,483935869,0,3698,310431,3050,233523,648,76908,936,9,1272,20,0,41,130000.0,39000.0,-71.0,-71.0,-68.0,-60.0,-71.0,-70.0,-68.0,-61.0,-86.0,-86.0,-82.0,-81.0,15.0,15.0,14.0,21.0,1
5452,BA:8C:B9:54:50:24,3841833,490119562,4844,6183693,3836989,483935869,0,9059,1703815,9037,1700320,22,3495,2348,15,5290,39,0,58,216660.0,130000.0,-50.0,-35.0,-43.0,-45.0,-42.0,-35.0,-44.0,-48.0,-86.0,-86.0,-82.0,-81.0,36.0,51.0,39.0,36.0,1
5453,62:47:05:9D:EB:15,3837049,483947364,57,11233,3836992,483936131,0,146,15401,135,13235,11,2166,41,0,83,0,0,6,229410.0,130000.0,-52.0,-45.0,-53.0,-62.0,-52.0,-45.0,-53.0,-61.0,-86.0,-86.0,-82.0,-81.0,34.0,41.0,29.0,19.0,1
5454,3C:55:76:E8:8F:1F,3889779,615422706,52787,131486575,3836992,483936131,23,24606,5611446,24273,5552806,333,58640,10816,30,52851,6363,23,250,154850.0,48750.0,-52.0,-53.0,-46.0,-43.0,-51.0,-52.0,-45.0,-43.0,-86.0,-86.0,-82.0,-81.0,34.0,33.0,36.0,38.0,1
5455,92:69:1D:31:68:E9,3840929,487563707,3937,3627576,3836992,483936131,0,4866,1111862,4720,1078787,146,33075,2133,11,4147,90,0,45,229410.0,137640.0,-52.0,-46.0,-42.0,-49.0,-51.0,-46.0,-43.0,-49.0,-86.0,-86.0,-82.0,-81.0,34.0,40.0,40.0,32.0,1
5456,CC:2F:71:3F:1F:24,4667292,1381795819,830300,897859688,3836992,483936131,37,673779,708990472,673048,708902546,731,87926,649552,15,830557,88993,34,531,144444.0,43333.0,-69.0,-65.0,-68.0,-69.0,-69.0,-64.0,-68.0,-69.0,-86.0,-86.0,-82.0,-81.0,17.0,21.0,14.0,12.0,1
5457,CC:2F:71:3E:C5:1F,3837877,484044206,885,108075,3836992,483936131,0,3698,310431,3050,233523,648,76908,936,9,1272,20,0,41,130000.0,39000.0,-71.0,-71.0,-68.0,-60.0,-71.0,-70.0,-68.0,-61.0,-86.0,-86.0,-82.0,-81.0,15.0,15.0,14.0,21.0,1
5458,BA:8C:B9:54:50:24,3841838,490120026,4844,6183693,3836994,483936333,0,9059,1703815,9037,1700320,22,3495,2348,15,5290,39,0,58,216660.0,130000.0,-50.0,-35.0,-43.0,-45.0,-42.0,-35.0,-44.0,-48.0,-86.0,-86.0,-82.0,-81.0,36.0,51.0,39.0,36.0,1
5459,62:47:05:9D:EB:15,3837055,483947970,57,11233,3836998,483936737,0,146,15401,135,13235,11,2166,41,0,83,0,0,6,229410.0,130000.0,-52.0,-45.0,-53.0,-62.0,-52.0,-45.0,-53.0,-61.0,-86.0,-86.0,-82.0,-81.0,34.0,41.0,29.0,19.0,1
5460,3C:55:76:E8:8F:1F,3889790,615424786,52792,131488049,3836998,483936737,23,24619,5613543,24286,5554903,333,58640,10820,30,52855,6363,23,250,154850.0,48750.0,-50.0,-48.0,-42.0,-41.0,-50.0,-49.0,-43.0,-43.0,-86.0,-86.0,-82.0,-81.0,36.0,38.0,40.0,40.0,1
5461,92:69:1D:31:68:E9,3840935,487564313,3937,3627576,3836998,483936737,0,4866,1111862,4720,1078787,146,33075,2133,11,4147,90,0,45,229410.0,137640.0,-52.0,-46.0,-42.0,-49.0,-51.0,-46.0,-43.0,-49.0,-86.0,-86.0,-82.0,-81.0,34.0,40.0,40.0,32.0,1
5462,CC:2F:71:3F:1F:24,4667524,1382070751,830526,898134014,3836998,483936737,37,673990,709250335,673259,709162409,731,87926,649753,15,830783,89010,34,531,144444.0,43333.0,-69.0,-65.0,-69.0,-69.0,-69.0,-65.0,-68.0,-69.0,-86.0,-86.0,-82.0,-81.0,17.0,21.0,13.0,12.0,1
5463,CC:2F:71:3E:C5:1F,3837883,484044812,885,108075,3836998,483936737,0,3698,310431,3050,233523,648,76908,936,9,1272,20,0,41,130000.0,39000.0,-71.0,-71.0,-68.0,-60.0,-71.0,-70.0,-68.0,-61.0,-86.0,-86.0,-82.0,-81.0,15.0,15.0,14.0,21.0,1
5464,BA:8C:B9:54:50:24,3841844,490120632,4844,6183693,3837000,483936939,0,9059,1703815,9037,1700320,22,3495,2348,15,5290,39,0,58,216660.0,130000.0,-50.0,-35.0,-43.0,-45.0,-42.0,-35.0,-44.0,-48.0,-86.0,-86.0,-82.0,-81.0,36.0,51.0,39.0,36.0,1
5465,62:47:05:9D:EB:15,3837058,483948232,57,11233,3837001,483936999,0,146,15401,135,13235,11,2166,41,0,83,0,0,6,229410.0,130000.0,-52.0,-45.0,-53.0,-62.0,-52.0,-45.0,-53.0,-61.0,-86.0,-86.0,-82.0,-81.0,34.0,41.0,29.0,19.0,1
5466,3C:55:76:E8:8F:1F,3889797,615425649,52794,131488448,3837003,483937201,23,24635,5614810,24302,5556170,333,58640,10823,30,52858,6363,23,250,154850.0,48750.0,-52.0,-50.0,-44.0,-45.0,-51.0,-49.0,-43.0,-44.0,-86.0,-86.0,-82.0,-81.0,34.0,36.0,38.0,36.0,1
5467,92:69:1D:31:68:E9,3840940,487564777,3937,3627576,3837003,483937201,0,4866,1111862,4720,1078787,146,33075,2133,11,4147,90,0,45,229410.0,137640.0,-52.0,-46.0,-42.0,-49.0,-51.0,-46.0,-43.0,-49.0,-86.0,-86.0,-82.0,-81.0,34.0,40.0,40.0,32.0,1
5468,CC:2F:71:3F:1F:24,4667739,1382334499,830736,898397298,3837003,483937201,37,674183,709503973,673452,709416047,731,87926,649939,15,830993,89021,34,531,144444.0,43333.0,-69.0,-65.0,-68.0,-68.0,-69.0,-65.0,-68.0,-69.0,-86.0,-86.0,-82.0,-81.0,17.0,21.0,14.0,13.0,1
5469,CC:2F:71:3E:C5:1F,3837890,484045478,885,108075,3837005,483937403,0,3698,310431,3050,233523,648,76908,936,9,1272,20,0,41,130000.0,39000.0,-71.0,-71.0,-68.0,-60.0,-71.0,-70.0,-68.0,-61.0,-86.0,-86.0,-82.0,-81.0,15.0,15.0,14.0,21.0,1
5470,BA:8C:B9:54:50:24,3841849,490121096,4844,6183693,3837005,483937403,0,9059,1703815,9037,1700320,22,3495,2348,15,5290,39,0,58,216660.0,130000.0,-50.0,-35.0,-43.0,-45.0,-42.0,-35.0,-44.0,-48.0,-86.0,-86.0,-82.0,-81.0,36.0,51.0,39.0,36.0,1
5471,62:47:05:9D:EB:15,3837064,483948838,57,11233,3837007,483937605,0,146,15401,135,13235,11,2166,41,0,83,0,0,6,229410.0,130000.0,-52.0,-45.0,-53.0,-62.0,-52.0,-45.0,-53.0,-61.0,-86.0,-86.0,-82.0,-81.0,34.0,41.0,29.0,19.0,1
5472,3C:55:76:E8:8F:1F,3889803,615426255,52794,131488448,3837009,483937807,23,24635,5614810,24302,5556170,333,58640,10823,30,52858,6363,23,250,154850.0,48750.0,-52.0,-50.0,-44.0,-45.0,-51.0,-49.0,-43.0,-44.0,-86.0,-86.0,-82.0,-81.0,34.0,36.0,38.0,36.0,1
5473,92:69:1D:31:68:E9,3840946,487565383,3937,3627576,3837009,483937807,0,4866,1111862,4720,1078787,146,33075,2133,11,4147,90,0,45,229410.0,137640.0,-52.0,-46.0,-42.0,-49.0,-51.0,-46.0,-43.0,-49.0,-86.0,-86.0,-82.0,-81.0,34.0,40.0,40.0,32.0,1
5474,CC:2F:71:3F:1F:24,4667959,1382601885,830950,898664078,3837009,483937807,37,674383,709768431,673652,709680505,731,87926,650130,15,831207,89037,34,531,144444.0,43333.0,-69.0,-64.0,-68.0,-70.0,-69.0,-64.0,-68.0,-69.0,-86.0,-86.0,-82.0,-81.0,17.0,22.0,14.0,11.0,1
5475,CC:2F:71:3E:C5:1F,3837894,484045882,885,108075,3837009,483937807,0,3698,310431,3050,233523,648,76908,936,9,1272,20,0,41,130000.0,39000.0,-71.0,-71.0,-68.0,-60.0,-71.0,-70.0,-68.0,-61.0,-86.0,-86.0,-82.0,-81.0,15.0,15.0,14.0,21.0,1
5476,BA:8C:B9:54:50:24,3841853,490121500,4844,6183693,3837009,483937807,0,9059,1703815,9037,1700320,22,3495,2348,15,5290,39,0,58,216660.0,130000.0,-50.0,-35.0,-43.0,-45.0,-42.0,-35.0,-44.0,-48.0,-86.0,-86.0,-82.0,-81.0,36.0,51.0,39.0,36.0,1
5477,62:47:05:9D:EB:15,3837069,483949376,57,11233,3837012,483938143,0,147,15469,136,13303,11,2166,41,0,83,0,0,6,229410.0,130000.0,-52.0,-45.0,-53.0,-60.0,-52.0,-45.0,-53.0,-61.0,-86.0,-86.0,-82.0,-81.0,34.0,41.0,29.0,21.0,1
5478,3C:55:76:E8:8F:1F,3889807,615426659,52794,131488448,3837013,483938211,23,24635,5614810,24302,5556170,333,58640,10823,30,52858,6363,23,250,154850.0,48750.0,-52.0,-50.0,-44.0,-45.0,-51.0,-49.0,-43.0,-44.0,-86.0,-86.0,-82.0,-81.0,34.0,36.0,38.0,36.0,1
5479,92:69:1D:31:68:E9,3840950,487565787,3937,3627576,3837013,483938211,0,4866,1111862,4720,1078787,146,33075,2133,11,4147,90,0,45,229410.0,137640.0,-52.0,-46.0,-42.0,-49.0,-51.0,-46.0,-43.0,-49.0,-86.0,-86.0,-82.0,-81.0,34.0,40.0,40.0,32.0,1
5480,CC:2F:71:3F:1F:24,4668183,1382869350,831169,898931079,3837014,483938271,37,674584,710026327,673853,709938401,731,87926,650324,15,831426,89057,34,531,144444.0,43333.0,-69.0,-64.0,-68.0,-69.0,-69.0,-64.0,-68.0,-69.0,-86.0,-86.0,-82.0,-81.0,17.0,22.0,14.0,12.0,1
5481,CC:2F:71:3E:C5:1F,3837899,484046346,885,108075,3837014,483938271,0,3698,310431,3050,233523,648,76908,936,9,1272,20,0,41,130000.0,39000.0,-71.0,-71.0,-68.0,-60.0,-71.0,-70.0,-68.0,-61.0,-86.0,-86.0,-82.0,-81.0,15.0,15.0,14.0,21.0,1
5482,BA:8C:B9:54:50:24,3841860,490122166,4844,6183693,3837016,483938473,0,9059,1703815,9037,1700320,22,3495,2348,15,5290,39,0,58,216660.0,130000.0,-50.0,-35.0,-43.0,-45.0,-42.0,-35.0,-44.0,-48.0,-86.0,-86.0,-82.0,-81.0,36.0,51.0,39.0,36.0,1
5483,62:47:05:9D:EB:15,3837075,483949908,57,11233,3837018,483938675,0,147,15469,136,13303,11,2166,41,0,83,0,0,6,229410.0,130000.0,-52.0,-45.0,-53.0,-60.0,-52.0,-45.0,-53.0,-61.0,-86.0,-86.0,-82.0,-81.0,34.0,41.0,29.0,21.0,1
5484,3C:55:76:E8:8F:1F,3889813,615427239,52795,131488564,3837018,483938675,23,24637,5614948,24304,5556308,333,58640,10823,30,52859,6363,23,250,154850.0,1000.0,-46.0,-51.0,-46.0,-36.0,-49.0,-50.0,-44.0,-42.0,-86.0,-86.0,-82.0,-81.0,40.0,35.0,36.0,45.0,1
5485,92:69:1D:31:68:E9,3840956,487566367,3938,3627692,3837018,483938675,0,4868,1111998,4722,1078923,146,33075,2133,11,4148,90,0,45,216660.0,130000.0,-53.0,-46.0,-42.0,-49.0,-51.0,-46.0,-43.0,-49.0,-86.0,-86.0,-82.0,-81.0,33.0,40.0,40.0,32.0,1
5486,CC:2F:71:3F:1F:24,4668400,1383136262,831382,899197587,3837018,483938675,37,674777,710276139,674046,710188213,731,87926,650509,15,831637,89070,34,531,144444.0,43333.0,-69.0,-65.0,-68.0,-69.0,-69.0,-65.0,-68.0,-69.0,-86.0,-86.0,-82.0,-81.0,17.0,21.0,14.0,12.0,1
5487,CC:2F:71:3E:C5:1F,3837908,484047527,890,108852,3837018,483938675,0,3705,311376,3057,234468,648,76908,942,9,1277,20,0,43,144444.0,39000.0,-71.0,-71.0,-68.0,-60.0,-72.0,-73.0,-69.0,-62.0,-86.0,-86.0,-82.0,-81.0,15.0,15.0,14.0,21.0,1
5488,BA:8C:B9:54:50:24,3841863,490122484,4845,6183809,3837018,483938675,0,9061,1703951,9039,1700456,22,3495,2348,15,5291,39,0,59,216660.0,130000.0,-39.0,-36.0,-45.0,-52.0,-41.0,-35.0,-44.0,-50.0,-86.0,-86.0,-82.0,-81.0,47.0,50.0,37.0,29.0,1
5489,62:47:05:9D:EB:15,3837080,483950428,58,11349,3837022,483939079,0,148,15537,137,13371,11,2166,41,0,84,0,0,6,229410.0,130000.0,-53.0,-45.0,-53.0,-60.0,-52.0,-45.0,-52.0,-61.0,-86.0,-86.0,-82.0,-81.0,33.0,41.0,29.0,21.0,1
5490,3C:55:76:E8:8F:1F,3889825,615429155,52803,131490076,3837022,483939079,23,24660,5617011,24327,5558371,333,58640,10831,30,52867,6363,23,250,154850.0,48750.0,-49.0,-54.0,-48.0,-40.0,-48.0,-53.0,-46.0,-39.0,-86.0,-86.0,-82.0,-81.0,37.0,32.0,34.0,41.0,1
5491,92:69:1D:31:68:E9,3840960,487566771,3938,3627692,3837022,483939079,0,4868,1111998,4722,1078923,146,33075,2133,11,4148,90,0,45,216660.0,130000.0,-53.0,-46.0,-42.0,-49.0,-51.0,-46.0,-43.0,-49.0,-86.0,-86.0,-82.0,-81.0,33.0,40.0,40.0,32.0,1
5492,CC:2F:71:3F:1F:24,4668613,1383396914,831589,899457633,3837024,483939281,37,674967,710529525,674236,710441599,731,87926,650692,15,831846,89088,34,531,144444.0,43333.0,-69.0,-65.0,-68.0,-70.0,-69.0,-64.0,-68.0,-69.0,-86.0,-86.0,-82.0,-81.0,17.0,21.0,14.0,11.0,1
5493,CC:2F:71:3E:C5:1F,3837914,484048133,890,108852,3837024,483939281,0,3705,311376,3057,234468,648,76908,942,9,1277,20,0,43,144444.0,39000.0,-71.0,-71.0,-68.0,-60.0,-72.0,-73.0,-69.0,-62.0,-86.0,-86.0,-82.0,-81.0,15.0,15.0,14.0,21.0,1
5494,BA:8C:B9:54:50:24,3841869,490123090,4845,6183809,3837024,483939281,0,9061,1703951,9039,1700456,22,3495,2348,15,5291,39,0,59,216660.0,130000.0,-39.0,-36.0,-45.0,-52.0,-41.0,-35.0,-44.0,-50.0,-85.0,-86.0,-82.0,-81.0,46.0,50.0,37.0,29.0,1
5495,62:47:05:9D:EB:15,3837086,483951165,58,11349,3837028,483939816,0,149,15605,138,13439,11,2166,41,0,84,0,0,6,229410.0,130000.0,-52.0,-46.0,-53.0,-60.0,-52.0,-45.0,-52.0,-61.0,-85.0,-86.0,-82.0,-81.0,33.0,40.0,29.0,21.0,1
5496,3C:55:76:E8:8F:1F,3889831,615429892,52803,131490076,3837028,483939816,23,24660,5617011,24327,5558371,333,58640,10831,30,52867,6363,23,250,154850.0,48750.0,-49.0,-54.0,-48.0,-40.0,-48.0,-53.0,-46.0,-39.0,-85.0,-86.0,-82.0,-81.0,36.0,32.0,34.0,41.0,1
5497,92:69:1D:31:68:E9,3840966,487567508,3938,3627692,3837028,483939816,0,4868,1111998,4722,1078923,146,33075,2133,11,4148,90,0,45,216660.0,130000.0,-53.0,-46.0,-42.0,-49.0,-51.0,-46.0,-43.0,-49.0,-85.0,-86.0,-82.0,-81.0,32.0,40.0,40.0,32.0,1
5498,CC:2F:71:3F:1F:24,4668827,1383660733,831799,899720917,3837028,483939816,37,675167,710794281,674436,710706355,731,87926,650878,15,832056,89114,34,531,144444.0,43333.0,-69.0,-65.0,-68.0,-69.0,-69.0,-65.0,-68.0,-69.0,-85.0,-86.0,-82.0,-81.0,16.0,21.0,14.0,12.0,1
5499,CC:2F:71:3E:C5:1F,3837920,484048870,890,108852,3837030,483940018,0,3705,311376,3057,234468,648,76908,942,9,1277,20,0,43,144444.0,39000.0,-71.0,-71.0,-68.0,-60.0,-72.0,-73.0,-69.0,-62.0,-85.0,-86.0,-82.0,-81.0,14.0,15.0,14.0,21.0,1
5500,BA:8C:B9:54:50:24,3841875,490123827,4845,6183809,3837030,483940018,0,9062,1704019,9040,1700524,22,3495,2348,15,5291,39,0,59,216660.0,130000.0,-40.0,-36.0,-45.0,-51.0,-41.0,-35.0,-44.0,-50.0,-85.0,-86.0,-82.0,-81.0,45.0,50.0,37.0,30.0,1
5501,62:47:05:9D:EB:15,3837093,483951833,58,11349,3837035,483940484,0,149,15605,138,13439,11,2166,41,0,84,0,0,6,229410.0,130000.0,-52.0,-46.0,-53.0,-60.0,-52.0,-45.0,-52.0,-61.0,-85.0,-86.0,-82.0,-81.0,33.0,40.0,29.0,21.0,1
5502,3C:55:76:E8:8F:1F,3891563,620016661,54528,136076177,3837035,483940484,23,25071,5675625,24738,5616985,333,58640,11002,30,54560,6380,23,251,206470.0,103230.0,-52.0,-51.0,-46.0,-44.0,-52.0,-51.0,-45.0,-44.0,-85.0,-86.0,-82.0,-81.0,33.0,35.0,36.0,37.0,1
5503,92:69:1D:31:68:E9,3840975,487568378,3938,3627692,3837037,483940686,0,4868,1111998,4722,1078923,146,33075,2133,11,4148,90,0,45,216660.0,130000.0,-53.0,-46.0,-42.0,-49.0,-51.0,-46.0,-43.0,-49.0,-85.0,-86.0,-82.0,-81.0,32.0,40.0,40.0,32.0,1
5504,CC:2F:71:3F:1F:24,4669133,1384047126,832096,900106440,3837037,483940686,37,675450,711170440,674718,711082396,732,88044,651153,15,832353,89128,34,531,144444.0,43333.0,-69.0,-64.0,-68.0,-69.0,-69.0,-64.0,-68.0,-69.0,-85.0,-86.0,-82.0,-81.0,16.0,22.0,14.0,12.0,1
5505,CC:2F:71:3E:C5:1F,3837927,484049538,890,108852,3837037,483940686,0,3705,311376,3057,234468,648,76908,942,9,1277,20,0,43,144444.0,39000.0,-71.0,-71.0,-68.0,-60.0,-72.0,-73.0,-69.0,-62.0,-85.0,-86.0,-82.0,-81.0,14.0,15.0,14.0,21.0,1
5506,BA:8C:B9:54:50:24,3841882,490124495,4845,6183809,3837037,483940686,0,9062,1704019,9040,1700524,22,3495,2348,15,5291,39,0,59,216660.0,130000.0,-40.0,-36.0,-45.0,-51.0,-41.0,-35.0,-44.0,-50.0,-85.0,-86.0,-82.0,-81.0,45.0,50.0,37.0,30.0,1
5507,62:47:05:9D:EB:15,3837098,483952297,58,11349,3837040,483940948,0,150,15673,139,13507,11,2166,41,0,84,0,0,6,229410.0,130000.0,-52.0,-45.0,-53.0,-60.0,-52.0,-45.0,-53.0,-61.0,-85.0,-86.0,-82.0,-81.0,33.0,41.0,29.0,21.0,1
5508,3C:55:76:E8:8F:1F,3891816,620670372,54776,136729424,3837040,483940948,23,25165,5687686,24832,5629046,333,58640,11044,31,54842,6467,23,251,195000.0,1000.0,-49.0,-54.0,-48.0,-40.0,-48.0,-53.0,-46.0,-39.0,-85.0,-86.0,-82.0,-81.0,36.0,32.0,34.0,41.0,1
5509,92:69:1D:31:68:E9,3840978,487568640,3938,3627692,3837040,483940948,0,4868,1111998,4722,1078923,146,33075,2133,11,4148,90,0,45,216660.0,130000.0,-53.0,-46.0,-42.0,-49.0,-51.0,-46.0,-43.0,-49.0,-85.0,-86.0,-82.0,-81.0,32.0,40.0,40.0,32.0,1
5510,CC:2F:71:3F:1F:24,4669349,1384311004,832307,900369854,3837042,483941150,37,675649,711429420,674917,711341376,732,88044,651340,15,832564,89134,34,531,144444.0,43333.0,-69.0,-65.0,-68.0,-70.0,-69.0,-65.0,-68.0,-69.0,-85.0,-86.0,-82.0,-81.0,16.0,21.0,14.0,11.0,1
5511,CC:2F:71:3E:C5:1F,3837934,484050204,890,108852,3837044,483941352,0,3705,311376,3057,234468,648,76908,942,9,1277,20,0,43,144444.0,39000.0,-71.0,-71.0,-68.0,-60.0,-72.0,-73.0,-69.0,-62.0,-85.0,-86.0,-82.0,-81.0,14.0,15.0,14.0,21.0,1
5512,BA:8C:B9:54:50:24,3841889,490125161,4845,6183809,3837044,483941352,0,9062,1704019,9040,1700524,22,3495,2348,15,5291,39,0,59,216660.0,130000.0,-40.0,-36.0,-45.0,-51.0,-41.0,-35.0,-44.0,-50.0,-85.0,-86.0,-82.0,-81.0,45.0,50.0,37.0,30.0,1
5513,62:47:05:9D:EB:15,3837104,483952903,58,11349,3837046,483941554,0,152,15809,141,13643,11,2166,41,0,84,0,0,6,229410.0,130000.0,-52.0,-45.0,-54.0,-60.0,-52.0,-45.0,-53.0,-60.0,-85.0,-86.0,-82.0,-81.0,33.0,41.0,28.0,21.0,1
5514,3C:55:76:E8:8F:1F,3891822,620670978,54776,136729424,3837046,483941554,23,25165,5687686,24832,5629046,333,58640,11044,31,54842,6467,23,251,195000.0,1000.0,-49.0,-54.0,-48.0,-40.0,-48.0,-53.0,-46.0,-39.0,-85.0,-86.0,-82.0,-81.0,36.0,32.0,34.0,41.0,1
5515,92:69:1D:31:68:E9,3840984,487569246,3938,3627692,3837046,483941554,0,4868,1111998,4722,1078923,146,33075,2133,11,4148,90,0,45,216660.0,130000.0,-53.0,-46.0,-42.0,-49.0,-51.0,-46.0,-43.0,-49.0,-85.0,-86.0,-82.0,-81.0,32.0,40.0,40.0,32.0,1
5516,CC:2F:71:3F:1F:24,4669560,1384571454,832514,900629900,3837046,483941554,37,675840,711682964,675108,711594920,732,88044,651523,15,832771,89148,34,531,144444.0,43333.0,-69.0,-65.0,-68.0,-69.0,-69.0,-65.0,-68.0,-69.0,-85.0,-86.0,-82.0,-81.0,16.0,21.0,14.0,12.0,1
5517,CC:2F:71:3E:C5:1F,3837936,484050406,890,108852,3837046,483941554,0,3705,311376,3057,234468,648,76908,942,9,1277,20,0,43,144444.0,39000.0,-71.0,-71.0,-68.0,-60.0,-72.0,-73.0,-69.0,-62.0,-85.0,-86.0,-82.0,-81.0,14.0,15.0,14.0,21.0,1
5518,BA:8C:B9:54:50:24,3841893,490125565,4845,6183809,3837048,483941756,0,9062,1704019,9040,1700524,22,3495,2348,15,5291,39,0,59,216660.0,130000.0,-40.0,-36.0,-45.0,-51.0,-41.0,-35.0,-44.0,-50.0,-85.0,-86.0,-82.0,-81.0,45.0,50.0,37.0,30.0,1
5519,62:47:05:9D:EB:15,3837109,483953367,58,11349,3837051,483942018,0,152,15809,141,13643,11,2166,41,0,84,0,0,6,229410.0,130000.0,-52.0,-45.0,-54.0,-60.0,-52.0,-45.0,-53.0,-60.0,-85.0,-86.0,-82.0,-81.0,33.0,41.0,28.0,21.0,1
5520,3C:55:76:E8:8F:1F,3891829,620671644,54776,136729424,3837053,483942220,23,25166,5687844,24833,5629204,333,58640,11045,31,54842,6467,23,251,195000.0,1000.0,-51.0,-51.0,-45.0,-40.0,-48.0,-52.0,-46.0,-39.0,-85.0,-86.0,-82.0,-81.0,34.0,35.0,37.0,41.0,1
5521,92:69:1D:31:68:E9,3840991,487569912,3938,3627692,3837053,483942220,0,4868,1111998,4722,1078923,146,33075,2133,11,4148,90,0,45,216660.0,130000.0,-53.0,-46.0,-42.0,-49.0,-51.0,-46.0,-43.0,-49.0,-85.0,-86.0,-82.0,-81.0,32.0,40.0,40.0,32.0,1
5522,CC:2F:71:3F:1F:24,4669782,1384838631,832729,900896411,3837053,483942220,37,676041,711940883,675309,711852839,732,88044,651716,15,832986,89167,34,531,144444.0,43333.0,-70.0,-65.0,-69.0,-69.0,-69.0,-65.0,-68.0,-69.0,-85.0,-86.0,-82.0,-81.0,15.0,21.0,13.0,12.0,1
5523,CC:2F:71:3E:C5:1F,3837945,484051304,892,109084,3837053,483942220,0,3710,311798,3062,234890,648,76908,944,9,1279,20,0,43,144444.0,39000.0,-71.0,-71.0,-68.0,-61.0,-72.0,-72.0,-68.0,-61.0,-85.0,-86.0,-82.0,-81.0,14.0,15.0,14.0,20.0,1
5524,BA:8C:B9:54:50:24,3841898,490126029,4845,6183809,3837053,483942220,0,9062,1704019,9040,1700524,22,3495,2348,15,5291,39,0,59,216660.0,130000.0,-40.0,-36.0,-45.0,-51.0,-41.0,-35.0,-44.0,-50.0,-85.0,-86.0,-82.0,-81.0,45.0,50.0,37.0,30.0,1
5525,62:47:05:9D:EB:15,3837115,483953973,58,11349,3837057,483942624,0,152,15809,141,13643,11,2166,41,0,84,0,0,6,229410.0,130000.0,-52.0,-45.0,-54.0,-60.0,-52.0,-45.0,-53.0,-60.0,-85.0,-86.0,-82.0,-81.0,33.0,41.0,28.0,21.0,1
5526,3C:55:76:E8:8F:1F,3891834,620672222,54777,136729598,3837057,483942624,23,25182,5688974,24849,5630334,333,58640,11046,31,54843,6467,23,251,162500.0,1000.0,-52.0,-50.0,-44.0,-45.0,-51.0,-49.0,-43.0,-44.0,-85.0,-86.0,-82.0,-81.0,33.0,36.0,38.0,36.0,1
5527,92:69:1D:31:68:E9,3840995,487570316,3938,3627692,3837057,483942624,0,4868,1111998,4722,1078923,146,33075,2133,11,4148,90,0,45,216660.0,130000.0,-53.0,-46.0,-42.0,-49.0,-51.0,-46.0,-43.0,-49.0,-85.0,-86.0,-82.0,-81.0,32.0,40.0,40.0,32.0,1
5528,CC:2F:71:3F:1F:24,4670004,1385114751,832947,901172127,3837057,483942624,37,676247,712216275,675515,712128231,732,88044,651911,15,833204,89185,34,531,144444.0,43333.0,-69.0,-65.0,-69.0,-69.0,-69.0,-64.0,-68.0,-69.0,-85.0,-86.0,-82.0,-81.0,16.0,21.0,13.0,12.0,1
5529,CC:2F:71:3E:C5:1F,3837949,484051708,892,109084,3837057,483942624,0,3710,311798,3062,234890,648,76908,944,9,1279,20,0,43,144444.0,39000.0,-71.0,-71.0,-68.0,-61.0,-72.0,-72.0,-68.0,-61.0,-85.0,-86.0,-82.0,-81.0,14.0,15.0,14.0,20.0,1
5530,BA:8C:B9:54:50:24,3841902,490126433,4845,6183809,3837057,483942624,0,9062,1704019,9040,1700524,22,3495,2348,15,5291,39,0,59,216660.0,130000.0,-40.0,-36.0,-45.0,-51.0,-41.0,-35.0,-44.0,-50.0,-85.0,-86.0,-82.0,-81.0,45.0,50.0,37.0,30.0,1
5531,62:47:05:9D:EB:15,3837120,483954437,58,11349,3837062,483943088,0,152,15809,141,13643,11,2166,41,0,84,0,0,6,229410.0,130000.0,-52.0,-45.0,-54.0,-60.0,-52.0,-45.0,-53.0,-60.0,-85.0,-85.0,-81.0,-81.0,33.0,40.0,27.0,21.0,1
5532,3C:55:76:E8:8F:1F,3891839,620672686,54777,136729598,3837062,483943088,23,25182,5688974,24849,5630334,333,58640,11046,31,54843,6467,23,251,162500.0,1000.0,-52.0,-50.0,-44.0,-45.0,-51.0,-49.0,-43.0,-44.0,-85.0,-85.0,-81.0,-81.0,33.0,35.0,37.0,36.0,1
5533,92:69:1D:31:68:E9,3841000,487570780,3938,3627692,3837062,483943088,0,4870,1112134,4724,1079059,146,33075,2133,11,4149,90,0,45,216660.0,130000.0,-53.0,-49.0,-43.0,-49.0,-51.0,-47.0,-43.0,-49.0,-85.0,-85.0,-81.0,-81.0,32.0,36.0,38.0,32.0,1
5534,CC:2F:71:3F:1F:24,4670221,1385378798,833159,901435710,3837062,483943088,37,676439,712468604,675707,712380560,732,88044,652096,15,833416,89199,34,531,144444.0,43333.0,-69.0,-65.0,-69.0,-69.0,-69.0,-64.0,-68.0,-69.0,-85.0,-85.0,-81.0,-81.0,16.0,20.0,12.0,12.0,1
5535,CC:2F:71:3E:C5:1F,3837954,484052172,892,109084,3837062,483943088,0,3710,311798,3062,234890,648,76908,944,9,1279,20,0,43,144444.0,39000.0,-71.0,-71.0,-68.0,-61.0,-72.0,-72.0,-68.0,-61.0,-85.0,-85.0,-81.0,-81.0,14.0,14.0,13.0,20.0,1
5536,BA:8C:B9:54:50:24,3841917,490130009,4845,6183809,3837072,483946200,0,9064,1704155,9042,1700660,22,3495,2348,15,5292,39,0,59,216660.0,130000.0,-39.0,-36.0,-45.0,-51.0,-40.0,-35.0,-45.0,-50.0,-85.0,-85.0,-81.0,-81.0,46.0,49.0,36.0,30.0,1
5537,62:47:05:9D:EB:15,3837133,483957813,58,11349,3837075,483946464,0,152,15809,141,13643,11,2166,41,0,84,0,0,6,229410.0,130000.0,-52.0,-45.0,-54.0,-60.0,-52.0,-45.0,-53.0,-60.0,-85.0,-85.0,-81.0,-81.0,33.0,40.0,27.0,21.0,1
5538,3C:55:76:E8:8F:1F,3891852,620676062,54777,136729598,3837075,483946464,23,25190,5689572,24856,5630814,334,58758,11047,31,54843,6467,23,251,162500.0,1000.0,-52.0,-50.0,-44.0,-45.0,-50.0,-48.0,-42.0,-41.0,-85.0,-85.0,-81.0,-81.0,33.0,35.0,37.0,36.0,1
5539,92:69:1D:31:68:E9,3841013,487574156,3938,3627692,3837075,483946464,0,4870,1112134,4724,1079059,146,33075,2133,11,4149,90,0,45,216660.0,130000.0,-53.0,-49.0,-43.0,-49.0,-51.0,-47.0,-43.0,-49.0,-85.0,-85.0,-81.0,-81.0,32.0,36.0,38.0,32.0,1
5540,CC:2F:71:3F:1F:24,4670453,1385649189,833378,901702725,3837075,483946464,37,676642,712725399,675910,712637355,732,88044,652293,15,833635,89214,34,531,144444.0,43333.0,-69.0,-65.0,-68.0,-69.0,-69.0,-65.0,-67.0,-69.0,-85.0,-85.0,-81.0,-81.0,16.0,20.0,13.0,12.0,1
5541,CC:2F:71:3E:C5:1F,3837967,484055548,892,109084,3837075,483946464,0,3710,311798,3062,234890,648,76908,944,9,1279,20,0,43,144444.0,39000.0,-71.0,-71.0,-68.0,-61.0,-72.0,-72.0,-68.0,-61.0,-85.0,-85.0,-81.0,-81.0,14.0,14.0,13.0,20.0,1
5542,BA:8C:B9:54:50:24,3841920,490130273,4845,6183809,3837075,483946464,0,9064,1704155,9042,1700660,22,3495,2348,15,5292,39,0,59,216660.0,130000.0,-39.0,-36.0,-45.0,-51.0,-40.0,-35.0,-45.0,-50.0,-85.0,-85.0,-81.0,-81.0,46.0,49.0,36.0,30.0,1
5543,62:47:05:9D:EB:15,3837137,483958217,58,11349,3837079,483946868,0,152,15809,141,13643,11,2166,41,0,84,0,0,6,229410.0,130000.0,-52.0,-45.0,-54.0,-60.0,-52.0,-45.0,-53.0,-60.0,-85.0,-85.0,-81.0,-81.0,33.0,40.0,27.0,21.0,1
5544,3C:55:76:E8:8F:1F,3891856,620676466,54777,136729598,3837079,483946868,23,25190,5689572,24856,5630814,334,58758,11047,31,54843,6467,23,251,162500.0,1000.0,-52.0,-50.0,-44.0,-45.0,-50.0,-48.0,-42.0,-41.0,-85.0,-85.0,-81.0,-81.0,33.0,35.0,37.0,36.0,1
5545,92:69:1D:31:68:E9,3841019,487574762,3938,3627692,3837081,483947070,0,4870,1112134,4724,1079059,146,33075,2133,11,4149,90,0,45,216660.0,130000.0,-53.0,-49.0,-43.0,-49.0,-51.0,-47.0,-43.0,-49.0,-85.0,-85.0,-81.0,-81.0,32.0,36.0,38.0,32.0,1
5546,CC:2F:71:3F:1F:24,4670671,1385913279,833589,901966139,3837082,483947140,37,676839,712985509,676107,712897465,732,88044,652479,15,833846,89235,34,531,144444.0,43333.0,-69.0,-64.0,-68.0,-70.0,-69.0,-64.0,-68.0,-69.0,-85.0,-85.0,-81.0,-81.0,16.0,21.0,13.0,11.0,1
5547,CC:2F:71:3E:C5:1F,3837974,484056224,892,109084,3837082,483947140,0,3710,311798,3062,234890,648,76908,944,9,1279,20,0,43,144444.0,39000.0,-71.0,-71.0,-68.0,-61.0,-72.0,-72.0,-68.0,-61.0,-85.0,-85.0,-81.0,-81.0,14.0,14.0,13.0,20.0,1
5548,BA:8C:B9:54:50:24,3841928,490131009,4845,6183809,3837083,483947200,0,9064,1704155,9042,1700660,22,3495,2348,15,5292,39,0,59,216660.0,130000.0,-39.0,-36.0,-45.0,-51.0,-40.0,-35.0,-45.0,-50.0,-85.0,-85.0,-81.0,-81.0,46.0,49.0,36.0,30.0,1
5549,62:47:05:9D:EB:15,3837144,483958813,58,11349,3837086,483947464,0,152,15809,141,13643,11,2166,41,0,84,0,0,6,229410.0,130000.0,-52.0,-45.0,-54.0,-60.0,-52.0,-45.0,-53.0,-60.0,-85.0,-85.0,-81.0,-81.0,33.0,40.0,27.0,21.0,1
5550,3C:55:76:E8:8F:1F,3891863,620677062,54777,136729598,3837086,483947464,23,25197,5690110,24862,5631226,335,58884,11048,31,54843,6467,23,252,162500.0,1000.0,-49.0,-48.0,-41.0,-42.0,-49.0,-48.0,-42.0,-41.0,-85.0,-85.0,-81.0,-81.0,36.0,37.0,40.0,39.0,1
5551,92:69:1D:31:68:E9,3841024,487575156,3938,3627692,3837086,483947464,0,4870,1112134,4724,1079059,146,33075,2133,11,4149,90,0,45,216660.0,130000.0,-53.0,-49.0,-43.0,-49.0,-51.0,-47.0,-43.0,-49.0,-85.0,-85.0,-81.0,-81.0,32.0,36.0,38.0,32.0,1
5552,CC:2F:71:3F:1F:24,4670887,1386177089,833799,902229423,3837088,483947666,37,677031,713241893,676299,713153849,732,88044,652663,15,834056,89248,34,531,144444.0,43333.0,-69.0,-65.0,-68.0,-69.0,-69.0,-65.0,-68.0,-69.0,-85.0,-85.0,-81.0,-81.0,16.0,20.0,13.0,12.0,1
5553,CC:2F:71:3E:C5:1F,3837980,484056750,892,109084,3837088,483947666,0,3712,311986,3063,234960,649,77026,945,9,1279,20,0,44,144444.0,39000.0,-79.0,-81.0,-73.0,-70.0,-72.0,-72.0,-68.0,-61.0,-85.0,-85.0,-81.0,-81.0,6.0,4.0,8.0,11.0,1
5554,BA:8C:B9:54:50:24,3841933,490131475,4845,6183809,3837088,483947666,0,9064,1704155,9042,1700660,22,3495,2348,15,5292,39,0,59,216660.0,130000.0,-39.0,-36.0,-45.0,-51.0,-40.0,-35.0,-45.0,-50.0,-85.0,-85.0,-81.0,-81.0,46.0,49.0,36.0,30.0,1
5555,62:47:05:9D:EB:15,3837150,483959419,58,11349,3837092,483948070,0,152,15809,141,13643,11,2166,41,0,84,0,0,6,229410.0,130000.0,-52.0,-45.0,-54.0,-60.0,-52.0,-45.0,-53.0,-60.0,-85.0,-85.0,-81.0,-81.0,33.0,40.0,27.0,21.0,1
5556,3C:55:76:E8:8F:1F,3891869,620677668,54777,136729598,3837092,483948070,23,25198,5690178,24863,5631294,335,58884,11048,31,54843,6467,23,252,162500.0,1000.0,-46.0,-52.0,-46.0,-36.0,-48.0,-48.0,-42.0,-39.0,-85.0,-85.0,-81.0,-81.0,39.0,33.0,35.0,45.0,1
5557,92:69:1D:31:68:E9,3841030,487575762,3938,3627692,3837092,483948070,0,4870,1112134,4724,1079059,146,33075,2133,11,4149,90,0,45,216660.0,130000.0,-53.0,-49.0,-43.0,-49.0,-51.0,-47.0,-43.0,-49.0,-85.0,-85.0,-81.0,-81.0,32.0,36.0,38.0,32.0,1
5558,CC:2F:71:3F:1F:24,4671101,1386440609,834009,902492539,3837092,483948070,37,677225,713498605,676493,713410561,732,88044,652849,15,834266,89262,34,531,144444.0,43333.0,-69.0,-64.0,-68.0,-69.0,-69.0,-64.0,-68.0,-69.0,-85.0,-85.0,-81.0,-81.0,16.0,21.0,13.0,12.0,1
5559,CC:2F:71:3E:C5:1F,3837986,484057356,892,109084,3837094,483948272,0,3712,311986,3063,234960,649,77026,945,9,1279,20,0,44,144444.0,39000.0,-79.0,-81.0,-73.0,-70.0,-72.0,-72.0,-68.0,-61.0,-85.0,-85.0,-81.0,-81.0,6.0,4.0,8.0,11.0,1
5560,BA:8C:B9:54:50:24,3841939,490132081,4845,6183809,3837094,483948272,0,9064,1704155,9042,1700660,22,3495,2348,15,5292,39,0,59,216660.0,130000.0,-39.0,-36.0,-45.0,-51.0,-40.0,-35.0,-45.0,-50.0,-85.0,-85.0,-81.0,-81.0,46.0,49.0,36.0,30.0,1
5561,62:47:05:9D:EB:15,3837156,483960156,58,11349,3837098,483948807,0,152,15809,141,13643,11,2166,41,0,84,0,0,6,229410.0,130000.0,-52.0,-45.0,-54.0,-60.0,-52.0,-45.0,-53.0,-60.0,-85.0,-85.0,-81.0,-81.0,33.0,40.0,27.0,21.0,1
5562,3C:55:76:E8:8F:1F,3891875,620678405,54777,136729598,3837098,483948807,23,25198,5690178,24863,5631294,335,58884,11048,31,54843,6467,23,252,162500.0,1000.0,-46.0,-52.0,-46.0,-36.0,-48.0,-48.0,-42.0,-39.0,-85.0,-85.0,-81.0,-81.0,39.0,33.0,35.0,45.0,1
5563,92:69:1D:31:68:E9,3841036,487576499,3938,3627692,3837098,483948807,0,4870,1112134,4724,1079059,146,33075,2133,11,4149,90,0,45,216660.0,130000.0,-53.0,-49.0,-43.0,-49.0,-51.0,-47.0,-43.0,-49.0,-85.0,-85.0,-81.0,-81.0,32.0,36.0,38.0,32.0,1
5564,CC:2F:71:3F:1F:24,4671330,1386711671,834230,902762662,3837100,483949009,37,677426,713755214,676694,713667170,732,88044,653043,15,834487,89282,34,531,144444.0,43333.0,-69.0,-65.0,-68.0,-69.0,-69.0,-65.0,-68.0,-69.0,-85.0,-85.0,-81.0,-81.0,16.0,20.0,13.0,12.0,1
5565,CC:2F:71:3E:C5:1F,3837992,484058093,892,109084,3837100,483949009,0,3712,311986,3063,234960,649,77026,945,9,1279,20,0,44,144444.0,39000.0,-79.0,-81.0,-73.0,-70.0,-72.0,-72.0,-68.0,-61.0,-85.0,-85.0,-81.0,-81.0,6.0,4.0,8.0,11.0,1
5566,BA:8C:B9:54:50:24,3841945,490132818,4845,6183809,3837100,483949009,0,9064,1704155,9042,1700660,22,3495,2348,15,5292,39,0,59,216660.0,130000.0,-39.0,-36.0,-45.0,-51.0,-40.0,-35.0,-45.0,-50.0,-85.0,-85.0,-81.0,-81.0,46.0,49.0,36.0,30.0,1
5567,62:47:05:9D:EB:15,3837162,483960762,58,11349,3837104,483949413,0,152,15809,141,13643,11,2166,41,0,84,0,0,6,229410.0,130000.0,-52.0,-45.0,-54.0,-60.0,-52.0,-45.0,-53.0,-60.0,-85.0,-85.0,-81.0,-81.0,33.0,40.0,27.0,21.0,1
5568,3C:55:76:E8:8F:1F,3891881,620679011,54777,136729598,3837104,483949413,23,25198,5690178,24863,5631294,335,58884,11048,31,54843,6467,23,252,162500.0,1000.0,-46.0,-52.0,-46.0,-36.0,-48.0,-48.0,-42.0,-39.0,-85.0,-85.0,-81.0,-81.0,39.0,33.0,35.0,45.0,1
5569,92:69:1D:31:68:E9,3841042,487577105,3938,3627692,3837104,483949413,0,4870,1112134,4724,1079059,146,33075,2133,11,4149,90,0,45,216660.0,130000.0,-53.0,-49.0,-43.0,-49.0,-51.0,-47.0,-43.0,-49.0,-85.0,-85.0,-81.0,-81.0,32.0,36.0,38.0,32.0,1
5570,CC:2F:71:3F:1F:24,4671545,1386975489,834441,903026076,3837104,483949413,37,677617,714010078,676885,713922034,732,88044,653228,15,834698,89297,34,531,144444.0,43333.0,-69.0,-65.0,-69.0,-69.0,-69.0,-64.0,-68.0,-69.0,-85.0,-85.0,-81.0,-81.0,16.0,20.0,12.0,12.0,1
5571,CC:2F:71:3E:C5:1F,3837996,484058497,892,109084,3837104,483949413,0,3712,311986,3063,234960,649,77026,945,9,1279,20,0,44,144444.0,39000.0,-79.0,-81.0,-73.0,-70.0,-72.0,-72.0,-68.0,-61.0,-85.0,-85.0,-81.0,-81.0,6.0,4.0,8.0,11.0,1
5572,BA:8C:B9:54:50:24,3841949,490133222,4845,6183809,3837104,483949413,0,9064,1704155,9042,1700660,22,3495,2348,15,5292,39,0,59,216660.0,130000.0,-39.0,-36.0,-45.0,-51.0,-40.0,-35.0,-45.0,-50.0,-85.0,-85.0,-81.0,-81.0,46.0,49.0,36.0,30.0,1
5573,62:47:05:9D:EB:15,3837167,483961226,58,11349,3837109,483949877,0,152,15809,141,13643,11,2166,41,0,84,0,0,6,229410.0,130000.0,-52.0,-45.0,-54.0,-60.0,-52.0,-45.0,-53.0,-60.0,-85.0,-85.0,-81.0,-80.0,33.0,40.0,27.0,20.0,1
5574,3C:55:76:E8:8F:1F,3891886,620679475,54777,136729598,3837109,483949877,23,25199,5690246,24864,5631362,335,58884,11048,31,54843,6467,23,252,162500.0,1000.0,-50.0,-48.0,-42.0,-40.0,-48.0,-48.0,-42.0,-40.0,-85.0,-85.0,-81.0,-80.0,35.0,37.0,39.0,40.0,1
5575,92:69:1D:31:68:E9,3841047,487577569,3938,3627692,3837109,483949877,0,4870,1112134,4724,1079059,146,33075,2133,11,4149,90,0,45,216660.0,130000.0,-53.0,-49.0,-43.0,-49.0,-51.0,-47.0,-43.0,-49.0,-85.0,-85.0,-81.0,-80.0,32.0,36.0,38.0,31.0,1
5576,CC:2F:71:3F:1F:24,4671767,1387248691,834658,903298814,3837109,483949877,37,677815,714271458,677083,714183414,732,88044,653420,15,834914,89312,34,531,144444.0,43333.0,-69.0,-64.0,-68.0,-69.0,-69.0,-64.0,-68.0,-69.0,-85.0,-85.0,-81.0,-80.0,16.0,21.0,13.0,11.0,1
5577,CC:2F:71:3E:C5:1F,3838001,484058961,892,109084,3837109,483949877,0,3712,311986,3063,234960,649,77026,945,9,1279,20,0,44,144444.0,39000.0,-79.0,-81.0,-73.0,-70.0,-72.0,-72.0,-68.0,-61.0,-85.0,-85.0,-81.0,-80.0,6.0,4.0,8.0,10.0,1
5578,BA:8C:B9:54:50:24,3841954,490133686,4845,6183809,3837109,483949877,0,9064,1704155,9042,1700660,22,3495,2348,15,5292,39,0,59,216660.0,130000.0,-39.0,-36.0,-45.0,-51.0,-40.0,-35.0,-45.0,-50.0,-85.0,-85.0,-81.0,-80.0,46.0,49.0,36.0,29.0,1
5579,62:47:05:9D:EB:15,3837171,483961630,58,11349,3837113,483950281,0,152,15809,141,13643,11,2166,41,0,84,0,0,6,229410.0,130000.0,-52.0,-45.0,-54.0,-60.0,-52.0,-45.0,-53.0,-60.0,-85.0,-85.0,-81.0,-80.0,33.0,40.0,27.0,20.0,1
5580,3C:55:76:E8:8F:1F,3891890,620679879,54777,136729598,3837113,483950281,23,25200,5690314,24865,5631430,335,58884,11048,31,54843,6467,23,252,162500.0,1000.0,-50.0,-48.0,-42.0,-40.0,-49.0,-48.0,-42.0,-40.0,-85.0,-85.0,-81.0,-80.0,35.0,37.0,39.0,40.0,1
5581,92:69:1D:31:68:E9,3841052,487578099,3938,3627692,3837114,483950407,0,4870,1112134,4724,1079059,146,33075,2133,11,4149,90,0,45,216660.0,130000.0,-53.0,-49.0,-43.0,-49.0,-51.0,-47.0,-43.0,-49.0,-85.0,-85.0,-81.0,-80.0,32.0,36.0,38.0,31.0,1
5582,CC:2F:71:3F:1F:24,4671994,1387514505,834880,903564098,3837114,483950407,37,678022,714530580,677290,714442536,732,88044,653618,15,835137,89321,34,531,144444.0,43333.0,-69.0,-65.0,-68.0,-70.0,-68.0,-64.0,-68.0,-69.0,-85.0,-85.0,-81.0,-80.0,16.0,20.0,13.0,10.0,1
5583,CC:2F:71:3E:C5:1F,3838006,484059491,892,109084,3837114,483950407,0,3712,311986,3063,234960,649,77026,945,9,1279,20,0,44,144444.0,39000.0,-79.0,-81.0,-73.0,-70.0,-72.0,-72.0,-68.0,-61.0,-85.0,-85.0,-81.0,-80.0,6.0,4.0,8.0,10.0,1
5584,BA:8C:B9:54:50:24,3841959,490134216,4845,6183809,3837114,483950407,0,9064,1704155,9042,1700660,22,3495,2348,15,5292,39,0,59,216660.0,130000.0,-39.0,-36.0,-45.0,-51.0,-40.0,-35.0,-45.0,-50.0,-85.0,-85.0,-81.0,-80.0,46.0,49.0,36.0,29.0,1
5585,62:47:05:9D:EB:15,3837176,483962160,58,11349,3837118,483950811,0,152,15809,141,13643,11,2166,41,0,84,0,0,6,229410.0,130000.0,-52.0,-45.0,-54.0,-60.0,-52.0,-45.0,-53.0,-60.0,-85.0,-85.0,-81.0,-80.0,33.0,40.0,27.0,20.0,1
5586,3C:55:76:E8:8F:1F,3891895,620680409,54777,136729598,3837118,483950811,23,25200,5690314,24865,5631430,335,58884,11048,31,54843,6467,23,252,162500.0,1000.0,-50.0,-48.0,-42.0,-40.0,-49.0,-48.0,-42.0,-40.0,-85.0,-85.0,-81.0,-80.0,35.0,37.0,39.0,40.0,1
5587,92:69:1D:31:68:E9,3841058,487578705,3938,3627692,3837120,483951013,0,4870,1112134,4724,1079059,146,33075,2133,11,4149,90,0,45,216660.0,130000.0,-53.0,-49.0,-43.0,-49.0,-51.0,-47.0,-43.0,-49.0,-85.0,-85.0,-81.0,-80.0,32.0,36.0,38.0,31.0,1
5588,CC:2F:71:3F:1F:24,4672219,1387780610,835098,903829537,3837121,483951073,37,678213,714779882,677481,714691838,732,88044,653807,15,835354,89359,34,531,130000.0,43333.0,-71.0,-66.0,-68.0,-68.0,-71.0,-66.0,-68.0,-68.0,-85.0,-85.0,-81.0,-80.0,14.0,19.0,13.0,12.0,1
5589,CC:2F:71:3E:C5:1F,3838013,484060157,892,109084,3837121,483951073,0,3712,311986,3063,234960,649,77026,945,9,1279,20,0,44,144444.0,39000.0,-79.0,-81.0,-73.0,-70.0,-72.0,-72.0,-68.0,-61.0,-85.0,-85.0,-81.0,-80.0,6.0,4.0,8.0,10.0,1
5590,BA:8C:B9:54:50:24,3841966,490134882,4845,6183809,3837121,483951073,0,9064,1704155,9042,1700660,22,3495,2348,15,5292,39,0,59,216660.0,130000.0,-39.0,-36.0,-45.0,-51.0,-40.0,-35.0,-45.0,-50.0,-85.0,-85.0,-81.0,-80.0,46.0,49.0,36.0,29.0,1
5591,62:47:05:9D:EB:15,3837181,483962624,58,11349,3837123,483951275,0,152,15809,141,13643,11,2166,41,0,84,0,0,6,229410.0,130000.0,-52.0,-45.0,-54.0,-60.0,-52.0,-45.0,-53.0,-60.0,-85.0,-85.0,-81.0,-80.0,33.0,40.0,27.0,20.0,1
5592,3C:55:76:E8:8F:1F,3891905,620683705,54782,136732430,3837123,483951275,23,25223,5695537,24888,5636653,335,58884,11056,31,54848,6467,23,253,162500.0,48750.0,-49.0,-51.0,-48.0,-38.0,-49.0,-52.0,-47.0,-39.0,-85.0,-85.0,-81.0,-80.0,36.0,34.0,33.0,42.0,1
5593,92:69:1D:31:68:E9,3841061,487578967,3938,3627692,3837123,483951275,0,4870,1112134,4724,1079059,146,33075,2133,11,4149,90,0,45,216660.0,130000.0,-53.0,-49.0,-43.0,-49.0,-51.0,-47.0,-43.0,-49.0,-85.0,-85.0,-81.0,-80.0,32.0,36.0,38.0,31.0,1
5594,CC:2F:71:3F:1F:24,4672428,1388037940,835305,904086665,3837123,483951275,37,678406,715035038,677674,714946994,732,88044,653989,15,835562,89362,34,531,130000.0,39000.0,-71.0,-66.0,-69.0,-67.0,-70.0,-66.0,-68.0,-68.0,-85.0,-85.0,-81.0,-80.0,14.0,19.0,12.0,13.0,1
5595,CC:2F:71:3E:C5:1F,3838015,484060359,892,109084,3837123,483951275,0,3712,311986,3063,234960,649,77026,945,9,1279,20,0,44,144444.0,39000.0,-79.0,-81.0,-73.0,-70.0,-72.0,-72.0,-68.0,-61.0,-85.0,-85.0,-81.0,-80.0,6.0,4.0,8.0,10.0,1
5596,BA:8C:B9:54:50:24,3841970,490135286,4845,6183809,3837125,483951477,0,9064,1704155,9042,1700660,22,3495,2348,15,5292,39,0,59,216660.0,130000.0,-39.0,-36.0,-45.0,-51.0,-40.0,-35.0,-45.0,-50.0,-85.0,-85.0,-81.0,-80.0,46.0,49.0,36.0,29.0,1
5597,62:47:05:9D:EB:15,3837187,483963230,58,11349,3837129,483951881,0,152,15809,141,13643,11,2166,41,0,84,0,0,6,229410.0,130000.0,-52.0,-45.0,-54.0,-60.0,-52.0,-45.0,-53.0,-60.0,-85.0,-85.0,-81.0,-80.0,33.0,40.0,27.0,20.0,1
5598,3C:55:76:E8:8F:1F,3891911,620684311,54782,136732430,3837129,483951881,23,25223,5695537,24888,5636653,335,58884,11056,31,54848,6467,23,253,162500.0,48750.0,-49.0,-51.0,-48.0,-38.0,-49.0,-52.0,-47.0,-39.0,-85.0,-85.0,-81.0,-80.0,36.0,34.0,33.0,42.0,1
5599,92:69:1D:31:68:E9,3841067,487579573,3938,3627692,3837129,483951881,0,4870,1112134,4724,1079059,146,33075,2133,11,4149,90,0,45,216660.0,130000.0,-53.0,-49.0,-43.0,-49.0,-51.0,-47.0,-43.0,-49.0,-85.0,-85.0,-81.0,-80.0,32.0,36.0,38.0,31.0,1
5600,CC:2F:71:3F:1F:24,4672655,1388314036,835524,904361953,3837131,483952083,37,678603,715293652,677871,715205608,732,88044,654185,15,835781,89389,34,531,130000.0,43333.0,-66.0,-66.0,-67.0,-69.0,-66.0,-66.0,-67.0,-69.0,-85.0,-85.0,-81.0,-80.0,19.0,19.0,14.0,11.0,1
5601,CC:2F:71:3E:C5:1F,3838023,484061167,892,109084,3837131,483952083,0,3712,311986,3063,234960,649,77026,945,9,1279,20,0,44,144444.0,39000.0,-79.0,-81.0,-73.0,-70.0,-72.0,-72.0,-68.0,-61.0,-85.0,-85.0,-81.0,-80.0,6.0,4.0,8.0,10.0,1
5602,BA:8C:B9:54:50:24,3841976,490135892,4845,6183809,3837131,483952083,0,9064,1704155,9042,1700660,22,3495,2348,15,5292,39,0,59,216660.0,130000.0,-39.0,-36.0,-45.0,-51.0,-40.0,-35.0,-45.0,-50.0,-85.0,-85.0,-81.0,-80.0,46.0,49.0,36.0,29.0,1
5603,62:47:05:9D:EB:15,3837190,483963492,58,11349,3837132,483952143,0,152,15809,141,13643,11,2166,41,0,84,0,0,6,229410.0,130000.0,-52.0,-45.0,-54.0,-60.0,-52.0,-45.0,-53.0,-60.0,-85.0,-85.0,-81.0,-80.0,33.0,40.0,27.0,20.0,1
5604,3C:55:76:E8:8F:1F,3891917,620684849,54783,136732504,3837134,483952345,23,25229,5695984,24894,5637100,335,58884,11057,31,54849,6467,23,253,162500.0,48750.0,-45.0,-57.0,-44.0,-39.0,-46.0,-54.0,-44.0,-38.0,-85.0,-85.0,-81.0,-80.0,40.0,28.0,37.0,41.0,1
5605,92:69:1D:31:68:E9,3841074,487580239,3938,3627692,3837136,483952547,0,4871,1112202,4725,1079127,146,33075,2133,11,4149,90,0,45,216660.0,130000.0,-51.0,-47.0,-42.0,-49.0,-51.0,-47.0,-43.0,-49.0,-85.0,-85.0,-81.0,-80.0,34.0,38.0,39.0,31.0,1
5606,CC:2F:71:3F:1F:24,4673326,1389148853,836190,905196306,3837136,483952547,37,678994,715580675,678262,715492631,732,88044,654572,15,836447,89396,34,531,130000.0,43333.0,-68.0,-67.0,-66.0,-71.0,-67.0,-66.0,-66.0,-70.0,-85.0,-85.0,-81.0,-80.0,17.0,18.0,15.0,9.0,1
5607,CC:2F:71:3E:C5:1F,3838028,484061631,892,109084,3837136,483952547,0,3712,311986,3063,234960,649,77026,945,9,1279,20,0,44,144444.0,39000.0,-79.0,-81.0,-73.0,-70.0,-72.0,-72.0,-68.0,-61.0,-85.0,-85.0,-81.0,-80.0,6.0,4.0,8.0,10.0,1
5608,BA:8C:B9:54:50:24,3841981,490136356,4845,6183809,3837136,483952547,0,9064,1704155,9042,1700660,22,3495,2348,15,5292,39,0,59,216660.0,130000.0,-39.0,-36.0,-45.0,-51.0,-40.0,-35.0,-45.0,-50.0,-85.0,-85.0,-81.0,-80.0,46.0,49.0,36.0,29.0,1
5609,62:47:05:9D:EB:15,3837198,483964300,58,11349,3837140,483952951,0,152,15809,141,13643,11,2166,41,0,84,0,0,6,229410.0,130000.0,-52.0,-45.0,-54.0,-60.0,-52.0,-45.0,-53.0,-60.0,-85.0,-85.0,-81.0,-80.0,33.0,40.0,27.0,20.0,1
5610,3C:55:76:E8:8F:1F,3891926,620685993,54786,136733042,3837140,483952951,23,25240,5698306,24905,5639422,335,58884,11061,31,54852,6467,23,253,162500.0,48750.0,-45.0,-53.0,-43.0,-39.0,-46.0,-53.0,-43.0,-40.0,-85.0,-85.0,-81.0,-80.0,40.0,32.0,38.0,41.0,1
5611,92:69:1D:31:68:E9,3841078,487580643,3938,3627692,3837140,483952951,0,4871,1112202,4725,1079127,146,33075,2133,11,4149,90,0,45,216660.0,130000.0,-51.0,-47.0,-42.0,-49.0,-51.0,-47.0,-43.0,-49.0,-85.0,-85.0,-81.0,-80.0,34.0,38.0,39.0,31.0,1
5612,CC:2F:71:3F:1F:24,4673735,1389661169,836595,905708218,3837140,483952951,37,679280,715847557,678548,715759513,732,88044,654851,15,836852,89415,34,531,130000.0,43333.0,-67.0,-66.0,-66.0,-70.0,-67.0,-66.0,-66.0,-69.0,-85.0,-85.0,-81.0,-80.0,18.0,19.0,15.0,10.0,1
5613,CC:2F:71:3E:C5:1F,3838032,484062035,892,109084,3837140,483952951,0,3712,311986,3063,234960,649,77026,945,9,1279,20,0,44,144444.0,39000.0,-79.0,-81.0,-73.0,-70.0,-72.0,-72.0,-68.0,-61.0,-85.0,-85.0,-81.0,-80.0,6.0,4.0,8.0,10.0,1
5614,BA:8C:B9:54:50:24,3841985,490136760,4845,6183809,3837140,483952951,0,9064,1704155,9042,1700660,22,3495,2348,15,5292,39,0,59,216660.0,130000.0,-39.0,-36.0,-45.0,-51.0,-40.0,-35.0,-45.0,-50.0,-85.0,-85.0,-81.0,-80.0,46.0,49.0,36.0,29.0,1
5615,62:47:05:9D:EB:15,3837203,483964764,58,11349,3837145,483953415,0,152,15809,141,13643,11,2166,41,0,84,0,0,6,229410.0,130000.0,-52.0,-45.0,-54.0,-60.0,-52.0,-45.0,-53.0,-60.0,-85.0,-85.0,-81.0,-80.0,33.0,40.0,27.0,20.0,1
5616,3C:55:76:E8:8F:1F,3891931,620686457,54786,136733042,3837145,483953415,23,25248,5698852,24913,5639968,335,58884,11061,31,54852,6467,23,253,162500.0,48750.0,-46.0,-55.0,-44.0,-40.0,-45.0,-54.0,-43.0,-39.0,-85.0,-85.0,-81.0,-80.0,39.0,30.0,37.0,40.0,1
5617,92:69:1D:31:68:E9,3841083,487581107,3938,3627692,3837145,483953415,0,4871,1112202,4725,1079127,146,33075,2133,11,4149,90,0,45,216660.0,130000.0,-51.0,-47.0,-42.0,-49.0,-51.0,-47.0,-43.0,-49.0,-85.0,-85.0,-81.0,-80.0,34.0,38.0,39.0,31.0,1
5618,CC:2F:71:3F:1F:24,4673961,1389940587,836816,905987172,3837145,483953415,37,679483,716119811,678751,716031767,732,88044,655045,15,837073,89415,34,531,130000.0,43333.0,-67.0,-67.0,-67.0,-69.0,-67.0,-67.0,-66.0,-69.0,-85.0,-85.0,-81.0,-80.0,18.0,18.0,14.0,11.0,1
5619,CC:2F:71:3E:C5:1F,3838037,484062499,892,109084,3837145,483953415,0,3712,311986,3063,234960,649,77026,945,9,1279,20,0,44,144444.0,39000.0,-79.0,-81.0,-73.0,-70.0,-72.0,-72.0,-68.0,-61.0,-85.0,-85.0,-81.0,-80.0,6.0,4.0,8.0,10.0,1
5620,BA:8C:B9:54:50:24,3841992,490137426,4845,6183809,3837147,483953617,0,9064,1704155,9042,1700660,22,3495,2348,15,5292,39,0,59,216660.0,130000.0,-39.0,-36.0,-45.0,-51.0,-40.0,-35.0,-45.0,-50.0,-85.0,-85.0,-81.0,-80.0,46.0,49.0,36.0,29.0,1
5621,62:47:05:9D:EB:15,3837207,483965168,58,11349,3837149,483953819,0,152,15809,141,13643,11,2166,41,0,84,0,0,6,229410.0,130000.0,-52.0,-45.0,-54.0,-60.0,-52.0,-45.0,-53.0,-60.0,-85.0,-85.0,-81.0,-80.0,33.0,40.0,27.0,20.0,1
5622,3C:55:76:E8:8F:1F,3891936,620686977,54787,136733158,3837149,483953819,23,25257,5699468,24922,5640584,335,58884,11061,31,54853,6467,23,254,162500.0,48750.0,-45.0,-48.0,-41.0,-38.0,-46.0,-47.0,-41.0,-38.0,-85.0,-85.0,-81.0,-80.0,40.0,37.0,40.0,42.0,1
5623,92:69:1D:31:68:E9,3841088,487581571,3939,3627752,3837149,483953819,0,4873,1112338,4727,1079263,146,33075,2133,11,4150,90,0,45,216660.0,130000.0,-51.0,-46.0,-42.0,-50.0,-51.0,-47.0,-43.0,-49.0,-85.0,-85.0,-81.0,-80.0,34.0,39.0,39.0,30.0,1
5624,CC:2F:71:3F:1F:24,4674194,1390231747,837045,906277928,3837149,483953819,37,679702,716410965,678970,716322921,732,88044,655249,15,837302,89450,34,531,117000.0,39000.0,-68.0,-67.0,-67.0,-69.0,-67.0,-67.0,-67.0,-68.0,-85.0,-85.0,-81.0,-80.0,17.0,18.0,14.0,11.0,1
5625,CC:2F:71:3E:C5:1F,3838042,484063019,893,109200,3837149,483953819,0,3714,312126,3065,235100,649,77026,945,9,1280,20,0,44,144444.0,39000.0,-66.0,-66.0,-65.0,-61.0,-71.0,-71.0,-68.0,-61.0,-85.0,-85.0,-81.0,-80.0,19.0,19.0,16.0,19.0,1
5626,BA:8C:B9:54:50:24,3841999,490138148,4846,6183925,3837153,483954223,0,9066,1704291,9044,1700796,22,3495,2348,15,5293,39,0,59,229410.0,130000.0,-48.0,-35.0,-42.0,-45.0,-41.0,-35.0,-44.0,-49.0,-85.0,-85.0,-81.0,-80.0,37.0,50.0,39.0,35.0,1
5627,62:47:05:9D:EB:15,3837218,483966425,59,11465,3837159,483954960,0,154,15945,143,13779,11,2166,41,0,85,1,0,6,229410.0,130000.0,-46.0,-55.0,-52.0,-57.0,-50.0,-47.0,-52.0,-59.0,-85.0,-85.0,-81.0,-80.0,39.0,30.0,29.0,23.0,1
5628,3C:55:76:E8:8F:1F,3891947,620688180,54787,136733158,3837160,483955022,23,25257,5699468,24922,5640584,335,58884,11061,31,54853,6467,23,254,162500.0,48750.0,-45.0,-48.0,-41.0,-38.0,-46.0,-47.0,-41.0,-38.0,-85.0,-85.0,-81.0,-80.0,40.0,37.0,40.0,42.0,1
5629,92:69:1D:31:68:E9,3841099,487582774,3939,3627752,3837160,483955022,0,4873,1112338,4727,1079263,146,33075,2133,11,4150,90,0,45,216660.0,130000.0,-51.0,-46.0,-42.0,-50.0,-51.0,-47.0,-43.0,-49.0,-85.0,-85.0,-81.0,-80.0,34.0,39.0,39.0,30.0,1
5630,CC:2F:71:3F:1F:24,4674501,1390623407,837341,906668385,3837160,483955022,37,679984,716793950,679252,716705906,732,88044,655520,15,837598,89495,34,532,130000.0,43333.0,-68.0,-67.0,-67.0,-69.0,-68.0,-67.0,-67.0,-69.0,-85.0,-85.0,-81.0,-80.0,17.0,18.0,14.0,11.0,1
5631,CC:2F:71:3E:C5:1F,3838053,484064222,893,109200,3837160,483955022,0,3716,312314,3066,235170,650,77144,946,9,1280,20,0,44,144444.0,39000.0,-71.0,-71.0,-68.0,-61.0,-71.0,-71.0,-68.0,-61.0,-85.0,-85.0,-81.0,-80.0,14.0,14.0,13.0,19.0,1
5632,BA:8C:B9:54:50:24,3842006,490138947,4846,6183925,3837160,483955022,0,9066,1704291,9044,1700796,22,3495,2348,15,5293,39,0,59,229410.0,130000.0,-48.0,-35.0,-42.0,-45.0,-41.0,-35.0,-44.0,-49.0,-85.0,-85.0,-81.0,-80.0,37.0,50.0,39.0,35.0,1
5633,62:47:05:9D:EB:15,3837223,483966891,59,11465,3837164,483955426,0,154,15945,143,13779,11,2166,41,0,85,1,0,6,229410.0,130000.0,-46.0,-55.0,-52.0,-57.0,-50.0,-47.0,-52.0,-59.0,-85.0,-85.0,-81.0,-80.0,39.0,30.0,29.0,23.0,1
5634,3C:55:76:E8:8F:1F,3891951,620688584,54787,136733158,3837164,483955426,23,25257,5699468,24922,5640584,335,58884,11061,31,54853,6467,23,254,162500.0,48750.0,-45.0,-48.0,-41.0,-38.0,-46.0,-47.0,-41.0,-38.0,-85.0,-85.0,-81.0,-80.0,40.0,37.0,40.0,42.0,1
5635,92:69:1D:31:68:E9,3841105,487583380,3939,3627752,3837166,483955628,0,4873,1112338,4727,1079263,146,33075,2133,11,4150,90,0,45,216660.0,130000.0,-51.0,-46.0,-42.0,-50.0,-51.0,-47.0,-43.0,-49.0,-85.0,-85.0,-81.0,-80.0,34.0,39.0,39.0,30.0,1
5636,CC:2F:71:3F:1F:24,4674741,1390924033,837575,906968405,3837166,483955628,37,680212,717103408,679480,717015364,732,88044,655729,15,837832,89518,34,532,130000.0,43333.0,-70.0,-68.0,-69.0,-69.0,-69.0,-67.0,-68.0,-68.0,-85.0,-85.0,-81.0,-80.0,15.0,17.0,12.0,11.0,1
5637,CC:2F:71:3E:C5:1F,3838061,484065030,893,109200,3837168,483955830,0,3716,312314,3066,235170,650,77144,946,9,1280,20,0,44,144444.0,39000.0,-71.0,-71.0,-68.0,-61.0,-71.0,-71.0,-68.0,-61.0,-85.0,-85.0,-81.0,-80.0,14.0,14.0,13.0,19.0,1
5638,BA:8C:B9:54:50:24,3842014,490139755,4846,6183925,3837168,483955830,0,9066,1704291,9044,1700796,22,3495,2348,15,5293,39,0,59,229410.0,130000.0,-48.0,-35.0,-42.0,-45.0,-41.0,-35.0,-44.0,-49.0,-85.0,-85.0,-81.0,-80.0,37.0,50.0,39.0,35.0,1
5639,62:47:05:9D:EB:15,3837228,483967355,59,11465,3837169,483955890,0,154,15945,143,13779,11,2166,41,0,85,1,0,6,229410.0,130000.0,-46.0,-55.0,-52.0,-57.0,-50.0,-47.0,-52.0,-59.0,-85.0,-85.0,-81.0,-80.0,39.0,30.0,29.0,23.0,1
5640,3C:55:76:E8:8F:1F,3891956,620689048,54787,136733158,3837169,483955890,23,25257,5699468,24922,5640584,335,58884,11061,31,54853,6467,23,254,162500.0,48750.0,-45.0,-48.0,-41.0,-38.0,-46.0,-47.0,-41.0,-38.0,-85.0,-85.0,-81.0,-80.0,40.0,37.0,40.0,42.0,1
5641,92:69:1D:31:68:E9,3841109,487583704,3939,3627752,3837170,483955952,0,4873,1112338,4727,1079263,146,33075,2133,11,4150,90,0,45,216660.0,130000.0,-51.0,-46.0,-42.0,-50.0,-51.0,-47.0,-43.0,-49.0,-85.0,-85.0,-81.0,-80.0,34.0,39.0,39.0,30.0,1
5642,CC:2F:71:3F:1F:24,4674952,1391185827,837782,907229875,3837170,483955952,37,680408,717361804,679676,717273760,732,88044,655915,15,838039,89529,34,532,130000.0,43333.0,-69.0,-68.0,-68.0,-70.0,-69.0,-67.0,-67.0,-69.0,-85.0,-85.0,-81.0,-80.0,16.0,17.0,13.0,10.0,1
5643,CC:2F:71:3E:C5:1F,3838065,484065520,893,109200,3837172,483956320,0,3716,312314,3066,235170,650,77144,946,9,1280,20,0,44,144444.0,39000.0,-71.0,-71.0,-68.0,-61.0,-71.0,-71.0,-68.0,-61.0,-85.0,-85.0,-81.0,-80.0,14.0,14.0,13.0,19.0,1
5644,BA:8C:B9:54:50:24,3842020,490140447,4846,6183925,3837174,483956522,0,9066,1704291,9044,1700796,22,3495,2348,15,5293,39,0,59,229410.0,130000.0,-48.0,-35.0,-42.0,-45.0,-41.0,-35.0,-44.0,-49.0,-85.0,-85.0,-81.0,-80.0,37.0,50.0,39.0,35.0,1
5645,62:47:05:9D:EB:15,3837239,483968593,59,11465,3837180,483957128,0,154,15945,143,13779,11,2166,41,0,85,1,0,6,229410.0,130000.0,-46.0,-55.0,-52.0,-57.0,-50.0,-47.0,-52.0,-59.0,-84.0,-84.0,-81.0,-80.0,38.0,29.0,29.0,23.0,1
5646,3C:55:76:E8:8F:1F,3891967,620690286,54787,136733158,3837180,483957128,23,25266,5700134,24930,5641132,336,59002,11062,31,54853,6467,23,256,162500.0,48750.0,-43.0,-51.0,-46.0,-39.0,-43.0,-49.0,-46.0,-38.0,-84.0,-84.0,-81.0,-80.0,41.0,33.0,35.0,41.0,1
5647,92:69:1D:31:68:E9,3841119,487584880,3939,3627752,3837180,483957128,0,4873,1112338,4727,1079263,146,33075,2133,11,4150,90,0,45,216660.0,130000.0,-51.0,-46.0,-42.0,-50.0,-51.0,-47.0,-43.0,-49.0,-84.0,-84.0,-81.0,-80.0,33.0,38.0,39.0,30.0,1
5648,CC:2F:71:3F:1F:24,4675185,1391458648,838005,907501520,3837180,483957128,37,680621,717632761,679889,717544717,732,88044,656114,15,838262,89538,34,533,130000.0,43333.0,-67.0,-66.0,-66.0,-72.0,-67.0,-66.0,-66.0,-70.0,-84.0,-84.0,-81.0,-80.0,17.0,18.0,15.0,8.0,1
5649,CC:2F:71:3E:C5:1F,3838074,484066390,893,109200,3837181,483957190,0,3716,312314,3066,235170,650,77144,946,9,1280,20,0,44,144444.0,39000.0,-71.0,-71.0,-68.0,-61.0,-71.0,-71.0,-68.0,-61.0,-84.0,-84.0,-81.0,-80.0,13.0,13.0,13.0,19.0,1
5650,BA:8C:B9:54:50:24,3842027,490141115,4846,6183925,3837181,483957190,0,9066,1704291,9044,1700796,22,3495,2348,15,5293,39,0,59,229410.0,130000.0,-48.0,-35.0,-42.0,-45.0,-41.0,-35.0,-44.0,-49.0,-84.0,-84.0,-81.0,-80.0,36.0,49.0,39.0,35.0,1
5651,62:47:05:9D:EB:15,3837241,483968715,59,11465,3837182,483957250,0,154,15945,143,13779,11,2166,41,0,85,1,0,6,229410.0,130000.0,-46.0,-55.0,-52.0,-57.0,-50.0,-47.0,-52.0,-59.0,-84.0,-84.0,-81.0,-80.0,38.0,29.0,29.0,23.0,1
5652,3C:55:76:E8:8F:1F,3891981,620697187,54799,136739937,3837182,483957250,23,25296,5707759,24959,5648639,337,59120,11078,31,54865,6467,23,259,162500.0,48750.0,-52.0,-56.0,-46.0,-45.0,-49.0,-55.0,-45.0,-42.0,-84.0,-84.0,-81.0,-80.0,32.0,28.0,35.0,35.0,1
5653,92:69:1D:31:68:E9,3841123,487585204,3939,3627752,3837184,483957452,0,4873,1112338,4727,1079263,146,33075,2133,11,4150,90,0,45,216660.0,130000.0,-51.0,-46.0,-42.0,-50.0,-51.0,-47.0,-43.0,-49.0,-84.0,-84.0,-81.0,-80.0,33.0,38.0,39.0,30.0,1
5654,CC:2F:71:3F:1F:24,4675400,1391726450,838216,907768998,3837184,483957452,37,680813,717889089,680081,717801045,732,88044,656302,15,838473,89556,34,533,130000.0,43333.0,-68.0,-66.0,-66.0,-71.0,-68.0,-66.0,-66.0,-70.0,-84.0,-84.0,-81.0,-80.0,16.0,18.0,15.0,9.0,1
5655,CC:2F:71:3E:C5:1F,3838077,484066652,893,109200,3837184,483957452,0,3716,312314,3066,235170,650,77144,946,9,1280,20,0,44,144444.0,39000.0,-71.0,-71.0,-68.0,-61.0,-71.0,-71.0,-68.0,-61.0,-84.0,-84.0,-81.0,-80.0,13.0,13.0,13.0,19.0,1
5656,BA:8C:B9:54:50:24,3842032,490141579,4846,6183925,3837186,483957654,0,9066,1704291,9044,1700796,22,3495,2348,15,5293,39,0,59,229410.0,130000.0,-48.0,-35.0,-42.0,-45.0,-41.0,-35.0,-44.0,-49.0,-84.0,-84.0,-81.0,-80.0,36.0,49.0,39.0,35.0,1
5657,62:47:05:9D:EB:15,3837249,483969523,59,11465,3837190,483958058,0,154,15945,143,13779,11,2166,41,0,85,1,0,6,229410.0,130000.0,-46.0,-55.0,-52.0,-57.0,-50.0,-47.0,-52.0,-59.0,-84.0,-84.0,-81.0,-80.0,38.0,29.0,29.0,23.0,1
5658,3C:55:76:E8:8F:1F,3891992,620698443,54801,136740323,3837191,483958120,23,25314,5709199,24977,5650079,337,59120,11081,31,54867,6467,23,262,162500.0,48750.0,-46.0,-59.0,-46.0,-41.0,-47.0,-59.0,-46.0,-42.0,-84.0,-84.0,-81.0,-80.0,38.0,25.0,35.0,39.0,1
5659,92:69:1D:31:68:E9,3841130,487585872,3939,3627752,3837191,483958120,0,4873,1112338,4727,1079263,146,33075,2133,11,4150,90,0,45,216660.0,130000.0,-51.0,-46.0,-42.0,-50.0,-51.0,-47.0,-43.0,-49.0,-84.0,-84.0,-81.0,-80.0,33.0,38.0,39.0,30.0,1
5660,CC:2F:71:3F:1F:24,4675617,1391991602,838426,908033482,3837191,483958120,37,681011,718149379,680278,718061217,733,88162,656488,15,838683,89567,34,533,130000.0,43333.0,-68.0,-66.0,-67.0,-69.0,-68.0,-66.0,-67.0,-69.0,-84.0,-84.0,-81.0,-80.0,16.0,18.0,14.0,11.0,1
5661,CC:2F:71:3E:C5:1F,3838084,484067320,893,109200,3837191,483958120,0,3716,312314,3066,235170,650,77144,946,9,1280,20,0,44,144444.0,39000.0,-71.0,-71.0,-68.0,-61.0,-71.0,-71.0,-68.0,-61.0,-84.0,-84.0,-81.0,-80.0,13.0,13.0,13.0,19.0,1
5662,BA:8C:B9:54:50:24,3842037,490142045,4846,6183925,3837191,483958120,0,9066,1704291,9044,1700796,22,3495,2348,15,5293,39,0,59,229410.0,130000.0,-48.0,-35.0,-42.0,-45.0,-41.0,-35.0,-44.0,-49.0,-84.0,-84.0,-81.0,-80.0,36.0,49.0,39.0,35.0,1
5663,62:47:05:9D:EB:15,3837252,483969787,59,11465,3837193,483958322,0,154,15945,143,13779,11,2166,41,0,85,1,0,6,229410.0,130000.0,-46.0,-55.0,-52.0,-57.0,-50.0,-47.0,-52.0,-59.0,-84.0,-84.0,-81.0,-80.0,38.0,29.0,29.0,23.0,1
5664,3C:55:76:E8:8F:1F,3891997,620699013,54802,136740489,3837195,483958524,23,25326,5710150,24989,5651030,337,59120,11083,31,54868,6467,23,263,172050.0,48750.0,-47.0,-58.0,-44.0,-41.0,-46.0,-58.0,-44.0,-41.0,-84.0,-84.0,-81.0,-80.0,37.0,26.0,37.0,39.0,1
5665,92:69:1D:31:68:E9,3841136,487586725,3939,3627752,3837197,483958973,0,4874,1112406,4728,1079331,146,33075,2133,11,4151,90,0,46,216660.0,130000.0,-50.0,-46.0,-44.0,-47.0,-51.0,-47.0,-43.0,-48.0,-84.0,-84.0,-81.0,-80.0,34.0,38.0,37.0,33.0,1
5666,CC:2F:71:3F:1F:24,4675840,1392266323,838642,908307290,3837198,483959033,37,681214,718418571,680481,718330409,733,88162,656683,15,838897,89574,34,533,130000.0,43333.0,-68.0,-67.0,-67.0,-70.0,-67.0,-67.0,-67.0,-69.0,-84.0,-84.0,-81.0,-80.0,16.0,17.0,14.0,10.0,1
5667,CC:2F:71:3E:C5:1F,3838093,484068435,893,109200,3837200,483959235,0,3718,312454,3068,235310,650,77144,946,10,1281,22,0,44,144444.0,39000.0,-80.0,-80.0,-73.0,-70.0,-72.0,-72.0,-68.0,-63.0,-84.0,-84.0,-81.0,-80.0,4.0,4.0,8.0,10.0,1
5668,BA:8C:B9:54:50:24,3842046,490143160,4846,6183925,3837200,483959235,0,9068,1704427,9046,1700932,22,3495,2348,15,5294,39,0,60,229410.0,130000.0,-40.0,-37.0,-46.0,-52.0,-40.0,-36.0,-44.0,-50.0,-84.0,-84.0,-81.0,-80.0,44.0,47.0,35.0,28.0,1
5669,62:47:05:9D:EB:15,3837261,483970902,59,11465,3837202,483959437,0,154,15945,143,13779,11,2166,41,0,85,1,0,6,229410.0,130000.0,-46.0,-55.0,-52.0,-57.0,-50.0,-47.0,-52.0,-59.0,-84.0,-84.0,-81.0,-80.0,38.0,29.0,29.0,23.0,1
5670,3C:55:76:E8:8F:1F,3892006,620700171,54804,136740734,3837202,483959437,23,25347,5712107,25008,5652426,339,59681,11086,31,54870,6467,23,263,172050.0,1000.0,-46.0,-55.0,-44.0,-40.0,-45.0,-54.0,-43.0,-40.0,-84.0,-84.0,-81.0,-80.0,38.0,29.0,37.0,40.0,1
5671,92:69:1D:31:68:E9,3841141,487587189,3939,3627752,3837202,483959437,0,4875,1112474,4729,1079399,146,33075,2133,11,4151,90,0,46,216660.0,130000.0,-50.0,-47.0,-42.0,-48.0,-51.0,-47.0,-43.0,-48.0,-84.0,-84.0,-81.0,-80.0,34.0,37.0,39.0,32.0,1
5672,CC:2F:71:3F:1F:24,4676072,1392544830,838870,908585393,3837202,483959437,37,681427,718687980,680694,718599818,733,88162,656886,15,839127,89585,34,533,117000.0,39000.0,-70.0,-67.0,-69.0,-69.0,-69.0,-66.0,-68.0,-70.0,-84.0,-84.0,-81.0,-80.0,14.0,17.0,12.0,11.0,1
5673,CC:2F:71:3E:C5:1F,3838097,484069086,893,109200,3837204,483959886,0,3718,312454,3068,235310,650,77144,946,10,1281,22,0,44,144444.0,39000.0,-80.0,-80.0,-73.0,-70.0,-72.0,-72.0,-68.0,-63.0,-84.0,-84.0,-81.0,-80.0,4.0,4.0,8.0,10.0,1
5674,BA:8C:B9:54:50:24,3842050,490143811,4846,6183925,3837204,483959886,0,9068,1704427,9046,1700932,22,3495,2348,15,5294,39,0,60,229410.0,130000.0,-40.0,-37.0,-46.0,-52.0,-40.0,-36.0,-44.0,-50.0,-84.0,-84.0,-81.0,-80.0,44.0,47.0,35.0,28.0,1
5675,62:47:05:9D:EB:15,3837270,483972019,59,11465,3837211,483960554,0,157,16149,146,13983,11,2166,41,0,86,1,0,6,229410.0,130000.0,-46.0,-48.0,-53.0,-50.0,-49.0,-50.0,-52.0,-56.0,-84.0,-84.0,-81.0,-80.0,38.0,36.0,28.0,30.0,1
5676,3C:55:76:E8:8F:1F,3892022,620702978,54811,136742424,3837211,483960554,23,25373,5718072,25033,5658273,340,59799,11098,31,54877,6467,23,263,172050.0,48750.0,-49.0,-54.0,-48.0,-46.0,-48.0,-53.0,-46.0,-44.0,-84.0,-84.0,-81.0,-80.0,35.0,30.0,33.0,34.0,1
5677,92:69:1D:31:68:E9,3841152,487588508,3939,3627752,3837213,483960756,0,4875,1112474,4729,1079399,146,33075,2133,11,4151,90,0,46,216660.0,130000.0,-50.0,-47.0,-42.0,-48.0,-51.0,-47.0,-43.0,-48.0,-84.0,-84.0,-81.0,-80.0,34.0,37.0,39.0,32.0,1
5678,CC:2F:71:3F:1F:24,4676292,1392809207,839079,908848451,3837213,483960756,37,681616,718938406,680883,718850244,733,88162,657070,15,839336,89590,34,533,130000.0,43333.0,-68.0,-66.0,-68.0,-71.0,-67.0,-66.0,-68.0,-71.0,-84.0,-84.0,-81.0,-80.0,16.0,18.0,13.0,9.0,1
5679,CC:2F:71:3E:C5:1F,3838106,484069956,893,109200,3837213,483960756,0,3718,312454,3068,235310,650,77144,946,10,1281,22,0,44,144444.0,39000.0,-80.0,-80.0,-73.0,-70.0,-72.0,-72.0,-68.0,-63.0,-84.0,-84.0,-80.0,-80.0,4.0,4.0,7.0,10.0,1
5680,BA:8C:B9:54:50:24,3842059,490144681,4846,6183925,3837213,483960756,0,9068,1704427,9046,1700932,22,3495,2348,15,5294,39,0,60,229410.0,130000.0,-40.0,-37.0,-46.0,-52.0,-40.0,-36.0,-44.0,-50.0,-84.0,-84.0,-80.0,-80.0,44.0,47.0,34.0,28.0,1
5681,62:47:05:9D:EB:15,3837275,483972730,59,11465,3837216,483961265,0,157,16149,146,13983,11,2166,41,0,86,1,0,6,229410.0,130000.0,-46.0,-48.0,-53.0,-50.0,-49.0,-50.0,-52.0,-56.0,-84.0,-84.0,-80.0,-80.0,38.0,36.0,27.0,30.0,1
5682,3C:55:76:E8:8F:1F,3892027,620703689,54811,136742424,3837216,483961265,23,25387,5719471,25047,5659672,340,59799,11099,31,54877,6467,23,265,172050.0,48750.0,-45.0,-52.0,-48.0,-41.0,-43.0,-50.0,-48.0,-39.0,-84.0,-84.0,-80.0,-80.0,39.0,32.0,32.0,39.0,1
5683,92:69:1D:31:68:E9,3841155,487589017,3939,3627752,3837216,483961265,0,4875,1112474,4729,1079399,146,33075,2133,11,4151,90,0,46,216660.0,130000.0,-50.0,-47.0,-42.0,-48.0,-51.0,-47.0,-43.0,-48.0,-84.0,-84.0,-80.0,-80.0,34.0,37.0,38.0,32.0,1
5684,CC:2F:71:3F:1F:24,4676503,1393069878,839287,909108613,3837216,483961265,37,681809,719194986,681076,719106824,733,88162,657254,15,839544,89592,34,534,130000.0,43333.0,-67.0,-65.0,-66.0,-70.0,-66.0,-65.0,-66.0,-70.0,-84.0,-84.0,-80.0,-80.0,17.0,19.0,14.0,10.0,1
5685,CC:2F:71:3E:C5:1F,3838111,484070667,893,109200,3837218,483961467,0,3718,312454,3068,235310,650,77144,946,10,1281,22,0,44,144444.0,39000.0,-80.0,-80.0,-73.0,-70.0,-72.0,-72.0,-68.0,-63.0,-84.0,-84.0,-80.0,-80.0,4.0,4.0,7.0,10.0,1
5686,BA:8C:B9:54:50:24,3842064,490145392,4846,6183925,3837218,483961467,0,9068,1704427,9046,1700932,22,3495,2348,15,5294,39,0,60,229410.0,130000.0,-40.0,-37.0,-46.0,-52.0,-40.0,-36.0,-44.0,-50.0,-84.0,-84.0,-80.0,-80.0,44.0,47.0,34.0,28.0,1
5687,62:47:05:9D:EB:15,3837285,483973987,59,11465,3837226,483962522,0,157,16149,146,13983,11,2166,41,0,86,1,0,6,229410.0,130000.0,-46.0,-48.0,-53.0,-50.0,-49.0,-50.0,-52.0,-56.0,-84.0,-84.0,-80.0,-80.0,38.0,36.0,27.0,30.0,1
5688,3C:55:76:E8:8F:1F,3892038,620705062,54812,136742540,3837226,483962522,23,25397,5720616,25055,5660256,342,60360,11102,31,54878,6467,23,267,162500.0,1000.0,-50.0,-51.0,-44.0,-43.0,-49.0,-52.0,-45.0,-42.0,-84.0,-84.0,-80.0,-80.0,34.0,33.0,36.0,37.0,1
5689,92:69:1D:31:68:E9,3841165,487590274,3939,3627752,3837226,483962522,0,4875,1112474,4729,1079399,146,33075,2133,11,4151,90,0,46,216660.0,130000.0,-50.0,-47.0,-42.0,-48.0,-51.0,-47.0,-43.0,-48.0,-84.0,-84.0,-80.0,-80.0,34.0,37.0,38.0,32.0,1
5690,CC:2F:71:3F:1F:24,4676725,1393333944,839499,909371422,3837226,483962522,37,682000,719443131,681267,719354969,733,88162,657442,15,839756,89604,34,534,130000.0,43333.0,-67.0,-66.0,-67.0,-69.0,-67.0,-66.0,-66.0,-69.0,-84.0,-84.0,-80.0,-80.0,17.0,18.0,13.0,11.0,1
5691,CC:2F:71:3E:C5:1F,3838119,484071722,893,109200,3837226,483962522,0,3718,312454,3068,235310,650,77144,946,10,1281,22,0,44,144444.0,39000.0,-80.0,-80.0,-73.0,-70.0,-72.0,-72.0,-68.0,-63.0,-84.0,-84.0,-80.0,-80.0,4.0,4.0,7.0,10.0,1
5692,BA:8C:B9:54:50:24,3842072,490146447,4846,6183925,3837226,483962522,0,9068,1704427,9046,1700932,22,3495,2348,15,5294,39,0,60,229410.0,130000.0,-40.0,-37.0,-46.0,-52.0,-40.0,-36.0,-44.0,-50.0,-84.0,-84.0,-80.0,-80.0,44.0,47.0,34.0,28.0,1
5693,62:47:05:9D:EB:15,3837291,483974724,59,11465,3837232,483963259,0,157,16149,146,13983,11,2166,41,0,86,1,0,6,229410.0,130000.0,-46.0,-48.0,-53.0,-50.0,-49.0,-50.0,-52.0,-56.0,-84.0,-84.0,-80.0,-80.0,38.0,36.0,27.0,30.0,1
5694,3C:55:76:E8:8F:1F,3892743,622547958,55509,138584497,3837234,483963461,24,25563,5744734,25221,5684374,342,60360,11180,31,55521,6510,24,267,121870.0,73120.0,-44.0,-52.0,-49.0,-41.0,-49.0,-53.0,-47.0,-44.0,-84.0,-84.0,-80.0,-80.0,40.0,32.0,31.0,39.0,1
5695,92:69:1D:31:68:E9,3841175,487591415,3939,3627752,3837236,483963663,0,4875,1112474,4729,1079399,146,33075,2133,11,4151,90,0,46,216660.0,130000.0,-50.0,-47.0,-42.0,-48.0,-51.0,-47.0,-43.0,-48.0,-84.0,-84.0,-80.0,-80.0,34.0,37.0,38.0,32.0,1
5696,CC:2F:71:3F:1F:24,4677058,1393772563,839822,909808900,3837236,483963663,37,682319,719890063,681586,719801901,733,88162,657739,15,840079,89614,34,534,117000.0,39000.0,-67.0,-66.0,-67.0,-71.0,-66.0,-66.0,-66.0,-69.0,-84.0,-84.0,-80.0,-80.0,17.0,18.0,13.0,9.0,1
5697,CC:2F:71:3E:C5:1F,3838129,484072863,893,109200,3837236,483963663,0,3718,312454,3068,235310,650,77144,946,10,1281,22,0,44,144444.0,39000.0,-80.0,-80.0,-73.0,-70.0,-72.0,-72.0,-68.0,-63.0,-84.0,-84.0,-80.0,-80.0,4.0,4.0,7.0,10.0,1
5698,BA:8C:B9:54:50:24,3842082,490147588,4846,6183925,3837236,483963663,0,9069,1704495,9047,1701000,22,3495,2348,15,5294,39,0,60,229410.0,130000.0,-48.0,-35.0,-43.0,-46.0,-41.0,-36.0,-44.0,-50.0,-84.0,-84.0,-80.0,-80.0,36.0,49.0,37.0,34.0,1
5699,62:47:05:9D:EB:15,3837297,483975330,59,11465,3837238,483963865,0,157,16149,146,13983,11,2166,41,0,86,1,0,6,229410.0,130000.0,-46.0,-48.0,-53.0,-50.0,-49.0,-50.0,-52.0,-56.0,-84.0,-84.0,-80.0,-80.0,38.0,36.0,27.0,30.0,1
5700,3C:55:76:E8:8F:1F,3893947,625715216,56709,141751351,3837238,483963865,24,25894,5790787,25552,5730427,342,60360,11360,31,56776,6514,24,276,73120.0,24370.0,-51.0,-60.0,-56.0,-44.0,-47.0,-53.0,-48.0,-43.0,-84.0,-84.0,-80.0,-80.0,33.0,24.0,24.0,36.0,1
5701,92:69:1D:31:68:E9,3841177,487591617,3939,3627752,3837238,483963865,0,4875,1112474,4729,1079399,146,33075,2133,11,4151,90,0,46,216660.0,130000.0,-50.0,-47.0,-42.0,-48.0,-51.0,-47.0,-43.0,-48.0,-84.0,-84.0,-80.0,-80.0,34.0,37.0,38.0,32.0,1
5702,CC:2F:71:3F:1F:24,4677287,1394064979,840049,910101114,3837238,483963865,37,682547,720192265,681814,720104103,733,88162,657948,15,840305,89618,34,534,130000.0,43333.0,-68.0,-65.0,-67.0,-70.0,-67.0,-65.0,-67.0,-69.0,-84.0,-84.0,-80.0,-80.0,16.0,19.0,13.0,10.0,1
5703,CC:2F:71:3E:C5:1F,3838133,484073267,893,109200,3837240,483964067,0,3718,312454,3068,235310,650,77144,946,10,1281,22,0,44,144444.0,39000.0,-80.0,-80.0,-73.0,-70.0,-72.0,-72.0,-68.0,-63.0,-84.0,-84.0,-80.0,-80.0,4.0,4.0,7.0,10.0,1
5704,BA:8C:B9:54:50:24,3842087,490148052,4846,6183925,3837241,483964127,0,9069,1704495,9047,1701000,22,3495,2348,15,5294,39,0,60,229410.0,130000.0,-48.0,-35.0,-43.0,-46.0,-41.0,-36.0,-44.0,-50.0,-84.0,-84.0,-80.0,-80.0,36.0,49.0,37.0,34.0,1
5705,62:47:05:9D:EB:15,3837304,483975996,59,11465,3837245,483964531,0,157,16149,146,13983,11,2166,41,0,86,1,0,6,229410.0,130000.0,-46.0,-48.0,-53.0,-50.0,-49.0,-50.0,-52.0,-56.0,-84.0,-84.0,-80.0,-80.0,38.0,36.0,27.0,30.0,1
5706,3C:55:76:E8:8F:1F,3893955,625715975,56710,141751444,3837245,483964531,24,25902,5791442,25560,5731082,342,60360,11362,31,56777,6514,24,276,65000.0,1000.0,-50.0,-51.0,-43.0,-44.0,-47.0,-50.0,-42.0,-41.0,-84.0,-84.0,-80.0,-80.0,34.0,33.0,37.0,36.0,1
5707,92:69:1D:31:68:E9,3841184,487592283,3939,3627752,3837245,483964531,0,4875,1112474,4729,1079399,146,33075,2133,11,4151,90,0,46,216660.0,130000.0,-50.0,-47.0,-42.0,-48.0,-51.0,-47.0,-43.0,-48.0,-84.0,-84.0,-80.0,-80.0,34.0,37.0,38.0,32.0,1
5708,CC:2F:71:3F:1F:24,4677509,1394330716,840264,910366185,3837245,483964531,37,682747,720447504,682014,720359342,733,88162,658140,15,840521,89620,34,534,130000.0,43333.0,-67.0,-65.0,-68.0,-70.0,-67.0,-65.0,-67.0,-69.0,-84.0,-84.0,-80.0,-80.0,17.0,19.0,12.0,10.0,1
5709,CC:2F:71:3E:C5:1F,3838138,484073731,893,109200,3837245,483964531,0,3718,312454,3068,235310,650,77144,946,10,1281,22,0,44,144444.0,39000.0,-80.0,-80.0,-73.0,-70.0,-72.0,-72.0,-68.0,-63.0,-84.0,-84.0,-80.0,-80.0,4.0,4.0,7.0,10.0,1
5710,BA:8C:B9:54:50:24,3842091,490148456,4846,6183925,3837245,483964531,0,9069,1704495,9047,1701000,22,3495,2348,15,5294,39,0,60,229410.0,130000.0,-48.0,-35.0,-43.0,-46.0,-41.0,-36.0,-44.0,-50.0,-84.0,-84.0,-80.0,-80.0,36.0,49.0,37.0,34.0,1
5711,62:47:05:9D:EB:15,3837308,483976400,59,11465,3837249,483964935,0,157,16149,146,13983,11,2166,41,0,86,1,0,6,229410.0,130000.0,-46.0,-48.0,-53.0,-50.0,-49.0,-50.0,-52.0,-56.0,-84.0,-84.0,-80.0,-80.0,38.0,36.0,27.0,30.0,1
5712,3C:55:76:E8:8F:1F,3893960,625716453,56711,141751518,3837249,483964935,24,25908,5791891,25566,5731531,342,60360,11363,31,56778,6514,24,276,65000.0,16250.0,-44.0,-50.0,-51.0,-40.0,-45.0,-49.0,-48.0,-40.0,-84.0,-84.0,-80.0,-80.0,40.0,34.0,29.0,40.0,1
5713,92:69:1D:31:68:E9,3841188,487592687,3939,3627752,3837249,483964935,0,4875,1112474,4729,1079399,146,33075,2133,11,4151,90,0,46,216660.0,130000.0,-50.0,-47.0,-42.0,-48.0,-51.0,-47.0,-43.0,-48.0,-84.0,-84.0,-80.0,-80.0,34.0,37.0,38.0,32.0,1
5714,CC:2F:71:3F:1F:24,4677722,1394593826,840473,910628891,3837249,483964935,37,682938,720703772,682205,720615610,733,88162,658323,15,840729,89633,34,534,130000.0,43333.0,-68.0,-65.0,-68.0,-67.0,-67.0,-65.0,-68.0,-69.0,-84.0,-84.0,-80.0,-80.0,16.0,19.0,12.0,13.0,1
5715,CC:2F:71:3E:C5:1F,3838142,484074135,893,109200,3837249,483964935,0,3718,312454,3068,235310,650,77144,946,10,1281,22,0,44,144444.0,39000.0,-80.0,-80.0,-73.0,-70.0,-72.0,-72.0,-68.0,-63.0,-84.0,-84.0,-80.0,-80.0,4.0,4.0,7.0,10.0,1
5716,BA:8C:B9:54:50:24,3842099,490149264,4846,6183925,3837253,483965339,0,9069,1704495,9047,1701000,22,3495,2348,15,5294,39,0,60,229410.0,130000.0,-48.0,-35.0,-43.0,-46.0,-41.0,-36.0,-44.0,-50.0,-84.0,-84.0,-80.0,-80.0,36.0,49.0,37.0,34.0,1
5717,62:47:05:9D:EB:15,3837313,483976864,59,11465,3837254,483965399,0,157,16149,146,13983,11,2166,41,0,86,1,0,6,229410.0,130000.0,-46.0,-48.0,-53.0,-50.0,-49.0,-50.0,-52.0,-56.0,-84.0,-84.0,-80.0,-80.0,38.0,36.0,27.0,30.0,1
5718,3C:55:76:E8:8F:1F,3893966,625717035,56712,141751636,3837254,483965399,24,25911,5792223,25569,5731863,342,60360,11365,31,56779,6514,24,276,65000.0,16250.0,-47.0,-51.0,-46.0,-42.0,-43.0,-49.0,-50.0,-39.0,-84.0,-84.0,-80.0,-80.0,37.0,33.0,34.0,38.0,1
5719,92:69:1D:31:68:E9,3841193,487593151,3939,3627752,3837254,483965399,0,4875,1112474,4729,1079399,146,33075,2133,11,4151,90,0,46,216660.0,130000.0,-50.0,-47.0,-42.0,-48.0,-51.0,-47.0,-43.0,-48.0,-84.0,-84.0,-80.0,-80.0,34.0,37.0,38.0,32.0,1
5720,CC:2F:71:3F:1F:24,4677936,1394854612,840682,910889213,3837254,483965399,37,683127,720954166,682394,720866004,733,88162,658507,15,840939,89634,34,534,130000.0,43333.0,-67.0,-66.0,-69.0,-70.0,-67.0,-65.0,-67.0,-70.0,-84.0,-84.0,-80.0,-80.0,17.0,18.0,11.0,10.0,1
5721,CC:2F:71:3E:C5:1F,3838147,484074599,893,109200,3837254,483965399,0,3718,312454,3068,235310,650,77144,946,10,1281,22,0,44,144444.0,39000.0,-80.0,-80.0,-73.0,-70.0,-72.0,-72.0,-68.0,-63.0,-84.0,-84.0,-80.0,-80.0,4.0,4.0,7.0,10.0,1
5722,BA:8C:B9:54:50:24,3842100,490149324,4846,6183925,3837254,483965399,0,9069,1704495,9047,1701000,22,3495,2348,15,5294,39,0,60,229410.0,130000.0,-48.0,-35.0,-43.0,-46.0,-41.0,-36.0,-44.0,-50.0,-84.0,-84.0,-80.0,-80.0,36.0,49.0,37.0,34.0,1
5723,62:47:05:9D:EB:15,3837318,483977328,59,11465,3837259,483965863,0,157,16149,146,13983,11,2166,41,0,86,1,0,6,229410.0,130000.0,-46.0,-48.0,-53.0,-50.0,-49.0,-50.0,-52.0,-56.0,-84.0,-84.0,-80.0,-80.0,38.0,36.0,27.0,30.0,1
5724,3C:55:76:E8:8F:1F,3893981,625721705,56718,141755438,3837263,483966267,24,25938,5798912,25595,5738446,343,60466,11373,31,56785,6514,24,276,65000.0,16250.0,-49.0,-50.0,-43.0,-43.0,-45.0,-50.0,-47.0,-40.0,-84.0,-84.0,-80.0,-80.0,35.0,34.0,37.0,37.0,1
5725,92:69:1D:31:68:E9,3841202,487594019,3939,3627752,3837263,483966267,0,4875,1112474,4729,1079399,146,33075,2133,11,4151,90,0,46,216660.0,130000.0,-50.0,-47.0,-42.0,-48.0,-51.0,-47.0,-43.0,-48.0,-84.0,-84.0,-80.0,-80.0,34.0,37.0,38.0,32.0,1
5726,CC:2F:71:3F:1F:24,4678157,1395121648,840894,911155381,3837263,483966267,37,683317,721206118,682584,721117956,733,88162,658693,15,841151,89641,34,534,130000.0,43333.0,-67.0,-66.0,-68.0,-69.0,-67.0,-65.0,-67.0,-69.0,-84.0,-84.0,-80.0,-80.0,17.0,18.0,12.0,11.0,1
5727,CC:2F:71:3E:C5:1F,3838156,484075467,893,109200,3837263,483966267,0,3718,312454,3068,235310,650,77144,946,10,1281,22,0,44,144444.0,39000.0,-80.0,-80.0,-73.0,-70.0,-72.0,-72.0,-68.0,-63.0,-84.0,-84.0,-80.0,-80.0,4.0,4.0,7.0,10.0,1
5728,BA:8C:B9:54:50:24,3842109,490150192,4846,6183925,3837263,483966267,0,9069,1704495,9047,1701000,22,3495,2348,15,5294,39,0,60,229410.0,130000.0,-48.0,-35.0,-43.0,-46.0,-41.0,-36.0,-44.0,-50.0,-84.0,-84.0,-80.0,-80.0,36.0,49.0,37.0,34.0,1
5729,62:47:05:9D:EB:15,3837324,483977852,59,11465,3837265,483966387,0,157,16149,146,13983,11,2166,41,0,86,1,0,6,229410.0,130000.0,-46.0,-48.0,-53.0,-50.0,-49.0,-50.0,-52.0,-56.0,-84.0,-84.0,-80.0,-80.0,38.0,36.0,27.0,30.0,1
5730,3C:55:76:E8:8F:1F,3893985,625722168,56720,141755781,3837265,483966387,24,25959,5800561,25615,5739989,344,60572,11377,31,56787,6514,24,276,65000.0,16250.0,-50.0,-61.0,-52.0,-44.0,-43.0,-50.0,-53.0,-39.0,-84.0,-84.0,-80.0,-80.0,34.0,23.0,28.0,36.0,1
5731,92:69:1D:31:68:E9,3841204,487594139,3939,3627752,3837265,483966387,0,4875,1112474,4729,1079399,146,33075,2133,11,4151,90,0,46,216660.0,130000.0,-50.0,-47.0,-42.0,-48.0,-51.0,-47.0,-43.0,-48.0,-84.0,-84.0,-80.0,-80.0,34.0,37.0,38.0,32.0,1
5732,CC:2F:71:3F:1F:24,4678372,1395385155,841107,911418768,3837265,483966387,37,683517,721455789,682784,721367627,733,88162,658883,15,841364,89642,34,534,130000.0,43333.0,-67.0,-65.0,-68.0,-70.0,-67.0,-65.0,-67.0,-69.0,-84.0,-84.0,-80.0,-80.0,17.0,19.0,12.0,10.0,1
5733,CC:2F:71:3E:C5:1F,3838160,484075789,893,109200,3837267,483966589,0,3718,312454,3068,235310,650,77144,946,10,1281,22,0,44,144444.0,39000.0,-80.0,-80.0,-73.0,-70.0,-72.0,-72.0,-68.0,-63.0,-84.0,-84.0,-80.0,-80.0,4.0,4.0,7.0,10.0,1
5734,BA:8C:B9:54:50:24,3842113,490150514,4846,6183925,3837267,483966589,0,9069,1704495,9047,1701000,22,3495,2348,15,5294,39,0,60,229410.0,130000.0,-48.0,-35.0,-43.0,-46.0,-41.0,-36.0,-44.0,-50.0,-84.0,-84.0,-80.0,-80.0,36.0,49.0,37.0,34.0,1
5735,62:47:05:9D:EB:15,3837333,483978720,59,11465,3837274,483967255,0,157,16149,146,13983,11,2166,41,0,86,1,0,6,229410.0,130000.0,-46.0,-48.0,-53.0,-50.0,-49.0,-50.0,-52.0,-56.0,-84.0,-84.0,-80.0,-80.0,38.0,36.0,27.0,30.0,1
5736,3C:55:76:E8:8F:1F,3893994,625723036,56720,141755781,3837274,483967255,24,25964,5800941,25619,5740263,345,60678,11378,31,56787,6514,24,276,65000.0,16250.0,-41.0,-49.0,-52.0,-37.0,-43.0,-50.0,-51.0,-38.0,-84.0,-84.0,-80.0,-80.0,43.0,35.0,28.0,43.0,1
5737,92:69:1D:31:68:E9,3841213,487595007,3939,3627752,3837274,483967255,0,4875,1112474,4729,1079399,146,33075,2133,11,4151,90,0,46,216660.0,130000.0,-50.0,-47.0,-42.0,-48.0,-51.0,-47.0,-43.0,-48.0,-84.0,-84.0,-80.0,-80.0,34.0,37.0,38.0,32.0,1
5738,CC:2F:71:3F:1F:24,4678589,1395645961,841315,911678706,3837274,483967255,37,683716,721718727,682983,721630565,733,88162,659070,15,841572,89646,34,534,130000.0,43333.0,-67.0,-65.0,-67.0,-70.0,-67.0,-65.0,-67.0,-70.0,-84.0,-84.0,-80.0,-80.0,17.0,19.0,13.0,10.0,1
5739,CC:2F:71:3E:C5:1F,3838167,484076455,893,109200,3837274,483967255,0,3718,312454,3068,235310,650,77144,946,10,1281,22,0,44,144444.0,39000.0,-80.0,-80.0,-73.0,-70.0,-72.0,-72.0,-68.0,-63.0,-84.0,-84.0,-80.0,-80.0,4.0,4.0,7.0,10.0,1
5740,BA:8C:B9:54:50:24,3842120,490151180,4846,6183925,3837274,483967255,0,9069,1704495,9047,1701000,22,3495,2348,15,5294,39,0,60,229410.0,130000.0,-48.0,-35.0,-43.0,-46.0,-41.0,-36.0,-44.0,-50.0,-84.0,-84.0,-80.0,-80.0,36.0,49.0,37.0,34.0,1
5741,62:47:05:9D:EB:15,3837333,483978720,59,11465,3837274,483967255,0,157,16149,146,13983,11,2166,41,0,86,1,0,6,229410.0,130000.0,-46.0,-48.0,-53.0,-50.0,-49.0,-50.0,-52.0,-56.0,-84.0,-84.0,-80.0,-80.0,38.0,36.0,27.0,30.0,1
5742,3C:55:76:E8:8F:1F,3893995,625723170,56720,141755781,3837275,483967389,24,25967,5801147,25622,5740469,345,60678,11378,31,56787,6514,24,276,65000.0,16250.0,-43.0,-50.0,-51.0,-40.0,-41.0,-48.0,-50.0,-37.0,-84.0,-84.0,-80.0,-80.0,41.0,34.0,29.0,40.0,1
5743,92:69:1D:31:68:E9,3841215,487595209,3939,3627752,3837276,483967457,0,4875,1112474,4729,1079399,146,33075,2133,11,4151,90,0,46,216660.0,130000.0,-50.0,-47.0,-42.0,-48.0,-51.0,-47.0,-43.0,-48.0,-84.0,-84.0,-80.0,-80.0,34.0,37.0,38.0,32.0,1
5744,CC:2F:71:3F:1F:24,4678798,1395905985,841522,911938528,3837276,483967457,37,683904,721967547,683171,721879385,733,88162,659252,15,841779,89649,34,534,130000.0,43333.0,-68.0,-65.0,-69.0,-70.0,-67.0,-65.0,-68.0,-69.0,-84.0,-84.0,-80.0,-80.0,16.0,19.0,11.0,10.0,1
5745,CC:2F:71:3E:C5:1F,3838170,484076717,893,109200,3837277,483967517,0,3718,312454,3068,235310,650,77144,946,10,1281,22,0,44,144444.0,39000.0,-80.0,-80.0,-73.0,-70.0,-72.0,-72.0,-68.0,-63.0,-84.0,-84.0,-80.0,-80.0,4.0,4.0,7.0,10.0,1
5746,BA:8C:B9:54:50:24,3842123,490151442,4846,6183925,3837277,483967517,0,9069,1704495,9047,1701000,22,3495,2348,15,5294,39,0,60,229410.0,130000.0,-48.0,-35.0,-43.0,-46.0,-41.0,-36.0,-44.0,-50.0,-84.0,-84.0,-80.0,-80.0,36.0,49.0,37.0,34.0,1
5747,62:47:05:9D:EB:15,3837342,483979588,59,11465,3837283,483968123,0,157,16149,146,13983,11,2166,41,0,86,1,0,6,229410.0,130000.0,-46.0,-48.0,-53.0,-50.0,-49.0,-50.0,-52.0,-56.0,-84.0,-84.0,-80.0,-80.0,38.0,36.0,27.0,30.0,1
5748,3C:55:76:E8:8F:1F,3894004,625723972,56721,141755849,3837283,483968123,24,25974,5801693,25629,5741015,345,60678,11379,31,56788,6514,24,276,65000.0,16250.0,-50.0,-50.0,-42.0,-43.0,-46.0,-50.0,-43.0,-41.0,-84.0,-84.0,-80.0,-80.0,34.0,34.0,38.0,37.0,1
5749,92:69:1D:31:68:E9,3841223,487595991,3940,3627868,3837283,483968123,0,4877,1112610,4731,1079535,146,33075,2133,11,4152,90,0,46,216660.0,130000.0,-48.0,-50.0,-47.0,-46.0,-50.0,-47.0,-43.0,-48.0,-84.0,-84.0,-80.0,-80.0,36.0,34.0,33.0,34.0,1
5750,CC:2F:71:3F:1F:24,4679027,1396179866,841744,912211743,3837283,483968123,37,684112,722229403,683379,722141241,733,88162,659452,15,842001,89650,34,534,130000.0,43333.0,-68.0,-65.0,-68.0,-70.0,-67.0,-65.0,-68.0,-70.0,-84.0,-84.0,-80.0,-80.0,16.0,19.0,12.0,10.0,1
5751,CC:2F:71:3E:C5:1F,3838177,484077439,894,109316,3837283,483968123,0,3720,312594,3070,235450,650,77144,946,10,1282,22,0,44,144444.0,39000.0,-72.0,-71.0,-69.0,-60.0,-71.0,-71.0,-68.0,-61.0,-84.0,-84.0,-80.0,-80.0,12.0,13.0,11.0,20.0,1
5752,BA:8C:B9:54:50:24,3842130,490152108,4847,6183985,3837283,483968123,0,9071,1704631,9049,1701136,22,3495,2348,15,5295,39,0,60,229410.0,130000.0,-40.0,-37.0,-46.0,-52.0,-41.0,-36.0,-44.0,-50.0,-84.0,-84.0,-80.0,-80.0,44.0,47.0,34.0,28.0,1
5753,62:47:05:9D:EB:15,3837345,483979906,60,11581,3837285,483968325,0,159,16285,148,14119,11,2166,41,0,87,1,0,6,229410.0,130000.0,-45.0,-53.0,-48.0,-53.0,-47.0,-52.0,-51.0,-54.0,-84.0,-84.0,-80.0,-80.0,39.0,31.0,32.0,27.0,1
5754,3C:55:76:E8:8F:1F,3894007,625724234,56722,141755909,3837285,483968325,24,25975,5801761,25630,5741083,345,60678,11379,31,56788,6514,24,276,65000.0,16250.0,-42.0,-53.0,-50.0,-38.0,-46.0,-51.0,-43.0,-40.0,-84.0,-84.0,-80.0,-80.0,42.0,31.0,30.0,42.0,1
5755,92:69:1D:31:68:E9,3841225,487596193,3940,3627868,3837285,483968325,0,4877,1112610,4731,1079535,146,33075,2133,11,4152,90,0,46,216660.0,130000.0,-48.0,-50.0,-47.0,-46.0,-50.0,-47.0,-43.0,-48.0,-84.0,-84.0,-80.0,-80.0,36.0,34.0,33.0,34.0,1
5756,CC:2F:71:3F:1F:24,4679237,1396439796,841952,912471471,3837285,483968325,37,684306,722484877,683573,722396715,733,88162,659635,15,842209,89666,34,534,130000.0,43333.0,-68.0,-66.0,-65.0,-71.0,-67.0,-65.0,-67.0,-70.0,-84.0,-84.0,-80.0,-80.0,16.0,18.0,15.0,9.0,1
5757,CC:2F:71:3E:C5:1F,3838179,484077641,894,109316,3837285,483968325,0,3720,312594,3070,235450,650,77144,946,10,1282,22,0,44,144444.0,39000.0,-72.0,-71.0,-69.0,-60.0,-71.0,-71.0,-68.0,-61.0,-84.0,-84.0,-80.0,-80.0,12.0,13.0,11.0,20.0,1
5758,BA:8C:B9:54:50:24,3842136,490152714,4847,6183985,3837289,483968729,0,9071,1704631,9049,1701136,22,3495,2348,15,5295,39,0,60,229410.0,130000.0,-40.0,-37.0,-46.0,-52.0,-41.0,-36.0,-44.0,-50.0,-84.0,-84.0,-80.0,-80.0,44.0,47.0,34.0,28.0,1
5759,62:47:05:9D:EB:15,3837353,483980845,60,11581,3837293,483969264,0,159,16285,148,14119,11,2166,41,0,87,1,0,6,229410.0,130000.0,-45.0,-53.0,-48.0,-53.0,-47.0,-52.0,-51.0,-54.0,-84.0,-84.0,-80.0,-80.0,39.0,31.0,32.0,27.0,1
5760,3C:55:76:E8:8F:1F,3894016,625725269,56723,141756005,3837293,483969264,24,25990,5802910,25645,5742232,345,60678,11381,31,56790,6514,24,276,65000.0,16250.0,-46.0,-52.0,-44.0,-42.0,-44.0,-52.0,-44.0,-41.0,-84.0,-84.0,-80.0,-80.0,38.0,32.0,36.0,38.0,1
5761,92:69:1D:31:68:E9,3841233,487597132,3940,3627868,3837293,483969264,0,4877,1112610,4731,1079535,146,33075,2133,11,4152,90,0,46,216660.0,130000.0,-48.0,-50.0,-47.0,-46.0,-50.0,-47.0,-43.0,-48.0,-84.0,-84.0,-80.0,-80.0,36.0,34.0,33.0,34.0,1
5762,CC:2F:71:3F:1F:24,4679453,1396700927,842160,912731663,3837293,483969264,37,684498,722734209,683765,722646047,733,88162,659821,15,842417,89667,34,534,130000.0,43333.0,-69.0,-67.0,-69.0,-70.0,-68.0,-66.0,-68.0,-70.0,-84.0,-84.0,-80.0,-80.0,15.0,17.0,11.0,10.0,1
5763,CC:2F:71:3E:C5:1F,3838187,484078580,894,109316,3837293,483969264,0,3720,312594,3070,235450,650,77144,946,10,1282,22,0,44,144444.0,39000.0,-72.0,-71.0,-69.0,-60.0,-71.0,-71.0,-68.0,-61.0,-84.0,-84.0,-80.0,-80.0,12.0,13.0,11.0,20.0,1
5764,BA:8C:B9:54:50:24,3842140,490153249,4847,6183985,3837293,483969264,0,9071,1704631,9049,1701136,22,3495,2348,15,5295,39,0,60,229410.0,130000.0,-40.0,-37.0,-46.0,-52.0,-41.0,-36.0,-44.0,-50.0,-84.0,-84.0,-80.0,-80.0,44.0,47.0,34.0,28.0,1
5765,62:47:05:9D:EB:15,3837355,483981047,60,11581,3837295,483969466,0,159,16285,148,14119,11,2166,41,0,87,1,0,6,229410.0,130000.0,-45.0,-53.0,-48.0,-53.0,-47.0,-52.0,-51.0,-54.0,-84.0,-84.0,-80.0,-80.0,39.0,31.0,32.0,27.0,1
5766,3C:55:76:E8:8F:1F,3894020,625725673,56723,141756005,3837297,483969668,24,25995,5803252,25650,5742574,345,60678,11381,31,56790,6514,24,276,65000.0,16250.0,-45.0,-57.0,-45.0,-40.0,-44.0,-54.0,-44.0,-40.0,-84.0,-84.0,-80.0,-80.0,39.0,27.0,35.0,40.0,1
5767,92:69:1D:31:68:E9,3841239,487597738,3940,3627868,3837299,483969870,0,4877,1112610,4731,1079535,146,33075,2133,11,4152,90,0,46,216660.0,130000.0,-48.0,-50.0,-47.0,-46.0,-50.0,-47.0,-43.0,-48.0,-84.0,-84.0,-80.0,-80.0,36.0,34.0,33.0,34.0,1
5768,CC:2F:71:3F:1F:24,4679666,1396961355,842367,912991485,3837299,483969870,37,684687,722984493,683954,722896331,733,88162,660006,15,842624,89673,34,534,130000.0,43333.0,-69.0,-66.0,-68.0,-71.0,-68.0,-65.0,-68.0,-70.0,-84.0,-84.0,-80.0,-80.0,15.0,18.0,12.0,9.0,1
5769,CC:2F:71:3E:C5:1F,3838195,484079388,894,109316,3837301,483970072,0,3720,312594,3070,235450,650,77144,946,10,1282,22,0,44,144444.0,39000.0,-72.0,-71.0,-69.0,-60.0,-71.0,-71.0,-68.0,-61.0,-84.0,-84.0,-80.0,-80.0,12.0,13.0,11.0,20.0,1
5770,BA:8C:B9:54:50:24,3842148,490154057,4847,6183985,3837301,483970072,0,9071,1704631,9049,1701136,22,3495,2348,15,5295,39,0,60,229410.0,130000.0,-40.0,-37.0,-46.0,-52.0,-41.0,-36.0,-44.0,-50.0,-84.0,-84.0,-80.0,-80.0,44.0,47.0,34.0,28.0,1
5771,62:47:05:9D:EB:15,3837364,483981837,60,11581,3837304,483970256,0,159,16285,148,14119,11,2166,41,0,87,1,0,6,229410.0,130000.0,-45.0,-53.0,-48.0,-53.0,-47.0,-52.0,-51.0,-54.0,-84.0,-84.0,-80.0,-80.0,39.0,31.0,32.0,27.0,1
5772,3C:55:76:E8:8F:1F,3894027,625726261,56723,141756005,3837304,483970256,24,26002,5803782,25656,5742986,346,60796,11382,31,56790,6514,24,276,65000.0,16250.0,-51.0,-50.0,-47.0,-45.0,-47.0,-49.0,-45.0,-40.0,-84.0,-84.0,-80.0,-80.0,33.0,34.0,33.0,35.0,1
5773,92:69:1D:31:68:E9,3841244,487598124,3940,3627868,3837304,483970256,0,4877,1112610,4731,1079535,146,33075,2133,11,4152,90,0,46,216660.0,130000.0,-48.0,-50.0,-47.0,-46.0,-50.0,-47.0,-43.0,-48.0,-84.0,-84.0,-80.0,-80.0,36.0,34.0,33.0,34.0,1
5774,CC:2F:71:3F:1F:24,4679890,1397228532,842586,913258276,3837304,483970256,37,684886,723239334,684153,723151172,733,88162,660197,15,842843,89686,34,534,130000.0,43333.0,-68.0,-66.0,-68.0,-71.0,-68.0,-66.0,-68.0,-70.0,-84.0,-84.0,-80.0,-80.0,16.0,18.0,12.0,9.0,1
5775,CC:2F:71:3E:C5:1F,3838198,484079572,894,109316,3837304,483970256,0,3722,312782,3071,235520,651,77262,947,10,1282,22,0,44,144444.0,39000.0,-71.0,-72.0,-69.0,-61.0,-72.0,-72.0,-69.0,-61.0,-84.0,-84.0,-80.0,-80.0,13.0,12.0,11.0,19.0,1
5776,BA:8C:B9:54:50:24,3842151,490154241,4847,6183985,3837304,483970256,0,9071,1704631,9049,1701136,22,3495,2348,15,5295,39,0,60,229410.0,130000.0,-40.0,-37.0,-46.0,-52.0,-41.0,-36.0,-44.0,-50.0,-84.0,-84.0,-80.0,-80.0,44.0,47.0,34.0,28.0,1
5777,62:47:05:9D:EB:15,3837371,483982505,60,11581,3837311,483970924,0,159,16285,148,14119,11,2166,41,0,87,1,0,6,229410.0,130000.0,-45.0,-53.0,-48.0,-53.0,-47.0,-52.0,-51.0,-54.0,-84.0,-84.0,-80.0,-80.0,39.0,31.0,32.0,27.0,1
5778,3C:55:76:E8:8F:1F,3894036,625727131,56723,141756005,3837313,483971126,24,26002,5803782,25656,5742986,346,60796,11382,31,56790,6514,24,276,65000.0,16250.0,-51.0,-50.0,-47.0,-45.0,-47.0,-49.0,-45.0,-40.0,-84.0,-84.0,-80.0,-80.0,33.0,34.0,33.0,35.0,1
5779,92:69:1D:31:68:E9,3841253,487598994,3940,3627868,3837313,483971126,0,4877,1112610,4731,1079535,146,33075,2133,11,4152,90,0,46,216660.0,130000.0,-48.0,-50.0,-47.0,-46.0,-50.0,-47.0,-43.0,-48.0,-84.0,-84.0,-80.0,-80.0,36.0,34.0,33.0,34.0,1
5780,CC:2F:71:3F:1F:24,4680105,1397489318,842792,913518192,3837313,483971126,37,685083,723497862,684349,723409582,734,88280,660383,15,843049,89690,34,534,130000.0,43333.0,-69.0,-66.0,-68.0,-67.0,-69.0,-66.0,-68.0,-69.0,-84.0,-84.0,-80.0,-80.0,15.0,18.0,12.0,13.0,1
5781,CC:2F:71:3E:C5:1F,3838207,484080442,894,109316,3837313,483971126,0,3722,312782,3071,235520,651,77262,947,10,1282,22,0,44,144444.0,39000.0,-71.0,-72.0,-69.0,-61.0,-72.0,-72.0,-69.0,-61.0,-84.0,-84.0,-80.0,-80.0,13.0,12.0,11.0,19.0,1
5782,BA:8C:B9:54:50:24,3842160,490155111,4847,6183985,3837313,483971126,0,9071,1704631,9049,1701136,22,3495,2348,15,5295,39,0,60,229410.0,130000.0,-40.0,-37.0,-46.0,-52.0,-41.0,-36.0,-44.0,-50.0,-84.0,-84.0,-80.0,-80.0,44.0,47.0,34.0,28.0,1
5783,62:47:05:9D:EB:15,3837374,483982769,60,11581,3837314,483971188,0,159,16285,148,14119,11,2166,41,0,87,1,0,6,229410.0,130000.0,-45.0,-53.0,-48.0,-53.0,-47.0,-52.0,-51.0,-54.0,-84.0,-84.0,-80.0,-80.0,39.0,31.0,32.0,27.0,1
5784,3C:55:76:E8:8F:1F,3894037,625727193,56723,141756005,3837314,483971188,24,26009,5804312,25662,5743398,347,60914,11383,31,56790,6514,24,276,65000.0,16250.0,-50.0,-50.0,-46.0,-44.0,-47.0,-48.0,-45.0,-40.0,-84.0,-84.0,-80.0,-80.0,34.0,34.0,34.0,36.0,1
5785,92:69:1D:31:68:E9,3841254,487599056,3940,3627868,3837314,483971188,0,4877,1112610,4731,1079535,146,33075,2133,11,4152,90,0,46,216660.0,130000.0,-48.0,-50.0,-47.0,-46.0,-50.0,-47.0,-43.0,-48.0,-84.0,-84.0,-80.0,-80.0,36.0,34.0,33.0,34.0,1
5786,CC:2F:71:3F:1F:24,4680314,1397749444,843000,913778256,3837314,483971188,37,685272,723748254,684538,723659974,734,88280,660566,15,843257,89702,34,534,117000.0,39000.0,-69.0,-66.0,-68.0,-67.0,-68.0,-65.0,-67.0,-70.0,-84.0,-84.0,-80.0,-80.0,15.0,18.0,12.0,13.0,1
5787,CC:2F:71:3E:C5:1F,3838209,484080564,894,109316,3837315,483971248,0,3722,312782,3071,235520,651,77262,947,10,1282,22,0,44,144444.0,39000.0,-71.0,-72.0,-69.0,-61.0,-72.0,-72.0,-69.0,-61.0,-84.0,-84.0,-80.0,-80.0,13.0,12.0,11.0,19.0,1
5788,BA:8C:B9:54:50:24,3842164,490155435,4847,6183985,3837317,483971450,0,9071,1704631,9049,1701136,22,3495,2348,15,5295,39,0,60,229410.0,130000.0,-40.0,-37.0,-46.0,-52.0,-41.0,-36.0,-44.0,-50.0,-84.0,-84.0,-80.0,-80.0,44.0,47.0,34.0,28.0,1
5789,62:47:05:9D:EB:15,3837383,483983637,60,11581,3837323,483972056,0,159,16285,148,14119,11,2166,41,0,87,1,0,6,229410.0,130000.0,-45.0,-53.0,-48.0,-53.0,-47.0,-52.0,-51.0,-54.0,-84.0,-84.0,-80.0,-80.0,39.0,31.0,32.0,27.0,1
5790,3C:55:76:E8:8F:1F,3894052,625730189,56729,141758133,3837323,483972056,24,26027,5807384,25680,5746470,347,60914,11391,31,56796,6514,24,276,65000.0,16250.0,-44.0,-55.0,-47.0,-41.0,-45.0,-53.0,-46.0,-41.0,-84.0,-84.0,-80.0,-80.0,40.0,29.0,33.0,39.0,1
5791,92:69:1D:31:68:E9,3841263,487599924,3940,3627868,3837323,483972056,0,4877,1112610,4731,1079535,146,33075,2133,11,4152,90,0,46,216660.0,130000.0,-48.0,-50.0,-47.0,-46.0,-50.0,-47.0,-43.0,-48.0,-84.0,-84.0,-80.0,-80.0,36.0,34.0,33.0,34.0,1
5792,CC:2F:71:3F:1F:24,4680545,1398024853,843222,914052797,3837323,483972056,37,685480,724012735,684746,723924455,734,88280,660767,15,843477,89703,34,534,130000.0,43333.0,-69.0,-66.0,-69.0,-71.0,-68.0,-65.0,-68.0,-70.0,-84.0,-84.0,-80.0,-80.0,15.0,18.0,11.0,9.0,1
5793,CC:2F:71:3E:C5:1F,3838217,484081372,894,109316,3837323,483972056,0,3722,312782,3071,235520,651,77262,947,10,1282,22,0,44,144444.0,39000.0,-71.0,-72.0,-69.0,-61.0,-72.0,-72.0,-69.0,-61.0,-84.0,-83.0,-80.0,-79.0,13.0,11.0,11.0,18.0,1
5794,BA:8C:B9:54:50:24,3842170,490156041,4847,6183985,3837323,483972056,0,9071,1704631,9049,1701136,22,3495,2348,15,5295,39,0,60,229410.0,130000.0,-40.0,-37.0,-46.0,-52.0,-41.0,-36.0,-44.0,-50.0,-84.0,-83.0,-80.0,-79.0,44.0,46.0,34.0,27.0,1
5795,62:47:05:9D:EB:15,3837383,483983637,60,11581,3837323,483972056,0,159,16285,148,14119,11,2166,41,0,87,1,0,6,229410.0,130000.0,-45.0,-53.0,-48.0,-53.0,-47.0,-52.0,-51.0,-54.0,-84.0,-83.0,-80.0,-79.0,39.0,30.0,32.0,26.0,1
5796,3C:55:76:E8:8F:1F,3894054,625730391,56729,141758133,3837325,483972258,24,26028,5807454,25681,5746540,347,60914,11391,31,56796,6514,24,276,65000.0,16250.0,-45.0,-55.0,-47.0,-41.0,-44.0,-54.0,-46.0,-41.0,-84.0,-83.0,-80.0,-79.0,39.0,28.0,33.0,38.0,1
5797,92:69:1D:31:68:E9,3841265,487600126,3940,3627868,3837325,483972258,0,4877,1112610,4731,1079535,146,33075,2133,11,4152,90,0,46,216660.0,130000.0,-48.0,-50.0,-47.0,-46.0,-50.0,-47.0,-43.0,-48.0,-84.0,-83.0,-80.0,-79.0,36.0,33.0,33.0,33.0,1
5798,CC:2F:71:3F:1F:24,4680759,1398290023,843434,914317765,3837325,483972258,37,685672,724267667,684938,724179387,734,88280,660953,15,843691,89703,34,534,130000.0,43333.0,-70.0,-66.0,-68.0,-71.0,-69.0,-66.0,-67.0,-71.0,-84.0,-83.0,-80.0,-79.0,14.0,17.0,12.0,8.0,1
5799,CC:2F:71:3E:C5:1F,3838219,484081574,894,109316,3837325,483972258,0,3722,312782,3071,235520,651,77262,947,10,1282,22,0,44,144444.0,39000.0,-71.0,-72.0,-69.0,-61.0,-72.0,-72.0,-69.0,-61.0,-84.0,-83.0,-80.0,-79.0,13.0,11.0,11.0,18.0,1
5800,BA:8C:B9:54:50:24,3842176,490156647,4847,6183985,3837329,483972662,0,9071,1704631,9049,1701136,22,3495,2348,15,5295,39,0,60,229410.0,130000.0,-40.0,-37.0,-46.0,-52.0,-41.0,-36.0,-44.0,-50.0,-84.0,-83.0,-80.0,-79.0,44.0,46.0,34.0,27.0,1
5801,62:47:05:9D:EB:15,3837392,483984505,60,11581,3837332,483972924,0,161,16421,150,14255,11,2166,41,0,88,1,0,6,229410.0,130000.0,-45.0,-52.0,-51.0,-57.0,-46.0,-53.0,-50.0,-54.0,-84.0,-83.0,-80.0,-79.0,39.0,31.0,29.0,22.0,1
5802,3C:55:76:E8:8F:1F,3894061,625731057,56729,141758133,3837332,483972924,24,26029,5807522,25682,5746608,347,60914,11391,31,56796,6514,24,276,65000.0,16250.0,-45.0,-54.0,-49.0,-40.0,-44.0,-54.0,-47.0,-41.0,-84.0,-83.0,-80.0,-79.0,39.0,29.0,31.0,39.0,1
5803,92:69:1D:31:68:E9,3841272,487600792,3940,3627868,3837332,483972924,0,4880,1112814,4734,1079739,146,33075,2133,11,4153,90,0,46,216660.0,130000.0,-51.0,-47.0,-42.0,-49.0,-50.0,-47.0,-43.0,-48.0,-84.0,-83.0,-80.0,-79.0,33.0,36.0,38.0,30.0,1
5804,CC:2F:71:3F:1F:24,4680976,1398552325,843644,914579401,3837332,483972924,37,685873,724533819,685139,724445539,734,88280,661140,15,843901,89713,34,534,130000.0,43333.0,-69.0,-66.0,-67.0,-71.0,-69.0,-66.0,-67.0,-70.0,-84.0,-83.0,-80.0,-79.0,15.0,17.0,13.0,8.0,1
5805,CC:2F:71:3E:C5:1F,3838226,484082240,894,109316,3837332,483972924,0,3722,312782,3071,235520,651,77262,947,10,1282,22,0,44,144444.0,39000.0,-71.0,-72.0,-69.0,-61.0,-72.0,-72.0,-69.0,-61.0,-84.0,-83.0,-80.0,-79.0,13.0,11.0,11.0,18.0,1
5806,BA:8C:B9:54:50:24,3842179,490156909,4847,6183985,3837332,483972924,0,9073,1704767,9051,1701272,22,3495,2348,15,5296,39,0,60,229410.0,130000.0,-40.0,-37.0,-45.0,-52.0,-42.0,-36.0,-44.0,-50.0,-84.0,-83.0,-80.0,-79.0,44.0,46.0,35.0,27.0,1
5807,62:47:05:9D:EB:15,3837394,483984707,60,11581,3837334,483973126,0,161,16421,150,14255,11,2166,41,0,88,1,0,6,229410.0,130000.0,-45.0,-52.0,-51.0,-57.0,-46.0,-53.0,-50.0,-54.0,-84.0,-83.0,-80.0,-79.0,39.0,31.0,29.0,22.0,1
5808,3C:55:76:E8:8F:1F,3894064,625731389,56730,141758263,3837334,483973126,24,26038,5808177,25691,5747263,347,60914,11392,31,56797,6514,24,276,65000.0,16250.0,-44.0,-57.0,-44.0,-42.0,-43.0,-55.0,-43.0,-40.0,-84.0,-83.0,-80.0,-79.0,40.0,26.0,36.0,37.0,1
5809,92:69:1D:31:68:E9,3841278,487601398,3940,3627868,3837338,483973530,0,4880,1112814,4734,1079739,146,33075,2133,11,4153,90,0,46,216660.0,130000.0,-51.0,-47.0,-42.0,-49.0,-50.0,-47.0,-43.0,-48.0,-84.0,-83.0,-80.0,-79.0,33.0,36.0,38.0,30.0,1
5810,CC:2F:71:3F:1F:24,4681195,1398820795,843856,914847203,3837339,483973592,37,686071,724793771,685337,724705491,734,88280,661331,15,844113,89713,34,534,130000.0,43333.0,-69.0,-66.0,-67.0,-71.0,-69.0,-66.0,-67.0,-70.0,-84.0,-83.0,-80.0,-79.0,15.0,17.0,13.0,8.0,1
5811,CC:2F:71:3E:C5:1F,3838233,484082908,894,109316,3837339,483973592,0,3722,312782,3071,235520,651,77262,947,10,1282,22,0,44,144444.0,39000.0,-71.0,-72.0,-69.0,-61.0,-72.0,-72.0,-69.0,-61.0,-84.0,-83.0,-80.0,-79.0,13.0,11.0,11.0,18.0,1
5812,BA:8C:B9:54:50:24,3842188,490157779,4847,6183985,3837341,483973794,0,9073,1704767,9051,1701272,22,3495,2348,15,5296,39,0,60,229410.0,130000.0,-40.0,-37.0,-45.0,-52.0,-42.0,-36.0,-44.0,-50.0,-84.0,-83.0,-80.0,-79.0,44.0,46.0,35.0,27.0,1
5813,62:47:05:9D:EB:15,3837402,483985435,60,11581,3837342,483973854,0,161,16421,150,14255,11,2166,41,0,88,1,0,6,229410.0,130000.0,-45.0,-52.0,-51.0,-57.0,-46.0,-53.0,-50.0,-54.0,-84.0,-83.0,-80.0,-79.0,39.0,31.0,29.0,22.0,1
5814,3C:55:76:E8:8F:1F,3894072,625732117,56730,141758263,3837342,483973854,24,26049,5808979,25701,5747947,348,61032,11393,31,56797,6514,24,276,65000.0,16250.0,-50.0,-52.0,-45.0,-44.0,-48.0,-50.0,-44.0,-41.0,-84.0,-83.0,-80.0,-79.0,34.0,31.0,35.0,35.0,1
5815,92:69:1D:31:68:E9,3841282,487601722,3940,3627868,3837342,483973854,0,4880,1112814,4734,1079739,146,33075,2133,11,4153,90,0,46,216660.0,130000.0,-51.0,-47.0,-42.0,-49.0,-50.0,-47.0,-43.0,-48.0,-84.0,-83.0,-80.0,-79.0,33.0,36.0,38.0,30.0,1
5816,CC:2F:71:3F:1F:24,4681415,1399087588,844073,915113734,3837342,483973854,37,686275,725056480,685541,724968200,734,88280,661524,15,844330,89720,34,534,130000.0,43333.0,-70.0,-66.0,-67.0,-71.0,-69.0,-65.0,-67.0,-71.0,-84.0,-83.0,-80.0,-79.0,14.0,17.0,13.0,8.0,1
5817,CC:2F:71:3E:C5:1F,3838236,484083170,894,109316,3837342,483973854,0,3722,312782,3071,235520,651,77262,947,10,1282,22,0,44,144444.0,39000.0,-71.0,-72.0,-69.0,-61.0,-72.0,-72.0,-69.0,-61.0,-84.0,-83.0,-80.0,-79.0,13.0,11.0,11.0,18.0,1
5818,BA:8C:B9:54:50:24,3842189,490157839,4847,6183985,3837342,483973854,0,9073,1704767,9051,1701272,22,3495,2348,15,5296,39,0,60,229410.0,130000.0,-40.0,-37.0,-45.0,-52.0,-42.0,-36.0,-44.0,-50.0,-84.0,-83.0,-80.0,-79.0,44.0,46.0,35.0,27.0,1
5819,62:47:05:9D:EB:15,3837432,483997132,60,11581,3837372,483985551,0,161,16421,150,14255,11,2166,41,0,88,1,0,6,229410.0,130000.0,-45.0,-52.0,-51.0,-57.0,-46.0,-53.0,-50.0,-54.0,-84.0,-83.0,-80.0,-79.0,39.0,31.0,29.0,22.0,1
5820,3C:55:76:E8:8F:1F,3894103,625743948,56730,141758263,3837373,483985685,24,26049,5808979,25701,5747947,348,61032,11393,31,56797,6514,24,276,65000.0,16250.0,-50.0,-52.0,-45.0,-44.0,-48.0,-50.0,-44.0,-41.0,-84.0,-83.0,-80.0,-79.0,34.0,31.0,35.0,35.0,1
5821,92:69:1D:31:68:E9,3841313,487613553,3940,3627868,3837373,483985685,0,4883,1113185,4736,1079875,147,33310,2134,11,4153,90,0,46,216660.0,130000.0,-51.0,-45.0,-42.0,-50.0,-50.0,-47.0,-44.0,-48.0,-84.0,-83.0,-80.0,-79.0,33.0,38.0,38.0,29.0,1
5822,CC:2F:71:3F:1F:24,4681668,1399381351,844295,915395666,3837373,483985685,37,686494,725342074,685760,725253794,734,88280,661726,15,844552,89722,34,534,130000.0,43333.0,-70.0,-66.0,-68.0,-71.0,-69.0,-65.0,-67.0,-70.0,-84.0,-83.0,-80.0,-79.0,14.0,17.0,12.0,8.0,1
5823,CC:2F:71:3E:C5:1F,3838267,484095001,894,109316,3837373,483985685,0,3722,312782,3071,235520,651,77262,947,10,1282,22,0,44,144444.0,39000.0,-71.0,-72.0,-69.0,-61.0,-72.0,-72.0,-69.0,-61.0,-84.0,-83.0,-80.0,-79.0,13.0,11.0,11.0,18.0,1
5824,BA:8C:B9:54:50:24,3842220,490169670,4847,6183985,3837373,483985685,0,9073,1704767,9051,1701272,22,3495,2348,15,5296,39,0,60,229410.0,130000.0,-40.0,-37.0,-45.0,-52.0,-42.0,-36.0,-44.0,-50.0,-84.0,-83.0,-80.0,-79.0,44.0,46.0,35.0,27.0,1
5825,62:47:05:9D:EB:15,3837433,483997266,60,11581,3837373,483985685,0,161,16421,150,14255,11,2166,41,0,88,1,0,6,229410.0,130000.0,-45.0,-52.0,-51.0,-57.0,-46.0,-53.0,-50.0,-54.0,-83.0,-83.0,-80.0,-79.0,38.0,31.0,29.0,22.0,1
5826,3C:55:76:E8:8F:1F,3894103,625743948,56730,141758263,3837373,483985685,24,26049,5808979,25701,5747947,348,61032,11393,31,56797,6514,24,276,65000.0,16250.0,-50.0,-52.0,-45.0,-44.0,-48.0,-50.0,-44.0,-41.0,-83.0,-83.0,-80.0,-79.0,33.0,31.0,35.0,35.0,1
5827,92:69:1D:31:68:E9,3841314,487613613,3940,3627868,3837374,483985745,0,4883,1113185,4736,1079875,147,33310,2134,11,4153,90,0,46,216660.0,130000.0,-51.0,-45.0,-42.0,-50.0,-50.0,-47.0,-44.0,-48.0,-83.0,-83.0,-80.0,-79.0,32.0,38.0,38.0,29.0,1
5828,CC:2F:71:3F:1F:24,4681879,1399644359,844505,915658614,3837374,483985745,37,686691,725599448,685957,725511168,734,88280,661912,15,844762,89732,34,534,130000.0,43333.0,-69.0,-66.0,-67.0,-71.0,-69.0,-66.0,-67.0,-70.0,-83.0,-83.0,-80.0,-79.0,14.0,17.0,13.0,8.0,1
5829,CC:2F:71:3E:C5:1F,3838268,484095061,894,109316,3837374,483985745,0,3722,312782,3071,235520,651,77262,947,10,1282,22,0,44,144444.0,39000.0,-71.0,-72.0,-69.0,-61.0,-72.0,-72.0,-69.0,-61.0,-83.0,-83.0,-80.0,-79.0,12.0,11.0,11.0,18.0,1
5830,BA:8C:B9:54:50:24,3842221,490169730,4847,6183985,3837374,483985745,0,9073,1704767,9051,1701272,22,3495,2348,15,5296,39,0,60,229410.0,130000.0,-40.0,-37.0,-45.0,-52.0,-42.0,-36.0,-44.0,-50.0,-83.0,-83.0,-80.0,-79.0,43.0,46.0,35.0,27.0,1
5831,62:47:05:9D:EB:15,3837443,483998407,60,11581,3837383,483986826,0,161,16421,150,14255,11,2166,41,0,88,1,0,6,229410.0,130000.0,-45.0,-52.0,-51.0,-57.0,-46.0,-53.0,-50.0,-54.0,-83.0,-83.0,-80.0,-79.0,38.0,31.0,29.0,22.0,1
5832,3C:55:76:E8:8F:1F,3894113,625745089,56730,141758263,3837383,483986826,24,26049,5808979,25701,5747947,348,61032,11393,31,56797,6514,24,276,65000.0,16250.0,-50.0,-52.0,-45.0,-44.0,-48.0,-50.0,-44.0,-41.0,-83.0,-83.0,-80.0,-79.0,33.0,31.0,35.0,35.0,1
5833,92:69:1D:31:68:E9,3841323,487614694,3940,3627868,3837383,483986826,0,4883,1113185,4736,1079875,147,33310,2134,11,4153,90,0,46,216660.0,130000.0,-51.0,-45.0,-42.0,-50.0,-50.0,-47.0,-44.0,-48.0,-83.0,-83.0,-80.0,-79.0,32.0,38.0,38.0,29.0,1
5834,CC:2F:71:3F:1F:24,4682108,1399919705,844725,915932879,3837383,483986826,37,686906,725870653,686172,725782373,734,88280,662114,15,844981,89732,34,535,130000.0,43333.0,-70.0,-66.0,-68.0,-71.0,-69.0,-65.0,-67.0,-70.0,-83.0,-83.0,-80.0,-79.0,13.0,17.0,12.0,8.0,1
5835,CC:2F:71:3E:C5:1F,3838277,484096142,894,109316,3837383,483986826,0,3722,312782,3071,235520,651,77262,947,10,1282,22,0,44,144444.0,39000.0,-71.0,-72.0,-69.0,-61.0,-72.0,-72.0,-69.0,-61.0,-83.0,-83.0,-80.0,-79.0,12.0,11.0,11.0,18.0,1
5836,BA:8C:B9:54:50:24,3842230,490170811,4847,6183985,3837383,483986826,0,9073,1704767,9051,1701272,22,3495,2348,15,5296,39,0,60,229410.0,130000.0,-40.0,-37.0,-45.0,-52.0,-42.0,-36.0,-44.0,-50.0,-83.0,-83.0,-80.0,-79.0,43.0,46.0,35.0,27.0,1
5837,62:47:05:9D:EB:15,3837449,483999013,60,11581,3837389,483987432,0,161,16421,150,14255,11,2166,41,0,88,1,0,6,229410.0,130000.0,-45.0,-52.0,-51.0,-57.0,-46.0,-53.0,-50.0,-54.0,-83.0,-83.0,-80.0,-79.0,38.0,31.0,29.0,22.0,1
5838,3C:55:76:E8:8F:1F,3895266,628778863,57876,144791371,3837390,483987492,24,26323,5852142,25975,5791110,348,61032,11556,31,57898,6551,24,298,81250.0,24370.0,-49.0,-51.0,-45.0,-44.0,-48.0,-53.0,-46.0,-44.0,-83.0,-83.0,-80.0,-79.0,34.0,32.0,35.0,35.0,1
5839,92:69:1D:31:68:E9,3841332,487615562,3940,3627868,3837392,483987694,0,4883,1113185,4736,1079875,147,33310,2134,11,4153,90,0,46,216660.0,130000.0,-51.0,-45.0,-42.0,-50.0,-50.0,-47.0,-44.0,-48.0,-83.0,-83.0,-80.0,-79.0,32.0,38.0,38.0,29.0,1
5840,CC:2F:71:3F:1F:24,4682429,1400339421,845037,916351727,3837392,483987694,37,687200,726276285,686466,726188005,734,88280,662405,15,845293,89743,34,535,130000.0,43333.0,-70.0,-65.0,-67.0,-70.0,-70.0,-65.0,-67.0,-70.0,-83.0,-83.0,-80.0,-79.0,13.0,18.0,13.0,9.0,1
5841,CC:2F:71:3E:C5:1F,3838286,484097010,894,109316,3837392,483987694,0,3722,312782,3071,235520,651,77262,947,10,1282,22,0,44,144444.0,39000.0,-71.0,-72.0,-69.0,-61.0,-72.0,-72.0,-69.0,-61.0,-83.0,-83.0,-80.0,-79.0,12.0,11.0,11.0,18.0,1
5842,BA:8C:B9:54:50:24,3842241,490172047,4847,6183985,3837394,483988062,0,9073,1704767,9051,1701272,22,3495,2348,15,5296,39,0,60,229410.0,130000.0,-40.0,-37.0,-45.0,-52.0,-42.0,-36.0,-44.0,-50.0,-83.0,-83.0,-80.0,-79.0,43.0,46.0,35.0,27.0,1
5843,62:47:05:9D:EB:15,3837454,483999643,60,11581,3837394,483988062,0,161,16421,150,14255,11,2166,41,0,88,1,0,6,229410.0,130000.0,-45.0,-52.0,-51.0,-57.0,-46.0,-53.0,-50.0,-54.0,-83.0,-83.0,-80.0,-79.0,38.0,31.0,29.0,22.0,1
5844,3C:55:76:E8:8F:1F,3895622,629704749,58228,145716687,3837394,483988062,24,26436,5867341,26088,5806309,348,61032,11624,32,58296,6559,24,304,77420.0,25800.0,-49.0,-52.0,-45.0,-44.0,-47.0,-53.0,-45.0,-44.0,-83.0,-83.0,-80.0,-79.0,34.0,31.0,35.0,35.0,1
5845,92:69:1D:31:68:E9,3841334,487615930,3940,3627868,3837394,483988062,0,4883,1113185,4736,1079875,147,33310,2134,11,4153,90,0,46,216660.0,130000.0,-51.0,-45.0,-42.0,-50.0,-50.0,-47.0,-44.0,-48.0,-83.0,-83.0,-80.0,-79.0,32.0,38.0,38.0,29.0,1
5846,CC:2F:71:3F:1F:24,4682661,1400628399,845265,916640135,3837396,483988264,37,687417,726562681,686683,726474401,734,88280,662613,15,845522,89743,34,535,130000.0,43333.0,-70.0,-66.0,-67.0,-70.0,-70.0,-66.0,-67.0,-70.0,-83.0,-83.0,-80.0,-79.0,13.0,17.0,13.0,9.0,1
5847,CC:2F:71:3E:C5:1F,3838292,484097782,894,109316,3837398,483988466,0,3722,312782,3071,235520,651,77262,947,10,1282,22,0,44,144444.0,39000.0,-71.0,-72.0,-69.0,-61.0,-72.0,-72.0,-69.0,-61.0,-83.0,-83.0,-80.0,-79.0,12.0,11.0,11.0,18.0,1
5848,BA:8C:B9:54:50:24,3842247,490172653,4847,6183985,3837400,483988668,0,9073,1704767,9051,1701272,22,3495,2348,15,5296,39,0,60,229410.0,130000.0,-40.0,-37.0,-45.0,-52.0,-42.0,-36.0,-44.0,-50.0,-83.0,-83.0,-80.0,-79.0,43.0,46.0,35.0,27.0,1
5849,62:47:05:9D:EB:15,3837463,484000511,60,11581,3837403,483988930,0,161,16421,150,14255,11,2166,41,0,88,1,0,6,229410.0,130000.0,-45.0,-52.0,-51.0,-57.0,-46.0,-53.0,-50.0,-54.0,-83.0,-83.0,-80.0,-79.0,38.0,31.0,29.0,22.0,1
5850,3C:55:76:E8:8F:1F,3895634,629706308,58231,145717378,3837403,483988930,24,26454,5869016,26106,5807984,348,61032,11630,32,58299,6559,24,304,73120.0,24370.0,-50.0,-52.0,-45.0,-45.0,-49.0,-51.0,-44.0,-43.0,-83.0,-83.0,-80.0,-79.0,33.0,31.0,35.0,34.0,1
5851,92:69:1D:31:68:E9,3841343,487616798,3940,3627868,3837403,483988930,0,4883,1113185,4736,1079875,147,33310,2134,11,4153,90,0,46,216660.0,130000.0,-51.0,-45.0,-42.0,-50.0,-50.0,-47.0,-44.0,-48.0,-83.0,-83.0,-80.0,-79.0,32.0,38.0,38.0,29.0,1
5852,CC:2F:71:3F:1F:24,4682886,1400897206,845483,916908276,3837403,483988930,37,687616,726814872,686882,726726592,734,88280,662808,15,845739,89743,34,535,144444.0,43333.0,-70.0,-66.0,-68.0,-70.0,-70.0,-66.0,-67.0,-70.0,-83.0,-83.0,-80.0,-79.0,13.0,17.0,12.0,9.0,1
5853,CC:2F:71:3E:C5:1F,3838297,484098246,894,109316,3837403,483988930,0,3722,312782,3071,235520,651,77262,947,10,1282,22,0,44,144444.0,39000.0,-71.0,-72.0,-69.0,-61.0,-72.0,-72.0,-69.0,-61.0,-83.0,-83.0,-80.0,-79.0,12.0,11.0,11.0,18.0,1
5854,BA:8C:B9:54:50:24,3842250,490172915,4847,6183985,3837403,483988930,0,9073,1704767,9051,1701272,22,3495,2348,15,5296,39,0,60,229410.0,130000.0,-40.0,-37.0,-45.0,-52.0,-42.0,-36.0,-44.0,-50.0,-83.0,-83.0,-80.0,-79.0,43.0,46.0,35.0,27.0,1
5855,62:47:05:9D:EB:15,3837469,484001117,60,11581,3837409,483989536,0,161,16421,150,14255,11,2166,41,0,88,1,0,6,229410.0,130000.0,-45.0,-52.0,-51.0,-57.0,-46.0,-53.0,-50.0,-54.0,-83.0,-83.0,-80.0,-79.0,38.0,31.0,29.0,22.0,1
5856,3C:55:76:E8:8F:1F,3895646,629710026,58237,145720490,3837409,483989536,24,26484,5874750,26136,5813718,348,61032,11637,32,58305,6559,24,304,65000.0,1000.0,-43.0,-54.0,-45.0,-42.0,-43.0,-53.0,-44.0,-42.0,-83.0,-83.0,-80.0,-79.0,40.0,29.0,35.0,37.0,1
5857,92:69:1D:31:68:E9,3841349,487617404,3940,3627868,3837409,483989536,0,4883,1113185,4736,1079875,147,33310,2134,11,4153,90,0,46,216660.0,130000.0,-51.0,-45.0,-42.0,-50.0,-50.0,-47.0,-44.0,-48.0,-83.0,-83.0,-80.0,-79.0,32.0,38.0,38.0,29.0,1
5858,CC:2F:71:3F:1F:24,4683129,1401204478,845720,917214942,3837409,483989536,37,687857,727115420,687123,727027140,734,88280,663024,15,845977,89745,34,536,144444.0,43333.0,-70.0,-66.0,-68.0,-70.0,-70.0,-65.0,-67.0,-70.0,-83.0,-83.0,-80.0,-79.0,13.0,17.0,12.0,9.0,1
5859,CC:2F:71:3E:C5:1F,3838305,484099054,894,109316,3837411,483989738,0,3722,312782,3071,235520,651,77262,947,10,1282,22,0,44,144444.0,39000.0,-71.0,-72.0,-69.0,-61.0,-72.0,-72.0,-69.0,-61.0,-83.0,-83.0,-80.0,-79.0,12.0,11.0,11.0,18.0,1
5860,BA:8C:B9:54:50:24,3842258,490173723,4847,6183985,3837411,483989738,0,9073,1704767,9051,1701272,22,3495,2348,15,5296,39,0,60,229410.0,130000.0,-40.0,-37.0,-45.0,-52.0,-42.0,-36.0,-44.0,-50.0,-83.0,-83.0,-80.0,-79.0,43.0,46.0,35.0,27.0,1
5861,62:47:05:9D:EB:15,3837471,484001319,60,11581,3837411,483989738,0,161,16421,150,14255,11,2166,41,0,88,1,0,6,229410.0,130000.0,-45.0,-52.0,-51.0,-57.0,-46.0,-53.0,-50.0,-54.0,-83.0,-83.0,-80.0,-79.0,38.0,31.0,29.0,22.0,1
5862,3C:55:76:E8:8F:1F,3895648,629710228,58237,145720490,3837411,483989738,24,26484,5874750,26136,5813718,348,61032,11637,32,58305,6559,24,304,65000.0,1000.0,-43.0,-54.0,-45.0,-42.0,-43.0,-53.0,-44.0,-42.0,-83.0,-83.0,-80.0,-79.0,40.0,29.0,35.0,37.0,1
5863,92:69:1D:31:68:E9,3841351,487617606,3940,3627868,3837411,483989738,0,4883,1113185,4736,1079875,147,33310,2134,11,4153,90,0,46,216660.0,130000.0,-51.0,-45.0,-42.0,-50.0,-50.0,-47.0,-44.0,-48.0,-83.0,-83.0,-80.0,-79.0,32.0,38.0,38.0,29.0,1
5864,CC:2F:71:3F:1F:24,4683341,1401467894,845929,917478096,3837412,483989798,37,688051,727370632,687317,727282352,734,88280,663212,15,846186,89747,34,536,144444.0,43333.0,-70.0,-66.0,-67.0,-70.0,-70.0,-65.0,-67.0,-70.0,-83.0,-83.0,-80.0,-79.0,13.0,17.0,13.0,9.0,1
5865,CC:2F:71:3E:C5:1F,3838306,484099114,894,109316,3837412,483989798,0,3722,312782,3071,235520,651,77262,947,10,1282,22,0,44,144444.0,39000.0,-71.0,-72.0,-69.0,-61.0,-72.0,-72.0,-69.0,-61.0,-83.0,-83.0,-80.0,-79.0,12.0,11.0,11.0,18.0,1
5866,BA:8C:B9:54:50:24,3842259,490173783,4847,6183985,3837412,483989798,0,9073,1704767,9051,1701272,22,3495,2348,15,5296,39,0,60,229410.0,130000.0,-40.0,-37.0,-45.0,-52.0,-42.0,-36.0,-44.0,-50.0,-83.0,-83.0,-80.0,-79.0,43.0,46.0,35.0,27.0,1
5867,62:47:05:9D:EB:15,3837478,484001985,60,11581,3837418,483990404,0,161,16421,150,14255,11,2166,41,0,88,1,0,6,229410.0,130000.0,-45.0,-52.0,-51.0,-57.0,-46.0,-53.0,-50.0,-54.0,-83.0,-83.0,-80.0,-79.0,38.0,31.0,29.0,22.0,1
5868,3C:55:76:E8:8F:1F,3895657,629711096,58237,145720490,3837420,483990606,24,26484,5874750,26136,5813718,348,61032,11637,32,58305,6559,24,304,65000.0,1000.0,-43.0,-54.0,-45.0,-42.0,-43.0,-53.0,-44.0,-42.0,-83.0,-83.0,-80.0,-79.0,40.0,29.0,35.0,37.0,1
5869,92:69:1D:31:68:E9,3841360,487618474,3940,3627868,3837420,483990606,0,4883,1113185,4736,1079875,147,33310,2134,11,4153,90,0,46,216660.0,130000.0,-51.0,-45.0,-42.0,-50.0,-50.0,-47.0,-44.0,-48.0,-83.0,-83.0,-80.0,-79.0,32.0,38.0,38.0,29.0,1
5870,CC:2F:71:3F:1F:24,4683568,1401738565,846148,917747959,3837420,483990606,37,688251,727627253,687517,727538973,734,88280,663405,15,846404,89750,34,536,144444.0,43333.0,-70.0,-66.0,-67.0,-71.0,-70.0,-65.0,-67.0,-71.0,-83.0,-83.0,-80.0,-79.0,13.0,17.0,13.0,8.0,1
5871,CC:2F:71:3E:C5:1F,3838314,484099922,894,109316,3837420,483990606,0,3722,312782,3071,235520,651,77262,947,10,1282,22,0,44,144444.0,39000.0,-71.0,-72.0,-69.0,-61.0,-72.0,-72.0,-69.0,-61.0,-83.0,-83.0,-80.0,-79.0,12.0,11.0,11.0,18.0,1
5872,BA:8C:B9:54:50:24,3842267,490174591,4847,6183985,3837420,483990606,0,9073,1704767,9051,1701272,22,3495,2348,15,5296,39,0,60,229410.0,130000.0,-40.0,-37.0,-45.0,-52.0,-42.0,-36.0,-44.0,-50.0,-83.0,-83.0,-80.0,-79.0,43.0,46.0,35.0,27.0,1
5873,62:47:05:9D:EB:15,3837480,484002187,60,11581,3837420,483990606,0,162,16489,151,14323,11,2166,41,0,88,1,0,6,229410.0,130000.0,-60.0,-56.0,-60.0,-63.0,-48.0,-53.0,-51.0,-55.0,-83.0,-83.0,-80.0,-79.0,23.0,27.0,20.0,16.0,1
5874,3C:55:76:E8:8F:1F,3895658,629712253,58238,145721647,3837420,483990606,24,26492,5875332,26144,5814300,348,61032,11638,32,58306,6559,24,304,65000.0,1000.0,-44.0,-52.0,-44.0,-42.0,-42.0,-51.0,-43.0,-40.0,-83.0,-83.0,-80.0,-79.0,39.0,31.0,36.0,37.0,1
5875,92:69:1D:31:68:E9,3841360,487618474,3940,3627868,3837420,483990606,0,4883,1113185,4736,1079875,147,33310,2134,11,4153,90,0,46,216660.0,130000.0,-51.0,-45.0,-42.0,-50.0,-50.0,-47.0,-44.0,-48.0,-83.0,-83.0,-80.0,-79.0,32.0,38.0,38.0,29.0,1
5876,CC:2F:71:3F:1F:24,4683777,1401998857,846357,918008251,3837420,483990606,37,688445,727875653,687711,727787373,734,88280,663592,15,846614,89751,34,536,144444.0,43333.0,-70.0,-66.0,-68.0,-66.0,-69.0,-66.0,-67.0,-69.0,-83.0,-83.0,-80.0,-79.0,13.0,17.0,12.0,13.0,1
5877,CC:2F:71:3E:C5:1F,3838316,484100124,894,109316,3837422,483990808,0,3722,312782,3071,235520,651,77262,947,10,1282,22,0,44,144444.0,39000.0,-71.0,-72.0,-69.0,-61.0,-72.0,-72.0,-69.0,-61.0,-83.0,-83.0,-80.0,-79.0,12.0,11.0,11.0,18.0,1
5878,BA:8C:B9:54:50:24,3842269,490174793,4847,6183985,3837422,483990808,0,9073,1704767,9051,1701272,22,3495,2348,15,5296,39,0,60,229410.0,130000.0,-40.0,-37.0,-45.0,-52.0,-42.0,-36.0,-44.0,-50.0,-83.0,-83.0,-80.0,-79.0,43.0,46.0,35.0,27.0,1
5879,62:47:05:9D:EB:15,3837489,484003055,60,11581,3837429,483991474,0,162,16489,151,14323,11,2166,41,0,88,1,0,6,229410.0,130000.0,-60.0,-56.0,-60.0,-63.0,-48.0,-53.0,-51.0,-55.0,-83.0,-83.0,-80.0,-79.0,23.0,27.0,20.0,16.0,1
5880,3C:55:76:E8:8F:1F,3895667,629713121,58238,145721647,3837429,483991474,24,26494,5875470,26146,5814438,348,61032,11638,32,58306,6559,24,304,65000.0,1000.0,-41.0,-51.0,-43.0,-39.0,-43.0,-51.0,-43.0,-41.0,-83.0,-83.0,-80.0,-79.0,42.0,32.0,37.0,40.0,1
5881,92:69:1D:31:68:E9,3841369,487619342,3940,3627868,3837429,483991474,0,4883,1113185,4736,1079875,147,33310,2134,11,4153,90,0,46,216660.0,130000.0,-51.0,-45.0,-42.0,-50.0,-50.0,-47.0,-44.0,-48.0,-83.0,-83.0,-80.0,-79.0,32.0,38.0,38.0,29.0,1
5882,CC:2F:71:3F:1F:24,4683998,1402266103,846569,918274629,3837429,483991474,37,688637,728132165,687903,728043885,734,88280,663780,15,846826,89752,34,536,144444.0,43333.0,-70.0,-66.0,-67.0,-70.0,-70.0,-66.0,-67.0,-70.0,-83.0,-83.0,-80.0,-79.0,13.0,17.0,13.0,9.0,1
5883,CC:2F:71:3E:C5:1F,3838324,484100906,895,109432,3837429,483991474,0,3723,312852,3072,235590,651,77262,947,10,1283,22,0,44,144444.0,39000.0,-71.0,-71.0,-69.0,-60.0,-72.0,-72.0,-69.0,-61.0,-83.0,-83.0,-80.0,-79.0,12.0,12.0,11.0,19.0,1
5884,BA:8C:B9:54:50:24,3842276,490175459,4847,6183985,3837429,483991474,0,9073,1704767,9051,1701272,22,3495,2348,15,5296,39,0,60,229410.0,130000.0,-40.0,-37.0,-45.0,-52.0,-42.0,-36.0,-44.0,-50.0,-83.0,-83.0,-80.0,-79.0,43.0,46.0,35.0,27.0,1
5885,62:47:05:9D:EB:15,3837492,484003373,61,11697,3837431,483991676,0,164,16625,153,14459,11,2166,41,0,89,1,0,7,229410.0,137640.0,-46.0,-54.0,-50.0,-55.0,-47.0,-52.0,-51.0,-55.0,-83.0,-83.0,-80.0,-79.0,37.0,29.0,30.0,24.0,1
5886,3C:55:76:E8:8F:1F,3895671,629713501,58239,145721763,3837432,483991738,24,26506,5876342,26157,5815192,349,61150,11639,32,58307,6559,24,306,65000.0,1000.0,-41.0,-51.0,-43.0,-39.0,-45.0,-51.0,-44.0,-42.0,-83.0,-83.0,-80.0,-79.0,42.0,32.0,37.0,40.0,1
5887,92:69:1D:31:68:E9,3841375,487619924,3941,3627984,3837434,483991940,0,4885,1113321,4738,1080011,147,33310,2134,11,4154,90,0,46,216660.0,130000.0,-51.0,-47.0,-42.0,-50.0,-51.0,-47.0,-43.0,-49.0,-83.0,-83.0,-80.0,-79.0,32.0,36.0,38.0,29.0,1
5888,CC:2F:71:3F:1F:24,4684226,1402539800,846792,918547860,3837434,483991940,37,688846,728394284,688112,728306004,734,88280,663978,15,847049,89758,34,536,144444.0,43333.0,-70.0,-66.0,-68.0,-70.0,-69.0,-65.0,-67.0,-70.0,-83.0,-83.0,-80.0,-79.0,13.0,17.0,12.0,9.0,1
5889,CC:2F:71:3E:C5:1F,3838331,484101574,895,109432,3837436,483992142,0,3724,312922,3073,235660,651,77262,947,10,1283,22,0,44,144444.0,39000.0,-72.0,-71.0,-69.0,-61.0,-72.0,-72.0,-69.0,-61.0,-83.0,-83.0,-80.0,-79.0,11.0,12.0,11.0,18.0,1
5890,BA:8C:B9:54:50:24,3842284,490176243,4848,6184101,3837436,483992142,0,9077,1705039,9055,1701544,22,3495,2348,15,5297,39,0,60,229410.0,130000.0,-40.0,-37.0,-46.0,-52.0,-42.0,-36.0,-44.0,-50.0,-83.0,-83.0,-80.0,-79.0,43.0,46.0,34.0,27.0,1
5891,62:47:05:9D:EB:15,3837500,484004101,61,11697,3837439,483992404,0,164,16625,153,14459,11,2166,41,0,89,1,0,7,229410.0,137640.0,-46.0,-54.0,-50.0,-55.0,-47.0,-52.0,-51.0,-55.0,-83.0,-83.0,-80.0,-79.0,37.0,29.0,30.0,24.0,1
5892,3C:55:76:E8:8F:1F,3895678,629714167,58239,145721763,3837439,483992404,24,26509,5876548,26160,5815398,349,61150,11639,32,58307,6559,24,306,65000.0,1000.0,-42.0,-51.0,-42.0,-40.0,-43.0,-51.0,-43.0,-40.0,-83.0,-83.0,-80.0,-79.0,41.0,32.0,38.0,39.0,1
5893,92:69:1D:31:68:E9,3841381,487620661,3941,3627984,3837440,483992677,0,4885,1113321,4738,1080011,147,33310,2134,11,4154,90,0,46,216660.0,130000.0,-51.0,-47.0,-42.0,-50.0,-51.0,-47.0,-43.0,-49.0,-83.0,-83.0,-80.0,-79.0,32.0,36.0,38.0,29.0,1
5894,CC:2F:71:3F:1F:24,4684440,1402802137,847000,918809460,3837440,483992677,37,689046,728660508,688312,728572228,734,88280,664162,15,847257,89761,34,536,144444.0,43333.0,-69.0,-65.0,-67.0,-71.0,-69.0,-65.0,-67.0,-70.0,-83.0,-83.0,-80.0,-79.0,14.0,18.0,13.0,8.0,1
5895,CC:2F:71:3E:C5:1F,3838335,484102109,895,109432,3837440,483992677,0,3724,312922,3073,235660,651,77262,947,10,1283,22,0,44,144444.0,39000.0,-72.0,-71.0,-69.0,-61.0,-72.0,-72.0,-69.0,-61.0,-83.0,-83.0,-80.0,-79.0,11.0,12.0,11.0,18.0,1
5896,BA:8C:B9:54:50:24,3842288,490176778,4848,6184101,3837440,483992677,0,9078,1705107,9056,1701612,22,3495,2348,15,5297,39,0,60,229410.0,130000.0,-40.0,-37.0,-46.0,-52.0,-42.0,-36.0,-44.0,-50.0,-83.0,-83.0,-80.0,-79.0,43.0,46.0,34.0,27.0,1
5897,62:47:05:9D:EB:15,3837507,484004980,61,11697,3837446,483993283,0,164,16625,153,14459,11,2166,41,0,89,1,0,7,229410.0,137640.0,-46.0,-54.0,-50.0,-55.0,-47.0,-52.0,-51.0,-55.0,-83.0,-83.0,-80.0,-79.0,37.0,29.0,30.0,24.0,1
5898,3C:55:76:E8:8F:1F,3895685,629715046,58239,145721763,3837446,483993283,24,26509,5876548,26160,5815398,349,61150,11639,32,58307,6559,24,306,65000.0,1000.0,-42.0,-51.0,-42.0,-40.0,-43.0,-51.0,-43.0,-40.0,-83.0,-83.0,-80.0,-79.0,41.0,32.0,38.0,39.0,1
5899,92:69:1D:31:68:E9,3841387,487621267,3941,3627984,3837446,483993283,0,4885,1113321,4738,1080011,147,33310,2134,11,4154,90,0,46,216660.0,130000.0,-51.0,-47.0,-42.0,-50.0,-51.0,-47.0,-43.0,-49.0,-83.0,-83.0,-80.0,-79.0,32.0,36.0,38.0,29.0,1
5900,CC:2F:71:3F:1F:24,4684654,1403062919,847208,919069636,3837446,483993283,37,689240,728914346,688506,728826066,734,88280,664348,15,847465,89763,34,536,144444.0,43333.0,-70.0,-66.0,-68.0,-68.0,-70.0,-66.0,-67.0,-69.0,-83.0,-83.0,-80.0,-79.0,13.0,17.0,12.0,11.0,1
5901,CC:2F:71:3E:C5:1F,3838341,484102715,895,109432,3837446,483993283,0,3724,312922,3073,235660,651,77262,947,10,1283,22,0,44,144444.0,39000.0,-72.0,-71.0,-69.0,-61.0,-72.0,-72.0,-69.0,-61.0,-83.0,-83.0,-80.0,-79.0,11.0,12.0,11.0,18.0,1
5902,BA:8C:B9:54:50:24,3842296,490177586,4848,6184101,3837448,483993485,0,9078,1705107,9056,1701612,22,3495,2348,15,5297,39,0,60,229410.0,130000.0,-40.0,-37.0,-46.0,-52.0,-42.0,-36.0,-44.0,-50.0,-83.0,-83.0,-80.0,-79.0,43.0,46.0,34.0,27.0,1
5903,62:47:05:9D:EB:15,3837509,484005182,61,11697,3837448,483993485,0,164,16625,153,14459,11,2166,41,0,89,1,0,7,229410.0,137640.0,-46.0,-54.0,-50.0,-55.0,-47.0,-52.0,-51.0,-55.0,-83.0,-83.0,-80.0,-79.0,37.0,29.0,30.0,24.0,1
5904,3C:55:76:E8:8F:1F,3895688,629715308,58239,145721763,3837449,483993545,24,26509,5876548,26160,5815398,349,61150,11639,32,58307,6559,24,306,65000.0,1000.0,-42.0,-51.0,-42.0,-40.0,-43.0,-51.0,-43.0,-40.0,-83.0,-83.0,-80.0,-79.0,41.0,32.0,38.0,39.0,1
5905,92:69:1D:31:68:E9,3841390,487621529,3941,3627984,3837449,483993545,0,4885,1113321,4738,1080011,147,33310,2134,11,4154,90,0,46,216660.0,130000.0,-51.0,-47.0,-42.0,-50.0,-51.0,-47.0,-43.0,-49.0,-83.0,-83.0,-80.0,-79.0,32.0,36.0,38.0,29.0,1
5906,CC:2F:71:3F:1F:24,4684864,1403324651,847415,919331106,3837449,483993545,37,689429,729163220,688695,729074940,734,88280,664532,15,847672,89765,34,536,144444.0,43333.0,-70.0,-66.0,-67.0,-71.0,-69.0,-65.0,-67.0,-69.0,-83.0,-83.0,-80.0,-79.0,13.0,17.0,13.0,8.0,1
5907,CC:2F:71:3E:C5:1F,3838344,484102977,895,109432,3837449,483993545,0,3724,312922,3073,235660,651,77262,947,10,1283,22,0,44,144444.0,39000.0,-72.0,-71.0,-69.0,-61.0,-72.0,-72.0,-69.0,-61.0,-83.0,-83.0,-80.0,-79.0,11.0,12.0,11.0,18.0,1
5908,BA:8C:B9:54:50:24,3842297,490177646,4848,6184101,3837449,483993545,0,9078,1705107,9056,1701612,22,3495,2348,15,5297,39,0,60,229410.0,130000.0,-40.0,-37.0,-46.0,-52.0,-42.0,-36.0,-44.0,-50.0,-83.0,-83.0,-80.0,-79.0,43.0,46.0,34.0,27.0,1
5909,62:47:05:9D:EB:15,3837517,484005910,61,11697,3837456,483994213,0,164,16625,153,14459,11,2166,41,0,89,1,0,7,229410.0,137640.0,-46.0,-54.0,-50.0,-55.0,-47.0,-52.0,-51.0,-55.0,-83.0,-83.0,-80.0,-79.0,37.0,29.0,30.0,24.0,1
5910,3C:55:76:E8:8F:1F,3895697,629716178,58239,145721763,3837458,483994415,24,26509,5876548,26160,5815398,349,61150,11639,32,58307,6559,24,306,65000.0,1000.0,-42.0,-51.0,-42.0,-40.0,-43.0,-51.0,-43.0,-40.0,-83.0,-83.0,-80.0,-79.0,41.0,32.0,38.0,39.0,1
5911,92:69:1D:31:68:E9,3841399,487622399,3941,3627984,3837458,483994415,0,4885,1113321,4738,1080011,147,33310,2134,11,4154,90,0,46,216660.0,130000.0,-51.0,-47.0,-42.0,-50.0,-51.0,-47.0,-43.0,-49.0,-83.0,-83.0,-80.0,-79.0,32.0,36.0,38.0,29.0,1
5912,CC:2F:71:3F:1F:24,4685089,1403590722,847631,919596307,3837458,483994415,37,689630,729424015,688896,729335735,734,88280,664723,15,847888,89766,34,536,144444.0,43333.0,-70.0,-66.0,-67.0,-71.0,-70.0,-65.0,-67.0,-70.0,-83.0,-83.0,-80.0,-79.0,13.0,17.0,13.0,8.0,1
5913,CC:2F:71:3E:C5:1F,3838353,484103847,895,109432,3837458,483994415,0,3726,313110,3074,235730,652,77380,948,10,1283,22,0,44,144444.0,39000.0,-72.0,-71.0,-70.0,-61.0,-71.0,-71.0,-69.0,-60.0,-83.0,-83.0,-80.0,-79.0,11.0,12.0,10.0,18.0,1
5914,BA:8C:B9:54:50:24,3842306,490178516,4848,6184101,3837458,483994415,0,9078,1705107,9056,1701612,22,3495,2348,15,5297,39,0,60,229410.0,130000.0,-40.0,-37.0,-46.0,-52.0,-42.0,-36.0,-44.0,-50.0,-83.0,-83.0,-80.0,-79.0,43.0,46.0,34.0,27.0,1
5915,62:47:05:9D:EB:15,3837519,484006112,61,11697,3837458,483994415,0,164,16625,153,14459,11,2166,41,0,89,1,0,7,229410.0,137640.0,-46.0,-54.0,-50.0,-55.0,-47.0,-52.0,-51.0,-55.0,-83.0,-83.0,-80.0,-79.0,37.0,29.0,30.0,24.0,1
5916,3C:55:76:E8:8F:1F,3895697,629716178,58239,145721763,3837458,483994415,24,26509,5876548,26160,5815398,349,61150,11639,32,58307,6559,24,306,65000.0,1000.0,-42.0,-51.0,-42.0,-40.0,-43.0,-51.0,-43.0,-40.0,-83.0,-83.0,-80.0,-79.0,41.0,32.0,38.0,39.0,1
5917,92:69:1D:31:68:E9,3841399,487622399,3941,3627984,3837458,483994415,0,4885,1113321,4738,1080011,147,33310,2134,11,4154,90,0,46,216660.0,130000.0,-51.0,-47.0,-42.0,-50.0,-51.0,-47.0,-43.0,-49.0,-83.0,-83.0,-80.0,-79.0,32.0,36.0,38.0,29.0,1
5918,CC:2F:71:3F:1F:24,4685299,1403855430,847841,919861015,3837458,483994415,37,689824,729684903,689090,729596623,734,88280,664909,15,848098,89767,34,536,144444.0,43333.0,-70.0,-66.0,-67.0,-71.0,-69.0,-65.0,-67.0,-70.0,-83.0,-83.0,-80.0,-79.0,13.0,17.0,13.0,8.0,1
5919,CC:2F:71:3E:C5:1F,3838357,484104173,895,109432,3837462,483994741,0,3726,313110,3074,235730,652,77380,948,10,1283,22,0,44,144444.0,39000.0,-72.0,-71.0,-70.0,-61.0,-71.0,-71.0,-69.0,-60.0,-83.0,-83.0,-80.0,-79.0,11.0,12.0,10.0,18.0,1
5920,BA:8C:B9:54:50:24,3842310,490178842,4848,6184101,3837462,483994741,0,9078,1705107,9056,1701612,22,3495,2348,15,5297,39,0,60,229410.0,130000.0,-40.0,-37.0,-46.0,-52.0,-42.0,-36.0,-44.0,-50.0,-83.0,-83.0,-80.0,-79.0,43.0,46.0,34.0,27.0,1
5921,62:47:05:9D:EB:15,3837530,484007104,61,11697,3837469,483995407,0,164,16625,153,14459,11,2166,41,0,89,1,0,7,229410.0,137640.0,-46.0,-54.0,-50.0,-55.0,-47.0,-52.0,-51.0,-55.0,-83.0,-83.0,-80.0,-79.0,37.0,29.0,30.0,24.0,1
5922,3C:55:76:E8:8F:1F,3895709,629717344,58240,145721937,3837469,483995407,24,26527,5877956,26177,5816688,350,61268,11642,32,58308,6559,24,307,65000.0,16250.0,-44.0,-52.0,-44.0,-42.0,-43.0,-51.0,-43.0,-41.0,-83.0,-83.0,-80.0,-79.0,39.0,31.0,36.0,37.0,1
5923,92:69:1D:31:68:E9,3841410,487623391,3941,3627984,3837469,483995407,0,4885,1113321,4738,1080011,147,33310,2134,11,4154,90,0,46,216660.0,130000.0,-51.0,-47.0,-42.0,-50.0,-51.0,-47.0,-43.0,-49.0,-83.0,-83.0,-80.0,-79.0,32.0,36.0,38.0,29.0,1
5924,CC:2F:71:3F:1F:24,4685519,1404119576,848050,920124169,3837469,483995407,37,690018,729940153,689283,729851755,735,88398,665096,15,848307,89774,34,536,144444.0,43333.0,-70.0,-66.0,-67.0,-71.0,-69.0,-65.0,-67.0,-70.0,-83.0,-83.0,-80.0,-79.0,13.0,17.0,13.0,8.0,1
5925,CC:2F:71:3E:C5:1F,3838364,484104839,895,109432,3837469,483995407,0,3726,313110,3074,235730,652,77380,948,10,1283,22,0,44,144444.0,39000.0,-72.0,-71.0,-70.0,-61.0,-71.0,-71.0,-69.0,-60.0,-83.0,-83.0,-80.0,-79.0,11.0,12.0,10.0,18.0,1
5926,BA:8C:B9:54:50:24,3842317,490179508,4848,6184101,3837469,483995407,0,9078,1705107,9056,1701612,22,3495,2348,15,5297,39,0,60,229410.0,130000.0,-40.0,-37.0,-46.0,-52.0,-42.0,-36.0,-44.0,-50.0,-83.0,-83.0,-80.0,-79.0,43.0,46.0,34.0,27.0,1
5927,62:47:05:9D:EB:15,3837532,484007306,61,11697,3837471,483995609,0,164,16625,153,14459,11,2166,41,0,89,1,0,7,229410.0,137640.0,-46.0,-54.0,-50.0,-55.0,-47.0,-52.0,-51.0,-55.0,-83.0,-83.0,-80.0,-79.0,37.0,29.0,30.0,24.0,1
5928,3C:55:76:E8:8F:1F,3895711,629717546,58240,145721937,3837471,483995609,24,26527,5877956,26177,5816688,350,61268,11642,32,58308,6559,24,307,65000.0,16250.0,-44.0,-52.0,-44.0,-42.0,-43.0,-51.0,-43.0,-41.0,-83.0,-83.0,-80.0,-79.0,39.0,31.0,36.0,37.0,1
5929,92:69:1D:31:68:E9,3841412,487623593,3941,3627984,3837471,483995609,0,4885,1113321,4738,1080011,147,33310,2134,11,4154,90,0,46,216660.0,130000.0,-51.0,-47.0,-42.0,-50.0,-51.0,-47.0,-43.0,-49.0,-83.0,-83.0,-80.0,-79.0,32.0,36.0,38.0,29.0,1
5930,CC:2F:71:3F:1F:24,4685728,1404379824,848257,920384215,3837471,483995609,37,690205,730187357,689470,730098959,735,88398,665279,15,848514,89775,34,536,144444.0,43333.0,-70.0,-66.0,-68.0,-71.0,-69.0,-66.0,-67.0,-70.0,-83.0,-83.0,-80.0,-79.0,13.0,17.0,12.0,8.0,1
5931,CC:2F:71:3E:C5:1F,3838366,484105041,895,109432,3837471,483995609,0,3726,313110,3074,235730,652,77380,948,10,1283,22,0,44,144444.0,39000.0,-72.0,-71.0,-70.0,-61.0,-71.0,-71.0,-69.0,-60.0,-83.0,-83.0,-80.0,-79.0,11.0,12.0,10.0,18.0,1
5932,BA:8C:B9:54:50:24,3842321,490179912,4848,6184101,3837473,483995811,0,9078,1705107,9056,1701612,22,3495,2348,15,5297,39,0,60,229410.0,130000.0,-40.0,-37.0,-46.0,-52.0,-42.0,-36.0,-44.0,-50.0,-83.0,-83.0,-80.0,-79.0,43.0,46.0,34.0,27.0,1
5933,62:47:05:9D:EB:15,3837539,484007972,61,11697,3837478,483996275,0,164,16625,153,14459,11,2166,41,0,89,1,0,7,229410.0,137640.0,-46.0,-54.0,-50.0,-55.0,-47.0,-52.0,-51.0,-55.0,-83.0,-83.0,-80.0,-79.0,37.0,29.0,30.0,24.0,1
5934,3C:55:76:E8:8F:1F,3895719,629718322,58241,145722047,3837478,483996275,24,26541,5879043,26191,5817775,350,61268,11644,32,58309,6559,24,307,65000.0,1000.0,-50.0,-52.0,-45.0,-45.0,-49.0,-51.0,-44.0,-45.0,-83.0,-83.0,-80.0,-79.0,33.0,31.0,35.0,34.0,1
5935,92:69:1D:31:68:E9,3841419,487624259,3941,3627984,3837478,483996275,0,4887,1113457,4740,1080147,147,33310,2134,11,4155,90,0,46,216660.0,130000.0,-51.0,-48.0,-45.0,-49.0,-51.0,-47.0,-43.0,-49.0,-83.0,-83.0,-80.0,-79.0,32.0,35.0,35.0,30.0,1
5936,CC:2F:71:3F:1F:24,4685950,1404646985,848472,920650710,3837478,483996275,37,690403,730437895,689668,730349497,735,88398,665473,15,848729,89777,34,536,144444.0,43333.0,-70.0,-66.0,-68.0,-70.0,-70.0,-66.0,-67.0,-69.0,-83.0,-83.0,-80.0,-79.0,13.0,17.0,12.0,9.0,1
5937,CC:2F:71:3E:C5:1F,3838373,484105707,895,109432,3837478,483996275,0,3726,313110,3074,235730,652,77380,948,10,1283,22,0,44,144444.0,39000.0,-72.0,-71.0,-70.0,-61.0,-71.0,-71.0,-69.0,-60.0,-83.0,-83.0,-80.0,-79.0,11.0,12.0,10.0,18.0,1
5938,BA:8C:B9:54:50:24,3842326,490180376,4848,6184101,3837478,483996275,0,9080,1705243,9058,1701748,22,3495,2348,15,5298,39,0,60,229410.0,130000.0,-48.0,-35.0,-42.0,-45.0,-44.0,-36.0,-43.0,-48.0,-83.0,-83.0,-80.0,-79.0,35.0,48.0,38.0,34.0,1
5939,62:47:05:9D:EB:15,3837541,484008174,61,11697,3837480,483996477,0,166,16761,155,14595,11,2166,41,0,90,1,0,8,229410.0,137640.0,-46.0,-55.0,-51.0,-56.0,-47.0,-54.0,-51.0,-56.0,-83.0,-83.0,-80.0,-79.0,37.0,28.0,29.0,23.0,1
5940,3C:55:76:E8:8F:1F,3895723,629718726,58241,145722047,3837482,483996679,24,26541,5879043,26191,5817775,350,61268,11644,32,58309,6559,24,307,65000.0,1000.0,-50.0,-52.0,-45.0,-45.0,-49.0,-51.0,-44.0,-45.0,-83.0,-83.0,-80.0,-79.0,33.0,31.0,35.0,34.0,1
5941,92:69:1D:31:68:E9,3841423,487624663,3941,3627984,3837482,483996679,0,4887,1113457,4740,1080147,147,33310,2134,11,4155,90,0,46,216660.0,130000.0,-51.0,-48.0,-45.0,-49.0,-51.0,-47.0,-43.0,-49.0,-83.0,-83.0,-80.0,-79.0,32.0,35.0,35.0,30.0,1
5942,CC:2F:71:3F:1F:24,4686163,1404910543,848681,920913864,3837482,483996679,37,690593,730688281,689858,730599883,735,88398,665660,15,848938,89783,34,536,144444.0,43333.0,-69.0,-66.0,-68.0,-70.0,-69.0,-66.0,-67.0,-70.0,-83.0,-83.0,-80.0,-79.0,14.0,17.0,12.0,9.0,1
5943,CC:2F:71:3E:C5:1F,3838377,484106111,895,109432,3837482,483996679,0,3726,313110,3074,235730,652,77380,948,10,1283,22,0,44,144444.0,39000.0,-72.0,-71.0,-70.0,-61.0,-71.0,-71.0,-69.0,-60.0,-83.0,-83.0,-80.0,-79.0,11.0,12.0,10.0,18.0,1
5944,BA:8C:B9:54:50:24,3842333,490181044,4848,6184101,3837485,483996943,0,9080,1705243,9058,1701748,22,3495,2348,15,5298,39,0,60,229410.0,130000.0,-48.0,-35.0,-42.0,-45.0,-44.0,-36.0,-43.0,-48.0,-83.0,-83.0,-80.0,-79.0,35.0,48.0,38.0,34.0,1
5945,62:47:05:9D:EB:15,3837548,484008842,61,11697,3837487,483997145,0,166,16761,155,14595,11,2166,41,0,90,1,0,8,229410.0,137640.0,-46.0,-55.0,-51.0,-56.0,-47.0,-54.0,-51.0,-56.0,-83.0,-83.0,-80.0,-79.0,37.0,28.0,29.0,23.0,1
5946,3C:55:76:E8:8F:1F,3895732,629719686,58244,145722481,3837488,483997205,24,26559,5881976,26208,5820590,351,61386,11650,32,58312,6559,24,308,65000.0,16250.0,-44.0,-52.0,-44.0,-42.0,-44.0,-52.0,-43.0,-42.0,-83.0,-83.0,-80.0,-79.0,39.0,31.0,36.0,37.0,1
5947,92:69:1D:31:68:E9,3841429,487625189,3941,3627984,3837488,483997205,0,4887,1113457,4740,1080147,147,33310,2134,11,4155,90,0,46,216660.0,130000.0,-51.0,-48.0,-45.0,-49.0,-51.0,-47.0,-43.0,-49.0,-83.0,-83.0,-80.0,-79.0,32.0,35.0,35.0,30.0,1
5948,CC:2F:71:3F:1F:24,4686379,1405177201,848891,921179996,3837488,483997205,37,690790,730944121,690055,730855723,735,88398,665847,15,849148,89784,34,536,144444.0,43333.0,-69.0,-66.0,-67.0,-70.0,-69.0,-66.0,-67.0,-70.0,-83.0,-83.0,-80.0,-79.0,14.0,17.0,13.0,9.0,1
5949,CC:2F:71:3E:C5:1F,3838383,484106637,895,109432,3837488,483997205,0,3726,313110,3074,235730,652,77380,948,10,1283,22,0,44,144444.0,39000.0,-72.0,-71.0,-70.0,-61.0,-71.0,-71.0,-69.0,-60.0,-83.0,-83.0,-80.0,-79.0,11.0,12.0,10.0,18.0,1
5950,BA:8C:B9:54:50:24,3842336,490181306,4848,6184101,3837488,483997205,0,9080,1705243,9058,1701748,22,3495,2348,15,5298,39,0,60,229410.0,130000.0,-48.0,-35.0,-42.0,-45.0,-44.0,-36.0,-43.0,-48.0,-83.0,-83.0,-80.0,-79.0,35.0,48.0,38.0,34.0,1
5951,62:47:05:9D:EB:15,3837553,484009306,61,11697,3837492,483997609,0,166,16761,155,14595,11,2166,41,0,90,1,0,8,229410.0,137640.0,-46.0,-55.0,-51.0,-56.0,-47.0,-54.0,-51.0,-56.0,-83.0,-83.0,-80.0,-79.0,37.0,28.0,29.0,23.0,1
5952,3C:55:76:E8:8F:1F,3895738,629720292,58244,145722481,3837494,483997811,24,26559,5881976,26208,5820590,351,61386,11650,32,58312,6559,24,308,65000.0,16250.0,-44.0,-52.0,-44.0,-42.0,-44.0,-52.0,-43.0,-42.0,-83.0,-83.0,-80.0,-79.0,39.0,31.0,36.0,37.0,1
5953,92:69:1D:31:68:E9,3841435,487625795,3941,3627984,3837494,483997811,0,4887,1113457,4740,1080147,147,33310,2134,11,4155,90,0,46,216660.0,130000.0,-51.0,-48.0,-45.0,-49.0,-51.0,-47.0,-43.0,-49.0,-83.0,-83.0,-80.0,-79.0,32.0,35.0,35.0,30.0,1
5954,CC:2F:71:3F:1F:24,4686602,1405441656,849106,921443643,3837496,483998013,37,690999,731205934,690264,731117536,735,88398,666043,15,849363,89789,34,536,144444.0,43333.0,-69.0,-66.0,-68.0,-71.0,-69.0,-66.0,-67.0,-70.0,-83.0,-83.0,-80.0,-79.0,14.0,17.0,12.0,8.0,1
5955,CC:2F:71:3E:C5:1F,3838391,484107445,895,109432,3837496,483998013,0,3726,313110,3074,235730,652,77380,948,10,1283,22,0,44,144444.0,39000.0,-72.0,-71.0,-70.0,-61.0,-71.0,-71.0,-69.0,-60.0,-83.0,-83.0,-80.0,-79.0,11.0,12.0,10.0,18.0,1
5956,BA:8C:B9:54:50:24,3842344,490182114,4848,6184101,3837496,483998013,0,9080,1705243,9058,1701748,22,3495,2348,15,5298,39,0,60,229410.0,130000.0,-48.0,-35.0,-42.0,-45.0,-44.0,-36.0,-43.0,-48.0,-83.0,-83.0,-80.0,-79.0,35.0,48.0,38.0,34.0,1
5957,62:47:05:9D:EB:15,3837557,484009710,61,11697,3837496,483998013,0,166,16761,155,14595,11,2166,41,0,90,1,0,8,229410.0,137640.0,-46.0,-55.0,-51.0,-56.0,-47.0,-54.0,-51.0,-56.0,-83.0,-83.0,-80.0,-79.0,37.0,28.0,29.0,23.0,1
5958,3C:55:76:E8:8F:1F,3895740,629720494,58244,145722481,3837496,483998013,24,26559,5881976,26208,5820590,351,61386,11650,32,58312,6559,24,308,65000.0,16250.0,-44.0,-52.0,-44.0,-42.0,-44.0,-52.0,-43.0,-42.0,-83.0,-83.0,-80.0,-79.0,39.0,31.0,36.0,37.0,1
5959,92:69:1D:31:68:E9,3841437,487625997,3941,3627984,3837496,483998013,0,4887,1113457,4740,1080147,147,33310,2134,11,4155,90,0,46,216660.0,130000.0,-51.0,-48.0,-45.0,-49.0,-51.0,-47.0,-43.0,-49.0,-83.0,-83.0,-80.0,-79.0,32.0,35.0,35.0,30.0,1
5960,CC:2F:71:3F:1F:24,4686812,1405704940,849316,921706927,3837496,483998013,37,691189,731456334,690454,731367936,735,88398,666229,15,849573,89792,34,536,144444.0,43333.0,-70.0,-66.0,-68.0,-70.0,-69.0,-65.0,-67.0,-70.0,-83.0,-83.0,-80.0,-79.0,13.0,17.0,12.0,9.0,1
5961,CC:2F:71:3E:C5:1F,3838393,484107647,895,109432,3837498,483998215,0,3726,313110,3074,235730,652,77380,948,10,1283,22,0,44,144444.0,39000.0,-72.0,-71.0,-70.0,-61.0,-71.0,-71.0,-69.0,-60.0,-83.0,-83.0,-80.0,-79.0,11.0,12.0,10.0,18.0,1
5962,BA:8C:B9:54:50:24,3842347,490182376,4848,6184101,3837499,483998275,0,9080,1705243,9058,1701748,22,3495,2348,15,5298,39,0,60,229410.0,130000.0,-48.0,-35.0,-42.0,-45.0,-44.0,-36.0,-43.0,-48.0,-83.0,-83.0,-80.0,-79.0,35.0,48.0,38.0,34.0,1
5963,62:47:05:9D:EB:15,3837567,484010851,61,11697,3837506,483999154,0,166,16761,155,14595,11,2166,41,0,90,1,0,8,229410.0,137640.0,-46.0,-55.0,-51.0,-56.0,-47.0,-54.0,-51.0,-56.0,-83.0,-83.0,-80.0,-79.0,37.0,28.0,29.0,23.0,1
5964,3C:55:76:E8:8F:1F,3895750,629721635,58244,145722481,3837506,483999154,24,26559,5881976,26208,5820590,351,61386,11650,32,58312,6559,24,308,65000.0,16250.0,-44.0,-52.0,-44.0,-42.0,-44.0,-52.0,-43.0,-42.0,-83.0,-83.0,-80.0,-79.0,39.0,31.0,36.0,37.0,1
5965,92:69:1D:31:68:E9,3841447,487627138,3941,3627984,3837506,483999154,0,4887,1113457,4740,1080147,147,33310,2134,11,4155,90,0,46,216660.0,130000.0,-51.0,-48.0,-45.0,-49.0,-51.0,-47.0,-43.0,-49.0,-83.0,-83.0,-80.0,-79.0,32.0,35.0,35.0,30.0,1
5966,CC:2F:71:3F:1F:24,4687032,1405972045,849526,921972891,3837506,483999154,37,691383,731712908,690648,731624510,735,88398,666418,15,849783,89798,34,536,144444.0,43333.0,-70.0,-66.0,-68.0,-71.0,-69.0,-66.0,-67.0,-70.0,-83.0,-83.0,-80.0,-79.0,13.0,17.0,12.0,8.0,1
5967,CC:2F:71:3E:C5:1F,3838401,484108586,895,109432,3837506,483999154,0,3726,313110,3074,235730,652,77380,948,10,1283,22,0,44,144444.0,39000.0,-72.0,-71.0,-70.0,-61.0,-71.0,-71.0,-69.0,-60.0,-83.0,-83.0,-80.0,-79.0,11.0,12.0,10.0,18.0,1
5968,BA:8C:B9:54:50:24,3842354,490183255,4848,6184101,3837506,483999154,0,9080,1705243,9058,1701748,22,3495,2348,15,5298,39,0,60,229410.0,130000.0,-48.0,-35.0,-42.0,-45.0,-44.0,-36.0,-43.0,-48.0,-83.0,-83.0,-80.0,-79.0,35.0,48.0,38.0,34.0,1
5969,62:47:05:9D:EB:15,3837569,484011053,61,11697,3837508,483999356,0,166,16761,155,14595,11,2166,41,0,90,1,0,8,229410.0,137640.0,-46.0,-55.0,-51.0,-56.0,-47.0,-54.0,-51.0,-56.0,-83.0,-83.0,-80.0,-79.0,37.0,28.0,29.0,23.0,1
5970,3C:55:76:E8:8F:1F,3895753,629721967,58245,145722611,3837508,483999356,24,26569,5882695,26218,5821309,351,61386,11651,32,58313,6560,24,308,65000.0,16250.0,-43.0,-51.0,-44.0,-42.0,-43.0,-50.0,-43.0,-41.0,-83.0,-83.0,-80.0,-79.0,40.0,32.0,36.0,37.0,1
5971,92:69:1D:31:68:E9,3841449,487627340,3941,3627984,3837508,483999356,0,4887,1113457,4740,1080147,147,33310,2134,11,4155,90,0,46,216660.0,130000.0,-51.0,-48.0,-45.0,-49.0,-51.0,-47.0,-43.0,-49.0,-83.0,-83.0,-80.0,-79.0,32.0,35.0,35.0,30.0,1
5972,CC:2F:71:3F:1F:24,4687247,1406238755,849739,922239399,3837508,483999356,37,691579,731972580,690844,731884182,735,88398,666607,15,849996,89804,34,536,144444.0,43333.0,-69.0,-66.0,-67.0,-71.0,-69.0,-66.0,-67.0,-70.0,-83.0,-83.0,-80.0,-79.0,14.0,17.0,13.0,8.0,1
5973,CC:2F:71:3E:C5:1F,3838403,484108788,895,109432,3837508,483999356,0,3726,313110,3074,235730,652,77380,948,10,1283,22,0,44,144444.0,39000.0,-72.0,-71.0,-70.0,-61.0,-71.0,-71.0,-69.0,-60.0,-83.0,-83.0,-80.0,-79.0,11.0,12.0,10.0,18.0,1
5974,BA:8C:B9:54:50:24,3842358,490183659,4848,6184101,3837510,483999558,0,9080,1705243,9058,1701748,22,3495,2348,15,5298,39,0,60,229410.0,130000.0,-48.0,-35.0,-42.0,-45.0,-44.0,-36.0,-43.0,-48.0,-83.0,-83.0,-80.0,-79.0,35.0,48.0,38.0,34.0,1
5975,62:47:05:9D:EB:15,3837576,484011719,61,11697,3837515,484000022,0,166,16761,155,14595,11,2166,41,0,90,1,0,8,229410.0,137640.0,-46.0,-55.0,-51.0,-56.0,-47.0,-54.0,-51.0,-56.0,-83.0,-83.0,-80.0,-79.0,37.0,28.0,29.0,23.0,1
5976,3C:55:76:E8:8F:1F,3896205,630893284,58690,146893262,3837515,484000022,24,26667,5899904,26316,5838518,351,61386,11699,32,58705,6560,24,312,73120.0,24370.0,-50.0,-51.0,-44.0,-44.0,-48.0,-53.0,-45.0,-45.0,-83.0,-83.0,-80.0,-79.0,33.0,32.0,36.0,35.0,1
5977,92:69:1D:31:68:E9,3841456,487628006,3941,3627984,3837515,484000022,0,4887,1113457,4740,1080147,147,33310,2134,11,4155,90,0,46,216660.0,130000.0,-51.0,-48.0,-45.0,-49.0,-51.0,-47.0,-43.0,-49.0,-83.0,-83.0,-80.0,-79.0,32.0,35.0,35.0,30.0,1
5978,CC:2F:71:3F:1F:24,4687521,1406583956,850006,922583934,3837515,484000022,37,691834,732309609,691099,732221211,735,88398,666855,15,850261,89818,34,537,144444.0,43333.0,-69.0,-66.0,-68.0,-70.0,-69.0,-65.0,-67.0,-70.0,-83.0,-83.0,-80.0,-79.0,14.0,17.0,12.0,9.0,1
5979,CC:2F:71:3E:C5:1F,3838410,484109454,895,109432,3837515,484000022,0,3726,313110,3074,235730,652,77380,948,10,1283,22,0,44,144444.0,39000.0,-72.0,-71.0,-70.0,-61.0,-71.0,-71.0,-69.0,-60.0,-83.0,-83.0,-80.0,-79.0,11.0,12.0,10.0,18.0,1
5980,BA:8C:B9:54:50:24,3842365,490184325,4848,6184101,3837517,484000224,0,9080,1705243,9058,1701748,22,3495,2348,15,5298,39,0,60,229410.0,130000.0,-48.0,-35.0,-42.0,-45.0,-44.0,-36.0,-43.0,-48.0,-83.0,-83.0,-80.0,-79.0,35.0,48.0,38.0,34.0,1
5981,62:47:05:9D:EB:15,3837584,484012527,61,11697,3837523,484000830,0,166,16761,155,14595,11,2166,41,0,90,1,0,8,229410.0,137640.0,-46.0,-55.0,-51.0,-56.0,-47.0,-54.0,-51.0,-56.0,-83.0,-83.0,-80.0,-79.0,37.0,28.0,29.0,23.0,1
5982,3C:55:76:E8:8F:1F,3897460,634188313,59937,150187483,3837523,484000830,24,26991,5945469,26640,5884083,351,61386,11904,33,60005,6573,24,335,114700.0,68820.0,-48.0,-54.0,-46.0,-46.0,-48.0,-53.0,-45.0,-45.0,-83.0,-83.0,-80.0,-79.0,35.0,29.0,34.0,33.0,1
5983,92:69:1D:31:68:E9,3841464,487628814,3941,3627984,3837523,484000830,0,4887,1113457,4740,1080147,147,33310,2134,11,4155,90,0,46,216660.0,130000.0,-51.0,-48.0,-45.0,-49.0,-51.0,-47.0,-43.0,-49.0,-83.0,-83.0,-80.0,-79.0,32.0,35.0,35.0,30.0,1
5984,CC:2F:71:3F:1F:24,4687793,1406929180,850270,922928350,3837523,484000830,37,692084,732648627,691349,732560229,735,88398,667094,15,850527,89845,34,537,144444.0,43333.0,-69.0,-66.0,-68.0,-70.0,-69.0,-66.0,-67.0,-70.0,-83.0,-83.0,-80.0,-79.0,14.0,17.0,12.0,9.0,1
5985,CC:2F:71:3E:C5:1F,3838418,484110262,895,109432,3837523,484000830,0,3726,313110,3074,235730,652,77380,948,10,1283,22,0,44,144444.0,39000.0,-72.0,-71.0,-70.0,-61.0,-71.0,-71.0,-69.0,-60.0,-83.0,-83.0,-80.0,-79.0,11.0,12.0,10.0,18.0,1
5986,BA:8C:B9:54:50:24,3842372,490184991,4848,6184101,3837524,484000890,0,9080,1705243,9058,1701748,22,3495,2348,15,5298,39,0,60,229410.0,130000.0,-48.0,-35.0,-42.0,-45.0,-44.0,-36.0,-43.0,-48.0,-83.0,-83.0,-80.0,-79.0,35.0,48.0,38.0,34.0,1
5987,62:47:05:9D:EB:15,3837588,484012915,61,11697,3837527,484001218,0,166,16761,155,14595,11,2166,41,0,90,1,0,8,229410.0,137640.0,-46.0,-55.0,-51.0,-56.0,-47.0,-54.0,-51.0,-56.0,-83.0,-83.0,-80.0,-79.0,37.0,28.0,29.0,23.0,1
5988,3C:55:76:E8:8F:1F,3897588,634512691,60061,150511473,3837527,484001218,24,27047,5951664,26696,5890278,351,61386,11937,33,60131,6579,24,335,77420.0,25800.0,-50.0,-53.0,-45.0,-45.0,-49.0,-54.0,-45.0,-45.0,-83.0,-83.0,-80.0,-79.0,33.0,30.0,35.0,34.0,1
5989,92:69:1D:31:68:E9,3841468,487629202,3941,3627984,3837527,484001218,0,4887,1113457,4740,1080147,147,33310,2134,11,4155,90,0,46,216660.0,130000.0,-51.0,-48.0,-45.0,-49.0,-51.0,-47.0,-43.0,-49.0,-83.0,-83.0,-80.0,-79.0,32.0,35.0,35.0,30.0,1
5990,CC:2F:71:3F:1F:24,4688008,1407191558,850481,923190340,3837527,484001218,37,692274,732899097,691539,732810699,735,88398,667280,15,850738,89858,34,537,144444.0,43333.0,-69.0,-66.0,-67.0,-71.0,-69.0,-66.0,-67.0,-70.0,-83.0,-83.0,-80.0,-79.0,14.0,17.0,13.0,8.0,1
5991,CC:2F:71:3E:C5:1F,3838424,484110852,895,109432,3837529,484001420,0,3726,313110,3074,235730,652,77380,948,10,1283,22,0,44,144444.0,39000.0,-72.0,-71.0,-70.0,-61.0,-71.0,-71.0,-69.0,-60.0,-83.0,-83.0,-80.0,-79.0,11.0,12.0,10.0,18.0,1
5992,BA:8C:B9:54:50:24,3842379,490185807,4850,6184387,3837529,484001420,0,9087,1705851,9065,1702356,22,3495,2350,15,5300,39,0,60,229410.0,130000.0,-48.0,-35.0,-43.0,-46.0,-45.0,-37.0,-45.0,-49.0,-83.0,-83.0,-80.0,-79.0,35.0,48.0,37.0,33.0,1
5993,62:47:05:9D:EB:15,3837594,484013521,61,11697,3837533,484001824,0,166,16761,155,14595,11,2166,41,0,90,1,0,8,229410.0,137640.0,-46.0,-55.0,-51.0,-56.0,-47.0,-54.0,-51.0,-56.0,-83.0,-83.0,-80.0,-79.0,37.0,28.0,29.0,23.0,1
5994,3C:55:76:E8:8F:1F,3897601,634517375,60068,150515551,3837533,484001824,24,27075,5958292,26724,5896906,351,61386,11946,33,60138,6579,24,335,77420.0,25800.0,-50.0,-53.0,-44.0,-45.0,-49.0,-52.0,-44.0,-44.0,-83.0,-83.0,-80.0,-79.0,33.0,30.0,36.0,34.0,1
5995,92:69:1D:31:68:E9,3841474,487629808,3941,3627984,3837533,484001824,0,4887,1113457,4740,1080147,147,33310,2134,11,4155,90,0,46,216660.0,130000.0,-51.0,-48.0,-45.0,-49.0,-51.0,-47.0,-43.0,-49.0,-83.0,-83.0,-80.0,-79.0,32.0,35.0,35.0,30.0,1
5996,CC:2F:71:3F:1F:24,4688244,1407461100,850711,923459276,3837533,484001824,37,692494,733165958,691759,733077560,735,88398,667485,15,850968,89862,34,537,144444.0,43333.0,-69.0,-66.0,-67.0,-71.0,-68.0,-66.0,-67.0,-70.0,-83.0,-83.0,-80.0,-79.0,14.0,17.0,13.0,8.0,1
5997,CC:2F:71:3E:C5:1F,3838428,484111256,895,109432,3837533,484001824,0,3726,313110,3074,235730,652,77380,948,10,1283,22,0,44,144444.0,39000.0,-72.0,-71.0,-70.0,-61.0,-71.0,-71.0,-69.0,-60.0,-83.0,-83.0,-80.0,-79.0,11.0,12.0,10.0,18.0,1
5998,BA:8C:B9:54:50:24,3842383,490186211,4850,6184387,3837533,484001824,0,9087,1705851,9065,1702356,22,3495,2350,15,5300,39,0,60,229410.0,130000.0,-48.0,-35.0,-43.0,-46.0,-45.0,-37.0,-45.0,-49.0,-83.0,-83.0,-80.0,-79.0,35.0,48.0,37.0,33.0,1
5999,62:47:05:9D:EB:15,3837599,484013985,61,11697,3837538,484002288,0,166,16761,155,14595,11,2166,41,0,90,1,0,8,229410.0,137640.0,-46.0,-55.0,-51.0,-56.0,-47.0,-54.0,-51.0,-56.0,-83.0,-83.0,-80.0,-79.0,37.0,28.0,29.0,23.0,1
6000,3C:55:76:E8:8F:1F,3897619,634524614,60081,150522326,3837538,484002288,24,27106,5970295,26755,5908909,351,61386,11958,33,60151,6579,24,335,77420.0,25800.0,-48.0,-54.0,-46.0,-46.0,-47.0,-52.0,-43.0,-44.0,-83.0,-83.0,-80.0,-79.0,35.0,29.0,34.0,33.0,1
6001,92:69:1D:31:68:E9,3841479,487630272,3941,3627984,3837538,484002288,0,4888,1113525,4741,1080215,147,33310,2134,11,4155,90,0,46,216660.0,130000.0,-51.0,-47.0,-42.0,-50.0,-51.0,-47.0,-43.0,-49.0,-83.0,-83.0,-80.0,-79.0,32.0,36.0,38.0,29.0,1
6002,CC:2F:71:3F:1F:24,4688461,1407725066,850921,923722576,3837540,484002490,37,692689,733424366,691954,733335968,735,88398,667670,15,851178,89878,34,537,144444.0,43333.0,-69.0,-66.0,-67.0,-70.0,-68.0,-65.0,-67.0,-70.0,-83.0,-83.0,-80.0,-79.0,14.0,17.0,13.0,9.0,1
6003,CC:2F:71:3E:C5:1F,3838435,484111922,895,109432,3837540,484002490,0,3726,313110,3074,235730,652,77380,948,10,1283,22,0,44,144444.0,39000.0,-72.0,-71.0,-70.0,-61.0,-71.0,-71.0,-69.0,-60.0,-83.0,-83.0,-80.0,-79.0,11.0,12.0,10.0,18.0,1
6004,BA:8C:B9:54:50:24,3842390,490186877,4850,6184387,3837540,484002490,0,9087,1705851,9065,1702356,22,3495,2350,15,5300,39,0,60,229410.0,130000.0,-48.0,-35.0,-43.0,-46.0,-45.0,-37.0,-45.0,-49.0,-83.0,-83.0,-80.0,-79.0,35.0,48.0,37.0,33.0,1
6005,62:47:05:9D:EB:15,3837603,484014389,61,11697,3837542,484002692,0,166,16761,155,14595,11,2166,41,0,90,1,0,8,229410.0,137640.0,-46.0,-55.0,-51.0,-56.0,-47.0,-54.0,-51.0,-56.0,-83.0,-83.0,-80.0,-79.0,37.0,28.0,29.0,23.0,1
6006,3C:55:76:E8:8F:1F,3897672,634645590,60130,150642898,3837542,484002692,24,27135,5973170,26784,5911784,351,61386,11966,33,60200,6579,24,335,77420.0,25800.0,-44.0,-52.0,-44.0,-42.0,-44.0,-51.0,-44.0,-41.0,-83.0,-83.0,-80.0,-79.0,39.0,31.0,36.0,37.0,1
6007,92:69:1D:31:68:E9,3841483,487630676,3941,3627984,3837542,484002692,0,4888,1113525,4741,1080215,147,33310,2134,11,4155,90,0,46,216660.0,130000.0,-51.0,-47.0,-42.0,-50.0,-51.0,-47.0,-43.0,-49.0,-83.0,-83.0,-80.0,-79.0,32.0,36.0,38.0,29.0,1
6008,CC:2F:71:3F:1F:24,4688678,1407997746,851136,923995054,3837542,484002692,37,692888,733690246,692153,733601848,735,88398,667861,15,851393,89898,34,537,144444.0,43333.0,-69.0,-65.0,-67.0,-70.0,-69.0,-65.0,-67.0,-70.0,-83.0,-83.0,-80.0,-79.0,14.0,18.0,13.0,9.0,1
6009,CC:2F:71:3E:C5:1F,3838439,484112326,895,109432,3837544,484002894,0,3726,313110,3074,235730,652,77380,948,10,1283,22,0,44,144444.0,39000.0,-72.0,-71.0,-70.0,-61.0,-71.0,-71.0,-69.0,-60.0,-83.0,-83.0,-80.0,-79.0,11.0,12.0,10.0,18.0,1
6010,BA:8C:B9:54:50:24,3842394,490187281,4850,6184387,3837544,484002894,0,9087,1705851,9065,1702356,22,3495,2350,15,5300,39,0,60,229410.0,130000.0,-48.0,-35.0,-43.0,-46.0,-45.0,-37.0,-45.0,-49.0,-83.0,-83.0,-80.0,-79.0,35.0,48.0,37.0,33.0,1
6011,62:47:05:9D:EB:15,3837637,484027794,88,24436,3837549,484003358,0,202,25689,191,23523,11,2166,71,0,117,2,0,8,229410.0,130000.0,-49.0,-55.0,-53.0,-58.0,-49.0,-54.0,-52.0,-58.0,-83.0,-83.0,-80.0,-79.0,34.0,28.0,27.0,21.0,1
6012,3C:55:76:E8:8F:1F,3897679,634646256,60130,150642898,3837549,484003358,24,27135,5973170,26784,5911784,351,61386,11966,33,60200,6579,24,335,77420.0,25800.0,-44.0,-52.0,-44.0,-42.0,-44.0,-51.0,-44.0,-41.0,-83.0,-83.0,-80.0,-79.0,39.0,31.0,36.0,37.0,1
6013,92:69:1D:31:68:E9,3841490,487631342,3941,3627984,3837549,484003358,0,4888,1113525,4741,1080215,147,33310,2134,11,4155,90,0,46,216660.0,130000.0,-51.0,-47.0,-42.0,-50.0,-51.0,-47.0,-43.0,-49.0,-83.0,-83.0,-80.0,-79.0,32.0,36.0,38.0,29.0,1
6014,CC:2F:71:3F:1F:24,4688905,1408268365,851356,924265007,3837549,484003358,37,693091,733947027,692356,733858629,735,88398,668059,15,851613,89943,34,537,130000.0,43333.0,-68.0,-66.0,-68.0,-71.0,-68.0,-66.0,-67.0,-70.0,-83.0,-83.0,-80.0,-79.0,15.0,17.0,12.0,8.0,1
6015,CC:2F:71:3E:C5:1F,3838446,484112992,895,109432,3837551,484003560,0,3726,313110,3074,235730,652,77380,948,10,1283,22,0,44,144444.0,39000.0,-72.0,-71.0,-70.0,-61.0,-71.0,-71.0,-69.0,-60.0,-83.0,-83.0,-80.0,-79.0,11.0,12.0,10.0,18.0,1
6016,BA:8C:B9:54:50:24,3842401,490187947,4850,6184387,3837551,484003560,0,9087,1705851,9065,1702356,22,3495,2350,15,5300,39,0,60,229410.0,130000.0,-48.0,-35.0,-43.0,-46.0,-45.0,-37.0,-45.0,-49.0,-83.0,-83.0,-80.0,-79.0,35.0,48.0,37.0,33.0,1
6017,62:47:05:9D:EB:15,3837650,484031906,96,28082,3837554,484003824,0,212,30521,201,28355,11,2166,79,0,125,2,0,8,229410.0,137640.0,-45.0,-53.0,-49.0,-53.0,-47.0,-53.0,-51.0,-57.0,-83.0,-83.0,-80.0,-79.0,38.0,30.0,31.0,26.0,1
6018,3C:55:76:E8:8F:1F,3897712,634672075,60158,150668251,3837554,484003824,24,27183,5988101,26831,5926597,352,61504,11993,33,60228,6579,24,336,97500.0,1000.0,-41.0,-49.0,-52.0,-38.0,-45.0,-50.0,-46.0,-41.0,-83.0,-83.0,-80.0,-79.0,42.0,34.0,28.0,41.0,1
6019,92:69:1D:31:68:E9,3841496,487631924,3942,3628100,3837554,484003824,0,4890,1113661,4743,1080351,147,33310,2134,11,4156,90,0,47,216660.0,130000.0,-51.0,-47.0,-42.0,-49.0,-51.0,-47.0,-42.0,-49.0,-83.0,-83.0,-80.0,-79.0,32.0,36.0,38.0,30.0,1
6020,CC:2F:71:3F:1F:24,4689125,1408536855,851571,924533031,3837554,484003824,37,693287,734205375,692552,734116977,735,88398,668248,15,851828,89950,34,537,144444.0,43333.0,-68.0,-66.0,-68.0,-71.0,-68.0,-66.0,-67.0,-70.0,-83.0,-83.0,-80.0,-79.0,15.0,17.0,12.0,8.0,1
6021,CC:2F:71:3E:C5:1F,3838450,484113372,896,109548,3837554,484003824,0,3728,313250,3076,235870,652,77380,948,10,1284,22,0,44,144444.0,39000.0,-71.0,-72.0,-69.0,-60.0,-72.0,-72.0,-69.0,-61.0,-83.0,-83.0,-80.0,-79.0,12.0,11.0,11.0,19.0,1
6022,BA:8C:B9:54:50:24,3842405,490188327,4851,6184503,3837554,484003824,0,9093,1706259,9071,1702764,22,3495,2350,15,5301,39,0,60,229410.0,130000.0,-48.0,-35.0,-43.0,-46.0,-45.0,-36.0,-44.0,-48.0,-83.0,-83.0,-80.0,-79.0,35.0,48.0,37.0,33.0,1
6023,62:47:05:9D:EB:15,3837719,484083576,159,79146,3837560,484004430,0,276,55284,265,53118,11,2166,133,0,187,2,0,8,229410.0,137640.0,-50.0,-54.0,-52.0,-57.0,-50.0,-54.0,-51.0,-57.0,-83.0,-83.0,-80.0,-79.0,33.0,29.0,28.0,22.0,1
6024,3C:55:76:E8:8F:1F,3897718,634672681,60158,150668251,3837560,484004430,24,27184,5988171,26832,5926667,352,61504,11993,33,60228,6579,24,336,97500.0,1000.0,-41.0,-49.0,-52.0,-38.0,-44.0,-50.0,-47.0,-40.0,-83.0,-83.0,-80.0,-79.0,42.0,34.0,28.0,41.0,1
6025,92:69:1D:31:68:E9,3841502,487632530,3942,3628100,3837560,484004430,0,4890,1113661,4743,1080351,147,33310,2134,11,4156,90,0,47,216660.0,130000.0,-51.0,-47.0,-42.0,-49.0,-51.0,-47.0,-42.0,-49.0,-83.0,-83.0,-80.0,-79.0,32.0,36.0,38.0,30.0,1
6026,CC:2F:71:3F:1F:24,4689338,1408797467,851778,924793037,3837560,484004430,37,693484,734464071,692749,734375673,735,88398,668431,15,852035,89961,34,537,130000.0,43333.0,-69.0,-65.0,-68.0,-70.0,-69.0,-65.0,-68.0,-70.0,-83.0,-83.0,-80.0,-79.0,14.0,18.0,12.0,9.0,1
6027,CC:2F:71:3E:C5:1F,3838457,484114038,896,109548,3837561,484004490,0,3728,313250,3076,235870,652,77380,948,10,1284,22,0,44,144444.0,39000.0,-71.0,-72.0,-69.0,-60.0,-72.0,-72.0,-69.0,-61.0,-83.0,-83.0,-80.0,-79.0,12.0,11.0,11.0,19.0,1
6028,BA:8C:B9:54:50:24,3842413,490189109,4852,6184619,3837561,484004490,0,9096,1706505,9074,1703010,22,3495,2351,15,5302,39,0,60,229410.0,130000.0,-48.0,-35.0,-43.0,-45.0,-45.0,-36.0,-44.0,-47.0,-83.0,-83.0,-80.0,-79.0,35.0,48.0,37.0,34.0,1
6029,62:47:05:9D:EB:15,3837734,484086292,169,81265,3837565,484005027,0,284,56268,273,54102,11,2166,140,0,198,2,0,8,216660.0,130000.0,-45.0,-54.0,-48.0,-55.0,-49.0,-55.0,-51.0,-57.0,-83.0,-83.0,-80.0,-79.0,38.0,29.0,32.0,24.0,1
6030,3C:55:76:E8:8F:1F,3897723,634673278,60158,150668251,3837565,484005027,24,27184,5988171,26832,5926667,352,61504,11993,33,60228,6579,24,336,97500.0,1000.0,-41.0,-49.0,-52.0,-38.0,-44.0,-50.0,-47.0,-40.0,-83.0,-83.0,-80.0,-79.0,42.0,34.0,28.0,41.0,1
6031,92:69:1D:31:68:E9,3841507,487633127,3942,3628100,3837565,484005027,0,4890,1113661,4743,1080351,147,33310,2134,11,4156,90,0,47,216660.0,130000.0,-51.0,-47.0,-42.0,-49.0,-51.0,-47.0,-42.0,-49.0,-83.0,-83.0,-80.0,-79.0,32.0,36.0,38.0,30.0,1
6032,CC:2F:71:3F:1F:24,4689555,1409059946,851990,925054919,3837565,484005027,37,693673,734712893,692938,734624495,735,88398,668618,15,852247,89978,34,537,130000.0,43333.0,-67.0,-66.0,-67.0,-67.0,-67.0,-66.0,-66.0,-69.0,-83.0,-83.0,-80.0,-79.0,16.0,17.0,13.0,12.0,1
6033,CC:2F:71:3E:C5:1F,3838463,484114777,896,109548,3837567,484005229,0,3730,313438,3077,235940,653,77498,949,10,1284,22,0,45,144444.0,39000.0,-71.0,-71.0,-68.0,-60.0,-73.0,-73.0,-70.0,-62.0,-83.0,-83.0,-80.0,-79.0,12.0,12.0,12.0,19.0,1
6034,BA:8C:B9:54:50:24,3842420,490189910,4852,6184619,3837568,484005291,0,9096,1706505,9074,1703010,22,3495,2351,15,5302,39,0,60,229410.0,130000.0,-48.0,-35.0,-43.0,-45.0,-45.0,-36.0,-44.0,-47.0,-83.0,-83.0,-80.0,-79.0,35.0,48.0,37.0,34.0,1
6035,62:47:05:9D:EB:15,3837741,484086960,169,81265,3837572,484005695,0,284,56268,273,54102,11,2166,140,0,198,2,0,8,216660.0,130000.0,-45.0,-54.0,-48.0,-55.0,-49.0,-55.0,-51.0,-57.0,-83.0,-83.0,-80.0,-79.0,38.0,29.0,32.0,24.0,1
6036,3C:55:76:E8:8F:1F,3897730,634673946,60158,150668251,3837572,484005695,24,27193,5988837,26840,5927215,353,61622,11994,33,60228,6579,24,336,97500.0,1000.0,-45.0,-57.0,-45.0,-39.0,-43.0,-55.0,-43.0,-37.0,-83.0,-83.0,-80.0,-79.0,38.0,26.0,35.0,40.0,1
6037,92:69:1D:31:68:E9,3841514,487633795,3942,3628100,3837572,484005695,0,4890,1113661,4743,1080351,147,33310,2134,11,4156,90,0,47,216660.0,130000.0,-51.0,-47.0,-42.0,-49.0,-51.0,-47.0,-42.0,-49.0,-83.0,-83.0,-80.0,-79.0,32.0,36.0,38.0,30.0,1
6038,CC:2F:71:3F:1F:24,4689779,1409324465,852207,925318770,3837572,484005695,37,693882,734974900,693147,734886502,735,88398,668810,15,852464,90003,34,537,130000.0,39000.0,-66.0,-65.0,-68.0,-70.0,-66.0,-65.0,-68.0,-70.0,-83.0,-83.0,-80.0,-79.0,17.0,18.0,12.0,9.0,1
6039,CC:2F:71:3E:C5:1F,3838468,484115243,896,109548,3837572,484005695,0,3730,313438,3077,235940,653,77498,949,10,1284,22,0,45,144444.0,39000.0,-71.0,-71.0,-68.0,-60.0,-73.0,-73.0,-70.0,-62.0,-83.0,-83.0,-80.0,-79.0,12.0,12.0,12.0,19.0,1
6040,BA:8C:B9:54:50:24,3842424,490190314,4852,6184619,3837572,484005695,0,9096,1706505,9074,1703010,22,3495,2351,15,5302,39,0,60,229410.0,130000.0,-48.0,-35.0,-43.0,-45.0,-45.0,-36.0,-44.0,-47.0,-83.0,-83.0,-80.0,-79.0,35.0,48.0,37.0,34.0,1
6041,62:47:05:9D:EB:15,3837746,484087424,169,81265,3837577,484006159,0,284,56268,273,54102,11,2166,140,0,198,2,0,8,216660.0,130000.0,-45.0,-54.0,-48.0,-55.0,-49.0,-55.0,-51.0,-57.0,-83.0,-83.0,-80.0,-79.0,38.0,29.0,32.0,24.0,1
6042,3C:55:76:E8:8F:1F,3897738,634674814,60160,150668593,3837578,484006221,24,27200,5989530,26846,5927790,354,61740,11998,33,60230,6579,24,336,97500.0,1000.0,-45.0,-50.0,-42.0,-41.0,-44.0,-51.0,-45.0,-40.0,-83.0,-83.0,-80.0,-79.0,38.0,33.0,38.0,38.0,1
6043,92:69:1D:31:68:E9,3841520,487634321,3942,3628100,3837578,484006221,0,4890,1113661,4743,1080351,147,33310,2134,11,4156,90,0,47,216660.0,130000.0,-51.0,-47.0,-42.0,-49.0,-51.0,-47.0,-42.0,-49.0,-83.0,-83.0,-80.0,-79.0,32.0,36.0,38.0,30.0,1
6044,CC:2F:71:3F:1F:24,4689992,1409586293,852414,925580072,3837578,484006221,37,694071,735226698,693336,735138300,735,88398,668992,15,852671,90016,34,537,130000.0,43333.0,-67.0,-66.0,-67.0,-72.0,-67.0,-66.0,-67.0,-71.0,-83.0,-83.0,-80.0,-79.0,16.0,17.0,13.0,7.0,1
6045,CC:2F:71:3E:C5:1F,3838474,484115769,896,109548,3837578,484006221,0,3730,313438,3077,235940,653,77498,949,10,1284,22,0,45,144444.0,39000.0,-71.0,-71.0,-68.0,-60.0,-73.0,-73.0,-70.0,-62.0,-83.0,-83.0,-80.0,-79.0,12.0,12.0,12.0,19.0,1
6046,BA:8C:B9:54:50:24,3842434,490191410,4852,6184619,3837582,484006791,0,9096,1706505,9074,1703010,22,3495,2351,15,5302,39,0,60,229410.0,130000.0,-48.0,-35.0,-43.0,-45.0,-45.0,-36.0,-44.0,-47.0,-83.0,-83.0,-80.0,-79.0,35.0,48.0,37.0,34.0,1
6047,62:47:05:9D:EB:15,3837754,484088374,170,81381,3837584,484006993,0,286,56446,275,54280,11,2166,141,0,199,2,0,8,216660.0,130000.0,-49.0,-54.0,-52.0,-59.0,-48.0,-54.0,-51.0,-57.0,-83.0,-83.0,-80.0,-79.0,34.0,29.0,28.0,20.0,1
6048,3C:55:76:E8:8F:1F,3897745,634675710,60161,150668717,3837584,484006993,24,27216,5990724,26862,5928984,354,61740,12000,33,60231,6579,24,336,97500.0,1000.0,-44.0,-53.0,-50.0,-42.0,-43.0,-52.0,-49.0,-40.0,-83.0,-83.0,-80.0,-79.0,39.0,30.0,30.0,37.0,1
6049,92:69:1D:31:68:E9,3841526,487635093,3942,3628100,3837584,484006993,0,4890,1113661,4743,1080351,147,33310,2134,11,4156,90,0,47,216660.0,130000.0,-51.0,-47.0,-42.0,-49.0,-51.0,-47.0,-42.0,-49.0,-83.0,-83.0,-80.0,-79.0,32.0,36.0,38.0,30.0,1
6050,CC:2F:71:3F:1F:24,4690208,1409848773,852624,925841780,3837584,484006993,37,694263,735480378,693528,735391980,735,88398,669176,15,852881,90030,34,537,144444.0,43333.0,-67.0,-66.0,-67.0,-71.0,-67.0,-66.0,-67.0,-71.0,-83.0,-83.0,-80.0,-79.0,16.0,17.0,13.0,8.0,1
6051,CC:2F:71:3E:C5:1F,3838482,484116743,896,109548,3837586,484007195,0,3730,313438,3077,235940,653,77498,949,10,1284,22,0,45,144444.0,39000.0,-71.0,-71.0,-68.0,-60.0,-73.0,-73.0,-70.0,-62.0,-83.0,-83.0,-80.0,-79.0,12.0,12.0,12.0,19.0,1
6052,BA:8C:B9:54:50:24,3842438,490191814,4852,6184619,3837586,484007195,0,9096,1706505,9074,1703010,22,3495,2351,15,5302,39,0,60,229410.0,130000.0,-48.0,-35.0,-43.0,-45.0,-45.0,-36.0,-44.0,-47.0,-83.0,-83.0,-80.0,-79.0,35.0,48.0,37.0,34.0,1
6053,62:47:05:9D:EB:15,3837759,484088838,170,81381,3837589,484007457,0,287,56514,276,54348,11,2166,141,0,199,2,0,8,216660.0,130000.0,-45.0,-52.0,-50.0,-56.0,-48.0,-54.0,-50.0,-57.0,-83.0,-83.0,-80.0,-79.0,38.0,31.0,30.0,23.0,1
6054,3C:55:76:E8:8F:1F,3897753,634676785,60162,150669126,3837591,484007659,24,27231,5992053,26877,5930313,354,61740,12002,33,60232,6579,24,336,81250.0,1000.0,-51.0,-52.0,-43.0,-43.0,-49.0,-52.0,-43.0,-43.0,-83.0,-83.0,-80.0,-79.0,32.0,31.0,37.0,36.0,1
6055,92:69:1D:31:68:E9,3841533,487635759,3942,3628100,3837591,484007659,0,4890,1113661,4743,1080351,147,33310,2134,11,4156,90,0,47,216660.0,130000.0,-51.0,-47.0,-42.0,-49.0,-51.0,-47.0,-42.0,-49.0,-83.0,-83.0,-80.0,-79.0,32.0,36.0,38.0,30.0,1
6056,CC:2F:71:3F:1F:24,4690430,1410113016,852839,926105357,3837591,484007659,37,694458,735729144,693723,735640746,735,88398,669368,15,853096,90047,34,539,130000.0,43333.0,-67.0,-66.0,-67.0,-70.0,-67.0,-65.0,-67.0,-69.0,-83.0,-83.0,-80.0,-79.0,16.0,17.0,13.0,9.0,1
6057,CC:2F:71:3E:C5:1F,3838487,484117207,896,109548,3837591,484007659,0,3730,313438,3077,235940,653,77498,949,10,1284,22,0,45,144444.0,39000.0,-71.0,-71.0,-68.0,-60.0,-73.0,-73.0,-70.0,-62.0,-83.0,-83.0,-80.0,-79.0,12.0,12.0,12.0,19.0,1
6058,BA:8C:B9:54:50:24,3842445,490192480,4852,6184619,3837593,484007861,0,9096,1706505,9074,1703010,22,3495,2351,15,5302,39,0,60,229410.0,130000.0,-48.0,-35.0,-43.0,-45.0,-45.0,-36.0,-44.0,-47.0,-83.0,-83.0,-80.0,-79.0,35.0,48.0,37.0,34.0,1
6059,62:47:05:9D:EB:15,3837764,484089304,170,81381,3837594,484007923,0,287,56514,276,54348,11,2166,141,0,199,2,0,8,216660.0,130000.0,-45.0,-52.0,-50.0,-56.0,-48.0,-54.0,-50.0,-57.0,-83.0,-83.0,-80.0,-79.0,38.0,31.0,30.0,23.0,1
6060,3C:55:76:E8:8F:1F,3897759,634677369,60163,150669244,3837596,484008125,24,27247,5993271,26893,5931531,354,61740,12004,33,60233,6579,24,336,81250.0,1000.0,-44.0,-53.0,-51.0,-42.0,-43.0,-52.0,-50.0,-41.0,-83.0,-83.0,-80.0,-79.0,39.0,30.0,29.0,37.0,1
6061,92:69:1D:31:68:E9,3841538,487636225,3942,3628100,3837596,484008125,0,4890,1113661,4743,1080351,147,33310,2134,11,4156,90,0,47,216660.0,130000.0,-51.0,-47.0,-42.0,-49.0,-51.0,-47.0,-42.0,-49.0,-83.0,-83.0,-80.0,-79.0,32.0,36.0,38.0,30.0,1
6062,CC:2F:71:3F:1F:24,4690648,1410379836,853052,926371711,3837596,484008125,37,694661,735999734,693925,735911218,736,88516,669555,15,853309,90053,34,539,130000.0,39000.0,-67.0,-66.0,-67.0,-70.0,-67.0,-66.0,-67.0,-70.0,-83.0,-83.0,-80.0,-79.0,16.0,17.0,13.0,9.0,1
6063,CC:2F:71:3E:C5:1F,3838492,484117673,896,109548,3837596,484008125,0,3730,313438,3077,235940,653,77498,949,10,1284,22,0,45,144444.0,39000.0,-71.0,-71.0,-68.0,-60.0,-73.0,-73.0,-70.0,-62.0,-83.0,-83.0,-80.0,-79.0,12.0,12.0,12.0,19.0,1
6064,BA:8C:B9:54:50:24,3842448,490192744,4852,6184619,3837596,484008125,0,9096,1706505,9074,1703010,22,3495,2351,15,5302,39,0,60,229410.0,130000.0,-48.0,-35.0,-43.0,-45.0,-45.0,-36.0,-44.0,-47.0,-83.0,-83.0,-80.0,-79.0,35.0,48.0,37.0,34.0,1
6065,62:47:05:9D:EB:15,3837770,484089910,170,81381,3837600,484008529,0,287,56514,276,54348,11,2166,141,0,199,2,0,8,216660.0,130000.0,-45.0,-52.0,-50.0,-56.0,-48.0,-54.0,-50.0,-57.0,-83.0,-83.0,-80.0,-79.0,38.0,31.0,30.0,23.0,1
6066,3C:55:76:E8:8F:1F,3897765,634677975,60163,150669244,3837602,484008731,24,27247,5993271,26893,5931531,354,61740,12004,33,60233,6579,24,336,81250.0,1000.0,-44.0,-53.0,-51.0,-42.0,-43.0,-52.0,-50.0,-41.0,-83.0,-83.0,-80.0,-79.0,39.0,30.0,29.0,37.0,1
6067,92:69:1D:31:68:E9,3841544,487636831,3942,3628100,3837602,484008731,0,4890,1113661,4743,1080351,147,33310,2134,11,4156,90,0,47,216660.0,130000.0,-51.0,-47.0,-42.0,-49.0,-51.0,-47.0,-42.0,-49.0,-83.0,-83.0,-80.0,-79.0,32.0,36.0,38.0,30.0,1
6068,CC:2F:71:3F:1F:24,4690867,1410646600,853264,926637809,3837603,484008791,37,694864,736267606,694128,736179090,736,88516,669745,15,853521,90059,34,539,130000.0,43333.0,-67.0,-66.0,-67.0,-70.0,-67.0,-66.0,-67.0,-69.0,-83.0,-83.0,-80.0,-79.0,16.0,17.0,13.0,9.0,1
6069,CC:2F:71:3E:C5:1F,3838499,484118339,896,109548,3837603,484008791,0,3731,313508,3078,236010,653,77498,949,10,1285,22,0,45,144444.0,39000.0,-71.0,-71.0,-69.0,-60.0,-73.0,-73.0,-70.0,-62.0,-83.0,-83.0,-80.0,-79.0,12.0,12.0,11.0,19.0,1
6070,BA:8C:B9:54:50:24,3842455,490193410,4852,6184619,3837603,484008791,0,9099,1706709,9077,1703214,22,3495,2351,15,5303,39,0,60,229410.0,130000.0,-40.0,-37.0,-45.0,-51.0,-45.0,-35.0,-43.0,-46.0,-83.0,-83.0,-80.0,-79.0,43.0,46.0,35.0,28.0,1
6071,62:47:05:9D:EB:15,3837775,484090374,170,81381,3837605,484008993,0,287,56514,276,54348,11,2166,141,0,199,2,0,8,216660.0,130000.0,-45.0,-52.0,-50.0,-56.0,-48.0,-54.0,-50.0,-57.0,-83.0,-83.0,-80.0,-79.0,38.0,31.0,30.0,23.0,1
6072,3C:55:76:E8:8F:1F,3898529,636593320,60924,152584327,3837605,484008993,24,27517,6055430,27163,5993690,354,61740,12160,33,60986,6634,24,340,108330.0,65000.0,-50.0,-54.0,-47.0,-46.0,-48.0,-53.0,-47.0,-44.0,-83.0,-83.0,-80.0,-79.0,33.0,29.0,33.0,33.0,1
6073,92:69:1D:31:68:E9,3841547,487637093,3942,3628100,3837605,484008993,0,4892,1113797,4745,1080487,147,33310,2134,11,4157,90,0,47,216660.0,130000.0,-50.0,-51.0,-47.0,-50.0,-51.0,-48.0,-43.0,-49.0,-83.0,-83.0,-80.0,-79.0,33.0,32.0,33.0,29.0,1
6074,CC:2F:71:3F:1F:24,4691095,1410934966,853490,926925973,3837605,484008993,37,695073,736549000,694337,736460484,736,88516,669945,15,853744,90069,34,539,130000.0,43333.0,-68.0,-66.0,-68.0,-71.0,-67.0,-66.0,-67.0,-70.0,-83.0,-83.0,-80.0,-79.0,15.0,17.0,12.0,8.0,1
6075,CC:2F:71:3E:C5:1F,3838503,484118743,896,109548,3837607,484009195,0,3732,313578,3079,236080,653,77498,949,10,1285,22,0,45,144444.0,39000.0,-71.0,-71.0,-69.0,-61.0,-73.0,-73.0,-70.0,-62.0,-83.0,-83.0,-80.0,-79.0,12.0,12.0,11.0,18.0,1
6076,BA:8C:B9:54:50:24,3842459,490193814,4852,6184619,3837607,484009195,0,9099,1706709,9077,1703214,22,3495,2351,15,5303,39,0,60,229410.0,130000.0,-40.0,-37.0,-45.0,-51.0,-45.0,-35.0,-43.0,-46.0,-83.0,-83.0,-80.0,-79.0,43.0,46.0,35.0,28.0,1
6077,62:47:05:9D:EB:15,3837781,484090980,170,81381,3837611,484009599,0,288,56582,277,54416,11,2166,141,0,199,2,0,8,216660.0,130000.0,-45.0,-51.0,-49.0,-56.0,-47.0,-53.0,-50.0,-57.0,-83.0,-83.0,-80.0,-79.0,38.0,32.0,31.0,23.0,1
6078,3C:55:76:E8:8F:1F,3899039,637920587,61428,153910988,3837611,484009599,24,27665,6075251,27311,6013511,354,61740,12239,33,61498,6636,24,340,114700.0,68820.0,-44.0,-60.0,-45.0,-40.0,-43.0,-54.0,-48.0,-40.0,-83.0,-83.0,-80.0,-79.0,39.0,23.0,35.0,39.0,1
6079,92:69:1D:31:68:E9,3841553,487637699,3942,3628100,3837611,484009599,0,4892,1113797,4745,1080487,147,33310,2134,11,4157,90,0,47,216660.0,130000.0,-50.0,-51.0,-47.0,-50.0,-51.0,-48.0,-43.0,-49.0,-83.0,-83.0,-80.0,-79.0,33.0,32.0,33.0,29.0,1
6080,CC:2F:71:3F:1F:24,4691339,1411230655,853728,927221056,3837611,484009599,37,695310,736851549,694574,736763033,736,88516,670158,15,853985,90083,34,539,130000.0,43333.0,-68.0,-65.0,-68.0,-71.0,-68.0,-65.0,-67.0,-70.0,-83.0,-83.0,-80.0,-79.0,15.0,18.0,12.0,8.0,1
6081,CC:2F:71:3E:C5:1F,3838507,484119147,896,109548,3837611,484009599,0,3732,313578,3079,236080,653,77498,949,10,1285,22,0,45,144444.0,39000.0,-71.0,-71.0,-69.0,-61.0,-73.0,-73.0,-70.0,-62.0,-83.0,-83.0,-80.0,-79.0,12.0,12.0,11.0,18.0,1
6082,BA:8C:B9:54:50:24,3842465,490194420,4852,6184619,3837613,484009801,0,9099,1706709,9077,1703214,22,3495,2351,15,5303,39,0,60,229410.0,130000.0,-40.0,-37.0,-45.0,-51.0,-45.0,-35.0,-43.0,-46.0,-83.0,-83.0,-80.0,-79.0,43.0,46.0,35.0,28.0,1
6083,62:47:05:9D:EB:15,3837786,484091444,170,81381,3837616,484010063,0,288,56582,277,54416,11,2166,141,0,199,2,0,8,216660.0,130000.0,-45.0,-51.0,-49.0,-56.0,-47.0,-53.0,-50.0,-57.0,-83.0,-83.0,-80.0,-79.0,38.0,32.0,31.0,23.0,1
6084,3C:55:76:E8:8F:1F,3899051,637922490,61435,153912427,3837616,484010063,24,27684,6079576,27330,6017836,354,61740,12246,33,61505,6636,24,340,121870.0,73120.0,-46.0,-56.0,-44.0,-39.0,-47.0,-54.0,-43.0,-39.0,-83.0,-83.0,-80.0,-79.0,37.0,27.0,36.0,40.0,1
6085,92:69:1D:31:68:E9,3841558,487638163,3942,3628100,3837616,484010063,0,4892,1113797,4745,1080487,147,33310,2134,11,4157,90,0,47,216660.0,130000.0,-50.0,-51.0,-47.0,-50.0,-51.0,-48.0,-43.0,-49.0,-83.0,-83.0,-80.0,-79.0,33.0,32.0,33.0,29.0,1
6086,CC:2F:71:3F:1F:24,4691550,1411490811,853934,927480748,3837616,484010063,37,695500,737104839,694764,737016323,736,88516,670341,15,854191,90103,34,539,130000.0,43333.0,-69.0,-66.0,-67.0,-70.0,-68.0,-66.0,-66.0,-69.0,-83.0,-83.0,-80.0,-79.0,14.0,17.0,13.0,9.0,1
6087,CC:2F:71:3E:C5:1F,3838514,484119813,896,109548,3837618,484010265,0,3732,313578,3079,236080,653,77498,949,10,1285,22,0,45,144444.0,39000.0,-71.0,-71.0,-69.0,-61.0,-73.0,-73.0,-70.0,-62.0,-83.0,-83.0,-80.0,-79.0,12.0,12.0,11.0,18.0,1
6088,BA:8C:B9:54:50:24,3842470,490194884,4852,6184619,3837618,484010265,0,9099,1706709,9077,1703214,22,3495,2351,15,5303,39,0,60,229410.0,130000.0,-40.0,-37.0,-45.0,-51.0,-45.0,-35.0,-43.0,-46.0,-83.0,-83.0,-80.0,-79.0,43.0,46.0,35.0,28.0,1
6089,62:47:05:9D:EB:15,3837792,484092050,170,81381,3837622,484010669,0,288,56582,277,54416,11,2166,141,0,199,2,0,8,216660.0,130000.0,-45.0,-51.0,-49.0,-56.0,-47.0,-53.0,-50.0,-57.0,-83.0,-83.0,-80.0,-79.0,38.0,32.0,31.0,23.0,1
6090,3C:55:76:E8:8F:1F,3899057,637923096,61435,153912427,3837622,484010669,24,27690,6079986,27336,6018246,354,61740,12246,33,61505,6636,24,340,121870.0,73120.0,-45.0,-55.0,-43.0,-37.0,-46.0,-55.0,-43.0,-38.0,-83.0,-83.0,-80.0,-79.0,38.0,28.0,37.0,42.0,1
6091,92:69:1D:31:68:E9,3841564,487638769,3942,3628100,3837622,484010669,0,4892,1113797,4745,1080487,147,33310,2134,11,4157,90,0,47,216660.0,130000.0,-50.0,-51.0,-47.0,-50.0,-51.0,-48.0,-43.0,-49.0,-83.0,-83.0,-80.0,-79.0,33.0,32.0,33.0,29.0,1
6092,CC:2F:71:3F:1F:24,4692220,1412325265,854598,928314596,3837622,484010669,37,695901,737397656,695165,737309140,736,88516,670734,15,854855,90119,34,539,130000.0,43333.0,-69.0,-66.0,-67.0,-68.0,-68.0,-66.0,-66.0,-69.0,-83.0,-83.0,-80.0,-79.0,14.0,17.0,13.0,11.0,1
6093,CC:2F:71:3E:C5:1F,3838518,484120217,896,109548,3837622,484010669,0,3732,313578,3079,236080,653,77498,949,10,1285,22,0,45,144444.0,39000.0,-71.0,-71.0,-69.0,-61.0,-73.0,-73.0,-70.0,-62.0,-83.0,-83.0,-80.0,-79.0,12.0,12.0,11.0,18.0,1
6094,BA:8C:B9:54:50:24,3842474,490195288,4852,6184619,3837622,484010669,0,9099,1706709,9077,1703214,22,3495,2351,15,5303,39,0,60,229410.0,130000.0,-40.0,-37.0,-45.0,-51.0,-45.0,-35.0,-43.0,-46.0,-83.0,-83.0,-80.0,-79.0,43.0,46.0,35.0,28.0,1
6095,62:47:05:9D:EB:15,3837798,484092787,170,81381,3837628,484011406,0,288,56582,277,54416,11,2166,141,0,199,2,0,8,216660.0,130000.0,-45.0,-51.0,-49.0,-56.0,-47.0,-53.0,-50.0,-57.0,-83.0,-83.0,-80.0,-79.0,38.0,32.0,31.0,23.0,1
6096,3C:55:76:E8:8F:1F,3899063,637923833,61435,153912427,3837628,484011406,24,27690,6079986,27336,6018246,354,61740,12246,33,61505,6636,24,340,121870.0,73120.0,-45.0,-55.0,-43.0,-37.0,-46.0,-55.0,-43.0,-38.0,-83.0,-83.0,-80.0,-79.0,38.0,28.0,37.0,42.0,1
6097,92:69:1D:31:68:E9,3841572,487639708,3942,3628100,3837630,484011608,0,4892,1113797,4745,1080487,147,33310,2134,11,4157,90,0,47,216660.0,130000.0,-50.0,-51.0,-47.0,-50.0,-51.0,-48.0,-43.0,-49.0,-83.0,-83.0,-80.0,-79.0,33.0,32.0,33.0,29.0,1
6098,CC:2F:71:3F:1F:24,4692436,1412584732,854806,928573124,3837630,484011608,37,696089,737642004,695353,737553488,736,88516,670916,15,855062,90129,34,539,130000.0,43333.0,-68.0,-66.0,-67.0,-69.0,-68.0,-66.0,-66.0,-69.0,-83.0,-83.0,-80.0,-79.0,15.0,17.0,13.0,10.0,1
6099,CC:2F:71:3E:C5:1F,3838526,484121156,896,109548,3837630,484011608,0,3732,313578,3079,236080,653,77498,949,10,1285,22,0,45,144444.0,39000.0,-71.0,-71.0,-69.0,-61.0,-73.0,-73.0,-70.0,-62.0,-83.0,-83.0,-80.0,-79.0,12.0,12.0,11.0,18.0,1
6100,BA:8C:B9:54:50:24,3842482,490196227,4852,6184619,3837630,484011608,0,9100,1706777,9078,1703282,22,3495,2351,15,5303,39,0,60,229410.0,130000.0,-40.0,-36.0,-45.0,-51.0,-45.0,-35.0,-43.0,-47.0,-83.0,-83.0,-80.0,-79.0,43.0,47.0,35.0,28.0,1
6101,62:47:05:9D:EB:15,3837802,484093191,170,81381,3837632,484011810,0,288,56582,277,54416,11,2166,141,0,199,2,0,8,216660.0,130000.0,-45.0,-51.0,-49.0,-56.0,-47.0,-53.0,-50.0,-57.0,-83.0,-83.0,-80.0,-79.0,38.0,32.0,31.0,23.0,1
6102,3C:55:76:E8:8F:1F,3899073,637925859,61441,153914049,3837632,484011810,24,27706,6085893,27352,6024153,354,61740,12254,33,61511,6636,24,340,121870.0,73120.0,-46.0,-55.0,-44.0,-39.0,-46.0,-54.0,-43.0,-39.0,-83.0,-83.0,-80.0,-79.0,37.0,28.0,36.0,40.0,1
6103,92:69:1D:31:68:E9,3841574,487639910,3942,3628100,3837632,484011810,0,4892,1113797,4745,1080487,147,33310,2134,11,4157,90,0,47,216660.0,130000.0,-50.0,-51.0,-47.0,-50.0,-51.0,-48.0,-43.0,-49.0,-83.0,-83.0,-80.0,-79.0,33.0,32.0,33.0,29.0,1
6104,CC:2F:71:3F:1F:24,4692656,1412859002,855024,928847192,3837632,484011810,37,696287,737906098,695551,737817582,736,88516,671108,15,855281,90138,34,539,130000.0,43333.0,-68.0,-66.0,-66.0,-70.0,-67.0,-65.0,-66.0,-69.0,-83.0,-83.0,-80.0,-79.0,15.0,17.0,14.0,9.0,1
6105,CC:2F:71:3E:C5:1F,3838528,484121358,896,109548,3837632,484011810,0,3732,313578,3079,236080,653,77498,949,10,1285,22,0,45,144444.0,39000.0,-71.0,-71.0,-69.0,-61.0,-73.0,-73.0,-70.0,-62.0,-83.0,-83.0,-80.0,-79.0,12.0,12.0,11.0,18.0,1
6106,BA:8C:B9:54:50:24,3842486,490196631,4852,6184619,3837634,484012012,0,9100,1706777,9078,1703282,22,3495,2351,15,5303,39,0,60,229410.0,130000.0,-40.0,-36.0,-45.0,-51.0,-45.0,-35.0,-43.0,-47.0,-83.0,-83.0,-80.0,-79.0,43.0,47.0,35.0,28.0,1
6107,62:47:05:9D:EB:15,3837809,484093857,170,81381,3837639,484012476,0,288,56582,277,54416,11,2166,141,0,199,2,0,8,216660.0,130000.0,-45.0,-51.0,-49.0,-56.0,-47.0,-53.0,-50.0,-57.0,-83.0,-83.0,-80.0,-79.0,38.0,32.0,31.0,23.0,1
6108,3C:55:76:E8:8F:1F,3901051,643163116,63412,159150640,3837639,484012476,24,28206,6156484,27852,6094744,354,61740,12506,34,63483,6793,24,347,121870.0,73120.0,-51.0,-55.0,-45.0,-44.0,-51.0,-55.0,-45.0,-44.0,-83.0,-83.0,-80.0,-79.0,32.0,28.0,35.0,35.0,1
6109,92:69:1D:31:68:E9,3841581,487640576,3942,3628100,3837639,484012476,0,4892,1113797,4745,1080487,147,33310,2134,11,4157,90,0,47,216660.0,130000.0,-50.0,-51.0,-47.0,-50.0,-51.0,-48.0,-43.0,-49.0,-83.0,-83.0,-80.0,-79.0,33.0,32.0,33.0,29.0,1
6110,CC:2F:71:3F:1F:24,4692905,1413172248,855266,929159772,3837639,484012476,37,696511,738207606,695775,738119090,736,88516,671325,15,855523,90179,34,539,130000.0,43333.0,-68.0,-66.0,-67.0,-70.0,-68.0,-66.0,-66.0,-69.0,-83.0,-83.0,-80.0,-79.0,15.0,17.0,13.0,9.0,1
6111,CC:2F:71:3E:C5:1F,3838537,484122226,896,109548,3837641,484012678,0,3732,313578,3079,236080,653,77498,949,10,1285,22,0,45,144444.0,39000.0,-71.0,-71.0,-69.0,-61.0,-73.0,-73.0,-70.0,-62.0,-83.0,-83.0,-80.0,-79.0,12.0,12.0,11.0,18.0,1
6112,BA:8C:B9:54:50:24,3842493,490197297,4852,6184619,3837641,484012678,0,9100,1706777,9078,1703282,22,3495,2351,15,5303,39,0,60,229410.0,130000.0,-40.0,-36.0,-45.0,-51.0,-45.0,-35.0,-43.0,-47.0,-83.0,-83.0,-80.0,-79.0,43.0,47.0,35.0,28.0,1
6113,62:47:05:9D:EB:15,3837811,484094059,170,81381,3837641,484012678,0,288,56582,277,54416,11,2166,141,0,199,2,0,8,216660.0,130000.0,-45.0,-51.0,-49.0,-56.0,-47.0,-53.0,-50.0,-57.0,-83.0,-83.0,-80.0,-79.0,38.0,32.0,31.0,23.0,1
6114,3C:55:76:E8:8F:1F,3901053,643163318,63412,159150640,3837641,484012678,24,28219,6157370,27865,6095630,354,61740,12506,34,63483,6793,24,347,121870.0,73120.0,-47.0,-57.0,-45.0,-40.0,-46.0,-55.0,-44.0,-39.0,-83.0,-83.0,-80.0,-79.0,36.0,26.0,35.0,39.0,1
6115,92:69:1D:31:68:E9,3841583,487640778,3942,3628100,3837641,484012678,0,4892,1113797,4745,1080487,147,33310,2134,11,4157,90,0,47,216660.0,130000.0,-50.0,-51.0,-47.0,-50.0,-51.0,-48.0,-43.0,-49.0,-83.0,-83.0,-80.0,-79.0,33.0,32.0,33.0,29.0,1
6116,CC:2F:71:3F:1F:24,4693354,1413707100,855713,929694422,3837641,484012678,37,696823,738484032,696087,738395516,736,88516,671635,15,855970,90207,34,539,130000.0,43333.0,-68.0,-66.0,-67.0,-70.0,-68.0,-66.0,-66.0,-70.0,-83.0,-83.0,-80.0,-79.0,15.0,17.0,13.0,9.0,1
6117,CC:2F:71:3E:C5:1F,3838539,484122428,896,109548,3837643,484012880,0,3732,313578,3079,236080,653,77498,949,10,1285,22,0,45,144444.0,39000.0,-71.0,-71.0,-69.0,-61.0,-73.0,-73.0,-70.0,-62.0,-83.0,-83.0,-80.0,-79.0,12.0,12.0,11.0,18.0,1
6118,BA:8C:B9:54:50:24,3842499,490197903,4852,6184619,3837647,484013284,0,9100,1706777,9078,1703282,22,3495,2351,15,5303,39,0,60,229410.0,130000.0,-40.0,-36.0,-45.0,-51.0,-45.0,-35.0,-43.0,-47.0,-83.0,-83.0,-80.0,-79.0,43.0,47.0,35.0,28.0,1
6119,62:47:05:9D:EB:15,3837820,484094927,170,81381,3837650,484013546,0,288,56582,277,54416,11,2166,141,0,199,2,0,8,216660.0,130000.0,-45.0,-51.0,-49.0,-56.0,-47.0,-53.0,-50.0,-57.0,-83.0,-83.0,-80.0,-79.0,38.0,32.0,31.0,23.0,1
6120,3C:55:76:E8:8F:1F,3901073,643170285,63423,159156739,3837650,484013546,24,28252,6163825,27898,6102085,354,61740,12517,34,63494,6793,24,347,108330.0,65000.0,-46.0,-50.0,-41.0,-40.0,-49.0,-50.0,-41.0,-42.0,-83.0,-83.0,-80.0,-79.0,37.0,33.0,39.0,39.0,1
6121,92:69:1D:31:68:E9,3841592,487641646,3942,3628100,3837650,484013546,0,4892,1113797,4745,1080487,147,33310,2134,11,4157,90,0,47,216660.0,130000.0,-50.0,-51.0,-47.0,-50.0,-51.0,-48.0,-43.0,-49.0,-83.0,-83.0,-80.0,-79.0,33.0,32.0,33.0,29.0,1
6122,CC:2F:71:3F:1F:24,4693577,1413974284,855927,929960738,3837650,484013546,37,697017,738739244,696281,738650728,736,88516,671823,15,856184,90227,34,539,117000.0,39000.0,-68.0,-66.0,-67.0,-71.0,-68.0,-66.0,-66.0,-70.0,-83.0,-83.0,-80.0,-79.0,15.0,17.0,13.0,8.0,1
6123,CC:2F:71:3E:C5:1F,3838546,484123094,896,109548,3837650,484013546,0,3732,313578,3079,236080,653,77498,949,10,1285,22,0,45,144444.0,39000.0,-71.0,-71.0,-69.0,-61.0,-73.0,-73.0,-70.0,-62.0,-83.0,-83.0,-80.0,-79.0,12.0,12.0,11.0,18.0,1
6124,BA:8C:B9:54:50:24,3842502,490198165,4852,6184619,3837650,484013546,0,9100,1706777,9078,1703282,22,3495,2351,15,5303,39,0,60,229410.0,130000.0,-40.0,-36.0,-45.0,-51.0,-45.0,-35.0,-43.0,-47.0,-83.0,-83.0,-80.0,-79.0,43.0,47.0,35.0,28.0,1
6125,62:47:05:9D:EB:15,3837822,484095129,170,81381,3837652,484013748,0,288,56582,277,54416,11,2166,141,0,199,2,0,8,216660.0,130000.0,-45.0,-51.0,-49.0,-56.0,-47.0,-53.0,-50.0,-57.0,-83.0,-83.0,-80.0,-79.0,38.0,32.0,31.0,23.0,1
6126,3C:55:76:E8:8F:1F,3901081,643171694,63429,159157946,3837652,484013748,24,28277,6169677,27923,6107937,354,61740,12525,34,63500,6793,24,347,130000.0,1000.0,-45.0,-49.0,-45.0,-42.0,-47.0,-50.0,-45.0,-43.0,-83.0,-83.0,-80.0,-79.0,38.0,34.0,35.0,37.0,1
6127,92:69:1D:31:68:E9,3841598,487642252,3942,3628100,3837656,484014152,0,4892,1113797,4745,1080487,147,33310,2134,11,4157,90,0,47,216660.0,130000.0,-50.0,-51.0,-47.0,-50.0,-51.0,-48.0,-43.0,-49.0,-83.0,-83.0,-80.0,-79.0,33.0,32.0,33.0,29.0,1
6128,CC:2F:71:3F:1F:24,4693790,1414234616,856134,930220464,3837656,484014152,37,697214,738997988,696478,738909472,736,88516,672006,15,856391,90237,34,539,130000.0,43333.0,-68.0,-66.0,-67.0,-71.0,-68.0,-65.0,-67.0,-70.0,-83.0,-83.0,-80.0,-79.0,15.0,17.0,13.0,8.0,1
6129,CC:2F:71:3E:C5:1F,3838552,484123700,896,109548,3837656,484014152,0,3732,313578,3079,236080,653,77498,949,10,1285,22,0,45,144444.0,39000.0,-71.0,-71.0,-69.0,-61.0,-73.0,-73.0,-70.0,-62.0,-83.0,-83.0,-80.0,-79.0,12.0,12.0,11.0,18.0,1
6130,BA:8C:B9:54:50:24,3842508,490198771,4852,6184619,3837656,484014152,0,9100,1706777,9078,1703282,22,3495,2351,15,5303,39,0,60,229410.0,130000.0,-40.0,-36.0,-45.0,-51.0,-45.0,-35.0,-43.0,-47.0,-83.0,-83.0,-80.0,-79.0,43.0,47.0,35.0,28.0,1
6131,62:47:05:9D:EB:15,3837828,484095735,170,81381,3837658,484014354,0,288,56582,277,54416,11,2166,141,0,199,2,0,8,216660.0,130000.0,-45.0,-51.0,-49.0,-56.0,-47.0,-53.0,-50.0,-57.0,-83.0,-83.0,-80.0,-79.0,38.0,32.0,31.0,23.0,1
6132,3C:55:76:E8:8F:1F,3901090,643174795,63432,159160441,3837658,484014354,24,28291,6170808,27937,6109068,354,61740,12528,34,63503,6793,24,347,108330.0,1000.0,-48.0,-52.0,-46.0,-46.0,-47.0,-51.0,-44.0,-44.0,-83.0,-83.0,-80.0,-79.0,35.0,31.0,34.0,33.0,1
6133,92:69:1D:31:68:E9,3841600,487642454,3942,3628100,3837658,484014354,0,4892,1113797,4745,1080487,147,33310,2134,11,4157,90,0,47,216660.0,130000.0,-50.0,-51.0,-47.0,-50.0,-51.0,-48.0,-43.0,-49.0,-83.0,-83.0,-80.0,-79.0,33.0,32.0,33.0,29.0,1
6134,CC:2F:71:3F:1F:24,4694001,1414495124,856343,930480770,3837658,484014354,37,697400,739245172,696664,739156656,736,88516,672188,15,856600,90243,34,539,130000.0,43333.0,-68.0,-67.0,-69.0,-70.0,-68.0,-67.0,-68.0,-70.0,-83.0,-83.0,-80.0,-79.0,15.0,16.0,11.0,9.0,1
6135,CC:2F:71:3E:C5:1F,3838554,484123902,896,109548,3837658,484014354,0,3732,313578,3079,236080,653,77498,949,10,1285,22,0,45,144444.0,39000.0,-71.0,-71.0,-69.0,-61.0,-73.0,-73.0,-70.0,-62.0,-83.0,-83.0,-80.0,-79.0,12.0,12.0,11.0,18.0,1
6136,BA:8C:B9:54:50:24,3842510,490198973,4852,6184619,3837658,484014354,0,9100,1706777,9078,1703282,22,3495,2351,15,5303,39,0,60,229410.0,130000.0,-40.0,-36.0,-45.0,-51.0,-45.0,-35.0,-43.0,-47.0,-83.0,-83.0,-80.0,-79.0,43.0,47.0,35.0,28.0,1
6137,62:47:05:9D:EB:15,3837835,484096401,170,81381,3837665,484015020,0,288,56582,277,54416,11,2166,141,0,199,2,0,8,216660.0,130000.0,-45.0,-51.0,-49.0,-56.0,-47.0,-53.0,-50.0,-57.0,-83.0,-83.0,-80.0,-79.0,38.0,32.0,31.0,23.0,1
6138,3C:55:76:E8:8F:1F,3901100,643175955,63435,159160935,3837665,484015020,24,28307,6173826,27953,6112086,354,61740,12533,34,63506,6793,24,347,108330.0,65000.0,-50.0,-54.0,-45.0,-45.0,-49.0,-53.0,-44.0,-44.0,-83.0,-83.0,-80.0,-79.0,33.0,29.0,35.0,34.0,1
6139,92:69:1D:31:68:E9,3841607,487643120,3942,3628100,3837665,484015020,0,4892,1113797,4745,1080487,147,33310,2134,11,4157,90,0,47,216660.0,130000.0,-50.0,-51.0,-47.0,-50.0,-51.0,-48.0,-43.0,-49.0,-83.0,-83.0,-80.0,-79.0,33.0,32.0,33.0,29.0,1
6140,CC:2F:71:3F:1F:24,4694223,1414758989,856558,930743969,3837665,484015020,37,697596,739498226,696860,739409710,736,88516,672377,15,856815,90264,34,539,130000.0,43333.0,-69.0,-67.0,-69.0,-69.0,-69.0,-67.0,-68.0,-69.0,-83.0,-83.0,-80.0,-79.0,14.0,16.0,11.0,10.0,1
6141,CC:2F:71:3E:C5:1F,3838561,484124568,896,109548,3837665,484015020,0,3732,313578,3079,236080,653,77498,949,10,1285,22,0,45,144444.0,39000.0,-71.0,-71.0,-69.0,-61.0,-73.0,-73.0,-70.0,-62.0,-83.0,-83.0,-80.0,-79.0,12.0,12.0,11.0,18.0,1
6142,BA:8C:B9:54:50:24,3842517,490199639,4852,6184619,3837665,484015020,0,9100,1706777,9078,1703282,22,3495,2351,15,5303,39,0,60,229410.0,130000.0,-40.0,-36.0,-45.0,-51.0,-45.0,-35.0,-43.0,-47.0,-83.0,-83.0,-80.0,-79.0,43.0,47.0,35.0,28.0,1
6143,62:47:05:9D:EB:15,3837837,484096603,170,81381,3837667,484015222,0,288,56582,277,54416,11,2166,141,0,199,2,0,8,216660.0,130000.0,-45.0,-51.0,-49.0,-56.0,-47.0,-53.0,-50.0,-57.0,-83.0,-83.0,-80.0,-79.0,38.0,32.0,31.0,23.0,1
6144,3C:55:76:E8:8F:1F,3901105,643176894,63438,159161672,3837667,484015222,24,28315,6176869,27961,6115129,354,61740,12537,34,63509,6793,24,347,108330.0,1000.0,-46.0,-51.0,-50.0,-41.0,-47.0,-51.0,-47.0,-41.0,-83.0,-83.0,-80.0,-79.0,37.0,32.0,30.0,38.0,1
6145,92:69:1D:31:68:E9,3841609,487643322,3942,3628100,3837667,484015222,0,4892,1113797,4745,1080487,147,33310,2134,11,4157,90,0,47,216660.0,130000.0,-50.0,-51.0,-47.0,-50.0,-51.0,-48.0,-43.0,-49.0,-83.0,-83.0,-80.0,-79.0,33.0,32.0,33.0,29.0,1
6146,CC:2F:71:3F:1F:24,4694434,1415019497,856767,931004275,3837667,484015222,37,697787,739749102,697051,739660586,736,88516,672560,15,857024,90267,34,539,130000.0,43333.0,-68.0,-67.0,-68.0,-70.0,-68.0,-67.0,-68.0,-69.0,-83.0,-83.0,-80.0,-79.0,15.0,16.0,12.0,9.0,1
6147,CC:2F:71:3E:C5:1F,3838563,484124770,896,109548,3837667,484015222,0,3732,313578,3079,236080,653,77498,949,10,1285,22,0,45,144444.0,39000.0,-71.0,-71.0,-69.0,-61.0,-73.0,-73.0,-70.0,-62.0,-83.0,-83.0,-80.0,-79.0,12.0,12.0,11.0,18.0,1
6148,BA:8C:B9:54:50:24,3842519,490199841,4852,6184619,3837667,484015222,0,9100,1706777,9078,1703282,22,3495,2351,15,5303,39,0,60,229410.0,130000.0,-40.0,-36.0,-45.0,-51.0,-45.0,-35.0,-43.0,-47.0,-83.0,-83.0,-80.0,-79.0,43.0,47.0,35.0,28.0,1
6149,62:47:05:9D:EB:15,3837844,484097269,170,81381,3837674,484015888,0,288,56582,277,54416,11,2166,141,0,199,2,0,8,216660.0,130000.0,-45.0,-51.0,-49.0,-56.0,-47.0,-53.0,-50.0,-57.0,-83.0,-83.0,-80.0,-79.0,38.0,32.0,31.0,23.0,1
6150,3C:55:76:E8:8F:1F,3901115,643177995,63441,159162107,3837674,484015888,24,28329,6178842,27975,6117102,354,61740,12541,34,63512,6793,24,347,97500.0,1000.0,-46.0,-50.0,-50.0,-41.0,-46.0,-52.0,-47.0,-42.0,-83.0,-83.0,-80.0,-79.0,37.0,33.0,30.0,38.0,1
6151,92:69:1D:31:68:E9,3841616,487643988,3942,3628100,3837674,484015888,0,4892,1113797,4745,1080487,147,33310,2134,11,4157,90,0,47,216660.0,130000.0,-50.0,-51.0,-47.0,-50.0,-51.0,-48.0,-43.0,-49.0,-83.0,-83.0,-80.0,-79.0,33.0,32.0,33.0,29.0,1
6152,CC:2F:71:3F:1F:24,4694650,1415280301,856976,931264413,3837674,484015888,37,697976,739996652,697240,739908136,736,88516,672746,15,857233,90278,34,539,130000.0,43333.0,-66.0,-68.0,-67.0,-71.0,-66.0,-67.0,-67.0,-70.0,-83.0,-83.0,-80.0,-79.0,17.0,15.0,13.0,8.0,1
6153,CC:2F:71:3E:C5:1F,3838572,484125638,896,109548,3837676,484016090,0,3732,313578,3079,236080,653,77498,949,10,1285,22,0,45,144444.0,39000.0,-71.0,-71.0,-69.0,-61.0,-73.0,-73.0,-70.0,-62.0,-83.0,-83.0,-80.0,-79.0,12.0,12.0,11.0,18.0,1
6154,BA:8C:B9:54:50:24,3842528,490200709,4852,6184619,3837676,484016090,0,9100,1706777,9078,1703282,22,3495,2351,15,5303,39,0,60,229410.0,130000.0,-40.0,-36.0,-45.0,-51.0,-45.0,-35.0,-43.0,-47.0,-83.0,-83.0,-80.0,-79.0,43.0,47.0,35.0,28.0,1
6155,62:47:05:9D:EB:15,3837846,484097471,170,81381,3837676,484016090,0,288,56582,277,54416,11,2166,141,0,199,2,0,8,216660.0,130000.0,-45.0,-51.0,-49.0,-56.0,-47.0,-53.0,-50.0,-57.0,-83.0,-83.0,-80.0,-79.0,38.0,32.0,31.0,23.0,1
6156,3C:55:76:E8:8F:1F,3901118,643178313,63442,159162223,3837676,484016090,24,28336,6179320,27982,6117580,354,61740,12541,34,63512,6793,24,347,97500.0,1000.0,-42.0,-46.0,-46.0,-38.0,-44.0,-48.0,-49.0,-40.0,-83.0,-83.0,-80.0,-79.0,41.0,37.0,34.0,41.0,1
6157,92:69:1D:31:68:E9,3841619,487644306,3943,3628216,3837676,484016090,0,4894,1113933,4747,1080623,147,33310,2134,11,4158,90,0,47,216660.0,130000.0,-50.0,-50.0,-47.0,-49.0,-51.0,-48.0,-44.0,-49.0,-83.0,-83.0,-80.0,-79.0,33.0,33.0,33.0,30.0,1
6158,CC:2F:71:3F:1F:24,4694867,1415550247,857191,931534157,3837676,484016090,37,698171,740253436,697435,740164920,736,88516,672937,15,857448,90281,34,539,130000.0,43333.0,-68.0,-67.0,-68.0,-69.0,-67.0,-67.0,-67.0,-69.0,-83.0,-83.0,-80.0,-79.0,15.0,16.0,12.0,10.0,1
6159,CC:2F:71:3E:C5:1F,3838573,484125754,897,109664,3837676,484016090,0,3734,313718,3081,236220,653,77498,949,10,1286,22,0,45,144444.0,43333.0,-70.0,-71.0,-69.0,-61.0,-72.0,-73.0,-69.0,-62.0,-83.0,-83.0,-80.0,-79.0,13.0,12.0,11.0,18.0,1
6160,BA:8C:B9:54:50:24,3842529,490200825,4853,6184735,3837676,484016090,0,9102,1706913,9080,1703418,22,3495,2351,15,5304,39,0,60,229410.0,130000.0,-48.0,-35.0,-42.0,-45.0,-44.0,-36.0,-44.0,-48.0,-83.0,-83.0,-80.0,-79.0,35.0,48.0,38.0,34.0,1
6161,62:47:05:9D:EB:15,3837856,484098455,171,81497,3837685,484016958,0,290,56718,279,54552,11,2166,141,0,200,2,0,8,216660.0,130000.0,-45.0,-55.0,-51.0,-50.0,-46.0,-53.0,-50.0,-55.0,-83.0,-83.0,-80.0,-79.0,38.0,28.0,29.0,29.0,1
6162,3C:55:76:E8:8F:1F,3901127,643179181,63442,159162223,3837685,484016958,24,28347,6180072,27993,6118332,354,61740,12541,34,63513,6793,24,347,97500.0,48750.0,-52.0,-62.0,-52.0,-46.0,-45.0,-49.0,-47.0,-41.0,-83.0,-83.0,-80.0,-79.0,31.0,21.0,28.0,33.0,1
6163,92:69:1D:31:68:E9,3841628,487645174,3943,3628216,3837685,484016958,0,4894,1113933,4747,1080623,147,33310,2134,11,4158,90,0,47,216660.0,130000.0,-50.0,-50.0,-47.0,-49.0,-51.0,-48.0,-44.0,-49.0,-83.0,-83.0,-80.0,-79.0,33.0,33.0,33.0,30.0,1
6164,CC:2F:71:3F:1F:24,4695094,1415817488,857409,931800530,3837685,484016958,37,698371,740509824,697635,740421308,736,88516,673131,15,857666,90343,34,540,117000.0,39000.0,-68.0,-67.0,-67.0,-70.0,-68.0,-67.0,-67.0,-70.0,-83.0,-83.0,-80.0,-79.0,15.0,16.0,13.0,9.0,1
6165,CC:2F:71:3E:C5:1F,3838582,484126622,897,109664,3837685,484016958,0,3734,313718,3081,236220,653,77498,949,10,1286,22,0,45,144444.0,43333.0,-70.0,-71.0,-69.0,-61.0,-72.0,-73.0,-69.0,-62.0,-83.0,-83.0,-80.0,-79.0,13.0,12.0,11.0,18.0,1
6166,BA:8C:B9:54:50:24,3842538,490201693,4853,6184735,3837685,484016958,0,9102,1706913,9080,1703418,22,3495,2351,15,5304,39,0,60,229410.0,130000.0,-48.0,-35.0,-42.0,-45.0,-44.0,-36.0,-44.0,-48.0,-83.0,-83.0,-80.0,-79.0,35.0,48.0,38.0,34.0,1
6167,62:47:05:9D:EB:15,3837858,484098790,171,81497,3837687,484017293,0,290,56718,279,54552,11,2166,141,0,200,2,0,8,216660.0,130000.0,-45.0,-55.0,-51.0,-50.0,-46.0,-53.0,-50.0,-55.0,-83.0,-83.0,-80.0,-79.0,38.0,28.0,29.0,29.0,1
6168,3C:55:76:E8:8F:1F,3901129,643179516,63442,159162223,3837687,484017293,24,28347,6180072,27993,6118332,354,61740,12541,34,63513,6793,24,347,97500.0,48750.0,-52.0,-62.0,-52.0,-46.0,-45.0,-49.0,-47.0,-41.0,-83.0,-83.0,-80.0,-79.0,31.0,21.0,28.0,33.0,1
6169,92:69:1D:31:68:E9,3841630,487645509,3943,3628216,3837687,484017293,0,4894,1113933,4747,1080623,147,33310,2134,11,4158,90,0,47,216660.0,130000.0,-50.0,-50.0,-47.0,-49.0,-51.0,-48.0,-44.0,-49.0,-83.0,-83.0,-80.0,-79.0,33.0,33.0,33.0,30.0,1
6170,CC:2F:71:3F:1F:24,4695306,1416080995,857619,932063702,3837687,484017293,37,698562,740760422,697825,740671788,737,88634,673318,15,857876,90373,34,540,130000.0,43333.0,-69.0,-68.0,-67.0,-71.0,-68.0,-68.0,-67.0,-71.0,-83.0,-83.0,-80.0,-79.0,14.0,15.0,13.0,8.0,1
6171,CC:2F:71:3E:C5:1F,3838586,484127159,897,109664,3837689,484017495,0,3734,313718,3081,236220,653,77498,949,10,1286,22,0,45,144444.0,43333.0,-70.0,-71.0,-69.0,-61.0,-72.0,-73.0,-69.0,-62.0,-83.0,-83.0,-80.0,-79.0,13.0,12.0,11.0,18.0,1
6172,BA:8C:B9:54:50:24,3842544,490202432,4853,6184735,3837691,484017697,0,9102,1706913,9080,1703418,22,3495,2351,15,5304,39,0,60,229410.0,130000.0,-48.0,-35.0,-42.0,-45.0,-44.0,-36.0,-44.0,-48.0,-83.0,-83.0,-80.0,-79.0,35.0,48.0,38.0,34.0,1
6173,62:47:05:9D:EB:15,3837866,484099598,171,81497,3837695,484018101,0,290,56718,279,54552,11,2166,141,0,200,2,0,8,216660.0,130000.0,-45.0,-55.0,-51.0,-50.0,-46.0,-53.0,-50.0,-55.0,-83.0,-83.0,-80.0,-79.0,38.0,28.0,29.0,29.0,1
6174,3C:55:76:E8:8F:1F,3901466,643895546,63771,159877445,3837695,484018101,24,28540,6244296,28186,6182556,354,61740,12632,35,63838,6809,24,354,108330.0,65000.0,-50.0,-52.0,-48.0,-48.0,-49.0,-52.0,-47.0,-47.0,-83.0,-83.0,-80.0,-79.0,33.0,31.0,32.0,31.0,1
6175,92:69:1D:31:68:E9,3841639,487646377,3943,3628216,3837696,484018161,0,4894,1113933,4747,1080623,147,33310,2134,11,4158,90,0,47,216660.0,130000.0,-50.0,-50.0,-47.0,-49.0,-51.0,-48.0,-44.0,-49.0,-83.0,-83.0,-80.0,-79.0,33.0,33.0,33.0,30.0,1
6176,CC:2F:71:3F:1F:24,4695550,1416382533,857854,932364372,3837696,484018161,37,698780,741054320,698043,740965686,737,88634,673527,15,858111,90383,34,541,130000.0,39000.0,-67.0,-66.0,-68.0,-72.0,-67.0,-66.0,-67.0,-72.0,-83.0,-83.0,-80.0,-79.0,16.0,17.0,12.0,7.0,1
6177,CC:2F:71:3E:C5:1F,3838593,484127825,897,109664,3837696,484018161,0,3734,313718,3081,236220,653,77498,949,10,1286,22,0,45,144444.0,43333.0,-70.0,-71.0,-69.0,-61.0,-72.0,-73.0,-69.0,-62.0,-83.0,-83.0,-80.0,-79.0,13.0,12.0,11.0,18.0,1
6178,BA:8C:B9:54:50:24,3842549,490202896,4853,6184735,3837696,484018161,0,9102,1706913,9080,1703418,22,3495,2351,15,5304,39,0,60,229410.0,130000.0,-48.0,-35.0,-42.0,-45.0,-44.0,-36.0,-44.0,-48.0,-83.0,-83.0,-80.0,-79.0,35.0,48.0,38.0,34.0,1
6179,62:47:05:9D:EB:15,3837874,484100326,171,81497,3837703,484018829,0,290,56718,279,54552,11,2166,141,0,200,2,0,8,216660.0,130000.0,-45.0,-55.0,-51.0,-50.0,-46.0,-53.0,-50.0,-55.0,-83.0,-83.0,-80.0,-79.0,38.0,28.0,29.0,29.0,1
6180,3C:55:76:E8:8F:1F,3902434,646372015,64731,162353186,3837703,484018829,24,28856,6295246,28501,6233388,355,61858,12814,35,64803,6907,24,355,77420.0,1000.0,-45.0,-53.0,-43.0,-41.0,-49.0,-52.0,-45.0,-45.0,-83.0,-83.0,-80.0,-79.0,38.0,30.0,37.0,38.0,1
6181,92:69:1D:31:68:E9,3841648,487647247,3943,3628216,3837705,484019031,0,4894,1113933,4747,1080623,147,33310,2134,11,4158,90,0,47,216660.0,130000.0,-50.0,-50.0,-47.0,-49.0,-51.0,-48.0,-44.0,-49.0,-83.0,-83.0,-80.0,-79.0,33.0,33.0,33.0,30.0,1
6182,CC:2F:71:3F:1F:24,4695808,1416699903,858103,932680872,3837705,484019031,37,699015,741366709,698278,741278075,737,88634,673749,15,858360,90411,34,541,144444.0,43333.0,-68.0,-65.0,-67.0,-71.0,-68.0,-65.0,-67.0,-70.0,-83.0,-83.0,-80.0,-79.0,15.0,18.0,13.0,8.0,1
6183,CC:2F:71:3E:C5:1F,3838602,484128695,897,109664,3837705,484019031,0,3734,313718,3081,236220,653,77498,949,10,1286,22,0,45,144444.0,43333.0,-70.0,-71.0,-69.0,-61.0,-72.0,-73.0,-69.0,-62.0,-83.0,-83.0,-80.0,-79.0,13.0,12.0,11.0,18.0,1
6184,BA:8C:B9:54:50:24,3842558,490203766,4853,6184735,3837705,484019031,0,9102,1706913,9080,1703418,22,3495,2351,15,5304,39,0,60,229410.0,130000.0,-48.0,-35.0,-42.0,-45.0,-44.0,-36.0,-44.0,-48.0,-83.0,-83.0,-80.0,-79.0,35.0,48.0,38.0,34.0,1
6185,62:47:05:9D:EB:15,3837876,484100528,171,81497,3837705,484019031,0,290,56718,279,54552,11,2166,141,0,200,2,0,8,216660.0,130000.0,-45.0,-55.0,-51.0,-50.0,-46.0,-53.0,-50.0,-55.0,-83.0,-83.0,-80.0,-79.0,38.0,28.0,29.0,29.0,1
6186,3C:55:76:E8:8F:1F,3902436,646372217,64731,162353186,3837705,484019031,24,28865,6295860,28510,6234002,355,61858,12814,35,64803,6907,24,355,77420.0,1000.0,-45.0,-52.0,-43.0,-41.0,-45.0,-52.0,-43.0,-41.0,-83.0,-83.0,-80.0,-79.0,38.0,31.0,37.0,38.0,1
6187,92:69:1D:31:68:E9,3841648,487647247,3943,3628216,3837705,484019031,0,4894,1113933,4747,1080623,147,33310,2134,11,4158,90,0,47,216660.0,130000.0,-50.0,-50.0,-47.0,-49.0,-51.0,-48.0,-44.0,-49.0,-83.0,-83.0,-80.0,-79.0,33.0,33.0,33.0,30.0,1
6188,CC:2F:71:3F:1F:24,4696016,1416960079,858311,932941048,3837705,484019031,37,699203,741618329,698466,741529695,737,88634,673931,15,858568,90414,34,541,144444.0,43333.0,-70.0,-66.0,-68.0,-67.0,-70.0,-66.0,-68.0,-69.0,-83.0,-83.0,-80.0,-79.0,13.0,17.0,12.0,12.0,1
6189,CC:2F:71:3E:C5:1F,3838602,484128695,897,109664,3837705,484019031,0,3734,313718,3081,236220,653,77498,949,10,1286,22,0,45,144444.0,43333.0,-70.0,-71.0,-69.0,-61.0,-72.0,-73.0,-69.0,-62.0,-83.0,-83.0,-80.0,-79.0,13.0,12.0,11.0,18.0,1
6190,BA:8C:B9:54:50:24,3842559,490203826,4853,6184735,3837706,484019091,0,9102,1706913,9080,1703418,22,3495,2351,15,5304,39,0,60,229410.0,130000.0,-48.0,-35.0,-42.0,-45.0,-44.0,-36.0,-44.0,-48.0,-83.0,-83.0,-80.0,-79.0,35.0,48.0,38.0,34.0,1
6191,62:47:05:9D:EB:15,3837885,484101396,171,81497,3837714,484019899,0,290,56718,279,54552,11,2166,141,0,200,2,0,8,216660.0,130000.0,-45.0,-55.0,-51.0,-50.0,-46.0,-53.0,-50.0,-55.0,-83.0,-83.0,-80.0,-79.0,38.0,28.0,29.0,29.0,1
6192,3C:55:76:E8:8F:1F,3902453,646374723,64739,162354824,3837714,484019899,24,28894,6300418,28539,6238560,355,61858,12823,35,64811,6907,24,355,77420.0,24370.0,-52.0,-54.0,-46.0,-43.0,-50.0,-52.0,-43.0,-42.0,-83.0,-83.0,-80.0,-79.0,31.0,29.0,34.0,36.0,1
6193,92:69:1D:31:68:E9,3841657,487648115,3943,3628216,3837714,484019899,0,4894,1113933,4747,1080623,147,33310,2134,11,4158,90,0,47,216660.0,130000.0,-50.0,-50.0,-47.0,-49.0,-51.0,-48.0,-44.0,-49.0,-83.0,-83.0,-80.0,-79.0,33.0,33.0,33.0,30.0,1
6194,CC:2F:71:3F:1F:24,4696233,1417223915,858519,933204016,3837714,484019899,37,699394,741870407,698657,741781773,737,88634,674115,15,858776,90457,34,541,130000.0,43333.0,-68.0,-66.0,-67.0,-70.0,-68.0,-65.0,-66.0,-70.0,-83.0,-83.0,-80.0,-79.0,15.0,17.0,13.0,9.0,1
6195,CC:2F:71:3E:C5:1F,3838611,484129563,897,109664,3837714,484019899,0,3734,313718,3081,236220,653,77498,949,10,1286,22,0,45,144444.0,43333.0,-70.0,-71.0,-69.0,-61.0,-72.0,-73.0,-69.0,-62.0,-83.0,-83.0,-80.0,-79.0,13.0,12.0,11.0,18.0,1
6196,BA:8C:B9:54:50:24,3842567,490204634,4853,6184735,3837714,484019899,0,9102,1706913,9080,1703418,22,3495,2351,15,5304,39,0,60,229410.0,130000.0,-48.0,-35.0,-42.0,-45.0,-44.0,-36.0,-44.0,-48.0,-83.0,-83.0,-80.0,-79.0,35.0,48.0,38.0,34.0,1
6197,62:47:05:9D:EB:15,3837885,484101396,171,81497,3837714,484019899,0,290,56718,279,54552,11,2166,141,0,200,2,0,8,216660.0,130000.0,-45.0,-55.0,-51.0,-50.0,-46.0,-53.0,-50.0,-55.0,-83.0,-83.0,-80.0,-79.0,38.0,28.0,29.0,29.0,1
6198,3C:55:76:E8:8F:1F,3902453,646374723,64739,162354824,3837714,484019899,24,28894,6300418,28539,6238560,355,61858,12823,35,64811,6907,24,355,77420.0,24370.0,-52.0,-54.0,-46.0,-43.0,-50.0,-52.0,-43.0,-42.0,-83.0,-83.0,-80.0,-79.0,31.0,29.0,34.0,36.0,1
6199,92:69:1D:31:68:E9,3841657,487648115,3943,3628216,3837714,484019899,0,4894,1113933,4747,1080623,147,33310,2134,11,4158,90,0,47,216660.0,130000.0,-50.0,-50.0,-47.0,-49.0,-51.0,-48.0,-44.0,-49.0,-83.0,-83.0,-80.0,-79.0,33.0,33.0,33.0,30.0,1
6200,CC:2F:71:3F:1F:24,4696444,1417485618,858730,933465719,3837714,484019899,37,699588,742119056,698851,742030422,737,88634,674304,15,858986,90482,34,541,130000.0,43333.0,-68.0,-66.0,-66.0,-71.0,-68.0,-66.0,-66.0,-70.0,-83.0,-83.0,-80.0,-79.0,15.0,17.0,14.0,8.0,1
6201,CC:2F:71:3E:C5:1F,3838611,484129563,897,109664,3837714,484019899,0,3734,313718,3081,236220,653,77498,949,10,1286,22,0,45,144444.0,43333.0,-70.0,-71.0,-69.0,-61.0,-72.0,-73.0,-69.0,-62.0,-83.0,-83.0,-80.0,-79.0,13.0,12.0,11.0,18.0,1
6202,BA:8C:B9:54:50:24,3842569,490204836,4853,6184735,3837716,484020101,0,9102,1706913,9080,1703418,22,3495,2351,15,5304,39,0,60,229410.0,130000.0,-48.0,-35.0,-42.0,-45.0,-44.0,-36.0,-44.0,-48.0,-83.0,-83.0,-80.0,-79.0,35.0,48.0,38.0,34.0,1
6203,62:47:05:9D:EB:15,3837894,484102264,171,81497,3837723,484020767,0,292,56854,281,54688,11,2166,141,0,201,2,0,8,216660.0,130000.0,-48.0,-52.0,-54.0,-51.0,-46.0,-52.0,-51.0,-53.0,-83.0,-83.0,-80.0,-79.0,35.0,31.0,26.0,28.0,1
6204,3C:55:76:E8:8F:1F,3902467,646376312,64744,162355545,3837723,484020767,24,28914,6303066,28559,6241208,355,61858,12829,35,64816,6907,24,355,77420.0,25800.0,-53.0,-54.0,-44.0,-43.0,-52.0,-53.0,-43.0,-42.0,-83.0,-83.0,-80.0,-79.0,30.0,29.0,36.0,36.0,1
6205,92:69:1D:31:68:E9,3841666,487648983,3943,3628216,3837723,484020767,0,4897,1114137,4750,1080827,147,33310,2134,11,4159,90,0,47,216660.0,130000.0,-52.0,-49.0,-43.0,-49.0,-51.0,-49.0,-44.0,-48.0,-83.0,-83.0,-80.0,-79.0,31.0,34.0,37.0,30.0,1
6206,CC:2F:71:3F:1F:24,4696661,1417747862,858938,933727095,3837723,484020767,37,699777,742370906,699040,742282272,737,88634,674488,15,859195,90519,34,541,130000.0,43333.0,-68.0,-66.0,-67.0,-71.0,-68.0,-66.0,-66.0,-70.0,-83.0,-83.0,-80.0,-79.0,15.0,17.0,13.0,8.0,1
6207,CC:2F:71:3E:C5:1F,3838620,484130431,897,109664,3837723,484020767,0,3736,313858,3083,236360,653,77498,949,10,1287,22,0,45,144444.0,43333.0,-70.0,-71.0,-69.0,-61.0,-71.0,-71.0,-69.0,-61.0,-83.0,-83.0,-80.0,-79.0,13.0,12.0,11.0,18.0,1
6208,BA:8C:B9:54:50:24,3842576,490205502,4853,6184735,3837723,484020767,0,9106,1707185,9084,1703690,22,3495,2351,16,5305,40,0,60,229410.0,130000.0,-40.0,-36.0,-45.0,-51.0,-42.0,-35.0,-44.0,-49.0,-83.0,-83.0,-80.0,-79.0,43.0,47.0,35.0,28.0,1
6209,62:47:05:9D:EB:15,3837894,484102264,171,81497,3837723,484020767,0,292,56854,281,54688,11,2166,141,0,201,2,0,8,216660.0,130000.0,-48.0,-52.0,-54.0,-51.0,-46.0,-52.0,-51.0,-53.0,-83.0,-83.0,-80.0,-79.0,35.0,31.0,26.0,28.0,1
6210,3C:55:76:E8:8F:1F,3902475,646377808,64750,162356839,3837725,484020969,24,28933,6309366,28578,6247508,355,61858,12836,35,64822,6907,24,355,81250.0,1000.0,-53.0,-52.0,-43.0,-42.0,-52.0,-51.0,-43.0,-42.0,-83.0,-83.0,-80.0,-79.0,30.0,31.0,37.0,37.0,1
6211,92:69:1D:31:68:E9,3841668,487649185,3943,3628216,3837725,484020969,0,4897,1114137,4750,1080827,147,33310,2134,11,4159,90,0,47,216660.0,130000.0,-52.0,-49.0,-43.0,-49.0,-51.0,-49.0,-44.0,-48.0,-83.0,-83.0,-80.0,-79.0,31.0,34.0,37.0,30.0,1
6212,CC:2F:71:3F:1F:24,4696870,1418008110,859145,933987141,3837725,484020969,37,699969,742623416,699232,742534782,737,88634,674671,15,859402,90534,34,541,130000.0,43333.0,-68.0,-66.0,-66.0,-71.0,-68.0,-66.0,-66.0,-69.0,-83.0,-83.0,-80.0,-79.0,15.0,17.0,14.0,8.0,1
6213,CC:2F:71:3E:C5:1F,3838625,484130897,897,109664,3837728,484021233,0,3737,313976,3083,236360,654,77616,950,10,1287,22,0,45,144444.0,43333.0,-71.0,-71.0,-70.0,-61.0,-70.0,-70.0,-68.0,-60.0,-83.0,-83.0,-80.0,-79.0,12.0,12.0,10.0,18.0,1
6214,BA:8C:B9:54:50:24,3842581,490205968,4853,6184735,3837728,484021233,0,9106,1707185,9084,1703690,22,3495,2351,16,5305,40,0,60,229410.0,130000.0,-40.0,-36.0,-45.0,-51.0,-42.0,-35.0,-44.0,-49.0,-83.0,-83.0,-80.0,-79.0,43.0,47.0,35.0,28.0,1
6215,62:47:05:9D:EB:15,3837904,484103194,171,81497,3837733,484021697,0,292,56854,281,54688,11,2166,141,0,201,2,0,8,216660.0,130000.0,-48.0,-52.0,-54.0,-51.0,-46.0,-52.0,-51.0,-53.0,-83.0,-83.0,-80.0,-79.0,35.0,31.0,26.0,28.0,1
6216,3C:55:76:E8:8F:1F,3902524,646394208,64791,162372511,3837733,484021697,24,29008,6335088,28653,6273230,355,61858,12872,35,64863,6913,24,355,73120.0,1000.0,-54.0,-53.0,-44.0,-43.0,-52.0,-54.0,-44.0,-42.0,-83.0,-83.0,-80.0,-79.0,29.0,30.0,36.0,36.0,1
6217,92:69:1D:31:68:E9,3841676,487649913,3943,3628216,3837733,484021697,0,4897,1114137,4750,1080827,147,33310,2134,11,4159,90,0,47,216660.0,130000.0,-52.0,-49.0,-43.0,-49.0,-51.0,-49.0,-44.0,-48.0,-83.0,-83.0,-80.0,-79.0,31.0,34.0,37.0,30.0,1
6218,CC:2F:71:3F:1F:24,4697085,1418271508,859352,934249811,3837733,484021697,37,700160,742878232,699423,742789598,737,88634,674856,15,859609,90544,34,541,130000.0,43333.0,-67.0,-66.0,-66.0,-71.0,-67.0,-66.0,-66.0,-70.0,-83.0,-83.0,-80.0,-79.0,16.0,17.0,14.0,8.0,1
6219,CC:2F:71:3E:C5:1F,3838630,484131361,897,109664,3837733,484021697,0,3738,314046,3084,236430,654,77616,950,10,1287,22,0,45,144444.0,43333.0,-78.0,-81.0,-75.0,-71.0,-71.0,-72.0,-69.0,-62.0,-83.0,-83.0,-80.0,-79.0,5.0,2.0,5.0,8.0,1
6220,BA:8C:B9:54:50:24,3842586,490206432,4853,6184735,3837733,484021697,0,9106,1707185,9084,1703690,22,3495,2351,16,5305,40,0,60,229410.0,130000.0,-40.0,-36.0,-45.0,-51.0,-42.0,-35.0,-44.0,-49.0,-83.0,-83.0,-80.0,-79.0,43.0,47.0,35.0,28.0,1
6221,62:47:05:9D:EB:15,3837922,484109321,171,81497,3837751,484027824,0,292,56854,281,54688,11,2166,141,0,201,2,0,8,216660.0,130000.0,-48.0,-52.0,-54.0,-51.0,-46.0,-52.0,-51.0,-53.0,-83.0,-83.0,-80.0,-79.0,35.0,31.0,26.0,28.0,1
6222,3C:55:76:E8:8F:1F,3902553,646405759,64791,162372511,3837762,484033248,24,29019,6335942,28662,6273848,357,62094,12874,35,64863,6913,24,355,73120.0,1000.0,-44.0,-51.0,-52.0,-37.0,-49.0,-51.0,-44.0,-40.0,-83.0,-83.0,-80.0,-79.0,39.0,32.0,28.0,42.0,1
6223,92:69:1D:31:68:E9,3841709,487661868,3943,3628216,3837766,484033652,0,4900,1114508,4752,1080963,148,33545,2135,11,4159,90,0,47,216660.0,130000.0,-52.0,-49.0,-43.0,-49.0,-51.0,-49.0,-44.0,-48.0,-83.0,-83.0,-80.0,-79.0,31.0,34.0,37.0,30.0,1
6224,CC:2F:71:3F:1F:24,4697339,1418559282,859573,934525630,3837766,484033652,37,700363,743139223,699626,743050589,737,88634,675055,15,859830,90544,34,541,130000.0,43333.0,-67.0,-66.0,-67.0,-71.0,-66.0,-65.0,-66.0,-70.0,-83.0,-83.0,-80.0,-79.0,16.0,17.0,13.0,8.0,1
6225,CC:2F:71:3E:C5:1F,3838663,484143316,897,109664,3837766,484033652,0,3738,314046,3084,236430,654,77616,950,10,1287,22,0,45,144444.0,43333.0,-78.0,-81.0,-75.0,-71.0,-71.0,-72.0,-69.0,-62.0,-83.0,-83.0,-80.0,-79.0,5.0,2.0,5.0,8.0,1
6226,BA:8C:B9:54:50:24,3842619,490218387,4853,6184735,3837766,484033652,0,9106,1707185,9084,1703690,22,3495,2351,16,5305,40,0,60,229410.0,130000.0,-40.0,-36.0,-45.0,-51.0,-42.0,-35.0,-44.0,-49.0,-83.0,-83.0,-80.0,-79.0,43.0,47.0,35.0,28.0,1
6227,62:47:05:9D:EB:15,3837940,484115877,174,82225,3837766,484033652,0,298,57569,287,55403,11,2166,143,0,204,2,0,8,216660.0,130000.0,-50.0,-55.0,-55.0,-51.0,-48.0,-54.0,-53.0,-51.0,-83.0,-83.0,-80.0,-79.0,33.0,28.0,25.0,28.0,1
6228,3C:55:76:E8:8F:1F,3902557,646406163,64791,162372511,3837766,484033652,24,29028,6336556,28671,6274462,357,62094,12874,35,64863,6913,24,356,73120.0,1000.0,-46.0,-53.0,-57.0,-40.0,-44.0,-51.0,-54.0,-38.0,-83.0,-83.0,-80.0,-79.0,37.0,30.0,23.0,39.0,1
6229,92:69:1D:31:68:E9,3841709,487661868,3943,3628216,3837766,484033652,0,4900,1114508,4752,1080963,148,33545,2135,11,4159,90,0,47,216660.0,130000.0,-52.0,-49.0,-43.0,-49.0,-51.0,-49.0,-44.0,-48.0,-83.0,-83.0,-80.0,-79.0,31.0,34.0,37.0,30.0,1
6230,CC:2F:71:3F:1F:24,4697545,1418820622,859779,934786970,3837766,484033652,37,700550,743386565,699813,743297931,737,88634,675237,15,860036,90544,34,543,130000.0,43333.0,-66.0,-66.0,-66.0,-70.0,-66.0,-65.0,-66.0,-70.0,-83.0,-83.0,-80.0,-79.0,17.0,17.0,14.0,9.0,1
6231,CC:2F:71:3E:C5:1F,3838664,484143376,897,109664,3837767,484033712,0,3738,314046,3084,236430,654,77616,950,10,1287,22,0,45,144444.0,43333.0,-78.0,-81.0,-75.0,-71.0,-71.0,-72.0,-69.0,-62.0,-83.0,-83.0,-80.0,-79.0,5.0,2.0,5.0,8.0,1
6232,BA:8C:B9:54:50:24,3842620,490218447,4853,6184735,3837767,484033712,0,9106,1707185,9084,1703690,22,3495,2351,16,5305,40,0,60,229410.0,130000.0,-40.0,-36.0,-45.0,-51.0,-42.0,-35.0,-44.0,-49.0,-83.0,-83.0,-80.0,-79.0,43.0,47.0,35.0,28.0,1
6233,62:47:05:9D:EB:15,3837954,484117694,177,82823,3837777,484034871,0,303,58210,291,55906,12,2304,146,0,207,2,0,8,216660.0,130000.0,-55.0,-57.0,-56.0,-55.0,-52.0,-55.0,-55.0,-53.0,-83.0,-83.0,-80.0,-79.0,28.0,26.0,24.0,24.0,1
6234,3C:55:76:E8:8F:1F,3902568,646407382,64791,162372511,3837777,484034871,24,29028,6336556,28671,6274462,357,62094,12874,35,64863,6913,24,356,73120.0,1000.0,-46.0,-53.0,-57.0,-40.0,-44.0,-51.0,-54.0,-38.0,-83.0,-83.0,-80.0,-79.0,37.0,30.0,23.0,39.0,1
6235,92:69:1D:31:68:E9,3841720,487663087,3943,3628216,3837777,484034871,0,4900,1114508,4752,1080963,148,33545,2135,11,4159,90,0,47,216660.0,130000.0,-52.0,-49.0,-43.0,-49.0,-51.0,-49.0,-44.0,-48.0,-83.0,-83.0,-80.0,-79.0,31.0,34.0,37.0,30.0,1
6236,CC:2F:71:3F:1F:24,4697764,1419083289,859987,935048418,3837777,484034871,37,700739,743639725,700002,743551091,737,88634,675420,15,860244,90548,34,543,144444.0,43333.0,-66.0,-66.0,-66.0,-71.0,-66.0,-65.0,-66.0,-70.0,-83.0,-83.0,-80.0,-79.0,17.0,17.0,14.0,8.0,1
6237,CC:2F:71:3E:C5:1F,3838674,484144535,897,109664,3837777,484034871,0,3738,314046,3084,236430,654,77616,950,10,1287,22,0,45,144444.0,43333.0,-78.0,-81.0,-75.0,-71.0,-71.0,-72.0,-69.0,-62.0,-83.0,-83.0,-80.0,-79.0,5.0,2.0,5.0,8.0,1
6238,BA:8C:B9:54:50:24,3842630,490219606,4853,6184735,3837777,484034871,0,9106,1707185,9084,1703690,22,3495,2351,16,5305,40,0,60,229410.0,130000.0,-40.0,-36.0,-45.0,-51.0,-42.0,-35.0,-44.0,-49.0,-83.0,-83.0,-80.0,-79.0,43.0,47.0,35.0,28.0,1
6239,62:47:05:9D:EB:15,3837954,484117694,177,82823,3837777,484034871,0,304,58278,292,55974,12,2304,146,0,207,2,0,8,216660.0,130000.0,-51.0,-55.0,-55.0,-51.0,-52.0,-56.0,-55.0,-53.0,-83.0,-83.0,-80.0,-79.0,32.0,28.0,25.0,28.0,1
6240,3C:55:76:E8:8F:1F,3902568,646407382,64791,162372511,3837777,484034871,24,29028,6336556,28671,6274462,357,62094,12874,35,64863,6913,24,356,73120.0,1000.0,-46.0,-53.0,-57.0,-40.0,-44.0,-51.0,-54.0,-38.0,-83.0,-83.0,-80.0,-79.0,37.0,30.0,23.0,39.0,1
6241,92:69:1D:31:68:E9,3841720,487663087,3943,3628216,3837777,484034871,0,4900,1114508,4752,1080963,148,33545,2135,11,4159,90,0,47,216660.0,130000.0,-52.0,-49.0,-43.0,-49.0,-51.0,-49.0,-44.0,-48.0,-83.0,-83.0,-80.0,-79.0,31.0,34.0,37.0,30.0,1
6242,CC:2F:71:3F:1F:24,4697980,1419352650,860203,935317779,3837777,484034871,37,700946,743905946,700209,743817312,737,88634,675614,15,860460,90573,34,543,115556.0,28889.0,-66.0,-67.0,-67.0,-68.0,-66.0,-66.0,-66.0,-70.0,-83.0,-83.0,-80.0,-79.0,17.0,16.0,13.0,11.0,1
6243,CC:2F:71:3E:C5:1F,3838674,484144535,897,109664,3837777,484034871,0,3738,314046,3084,236430,654,77616,950,10,1287,22,0,45,144444.0,43333.0,-78.0,-81.0,-75.0,-71.0,-71.0,-72.0,-69.0,-62.0,-83.0,-83.0,-80.0,-79.0,5.0,2.0,5.0,8.0,1
6244,BA:8C:B9:54:50:24,3842632,490219808,4853,6184735,3837779,484035073,0,9106,1707185,9084,1703690,22,3495,2351,16,5305,40,0,60,229410.0,130000.0,-40.0,-36.0,-45.0,-51.0,-42.0,-35.0,-44.0,-49.0,-83.0,-83.0,-80.0,-79.0,43.0,47.0,35.0,28.0,1
6245,62:47:05:9D:EB:15,3837963,484118562,177,82823,3837786,484035739,0,304,58278,292,55974,12,2304,146,0,207,2,0,8,216660.0,130000.0,-51.0,-55.0,-55.0,-51.0,-52.0,-56.0,-55.0,-53.0,-83.0,-83.0,-80.0,-79.0,32.0,28.0,25.0,28.0,1
6246,3C:55:76:E8:8F:1F,3902577,646408250,64791,162372511,3837786,484035739,24,29028,6336556,28671,6274462,357,62094,12874,35,64863,6913,24,356,73120.0,1000.0,-46.0,-53.0,-57.0,-40.0,-44.0,-51.0,-54.0,-38.0,-83.0,-83.0,-80.0,-79.0,37.0,30.0,23.0,39.0,1
6247,92:69:1D:31:68:E9,3841729,487663955,3943,3628216,3837786,484035739,0,4900,1114508,4752,1080963,148,33545,2135,11,4159,90,0,47,216660.0,130000.0,-52.0,-49.0,-43.0,-49.0,-51.0,-49.0,-44.0,-48.0,-83.0,-83.0,-80.0,-79.0,31.0,34.0,37.0,30.0,1
6248,CC:2F:71:3F:1F:24,4698196,1419614988,860410,935579249,3837786,484035739,37,701134,744153380,700397,744064746,737,88634,675799,15,860667,90574,34,543,115556.0,28889.0,-66.0,-66.0,-66.0,-71.0,-66.0,-66.0,-66.0,-71.0,-83.0,-83.0,-80.0,-79.0,17.0,17.0,14.0,8.0,1
6249,CC:2F:71:3E:C5:1F,3838685,484145771,897,109664,3837788,484036107,0,3738,314046,3084,236430,654,77616,950,10,1287,22,0,45,144444.0,43333.0,-78.0,-81.0,-75.0,-71.0,-71.0,-72.0,-69.0,-62.0,-83.0,-83.0,-80.0,-79.0,5.0,2.0,5.0,8.0,1
6250,BA:8C:B9:54:50:24,3842641,490220842,4853,6184735,3837788,484036107,0,9106,1707185,9084,1703690,22,3495,2351,16,5305,40,0,60,229410.0,130000.0,-40.0,-36.0,-45.0,-51.0,-42.0,-35.0,-44.0,-49.0,-83.0,-83.0,-80.0,-79.0,43.0,47.0,35.0,28.0,1
6251,62:47:05:9D:EB:15,3837965,484118930,177,82823,3837788,484036107,0,304,58278,292,55974,12,2304,146,0,207,2,0,8,216660.0,130000.0,-51.0,-55.0,-55.0,-51.0,-52.0,-56.0,-55.0,-53.0,-83.0,-83.0,-80.0,-79.0,32.0,28.0,25.0,28.0,1
6252,3C:55:76:E8:8F:1F,3902942,647359114,65152,163322805,3837790,484036309,24,29164,6356046,28807,6293952,357,62094,12932,35,65220,6919,24,357,73120.0,24370.0,-51.0,-57.0,-47.0,-45.0,-48.0,-54.0,-49.0,-43.0,-83.0,-83.0,-80.0,-79.0,32.0,26.0,33.0,34.0,1
6253,92:69:1D:31:68:E9,3841735,487664727,3943,3628216,3837792,484036511,0,4900,1114508,4752,1080963,148,33545,2135,11,4159,90,0,47,216660.0,130000.0,-52.0,-49.0,-43.0,-49.0,-51.0,-49.0,-44.0,-48.0,-83.0,-83.0,-80.0,-79.0,31.0,34.0,37.0,30.0,1
6254,CC:2F:71:3F:1F:24,4698436,1419914534,860644,935878023,3837792,484036511,37,701365,744465780,700628,744377146,737,88634,676012,15,860901,90585,34,543,130000.0,39000.0,-66.0,-66.0,-66.0,-72.0,-66.0,-66.0,-66.0,-70.0,-83.0,-83.0,-80.0,-79.0,17.0,17.0,14.0,7.0,1
6255,CC:2F:71:3E:C5:1F,3838693,484146579,897,109664,3837796,484036915,0,3738,314046,3084,236430,654,77616,950,10,1287,22,0,45,144444.0,43333.0,-78.0,-81.0,-75.0,-71.0,-71.0,-72.0,-69.0,-62.0,-83.0,-83.0,-80.0,-79.0,5.0,2.0,5.0,8.0,1
6256,BA:8C:B9:54:50:24,3842649,490221650,4853,6184735,3837796,484036915,0,9106,1707185,9084,1703690,22,3495,2351,16,5305,40,0,60,229410.0,130000.0,-40.0,-36.0,-45.0,-51.0,-42.0,-35.0,-44.0,-49.0,-83.0,-83.0,-80.0,-79.0,43.0,47.0,35.0,28.0,1
6257,62:47:05:9D:EB:15,3837974,484119798,177,82823,3837797,484036975,0,304,58278,292,55974,12,2304,146,0,207,2,0,8,216660.0,130000.0,-51.0,-55.0,-55.0,-51.0,-52.0,-56.0,-55.0,-53.0,-83.0,-83.0,-80.0,-79.0,32.0,28.0,25.0,28.0,1
6258,3C:55:76:E8:8F:1F,3903482,648762321,65685,164725346,3837797,484036975,24,29319,6377883,28962,6315789,357,62094,13011,35,65757,6920,24,358,97500.0,48750.0,-45.0,-51.0,-52.0,-40.0,-45.0,-52.0,-52.0,-39.0,-83.0,-83.0,-80.0,-79.0,38.0,32.0,28.0,39.0,1
6259,92:69:1D:31:68:E9,3841740,487665191,3943,3628216,3837797,484036975,0,4900,1114508,4752,1080963,148,33545,2135,11,4159,90,0,47,216660.0,130000.0,-52.0,-49.0,-43.0,-49.0,-51.0,-49.0,-44.0,-48.0,-83.0,-83.0,-80.0,-79.0,31.0,34.0,37.0,30.0,1
6260,CC:2F:71:3F:1F:24,4698678,1420206891,860881,936169916,3837797,484036975,37,701582,744747233,700845,744658599,737,88634,676219,15,861138,90593,34,543,130000.0,43333.0,-66.0,-66.0,-66.0,-71.0,-66.0,-66.0,-66.0,-69.0,-83.0,-83.0,-80.0,-79.0,17.0,17.0,14.0,8.0,1
6261,CC:2F:71:3E:C5:1F,3838694,484146639,897,109664,3837797,484036975,0,3738,314046,3084,236430,654,77616,950,10,1287,22,0,45,144444.0,43333.0,-78.0,-81.0,-75.0,-71.0,-71.0,-72.0,-69.0,-62.0,-83.0,-83.0,-80.0,-79.0,5.0,2.0,5.0,8.0,1
6262,BA:8C:B9:54:50:24,3842650,490221710,4853,6184735,3837797,484036975,0,9106,1707185,9084,1703690,22,3495,2351,16,5305,40,0,60,229410.0,130000.0,-40.0,-36.0,-45.0,-51.0,-42.0,-35.0,-44.0,-49.0,-83.0,-83.0,-80.0,-79.0,43.0,47.0,35.0,28.0,1
6263,62:47:05:9D:EB:15,3837982,484120606,177,82823,3837805,484037783,0,304,58278,292,55974,12,2304,146,0,207,2,0,8,216660.0,130000.0,-51.0,-55.0,-55.0,-51.0,-52.0,-56.0,-55.0,-53.0,-83.0,-83.0,-80.0,-79.0,32.0,28.0,25.0,28.0,1
6264,3C:55:76:E8:8F:1F,3903494,648766734,65689,164728951,3837805,484037783,24,29334,6382680,28977,6320586,357,62094,13017,35,65761,6920,24,358,97500.0,48750.0,-50.0,-59.0,-43.0,-43.0,-48.0,-57.0,-43.0,-42.0,-83.0,-83.0,-80.0,-79.0,33.0,24.0,37.0,36.0,1
6265,92:69:1D:31:68:E9,3841748,487665999,3943,3628216,3837805,484037783,0,4900,1114508,4752,1080963,148,33545,2135,11,4159,90,0,47,216660.0,130000.0,-52.0,-49.0,-43.0,-49.0,-51.0,-49.0,-44.0,-48.0,-83.0,-83.0,-80.0,-79.0,31.0,34.0,37.0,30.0,1
6266,CC:2F:71:3F:1F:24,4698897,1420475161,861092,936437378,3837805,484037783,37,701779,745005831,701042,744917197,737,88634,676409,15,861349,90601,34,543,130000.0,43333.0,-66.0,-66.0,-67.0,-71.0,-66.0,-66.0,-66.0,-70.0,-83.0,-83.0,-80.0,-79.0,17.0,17.0,13.0,8.0,1
6267,CC:2F:71:3E:C5:1F,3838702,484147447,897,109664,3837805,484037783,0,3738,314046,3084,236430,654,77616,950,10,1287,22,0,45,144444.0,43333.0,-78.0,-81.0,-75.0,-71.0,-71.0,-72.0,-69.0,-62.0,-83.0,-83.0,-80.0,-79.0,5.0,2.0,5.0,8.0,1
6268,BA:8C:B9:54:50:24,3842658,490222518,4853,6184735,3837805,484037783,0,9106,1707185,9084,1703690,22,3495,2351,16,5305,40,0,60,229410.0,130000.0,-40.0,-36.0,-45.0,-51.0,-42.0,-35.0,-44.0,-49.0,-83.0,-83.0,-80.0,-79.0,43.0,47.0,35.0,28.0,1
6269,62:47:05:9D:EB:15,3837983,484120666,177,82823,3837806,484037843,0,304,58278,292,55974,12,2304,146,0,207,2,0,8,216660.0,130000.0,-51.0,-55.0,-55.0,-51.0,-52.0,-56.0,-55.0,-53.0,-83.0,-83.0,-80.0,-79.0,32.0,28.0,25.0,28.0,1
6270,3C:55:76:E8:8F:1F,3903495,648766794,65689,164728951,3837806,484037843,24,29341,6383158,28984,6321064,357,62094,13017,35,65761,6920,24,358,97500.0,48750.0,-50.0,-61.0,-43.0,-44.0,-50.0,-60.0,-43.0,-43.0,-83.0,-83.0,-80.0,-79.0,33.0,22.0,37.0,35.0,1
6271,92:69:1D:31:68:E9,3841749,487666059,3943,3628216,3837806,484037843,0,4900,1114508,4752,1080963,148,33545,2135,11,4159,90,0,47,216660.0,130000.0,-52.0,-49.0,-43.0,-49.0,-51.0,-49.0,-44.0,-48.0,-83.0,-83.0,-80.0,-79.0,31.0,34.0,37.0,30.0,1
6272,CC:2F:71:3F:1F:24,4699108,1420737081,861302,936699238,3837806,484037843,37,701967,745253123,701230,745164489,737,88634,676595,15,861559,90602,34,543,130000.0,43333.0,-66.0,-66.0,-66.0,-67.0,-66.0,-66.0,-66.0,-69.0,-83.0,-83.0,-80.0,-79.0,17.0,17.0,14.0,12.0,1
6273,CC:2F:71:3E:C5:1F,3838703,484147507,897,109664,3837806,484037843,0,3738,314046,3084,236430,654,77616,950,10,1287,22,0,45,144444.0,43333.0,-78.0,-81.0,-75.0,-71.0,-71.0,-72.0,-69.0,-62.0,-83.0,-83.0,-80.0,-79.0,5.0,2.0,5.0,8.0,1
6274,BA:8C:B9:54:50:24,3842659,490222578,4853,6184735,3837806,484037843,0,9106,1707185,9084,1703690,22,3495,2351,16,5305,40,0,60,229410.0,130000.0,-40.0,-36.0,-45.0,-51.0,-42.0,-35.0,-44.0,-49.0,-83.0,-83.0,-80.0,-79.0,43.0,47.0,35.0,28.0,1
6275,62:47:05:9D:EB:15,3837991,484121474,177,82823,3837814,484038651,0,304,58278,292,55974,12,2304,146,0,207,2,0,8,216660.0,130000.0,-51.0,-55.0,-55.0,-51.0,-52.0,-56.0,-55.0,-53.0,-83.0,-83.0,-80.0,-79.0,32.0,28.0,25.0,28.0,1
6276,3C:55:76:E8:8F:1F,3903504,648767732,65690,164729081,3837814,484038651,24,29348,6383675,28991,6321581,357,62094,13018,35,65762,6920,24,358,97500.0,1000.0,-45.0,-52.0,-51.0,-39.0,-45.0,-53.0,-49.0,-39.0,-83.0,-83.0,-80.0,-79.0,38.0,31.0,29.0,40.0,1
6277,92:69:1D:31:68:E9,3841757,487666867,3943,3628216,3837814,484038651,0,4900,1114508,4752,1080963,148,33545,2135,11,4159,90,0,47,216660.0,130000.0,-52.0,-49.0,-43.0,-49.0,-51.0,-49.0,-44.0,-48.0,-83.0,-83.0,-80.0,-79.0,31.0,34.0,37.0,30.0,1
6278,CC:2F:71:3F:1F:24,4699324,1420999377,861510,936960726,3837814,484038651,37,702160,745509779,701423,745421145,737,88634,676778,15,861766,90611,34,543,117000.0,39000.0,-66.0,-66.0,-67.0,-71.0,-66.0,-66.0,-66.0,-71.0,-83.0,-83.0,-80.0,-79.0,17.0,17.0,13.0,8.0,1
6279,CC:2F:71:3E:C5:1F,3838711,484148315,897,109664,3837814,484038651,0,3738,314046,3084,236430,654,77616,950,10,1287,22,0,45,144444.0,43333.0,-78.0,-81.0,-75.0,-71.0,-71.0,-72.0,-69.0,-62.0,-83.0,-83.0,-80.0,-79.0,5.0,2.0,5.0,8.0,1
6280,BA:8C:B9:54:50:24,3842667,490223386,4853,6184735,3837814,484038651,0,9106,1707185,9084,1703690,22,3495,2351,16,5305,40,0,60,229410.0,130000.0,-40.0,-36.0,-45.0,-51.0,-42.0,-35.0,-44.0,-49.0,-83.0,-83.0,-80.0,-79.0,43.0,47.0,35.0,28.0,1
6281,62:47:05:9D:EB:15,3837991,484121474,177,82823,3837814,484038651,0,305,58346,293,56042,12,2304,146,0,207,2,0,8,216660.0,130000.0,-51.0,-51.0,-55.0,-52.0,-52.0,-55.0,-55.0,-53.0,-83.0,-83.0,-80.0,-79.0,32.0,32.0,25.0,27.0,1
6282,3C:55:76:E8:8F:1F,3904300,650876662,66486,166838011,3837814,484038651,24,29553,6414399,29196,6352305,357,62094,13116,35,66555,6932,24,364,86020.0,25800.0,-49.0,-58.0,-48.0,-45.0,-48.0,-58.0,-45.0,-43.0,-83.0,-83.0,-80.0,-79.0,34.0,25.0,32.0,34.0,1
6283,92:69:1D:31:68:E9,3841758,487666927,3943,3628216,3837815,484038711,0,4900,1114508,4752,1080963,148,33545,2135,11,4159,90,0,47,216660.0,130000.0,-52.0,-49.0,-43.0,-49.0,-51.0,-49.0,-44.0,-48.0,-83.0,-83.0,-80.0,-79.0,31.0,34.0,37.0,30.0,1
6284,CC:2F:71:3F:1F:24,4699575,1421311421,861756,937272306,3837819,484039115,37,702389,745809608,701652,745720974,737,88634,677000,15,862011,90633,34,543,130000.0,43333.0,-67.0,-66.0,-67.0,-71.0,-66.0,-66.0,-66.0,-70.0,-83.0,-83.0,-80.0,-79.0,16.0,17.0,13.0,8.0,1
6285,CC:2F:71:3E:C5:1F,3838720,484149183,897,109664,3837823,484039519,0,3738,314046,3084,236430,654,77616,950,10,1287,22,0,45,144444.0,43333.0,-78.0,-81.0,-75.0,-71.0,-71.0,-72.0,-69.0,-62.0,-83.0,-83.0,-80.0,-79.0,5.0,2.0,5.0,8.0,1
6286,BA:8C:B9:54:50:24,3842676,490224254,4853,6184735,3837823,484039519,0,9106,1707185,9084,1703690,22,3495,2351,16,5305,40,0,60,229410.0,130000.0,-40.0,-36.0,-45.0,-51.0,-42.0,-35.0,-44.0,-49.0,-83.0,-83.0,-80.0,-79.0,43.0,47.0,35.0,28.0,1
6287,62:47:05:9D:EB:15,3838000,484122342,177,82823,3837823,484039519,0,305,58346,293,56042,12,2304,146,0,207,2,0,8,216660.0,130000.0,-51.0,-51.0,-55.0,-52.0,-52.0,-55.0,-55.0,-53.0,-83.0,-83.0,-80.0,-79.0,32.0,32.0,25.0,27.0,1
6288,3C:55:76:E8:8F:1F,3904452,651248834,66629,167209315,3837823,484039519,24,29605,6420406,29248,6358312,357,62094,13137,35,66701,6935,24,364,73120.0,1000.0,-47.0,-62.0,-41.0,-40.0,-49.0,-60.0,-42.0,-42.0,-83.0,-83.0,-80.0,-79.0,36.0,21.0,39.0,39.0,1
6289,92:69:1D:31:68:E9,3841767,487667851,3944,3628332,3837823,484039519,0,4902,1114644,4754,1081099,148,33545,2135,11,4160,90,0,47,216660.0,130000.0,-53.0,-47.0,-42.0,-50.0,-52.0,-49.0,-44.0,-49.0,-83.0,-83.0,-80.0,-79.0,30.0,36.0,38.0,29.0,1
6290,CC:2F:71:3F:1F:24,4699792,1421575533,861969,937536014,3837823,484039519,37,702586,746062600,701849,745973966,737,88634,677189,15,862226,90633,34,543,130000.0,43333.0,-66.0,-66.0,-67.0,-72.0,-66.0,-66.0,-67.0,-69.0,-83.0,-83.0,-80.0,-79.0,17.0,17.0,13.0,7.0,1
6291,CC:2F:71:3E:C5:1F,3838721,484149243,898,109724,3837823,484039519,0,3740,314186,3086,236570,654,77616,950,10,1288,22,0,45,130000.0,39000.0,-78.0,-80.0,-75.0,-71.0,-72.0,-73.0,-70.0,-63.0,-83.0,-83.0,-80.0,-79.0,5.0,3.0,5.0,8.0,1
6292,BA:8C:B9:54:50:24,3842677,490224370,4854,6184851,3837823,484039519,0,9108,1707321,9086,1703826,22,3495,2351,16,5306,40,0,60,229410.0,130000.0,-48.0,-35.0,-43.0,-45.0,-43.0,-35.0,-44.0,-49.0,-83.0,-83.0,-80.0,-79.0,35.0,48.0,37.0,34.0,1
6293,62:47:05:9D:EB:15,3838005,484122862,178,82939,3837827,484039923,0,307,58482,295,56178,12,2304,146,0,208,2,0,8,216660.0,130000.0,-52.0,-52.0,-55.0,-52.0,-52.0,-54.0,-55.0,-52.0,-83.0,-83.0,-80.0,-79.0,31.0,31.0,25.0,27.0,1
6294,3C:55:76:E8:8F:1F,3904460,651249642,66629,167209315,3837831,484040327,24,29612,6420884,29255,6358790,357,62094,13137,35,66701,6935,24,365,73120.0,1000.0,-50.0,-61.0,-43.0,-43.0,-48.0,-61.0,-42.0,-41.0,-83.0,-83.0,-80.0,-79.0,33.0,22.0,37.0,36.0,1
6295,92:69:1D:31:68:E9,3841775,487668659,3944,3628332,3837831,484040327,0,4902,1114644,4754,1081099,148,33545,2135,11,4160,90,0,47,216660.0,130000.0,-53.0,-47.0,-42.0,-50.0,-52.0,-49.0,-44.0,-49.0,-83.0,-83.0,-80.0,-79.0,30.0,36.0,38.0,29.0,1
6296,CC:2F:71:3F:1F:24,4700011,1421839531,862180,937799204,3837831,484040327,37,702779,746314848,702042,746226214,737,88634,677376,15,862437,90639,34,543,130000.0,43333.0,-66.0,-66.0,-67.0,-67.0,-66.0,-66.0,-67.0,-70.0,-83.0,-83.0,-80.0,-79.0,17.0,17.0,13.0,12.0,1
6297,CC:2F:71:3E:C5:1F,3838729,484150051,898,109724,3837831,484040327,0,3740,314186,3086,236570,654,77616,950,10,1288,22,0,45,130000.0,39000.0,-78.0,-80.0,-75.0,-71.0,-72.0,-73.0,-70.0,-63.0,-83.0,-83.0,-80.0,-79.0,5.0,3.0,5.0,8.0,1
6298,BA:8C:B9:54:50:24,3842685,490225178,4854,6184851,3837831,484040327,0,9108,1707321,9086,1703826,22,3495,2351,16,5306,40,0,60,229410.0,130000.0,-48.0,-35.0,-43.0,-45.0,-43.0,-35.0,-44.0,-49.0,-83.0,-83.0,-80.0,-79.0,35.0,48.0,37.0,34.0,1
6299,62:47:05:9D:EB:15,3838011,484123599,178,82939,3837833,484040660,0,307,58482,295,56178,12,2304,146,0,208,2,0,8,216660.0,130000.0,-52.0,-52.0,-55.0,-52.0,-52.0,-54.0,-55.0,-52.0,-83.0,-83.0,-80.0,-79.0,31.0,31.0,25.0,27.0,1
6300,3C:55:76:E8:8F:1F,3904462,651249975,66629,167209315,3837833,484040660,24,29612,6420884,29255,6358790,357,62094,13137,35,66701,6935,24,365,73120.0,1000.0,-50.0,-61.0,-43.0,-43.0,-48.0,-61.0,-42.0,-41.0,-83.0,-83.0,-80.0,-79.0,33.0,22.0,37.0,36.0,1
6301,92:69:1D:31:68:E9,3841777,487668992,3944,3628332,3837833,484040660,0,4902,1114644,4754,1081099,148,33545,2135,11,4160,90,0,47,216660.0,130000.0,-53.0,-47.0,-42.0,-50.0,-52.0,-49.0,-44.0,-49.0,-83.0,-83.0,-80.0,-79.0,30.0,36.0,38.0,29.0,1
6302,CC:2F:71:3F:1F:24,4700232,1422106655,862399,938065995,3837833,484040660,37,702979,746568378,702242,746479744,737,88634,677570,15,862654,90645,34,543,130000.0,43333.0,-66.0,-66.0,-66.0,-69.0,-66.0,-66.0,-66.0,-69.0,-83.0,-83.0,-80.0,-79.0,17.0,17.0,14.0,10.0,1
6303,CC:2F:71:3E:C5:1F,3838731,484150384,898,109724,3837833,484040660,0,3740,314186,3086,236570,654,77616,950,10,1288,22,0,45,130000.0,39000.0,-78.0,-80.0,-75.0,-71.0,-72.0,-73.0,-70.0,-63.0,-83.0,-83.0,-80.0,-79.0,5.0,3.0,5.0,8.0,1
6304,BA:8C:B9:54:50:24,3842687,490225511,4854,6184851,3837833,484040660,0,9109,1707389,9087,1703894,22,3495,2351,16,5306,40,0,60,229410.0,130000.0,-40.0,-36.0,-45.0,-52.0,-43.0,-35.0,-44.0,-49.0,-83.0,-83.0,-80.0,-79.0,43.0,47.0,35.0,27.0,1
6305,62:47:05:9D:EB:15,3838019,484124407,178,82939,3837841,484041468,0,307,58482,295,56178,12,2304,146,0,208,2,0,8,216660.0,130000.0,-52.0,-52.0,-55.0,-52.0,-52.0,-54.0,-55.0,-52.0,-83.0,-83.0,-80.0,-79.0,31.0,31.0,25.0,27.0,1
6306,3C:55:76:E8:8F:1F,3904470,651250783,66629,167209315,3837841,484041468,24,29612,6420884,29255,6358790,357,62094,13137,35,66701,6935,24,365,73120.0,1000.0,-50.0,-61.0,-43.0,-43.0,-48.0,-61.0,-42.0,-41.0,-83.0,-83.0,-80.0,-79.0,33.0,22.0,37.0,36.0,1
6307,92:69:1D:31:68:E9,3841785,487669800,3944,3628332,3837841,484041468,0,4902,1114644,4754,1081099,148,33545,2135,11,4160,90,0,47,216660.0,130000.0,-53.0,-47.0,-42.0,-50.0,-52.0,-49.0,-44.0,-49.0,-83.0,-83.0,-80.0,-79.0,30.0,36.0,38.0,29.0,1
6308,CC:2F:71:3F:1F:24,4700451,1422370877,862610,938329409,3837841,484041468,37,703172,746826316,702435,746737682,737,88634,677757,15,862867,90645,34,543,130000.0,43333.0,-66.0,-66.0,-67.0,-71.0,-66.0,-66.0,-66.0,-71.0,-83.0,-83.0,-80.0,-79.0,17.0,17.0,13.0,8.0,1
6309,CC:2F:71:3E:C5:1F,3838739,484151192,898,109724,3837841,484041468,0,3740,314186,3086,236570,654,77616,950,10,1288,22,0,45,130000.0,39000.0,-78.0,-80.0,-75.0,-71.0,-72.0,-73.0,-70.0,-63.0,-83.0,-83.0,-80.0,-79.0,5.0,3.0,5.0,8.0,1
6310,BA:8C:B9:54:50:24,3842695,490226319,4854,6184851,3837841,484041468,0,9109,1707389,9087,1703894,22,3495,2351,16,5306,40,0,60,229410.0,130000.0,-40.0,-36.0,-45.0,-52.0,-43.0,-35.0,-44.0,-49.0,-83.0,-83.0,-80.0,-79.0,43.0,47.0,35.0,27.0,1
6311,62:47:05:9D:EB:15,3838020,484124467,178,82939,3837842,484041528,0,307,58482,295,56178,12,2304,146,0,208,2,0,8,216660.0,130000.0,-52.0,-52.0,-55.0,-52.0,-52.0,-54.0,-55.0,-52.0,-83.0,-83.0,-80.0,-79.0,31.0,31.0,25.0,27.0,1
6312,3C:55:76:E8:8F:1F,3904471,651250843,66629,167209315,3837842,484041528,24,29612,6420884,29255,6358790,357,62094,13137,35,66701,6935,24,365,73120.0,1000.0,-50.0,-61.0,-43.0,-43.0,-48.0,-61.0,-42.0,-41.0,-83.0,-83.0,-80.0,-79.0,33.0,22.0,37.0,36.0,1
6313,92:69:1D:31:68:E9,3841786,487669860,3944,3628332,3837842,484041528,0,4902,1114644,4754,1081099,148,33545,2135,11,4160,90,0,47,216660.0,130000.0,-53.0,-47.0,-42.0,-50.0,-52.0,-49.0,-44.0,-49.0,-83.0,-83.0,-80.0,-79.0,30.0,36.0,38.0,29.0,1
6314,CC:2F:71:3F:1F:24,4700662,1422631149,862820,938589621,3837842,484041528,37,703364,747078510,702627,746989876,737,88634,677942,15,863077,90654,34,543,130000.0,43333.0,-67.0,-66.0,-67.0,-71.0,-66.0,-66.0,-66.0,-70.0,-83.0,-83.0,-80.0,-79.0,16.0,17.0,13.0,8.0,1
6315,CC:2F:71:3E:C5:1F,3838740,484151252,898,109724,3837842,484041528,0,3740,314186,3086,236570,654,77616,950,10,1288,22,0,45,130000.0,39000.0,-78.0,-80.0,-75.0,-71.0,-72.0,-73.0,-70.0,-63.0,-83.0,-83.0,-80.0,-79.0,5.0,3.0,5.0,8.0,1
6316,BA:8C:B9:54:50:24,3842697,490226441,4854,6184851,3837843,484041590,0,9109,1707389,9087,1703894,22,3495,2351,16,5306,40,0,60,229410.0,130000.0,-40.0,-36.0,-45.0,-52.0,-43.0,-35.0,-44.0,-49.0,-83.0,-83.0,-80.0,-79.0,43.0,47.0,35.0,27.0,1
6317,62:47:05:9D:EB:15,3838029,484125337,178,82939,3837851,484042398,0,307,58482,295,56178,12,2304,146,0,208,2,0,8,216660.0,130000.0,-52.0,-52.0,-55.0,-52.0,-52.0,-54.0,-55.0,-52.0,-83.0,-83.0,-80.0,-79.0,31.0,31.0,25.0,27.0,1
6318,3C:55:76:E8:8F:1F,3904480,651251713,66629,167209315,3837851,484042398,24,29612,6420884,29255,6358790,357,62094,13137,35,66701,6935,24,365,73120.0,1000.0,-50.0,-61.0,-43.0,-43.0,-48.0,-61.0,-42.0,-41.0,-83.0,-83.0,-80.0,-79.0,33.0,22.0,37.0,36.0,1
6319,92:69:1D:31:68:E9,3841795,487670730,3944,3628332,3837851,484042398,0,4902,1114644,4754,1081099,148,33545,2135,11,4160,90,0,47,216660.0,130000.0,-53.0,-47.0,-42.0,-50.0,-52.0,-49.0,-44.0,-49.0,-83.0,-83.0,-80.0,-79.0,30.0,36.0,38.0,29.0,1
6320,CC:2F:71:3F:1F:24,4700879,1422892195,863028,938849797,3837851,484042398,37,703551,747327138,702814,747238504,737,88634,678125,15,863285,90655,34,543,130000.0,43333.0,-66.0,-66.0,-67.0,-71.0,-66.0,-66.0,-66.0,-71.0,-83.0,-83.0,-80.0,-79.0,17.0,17.0,13.0,8.0,1
6321,CC:2F:71:3E:C5:1F,3838749,484152122,898,109724,3837851,484042398,0,3742,314374,3087,236640,655,77734,951,10,1288,22,0,46,130000.0,39000.0,-67.0,-68.0,-67.0,-69.0,-71.0,-72.0,-69.0,-65.0,-83.0,-83.0,-80.0,-79.0,16.0,15.0,13.0,10.0,1
6322,BA:8C:B9:54:50:24,3842705,490227249,4854,6184851,3837851,484042398,0,9109,1707389,9087,1703894,22,3495,2351,16,5306,40,0,60,229410.0,130000.0,-40.0,-36.0,-45.0,-52.0,-43.0,-35.0,-44.0,-49.0,-83.0,-83.0,-80.0,-79.0,43.0,47.0,35.0,27.0,1
6323,62:47:05:9D:EB:15,3838029,484125337,178,82939,3837851,484042398,0,307,58482,295,56178,12,2304,146,0,208,2,0,8,216660.0,130000.0,-52.0,-52.0,-55.0,-52.0,-52.0,-54.0,-55.0,-52.0,-83.0,-83.0,-80.0,-79.0,31.0,31.0,25.0,27.0,1
6324,3C:55:76:E8:8F:1F,3904483,651251999,66631,167209541,3837852,484042458,24,29628,6422136,29271,6360042,357,62094,13140,35,66703,6935,24,365,73120.0,24370.0,-49.0,-63.0,-51.0,-44.0,-49.0,-60.0,-44.0,-43.0,-83.0,-83.0,-80.0,-79.0,34.0,20.0,29.0,35.0,1
6325,92:69:1D:31:68:E9,3841796,487670790,3944,3628332,3837852,484042458,0,4902,1114644,4754,1081099,148,33545,2135,11,4160,90,0,47,216660.0,130000.0,-53.0,-47.0,-42.0,-50.0,-52.0,-49.0,-44.0,-49.0,-83.0,-83.0,-80.0,-79.0,30.0,36.0,38.0,29.0,1
6326,CC:2F:71:3F:1F:24,4701102,1423159806,863248,939117146,3837854,484042660,37,703756,747584492,703019,747495858,737,88634,678318,15,863505,90662,34,543,130000.0,39000.0,-67.0,-66.0,-67.0,-71.0,-66.0,-66.0,-66.0,-70.0,-83.0,-83.0,-80.0,-79.0,16.0,17.0,13.0,8.0,1
6327,CC:2F:71:3E:C5:1F,3838752,484152384,898,109724,3837854,484042660,0,3742,314374,3087,236640,655,77734,951,10,1288,22,0,46,130000.0,39000.0,-67.0,-68.0,-67.0,-69.0,-71.0,-72.0,-69.0,-65.0,-83.0,-83.0,-80.0,-79.0,16.0,15.0,13.0,10.0,1
6328,BA:8C:B9:54:50:24,3842708,490227511,4854,6184851,3837854,484042660,0,9109,1707389,9087,1703894,22,3495,2351,16,5306,40,0,60,229410.0,130000.0,-40.0,-36.0,-45.0,-52.0,-43.0,-35.0,-44.0,-49.0,-83.0,-83.0,-80.0,-79.0,43.0,47.0,35.0,27.0,1
6329,62:47:05:9D:EB:15,3838038,484126205,178,82939,3837860,484043266,0,307,58482,295,56178,12,2304,146,0,208,2,0,8,216660.0,130000.0,-52.0,-52.0,-55.0,-52.0,-52.0,-54.0,-55.0,-52.0,-83.0,-83.0,-80.0,-79.0,31.0,31.0,25.0,27.0,1
6330,3C:55:76:E8:8F:1F,3905132,652941381,67271,168898053,3837861,484043328,24,29784,6446100,29427,6384006,357,62094,13216,35,67327,6970,24,371,103230.0,1000.0,-49.0,-57.0,-47.0,-43.0,-48.0,-56.0,-44.0,-42.0,-83.0,-83.0,-80.0,-79.0,34.0,26.0,33.0,36.0,1
6331,92:69:1D:31:68:E9,3841805,487671660,3944,3628332,3837861,484043328,0,4902,1114644,4754,1081099,148,33545,2135,11,4160,90,0,47,216660.0,130000.0,-53.0,-47.0,-42.0,-50.0,-52.0,-49.0,-44.0,-49.0,-83.0,-83.0,-80.0,-79.0,30.0,36.0,38.0,29.0,1
6332,CC:2F:71:3F:1F:24,4701345,1423461402,863484,939418074,3837861,484043328,37,703974,747879504,703237,747790870,737,88634,678528,15,863741,90665,34,543,130000.0,43333.0,-66.0,-66.0,-67.0,-72.0,-66.0,-66.0,-67.0,-69.0,-83.0,-83.0,-80.0,-79.0,17.0,17.0,13.0,7.0,1
6333,CC:2F:71:3E:C5:1F,3838759,484153052,898,109724,3837861,484043328,0,3742,314374,3087,236640,655,77734,951,10,1288,22,0,46,130000.0,39000.0,-67.0,-68.0,-67.0,-69.0,-71.0,-72.0,-69.0,-65.0,-83.0,-83.0,-80.0,-79.0,16.0,15.0,13.0,10.0,1
6334,BA:8C:B9:54:50:24,3842715,490228179,4854,6184851,3837861,484043328,0,9109,1707389,9087,1703894,22,3495,2351,16,5306,40,0,60,229410.0,130000.0,-40.0,-36.0,-45.0,-52.0,-43.0,-35.0,-44.0,-49.0,-83.0,-83.0,-80.0,-79.0,43.0,47.0,35.0,27.0,1
6335,62:47:05:9D:EB:15,3838043,484126671,178,82939,3837865,484043732,0,307,58482,295,56178,12,2304,146,0,208,2,0,8,216660.0,130000.0,-52.0,-52.0,-55.0,-52.0,-52.0,-54.0,-55.0,-52.0,-83.0,-83.0,-80.0,-79.0,31.0,31.0,25.0,27.0,1
6336,3C:55:76:E8:8F:1F,3905302,653364446,67433,169320310,3837869,484044136,24,29840,6455648,29483,6393554,357,62094,13243,35,67505,6985,24,371,81250.0,1000.0,-50.0,-55.0,-43.0,-42.0,-49.0,-56.0,-44.0,-42.0,-83.0,-83.0,-80.0,-79.0,33.0,28.0,37.0,37.0,1
6337,92:69:1D:31:68:E9,3841813,487672468,3944,3628332,3837869,484044136,0,4902,1114644,4754,1081099,148,33545,2135,11,4160,90,0,47,216660.0,130000.0,-53.0,-47.0,-42.0,-50.0,-52.0,-49.0,-44.0,-49.0,-83.0,-83.0,-80.0,-79.0,30.0,36.0,38.0,29.0,1
6338,CC:2F:71:3F:1F:24,4701570,1423734878,863700,939690682,3837870,484044196,37,704176,748147126,703439,748058492,737,88634,678721,15,863957,90667,34,543,130000.0,43333.0,-68.0,-66.0,-68.0,-71.0,-67.0,-65.0,-67.0,-71.0,-83.0,-83.0,-80.0,-79.0,15.0,17.0,12.0,8.0,1
6339,CC:2F:71:3E:C5:1F,3838768,484153920,898,109724,3837870,484044196,0,3742,314374,3087,236640,655,77734,951,10,1288,22,0,46,130000.0,39000.0,-67.0,-68.0,-67.0,-69.0,-71.0,-72.0,-69.0,-65.0,-83.0,-83.0,-80.0,-79.0,16.0,15.0,13.0,10.0,1
6340,BA:8C:B9:54:50:24,3842724,490229047,4854,6184851,3837870,484044196,0,9110,1707457,9088,1703962,22,3495,2351,16,5307,40,0,60,229410.0,130000.0,-40.0,-36.0,-45.0,-51.0,-42.0,-35.0,-44.0,-49.0,-83.0,-83.0,-80.0,-79.0,43.0,47.0,35.0,28.0,1
6341,62:47:05:9D:EB:15,3838049,484127197,178,82939,3837871,484044258,0,309,58618,297,56314,12,2304,146,0,209,2,0,8,216660.0,130000.0,-49.0,-52.0,-54.0,-55.0,-51.0,-53.0,-54.0,-53.0,-83.0,-83.0,-80.0,-79.0,34.0,31.0,26.0,24.0,1
6342,3C:55:76:E8:8F:1F,3905304,653364568,67433,169320310,3837871,484044258,24,29849,6456314,29491,6394102,358,62212,13244,35,67505,6985,24,372,81250.0,1000.0,-52.0,-51.0,-47.0,-43.0,-50.0,-49.0,-46.0,-41.0,-83.0,-83.0,-80.0,-79.0,31.0,32.0,33.0,36.0,1
6343,92:69:1D:31:68:E9,3841815,487672590,3944,3628332,3837871,484044258,0,4904,1114780,4756,1081235,148,33545,2135,11,4161,90,0,47,216660.0,130000.0,-52.0,-49.0,-45.0,-46.0,-52.0,-49.0,-44.0,-48.0,-83.0,-83.0,-80.0,-79.0,31.0,34.0,35.0,33.0,1
6344,CC:2F:71:3F:1F:24,4701788,1423998679,863917,939954421,3837871,484044258,37,704377,748403793,703640,748315159,737,88634,678912,15,864174,90674,34,543,144444.0,43333.0,-67.0,-65.0,-68.0,-71.0,-67.0,-65.0,-67.0,-70.0,-83.0,-83.0,-80.0,-79.0,16.0,18.0,12.0,8.0,1
6345,CC:2F:71:3E:C5:1F,3838769,484153982,898,109724,3837871,484044258,0,3742,314374,3087,236640,655,77734,951,10,1288,22,0,46,130000.0,39000.0,-67.0,-68.0,-67.0,-69.0,-71.0,-72.0,-69.0,-65.0,-83.0,-83.0,-80.0,-79.0,16.0,15.0,13.0,10.0,1
6346,BA:8C:B9:54:50:24,3842725,490229109,4854,6184851,3837871,484044258,0,9112,1707593,9090,1704098,22,3495,2351,16,5307,40,0,60,229410.0,130000.0,-40.0,-37.0,-46.0,-52.0,-43.0,-35.0,-44.0,-49.0,-83.0,-83.0,-80.0,-79.0,43.0,46.0,34.0,27.0,1
6347,62:47:05:9D:EB:15,3838059,484128129,178,82939,3837881,484045190,0,309,58618,297,56314,12,2304,146,0,209,2,0,8,216660.0,130000.0,-49.0,-52.0,-54.0,-55.0,-51.0,-53.0,-54.0,-53.0,-83.0,-83.0,-80.0,-79.0,34.0,31.0,26.0,24.0,1
6348,3C:55:76:E8:8F:1F,3905601,654126214,67720,170081024,3837881,484045190,24,29910,6467319,29551,6404989,359,62330,13281,35,67764,7013,24,377,103230.0,16250.0,-51.0,-50.0,-47.0,-42.0,-49.0,-52.0,-48.0,-43.0,-83.0,-83.0,-80.0,-79.0,32.0,33.0,33.0,37.0,1
6349,92:69:1D:31:68:E9,3841825,487673522,3944,3628332,3837881,484045190,0,4904,1114780,4756,1081235,148,33545,2135,11,4161,90,0,47,216660.0,130000.0,-52.0,-49.0,-45.0,-46.0,-52.0,-49.0,-44.0,-48.0,-83.0,-83.0,-80.0,-79.0,31.0,34.0,35.0,33.0,1
6350,CC:2F:71:3F:1F:24,4702030,1424297083,864149,940251893,3837881,484045190,37,704593,748695757,703855,748607005,738,88752,679119,15,864406,90690,34,543,144444.0,43333.0,-67.0,-65.0,-67.0,-71.0,-67.0,-65.0,-67.0,-70.0,-83.0,-83.0,-80.0,-79.0,16.0,18.0,13.0,8.0,1
6351,CC:2F:71:3E:C5:1F,3838779,484154914,898,109724,3837881,484045190,0,3742,314374,3087,236640,655,77734,951,10,1288,22,0,46,130000.0,39000.0,-67.0,-68.0,-67.0,-69.0,-71.0,-72.0,-69.0,-65.0,-83.0,-83.0,-80.0,-79.0,16.0,15.0,13.0,10.0,1
6352,BA:8C:B9:54:50:24,3842735,490230041,4854,6184851,3837881,484045190,0,9112,1707593,9090,1704098,22,3495,2351,16,5307,40,0,60,229410.0,130000.0,-40.0,-37.0,-46.0,-52.0,-43.0,-35.0,-44.0,-49.0,-83.0,-83.0,-80.0,-79.0,43.0,46.0,34.0,27.0,1
6353,62:47:05:9D:EB:15,3838060,484128189,178,82939,3837882,484045250,0,309,58618,297,56314,12,2304,146,0,209,2,0,8,216660.0,130000.0,-49.0,-52.0,-54.0,-55.0,-51.0,-53.0,-54.0,-53.0,-83.0,-83.0,-80.0,-79.0,34.0,31.0,26.0,24.0,1
6354,3C:55:76:E8:8F:1F,3905739,654475102,67857,170429852,3837882,484045250,24,29970,6477335,29611,6415005,359,62330,13306,35,67929,7013,24,380,130000.0,32500.0,-45.0,-51.0,-50.0,-40.0,-45.0,-50.0,-47.0,-39.0,-83.0,-83.0,-80.0,-79.0,38.0,32.0,30.0,39.0,1
6355,92:69:1D:31:68:E9,3841828,487673784,3944,3628332,3837884,484045452,0,4904,1114780,4756,1081235,148,33545,2135,11,4161,90,0,47,216660.0,130000.0,-52.0,-49.0,-45.0,-46.0,-52.0,-49.0,-44.0,-48.0,-83.0,-83.0,-80.0,-79.0,31.0,34.0,35.0,33.0,1
6356,CC:2F:71:3F:1F:24,4702243,1424557767,864359,940512315,3837884,484045452,37,704788,748948165,704050,748859413,738,88752,679309,15,864616,90693,34,543,144444.0,43333.0,-67.0,-66.0,-67.0,-71.0,-67.0,-65.0,-67.0,-70.0,-83.0,-83.0,-80.0,-79.0,16.0,17.0,13.0,8.0,1
6357,CC:2F:71:3E:C5:1F,3838782,484155176,898,109724,3837884,484045452,0,3742,314374,3087,236640,655,77734,951,10,1288,22,0,46,130000.0,39000.0,-67.0,-68.0,-67.0,-69.0,-71.0,-72.0,-69.0,-65.0,-83.0,-83.0,-80.0,-79.0,16.0,15.0,13.0,10.0,1
6358,BA:8C:B9:54:50:24,3842738,490230303,4854,6184851,3837884,484045452,0,9112,1707593,9090,1704098,22,3495,2351,16,5307,40,0,60,229410.0,130000.0,-40.0,-37.0,-46.0,-52.0,-43.0,-35.0,-44.0,-49.0,-83.0,-83.0,-80.0,-79.0,43.0,46.0,34.0,27.0,1
6359,62:47:05:9D:EB:15,3838068,484128997,178,82939,3837890,484046058,0,309,58618,297,56314,12,2304,146,0,209,2,0,8,216660.0,130000.0,-49.0,-52.0,-54.0,-55.0,-51.0,-53.0,-54.0,-53.0,-83.0,-83.0,-80.0,-79.0,34.0,31.0,26.0,24.0,1
6360,3C:55:76:E8:8F:1F,3905747,654475910,67857,170429852,3837890,484046058,24,29970,6477335,29611,6415005,359,62330,13306,35,67929,7013,24,380,130000.0,32500.0,-45.0,-51.0,-50.0,-40.0,-45.0,-50.0,-47.0,-39.0,-83.0,-83.0,-80.0,-79.0,38.0,32.0,30.0,39.0,1
6361,92:69:1D:31:68:E9,3841834,487674390,3944,3628332,3837890,484046058,0,4904,1114780,4756,1081235,148,33545,2135,11,4161,90,0,47,216660.0,130000.0,-52.0,-49.0,-45.0,-46.0,-52.0,-49.0,-44.0,-48.0,-83.0,-83.0,-80.0,-79.0,31.0,34.0,35.0,33.0,1
6362,CC:2F:71:3F:1F:24,4702459,1424821657,864569,940775599,3837890,484046058,37,704982,749203439,704244,749114687,738,88752,679496,15,864826,90713,34,543,144444.0,43333.0,-67.0,-66.0,-68.0,-71.0,-67.0,-66.0,-67.0,-70.0,-83.0,-83.0,-80.0,-79.0,16.0,17.0,12.0,8.0,1
6363,CC:2F:71:3E:C5:1F,3838788,484155782,898,109724,3837890,484046058,0,3742,314374,3087,236640,655,77734,951,10,1288,22,0,46,130000.0,39000.0,-67.0,-68.0,-67.0,-69.0,-71.0,-72.0,-69.0,-65.0,-83.0,-83.0,-80.0,-79.0,16.0,15.0,13.0,10.0,1
6364,BA:8C:B9:54:50:24,3842744,490230909,4854,6184851,3837890,484046058,0,9112,1707593,9090,1704098,22,3495,2351,16,5307,40,0,60,229410.0,130000.0,-40.0,-37.0,-46.0,-52.0,-43.0,-35.0,-44.0,-49.0,-83.0,-83.0,-80.0,-79.0,43.0,46.0,34.0,27.0,1
6365,62:47:05:9D:EB:15,3838071,484129259,178,82939,3837893,484046320,0,309,58618,297,56314,12,2304,146,0,209,2,0,8,216660.0,130000.0,-49.0,-52.0,-54.0,-55.0,-51.0,-53.0,-54.0,-53.0,-83.0,-83.0,-80.0,-79.0,34.0,31.0,26.0,24.0,1
6366,3C:55:76:E8:8F:1F,3905750,654476172,67857,170429852,3837893,484046320,24,29970,6477335,29611,6415005,359,62330,13306,35,67929,7013,24,380,130000.0,32500.0,-45.0,-51.0,-50.0,-40.0,-45.0,-50.0,-47.0,-39.0,-83.0,-83.0,-80.0,-79.0,38.0,32.0,30.0,39.0,1
6367,92:69:1D:31:68:E9,3841838,487674925,3944,3628332,3837894,484046593,0,4904,1114780,4756,1081235,148,33545,2135,11,4161,90,0,47,216660.0,130000.0,-52.0,-49.0,-45.0,-46.0,-52.0,-49.0,-44.0,-48.0,-83.0,-83.0,-80.0,-79.0,31.0,34.0,35.0,33.0,1
6368,CC:2F:71:3F:1F:24,4702680,1425088833,864784,941042038,3837896,484046795,37,705179,749458004,704441,749369252,738,88752,679688,15,865041,90747,34,543,130000.0,43333.0,-67.0,-66.0,-67.0,-70.0,-67.0,-66.0,-66.0,-70.0,-83.0,-83.0,-80.0,-79.0,16.0,17.0,13.0,9.0,1
6369,CC:2F:71:3E:C5:1F,3838796,484156721,898,109724,3837898,484046997,0,3742,314374,3087,236640,655,77734,951,10,1288,22,0,46,130000.0,39000.0,-67.0,-68.0,-67.0,-69.0,-71.0,-72.0,-69.0,-65.0,-83.0,-83.0,-80.0,-79.0,16.0,15.0,13.0,10.0,1
6370,BA:8C:B9:54:50:24,3842752,490231848,4854,6184851,3837898,484046997,0,9112,1707593,9090,1704098,22,3495,2351,16,5307,40,0,60,229410.0,130000.0,-40.0,-37.0,-46.0,-52.0,-43.0,-35.0,-44.0,-49.0,-83.0,-83.0,-80.0,-79.0,43.0,46.0,34.0,27.0,1
6371,62:47:05:9D:EB:15,3838078,484130138,178,82939,3837900,484047199,0,309,58618,297,56314,12,2304,146,0,209,2,0,8,216660.0,130000.0,-49.0,-52.0,-54.0,-55.0,-51.0,-53.0,-54.0,-53.0,-83.0,-83.0,-79.0,-79.0,34.0,31.0,25.0,24.0,1
6372,3C:55:76:E8:8F:1F,3905820,654642539,67920,170595340,3837900,484047199,24,29990,6482409,29631,6420079,359,62330,13320,35,67992,7013,24,380,130000.0,1000.0,-48.0,-53.0,-48.0,-44.0,-47.0,-50.0,-45.0,-41.0,-83.0,-83.0,-79.0,-79.0,35.0,30.0,31.0,35.0,1
6373,92:69:1D:31:68:E9,3841844,487675531,3944,3628332,3837900,484047199,0,4904,1114780,4756,1081235,148,33545,2135,11,4161,90,0,47,216660.0,130000.0,-52.0,-49.0,-45.0,-46.0,-52.0,-49.0,-44.0,-48.0,-83.0,-83.0,-79.0,-79.0,31.0,34.0,34.0,33.0,1
6374,CC:2F:71:3F:1F:24,4702905,1425368025,865005,941320826,3837900,484047199,37,705389,749735178,704651,749646426,738,88752,679886,15,865262,90755,34,543,144444.0,43333.0,-67.0,-66.0,-66.0,-69.0,-67.0,-66.0,-66.0,-69.0,-83.0,-83.0,-79.0,-79.0,16.0,17.0,13.0,10.0,1
6375,CC:2F:71:3E:C5:1F,3838798,484156923,898,109724,3837900,484047199,0,3742,314374,3087,236640,655,77734,951,10,1288,22,0,46,130000.0,39000.0,-67.0,-68.0,-67.0,-69.0,-71.0,-72.0,-69.0,-65.0,-83.0,-83.0,-79.0,-79.0,16.0,15.0,12.0,10.0,1
6376,BA:8C:B9:54:50:24,3842754,490232050,4854,6184851,3837900,484047199,0,9112,1707593,9090,1704098,22,3495,2351,16,5307,40,0,60,229410.0,130000.0,-40.0,-37.0,-46.0,-52.0,-43.0,-35.0,-44.0,-49.0,-83.0,-83.0,-79.0,-79.0,43.0,46.0,33.0,27.0,1
6377,62:47:05:9D:EB:15,3838085,484130804,178,82939,3837907,484047865,0,309,58618,297,56314,12,2304,146,0,209,2,0,8,216660.0,130000.0,-49.0,-52.0,-54.0,-55.0,-51.0,-53.0,-54.0,-53.0,-83.0,-83.0,-79.0,-79.0,34.0,31.0,25.0,24.0,1
6378,3C:55:76:E8:8F:1F,3906446,656273656,68539,172225791,3837907,484047865,24,30152,6505844,29793,6443514,359,62330,13394,35,68611,7013,24,380,146250.0,48750.0,-52.0,-52.0,-44.0,-43.0,-51.0,-54.0,-44.0,-43.0,-83.0,-83.0,-79.0,-79.0,31.0,31.0,35.0,36.0,1
6379,92:69:1D:31:68:E9,3841853,487676399,3944,3628332,3837909,484048067,0,4904,1114780,4756,1081235,148,33545,2135,11,4161,90,0,47,216660.0,130000.0,-52.0,-49.0,-45.0,-46.0,-52.0,-49.0,-44.0,-48.0,-83.0,-83.0,-79.0,-79.0,31.0,34.0,34.0,33.0,1
6380,CC:2F:71:3F:1F:24,4703133,1425647027,865224,941598960,3837909,484048067,37,705588,750002492,704850,749913740,738,88752,680079,15,865481,90816,34,543,115556.0,28889.0,-69.0,-67.0,-68.0,-70.0,-69.0,-66.0,-68.0,-70.0,-83.0,-83.0,-79.0,-79.0,14.0,16.0,11.0,9.0,1
6381,CC:2F:71:3E:C5:1F,3838807,484157791,898,109724,3837909,484048067,0,3742,314374,3087,236640,655,77734,951,10,1288,22,0,46,130000.0,39000.0,-67.0,-68.0,-67.0,-69.0,-71.0,-72.0,-69.0,-65.0,-83.0,-83.0,-79.0,-79.0,16.0,15.0,12.0,10.0,1
6382,BA:8C:B9:54:50:24,3842763,490232918,4854,6184851,3837909,484048067,0,9112,1707593,9090,1704098,22,3495,2351,16,5307,40,0,60,229410.0,130000.0,-40.0,-37.0,-46.0,-52.0,-43.0,-35.0,-44.0,-49.0,-83.0,-83.0,-79.0,-79.0,43.0,46.0,33.0,27.0,1
6383,62:47:05:9D:EB:15,3838087,484131006,178,82939,3837909,484048067,0,309,58618,297,56314,12,2304,146,0,209,2,0,8,216660.0,130000.0,-49.0,-52.0,-54.0,-55.0,-51.0,-53.0,-54.0,-53.0,-83.0,-83.0,-79.0,-79.0,34.0,31.0,25.0,24.0,1
6384,3C:55:76:E8:8F:1F,3906448,656273858,68539,172225791,3837909,484048067,24,30152,6505844,29793,6443514,359,62330,13394,35,68611,7013,24,380,146250.0,48750.0,-52.0,-52.0,-44.0,-43.0,-51.0,-54.0,-44.0,-43.0,-83.0,-83.0,-79.0,-79.0,31.0,31.0,35.0,36.0,1
6385,92:69:1D:31:68:E9,3841853,487676399,3944,3628332,3837909,484048067,0,4904,1114780,4756,1081235,148,33545,2135,11,4161,90,0,47,216660.0,130000.0,-52.0,-49.0,-45.0,-46.0,-52.0,-49.0,-44.0,-48.0,-83.0,-83.0,-79.0,-79.0,31.0,34.0,34.0,33.0,1
6386,CC:2F:71:3F:1F:24,4703360,1425926546,865449,941878277,3837911,484048269,37,705794,750263796,705056,750175044,738,88752,680281,15,865704,90868,34,543,115556.0,28889.0,-69.0,-66.0,-68.0,-70.0,-68.0,-66.0,-68.0,-70.0,-83.0,-83.0,-79.0,-79.0,14.0,17.0,11.0,9.0,1
6387,CC:2F:71:3E:C5:1F,3838809,484157993,898,109724,3837911,484048269,0,3742,314374,3087,236640,655,77734,951,10,1288,22,0,46,130000.0,39000.0,-67.0,-68.0,-67.0,-69.0,-71.0,-72.0,-69.0,-65.0,-83.0,-83.0,-79.0,-79.0,16.0,15.0,12.0,10.0,1
6388,BA:8C:B9:54:50:24,3842765,490233120,4854,6184851,3837911,484048269,0,9112,1707593,9090,1704098,22,3495,2351,16,5307,40,0,60,229410.0,130000.0,-40.0,-37.0,-46.0,-52.0,-43.0,-35.0,-44.0,-49.0,-83.0,-83.0,-79.0,-79.0,43.0,46.0,33.0,27.0,1
6389,62:47:05:9D:EB:15,3838095,484131814,178,82939,3837917,484048875,0,309,58618,297,56314,12,2304,146,0,209,2,0,8,216660.0,130000.0,-49.0,-52.0,-54.0,-55.0,-51.0,-53.0,-54.0,-53.0,-83.0,-83.0,-79.0,-79.0,34.0,31.0,25.0,24.0,1
6390,3C:55:76:E8:8F:1F,3906458,656274946,68541,172226071,3837917,484048875,24,30165,6506824,29806,6444494,359,62330,13395,35,68613,7013,24,380,146250.0,48750.0,-48.0,-54.0,-44.0,-45.0,-49.0,-50.0,-46.0,-43.0,-83.0,-83.0,-79.0,-79.0,35.0,29.0,35.0,34.0,1
6391,92:69:1D:31:68:E9,3841861,487677207,3944,3628332,3837917,484048875,0,4904,1114780,4756,1081235,148,33545,2135,11,4161,90,0,47,216660.0,130000.0,-52.0,-49.0,-45.0,-46.0,-52.0,-49.0,-44.0,-48.0,-83.0,-83.0,-79.0,-79.0,31.0,34.0,34.0,33.0,1
6392,CC:2F:71:3F:1F:24,4703579,1426196396,865661,942147461,3837918,484048935,37,705985,750518570,705247,750429818,738,88752,680471,15,865918,90873,34,543,117000.0,39000.0,-68.0,-65.0,-66.0,-69.0,-68.0,-65.0,-66.0,-68.0,-83.0,-83.0,-79.0,-79.0,15.0,18.0,13.0,10.0,1
6393,CC:2F:71:3E:C5:1F,3838816,484158659,898,109724,3837918,484048935,0,3742,314374,3087,236640,655,77734,951,10,1288,22,0,46,130000.0,39000.0,-67.0,-68.0,-67.0,-69.0,-71.0,-72.0,-69.0,-65.0,-83.0,-83.0,-79.0,-79.0,16.0,15.0,12.0,10.0,1
6394,BA:8C:B9:54:50:24,3842772,490233786,4854,6184851,3837918,484048935,0,9112,1707593,9090,1704098,22,3495,2351,16,5307,40,0,60,229410.0,130000.0,-40.0,-37.0,-46.0,-52.0,-43.0,-35.0,-44.0,-49.0,-83.0,-83.0,-79.0,-79.0,43.0,46.0,33.0,27.0,1
6395,62:47:05:9D:EB:15,3838099,484132202,178,82939,3837921,484049263,0,309,58618,297,56314,12,2304,146,0,209,2,0,8,216660.0,130000.0,-49.0,-52.0,-54.0,-55.0,-51.0,-53.0,-54.0,-53.0,-83.0,-83.0,-79.0,-79.0,34.0,31.0,25.0,24.0,1
6396,3C:55:76:E8:8F:1F,3906463,656275590,68542,172226327,3837921,484049263,24,30175,6507634,29816,6445304,359,62330,13397,35,68614,7013,24,380,154850.0,48750.0,-49.0,-49.0,-46.0,-45.0,-47.0,-49.0,-45.0,-43.0,-83.0,-83.0,-79.0,-79.0,34.0,34.0,33.0,34.0,1
6397,92:69:1D:31:68:E9,3841865,487677595,3944,3628332,3837921,484049263,0,4904,1114780,4756,1081235,148,33545,2135,11,4161,90,0,47,216660.0,130000.0,-52.0,-49.0,-45.0,-46.0,-52.0,-49.0,-44.0,-48.0,-83.0,-83.0,-79.0,-79.0,31.0,34.0,34.0,33.0,1
6398,CC:2F:71:3F:1F:24,4703795,1426462462,865874,942413199,3837921,484049263,37,706178,750776494,705440,750687742,738,88752,680659,15,866131,90946,34,543,130000.0,43333.0,-69.0,-67.0,-67.0,-71.0,-69.0,-66.0,-67.0,-70.0,-83.0,-83.0,-79.0,-79.0,14.0,16.0,12.0,8.0,1
6399,CC:2F:71:3E:C5:1F,3838819,484158987,898,109724,3837921,484049263,0,3742,314374,3087,236640,655,77734,951,10,1288,22,0,46,130000.0,39000.0,-67.0,-68.0,-67.0,-69.0,-71.0,-72.0,-69.0,-65.0,-83.0,-83.0,-79.0,-79.0,16.0,15.0,12.0,10.0,1
6400,BA:8C:B9:54:50:24,3842777,490234316,4854,6184851,3837923,484049465,0,9112,1707593,9090,1704098,22,3495,2351,16,5307,40,0,60,229410.0,130000.0,-40.0,-37.0,-46.0,-52.0,-43.0,-35.0,-44.0,-49.0,-83.0,-83.0,-79.0,-79.0,43.0,46.0,33.0,27.0,1
6401,62:47:05:9D:EB:15,3838105,484132808,178,82939,3837927,484049869,0,309,58618,297,56314,12,2304,146,0,209,2,0,8,216660.0,130000.0,-49.0,-52.0,-54.0,-55.0,-51.0,-53.0,-54.0,-53.0,-83.0,-83.0,-79.0,-79.0,34.0,31.0,25.0,24.0,1
6402,3C:55:76:E8:8F:1F,3906483,656286151,68556,172236282,3837927,484049869,24,30210,6520402,29851,6458072,359,62330,13410,35,68628,7013,24,380,154850.0,48750.0,-43.0,-51.0,-45.0,-44.0,-45.0,-51.0,-46.0,-44.0,-83.0,-83.0,-79.0,-79.0,40.0,32.0,34.0,35.0,1
6403,92:69:1D:31:68:E9,3841871,487678201,3944,3628332,3837927,484049869,0,4904,1114780,4756,1081235,148,33545,2135,11,4161,90,0,47,216660.0,130000.0,-52.0,-49.0,-45.0,-46.0,-52.0,-49.0,-44.0,-48.0,-83.0,-83.0,-79.0,-79.0,31.0,34.0,34.0,33.0,1
6404,CC:2F:71:3F:1F:24,4704027,1426732531,866100,942682662,3837927,484049869,37,706387,751031869,705649,750943117,738,88752,680862,15,866357,91008,34,543,130000.0,43333.0,-70.0,-67.0,-66.0,-69.0,-69.0,-66.0,-65.0,-69.0,-83.0,-83.0,-79.0,-79.0,13.0,16.0,13.0,10.0,1
6405,CC:2F:71:3E:C5:1F,3838825,484159593,898,109724,3837927,484049869,0,3742,314374,3087,236640,655,77734,951,10,1288,22,0,46,130000.0,39000.0,-67.0,-68.0,-67.0,-69.0,-71.0,-72.0,-69.0,-65.0,-83.0,-83.0,-79.0,-79.0,16.0,15.0,12.0,10.0,1
6406,BA:8C:B9:54:50:24,3842781,490234720,4854,6184851,3837927,484049869,0,9112,1707593,9090,1704098,22,3495,2351,16,5307,40,0,60,229410.0,130000.0,-40.0,-37.0,-46.0,-52.0,-43.0,-35.0,-44.0,-49.0,-83.0,-83.0,-79.0,-79.0,43.0,46.0,33.0,27.0,1
6407,62:47:05:9D:EB:15,3838108,484133070,178,82939,3837930,484050131,0,309,58618,297,56314,12,2304,146,0,209,2,0,8,216660.0,130000.0,-49.0,-52.0,-54.0,-55.0,-51.0,-53.0,-54.0,-53.0,-83.0,-83.0,-79.0,-79.0,34.0,31.0,25.0,24.0,1
6408,3C:55:76:E8:8F:1F,3906491,656287490,68559,172237157,3837932,484050333,24,30226,6522516,29867,6460186,359,62330,13414,35,68631,7013,24,380,154850.0,48750.0,-42.0,-49.0,-45.0,-42.0,-42.0,-49.0,-47.0,-41.0,-83.0,-83.0,-79.0,-79.0,41.0,34.0,34.0,37.0,1
6409,92:69:1D:31:68:E9,3841876,487678665,3944,3628332,3837932,484050333,0,4905,1114848,4757,1081303,148,33545,2135,11,4161,90,0,47,216660.0,130000.0,-51.0,-48.0,-43.0,-47.0,-52.0,-48.0,-44.0,-48.0,-83.0,-83.0,-79.0,-79.0,32.0,35.0,36.0,32.0,1
6410,CC:2F:71:3F:1F:24,4704243,1426996409,866311,942946076,3837932,484050333,37,706573,751278929,705835,751190177,738,88752,681046,15,866568,91009,34,543,130000.0,43333.0,-68.0,-66.0,-69.0,-70.0,-67.0,-66.0,-68.0,-69.0,-83.0,-83.0,-79.0,-79.0,15.0,17.0,10.0,9.0,1
6411,CC:2F:71:3E:C5:1F,3838832,484160259,898,109724,3837934,484050535,0,3742,314374,3087,236640,655,77734,951,10,1288,22,0,46,130000.0,39000.0,-67.0,-68.0,-67.0,-69.0,-71.0,-72.0,-69.0,-65.0,-83.0,-83.0,-79.0,-79.0,16.0,15.0,12.0,10.0,1
6412,BA:8C:B9:54:50:24,3842788,490235386,4854,6184851,3837934,484050535,0,9112,1707593,9090,1704098,22,3495,2351,16,5307,40,0,60,229410.0,130000.0,-40.0,-37.0,-46.0,-52.0,-43.0,-35.0,-44.0,-49.0,-83.0,-83.0,-79.0,-79.0,43.0,46.0,33.0,27.0,1
6413,62:47:05:9D:EB:15,3838114,484133676,178,82939,3837936,484050737,0,309,58618,297,56314,12,2304,146,0,209,2,0,8,216660.0,130000.0,-49.0,-52.0,-54.0,-55.0,-51.0,-53.0,-54.0,-53.0,-83.0,-83.0,-79.0,-79.0,34.0,31.0,25.0,24.0,1
6414,3C:55:76:E8:8F:1F,3906498,656288444,68562,172237707,3837936,484050737,24,30237,6524880,29878,6462550,359,62330,13419,35,68634,7013,24,380,154850.0,48750.0,-47.0,-54.0,-48.0,-44.0,-45.0,-54.0,-46.0,-43.0,-83.0,-83.0,-79.0,-79.0,36.0,29.0,31.0,35.0,1
6415,92:69:1D:31:68:E9,3841880,487679069,3944,3628332,3837936,484050737,0,4905,1114848,4757,1081303,148,33545,2135,11,4161,90,0,47,216660.0,130000.0,-51.0,-48.0,-43.0,-47.0,-52.0,-48.0,-44.0,-48.0,-83.0,-83.0,-79.0,-79.0,32.0,35.0,36.0,32.0,1
6416,CC:2F:71:3F:1F:24,4704462,1427265995,866526,943215258,3837936,484050737,37,706767,751537041,706029,751448289,738,88752,681236,15,866783,91072,34,543,130000.0,43333.0,-67.0,-67.0,-68.0,-69.0,-66.0,-66.0,-67.0,-69.0,-83.0,-83.0,-79.0,-79.0,16.0,16.0,11.0,10.0,1
6417,CC:2F:71:3E:C5:1F,3838834,484160461,898,109724,3837936,484050737,0,3742,314374,3087,236640,655,77734,951,10,1288,22,0,46,130000.0,39000.0,-67.0,-68.0,-67.0,-69.0,-71.0,-72.0,-69.0,-65.0,-83.0,-83.0,-79.0,-79.0,16.0,15.0,12.0,10.0,1
6418,BA:8C:B9:54:50:24,3842790,490235588,4854,6184851,3837936,484050737,0,9112,1707593,9090,1704098,22,3495,2351,16,5307,40,0,60,229410.0,130000.0,-40.0,-37.0,-46.0,-52.0,-43.0,-35.0,-44.0,-49.0,-83.0,-83.0,-79.0,-79.0,43.0,46.0,33.0,27.0,1
6419,62:47:05:9D:EB:15,3838119,484134140,178,82939,3837941,484051201,0,309,58618,297,56314,12,2304,146,0,209,2,0,8,216660.0,130000.0,-49.0,-52.0,-54.0,-55.0,-51.0,-53.0,-54.0,-53.0,-83.0,-83.0,-79.0,-79.0,34.0,31.0,25.0,24.0,1
6420,3C:55:76:E8:8F:1F,3906505,656289110,68562,172237707,3837943,484051403,24,30246,6525494,29887,6463164,359,62330,13419,35,68634,7013,24,380,154850.0,48750.0,-47.0,-59.0,-45.0,-44.0,-46.0,-55.0,-45.0,-43.0,-83.0,-83.0,-79.0,-79.0,36.0,24.0,34.0,35.0,1
6421,92:69:1D:31:68:E9,3841889,487679937,3944,3628332,3837945,484051605,0,4905,1114848,4757,1081303,148,33545,2135,11,4161,90,0,47,216660.0,130000.0,-51.0,-48.0,-43.0,-47.0,-52.0,-48.0,-44.0,-48.0,-83.0,-83.0,-79.0,-79.0,32.0,35.0,36.0,32.0,1
6422,CC:2F:71:3F:1F:24,4704682,1427529661,866737,943478056,3837945,484051605,37,706957,751791769,706219,751703017,738,88752,681420,15,866994,91148,34,543,115556.0,28889.0,-68.0,-66.0,-67.0,-70.0,-68.0,-66.0,-67.0,-69.0,-83.0,-83.0,-79.0,-79.0,15.0,17.0,12.0,9.0,1
6423,CC:2F:71:3E:C5:1F,3838843,484161329,898,109724,3837945,484051605,0,3742,314374,3087,236640,655,77734,951,10,1288,22,0,46,130000.0,39000.0,-67.0,-68.0,-67.0,-69.0,-71.0,-72.0,-69.0,-65.0,-83.0,-83.0,-79.0,-79.0,16.0,15.0,12.0,10.0,1
6424,BA:8C:B9:54:50:24,3842799,490236456,4854,6184851,3837945,484051605,0,9112,1707593,9090,1704098,22,3495,2351,16,5307,40,0,60,229410.0,130000.0,-40.0,-37.0,-46.0,-52.0,-43.0,-35.0,-44.0,-49.0,-83.0,-83.0,-79.0,-79.0,43.0,46.0,33.0,27.0,1
6425,62:47:05:9D:EB:15,3838123,484134544,178,82939,3837945,484051605,0,309,58618,297,56314,12,2304,146,0,209,2,0,8,216660.0,130000.0,-49.0,-52.0,-54.0,-55.0,-51.0,-53.0,-54.0,-53.0,-83.0,-83.0,-79.0,-79.0,34.0,31.0,25.0,24.0,1
6426,3C:55:76:E8:8F:1F,3906508,656289428,68563,172237823,3837945,484051605,24,30254,6526042,29895,6463712,359,62330,13419,35,68635,7013,24,380,154850.0,48750.0,-44.0,-50.0,-47.0,-41.0,-42.0,-48.0,-45.0,-39.0,-83.0,-83.0,-79.0,-79.0,39.0,33.0,32.0,38.0,1
6427,92:69:1D:31:68:E9,3841892,487680255,3945,3628448,3837947,484051807,0,4907,1114984,4759,1081439,148,33545,2135,11,4162,90,0,47,216660.0,130000.0,-52.0,-47.0,-42.0,-49.0,-52.0,-48.0,-43.0,-48.0,-83.0,-83.0,-79.0,-79.0,31.0,36.0,37.0,30.0,1
6428,CC:2F:71:3F:1F:24,4704905,1427799806,866958,943747999,3837947,484051807,37,707155,752046436,706417,751957684,738,88752,681614,15,867215,91150,34,543,115556.0,28889.0,-67.0,-66.0,-68.0,-69.0,-67.0,-67.0,-69.0,-69.0,-83.0,-83.0,-79.0,-79.0,16.0,17.0,11.0,10.0,1
6429,CC:2F:71:3E:C5:1F,3838846,484161591,899,109784,3837947,484051807,0,3744,314514,3089,236780,655,77734,951,10,1289,22,0,46,130000.0,39000.0,-70.0,-71.0,-68.0,-61.0,-71.0,-72.0,-69.0,-65.0,-83.0,-83.0,-79.0,-79.0,13.0,12.0,11.0,18.0,1
6430,BA:8C:B9:54:50:24,3842802,490236774,4855,6184967,3837947,484051807,0,9116,1707865,9094,1704370,22,3495,2351,16,5308,40,0,60,229410.0,130000.0,-40.0,-37.0,-46.0,-52.0,-41.0,-35.0,-44.0,-49.0,-83.0,-83.0,-79.0,-79.0,43.0,46.0,33.0,27.0,1
6431,62:47:05:9D:EB:15,3838134,484135767,181,83354,3837953,484052413,0,312,58913,300,56609,12,2304,147,0,212,2,0,8,216660.0,130000.0,-49.0,-46.0,-45.0,-51.0,-50.0,-50.0,-51.0,-52.0,-83.0,-83.0,-79.0,-79.0,34.0,37.0,34.0,28.0,1
6432,3C:55:76:E8:8F:1F,3906516,656290236,68563,172237823,3837953,484052413,24,30254,6526042,29895,6463712,359,62330,13419,35,68635,7013,24,380,154850.0,48750.0,-44.0,-50.0,-47.0,-41.0,-42.0,-48.0,-45.0,-39.0,-83.0,-83.0,-79.0,-79.0,39.0,33.0,32.0,38.0,1
6433,92:69:1D:31:68:E9,3841899,487680921,3945,3628448,3837954,484052473,0,4907,1114984,4759,1081439,148,33545,2135,11,4162,90,0,47,216660.0,130000.0,-52.0,-47.0,-42.0,-49.0,-52.0,-48.0,-43.0,-48.0,-83.0,-83.0,-79.0,-79.0,31.0,36.0,37.0,30.0,1
6434,CC:2F:71:3F:1F:24,4705121,1428063514,867167,944011041,3837954,484052473,37,707345,752298370,706607,752209618,738,88752,681799,15,867424,91153,34,543,130000.0,39000.0,-67.0,-67.0,-69.0,-69.0,-67.0,-67.0,-68.0,-69.0,-83.0,-83.0,-79.0,-79.0,16.0,16.0,10.0,10.0,1
6435,CC:2F:71:3E:C5:1F,3838853,484162257,899,109784,3837954,484052473,0,3744,314514,3089,236780,655,77734,951,10,1289,22,0,46,130000.0,39000.0,-70.0,-71.0,-68.0,-61.0,-71.0,-72.0,-69.0,-65.0,-83.0,-83.0,-79.0,-79.0,13.0,12.0,11.0,18.0,1
6436,BA:8C:B9:54:50:24,3842809,490237440,4855,6184967,3837954,484052473,0,9116,1707865,9094,1704370,22,3495,2351,16,5308,40,0,60,229410.0,130000.0,-40.0,-37.0,-46.0,-52.0,-41.0,-35.0,-44.0,-49.0,-83.0,-83.0,-79.0,-79.0,43.0,46.0,33.0,27.0,1
6437,62:47:05:9D:EB:15,3838140,484136508,181,83354,3837959,484053154,0,312,58913,300,56609,12,2304,147,0,212,2,0,8,216660.0,130000.0,-49.0,-46.0,-45.0,-51.0,-50.0,-50.0,-51.0,-52.0,-83.0,-83.0,-79.0,-79.0,34.0,37.0,34.0,28.0,1
6438,3C:55:76:E8:8F:1F,3906523,656291093,68564,172237939,3837959,484053154,24,30263,6526878,29902,6464230,361,62648,13422,35,68636,7013,24,382,154850.0,1000.0,-44.0,-50.0,-46.0,-41.0,-43.0,-49.0,-44.0,-40.0,-83.0,-83.0,-79.0,-79.0,39.0,33.0,33.0,38.0,1
6439,92:69:1D:31:68:E9,3841904,487681602,3945,3628448,3837959,484053154,0,4907,1114984,4759,1081439,148,33545,2135,11,4162,90,0,47,216660.0,130000.0,-52.0,-47.0,-42.0,-49.0,-52.0,-48.0,-43.0,-48.0,-83.0,-83.0,-79.0,-79.0,31.0,36.0,37.0,30.0,1
6440,CC:2F:71:3F:1F:24,4705343,1428336429,867384,944283275,3837959,484053154,37,707538,752556210,706800,752467458,738,88752,681990,15,867641,91189,34,543,130000.0,43333.0,-67.0,-67.0,-69.0,-70.0,-67.0,-67.0,-68.0,-69.0,-83.0,-83.0,-79.0,-79.0,16.0,16.0,10.0,9.0,1
6441,CC:2F:71:3E:C5:1F,3838860,484163140,899,109784,3837961,484053356,0,3744,314514,3089,236780,655,77734,951,10,1289,22,0,46,130000.0,39000.0,-70.0,-71.0,-68.0,-61.0,-71.0,-72.0,-69.0,-65.0,-83.0,-83.0,-79.0,-79.0,13.0,12.0,11.0,18.0,1
6442,BA:8C:B9:54:50:24,3842816,490238323,4855,6184967,3837961,484053356,0,9116,1707865,9094,1704370,22,3495,2351,16,5308,40,0,60,229410.0,130000.0,-40.0,-37.0,-46.0,-52.0,-41.0,-35.0,-44.0,-49.0,-83.0,-83.0,-79.0,-79.0,43.0,46.0,33.0,27.0,1
6443,62:47:05:9D:EB:15,3838153,484138042,184,83952,3837969,484054090,0,316,59416,304,57112,12,2304,149,0,215,2,0,9,229410.0,130000.0,-51.0,-50.0,-47.0,-53.0,-49.0,-49.0,-48.0,-53.0,-83.0,-83.0,-79.0,-79.0,32.0,33.0,32.0,26.0,1
6444,3C:55:76:E8:8F:1F,3906533,656292029,68564,172237939,3837969,484054090,24,30273,6527744,29910,6464778,363,62966,13424,35,68636,7013,24,382,154850.0,1000.0,-44.0,-51.0,-46.0,-41.0,-42.0,-49.0,-45.0,-39.0,-83.0,-83.0,-79.0,-79.0,39.0,32.0,33.0,38.0,1
6445,92:69:1D:31:68:E9,3841914,487682538,3945,3628448,3837969,484054090,0,4907,1114984,4759,1081439,148,33545,2135,11,4162,90,0,47,216660.0,130000.0,-52.0,-47.0,-42.0,-49.0,-52.0,-48.0,-43.0,-48.0,-83.0,-83.0,-79.0,-79.0,31.0,36.0,37.0,30.0,1
6446,CC:2F:71:3F:1F:24,4705571,1428604266,867602,944550176,3837969,484054090,37,707737,752805738,706998,752716868,739,88870,682183,15,867859,91210,34,543,130000.0,43333.0,-67.0,-67.0,-68.0,-69.0,-66.0,-67.0,-67.0,-69.0,-83.0,-83.0,-79.0,-79.0,16.0,16.0,11.0,10.0,1
6447,CC:2F:71:3E:C5:1F,3838869,484163936,899,109784,3837970,484054152,0,3746,314702,3090,236850,656,77852,952,10,1289,22,0,46,130000.0,39000.0,-70.0,-71.0,-67.0,-61.0,-70.0,-71.0,-68.0,-64.0,-83.0,-83.0,-79.0,-79.0,13.0,12.0,12.0,18.0,1
6448,BA:8C:B9:54:50:24,3842825,490239119,4855,6184967,3837970,484054152,0,9116,1707865,9094,1704370,22,3495,2351,16,5308,40,0,60,229410.0,130000.0,-40.0,-37.0,-46.0,-52.0,-41.0,-35.0,-44.0,-49.0,-83.0,-83.0,-79.0,-79.0,43.0,46.0,33.0,27.0,1
6449,62:47:05:9D:EB:15,3838158,484138428,184,83952,3837974,484054476,0,317,59484,305,57180,12,2304,149,0,215,2,0,9,229410.0,130000.0,-48.0,-46.0,-43.0,-52.0,-49.0,-49.0,-47.0,-53.0,-83.0,-83.0,-79.0,-79.0,35.0,37.0,36.0,27.0,1
6450,3C:55:76:E8:8F:1F,3906540,656292617,68564,172237939,3837976,484054678,24,30289,6528940,29924,6465738,365,63202,13426,35,68636,7013,24,382,154850.0,1000.0,-44.0,-51.0,-47.0,-42.0,-43.0,-51.0,-45.0,-40.0,-83.0,-83.0,-79.0,-79.0,39.0,32.0,32.0,37.0,1
6451,92:69:1D:31:68:E9,3841923,487683494,3945,3628448,3837978,484055046,0,4907,1114984,4759,1081439,148,33545,2135,11,4162,90,0,47,216660.0,130000.0,-52.0,-47.0,-42.0,-49.0,-52.0,-48.0,-43.0,-48.0,-83.0,-83.0,-79.0,-79.0,31.0,36.0,37.0,30.0,1
6452,CC:2F:71:3F:1F:24,4705790,1428868282,867812,944813236,3837978,484055046,37,707930,753063662,707191,752974792,739,88870,682368,15,868069,91240,34,543,130000.0,43333.0,-67.0,-67.0,-69.0,-69.0,-67.0,-66.0,-67.0,-69.0,-83.0,-83.0,-79.0,-79.0,16.0,16.0,10.0,10.0,1
6453,CC:2F:71:3E:C5:1F,3838881,484165234,899,109784,3837982,484055450,0,3746,314702,3090,236850,656,77852,952,10,1289,22,0,46,130000.0,39000.0,-70.0,-71.0,-67.0,-61.0,-70.0,-71.0,-68.0,-64.0,-83.0,-83.0,-79.0,-79.0,13.0,12.0,12.0,18.0,1
6454,BA:8C:B9:54:50:24,3842837,490240417,4855,6184967,3837982,484055450,0,9116,1707865,9094,1704370,22,3495,2351,16,5308,40,0,60,229410.0,130000.0,-40.0,-37.0,-46.0,-52.0,-41.0,-35.0,-44.0,-49.0,-83.0,-83.0,-79.0,-79.0,43.0,46.0,33.0,27.0,1
6455,62:47:05:9D:EB:15,3838166,484139402,184,83952,3837982,484055450,0,317,59484,305,57180,12,2304,149,0,215,2,0,9,229410.0,130000.0,-48.0,-46.0,-43.0,-52.0,-49.0,-49.0,-47.0,-53.0,-83.0,-83.0,-79.0,-79.0,35.0,37.0,36.0,27.0,1
6456,3C:55:76:E8:8F:1F,3906546,656293389,68564,172237939,3837982,484055450,24,30289,6528940,29924,6465738,365,63202,13426,35,68636,7013,24,382,154850.0,1000.0,-44.0,-51.0,-47.0,-42.0,-43.0,-51.0,-45.0,-40.0,-83.0,-83.0,-79.0,-79.0,39.0,32.0,32.0,37.0,1
6457,92:69:1D:31:68:E9,3841927,487683898,3945,3628448,3837982,484055450,0,4907,1114984,4759,1081439,148,33545,2135,11,4162,90,0,47,216660.0,130000.0,-52.0,-47.0,-42.0,-49.0,-52.0,-48.0,-43.0,-48.0,-83.0,-83.0,-79.0,-79.0,31.0,36.0,37.0,30.0,1
6458,CC:2F:71:3F:1F:24,4706011,1429141410,868029,945085960,3837982,484055450,37,708131,753331280,707392,753242410,739,88870,682560,15,868286,91252,34,543,130000.0,43333.0,-67.0,-67.0,-68.0,-71.0,-67.0,-67.0,-68.0,-70.0,-83.0,-83.0,-79.0,-79.0,16.0,16.0,11.0,8.0,1
6459,CC:2F:71:3E:C5:1F,3838883,484165436,899,109784,3837984,484055652,0,3746,314702,3090,236850,656,77852,952,10,1289,22,0,46,130000.0,39000.0,-70.0,-71.0,-67.0,-61.0,-70.0,-71.0,-68.0,-64.0,-83.0,-83.0,-79.0,-79.0,13.0,12.0,12.0,18.0,1
6460,BA:8C:B9:54:50:24,3842839,490240619,4855,6184967,3837984,484055652,0,9116,1707865,9094,1704370,22,3495,2351,16,5308,40,0,60,229410.0,130000.0,-40.0,-37.0,-46.0,-52.0,-41.0,-35.0,-44.0,-49.0,-83.0,-83.0,-79.0,-79.0,43.0,46.0,33.0,27.0,1
6461,62:47:05:9D:EB:15,3838175,484140270,184,83952,3837991,484056318,0,317,59484,305,57180,12,2304,149,0,215,2,0,9,229410.0,130000.0,-48.0,-46.0,-43.0,-52.0,-49.0,-49.0,-47.0,-53.0,-83.0,-83.0,-79.0,-79.0,35.0,37.0,36.0,27.0,1
6462,3C:55:76:E8:8F:1F,3906565,656306317,68574,172249999,3837991,484056318,24,30323,6532840,29958,6469638,365,63202,13441,35,68646,7013,24,382,146250.0,48750.0,-45.0,-54.0,-43.0,-41.0,-44.0,-52.0,-45.0,-40.0,-83.0,-83.0,-79.0,-79.0,38.0,29.0,36.0,38.0,1
6463,92:69:1D:31:68:E9,3841936,487684766,3945,3628448,3837991,484056318,0,4907,1114984,4759,1081439,148,33545,2135,11,4162,90,0,47,216660.0,130000.0,-52.0,-47.0,-42.0,-49.0,-52.0,-48.0,-43.0,-48.0,-83.0,-83.0,-79.0,-79.0,31.0,36.0,37.0,30.0,1
6464,CC:2F:71:3F:1F:24,4706243,1429423780,868252,945367462,3837991,484056318,37,708336,753606288,707597,753517418,739,88870,682758,15,868509,91342,34,543,117000.0,39000.0,-68.0,-67.0,-68.0,-70.0,-68.0,-66.0,-67.0,-70.0,-83.0,-83.0,-79.0,-79.0,15.0,16.0,11.0,9.0,1
6465,CC:2F:71:3E:C5:1F,3838890,484166102,899,109784,3837991,484056318,0,3746,314702,3090,236850,656,77852,952,10,1289,22,0,46,130000.0,39000.0,-70.0,-71.0,-67.0,-61.0,-70.0,-71.0,-68.0,-64.0,-83.0,-83.0,-79.0,-79.0,13.0,12.0,12.0,18.0,1
6466,BA:8C:B9:54:50:24,3842846,490241285,4855,6184967,3837991,484056318,0,9116,1707865,9094,1704370,22,3495,2351,16,5308,40,0,60,229410.0,130000.0,-40.0,-37.0,-46.0,-52.0,-41.0,-35.0,-44.0,-49.0,-83.0,-83.0,-79.0,-79.0,43.0,46.0,33.0,27.0,1
6467,62:47:05:9D:EB:15,3838177,484140472,184,83952,3837993,484056520,0,317,59484,305,57180,12,2304,149,0,215,2,0,9,229410.0,130000.0,-48.0,-46.0,-43.0,-52.0,-49.0,-49.0,-47.0,-53.0,-83.0,-83.0,-79.0,-79.0,35.0,37.0,36.0,27.0,1
6468,3C:55:76:E8:8F:1F,3906567,656306519,68574,172249999,3837993,484056520,24,30324,6532910,29959,6469708,365,63202,13441,35,68646,7013,24,382,146250.0,48750.0,-45.0,-55.0,-43.0,-41.0,-44.0,-52.0,-45.0,-41.0,-83.0,-83.0,-79.0,-79.0,38.0,28.0,36.0,38.0,1
6469,92:69:1D:31:68:E9,3841938,487684968,3945,3628448,3837993,484056520,0,4907,1114984,4759,1081439,148,33545,2135,11,4162,90,0,47,216660.0,130000.0,-52.0,-47.0,-42.0,-49.0,-52.0,-48.0,-43.0,-48.0,-83.0,-83.0,-79.0,-79.0,31.0,36.0,37.0,30.0,1
6470,CC:2F:71:3F:1F:24,4706465,1429690791,868472,945634271,3837993,484056520,37,708535,753858346,707796,753769476,739,88870,682953,15,868729,91365,34,544,115556.0,28889.0,-68.0,-67.0,-69.0,-69.0,-68.0,-67.0,-68.0,-69.0,-83.0,-83.0,-79.0,-79.0,15.0,16.0,10.0,10.0,1
6471,CC:2F:71:3E:C5:1F,3838892,484166304,899,109784,3837993,484056520,0,3746,314702,3090,236850,656,77852,952,10,1289,22,0,46,130000.0,39000.0,-70.0,-71.0,-67.0,-61.0,-70.0,-71.0,-68.0,-64.0,-83.0,-83.0,-79.0,-79.0,13.0,12.0,12.0,18.0,1
6472,BA:8C:B9:54:50:24,3842848,490241487,4855,6184967,3837993,484056520,0,9116,1707865,9094,1704370,22,3495,2351,16,5308,40,0,60,229410.0,130000.0,-40.0,-37.0,-46.0,-52.0,-41.0,-35.0,-44.0,-49.0,-83.0,-83.0,-79.0,-79.0,43.0,46.0,33.0,27.0,1
6473,62:47:05:9D:EB:15,3838186,484141587,184,83952,3838002,484057635,0,317,59484,305,57180,12,2304,149,0,215,2,0,9,229410.0,130000.0,-48.0,-46.0,-43.0,-52.0,-49.0,-49.0,-47.0,-53.0,-83.0,-83.0,-80.0,-79.0,35.0,37.0,37.0,27.0,1
6474,3C:55:76:E8:8F:1F,3906577,656307800,68575,172250165,3838002,484057635,24,30337,6534352,29970,6470589,367,63763,13445,35,68647,7013,24,383,146250.0,48750.0,-46.0,-53.0,-46.0,-43.0,-45.0,-54.0,-45.0,-43.0,-83.0,-83.0,-80.0,-79.0,37.0,30.0,34.0,36.0,1
6475,92:69:1D:31:68:E9,3841947,487686083,3945,3628448,3838002,484057635,0,4909,1115120,4761,1081575,148,33545,2135,11,4163,90,0,47,216660.0,130000.0,-52.0,-49.0,-44.0,-47.0,-52.0,-48.0,-43.0,-47.0,-83.0,-83.0,-80.0,-79.0,31.0,34.0,36.0,32.0,1
6476,CC:2F:71:3F:1F:24,4706686,1429958060,868684,945900425,3838002,484057635,37,708732,754119696,707993,754030826,739,88870,683140,15,868941,91367,34,544,117000.0,39000.0,-69.0,-67.0,-68.0,-70.0,-69.0,-67.0,-68.0,-69.0,-83.0,-83.0,-80.0,-79.0,14.0,16.0,12.0,9.0,1
6477,CC:2F:71:3E:C5:1F,3838901,484167419,899,109784,3838002,484057635,0,3748,314842,3092,236990,656,77852,952,10,1290,22,0,46,130000.0,39000.0,-71.0,-72.0,-67.0,-61.0,-69.0,-70.0,-66.0,-62.0,-83.0,-83.0,-80.0,-79.0,12.0,11.0,13.0,18.0,1
6478,BA:8C:B9:54:50:24,3842857,490242602,4855,6184967,3838002,484057635,0,9119,1708069,9097,1704574,22,3495,2351,16,5309,40,0,60,229410.0,130000.0,-40.0,-37.0,-46.0,-52.0,-41.0,-36.0,-44.0,-49.0,-83.0,-83.0,-80.0,-79.0,43.0,46.0,34.0,27.0,1
6479,62:47:05:9D:EB:15,3838189,484142014,184,83952,3838005,484058062,0,319,59620,307,57316,12,2304,149,0,216,2,0,9,229410.0,130000.0,-51.0,-52.0,-41.0,-46.0,-49.0,-48.0,-44.0,-51.0,-83.0,-83.0,-80.0,-79.0,32.0,31.0,39.0,33.0,1
6480,3C:55:76:E8:8F:1F,3906581,656308451,68575,172250165,3838006,484058286,24,30345,6535325,29976,6471001,369,64324,13447,35,68647,7013,24,383,146250.0,48750.0,-44.0,-49.0,-42.0,-45.0,-45.0,-52.0,-44.0,-43.0,-83.0,-83.0,-80.0,-79.0,39.0,34.0,38.0,34.0,1
6481,92:69:1D:31:68:E9,3841951,487686734,3945,3628448,3838006,484058286,0,4909,1115120,4761,1081575,148,33545,2135,11,4163,90,0,47,216660.0,130000.0,-52.0,-49.0,-44.0,-47.0,-52.0,-48.0,-43.0,-47.0,-83.0,-83.0,-80.0,-79.0,31.0,34.0,36.0,32.0,1
6482,CC:2F:71:3F:1F:24,4706902,1430224205,868894,946165717,3838008,484058488,37,708923,754374484,708184,754285614,739,88870,683327,15,869151,91390,34,544,130000.0,43333.0,-69.0,-67.0,-68.0,-69.0,-69.0,-67.0,-67.0,-68.0,-83.0,-83.0,-80.0,-79.0,14.0,16.0,12.0,10.0,1
6483,CC:2F:71:3E:C5:1F,3838907,484168272,899,109784,3838008,484058488,0,3748,314842,3092,236990,656,77852,952,10,1290,22,0,46,130000.0,39000.0,-71.0,-72.0,-67.0,-61.0,-69.0,-70.0,-66.0,-62.0,-83.0,-83.0,-80.0,-79.0,12.0,11.0,13.0,18.0,1
6484,BA:8C:B9:54:50:24,3842863,490243455,4855,6184967,3838008,484058488,0,9119,1708069,9097,1704574,22,3495,2351,16,5309,40,0,60,229410.0,130000.0,-40.0,-37.0,-46.0,-52.0,-41.0,-36.0,-44.0,-49.0,-83.0,-83.0,-80.0,-79.0,43.0,46.0,34.0,27.0,1
6485,62:47:05:9D:EB:15,3838197,484142906,184,83952,3838013,484058954,0,320,59688,308,57384,12,2304,149,0,216,2,0,9,229410.0,130000.0,-45.0,-47.0,-47.0,-54.0,-49.0,-48.0,-44.0,-51.0,-83.0,-83.0,-80.0,-79.0,38.0,36.0,33.0,25.0,1
6486,3C:55:76:E8:8F:1F,3906588,656309119,68575,172250165,3838013,484058954,24,30360,6536401,29990,6471959,370,64442,13448,35,68647,7013,24,384,146250.0,48750.0,-45.0,-52.0,-48.0,-42.0,-42.0,-49.0,-45.0,-41.0,-83.0,-83.0,-80.0,-79.0,38.0,31.0,32.0,37.0,1
6487,92:69:1D:31:68:E9,3841958,487687402,3945,3628448,3838013,484058954,0,4909,1115120,4761,1081575,148,33545,2135,11,4163,90,0,47,216660.0,130000.0,-52.0,-49.0,-44.0,-47.0,-52.0,-48.0,-43.0,-47.0,-83.0,-83.0,-80.0,-79.0,31.0,34.0,36.0,32.0,1
6488,CC:2F:71:3F:1F:24,4707128,1430494635,869112,946435172,3838016,484059463,37,709121,754629322,708382,754540452,739,88870,683521,15,869369,91427,34,544,115556.0,28889.0,-68.0,-67.0,-67.0,-70.0,-68.0,-66.0,-67.0,-69.0,-83.0,-83.0,-80.0,-79.0,15.0,16.0,13.0,9.0,1
6489,CC:2F:71:3E:C5:1F,3838915,484169247,899,109784,3838016,484059463,0,3748,314842,3092,236990,656,77852,952,10,1290,22,0,46,130000.0,39000.0,-71.0,-72.0,-67.0,-61.0,-69.0,-70.0,-66.0,-62.0,-83.0,-83.0,-80.0,-79.0,12.0,11.0,13.0,18.0,1
6490,BA:8C:B9:54:50:24,3842871,490244430,4855,6184967,3838016,484059463,0,9119,1708069,9097,1704574,22,3495,2351,16,5309,40,0,60,229410.0,130000.0,-40.0,-37.0,-46.0,-52.0,-41.0,-36.0,-44.0,-49.0,-83.0,-83.0,-80.0,-79.0,43.0,46.0,34.0,27.0,1
6491,62:47:05:9D:EB:15,3838204,484143819,184,83952,3838020,484059867,0,320,59688,308,57384,12,2304,149,0,216,2,0,9,229410.0,130000.0,-45.0,-47.0,-47.0,-54.0,-49.0,-48.0,-44.0,-51.0,-83.0,-83.0,-80.0,-79.0,38.0,36.0,33.0,25.0,1
6492,3C:55:76:E8:8F:1F,3906599,656310618,68579,172250751,3838020,484059867,24,30385,6539505,30013,6474502,372,65003,13454,35,68651,7013,24,386,146250.0,48750.0,-49.0,-55.0,-45.0,-44.0,-48.0,-52.0,-45.0,-43.0,-83.0,-83.0,-80.0,-79.0,34.0,28.0,35.0,35.0,1
6493,92:69:1D:31:68:E9,3841965,487688315,3945,3628448,3838020,484059867,0,4909,1115120,4761,1081575,148,33545,2135,11,4163,90,0,47,216660.0,130000.0,-52.0,-49.0,-44.0,-47.0,-52.0,-48.0,-43.0,-47.0,-83.0,-83.0,-80.0,-79.0,31.0,34.0,36.0,32.0,1
6494,CC:2F:71:3F:1F:24,4707341,1430758193,869321,946698326,3838020,484059867,37,709311,754881256,708572,754792386,739,88870,683706,15,869578,91428,34,544,115556.0,28889.0,-68.0,-66.0,-68.0,-68.0,-68.0,-65.0,-68.0,-67.0,-83.0,-83.0,-80.0,-79.0,15.0,17.0,12.0,11.0,1
6495,CC:2F:71:3E:C5:1F,3838919,484169651,899,109784,3838020,484059867,0,3748,314842,3092,236990,656,77852,952,10,1290,22,0,46,130000.0,39000.0,-71.0,-72.0,-67.0,-61.0,-69.0,-70.0,-66.0,-62.0,-83.0,-83.0,-80.0,-79.0,12.0,11.0,13.0,18.0,1
6496,BA:8C:B9:54:50:24,3842881,490245687,4855,6184967,3838026,484060720,0,9119,1708069,9097,1704574,22,3495,2351,16,5309,40,0,60,229410.0,130000.0,-40.0,-37.0,-46.0,-52.0,-41.0,-36.0,-44.0,-49.0,-83.0,-83.0,-80.0,-79.0,43.0,46.0,34.0,27.0,1
6497,62:47:05:9D:EB:15,3838210,484144672,184,83952,3838026,484060720,0,320,59688,308,57384,12,2304,149,0,216,2,0,9,229410.0,130000.0,-45.0,-47.0,-47.0,-54.0,-49.0,-48.0,-44.0,-51.0,-83.0,-83.0,-80.0,-79.0,38.0,36.0,33.0,25.0,1
6498,3C:55:76:E8:8F:1F,3906606,656311747,68580,172251027,3838026,484060720,24,30402,6541263,30028,6475699,374,65564,13458,35,68652,7013,24,387,146250.0,48750.0,-48.0,-52.0,-45.0,-45.0,-48.0,-51.0,-44.0,-44.0,-83.0,-83.0,-80.0,-79.0,35.0,31.0,35.0,34.0,1
6499,92:69:1D:31:68:E9,3841971,487689168,3945,3628448,3838026,484060720,0,4909,1115120,4761,1081575,148,33545,2135,11,4163,90,0,47,216660.0,130000.0,-52.0,-49.0,-44.0,-47.0,-52.0,-48.0,-43.0,-47.0,-83.0,-83.0,-80.0,-79.0,31.0,34.0,36.0,32.0,1
6500,CC:2F:71:3F:1F:24,4707555,1431018772,869527,946957850,3838028,484060922,37,709499,755131494,708760,755042624,739,88870,683888,15,869784,91435,34,544,130000.0,43333.0,-69.0,-65.0,-66.0,-69.0,-69.0,-65.0,-66.0,-69.0,-83.0,-83.0,-80.0,-79.0,14.0,18.0,14.0,10.0,1
6501,CC:2F:71:3E:C5:1F,3838927,484170706,899,109784,3838028,484060922,0,3748,314842,3092,236990,656,77852,952,10,1290,22,0,46,130000.0,39000.0,-71.0,-72.0,-67.0,-61.0,-69.0,-70.0,-66.0,-62.0,-83.0,-83.0,-80.0,-79.0,12.0,11.0,13.0,18.0,1
6502,BA:8C:B9:54:50:24,3842883,490245889,4855,6184967,3838028,484060922,0,9119,1708069,9097,1704574,22,3495,2351,16,5309,40,0,60,229410.0,130000.0,-40.0,-37.0,-46.0,-52.0,-41.0,-36.0,-44.0,-49.0,-83.0,-83.0,-80.0,-79.0,43.0,46.0,34.0,27.0,1
6503,62:47:05:9D:EB:15,3838216,484145409,184,83952,3838032,484061457,0,320,59688,308,57384,12,2304,149,0,216,2,0,9,229410.0,130000.0,-45.0,-47.0,-47.0,-54.0,-49.0,-48.0,-44.0,-51.0,-83.0,-83.0,-80.0,-79.0,38.0,36.0,33.0,25.0,1
6504,3C:55:76:E8:8F:1F,3906614,656312686,68580,172251027,3838034,484061659,24,30402,6541263,30028,6475699,374,65564,13458,35,68652,7013,24,387,146250.0,48750.0,-48.0,-52.0,-45.0,-45.0,-48.0,-51.0,-44.0,-44.0,-83.0,-83.0,-80.0,-79.0,35.0,31.0,35.0,34.0,1
6505,92:69:1D:31:68:E9,3841979,487690107,3945,3628448,3838034,484061659,0,4909,1115120,4761,1081575,148,33545,2135,11,4163,90,0,47,216660.0,130000.0,-52.0,-49.0,-44.0,-47.0,-52.0,-48.0,-43.0,-47.0,-83.0,-83.0,-80.0,-79.0,31.0,34.0,36.0,32.0,1
6506,CC:2F:71:3F:1F:24,4707774,1431283125,869738,947221264,3838036,484061861,37,709689,755386194,708950,755297324,739,88870,684072,15,869995,91436,34,544,130000.0,43333.0,-68.0,-65.0,-68.0,-69.0,-67.0,-65.0,-68.0,-69.0,-83.0,-83.0,-80.0,-79.0,15.0,18.0,12.0,10.0,1
6507,CC:2F:71:3E:C5:1F,3838935,484171645,899,109784,3838036,484061861,0,3748,314842,3092,236990,656,77852,952,10,1290,22,0,46,130000.0,39000.0,-71.0,-72.0,-67.0,-61.0,-69.0,-70.0,-66.0,-62.0,-83.0,-83.0,-80.0,-79.0,12.0,11.0,13.0,18.0,1
6508,BA:8C:B9:54:50:24,3842891,490246828,4855,6184967,3838036,484061861,0,9120,1708137,9098,1704642,22,3495,2351,16,5309,40,0,60,229410.0,130000.0,-40.0,-37.0,-46.0,-52.0,-41.0,-36.0,-44.0,-49.0,-83.0,-83.0,-80.0,-79.0,43.0,46.0,34.0,27.0,1
6509,62:47:05:9D:EB:15,3838222,484146015,184,83952,3838038,484062063,0,320,59688,308,57384,12,2304,149,0,216,2,0,9,229410.0,130000.0,-45.0,-47.0,-47.0,-54.0,-49.0,-48.0,-44.0,-51.0,-83.0,-83.0,-80.0,-79.0,38.0,36.0,33.0,25.0,1
6510,3C:55:76:E8:8F:1F,3906618,656313090,68580,172251027,3838038,484062063,24,30402,6541263,30028,6475699,374,65564,13458,35,68652,7013,24,387,146250.0,48750.0,-48.0,-52.0,-45.0,-45.0,-48.0,-51.0,-44.0,-44.0,-83.0,-83.0,-80.0,-79.0,35.0,31.0,35.0,34.0,1
6511,92:69:1D:31:68:E9,3841983,487690511,3945,3628448,3838038,484062063,0,4909,1115120,4761,1081575,148,33545,2135,11,4163,90,0,47,216660.0,130000.0,-52.0,-49.0,-44.0,-47.0,-52.0,-48.0,-43.0,-47.0,-83.0,-83.0,-80.0,-79.0,31.0,34.0,36.0,32.0,1
6512,CC:2F:71:3F:1F:24,4707995,1431552966,869957,947490903,3838038,484062063,37,709891,755645674,709152,755556804,739,88870,684268,15,870214,91445,34,544,130000.0,43333.0,-69.0,-65.0,-66.0,-69.0,-69.0,-64.0,-66.0,-68.0,-83.0,-83.0,-80.0,-79.0,14.0,18.0,14.0,10.0,1
6513,CC:2F:71:3E:C5:1F,3838937,484171847,899,109784,3838038,484062063,0,3748,314842,3092,236990,656,77852,952,10,1290,22,0,46,130000.0,39000.0,-71.0,-72.0,-67.0,-61.0,-69.0,-70.0,-66.0,-62.0,-83.0,-83.0,-80.0,-79.0,12.0,11.0,13.0,18.0,1
6514,BA:8C:B9:54:50:24,3842893,490247030,4855,6184967,3838038,484062063,0,9120,1708137,9098,1704642,22,3495,2351,16,5309,40,0,60,229410.0,130000.0,-40.0,-37.0,-46.0,-52.0,-41.0,-36.0,-44.0,-49.0,-83.0,-83.0,-80.0,-79.0,43.0,46.0,34.0,27.0,1
6515,62:47:05:9D:EB:15,3838229,484146681,184,83952,3838045,484062729,0,320,59688,308,57384,12,2304,149,0,216,2,0,9,229410.0,130000.0,-45.0,-47.0,-47.0,-54.0,-49.0,-48.0,-44.0,-51.0,-83.0,-83.0,-80.0,-79.0,38.0,36.0,33.0,25.0,1
6516,3C:55:76:E8:8F:1F,3906625,656313756,68580,172251027,3838045,484062729,24,30402,6541263,30028,6475699,374,65564,13458,35,68652,7013,24,387,146250.0,48750.0,-48.0,-52.0,-45.0,-45.0,-48.0,-51.0,-44.0,-44.0,-83.0,-83.0,-80.0,-79.0,35.0,31.0,35.0,34.0,1
6517,92:69:1D:31:68:E9,3841990,487691177,3945,3628448,3838045,484062729,0,4909,1115120,4761,1081575,148,33545,2135,11,4163,90,0,47,216660.0,130000.0,-52.0,-49.0,-44.0,-47.0,-52.0,-48.0,-43.0,-47.0,-83.0,-83.0,-80.0,-79.0,31.0,34.0,36.0,32.0,1
6518,CC:2F:71:3F:1F:24,4708212,1431819540,870167,947756811,3838045,484062729,37,710088,755909942,709349,755821072,739,88870,684453,15,870422,91458,34,544,130000.0,43333.0,-69.0,-64.0,-69.0,-70.0,-69.0,-64.0,-68.0,-69.0,-83.0,-83.0,-80.0,-79.0,14.0,19.0,11.0,9.0,1
6519,CC:2F:71:3E:C5:1F,3838944,484172513,899,109784,3838045,484062729,0,3748,314842,3092,236990,656,77852,952,10,1290,22,0,46,130000.0,39000.0,-71.0,-72.0,-67.0,-61.0,-69.0,-70.0,-66.0,-62.0,-83.0,-83.0,-80.0,-79.0,12.0,11.0,13.0,18.0,1
6520,BA:8C:B9:54:50:24,3842900,490247696,4855,6184967,3838045,484062729,0,9120,1708137,9098,1704642,22,3495,2351,16,5309,40,0,60,229410.0,130000.0,-40.0,-37.0,-46.0,-52.0,-41.0,-36.0,-44.0,-49.0,-83.0,-83.0,-80.0,-79.0,43.0,46.0,34.0,27.0,1
6521,62:47:05:9D:EB:15,3838231,484146883,184,83952,3838047,484062931,0,320,59688,308,57384,12,2304,149,0,216,2,0,9,229410.0,130000.0,-45.0,-47.0,-47.0,-54.0,-49.0,-48.0,-44.0,-51.0,-83.0,-83.0,-80.0,-79.0,38.0,36.0,33.0,25.0,1
6522,3C:55:76:E8:8F:1F,3906628,656314107,68581,172251176,3838047,484062931,24,30412,6542054,30038,6476490,374,65564,13460,35,68653,7013,24,387,135410.0,1000.0,-48.0,-55.0,-48.0,-43.0,-46.0,-53.0,-47.0,-42.0,-83.0,-83.0,-80.0,-79.0,35.0,28.0,32.0,36.0,1
6523,92:69:1D:31:68:E9,3841992,487691379,3945,3628448,3838047,484062931,0,4909,1115120,4761,1081575,148,33545,2135,11,4163,90,0,47,216660.0,130000.0,-52.0,-49.0,-44.0,-47.0,-52.0,-48.0,-43.0,-47.0,-83.0,-83.0,-80.0,-79.0,31.0,34.0,36.0,32.0,1
6524,CC:2F:71:3F:1F:24,4708425,1432080026,870376,948016893,3838049,484063133,37,710275,756158556,709536,756069686,739,88870,684637,15,870633,91495,34,544,130000.0,43333.0,-67.0,-65.0,-69.0,-67.0,-67.0,-65.0,-68.0,-67.0,-83.0,-83.0,-80.0,-79.0,16.0,18.0,11.0,12.0,1
6525,CC:2F:71:3E:C5:1F,3838948,484172917,899,109784,3838049,484063133,0,3748,314842,3092,236990,656,77852,952,10,1290,22,0,46,130000.0,39000.0,-71.0,-72.0,-67.0,-61.0,-69.0,-70.0,-66.0,-62.0,-83.0,-83.0,-80.0,-79.0,12.0,11.0,13.0,18.0,1
6526,BA:8C:B9:54:50:24,3842904,490248100,4855,6184967,3838049,484063133,0,9120,1708137,9098,1704642,22,3495,2351,16,5309,40,0,60,229410.0,130000.0,-40.0,-37.0,-46.0,-52.0,-41.0,-36.0,-44.0,-49.0,-83.0,-83.0,-80.0,-79.0,43.0,46.0,34.0,27.0,1
6527,62:47:05:9D:EB:15,3838237,484147489,184,83952,3838053,484063537,0,320,59688,308,57384,12,2304,149,0,216,2,0,9,229410.0,130000.0,-45.0,-47.0,-47.0,-54.0,-49.0,-48.0,-44.0,-51.0,-83.0,-83.0,-80.0,-79.0,38.0,36.0,33.0,25.0,1
6528,3C:55:76:E8:8F:1F,3906639,656318952,68586,172255415,3838053,484063537,24,30431,6546230,30057,6480666,374,65564,13465,35,68658,7014,24,387,135410.0,1000.0,-45.0,-53.0,-50.0,-40.0,-45.0,-52.0,-48.0,-40.0,-83.0,-83.0,-80.0,-79.0,38.0,30.0,30.0,39.0,1
6529,92:69:1D:31:68:E9,3841998,487691985,3945,3628448,3838053,484063537,0,4909,1115120,4761,1081575,148,33545,2135,11,4163,90,0,47,216660.0,130000.0,-52.0,-49.0,-44.0,-47.0,-52.0,-48.0,-43.0,-47.0,-83.0,-83.0,-80.0,-79.0,31.0,34.0,36.0,32.0,1
6530,CC:2F:71:3F:1F:24,4708647,1432344397,870593,948280800,3838054,484063597,37,710466,756401183,709727,756312313,739,88870,684826,15,870850,91497,34,544,130000.0,39000.0,-67.0,-66.0,-67.0,-68.0,-67.0,-66.0,-66.0,-68.0,-83.0,-83.0,-80.0,-79.0,16.0,17.0,13.0,11.0,1
6531,CC:2F:71:3E:C5:1F,3838953,484173381,899,109784,3838054,484063597,0,3748,314842,3092,236990,656,77852,952,10,1290,22,0,46,130000.0,39000.0,-71.0,-72.0,-67.0,-61.0,-69.0,-70.0,-66.0,-62.0,-83.0,-83.0,-80.0,-79.0,12.0,11.0,13.0,18.0,1
6532,BA:8C:B9:54:50:24,3842909,490248564,4855,6184967,3838054,484063597,0,9120,1708137,9098,1704642,22,3495,2351,16,5309,40,0,60,229410.0,130000.0,-40.0,-37.0,-46.0,-52.0,-41.0,-36.0,-44.0,-49.0,-83.0,-83.0,-80.0,-79.0,43.0,46.0,34.0,27.0,1
6533,62:47:05:9D:EB:15,3838242,484147953,184,83952,3838058,484064001,0,320,59688,308,57384,12,2304,149,0,216,2,0,9,229410.0,130000.0,-45.0,-47.0,-47.0,-54.0,-49.0,-48.0,-44.0,-51.0,-83.0,-83.0,-80.0,-79.0,38.0,36.0,33.0,25.0,1
6534,3C:55:76:E8:8F:1F,3906657,656327688,68599,172263687,3838058,484064001,24,30467,6553026,30093,6487462,374,65564,13479,35,68671,7014,24,387,154850.0,48750.0,-45.0,-59.0,-49.0,-40.0,-46.0,-58.0,-49.0,-41.0,-83.0,-83.0,-80.0,-79.0,38.0,24.0,31.0,39.0,1
6535,92:69:1D:31:68:E9,3842003,487692449,3945,3628448,3838058,484064001,0,4909,1115120,4761,1081575,148,33545,2135,11,4163,90,0,47,216660.0,130000.0,-52.0,-49.0,-44.0,-47.0,-52.0,-48.0,-43.0,-47.0,-83.0,-83.0,-80.0,-79.0,31.0,34.0,36.0,32.0,1
6536,CC:2F:71:3F:1F:24,4708856,1432601515,870798,948537514,3838058,484064001,37,710648,756643507,709909,756554637,739,88870,685006,15,871055,91514,34,544,130000.0,43333.0,-68.0,-65.0,-68.0,-68.0,-68.0,-65.0,-67.0,-68.0,-83.0,-83.0,-80.0,-79.0,15.0,18.0,12.0,11.0,1
6537,CC:2F:71:3E:C5:1F,3838957,484173785,899,109784,3838058,484064001,0,3748,314842,3092,236990,656,77852,952,10,1290,22,0,46,130000.0,39000.0,-71.0,-72.0,-67.0,-61.0,-69.0,-70.0,-66.0,-62.0,-83.0,-83.0,-80.0,-79.0,12.0,11.0,13.0,18.0,1
6538,BA:8C:B9:54:50:24,3842913,490248968,4855,6184967,3838058,484064001,0,9120,1708137,9098,1704642,22,3495,2351,16,5309,40,0,60,229410.0,130000.0,-40.0,-37.0,-46.0,-52.0,-41.0,-36.0,-44.0,-49.0,-83.0,-83.0,-80.0,-79.0,43.0,46.0,34.0,27.0,1
6539,62:47:05:9D:EB:15,3838246,484148357,184,83952,3838062,484064405,0,320,59688,308,57384,12,2304,149,0,216,2,0,9,229410.0,130000.0,-45.0,-47.0,-47.0,-54.0,-49.0,-48.0,-44.0,-51.0,-83.0,-83.0,-80.0,-79.0,38.0,36.0,33.0,25.0,1
6540,3C:55:76:E8:8F:1F,3906665,656331569,68603,172267164,3838062,484064405,24,30488,6557908,30114,6492344,374,65564,13484,35,68675,7014,24,387,154850.0,48750.0,-45.0,-61.0,-48.0,-40.0,-45.0,-59.0,-47.0,-40.0,-83.0,-83.0,-80.0,-79.0,38.0,22.0,32.0,39.0,1
6541,92:69:1D:31:68:E9,3842007,487692853,3945,3628448,3838062,484064405,0,4909,1115120,4761,1081575,148,33545,2135,11,4163,90,0,47,216660.0,130000.0,-52.0,-49.0,-44.0,-47.0,-52.0,-48.0,-43.0,-47.0,-83.0,-83.0,-80.0,-79.0,31.0,34.0,36.0,32.0,1
6542,CC:2F:71:3F:1F:24,4709069,1432862167,871005,948797560,3838064,484064607,37,710833,756890451,710094,756801581,739,88870,685189,15,871262,91515,34,544,130000.0,43333.0,-69.0,-65.0,-68.0,-65.0,-68.0,-65.0,-67.0,-67.0,-83.0,-83.0,-80.0,-79.0,14.0,18.0,12.0,14.0,1
6543,CC:2F:71:3E:C5:1F,3838963,484174391,899,109784,3838064,484064607,0,3748,314842,3092,236990,656,77852,952,10,1290,22,0,46,130000.0,39000.0,-71.0,-72.0,-67.0,-61.0,-69.0,-70.0,-66.0,-62.0,-83.0,-83.0,-80.0,-79.0,12.0,11.0,13.0,18.0,1
6544,BA:8C:B9:54:50:24,3842919,490249574,4855,6184967,3838064,484064607,0,9120,1708137,9098,1704642,22,3495,2351,16,5309,40,0,60,229410.0,130000.0,-40.0,-37.0,-46.0,-52.0,-41.0,-36.0,-44.0,-49.0,-83.0,-83.0,-80.0,-79.0,43.0,46.0,34.0,27.0,1
6545,62:47:05:9D:EB:15,3838251,484148821,184,83952,3838067,484064869,0,320,59688,308,57384,12,2304,149,0,216,2,0,9,229410.0,130000.0,-45.0,-47.0,-47.0,-54.0,-49.0,-48.0,-44.0,-51.0,-83.0,-83.0,-80.0,-79.0,38.0,36.0,33.0,25.0,1
6546,3C:55:76:E8:8F:1F,3906671,656332093,68603,172267164,3838068,484064929,24,30491,6558154,30116,6492484,375,65670,13485,35,68675,7014,24,387,154850.0,48750.0,-46.0,-54.0,-47.0,-40.0,-45.0,-59.0,-47.0,-39.0,-83.0,-83.0,-80.0,-79.0,37.0,29.0,33.0,39.0,1
6547,92:69:1D:31:68:E9,3842013,487693377,3945,3628448,3838068,484064929,0,4909,1115120,4761,1081575,148,33545,2135,11,4163,90,0,47,216660.0,130000.0,-52.0,-49.0,-44.0,-47.0,-52.0,-48.0,-43.0,-47.0,-83.0,-83.0,-80.0,-79.0,31.0,34.0,36.0,32.0,1
6548,CC:2F:71:3F:1F:24,4709282,1433125419,871214,949060490,3838068,484064929,37,711023,757142303,710284,757053433,739,88870,685373,15,871471,91534,34,544,130000.0,43333.0,-69.0,-65.0,-67.0,-68.0,-68.0,-65.0,-67.0,-68.0,-83.0,-83.0,-80.0,-79.0,14.0,18.0,13.0,11.0,1
6549,CC:2F:71:3E:C5:1F,3838967,484174713,899,109784,3838068,484064929,0,3748,314842,3092,236990,656,77852,952,10,1290,22,0,46,130000.0,39000.0,-71.0,-72.0,-67.0,-61.0,-69.0,-70.0,-66.0,-62.0,-83.0,-83.0,-80.0,-79.0,12.0,11.0,13.0,18.0,1
6550,BA:8C:B9:54:50:24,3842925,490250098,4855,6184967,3838070,484065131,0,9120,1708137,9098,1704642,22,3495,2351,16,5309,40,0,60,229410.0,130000.0,-40.0,-37.0,-46.0,-52.0,-41.0,-36.0,-44.0,-49.0,-83.0,-83.0,-80.0,-79.0,43.0,46.0,34.0,27.0,1
6551,62:47:05:9D:EB:15,3838258,484149487,184,83952,3838074,484065535,0,320,59688,308,57384,12,2304,149,0,216,2,0,9,229410.0,130000.0,-45.0,-47.0,-47.0,-54.0,-49.0,-48.0,-44.0,-51.0,-83.0,-83.0,-80.0,-79.0,38.0,36.0,33.0,25.0,1
6552,3C:55:76:E8:8F:1F,3906677,656332699,68603,172267164,3838074,484065535,24,30496,6558496,30121,6492826,375,65670,13485,35,68675,7014,24,387,154850.0,48750.0,-50.0,-57.0,-49.0,-44.0,-46.0,-55.0,-46.0,-40.0,-83.0,-83.0,-80.0,-79.0,33.0,26.0,31.0,35.0,1
6553,92:69:1D:31:68:E9,3842020,487694043,3945,3628448,3838075,484065595,0,4909,1115120,4761,1081575,148,33545,2135,11,4163,90,0,47,216660.0,130000.0,-52.0,-49.0,-44.0,-47.0,-52.0,-48.0,-43.0,-47.0,-83.0,-83.0,-80.0,-79.0,31.0,34.0,36.0,32.0,1
6554,CC:2F:71:3F:1F:24,4709509,1433392992,871434,949327397,3838075,484065595,37,711229,757407996,710490,757319126,739,88870,685565,15,871689,91547,34,544,130000.0,43333.0,-67.0,-66.0,-69.0,-68.0,-66.0,-64.0,-68.0,-68.0,-83.0,-83.0,-80.0,-79.0,16.0,17.0,11.0,11.0,1
6555,CC:2F:71:3E:C5:1F,3838974,484175379,899,109784,3838075,484065595,0,3748,314842,3092,236990,656,77852,952,10,1290,22,0,46,130000.0,39000.0,-71.0,-72.0,-67.0,-61.0,-69.0,-70.0,-66.0,-62.0,-83.0,-83.0,-80.0,-79.0,12.0,11.0,13.0,18.0,1
6556,BA:8C:B9:54:50:24,3842930,490250562,4855,6184967,3838075,484065595,0,9120,1708137,9098,1704642,22,3495,2351,16,5309,40,0,60,229410.0,130000.0,-40.0,-37.0,-46.0,-52.0,-41.0,-36.0,-44.0,-49.0,-83.0,-83.0,-80.0,-79.0,43.0,46.0,34.0,27.0,1
6557,62:47:05:9D:EB:15,3838262,484149809,184,83952,3838078,484065857,0,320,59688,308,57384,12,2304,149,0,216,2,0,9,229410.0,130000.0,-45.0,-47.0,-47.0,-54.0,-49.0,-48.0,-44.0,-51.0,-83.0,-83.0,-80.0,-79.0,38.0,36.0,33.0,25.0,1
6558,3C:55:76:E8:8F:1F,3906681,656333021,68603,172267164,3838078,484065857,24,30502,6558946,30126,6493170,376,65776,13486,35,68675,7014,24,387,154850.0,48750.0,-50.0,-58.0,-56.0,-45.0,-46.0,-53.0,-45.0,-40.0,-83.0,-83.0,-80.0,-79.0,33.0,25.0,24.0,34.0,1
6559,92:69:1D:31:68:E9,3842023,487694305,3945,3628448,3838078,484065857,0,4909,1115120,4761,1081575,148,33545,2135,11,4163,90,0,47,216660.0,130000.0,-52.0,-49.0,-44.0,-47.0,-52.0,-48.0,-43.0,-47.0,-83.0,-83.0,-80.0,-79.0,31.0,34.0,36.0,32.0,1
6560,CC:2F:71:3F:1F:24,4709725,1433653740,871643,949587479,3838082,484066261,37,711419,757655752,710680,757566882,739,88870,685749,15,871898,91558,34,544,130000.0,43333.0,-68.0,-67.0,-67.0,-69.0,-68.0,-67.0,-67.0,-69.0,-83.0,-83.0,-80.0,-79.0,15.0,16.0,13.0,10.0,1
6561,CC:2F:71:3E:C5:1F,3838981,484176045,899,109784,3838082,484066261,0,3748,314842,3092,236990,656,77852,952,10,1290,22,0,46,130000.0,39000.0,-71.0,-72.0,-67.0,-61.0,-69.0,-70.0,-66.0,-62.0,-83.0,-83.0,-80.0,-79.0,12.0,11.0,13.0,18.0,1
6562,BA:8C:B9:54:50:24,3842940,490251461,4855,6184967,3838085,484066494,0,9120,1708137,9098,1704642,22,3495,2351,16,5309,40,0,60,229410.0,130000.0,-40.0,-37.0,-46.0,-52.0,-41.0,-36.0,-44.0,-49.0,-83.0,-83.0,-80.0,-79.0,43.0,46.0,34.0,27.0,1
6563,62:47:05:9D:EB:15,3838326,484178011,239,111315,3838087,484066696,0,414,97217,400,94620,14,2597,209,0,276,2,0,9,229410.0,137640.0,-47.0,-44.0,-47.0,-41.0,-48.0,-46.0,-49.0,-43.0,-83.0,-83.0,-80.0,-79.0,36.0,39.0,33.0,38.0,1
6564,3C:55:76:E8:8F:1F,3906691,656333976,68604,172267280,3838087,484066696,24,30516,6559940,30139,6494058,377,65882,13487,35,68676,7014,24,387,154850.0,48750.0,-45.0,-51.0,-50.0,-42.0,-45.0,-51.0,-50.0,-43.0,-83.0,-83.0,-80.0,-79.0,38.0,32.0,30.0,37.0,1
6565,92:69:1D:31:68:E9,3842033,487695260,3946,3628564,3838087,484066696,0,4911,1115256,4763,1081711,148,33545,2135,11,4164,90,0,47,216660.0,130000.0,-53.0,-47.0,-42.0,-48.0,-52.0,-48.0,-43.0,-47.0,-83.0,-83.0,-80.0,-79.0,30.0,36.0,38.0,31.0,1
6566,CC:2F:71:3F:1F:24,4709944,1433920589,871857,949853893,3838087,484066696,37,711615,757919944,710876,757831074,739,88870,685935,15,872114,91585,34,545,130000.0,43333.0,-70.0,-65.0,-68.0,-69.0,-70.0,-64.0,-67.0,-69.0,-83.0,-83.0,-80.0,-79.0,13.0,18.0,12.0,10.0,1
6567,CC:2F:71:3E:C5:1F,3838987,484176596,900,109900,3838087,484066696,0,3750,314982,3094,237130,656,77852,952,10,1291,22,0,46,130000.0,39000.0,-71.0,-71.0,-69.0,-60.0,-70.0,-71.0,-67.0,-60.0,-83.0,-83.0,-80.0,-79.0,12.0,12.0,11.0,19.0,1
6568,BA:8C:B9:54:50:24,3842945,490251981,4856,6185083,3838089,484066898,0,9124,1708409,9102,1704914,22,3495,2351,16,5310,40,0,60,229410.0,137640.0,-40.0,-37.0,-46.0,-52.0,-41.0,-36.0,-44.0,-49.0,-83.0,-83.0,-80.0,-79.0,43.0,46.0,34.0,27.0,1
6569,62:47:05:9D:EB:15,3838496,484296521,401,229046,3838095,484067475,0,624,165563,608,162673,16,2890,352,0,438,18,0,9,229410.0,137640.0,-48.0,-52.0,-50.0,-44.0,-49.0,-52.0,-49.0,-45.0,-83.0,-83.0,-80.0,-79.0,35.0,31.0,30.0,35.0,1
6570,3C:55:76:E8:8F:1F,3906700,656334817,68604,172267280,3838096,484067537,24,30518,6560128,30140,6494128,378,66000,13488,35,68676,7014,24,387,154850.0,48750.0,-46.0,-54.0,-43.0,-41.0,-45.0,-51.0,-48.0,-42.0,-83.0,-83.0,-80.0,-79.0,37.0,29.0,37.0,38.0,1
6571,92:69:1D:31:68:E9,3842042,487696101,3946,3628564,3838096,484067537,0,4911,1115256,4763,1081711,148,33545,2135,11,4164,90,0,47,216660.0,130000.0,-53.0,-47.0,-42.0,-48.0,-52.0,-48.0,-43.0,-47.0,-83.0,-83.0,-80.0,-79.0,30.0,36.0,38.0,31.0,1
6572,CC:2F:71:3F:1F:24,4710171,1434185475,872074,950117878,3838097,484067597,37,711812,758167586,711073,758078716,739,88870,686129,15,872331,91594,34,545,130000.0,43333.0,-69.0,-66.0,-69.0,-68.0,-68.0,-66.0,-68.0,-68.0,-83.0,-83.0,-80.0,-79.0,14.0,17.0,11.0,11.0,1
6573,CC:2F:71:3E:C5:1F,3838997,484177497,900,109900,3838097,484067597,0,3750,314982,3094,237130,656,77852,952,10,1291,22,0,46,130000.0,39000.0,-71.0,-71.0,-69.0,-60.0,-70.0,-71.0,-67.0,-60.0,-83.0,-83.0,-80.0,-79.0,12.0,12.0,11.0,19.0,1
6574,BA:8C:B9:54:50:24,3842953,490252680,4856,6185083,3838097,484067597,0,9124,1708409,9102,1704914,22,3495,2351,16,5310,40,0,60,229410.0,137640.0,-40.0,-37.0,-46.0,-52.0,-41.0,-36.0,-44.0,-49.0,-83.0,-83.0,-80.0,-79.0,43.0,46.0,34.0,27.0,1
6575,62:47:05:9D:EB:15,3838555,484320386,453,252141,3838102,484068245,0,724,234800,707,231739,17,3061,414,0,490,35,0,11,229410.0,137640.0,-54.0,-54.0,-49.0,-48.0,-54.0,-54.0,-48.0,-48.0,-83.0,-83.0,-80.0,-79.0,29.0,29.0,31.0,31.0,1
6576,3C:55:76:E8:8F:1F,3906706,656335525,68604,172267280,3838102,484068245,24,30533,6561204,30154,6495086,379,66118,13489,35,68676,7014,24,387,154850.0,48750.0,-43.0,-49.0,-44.0,-40.0,-42.0,-48.0,-43.0,-38.0,-83.0,-83.0,-80.0,-79.0,40.0,34.0,36.0,39.0,1
6577,92:69:1D:31:68:E9,3842050,487697011,3946,3628564,3838104,484068447,0,4911,1115256,4763,1081711,148,33545,2135,11,4164,90,0,47,216660.0,130000.0,-53.0,-47.0,-42.0,-48.0,-52.0,-48.0,-43.0,-47.0,-83.0,-83.0,-80.0,-79.0,30.0,36.0,38.0,31.0,1
6578,CC:2F:71:3F:1F:24,4710386,1434446053,872282,950377606,3838104,484068447,37,712001,758418026,711262,758329156,739,88870,686312,15,872539,91631,34,545,130000.0,43333.0,-68.0,-66.0,-69.0,-69.0,-67.0,-66.0,-68.0,-69.0,-83.0,-83.0,-80.0,-79.0,15.0,17.0,11.0,10.0,1
6579,CC:2F:71:3E:C5:1F,3839004,484178347,900,109900,3838104,484068447,0,3750,314982,3094,237130,656,77852,952,10,1291,22,0,46,130000.0,39000.0,-71.0,-71.0,-69.0,-60.0,-70.0,-71.0,-67.0,-60.0,-83.0,-83.0,-80.0,-79.0,12.0,12.0,11.0,19.0,1
6580,BA:8C:B9:54:50:24,3842960,490253530,4856,6185083,3838104,484068447,0,9124,1708409,9102,1704914,22,3495,2351,16,5310,40,0,60,229410.0,137640.0,-40.0,-37.0,-46.0,-52.0,-41.0,-36.0,-44.0,-49.0,-83.0,-83.0,-80.0,-79.0,43.0,46.0,34.0,27.0,1
6581,62:47:05:9D:EB:15,3838574,484331621,466,262770,3838108,484068851,0,786,250233,769,247172,17,3061,430,0,503,35,0,12,229410.0,137640.0,-59.0,-54.0,-49.0,-54.0,-57.0,-53.0,-49.0,-52.0,-83.0,-83.0,-80.0,-79.0,24.0,29.0,31.0,25.0,1
6582,3C:55:76:E8:8F:1F,3906713,656336261,68605,172267410,3838108,484068851,24,30547,6562195,30168,6496077,379,66118,13490,35,68677,7014,24,387,154850.0,48750.0,-44.0,-51.0,-46.0,-40.0,-43.0,-52.0,-45.0,-40.0,-83.0,-83.0,-80.0,-79.0,39.0,32.0,34.0,39.0,1
6583,92:69:1D:31:68:E9,3842054,487697415,3946,3628564,3838108,484068851,0,4911,1115256,4763,1081711,148,33545,2135,11,4164,90,0,47,216660.0,130000.0,-53.0,-47.0,-42.0,-48.0,-52.0,-48.0,-43.0,-47.0,-83.0,-83.0,-80.0,-79.0,30.0,36.0,38.0,31.0,1
6584,CC:2F:71:3F:1F:24,4710603,1434711513,872493,950642460,3838110,484069053,37,712194,758671844,711455,758582974,739,88870,686498,15,872749,91647,34,545,130000.0,43333.0,-67.0,-66.0,-68.0,-70.0,-67.0,-66.0,-67.0,-70.0,-83.0,-83.0,-80.0,-79.0,16.0,17.0,12.0,9.0,1
6585,CC:2F:71:3E:C5:1F,3839010,484178953,900,109900,3838110,484069053,0,3750,314982,3094,237130,656,77852,952,10,1291,22,0,46,130000.0,39000.0,-71.0,-71.0,-69.0,-60.0,-70.0,-71.0,-67.0,-60.0,-83.0,-83.0,-80.0,-79.0,12.0,12.0,11.0,19.0,1
6586,BA:8C:B9:54:50:24,3842966,490254136,4856,6185083,3838110,484069053,0,9124,1708409,9102,1704914,22,3495,2351,16,5310,40,0,60,229410.0,137640.0,-40.0,-37.0,-46.0,-52.0,-41.0,-36.0,-44.0,-49.0,-83.0,-83.0,-80.0,-79.0,43.0,46.0,34.0,27.0,1
6587,62:47:05:9D:EB:15,3838594,484340708,481,271393,3838113,484069315,0,840,257327,823,254266,17,3061,447,0,518,35,0,12,216660.0,130000.0,-53.0,-49.0,-55.0,-55.0,-51.0,-49.0,-53.0,-56.0,-83.0,-83.0,-80.0,-79.0,30.0,34.0,25.0,24.0,1
6588,3C:55:76:E8:8F:1F,3906718,656336725,68605,172267410,3838113,484069315,24,30554,6562673,30175,6496555,379,66118,13490,35,68677,7014,24,387,154850.0,48750.0,-44.0,-53.0,-46.0,-41.0,-44.0,-51.0,-46.0,-40.0,-83.0,-83.0,-80.0,-79.0,39.0,30.0,34.0,38.0,1
6589,92:69:1D:31:68:E9,3842059,487697879,3946,3628564,3838113,484069315,0,4911,1115256,4763,1081711,148,33545,2135,11,4164,90,0,47,216660.0,130000.0,-53.0,-47.0,-42.0,-48.0,-52.0,-48.0,-43.0,-47.0,-83.0,-83.0,-80.0,-79.0,30.0,36.0,38.0,31.0,1
6590,CC:2F:71:3F:1F:24,4710816,1434973371,872703,950904056,3838113,484069315,37,712389,758927390,711650,758838520,739,88870,686684,15,872960,91689,34,545,115556.0,28889.0,-67.0,-66.0,-68.0,-71.0,-67.0,-66.0,-67.0,-70.0,-83.0,-83.0,-80.0,-79.0,16.0,17.0,12.0,8.0,1
6591,CC:2F:71:3E:C5:1F,3839013,484179215,900,109900,3838113,484069315,0,3750,314982,3094,237130,656,77852,952,10,1291,22,0,46,130000.0,39000.0,-71.0,-71.0,-69.0,-60.0,-70.0,-71.0,-67.0,-60.0,-83.0,-83.0,-80.0,-79.0,12.0,12.0,11.0,19.0,1
6592,BA:8C:B9:54:50:24,3842970,490254460,4856,6185083,3838114,484069377,0,9124,1708409,9102,1704914,22,3495,2351,16,5310,40,0,60,229410.0,137640.0,-40.0,-37.0,-46.0,-52.0,-41.0,-36.0,-44.0,-49.0,-83.0,-83.0,-80.0,-79.0,43.0,46.0,34.0,27.0,1
6593,62:47:05:9D:EB:15,3838648,484355961,527,285916,3838121,484070045,0,920,279910,902,276727,18,3183,497,0,564,35,0,12,229410.0,137640.0,-49.0,-51.0,-53.0,-51.0,-46.0,-48.0,-50.0,-49.0,-83.0,-83.0,-79.0,-79.0,34.0,32.0,26.0,28.0,1
6594,3C:55:76:E8:8F:1F,3906726,656337455,68605,172267410,3838121,484070045,24,30554,6562673,30175,6496555,379,66118,13490,35,68677,7014,24,387,154850.0,48750.0,-44.0,-53.0,-46.0,-41.0,-44.0,-51.0,-46.0,-40.0,-83.0,-83.0,-79.0,-79.0,39.0,30.0,33.0,38.0,1
6595,92:69:1D:31:68:E9,3842067,487698609,3946,3628564,3838121,484070045,0,4911,1115256,4763,1081711,148,33545,2135,11,4164,90,0,47,216660.0,130000.0,-53.0,-47.0,-42.0,-48.0,-52.0,-48.0,-43.0,-47.0,-83.0,-83.0,-79.0,-79.0,30.0,36.0,37.0,31.0,1
6596,CC:2F:71:3F:1F:24,4711042,1435237764,872921,951167719,3838121,484070045,37,712586,759177671,711846,759088683,740,88988,686877,15,873178,91704,34,545,130000.0,43333.0,-67.0,-66.0,-67.0,-71.0,-67.0,-66.0,-67.0,-71.0,-83.0,-83.0,-79.0,-79.0,16.0,17.0,12.0,8.0,1
6597,CC:2F:71:3E:C5:1F,3839021,484179945,900,109900,3838121,484070045,0,3750,314982,3094,237130,656,77852,952,10,1291,22,0,46,130000.0,39000.0,-71.0,-71.0,-69.0,-60.0,-70.0,-71.0,-67.0,-60.0,-83.0,-83.0,-79.0,-79.0,12.0,12.0,10.0,19.0,1
6598,BA:8C:B9:54:50:24,3842977,490255128,4856,6185083,3838121,484070045,0,9124,1708409,9102,1704914,22,3495,2351,16,5310,40,0,60,229410.0,137640.0,-40.0,-37.0,-46.0,-52.0,-41.0,-36.0,-44.0,-49.0,-83.0,-83.0,-79.0,-79.0,43.0,46.0,33.0,27.0,1
6599,62:47:05:9D:EB:15,3838788,484567268,664,496961,3838124,484070307,0,1047,313299,1029,310116,18,3183,584,0,701,36,0,13,229410.0,137640.0,-52.0,-50.0,-53.0,-53.0,-51.0,-49.0,-52.0,-53.0,-83.0,-83.0,-79.0,-79.0,31.0,33.0,26.0,26.0,1
6600,3C:55:76:E8:8F:1F,3906729,656337717,68605,172267410,3838124,484070307,24,30554,6562673,30175,6496555,379,66118,13490,35,68677,7014,24,387,154850.0,48750.0,-44.0,-53.0,-46.0,-41.0,-44.0,-51.0,-46.0,-40.0,-83.0,-83.0,-79.0,-79.0,39.0,30.0,33.0,38.0,1
6601,92:69:1D:31:68:E9,3842070,487698871,3946,3628564,3838124,484070307,0,4911,1115256,4763,1081711,148,33545,2135,11,4164,90,0,47,216660.0,130000.0,-53.0,-47.0,-42.0,-48.0,-52.0,-48.0,-43.0,-47.0,-83.0,-83.0,-79.0,-79.0,30.0,36.0,37.0,31.0,1
6602,CC:2F:71:3F:1F:24,4711268,1435520174,873142,951449665,3838126,484070509,37,712804,759461485,712064,759372497,740,88988,687080,15,873399,91718,34,545,130000.0,43333.0,-68.0,-67.0,-68.0,-71.0,-67.0,-67.0,-67.0,-71.0,-83.0,-83.0,-79.0,-79.0,15.0,16.0,11.0,8.0,1
6603,CC:2F:71:3E:C5:1F,3839026,484180409,900,109900,3838126,484070509,0,3750,314982,3094,237130,656,77852,952,10,1291,22,0,46,130000.0,39000.0,-71.0,-71.0,-69.0,-60.0,-70.0,-71.0,-67.0,-60.0,-83.0,-83.0,-79.0,-79.0,12.0,12.0,10.0,19.0,1
6604,BA:8C:B9:54:50:24,3842982,490255592,4856,6185083,3838126,484070509,0,9124,1708409,9102,1704914,22,3495,2351,16,5310,40,0,60,229410.0,137640.0,-40.0,-37.0,-46.0,-52.0,-41.0,-36.0,-44.0,-49.0,-83.0,-83.0,-79.0,-79.0,43.0,46.0,33.0,27.0,1
6605,62:47:05:9D:EB:15,3838817,484582981,687,512068,3838130,484070913,0,1117,322625,1099,319442,18,3183,608,0,724,36,0,14,229410.0,137640.0,-49.0,-51.0,-52.0,-52.0,-48.0,-50.0,-51.0,-51.0,-83.0,-83.0,-79.0,-79.0,34.0,32.0,27.0,27.0,1
6606,3C:55:76:E8:8F:1F,3906737,656338649,68607,172267736,3838130,484070913,24,30582,6564846,30203,6498728,379,66118,13493,35,68679,7014,24,387,154850.0,1000.0,-47.0,-56.0,-47.0,-44.0,-47.0,-55.0,-47.0,-44.0,-83.0,-83.0,-79.0,-79.0,36.0,27.0,32.0,35.0,1
6607,92:69:1D:31:68:E9,3842076,487699477,3946,3628564,3838130,484070913,0,4911,1115256,4763,1081711,148,33545,2135,11,4164,90,0,47,216660.0,130000.0,-53.0,-47.0,-42.0,-48.0,-52.0,-48.0,-43.0,-47.0,-83.0,-83.0,-79.0,-79.0,30.0,36.0,37.0,31.0,1
6608,CC:2F:71:3F:1F:24,4711484,1435786354,873354,951715441,3838130,484070913,37,712997,759715347,712257,759626359,740,88988,687268,15,873611,91793,34,545,130000.0,39000.0,-67.0,-67.0,-67.0,-71.0,-67.0,-66.0,-67.0,-70.0,-83.0,-83.0,-79.0,-79.0,16.0,16.0,12.0,8.0,1
6609,CC:2F:71:3E:C5:1F,3839030,484180813,900,109900,3838130,484070913,0,3750,314982,3094,237130,656,77852,952,10,1291,22,0,46,130000.0,39000.0,-71.0,-71.0,-69.0,-60.0,-70.0,-71.0,-67.0,-60.0,-83.0,-83.0,-79.0,-79.0,12.0,12.0,10.0,19.0,1
6610,BA:8C:B9:54:50:24,3842988,490256198,4856,6185083,3838132,484071115,0,9124,1708409,9102,1704914,22,3495,2351,16,5310,40,0,60,229410.0,137640.0,-40.0,-37.0,-46.0,-52.0,-41.0,-36.0,-44.0,-49.0,-83.0,-83.0,-79.0,-79.0,43.0,46.0,33.0,27.0,1
6611,62:47:05:9D:EB:15,3838861,484619176,728,547999,3838133,484071177,0,1220,355089,1202,351906,18,3183,654,0,765,36,0,14,229410.0,137640.0,-51.0,-49.0,-51.0,-53.0,-49.0,-47.0,-49.0,-51.0,-83.0,-83.0,-79.0,-79.0,32.0,34.0,28.0,26.0,1
6612,3C:55:76:E8:8F:1F,3906743,656339175,68607,172267736,3838136,484071439,24,30589,6565376,30209,6499140,380,66236,13494,35,68679,7014,24,388,154850.0,1000.0,-47.0,-55.0,-47.0,-44.0,-46.0,-54.0,-45.0,-42.0,-83.0,-83.0,-79.0,-79.0,36.0,28.0,32.0,35.0,1
6613,92:69:1D:31:68:E9,3842084,487700205,3946,3628564,3838138,484071641,0,4912,1115324,4764,1081779,148,33545,2135,11,4164,90,0,47,216660.0,130000.0,-52.0,-48.0,-42.0,-49.0,-52.0,-47.0,-43.0,-47.0,-83.0,-83.0,-79.0,-79.0,31.0,35.0,37.0,30.0,1
6614,CC:2F:71:3F:1F:24,4711708,1436055091,873570,951983450,3838138,484071641,37,713207,759976125,712467,759887137,740,88988,687465,15,873826,91833,34,545,130000.0,43333.0,-67.0,-66.0,-67.0,-71.0,-67.0,-66.0,-67.0,-71.0,-83.0,-83.0,-79.0,-79.0,16.0,17.0,12.0,8.0,1
6615,CC:2F:71:3E:C5:1F,3839038,484181541,900,109900,3838138,484071641,0,3751,315052,3095,237200,656,77852,952,11,1292,23,0,46,130000.0,39000.0,-71.0,-71.0,-69.0,-60.0,-70.0,-71.0,-67.0,-60.0,-83.0,-83.0,-79.0,-79.0,12.0,12.0,10.0,19.0,1
6616,BA:8C:B9:54:50:24,3842994,490256724,4856,6185083,3838138,484071641,0,9126,1708545,9104,1705050,22,3495,2351,16,5311,40,0,60,229410.0,137640.0,-40.0,-37.0,-45.0,-52.0,-40.0,-36.0,-44.0,-50.0,-83.0,-83.0,-79.0,-79.0,43.0,46.0,34.0,27.0,1
6617,62:47:05:9D:EB:15,3838901,484643759,760,571854,3838141,484071905,0,1281,363109,1263,359926,18,3183,684,0,797,36,0,14,229410.0,137640.0,-44.0,-51.0,-51.0,-45.0,-45.0,-49.0,-48.0,-46.0,-83.0,-83.0,-79.0,-79.0,39.0,32.0,28.0,34.0,1
6618,3C:55:76:E8:8F:1F,3906748,656339641,68607,172267736,3838141,484071905,24,30589,6565376,30209,6499140,380,66236,13494,35,68679,7014,24,388,154850.0,1000.0,-47.0,-55.0,-47.0,-44.0,-46.0,-54.0,-45.0,-42.0,-83.0,-83.0,-79.0,-79.0,36.0,28.0,32.0,35.0,1
6619,92:69:1D:31:68:E9,3842089,487700671,3946,3628564,3838143,484072107,0,4912,1115324,4764,1081779,148,33545,2135,11,4164,90,0,47,216660.0,130000.0,-52.0,-48.0,-42.0,-49.0,-52.0,-47.0,-43.0,-47.0,-83.0,-83.0,-79.0,-79.0,31.0,35.0,37.0,30.0,1
6620,CC:2F:71:3F:1F:24,4711923,1436317417,873780,952245310,3838143,484072107,37,713393,760223185,712653,760134197,740,88988,687649,15,874035,91863,34,545,130000.0,43333.0,-67.0,-67.0,-67.0,-71.0,-67.0,-66.0,-67.0,-71.0,-83.0,-83.0,-79.0,-79.0,16.0,16.0,12.0,8.0,1
6621,CC:2F:71:3E:C5:1F,3839043,484182007,900,109900,3838143,484072107,0,3754,315310,3097,237340,657,77970,953,11,1292,23,0,47,130000.0,39000.0,-70.0,-71.0,-68.0,-60.0,-70.0,-71.0,-68.0,-60.0,-83.0,-83.0,-79.0,-79.0,13.0,12.0,11.0,19.0,1
6622,BA:8C:B9:54:50:24,3842999,490257190,4856,6185083,3838143,484072107,0,9126,1708545,9104,1705050,22,3495,2351,16,5311,40,0,60,229410.0,137640.0,-40.0,-37.0,-45.0,-52.0,-40.0,-36.0,-44.0,-50.0,-83.0,-83.0,-79.0,-79.0,43.0,46.0,34.0,27.0,1
6623,62:47:05:9D:EB:15,3838916,484657992,769,585481,3838147,484072511,0,1317,369157,1299,365974,18,3183,690,0,806,36,0,14,229410.0,137640.0,-48.0,-55.0,-52.0,-50.0,-46.0,-54.0,-52.0,-48.0,-83.0,-83.0,-79.0,-79.0,35.0,28.0,27.0,29.0,1
6624,3C:55:76:E8:8F:1F,3906754,656340247,68607,172267736,3838147,484072511,24,30589,6565376,30209,6499140,380,66236,13494,35,68679,7014,24,388,154850.0,1000.0,-47.0,-55.0,-47.0,-44.0,-46.0,-54.0,-45.0,-42.0,-83.0,-83.0,-79.0,-79.0,36.0,28.0,32.0,35.0,1
6625,92:69:1D:31:68:E9,3842095,487701277,3946,3628564,3838149,484072713,0,4912,1115324,4764,1081779,148,33545,2135,11,4164,90,0,47,216660.0,130000.0,-52.0,-48.0,-42.0,-49.0,-52.0,-47.0,-43.0,-47.0,-83.0,-83.0,-79.0,-79.0,31.0,35.0,37.0,30.0,1
6626,CC:2F:71:3F:1F:24,4712135,1436576083,873986,952503370,3838149,484072713,37,713581,760473381,712841,760384393,740,88988,687831,15,874243,91896,34,545,130000.0,43333.0,-67.0,-67.0,-67.0,-71.0,-67.0,-66.0,-67.0,-70.0,-83.0,-83.0,-79.0,-79.0,16.0,16.0,12.0,8.0,1
6627,CC:2F:71:3E:C5:1F,3839049,484182613,900,109900,3838149,484072713,0,3754,315310,3097,237340,657,77970,953,11,1292,23,0,47,130000.0,39000.0,-70.0,-71.0,-68.0,-60.0,-70.0,-71.0,-68.0,-60.0,-83.0,-83.0,-79.0,-79.0,13.0,12.0,11.0,19.0,1
6628,BA:8C:B9:54:50:24,3843005,490257796,4856,6185083,3838149,484072713,0,9126,1708545,9104,1705050,22,3495,2351,16,5311,40,0,60,229410.0,137640.0,-40.0,-37.0,-45.0,-52.0,-40.0,-36.0,-44.0,-50.0,-83.0,-83.0,-79.0,-79.0,43.0,46.0,34.0,27.0,1
6629,62:47:05:9D:EB:15,3838942,484690898,790,617923,3838152,484072975,0,1363,377073,1345,373890,18,3183,704,0,827,36,0,14,229410.0,137640.0,-48.0,-54.0,-52.0,-50.0,-47.0,-54.0,-51.0,-48.0,-83.0,-83.0,-79.0,-79.0,35.0,29.0,27.0,29.0,1
6630,3C:55:76:E8:8F:1F,3906772,656348106,68620,172275131,3838152,484072975,24,30620,6575835,30240,6509599,380,66236,13507,35,68692,7014,24,388,146250.0,48750.0,-47.0,-55.0,-47.0,-44.0,-46.0,-54.0,-46.0,-43.0,-83.0,-83.0,-79.0,-79.0,36.0,28.0,32.0,35.0,1
6631,92:69:1D:31:68:E9,3842098,487701539,3946,3628564,3838152,484072975,0,4912,1115324,4764,1081779,148,33545,2135,11,4164,90,0,47,216660.0,130000.0,-52.0,-48.0,-42.0,-49.0,-52.0,-47.0,-43.0,-47.0,-83.0,-83.0,-79.0,-79.0,31.0,35.0,37.0,30.0,1
6632,CC:2F:71:3F:1F:24,4712345,1436837831,874193,952764856,3838152,484072975,37,713776,760734413,713036,760645425,740,88988,688016,15,874450,91936,34,545,130000.0,43333.0,-68.0,-67.0,-68.0,-71.0,-67.0,-66.0,-67.0,-70.0,-83.0,-83.0,-79.0,-79.0,15.0,16.0,11.0,8.0,1
6633,CC:2F:71:3E:C5:1F,3839064,484188474,900,109900,3838164,484078574,0,3754,315310,3097,237340,657,77970,953,11,1292,23,0,47,130000.0,39000.0,-70.0,-71.0,-68.0,-60.0,-70.0,-71.0,-68.0,-60.0,-83.0,-83.0,-79.0,-79.0,13.0,12.0,11.0,19.0,1
6634,BA:8C:B9:54:50:24,3843020,490263657,4856,6185083,3838164,484078574,0,9126,1708545,9104,1705050,22,3495,2351,16,5311,40,0,60,229410.0,137640.0,-40.0,-37.0,-45.0,-52.0,-40.0,-36.0,-44.0,-50.0,-83.0,-83.0,-79.0,-79.0,43.0,46.0,34.0,27.0,1
6635,62:47:05:9D:EB:15,3838979,484705260,798,620656,3838181,484084604,0,1410,382615,1392,379432,18,3183,711,0,835,36,0,15,229410.0,137640.0,-43.0,-43.0,-40.0,-37.0,-42.0,-44.0,-40.0,-37.0,-83.0,-83.0,-79.0,-79.0,40.0,40.0,39.0,42.0,1
6636,3C:55:76:E8:8F:1F,3906801,656359735,68620,172275131,3838181,484084604,24,30620,6575835,30240,6509599,380,66236,13507,35,68692,7014,24,388,146250.0,48750.0,-47.0,-55.0,-47.0,-44.0,-46.0,-54.0,-46.0,-43.0,-83.0,-83.0,-79.0,-79.0,36.0,28.0,32.0,35.0,1
6637,92:69:1D:31:68:E9,3842127,487713168,3946,3628564,3838181,484084604,0,4915,1115695,4766,1081915,149,33780,2136,11,4164,90,0,47,216660.0,130000.0,-52.0,-48.0,-42.0,-49.0,-52.0,-48.0,-43.0,-48.0,-83.0,-83.0,-79.0,-79.0,31.0,35.0,37.0,30.0,1
6638,CC:2F:71:3F:1F:24,4712599,1437128311,874418,953043707,3838181,484084604,37,713986,761006375,713246,760917387,740,88988,688214,15,874674,91953,34,545,117000.0,39000.0,-67.0,-66.0,-68.0,-71.0,-67.0,-66.0,-67.0,-70.0,-83.0,-83.0,-79.0,-79.0,16.0,17.0,11.0,8.0,1
6639,CC:2F:71:3E:C5:1F,3839081,484194504,900,109900,3838181,484084604,0,3754,315310,3097,237340,657,77970,953,11,1292,23,0,47,130000.0,39000.0,-70.0,-71.0,-68.0,-60.0,-70.0,-71.0,-68.0,-60.0,-83.0,-83.0,-79.0,-79.0,13.0,12.0,11.0,19.0,1
6640,BA:8C:B9:54:50:24,3843037,490269687,4856,6185083,3838181,484084604,0,9126,1708545,9104,1705050,22,3495,2351,16,5311,40,0,60,229410.0,137640.0,-40.0,-37.0,-45.0,-52.0,-40.0,-36.0,-44.0,-50.0,-83.0,-83.0,-79.0,-79.0,43.0,46.0,34.0,27.0,1
6641,62:47:05:9D:EB:15,3838982,484705522,798,620656,3838184,484084866,0,1428,383839,1410,380656,18,3183,711,0,835,36,0,15,229410.0,137640.0,-44.0,-44.0,-50.0,-38.0,-43.0,-43.0,-43.0,-37.0,-83.0,-83.0,-79.0,-79.0,39.0,39.0,29.0,41.0,1
6642,3C:55:76:E8:8F:1F,3906804,656359997,68620,172275131,3838184,484084866,24,30620,6575835,30240,6509599,380,66236,13507,35,68692,7014,24,388,146250.0,48750.0,-47.0,-55.0,-47.0,-44.0,-46.0,-54.0,-46.0,-43.0,-83.0,-83.0,-79.0,-79.0,36.0,28.0,32.0,35.0,1
6643,92:69:1D:31:68:E9,3842131,487713703,3946,3628564,3838185,484085139,0,4915,1115695,4766,1081915,149,33780,2136,11,4164,90,0,47,216660.0,130000.0,-52.0,-48.0,-42.0,-49.0,-52.0,-48.0,-43.0,-48.0,-83.0,-83.0,-79.0,-79.0,31.0,35.0,37.0,30.0,1
6644,CC:2F:71:3F:1F:24,4712815,1437395014,874630,953309875,3838185,484085139,37,714180,761264483,713440,761175495,740,88988,688402,15,874887,91963,34,545,130000.0,43333.0,-68.0,-67.0,-68.0,-70.0,-67.0,-66.0,-67.0,-70.0,-83.0,-83.0,-79.0,-79.0,15.0,16.0,11.0,9.0,1
6645,CC:2F:71:3E:C5:1F,3839085,484195039,900,109900,3838185,484085139,0,3754,315310,3097,237340,657,77970,953,11,1292,23,0,47,130000.0,39000.0,-70.0,-71.0,-68.0,-60.0,-70.0,-71.0,-68.0,-60.0,-83.0,-83.0,-79.0,-79.0,13.0,12.0,11.0,19.0,1
6646,BA:8C:B9:54:50:24,3843043,490270424,4856,6185083,3838187,484085341,0,9126,1708545,9104,1705050,22,3495,2351,16,5311,40,0,60,229410.0,137640.0,-40.0,-37.0,-45.0,-52.0,-40.0,-36.0,-44.0,-50.0,-83.0,-83.0,-79.0,-79.0,43.0,46.0,34.0,27.0,1
6647,62:47:05:9D:EB:15,3839028,484748119,837,662374,3838191,484085745,0,1519,413589,1501,410406,18,3183,751,0,874,36,0,15,229410.0,130000.0,-49.0,-46.0,-51.0,-50.0,-48.0,-46.0,-51.0,-49.0,-83.0,-83.0,-79.0,-79.0,34.0,37.0,28.0,29.0,1
6648,3C:55:76:E8:8F:1F,3906811,656360876,68620,172275131,3838191,484085745,24,30621,6575903,30241,6509667,380,66236,13507,35,68692,7014,24,388,146250.0,48750.0,-46.0,-57.0,-45.0,-41.0,-46.0,-55.0,-46.0,-43.0,-83.0,-83.0,-79.0,-79.0,37.0,26.0,34.0,38.0,1
6649,92:69:1D:31:68:E9,3842137,487714309,3946,3628564,3838191,484085745,0,4915,1115695,4766,1081915,149,33780,2136,11,4164,90,0,47,216660.0,130000.0,-52.0,-48.0,-42.0,-49.0,-52.0,-48.0,-43.0,-48.0,-83.0,-83.0,-79.0,-79.0,31.0,35.0,37.0,30.0,1
6650,CC:2F:71:3F:1F:24,4713029,1437658436,874838,953572691,3838191,484085745,37,714369,761514753,713629,761425765,740,88988,688588,15,875093,91970,34,545,130000.0,43333.0,-67.0,-67.0,-69.0,-70.0,-67.0,-66.0,-68.0,-70.0,-83.0,-83.0,-79.0,-79.0,16.0,16.0,10.0,9.0,1
6651,CC:2F:71:3E:C5:1F,3839091,484195645,900,109900,3838191,484085745,0,3754,315310,3097,237340,657,77970,953,11,1292,23,0,47,130000.0,39000.0,-70.0,-71.0,-68.0,-60.0,-70.0,-71.0,-68.0,-60.0,-83.0,-83.0,-79.0,-79.0,13.0,12.0,11.0,19.0,1
6652,BA:8C:B9:54:50:24,3843047,490270828,4856,6185083,3838191,484085745,0,9126,1708545,9104,1705050,22,3495,2351,16,5311,40,0,60,229410.0,137640.0,-40.0,-37.0,-45.0,-52.0,-40.0,-36.0,-44.0,-50.0,-83.0,-83.0,-79.0,-79.0,43.0,46.0,34.0,27.0,1
6653,62:47:05:9D:EB:15,3839033,484748680,839,662673,3838194,484086007,0,1548,415652,1530,412469,18,3183,752,0,876,36,0,15,229410.0,130000.0,-48.0,-42.0,-47.0,-45.0,-47.0,-42.0,-48.0,-45.0,-83.0,-83.0,-79.0,-79.0,35.0,41.0,32.0,34.0,1
6654,3C:55:76:E8:8F:1F,3906814,656361138,68620,172275131,3838194,484086007,24,30621,6575903,30241,6509667,380,66236,13507,35,68692,7014,24,388,146250.0,48750.0,-46.0,-57.0,-45.0,-41.0,-46.0,-55.0,-46.0,-43.0,-83.0,-83.0,-79.0,-79.0,37.0,26.0,34.0,38.0,1
6655,92:69:1D:31:68:E9,3842142,487714773,3946,3628564,3838196,484086209,0,4915,1115695,4766,1081915,149,33780,2136,11,4164,90,0,47,216660.0,130000.0,-52.0,-48.0,-42.0,-49.0,-52.0,-48.0,-43.0,-48.0,-83.0,-83.0,-79.0,-79.0,31.0,35.0,37.0,30.0,1
6656,CC:2F:71:3F:1F:24,4713251,1437922569,875055,953836360,3838196,484086209,37,714567,761770876,713827,761681888,740,88988,688779,15,875312,91974,34,545,130000.0,43333.0,-67.0,-67.0,-68.0,-71.0,-67.0,-66.0,-67.0,-70.0,-83.0,-83.0,-79.0,-79.0,16.0,16.0,11.0,8.0,1
6657,CC:2F:71:3E:C5:1F,3839098,484196311,900,109900,3838198,484086411,0,3754,315310,3097,237340,657,77970,953,11,1292,23,0,47,130000.0,39000.0,-70.0,-71.0,-68.0,-60.0,-70.0,-71.0,-68.0,-60.0,-83.0,-83.0,-79.0,-79.0,13.0,12.0,11.0,19.0,1
6658,BA:8C:B9:54:50:24,3843056,490271696,4856,6185083,3838200,484086613,0,9126,1708545,9104,1705050,22,3495,2351,16,5311,40,0,60,229410.0,137640.0,-40.0,-37.0,-45.0,-52.0,-40.0,-36.0,-44.0,-50.0,-83.0,-83.0,-79.0,-79.0,43.0,46.0,34.0,27.0,1
6659,62:47:05:9D:EB:15,3839041,484749654,839,662673,3838202,484086981,0,1548,415652,1530,412469,18,3183,752,0,876,36,0,15,229410.0,130000.0,-48.0,-42.0,-47.0,-45.0,-47.0,-42.0,-48.0,-45.0,-83.0,-83.0,-79.0,-79.0,35.0,41.0,32.0,34.0,1
6660,3C:55:76:E8:8F:1F,3906822,656362112,68620,172275131,3838202,484086981,24,30621,6575903,30241,6509667,380,66236,13507,35,68692,7014,24,388,146250.0,48750.0,-46.0,-57.0,-45.0,-41.0,-46.0,-55.0,-46.0,-43.0,-83.0,-83.0,-79.0,-79.0,37.0,26.0,34.0,38.0,1
6661,92:69:1D:31:68:E9,3842148,487715545,3946,3628564,3838202,484086981,0,4915,1115695,4766,1081915,149,33780,2136,11,4164,90,0,47,216660.0,130000.0,-52.0,-48.0,-42.0,-49.0,-52.0,-48.0,-43.0,-48.0,-83.0,-83.0,-79.0,-79.0,31.0,35.0,37.0,30.0,1
6662,CC:2F:71:3F:1F:24,4713463,1438183257,875261,954096276,3838202,484086981,37,714759,762028726,714019,761939738,740,88988,688960,15,875518,91974,34,545,130000.0,43333.0,-67.0,-66.0,-68.0,-70.0,-67.0,-66.0,-68.0,-70.0,-83.0,-83.0,-79.0,-79.0,16.0,17.0,11.0,9.0,1
6663,CC:2F:71:3E:C5:1F,3839104,484197083,900,109900,3838204,484087183,0,3754,315310,3097,237340,657,77970,953,11,1292,23,0,47,130000.0,39000.0,-70.0,-71.0,-68.0,-60.0,-70.0,-71.0,-68.0,-60.0,-83.0,-83.0,-79.0,-80.0,13.0,12.0,11.0,20.0,1
6664,BA:8C:B9:54:50:24,3843060,490272266,4856,6185083,3838204,484087183,0,9126,1708545,9104,1705050,22,3495,2351,16,5311,40,0,60,229410.0,137640.0,-40.0,-37.0,-45.0,-52.0,-40.0,-36.0,-44.0,-50.0,-83.0,-83.0,-79.0,-80.0,43.0,46.0,34.0,28.0,1
6665,62:47:05:9D:EB:15,3839045,484750058,839,662673,3838206,484087385,0,1549,415720,1531,412537,18,3183,752,0,876,36,0,15,229410.0,130000.0,-49.0,-44.0,-47.0,-46.0,-47.0,-43.0,-47.0,-45.0,-83.0,-83.0,-79.0,-80.0,34.0,39.0,32.0,34.0,1
6666,3C:55:76:E8:8F:1F,3906832,656363397,68622,172275608,3838210,484087789,24,30632,6576990,30252,6510754,380,66236,13509,35,68694,7014,24,388,146250.0,48750.0,-46.0,-57.0,-44.0,-41.0,-46.0,-57.0,-44.0,-42.0,-83.0,-83.0,-79.0,-80.0,37.0,26.0,35.0,39.0,1
6667,92:69:1D:31:68:E9,3842156,487716353,3946,3628564,3838210,484087789,0,4915,1115695,4766,1081915,149,33780,2136,11,4164,90,0,47,216660.0,130000.0,-52.0,-48.0,-42.0,-49.0,-52.0,-48.0,-43.0,-48.0,-83.0,-83.0,-79.0,-80.0,31.0,35.0,37.0,31.0,1
6668,CC:2F:71:3F:1F:24,4713686,1438456319,875476,954368530,3838210,484087789,37,714954,762289674,714214,762200686,740,88988,689151,15,875733,91981,34,545,130000.0,43333.0,-67.0,-67.0,-68.0,-71.0,-67.0,-67.0,-67.0,-70.0,-83.0,-83.0,-79.0,-80.0,16.0,16.0,11.0,9.0,1
6669,CC:2F:71:3E:C5:1F,3839110,484197689,900,109900,3838210,484087789,0,3754,315310,3097,237340,657,77970,953,11,1292,23,0,47,130000.0,39000.0,-70.0,-71.0,-68.0,-60.0,-70.0,-71.0,-68.0,-60.0,-83.0,-83.0,-79.0,-80.0,13.0,12.0,11.0,20.0,1
6670,BA:8C:B9:54:50:24,3843067,490272932,4856,6185083,3838211,484087849,0,9126,1708545,9104,1705050,22,3495,2351,16,5311,40,0,60,229410.0,137640.0,-40.0,-37.0,-45.0,-52.0,-40.0,-36.0,-44.0,-50.0,-83.0,-83.0,-79.0,-80.0,43.0,46.0,34.0,28.0,1
6671,62:47:05:9D:EB:15,3839054,484751023,841,662972,3838213,484088051,0,1553,416251,1535,413068,18,3183,755,0,878,36,0,15,229410.0,130000.0,-50.0,-50.0,-47.0,-52.0,-48.0,-46.0,-47.0,-46.0,-83.0,-83.0,-79.0,-80.0,33.0,33.0,32.0,28.0,1
6672,3C:55:76:E8:8F:1F,3906836,656363833,68623,172275782,3838213,484088051,24,30650,6578382,30270,6512146,380,66236,13512,35,68695,7014,24,388,146250.0,48750.0,-46.0,-54.0,-46.0,-44.0,-45.0,-53.0,-45.0,-43.0,-83.0,-83.0,-79.0,-80.0,37.0,29.0,33.0,36.0,1
6673,92:69:1D:31:68:E9,3842159,487716615,3946,3628564,3838213,484088051,0,4915,1115695,4766,1081915,149,33780,2136,11,4164,90,0,47,216660.0,130000.0,-52.0,-48.0,-42.0,-49.0,-52.0,-48.0,-43.0,-48.0,-83.0,-83.0,-79.0,-80.0,31.0,35.0,37.0,31.0,1
6674,CC:2F:71:3F:1F:24,4713895,1438716401,875682,954628350,3838213,484088051,37,715148,762544880,714408,762455892,740,88988,689336,15,875937,91999,34,545,117000.0,39000.0,-68.0,-66.0,-67.0,-71.0,-68.0,-66.0,-67.0,-71.0,-83.0,-83.0,-79.0,-80.0,15.0,17.0,12.0,9.0,1
6675,CC:2F:71:3E:C5:1F,3839113,484197951,900,109900,3838213,484088051,0,3754,315310,3097,237340,657,77970,953,11,1292,23,0,47,130000.0,39000.0,-70.0,-71.0,-68.0,-60.0,-70.0,-71.0,-68.0,-60.0,-83.0,-83.0,-79.0,-80.0,13.0,12.0,11.0,20.0,1
6676,BA:8C:B9:54:50:24,3843069,490273134,4856,6185083,3838213,484088051,0,9126,1708545,9104,1705050,22,3495,2351,16,5311,40,0,60,229410.0,137640.0,-40.0,-37.0,-45.0,-52.0,-40.0,-36.0,-44.0,-50.0,-83.0,-83.0,-79.0,-80.0,43.0,46.0,34.0,28.0,1
6677,62:47:05:9D:EB:15,3839062,484752591,843,663934,3838219,484088657,0,1559,416812,1541,413629,18,3183,757,0,880,36,0,16,229410.0,130000.0,-50.0,-45.0,-51.0,-46.0,-49.0,-47.0,-49.0,-46.0,-83.0,-83.0,-79.0,-80.0,33.0,38.0,28.0,34.0,1
6678,3C:55:76:E8:8F:1F,3906846,656367357,68627,172278700,3838219,484088657,24,30662,6585435,30282,6519199,380,66236,13517,35,68699,7014,24,388,146250.0,48750.0,-43.0,-51.0,-46.0,-40.0,-44.0,-52.0,-45.0,-41.0,-83.0,-83.0,-79.0,-80.0,40.0,32.0,33.0,40.0,1
6679,92:69:1D:31:68:E9,3842165,487717221,3946,3628564,3838219,484088657,0,4915,1115695,4766,1081915,149,33780,2136,11,4164,90,0,47,216660.0,130000.0,-52.0,-48.0,-42.0,-49.0,-52.0,-48.0,-43.0,-48.0,-83.0,-83.0,-79.0,-80.0,31.0,35.0,37.0,31.0,1
6680,CC:2F:71:3F:1F:24,4714117,1438983312,875898,954894655,3838219,484088657,37,715343,762796588,714603,762707600,740,88988,689528,15,876154,92037,34,545,130000.0,43333.0,-68.0,-67.0,-67.0,-71.0,-68.0,-66.0,-67.0,-70.0,-83.0,-83.0,-79.0,-80.0,15.0,16.0,12.0,9.0,1
6681,CC:2F:71:3E:C5:1F,3839119,484198557,900,109900,3838219,484088657,0,3754,315310,3097,237340,657,77970,953,11,1292,23,0,47,130000.0,39000.0,-70.0,-71.0,-68.0,-60.0,-70.0,-71.0,-68.0,-60.0,-83.0,-83.0,-79.0,-80.0,13.0,12.0,11.0,20.0,1
6682,BA:8C:B9:54:50:24,3843075,490273740,4856,6185083,3838219,484088657,0,9126,1708545,9104,1705050,22,3495,2351,16,5311,40,0,60,229410.0,137640.0,-40.0,-37.0,-45.0,-52.0,-40.0,-36.0,-44.0,-50.0,-83.0,-83.0,-79.0,-80.0,43.0,46.0,34.0,28.0,1
6683,62:47:05:9D:EB:15,3839336,484810422,1114,721503,3838222,484088919,0,2941,2720117,2923,2716934,18,3183,1573,0,1151,38,0,96,229410.0,137640.0,-50.0,-51.0,-49.0,-42.0,-51.0,-47.0,-49.0,-43.0,-83.0,-83.0,-79.0,-80.0,33.0,32.0,30.0,38.0,1
6684,3C:55:76:E8:8F:1F,3906849,656367619,68627,172278700,3838222,484088919,24,30669,6585913,30289,6519677,380,66236,13517,35,68699,7014,24,388,146250.0,48750.0,-43.0,-52.0,-47.0,-40.0,-43.0,-51.0,-46.0,-40.0,-83.0,-83.0,-79.0,-80.0,40.0,31.0,32.0,40.0,1
6685,92:69:1D:31:68:E9,3842168,487717483,3946,3628564,3838222,484088919,0,4915,1115695,4766,1081915,149,33780,2136,11,4164,90,0,47,216660.0,130000.0,-52.0,-48.0,-42.0,-49.0,-52.0,-48.0,-43.0,-48.0,-83.0,-83.0,-79.0,-80.0,31.0,35.0,37.0,31.0,1
6686,CC:2F:71:3F:1F:24,4714333,1439251456,876111,955162537,3838222,484088919,37,715540,763053522,714800,762964534,740,88988,689720,15,876368,92074,34,545,130000.0,43333.0,-67.0,-65.0,-67.0,-70.0,-67.0,-66.0,-67.0,-70.0,-83.0,-83.0,-79.0,-80.0,16.0,18.0,12.0,10.0,1
6687,CC:2F:71:3E:C5:1F,3839122,484198819,900,109900,3838222,484088919,0,3754,315310,3097,237340,657,77970,953,11,1292,23,0,47,130000.0,39000.0,-70.0,-71.0,-68.0,-60.0,-70.0,-71.0,-68.0,-60.0,-83.0,-83.0,-79.0,-80.0,13.0,12.0,11.0,20.0,1
6688,BA:8C:B9:54:50:24,3843078,490274002,4856,6185083,3838222,484088919,0,9126,1708545,9104,1705050,22,3495,2351,16,5311,40,0,60,229410.0,137640.0,-40.0,-37.0,-45.0,-52.0,-40.0,-36.0,-44.0,-50.0,-83.0,-83.0,-79.0,-80.0,43.0,46.0,34.0,28.0,1
6689,62:47:05:9D:EB:15,3839373,484822045,1145,732520,3838228,484089525,0,3029,2767796,3011,2764613,18,3183,1615,0,1182,38,0,96,229410.0,137640.0,-44.0,-49.0,-46.0,-38.0,-47.0,-50.0,-48.0,-40.0,-83.0,-83.0,-79.0,-80.0,39.0,34.0,33.0,42.0,1
6690,3C:55:76:E8:8F:1F,3906855,656368225,68627,172278700,3838228,484089525,24,30669,6585913,30289,6519677,380,66236,13517,35,68699,7014,24,388,146250.0,48750.0,-43.0,-52.0,-47.0,-40.0,-43.0,-51.0,-46.0,-40.0,-83.0,-83.0,-79.0,-80.0,40.0,31.0,32.0,40.0,1
6691,92:69:1D:31:68:E9,3842174,487718089,3946,3628564,3838228,484089525,0,4915,1115695,4766,1081915,149,33780,2136,11,4164,90,0,47,216660.0,130000.0,-52.0,-48.0,-42.0,-49.0,-52.0,-48.0,-43.0,-48.0,-83.0,-83.0,-79.0,-80.0,31.0,35.0,37.0,31.0,1
6692,CC:2F:71:3F:1F:24,4714550,1439519708,876322,955430183,3838228,484089525,37,715729,763305216,714989,763216228,740,88988,689908,15,876578,92097,34,545,130000.0,39000.0,-67.0,-66.0,-66.0,-71.0,-67.0,-66.0,-66.0,-70.0,-83.0,-83.0,-79.0,-80.0,16.0,17.0,13.0,9.0,1
6693,CC:2F:71:3E:C5:1F,3839128,484199425,900,109900,3838228,484089525,0,3754,315310,3097,237340,657,77970,953,11,1292,23,0,47,130000.0,39000.0,-70.0,-71.0,-68.0,-60.0,-70.0,-71.0,-68.0,-60.0,-83.0,-83.0,-79.0,-80.0,13.0,12.0,11.0,20.0,1
6694,BA:8C:B9:54:50:24,3843084,490274608,4856,6185083,3838228,484089525,0,9126,1708545,9104,1705050,22,3495,2351,16,5311,40,0,60,229410.0,137640.0,-40.0,-37.0,-45.0,-52.0,-40.0,-36.0,-44.0,-50.0,-83.0,-83.0,-79.0,-80.0,43.0,46.0,34.0,28.0,1
6695,62:47:05:9D:EB:15,3839376,484822307,1145,732520,3838231,484089787,0,3030,2767864,3012,2764681,18,3183,1615,0,1182,38,0,96,229410.0,137640.0,-45.0,-49.0,-45.0,-38.0,-47.0,-50.0,-48.0,-40.0,-83.0,-83.0,-79.0,-80.0,38.0,34.0,34.0,42.0,1
6696,3C:55:76:E8:8F:1F,3906859,656369696,68628,172279909,3838231,484089787,24,30677,6586497,30297,6520261,380,66236,13518,35,68700,7014,24,388,146250.0,48750.0,-47.0,-55.0,-47.0,-44.0,-45.0,-54.0,-45.0,-42.0,-83.0,-83.0,-79.0,-80.0,36.0,28.0,32.0,36.0,1
6697,92:69:1D:31:68:E9,3842179,487718553,3946,3628564,3838233,484089989,0,4915,1115695,4766,1081915,149,33780,2136,11,4164,90,0,47,216660.0,130000.0,-52.0,-48.0,-42.0,-49.0,-52.0,-48.0,-43.0,-48.0,-83.0,-83.0,-79.0,-80.0,31.0,35.0,37.0,31.0,1
6698,CC:2F:71:3F:1F:24,4714769,1439783523,876536,955693534,3838233,484089989,37,715924,763556692,715184,763467704,740,88988,690098,15,876793,92137,34,545,130000.0,43333.0,-68.0,-66.0,-67.0,-70.0,-67.0,-66.0,-67.0,-70.0,-83.0,-83.0,-79.0,-80.0,15.0,17.0,12.0,10.0,1
6699,CC:2F:71:3E:C5:1F,3839133,484199889,900,109900,3838233,484089989,0,3754,315310,3097,237340,657,77970,953,11,1292,23,0,47,130000.0,39000.0,-70.0,-71.0,-68.0,-60.0,-70.0,-71.0,-68.0,-60.0,-83.0,-83.0,-79.0,-80.0,13.0,12.0,11.0,20.0,1
6700,BA:8C:B9:54:50:24,3843093,490275476,4856,6185083,3838237,484090393,0,9126,1708545,9104,1705050,22,3495,2351,16,5311,40,0,60,229410.0,137640.0,-40.0,-37.0,-45.0,-52.0,-40.0,-36.0,-44.0,-50.0,-83.0,-83.0,-79.0,-80.0,43.0,46.0,34.0,28.0,1
6701,62:47:05:9D:EB:15,3839385,484823299,1148,732906,3838237,484090393,0,3052,2769476,3034,2766293,18,3183,1617,0,1185,38,0,96,229410.0,137640.0,-45.0,-48.0,-49.0,-39.0,-45.0,-50.0,-50.0,-41.0,-83.0,-83.0,-79.0,-80.0,38.0,35.0,30.0,41.0,1
6702,3C:55:76:E8:8F:1F,3906866,656370418,68629,172280025,3838237,484090393,24,30680,6586703,30300,6520467,380,66236,13518,35,68701,7014,24,388,146250.0,48750.0,-41.0,-49.0,-45.0,-38.0,-44.0,-52.0,-45.0,-40.0,-83.0,-83.0,-79.0,-80.0,42.0,34.0,34.0,42.0,1
6703,92:69:1D:31:68:E9,3842184,487719073,3947,3628680,3838237,484090393,0,4917,1115831,4768,1082051,149,33780,2136,11,4165,90,0,47,216660.0,130000.0,-52.0,-48.0,-42.0,-49.0,-52.0,-47.0,-43.0,-48.0,-83.0,-83.0,-79.0,-80.0,31.0,35.0,37.0,31.0,1
6704,CC:2F:71:3F:1F:24,4714986,1440047533,876749,955957140,3838237,484090393,37,716120,763813640,715380,763724652,740,88988,690285,15,877004,92175,34,545,130000.0,39000.0,-67.0,-67.0,-67.0,-71.0,-67.0,-66.0,-67.0,-70.0,-83.0,-83.0,-79.0,-80.0,16.0,16.0,12.0,9.0,1
6705,CC:2F:71:3E:C5:1F,3839140,484200611,901,110016,3838239,484090595,0,3756,315450,3099,237480,657,77970,953,11,1293,23,0,47,130000.0,39000.0,-66.0,-65.0,-65.0,-60.0,-71.0,-71.0,-68.0,-61.0,-83.0,-83.0,-79.0,-80.0,17.0,18.0,14.0,20.0,1
6706,BA:8C:B9:54:50:24,3843096,490275738,4857,6185143,3838239,484090595,0,9128,1708681,9106,1705186,22,3495,2351,16,5312,40,0,60,216660.0,130000.0,-49.0,-35.0,-43.0,-45.0,-41.0,-36.0,-44.0,-49.0,-83.0,-83.0,-79.0,-80.0,34.0,48.0,36.0,35.0,1
6707,62:47:05:9D:EB:15,3839389,484823703,1148,732906,3838241,484090797,0,3052,2769476,3034,2766293,18,3183,1617,0,1185,38,0,96,229410.0,137640.0,-45.0,-48.0,-49.0,-39.0,-45.0,-50.0,-50.0,-41.0,-83.0,-83.0,-79.0,-80.0,38.0,35.0,30.0,41.0,1
6708,3C:55:76:E8:8F:1F,3906874,656371226,68629,172280025,3838245,484091201,24,30685,6587045,30305,6520809,380,66236,13518,35,68701,7014,24,388,146250.0,48750.0,-44.0,-52.0,-47.0,-40.0,-42.0,-50.0,-45.0,-38.0,-83.0,-83.0,-79.0,-80.0,39.0,31.0,32.0,40.0,1
6709,92:69:1D:31:68:E9,3842193,487719943,3947,3628680,3838246,484091263,0,4917,1115831,4768,1082051,149,33780,2136,11,4165,90,0,47,216660.0,130000.0,-52.0,-48.0,-42.0,-49.0,-52.0,-47.0,-43.0,-48.0,-83.0,-83.0,-79.0,-80.0,31.0,35.0,37.0,31.0,1
6710,CC:2F:71:3F:1F:24,4715205,1440311535,876959,956220272,3838246,484091263,37,716318,764072206,715578,763983218,740,88988,690474,15,877216,92216,34,545,130000.0,43333.0,-67.0,-66.0,-67.0,-71.0,-67.0,-66.0,-67.0,-70.0,-83.0,-83.0,-79.0,-80.0,16.0,17.0,12.0,9.0,1
6711,CC:2F:71:3E:C5:1F,3839148,484201339,901,110016,3838247,484091323,0,3756,315450,3099,237480,657,77970,953,11,1293,23,0,47,130000.0,39000.0,-66.0,-65.0,-65.0,-60.0,-71.0,-71.0,-68.0,-61.0,-83.0,-83.0,-79.0,-80.0,17.0,18.0,14.0,20.0,1
6712,BA:8C:B9:54:50:24,3843104,490276466,4857,6185143,3838247,484091323,0,9128,1708681,9106,1705186,22,3495,2351,16,5312,40,0,60,216660.0,130000.0,-49.0,-35.0,-43.0,-45.0,-41.0,-36.0,-44.0,-49.0,-83.0,-83.0,-79.0,-80.0,34.0,48.0,36.0,35.0,1
6713,62:47:05:9D:EB:15,3839398,484824675,1148,732906,3838250,484091769,0,3055,2769783,3036,2766429,19,3354,1618,0,1185,38,0,96,229410.0,137640.0,-44.0,-45.0,-49.0,-40.0,-45.0,-48.0,-49.0,-40.0,-83.0,-83.0,-79.0,-80.0,39.0,38.0,30.0,40.0,1
6714,3C:55:76:E8:8F:1F,3906881,656371996,68629,172280025,3838252,484091971,24,30702,6588309,30320,6521837,382,66472,13520,35,68701,7014,24,390,146250.0,48750.0,-44.0,-52.0,-47.0,-40.0,-41.0,-50.0,-44.0,-38.0,-83.0,-83.0,-79.0,-80.0,39.0,31.0,32.0,40.0,1
6715,92:69:1D:31:68:E9,3842199,487720651,3947,3628680,3838252,484091971,0,4917,1115831,4768,1082051,149,33780,2136,11,4165,90,0,47,216660.0,130000.0,-52.0,-48.0,-42.0,-49.0,-52.0,-47.0,-43.0,-48.0,-83.0,-83.0,-79.0,-80.0,31.0,35.0,37.0,31.0,1
6716,CC:2F:71:3F:1F:24,4715423,1440581499,877171,956489528,3838252,484091971,37,716518,764336898,715778,764247910,740,88988,690662,15,877427,92241,34,545,130000.0,43333.0,-68.0,-66.0,-67.0,-71.0,-67.0,-66.0,-66.0,-71.0,-83.0,-83.0,-79.0,-80.0,15.0,17.0,12.0,9.0,1
6717,CC:2F:71:3E:C5:1F,3839153,484201987,901,110016,3838252,484091971,0,3756,315450,3099,237480,657,77970,953,11,1293,23,0,47,130000.0,39000.0,-66.0,-65.0,-65.0,-60.0,-71.0,-71.0,-68.0,-61.0,-83.0,-83.0,-79.0,-80.0,17.0,18.0,14.0,20.0,1
6718,BA:8C:B9:54:50:24,3843109,490277114,4857,6185143,3838252,484091971,0,9129,1708749,9107,1705254,22,3495,2351,16,5312,40,0,60,216660.0,130000.0,-39.0,-36.0,-45.0,-52.0,-41.0,-35.0,-44.0,-49.0,-83.0,-83.0,-79.0,-80.0,44.0,47.0,34.0,28.0,1
6719,62:47:05:9D:EB:15,3839409,484826208,1151,733631,3838258,484092577,0,3078,2771685,3059,2768331,19,3354,1623,0,1188,38,0,96,229410.0,137640.0,-48.0,-51.0,-51.0,-44.0,-47.0,-51.0,-51.0,-44.0,-83.0,-83.0,-79.0,-80.0,35.0,32.0,28.0,36.0,1
6720,3C:55:76:E8:8F:1F,3906887,656372602,68629,172280025,3838258,484092577,24,30702,6588309,30320,6521837,382,66472,13520,35,68701,7014,24,390,146250.0,48750.0,-44.0,-52.0,-47.0,-40.0,-41.0,-50.0,-44.0,-38.0,-83.0,-83.0,-79.0,-80.0,39.0,31.0,32.0,40.0,1
6721,92:69:1D:31:68:E9,3842205,487721257,3947,3628680,3838258,484092577,0,4917,1115831,4768,1082051,149,33780,2136,11,4165,90,0,47,216660.0,130000.0,-52.0,-48.0,-42.0,-49.0,-52.0,-47.0,-43.0,-48.0,-83.0,-83.0,-79.0,-80.0,31.0,35.0,37.0,31.0,1
6722,CC:2F:71:3F:1F:24,4715645,1440845690,877387,956753113,3838258,484092577,37,716718,764587905,715978,764498917,740,88988,690856,15,877644,92271,34,545,130000.0,43333.0,-68.0,-67.0,-67.0,-71.0,-67.0,-66.0,-67.0,-70.0,-83.0,-83.0,-79.0,-80.0,15.0,16.0,12.0,9.0,1
6723,CC:2F:71:3E:C5:1F,3839159,484202593,901,110016,3838258,484092577,0,3756,315450,3099,237480,657,77970,953,11,1293,23,0,47,130000.0,39000.0,-66.0,-65.0,-65.0,-60.0,-71.0,-71.0,-68.0,-61.0,-83.0,-83.0,-79.0,-80.0,17.0,18.0,14.0,20.0,1
6724,BA:8C:B9:54:50:24,3843115,490277720,4857,6185143,3838258,484092577,0,9129,1708749,9107,1705254,22,3495,2351,16,5312,40,0,60,216660.0,130000.0,-39.0,-36.0,-45.0,-52.0,-41.0,-35.0,-44.0,-49.0,-83.0,-83.0,-79.0,-80.0,44.0,47.0,34.0,28.0,1
6725,62:47:05:9D:EB:15,3839413,484826729,1152,733890,3838261,484092839,0,3091,2772712,3072,2769358,19,3354,1625,0,1189,38,0,96,229410.0,137640.0,-48.0,-48.0,-51.0,-46.0,-48.0,-48.0,-51.0,-46.0,-83.0,-83.0,-79.0,-80.0,35.0,35.0,28.0,34.0,1
6726,3C:55:76:E8:8F:1F,3906891,656372926,68629,172280025,3838262,484092901,24,30705,6588565,30322,6521975,383,66590,13521,35,68701,7014,24,390,146250.0,48750.0,-45.0,-54.0,-44.0,-41.0,-42.0,-51.0,-44.0,-39.0,-83.0,-83.0,-79.0,-80.0,38.0,29.0,35.0,39.0,1
6727,92:69:1D:31:68:E9,3842209,487721581,3947,3628680,3838262,484092901,0,4917,1115831,4768,1082051,149,33780,2136,11,4165,90,0,47,216660.0,130000.0,-52.0,-48.0,-42.0,-49.0,-52.0,-47.0,-43.0,-48.0,-83.0,-83.0,-79.0,-80.0,31.0,35.0,37.0,31.0,1
6728,CC:2F:71:3F:1F:24,4715856,1441105852,877594,957012951,3838262,484092901,37,716909,764837073,716169,764748085,740,88988,691041,15,877851,92316,34,545,130000.0,43333.0,-67.0,-66.0,-66.0,-71.0,-67.0,-66.0,-67.0,-70.0,-83.0,-83.0,-79.0,-80.0,16.0,17.0,13.0,9.0,1
6729,CC:2F:71:3E:C5:1F,3839163,484202917,901,110016,3838262,484092901,0,3756,315450,3099,237480,657,77970,953,11,1293,23,0,47,130000.0,39000.0,-66.0,-65.0,-65.0,-60.0,-71.0,-71.0,-68.0,-61.0,-83.0,-83.0,-79.0,-80.0,17.0,18.0,14.0,20.0,1
6730,BA:8C:B9:54:50:24,3843119,490278044,4857,6185143,3838262,484092901,0,9129,1708749,9107,1705254,22,3495,2351,16,5312,40,0,60,216660.0,130000.0,-39.0,-36.0,-45.0,-52.0,-41.0,-35.0,-44.0,-49.0,-83.0,-83.0,-79.0,-80.0,44.0,47.0,34.0,28.0,1
6731,62:47:05:9D:EB:15,3839441,484833494,1172,739925,3838269,484093569,0,3135,2792455,3116,2789101,19,3354,1649,0,1209,38,0,96,229410.0,137640.0,-51.0,-46.0,-52.0,-49.0,-48.0,-48.0,-50.0,-47.0,-84.0,-82.0,-79.0,-80.0,33.0,36.0,27.0,31.0,1
6732,3C:55:76:E8:8F:1F,3906898,656373594,68629,172280025,3838269,484093569,24,30708,6588771,30325,6522181,383,66590,13521,35,68701,7014,24,390,146250.0,48750.0,-46.0,-55.0,-45.0,-41.0,-44.0,-53.0,-45.0,-40.0,-84.0,-82.0,-79.0,-80.0,38.0,27.0,34.0,39.0,1
6733,92:69:1D:31:68:E9,3842216,487722249,3947,3628680,3838269,484093569,0,4917,1115831,4768,1082051,149,33780,2136,11,4165,90,0,47,216660.0,130000.0,-52.0,-48.0,-42.0,-49.0,-52.0,-47.0,-43.0,-48.0,-84.0,-82.0,-79.0,-80.0,32.0,34.0,37.0,31.0,1
6734,CC:2F:71:3F:1F:24,4716076,1441372834,877807,957279265,3838269,484093569,37,717103,765095101,716362,765005995,741,89106,691228,15,878064,92345,34,545,130000.0,43333.0,-69.0,-66.0,-67.0,-69.0,-68.0,-66.0,-67.0,-69.0,-84.0,-82.0,-79.0,-80.0,15.0,16.0,12.0,11.0,1
6735,CC:2F:71:3E:C5:1F,3839170,484203585,901,110016,3838269,484093569,0,3756,315450,3099,237480,657,77970,953,11,1293,23,0,47,130000.0,39000.0,-66.0,-65.0,-65.0,-60.0,-71.0,-71.0,-68.0,-61.0,-84.0,-82.0,-79.0,-80.0,18.0,17.0,14.0,20.0,1
6736,BA:8C:B9:54:50:24,3843126,490278712,4857,6185143,3838269,484093569,0,9129,1708749,9107,1705254,22,3495,2351,16,5312,40,0,60,216660.0,130000.0,-39.0,-36.0,-45.0,-52.0,-41.0,-35.0,-44.0,-49.0,-84.0,-82.0,-79.0,-80.0,45.0,46.0,34.0,28.0,1
6737,62:47:05:9D:EB:15,3839444,484833756,1172,739925,3838272,484093831,0,3135,2792455,3116,2789101,19,3354,1649,0,1209,38,0,96,229410.0,137640.0,-51.0,-46.0,-52.0,-49.0,-48.0,-48.0,-50.0,-47.0,-84.0,-82.0,-79.0,-80.0,33.0,36.0,27.0,31.0,1
6738,3C:55:76:E8:8F:1F,3906901,656373856,68629,172280025,3838272,484093831,24,30708,6588771,30325,6522181,383,66590,13521,35,68701,7014,24,390,146250.0,48750.0,-46.0,-55.0,-45.0,-41.0,-44.0,-53.0,-45.0,-40.0,-84.0,-82.0,-79.0,-80.0,38.0,27.0,34.0,39.0,1
6739,92:69:1D:31:68:E9,3842219,487722511,3947,3628680,3838272,484093831,0,4917,1115831,4768,1082051,149,33780,2136,11,4165,90,0,47,216660.0,130000.0,-52.0,-48.0,-42.0,-49.0,-52.0,-47.0,-43.0,-48.0,-84.0,-82.0,-79.0,-80.0,32.0,34.0,37.0,31.0,1
6740,CC:2F:71:3F:1F:24,4716296,1441636737,878022,957542704,3838274,484094033,37,717302,765349941,716561,765260835,741,89106,691421,15,878279,92353,34,545,130000.0,43333.0,-68.0,-67.0,-68.0,-70.0,-68.0,-66.0,-68.0,-69.0,-84.0,-82.0,-79.0,-80.0,16.0,15.0,11.0,10.0,1
6741,CC:2F:71:3E:C5:1F,3839177,484204251,901,110016,3838276,484094235,0,3756,315450,3099,237480,657,77970,953,11,1293,23,0,47,130000.0,39000.0,-66.0,-65.0,-65.0,-60.0,-71.0,-71.0,-68.0,-61.0,-84.0,-82.0,-79.0,-80.0,18.0,17.0,14.0,20.0,1
6742,BA:8C:B9:54:50:24,3843135,490279580,4857,6185143,3838278,484094437,0,9129,1708749,9107,1705254,22,3495,2351,16,5312,40,0,60,216660.0,130000.0,-39.0,-36.0,-45.0,-52.0,-41.0,-35.0,-44.0,-49.0,-84.0,-82.0,-79.0,-80.0,45.0,46.0,34.0,28.0,1
6743,62:47:05:9D:EB:15,3839451,484834621,1173,740184,3838278,484094437,0,3155,2793958,3136,2790604,19,3354,1651,0,1210,38,0,96,229410.0,137640.0,-40.0,-51.0,-45.0,-52.0,-44.0,-54.0,-47.0,-51.0,-84.0,-82.0,-79.0,-80.0,44.0,31.0,34.0,28.0,1
6744,3C:55:76:E8:8F:1F,3906908,656374636,68630,172280199,3838278,484094437,24,30721,6589785,30338,6523195,383,66590,13523,35,68702,7014,24,390,146250.0,48750.0,-44.0,-51.0,-46.0,-40.0,-43.0,-51.0,-45.0,-40.0,-84.0,-82.0,-79.0,-80.0,40.0,31.0,33.0,40.0,1
6745,92:69:1D:31:68:E9,3842225,487723117,3947,3628680,3838278,484094437,0,4917,1115831,4768,1082051,149,33780,2136,11,4165,90,0,47,216660.0,130000.0,-52.0,-48.0,-42.0,-49.0,-52.0,-47.0,-43.0,-48.0,-84.0,-82.0,-79.0,-80.0,32.0,34.0,37.0,31.0,1
6746,CC:2F:71:3F:1F:24,4716512,1441902125,878234,957807688,3838278,484094437,37,717498,765611075,716757,765521969,741,89106,691608,15,878491,92360,34,545,130000.0,43333.0,-68.0,-66.0,-68.0,-69.0,-67.0,-66.0,-68.0,-69.0,-84.0,-82.0,-79.0,-80.0,16.0,16.0,11.0,11.0,1
6747,CC:2F:71:3E:C5:1F,3839179,484204453,901,110016,3838278,484094437,0,3756,315450,3099,237480,657,77970,953,11,1293,23,0,47,130000.0,39000.0,-66.0,-65.0,-65.0,-60.0,-71.0,-71.0,-68.0,-61.0,-84.0,-82.0,-79.0,-80.0,18.0,17.0,14.0,20.0,1
6748,BA:8C:B9:54:50:24,3843135,490279580,4857,6185143,3838278,484094437,0,9129,1708749,9107,1705254,22,3495,2351,16,5312,40,0,60,216660.0,130000.0,-39.0,-36.0,-45.0,-52.0,-41.0,-35.0,-44.0,-49.0,-84.0,-82.0,-79.0,-80.0,45.0,46.0,34.0,28.0,1
6749,62:47:05:9D:EB:15,3839461,484838355,1181,743716,3838280,484094639,0,3184,2797907,3165,2794553,19,3354,1660,0,1218,38,0,96,229410.0,137640.0,-52.0,-52.0,-45.0,-47.0,-47.0,-47.0,-47.0,-42.0,-84.0,-82.0,-79.0,-80.0,32.0,30.0,34.0,33.0,1
6750,3C:55:76:E8:8F:1F,3906916,656375444,68630,172280199,3838286,484095245,24,30722,6589948,30339,6523358,383,66590,13524,35,68702,7014,24,390,146250.0,48750.0,-46.0,-51.0,-44.0,-41.0,-44.0,-51.0,-45.0,-40.0,-84.0,-82.0,-79.0,-80.0,38.0,31.0,35.0,39.0,1
6751,92:69:1D:31:68:E9,3842233,487723925,3947,3628680,3838286,484095245,0,4917,1115831,4768,1082051,149,33780,2136,11,4165,90,0,47,216660.0,130000.0,-52.0,-48.0,-42.0,-49.0,-52.0,-47.0,-43.0,-48.0,-84.0,-82.0,-79.0,-80.0,32.0,34.0,37.0,31.0,1
6752,CC:2F:71:3F:1F:24,4716732,1442167727,878445,958072422,3838287,484095305,37,717693,765866405,716952,765777299,741,89106,691797,15,878702,92384,34,545,115556.0,28889.0,-68.0,-66.0,-66.0,-68.0,-67.0,-66.0,-66.0,-68.0,-84.0,-82.0,-79.0,-80.0,16.0,16.0,13.0,12.0,1
6753,CC:2F:71:3E:C5:1F,3839188,484205321,901,110016,3838287,484095305,0,3756,315450,3099,237480,657,77970,953,11,1293,23,0,47,130000.0,39000.0,-66.0,-65.0,-65.0,-60.0,-71.0,-71.0,-68.0,-61.0,-84.0,-82.0,-79.0,-80.0,18.0,17.0,14.0,20.0,1
6754,BA:8C:B9:54:50:24,3843144,490280448,4857,6185143,3838287,484095305,0,9129,1708749,9107,1705254,22,3495,2351,16,5312,40,0,60,216660.0,130000.0,-39.0,-36.0,-45.0,-52.0,-41.0,-35.0,-44.0,-49.0,-84.0,-82.0,-79.0,-80.0,45.0,46.0,34.0,28.0,1
6755,62:47:05:9D:EB:15,3839468,484839021,1181,743716,3838287,484095305,0,3193,2798519,3174,2795165,19,3354,1660,0,1218,38,0,97,229410.0,137640.0,-51.0,-45.0,-44.0,-38.0,-49.0,-49.0,-45.0,-43.0,-84.0,-82.0,-79.0,-80.0,33.0,37.0,35.0,42.0,1
6756,3C:55:76:E8:8F:1F,3906918,656375670,68631,172280365,3838287,484095305,24,30732,6590668,30349,6524078,383,66590,13525,35,68703,7014,24,390,146250.0,48750.0,-44.0,-51.0,-51.0,-41.0,-43.0,-50.0,-47.0,-40.0,-84.0,-82.0,-79.0,-80.0,40.0,31.0,28.0,39.0,1
6757,92:69:1D:31:68:E9,3842235,487724047,3947,3628680,3838288,484095367,0,4919,1115967,4770,1082187,149,33780,2136,11,4166,90,0,48,216660.0,130000.0,-52.0,-48.0,-43.0,-46.0,-52.0,-48.0,-43.0,-48.0,-84.0,-82.0,-79.0,-80.0,32.0,34.0,36.0,34.0,1
6758,CC:2F:71:3F:1F:24,4716942,1442430945,878654,958335578,3838288,484095367,37,717885,766120133,717144,766031027,741,89106,691981,15,878911,92388,34,545,115556.0,28889.0,-70.0,-67.0,-68.0,-68.0,-69.0,-66.0,-67.0,-68.0,-84.0,-82.0,-79.0,-80.0,14.0,15.0,11.0,12.0,1
6759,CC:2F:71:3E:C5:1F,3839191,484205585,901,110016,3838290,484095569,0,3760,315778,3102,237690,658,78088,954,11,1294,23,0,47,130000.0,39000.0,-71.0,-71.0,-68.0,-61.0,-70.0,-71.0,-68.0,-61.0,-84.0,-82.0,-79.0,-80.0,13.0,11.0,11.0,19.0,1
6760,BA:8C:B9:54:50:24,3843147,490280712,4857,6185143,3838290,484095569,0,9131,1708885,9109,1705390,22,3495,2351,16,5313,40,0,60,216660.0,130000.0,-47.0,-35.0,-39.0,-44.0,-41.0,-36.0,-44.0,-50.0,-84.0,-82.0,-79.0,-80.0,37.0,47.0,40.0,36.0,1
6761,62:47:05:9D:EB:15,3839477,484839891,1181,743716,3838296,484096175,0,3193,2798519,3174,2795165,19,3354,1660,0,1218,38,0,97,229410.0,137640.0,-51.0,-45.0,-44.0,-38.0,-49.0,-49.0,-45.0,-43.0,-84.0,-82.0,-79.0,-80.0,33.0,37.0,35.0,42.0,1
6762,3C:55:76:E8:8F:1F,3906927,656376540,68631,172280365,3838296,484096175,24,30732,6590668,30349,6524078,383,66590,13525,35,68703,7014,24,390,146250.0,48750.0,-44.0,-51.0,-51.0,-41.0,-43.0,-50.0,-47.0,-40.0,-84.0,-82.0,-79.0,-80.0,40.0,31.0,28.0,39.0,1
6763,92:69:1D:31:68:E9,3842243,487724855,3947,3628680,3838296,484096175,0,4919,1115967,4770,1082187,149,33780,2136,11,4166,90,0,48,216660.0,130000.0,-52.0,-48.0,-43.0,-46.0,-52.0,-48.0,-43.0,-48.0,-84.0,-82.0,-79.0,-80.0,32.0,34.0,36.0,34.0,1
6764,CC:2F:71:3F:1F:24,4717166,1442698004,878870,958601829,3838296,484096175,37,718088,766381270,717347,766292164,741,89106,692173,15,879127,92400,34,545,130000.0,43333.0,-67.0,-66.0,-68.0,-67.0,-67.0,-66.0,-67.0,-67.0,-84.0,-82.0,-79.0,-80.0,17.0,16.0,11.0,13.0,1
6765,CC:2F:71:3E:C5:1F,3839197,484206191,901,110016,3838296,484096175,0,3760,315778,3102,237690,658,78088,954,11,1294,23,0,47,130000.0,39000.0,-71.0,-71.0,-68.0,-61.0,-70.0,-71.0,-68.0,-61.0,-84.0,-82.0,-79.0,-80.0,13.0,11.0,11.0,19.0,1
6766,BA:8C:B9:54:50:24,3843153,490281318,4857,6185143,3838296,484096175,0,9131,1708885,9109,1705390,22,3495,2351,16,5313,40,0,60,216660.0,130000.0,-47.0,-35.0,-39.0,-44.0,-41.0,-36.0,-44.0,-50.0,-84.0,-82.0,-79.0,-80.0,37.0,47.0,40.0,36.0,1
6767,62:47:05:9D:EB:15,3839481,484840215,1181,743716,3838300,484096499,0,3197,2798845,3177,2795369,20,3476,1661,0,1218,38,0,97,229410.0,137640.0,-46.0,-48.0,-45.0,-43.0,-49.0,-49.0,-45.0,-43.0,-84.0,-82.0,-79.0,-80.0,38.0,34.0,34.0,37.0,1
6768,3C:55:76:E8:8F:1F,3906934,656377354,68634,172280855,3838300,484096499,24,30741,6592472,30358,6525882,383,66590,13529,35,68706,7016,24,390,135410.0,48750.0,-44.0,-49.0,-52.0,-41.0,-43.0,-49.0,-49.0,-42.0,-84.0,-82.0,-79.0,-80.0,40.0,33.0,27.0,39.0,1
6769,92:69:1D:31:68:E9,3842247,487725179,3947,3628680,3838300,484096499,0,4919,1115967,4770,1082187,149,33780,2136,11,4166,90,0,48,216660.0,130000.0,-52.0,-48.0,-43.0,-46.0,-52.0,-48.0,-43.0,-48.0,-84.0,-82.0,-79.0,-80.0,32.0,34.0,36.0,34.0,1
6770,CC:2F:71:3F:1F:24,4717377,1442958374,879077,958861875,3838300,484096499,37,718276,766631438,717535,766542332,741,89106,692357,15,879334,92400,34,545,130000.0,43333.0,-69.0,-67.0,-68.0,-68.0,-69.0,-67.0,-68.0,-68.0,-84.0,-82.0,-79.0,-80.0,15.0,15.0,11.0,12.0,1
6771,CC:2F:71:3E:C5:1F,3839201,484206515,901,110016,3838300,484096499,0,3760,315778,3102,237690,658,78088,954,11,1294,23,0,47,130000.0,39000.0,-71.0,-71.0,-68.0,-61.0,-70.0,-71.0,-68.0,-61.0,-84.0,-82.0,-79.0,-80.0,13.0,11.0,11.0,19.0,1
6772,BA:8C:B9:54:50:24,3843158,490281720,4857,6185143,3838301,484096577,0,9131,1708885,9109,1705390,22,3495,2351,16,5313,40,0,60,216660.0,130000.0,-47.0,-35.0,-39.0,-44.0,-41.0,-36.0,-44.0,-50.0,-84.0,-82.0,-79.0,-80.0,37.0,47.0,40.0,36.0,1
6773,62:47:05:9D:EB:15,3839489,484841158,1182,743975,3838307,484097183,0,3200,2799262,3179,2795648,21,3614,1664,0,1219,38,0,97,229410.0,137640.0,-49.0,-50.0,-48.0,-48.0,-48.0,-49.0,-45.0,-45.0,-84.0,-82.0,-79.0,-80.0,35.0,32.0,31.0,32.0,1
6774,3C:55:76:E8:8F:1F,3906941,656378038,68634,172280855,3838307,484097183,24,30754,6593358,30371,6526768,383,66590,13529,35,68706,7016,24,390,135410.0,48750.0,-44.0,-50.0,-53.0,-42.0,-44.0,-50.0,-52.0,-42.0,-84.0,-82.0,-79.0,-80.0,40.0,32.0,26.0,38.0,1
6775,92:69:1D:31:68:E9,3842254,487725863,3947,3628680,3838307,484097183,0,4919,1115967,4770,1082187,149,33780,2136,11,4166,90,0,48,216660.0,130000.0,-52.0,-48.0,-43.0,-46.0,-52.0,-48.0,-43.0,-48.0,-84.0,-82.0,-79.0,-80.0,32.0,34.0,36.0,34.0,1
6776,CC:2F:71:3F:1F:24,4717594,1443222576,879287,959125393,3838307,484097183,37,718470,766886802,717729,766797696,741,89106,692542,15,879544,92402,34,545,144444.0,43333.0,-69.0,-67.0,-68.0,-68.0,-69.0,-67.0,-67.0,-68.0,-84.0,-82.0,-79.0,-80.0,15.0,15.0,11.0,12.0,1
6777,CC:2F:71:3E:C5:1F,3839208,484207199,901,110016,3838307,484097183,0,3760,315778,3102,237690,658,78088,954,11,1294,23,0,47,130000.0,39000.0,-71.0,-71.0,-68.0,-61.0,-70.0,-71.0,-68.0,-61.0,-84.0,-82.0,-79.0,-80.0,13.0,11.0,11.0,19.0,1
6778,BA:8C:B9:54:50:24,3843164,490282326,4857,6185143,3838307,484097183,0,9131,1708885,9109,1705390,22,3495,2351,16,5313,40,0,60,216660.0,130000.0,-47.0,-35.0,-39.0,-44.0,-41.0,-36.0,-44.0,-50.0,-84.0,-82.0,-79.0,-80.0,37.0,47.0,40.0,36.0,1
6779,62:47:05:9D:EB:15,3839492,484841420,1182,743975,3838310,484097445,0,3201,2799330,3180,2795716,21,3614,1664,0,1219,38,0,97,229410.0,137640.0,-47.0,-47.0,-45.0,-44.0,-48.0,-49.0,-46.0,-45.0,-84.0,-82.0,-79.0,-80.0,37.0,35.0,34.0,36.0,1
6780,3C:55:76:E8:8F:1F,3906944,656378300,68634,172280855,3838310,484097445,24,30754,6593358,30371,6526768,383,66590,13529,35,68706,7016,24,390,135410.0,48750.0,-44.0,-50.0,-53.0,-42.0,-44.0,-50.0,-52.0,-42.0,-84.0,-82.0,-79.0,-80.0,40.0,32.0,26.0,38.0,1
6781,92:69:1D:31:68:E9,3842257,487726125,3947,3628680,3838310,484097445,0,4919,1115967,4770,1082187,149,33780,2136,11,4166,90,0,48,216660.0,130000.0,-52.0,-48.0,-43.0,-46.0,-52.0,-48.0,-43.0,-48.0,-84.0,-82.0,-79.0,-80.0,32.0,34.0,36.0,34.0,1
6782,CC:2F:71:3F:1F:24,4717809,1443483263,879499,959385818,3838310,484097445,37,718668,767142992,717927,767053886,741,89106,692729,15,879756,92406,34,545,144444.0,43333.0,-69.0,-67.0,-67.0,-68.0,-69.0,-67.0,-67.0,-68.0,-84.0,-82.0,-79.0,-80.0,15.0,15.0,12.0,12.0,1
6783,CC:2F:71:3E:C5:1F,3839211,484207461,901,110016,3838310,484097445,0,3760,315778,3102,237690,658,78088,954,11,1294,23,0,47,130000.0,39000.0,-71.0,-71.0,-68.0,-61.0,-70.0,-71.0,-68.0,-61.0,-84.0,-82.0,-79.0,-80.0,13.0,11.0,11.0,19.0,1
6784,BA:8C:B9:54:50:24,3843170,490283063,4857,6185143,3838313,484097920,0,9131,1708885,9109,1705390,22,3495,2351,16,5313,40,0,60,216660.0,130000.0,-47.0,-35.0,-39.0,-44.0,-41.0,-36.0,-44.0,-50.0,-84.0,-82.0,-79.0,-80.0,37.0,47.0,40.0,36.0,1
6785,62:47:05:9D:EB:15,3839503,484843788,1186,745464,3838317,484098324,0,3223,2805259,3202,2801645,21,3614,1671,0,1223,38,0,97,229410.0,137640.0,-46.0,-47.0,-46.0,-44.0,-47.0,-48.0,-45.0,-46.0,-84.0,-82.0,-79.0,-80.0,38.0,35.0,33.0,36.0,1
6786,3C:55:76:E8:8F:1F,3906951,656379179,68634,172280855,3838317,484098324,24,30754,6593358,30371,6526768,383,66590,13529,35,68706,7016,24,390,135410.0,48750.0,-44.0,-50.0,-53.0,-42.0,-44.0,-50.0,-52.0,-42.0,-84.0,-82.0,-79.0,-80.0,40.0,32.0,26.0,38.0,1
6787,92:69:1D:31:68:E9,3842264,487727004,3947,3628680,3838317,484098324,0,4919,1115967,4770,1082187,149,33780,2136,11,4166,90,0,48,216660.0,130000.0,-52.0,-48.0,-43.0,-46.0,-52.0,-48.0,-43.0,-48.0,-84.0,-82.0,-79.0,-80.0,32.0,34.0,36.0,34.0,1
6788,CC:2F:71:3F:1F:24,4718027,1443750420,879710,959652096,3838317,484098324,37,718865,767403056,718124,767313950,741,89106,692918,15,879967,92412,34,545,144444.0,43333.0,-69.0,-67.0,-67.0,-68.0,-69.0,-66.0,-67.0,-67.0,-84.0,-82.0,-79.0,-80.0,15.0,15.0,12.0,12.0,1
6789,CC:2F:71:3E:C5:1F,3839218,484208340,901,110016,3838317,484098324,0,3760,315778,3102,237690,658,78088,954,11,1294,23,0,47,130000.0,39000.0,-71.0,-71.0,-68.0,-61.0,-70.0,-71.0,-68.0,-61.0,-84.0,-82.0,-79.0,-80.0,13.0,11.0,11.0,19.0,1
6790,BA:8C:B9:54:50:24,3843174,490283467,4857,6185143,3838317,484098324,0,9131,1708885,9109,1705390,22,3495,2351,16,5313,40,0,60,216660.0,130000.0,-47.0,-35.0,-39.0,-44.0,-41.0,-36.0,-44.0,-50.0,-84.0,-82.0,-79.0,-80.0,37.0,47.0,40.0,36.0,1
6791,62:47:05:9D:EB:15,3839507,484844242,1188,745716,3838319,484098526,0,3235,2806200,3214,2802586,21,3614,1673,0,1225,38,0,97,216660.0,130000.0,-49.0,-52.0,-51.0,-50.0,-49.0,-51.0,-50.0,-50.0,-84.0,-82.0,-79.0,-80.0,35.0,30.0,28.0,30.0,1
6792,3C:55:76:E8:8F:1F,3906955,656379583,68634,172280855,3838321,484098728,24,30754,6593358,30371,6526768,383,66590,13529,35,68706,7016,24,390,135410.0,48750.0,-44.0,-50.0,-53.0,-42.0,-44.0,-50.0,-52.0,-42.0,-84.0,-82.0,-79.0,-80.0,40.0,32.0,26.0,38.0,1
6793,92:69:1D:31:68:E9,3842268,487727408,3947,3628680,3838321,484098728,0,4919,1115967,4770,1082187,149,33780,2136,11,4166,90,0,48,216660.0,130000.0,-52.0,-48.0,-43.0,-46.0,-52.0,-48.0,-43.0,-48.0,-84.0,-82.0,-79.0,-80.0,32.0,34.0,36.0,34.0,1
6794,CC:2F:71:3F:1F:24,4718246,1444014664,879922,959915600,3838324,484099064,37,719056,767656434,718315,767567328,741,89106,693104,15,880179,92459,34,545,130000.0,43333.0,-69.0,-67.0,-68.0,-69.0,-69.0,-66.0,-68.0,-68.0,-84.0,-82.0,-79.0,-80.0,15.0,15.0,11.0,11.0,1
6795,CC:2F:71:3E:C5:1F,3839227,484209208,901,110016,3838326,484099192,0,3760,315778,3102,237690,658,78088,954,11,1294,23,0,47,130000.0,39000.0,-71.0,-71.0,-68.0,-61.0,-70.0,-71.0,-68.0,-61.0,-84.0,-82.0,-79.0,-80.0,13.0,11.0,11.0,19.0,1
6796,BA:8C:B9:54:50:24,3843183,490284335,4857,6185143,3838326,484099192,0,9131,1708885,9109,1705390,22,3495,2351,16,5313,40,0,60,216660.0,130000.0,-47.0,-35.0,-39.0,-44.0,-41.0,-36.0,-44.0,-50.0,-84.0,-82.0,-79.0,-80.0,37.0,47.0,40.0,36.0,1
6797,62:47:05:9D:EB:15,3839514,484844908,1188,745716,3838326,484099192,0,3239,2806472,3218,2802858,21,3614,1673,0,1225,38,0,97,216660.0,130000.0,-48.0,-48.0,-47.0,-46.0,-49.0,-51.0,-50.0,-49.0,-84.0,-82.0,-79.0,-80.0,36.0,34.0,32.0,34.0,1
6798,3C:55:76:E8:8F:1F,3906960,656380047,68634,172280855,3838326,484099192,24,30756,6593567,30373,6526977,383,66590,13530,35,68706,7016,24,390,135410.0,48750.0,-44.0,-49.0,-42.0,-43.0,-44.0,-49.0,-50.0,-42.0,-84.0,-82.0,-79.0,-80.0,40.0,33.0,37.0,37.0,1
6799,92:69:1D:31:68:E9,3842273,487727872,3947,3628680,3838326,484099192,0,4919,1115967,4770,1082187,149,33780,2136,11,4166,90,0,48,216660.0,130000.0,-52.0,-48.0,-43.0,-46.0,-52.0,-48.0,-43.0,-48.0,-84.0,-82.0,-79.0,-80.0,32.0,34.0,36.0,34.0,1
6800,CC:2F:71:3F:1F:24,4718459,1444278222,880133,960179030,3838326,484099192,37,719249,767907386,718508,767818280,741,89106,693291,15,880390,92461,34,545,130000.0,43333.0,-69.0,-67.0,-67.0,-70.0,-69.0,-67.0,-67.0,-69.0,-84.0,-82.0,-79.0,-80.0,15.0,15.0,12.0,10.0,1
6801,CC:2F:71:3E:C5:1F,3839227,484209208,901,110016,3838326,484099192,0,3760,315778,3102,237690,658,78088,954,11,1294,23,0,47,130000.0,39000.0,-71.0,-71.0,-68.0,-61.0,-70.0,-71.0,-68.0,-61.0,-84.0,-82.0,-79.0,-80.0,13.0,11.0,11.0,19.0,1
6802,BA:8C:B9:54:50:24,3843185,490284537,4857,6185143,3838328,484099394,0,9131,1708885,9109,1705390,22,3495,2351,16,5313,40,0,60,216660.0,130000.0,-47.0,-35.0,-39.0,-44.0,-41.0,-36.0,-44.0,-50.0,-84.0,-82.0,-79.0,-80.0,37.0,47.0,40.0,36.0,1
6803,62:47:05:9D:EB:15,3839518,484845312,1188,745716,3838330,484099596,0,3239,2806472,3218,2802858,21,3614,1673,0,1225,38,0,97,216660.0,130000.0,-48.0,-48.0,-47.0,-46.0,-49.0,-51.0,-50.0,-49.0,-84.0,-82.0,-79.0,-80.0,36.0,34.0,32.0,34.0,1
6804,3C:55:76:E8:8F:1F,3906969,656380948,68635,172280948,3838334,484100000,24,30764,6594149,30381,6527559,383,66590,13531,35,68707,7016,24,390,146250.0,48750.0,-46.0,-49.0,-44.0,-45.0,-44.0,-49.0,-43.0,-44.0,-84.0,-82.0,-79.0,-80.0,38.0,33.0,35.0,35.0,1
6805,92:69:1D:31:68:E9,3842281,487728680,3947,3628680,3838334,484100000,0,4919,1115967,4770,1082187,149,33780,2136,11,4166,90,0,48,216660.0,130000.0,-52.0,-48.0,-43.0,-46.0,-52.0,-48.0,-43.0,-48.0,-84.0,-82.0,-79.0,-80.0,32.0,34.0,36.0,34.0,1
6806,CC:2F:71:3F:1F:24,4718683,1444545447,880349,960445447,3838334,484100000,37,719445,768161821,718704,768072715,741,89106,693483,15,880606,92473,34,545,130000.0,43333.0,-69.0,-67.0,-68.0,-68.0,-69.0,-67.0,-67.0,-68.0,-84.0,-82.0,-79.0,-80.0,15.0,15.0,11.0,12.0,1
6807,CC:2F:71:3E:C5:1F,3839235,484210016,901,110016,3838334,484100000,0,3760,315778,3102,237690,658,78088,954,11,1294,23,0,47,130000.0,39000.0,-71.0,-71.0,-68.0,-61.0,-70.0,-71.0,-68.0,-61.0,-84.0,-82.0,-79.0,-80.0,13.0,11.0,11.0,19.0,1
6808,BA:8C:B9:54:50:24,3843191,490285143,4857,6185143,3838334,484100000,0,9131,1708885,9109,1705390,22,3495,2351,16,5313,40,0,60,216660.0,130000.0,-47.0,-35.0,-39.0,-44.0,-41.0,-36.0,-44.0,-50.0,-84.0,-82.0,-79.0,-80.0,37.0,47.0,40.0,36.0,1
6809,62:47:05:9D:EB:15,3839727,485198987,1392,1098927,3838335,484100060,0,3401,2867647,3380,2864033,21,3614,1781,0,1429,39,0,97,229410.0,137640.0,-51.0,-50.0,-50.0,-49.0,-49.0,-49.0,-50.0,-48.0,-84.0,-82.0,-79.0,-80.0,33.0,32.0,29.0,31.0,1
6810,3C:55:76:E8:8F:1F,3906973,656381384,68636,172281122,3838337,484100262,24,30771,6594753,30388,6528163,383,66590,13533,35,68708,7016,24,390,146250.0,48750.0,-42.0,-49.0,-51.0,-40.0,-43.0,-49.0,-48.0,-41.0,-84.0,-82.0,-79.0,-80.0,42.0,33.0,28.0,40.0,1
6811,92:69:1D:31:68:E9,3842285,487729068,3947,3628680,3838338,484100388,0,4919,1115967,4770,1082187,149,33780,2136,11,4166,90,0,48,216660.0,130000.0,-52.0,-48.0,-43.0,-46.0,-52.0,-48.0,-43.0,-48.0,-84.0,-82.0,-79.0,-80.0,32.0,34.0,36.0,34.0,1
6812,CC:2F:71:3F:1F:24,4718902,1444812448,880564,960712060,3838338,484100388,37,719643,768421884,718902,768332778,741,89106,693673,15,880821,92479,34,545,130000.0,43333.0,-70.0,-67.0,-68.0,-69.0,-69.0,-66.0,-68.0,-68.0,-84.0,-82.0,-79.0,-80.0,14.0,15.0,11.0,11.0,1
6813,CC:2F:71:3E:C5:1F,3839239,484210404,901,110016,3838338,484100388,0,3760,315778,3102,237690,658,78088,954,11,1294,23,0,47,130000.0,39000.0,-71.0,-71.0,-68.0,-61.0,-70.0,-71.0,-68.0,-61.0,-84.0,-82.0,-79.0,-80.0,13.0,11.0,11.0,19.0,1
6814,BA:8C:B9:54:50:24,3843195,490285531,4857,6185143,3838338,484100388,0,9131,1708885,9109,1705390,22,3495,2351,16,5313,40,0,60,216660.0,130000.0,-47.0,-35.0,-39.0,-44.0,-41.0,-36.0,-44.0,-50.0,-84.0,-82.0,-79.0,-80.0,37.0,47.0,40.0,36.0,1
6815,62:47:05:9D:EB:15,3839744,485207283,1400,1106289,3838344,484100994,0,3429,2869946,3408,2866332,21,3614,1786,0,1437,39,0,97,229410.0,137640.0,-49.0,-49.0,-53.0,-45.0,-49.0,-49.0,-52.0,-45.0,-84.0,-82.0,-79.0,-80.0,35.0,33.0,26.0,35.0,1
6816,3C:55:76:E8:8F:1F,3906980,656382116,68636,172281122,3838344,484100994,24,30774,6594959,30391,6528369,383,66590,13533,35,68708,7016,24,390,146250.0,48750.0,-43.0,-50.0,-52.0,-41.0,-42.0,-49.0,-50.0,-41.0,-84.0,-82.0,-79.0,-80.0,41.0,32.0,27.0,39.0,1
6817,92:69:1D:31:68:E9,3842291,487729674,3947,3628680,3838344,484100994,0,4919,1115967,4770,1082187,149,33780,2136,11,4166,90,0,48,216660.0,130000.0,-52.0,-48.0,-43.0,-46.0,-52.0,-48.0,-43.0,-48.0,-84.0,-82.0,-79.0,-80.0,32.0,34.0,36.0,34.0,1
6818,CC:2F:71:3F:1F:24,4719120,1445079238,880776,960978244,3838344,484100994,37,719837,768677346,719096,768588240,741,89106,693860,15,881033,92486,34,545,130000.0,43333.0,-69.0,-67.0,-68.0,-69.0,-69.0,-66.0,-68.0,-68.0,-84.0,-82.0,-79.0,-80.0,15.0,15.0,11.0,11.0,1
6819,CC:2F:71:3E:C5:1F,3839245,484211010,901,110016,3838344,484100994,0,3760,315778,3102,237690,658,78088,954,11,1294,23,0,47,130000.0,39000.0,-71.0,-71.0,-68.0,-61.0,-70.0,-71.0,-68.0,-61.0,-84.0,-82.0,-79.0,-80.0,13.0,11.0,11.0,19.0,1
6820,BA:8C:B9:54:50:24,3843201,490286137,4857,6185143,3838344,484100994,0,9131,1708885,9109,1705390,22,3495,2351,16,5313,40,0,60,216660.0,130000.0,-47.0,-35.0,-39.0,-44.0,-41.0,-36.0,-44.0,-50.0,-84.0,-82.0,-79.0,-80.0,37.0,47.0,40.0,36.0,1
6821,62:47:05:9D:EB:15,3839864,485489263,1517,1388007,3838347,484101256,0,3442,2872873,3421,2869259,21,3614,1796,0,1554,39,0,97,229410.0,137640.0,-50.0,-51.0,-50.0,-48.0,-50.0,-50.0,-50.0,-48.0,-84.0,-82.0,-79.0,-80.0,34.0,31.0,29.0,32.0,1
6822,3C:55:76:E8:8F:1F,3906991,656386546,68644,172285290,3838347,484101256,24,30799,6601722,30416,6535132,383,66590,13542,35,68716,7016,24,390,146250.0,48750.0,-46.0,-51.0,-45.0,-46.0,-45.0,-50.0,-44.0,-45.0,-84.0,-82.0,-79.0,-80.0,38.0,31.0,34.0,34.0,1
6823,92:69:1D:31:68:E9,3842294,487729936,3947,3628680,3838347,484101256,0,4920,1116035,4771,1082255,149,33780,2136,11,4166,90,0,48,216660.0,130000.0,-52.0,-48.0,-42.0,-48.0,-52.0,-48.0,-43.0,-48.0,-84.0,-82.0,-79.0,-80.0,32.0,34.0,37.0,32.0,1
6824,CC:2F:71:3F:1F:24,4719349,1445349271,881002,961248015,3838347,484101256,37,720054,768942361,719313,768853255,741,89106,694065,15,881259,92486,34,545,130000.0,43333.0,-69.0,-67.0,-68.0,-69.0,-69.0,-67.0,-68.0,-68.0,-84.0,-82.0,-79.0,-80.0,15.0,15.0,11.0,11.0,1
6825,CC:2F:71:3E:C5:1F,3839250,484211474,901,110016,3838349,484101458,0,3760,315778,3102,237690,658,78088,954,11,1294,23,0,47,130000.0,39000.0,-71.0,-71.0,-68.0,-61.0,-70.0,-71.0,-68.0,-61.0,-84.0,-82.0,-79.0,-80.0,13.0,11.0,11.0,19.0,1
6826,BA:8C:B9:54:50:24,3843206,490286601,4857,6185143,3838349,484101458,0,9131,1708885,9109,1705390,22,3495,2351,16,5313,40,0,60,216660.0,130000.0,-47.0,-35.0,-39.0,-44.0,-41.0,-36.0,-44.0,-50.0,-84.0,-82.0,-79.0,-80.0,37.0,47.0,40.0,36.0,1
6827,62:47:05:9D:EB:15,3839882,485494825,1529,1392963,3838353,484101862,0,3491,2896879,3470,2893265,21,3614,1813,0,1566,39,0,97,229410.0,137640.0,-47.0,-46.0,-48.0,-44.0,-51.0,-50.0,-49.0,-48.0,-84.0,-82.0,-79.0,-80.0,37.0,36.0,31.0,36.0,1
6828,3C:55:76:E8:8F:1F,3906997,656387152,68644,172285290,3838353,484101862,24,30799,6601722,30416,6535132,383,66590,13542,35,68716,7016,24,390,146250.0,48750.0,-46.0,-51.0,-45.0,-46.0,-45.0,-50.0,-44.0,-45.0,-84.0,-82.0,-79.0,-80.0,38.0,31.0,34.0,34.0,1
6829,92:69:1D:31:68:E9,3842300,487730542,3947,3628680,3838353,484101862,0,4920,1116035,4771,1082255,149,33780,2136,11,4166,90,0,48,216660.0,130000.0,-52.0,-48.0,-42.0,-48.0,-52.0,-48.0,-43.0,-48.0,-84.0,-82.0,-79.0,-80.0,32.0,34.0,37.0,32.0,1
6830,CC:2F:71:3F:1F:24,4719564,1445612935,881211,961511073,3838353,484101862,37,720246,769196041,719505,769106935,741,89106,694249,15,881468,92491,34,545,117000.0,39000.0,-69.0,-67.0,-68.0,-68.0,-69.0,-67.0,-67.0,-68.0,-84.0,-82.0,-79.0,-80.0,15.0,15.0,11.0,12.0,1
6831,CC:2F:71:3E:C5:1F,3839254,484211878,901,110016,3838353,484101862,0,3760,315778,3102,237690,658,78088,954,11,1294,23,0,47,130000.0,39000.0,-71.0,-71.0,-68.0,-61.0,-70.0,-71.0,-68.0,-61.0,-84.0,-82.0,-79.0,-80.0,13.0,11.0,11.0,19.0,1
6832,BA:8C:B9:54:50:24,3843210,490287005,4857,6185143,3838353,484101862,0,9131,1708885,9109,1705390,22,3495,2351,16,5313,40,0,60,216660.0,130000.0,-47.0,-35.0,-39.0,-44.0,-41.0,-36.0,-44.0,-50.0,-84.0,-82.0,-79.0,-80.0,37.0,47.0,40.0,36.0,1
6833,62:47:05:9D:EB:15,3839888,485495861,1531,1393595,3838357,484102266,0,3506,2897990,3485,2894376,21,3614,1814,0,1568,39,0,97,229410.0,137640.0,-48.0,-47.0,-49.0,-43.0,-47.0,-47.0,-47.0,-44.0,-84.0,-82.0,-79.0,-80.0,36.0,35.0,30.0,37.0,1
6834,3C:55:76:E8:8F:1F,3907002,656387616,68644,172285290,3838358,484102326,24,30799,6601722,30416,6535132,383,66590,13542,35,68716,7016,24,390,146250.0,48750.0,-46.0,-51.0,-45.0,-46.0,-45.0,-50.0,-44.0,-45.0,-84.0,-82.0,-79.0,-80.0,38.0,31.0,34.0,34.0,1
6835,92:69:1D:31:68:E9,3842305,487731006,3947,3628680,3838358,484102326,0,4920,1116035,4771,1082255,149,33780,2136,11,4166,90,0,48,216660.0,130000.0,-52.0,-48.0,-42.0,-48.0,-52.0,-48.0,-43.0,-48.0,-84.0,-82.0,-79.0,-80.0,32.0,34.0,37.0,32.0,1
6836,CC:2F:71:3F:1F:24,4719785,1445885687,881427,961783361,3838358,484102326,37,720440,769455547,719699,769366441,741,89106,694439,15,881684,92494,34,545,130000.0,43333.0,-69.0,-67.0,-68.0,-69.0,-69.0,-67.0,-68.0,-68.0,-84.0,-82.0,-79.0,-80.0,15.0,15.0,11.0,11.0,1
6837,CC:2F:71:3E:C5:1F,3839259,484212342,901,110016,3838358,484102326,0,3760,315778,3102,237690,658,78088,954,11,1294,23,0,47,130000.0,39000.0,-71.0,-71.0,-68.0,-61.0,-70.0,-71.0,-68.0,-61.0,-84.0,-82.0,-79.0,-80.0,13.0,11.0,11.0,19.0,1
6838,BA:8C:B9:54:50:24,3843215,490287469,4857,6185143,3838358,484102326,0,9131,1708885,9109,1705390,22,3495,2351,16,5313,40,0,60,216660.0,130000.0,-47.0,-35.0,-39.0,-44.0,-41.0,-36.0,-44.0,-50.0,-84.0,-82.0,-79.0,-80.0,37.0,47.0,40.0,36.0,1
6839,62:47:05:9D:EB:15,3839893,485496325,1531,1393595,3838362,484102730,0,3506,2897990,3485,2894376,21,3614,1814,0,1568,39,0,97,229410.0,137640.0,-48.0,-47.0,-49.0,-43.0,-47.0,-47.0,-47.0,-44.0,-84.0,-82.0,-79.0,-80.0,36.0,35.0,30.0,37.0,1
6840,3C:55:76:E8:8F:1F,3907007,656388136,68645,172285406,3838362,484102730,24,30804,6602064,30421,6535474,383,66590,13542,35,68717,7016,24,390,146250.0,48750.0,-44.0,-49.0,-42.0,-43.0,-44.0,-49.0,-43.0,-43.0,-84.0,-82.0,-79.0,-80.0,40.0,33.0,37.0,37.0,1
6841,92:69:1D:31:68:E9,3842310,487731526,3948,3628796,3838362,484102730,0,4922,1116171,4773,1082391,149,33780,2136,11,4167,90,0,48,216660.0,130000.0,-52.0,-47.0,-42.0,-48.0,-51.0,-47.0,-42.0,-47.0,-84.0,-82.0,-79.0,-80.0,32.0,35.0,37.0,32.0,1
6842,CC:2F:71:3F:1F:24,4720001,1446149637,881639,962046907,3838362,484102730,37,720635,769715311,719894,769626205,741,89106,694624,15,881896,92495,34,545,130000.0,43333.0,-70.0,-67.0,-68.0,-68.0,-69.0,-66.0,-68.0,-68.0,-84.0,-82.0,-79.0,-80.0,14.0,15.0,11.0,12.0,1
6843,CC:2F:71:3E:C5:1F,3839266,484213064,902,110132,3838364,484102932,0,3762,315918,3104,237830,658,78088,954,11,1295,23,0,47,130000.0,39000.0,-71.0,-71.0,-68.0,-61.0,-71.0,-71.0,-68.0,-61.0,-84.0,-82.0,-79.0,-80.0,13.0,11.0,11.0,19.0,1
6844,BA:8C:B9:54:50:24,3843222,490288135,4858,6185203,3838364,484102932,0,9133,1709021,9111,1705526,22,3495,2351,16,5314,40,0,60,216660.0,130000.0,-39.0,-36.0,-45.0,-52.0,-41.0,-36.0,-44.0,-50.0,-84.0,-82.0,-79.0,-80.0,45.0,46.0,34.0,28.0,1
6845,62:47:05:9D:EB:15,3839923,485517929,1557,1414795,3838366,484103134,0,3565,2909031,3544,2905417,21,3614,1840,0,1594,39,0,97,229410.0,137640.0,-52.0,-51.0,-50.0,-50.0,-49.0,-49.0,-49.0,-48.0,-84.0,-82.0,-79.0,-80.0,32.0,31.0,29.0,30.0,1
6846,3C:55:76:E8:8F:1F,3907011,656388540,68645,172285406,3838366,484103134,24,30807,6602270,30424,6535680,383,66590,13542,35,68717,7016,24,390,146250.0,48750.0,-46.0,-51.0,-45.0,-46.0,-44.0,-49.0,-43.0,-44.0,-84.0,-82.0,-79.0,-80.0,38.0,31.0,34.0,34.0,1
6847,92:69:1D:31:68:E9,3842314,487731930,3948,3628796,3838366,484103134,0,4922,1116171,4773,1082391,149,33780,2136,11,4167,90,0,48,216660.0,130000.0,-52.0,-47.0,-42.0,-48.0,-51.0,-47.0,-42.0,-47.0,-84.0,-82.0,-79.0,-80.0,32.0,35.0,37.0,32.0,1
6848,CC:2F:71:3F:1F:24,4720222,1446416604,881856,962313470,3838366,484103134,37,720840,769982294,720099,769893188,741,89106,694817,15,882113,92499,34,545,130000.0,43333.0,-70.0,-67.0,-68.0,-68.0,-69.0,-67.0,-68.0,-68.0,-84.0,-82.0,-79.0,-80.0,14.0,15.0,11.0,12.0,1
6849,CC:2F:71:3E:C5:1F,3839272,484213670,902,110132,3838370,484103538,0,3762,315918,3104,237830,658,78088,954,11,1295,23,0,47,130000.0,39000.0,-71.0,-71.0,-68.0,-61.0,-71.0,-71.0,-68.0,-61.0,-84.0,-82.0,-79.0,-80.0,13.0,11.0,11.0,19.0,1
6850,BA:8C:B9:54:50:24,3843228,490288741,4858,6185203,3838370,484103538,0,9133,1709021,9111,1705526,22,3495,2351,16,5314,40,0,60,216660.0,130000.0,-39.0,-36.0,-45.0,-52.0,-41.0,-36.0,-44.0,-50.0,-84.0,-82.0,-79.0,-80.0,45.0,46.0,34.0,28.0,1
6851,62:47:05:9D:EB:15,3839941,485531843,1567,1427799,3838374,484104044,0,3612,2913266,3590,2909481,22,3785,1847,0,1604,39,0,97,229410.0,137640.0,-53.0,-52.0,-53.0,-52.0,-52.0,-51.0,-52.0,-51.0,-84.0,-82.0,-79.0,-80.0,31.0,30.0,26.0,28.0,1
6852,3C:55:76:E8:8F:1F,3907021,656389652,68645,172285406,3838376,484104246,24,30807,6602270,30424,6535680,383,66590,13542,35,68717,7016,24,390,146250.0,48750.0,-46.0,-51.0,-45.0,-46.0,-44.0,-49.0,-43.0,-44.0,-84.0,-82.0,-79.0,-80.0,38.0,31.0,34.0,34.0,1
6853,92:69:1D:31:68:E9,3842324,487733042,3948,3628796,3838376,484104246,0,4922,1116171,4773,1082391,149,33780,2136,11,4167,90,0,48,216660.0,130000.0,-52.0,-47.0,-42.0,-48.0,-51.0,-47.0,-42.0,-47.0,-84.0,-82.0,-79.0,-80.0,32.0,35.0,37.0,32.0,1
6854,CC:2F:71:3F:1F:24,4720439,1446677764,882063,962573518,3838376,484104246,37,721036,770239286,720294,770150062,742,89224,695001,15,882320,92499,34,545,130000.0,43333.0,-69.0,-67.0,-68.0,-69.0,-69.0,-67.0,-67.0,-68.0,-84.0,-82.0,-79.0,-80.0,15.0,15.0,11.0,11.0,1
6855,CC:2F:71:3E:C5:1F,3839278,484214378,902,110132,3838376,484104246,0,3762,315918,3104,237830,658,78088,954,11,1295,23,0,47,130000.0,39000.0,-71.0,-71.0,-68.0,-61.0,-71.0,-71.0,-68.0,-61.0,-84.0,-82.0,-79.0,-80.0,13.0,11.0,11.0,19.0,1
6856,BA:8C:B9:54:50:24,3843234,490289449,4858,6185203,3838376,484104246,0,9133,1709021,9111,1705526,22,3495,2351,16,5314,40,0,60,216660.0,130000.0,-39.0,-36.0,-45.0,-52.0,-41.0,-36.0,-44.0,-50.0,-84.0,-82.0,-79.0,-80.0,45.0,46.0,34.0,28.0,1
6857,62:47:05:9D:EB:15,3839947,485532702,1569,1428254,3838378,484104448,0,3644,2916025,3622,2912240,22,3785,1851,0,1606,39,0,98,229410.0,137640.0,-53.0,-51.0,-51.0,-51.0,-53.0,-50.0,-50.0,-50.0,-84.0,-82.0,-79.0,-80.0,31.0,31.0,28.0,29.0,1
6858,3C:55:76:E8:8F:1F,3907027,656390258,68645,172285406,3838382,484104852,24,30807,6602270,30424,6535680,383,66590,13542,35,68717,7016,24,390,146250.0,48750.0,-46.0,-51.0,-45.0,-46.0,-44.0,-49.0,-43.0,-44.0,-84.0,-82.0,-79.0,-80.0,38.0,31.0,34.0,34.0,1
6859,92:69:1D:31:68:E9,3842330,487733648,3948,3628796,3838382,484104852,0,4922,1116171,4773,1082391,149,33780,2136,11,4167,90,0,48,216660.0,130000.0,-52.0,-47.0,-42.0,-48.0,-51.0,-47.0,-42.0,-47.0,-84.0,-82.0,-79.0,-80.0,32.0,35.0,37.0,32.0,1
6860,CC:2F:71:3F:1F:24,4720655,1446941462,882273,962836610,3838382,484104852,37,721227,770488378,720485,770399154,742,89224,695188,15,882530,92505,34,545,130000.0,43333.0,-69.0,-67.0,-67.0,-68.0,-69.0,-67.0,-68.0,-68.0,-84.0,-82.0,-79.0,-80.0,15.0,15.0,12.0,12.0,1
6861,CC:2F:71:3E:C5:1F,3839284,484214984,902,110132,3838382,484104852,0,3762,315918,3104,237830,658,78088,954,11,1295,23,0,47,130000.0,39000.0,-71.0,-71.0,-68.0,-61.0,-71.0,-71.0,-68.0,-61.0,-84.0,-82.0,-79.0,-80.0,13.0,11.0,11.0,19.0,1
6862,BA:8C:B9:54:50:24,3843240,490290055,4858,6185203,3838382,484104852,0,9133,1709021,9111,1705526,22,3495,2351,16,5314,40,0,60,216660.0,130000.0,-39.0,-36.0,-45.0,-52.0,-41.0,-36.0,-44.0,-50.0,-84.0,-82.0,-79.0,-80.0,45.0,46.0,34.0,28.0,1
6863,62:47:05:9D:EB:15,3839955,485533430,1569,1428254,3838386,484105176,0,3666,2917575,3643,2913668,23,3907,1852,0,1606,39,0,99,229410.0,137640.0,-49.0,-47.0,-48.0,-46.0,-48.0,-46.0,-47.0,-46.0,-84.0,-82.0,-79.0,-80.0,35.0,35.0,31.0,34.0,1
6864,3C:55:76:E8:8F:1F,3907031,656390582,68645,172285406,3838386,484105176,24,30807,6602270,30424,6535680,383,66590,13542,35,68717,7016,24,390,146250.0,48750.0,-46.0,-51.0,-45.0,-46.0,-44.0,-49.0,-43.0,-44.0,-84.0,-82.0,-79.0,-80.0,38.0,31.0,34.0,34.0,1
6865,92:69:1D:31:68:E9,3842334,487733972,3948,3628796,3838386,484105176,0,4922,1116171,4773,1082391,149,33780,2136,11,4167,90,0,48,216660.0,130000.0,-52.0,-47.0,-42.0,-48.0,-51.0,-47.0,-42.0,-47.0,-84.0,-82.0,-79.0,-80.0,32.0,35.0,37.0,32.0,1
6866,CC:2F:71:3F:1F:24,4720876,1447208557,882490,963103381,3838386,484105176,37,721425,770742148,720683,770652924,742,89224,695381,15,882747,92505,34,546,130000.0,43333.0,-69.0,-66.0,-68.0,-68.0,-69.0,-66.0,-68.0,-68.0,-84.0,-82.0,-79.0,-80.0,15.0,16.0,11.0,12.0,1
6867,CC:2F:71:3E:C5:1F,3839290,484215510,902,110132,3838388,484105378,0,3762,315918,3104,237830,658,78088,954,11,1295,23,0,47,130000.0,39000.0,-71.0,-71.0,-68.0,-61.0,-71.0,-71.0,-68.0,-61.0,-84.0,-82.0,-79.0,-80.0,13.0,11.0,11.0,19.0,1
6868,BA:8C:B9:54:50:24,3843246,490290581,4858,6185203,3838388,484105378,0,9133,1709021,9111,1705526,22,3495,2351,16,5314,40,0,60,216660.0,130000.0,-39.0,-36.0,-45.0,-52.0,-41.0,-36.0,-44.0,-50.0,-84.0,-82.0,-79.0,-80.0,45.0,46.0,34.0,28.0,1
6869,62:47:05:9D:EB:15,3839963,485534404,1569,1428254,3838394,484106150,0,3666,2917575,3643,2913668,23,3907,1852,0,1606,39,0,99,229410.0,137640.0,-49.0,-47.0,-48.0,-46.0,-48.0,-46.0,-47.0,-46.0,-84.0,-82.0,-79.0,-80.0,35.0,35.0,31.0,34.0,1
6870,3C:55:76:E8:8F:1F,3907039,656391556,68645,172285406,3838394,484106150,24,30807,6602270,30424,6535680,383,66590,13542,35,68717,7016,24,390,146250.0,48750.0,-46.0,-51.0,-45.0,-46.0,-44.0,-49.0,-43.0,-44.0,-84.0,-82.0,-79.0,-80.0,38.0,31.0,34.0,34.0,1
6871,92:69:1D:31:68:E9,3842342,487734946,3948,3628796,3838394,484106150,0,4922,1116171,4773,1082391,149,33780,2136,11,4167,90,0,48,216660.0,130000.0,-52.0,-47.0,-42.0,-48.0,-51.0,-47.0,-42.0,-47.0,-84.0,-82.0,-79.0,-80.0,32.0,35.0,37.0,32.0,1
6872,CC:2F:71:3F:1F:24,4721094,1447472607,882700,963366457,3838394,484106150,37,721617,770997262,720875,770908038,742,89224,695567,15,882957,92511,34,546,130000.0,43333.0,-69.0,-66.0,-68.0,-68.0,-69.0,-66.0,-68.0,-68.0,-84.0,-82.0,-79.0,-80.0,15.0,16.0,11.0,12.0,1
6873,CC:2F:71:3E:C5:1F,3839296,484216282,902,110132,3838394,484106150,0,3762,315918,3104,237830,658,78088,954,11,1295,23,0,47,130000.0,39000.0,-71.0,-71.0,-68.0,-61.0,-71.0,-71.0,-68.0,-61.0,-84.0,-82.0,-79.0,-80.0,13.0,11.0,11.0,19.0,1
6874,BA:8C:B9:54:50:24,3843252,490291353,4858,6185203,3838394,484106150,0,9133,1709021,9111,1705526,22,3495,2351,16,5314,40,0,60,216660.0,130000.0,-39.0,-36.0,-45.0,-52.0,-41.0,-36.0,-44.0,-50.0,-84.0,-82.0,-79.0,-80.0,45.0,46.0,34.0,28.0,1
6875,62:47:05:9D:EB:15,3839967,485534808,1569,1428254,3838398,484106554,0,3666,2917575,3643,2913668,23,3907,1852,0,1606,39,0,99,229410.0,137640.0,-49.0,-47.0,-48.0,-46.0,-48.0,-46.0,-47.0,-46.0,-84.0,-82.0,-79.0,-80.0,35.0,35.0,31.0,34.0,1
6876,3C:55:76:E8:8F:1F,3907045,656392347,68646,172285733,3838399,484106614,24,30815,6603121,30432,6536531,383,66590,13544,35,68718,7016,24,390,146250.0,48750.0,-43.0,-50.0,-51.0,-41.0,-42.0,-49.0,-49.0,-41.0,-84.0,-82.0,-79.0,-80.0,41.0,32.0,28.0,39.0,1
6877,92:69:1D:31:68:E9,3842347,487735410,3948,3628796,3838399,484106614,0,4922,1116171,4773,1082391,149,33780,2136,11,4167,90,0,48,216660.0,130000.0,-52.0,-47.0,-42.0,-48.0,-51.0,-47.0,-42.0,-47.0,-84.0,-82.0,-79.0,-80.0,32.0,35.0,37.0,32.0,1
6878,CC:2F:71:3F:1F:24,4721311,1447739479,882912,963632865,3838399,484106614,37,721808,771250736,721066,771161512,742,89224,695753,15,883169,92511,34,546,130000.0,43333.0,-70.0,-67.0,-68.0,-69.0,-69.0,-66.0,-68.0,-68.0,-84.0,-83.0,-79.0,-80.0,14.0,16.0,11.0,11.0,1
6879,CC:2F:71:3E:C5:1F,3839301,484216746,902,110132,3838399,484106614,0,3762,315918,3104,237830,658,78088,954,11,1295,23,0,47,130000.0,39000.0,-71.0,-71.0,-68.0,-61.0,-71.0,-71.0,-68.0,-61.0,-84.0,-83.0,-79.0,-80.0,13.0,12.0,11.0,19.0,1
6880,BA:8C:B9:54:50:24,3843257,490291817,4858,6185203,3838399,484106614,0,9133,1709021,9111,1705526,22,3495,2351,16,5314,40,0,60,216660.0,130000.0,-39.0,-36.0,-45.0,-52.0,-41.0,-36.0,-44.0,-50.0,-84.0,-83.0,-79.0,-80.0,45.0,47.0,34.0,28.0,1
6881,62:47:05:9D:EB:15,3839973,485535334,1569,1428254,3838404,484107080,0,3666,2917575,3643,2913668,23,3907,1852,0,1606,39,0,99,229410.0,137640.0,-49.0,-47.0,-48.0,-46.0,-48.0,-46.0,-47.0,-46.0,-84.0,-83.0,-79.0,-80.0,35.0,36.0,31.0,34.0,1
6882,3C:55:76:E8:8F:1F,3907051,656392987,68647,172285907,3838404,484107080,24,30829,6604253,30445,6537545,384,66708,13547,35,68719,7016,24,390,154850.0,48750.0,-46.0,-51.0,-45.0,-46.0,-45.0,-49.0,-44.0,-45.0,-84.0,-83.0,-79.0,-80.0,38.0,32.0,34.0,34.0,1
6883,92:69:1D:31:68:E9,3842352,487735876,3948,3628796,3838404,484107080,0,4922,1116171,4773,1082391,149,33780,2136,11,4167,90,0,48,216660.0,130000.0,-52.0,-47.0,-42.0,-48.0,-51.0,-47.0,-42.0,-47.0,-84.0,-83.0,-79.0,-80.0,32.0,36.0,37.0,32.0,1
6884,CC:2F:71:3F:1F:24,4721525,1448000267,883121,963893187,3838404,484107080,37,721998,771499886,721256,771410662,742,89224,695938,15,883378,92512,34,546,130000.0,43333.0,-69.0,-67.0,-68.0,-68.0,-69.0,-67.0,-68.0,-68.0,-84.0,-83.0,-79.0,-80.0,15.0,16.0,11.0,12.0,1
6885,CC:2F:71:3E:C5:1F,3839306,484217212,902,110132,3838404,484107080,0,3762,315918,3104,237830,658,78088,954,11,1295,23,0,47,130000.0,39000.0,-71.0,-71.0,-68.0,-61.0,-71.0,-71.0,-68.0,-61.0,-84.0,-83.0,-79.0,-80.0,13.0,12.0,11.0,19.0,1
6886,BA:8C:B9:54:50:24,3843262,490292283,4858,6185203,3838404,484107080,0,9133,1709021,9111,1705526,22,3495,2351,16,5314,40,0,60,216660.0,130000.0,-39.0,-36.0,-45.0,-52.0,-41.0,-36.0,-44.0,-50.0,-84.0,-83.0,-79.0,-80.0,45.0,47.0,34.0,28.0,1
6887,62:47:05:9D:EB:15,3839978,485535800,1569,1428254,3838409,484107546,0,3666,2917575,3643,2913668,23,3907,1852,0,1606,39,0,99,229410.0,137640.0,-49.0,-47.0,-48.0,-46.0,-48.0,-46.0,-47.0,-46.0,-84.0,-83.0,-79.0,-80.0,35.0,36.0,31.0,34.0,1
6888,3C:55:76:E8:8F:1F,3907056,656393453,68647,172285907,3838409,484107546,24,30829,6604253,30445,6537545,384,66708,13547,35,68719,7016,24,390,154850.0,48750.0,-46.0,-51.0,-45.0,-46.0,-45.0,-49.0,-44.0,-45.0,-84.0,-83.0,-79.0,-80.0,38.0,32.0,34.0,34.0,1
6889,92:69:1D:31:68:E9,3842357,487736342,3948,3628796,3838409,484107546,0,4922,1116171,4773,1082391,149,33780,2136,11,4167,90,0,48,216660.0,130000.0,-52.0,-47.0,-42.0,-48.0,-51.0,-47.0,-42.0,-47.0,-84.0,-83.0,-79.0,-80.0,32.0,36.0,37.0,32.0,1
6890,CC:2F:71:3F:1F:24,4721748,1448267410,883339,964159864,3838409,484107546,37,722200,771752417,721458,771663193,742,89224,696132,15,883596,92517,34,546,130000.0,43333.0,-69.0,-67.0,-68.0,-69.0,-69.0,-67.0,-68.0,-68.0,-84.0,-83.0,-79.0,-80.0,15.0,16.0,11.0,11.0,1
6891,CC:2F:71:3E:C5:1F,3839311,484217678,902,110132,3838409,484107546,0,3764,316106,3105,237900,659,78206,955,11,1295,23,0,47,130000.0,39000.0,-71.0,-71.0,-67.0,-60.0,-70.0,-71.0,-67.0,-60.0,-84.0,-83.0,-79.0,-80.0,13.0,12.0,12.0,20.0,1
6892,BA:8C:B9:54:50:24,3843269,490292951,4858,6185203,3838411,484107748,0,9133,1709021,9111,1705526,22,3495,2351,16,5314,40,0,60,216660.0,130000.0,-39.0,-36.0,-45.0,-52.0,-41.0,-36.0,-44.0,-50.0,-84.0,-83.0,-79.0,-80.0,45.0,47.0,34.0,28.0,1
6893,62:47:05:9D:EB:15,3839988,485537658,1573,1429586,3838415,484108072,0,3707,2921069,3684,2917162,23,3907,1856,0,1610,39,0,100,229410.0,137640.0,-47.0,-46.0,-43.0,-48.0,-47.0,-46.0,-43.0,-46.0,-84.0,-83.0,-79.0,-80.0,37.0,37.0,36.0,32.0,1
6894,3C:55:76:E8:8F:1F,3907063,656394053,68648,172285981,3838415,484108072,24,30837,6604888,30452,6538062,385,66826,13549,35,68720,7016,24,390,154850.0,48750.0,-47.0,-52.0,-45.0,-46.0,-45.0,-50.0,-44.0,-44.0,-84.0,-83.0,-79.0,-80.0,37.0,31.0,34.0,34.0,1
6895,92:69:1D:31:68:E9,3842363,487736868,3948,3628796,3838415,484108072,0,4924,1116307,4775,1082527,149,33780,2136,11,4168,90,0,48,216660.0,130000.0,-51.0,-50.0,-43.0,-46.0,-50.0,-48.0,-42.0,-46.0,-84.0,-83.0,-79.0,-80.0,33.0,33.0,36.0,34.0,1
6896,CC:2F:71:3F:1F:24,4721966,1448531214,883549,964422940,3838417,484108274,37,722393,772006137,721651,771916913,742,89224,696319,15,883806,92526,34,546,130000.0,43333.0,-69.0,-66.0,-68.0,-68.0,-69.0,-66.0,-68.0,-68.0,-84.0,-83.0,-79.0,-80.0,15.0,17.0,11.0,12.0,1
6897,CC:2F:71:3E:C5:1F,3839319,484218406,902,110132,3838417,484108274,0,3764,316106,3105,237900,659,78206,955,11,1295,23,0,47,130000.0,39000.0,-71.0,-71.0,-67.0,-60.0,-70.0,-71.0,-67.0,-60.0,-84.0,-83.0,-79.0,-80.0,13.0,12.0,12.0,20.0,1
6898,BA:8C:B9:54:50:24,3843275,490293477,4858,6185203,3838417,484108274,0,9135,1709157,9113,1705662,22,3495,2351,16,5315,40,0,61,216660.0,130000.0,-39.0,-36.0,-45.0,-52.0,-41.0,-35.0,-44.0,-50.0,-84.0,-83.0,-79.0,-80.0,45.0,47.0,34.0,28.0,1
6899,62:47:05:9D:EB:15,3840003,485548326,1584,1439850,3838419,484108476,0,3720,2926203,3697,2922296,23,3907,1865,0,1621,39,0,100,229410.0,137640.0,-46.0,-44.0,-46.0,-45.0,-49.0,-49.0,-50.0,-50.0,-84.0,-83.0,-79.0,-80.0,38.0,39.0,33.0,35.0,1
6900,3C:55:76:E8:8F:1F,3907069,656394659,68648,172285981,3838421,484108678,24,30838,6604956,30453,6538130,385,66826,13549,35,68720,7016,24,390,154850.0,48750.0,-44.0,-49.0,-42.0,-43.0,-45.0,-50.0,-44.0,-44.0,-84.0,-83.0,-79.0,-80.0,40.0,34.0,37.0,37.0,1
6901,92:69:1D:31:68:E9,3842369,487737474,3948,3628796,3838421,484108678,0,4924,1116307,4775,1082527,149,33780,2136,11,4168,90,0,48,216660.0,130000.0,-51.0,-50.0,-43.0,-46.0,-50.0,-48.0,-42.0,-46.0,-84.0,-83.0,-79.0,-80.0,33.0,33.0,36.0,34.0,1
6902,CC:2F:71:3F:1F:24,4722181,1448795052,883759,964686240,3838422,484108812,37,722585,772261083,721843,772171859,742,89224,696504,15,884014,92528,34,546,130000.0,43333.0,-70.0,-67.0,-68.0,-68.0,-69.0,-67.0,-68.0,-68.0,-84.0,-83.0,-79.0,-80.0,14.0,16.0,11.0,12.0,1
6903,CC:2F:71:3E:C5:1F,3839324,484218944,902,110132,3838422,484108812,0,3764,316106,3105,237900,659,78206,955,11,1295,23,0,47,130000.0,39000.0,-71.0,-71.0,-67.0,-60.0,-70.0,-71.0,-67.0,-60.0,-84.0,-83.0,-79.0,-80.0,13.0,12.0,12.0,20.0,1
6904,BA:8C:B9:54:50:24,3843281,490294083,4858,6185203,3838423,484108880,0,9135,1709157,9113,1705662,22,3495,2351,16,5315,40,0,61,216660.0,130000.0,-39.0,-36.0,-45.0,-52.0,-41.0,-35.0,-44.0,-50.0,-84.0,-83.0,-79.0,-80.0,45.0,47.0,34.0,28.0,1
6905,62:47:05:9D:EB:15,3840381,486485712,1954,2376508,3838427,484109204,0,3777,2934408,3754,2930501,23,3907,1886,0,1991,39,0,101,229410.0,137640.0,-45.0,-43.0,-44.0,-47.0,-45.0,-43.0,-44.0,-47.0,-84.0,-83.0,-79.0,-80.0,39.0,40.0,35.0,33.0,1
6906,3C:55:76:E8:8F:1F,3907075,656395185,68648,172285981,3838427,484109204,24,30848,6605690,30462,6538746,386,66944,13550,35,68720,7016,24,390,154850.0,48750.0,-46.0,-51.0,-45.0,-46.0,-44.0,-49.0,-43.0,-44.0,-84.0,-83.0,-79.0,-80.0,38.0,32.0,34.0,34.0,1
6907,92:69:1D:31:68:E9,3842377,487738202,3948,3628796,3838429,484109406,0,4924,1116307,4775,1082527,149,33780,2136,11,4168,90,0,48,216660.0,130000.0,-51.0,-50.0,-43.0,-46.0,-50.0,-48.0,-42.0,-46.0,-84.0,-83.0,-79.0,-80.0,33.0,33.0,36.0,34.0,1
6908,CC:2F:71:3F:1F:24,4722414,1449077659,883985,964968253,3838429,484109406,37,722794,772532760,722052,772443536,742,89224,696707,15,884242,92541,34,546,144444.0,43333.0,-69.0,-67.0,-68.0,-69.0,-69.0,-67.0,-68.0,-68.0,-84.0,-83.0,-79.0,-80.0,15.0,16.0,11.0,11.0,1
6909,CC:2F:71:3E:C5:1F,3839331,484219538,902,110132,3838429,484109406,0,3764,316106,3105,237900,659,78206,955,11,1295,23,0,47,130000.0,39000.0,-71.0,-71.0,-67.0,-60.0,-70.0,-71.0,-67.0,-60.0,-84.0,-83.0,-79.0,-80.0,13.0,12.0,12.0,20.0,1
6910,BA:8C:B9:54:50:24,3843287,490294609,4858,6185203,3838429,484109406,0,9135,1709157,9113,1705662,22,3495,2351,16,5315,40,0,61,216660.0,130000.0,-39.0,-36.0,-45.0,-52.0,-41.0,-35.0,-44.0,-50.0,-84.0,-83.0,-79.0,-80.0,45.0,47.0,34.0,28.0,1
6911,62:47:05:9D:EB:15,3840387,486486318,1954,2376508,3838433,484109810,0,3815,2938566,3792,2934659,23,3907,1901,0,1991,39,0,104,229410.0,137640.0,-47.0,-42.0,-43.0,-49.0,-49.0,-46.0,-46.0,-51.0,-84.0,-83.0,-79.0,-80.0,37.0,41.0,36.0,31.0,1
6912,3C:55:76:E8:8F:1F,3907082,656395921,68649,172286111,3838433,484109810,24,30857,6606343,30471,6539399,386,66944,13551,35,68721,7016,24,390,154850.0,48750.0,-45.0,-50.0,-45.0,-46.0,-44.0,-49.0,-44.0,-44.0,-84.0,-83.0,-79.0,-80.0,39.0,33.0,34.0,34.0,1
6913,92:69:1D:31:68:E9,3842381,487738606,3948,3628796,3838433,484109810,0,4924,1116307,4775,1082527,149,33780,2136,11,4168,90,0,48,216660.0,130000.0,-51.0,-50.0,-43.0,-46.0,-50.0,-48.0,-42.0,-46.0,-84.0,-83.0,-79.0,-80.0,33.0,33.0,36.0,34.0,1
6914,CC:2F:71:3F:1F:24,4722636,1449356587,884203,965246777,3838433,484109810,37,722998,772800790,722256,772711566,742,89224,696901,15,884460,92554,34,546,130000.0,43333.0,-68.0,-67.0,-67.0,-69.0,-69.0,-66.0,-68.0,-68.0,-84.0,-83.0,-79.0,-80.0,16.0,16.0,12.0,11.0,1
6915,CC:2F:71:3E:C5:1F,3839335,484219942,902,110132,3838433,484109810,0,3764,316106,3105,237900,659,78206,955,11,1295,23,0,47,130000.0,39000.0,-71.0,-71.0,-67.0,-60.0,-70.0,-71.0,-67.0,-60.0,-84.0,-83.0,-79.0,-80.0,13.0,12.0,12.0,20.0,1
6916,BA:8C:B9:54:50:24,3843291,490295013,4858,6185203,3838433,484109810,0,9135,1709157,9113,1705662,22,3495,2351,16,5315,40,0,61,216660.0,130000.0,-39.0,-36.0,-45.0,-52.0,-41.0,-35.0,-44.0,-50.0,-84.0,-83.0,-79.0,-80.0,45.0,47.0,34.0,28.0,1
6917,62:47:05:9D:EB:15,3840395,486487476,1957,2377202,3838438,484110274,0,3840,2945940,3817,2942033,23,3907,1907,0,1994,39,0,104,216660.0,130000.0,-47.0,-42.0,-43.0,-49.0,-45.0,-42.0,-43.0,-47.0,-84.0,-83.0,-79.0,-80.0,37.0,41.0,36.0,31.0,1
6918,3C:55:76:E8:8F:1F,3907088,656396515,68650,172286241,3838438,484110274,24,30866,6606996,30480,6540052,386,66944,13552,35,68722,7016,24,390,154850.0,48750.0,-43.0,-50.0,-52.0,-41.0,-42.0,-49.0,-51.0,-40.0,-84.0,-83.0,-79.0,-80.0,41.0,33.0,27.0,39.0,1
6919,92:69:1D:31:68:E9,3842386,487739070,3948,3628796,3838438,484110274,0,4924,1116307,4775,1082527,149,33780,2136,11,4168,90,0,48,216660.0,130000.0,-51.0,-50.0,-43.0,-46.0,-50.0,-48.0,-42.0,-46.0,-84.0,-83.0,-79.0,-80.0,33.0,33.0,36.0,34.0,1
6920,CC:2F:71:3F:1F:24,4722852,1449620313,884414,965510039,3838438,484110274,37,723199,773064128,722457,772974904,742,89224,697089,15,884671,92566,34,546,130000.0,43333.0,-69.0,-66.0,-68.0,-68.0,-69.0,-66.0,-68.0,-68.0,-84.0,-83.0,-79.0,-80.0,15.0,17.0,11.0,12.0,1
6921,CC:2F:71:3E:C5:1F,3839340,484220406,902,110132,3838438,484110274,0,3764,316106,3105,237900,659,78206,955,11,1295,23,0,47,130000.0,39000.0,-71.0,-71.0,-67.0,-60.0,-70.0,-71.0,-67.0,-60.0,-84.0,-83.0,-79.0,-80.0,13.0,12.0,12.0,20.0,1
6922,BA:8C:B9:54:50:24,3843297,490295750,4858,6185203,3838439,484110547,0,9136,1709225,9114,1705730,22,3495,2351,16,5315,40,0,61,216660.0,130000.0,-39.0,-37.0,-45.0,-52.0,-40.0,-36.0,-44.0,-50.0,-84.0,-83.0,-79.0,-80.0,45.0,46.0,34.0,28.0,1
6923,62:47:05:9D:EB:15,3840400,486488153,1957,2377202,3838443,484110951,0,3840,2945940,3817,2942033,23,3907,1907,0,1994,39,0,104,216660.0,130000.0,-47.0,-42.0,-43.0,-49.0,-45.0,-42.0,-43.0,-47.0,-84.0,-83.0,-79.0,-80.0,37.0,41.0,36.0,31.0,1
6924,3C:55:76:E8:8F:1F,3907093,656397192,68650,172286241,3838443,484110951,24,30866,6606996,30480,6540052,386,66944,13552,35,68722,7016,24,390,154850.0,48750.0,-43.0,-50.0,-52.0,-41.0,-42.0,-49.0,-51.0,-40.0,-84.0,-83.0,-79.0,-80.0,41.0,33.0,27.0,39.0,1
6925,92:69:1D:31:68:E9,3842391,487739747,3948,3628796,3838443,484110951,0,4924,1116307,4775,1082527,149,33780,2136,11,4168,90,0,48,216660.0,130000.0,-51.0,-50.0,-43.0,-46.0,-50.0,-48.0,-42.0,-46.0,-84.0,-83.0,-79.0,-80.0,33.0,33.0,36.0,34.0,1
6926,CC:2F:71:3F:1F:24,4723068,1449885774,884625,965774823,3838443,484110951,37,723394,773319706,722652,773230482,742,89224,697276,15,884882,92566,34,546,130000.0,43333.0,-69.0,-67.0,-68.0,-68.0,-69.0,-66.0,-68.0,-68.0,-84.0,-83.0,-79.0,-80.0,15.0,16.0,11.0,12.0,1
6927,CC:2F:71:3E:C5:1F,3839345,484221083,902,110132,3838443,484110951,0,3764,316106,3105,237900,659,78206,955,11,1295,23,0,47,130000.0,39000.0,-71.0,-71.0,-67.0,-60.0,-70.0,-71.0,-67.0,-60.0,-84.0,-83.0,-79.0,-80.0,13.0,12.0,12.0,20.0,1
6928,BA:8C:B9:54:50:24,3843303,490296356,4858,6185203,3838445,484111153,0,9136,1709225,9114,1705730,22,3495,2351,16,5315,40,0,61,216660.0,130000.0,-39.0,-37.0,-45.0,-52.0,-40.0,-36.0,-44.0,-50.0,-84.0,-83.0,-79.0,-80.0,45.0,46.0,34.0,28.0,1
6929,62:47:05:9D:EB:15,3840405,486488816,1958,2377461,3838447,484111355,0,3860,2947443,3837,2943536,23,3907,1909,0,1995,39,0,104,216660.0,130000.0,-46.0,-42.0,-43.0,-48.0,-49.0,-45.0,-47.0,-50.0,-84.0,-83.0,-79.0,-80.0,38.0,41.0,36.0,32.0,1
6930,3C:55:76:E8:8F:1F,3907097,656397596,68650,172286241,3838447,484111355,24,30866,6606996,30480,6540052,386,66944,13552,35,68722,7016,24,390,154850.0,48750.0,-43.0,-50.0,-52.0,-41.0,-42.0,-49.0,-51.0,-40.0,-84.0,-83.0,-79.0,-80.0,41.0,33.0,27.0,39.0,1
6931,92:69:1D:31:68:E9,3842395,487740151,3948,3628796,3838447,484111355,0,4924,1116307,4775,1082527,149,33780,2136,11,4168,90,0,48,216660.0,130000.0,-51.0,-50.0,-43.0,-46.0,-50.0,-48.0,-42.0,-46.0,-84.0,-83.0,-79.0,-80.0,33.0,33.0,36.0,34.0,1
6932,CC:2F:71:3F:1F:24,4723289,1450151455,884841,966040040,3838448,484111415,37,723601,773585653,722859,773496429,742,89224,697469,15,885098,92566,34,546,130000.0,43333.0,-69.0,-67.0,-68.0,-68.0,-69.0,-67.0,-68.0,-68.0,-84.0,-83.0,-79.0,-80.0,15.0,16.0,11.0,12.0,1
6933,CC:2F:71:3E:C5:1F,3839350,484221547,902,110132,3838448,484111415,0,3764,316106,3105,237900,659,78206,955,11,1295,23,0,47,130000.0,39000.0,-71.0,-71.0,-67.0,-60.0,-70.0,-71.0,-67.0,-60.0,-84.0,-83.0,-79.0,-80.0,13.0,12.0,12.0,20.0,1
6934,BA:8C:B9:54:50:24,3843308,490296820,4858,6185203,3838450,484111617,0,9136,1709225,9114,1705730,22,3495,2351,16,5315,40,0,61,216660.0,130000.0,-39.0,-37.0,-45.0,-52.0,-40.0,-36.0,-44.0,-50.0,-84.0,-83.0,-79.0,-80.0,45.0,46.0,34.0,28.0,1
6935,62:47:05:9D:EB:15,3840410,486489280,1958,2377461,3838452,484111819,0,3860,2947443,3837,2943536,23,3907,1909,0,1995,39,0,104,216660.0,130000.0,-46.0,-42.0,-43.0,-48.0,-49.0,-45.0,-47.0,-50.0,-84.0,-83.0,-79.0,-80.0,38.0,41.0,36.0,32.0,1
6936,3C:55:76:E8:8F:1F,3907104,656398262,68650,172286241,3838454,484112021,24,30866,6606996,30480,6540052,386,66944,13552,35,68722,7016,24,390,154850.0,48750.0,-43.0,-50.0,-52.0,-41.0,-42.0,-49.0,-51.0,-40.0,-84.0,-83.0,-79.0,-80.0,41.0,33.0,27.0,39.0,1
6937,92:69:1D:31:68:E9,3842402,487740817,3948,3628796,3838454,484112021,0,4924,1116307,4775,1082527,149,33780,2136,11,4168,90,0,48,216660.0,130000.0,-51.0,-50.0,-43.0,-46.0,-50.0,-48.0,-42.0,-46.0,-84.0,-83.0,-79.0,-80.0,33.0,33.0,36.0,34.0,1
6938,CC:2F:71:3F:1F:24,4723507,1450418245,885053,966306224,3838454,484112021,37,723796,773845329,723054,773756105,742,89224,697656,15,885310,92573,34,546,130000.0,43333.0,-69.0,-67.0,-67.0,-67.0,-69.0,-67.0,-67.0,-67.0,-84.0,-83.0,-79.0,-80.0,15.0,16.0,12.0,13.0,1
6939,CC:2F:71:3E:C5:1F,3839356,484222153,902,110132,3838454,484112021,0,3764,316106,3105,237900,659,78206,955,11,1295,23,0,47,130000.0,39000.0,-71.0,-71.0,-67.0,-60.0,-70.0,-71.0,-67.0,-60.0,-84.0,-83.0,-79.0,-80.0,13.0,12.0,12.0,20.0,1
6940,BA:8C:B9:54:50:24,3843314,490297426,4858,6185203,3838456,484112223,0,9136,1709225,9114,1705730,22,3495,2351,16,5315,40,0,61,216660.0,130000.0,-39.0,-37.0,-45.0,-52.0,-40.0,-36.0,-44.0,-50.0,-84.0,-83.0,-79.0,-80.0,45.0,46.0,34.0,28.0,1
6941,62:47:05:9D:EB:15,3840415,486489853,1959,2377630,3838456,484112223,0,3874,2948538,3851,2944631,23,3907,1911,0,1996,39,0,104,216660.0,130000.0,-38.0,-52.0,-39.0,-42.0,-43.0,-55.0,-44.0,-47.0,-84.0,-83.0,-79.0,-80.0,46.0,31.0,40.0,38.0,1
6942,3C:55:76:E8:8F:1F,3907107,656398594,68651,172286371,3838456,484112223,24,30875,6607649,30489,6540705,386,66944,13553,35,68723,7016,24,390,154850.0,48750.0,-48.0,-53.0,-45.0,-45.0,-46.0,-51.0,-43.0,-43.0,-84.0,-83.0,-79.0,-80.0,36.0,30.0,34.0,35.0,1
6943,92:69:1D:31:68:E9,3842406,487741221,3948,3628796,3838458,484112425,0,4924,1116307,4775,1082527,149,33780,2136,11,4168,90,0,48,216660.0,130000.0,-51.0,-50.0,-43.0,-46.0,-50.0,-48.0,-42.0,-46.0,-84.0,-83.0,-79.0,-80.0,33.0,33.0,36.0,34.0,1
6944,CC:2F:71:3F:1F:24,4723718,1450678711,885260,966566286,3838458,484112425,37,723986,774100057,723244,774010833,742,89224,697838,15,885517,92577,34,546,130000.0,43333.0,-68.0,-68.0,-67.0,-69.0,-68.0,-67.0,-67.0,-68.0,-84.0,-83.0,-79.0,-80.0,16.0,15.0,12.0,11.0,1
6945,CC:2F:71:3E:C5:1F,3839360,484222557,902,110132,3838458,484112425,0,3764,316106,3105,237900,659,78206,955,11,1295,23,0,47,130000.0,39000.0,-71.0,-71.0,-67.0,-60.0,-70.0,-71.0,-67.0,-60.0,-84.0,-83.0,-79.0,-80.0,13.0,12.0,12.0,20.0,1
6946,BA:8C:B9:54:50:24,3843316,490297628,4858,6185203,3838458,484112425,0,9136,1709225,9114,1705730,22,3495,2351,16,5315,40,0,61,216660.0,130000.0,-39.0,-37.0,-45.0,-52.0,-40.0,-36.0,-44.0,-50.0,-84.0,-83.0,-79.0,-80.0,45.0,46.0,34.0,28.0,1
6947,62:47:05:9D:EB:15,3840423,486490649,1960,2377760,3838463,484112889,0,3887,2949499,3864,2945592,23,3907,1912,0,1997,39,0,105,216660.0,130000.0,-45.0,-46.0,-33.0,-45.0,-41.0,-46.0,-40.0,-41.0,-84.0,-83.0,-79.0,-80.0,39.0,37.0,46.0,35.0,1
6948,3C:55:76:E8:8F:1F,3907172,656486293,68707,172373202,3838465,484113091,24,30982,6635861,30596,6568917,386,66944,13629,35,68778,7016,24,390,172050.0,48750.0,-49.0,-53.0,-47.0,-46.0,-49.0,-53.0,-47.0,-46.0,-84.0,-83.0,-79.0,-80.0,35.0,30.0,32.0,34.0,1
6949,92:69:1D:31:68:E9,3842413,487741887,3948,3628796,3838465,484113091,0,4924,1116307,4775,1082527,149,33780,2136,11,4168,90,0,48,216660.0,130000.0,-51.0,-50.0,-43.0,-46.0,-50.0,-48.0,-42.0,-46.0,-84.0,-83.0,-79.0,-80.0,33.0,33.0,36.0,34.0,1
6950,CC:2F:71:3F:1F:24,4723943,1450950342,885478,966837251,3838465,484113091,37,724188,774359488,723446,774270264,742,89224,698034,15,885735,92608,34,546,130000.0,43333.0,-68.0,-67.0,-68.0,-69.0,-68.0,-66.0,-68.0,-68.0,-84.0,-83.0,-79.0,-80.0,16.0,16.0,11.0,11.0,1
6951,CC:2F:71:3E:C5:1F,3839367,484223223,902,110132,3838465,484113091,0,3764,316106,3105,237900,659,78206,955,11,1295,23,0,47,130000.0,39000.0,-71.0,-71.0,-67.0,-60.0,-70.0,-71.0,-67.0,-60.0,-84.0,-83.0,-79.0,-80.0,13.0,12.0,12.0,20.0,1
6952,BA:8C:B9:54:50:24,3843323,490298294,4858,6185203,3838465,484113091,0,9136,1709225,9114,1705730,22,3495,2351,16,5315,40,0,61,216660.0,130000.0,-39.0,-37.0,-45.0,-52.0,-40.0,-36.0,-44.0,-50.0,-84.0,-83.0,-79.0,-80.0,45.0,46.0,34.0,28.0,1
6953,62:47:05:9D:EB:15,3840442,486498515,1975,2385222,3838467,484113293,0,3926,2957621,3903,2953714,23,3907,1925,0,2012,52,0,105,195000.0,97500.0,-54.0,-54.0,-53.0,-55.0,-53.0,-57.0,-51.0,-52.0,-84.0,-83.0,-79.0,-80.0,30.0,29.0,26.0,25.0,1
6954,3C:55:76:E8:8F:1F,3907207,656541115,68740,172427822,3838467,484113293,24,31049,6651715,30663,6584771,386,66944,13676,35,68812,7016,24,390,195000.0,97500.0,-48.0,-51.0,-47.0,-46.0,-47.0,-52.0,-45.0,-45.0,-84.0,-83.0,-79.0,-80.0,36.0,32.0,32.0,34.0,1
6955,92:69:1D:31:68:E9,3842417,487742291,3948,3628796,3838469,484113495,0,4924,1116307,4775,1082527,149,33780,2136,11,4168,90,0,48,216660.0,130000.0,-51.0,-50.0,-43.0,-46.0,-50.0,-48.0,-42.0,-46.0,-84.0,-83.0,-79.0,-80.0,33.0,33.0,36.0,34.0,1
6956,CC:2F:71:3F:1F:24,4724162,1451218730,885693,967105235,3838469,484113495,37,724384,774620694,723642,774531470,742,89224,698222,15,885950,92637,34,546,130000.0,43333.0,-68.0,-69.0,-67.0,-68.0,-68.0,-68.0,-67.0,-68.0,-84.0,-83.0,-79.0,-80.0,16.0,14.0,12.0,12.0,1
6957,CC:2F:71:3E:C5:1F,3839371,484223627,902,110132,3838469,484113495,0,3764,316106,3105,237900,659,78206,955,11,1295,23,0,47,130000.0,39000.0,-71.0,-71.0,-67.0,-60.0,-70.0,-71.0,-67.0,-60.0,-84.0,-83.0,-79.0,-80.0,13.0,12.0,12.0,20.0,1
6958,BA:8C:B9:54:50:24,3843327,490298698,4858,6185203,3838469,484113495,0,9136,1709225,9114,1705730,22,3495,2351,16,5315,40,0,61,216660.0,130000.0,-39.0,-37.0,-45.0,-52.0,-40.0,-36.0,-44.0,-50.0,-84.0,-83.0,-79.0,-80.0,45.0,46.0,34.0,28.0,1
6959,62:47:05:9D:EB:15,3840470,486503481,1995,2389460,3838475,484114021,0,3958,2966328,3934,2962299,24,4029,1949,0,2032,52,0,105,206470.0,97500.0,-47.0,-47.0,-51.0,-47.0,-47.0,-47.0,-48.0,-47.0,-84.0,-83.0,-79.0,-80.0,37.0,36.0,28.0,33.0,1
6960,3C:55:76:E8:8F:1F,3907219,656544762,68744,172430741,3838475,484114021,24,31066,6656587,30680,6589643,386,66944,13681,35,68816,7016,24,392,195000.0,97500.0,-46.0,-54.0,-50.0,-41.0,-45.0,-55.0,-48.0,-40.0,-84.0,-83.0,-79.0,-80.0,38.0,29.0,29.0,39.0,1
6961,92:69:1D:31:68:E9,3842424,487742879,3948,3628796,3838476,484114083,0,4924,1116307,4775,1082527,149,33780,2136,11,4168,90,0,48,216660.0,130000.0,-51.0,-50.0,-43.0,-46.0,-50.0,-48.0,-42.0,-46.0,-84.0,-83.0,-79.0,-80.0,33.0,33.0,36.0,34.0,1
6962,CC:2F:71:3F:1F:24,4724383,1451486002,885907,967371919,3838476,484114083,37,724585,774884012,723843,774794788,742,89224,698411,15,886164,92639,34,546,130000.0,43333.0,-67.0,-65.0,-68.0,-72.0,-67.0,-65.0,-68.0,-71.0,-84.0,-83.0,-79.0,-80.0,17.0,18.0,11.0,8.0,1
6963,CC:2F:71:3E:C5:1F,3839378,484224215,902,110132,3838476,484114083,0,3764,316106,3105,237900,659,78206,955,11,1295,23,0,47,130000.0,39000.0,-71.0,-71.0,-67.0,-60.0,-70.0,-71.0,-67.0,-60.0,-84.0,-83.0,-79.0,-80.0,13.0,12.0,12.0,20.0,1
6964,BA:8C:B9:54:50:24,3843334,490299286,4858,6185203,3838476,484114083,0,9136,1709225,9114,1705730,22,3495,2351,16,5315,40,0,61,216660.0,130000.0,-39.0,-37.0,-45.0,-52.0,-40.0,-36.0,-44.0,-50.0,-84.0,-83.0,-79.0,-80.0,45.0,46.0,34.0,28.0,1
6965,62:47:05:9D:EB:15,3840482,486505572,2002,2391085,3838480,484114487,0,3967,2967402,3942,2963251,25,4151,1957,0,2039,52,0,105,206470.0,103230.0,-42.0,-44.0,-41.0,-39.0,-47.0,-45.0,-46.0,-44.0,-84.0,-83.0,-79.0,-80.0,42.0,39.0,38.0,41.0,1
6966,3C:55:76:E8:8F:1F,3907224,656545228,68744,172430741,3838480,484114487,24,31066,6656587,30680,6589643,386,66944,13681,35,68816,7016,24,392,195000.0,97500.0,-46.0,-54.0,-50.0,-41.0,-45.0,-55.0,-48.0,-40.0,-84.0,-83.0,-79.0,-80.0,38.0,29.0,29.0,39.0,1
6967,92:69:1D:31:68:E9,3842428,487743283,3948,3628796,3838480,484114487,0,4924,1116307,4775,1082527,149,33780,2136,11,4168,90,0,48,216660.0,130000.0,-51.0,-50.0,-43.0,-46.0,-50.0,-48.0,-42.0,-46.0,-84.0,-83.0,-79.0,-80.0,33.0,33.0,36.0,34.0,1
6968,CC:2F:71:3F:1F:24,4724597,1451749594,886117,967635107,3838480,484114487,37,724779,775140614,724037,775051390,742,89224,698598,15,886374,92657,34,546,117000.0,39000.0,-69.0,-67.0,-67.0,-69.0,-69.0,-66.0,-67.0,-69.0,-84.0,-83.0,-79.0,-80.0,15.0,16.0,12.0,11.0,1
6969,CC:2F:71:3E:C5:1F,3839382,484224619,902,110132,3838480,484114487,0,3764,316106,3105,237900,659,78206,955,11,1295,23,0,47,130000.0,39000.0,-71.0,-71.0,-67.0,-60.0,-70.0,-71.0,-67.0,-60.0,-84.0,-83.0,-79.0,-80.0,13.0,12.0,12.0,20.0,1
6970,BA:8C:B9:54:50:24,3843340,490299892,4858,6185203,3838482,484114689,0,9136,1709225,9114,1705730,22,3495,2351,16,5315,40,0,61,216660.0,130000.0,-39.0,-37.0,-45.0,-52.0,-40.0,-36.0,-44.0,-50.0,-84.0,-83.0,-79.0,-80.0,45.0,46.0,34.0,28.0,1
6971,62:47:05:9D:EB:15,3840486,486505976,2002,2391085,3838484,484114891,0,3967,2967402,3942,2963251,25,4151,1957,0,2039,52,0,105,206470.0,103230.0,-42.0,-44.0,-41.0,-39.0,-47.0,-45.0,-46.0,-44.0,-84.0,-83.0,-79.0,-80.0,42.0,39.0,38.0,41.0,1
6972,3C:55:76:E8:8F:1F,3907228,656545632,68744,172430741,3838484,484114891,24,31066,6656587,30680,6589643,386,66944,13681,35,68816,7016,24,392,195000.0,97500.0,-46.0,-54.0,-50.0,-41.0,-45.0,-55.0,-48.0,-40.0,-84.0,-83.0,-79.0,-80.0,38.0,29.0,29.0,39.0,1
6973,92:69:1D:31:68:E9,3842433,487743747,3948,3628796,3838485,484114951,0,4924,1116307,4775,1082527,149,33780,2136,11,4168,90,0,48,216660.0,130000.0,-51.0,-50.0,-43.0,-46.0,-50.0,-48.0,-42.0,-46.0,-84.0,-83.0,-79.0,-80.0,33.0,33.0,36.0,34.0,1
6974,CC:2F:71:3F:1F:24,4724820,1452019695,886335,967904744,3838485,484114951,37,724983,775402304,724241,775313080,742,89224,698791,15,886592,92658,34,546,130000.0,43333.0,-69.0,-68.0,-66.0,-67.0,-69.0,-67.0,-66.0,-67.0,-84.0,-83.0,-79.0,-80.0,15.0,15.0,13.0,13.0,1
6975,CC:2F:71:3E:C5:1F,3839387,484225083,902,110132,3838485,484114951,0,3764,316106,3105,237900,659,78206,955,11,1295,23,0,47,130000.0,39000.0,-71.0,-71.0,-67.0,-60.0,-70.0,-71.0,-67.0,-60.0,-84.0,-83.0,-79.0,-80.0,13.0,12.0,12.0,20.0,1
6976,BA:8C:B9:54:50:24,3843343,490300154,4858,6185203,3838485,484114951,0,9136,1709225,9114,1705730,22,3495,2351,16,5315,40,0,61,216660.0,130000.0,-39.0,-37.0,-45.0,-52.0,-40.0,-36.0,-44.0,-50.0,-84.0,-83.0,-79.0,-80.0,45.0,46.0,34.0,28.0,1
6977,62:47:05:9D:EB:15,3840491,486506440,2002,2391085,3838489,484115355,0,3967,2967402,3942,2963251,25,4151,1957,0,2039,52,0,105,206470.0,103230.0,-42.0,-44.0,-41.0,-39.0,-47.0,-45.0,-46.0,-44.0,-84.0,-83.0,-79.0,-80.0,42.0,39.0,38.0,41.0,1
6978,3C:55:76:E8:8F:1F,3907237,656546482,68746,172430925,3838491,484115557,24,31074,6657203,30688,6590259,386,66944,13682,35,68818,7016,24,393,195000.0,1000.0,-40.0,-54.0,-46.0,-37.0,-41.0,-51.0,-46.0,-39.0,-84.0,-83.0,-79.0,-80.0,44.0,29.0,33.0,43.0,1
6979,92:69:1D:31:68:E9,3842440,487744469,3949,3628912,3838491,484115557,0,4926,1116443,4777,1082663,149,33780,2136,11,4169,90,0,49,216660.0,130000.0,-54.0,-46.0,-42.0,-48.0,-51.0,-47.0,-42.0,-46.0,-84.0,-83.0,-79.0,-80.0,30.0,37.0,37.0,32.0,1
6980,CC:2F:71:3F:1F:24,4725039,1452283890,886546,968168160,3838493,484115730,37,725176,775661652,724434,775572428,742,89224,698976,15,886803,92658,34,546,130000.0,43333.0,-68.0,-65.0,-66.0,-67.0,-68.0,-64.0,-65.0,-67.0,-84.0,-83.0,-79.0,-80.0,16.0,18.0,13.0,13.0,1
6981,CC:2F:71:3E:C5:1F,3839398,484226180,903,110248,3838495,484115932,0,3766,316246,3107,238040,659,78206,955,11,1296,23,0,47,130000.0,39000.0,-71.0,-71.0,-69.0,-60.0,-70.0,-71.0,-68.0,-60.0,-84.0,-83.0,-79.0,-80.0,13.0,12.0,10.0,20.0,1
6982,BA:8C:B9:54:50:24,3843354,490301251,4859,6185319,3838495,484115932,0,9140,1709497,9118,1706002,22,3495,2351,16,5316,40,0,61,216660.0,130000.0,-39.0,-36.0,-45.0,-51.0,-40.0,-35.0,-44.0,-49.0,-84.0,-83.0,-79.0,-80.0,45.0,47.0,34.0,29.0,1
6983,62:47:05:9D:EB:15,3840501,486507411,2004,2391355,3838497,484116056,0,3974,2968147,3946,2963581,28,4566,1961,0,2041,52,0,105,206470.0,103230.0,-49.0,-49.0,-46.0,-43.0,-46.0,-44.0,-44.0,-40.0,-84.0,-83.0,-79.0,-80.0,35.0,34.0,33.0,37.0,1
6984,3C:55:76:E8:8F:1F,3907243,656546981,68746,172430925,3838497,484116056,24,31089,6658225,30703,6591281,386,66944,13682,35,68818,7016,24,393,195000.0,1000.0,-48.0,-64.0,-55.0,-45.0,-43.0,-55.0,-47.0,-40.0,-84.0,-83.0,-79.0,-80.0,36.0,19.0,24.0,35.0,1
6985,92:69:1D:31:68:E9,3842446,487744968,3949,3628912,3838497,484116056,0,4926,1116443,4777,1082663,149,33780,2136,11,4169,90,0,49,216660.0,130000.0,-54.0,-46.0,-42.0,-48.0,-51.0,-47.0,-42.0,-46.0,-84.0,-83.0,-79.0,-80.0,30.0,37.0,37.0,32.0,1
6986,CC:2F:71:3F:1F:24,4725254,1452544364,886755,968428106,3838499,484116258,37,725361,775905986,724619,775816762,742,89224,699158,15,887012,92686,34,546,144444.0,43333.0,-67.0,-72.0,-67.0,-68.0,-67.0,-72.0,-67.0,-67.0,-84.0,-83.0,-79.0,-80.0,17.0,11.0,12.0,12.0,1
6987,CC:2F:71:3E:C5:1F,3839402,484226506,903,110248,3838499,484116258,0,3768,316434,3108,238110,660,78324,956,11,1296,23,0,47,130000.0,39000.0,-70.0,-70.0,-69.0,-60.0,-70.0,-70.0,-68.0,-60.0,-84.0,-83.0,-79.0,-80.0,14.0,13.0,10.0,20.0,1
6988,BA:8C:B9:54:50:24,3843358,490301577,4859,6185319,3838499,484116258,0,9140,1709497,9118,1706002,22,3495,2351,16,5316,40,0,61,216660.0,130000.0,-39.0,-36.0,-45.0,-51.0,-40.0,-35.0,-44.0,-49.0,-84.0,-83.0,-79.0,-80.0,45.0,47.0,34.0,29.0,1
6989,62:47:05:9D:EB:15,3840514,486508787,2004,2391355,3838510,484117432,0,3980,2968766,3949,2963785,31,4981,1964,0,2041,52,0,105,206470.0,103230.0,-50.0,-45.0,-39.0,-44.0,-46.0,-47.0,-41.0,-42.0,-84.0,-83.0,-79.0,-80.0,34.0,38.0,40.0,36.0,1
6990,3C:55:76:E8:8F:1F,3907256,656548357,68746,172430925,3838510,484117432,24,31089,6658225,30703,6591281,386,66944,13682,35,68818,7016,24,393,195000.0,1000.0,-48.0,-64.0,-55.0,-45.0,-43.0,-55.0,-47.0,-40.0,-84.0,-83.0,-79.0,-80.0,36.0,19.0,24.0,35.0,1
6991,92:69:1D:31:68:E9,3842459,487746344,3949,3628912,3838510,484117432,0,4926,1116443,4777,1082663,149,33780,2136,11,4169,90,0,49,216660.0,130000.0,-54.0,-46.0,-42.0,-48.0,-51.0,-47.0,-42.0,-46.0,-84.0,-83.0,-79.0,-80.0,30.0,37.0,37.0,32.0,1
6992,CC:2F:71:3F:1F:24,4725489,1452818713,886979,968701281,3838510,484117432,37,725561,776156728,724819,776067504,742,89224,699358,15,887236,92735,34,547,117000.0,39000.0,-70.0,-70.0,-66.0,-73.0,-69.0,-70.0,-66.0,-72.0,-84.0,-83.0,-79.0,-80.0,14.0,13.0,13.0,7.0,1
6993,CC:2F:71:3E:C5:1F,3839413,484227680,903,110248,3838510,484117432,0,3768,316434,3108,238110,660,78324,956,11,1296,23,0,47,130000.0,39000.0,-70.0,-70.0,-69.0,-60.0,-70.0,-70.0,-68.0,-60.0,-84.0,-83.0,-79.0,-80.0,14.0,13.0,10.0,20.0,1
6994,BA:8C:B9:54:50:24,3843369,490302751,4859,6185319,3838510,484117432,0,9140,1709497,9118,1706002,22,3495,2351,16,5316,40,0,61,216660.0,130000.0,-39.0,-36.0,-45.0,-51.0,-40.0,-35.0,-44.0,-49.0,-84.0,-83.0,-79.0,-80.0,45.0,47.0,34.0,29.0,1
6995,62:47:05:9D:EB:15,3840530,486516432,2018,2398798,3838512,484117634,0,4007,2979442,3976,2974461,31,4981,1982,0,2055,52,0,105,216660.0,130000.0,-47.0,-45.0,-39.0,-46.0,-47.0,-49.0,-39.0,-48.0,-84.0,-83.0,-79.0,-80.0,37.0,38.0,40.0,34.0,1
6996,3C:55:76:E8:8F:1F,3907266,656550800,68754,172433166,3838512,484117634,24,31115,6661423,30729,6594479,386,66944,13693,35,68826,7016,24,393,195000.0,97500.0,-47.0,-53.0,-50.0,-41.0,-45.0,-54.0,-50.0,-41.0,-84.0,-83.0,-79.0,-80.0,37.0,30.0,29.0,39.0,1
6997,92:69:1D:31:68:E9,3842461,487746546,3949,3628912,3838512,484117634,0,4926,1116443,4777,1082663,149,33780,2136,11,4169,90,0,49,216660.0,130000.0,-54.0,-46.0,-42.0,-48.0,-51.0,-47.0,-42.0,-46.0,-84.0,-83.0,-79.0,-80.0,30.0,37.0,37.0,32.0,1
6998,CC:2F:71:3F:1F:24,4725704,1453083579,887190,968965743,3838514,484117836,37,725754,776411762,725012,776322538,742,89224,699546,15,887446,92770,34,547,115556.0,28889.0,-67.0,-70.0,-66.0,-72.0,-67.0,-70.0,-65.0,-70.0,-84.0,-83.0,-79.0,-80.0,17.0,13.0,13.0,8.0,1
6999,CC:2F:71:3E:C5:1F,3839417,484228084,903,110248,3838514,484117836,0,3768,316434,3108,238110,660,78324,956,11,1296,23,0,47,130000.0,39000.0,-70.0,-70.0,-69.0,-60.0,-70.0,-70.0,-68.0,-60.0,-84.0,-83.0,-79.0,-80.0,14.0,13.0,10.0,20.0,1
7000,BA:8C:B9:54:50:24,3843373,490303155,4859,6185319,3838514,484117836,0,9140,1709497,9118,1706002,22,3495,2351,16,5316,40,0,61,216660.0,130000.0,-39.0,-36.0,-45.0,-51.0,-40.0,-35.0,-44.0,-49.0,-84.0,-83.0,-79.0,-80.0,45.0,47.0,34.0,29.0,1
7001,62:47:05:9D:EB:15,3840538,486517214,2019,2398914,3838519,484118300,0,4009,2979620,3978,2974639,31,4981,1983,0,2056,53,0,105,216660.0,130000.0,-48.0,-48.0,-41.0,-49.0,-47.0,-48.0,-39.0,-48.0,-84.0,-83.0,-79.0,-80.0,36.0,35.0,38.0,31.0,1
7002,3C:55:76:E8:8F:1F,3907273,656551466,68754,172433166,3838519,484118300,24,31115,6661423,30729,6594479,386,66944,13693,35,68826,7016,24,393,195000.0,97500.0,-47.0,-53.0,-50.0,-41.0,-45.0,-54.0,-50.0,-41.0,-84.0,-83.0,-79.0,-80.0,37.0,30.0,29.0,39.0,1
7003,92:69:1D:31:68:E9,3842468,487747212,3949,3628912,3838519,484118300,0,4926,1116443,4777,1082663,149,33780,2136,11,4169,90,0,49,216660.0,130000.0,-54.0,-46.0,-42.0,-48.0,-51.0,-47.0,-42.0,-46.0,-84.0,-83.0,-79.0,-80.0,30.0,37.0,37.0,32.0,1
7004,CC:2F:71:3F:1F:24,4725921,1453348695,887401,969230333,3838520,484118362,37,725948,776667306,725206,776578082,742,89224,699732,15,887658,92806,34,547,130000.0,39000.0,-68.0,-71.0,-66.0,-71.0,-67.0,-70.0,-65.0,-69.0,-84.0,-83.0,-79.0,-80.0,16.0,12.0,13.0,9.0,1
7005,CC:2F:71:3E:C5:1F,3839423,484228610,903,110248,3838520,484118362,0,3768,316434,3108,238110,660,78324,956,11,1296,23,0,47,130000.0,39000.0,-70.0,-70.0,-69.0,-60.0,-70.0,-70.0,-68.0,-60.0,-84.0,-83.0,-79.0,-80.0,14.0,13.0,10.0,20.0,1
7006,BA:8C:B9:54:50:24,3843379,490303681,4859,6185319,3838520,484118362,0,9140,1709497,9118,1706002,22,3495,2351,16,5316,40,0,61,216660.0,130000.0,-39.0,-36.0,-45.0,-51.0,-40.0,-35.0,-44.0,-49.0,-84.0,-83.0,-79.0,-80.0,45.0,47.0,34.0,29.0,1
7007,62:47:05:9D:EB:15,3840543,486517680,2019,2398914,3838524,484118766,0,4010,2979688,3979,2974707,31,4981,1983,0,2056,53,0,105,216660.0,130000.0,-46.0,-45.0,-39.0,-45.0,-47.0,-47.0,-39.0,-47.0,-84.0,-83.0,-79.0,-80.0,38.0,38.0,40.0,35.0,1
7008,3C:55:76:E8:8F:1F,3907279,656552226,68755,172433460,3838524,484118766,24,31134,6662828,30747,6595766,387,67062,13695,35,68827,7016,24,393,195000.0,97500.0,-45.0,-58.0,-53.0,-40.0,-44.0,-57.0,-52.0,-38.0,-84.0,-83.0,-79.0,-80.0,39.0,25.0,26.0,40.0,1
7009,92:69:1D:31:68:E9,3842473,487747678,3949,3628912,3838524,484118766,0,4926,1116443,4777,1082663,149,33780,2136,11,4169,90,0,49,216660.0,130000.0,-54.0,-46.0,-42.0,-48.0,-51.0,-47.0,-42.0,-46.0,-84.0,-83.0,-79.0,-80.0,30.0,37.0,37.0,32.0,1
7010,CC:2F:71:3F:1F:24,4726134,1453613301,887610,969494535,3838524,484118766,37,726142,776926898,725400,776837674,742,89224,699918,15,887867,92857,34,547,115556.0,28889.0,-68.0,-71.0,-64.0,-71.0,-68.0,-71.0,-65.0,-70.0,-84.0,-83.0,-79.0,-80.0,16.0,12.0,15.0,9.0,1
7011,CC:2F:71:3E:C5:1F,3839429,484229216,903,110248,3838526,484118968,0,3768,316434,3108,238110,660,78324,956,11,1296,23,0,47,130000.0,39000.0,-70.0,-70.0,-69.0,-60.0,-70.0,-70.0,-68.0,-60.0,-84.0,-83.0,-79.0,-80.0,14.0,13.0,10.0,20.0,1
7012,BA:8C:B9:54:50:24,3843385,490304287,4859,6185319,3838526,484118968,0,9140,1709497,9118,1706002,22,3495,2351,16,5316,40,0,61,216660.0,130000.0,-39.0,-36.0,-45.0,-51.0,-40.0,-35.0,-44.0,-49.0,-84.0,-83.0,-79.0,-80.0,45.0,47.0,34.0,29.0,1
7013,62:47:05:9D:EB:15,3840547,486518084,2019,2398914,3838528,484119170,0,4010,2979688,3979,2974707,31,4981,1983,0,2056,53,0,105,216660.0,130000.0,-46.0,-45.0,-39.0,-45.0,-47.0,-47.0,-39.0,-47.0,-84.0,-83.0,-79.0,-80.0,38.0,38.0,40.0,35.0,1
7014,3C:55:76:E8:8F:1F,3907284,656552690,68755,172433460,3838529,484119230,24,31151,6663986,30764,6596924,387,67062,13695,35,68827,7016,24,393,195000.0,97500.0,-47.0,-58.0,-52.0,-40.0,-46.0,-57.0,-51.0,-40.0,-84.0,-83.0,-79.0,-80.0,37.0,25.0,27.0,40.0,1
7015,92:69:1D:31:68:E9,3842478,487748142,3949,3628912,3838529,484119230,0,4926,1116443,4777,1082663,149,33780,2136,11,4169,90,0,49,216660.0,130000.0,-54.0,-46.0,-42.0,-48.0,-51.0,-47.0,-42.0,-46.0,-84.0,-83.0,-79.0,-80.0,30.0,37.0,37.0,32.0,1
7016,CC:2F:71:3F:1F:24,4726368,1453903402,887839,969784172,3838529,484119230,37,726352,777200156,725610,777110932,742,89224,700125,15,888096,92883,34,548,117000.0,39000.0,-70.0,-71.0,-66.0,-71.0,-69.0,-70.0,-66.0,-70.0,-84.0,-83.0,-79.0,-80.0,14.0,12.0,13.0,9.0,1
7017,CC:2F:71:3E:C5:1F,3839432,484229478,903,110248,3838529,484119230,0,3768,316434,3108,238110,660,78324,956,11,1296,23,0,47,130000.0,39000.0,-70.0,-70.0,-69.0,-60.0,-70.0,-70.0,-68.0,-60.0,-84.0,-83.0,-79.0,-80.0,14.0,13.0,10.0,20.0,1
7018,BA:8C:B9:54:50:24,3843388,490304549,4859,6185319,3838529,484119230,0,9140,1709497,9118,1706002,22,3495,2351,16,5316,40,0,61,216660.0,130000.0,-39.0,-36.0,-45.0,-51.0,-40.0,-35.0,-44.0,-49.0,-84.0,-83.0,-79.0,-80.0,45.0,47.0,34.0,29.0,1
7019,62:47:05:9D:EB:15,3840555,486518812,2019,2398914,3838536,484119898,0,4010,2979688,3979,2974707,31,4981,1983,0,2056,53,0,105,216660.0,130000.0,-46.0,-45.0,-39.0,-45.0,-47.0,-47.0,-39.0,-47.0,-84.0,-83.0,-79.0,-80.0,38.0,38.0,40.0,35.0,1
7020,3C:55:76:E8:8F:1F,3907292,656553532,68756,172433634,3838536,484119898,24,31164,6665000,30777,6597938,387,67062,13697,35,68828,7016,24,393,206470.0,97500.0,-46.0,-54.0,-51.0,-40.0,-45.0,-54.0,-51.0,-40.0,-84.0,-83.0,-79.0,-80.0,38.0,29.0,28.0,40.0,1
7021,92:69:1D:31:68:E9,3842487,487749012,3949,3628912,3838538,484120100,0,4926,1116443,4777,1082663,149,33780,2136,11,4169,90,0,49,216660.0,130000.0,-54.0,-46.0,-42.0,-48.0,-51.0,-47.0,-42.0,-46.0,-84.0,-83.0,-79.0,-80.0,30.0,37.0,37.0,32.0,1
7022,CC:2F:71:3F:1F:24,4726590,1454170012,888052,970049912,3838538,484120100,37,726542,777452014,725799,777362672,743,89342,700313,15,888309,92962,34,549,130000.0,43333.0,-69.0,-69.0,-66.0,-72.0,-69.0,-69.0,-65.0,-70.0,-84.0,-83.0,-79.0,-80.0,15.0,14.0,13.0,8.0,1
7023,CC:2F:71:3E:C5:1F,3839441,484230348,903,110248,3838538,484120100,0,3768,316434,3108,238110,660,78324,956,11,1296,23,0,47,130000.0,39000.0,-70.0,-70.0,-69.0,-60.0,-70.0,-70.0,-68.0,-60.0,-84.0,-83.0,-79.0,-80.0,14.0,13.0,10.0,20.0,1
7024,BA:8C:B9:54:50:24,3843397,490305419,4859,6185319,3838538,484120100,0,9140,1709497,9118,1706002,22,3495,2351,16,5316,40,0,61,216660.0,130000.0,-39.0,-36.0,-45.0,-51.0,-40.0,-35.0,-44.0,-49.0,-84.0,-83.0,-79.0,-80.0,45.0,47.0,34.0,29.0,1
7025,62:47:05:9D:EB:15,3840558,486519076,2019,2398914,3838539,484120162,0,4010,2979688,3979,2974707,31,4981,1983,0,2056,53,0,105,216660.0,130000.0,-46.0,-45.0,-39.0,-45.0,-47.0,-47.0,-39.0,-47.0,-84.0,-83.0,-79.0,-80.0,38.0,38.0,40.0,35.0,1
7026,3C:55:76:E8:8F:1F,3907295,656553796,68756,172433634,3838539,484120162,24,31174,6665734,30786,6598554,388,67180,13698,35,68828,7016,24,393,206470.0,97500.0,-46.0,-55.0,-52.0,-41.0,-43.0,-53.0,-49.0,-38.0,-84.0,-83.0,-79.0,-80.0,38.0,28.0,27.0,39.0,1
7027,92:69:1D:31:68:E9,3842490,487749276,3949,3628912,3838541,484120364,0,4926,1116443,4777,1082663,149,33780,2136,11,4169,90,0,49,216660.0,130000.0,-54.0,-46.0,-42.0,-48.0,-51.0,-47.0,-42.0,-46.0,-84.0,-83.0,-79.0,-80.0,30.0,37.0,37.0,32.0,1
7028,CC:2F:71:3F:1F:24,4726807,1454436664,888266,970316300,3838541,484120364,37,726733,777703968,725990,777614626,743,89342,700502,15,888523,93001,34,549,115556.0,28889.0,-69.0,-70.0,-66.0,-71.0,-69.0,-69.0,-66.0,-71.0,-84.0,-83.0,-79.0,-80.0,15.0,13.0,13.0,9.0,1
7029,CC:2F:71:3E:C5:1F,3839445,484230672,903,110248,3838542,484120424,0,3768,316434,3108,238110,660,78324,956,11,1296,23,0,47,130000.0,39000.0,-70.0,-70.0,-69.0,-60.0,-70.0,-70.0,-68.0,-60.0,-84.0,-83.0,-79.0,-80.0,14.0,13.0,10.0,20.0,1
7030,BA:8C:B9:54:50:24,3843401,490305743,4859,6185319,3838542,484120424,0,9140,1709497,9118,1706002,22,3495,2351,16,5316,40,0,61,216660.0,130000.0,-39.0,-36.0,-45.0,-51.0,-40.0,-35.0,-44.0,-49.0,-84.0,-83.0,-79.0,-80.0,45.0,47.0,34.0,29.0,1
7031,62:47:05:9D:EB:15,3840568,486520006,2019,2398914,3838549,484121092,0,4010,2979688,3979,2974707,31,4981,1983,0,2056,53,0,105,216660.0,130000.0,-46.0,-45.0,-39.0,-45.0,-47.0,-47.0,-39.0,-47.0,-84.0,-83.0,-79.0,-80.0,38.0,38.0,40.0,35.0,1
7032,3C:55:76:E8:8F:1F,3907306,656554836,68757,172433744,3838549,484121092,24,31197,6667487,30808,6600189,389,67298,13701,35,68829,7016,24,394,206470.0,1000.0,-46.0,-56.0,-52.0,-41.0,-44.0,-54.0,-49.0,-38.0,-84.0,-83.0,-79.0,-80.0,38.0,27.0,27.0,39.0,1
7033,92:69:1D:31:68:E9,3842498,487750004,3949,3628912,3838549,484121092,0,4927,1116511,4778,1082731,149,33780,2136,11,4169,90,0,49,216660.0,130000.0,-52.0,-48.0,-44.0,-46.0,-51.0,-47.0,-42.0,-46.0,-84.0,-83.0,-79.0,-80.0,32.0,35.0,35.0,34.0,1
7034,CC:2F:71:3F:1F:24,4727033,1454704295,888484,970583203,3838549,484121092,37,726930,777958533,726187,777869191,743,89342,700694,15,888741,93002,34,549,115556.0,28889.0,-69.0,-70.0,-66.0,-72.0,-69.0,-69.0,-65.0,-71.0,-84.0,-83.0,-79.0,-80.0,15.0,13.0,13.0,8.0,1
7035,CC:2F:71:3E:C5:1F,3839452,484231340,903,110248,3838549,484121092,0,3770,316574,3110,238250,660,78324,956,11,1297,23,0,47,130000.0,39000.0,-70.0,-71.0,-69.0,-60.0,-70.0,-70.0,-68.0,-60.0,-84.0,-83.0,-79.0,-80.0,14.0,12.0,10.0,20.0,1
7036,BA:8C:B9:54:50:24,3843408,490306411,4859,6185319,3838549,484121092,0,9142,1709633,9120,1706138,22,3495,2351,16,5317,40,0,61,216660.0,130000.0,-48.0,-35.0,-43.0,-46.0,-41.0,-35.0,-43.0,-48.0,-84.0,-83.0,-79.0,-80.0,36.0,48.0,36.0,34.0,1
7037,62:47:05:9D:EB:15,3840570,486520208,2019,2398914,3838551,484121294,0,4010,2979688,3979,2974707,31,4981,1983,0,2056,53,0,105,216660.0,130000.0,-46.0,-45.0,-39.0,-45.0,-47.0,-47.0,-39.0,-47.0,-84.0,-83.0,-79.0,-80.0,38.0,38.0,40.0,35.0,1
7038,3C:55:76:E8:8F:1F,3907308,656555038,68757,172433744,3838551,484121294,24,31197,6667487,30808,6600189,389,67298,13701,35,68829,7016,24,394,206470.0,1000.0,-46.0,-56.0,-52.0,-41.0,-44.0,-54.0,-49.0,-38.0,-84.0,-83.0,-79.0,-80.0,38.0,27.0,27.0,39.0,1
7039,92:69:1D:31:68:E9,3842501,487750340,3949,3628912,3838552,484121428,0,4927,1116511,4778,1082731,149,33780,2136,11,4169,90,0,49,216660.0,130000.0,-52.0,-48.0,-44.0,-46.0,-51.0,-47.0,-42.0,-46.0,-84.0,-83.0,-79.0,-80.0,32.0,35.0,35.0,34.0,1
7040,CC:2F:71:3F:1F:24,4727248,1454967681,888695,970846185,3838553,484121496,37,727121,778209375,726378,778120033,743,89342,700879,15,888952,93014,34,549,115556.0,28889.0,-68.0,-70.0,-65.0,-71.0,-68.0,-70.0,-65.0,-70.0,-84.0,-83.0,-79.0,-80.0,16.0,13.0,14.0,9.0,1
7041,CC:2F:71:3E:C5:1F,3839456,484231744,903,110248,3838553,484121496,0,3770,316574,3110,238250,660,78324,956,11,1297,23,0,47,130000.0,39000.0,-70.0,-71.0,-69.0,-60.0,-70.0,-70.0,-68.0,-60.0,-84.0,-83.0,-79.0,-80.0,14.0,12.0,10.0,20.0,1
7042,BA:8C:B9:54:50:24,3843412,490306815,4859,6185319,3838553,484121496,0,9142,1709633,9120,1706138,22,3495,2351,16,5317,40,0,61,216660.0,130000.0,-48.0,-35.0,-43.0,-46.0,-41.0,-35.0,-43.0,-48.0,-84.0,-83.0,-79.0,-80.0,36.0,48.0,36.0,34.0,1
7043,62:47:05:9D:EB:15,3840577,486520874,2019,2398914,3838558,484121960,0,4010,2979688,3979,2974707,31,4981,1983,0,2056,53,0,105,216660.0,130000.0,-46.0,-45.0,-39.0,-45.0,-47.0,-47.0,-39.0,-47.0,-84.0,-83.0,-79.0,-80.0,38.0,38.0,40.0,35.0,1
7044,3C:55:76:E8:8F:1F,3907315,656555704,68757,172433744,3838558,484121960,24,31197,6667487,30808,6600189,389,67298,13701,35,68829,7016,24,394,206470.0,1000.0,-46.0,-56.0,-52.0,-41.0,-44.0,-54.0,-49.0,-38.0,-84.0,-83.0,-79.0,-80.0,38.0,27.0,27.0,39.0,1
7045,92:69:1D:31:68:E9,3842507,487750872,3949,3628912,3838558,484121960,0,4927,1116511,4778,1082731,149,33780,2136,11,4169,90,0,49,216660.0,130000.0,-52.0,-48.0,-44.0,-46.0,-51.0,-47.0,-42.0,-46.0,-84.0,-83.0,-79.0,-80.0,32.0,35.0,35.0,34.0,1
7046,CC:2F:71:3F:1F:24,4727466,1455234235,888908,971112275,3838558,484121960,37,727315,778464587,726572,778375245,743,89342,701067,15,889164,93063,34,549,115556.0,28889.0,-68.0,-70.0,-65.0,-72.0,-68.0,-70.0,-65.0,-69.0,-84.0,-83.0,-79.0,-80.0,16.0,13.0,14.0,8.0,1
7047,CC:2F:71:3E:C5:1F,3839461,484232208,903,110248,3838558,484121960,0,3770,316574,3110,238250,660,78324,956,11,1297,23,0,47,130000.0,39000.0,-70.0,-71.0,-69.0,-60.0,-70.0,-70.0,-68.0,-60.0,-84.0,-83.0,-79.0,-80.0,14.0,12.0,10.0,20.0,1
7048,BA:8C:B9:54:50:24,3843417,490307279,4859,6185319,3838558,484121960,0,9142,1709633,9120,1706138,22,3495,2351,16,5317,40,0,61,216660.0,130000.0,-48.0,-35.0,-43.0,-46.0,-41.0,-35.0,-43.0,-48.0,-84.0,-83.0,-79.0,-80.0,36.0,48.0,36.0,34.0,1
7049,62:47:05:9D:EB:15,3840603,486532233,2019,2398914,3838584,484133319,0,4010,2979688,3979,2974707,31,4981,1983,0,2056,53,0,105,216660.0,130000.0,-46.0,-45.0,-39.0,-45.0,-47.0,-47.0,-39.0,-47.0,-84.0,-83.0,-79.0,-80.0,38.0,38.0,40.0,35.0,1
7050,3C:55:76:E8:8F:1F,3907342,656567131,68757,172433744,3838585,484133387,24,31197,6667487,30808,6600189,389,67298,13701,35,68829,7016,24,394,206470.0,1000.0,-46.0,-56.0,-52.0,-41.0,-44.0,-54.0,-49.0,-38.0,-84.0,-83.0,-79.0,-80.0,38.0,27.0,27.0,39.0,1
7051,92:69:1D:31:68:E9,3842534,487762299,3949,3628912,3838585,484133387,0,4930,1116882,4780,1082867,150,34015,2137,11,4169,90,0,49,216660.0,130000.0,-52.0,-48.0,-44.0,-47.0,-52.0,-48.0,-43.0,-47.0,-84.0,-83.0,-79.0,-80.0,32.0,35.0,35.0,33.0,1
7052,CC:2F:71:3F:1F:24,4727710,1455510192,889123,971376603,3838587,484133589,37,727522,778733459,726779,778644117,743,89342,701258,15,889380,93105,34,549,115556.0,28889.0,-67.0,-70.0,-65.0,-72.0,-67.0,-69.0,-65.0,-70.0,-84.0,-83.0,-79.0,-80.0,17.0,13.0,14.0,8.0,1
7053,CC:2F:71:3E:C5:1F,3839490,484243837,903,110248,3838587,484133589,0,3770,316574,3110,238250,660,78324,956,11,1297,23,0,47,130000.0,39000.0,-70.0,-71.0,-69.0,-60.0,-70.0,-70.0,-68.0,-60.0,-84.0,-83.0,-79.0,-80.0,14.0,12.0,10.0,20.0,1
7054,BA:8C:B9:54:50:24,3843448,490319110,4859,6185319,3838589,484133791,0,9142,1709633,9120,1706138,22,3495,2351,16,5317,40,0,61,216660.0,130000.0,-48.0,-35.0,-43.0,-46.0,-41.0,-35.0,-43.0,-48.0,-84.0,-83.0,-79.0,-80.0,36.0,48.0,36.0,34.0,1
7055,62:47:05:9D:EB:15,3840613,486533649,2023,2399798,3838590,484133851,0,4017,2980538,3986,2975557,31,4981,1986,0,2060,53,0,105,229410.0,130000.0,-48.0,-44.0,-40.0,-46.0,-46.0,-45.0,-40.0,-47.0,-84.0,-83.0,-79.0,-80.0,36.0,39.0,39.0,34.0,1
7056,3C:55:76:E8:8F:1F,3907347,656567595,68757,172433744,3838590,484133851,24,31197,6667487,30808,6600189,389,67298,13701,35,68829,7016,24,394,206470.0,1000.0,-46.0,-56.0,-52.0,-41.0,-44.0,-54.0,-49.0,-38.0,-84.0,-83.0,-79.0,-80.0,38.0,27.0,27.0,39.0,1
7057,92:69:1D:31:68:E9,3842539,487762763,3949,3628912,3838590,484133851,0,4930,1116882,4780,1082867,150,34015,2137,11,4169,90,0,49,216660.0,130000.0,-52.0,-48.0,-44.0,-47.0,-52.0,-48.0,-43.0,-47.0,-84.0,-83.0,-79.0,-80.0,32.0,35.0,35.0,33.0,1
7058,CC:2F:71:3F:1F:24,4727931,1455778749,889341,971644898,3838590,484133851,37,727717,778988821,726974,778899479,743,89342,701448,15,889598,93145,34,549,86667.0,14444.0,-68.0,-70.0,-66.0,-72.0,-67.0,-70.0,-65.0,-72.0,-84.0,-83.0,-79.0,-80.0,16.0,13.0,13.0,8.0,1
7059,CC:2F:71:3E:C5:1F,3839493,484244099,903,110248,3838590,484133851,0,3770,316574,3110,238250,660,78324,956,11,1297,23,0,47,130000.0,39000.0,-70.0,-71.0,-69.0,-60.0,-70.0,-70.0,-68.0,-60.0,-84.0,-83.0,-79.0,-80.0,14.0,12.0,10.0,20.0,1
7060,BA:8C:B9:54:50:24,3843450,490319443,4859,6185319,3838591,484134124,0,9142,1709633,9120,1706138,22,3495,2351,16,5317,40,0,61,216660.0,130000.0,-48.0,-35.0,-43.0,-46.0,-41.0,-35.0,-43.0,-48.0,-84.0,-83.0,-79.0,-80.0,36.0,48.0,36.0,34.0,1
7061,62:47:05:9D:EB:15,3840620,486534528,2023,2399798,3838597,484134730,0,4017,2980538,3986,2975557,31,4981,1986,0,2060,53,0,105,229410.0,130000.0,-48.0,-44.0,-40.0,-46.0,-46.0,-45.0,-40.0,-47.0,-84.0,-83.0,-79.0,-80.0,36.0,39.0,39.0,34.0,1
7062,3C:55:76:E8:8F:1F,3907356,656568676,68757,172433744,3838599,484134932,24,31197,6667487,30808,6600189,389,67298,13701,35,68829,7016,24,394,206470.0,1000.0,-46.0,-56.0,-52.0,-41.0,-44.0,-54.0,-49.0,-38.0,-84.0,-83.0,-79.0,-80.0,38.0,27.0,27.0,39.0,1
7063,92:69:1D:31:68:E9,3842548,487763844,3949,3628912,3838599,484134932,0,4930,1116882,4780,1082867,150,34015,2137,11,4169,90,0,49,216660.0,130000.0,-52.0,-48.0,-44.0,-47.0,-52.0,-48.0,-43.0,-47.0,-84.0,-83.0,-79.0,-80.0,32.0,35.0,35.0,33.0,1
7064,CC:2F:71:3F:1F:24,4728154,1456048730,889555,971913798,3838599,484134932,37,727912,779246991,727169,779157649,743,89342,701639,15,889812,93147,34,549,104000.0,26000.0,-68.0,-70.0,-65.0,-75.0,-68.0,-70.0,-65.0,-74.0,-84.0,-83.0,-79.0,-80.0,16.0,13.0,14.0,5.0,1
7065,CC:2F:71:3E:C5:1F,3839502,484245180,903,110248,3838599,484134932,0,3770,316574,3110,238250,660,78324,956,11,1297,23,0,47,130000.0,39000.0,-70.0,-71.0,-69.0,-60.0,-70.0,-70.0,-68.0,-60.0,-84.0,-83.0,-79.0,-80.0,14.0,12.0,10.0,20.0,1
7066,BA:8C:B9:54:50:24,3843458,490320251,4859,6185319,3838599,484134932,0,9142,1709633,9120,1706138,22,3495,2351,16,5317,40,0,61,216660.0,130000.0,-48.0,-35.0,-43.0,-46.0,-41.0,-35.0,-43.0,-48.0,-84.0,-83.0,-79.0,-80.0,36.0,48.0,36.0,34.0,1
7067,62:47:05:9D:EB:15,3840622,486534730,2023,2399798,3838599,484134932,0,4017,2980538,3986,2975557,31,4981,1986,0,2060,53,0,105,229410.0,130000.0,-48.0,-44.0,-40.0,-46.0,-46.0,-45.0,-40.0,-47.0,-84.0,-83.0,-79.0,-80.0,36.0,39.0,39.0,34.0,1
7068,3C:55:76:E8:8F:1F,3907356,656568676,68757,172433744,3838599,484134932,24,31197,6667487,30808,6600189,389,67298,13701,35,68829,7016,24,394,206470.0,1000.0,-46.0,-56.0,-52.0,-41.0,-44.0,-54.0,-49.0,-38.0,-84.0,-83.0,-79.0,-80.0,38.0,27.0,27.0,39.0,1
7069,92:69:1D:31:68:E9,3842551,487764106,3949,3628912,3838602,484135194,0,4930,1116882,4780,1082867,150,34015,2137,11,4169,90,0,49,216660.0,130000.0,-52.0,-48.0,-44.0,-47.0,-52.0,-48.0,-43.0,-47.0,-84.0,-83.0,-79.0,-80.0,32.0,35.0,35.0,33.0,1
7070,CC:2F:71:3F:1F:24,4728373,1456323512,889771,972188318,3838602,484135194,37,728112,779514353,727369,779425011,743,89342,701832,15,890028,93178,34,549,86667.0,14444.0,-69.0,-72.0,-66.0,-74.0,-69.0,-72.0,-66.0,-74.0,-84.0,-83.0,-79.0,-80.0,15.0,11.0,13.0,6.0,1
7071,CC:2F:71:3E:C5:1F,3839505,484245442,903,110248,3838602,484135194,0,3770,316574,3110,238250,660,78324,956,11,1297,23,0,47,130000.0,39000.0,-70.0,-71.0,-69.0,-60.0,-70.0,-70.0,-68.0,-60.0,-84.0,-83.0,-79.0,-80.0,14.0,12.0,10.0,20.0,1
7072,BA:8C:B9:54:50:24,3843461,490320513,4859,6185319,3838602,484135194,0,9142,1709633,9120,1706138,22,3495,2351,16,5317,40,0,61,216660.0,130000.0,-48.0,-35.0,-43.0,-46.0,-41.0,-35.0,-43.0,-48.0,-84.0,-83.0,-79.0,-80.0,36.0,48.0,36.0,34.0,1
7073,62:47:05:9D:EB:15,3840633,486535966,2023,2399798,3838610,484136168,0,4017,2980538,3986,2975557,31,4981,1986,0,2060,53,0,105,229410.0,130000.0,-48.0,-44.0,-40.0,-46.0,-46.0,-45.0,-40.0,-47.0,-84.0,-83.0,-79.0,-80.0,36.0,39.0,39.0,34.0,1
7074,3C:55:76:E8:8F:1F,3907367,656569912,68757,172433744,3838610,484136168,24,31197,6667487,30808,6600189,389,67298,13701,35,68829,7016,24,394,206470.0,1000.0,-46.0,-56.0,-52.0,-41.0,-44.0,-54.0,-49.0,-38.0,-84.0,-83.0,-79.0,-80.0,38.0,27.0,27.0,39.0,1
7075,92:69:1D:31:68:E9,3842559,487765080,3949,3628912,3838610,484136168,0,4930,1116882,4780,1082867,150,34015,2137,11,4169,90,0,49,216660.0,130000.0,-52.0,-48.0,-44.0,-47.0,-52.0,-48.0,-43.0,-47.0,-84.0,-83.0,-79.0,-80.0,32.0,35.0,35.0,33.0,1
7076,CC:2F:71:3F:1F:24,4728599,1456593564,889989,972457396,3838610,484136168,37,728308,779767493,727565,779678151,743,89342,702024,15,890246,93178,34,549,86667.0,14444.0,-68.0,-71.0,-67.0,-73.0,-68.0,-71.0,-66.0,-72.0,-84.0,-83.0,-79.0,-80.0,16.0,12.0,12.0,7.0,1
7077,CC:2F:71:3E:C5:1F,3839513,484246416,903,110248,3838610,484136168,0,3770,316574,3110,238250,660,78324,956,11,1297,23,0,47,130000.0,39000.0,-70.0,-71.0,-69.0,-60.0,-70.0,-70.0,-68.0,-60.0,-84.0,-83.0,-79.0,-80.0,14.0,12.0,10.0,20.0,1
7078,BA:8C:B9:54:50:24,3843469,490321487,4859,6185319,3838610,484136168,0,9142,1709633,9120,1706138,22,3495,2351,16,5317,40,0,61,216660.0,130000.0,-48.0,-35.0,-43.0,-46.0,-41.0,-35.0,-43.0,-48.0,-84.0,-83.0,-79.0,-80.0,36.0,48.0,36.0,34.0,1
7079,62:47:05:9D:EB:15,3840635,486536168,2023,2399798,3838612,484136370,0,4019,2980674,3988,2975693,31,4981,1986,0,2060,53,0,105,229410.0,130000.0,-45.0,-45.0,-39.0,-46.0,-46.0,-45.0,-40.0,-47.0,-84.0,-83.0,-79.0,-80.0,39.0,38.0,40.0,34.0,1
7080,3C:55:76:E8:8F:1F,3907370,656570207,68758,172433837,3838612,484136370,25,31207,6668278,30818,6600980,389,67298,13703,35,68830,7022,25,395,206470.0,97500.0,-46.0,-55.0,-52.0,-40.0,-46.0,-55.0,-50.0,-40.0,-84.0,-83.0,-79.0,-80.0,38.0,28.0,27.0,40.0,1
7081,92:69:1D:31:68:E9,3842561,487765282,3949,3628912,3838612,484136370,0,4930,1116882,4780,1082867,150,34015,2137,11,4169,90,0,49,216660.0,130000.0,-52.0,-48.0,-44.0,-47.0,-52.0,-48.0,-43.0,-47.0,-84.0,-83.0,-79.0,-80.0,32.0,35.0,35.0,33.0,1
7082,CC:2F:71:3F:1F:24,4728807,1456853082,890195,972716712,3838612,484136370,37,728497,780020681,727754,779931339,743,89342,702205,15,890450,93191,34,549,115556.0,28889.0,-69.0,-71.0,-67.0,-73.0,-68.0,-71.0,-66.0,-72.0,-84.0,-83.0,-79.0,-80.0,15.0,12.0,12.0,7.0,1
7083,CC:2F:71:3E:C5:1F,3839515,484246618,903,110248,3838612,484136370,0,3770,316574,3110,238250,660,78324,956,11,1297,23,0,47,130000.0,39000.0,-70.0,-71.0,-69.0,-60.0,-70.0,-70.0,-68.0,-60.0,-84.0,-83.0,-79.0,-80.0,14.0,12.0,10.0,20.0,1
7084,BA:8C:B9:54:50:24,3843473,490321891,4859,6185319,3838614,484136572,0,9142,1709633,9120,1706138,22,3495,2351,16,5317,40,0,61,216660.0,130000.0,-48.0,-35.0,-43.0,-46.0,-41.0,-35.0,-43.0,-48.0,-84.0,-83.0,-79.0,-80.0,36.0,48.0,36.0,34.0,1
