sample,station,tx_total_pkts,tx_total_bytes,tx_ucast_pkts,tx_ucast_bytes,tx_mcast_bcast_pkts,tx_mcast_bcast_bytes,tx_failures,rx_data_pkts,rx_data_bytes,rx_ucast_pkts,rx_ucast_bytes,rx_mcast_bcast_pkts,rx_mcast_bcast_bytes,rx_decrypt_succeeds,tx_data_pkts_retried,tx_total_pkts_sent,tx_pkts_retries,tx_pkts_retry_exhausted,rx_total_pkts_retried,rate_last_tx_pkt_min,rate_last_tx_pkt_max,per_antenna_rssi_last_rx_data_frame_1,per_antenna_rssi_last_rx_data_frame_2,per_antenna_rssi_last_rx_data_frame_3,per_antenna_rssi_last_rx_data_frame_4,per_antenna_avg_rssi_rx_data_frames_1,per_antenna_avg_rssi_rx_data_frames_2,per_antenna_avg_rssi_rx_data_frames_3,per_antenna_avg_rssi_rx_data_frames_4,per_antenna_noise_floor_1,per_antenna_noise_floor_2,per_antenna_noise_floor_3,per_antenna_noise_floor_4,sinr_per_antenna_1,sinr_per_antenna_2,sinr_per_antenna_3,sinr_per_antenna_4,attack
1,62:47:05:9D:EB:15,3856810,497817924,7029,12301999,3849781,485515925,1,7467,3908256,7417,3900598,50,7658,3572,0,7107,56,1,126,216660.0,130000.0,-43.0,-45.0,-35.0,-47.0,-43.0,-45.0,-36.0,-48.0,-90.0,-93.0,-89.0,-92.0,47.0,48.0,54.0,45.0,1
2,92:69:1D:31:68:E9,3853959,489220854,4178,3704929,3849781,485515925,1,5697,1227401,5519,1186903,178,40498,2316,12,4445,104,1,65,216660.0,130000.0,-51.0,-48.0,-45.0,-47.0,-51.0,-47.0,-43.0,-48.0,-90.0,-93.0,-89.0,-92.0,39.0,45.0,44.0,45.0,1
3,CC:2F:71:3F:1F:24,5140412,1980931410,1290631,1495415485,3849781,485515925,2222,1089085,1253044687,1088218,1252939727,867,104960,1053863,15,1288764,122735,2219,832,144444.0,43333.0,-71.0,-69.0,-67.0,-73.0,-71.0,-69.0,-66.0,-73.0,-90.0,-93.0,-89.0,-92.0,19.0,24.0,22.0,19.0,1
4,CC:2F:71:3E:C5:1F,3850801,485640624,1020,124699,3849781,485515925,3,4458,371605,3718,283755,740,87850,1079,14,1467,30,3,54,130000.0,39000.0,-72.0,-72.0,-70.0,-60.0,-71.0,-71.0,-70.0,-60.0,-90.0,-93.0,-89.0,-92.0,18.0,21.0,19.0,32.0,1
5,BA:8C:B9:54:50:24,3854736,491712601,4955,6196676,3849781,485515925,7,9969,1766580,9947,1763085,22,3495,2361,18,5476,44,7,77,216660.0,130000.0,-40.0,-37.0,-45.0,-52.0,-44.0,-36.0,-44.0,-48.0,-90.0,-93.0,-89.0,-92.0,50.0,56.0,44.0,40.0,1
6,62:47:05:9D:EB:15,3856813,497818186,7029,12301999,3849784,485516187,1,7467,3908256,7417,3900598,50,7658,3572,0,7107,56,1,126,216660.0,130000.0,-43.0,-45.0,-35.0,-47.0,-43.0,-45.0,-36.0,-48.0,-90.0,-93.0,-89.0,-93.0,47.0,48.0,54.0,46.0,1
7,92:69:1D:31:68:E9,3853962,489221116,4178,3704929,3849784,485516187,1,5697,1227401,5519,1186903,178,40498,2316,12,4445,104,1,65,216660.0,130000.0,-51.0,-48.0,-45.0,-47.0,-51.0,-47.0,-43.0,-48.0,-90.0,-93.0,-89.0,-93.0,39.0,45.0,44.0,46.0,1
8,CC:2F:71:3F:1F:24,5140604,1981172834,1290820,1495656647,3849784,485516187,2222,1089256,1253274071,1088389,1253169111,867,104960,1054034,15,1288955,122737,2219,832,144444.0,43333.0,-71.0,-68.0,-67.0,-73.0,-71.0,-68.0,-66.0,-73.0,-90.0,-93.0,-89.0,-93.0,19.0,25.0,22.0,20.0,1
9,CC:2F:71:3E:C5:1F,3850804,485640886,1020,124699,3849784,485516187,3,4458,371605,3718,283755,740,87850,1079,14,1467,30,3,54,130000.0,39000.0,-72.0,-72.0,-70.0,-60.0,-71.0,-71.0,-70.0,-60.0,-90.0,-93.0,-89.0,-93.0,18.0,21.0,19.0,33.0,1
10,BA:8C:B9:54:50:24,3854743,491713267,4955,6196676,3849788,485516591,7,9969,1766580,9947,1763085,22,3495,2361,18,5476,44,7,77,216660.0,130000.0,-40.0,-37.0,-45.0,-52.0,-44.0,-36.0,-44.0,-48.0,-90.0,-93.0,-89.0,-93.0,50.0,56.0,44.0,41.0,1
11,62:47:05:9D:EB:15,3856819,497818792,7029,12301999,3849790,485516793,1,7467,3908256,7417,3900598,50,7658,3572,0,7107,56,1,126,216660.0,130000.0,-43.0,-45.0,-35.0,-47.0,-43.0,-45.0,-36.0,-48.0,-90.0,-93.0,-89.0,-93.0,47.0,48.0,54.0,46.0,1
12,92:69:1D:31:68:E9,3853968,489221722,4178,3704929,3849790,485516793,1,5697,1227401,5519,1186903,178,40498,2316,12,4445,104,1,65,216660.0,130000.0,-51.0,-48.0,-45.0,-47.0,-51.0,-47.0,-43.0,-48.0,-90.0,-93.0,-89.0,-93.0,39.0,45.0,44.0,46.0,1
13,CC:2F:71:3F:1F:24,5140802,1981417840,1291012,1495901047,3849790,485516793,2222,1089427,1253503525,1088560,1253398565,867,104960,1054205,15,1289147,122738,2219,832,144444.0,43333.0,-71.0,-68.0,-66.0,-73.0,-71.0,-68.0,-66.0,-73.0,-90.0,-93.0,-89.0,-93.0,19.0,25.0,23.0,20.0,1
14,CC:2F:71:3E:C5:1F,3850810,485641492,1020,124699,3849790,485516793,3,4458,371605,3718,283755,740,87850,1079,14,1467,30,3,54,130000.0,39000.0,-72.0,-72.0,-70.0,-60.0,-71.0,-71.0,-70.0,-60.0,-90.0,-93.0,-89.0,-93.0,18.0,21.0,19.0,33.0,1
15,BA:8C:B9:54:50:24,3854745,491713469,4955,6196676,3849790,485516793,7,9969,1766580,9947,1763085,22,3495,2361,18,5476,44,7,77,216660.0,130000.0,-40.0,-37.0,-45.0,-52.0,-44.0,-36.0,-44.0,-48.0,-90.0,-93.0,-89.0,-93.0,50.0,56.0,44.0,41.0,1
16,62:47:05:9D:EB:15,3856822,497819056,7029,12301999,3849793,485517057,1,7467,3908256,7417,3900598,50,7658,3572,0,7107,56,1,126,216660.0,130000.0,-43.0,-45.0,-35.0,-47.0,-43.0,-45.0,-36.0,-48.0,-90.0,-93.0,-89.0,-93.0,47.0,48.0,54.0,46.0,1
17,92:69:1D:31:68:E9,3853971,489221986,4178,3704929,3849793,485517057,1,5697,1227401,5519,1186903,178,40498,2316,12,4445,104,1,65,216660.0,130000.0,-51.0,-48.0,-45.0,-47.0,-51.0,-47.0,-43.0,-48.0,-90.0,-93.0,-89.0,-93.0,39.0,45.0,44.0,46.0,1
18,CC:2F:71:3F:1F:24,5141009,1981666495,1291212,1496149034,3849797,485517461,2222,1089602,1253730979,1088735,1253626019,867,104960,1054380,15,1289347,122739,2219,832,144444.0,43333.0,-72.0,-69.0,-67.0,-75.0,-72.0,-69.0,-66.0,-74.0,-89.0,-92.0,-89.0,-92.0,17.0,23.0,22.0,17.0,1
19,CC:2F:71:3E:C5:1F,3850817,485642160,1020,124699,3849797,485517461,3,4460,371793,3719,283825,741,87968,1080,14,1467,30,3,54,130000.0,39000.0,-72.0,-72.0,-70.0,-60.0,-71.0,-71.0,-70.0,-60.0,-89.0,-92.0,-89.0,-92.0,17.0,20.0,19.0,32.0,1
20,BA:8C:B9:54:50:24,3854754,491714331,4955,6196676,3849799,485517655,7,9969,1766580,9947,1763085,22,3495,2361,18,5476,44,7,77,216660.0,130000.0,-40.0,-37.0,-45.0,-52.0,-44.0,-36.0,-44.0,-48.0,-89.0,-92.0,-89.0,-92.0,49.0,55.0,44.0,40.0,1
21,62:47:05:9D:EB:15,3856829,497819722,7029,12301999,3849800,485517723,1,7467,3908256,7417,3900598,50,7658,3572,0,7107,56,1,126,216660.0,130000.0,-43.0,-45.0,-35.0,-47.0,-43.0,-45.0,-36.0,-48.0,-89.0,-92.0,-89.0,-92.0,46.0,47.0,54.0,45.0,1
22,92:69:1D:31:68:E9,3853978,489222652,4178,3704929,3849800,485517723,1,5697,1227401,5519,1186903,178,40498,2316,12,4445,104,1,65,216660.0,130000.0,-51.0,-48.0,-45.0,-47.0,-51.0,-47.0,-43.0,-48.0,-89.0,-92.0,-89.0,-92.0,38.0,44.0,44.0,45.0,1
23,CC:2F:71:3F:1F:24,5141203,1981911011,1291403,1496393288,3849800,485517723,2222,1089777,1253965147,1088910,1253860187,867,104960,1054553,15,1289538,122741,2219,832,144444.0,43333.0,-76.0,-73.0,-70.0,-79.0,-75.0,-72.0,-70.0,-78.0,-89.0,-92.0,-89.0,-92.0,13.0,19.0,19.0,13.0,1
24,CC:2F:71:3E:C5:1F,3850820,485642422,1020,124699,3849800,485517723,3,4460,371793,3719,283825,741,87968,1080,14,1467,30,3,54,130000.0,39000.0,-72.0,-72.0,-70.0,-60.0,-71.0,-71.0,-70.0,-60.0,-89.0,-92.0,-89.0,-92.0,17.0,20.0,19.0,32.0,1
25,BA:8C:B9:54:50:24,3854755,491714399,4955,6196676,3849800,485517723,7,9969,1766580,9947,1763085,22,3495,2361,18,5476,44,7,77,216660.0,130000.0,-40.0,-37.0,-45.0,-52.0,-44.0,-36.0,-44.0,-48.0,-89.0,-92.0,-89.0,-92.0,49.0,55.0,44.0,40.0,1
26,62:47:05:9D:EB:15,3856833,497820126,7029,12301999,3849804,485518127,1,7468,3908324,7418,3900666,50,7658,3572,0,7108,56,1,126,216660.0,130000.0,-43.0,-46.0,-36.0,-47.0,-43.0,-45.0,-36.0,-48.0,-89.0,-92.0,-89.0,-92.0,46.0,46.0,53.0,45.0,1
27,92:69:1D:31:68:E9,3853983,489223190,4178,3704929,3849805,485518261,1,5699,1227537,5521,1187039,178,40498,2316,12,4446,104,1,65,216660.0,130000.0,-51.0,-48.0,-45.0,-49.0,-51.0,-47.0,-43.0,-48.0,-89.0,-92.0,-89.0,-92.0,38.0,44.0,44.0,43.0,1
28,CC:2F:71:3F:1F:24,5141398,1982152763,1291592,1496634434,3849806,485518329,2222,1089945,1254191307,1089078,1254086347,867,104960,1054721,15,1289727,122741,2219,832,144444.0,43333.0,-71.0,-70.0,-67.0,-74.0,-71.0,-70.0,-67.0,-74.0,-89.0,-92.0,-89.0,-92.0,18.0,22.0,22.0,18.0,1
29,CC:2F:71:3E:C5:1F,3850826,485643028,1020,124699,3849806,485518329,3,4460,371793,3719,283825,741,87968,1080,14,1467,30,3,54,130000.0,39000.0,-72.0,-72.0,-70.0,-60.0,-71.0,-71.0,-70.0,-60.0,-89.0,-92.0,-89.0,-92.0,17.0,20.0,19.0,32.0,1
30,BA:8C:B9:54:50:24,3854763,491715207,4955,6196676,3849808,485518531,7,9971,1766716,9949,1763221,22,3495,2361,18,5477,44,7,77,216660.0,130000.0,-48.0,-35.0,-43.0,-45.0,-44.0,-36.0,-44.0,-48.0,-89.0,-92.0,-89.0,-92.0,41.0,57.0,46.0,47.0,1
31,62:47:05:9D:EB:15,3856838,497820590,7029,12301999,3849809,485518591,1,7469,3908392,7419,3900734,50,7658,3572,0,7108,56,1,126,216660.0,130000.0,-43.0,-46.0,-38.0,-48.0,-43.0,-45.0,-36.0,-47.0,-89.0,-92.0,-89.0,-92.0,46.0,46.0,51.0,44.0,1
32,92:69:1D:31:68:E9,3853987,489223520,4178,3704929,3849809,485518591,1,5699,1227537,5521,1187039,178,40498,2316,12,4446,104,1,65,216660.0,130000.0,-51.0,-48.0,-45.0,-49.0,-51.0,-47.0,-43.0,-48.0,-89.0,-92.0,-89.0,-92.0,38.0,44.0,44.0,43.0,1
33,CC:2F:71:3F:1F:24,5141592,1982394431,1291783,1496875840,3849809,485518591,2222,1090117,1254420835,1089250,1254315875,867,104960,1054891,15,1289918,122743,2219,832,144444.0,43333.0,-75.0,-73.0,-71.0,-79.0,-74.0,-72.0,-69.0,-78.0,-89.0,-92.0,-89.0,-92.0,14.0,19.0,18.0,13.0,1
34,CC:2F:71:3E:C5:1F,3850829,485643290,1020,124699,3849809,485518591,3,4460,371793,3719,283825,741,87968,1080,14,1467,30,3,54,130000.0,39000.0,-72.0,-72.0,-70.0,-60.0,-71.0,-71.0,-70.0,-60.0,-89.0,-92.0,-89.0,-92.0,17.0,20.0,19.0,32.0,1
35,BA:8C:B9:54:50:24,3854764,491715267,4955,6196676,3849809,485518591,7,9971,1766716,9949,1763221,22,3495,2361,18,5477,44,7,77,216660.0,130000.0,-48.0,-35.0,-43.0,-45.0,-44.0,-36.0,-44.0,-48.0,-89.0,-92.0,-89.0,-92.0,41.0,57.0,46.0,47.0,1
36,62:47:05:9D:EB:15,3856842,497820994,7029,12301999,3849813,485518995,1,7469,3908392,7419,3900734,50,7658,3572,0,7108,56,1,126,216660.0,130000.0,-43.0,-46.0,-38.0,-48.0,-43.0,-45.0,-36.0,-47.0,-89.0,-92.0,-89.0,-92.0,46.0,46.0,51.0,44.0,1
37,92:69:1D:31:68:E9,3853991,489223924,4178,3704929,3849813,485518995,1,5699,1227537,5521,1187039,178,40498,2316,12,4446,104,1,65,216660.0,130000.0,-51.0,-48.0,-45.0,-49.0,-51.0,-47.0,-43.0,-48.0,-89.0,-92.0,-89.0,-92.0,38.0,44.0,44.0,43.0,1
38,CC:2F:71:3F:1F:24,5141791,1982639551,1291976,1497120354,3849815,485519197,2222,1090291,1254651977,1089424,1254547017,867,104960,1055064,15,1290111,122744,2219,832,144444.0,43333.0,-71.0,-70.0,-67.0,-76.0,-71.0,-70.0,-67.0,-76.0,-89.0,-92.0,-89.0,-92.0,18.0,22.0,22.0,16.0,1
39,CC:2F:71:3E:C5:1F,3850838,485644371,1020,124699,3849818,485519672,3,4460,371793,3719,283825,741,87968,1080,14,1467,30,3,54,130000.0,39000.0,-72.0,-72.0,-70.0,-60.0,-71.0,-71.0,-70.0,-60.0,-89.0,-92.0,-89.0,-92.0,17.0,20.0,19.0,32.0,1
40,BA:8C:B9:54:50:24,3854773,491716348,4955,6196676,3849818,485519672,7,9971,1766716,9949,1763221,22,3495,2361,18,5477,44,7,77,216660.0,130000.0,-48.0,-35.0,-43.0,-45.0,-44.0,-36.0,-44.0,-48.0,-89.0,-92.0,-89.0,-92.0,41.0,57.0,46.0,47.0,1
41,62:47:05:9D:EB:15,3856847,497821671,7029,12301999,3849818,485519672,1,7469,3908392,7419,3900734,50,7658,3572,0,7108,56,1,126,216660.0,130000.0,-43.0,-46.0,-38.0,-48.0,-43.0,-45.0,-36.0,-47.0,-89.0,-92.0,-89.0,-92.0,46.0,46.0,51.0,44.0,1
42,92:69:1D:31:68:E9,3853996,489224601,4178,3704929,3849818,485519672,1,5699,1227537,5521,1187039,178,40498,2316,12,4446,104,1,65,216660.0,130000.0,-51.0,-48.0,-45.0,-49.0,-51.0,-47.0,-43.0,-48.0,-89.0,-92.0,-89.0,-92.0,38.0,44.0,44.0,43.0,1
43,CC:2F:71:3F:1F:24,5141996,1982891105,1292178,1497371433,3849818,485519672,2222,1090471,1254884282,1089604,1254779322,867,104960,1055244,15,1290313,122744,2219,832,144444.0,43333.0,-71.0,-70.0,-67.0,-76.0,-71.0,-70.0,-67.0,-75.0,-89.0,-92.0,-89.0,-92.0,18.0,22.0,22.0,16.0,1
44,CC:2F:71:3E:C5:1F,3850838,485644371,1020,124699,3849818,485519672,3,4460,371793,3719,283825,741,87968,1080,14,1467,30,3,54,130000.0,39000.0,-72.0,-72.0,-70.0,-60.0,-71.0,-71.0,-70.0,-60.0,-89.0,-92.0,-89.0,-92.0,17.0,20.0,19.0,32.0,1
45,BA:8C:B9:54:50:24,3854774,491716408,4955,6196676,3849819,485519732,7,9971,1766716,9949,1763221,22,3495,2361,18,5477,44,7,77,216660.0,130000.0,-48.0,-35.0,-43.0,-45.0,-44.0,-36.0,-44.0,-48.0,-89.0,-92.0,-89.0,-92.0,41.0,57.0,46.0,47.0,1
46,62:47:05:9D:EB:15,3856854,497822337,7029,12301999,3849825,485520338,1,7469,3908392,7419,3900734,50,7658,3572,0,7108,56,1,126,216660.0,130000.0,-43.0,-46.0,-38.0,-48.0,-43.0,-45.0,-36.0,-47.0,-89.0,-92.0,-89.0,-92.0,46.0,46.0,51.0,44.0,1
47,92:69:1D:31:68:E9,3854003,489225267,4178,3704929,3849825,485520338,1,5699,1227537,5521,1187039,178,40498,2316,12,4446,104,1,65,216660.0,130000.0,-51.0,-48.0,-45.0,-49.0,-51.0,-47.0,-43.0,-48.0,-89.0,-92.0,-89.0,-92.0,38.0,44.0,44.0,43.0,1
48,CC:2F:71:3F:1F:24,5142197,1983136357,1292370,1497615817,3849827,485520540,2222,1090642,1255113714,1089775,1255008754,867,104960,1055413,15,1290505,122744,2219,832,144444.0,43333.0,-71.0,-69.0,-67.0,-74.0,-71.0,-69.0,-67.0,-74.0,-89.0,-92.0,-89.0,-92.0,18.0,23.0,22.0,18.0,1
49,CC:2F:71:3E:C5:1F,3850847,485645239,1020,124699,3849827,485520540,3,4460,371793,3719,283825,741,87968,1080,14,1467,30,3,54,130000.0,39000.0,-72.0,-72.0,-70.0,-60.0,-71.0,-71.0,-70.0,-60.0,-89.0,-92.0,-89.0,-92.0,17.0,20.0,19.0,32.0,1
50,BA:8C:B9:54:50:24,3854782,491717216,4955,6196676,3849827,485520540,7,9971,1766716,9949,1763221,22,3495,2361,18,5477,44,7,77,216660.0,130000.0,-48.0,-35.0,-43.0,-45.0,-44.0,-36.0,-44.0,-48.0,-89.0,-92.0,-89.0,-92.0,41.0,57.0,46.0,47.0,1
51,62:47:05:9D:EB:15,3856856,497822539,7029,12301999,3849827,485520540,1,7469,3908392,7419,3900734,50,7658,3572,0,7108,56,1,126,216660.0,130000.0,-43.0,-46.0,-38.0,-48.0,-43.0,-45.0,-36.0,-47.0,-89.0,-92.0,-89.0,-92.0,46.0,46.0,51.0,44.0,1
52,92:69:1D:31:68:E9,3854005,489225469,4178,3704929,3849827,485520540,1,5699,1227537,5521,1187039,178,40498,2316,12,4446,104,1,65,216660.0,130000.0,-51.0,-48.0,-45.0,-49.0,-51.0,-47.0,-43.0,-48.0,-89.0,-92.0,-89.0,-92.0,38.0,44.0,44.0,43.0,1
53,CC:2F:71:3F:1F:24,5142386,1983378943,1292559,1497858403,3849827,485520540,2222,1090813,1255343070,1089946,1255238110,867,104960,1055584,15,1290693,122744,2219,832,144444.0,43333.0,-71.0,-68.0,-66.0,-74.0,-71.0,-68.0,-66.0,-74.0,-89.0,-92.0,-89.0,-92.0,18.0,24.0,23.0,18.0,1
54,CC:2F:71:3E:C5:1F,3850847,485645239,1020,124699,3849827,485520540,3,4460,371793,3719,283825,741,87968,1080,14,1467,30,3,54,130000.0,39000.0,-72.0,-72.0,-70.0,-60.0,-71.0,-71.0,-70.0,-60.0,-89.0,-92.0,-89.0,-92.0,17.0,20.0,19.0,32.0,1
55,BA:8C:B9:54:50:24,3854784,491717418,4955,6196676,3849829,485520742,7,9971,1766716,9949,1763221,22,3495,2361,18,5477,44,7,77,216660.0,130000.0,-48.0,-35.0,-43.0,-45.0,-44.0,-36.0,-44.0,-48.0,-89.0,-92.0,-89.0,-92.0,41.0,57.0,46.0,47.0,1
56,62:47:05:9D:EB:15,3856865,497823407,7029,12301999,3849836,485521408,1,7469,3908392,7419,3900734,50,7658,3572,0,7108,56,1,126,216660.0,130000.0,-43.0,-46.0,-38.0,-48.0,-43.0,-45.0,-36.0,-47.0,-89.0,-92.0,-89.0,-92.0,46.0,46.0,51.0,44.0,1
57,92:69:1D:31:68:E9,3854014,489226337,4178,3704929,3849836,485521408,1,5699,1227537,5521,1187039,178,40498,2316,12,4446,104,1,65,216660.0,130000.0,-51.0,-48.0,-45.0,-49.0,-51.0,-47.0,-43.0,-48.0,-89.0,-92.0,-89.0,-92.0,38.0,44.0,44.0,43.0,1
58,CC:2F:71:3F:1F:24,5142586,1983622489,1292750,1498101081,3849836,485521408,2222,1090983,1255570900,1090116,1255465940,867,104960,1055753,15,1290885,122745,2219,832,144444.0,43333.0,-71.0,-68.0,-67.0,-73.0,-71.0,-68.0,-67.0,-73.0,-89.0,-92.0,-89.0,-92.0,18.0,24.0,22.0,19.0,1
59,CC:2F:71:3E:C5:1F,3850856,485646107,1020,124699,3849836,485521408,3,4460,371793,3719,283825,741,87968,1080,14,1467,30,3,54,130000.0,39000.0,-72.0,-72.0,-70.0,-60.0,-71.0,-71.0,-70.0,-60.0,-89.0,-92.0,-89.0,-92.0,17.0,20.0,19.0,32.0,1
60,BA:8C:B9:54:50:24,3854791,491718084,4955,6196676,3849836,485521408,7,9971,1766716,9949,1763221,22,3495,2361,18,5477,44,7,77,216660.0,130000.0,-48.0,-35.0,-43.0,-45.0,-44.0,-36.0,-44.0,-48.0,-89.0,-92.0,-89.0,-92.0,41.0,57.0,46.0,47.0,1
61,62:47:05:9D:EB:15,3856865,497823407,7029,12301999,3849836,485521408,1,7469,3908392,7419,3900734,50,7658,3572,0,7108,56,1,126,216660.0,130000.0,-43.0,-46.0,-38.0,-48.0,-43.0,-45.0,-36.0,-47.0,-89.0,-92.0,-89.0,-92.0,46.0,46.0,51.0,44.0,1
62,92:69:1D:31:68:E9,3854014,489226337,4178,3704929,3849836,485521408,1,5699,1227537,5521,1187039,178,40498,2316,12,4446,104,1,65,216660.0,130000.0,-51.0,-48.0,-45.0,-49.0,-51.0,-47.0,-43.0,-48.0,-89.0,-92.0,-89.0,-92.0,38.0,44.0,44.0,43.0,1
63,CC:2F:71:3F:1F:24,5142778,1983866889,1292942,1498345481,3849836,485521408,2222,1091156,1255800488,1090289,1255695528,867,104960,1055926,15,1291077,122745,2219,832,144444.0,43333.0,-71.0,-68.0,-66.0,-73.0,-71.0,-68.0,-66.0,-73.0,-89.0,-92.0,-89.0,-92.0,18.0,24.0,23.0,19.0,1
64,CC:2F:71:3E:C5:1F,3850858,485646309,1020,124699,3849838,485521610,3,4460,371793,3719,283825,741,87968,1080,14,1467,30,3,54,130000.0,39000.0,-72.0,-72.0,-70.0,-60.0,-71.0,-71.0,-70.0,-60.0,-89.0,-92.0,-89.0,-92.0,17.0,20.0,19.0,32.0,1
65,BA:8C:B9:54:50:24,3854793,491718286,4955,6196676,3849838,485521610,7,9971,1766716,9949,1763221,22,3495,2361,18,5477,44,7,77,216660.0,130000.0,-48.0,-35.0,-43.0,-45.0,-44.0,-36.0,-44.0,-48.0,-89.0,-92.0,-89.0,-92.0,41.0,57.0,46.0,47.0,1
66,62:47:05:9D:EB:15,3856873,497824215,7029,12301999,3849844,485522216,1,7469,3908392,7419,3900734,50,7658,3572,0,7108,56,1,126,216660.0,130000.0,-43.0,-46.0,-38.0,-48.0,-43.0,-45.0,-36.0,-47.0,-89.0,-92.0,-89.0,-92.0,46.0,46.0,51.0,44.0,1
67,92:69:1D:31:68:E9,3854022,489227145,4178,3704929,3849844,485522216,1,5699,1227537,5521,1187039,178,40498,2316,12,4446,104,1,65,216660.0,130000.0,-51.0,-48.0,-45.0,-49.0,-51.0,-47.0,-43.0,-48.0,-89.0,-92.0,-89.0,-92.0,38.0,44.0,44.0,43.0,1
68,CC:2F:71:3F:1F:24,5142985,1984112720,1293141,1498590504,3849844,485522216,2222,1091337,1256032933,1090470,1255927973,867,104960,1056106,15,1291276,122745,2219,832,144444.0,43333.0,-71.0,-68.0,-68.0,-71.0,-70.0,-68.0,-67.0,-70.0,-89.0,-92.0,-89.0,-92.0,18.0,24.0,21.0,21.0,1
69,CC:2F:71:3E:C5:1F,3850865,485646975,1020,124699,3849845,485522276,3,4460,371793,3719,283825,741,87968,1080,14,1467,30,3,54,130000.0,39000.0,-72.0,-72.0,-70.0,-60.0,-71.0,-71.0,-70.0,-60.0,-89.0,-92.0,-89.0,-92.0,17.0,20.0,19.0,32.0,1
70,BA:8C:B9:54:50:24,3854800,491718952,4955,6196676,3849845,485522276,7,9971,1766716,9949,1763221,22,3495,2361,18,5477,44,7,77,216660.0,130000.0,-48.0,-35.0,-43.0,-45.0,-44.0,-36.0,-44.0,-48.0,-89.0,-92.0,-89.0,-92.0,41.0,57.0,46.0,47.0,1
71,62:47:05:9D:EB:15,3856874,497824275,7029,12301999,3849845,485522276,1,7469,3908392,7419,3900734,50,7658,3572,0,7108,56,1,126,216660.0,130000.0,-43.0,-46.0,-38.0,-48.0,-43.0,-45.0,-36.0,-47.0,-89.0,-92.0,-89.0,-92.0,46.0,46.0,51.0,44.0,1
72,92:69:1D:31:68:E9,3854023,489227205,4178,3704929,3849845,485522276,1,5700,1227605,5522,1187107,178,40498,2316,12,4446,104,1,65,216660.0,130000.0,-51.0,-48.0,-44.0,-47.0,-51.0,-47.0,-43.0,-48.0,-89.0,-92.0,-89.0,-92.0,38.0,44.0,45.0,45.0,1
73,CC:2F:71:3F:1F:24,5143181,1984360418,1293336,1498838142,3849845,485522276,2222,1091508,1256262289,1090641,1256157329,867,104960,1056277,15,1291469,122757,2219,832,144444.0,43333.0,-69.0,-70.0,-68.0,-72.0,-69.0,-70.0,-67.0,-72.0,-89.0,-92.0,-89.0,-92.0,20.0,22.0,21.0,20.0,1
74,CC:2F:71:3E:C5:1F,3850867,485647177,1020,124699,3849847,485522478,3,4460,371793,3719,283825,741,87968,1080,14,1467,30,3,54,130000.0,39000.0,-72.0,-72.0,-70.0,-60.0,-71.0,-71.0,-70.0,-60.0,-89.0,-92.0,-89.0,-92.0,17.0,20.0,19.0,32.0,1
75,BA:8C:B9:54:50:24,3854802,491719154,4955,6196676,3849847,485522478,7,9971,1766716,9949,1763221,22,3495,2361,18,5477,44,7,77,216660.0,130000.0,-48.0,-35.0,-43.0,-45.0,-44.0,-36.0,-44.0,-48.0,-89.0,-92.0,-89.0,-92.0,41.0,57.0,46.0,47.0,1
76,62:47:05:9D:EB:15,3856882,497825083,7029,12301999,3849853,485523084,1,7469,3908392,7419,3900734,50,7658,3572,0,7108,56,1,126,216660.0,130000.0,-43.0,-46.0,-38.0,-48.0,-43.0,-45.0,-36.0,-47.0,-89.0,-92.0,-89.0,-92.0,46.0,46.0,51.0,44.0,1
77,92:69:1D:31:68:E9,3854031,489228013,4178,3704929,3849853,485523084,1,5700,1227605,5522,1187107,178,40498,2316,12,4446,104,1,65,216660.0,130000.0,-51.0,-48.0,-44.0,-47.0,-51.0,-47.0,-43.0,-48.0,-89.0,-92.0,-89.0,-92.0,38.0,44.0,45.0,45.0,1
78,CC:2F:71:3F:1F:24,5143382,1984605756,1293529,1499082672,3849853,485523084,2222,1091682,1256494883,1090815,1256389923,867,104960,1056451,15,1291664,122771,2219,834,144444.0,43333.0,-71.0,-70.0,-68.0,-73.0,-70.0,-70.0,-67.0,-72.0,-89.0,-92.0,-89.0,-92.0,18.0,22.0,21.0,19.0,1
79,CC:2F:71:3E:C5:1F,3850873,485647783,1020,124699,3849853,485523084,3,4460,371793,3719,283825,741,87968,1080,14,1467,30,3,54,130000.0,39000.0,-72.0,-72.0,-70.0,-60.0,-71.0,-71.0,-70.0,-60.0,-89.0,-92.0,-89.0,-92.0,17.0,20.0,19.0,32.0,1
80,BA:8C:B9:54:50:24,3854808,491719760,4955,6196676,3849853,485523084,7,9971,1766716,9949,1763221,22,3495,2361,18,5477,44,7,77,216660.0,130000.0,-48.0,-35.0,-43.0,-45.0,-44.0,-36.0,-44.0,-48.0,-89.0,-92.0,-89.0,-92.0,41.0,57.0,46.0,47.0,1
81,62:47:05:9D:EB:15,3856883,497825143,7029,12301999,3849854,485523144,1,7469,3908392,7419,3900734,50,7658,3572,0,7108,56,1,126,216660.0,130000.0,-43.0,-46.0,-38.0,-48.0,-43.0,-45.0,-36.0,-47.0,-89.0,-92.0,-89.0,-92.0,46.0,46.0,51.0,44.0,1
82,92:69:1D:31:68:E9,3854034,489228275,4178,3704929,3849856,485523346,1,5700,1227605,5522,1187107,178,40498,2316,12,4446,104,1,65,216660.0,130000.0,-51.0,-48.0,-44.0,-47.0,-51.0,-47.0,-43.0,-48.0,-89.0,-92.0,-89.0,-92.0,38.0,44.0,45.0,45.0,1
83,CC:2F:71:3F:1F:24,5143579,1984853510,1293723,1499330164,3849856,485523346,2222,1091856,1256727435,1090989,1256622475,867,104960,1056625,15,1291858,122778,2219,834,144444.0,43333.0,-72.0,-69.0,-67.0,-75.0,-72.0,-69.0,-67.0,-75.0,-89.0,-92.0,-89.0,-92.0,17.0,23.0,22.0,17.0,1
84,CC:2F:71:3E:C5:1F,3850878,485648247,1020,124699,3849858,485523548,3,4460,371793,3719,283825,741,87968,1080,14,1467,30,3,54,130000.0,39000.0,-72.0,-72.0,-70.0,-60.0,-71.0,-71.0,-70.0,-60.0,-89.0,-92.0,-89.0,-92.0,17.0,20.0,19.0,32.0,1
85,BA:8C:B9:54:50:24,3854813,491720224,4955,6196676,3849858,485523548,7,9971,1766716,9949,1763221,22,3495,2361,18,5477,44,7,77,216660.0,130000.0,-48.0,-35.0,-43.0,-45.0,-44.0,-36.0,-44.0,-48.0,-89.0,-92.0,-89.0,-92.0,41.0,57.0,46.0,47.0,1
86,62:47:05:9D:EB:15,3856892,497826077,7029,12301999,3849863,485524078,1,7469,3908392,7419,3900734,50,7658,3572,0,7108,56,1,126,216660.0,130000.0,-43.0,-46.0,-38.0,-48.0,-43.0,-45.0,-36.0,-47.0,-89.0,-92.0,-89.0,-92.0,46.0,46.0,51.0,44.0,1
87,92:69:1D:31:68:E9,3854042,489229123,4179,3705045,3849863,485524078,1,5702,1227741,5524,1187243,178,40498,2316,12,4447,104,1,65,216660.0,130000.0,-53.0,-47.0,-42.0,-49.0,-51.0,-47.0,-43.0,-48.0,-89.0,-92.0,-89.0,-92.0,36.0,45.0,47.0,43.0,1
88,CC:2F:71:3F:1F:24,5143779,1985098742,1293916,1499574664,3849863,485524078,2222,1092030,1256957167,1091163,1256852207,867,104960,1056799,15,1292051,122779,2219,834,144444.0,43333.0,-72.0,-69.0,-68.0,-75.0,-72.0,-69.0,-68.0,-75.0,-89.0,-92.0,-89.0,-92.0,17.0,23.0,21.0,17.0,1
89,CC:2F:71:3E:C5:1F,3850884,485648893,1021,124815,3849863,485524078,3,4462,371933,3721,283965,741,87968,1080,14,1468,30,3,54,130000.0,39000.0,-72.0,-72.0,-69.0,-60.0,-71.0,-71.0,-69.0,-60.0,-89.0,-92.0,-89.0,-92.0,17.0,20.0,20.0,32.0,1
90,BA:8C:B9:54:50:24,3854819,491720870,4956,6196792,3849863,485524078,7,9973,1766852,9951,1763357,22,3495,2361,18,5478,44,7,77,216660.0,130000.0,-48.0,-35.0,-42.0,-45.0,-44.0,-36.0,-44.0,-48.0,-89.0,-92.0,-89.0,-92.0,41.0,57.0,47.0,47.0,1
91,62:47:05:9D:EB:15,3856895,497826339,7030,12302059,3849865,485524280,1,7471,3908528,7421,3900870,50,7658,3572,0,7109,56,1,126,216660.0,130000.0,-43.0,-45.0,-36.0,-48.0,-43.0,-45.0,-35.0,-47.0,-89.0,-92.0,-89.0,-92.0,46.0,47.0,53.0,44.0,1
92,92:69:1D:31:68:E9,3854046,489229527,4179,3705045,3849867,485524482,1,5702,1227741,5524,1187243,178,40498,2316,12,4447,104,1,65,216660.0,130000.0,-53.0,-47.0,-42.0,-49.0,-51.0,-47.0,-43.0,-48.0,-89.0,-92.0,-89.0,-92.0,36.0,45.0,47.0,43.0,1
93,CC:2F:71:3F:1F:24,5143983,1985344269,1294116,1499819787,3849867,485524482,2222,1092210,1257185199,1091343,1257080239,867,104960,1056979,15,1292251,122779,2219,834,144444.0,43333.0,-72.0,-69.0,-67.0,-74.0,-71.0,-69.0,-67.0,-74.0,-89.0,-92.0,-89.0,-92.0,17.0,23.0,22.0,18.0,1
94,CC:2F:71:3E:C5:1F,3850889,485649357,1021,124815,3849868,485524542,3,4462,371933,3721,283965,741,87968,1080,14,1468,30,3,54,130000.0,39000.0,-72.0,-72.0,-69.0,-60.0,-71.0,-71.0,-69.0,-60.0,-89.0,-92.0,-89.0,-92.0,17.0,20.0,20.0,32.0,1
95,BA:8C:B9:54:50:24,3854824,491721334,4956,6196792,3849868,485524542,7,9973,1766852,9951,1763357,22,3495,2361,18,5478,44,7,77,216660.0,130000.0,-48.0,-35.0,-42.0,-45.0,-44.0,-36.0,-44.0,-48.0,-89.0,-92.0,-89.0,-92.0,41.0,57.0,47.0,47.0,1
96,62:47:05:9D:EB:15,3856902,497827005,7030,12302059,3849872,485524946,1,7471,3908528,7421,3900870,50,7658,3572,0,7109,56,1,126,216660.0,130000.0,-43.0,-45.0,-36.0,-48.0,-43.0,-45.0,-35.0,-47.0,-89.0,-92.0,-89.0,-92.0,46.0,47.0,53.0,44.0,1
97,92:69:1D:31:68:E9,3854051,489229991,4179,3705045,3849872,485524946,1,5702,1227741,5524,1187243,178,40498,2316,12,4447,104,1,65,216660.0,130000.0,-53.0,-47.0,-42.0,-49.0,-51.0,-47.0,-43.0,-48.0,-89.0,-92.0,-89.0,-92.0,36.0,45.0,47.0,43.0,1
98,CC:2F:71:3F:1F:24,5144183,1985592355,1294311,1500067409,3849872,485524946,2222,1092385,1257417867,1091518,1257312907,867,104960,1057154,15,1292446,122779,2219,834,144444.0,43333.0,-72.0,-70.0,-67.0,-74.0,-71.0,-69.0,-67.0,-73.0,-89.0,-92.0,-89.0,-92.0,17.0,22.0,22.0,18.0,1
99,CC:2F:71:3E:C5:1F,3850893,485649761,1021,124815,3849872,485524946,3,4462,371933,3721,283965,741,87968,1080,14,1468,30,3,54,130000.0,39000.0,-72.0,-72.0,-69.0,-60.0,-71.0,-71.0,-69.0,-60.0,-89.0,-92.0,-89.0,-92.0,17.0,20.0,20.0,32.0,1
100,BA:8C:B9:54:50:24,3854828,491721738,4956,6196792,3849872,485524946,7,9973,1766852,9951,1763357,22,3495,2361,18,5478,44,7,77,216660.0,130000.0,-48.0,-35.0,-42.0,-45.0,-44.0,-36.0,-44.0,-48.0,-89.0,-92.0,-89.0,-92.0,41.0,57.0,47.0,47.0,1
101,62:47:05:9D:EB:15,3856907,497827682,7030,12302059,3849877,485525623,1,7471,3908528,7421,3900870,50,7658,3572,0,7109,56,1,126,216660.0,130000.0,-43.0,-45.0,-36.0,-48.0,-43.0,-45.0,-35.0,-47.0,-89.0,-92.0,-89.0,-92.0,46.0,47.0,53.0,44.0,1
102,92:69:1D:31:68:E9,3854056,489230668,4179,3705045,3849877,485525623,1,5702,1227741,5524,1187243,178,40498,2316,12,4447,104,1,65,216660.0,130000.0,-53.0,-47.0,-42.0,-49.0,-51.0,-47.0,-43.0,-48.0,-89.0,-92.0,-89.0,-92.0,36.0,45.0,47.0,43.0,1
103,CC:2F:71:3F:1F:24,5144380,1985834568,1294503,1500308945,3849877,485525623,2222,1092554,1257642719,1091687,1257537759,867,104960,1057323,15,1292638,122779,2219,834,144444.0,43333.0,-71.0,-69.0,-68.0,-73.0,-71.0,-69.0,-67.0,-73.0,-89.0,-92.0,-89.0,-92.0,18.0,23.0,21.0,19.0,1
104,CC:2F:71:3E:C5:1F,3850898,485650438,1021,124815,3849877,485525623,3,4462,371933,3721,283965,741,87968,1080,14,1468,30,3,54,130000.0,39000.0,-72.0,-72.0,-69.0,-60.0,-71.0,-71.0,-69.0,-60.0,-89.0,-92.0,-89.0,-92.0,17.0,20.0,20.0,32.0,1
105,BA:8C:B9:54:50:24,3854833,491722415,4956,6196792,3849877,485525623,7,9973,1766852,9951,1763357,22,3495,2361,18,5478,44,7,77,216660.0,130000.0,-48.0,-35.0,-42.0,-45.0,-44.0,-36.0,-44.0,-48.0,-89.0,-92.0,-89.0,-92.0,41.0,57.0,47.0,47.0,1
106,62:47:05:9D:EB:15,3856912,497828146,7030,12302059,3849882,485526087,1,7471,3908528,7421,3900870,50,7658,3572,0,7109,56,1,126,216660.0,130000.0,-43.0,-45.0,-36.0,-48.0,-43.0,-45.0,-35.0,-47.0,-89.0,-92.0,-89.0,-92.0,46.0,47.0,53.0,44.0,1
107,92:69:1D:31:68:E9,3854061,489231132,4179,3705045,3849882,485526087,1,5702,1227741,5524,1187243,178,40498,2316,12,4447,104,1,65,216660.0,130000.0,-53.0,-47.0,-42.0,-49.0,-51.0,-47.0,-43.0,-48.0,-89.0,-92.0,-89.0,-92.0,36.0,45.0,47.0,43.0,1
108,CC:2F:71:3F:1F:24,5144575,1986076308,1294693,1500550221,3849882,485526087,2222,1092724,1257870535,1091857,1257765575,867,104960,1057493,15,1292828,122779,2219,834,144444.0,43333.0,-74.0,-72.0,-71.0,-77.0,-73.0,-71.0,-70.0,-76.0,-89.0,-92.0,-89.0,-92.0,15.0,20.0,18.0,15.0,1
109,CC:2F:71:3E:C5:1F,3850903,485650902,1021,124815,3849882,485526087,3,4462,371933,3721,283965,741,87968,1080,14,1468,30,3,54,130000.0,39000.0,-72.0,-72.0,-69.0,-60.0,-71.0,-71.0,-69.0,-60.0,-89.0,-92.0,-89.0,-92.0,17.0,20.0,20.0,32.0,1
110,BA:8C:B9:54:50:24,3854838,491722879,4956,6196792,3849882,485526087,7,9973,1766852,9951,1763357,22,3495,2361,18,5478,44,7,77,216660.0,130000.0,-48.0,-35.0,-42.0,-45.0,-44.0,-36.0,-44.0,-48.0,-89.0,-92.0,-89.0,-92.0,41.0,57.0,47.0,47.0,1
111,62:47:05:9D:EB:15,3856916,497828550,7030,12302059,3849886,485526491,1,7471,3908528,7421,3900870,50,7658,3572,0,7109,56,1,126,216660.0,130000.0,-43.0,-45.0,-36.0,-48.0,-43.0,-45.0,-35.0,-47.0,-89.0,-92.0,-89.0,-92.0,46.0,47.0,53.0,44.0,1
112,92:69:1D:31:68:E9,3854065,489231536,4179,3705045,3849886,485526491,1,5702,1227741,5524,1187243,178,40498,2316,12,4447,104,1,65,216660.0,130000.0,-53.0,-47.0,-42.0,-49.0,-51.0,-47.0,-43.0,-48.0,-89.0,-92.0,-89.0,-92.0,36.0,45.0,47.0,43.0,1
113,CC:2F:71:3F:1F:24,5144769,1986320836,1294883,1500794345,3849886,485526491,2222,1092895,1258099891,1092028,1257994931,867,104960,1057664,15,1293018,122779,2219,834,144444.0,43333.0,-71.0,-69.0,-67.0,-73.0,-71.0,-69.0,-67.0,-73.0,-89.0,-92.0,-89.0,-92.0,18.0,23.0,22.0,19.0,1
114,CC:2F:71:3E:C5:1F,3850909,485651674,1021,124815,3849888,485526859,3,4462,371933,3721,283965,741,87968,1080,14,1468,30,3,54,130000.0,39000.0,-72.0,-72.0,-69.0,-60.0,-71.0,-71.0,-69.0,-60.0,-89.0,-92.0,-89.0,-92.0,17.0,20.0,20.0,32.0,1
115,BA:8C:B9:54:50:24,3854846,491723853,4956,6196792,3849890,485527061,7,9973,1766852,9951,1763357,22,3495,2361,18,5478,44,7,77,216660.0,130000.0,-48.0,-35.0,-42.0,-45.0,-44.0,-36.0,-44.0,-48.0,-89.0,-92.0,-89.0,-92.0,41.0,57.0,47.0,47.0,1
116,62:47:05:9D:EB:15,3856922,497829322,7030,12302059,3849892,485527263,1,7471,3908528,7421,3900870,50,7658,3572,0,7109,56,1,126,216660.0,130000.0,-43.0,-45.0,-36.0,-48.0,-43.0,-45.0,-35.0,-47.0,-89.0,-92.0,-89.0,-92.0,46.0,47.0,53.0,44.0,1
117,92:69:1D:31:68:E9,3854071,489232308,4179,3705045,3849892,485527263,1,5702,1227741,5524,1187243,178,40498,2316,12,4447,104,1,65,216660.0,130000.0,-53.0,-47.0,-42.0,-49.0,-51.0,-47.0,-43.0,-48.0,-90.0,-92.0,-89.0,-92.0,37.0,45.0,47.0,43.0,1
118,CC:2F:71:3F:1F:24,5144979,1986575739,1295086,1501048416,3849893,485527323,2222,1093074,1258333514,1092207,1258228554,867,104960,1057843,15,1293219,122779,2219,834,144444.0,43333.0,-71.0,-69.0,-67.0,-73.0,-70.0,-69.0,-67.0,-73.0,-90.0,-92.0,-89.0,-92.0,19.0,23.0,22.0,19.0,1
119,CC:2F:71:3E:C5:1F,3850914,485652138,1021,124815,3849893,485527323,3,4462,371933,3721,283965,741,87968,1080,14,1468,30,3,54,130000.0,39000.0,-72.0,-72.0,-69.0,-60.0,-71.0,-71.0,-69.0,-60.0,-90.0,-92.0,-89.0,-92.0,18.0,20.0,20.0,32.0,1
120,BA:8C:B9:54:50:24,3854849,491724115,4956,6196792,3849893,485527323,7,9973,1766852,9951,1763357,22,3495,2361,18,5478,44,7,77,216660.0,130000.0,-48.0,-35.0,-42.0,-45.0,-44.0,-36.0,-44.0,-48.0,-90.0,-92.0,-89.0,-92.0,42.0,57.0,47.0,47.0,1
121,62:47:05:9D:EB:15,3856927,497829786,7030,12302059,3849897,485527727,1,7471,3908528,7421,3900870,50,7658,3572,0,7109,56,1,126,216660.0,130000.0,-43.0,-45.0,-36.0,-48.0,-43.0,-45.0,-35.0,-47.0,-90.0,-92.0,-89.0,-92.0,47.0,47.0,53.0,44.0,1
122,92:69:1D:31:68:E9,3854076,489232772,4179,3705045,3849897,485527727,1,5702,1227741,5524,1187243,178,40498,2316,12,4447,104,1,65,216660.0,130000.0,-53.0,-47.0,-42.0,-49.0,-51.0,-47.0,-43.0,-48.0,-90.0,-92.0,-89.0,-92.0,37.0,45.0,47.0,43.0,1
123,CC:2F:71:3F:1F:24,5145176,1986817751,1295277,1501289822,3849899,485527929,2222,1093247,1258563130,1092380,1258458170,867,104960,1058016,15,1293412,122779,2219,834,144444.0,43333.0,-71.0,-69.0,-67.0,-73.0,-71.0,-69.0,-67.0,-72.0,-90.0,-92.0,-89.0,-92.0,19.0,23.0,22.0,19.0,1
124,CC:2F:71:3E:C5:1F,3850920,485652744,1021,124815,3849899,485527929,3,4462,371933,3721,283965,741,87968,1080,14,1468,30,3,54,130000.0,39000.0,-72.0,-72.0,-69.0,-60.0,-71.0,-71.0,-69.0,-60.0,-90.0,-92.0,-89.0,-92.0,18.0,20.0,20.0,32.0,1
125,BA:8C:B9:54:50:24,3854855,491724721,4956,6196792,3849899,485527929,7,9973,1766852,9951,1763357,22,3495,2361,18,5478,44,7,77,216660.0,130000.0,-48.0,-35.0,-42.0,-45.0,-44.0,-36.0,-44.0,-48.0,-90.0,-92.0,-89.0,-92.0,42.0,57.0,47.0,47.0,1
126,62:47:05:9D:EB:15,3856931,497830190,7030,12302059,3849901,485528131,1,7471,3908528,7421,3900870,50,7658,3572,0,7109,56,1,126,216660.0,130000.0,-43.0,-45.0,-36.0,-48.0,-43.0,-45.0,-35.0,-47.0,-90.0,-92.0,-89.0,-92.0,47.0,47.0,53.0,44.0,1
127,92:69:1D:31:68:E9,3854080,489233176,4179,3705045,3849901,485528131,1,5702,1227741,5524,1187243,178,40498,2316,12,4447,104,1,65,216660.0,130000.0,-53.0,-47.0,-42.0,-49.0,-51.0,-47.0,-43.0,-48.0,-90.0,-92.0,-89.0,-92.0,37.0,45.0,47.0,43.0,1
128,CC:2F:71:3F:1F:24,5145371,1987062467,1295470,1501534336,3849901,485528131,2222,1093420,1258792718,1092553,1258687758,867,104960,1058189,15,1293605,122779,2219,834,144444.0,43333.0,-71.0,-69.0,-67.0,-73.0,-71.0,-69.0,-67.0,-73.0,-90.0,-92.0,-89.0,-92.0,19.0,23.0,22.0,19.0,1
129,CC:2F:71:3E:C5:1F,3850922,485652946,1021,124815,3849901,485528131,3,4462,371933,3721,283965,741,87968,1080,14,1468,30,3,54,130000.0,39000.0,-72.0,-72.0,-69.0,-60.0,-71.0,-71.0,-69.0,-60.0,-90.0,-92.0,-89.0,-92.0,18.0,20.0,20.0,32.0,1
130,BA:8C:B9:54:50:24,3854857,491724923,4956,6196792,3849901,485528131,7,9973,1766852,9951,1763357,22,3495,2361,18,5478,44,7,77,216660.0,130000.0,-48.0,-35.0,-42.0,-45.0,-44.0,-36.0,-44.0,-48.0,-90.0,-92.0,-89.0,-92.0,42.0,57.0,47.0,47.0,1
131,62:47:05:9D:EB:15,3856938,497830856,7030,12302059,3849908,485528797,1,7471,3908528,7421,3900870,50,7658,3572,0,7109,56,1,126,216660.0,130000.0,-43.0,-45.0,-36.0,-48.0,-43.0,-45.0,-35.0,-47.0,-90.0,-92.0,-89.0,-92.0,47.0,47.0,53.0,44.0,1
132,92:69:1D:31:68:E9,3854087,489233842,4179,3705045,3849908,485528797,1,5702,1227741,5524,1187243,178,40498,2316,12,4447,104,1,65,216660.0,130000.0,-53.0,-47.0,-42.0,-49.0,-51.0,-47.0,-43.0,-48.0,-90.0,-92.0,-89.0,-92.0,37.0,45.0,47.0,43.0,1
133,CC:2F:71:3F:1F:24,5145573,1987313603,1295665,1501784806,3849908,485528797,2222,1093596,1259028518,1092729,1258923558,867,104960,1058365,15,1293800,122781,2219,835,144444.0,43333.0,-71.0,-69.0,-67.0,-74.0,-71.0,-69.0,-67.0,-73.0,-90.0,-92.0,-89.0,-92.0,19.0,23.0,22.0,18.0,1
134,CC:2F:71:3E:C5:1F,3850929,485653612,1021,124815,3849908,485528797,3,4462,371933,3721,283965,741,87968,1080,14,1468,30,3,54,130000.0,39000.0,-72.0,-72.0,-69.0,-60.0,-71.0,-71.0,-69.0,-60.0,-90.0,-92.0,-89.0,-92.0,18.0,20.0,20.0,32.0,1
135,BA:8C:B9:54:50:24,3854864,491725589,4956,6196792,3849908,485528797,7,9973,1766852,9951,1763357,22,3495,2361,18,5478,44,7,77,216660.0,130000.0,-48.0,-35.0,-42.0,-45.0,-44.0,-36.0,-44.0,-48.0,-90.0,-92.0,-89.0,-92.0,42.0,57.0,47.0,47.0,1
136,62:47:05:9D:EB:15,3856940,497831058,7030,12302059,3849910,485528999,1,7471,3908528,7421,3900870,50,7658,3572,0,7109,56,1,126,216660.0,130000.0,-43.0,-45.0,-36.0,-48.0,-43.0,-45.0,-35.0,-47.0,-90.0,-92.0,-89.0,-92.0,47.0,47.0,53.0,44.0,1
137,92:69:1D:31:68:E9,3854089,489234044,4179,3705045,3849910,485528999,1,5702,1227741,5524,1187243,178,40498,2316,12,4447,104,1,65,216660.0,130000.0,-53.0,-47.0,-42.0,-49.0,-51.0,-47.0,-43.0,-48.0,-90.0,-92.0,-89.0,-92.0,37.0,45.0,47.0,43.0,1
138,CC:2F:71:3F:1F:24,5145766,1987558059,1295856,1502029060,3849910,485528999,2222,1093769,1259259544,1092902,1259154584,867,104960,1058537,15,1293991,122785,2219,835,144444.0,43333.0,-71.0,-68.0,-67.0,-73.0,-71.0,-68.0,-67.0,-73.0,-90.0,-92.0,-89.0,-92.0,19.0,24.0,22.0,19.0,1
139,CC:2F:71:3E:C5:1F,3850932,485653876,1021,124815,3849911,485529061,3,4463,372051,3721,283965,742,88086,1081,14,1468,30,3,54,130000.0,39000.0,-72.0,-72.0,-70.0,-60.0,-72.0,-71.0,-69.0,-60.0,-90.0,-92.0,-89.0,-92.0,18.0,20.0,19.0,32.0,1
140,BA:8C:B9:54:50:24,3854867,491725853,4956,6196792,3849911,485529061,7,9973,1766852,9951,1763357,22,3495,2361,18,5478,44,7,77,216660.0,130000.0,-48.0,-35.0,-42.0,-45.0,-44.0,-36.0,-44.0,-48.0,-90.0,-92.0,-89.0,-92.0,42.0,57.0,47.0,47.0,1
141,62:47:05:9D:EB:15,3856948,497831788,7030,12302059,3849918,485529729,1,7472,3908596,7422,3900938,50,7658,3572,0,7109,56,1,126,216660.0,130000.0,-44.0,-50.0,-46.0,-43.0,-43.0,-45.0,-37.0,-46.0,-90.0,-93.0,-90.0,-93.0,46.0,43.0,44.0,50.0,1
142,92:69:1D:31:68:E9,3854098,489234834,4179,3705045,3849919,485529789,1,5702,1227741,5524,1187243,178,40498,2316,12,4447,104,1,65,216660.0,130000.0,-53.0,-47.0,-42.0,-49.0,-51.0,-47.0,-43.0,-48.0,-90.0,-93.0,-90.0,-93.0,37.0,46.0,48.0,44.0,1
143,CC:2F:71:3F:1F:24,5145976,1987809796,1296057,1502280007,3849919,485529789,2222,1093951,1259494998,1093083,1259389920,868,105078,1058718,15,1294192,122785,2219,835,144444.0,43333.0,-71.0,-69.0,-67.0,-73.0,-71.0,-69.0,-66.0,-73.0,-90.0,-93.0,-90.0,-93.0,19.0,24.0,23.0,20.0,1
144,CC:2F:71:3E:C5:1F,3850942,485654806,1021,124815,3849921,485529991,3,4464,372121,3722,284035,742,88086,1081,14,1468,30,3,54,130000.0,39000.0,-72.0,-72.0,-70.0,-60.0,-72.0,-71.0,-69.0,-60.0,-90.0,-93.0,-90.0,-93.0,18.0,21.0,20.0,33.0,1
145,BA:8C:B9:54:50:24,3854877,491726783,4956,6196792,3849921,485529991,7,9973,1766852,9951,1763357,22,3495,2361,18,5478,44,7,77,216660.0,130000.0,-48.0,-35.0,-42.0,-45.0,-44.0,-36.0,-44.0,-48.0,-90.0,-93.0,-90.0,-93.0,42.0,58.0,48.0,48.0,1
146,62:47:05:9D:EB:15,3856952,497832110,7030,12302059,3849922,485530051,1,7472,3908596,7422,3900938,50,7658,3572,0,7109,56,1,126,216660.0,130000.0,-44.0,-50.0,-46.0,-43.0,-43.0,-45.0,-37.0,-46.0,-90.0,-93.0,-90.0,-93.0,46.0,43.0,44.0,50.0,1
147,92:69:1D:31:68:E9,3854101,489235096,4179,3705045,3849922,485530051,1,5702,1227741,5524,1187243,178,40498,2316,12,4447,104,1,65,216660.0,130000.0,-53.0,-47.0,-42.0,-49.0,-51.0,-47.0,-43.0,-48.0,-90.0,-93.0,-90.0,-93.0,37.0,46.0,48.0,44.0,1
148,CC:2F:71:3F:1F:24,5146173,1988054718,1296251,1502524667,3849922,485530051,2222,1094127,1259724932,1093258,1259619740,869,105192,1058894,15,1294386,122785,2219,835,144444.0,43333.0,-71.0,-69.0,-67.0,-75.0,-71.0,-69.0,-67.0,-74.0,-90.0,-93.0,-90.0,-93.0,19.0,24.0,23.0,18.0,1
149,CC:2F:71:3E:C5:1F,3850945,485655068,1021,124815,3849924,485530253,3,4464,372121,3722,284035,742,88086,1081,14,1468,30,3,54,130000.0,39000.0,-72.0,-72.0,-70.0,-60.0,-72.0,-71.0,-69.0,-60.0,-90.0,-93.0,-90.0,-93.0,18.0,21.0,20.0,33.0,1
150,BA:8C:B9:54:50:24,3854880,491727045,4956,6196792,3849924,485530253,7,9973,1766852,9951,1763357,22,3495,2361,18,5478,44,7,77,216660.0,130000.0,-48.0,-35.0,-42.0,-45.0,-44.0,-36.0,-44.0,-48.0,-90.0,-93.0,-90.0,-93.0,42.0,58.0,48.0,48.0,1
151,62:47:05:9D:EB:15,3856961,497833002,7030,12302059,3849931,485530943,1,7472,3908596,7422,3900938,50,7658,3572,0,7109,56,1,126,216660.0,130000.0,-44.0,-50.0,-46.0,-43.0,-43.0,-45.0,-37.0,-46.0,-90.0,-93.0,-90.0,-93.0,46.0,43.0,44.0,50.0,1
152,92:69:1D:31:68:E9,3854110,489235988,4179,3705045,3849931,485530943,1,5704,1227877,5526,1187379,178,40498,2316,12,4448,104,1,65,216660.0,130000.0,-52.0,-47.0,-42.0,-48.0,-51.0,-47.0,-43.0,-47.0,-90.0,-93.0,-90.0,-93.0,38.0,46.0,48.0,45.0,1
153,CC:2F:71:3F:1F:24,5146378,1988300192,1296445,1502769047,3849933,485531145,2222,1094306,1259956774,1093434,1259851128,872,105646,1059071,15,1294580,122845,2219,836,130000.0,43333.0,-71.0,-69.0,-66.0,-73.0,-70.0,-69.0,-66.0,-73.0,-90.0,-93.0,-90.0,-93.0,19.0,24.0,24.0,20.0,1
154,CC:2F:71:3E:C5:1F,3850954,485655960,1021,124815,3849933,485531145,3,4464,372121,3722,284035,742,88086,1081,14,1468,30,3,54,130000.0,39000.0,-72.0,-72.0,-70.0,-60.0,-72.0,-71.0,-69.0,-60.0,-90.0,-93.0,-90.0,-93.0,18.0,21.0,20.0,33.0,1
155,BA:8C:B9:54:50:24,3854889,491727937,4956,6196792,3849933,485531145,7,9975,1766988,9953,1763493,22,3495,2361,18,5479,44,7,77,216660.0,130000.0,-40.0,-36.0,-46.0,-52.0,-42.0,-36.0,-44.0,-50.0,-90.0,-93.0,-90.0,-93.0,50.0,57.0,44.0,41.0,1
156,62:47:05:9D:EB:15,3856964,497833264,7030,12302059,3849934,485531205,1,7472,3908596,7422,3900938,50,7658,3572,0,7109,56,1,126,216660.0,130000.0,-44.0,-50.0,-46.0,-43.0,-43.0,-45.0,-37.0,-46.0,-90.0,-93.0,-90.0,-93.0,46.0,43.0,44.0,50.0,1
157,92:69:1D:31:68:E9,3854113,489236250,4179,3705045,3849934,485531205,1,5704,1227877,5526,1187379,178,40498,2316,12,4448,104,1,65,216660.0,130000.0,-52.0,-47.0,-42.0,-48.0,-51.0,-47.0,-43.0,-47.0,-90.0,-93.0,-90.0,-93.0,38.0,46.0,48.0,45.0,1
158,CC:2F:71:3F:1F:24,5146571,1988541746,1296635,1503010339,3849936,485531407,2222,1094478,1260183398,1093606,1260077752,872,105646,1059243,15,1294770,122858,2219,836,130000.0,43333.0,-72.0,-68.0,-66.0,-74.0,-72.0,-68.0,-66.0,-74.0,-90.0,-93.0,-90.0,-93.0,18.0,25.0,24.0,19.0,1
159,CC:2F:71:3E:C5:1F,3850958,485656356,1021,124815,3849937,485531541,3,4464,372121,3722,284035,742,88086,1081,14,1468,30,3,54,130000.0,39000.0,-72.0,-72.0,-70.0,-60.0,-72.0,-71.0,-69.0,-60.0,-90.0,-93.0,-90.0,-93.0,18.0,21.0,20.0,33.0,1
160,BA:8C:B9:54:50:24,3854894,491728401,4956,6196792,3849938,485531609,7,9976,1767056,9954,1763561,22,3495,2361,18,5479,44,7,77,216660.0,130000.0,-48.0,-35.0,-43.0,-45.0,-43.0,-36.0,-44.0,-49.0,-90.0,-93.0,-90.0,-93.0,42.0,58.0,47.0,48.0,1
161,62:47:05:9D:EB:15,3856973,497834345,7030,12302059,3849943,485532286,1,7472,3908596,7422,3900938,50,7658,3572,0,7109,56,1,126,216660.0,130000.0,-44.0,-50.0,-46.0,-43.0,-43.0,-45.0,-37.0,-46.0,-90.0,-93.0,-90.0,-93.0,46.0,43.0,44.0,50.0,1
162,92:69:1D:31:68:E9,3854122,489237331,4179,3705045,3849943,485532286,1,5704,1227877,5526,1187379,178,40498,2316,12,4448,104,1,65,216660.0,130000.0,-52.0,-47.0,-42.0,-48.0,-51.0,-47.0,-43.0,-47.0,-90.0,-93.0,-90.0,-93.0,38.0,46.0,48.0,45.0,1
163,CC:2F:71:3F:1F:24,5146770,1988786857,1296827,1503254571,3849943,485532286,2222,1094648,1260409790,1093776,1260304144,872,105646,1059413,15,1294960,122859,2219,836,144444.0,43333.0,-71.0,-69.0,-66.0,-74.0,-71.0,-69.0,-65.0,-74.0,-90.0,-93.0,-90.0,-93.0,19.0,24.0,24.0,19.0,1
164,CC:2F:71:3E:C5:1F,3850964,485657101,1021,124815,3849943,485532286,3,4464,372121,3722,284035,742,88086,1081,14,1468,30,3,54,130000.0,39000.0,-72.0,-72.0,-70.0,-60.0,-72.0,-71.0,-69.0,-60.0,-90.0,-93.0,-90.0,-93.0,18.0,21.0,20.0,33.0,1
165,BA:8C:B9:54:50:24,3854899,491729078,4956,6196792,3849943,485532286,7,9976,1767056,9954,1763561,22,3495,2361,18,5479,44,7,77,216660.0,130000.0,-48.0,-35.0,-43.0,-45.0,-43.0,-36.0,-44.0,-49.0,-90.0,-93.0,-90.0,-93.0,42.0,58.0,47.0,48.0,1
166,62:47:05:9D:EB:15,3856976,497834607,7030,12302059,3849946,485532548,1,7472,3908596,7422,3900938,50,7658,3572,0,7109,56,1,126,216660.0,130000.0,-44.0,-50.0,-46.0,-43.0,-43.0,-45.0,-37.0,-46.0,-90.0,-93.0,-90.0,-93.0,46.0,43.0,44.0,50.0,1
167,92:69:1D:31:68:E9,3854125,489237593,4179,3705045,3849946,485532548,1,5704,1227877,5526,1187379,178,40498,2316,12,4448,104,1,65,216660.0,130000.0,-52.0,-47.0,-42.0,-48.0,-51.0,-47.0,-43.0,-47.0,-90.0,-93.0,-90.0,-93.0,38.0,46.0,48.0,45.0,1
168,CC:2F:71:3F:1F:24,5146973,1989029916,1297027,1503497368,3849946,485532548,2222,1094831,1260638309,1093959,1260532663,872,105646,1059596,15,1295162,122861,2219,837,144444.0,43333.0,-73.0,-70.0,-67.0,-74.0,-73.0,-69.0,-66.0,-73.0,-90.0,-93.0,-90.0,-93.0,17.0,23.0,23.0,19.0,1
169,CC:2F:71:3E:C5:1F,3850969,485657565,1021,124815,3849948,485532750,3,4464,372121,3722,284035,742,88086,1081,14,1468,30,3,54,130000.0,39000.0,-72.0,-72.0,-70.0,-60.0,-72.0,-71.0,-69.0,-60.0,-90.0,-93.0,-90.0,-93.0,18.0,21.0,20.0,33.0,1
170,BA:8C:B9:54:50:24,3854904,491729542,4956,6196792,3849948,485532750,7,9976,1767056,9954,1763561,22,3495,2361,18,5479,44,7,77,216660.0,130000.0,-48.0,-35.0,-43.0,-45.0,-43.0,-36.0,-44.0,-49.0,-90.0,-93.0,-90.0,-93.0,42.0,58.0,47.0,48.0,1
171,62:47:05:9D:EB:15,3856982,497835213,7030,12302059,3849952,485533154,1,7472,3908596,7422,3900938,50,7658,3572,0,7109,56,1,126,216660.0,130000.0,-44.0,-50.0,-46.0,-43.0,-43.0,-45.0,-37.0,-46.0,-90.0,-93.0,-90.0,-93.0,46.0,43.0,44.0,50.0,1
172,92:69:1D:31:68:E9,3854131,489238199,4179,3705045,3849952,485533154,1,5704,1227877,5526,1187379,178,40498,2316,12,4448,104,1,65,216660.0,130000.0,-52.0,-47.0,-42.0,-48.0,-51.0,-47.0,-43.0,-47.0,-90.0,-93.0,-90.0,-93.0,38.0,46.0,48.0,45.0,1
173,CC:2F:71:3F:1F:24,5147170,1989271944,1297218,1503738790,3849952,485533154,2222,1095003,1260864961,1094131,1260759315,872,105646,1059768,15,1295353,122864,2219,837,144444.0,43333.0,-73.0,-69.0,-66.0,-74.0,-72.0,-69.0,-66.0,-74.0,-90.0,-93.0,-90.0,-93.0,17.0,24.0,24.0,19.0,1
174,CC:2F:71:3E:C5:1F,3850973,485657969,1021,124815,3849952,485533154,3,4464,372121,3722,284035,742,88086,1081,14,1468,30,3,54,130000.0,39000.0,-72.0,-72.0,-70.0,-60.0,-72.0,-71.0,-69.0,-60.0,-90.0,-93.0,-89.0,-93.0,18.0,21.0,19.0,33.0,1
175,BA:8C:B9:54:50:24,3854908,491729946,4956,6196792,3849952,485533154,7,9976,1767056,9954,1763561,22,3495,2361,18,5479,44,7,77,216660.0,130000.0,-48.0,-35.0,-43.0,-45.0,-43.0,-36.0,-44.0,-49.0,-90.0,-93.0,-89.0,-93.0,42.0,58.0,46.0,48.0,1
176,62:47:05:9D:EB:15,3856986,497835617,7030,12302059,3849956,485533558,1,7472,3908596,7422,3900938,50,7658,3572,0,7109,56,1,126,216660.0,130000.0,-44.0,-50.0,-46.0,-43.0,-43.0,-45.0,-37.0,-46.0,-90.0,-93.0,-89.0,-93.0,46.0,43.0,43.0,50.0,1
177,92:69:1D:31:68:E9,3854135,489238603,4179,3705045,3849956,485533558,1,5704,1227877,5526,1187379,178,40498,2316,12,4448,104,1,65,216660.0,130000.0,-52.0,-47.0,-42.0,-48.0,-51.0,-47.0,-43.0,-47.0,-90.0,-93.0,-89.0,-93.0,38.0,46.0,47.0,45.0,1
178,CC:2F:71:3F:1F:24,5147382,1989538892,1297426,1504005334,3849956,485533558,2222,1095191,1261119295,1094319,1261013649,872,105646,1059953,15,1295561,122868,2219,838,144444.0,43333.0,-72.0,-69.0,-67.0,-72.0,-72.0,-69.0,-66.0,-72.0,-90.0,-93.0,-89.0,-93.0,18.0,24.0,22.0,21.0,1
179,CC:2F:71:3E:C5:1F,3850977,485658373,1021,124815,3849956,485533558,3,4464,372121,3722,284035,742,88086,1081,14,1468,30,3,54,130000.0,39000.0,-72.0,-72.0,-70.0,-60.0,-72.0,-71.0,-69.0,-60.0,-90.0,-93.0,-89.0,-93.0,18.0,21.0,19.0,33.0,1
180,BA:8C:B9:54:50:24,3854912,491730350,4956,6196792,3849956,485533558,7,9976,1767056,9954,1763561,22,3495,2361,18,5479,44,7,77,216660.0,130000.0,-48.0,-35.0,-43.0,-45.0,-43.0,-36.0,-44.0,-49.0,-90.0,-93.0,-89.0,-93.0,42.0,58.0,46.0,48.0,1
181,62:47:05:9D:EB:15,3856991,497836081,7030,12302059,3849961,485534022,1,7472,3908596,7422,3900938,50,7658,3572,0,7109,56,1,126,216660.0,130000.0,-44.0,-50.0,-46.0,-43.0,-43.0,-45.0,-37.0,-46.0,-90.0,-93.0,-89.0,-93.0,46.0,43.0,43.0,50.0,1
182,92:69:1D:31:68:E9,3854140,489239067,4179,3705045,3849961,485534022,1,5704,1227877,5526,1187379,178,40498,2316,12,4448,104,1,65,216660.0,130000.0,-52.0,-47.0,-42.0,-48.0,-51.0,-47.0,-43.0,-47.0,-90.0,-93.0,-89.0,-93.0,38.0,46.0,47.0,45.0,1
183,CC:2F:71:3F:1F:24,5147603,1989812207,1297642,1504278185,3849961,485534022,2222,1095388,1261375361,1094516,1261269715,872,105646,1060147,15,1295777,122891,2219,839,144444.0,43333.0,-72.0,-69.0,-67.0,-72.0,-71.0,-69.0,-67.0,-72.0,-90.0,-93.0,-89.0,-93.0,18.0,24.0,22.0,21.0,1
184,CC:2F:71:3E:C5:1F,3850982,485658837,1021,124815,3849961,485534022,3,4464,372121,3722,284035,742,88086,1081,14,1468,30,3,54,130000.0,39000.0,-72.0,-72.0,-70.0,-60.0,-72.0,-71.0,-69.0,-60.0,-90.0,-93.0,-89.0,-93.0,18.0,21.0,19.0,33.0,1
185,BA:8C:B9:54:50:24,3854917,491730814,4956,6196792,3849961,485534022,7,9976,1767056,9954,1763561,22,3495,2361,18,5479,44,7,77,216660.0,130000.0,-48.0,-35.0,-43.0,-45.0,-43.0,-36.0,-44.0,-49.0,-90.0,-93.0,-89.0,-93.0,42.0,58.0,46.0,48.0,1
186,62:47:05:9D:EB:15,3856995,497836485,7030,12302059,3849965,485534426,1,7472,3908596,7422,3900938,50,7658,3572,0,7109,56,1,126,216660.0,130000.0,-44.0,-50.0,-46.0,-43.0,-43.0,-45.0,-37.0,-46.0,-90.0,-93.0,-89.0,-93.0,46.0,43.0,43.0,50.0,1
187,92:69:1D:31:68:E9,3854144,489239471,4179,3705045,3849965,485534426,1,5704,1227877,5526,1187379,178,40498,2316,12,4448,104,1,65,216660.0,130000.0,-52.0,-47.0,-42.0,-48.0,-51.0,-47.0,-43.0,-47.0,-90.0,-93.0,-89.0,-93.0,38.0,46.0,47.0,45.0,1
188,CC:2F:71:3F:1F:24,5147795,1990050795,1297830,1504516369,3849965,485534426,2222,1095557,1261601651,1094685,1261496005,872,105646,1060315,15,1295965,122906,2219,839,144444.0,43333.0,-71.0,-70.0,-67.0,-72.0,-71.0,-69.0,-66.0,-72.0,-90.0,-93.0,-89.0,-93.0,19.0,23.0,22.0,21.0,1
189,CC:2F:71:3E:C5:1F,3850986,485659241,1021,124815,3849965,485534426,3,4464,372121,3722,284035,742,88086,1081,14,1468,30,3,54,130000.0,39000.0,-72.0,-72.0,-70.0,-60.0,-72.0,-71.0,-69.0,-60.0,-90.0,-93.0,-89.0,-93.0,18.0,21.0,19.0,33.0,1
190,BA:8C:B9:54:50:24,3854923,491731420,4956,6196792,3849967,485534628,7,9976,1767056,9954,1763561,22,3495,2361,18,5479,44,7,77,216660.0,130000.0,-48.0,-35.0,-43.0,-45.0,-43.0,-36.0,-44.0,-49.0,-90.0,-93.0,-89.0,-93.0,42.0,58.0,46.0,48.0,1
191,62:47:05:9D:EB:15,3857000,497836949,7030,12302059,3849970,485534890,1,7472,3908596,7422,3900938,50,7658,3572,0,7109,56,1,126,216660.0,130000.0,-44.0,-50.0,-46.0,-43.0,-43.0,-45.0,-37.0,-46.0,-90.0,-93.0,-89.0,-93.0,46.0,43.0,43.0,50.0,1
192,92:69:1D:31:68:E9,3854149,489239935,4179,3705045,3849970,485534890,1,5704,1227877,5526,1187379,178,40498,2316,12,4448,104,1,65,216660.0,130000.0,-52.0,-47.0,-42.0,-48.0,-51.0,-47.0,-43.0,-47.0,-90.0,-93.0,-89.0,-93.0,38.0,46.0,47.0,45.0,1
193,CC:2F:71:3F:1F:24,5148442,1990854364,1298472,1505319474,3849970,485534890,2222,1095957,1261868482,1095085,1261762836,872,105646,1060710,15,1296607,122954,2219,841,144444.0,43333.0,-71.0,-70.0,-67.0,-72.0,-71.0,-69.0,-66.0,-71.0,-90.0,-93.0,-89.0,-93.0,19.0,23.0,22.0,21.0,1
194,CC:2F:71:3E:C5:1F,3850991,485659705,1021,124815,3849970,485534890,3,4464,372121,3722,284035,742,88086,1081,14,1468,30,3,54,130000.0,39000.0,-72.0,-72.0,-70.0,-60.0,-72.0,-71.0,-69.0,-60.0,-90.0,-93.0,-89.0,-93.0,18.0,21.0,19.0,33.0,1
195,BA:8C:B9:54:50:24,3854926,491731682,4956,6196792,3849970,485534890,7,9976,1767056,9954,1763561,22,3495,2361,18,5479,44,7,77,216660.0,130000.0,-48.0,-35.0,-43.0,-45.0,-43.0,-36.0,-44.0,-49.0,-90.0,-93.0,-89.0,-93.0,42.0,58.0,46.0,48.0,1
196,62:47:05:9D:EB:15,3857004,497837353,7030,12302059,3849974,485535294,1,7472,3908596,7422,3900938,50,7658,3572,0,7109,56,1,126,216660.0,130000.0,-44.0,-50.0,-46.0,-43.0,-43.0,-45.0,-37.0,-46.0,-90.0,-93.0,-89.0,-93.0,46.0,43.0,43.0,50.0,1
197,92:69:1D:31:68:E9,3854153,489240339,4179,3705045,3849974,485535294,1,5704,1227877,5526,1187379,178,40498,2316,12,4448,104,1,65,216660.0,130000.0,-52.0,-47.0,-42.0,-48.0,-51.0,-47.0,-43.0,-47.0,-90.0,-93.0,-89.0,-93.0,38.0,46.0,47.0,45.0,1
198,CC:2F:71:3F:1F:24,5148996,1991556908,1299020,1506021412,3849976,485535496,2222,1096296,1262126972,1095424,1262021326,872,105646,1061046,15,1297155,122976,2219,842,144444.0,43333.0,-71.0,-70.0,-67.0,-72.0,-71.0,-69.0,-67.0,-71.0,-90.0,-93.0,-89.0,-93.0,19.0,23.0,22.0,21.0,1
199,CC:2F:71:3E:C5:1F,3850997,485660311,1021,124815,3849976,485535496,3,4464,372121,3722,284035,742,88086,1081,14,1468,30,3,54,130000.0,39000.0,-72.0,-72.0,-70.0,-60.0,-72.0,-71.0,-69.0,-60.0,-90.0,-93.0,-89.0,-93.0,18.0,21.0,19.0,33.0,1
200,BA:8C:B9:54:50:24,3854932,491732288,4956,6196792,3849976,485535496,7,9976,1767056,9954,1763561,22,3495,2361,18,5479,44,7,77,216660.0,130000.0,-48.0,-35.0,-43.0,-45.0,-43.0,-36.0,-44.0,-49.0,-90.0,-93.0,-89.0,-93.0,42.0,58.0,46.0,48.0,1
201,62:47:05:9D:EB:15,3857008,497837757,7030,12302059,3849978,485535698,1,7472,3908596,7422,3900938,50,7658,3572,0,7109,56,1,126,216660.0,130000.0,-44.0,-50.0,-46.0,-43.0,-43.0,-45.0,-37.0,-46.0,-90.0,-93.0,-89.0,-93.0,46.0,43.0,43.0,50.0,1
202,92:69:1D:31:68:E9,3854157,489240743,4179,3705045,3849978,485535698,1,5704,1227877,5526,1187379,178,40498,2316,12,4448,104,1,65,216660.0,130000.0,-52.0,-47.0,-42.0,-48.0,-51.0,-47.0,-43.0,-47.0,-90.0,-93.0,-89.0,-93.0,38.0,46.0,47.0,45.0,1
203,CC:2F:71:3F:1F:24,5149252,1991846357,1299274,1506310659,3849978,485535698,2222,1096528,1262373955,1095656,1262268309,872,105646,1061269,15,1297407,122983,2219,842,144444.0,43333.0,-71.0,-70.0,-67.0,-72.0,-71.0,-69.0,-67.0,-71.0,-90.0,-93.0,-89.0,-93.0,19.0,23.0,22.0,21.0,1
204,CC:2F:71:3E:C5:1F,3850999,485660513,1021,124815,3849978,485535698,3,4464,372121,3722,284035,742,88086,1081,14,1468,30,3,54,130000.0,39000.0,-72.0,-72.0,-70.0,-60.0,-72.0,-71.0,-69.0,-60.0,-90.0,-93.0,-89.0,-93.0,18.0,21.0,19.0,33.0,1
205,BA:8C:B9:54:50:24,3854934,491732490,4956,6196792,3849978,485535698,7,9976,1767056,9954,1763561,22,3495,2361,18,5479,44,7,77,216660.0,130000.0,-48.0,-35.0,-43.0,-45.0,-43.0,-36.0,-44.0,-49.0,-90.0,-93.0,-89.0,-92.0,42.0,58.0,46.0,47.0,1
206,62:47:05:9D:EB:15,3857013,497838221,7030,12302059,3849983,485536162,1,7472,3908596,7422,3900938,50,7658,3572,0,7109,56,1,126,216660.0,130000.0,-44.0,-50.0,-46.0,-43.0,-43.0,-45.0,-37.0,-46.0,-90.0,-93.0,-89.0,-92.0,46.0,43.0,43.0,49.0,1
207,92:69:1D:31:68:E9,3854164,489241409,4179,3705045,3849985,485536364,1,5704,1227877,5526,1187379,178,40498,2316,12,4448,104,1,65,216660.0,130000.0,-52.0,-47.0,-42.0,-48.0,-51.0,-47.0,-43.0,-47.0,-90.0,-93.0,-89.0,-92.0,38.0,46.0,47.0,44.0,1
208,CC:2F:71:3F:1F:24,5149452,1992088691,1299467,1506552327,3849985,485536364,2222,1096701,1262607941,1095829,1262502295,872,105646,1061437,15,1297600,122996,2219,842,144444.0,43333.0,-72.0,-70.0,-68.0,-72.0,-72.0,-70.0,-67.0,-72.0,-90.0,-93.0,-89.0,-92.0,18.0,23.0,21.0,20.0,1
209,CC:2F:71:3E:C5:1F,3851007,485661295,1022,124931,3849985,485536364,3,4465,372191,3723,284105,742,88086,1081,14,1469,30,3,54,130000.0,39000.0,-72.0,-72.0,-69.0,-60.0,-72.0,-72.0,-69.0,-60.0,-90.0,-93.0,-89.0,-92.0,18.0,21.0,20.0,32.0,1
210,BA:8C:B9:54:50:24,3854943,491733358,4956,6196792,3849987,485536566,7,9976,1767056,9954,1763561,22,3495,2361,18,5479,44,7,77,216660.0,130000.0,-48.0,-35.0,-43.0,-45.0,-43.0,-36.0,-44.0,-49.0,-90.0,-93.0,-89.0,-92.0,42.0,58.0,46.0,47.0,1
211,62:47:05:9D:EB:15,3857018,497838741,7031,12302175,3849987,485536566,1,7473,3908664,7423,3901006,50,7658,3572,0,7110,56,1,126,216660.0,130000.0,-44.0,-45.0,-35.0,-47.0,-43.0,-45.0,-37.0,-46.0,-90.0,-93.0,-89.0,-92.0,46.0,48.0,54.0,45.0,1
212,92:69:1D:31:68:E9,3854167,489241727,4180,3705161,3849987,485536566,1,5706,1228013,5528,1187515,178,40498,2316,12,4449,104,1,65,216660.0,130000.0,-52.0,-47.0,-42.0,-48.0,-51.0,-47.0,-43.0,-47.0,-90.0,-93.0,-89.0,-92.0,38.0,46.0,47.0,44.0,1
213,CC:2F:71:3F:1F:24,5149646,1992330413,1299659,1506793847,3849987,485536566,2222,1096876,1262842187,1096004,1262736541,872,105646,1061607,15,1297793,123006,2219,842,144444.0,43333.0,-72.0,-70.0,-68.0,-72.0,-72.0,-70.0,-67.0,-72.0,-90.0,-93.0,-89.0,-92.0,18.0,23.0,21.0,20.0,1
214,CC:2F:71:3E:C5:1F,3851011,485661699,1022,124931,3849989,485536768,3,4466,372261,3724,284175,742,88086,1081,14,1469,30,3,54,130000.0,39000.0,-72.0,-72.0,-70.0,-60.0,-72.0,-72.0,-69.0,-60.0,-90.0,-93.0,-89.0,-92.0,18.0,21.0,19.0,32.0,1
215,BA:8C:B9:54:50:24,3854946,491733676,4957,6196908,3849989,485536768,7,9978,1767192,9956,1763697,22,3495,2361,18,5480,44,7,77,216660.0,130000.0,-39.0,-37.0,-45.0,-52.0,-42.0,-36.0,-44.0,-49.0,-90.0,-93.0,-89.0,-92.0,51.0,56.0,44.0,40.0,1
216,62:47:05:9D:EB:15,3857026,497839469,7031,12302175,3849995,485537294,1,7474,3908732,7424,3901074,50,7658,3572,0,7110,56,1,126,216660.0,130000.0,-44.0,-45.0,-35.0,-47.0,-43.0,-45.0,-37.0,-46.0,-90.0,-92.0,-89.0,-92.0,46.0,47.0,54.0,45.0,1
217,92:69:1D:31:68:E9,3854175,489242455,4180,3705161,3849995,485537294,1,5706,1228013,5528,1187515,178,40498,2316,12,4449,104,1,65,216660.0,130000.0,-52.0,-47.0,-42.0,-48.0,-51.0,-47.0,-43.0,-47.0,-90.0,-92.0,-89.0,-92.0,38.0,45.0,47.0,44.0,1
218,CC:2F:71:3F:1F:24,5149854,1992576220,1299857,1507038724,3849997,485537496,2222,1097054,1263070000,1096181,1262964236,873,105764,1061785,15,1297992,123028,2219,842,144444.0,43333.0,-71.0,-69.0,-68.0,-72.0,-71.0,-69.0,-67.0,-72.0,-90.0,-92.0,-89.0,-92.0,19.0,23.0,21.0,20.0,1
219,CC:2F:71:3E:C5:1F,3851019,485662427,1022,124931,3849997,485537496,3,4466,372261,3724,284175,742,88086,1081,14,1469,30,3,54,130000.0,39000.0,-72.0,-72.0,-70.0,-60.0,-72.0,-72.0,-69.0,-60.0,-90.0,-92.0,-89.0,-92.0,18.0,20.0,19.0,32.0,1
220,BA:8C:B9:54:50:24,3854954,491734404,4957,6196908,3849997,485537496,7,9978,1767192,9956,1763697,22,3495,2361,18,5480,44,7,77,216660.0,130000.0,-39.0,-37.0,-45.0,-52.0,-42.0,-36.0,-44.0,-49.0,-90.0,-92.0,-89.0,-92.0,51.0,55.0,44.0,40.0,1
221,62:47:05:9D:EB:15,3857028,497839671,7031,12302175,3849997,485537496,1,7474,3908732,7424,3901074,50,7658,3572,0,7110,56,1,126,216660.0,130000.0,-44.0,-45.0,-35.0,-47.0,-43.0,-45.0,-37.0,-46.0,-90.0,-92.0,-89.0,-92.0,46.0,47.0,54.0,45.0,1
222,92:69:1D:31:68:E9,3854177,489242657,4180,3705161,3849997,485537496,1,5706,1228013,5528,1187515,178,40498,2316,12,4449,104,1,65,216660.0,130000.0,-52.0,-47.0,-42.0,-48.0,-51.0,-47.0,-43.0,-47.0,-90.0,-92.0,-89.0,-92.0,38.0,45.0,47.0,44.0,1
223,CC:2F:71:3F:1F:24,5150242,1993063908,1300243,1507526210,3849999,485537698,2222,1097312,1263310606,1096439,1263204842,873,105764,1062042,15,1298376,123086,2219,842,144444.0,43333.0,-71.0,-70.0,-67.0,-72.0,-71.0,-69.0,-66.0,-71.0,-90.0,-92.0,-89.0,-92.0,19.0,22.0,22.0,20.0,1
224,CC:2F:71:3E:C5:1F,3851021,485662629,1022,124931,3849999,485537698,3,4466,372261,3724,284175,742,88086,1081,14,1469,30,3,54,130000.0,39000.0,-72.0,-72.0,-70.0,-60.0,-72.0,-72.0,-69.0,-60.0,-90.0,-92.0,-89.0,-92.0,18.0,20.0,19.0,32.0,1
225,BA:8C:B9:54:50:24,3854956,491734606,4957,6196908,3849999,485537698,7,9978,1767192,9956,1763697,22,3495,2361,18,5480,44,7,77,216660.0,130000.0,-39.0,-37.0,-45.0,-52.0,-42.0,-36.0,-44.0,-49.0,-90.0,-92.0,-89.0,-92.0,51.0,55.0,44.0,40.0,1
226,62:47:05:9D:EB:15,3857035,497840550,7031,12302175,3850004,485538375,1,7474,3908732,7424,3901074,50,7658,3572,0,7110,56,1,126,216660.0,130000.0,-44.0,-45.0,-35.0,-47.0,-43.0,-45.0,-37.0,-46.0,-90.0,-92.0,-89.0,-92.0,46.0,47.0,54.0,45.0,1
227,92:69:1D:31:68:E9,3854184,489243536,4180,3705161,3850004,485538375,1,5706,1228013,5528,1187515,178,40498,2316,12,4449,104,1,65,216660.0,130000.0,-52.0,-47.0,-42.0,-48.0,-51.0,-47.0,-43.0,-47.0,-90.0,-92.0,-89.0,-92.0,38.0,45.0,47.0,44.0,1
228,CC:2F:71:3F:1F:24,5150651,1993569391,1300645,1508030814,3850006,485538577,2222,1097588,1263557436,1096715,1263451672,873,105764,1062316,15,1298779,123167,2219,842,144444.0,43333.0,-71.0,-70.0,-67.0,-72.0,-71.0,-70.0,-67.0,-72.0,-90.0,-92.0,-89.0,-92.0,19.0,22.0,22.0,20.0,1
229,CC:2F:71:3E:C5:1F,3851028,485663508,1022,124931,3850006,485538577,3,4466,372261,3724,284175,742,88086,1081,14,1469,30,3,54,130000.0,39000.0,-72.0,-72.0,-70.0,-60.0,-72.0,-72.0,-69.0,-60.0,-90.0,-92.0,-89.0,-92.0,18.0,20.0,19.0,32.0,1
230,BA:8C:B9:54:50:24,3854964,491735545,4957,6196908,3850007,485538637,7,9978,1767192,9956,1763697,22,3495,2361,18,5480,44,7,77,216660.0,130000.0,-39.0,-37.0,-45.0,-52.0,-42.0,-36.0,-44.0,-49.0,-90.0,-92.0,-88.0,-91.0,51.0,55.0,43.0,39.0,1
231,62:47:05:9D:EB:15,3857040,497841014,7031,12302175,3850009,485538839,1,7474,3908732,7424,3901074,50,7658,3572,0,7110,56,1,126,216660.0,130000.0,-44.0,-45.0,-35.0,-47.0,-43.0,-45.0,-37.0,-46.0,-90.0,-92.0,-88.0,-91.0,46.0,47.0,53.0,44.0,1
232,92:69:1D:31:68:E9,3854189,489244000,4180,3705161,3850009,485538839,1,5706,1228013,5528,1187515,178,40498,2316,12,4449,104,1,65,216660.0,130000.0,-52.0,-47.0,-42.0,-48.0,-51.0,-47.0,-43.0,-47.0,-90.0,-92.0,-88.0,-91.0,38.0,45.0,46.0,43.0,1
233,CC:2F:71:3F:1F:24,5151223,1994293546,1301214,1508754707,3850009,485538839,2222,1097933,1263813867,1097060,1263708103,873,105764,1062661,15,1299349,123288,2219,842,144444.0,43333.0,-71.0,-69.0,-67.0,-72.0,-71.0,-69.0,-67.0,-71.0,-90.0,-92.0,-88.0,-91.0,19.0,23.0,21.0,19.0,1
234,CC:2F:71:3E:C5:1F,3851031,485663770,1022,124931,3850009,485538839,3,4466,372261,3724,284175,742,88086,1081,14,1469,30,3,54,130000.0,39000.0,-72.0,-72.0,-70.0,-60.0,-72.0,-72.0,-69.0,-60.0,-90.0,-92.0,-88.0,-91.0,18.0,20.0,18.0,31.0,1
235,BA:8C:B9:54:50:24,3854967,491735881,4957,6196908,3850010,485538973,7,9978,1767192,9956,1763697,22,3495,2361,18,5480,44,7,77,216660.0,130000.0,-39.0,-37.0,-45.0,-52.0,-42.0,-36.0,-44.0,-49.0,-90.0,-92.0,-88.0,-91.0,51.0,55.0,43.0,39.0,1
236,62:47:05:9D:EB:15,3857046,497841620,7031,12302175,3850015,485539445,1,7474,3908732,7424,3901074,50,7658,3572,0,7110,56,1,126,216660.0,130000.0,-44.0,-45.0,-35.0,-47.0,-43.0,-45.0,-37.0,-46.0,-90.0,-92.0,-88.0,-91.0,46.0,47.0,53.0,44.0,1
237,92:69:1D:31:68:E9,3854195,489244606,4180,3705161,3850015,485539445,1,5706,1228013,5528,1187515,178,40498,2316,12,4449,104,1,65,216660.0,130000.0,-52.0,-47.0,-42.0,-48.0,-51.0,-47.0,-43.0,-47.0,-90.0,-92.0,-88.0,-91.0,38.0,45.0,46.0,43.0,1
238,CC:2F:71:3F:1F:24,5151788,1995001578,1301773,1509462133,3850015,485539445,2222,1098274,1264070954,1097401,1263965190,873,105764,1063002,15,1299908,123390,2219,842,144444.0,43333.0,-71.0,-70.0,-67.0,-72.0,-71.0,-70.0,-67.0,-72.0,-90.0,-92.0,-88.0,-91.0,19.0,22.0,21.0,19.0,1
239,CC:2F:71:3E:C5:1F,3851037,485664376,1022,124931,3850015,485539445,3,4466,372261,3724,284175,742,88086,1081,14,1469,30,3,54,130000.0,39000.0,-72.0,-72.0,-70.0,-60.0,-72.0,-72.0,-69.0,-60.0,-90.0,-92.0,-88.0,-91.0,18.0,20.0,18.0,31.0,1
240,BA:8C:B9:54:50:24,3854972,491736353,4957,6196908,3850015,485539445,7,9978,1767192,9956,1763697,22,3495,2361,18,5480,44,7,77,216660.0,130000.0,-39.0,-37.0,-45.0,-52.0,-42.0,-36.0,-44.0,-49.0,-90.0,-92.0,-88.0,-91.0,51.0,55.0,43.0,39.0,1
241,62:47:05:9D:EB:15,3857049,497841882,7031,12302175,3850018,485539707,1,7474,3908732,7424,3901074,50,7658,3572,0,7110,56,1,126,216660.0,130000.0,-44.0,-45.0,-35.0,-47.0,-43.0,-45.0,-37.0,-46.0,-90.0,-91.0,-88.0,-91.0,46.0,46.0,53.0,44.0,1
242,92:69:1D:31:68:E9,3854198,489244868,4180,3705161,3850018,485539707,1,5706,1228013,5528,1187515,178,40498,2316,12,4449,104,1,65,216660.0,130000.0,-52.0,-47.0,-42.0,-48.0,-51.0,-47.0,-43.0,-47.0,-90.0,-91.0,-88.0,-91.0,38.0,44.0,46.0,43.0,1
243,CC:2F:71:3F:1F:24,5152385,1995754126,1302365,1510214217,3850020,485539909,2222,1098632,1264341486,1097759,1264235722,873,105764,1063360,15,1300500,123514,2219,842,144444.0,43333.0,-72.0,-70.0,-67.0,-72.0,-71.0,-70.0,-67.0,-72.0,-90.0,-91.0,-88.0,-91.0,18.0,21.0,21.0,19.0,1
244,CC:2F:71:3E:C5:1F,3851042,485664840,1022,124931,3850020,485539909,3,4466,372261,3724,284175,742,88086,1081,14,1469,30,3,54,130000.0,39000.0,-72.0,-72.0,-70.0,-60.0,-72.0,-72.0,-69.0,-60.0,-90.0,-91.0,-88.0,-91.0,18.0,19.0,18.0,31.0,1
245,BA:8C:B9:54:50:24,3854977,491736817,4957,6196908,3850020,485539909,7,9978,1767192,9956,1763697,22,3495,2361,18,5480,44,7,77,216660.0,130000.0,-39.0,-37.0,-45.0,-52.0,-42.0,-36.0,-44.0,-49.0,-90.0,-91.0,-88.0,-91.0,51.0,54.0,43.0,39.0,1
246,62:47:05:9D:EB:15,3857055,497842488,7031,12302175,3850024,485540313,1,7474,3908732,7424,3901074,50,7658,3572,0,7110,56,1,126,216660.0,130000.0,-44.0,-45.0,-35.0,-47.0,-43.0,-45.0,-37.0,-46.0,-90.0,-91.0,-88.0,-91.0,46.0,46.0,53.0,44.0,1
247,92:69:1D:31:68:E9,3854204,489245474,4180,3705161,3850024,485540313,1,5706,1228013,5528,1187515,178,40498,2316,12,4449,104,1,65,216660.0,130000.0,-52.0,-47.0,-42.0,-48.0,-51.0,-47.0,-43.0,-47.0,-90.0,-91.0,-88.0,-91.0,38.0,44.0,46.0,43.0,1
248,CC:2F:71:3F:1F:24,5153006,1996528679,1302982,1510988366,3850024,485540313,2222,1098999,1264600146,1098126,1264494382,873,105764,1063727,15,1301117,123645,2219,842,144444.0,43333.0,-72.0,-70.0,-67.0,-72.0,-71.0,-70.0,-67.0,-72.0,-90.0,-91.0,-88.0,-91.0,18.0,21.0,21.0,19.0,1
249,CC:2F:71:3E:C5:1F,3851046,485665244,1022,124931,3850024,485540313,3,4466,372261,3724,284175,742,88086,1081,14,1469,30,3,54,130000.0,39000.0,-72.0,-72.0,-70.0,-60.0,-72.0,-72.0,-69.0,-60.0,-90.0,-91.0,-88.0,-91.0,18.0,19.0,18.0,31.0,1
250,BA:8C:B9:54:50:24,3854981,491737221,4957,6196908,3850024,485540313,7,9978,1767192,9956,1763697,22,3495,2361,18,5480,44,7,77,216660.0,130000.0,-39.0,-37.0,-45.0,-52.0,-42.0,-36.0,-44.0,-49.0,-90.0,-91.0,-88.0,-91.0,51.0,54.0,43.0,39.0,1
251,62:47:05:9D:EB:15,3857060,497842954,7031,12302175,3850029,485540779,1,7474,3908732,7424,3901074,50,7658,3572,0,7110,56,1,126,216660.0,130000.0,-44.0,-45.0,-35.0,-47.0,-43.0,-45.0,-37.0,-46.0,-90.0,-91.0,-88.0,-91.0,46.0,46.0,53.0,44.0,1
252,92:69:1D:31:68:E9,3854209,489245940,4180,3705161,3850029,485540779,1,5706,1228013,5528,1187515,178,40498,2316,12,4449,104,1,65,216660.0,130000.0,-52.0,-47.0,-42.0,-48.0,-51.0,-47.0,-43.0,-47.0,-90.0,-91.0,-88.0,-91.0,38.0,44.0,46.0,43.0,1
253,CC:2F:71:3F:1F:24,5153204,1996772235,1303175,1511231456,3850029,485540779,2222,1099172,1264829748,1098299,1264723984,873,105764,1063899,15,1301309,123660,2219,842,144444.0,43333.0,-70.0,-69.0,-67.0,-74.0,-70.0,-69.0,-66.0,-73.0,-90.0,-91.0,-88.0,-91.0,20.0,22.0,21.0,17.0,1
254,CC:2F:71:3E:C5:1F,3851052,485665770,1022,124931,3850030,485540839,3,4468,372449,3725,284245,743,88204,1082,14,1469,30,3,54,130000.0,39000.0,-72.0,-72.0,-70.0,-60.0,-72.0,-72.0,-69.0,-60.0,-90.0,-91.0,-88.0,-90.0,18.0,19.0,18.0,30.0,1
255,BA:8C:B9:54:50:24,3854987,491737747,4957,6196908,3850030,485540839,7,9978,1767192,9956,1763697,22,3495,2361,18,5480,44,7,77,216660.0,130000.0,-39.0,-37.0,-45.0,-52.0,-42.0,-36.0,-44.0,-49.0,-90.0,-91.0,-88.0,-90.0,51.0,54.0,43.0,38.0,1
256,62:47:05:9D:EB:15,3857065,497843418,7031,12302175,3850034,485541243,1,7474,3908732,7424,3901074,50,7658,3572,0,7110,56,1,126,216660.0,130000.0,-44.0,-45.0,-35.0,-47.0,-43.0,-45.0,-37.0,-46.0,-90.0,-91.0,-88.0,-90.0,46.0,46.0,53.0,43.0,1
257,92:69:1D:31:68:E9,3854214,489246404,4180,3705161,3850034,485541243,1,5707,1228081,5529,1187583,178,40498,2316,12,4449,104,1,65,216660.0,130000.0,-51.0,-47.0,-46.0,-47.0,-51.0,-47.0,-43.0,-47.0,-90.0,-91.0,-88.0,-90.0,39.0,44.0,42.0,43.0,1
258,CC:2F:71:3F:1F:24,5153402,1997015789,1303368,1511474546,3850034,485541243,2222,1099347,1265061224,1098474,1264955460,873,105764,1064070,15,1301503,123660,2219,842,144444.0,43333.0,-71.0,-70.0,-66.0,-74.0,-71.0,-70.0,-66.0,-73.0,-90.0,-91.0,-88.0,-90.0,19.0,21.0,22.0,16.0,1
259,CC:2F:71:3E:C5:1F,3851056,485666174,1022,124931,3850034,485541243,3,4468,372449,3725,284245,743,88204,1082,14,1469,30,3,54,130000.0,39000.0,-72.0,-72.0,-70.0,-60.0,-72.0,-72.0,-69.0,-60.0,-90.0,-91.0,-88.0,-90.0,18.0,19.0,18.0,30.0,1
260,BA:8C:B9:54:50:24,3854991,491738151,4957,6196908,3850034,485541243,7,9978,1767192,9956,1763697,22,3495,2361,18,5480,44,7,77,216660.0,130000.0,-39.0,-37.0,-45.0,-52.0,-42.0,-36.0,-44.0,-49.0,-90.0,-91.0,-88.0,-90.0,51.0,54.0,43.0,38.0,1
261,62:47:05:9D:EB:15,3857069,497843822,7031,12302175,3850038,485541647,1,7474,3908732,7424,3901074,50,7658,3572,0,7110,56,1,126,216660.0,130000.0,-44.0,-45.0,-35.0,-47.0,-43.0,-45.0,-37.0,-46.0,-90.0,-91.0,-88.0,-90.0,46.0,46.0,53.0,43.0,1
262,92:69:1D:31:68:E9,3854218,489246808,4180,3705161,3850038,485541647,1,5707,1228081,5529,1187583,178,40498,2316,12,4449,104,1,65,216660.0,130000.0,-51.0,-47.0,-46.0,-47.0,-51.0,-47.0,-43.0,-47.0,-90.0,-91.0,-88.0,-90.0,39.0,44.0,42.0,43.0,1
263,CC:2F:71:3F:1F:24,5153598,1997257561,1303560,1511715914,3850038,485541647,2222,1099519,1265292176,1098646,1265186412,873,105764,1064238,15,1301695,123665,2219,842,144444.0,43333.0,-71.0,-70.0,-66.0,-74.0,-70.0,-70.0,-66.0,-73.0,-90.0,-91.0,-88.0,-90.0,19.0,21.0,22.0,16.0,1
264,CC:2F:71:3E:C5:1F,3851060,485666578,1022,124931,3850038,485541647,3,4468,372449,3725,284245,743,88204,1082,14,1469,30,3,54,130000.0,39000.0,-72.0,-72.0,-70.0,-60.0,-72.0,-72.0,-69.0,-60.0,-90.0,-91.0,-88.0,-90.0,18.0,19.0,18.0,30.0,1
265,BA:8C:B9:54:50:24,3854995,491738555,4957,6196908,3850038,485541647,7,9978,1767192,9956,1763697,22,3495,2361,18,5480,44,7,77,216660.0,130000.0,-39.0,-37.0,-45.0,-52.0,-42.0,-36.0,-44.0,-49.0,-90.0,-91.0,-88.0,-90.0,51.0,54.0,43.0,38.0,1
266,62:47:05:9D:EB:15,3857074,497844286,7031,12302175,3850043,485542111,1,7474,3908732,7424,3901074,50,7658,3572,0,7110,56,1,126,216660.0,130000.0,-44.0,-45.0,-35.0,-47.0,-43.0,-45.0,-37.0,-46.0,-89.0,-91.0,-88.0,-90.0,45.0,46.0,53.0,43.0,1
267,92:69:1D:31:68:E9,3854223,489247272,4180,3705161,3850043,485542111,1,5707,1228081,5529,1187583,178,40498,2316,12,4449,104,1,65,216660.0,130000.0,-51.0,-47.0,-46.0,-47.0,-51.0,-47.0,-43.0,-47.0,-89.0,-91.0,-88.0,-90.0,38.0,44.0,42.0,43.0,1
268,CC:2F:71:3F:1F:24,5153803,1997506010,1303760,1511963899,3850043,485542111,2222,1099704,1265533713,1098831,1265427949,873,105764,1064416,15,1301895,123666,2219,842,144444.0,43333.0,-71.0,-71.0,-67.0,-74.0,-71.0,-71.0,-67.0,-73.0,-89.0,-91.0,-88.0,-90.0,18.0,20.0,21.0,16.0,1
269,CC:2F:71:3E:C5:1F,3851065,485667042,1022,124931,3850043,485542111,3,4468,372449,3725,284245,743,88204,1082,14,1469,30,3,54,130000.0,39000.0,-72.0,-72.0,-70.0,-60.0,-72.0,-72.0,-69.0,-60.0,-89.0,-91.0,-88.0,-90.0,17.0,19.0,18.0,30.0,1
270,BA:8C:B9:54:50:24,3855000,491739019,4957,6196908,3850043,485542111,7,9978,1767192,9956,1763697,22,3495,2361,18,5480,44,7,77,216660.0,130000.0,-39.0,-37.0,-45.0,-52.0,-42.0,-36.0,-44.0,-49.0,-89.0,-91.0,-88.0,-90.0,50.0,54.0,43.0,38.0,1
271,62:47:05:9D:EB:15,3857090,497850289,7031,12302175,3850059,485548114,1,7474,3908732,7424,3901074,50,7658,3572,0,7110,56,1,126,216660.0,130000.0,-44.0,-45.0,-35.0,-47.0,-43.0,-45.0,-37.0,-46.0,-89.0,-90.0,-87.0,-89.0,45.0,45.0,52.0,42.0,1
272,92:69:1D:31:68:E9,3854239,489253275,4180,3705161,3850059,485548114,1,5710,1228452,5531,1187719,179,40733,2317,12,4449,104,1,66,216660.0,130000.0,-51.0,-47.0,-42.0,-48.0,-51.0,-47.0,-43.0,-47.0,-89.0,-90.0,-87.0,-89.0,38.0,43.0,45.0,41.0,1
273,CC:2F:71:3F:1F:24,5154032,1997774401,1303962,1512220863,3850070,485553538,2222,1099890,1265784829,1099017,1265679065,873,105764,1064596,15,1302097,123666,2219,842,144444.0,43333.0,-71.0,-70.0,-68.0,-74.0,-70.0,-70.0,-67.0,-73.0,-89.0,-90.0,-87.0,-89.0,18.0,20.0,19.0,15.0,1
274,CC:2F:71:3E:C5:1F,3851092,485678469,1022,124931,3850070,485553538,3,4468,372449,3725,284245,743,88204,1082,14,1469,30,3,54,130000.0,39000.0,-72.0,-72.0,-70.0,-60.0,-72.0,-72.0,-69.0,-60.0,-89.0,-90.0,-87.0,-89.0,17.0,18.0,17.0,29.0,1
275,BA:8C:B9:54:50:24,3855027,491750446,4957,6196908,3850070,485553538,7,9980,1767328,9958,1763833,22,3495,2361,18,5481,44,7,77,216660.0,130000.0,-48.0,-35.0,-43.0,-45.0,-42.0,-35.0,-44.0,-49.0,-89.0,-90.0,-87.0,-89.0,41.0,55.0,44.0,44.0,1
276,62:47:05:9D:EB:15,3857105,497856117,7031,12302175,3850074,485553942,1,7476,3908868,7426,3901210,50,7658,3572,0,7111,56,1,126,216660.0,130000.0,-44.0,-46.0,-35.0,-47.0,-43.0,-46.0,-37.0,-46.0,-89.0,-90.0,-87.0,-89.0,45.0,44.0,52.0,42.0,1
277,92:69:1D:31:68:E9,3854255,489259163,4180,3705161,3850075,485554002,1,5710,1228452,5531,1187719,179,40733,2317,12,4449,104,1,66,216660.0,130000.0,-51.0,-47.0,-42.0,-48.0,-51.0,-47.0,-43.0,-47.0,-89.0,-90.0,-87.0,-89.0,38.0,43.0,45.0,41.0,1
278,CC:2F:71:3F:1F:24,5154239,1998029035,1304162,1512474831,3850077,485554204,2222,1100075,1266031781,1099202,1265926017,873,105764,1064771,15,1302295,123666,2219,842,144444.0,43333.0,-72.0,-69.0,-67.0,-72.0,-72.0,-69.0,-67.0,-72.0,-89.0,-90.0,-87.0,-89.0,17.0,21.0,20.0,17.0,1
279,CC:2F:71:3E:C5:1F,3851099,485679135,1022,124931,3850077,485554204,3,4468,372449,3725,284245,743,88204,1082,14,1469,30,3,54,130000.0,39000.0,-72.0,-72.0,-70.0,-60.0,-72.0,-72.0,-69.0,-60.0,-89.0,-90.0,-87.0,-89.0,17.0,18.0,17.0,29.0,1
280,BA:8C:B9:54:50:24,3855034,491751112,4957,6196908,3850077,485554204,7,9980,1767328,9958,1763833,22,3495,2361,18,5481,44,7,77,216660.0,130000.0,-48.0,-35.0,-43.0,-45.0,-42.0,-35.0,-44.0,-49.0,-89.0,-90.0,-87.0,-89.0,41.0,55.0,44.0,44.0,1
281,62:47:05:9D:EB:15,3857110,497856581,7031,12302175,3850079,485554406,1,7476,3908868,7426,3901210,50,7658,3572,0,7111,56,1,126,216660.0,130000.0,-44.0,-46.0,-35.0,-47.0,-43.0,-46.0,-37.0,-46.0,-89.0,-90.0,-87.0,-89.0,45.0,44.0,52.0,42.0,1
282,92:69:1D:31:68:E9,3854259,489259567,4180,3705161,3850079,485554406,1,5710,1228452,5531,1187719,179,40733,2317,12,4449,104,1,66,216660.0,130000.0,-51.0,-47.0,-42.0,-48.0,-51.0,-47.0,-43.0,-47.0,-89.0,-90.0,-87.0,-89.0,38.0,43.0,45.0,41.0,1
283,CC:2F:71:3F:1F:24,5154431,1998267665,1304352,1512713259,3850079,485554406,2222,1100252,1266270461,1099379,1266164697,873,105764,1064942,15,1302487,123666,2219,842,144444.0,43333.0,-72.0,-69.0,-66.0,-73.0,-72.0,-69.0,-66.0,-72.0,-89.0,-90.0,-87.0,-89.0,17.0,21.0,21.0,16.0,1
284,CC:2F:71:3E:C5:1F,3851101,485679337,1022,124931,3850079,485554406,3,4468,372449,3725,284245,743,88204,1082,14,1469,30,3,54,130000.0,39000.0,-72.0,-72.0,-70.0,-60.0,-72.0,-72.0,-69.0,-60.0,-89.0,-90.0,-87.0,-89.0,17.0,18.0,17.0,29.0,1
285,BA:8C:B9:54:50:24,3855038,491751516,4957,6196908,3850081,485554608,7,9980,1767328,9958,1763833,22,3495,2361,18,5481,44,7,77,216660.0,130000.0,-48.0,-35.0,-43.0,-45.0,-42.0,-35.0,-44.0,-49.0,-89.0,-90.0,-87.0,-89.0,41.0,55.0,44.0,44.0,1
286,62:47:05:9D:EB:15,3857117,497857460,7031,12302175,3850086,485555285,1,7476,3908868,7426,3901210,50,7658,3572,0,7111,56,1,126,216660.0,130000.0,-44.0,-46.0,-35.0,-47.0,-43.0,-46.0,-37.0,-46.0,-89.0,-90.0,-87.0,-89.0,45.0,44.0,52.0,42.0,1
287,92:69:1D:31:68:E9,3854266,489260446,4180,3705161,3850086,485555285,1,5710,1228452,5531,1187719,179,40733,2317,12,4449,104,1,66,216660.0,130000.0,-51.0,-47.0,-42.0,-48.0,-51.0,-47.0,-43.0,-47.0,-89.0,-90.0,-87.0,-89.0,38.0,43.0,45.0,41.0,1
288,CC:2F:71:3F:1F:24,5154651,1998535307,1304565,1512980022,3850086,485555285,2222,1100444,1266521466,1099571,1266415702,873,105764,1065131,15,1302700,123668,2219,842,144444.0,43333.0,-72.0,-69.0,-67.0,-73.0,-72.0,-69.0,-67.0,-73.0,-89.0,-90.0,-87.0,-89.0,17.0,21.0,20.0,16.0,1
289,CC:2F:71:3E:C5:1F,3851108,485680216,1022,124931,3850086,485555285,3,4468,372449,3725,284245,743,88204,1082,14,1469,30,3,54,130000.0,39000.0,-72.0,-72.0,-70.0,-60.0,-72.0,-72.0,-69.0,-60.0,-89.0,-90.0,-87.0,-89.0,17.0,18.0,17.0,29.0,1
290,BA:8C:B9:54:50:24,3855043,491752193,4957,6196908,3850086,485555285,7,9980,1767328,9958,1763833,22,3495,2361,18,5481,44,7,77,216660.0,130000.0,-48.0,-35.0,-43.0,-45.0,-42.0,-35.0,-44.0,-49.0,-89.0,-90.0,-87.0,-89.0,41.0,55.0,44.0,44.0,1
291,62:47:05:9D:EB:15,3857120,497857722,7031,12302175,3850089,485555547,1,7476,3908868,7426,3901210,50,7658,3572,0,7111,56,1,126,216660.0,130000.0,-44.0,-46.0,-35.0,-47.0,-43.0,-46.0,-37.0,-46.0,-89.0,-90.0,-87.0,-89.0,45.0,44.0,52.0,42.0,1
292,92:69:1D:31:68:E9,3854269,489260708,4180,3705161,3850089,485555547,1,5710,1228452,5531,1187719,179,40733,2317,12,4449,104,1,66,216660.0,130000.0,-51.0,-47.0,-42.0,-48.0,-51.0,-47.0,-43.0,-47.0,-89.0,-90.0,-87.0,-89.0,38.0,43.0,45.0,41.0,1
293,CC:2F:71:3F:1F:24,5154850,1998780415,1304759,1513224666,3850091,485555749,2222,1100623,1266754682,1099750,1266648918,873,105764,1065304,15,1302892,123668,2219,842,144444.0,43333.0,-73.0,-69.0,-67.0,-73.0,-72.0,-69.0,-67.0,-72.0,-89.0,-90.0,-87.0,-89.0,16.0,21.0,20.0,16.0,1
294,CC:2F:71:3E:C5:1F,3851113,485680680,1022,124931,3850091,485555749,3,4468,372449,3725,284245,743,88204,1082,14,1469,30,3,54,130000.0,39000.0,-72.0,-72.0,-70.0,-60.0,-72.0,-72.0,-69.0,-60.0,-89.0,-90.0,-87.0,-89.0,17.0,18.0,17.0,29.0,1
295,BA:8C:B9:54:50:24,3855048,491752657,4957,6196908,3850091,485555749,7,9980,1767328,9958,1763833,22,3495,2361,18,5481,44,7,77,216660.0,130000.0,-48.0,-35.0,-43.0,-45.0,-42.0,-35.0,-44.0,-49.0,-89.0,-90.0,-87.0,-89.0,41.0,55.0,44.0,44.0,1
296,62:47:05:9D:EB:15,3857126,497858328,7031,12302175,3850095,485556153,1,7476,3908868,7426,3901210,50,7658,3572,0,7111,56,1,126,216660.0,130000.0,-44.0,-46.0,-35.0,-47.0,-43.0,-46.0,-37.0,-46.0,-89.0,-90.0,-87.0,-89.0,45.0,44.0,52.0,42.0,1
297,92:69:1D:31:68:E9,3854277,489261682,4180,3705161,3850097,485556521,1,5710,1228452,5531,1187719,179,40733,2317,12,4449,104,1,66,216660.0,130000.0,-51.0,-47.0,-42.0,-48.0,-51.0,-47.0,-43.0,-47.0,-89.0,-90.0,-87.0,-89.0,38.0,43.0,45.0,41.0,1
298,CC:2F:71:3F:1F:24,5155048,1999022723,1304951,1513466202,3850097,485556521,2222,1100802,1266991186,1099929,1266885422,873,105764,1065476,15,1303086,123668,2219,842,144444.0,43333.0,-72.0,-69.0,-68.0,-72.0,-72.0,-69.0,-67.0,-72.0,-89.0,-90.0,-87.0,-89.0,17.0,21.0,19.0,17.0,1
299,CC:2F:71:3E:C5:1F,3851119,485681452,1022,124931,3850097,485556521,3,4468,372449,3725,284245,743,88204,1082,14,1469,30,3,54,130000.0,39000.0,-72.0,-72.0,-70.0,-60.0,-72.0,-72.0,-69.0,-60.0,-89.0,-90.0,-87.0,-89.0,17.0,18.0,17.0,29.0,1
300,BA:8C:B9:54:50:24,3855054,491753429,4957,6196908,3850097,485556521,7,9980,1767328,9958,1763833,22,3495,2361,18,5481,44,7,77,216660.0,130000.0,-48.0,-35.0,-43.0,-45.0,-42.0,-35.0,-44.0,-49.0,-89.0,-90.0,-87.0,-89.0,41.0,55.0,44.0,44.0,1
301,62:47:05:9D:EB:15,3857131,497858958,7031,12302175,3850100,485556783,1,7476,3908868,7426,3901210,50,7658,3572,0,7111,56,1,126,216660.0,130000.0,-44.0,-46.0,-35.0,-47.0,-43.0,-46.0,-37.0,-46.0,-89.0,-89.0,-87.0,-88.0,45.0,43.0,52.0,41.0,1
302,92:69:1D:31:68:E9,3854282,489262146,4180,3705161,3850102,485556985,1,5710,1228452,5531,1187719,179,40733,2317,12,4449,104,1,66,216660.0,130000.0,-51.0,-47.0,-42.0,-48.0,-51.0,-47.0,-43.0,-47.0,-89.0,-89.0,-87.0,-88.0,38.0,42.0,45.0,40.0,1
303,CC:2F:71:3F:1F:24,5155245,1999264723,1305143,1513707738,3850102,485556985,2222,1100981,1267231564,1100108,1267125800,873,105764,1065646,15,1303278,123668,2219,842,144444.0,43333.0,-75.0,-72.0,-70.0,-76.0,-75.0,-72.0,-70.0,-75.0,-89.0,-89.0,-87.0,-88.0,14.0,17.0,17.0,12.0,1
304,CC:2F:71:3E:C5:1F,3851124,485681916,1022,124931,3850102,485556985,3,4468,372449,3725,284245,743,88204,1082,14,1469,30,3,54,130000.0,39000.0,-72.0,-72.0,-70.0,-60.0,-72.0,-72.0,-69.0,-60.0,-89.0,-89.0,-87.0,-88.0,17.0,17.0,17.0,28.0,1
305,BA:8C:B9:54:50:24,3855061,491754095,4957,6196908,3850104,485557187,7,9980,1767328,9958,1763833,22,3495,2361,18,5481,44,7,77,216660.0,130000.0,-48.0,-35.0,-43.0,-45.0,-42.0,-35.0,-44.0,-49.0,-89.0,-89.0,-87.0,-88.0,41.0,54.0,44.0,43.0,1
306,62:47:05:9D:EB:15,3857137,497859564,7031,12302175,3850106,485557389,1,7476,3908868,7426,3901210,50,7658,3572,0,7111,56,1,126,216660.0,130000.0,-44.0,-46.0,-35.0,-47.0,-43.0,-46.0,-37.0,-46.0,-89.0,-89.0,-87.0,-88.0,45.0,43.0,52.0,41.0,1
307,92:69:1D:31:68:E9,3854286,489262550,4180,3705161,3850106,485557389,1,5710,1228452,5531,1187719,179,40733,2317,12,4449,104,1,66,216660.0,130000.0,-51.0,-47.0,-42.0,-48.0,-51.0,-47.0,-43.0,-47.0,-89.0,-89.0,-87.0,-88.0,38.0,42.0,45.0,40.0,1
308,CC:2F:71:3F:1F:24,5155449,1999510250,1305343,1513952861,3850106,485557389,2222,1101167,1267470529,1100294,1267364765,873,105764,1065822,15,1303478,123669,2219,842,144444.0,43333.0,-75.0,-72.0,-70.0,-75.0,-75.0,-72.0,-70.0,-75.0,-89.0,-89.0,-87.0,-88.0,14.0,17.0,17.0,13.0,1
309,CC:2F:71:3E:C5:1F,3851128,485682320,1022,124931,3850106,485557389,3,4468,372449,3725,284245,743,88204,1082,14,1469,30,3,54,130000.0,39000.0,-72.0,-72.0,-70.0,-60.0,-72.0,-72.0,-69.0,-60.0,-89.0,-89.0,-87.0,-88.0,17.0,17.0,17.0,28.0,1
310,BA:8C:B9:54:50:24,3855065,491754499,4957,6196908,3850108,485557591,7,9980,1767328,9958,1763833,22,3495,2361,18,5481,44,7,77,216660.0,130000.0,-48.0,-35.0,-43.0,-45.0,-42.0,-35.0,-44.0,-49.0,-89.0,-89.0,-86.0,-88.0,41.0,54.0,43.0,43.0,1
311,62:47:05:9D:EB:15,3857139,497859766,7031,12302175,3850108,485557591,1,7476,3908868,7426,3901210,50,7658,3572,0,7111,56,1,126,216660.0,130000.0,-44.0,-46.0,-35.0,-47.0,-43.0,-46.0,-37.0,-46.0,-89.0,-89.0,-86.0,-88.0,45.0,43.0,51.0,41.0,1
312,92:69:1D:31:68:E9,3854290,489262954,4180,3705161,3850110,485557793,1,5710,1228452,5531,1187719,179,40733,2317,12,4449,104,1,66,216660.0,130000.0,-51.0,-47.0,-42.0,-48.0,-51.0,-47.0,-43.0,-47.0,-89.0,-89.0,-86.0,-88.0,38.0,42.0,44.0,40.0,1
313,CC:2F:71:3F:1F:24,5155646,1999755168,1305536,1514197375,3850110,485557793,2222,1101347,1267711217,1100474,1267605453,873,105764,1065991,15,1303671,123670,2219,843,144444.0,43333.0,-75.0,-72.0,-70.0,-76.0,-75.0,-72.0,-70.0,-75.0,-89.0,-89.0,-86.0,-88.0,14.0,17.0,16.0,12.0,1
314,CC:2F:71:3E:C5:1F,3851132,485682724,1022,124931,3850110,485557793,3,4468,372449,3725,284245,743,88204,1082,14,1469,30,3,54,130000.0,39000.0,-72.0,-72.0,-70.0,-60.0,-72.0,-72.0,-69.0,-60.0,-89.0,-89.0,-86.0,-88.0,17.0,17.0,16.0,28.0,1
315,BA:8C:B9:54:50:24,3855069,491754903,4957,6196908,3850112,485557995,7,9980,1767328,9958,1763833,22,3495,2361,18,5481,44,7,77,216660.0,130000.0,-48.0,-35.0,-43.0,-45.0,-42.0,-35.0,-44.0,-49.0,-89.0,-89.0,-86.0,-88.0,41.0,54.0,43.0,43.0,1
316,62:47:05:9D:EB:15,3857146,497860432,7031,12302175,3850115,485558257,1,7476,3908868,7426,3901210,50,7658,3572,0,7111,56,1,126,216660.0,130000.0,-44.0,-46.0,-35.0,-47.0,-43.0,-46.0,-37.0,-46.0,-89.0,-89.0,-86.0,-88.0,45.0,43.0,51.0,41.0,1
317,92:69:1D:31:68:E9,3854295,489263418,4180,3705161,3850115,485558257,1,5710,1228452,5531,1187719,179,40733,2317,12,4449,104,1,66,216660.0,130000.0,-51.0,-47.0,-42.0,-48.0,-51.0,-47.0,-43.0,-47.0,-89.0,-89.0,-86.0,-88.0,38.0,42.0,44.0,40.0,1
318,CC:2F:71:3F:1F:24,5155843,1999997168,1305728,1514438911,3850115,485558257,2222,1101526,1267950327,1100653,1267844563,873,105764,1066161,15,1303861,123670,2219,843,144444.0,43333.0,-75.0,-72.0,-70.0,-75.0,-74.0,-71.0,-69.0,-75.0,-89.0,-89.0,-86.0,-88.0,14.0,17.0,16.0,13.0,1
319,CC:2F:71:3E:C5:1F,3851139,485683390,1022,124931,3850117,485558459,3,4468,372449,3725,284245,743,88204,1082,14,1469,30,3,54,130000.0,39000.0,-72.0,-72.0,-70.0,-60.0,-72.0,-72.0,-69.0,-60.0,-89.0,-89.0,-86.0,-88.0,17.0,17.0,16.0,28.0,1
320,BA:8C:B9:54:50:24,3855074,491755367,4957,6196908,3850117,485558459,7,9980,1767328,9958,1763833,22,3495,2361,18,5481,44,7,77,216660.0,130000.0,-48.0,-35.0,-43.0,-45.0,-42.0,-35.0,-44.0,-49.0,-89.0,-89.0,-86.0,-88.0,41.0,54.0,43.0,43.0,1
321,62:47:05:9D:EB:15,3857150,497860836,7031,12302175,3850119,485558661,1,7476,3908868,7426,3901210,50,7658,3572,0,7111,56,1,126,216660.0,130000.0,-44.0,-46.0,-35.0,-47.0,-43.0,-46.0,-37.0,-46.0,-89.0,-89.0,-86.0,-88.0,45.0,43.0,51.0,41.0,1
322,92:69:1D:31:68:E9,3854299,489263822,4180,3705161,3850119,485558661,1,5710,1228452,5531,1187719,179,40733,2317,12,4449,104,1,66,216660.0,130000.0,-51.0,-47.0,-42.0,-48.0,-51.0,-47.0,-43.0,-47.0,-89.0,-89.0,-86.0,-88.0,38.0,42.0,44.0,40.0,1
323,CC:2F:71:3F:1F:24,5156062,2000252021,1305941,1514693158,3850121,485558863,2222,1101733,1268202527,1100860,1268096763,873,105764,1066358,15,1304076,123670,2219,843,144444.0,43333.0,-72.0,-69.0,-68.0,-73.0,-72.0,-68.0,-67.0,-72.0,-89.0,-89.0,-86.0,-88.0,17.0,20.0,18.0,15.0,1
324,CC:2F:71:3E:C5:1F,3851143,485683794,1022,124931,3850121,485558863,3,4468,372449,3725,284245,743,88204,1082,14,1469,30,3,54,130000.0,39000.0,-72.0,-72.0,-70.0,-60.0,-72.0,-72.0,-69.0,-60.0,-89.0,-89.0,-86.0,-88.0,17.0,17.0,16.0,28.0,1
325,BA:8C:B9:54:50:24,3855078,491755771,4957,6196908,3850121,485558863,7,9980,1767328,9958,1763833,22,3495,2361,18,5481,44,7,77,216660.0,130000.0,-48.0,-35.0,-43.0,-45.0,-42.0,-35.0,-44.0,-49.0,-89.0,-89.0,-86.0,-88.0,41.0,54.0,43.0,43.0,1
326,62:47:05:9D:EB:15,3857155,497861300,7031,12302175,3850124,485559125,1,7477,3908936,7427,3901278,50,7658,3572,0,7111,56,1,126,216660.0,130000.0,-44.0,-46.0,-36.0,-46.0,-43.0,-46.0,-36.0,-46.0,-89.0,-89.0,-86.0,-88.0,45.0,43.0,50.0,42.0,1
327,92:69:1D:31:68:E9,3854306,489264488,4180,3705161,3850126,485559327,1,5710,1228452,5531,1187719,179,40733,2317,12,4449,104,1,66,216660.0,130000.0,-51.0,-47.0,-42.0,-48.0,-51.0,-47.0,-43.0,-47.0,-89.0,-89.0,-86.0,-88.0,38.0,42.0,44.0,40.0,1
328,CC:2F:71:3F:1F:24,5156259,2000494021,1306133,1514934694,3850126,485559327,2222,1101911,1268438503,1101038,1268332739,873,105764,1066530,15,1304268,123674,2219,843,144444.0,43333.0,-72.0,-69.0,-68.0,-72.0,-71.0,-68.0,-67.0,-72.0,-89.0,-89.0,-86.0,-88.0,17.0,20.0,18.0,16.0,1
329,CC:2F:71:3E:C5:1F,3851148,485684258,1022,124931,3850126,485559327,3,4468,372449,3725,284245,743,88204,1082,14,1469,30,3,54,130000.0,39000.0,-72.0,-72.0,-70.0,-60.0,-72.0,-72.0,-69.0,-60.0,-89.0,-89.0,-86.0,-88.0,17.0,17.0,16.0,28.0,1
330,BA:8C:B9:54:50:24,3855083,491756235,4957,6196908,3850126,485559327,7,9980,1767328,9958,1763833,22,3495,2361,18,5481,44,7,77,216660.0,130000.0,-48.0,-35.0,-43.0,-45.0,-42.0,-35.0,-44.0,-49.0,-89.0,-89.0,-86.0,-88.0,41.0,54.0,43.0,43.0,1
331,62:47:05:9D:EB:15,3857159,497861704,7031,12302175,3850128,485559529,1,7477,3908936,7427,3901278,50,7658,3572,0,7111,56,1,126,216660.0,130000.0,-44.0,-46.0,-36.0,-46.0,-43.0,-46.0,-36.0,-46.0,-89.0,-89.0,-86.0,-88.0,45.0,43.0,50.0,42.0,1
332,92:69:1D:31:68:E9,3854311,489265008,4181,3705277,3850130,485559731,1,5712,1228588,5533,1187855,179,40733,2317,12,4450,104,1,66,216660.0,130000.0,-51.0,-47.0,-42.0,-49.0,-51.0,-47.0,-43.0,-48.0,-89.0,-89.0,-86.0,-88.0,38.0,42.0,44.0,39.0,1
333,CC:2F:71:3F:1F:24,5156460,2000742293,1306330,1515182562,3850130,485559731,2222,1102102,1268687809,1101229,1268582045,873,105764,1066706,15,1304465,123674,2219,844,144444.0,43333.0,-72.0,-69.0,-68.0,-73.0,-72.0,-69.0,-67.0,-72.0,-89.0,-89.0,-86.0,-88.0,17.0,20.0,18.0,15.0,1
334,CC:2F:71:3E:C5:1F,3851153,485684778,1023,125047,3850130,485559731,3,4470,372589,3727,284385,743,88204,1082,14,1470,30,3,54,130000.0,39000.0,-72.0,-73.0,-69.0,-60.0,-72.0,-72.0,-69.0,-60.0,-89.0,-89.0,-86.0,-88.0,17.0,16.0,17.0,28.0,1
335,BA:8C:B9:54:50:24,3855088,491756755,4958,6197024,3850130,485559731,7,9982,1767464,9960,1763969,22,3495,2361,18,5482,44,7,77,229410.0,130000.0,-48.0,-35.0,-43.0,-45.0,-43.0,-35.0,-44.0,-48.0,-89.0,-89.0,-86.0,-88.0,41.0,54.0,43.0,43.0,1
336,62:47:05:9D:EB:15,3857166,497862426,7032,12302291,3850134,485560135,1,7479,3909072,7429,3901414,50,7658,3572,0,7112,56,1,126,216660.0,130000.0,-43.0,-46.0,-35.0,-47.0,-43.0,-46.0,-36.0,-46.0,-89.0,-89.0,-86.0,-88.0,46.0,43.0,51.0,41.0,1
337,92:69:1D:31:68:E9,3854315,489265412,4181,3705277,3850134,485560135,1,5712,1228588,5533,1187855,179,40733,2317,12,4450,104,1,66,216660.0,130000.0,-51.0,-47.0,-42.0,-49.0,-51.0,-47.0,-43.0,-48.0,-89.0,-89.0,-86.0,-88.0,38.0,42.0,44.0,39.0,1
338,CC:2F:71:3F:1F:24,5156656,2000984233,1306522,1515424098,3850134,485560135,2222,1102282,1268926907,1101409,1268821143,873,105764,1066877,15,1304657,123674,2219,844,144444.0,43333.0,-71.0,-68.0,-67.0,-72.0,-71.0,-68.0,-67.0,-72.0,-89.0,-89.0,-86.0,-88.0,18.0,21.0,19.0,16.0,1
339,CC:2F:71:3E:C5:1F,3851157,485685182,1023,125047,3850134,485560135,3,4470,372589,3727,284385,743,88204,1082,14,1470,30,3,54,130000.0,39000.0,-72.0,-73.0,-69.0,-60.0,-72.0,-72.0,-69.0,-60.0,-89.0,-89.0,-86.0,-88.0,17.0,16.0,17.0,28.0,1
340,BA:8C:B9:54:50:24,3855092,491757159,4958,6197024,3850134,485560135,7,9982,1767464,9960,1763969,22,3495,2361,18,5482,44,7,77,229410.0,130000.0,-48.0,-35.0,-43.0,-45.0,-43.0,-35.0,-44.0,-48.0,-89.0,-89.0,-86.0,-88.0,41.0,54.0,43.0,43.0,1
341,62:47:05:9D:EB:15,3857174,497865684,7035,12305085,3850139,485560599,1,7480,3909140,7430,3901482,50,7658,3572,0,7115,56,1,126,216660.0,130000.0,-44.0,-46.0,-35.0,-49.0,-43.0,-45.0,-35.0,-47.0,-89.0,-89.0,-86.0,-88.0,45.0,43.0,51.0,39.0,1
342,92:69:1D:31:68:E9,3854320,489265876,4181,3705277,3850139,485560599,1,5712,1228588,5533,1187855,179,40733,2317,12,4450,104,1,66,216660.0,130000.0,-51.0,-47.0,-42.0,-49.0,-51.0,-47.0,-43.0,-48.0,-89.0,-89.0,-86.0,-88.0,38.0,42.0,44.0,39.0,1
343,CC:2F:71:3F:1F:24,5156860,2001229704,1306721,1515669105,3850139,485560599,2222,1102465,1269161113,1101592,1269055349,873,105764,1067055,15,1304856,123674,2219,844,144444.0,43333.0,-71.0,-70.0,-66.0,-73.0,-71.0,-69.0,-66.0,-73.0,-89.0,-89.0,-86.0,-88.0,18.0,19.0,20.0,15.0,1
344,CC:2F:71:3E:C5:1F,3851164,485685848,1023,125047,3850141,485560801,3,4470,372589,3727,284385,743,88204,1082,14,1470,30,3,54,130000.0,39000.0,-72.0,-73.0,-69.0,-60.0,-72.0,-72.0,-69.0,-60.0,-89.0,-89.0,-86.0,-88.0,17.0,16.0,17.0,28.0,1
345,BA:8C:B9:54:50:24,3855099,491757825,4958,6197024,3850141,485560801,7,9983,1767532,9961,1764037,22,3495,2361,18,5482,44,7,77,229410.0,130000.0,-39.0,-36.0,-45.0,-52.0,-43.0,-35.0,-44.0,-48.0,-89.0,-89.0,-86.0,-88.0,50.0,53.0,41.0,36.0,1
346,62:47:05:9D:EB:15,3857190,497869493,7046,12308217,3850144,485561276,1,7500,3914518,7450,3906860,50,7658,3586,0,7126,56,1,126,229410.0,130000.0,-45.0,-51.0,-44.0,-44.0,-46.0,-48.0,-40.0,-46.0,-89.0,-89.0,-86.0,-88.0,44.0,38.0,42.0,44.0,1
347,92:69:1D:31:68:E9,3854325,489266553,4181,3705277,3850144,485561276,1,5712,1228588,5533,1187855,179,40733,2317,12,4450,104,1,66,216660.0,130000.0,-51.0,-47.0,-42.0,-49.0,-51.0,-47.0,-43.0,-48.0,-89.0,-89.0,-86.0,-88.0,38.0,42.0,44.0,39.0,1
348,CC:2F:71:3F:1F:24,5157057,2001471917,1306913,1515910641,3850144,485561276,2222,1102644,1269394565,1101771,1269288801,873,105764,1067226,15,1305048,123691,2219,844,144444.0,43333.0,-70.0,-70.0,-67.0,-73.0,-69.0,-70.0,-67.0,-73.0,-89.0,-89.0,-86.0,-88.0,19.0,19.0,19.0,15.0,1
349,CC:2F:71:3E:C5:1F,3851167,485686323,1023,125047,3850144,485561276,3,4470,372589,3727,284385,743,88204,1082,14,1470,30,3,54,130000.0,39000.0,-72.0,-73.0,-69.0,-60.0,-72.0,-72.0,-69.0,-60.0,-89.0,-89.0,-86.0,-88.0,17.0,16.0,17.0,28.0,1
350,BA:8C:B9:54:50:24,3855102,491758300,4958,6197024,3850144,485561276,7,9983,1767532,9961,1764037,22,3495,2361,18,5482,44,7,77,229410.0,130000.0,-39.0,-36.0,-45.0,-52.0,-43.0,-35.0,-44.0,-48.0,-89.0,-89.0,-86.0,-88.0,50.0,53.0,41.0,36.0,1
351,62:47:05:9D:EB:15,3857195,497869957,7046,12308217,3850149,485561740,1,7500,3914518,7450,3906860,50,7658,3586,0,7126,56,1,126,229410.0,130000.0,-45.0,-51.0,-44.0,-44.0,-46.0,-48.0,-40.0,-46.0,-89.0,-89.0,-86.0,-88.0,44.0,38.0,42.0,44.0,1
352,92:69:1D:31:68:E9,3854330,489267017,4181,3705277,3850149,485561740,1,5712,1228588,5533,1187855,179,40733,2317,12,4450,104,1,66,216660.0,130000.0,-51.0,-47.0,-42.0,-49.0,-51.0,-47.0,-43.0,-48.0,-89.0,-89.0,-86.0,-88.0,38.0,42.0,44.0,39.0,1
353,CC:2F:71:3F:1F:24,5157256,2001714063,1307105,1516152121,3850151,485561942,2222,1102820,1269628829,1101947,1269523065,873,105764,1067398,15,1305240,123728,2219,844,130000.0,43333.0,-70.0,-70.0,-67.0,-73.0,-69.0,-70.0,-66.0,-73.0,-89.0,-89.0,-86.0,-88.0,19.0,19.0,19.0,15.0,1
354,CC:2F:71:3E:C5:1F,3851174,485686989,1023,125047,3850151,485561942,3,4470,372589,3727,284385,743,88204,1082,14,1470,30,3,54,130000.0,39000.0,-72.0,-73.0,-69.0,-60.0,-72.0,-72.0,-69.0,-60.0,-89.0,-89.0,-86.0,-88.0,17.0,16.0,17.0,28.0,1
355,BA:8C:B9:54:50:24,3855109,491758966,4958,6197024,3850151,485561942,7,9983,1767532,9961,1764037,22,3495,2361,18,5482,44,7,77,229410.0,130000.0,-39.0,-36.0,-45.0,-52.0,-43.0,-35.0,-44.0,-48.0,-89.0,-89.0,-86.0,-88.0,50.0,53.0,41.0,36.0,1
356,62:47:05:9D:EB:15,3857199,497870361,7046,12308217,3850153,485562144,1,7500,3914518,7450,3906860,50,7658,3586,0,7126,56,1,126,229410.0,130000.0,-45.0,-51.0,-44.0,-44.0,-46.0,-48.0,-40.0,-46.0,-89.0,-89.0,-86.0,-88.0,44.0,38.0,42.0,44.0,1
357,92:69:1D:31:68:E9,3854334,489267421,4181,3705277,3850153,485562144,1,5712,1228588,5533,1187855,179,40733,2317,12,4450,104,1,66,216660.0,130000.0,-51.0,-47.0,-42.0,-49.0,-51.0,-47.0,-43.0,-48.0,-89.0,-89.0,-86.0,-88.0,38.0,42.0,44.0,39.0,1
358,CC:2F:71:3F:1F:24,5157452,2001958909,1307299,1516396765,3850153,485562144,2222,1102998,1269869063,1102125,1269763299,873,105764,1067569,15,1305434,123728,2219,844,130000.0,43333.0,-70.0,-70.0,-66.0,-73.0,-70.0,-70.0,-66.0,-72.0,-89.0,-89.0,-86.0,-88.0,19.0,19.0,20.0,15.0,1
359,CC:2F:71:3E:C5:1F,3851176,485687191,1023,125047,3850153,485562144,3,4470,372589,3727,284385,743,88204,1082,14,1470,30,3,54,130000.0,39000.0,-72.0,-73.0,-69.0,-60.0,-72.0,-72.0,-69.0,-60.0,-89.0,-90.0,-87.0,-88.0,17.0,17.0,18.0,28.0,1
360,BA:8C:B9:54:50:24,3855111,491759168,4958,6197024,3850153,485562144,7,9983,1767532,9961,1764037,22,3495,2361,18,5482,44,7,77,229410.0,130000.0,-39.0,-36.0,-45.0,-52.0,-43.0,-35.0,-44.0,-48.0,-89.0,-90.0,-87.0,-88.0,50.0,54.0,42.0,36.0,1
361,62:47:05:9D:EB:15,3857207,497871091,7046,12308217,3850161,485562874,1,7500,3914518,7450,3906860,50,7658,3586,0,7126,56,1,126,229410.0,130000.0,-45.0,-51.0,-44.0,-44.0,-46.0,-48.0,-40.0,-46.0,-89.0,-90.0,-87.0,-88.0,44.0,39.0,43.0,44.0,1
362,92:69:1D:31:68:E9,3854342,489268151,4181,3705277,3850161,485562874,1,5712,1228588,5533,1187855,179,40733,2317,12,4450,104,1,66,216660.0,130000.0,-51.0,-47.0,-42.0,-49.0,-51.0,-47.0,-43.0,-48.0,-89.0,-90.0,-87.0,-88.0,38.0,43.0,45.0,39.0,1
363,CC:2F:71:3F:1F:24,5157660,2002204810,1307499,1516641936,3850161,485562874,2222,1103185,1270109473,1102311,1270003591,874,105882,1067747,15,1305634,123731,2219,844,144444.0,43333.0,-70.0,-70.0,-67.0,-74.0,-70.0,-70.0,-67.0,-73.0,-89.0,-90.0,-87.0,-88.0,19.0,20.0,20.0,14.0,1
364,CC:2F:71:3E:C5:1F,3851184,485687921,1023,125047,3850161,485562874,3,4472,372777,3728,284455,744,88322,1083,14,1470,30,3,54,130000.0,39000.0,-72.0,-72.0,-70.0,-60.0,-72.0,-72.0,-69.0,-60.0,-89.0,-90.0,-87.0,-88.0,17.0,18.0,17.0,28.0,1
365,BA:8C:B9:54:50:24,3855119,491759898,4958,6197024,3850161,485562874,7,9983,1767532,9961,1764037,22,3495,2361,18,5482,44,7,77,229410.0,130000.0,-39.0,-36.0,-45.0,-52.0,-43.0,-35.0,-44.0,-48.0,-89.0,-90.0,-87.0,-88.0,50.0,54.0,42.0,36.0,1
366,62:47:05:9D:EB:15,3857210,497871353,7046,12308217,3850164,485563136,1,7500,3914518,7450,3906860,50,7658,3586,0,7126,56,1,126,229410.0,130000.0,-45.0,-51.0,-44.0,-44.0,-46.0,-48.0,-40.0,-46.0,-89.0,-90.0,-87.0,-88.0,44.0,39.0,43.0,44.0,1
367,92:69:1D:31:68:E9,3854345,489268413,4181,3705277,3850164,485563136,1,5712,1228588,5533,1187855,179,40733,2317,12,4450,104,1,66,216660.0,130000.0,-51.0,-47.0,-42.0,-49.0,-51.0,-47.0,-43.0,-48.0,-89.0,-90.0,-87.0,-88.0,38.0,43.0,45.0,39.0,1
368,CC:2F:71:3F:1F:24,5157855,2002446608,1307691,1516883472,3850164,485563136,2222,1103359,1270343629,1102485,1270237747,874,105882,1067915,15,1305826,123739,2219,844,144444.0,43333.0,-70.0,-70.0,-67.0,-73.0,-70.0,-70.0,-66.0,-73.0,-89.0,-90.0,-87.0,-88.0,19.0,20.0,20.0,15.0,1
369,CC:2F:71:3E:C5:1F,3851187,485688183,1023,125047,3850164,485563136,3,4472,372777,3728,284455,744,88322,1083,14,1470,30,3,54,130000.0,39000.0,-72.0,-72.0,-70.0,-60.0,-72.0,-72.0,-69.0,-60.0,-89.0,-90.0,-87.0,-88.0,17.0,18.0,17.0,28.0,1
370,BA:8C:B9:54:50:24,3855122,491760160,4958,6197024,3850164,485563136,7,9983,1767532,9961,1764037,22,3495,2361,18,5482,44,7,77,229410.0,130000.0,-39.0,-36.0,-45.0,-52.0,-43.0,-35.0,-44.0,-48.0,-89.0,-90.0,-87.0,-88.0,50.0,54.0,42.0,36.0,1
371,62:47:05:9D:EB:15,3857216,497871959,7046,12308217,3850170,485563742,1,7503,3914722,7453,3907064,50,7658,3586,0,7126,56,1,126,229410.0,130000.0,-44.0,-46.0,-35.0,-47.0,-45.0,-47.0,-38.0,-46.0,-89.0,-90.0,-87.0,-88.0,45.0,44.0,52.0,41.0,1
372,92:69:1D:31:68:E9,3854351,489269019,4181,3705277,3850170,485563742,1,5712,1228588,5533,1187855,179,40733,2317,12,4450,104,1,66,216660.0,130000.0,-51.0,-47.0,-42.0,-49.0,-51.0,-47.0,-43.0,-48.0,-89.0,-90.0,-87.0,-88.0,38.0,43.0,45.0,39.0,1
373,CC:2F:71:3F:1F:24,5158051,2002685642,1307881,1517121900,3850170,485563742,2222,1103540,1270585705,1102666,1270479823,874,105882,1068084,15,1306016,123741,2219,844,144444.0,43333.0,-72.0,-70.0,-67.0,-74.0,-71.0,-70.0,-67.0,-74.0,-89.0,-90.0,-87.0,-88.0,17.0,20.0,20.0,14.0,1
374,CC:2F:71:3E:C5:1F,3851193,485688789,1023,125047,3850170,485563742,3,4472,372777,3728,284455,744,88322,1083,14,1470,30,3,54,130000.0,39000.0,-72.0,-72.0,-70.0,-60.0,-72.0,-72.0,-69.0,-60.0,-89.0,-90.0,-87.0,-88.0,17.0,18.0,17.0,28.0,1
375,BA:8C:B9:54:50:24,3855128,491760766,4958,6197024,3850170,485563742,7,9985,1767668,9963,1764173,22,3495,2361,18,5482,44,7,77,229410.0,130000.0,-48.0,-35.0,-43.0,-45.0,-43.0,-35.0,-44.0,-48.0,-89.0,-90.0,-87.0,-88.0,41.0,55.0,44.0,43.0,1
376,62:47:05:9D:EB:15,3857219,497872221,7046,12308217,3850173,485564004,1,7503,3914722,7453,3907064,50,7658,3586,0,7126,56,1,126,229410.0,130000.0,-44.0,-46.0,-35.0,-47.0,-45.0,-47.0,-38.0,-46.0,-89.0,-90.0,-87.0,-88.0,45.0,44.0,52.0,41.0,1
377,92:69:1D:31:68:E9,3854354,489269281,4181,3705277,3850173,485564004,1,5712,1228588,5533,1187855,179,40733,2317,12,4450,104,1,66,216660.0,130000.0,-51.0,-47.0,-42.0,-49.0,-51.0,-47.0,-43.0,-48.0,-89.0,-90.0,-87.0,-88.0,38.0,43.0,45.0,39.0,1
378,CC:2F:71:3F:1F:24,5158248,2002930548,1308075,1517366544,3850173,485564004,2222,1103714,1270817017,1102840,1270711135,874,105882,1068254,15,1306210,123744,2219,844,144444.0,43333.0,-70.0,-69.0,-67.0,-73.0,-70.0,-69.0,-67.0,-74.0,-89.0,-90.0,-87.0,-88.0,19.0,21.0,20.0,15.0,1
379,CC:2F:71:3E:C5:1F,3851196,485689051,1023,125047,3850173,485564004,3,4472,372777,3728,284455,744,88322,1083,14,1470,30,3,54,130000.0,39000.0,-72.0,-72.0,-70.0,-60.0,-72.0,-72.0,-69.0,-60.0,-89.0,-90.0,-87.0,-88.0,17.0,18.0,17.0,28.0,1
380,BA:8C:B9:54:50:24,3855131,491761028,4958,6197024,3850173,485564004,7,9989,1767940,9967,1764445,22,3495,2361,18,5482,44,7,77,229410.0,130000.0,-39.0,-36.0,-46.0,-52.0,-43.0,-35.0,-44.0,-48.0,-89.0,-90.0,-87.0,-88.0,50.0,54.0,41.0,36.0,1
381,62:47:05:9D:EB:15,3857225,497872827,7046,12308217,3850179,485564610,1,7503,3914722,7453,3907064,50,7658,3586,0,7126,56,1,126,229410.0,130000.0,-44.0,-46.0,-35.0,-47.0,-45.0,-47.0,-38.0,-46.0,-89.0,-90.0,-87.0,-88.0,45.0,44.0,52.0,41.0,1
382,92:69:1D:31:68:E9,3854360,489269887,4181,3705277,3850179,485564610,1,5712,1228588,5533,1187855,179,40733,2317,12,4450,104,1,66,216660.0,130000.0,-51.0,-47.0,-42.0,-49.0,-51.0,-47.0,-43.0,-48.0,-89.0,-90.0,-87.0,-88.0,38.0,43.0,45.0,39.0,1
383,CC:2F:71:3F:1F:24,5158464,2003194679,1308285,1517630069,3850179,485564610,2222,1103912,1271076271,1103038,1270970389,874,105882,1068443,15,1306420,123745,2219,844,144444.0,43333.0,-70.0,-70.0,-67.0,-74.0,-70.0,-70.0,-67.0,-74.0,-89.0,-90.0,-87.0,-88.0,19.0,20.0,20.0,14.0,1
384,CC:2F:71:3E:C5:1F,3851202,485689657,1023,125047,3850179,485564610,3,4472,372777,3728,284455,744,88322,1083,14,1470,30,3,54,130000.0,39000.0,-72.0,-72.0,-70.0,-60.0,-72.0,-72.0,-69.0,-60.0,-89.0,-90.0,-87.0,-88.0,17.0,18.0,17.0,28.0,1
385,BA:8C:B9:54:50:24,3855137,491761634,4958,6197024,3850179,485564610,7,9989,1767940,9967,1764445,22,3495,2361,18,5482,44,7,77,229410.0,130000.0,-39.0,-36.0,-46.0,-52.0,-43.0,-35.0,-44.0,-48.0,-89.0,-90.0,-87.0,-88.0,50.0,54.0,41.0,36.0,1
386,62:47:05:9D:EB:15,3857227,497873029,7046,12308217,3850181,485564812,1,7503,3914722,7453,3907064,50,7658,3586,0,7126,56,1,126,229410.0,130000.0,-44.0,-46.0,-35.0,-47.0,-45.0,-47.0,-38.0,-46.0,-89.0,-90.0,-87.0,-88.0,45.0,44.0,52.0,41.0,1
387,92:69:1D:31:68:E9,3854362,489270089,4181,3705277,3850181,485564812,1,5712,1228588,5533,1187855,179,40733,2317,12,4450,104,1,66,216660.0,130000.0,-51.0,-47.0,-42.0,-49.0,-51.0,-47.0,-43.0,-48.0,-89.0,-90.0,-87.0,-88.0,38.0,43.0,45.0,39.0,1
388,CC:2F:71:3F:1F:24,5158657,2003439135,1308476,1517874323,3850181,485564812,2222,1104083,1271307065,1103209,1271201183,874,105882,1068613,15,1306611,123747,2219,844,144444.0,43333.0,-71.0,-70.0,-67.0,-74.0,-70.0,-70.0,-67.0,-74.0,-89.0,-90.0,-87.0,-88.0,18.0,20.0,20.0,14.0,1
389,CC:2F:71:3E:C5:1F,3851204,485689859,1023,125047,3850181,485564812,3,4472,372777,3728,284455,744,88322,1083,14,1470,30,3,54,130000.0,39000.0,-72.0,-72.0,-70.0,-60.0,-72.0,-72.0,-69.0,-60.0,-89.0,-90.0,-87.0,-88.0,17.0,18.0,17.0,28.0,1
390,BA:8C:B9:54:50:24,3855141,491762038,4958,6197024,3850183,485565014,7,9989,1767940,9967,1764445,22,3495,2361,18,5482,44,7,77,229410.0,130000.0,-39.0,-36.0,-46.0,-52.0,-43.0,-35.0,-44.0,-48.0,-89.0,-90.0,-87.0,-88.0,50.0,54.0,41.0,36.0,1
391,62:47:05:9D:EB:15,3857234,497873695,7046,12308217,3850188,485565478,1,7503,3914722,7453,3907064,50,7658,3586,0,7126,56,1,126,229410.0,130000.0,-44.0,-46.0,-35.0,-47.0,-45.0,-47.0,-38.0,-46.0,-89.0,-90.0,-87.0,-88.0,45.0,44.0,52.0,41.0,1
392,92:69:1D:31:68:E9,3854369,489270755,4181,3705277,3850188,485565478,1,5712,1228588,5533,1187855,179,40733,2317,12,4450,104,1,66,216660.0,130000.0,-51.0,-47.0,-42.0,-49.0,-51.0,-47.0,-43.0,-48.0,-89.0,-90.0,-87.0,-88.0,38.0,43.0,45.0,39.0,1
393,CC:2F:71:3F:1F:24,5158855,2003684055,1308667,1518118577,3850188,485565478,2222,1104260,1271544529,1103386,1271438647,874,105882,1068782,15,1306802,123752,2219,845,144444.0,43333.0,-71.0,-70.0,-67.0,-74.0,-71.0,-70.0,-67.0,-73.0,-89.0,-90.0,-87.0,-88.0,18.0,20.0,20.0,14.0,1
394,CC:2F:71:3E:C5:1F,3851211,485690525,1023,125047,3850188,485565478,3,4472,372777,3728,284455,744,88322,1083,14,1470,30,3,54,130000.0,39000.0,-72.0,-72.0,-70.0,-60.0,-72.0,-72.0,-69.0,-60.0,-89.0,-90.0,-87.0,-88.0,17.0,18.0,17.0,28.0,1
395,BA:8C:B9:54:50:24,3855146,491762502,4958,6197024,3850188,485565478,7,9989,1767940,9967,1764445,22,3495,2361,18,5482,44,7,77,229410.0,130000.0,-39.0,-36.0,-46.0,-52.0,-43.0,-35.0,-44.0,-48.0,-89.0,-90.0,-87.0,-88.0,50.0,54.0,41.0,36.0,1
396,62:47:05:9D:EB:15,3857236,497873897,7046,12308217,3850190,485565680,1,7503,3914722,7453,3907064,50,7658,3586,0,7126,56,1,126,229410.0,130000.0,-44.0,-46.0,-35.0,-47.0,-45.0,-47.0,-38.0,-46.0,-89.0,-90.0,-87.0,-88.0,45.0,44.0,52.0,41.0,1
397,92:69:1D:31:68:E9,3854371,489270957,4181,3705277,3850190,485565680,1,5714,1228724,5535,1187991,179,40733,2317,12,4451,104,1,66,216660.0,130000.0,-52.0,-47.0,-42.0,-48.0,-51.0,-47.0,-43.0,-48.0,-89.0,-90.0,-87.0,-88.0,37.0,43.0,45.0,40.0,1
398,CC:2F:71:3F:1F:24,5159052,2003925896,1308862,1518360216,3850190,485565680,2222,1104442,1271781433,1103568,1271675551,874,105882,1068958,15,1306997,123760,2219,845,144444.0,43333.0,-72.0,-71.0,-67.0,-74.0,-73.0,-72.0,-69.0,-76.0,-89.0,-90.0,-87.0,-88.0,17.0,19.0,20.0,14.0,1
399,CC:2F:71:3E:C5:1F,3851215,485690929,1023,125047,3850192,485565882,3,4474,372917,3730,284595,744,88322,1083,14,1471,30,3,54,130000.0,39000.0,-72.0,-72.0,-71.0,-60.0,-72.0,-72.0,-69.0,-60.0,-89.0,-90.0,-87.0,-88.0,17.0,18.0,16.0,28.0,1
400,BA:8C:B9:54:50:24,3855150,491762906,4958,6197024,3850192,485565882,7,9989,1767940,9967,1764445,22,3495,2361,18,5482,44,7,77,229410.0,130000.0,-39.0,-36.0,-46.0,-52.0,-43.0,-35.0,-44.0,-48.0,-89.0,-90.0,-87.0,-88.0,50.0,54.0,41.0,36.0,1
401,62:47:05:9D:EB:15,3857243,497874563,7046,12308217,3850197,485566346,1,7505,3914858,7455,3907200,50,7658,3586,0,7127,56,1,126,229410.0,130000.0,-47.0,-49.0,-47.0,-45.0,-44.0,-47.0,-39.0,-46.0,-90.0,-90.0,-87.0,-88.0,43.0,41.0,40.0,43.0,1
402,92:69:1D:31:68:E9,3854378,489271623,4181,3705277,3850197,485566346,1,5714,1228724,5535,1187991,179,40733,2317,12,4451,104,1,66,216660.0,130000.0,-52.0,-47.0,-42.0,-48.0,-51.0,-47.0,-43.0,-48.0,-90.0,-90.0,-87.0,-88.0,38.0,43.0,45.0,40.0,1
403,CC:2F:71:3F:1F:24,5159253,2004174054,1309056,1518607708,3850197,485566346,2222,1104622,1272022131,1103748,1271916249,874,105882,1069129,15,1307189,123774,2219,846,144444.0,43333.0,-71.0,-70.0,-67.0,-73.0,-71.0,-70.0,-66.0,-73.0,-90.0,-90.0,-87.0,-88.0,19.0,20.0,20.0,15.0,1
404,CC:2F:71:3E:C5:1F,3851220,485691393,1023,125047,3850197,485566346,3,4474,372917,3730,284595,744,88322,1083,14,1471,30,3,54,130000.0,39000.0,-72.0,-72.0,-71.0,-60.0,-72.0,-72.0,-69.0,-60.0,-90.0,-90.0,-87.0,-88.0,18.0,18.0,16.0,28.0,1
405,BA:8C:B9:54:50:24,3855155,491763370,4958,6197024,3850197,485566346,7,9989,1767940,9967,1764445,22,3495,2361,18,5482,44,7,77,229410.0,130000.0,-39.0,-36.0,-46.0,-52.0,-43.0,-35.0,-44.0,-48.0,-90.0,-90.0,-87.0,-88.0,51.0,54.0,41.0,36.0,1
406,62:47:05:9D:EB:15,3857245,497874765,7046,12308217,3850199,485566548,1,7505,3914858,7455,3907200,50,7658,3586,0,7127,56,1,126,229410.0,130000.0,-47.0,-49.0,-47.0,-45.0,-44.0,-47.0,-39.0,-46.0,-90.0,-90.0,-87.0,-88.0,43.0,41.0,40.0,43.0,1
407,92:69:1D:31:68:E9,3854382,489272027,4181,3705277,3850201,485566750,1,5714,1228724,5535,1187991,179,40733,2317,12,4451,104,1,66,216660.0,130000.0,-52.0,-47.0,-42.0,-48.0,-51.0,-47.0,-43.0,-48.0,-90.0,-90.0,-87.0,-88.0,38.0,43.0,45.0,40.0,1
408,CC:2F:71:3F:1F:24,5159450,2004418972,1309249,1518852222,3850201,485566750,2222,1104803,1272267109,1103929,1272161227,874,105882,1069301,15,1307384,123774,2219,846,144444.0,43333.0,-71.0,-70.0,-67.0,-74.0,-71.0,-70.0,-67.0,-74.0,-90.0,-90.0,-87.0,-88.0,19.0,20.0,20.0,14.0,1
409,CC:2F:71:3E:C5:1F,3851226,485691999,1023,125047,3850203,485566952,3,4474,372917,3730,284595,744,88322,1083,14,1471,30,3,54,130000.0,39000.0,-72.0,-72.0,-71.0,-60.0,-72.0,-72.0,-69.0,-60.0,-90.0,-90.0,-87.0,-88.0,18.0,18.0,16.0,28.0,1
410,BA:8C:B9:54:50:24,3855161,491763976,4958,6197024,3850203,485566952,7,9989,1767940,9967,1764445,22,3495,2361,18,5482,44,7,77,229410.0,130000.0,-39.0,-36.0,-46.0,-52.0,-43.0,-35.0,-44.0,-48.0,-90.0,-90.0,-87.0,-88.0,51.0,54.0,41.0,36.0,1
411,62:47:05:9D:EB:15,3857252,497875644,7046,12308217,3850206,485567427,1,7505,3914858,7455,3907200,50,7658,3586,0,7127,56,1,126,229410.0,130000.0,-47.0,-49.0,-47.0,-45.0,-44.0,-47.0,-39.0,-46.0,-90.0,-90.0,-87.0,-88.0,43.0,41.0,40.0,43.0,1
412,92:69:1D:31:68:E9,3854387,489272704,4181,3705277,3850206,485567427,1,5714,1228724,5535,1187991,179,40733,2317,12,4451,104,1,66,216660.0,130000.0,-52.0,-47.0,-42.0,-48.0,-51.0,-47.0,-43.0,-48.0,-90.0,-90.0,-87.0,-88.0,38.0,43.0,45.0,40.0,1
413,CC:2F:71:3F:1F:24,5159655,2004676465,1309449,1519109038,3850206,485567427,2222,1104988,1272515233,1104114,1272409351,874,105882,1069482,15,1307584,123775,2219,846,144444.0,43333.0,-72.0,-69.0,-67.0,-73.0,-71.0,-69.0,-67.0,-73.0,-90.0,-90.0,-87.0,-88.0,18.0,21.0,20.0,15.0,1
414,CC:2F:71:3E:C5:1F,3851229,485692474,1023,125047,3850206,485567427,3,4474,372917,3730,284595,744,88322,1083,14,1471,30,3,54,130000.0,39000.0,-72.0,-72.0,-71.0,-60.0,-72.0,-72.0,-69.0,-60.0,-90.0,-90.0,-87.0,-88.0,18.0,18.0,16.0,28.0,1
415,BA:8C:B9:54:50:24,3855166,491764653,4958,6197024,3850208,485567629,7,9989,1767940,9967,1764445,22,3495,2361,18,5482,44,7,77,229410.0,130000.0,-39.0,-36.0,-46.0,-52.0,-43.0,-35.0,-44.0,-48.0,-90.0,-90.0,-87.0,-88.0,51.0,54.0,41.0,36.0,1
416,62:47:05:9D:EB:15,3857257,497876108,7046,12308217,3850211,485567891,1,7505,3914858,7455,3907200,50,7658,3586,0,7127,56,1,126,229410.0,130000.0,-47.0,-49.0,-47.0,-45.0,-44.0,-47.0,-39.0,-46.0,-90.0,-90.0,-87.0,-88.0,43.0,41.0,40.0,43.0,1
417,92:69:1D:31:68:E9,3854392,489273168,4181,3705277,3850211,485567891,1,5714,1228724,5535,1187991,179,40733,2317,12,4451,104,1,66,216660.0,130000.0,-52.0,-47.0,-42.0,-48.0,-51.0,-47.0,-43.0,-48.0,-90.0,-90.0,-87.0,-88.0,38.0,43.0,45.0,40.0,1
418,CC:2F:71:3F:1F:24,5159860,2004921950,1309645,1519353655,3850215,485568295,2222,1105171,1272753802,1104297,1272647920,874,105882,1069657,15,1307780,123775,2219,846,144444.0,43333.0,-72.0,-70.0,-67.0,-74.0,-72.0,-69.0,-67.0,-74.0,-90.0,-90.0,-87.0,-88.0,18.0,20.0,20.0,14.0,1
419,CC:2F:71:3E:C5:1F,3851238,485693342,1023,125047,3850215,485568295,3,4474,372917,3730,284595,744,88322,1083,14,1471,30,3,54,130000.0,39000.0,-72.0,-72.0,-71.0,-60.0,-72.0,-72.0,-69.0,-60.0,-90.0,-90.0,-87.0,-88.0,18.0,18.0,16.0,28.0,1
420,BA:8C:B9:54:50:24,3855173,491765319,4958,6197024,3850215,485568295,7,9989,1767940,9967,1764445,22,3495,2361,18,5482,44,7,77,229410.0,130000.0,-39.0,-36.0,-46.0,-52.0,-43.0,-35.0,-44.0,-48.0,-90.0,-90.0,-87.0,-88.0,51.0,54.0,41.0,36.0,1
421,62:47:05:9D:EB:15,3857261,497876512,7046,12308217,3850215,485568295,1,7505,3914858,7455,3907200,50,7658,3586,0,7127,56,1,126,229410.0,130000.0,-47.0,-49.0,-47.0,-45.0,-44.0,-47.0,-39.0,-46.0,-90.0,-90.0,-87.0,-88.0,43.0,41.0,40.0,43.0,1
422,92:69:1D:31:68:E9,3854396,489273572,4181,3705277,3850215,485568295,1,5714,1228724,5535,1187991,179,40733,2317,12,4451,104,1,66,216660.0,130000.0,-52.0,-47.0,-42.0,-48.0,-51.0,-47.0,-43.0,-48.0,-90.0,-90.0,-87.0,-88.0,38.0,43.0,45.0,40.0,1
423,CC:2F:71:3F:1F:24,5160054,2005163674,1309837,1519595177,3850217,485568497,2222,1105344,1272984984,1104470,1272879102,874,105882,1069824,15,1307972,123776,2219,846,144444.0,43333.0,-72.0,-70.0,-67.0,-75.0,-72.0,-69.0,-67.0,-74.0,-90.0,-90.0,-87.0,-88.0,18.0,20.0,20.0,13.0,1
424,CC:2F:71:3E:C5:1F,3851240,485693544,1023,125047,3850217,485568497,3,4474,372917,3730,284595,744,88322,1083,14,1471,30,3,54,130000.0,39000.0,-72.0,-72.0,-71.0,-60.0,-72.0,-72.0,-69.0,-60.0,-90.0,-90.0,-87.0,-88.0,18.0,18.0,16.0,28.0,1
425,BA:8C:B9:54:50:24,3855175,491765521,4958,6197024,3850217,485568497,7,9989,1767940,9967,1764445,22,3495,2361,18,5482,44,7,77,229410.0,130000.0,-39.0,-36.0,-46.0,-52.0,-43.0,-35.0,-44.0,-48.0,-90.0,-90.0,-87.0,-88.0,51.0,54.0,41.0,36.0,1
426,62:47:05:9D:EB:15,3857266,497876976,7046,12308217,3850220,485568759,1,7505,3914858,7455,3907200,50,7658,3586,0,7127,56,1,126,229410.0,130000.0,-47.0,-49.0,-47.0,-45.0,-44.0,-47.0,-39.0,-46.0,-90.0,-90.0,-87.0,-88.0,43.0,41.0,40.0,43.0,1
427,92:69:1D:31:68:E9,3854403,489274238,4181,3705277,3850222,485568961,1,5714,1228724,5535,1187991,179,40733,2317,12,4451,104,1,66,216660.0,130000.0,-52.0,-47.0,-42.0,-48.0,-51.0,-47.0,-43.0,-48.0,-90.0,-90.0,-87.0,-88.0,38.0,43.0,45.0,40.0,1
428,CC:2F:71:3F:1F:24,5160251,2005405616,1310027,1519836453,3850224,485569163,2222,1105518,1273220454,1104644,1273114572,874,105882,1069993,15,1308162,123776,2219,846,144444.0,43333.0,-72.0,-70.0,-68.0,-74.0,-72.0,-70.0,-68.0,-74.0,-90.0,-90.0,-87.0,-88.0,18.0,20.0,19.0,14.0,1
429,CC:2F:71:3E:C5:1F,3851247,485694210,1023,125047,3850224,485569163,3,4474,372917,3730,284595,744,88322,1083,14,1471,30,3,54,130000.0,39000.0,-72.0,-72.0,-71.0,-60.0,-72.0,-72.0,-69.0,-60.0,-90.0,-90.0,-87.0,-88.0,18.0,18.0,16.0,28.0,1
430,BA:8C:B9:54:50:24,3855182,491766187,4958,6197024,3850224,485569163,7,9989,1767940,9967,1764445,22,3495,2361,18,5482,44,7,77,229410.0,130000.0,-39.0,-36.0,-46.0,-52.0,-43.0,-35.0,-44.0,-48.0,-90.0,-90.0,-87.0,-88.0,51.0,54.0,41.0,36.0,1
431,62:47:05:9D:EB:15,3857270,497877380,7046,12308217,3850224,485569163,1,7505,3914858,7455,3907200,50,7658,3586,0,7127,56,1,126,229410.0,130000.0,-47.0,-49.0,-47.0,-45.0,-44.0,-47.0,-39.0,-46.0,-90.0,-90.0,-87.0,-88.0,43.0,41.0,40.0,43.0,1
432,92:69:1D:31:68:E9,3854407,489274642,4181,3705277,3850226,485569365,1,5714,1228724,5535,1187991,179,40733,2317,12,4451,104,1,66,216660.0,130000.0,-52.0,-47.0,-42.0,-48.0,-51.0,-47.0,-43.0,-48.0,-90.0,-90.0,-87.0,-88.0,38.0,43.0,45.0,40.0,1
433,CC:2F:71:3F:1F:24,5160444,2005647224,1310218,1520077859,3850226,485569365,2222,1105695,1273455398,1104821,1273349516,874,105882,1070162,15,1308353,123776,2219,846,144444.0,43333.0,-71.0,-70.0,-69.0,-74.0,-71.0,-70.0,-69.0,-74.0,-90.0,-90.0,-87.0,-88.0,19.0,20.0,18.0,14.0,1
434,CC:2F:71:3E:C5:1F,3851249,485694412,1023,125047,3850226,485569365,3,4474,372917,3730,284595,744,88322,1083,14,1471,30,3,54,130000.0,39000.0,-72.0,-72.0,-71.0,-60.0,-72.0,-72.0,-69.0,-60.0,-90.0,-90.0,-87.0,-88.0,18.0,18.0,16.0,28.0,1
435,BA:8C:B9:54:50:24,3855184,491766389,4958,6197024,3850226,485569365,7,9989,1767940,9967,1764445,22,3495,2361,18,5482,44,7,77,229410.0,130000.0,-39.0,-36.0,-46.0,-52.0,-43.0,-35.0,-44.0,-48.0,-90.0,-90.0,-87.0,-88.0,51.0,54.0,41.0,36.0,1
436,62:47:05:9D:EB:15,3857276,497877986,7046,12308217,3850230,485569769,1,7505,3914858,7455,3907200,50,7658,3586,0,7127,56,1,126,229410.0,130000.0,-47.0,-49.0,-47.0,-45.0,-44.0,-47.0,-39.0,-46.0,-90.0,-90.0,-87.0,-88.0,43.0,41.0,40.0,43.0,1
437,92:69:1D:31:68:E9,3854413,489275248,4181,3705277,3850232,485569971,1,5714,1228724,5535,1187991,179,40733,2317,12,4451,104,1,66,216660.0,130000.0,-52.0,-47.0,-42.0,-48.0,-51.0,-47.0,-43.0,-48.0,-90.0,-90.0,-87.0,-88.0,38.0,43.0,45.0,40.0,1
438,CC:2F:71:3F:1F:24,5160649,2005892837,1310417,1520322866,3850232,485569971,2222,1105879,1273692643,1105005,1273586761,874,105882,1070339,15,1308552,123778,2219,846,144444.0,43333.0,-72.0,-70.0,-68.0,-75.0,-72.0,-70.0,-67.0,-74.0,-90.0,-90.0,-87.0,-88.0,18.0,20.0,19.0,13.0,1
439,CC:2F:71:3E:C5:1F,3851255,485695018,1023,125047,3850232,485569971,3,4474,372917,3730,284595,744,88322,1083,14,1471,30,3,54,130000.0,39000.0,-72.0,-72.0,-71.0,-60.0,-72.0,-72.0,-69.0,-60.0,-90.0,-90.0,-87.0,-88.0,18.0,18.0,16.0,28.0,1
440,BA:8C:B9:54:50:24,3855190,491766995,4958,6197024,3850232,485569971,7,9989,1767940,9967,1764445,22,3495,2361,18,5482,44,7,77,229410.0,130000.0,-39.0,-36.0,-46.0,-52.0,-43.0,-35.0,-44.0,-48.0,-90.0,-90.0,-87.0,-88.0,51.0,54.0,41.0,36.0,1
441,62:47:05:9D:EB:15,3857281,497878450,7046,12308217,3850235,485570233,1,7505,3914858,7455,3907200,50,7658,3586,0,7127,56,1,126,229410.0,130000.0,-47.0,-49.0,-47.0,-45.0,-44.0,-47.0,-39.0,-46.0,-90.0,-91.0,-87.0,-88.0,43.0,42.0,40.0,43.0,1
442,92:69:1D:31:68:E9,3854416,489275510,4181,3705277,3850235,485570233,1,5715,1228792,5536,1188059,179,40733,2317,12,4451,104,1,66,216660.0,130000.0,-51.0,-47.0,-45.0,-47.0,-51.0,-47.0,-43.0,-48.0,-90.0,-91.0,-87.0,-88.0,39.0,44.0,42.0,41.0,1
443,CC:2F:71:3F:1F:24,5160841,2006131397,1310606,1520561164,3850235,485570233,2222,1106054,1273925561,1105180,1273819679,874,105882,1070507,15,1308741,123778,2219,846,144444.0,43333.0,-72.0,-70.0,-68.0,-74.0,-72.0,-70.0,-67.0,-74.0,-90.0,-91.0,-87.0,-88.0,18.0,21.0,19.0,14.0,1
444,CC:2F:71:3E:C5:1F,3851258,485695280,1023,125047,3850235,485570233,3,4474,372917,3730,284595,744,88322,1083,14,1471,30,3,54,130000.0,39000.0,-72.0,-72.0,-71.0,-60.0,-72.0,-72.0,-69.0,-60.0,-90.0,-91.0,-87.0,-88.0,18.0,19.0,16.0,28.0,1
445,BA:8C:B9:54:50:24,3855193,491767257,4958,6197024,3850235,485570233,7,9989,1767940,9967,1764445,22,3495,2361,18,5482,44,7,77,229410.0,130000.0,-39.0,-36.0,-46.0,-52.0,-43.0,-35.0,-44.0,-48.0,-90.0,-91.0,-87.0,-88.0,51.0,55.0,41.0,36.0,1
446,62:47:05:9D:EB:15,3857287,497879056,7046,12308217,3850241,485570839,1,7505,3914858,7455,3907200,50,7658,3586,0,7127,56,1,126,229410.0,130000.0,-47.0,-49.0,-47.0,-45.0,-44.0,-47.0,-39.0,-46.0,-90.0,-91.0,-87.0,-88.0,43.0,42.0,40.0,43.0,1
447,92:69:1D:31:68:E9,3854422,489276116,4181,3705277,3850241,485570839,1,5715,1228792,5536,1188059,179,40733,2317,12,4451,104,1,66,216660.0,130000.0,-51.0,-47.0,-45.0,-47.0,-51.0,-47.0,-43.0,-48.0,-90.0,-91.0,-87.0,-88.0,39.0,44.0,42.0,41.0,1
448,CC:2F:71:3F:1F:24,5161049,2006389065,1310808,1520818226,3850241,485570839,2222,1106244,1274180007,1105370,1274074125,874,105882,1070689,15,1308943,123783,2219,846,144444.0,43333.0,-72.0,-70.0,-68.0,-74.0,-72.0,-70.0,-68.0,-73.0,-90.0,-91.0,-87.0,-88.0,18.0,21.0,19.0,14.0,1
449,CC:2F:71:3E:C5:1F,3851264,485695886,1023,125047,3850241,485570839,3,4474,372917,3730,284595,744,88322,1083,14,1471,30,3,54,130000.0,39000.0,-72.0,-72.0,-71.0,-60.0,-72.0,-72.0,-69.0,-60.0,-90.0,-91.0,-87.0,-88.0,18.0,19.0,16.0,28.0,1
450,BA:8C:B9:54:50:24,3855199,491767863,4958,6197024,3850241,485570839,7,9989,1767940,9967,1764445,22,3495,2361,18,5482,44,7,77,229410.0,130000.0,-39.0,-36.0,-46.0,-52.0,-43.0,-35.0,-44.0,-48.0,-90.0,-91.0,-87.0,-88.0,51.0,55.0,41.0,36.0,1
451,62:47:05:9D:EB:15,3857291,497880414,7047,12309313,3850244,485571101,1,7506,3914926,7456,3907268,50,7658,3586,0,7128,56,1,126,229410.0,130000.0,-44.0,-45.0,-36.0,-48.0,-44.0,-47.0,-38.0,-46.0,-90.0,-91.0,-87.0,-88.0,46.0,46.0,51.0,40.0,1
452,92:69:1D:31:68:E9,3854425,489276378,4181,3705277,3850244,485571101,1,5715,1228792,5536,1188059,179,40733,2317,12,4451,104,1,66,216660.0,130000.0,-51.0,-47.0,-45.0,-47.0,-51.0,-47.0,-43.0,-48.0,-90.0,-91.0,-87.0,-88.0,39.0,44.0,42.0,41.0,1
453,CC:2F:71:3F:1F:24,5161245,2006633841,1311001,1521062740,3850244,485571101,2222,1106424,1274423459,1105550,1274317577,874,105882,1070859,15,1309136,123783,2219,846,144444.0,43333.0,-72.0,-70.0,-67.0,-74.0,-72.0,-70.0,-67.0,-74.0,-90.0,-91.0,-87.0,-88.0,18.0,21.0,20.0,14.0,1
454,CC:2F:71:3E:C5:1F,3851267,485696148,1023,125047,3850244,485571101,3,4474,372917,3730,284595,744,88322,1083,14,1471,30,3,54,130000.0,39000.0,-72.0,-72.0,-71.0,-60.0,-72.0,-72.0,-69.0,-60.0,-90.0,-91.0,-87.0,-88.0,18.0,19.0,16.0,28.0,1
455,BA:8C:B9:54:50:24,3855202,491768125,4958,6197024,3850244,485571101,7,9989,1767940,9967,1764445,22,3495,2361,18,5482,44,7,77,229410.0,130000.0,-39.0,-36.0,-46.0,-52.0,-43.0,-35.0,-44.0,-48.0,-90.0,-91.0,-87.0,-88.0,51.0,55.0,41.0,36.0,1
456,62:47:05:9D:EB:15,3857298,497881082,7047,12309313,3850251,485571769,1,7507,3914994,7457,3907336,50,7658,3586,0,7128,56,1,126,229410.0,130000.0,-44.0,-46.0,-35.0,-48.0,-44.0,-46.0,-37.0,-46.0,-90.0,-91.0,-87.0,-88.0,46.0,45.0,52.0,40.0,1
457,92:69:1D:31:68:E9,3854433,489277162,4182,3705393,3850251,485571769,1,5717,1228928,5538,1188195,179,40733,2317,12,4452,104,1,66,216660.0,130000.0,-51.0,-47.0,-42.0,-49.0,-51.0,-47.0,-43.0,-47.0,-90.0,-90.0,-87.0,-88.0,39.0,43.0,45.0,39.0,1
458,CC:2F:71:3F:1F:24,5161453,2006882554,1311202,1521310785,3850251,485571769,2222,1106606,1274656160,1105731,1274550160,875,106000,1071037,15,1309336,123783,2219,846,130000.0,39000.0,-72.0,-69.0,-67.0,-73.0,-72.0,-69.0,-67.0,-73.0,-90.0,-90.0,-87.0,-88.0,18.0,21.0,20.0,15.0,1
459,CC:2F:71:3E:C5:1F,3851276,485697058,1024,125163,3850252,485571895,3,4476,373057,3732,284735,744,88322,1083,14,1472,30,3,54,130000.0,39000.0,-81.0,-83.0,-76.0,-71.0,-73.0,-73.0,-70.0,-61.0,-90.0,-90.0,-87.0,-88.0,9.0,7.0,11.0,17.0,1
460,BA:8C:B9:54:50:24,3855211,491768979,4959,6197084,3850252,485571895,7,9991,1768076,9969,1764581,22,3495,2361,18,5483,44,7,77,229410.0,130000.0,-48.0,-35.0,-43.0,-45.0,-43.0,-35.0,-44.0,-48.0,-90.0,-90.0,-87.0,-88.0,42.0,55.0,44.0,43.0,1
461,62:47:05:9D:EB:15,3857304,497883285,7050,12311188,3850254,485572097,1,7509,3915130,7459,3907472,50,7658,3586,0,7131,56,1,126,229410.0,130000.0,-44.0,-46.0,-36.0,-47.0,-44.0,-46.0,-36.0,-47.0,-90.0,-90.0,-87.0,-88.0,46.0,44.0,51.0,41.0,1
462,92:69:1D:31:68:E9,3854436,489277490,4182,3705393,3850254,485572097,1,5717,1228928,5538,1188195,179,40733,2317,12,4452,104,1,66,216660.0,130000.0,-51.0,-47.0,-42.0,-49.0,-51.0,-47.0,-43.0,-47.0,-90.0,-90.0,-87.0,-88.0,39.0,43.0,45.0,39.0,1
463,CC:2F:71:3F:1F:24,5161650,2007127400,1311396,1521555303,3850254,485572097,2222,1106787,1274898426,1105912,1274792426,875,106000,1071210,15,1309531,123783,2219,846,144444.0,43333.0,-71.0,-69.0,-67.0,-73.0,-71.0,-68.0,-67.0,-72.0,-90.0,-90.0,-87.0,-88.0,19.0,21.0,20.0,15.0,1
464,CC:2F:71:3E:C5:1F,3851278,485697260,1024,125163,3850254,485572097,3,4476,373057,3732,284735,744,88322,1083,14,1472,30,3,54,130000.0,39000.0,-81.0,-83.0,-76.0,-71.0,-73.0,-73.0,-70.0,-61.0,-90.0,-90.0,-87.0,-88.0,9.0,7.0,11.0,17.0,1
465,BA:8C:B9:54:50:24,3855214,491769241,4959,6197084,3850255,485572157,7,9991,1768076,9969,1764581,22,3495,2361,18,5483,44,7,77,229410.0,130000.0,-48.0,-35.0,-43.0,-45.0,-43.0,-35.0,-44.0,-48.0,-90.0,-90.0,-87.0,-88.0,42.0,55.0,44.0,43.0,1
466,62:47:05:9D:EB:15,3857312,497884537,7051,12311774,3850261,485572763,1,7510,3915198,7460,3907540,50,7658,3586,0,7132,56,1,127,229410.0,130000.0,-44.0,-47.0,-36.0,-48.0,-44.0,-46.0,-37.0,-47.0,-90.0,-90.0,-87.0,-88.0,46.0,43.0,51.0,40.0,1
467,92:69:1D:31:68:E9,3854443,489278156,4182,3705393,3850261,485572763,1,5717,1228928,5538,1188195,179,40733,2317,12,4452,104,1,66,216660.0,130000.0,-51.0,-47.0,-42.0,-49.0,-51.0,-47.0,-43.0,-47.0,-90.0,-90.0,-87.0,-88.0,39.0,43.0,45.0,39.0,1
468,CC:2F:71:3F:1F:24,5161846,2007369212,1311585,1521796449,3850261,485572763,2222,1106963,1275131438,1106088,1275025438,875,106000,1071380,15,1309720,123783,2219,846,144444.0,43333.0,-71.0,-69.0,-67.0,-73.0,-71.0,-69.0,-67.0,-73.0,-90.0,-90.0,-87.0,-88.0,19.0,21.0,20.0,15.0,1
469,CC:2F:71:3E:C5:1F,3851285,485697926,1024,125163,3850261,485572763,3,4476,373057,3732,284735,744,88322,1083,14,1472,30,3,54,130000.0,39000.0,-81.0,-83.0,-76.0,-71.0,-73.0,-73.0,-70.0,-61.0,-90.0,-90.0,-87.0,-88.0,9.0,7.0,11.0,17.0,1
470,BA:8C:B9:54:50:24,3855220,491769847,4959,6197084,3850261,485572763,7,9991,1768076,9969,1764581,22,3495,2361,18,5483,44,7,77,229410.0,130000.0,-48.0,-35.0,-43.0,-45.0,-43.0,-35.0,-44.0,-48.0,-90.0,-90.0,-87.0,-88.0,42.0,55.0,44.0,43.0,1
471,62:47:05:9D:EB:15,3857315,497885012,7051,12311774,3850264,485573238,1,7511,3915266,7461,3907608,50,7658,3586,0,7132,56,1,127,229410.0,130000.0,-44.0,-47.0,-36.0,-48.0,-44.0,-46.0,-37.0,-47.0,-90.0,-90.0,-87.0,-88.0,46.0,43.0,51.0,40.0,1
472,92:69:1D:31:68:E9,3854446,489278631,4182,3705393,3850264,485573238,1,5717,1228928,5538,1188195,179,40733,2317,12,4452,104,1,66,216660.0,130000.0,-51.0,-47.0,-42.0,-49.0,-51.0,-47.0,-43.0,-47.0,-90.0,-90.0,-87.0,-88.0,39.0,43.0,45.0,39.0,1
473,CC:2F:71:3F:1F:24,5162047,2007617412,1311783,1522044174,3850264,485573238,2222,1107143,1275363796,1106268,1275257796,875,106000,1071559,15,1309918,123783,2219,847,144444.0,43333.0,-72.0,-69.0,-68.0,-74.0,-72.0,-69.0,-68.0,-74.0,-90.0,-90.0,-87.0,-88.0,18.0,21.0,19.0,14.0,1
474,CC:2F:71:3E:C5:1F,3851288,485698401,1024,125163,3850264,485573238,3,4476,373057,3732,284735,744,88322,1083,14,1472,30,3,54,130000.0,39000.0,-81.0,-83.0,-76.0,-71.0,-73.0,-73.0,-70.0,-61.0,-90.0,-90.0,-87.0,-88.0,9.0,7.0,11.0,17.0,1
475,BA:8C:B9:54:50:24,3855223,491770322,4959,6197084,3850264,485573238,7,9991,1768076,9969,1764581,22,3495,2361,18,5483,44,7,77,229410.0,130000.0,-48.0,-35.0,-43.0,-45.0,-43.0,-35.0,-44.0,-48.0,-90.0,-90.0,-87.0,-88.0,42.0,55.0,44.0,43.0,1
476,62:47:05:9D:EB:15,3857323,497886285,7052,12312381,3850271,485573904,1,7513,3915402,7463,3907744,50,7658,3586,0,7133,56,1,127,229410.0,130000.0,-44.0,-46.0,-36.0,-48.0,-44.0,-46.0,-35.0,-48.0,-90.0,-90.0,-87.0,-88.0,46.0,44.0,51.0,40.0,1
477,92:69:1D:31:68:E9,3854453,489279297,4182,3705393,3850271,485573904,1,5717,1228928,5538,1188195,179,40733,2317,12,4452,104,1,66,216660.0,130000.0,-51.0,-47.0,-42.0,-49.0,-51.0,-47.0,-43.0,-47.0,-90.0,-90.0,-87.0,-88.0,39.0,43.0,45.0,39.0,1
478,CC:2F:71:3F:1F:24,5162248,2007865698,1311977,1522291794,3850271,485573904,2222,1107332,1275618260,1106457,1275512260,875,106000,1071734,15,1310112,123783,2219,847,144444.0,43333.0,-72.0,-69.0,-68.0,-74.0,-71.0,-68.0,-67.0,-73.0,-90.0,-90.0,-87.0,-88.0,18.0,21.0,19.0,14.0,1
479,CC:2F:71:3E:C5:1F,3851295,485699067,1024,125163,3850271,485573904,3,4476,373057,3732,284735,744,88322,1083,14,1472,30,3,54,130000.0,39000.0,-81.0,-83.0,-76.0,-71.0,-73.0,-73.0,-70.0,-61.0,-90.0,-90.0,-87.0,-88.0,9.0,7.0,11.0,17.0,1
480,BA:8C:B9:54:50:24,3855230,491770988,4959,6197084,3850271,485573904,7,9991,1768076,9969,1764581,22,3495,2361,18,5483,44,7,77,229410.0,130000.0,-48.0,-35.0,-43.0,-45.0,-43.0,-35.0,-44.0,-48.0,-90.0,-90.0,-87.0,-88.0,42.0,55.0,44.0,43.0,1
481,62:47:05:9D:EB:15,3857326,497887073,7053,12312967,3850273,485574106,1,7515,3915538,7465,3907880,50,7658,3586,0,7134,56,1,127,229410.0,130000.0,-44.0,-46.0,-36.0,-48.0,-44.0,-46.0,-36.0,-48.0,-90.0,-90.0,-87.0,-88.0,46.0,44.0,51.0,40.0,1
482,92:69:1D:31:68:E9,3854455,489279499,4182,3705393,3850273,485574106,1,5717,1228928,5538,1188195,179,40733,2317,12,4452,104,1,66,216660.0,130000.0,-51.0,-47.0,-42.0,-49.0,-51.0,-47.0,-43.0,-47.0,-90.0,-90.0,-87.0,-88.0,39.0,43.0,45.0,39.0,1
483,CC:2F:71:3F:1F:24,5162442,2008108860,1312169,1522534754,3850273,485574106,2222,1107520,1275868554,1106645,1275762554,875,106000,1071905,15,1310304,123783,2219,848,144444.0,43333.0,-72.0,-69.0,-68.0,-73.0,-71.0,-69.0,-67.0,-73.0,-90.0,-90.0,-87.0,-88.0,18.0,21.0,19.0,15.0,1
484,CC:2F:71:3E:C5:1F,3851299,485699471,1024,125163,3850275,485574308,3,4476,373057,3732,284735,744,88322,1083,14,1472,30,3,54,130000.0,39000.0,-81.0,-83.0,-76.0,-71.0,-73.0,-73.0,-70.0,-61.0,-90.0,-90.0,-87.0,-88.0,9.0,7.0,11.0,17.0,1
485,BA:8C:B9:54:50:24,3855236,491771594,4959,6197084,3850277,485574510,7,9991,1768076,9969,1764581,22,3495,2361,18,5483,44,7,77,229410.0,130000.0,-48.0,-35.0,-43.0,-45.0,-43.0,-35.0,-44.0,-48.0,-90.0,-90.0,-87.0,-88.0,42.0,55.0,44.0,43.0,1
486,62:47:05:9D:EB:15,3857334,497888047,7053,12312967,3850281,485575080,1,7515,3915538,7465,3907880,50,7658,3586,0,7134,56,1,127,229410.0,130000.0,-44.0,-46.0,-36.0,-48.0,-44.0,-46.0,-36.0,-48.0,-90.0,-90.0,-87.0,-88.0,46.0,44.0,51.0,40.0,1
487,92:69:1D:31:68:E9,3854463,489280473,4182,3705393,3850281,485575080,1,5717,1228928,5538,1188195,179,40733,2317,12,4452,104,1,66,216660.0,130000.0,-51.0,-47.0,-42.0,-49.0,-51.0,-47.0,-43.0,-47.0,-90.0,-90.0,-87.0,-88.0,39.0,43.0,45.0,39.0,1
488,CC:2F:71:3F:1F:24,5162642,2008352794,1312361,1522777714,3850281,485575080,2222,1107694,1276099800,1106819,1275993800,875,106000,1072074,15,1310494,123784,2219,848,144444.0,43333.0,-71.0,-69.0,-67.0,-74.0,-71.0,-69.0,-67.0,-73.0,-90.0,-90.0,-87.0,-88.0,19.0,21.0,20.0,14.0,1
489,CC:2F:71:3E:C5:1F,3851305,485700243,1024,125163,3850281,485575080,3,4476,373057,3732,284735,744,88322,1083,14,1472,30,3,54,130000.0,39000.0,-81.0,-83.0,-76.0,-71.0,-73.0,-73.0,-70.0,-61.0,-90.0,-90.0,-87.0,-88.0,9.0,7.0,11.0,17.0,1
490,BA:8C:B9:54:50:24,3855240,491772164,4959,6197084,3850281,485575080,7,9991,1768076,9969,1764581,22,3495,2361,18,5483,44,7,77,229410.0,130000.0,-48.0,-35.0,-43.0,-45.0,-43.0,-35.0,-44.0,-48.0,-90.0,-90.0,-87.0,-88.0,42.0,55.0,44.0,43.0,1
491,62:47:05:9D:EB:15,3857337,497888309,7053,12312967,3850284,485575342,1,7515,3915538,7465,3907880,50,7658,3586,0,7134,56,1,127,229410.0,130000.0,-44.0,-46.0,-36.0,-48.0,-44.0,-46.0,-36.0,-48.0,-90.0,-90.0,-87.0,-88.0,46.0,44.0,51.0,40.0,1
492,92:69:1D:31:68:E9,3854468,489280937,4182,3705393,3850286,485575544,1,5717,1228928,5538,1188195,179,40733,2317,12,4452,104,1,66,216660.0,130000.0,-51.0,-47.0,-42.0,-49.0,-51.0,-47.0,-43.0,-47.0,-90.0,-90.0,-87.0,-88.0,39.0,43.0,45.0,39.0,1
493,CC:2F:71:3F:1F:24,5162845,2008598077,1312557,1523022331,3850288,485575746,2222,1107878,1276339866,1107003,1276233866,875,106000,1072251,15,1310692,123786,2219,848,144444.0,43333.0,-72.0,-70.0,-68.0,-74.0,-72.0,-70.0,-68.0,-74.0,-90.0,-90.0,-87.0,-88.0,18.0,20.0,19.0,14.0,1
494,CC:2F:71:3E:C5:1F,3851312,485700909,1024,125163,3850288,485575746,3,4476,373057,3732,284735,744,88322,1083,14,1472,30,3,54,130000.0,39000.0,-81.0,-83.0,-76.0,-71.0,-73.0,-73.0,-70.0,-61.0,-90.0,-90.0,-87.0,-88.0,9.0,7.0,11.0,17.0,1
495,BA:8C:B9:54:50:24,3855247,491772830,4959,6197084,3850288,485575746,7,9991,1768076,9969,1764581,22,3495,2361,18,5483,44,7,77,229410.0,130000.0,-48.0,-35.0,-43.0,-45.0,-43.0,-35.0,-44.0,-48.0,-90.0,-90.0,-87.0,-88.0,42.0,55.0,44.0,43.0,1
496,62:47:05:9D:EB:15,3857344,497889522,7054,12313574,3850290,485575948,1,7516,3915606,7466,3907948,50,7658,3586,0,7135,56,1,127,229410.0,130000.0,-44.0,-47.0,-36.0,-48.0,-44.0,-46.0,-36.0,-47.0,-90.0,-90.0,-87.0,-88.0,46.0,43.0,51.0,40.0,1
497,92:69:1D:31:68:E9,3854472,489281341,4182,3705393,3850290,485575948,1,5717,1228928,5538,1188195,179,40733,2317,12,4452,104,1,66,216660.0,130000.0,-51.0,-47.0,-42.0,-49.0,-51.0,-47.0,-43.0,-47.0,-90.0,-90.0,-87.0,-88.0,39.0,43.0,45.0,39.0,1
498,CC:2F:71:3F:1F:24,5163036,2008839425,1312746,1523263477,3850290,485575948,2222,1108058,1276581940,1107183,1276475940,875,106000,1072420,15,1310881,123786,2219,848,144444.0,43333.0,-75.0,-72.0,-70.0,-77.0,-73.0,-71.0,-69.0,-75.0,-90.0,-90.0,-87.0,-88.0,15.0,18.0,17.0,11.0,1
499,CC:2F:71:3E:C5:1F,3851314,485701111,1024,125163,3850290,485575948,3,4476,373057,3732,284735,744,88322,1083,14,1472,30,3,54,130000.0,39000.0,-81.0,-83.0,-76.0,-71.0,-73.0,-73.0,-70.0,-61.0,-90.0,-90.0,-87.0,-88.0,9.0,7.0,11.0,17.0,1
500,BA:8C:B9:54:50:24,3855249,491773032,4959,6197084,3850290,485575948,7,9991,1768076,9969,1764581,22,3495,2361,18,5483,44,7,77,229410.0,130000.0,-48.0,-35.0,-43.0,-45.0,-43.0,-35.0,-44.0,-48.0,-90.0,-90.0,-87.0,-88.0,42.0,55.0,44.0,43.0,1
501,62:47:05:9D:EB:15,3857349,497889986,7054,12313574,3850295,485576412,1,7517,3915674,7467,3908016,50,7658,3586,0,7135,56,1,127,229410.0,130000.0,-44.0,-47.0,-36.0,-48.0,-44.0,-46.0,-36.0,-48.0,-90.0,-90.0,-87.0,-88.0,46.0,43.0,51.0,40.0,1
502,92:69:1D:31:68:E9,3854479,489282007,4182,3705393,3850297,485576614,1,5717,1228928,5538,1188195,179,40733,2317,12,4452,104,1,66,216660.0,130000.0,-51.0,-47.0,-42.0,-49.0,-51.0,-47.0,-43.0,-47.0,-90.0,-90.0,-87.0,-88.0,39.0,43.0,45.0,39.0,1
503,CC:2F:71:3F:1F:24,5163235,2009081627,1312938,1523505013,3850297,485576614,2222,1108237,1276822508,1107362,1276716508,875,106000,1072589,15,1311073,123786,2219,848,144444.0,43333.0,-75.0,-72.0,-71.0,-77.0,-75.0,-72.0,-70.0,-77.0,-90.0,-90.0,-87.0,-88.0,15.0,18.0,16.0,11.0,1
504,CC:2F:71:3E:C5:1F,3851321,485701777,1024,125163,3850297,485576614,3,4476,373057,3732,284735,744,88322,1083,14,1472,30,3,54,130000.0,39000.0,-81.0,-83.0,-76.0,-71.0,-73.0,-73.0,-70.0,-61.0,-90.0,-90.0,-87.0,-88.0,9.0,7.0,11.0,17.0,1
505,BA:8C:B9:54:50:24,3855258,491773900,4959,6197084,3850299,485576816,7,9991,1768076,9969,1764581,22,3495,2361,18,5483,44,7,77,229410.0,130000.0,-48.0,-35.0,-43.0,-45.0,-43.0,-35.0,-44.0,-48.0,-90.0,-90.0,-87.0,-88.0,42.0,55.0,44.0,43.0,1
506,62:47:05:9D:EB:15,3857353,497890390,7054,12313574,3850299,485576816,1,7517,3915674,7467,3908016,50,7658,3586,0,7135,56,1,127,229410.0,130000.0,-44.0,-47.0,-36.0,-48.0,-44.0,-46.0,-36.0,-48.0,-90.0,-90.0,-87.0,-88.0,46.0,43.0,51.0,40.0,1
507,92:69:1D:31:68:E9,3854481,489282209,4182,3705393,3850299,485576816,1,5717,1228928,5538,1188195,179,40733,2317,12,4452,104,1,66,216660.0,130000.0,-51.0,-47.0,-42.0,-49.0,-51.0,-47.0,-43.0,-47.0,-90.0,-90.0,-87.0,-88.0,39.0,43.0,45.0,39.0,1
508,CC:2F:71:3F:1F:24,5163430,2009326343,1313131,1523749527,3850299,485576816,2222,1108414,1277061230,1107539,1276955230,875,106000,1072760,15,1311266,123786,2219,848,144444.0,43333.0,-75.0,-72.0,-71.0,-77.0,-74.0,-71.0,-70.0,-76.0,-90.0,-90.0,-87.0,-88.0,15.0,18.0,16.0,11.0,1
509,CC:2F:71:3E:C5:1F,3851323,485701979,1024,125163,3850299,485576816,3,4476,373057,3732,284735,744,88322,1083,14,1472,30,3,54,130000.0,39000.0,-81.0,-83.0,-76.0,-71.0,-73.0,-73.0,-70.0,-61.0,-90.0,-90.0,-87.0,-88.0,9.0,7.0,11.0,17.0,1
510,BA:8C:B9:54:50:24,3855260,491774102,4959,6197084,3850301,485577018,7,9991,1768076,9969,1764581,22,3495,2361,18,5483,44,7,77,229410.0,130000.0,-48.0,-35.0,-43.0,-45.0,-43.0,-35.0,-44.0,-48.0,-90.0,-90.0,-87.0,-88.0,42.0,55.0,44.0,43.0,1
511,62:47:05:9D:EB:15,3857361,497891644,7055,12314160,3850306,485577484,1,7520,3915878,7470,3908220,50,7658,3586,0,7136,56,1,127,229410.0,130000.0,-44.0,-47.0,-35.0,-49.0,-44.0,-46.0,-35.0,-48.0,-90.0,-90.0,-87.0,-88.0,46.0,43.0,52.0,39.0,1
512,92:69:1D:31:68:E9,3854488,489282877,4182,3705393,3850306,485577484,1,5717,1228928,5538,1188195,179,40733,2317,12,4452,104,1,66,216660.0,130000.0,-51.0,-47.0,-42.0,-49.0,-51.0,-47.0,-43.0,-47.0,-90.0,-90.0,-87.0,-88.0,39.0,43.0,45.0,39.0,1
513,CC:2F:71:3F:1F:24,5163635,2009571830,1313327,1523994144,3850308,485577686,2222,1108600,1277301529,1107725,1277195529,875,106000,1072937,15,1311462,123786,2219,848,144444.0,43333.0,-71.0,-69.0,-67.0,-73.0,-71.0,-68.0,-67.0,-73.0,-90.0,-90.0,-87.0,-88.0,19.0,21.0,20.0,15.0,1
514,CC:2F:71:3E:C5:1F,3851332,485702849,1024,125163,3850308,485577686,3,4478,373245,3733,284805,745,88440,1084,14,1472,30,3,54,130000.0,39000.0,-71.0,-72.0,-70.0,-60.0,-72.0,-73.0,-71.0,-61.0,-90.0,-90.0,-87.0,-88.0,19.0,18.0,17.0,28.0,1
515,BA:8C:B9:54:50:24,3855268,491774830,4959,6197084,3850309,485577746,7,9991,1768076,9969,1764581,22,3495,2361,18,5483,44,7,77,229410.0,130000.0,-48.0,-35.0,-43.0,-45.0,-43.0,-35.0,-44.0,-48.0,-90.0,-90.0,-87.0,-88.0,42.0,55.0,44.0,43.0,1
516,62:47:05:9D:EB:15,3857364,497891906,7055,12314160,3850309,485577746,1,7520,3915878,7470,3908220,50,7658,3586,0,7136,56,1,127,229410.0,130000.0,-44.0,-47.0,-35.0,-49.0,-44.0,-46.0,-35.0,-48.0,-90.0,-90.0,-87.0,-88.0,46.0,43.0,52.0,39.0,1
517,92:69:1D:31:68:E9,3854491,489283139,4182,3705393,3850309,485577746,1,5717,1228928,5538,1188195,179,40733,2317,12,4452,104,1,66,216660.0,130000.0,-51.0,-47.0,-42.0,-49.0,-51.0,-47.0,-43.0,-47.0,-90.0,-90.0,-87.0,-88.0,39.0,43.0,45.0,39.0,1
518,CC:2F:71:3F:1F:24,5163828,2009813368,1313517,1524235420,3850311,485577948,2222,1108772,1277529653,1107897,1277423653,875,106000,1073107,15,1311652,123788,2219,848,144444.0,43333.0,-71.0,-69.0,-67.0,-74.0,-71.0,-68.0,-67.0,-73.0,-90.0,-90.0,-87.0,-88.0,19.0,21.0,20.0,14.0,1
519,CC:2F:71:3E:C5:1F,3851335,485703111,1024,125163,3850311,485577948,3,4478,373245,3733,284805,745,88440,1084,14,1472,30,3,54,130000.0,39000.0,-71.0,-72.0,-70.0,-60.0,-72.0,-73.0,-71.0,-61.0,-90.0,-90.0,-87.0,-88.0,19.0,18.0,17.0,28.0,1
520,BA:8C:B9:54:50:24,3855270,491775032,4959,6197084,3850311,485577948,7,9991,1768076,9969,1764581,22,3495,2361,18,5483,44,7,77,229410.0,130000.0,-48.0,-35.0,-43.0,-45.0,-43.0,-35.0,-44.0,-48.0,-90.0,-90.0,-87.0,-88.0,42.0,55.0,44.0,43.0,1
521,62:47:05:9D:EB:15,3857374,497894316,7057,12315762,3850317,485578554,1,7522,3916014,7472,3908356,50,7658,3586,0,7138,56,1,127,229410.0,130000.0,-44.0,-47.0,-36.0,-48.0,-44.0,-46.0,-36.0,-48.0,-90.0,-90.0,-87.0,-88.0,46.0,43.0,51.0,40.0,1
522,92:69:1D:31:68:E9,3854499,489283947,4182,3705393,3850317,485578554,1,5719,1229064,5540,1188331,179,40733,2317,12,4453,104,1,66,216660.0,130000.0,-51.0,-47.0,-42.0,-48.0,-51.0,-47.0,-43.0,-47.0,-90.0,-90.0,-87.0,-88.0,39.0,43.0,45.0,40.0,1
523,CC:2F:71:3F:1F:24,5164035,2010071034,1313718,1524492480,3850317,485578554,2222,1108970,1277789679,1108095,1277683679,875,106000,1073289,15,1311853,123788,2219,849,144444.0,43333.0,-71.0,-69.0,-67.0,-73.0,-71.0,-69.0,-67.0,-73.0,-90.0,-90.0,-87.0,-88.0,19.0,21.0,20.0,15.0,1
524,CC:2F:71:3E:C5:1F,3851341,485703717,1024,125163,3850317,485578554,3,4478,373245,3733,284805,745,88440,1084,14,1472,30,3,54,130000.0,39000.0,-71.0,-72.0,-70.0,-60.0,-72.0,-73.0,-71.0,-61.0,-90.0,-90.0,-87.0,-88.0,19.0,18.0,17.0,28.0,1
525,BA:8C:B9:54:50:24,3855276,491775638,4959,6197084,3850317,485578554,7,9993,1768212,9971,1764717,22,3495,2361,18,5484,44,7,77,229410.0,130000.0,-49.0,-35.0,-43.0,-45.0,-43.0,-35.0,-44.0,-48.0,-90.0,-90.0,-87.0,-88.0,41.0,55.0,44.0,43.0,1
526,62:47:05:9D:EB:15,3857378,497894917,7058,12316101,3850320,485578816,1,7524,3916150,7474,3908492,50,7658,3586,0,7139,56,1,127,229410.0,137640.0,-44.0,-47.0,-36.0,-48.0,-44.0,-46.0,-36.0,-48.0,-90.0,-90.0,-87.0,-88.0,46.0,43.0,51.0,40.0,1
527,92:69:1D:31:68:E9,3854502,489284209,4182,3705393,3850320,485578816,1,5719,1229064,5540,1188331,179,40733,2317,12,4453,104,1,66,216660.0,130000.0,-51.0,-47.0,-42.0,-48.0,-51.0,-47.0,-43.0,-47.0,-90.0,-90.0,-87.0,-88.0,39.0,43.0,45.0,40.0,1
528,CC:2F:71:3F:1F:24,5164229,2010312718,1313909,1524733902,3850320,485578816,2222,1109146,1278028243,1108271,1277922243,875,106000,1073459,15,1312044,123788,2219,849,144444.0,43333.0,-71.0,-69.0,-67.0,-73.0,-71.0,-68.0,-67.0,-73.0,-90.0,-90.0,-87.0,-88.0,19.0,21.0,20.0,15.0,1
529,CC:2F:71:3E:C5:1F,3851344,485703979,1024,125163,3850320,485578816,3,4478,373245,3733,284805,745,88440,1084,14,1472,30,3,54,130000.0,39000.0,-71.0,-72.0,-70.0,-60.0,-72.0,-73.0,-71.0,-61.0,-90.0,-90.0,-87.0,-88.0,19.0,18.0,17.0,28.0,1
530,BA:8C:B9:54:50:24,3855279,491775900,4959,6197084,3850320,485578816,7,9994,1768280,9972,1764785,22,3495,2361,18,5484,44,7,77,229410.0,130000.0,-48.0,-35.0,-43.0,-45.0,-43.0,-35.0,-44.0,-48.0,-90.0,-90.0,-87.0,-88.0,42.0,55.0,44.0,43.0,1
531,62:47:05:9D:EB:15,3857384,497895523,7058,12316101,3850326,485579422,1,7524,3916150,7474,3908492,50,7658,3586,0,7139,56,1,127,229410.0,137640.0,-44.0,-47.0,-36.0,-48.0,-44.0,-46.0,-36.0,-48.0,-90.0,-90.0,-87.0,-88.0,46.0,43.0,51.0,40.0,1
532,92:69:1D:31:68:E9,3854508,489284815,4182,3705393,3850326,485579422,1,5719,1229064,5540,1188331,179,40733,2317,12,4453,104,1,66,216660.0,130000.0,-51.0,-47.0,-42.0,-48.0,-51.0,-47.0,-43.0,-47.0,-90.0,-90.0,-87.0,-88.0,39.0,43.0,45.0,40.0,1
533,CC:2F:71:3F:1F:24,5164437,2010564433,1314111,1524985011,3850326,485579422,2222,1109337,1278274790,1108462,1278168790,875,106000,1073640,15,1312246,123790,2219,849,144444.0,43333.0,-71.0,-69.0,-67.0,-73.0,-71.0,-68.0,-67.0,-73.0,-90.0,-90.0,-87.0,-88.0,19.0,21.0,20.0,15.0,1
534,CC:2F:71:3E:C5:1F,3851351,485704858,1024,125163,3850327,485579695,3,4478,373245,3733,284805,745,88440,1084,14,1472,30,3,54,130000.0,39000.0,-71.0,-72.0,-70.0,-60.0,-72.0,-73.0,-71.0,-61.0,-90.0,-90.0,-87.0,-88.0,19.0,18.0,17.0,28.0,1
535,BA:8C:B9:54:50:24,3855286,491776779,4959,6197084,3850327,485579695,7,9994,1768280,9972,1764785,22,3495,2361,18,5484,44,7,77,229410.0,130000.0,-48.0,-35.0,-43.0,-45.0,-43.0,-35.0,-44.0,-48.0,-90.0,-90.0,-87.0,-88.0,42.0,55.0,44.0,43.0,1
536,62:47:05:9D:EB:15,3857388,497897320,7059,12317423,3850329,485579897,1,7525,3916218,7475,3908560,50,7658,3586,0,7140,56,1,127,229410.0,137640.0,-44.0,-46.0,-36.0,-48.0,-44.0,-46.0,-36.0,-48.0,-90.0,-90.0,-87.0,-88.0,46.0,44.0,51.0,40.0,1
537,92:69:1D:31:68:E9,3854511,489285290,4182,3705393,3850329,485579897,1,5719,1229064,5540,1188331,179,40733,2317,12,4453,104,1,66,216660.0,130000.0,-51.0,-47.0,-42.0,-48.0,-51.0,-47.0,-43.0,-47.0,-90.0,-90.0,-87.0,-88.0,39.0,43.0,45.0,40.0,1
538,CC:2F:71:3F:1F:24,5164630,2010806200,1314301,1525226303,3850329,485579897,2222,1109515,1278512190,1108640,1278406190,875,106000,1073810,15,1312436,123790,2219,849,144444.0,43333.0,-71.0,-69.0,-67.0,-73.0,-71.0,-68.0,-67.0,-73.0,-90.0,-90.0,-87.0,-88.0,19.0,21.0,20.0,15.0,1
539,CC:2F:71:3E:C5:1F,3851353,485705060,1024,125163,3850329,485579897,3,4478,373245,3733,284805,745,88440,1084,14,1472,30,3,54,130000.0,39000.0,-71.0,-72.0,-70.0,-60.0,-72.0,-73.0,-71.0,-61.0,-90.0,-90.0,-87.0,-88.0,19.0,18.0,17.0,28.0,1
540,BA:8C:B9:54:50:24,3855289,491777041,4959,6197084,3850330,485579957,7,9994,1768280,9972,1764785,22,3495,2361,18,5484,44,7,77,229410.0,130000.0,-48.0,-35.0,-43.0,-45.0,-43.0,-35.0,-44.0,-48.0,-89.0,-90.0,-87.0,-88.0,41.0,55.0,44.0,43.0,1
541,62:47:05:9D:EB:15,3857396,497898593,7060,12318030,3850336,485580563,1,7527,3916354,7477,3908696,50,7658,3586,0,7141,56,1,127,229410.0,137640.0,-44.0,-46.0,-36.0,-48.0,-44.0,-46.0,-36.0,-48.0,-89.0,-90.0,-87.0,-88.0,45.0,44.0,51.0,40.0,1
542,92:69:1D:31:68:E9,3854518,489285956,4182,3705393,3850336,485580563,1,5719,1229064,5540,1188331,179,40733,2317,12,4453,104,1,66,216660.0,130000.0,-51.0,-47.0,-42.0,-48.0,-51.0,-47.0,-43.0,-47.0,-89.0,-90.0,-87.0,-88.0,38.0,43.0,45.0,40.0,1
543,CC:2F:71:3F:1F:24,5164826,2011048028,1314490,1525467465,3850336,485580563,2222,1109689,1278746346,1108814,1278640346,875,106000,1073978,15,1312625,123790,2219,849,144444.0,43333.0,-71.0,-69.0,-67.0,-73.0,-70.0,-69.0,-67.0,-72.0,-89.0,-90.0,-87.0,-88.0,18.0,21.0,20.0,15.0,1
544,CC:2F:71:3E:C5:1F,3851360,485705726,1024,125163,3850336,485580563,3,4478,373245,3733,284805,745,88440,1084,14,1472,30,3,54,130000.0,39000.0,-71.0,-72.0,-70.0,-60.0,-72.0,-73.0,-71.0,-61.0,-89.0,-90.0,-87.0,-88.0,18.0,18.0,17.0,28.0,1
545,BA:8C:B9:54:50:24,3855295,491777647,4959,6197084,3850336,485580563,7,9994,1768280,9972,1764785,22,3495,2361,18,5484,44,7,77,229410.0,130000.0,-48.0,-35.0,-43.0,-45.0,-43.0,-35.0,-44.0,-48.0,-89.0,-90.0,-87.0,-88.0,41.0,55.0,44.0,43.0,1
546,62:47:05:9D:EB:15,3857398,497898795,7060,12318030,3850338,485580765,1,7528,3916422,7478,3908764,50,7658,3586,0,7141,56,1,127,229410.0,137640.0,-44.0,-46.0,-38.0,-49.0,-44.0,-46.0,-36.0,-48.0,-89.0,-90.0,-87.0,-88.0,45.0,44.0,49.0,39.0,1
547,92:69:1D:31:68:E9,3854520,489286158,4182,3705393,3850338,485580765,1,5719,1229064,5540,1188331,179,40733,2317,12,4453,104,1,66,216660.0,130000.0,-51.0,-47.0,-42.0,-48.0,-51.0,-47.0,-43.0,-47.0,-89.0,-90.0,-87.0,-88.0,38.0,43.0,45.0,40.0,1
548,CC:2F:71:3F:1F:24,5165032,2011299661,1314694,1525718896,3850338,485580765,2222,1109878,1278991269,1109003,1278885269,875,106000,1074158,15,1312827,123790,2219,849,144444.0,43333.0,-71.0,-68.0,-67.0,-74.0,-71.0,-68.0,-66.0,-73.0,-89.0,-90.0,-87.0,-88.0,18.0,22.0,20.0,14.0,1
549,CC:2F:71:3E:C5:1F,3851362,485705928,1024,125163,3850338,485580765,3,4478,373245,3733,284805,745,88440,1084,14,1472,30,3,54,130000.0,39000.0,-71.0,-72.0,-70.0,-60.0,-72.0,-73.0,-71.0,-61.0,-89.0,-90.0,-87.0,-88.0,18.0,18.0,17.0,28.0,1
550,BA:8C:B9:54:50:24,3855297,491777849,4959,6197084,3850338,485580765,7,9994,1768280,9972,1764785,22,3495,2361,18,5484,44,7,77,229410.0,130000.0,-48.0,-35.0,-43.0,-45.0,-43.0,-35.0,-44.0,-48.0,-89.0,-90.0,-87.0,-88.0,41.0,55.0,44.0,43.0,1
551,62:47:05:9D:EB:15,3857405,497899461,7060,12318030,3850345,485581431,1,7528,3916422,7478,3908764,50,7658,3586,0,7141,56,1,127,229410.0,137640.0,-44.0,-46.0,-38.0,-49.0,-44.0,-46.0,-36.0,-48.0,-89.0,-90.0,-87.0,-88.0,45.0,44.0,49.0,39.0,1
552,92:69:1D:31:68:E9,3854527,489286824,4182,3705393,3850345,485581431,1,5719,1229064,5540,1188331,179,40733,2317,12,4453,104,1,66,216660.0,130000.0,-51.0,-47.0,-42.0,-48.0,-51.0,-47.0,-43.0,-47.0,-89.0,-90.0,-87.0,-88.0,38.0,43.0,45.0,40.0,1
553,CC:2F:71:3F:1F:24,5165232,2011544857,1314887,1525963426,3850345,485581431,2222,1110061,1279237807,1109186,1279131807,875,106000,1074332,15,1313022,123790,2219,849,144444.0,43333.0,-71.0,-69.0,-67.0,-73.0,-71.0,-68.0,-67.0,-73.0,-89.0,-90.0,-87.0,-88.0,18.0,21.0,20.0,15.0,1
554,CC:2F:71:3E:C5:1F,3851369,485706594,1024,125163,3850345,485581431,3,4478,373245,3733,284805,745,88440,1084,14,1472,30,3,54,130000.0,39000.0,-71.0,-72.0,-70.0,-60.0,-72.0,-73.0,-71.0,-61.0,-89.0,-90.0,-87.0,-88.0,18.0,18.0,17.0,28.0,1
555,BA:8C:B9:54:50:24,3855304,491778515,4959,6197084,3850345,485581431,7,9994,1768280,9972,1764785,22,3495,2361,18,5484,44,7,77,229410.0,130000.0,-48.0,-35.0,-43.0,-45.0,-43.0,-35.0,-44.0,-48.0,-89.0,-90.0,-87.0,-88.0,41.0,55.0,44.0,43.0,1
556,62:47:05:9D:EB:15,3857407,497899663,7060,12318030,3850347,485581633,1,7528,3916422,7478,3908764,50,7658,3586,0,7141,56,1,127,229410.0,137640.0,-44.0,-46.0,-38.0,-49.0,-44.0,-46.0,-36.0,-48.0,-89.0,-90.0,-87.0,-88.0,45.0,44.0,49.0,39.0,1
557,92:69:1D:31:68:E9,3854529,489287026,4182,3705393,3850347,485581633,1,5719,1229064,5540,1188331,179,40733,2317,12,4453,104,1,66,216660.0,130000.0,-51.0,-47.0,-42.0,-48.0,-51.0,-47.0,-43.0,-47.0,-89.0,-90.0,-87.0,-88.0,38.0,43.0,45.0,40.0,1
558,CC:2F:71:3F:1F:24,5165425,2011786369,1315078,1526204736,3850347,485581633,2222,1110236,1279470635,1109361,1279364635,875,106000,1074501,15,1313213,123790,2219,849,144444.0,39000.0,-71.0,-69.0,-67.0,-73.0,-71.0,-69.0,-67.0,-73.0,-89.0,-90.0,-87.0,-88.0,18.0,21.0,20.0,15.0,1
559,CC:2F:71:3E:C5:1F,3851373,485706998,1024,125163,3850349,485581835,3,4478,373245,3733,284805,745,88440,1084,14,1472,30,3,54,130000.0,39000.0,-71.0,-72.0,-70.0,-60.0,-72.0,-73.0,-71.0,-61.0,-89.0,-90.0,-87.0,-88.0,18.0,18.0,17.0,28.0,1
560,BA:8C:B9:54:50:24,3855308,491778919,4959,6197084,3850349,485581835,7,9994,1768280,9972,1764785,22,3495,2361,18,5484,44,7,77,229410.0,130000.0,-48.0,-35.0,-43.0,-45.0,-43.0,-35.0,-44.0,-48.0,-89.0,-90.0,-87.0,-88.0,41.0,55.0,44.0,43.0,1
561,62:47:05:9D:EB:15,3857414,497901647,7061,12319408,3850353,485582239,1,7530,3916558,7480,3908900,50,7658,3586,0,7142,56,1,127,229410.0,137640.0,-44.0,-45.0,-35.0,-48.0,-44.0,-46.0,-36.0,-48.0,-89.0,-90.0,-87.0,-88.0,45.0,45.0,52.0,40.0,1
562,92:69:1D:31:68:E9,3854535,489287632,4182,3705393,3850353,485582239,1,5719,1229064,5540,1188331,179,40733,2317,12,4453,104,1,66,216660.0,130000.0,-51.0,-47.0,-42.0,-48.0,-51.0,-47.0,-43.0,-47.0,-89.0,-90.0,-87.0,-88.0,38.0,43.0,45.0,40.0,1
563,CC:2F:71:3F:1F:24,5165626,2012031732,1315273,1526449493,3850353,485582239,2222,1110411,1279704808,1109536,1279598808,875,106000,1074673,15,1313408,123790,2219,849,144444.0,43333.0,-72.0,-70.0,-67.0,-75.0,-71.0,-69.0,-67.0,-74.0,-89.0,-90.0,-87.0,-88.0,17.0,20.0,20.0,13.0,1
564,CC:2F:71:3E:C5:1F,3851378,485707462,1024,125163,3850354,485582299,3,4478,373245,3733,284805,745,88440,1084,14,1472,30,3,54,130000.0,39000.0,-71.0,-72.0,-70.0,-60.0,-72.0,-73.0,-71.0,-61.0,-89.0,-90.0,-87.0,-88.0,18.0,18.0,17.0,28.0,1
565,BA:8C:B9:54:50:24,3855313,491779383,4959,6197084,3850354,485582299,7,9994,1768280,9972,1764785,22,3495,2361,18,5484,44,7,77,229410.0,130000.0,-48.0,-35.0,-43.0,-45.0,-43.0,-35.0,-44.0,-48.0,-89.0,-90.0,-87.0,-88.0,41.0,55.0,44.0,43.0,1
566,62:47:05:9D:EB:15,3857419,497902573,7062,12319994,3850357,485582579,1,7539,3917448,7488,3909652,51,7796,3590,0,7143,56,1,127,229410.0,137640.0,-45.0,-52.0,-47.0,-45.0,-45.0,-48.0,-39.0,-47.0,-89.0,-90.0,-87.0,-88.0,44.0,38.0,40.0,43.0,1
567,92:69:1D:31:68:E9,3854539,489287972,4182,3705393,3850357,485582579,1,5719,1229064,5540,1188331,179,40733,2317,12,4453,104,1,66,216660.0,130000.0,-51.0,-47.0,-42.0,-48.0,-51.0,-47.0,-43.0,-47.0,-89.0,-90.0,-87.0,-88.0,38.0,43.0,45.0,40.0,1
568,CC:2F:71:3F:1F:24,5165834,2012283367,1315475,1526700586,3850359,485582781,2222,1110595,1279940539,1109720,1279834539,875,106000,1074853,15,1313608,123815,2219,849,144444.0,43333.0,-70.0,-70.0,-67.0,-73.0,-70.0,-70.0,-66.0,-72.0,-89.0,-90.0,-87.0,-88.0,19.0,20.0,20.0,15.0,1
569,CC:2F:71:3E:C5:1F,3851385,485708146,1024,125163,3850361,485582983,3,4478,373245,3733,284805,745,88440,1084,14,1472,30,3,54,130000.0,39000.0,-71.0,-72.0,-70.0,-60.0,-72.0,-73.0,-71.0,-61.0,-89.0,-90.0,-87.0,-88.0,18.0,18.0,17.0,28.0,1
570,BA:8C:B9:54:50:24,3855320,491780067,4959,6197084,3850361,485582983,7,9994,1768280,9972,1764785,22,3495,2361,18,5484,44,7,77,229410.0,130000.0,-48.0,-35.0,-43.0,-45.0,-43.0,-35.0,-44.0,-48.0,-89.0,-90.0,-87.0,-88.0,41.0,55.0,44.0,43.0,1
571,62:47:05:9D:EB:15,3857425,497903179,7062,12319994,3850363,485583185,1,7539,3917448,7488,3909652,51,7796,3590,0,7143,56,1,127,229410.0,137640.0,-45.0,-52.0,-47.0,-45.0,-45.0,-48.0,-39.0,-47.0,-89.0,-90.0,-87.0,-88.0,44.0,38.0,40.0,43.0,1
572,92:69:1D:31:68:E9,3854545,489288578,4182,3705393,3850363,485583185,1,5719,1229064,5540,1188331,179,40733,2317,12,4453,104,1,66,216660.0,130000.0,-51.0,-47.0,-42.0,-48.0,-51.0,-47.0,-43.0,-47.0,-89.0,-90.0,-87.0,-88.0,38.0,43.0,45.0,40.0,1
573,CC:2F:71:3F:1F:24,5166380,2013028704,1316017,1527445519,3850363,485583185,2222,1110904,1280201304,1110029,1280095304,875,106000,1075158,15,1314152,123852,2219,849,144444.0,43333.0,-71.0,-69.0,-67.0,-72.0,-70.0,-69.0,-67.0,-72.0,-89.0,-90.0,-87.0,-88.0,18.0,21.0,20.0,16.0,1
574,CC:2F:71:3E:C5:1F,3851387,485708348,1024,125163,3850363,485583185,3,4478,373245,3733,284805,745,88440,1084,14,1472,30,3,54,130000.0,39000.0,-71.0,-72.0,-70.0,-60.0,-72.0,-73.0,-71.0,-61.0,-89.0,-90.0,-87.0,-88.0,18.0,18.0,17.0,28.0,1
575,BA:8C:B9:54:50:24,3855322,491780269,4959,6197084,3850363,485583185,7,9994,1768280,9972,1764785,22,3495,2361,18,5484,44,7,77,229410.0,130000.0,-48.0,-35.0,-43.0,-45.0,-43.0,-35.0,-44.0,-48.0,-89.0,-90.0,-87.0,-88.0,41.0,55.0,44.0,43.0,1
576,62:47:05:9D:EB:15,3857430,497903643,7062,12319994,3850368,485583649,1,7539,3917448,7488,3909652,51,7796,3590,0,7143,56,1,127,229410.0,137640.0,-45.0,-52.0,-47.0,-45.0,-45.0,-48.0,-39.0,-47.0,-89.0,-90.0,-87.0,-88.0,44.0,38.0,40.0,43.0,1
577,92:69:1D:31:68:E9,3854552,489289244,4182,3705393,3850370,485583851,1,5719,1229064,5540,1188331,179,40733,2317,12,4453,104,1,66,216660.0,130000.0,-51.0,-47.0,-42.0,-48.0,-51.0,-47.0,-43.0,-47.0,-89.0,-90.0,-87.0,-88.0,38.0,43.0,45.0,40.0,1
578,CC:2F:71:3F:1F:24,5166861,2013591446,1316491,1528007595,3850370,485583851,2222,1111238,1280469275,1110363,1280363275,875,106000,1075492,15,1314626,123904,2219,849,144444.0,43333.0,-70.0,-69.0,-67.0,-72.0,-70.0,-69.0,-67.0,-72.0,-89.0,-90.0,-87.0,-88.0,19.0,21.0,20.0,16.0,1
579,CC:2F:71:3E:C5:1F,3851394,485709014,1024,125163,3850370,485583851,3,4478,373245,3733,284805,745,88440,1084,14,1472,30,3,54,130000.0,39000.0,-71.0,-72.0,-70.0,-60.0,-72.0,-73.0,-71.0,-61.0,-89.0,-90.0,-87.0,-88.0,18.0,18.0,17.0,28.0,1
580,BA:8C:B9:54:50:24,3855331,491781137,4959,6197084,3850372,485584053,7,9994,1768280,9972,1764785,22,3495,2361,18,5484,44,7,77,229410.0,130000.0,-48.0,-35.0,-43.0,-45.0,-43.0,-35.0,-44.0,-48.0,-89.0,-90.0,-87.0,-88.0,41.0,55.0,44.0,43.0,1
581,62:47:05:9D:EB:15,3857435,497904109,7062,12319994,3850373,485584115,1,7539,3917448,7488,3909652,51,7796,3590,0,7143,56,1,127,229410.0,137640.0,-45.0,-52.0,-47.0,-45.0,-45.0,-48.0,-39.0,-47.0,-89.0,-90.0,-87.0,-88.0,44.0,38.0,40.0,43.0,1
582,92:69:1D:31:68:E9,3854556,489289624,4183,3705509,3850373,485584115,1,5721,1229200,5542,1188467,179,40733,2317,12,4454,104,1,66,216660.0,130000.0,-52.0,-47.0,-42.0,-48.0,-51.0,-47.0,-43.0,-47.0,-89.0,-90.0,-87.0,-88.0,37.0,43.0,45.0,40.0,1
583,CC:2F:71:3F:1F:24,5167061,2013839594,1316688,1528255479,3850373,485584115,2222,1111420,1280711395,1110545,1280605395,875,106000,1075668,15,1314824,123946,2219,849,144444.0,43333.0,-71.0,-70.0,-68.0,-73.0,-72.0,-71.0,-69.0,-74.0,-89.0,-90.0,-87.0,-88.0,18.0,20.0,19.0,15.0,1
584,CC:2F:71:3E:C5:1F,3851398,485709394,1025,125279,3850373,485584115,3,4482,373573,3736,285015,746,88558,1085,14,1473,30,3,54,130000.0,39000.0,-72.0,-72.0,-69.0,-60.0,-72.0,-73.0,-70.0,-61.0,-89.0,-90.0,-87.0,-88.0,17.0,18.0,18.0,28.0,1
585,BA:8C:B9:54:50:24,3855335,491781517,4960,6197200,3850375,485584317,7,9996,1768416,9974,1764921,22,3495,2361,18,5485,44,7,77,229410.0,130000.0,-49.0,-35.0,-43.0,-45.0,-44.0,-35.0,-44.0,-48.0,-89.0,-90.0,-87.0,-88.0,40.0,55.0,44.0,43.0,1
586,62:47:05:9D:EB:15,3857442,497904831,7063,12320110,3850379,485584721,1,7541,3917584,7490,3909788,51,7796,3590,0,7144,56,1,127,229410.0,137640.0,-43.0,-46.0,-36.0,-48.0,-44.0,-48.0,-39.0,-47.0,-89.0,-90.0,-87.0,-88.0,46.0,44.0,51.0,40.0,1
587,92:69:1D:31:68:E9,3854563,489290290,4183,3705509,3850380,485584781,1,5721,1229200,5542,1188467,179,40733,2317,12,4454,104,1,66,216660.0,130000.0,-52.0,-47.0,-42.0,-48.0,-51.0,-47.0,-43.0,-47.0,-89.0,-90.0,-87.0,-88.0,37.0,43.0,45.0,40.0,1
588,CC:2F:71:3F:1F:24,5167261,2014084774,1316881,1528499993,3850380,485584781,2222,1111593,1280943887,1110718,1280837887,875,106000,1075837,15,1315015,123951,2219,849,144444.0,43333.0,-71.0,-69.0,-67.0,-72.0,-70.0,-69.0,-66.0,-72.0,-89.0,-90.0,-87.0,-88.0,18.0,21.0,20.0,16.0,1
589,CC:2F:71:3E:C5:1F,3851407,485710262,1025,125279,3850382,485584983,3,4482,373573,3736,285015,746,88558,1085,14,1473,30,3,54,130000.0,39000.0,-72.0,-72.0,-69.0,-60.0,-72.0,-73.0,-70.0,-61.0,-89.0,-90.0,-87.0,-88.0,17.0,18.0,18.0,28.0,1
590,BA:8C:B9:54:50:24,3855342,491782183,4960,6197200,3850382,485584983,7,9996,1768416,9974,1764921,22,3495,2361,18,5485,44,7,77,229410.0,130000.0,-49.0,-35.0,-43.0,-45.0,-44.0,-35.0,-44.0,-48.0,-89.0,-90.0,-87.0,-88.0,40.0,55.0,44.0,43.0,1
591,62:47:05:9D:EB:15,3857445,497905093,7063,12320110,3850382,485584983,1,7541,3917584,7490,3909788,51,7796,3590,0,7144,56,1,127,229410.0,137640.0,-43.0,-46.0,-36.0,-48.0,-44.0,-48.0,-39.0,-47.0,-89.0,-90.0,-87.0,-88.0,46.0,44.0,51.0,40.0,1
592,92:69:1D:31:68:E9,3854565,489290492,4183,3705509,3850382,485584983,1,5721,1229200,5542,1188467,179,40733,2317,12,4454,104,1,66,216660.0,130000.0,-52.0,-47.0,-42.0,-48.0,-51.0,-47.0,-43.0,-47.0,-89.0,-90.0,-87.0,-88.0,37.0,43.0,45.0,40.0,1
593,CC:2F:71:3F:1F:24,5167455,2014327878,1317071,1528742693,3850384,485585185,2222,1111765,1281176235,1110890,1281070235,875,106000,1076007,15,1315207,123958,2219,849,144444.0,43333.0,-71.0,-69.0,-68.0,-74.0,-70.0,-69.0,-67.0,-73.0,-89.0,-90.0,-87.0,-88.0,18.0,21.0,19.0,14.0,1
594,CC:2F:71:3E:C5:1F,3851409,485710464,1025,125279,3850384,485585185,3,4482,373573,3736,285015,746,88558,1085,14,1473,30,3,54,130000.0,39000.0,-72.0,-72.0,-69.0,-60.0,-72.0,-73.0,-70.0,-61.0,-89.0,-90.0,-87.0,-88.0,17.0,18.0,18.0,28.0,1
595,BA:8C:B9:54:50:24,3855344,491782385,4960,6197200,3850384,485585185,7,9996,1768416,9974,1764921,22,3495,2361,18,5485,44,7,77,229410.0,130000.0,-49.0,-35.0,-43.0,-45.0,-44.0,-35.0,-44.0,-48.0,-89.0,-90.0,-87.0,-88.0,40.0,55.0,44.0,43.0,1
596,62:47:05:9D:EB:15,3857452,497905972,7063,12320110,3850389,485585862,1,7541,3917584,7490,3909788,51,7796,3590,0,7144,56,1,127,229410.0,137640.0,-43.0,-46.0,-36.0,-48.0,-44.0,-48.0,-39.0,-47.0,-89.0,-90.0,-87.0,-88.0,46.0,44.0,51.0,40.0,1
597,92:69:1D:31:68:E9,3854574,489291573,4183,3705509,3850391,485586064,1,5721,1229200,5542,1188467,179,40733,2317,12,4454,104,1,66,216660.0,130000.0,-52.0,-47.0,-42.0,-48.0,-51.0,-47.0,-43.0,-47.0,-89.0,-90.0,-87.0,-88.0,37.0,43.0,45.0,40.0,1
598,CC:2F:71:3F:1F:24,5167660,2014575058,1317269,1528988994,3850391,485586064,2222,1111950,1281416334,1111075,1281310334,875,106000,1076186,15,1315405,123963,2219,849,144444.0,43333.0,-71.0,-70.0,-68.0,-73.0,-70.0,-70.0,-68.0,-72.0,-89.0,-90.0,-87.0,-88.0,18.0,20.0,19.0,15.0,1
599,CC:2F:71:3E:C5:1F,3851416,485711343,1025,125279,3850391,485586064,3,4482,373573,3736,285015,746,88558,1085,14,1473,30,3,54,130000.0,39000.0,-72.0,-72.0,-69.0,-60.0,-72.0,-73.0,-70.0,-61.0,-89.0,-90.0,-87.0,-88.0,17.0,18.0,18.0,28.0,1
600,BA:8C:B9:54:50:24,3855351,491783264,4960,6197200,3850391,485586064,7,9996,1768416,9974,1764921,22,3495,2361,18,5485,44,7,77,229410.0,130000.0,-49.0,-35.0,-43.0,-45.0,-44.0,-35.0,-44.0,-48.0,-89.0,-90.0,-87.0,-88.0,40.0,55.0,44.0,43.0,1
601,62:47:05:9D:EB:15,3857457,497906436,7063,12320110,3850394,485586326,1,7541,3917584,7490,3909788,51,7796,3590,0,7144,56,1,127,229410.0,137640.0,-43.0,-46.0,-36.0,-48.0,-44.0,-48.0,-39.0,-47.0,-89.0,-90.0,-87.0,-88.0,46.0,44.0,51.0,40.0,1
602,92:69:1D:31:68:E9,3854577,489291835,4183,3705509,3850394,485586326,1,5721,1229200,5542,1188467,179,40733,2317,12,4454,104,1,66,216660.0,130000.0,-52.0,-47.0,-42.0,-48.0,-51.0,-47.0,-43.0,-47.0,-89.0,-90.0,-87.0,-88.0,37.0,43.0,45.0,40.0,1
603,CC:2F:71:3F:1F:24,5167857,2014819964,1317463,1529233638,3850394,485586326,2222,1112125,1281650468,1111250,1281544468,875,106000,1076358,15,1315599,123964,2219,849,144444.0,43333.0,-71.0,-69.0,-67.0,-73.0,-71.0,-69.0,-67.0,-73.0,-89.0,-90.0,-87.0,-88.0,18.0,21.0,20.0,15.0,1
604,CC:2F:71:3E:C5:1F,3851419,485711605,1025,125279,3850394,485586326,3,4482,373573,3736,285015,746,88558,1085,14,1473,30,3,54,130000.0,39000.0,-72.0,-72.0,-69.0,-60.0,-72.0,-73.0,-70.0,-61.0,-89.0,-90.0,-87.0,-88.0,17.0,18.0,18.0,28.0,1
605,BA:8C:B9:54:50:24,3855354,491783526,4960,6197200,3850394,485586326,7,9996,1768416,9974,1764921,22,3495,2361,18,5485,44,7,77,229410.0,130000.0,-49.0,-35.0,-43.0,-45.0,-44.0,-35.0,-44.0,-48.0,-89.0,-90.0,-87.0,-88.0,40.0,55.0,44.0,43.0,1
606,62:47:05:9D:EB:15,3857462,497907508,7064,12320778,3850398,485586730,1,7543,3917720,7492,3909924,51,7796,3590,0,7145,56,1,127,229410.0,137640.0,-43.0,-45.0,-36.0,-48.0,-43.0,-47.0,-38.0,-47.0,-89.0,-90.0,-87.0,-88.0,46.0,45.0,51.0,40.0,1
607,92:69:1D:31:68:E9,3854583,489292441,4183,3705509,3850400,485586932,1,5721,1229200,5542,1188467,179,40733,2317,12,4454,104,1,66,216660.0,130000.0,-52.0,-47.0,-42.0,-48.0,-51.0,-47.0,-43.0,-47.0,-89.0,-90.0,-87.0,-88.0,37.0,43.0,45.0,40.0,1
608,CC:2F:71:3F:1F:24,5168053,2015063270,1317653,1529476338,3850400,485586932,2222,1112296,1281881290,1111421,1281775290,875,106000,1076526,15,1315788,123967,2219,849,144444.0,43333.0,-71.0,-69.0,-67.0,-73.0,-71.0,-69.0,-67.0,-73.0,-89.0,-90.0,-87.0,-88.0,18.0,21.0,20.0,15.0,1
609,CC:2F:71:3E:C5:1F,3851425,485712211,1025,125279,3850400,485586932,3,4482,373573,3736,285015,746,88558,1085,14,1473,30,3,54,130000.0,39000.0,-72.0,-72.0,-69.0,-60.0,-72.0,-73.0,-70.0,-61.0,-89.0,-90.0,-87.0,-88.0,17.0,18.0,18.0,28.0,1
610,BA:8C:B9:54:50:24,3855360,491784132,4960,6197200,3850400,485586932,7,9996,1768416,9974,1764921,22,3495,2361,18,5485,44,7,77,229410.0,130000.0,-49.0,-35.0,-43.0,-45.0,-44.0,-35.0,-44.0,-48.0,-89.0,-90.0,-87.0,-88.0,40.0,55.0,44.0,43.0,1
611,62:47:05:9D:EB:15,3857467,497907972,7064,12320778,3850403,485587194,1,7543,3917720,7492,3909924,51,7796,3590,0,7145,56,1,127,229410.0,137640.0,-43.0,-45.0,-36.0,-48.0,-43.0,-47.0,-38.0,-47.0,-89.0,-90.0,-87.0,-88.0,46.0,45.0,51.0,40.0,1
612,92:69:1D:31:68:E9,3854586,489292703,4183,3705509,3850403,485587194,1,5721,1229200,5542,1188467,179,40733,2317,12,4454,104,1,66,216660.0,130000.0,-52.0,-47.0,-42.0,-48.0,-51.0,-47.0,-43.0,-47.0,-89.0,-90.0,-87.0,-88.0,37.0,43.0,45.0,40.0,1
613,CC:2F:71:3F:1F:24,5168261,2015331080,1317858,1529743886,3850403,485587194,2222,1112495,1282148212,1111620,1282042212,875,106000,1076715,15,1315994,123986,2219,849,144444.0,43333.0,-71.0,-69.0,-66.0,-73.0,-71.0,-69.0,-66.0,-73.0,-89.0,-90.0,-87.0,-88.0,18.0,21.0,21.0,15.0,1
614,CC:2F:71:3E:C5:1F,3851428,485712473,1025,125279,3850403,485587194,3,4482,373573,3736,285015,746,88558,1085,14,1473,30,3,54,130000.0,39000.0,-72.0,-72.0,-69.0,-60.0,-72.0,-73.0,-70.0,-61.0,-89.0,-90.0,-87.0,-88.0,17.0,18.0,18.0,28.0,1
615,BA:8C:B9:54:50:24,3855365,491784596,4960,6197200,3850405,485587396,7,9996,1768416,9974,1764921,22,3495,2361,18,5485,44,7,77,229410.0,130000.0,-49.0,-35.0,-43.0,-45.0,-44.0,-35.0,-44.0,-48.0,-89.0,-90.0,-87.0,-88.0,40.0,55.0,44.0,43.0,1
616,62:47:05:9D:EB:15,3857474,497909307,7065,12321507,3850409,485587800,1,7545,3917856,7494,3910060,51,7796,3590,0,7146,56,1,127,229410.0,137640.0,-45.0,-51.0,-50.0,-46.0,-43.0,-47.0,-39.0,-47.0,-89.0,-90.0,-87.0,-88.0,44.0,39.0,37.0,42.0,1
617,92:69:1D:31:68:E9,3854592,489293309,4183,3705509,3850409,485587800,1,5721,1229200,5542,1188467,179,40733,2317,12,4454,104,1,66,216660.0,130000.0,-52.0,-47.0,-42.0,-48.0,-51.0,-47.0,-43.0,-47.0,-89.0,-90.0,-87.0,-88.0,37.0,43.0,45.0,40.0,1
618,CC:2F:71:3F:1F:24,5168465,2015576563,1318056,1529988763,3850409,485587800,2222,1112677,1282381054,1111802,1282275054,875,106000,1076892,15,1316192,124043,2219,849,144444.0,43333.0,-71.0,-70.0,-67.0,-73.0,-71.0,-69.0,-66.0,-73.0,-89.0,-90.0,-87.0,-88.0,18.0,20.0,20.0,15.0,1
619,CC:2F:71:3E:C5:1F,3851434,485713079,1025,125279,3850409,485587800,3,4482,373573,3736,285015,746,88558,1085,14,1473,30,3,54,130000.0,39000.0,-72.0,-72.0,-69.0,-60.0,-72.0,-73.0,-70.0,-61.0,-89.0,-90.0,-87.0,-88.0,17.0,18.0,18.0,28.0,1
620,BA:8C:B9:54:50:24,3855369,491785000,4960,6197200,3850409,485587800,7,9996,1768416,9974,1764921,22,3495,2361,18,5485,44,7,77,229410.0,130000.0,-49.0,-35.0,-43.0,-45.0,-44.0,-35.0,-44.0,-48.0,-89.0,-90.0,-87.0,-88.0,40.0,55.0,44.0,43.0,1
621,62:47:05:9D:EB:15,3857476,497909509,7065,12321507,3850411,485588002,1,7545,3917856,7494,3910060,51,7796,3590,0,7146,56,1,127,229410.0,137640.0,-45.0,-51.0,-50.0,-46.0,-43.0,-47.0,-39.0,-47.0,-89.0,-90.0,-87.0,-88.0,44.0,39.0,37.0,42.0,1
622,92:69:1D:31:68:E9,3854594,489293511,4183,3705509,3850411,485588002,1,5721,1229200,5542,1188467,179,40733,2317,12,4454,104,1,66,216660.0,130000.0,-52.0,-47.0,-42.0,-48.0,-51.0,-47.0,-43.0,-47.0,-89.0,-90.0,-87.0,-88.0,37.0,43.0,45.0,40.0,1
623,CC:2F:71:3F:1F:24,5168663,2015821611,1318250,1530233407,3850413,485588204,2222,1112850,1282613518,1111975,1282507518,875,106000,1077063,15,1316386,124085,2219,849,144444.0,43333.0,-71.0,-69.0,-67.0,-73.0,-71.0,-69.0,-66.0,-73.0,-89.0,-90.0,-87.0,-88.0,18.0,21.0,20.0,15.0,1
624,CC:2F:71:3E:C5:1F,3851438,485713483,1025,125279,3850413,485588204,3,4482,373573,3736,285015,746,88558,1085,14,1473,30,3,54,130000.0,39000.0,-72.0,-72.0,-69.0,-60.0,-72.0,-73.0,-70.0,-61.0,-89.0,-90.0,-87.0,-88.0,17.0,18.0,18.0,28.0,1
625,BA:8C:B9:54:50:24,3855373,491785404,4960,6197200,3850413,485588204,7,9996,1768416,9974,1764921,22,3495,2361,18,5485,44,7,77,229410.0,130000.0,-49.0,-35.0,-43.0,-45.0,-44.0,-35.0,-44.0,-48.0,-89.0,-90.0,-87.0,-88.0,40.0,55.0,44.0,43.0,1
626,62:47:05:9D:EB:15,3857483,497910175,7065,12321507,3850418,485588668,1,7545,3917856,7494,3910060,51,7796,3590,0,7146,56,1,127,229410.0,137640.0,-45.0,-51.0,-50.0,-46.0,-43.0,-47.0,-39.0,-47.0,-89.0,-90.0,-87.0,-88.0,44.0,39.0,37.0,42.0,1
627,92:69:1D:31:68:E9,3854601,489294177,4183,3705509,3850418,485588668,1,5722,1229268,5543,1188535,179,40733,2317,12,4454,104,1,66,216660.0,130000.0,-52.0,-47.0,-44.0,-47.0,-51.0,-47.0,-43.0,-47.0,-89.0,-90.0,-87.0,-88.0,37.0,43.0,43.0,41.0,1
628,CC:2F:71:3F:1F:24,5168862,2016066719,1318444,1530478051,3850418,485588668,2222,1113026,1282850644,1112151,1282744644,875,106000,1077234,15,1316580,124141,2219,849,144444.0,43333.0,-71.0,-70.0,-67.0,-74.0,-71.0,-69.0,-66.0,-73.0,-89.0,-90.0,-87.0,-88.0,18.0,20.0,20.0,14.0,1
629,CC:2F:71:3E:C5:1F,3851443,485713947,1025,125279,3850418,485588668,3,4482,373573,3736,285015,746,88558,1085,14,1473,30,3,54,130000.0,39000.0,-72.0,-72.0,-69.0,-60.0,-72.0,-73.0,-70.0,-61.0,-89.0,-90.0,-87.0,-88.0,17.0,18.0,18.0,28.0,1
630,BA:8C:B9:54:50:24,3855378,491785868,4960,6197200,3850418,485588668,7,9996,1768416,9974,1764921,22,3495,2361,18,5485,44,7,77,229410.0,130000.0,-49.0,-35.0,-43.0,-45.0,-44.0,-35.0,-44.0,-48.0,-89.0,-90.0,-87.0,-88.0,40.0,55.0,44.0,43.0,1
631,62:47:05:9D:EB:15,3857488,497911186,7066,12322114,3850422,485589072,1,7547,3917992,7496,3910196,51,7796,3590,0,7147,56,1,127,216660.0,130000.0,-43.0,-45.0,-35.0,-48.0,-43.0,-46.0,-37.0,-47.0,-89.0,-90.0,-87.0,-88.0,46.0,45.0,52.0,40.0,1
632,92:69:1D:31:68:E9,3854605,489294581,4183,3705509,3850422,485589072,1,5722,1229268,5543,1188535,179,40733,2317,12,4454,104,1,66,216660.0,130000.0,-52.0,-47.0,-44.0,-47.0,-51.0,-47.0,-43.0,-47.0,-89.0,-90.0,-87.0,-88.0,37.0,43.0,43.0,41.0,1
633,CC:2F:71:3F:1F:24,5169055,2016308213,1318633,1530719141,3850422,485589072,2222,1113201,1283082118,1112326,1282976118,875,106000,1077404,15,1316769,124207,2219,849,130000.0,43333.0,-71.0,-69.0,-67.0,-73.0,-71.0,-69.0,-66.0,-73.0,-89.0,-90.0,-87.0,-88.0,18.0,21.0,20.0,15.0,1
634,CC:2F:71:3E:C5:1F,3851447,485714351,1025,125279,3850422,485589072,3,4482,373573,3736,285015,746,88558,1085,14,1473,30,3,54,130000.0,39000.0,-72.0,-72.0,-69.0,-60.0,-72.0,-73.0,-70.0,-61.0,-89.0,-90.0,-87.0,-88.0,17.0,18.0,18.0,28.0,1
635,BA:8C:B9:54:50:24,3855382,491786272,4960,6197200,3850422,485589072,7,9996,1768416,9974,1764921,22,3495,2361,18,5485,44,7,77,229410.0,130000.0,-49.0,-35.0,-43.0,-45.0,-44.0,-35.0,-44.0,-48.0,-89.0,-90.0,-87.0,-88.0,40.0,55.0,44.0,43.0,1
636,62:47:05:9D:EB:15,3857494,497911712,7066,12322114,3850428,485589598,1,7547,3917992,7496,3910196,51,7796,3590,0,7147,56,1,127,216660.0,130000.0,-43.0,-45.0,-35.0,-48.0,-43.0,-46.0,-37.0,-47.0,-89.0,-90.0,-87.0,-88.0,46.0,45.0,52.0,40.0,1
637,92:69:1D:31:68:E9,3854611,489295107,4183,3705509,3850428,485589598,1,5722,1229268,5543,1188535,179,40733,2317,12,4454,104,1,66,216660.0,130000.0,-52.0,-47.0,-44.0,-47.0,-51.0,-47.0,-43.0,-47.0,-89.0,-90.0,-87.0,-88.0,37.0,43.0,43.0,41.0,1
638,CC:2F:71:3F:1F:24,5169263,2016558470,1318835,1530968872,3850428,485589598,2222,1113389,1283319765,1112513,1283213647,876,106118,1077586,15,1316971,124207,2219,849,130000.0,43333.0,-71.0,-70.0,-67.0,-73.0,-71.0,-69.0,-67.0,-73.0,-89.0,-90.0,-87.0,-88.0,18.0,20.0,20.0,15.0,1
639,CC:2F:71:3E:C5:1F,3851453,485714877,1025,125279,3850428,485589598,3,4482,373573,3736,285015,746,88558,1085,14,1473,30,3,54,130000.0,39000.0,-72.0,-72.0,-69.0,-60.0,-72.0,-73.0,-70.0,-61.0,-89.0,-90.0,-87.0,-88.0,17.0,18.0,18.0,28.0,1
640,BA:8C:B9:54:50:24,3855388,491786798,4960,6197200,3850428,485589598,7,9996,1768416,9974,1764921,22,3495,2361,18,5485,44,7,77,229410.0,130000.0,-49.0,-35.0,-43.0,-45.0,-44.0,-35.0,-44.0,-48.0,-89.0,-90.0,-87.0,-88.0,40.0,55.0,44.0,43.0,1
641,62:47:05:9D:EB:15,3857498,497912116,7066,12322114,3850432,485590002,1,7547,3917992,7496,3910196,51,7796,3590,0,7147,56,1,127,216660.0,130000.0,-43.0,-45.0,-35.0,-48.0,-43.0,-46.0,-37.0,-47.0,-89.0,-90.0,-87.0,-88.0,46.0,45.0,52.0,40.0,1
642,92:69:1D:31:68:E9,3854615,489295511,4183,3705509,3850432,485590002,1,5722,1229268,5543,1188535,179,40733,2317,12,4454,104,1,66,216660.0,130000.0,-52.0,-47.0,-44.0,-47.0,-51.0,-47.0,-43.0,-47.0,-89.0,-90.0,-87.0,-88.0,37.0,43.0,43.0,41.0,1
643,CC:2F:71:3F:1F:24,5169471,2016807433,1319027,1531211832,3850444,485595601,2222,1113569,1283558935,1112693,1283452817,876,106118,1077759,15,1317163,124207,2219,849,130000.0,43333.0,-71.0,-69.0,-67.0,-74.0,-71.0,-69.0,-66.0,-73.0,-89.0,-90.0,-87.0,-88.0,18.0,21.0,20.0,14.0,1
644,CC:2F:71:3E:C5:1F,3851469,485720880,1025,125279,3850444,485595601,3,4482,373573,3736,285015,746,88558,1085,14,1473,30,3,54,130000.0,39000.0,-72.0,-72.0,-69.0,-60.0,-72.0,-73.0,-70.0,-61.0,-89.0,-90.0,-87.0,-88.0,17.0,18.0,18.0,28.0,1
645,BA:8C:B9:54:50:24,3855406,491793003,4960,6197200,3850446,485595803,7,9996,1768416,9974,1764921,22,3495,2361,18,5485,44,7,77,229410.0,130000.0,-49.0,-35.0,-43.0,-45.0,-44.0,-35.0,-44.0,-48.0,-89.0,-90.0,-87.0,-88.0,40.0,55.0,44.0,43.0,1
646,62:47:05:9D:EB:15,3857525,497923543,7066,12322114,3850459,485601429,1,7547,3917992,7496,3910196,51,7796,3590,0,7147,56,1,127,216660.0,130000.0,-43.0,-45.0,-35.0,-48.0,-43.0,-46.0,-37.0,-47.0,-89.0,-90.0,-87.0,-88.0,46.0,45.0,52.0,40.0,1
647,92:69:1D:31:68:E9,3854642,489306938,4183,3705509,3850459,485601429,1,5725,1229639,5545,1188671,180,40968,2318,12,4454,104,1,66,216660.0,130000.0,-52.0,-47.0,-44.0,-47.0,-51.0,-47.0,-43.0,-48.0,-89.0,-90.0,-87.0,-88.0,37.0,43.0,43.0,41.0,1
648,CC:2F:71:3F:1F:24,5169687,2017069983,1319228,1531468554,3850459,485601429,2222,1113753,1283808493,1112877,1283702375,876,106118,1077938,15,1317364,124228,2219,849,130000.0,43333.0,-71.0,-69.0,-66.0,-74.0,-71.0,-69.0,-66.0,-73.0,-89.0,-90.0,-87.0,-88.0,18.0,21.0,21.0,14.0,1
649,CC:2F:71:3E:C5:1F,3851484,485726708,1025,125279,3850459,485601429,3,4484,373713,3738,285155,746,88558,1085,14,1474,30,3,54,130000.0,39000.0,-72.0,-70.0,-68.0,-60.0,-72.0,-73.0,-70.0,-61.0,-89.0,-90.0,-87.0,-88.0,17.0,20.0,19.0,28.0,1
650,BA:8C:B9:54:50:24,3855419,491798629,4960,6197200,3850459,485601429,7,9998,1768552,9976,1765057,22,3495,2361,18,5486,44,7,77,229410.0,130000.0,-48.0,-35.0,-43.0,-46.0,-46.0,-35.0,-43.0,-46.0,-89.0,-90.0,-87.0,-88.0,41.0,55.0,44.0,42.0,1
651,62:47:05:9D:EB:15,3857531,497924067,7067,12322174,3850464,485601893,1,7550,3918238,7499,3910442,51,7796,3591,0,7148,56,1,127,216660.0,130000.0,-43.0,-45.0,-35.0,-48.0,-43.0,-46.0,-37.0,-48.0,-89.0,-90.0,-87.0,-88.0,46.0,45.0,52.0,40.0,1
652,92:69:1D:31:68:E9,3854647,489307402,4183,3705509,3850464,485601893,1,5725,1229639,5545,1188671,180,40968,2318,12,4454,104,1,66,216660.0,130000.0,-52.0,-47.0,-44.0,-47.0,-51.0,-47.0,-43.0,-48.0,-89.0,-90.0,-87.0,-88.0,37.0,43.0,43.0,41.0,1
653,CC:2F:71:3F:1F:24,5169886,2017315033,1319420,1531712938,3850466,485602095,2222,1113928,1284044093,1113052,1283937975,876,106118,1078109,15,1317556,124228,2219,849,130000.0,43333.0,-71.0,-70.0,-68.0,-73.0,-71.0,-70.0,-67.0,-73.0,-89.0,-90.0,-87.0,-88.0,18.0,20.0,19.0,15.0,1
654,CC:2F:71:3E:C5:1F,3851491,485727374,1025,125279,3850466,485602095,3,4484,373713,3738,285155,746,88558,1085,14,1474,30,3,54,130000.0,39000.0,-72.0,-70.0,-68.0,-60.0,-72.0,-73.0,-70.0,-61.0,-89.0,-90.0,-87.0,-88.0,17.0,20.0,19.0,28.0,1
655,BA:8C:B9:54:50:24,3855426,491799295,4960,6197200,3850466,485602095,7,9998,1768552,9976,1765057,22,3495,2361,18,5486,44,7,77,229410.0,130000.0,-48.0,-35.0,-43.0,-46.0,-46.0,-35.0,-43.0,-46.0,-89.0,-90.0,-87.0,-88.0,41.0,55.0,44.0,42.0,1
656,62:47:05:9D:EB:15,3857536,497924744,7067,12322174,3850469,485602570,1,7550,3918238,7499,3910442,51,7796,3591,0,7148,56,1,127,216660.0,130000.0,-43.0,-45.0,-35.0,-48.0,-43.0,-46.0,-37.0,-48.0,-89.0,-90.0,-87.0,-88.0,46.0,45.0,52.0,40.0,1
657,92:69:1D:31:68:E9,3854652,489308079,4183,3705509,3850469,485602570,1,5725,1229639,5545,1188671,180,40968,2318,12,4454,104,1,66,216660.0,130000.0,-52.0,-47.0,-44.0,-47.0,-51.0,-47.0,-43.0,-48.0,-89.0,-90.0,-87.0,-88.0,37.0,43.0,43.0,41.0,1
658,CC:2F:71:3F:1F:24,5170088,2017563139,1319619,1531960569,3850469,485602570,2222,1114111,1284281146,1113235,1284175028,876,106118,1078287,15,1317755,124239,2219,849,130000.0,43333.0,-71.0,-69.0,-67.0,-74.0,-71.0,-70.0,-67.0,-74.0,-89.0,-90.0,-87.0,-88.0,18.0,21.0,20.0,14.0,1
659,CC:2F:71:3E:C5:1F,3851494,485727849,1025,125279,3850469,485602570,3,4484,373713,3738,285155,746,88558,1085,14,1474,30,3,54,130000.0,39000.0,-72.0,-70.0,-68.0,-60.0,-72.0,-73.0,-70.0,-61.0,-89.0,-90.0,-87.0,-88.0,17.0,20.0,19.0,28.0,1
660,BA:8C:B9:54:50:24,3855429,491799770,4960,6197200,3850469,485602570,7,9998,1768552,9976,1765057,22,3495,2361,18,5486,44,7,77,229410.0,130000.0,-48.0,-35.0,-43.0,-46.0,-46.0,-35.0,-43.0,-46.0,-89.0,-90.0,-87.0,-88.0,41.0,55.0,44.0,42.0,1
661,62:47:05:9D:EB:15,3857543,497925410,7067,12322174,3850476,485603236,1,7550,3918238,7499,3910442,51,7796,3591,0,7148,56,1,127,216660.0,130000.0,-43.0,-45.0,-35.0,-48.0,-43.0,-46.0,-37.0,-48.0,-89.0,-90.0,-87.0,-88.0,46.0,45.0,52.0,40.0,1
662,92:69:1D:31:68:E9,3854659,489308745,4183,3705509,3850476,485603236,1,5725,1229639,5545,1188671,180,40968,2318,12,4454,104,1,66,216660.0,130000.0,-52.0,-47.0,-44.0,-47.0,-51.0,-47.0,-43.0,-48.0,-89.0,-90.0,-87.0,-88.0,37.0,43.0,43.0,41.0,1
663,CC:2F:71:3F:1F:24,5170288,2017808305,1319812,1532205069,3850476,485603236,2222,1114286,1284513902,1113410,1284407784,876,106118,1078458,15,1317948,124239,2219,849,130000.0,43333.0,-75.0,-73.0,-70.0,-77.0,-73.0,-72.0,-69.0,-76.0,-89.0,-90.0,-87.0,-88.0,14.0,17.0,17.0,11.0,1
664,CC:2F:71:3E:C5:1F,3851503,485728717,1025,125279,3850478,485603438,3,4484,373713,3738,285155,746,88558,1085,14,1474,30,3,54,130000.0,39000.0,-72.0,-70.0,-68.0,-60.0,-72.0,-73.0,-70.0,-61.0,-89.0,-90.0,-87.0,-88.0,17.0,20.0,19.0,28.0,1
665,BA:8C:B9:54:50:24,3855438,491800638,4960,6197200,3850478,485603438,7,9998,1768552,9976,1765057,22,3495,2361,18,5486,44,7,77,229410.0,130000.0,-48.0,-35.0,-43.0,-46.0,-46.0,-35.0,-43.0,-46.0,-89.0,-90.0,-87.0,-88.0,41.0,55.0,44.0,42.0,1
666,62:47:05:9D:EB:15,3857545,497925612,7067,12322174,3850478,485603438,1,7550,3918238,7499,3910442,51,7796,3591,0,7148,56,1,127,216660.0,130000.0,-43.0,-45.0,-35.0,-48.0,-43.0,-46.0,-37.0,-48.0,-89.0,-90.0,-87.0,-88.0,46.0,45.0,52.0,40.0,1
667,92:69:1D:31:68:E9,3854661,489308947,4183,3705509,3850478,485603438,1,5725,1229639,5545,1188671,180,40968,2318,12,4454,104,1,66,216660.0,130000.0,-52.0,-47.0,-44.0,-47.0,-51.0,-47.0,-43.0,-48.0,-89.0,-90.0,-87.0,-88.0,37.0,43.0,43.0,41.0,1
668,CC:2F:71:3F:1F:24,5170482,2018052835,1320004,1532449397,3850478,485603438,2222,1114462,1284749794,1113586,1284643676,876,106118,1078628,15,1318140,124239,2219,849,130000.0,39000.0,-74.0,-73.0,-70.0,-77.0,-74.0,-73.0,-70.0,-77.0,-89.0,-90.0,-87.0,-88.0,15.0,17.0,17.0,11.0,1
669,CC:2F:71:3E:C5:1F,3851503,485728717,1025,125279,3850478,485603438,3,4484,373713,3738,285155,746,88558,1085,14,1474,30,3,54,130000.0,39000.0,-72.0,-70.0,-68.0,-60.0,-72.0,-73.0,-70.0,-61.0,-89.0,-90.0,-87.0,-88.0,17.0,20.0,19.0,28.0,1
670,BA:8C:B9:54:50:24,3855440,491800840,4960,6197200,3850480,485603640,7,9998,1768552,9976,1765057,22,3495,2361,18,5486,44,7,77,229410.0,130000.0,-48.0,-35.0,-43.0,-46.0,-46.0,-35.0,-43.0,-46.0,-89.0,-90.0,-87.0,-88.0,41.0,55.0,44.0,42.0,1
671,62:47:05:9D:EB:15,3857553,497926586,7067,12322174,3850486,485604412,1,7550,3918238,7499,3910442,51,7796,3591,0,7148,56,1,127,216660.0,130000.0,-43.0,-45.0,-35.0,-48.0,-43.0,-46.0,-37.0,-48.0,-89.0,-90.0,-87.0,-88.0,46.0,45.0,52.0,40.0,1
672,92:69:1D:31:68:E9,3854669,489309921,4183,3705509,3850486,485604412,1,5725,1229639,5545,1188671,180,40968,2318,12,4454,104,1,66,216660.0,130000.0,-52.0,-47.0,-44.0,-47.0,-51.0,-47.0,-43.0,-48.0,-89.0,-90.0,-87.0,-88.0,37.0,43.0,43.0,41.0,1
673,CC:2F:71:3F:1F:24,5170693,2018301958,1320205,1532697344,3850488,485604614,2222,1114651,1284991870,1113775,1284885752,876,106118,1078808,15,1318341,124247,2219,849,130000.0,43333.0,-75.0,-73.0,-70.0,-77.0,-75.0,-73.0,-70.0,-77.0,-89.0,-90.0,-87.0,-88.0,14.0,17.0,17.0,11.0,1
674,CC:2F:71:3E:C5:1F,3851513,485729893,1025,125279,3850488,485604614,3,4484,373713,3738,285155,746,88558,1085,14,1474,30,3,54,130000.0,39000.0,-72.0,-70.0,-68.0,-60.0,-72.0,-73.0,-70.0,-61.0,-89.0,-90.0,-87.0,-88.0,17.0,20.0,19.0,28.0,1
675,BA:8C:B9:54:50:24,3855449,491801874,4960,6197200,3850489,485604674,7,9998,1768552,9976,1765057,22,3495,2361,18,5486,44,7,77,229410.0,130000.0,-48.0,-35.0,-43.0,-46.0,-46.0,-35.0,-43.0,-46.0,-89.0,-90.0,-87.0,-88.0,41.0,55.0,44.0,42.0,1
676,62:47:05:9D:EB:15,3857556,497926848,7067,12322174,3850489,485604674,1,7550,3918238,7499,3910442,51,7796,3591,0,7148,56,1,127,216660.0,130000.0,-43.0,-45.0,-35.0,-48.0,-43.0,-46.0,-37.0,-48.0,-89.0,-90.0,-87.0,-88.0,46.0,45.0,52.0,40.0,1
677,92:69:1D:31:68:E9,3854672,489310183,4183,3705509,3850489,485604674,1,5725,1229639,5545,1188671,180,40968,2318,12,4454,104,1,66,216660.0,130000.0,-52.0,-47.0,-44.0,-47.0,-51.0,-47.0,-43.0,-48.0,-89.0,-90.0,-87.0,-88.0,37.0,43.0,43.0,41.0,1
678,CC:2F:71:3F:1F:24,5170883,2018542940,1320394,1532938266,3850489,485604674,2222,1114826,1285228978,1113950,1285122860,876,106118,1078974,15,1318528,124266,2219,850,130000.0,43333.0,-75.0,-73.0,-70.0,-77.0,-74.0,-73.0,-70.0,-77.0,-89.0,-90.0,-87.0,-88.0,14.0,17.0,17.0,11.0,1
679,CC:2F:71:3E:C5:1F,3851516,485730155,1025,125279,3850491,485604876,3,4484,373713,3738,285155,746,88558,1085,14,1474,30,3,54,130000.0,39000.0,-72.0,-70.0,-68.0,-60.0,-72.0,-73.0,-70.0,-61.0,-89.0,-90.0,-87.0,-88.0,17.0,20.0,19.0,28.0,1
680,BA:8C:B9:54:50:24,3855451,491802076,4960,6197200,3850491,485604876,7,9998,1768552,9976,1765057,22,3495,2361,18,5486,44,7,77,229410.0,130000.0,-48.0,-35.0,-43.0,-46.0,-46.0,-35.0,-43.0,-46.0,-89.0,-90.0,-87.0,-88.0,41.0,55.0,44.0,42.0,1
681,62:47:05:9D:EB:15,3857564,497927656,7067,12322174,3850497,485605482,1,7550,3918238,7499,3910442,51,7796,3591,0,7148,56,1,127,216660.0,130000.0,-43.0,-45.0,-35.0,-48.0,-43.0,-46.0,-37.0,-48.0,-89.0,-90.0,-87.0,-88.0,46.0,45.0,52.0,40.0,1
682,92:69:1D:31:68:E9,3854680,489310991,4183,3705509,3850497,485605482,1,5725,1229639,5545,1188671,180,40968,2318,12,4454,104,1,66,216660.0,130000.0,-52.0,-47.0,-44.0,-47.0,-51.0,-47.0,-43.0,-48.0,-89.0,-90.0,-87.0,-88.0,37.0,43.0,43.0,41.0,1
683,CC:2F:71:3F:1F:24,5171080,2018782046,1320583,1533176564,3850497,485605482,2222,1115001,1285463230,1114125,1285357112,876,106118,1079143,15,1318719,124267,2219,851,130000.0,43333.0,-72.0,-70.0,-67.0,-74.0,-71.0,-69.0,-66.0,-73.0,-89.0,-90.0,-87.0,-88.0,17.0,20.0,20.0,14.0,1
684,CC:2F:71:3E:C5:1F,3851522,485730761,1025,125279,3850497,485605482,3,4484,373713,3738,285155,746,88558,1085,14,1474,30,3,54,130000.0,39000.0,-72.0,-70.0,-68.0,-60.0,-72.0,-73.0,-70.0,-61.0,-89.0,-90.0,-87.0,-88.0,17.0,20.0,19.0,28.0,1
685,BA:8C:B9:54:50:24,3855457,491802682,4960,6197200,3850497,485605482,7,9998,1768552,9976,1765057,22,3495,2361,18,5486,44,7,77,229410.0,130000.0,-48.0,-35.0,-43.0,-46.0,-46.0,-35.0,-43.0,-46.0,-89.0,-90.0,-87.0,-88.0,41.0,55.0,44.0,42.0,1
686,62:47:05:9D:EB:15,3857565,497927716,7067,12322174,3850498,485605542,1,7550,3918238,7499,3910442,51,7796,3591,0,7148,56,1,127,216660.0,130000.0,-43.0,-45.0,-35.0,-48.0,-43.0,-46.0,-37.0,-48.0,-89.0,-90.0,-87.0,-88.0,46.0,45.0,52.0,40.0,1
687,92:69:1D:31:68:E9,3854681,489311051,4183,3705509,3850498,485605542,1,5725,1229639,5545,1188671,180,40968,2318,12,4454,104,1,66,216660.0,130000.0,-52.0,-47.0,-44.0,-47.0,-51.0,-47.0,-43.0,-48.0,-89.0,-90.0,-87.0,-88.0,37.0,43.0,43.0,41.0,1
688,CC:2F:71:3F:1F:24,5171274,2019024970,1320774,1533419226,3850500,485605744,2222,1115173,1285695606,1114297,1285589488,876,106118,1079311,15,1318909,124276,2219,851,144444.0,43333.0,-71.0,-70.0,-67.0,-73.0,-71.0,-70.0,-66.0,-73.0,-89.0,-90.0,-87.0,-88.0,18.0,20.0,20.0,15.0,1
689,CC:2F:71:3E:C5:1F,3851527,485731225,1025,125279,3850502,485605946,3,4484,373713,3738,285155,746,88558,1085,14,1474,30,3,54,130000.0,39000.0,-72.0,-70.0,-68.0,-60.0,-72.0,-73.0,-70.0,-61.0,-89.0,-90.0,-87.0,-88.0,17.0,20.0,19.0,28.0,1
690,BA:8C:B9:54:50:24,3855462,491803146,4960,6197200,3850502,485605946,7,9998,1768552,9976,1765057,22,3495,2361,18,5486,44,7,77,229410.0,130000.0,-48.0,-35.0,-43.0,-46.0,-46.0,-35.0,-43.0,-46.0,-89.0,-90.0,-87.0,-88.0,41.0,55.0,44.0,42.0,1
691,62:47:05:9D:EB:15,3857574,497929791,7068,12323441,3850506,485606350,1,7553,3918494,7502,3910698,51,7796,3592,0,7149,56,1,127,216660.0,130000.0,-43.0,-46.0,-35.0,-47.0,-43.0,-46.0,-36.0,-47.0,-89.0,-90.0,-87.0,-88.0,46.0,44.0,52.0,41.0,1
692,92:69:1D:31:68:E9,3854689,489311859,4183,3705509,3850506,485606350,1,5725,1229639,5545,1188671,180,40968,2318,12,4454,104,1,66,216660.0,130000.0,-52.0,-47.0,-44.0,-47.0,-51.0,-47.0,-43.0,-48.0,-89.0,-90.0,-87.0,-88.0,37.0,43.0,43.0,41.0,1
693,CC:2F:71:3F:1F:24,5171484,2019281201,1320978,1533674851,3850506,485606350,2222,1115362,1285943275,1114486,1285837157,876,106118,1079495,15,1319114,124308,2219,851,144444.0,43333.0,-72.0,-70.0,-67.0,-74.0,-71.0,-70.0,-67.0,-73.0,-89.0,-90.0,-87.0,-88.0,17.0,20.0,20.0,14.0,1
694,CC:2F:71:3E:C5:1F,3851531,485731629,1025,125279,3850506,485606350,3,4484,373713,3738,285155,746,88558,1085,14,1474,30,3,54,130000.0,39000.0,-72.0,-70.0,-68.0,-60.0,-72.0,-73.0,-70.0,-61.0,-89.0,-90.0,-87.0,-88.0,17.0,20.0,19.0,28.0,1
695,BA:8C:B9:54:50:24,3855466,491803550,4960,6197200,3850506,485606350,7,9998,1768552,9976,1765057,22,3495,2361,18,5486,44,7,77,229410.0,130000.0,-48.0,-35.0,-43.0,-46.0,-46.0,-35.0,-43.0,-46.0,-89.0,-90.0,-87.0,-88.0,41.0,55.0,44.0,42.0,1
696,62:47:05:9D:EB:15,3857574,497929791,7068,12323441,3850506,485606350,1,7554,3918562,7503,3910766,51,7796,3592,0,7149,56,1,127,216660.0,130000.0,-43.0,-52.0,-48.0,-45.0,-43.0,-47.0,-38.0,-47.0,-89.0,-90.0,-87.0,-88.0,46.0,38.0,39.0,43.0,1
697,92:69:1D:31:68:E9,3854693,489312263,4183,3705509,3850510,485606754,1,5725,1229639,5545,1188671,180,40968,2318,12,4454,104,1,66,216660.0,130000.0,-52.0,-47.0,-44.0,-47.0,-51.0,-47.0,-43.0,-48.0,-89.0,-90.0,-87.0,-88.0,37.0,43.0,43.0,41.0,1
698,CC:2F:71:3F:1F:24,5171684,2019532149,1321174,1533925395,3850510,485606754,2222,1115540,1286182043,1114664,1286075925,876,106118,1079671,15,1319310,124317,2219,851,130000.0,43333.0,-75.0,-73.0,-70.0,-77.0,-74.0,-72.0,-69.0,-76.0,-89.0,-90.0,-87.0,-88.0,14.0,17.0,17.0,11.0,1
699,CC:2F:71:3E:C5:1F,3851535,485732033,1025,125279,3850510,485606754,3,4484,373713,3738,285155,746,88558,1085,14,1474,30,3,54,130000.0,39000.0,-72.0,-70.0,-68.0,-60.0,-72.0,-73.0,-70.0,-61.0,-89.0,-90.0,-87.0,-88.0,17.0,20.0,19.0,28.0,1
700,BA:8C:B9:54:50:24,3855471,491804014,4960,6197200,3850511,485606814,7,9998,1768552,9976,1765057,22,3495,2361,18,5486,44,7,77,229410.0,130000.0,-48.0,-35.0,-43.0,-46.0,-46.0,-35.0,-43.0,-46.0,-89.0,-90.0,-87.0,-88.0,41.0,55.0,44.0,42.0,1
701,62:47:05:9D:EB:15,3857583,497930659,7068,12323441,3850515,485607218,1,7554,3918562,7503,3910766,51,7796,3592,0,7149,56,1,127,216660.0,130000.0,-43.0,-52.0,-48.0,-45.0,-43.0,-47.0,-38.0,-47.0,-89.0,-90.0,-87.0,-88.0,46.0,38.0,39.0,43.0,1
702,92:69:1D:31:68:E9,3854698,489312727,4183,3705509,3850515,485607218,1,5725,1229639,5545,1188671,180,40968,2318,12,4454,104,1,66,216660.0,130000.0,-52.0,-47.0,-44.0,-47.0,-51.0,-47.0,-43.0,-48.0,-89.0,-90.0,-87.0,-88.0,37.0,43.0,43.0,41.0,1
703,CC:2F:71:3F:1F:24,5171884,2019777373,1321369,1534170155,3850515,485607218,2222,1115720,1286421351,1114844,1286315233,876,106118,1079841,15,1319505,124319,2219,851,130000.0,43333.0,-75.0,-73.0,-70.0,-77.0,-74.0,-73.0,-69.0,-77.0,-89.0,-90.0,-87.0,-88.0,14.0,17.0,17.0,11.0,1
704,CC:2F:71:3E:C5:1F,3851541,485732613,1026,125395,3850515,485607218,3,4486,373853,3740,285295,746,88558,1085,14,1475,30,3,54,130000.0,39000.0,-72.0,-72.0,-69.0,-60.0,-73.0,-73.0,-69.0,-61.0,-89.0,-90.0,-87.0,-88.0,17.0,18.0,18.0,28.0,1
705,BA:8C:B9:54:50:24,3855476,491804534,4961,6197316,3850515,485607218,7,10000,1768688,9978,1765193,22,3495,2361,18,5487,44,7,77,229410.0,130000.0,-40.0,-36.0,-45.0,-51.0,-46.0,-35.0,-43.0,-46.0,-89.0,-90.0,-87.0,-88.0,49.0,54.0,42.0,37.0,1
706,62:47:05:9D:EB:15,3857588,497931179,7069,12323557,3850519,485607622,1,7555,3918630,7504,3910834,51,7796,3592,0,7150,56,1,127,216660.0,130000.0,-43.0,-46.0,-36.0,-48.0,-43.0,-47.0,-38.0,-47.0,-89.0,-90.0,-87.0,-88.0,46.0,44.0,51.0,40.0,1
707,92:69:1D:31:68:E9,3854703,489313247,4184,3705625,3850519,485607622,1,5727,1229775,5547,1188807,180,40968,2318,12,4455,104,1,66,216660.0,130000.0,-52.0,-48.0,-45.0,-50.0,-52.0,-47.0,-43.0,-48.0,-89.0,-90.0,-87.0,-88.0,37.0,42.0,42.0,38.0,1
708,CC:2F:71:3F:1F:24,5172078,2020018885,1321559,1534411263,3850519,485607622,2222,1115891,1286652271,1115015,1286546153,876,106118,1080009,15,1319695,124319,2219,852,144444.0,43333.0,-75.0,-73.0,-70.0,-78.0,-75.0,-73.0,-70.0,-77.0,-89.0,-90.0,-87.0,-88.0,14.0,17.0,17.0,10.0,1
709,CC:2F:71:3E:C5:1F,3851545,485733017,1026,125395,3850519,485607622,3,4486,373853,3740,285295,746,88558,1085,14,1475,30,3,54,130000.0,39000.0,-72.0,-72.0,-69.0,-60.0,-73.0,-73.0,-69.0,-61.0,-89.0,-90.0,-87.0,-88.0,17.0,18.0,18.0,28.0,1
710,BA:8C:B9:54:50:24,3855480,491804938,4961,6197316,3850519,485607622,7,10000,1768688,9978,1765193,22,3495,2361,18,5487,44,7,77,229410.0,130000.0,-40.0,-36.0,-45.0,-51.0,-46.0,-35.0,-43.0,-46.0,-89.0,-90.0,-87.0,-88.0,49.0,54.0,42.0,37.0,1
711,62:47:05:9D:EB:15,3857593,497931643,7069,12323557,3850524,485608086,1,7556,3918698,7505,3910902,51,7796,3592,0,7150,56,1,127,216660.0,130000.0,-43.0,-46.0,-36.0,-48.0,-43.0,-47.0,-38.0,-47.0,-89.0,-90.0,-87.0,-88.0,46.0,44.0,51.0,40.0,1
712,92:69:1D:31:68:E9,3854708,489313711,4184,3705625,3850524,485608086,1,5727,1229775,5547,1188807,180,40968,2318,12,4455,104,1,66,216660.0,130000.0,-52.0,-48.0,-45.0,-50.0,-52.0,-47.0,-43.0,-48.0,-89.0,-90.0,-87.0,-88.0,37.0,42.0,42.0,38.0,1
713,CC:2F:71:3F:1F:24,5172290,2020267120,1321766,1534659034,3850524,485608086,2222,1116081,1286889333,1115205,1286783215,876,106118,1080194,15,1319902,124324,2219,852,144444.0,43333.0,-75.0,-73.0,-70.0,-78.0,-75.0,-73.0,-70.0,-77.0,-89.0,-90.0,-87.0,-88.0,14.0,17.0,17.0,10.0,1
714,CC:2F:71:3E:C5:1F,3851550,485733481,1026,125395,3850524,485608086,3,4486,373853,3740,285295,746,88558,1085,14,1475,30,3,54,130000.0,39000.0,-72.0,-72.0,-69.0,-60.0,-73.0,-73.0,-69.0,-61.0,-89.0,-90.0,-87.0,-88.0,17.0,18.0,18.0,28.0,1
715,BA:8C:B9:54:50:24,3855485,491805402,4961,6197316,3850524,485608086,7,10001,1768756,9979,1765261,22,3495,2361,18,5487,44,7,77,229410.0,130000.0,-40.0,-37.0,-45.0,-52.0,-45.0,-35.0,-44.0,-47.0,-89.0,-90.0,-87.0,-88.0,49.0,53.0,42.0,36.0,1
716,62:47:05:9D:EB:15,3857597,497932047,7069,12323557,3850528,485608490,1,7556,3918698,7505,3910902,51,7796,3592,0,7150,56,1,127,216660.0,130000.0,-43.0,-46.0,-36.0,-48.0,-43.0,-47.0,-38.0,-47.0,-89.0,-90.0,-87.0,-88.0,46.0,44.0,51.0,40.0,1
717,92:69:1D:31:68:E9,3854712,489314115,4184,3705625,3850528,485608490,1,5727,1229775,5547,1188807,180,40968,2318,12,4455,104,1,66,216660.0,130000.0,-52.0,-48.0,-45.0,-50.0,-52.0,-47.0,-43.0,-48.0,-89.0,-90.0,-87.0,-88.0,37.0,42.0,42.0,38.0,1
718,CC:2F:71:3F:1F:24,5172487,2020514886,1321959,1534906396,3850528,485608490,2222,1116257,1287126695,1115381,1287020577,876,106118,1080366,15,1320095,124330,2219,854,144444.0,43333.0,-72.0,-70.0,-66.0,-74.0,-71.0,-69.0,-66.0,-74.0,-89.0,-90.0,-87.0,-88.0,17.0,20.0,21.0,14.0,1
719,CC:2F:71:3E:C5:1F,3851556,485734095,1026,125395,3850530,485608700,3,4486,373853,3740,285295,746,88558,1085,14,1475,30,3,54,130000.0,39000.0,-72.0,-72.0,-69.0,-60.0,-73.0,-73.0,-69.0,-61.0,-89.0,-90.0,-87.0,-88.0,17.0,18.0,18.0,28.0,1
720,BA:8C:B9:54:50:24,3855492,491806289,4961,6197316,3850531,485608973,7,10001,1768756,9979,1765261,22,3495,2361,18,5487,44,7,77,229410.0,130000.0,-40.0,-37.0,-45.0,-52.0,-45.0,-35.0,-44.0,-47.0,-89.0,-90.0,-87.0,-88.0,49.0,53.0,42.0,36.0,1
721,62:47:05:9D:EB:15,3857604,497932934,7069,12323557,3850535,485609377,1,7556,3918698,7505,3910902,51,7796,3592,0,7150,56,1,127,216660.0,130000.0,-43.0,-46.0,-36.0,-48.0,-43.0,-47.0,-38.0,-47.0,-89.0,-90.0,-87.0,-88.0,46.0,44.0,51.0,40.0,1
722,92:69:1D:31:68:E9,3854719,489315002,4184,3705625,3850535,485609377,1,5727,1229775,5547,1188807,180,40968,2318,12,4455,104,1,66,216660.0,130000.0,-52.0,-48.0,-45.0,-50.0,-52.0,-47.0,-43.0,-48.0,-89.0,-90.0,-87.0,-88.0,37.0,42.0,42.0,38.0,1
723,CC:2F:71:3F:1F:24,5172687,2020760287,1322152,1535150910,3850535,485609377,2222,1116430,1287357811,1115554,1287251693,876,106118,1080535,15,1320286,124334,2219,854,144444.0,43333.0,-71.0,-70.0,-67.0,-74.0,-71.0,-70.0,-67.0,-73.0,-89.0,-90.0,-87.0,-88.0,18.0,20.0,20.0,14.0,1
724,CC:2F:71:3E:C5:1F,3851562,485734832,1026,125395,3850536,485609437,3,4486,373853,3740,285295,746,88558,1085,14,1475,30,3,54,130000.0,39000.0,-72.0,-72.0,-69.0,-60.0,-73.0,-73.0,-69.0,-61.0,-89.0,-90.0,-87.0,-88.0,17.0,18.0,18.0,28.0,1
725,BA:8C:B9:54:50:24,3855497,491806753,4961,6197316,3850536,485609437,7,10001,1768756,9979,1765261,22,3495,2361,18,5487,44,7,77,229410.0,130000.0,-40.0,-37.0,-45.0,-52.0,-45.0,-35.0,-44.0,-47.0,-89.0,-90.0,-87.0,-88.0,49.0,53.0,42.0,36.0,1
726,62:47:05:9D:EB:15,3857609,497933398,7069,12323557,3850540,485609841,1,7556,3918698,7505,3910902,51,7796,3592,0,7150,56,1,127,216660.0,130000.0,-43.0,-46.0,-36.0,-48.0,-43.0,-47.0,-38.0,-47.0,-89.0,-90.0,-87.0,-88.0,46.0,44.0,51.0,40.0,1
727,92:69:1D:31:68:E9,3854724,489315466,4184,3705625,3850540,485609841,1,5727,1229775,5547,1188807,180,40968,2318,12,4455,104,1,66,216660.0,130000.0,-52.0,-48.0,-45.0,-50.0,-52.0,-47.0,-43.0,-48.0,-89.0,-90.0,-87.0,-88.0,37.0,42.0,42.0,38.0,1
728,CC:2F:71:3F:1F:24,5172880,2020998919,1322340,1535389078,3850540,485609841,2222,1116604,1287593323,1115728,1287487205,876,106118,1080703,15,1320476,124336,2219,854,144444.0,43333.0,-71.0,-70.0,-66.0,-74.0,-71.0,-69.0,-66.0,-73.0,-89.0,-90.0,-87.0,-88.0,18.0,20.0,21.0,14.0,1
729,CC:2F:71:3E:C5:1F,3851568,485735438,1026,125395,3850542,485610043,3,4486,373853,3740,285295,746,88558,1085,14,1475,30,3,54,130000.0,39000.0,-72.0,-72.0,-69.0,-60.0,-73.0,-73.0,-69.0,-61.0,-89.0,-90.0,-87.0,-88.0,17.0,18.0,18.0,28.0,1
730,BA:8C:B9:54:50:24,3855503,491807359,4961,6197316,3850542,485610043,7,10001,1768756,9979,1765261,22,3495,2361,18,5487,44,7,77,229410.0,130000.0,-40.0,-37.0,-45.0,-52.0,-45.0,-35.0,-44.0,-47.0,-89.0,-90.0,-87.0,-88.0,49.0,53.0,42.0,36.0,1
731,62:47:05:9D:EB:15,3857614,497933864,7069,12323557,3850545,485610307,1,7556,3918698,7505,3910902,51,7796,3592,0,7150,56,1,127,216660.0,130000.0,-43.0,-46.0,-36.0,-48.0,-43.0,-47.0,-38.0,-47.0,-89.0,-90.0,-87.0,-88.0,46.0,44.0,51.0,40.0,1
732,92:69:1D:31:68:E9,3854729,489315932,4184,3705625,3850545,485610307,1,5727,1229775,5547,1188807,180,40968,2318,12,4455,104,1,66,216660.0,130000.0,-52.0,-48.0,-45.0,-50.0,-52.0,-47.0,-43.0,-48.0,-89.0,-90.0,-87.0,-88.0,37.0,42.0,42.0,38.0,1
733,CC:2F:71:3F:1F:24,5173085,2021250218,1322540,1535639911,3850545,485610307,2222,1116789,1287832098,1115912,1287725862,877,106236,1080882,15,1320676,124341,2219,854,144444.0,43333.0,-71.0,-70.0,-67.0,-74.0,-71.0,-69.0,-66.0,-73.0,-89.0,-90.0,-87.0,-88.0,18.0,20.0,20.0,14.0,1
734,CC:2F:71:3E:C5:1F,3851571,485735702,1026,125395,3850545,485610307,3,4486,373853,3740,285295,746,88558,1085,14,1475,30,3,54,130000.0,39000.0,-72.0,-72.0,-69.0,-60.0,-73.0,-73.0,-69.0,-61.0,-89.0,-90.0,-87.0,-88.0,17.0,18.0,18.0,28.0,1
735,BA:8C:B9:54:50:24,3855506,491807623,4961,6197316,3850545,485610307,7,10001,1768756,9979,1765261,22,3495,2361,18,5487,44,7,77,229410.0,130000.0,-40.0,-37.0,-45.0,-52.0,-45.0,-35.0,-44.0,-47.0,-89.0,-90.0,-87.0,-88.0,49.0,53.0,42.0,36.0,1
736,62:47:05:9D:EB:15,3857619,497934328,7069,12323557,3850550,485610771,1,7556,3918698,7505,3910902,51,7796,3592,0,7150,56,1,127,216660.0,130000.0,-43.0,-46.0,-36.0,-48.0,-43.0,-47.0,-38.0,-47.0,-89.0,-90.0,-87.0,-88.0,46.0,44.0,51.0,40.0,1
737,92:69:1D:31:68:E9,3854736,489316598,4184,3705625,3850552,485610973,1,5727,1229775,5547,1188807,180,40968,2318,12,4455,104,1,66,216660.0,130000.0,-52.0,-48.0,-45.0,-50.0,-52.0,-47.0,-43.0,-48.0,-89.0,-90.0,-87.0,-88.0,37.0,42.0,42.0,38.0,1
738,CC:2F:71:3F:1F:24,5173288,2021498608,1322736,1535887635,3850552,485610973,2222,1116970,1288075536,1116093,1287969300,877,106236,1081058,15,1320872,124350,2219,854,144444.0,43333.0,-71.0,-70.0,-67.0,-73.0,-71.0,-69.0,-67.0,-73.0,-89.0,-90.0,-87.0,-88.0,18.0,20.0,20.0,15.0,1
739,CC:2F:71:3E:C5:1F,3851578,485736368,1026,125395,3850552,485610973,3,4486,373853,3740,285295,746,88558,1085,14,1475,30,3,54,130000.0,39000.0,-72.0,-72.0,-69.0,-60.0,-73.0,-73.0,-69.0,-61.0,-89.0,-90.0,-87.0,-88.0,17.0,18.0,18.0,28.0,1
740,BA:8C:B9:54:50:24,3855513,491808289,4961,6197316,3850552,485610973,7,10001,1768756,9979,1765261,22,3495,2361,18,5487,44,7,77,229410.0,130000.0,-40.0,-37.0,-45.0,-52.0,-45.0,-35.0,-44.0,-47.0,-89.0,-90.0,-87.0,-88.0,49.0,53.0,42.0,36.0,1
741,62:47:05:9D:EB:15,3857623,497934732,7069,12323557,3850554,485611175,1,7556,3918698,7505,3910902,51,7796,3592,0,7150,56,1,127,216660.0,130000.0,-43.0,-46.0,-36.0,-48.0,-43.0,-47.0,-38.0,-47.0,-89.0,-90.0,-87.0,-88.0,46.0,44.0,51.0,40.0,1
742,92:69:1D:31:68:E9,3854738,489316800,4184,3705625,3850554,485611175,1,5727,1229775,5547,1188807,180,40968,2318,12,4455,104,1,66,216660.0,130000.0,-52.0,-48.0,-45.0,-50.0,-52.0,-47.0,-43.0,-48.0,-89.0,-90.0,-87.0,-88.0,37.0,42.0,42.0,38.0,1
743,CC:2F:71:3F:1F:24,5173484,2021746234,1322929,1536134997,3850555,485611237,2222,1117150,1288316226,1116273,1288209990,877,106236,1081231,15,1321065,124358,2219,854,144444.0,43333.0,-72.0,-70.0,-67.0,-73.0,-71.0,-69.0,-66.0,-73.0,-89.0,-90.0,-87.0,-88.0,17.0,20.0,20.0,15.0,1
744,CC:2F:71:3E:C5:1F,3851581,485736632,1026,125395,3850555,485611237,3,4488,374041,3741,285365,747,88676,1086,14,1475,30,3,54,130000.0,39000.0,-72.0,-72.0,-69.0,-60.0,-73.0,-73.0,-69.0,-61.0,-89.0,-90.0,-87.0,-88.0,17.0,18.0,18.0,28.0,1
745,BA:8C:B9:54:50:24,3855516,491808553,4961,6197316,3850555,485611237,7,10001,1768756,9979,1765261,22,3495,2361,18,5487,44,7,77,229410.0,130000.0,-40.0,-37.0,-45.0,-52.0,-45.0,-35.0,-44.0,-47.0,-89.0,-90.0,-87.0,-88.0,49.0,53.0,42.0,36.0,1
746,62:47:05:9D:EB:15,3857630,497935400,7069,12323557,3850561,485611843,1,7556,3918698,7505,3910902,51,7796,3592,0,7150,56,1,127,216660.0,130000.0,-43.0,-46.0,-36.0,-48.0,-43.0,-47.0,-38.0,-47.0,-89.0,-90.0,-87.0,-88.0,46.0,44.0,51.0,40.0,1
747,92:69:1D:31:68:E9,3854745,489317468,4184,3705625,3850561,485611843,1,5727,1229775,5547,1188807,180,40968,2318,12,4455,104,1,66,216660.0,130000.0,-52.0,-48.0,-45.0,-50.0,-52.0,-47.0,-43.0,-48.0,-89.0,-90.0,-87.0,-88.0,37.0,42.0,42.0,38.0,1
748,CC:2F:71:3F:1F:24,5173686,2021991457,1323125,1536379614,3850561,485611843,2222,1117331,1288548775,1116454,1288442539,877,106236,1081407,15,1321261,124369,2219,854,144444.0,43333.0,-72.0,-70.0,-69.0,-74.0,-71.0,-69.0,-67.0,-73.0,-89.0,-90.0,-87.0,-88.0,17.0,20.0,18.0,14.0,1
749,CC:2F:71:3E:C5:1F,3851588,485737298,1026,125395,3850562,485611903,3,4488,374041,3741,285365,747,88676,1086,14,1475,30,3,54,130000.0,39000.0,-72.0,-72.0,-69.0,-60.0,-73.0,-73.0,-69.0,-61.0,-89.0,-90.0,-87.0,-88.0,17.0,18.0,18.0,28.0,1
750,BA:8C:B9:54:50:24,3855523,491809219,4961,6197316,3850562,485611903,7,10001,1768756,9979,1765261,22,3495,2361,18,5487,44,7,77,229410.0,130000.0,-40.0,-37.0,-45.0,-52.0,-45.0,-35.0,-44.0,-47.0,-89.0,-90.0,-87.0,-88.0,49.0,53.0,42.0,36.0,1
751,62:47:05:9D:EB:15,3857633,497935662,7069,12323557,3850564,485612105,1,7556,3918698,7505,3910902,51,7796,3592,0,7150,56,1,127,216660.0,130000.0,-43.0,-46.0,-36.0,-48.0,-43.0,-47.0,-38.0,-47.0,-89.0,-90.0,-87.0,-88.0,46.0,44.0,51.0,40.0,1
752,92:69:1D:31:68:E9,3854748,489317730,4184,3705625,3850564,485612105,1,5727,1229775,5547,1188807,180,40968,2318,12,4455,104,1,66,216660.0,130000.0,-52.0,-48.0,-45.0,-50.0,-52.0,-47.0,-43.0,-48.0,-89.0,-90.0,-87.0,-88.0,37.0,42.0,42.0,38.0,1
753,CC:2F:71:3F:1F:24,5173879,2022232995,1323315,1536620890,3850564,485612105,2222,1117504,1288779871,1116627,1288673635,877,106236,1081577,15,1321451,124384,2219,855,144444.0,43333.0,-72.0,-70.0,-67.0,-74.0,-71.0,-70.0,-67.0,-73.0,-89.0,-90.0,-87.0,-88.0,17.0,20.0,20.0,14.0,1
754,CC:2F:71:3E:C5:1F,3851590,485737500,1026,125395,3850564,485612105,3,4488,374041,3741,285365,747,88676,1086,14,1475,30,3,54,130000.0,39000.0,-72.0,-72.0,-69.0,-60.0,-73.0,-73.0,-69.0,-61.0,-89.0,-90.0,-87.0,-88.0,17.0,18.0,18.0,28.0,1
755,BA:8C:B9:54:50:24,3855527,491809623,4961,6197316,3850566,485612307,7,10001,1768756,9979,1765261,22,3495,2361,18,5487,44,7,77,229410.0,130000.0,-40.0,-37.0,-45.0,-52.0,-45.0,-35.0,-44.0,-47.0,-89.0,-90.0,-87.0,-88.0,49.0,53.0,42.0,36.0,1
756,62:47:05:9D:EB:15,3857639,497936268,7069,12323557,3850570,485612711,1,7556,3918698,7505,3910902,51,7796,3592,0,7150,56,1,127,216660.0,130000.0,-43.0,-46.0,-36.0,-48.0,-43.0,-47.0,-38.0,-47.0,-89.0,-90.0,-87.0,-88.0,46.0,44.0,51.0,40.0,1
757,92:69:1D:31:68:E9,3854754,489318336,4184,3705625,3850570,485612711,1,5727,1229775,5547,1188807,180,40968,2318,12,4455,104,1,66,216660.0,130000.0,-52.0,-48.0,-45.0,-50.0,-52.0,-47.0,-43.0,-48.0,-89.0,-90.0,-87.0,-88.0,37.0,42.0,42.0,38.0,1
758,CC:2F:71:3F:1F:24,5174074,2022471899,1323504,1536859188,3850570,485612711,2222,1117678,1289012649,1116801,1288906413,877,106236,1081744,15,1321640,124387,2219,855,144444.0,43333.0,-71.0,-70.0,-67.0,-74.0,-71.0,-70.0,-67.0,-73.0,-89.0,-90.0,-87.0,-88.0,18.0,20.0,20.0,14.0,1
759,CC:2F:71:3E:C5:1F,3851596,485738106,1026,125395,3850570,485612711,3,4488,374041,3741,285365,747,88676,1086,14,1475,30,3,54,130000.0,39000.0,-72.0,-72.0,-69.0,-60.0,-73.0,-73.0,-69.0,-61.0,-89.0,-90.0,-87.0,-88.0,17.0,18.0,18.0,28.0,1
760,BA:8C:B9:54:50:24,3855531,491810027,4961,6197316,3850570,485612711,7,10001,1768756,9979,1765261,22,3495,2361,18,5487,44,7,77,229410.0,130000.0,-40.0,-37.0,-45.0,-52.0,-45.0,-35.0,-44.0,-47.0,-89.0,-90.0,-87.0,-88.0,49.0,53.0,42.0,36.0,1
761,62:47:05:9D:EB:15,3857642,497936530,7069,12323557,3850573,485612973,1,7556,3918698,7505,3910902,51,7796,3592,0,7150,56,1,127,216660.0,130000.0,-43.0,-46.0,-36.0,-48.0,-43.0,-47.0,-38.0,-47.0,-89.0,-90.0,-87.0,-88.0,46.0,44.0,51.0,40.0,1
762,92:69:1D:31:68:E9,3854757,489318598,4184,3705625,3850573,485612973,1,5727,1229775,5547,1188807,180,40968,2318,12,4455,104,1,66,216660.0,130000.0,-52.0,-48.0,-45.0,-50.0,-52.0,-47.0,-43.0,-48.0,-89.0,-90.0,-87.0,-88.0,37.0,42.0,42.0,38.0,1
763,CC:2F:71:3F:1F:24,5174267,2022713437,1323694,1537100464,3850573,485612973,2222,1117852,1289246695,1116975,1289140459,877,106236,1081913,15,1321830,124397,2219,855,144444.0,43333.0,-72.0,-70.0,-67.0,-74.0,-71.0,-70.0,-66.0,-73.0,-89.0,-90.0,-87.0,-88.0,17.0,20.0,20.0,14.0,1
764,CC:2F:71:3E:C5:1F,3851601,485738570,1026,125395,3850575,485613175,3,4488,374041,3741,285365,747,88676,1086,14,1475,30,3,54,130000.0,39000.0,-72.0,-72.0,-69.0,-60.0,-73.0,-73.0,-69.0,-61.0,-89.0,-90.0,-87.0,-88.0,17.0,18.0,18.0,28.0,1
765,BA:8C:B9:54:50:24,3855536,491810491,4961,6197316,3850575,485613175,7,10001,1768756,9979,1765261,22,3495,2361,18,5487,44,7,77,229410.0,130000.0,-40.0,-37.0,-45.0,-52.0,-45.0,-35.0,-44.0,-47.0,-89.0,-90.0,-87.0,-88.0,49.0,53.0,42.0,36.0,1
766,62:47:05:9D:EB:15,3857648,497937136,7069,12323557,3850579,485613579,1,7556,3918698,7505,3910902,51,7796,3592,0,7150,56,1,127,216660.0,130000.0,-43.0,-46.0,-36.0,-48.0,-43.0,-47.0,-38.0,-47.0,-89.0,-90.0,-87.0,-88.0,46.0,44.0,51.0,40.0,1
767,92:69:1D:31:68:E9,3854763,489319204,4184,3705625,3850579,485613579,1,5727,1229775,5547,1188807,180,40968,2318,12,4455,104,1,66,216660.0,130000.0,-52.0,-48.0,-45.0,-50.0,-52.0,-47.0,-43.0,-48.0,-89.0,-90.0,-87.0,-88.0,37.0,42.0,42.0,38.0,1
768,CC:2F:71:3F:1F:24,5174474,2022962158,1323895,1537348579,3850579,485613579,2222,1118034,1289482147,1117157,1289375911,877,106236,1082091,15,1322031,124412,2219,855,144444.0,43333.0,-72.0,-70.0,-67.0,-74.0,-72.0,-70.0,-66.0,-74.0,-89.0,-90.0,-87.0,-88.0,17.0,20.0,20.0,14.0,1
769,CC:2F:71:3E:C5:1F,3851605,485738974,1026,125395,3850579,485613579,3,4488,374041,3741,285365,747,88676,1086,14,1475,30,3,54,130000.0,39000.0,-72.0,-72.0,-69.0,-60.0,-73.0,-73.0,-69.0,-61.0,-89.0,-90.0,-87.0,-88.0,17.0,18.0,18.0,28.0,1
770,BA:8C:B9:54:50:24,3855540,491810895,4961,6197316,3850579,485613579,7,10002,1768824,9980,1765329,22,3495,2361,18,5488,44,7,77,229410.0,130000.0,-40.0,-37.0,-46.0,-52.0,-44.0,-36.0,-44.0,-48.0,-89.0,-90.0,-87.0,-88.0,49.0,53.0,41.0,36.0,1
771,62:47:05:9D:EB:15,3857650,497937338,7069,12323557,3850581,485613781,1,7558,3918834,7507,3911038,51,7796,3592,0,7151,56,1,127,216660.0,130000.0,-43.0,-45.0,-35.0,-47.0,-43.0,-47.0,-37.0,-47.0,-89.0,-90.0,-87.0,-88.0,46.0,45.0,52.0,41.0,1
772,92:69:1D:31:68:E9,3854767,489319608,4184,3705625,3850583,485613983,1,5729,1229911,5549,1188943,180,40968,2318,12,4456,104,1,66,216660.0,130000.0,-52.0,-47.0,-42.0,-48.0,-52.0,-47.0,-43.0,-48.0,-89.0,-90.0,-87.0,-88.0,37.0,43.0,45.0,40.0,1
773,CC:2F:71:3F:1F:24,5174670,2023204468,1324087,1537590485,3850583,485613983,2222,1118206,1289711667,1117329,1289605431,877,106236,1082262,15,1322223,124453,2219,855,144444.0,43333.0,-72.0,-70.0,-67.0,-74.0,-71.0,-70.0,-67.0,-73.0,-89.0,-90.0,-87.0,-88.0,17.0,20.0,20.0,14.0,1
774,CC:2F:71:3E:C5:1F,3851610,485739438,1026,125395,3850584,485614043,3,4488,374041,3741,285365,747,88676,1086,14,1475,30,3,54,130000.0,39000.0,-72.0,-72.0,-69.0,-60.0,-73.0,-73.0,-69.0,-61.0,-89.0,-90.0,-87.0,-88.0,17.0,18.0,18.0,28.0,1
775,BA:8C:B9:54:50:24,3855545,491811359,4961,6197316,3850584,485614043,7,10003,1768892,9981,1765397,22,3495,2361,18,5488,44,7,77,229410.0,130000.0,-40.0,-37.0,-46.0,-52.0,-44.0,-35.0,-44.0,-48.0,-89.0,-90.0,-87.0,-88.0,49.0,53.0,41.0,36.0,1
776,62:47:05:9D:EB:15,3857657,497938004,7069,12323557,3850588,485614447,1,7558,3918834,7507,3911038,51,7796,3592,0,7151,56,1,127,216660.0,130000.0,-43.0,-45.0,-35.0,-47.0,-43.0,-47.0,-37.0,-47.0,-89.0,-90.0,-87.0,-88.0,46.0,45.0,52.0,41.0,1
777,92:69:1D:31:68:E9,3854772,489320072,4184,3705625,3850588,485614447,1,5729,1229911,5549,1188943,180,40968,2318,12,4456,104,1,66,216660.0,130000.0,-52.0,-47.0,-42.0,-48.0,-52.0,-47.0,-43.0,-48.0,-89.0,-90.0,-87.0,-88.0,37.0,43.0,45.0,40.0,1
778,CC:2F:71:3F:1F:24,5174865,2023446208,1324277,1537831761,3850588,485614447,2222,1118384,1289949177,1117507,1289842941,877,106236,1082431,15,1322413,124467,2219,855,144444.0,43333.0,-71.0,-70.0,-67.0,-74.0,-71.0,-70.0,-67.0,-73.0,-89.0,-90.0,-87.0,-88.0,18.0,20.0,20.0,14.0,1
779,CC:2F:71:3E:C5:1F,3851614,485739842,1026,125395,3850588,485614447,3,4488,374041,3741,285365,747,88676,1086,14,1475,30,3,54,130000.0,39000.0,-72.0,-72.0,-69.0,-60.0,-73.0,-73.0,-69.0,-61.0,-89.0,-90.0,-87.0,-88.0,17.0,18.0,18.0,28.0,1
780,BA:8C:B9:54:50:24,3855549,491811763,4961,6197316,3850588,485614447,7,10003,1768892,9981,1765397,22,3495,2361,18,5488,44,7,77,229410.0,130000.0,-40.0,-37.0,-46.0,-52.0,-44.0,-35.0,-44.0,-48.0,-89.0,-90.0,-87.0,-88.0,49.0,53.0,41.0,36.0,1
781,62:47:05:9D:EB:15,3857662,497938681,7069,12323557,3850593,485615124,1,7558,3918834,7507,3911038,51,7796,3592,0,7151,56,1,127,216660.0,130000.0,-43.0,-45.0,-35.0,-47.0,-43.0,-47.0,-37.0,-47.0,-89.0,-90.0,-87.0,-88.0,46.0,45.0,52.0,41.0,1
782,92:69:1D:31:68:E9,3854777,489320749,4184,3705625,3850593,485615124,1,5729,1229911,5549,1188943,180,40968,2318,12,4456,104,1,66,216660.0,130000.0,-52.0,-47.0,-42.0,-48.0,-52.0,-47.0,-43.0,-48.0,-89.0,-90.0,-87.0,-88.0,37.0,43.0,45.0,40.0,1
783,CC:2F:71:3F:1F:24,5175062,2023688421,1324469,1538073297,3850593,485615124,2222,1118557,1290180231,1117680,1290073995,877,106236,1082601,15,1322605,124517,2219,855,144444.0,43333.0,-71.0,-70.0,-66.0,-74.0,-71.0,-69.0,-66.0,-74.0,-89.0,-90.0,-87.0,-88.0,18.0,20.0,21.0,14.0,1
784,CC:2F:71:3E:C5:1F,3851619,485740519,1026,125395,3850593,485615124,3,4488,374041,3741,285365,747,88676,1086,14,1475,30,3,54,130000.0,39000.0,-72.0,-72.0,-69.0,-60.0,-73.0,-73.0,-69.0,-61.0,-89.0,-90.0,-87.0,-88.0,17.0,18.0,18.0,28.0,1
785,BA:8C:B9:54:50:24,3855554,491812440,4961,6197316,3850593,485615124,7,10003,1768892,9981,1765397,22,3495,2361,18,5488,44,7,77,229410.0,130000.0,-40.0,-37.0,-46.0,-52.0,-44.0,-35.0,-44.0,-48.0,-89.0,-90.0,-87.0,-88.0,49.0,53.0,41.0,36.0,1
786,62:47:05:9D:EB:15,3857667,497939145,7069,12323557,3850598,485615588,1,7558,3918834,7507,3911038,51,7796,3592,0,7151,56,1,127,216660.0,130000.0,-43.0,-45.0,-35.0,-47.0,-43.0,-47.0,-37.0,-47.0,-89.0,-90.0,-87.0,-88.0,46.0,45.0,52.0,41.0,1
787,92:69:1D:31:68:E9,3854782,489321213,4184,3705625,3850598,485615588,1,5729,1229911,5549,1188943,180,40968,2318,12,4456,104,1,66,216660.0,130000.0,-52.0,-47.0,-42.0,-48.0,-52.0,-47.0,-43.0,-48.0,-89.0,-90.0,-87.0,-88.0,37.0,43.0,45.0,40.0,1
788,CC:2F:71:3F:1F:24,5175266,2023933892,1324668,1538318304,3850598,485615588,2222,1118742,1290420568,1117865,1290314332,877,106236,1082778,15,1322804,124532,2219,855,144444.0,43333.0,-72.0,-70.0,-66.0,-74.0,-71.0,-69.0,-66.0,-73.0,-89.0,-90.0,-87.0,-88.0,17.0,20.0,21.0,14.0,1
789,CC:2F:71:3E:C5:1F,3851624,485740983,1026,125395,3850598,485615588,3,4488,374041,3741,285365,747,88676,1086,14,1475,30,3,54,130000.0,39000.0,-72.0,-72.0,-69.0,-60.0,-73.0,-73.0,-69.0,-61.0,-89.0,-90.0,-87.0,-88.0,17.0,18.0,18.0,28.0,1
790,BA:8C:B9:54:50:24,3855559,491812904,4961,6197316,3850598,485615588,7,10003,1768892,9981,1765397,22,3495,2361,18,5488,44,7,77,229410.0,130000.0,-40.0,-37.0,-46.0,-52.0,-44.0,-35.0,-44.0,-48.0,-89.0,-90.0,-87.0,-88.0,49.0,53.0,41.0,36.0,1
791,62:47:05:9D:EB:15,3857671,497939549,7069,12323557,3850602,485615992,1,7558,3918834,7507,3911038,51,7796,3592,0,7151,56,1,127,216660.0,130000.0,-43.0,-45.0,-35.0,-47.0,-43.0,-47.0,-37.0,-47.0,-89.0,-90.0,-87.0,-88.0,46.0,45.0,52.0,41.0,1
792,92:69:1D:31:68:E9,3854786,489321617,4184,3705625,3850602,485615992,1,5729,1229911,5549,1188943,180,40968,2318,12,4456,104,1,66,216660.0,130000.0,-52.0,-47.0,-42.0,-48.0,-52.0,-47.0,-43.0,-48.0,-89.0,-90.0,-87.0,-88.0,37.0,43.0,45.0,40.0,1
793,CC:2F:71:3F:1F:24,5175461,2024175702,1324859,1538559710,3850602,485615992,2222,1118914,1290645782,1118037,1290539546,877,106236,1082949,15,1322995,124544,2219,855,144444.0,43333.0,-71.0,-69.0,-67.0,-74.0,-71.0,-69.0,-66.0,-73.0,-89.0,-90.0,-87.0,-88.0,18.0,21.0,20.0,14.0,1
794,CC:2F:71:3E:C5:1F,3851628,485741387,1026,125395,3850602,485615992,3,4488,374041,3741,285365,747,88676,1086,14,1475,30,3,54,130000.0,39000.0,-72.0,-72.0,-69.0,-60.0,-73.0,-73.0,-69.0,-61.0,-89.0,-90.0,-87.0,-88.0,17.0,18.0,18.0,28.0,1
795,BA:8C:B9:54:50:24,3855563,491813308,4961,6197316,3850602,485615992,7,10003,1768892,9981,1765397,22,3495,2361,18,5488,44,7,77,229410.0,130000.0,-40.0,-37.0,-46.0,-52.0,-44.0,-35.0,-44.0,-48.0,-89.0,-90.0,-87.0,-88.0,49.0,53.0,41.0,36.0,1
796,62:47:05:9D:EB:15,3857675,497939953,7069,12323557,3850606,485616396,1,7558,3918834,7507,3911038,51,7796,3592,0,7151,56,1,127,216660.0,130000.0,-43.0,-45.0,-35.0,-47.0,-43.0,-47.0,-37.0,-47.0,-89.0,-90.0,-87.0,-88.0,46.0,45.0,52.0,41.0,1
797,92:69:1D:31:68:E9,3854790,489322021,4184,3705625,3850606,485616396,1,5729,1229911,5549,1188943,180,40968,2318,12,4456,104,1,66,216660.0,130000.0,-52.0,-47.0,-42.0,-48.0,-52.0,-47.0,-43.0,-48.0,-89.0,-90.0,-87.0,-88.0,37.0,43.0,45.0,40.0,1
798,CC:2F:71:3F:1F:24,5175660,2024423728,1325054,1538807332,3850606,485616396,2222,1119092,1290883098,1118215,1290776862,877,106236,1083125,15,1323190,124600,2219,855,144444.0,43333.0,-71.0,-70.0,-66.0,-74.0,-70.0,-69.0,-66.0,-73.0,-89.0,-90.0,-87.0,-88.0,18.0,20.0,21.0,14.0,1
799,CC:2F:71:3E:C5:1F,3851633,485741851,1026,125395,3850607,485616456,3,4488,374041,3741,285365,747,88676,1086,14,1475,30,3,54,130000.0,39000.0,-72.0,-72.0,-69.0,-60.0,-73.0,-73.0,-69.0,-61.0,-89.0,-90.0,-87.0,-88.0,17.0,18.0,18.0,28.0,1
800,BA:8C:B9:54:50:24,3855568,491813772,4961,6197316,3850607,485616456,7,10003,1768892,9981,1765397,22,3495,2361,18,5488,44,7,77,229410.0,130000.0,-40.0,-37.0,-46.0,-52.0,-44.0,-35.0,-44.0,-48.0,-89.0,-90.0,-87.0,-88.0,49.0,53.0,41.0,36.0,1
801,62:47:05:9D:EB:15,3857680,497940417,7069,12323557,3850611,485616860,1,7558,3918834,7507,3911038,51,7796,3592,0,7151,56,1,127,216660.0,130000.0,-43.0,-45.0,-35.0,-47.0,-43.0,-47.0,-37.0,-47.0,-89.0,-90.0,-87.0,-88.0,46.0,45.0,52.0,41.0,1
802,92:69:1D:31:68:E9,3854795,489322485,4184,3705625,3850611,485616860,1,5729,1229911,5549,1188943,180,40968,2318,12,4456,104,1,66,216660.0,130000.0,-52.0,-47.0,-42.0,-48.0,-52.0,-47.0,-43.0,-48.0,-89.0,-90.0,-87.0,-88.0,37.0,43.0,45.0,40.0,1
803,CC:2F:71:3F:1F:24,5176077,2024922283,1325466,1539305423,3850611,485616860,2222,1119364,1291129544,1118487,1291023308,877,106236,1083396,15,1323602,124721,2219,855,144444.0,43333.0,-71.0,-70.0,-66.0,-73.0,-71.0,-69.0,-66.0,-73.0,-89.0,-90.0,-87.0,-88.0,18.0,20.0,21.0,15.0,1
804,CC:2F:71:3E:C5:1F,3851637,485742255,1026,125395,3850611,485616860,3,4488,374041,3741,285365,747,88676,1086,14,1475,30,3,54,130000.0,39000.0,-72.0,-72.0,-69.0,-60.0,-73.0,-73.0,-69.0,-61.0,-89.0,-90.0,-87.0,-88.0,17.0,18.0,18.0,28.0,1
805,BA:8C:B9:54:50:24,3855572,491814176,4961,6197316,3850611,485616860,7,10003,1768892,9981,1765397,22,3495,2361,18,5488,44,7,77,229410.0,130000.0,-40.0,-37.0,-46.0,-52.0,-44.0,-35.0,-44.0,-48.0,-89.0,-90.0,-87.0,-88.0,49.0,53.0,41.0,36.0,1
806,62:47:05:9D:EB:15,3857684,497940821,7069,12323557,3850615,485617264,1,7558,3918834,7507,3911038,51,7796,3592,0,7151,56,1,127,216660.0,130000.0,-43.0,-45.0,-35.0,-47.0,-43.0,-47.0,-37.0,-47.0,-89.0,-90.0,-87.0,-88.0,46.0,45.0,52.0,41.0,1
807,92:69:1D:31:68:E9,3854799,489322889,4184,3705625,3850615,485617264,1,5729,1229911,5549,1188943,180,40968,2318,12,4456,104,1,66,216660.0,130000.0,-52.0,-47.0,-42.0,-48.0,-52.0,-47.0,-43.0,-48.0,-89.0,-90.0,-87.0,-88.0,37.0,43.0,45.0,40.0,1
808,CC:2F:71:3F:1F:24,5176466,2025409861,1325851,1539792597,3850615,485617264,2222,1119627,1291369281,1118750,1291263045,877,106236,1083659,15,1323987,124837,2219,855,144444.0,43333.0,-71.0,-69.0,-66.0,-73.0,-71.0,-69.0,-66.0,-73.0,-89.0,-90.0,-87.0,-88.0,18.0,21.0,21.0,15.0,1
809,CC:2F:71:3E:C5:1F,3851641,485742659,1026,125395,3850615,485617264,3,4488,374041,3741,285365,747,88676,1086,14,1475,30,3,54,130000.0,39000.0,-72.0,-72.0,-69.0,-60.0,-73.0,-73.0,-69.0,-61.0,-89.0,-90.0,-87.0,-88.0,17.0,18.0,18.0,28.0,1
810,BA:8C:B9:54:50:24,3855576,491814580,4961,6197316,3850615,485617264,7,10003,1768892,9981,1765397,22,3495,2361,18,5488,44,7,77,229410.0,130000.0,-40.0,-37.0,-46.0,-52.0,-44.0,-35.0,-44.0,-48.0,-89.0,-90.0,-87.0,-88.0,49.0,53.0,41.0,36.0,1
811,62:47:05:9D:EB:15,3857689,497941285,7069,12323557,3850620,485617728,1,7558,3918834,7507,3911038,51,7796,3592,0,7151,56,1,127,216660.0,130000.0,-43.0,-45.0,-35.0,-47.0,-43.0,-47.0,-37.0,-47.0,-89.0,-90.0,-87.0,-88.0,46.0,45.0,52.0,41.0,1
812,92:69:1D:31:68:E9,3854804,489323353,4184,3705625,3850620,485617728,1,5730,1229979,5550,1189011,180,40968,2318,12,4456,104,1,66,216660.0,130000.0,-51.0,-47.0,-45.0,-47.0,-51.0,-47.0,-43.0,-48.0,-89.0,-90.0,-87.0,-88.0,38.0,43.0,42.0,41.0,1
813,CC:2F:71:3F:1F:24,5176663,2025654709,1326043,1540036981,3850620,485617728,2222,1119801,1291604737,1118924,1291498501,877,106236,1083829,15,1324179,124871,2219,855,144444.0,43333.0,-71.0,-70.0,-67.0,-74.0,-71.0,-69.0,-66.0,-73.0,-89.0,-90.0,-87.0,-88.0,18.0,20.0,20.0,14.0,1
814,CC:2F:71:3E:C5:1F,3851646,485743123,1026,125395,3850620,485617728,3,4488,374041,3741,285365,747,88676,1086,14,1475,30,3,54,130000.0,39000.0,-72.0,-72.0,-69.0,-60.0,-73.0,-73.0,-69.0,-61.0,-89.0,-90.0,-87.0,-88.0,17.0,18.0,18.0,28.0,1
815,BA:8C:B9:54:50:24,3855583,491815246,4961,6197316,3850622,485617930,7,10003,1768892,9981,1765397,22,3495,2361,18,5488,44,7,77,229410.0,130000.0,-40.0,-37.0,-46.0,-52.0,-44.0,-35.0,-44.0,-48.0,-89.0,-90.0,-87.0,-88.0,49.0,53.0,41.0,36.0,1
816,62:47:05:9D:EB:15,3857694,497942296,7070,12324164,3850624,485618132,1,7560,3918970,7509,3911174,51,7796,3592,0,7152,56,1,127,216660.0,130000.0,-43.0,-45.0,-35.0,-47.0,-43.0,-47.0,-38.0,-46.0,-89.0,-90.0,-87.0,-88.0,46.0,45.0,52.0,41.0,1
817,92:69:1D:31:68:E9,3854808,489323757,4184,3705625,3850624,485618132,1,5730,1229979,5550,1189011,180,40968,2318,12,4456,104,1,66,216660.0,130000.0,-51.0,-47.0,-45.0,-47.0,-51.0,-47.0,-43.0,-48.0,-89.0,-90.0,-87.0,-88.0,38.0,43.0,42.0,41.0,1
818,CC:2F:71:3F:1F:24,5176863,2025902993,1326239,1540284861,3850624,485618132,2222,1119981,1291846653,1119104,1291740417,877,106236,1084001,15,1324375,124896,2219,855,144444.0,43333.0,-72.0,-70.0,-67.0,-73.0,-71.0,-69.0,-67.0,-73.0,-89.0,-90.0,-87.0,-88.0,17.0,20.0,20.0,15.0,1
819,CC:2F:71:3E:C5:1F,3851652,485743729,1026,125395,3850626,485618334,3,4488,374041,3741,285365,747,88676,1086,14,1475,30,3,54,130000.0,39000.0,-72.0,-72.0,-69.0,-60.0,-73.0,-73.0,-69.0,-61.0,-89.0,-90.0,-87.0,-88.0,17.0,18.0,18.0,28.0,1
820,BA:8C:B9:54:50:24,3855587,491815650,4961,6197316,3850626,485618334,7,10003,1768892,9981,1765397,22,3495,2361,18,5488,44,7,77,229410.0,130000.0,-40.0,-37.0,-46.0,-52.0,-44.0,-35.0,-44.0,-48.0,-89.0,-90.0,-87.0,-88.0,49.0,53.0,41.0,36.0,1
821,62:47:05:9D:EB:15,3857698,497942700,7070,12324164,3850628,485618536,1,7560,3918970,7509,3911174,51,7796,3592,0,7152,56,1,127,216660.0,130000.0,-43.0,-45.0,-35.0,-47.0,-43.0,-47.0,-38.0,-46.0,-89.0,-90.0,-87.0,-88.0,46.0,45.0,52.0,41.0,1
822,92:69:1D:31:68:E9,3854814,489324363,4184,3705625,3850630,485618738,1,5730,1229979,5550,1189011,180,40968,2318,12,4456,104,1,66,216660.0,130000.0,-51.0,-47.0,-45.0,-47.0,-51.0,-47.0,-43.0,-48.0,-89.0,-90.0,-87.0,-88.0,38.0,43.0,42.0,41.0,1
823,CC:2F:71:3F:1F:24,5177066,2026154259,1326435,1540535461,3850631,485618798,2222,1120165,1292093471,1119288,1291987235,877,106236,1084178,15,1324571,124923,2219,855,144444.0,43333.0,-71.0,-70.0,-67.0,-74.0,-71.0,-70.0,-66.0,-73.0,-89.0,-90.0,-87.0,-88.0,18.0,20.0,20.0,14.0,1
824,CC:2F:71:3E:C5:1F,3851657,485744193,1026,125395,3850631,485618798,3,4488,374041,3741,285365,747,88676,1086,14,1475,30,3,54,130000.0,39000.0,-72.0,-72.0,-69.0,-60.0,-73.0,-73.0,-69.0,-61.0,-89.0,-90.0,-87.0,-88.0,17.0,18.0,18.0,28.0,1
825,BA:8C:B9:54:50:24,3855594,491816316,4961,6197316,3850633,485619000,7,10003,1768892,9981,1765397,22,3495,2361,18,5488,44,7,77,229410.0,130000.0,-40.0,-37.0,-46.0,-52.0,-44.0,-35.0,-44.0,-48.0,-89.0,-90.0,-87.0,-88.0,49.0,53.0,41.0,36.0,1
826,62:47:05:9D:EB:15,3857704,497943280,7071,12324280,3850633,485619000,1,7561,3919038,7510,3911242,51,7796,3592,0,7153,56,1,127,216660.0,130000.0,-43.0,-45.0,-35.0,-47.0,-43.0,-47.0,-38.0,-46.0,-89.0,-90.0,-87.0,-88.0,46.0,45.0,52.0,41.0,1
827,92:69:1D:31:68:E9,3854820,489324943,4185,3705741,3850635,485619202,1,5732,1230115,5552,1189147,180,40968,2318,12,4457,104,1,66,216660.0,130000.0,-52.0,-47.0,-42.0,-48.0,-51.0,-47.0,-43.0,-47.0,-89.0,-90.0,-87.0,-88.0,37.0,43.0,45.0,40.0,1
828,CC:2F:71:3F:1F:24,5177444,2026619758,1326809,1541000556,3850635,485619202,2222,1120428,1292344148,1119551,1292237912,877,106236,1084438,15,1324945,124991,2219,855,144444.0,43333.0,-71.0,-70.0,-68.0,-74.0,-71.0,-70.0,-67.0,-73.0,-89.0,-90.0,-87.0,-88.0,18.0,20.0,19.0,14.0,1
829,CC:2F:71:3E:C5:1F,3851662,485744713,1027,125511,3850635,485619202,3,4490,374181,3743,285505,747,88676,1086,14,1476,30,3,54,130000.0,39000.0,-73.0,-72.0,-70.0,-60.0,-73.0,-72.0,-69.0,-61.0,-89.0,-90.0,-87.0,-88.0,16.0,18.0,17.0,28.0,1
830,BA:8C:B9:54:50:24,3855599,491816836,4962,6197432,3850637,485619404,7,10005,1769028,9983,1765533,22,3495,2361,18,5489,44,7,77,229410.0,130000.0,-48.0,-35.0,-43.0,-45.0,-43.0,-36.0,-44.0,-49.0,-89.0,-90.0,-87.0,-88.0,41.0,55.0,44.0,43.0,1
831,62:47:05:9D:EB:15,3857710,497943886,7071,12324280,3850639,485619606,1,7562,3919106,7511,3911310,51,7796,3592,0,7153,56,1,127,216660.0,130000.0,-44.0,-50.0,-49.0,-47.0,-43.0,-46.0,-38.0,-47.0,-89.0,-90.0,-87.0,-88.0,45.0,40.0,38.0,41.0,1
832,92:69:1D:31:68:E9,3854824,489325347,4185,3705741,3850639,485619606,1,5732,1230115,5552,1189147,180,40968,2318,12,4457,104,1,66,216660.0,130000.0,-52.0,-47.0,-42.0,-48.0,-51.0,-47.0,-43.0,-47.0,-89.0,-90.0,-87.0,-88.0,37.0,43.0,45.0,40.0,1
833,CC:2F:71:3F:1F:24,5178021,2027353551,1327382,1541733945,3850639,485619606,2222,1120766,1292599809,1119889,1292493573,877,106236,1084772,15,1325518,125102,2219,855,130000.0,43333.0,-71.0,-70.0,-67.0,-74.0,-71.0,-70.0,-67.0,-74.0,-89.0,-90.0,-87.0,-88.0,18.0,20.0,20.0,14.0,1
834,CC:2F:71:3E:C5:1F,3851666,485745117,1027,125511,3850639,485619606,3,4490,374181,3743,285505,747,88676,1086,14,1476,30,3,54,130000.0,39000.0,-73.0,-72.0,-70.0,-60.0,-73.0,-72.0,-69.0,-61.0,-89.0,-90.0,-87.0,-88.0,16.0,18.0,17.0,28.0,1
835,BA:8C:B9:54:50:24,3855601,491817038,4962,6197432,3850639,485619606,7,10005,1769028,9983,1765533,22,3495,2361,18,5489,44,7,77,229410.0,130000.0,-48.0,-35.0,-43.0,-45.0,-43.0,-36.0,-44.0,-49.0,-89.0,-90.0,-87.0,-88.0,41.0,55.0,44.0,43.0,1
836,62:47:05:9D:EB:15,3857716,497944476,7071,12324280,3850645,485620196,1,7562,3919106,7511,3911310,51,7796,3592,0,7153,56,1,127,216660.0,130000.0,-44.0,-50.0,-49.0,-47.0,-43.0,-46.0,-38.0,-47.0,-89.0,-90.0,-87.0,-88.0,45.0,40.0,38.0,41.0,1
837,92:69:1D:31:68:E9,3854830,489325937,4185,3705741,3850645,485620196,1,5732,1230115,5552,1189147,180,40968,2318,12,4457,104,1,66,216660.0,130000.0,-52.0,-47.0,-42.0,-48.0,-51.0,-47.0,-43.0,-47.0,-89.0,-90.0,-87.0,-88.0,37.0,43.0,45.0,40.0,1
838,CC:2F:71:3F:1F:24,5178665,2028130043,1328018,1542509645,3850647,485620398,2222,1121164,1292870724,1120287,1292764488,877,106236,1085161,15,1326154,125103,2219,855,130000.0,43333.0,-71.0,-70.0,-68.0,-74.0,-71.0,-70.0,-67.0,-73.0,-89.0,-90.0,-87.0,-88.0,18.0,20.0,19.0,14.0,1
839,CC:2F:71:3E:C5:1F,3851674,485745909,1027,125511,3850647,485620398,3,4490,374181,3743,285505,747,88676,1086,14,1476,30,3,54,130000.0,39000.0,-73.0,-72.0,-70.0,-60.0,-73.0,-72.0,-69.0,-61.0,-89.0,-90.0,-87.0,-88.0,16.0,18.0,17.0,28.0,1
840,BA:8C:B9:54:50:24,3855609,491817830,4962,6197432,3850647,485620398,7,10005,1769028,9983,1765533,22,3495,2361,18,5489,44,7,77,229410.0,130000.0,-48.0,-35.0,-43.0,-45.0,-43.0,-36.0,-44.0,-49.0,-89.0,-90.0,-87.0,-88.0,41.0,55.0,44.0,43.0,1
841,62:47:05:9D:EB:15,3857720,497944880,7071,12324280,3850649,485620600,1,7562,3919106,7511,3911310,51,7796,3592,0,7153,56,1,127,216660.0,130000.0,-44.0,-50.0,-49.0,-47.0,-43.0,-46.0,-38.0,-47.0,-89.0,-90.0,-87.0,-88.0,45.0,40.0,38.0,41.0,1
842,92:69:1D:31:68:E9,3854834,489326341,4185,3705741,3850649,485620600,1,5732,1230115,5552,1189147,180,40968,2318,12,4457,104,1,66,216660.0,130000.0,-52.0,-47.0,-42.0,-48.0,-51.0,-47.0,-43.0,-47.0,-89.0,-90.0,-87.0,-88.0,37.0,43.0,45.0,40.0,1
843,CC:2F:71:3F:1F:24,5178861,2028373496,1328211,1542752623,3850650,485620873,2222,1121337,1293103216,1120460,1292996980,877,106236,1085330,15,1326347,125111,2219,855,144444.0,39000.0,-72.0,-70.0,-67.0,-74.0,-71.0,-70.0,-66.0,-74.0,-89.0,-90.0,-87.0,-88.0,17.0,20.0,20.0,14.0,1
844,CC:2F:71:3E:C5:1F,3851677,485746384,1027,125511,3850650,485620873,3,4490,374181,3743,285505,747,88676,1086,14,1476,30,3,54,130000.0,39000.0,-73.0,-72.0,-70.0,-60.0,-73.0,-72.0,-69.0,-61.0,-89.0,-90.0,-87.0,-88.0,16.0,18.0,17.0,28.0,1
845,BA:8C:B9:54:50:24,3855614,491818507,4962,6197432,3850652,485621075,7,10005,1769028,9983,1765533,22,3495,2361,18,5489,44,7,77,229410.0,130000.0,-48.0,-35.0,-43.0,-45.0,-43.0,-36.0,-44.0,-49.0,-89.0,-90.0,-87.0,-88.0,41.0,55.0,44.0,43.0,1
846,62:47:05:9D:EB:15,3857725,497945557,7071,12324280,3850654,485621277,1,7562,3919106,7511,3911310,51,7796,3592,0,7153,56,1,127,216660.0,130000.0,-44.0,-50.0,-49.0,-47.0,-43.0,-46.0,-38.0,-47.0,-89.0,-90.0,-87.0,-88.0,45.0,40.0,38.0,41.0,1
847,92:69:1D:31:68:E9,3854841,489327220,4185,3705741,3850656,485621479,1,5732,1230115,5552,1189147,180,40968,2318,12,4457,104,1,66,216660.0,130000.0,-52.0,-47.0,-42.0,-48.0,-51.0,-47.0,-43.0,-47.0,-89.0,-90.0,-87.0,-88.0,37.0,43.0,45.0,40.0,1
848,CC:2F:71:3F:1F:24,5179062,2028620050,1328404,1542998449,3850658,485621601,2222,1121510,1293332806,1120632,1293226452,878,106354,1085503,15,1326540,125119,2219,855,130000.0,43333.0,-71.0,-70.0,-66.0,-72.0,-71.0,-70.0,-66.0,-72.0,-89.0,-90.0,-87.0,-88.0,18.0,20.0,21.0,16.0,1
849,CC:2F:71:3E:C5:1F,3851685,485747112,1027,125511,3850658,485621601,3,4490,374181,3743,285505,747,88676,1086,14,1476,30,3,54,130000.0,39000.0,-73.0,-72.0,-70.0,-60.0,-73.0,-72.0,-69.0,-61.0,-89.0,-90.0,-87.0,-88.0,16.0,18.0,17.0,28.0,1
850,BA:8C:B9:54:50:24,3855620,491819033,4962,6197432,3850658,485621601,7,10005,1769028,9983,1765533,22,3495,2361,18,5489,44,7,77,229410.0,130000.0,-48.0,-35.0,-43.0,-45.0,-43.0,-36.0,-44.0,-49.0,-89.0,-90.0,-87.0,-88.0,41.0,55.0,44.0,43.0,1
851,62:47:05:9D:EB:15,3857731,497946083,7071,12324280,3850660,485621803,1,7562,3919106,7511,3911310,51,7796,3592,0,7153,56,1,127,216660.0,130000.0,-44.0,-50.0,-49.0,-47.0,-43.0,-46.0,-38.0,-47.0,-89.0,-90.0,-87.0,-88.0,45.0,40.0,38.0,41.0,1
852,92:69:1D:31:68:E9,3854845,489327544,4185,3705741,3850660,485621803,1,5732,1230115,5552,1189147,180,40968,2318,12,4457,104,1,66,216660.0,130000.0,-52.0,-47.0,-42.0,-48.0,-51.0,-47.0,-43.0,-47.0,-89.0,-90.0,-87.0,-88.0,37.0,43.0,45.0,40.0,1
853,CC:2F:71:3F:1F:24,5179260,2028870852,1328600,1543249049,3850660,485621803,2222,1121689,1293571732,1120811,1293465378,878,106354,1085682,15,1326736,125119,2219,855,130000.0,43333.0,-70.0,-70.0,-66.0,-74.0,-70.0,-70.0,-66.0,-73.0,-89.0,-90.0,-87.0,-88.0,19.0,20.0,21.0,14.0,1
854,CC:2F:71:3E:C5:1F,3851689,485747516,1027,125511,3850662,485622005,3,4490,374181,3743,285505,747,88676,1086,14,1476,30,3,54,130000.0,39000.0,-73.0,-72.0,-70.0,-60.0,-73.0,-72.0,-69.0,-61.0,-89.0,-90.0,-87.0,-88.0,16.0,18.0,17.0,28.0,1
855,BA:8C:B9:54:50:24,3855624,491819437,4962,6197432,3850662,485622005,7,10005,1769028,9983,1765533,22,3495,2361,18,5489,44,7,77,229410.0,130000.0,-48.0,-35.0,-43.0,-45.0,-43.0,-36.0,-44.0,-49.0,-89.0,-90.0,-87.0,-88.0,41.0,55.0,44.0,43.0,1
856,62:47:05:9D:EB:15,3857740,497947119,7071,12324280,3850669,485622839,1,7562,3919106,7511,3911310,51,7796,3592,0,7153,56,1,127,216660.0,130000.0,-44.0,-50.0,-49.0,-47.0,-43.0,-46.0,-38.0,-47.0,-89.0,-90.0,-87.0,-89.0,45.0,40.0,38.0,42.0,1
857,92:69:1D:31:68:E9,3854854,489328580,4185,3705741,3850669,485622839,1,5732,1230115,5552,1189147,180,40968,2318,12,4457,104,1,66,216660.0,130000.0,-52.0,-47.0,-42.0,-48.0,-51.0,-47.0,-43.0,-47.0,-89.0,-90.0,-87.0,-89.0,37.0,43.0,45.0,41.0,1
858,CC:2F:71:3F:1F:24,5179469,2029119649,1328800,1543496810,3850669,485622839,2222,1121867,1293799543,1120989,1293693189,878,106354,1085860,15,1326936,125133,2219,855,130000.0,43333.0,-70.0,-69.0,-67.0,-77.0,-70.0,-69.0,-67.0,-77.0,-89.0,-90.0,-87.0,-89.0,19.0,21.0,20.0,12.0,1
859,CC:2F:71:3E:C5:1F,3851696,485748350,1027,125511,3850669,485622839,3,4492,374369,3744,285575,748,88794,1087,14,1476,30,3,54,130000.0,39000.0,-72.0,-72.0,-70.0,-60.0,-72.0,-71.0,-69.0,-60.0,-89.0,-90.0,-87.0,-89.0,17.0,18.0,17.0,29.0,1
860,BA:8C:B9:54:50:24,3855631,491820271,4962,6197432,3850669,485622839,7,10005,1769028,9983,1765533,22,3495,2361,18,5489,44,7,77,229410.0,130000.0,-48.0,-35.0,-43.0,-45.0,-43.0,-36.0,-44.0,-49.0,-89.0,-90.0,-87.0,-89.0,41.0,55.0,44.0,44.0,1
861,62:47:05:9D:EB:15,3857743,497947381,7071,12324280,3850672,485623101,1,7562,3919106,7511,3911310,51,7796,3592,0,7153,56,1,127,216660.0,130000.0,-44.0,-50.0,-49.0,-47.0,-43.0,-46.0,-38.0,-47.0,-89.0,-91.0,-87.0,-89.0,45.0,41.0,38.0,42.0,1
862,92:69:1D:31:68:E9,3854857,489328842,4185,3705741,3850672,485623101,1,5732,1230115,5552,1189147,180,40968,2318,12,4457,104,1,66,216660.0,130000.0,-52.0,-47.0,-42.0,-48.0,-51.0,-47.0,-43.0,-47.0,-89.0,-91.0,-87.0,-89.0,37.0,44.0,45.0,41.0,1
863,CC:2F:71:3F:1F:24,5179664,2029361165,1328990,1543737862,3850674,485623303,2222,1122037,1294028783,1121159,1293922429,878,106354,1086030,15,1327126,125146,2219,855,130000.0,43333.0,-69.0,-70.0,-68.0,-77.0,-69.0,-70.0,-68.0,-76.0,-89.0,-91.0,-87.0,-89.0,20.0,21.0,19.0,12.0,1
864,CC:2F:71:3E:C5:1F,3851701,485748814,1027,125511,3850674,485623303,3,4492,374369,3744,285575,748,88794,1087,14,1476,30,3,54,130000.0,39000.0,-72.0,-72.0,-70.0,-60.0,-72.0,-71.0,-69.0,-60.0,-89.0,-91.0,-87.0,-89.0,17.0,19.0,17.0,29.0,1
865,BA:8C:B9:54:50:24,3855636,491820735,4962,6197432,3850674,485623303,7,10005,1769028,9983,1765533,22,3495,2361,18,5489,44,7,77,229410.0,130000.0,-48.0,-35.0,-43.0,-45.0,-43.0,-36.0,-44.0,-49.0,-89.0,-91.0,-87.0,-89.0,41.0,56.0,44.0,44.0,1
866,62:47:05:9D:EB:15,3857749,497947987,7071,12324280,3850678,485623707,1,7562,3919106,7511,3911310,51,7796,3592,0,7153,56,1,127,216660.0,130000.0,-44.0,-50.0,-49.0,-47.0,-43.0,-46.0,-38.0,-47.0,-89.0,-91.0,-87.0,-89.0,45.0,41.0,38.0,42.0,1
867,92:69:1D:31:68:E9,3854863,489329448,4185,3705741,3850678,485623707,1,5732,1230115,5552,1189147,180,40968,2318,12,4457,104,1,66,216660.0,130000.0,-52.0,-47.0,-42.0,-48.0,-51.0,-47.0,-43.0,-47.0,-89.0,-91.0,-87.0,-89.0,37.0,44.0,45.0,41.0,1
868,CC:2F:71:3F:1F:24,5179859,2029602975,1329181,1543979268,3850678,485623707,2222,1122206,1294255059,1121328,1294148705,878,106354,1086199,15,1327317,125148,2219,855,130000.0,43333.0,-70.0,-69.0,-68.0,-73.0,-70.0,-69.0,-68.0,-72.0,-89.0,-91.0,-87.0,-89.0,19.0,22.0,19.0,16.0,1
869,CC:2F:71:3E:C5:1F,3851705,485749218,1027,125511,3850678,485623707,3,4492,374369,3744,285575,748,88794,1087,14,1476,30,3,54,130000.0,39000.0,-72.0,-72.0,-70.0,-60.0,-72.0,-71.0,-69.0,-60.0,-89.0,-91.0,-87.0,-89.0,17.0,19.0,17.0,29.0,1
870,BA:8C:B9:54:50:24,3855640,491821139,4962,6197432,3850678,485623707,7,10005,1769028,9983,1765533,22,3495,2361,18,5489,44,7,77,229410.0,130000.0,-48.0,-35.0,-43.0,-45.0,-43.0,-36.0,-44.0,-49.0,-89.0,-91.0,-87.0,-89.0,41.0,56.0,44.0,44.0,1
871,62:47:05:9D:EB:15,3857753,497948391,7071,12324280,3850682,485624111,1,7562,3919106,7511,3911310,51,7796,3592,0,7153,56,1,127,216660.0,130000.0,-44.0,-50.0,-49.0,-47.0,-43.0,-46.0,-38.0,-47.0,-89.0,-91.0,-87.0,-89.0,45.0,41.0,38.0,42.0,1
872,92:69:1D:31:68:E9,3854868,489329912,4185,3705741,3850683,485624171,1,5732,1230115,5552,1189147,180,40968,2318,12,4457,104,1,66,216660.0,130000.0,-52.0,-47.0,-42.0,-48.0,-51.0,-47.0,-43.0,-47.0,-89.0,-91.0,-87.0,-89.0,37.0,44.0,45.0,41.0,1
873,CC:2F:71:3F:1F:24,5180056,2029847823,1329373,1544223652,3850683,485624171,2222,1122376,1294484299,1121498,1294377945,878,106354,1086369,15,1327509,125148,2219,855,130000.0,43333.0,-71.0,-69.0,-67.0,-72.0,-71.0,-69.0,-66.0,-72.0,-89.0,-91.0,-87.0,-89.0,18.0,22.0,20.0,17.0,1
874,CC:2F:71:3E:C5:1F,3851710,485749682,1027,125511,3850683,485624171,3,4492,374369,3744,285575,748,88794,1087,14,1476,30,3,54,130000.0,39000.0,-72.0,-72.0,-70.0,-60.0,-72.0,-71.0,-69.0,-60.0,-89.0,-91.0,-87.0,-89.0,17.0,19.0,17.0,29.0,1
875,BA:8C:B9:54:50:24,3855645,491821603,4962,6197432,3850683,485624171,7,10005,1769028,9983,1765533,22,3495,2361,18,5489,44,7,77,229410.0,130000.0,-48.0,-35.0,-43.0,-45.0,-43.0,-36.0,-44.0,-49.0,-89.0,-91.0,-87.0,-89.0,41.0,56.0,44.0,44.0,1
876,62:47:05:9D:EB:15,3857758,497948855,7071,12324280,3850687,485624575,1,7562,3919106,7511,3911310,51,7796,3592,0,7153,56,1,127,216660.0,130000.0,-44.0,-50.0,-49.0,-47.0,-43.0,-46.0,-38.0,-47.0,-89.0,-91.0,-87.0,-89.0,45.0,41.0,38.0,42.0,1
877,92:69:1D:31:68:E9,3854872,489330316,4185,3705741,3850687,485624575,1,5732,1230115,5552,1189147,180,40968,2318,12,4457,104,1,66,216660.0,130000.0,-52.0,-47.0,-42.0,-48.0,-51.0,-47.0,-43.0,-47.0,-89.0,-91.0,-87.0,-89.0,37.0,44.0,45.0,41.0,1
878,CC:2F:71:3F:1F:24,5180258,2030092922,1329571,1544468347,3850687,485624575,2222,1122556,1294716674,1121678,1294610320,878,106354,1086546,15,1327707,125148,2219,855,144444.0,43333.0,-73.0,-69.0,-67.0,-73.0,-73.0,-69.0,-67.0,-73.0,-89.0,-91.0,-87.0,-89.0,16.0,22.0,20.0,16.0,1
879,CC:2F:71:3E:C5:1F,3851714,485750086,1027,125511,3850687,485624575,3,4492,374369,3744,285575,748,88794,1087,14,1476,30,3,54,130000.0,39000.0,-72.0,-72.0,-70.0,-60.0,-72.0,-71.0,-69.0,-60.0,-89.0,-91.0,-87.0,-89.0,17.0,19.0,17.0,29.0,1
880,BA:8C:B9:54:50:24,3855649,491822007,4962,6197432,3850687,485624575,7,10005,1769028,9983,1765533,22,3495,2361,18,5489,44,7,77,229410.0,130000.0,-48.0,-35.0,-43.0,-45.0,-43.0,-36.0,-44.0,-49.0,-89.0,-91.0,-87.0,-89.0,41.0,56.0,44.0,44.0,1
881,62:47:05:9D:EB:15,3857762,497949259,7071,12324280,3850691,485624979,1,7563,3919174,7512,3911378,51,7796,3592,0,7153,56,1,127,216660.0,130000.0,-43.0,-45.0,-36.0,-48.0,-43.0,-46.0,-38.0,-47.0,-89.0,-90.0,-87.0,-89.0,46.0,45.0,51.0,41.0,1
882,92:69:1D:31:68:E9,3854876,489330720,4185,3705741,3850691,485624979,1,5732,1230115,5552,1189147,180,40968,2318,12,4457,104,1,66,216660.0,130000.0,-52.0,-47.0,-42.0,-48.0,-51.0,-47.0,-43.0,-47.0,-89.0,-90.0,-87.0,-89.0,37.0,43.0,45.0,41.0,1
883,CC:2F:71:3F:1F:24,5180455,2030337840,1329764,1544712861,3850691,485624979,2222,1122727,1294946030,1121849,1294839676,878,106354,1086717,15,1327900,125150,2219,855,144444.0,43333.0,-71.0,-69.0,-66.0,-74.0,-71.0,-68.0,-66.0,-74.0,-89.0,-90.0,-87.0,-89.0,18.0,21.0,21.0,15.0,1
884,CC:2F:71:3E:C5:1F,3851718,485750490,1027,125511,3850691,485624979,3,4492,374369,3744,285575,748,88794,1087,14,1476,30,3,54,130000.0,39000.0,-72.0,-72.0,-70.0,-60.0,-72.0,-71.0,-69.0,-60.0,-89.0,-90.0,-87.0,-89.0,17.0,18.0,17.0,29.0,1
885,BA:8C:B9:54:50:24,3855653,491822411,4962,6197432,3850691,485624979,7,10005,1769028,9983,1765533,22,3495,2361,18,5489,44,7,77,229410.0,130000.0,-48.0,-35.0,-43.0,-45.0,-43.0,-36.0,-44.0,-49.0,-89.0,-90.0,-87.0,-89.0,41.0,55.0,44.0,44.0,1
886,62:47:05:9D:EB:15,3857767,497949723,7071,12324280,3850696,485625443,1,7563,3919174,7512,3911378,51,7796,3592,0,7153,56,1,127,216660.0,130000.0,-43.0,-45.0,-36.0,-48.0,-43.0,-46.0,-38.0,-47.0,-89.0,-90.0,-87.0,-89.0,46.0,45.0,51.0,41.0,1
887,92:69:1D:31:68:E9,3854881,489331184,4185,3705741,3850696,485625443,1,5732,1230115,5552,1189147,180,40968,2318,12,4457,104,1,66,216660.0,130000.0,-52.0,-47.0,-42.0,-48.0,-51.0,-47.0,-43.0,-47.0,-89.0,-90.0,-87.0,-89.0,37.0,43.0,45.0,41.0,1
888,CC:2F:71:3F:1F:24,5180651,2030582558,1329955,1544957115,3850696,485625443,2222,1122897,1295175340,1122019,1295068986,878,106354,1086887,15,1328091,125157,2219,855,144444.0,43333.0,-70.0,-70.0,-68.0,-75.0,-70.0,-70.0,-68.0,-74.0,-89.0,-90.0,-87.0,-89.0,19.0,20.0,19.0,14.0,1
889,CC:2F:71:3E:C5:1F,3851723,485750954,1027,125511,3850696,485625443,3,4492,374369,3744,285575,748,88794,1087,14,1476,30,3,54,130000.0,39000.0,-72.0,-72.0,-70.0,-60.0,-72.0,-71.0,-69.0,-60.0,-89.0,-90.0,-87.0,-89.0,17.0,18.0,17.0,29.0,1
890,BA:8C:B9:54:50:24,3855658,491822875,4962,6197432,3850696,485625443,7,10005,1769028,9983,1765533,22,3495,2361,18,5489,44,7,77,229410.0,130000.0,-48.0,-35.0,-43.0,-45.0,-43.0,-36.0,-44.0,-49.0,-89.0,-90.0,-87.0,-89.0,41.0,55.0,44.0,44.0,1
891,62:47:05:9D:EB:15,3857771,497950127,7071,12324280,3850700,485625847,1,7563,3919174,7512,3911378,51,7796,3592,0,7153,56,1,127,216660.0,130000.0,-43.0,-45.0,-36.0,-48.0,-43.0,-46.0,-38.0,-47.0,-89.0,-90.0,-87.0,-89.0,46.0,45.0,51.0,41.0,1
892,92:69:1D:31:68:E9,3854885,489331588,4185,3705741,3850700,485625847,1,5732,1230115,5552,1189147,180,40968,2318,12,4457,104,1,66,216660.0,130000.0,-52.0,-47.0,-42.0,-48.0,-51.0,-47.0,-43.0,-47.0,-89.0,-90.0,-87.0,-89.0,37.0,43.0,45.0,41.0,1
893,CC:2F:71:3F:1F:24,5180847,2030827346,1330147,1545201499,3850700,485625847,2222,1123068,1295404696,1122190,1295298342,878,106354,1087058,15,1328283,125159,2219,855,144444.0,43333.0,-69.0,-69.0,-67.0,-75.0,-69.0,-69.0,-67.0,-74.0,-89.0,-90.0,-87.0,-89.0,20.0,21.0,20.0,14.0,1
894,CC:2F:71:3E:C5:1F,3851727,485751358,1027,125511,3850700,485625847,3,4494,374509,3746,285715,748,88794,1087,14,1477,30,3,54,130000.0,39000.0,-72.0,-72.0,-69.0,-60.0,-72.0,-71.0,-69.0,-60.0,-89.0,-90.0,-87.0,-89.0,17.0,18.0,18.0,29.0,1
895,BA:8C:B9:54:50:24,3855664,491823481,4962,6197432,3850702,485626049,7,10007,1769164,9985,1765669,22,3495,2361,18,5490,44,7,77,229410.0,130000.0,-48.0,-35.0,-42.0,-46.0,-42.0,-36.0,-44.0,-50.0,-89.0,-90.0,-87.0,-89.0,41.0,55.0,45.0,43.0,1
896,62:47:05:9D:EB:15,3857776,497950591,7071,12324280,3850705,485626311,1,7563,3919174,7512,3911378,51,7796,3592,0,7153,56,1,127,216660.0,130000.0,-43.0,-45.0,-36.0,-48.0,-43.0,-46.0,-38.0,-47.0,-89.0,-90.0,-87.0,-89.0,46.0,45.0,51.0,41.0,1
897,92:69:1D:31:68:E9,3854890,489332052,4185,3705741,3850705,485626311,1,5734,1230251,5554,1189283,180,40968,2318,12,4458,104,1,66,216660.0,130000.0,-52.0,-48.0,-45.0,-47.0,-51.0,-47.0,-43.0,-48.0,-89.0,-90.0,-87.0,-89.0,37.0,42.0,42.0,42.0,1
898,CC:2F:71:3F:1F:24,5181065,2031091853,1330360,1545465542,3850705,485626311,2222,1123259,1295651116,1122381,1295544762,878,106354,1087249,15,1328496,125164,2219,855,144444.0,43333.0,-69.0,-70.0,-66.0,-75.0,-69.0,-69.0,-66.0,-75.0,-90.0,-91.0,-87.0,-89.0,21.0,21.0,21.0,14.0,1
899,CC:2F:71:3E:C5:1F,3851732,485751822,1027,125511,3850705,485626311,3,4494,374509,3746,285715,748,88794,1087,14,1477,30,3,54,130000.0,39000.0,-72.0,-72.0,-69.0,-60.0,-72.0,-71.0,-69.0,-60.0,-90.0,-91.0,-87.0,-89.0,18.0,19.0,18.0,29.0,1
900,BA:8C:B9:54:50:24,3855669,491823945,4962,6197432,3850707,485626513,7,10008,1769232,9986,1765737,22,3495,2361,18,5490,44,7,77,229410.0,130000.0,-40.0,-37.0,-45.0,-51.0,-42.0,-36.0,-44.0,-50.0,-90.0,-91.0,-87.0,-89.0,50.0,54.0,42.0,38.0,1
901,62:47:05:9D:EB:15,3857780,497950995,7071,12324280,3850709,485626715,1,7563,3919174,7512,3911378,51,7796,3592,0,7153,56,1,127,216660.0,130000.0,-43.0,-45.0,-36.0,-48.0,-43.0,-46.0,-38.0,-47.0,-90.0,-91.0,-87.0,-89.0,47.0,46.0,51.0,41.0,1
902,92:69:1D:31:68:E9,3854900,489333355,4191,3706640,3850709,485626715,1,5741,1230960,5561,1189992,180,40968,2321,12,4464,104,1,66,216660.0,130000.0,-51.0,-47.0,-44.0,-47.0,-51.0,-48.0,-44.0,-48.0,-90.0,-91.0,-87.0,-89.0,39.0,44.0,43.0,42.0,1
903,CC:2F:71:3F:1F:24,5181262,2031336771,1330553,1545710056,3850709,485626715,2222,1123430,1295879048,1122552,1295772694,878,106354,1087420,15,1328688,125173,2219,855,144444.0,43333.0,-70.0,-69.0,-68.0,-74.0,-70.0,-68.0,-67.0,-74.0,-90.0,-91.0,-87.0,-89.0,20.0,22.0,19.0,15.0,1
904,CC:2F:71:3E:C5:1F,3851738,485752428,1027,125511,3850711,485626917,3,4494,374509,3746,285715,748,88794,1087,14,1477,30,3,54,130000.0,39000.0,-72.0,-72.0,-69.0,-60.0,-72.0,-71.0,-69.0,-60.0,-90.0,-91.0,-87.0,-89.0,18.0,19.0,18.0,29.0,1
905,BA:8C:B9:54:50:24,3855673,491824349,4962,6197432,3850711,485626917,7,10008,1769232,9986,1765737,22,3495,2361,18,5490,44,7,77,229410.0,130000.0,-40.0,-37.0,-45.0,-51.0,-42.0,-36.0,-44.0,-50.0,-90.0,-91.0,-87.0,-89.0,50.0,54.0,42.0,38.0,1
906,62:47:05:9D:EB:15,3857785,497951672,7071,12324280,3850714,485627392,1,7565,3919310,7514,3911514,51,7796,3592,0,7153,56,1,127,216660.0,130000.0,-43.0,-46.0,-36.0,-48.0,-43.0,-46.0,-38.0,-47.0,-90.0,-91.0,-87.0,-89.0,47.0,45.0,51.0,41.0,1
907,92:69:1D:31:68:E9,3854906,489334162,4192,3706770,3850714,485627392,1,5744,1231216,5564,1190248,180,40968,2322,12,4465,104,1,66,229410.0,130000.0,-52.0,-47.0,-45.0,-47.0,-51.0,-48.0,-45.0,-49.0,-90.0,-91.0,-87.0,-89.0,38.0,44.0,42.0,42.0,1
908,CC:2F:71:3F:1F:24,5181458,2031581702,1330744,1545954310,3850714,485627392,2222,1123605,1296110292,1122727,1296003938,878,106354,1087595,15,1328880,125182,2219,855,144444.0,43333.0,-69.0,-69.0,-67.0,-75.0,-69.0,-69.0,-66.0,-74.0,-90.0,-91.0,-87.0,-89.0,21.0,22.0,20.0,14.0,1
909,CC:2F:71:3E:C5:1F,3851743,485753105,1027,125511,3850716,485627594,3,4494,374509,3746,285715,748,88794,1087,14,1477,30,3,54,130000.0,39000.0,-72.0,-72.0,-69.0,-60.0,-72.0,-71.0,-69.0,-60.0,-90.0,-91.0,-87.0,-89.0,18.0,19.0,18.0,29.0,1
910,BA:8C:B9:54:50:24,3855678,491825026,4962,6197432,3850716,485627594,7,10008,1769232,9986,1765737,22,3495,2361,18,5490,44,7,77,229410.0,130000.0,-40.0,-37.0,-45.0,-51.0,-42.0,-36.0,-44.0,-50.0,-90.0,-91.0,-87.0,-89.0,50.0,54.0,42.0,38.0,1
911,62:47:05:9D:EB:15,3857790,497952136,7071,12324280,3850719,485627856,1,7565,3919310,7514,3911514,51,7796,3592,0,7153,56,1,127,216660.0,130000.0,-43.0,-46.0,-36.0,-48.0,-43.0,-46.0,-38.0,-47.0,-90.0,-91.0,-87.0,-89.0,47.0,45.0,51.0,41.0,1
912,92:69:1D:31:68:E9,3854913,489334828,4192,3706770,3850721,485628058,1,5744,1231216,5564,1190248,180,40968,2322,12,4465,104,1,66,229410.0,130000.0,-52.0,-47.0,-45.0,-47.0,-51.0,-48.0,-45.0,-49.0,-90.0,-91.0,-87.0,-89.0,38.0,44.0,42.0,42.0,1
913,CC:2F:71:3F:1F:24,5181663,2031827245,1330942,1546199187,3850721,485628058,2222,1123782,1296339425,1122904,1296233071,878,106354,1087771,15,1329078,125200,2219,855,144444.0,43333.0,-69.0,-68.0,-66.0,-74.0,-68.0,-68.0,-66.0,-74.0,-90.0,-91.0,-87.0,-89.0,21.0,23.0,21.0,15.0,1
914,CC:2F:71:3E:C5:1F,3851748,485753569,1027,125511,3850721,485628058,3,4494,374509,3746,285715,748,88794,1087,14,1477,30,3,54,130000.0,39000.0,-72.0,-72.0,-69.0,-60.0,-72.0,-71.0,-69.0,-60.0,-90.0,-91.0,-87.0,-89.0,18.0,19.0,18.0,29.0,1
915,BA:8C:B9:54:50:24,3855683,491825490,4962,6197432,3850721,485628058,7,10008,1769232,9986,1765737,22,3495,2361,18,5490,44,7,77,229410.0,130000.0,-40.0,-37.0,-45.0,-51.0,-42.0,-36.0,-44.0,-50.0,-90.0,-91.0,-87.0,-89.0,50.0,54.0,42.0,38.0,1
916,62:47:05:9D:EB:15,3857794,497952540,7071,12324280,3850723,485628260,1,7565,3919310,7514,3911514,51,7796,3592,0,7153,56,1,127,216660.0,130000.0,-43.0,-46.0,-36.0,-48.0,-43.0,-46.0,-38.0,-47.0,-90.0,-91.0,-87.0,-89.0,47.0,45.0,51.0,41.0,1
917,92:69:1D:31:68:E9,3854915,489335030,4192,3706770,3850723,485628260,1,5744,1231216,5564,1190248,180,40968,2322,12,4465,104,1,66,229410.0,130000.0,-52.0,-47.0,-45.0,-47.0,-51.0,-48.0,-45.0,-49.0,-90.0,-91.0,-87.0,-89.0,38.0,44.0,42.0,42.0,1
918,CC:2F:71:3F:1F:24,5181860,2032072179,1331135,1546443717,3850725,485628462,2222,1123954,1296568953,1123076,1296462599,878,106354,1087943,15,1329271,125229,2219,855,144444.0,43333.0,-68.0,-68.0,-66.0,-73.0,-68.0,-68.0,-65.0,-73.0,-90.0,-91.0,-87.0,-89.0,22.0,23.0,21.0,16.0,1
919,CC:2F:71:3E:C5:1F,3851752,485753973,1027,125511,3850725,485628462,3,4494,374509,3746,285715,748,88794,1087,14,1477,30,3,54,130000.0,39000.0,-72.0,-72.0,-69.0,-60.0,-72.0,-71.0,-69.0,-60.0,-90.0,-91.0,-87.0,-89.0,18.0,19.0,18.0,29.0,1
920,BA:8C:B9:54:50:24,3855687,491825894,4962,6197432,3850725,485628462,7,10008,1769232,9986,1765737,22,3495,2361,18,5490,44,7,77,229410.0,130000.0,-40.0,-37.0,-45.0,-51.0,-42.0,-36.0,-44.0,-50.0,-90.0,-91.0,-87.0,-89.0,50.0,54.0,42.0,38.0,1
921,62:47:05:9D:EB:15,3857801,497953206,7071,12324280,3850730,485628926,1,7565,3919310,7514,3911514,51,7796,3592,0,7153,56,1,127,216660.0,130000.0,-43.0,-46.0,-36.0,-48.0,-43.0,-46.0,-38.0,-47.0,-90.0,-91.0,-87.0,-89.0,47.0,45.0,51.0,41.0,1
922,92:69:1D:31:68:E9,3854922,489335696,4192,3706770,3850730,485628926,1,5744,1231216,5564,1190248,180,40968,2322,12,4465,104,1,66,229410.0,130000.0,-52.0,-47.0,-45.0,-47.0,-51.0,-48.0,-45.0,-49.0,-90.0,-91.0,-87.0,-89.0,38.0,44.0,42.0,42.0,1
923,CC:2F:71:3F:1F:24,5182063,2032326367,1331333,1546697441,3850730,485628926,2222,1124130,1296806065,1123252,1296699711,878,106354,1088118,15,1329467,125240,2219,855,144444.0,43333.0,-68.0,-68.0,-67.0,-74.0,-68.0,-68.0,-67.0,-73.0,-90.0,-91.0,-87.0,-89.0,22.0,23.0,20.0,15.0,1
924,CC:2F:71:3E:C5:1F,3851757,485754437,1027,125511,3850730,485628926,3,4494,374509,3746,285715,748,88794,1087,14,1477,30,3,54,130000.0,39000.0,-72.0,-72.0,-69.0,-60.0,-72.0,-71.0,-69.0,-60.0,-90.0,-91.0,-87.0,-89.0,18.0,19.0,18.0,29.0,1
925,BA:8C:B9:54:50:24,3855692,491826358,4962,6197432,3850730,485628926,7,10008,1769232,9986,1765737,22,3495,2361,18,5490,44,7,77,229410.0,130000.0,-40.0,-37.0,-45.0,-51.0,-42.0,-36.0,-44.0,-50.0,-90.0,-91.0,-87.0,-89.0,50.0,54.0,42.0,38.0,1
926,62:47:05:9D:EB:15,3857805,497953610,7071,12324280,3850734,485629330,1,7565,3919310,7514,3911514,51,7796,3592,0,7153,56,1,127,216660.0,130000.0,-43.0,-46.0,-36.0,-48.0,-43.0,-46.0,-38.0,-47.0,-90.0,-91.0,-87.0,-89.0,47.0,45.0,51.0,41.0,1
927,92:69:1D:31:68:E9,3854926,489336100,4192,3706770,3850734,485629330,1,5744,1231216,5564,1190248,180,40968,2322,12,4465,104,1,66,229410.0,130000.0,-52.0,-47.0,-45.0,-47.0,-51.0,-48.0,-45.0,-49.0,-90.0,-91.0,-87.0,-89.0,38.0,44.0,42.0,42.0,1
928,CC:2F:71:3F:1F:24,5182260,2032571340,1331526,1546942010,3850734,485629330,2222,1124307,1297039004,1123429,1296932650,878,106354,1088295,15,1329662,125257,2219,855,144444.0,43333.0,-68.0,-68.0,-66.0,-74.0,-68.0,-68.0,-66.0,-73.0,-90.0,-91.0,-87.0,-89.0,22.0,23.0,21.0,15.0,1
929,CC:2F:71:3E:C5:1F,3851761,485754841,1027,125511,3850734,485629330,3,4494,374509,3746,285715,748,88794,1087,14,1477,30,3,54,130000.0,39000.0,-72.0,-72.0,-69.0,-60.0,-72.0,-71.0,-69.0,-60.0,-90.0,-91.0,-87.0,-89.0,18.0,19.0,18.0,29.0,1
930,BA:8C:B9:54:50:24,3855696,491826762,4962,6197432,3850734,485629330,7,10008,1769232,9986,1765737,22,3495,2361,18,5490,44,7,77,229410.0,130000.0,-40.0,-37.0,-45.0,-51.0,-42.0,-36.0,-44.0,-50.0,-90.0,-91.0,-87.0,-89.0,50.0,54.0,42.0,38.0,1
931,62:47:05:9D:EB:15,3857809,497954014,7071,12324280,3850738,485629734,1,7565,3919310,7514,3911514,51,7796,3592,0,7153,56,1,127,216660.0,130000.0,-43.0,-46.0,-36.0,-48.0,-43.0,-46.0,-38.0,-47.0,-90.0,-91.0,-88.0,-90.0,47.0,45.0,52.0,42.0,1
932,92:69:1D:31:68:E9,3854930,489336504,4192,3706770,3850738,485629734,1,5744,1231216,5564,1190248,180,40968,2322,12,4465,104,1,66,229410.0,130000.0,-52.0,-47.0,-45.0,-47.0,-51.0,-48.0,-45.0,-49.0,-90.0,-91.0,-88.0,-90.0,38.0,44.0,43.0,43.0,1
933,CC:2F:71:3F:1F:24,5182511,2032879094,1331773,1547249360,3850738,485629734,2222,1124520,1297284980,1123642,1297178626,878,106354,1088500,15,1329909,125309,2219,855,144444.0,43333.0,-68.0,-68.0,-66.0,-74.0,-68.0,-68.0,-66.0,-74.0,-90.0,-91.0,-88.0,-90.0,22.0,23.0,22.0,16.0,1
934,CC:2F:71:3E:C5:1F,3851765,485755245,1027,125511,3850738,485629734,3,4494,374509,3746,285715,748,88794,1087,14,1477,30,3,54,130000.0,39000.0,-72.0,-72.0,-69.0,-60.0,-72.0,-71.0,-69.0,-60.0,-90.0,-91.0,-88.0,-90.0,18.0,19.0,19.0,30.0,1
935,BA:8C:B9:54:50:24,3855700,491827166,4962,6197432,3850738,485629734,7,10008,1769232,9986,1765737,22,3495,2361,18,5490,44,7,77,229410.0,130000.0,-40.0,-37.0,-45.0,-51.0,-42.0,-36.0,-44.0,-50.0,-90.0,-91.0,-88.0,-90.0,50.0,54.0,43.0,39.0,1
936,62:47:05:9D:EB:15,3857816,497954688,7071,12324280,3850745,485630408,1,7565,3919310,7514,3911514,51,7796,3592,0,7153,56,1,127,216660.0,130000.0,-43.0,-46.0,-36.0,-48.0,-43.0,-46.0,-38.0,-47.0,-90.0,-91.0,-88.0,-90.0,47.0,45.0,52.0,42.0,1
937,92:69:1D:31:68:E9,3854939,489337354,4194,3706946,3850745,485630408,1,5750,1231704,5570,1190736,180,40968,2324,12,4467,104,1,66,229410.0,130000.0,-51.0,-47.0,-45.0,-47.0,-51.0,-47.0,-44.0,-48.0,-90.0,-91.0,-88.0,-90.0,39.0,44.0,43.0,43.0,1
938,CC:2F:71:3F:1F:24,5183190,2033749373,1332445,1548118965,3850745,485630408,2222,1124926,1297558373,1124048,1297452019,878,106354,1088888,15,1330581,125447,2219,855,130000.0,43333.0,-68.0,-68.0,-65.0,-74.0,-68.0,-68.0,-65.0,-74.0,-90.0,-91.0,-88.0,-90.0,22.0,23.0,23.0,16.0,1
939,CC:2F:71:3E:C5:1F,3851772,485755919,1027,125511,3850745,485630408,3,4494,374509,3746,285715,748,88794,1087,14,1477,30,3,54,130000.0,39000.0,-72.0,-72.0,-69.0,-60.0,-72.0,-71.0,-69.0,-60.0,-90.0,-91.0,-88.0,-90.0,18.0,19.0,19.0,30.0,1
940,BA:8C:B9:54:50:24,3855707,491827840,4962,6197432,3850745,485630408,7,10008,1769232,9986,1765737,22,3495,2361,18,5490,44,7,77,229410.0,130000.0,-40.0,-37.0,-45.0,-51.0,-42.0,-36.0,-44.0,-50.0,-90.0,-91.0,-88.0,-90.0,50.0,54.0,43.0,39.0,1
941,62:47:05:9D:EB:15,3857820,497955092,7071,12324280,3850749,485630812,1,7565,3919310,7514,3911514,51,7796,3592,0,7153,56,1,127,216660.0,130000.0,-43.0,-46.0,-36.0,-48.0,-43.0,-46.0,-38.0,-47.0,-90.0,-91.0,-88.0,-90.0,47.0,45.0,52.0,42.0,1
942,92:69:1D:31:68:E9,3854943,489337758,4194,3706946,3850749,485630812,1,5750,1231704,5570,1190736,180,40968,2324,12,4467,104,1,66,229410.0,130000.0,-51.0,-47.0,-45.0,-47.0,-51.0,-47.0,-44.0,-48.0,-90.0,-91.0,-88.0,-90.0,39.0,44.0,43.0,43.0,1
943,CC:2F:71:3F:1F:24,5183656,2034293431,1332907,1548662619,3850749,485630812,2222,1125246,1297813044,1124368,1297706690,878,106354,1089204,15,1331041,125448,2219,855,130000.0,43333.0,-72.0,-72.0,-69.0,-78.0,-71.0,-71.0,-68.0,-77.0,-90.0,-91.0,-88.0,-90.0,18.0,19.0,19.0,12.0,1
944,CC:2F:71:3E:C5:1F,3851776,485756323,1027,125511,3850749,485630812,3,4494,374509,3746,285715,748,88794,1087,14,1477,30,3,54,130000.0,39000.0,-72.0,-72.0,-69.0,-60.0,-72.0,-71.0,-69.0,-60.0,-90.0,-91.0,-88.0,-90.0,18.0,19.0,19.0,30.0,1
945,BA:8C:B9:54:50:24,3855713,491828446,4962,6197432,3850751,485631014,7,10008,1769232,9986,1765737,22,3495,2361,18,5490,44,7,77,229410.0,130000.0,-40.0,-37.0,-45.0,-51.0,-42.0,-36.0,-44.0,-50.0,-90.0,-91.0,-88.0,-90.0,50.0,54.0,43.0,39.0,1
946,62:47:05:9D:EB:15,3857825,497955556,7071,12324280,3850754,485631276,1,7565,3919310,7514,3911514,51,7796,3592,0,7153,56,1,127,216660.0,130000.0,-43.0,-46.0,-36.0,-48.0,-43.0,-46.0,-38.0,-47.0,-90.0,-91.0,-88.0,-90.0,47.0,45.0,52.0,42.0,1
947,92:69:1D:31:68:E9,3854948,489338222,4194,3706946,3850754,485631276,1,5750,1231704,5570,1190736,180,40968,2324,12,4467,104,1,66,229410.0,130000.0,-51.0,-47.0,-45.0,-47.0,-51.0,-47.0,-44.0,-48.0,-90.0,-91.0,-88.0,-90.0,39.0,44.0,43.0,43.0,1
948,CC:2F:71:3F:1F:24,5183849,2034532007,1333095,1548900731,3850754,485631276,2222,1125419,1298044240,1124541,1297937886,878,106354,1089373,15,1331231,125451,2219,855,144444.0,39000.0,-69.0,-69.0,-67.0,-75.0,-71.0,-71.0,-68.0,-77.0,-90.0,-91.0,-88.0,-90.0,21.0,22.0,21.0,15.0,1
949,CC:2F:71:3E:C5:1F,3851781,485756787,1027,125511,3850754,485631276,3,4494,374509,3746,285715,748,88794,1087,14,1477,30,3,54,130000.0,39000.0,-72.0,-72.0,-69.0,-60.0,-72.0,-71.0,-69.0,-60.0,-90.0,-91.0,-88.0,-90.0,18.0,19.0,19.0,30.0,1
950,BA:8C:B9:54:50:24,3855716,491828708,4962,6197432,3850754,485631276,7,10008,1769232,9986,1765737,22,3495,2361,18,5490,44,7,77,229410.0,130000.0,-40.0,-37.0,-45.0,-51.0,-42.0,-36.0,-44.0,-50.0,-90.0,-91.0,-88.0,-90.0,50.0,54.0,43.0,39.0,1
951,62:47:05:9D:EB:15,3857829,497955960,7071,12324280,3850758,485631680,1,7565,3919310,7514,3911514,51,7796,3592,0,7153,56,1,127,216660.0,130000.0,-43.0,-46.0,-36.0,-48.0,-43.0,-46.0,-38.0,-47.0,-90.0,-91.0,-88.0,-90.0,47.0,45.0,52.0,42.0,1
952,92:69:1D:31:68:E9,3854953,489338742,4195,3707062,3850758,485631680,1,5752,1231840,5572,1190872,180,40968,2324,12,4468,104,1,66,229410.0,130000.0,-52.0,-47.0,-42.0,-48.0,-51.0,-47.0,-44.0,-47.0,-90.0,-91.0,-88.0,-90.0,38.0,44.0,46.0,42.0,1
953,CC:2F:71:3F:1F:24,5184049,2034776949,1333289,1549145067,3850760,485631882,2222,1125594,1298278420,1124716,1298172066,878,106354,1089545,15,1331425,125472,2219,855,117000.0,39000.0,-69.0,-68.0,-66.0,-74.0,-68.0,-68.0,-65.0,-74.0,-90.0,-91.0,-88.0,-90.0,21.0,23.0,22.0,16.0,1
954,CC:2F:71:3E:C5:1F,3851788,485757509,1028,125627,3850760,485631882,3,4496,374649,3748,285855,748,88794,1087,14,1478,30,3,54,130000.0,39000.0,-72.0,-73.0,-69.0,-60.0,-71.0,-72.0,-69.0,-60.0,-90.0,-91.0,-88.0,-90.0,18.0,18.0,19.0,30.0,1
955,BA:8C:B9:54:50:24,3855723,491829430,4963,6197548,3850760,485631882,7,10014,1769640,9992,1766145,22,3495,2361,18,5491,44,7,77,229410.0,130000.0,-40.0,-37.0,-45.0,-51.0,-41.0,-35.0,-43.0,-47.0,-90.0,-91.0,-88.0,-90.0,50.0,54.0,43.0,39.0,1
956,62:47:05:9D:EB:15,3857834,497956480,7072,12324396,3850762,485632084,1,7567,3919446,7516,3911650,51,7796,3592,0,7154,56,1,127,216660.0,130000.0,-44.0,-45.0,-36.0,-48.0,-43.0,-45.0,-37.0,-47.0,-90.0,-91.0,-88.0,-90.0,46.0,46.0,52.0,42.0,1
957,92:69:1D:31:68:E9,3854957,489339146,4195,3707062,3850762,485632084,1,5752,1231840,5572,1190872,180,40968,2324,12,4468,104,1,66,229410.0,130000.0,-52.0,-47.0,-42.0,-48.0,-51.0,-47.0,-44.0,-47.0,-90.0,-91.0,-88.0,-90.0,38.0,44.0,46.0,42.0,1
958,CC:2F:71:3F:1F:24,5184241,2035018315,1333479,1549386231,3850762,485632084,2222,1125768,1298505276,1124890,1298398922,878,106354,1089719,15,1331615,125472,2219,855,130000.0,43333.0,-69.0,-67.0,-66.0,-75.0,-69.0,-67.0,-66.0,-74.0,-90.0,-91.0,-88.0,-90.0,21.0,24.0,22.0,15.0,1
959,CC:2F:71:3E:C5:1F,3851790,485757711,1028,125627,3850762,485632084,3,4496,374649,3748,285855,748,88794,1087,14,1478,30,3,54,130000.0,39000.0,-72.0,-73.0,-69.0,-60.0,-71.0,-72.0,-69.0,-60.0,-90.0,-91.0,-88.0,-90.0,18.0,18.0,19.0,30.0,1
960,BA:8C:B9:54:50:24,3855725,491829632,4963,6197548,3850762,485632084,7,10014,1769640,9992,1766145,22,3495,2361,18,5491,44,7,77,229410.0,130000.0,-40.0,-37.0,-45.0,-51.0,-41.0,-35.0,-43.0,-47.0,-90.0,-91.0,-88.0,-90.0,50.0,54.0,43.0,39.0,1
961,62:47:05:9D:EB:15,3857839,497956944,7072,12324396,3850767,485632548,1,7567,3919446,7516,3911650,51,7796,3592,0,7154,56,1,127,216660.0,130000.0,-44.0,-45.0,-36.0,-48.0,-43.0,-45.0,-37.0,-47.0,-90.0,-92.0,-88.0,-90.0,46.0,47.0,52.0,42.0,1
962,92:69:1D:31:68:E9,3854964,489339812,4195,3707062,3850769,485632750,1,5752,1231840,5572,1190872,180,40968,2324,12,4468,104,1,66,229410.0,130000.0,-52.0,-47.0,-42.0,-48.0,-51.0,-47.0,-44.0,-47.0,-90.0,-92.0,-88.0,-90.0,38.0,45.0,46.0,42.0,1
963,CC:2F:71:3F:1F:24,5184445,2035263504,1333676,1549630754,3850769,485632750,2222,1125942,1298729860,1125064,1298623506,878,106354,1089893,15,1331810,125486,2219,856,130000.0,43333.0,-69.0,-67.0,-67.0,-75.0,-69.0,-67.0,-67.0,-75.0,-90.0,-92.0,-88.0,-90.0,21.0,25.0,21.0,15.0,1
964,CC:2F:71:3E:C5:1F,3851797,485758377,1028,125627,3850769,485632750,3,4496,374649,3748,285855,748,88794,1087,14,1478,30,3,54,130000.0,39000.0,-72.0,-73.0,-69.0,-60.0,-71.0,-72.0,-69.0,-60.0,-90.0,-92.0,-88.0,-90.0,18.0,19.0,19.0,30.0,1
965,BA:8C:B9:54:50:24,3855732,491830298,4963,6197548,3850769,485632750,7,10014,1769640,9992,1766145,22,3495,2361,18,5491,44,7,77,229410.0,130000.0,-40.0,-37.0,-45.0,-51.0,-41.0,-35.0,-43.0,-47.0,-90.0,-92.0,-88.0,-90.0,50.0,55.0,43.0,39.0,1
966,62:47:05:9D:EB:15,3857845,497957681,7072,12324396,3850773,485633285,1,7567,3919446,7516,3911650,51,7796,3592,0,7154,56,1,127,216660.0,130000.0,-44.0,-45.0,-36.0,-48.0,-43.0,-45.0,-37.0,-47.0,-90.0,-92.0,-88.0,-91.0,46.0,47.0,52.0,43.0,1
967,92:69:1D:31:68:E9,3854968,489340347,4195,3707062,3850773,485633285,1,5752,1231840,5572,1190872,180,40968,2324,12,4468,104,1,66,229410.0,130000.0,-52.0,-47.0,-42.0,-48.0,-51.0,-47.0,-44.0,-47.0,-90.0,-92.0,-88.0,-91.0,38.0,45.0,46.0,43.0,1
968,CC:2F:71:3F:1F:24,5184637,2035502163,1333863,1549868792,3850774,485633371,2222,1126112,1298956276,1125232,1298849666,880,106610,1090063,15,1331999,125486,2219,856,130000.0,43333.0,-69.0,-70.0,-67.0,-75.0,-69.0,-68.0,-66.0,-74.0,-90.0,-92.0,-88.0,-91.0,21.0,22.0,21.0,16.0,1
969,CC:2F:71:3E:C5:1F,3851802,485758998,1028,125627,3850774,485633371,3,4496,374649,3748,285855,748,88794,1087,14,1478,30,3,54,130000.0,39000.0,-72.0,-73.0,-69.0,-60.0,-71.0,-72.0,-69.0,-60.0,-90.0,-92.0,-88.0,-91.0,18.0,19.0,19.0,31.0,1
970,BA:8C:B9:54:50:24,3855739,491831121,4963,6197548,3850776,485633573,7,10014,1769640,9992,1766145,22,3495,2361,18,5491,44,7,77,229410.0,130000.0,-40.0,-37.0,-45.0,-51.0,-41.0,-35.0,-43.0,-47.0,-90.0,-92.0,-88.0,-91.0,50.0,55.0,43.0,40.0,1
971,62:47:05:9D:EB:15,3857853,497958431,7072,12324396,3850781,485634035,1,7567,3919446,7516,3911650,51,7796,3592,0,7154,56,1,127,216660.0,130000.0,-44.0,-45.0,-36.0,-48.0,-43.0,-45.0,-37.0,-47.0,-90.0,-92.0,-88.0,-91.0,46.0,47.0,52.0,43.0,1
972,92:69:1D:31:68:E9,3854978,489341299,4195,3707062,3850783,485634237,1,5752,1231840,5572,1190872,180,40968,2324,12,4468,104,1,66,229410.0,130000.0,-52.0,-47.0,-42.0,-48.0,-51.0,-47.0,-44.0,-47.0,-90.0,-92.0,-88.0,-91.0,38.0,45.0,46.0,43.0,1
973,CC:2F:71:3F:1F:24,5184838,2035744509,1334055,1550110272,3850783,485634237,2222,1126283,1299182864,1125401,1299075942,882,106922,1090234,15,1332191,125486,2219,856,130000.0,39000.0,-69.0,-69.0,-65.0,-74.0,-69.0,-69.0,-65.0,-73.0,-90.0,-92.0,-88.0,-91.0,21.0,23.0,23.0,17.0,1
974,CC:2F:71:3E:C5:1F,3851811,485759864,1028,125627,3850783,485634237,3,4496,374649,3748,285855,748,88794,1087,14,1478,30,3,54,130000.0,39000.0,-72.0,-73.0,-69.0,-60.0,-71.0,-72.0,-69.0,-60.0,-90.0,-92.0,-88.0,-91.0,18.0,19.0,19.0,31.0,1
975,BA:8C:B9:54:50:24,3855746,491831785,4963,6197548,3850783,485634237,7,10014,1769640,9992,1766145,22,3495,2361,18,5491,44,7,77,229410.0,130000.0,-40.0,-37.0,-45.0,-51.0,-41.0,-35.0,-43.0,-47.0,-90.0,-92.0,-88.0,-91.0,50.0,55.0,43.0,40.0,1
976,62:47:05:9D:EB:15,3857857,497958835,7072,12324396,3850785,485634439,1,7567,3919446,7516,3911650,51,7796,3592,0,7154,56,1,127,216660.0,130000.0,-44.0,-45.0,-36.0,-48.0,-43.0,-45.0,-37.0,-47.0,-90.0,-92.0,-88.0,-91.0,46.0,47.0,52.0,43.0,1
977,92:69:1D:31:68:E9,3854980,489341501,4195,3707062,3850785,485634439,1,5752,1231840,5572,1190872,180,40968,2324,12,4468,104,1,66,229410.0,130000.0,-52.0,-47.0,-42.0,-48.0,-51.0,-47.0,-44.0,-47.0,-90.0,-92.0,-88.0,-91.0,38.0,45.0,46.0,43.0,1
978,CC:2F:71:3F:1F:24,5185030,2035985891,1334245,1550351452,3850785,485634439,2222,1126451,1299406176,1125569,1299299254,882,106922,1090402,15,1332380,125496,2219,856,144444.0,43333.0,-70.0,-70.0,-66.0,-72.0,-70.0,-69.0,-66.0,-72.0,-90.0,-92.0,-88.0,-91.0,20.0,22.0,22.0,19.0,1
979,CC:2F:71:3E:C5:1F,3851815,485760268,1028,125627,3850787,485634641,3,4496,374649,3748,285855,748,88794,1087,14,1478,30,3,54,130000.0,39000.0,-72.0,-73.0,-69.0,-60.0,-71.0,-72.0,-69.0,-60.0,-90.0,-92.0,-88.0,-91.0,18.0,19.0,19.0,31.0,1
980,BA:8C:B9:54:50:24,3855750,491832189,4963,6197548,3850787,485634641,7,10014,1769640,9992,1766145,22,3495,2361,18,5491,44,7,77,229410.0,130000.0,-40.0,-37.0,-45.0,-51.0,-41.0,-35.0,-43.0,-47.0,-90.0,-92.0,-88.0,-91.0,50.0,55.0,43.0,40.0,1
981,62:47:05:9D:EB:15,3857863,497959441,7072,12324396,3850791,485635045,1,7567,3919446,7516,3911650,51,7796,3592,0,7154,56,1,127,216660.0,130000.0,-44.0,-45.0,-36.0,-48.0,-43.0,-45.0,-37.0,-47.0,-90.0,-92.0,-88.0,-91.0,46.0,47.0,52.0,43.0,1
982,92:69:1D:31:68:E9,3854986,489342107,4195,3707062,3850791,485635045,1,5752,1231840,5572,1190872,180,40968,2324,12,4468,104,1,66,229410.0,130000.0,-52.0,-47.0,-42.0,-48.0,-51.0,-47.0,-44.0,-47.0,-90.0,-92.0,-88.0,-91.0,38.0,45.0,46.0,43.0,1
983,CC:2F:71:3F:1F:24,5185236,2036231650,1334445,1550596605,3850791,485635045,2222,1126629,1299633987,1125747,1299527065,882,106922,1090580,15,1332581,125511,2219,856,144444.0,43333.0,-71.0,-67.0,-66.0,-74.0,-71.0,-67.0,-66.0,-74.0,-90.0,-92.0,-88.0,-91.0,19.0,25.0,22.0,17.0,1
984,CC:2F:71:3E:C5:1F,3851819,485760672,1028,125627,3850791,485635045,3,4496,374649,3748,285855,748,88794,1087,14,1478,30,3,54,130000.0,39000.0,-72.0,-73.0,-69.0,-60.0,-71.0,-72.0,-69.0,-60.0,-90.0,-92.0,-88.0,-91.0,18.0,19.0,19.0,31.0,1
985,BA:8C:B9:54:50:24,3855754,491832593,4963,6197548,3850791,485635045,7,10014,1769640,9992,1766145,22,3495,2361,18,5491,44,7,77,229410.0,130000.0,-40.0,-37.0,-45.0,-51.0,-41.0,-35.0,-43.0,-47.0,-90.0,-92.0,-88.0,-91.0,50.0,55.0,43.0,40.0,1
986,62:47:05:9D:EB:15,3857866,497959703,7072,12324396,3850794,485635307,1,7567,3919446,7516,3911650,51,7796,3592,0,7154,56,1,127,216660.0,130000.0,-44.0,-45.0,-36.0,-48.0,-43.0,-45.0,-37.0,-47.0,-90.0,-92.0,-88.0,-91.0,46.0,47.0,52.0,43.0,1
987,92:69:1D:31:68:E9,3854991,489342571,4195,3707062,3850796,485635509,1,5752,1231840,5572,1190872,180,40968,2324,12,4468,104,1,66,229410.0,130000.0,-52.0,-47.0,-42.0,-48.0,-51.0,-47.0,-44.0,-47.0,-90.0,-92.0,-88.0,-91.0,38.0,45.0,46.0,43.0,1
988,CC:2F:71:3F:1F:24,5185430,2036473164,1334634,1550837655,3850796,485635509,2222,1126798,1299860347,1125916,1299753425,882,106922,1090749,15,1332770,125569,2219,857,144444.0,43333.0,-69.0,-67.0,-66.0,-72.0,-69.0,-67.0,-65.0,-72.0,-90.0,-92.0,-88.0,-91.0,21.0,25.0,22.0,19.0,1
989,CC:2F:71:3E:C5:1F,3851824,485761136,1028,125627,3850796,485635509,3,4496,374649,3748,285855,748,88794,1087,14,1478,30,3,54,130000.0,39000.0,-72.0,-73.0,-69.0,-60.0,-71.0,-72.0,-69.0,-60.0,-90.0,-92.0,-88.0,-91.0,18.0,19.0,19.0,31.0,1
990,BA:8C:B9:54:50:24,3855761,491833259,4963,6197548,3850798,485635711,7,10014,1769640,9992,1766145,22,3495,2361,18,5491,44,7,77,229410.0,130000.0,-40.0,-37.0,-45.0,-51.0,-41.0,-35.0,-43.0,-47.0,-90.0,-92.0,-88.0,-91.0,50.0,55.0,43.0,40.0,1
991,62:47:05:9D:EB:15,3857872,497960309,7072,12324396,3850800,485635913,1,7567,3919446,7516,3911650,51,7796,3592,0,7154,56,1,127,216660.0,130000.0,-44.0,-45.0,-36.0,-48.0,-43.0,-45.0,-37.0,-47.0,-90.0,-92.0,-89.0,-91.0,46.0,47.0,53.0,43.0,1
992,92:69:1D:31:68:E9,3854995,489342975,4195,3707062,3850800,485635913,1,5752,1231840,5572,1190872,180,40968,2324,12,4468,104,1,66,229410.0,130000.0,-52.0,-47.0,-42.0,-48.0,-51.0,-47.0,-44.0,-47.0,-90.0,-92.0,-89.0,-91.0,38.0,45.0,47.0,43.0,1
993,CC:2F:71:3F:1F:24,5185632,2036724388,1334832,1551088475,3850800,485635913,2222,1126974,1300098841,1126092,1299991919,882,106922,1090924,15,1332968,125616,2219,857,130000.0,43333.0,-70.0,-68.0,-66.0,-72.0,-70.0,-68.0,-66.0,-71.0,-90.0,-92.0,-89.0,-91.0,20.0,24.0,23.0,19.0,1
994,CC:2F:71:3E:C5:1F,3851828,485761540,1028,125627,3850800,485635913,3,4496,374649,3748,285855,748,88794,1087,14,1478,30,3,54,130000.0,39000.0,-72.0,-73.0,-69.0,-60.0,-71.0,-72.0,-69.0,-60.0,-90.0,-92.0,-89.0,-91.0,18.0,19.0,20.0,31.0,1
995,BA:8C:B9:54:50:24,3855765,491833663,4963,6197548,3850802,485636115,7,10014,1769640,9992,1766145,22,3495,2361,18,5491,44,7,77,229410.0,130000.0,-40.0,-37.0,-45.0,-51.0,-41.0,-35.0,-43.0,-47.0,-90.0,-92.0,-89.0,-91.0,50.0,55.0,44.0,40.0,1
996,62:47:05:9D:EB:15,3857877,497960773,7072,12324396,3850805,485636377,1,7567,3919446,7516,3911650,51,7796,3592,0,7154,56,1,127,216660.0,130000.0,-44.0,-45.0,-36.0,-48.0,-43.0,-45.0,-37.0,-47.0,-90.0,-92.0,-89.0,-91.0,46.0,47.0,53.0,43.0,1
997,92:69:1D:31:68:E9,3855000,489343439,4195,3707062,3850805,485636377,1,5753,1231908,5573,1190940,180,40968,2324,12,4468,104,1,66,229410.0,130000.0,-51.0,-47.0,-44.0,-47.0,-51.0,-47.0,-44.0,-47.0,-90.0,-92.0,-89.0,-91.0,39.0,45.0,45.0,44.0,1
998,CC:2F:71:3F:1F:24,5185830,2036966350,1335023,1551329771,3850807,485636579,2222,1127160,1300350243,1126278,1300243321,882,106922,1091094,15,1333159,125626,2219,858,117000.0,39000.0,-69.0,-68.0,-66.0,-72.0,-69.0,-68.0,-65.0,-72.0,-90.0,-92.0,-89.0,-91.0,21.0,24.0,23.0,19.0,1
999,CC:2F:71:3E:C5:1F,3851835,485762206,1028,125627,3850807,485636579,3,4496,374649,3748,285855,748,88794,1087,14,1478,30,3,54,130000.0,39000.0,-72.0,-73.0,-69.0,-60.0,-71.0,-72.0,-69.0,-60.0,-90.0,-92.0,-89.0,-91.0,18.0,19.0,20.0,31.0,1
1000,BA:8C:B9:54:50:24,3855770,491834127,4963,6197548,3850807,485636579,7,10014,1769640,9992,1766145,22,3495,2361,18,5491,44,7,77,229410.0,130000.0,-40.0,-37.0,-45.0,-51.0,-41.0,-35.0,-43.0,-47.0,-90.0,-92.0,-89.0,-91.0,50.0,55.0,44.0,40.0,1
1001,62:47:05:9D:EB:15,3857882,497961239,7072,12324396,3850810,485636843,1,7567,3919446,7516,3911650,51,7796,3592,0,7154,56,1,127,216660.0,130000.0,-44.0,-45.0,-36.0,-48.0,-43.0,-45.0,-37.0,-47.0,-90.0,-92.0,-89.0,-91.0,46.0,47.0,53.0,43.0,1
1002,92:69:1D:31:68:E9,3855005,489343905,4195,3707062,3850810,485636843,1,5753,1231908,5573,1190940,180,40968,2324,12,4468,104,1,66,229410.0,130000.0,-51.0,-47.0,-44.0,-47.0,-51.0,-47.0,-44.0,-47.0,-90.0,-92.0,-89.0,-91.0,39.0,45.0,45.0,44.0,1
1003,CC:2F:71:3F:1F:24,5186032,2037211525,1335222,1551574682,3850810,485636843,2222,1127340,1300584100,1126458,1300477178,882,106922,1091269,15,1333358,125626,2219,858,130000.0,43333.0,-70.0,-68.0,-65.0,-72.0,-69.0,-68.0,-66.0,-72.0,-90.0,-92.0,-89.0,-91.0,20.0,24.0,24.0,19.0,1
1004,CC:2F:71:3E:C5:1F,3851838,485762470,1028,125627,3850810,485636843,3,4498,374837,3749,285925,749,88912,1088,14,1478,30,3,54,130000.0,39000.0,-72.0,-73.0,-69.0,-60.0,-71.0,-72.0,-69.0,-60.0,-90.0,-92.0,-89.0,-91.0,18.0,19.0,20.0,31.0,1
1005,BA:8C:B9:54:50:24,3855775,491834593,4963,6197548,3850812,485637045,7,10014,1769640,9992,1766145,22,3495,2361,18,5491,44,7,77,229410.0,130000.0,-40.0,-37.0,-45.0,-51.0,-41.0,-35.0,-43.0,-47.0,-90.0,-92.0,-89.0,-91.0,50.0,55.0,44.0,40.0,1
1006,62:47:05:9D:EB:15,3857886,497961643,7072,12324396,3850814,485637247,1,7567,3919446,7516,3911650,51,7796,3592,0,7154,56,1,127,216660.0,130000.0,-44.0,-45.0,-36.0,-48.0,-43.0,-45.0,-37.0,-47.0,-90.0,-92.0,-89.0,-91.0,46.0,47.0,53.0,43.0,1
1007,92:69:1D:31:68:E9,3855011,489344511,4195,3707062,3850816,485637449,1,5753,1231908,5573,1190940,180,40968,2324,12,4468,104,1,66,229410.0,130000.0,-51.0,-47.0,-44.0,-47.0,-51.0,-47.0,-44.0,-47.0,-90.0,-92.0,-89.0,-91.0,39.0,45.0,45.0,44.0,1
1008,CC:2F:71:3F:1F:24,5186228,2037454847,1335412,1551817398,3850816,485637449,2222,1127513,1300815154,1126631,1300708232,882,106922,1091439,15,1333547,125626,2219,858,130000.0,43333.0,-69.0,-68.0,-66.0,-71.0,-69.0,-68.0,-65.0,-71.0,-90.0,-92.0,-89.0,-91.0,21.0,24.0,23.0,20.0,1
1009,CC:2F:71:3E:C5:1F,3851844,485763076,1028,125627,3850816,485637449,3,4498,374837,3749,285925,749,88912,1088,14,1478,30,3,54,130000.0,39000.0,-72.0,-73.0,-69.0,-60.0,-71.0,-72.0,-69.0,-60.0,-90.0,-92.0,-89.0,-91.0,18.0,19.0,20.0,31.0,1
1010,BA:8C:B9:54:50:24,3855779,491834997,4963,6197548,3850816,485637449,7,10014,1769640,9992,1766145,22,3495,2361,18,5491,44,7,77,229410.0,130000.0,-40.0,-37.0,-45.0,-51.0,-41.0,-35.0,-43.0,-47.0,-90.0,-92.0,-89.0,-91.0,50.0,55.0,44.0,40.0,1
1011,62:47:05:9D:EB:15,3857891,497962107,7072,12324396,3850819,485637711,1,7567,3919446,7516,3911650,51,7796,3592,0,7154,56,1,127,216660.0,130000.0,-44.0,-45.0,-36.0,-48.0,-43.0,-45.0,-37.0,-47.0,-90.0,-92.0,-88.0,-91.0,46.0,47.0,52.0,43.0,1
1012,92:69:1D:31:68:E9,3855014,489344773,4195,3707062,3850819,485637711,1,5753,1231908,5573,1190940,180,40968,2324,12,4468,104,1,66,229410.0,130000.0,-51.0,-47.0,-44.0,-47.0,-51.0,-47.0,-44.0,-47.0,-90.0,-92.0,-88.0,-91.0,39.0,45.0,44.0,44.0,1
1013,CC:2F:71:3F:1F:24,5186426,2037701083,1335607,1552063372,3850819,485637711,2222,1127689,1301052252,1126807,1300945330,882,106922,1091612,15,1333743,125630,2219,858,130000.0,43333.0,-69.0,-68.0,-65.0,-72.0,-69.0,-68.0,-65.0,-71.0,-90.0,-92.0,-88.0,-91.0,21.0,24.0,23.0,19.0,1
1014,CC:2F:71:3E:C5:1F,3851848,485763400,1028,125627,3850820,485637773,3,4498,374837,3749,285925,749,88912,1088,14,1478,30,3,54,130000.0,39000.0,-72.0,-73.0,-69.0,-60.0,-71.0,-72.0,-69.0,-60.0,-90.0,-92.0,-88.0,-91.0,18.0,19.0,19.0,31.0,1
1015,BA:8C:B9:54:50:24,3855783,491835321,4963,6197548,3850820,485637773,7,10014,1769640,9992,1766145,22,3495,2361,18,5491,44,7,77,229410.0,130000.0,-40.0,-37.0,-45.0,-51.0,-41.0,-35.0,-43.0,-47.0,-90.0,-92.0,-88.0,-91.0,50.0,55.0,43.0,40.0,1
1016,62:47:05:9D:EB:15,3857921,497973798,7072,12324396,3850849,485649402,1,7567,3919446,7516,3911650,51,7796,3592,0,7154,56,1,127,216660.0,130000.0,-44.0,-45.0,-36.0,-48.0,-43.0,-45.0,-37.0,-47.0,-90.0,-92.0,-88.0,-91.0,46.0,47.0,52.0,43.0,1
1017,92:69:1D:31:68:E9,3855044,489356464,4195,3707062,3850849,485649402,1,5756,1232279,5575,1191076,181,41203,2325,12,4468,104,1,66,229410.0,130000.0,-51.0,-47.0,-42.0,-48.0,-51.0,-47.0,-43.0,-48.0,-90.0,-92.0,-88.0,-91.0,39.0,45.0,46.0,43.0,1
1018,CC:2F:71:3F:1F:24,5186669,2037977768,1335820,1552328366,3850849,485649402,2222,1127887,1301308287,1127004,1301201247,883,107040,1091803,15,1333956,125630,2219,858,130000.0,43333.0,-69.0,-69.0,-67.0,-72.0,-69.0,-68.0,-67.0,-71.0,-90.0,-92.0,-88.0,-91.0,21.0,23.0,21.0,19.0,1
1019,CC:2F:71:3E:C5:1F,3851877,485775029,1028,125627,3850849,485649402,3,4498,374837,3749,285925,749,88912,1088,14,1478,30,3,54,130000.0,39000.0,-72.0,-73.0,-69.0,-60.0,-71.0,-72.0,-69.0,-60.0,-90.0,-92.0,-88.0,-91.0,18.0,19.0,19.0,31.0,1
1020,BA:8C:B9:54:50:24,3855812,491846950,4963,6197548,3850849,485649402,7,10020,1770048,9998,1766553,22,3495,2361,18,5492,44,7,77,229410.0,130000.0,-48.0,-35.0,-43.0,-45.0,-43.0,-35.0,-44.0,-48.0,-90.0,-92.0,-88.0,-91.0,42.0,57.0,45.0,46.0,1
1021,62:47:05:9D:EB:15,3857924,497974060,7072,12324396,3850852,485649664,1,7569,3919582,7518,3911786,51,7796,3592,0,7155,56,1,127,216660.0,130000.0,-43.0,-46.0,-36.0,-47.0,-43.0,-46.0,-38.0,-47.0,-90.0,-92.0,-88.0,-91.0,47.0,46.0,52.0,44.0,1
1022,92:69:1D:31:68:E9,3855047,489356726,4195,3707062,3850852,485649664,1,5756,1232279,5575,1191076,181,41203,2325,12,4468,104,1,66,229410.0,130000.0,-51.0,-47.0,-42.0,-48.0,-51.0,-47.0,-43.0,-48.0,-90.0,-92.0,-88.0,-91.0,39.0,45.0,46.0,43.0,1
1023,CC:2F:71:3F:1F:24,5186875,2038231259,1336021,1552581393,3850854,485649866,2222,1128072,1301555043,1127189,1301448003,883,107040,1091980,15,1334157,125638,2219,858,130000.0,43333.0,-69.0,-68.0,-65.0,-72.0,-69.0,-68.0,-65.0,-72.0,-90.0,-92.0,-88.0,-91.0,21.0,24.0,23.0,19.0,1
1024,CC:2F:71:3E:C5:1F,3851882,485775493,1028,125627,3850854,485649866,3,4498,374837,3749,285925,749,88912,1088,14,1478,30,3,54,130000.0,39000.0,-72.0,-73.0,-69.0,-60.0,-71.0,-72.0,-69.0,-60.0,-90.0,-92.0,-88.0,-91.0,18.0,19.0,19.0,31.0,1
1025,BA:8C:B9:54:50:24,3855817,491847414,4963,6197548,3850854,485649866,7,10020,1770048,9998,1766553,22,3495,2361,18,5492,44,7,77,229410.0,130000.0,-48.0,-35.0,-43.0,-45.0,-43.0,-35.0,-44.0,-48.0,-90.0,-92.0,-88.0,-91.0,42.0,57.0,45.0,46.0,1
1026,62:47:05:9D:EB:15,3857930,497974666,7072,12324396,3850858,485650270,1,7569,3919582,7518,3911786,51,7796,3592,0,7155,56,1,127,216660.0,130000.0,-43.0,-46.0,-36.0,-47.0,-43.0,-46.0,-38.0,-47.0,-90.0,-92.0,-88.0,-91.0,47.0,46.0,52.0,44.0,1
1027,92:69:1D:31:68:E9,3855053,489357332,4195,3707062,3850858,485650270,1,5756,1232279,5575,1191076,181,41203,2325,12,4468,104,1,66,229410.0,130000.0,-51.0,-47.0,-42.0,-48.0,-51.0,-47.0,-43.0,-48.0,-90.0,-92.0,-88.0,-91.0,39.0,45.0,46.0,43.0,1
1028,CC:2F:71:3F:1F:24,5187069,2038472883,1336211,1552822613,3850858,485650270,2222,1128248,1301792183,1127365,1301685143,883,107040,1092150,15,1334347,125642,2219,858,130000.0,43333.0,-69.0,-69.0,-66.0,-73.0,-69.0,-69.0,-65.0,-72.0,-90.0,-92.0,-88.0,-91.0,21.0,23.0,22.0,18.0,1
1029,CC:2F:71:3E:C5:1F,3851886,485775897,1028,125627,3850858,485650270,3,4498,374837,3749,285925,749,88912,1088,14,1478,30,3,54,130000.0,39000.0,-72.0,-73.0,-69.0,-60.0,-71.0,-72.0,-69.0,-60.0,-90.0,-92.0,-88.0,-91.0,18.0,19.0,19.0,31.0,1
1030,BA:8C:B9:54:50:24,3855822,491848091,4963,6197548,3850859,485650543,7,10020,1770048,9998,1766553,22,3495,2361,18,5492,44,7,77,229410.0,130000.0,-48.0,-35.0,-43.0,-45.0,-43.0,-35.0,-44.0,-48.0,-90.0,-92.0,-88.0,-91.0,42.0,57.0,45.0,46.0,1
1031,62:47:05:9D:EB:15,3857933,497975141,7072,12324396,3850861,485650745,1,7569,3919582,7518,3911786,51,7796,3592,0,7155,56,1,127,216660.0,130000.0,-43.0,-46.0,-36.0,-47.0,-43.0,-46.0,-38.0,-47.0,-90.0,-92.0,-88.0,-91.0,47.0,46.0,52.0,44.0,1
1032,92:69:1D:31:68:E9,3855058,489358009,4195,3707062,3850863,485650947,1,5756,1232279,5575,1191076,181,41203,2325,12,4468,104,1,66,229410.0,130000.0,-51.0,-47.0,-42.0,-48.0,-51.0,-47.0,-43.0,-48.0,-90.0,-92.0,-88.0,-91.0,39.0,45.0,46.0,43.0,1
1033,CC:2F:71:3F:1F:24,5187700,2039270614,1336837,1553619667,3850863,485650947,2222,1128605,1302060000,1127722,1301952960,883,107040,1092500,15,1334973,125657,2219,858,130000.0,43333.0,-71.0,-69.0,-67.0,-73.0,-71.0,-69.0,-67.0,-73.0,-90.0,-92.0,-88.0,-91.0,19.0,23.0,21.0,18.0,1
1034,CC:2F:71:3E:C5:1F,3851891,485776574,1028,125627,3850863,485650947,3,4498,374837,3749,285925,749,88912,1088,14,1478,30,3,54,130000.0,39000.0,-72.0,-73.0,-69.0,-60.0,-71.0,-72.0,-69.0,-60.0,-90.0,-92.0,-88.0,-91.0,18.0,19.0,19.0,31.0,1
1035,BA:8C:B9:54:50:24,3855829,491848757,4963,6197548,3850866,485651209,7,10026,1770456,10004,1766961,22,3495,2361,18,5492,44,7,77,229410.0,130000.0,-48.0,-35.0,-43.0,-45.0,-46.0,-35.0,-43.0,-46.0,-90.0,-92.0,-88.0,-91.0,42.0,57.0,45.0,46.0,1
1036,62:47:05:9D:EB:15,3857940,497975807,7072,12324396,3850868,485651411,1,7569,3919582,7518,3911786,51,7796,3592,0,7155,56,1,127,216660.0,130000.0,-43.0,-46.0,-36.0,-47.0,-43.0,-46.0,-38.0,-47.0,-90.0,-91.0,-88.0,-90.0,47.0,45.0,52.0,43.0,1
1037,92:69:1D:31:68:E9,3855063,489358473,4195,3707062,3850868,485651411,1,5756,1232279,5575,1191076,181,41203,2325,12,4468,104,1,66,229410.0,130000.0,-51.0,-47.0,-42.0,-48.0,-51.0,-47.0,-43.0,-48.0,-90.0,-91.0,-88.0,-90.0,39.0,44.0,46.0,42.0,1
1038,CC:2F:71:3F:1F:24,5188092,2039761374,1337224,1554109963,3850868,485651411,2222,1128870,1302302868,1127987,1302195828,883,107040,1092762,15,1335360,125682,2219,858,144444.0,43333.0,-70.0,-69.0,-67.0,-73.0,-70.0,-69.0,-66.0,-72.0,-90.0,-91.0,-88.0,-90.0,20.0,22.0,21.0,17.0,1
1039,CC:2F:71:3E:C5:1F,3851896,485777038,1028,125627,3850868,485651411,3,4498,374837,3749,285925,749,88912,1088,14,1478,30,3,54,130000.0,39000.0,-72.0,-73.0,-69.0,-60.0,-71.0,-72.0,-69.0,-60.0,-90.0,-91.0,-88.0,-90.0,18.0,18.0,19.0,30.0,1
1040,BA:8C:B9:54:50:24,3855833,491849161,4963,6197548,3850870,485651613,7,10026,1770456,10004,1766961,22,3495,2361,18,5492,44,7,77,229410.0,130000.0,-48.0,-35.0,-43.0,-45.0,-46.0,-35.0,-43.0,-46.0,-90.0,-91.0,-88.0,-90.0,42.0,56.0,45.0,45.0,1
1041,62:47:05:9D:EB:15,3857946,497976579,7072,12324396,3850874,485652183,1,7569,3919582,7518,3911786,51,7796,3592,0,7155,56,1,127,216660.0,130000.0,-43.0,-46.0,-36.0,-47.0,-43.0,-46.0,-38.0,-47.0,-90.0,-91.0,-88.0,-90.0,47.0,45.0,52.0,43.0,1
1042,92:69:1D:31:68:E9,3855069,489359245,4195,3707062,3850874,485652183,1,5756,1232279,5575,1191076,181,41203,2325,12,4468,104,1,66,229410.0,130000.0,-51.0,-47.0,-42.0,-48.0,-51.0,-47.0,-43.0,-48.0,-90.0,-91.0,-88.0,-90.0,39.0,44.0,46.0,42.0,1
1043,CC:2F:71:3F:1F:24,5188488,2040250094,1337612,1554597709,3850876,485652385,2222,1129133,1302545505,1128250,1302438465,883,107040,1093022,15,1335748,125723,2219,858,144444.0,43333.0,-70.0,-69.0,-67.0,-72.0,-70.0,-69.0,-66.0,-72.0,-90.0,-91.0,-88.0,-90.0,20.0,22.0,21.0,18.0,1
1044,CC:2F:71:3E:C5:1F,3851904,485778012,1028,125627,3850876,485652385,3,4498,374837,3749,285925,749,88912,1088,14,1478,30,3,54,130000.0,39000.0,-72.0,-73.0,-69.0,-60.0,-71.0,-72.0,-69.0,-60.0,-90.0,-91.0,-88.0,-90.0,18.0,18.0,19.0,30.0,1
1045,BA:8C:B9:54:50:24,3855839,491849933,4963,6197548,3850876,485652385,7,10026,1770456,10004,1766961,22,3495,2361,18,5492,44,7,77,229410.0,130000.0,-48.0,-35.0,-43.0,-45.0,-46.0,-35.0,-43.0,-46.0,-90.0,-91.0,-88.0,-90.0,42.0,56.0,45.0,45.0,1
1046,62:47:05:9D:EB:15,3857951,497977043,7072,12324396,3850879,485652647,1,7569,3919582,7518,3911786,51,7796,3592,0,7155,56,1,127,216660.0,130000.0,-43.0,-46.0,-36.0,-47.0,-43.0,-46.0,-38.0,-47.0,-90.0,-91.0,-88.0,-90.0,47.0,45.0,52.0,43.0,1
1047,92:69:1D:31:68:E9,3855074,489359709,4195,3707062,3850879,485652647,1,5756,1232279,5575,1191076,181,41203,2325,12,4468,104,1,66,229410.0,130000.0,-51.0,-47.0,-42.0,-48.0,-51.0,-47.0,-43.0,-48.0,-90.0,-91.0,-88.0,-90.0,39.0,44.0,46.0,42.0,1
1048,CC:2F:71:3F:1F:24,5188880,2040743872,1338001,1555091225,3850879,485652647,2222,1129399,1302789793,1128516,1302682753,883,107040,1093285,15,1336137,125755,2219,858,130000.0,43333.0,-70.0,-69.0,-67.0,-73.0,-70.0,-69.0,-66.0,-72.0,-90.0,-91.0,-88.0,-90.0,20.0,22.0,21.0,17.0,1
1049,CC:2F:71:3E:C5:1F,3851909,485778476,1028,125627,3850881,485652849,3,4498,374837,3749,285925,749,88912,1088,14,1478,30,3,54,130000.0,39000.0,-72.0,-73.0,-69.0,-60.0,-71.0,-72.0,-69.0,-60.0,-90.0,-91.0,-88.0,-90.0,18.0,18.0,19.0,30.0,1
1050,BA:8C:B9:54:50:24,3855844,491850397,4963,6197548,3850881,485652849,7,10026,1770456,10004,1766961,22,3495,2361,18,5492,44,7,77,229410.0,130000.0,-48.0,-35.0,-43.0,-45.0,-46.0,-35.0,-43.0,-46.0,-90.0,-91.0,-88.0,-90.0,42.0,56.0,45.0,45.0,1
1051,62:47:05:9D:EB:15,3857955,497977447,7072,12324396,3850883,485653051,1,7569,3919582,7518,3911786,51,7796,3592,0,7155,56,1,127,216660.0,130000.0,-43.0,-46.0,-36.0,-47.0,-43.0,-46.0,-38.0,-47.0,-90.0,-91.0,-88.0,-90.0,47.0,45.0,52.0,43.0,1
1052,92:69:1D:31:68:E9,3855080,489360315,4195,3707062,3850885,485653253,1,5756,1232279,5575,1191076,181,41203,2325,12,4468,104,1,66,229410.0,130000.0,-51.0,-47.0,-42.0,-48.0,-51.0,-47.0,-43.0,-48.0,-90.0,-91.0,-88.0,-90.0,39.0,44.0,46.0,42.0,1
1053,CC:2F:71:3F:1F:24,5189483,2041491211,1338598,1555837958,3850885,485653253,2222,1129788,1303069197,1128905,1302962157,883,107040,1093661,15,1336734,125817,2219,858,144444.0,43333.0,-70.0,-69.0,-67.0,-73.0,-69.0,-68.0,-66.0,-72.0,-90.0,-91.0,-88.0,-90.0,20.0,22.0,21.0,17.0,1
1054,CC:2F:71:3E:C5:1F,3851913,485778880,1028,125627,3850885,485653253,3,4498,374837,3749,285925,749,88912,1088,14,1478,30,3,54,130000.0,39000.0,-72.0,-73.0,-69.0,-60.0,-71.0,-72.0,-69.0,-60.0,-90.0,-91.0,-88.0,-90.0,18.0,18.0,19.0,30.0,1
1055,BA:8C:B9:54:50:24,3855850,491851003,4963,6197548,3850887,485653455,7,10026,1770456,10004,1766961,22,3495,2361,18,5492,44,7,77,229410.0,130000.0,-48.0,-35.0,-43.0,-45.0,-46.0,-35.0,-43.0,-46.0,-90.0,-91.0,-88.0,-90.0,42.0,56.0,45.0,45.0,1
1056,62:47:05:9D:EB:15,3857959,497977851,7072,12324396,3850887,485653455,1,7569,3919582,7518,3911786,51,7796,3592,0,7155,56,1,127,216660.0,130000.0,-43.0,-46.0,-36.0,-47.0,-43.0,-46.0,-38.0,-47.0,-90.0,-91.0,-88.0,-90.0,47.0,45.0,52.0,43.0,1
1057,92:69:1D:31:68:E9,3855082,489360517,4195,3707062,3850887,485653455,1,5756,1232279,5575,1191076,181,41203,2325,12,4468,104,1,66,229410.0,130000.0,-51.0,-47.0,-42.0,-48.0,-51.0,-47.0,-43.0,-48.0,-90.0,-91.0,-88.0,-90.0,39.0,44.0,46.0,42.0,1
1058,CC:2F:71:3F:1F:24,5190104,2042268837,1339216,1556615322,3850888,485653515,2222,1130165,1303331647,1129282,1303224607,883,107040,1094035,15,1337351,125843,2219,858,130000.0,43333.0,-70.0,-70.0,-66.0,-72.0,-70.0,-69.0,-66.0,-72.0,-90.0,-91.0,-88.0,-90.0,20.0,21.0,22.0,18.0,1
1059,CC:2F:71:3E:C5:1F,3851918,485779344,1028,125627,3850890,485653717,3,4498,374837,3749,285925,749,88912,1088,14,1478,30,3,54,130000.0,39000.0,-72.0,-73.0,-69.0,-60.0,-71.0,-72.0,-69.0,-60.0,-90.0,-91.0,-88.0,-90.0,18.0,18.0,19.0,30.0,1
1060,BA:8C:B9:54:50:24,3855853,491851265,4963,6197548,3850890,485653717,7,10026,1770456,10004,1766961,22,3495,2361,18,5492,44,7,77,229410.0,130000.0,-48.0,-35.0,-43.0,-45.0,-46.0,-35.0,-43.0,-46.0,-90.0,-91.0,-88.0,-90.0,42.0,56.0,45.0,45.0,1
1061,62:47:05:9D:EB:15,3857966,497978517,7072,12324396,3850894,485654121,1,7569,3919582,7518,3911786,51,7796,3592,0,7155,56,1,127,216660.0,130000.0,-43.0,-46.0,-36.0,-47.0,-43.0,-46.0,-38.0,-47.0,-90.0,-91.0,-88.0,-90.0,47.0,45.0,52.0,43.0,1
1062,92:69:1D:31:68:E9,3855089,489361183,4195,3707062,3850894,485654121,1,5756,1232279,5575,1191076,181,41203,2325,12,4468,104,1,66,229410.0,130000.0,-51.0,-47.0,-42.0,-48.0,-51.0,-47.0,-43.0,-48.0,-90.0,-91.0,-88.0,-90.0,39.0,44.0,46.0,42.0,1
1063,CC:2F:71:3F:1F:24,5190470,2042727391,1339574,1557073068,3850896,485654323,2222,1130416,1303586742,1129533,1303479702,883,107040,1094276,15,1337709,125844,2219,858,130000.0,43333.0,-70.0,-69.0,-66.0,-71.0,-70.0,-68.0,-65.0,-71.0,-90.0,-91.0,-88.0,-90.0,20.0,22.0,22.0,19.0,1
1064,CC:2F:71:3E:C5:1F,3851924,485779950,1028,125627,3850896,485654323,3,4498,374837,3749,285925,749,88912,1088,14,1478,30,3,54,130000.0,39000.0,-72.0,-73.0,-69.0,-60.0,-71.0,-72.0,-69.0,-60.0,-90.0,-91.0,-88.0,-90.0,18.0,18.0,19.0,30.0,1
1065,BA:8C:B9:54:50:24,3855859,491851871,4963,6197548,3850896,485654323,7,10026,1770456,10004,1766961,22,3495,2361,18,5492,44,7,77,229410.0,130000.0,-48.0,-35.0,-43.0,-45.0,-46.0,-35.0,-43.0,-46.0,-90.0,-91.0,-88.0,-90.0,42.0,56.0,45.0,45.0,1
1066,62:47:05:9D:EB:15,3857968,497978719,7072,12324396,3850896,485654323,1,7570,3919650,7519,3911854,51,7796,3592,0,7155,56,1,127,216660.0,130000.0,-43.0,-46.0,-38.0,-49.0,-43.0,-46.0,-37.0,-47.0,-90.0,-91.0,-88.0,-90.0,47.0,45.0,50.0,41.0,1
1067,92:69:1D:31:68:E9,3855093,489361587,4195,3707062,3850898,485654525,1,5756,1232279,5575,1191076,181,41203,2325,12,4468,104,1,66,229410.0,130000.0,-51.0,-47.0,-42.0,-48.0,-51.0,-47.0,-43.0,-48.0,-90.0,-91.0,-88.0,-90.0,39.0,44.0,46.0,42.0,1
1068,CC:2F:71:3F:1F:24,5190663,2042970199,1339765,1557315674,3850898,485654525,2222,1130588,1303819090,1129705,1303712050,883,107040,1094446,15,1337901,125853,2219,858,130000.0,43333.0,-69.0,-69.0,-67.0,-72.0,-69.0,-69.0,-66.0,-71.0,-90.0,-91.0,-88.0,-90.0,21.0,22.0,21.0,18.0,1
1069,CC:2F:71:3E:C5:1F,3851926,485780152,1028,125627,3850898,485654525,3,4498,374837,3749,285925,749,88912,1088,14,1478,30,3,54,130000.0,39000.0,-72.0,-73.0,-69.0,-60.0,-71.0,-72.0,-69.0,-60.0,-90.0,-91.0,-88.0,-90.0,18.0,18.0,19.0,30.0,1
1070,BA:8C:B9:54:50:24,3855861,491852073,4963,6197548,3850898,485654525,7,10026,1770456,10004,1766961,22,3495,2361,18,5492,44,7,77,229410.0,130000.0,-48.0,-35.0,-43.0,-45.0,-46.0,-35.0,-43.0,-46.0,-90.0,-91.0,-88.0,-90.0,42.0,56.0,45.0,45.0,1
1071,62:47:05:9D:EB:15,3857975,497979385,7072,12324396,3850903,485654989,1,7570,3919650,7519,3911854,51,7796,3592,0,7155,56,1,127,216660.0,130000.0,-43.0,-46.0,-38.0,-49.0,-43.0,-46.0,-37.0,-47.0,-90.0,-91.0,-88.0,-90.0,47.0,45.0,50.0,41.0,1
1072,92:69:1D:31:68:E9,3855100,489362253,4195,3707062,3850905,485655191,1,5756,1232279,5575,1191076,181,41203,2325,12,4468,104,1,66,229410.0,130000.0,-51.0,-47.0,-42.0,-48.0,-51.0,-47.0,-43.0,-48.0,-90.0,-91.0,-88.0,-90.0,39.0,44.0,46.0,42.0,1
1073,CC:2F:71:3F:1F:24,5190861,2043212271,1339956,1557557080,3850905,485655191,2222,1130761,1304051644,1129878,1303944604,883,107040,1094614,15,1338092,125853,2219,858,130000.0,43333.0,-70.0,-69.0,-66.0,-72.0,-69.0,-69.0,-65.0,-72.0,-90.0,-91.0,-88.0,-90.0,20.0,22.0,22.0,18.0,1
1074,CC:2F:71:3E:C5:1F,3851933,485780818,1028,125627,3850905,485655191,3,4498,374837,3749,285925,749,88912,1088,14,1478,30,3,54,130000.0,39000.0,-72.0,-73.0,-69.0,-60.0,-71.0,-72.0,-69.0,-60.0,-90.0,-91.0,-88.0,-90.0,18.0,18.0,19.0,30.0,1
1075,BA:8C:B9:54:50:24,3855868,491852739,4963,6197548,3850905,485655191,7,10026,1770456,10004,1766961,22,3495,2361,18,5492,44,7,77,229410.0,130000.0,-48.0,-35.0,-43.0,-45.0,-46.0,-35.0,-43.0,-46.0,-90.0,-91.0,-88.0,-90.0,42.0,56.0,45.0,45.0,1
1076,62:47:05:9D:EB:15,3857980,497979905,7073,12324512,3850907,485655393,1,7571,3919718,7520,3911922,51,7796,3592,0,7156,56,1,127,216660.0,130000.0,-43.0,-45.0,-36.0,-47.0,-43.0,-46.0,-37.0,-47.0,-90.0,-91.0,-88.0,-90.0,47.0,46.0,52.0,43.0,1
1077,92:69:1D:31:68:E9,3855103,489362571,4196,3707178,3850907,485655393,1,5758,1232415,5577,1191212,181,41203,2325,12,4469,104,1,66,229410.0,130000.0,-52.0,-47.0,-42.0,-48.0,-51.0,-47.0,-43.0,-48.0,-89.0,-91.0,-88.0,-89.0,37.0,44.0,46.0,41.0,1
1078,CC:2F:71:3F:1F:24,5191062,2043457354,1340155,1557801961,3850907,485655393,2222,1130940,1304282475,1130057,1304175435,883,107040,1094789,15,1338291,125862,2219,858,117000.0,39000.0,-73.0,-72.0,-69.0,-74.0,-71.0,-70.0,-67.0,-72.0,-89.0,-91.0,-88.0,-89.0,16.0,19.0,19.0,15.0,1
1079,CC:2F:71:3E:C5:1F,3851936,485781136,1029,125743,3850907,485655393,3,4500,374977,3751,286065,749,88912,1088,14,1479,30,3,54,130000.0,39000.0,-72.0,-73.0,-68.0,-60.0,-71.0,-72.0,-68.0,-60.0,-89.0,-91.0,-88.0,-89.0,17.0,18.0,20.0,29.0,1
1080,BA:8C:B9:54:50:24,3855871,491853057,4964,6197664,3850907,485655393,7,10028,1770592,10006,1767097,22,3495,2361,18,5493,44,7,77,229410.0,130000.0,-48.0,-35.0,-42.0,-46.0,-45.0,-35.0,-43.0,-47.0,-89.0,-91.0,-88.0,-89.0,41.0,56.0,46.0,43.0,1
1081,62:47:05:9D:EB:15,3857986,497980511,7073,12324512,3850913,485655999,1,7572,3919786,7521,3911990,51,7796,3592,0,7156,56,1,127,216660.0,130000.0,-43.0,-45.0,-36.0,-47.0,-43.0,-46.0,-37.0,-47.0,-89.0,-91.0,-88.0,-89.0,46.0,46.0,52.0,42.0,1
1082,92:69:1D:31:68:E9,3855109,489363177,4196,3707178,3850913,485655999,1,5758,1232415,5577,1191212,181,41203,2325,12,4469,104,1,66,229410.0,130000.0,-52.0,-47.0,-42.0,-48.0,-51.0,-47.0,-43.0,-48.0,-89.0,-91.0,-88.0,-89.0,37.0,44.0,46.0,41.0,1
1083,CC:2F:71:3F:1F:24,5191259,2043699184,1340345,1558043125,3850914,485656059,2222,1131116,1304521109,1130233,1304414069,883,107040,1094957,15,1338481,125864,2219,858,130000.0,43333.0,-69.0,-69.0,-66.0,-72.0,-69.0,-69.0,-65.0,-71.0,-89.0,-91.0,-88.0,-89.0,20.0,22.0,22.0,17.0,1
1084,CC:2F:71:3E:C5:1F,3851943,485781802,1029,125743,3850914,485656059,3,4500,374977,3751,286065,749,88912,1088,14,1479,30,3,54,130000.0,39000.0,-72.0,-73.0,-68.0,-60.0,-71.0,-72.0,-68.0,-60.0,-89.0,-91.0,-88.0,-89.0,17.0,18.0,20.0,29.0,1
1085,BA:8C:B9:54:50:24,3855878,491853723,4964,6197664,3850914,485656059,7,10028,1770592,10006,1767097,22,3495,2361,18,5493,44,7,77,229410.0,130000.0,-48.0,-35.0,-42.0,-46.0,-45.0,-35.0,-43.0,-47.0,-89.0,-91.0,-88.0,-89.0,41.0,56.0,46.0,43.0,1
1086,62:47:05:9D:EB:15,3857989,497980773,7073,12324512,3850916,485656261,1,7572,3919786,7521,3911990,51,7796,3592,0,7156,56,1,127,216660.0,130000.0,-43.0,-45.0,-36.0,-47.0,-43.0,-46.0,-37.0,-47.0,-89.0,-91.0,-88.0,-89.0,46.0,46.0,52.0,42.0,1
1087,92:69:1D:31:68:E9,3855112,489363439,4196,3707178,3850916,485656261,1,5758,1232415,5577,1191212,181,41203,2325,12,4469,104,1,66,229410.0,130000.0,-52.0,-47.0,-42.0,-48.0,-51.0,-47.0,-43.0,-48.0,-89.0,-91.0,-88.0,-89.0,37.0,44.0,46.0,41.0,1
1088,CC:2F:71:3F:1F:24,5191615,2044170225,1340699,1558513964,3850916,485656261,2222,1131355,1304777287,1130472,1304670247,883,107040,1095194,15,1338833,125869,2219,858,130000.0,43333.0,-69.0,-68.0,-65.0,-71.0,-69.0,-68.0,-65.0,-71.0,-89.0,-91.0,-88.0,-89.0,20.0,23.0,23.0,18.0,1
1089,CC:2F:71:3E:C5:1F,3851945,485782004,1029,125743,3850916,485656261,3,4500,374977,3751,286065,749,88912,1088,14,1479,30,3,54,130000.0,39000.0,-72.0,-73.0,-68.0,-60.0,-71.0,-72.0,-68.0,-60.0,-89.0,-91.0,-88.0,-89.0,17.0,18.0,20.0,29.0,1
1090,BA:8C:B9:54:50:24,3855882,491854127,4964,6197664,3850918,485656463,7,10029,1770660,10007,1767165,22,3495,2361,18,5493,44,7,77,229410.0,130000.0,-40.0,-37.0,-46.0,-51.0,-45.0,-35.0,-43.0,-47.0,-89.0,-91.0,-88.0,-89.0,49.0,54.0,42.0,38.0,1
1091,62:47:05:9D:EB:15,3857996,497981652,7073,12324512,3850923,485657140,1,7572,3919786,7521,3911990,51,7796,3592,0,7156,56,1,127,216660.0,130000.0,-43.0,-45.0,-36.0,-47.0,-43.0,-46.0,-37.0,-47.0,-89.0,-90.0,-87.0,-89.0,46.0,45.0,51.0,42.0,1
1092,92:69:1D:31:68:E9,3855119,489364318,4196,3707178,3850923,485657140,1,5758,1232415,5577,1191212,181,41203,2325,12,4469,104,1,66,229410.0,130000.0,-52.0,-47.0,-42.0,-48.0,-51.0,-47.0,-43.0,-48.0,-89.0,-90.0,-87.0,-89.0,37.0,43.0,45.0,41.0,1
1093,CC:2F:71:3F:1F:24,5192061,2044698957,1341138,1559041817,3850923,485657140,2222,1131663,1305028170,1130780,1304921130,883,107040,1095500,15,1339274,125887,2219,858,130000.0,43333.0,-69.0,-69.0,-65.0,-72.0,-69.0,-68.0,-65.0,-71.0,-89.0,-90.0,-87.0,-89.0,20.0,21.0,22.0,17.0,1
1094,CC:2F:71:3E:C5:1F,3851952,485782883,1029,125743,3850923,485657140,3,4500,374977,3751,286065,749,88912,1088,14,1479,30,3,54,130000.0,39000.0,-72.0,-73.0,-68.0,-60.0,-71.0,-72.0,-68.0,-60.0,-89.0,-90.0,-87.0,-89.0,17.0,17.0,19.0,29.0,1
1095,BA:8C:B9:54:50:24,3855887,491854804,4964,6197664,3850923,485657140,7,10029,1770660,10007,1767165,22,3495,2361,18,5493,44,7,77,229410.0,130000.0,-40.0,-37.0,-46.0,-51.0,-45.0,-35.0,-43.0,-47.0,-89.0,-90.0,-87.0,-89.0,49.0,53.0,41.0,38.0,1
1096,62:47:05:9D:EB:15,3857999,497981914,7073,12324512,3850926,485657402,1,7572,3919786,7521,3911990,51,7796,3592,0,7156,56,1,127,216660.0,130000.0,-43.0,-45.0,-36.0,-47.0,-43.0,-46.0,-37.0,-47.0,-89.0,-90.0,-87.0,-88.0,46.0,45.0,51.0,41.0,1
1097,92:69:1D:31:68:E9,3855122,489364580,4196,3707178,3850926,485657402,1,5758,1232415,5577,1191212,181,41203,2325,12,4469,104,1,66,229410.0,130000.0,-52.0,-47.0,-42.0,-48.0,-51.0,-47.0,-43.0,-48.0,-89.0,-90.0,-87.0,-88.0,37.0,43.0,45.0,40.0,1
1098,CC:2F:71:3F:1F:24,5192603,2045396179,1341675,1559738575,3850928,485657604,2222,1131989,1305277831,1131106,1305170791,883,107040,1095823,15,1339811,125894,2219,858,130000.0,43333.0,-69.0,-68.0,-66.0,-71.0,-69.0,-68.0,-65.0,-71.0,-89.0,-90.0,-87.0,-88.0,20.0,22.0,21.0,17.0,1
1099,CC:2F:71:3E:C5:1F,3851957,485783347,1029,125743,3850928,485657604,3,4500,374977,3751,286065,749,88912,1088,14,1479,30,3,54,130000.0,39000.0,-72.0,-73.0,-68.0,-60.0,-71.0,-72.0,-68.0,-60.0,-89.0,-90.0,-87.0,-88.0,17.0,17.0,19.0,28.0,1
1100,BA:8C:B9:54:50:24,3855894,491855470,4964,6197664,3850930,485657806,7,10029,1770660,10007,1767165,22,3495,2361,18,5493,44,7,77,229410.0,130000.0,-40.0,-37.0,-46.0,-51.0,-45.0,-35.0,-43.0,-47.0,-89.0,-90.0,-87.0,-88.0,49.0,53.0,41.0,37.0,1
1101,62:47:05:9D:EB:15,3858005,497982520,7073,12324512,3850932,485658008,1,7574,3919922,7523,3912126,51,7796,3592,0,7156,56,1,127,216660.0,130000.0,-44.0,-51.0,-46.0,-45.0,-43.0,-46.0,-38.0,-46.0,-89.0,-90.0,-87.0,-88.0,45.0,39.0,41.0,43.0,1
1102,92:69:1D:31:68:E9,3855128,489365186,4196,3707178,3850932,485658008,1,5758,1232415,5577,1191212,181,41203,2325,12,4469,104,1,66,229410.0,130000.0,-52.0,-47.0,-42.0,-48.0,-51.0,-47.0,-43.0,-48.0,-89.0,-90.0,-87.0,-88.0,37.0,43.0,45.0,40.0,1
1103,CC:2F:71:3F:1F:24,5193038,2045926535,1342106,1560268527,3850932,485658008,2222,1132283,1305528457,1131400,1305421417,883,107040,1096114,15,1340242,125916,2219,858,130000.0,39000.0,-70.0,-69.0,-66.0,-71.0,-70.0,-69.0,-66.0,-71.0,-89.0,-90.0,-87.0,-88.0,19.0,21.0,21.0,17.0,1
1104,CC:2F:71:3E:C5:1F,3851961,485783751,1029,125743,3850932,485658008,3,4500,374977,3751,286065,749,88912,1088,14,1479,30,3,54,130000.0,39000.0,-72.0,-73.0,-68.0,-60.0,-71.0,-72.0,-68.0,-60.0,-89.0,-90.0,-87.0,-88.0,17.0,17.0,19.0,28.0,1
1105,BA:8C:B9:54:50:24,3855896,491855672,4964,6197664,3850932,485658008,7,10029,1770660,10007,1767165,22,3495,2361,18,5493,44,7,77,229410.0,130000.0,-40.0,-37.0,-46.0,-51.0,-45.0,-35.0,-43.0,-47.0,-89.0,-90.0,-87.0,-88.0,49.0,53.0,41.0,37.0,1
1106,62:47:05:9D:EB:15,3858011,497983046,7073,12324512,3850938,485658534,1,7575,3919990,7524,3912194,51,7796,3592,0,7156,56,1,127,216660.0,130000.0,-43.0,-45.0,-36.0,-47.0,-43.0,-46.0,-38.0,-46.0,-89.0,-90.0,-87.0,-88.0,46.0,45.0,51.0,41.0,1
1107,92:69:1D:31:68:E9,3855134,489365712,4196,3707178,3850938,485658534,1,5758,1232415,5577,1191212,181,41203,2325,12,4469,104,1,66,229410.0,130000.0,-52.0,-47.0,-42.0,-48.0,-51.0,-47.0,-43.0,-48.0,-89.0,-90.0,-87.0,-88.0,37.0,43.0,45.0,40.0,1
1108,CC:2F:71:3F:1F:24,5193236,2046168483,1342296,1560509747,3850940,485658736,2222,1132458,1305764157,1131574,1305656999,884,107158,1096283,15,1340432,125916,2219,859,130000.0,43333.0,-70.0,-69.0,-68.0,-73.0,-69.0,-68.0,-67.0,-72.0,-89.0,-90.0,-87.0,-88.0,19.0,21.0,19.0,15.0,1
1109,CC:2F:71:3E:C5:1F,3851969,485784479,1029,125743,3850940,485658736,3,4500,374977,3751,286065,749,88912,1088,14,1479,30,3,54,130000.0,39000.0,-72.0,-73.0,-68.0,-60.0,-71.0,-72.0,-68.0,-60.0,-89.0,-90.0,-87.0,-88.0,17.0,17.0,19.0,28.0,1
1110,BA:8C:B9:54:50:24,3855904,491856400,4964,6197664,3850940,485658736,7,10029,1770660,10007,1767165,22,3495,2361,18,5493,44,7,77,229410.0,130000.0,-40.0,-37.0,-46.0,-51.0,-45.0,-35.0,-43.0,-47.0,-89.0,-89.0,-86.0,-87.0,49.0,52.0,40.0,36.0,1
1111,62:47:05:9D:EB:15,3858015,497983450,7073,12324512,3850942,485658938,1,7575,3919990,7524,3912194,51,7796,3592,0,7156,56,1,127,216660.0,130000.0,-43.0,-45.0,-36.0,-47.0,-43.0,-46.0,-38.0,-46.0,-89.0,-89.0,-86.0,-87.0,46.0,44.0,50.0,40.0,1
1112,92:69:1D:31:68:E9,3855138,489366116,4196,3707178,3850942,485658938,1,5758,1232415,5577,1191212,181,41203,2325,12,4469,104,1,66,229410.0,130000.0,-52.0,-47.0,-42.0,-48.0,-51.0,-47.0,-43.0,-48.0,-89.0,-89.0,-86.0,-87.0,37.0,42.0,44.0,39.0,1
1113,CC:2F:71:3F:1F:24,5193429,2046410091,1342487,1560751153,3850942,485658938,2222,1132630,1305993657,1131746,1305886499,884,107158,1096453,15,1340623,125916,2219,859,130000.0,43333.0,-72.0,-70.0,-70.0,-73.0,-71.0,-69.0,-69.0,-73.0,-89.0,-89.0,-86.0,-87.0,17.0,19.0,16.0,14.0,1
1114,CC:2F:71:3E:C5:1F,3851971,485784681,1029,125743,3850942,485658938,3,4500,374977,3751,286065,749,88912,1088,14,1479,30,3,54,130000.0,39000.0,-72.0,-73.0,-68.0,-60.0,-71.0,-72.0,-68.0,-60.0,-89.0,-89.0,-86.0,-87.0,17.0,16.0,18.0,27.0,1
1115,BA:8C:B9:54:50:24,3855906,491856602,4964,6197664,3850942,485658938,7,10029,1770660,10007,1767165,22,3495,2361,18,5493,44,7,77,229410.0,130000.0,-40.0,-37.0,-46.0,-51.0,-45.0,-35.0,-43.0,-47.0,-89.0,-89.0,-86.0,-87.0,49.0,52.0,40.0,36.0,1
1116,62:47:05:9D:EB:15,3858019,497983854,7073,12324512,3850946,485659342,1,7575,3919990,7524,3912194,51,7796,3592,0,7156,56,1,127,216660.0,130000.0,-43.0,-45.0,-36.0,-47.0,-43.0,-46.0,-38.0,-46.0,-89.0,-89.0,-86.0,-87.0,46.0,44.0,50.0,40.0,1
1117,92:69:1D:31:68:E9,3855144,489366722,4196,3707178,3850948,485659544,1,5758,1232415,5577,1191212,181,41203,2325,12,4469,104,1,66,229410.0,130000.0,-52.0,-47.0,-42.0,-48.0,-51.0,-47.0,-43.0,-48.0,-89.0,-89.0,-86.0,-87.0,37.0,42.0,44.0,39.0,1
1118,CC:2F:71:3F:1F:24,5193626,2046651935,1342678,1560992391,3850948,485659544,2222,1132803,1306226163,1131919,1306119005,884,107158,1096621,15,1340813,125916,2219,859,144444.0,43333.0,-70.0,-68.0,-66.0,-71.0,-69.0,-68.0,-66.0,-70.0,-89.0,-89.0,-86.0,-87.0,19.0,21.0,20.0,16.0,1
1119,CC:2F:71:3E:C5:1F,3851977,485785287,1029,125743,3850948,485659544,3,4500,374977,3751,286065,749,88912,1088,14,1479,30,3,54,130000.0,39000.0,-72.0,-73.0,-68.0,-60.0,-71.0,-72.0,-68.0,-60.0,-89.0,-89.0,-86.0,-87.0,17.0,16.0,18.0,27.0,1
1120,BA:8C:B9:54:50:24,3855912,491857208,4964,6197664,3850948,485659544,7,10029,1770660,10007,1767165,22,3495,2361,18,5493,44,7,77,229410.0,130000.0,-40.0,-37.0,-46.0,-51.0,-45.0,-35.0,-43.0,-47.0,-89.0,-89.0,-86.0,-87.0,49.0,52.0,40.0,36.0,1
1121,62:47:05:9D:EB:15,3858024,497984318,7073,12324512,3850951,485659806,1,7575,3919990,7524,3912194,51,7796,3592,0,7156,56,1,127,216660.0,130000.0,-43.0,-45.0,-36.0,-47.0,-43.0,-46.0,-38.0,-46.0,-88.0,-89.0,-85.0,-87.0,45.0,44.0,49.0,40.0,1
1122,92:69:1D:31:68:E9,3855147,489366984,4196,3707178,3850951,485659806,1,5758,1232415,5577,1191212,181,41203,2325,12,4469,104,1,66,229410.0,130000.0,-52.0,-47.0,-42.0,-48.0,-51.0,-47.0,-43.0,-48.0,-88.0,-89.0,-85.0,-87.0,36.0,42.0,43.0,39.0,1
1123,CC:2F:71:3F:1F:24,5193827,2046897074,1342876,1561237268,3850951,485659806,2222,1132983,1306461395,1132099,1306354237,884,107158,1096796,15,1341011,125916,2219,859,144444.0,43333.0,-69.0,-69.0,-66.0,-70.0,-69.0,-69.0,-66.0,-70.0,-88.0,-89.0,-85.0,-87.0,19.0,20.0,19.0,17.0,1
1124,CC:2F:71:3E:C5:1F,3851980,485785549,1029,125743,3850951,485659806,3,4500,374977,3751,286065,749,88912,1088,14,1479,30,3,54,130000.0,39000.0,-72.0,-73.0,-68.0,-60.0,-71.0,-72.0,-68.0,-60.0,-88.0,-89.0,-85.0,-87.0,16.0,16.0,17.0,27.0,1
1125,BA:8C:B9:54:50:24,3855915,491857470,4964,6197664,3850951,485659806,7,10029,1770660,10007,1767165,22,3495,2361,18,5493,44,7,77,229410.0,130000.0,-40.0,-37.0,-46.0,-51.0,-45.0,-35.0,-43.0,-47.0,-88.0,-89.0,-85.0,-87.0,48.0,52.0,39.0,36.0,1
1126,62:47:05:9D:EB:15,3858030,497984924,7073,12324512,3850957,485660412,1,7576,3920058,7525,3912262,51,7796,3592,0,7156,56,1,127,216660.0,130000.0,-44.0,-44.0,-36.0,-48.0,-43.0,-45.0,-37.0,-47.0,-88.0,-89.0,-85.0,-87.0,44.0,45.0,49.0,39.0,1
1127,92:69:1D:31:68:E9,3855153,489367590,4196,3707178,3850957,485660412,1,5758,1232415,5577,1191212,181,41203,2325,12,4469,104,1,66,229410.0,130000.0,-52.0,-47.0,-42.0,-48.0,-51.0,-47.0,-43.0,-48.0,-88.0,-89.0,-85.0,-87.0,36.0,42.0,43.0,39.0,1
1128,CC:2F:71:3F:1F:24,5194024,2047139086,1343067,1561478674,3850957,485660412,2222,1133164,1306705117,1132280,1306597959,884,107158,1096965,15,1341203,125920,2219,860,144444.0,43333.0,-70.0,-70.0,-67.0,-71.0,-70.0,-69.0,-66.0,-70.0,-88.0,-89.0,-85.0,-87.0,18.0,19.0,18.0,16.0,1
1129,CC:2F:71:3E:C5:1F,3851986,485786155,1029,125743,3850957,485660412,3,4500,374977,3751,286065,749,88912,1088,14,1479,30,3,54,130000.0,39000.0,-72.0,-73.0,-68.0,-60.0,-71.0,-72.0,-68.0,-60.0,-88.0,-89.0,-85.0,-87.0,16.0,16.0,17.0,27.0,1
1130,BA:8C:B9:54:50:24,3855921,491858076,4964,6197664,3850957,485660412,7,10029,1770660,10007,1767165,22,3495,2361,18,5493,44,7,77,229410.0,130000.0,-40.0,-37.0,-46.0,-51.0,-45.0,-35.0,-43.0,-47.0,-88.0,-89.0,-85.0,-87.0,48.0,52.0,39.0,36.0,1
1131,62:47:05:9D:EB:15,3858033,497985188,7073,12324512,3850960,485660676,1,7577,3920126,7526,3912330,51,7796,3592,0,7156,56,1,127,216660.0,130000.0,-43.0,-44.0,-36.0,-48.0,-43.0,-45.0,-37.0,-47.0,-88.0,-89.0,-85.0,-87.0,45.0,45.0,49.0,39.0,1
1132,92:69:1D:31:68:E9,3855157,489367914,4196,3707178,3850961,485660736,1,5758,1232415,5577,1191212,181,41203,2325,12,4469,104,1,66,229410.0,130000.0,-52.0,-47.0,-42.0,-48.0,-51.0,-47.0,-43.0,-48.0,-88.0,-89.0,-85.0,-87.0,36.0,42.0,43.0,39.0,1
1133,CC:2F:71:3F:1F:24,5194221,2047383924,1343260,1561723188,3850961,485660736,2222,1133344,1306947163,1132460,1306840005,884,107158,1097136,15,1341396,125922,2219,860,144444.0,43333.0,-71.0,-70.0,-67.0,-71.0,-70.0,-69.0,-66.0,-71.0,-88.0,-89.0,-85.0,-87.0,17.0,19.0,18.0,16.0,1
1134,CC:2F:71:3E:C5:1F,3851990,485786479,1029,125743,3850961,485660736,3,4502,375165,3752,286135,750,89030,1089,14,1479,30,3,54,130000.0,39000.0,-73.0,-73.0,-68.0,-60.0,-72.0,-73.0,-68.0,-60.0,-88.0,-89.0,-85.0,-87.0,15.0,16.0,17.0,27.0,1
1135,BA:8C:B9:54:50:24,3855925,491858400,4964,6197664,3850961,485660736,7,10029,1770660,10007,1767165,22,3495,2361,18,5493,44,7,77,229410.0,130000.0,-40.0,-37.0,-46.0,-51.0,-45.0,-35.0,-43.0,-47.0,-88.0,-88.0,-85.0,-86.0,48.0,51.0,39.0,35.0,1
1136,62:47:05:9D:EB:15,3858040,497985854,7073,12324512,3850967,485661342,1,7577,3920126,7526,3912330,51,7796,3592,0,7156,56,1,127,216660.0,130000.0,-43.0,-44.0,-36.0,-48.0,-43.0,-45.0,-37.0,-47.0,-88.0,-88.0,-85.0,-86.0,45.0,44.0,49.0,38.0,1
1137,92:69:1D:31:68:E9,3855163,489368520,4196,3707178,3850967,485661342,1,5758,1232415,5577,1191212,181,41203,2325,12,4469,104,1,66,229410.0,130000.0,-52.0,-47.0,-42.0,-48.0,-51.0,-47.0,-43.0,-48.0,-88.0,-88.0,-85.0,-86.0,36.0,41.0,43.0,38.0,1
1138,CC:2F:71:3F:1F:24,5194418,2047628784,1343451,1561967442,3850967,485661342,2222,1133515,1307176699,1132631,1307069541,884,107158,1097304,15,1341587,125922,2219,860,144444.0,43333.0,-71.0,-69.0,-67.0,-71.0,-71.0,-69.0,-66.0,-71.0,-88.0,-88.0,-85.0,-86.0,17.0,19.0,18.0,15.0,1
1139,CC:2F:71:3E:C5:1F,3851996,485787085,1029,125743,3850967,485661342,3,4502,375165,3752,286135,750,89030,1089,14,1479,30,3,54,130000.0,39000.0,-73.0,-73.0,-68.0,-60.0,-72.0,-73.0,-68.0,-60.0,-88.0,-88.0,-85.0,-86.0,15.0,15.0,17.0,26.0,1
1140,BA:8C:B9:54:50:24,3855931,491859006,4964,6197664,3850967,485661342,7,10029,1770660,10007,1767165,22,3495,2361,18,5493,44,7,77,229410.0,130000.0,-40.0,-37.0,-46.0,-51.0,-45.0,-35.0,-43.0,-47.0,-88.0,-88.0,-85.0,-86.0,48.0,51.0,39.0,35.0,1
1141,62:47:05:9D:EB:15,3858042,497986056,7073,12324512,3850969,485661544,1,7577,3920126,7526,3912330,51,7796,3592,0,7156,56,1,127,216660.0,130000.0,-43.0,-44.0,-36.0,-48.0,-43.0,-45.0,-37.0,-47.0,-88.0,-87.0,-84.0,-85.0,45.0,43.0,48.0,37.0,1
1142,92:69:1D:31:68:E9,3855165,489368722,4196,3707178,3850969,485661544,1,5760,1232551,5579,1191348,181,41203,2325,12,4470,104,1,66,229410.0,130000.0,-51.0,-48.0,-42.0,-48.0,-51.0,-47.0,-43.0,-48.0,-88.0,-87.0,-84.0,-85.0,37.0,39.0,42.0,37.0,1
1143,CC:2F:71:3F:1F:24,5194615,2047872049,1343646,1562210505,3850969,485661544,2222,1133697,1307411072,1132813,1307303914,884,107158,1097479,15,1341781,125924,2219,860,144444.0,43333.0,-70.0,-69.0,-67.0,-71.0,-70.0,-69.0,-66.0,-71.0,-88.0,-87.0,-84.0,-85.0,18.0,18.0,17.0,14.0,1
1144,CC:2F:71:3E:C5:1F,3851998,485787287,1029,125743,3850969,485661544,3,4502,375165,3752,286135,750,89030,1089,14,1479,30,3,54,130000.0,39000.0,-73.0,-73.0,-68.0,-60.0,-72.0,-73.0,-68.0,-60.0,-88.0,-87.0,-84.0,-85.0,15.0,14.0,16.0,25.0,1
1145,BA:8C:B9:54:50:24,3855933,491859208,4964,6197664,3850969,485661544,7,10031,1770796,10009,1767301,22,3495,2361,18,5494,44,7,78,229410.0,130000.0,-48.0,-35.0,-43.0,-46.0,-45.0,-35.0,-43.0,-47.0,-88.0,-87.0,-84.0,-85.0,40.0,52.0,41.0,39.0,1
1146,62:47:05:9D:EB:15,3858049,497986722,7073,12324512,3850976,485662210,1,7577,3920126,7526,3912330,51,7796,3592,0,7156,56,1,127,216660.0,130000.0,-43.0,-44.0,-36.0,-48.0,-43.0,-45.0,-37.0,-47.0,-88.0,-87.0,-84.0,-85.0,45.0,43.0,48.0,37.0,1
1147,92:69:1D:31:68:E9,3855172,489369388,4196,3707178,3850976,485662210,1,5760,1232551,5579,1191348,181,41203,2325,12,4470,104,1,66,229410.0,130000.0,-51.0,-48.0,-42.0,-48.0,-51.0,-47.0,-43.0,-48.0,-88.0,-87.0,-84.0,-85.0,37.0,39.0,42.0,37.0,1
1148,CC:2F:71:3F:1F:24,5194811,2048112437,1343835,1562450227,3850976,485662210,2222,1133871,1307643822,1132987,1307536664,884,107158,1097648,15,1341971,125925,2219,860,144444.0,43333.0,-71.0,-70.0,-66.0,-72.0,-70.0,-69.0,-66.0,-71.0,-88.0,-87.0,-84.0,-85.0,17.0,17.0,18.0,13.0,1
1149,CC:2F:71:3E:C5:1F,3852005,485787953,1029,125743,3850976,485662210,3,4502,375165,3752,286135,750,89030,1089,14,1479,30,3,54,130000.0,39000.0,-73.0,-73.0,-68.0,-60.0,-72.0,-73.0,-68.0,-60.0,-88.0,-87.0,-84.0,-85.0,15.0,14.0,16.0,25.0,1
1150,BA:8C:B9:54:50:24,3855941,491860008,4964,6197664,3850977,485662344,7,10031,1770796,10009,1767301,22,3495,2361,18,5494,44,7,78,229410.0,130000.0,-48.0,-35.0,-43.0,-46.0,-45.0,-35.0,-43.0,-47.0,-88.0,-87.0,-84.0,-85.0,40.0,52.0,41.0,39.0,1
1151,62:47:05:9D:EB:15,3858053,497987134,7073,12324512,3850980,485662622,1,7577,3920126,7526,3912330,51,7796,3592,0,7156,56,1,127,216660.0,130000.0,-43.0,-44.0,-36.0,-48.0,-43.0,-45.0,-37.0,-47.0,-88.0,-87.0,-84.0,-85.0,45.0,43.0,48.0,37.0,1
1152,92:69:1D:31:68:E9,3855176,489369800,4196,3707178,3850980,485662622,1,5760,1232551,5579,1191348,181,41203,2325,12,4470,104,1,66,229410.0,130000.0,-51.0,-48.0,-42.0,-48.0,-51.0,-47.0,-43.0,-48.0,-88.0,-87.0,-84.0,-84.0,37.0,39.0,42.0,36.0,1
1153,CC:2F:71:3F:1F:24,5195006,2048354398,1344025,1562691503,3850981,485662895,2222,1134050,1307881638,1133166,1307774480,884,107158,1097817,15,1342161,125925,2219,860,144444.0,43333.0,-70.0,-69.0,-68.0,-71.0,-70.0,-69.0,-67.0,-71.0,-88.0,-87.0,-84.0,-84.0,18.0,18.0,16.0,13.0,1
1154,CC:2F:71:3E:C5:1F,3852010,485788638,1029,125743,3850981,485662895,3,4502,375165,3752,286135,750,89030,1089,14,1479,30,3,54,130000.0,39000.0,-73.0,-73.0,-68.0,-60.0,-72.0,-73.0,-68.0,-60.0,-88.0,-87.0,-84.0,-84.0,15.0,14.0,16.0,24.0,1
1155,BA:8C:B9:54:50:24,3855945,491860559,4964,6197664,3850981,485662895,7,10031,1770796,10009,1767301,22,3495,2361,18,5494,44,7,78,229410.0,130000.0,-48.0,-35.0,-43.0,-46.0,-45.0,-35.0,-43.0,-47.0,-88.0,-87.0,-84.0,-84.0,40.0,52.0,41.0,38.0,1
1156,62:47:05:9D:EB:15,3858060,497988013,7073,12324512,3850987,485663501,1,7577,3920126,7526,3912330,51,7796,3592,0,7156,56,1,127,216660.0,130000.0,-43.0,-44.0,-36.0,-48.0,-43.0,-45.0,-37.0,-47.0,-88.0,-87.0,-84.0,-84.0,45.0,43.0,48.0,36.0,1
1157,92:69:1D:31:68:E9,3855184,489370739,4196,3707178,3850988,485663561,1,5760,1232551,5579,1191348,181,41203,2325,12,4470,104,1,66,229410.0,130000.0,-51.0,-48.0,-42.0,-48.0,-51.0,-47.0,-43.0,-48.0,-88.0,-87.0,-84.0,-84.0,37.0,39.0,42.0,36.0,1
1158,CC:2F:71:3F:1F:24,5195204,2048596470,1344216,1562932909,3850988,485663561,2222,1134226,1308117354,1133342,1308010196,884,107158,1097987,15,1342352,125925,2219,860,144444.0,43333.0,-71.0,-69.0,-67.0,-71.0,-70.0,-69.0,-66.0,-71.0,-88.0,-87.0,-84.0,-84.0,17.0,18.0,17.0,13.0,1
1159,CC:2F:71:3E:C5:1F,3852019,485790428,1029,125743,3850990,485664685,3,4502,375165,3752,286135,750,89030,1089,14,1479,30,3,54,130000.0,39000.0,-73.0,-73.0,-68.0,-60.0,-72.0,-73.0,-68.0,-60.0,-88.0,-87.0,-84.0,-84.0,15.0,14.0,16.0,24.0,1
1160,BA:8C:B9:54:50:24,3855956,491862551,4964,6197664,3850992,485664887,7,10031,1770796,10009,1767301,22,3495,2361,18,5494,44,7,78,229410.0,130000.0,-48.0,-35.0,-43.0,-46.0,-45.0,-35.0,-43.0,-47.0,-88.0,-87.0,-84.0,-84.0,40.0,52.0,41.0,38.0,1
1161,62:47:05:9D:EB:15,3858065,497989399,7073,12324512,3850992,485664887,1,7577,3920126,7526,3912330,51,7796,3592,0,7156,56,1,127,216660.0,130000.0,-43.0,-44.0,-36.0,-48.0,-43.0,-45.0,-37.0,-47.0,-87.0,-86.0,-83.0,-84.0,44.0,42.0,47.0,36.0,1
1162,92:69:1D:31:68:E9,3855188,489372065,4196,3707178,3850992,485664887,1,5760,1232551,5579,1191348,181,41203,2325,12,4470,104,1,66,229410.0,130000.0,-51.0,-48.0,-42.0,-48.0,-51.0,-47.0,-43.0,-48.0,-87.0,-86.0,-83.0,-84.0,36.0,38.0,41.0,36.0,1
1163,CC:2F:71:3F:1F:24,5195411,2048851867,1344419,1563186980,3850992,485664887,2222,1134415,1308362436,1133531,1308255278,884,107158,1098169,15,1342555,125927,2219,860,144444.0,43333.0,-71.0,-69.0,-66.0,-71.0,-71.0,-69.0,-65.0,-70.0,-87.0,-86.0,-83.0,-84.0,16.0,17.0,17.0,13.0,1
1164,CC:2F:71:3E:C5:1F,3852023,485790832,1029,125743,3850994,485665089,3,4502,375165,3752,286135,750,89030,1089,14,1479,30,3,54,130000.0,39000.0,-73.0,-73.0,-68.0,-60.0,-72.0,-73.0,-68.0,-60.0,-87.0,-86.0,-83.0,-84.0,14.0,13.0,15.0,24.0,1
1165,BA:8C:B9:54:50:24,3855958,491862753,4964,6197664,3850994,485665089,7,10031,1770796,10009,1767301,22,3495,2361,18,5494,44,7,78,229410.0,130000.0,-48.0,-35.0,-43.0,-46.0,-45.0,-35.0,-43.0,-47.0,-87.0,-86.0,-83.0,-84.0,39.0,51.0,40.0,38.0,1
1166,62:47:05:9D:EB:15,3858073,497991129,7073,12324512,3851000,485666617,1,7577,3920126,7526,3912330,51,7796,3592,0,7156,56,1,127,216660.0,130000.0,-43.0,-44.0,-36.0,-48.0,-43.0,-45.0,-37.0,-47.0,-87.0,-86.0,-83.0,-83.0,44.0,42.0,47.0,35.0,1
1167,92:69:1D:31:68:E9,3855196,489373795,4196,3707178,3851000,485666617,1,5760,1232551,5579,1191348,181,41203,2325,12,4470,104,1,66,229410.0,130000.0,-51.0,-48.0,-42.0,-48.0,-51.0,-47.0,-43.0,-48.0,-87.0,-86.0,-83.0,-83.0,36.0,38.0,41.0,35.0,1
1168,CC:2F:71:3F:1F:24,5195619,2049107507,1344617,1563440688,3851002,485666819,2222,1134605,1308617044,1133721,1308509886,884,107158,1098347,15,1342753,125929,2219,860,144444.0,43333.0,-70.0,-69.0,-68.0,-71.0,-70.0,-69.0,-67.0,-70.0,-87.0,-86.0,-83.0,-83.0,17.0,17.0,15.0,12.0,1
1169,CC:2F:71:3E:C5:1F,3852031,485792562,1029,125743,3851002,485666819,3,4502,375165,3752,286135,750,89030,1089,14,1479,30,3,54,130000.0,39000.0,-73.0,-73.0,-68.0,-60.0,-72.0,-73.0,-68.0,-60.0,-87.0,-86.0,-83.0,-83.0,14.0,13.0,15.0,23.0,1
1170,BA:8C:B9:54:50:24,3855966,491864483,4964,6197664,3851002,485666819,7,10031,1770796,10009,1767301,22,3495,2361,18,5494,44,7,78,229410.0,130000.0,-48.0,-35.0,-43.0,-46.0,-45.0,-35.0,-43.0,-47.0,-87.0,-86.0,-83.0,-83.0,39.0,51.0,40.0,37.0,1
1171,62:47:05:9D:EB:15,3858076,497991391,7073,12324512,3851003,485666879,1,7577,3920126,7526,3912330,51,7796,3592,0,7156,56,1,127,216660.0,130000.0,-43.0,-44.0,-36.0,-48.0,-43.0,-45.0,-37.0,-47.0,-87.0,-86.0,-83.0,-83.0,44.0,42.0,47.0,35.0,1
1172,92:69:1D:31:68:E9,3855201,489374259,4196,3707178,3851005,485667081,1,5760,1232551,5579,1191348,181,41203,2325,12,4470,104,1,66,229410.0,130000.0,-51.0,-48.0,-42.0,-48.0,-51.0,-47.0,-43.0,-48.0,-87.0,-86.0,-83.0,-83.0,36.0,38.0,41.0,35.0,1
1173,CC:2F:71:3F:1F:24,5195817,2049355377,1344812,1563688296,3851005,485667081,2222,1134790,1308865338,1133906,1308758180,884,107158,1098522,15,1342948,125937,2219,860,144444.0,43333.0,-71.0,-69.0,-68.0,-71.0,-70.0,-69.0,-67.0,-70.0,-87.0,-86.0,-83.0,-83.0,16.0,17.0,15.0,12.0,1
1174,CC:2F:71:3E:C5:1F,3852034,485792824,1029,125743,3851005,485667081,3,4502,375165,3752,286135,750,89030,1089,14,1479,30,3,54,130000.0,39000.0,-73.0,-73.0,-68.0,-60.0,-72.0,-73.0,-68.0,-60.0,-87.0,-86.0,-83.0,-83.0,14.0,13.0,15.0,23.0,1
1175,BA:8C:B9:54:50:24,3855971,491864947,4964,6197664,3851007,485667283,7,10031,1770796,10009,1767301,22,3495,2361,18,5494,44,7,78,229410.0,130000.0,-48.0,-35.0,-43.0,-46.0,-45.0,-35.0,-43.0,-47.0,-87.0,-86.0,-83.0,-83.0,39.0,51.0,40.0,37.0,1
1176,62:47:05:9D:EB:15,3858086,497993323,7073,12324512,3851013,485668811,1,7577,3920126,7526,3912330,51,7796,3592,0,7156,56,1,127,216660.0,130000.0,-43.0,-44.0,-36.0,-48.0,-43.0,-45.0,-37.0,-47.0,-87.0,-86.0,-83.0,-83.0,44.0,42.0,47.0,35.0,1
1177,92:69:1D:31:68:E9,3855209,489375989,4196,3707178,3851013,485668811,1,5760,1232551,5579,1191348,181,41203,2325,12,4470,104,1,66,229410.0,130000.0,-51.0,-48.0,-42.0,-48.0,-51.0,-47.0,-43.0,-48.0,-87.0,-86.0,-83.0,-83.0,36.0,38.0,41.0,35.0,1
1178,CC:2F:71:3F:1F:24,5196025,2049607940,1345012,1563939129,3851013,485668811,2222,1134978,1309110086,1134094,1309002928,884,107158,1098702,15,1343148,125945,2219,860,144444.0,43333.0,-70.0,-69.0,-68.0,-71.0,-70.0,-69.0,-67.0,-70.0,-87.0,-86.0,-83.0,-83.0,17.0,17.0,15.0,12.0,1
1179,CC:2F:71:3E:C5:1F,3852042,485794554,1029,125743,3851013,485668811,3,4502,375165,3752,286135,750,89030,1089,14,1479,30,3,54,130000.0,39000.0,-73.0,-73.0,-68.0,-60.0,-72.0,-73.0,-68.0,-60.0,-87.0,-86.0,-83.0,-83.0,14.0,13.0,15.0,23.0,1
1180,BA:8C:B9:54:50:24,3855977,491866475,4964,6197664,3851013,485668811,7,10031,1770796,10009,1767301,22,3495,2361,18,5494,44,7,78,229410.0,130000.0,-48.0,-35.0,-43.0,-46.0,-45.0,-35.0,-43.0,-47.0,-87.0,-86.0,-83.0,-83.0,39.0,51.0,40.0,37.0,1
1181,62:47:05:9D:EB:15,3858089,497993585,7073,12324512,3851016,485669073,1,7577,3920126,7526,3912330,51,7796,3592,0,7156,56,1,127,216660.0,130000.0,-43.0,-44.0,-36.0,-48.0,-43.0,-45.0,-37.0,-47.0,-87.0,-86.0,-83.0,-83.0,44.0,42.0,47.0,35.0,1
1182,92:69:1D:31:68:E9,3855212,489376251,4196,3707178,3851016,485669073,1,5761,1232619,5580,1191416,181,41203,2325,12,4470,104,1,66,229410.0,130000.0,-51.0,-46.0,-44.0,-49.0,-51.0,-47.0,-43.0,-48.0,-87.0,-86.0,-83.0,-83.0,36.0,40.0,39.0,34.0,1
1183,CC:2F:71:3F:1F:24,5196221,2049849810,1345203,1564180535,3851018,485669275,2222,1135158,1309347766,1134274,1309240608,884,107158,1098874,15,1343339,125956,2219,860,144444.0,43333.0,-70.0,-69.0,-68.0,-71.0,-70.0,-69.0,-68.0,-71.0,-87.0,-86.0,-83.0,-83.0,17.0,17.0,15.0,12.0,1
1184,CC:2F:71:3E:C5:1F,3852047,485795018,1029,125743,3851018,485669275,3,4502,375165,3752,286135,750,89030,1089,14,1479,30,3,54,130000.0,39000.0,-73.0,-73.0,-68.0,-60.0,-72.0,-73.0,-68.0,-60.0,-87.0,-85.0,-82.0,-83.0,14.0,12.0,14.0,23.0,1
1185,BA:8C:B9:54:50:24,3855982,491866939,4964,6197664,3851018,485669275,7,10031,1770796,10009,1767301,22,3495,2361,18,5494,44,7,78,229410.0,130000.0,-48.0,-35.0,-43.0,-46.0,-45.0,-35.0,-43.0,-47.0,-87.0,-85.0,-82.0,-83.0,39.0,50.0,39.0,37.0,1
1186,62:47:05:9D:EB:15,3858095,497994191,7073,12324512,3851022,485669679,1,7577,3920126,7526,3912330,51,7796,3592,0,7156,56,1,127,216660.0,130000.0,-43.0,-44.0,-36.0,-48.0,-43.0,-45.0,-37.0,-47.0,-87.0,-85.0,-82.0,-83.0,44.0,41.0,46.0,35.0,1
1187,92:69:1D:31:68:E9,3855218,489376857,4196,3707178,3851022,485669679,1,5761,1232619,5580,1191416,181,41203,2325,12,4470,104,1,66,229410.0,130000.0,-51.0,-46.0,-44.0,-49.0,-51.0,-47.0,-43.0,-48.0,-87.0,-85.0,-82.0,-83.0,36.0,39.0,38.0,34.0,1
1188,CC:2F:71:3F:1F:24,5196418,2050094714,1345396,1564425035,3851022,485669679,2222,1135342,1309593000,1134458,1309485842,884,107158,1099048,15,1343532,126000,2219,860,144444.0,43333.0,-70.0,-69.0,-68.0,-71.0,-69.0,-69.0,-67.0,-71.0,-87.0,-85.0,-82.0,-83.0,17.0,16.0,14.0,12.0,1
1189,CC:2F:71:3E:C5:1F,3852051,485795422,1029,125743,3851022,485669679,3,4502,375165,3752,286135,750,89030,1089,14,1479,30,3,54,130000.0,39000.0,-73.0,-73.0,-68.0,-60.0,-72.0,-73.0,-68.0,-60.0,-87.0,-85.0,-82.0,-83.0,14.0,12.0,14.0,23.0,1
1190,BA:8C:B9:54:50:24,3855986,491867343,4964,6197664,3851022,485669679,7,10031,1770796,10009,1767301,22,3495,2361,18,5494,44,7,78,229410.0,130000.0,-48.0,-35.0,-43.0,-46.0,-45.0,-35.0,-43.0,-47.0,-87.0,-85.0,-82.0,-83.0,39.0,50.0,39.0,37.0,1
1191,62:47:05:9D:EB:15,3858100,497995202,7074,12325119,3851026,485670083,1,7579,3920262,7528,3912466,51,7796,3592,0,7157,56,1,127,216660.0,130000.0,-44.0,-46.0,-36.0,-47.0,-43.0,-45.0,-37.0,-47.0,-87.0,-85.0,-82.0,-83.0,43.0,39.0,46.0,36.0,1
1192,92:69:1D:31:68:E9,3855222,489377261,4196,3707178,3851026,485670083,1,5761,1232619,5580,1191416,181,41203,2325,12,4470,104,1,66,229410.0,130000.0,-51.0,-46.0,-44.0,-49.0,-51.0,-47.0,-43.0,-48.0,-87.0,-85.0,-82.0,-83.0,36.0,39.0,38.0,34.0,1
1193,CC:2F:71:3F:1F:24,5196613,2050336524,1345587,1564666441,3851026,485670083,2222,1135516,1309825726,1134632,1309718568,884,107158,1099217,15,1343723,126005,2219,861,144444.0,43333.0,-70.0,-69.0,-68.0,-71.0,-69.0,-69.0,-67.0,-71.0,-87.0,-85.0,-82.0,-83.0,17.0,16.0,14.0,12.0,1
1194,CC:2F:71:3E:C5:1F,3852055,485795826,1029,125743,3851026,485670083,3,4502,375165,3752,286135,750,89030,1089,14,1479,30,3,54,130000.0,39000.0,-73.0,-73.0,-68.0,-60.0,-72.0,-73.0,-68.0,-60.0,-87.0,-85.0,-82.0,-83.0,14.0,12.0,14.0,23.0,1
1195,BA:8C:B9:54:50:24,3855992,491867949,4964,6197664,3851028,485670285,7,10031,1770796,10009,1767301,22,3495,2361,18,5494,44,7,78,229410.0,130000.0,-48.0,-35.0,-43.0,-46.0,-45.0,-35.0,-43.0,-47.0,-87.0,-85.0,-82.0,-83.0,39.0,50.0,39.0,37.0,1
1196,62:47:05:9D:EB:15,3858105,497995666,7074,12325119,3851031,485670547,1,7579,3920262,7528,3912466,51,7796,3592,0,7157,56,1,127,216660.0,130000.0,-44.0,-46.0,-36.0,-47.0,-43.0,-45.0,-37.0,-47.0,-87.0,-85.0,-82.0,-82.0,43.0,39.0,46.0,35.0,1
1197,92:69:1D:31:68:E9,3855227,489377725,4196,3707178,3851031,485670547,1,5761,1232619,5580,1191416,181,41203,2325,12,4470,104,1,66,229410.0,130000.0,-51.0,-46.0,-44.0,-49.0,-51.0,-47.0,-43.0,-48.0,-87.0,-85.0,-82.0,-82.0,36.0,39.0,38.0,33.0,1
1198,CC:2F:71:3F:1F:24,5196817,2050585062,1345786,1564914515,3851031,485670547,2222,1135702,1310061890,1134818,1309954732,884,107158,1099397,15,1343922,126009,2219,861,144444.0,43333.0,-69.0,-68.0,-67.0,-70.0,-69.0,-68.0,-67.0,-70.0,-87.0,-85.0,-82.0,-82.0,18.0,17.0,15.0,12.0,1
1199,CC:2F:71:3E:C5:1F,3852060,485796290,1029,125743,3851031,485670547,3,4502,375165,3752,286135,750,89030,1089,14,1479,30,3,54,130000.0,39000.0,-73.0,-73.0,-68.0,-60.0,-72.0,-73.0,-68.0,-60.0,-87.0,-85.0,-82.0,-82.0,14.0,12.0,14.0,22.0,1
1200,BA:8C:B9:54:50:24,3855995,491868211,4964,6197664,3851031,485670547,7,10031,1770796,10009,1767301,22,3495,2361,18,5494,44,7,78,229410.0,130000.0,-48.0,-35.0,-43.0,-46.0,-45.0,-35.0,-43.0,-47.0,-87.0,-85.0,-82.0,-82.0,39.0,50.0,39.0,36.0,1
1201,62:47:05:9D:EB:15,3858110,497996186,7075,12325235,3851035,485670951,1,7580,3920330,7529,3912534,51,7796,3592,0,7158,56,1,127,216660.0,130000.0,-44.0,-46.0,-36.0,-48.0,-43.0,-45.0,-37.0,-47.0,-87.0,-85.0,-82.0,-82.0,43.0,39.0,46.0,34.0,1
1202,92:69:1D:31:68:E9,3855232,489378245,4197,3707294,3851035,485670951,1,5763,1232755,5582,1191552,181,41203,2325,12,4471,104,1,66,229410.0,130000.0,-50.0,-47.0,-42.0,-48.0,-51.0,-46.0,-43.0,-48.0,-87.0,-85.0,-82.0,-82.0,37.0,38.0,40.0,34.0,1
1203,CC:2F:71:3F:1F:24,5197019,2050833356,1345980,1565161993,3851039,485671363,2222,1135876,1310295894,1134992,1310188736,884,107158,1099569,15,1344116,126014,2219,861,144444.0,43333.0,-69.0,-68.0,-67.0,-71.0,-69.0,-68.0,-67.0,-70.0,-87.0,-85.0,-82.0,-82.0,18.0,17.0,15.0,11.0,1
1204,CC:2F:71:3E:C5:1F,3852069,485797222,1030,125859,3851039,485671363,3,4504,375305,3754,286275,750,89030,1089,14,1480,30,3,54,130000.0,39000.0,-72.0,-72.0,-68.0,-60.0,-72.0,-72.0,-68.0,-60.0,-87.0,-85.0,-82.0,-82.0,15.0,13.0,14.0,22.0,1
1205,BA:8C:B9:54:50:24,3856004,491869143,4965,6197780,3851039,485671363,7,10034,1771000,10012,1767505,22,3495,2361,18,5495,44,7,78,229410.0,130000.0,-48.0,-35.0,-42.0,-46.0,-46.0,-35.0,-43.0,-47.0,-87.0,-85.0,-82.0,-82.0,39.0,50.0,40.0,36.0,1
1206,62:47:05:9D:EB:15,3858119,497997048,7075,12325235,3851044,485671813,1,7581,3920398,7530,3912602,51,7796,3592,0,7158,56,1,127,216660.0,130000.0,-44.0,-46.0,-36.0,-47.0,-43.0,-46.0,-37.0,-47.0,-87.0,-85.0,-82.0,-82.0,43.0,39.0,46.0,35.0,1
1207,92:69:1D:31:68:E9,3855241,489379107,4197,3707294,3851044,485671813,1,5763,1232755,5582,1191552,181,41203,2325,12,4471,104,1,66,229410.0,130000.0,-50.0,-47.0,-42.0,-48.0,-51.0,-46.0,-43.0,-48.0,-87.0,-85.0,-82.0,-82.0,37.0,38.0,40.0,34.0,1
1208,CC:2F:71:3F:1F:24,5197214,2051075082,1346170,1565403269,3851044,485671813,2222,1136047,1310523950,1135163,1310416792,884,107158,1099738,15,1344306,126018,2219,861,144444.0,43333.0,-69.0,-68.0,-67.0,-71.0,-69.0,-68.0,-67.0,-71.0,-87.0,-85.0,-82.0,-82.0,18.0,17.0,15.0,11.0,1
1209,CC:2F:71:3E:C5:1F,3852074,485797672,1030,125859,3851044,485671813,3,4506,375493,3755,286345,751,89148,1090,14,1480,30,3,54,130000.0,39000.0,-72.0,-72.0,-68.0,-60.0,-72.0,-72.0,-68.0,-60.0,-87.0,-85.0,-82.0,-82.0,15.0,13.0,14.0,22.0,1
1210,BA:8C:B9:54:50:24,3856009,491869593,4965,6197780,3851044,485671813,7,10034,1771000,10012,1767505,22,3495,2361,18,5495,44,7,78,229410.0,130000.0,-48.0,-35.0,-42.0,-46.0,-46.0,-35.0,-43.0,-47.0,-87.0,-85.0,-82.0,-82.0,39.0,50.0,40.0,36.0,1
1211,62:47:05:9D:EB:15,3858125,497997654,7075,12325235,3851050,485672419,1,7581,3920398,7530,3912602,51,7796,3592,0,7158,56,1,127,216660.0,130000.0,-44.0,-46.0,-36.0,-47.0,-43.0,-46.0,-37.0,-47.0,-87.0,-85.0,-82.0,-82.0,43.0,39.0,46.0,35.0,1
1212,92:69:1D:31:68:E9,3855247,489379713,4197,3707294,3851050,485672419,1,5763,1232755,5582,1191552,181,41203,2325,12,4471,104,1,66,229410.0,130000.0,-50.0,-47.0,-42.0,-48.0,-51.0,-46.0,-43.0,-48.0,-87.0,-85.0,-82.0,-82.0,37.0,38.0,40.0,34.0,1
1213,CC:2F:71:3F:1F:24,5197414,2051320332,1346364,1565647913,3851050,485672419,2222,1136224,1310759862,1135340,1310652704,884,107158,1099909,15,1344500,126019,2219,861,144444.0,43333.0,-69.0,-68.0,-67.0,-70.0,-69.0,-68.0,-67.0,-70.0,-87.0,-85.0,-82.0,-82.0,18.0,17.0,15.0,12.0,1
1214,CC:2F:71:3E:C5:1F,3852080,485798278,1030,125859,3851050,485672419,3,4506,375493,3755,286345,751,89148,1090,14,1480,30,3,54,130000.0,39000.0,-72.0,-72.0,-68.0,-60.0,-72.0,-72.0,-68.0,-60.0,-87.0,-85.0,-82.0,-82.0,15.0,13.0,14.0,22.0,1
1215,BA:8C:B9:54:50:24,3856015,491870199,4965,6197780,3851050,485672419,7,10034,1771000,10012,1767505,22,3495,2361,18,5495,44,7,78,229410.0,130000.0,-48.0,-35.0,-42.0,-46.0,-46.0,-35.0,-43.0,-47.0,-87.0,-85.0,-82.0,-82.0,39.0,50.0,40.0,36.0,1
1216,62:47:05:9D:EB:15,3858128,497998129,7075,12325235,3851053,485672894,1,7581,3920398,7530,3912602,51,7796,3592,0,7158,56,1,127,216660.0,130000.0,-44.0,-46.0,-36.0,-47.0,-43.0,-46.0,-37.0,-47.0,-87.0,-85.0,-82.0,-82.0,43.0,39.0,46.0,35.0,1
1217,92:69:1D:31:68:E9,3855250,489380188,4197,3707294,3851053,485672894,1,5763,1232755,5582,1191552,181,41203,2325,12,4471,104,1,66,229410.0,130000.0,-50.0,-47.0,-42.0,-48.0,-51.0,-46.0,-43.0,-48.0,-87.0,-85.0,-82.0,-82.0,37.0,38.0,40.0,34.0,1
1218,CC:2F:71:3F:1F:24,5197614,2051565386,1346561,1565892492,3851053,485672894,2222,1136409,1311001414,1135525,1310894256,884,107158,1100086,15,1344697,126023,2219,861,144444.0,43333.0,-69.0,-68.0,-67.0,-71.0,-69.0,-68.0,-67.0,-70.0,-87.0,-85.0,-82.0,-82.0,18.0,17.0,15.0,11.0,1
1219,CC:2F:71:3E:C5:1F,3852083,485798753,1030,125859,3851053,485672894,3,4506,375493,3755,286345,751,89148,1090,14,1480,30,3,54,130000.0,39000.0,-72.0,-72.0,-68.0,-60.0,-72.0,-72.0,-68.0,-60.0,-87.0,-85.0,-82.0,-82.0,15.0,13.0,14.0,22.0,1
1220,BA:8C:B9:54:50:24,3856018,491870674,4965,6197780,3851053,485672894,7,10034,1771000,10012,1767505,22,3495,2361,18,5495,44,7,78,229410.0,130000.0,-48.0,-35.0,-42.0,-46.0,-46.0,-35.0,-43.0,-47.0,-87.0,-85.0,-82.0,-82.0,39.0,50.0,40.0,36.0,1
1221,62:47:05:9D:EB:15,3858135,497998795,7075,12325235,3851060,485673560,1,7581,3920398,7530,3912602,51,7796,3592,0,7158,56,1,127,216660.0,130000.0,-44.0,-46.0,-36.0,-47.0,-43.0,-46.0,-37.0,-47.0,-87.0,-84.0,-81.0,-81.0,43.0,38.0,45.0,34.0,1
1222,92:69:1D:31:68:E9,3855257,489380854,4197,3707294,3851060,485673560,1,5763,1232755,5582,1191552,181,41203,2325,12,4471,104,1,66,229410.0,130000.0,-50.0,-47.0,-42.0,-48.0,-51.0,-46.0,-43.0,-48.0,-87.0,-84.0,-81.0,-81.0,37.0,37.0,39.0,33.0,1
1223,CC:2F:71:3F:1F:24,5197813,2051810436,1346753,1566136876,3851060,485673560,2222,1136586,1311241560,1135702,1311134402,884,107158,1100254,15,1344887,126026,2219,861,144444.0,43333.0,-69.0,-68.0,-67.0,-71.0,-69.0,-68.0,-67.0,-70.0,-87.0,-84.0,-81.0,-81.0,18.0,16.0,14.0,10.0,1
1224,CC:2F:71:3E:C5:1F,3852090,485799419,1030,125859,3851060,485673560,3,4506,375493,3755,286345,751,89148,1090,14,1480,30,3,54,130000.0,39000.0,-72.0,-72.0,-68.0,-60.0,-72.0,-72.0,-68.0,-60.0,-87.0,-84.0,-81.0,-81.0,15.0,12.0,13.0,21.0,1
1225,BA:8C:B9:54:50:24,3856025,491871340,4965,6197780,3851060,485673560,7,10034,1771000,10012,1767505,22,3495,2361,18,5495,44,7,78,229410.0,130000.0,-48.0,-35.0,-42.0,-46.0,-46.0,-35.0,-43.0,-47.0,-87.0,-84.0,-81.0,-81.0,39.0,49.0,39.0,35.0,1
1226,62:47:05:9D:EB:15,3858137,497998997,7075,12325235,3851062,485673762,1,7581,3920398,7530,3912602,51,7796,3592,0,7158,56,1,127,216660.0,130000.0,-44.0,-46.0,-36.0,-47.0,-43.0,-46.0,-37.0,-47.0,-87.0,-84.0,-81.0,-81.0,43.0,38.0,45.0,34.0,1
1227,92:69:1D:31:68:E9,3855261,489381424,4197,3707294,3851064,485674130,1,5763,1232755,5582,1191552,181,41203,2325,12,4471,104,1,66,229410.0,130000.0,-50.0,-47.0,-42.0,-48.0,-51.0,-46.0,-43.0,-48.0,-87.0,-84.0,-81.0,-81.0,37.0,37.0,39.0,33.0,1
1228,CC:2F:71:3F:1F:24,5198011,2052055650,1346947,1566381520,3851064,485674130,2222,1136772,1311491608,1135888,1311384450,884,107158,1100428,15,1345083,126029,2219,861,144444.0,43333.0,-69.0,-69.0,-68.0,-70.0,-68.0,-68.0,-67.0,-70.0,-87.0,-84.0,-81.0,-81.0,18.0,15.0,13.0,11.0,1
1229,CC:2F:71:3E:C5:1F,3852094,485799989,1030,125859,3851064,485674130,3,4506,375493,3755,286345,751,89148,1090,14,1480,30,3,54,130000.0,39000.0,-72.0,-72.0,-68.0,-60.0,-72.0,-72.0,-68.0,-60.0,-87.0,-84.0,-81.0,-81.0,15.0,12.0,13.0,21.0,1
1230,BA:8C:B9:54:50:24,3856029,491871910,4965,6197780,3851064,485674130,7,10034,1771000,10012,1767505,22,3495,2361,18,5495,44,7,78,229410.0,130000.0,-48.0,-35.0,-42.0,-46.0,-46.0,-35.0,-43.0,-47.0,-87.0,-84.0,-81.0,-81.0,39.0,49.0,39.0,35.0,1
1231,62:47:05:9D:EB:15,3858147,498000093,7075,12325235,3851072,485674858,1,7581,3920398,7530,3912602,51,7796,3592,0,7158,56,1,127,216660.0,130000.0,-44.0,-46.0,-36.0,-47.0,-43.0,-46.0,-37.0,-47.0,-87.0,-84.0,-81.0,-81.0,43.0,38.0,45.0,34.0,1
1232,92:69:1D:31:68:E9,3855269,489382152,4197,3707294,3851072,485674858,1,5763,1232755,5582,1191552,181,41203,2325,12,4471,104,1,66,229410.0,130000.0,-50.0,-47.0,-42.0,-48.0,-51.0,-46.0,-43.0,-48.0,-87.0,-84.0,-81.0,-81.0,37.0,37.0,39.0,33.0,1
1233,CC:2F:71:3F:1F:24,5198216,2052301125,1347144,1566626267,3851072,485674858,2222,1136952,1311725405,1136067,1311618129,885,107276,1100604,15,1345280,126033,2219,861,144444.0,43333.0,-69.0,-68.0,-67.0,-71.0,-69.0,-68.0,-66.0,-70.0,-87.0,-84.0,-81.0,-81.0,18.0,16.0,14.0,10.0,1
1234,CC:2F:71:3E:C5:1F,3852102,485800717,1030,125859,3851072,485674858,3,4506,375493,3755,286345,751,89148,1090,14,1480,30,3,54,130000.0,39000.0,-72.0,-72.0,-68.0,-60.0,-72.0,-72.0,-68.0,-60.0,-87.0,-84.0,-81.0,-81.0,15.0,12.0,13.0,21.0,1
1235,BA:8C:B9:54:50:24,3856037,491872638,4965,6197780,3851072,485674858,7,10034,1771000,10012,1767505,22,3495,2361,18,5495,44,7,78,229410.0,130000.0,-48.0,-35.0,-42.0,-46.0,-46.0,-35.0,-43.0,-47.0,-87.0,-84.0,-81.0,-81.0,39.0,49.0,39.0,35.0,1
1236,62:47:05:9D:EB:15,3858149,498000295,7075,12325235,3851074,485675060,1,7581,3920398,7530,3912602,51,7796,3592,0,7158,56,1,127,216660.0,130000.0,-44.0,-46.0,-36.0,-47.0,-43.0,-46.0,-37.0,-47.0,-87.0,-84.0,-81.0,-81.0,43.0,38.0,45.0,34.0,1
1237,92:69:1D:31:68:E9,3855271,489382354,4197,3707294,3851074,485675060,1,5763,1232755,5582,1191552,181,41203,2325,12,4471,104,1,66,229410.0,130000.0,-50.0,-47.0,-42.0,-48.0,-51.0,-46.0,-43.0,-48.0,-87.0,-84.0,-81.0,-81.0,37.0,37.0,39.0,33.0,1
1238,CC:2F:71:3F:1F:24,5198409,2052542733,1347335,1566867673,3851074,485675060,2222,1137134,1311964879,1136249,1311857603,885,107276,1100775,15,1345471,126036,2219,861,144444.0,43333.0,-70.0,-69.0,-67.0,-71.0,-70.0,-69.0,-66.0,-70.0,-87.0,-84.0,-81.0,-81.0,17.0,15.0,14.0,10.0,1
1239,CC:2F:71:3E:C5:1F,3852104,485800919,1030,125859,3851074,485675060,3,4506,375493,3755,286345,751,89148,1090,14,1480,30,3,54,130000.0,39000.0,-72.0,-72.0,-68.0,-60.0,-72.0,-72.0,-68.0,-60.0,-87.0,-84.0,-81.0,-81.0,15.0,12.0,13.0,21.0,1
1240,BA:8C:B9:54:50:24,3856041,491873042,4965,6197780,3851076,485675262,7,10034,1771000,10012,1767505,22,3495,2361,18,5495,44,7,78,229410.0,130000.0,-48.0,-35.0,-42.0,-46.0,-46.0,-35.0,-43.0,-47.0,-87.0,-84.0,-81.0,-81.0,39.0,49.0,39.0,35.0,1
1241,62:47:05:9D:EB:15,3858155,498000901,7075,12325235,3851080,485675666,1,7581,3920398,7530,3912602,51,7796,3592,0,7158,56,1,127,216660.0,130000.0,-44.0,-46.0,-36.0,-47.0,-43.0,-46.0,-37.0,-47.0,-87.0,-84.0,-81.0,-81.0,43.0,38.0,45.0,34.0,1
1242,92:69:1D:31:68:E9,3855277,489382960,4197,3707294,3851080,485675666,1,5763,1232755,5582,1191552,181,41203,2325,12,4471,104,1,66,229410.0,130000.0,-50.0,-47.0,-42.0,-48.0,-51.0,-46.0,-43.0,-48.0,-87.0,-84.0,-81.0,-81.0,37.0,37.0,39.0,33.0,1
1243,CC:2F:71:3F:1F:24,5198604,2052784485,1347524,1567108819,3851080,485675666,2222,1137308,1312197549,1136423,1312090273,885,107276,1100944,15,1345660,126036,2219,861,144444.0,43333.0,-70.0,-68.0,-67.0,-71.0,-70.0,-68.0,-66.0,-71.0,-87.0,-84.0,-81.0,-81.0,17.0,16.0,14.0,10.0,1
1244,CC:2F:71:3E:C5:1F,3852110,485801525,1030,125859,3851080,485675666,3,4506,375493,3755,286345,751,89148,1090,14,1480,30,3,54,130000.0,39000.0,-72.0,-72.0,-68.0,-60.0,-72.0,-72.0,-68.0,-60.0,-87.0,-84.0,-81.0,-81.0,15.0,12.0,13.0,21.0,1
1245,BA:8C:B9:54:50:24,3856045,491873446,4965,6197780,3851080,485675666,7,10034,1771000,10012,1767505,22,3495,2361,18,5495,44,7,78,229410.0,130000.0,-48.0,-35.0,-42.0,-46.0,-46.0,-35.0,-43.0,-47.0,-87.0,-84.0,-81.0,-81.0,39.0,49.0,39.0,35.0,1
1246,62:47:05:9D:EB:15,3858158,498001163,7075,12325235,3851083,485675928,1,7581,3920398,7530,3912602,51,7796,3592,0,7158,56,1,127,216660.0,130000.0,-44.0,-46.0,-36.0,-47.0,-43.0,-46.0,-37.0,-47.0,-87.0,-84.0,-81.0,-81.0,43.0,38.0,45.0,34.0,1
1247,92:69:1D:31:68:E9,3855280,489383222,4197,3707294,3851083,485675928,1,5763,1232755,5582,1191552,181,41203,2325,12,4471,104,1,66,229410.0,130000.0,-50.0,-47.0,-42.0,-48.0,-51.0,-46.0,-43.0,-48.0,-87.0,-84.0,-81.0,-81.0,37.0,37.0,39.0,33.0,1
1248,CC:2F:71:3F:1F:24,5198798,2053029001,1347715,1567353073,3851083,485675928,2222,1137489,1312442445,1136604,1312335169,885,107276,1101115,15,1345851,126040,2219,861,144444.0,43333.0,-70.0,-68.0,-67.0,-71.0,-70.0,-68.0,-66.0,-70.0,-87.0,-84.0,-81.0,-81.0,17.0,16.0,14.0,10.0,1
1249,CC:2F:71:3E:C5:1F,3852115,485801989,1030,125859,3851085,485676130,3,4506,375493,3755,286345,751,89148,1090,14,1480,30,3,54,130000.0,39000.0,-72.0,-72.0,-68.0,-60.0,-72.0,-72.0,-68.0,-60.0,-87.0,-84.0,-81.0,-81.0,15.0,12.0,13.0,21.0,1
1250,BA:8C:B9:54:50:24,3856052,491874112,4965,6197780,3851087,485676332,7,10034,1771000,10012,1767505,22,3495,2361,18,5495,44,7,78,229410.0,130000.0,-48.0,-35.0,-42.0,-46.0,-46.0,-35.0,-43.0,-47.0,-87.0,-84.0,-81.0,-81.0,39.0,49.0,39.0,35.0,1
1251,62:47:05:9D:EB:15,3858164,498001769,7075,12325235,3851089,485676534,1,7581,3920398,7530,3912602,51,7796,3592,0,7158,56,1,127,216660.0,130000.0,-44.0,-46.0,-36.0,-47.0,-43.0,-46.0,-37.0,-47.0,-87.0,-84.0,-81.0,-81.0,43.0,38.0,45.0,34.0,1
1252,92:69:1D:31:68:E9,3855286,489383828,4197,3707294,3851089,485676534,1,5763,1232755,5582,1191552,181,41203,2325,12,4471,104,1,66,229410.0,130000.0,-50.0,-47.0,-42.0,-48.0,-51.0,-46.0,-43.0,-48.0,-87.0,-84.0,-81.0,-81.0,37.0,37.0,39.0,33.0,1
1253,CC:2F:71:3F:1F:24,5199001,2053275778,1347912,1567599244,3851089,485676534,2222,1137676,1312684337,1136791,1312577061,885,107276,1101292,15,1346048,126048,2219,861,144444.0,43333.0,-70.0,-68.0,-67.0,-71.0,-70.0,-68.0,-66.0,-71.0,-87.0,-84.0,-81.0,-81.0,17.0,16.0,14.0,10.0,1
1254,CC:2F:71:3E:C5:1F,3852119,485802393,1030,125859,3851089,485676534,3,4506,375493,3755,286345,751,89148,1090,14,1480,30,3,54,130000.0,39000.0,-72.0,-72.0,-68.0,-60.0,-72.0,-72.0,-68.0,-60.0,-87.0,-84.0,-81.0,-81.0,15.0,12.0,13.0,21.0,1
1255,BA:8C:B9:54:50:24,3856054,491874314,4965,6197780,3851089,485676534,7,10034,1771000,10012,1767505,22,3495,2361,18,5495,44,7,78,229410.0,130000.0,-48.0,-35.0,-42.0,-46.0,-46.0,-35.0,-43.0,-47.0,-87.0,-84.0,-81.0,-81.0,39.0,49.0,39.0,35.0,1
1256,62:47:05:9D:EB:15,3858167,498002031,7075,12325235,3851092,485676796,1,7582,3920466,7531,3912670,51,7796,3592,0,7158,56,1,127,216660.0,130000.0,-44.0,-45.0,-36.0,-48.0,-43.0,-45.0,-36.0,-47.0,-87.0,-84.0,-81.0,-81.0,43.0,39.0,45.0,33.0,1
1257,92:69:1D:31:68:E9,3855291,489384292,4197,3707294,3851094,485676998,1,5763,1232755,5582,1191552,181,41203,2325,12,4471,104,1,66,229410.0,130000.0,-50.0,-47.0,-42.0,-48.0,-51.0,-46.0,-43.0,-48.0,-87.0,-84.0,-81.0,-81.0,37.0,37.0,39.0,33.0,1
1258,CC:2F:71:3F:1F:24,5199195,2053515964,1348101,1567838966,3851094,485676998,2222,1137851,1312919937,1136966,1312812661,885,107276,1101461,15,1346237,126052,2219,861,144444.0,43333.0,-70.0,-68.0,-67.0,-71.0,-70.0,-68.0,-67.0,-71.0,-87.0,-84.0,-81.0,-81.0,17.0,16.0,14.0,10.0,1
1259,CC:2F:71:3E:C5:1F,3852126,485803059,1030,125859,3851096,485677200,3,4506,375493,3755,286345,751,89148,1090,14,1480,30,3,54,130000.0,39000.0,-72.0,-72.0,-68.0,-60.0,-72.0,-72.0,-68.0,-60.0,-87.0,-84.0,-81.0,-81.0,15.0,12.0,13.0,21.0,1
1260,BA:8C:B9:54:50:24,3856061,491874980,4965,6197780,3851096,485677200,7,10034,1771000,10012,1767505,22,3495,2361,18,5495,44,7,78,229410.0,130000.0,-48.0,-35.0,-42.0,-46.0,-46.0,-35.0,-43.0,-47.0,-87.0,-84.0,-81.0,-81.0,39.0,49.0,39.0,35.0,1
1261,62:47:05:9D:EB:15,3858173,498002637,7075,12325235,3851098,485677402,1,7582,3920466,7531,3912670,51,7796,3592,0,7158,56,1,127,216660.0,130000.0,-44.0,-45.0,-36.0,-48.0,-43.0,-45.0,-36.0,-47.0,-87.0,-84.0,-81.0,-81.0,43.0,39.0,45.0,33.0,1
1262,92:69:1D:31:68:E9,3855295,489384696,4197,3707294,3851098,485677402,1,5763,1232755,5582,1191552,181,41203,2325,12,4471,104,1,66,229410.0,130000.0,-50.0,-47.0,-42.0,-48.0,-51.0,-46.0,-43.0,-48.0,-87.0,-84.0,-81.0,-81.0,37.0,37.0,39.0,33.0,1
1263,CC:2F:71:3F:1F:24,5199395,2053764120,1348297,1568086718,3851098,485677402,2222,1138032,1313160647,1137147,1313053371,885,107276,1101635,15,1346433,126056,2219,861,144444.0,43333.0,-70.0,-69.0,-67.0,-71.0,-70.0,-69.0,-66.0,-70.0,-87.0,-84.0,-81.0,-81.0,17.0,15.0,14.0,10.0,1
1264,CC:2F:71:3E:C5:1F,3852128,485803261,1030,125859,3851098,485677402,3,4506,375493,3755,286345,751,89148,1090,14,1480,30,3,54,130000.0,39000.0,-72.0,-72.0,-68.0,-60.0,-72.0,-72.0,-68.0,-60.0,-87.0,-84.0,-81.0,-81.0,15.0,12.0,13.0,21.0,1
1265,BA:8C:B9:54:50:24,3856063,491875182,4965,6197780,3851098,485677402,7,10034,1771000,10012,1767505,22,3495,2361,18,5495,44,7,78,229410.0,130000.0,-48.0,-35.0,-42.0,-46.0,-46.0,-35.0,-43.0,-47.0,-87.0,-84.0,-81.0,-81.0,39.0,49.0,39.0,35.0,1
1266,62:47:05:9D:EB:15,3858177,498003041,7075,12325235,3851102,485677806,1,7582,3920466,7531,3912670,51,7796,3592,0,7158,56,1,127,216660.0,130000.0,-44.0,-45.0,-36.0,-48.0,-43.0,-45.0,-36.0,-47.0,-87.0,-85.0,-82.0,-82.0,43.0,40.0,46.0,34.0,1
1267,92:69:1D:31:68:E9,3855301,489385302,4197,3707294,3851104,485678008,1,5765,1232891,5584,1191688,181,41203,2325,12,4472,104,1,66,229410.0,130000.0,-52.0,-48.0,-46.0,-48.0,-51.0,-46.0,-43.0,-48.0,-87.0,-85.0,-82.0,-82.0,35.0,37.0,36.0,34.0,1
1268,CC:2F:71:3F:1F:24,5199594,2054009240,1348490,1568331232,3851104,485678008,2222,1138206,1313394755,1137321,1313287479,885,107276,1101805,15,1346626,126059,2219,861,144444.0,43333.0,-69.0,-69.0,-66.0,-71.0,-69.0,-68.0,-66.0,-71.0,-87.0,-85.0,-82.0,-82.0,18.0,16.0,16.0,11.0,1
1269,CC:2F:71:3E:C5:1F,3852134,485803867,1030,125859,3851104,485678008,3,4508,375633,3757,286485,751,89148,1090,14,1481,30,3,54,130000.0,39000.0,-71.0,-73.0,-68.0,-61.0,-72.0,-72.0,-68.0,-60.0,-87.0,-85.0,-82.0,-82.0,16.0,12.0,14.0,21.0,1
1270,BA:8C:B9:54:50:24,3856069,491875788,4965,6197780,3851104,485678008,7,10036,1771136,10014,1767641,22,3495,2361,18,5496,44,7,78,229410.0,130000.0,-48.0,-35.0,-43.0,-46.0,-46.0,-35.0,-43.0,-47.0,-87.0,-85.0,-82.0,-82.0,39.0,50.0,39.0,36.0,1
1271,62:47:05:9D:EB:15,3858182,498003505,7075,12325235,3851107,485678270,1,7582,3920466,7531,3912670,51,7796,3592,0,7158,56,1,127,216660.0,130000.0,-44.0,-45.0,-36.0,-48.0,-43.0,-45.0,-36.0,-47.0,-87.0,-85.0,-82.0,-82.0,43.0,40.0,46.0,34.0,1
1272,92:69:1D:31:68:E9,3855304,489385564,4197,3707294,3851107,485678270,1,5765,1232891,5584,1191688,181,41203,2325,12,4472,104,1,66,229410.0,130000.0,-52.0,-48.0,-46.0,-48.0,-51.0,-46.0,-43.0,-48.0,-87.0,-85.0,-82.0,-82.0,35.0,37.0,36.0,34.0,1
1273,CC:2F:71:3F:1F:24,5199793,2054254119,1348686,1568575849,3851107,485678270,2222,1138385,1313625695,1137500,1313518419,885,107276,1101979,15,1346822,126061,2219,861,144444.0,43333.0,-69.0,-69.0,-66.0,-71.0,-69.0,-69.0,-66.0,-70.0,-87.0,-85.0,-82.0,-82.0,18.0,16.0,16.0,11.0,1
1274,CC:2F:71:3E:C5:1F,3852137,485804129,1030,125859,3851107,485678270,3,4508,375633,3757,286485,751,89148,1090,14,1481,30,3,54,130000.0,39000.0,-71.0,-73.0,-68.0,-61.0,-72.0,-72.0,-68.0,-60.0,-87.0,-85.0,-82.0,-82.0,16.0,12.0,14.0,21.0,1
1275,BA:8C:B9:54:50:24,3856072,491876050,4965,6197780,3851107,485678270,7,10037,1771204,10015,1767709,22,3495,2361,18,5496,44,7,78,229410.0,130000.0,-49.0,-35.0,-42.0,-46.0,-47.0,-35.0,-43.0,-46.0,-87.0,-85.0,-82.0,-82.0,38.0,50.0,40.0,36.0,1
1276,62:47:05:9D:EB:15,3858189,498004384,7075,12325235,3851114,485679149,1,7585,3920670,7534,3912874,51,7796,3592,0,7158,56,1,127,216660.0,130000.0,-43.0,-45.0,-36.0,-49.0,-43.0,-45.0,-36.0,-48.0,-87.0,-85.0,-82.0,-82.0,44.0,40.0,46.0,33.0,1
1277,92:69:1D:31:68:E9,3855313,489386679,4199,3707530,3851114,485679149,1,5769,1233303,5588,1192100,181,41203,2326,12,4474,104,1,66,229410.0,130000.0,-52.0,-49.0,-47.0,-48.0,-51.0,-47.0,-44.0,-48.0,-87.0,-85.0,-82.0,-82.0,35.0,36.0,35.0,34.0,1
1278,CC:2F:71:3F:1F:24,5199993,2054499512,1348879,1568820363,3851114,485679149,2222,1138561,1313864231,1137676,1313756955,885,107276,1102151,15,1347015,126067,2219,861,144444.0,43333.0,-70.0,-69.0,-66.0,-71.0,-70.0,-69.0,-66.0,-70.0,-87.0,-85.0,-82.0,-82.0,17.0,16.0,16.0,11.0,1
1279,CC:2F:71:3E:C5:1F,3852144,485805008,1030,125859,3851114,485679149,3,4508,375633,3757,286485,751,89148,1090,14,1481,30,3,54,130000.0,39000.0,-71.0,-73.0,-68.0,-61.0,-72.0,-72.0,-68.0,-60.0,-87.0,-85.0,-82.0,-82.0,16.0,12.0,14.0,21.0,1
1280,BA:8C:B9:54:50:24,3856079,491876929,4965,6197780,3851114,485679149,7,10037,1771204,10015,1767709,22,3495,2361,18,5496,44,7,78,229410.0,130000.0,-49.0,-35.0,-42.0,-46.0,-47.0,-35.0,-43.0,-46.0,-87.0,-85.0,-82.0,-82.0,38.0,50.0,40.0,36.0,1
1281,62:47:05:9D:EB:15,3858192,498004646,7075,12325235,3851117,485679411,1,7585,3920670,7534,3912874,51,7796,3592,0,7158,56,1,127,216660.0,130000.0,-43.0,-45.0,-36.0,-49.0,-43.0,-45.0,-36.0,-48.0,-87.0,-85.0,-82.0,-82.0,44.0,40.0,46.0,33.0,1
1282,92:69:1D:31:68:E9,3855316,489386941,4199,3707530,3851117,485679411,1,5769,1233303,5588,1192100,181,41203,2326,12,4474,104,1,66,229410.0,130000.0,-52.0,-49.0,-47.0,-48.0,-51.0,-47.0,-44.0,-48.0,-87.0,-85.0,-82.0,-82.0,35.0,36.0,35.0,34.0,1
1283,CC:2F:71:3F:1F:24,5200187,2054741180,1349070,1569061769,3851117,485679411,2222,1138738,1314100243,1137853,1313992967,885,107276,1102321,15,1347206,126070,2219,861,144444.0,43333.0,-70.0,-69.0,-66.0,-71.0,-69.0,-69.0,-65.0,-70.0,-87.0,-85.0,-82.0,-82.0,17.0,16.0,16.0,11.0,1
1284,CC:2F:71:3E:C5:1F,3852149,485805472,1030,125859,3851119,485679613,3,4508,375633,3757,286485,751,89148,1090,14,1481,30,3,54,130000.0,39000.0,-71.0,-73.0,-68.0,-61.0,-72.0,-72.0,-68.0,-60.0,-87.0,-85.0,-82.0,-82.0,16.0,12.0,14.0,21.0,1
1285,BA:8C:B9:54:50:24,3856084,491877393,4965,6197780,3851119,485679613,7,10037,1771204,10015,1767709,22,3495,2361,18,5496,44,7,78,229410.0,130000.0,-49.0,-35.0,-42.0,-46.0,-47.0,-35.0,-43.0,-46.0,-87.0,-85.0,-82.0,-82.0,38.0,50.0,40.0,36.0,1
1286,62:47:05:9D:EB:15,3858198,498005252,7075,12325235,3851123,485680017,1,7585,3920670,7534,3912874,51,7796,3592,0,7158,56,1,127,216660.0,130000.0,-43.0,-45.0,-36.0,-49.0,-43.0,-45.0,-36.0,-48.0,-87.0,-85.0,-82.0,-82.0,44.0,40.0,46.0,33.0,1
1287,92:69:1D:31:68:E9,3855322,489387547,4199,3707530,3851123,485680017,1,5769,1233303,5588,1192100,181,41203,2326,12,4474,104,1,66,229410.0,130000.0,-52.0,-49.0,-47.0,-48.0,-51.0,-47.0,-44.0,-48.0,-87.0,-85.0,-82.0,-82.0,35.0,36.0,35.0,34.0,1
1288,CC:2F:71:3F:1F:24,5200385,2054986170,1349262,1569306153,3851123,485680017,2222,1138919,1314341107,1138034,1314233831,885,107276,1102492,15,1347398,126070,2219,861,144444.0,43333.0,-69.0,-69.0,-66.0,-71.0,-69.0,-69.0,-66.0,-71.0,-87.0,-85.0,-82.0,-82.0,18.0,16.0,16.0,11.0,1
1289,CC:2F:71:3E:C5:1F,3852153,485805876,1030,125859,3851123,485680017,3,4508,375633,3757,286485,751,89148,1090,14,1481,30,3,54,130000.0,39000.0,-71.0,-73.0,-68.0,-61.0,-72.0,-72.0,-68.0,-60.0,-87.0,-85.0,-82.0,-82.0,16.0,12.0,14.0,21.0,1
1290,BA:8C:B9:54:50:24,3856088,491877797,4965,6197780,3851123,485680017,7,10037,1771204,10015,1767709,22,3495,2361,18,5496,44,7,78,229410.0,130000.0,-49.0,-35.0,-42.0,-46.0,-47.0,-35.0,-43.0,-46.0,-87.0,-85.0,-82.0,-82.0,38.0,50.0,40.0,36.0,1
1291,62:47:05:9D:EB:15,3858200,498005454,7075,12325235,3851125,485680219,1,7585,3920670,7534,3912874,51,7796,3592,0,7158,56,1,127,216660.0,130000.0,-43.0,-45.0,-36.0,-49.0,-43.0,-45.0,-36.0,-48.0,-87.0,-85.0,-82.0,-82.0,44.0,40.0,46.0,33.0,1
1292,92:69:1D:31:68:E9,3855326,489387951,4199,3707530,3851127,485680421,1,5769,1233303,5588,1192100,181,41203,2326,12,4474,104,1,66,229410.0,130000.0,-52.0,-49.0,-47.0,-48.0,-51.0,-47.0,-44.0,-48.0,-87.0,-85.0,-82.0,-82.0,35.0,36.0,35.0,34.0,1
1293,CC:2F:71:3F:1F:24,5200601,2055253207,1349474,1569572786,3851127,485680421,2222,1139115,1314592675,1138230,1314485399,885,107276,1102684,15,1347610,126090,2219,863,144444.0,43333.0,-70.0,-69.0,-67.0,-71.0,-69.0,-69.0,-66.0,-70.0,-87.0,-85.0,-82.0,-82.0,17.0,16.0,15.0,11.0,1
1294,CC:2F:71:3E:C5:1F,3852157,485806280,1030,125859,3851127,485680421,3,4508,375633,3757,286485,751,89148,1090,14,1481,30,3,54,130000.0,39000.0,-71.0,-73.0,-68.0,-61.0,-72.0,-72.0,-68.0,-60.0,-87.0,-85.0,-82.0,-82.0,16.0,12.0,14.0,21.0,1
1295,BA:8C:B9:54:50:24,3856092,491878201,4965,6197780,3851127,485680421,7,10037,1771204,10015,1767709,22,3495,2361,18,5496,44,7,78,229410.0,130000.0,-49.0,-35.0,-42.0,-46.0,-47.0,-35.0,-43.0,-46.0,-87.0,-85.0,-82.0,-82.0,38.0,50.0,40.0,36.0,1
1296,62:47:05:9D:EB:15,3858207,498006120,7075,12325235,3851132,485680885,1,7585,3920670,7534,3912874,51,7796,3592,0,7158,56,1,127,216660.0,130000.0,-43.0,-45.0,-36.0,-49.0,-43.0,-45.0,-36.0,-48.0,-87.0,-85.0,-82.0,-82.0,44.0,40.0,46.0,33.0,1
1297,92:69:1D:31:68:E9,3855331,489388415,4199,3707530,3851132,485680885,1,5769,1233303,5588,1192100,181,41203,2326,12,4474,104,1,66,229410.0,130000.0,-52.0,-49.0,-47.0,-48.0,-51.0,-47.0,-44.0,-48.0,-87.0,-85.0,-82.0,-82.0,35.0,36.0,35.0,34.0,1
1298,CC:2F:71:3F:1F:24,5200798,2055495193,1349666,1569814308,3851132,485680885,2222,1139298,1314839259,1138413,1314731983,885,107276,1102856,15,1347802,126094,2219,863,144444.0,43333.0,-69.0,-69.0,-66.0,-71.0,-69.0,-69.0,-66.0,-71.0,-87.0,-85.0,-82.0,-82.0,18.0,16.0,16.0,11.0,1
1299,CC:2F:71:3E:C5:1F,3852162,485806744,1030,125859,3851132,485680885,3,4508,375633,3757,286485,751,89148,1090,14,1481,30,3,54,130000.0,39000.0,-71.0,-73.0,-68.0,-61.0,-72.0,-72.0,-68.0,-60.0,-87.0,-85.0,-82.0,-82.0,16.0,12.0,14.0,21.0,1
1300,BA:8C:B9:54:50:24,3856097,491878665,4965,6197780,3851132,485680885,7,10037,1771204,10015,1767709,22,3495,2361,18,5496,44,7,78,229410.0,130000.0,-49.0,-35.0,-42.0,-46.0,-47.0,-35.0,-43.0,-46.0,-87.0,-85.0,-82.0,-82.0,38.0,50.0,40.0,36.0,1
1301,62:47:05:9D:EB:15,3858211,498006524,7075,12325235,3851136,485681289,1,7585,3920670,7534,3912874,51,7796,3592,0,7158,56,1,127,216660.0,130000.0,-43.0,-45.0,-36.0,-49.0,-43.0,-45.0,-36.0,-48.0,-87.0,-85.0,-82.0,-82.0,44.0,40.0,46.0,33.0,1
1302,92:69:1D:31:68:E9,3855335,489388819,4199,3707530,3851136,485681289,1,5769,1233303,5588,1192100,181,41203,2326,12,4474,104,1,66,229410.0,130000.0,-52.0,-49.0,-47.0,-48.0,-51.0,-47.0,-44.0,-48.0,-87.0,-85.0,-82.0,-82.0,35.0,36.0,35.0,34.0,1
1303,CC:2F:71:3F:1F:24,5200993,2055739851,1349857,1570058562,3851136,485681289,2222,1139471,1315071751,1138586,1314964475,885,107276,1103025,15,1347993,126103,2219,863,144444.0,43333.0,-69.0,-69.0,-67.0,-71.0,-69.0,-69.0,-66.0,-70.0,-87.0,-85.0,-82.0,-82.0,18.0,16.0,15.0,11.0,1
1304,CC:2F:71:3E:C5:1F,3852166,485807148,1030,125859,3851136,485681289,3,4508,375633,3757,286485,751,89148,1090,14,1481,30,3,54,130000.0,39000.0,-71.0,-73.0,-68.0,-61.0,-72.0,-72.0,-68.0,-60.0,-87.0,-85.0,-82.0,-82.0,16.0,12.0,14.0,21.0,1
1305,BA:8C:B9:54:50:24,3856101,491879069,4965,6197780,3851136,485681289,7,10037,1771204,10015,1767709,22,3495,2361,18,5496,44,7,78,229410.0,130000.0,-49.0,-35.0,-42.0,-46.0,-47.0,-35.0,-43.0,-46.0,-87.0,-85.0,-82.0,-82.0,38.0,50.0,40.0,36.0,1
1306,62:47:05:9D:EB:15,3858216,498006988,7075,12325235,3851141,485681753,1,7585,3920670,7534,3912874,51,7796,3592,0,7158,56,1,127,216660.0,130000.0,-43.0,-45.0,-36.0,-49.0,-43.0,-45.0,-36.0,-48.0,-87.0,-85.0,-82.0,-82.0,44.0,40.0,46.0,33.0,1
1307,92:69:1D:31:68:E9,3855340,489389283,4199,3707530,3851141,485681753,1,5769,1233303,5588,1192100,181,41203,2326,12,4474,104,1,66,229410.0,130000.0,-52.0,-49.0,-47.0,-48.0,-51.0,-47.0,-44.0,-48.0,-87.0,-85.0,-82.0,-82.0,35.0,36.0,35.0,34.0,1
1308,CC:2F:71:3F:1F:24,5201197,2055985308,1350056,1570303555,3851141,485681753,2222,1139655,1315308849,1138770,1315201573,885,107276,1103205,15,1348192,126106,2219,863,144444.0,43333.0,-69.0,-68.0,-66.0,-71.0,-69.0,-68.0,-66.0,-71.0,-87.0,-85.0,-82.0,-82.0,18.0,17.0,16.0,11.0,1
1309,CC:2F:71:3E:C5:1F,3852171,485807612,1030,125859,3851141,485681753,3,4508,375633,3757,286485,751,89148,1090,14,1481,30,3,54,130000.0,39000.0,-71.0,-73.0,-68.0,-61.0,-72.0,-72.0,-68.0,-60.0,-87.0,-85.0,-82.0,-82.0,16.0,12.0,14.0,21.0,1
1310,BA:8C:B9:54:50:24,3856106,491879533,4965,6197780,3851141,485681753,7,10037,1771204,10015,1767709,22,3495,2361,18,5496,44,7,78,229410.0,130000.0,-49.0,-35.0,-42.0,-46.0,-47.0,-35.0,-43.0,-46.0,-87.0,-85.0,-82.0,-82.0,38.0,50.0,40.0,36.0,1
1311,62:47:05:9D:EB:15,3858218,498007190,7075,12325235,3851143,485681955,1,7585,3920670,7534,3912874,51,7796,3592,0,7158,56,1,127,216660.0,130000.0,-43.0,-45.0,-36.0,-49.0,-43.0,-45.0,-36.0,-48.0,-87.0,-85.0,-82.0,-82.0,44.0,40.0,46.0,33.0,1
1312,92:69:1D:31:68:E9,3855346,489389919,4201,3707762,3851145,485682157,1,5775,1233791,5594,1192588,181,41203,2328,12,4476,104,1,66,229410.0,130000.0,-51.0,-46.0,-46.0,-46.0,-51.0,-47.0,-46.0,-47.0,-87.0,-85.0,-82.0,-82.0,36.0,39.0,36.0,36.0,1
1313,CC:2F:71:3F:1F:24,5201392,2056228542,1350247,1570546385,3851145,485682157,2222,1139831,1315544565,1138946,1315437289,885,107276,1103375,15,1348382,126107,2219,863,144444.0,43333.0,-69.0,-69.0,-66.0,-71.0,-69.0,-68.0,-66.0,-70.0,-87.0,-85.0,-82.0,-82.0,18.0,16.0,16.0,11.0,1
1314,CC:2F:71:3E:C5:1F,3852175,485808016,1030,125859,3851145,485682157,3,4508,375633,3757,286485,751,89148,1090,14,1481,30,3,54,130000.0,39000.0,-71.0,-73.0,-68.0,-61.0,-72.0,-72.0,-68.0,-60.0,-87.0,-85.0,-82.0,-82.0,16.0,12.0,14.0,21.0,1
1315,BA:8C:B9:54:50:24,3856110,491879937,4965,6197780,3851145,485682157,7,10037,1771204,10015,1767709,22,3495,2361,18,5496,44,7,78,229410.0,130000.0,-49.0,-35.0,-42.0,-46.0,-47.0,-35.0,-43.0,-46.0,-87.0,-85.0,-82.0,-82.0,38.0,50.0,40.0,36.0,1
1316,62:47:05:9D:EB:15,3858224,498007796,7075,12325235,3851149,485682561,1,7585,3920670,7534,3912874,51,7796,3592,0,7158,56,1,127,216660.0,130000.0,-43.0,-45.0,-36.0,-49.0,-43.0,-45.0,-36.0,-48.0,-87.0,-85.0,-82.0,-82.0,44.0,40.0,46.0,33.0,1
1317,92:69:1D:31:68:E9,3855350,489390323,4201,3707762,3851149,485682561,1,5775,1233791,5594,1192588,181,41203,2328,12,4476,104,1,66,229410.0,130000.0,-51.0,-46.0,-46.0,-46.0,-51.0,-47.0,-46.0,-47.0,-87.0,-85.0,-82.0,-82.0,36.0,39.0,36.0,36.0,1
1318,CC:2F:71:3F:1F:24,5201586,2056471478,1350437,1570788917,3851149,485682561,2222,1140007,1315781801,1139122,1315674525,885,107276,1103545,15,1348573,126111,2219,863,144444.0,43333.0,-69.0,-68.0,-66.0,-71.0,-69.0,-68.0,-66.0,-70.0,-87.0,-85.0,-82.0,-82.0,18.0,17.0,16.0,11.0,1
1319,CC:2F:71:3E:C5:1F,3852179,485808420,1030,125859,3851149,485682561,3,4508,375633,3757,286485,751,89148,1090,14,1481,30,3,54,130000.0,39000.0,-71.0,-73.0,-68.0,-61.0,-72.0,-72.0,-68.0,-60.0,-87.0,-85.0,-82.0,-82.0,16.0,12.0,14.0,21.0,1
1320,BA:8C:B9:54:50:24,3856117,491880603,4965,6197780,3851152,485682823,7,10037,1771204,10015,1767709,22,3495,2361,18,5496,44,7,78,229410.0,130000.0,-49.0,-35.0,-42.0,-46.0,-47.0,-35.0,-43.0,-46.0,-87.0,-85.0,-82.0,-82.0,38.0,50.0,40.0,36.0,1
1321,62:47:05:9D:EB:15,3858227,498008058,7075,12325235,3851152,485682823,1,7585,3920670,7534,3912874,51,7796,3592,0,7158,56,1,127,216660.0,130000.0,-43.0,-45.0,-36.0,-49.0,-43.0,-45.0,-36.0,-48.0,-87.0,-85.0,-82.0,-82.0,44.0,40.0,46.0,33.0,1
1322,92:69:1D:31:68:E9,3855355,489390787,4201,3707762,3851154,485683025,1,5775,1233791,5594,1192588,181,41203,2328,12,4476,104,1,66,229410.0,130000.0,-51.0,-46.0,-46.0,-46.0,-51.0,-47.0,-46.0,-47.0,-87.0,-85.0,-82.0,-82.0,36.0,39.0,36.0,36.0,1
1323,CC:2F:71:3F:1F:24,5201791,2056725896,1350637,1571042871,3851154,485683025,2222,1140192,1316030141,1139307,1315922865,885,107276,1103723,15,1348773,126112,2219,863,144444.0,43333.0,-69.0,-68.0,-66.0,-70.0,-69.0,-68.0,-66.0,-70.0,-87.0,-85.0,-82.0,-82.0,18.0,17.0,16.0,12.0,1
1324,CC:2F:71:3E:C5:1F,3852187,485809202,1031,125975,3851156,485683227,3,4509,375703,3758,286555,751,89148,1090,14,1482,30,3,54,130000.0,39000.0,-73.0,-72.0,-68.0,-60.0,-72.0,-72.0,-68.0,-60.0,-87.0,-85.0,-82.0,-82.0,14.0,13.0,14.0,22.0,1
1325,BA:8C:B9:54:50:24,3856121,491881007,4965,6197780,3851156,485683227,7,10037,1771204,10015,1767709,22,3495,2361,18,5496,44,7,78,229410.0,130000.0,-49.0,-35.0,-42.0,-46.0,-47.0,-35.0,-43.0,-46.0,-87.0,-85.0,-82.0,-82.0,38.0,50.0,40.0,36.0,1
1326,62:47:05:9D:EB:15,3858233,498008664,7075,12325235,3851158,485683429,1,7585,3920670,7534,3912874,51,7796,3592,0,7158,56,1,127,216660.0,130000.0,-43.0,-45.0,-36.0,-49.0,-43.0,-45.0,-36.0,-48.0,-87.0,-85.0,-82.0,-82.0,44.0,40.0,46.0,33.0,1
1327,92:69:1D:31:68:E9,3855362,489391509,4202,3707878,3851160,485683631,1,5777,1233927,5596,1192724,181,41203,2328,12,4477,104,1,66,229410.0,130000.0,-50.0,-46.0,-43.0,-46.0,-50.0,-46.0,-45.0,-46.0,-87.0,-85.0,-82.0,-82.0,37.0,39.0,39.0,36.0,1
1328,CC:2F:71:3F:1F:24,5202002,2056975540,1350842,1571291909,3851160,485683631,2222,1140375,1316258661,1139490,1316151385,885,107276,1103906,15,1348978,126116,2219,863,144444.0,43333.0,-69.0,-67.0,-67.0,-70.0,-69.0,-67.0,-67.0,-70.0,-87.0,-85.0,-82.0,-82.0,18.0,18.0,15.0,12.0,1
1329,CC:2F:71:3E:C5:1F,3852191,485809606,1031,125975,3851160,485683631,3,4510,375773,3759,286625,751,89148,1090,14,1482,30,3,54,130000.0,39000.0,-73.0,-72.0,-69.0,-60.0,-72.0,-72.0,-68.0,-60.0,-87.0,-85.0,-82.0,-82.0,14.0,13.0,13.0,22.0,1
1330,BA:8C:B9:54:50:24,3856126,491881527,4966,6197896,3851160,485683631,7,10042,1771544,10020,1768049,22,3495,2361,18,5497,44,7,78,229410.0,130000.0,-48.0,-35.0,-43.0,-46.0,-43.0,-35.0,-43.0,-47.0,-87.0,-85.0,-82.0,-82.0,39.0,50.0,39.0,36.0,1
1331,62:47:05:9D:EB:15,3858239,498009244,7076,12325351,3851163,485683893,1,7587,3920806,7536,3913010,51,7796,3592,0,7159,56,1,127,216660.0,130000.0,-44.0,-46.0,-36.0,-47.0,-43.0,-45.0,-36.0,-48.0,-87.0,-85.0,-82.0,-82.0,43.0,39.0,46.0,35.0,1
1332,92:69:1D:31:68:E9,3855367,489391973,4202,3707878,3851165,485684095,1,5777,1233927,5596,1192724,181,41203,2328,12,4477,104,1,66,229410.0,130000.0,-50.0,-46.0,-43.0,-46.0,-50.0,-46.0,-45.0,-46.0,-87.0,-85.0,-82.0,-82.0,37.0,39.0,39.0,36.0,1
1333,CC:2F:71:3F:1F:24,5202198,2057217410,1351033,1571533315,3851165,485684095,2222,1140551,1316494363,1139666,1316387087,885,107276,1104077,15,1349169,126121,2219,863,144444.0,43333.0,-69.0,-68.0,-66.0,-71.0,-69.0,-68.0,-66.0,-70.0,-87.0,-85.0,-82.0,-82.0,18.0,17.0,16.0,11.0,1
1334,CC:2F:71:3E:C5:1F,3852196,485810070,1031,125975,3851165,485684095,3,4510,375773,3759,286625,751,89148,1090,14,1482,30,3,54,130000.0,39000.0,-73.0,-72.0,-69.0,-60.0,-72.0,-72.0,-68.0,-60.0,-87.0,-85.0,-82.0,-82.0,14.0,13.0,13.0,22.0,1
1335,BA:8C:B9:54:50:24,3856133,491882193,4966,6197896,3851167,485684297,7,10042,1771544,10020,1768049,22,3495,2361,18,5497,44,7,78,229410.0,130000.0,-48.0,-35.0,-43.0,-46.0,-43.0,-35.0,-43.0,-47.0,-87.0,-85.0,-82.0,-82.0,39.0,50.0,39.0,36.0,1
1336,62:47:05:9D:EB:15,3858246,498009912,7076,12325351,3851170,485684561,1,7587,3920806,7536,3913010,51,7796,3592,0,7159,56,1,127,216660.0,130000.0,-44.0,-46.0,-36.0,-47.0,-43.0,-45.0,-36.0,-48.0,-87.0,-85.0,-82.0,-82.0,43.0,39.0,46.0,35.0,1
1337,92:69:1D:31:68:E9,3855372,489392439,4202,3707878,3851170,485684561,1,5777,1233927,5596,1192724,181,41203,2328,12,4477,104,1,66,229410.0,130000.0,-50.0,-46.0,-43.0,-46.0,-50.0,-46.0,-45.0,-46.0,-87.0,-85.0,-82.0,-82.0,37.0,39.0,39.0,36.0,1
1338,CC:2F:71:3F:1F:24,5202394,2057462130,1351224,1571777569,3851170,485684561,2222,1140730,1316729257,1139845,1316621981,885,107276,1104249,15,1349360,126122,2219,863,144444.0,43333.0,-69.0,-68.0,-66.0,-71.0,-69.0,-68.0,-66.0,-71.0,-87.0,-85.0,-82.0,-82.0,18.0,17.0,16.0,11.0,1
1339,CC:2F:71:3E:C5:1F,3852201,485810536,1031,125975,3851170,485684561,3,4512,375961,3760,286695,752,89266,1091,14,1482,30,3,54,130000.0,39000.0,-72.0,-71.0,-68.0,-60.0,-72.0,-72.0,-68.0,-60.0,-87.0,-85.0,-82.0,-82.0,15.0,14.0,14.0,22.0,1
1340,BA:8C:B9:54:50:24,3856136,491882457,4966,6197896,3851170,485684561,7,10042,1771544,10020,1768049,22,3495,2361,18,5497,44,7,78,229410.0,130000.0,-48.0,-35.0,-43.0,-46.0,-43.0,-35.0,-43.0,-47.0,-87.0,-85.0,-82.0,-82.0,39.0,50.0,39.0,36.0,1
1341,62:47:05:9D:EB:15,3858251,498010589,7076,12325351,3851175,485685238,1,7587,3920806,7536,3913010,51,7796,3592,0,7159,56,1,127,216660.0,130000.0,-44.0,-46.0,-36.0,-47.0,-43.0,-45.0,-36.0,-48.0,-87.0,-85.0,-82.0,-82.0,43.0,39.0,46.0,35.0,1
1342,92:69:1D:31:68:E9,3855377,489393116,4202,3707878,3851175,485685238,1,5777,1233927,5596,1192724,181,41203,2328,12,4477,104,1,66,229410.0,130000.0,-50.0,-46.0,-43.0,-46.0,-50.0,-46.0,-45.0,-46.0,-87.0,-85.0,-82.0,-82.0,37.0,39.0,39.0,36.0,1
1343,CC:2F:71:3F:1F:24,5202590,2057707061,1351415,1572021823,3851175,485685238,2222,1140903,1316961721,1140018,1316854445,885,107276,1104420,15,1349551,126123,2219,863,144444.0,43333.0,-70.0,-67.0,-66.0,-71.0,-69.0,-66.0,-66.0,-70.0,-87.0,-85.0,-82.0,-82.0,17.0,18.0,16.0,11.0,1
1344,CC:2F:71:3E:C5:1F,3852208,485811415,1031,125975,3851177,485685440,3,4512,375961,3760,286695,752,89266,1091,14,1482,30,3,54,130000.0,39000.0,-72.0,-71.0,-68.0,-60.0,-72.0,-72.0,-68.0,-60.0,-87.0,-85.0,-82.0,-82.0,15.0,14.0,14.0,22.0,1
1345,BA:8C:B9:54:50:24,3856144,491883396,4966,6197896,3851178,485685500,7,10042,1771544,10020,1768049,22,3495,2361,18,5497,44,7,78,229410.0,130000.0,-48.0,-35.0,-43.0,-46.0,-43.0,-35.0,-43.0,-47.0,-87.0,-85.0,-82.0,-82.0,39.0,50.0,39.0,36.0,1
1346,62:47:05:9D:EB:15,3858256,498011053,7076,12325351,3851180,485685702,1,7587,3920806,7536,3913010,51,7796,3592,0,7159,56,1,127,216660.0,130000.0,-44.0,-46.0,-36.0,-47.0,-43.0,-45.0,-36.0,-48.0,-87.0,-85.0,-82.0,-82.0,43.0,39.0,46.0,35.0,1
1347,92:69:1D:31:68:E9,3855382,489393580,4202,3707878,3851180,485685702,1,5777,1233927,5596,1192724,181,41203,2328,12,4477,104,1,66,229410.0,130000.0,-50.0,-46.0,-43.0,-46.0,-50.0,-46.0,-45.0,-46.0,-87.0,-85.0,-82.0,-82.0,37.0,39.0,39.0,36.0,1
1348,CC:2F:71:3F:1F:24,5202792,2057952272,1351612,1572266570,3851180,485685702,2222,1141083,1317192793,1140198,1317085517,885,107276,1104594,15,1349748,126123,2219,863,144444.0,43333.0,-70.0,-67.0,-66.0,-70.0,-69.0,-66.0,-66.0,-70.0,-87.0,-85.0,-82.0,-82.0,17.0,18.0,16.0,12.0,1
1349,CC:2F:71:3E:C5:1F,3852211,485811677,1031,125975,3851180,485685702,3,4512,375961,3760,286695,752,89266,1091,14,1482,30,3,54,130000.0,39000.0,-72.0,-71.0,-68.0,-60.0,-72.0,-72.0,-68.0,-60.0,-87.0,-85.0,-82.0,-82.0,15.0,14.0,14.0,22.0,1
1350,BA:8C:B9:54:50:24,3856146,491883598,4966,6197896,3851180,485685702,7,10042,1771544,10020,1768049,22,3495,2361,18,5497,44,7,78,229410.0,130000.0,-48.0,-35.0,-43.0,-46.0,-43.0,-35.0,-43.0,-47.0,-87.0,-85.0,-82.0,-82.0,39.0,50.0,39.0,36.0,1
1351,62:47:05:9D:EB:15,3858260,498011457,7076,12325351,3851184,485686106,1,7587,3920806,7536,3913010,51,7796,3592,0,7159,56,1,127,216660.0,130000.0,-44.0,-46.0,-36.0,-47.0,-43.0,-45.0,-36.0,-48.0,-87.0,-85.0,-82.0,-82.0,43.0,39.0,46.0,35.0,1
1352,92:69:1D:31:68:E9,3855388,489394186,4202,3707878,3851186,485686308,1,5777,1233927,5596,1192724,181,41203,2328,12,4477,104,1,66,229410.0,130000.0,-50.0,-46.0,-43.0,-46.0,-50.0,-46.0,-45.0,-46.0,-87.0,-85.0,-82.0,-82.0,37.0,39.0,39.0,36.0,1
1353,CC:2F:71:3F:1F:24,5202989,2058194284,1351803,1572507976,3851186,485686308,2222,1141262,1317430267,1140377,1317322991,885,107276,1104768,15,1349939,126123,2219,863,144444.0,43333.0,-70.0,-66.0,-66.0,-70.0,-69.0,-66.0,-66.0,-70.0,-87.0,-85.0,-82.0,-82.0,17.0,19.0,16.0,12.0,1
1354,CC:2F:71:3E:C5:1F,3852217,485812283,1031,125975,3851186,485686308,3,4512,375961,3760,286695,752,89266,1091,14,1482,30,3,54,130000.0,39000.0,-72.0,-71.0,-68.0,-60.0,-72.0,-72.0,-68.0,-60.0,-87.0,-85.0,-82.0,-82.0,15.0,14.0,14.0,22.0,1
1355,BA:8C:B9:54:50:24,3856152,491884204,4966,6197896,3851186,485686308,7,10042,1771544,10020,1768049,22,3495,2361,18,5497,44,7,78,229410.0,130000.0,-48.0,-35.0,-43.0,-46.0,-43.0,-35.0,-43.0,-47.0,-87.0,-85.0,-82.0,-82.0,39.0,50.0,39.0,36.0,1
1356,62:47:05:9D:EB:15,3858267,498012131,7076,12325351,3851191,485686780,1,7589,3920942,7538,3913146,51,7796,3592,0,7159,56,1,127,216660.0,130000.0,-45.0,-51.0,-45.0,-46.0,-43.0,-46.0,-37.0,-47.0,-87.0,-85.0,-82.0,-82.0,42.0,34.0,37.0,36.0,1
1357,92:69:1D:31:68:E9,3855393,489394658,4202,3707878,3851191,485686780,1,5777,1233927,5596,1192724,181,41203,2328,12,4477,104,1,66,229410.0,130000.0,-50.0,-46.0,-43.0,-46.0,-50.0,-46.0,-45.0,-46.0,-87.0,-85.0,-82.0,-82.0,37.0,39.0,39.0,36.0,1
1358,CC:2F:71:3F:1F:24,5203189,2058442378,1351998,1572755598,3851191,485686780,2222,1141444,1317676825,1140559,1317569549,885,107276,1104940,15,1350134,126124,2219,863,144444.0,43333.0,-70.0,-69.0,-66.0,-71.0,-70.0,-68.0,-66.0,-70.0,-87.0,-85.0,-82.0,-82.0,17.0,16.0,16.0,11.0,1
1359,CC:2F:71:3E:C5:1F,3852222,485812755,1031,125975,3851191,485686780,3,4512,375961,3760,286695,752,89266,1091,14,1482,30,3,54,130000.0,39000.0,-72.0,-71.0,-68.0,-60.0,-72.0,-72.0,-68.0,-60.0,-87.0,-85.0,-82.0,-82.0,15.0,14.0,14.0,22.0,1
1360,BA:8C:B9:54:50:24,3856157,491884676,4966,6197896,3851191,485686780,7,10042,1771544,10020,1768049,22,3495,2361,18,5497,44,7,78,229410.0,130000.0,-48.0,-35.0,-43.0,-46.0,-43.0,-35.0,-43.0,-47.0,-87.0,-85.0,-82.0,-82.0,39.0,50.0,39.0,36.0,1
1361,62:47:05:9D:EB:15,3858273,498012737,7076,12325351,3851197,485687386,1,7589,3920942,7538,3913146,51,7796,3592,0,7159,56,1,127,216660.0,130000.0,-45.0,-51.0,-45.0,-46.0,-43.0,-46.0,-37.0,-47.0,-87.0,-85.0,-82.0,-82.0,42.0,34.0,37.0,36.0,1
1362,92:69:1D:31:68:E9,3855399,489395264,4202,3707878,3851197,485687386,1,5777,1233927,5596,1192724,181,41203,2328,12,4477,104,1,66,229410.0,130000.0,-50.0,-46.0,-43.0,-46.0,-50.0,-46.0,-45.0,-46.0,-87.0,-85.0,-82.0,-82.0,37.0,39.0,39.0,36.0,1
1363,CC:2F:71:3F:1F:24,5203383,2058684000,1352186,1572996614,3851197,485687386,2222,1141619,1317912425,1140734,1317805149,885,107276,1105109,15,1350322,126125,2219,863,144444.0,43333.0,-71.0,-69.0,-67.0,-70.0,-71.0,-68.0,-66.0,-70.0,-87.0,-85.0,-82.0,-82.0,16.0,16.0,15.0,12.0,1
1364,CC:2F:71:3E:C5:1F,3852228,485813361,1031,125975,3851197,485687386,3,4512,375961,3760,286695,752,89266,1091,14,1482,30,3,54,130000.0,39000.0,-72.0,-71.0,-68.0,-60.0,-72.0,-72.0,-68.0,-60.0,-87.0,-85.0,-82.0,-82.0,15.0,14.0,14.0,22.0,1
1365,BA:8C:B9:54:50:24,3856163,491885282,4966,6197896,3851197,485687386,7,10042,1771544,10020,1768049,22,3495,2361,18,5497,44,7,78,229410.0,130000.0,-48.0,-35.0,-43.0,-46.0,-43.0,-35.0,-43.0,-47.0,-87.0,-85.0,-82.0,-82.0,39.0,50.0,39.0,36.0,1
1366,62:47:05:9D:EB:15,3858275,498012939,7076,12325351,3851199,485687588,1,7589,3920942,7538,3913146,51,7796,3592,0,7159,56,1,127,216660.0,130000.0,-45.0,-51.0,-45.0,-46.0,-43.0,-46.0,-37.0,-47.0,-87.0,-85.0,-82.0,-82.0,42.0,34.0,37.0,36.0,1
1367,92:69:1D:31:68:E9,3855401,489395466,4202,3707878,3851199,485687588,1,5777,1233927,5596,1192724,181,41203,2328,12,4477,104,1,66,229410.0,130000.0,-50.0,-46.0,-43.0,-46.0,-50.0,-46.0,-45.0,-46.0,-87.0,-85.0,-82.0,-82.0,37.0,39.0,39.0,36.0,1
1368,CC:2F:71:3F:1F:24,5203584,2058932057,1352385,1573244469,3851199,485687588,2222,1141801,1318147973,1140916,1318040697,885,107276,1105287,15,1350521,126131,2219,863,144444.0,43333.0,-70.0,-67.0,-67.0,-70.0,-70.0,-66.0,-67.0,-69.0,-87.0,-85.0,-82.0,-82.0,17.0,18.0,15.0,12.0,1
1369,CC:2F:71:3E:C5:1F,3852231,485813623,1031,125975,3851200,485687648,3,4512,375961,3760,286695,752,89266,1091,14,1482,30,3,54,130000.0,39000.0,-72.0,-71.0,-68.0,-60.0,-72.0,-72.0,-68.0,-60.0,-87.0,-85.0,-82.0,-82.0,15.0,14.0,14.0,22.0,1
1370,BA:8C:B9:54:50:24,3856166,491885544,4966,6197896,3851200,485687648,7,10042,1771544,10020,1768049,22,3495,2361,18,5497,44,7,78,229410.0,130000.0,-48.0,-35.0,-43.0,-46.0,-43.0,-35.0,-43.0,-47.0,-87.0,-85.0,-82.0,-82.0,39.0,50.0,39.0,36.0,1
1371,62:47:05:9D:EB:15,3858282,498013605,7076,12325351,3851206,485688254,1,7589,3920942,7538,3913146,51,7796,3592,0,7159,56,1,127,216660.0,130000.0,-45.0,-51.0,-45.0,-46.0,-43.0,-46.0,-37.0,-47.0,-87.0,-85.0,-82.0,-82.0,42.0,34.0,37.0,36.0,1
1372,92:69:1D:31:68:E9,3855408,489396132,4202,3707878,3851206,485688254,1,5778,1233995,5597,1192792,181,41203,2328,12,4477,104,1,66,229410.0,130000.0,-49.0,-47.0,-46.0,-45.0,-50.0,-46.0,-45.0,-46.0,-87.0,-85.0,-82.0,-82.0,38.0,38.0,36.0,37.0,1
1373,CC:2F:71:3F:1F:24,5203784,2059177237,1352578,1573488983,3851206,485688254,2222,1141981,1318388687,1141096,1318281411,885,107276,1105456,15,1350714,126131,2219,863,144444.0,43333.0,-70.0,-67.0,-67.0,-70.0,-70.0,-67.0,-67.0,-70.0,-87.0,-85.0,-82.0,-82.0,17.0,18.0,15.0,12.0,1
1374,CC:2F:71:3E:C5:1F,3852237,485814229,1031,125975,3851206,485688254,3,4512,375961,3760,286695,752,89266,1091,14,1482,30,3,54,130000.0,39000.0,-72.0,-71.0,-68.0,-60.0,-72.0,-72.0,-68.0,-60.0,-87.0,-85.0,-82.0,-82.0,15.0,14.0,14.0,22.0,1
1375,BA:8C:B9:54:50:24,3856172,491886150,4966,6197896,3851206,485688254,7,10042,1771544,10020,1768049,22,3495,2361,18,5497,44,7,78,229410.0,130000.0,-48.0,-35.0,-43.0,-46.0,-43.0,-35.0,-43.0,-47.0,-87.0,-85.0,-82.0,-82.0,39.0,50.0,39.0,36.0,1
1376,62:47:05:9D:EB:15,3858285,498013869,7076,12325351,3851209,485688518,1,7591,3921078,7540,3913282,51,7796,3592,0,7159,56,1,127,216660.0,130000.0,-44.0,-45.0,-36.0,-49.0,-43.0,-45.0,-37.0,-48.0,-87.0,-85.0,-82.0,-82.0,43.0,40.0,46.0,33.0,1
1377,92:69:1D:31:68:E9,3855411,489396396,4202,3707878,3851209,485688518,1,5778,1233995,5597,1192792,181,41203,2328,12,4477,104,1,66,229410.0,130000.0,-49.0,-47.0,-46.0,-45.0,-50.0,-46.0,-45.0,-46.0,-87.0,-85.0,-82.0,-82.0,38.0,38.0,36.0,37.0,1
1378,CC:2F:71:3F:1F:24,5203978,2059418893,1352769,1573730375,3851209,485688518,2222,1142162,1318630841,1141276,1318523447,886,107394,1105628,15,1350905,126131,2219,863,144444.0,43333.0,-70.0,-68.0,-67.0,-70.0,-70.0,-68.0,-67.0,-70.0,-87.0,-85.0,-82.0,-82.0,17.0,17.0,15.0,12.0,1
1379,CC:2F:71:3E:C5:1F,3852240,485814493,1031,125975,3851209,485688518,3,4512,375961,3760,286695,752,89266,1091,14,1482,30,3,54,130000.0,39000.0,-72.0,-71.0,-68.0,-60.0,-72.0,-72.0,-68.0,-60.0,-87.0,-85.0,-82.0,-82.0,15.0,14.0,14.0,22.0,1
1380,BA:8C:B9:54:50:24,3856175,491886414,4966,6197896,3851209,485688518,7,10042,1771544,10020,1768049,22,3495,2361,18,5497,44,7,78,229410.0,130000.0,-48.0,-35.0,-43.0,-46.0,-43.0,-35.0,-43.0,-47.0,-87.0,-85.0,-82.0,-82.0,39.0,50.0,39.0,36.0,1
1381,62:47:05:9D:EB:15,3858292,498014535,7076,12325351,3851216,485689184,1,7592,3921146,7541,3913350,51,7796,3592,0,7159,56,1,127,216660.0,130000.0,-44.0,-45.0,-36.0,-49.0,-43.0,-45.0,-37.0,-48.0,-87.0,-85.0,-82.0,-82.0,43.0,40.0,46.0,33.0,1
1382,92:69:1D:31:68:E9,3855418,489397062,4202,3707878,3851216,485689184,1,5778,1233995,5597,1192792,181,41203,2328,12,4477,104,1,66,229410.0,130000.0,-49.0,-47.0,-46.0,-45.0,-50.0,-46.0,-45.0,-46.0,-87.0,-85.0,-82.0,-82.0,38.0,38.0,36.0,37.0,1
1383,CC:2F:71:3F:1F:24,5204185,2059667544,1352969,1573978360,3851216,485689184,2222,1142344,1318867715,1141458,1318760321,886,107394,1105806,15,1351105,126132,2219,863,144444.0,43333.0,-70.0,-69.0,-68.0,-71.0,-70.0,-68.0,-67.0,-70.0,-87.0,-85.0,-81.0,-82.0,17.0,16.0,13.0,11.0,1
1384,CC:2F:71:3E:C5:1F,3852247,485815159,1031,125975,3851216,485689184,3,4512,375961,3760,286695,752,89266,1091,14,1482,30,3,54,130000.0,39000.0,-72.0,-71.0,-68.0,-60.0,-72.0,-72.0,-68.0,-60.0,-87.0,-85.0,-81.0,-82.0,15.0,14.0,13.0,22.0,1
1385,BA:8C:B9:54:50:24,3856182,491887080,4966,6197896,3851216,485689184,7,10042,1771544,10020,1768049,22,3495,2361,18,5497,44,7,78,229410.0,130000.0,-48.0,-35.0,-43.0,-46.0,-43.0,-35.0,-43.0,-47.0,-87.0,-85.0,-81.0,-82.0,39.0,50.0,38.0,36.0,1
1386,62:47:05:9D:EB:15,3858306,498020336,7076,12325351,3851230,485694985,1,7592,3921146,7541,3913350,51,7796,3592,0,7159,56,1,127,216660.0,130000.0,-44.0,-45.0,-36.0,-49.0,-43.0,-45.0,-37.0,-48.0,-87.0,-85.0,-81.0,-82.0,43.0,40.0,45.0,33.0,1
1387,92:69:1D:31:68:E9,3855432,489402863,4202,3707878,3851230,485694985,1,5781,1234366,5599,1192928,182,41438,2329,12,4477,104,1,66,229410.0,130000.0,-50.0,-49.0,-47.0,-46.0,-50.0,-48.0,-45.0,-47.0,-87.0,-85.0,-81.0,-82.0,37.0,36.0,34.0,36.0,1
1388,CC:2F:71:3F:1F:24,5204403,2059932091,1353173,1574237106,3851230,485694985,2222,1142527,1319115667,1141641,1319008273,886,107394,1105985,15,1351308,126133,2219,863,144444.0,43333.0,-71.0,-70.0,-68.0,-72.0,-71.0,-69.0,-68.0,-71.0,-87.0,-85.0,-81.0,-82.0,16.0,15.0,13.0,10.0,1
1389,CC:2F:71:3E:C5:1F,3852272,485826384,1031,125975,3851241,485700409,3,4512,375961,3760,286695,752,89266,1091,14,1482,30,3,54,130000.0,39000.0,-72.0,-71.0,-68.0,-60.0,-72.0,-72.0,-68.0,-60.0,-87.0,-85.0,-81.0,-82.0,15.0,14.0,13.0,22.0,1
1390,BA:8C:B9:54:50:24,3856211,491898709,4966,6197896,3851245,485700813,7,10044,1771680,10022,1768185,22,3495,2361,18,5498,44,7,78,229410.0,130000.0,-49.0,-35.0,-42.0,-46.0,-43.0,-35.0,-43.0,-47.0,-87.0,-85.0,-81.0,-82.0,38.0,50.0,39.0,36.0,1
1391,62:47:05:9D:EB:15,3858323,498026366,7076,12325351,3851247,485701015,1,7592,3921146,7541,3913350,51,7796,3592,0,7159,56,1,127,216660.0,130000.0,-44.0,-45.0,-36.0,-49.0,-43.0,-45.0,-37.0,-48.0,-87.0,-85.0,-81.0,-82.0,43.0,40.0,45.0,33.0,1
1392,92:69:1D:31:68:E9,3855450,489408953,4202,3707878,3851248,485701075,1,5781,1234366,5599,1192928,182,41438,2329,12,4477,104,1,66,229410.0,130000.0,-50.0,-49.0,-47.0,-46.0,-50.0,-48.0,-45.0,-47.0,-87.0,-85.0,-81.0,-82.0,37.0,36.0,34.0,36.0,1
1393,CC:2F:71:3F:1F:24,5204625,2060197011,1353375,1574495734,3851250,485701277,2222,1142719,1319369019,1141833,1319261625,886,107394,1106169,15,1351511,126136,2219,864,144444.0,43333.0,-70.0,-69.0,-67.0,-70.0,-70.0,-68.0,-67.0,-70.0,-87.0,-85.0,-81.0,-82.0,17.0,16.0,14.0,12.0,1
1394,CC:2F:71:3E:C5:1F,3852281,485827252,1031,125975,3851250,485701277,3,4514,376101,3762,286835,752,89266,1091,14,1483,30,3,54,130000.0,39000.0,-73.0,-73.0,-68.0,-60.0,-72.0,-72.0,-68.0,-60.0,-87.0,-85.0,-81.0,-82.0,14.0,12.0,13.0,22.0,1
1395,BA:8C:B9:54:50:24,3856216,491899173,4966,6197896,3851250,485701277,7,10044,1771680,10022,1768185,22,3495,2361,18,5498,44,7,78,229410.0,130000.0,-49.0,-35.0,-42.0,-46.0,-43.0,-35.0,-43.0,-47.0,-87.0,-85.0,-81.0,-82.0,38.0,50.0,39.0,36.0,1
1396,62:47:05:9D:EB:15,3858326,498026628,7076,12325351,3851250,485701277,1,7592,3921146,7541,3913350,51,7796,3592,0,7159,56,1,127,216660.0,130000.0,-44.0,-45.0,-36.0,-49.0,-43.0,-45.0,-37.0,-48.0,-87.0,-85.0,-81.0,-82.0,43.0,40.0,45.0,33.0,1
1397,92:69:1D:31:68:E9,3855452,489409155,4202,3707878,3851250,485701277,1,5781,1234366,5599,1192928,182,41438,2329,12,4477,104,1,66,229410.0,130000.0,-50.0,-49.0,-47.0,-46.0,-50.0,-48.0,-45.0,-47.0,-87.0,-85.0,-81.0,-82.0,37.0,36.0,34.0,36.0,1
1398,CC:2F:71:3F:1F:24,5204820,2060438821,1353566,1574737140,3851254,485701681,2222,1142892,1319602949,1142006,1319495555,886,107394,1106337,15,1351702,126136,2219,864,144444.0,43333.0,-70.0,-69.0,-67.0,-71.0,-70.0,-68.0,-67.0,-70.0,-87.0,-85.0,-81.0,-82.0,17.0,16.0,14.0,11.0,1
1399,CC:2F:71:3E:C5:1F,3852285,485827656,1031,125975,3851254,485701681,3,4514,376101,3762,286835,752,89266,1091,14,1483,30,3,54,130000.0,39000.0,-73.0,-73.0,-68.0,-60.0,-72.0,-72.0,-68.0,-60.0,-87.0,-85.0,-81.0,-82.0,14.0,12.0,13.0,22.0,1
1400,BA:8C:B9:54:50:24,3856220,491899577,4966,6197896,3851254,485701681,7,10044,1771680,10022,1768185,22,3495,2361,18,5498,44,7,78,229410.0,130000.0,-49.0,-35.0,-42.0,-46.0,-43.0,-35.0,-43.0,-47.0,-87.0,-85.0,-81.0,-82.0,38.0,50.0,39.0,36.0,1
1401,62:47:05:9D:EB:15,3858333,498027507,7076,12325351,3851257,485702156,1,7592,3921146,7541,3913350,51,7796,3592,0,7159,56,1,127,216660.0,130000.0,-44.0,-45.0,-36.0,-49.0,-43.0,-45.0,-37.0,-48.0,-87.0,-85.0,-81.0,-82.0,43.0,40.0,45.0,33.0,1
1402,92:69:1D:31:68:E9,3855461,489410236,4202,3707878,3851259,485702358,1,5781,1234366,5599,1192928,182,41438,2329,12,4477,104,1,66,229410.0,130000.0,-50.0,-49.0,-47.0,-46.0,-50.0,-48.0,-45.0,-47.0,-87.0,-85.0,-81.0,-82.0,37.0,36.0,34.0,36.0,1
1403,CC:2F:71:3F:1F:24,5205027,2060687805,1353768,1574985447,3851259,485702358,2222,1143078,1319843343,1142192,1319735949,886,107394,1106515,15,1351904,126136,2219,864,144444.0,43333.0,-71.0,-68.0,-67.0,-70.0,-70.0,-68.0,-67.0,-70.0,-87.0,-85.0,-81.0,-82.0,16.0,17.0,14.0,12.0,1
1404,CC:2F:71:3E:C5:1F,3852290,485828333,1031,125975,3851259,485702358,3,4514,376101,3762,286835,752,89266,1091,14,1483,30,3,54,130000.0,39000.0,-73.0,-73.0,-68.0,-60.0,-72.0,-72.0,-68.0,-60.0,-87.0,-85.0,-81.0,-82.0,14.0,12.0,13.0,22.0,1
1405,BA:8C:B9:54:50:24,3856225,491900254,4966,6197896,3851259,485702358,7,10044,1771680,10022,1768185,22,3495,2361,18,5498,44,7,78,229410.0,130000.0,-49.0,-35.0,-42.0,-46.0,-43.0,-35.0,-43.0,-47.0,-87.0,-85.0,-81.0,-82.0,38.0,50.0,39.0,36.0,1
1406,62:47:05:9D:EB:15,3858340,498028173,7076,12325351,3851264,485702822,1,7592,3921146,7541,3913350,51,7796,3592,0,7159,56,1,127,216660.0,130000.0,-44.0,-45.0,-36.0,-49.0,-43.0,-45.0,-37.0,-48.0,-87.0,-85.0,-81.0,-82.0,43.0,40.0,45.0,33.0,1
1407,92:69:1D:31:68:E9,3855466,489410700,4202,3707878,3851264,485702822,1,5781,1234366,5599,1192928,182,41438,2329,12,4477,104,1,66,229410.0,130000.0,-50.0,-49.0,-47.0,-46.0,-50.0,-48.0,-45.0,-47.0,-87.0,-85.0,-81.0,-82.0,37.0,36.0,34.0,36.0,1
1408,CC:2F:71:3F:1F:24,5205225,2060932783,1353961,1575229961,3851264,485702822,2222,1143253,1320079249,1142367,1319971855,886,107394,1106686,15,1352097,126137,2219,864,144444.0,43333.0,-71.0,-69.0,-67.0,-71.0,-70.0,-68.0,-67.0,-70.0,-87.0,-85.0,-81.0,-82.0,16.0,16.0,14.0,11.0,1
1409,CC:2F:71:3E:C5:1F,3852295,485828797,1031,125975,3851264,485702822,3,4514,376101,3762,286835,752,89266,1091,14,1483,30,3,54,130000.0,39000.0,-73.0,-73.0,-68.0,-60.0,-72.0,-72.0,-68.0,-60.0,-87.0,-85.0,-81.0,-82.0,14.0,12.0,13.0,22.0,1
1410,BA:8C:B9:54:50:24,3856232,491900920,4966,6197896,3851266,485703024,7,10044,1771680,10022,1768185,22,3495,2361,18,5498,44,7,78,229410.0,130000.0,-49.0,-35.0,-42.0,-46.0,-43.0,-35.0,-43.0,-47.0,-87.0,-85.0,-81.0,-82.0,38.0,50.0,39.0,36.0,1
1411,62:47:05:9D:EB:15,3858344,498028577,7076,12325351,3851268,485703226,1,7592,3921146,7541,3913350,51,7796,3592,0,7159,56,1,127,216660.0,130000.0,-44.0,-45.0,-36.0,-49.0,-43.0,-45.0,-37.0,-48.0,-87.0,-85.0,-81.0,-82.0,43.0,40.0,45.0,33.0,1
1412,92:69:1D:31:68:E9,3855470,489411104,4202,3707878,3851268,485703226,1,5781,1234366,5599,1192928,182,41438,2329,12,4477,104,1,66,229410.0,130000.0,-50.0,-49.0,-47.0,-46.0,-50.0,-48.0,-45.0,-47.0,-87.0,-85.0,-81.0,-82.0,37.0,36.0,34.0,36.0,1
1413,CC:2F:71:3F:1F:24,5205421,2061177515,1354153,1575474289,3851268,485703226,2222,1143431,1320319635,1142545,1320212241,886,107394,1106856,15,1352289,126137,2219,864,130000.0,39000.0,-71.0,-69.0,-68.0,-71.0,-71.0,-69.0,-68.0,-71.0,-87.0,-85.0,-81.0,-82.0,16.0,16.0,13.0,11.0,1
1414,CC:2F:71:3E:C5:1F,3852301,485829569,1031,125975,3851270,485703594,3,4514,376101,3762,286835,752,89266,1091,14,1483,30,3,54,130000.0,39000.0,-73.0,-73.0,-68.0,-60.0,-72.0,-72.0,-68.0,-60.0,-87.0,-85.0,-81.0,-82.0,14.0,12.0,13.0,22.0,1
1415,BA:8C:B9:54:50:24,3856236,491901490,4966,6197896,3851270,485703594,7,10044,1771680,10022,1768185,22,3495,2361,18,5498,44,7,78,229410.0,130000.0,-49.0,-35.0,-42.0,-46.0,-43.0,-35.0,-43.0,-47.0,-87.0,-85.0,-81.0,-82.0,38.0,50.0,39.0,36.0,1
1416,62:47:05:9D:EB:15,3858351,498029409,7076,12325351,3851275,485704058,1,7592,3921146,7541,3913350,51,7796,3592,0,7159,56,1,127,216660.0,130000.0,-44.0,-45.0,-36.0,-49.0,-43.0,-45.0,-37.0,-48.0,-87.0,-85.0,-81.0,-82.0,43.0,40.0,45.0,33.0,1
1417,92:69:1D:31:68:E9,3855477,489411936,4202,3707878,3851275,485704058,1,5781,1234366,5599,1192928,182,41438,2329,12,4477,104,1,66,229410.0,130000.0,-50.0,-49.0,-47.0,-46.0,-50.0,-48.0,-45.0,-47.0,-87.0,-85.0,-81.0,-82.0,37.0,36.0,34.0,36.0,1
1418,CC:2F:71:3F:1F:24,5205625,2061423250,1354348,1575718990,3851277,485704260,2222,1143608,1320555478,1142722,1320448084,886,107394,1107029,15,1352484,126137,2219,864,144444.0,43333.0,-71.0,-69.0,-68.0,-71.0,-71.0,-69.0,-67.0,-70.0,-87.0,-85.0,-81.0,-82.0,16.0,16.0,13.0,11.0,1
1419,CC:2F:71:3E:C5:1F,3852308,485830235,1031,125975,3851277,485704260,3,4514,376101,3762,286835,752,89266,1091,14,1483,30,3,54,130000.0,39000.0,-73.0,-73.0,-68.0,-60.0,-72.0,-72.0,-68.0,-60.0,-87.0,-85.0,-81.0,-82.0,14.0,12.0,13.0,22.0,1
1420,BA:8C:B9:54:50:24,3856243,491902156,4966,6197896,3851277,485704260,7,10044,1771680,10022,1768185,22,3495,2361,18,5498,44,7,78,229410.0,130000.0,-49.0,-35.0,-42.0,-46.0,-43.0,-35.0,-43.0,-47.0,-87.0,-85.0,-81.0,-82.0,38.0,50.0,39.0,36.0,1
1421,62:47:05:9D:EB:15,3858355,498029813,7076,12325351,3851279,485704462,1,7592,3921146,7541,3913350,51,7796,3592,0,7159,56,1,127,216660.0,130000.0,-44.0,-45.0,-36.0,-49.0,-43.0,-45.0,-37.0,-48.0,-87.0,-85.0,-81.0,-82.0,43.0,40.0,45.0,33.0,1
1422,92:69:1D:31:68:E9,3855481,489412340,4202,3707878,3851279,485704462,1,5781,1234366,5599,1192928,182,41438,2329,12,4477,104,1,66,229410.0,130000.0,-50.0,-49.0,-47.0,-46.0,-50.0,-48.0,-45.0,-47.0,-87.0,-85.0,-81.0,-82.0,37.0,36.0,34.0,36.0,1
1423,CC:2F:71:3F:1F:24,5205834,2061673123,1354555,1575968661,3851279,485704462,2222,1143795,1320789630,1142909,1320682236,886,107394,1107212,15,1352691,126138,2219,864,144444.0,43333.0,-70.0,-69.0,-66.0,-71.0,-69.0,-69.0,-66.0,-71.0,-87.0,-85.0,-81.0,-82.0,17.0,16.0,15.0,11.0,1
1424,CC:2F:71:3E:C5:1F,3852310,485830437,1031,125975,3851279,485704462,3,4514,376101,3762,286835,752,89266,1091,14,1483,30,3,54,130000.0,39000.0,-73.0,-73.0,-68.0,-60.0,-72.0,-72.0,-68.0,-60.0,-87.0,-85.0,-81.0,-82.0,14.0,12.0,13.0,22.0,1
1425,BA:8C:B9:54:50:24,3856245,491902358,4966,6197896,3851279,485704462,7,10044,1771680,10022,1768185,22,3495,2361,18,5498,44,7,78,229410.0,130000.0,-49.0,-35.0,-42.0,-46.0,-43.0,-35.0,-43.0,-47.0,-87.0,-85.0,-81.0,-82.0,38.0,50.0,39.0,36.0,1
1426,62:47:05:9D:EB:15,3858359,498030217,7076,12325351,3851283,485704866,1,7592,3921146,7541,3913350,51,7796,3592,0,7159,56,1,127,216660.0,130000.0,-44.0,-45.0,-36.0,-49.0,-43.0,-45.0,-37.0,-48.0,-87.0,-85.0,-81.0,-82.0,43.0,40.0,45.0,33.0,1
1427,92:69:1D:31:68:E9,3855487,489412946,4202,3707878,3851285,485705068,1,5781,1234366,5599,1192928,182,41438,2329,12,4477,104,1,66,229410.0,130000.0,-50.0,-49.0,-47.0,-46.0,-50.0,-48.0,-45.0,-47.0,-87.0,-85.0,-81.0,-82.0,37.0,36.0,34.0,36.0,1
1428,CC:2F:71:3F:1F:24,5206034,2061921221,1354749,1576216153,3851285,485705068,2222,1143975,1321031796,1143089,1320924402,886,107394,1107385,15,1352885,126160,2219,864,144444.0,43333.0,-71.0,-69.0,-66.0,-71.0,-71.0,-69.0,-66.0,-71.0,-87.0,-85.0,-81.0,-82.0,16.0,16.0,15.0,11.0,1
1429,CC:2F:71:3E:C5:1F,3852316,485831043,1031,125975,3851285,485705068,3,4514,376101,3762,286835,752,89266,1091,14,1483,30,3,54,130000.0,39000.0,-73.0,-73.0,-68.0,-60.0,-72.0,-72.0,-68.0,-60.0,-87.0,-85.0,-81.0,-82.0,14.0,12.0,13.0,22.0,1
1430,BA:8C:B9:54:50:24,3856251,491902964,4966,6197896,3851285,485705068,7,10044,1771680,10022,1768185,22,3495,2361,18,5498,44,7,78,229410.0,130000.0,-49.0,-35.0,-42.0,-46.0,-43.0,-35.0,-43.0,-47.0,-87.0,-85.0,-81.0,-82.0,38.0,50.0,39.0,36.0,1
1431,62:47:05:9D:EB:15,3858364,498030681,7076,12325351,3851288,485705330,1,7592,3921146,7541,3913350,51,7796,3592,0,7159,56,1,127,216660.0,130000.0,-44.0,-45.0,-36.0,-49.0,-43.0,-45.0,-37.0,-48.0,-87.0,-85.0,-81.0,-82.0,43.0,40.0,45.0,33.0,1
1432,92:69:1D:31:68:E9,3855490,489413208,4202,3707878,3851288,485705330,1,5781,1234366,5599,1192928,182,41438,2329,12,4477,104,1,66,229410.0,130000.0,-50.0,-49.0,-47.0,-46.0,-50.0,-48.0,-45.0,-47.0,-87.0,-85.0,-81.0,-82.0,37.0,36.0,34.0,36.0,1
1433,CC:2F:71:3F:1F:24,5206238,2062171318,1354950,1576465988,3851288,485705330,2222,1144152,1321264229,1143266,1321156835,886,107394,1107558,15,1353086,126182,2219,864,130000.0,43333.0,-71.0,-67.0,-69.0,-72.0,-71.0,-67.0,-68.0,-72.0,-87.0,-85.0,-81.0,-82.0,16.0,18.0,12.0,10.0,1
1434,CC:2F:71:3E:C5:1F,3852319,485831305,1031,125975,3851288,485705330,3,4514,376101,3762,286835,752,89266,1091,14,1483,30,3,54,130000.0,39000.0,-73.0,-73.0,-68.0,-60.0,-72.0,-72.0,-68.0,-60.0,-87.0,-85.0,-81.0,-82.0,14.0,12.0,13.0,22.0,1
1435,BA:8C:B9:54:50:24,3856254,491903226,4966,6197896,3851288,485705330,7,10044,1771680,10022,1768185,22,3495,2361,18,5498,44,7,78,229410.0,130000.0,-49.0,-35.0,-42.0,-46.0,-43.0,-35.0,-43.0,-47.0,-87.0,-85.0,-81.0,-82.0,38.0,50.0,39.0,36.0,1
1436,62:47:05:9D:EB:15,3858370,498031287,7076,12325351,3851294,485705936,1,7592,3921146,7541,3913350,51,7796,3592,0,7159,56,1,127,216660.0,130000.0,-44.0,-45.0,-36.0,-49.0,-43.0,-45.0,-37.0,-48.0,-87.0,-85.0,-81.0,-82.0,43.0,40.0,45.0,33.0,1
1437,92:69:1D:31:68:E9,3855496,489413814,4202,3707878,3851294,485705936,1,5781,1234366,5599,1192928,182,41438,2329,12,4477,104,1,66,229410.0,130000.0,-50.0,-49.0,-47.0,-46.0,-50.0,-48.0,-45.0,-47.0,-87.0,-85.0,-81.0,-82.0,37.0,36.0,34.0,36.0,1
1438,CC:2F:71:3F:1F:24,5207037,2063185377,1355743,1577479441,3851294,485705936,2222,1144615,1321552815,1143729,1321445421,886,107394,1108004,15,1353879,126182,2219,864,130000.0,39000.0,-70.0,-68.0,-66.0,-71.0,-70.0,-68.0,-65.0,-70.0,-87.0,-85.0,-81.0,-82.0,17.0,17.0,15.0,11.0,1
1439,CC:2F:71:3E:C5:1F,3852325,485831911,1031,125975,3851294,485705936,3,4514,376101,3762,286835,752,89266,1091,14,1483,30,3,54,130000.0,39000.0,-73.0,-73.0,-68.0,-60.0,-72.0,-72.0,-68.0,-60.0,-87.0,-85.0,-81.0,-82.0,14.0,12.0,13.0,22.0,1
1440,BA:8C:B9:54:50:24,3856260,491903832,4966,6197896,3851294,485705936,7,10044,1771680,10022,1768185,22,3495,2361,18,5498,44,7,78,229410.0,130000.0,-49.0,-35.0,-42.0,-46.0,-43.0,-35.0,-43.0,-47.0,-87.0,-85.0,-81.0,-82.0,38.0,50.0,39.0,36.0,1
1441,62:47:05:9D:EB:15,3858373,498031549,7076,12325351,3851297,485706198,1,7593,3921214,7542,3913418,51,7796,3592,0,7159,56,1,127,216660.0,130000.0,-47.0,-50.0,-49.0,-46.0,-44.0,-46.0,-38.0,-47.0,-87.0,-85.0,-81.0,-82.0,40.0,35.0,32.0,36.0,1
1442,92:69:1D:31:68:E9,3855499,489414076,4202,3707878,3851297,485706198,1,5781,1234366,5599,1192928,182,41438,2329,12,4477,104,1,66,229410.0,130000.0,-50.0,-49.0,-47.0,-46.0,-50.0,-48.0,-45.0,-47.0,-87.0,-85.0,-81.0,-82.0,37.0,36.0,34.0,36.0,1
1443,CC:2F:71:3F:1F:24,5207277,2063466801,1355980,1577760603,3851297,485706198,2222,1144820,1321793796,1143934,1321686402,886,107394,1108204,15,1354116,126198,2219,864,130000.0,43333.0,-71.0,-69.0,-66.0,-73.0,-71.0,-69.0,-66.0,-73.0,-87.0,-85.0,-81.0,-82.0,16.0,16.0,15.0,9.0,1
1444,CC:2F:71:3E:C5:1F,3852328,485832173,1031,125975,3851297,485706198,3,4514,376101,3762,286835,752,89266,1091,14,1483,30,3,54,130000.0,39000.0,-73.0,-73.0,-68.0,-60.0,-72.0,-72.0,-68.0,-60.0,-87.0,-85.0,-81.0,-82.0,14.0,12.0,13.0,22.0,1
1445,BA:8C:B9:54:50:24,3856263,491904094,4966,6197896,3851297,485706198,7,10044,1771680,10022,1768185,22,3495,2361,18,5498,44,7,78,229410.0,130000.0,-49.0,-35.0,-42.0,-46.0,-43.0,-35.0,-43.0,-47.0,-87.0,-85.0,-81.0,-82.0,38.0,50.0,39.0,36.0,1
1446,62:47:05:9D:EB:15,3858379,498032155,7076,12325351,3851303,485706804,1,7593,3921214,7542,3913418,51,7796,3592,0,7159,56,1,127,216660.0,130000.0,-47.0,-50.0,-49.0,-46.0,-44.0,-46.0,-38.0,-47.0,-87.0,-85.0,-81.0,-82.0,40.0,35.0,32.0,36.0,1
1447,92:69:1D:31:68:E9,3855506,489414798,4203,3707994,3851303,485706804,1,5782,1234434,5600,1192996,182,41438,2329,12,4478,104,1,66,229410.0,137640.0,-52.0,-48.0,-45.0,-47.0,-50.0,-47.0,-45.0,-46.0,-87.0,-85.0,-81.0,-82.0,35.0,37.0,36.0,35.0,1
1448,CC:2F:71:3F:1F:24,5207475,2063708929,1356172,1578002125,3851303,485706804,2222,1144995,1322029396,1144109,1321922002,886,107394,1108373,15,1354308,126200,2219,864,130000.0,43333.0,-71.0,-68.0,-66.0,-73.0,-71.0,-68.0,-65.0,-73.0,-87.0,-85.0,-81.0,-82.0,16.0,17.0,15.0,9.0,1
1449,CC:2F:71:3E:C5:1F,3852339,485833552,1036,126748,3851303,485706804,3,4521,377058,3769,287792,752,89266,1097,14,1488,30,3,54,144444.0,39000.0,-71.0,-70.0,-69.0,-60.0,-71.0,-70.0,-68.0,-60.0,-87.0,-85.0,-81.0,-82.0,16.0,15.0,12.0,22.0,1
1450,BA:8C:B9:54:50:24,3856270,491904816,4967,6198012,3851303,485706804,7,10046,1771816,10024,1768321,22,3495,2361,18,5499,44,7,78,229410.0,130000.0,-48.0,-35.0,-43.0,-45.0,-44.0,-34.0,-42.0,-46.0,-87.0,-85.0,-81.0,-82.0,39.0,50.0,38.0,37.0,1
1451,62:47:05:9D:EB:15,3858382,498032473,7077,12325467,3851305,485707006,1,7595,3921350,7544,3913554,51,7796,3592,0,7160,56,1,127,216660.0,130000.0,-44.0,-45.0,-36.0,-47.0,-44.0,-46.0,-38.0,-47.0,-87.0,-85.0,-81.0,-82.0,43.0,40.0,45.0,35.0,1
1452,92:69:1D:31:68:E9,3855508,489415000,4203,3707994,3851305,485707006,1,5783,1234502,5601,1193064,182,41438,2329,12,4478,104,1,66,229410.0,137640.0,-51.0,-47.0,-42.0,-48.0,-50.0,-47.0,-45.0,-47.0,-87.0,-85.0,-81.0,-82.0,36.0,38.0,39.0,34.0,1
1453,CC:2F:71:3F:1F:24,5207669,2063953291,1356364,1578246285,3851305,485707006,2222,1145178,1322273336,1144292,1322165942,886,107394,1108544,15,1354500,126206,2219,864,130000.0,43333.0,-72.0,-69.0,-66.0,-73.0,-71.0,-69.0,-65.0,-73.0,-87.0,-85.0,-81.0,-82.0,15.0,16.0,15.0,9.0,1
1454,CC:2F:71:3E:C5:1F,3852341,485833754,1036,126748,3851305,485707006,3,4521,377058,3769,287792,752,89266,1097,14,1488,30,3,54,144444.0,39000.0,-71.0,-70.0,-69.0,-60.0,-71.0,-70.0,-68.0,-60.0,-87.0,-85.0,-81.0,-82.0,16.0,15.0,12.0,22.0,1
1455,BA:8C:B9:54:50:24,3856272,491905018,4967,6198012,3851305,485707006,7,10046,1771816,10024,1768321,22,3495,2361,18,5499,44,7,78,229410.0,130000.0,-48.0,-35.0,-43.0,-45.0,-44.0,-34.0,-42.0,-46.0,-87.0,-85.0,-81.0,-82.0,39.0,50.0,38.0,37.0,1
1456,62:47:05:9D:EB:15,3858389,498033139,7077,12325467,3851312,485707672,1,7595,3921350,7544,3913554,51,7796,3592,0,7160,56,1,127,216660.0,130000.0,-44.0,-45.0,-36.0,-47.0,-44.0,-46.0,-38.0,-47.0,-86.0,-85.0,-81.0,-82.0,42.0,40.0,45.0,35.0,1
1457,92:69:1D:31:68:E9,3855515,489415666,4203,3707994,3851312,485707672,1,5783,1234502,5601,1193064,182,41438,2329,12,4478,104,1,66,229410.0,137640.0,-51.0,-47.0,-42.0,-48.0,-50.0,-47.0,-45.0,-47.0,-86.0,-85.0,-81.0,-82.0,35.0,38.0,39.0,34.0,1
1458,CC:2F:71:3F:1F:24,5207895,2064204663,1356583,1578496991,3851312,485707672,2222,1145382,1322515723,1144496,1322408329,886,107394,1108738,15,1354719,126206,2219,864,130000.0,43333.0,-72.0,-69.0,-66.0,-73.0,-71.0,-69.0,-66.0,-73.0,-86.0,-85.0,-81.0,-82.0,14.0,16.0,15.0,9.0,1
1459,CC:2F:71:3E:C5:1F,3852348,485834420,1036,126748,3851312,485707672,3,4521,377058,3769,287792,752,89266,1097,14,1488,30,3,54,144444.0,39000.0,-71.0,-70.0,-69.0,-60.0,-71.0,-70.0,-68.0,-60.0,-86.0,-85.0,-81.0,-82.0,15.0,15.0,12.0,22.0,1
1460,BA:8C:B9:54:50:24,3856279,491905684,4967,6198012,3851312,485707672,7,10047,1771884,10025,1768389,22,3495,2361,18,5499,44,7,78,229410.0,130000.0,-39.0,-36.0,-46.0,-52.0,-44.0,-35.0,-43.0,-47.0,-86.0,-85.0,-81.0,-82.0,47.0,49.0,35.0,30.0,1
1461,62:47:05:9D:EB:15,3858391,498033341,7077,12325467,3851314,485707874,1,7595,3921350,7544,3913554,51,7796,3592,0,7160,56,1,127,216660.0,130000.0,-44.0,-45.0,-36.0,-47.0,-44.0,-46.0,-38.0,-47.0,-86.0,-85.0,-81.0,-82.0,42.0,40.0,45.0,35.0,1
1462,92:69:1D:31:68:E9,3855517,489415868,4203,3707994,3851314,485707874,1,5783,1234502,5601,1193064,182,41438,2329,12,4478,104,1,66,229410.0,137640.0,-51.0,-47.0,-42.0,-48.0,-50.0,-47.0,-45.0,-47.0,-86.0,-85.0,-81.0,-82.0,35.0,38.0,39.0,34.0,1
1463,CC:2F:71:3F:1F:24,5208091,2064448172,1356776,1578740025,3851315,485708147,2222,1145554,1322746771,1144668,1322639377,886,107394,1108906,15,1354912,126211,2219,864,117000.0,39000.0,-72.0,-70.0,-66.0,-74.0,-72.0,-70.0,-66.0,-74.0,-86.0,-85.0,-81.0,-82.0,14.0,15.0,15.0,8.0,1
1464,CC:2F:71:3E:C5:1F,3852353,485835097,1036,126748,3851317,485708349,3,4521,377058,3769,287792,752,89266,1097,14,1488,30,3,54,144444.0,39000.0,-71.0,-70.0,-69.0,-60.0,-71.0,-70.0,-68.0,-60.0,-86.0,-85.0,-81.0,-82.0,15.0,15.0,12.0,22.0,1
1465,BA:8C:B9:54:50:24,3856284,491906361,4967,6198012,3851317,485708349,7,10047,1771884,10025,1768389,22,3495,2361,18,5499,44,7,78,229410.0,130000.0,-39.0,-36.0,-46.0,-52.0,-44.0,-35.0,-43.0,-47.0,-86.0,-85.0,-81.0,-82.0,47.0,49.0,35.0,30.0,1
1466,62:47:05:9D:EB:15,3858399,498034280,7077,12325467,3851322,485708813,1,7595,3921350,7544,3913554,51,7796,3592,0,7160,56,1,127,216660.0,130000.0,-44.0,-45.0,-36.0,-47.0,-44.0,-46.0,-38.0,-47.0,-87.0,-85.0,-82.0,-83.0,43.0,40.0,46.0,36.0,1
1467,92:69:1D:31:68:E9,3855525,489416807,4203,3707994,3851322,485708813,1,5783,1234502,5601,1193064,182,41438,2329,12,4478,104,1,66,229410.0,137640.0,-51.0,-47.0,-42.0,-48.0,-50.0,-47.0,-45.0,-47.0,-87.0,-85.0,-82.0,-83.0,36.0,38.0,40.0,35.0,1
1468,CC:2F:71:3F:1F:24,5208291,2064691760,1356969,1578982947,3851322,485708813,2222,1145727,1322979235,1144841,1322871841,886,107394,1109077,15,1355105,126211,2219,864,130000.0,43333.0,-72.0,-69.0,-67.0,-74.0,-72.0,-69.0,-66.0,-74.0,-87.0,-85.0,-82.0,-83.0,15.0,16.0,15.0,9.0,1
1469,CC:2F:71:3E:C5:1F,3852358,485835561,1036,126748,3851322,485708813,3,4521,377058,3769,287792,752,89266,1097,14,1488,30,3,54,144444.0,39000.0,-71.0,-70.0,-69.0,-60.0,-71.0,-70.0,-68.0,-60.0,-87.0,-85.0,-82.0,-83.0,16.0,15.0,13.0,23.0,1
1470,BA:8C:B9:54:50:24,3856289,491906825,4967,6198012,3851322,485708813,7,10047,1771884,10025,1768389,22,3495,2361,18,5499,44,7,78,229410.0,130000.0,-39.0,-36.0,-46.0,-52.0,-44.0,-35.0,-43.0,-47.0,-87.0,-85.0,-82.0,-83.0,48.0,49.0,36.0,31.0,1
1471,62:47:05:9D:EB:15,3858401,498034482,7077,12325467,3851324,485709015,1,7595,3921350,7544,3913554,51,7796,3592,0,7160,56,1,127,216660.0,130000.0,-44.0,-45.0,-36.0,-47.0,-44.0,-46.0,-38.0,-47.0,-87.0,-85.0,-82.0,-83.0,43.0,40.0,46.0,36.0,1
1472,92:69:1D:31:68:E9,3855529,489417211,4203,3707994,3851326,485709217,1,5783,1234502,5601,1193064,182,41438,2329,12,4478,104,1,66,229410.0,137640.0,-51.0,-47.0,-42.0,-48.0,-50.0,-47.0,-45.0,-47.0,-87.0,-85.0,-82.0,-83.0,36.0,38.0,40.0,35.0,1
1473,CC:2F:71:3F:1F:24,5208485,2064933440,1357159,1579224223,3851326,485709217,2222,1145895,1323205437,1145009,1323098043,886,107394,1109245,15,1355295,126211,2219,864,130000.0,43333.0,-72.0,-70.0,-67.0,-74.0,-72.0,-69.0,-66.0,-74.0,-87.0,-85.0,-82.0,-83.0,15.0,15.0,15.0,9.0,1
1474,CC:2F:71:3E:C5:1F,3852362,485835965,1036,126748,3851326,485709217,3,4521,377058,3769,287792,752,89266,1097,14,1488,30,3,54,144444.0,39000.0,-71.0,-70.0,-69.0,-60.0,-71.0,-70.0,-68.0,-60.0,-87.0,-85.0,-82.0,-83.0,16.0,15.0,13.0,23.0,1
1475,BA:8C:B9:54:50:24,3856295,491907431,4967,6198012,3851328,485709419,7,10047,1771884,10025,1768389,22,3495,2361,18,5499,44,7,78,229410.0,130000.0,-39.0,-36.0,-46.0,-52.0,-44.0,-35.0,-43.0,-47.0,-87.0,-85.0,-82.0,-83.0,48.0,49.0,36.0,31.0,1
1476,62:47:05:9D:EB:15,3858407,498035088,7077,12325467,3851330,485709621,1,7595,3921350,7544,3913554,51,7796,3592,0,7160,56,1,127,216660.0,130000.0,-44.0,-45.0,-36.0,-47.0,-44.0,-46.0,-38.0,-47.0,-87.0,-86.0,-83.0,-83.0,43.0,41.0,47.0,36.0,1
1477,92:69:1D:31:68:E9,3855533,489417615,4203,3707994,3851330,485709621,1,5783,1234502,5601,1193064,182,41438,2329,12,4478,104,1,66,229410.0,137640.0,-51.0,-47.0,-42.0,-48.0,-50.0,-47.0,-45.0,-47.0,-87.0,-86.0,-83.0,-83.0,36.0,39.0,41.0,35.0,1
1478,CC:2F:71:3F:1F:24,5208697,2065181577,1357367,1579471956,3851330,485709621,2222,1146080,1323431879,1145194,1323324485,886,107394,1109430,15,1355503,126226,2219,864,130000.0,43333.0,-72.0,-69.0,-67.0,-74.0,-72.0,-69.0,-66.0,-74.0,-87.0,-86.0,-83.0,-83.0,15.0,17.0,16.0,9.0,1
1479,CC:2F:71:3E:C5:1F,3852368,485836601,1038,126980,3851330,485709621,3,4525,377410,3773,288144,752,89266,1099,14,1490,30,3,54,144444.0,39000.0,-72.0,-71.0,-69.0,-61.0,-71.0,-70.0,-68.0,-60.0,-87.0,-86.0,-83.0,-83.0,15.0,15.0,14.0,22.0,1
1480,BA:8C:B9:54:50:24,3856297,491907633,4967,6198012,3851330,485709621,7,10047,1771884,10025,1768389,22,3495,2361,18,5499,44,7,78,229410.0,130000.0,-39.0,-36.0,-46.0,-52.0,-44.0,-35.0,-43.0,-47.0,-87.0,-86.0,-83.0,-83.0,48.0,50.0,37.0,31.0,1
1481,62:47:05:9D:EB:15,3858412,498035552,7077,12325467,3851335,485710085,1,7595,3921350,7544,3913554,51,7796,3592,0,7160,56,1,127,216660.0,130000.0,-44.0,-45.0,-36.0,-47.0,-44.0,-46.0,-38.0,-47.0,-87.0,-86.0,-83.0,-83.0,43.0,41.0,47.0,36.0,1
1482,92:69:1D:31:68:E9,3855538,489418079,4203,3707994,3851335,485710085,1,5783,1234502,5601,1193064,182,41438,2329,12,4478,104,1,66,229410.0,137640.0,-51.0,-47.0,-42.0,-48.0,-50.0,-47.0,-45.0,-47.0,-87.0,-86.0,-83.0,-83.0,36.0,39.0,41.0,35.0,1
1483,CC:2F:71:3F:1F:24,5208901,2065429861,1357564,1579719574,3851337,485710287,2222,1146261,1323673939,1145375,1323566545,886,107394,1109606,15,1355700,126245,2219,864,130000.0,43333.0,-72.0,-69.0,-67.0,-75.0,-72.0,-69.0,-66.0,-74.0,-87.0,-86.0,-83.0,-83.0,15.0,17.0,16.0,8.0,1
1484,CC:2F:71:3E:C5:1F,3852375,485837267,1038,126980,3851337,485710287,3,4525,377410,3773,288144,752,89266,1099,14,1490,30,3,54,144444.0,39000.0,-72.0,-71.0,-69.0,-61.0,-71.0,-70.0,-68.0,-60.0,-87.0,-86.0,-83.0,-83.0,15.0,15.0,14.0,22.0,1
1485,BA:8C:B9:54:50:24,3856304,491908299,4967,6198012,3851337,485710287,7,10047,1771884,10025,1768389,22,3495,2361,18,5499,44,7,78,229410.0,130000.0,-39.0,-36.0,-46.0,-52.0,-44.0,-35.0,-43.0,-47.0,-87.0,-86.0,-83.0,-83.0,48.0,50.0,37.0,31.0,1
1486,62:47:05:9D:EB:15,3858416,498035956,7077,12325467,3851339,485710489,1,7595,3921350,7544,3913554,51,7796,3592,0,7160,56,1,127,216660.0,130000.0,-44.0,-45.0,-36.0,-47.0,-44.0,-46.0,-38.0,-47.0,-87.0,-86.0,-83.0,-83.0,43.0,41.0,47.0,36.0,1
1487,92:69:1D:31:68:E9,3855542,489418483,4203,3707994,3851339,485710489,1,5783,1234502,5601,1193064,182,41438,2329,12,4478,104,1,66,229410.0,137640.0,-51.0,-47.0,-42.0,-48.0,-50.0,-47.0,-45.0,-47.0,-87.0,-86.0,-83.0,-84.0,36.0,39.0,41.0,36.0,1
1488,CC:2F:71:3F:1F:24,5209092,2065671153,1357753,1579960664,3851339,485710489,2222,1146438,1323911285,1145552,1323803891,886,107394,1109776,15,1355889,126248,2219,864,130000.0,39000.0,-72.0,-68.0,-66.0,-73.0,-72.0,-68.0,-66.0,-73.0,-87.0,-86.0,-83.0,-84.0,15.0,18.0,17.0,11.0,1
1489,CC:2F:71:3E:C5:1F,3852377,485837469,1038,126980,3851339,485710489,3,4525,377410,3773,288144,752,89266,1099,14,1490,30,3,54,144444.0,39000.0,-72.0,-71.0,-69.0,-61.0,-71.0,-70.0,-68.0,-60.0,-87.0,-86.0,-83.0,-84.0,15.0,15.0,14.0,23.0,1
1490,BA:8C:B9:54:50:24,3856306,491908501,4967,6198012,3851339,485710489,7,10047,1771884,10025,1768389,22,3495,2361,18,5499,44,7,78,229410.0,130000.0,-39.0,-36.0,-46.0,-52.0,-44.0,-35.0,-43.0,-47.0,-87.0,-86.0,-83.0,-84.0,48.0,50.0,37.0,32.0,1
1491,62:47:05:9D:EB:15,3858421,498036420,7077,12325467,3851344,485710953,1,7595,3921350,7544,3913554,51,7796,3592,0,7160,56,1,127,216660.0,130000.0,-44.0,-45.0,-36.0,-47.0,-44.0,-46.0,-38.0,-47.0,-87.0,-86.0,-83.0,-84.0,43.0,41.0,47.0,37.0,1
1492,92:69:1D:31:68:E9,3855549,489419149,4203,3707994,3851346,485711155,1,5783,1234502,5601,1193064,182,41438,2329,12,4478,104,1,66,229410.0,137640.0,-51.0,-47.0,-42.0,-48.0,-50.0,-47.0,-45.0,-47.0,-87.0,-86.0,-83.0,-84.0,36.0,39.0,41.0,36.0,1
1493,CC:2F:71:3F:1F:24,5209292,2065913413,1357946,1580202258,3851346,485711155,2222,1146615,1324144517,1145729,1324037123,886,107394,1109947,15,1356082,126260,2219,864,144444.0,43333.0,-69.0,-69.0,-68.0,-71.0,-69.0,-68.0,-67.0,-71.0,-87.0,-86.0,-83.0,-84.0,18.0,17.0,15.0,13.0,1
1494,CC:2F:71:3E:C5:1F,3852384,485838135,1038,126980,3851346,485711155,3,4525,377410,3773,288144,752,89266,1099,14,1490,30,3,54,144444.0,39000.0,-72.0,-71.0,-69.0,-61.0,-71.0,-70.0,-68.0,-60.0,-87.0,-86.0,-83.0,-84.0,15.0,15.0,14.0,23.0,1
1495,BA:8C:B9:54:50:24,3856313,491909167,4967,6198012,3851346,485711155,7,10047,1771884,10025,1768389,22,3495,2361,18,5499,44,7,78,229410.0,130000.0,-39.0,-36.0,-46.0,-52.0,-44.0,-35.0,-43.0,-47.0,-87.0,-86.0,-83.0,-84.0,48.0,50.0,37.0,32.0,1
1496,62:47:05:9D:EB:15,3858427,498036948,7077,12325467,3851350,485711481,1,7595,3921350,7544,3913554,51,7796,3592,0,7160,56,1,127,216660.0,130000.0,-44.0,-45.0,-36.0,-47.0,-44.0,-46.0,-38.0,-47.0,-87.0,-87.0,-84.0,-85.0,43.0,42.0,48.0,38.0,1
1497,92:69:1D:31:68:E9,3855553,489419475,4203,3707994,3851350,485711481,1,5783,1234502,5601,1193064,182,41438,2329,12,4478,104,1,66,229410.0,137640.0,-51.0,-47.0,-42.0,-48.0,-50.0,-47.0,-45.0,-47.0,-87.0,-87.0,-84.0,-85.0,36.0,40.0,42.0,37.0,1
1498,CC:2F:71:3F:1F:24,5209499,2066164922,1358149,1580453441,3851350,485711481,2222,1146800,1324383306,1145913,1324275794,887,107512,1110129,15,1356285,126278,2219,864,130000.0,43333.0,-70.0,-68.0,-66.0,-71.0,-70.0,-68.0,-66.0,-70.0,-87.0,-87.0,-84.0,-85.0,17.0,19.0,18.0,14.0,1
1499,CC:2F:71:3E:C5:1F,3852388,485838461,1038,126980,3851350,485711481,3,4527,377598,3774,288214,753,89384,1100,14,1490,30,3,54,144444.0,39000.0,-73.0,-70.0,-71.0,-60.0,-71.0,-70.0,-69.0,-60.0,-87.0,-87.0,-84.0,-85.0,14.0,17.0,13.0,25.0,1
1500,BA:8C:B9:54:50:24,3856319,491909723,4969,6198242,3851350,485711481,7,10051,1772288,10029,1768793,22,3495,2363,18,5501,44,7,78,229410.0,137640.0,-48.0,-35.0,-42.0,-45.0,-45.0,-36.0,-44.0,-48.0,-87.0,-87.0,-84.0,-85.0,39.0,52.0,42.0,40.0,1
1501,62:47:05:9D:EB:15,3858433,498037554,7077,12325467,3851356,485712087,1,7595,3921350,7544,3913554,51,7796,3592,0,7160,56,1,127,216660.0,130000.0,-44.0,-45.0,-36.0,-47.0,-44.0,-46.0,-38.0,-47.0,-87.0,-87.0,-84.0,-85.0,43.0,42.0,48.0,38.0,1
1502,92:69:1D:31:68:E9,3855559,489420081,4203,3707994,3851356,485712087,1,5783,1234502,5601,1193064,182,41438,2329,12,4478,104,1,66,229410.0,137640.0,-51.0,-47.0,-42.0,-48.0,-50.0,-47.0,-45.0,-47.0,-87.0,-87.0,-84.0,-85.0,36.0,40.0,42.0,37.0,1
1503,CC:2F:71:3F:1F:24,5209694,2066406690,1358338,1580694603,3851356,485712087,2222,1146973,1324614416,1146086,1324506904,887,107512,1110299,15,1356474,126278,2219,864,130000.0,43333.0,-71.0,-69.0,-67.0,-71.0,-71.0,-68.0,-67.0,-71.0,-87.0,-87.0,-84.0,-85.0,16.0,18.0,17.0,14.0,1
1504,CC:2F:71:3E:C5:1F,3852394,485839067,1038,126980,3851356,485712087,3,4527,377598,3774,288214,753,89384,1100,14,1490,30,3,54,144444.0,39000.0,-73.0,-70.0,-71.0,-60.0,-71.0,-70.0,-69.0,-60.0,-87.0,-87.0,-84.0,-85.0,14.0,17.0,13.0,25.0,1
1505,BA:8C:B9:54:50:24,3856325,491910329,4969,6198242,3851356,485712087,7,10051,1772288,10029,1768793,22,3495,2363,18,5501,44,7,78,229410.0,137640.0,-48.0,-35.0,-42.0,-45.0,-45.0,-36.0,-44.0,-48.0,-87.0,-87.0,-84.0,-85.0,39.0,52.0,42.0,40.0,1
1506,62:47:05:9D:EB:15,3858436,498037816,7077,12325467,3851359,485712349,1,7595,3921350,7544,3913554,51,7796,3592,0,7160,56,1,127,216660.0,130000.0,-44.0,-45.0,-36.0,-47.0,-44.0,-46.0,-38.0,-47.0,-87.0,-87.0,-84.0,-85.0,43.0,42.0,48.0,38.0,1
1507,92:69:1D:31:68:E9,3855562,489420343,4203,3707994,3851359,485712349,1,5783,1234502,5601,1193064,182,41438,2329,12,4478,104,1,66,229410.0,137640.0,-51.0,-47.0,-42.0,-48.0,-50.0,-47.0,-45.0,-47.0,-87.0,-87.0,-84.0,-85.0,36.0,40.0,42.0,37.0,1
1508,CC:2F:71:3F:1F:24,5209890,2066654162,1358531,1580941813,3851359,485712349,2222,1147150,1324853172,1146263,1324745660,887,107512,1110471,15,1356667,126282,2219,866,144444.0,43333.0,-72.0,-69.0,-68.0,-71.0,-71.0,-68.0,-67.0,-71.0,-87.0,-87.0,-84.0,-85.0,15.0,18.0,16.0,14.0,1
1509,CC:2F:71:3E:C5:1F,3852397,485839329,1038,126980,3851359,485712349,3,4527,377598,3774,288214,753,89384,1100,14,1490,30,3,54,144444.0,39000.0,-73.0,-70.0,-71.0,-60.0,-71.0,-70.0,-69.0,-60.0,-87.0,-87.0,-84.0,-85.0,14.0,17.0,13.0,25.0,1
1510,BA:8C:B9:54:50:24,3856328,491910591,4969,6198242,3851359,485712349,7,10051,1772288,10029,1768793,22,3495,2363,18,5501,44,7,78,229410.0,137640.0,-48.0,-35.0,-42.0,-45.0,-45.0,-36.0,-44.0,-48.0,-87.0,-87.0,-84.0,-85.0,39.0,52.0,42.0,40.0,1
1511,62:47:05:9D:EB:15,3858442,498038422,7077,12325467,3851365,485712955,1,7595,3921350,7544,3913554,51,7796,3592,0,7160,56,1,127,216660.0,130000.0,-44.0,-45.0,-36.0,-47.0,-44.0,-46.0,-38.0,-47.0,-87.0,-87.0,-84.0,-85.0,43.0,42.0,48.0,38.0,1
1512,92:69:1D:31:68:E9,3855568,489420949,4203,3707994,3851365,485712955,1,5783,1234502,5601,1193064,182,41438,2329,12,4478,104,1,66,229410.0,137640.0,-51.0,-47.0,-42.0,-48.0,-50.0,-47.0,-45.0,-47.0,-88.0,-88.0,-85.0,-86.0,37.0,41.0,43.0,38.0,1
1513,CC:2F:71:3F:1F:24,5210086,2066897484,1358721,1581184529,3851365,485712955,2222,1147325,1325085910,1146438,1324978398,887,107512,1110641,15,1356856,126284,2219,866,144444.0,43333.0,-70.0,-69.0,-67.0,-71.0,-70.0,-69.0,-67.0,-71.0,-88.0,-88.0,-85.0,-86.0,18.0,19.0,18.0,15.0,1
1514,CC:2F:71:3E:C5:1F,3852403,485839935,1038,126980,3851365,485712955,3,4527,377598,3774,288214,753,89384,1100,14,1490,30,3,54,144444.0,39000.0,-73.0,-70.0,-71.0,-60.0,-71.0,-70.0,-69.0,-60.0,-88.0,-88.0,-85.0,-86.0,15.0,18.0,14.0,26.0,1
1515,BA:8C:B9:54:50:24,3856334,491911197,4969,6198242,3851365,485712955,7,10051,1772288,10029,1768793,22,3495,2363,18,5501,44,7,78,229410.0,137640.0,-48.0,-35.0,-42.0,-45.0,-45.0,-36.0,-44.0,-48.0,-88.0,-88.0,-85.0,-86.0,40.0,53.0,43.0,41.0,1
1516,62:47:05:9D:EB:15,3858445,498038684,7077,12325467,3851368,485713217,1,7595,3921350,7544,3913554,51,7796,3592,0,7160,56,1,127,216660.0,130000.0,-44.0,-45.0,-36.0,-47.0,-44.0,-46.0,-38.0,-47.0,-88.0,-88.0,-85.0,-86.0,44.0,43.0,49.0,39.0,1
1517,92:69:1D:31:68:E9,3855571,489421211,4203,3707994,3851368,485713217,1,5785,1234638,5603,1193200,182,41438,2329,12,4479,104,1,66,229410.0,137640.0,-52.0,-47.0,-42.0,-48.0,-50.0,-48.0,-44.0,-47.0,-88.0,-88.0,-85.0,-86.0,36.0,41.0,43.0,38.0,1
1518,CC:2F:71:3F:1F:24,5210289,2067144900,1358921,1581431683,3851368,485713217,2222,1147509,1325320411,1146622,1325212899,887,107512,1110821,15,1357055,126284,2219,867,144444.0,43333.0,-70.0,-68.0,-67.0,-70.0,-70.0,-68.0,-66.0,-70.0,-88.0,-88.0,-85.0,-86.0,18.0,20.0,18.0,16.0,1
1519,CC:2F:71:3E:C5:1F,3852406,485840197,1038,126980,3851368,485713217,3,4527,377598,3774,288214,753,89384,1100,14,1490,30,3,54,144444.0,39000.0,-73.0,-70.0,-71.0,-60.0,-71.0,-70.0,-69.0,-60.0,-88.0,-88.0,-85.0,-86.0,15.0,18.0,14.0,26.0,1
1520,BA:8C:B9:54:50:24,3856337,491911459,4969,6198242,3851368,485713217,7,10055,1772560,10033,1769065,22,3495,2363,18,5501,44,7,78,229410.0,137640.0,-48.0,-35.0,-42.0,-45.0,-45.0,-36.0,-43.0,-48.0,-88.0,-88.0,-85.0,-86.0,40.0,53.0,43.0,41.0,1
1521,62:47:05:9D:EB:15,3858451,498039290,7077,12325467,3851374,485713823,1,7597,3921486,7546,3913690,51,7796,3592,0,7161,56,1,127,216660.0,130000.0,-43.0,-45.0,-35.0,-48.0,-44.0,-45.0,-37.0,-48.0,-88.0,-88.0,-85.0,-87.0,45.0,43.0,50.0,39.0,1
1522,92:69:1D:31:68:E9,3855577,489421817,4203,3707994,3851374,485713823,1,5785,1234638,5603,1193200,182,41438,2329,12,4479,104,1,66,229410.0,137640.0,-52.0,-47.0,-42.0,-48.0,-50.0,-48.0,-44.0,-47.0,-88.0,-88.0,-85.0,-87.0,36.0,41.0,43.0,39.0,1
1523,CC:2F:71:3F:1F:24,5210488,2067392884,1359114,1581679061,3851374,485713823,2222,1147684,1325557519,1146797,1325450007,887,107512,1110993,15,1357248,126291,2219,869,144444.0,43333.0,-70.0,-68.0,-67.0,-71.0,-70.0,-68.0,-66.0,-71.0,-88.0,-88.0,-85.0,-87.0,18.0,20.0,18.0,16.0,1
1524,CC:2F:71:3E:C5:1F,3852412,485840803,1038,126980,3851374,485713823,3,4527,377598,3774,288214,753,89384,1100,14,1490,30,3,54,144444.0,39000.0,-73.0,-70.0,-71.0,-60.0,-71.0,-70.0,-69.0,-60.0,-88.0,-88.0,-85.0,-87.0,15.0,18.0,14.0,27.0,1
1525,BA:8C:B9:54:50:24,3856343,491912065,4969,6198242,3851374,485713823,7,10055,1772560,10033,1769065,22,3495,2363,18,5501,44,7,78,229410.0,137640.0,-48.0,-35.0,-42.0,-45.0,-45.0,-36.0,-43.0,-48.0,-88.0,-88.0,-85.0,-87.0,40.0,53.0,43.0,42.0,1
1526,62:47:05:9D:EB:15,3858454,498039765,7077,12325467,3851377,485714298,1,7597,3921486,7546,3913690,51,7796,3592,0,7161,56,1,127,216660.0,130000.0,-43.0,-45.0,-35.0,-48.0,-44.0,-45.0,-37.0,-48.0,-88.0,-88.0,-85.0,-87.0,45.0,43.0,50.0,39.0,1
1527,92:69:1D:31:68:E9,3855582,489422494,4203,3707994,3851379,485714500,1,5785,1234638,5603,1193200,182,41438,2329,12,4479,104,1,66,229410.0,137640.0,-52.0,-47.0,-42.0,-48.0,-50.0,-48.0,-44.0,-47.0,-88.0,-88.0,-85.0,-87.0,36.0,41.0,43.0,39.0,1
1528,CC:2F:71:3F:1F:24,5210707,2067669357,1359326,1581954655,3851381,485714702,2222,1147897,1325848141,1147010,1325740629,887,107512,1111192,15,1357462,126294,2219,871,144444.0,43333.0,-70.0,-68.0,-67.0,-70.0,-70.0,-68.0,-67.0,-70.0,-88.0,-88.0,-85.0,-87.0,18.0,20.0,18.0,17.0,1
1529,CC:2F:71:3E:C5:1F,3852419,485841682,1038,126980,3851381,485714702,3,4527,377598,3774,288214,753,89384,1100,14,1490,30,3,54,144444.0,39000.0,-73.0,-70.0,-71.0,-60.0,-71.0,-70.0,-69.0,-60.0,-88.0,-88.0,-85.0,-87.0,15.0,18.0,14.0,27.0,1
1530,BA:8C:B9:54:50:24,3856352,491913120,4970,6198358,3851382,485714762,7,10058,1772806,10036,1769311,22,3495,2364,18,5502,44,7,78,229410.0,137640.0,-48.0,-35.0,-42.0,-45.0,-45.0,-35.0,-43.0,-47.0,-88.0,-88.0,-85.0,-87.0,40.0,53.0,43.0,42.0,1
1531,62:47:05:9D:EB:15,3858461,498040431,7077,12325467,3851384,485714964,1,7597,3921486,7546,3913690,51,7796,3592,0,7161,56,1,127,216660.0,130000.0,-43.0,-45.0,-35.0,-48.0,-44.0,-45.0,-37.0,-48.0,-88.0,-89.0,-86.0,-88.0,45.0,44.0,51.0,40.0,1
1532,92:69:1D:31:68:E9,3855587,489422958,4203,3707994,3851384,485714964,1,5785,1234638,5603,1193200,182,41438,2329,12,4479,104,1,66,229410.0,137640.0,-52.0,-47.0,-42.0,-48.0,-50.0,-48.0,-44.0,-47.0,-88.0,-89.0,-86.0,-88.0,36.0,42.0,44.0,40.0,1
1533,CC:2F:71:3F:1F:24,5210912,2067920670,1359526,1582205504,3851386,485715166,2222,1148079,1326083607,1147192,1325976095,887,107512,1111369,15,1357662,126300,2219,871,144444.0,43333.0,-70.0,-68.0,-68.0,-70.0,-70.0,-68.0,-68.0,-70.0,-88.0,-89.0,-86.0,-88.0,18.0,21.0,18.0,18.0,1
1534,CC:2F:71:3E:C5:1F,3852424,485842146,1038,126980,3851386,485715166,3,4527,377598,3774,288214,753,89384,1100,14,1490,30,3,54,144444.0,39000.0,-73.0,-70.0,-71.0,-60.0,-71.0,-70.0,-69.0,-60.0,-88.0,-89.0,-86.0,-88.0,15.0,19.0,15.0,28.0,1
1535,BA:8C:B9:54:50:24,3856356,491913524,4970,6198358,3851386,485715166,7,10058,1772806,10036,1769311,22,3495,2364,18,5502,44,7,78,229410.0,137640.0,-48.0,-35.0,-42.0,-45.0,-45.0,-35.0,-43.0,-47.0,-88.0,-89.0,-86.0,-88.0,40.0,54.0,44.0,43.0,1
1536,62:47:05:9D:EB:15,3858467,498041037,7077,12325467,3851390,485715570,1,7597,3921486,7546,3913690,51,7796,3592,0,7161,56,1,127,216660.0,130000.0,-43.0,-45.0,-35.0,-48.0,-44.0,-45.0,-37.0,-48.0,-88.0,-89.0,-86.0,-88.0,45.0,44.0,51.0,40.0,1
1537,92:69:1D:31:68:E9,3855593,489423564,4203,3707994,3851390,485715570,1,5785,1234638,5603,1193200,182,41438,2329,12,4479,104,1,66,229410.0,137640.0,-52.0,-47.0,-42.0,-48.0,-50.0,-48.0,-44.0,-47.0,-88.0,-89.0,-86.0,-88.0,36.0,42.0,44.0,40.0,1
1538,CC:2F:71:3F:1F:24,5211107,2068165344,1359717,1582449774,3851390,485715570,2222,1148251,1326314687,1147364,1326207175,887,107512,1111537,15,1357853,126307,2219,871,144444.0,43333.0,-71.0,-68.0,-68.0,-70.0,-70.0,-68.0,-67.0,-70.0,-88.0,-89.0,-86.0,-88.0,17.0,21.0,18.0,18.0,1
1539,CC:2F:71:3E:C5:1F,3852428,485842550,1038,126980,3851390,485715570,3,4527,377598,3774,288214,753,89384,1100,14,1490,30,3,54,144444.0,39000.0,-73.0,-70.0,-71.0,-60.0,-71.0,-70.0,-69.0,-60.0,-88.0,-89.0,-86.0,-88.0,15.0,19.0,15.0,28.0,1
1540,BA:8C:B9:54:50:24,3856360,491913928,4970,6198358,3851390,485715570,7,10058,1772806,10036,1769311,22,3495,2364,18,5502,44,7,78,229410.0,137640.0,-48.0,-35.0,-42.0,-45.0,-45.0,-35.0,-43.0,-47.0,-88.0,-89.0,-86.0,-88.0,40.0,54.0,44.0,43.0,1
1541,62:47:05:9D:EB:15,3858472,498041501,7077,12325467,3851395,485716034,1,7597,3921486,7546,3913690,51,7796,3592,0,7161,56,1,127,216660.0,130000.0,-43.0,-45.0,-35.0,-48.0,-44.0,-45.0,-37.0,-48.0,-88.0,-89.0,-86.0,-88.0,45.0,44.0,51.0,40.0,1
1542,92:69:1D:31:68:E9,3855598,489424028,4203,3707994,3851395,485716034,1,5785,1234638,5603,1193200,182,41438,2329,12,4479,104,1,66,229410.0,137640.0,-52.0,-47.0,-42.0,-48.0,-50.0,-48.0,-44.0,-47.0,-88.0,-89.0,-86.0,-88.0,36.0,42.0,44.0,40.0,1
1543,CC:2F:71:3F:1F:24,5211301,2068406970,1359906,1582690936,3851395,485716034,2222,1148428,1326549177,1147541,1326441665,887,107512,1111709,15,1358042,126316,2219,871,144444.0,43333.0,-70.0,-68.0,-67.0,-70.0,-69.0,-68.0,-67.0,-70.0,-89.0,-90.0,-87.0,-88.0,19.0,22.0,20.0,18.0,1
1544,CC:2F:71:3E:C5:1F,3852433,485843014,1038,126980,3851395,485716034,3,4527,377598,3774,288214,753,89384,1100,14,1490,30,3,54,144444.0,39000.0,-73.0,-70.0,-71.0,-60.0,-71.0,-70.0,-69.0,-60.0,-89.0,-90.0,-87.0,-88.0,16.0,20.0,16.0,28.0,1
1545,BA:8C:B9:54:50:24,3856365,491914392,4970,6198358,3851395,485716034,7,10058,1772806,10036,1769311,22,3495,2364,18,5502,44,7,78,229410.0,137640.0,-48.0,-35.0,-42.0,-45.0,-45.0,-35.0,-43.0,-47.0,-89.0,-90.0,-87.0,-88.0,41.0,55.0,45.0,43.0,1
1546,62:47:05:9D:EB:15,3858476,498041905,7077,12325467,3851399,485716438,1,7597,3921486,7546,3913690,51,7796,3592,0,7161,56,1,127,216660.0,130000.0,-43.0,-45.0,-35.0,-48.0,-44.0,-45.0,-37.0,-48.0,-89.0,-90.0,-87.0,-88.0,46.0,45.0,52.0,40.0,1
1547,92:69:1D:31:68:E9,3855602,489424432,4203,3707994,3851399,485716438,1,5785,1234638,5603,1193200,182,41438,2329,12,4479,104,1,66,229410.0,137640.0,-52.0,-47.0,-42.0,-48.0,-50.0,-48.0,-44.0,-47.0,-89.0,-90.0,-87.0,-88.0,37.0,43.0,45.0,40.0,1
1548,CC:2F:71:3F:1F:24,5211497,2068651774,1360098,1582935336,3851399,485716438,2222,1148610,1326790045,1147723,1326682533,887,107512,1111881,15,1358234,126318,2219,871,144444.0,43333.0,-71.0,-68.0,-67.0,-71.0,-70.0,-68.0,-66.0,-71.0,-89.0,-90.0,-87.0,-88.0,18.0,22.0,20.0,17.0,1
1549,CC:2F:71:3E:C5:1F,3852437,485843418,1038,126980,3851399,485716438,3,4527,377598,3774,288214,753,89384,1100,14,1490,30,3,54,144444.0,39000.0,-73.0,-70.0,-71.0,-60.0,-71.0,-70.0,-69.0,-60.0,-89.0,-90.0,-87.0,-88.0,16.0,20.0,16.0,28.0,1
1550,BA:8C:B9:54:50:24,3856369,491914796,4970,6198358,3851399,485716438,7,10058,1772806,10036,1769311,22,3495,2364,18,5502,44,7,78,229410.0,137640.0,-48.0,-35.0,-42.0,-45.0,-45.0,-35.0,-43.0,-47.0,-89.0,-90.0,-87.0,-88.0,41.0,55.0,45.0,43.0,1
1551,62:47:05:9D:EB:15,3858480,498042309,7077,12325467,3851403,485716842,1,7597,3921486,7546,3913690,51,7796,3592,0,7161,56,1,127,216660.0,130000.0,-43.0,-45.0,-35.0,-48.0,-44.0,-45.0,-37.0,-48.0,-89.0,-90.0,-87.0,-89.0,46.0,45.0,52.0,41.0,1
1552,92:69:1D:31:68:E9,3855606,489424836,4203,3707994,3851403,485716842,1,5785,1234638,5603,1193200,182,41438,2329,12,4479,104,1,66,229410.0,137640.0,-52.0,-47.0,-42.0,-48.0,-50.0,-48.0,-44.0,-47.0,-89.0,-90.0,-87.0,-89.0,37.0,43.0,45.0,41.0,1
1553,CC:2F:71:3F:1F:24,5211695,2068893703,1360292,1583176861,3851403,485716842,2222,1148790,1327021121,1147903,1326913609,887,107512,1112057,15,1358428,126320,2219,871,144444.0,43333.0,-69.0,-68.0,-67.0,-72.0,-69.0,-68.0,-67.0,-72.0,-89.0,-90.0,-87.0,-89.0,20.0,22.0,20.0,17.0,1
1554,CC:2F:71:3E:C5:1F,3852441,485843822,1038,126980,3851403,485716842,3,4527,377598,3774,288214,753,89384,1100,14,1490,30,3,54,144444.0,39000.0,-73.0,-70.0,-71.0,-60.0,-71.0,-70.0,-69.0,-60.0,-89.0,-90.0,-87.0,-89.0,16.0,20.0,16.0,29.0,1
1555,BA:8C:B9:54:50:24,3856374,491915260,4970,6198358,3851404,485716902,7,10058,1772806,10036,1769311,22,3495,2364,18,5502,44,7,78,229410.0,137640.0,-48.0,-35.0,-42.0,-45.0,-45.0,-35.0,-43.0,-47.0,-89.0,-90.0,-87.0,-89.0,41.0,55.0,45.0,44.0,1
1556,62:47:05:9D:EB:15,3858485,498042773,7077,12325467,3851408,485717306,1,7597,3921486,7546,3913690,51,7796,3592,0,7161,56,1,127,216660.0,130000.0,-43.0,-45.0,-35.0,-48.0,-44.0,-45.0,-37.0,-48.0,-89.0,-91.0,-88.0,-90.0,46.0,46.0,53.0,42.0,1
1557,92:69:1D:31:68:E9,3855611,489425300,4203,3707994,3851408,485717306,1,5786,1234706,5604,1193268,182,41438,2329,12,4479,104,1,66,229410.0,137640.0,-53.0,-49.0,-44.0,-48.0,-51.0,-48.0,-44.0,-47.0,-89.0,-91.0,-88.0,-90.0,36.0,42.0,44.0,42.0,1
1558,CC:2F:71:3F:1F:24,5211891,2069138437,1360483,1583421131,3851408,485717306,2222,1148966,1327255579,1148079,1327148067,887,107512,1112225,15,1358617,126323,2219,871,144444.0,43333.0,-70.0,-68.0,-67.0,-72.0,-69.0,-68.0,-66.0,-71.0,-89.0,-91.0,-88.0,-90.0,19.0,23.0,21.0,18.0,1
1559,CC:2F:71:3E:C5:1F,3852446,485844286,1038,126980,3851408,485717306,3,4527,377598,3774,288214,753,89384,1100,14,1490,30,3,54,144444.0,39000.0,-73.0,-70.0,-71.0,-60.0,-71.0,-70.0,-69.0,-60.0,-89.0,-91.0,-88.0,-90.0,16.0,21.0,17.0,30.0,1
1560,BA:8C:B9:54:50:24,3856378,491915664,4970,6198358,3851408,485717306,7,10058,1772806,10036,1769311,22,3495,2364,18,5502,44,7,78,229410.0,137640.0,-48.0,-35.0,-42.0,-45.0,-45.0,-35.0,-43.0,-47.0,-89.0,-91.0,-88.0,-90.0,41.0,56.0,46.0,45.0,1
1561,62:47:05:9D:EB:15,3858489,498043177,7077,12325467,3851412,485717710,1,7597,3921486,7546,3913690,51,7796,3592,0,7161,56,1,127,216660.0,130000.0,-43.0,-45.0,-35.0,-48.0,-44.0,-45.0,-37.0,-48.0,-89.0,-91.0,-88.0,-90.0,46.0,46.0,53.0,42.0,1
1562,92:69:1D:31:68:E9,3855615,489425704,4203,3707994,3851412,485717710,1,5786,1234706,5604,1193268,182,41438,2329,12,4479,104,1,66,229410.0,137640.0,-53.0,-49.0,-44.0,-48.0,-51.0,-48.0,-44.0,-47.0,-89.0,-91.0,-88.0,-90.0,36.0,42.0,44.0,42.0,1
1563,CC:2F:71:3F:1F:24,5212096,2069395819,1360684,1583678109,3851412,485717710,2222,1149155,1327507117,1148268,1327399605,887,107512,1112407,15,1358818,126336,2219,871,144444.0,43333.0,-69.0,-68.0,-67.0,-72.0,-69.0,-68.0,-66.0,-72.0,-89.0,-91.0,-88.0,-90.0,20.0,23.0,21.0,18.0,1
1564,CC:2F:71:3E:C5:1F,3852450,485844690,1038,126980,3851412,485717710,3,4527,377598,3774,288214,753,89384,1100,14,1490,30,3,54,144444.0,39000.0,-73.0,-70.0,-71.0,-60.0,-71.0,-70.0,-69.0,-60.0,-89.0,-91.0,-88.0,-90.0,16.0,21.0,17.0,30.0,1
1565,BA:8C:B9:54:50:24,3856382,491916068,4970,6198358,3851412,485717710,7,10058,1772806,10036,1769311,22,3495,2364,18,5502,44,7,78,229410.0,137640.0,-48.0,-35.0,-42.0,-45.0,-45.0,-35.0,-43.0,-47.0,-89.0,-91.0,-88.0,-90.0,41.0,56.0,46.0,45.0,1
1566,62:47:05:9D:EB:15,3858494,498043641,7077,12325467,3851417,485718174,1,7597,3921486,7546,3913690,51,7796,3592,0,7161,56,1,127,216660.0,130000.0,-43.0,-45.0,-35.0,-48.0,-44.0,-45.0,-37.0,-48.0,-89.0,-91.0,-88.0,-90.0,46.0,46.0,53.0,42.0,1
1567,92:69:1D:31:68:E9,3855620,489426168,4203,3707994,3851417,485718174,1,5786,1234706,5604,1193268,182,41438,2329,12,4479,104,1,66,229410.0,137640.0,-53.0,-49.0,-44.0,-48.0,-51.0,-48.0,-44.0,-47.0,-89.0,-91.0,-88.0,-91.0,36.0,42.0,44.0,43.0,1
1568,CC:2F:71:3F:1F:24,5212292,2069637691,1360875,1583919517,3851417,485718174,2222,1149335,1327749011,1148448,1327641499,887,107512,1112579,15,1359011,126338,2219,871,144444.0,43333.0,-69.0,-67.0,-66.0,-72.0,-69.0,-67.0,-66.0,-72.0,-89.0,-91.0,-88.0,-91.0,20.0,24.0,22.0,19.0,1
1569,CC:2F:71:3E:C5:1F,3852455,485845154,1038,126980,3851417,485718174,3,4527,377598,3774,288214,753,89384,1100,14,1490,30,3,54,144444.0,39000.0,-73.0,-70.0,-71.0,-60.0,-71.0,-70.0,-69.0,-60.0,-89.0,-91.0,-88.0,-91.0,16.0,21.0,17.0,31.0,1
1570,BA:8C:B9:54:50:24,3856387,491916532,4970,6198358,3851417,485718174,7,10058,1772806,10036,1769311,22,3495,2364,18,5502,44,7,78,229410.0,137640.0,-48.0,-35.0,-42.0,-45.0,-45.0,-35.0,-43.0,-47.0,-89.0,-91.0,-88.0,-91.0,41.0,56.0,46.0,46.0,1
1571,62:47:05:9D:EB:15,3858498,498044045,7077,12325467,3851421,485718578,1,7597,3921486,7546,3913690,51,7796,3592,0,7161,56,1,127,216660.0,130000.0,-43.0,-45.0,-35.0,-48.0,-44.0,-45.0,-37.0,-48.0,-89.0,-91.0,-88.0,-91.0,46.0,46.0,53.0,43.0,1
1572,92:69:1D:31:68:E9,3855625,489426632,4204,3708054,3851421,485718578,1,5788,1234842,5606,1193404,182,41438,2329,12,4480,104,1,66,216660.0,130000.0,-52.0,-47.0,-42.0,-48.0,-51.0,-47.0,-43.0,-47.0,-89.0,-91.0,-88.0,-91.0,37.0,44.0,46.0,43.0,1
1573,CC:2F:71:3F:1F:24,5212498,2069886342,1361077,1584167764,3851421,485718578,2222,1149522,1327985180,1148635,1327877668,887,107512,1112759,15,1359211,126359,2219,871,144444.0,43333.0,-69.0,-69.0,-67.0,-73.0,-68.0,-68.0,-67.0,-73.0,-89.0,-91.0,-88.0,-91.0,20.0,22.0,21.0,18.0,1
1574,CC:2F:71:3E:C5:1F,3852460,485845674,1039,127096,3851421,485718578,3,4529,377738,3776,288354,753,89384,1100,14,1491,30,3,54,144444.0,39000.0,-73.0,-71.0,-70.0,-60.0,-72.0,-70.0,-69.0,-60.0,-89.0,-91.0,-88.0,-91.0,16.0,20.0,18.0,31.0,1
1575,BA:8C:B9:54:50:24,3856392,491917052,4971,6198474,3851421,485718578,7,10064,1773214,10042,1769719,22,3495,2364,18,5503,44,7,78,229410.0,137640.0,-48.0,-35.0,-42.0,-46.0,-43.0,-35.0,-43.0,-47.0,-89.0,-91.0,-88.0,-91.0,41.0,56.0,46.0,45.0,1
1576,62:47:05:9D:EB:15,3858503,498044565,7078,12325583,3851425,485718982,1,7599,3921622,7548,3913826,51,7796,3592,0,7162,56,1,127,216660.0,130000.0,-43.0,-45.0,-35.0,-47.0,-44.0,-45.0,-37.0,-47.0,-89.0,-91.0,-88.0,-91.0,46.0,46.0,53.0,44.0,1
1577,92:69:1D:31:68:E9,3855640,489434596,4215,3715614,3851425,485718982,1,5802,1237673,5620,1196235,182,41438,2341,12,4491,104,1,66,216660.0,130000.0,-52.0,-50.0,-46.0,-51.0,-52.0,-50.0,-46.0,-51.0,-89.0,-91.0,-88.0,-91.0,37.0,41.0,42.0,40.0,1
1578,CC:2F:71:3F:1F:24,5212693,2070129594,1361268,1584410612,3851425,485718982,2222,1149705,1328224656,1148818,1328117144,887,107512,1112935,15,1359404,126397,2219,871,144444.0,43333.0,-70.0,-68.0,-67.0,-72.0,-70.0,-68.0,-67.0,-72.0,-89.0,-91.0,-88.0,-91.0,19.0,23.0,21.0,19.0,1
1579,CC:2F:71:3E:C5:1F,3852467,485846340,1039,127096,3851428,485719244,3,4529,377738,3776,288354,753,89384,1100,14,1491,30,3,54,144444.0,39000.0,-73.0,-71.0,-70.0,-60.0,-72.0,-70.0,-69.0,-60.0,-89.0,-91.0,-88.0,-91.0,16.0,20.0,18.0,31.0,1
1580,BA:8C:B9:54:50:24,3856399,491917718,4971,6198474,3851428,485719244,7,10064,1773214,10042,1769719,22,3495,2364,18,5503,44,7,78,229410.0,137640.0,-48.0,-35.0,-42.0,-46.0,-43.0,-35.0,-43.0,-47.0,-89.0,-91.0,-88.0,-91.0,41.0,56.0,46.0,45.0,1
1581,62:47:05:9D:EB:15,3858509,498045155,7078,12325583,3851431,485719572,1,7599,3921622,7548,3913826,51,7796,3592,0,7162,56,1,127,216660.0,130000.0,-43.0,-45.0,-35.0,-47.0,-44.0,-45.0,-37.0,-47.0,-90.0,-92.0,-89.0,-91.0,47.0,47.0,54.0,44.0,1
1582,92:69:1D:31:68:E9,3855653,489436756,4222,3717184,3851431,485719572,1,5814,1239215,5632,1197777,182,41438,2350,12,4498,104,1,66,216660.0,130000.0,-51.0,-50.0,-46.0,-48.0,-51.0,-50.0,-46.0,-50.0,-90.0,-92.0,-89.0,-91.0,39.0,42.0,43.0,43.0,1
1583,CC:2F:71:3F:1F:24,5212892,2070376138,1361461,1584656566,3851431,485719572,2222,1149887,1328463888,1149000,1328356376,887,107512,1113113,15,1359597,126453,2219,871,144444.0,43333.0,-70.0,-69.0,-67.0,-74.0,-70.0,-68.0,-67.0,-74.0,-90.0,-92.0,-89.0,-91.0,20.0,23.0,22.0,17.0,1
1584,CC:2F:71:3E:C5:1F,3852470,485846668,1039,127096,3851431,485719572,3,4529,377738,3776,288354,753,89384,1100,14,1491,30,3,54,144444.0,39000.0,-73.0,-71.0,-70.0,-60.0,-72.0,-70.0,-69.0,-60.0,-90.0,-92.0,-89.0,-91.0,17.0,21.0,19.0,31.0,1
1585,BA:8C:B9:54:50:24,3856404,491918248,4971,6198474,3851433,485719774,7,10064,1773214,10042,1769719,22,3495,2364,18,5503,44,7,78,229410.0,137640.0,-48.0,-35.0,-42.0,-46.0,-43.0,-35.0,-43.0,-47.0,-90.0,-92.0,-89.0,-91.0,42.0,57.0,47.0,45.0,1
1586,62:47:05:9D:EB:15,3858514,498045832,7078,12325583,3851436,485720249,1,7599,3921622,7548,3913826,51,7796,3592,0,7162,56,1,127,216660.0,130000.0,-43.0,-45.0,-35.0,-47.0,-44.0,-45.0,-37.0,-47.0,-90.0,-92.0,-89.0,-92.0,47.0,47.0,54.0,45.0,1
1587,92:69:1D:31:68:E9,3855658,489437433,4222,3717184,3851436,485720249,1,5814,1239215,5632,1197777,182,41438,2350,12,4498,104,1,66,216660.0,130000.0,-51.0,-50.0,-46.0,-48.0,-51.0,-50.0,-46.0,-50.0,-90.0,-92.0,-89.0,-92.0,39.0,42.0,43.0,44.0,1
1588,CC:2F:71:3F:1F:24,5213094,2070630297,1361658,1584910048,3851436,485720249,2222,1150073,1328715192,1149186,1328607680,887,107512,1113290,15,1359794,126508,2219,872,144444.0,43333.0,-69.0,-68.0,-67.0,-71.0,-70.0,-67.0,-66.0,-71.0,-90.0,-92.0,-89.0,-92.0,21.0,24.0,22.0,21.0,1
1589,CC:2F:71:3E:C5:1F,3852475,485847345,1039,127096,3851436,485720249,3,4529,377738,3776,288354,753,89384,1100,14,1491,30,3,54,144444.0,39000.0,-73.0,-71.0,-70.0,-60.0,-72.0,-70.0,-69.0,-60.0,-90.0,-92.0,-89.0,-92.0,17.0,21.0,19.0,32.0,1
1590,BA:8C:B9:54:50:24,3856407,491918723,4971,6198474,3851436,485720249,7,10064,1773214,10042,1769719,22,3495,2364,18,5503,44,7,78,229410.0,137640.0,-48.0,-35.0,-42.0,-46.0,-43.0,-35.0,-43.0,-47.0,-90.0,-92.0,-89.0,-92.0,42.0,57.0,47.0,46.0,1
1591,62:47:05:9D:EB:15,3858519,498046296,7078,12325583,3851441,485720713,1,7599,3921622,7548,3913826,51,7796,3592,0,7162,56,1,127,216660.0,130000.0,-43.0,-45.0,-35.0,-47.0,-44.0,-45.0,-37.0,-47.0,-90.0,-92.0,-89.0,-92.0,47.0,47.0,54.0,45.0,1
1592,92:69:1D:31:68:E9,3855663,489437897,4222,3717184,3851441,485720713,1,5814,1239215,5632,1197777,182,41438,2350,12,4498,104,1,66,216660.0,130000.0,-51.0,-50.0,-46.0,-48.0,-51.0,-50.0,-46.0,-50.0,-90.0,-92.0,-89.0,-92.0,39.0,42.0,43.0,44.0,1
1593,CC:2F:71:3F:1F:24,5213296,2070875468,1361855,1585154755,3851441,485720713,2222,1150255,1328952151,1149368,1328844639,887,107512,1113466,15,1359991,126565,2219,872,130000.0,43333.0,-71.0,-68.0,-66.0,-72.0,-71.0,-67.0,-66.0,-71.0,-90.0,-92.0,-89.0,-92.0,19.0,24.0,23.0,20.0,1
1594,CC:2F:71:3E:C5:1F,3852482,485848011,1039,127096,3851443,485720915,3,4529,377738,3776,288354,753,89384,1100,14,1491,30,3,54,144444.0,39000.0,-73.0,-71.0,-70.0,-60.0,-72.0,-70.0,-69.0,-60.0,-90.0,-92.0,-89.0,-92.0,17.0,21.0,19.0,32.0,1
1595,BA:8C:B9:54:50:24,3856416,491919591,4971,6198474,3851445,485721117,7,10064,1773214,10042,1769719,22,3495,2364,18,5503,44,7,78,229410.0,137640.0,-48.0,-35.0,-42.0,-46.0,-43.0,-35.0,-43.0,-47.0,-90.0,-92.0,-89.0,-92.0,42.0,57.0,47.0,46.0,1
1596,62:47:05:9D:EB:15,3858524,498046762,7078,12325583,3851446,485721179,1,7599,3921622,7548,3913826,51,7796,3592,0,7162,56,1,127,216660.0,130000.0,-43.0,-45.0,-35.0,-47.0,-44.0,-45.0,-37.0,-47.0,-90.0,-92.0,-89.0,-92.0,47.0,47.0,54.0,45.0,1
1597,92:69:1D:31:68:E9,3855668,489438363,4222,3717184,3851446,485721179,1,5814,1239215,5632,1197777,182,41438,2350,12,4498,104,1,66,216660.0,130000.0,-51.0,-50.0,-46.0,-48.0,-51.0,-50.0,-46.0,-50.0,-90.0,-92.0,-89.0,-92.0,39.0,42.0,43.0,44.0,1
1598,CC:2F:71:3F:1F:24,5213495,2071123442,1362049,1585402263,3851446,485721179,2222,1150431,1329188023,1149543,1329080393,888,107630,1113640,15,1360185,126565,2219,873,130000.0,43333.0,-71.0,-68.0,-67.0,-71.0,-71.0,-68.0,-67.0,-71.0,-90.0,-92.0,-89.0,-92.0,19.0,24.0,22.0,21.0,1
1599,CC:2F:71:3E:C5:1F,3852485,485848275,1039,127096,3851446,485721179,3,4529,377738,3776,288354,753,89384,1100,14,1491,30,3,54,144444.0,39000.0,-73.0,-71.0,-70.0,-60.0,-72.0,-70.0,-69.0,-60.0,-90.0,-92.0,-89.0,-92.0,17.0,21.0,19.0,32.0,1
1600,BA:8C:B9:54:50:24,3856419,491920021,4971,6198474,3851448,485721547,7,10064,1773214,10042,1769719,22,3495,2364,18,5503,44,7,78,229410.0,137640.0,-48.0,-35.0,-42.0,-46.0,-43.0,-35.0,-43.0,-47.0,-90.0,-93.0,-90.0,-93.0,42.0,58.0,48.0,47.0,1
1601,62:47:05:9D:EB:15,3858530,498047534,7078,12325583,3851452,485721951,1,7599,3921622,7548,3913826,51,7796,3592,0,7162,56,1,127,216660.0,130000.0,-43.0,-45.0,-35.0,-47.0,-44.0,-45.0,-37.0,-47.0,-90.0,-93.0,-90.0,-93.0,47.0,48.0,55.0,46.0,1
1602,92:69:1D:31:68:E9,3855676,489439337,4222,3717184,3851454,485722153,1,5814,1239215,5632,1197777,182,41438,2350,12,4498,104,1,66,216660.0,130000.0,-51.0,-50.0,-46.0,-48.0,-51.0,-50.0,-46.0,-50.0,-90.0,-93.0,-90.0,-93.0,39.0,43.0,44.0,45.0,1
1603,CC:2F:71:3F:1F:24,5213697,2071368768,1362242,1585646555,3851455,485722213,2222,1150607,1329425139,1149719,1329317509,888,107630,1113811,15,1360378,126576,2219,873,130000.0,43333.0,-71.0,-68.0,-66.0,-71.0,-70.0,-68.0,-66.0,-71.0,-90.0,-93.0,-90.0,-93.0,19.0,25.0,24.0,22.0,1
1604,CC:2F:71:3E:C5:1F,3852496,485849511,1039,127096,3851457,485722415,3,4529,377738,3776,288354,753,89384,1100,14,1491,30,3,54,144444.0,39000.0,-73.0,-71.0,-70.0,-60.0,-72.0,-70.0,-69.0,-60.0,-90.0,-93.0,-90.0,-93.0,17.0,22.0,20.0,33.0,1
1605,BA:8C:B9:54:50:24,3856428,491920889,4971,6198474,3851457,485722415,7,10064,1773214,10042,1769719,22,3495,2364,18,5503,44,7,78,229410.0,137640.0,-48.0,-35.0,-42.0,-46.0,-43.0,-35.0,-43.0,-47.0,-90.0,-93.0,-90.0,-93.0,42.0,58.0,48.0,47.0,1
1606,62:47:05:9D:EB:15,3858535,498047998,7078,12325583,3851457,485722415,1,7599,3921622,7548,3913826,51,7796,3592,0,7162,56,1,127,216660.0,130000.0,-43.0,-45.0,-35.0,-47.0,-44.0,-45.0,-37.0,-47.0,-90.0,-93.0,-90.0,-93.0,47.0,48.0,55.0,46.0,1
1607,92:69:1D:31:68:E9,3855679,489439599,4222,3717184,3851457,485722415,1,5814,1239215,5632,1197777,182,41438,2350,12,4498,104,1,66,216660.0,130000.0,-51.0,-50.0,-46.0,-48.0,-51.0,-50.0,-46.0,-50.0,-90.0,-93.0,-90.0,-93.0,39.0,43.0,44.0,45.0,1
1608,CC:2F:71:3F:1F:24,5213897,2071616711,1362440,1585894296,3851457,485722415,2222,1150795,1329668462,1149907,1329560832,888,107630,1113991,15,1360576,126576,2219,873,130000.0,43333.0,-70.0,-68.0,-67.0,-71.0,-70.0,-68.0,-66.0,-71.0,-90.0,-93.0,-90.0,-93.0,20.0,25.0,23.0,22.0,1
1609,CC:2F:71:3E:C5:1F,3852496,485849511,1039,127096,3851457,485722415,3,4529,377738,3776,288354,753,89384,1100,14,1491,30,3,54,144444.0,39000.0,-73.0,-71.0,-70.0,-60.0,-72.0,-70.0,-69.0,-60.0,-90.0,-93.0,-90.0,-93.0,17.0,22.0,20.0,33.0,1
1610,BA:8C:B9:54:50:24,3856430,491921091,4971,6198474,3851459,485722617,7,10064,1773214,10042,1769719,22,3495,2364,18,5503,44,7,78,229410.0,137640.0,-48.0,-35.0,-42.0,-46.0,-43.0,-35.0,-43.0,-47.0,-90.0,-93.0,-90.0,-93.0,42.0,58.0,48.0,47.0,1
1611,62:47:05:9D:EB:15,3858541,498048604,7078,12325583,3851463,485723021,1,7599,3921622,7548,3913826,51,7796,3592,0,7162,56,1,127,216660.0,130000.0,-43.0,-45.0,-35.0,-47.0,-44.0,-45.0,-37.0,-47.0,-90.0,-93.0,-90.0,-93.0,47.0,48.0,55.0,46.0,1
1612,92:69:1D:31:68:E9,3855686,489440321,4223,3717300,3851463,485723021,1,5817,1239461,5635,1198023,182,41438,2351,12,4499,104,1,66,216660.0,130000.0,-52.0,-49.0,-44.0,-48.0,-51.0,-49.0,-45.0,-50.0,-90.0,-93.0,-90.0,-93.0,38.0,44.0,46.0,45.0,1
1613,CC:2F:71:3F:1F:24,5214096,2071861621,1362631,1586138398,3851465,485723223,2222,1150969,1329902508,1150081,1329794878,888,107630,1114160,15,1360765,126578,2219,873,144444.0,43333.0,-70.0,-69.0,-67.0,-72.0,-70.0,-69.0,-67.0,-72.0,-90.0,-93.0,-90.0,-93.0,20.0,24.0,23.0,21.0,1
1614,CC:2F:71:3E:C5:1F,3852504,485850319,1039,127096,3851465,485723223,3,4529,377738,3776,288354,753,89384,1100,14,1491,30,3,54,144444.0,39000.0,-73.0,-71.0,-70.0,-60.0,-72.0,-70.0,-69.0,-60.0,-90.0,-93.0,-90.0,-93.0,17.0,22.0,20.0,33.0,1
1615,BA:8C:B9:54:50:24,3856436,491921697,4971,6198474,3851465,485723223,7,10064,1773214,10042,1769719,22,3495,2364,18,5503,44,7,78,229410.0,137640.0,-48.0,-35.0,-42.0,-46.0,-43.0,-35.0,-43.0,-47.0,-90.0,-93.0,-90.0,-93.0,42.0,58.0,48.0,47.0,1
1616,62:47:05:9D:EB:15,3858544,498048866,7078,12325583,3851466,485723283,1,7599,3921622,7548,3913826,51,7796,3592,0,7162,56,1,127,216660.0,130000.0,-43.0,-45.0,-35.0,-47.0,-44.0,-45.0,-37.0,-47.0,-90.0,-93.0,-90.0,-93.0,47.0,48.0,55.0,46.0,1
1617,92:69:1D:31:68:E9,3855689,489440583,4223,3717300,3851466,485723283,1,5817,1239461,5635,1198023,182,41438,2351,12,4499,104,1,66,216660.0,130000.0,-52.0,-49.0,-44.0,-48.0,-51.0,-49.0,-45.0,-50.0,-90.0,-93.0,-90.0,-93.0,38.0,44.0,46.0,45.0,1
1618,CC:2F:71:3F:1F:24,5214287,2072102917,1362821,1586379634,3851466,485723283,2222,1151148,1330140124,1150260,1330032494,888,107630,1114333,15,1360957,126594,2219,873,130000.0,43333.0,-72.0,-69.0,-67.0,-74.0,-72.0,-69.0,-67.0,-74.0,-90.0,-93.0,-90.0,-93.0,18.0,24.0,23.0,19.0,1
1619,CC:2F:71:3E:C5:1F,3852505,485850379,1039,127096,3851466,485723283,3,4529,377738,3776,288354,753,89384,1100,14,1491,30,3,54,144444.0,39000.0,-73.0,-71.0,-70.0,-60.0,-72.0,-70.0,-69.0,-60.0,-90.0,-93.0,-90.0,-93.0,17.0,22.0,20.0,33.0,1
1620,BA:8C:B9:54:50:24,3856438,491921891,4971,6198474,3851467,485723417,7,10064,1773214,10042,1769719,22,3495,2364,18,5503,44,7,78,229410.0,137640.0,-48.0,-35.0,-42.0,-46.0,-43.0,-35.0,-43.0,-47.0,-90.0,-93.0,-90.0,-93.0,42.0,58.0,48.0,47.0,1
1621,62:47:05:9D:EB:15,3858552,498049674,7078,12325583,3851474,485724091,1,7599,3921622,7548,3913826,51,7796,3592,0,7162,56,1,127,216660.0,130000.0,-43.0,-45.0,-35.0,-47.0,-44.0,-45.0,-37.0,-47.0,-90.0,-93.0,-90.0,-93.0,47.0,48.0,55.0,46.0,1
1622,92:69:1D:31:68:E9,3855697,489441391,4223,3717300,3851474,485724091,1,5817,1239461,5635,1198023,182,41438,2351,12,4499,104,1,66,216660.0,130000.0,-52.0,-49.0,-44.0,-48.0,-51.0,-49.0,-45.0,-50.0,-90.0,-93.0,-90.0,-93.0,38.0,44.0,46.0,45.0,1
1623,CC:2F:71:3F:1F:24,5214487,2072348125,1363013,1586624034,3851474,485724091,2222,1151326,1330377496,1150438,1330269866,888,107630,1114505,15,1361149,126594,2219,873,130000.0,43333.0,-73.0,-69.0,-67.0,-73.0,-73.0,-69.0,-67.0,-73.0,-90.0,-93.0,-90.0,-93.0,17.0,24.0,23.0,20.0,1
1624,CC:2F:71:3E:C5:1F,3852513,485851187,1039,127096,3851474,485724091,3,4529,377738,3776,288354,753,89384,1100,14,1491,30,3,54,144444.0,39000.0,-73.0,-71.0,-70.0,-60.0,-72.0,-70.0,-69.0,-60.0,-90.0,-93.0,-90.0,-93.0,17.0,22.0,20.0,33.0,1
1625,BA:8C:B9:54:50:24,3856445,491922565,4971,6198474,3851474,485724091,7,10064,1773214,10042,1769719,22,3495,2364,18,5503,44,7,78,229410.0,137640.0,-48.0,-35.0,-42.0,-46.0,-43.0,-35.0,-43.0,-47.0,-90.0,-93.0,-90.0,-93.0,42.0,58.0,48.0,47.0,1
1626,62:47:05:9D:EB:15,3858553,498049736,7078,12325583,3851475,485724153,1,7600,3921690,7549,3913894,51,7796,3592,0,7162,56,1,127,216660.0,130000.0,-44.0,-45.0,-36.0,-48.0,-44.0,-45.0,-37.0,-47.0,-90.0,-93.0,-90.0,-93.0,46.0,48.0,54.0,45.0,1
1627,92:69:1D:31:68:E9,3855698,489441453,4223,3717300,3851475,485724153,1,5817,1239461,5635,1198023,182,41438,2351,12,4499,104,1,66,216660.0,130000.0,-52.0,-49.0,-44.0,-48.0,-51.0,-49.0,-45.0,-50.0,-90.0,-93.0,-90.0,-93.0,38.0,44.0,46.0,45.0,1
1628,CC:2F:71:3F:1F:24,5214685,2072592656,1363209,1586868443,3851476,485724213,2222,1151504,1330605350,1150616,1330497720,888,107630,1114682,15,1361345,126599,2219,873,130000.0,43333.0,-72.0,-69.0,-67.0,-72.0,-71.0,-69.0,-67.0,-72.0,-90.0,-93.0,-90.0,-93.0,18.0,24.0,23.0,21.0,1
1629,CC:2F:71:3E:C5:1F,3852515,485851309,1039,127096,3851476,485724213,3,4531,377926,3777,288424,754,89502,1101,14,1491,30,3,54,144444.0,39000.0,-72.0,-71.0,-68.0,-61.0,-72.0,-70.0,-69.0,-60.0,-90.0,-93.0,-90.0,-93.0,18.0,22.0,22.0,32.0,1
1630,BA:8C:B9:54:50:24,3856449,491922889,4971,6198474,3851478,485724415,7,10064,1773214,10042,1769719,22,3495,2364,18,5503,44,7,78,229410.0,137640.0,-48.0,-35.0,-42.0,-46.0,-43.0,-35.0,-43.0,-47.0,-90.0,-93.0,-90.0,-93.0,42.0,58.0,48.0,47.0,1
1631,62:47:05:9D:EB:15,3858562,498050604,7078,12325583,3851484,485725021,1,7600,3921690,7549,3913894,51,7796,3592,0,7162,56,1,127,216660.0,130000.0,-44.0,-45.0,-36.0,-48.0,-44.0,-45.0,-37.0,-47.0,-90.0,-93.0,-90.0,-93.0,46.0,48.0,54.0,45.0,1
1632,92:69:1D:31:68:E9,3855707,489442321,4223,3717300,3851484,485725021,1,5817,1239461,5635,1198023,182,41438,2351,12,4499,104,1,66,216660.0,130000.0,-52.0,-49.0,-44.0,-48.0,-51.0,-49.0,-45.0,-50.0,-90.0,-93.0,-90.0,-93.0,38.0,44.0,46.0,45.0,1
1633,CC:2F:71:3F:1F:24,5214884,2072834886,1363400,1587109865,3851484,485725021,2222,1151673,1330831724,1150785,1330724094,888,107630,1114851,15,1361536,126602,2219,873,130000.0,43333.0,-71.0,-69.0,-67.0,-72.0,-71.0,-69.0,-66.0,-72.0,-90.0,-93.0,-90.0,-93.0,19.0,24.0,23.0,21.0,1
1634,CC:2F:71:3E:C5:1F,3852523,485852117,1039,127096,3851484,485725021,3,4531,377926,3777,288424,754,89502,1101,14,1491,30,3,54,144444.0,39000.0,-72.0,-71.0,-68.0,-61.0,-72.0,-70.0,-69.0,-60.0,-90.0,-93.0,-90.0,-93.0,18.0,22.0,22.0,32.0,1
1635,BA:8C:B9:54:50:24,3856455,491923495,4971,6198474,3851484,485725021,7,10064,1773214,10042,1769719,22,3495,2364,18,5503,44,7,78,229410.0,137640.0,-48.0,-35.0,-42.0,-46.0,-43.0,-35.0,-43.0,-47.0,-90.0,-93.0,-90.0,-93.0,42.0,58.0,48.0,47.0,1
1636,62:47:05:9D:EB:15,3858563,498050664,7078,12325583,3851485,485725081,1,7600,3921690,7549,3913894,51,7796,3592,0,7162,56,1,127,216660.0,130000.0,-44.0,-45.0,-36.0,-48.0,-44.0,-45.0,-37.0,-47.0,-90.0,-93.0,-90.0,-93.0,46.0,48.0,54.0,45.0,1
1637,92:69:1D:31:68:E9,3855708,489442381,4223,3717300,3851485,485725081,1,5819,1239597,5637,1198159,182,41438,2351,12,4500,104,1,66,216660.0,130000.0,-51.0,-45.0,-43.0,-48.0,-51.0,-48.0,-44.0,-49.0,-90.0,-93.0,-90.0,-93.0,39.0,48.0,47.0,45.0,1
1638,CC:2F:71:3F:1F:24,5215079,2073079324,1363592,1587354041,3851487,485725283,2222,1151849,1331064520,1150960,1330956776,889,107744,1115026,15,1361728,126609,2219,873,130000.0,43333.0,-71.0,-69.0,-66.0,-74.0,-70.0,-69.0,-66.0,-74.0,-90.0,-93.0,-90.0,-93.0,19.0,24.0,24.0,19.0,1
1639,CC:2F:71:3E:C5:1F,3852526,485852379,1039,127096,3851487,485725283,3,4531,377926,3777,288424,754,89502,1101,14,1491,30,3,54,144444.0,39000.0,-72.0,-71.0,-68.0,-61.0,-72.0,-70.0,-69.0,-60.0,-90.0,-93.0,-90.0,-93.0,18.0,22.0,22.0,32.0,1
1640,BA:8C:B9:54:50:24,3856460,491923959,4971,6198474,3851489,485725485,7,10066,1773350,10044,1769855,22,3495,2364,18,5504,44,7,78,229410.0,137640.0,-48.0,-35.0,-42.0,-45.0,-43.0,-35.0,-42.0,-46.0,-90.0,-93.0,-90.0,-93.0,42.0,58.0,48.0,48.0,1
1641,62:47:05:9D:EB:15,3858575,498051818,7078,12325583,3851497,485726235,1,7600,3921690,7549,3913894,51,7796,3592,0,7162,56,1,127,216660.0,130000.0,-44.0,-45.0,-36.0,-48.0,-44.0,-45.0,-37.0,-47.0,-90.0,-93.0,-90.0,-93.0,46.0,48.0,54.0,45.0,1
1642,92:69:1D:31:68:E9,3855720,489443535,4223,3717300,3851497,485726235,1,5819,1239597,5637,1198159,182,41438,2351,12,4500,104,1,66,216660.0,130000.0,-51.0,-45.0,-43.0,-48.0,-51.0,-48.0,-44.0,-49.0,-90.0,-93.0,-90.0,-93.0,39.0,48.0,47.0,45.0,1
1643,CC:2F:71:3F:1F:24,5215280,2073321698,1363783,1587595463,3851497,485726235,2222,1152021,1331291250,1151129,1331183052,892,108198,1115198,15,1361919,126609,2219,873,130000.0,43333.0,-72.0,-69.0,-66.0,-74.0,-72.0,-69.0,-66.0,-74.0,-90.0,-93.0,-90.0,-93.0,18.0,24.0,24.0,19.0,1
1644,CC:2F:71:3E:C5:1F,3852536,485853331,1039,127096,3851497,485726235,3,4531,377926,3777,288424,754,89502,1101,14,1491,30,3,54,144444.0,39000.0,-72.0,-71.0,-68.0,-61.0,-72.0,-70.0,-69.0,-60.0,-90.0,-93.0,-90.0,-93.0,18.0,22.0,22.0,32.0,1
1645,BA:8C:B9:54:50:24,3856468,491924709,4971,6198474,3851497,485726235,7,10067,1773418,10045,1769923,22,3495,2364,18,5504,44,7,78,229410.0,137640.0,-39.0,-36.0,-45.0,-51.0,-43.0,-35.0,-42.0,-46.0,-90.0,-93.0,-90.0,-93.0,51.0,57.0,45.0,42.0,1
1646,62:47:05:9D:EB:15,3858575,498051818,7078,12325583,3851497,485726235,1,7602,3921826,7551,3914030,51,7796,3592,0,7162,56,1,127,216660.0,130000.0,-44.0,-45.0,-36.0,-46.0,-43.0,-45.0,-35.0,-47.0,-90.0,-93.0,-90.0,-93.0,46.0,48.0,54.0,47.0,1
1647,92:69:1D:31:68:E9,3855720,489443535,4223,3717300,3851497,485726235,1,5819,1239597,5637,1198159,182,41438,2351,12,4500,104,1,66,216660.0,130000.0,-51.0,-45.0,-43.0,-48.0,-51.0,-48.0,-44.0,-49.0,-90.0,-93.0,-90.0,-93.0,39.0,48.0,47.0,45.0,1
1648,CC:2F:71:3F:1F:24,5215477,2073563555,1363978,1587837118,3851499,485726437,2222,1152195,1331515806,1151303,1331407608,892,108198,1115372,15,1362114,126609,2219,873,130000.0,43333.0,-71.0,-69.0,-66.0,-74.0,-71.0,-69.0,-65.0,-74.0,-90.0,-93.0,-90.0,-93.0,19.0,24.0,24.0,19.0,1
1649,CC:2F:71:3E:C5:1F,3852541,485854008,1039,127096,3851502,485726912,3,4531,377926,3777,288424,754,89502,1101,14,1491,30,3,54,144444.0,39000.0,-72.0,-71.0,-68.0,-61.0,-72.0,-70.0,-69.0,-60.0,-90.0,-93.0,-90.0,-93.0,18.0,22.0,22.0,32.0,1
1650,BA:8C:B9:54:50:24,3856473,491925386,4971,6198474,3851502,485726912,7,10067,1773418,10045,1769923,22,3495,2364,18,5504,44,7,78,229410.0,137640.0,-39.0,-36.0,-45.0,-51.0,-43.0,-35.0,-42.0,-46.0,-90.0,-93.0,-90.0,-93.0,51.0,57.0,45.0,42.0,1
1651,62:47:05:9D:EB:15,3858584,498052899,7078,12325583,3851506,485727316,1,7603,3921894,7552,3914098,51,7796,3592,0,7162,56,1,127,216660.0,130000.0,-44.0,-46.0,-36.0,-46.0,-43.0,-45.0,-35.0,-47.0,-90.0,-93.0,-90.0,-93.0,46.0,47.0,54.0,47.0,1
1652,92:69:1D:31:68:E9,3855729,489444616,4223,3717300,3851506,485727316,1,5819,1239597,5637,1198159,182,41438,2351,12,4500,104,1,66,216660.0,130000.0,-51.0,-45.0,-43.0,-48.0,-51.0,-48.0,-44.0,-49.0,-90.0,-93.0,-90.0,-93.0,39.0,48.0,47.0,45.0,1
1653,CC:2F:71:3F:1F:24,5215671,2073796498,1364164,1588069122,3851507,485727376,2222,1152369,1331748358,1151477,1331640160,892,108198,1115546,15,1362300,126613,2219,873,130000.0,43333.0,-71.0,-69.0,-65.0,-75.0,-71.0,-69.0,-65.0,-74.0,-90.0,-93.0,-90.0,-93.0,19.0,24.0,25.0,18.0,1
1654,CC:2F:71:3E:C5:1F,3852546,485854472,1039,127096,3851507,485727376,3,4531,377926,3777,288424,754,89502,1101,14,1491,30,3,54,144444.0,39000.0,-72.0,-71.0,-68.0,-61.0,-72.0,-70.0,-69.0,-60.0,-90.0,-93.0,-90.0,-93.0,18.0,22.0,22.0,32.0,1
1655,BA:8C:B9:54:50:24,3856478,491925850,4971,6198474,3851507,485727376,7,10067,1773418,10045,1769923,22,3495,2364,18,5504,44,7,78,229410.0,137640.0,-39.0,-36.0,-45.0,-51.0,-43.0,-35.0,-42.0,-46.0,-90.0,-93.0,-90.0,-93.0,51.0,57.0,45.0,42.0,1
1656,62:47:05:9D:EB:15,3858587,498053161,7078,12325583,3851509,485727578,1,7603,3921894,7552,3914098,51,7796,3592,0,7162,56,1,127,216660.0,130000.0,-44.0,-46.0,-36.0,-46.0,-43.0,-45.0,-35.0,-47.0,-90.0,-93.0,-90.0,-93.0,46.0,47.0,54.0,47.0,1
1657,92:69:1D:31:68:E9,3855734,489445080,4223,3717300,3851511,485727780,1,5819,1239597,5637,1198159,182,41438,2351,12,4500,104,1,66,216660.0,130000.0,-51.0,-45.0,-43.0,-48.0,-51.0,-48.0,-44.0,-49.0,-90.0,-93.0,-90.0,-93.0,39.0,48.0,47.0,45.0,1
1658,CC:2F:71:3F:1F:24,5215880,2074059856,1364369,1588332076,3851511,485727780,2222,1152540,1331979138,1151648,1331870940,892,108198,1115717,15,1362505,126615,2219,873,130000.0,43333.0,-71.0,-69.0,-66.0,-74.0,-71.0,-69.0,-65.0,-74.0,-90.0,-93.0,-90.0,-93.0,19.0,24.0,24.0,19.0,1
1659,CC:2F:71:3E:C5:1F,3852550,485854876,1039,127096,3851511,485727780,3,4531,377926,3777,288424,754,89502,1101,14,1491,30,3,54,144444.0,39000.0,-72.0,-71.0,-68.0,-61.0,-72.0,-70.0,-69.0,-60.0,-90.0,-93.0,-90.0,-93.0,18.0,22.0,22.0,32.0,1
1660,BA:8C:B9:54:50:24,3856484,491926456,4971,6198474,3851513,485727982,7,10067,1773418,10045,1769923,22,3495,2364,18,5504,44,7,78,229410.0,137640.0,-39.0,-36.0,-45.0,-51.0,-43.0,-35.0,-42.0,-46.0,-90.0,-93.0,-90.0,-93.0,51.0,57.0,45.0,42.0,1
1661,62:47:05:9D:EB:15,3858593,498053767,7078,12325583,3851515,485728184,1,7603,3921894,7552,3914098,51,7796,3592,0,7162,56,1,127,216660.0,130000.0,-44.0,-46.0,-36.0,-46.0,-43.0,-45.0,-35.0,-47.0,-90.0,-93.0,-90.0,-93.0,46.0,47.0,54.0,47.0,1
1662,92:69:1D:31:68:E9,3855738,489445484,4223,3717300,3851515,485728184,1,5819,1239597,5637,1198159,182,41438,2351,12,4500,104,1,66,216660.0,130000.0,-51.0,-45.0,-43.0,-48.0,-51.0,-48.0,-44.0,-49.0,-90.0,-93.0,-90.0,-93.0,39.0,48.0,47.0,45.0,1
1663,CC:2F:71:3F:1F:24,5216078,2074307544,1364563,1588579360,3851515,485728184,2222,1152712,1332211514,1151820,1332103316,892,108198,1115889,15,1362699,126620,2219,873,130000.0,43333.0,-71.0,-69.0,-66.0,-74.0,-71.0,-69.0,-65.0,-74.0,-90.0,-93.0,-90.0,-93.0,19.0,24.0,24.0,19.0,1
1664,CC:2F:71:3E:C5:1F,3852554,485855280,1039,127096,3851515,485728184,3,4531,377926,3777,288424,754,89502,1101,14,1491,30,3,54,144444.0,39000.0,-72.0,-71.0,-68.0,-61.0,-72.0,-70.0,-69.0,-60.0,-90.0,-93.0,-90.0,-93.0,18.0,22.0,22.0,32.0,1
1665,BA:8C:B9:54:50:24,3856486,491926658,4971,6198474,3851515,485728184,7,10067,1773418,10045,1769923,22,3495,2364,18,5504,44,7,78,229410.0,137640.0,-39.0,-36.0,-45.0,-51.0,-43.0,-35.0,-42.0,-46.0,-90.0,-93.0,-90.0,-93.0,51.0,57.0,45.0,42.0,1
1666,62:47:05:9D:EB:15,3858598,498054231,7078,12325583,3851520,485728648,1,7603,3921894,7552,3914098,51,7796,3592,0,7162,56,1,127,216660.0,130000.0,-44.0,-46.0,-36.0,-46.0,-43.0,-45.0,-35.0,-47.0,-90.0,-93.0,-90.0,-93.0,46.0,47.0,54.0,47.0,1
1667,92:69:1D:31:68:E9,3855743,489445948,4223,3717300,3851520,485728648,1,5819,1239597,5637,1198159,182,41438,2351,12,4500,104,1,66,216660.0,130000.0,-51.0,-45.0,-43.0,-48.0,-51.0,-48.0,-44.0,-49.0,-90.0,-93.0,-90.0,-93.0,39.0,48.0,47.0,45.0,1
1668,CC:2F:71:3F:1F:24,5216286,2074556061,1364764,1588827211,3851522,485728850,2222,1152899,1332450392,1152007,1332342194,892,108198,1116072,15,1362900,126623,2219,873,130000.0,43333.0,-71.0,-69.0,-66.0,-74.0,-70.0,-69.0,-66.0,-74.0,-90.0,-93.0,-90.0,-93.0,19.0,24.0,24.0,19.0,1
1669,CC:2F:71:3E:C5:1F,3852561,485855946,1039,127096,3851522,485728850,3,4531,377926,3777,288424,754,89502,1101,14,1491,30,3,54,144444.0,39000.0,-72.0,-71.0,-68.0,-61.0,-72.0,-70.0,-69.0,-60.0,-90.0,-93.0,-90.0,-93.0,18.0,22.0,22.0,32.0,1
1670,BA:8C:B9:54:50:24,3856493,491927324,4971,6198474,3851522,485728850,7,10067,1773418,10045,1769923,22,3495,2364,18,5504,44,7,78,229410.0,137640.0,-39.0,-36.0,-45.0,-51.0,-43.0,-35.0,-42.0,-46.0,-90.0,-93.0,-90.0,-93.0,51.0,57.0,45.0,42.0,1
1671,62:47:05:9D:EB:15,3858602,498054635,7078,12325583,3851524,485729052,1,7605,3922030,7554,3914234,51,7796,3592,0,7162,56,1,127,216660.0,130000.0,-44.0,-45.0,-36.0,-46.0,-43.0,-45.0,-35.0,-46.0,-90.0,-93.0,-90.0,-93.0,46.0,48.0,54.0,47.0,1
1672,92:69:1D:31:68:E9,3855747,489446352,4223,3717300,3851524,485729052,1,5819,1239597,5637,1198159,182,41438,2351,12,4500,104,1,66,216660.0,130000.0,-51.0,-45.0,-43.0,-48.0,-51.0,-48.0,-44.0,-49.0,-90.0,-93.0,-90.0,-93.0,39.0,48.0,47.0,45.0,1
1673,CC:2F:71:3F:1F:24,5216478,2074797555,1364954,1589068503,3851524,485729052,2222,1153073,1332684500,1152181,1332576302,892,108198,1116240,15,1363090,126625,2219,873,130000.0,43333.0,-71.0,-69.0,-66.0,-74.0,-71.0,-69.0,-65.0,-74.0,-90.0,-93.0,-90.0,-93.0,19.0,24.0,24.0,19.0,1
1674,CC:2F:71:3E:C5:1F,3852563,485856148,1039,127096,3851524,485729052,3,4531,377926,3777,288424,754,89502,1101,14,1491,30,3,54,144444.0,39000.0,-72.0,-71.0,-68.0,-61.0,-72.0,-70.0,-69.0,-60.0,-90.0,-93.0,-89.0,-92.0,18.0,22.0,21.0,31.0,1
1675,BA:8C:B9:54:50:24,3856495,491927526,4971,6198474,3851524,485729052,7,10067,1773418,10045,1769923,22,3495,2364,18,5504,44,7,78,229410.0,137640.0,-39.0,-36.0,-45.0,-51.0,-43.0,-35.0,-42.0,-46.0,-90.0,-93.0,-89.0,-92.0,51.0,57.0,44.0,41.0,1
1676,62:47:05:9D:EB:15,3858606,498055039,7078,12325583,3851528,485729456,1,7606,3922098,7555,3914302,51,7796,3592,0,7162,56,1,127,216660.0,130000.0,-44.0,-45.0,-36.0,-46.0,-43.0,-45.0,-35.0,-46.0,-90.0,-93.0,-89.0,-92.0,46.0,48.0,53.0,46.0,1
1677,92:69:1D:31:68:E9,3855754,489447018,4223,3717300,3851531,485729718,1,5819,1239597,5637,1198159,182,41438,2351,12,4500,104,1,66,216660.0,130000.0,-51.0,-45.0,-43.0,-48.0,-51.0,-48.0,-44.0,-49.0,-90.0,-93.0,-89.0,-92.0,39.0,48.0,46.0,44.0,1
1678,CC:2F:71:3F:1F:24,5216677,2075042397,1365146,1589312679,3851531,485729718,2222,1153246,1332918402,1152354,1332810204,892,108198,1116410,15,1363282,126639,2219,873,130000.0,43333.0,-71.0,-69.0,-66.0,-74.0,-71.0,-69.0,-66.0,-74.0,-90.0,-93.0,-89.0,-92.0,19.0,24.0,23.0,18.0,1
1679,CC:2F:71:3E:C5:1F,3852570,485856814,1039,127096,3851531,485729718,3,4531,377926,3777,288424,754,89502,1101,14,1491,30,3,54,144444.0,39000.0,-72.0,-71.0,-68.0,-61.0,-72.0,-70.0,-69.0,-60.0,-90.0,-93.0,-89.0,-92.0,18.0,22.0,21.0,31.0,1
1680,BA:8C:B9:54:50:24,3856502,491928192,4971,6198474,3851531,485729718,7,10067,1773418,10045,1769923,22,3495,2364,18,5504,44,7,78,229410.0,137640.0,-39.0,-36.0,-45.0,-51.0,-43.0,-35.0,-42.0,-46.0,-90.0,-93.0,-89.0,-92.0,51.0,57.0,44.0,41.0,1
1681,62:47:05:9D:EB:15,3858611,498055503,7078,12325583,3851533,485729920,1,7606,3922098,7555,3914302,51,7796,3592,0,7162,56,1,127,216660.0,130000.0,-44.0,-45.0,-36.0,-46.0,-43.0,-45.0,-35.0,-46.0,-90.0,-92.0,-89.0,-92.0,46.0,47.0,53.0,46.0,1
1682,92:69:1D:31:68:E9,3855756,489447220,4223,3717300,3851533,485729920,1,5819,1239597,5637,1198159,182,41438,2351,12,4500,104,1,66,216660.0,130000.0,-51.0,-45.0,-43.0,-48.0,-51.0,-48.0,-44.0,-49.0,-90.0,-92.0,-89.0,-92.0,39.0,47.0,46.0,44.0,1
1683,CC:2F:71:3F:1F:24,5216878,2075290454,1365345,1589560534,3851533,485729920,2222,1153422,1333147419,1152530,1333039221,892,108198,1116585,15,1363481,126639,2219,873,130000.0,43333.0,-72.0,-69.0,-66.0,-72.0,-71.0,-69.0,-66.0,-72.0,-90.0,-92.0,-89.0,-92.0,18.0,23.0,23.0,20.0,1
1684,CC:2F:71:3E:C5:1F,3852572,485857016,1039,127096,3851533,485729920,3,4531,377926,3777,288424,754,89502,1101,14,1491,30,3,54,144444.0,39000.0,-72.0,-71.0,-68.0,-61.0,-72.0,-70.0,-69.0,-60.0,-90.0,-92.0,-89.0,-92.0,18.0,21.0,21.0,31.0,1
1685,BA:8C:B9:54:50:24,3856504,491928394,4971,6198474,3851533,485729920,7,10067,1773418,10045,1769923,22,3495,2364,18,5504,44,7,78,229410.0,137640.0,-39.0,-36.0,-45.0,-51.0,-43.0,-35.0,-42.0,-46.0,-90.0,-92.0,-89.0,-92.0,51.0,56.0,44.0,41.0,1
1686,62:47:05:9D:EB:15,3858617,498056109,7078,12325583,3851539,485730526,1,7606,3922098,7555,3914302,51,7796,3592,0,7162,56,1,127,216660.0,130000.0,-44.0,-45.0,-36.0,-46.0,-43.0,-45.0,-35.0,-46.0,-90.0,-92.0,-89.0,-92.0,46.0,47.0,53.0,46.0,1
1687,92:69:1D:31:68:E9,3855762,489447826,4223,3717300,3851539,485730526,1,5819,1239597,5637,1198159,182,41438,2351,12,4500,104,1,66,216660.0,130000.0,-51.0,-45.0,-43.0,-48.0,-51.0,-48.0,-44.0,-49.0,-90.0,-92.0,-89.0,-92.0,39.0,47.0,46.0,44.0,1
1688,CC:2F:71:3F:1F:24,5217077,2075535406,1365538,1589804880,3851539,485730526,2222,1153604,1333389683,1152712,1333281485,892,108198,1116759,15,1363674,126647,2219,873,144444.0,43333.0,-71.0,-69.0,-66.0,-72.0,-71.0,-69.0,-66.0,-72.0,-90.0,-92.0,-89.0,-92.0,19.0,23.0,23.0,20.0,1
1689,CC:2F:71:3E:C5:1F,3852580,485857824,1039,127096,3851541,485730728,3,4531,377926,3777,288424,754,89502,1101,14,1491,30,3,54,144444.0,39000.0,-72.0,-71.0,-68.0,-61.0,-72.0,-70.0,-69.0,-60.0,-90.0,-92.0,-89.0,-92.0,18.0,21.0,21.0,31.0,1
1690,BA:8C:B9:54:50:24,3856512,491929202,4971,6198474,3851541,485730728,7,10067,1773418,10045,1769923,22,3495,2364,18,5504,44,7,78,229410.0,137640.0,-39.0,-36.0,-45.0,-51.0,-43.0,-35.0,-42.0,-46.0,-90.0,-92.0,-89.0,-92.0,51.0,56.0,44.0,41.0,1
1691,62:47:05:9D:EB:15,3858620,498056371,7078,12325583,3851542,485730788,1,7606,3922098,7555,3914302,51,7796,3592,0,7162,56,1,127,216660.0,130000.0,-44.0,-45.0,-36.0,-46.0,-43.0,-45.0,-35.0,-46.0,-90.0,-92.0,-89.0,-92.0,46.0,47.0,53.0,46.0,1
1692,92:69:1D:31:68:E9,3855765,489448088,4223,3717300,3851542,485730788,1,5819,1239597,5637,1198159,182,41438,2351,12,4500,104,1,66,216660.0,130000.0,-51.0,-45.0,-43.0,-48.0,-51.0,-48.0,-44.0,-49.0,-90.0,-92.0,-89.0,-92.0,39.0,47.0,46.0,44.0,1
1693,CC:2F:71:3F:1F:24,5217270,2075776888,1365728,1590046100,3851542,485730788,2222,1153783,1333628623,1152891,1333520425,892,108198,1116930,15,1363864,126664,2219,873,130000.0,43333.0,-71.0,-70.0,-67.0,-73.0,-70.0,-69.0,-66.0,-73.0,-90.0,-92.0,-89.0,-92.0,19.0,22.0,22.0,19.0,1
1694,CC:2F:71:3E:C5:1F,3852581,485857884,1039,127096,3851542,485730788,3,4531,377926,3777,288424,754,89502,1101,14,1491,30,3,54,144444.0,39000.0,-72.0,-71.0,-68.0,-61.0,-72.0,-70.0,-69.0,-60.0,-90.0,-92.0,-89.0,-92.0,18.0,21.0,21.0,31.0,1
1695,BA:8C:B9:54:50:24,3856513,491929262,4971,6198474,3851542,485730788,7,10067,1773418,10045,1769923,22,3495,2364,18,5504,44,7,78,229410.0,137640.0,-39.0,-36.0,-45.0,-51.0,-43.0,-35.0,-42.0,-46.0,-90.0,-92.0,-89.0,-92.0,51.0,56.0,44.0,41.0,1
1696,62:47:05:9D:EB:15,3858627,498057093,7079,12325699,3851548,485731394,1,7608,3922234,7557,3914438,51,7796,3592,0,7163,56,1,127,216660.0,130000.0,-43.0,-44.0,-35.0,-46.0,-43.0,-45.0,-37.0,-46.0,-90.0,-92.0,-89.0,-92.0,47.0,48.0,54.0,46.0,1
1697,92:69:1D:31:68:E9,3855772,489448810,4224,3717416,3851548,485731394,1,5821,1239733,5639,1198295,182,41438,2351,12,4501,104,1,66,229410.0,130000.0,-51.0,-47.0,-42.0,-48.0,-51.0,-47.0,-44.0,-48.0,-90.0,-92.0,-89.0,-92.0,39.0,45.0,47.0,44.0,1
1698,CC:2F:71:3F:1F:24,5217470,2076024972,1365922,1590293578,3851548,485731394,2222,1153966,1333876627,1153074,1333768429,892,108198,1117103,15,1364058,126666,2219,873,130000.0,43333.0,-72.0,-69.0,-68.0,-72.0,-72.0,-69.0,-68.0,-72.0,-90.0,-92.0,-89.0,-92.0,18.0,23.0,21.0,20.0,1
1699,CC:2F:71:3E:C5:1F,3852590,485858808,1040,127212,3851550,485731596,3,4533,378066,3779,288564,754,89502,1101,14,1492,30,3,54,144444.0,39000.0,-72.0,-73.0,-71.0,-60.0,-72.0,-71.0,-70.0,-60.0,-90.0,-92.0,-89.0,-91.0,18.0,19.0,18.0,31.0,1
1700,BA:8C:B9:54:50:24,3856522,491930186,4972,6198590,3851550,485731596,7,10075,1773962,10053,1770467,22,3495,2364,18,5505,44,7,78,216660.0,130000.0,-48.0,-35.0,-42.0,-45.0,-42.0,-35.0,-43.0,-45.0,-90.0,-92.0,-89.0,-91.0,42.0,57.0,47.0,46.0,1
1701,62:47:05:9D:EB:15,3858630,498057355,7079,12325699,3851551,485731656,1,7608,3922234,7557,3914438,51,7796,3592,0,7163,56,1,127,216660.0,130000.0,-43.0,-44.0,-35.0,-46.0,-43.0,-45.0,-37.0,-46.0,-90.0,-92.0,-89.0,-91.0,47.0,48.0,54.0,45.0,1
1702,92:69:1D:31:68:E9,3855775,489449072,4224,3717416,3851551,485731656,1,5821,1239733,5639,1198295,182,41438,2351,12,4501,104,1,66,229410.0,130000.0,-51.0,-47.0,-42.0,-48.0,-51.0,-47.0,-44.0,-48.0,-90.0,-92.0,-89.0,-91.0,39.0,45.0,47.0,43.0,1
1703,CC:2F:71:3F:1F:24,5217678,2076282021,1366127,1590550365,3851551,485731656,2222,1154158,1334124826,1153266,1334016628,892,108198,1117290,15,1364263,126690,2219,874,144444.0,43333.0,-71.0,-71.0,-69.0,-72.0,-71.0,-71.0,-69.0,-72.0,-90.0,-92.0,-89.0,-91.0,19.0,21.0,20.0,19.0,1
1704,CC:2F:71:3E:C5:1F,3852591,485858868,1040,127212,3851551,485731656,3,4533,378066,3779,288564,754,89502,1101,14,1492,30,3,54,144444.0,39000.0,-72.0,-73.0,-71.0,-60.0,-72.0,-71.0,-70.0,-60.0,-90.0,-92.0,-89.0,-91.0,18.0,19.0,18.0,31.0,1
1705,BA:8C:B9:54:50:24,3856523,491930246,4972,6198590,3851551,485731656,7,10075,1773962,10053,1770467,22,3495,2364,18,5505,44,7,78,216660.0,130000.0,-48.0,-35.0,-42.0,-45.0,-42.0,-35.0,-43.0,-45.0,-90.0,-92.0,-89.0,-91.0,42.0,57.0,47.0,46.0,1
1706,62:47:05:9D:EB:15,3858638,498058163,7079,12325699,3851559,485732464,1,7608,3922234,7557,3914438,51,7796,3592,0,7163,56,1,127,216660.0,130000.0,-43.0,-44.0,-35.0,-46.0,-43.0,-45.0,-37.0,-46.0,-90.0,-92.0,-89.0,-91.0,47.0,48.0,54.0,45.0,1
1707,92:69:1D:31:68:E9,3855783,489449880,4224,3717416,3851559,485732464,1,5821,1239733,5639,1198295,182,41438,2351,12,4501,104,1,66,229410.0,130000.0,-51.0,-47.0,-42.0,-48.0,-51.0,-47.0,-44.0,-48.0,-90.0,-92.0,-89.0,-91.0,39.0,45.0,47.0,43.0,1
1708,CC:2F:71:3F:1F:24,5217878,2076527157,1366319,1590794693,3851559,485732464,2222,1154339,1334367192,1153447,1334258994,892,108198,1117460,15,1364455,126710,2219,874,130000.0,39000.0,-70.0,-70.0,-68.0,-74.0,-70.0,-70.0,-67.0,-73.0,-90.0,-92.0,-89.0,-91.0,20.0,22.0,21.0,17.0,1
1709,CC:2F:71:3E:C5:1F,3852599,485859676,1040,127212,3851559,485732464,3,4533,378066,3779,288564,754,89502,1101,14,1492,30,3,54,144444.0,39000.0,-72.0,-73.0,-71.0,-60.0,-72.0,-71.0,-70.0,-60.0,-90.0,-92.0,-89.0,-91.0,18.0,19.0,18.0,31.0,1
1710,BA:8C:B9:54:50:24,3856531,491931054,4972,6198590,3851559,485732464,7,10075,1773962,10053,1770467,22,3495,2364,18,5505,44,7,78,216660.0,130000.0,-48.0,-35.0,-42.0,-45.0,-42.0,-35.0,-43.0,-45.0,-90.0,-92.0,-89.0,-91.0,42.0,57.0,47.0,46.0,1
1711,62:47:05:9D:EB:15,3858639,498058436,7079,12325699,3851560,485732737,1,7608,3922234,7557,3914438,51,7796,3592,0,7163,56,1,127,216660.0,130000.0,-43.0,-44.0,-35.0,-46.0,-43.0,-45.0,-37.0,-46.0,-90.0,-92.0,-89.0,-91.0,47.0,48.0,54.0,45.0,1
1712,92:69:1D:31:68:E9,3855784,489450153,4224,3717416,3851560,485732737,1,5821,1239733,5639,1198295,182,41438,2351,12,4501,104,1,66,229410.0,130000.0,-51.0,-47.0,-42.0,-48.0,-51.0,-47.0,-44.0,-48.0,-90.0,-92.0,-89.0,-91.0,39.0,45.0,47.0,43.0,1
1713,CC:2F:71:3F:1F:24,5218069,2076768482,1366509,1591035745,3851560,485732737,2222,1154509,1334596460,1153617,1334488262,892,108198,1117628,15,1364645,126723,2219,874,130000.0,43333.0,-73.0,-73.0,-73.0,-76.0,-72.0,-72.0,-72.0,-75.0,-90.0,-92.0,-89.0,-91.0,17.0,19.0,16.0,15.0,1
1714,CC:2F:71:3E:C5:1F,3852600,485859949,1040,127212,3851560,485732737,3,4533,378066,3779,288564,754,89502,1101,14,1492,30,3,54,144444.0,39000.0,-72.0,-73.0,-71.0,-60.0,-72.0,-71.0,-70.0,-60.0,-90.0,-92.0,-89.0,-91.0,18.0,19.0,18.0,31.0,1
1715,BA:8C:B9:54:50:24,3856532,491931327,4972,6198590,3851560,485732737,7,10075,1773962,10053,1770467,22,3495,2364,18,5505,44,7,78,216660.0,130000.0,-48.0,-35.0,-42.0,-45.0,-42.0,-35.0,-43.0,-45.0,-90.0,-92.0,-89.0,-91.0,42.0,57.0,47.0,46.0,1
1716,62:47:05:9D:EB:15,3858648,498059304,7079,12325699,3851569,485733605,1,7608,3922234,7557,3914438,51,7796,3592,0,7163,56,1,127,216660.0,130000.0,-43.0,-44.0,-35.0,-46.0,-43.0,-45.0,-37.0,-46.0,-90.0,-92.0,-89.0,-91.0,47.0,48.0,54.0,45.0,1
1717,92:69:1D:31:68:E9,3855793,489451021,4224,3717416,3851569,485733605,1,5821,1239733,5639,1198295,182,41438,2351,12,4501,104,1,66,229410.0,130000.0,-51.0,-47.0,-42.0,-48.0,-51.0,-47.0,-44.0,-48.0,-90.0,-92.0,-89.0,-91.0,39.0,45.0,47.0,43.0,1
1718,CC:2F:71:3F:1F:24,5218272,2077016506,1366703,1591282901,3851569,485733605,2222,1154689,1334836954,1153797,1334728756,892,108198,1117802,15,1364839,126734,2219,874,130000.0,43333.0,-73.0,-73.0,-73.0,-76.0,-73.0,-72.0,-73.0,-76.0,-90.0,-92.0,-89.0,-91.0,17.0,19.0,16.0,15.0,1
1719,CC:2F:71:3E:C5:1F,3852609,485860817,1040,127212,3851569,485733605,3,4533,378066,3779,288564,754,89502,1101,14,1492,30,3,54,144444.0,39000.0,-72.0,-73.0,-71.0,-60.0,-72.0,-71.0,-70.0,-60.0,-90.0,-92.0,-89.0,-91.0,18.0,19.0,18.0,31.0,1
1720,BA:8C:B9:54:50:24,3856541,491932195,4972,6198590,3851569,485733605,7,10075,1773962,10053,1770467,22,3495,2364,18,5505,44,7,78,216660.0,130000.0,-48.0,-35.0,-42.0,-45.0,-42.0,-35.0,-43.0,-45.0,-90.0,-92.0,-89.0,-91.0,42.0,57.0,47.0,46.0,1
1721,62:47:05:9D:EB:15,3858648,498059304,7079,12325699,3851569,485733605,1,7608,3922234,7557,3914438,51,7796,3592,0,7163,56,1,127,216660.0,130000.0,-43.0,-44.0,-35.0,-46.0,-43.0,-45.0,-37.0,-46.0,-90.0,-92.0,-89.0,-91.0,47.0,48.0,54.0,45.0,1
1722,92:69:1D:31:68:E9,3855793,489451021,4224,3717416,3851569,485733605,1,5821,1239733,5639,1198295,182,41438,2351,12,4501,104,1,66,229410.0,130000.0,-51.0,-47.0,-42.0,-48.0,-51.0,-47.0,-44.0,-48.0,-90.0,-92.0,-89.0,-91.0,39.0,45.0,47.0,43.0,1
1723,CC:2F:71:3F:1F:24,5218481,2077280029,1366912,1591546424,3851569,485733605,2222,1154895,1335097087,1154003,1334988889,892,108198,1117997,15,1365048,126735,2219,876,130000.0,43333.0,-69.0,-70.0,-70.0,-73.0,-69.0,-70.0,-69.0,-73.0,-90.0,-92.0,-89.0,-91.0,21.0,22.0,19.0,18.0,1
1724,CC:2F:71:3E:C5:1F,3852613,485861221,1040,127212,3851573,485734009,3,4533,378066,3779,288564,754,89502,1101,14,1492,30,3,54,144444.0,39000.0,-72.0,-73.0,-71.0,-60.0,-72.0,-71.0,-70.0,-60.0,-90.0,-92.0,-89.0,-91.0,18.0,19.0,18.0,31.0,1
1725,BA:8C:B9:54:50:24,3856547,491932801,4972,6198590,3851575,485734211,7,10075,1773962,10053,1770467,22,3495,2364,18,5505,44,7,78,216660.0,130000.0,-48.0,-35.0,-42.0,-45.0,-42.0,-35.0,-43.0,-45.0,-90.0,-92.0,-89.0,-91.0,42.0,57.0,47.0,46.0,1
1726,62:47:05:9D:EB:15,3858657,498060172,7079,12325699,3851578,485734473,1,7608,3922234,7557,3914438,51,7796,3592,0,7163,56,1,127,216660.0,130000.0,-43.0,-44.0,-35.0,-46.0,-43.0,-45.0,-37.0,-46.0,-90.0,-92.0,-89.0,-91.0,47.0,48.0,54.0,45.0,1
1727,92:69:1D:31:68:E9,3855802,489451889,4224,3717416,3851578,485734473,1,5821,1239733,5639,1198295,182,41438,2351,12,4501,104,1,66,229410.0,130000.0,-51.0,-47.0,-42.0,-48.0,-51.0,-47.0,-44.0,-48.0,-90.0,-92.0,-89.0,-91.0,39.0,45.0,47.0,43.0,1
1728,CC:2F:71:3F:1F:24,5218688,2077534605,1367110,1591800132,3851578,485734473,2222,1155078,1335345117,1154186,1335236919,892,108198,1118173,15,1365246,126737,2219,876,130000.0,43333.0,-70.0,-70.0,-69.0,-73.0,-69.0,-70.0,-69.0,-73.0,-90.0,-92.0,-89.0,-91.0,20.0,22.0,20.0,18.0,1
1729,CC:2F:71:3E:C5:1F,3852618,485861685,1040,127212,3851578,485734473,3,4533,378066,3779,288564,754,89502,1101,14,1492,30,3,54,144444.0,39000.0,-72.0,-73.0,-71.0,-60.0,-72.0,-71.0,-70.0,-60.0,-90.0,-92.0,-89.0,-91.0,18.0,19.0,18.0,31.0,1
1730,BA:8C:B9:54:50:24,3856550,491933063,4972,6198590,3851578,485734473,7,10075,1773962,10053,1770467,22,3495,2364,18,5505,44,7,78,216660.0,130000.0,-48.0,-35.0,-42.0,-45.0,-42.0,-35.0,-43.0,-45.0,-90.0,-92.0,-89.0,-91.0,42.0,57.0,47.0,46.0,1
1731,62:47:05:9D:EB:15,3858659,498060374,7079,12325699,3851580,485734675,1,7608,3922234,7557,3914438,51,7796,3592,0,7163,56,1,127,216660.0,130000.0,-43.0,-44.0,-35.0,-46.0,-43.0,-45.0,-37.0,-46.0,-90.0,-92.0,-89.0,-91.0,47.0,48.0,54.0,45.0,1
1732,92:69:1D:31:68:E9,3855808,489452495,4224,3717416,3851584,485735079,1,5821,1239733,5639,1198295,182,41438,2351,12,4501,104,1,66,229410.0,130000.0,-51.0,-47.0,-42.0,-48.0,-51.0,-47.0,-44.0,-48.0,-90.0,-92.0,-89.0,-91.0,39.0,45.0,47.0,43.0,1
1733,CC:2F:71:3F:1F:24,5218895,2077791933,1367311,1592056854,3851584,485735079,2222,1155259,1335591367,1154367,1335483169,892,108198,1118351,15,1365447,126744,2219,876,130000.0,43333.0,-70.0,-70.0,-70.0,-74.0,-70.0,-70.0,-69.0,-74.0,-90.0,-92.0,-89.0,-91.0,20.0,22.0,19.0,17.0,1
1734,CC:2F:71:3E:C5:1F,3852624,485862291,1040,127212,3851584,485735079,3,4533,378066,3779,288564,754,89502,1101,14,1492,30,3,54,144444.0,39000.0,-72.0,-73.0,-71.0,-60.0,-72.0,-71.0,-70.0,-60.0,-90.0,-92.0,-89.0,-91.0,18.0,19.0,18.0,31.0,1
1735,BA:8C:B9:54:50:24,3856556,491933669,4972,6198590,3851584,485735079,7,10075,1773962,10053,1770467,22,3495,2364,18,5505,44,7,78,216660.0,130000.0,-48.0,-35.0,-42.0,-45.0,-42.0,-35.0,-43.0,-45.0,-90.0,-92.0,-89.0,-91.0,42.0,57.0,47.0,46.0,1
1736,62:47:05:9D:EB:15,3858665,498060980,7079,12325699,3851586,485735281,1,7608,3922234,7557,3914438,51,7796,3592,0,7163,56,1,127,216660.0,130000.0,-43.0,-44.0,-35.0,-46.0,-43.0,-45.0,-37.0,-46.0,-90.0,-91.0,-89.0,-91.0,47.0,47.0,54.0,45.0,1
1737,92:69:1D:31:68:E9,3855810,489452697,4224,3717416,3851586,485735281,1,5821,1239733,5639,1198295,182,41438,2351,12,4501,104,1,66,229410.0,130000.0,-51.0,-47.0,-42.0,-48.0,-51.0,-47.0,-44.0,-48.0,-90.0,-91.0,-89.0,-91.0,39.0,44.0,47.0,43.0,1
1738,CC:2F:71:3F:1F:24,5219094,2078037771,1367508,1592302490,3851586,485735281,2222,1155437,1335823596,1154545,1335715398,892,108198,1118527,15,1365643,126744,2219,876,130000.0,43333.0,-70.0,-70.0,-69.0,-73.0,-69.0,-70.0,-68.0,-73.0,-90.0,-91.0,-89.0,-91.0,20.0,21.0,20.0,18.0,1
1739,CC:2F:71:3E:C5:1F,3852626,485862493,1040,127212,3851586,485735281,3,4533,378066,3779,288564,754,89502,1101,14,1492,30,3,54,144444.0,39000.0,-72.0,-73.0,-71.0,-60.0,-72.0,-71.0,-70.0,-60.0,-90.0,-91.0,-89.0,-91.0,18.0,18.0,18.0,31.0,1
1740,BA:8C:B9:54:50:24,3856559,491933931,4972,6198590,3851587,485735341,7,10075,1773962,10053,1770467,22,3495,2364,18,5505,44,7,78,216660.0,130000.0,-48.0,-35.0,-42.0,-45.0,-42.0,-35.0,-43.0,-45.0,-90.0,-91.0,-89.0,-91.0,42.0,56.0,47.0,46.0,1
1741,62:47:05:9D:EB:15,3858672,498061646,7079,12325699,3851593,485735947,1,7608,3922234,7557,3914438,51,7796,3592,0,7163,56,1,127,216660.0,130000.0,-43.0,-44.0,-35.0,-46.0,-43.0,-45.0,-37.0,-46.0,-90.0,-91.0,-88.0,-90.0,47.0,47.0,53.0,44.0,1
1742,92:69:1D:31:68:E9,3855817,489453363,4224,3717416,3851593,485735947,1,5822,1239801,5640,1198363,182,41438,2351,12,4501,104,1,66,229410.0,130000.0,-49.0,-51.0,-41.0,-47.0,-51.0,-48.0,-43.0,-48.0,-90.0,-91.0,-88.0,-90.0,41.0,40.0,47.0,43.0,1
1743,CC:2F:71:3F:1F:24,5219296,2078282084,1367703,1592546137,3851593,485735947,2222,1155615,1336059544,1154723,1335951346,892,108198,1118699,15,1365839,126752,2219,876,130000.0,43333.0,-70.0,-70.0,-69.0,-73.0,-71.0,-72.0,-71.0,-75.0,-90.0,-91.0,-88.0,-90.0,20.0,21.0,19.0,17.0,1
1744,CC:2F:71:3E:C5:1F,3852633,485863159,1040,127212,3851593,485735947,3,4533,378066,3779,288564,754,89502,1101,14,1492,30,3,54,144444.0,39000.0,-72.0,-73.0,-71.0,-60.0,-72.0,-71.0,-70.0,-60.0,-90.0,-91.0,-88.0,-90.0,18.0,18.0,17.0,30.0,1
1745,BA:8C:B9:54:50:24,3856565,491934537,4972,6198590,3851593,485735947,7,10075,1773962,10053,1770467,22,3495,2364,18,5505,44,7,78,216660.0,130000.0,-48.0,-35.0,-42.0,-45.0,-42.0,-35.0,-43.0,-45.0,-90.0,-91.0,-88.0,-90.0,42.0,56.0,46.0,45.0,1
1746,62:47:05:9D:EB:15,3858674,498061848,7079,12325699,3851595,485736149,1,7608,3922234,7557,3914438,51,7796,3592,0,7163,56,1,127,216660.0,130000.0,-43.0,-44.0,-35.0,-46.0,-43.0,-45.0,-37.0,-46.0,-90.0,-91.0,-88.0,-90.0,47.0,47.0,53.0,44.0,1
1747,92:69:1D:31:68:E9,3855819,489453565,4224,3717416,3851595,485736149,1,5822,1239801,5640,1198363,182,41438,2351,12,4501,104,1,66,229410.0,130000.0,-49.0,-51.0,-41.0,-47.0,-51.0,-48.0,-43.0,-48.0,-90.0,-91.0,-88.0,-90.0,41.0,40.0,47.0,43.0,1
1748,CC:2F:71:3F:1F:24,5219502,2078542246,1367907,1592806097,3851595,485736149,2222,1155802,1336313820,1154910,1336205622,892,108198,1118880,15,1366043,126756,2219,876,130000.0,43333.0,-69.0,-69.0,-68.0,-72.0,-69.0,-69.0,-68.0,-72.0,-90.0,-91.0,-88.0,-90.0,21.0,22.0,20.0,18.0,1
1749,CC:2F:71:3E:C5:1F,3852635,485863361,1040,127212,3851595,485736149,3,4533,378066,3779,288564,754,89502,1101,14,1492,30,3,54,144444.0,39000.0,-72.0,-73.0,-71.0,-60.0,-72.0,-71.0,-70.0,-60.0,-90.0,-91.0,-88.0,-90.0,18.0,18.0,17.0,30.0,1
1750,BA:8C:B9:54:50:24,3856568,491934801,4972,6198590,3851596,485736211,7,10075,1773962,10053,1770467,22,3495,2364,18,5505,44,7,78,216660.0,130000.0,-48.0,-35.0,-42.0,-45.0,-42.0,-35.0,-43.0,-45.0,-90.0,-91.0,-88.0,-90.0,42.0,56.0,46.0,45.0,1
1751,62:47:05:9D:EB:15,3858683,498062638,7079,12325699,3851604,485736939,1,7608,3922234,7557,3914438,51,7796,3592,0,7163,56,1,127,216660.0,130000.0,-43.0,-44.0,-35.0,-46.0,-43.0,-45.0,-37.0,-46.0,-90.0,-91.0,-88.0,-90.0,47.0,47.0,53.0,44.0,1
1752,92:69:1D:31:68:E9,3855828,489454355,4224,3717416,3851604,485736939,1,5822,1239801,5640,1198363,182,41438,2351,12,4501,104,1,66,229410.0,130000.0,-49.0,-51.0,-41.0,-47.0,-51.0,-48.0,-43.0,-48.0,-90.0,-91.0,-88.0,-90.0,41.0,40.0,47.0,43.0,1
1753,CC:2F:71:3F:1F:24,5219702,2078784386,1368098,1593047447,3851604,485736939,2222,1155980,1336552788,1155087,1336444472,893,108316,1119049,15,1366234,126756,2219,876,130000.0,39000.0,-69.0,-70.0,-69.0,-74.0,-69.0,-69.0,-69.0,-73.0,-90.0,-91.0,-88.0,-90.0,21.0,21.0,19.0,16.0,1
1754,CC:2F:71:3E:C5:1F,3852644,485864151,1040,127212,3851604,485736939,3,4535,378254,3780,288634,755,89620,1102,14,1492,30,3,54,144444.0,39000.0,-72.0,-72.0,-67.0,-60.0,-72.0,-71.0,-69.0,-60.0,-90.0,-91.0,-88.0,-90.0,18.0,19.0,21.0,30.0,1
1755,BA:8C:B9:54:50:24,3856576,491935529,4972,6198590,3851604,485736939,7,10075,1773962,10053,1770467,22,3495,2364,18,5505,44,7,78,216660.0,130000.0,-48.0,-35.0,-42.0,-45.0,-42.0,-35.0,-43.0,-45.0,-90.0,-91.0,-88.0,-90.0,42.0,56.0,46.0,45.0,1
1756,62:47:05:9D:EB:15,3858697,498068439,7079,12325699,3851618,485742740,1,7608,3922234,7557,3914438,51,7796,3592,0,7163,56,1,127,216660.0,130000.0,-43.0,-44.0,-35.0,-46.0,-43.0,-45.0,-37.0,-46.0,-90.0,-91.0,-88.0,-90.0,47.0,47.0,53.0,44.0,1
1757,92:69:1D:31:68:E9,3855842,489460156,4224,3717416,3851618,485742740,1,5825,1240172,5642,1198499,183,41673,2352,12,4501,104,1,66,229410.0,130000.0,-50.0,-49.0,-42.0,-46.0,-51.0,-48.0,-43.0,-48.0,-90.0,-91.0,-88.0,-90.0,40.0,42.0,46.0,44.0,1
1758,CC:2F:71:3F:1F:24,5219937,2079058954,1368308,1593310790,3851629,485748164,2222,1156183,1336812138,1155290,1336703822,893,108316,1119240,15,1366444,126769,2219,876,130000.0,43333.0,-70.0,-70.0,-69.0,-74.0,-69.0,-70.0,-69.0,-73.0,-90.0,-91.0,-88.0,-90.0,20.0,21.0,19.0,16.0,1
1759,CC:2F:71:3E:C5:1F,3852669,485875376,1040,127212,3851629,485748164,3,4535,378254,3780,288634,755,89620,1102,14,1492,30,3,54,144444.0,39000.0,-72.0,-72.0,-67.0,-60.0,-72.0,-71.0,-69.0,-60.0,-90.0,-91.0,-88.0,-90.0,18.0,19.0,21.0,30.0,1
1760,BA:8C:B9:54:50:24,3856601,491946754,4972,6198590,3851629,485748164,7,10076,1774030,10054,1770535,22,3495,2364,18,5506,44,7,78,216660.0,130000.0,-39.0,-36.0,-45.0,-51.0,-41.0,-35.0,-43.0,-46.0,-90.0,-91.0,-88.0,-90.0,51.0,55.0,43.0,39.0,1
1761,62:47:05:9D:EB:15,3858714,498074469,7079,12325699,3851635,485748770,1,7608,3922234,7557,3914438,51,7796,3592,0,7163,56,1,127,216660.0,130000.0,-43.0,-44.0,-35.0,-46.0,-43.0,-45.0,-37.0,-46.0,-90.0,-91.0,-88.0,-90.0,47.0,47.0,53.0,44.0,1
1762,92:69:1D:31:68:E9,3855860,489466246,4224,3717416,3851636,485748830,1,5825,1240172,5642,1198499,183,41673,2352,12,4501,104,1,66,229410.0,130000.0,-50.0,-49.0,-42.0,-46.0,-51.0,-48.0,-43.0,-48.0,-90.0,-91.0,-88.0,-90.0,40.0,42.0,46.0,44.0,1
1763,CC:2F:71:3F:1F:24,5220141,2079310354,1368504,1593561390,3851637,485748964,2222,1156362,1337053932,1155469,1336945616,893,108316,1119414,15,1366640,126769,2219,876,130000.0,43333.0,-70.0,-70.0,-69.0,-74.0,-70.0,-70.0,-69.0,-74.0,-90.0,-91.0,-88.0,-90.0,20.0,21.0,19.0,16.0,1
1764,CC:2F:71:3E:C5:1F,3852678,485876244,1040,127212,3851638,485749032,3,4535,378254,3780,288634,755,89620,1102,14,1492,30,3,54,144444.0,39000.0,-72.0,-72.0,-67.0,-60.0,-72.0,-71.0,-69.0,-60.0,-90.0,-91.0,-88.0,-90.0,18.0,19.0,21.0,30.0,1
1765,BA:8C:B9:54:50:24,3856610,491947622,4972,6198590,3851638,485749032,7,10077,1774098,10055,1770603,22,3495,2364,18,5506,44,7,78,216660.0,130000.0,-48.0,-35.0,-42.0,-45.0,-42.0,-35.0,-43.0,-46.0,-90.0,-91.0,-88.0,-90.0,42.0,56.0,46.0,45.0,1
1766,62:47:05:9D:EB:15,3858717,498074731,7079,12325699,3851638,485749032,1,7610,3922370,7559,3914574,51,7796,3592,0,7164,56,1,127,216660.0,130000.0,-42.0,-45.0,-35.0,-49.0,-43.0,-45.0,-36.0,-46.0,-90.0,-91.0,-88.0,-90.0,48.0,46.0,53.0,41.0,1
1767,92:69:1D:31:68:E9,3855862,489466448,4224,3717416,3851638,485749032,1,5825,1240172,5642,1198499,183,41673,2352,12,4501,104,1,66,229410.0,130000.0,-50.0,-49.0,-42.0,-46.0,-51.0,-48.0,-43.0,-48.0,-90.0,-91.0,-88.0,-90.0,40.0,42.0,46.0,44.0,1
1768,CC:2F:71:3F:1F:24,5220335,2079554712,1368697,1593805680,3851638,485749032,2222,1156546,1337299490,1155653,1337191174,893,108316,1119585,15,1366833,126782,2219,876,130000.0,43333.0,-71.0,-72.0,-73.0,-77.0,-71.0,-71.0,-72.0,-76.0,-90.0,-91.0,-88.0,-90.0,19.0,19.0,15.0,13.0,1
1769,CC:2F:71:3E:C5:1F,3852678,485876244,1040,127212,3851638,485749032,3,4535,378254,3780,288634,755,89620,1102,14,1492,30,3,54,144444.0,39000.0,-72.0,-72.0,-67.0,-60.0,-72.0,-71.0,-69.0,-60.0,-90.0,-91.0,-88.0,-90.0,18.0,19.0,21.0,30.0,1
1770,BA:8C:B9:54:50:24,3856610,491947622,4972,6198590,3851638,485749032,7,10077,1774098,10055,1770603,22,3495,2364,18,5506,44,7,78,216660.0,130000.0,-48.0,-35.0,-42.0,-45.0,-42.0,-35.0,-43.0,-46.0,-90.0,-91.0,-88.0,-90.0,42.0,56.0,46.0,45.0,1
1771,62:47:05:9D:EB:15,3858724,498075610,7079,12325699,3851645,485749911,1,7610,3922370,7559,3914574,51,7796,3592,0,7164,56,1,127,216660.0,130000.0,-42.0,-45.0,-35.0,-49.0,-43.0,-45.0,-36.0,-46.0,-90.0,-91.0,-88.0,-90.0,48.0,46.0,53.0,41.0,1
1772,92:69:1D:31:68:E9,3855871,489467529,4224,3717416,3851647,485750113,1,5825,1240172,5642,1198499,183,41673,2352,12,4501,104,1,66,229410.0,130000.0,-50.0,-49.0,-42.0,-46.0,-51.0,-48.0,-43.0,-48.0,-90.0,-91.0,-88.0,-90.0,40.0,42.0,46.0,44.0,1
1773,CC:2F:71:3F:1F:24,5220536,2079800009,1368889,1594049896,3851647,485750113,2222,1156726,1337542832,1155833,1337434516,893,108316,1119756,15,1367025,126789,2219,876,130000.0,43333.0,-69.0,-70.0,-71.0,-75.0,-68.0,-69.0,-70.0,-74.0,-90.0,-91.0,-88.0,-90.0,21.0,21.0,17.0,15.0,1
1774,CC:2F:71:3E:C5:1F,3852687,485877325,1040,127212,3851647,485750113,3,4535,378254,3780,288634,755,89620,1102,14,1492,30,3,54,144444.0,39000.0,-72.0,-72.0,-67.0,-60.0,-72.0,-71.0,-69.0,-60.0,-90.0,-91.0,-88.0,-90.0,18.0,19.0,21.0,30.0,1
1775,BA:8C:B9:54:50:24,3856619,491948703,4972,6198590,3851647,485750113,7,10080,1774302,10058,1770807,22,3495,2364,18,5506,44,7,78,216660.0,130000.0,-40.0,-36.0,-45.0,-52.0,-44.0,-35.0,-43.0,-47.0,-90.0,-91.0,-88.0,-90.0,50.0,55.0,43.0,38.0,1
1776,62:47:05:9D:EB:15,3858727,498075872,7079,12325699,3851648,485750173,1,7610,3922370,7559,3914574,51,7796,3592,0,7164,56,1,127,216660.0,130000.0,-42.0,-45.0,-35.0,-49.0,-43.0,-45.0,-36.0,-46.0,-90.0,-91.0,-88.0,-89.0,48.0,46.0,53.0,40.0,1
1777,92:69:1D:31:68:E9,3855872,489467589,4224,3717416,3851648,485750173,1,5825,1240172,5642,1198499,183,41673,2352,12,4501,104,1,66,229410.0,130000.0,-50.0,-49.0,-42.0,-46.0,-51.0,-48.0,-43.0,-48.0,-90.0,-91.0,-88.0,-89.0,40.0,42.0,46.0,43.0,1
1778,CC:2F:71:3F:1F:24,5220739,2080048359,1369091,1594298186,3851648,485750173,2222,1156911,1337774569,1156018,1337666253,893,108316,1119935,15,1367227,126789,2219,876,130000.0,43333.0,-69.0,-69.0,-69.0,-73.0,-68.0,-69.0,-69.0,-73.0,-90.0,-91.0,-88.0,-89.0,21.0,22.0,19.0,16.0,1
1779,CC:2F:71:3E:C5:1F,3852690,485877587,1040,127212,3851650,485750375,3,4535,378254,3780,288634,755,89620,1102,14,1492,30,3,54,144444.0,39000.0,-72.0,-72.0,-67.0,-60.0,-72.0,-71.0,-69.0,-60.0,-90.0,-91.0,-88.0,-89.0,18.0,19.0,21.0,29.0,1
1780,BA:8C:B9:54:50:24,3856622,491948965,4972,6198590,3851650,485750375,7,10081,1774370,10059,1770875,22,3495,2364,18,5506,44,7,78,216660.0,130000.0,-48.0,-35.0,-43.0,-45.0,-45.0,-35.0,-43.0,-46.0,-90.0,-91.0,-88.0,-89.0,42.0,56.0,45.0,44.0,1
1781,62:47:05:9D:EB:15,3858735,498076680,7079,12325699,3851656,485750981,1,7610,3922370,7559,3914574,51,7796,3592,0,7164,56,1,127,216660.0,130000.0,-42.0,-45.0,-35.0,-49.0,-43.0,-45.0,-36.0,-46.0,-90.0,-91.0,-88.0,-89.0,48.0,46.0,53.0,40.0,1
1782,92:69:1D:31:68:E9,3855880,489468397,4224,3717416,3851656,485750981,1,5825,1240172,5642,1198499,183,41673,2352,12,4501,104,1,66,229410.0,130000.0,-50.0,-49.0,-42.0,-46.0,-51.0,-48.0,-43.0,-48.0,-90.0,-91.0,-88.0,-89.0,40.0,42.0,46.0,43.0,1
1783,CC:2F:71:3F:1F:24,5220946,2080303005,1369290,1594552024,3851656,485750981,2222,1157098,1338024633,1156205,1337916317,893,108316,1120112,15,1367426,126791,2219,876,130000.0,43333.0,-69.0,-70.0,-69.0,-75.0,-69.0,-69.0,-69.0,-75.0,-90.0,-91.0,-88.0,-89.0,21.0,21.0,19.0,14.0,1
1784,CC:2F:71:3E:C5:1F,3852698,485878561,1040,127212,3851658,485751349,3,4535,378254,3780,288634,755,89620,1102,14,1492,30,3,54,144444.0,39000.0,-72.0,-72.0,-67.0,-60.0,-72.0,-71.0,-69.0,-60.0,-90.0,-91.0,-88.0,-89.0,18.0,19.0,21.0,29.0,1
1785,BA:8C:B9:54:50:24,3856630,491949939,4972,6198590,3851658,485751349,7,10081,1774370,10059,1770875,22,3495,2364,18,5506,44,7,78,216660.0,130000.0,-48.0,-35.0,-43.0,-45.0,-45.0,-35.0,-43.0,-46.0,-90.0,-91.0,-88.0,-89.0,42.0,56.0,45.0,44.0,1
1786,62:47:05:9D:EB:15,3858738,498077108,7079,12325699,3851659,485751409,1,7610,3922370,7559,3914574,51,7796,3592,0,7164,56,1,127,216660.0,130000.0,-42.0,-45.0,-35.0,-49.0,-43.0,-45.0,-36.0,-46.0,-90.0,-91.0,-88.0,-89.0,48.0,46.0,53.0,40.0,1
1787,92:69:1D:31:68:E9,3855885,489469027,4224,3717416,3851661,485751611,1,5825,1240172,5642,1198499,183,41673,2352,12,4501,104,1,66,229410.0,130000.0,-50.0,-49.0,-42.0,-46.0,-51.0,-48.0,-43.0,-48.0,-90.0,-91.0,-88.0,-89.0,40.0,42.0,46.0,43.0,1
1788,CC:2F:71:3F:1F:24,5221144,2080547925,1369483,1594796314,3851661,485751611,2222,1157277,1338267873,1156384,1338159557,893,108316,1120284,15,1367619,126809,2219,876,130000.0,43333.0,-68.0,-69.0,-68.0,-74.0,-68.0,-69.0,-68.0,-73.0,-90.0,-91.0,-88.0,-89.0,22.0,22.0,20.0,15.0,1
1789,CC:2F:71:3E:C5:1F,3852703,485879025,1040,127212,3851663,485751813,3,4535,378254,3780,288634,755,89620,1102,14,1492,30,3,54,144444.0,39000.0,-72.0,-72.0,-67.0,-60.0,-72.0,-71.0,-69.0,-60.0,-90.0,-91.0,-88.0,-89.0,18.0,19.0,21.0,29.0,1
1790,BA:8C:B9:54:50:24,3856635,491950403,4972,6198590,3851663,485751813,7,10081,1774370,10059,1770875,22,3495,2364,18,5506,44,7,78,216660.0,130000.0,-48.0,-35.0,-43.0,-45.0,-45.0,-35.0,-43.0,-46.0,-90.0,-91.0,-88.0,-89.0,42.0,56.0,45.0,44.0,1
1791,62:47:05:9D:EB:15,3858746,498077916,7079,12325699,3851667,485752217,1,7610,3922370,7559,3914574,51,7796,3592,0,7164,56,1,127,216660.0,130000.0,-42.0,-45.0,-35.0,-49.0,-43.0,-45.0,-36.0,-46.0,-90.0,-91.0,-88.0,-89.0,48.0,46.0,53.0,40.0,1
1792,92:69:1D:31:68:E9,3855891,489469633,4224,3717416,3851667,485752217,1,5825,1240172,5642,1198499,183,41673,2352,12,4501,104,1,66,229410.0,130000.0,-50.0,-49.0,-42.0,-46.0,-51.0,-48.0,-43.0,-48.0,-90.0,-91.0,-88.0,-89.0,40.0,42.0,46.0,43.0,1
1793,CC:2F:71:3F:1F:24,5221323,2080755357,1369656,1595003140,3851667,485752217,2222,1157440,1338474191,1156547,1338365875,893,108316,1120437,15,1367792,126809,2219,876,130000.0,43333.0,-69.0,-70.0,-70.0,-73.0,-69.0,-70.0,-69.0,-73.0,-90.0,-91.0,-88.0,-89.0,21.0,21.0,18.0,16.0,1
1794,CC:2F:71:3E:C5:1F,3852707,485879429,1040,127212,3851667,485752217,3,4535,378254,3780,288634,755,89620,1102,14,1492,30,3,54,144444.0,39000.0,-72.0,-72.0,-67.0,-60.0,-72.0,-71.0,-69.0,-60.0,-90.0,-91.0,-88.0,-89.0,18.0,19.0,21.0,29.0,1
1795,BA:8C:B9:54:50:24,3856639,491950807,4972,6198590,3851667,485752217,7,10081,1774370,10059,1770875,22,3495,2364,18,5506,44,7,78,216660.0,130000.0,-48.0,-35.0,-43.0,-45.0,-45.0,-35.0,-43.0,-46.0,-90.0,-91.0,-88.0,-89.0,42.0,56.0,45.0,44.0,1
1796,62:47:05:9D:EB:15,3858748,498078118,7079,12325699,3851669,485752419,1,7610,3922370,7559,3914574,51,7796,3592,0,7164,56,1,127,216660.0,130000.0,-42.0,-45.0,-35.0,-49.0,-43.0,-45.0,-36.0,-46.0,-90.0,-91.0,-88.0,-89.0,48.0,46.0,53.0,40.0,1
1797,92:69:1D:31:68:E9,3855895,489470037,4224,3717416,3851671,485752621,1,5825,1240172,5642,1198499,183,41673,2352,12,4501,104,1,66,229410.0,130000.0,-50.0,-49.0,-42.0,-46.0,-51.0,-48.0,-43.0,-48.0,-90.0,-91.0,-88.0,-89.0,40.0,42.0,46.0,43.0,1
1798,CC:2F:71:3F:1F:24,5221457,2080890532,1369786,1595137911,3851671,485752621,2222,1157556,1338602464,1156663,1338494148,893,108316,1120545,15,1367922,126813,2219,876,130000.0,43333.0,-69.0,-70.0,-69.0,-74.0,-69.0,-70.0,-69.0,-73.0,-90.0,-91.0,-88.0,-89.0,21.0,21.0,19.0,15.0,1
1799,CC:2F:71:3E:C5:1F,3852711,485879833,1040,127212,3851671,485752621,3,4535,378254,3780,288634,755,89620,1102,14,1492,30,3,54,144444.0,39000.0,-72.0,-72.0,-67.0,-60.0,-72.0,-71.0,-69.0,-60.0,-90.0,-91.0,-88.0,-89.0,18.0,19.0,21.0,29.0,1
1800,BA:8C:B9:54:50:24,3856643,491951211,4972,6198590,3851671,485752621,7,10081,1774370,10059,1770875,22,3495,2364,18,5506,44,7,78,216660.0,130000.0,-48.0,-35.0,-43.0,-45.0,-45.0,-35.0,-43.0,-46.0,-90.0,-91.0,-88.0,-89.0,42.0,56.0,45.0,44.0,1
1801,62:47:05:9D:EB:15,3858755,498078784,7079,12325699,3851676,485753085,1,7610,3922370,7559,3914574,51,7796,3592,0,7164,56,1,127,216660.0,130000.0,-42.0,-45.0,-35.0,-49.0,-43.0,-45.0,-36.0,-46.0,-90.0,-91.0,-88.0,-89.0,48.0,46.0,53.0,40.0,1
1802,92:69:1D:31:68:E9,3855900,489470501,4224,3717416,3851676,485753085,1,5825,1240172,5642,1198499,183,41673,2352,12,4501,104,1,66,229410.0,130000.0,-50.0,-49.0,-42.0,-46.0,-51.0,-48.0,-43.0,-48.0,-90.0,-91.0,-88.0,-89.0,40.0,42.0,46.0,43.0,1
1803,CC:2F:71:3F:1F:24,5221579,2081020254,1369903,1595267169,3851676,485753085,2222,1157654,1338720852,1156761,1338612536,893,108316,1120641,15,1368039,126814,2219,876,130000.0,43333.0,-69.0,-70.0,-69.0,-73.0,-69.0,-69.0,-68.0,-73.0,-90.0,-91.0,-88.0,-89.0,21.0,21.0,19.0,16.0,1
1804,CC:2F:71:3E:C5:1F,3852716,485880297,1040,127212,3851676,485753085,3,4535,378254,3780,288634,755,89620,1102,14,1492,30,3,54,144444.0,39000.0,-72.0,-72.0,-67.0,-60.0,-72.0,-71.0,-69.0,-60.0,-90.0,-91.0,-88.0,-89.0,18.0,19.0,21.0,29.0,1
1805,BA:8C:B9:54:50:24,3856648,491951675,4972,6198590,3851676,485753085,7,10081,1774370,10059,1770875,22,3495,2364,18,5506,44,7,78,216660.0,130000.0,-48.0,-35.0,-43.0,-45.0,-45.0,-35.0,-43.0,-46.0,-90.0,-91.0,-88.0,-89.0,42.0,56.0,45.0,44.0,1
1806,62:47:05:9D:EB:15,3858759,498079188,7079,12325699,3851680,485753489,1,7610,3922370,7559,3914574,51,7796,3592,0,7164,56,1,127,216660.0,130000.0,-42.0,-45.0,-35.0,-49.0,-43.0,-45.0,-36.0,-46.0,-90.0,-91.0,-88.0,-89.0,48.0,46.0,53.0,40.0,1
1807,92:69:1D:31:68:E9,3855904,489470905,4224,3717416,3851680,485753489,1,5825,1240172,5642,1198499,183,41673,2352,12,4501,104,1,66,229410.0,130000.0,-50.0,-49.0,-42.0,-46.0,-51.0,-48.0,-43.0,-48.0,-90.0,-91.0,-88.0,-89.0,40.0,42.0,46.0,43.0,1
1808,CC:2F:71:3F:1F:24,5221703,2081153154,1370023,1595399665,3851680,485753489,2222,1157755,1338841074,1156862,1338732758,893,108316,1120739,15,1368158,126815,2219,876,130000.0,43333.0,-69.0,-70.0,-69.0,-73.0,-68.0,-69.0,-68.0,-73.0,-90.0,-91.0,-88.0,-89.0,21.0,21.0,19.0,16.0,1
1809,CC:2F:71:3E:C5:1F,3852720,485880701,1040,127212,3851680,485753489,3,4535,378254,3780,288634,755,89620,1102,14,1492,30,3,54,144444.0,39000.0,-72.0,-72.0,-67.0,-60.0,-72.0,-71.0,-69.0,-60.0,-90.0,-90.0,-87.0,-89.0,18.0,18.0,20.0,29.0,1
1810,BA:8C:B9:54:50:24,3856654,491952281,4972,6198590,3851682,485753691,7,10081,1774370,10059,1770875,22,3495,2364,18,5506,44,7,78,216660.0,130000.0,-48.0,-35.0,-43.0,-45.0,-45.0,-35.0,-43.0,-46.0,-90.0,-90.0,-87.0,-89.0,42.0,55.0,44.0,44.0,1
1811,62:47:05:9D:EB:15,3858764,498079652,7079,12325699,3851685,485753953,1,7611,3922438,7560,3914642,51,7796,3592,0,7164,56,1,127,216660.0,130000.0,-43.0,-45.0,-36.0,-48.0,-43.0,-45.0,-36.0,-46.0,-90.0,-90.0,-87.0,-89.0,47.0,45.0,51.0,41.0,1
1812,92:69:1D:31:68:E9,3855909,489471369,4224,3717416,3851685,485753953,1,5825,1240172,5642,1198499,183,41673,2352,12,4501,104,1,66,229410.0,130000.0,-50.0,-49.0,-42.0,-46.0,-51.0,-48.0,-43.0,-48.0,-90.0,-90.0,-87.0,-89.0,40.0,41.0,45.0,43.0,1
1813,CC:2F:71:3F:1F:24,5221833,2081287397,1370148,1595533444,3851685,485753953,2222,1157866,1338961647,1156973,1338853331,893,108316,1120845,15,1368284,126821,2219,876,130000.0,43333.0,-68.0,-69.0,-68.0,-72.0,-68.0,-69.0,-68.0,-72.0,-90.0,-90.0,-87.0,-89.0,22.0,21.0,19.0,17.0,1
1814,CC:2F:71:3E:C5:1F,3852725,485881165,1040,127212,3851685,485753953,3,4535,378254,3780,288634,755,89620,1102,14,1492,30,3,54,144444.0,39000.0,-72.0,-72.0,-67.0,-60.0,-72.0,-71.0,-69.0,-60.0,-90.0,-90.0,-87.0,-89.0,18.0,18.0,20.0,29.0,1
1815,BA:8C:B9:54:50:24,3856657,491952543,4972,6198590,3851685,485753953,7,10081,1774370,10059,1770875,22,3495,2364,18,5506,44,7,78,216660.0,130000.0,-48.0,-35.0,-43.0,-45.0,-45.0,-35.0,-43.0,-46.0,-90.0,-90.0,-87.0,-89.0,42.0,55.0,44.0,44.0,1
1816,62:47:05:9D:EB:15,3858768,498080056,7079,12325699,3851689,485754357,1,7611,3922438,7560,3914642,51,7796,3592,0,7164,56,1,127,216660.0,130000.0,-43.0,-45.0,-36.0,-48.0,-43.0,-45.0,-36.0,-46.0,-89.0,-90.0,-87.0,-88.0,46.0,45.0,51.0,40.0,1
1817,92:69:1D:31:68:E9,3855914,489471833,4225,3717476,3851689,485754357,1,5827,1240308,5644,1198635,183,41673,2352,12,4502,104,1,66,229410.0,130000.0,-52.0,-49.0,-46.0,-49.0,-51.0,-49.0,-43.0,-48.0,-89.0,-90.0,-87.0,-88.0,37.0,41.0,41.0,39.0,1
1818,CC:2F:71:3F:1F:24,5221955,2081417175,1370266,1595662818,3851689,485754357,2222,1157969,1339083695,1157076,1338975379,893,108316,1120942,15,1368402,126821,2219,876,130000.0,43333.0,-67.0,-69.0,-68.0,-73.0,-67.0,-68.0,-68.0,-73.0,-89.0,-90.0,-87.0,-88.0,22.0,21.0,19.0,15.0,1
1819,CC:2F:71:3E:C5:1F,3852732,485881887,1041,127328,3851691,485754559,3,4537,378394,3782,288774,755,89620,1102,14,1493,30,3,54,144444.0,39000.0,-71.0,-73.0,-68.0,-61.0,-71.0,-72.0,-68.0,-60.0,-89.0,-90.0,-87.0,-88.0,18.0,17.0,19.0,27.0,1
1820,BA:8C:B9:54:50:24,3856664,491953209,4973,6198650,3851691,485754559,7,10083,1774506,10061,1771011,22,3495,2364,18,5507,44,7,78,216660.0,130000.0,-48.0,-35.0,-42.0,-45.0,-45.0,-35.0,-43.0,-46.0,-89.0,-90.0,-87.0,-88.0,41.0,55.0,45.0,43.0,1
1821,62:47:05:9D:EB:15,3858773,498080576,7080,12325815,3851693,485754761,1,7613,3922574,7562,3914778,51,7796,3592,0,7165,56,1,127,216660.0,130000.0,-42.0,-44.0,-35.0,-48.0,-43.0,-45.0,-36.0,-47.0,-89.0,-90.0,-87.0,-88.0,47.0,46.0,52.0,40.0,1
1822,92:69:1D:31:68:E9,3855918,489472237,4225,3717476,3851693,485754761,1,5827,1240308,5644,1198635,183,41673,2352,12,4502,104,1,66,229410.0,130000.0,-52.0,-49.0,-46.0,-49.0,-51.0,-49.0,-43.0,-48.0,-89.0,-90.0,-87.0,-88.0,37.0,41.0,41.0,39.0,1
1823,CC:2F:71:3F:1F:24,5222078,2081546873,1370385,1595792112,3851693,485754761,2222,1158071,1339205533,1157178,1339097217,893,108316,1121039,15,1368521,126827,2219,876,130000.0,43333.0,-67.0,-69.0,-68.0,-72.0,-67.0,-68.0,-67.0,-72.0,-89.0,-90.0,-87.0,-88.0,22.0,21.0,19.0,16.0,1
1824,CC:2F:71:3E:C5:1F,3852734,485882089,1041,127328,3851693,485754761,3,4537,378394,3782,288774,755,89620,1102,14,1493,30,3,54,144444.0,39000.0,-71.0,-73.0,-68.0,-61.0,-71.0,-72.0,-68.0,-60.0,-89.0,-90.0,-87.0,-88.0,18.0,17.0,19.0,27.0,1
1825,BA:8C:B9:54:50:24,3856666,491953411,4973,6198650,3851693,485754761,7,10083,1774506,10061,1771011,22,3495,2364,18,5507,44,7,78,216660.0,130000.0,-48.0,-35.0,-42.0,-45.0,-45.0,-35.0,-43.0,-46.0,-89.0,-90.0,-87.0,-88.0,41.0,55.0,45.0,43.0,1
1826,62:47:05:9D:EB:15,3858778,498081040,7080,12325815,3851698,485755225,1,7613,3922574,7562,3914778,51,7796,3592,0,7165,56,1,127,216660.0,130000.0,-42.0,-44.0,-35.0,-48.0,-43.0,-45.0,-36.0,-47.0,-89.0,-90.0,-87.0,-88.0,47.0,46.0,52.0,40.0,1
1827,92:69:1D:31:68:E9,3855923,489472701,4225,3717476,3851698,485755225,1,5827,1240308,5644,1198635,183,41673,2352,12,4502,104,1,66,229410.0,130000.0,-52.0,-49.0,-46.0,-49.0,-51.0,-49.0,-43.0,-48.0,-89.0,-90.0,-87.0,-88.0,37.0,41.0,41.0,39.0,1
1828,CC:2F:71:3F:1F:24,5222203,2081676927,1370503,1595921500,3851700,485755427,2222,1158174,1339329081,1157281,1339220765,893,108316,1121134,15,1368638,126830,2219,876,130000.0,43333.0,-68.0,-69.0,-68.0,-74.0,-67.0,-69.0,-68.0,-74.0,-89.0,-90.0,-87.0,-88.0,21.0,21.0,19.0,14.0,1
1829,CC:2F:71:3E:C5:1F,3852741,485882755,1041,127328,3851700,485755427,3,4537,378394,3782,288774,755,89620,1102,14,1493,30,3,54,144444.0,39000.0,-71.0,-73.0,-68.0,-61.0,-71.0,-72.0,-68.0,-60.0,-89.0,-90.0,-87.0,-88.0,18.0,17.0,19.0,27.0,1
1830,BA:8C:B9:54:50:24,3856673,491954077,4973,6198650,3851700,485755427,7,10084,1774574,10062,1771079,22,3495,2364,18,5507,44,7,78,216660.0,130000.0,-39.0,-36.0,-46.0,-52.0,-45.0,-35.0,-43.0,-46.0,-89.0,-90.0,-87.0,-88.0,50.0,54.0,41.0,36.0,1
1831,62:47:05:9D:EB:15,3858782,498081444,7080,12325815,3851702,485755629,1,7613,3922574,7562,3914778,51,7796,3592,0,7165,56,1,127,216660.0,130000.0,-42.0,-44.0,-35.0,-48.0,-43.0,-45.0,-36.0,-47.0,-89.0,-90.0,-87.0,-88.0,47.0,46.0,52.0,40.0,1
1832,92:69:1D:31:68:E9,3855927,489473105,4225,3717476,3851702,485755629,1,5827,1240308,5644,1198635,183,41673,2352,12,4502,104,1,66,229410.0,130000.0,-52.0,-49.0,-46.0,-49.0,-51.0,-49.0,-43.0,-48.0,-89.0,-90.0,-87.0,-88.0,37.0,41.0,41.0,39.0,1
1833,CC:2F:71:3F:1F:24,5222332,2081810279,1370629,1596054377,3851703,485755902,2222,1158281,1339446218,1157388,1339337902,893,108316,1121240,15,1368765,126843,2219,876,117000.0,39000.0,-69.0,-70.0,-71.0,-73.0,-68.0,-69.0,-69.0,-72.0,-89.0,-90.0,-87.0,-88.0,20.0,20.0,16.0,15.0,1
1834,CC:2F:71:3E:C5:1F,3852744,485883230,1041,127328,3851703,485755902,3,4537,378394,3782,288774,755,89620,1102,14,1493,30,3,54,144444.0,39000.0,-71.0,-73.0,-68.0,-61.0,-71.0,-72.0,-68.0,-60.0,-89.0,-90.0,-87.0,-88.0,18.0,17.0,19.0,27.0,1
1835,BA:8C:B9:54:50:24,3856676,491954552,4973,6198650,3851703,485755902,7,10084,1774574,10062,1771079,22,3495,2364,18,5507,44,7,78,216660.0,130000.0,-39.0,-36.0,-46.0,-52.0,-45.0,-35.0,-43.0,-46.0,-89.0,-90.0,-87.0,-88.0,50.0,54.0,41.0,36.0,1
1836,62:47:05:9D:EB:15,3858789,498082249,7080,12325815,3851709,485756434,1,7613,3922574,7562,3914778,51,7796,3592,0,7165,56,1,127,216660.0,130000.0,-42.0,-44.0,-35.0,-48.0,-43.0,-45.0,-36.0,-47.0,-89.0,-90.0,-87.0,-88.0,47.0,46.0,52.0,40.0,1
1837,92:69:1D:31:68:E9,3855934,489473910,4225,3717476,3851709,485756434,1,5827,1240308,5644,1198635,183,41673,2352,12,4502,104,1,66,229410.0,130000.0,-52.0,-49.0,-46.0,-49.0,-51.0,-49.0,-43.0,-48.0,-89.0,-90.0,-87.0,-88.0,37.0,41.0,41.0,39.0,1
1838,CC:2F:71:3F:1F:24,5222458,2081940351,1370748,1596183783,3851710,485756568,2222,1158387,1339568610,1157494,1339460294,893,108316,1121338,15,1368884,126849,2219,876,130000.0,43333.0,-70.0,-70.0,-68.0,-74.0,-69.0,-70.0,-67.0,-72.0,-89.0,-90.0,-87.0,-88.0,19.0,20.0,19.0,14.0,1
1839,CC:2F:71:3E:C5:1F,3852751,485883896,1041,127328,3851710,485756568,3,4537,378394,3782,288774,755,89620,1102,14,1493,30,3,54,144444.0,39000.0,-71.0,-73.0,-68.0,-61.0,-71.0,-72.0,-68.0,-60.0,-89.0,-90.0,-87.0,-88.0,18.0,17.0,19.0,27.0,1
1840,BA:8C:B9:54:50:24,3856683,491955218,4973,6198650,3851710,485756568,7,10084,1774574,10062,1771079,22,3495,2364,18,5507,44,7,78,216660.0,130000.0,-39.0,-36.0,-46.0,-52.0,-45.0,-35.0,-43.0,-46.0,-89.0,-90.0,-87.0,-88.0,50.0,54.0,41.0,36.0,1
1841,62:47:05:9D:EB:15,3858792,498082585,7080,12325815,3851712,485756770,1,7613,3922574,7562,3914778,51,7796,3592,0,7165,56,1,127,216660.0,130000.0,-42.0,-44.0,-35.0,-48.0,-43.0,-45.0,-36.0,-47.0,-89.0,-90.0,-87.0,-88.0,47.0,46.0,52.0,40.0,1
1842,92:69:1D:31:68:E9,3855937,489474246,4225,3717476,3851712,485756770,1,5827,1240308,5644,1198635,183,41673,2352,12,4502,104,1,66,229410.0,130000.0,-52.0,-49.0,-46.0,-49.0,-51.0,-49.0,-43.0,-48.0,-89.0,-90.0,-87.0,-88.0,37.0,41.0,41.0,39.0,1
1843,CC:2F:71:3F:1F:24,5222579,2082069847,1370867,1596313077,3851712,485756770,2222,1158485,1339685560,1157592,1339577244,893,108316,1121435,15,1369003,126854,2219,876,130000.0,43333.0,-69.0,-70.0,-67.0,-73.0,-68.0,-69.0,-66.0,-73.0,-89.0,-90.0,-87.0,-88.0,20.0,20.0,20.0,15.0,1
1844,CC:2F:71:3E:C5:1F,3852753,485884098,1041,127328,3851712,485756770,3,4537,378394,3782,288774,755,89620,1102,14,1493,30,3,54,144444.0,39000.0,-71.0,-73.0,-68.0,-61.0,-71.0,-72.0,-68.0,-60.0,-89.0,-90.0,-87.0,-88.0,18.0,17.0,19.0,27.0,1
1845,BA:8C:B9:54:50:24,3856687,491955544,4973,6198650,3851714,485756894,7,10084,1774574,10062,1771079,22,3495,2364,18,5507,44,7,78,216660.0,130000.0,-39.0,-36.0,-46.0,-52.0,-45.0,-35.0,-43.0,-46.0,-89.0,-90.0,-87.0,-88.0,50.0,54.0,41.0,36.0,1
1846,62:47:05:9D:EB:15,3858800,498083315,7080,12325815,3851720,485757500,1,7616,3922778,7565,3914982,51,7796,3592,0,7165,56,1,127,216660.0,130000.0,-44.0,-44.0,-35.0,-49.0,-43.0,-45.0,-37.0,-47.0,-90.0,-90.0,-87.0,-88.0,46.0,46.0,52.0,39.0,1
1847,92:69:1D:31:68:E9,3855945,489474976,4225,3717476,3851720,485757500,1,5827,1240308,5644,1198635,183,41673,2352,12,4502,104,1,66,229410.0,130000.0,-52.0,-49.0,-46.0,-49.0,-51.0,-49.0,-43.0,-48.0,-90.0,-90.0,-87.0,-88.0,38.0,41.0,41.0,39.0,1
1848,CC:2F:71:3F:1F:24,5222707,2082200225,1370987,1596442725,3851720,485757500,2222,1158589,1339807584,1157695,1339699150,894,108434,1121534,15,1369123,126854,2219,876,130000.0,43333.0,-70.0,-69.0,-70.0,-75.0,-69.0,-69.0,-69.0,-74.0,-90.0,-90.0,-87.0,-88.0,20.0,21.0,17.0,13.0,1
1849,CC:2F:71:3E:C5:1F,3852761,485884828,1041,127328,3851720,485757500,3,4539,378582,3783,288844,756,89738,1103,14,1493,30,3,54,144444.0,39000.0,-70.0,-73.0,-67.0,-60.0,-71.0,-72.0,-68.0,-60.0,-90.0,-90.0,-87.0,-88.0,20.0,17.0,20.0,28.0,1
1850,BA:8C:B9:54:50:24,3856693,491956150,4973,6198650,3851720,485757500,7,10084,1774574,10062,1771079,22,3495,2364,18,5507,44,7,78,216660.0,130000.0,-39.0,-36.0,-46.0,-52.0,-45.0,-35.0,-43.0,-46.0,-90.0,-90.0,-87.0,-88.0,51.0,54.0,41.0,36.0,1
1851,62:47:05:9D:EB:15,3858803,498083577,7080,12325815,3851723,485757762,1,7616,3922778,7565,3914982,51,7796,3592,0,7165,56,1,127,216660.0,130000.0,-44.0,-44.0,-35.0,-49.0,-43.0,-45.0,-37.0,-47.0,-90.0,-90.0,-87.0,-88.0,46.0,46.0,52.0,39.0,1
1852,92:69:1D:31:68:E9,3855948,489475238,4225,3717476,3851723,485757762,1,5827,1240308,5644,1198635,183,41673,2352,12,4502,104,1,66,229410.0,130000.0,-52.0,-49.0,-46.0,-49.0,-51.0,-49.0,-43.0,-48.0,-90.0,-90.0,-87.0,-88.0,38.0,41.0,41.0,39.0,1
1853,CC:2F:71:3F:1F:24,5222846,2082336538,1371123,1596578776,3851723,485757762,2222,1158716,1339942112,1157822,1339833678,894,108434,1121649,15,1369259,126861,2219,876,144444.0,43333.0,-70.0,-70.0,-69.0,-75.0,-70.0,-69.0,-69.0,-74.0,-90.0,-90.0,-87.0,-88.0,20.0,20.0,18.0,13.0,1
1854,CC:2F:71:3E:C5:1F,3852766,485885292,1041,127328,3851725,485757964,3,4539,378582,3783,288844,756,89738,1103,14,1493,30,3,54,144444.0,39000.0,-70.0,-73.0,-67.0,-60.0,-71.0,-72.0,-68.0,-60.0,-90.0,-90.0,-87.0,-88.0,20.0,17.0,20.0,28.0,1
1855,BA:8C:B9:54:50:24,3856698,491956614,4973,6198650,3851725,485757964,7,10084,1774574,10062,1771079,22,3495,2364,18,5507,44,7,78,216660.0,130000.0,-39.0,-36.0,-46.0,-52.0,-45.0,-35.0,-43.0,-46.0,-90.0,-90.0,-87.0,-88.0,51.0,54.0,41.0,36.0,1
1856,62:47:05:9D:EB:15,3858809,498084183,7080,12325815,3851729,485758368,1,7616,3922778,7565,3914982,51,7796,3592,0,7165,56,1,127,216660.0,130000.0,-44.0,-44.0,-35.0,-49.0,-43.0,-45.0,-37.0,-47.0,-90.0,-90.0,-87.0,-88.0,46.0,46.0,52.0,39.0,1
1857,92:69:1D:31:68:E9,3855954,489475844,4225,3717476,3851729,485758368,1,5827,1240308,5644,1198635,183,41673,2352,12,4502,104,1,66,229410.0,130000.0,-52.0,-49.0,-46.0,-49.0,-51.0,-49.0,-43.0,-48.0,-90.0,-90.0,-87.0,-88.0,38.0,41.0,41.0,39.0,1
1858,CC:2F:71:3F:1F:24,5222972,2082467880,1371243,1596709512,3851729,485758368,2222,1158820,1340068372,1157926,1339959938,894,108434,1121747,15,1369379,126895,2219,876,130000.0,43333.0,-67.0,-70.0,-68.0,-77.0,-66.0,-69.0,-68.0,-76.0,-90.0,-90.0,-87.0,-88.0,23.0,20.0,19.0,11.0,1
1859,CC:2F:71:3E:C5:1F,3852770,485885696,1041,127328,3851729,485758368,3,4539,378582,3783,288844,756,89738,1103,14,1493,30,3,54,144444.0,39000.0,-70.0,-73.0,-67.0,-60.0,-71.0,-72.0,-68.0,-60.0,-90.0,-90.0,-87.0,-88.0,20.0,17.0,20.0,28.0,1
1860,BA:8C:B9:54:50:24,3856704,491957220,4973,6198650,3851731,485758570,7,10084,1774574,10062,1771079,22,3495,2364,18,5507,44,7,78,216660.0,130000.0,-39.0,-36.0,-46.0,-52.0,-45.0,-35.0,-43.0,-46.0,-90.0,-90.0,-87.0,-88.0,51.0,54.0,41.0,36.0,1
1861,62:47:05:9D:EB:15,3858812,498084445,7080,12325815,3851732,485758630,1,7616,3922778,7565,3914982,51,7796,3592,0,7165,56,1,127,216660.0,130000.0,-44.0,-44.0,-35.0,-49.0,-43.0,-45.0,-37.0,-47.0,-90.0,-90.0,-87.0,-88.0,46.0,46.0,52.0,39.0,1
1862,92:69:1D:31:68:E9,3855957,489476106,4225,3717476,3851732,485758630,1,5827,1240308,5644,1198635,183,41673,2352,12,4502,104,1,66,229410.0,130000.0,-52.0,-49.0,-46.0,-49.0,-51.0,-49.0,-43.0,-48.0,-90.0,-90.0,-87.0,-88.0,38.0,41.0,41.0,39.0,1
1863,CC:2F:71:3F:1F:24,5223097,2082599416,1371363,1596840584,3851734,485758832,2222,1158926,1340197740,1158032,1340089306,894,108434,1121845,15,1369499,126895,2219,876,130000.0,43333.0,-70.0,-68.0,-67.0,-75.0,-70.0,-68.0,-66.0,-75.0,-90.0,-90.0,-87.0,-88.0,20.0,22.0,20.0,13.0,1
1864,CC:2F:71:3E:C5:1F,3852775,485886160,1041,127328,3851734,485758832,3,4539,378582,3783,288844,756,89738,1103,14,1493,30,3,54,144444.0,39000.0,-70.0,-73.0,-67.0,-60.0,-71.0,-72.0,-68.0,-60.0,-90.0,-90.0,-87.0,-88.0,20.0,17.0,20.0,28.0,1
1865,BA:8C:B9:54:50:24,3856707,491957482,4973,6198650,3851734,485758832,7,10084,1774574,10062,1771079,22,3495,2364,18,5507,44,7,78,216660.0,130000.0,-39.0,-36.0,-46.0,-52.0,-45.0,-35.0,-43.0,-46.0,-90.0,-90.0,-87.0,-88.0,51.0,54.0,41.0,36.0,1
1866,62:47:05:9D:EB:15,3858818,498085051,7080,12325815,3851738,485759236,1,7616,3922778,7565,3914982,51,7796,3592,0,7165,56,1,127,216660.0,130000.0,-44.0,-44.0,-35.0,-49.0,-43.0,-45.0,-37.0,-47.0,-90.0,-90.0,-87.0,-88.0,46.0,46.0,52.0,39.0,1
1867,92:69:1D:31:68:E9,3855965,489476914,4225,3717476,3851740,485759438,1,5827,1240308,5644,1198635,183,41673,2352,12,4502,104,1,66,229410.0,130000.0,-52.0,-49.0,-46.0,-49.0,-51.0,-49.0,-43.0,-48.0,-90.0,-90.0,-87.0,-88.0,38.0,41.0,41.0,39.0,1
1868,CC:2F:71:3F:1F:24,5223229,2082737250,1371489,1596977812,3851740,485759438,2222,1159040,1340330944,1158146,1340222510,894,108434,1121951,15,1369625,126911,2219,876,117000.0,39000.0,-71.0,-70.0,-68.0,-76.0,-71.0,-70.0,-68.0,-76.0,-90.0,-90.0,-87.0,-88.0,19.0,20.0,19.0,12.0,1
1869,CC:2F:71:3E:C5:1F,3852781,485886766,1041,127328,3851740,485759438,3,4539,378582,3783,288844,756,89738,1103,14,1493,30,3,54,144444.0,39000.0,-70.0,-73.0,-67.0,-60.0,-71.0,-72.0,-68.0,-60.0,-90.0,-90.0,-87.0,-88.0,20.0,17.0,20.0,28.0,1
1870,BA:8C:B9:54:50:24,3856713,491958088,4973,6198650,3851740,485759438,7,10084,1774574,10062,1771079,22,3495,2364,18,5507,44,7,78,216660.0,130000.0,-39.0,-36.0,-46.0,-52.0,-45.0,-35.0,-43.0,-46.0,-90.0,-90.0,-87.0,-88.0,51.0,54.0,41.0,36.0,1
1871,62:47:05:9D:EB:15,3858822,498085455,7080,12325815,3851742,485759640,1,7616,3922778,7565,3914982,51,7796,3592,0,7165,56,1,127,216660.0,130000.0,-44.0,-44.0,-35.0,-49.0,-43.0,-45.0,-37.0,-47.0,-90.0,-90.0,-87.0,-88.0,46.0,46.0,52.0,39.0,1
1872,92:69:1D:31:68:E9,3855967,489477116,4225,3717476,3851742,485759640,1,5827,1240308,5644,1198635,183,41673,2352,12,4502,104,1,66,229410.0,130000.0,-52.0,-49.0,-46.0,-49.0,-51.0,-49.0,-43.0,-48.0,-90.0,-90.0,-87.0,-88.0,38.0,41.0,41.0,39.0,1
1873,CC:2F:71:3F:1F:24,5223357,2082870329,1371615,1597110689,3851742,485759640,2222,1159153,1340454764,1158259,1340346330,894,108434,1122054,15,1369750,126913,2219,876,130000.0,43333.0,-70.0,-70.0,-70.0,-75.0,-70.0,-69.0,-69.0,-74.0,-90.0,-90.0,-87.0,-88.0,20.0,20.0,17.0,13.0,1
1874,CC:2F:71:3E:C5:1F,3852783,485886968,1041,127328,3851742,485759640,3,4539,378582,3783,288844,756,89738,1103,14,1493,30,3,54,144444.0,39000.0,-70.0,-73.0,-67.0,-60.0,-71.0,-72.0,-68.0,-60.0,-90.0,-90.0,-87.0,-88.0,20.0,17.0,20.0,28.0,1
1875,BA:8C:B9:54:50:24,3856715,491958290,4973,6198650,3851742,485759640,7,10084,1774574,10062,1771079,22,3495,2364,18,5507,44,7,78,216660.0,130000.0,-39.0,-36.0,-46.0,-52.0,-45.0,-35.0,-43.0,-46.0,-90.0,-90.0,-87.0,-88.0,51.0,54.0,41.0,36.0,1
1876,62:47:05:9D:EB:15,3858829,498086121,7080,12325815,3851749,485760306,1,7616,3922778,7565,3914982,51,7796,3592,0,7165,56,1,127,216660.0,130000.0,-44.0,-44.0,-35.0,-49.0,-43.0,-45.0,-37.0,-47.0,-90.0,-90.0,-87.0,-88.0,46.0,46.0,52.0,39.0,1
1877,92:69:1D:31:68:E9,3855974,489477782,4225,3717476,3851749,485760306,1,5827,1240308,5644,1198635,183,41673,2352,12,4502,104,1,66,229410.0,130000.0,-52.0,-49.0,-46.0,-49.0,-51.0,-49.0,-43.0,-48.0,-90.0,-90.0,-87.0,-88.0,38.0,41.0,41.0,39.0,1
1878,CC:2F:71:3F:1F:24,5223483,2083000345,1371734,1597240039,3851749,485760306,2222,1159255,1340576634,1158361,1340468200,894,108434,1122151,15,1369870,126925,2219,876,130000.0,39000.0,-70.0,-70.0,-70.0,-73.0,-70.0,-69.0,-70.0,-72.0,-90.0,-90.0,-87.0,-88.0,20.0,20.0,17.0,15.0,1
1879,CC:2F:71:3E:C5:1F,3852790,485887634,1041,127328,3851749,485760306,3,4539,378582,3783,288844,756,89738,1103,14,1493,30,3,54,144444.0,39000.0,-70.0,-73.0,-67.0,-60.0,-71.0,-72.0,-68.0,-60.0,-90.0,-90.0,-87.0,-88.0,20.0,17.0,20.0,28.0,1
1880,BA:8C:B9:54:50:24,3856722,491958956,4973,6198650,3851749,485760306,7,10084,1774574,10062,1771079,22,3495,2364,18,5507,44,7,78,216660.0,130000.0,-39.0,-36.0,-46.0,-52.0,-45.0,-35.0,-43.0,-46.0,-90.0,-90.0,-87.0,-88.0,51.0,54.0,41.0,36.0,1
1881,62:47:05:9D:EB:15,3858831,498086323,7080,12325815,3851751,485760508,1,7616,3922778,7565,3914982,51,7796,3592,0,7165,56,1,127,216660.0,130000.0,-44.0,-44.0,-35.0,-49.0,-43.0,-45.0,-37.0,-47.0,-90.0,-90.0,-87.0,-88.0,46.0,46.0,52.0,39.0,1
1882,92:69:1D:31:68:E9,3855976,489477984,4225,3717476,3851751,485760508,1,5827,1240308,5644,1198635,183,41673,2352,12,4502,104,1,66,229410.0,130000.0,-52.0,-49.0,-46.0,-49.0,-51.0,-49.0,-43.0,-48.0,-90.0,-90.0,-87.0,-88.0,38.0,41.0,41.0,39.0,1
1883,CC:2F:71:3F:1F:24,5223604,2083130009,1371853,1597369501,3851751,485760508,2222,1159358,1340697290,1158464,1340588856,894,108434,1122248,15,1369989,126927,2219,876,130000.0,43333.0,-72.0,-69.0,-68.0,-73.0,-72.0,-69.0,-67.0,-73.0,-90.0,-90.0,-87.0,-88.0,18.0,21.0,19.0,15.0,1
1884,CC:2F:71:3E:C5:1F,3852792,485887836,1041,127328,3851751,485760508,3,4539,378582,3783,288844,756,89738,1103,14,1493,30,3,54,144444.0,39000.0,-70.0,-73.0,-67.0,-60.0,-71.0,-72.0,-68.0,-60.0,-90.0,-90.0,-87.0,-88.0,20.0,17.0,20.0,28.0,1
1885,BA:8C:B9:54:50:24,3856724,491959158,4973,6198650,3851751,485760508,7,10087,1774778,10065,1771283,22,3495,2364,18,5508,44,7,78,216660.0,130000.0,-48.0,-35.0,-42.0,-45.0,-43.0,-35.0,-43.0,-48.0,-90.0,-90.0,-87.0,-88.0,42.0,55.0,45.0,43.0,1
1886,62:47:05:9D:EB:15,3858838,498086989,7080,12325815,3851758,485761174,1,7618,3922914,7567,3915118,51,7796,3592,0,7166,56,1,127,216660.0,130000.0,-43.0,-45.0,-35.0,-46.0,-43.0,-45.0,-37.0,-47.0,-90.0,-90.0,-87.0,-88.0,47.0,45.0,52.0,42.0,1
1887,92:69:1D:31:68:E9,3855983,489478650,4225,3717476,3851758,485761174,1,5829,1240444,5646,1198771,183,41673,2352,12,4503,104,1,66,229410.0,130000.0,-51.0,-47.0,-44.0,-46.0,-51.0,-49.0,-43.0,-47.0,-90.0,-90.0,-87.0,-88.0,39.0,43.0,43.0,42.0,1
1888,CC:2F:71:3F:1F:24,5223676,2083157890,1371918,1597396716,3851758,485761174,2222,1159402,1340709205,1158508,1340600771,894,108434,1122289,15,1370054,126928,2219,876,130000.0,43333.0,-71.0,-69.0,-66.0,-75.0,-71.0,-69.0,-66.0,-74.0,-90.0,-90.0,-87.0,-88.0,19.0,21.0,21.0,13.0,1
1889,CC:2F:71:3E:C5:1F,3852799,485888502,1041,127328,3851758,485761174,3,4541,378722,3785,288984,756,89738,1103,14,1494,30,3,54,144444.0,39000.0,-70.0,-73.0,-68.0,-60.0,-70.0,-72.0,-67.0,-60.0,-90.0,-90.0,-87.0,-88.0,20.0,17.0,19.0,28.0,1
1890,BA:8C:B9:54:50:24,3856731,491959824,4973,6198650,3851758,485761174,7,10088,1774846,10066,1771351,22,3495,2364,18,5508,44,7,78,216660.0,130000.0,-40.0,-36.0,-46.0,-52.0,-43.0,-35.0,-44.0,-48.0,-90.0,-90.0,-87.0,-88.0,50.0,54.0,41.0,36.0,1
1891,62:47:05:9D:EB:15,3858840,498087191,7080,12325815,3851760,485761376,1,7618,3922914,7567,3915118,51,7796,3592,0,7166,56,1,127,216660.0,130000.0,-43.0,-45.0,-35.0,-46.0,-43.0,-45.0,-37.0,-47.0,-90.0,-90.0,-87.0,-88.0,47.0,45.0,52.0,42.0,1
1892,92:69:1D:31:68:E9,3855985,489478852,4225,3717476,3851760,485761376,1,5829,1240444,5646,1198771,183,41673,2352,12,4503,104,1,66,229410.0,130000.0,-51.0,-47.0,-44.0,-46.0,-51.0,-49.0,-43.0,-47.0,-90.0,-90.0,-87.0,-88.0,39.0,43.0,43.0,42.0,1
1893,CC:2F:71:3F:1F:24,5223729,2083176256,1371967,1597414678,3851762,485761578,2222,1159440,1340715505,1158546,1340607071,894,108434,1122319,15,1370103,126928,2219,877,130000.0,39000.0,-67.0,-71.0,-70.0,-70.0,-68.0,-72.0,-69.0,-72.0,-90.0,-90.0,-87.0,-88.0,23.0,19.0,17.0,18.0,1
1894,CC:2F:71:3E:C5:1F,3852803,485888906,1041,127328,3851762,485761578,3,4541,378722,3785,288984,756,89738,1103,14,1494,30,3,54,144444.0,39000.0,-70.0,-73.0,-68.0,-60.0,-70.0,-72.0,-67.0,-60.0,-90.0,-90.0,-87.0,-88.0,20.0,17.0,19.0,28.0,1
1895,BA:8C:B9:54:50:24,3856735,491960228,4973,6198650,3851762,485761578,7,10088,1774846,10066,1771351,22,3495,2364,18,5508,44,7,78,216660.0,130000.0,-40.0,-36.0,-46.0,-52.0,-43.0,-35.0,-44.0,-48.0,-90.0,-90.0,-87.0,-88.0,50.0,54.0,41.0,36.0,1
1896,62:47:05:9D:EB:15,3858850,498088305,7080,12325815,3851770,485762490,1,7624,3923533,7570,3915322,54,8211,3595,0,7166,56,1,127,216660.0,130000.0,-45.0,-41.0,-44.0,-48.0,-41.0,-40.0,-40.0,-44.0,-90.0,-90.0,-87.0,-88.0,45.0,49.0,43.0,40.0,1
1897,92:69:1D:31:68:E9,3855995,489479966,4225,3717476,3851770,485762490,1,5829,1240444,5646,1198771,183,41673,2352,12,4503,104,1,66,229410.0,130000.0,-51.0,-47.0,-44.0,-46.0,-51.0,-49.0,-43.0,-47.0,-90.0,-90.0,-87.0,-88.0,39.0,43.0,43.0,42.0,1
1898,CC:2F:71:3F:1F:24,5223784,2083194702,1372014,1597432212,3851770,485762490,2222,1159467,1340720301,1158573,1340611867,894,108434,1122344,15,1370150,126935,2219,877,144444.0,43333.0,-72.0,-67.0,-67.0,-72.0,-72.0,-66.0,-67.0,-71.0,-90.0,-90.0,-87.0,-88.0,18.0,23.0,20.0,16.0,1
1899,CC:2F:71:3E:C5:1F,3852811,485889818,1041,127328,3851770,485762490,3,4541,378722,3785,288984,756,89738,1103,14,1494,30,3,54,144444.0,39000.0,-70.0,-73.0,-68.0,-60.0,-70.0,-72.0,-67.0,-60.0,-90.0,-90.0,-87.0,-88.0,20.0,17.0,19.0,28.0,1
1900,BA:8C:B9:54:50:24,3856743,491961140,4973,6198650,3851770,485762490,7,10088,1774846,10066,1771351,22,3495,2364,18,5508,44,7,78,216660.0,130000.0,-40.0,-36.0,-46.0,-52.0,-43.0,-35.0,-44.0,-48.0,-90.0,-90.0,-87.0,-88.0,50.0,54.0,41.0,36.0,1
1901,62:47:05:9D:EB:15,3858853,498088567,7080,12325815,3851773,485762752,1,7625,3923601,7571,3915390,54,8211,3595,0,7166,56,1,127,216660.0,130000.0,-53.0,-46.0,-53.0,-52.0,-42.0,-41.0,-42.0,-45.0,-90.0,-90.0,-87.0,-88.0,37.0,44.0,34.0,36.0,1
1902,92:69:1D:31:68:E9,3855999,489480339,4225,3717476,3851774,485762863,1,5829,1240444,5646,1198771,183,41673,2352,12,4503,104,1,66,229410.0,130000.0,-51.0,-47.0,-44.0,-46.0,-51.0,-49.0,-43.0,-47.0,-90.0,-90.0,-87.0,-88.0,39.0,43.0,43.0,42.0,1
1903,CC:2F:71:3F:1F:24,5223835,2083212647,1372059,1597449582,3851776,485763065,2222,1159493,1340724997,1158599,1340616563,894,108434,1122368,15,1370195,126940,2219,877,144444.0,43333.0,-69.0,-66.0,-71.0,-71.0,-69.0,-66.0,-70.0,-71.0,-90.0,-90.0,-87.0,-88.0,21.0,24.0,16.0,17.0,1
1904,CC:2F:71:3E:C5:1F,3852817,485890393,1041,127328,3851776,485763065,3,4541,378722,3785,288984,756,89738,1103,14,1494,30,3,54,144444.0,39000.0,-70.0,-73.0,-68.0,-60.0,-70.0,-72.0,-67.0,-60.0,-90.0,-90.0,-87.0,-88.0,20.0,17.0,19.0,28.0,1
1905,BA:8C:B9:54:50:24,3856749,491961715,4973,6198650,3851776,485763065,7,10088,1774846,10066,1771351,22,3495,2364,18,5508,44,7,78,216660.0,130000.0,-40.0,-36.0,-46.0,-52.0,-43.0,-35.0,-44.0,-48.0,-90.0,-90.0,-87.0,-88.0,50.0,54.0,41.0,36.0,1
1906,62:47:05:9D:EB:15,3858921,498118964,7141,12355495,3851780,485763469,1,7704,3949147,7649,3940765,55,8382,3659,0,7227,56,1,127,229410.0,137640.0,-47.0,-49.0,-49.0,-49.0,-46.0,-48.0,-47.0,-48.0,-90.0,-90.0,-87.0,-88.0,43.0,41.0,38.0,39.0,1
1907,92:69:1D:31:68:E9,3856006,489481120,4225,3717476,3851781,485763644,1,5829,1240444,5646,1198771,183,41673,2352,12,4503,104,1,66,229410.0,130000.0,-51.0,-47.0,-44.0,-46.0,-51.0,-49.0,-43.0,-47.0,-90.0,-90.0,-87.0,-88.0,39.0,43.0,43.0,42.0,1
1908,CC:2F:71:3F:1F:24,5223913,2083239948,1372132,1597476304,3851781,485763644,2222,1159545,1340735929,1158651,1340627495,894,108434,1122416,15,1370268,126942,2219,877,144444.0,43333.0,-68.0,-67.0,-71.0,-70.0,-68.0,-67.0,-70.0,-70.0,-90.0,-90.0,-87.0,-88.0,22.0,23.0,16.0,18.0,1
1909,CC:2F:71:3E:C5:1F,3852822,485890972,1041,127328,3851781,485763644,3,4541,378722,3785,288984,756,89738,1103,14,1494,30,3,54,144444.0,39000.0,-70.0,-73.0,-68.0,-60.0,-70.0,-72.0,-67.0,-60.0,-90.0,-90.0,-87.0,-88.0,20.0,17.0,19.0,28.0,1
1910,BA:8C:B9:54:50:24,3856754,491962294,4973,6198650,3851781,485763644,7,10088,1774846,10066,1771351,22,3495,2364,18,5508,44,7,78,216660.0,130000.0,-40.0,-36.0,-46.0,-52.0,-43.0,-35.0,-44.0,-48.0,-90.0,-90.0,-87.0,-88.0,50.0,54.0,41.0,36.0,1
1911,62:47:05:9D:EB:15,3859134,498260816,7349,12496799,3851785,485764017,1,7977,4063394,7920,4054606,57,8788,3864,0,7435,56,1,135,229410.0,137640.0,-47.0,-46.0,-45.0,-46.0,-47.0,-46.0,-45.0,-46.0,-90.0,-90.0,-87.0,-88.0,43.0,44.0,42.0,42.0,1
1912,92:69:1D:31:68:E9,3856010,489481493,4225,3717476,3851785,485764017,1,5829,1240444,5646,1198771,183,41673,2352,12,4503,104,1,66,229410.0,130000.0,-51.0,-47.0,-44.0,-46.0,-51.0,-49.0,-43.0,-47.0,-90.0,-90.0,-87.0,-88.0,39.0,43.0,43.0,42.0,1
1913,CC:2F:71:3F:1F:24,5223966,2083258169,1372179,1597493950,3851787,485764219,2222,1159574,1340740863,1158680,1340632429,894,108434,1122444,15,1370315,126951,2219,877,144444.0,43333.0,-69.0,-68.0,-69.0,-71.0,-68.0,-68.0,-69.0,-71.0,-90.0,-90.0,-87.0,-88.0,21.0,22.0,18.0,17.0,1
1914,CC:2F:71:3E:C5:1F,3852828,485891547,1041,127328,3851787,485764219,3,4541,378722,3785,288984,756,89738,1103,14,1494,30,3,54,144444.0,39000.0,-70.0,-73.0,-68.0,-60.0,-70.0,-72.0,-67.0,-60.0,-90.0,-90.0,-87.0,-88.0,20.0,17.0,19.0,28.0,1
1915,BA:8C:B9:54:50:24,3856762,491963071,4973,6198650,3851789,485764421,7,10088,1774846,10066,1771351,22,3495,2364,18,5508,44,7,78,216660.0,130000.0,-40.0,-36.0,-46.0,-52.0,-43.0,-35.0,-44.0,-48.0,-90.0,-90.0,-87.0,-88.0,50.0,54.0,41.0,36.0,1
1916,62:47:05:9D:EB:15,3859564,499273756,7773,13509133,3851791,485764623,1,8060,4081371,8003,4072583,57,8788,3917,0,7859,56,1,135,229410.0,137640.0,-43.0,-44.0,-40.0,-44.0,-48.0,-47.0,-45.0,-47.0,-90.0,-90.0,-87.0,-89.0,47.0,46.0,47.0,45.0,1
1917,92:69:1D:31:68:E9,3856016,489482099,4225,3717476,3851791,485764623,1,5829,1240444,5646,1198771,183,41673,2352,12,4503,104,1,66,229410.0,130000.0,-51.0,-47.0,-44.0,-46.0,-51.0,-49.0,-43.0,-47.0,-90.0,-90.0,-87.0,-89.0,39.0,43.0,43.0,43.0,1
1918,CC:2F:71:3F:1F:24,5224016,2083276073,1372225,1597511450,3851791,485764623,2222,1159599,1340745333,1158705,1340636899,894,108434,1122468,15,1370361,126963,2219,877,144444.0,43333.0,-69.0,-69.0,-70.0,-70.0,-69.0,-68.0,-69.0,-70.0,-90.0,-90.0,-87.0,-89.0,21.0,21.0,17.0,19.0,1
1919,CC:2F:71:3E:C5:1F,3852832,485891951,1041,127328,3851791,485764623,3,4541,378722,3785,288984,756,89738,1103,14,1494,30,3,54,144444.0,39000.0,-70.0,-73.0,-68.0,-60.0,-70.0,-72.0,-67.0,-60.0,-90.0,-90.0,-87.0,-89.0,20.0,17.0,19.0,29.0,1
1920,BA:8C:B9:54:50:24,3856766,491963475,4973,6198650,3851793,485764825,7,10088,1774846,10066,1771351,22,3495,2364,18,5508,44,7,78,216660.0,130000.0,-40.0,-36.0,-46.0,-52.0,-43.0,-35.0,-44.0,-48.0,-90.0,-90.0,-87.0,-89.0,50.0,54.0,41.0,37.0,1
1921,62:47:05:9D:EB:15,3859649,499356417,7854,13591390,3851795,485765027,1,8137,4138962,8080,4130174,57,8788,3963,0,7940,58,1,143,229410.0,137640.0,-44.0,-42.0,-39.0,-44.0,-47.0,-45.0,-43.0,-47.0,-90.0,-90.0,-87.0,-89.0,46.0,48.0,48.0,45.0,1
1922,92:69:1D:31:68:E9,3856020,489482503,4225,3717476,3851795,485765027,1,5829,1240444,5646,1198771,183,41673,2352,12,4503,104,1,66,229410.0,130000.0,-51.0,-47.0,-44.0,-46.0,-51.0,-49.0,-43.0,-47.0,-90.0,-90.0,-87.0,-89.0,39.0,43.0,43.0,43.0,1
1923,CC:2F:71:3F:1F:24,5224066,2083293977,1372271,1597528950,3851795,485765027,2222,1159627,1340750151,1158733,1340641717,894,108434,1122495,15,1370407,126965,2219,877,144444.0,43333.0,-69.0,-68.0,-69.0,-70.0,-69.0,-68.0,-69.0,-70.0,-90.0,-90.0,-87.0,-89.0,21.0,22.0,18.0,19.0,1
1924,CC:2F:71:3E:C5:1F,3852836,485892355,1041,127328,3851795,485765027,3,4541,378722,3785,288984,756,89738,1103,14,1494,30,3,54,144444.0,39000.0,-70.0,-73.0,-68.0,-60.0,-70.0,-72.0,-67.0,-60.0,-90.0,-90.0,-87.0,-89.0,20.0,17.0,19.0,29.0,1
1925,BA:8C:B9:54:50:24,3856768,491963677,4973,6198650,3851795,485765027,7,10088,1774846,10066,1771351,22,3495,2364,18,5508,44,7,78,216660.0,130000.0,-40.0,-36.0,-46.0,-52.0,-43.0,-35.0,-44.0,-48.0,-90.0,-90.0,-87.0,-89.0,50.0,54.0,41.0,37.0,1
1926,62:47:05:9D:EB:15,3859699,499381469,7899,13615978,3851800,485765491,1,8217,4167706,8160,4158918,57,8788,4026,0,7985,58,1,143,229410.0,137640.0,-48.0,-46.0,-43.0,-48.0,-48.0,-45.0,-43.0,-48.0,-90.0,-90.0,-87.0,-89.0,42.0,44.0,44.0,41.0,1
1927,92:69:1D:31:68:E9,3856025,489482967,4225,3717476,3851800,485765491,1,5830,1240512,5647,1198839,183,41673,2352,12,4503,104,1,66,229410.0,130000.0,-52.0,-47.0,-42.0,-49.0,-51.0,-48.0,-43.0,-48.0,-90.0,-90.0,-87.0,-89.0,38.0,43.0,45.0,40.0,1
1928,CC:2F:71:3F:1F:24,5224125,2083315500,1372323,1597549807,3851802,485765693,2222,1159661,1340756173,1158767,1340647739,894,108434,1122526,15,1370459,126975,2219,877,144444.0,43333.0,-70.0,-69.0,-69.0,-70.0,-69.0,-69.0,-68.0,-70.0,-90.0,-90.0,-87.0,-89.0,20.0,21.0,18.0,19.0,1
1929,CC:2F:71:3E:C5:1F,3852843,485893021,1041,127328,3851802,485765693,3,4541,378722,3785,288984,756,89738,1103,14,1494,30,3,54,144444.0,39000.0,-70.0,-73.0,-68.0,-60.0,-70.0,-72.0,-67.0,-60.0,-90.0,-90.0,-87.0,-89.0,20.0,17.0,19.0,29.0,1
1930,BA:8C:B9:54:50:24,3856775,491964343,4973,6198650,3851802,485765693,7,10088,1774846,10066,1771351,22,3495,2364,18,5508,44,7,78,216660.0,130000.0,-40.0,-36.0,-46.0,-52.0,-43.0,-35.0,-44.0,-48.0,-90.0,-90.0,-87.0,-89.0,50.0,54.0,41.0,37.0,1
1931,62:47:05:9D:EB:15,3859729,499393070,7925,13627175,3851804,485765895,1,8257,4175923,8200,4167135,57,8788,4052,0,8011,58,1,143,229410.0,137640.0,-49.0,-46.0,-44.0,-49.0,-49.0,-45.0,-44.0,-49.0,-90.0,-90.0,-87.0,-89.0,41.0,44.0,43.0,40.0,1
1932,92:69:1D:31:68:E9,3856029,489483371,4225,3717476,3851804,485765895,1,5830,1240512,5647,1198839,183,41673,2352,12,4503,104,1,66,229410.0,130000.0,-52.0,-47.0,-42.0,-49.0,-51.0,-48.0,-43.0,-48.0,-90.0,-90.0,-87.0,-89.0,38.0,43.0,45.0,40.0,1
1933,CC:2F:71:3F:1F:24,5224174,2083333332,1372370,1597567437,3851804,485765895,2222,1159689,1340760991,1158795,1340652557,894,108434,1122553,15,1370506,126978,2219,877,144444.0,43333.0,-70.0,-70.0,-68.0,-70.0,-70.0,-69.0,-68.0,-70.0,-90.0,-90.0,-87.0,-89.0,20.0,20.0,19.0,19.0,1
1934,CC:2F:71:3E:C5:1F,3852849,485893627,1041,127328,3851808,485766299,3,4541,378722,3785,288984,756,89738,1103,14,1494,30,3,54,144444.0,39000.0,-70.0,-73.0,-68.0,-60.0,-70.0,-72.0,-67.0,-60.0,-90.0,-90.0,-87.0,-89.0,20.0,17.0,19.0,29.0,1
1935,BA:8C:B9:54:50:24,3856781,491964949,4973,6198650,3851808,485766299,7,10088,1774846,10066,1771351,22,3495,2364,18,5508,44,7,78,216660.0,130000.0,-40.0,-36.0,-46.0,-52.0,-43.0,-35.0,-44.0,-48.0,-90.0,-90.0,-87.0,-89.0,50.0,54.0,41.0,37.0,1
1936,62:47:05:9D:EB:15,3859811,499507095,8000,13740534,3851811,485766561,1,8337,4189901,8280,4181113,57,8788,4086,0,8086,59,1,144,229410.0,137640.0,-49.0,-46.0,-43.0,-49.0,-47.0,-43.0,-41.0,-46.0,-90.0,-90.0,-87.0,-89.0,41.0,44.0,44.0,40.0,1
1937,92:69:1D:31:68:E9,3856036,489484037,4225,3717476,3851811,485766561,1,5830,1240512,5647,1198839,183,41673,2352,12,4503,104,1,66,229410.0,130000.0,-52.0,-47.0,-42.0,-49.0,-51.0,-48.0,-43.0,-48.0,-90.0,-90.0,-87.0,-89.0,38.0,43.0,45.0,40.0,1
1938,CC:2F:71:3F:1F:24,5224227,2083351514,1372416,1597584953,3851811,485766561,2222,1159715,1340765577,1158821,1340657143,894,108434,1122578,15,1370552,126979,2219,877,144444.0,43333.0,-70.0,-70.0,-69.0,-71.0,-70.0,-70.0,-69.0,-70.0,-90.0,-90.0,-87.0,-89.0,20.0,20.0,18.0,18.0,1
1939,CC:2F:71:3E:C5:1F,3852852,485893889,1041,127328,3851811,485766561,3,4541,378722,3785,288984,756,89738,1103,14,1494,30,3,54,144444.0,39000.0,-70.0,-73.0,-68.0,-60.0,-70.0,-72.0,-67.0,-60.0,-90.0,-90.0,-87.0,-89.0,20.0,17.0,19.0,29.0,1
1940,BA:8C:B9:54:50:24,3856784,491965211,4973,6198650,3851811,485766561,7,10088,1774846,10066,1771351,22,3495,2364,18,5508,44,7,78,216660.0,130000.0,-40.0,-36.0,-46.0,-52.0,-43.0,-35.0,-44.0,-48.0,-90.0,-90.0,-87.0,-89.0,50.0,54.0,41.0,37.0,1
1941,62:47:05:9D:EB:15,3859833,499514201,8020,13747438,3851813,485766763,1,8395,4223100,8338,4214312,57,8788,4114,0,8106,59,1,144,229410.0,137640.0,-44.0,-41.0,-38.0,-44.0,-44.0,-41.0,-39.0,-44.0,-90.0,-90.0,-87.0,-89.0,46.0,49.0,49.0,45.0,1
1942,92:69:1D:31:68:E9,3856043,489484759,4226,3717592,3851817,485767167,1,5832,1240648,5649,1198975,183,41673,2352,12,4504,104,1,66,229410.0,130000.0,-51.0,-46.0,-44.0,-47.0,-51.0,-47.0,-43.0,-47.0,-90.0,-90.0,-87.0,-89.0,39.0,44.0,43.0,42.0,1
1943,CC:2F:71:3F:1F:24,5224281,2083369866,1372464,1597602699,3851817,485767167,2222,1159745,1340770535,1158851,1340662101,894,108434,1122605,15,1370600,126981,2219,877,144444.0,43333.0,-73.0,-73.0,-72.0,-74.0,-72.0,-72.0,-71.0,-72.0,-90.0,-90.0,-87.0,-89.0,17.0,17.0,15.0,15.0,1
1944,CC:2F:71:3E:C5:1F,3852859,485894611,1042,127444,3851817,485767167,3,4543,378862,3787,289124,756,89738,1103,14,1495,30,3,54,144444.0,39000.0,-71.0,-74.0,-70.0,-60.0,-70.0,-72.0,-67.0,-60.0,-90.0,-90.0,-87.0,-89.0,19.0,16.0,17.0,29.0,1
1945,BA:8C:B9:54:50:24,3856791,491965933,4974,6198766,3851817,485767167,7,10090,1774982,10068,1771487,22,3495,2364,18,5509,44,7,78,216660.0,130000.0,-48.0,-35.0,-43.0,-45.0,-43.0,-35.0,-44.0,-48.0,-90.0,-90.0,-87.0,-89.0,42.0,55.0,44.0,44.0,1
1946,62:47:05:9D:EB:15,3860757,501828272,8937,16060841,3851820,485767431,1,8509,4251971,8451,4243061,58,8910,4191,0,9023,61,1,145,229410.0,137640.0,-49.0,-46.0,-44.0,-48.0,-49.0,-46.0,-43.0,-48.0,-90.0,-90.0,-86.0,-89.0,41.0,44.0,42.0,41.0,1
1947,92:69:1D:31:68:E9,3856046,489485023,4226,3717592,3851820,485767431,1,5832,1240648,5649,1198975,183,41673,2352,12,4504,104,1,66,229410.0,130000.0,-51.0,-46.0,-44.0,-47.0,-51.0,-47.0,-43.0,-47.0,-90.0,-90.0,-86.0,-89.0,39.0,44.0,42.0,42.0,1
1948,CC:2F:71:3F:1F:24,5224339,2083391377,1372519,1597623946,3851820,485767431,2222,1159783,1340777162,1158889,1340668728,894,108434,1122640,15,1370655,126983,2219,877,144444.0,43333.0,-73.0,-73.0,-72.0,-74.0,-72.0,-72.0,-72.0,-73.0,-90.0,-90.0,-86.0,-89.0,17.0,17.0,14.0,15.0,1
1949,CC:2F:71:3E:C5:1F,3852863,485894935,1042,127444,3851821,485767491,3,4543,378862,3787,289124,756,89738,1103,14,1495,30,3,54,144444.0,39000.0,-71.0,-74.0,-70.0,-60.0,-70.0,-72.0,-67.0,-60.0,-90.0,-90.0,-86.0,-89.0,19.0,16.0,16.0,29.0,1
1950,BA:8C:B9:54:50:24,3856795,491966257,4974,6198766,3851821,485767491,7,10090,1774982,10068,1771487,22,3495,2364,18,5509,44,7,78,216660.0,130000.0,-48.0,-35.0,-43.0,-45.0,-43.0,-35.0,-44.0,-48.0,-90.0,-90.0,-86.0,-89.0,42.0,55.0,43.0,44.0,1
1951,62:47:05:9D:EB:15,3860768,501829814,8940,16061591,3851828,485768223,1,8519,4258060,8461,4249150,58,8910,4197,0,9026,61,1,145,229410.0,137640.0,-49.0,-47.0,-44.0,-48.0,-47.0,-45.0,-42.0,-46.0,-90.0,-90.0,-86.0,-89.0,41.0,43.0,42.0,41.0,1
1952,92:69:1D:31:68:E9,3856054,489485815,4226,3717592,3851828,485768223,1,5832,1240648,5649,1198975,183,41673,2352,12,4504,104,1,66,229410.0,130000.0,-51.0,-46.0,-44.0,-47.0,-51.0,-47.0,-43.0,-47.0,-90.0,-90.0,-86.0,-89.0,39.0,44.0,42.0,42.0,1
1953,CC:2F:71:3F:1F:24,5224395,2083409945,1372567,1597641722,3851828,485768223,2222,1159811,1340781980,1158917,1340673546,894,108434,1122667,15,1370703,126983,2219,877,144444.0,43333.0,-73.0,-72.0,-72.0,-74.0,-73.0,-72.0,-72.0,-73.0,-90.0,-90.0,-86.0,-89.0,17.0,18.0,14.0,15.0,1
1954,CC:2F:71:3E:C5:1F,3852870,485895667,1042,127444,3851828,485768223,3,4543,378862,3787,289124,756,89738,1103,14,1495,30,3,54,144444.0,39000.0,-71.0,-74.0,-70.0,-60.0,-70.0,-72.0,-67.0,-60.0,-90.0,-90.0,-86.0,-89.0,19.0,16.0,16.0,29.0,1
1955,BA:8C:B9:54:50:24,3856802,491966989,4974,6198766,3851828,485768223,7,10090,1774982,10068,1771487,22,3495,2364,18,5509,44,7,78,216660.0,130000.0,-48.0,-35.0,-43.0,-45.0,-43.0,-35.0,-44.0,-48.0,-90.0,-90.0,-86.0,-89.0,42.0,55.0,43.0,44.0,1
1956,62:47:05:9D:EB:15,3860771,501830289,8940,16061591,3851831,485768698,1,8520,4258128,8462,4249218,58,8910,4197,0,9026,61,1,145,229410.0,137640.0,-45.0,-41.0,-38.0,-44.0,-47.0,-44.0,-41.0,-46.0,-90.0,-90.0,-86.0,-89.0,45.0,49.0,48.0,45.0,1
1957,92:69:1D:31:68:E9,3856057,489486290,4226,3717592,3851831,485768698,1,5832,1240648,5649,1198975,183,41673,2352,12,4504,104,1,66,229410.0,130000.0,-51.0,-46.0,-44.0,-47.0,-51.0,-47.0,-43.0,-47.0,-90.0,-90.0,-86.0,-89.0,39.0,44.0,42.0,42.0,1
1958,CC:2F:71:3F:1F:24,5224446,2083428180,1372615,1597659482,3851831,485768698,2222,1159837,1340786566,1158943,1340678132,894,108434,1122692,15,1370751,126985,2219,877,144444.0,43333.0,-73.0,-73.0,-73.0,-73.0,-73.0,-73.0,-72.0,-73.0,-90.0,-90.0,-86.0,-89.0,17.0,17.0,13.0,16.0,1
1959,CC:2F:71:3E:C5:1F,3852873,485896142,1042,127444,3851831,485768698,3,4543,378862,3787,289124,756,89738,1103,14,1495,30,3,54,144444.0,39000.0,-71.0,-74.0,-70.0,-60.0,-70.0,-72.0,-67.0,-60.0,-90.0,-90.0,-86.0,-89.0,19.0,16.0,16.0,29.0,1
1960,BA:8C:B9:54:50:24,3856805,491967464,4974,6198766,3851831,485768698,7,10090,1774982,10068,1771487,22,3495,2364,18,5509,44,7,78,216660.0,130000.0,-48.0,-35.0,-43.0,-45.0,-43.0,-35.0,-44.0,-48.0,-90.0,-90.0,-86.0,-89.0,42.0,55.0,43.0,44.0,1
1961,62:47:05:9D:EB:15,3860792,501859768,8953,16090342,3851839,485769426,1,8524,4258552,8466,4249642,58,8910,4199,0,9039,73,1,145,229410.0,137640.0,-43.0,-42.0,-39.0,-41.0,-46.0,-45.0,-42.0,-45.0,-90.0,-90.0,-86.0,-89.0,47.0,48.0,47.0,48.0,1
1962,92:69:1D:31:68:E9,3856065,489487018,4226,3717592,3851839,485769426,1,5832,1240648,5649,1198975,183,41673,2352,12,4504,104,1,66,229410.0,130000.0,-51.0,-46.0,-44.0,-47.0,-51.0,-47.0,-43.0,-47.0,-90.0,-90.0,-86.0,-89.0,39.0,44.0,42.0,42.0,1
1963,CC:2F:71:3F:1F:24,5224508,2083450009,1372669,1597680583,3851839,485769426,2222,1159869,1340792339,1158975,1340683905,894,108434,1122723,15,1370805,126985,2219,877,144444.0,43333.0,-73.0,-73.0,-72.0,-73.0,-73.0,-73.0,-72.0,-73.0,-90.0,-90.0,-86.0,-89.0,17.0,17.0,14.0,16.0,1
1964,CC:2F:71:3E:C5:1F,3852881,485896870,1042,127444,3851839,485769426,3,4545,379050,3788,289194,757,89856,1104,14,1495,30,3,54,144444.0,39000.0,-71.0,-73.0,-70.0,-60.0,-70.0,-72.0,-68.0,-60.0,-90.0,-90.0,-86.0,-89.0,19.0,17.0,16.0,29.0,1
1965,BA:8C:B9:54:50:24,3856813,491968192,4974,6198766,3851839,485769426,7,10090,1774982,10068,1771487,22,3495,2364,18,5509,44,7,78,216660.0,130000.0,-48.0,-35.0,-43.0,-45.0,-43.0,-35.0,-44.0,-48.0,-90.0,-90.0,-86.0,-89.0,42.0,55.0,43.0,44.0,1
1966,62:47:05:9D:EB:15,3860810,501863904,8969,16094276,3851841,485769628,1,8583,4273948,8525,4265038,58,8910,4223,0,9055,74,1,145,229410.0,137640.0,-47.0,-48.0,-45.0,-46.0,-47.0,-48.0,-45.0,-46.0,-90.0,-90.0,-86.0,-89.0,43.0,42.0,41.0,43.0,1
1967,92:69:1D:31:68:E9,3856067,489487220,4226,3717592,3851841,485769628,1,5832,1240648,5649,1198975,183,41673,2352,12,4504,104,1,66,229410.0,130000.0,-51.0,-46.0,-44.0,-47.0,-51.0,-47.0,-43.0,-47.0,-90.0,-90.0,-86.0,-89.0,39.0,44.0,42.0,42.0,1
1968,CC:2F:71:3F:1F:24,5224558,2083467987,1372717,1597698359,3851841,485769628,2222,1159897,1340797267,1159003,1340688833,894,108434,1122749,15,1370853,126985,2219,877,144444.0,43333.0,-73.0,-73.0,-72.0,-73.0,-72.0,-72.0,-71.0,-72.0,-90.0,-90.0,-86.0,-89.0,17.0,17.0,14.0,16.0,1
1969,CC:2F:71:3E:C5:1F,3852883,485897072,1042,127444,3851841,485769628,3,4545,379050,3788,289194,757,89856,1104,14,1495,30,3,54,144444.0,39000.0,-71.0,-73.0,-70.0,-60.0,-70.0,-72.0,-68.0,-60.0,-90.0,-90.0,-86.0,-89.0,19.0,17.0,16.0,29.0,1
1970,BA:8C:B9:54:50:24,3856815,491968394,4974,6198766,3851841,485769628,7,10090,1774982,10068,1771487,22,3495,2364,18,5509,44,7,78,216660.0,130000.0,-48.0,-35.0,-43.0,-45.0,-43.0,-35.0,-44.0,-48.0,-90.0,-90.0,-86.0,-89.0,42.0,55.0,43.0,44.0,1
1971,62:47:05:9D:EB:15,3860842,501872528,8991,16101689,3851851,485770839,1,8647,4286413,8588,4277268,59,9145,4245,0,9077,74,1,145,229410.0,137640.0,-44.0,-44.0,-40.0,-42.0,-46.0,-47.0,-44.0,-45.0,-90.0,-91.0,-87.0,-89.0,46.0,47.0,47.0,47.0,1
1972,92:69:1D:31:68:E9,3856077,489488431,4226,3717592,3851851,485770839,1,5832,1240648,5649,1198975,183,41673,2352,12,4504,104,1,66,229410.0,130000.0,-51.0,-46.0,-44.0,-47.0,-51.0,-47.0,-43.0,-47.0,-90.0,-91.0,-87.0,-89.0,39.0,45.0,43.0,42.0,1
1973,CC:2F:71:3F:1F:24,5224616,2083486958,1372765,1597716119,3851851,485770839,2222,1159927,1340802461,1159032,1340693909,895,108552,1122775,15,1370901,126993,2219,877,144444.0,43333.0,-73.0,-73.0,-73.0,-73.0,-73.0,-73.0,-72.0,-72.0,-90.0,-91.0,-87.0,-89.0,17.0,18.0,14.0,16.0,1
1974,CC:2F:71:3E:C5:1F,3852893,485898283,1042,127444,3851851,485770839,3,4545,379050,3788,289194,757,89856,1104,14,1495,30,3,54,144444.0,39000.0,-71.0,-73.0,-70.0,-60.0,-70.0,-72.0,-68.0,-60.0,-90.0,-91.0,-87.0,-89.0,19.0,18.0,17.0,29.0,1
1975,BA:8C:B9:54:50:24,3856826,491969665,4974,6198766,3851852,485770899,7,10090,1774982,10068,1771487,22,3495,2364,18,5509,44,7,78,216660.0,130000.0,-48.0,-35.0,-43.0,-45.0,-43.0,-35.0,-44.0,-48.0,-90.0,-91.0,-87.0,-89.0,42.0,56.0,44.0,44.0,1
1976,62:47:05:9D:EB:15,3860845,501872790,8991,16101689,3851854,485771101,1,8659,4287229,8600,4278084,59,9145,4245,0,9077,74,1,145,229410.0,137640.0,-43.0,-44.0,-39.0,-41.0,-43.0,-44.0,-40.0,-41.0,-90.0,-91.0,-87.0,-89.0,47.0,47.0,48.0,48.0,1
1977,92:69:1D:31:68:E9,3856080,489488693,4226,3717592,3851854,485771101,1,5832,1240648,5649,1198975,183,41673,2352,12,4504,104,1,66,229410.0,130000.0,-51.0,-46.0,-44.0,-47.0,-51.0,-47.0,-43.0,-47.0,-90.0,-91.0,-87.0,-89.0,39.0,45.0,43.0,42.0,1
1978,CC:2F:71:3F:1F:24,5224664,2083504590,1372810,1597733489,3851854,485771101,2222,1159955,1340807341,1159060,1340698789,895,108552,1122801,15,1370946,126994,2219,877,144444.0,43333.0,-73.0,-72.0,-72.0,-73.0,-71.0,-71.0,-70.0,-72.0,-90.0,-91.0,-87.0,-89.0,17.0,19.0,15.0,16.0,1
1979,CC:2F:71:3E:C5:1F,3852896,485898545,1042,127444,3851854,485771101,3,4545,379050,3788,289194,757,89856,1104,14,1495,30,3,54,144444.0,39000.0,-71.0,-73.0,-70.0,-60.0,-70.0,-72.0,-68.0,-60.0,-90.0,-91.0,-87.0,-89.0,19.0,18.0,17.0,29.0,1
1980,BA:8C:B9:54:50:24,3856828,491969867,4974,6198766,3851854,485771101,7,10090,1774982,10068,1771487,22,3495,2364,18,5509,44,7,78,216660.0,130000.0,-48.0,-35.0,-43.0,-45.0,-43.0,-35.0,-44.0,-48.0,-90.0,-91.0,-87.0,-89.0,42.0,56.0,44.0,44.0,1
1981,62:47:05:9D:EB:15,3860851,501873396,8991,16101689,3851860,485771707,1,8659,4287229,8600,4278084,59,9145,4245,0,9077,74,1,145,229410.0,137640.0,-43.0,-44.0,-39.0,-41.0,-43.0,-44.0,-40.0,-41.0,-90.0,-91.0,-87.0,-89.0,47.0,47.0,48.0,48.0,1
1982,92:69:1D:31:68:E9,3856086,489489299,4226,3717592,3851860,485771707,1,5832,1240648,5649,1198975,183,41673,2352,12,4504,104,1,66,229410.0,130000.0,-51.0,-46.0,-44.0,-47.0,-51.0,-47.0,-43.0,-47.0,-90.0,-91.0,-87.0,-89.0,39.0,45.0,43.0,42.0,1
1983,CC:2F:71:3F:1F:24,5224722,2083526037,1372862,1597754330,3851860,485771707,2222,1159991,1340813752,1159096,1340705200,895,108552,1122833,15,1370998,126994,2219,877,144444.0,43333.0,-70.0,-70.0,-69.0,-70.0,-69.0,-69.0,-68.0,-70.0,-90.0,-91.0,-87.0,-89.0,20.0,21.0,18.0,19.0,1
1984,CC:2F:71:3E:C5:1F,3852902,485899151,1042,127444,3851860,485771707,3,4545,379050,3788,289194,757,89856,1104,14,1495,30,3,54,144444.0,39000.0,-71.0,-73.0,-70.0,-60.0,-70.0,-72.0,-68.0,-60.0,-90.0,-91.0,-87.0,-89.0,19.0,18.0,17.0,29.0,1
1985,BA:8C:B9:54:50:24,3856834,491970473,4974,6198766,3851860,485771707,7,10090,1774982,10068,1771487,22,3495,2364,18,5509,44,7,78,216660.0,130000.0,-48.0,-35.0,-43.0,-45.0,-43.0,-35.0,-44.0,-48.0,-90.0,-91.0,-87.0,-89.0,42.0,56.0,44.0,44.0,1
1986,62:47:05:9D:EB:15,3860854,501873658,8991,16101689,3851863,485771969,1,8659,4287229,8600,4278084,59,9145,4245,0,9077,74,1,145,229410.0,137640.0,-43.0,-44.0,-39.0,-41.0,-43.0,-44.0,-40.0,-41.0,-90.0,-91.0,-87.0,-89.0,47.0,47.0,48.0,48.0,1
1987,92:69:1D:31:68:E9,3856089,489489561,4226,3717592,3851863,485771969,1,5832,1240648,5649,1198975,183,41673,2352,12,4504,104,1,66,229410.0,130000.0,-51.0,-46.0,-44.0,-47.0,-51.0,-47.0,-43.0,-47.0,-90.0,-91.0,-87.0,-89.0,39.0,45.0,43.0,42.0,1
1988,CC:2F:71:3F:1F:24,5224773,2083544059,1372910,1597772090,3851863,485771969,2222,1160017,1340818338,1159122,1340709786,895,108552,1122858,15,1371046,126996,2219,877,144444.0,43333.0,-70.0,-70.0,-68.0,-70.0,-70.0,-69.0,-68.0,-70.0,-90.0,-91.0,-87.0,-89.0,20.0,21.0,19.0,19.0,1
1989,CC:2F:71:3E:C5:1F,3852905,485899413,1042,127444,3851863,485771969,3,4545,379050,3788,289194,757,89856,1104,14,1495,30,3,54,144444.0,39000.0,-71.0,-73.0,-70.0,-60.0,-70.0,-72.0,-68.0,-60.0,-90.0,-91.0,-87.0,-89.0,19.0,18.0,17.0,29.0,1
1990,BA:8C:B9:54:50:24,3856839,491970937,4974,6198766,3851865,485772171,7,10090,1774982,10068,1771487,22,3495,2364,18,5509,44,7,78,216660.0,130000.0,-48.0,-35.0,-43.0,-45.0,-43.0,-35.0,-44.0,-48.0,-90.0,-90.0,-87.0,-89.0,42.0,55.0,44.0,44.0,1
1991,62:47:05:9D:EB:15,3860864,501875109,8995,16102534,3851869,485772575,1,8667,4291074,8608,4281929,59,9145,4249,0,9081,74,1,145,229410.0,137640.0,-49.0,-47.0,-44.0,-46.0,-45.0,-45.0,-41.0,-43.0,-90.0,-90.0,-87.0,-89.0,41.0,43.0,43.0,43.0,1
1992,92:69:1D:31:68:E9,3856095,489490167,4226,3717592,3851869,485772575,1,5832,1240648,5649,1198975,183,41673,2352,12,4504,104,1,66,229410.0,130000.0,-51.0,-46.0,-44.0,-47.0,-51.0,-47.0,-43.0,-47.0,-90.0,-90.0,-87.0,-89.0,39.0,44.0,43.0,42.0,1
1993,CC:2F:71:3F:1F:24,5224826,2083562199,1372957,1597789624,3851869,485772575,2222,1160044,1340823102,1159149,1340714550,895,108552,1122883,15,1371093,126996,2219,877,144444.0,39000.0,-70.0,-70.0,-69.0,-70.0,-70.0,-69.0,-68.0,-70.0,-90.0,-90.0,-87.0,-89.0,20.0,20.0,18.0,19.0,1
1994,CC:2F:71:3E:C5:1F,3852913,485900221,1042,127444,3851871,485772777,3,4545,379050,3788,289194,757,89856,1104,14,1495,30,3,54,144444.0,39000.0,-71.0,-73.0,-70.0,-60.0,-70.0,-72.0,-68.0,-60.0,-90.0,-90.0,-87.0,-89.0,19.0,17.0,17.0,29.0,1
1995,BA:8C:B9:54:50:24,3856845,491971543,4974,6198766,3851871,485772777,7,10090,1774982,10068,1771487,22,3495,2364,18,5509,44,7,78,216660.0,130000.0,-48.0,-35.0,-43.0,-45.0,-43.0,-35.0,-44.0,-48.0,-90.0,-90.0,-87.0,-89.0,42.0,55.0,44.0,44.0,1
1996,62:47:05:9D:EB:15,3860878,501877933,9007,16105156,3851871,485772777,1,8683,4293355,8624,4284210,59,9145,4260,0,9093,74,1,145,229410.0,137640.0,-45.0,-42.0,-38.0,-42.0,-48.0,-45.0,-42.0,-45.0,-90.0,-90.0,-87.0,-89.0,45.0,48.0,49.0,47.0,1
1997,92:69:1D:31:68:E9,3856097,489490369,4226,3717592,3851871,485772777,1,5832,1240648,5649,1198975,183,41673,2352,12,4504,104,1,66,229410.0,130000.0,-51.0,-46.0,-44.0,-47.0,-51.0,-47.0,-43.0,-47.0,-90.0,-90.0,-87.0,-89.0,39.0,44.0,43.0,42.0,1
1998,CC:2F:71:3F:1F:24,5224874,2083579845,1373003,1597807068,3851871,485772777,2222,1160071,1340827914,1159176,1340719362,895,108552,1122908,15,1371139,126998,2219,877,144444.0,43333.0,-70.0,-70.0,-69.0,-70.0,-70.0,-69.0,-68.0,-70.0,-90.0,-90.0,-87.0,-89.0,20.0,20.0,18.0,19.0,1
1999,CC:2F:71:3E:C5:1F,3852916,485900483,1042,127444,3851874,485773039,3,4545,379050,3788,289194,757,89856,1104,14,1495,30,3,54,144444.0,39000.0,-71.0,-73.0,-70.0,-60.0,-70.0,-72.0,-68.0,-60.0,-90.0,-90.0,-87.0,-89.0,19.0,17.0,17.0,29.0,1
2000,BA:8C:B9:54:50:24,3856848,491971805,4974,6198766,3851874,485773039,7,10090,1774982,10068,1771487,22,3495,2364,18,5509,44,7,78,216660.0,130000.0,-48.0,-35.0,-43.0,-45.0,-43.0,-35.0,-44.0,-48.0,-90.0,-90.0,-87.0,-89.0,42.0,55.0,44.0,44.0,1
2001,62:47:05:9D:EB:15,3860888,501879485,9010,16106042,3851878,485773443,1,8708,4297110,8649,4287965,59,9145,4267,0,9096,74,1,145,216660.0,130000.0,-49.0,-48.0,-45.0,-47.0,-48.0,-46.0,-43.0,-45.0,-90.0,-90.0,-87.0,-89.0,41.0,42.0,42.0,42.0,1
2002,92:69:1D:31:68:E9,3856104,489491035,4226,3717592,3851878,485773443,1,5832,1240648,5649,1198975,183,41673,2352,12,4504,104,1,66,229410.0,130000.0,-51.0,-46.0,-44.0,-47.0,-51.0,-47.0,-43.0,-47.0,-90.0,-90.0,-87.0,-89.0,39.0,44.0,43.0,42.0,1
2003,CC:2F:71:3F:1F:24,5224936,2083601700,1373056,1597828055,3851880,485773645,2222,1160105,1340833873,1159210,1340725321,895,108552,1122940,15,1371192,127003,2219,877,144444.0,43333.0,-70.0,-69.0,-68.0,-70.0,-70.0,-69.0,-68.0,-70.0,-90.0,-90.0,-87.0,-89.0,20.0,21.0,19.0,19.0,1
2004,CC:2F:71:3E:C5:1F,3852922,485901089,1042,127444,3851880,485773645,3,4545,379050,3788,289194,757,89856,1104,14,1495,30,3,54,144444.0,39000.0,-71.0,-73.0,-70.0,-60.0,-70.0,-72.0,-68.0,-60.0,-90.0,-90.0,-87.0,-89.0,19.0,17.0,17.0,29.0,1
2005,BA:8C:B9:54:50:24,3856854,491972411,4974,6198766,3851880,485773645,7,10090,1774982,10068,1771487,22,3495,2364,18,5509,44,7,78,216660.0,130000.0,-48.0,-35.0,-43.0,-45.0,-43.0,-35.0,-44.0,-48.0,-90.0,-90.0,-87.0,-89.0,42.0,55.0,44.0,44.0,1
2006,62:47:05:9D:EB:15,3860891,501879841,9011,16106196,3851880,485773645,1,8709,4297178,8650,4288033,59,9145,4267,0,9097,74,1,145,216660.0,130000.0,-45.0,-42.0,-38.0,-42.0,-47.0,-45.0,-42.0,-45.0,-89.0,-90.0,-86.0,-89.0,44.0,48.0,48.0,47.0,1
2007,92:69:1D:31:68:E9,3856108,489491439,4226,3717592,3851882,485773847,1,5832,1240648,5649,1198975,183,41673,2352,12,4504,104,1,66,229410.0,130000.0,-51.0,-46.0,-44.0,-47.0,-51.0,-47.0,-43.0,-47.0,-89.0,-90.0,-86.0,-89.0,38.0,44.0,42.0,42.0,1
2008,CC:2F:71:3F:1F:24,5224986,2083619662,1373104,1597845815,3851882,485773847,2222,1160133,1340838659,1159238,1340730107,895,108552,1122965,15,1371240,127006,2219,877,144444.0,43333.0,-70.0,-70.0,-69.0,-70.0,-70.0,-69.0,-69.0,-70.0,-89.0,-90.0,-86.0,-89.0,19.0,20.0,17.0,19.0,1
2009,CC:2F:71:3E:C5:1F,3852924,485901291,1042,127444,3851882,485773847,3,4546,379120,3789,289264,757,89856,1104,15,1496,31,3,54,144444.0,39000.0,-71.0,-73.0,-70.0,-60.0,-70.0,-72.0,-68.0,-60.0,-89.0,-90.0,-86.0,-89.0,18.0,17.0,16.0,29.0,1
2010,BA:8C:B9:54:50:24,3856856,491972613,4974,6198766,3851882,485773847,7,10092,1775118,10070,1771623,22,3495,2364,18,5510,44,7,79,216660.0,130000.0,-39.0,-36.0,-46.0,-52.0,-43.0,-35.0,-44.0,-48.0,-89.0,-90.0,-86.0,-89.0,50.0,54.0,40.0,37.0,1
2011,62:47:05:9D:EB:15,3860913,501884660,9024,16110147,3851889,485774513,1,8759,4307208,8700,4298063,59,9145,4281,0,9110,74,1,145,229410.0,130000.0,-43.0,-42.0,-38.0,-42.0,-43.0,-42.0,-39.0,-42.0,-89.0,-90.0,-86.0,-89.0,46.0,48.0,48.0,47.0,1
2012,92:69:1D:31:68:E9,3856115,489492105,4226,3717592,3851889,485774513,1,5834,1240784,5651,1199111,183,41673,2352,12,4505,104,1,66,229410.0,130000.0,-52.0,-46.0,-44.0,-46.0,-51.0,-47.0,-43.0,-47.0,-89.0,-90.0,-86.0,-89.0,37.0,44.0,42.0,43.0,1
2013,CC:2F:71:3F:1F:24,5225040,2083637942,1373151,1597863429,3851889,485774513,2222,1160163,1340843709,1159268,1340735157,895,108552,1122994,15,1371287,127007,2219,877,144444.0,43333.0,-70.0,-69.0,-68.0,-70.0,-70.0,-69.0,-68.0,-70.0,-89.0,-90.0,-86.0,-89.0,19.0,21.0,18.0,19.0,1
2014,CC:2F:71:3E:C5:1F,3852931,485901957,1042,127444,3851889,485774513,3,4547,379190,3790,289334,757,89856,1104,15,1496,31,3,54,144444.0,39000.0,-71.0,-74.0,-70.0,-60.0,-70.0,-72.0,-68.0,-60.0,-89.0,-90.0,-86.0,-89.0,18.0,16.0,16.0,29.0,1
2015,BA:8C:B9:54:50:24,3856863,491973279,4974,6198766,3851889,485774513,7,10093,1775186,10071,1771691,22,3495,2364,18,5510,44,7,79,216660.0,130000.0,-39.0,-37.0,-45.0,-52.0,-43.0,-35.0,-44.0,-48.0,-89.0,-90.0,-86.0,-89.0,50.0,53.0,41.0,37.0,1
2016,62:47:05:9D:EB:15,3860915,501884862,9024,16110147,3851891,485774715,1,8759,4307208,8700,4298063,59,9145,4281,0,9110,74,1,145,229410.0,130000.0,-43.0,-42.0,-38.0,-42.0,-43.0,-42.0,-39.0,-42.0,-89.0,-90.0,-86.0,-89.0,46.0,48.0,48.0,47.0,1
2017,92:69:1D:31:68:E9,3856117,489492307,4226,3717592,3851891,485774715,1,5834,1240784,5651,1199111,183,41673,2352,12,4505,104,1,66,229410.0,130000.0,-52.0,-46.0,-44.0,-46.0,-51.0,-47.0,-43.0,-47.0,-89.0,-90.0,-86.0,-89.0,37.0,44.0,42.0,43.0,1
2018,CC:2F:71:3F:1F:24,5225087,2083655514,1373196,1597880799,3851891,485774715,2222,1160192,1340848879,1159297,1340740327,895,108552,1123020,15,1371332,127012,2219,877,144444.0,43333.0,-70.0,-70.0,-68.0,-70.0,-70.0,-69.0,-68.0,-70.0,-89.0,-90.0,-86.0,-89.0,19.0,20.0,18.0,19.0,1
2019,CC:2F:71:3E:C5:1F,3852933,485902159,1042,127444,3851891,485774715,3,4547,379190,3790,289334,757,89856,1104,15,1496,31,3,54,144444.0,39000.0,-71.0,-74.0,-70.0,-60.0,-70.0,-72.0,-68.0,-60.0,-89.0,-90.0,-86.0,-89.0,18.0,16.0,16.0,29.0,1
2020,BA:8C:B9:54:50:24,3856867,491973683,4974,6198766,3851893,485774917,7,10093,1775186,10071,1771691,22,3495,2364,18,5510,44,7,79,216660.0,130000.0,-39.0,-37.0,-45.0,-52.0,-43.0,-35.0,-44.0,-48.0,-89.0,-90.0,-86.0,-89.0,50.0,53.0,41.0,37.0,1
2021,62:47:05:9D:EB:15,3860922,501885741,9024,16110147,3851898,485775594,1,8759,4307208,8700,4298063,59,9145,4281,0,9110,74,1,145,229410.0,130000.0,-43.0,-42.0,-38.0,-42.0,-43.0,-42.0,-39.0,-42.0,-89.0,-90.0,-86.0,-89.0,46.0,48.0,48.0,47.0,1
2022,92:69:1D:31:68:E9,3856124,489493186,4226,3717592,3851898,485775594,1,5834,1240784,5651,1199111,183,41673,2352,12,4505,104,1,66,229410.0,130000.0,-52.0,-46.0,-44.0,-46.0,-51.0,-47.0,-43.0,-47.0,-89.0,-90.0,-86.0,-89.0,37.0,44.0,42.0,43.0,1
2023,CC:2F:71:3F:1F:24,5225147,2083677364,1373249,1597901770,3851898,485775594,2222,1160225,1340854878,1159330,1340746326,895,108552,1123051,15,1371385,127013,2219,877,144444.0,43333.0,-70.0,-69.0,-69.0,-70.0,-70.0,-69.0,-68.0,-70.0,-89.0,-90.0,-86.0,-89.0,19.0,21.0,17.0,19.0,1
2024,CC:2F:71:3E:C5:1F,3852940,485903038,1042,127444,3851898,485775594,3,4547,379190,3790,289334,757,89856,1104,15,1496,31,3,54,144444.0,39000.0,-71.0,-74.0,-70.0,-60.0,-70.0,-72.0,-68.0,-60.0,-89.0,-90.0,-86.0,-89.0,18.0,16.0,16.0,29.0,1
2025,BA:8C:B9:54:50:24,3856873,491974420,4974,6198766,3851899,485775654,7,10093,1775186,10071,1771691,22,3495,2364,18,5510,44,7,79,216660.0,130000.0,-39.0,-37.0,-45.0,-52.0,-43.0,-35.0,-44.0,-48.0,-89.0,-90.0,-86.0,-89.0,50.0,53.0,41.0,37.0,1
2026,62:47:05:9D:EB:15,3860925,501886003,9024,16110147,3851901,485775856,1,8759,4307208,8700,4298063,59,9145,4281,0,9110,74,1,145,229410.0,130000.0,-43.0,-42.0,-38.0,-42.0,-43.0,-42.0,-39.0,-42.0,-89.0,-90.0,-86.0,-89.0,46.0,48.0,48.0,47.0,1
2027,92:69:1D:31:68:E9,3856127,489493448,4226,3717592,3851901,485775856,1,5834,1240784,5651,1199111,183,41673,2352,12,4505,104,1,66,229410.0,130000.0,-52.0,-46.0,-44.0,-46.0,-51.0,-47.0,-43.0,-47.0,-89.0,-90.0,-86.0,-89.0,37.0,44.0,42.0,43.0,1
2028,CC:2F:71:3F:1F:24,5225197,2083695256,1373296,1597919400,3851901,485775856,2222,1160252,1340859704,1159357,1340751152,895,108552,1123075,15,1371432,127013,2219,877,144444.0,43333.0,-70.0,-69.0,-69.0,-70.0,-70.0,-69.0,-68.0,-70.0,-89.0,-90.0,-86.0,-89.0,19.0,21.0,17.0,19.0,1
2029,CC:2F:71:3E:C5:1F,3852944,485903434,1042,127444,3851902,485775990,3,4547,379190,3790,289334,757,89856,1104,15,1496,31,3,54,144444.0,39000.0,-71.0,-74.0,-70.0,-60.0,-70.0,-72.0,-68.0,-60.0,-89.0,-90.0,-86.0,-89.0,18.0,16.0,16.0,29.0,1
2030,BA:8C:B9:54:50:24,3856877,491974824,4974,6198766,3851903,485776058,7,10093,1775186,10071,1771691,22,3495,2364,18,5510,44,7,79,216660.0,130000.0,-39.0,-37.0,-45.0,-52.0,-43.0,-35.0,-44.0,-48.0,-89.0,-90.0,-86.0,-89.0,50.0,53.0,41.0,37.0,1
2031,62:47:05:9D:EB:15,3860945,501900359,9038,16123897,3851907,485776462,1,8780,4311042,8721,4301897,59,9145,4294,0,9123,74,1,145,229410.0,130000.0,-41.0,-42.0,-39.0,-46.0,-44.0,-45.0,-42.0,-48.0,-89.0,-90.0,-86.0,-89.0,48.0,48.0,47.0,43.0,1
2032,92:69:1D:31:68:E9,3856133,489494054,4226,3717592,3851907,485776462,1,5834,1240784,5651,1199111,183,41673,2352,12,4505,104,1,66,229410.0,130000.0,-52.0,-46.0,-44.0,-46.0,-51.0,-47.0,-43.0,-47.0,-89.0,-90.0,-86.0,-89.0,37.0,44.0,42.0,43.0,1
2033,CC:2F:71:3F:1F:24,5225248,2083713232,1373341,1597936770,3851907,485776462,2222,1160279,1340864406,1159384,1340755854,895,108552,1123101,15,1371477,127015,2219,877,144444.0,43333.0,-70.0,-69.0,-68.0,-70.0,-70.0,-69.0,-68.0,-70.0,-89.0,-90.0,-86.0,-89.0,19.0,21.0,18.0,19.0,1
2034,CC:2F:71:3E:C5:1F,3852950,485904017,1042,127444,3851908,485776573,3,4547,379190,3790,289334,757,89856,1104,15,1496,31,3,54,144444.0,39000.0,-71.0,-74.0,-70.0,-60.0,-70.0,-72.0,-68.0,-60.0,-89.0,-90.0,-86.0,-89.0,18.0,16.0,16.0,29.0,1
2035,BA:8C:B9:54:50:24,3856882,491975339,4974,6198766,3851908,485776573,7,10093,1775186,10071,1771691,22,3495,2364,18,5510,44,7,79,216660.0,130000.0,-39.0,-37.0,-45.0,-52.0,-43.0,-35.0,-44.0,-48.0,-89.0,-90.0,-86.0,-89.0,50.0,53.0,41.0,37.0,1
2036,62:47:05:9D:EB:15,3861295,502508187,9384,16731352,3851911,485776835,1,9110,4383786,9050,4374470,60,9316,4507,0,9437,75,1,145,229410.0,137640.0,-47.0,-46.0,-44.0,-50.0,-47.0,-46.0,-43.0,-49.0,-89.0,-90.0,-86.0,-89.0,42.0,44.0,42.0,39.0,1
2037,92:69:1D:31:68:E9,3856137,489494427,4226,3717592,3851911,485776835,1,5834,1240784,5651,1199111,183,41673,2352,12,4505,104,1,66,229410.0,130000.0,-52.0,-46.0,-44.0,-46.0,-51.0,-47.0,-43.0,-47.0,-89.0,-90.0,-86.0,-89.0,37.0,44.0,42.0,43.0,1
2038,CC:2F:71:3F:1F:24,5225308,2083734908,1373395,1597957871,3851913,485777037,2222,1160317,1340870998,1159422,1340762446,895,108552,1123136,15,1371531,127015,2219,877,144444.0,43333.0,-70.0,-70.0,-68.0,-70.0,-70.0,-70.0,-68.0,-70.0,-89.0,-90.0,-86.0,-89.0,19.0,20.0,18.0,19.0,1
2039,CC:2F:71:3E:C5:1F,3852955,485904481,1042,127444,3851913,485777037,3,4547,379190,3790,289334,757,89856,1104,15,1496,31,3,54,144444.0,39000.0,-71.0,-74.0,-70.0,-60.0,-70.0,-72.0,-68.0,-60.0,-89.0,-90.0,-86.0,-89.0,18.0,16.0,16.0,29.0,1
2040,BA:8C:B9:54:50:24,3856889,491976005,4974,6198766,3851915,485777239,7,10093,1775186,10071,1771691,22,3495,2364,18,5510,44,7,79,216660.0,130000.0,-39.0,-37.0,-45.0,-52.0,-43.0,-35.0,-44.0,-48.0,-89.0,-90.0,-86.0,-89.0,50.0,53.0,41.0,37.0,1
2041,62:47:05:9D:EB:15,3861615,503301223,9698,17523782,3851917,485777441,1,9317,4421255,9257,4411939,60,9316,4622,0,9784,83,1,145,229410.0,137640.0,-46.0,-47.0,-45.0,-48.0,-44.0,-45.0,-42.0,-46.0,-89.0,-90.0,-86.0,-89.0,43.0,43.0,41.0,41.0,1
2042,92:69:1D:31:68:E9,3856143,489495033,4226,3717592,3851917,485777441,1,5834,1240784,5651,1199111,183,41673,2352,12,4505,104,1,66,229410.0,130000.0,-52.0,-46.0,-44.0,-46.0,-51.0,-47.0,-43.0,-47.0,-89.0,-90.0,-86.0,-89.0,37.0,44.0,42.0,43.0,1
2043,CC:2F:71:3F:1F:24,5225357,2083752698,1373440,1597975257,3851917,485777441,2222,1160342,1340875468,1159447,1340766916,895,108552,1123160,15,1371576,127016,2219,877,144444.0,43333.0,-70.0,-70.0,-69.0,-70.0,-70.0,-70.0,-68.0,-70.0,-89.0,-90.0,-86.0,-89.0,19.0,20.0,17.0,19.0,1
2044,CC:2F:71:3E:C5:1F,3852959,485904885,1042,127444,3851917,485777441,3,4547,379190,3790,289334,757,89856,1104,15,1496,31,3,54,144444.0,39000.0,-71.0,-74.0,-70.0,-60.0,-70.0,-72.0,-68.0,-60.0,-89.0,-90.0,-86.0,-89.0,18.0,16.0,16.0,29.0,1
2045,BA:8C:B9:54:50:24,3856891,491976207,4974,6198766,3851917,485777441,7,10093,1775186,10071,1771691,22,3495,2364,18,5510,44,7,79,216660.0,130000.0,-39.0,-37.0,-45.0,-52.0,-43.0,-35.0,-44.0,-48.0,-89.0,-90.0,-86.0,-89.0,50.0,53.0,41.0,37.0,1
2046,62:47:05:9D:EB:15,3861669,503439177,9750,17661534,3851919,485777643,1,9356,4426578,9296,4417262,60,9316,4644,0,9836,83,1,145,229410.0,137640.0,-46.0,-47.0,-44.0,-50.0,-44.0,-45.0,-43.0,-47.0,-89.0,-90.0,-86.0,-89.0,43.0,43.0,42.0,39.0,1
2047,92:69:1D:31:68:E9,3856147,489495437,4226,3717592,3851921,485777845,1,5834,1240784,5651,1199111,183,41673,2352,12,4505,104,1,66,229410.0,130000.0,-52.0,-46.0,-44.0,-46.0,-51.0,-47.0,-43.0,-47.0,-89.0,-90.0,-86.0,-89.0,37.0,44.0,42.0,43.0,1
2048,CC:2F:71:3F:1F:24,5225408,2083770748,1373487,1597992903,3851921,485777845,2222,1160370,1340880314,1159475,1340771762,895,108552,1123185,15,1371623,127019,2219,877,144444.0,43333.0,-70.0,-70.0,-68.0,-70.0,-70.0,-70.0,-68.0,-70.0,-89.0,-90.0,-86.0,-89.0,19.0,20.0,18.0,19.0,1
2049,CC:2F:71:3E:C5:1F,3852964,485905349,1042,127444,3851922,485777905,3,4547,379190,3790,289334,757,89856,1104,15,1496,31,3,54,144444.0,39000.0,-71.0,-74.0,-70.0,-60.0,-70.0,-72.0,-68.0,-60.0,-89.0,-90.0,-86.0,-89.0,18.0,16.0,16.0,29.0,1
2050,BA:8C:B9:54:50:24,3856898,491976873,4974,6198766,3851924,485778107,7,10093,1775186,10071,1771691,22,3495,2364,18,5510,44,7,79,216660.0,130000.0,-39.0,-37.0,-45.0,-52.0,-43.0,-35.0,-44.0,-48.0,-89.0,-90.0,-86.0,-89.0,50.0,53.0,41.0,37.0,1
2051,62:47:05:9D:EB:15,3861924,504013685,9998,18235376,3851926,485778309,1,9455,4443794,9395,4434478,60,9316,4702,0,10084,83,1,145,229410.0,137640.0,-47.0,-48.0,-45.0,-45.0,-47.0,-47.0,-45.0,-45.0,-89.0,-90.0,-86.0,-89.0,42.0,42.0,41.0,44.0,1
2052,92:69:1D:31:68:E9,3856152,489495901,4226,3717592,3851926,485778309,1,5834,1240784,5651,1199111,183,41673,2352,12,4505,104,1,66,229410.0,130000.0,-52.0,-46.0,-44.0,-46.0,-51.0,-47.0,-43.0,-47.0,-89.0,-90.0,-86.0,-89.0,37.0,44.0,42.0,43.0,1
2053,CC:2F:71:3F:1F:24,5225460,2083788858,1373534,1598010549,3851926,485778309,2222,1160397,1340885016,1159502,1340776464,895,108552,1123211,15,1371670,127022,2219,877,144444.0,43333.0,-71.0,-70.0,-68.0,-71.0,-70.0,-70.0,-68.0,-70.0,-89.0,-90.0,-86.0,-89.0,18.0,20.0,18.0,18.0,1
2054,CC:2F:71:3E:C5:1F,3852968,485905753,1042,127444,3851926,485778309,3,4547,379190,3790,289334,757,89856,1104,15,1496,31,3,54,144444.0,39000.0,-71.0,-74.0,-70.0,-60.0,-70.0,-72.0,-68.0,-60.0,-89.0,-90.0,-86.0,-89.0,18.0,16.0,16.0,29.0,1
2055,BA:8C:B9:54:50:24,3856900,491977075,4974,6198766,3851926,485778309,7,10093,1775186,10071,1771691,22,3495,2364,18,5510,44,7,79,216660.0,130000.0,-39.0,-37.0,-45.0,-52.0,-43.0,-35.0,-44.0,-48.0,-89.0,-90.0,-86.0,-89.0,50.0,53.0,41.0,37.0,1
2056,62:47:05:9D:EB:15,3861969,504118831,10039,18340118,3851930,485778713,1,9468,4448450,9408,4439134,60,9316,4711,0,10125,83,1,145,229410.0,137640.0,-43.0,-45.0,-40.0,-42.0,-46.0,-46.0,-44.0,-44.0,-89.0,-90.0,-86.0,-89.0,46.0,45.0,46.0,47.0,1
2057,92:69:1D:31:68:E9,3856156,489496305,4226,3717592,3851930,485778713,1,5834,1240784,5651,1199111,183,41673,2352,12,4505,104,1,66,229410.0,130000.0,-52.0,-46.0,-44.0,-46.0,-51.0,-47.0,-43.0,-47.0,-89.0,-90.0,-86.0,-89.0,37.0,44.0,42.0,43.0,1
2058,CC:2F:71:3F:1F:24,5225520,2083810565,1373588,1598031650,3851932,485778915,2222,1160430,1340890907,1159535,1340782355,895,108552,1123243,15,1371724,127023,2219,877,144444.0,43333.0,-69.0,-69.0,-68.0,-70.0,-71.0,-71.0,-70.0,-71.0,-89.0,-90.0,-86.0,-89.0,20.0,21.0,18.0,19.0,1
2059,CC:2F:71:3E:C5:1F,3852974,485906359,1042,127444,3851932,485778915,3,4547,379190,3790,289334,757,89856,1104,15,1496,31,3,54,144444.0,39000.0,-71.0,-74.0,-70.0,-60.0,-70.0,-72.0,-68.0,-60.0,-89.0,-90.0,-86.0,-89.0,18.0,16.0,16.0,29.0,1
2060,BA:8C:B9:54:50:24,3856906,491977681,4974,6198766,3851932,485778915,7,10093,1775186,10071,1771691,22,3495,2364,18,5510,44,7,79,216660.0,130000.0,-39.0,-37.0,-45.0,-52.0,-43.0,-35.0,-44.0,-48.0,-89.0,-90.0,-86.0,-89.0,50.0,53.0,41.0,37.0,1
2061,62:47:05:9D:EB:15,3861991,504127143,10056,18347966,3851935,485779177,1,9518,4459890,9458,4450574,60,9316,4730,0,10142,83,1,145,229410.0,137640.0,-46.0,-49.0,-46.0,-47.0,-43.0,-45.0,-44.0,-44.0,-89.0,-90.0,-86.0,-89.0,43.0,41.0,40.0,42.0,1
2062,92:69:1D:31:68:E9,3856161,489496769,4226,3717592,3851935,485779177,1,5834,1240784,5651,1199111,183,41673,2352,12,4505,104,1,66,229410.0,130000.0,-52.0,-46.0,-44.0,-46.0,-51.0,-47.0,-43.0,-47.0,-89.0,-90.0,-86.0,-89.0,37.0,44.0,42.0,43.0,1
2063,CC:2F:71:3F:1F:24,5225570,2083828473,1373635,1598049296,3851935,485779177,2222,1160457,1340895609,1159562,1340787057,895,108552,1123269,15,1371771,127026,2219,877,144444.0,43333.0,-70.0,-70.0,-69.0,-70.0,-70.0,-70.0,-68.0,-70.0,-89.0,-90.0,-86.0,-89.0,19.0,20.0,17.0,19.0,1
2064,CC:2F:71:3E:C5:1F,3852977,485906621,1042,127444,3851935,485779177,3,4547,379190,3790,289334,757,89856,1104,15,1496,31,3,54,144444.0,39000.0,-71.0,-74.0,-70.0,-60.0,-70.0,-72.0,-68.0,-60.0,-89.0,-90.0,-86.0,-89.0,18.0,16.0,16.0,29.0,1
2065,BA:8C:B9:54:50:24,3856909,491977943,4974,6198766,3851935,485779177,7,10093,1775186,10071,1771691,22,3495,2364,18,5510,44,7,79,216660.0,130000.0,-39.0,-37.0,-45.0,-52.0,-43.0,-35.0,-44.0,-48.0,-89.0,-90.0,-86.0,-89.0,50.0,53.0,41.0,37.0,1
2066,62:47:05:9D:EB:15,3862041,504239696,10100,18459913,3851941,485779783,1,9534,4462586,9474,4453270,60,9316,4739,0,10186,83,1,145,229410.0,137640.0,-46.0,-49.0,-46.0,-47.0,-46.0,-49.0,-46.0,-47.0,-89.0,-90.0,-86.0,-89.0,43.0,41.0,40.0,42.0,1
2067,92:69:1D:31:68:E9,3856168,489497491,4227,3717708,3851941,485779783,1,5836,1240920,5653,1199247,183,41673,2352,12,4506,104,1,66,229410.0,130000.0,-52.0,-47.0,-42.0,-49.0,-51.0,-46.0,-43.0,-47.0,-89.0,-90.0,-86.0,-89.0,37.0,43.0,44.0,40.0,1
2068,CC:2F:71:3F:1F:24,5225624,2083846841,1373683,1598067058,3851941,485779783,2222,1160490,1340901053,1159595,1340792501,895,108552,1123296,15,1371819,127032,2219,877,144444.0,43333.0,-69.0,-70.0,-69.0,-70.0,-69.0,-70.0,-69.0,-70.0,-89.0,-90.0,-86.0,-89.0,20.0,20.0,17.0,19.0,1
2069,CC:2F:71:3E:C5:1F,3852984,485907343,1043,127560,3851941,485779783,3,4549,379330,3792,289474,757,89856,1104,15,1497,31,3,54,144444.0,39000.0,-71.0,-73.0,-70.0,-60.0,-70.0,-72.0,-69.0,-60.0,-89.0,-90.0,-86.0,-89.0,18.0,17.0,16.0,29.0,1
2070,BA:8C:B9:54:50:24,3856918,491978867,4975,6198882,3851943,485779985,7,10099,1775594,10077,1772099,22,3495,2364,18,5511,44,7,79,216660.0,130000.0,-40.0,-37.0,-46.0,-52.0,-41.0,-35.0,-44.0,-47.0,-89.0,-90.0,-86.0,-89.0,49.0,53.0,40.0,37.0,1
2071,62:47:05:9D:EB:15,3862048,504240589,10105,18460604,3851943,485779985,1,9570,4465560,9510,4456244,60,9316,4744,0,10191,83,1,145,229410.0,137640.0,-53.0,-59.0,-53.0,-61.0,-54.0,-60.0,-54.0,-62.0,-89.0,-90.0,-86.0,-89.0,36.0,31.0,33.0,28.0,1
2072,92:69:1D:31:68:E9,3856170,489497693,4227,3717708,3851943,485779985,1,5836,1240920,5653,1199247,183,41673,2352,12,4506,104,1,66,229410.0,130000.0,-52.0,-47.0,-42.0,-49.0,-51.0,-46.0,-43.0,-47.0,-89.0,-90.0,-86.0,-89.0,37.0,43.0,44.0,40.0,1
2073,CC:2F:71:3F:1F:24,5225673,2083864673,1373730,1598084688,3851943,485779985,2222,1160517,1340905755,1159622,1340797203,895,108552,1123322,15,1371866,127039,2219,877,144444.0,43333.0,-70.0,-68.0,-71.0,-72.0,-70.0,-67.0,-70.0,-72.0,-89.0,-90.0,-86.0,-89.0,19.0,22.0,15.0,17.0,1
2074,CC:2F:71:3E:C5:1F,3852987,485907605,1043,127560,3851944,485780045,3,4549,379330,3792,289474,757,89856,1104,15,1497,31,3,54,144444.0,39000.0,-71.0,-73.0,-70.0,-60.0,-70.0,-72.0,-69.0,-60.0,-89.0,-90.0,-86.0,-89.0,18.0,17.0,16.0,29.0,1
2075,BA:8C:B9:54:50:24,3856919,491978927,4975,6198882,3851944,485780045,7,10099,1775594,10077,1772099,22,3495,2364,18,5511,44,7,79,216660.0,130000.0,-40.0,-37.0,-46.0,-52.0,-41.0,-35.0,-44.0,-47.0,-89.0,-90.0,-86.0,-89.0,49.0,53.0,40.0,37.0,1
2076,62:47:05:9D:EB:15,3862126,504436691,10176,18656040,3851950,485780651,1,9600,4468299,9540,4458983,60,9316,4752,0,10262,83,1,145,229410.0,137640.0,-57.0,-63.0,-52.0,-62.0,-53.0,-59.0,-52.0,-61.0,-89.0,-90.0,-86.0,-89.0,32.0,27.0,34.0,27.0,1
2077,92:69:1D:31:68:E9,3856177,489498359,4227,3717708,3851950,485780651,1,5836,1240920,5653,1199247,183,41673,2352,12,4506,104,1,66,229410.0,130000.0,-52.0,-47.0,-42.0,-49.0,-51.0,-46.0,-43.0,-47.0,-89.0,-90.0,-86.0,-89.0,37.0,43.0,44.0,40.0,1
2078,CC:2F:71:3F:1F:24,5225735,2083886512,1373783,1598105659,3851952,485780853,2222,1160555,1340912509,1159660,1340803957,895,108552,1123355,15,1371919,127041,2219,877,144444.0,43333.0,-74.0,-71.0,-72.0,-75.0,-74.0,-71.0,-72.0,-74.0,-89.0,-90.0,-86.0,-89.0,15.0,19.0,14.0,14.0,1
2079,CC:2F:71:3E:C5:1F,3852995,485908413,1043,127560,3851952,485780853,3,4549,379330,3792,289474,757,89856,1104,15,1497,31,3,54,144444.0,39000.0,-71.0,-73.0,-70.0,-60.0,-70.0,-72.0,-69.0,-60.0,-89.0,-90.0,-86.0,-89.0,18.0,17.0,16.0,29.0,1
2080,BA:8C:B9:54:50:24,3856927,491979735,4975,6198882,3851952,485780853,7,10099,1775594,10077,1772099,22,3495,2364,18,5511,44,7,79,216660.0,130000.0,-40.0,-37.0,-46.0,-52.0,-41.0,-35.0,-44.0,-47.0,-89.0,-90.0,-86.0,-89.0,49.0,53.0,40.0,37.0,1
2081,62:47:05:9D:EB:15,3862129,504437166,10176,18656040,3851953,485781126,1,9600,4468299,9540,4458983,60,9316,4752,0,10262,83,1,145,229410.0,137640.0,-57.0,-63.0,-52.0,-62.0,-53.0,-59.0,-52.0,-61.0,-89.0,-90.0,-86.0,-89.0,32.0,27.0,34.0,27.0,1
2082,92:69:1D:31:68:E9,3856180,489498834,4227,3717708,3851953,485781126,1,5836,1240920,5653,1199247,183,41673,2352,12,4506,104,1,66,229410.0,130000.0,-52.0,-47.0,-42.0,-49.0,-51.0,-46.0,-43.0,-47.0,-89.0,-90.0,-86.0,-89.0,37.0,43.0,44.0,40.0,1
2083,CC:2F:71:3F:1F:24,5225782,2083904285,1373829,1598123159,3851953,485781126,2222,1160585,1340917715,1159690,1340809163,895,108552,1123382,15,1371965,127041,2219,877,144444.0,43333.0,-74.0,-71.0,-72.0,-74.0,-74.0,-71.0,-72.0,-74.0,-89.0,-90.0,-86.0,-89.0,15.0,19.0,14.0,15.0,1
2084,CC:2F:71:3E:C5:1F,3852996,485908686,1043,127560,3851953,485781126,3,4549,379330,3792,289474,757,89856,1104,15,1497,31,3,54,144444.0,39000.0,-71.0,-73.0,-70.0,-60.0,-70.0,-72.0,-69.0,-60.0,-89.0,-90.0,-86.0,-89.0,18.0,17.0,16.0,29.0,1
2085,BA:8C:B9:54:50:24,3856928,491980008,4975,6198882,3851953,485781126,7,10099,1775594,10077,1772099,22,3495,2364,18,5511,44,7,79,216660.0,130000.0,-40.0,-37.0,-46.0,-52.0,-41.0,-35.0,-44.0,-47.0,-89.0,-90.0,-86.0,-89.0,49.0,53.0,40.0,37.0,1
2086,62:47:05:9D:EB:15,3862138,504438034,10176,18656040,3851962,485781994,1,9600,4468299,9540,4458983,60,9316,4752,0,10262,83,1,145,229410.0,137640.0,-57.0,-63.0,-52.0,-62.0,-53.0,-59.0,-52.0,-61.0,-89.0,-90.0,-86.0,-89.0,32.0,27.0,34.0,27.0,1
2087,92:69:1D:31:68:E9,3856189,489499702,4227,3717708,3851962,485781994,1,5836,1240920,5653,1199247,183,41673,2352,12,4506,104,1,66,229410.0,130000.0,-52.0,-47.0,-42.0,-49.0,-51.0,-46.0,-43.0,-47.0,-89.0,-90.0,-86.0,-89.0,37.0,43.0,44.0,40.0,1
2088,CC:2F:71:3F:1F:24,5225837,2083922653,1373875,1598140659,3851962,485781994,2222,1160610,1340922185,1159715,1340813633,895,108552,1123406,15,1372011,127047,2219,877,144444.0,43333.0,-74.0,-71.0,-72.0,-75.0,-74.0,-71.0,-71.0,-74.0,-89.0,-90.0,-86.0,-89.0,15.0,19.0,14.0,14.0,1
2089,CC:2F:71:3E:C5:1F,3853005,485909554,1043,127560,3851962,485781994,3,4549,379330,3792,289474,757,89856,1104,15,1497,31,3,54,144444.0,39000.0,-71.0,-73.0,-70.0,-60.0,-70.0,-72.0,-69.0,-60.0,-89.0,-90.0,-86.0,-89.0,18.0,17.0,16.0,29.0,1
2090,BA:8C:B9:54:50:24,3856937,491980876,4975,6198882,3851962,485781994,7,10099,1775594,10077,1772099,22,3495,2364,18,5511,44,7,79,216660.0,130000.0,-40.0,-37.0,-46.0,-52.0,-41.0,-35.0,-44.0,-47.0,-89.0,-90.0,-86.0,-89.0,49.0,53.0,40.0,37.0,1
2091,62:47:05:9D:EB:15,3862139,504438203,10177,18656209,3851962,485781994,1,9611,4469190,9551,4459874,60,9316,4754,0,10263,83,1,145,229410.0,137640.0,-57.0,-62.0,-57.0,-67.0,-57.0,-63.0,-54.0,-67.0,-89.0,-90.0,-86.0,-89.0,32.0,28.0,29.0,22.0,1
2092,92:69:1D:31:68:E9,3856189,489499702,4227,3717708,3851962,485781994,1,5836,1240920,5653,1199247,183,41673,2352,12,4506,104,1,66,229410.0,130000.0,-52.0,-47.0,-42.0,-49.0,-51.0,-46.0,-43.0,-47.0,-89.0,-90.0,-86.0,-89.0,37.0,43.0,44.0,40.0,1
2093,CC:2F:71:3F:1F:24,5225885,2083940301,1373923,1598158307,3851962,485781994,2222,1160635,1340926655,1159740,1340818103,895,108552,1123430,15,1372059,127048,2219,877,144444.0,39000.0,-73.0,-70.0,-71.0,-74.0,-72.0,-68.0,-69.0,-73.0,-89.0,-90.0,-86.0,-89.0,16.0,20.0,15.0,15.0,1
2094,CC:2F:71:3E:C5:1F,3853005,485909554,1043,127560,3851962,485781994,3,4549,379330,3792,289474,757,89856,1104,15,1497,31,3,54,144444.0,39000.0,-71.0,-73.0,-70.0,-60.0,-70.0,-72.0,-69.0,-60.0,-89.0,-90.0,-86.0,-89.0,18.0,17.0,16.0,29.0,1
2095,BA:8C:B9:54:50:24,3856939,491981078,4975,6198882,3851964,485782196,7,10099,1775594,10077,1772099,22,3495,2364,18,5511,44,7,79,216660.0,130000.0,-40.0,-37.0,-46.0,-52.0,-41.0,-35.0,-44.0,-47.0,-89.0,-90.0,-86.0,-89.0,49.0,53.0,40.0,37.0,1
2096,62:47:05:9D:EB:15,3862155,504441229,10185,18658427,3851970,485782802,1,9657,4475168,9597,4465852,60,9316,4766,0,10271,83,1,145,229410.0,137640.0,-57.0,-61.0,-59.0,-64.0,-56.0,-60.0,-57.0,-64.0,-89.0,-90.0,-87.0,-89.0,32.0,29.0,28.0,25.0,1
2097,92:69:1D:31:68:E9,3856197,489500510,4227,3717708,3851970,485782802,1,5836,1240920,5653,1199247,183,41673,2352,12,4506,104,1,66,229410.0,130000.0,-52.0,-47.0,-42.0,-49.0,-51.0,-46.0,-43.0,-47.0,-89.0,-90.0,-87.0,-89.0,37.0,43.0,45.0,40.0,1
2098,CC:2F:71:3F:1F:24,5225948,2083962246,1373977,1598179384,3851971,485782862,2222,1160670,1340932776,1159775,1340824224,895,108552,1123464,15,1372113,127056,2219,877,144444.0,43333.0,-68.0,-67.0,-68.0,-73.0,-68.0,-67.0,-68.0,-72.0,-89.0,-90.0,-87.0,-89.0,21.0,23.0,19.0,16.0,1
2099,CC:2F:71:3E:C5:1F,3853014,485910422,1043,127560,3851971,485782862,3,4549,379330,3792,289474,757,89856,1104,15,1497,31,3,54,144444.0,39000.0,-71.0,-73.0,-70.0,-60.0,-70.0,-72.0,-69.0,-60.0,-89.0,-90.0,-87.0,-89.0,18.0,17.0,17.0,29.0,1
2100,BA:8C:B9:54:50:24,3856946,491981744,4975,6198882,3851971,485782862,7,10099,1775594,10077,1772099,22,3495,2364,18,5511,44,7,79,216660.0,130000.0,-40.0,-37.0,-46.0,-52.0,-41.0,-35.0,-44.0,-47.0,-89.0,-90.0,-87.0,-89.0,49.0,53.0,41.0,37.0,1
2101,62:47:05:9D:EB:15,3862161,504443075,10190,18660213,3851971,485782862,1,9664,4477867,9604,4468551,60,9316,4772,0,10276,83,1,145,229410.0,137640.0,-53.0,-62.0,-57.0,-72.0,-56.0,-61.0,-58.0,-65.0,-89.0,-90.0,-87.0,-89.0,36.0,28.0,30.0,17.0,1
2102,92:69:1D:31:68:E9,3856200,489500772,4227,3717708,3851973,485783064,1,5836,1240920,5653,1199247,183,41673,2352,12,4506,104,1,66,229410.0,130000.0,-52.0,-47.0,-42.0,-49.0,-51.0,-46.0,-43.0,-47.0,-89.0,-90.0,-87.0,-89.0,37.0,43.0,45.0,40.0,1
2103,CC:2F:71:3F:1F:24,5225996,2083980092,1374023,1598197028,3851973,485783064,2222,1160697,1340937490,1159802,1340828938,895,108552,1123490,15,1372159,127081,2219,877,144444.0,43333.0,-69.0,-69.0,-68.0,-70.0,-69.0,-69.0,-68.0,-70.0,-89.0,-90.0,-87.0,-89.0,20.0,21.0,19.0,19.0,1
2104,CC:2F:71:3E:C5:1F,3853016,485910624,1043,127560,3851973,485783064,3,4549,379330,3792,289474,757,89856,1104,15,1497,31,3,54,144444.0,39000.0,-71.0,-73.0,-70.0,-60.0,-70.0,-72.0,-69.0,-60.0,-89.0,-90.0,-87.0,-89.0,18.0,17.0,17.0,29.0,1
2105,BA:8C:B9:54:50:24,3856950,491982148,4975,6198882,3851975,485783266,7,10099,1775594,10077,1772099,22,3495,2364,18,5511,44,7,79,216660.0,130000.0,-40.0,-37.0,-46.0,-52.0,-41.0,-35.0,-44.0,-47.0,-89.0,-90.0,-87.0,-89.0,49.0,53.0,41.0,37.0,1
2106,62:47:05:9D:EB:15,3862281,504743693,10301,18959961,3851980,485783732,1,9698,4481572,9637,4472134,61,9438,4789,0,10387,83,1,145,229410.0,137640.0,-53.0,-63.0,-59.0,-64.0,-53.0,-63.0,-59.0,-64.0,-89.0,-90.0,-87.0,-89.0,36.0,27.0,28.0,25.0,1
2107,92:69:1D:31:68:E9,3856207,489501440,4227,3717708,3851980,485783732,1,5836,1240920,5653,1199247,183,41673,2352,12,4506,104,1,66,229410.0,130000.0,-52.0,-47.0,-42.0,-49.0,-51.0,-46.0,-43.0,-47.0,-89.0,-90.0,-87.0,-89.0,37.0,43.0,45.0,40.0,1
2108,CC:2F:71:3F:1F:24,5226051,2083998536,1374071,1598214804,3851980,485783732,2222,1160727,1340942557,1159832,1340834005,895,108552,1123518,15,1372207,127099,2219,877,144444.0,43333.0,-69.0,-70.0,-68.0,-70.0,-69.0,-69.0,-68.0,-70.0,-89.0,-90.0,-87.0,-89.0,20.0,20.0,19.0,19.0,1
2109,CC:2F:71:3E:C5:1F,3853023,485911292,1043,127560,3851980,485783732,3,4549,379330,3792,289474,757,89856,1104,15,1497,31,3,54,144444.0,39000.0,-71.0,-73.0,-70.0,-60.0,-70.0,-72.0,-69.0,-60.0,-89.0,-90.0,-87.0,-89.0,18.0,17.0,17.0,29.0,1
2110,BA:8C:B9:54:50:24,3856955,491982614,4975,6198882,3851980,485783732,7,10099,1775594,10077,1772099,22,3495,2364,18,5511,44,7,79,216660.0,130000.0,-40.0,-37.0,-46.0,-52.0,-41.0,-35.0,-44.0,-47.0,-89.0,-90.0,-87.0,-89.0,49.0,53.0,41.0,37.0,1
2111,62:47:05:9D:EB:15,3862284,504743955,10301,18959961,3851983,485783994,1,9698,4481572,9637,4472134,61,9438,4789,0,10387,83,1,145,229410.0,137640.0,-53.0,-63.0,-59.0,-64.0,-53.0,-63.0,-59.0,-64.0,-89.0,-90.0,-87.0,-89.0,36.0,27.0,28.0,25.0,1
2112,92:69:1D:31:68:E9,3856210,489501702,4227,3717708,3851983,485783994,1,5837,1240988,5654,1199315,183,41673,2352,12,4506,104,1,66,229410.0,130000.0,-52.0,-47.0,-45.0,-47.0,-51.0,-46.0,-43.0,-47.0,-89.0,-90.0,-87.0,-89.0,37.0,43.0,42.0,42.0,1
2113,CC:2F:71:3F:1F:24,5226110,2084020117,1374125,1598235921,3851985,485784196,2222,1160761,1340948562,1159866,1340840010,895,108552,1123551,15,1372261,127112,2219,877,144444.0,43333.0,-69.0,-70.0,-68.0,-70.0,-69.0,-70.0,-67.0,-70.0,-89.0,-90.0,-87.0,-89.0,20.0,20.0,19.0,19.0,1
2114,CC:2F:71:3E:C5:1F,3853028,485911756,1043,127560,3851985,485784196,3,4549,379330,3792,289474,757,89856,1104,15,1497,31,3,54,144444.0,39000.0,-71.0,-73.0,-70.0,-60.0,-70.0,-72.0,-69.0,-60.0,-89.0,-90.0,-87.0,-89.0,18.0,17.0,17.0,29.0,1
2115,BA:8C:B9:54:50:24,3856962,491983280,4975,6198882,3851987,485784398,7,10099,1775594,10077,1772099,22,3495,2364,18,5511,44,7,79,216660.0,130000.0,-40.0,-37.0,-46.0,-52.0,-41.0,-35.0,-44.0,-47.0,-89.0,-90.0,-87.0,-89.0,49.0,53.0,41.0,37.0,1
2116,62:47:05:9D:EB:15,3862325,504833339,10336,19048739,3851989,485784600,1,9722,4483993,9661,4474555,61,9438,4798,0,10422,83,1,145,229410.0,137640.0,-56.0,-66.0,-61.0,-65.0,-55.0,-65.0,-60.0,-64.0,-89.0,-90.0,-87.0,-89.0,33.0,24.0,26.0,24.0,1
2117,92:69:1D:31:68:E9,3856216,489502308,4227,3717708,3851989,485784600,1,5837,1240988,5654,1199315,183,41673,2352,12,4506,104,1,66,229410.0,130000.0,-52.0,-47.0,-45.0,-47.0,-51.0,-46.0,-43.0,-47.0,-89.0,-90.0,-87.0,-89.0,37.0,43.0,42.0,42.0,1
2118,CC:2F:71:3F:1F:24,5226160,2084038053,1374171,1598253453,3851989,485784600,2222,1160788,1340953264,1159893,1340844712,895,108552,1123577,15,1372307,127134,2219,877,144444.0,43333.0,-69.0,-70.0,-68.0,-70.0,-69.0,-69.0,-68.0,-70.0,-89.0,-90.0,-87.0,-89.0,20.0,20.0,19.0,19.0,1
2119,CC:2F:71:3E:C5:1F,3853032,485912160,1043,127560,3851989,485784600,3,4549,379330,3792,289474,757,89856,1104,15,1497,31,3,54,144444.0,39000.0,-71.0,-73.0,-70.0,-60.0,-70.0,-72.0,-69.0,-60.0,-89.0,-90.0,-87.0,-90.0,18.0,17.0,17.0,30.0,1
2120,BA:8C:B9:54:50:24,3856964,491983482,4975,6198882,3851989,485784600,7,10099,1775594,10077,1772099,22,3495,2364,18,5511,44,7,79,216660.0,130000.0,-40.0,-37.0,-46.0,-52.0,-41.0,-35.0,-44.0,-47.0,-89.0,-90.0,-87.0,-90.0,49.0,53.0,41.0,38.0,1
2121,62:47:05:9D:EB:15,3862328,504833601,10336,19048739,3851992,485784862,1,9729,4484469,9668,4475031,61,9438,4798,0,10422,83,1,145,229410.0,137640.0,-53.0,-64.0,-58.0,-62.0,-53.0,-63.0,-58.0,-62.0,-89.0,-90.0,-87.0,-90.0,36.0,26.0,29.0,28.0,1
2122,92:69:1D:31:68:E9,3856222,489502834,4227,3717708,3851995,485785126,1,5837,1240988,5654,1199315,183,41673,2352,12,4506,104,1,66,229410.0,130000.0,-52.0,-47.0,-45.0,-47.0,-51.0,-46.0,-43.0,-47.0,-89.0,-90.0,-87.0,-90.0,37.0,43.0,42.0,43.0,1
2123,CC:2F:71:3F:1F:24,5226215,2084056427,1374218,1598271099,3851997,485785328,2222,1160814,1340957852,1159918,1340849182,896,108670,1123602,15,1372354,127152,2219,877,144444.0,43333.0,-69.0,-70.0,-68.0,-69.0,-69.0,-69.0,-67.0,-69.0,-89.0,-90.0,-87.0,-90.0,20.0,20.0,19.0,21.0,1
2124,CC:2F:71:3E:C5:1F,3853040,485912888,1043,127560,3851997,485785328,3,4549,379330,3792,289474,757,89856,1104,15,1497,31,3,54,144444.0,39000.0,-71.0,-73.0,-70.0,-60.0,-70.0,-72.0,-69.0,-60.0,-89.0,-90.0,-87.0,-90.0,18.0,17.0,17.0,30.0,1
2125,BA:8C:B9:54:50:24,3856974,491984412,4975,6198882,3851999,485785530,7,10099,1775594,10077,1772099,22,3495,2364,18,5511,44,7,79,216660.0,130000.0,-40.0,-37.0,-46.0,-52.0,-41.0,-35.0,-44.0,-47.0,-89.0,-90.0,-87.0,-90.0,49.0,53.0,41.0,38.0,1
2126,62:47:05:9D:EB:15,3862384,504969469,10384,19183877,3852000,485785592,1,9750,4486904,9689,4477466,61,9438,4808,0,10470,84,1,145,229410.0,137640.0,-54.0,-64.0,-58.0,-68.0,-55.0,-65.0,-60.0,-68.0,-89.0,-90.0,-87.0,-90.0,35.0,26.0,29.0,22.0,1
2127,92:69:1D:31:68:E9,3856227,489503300,4227,3717708,3852000,485785592,1,5837,1240988,5654,1199315,183,41673,2352,12,4506,104,1,66,229410.0,130000.0,-52.0,-47.0,-45.0,-47.0,-51.0,-46.0,-43.0,-47.0,-89.0,-90.0,-87.0,-90.0,37.0,43.0,42.0,43.0,1
2128,CC:2F:71:3F:1F:24,5226277,2084079936,1374265,1598288745,3852012,485791191,2222,1160840,1340962438,1159944,1340853768,896,108670,1123627,15,1372401,127159,2219,877,144444.0,43333.0,-69.0,-70.0,-68.0,-69.0,-69.0,-70.0,-67.0,-69.0,-89.0,-90.0,-87.0,-90.0,20.0,20.0,19.0,21.0,1
2129,CC:2F:71:3E:C5:1F,3853055,485918751,1043,127560,3852012,485791191,3,4551,379518,3793,289544,758,89974,1105,15,1497,31,3,54,144444.0,39000.0,-72.0,-73.0,-69.0,-60.0,-71.0,-72.0,-69.0,-60.0,-89.0,-90.0,-87.0,-90.0,17.0,17.0,18.0,30.0,1
2130,BA:8C:B9:54:50:24,3856987,491990073,4975,6198882,3852012,485791191,7,10099,1775594,10077,1772099,22,3495,2364,18,5511,44,7,79,216660.0,130000.0,-40.0,-37.0,-46.0,-52.0,-41.0,-35.0,-44.0,-47.0,-89.0,-90.0,-87.0,-90.0,49.0,53.0,41.0,38.0,1
2131,62:47:05:9D:EB:15,3862418,504981798,10387,19184375,3852031,485797423,1,9781,4489316,9720,4479878,61,9438,4812,0,10473,84,1,145,229410.0,137640.0,-54.0,-64.0,-58.0,-67.0,-56.0,-66.0,-61.0,-68.0,-89.0,-90.0,-87.0,-90.0,35.0,26.0,29.0,23.0,1
2132,92:69:1D:31:68:E9,3856258,489515131,4227,3717708,3852031,485797423,1,5840,1241359,5656,1199451,184,41908,2353,12,4506,104,1,66,229410.0,130000.0,-52.0,-47.0,-42.0,-48.0,-52.0,-47.0,-43.0,-48.0,-89.0,-90.0,-87.0,-90.0,37.0,43.0,45.0,42.0,1
2133,CC:2F:71:3F:1F:24,5226350,2084107285,1374319,1598309862,3852031,485797423,2222,1160875,1340968513,1159979,1340859843,896,108670,1123660,15,1372455,127185,2219,877,144444.0,43333.0,-77.0,-76.0,-75.0,-76.0,-74.0,-73.0,-72.0,-74.0,-89.0,-90.0,-87.0,-90.0,12.0,14.0,12.0,14.0,1
2134,CC:2F:71:3E:C5:1F,3853074,485924983,1043,127560,3852031,485797423,3,4551,379518,3793,289544,758,89974,1105,15,1497,31,3,54,144444.0,39000.0,-72.0,-73.0,-69.0,-60.0,-71.0,-72.0,-69.0,-60.0,-89.0,-90.0,-87.0,-90.0,17.0,17.0,18.0,30.0,1
2135,BA:8C:B9:54:50:24,3857007,491996365,4975,6198882,3852032,485797483,7,10101,1775730,10079,1772235,22,3495,2364,18,5512,44,7,79,216660.0,130000.0,-48.0,-35.0,-43.0,-45.0,-42.0,-35.0,-44.0,-46.0,-89.0,-90.0,-87.0,-90.0,41.0,55.0,44.0,45.0,1
2136,62:47:05:9D:EB:15,3862419,504981858,10387,19184375,3852032,485797483,1,9781,4489316,9720,4479878,61,9438,4812,0,10473,84,1,145,229410.0,137640.0,-54.0,-64.0,-58.0,-67.0,-56.0,-66.0,-61.0,-68.0,-89.0,-90.0,-87.0,-90.0,35.0,26.0,29.0,23.0,1
2137,92:69:1D:31:68:E9,3856259,489515191,4227,3717708,3852032,485797483,1,5840,1241359,5656,1199451,184,41908,2353,12,4506,104,1,66,229410.0,130000.0,-52.0,-47.0,-42.0,-48.0,-52.0,-47.0,-43.0,-48.0,-89.0,-90.0,-87.0,-90.0,37.0,43.0,45.0,42.0,1
2138,CC:2F:71:3F:1F:24,5226397,2084124845,1374365,1598327362,3852032,485797483,2222,1160900,1340972983,1160004,1340864313,896,108670,1123684,15,1372501,127202,2219,877,144444.0,43333.0,-70.0,-70.0,-69.0,-70.0,-70.0,-70.0,-69.0,-70.0,-89.0,-90.0,-87.0,-90.0,19.0,20.0,18.0,20.0,1
2139,CC:2F:71:3E:C5:1F,3853075,485925043,1043,127560,3852032,485797483,3,4551,379518,3793,289544,758,89974,1105,15,1497,31,3,54,144444.0,39000.0,-72.0,-73.0,-69.0,-60.0,-71.0,-72.0,-69.0,-60.0,-89.0,-90.0,-87.0,-90.0,17.0,17.0,18.0,30.0,1
2140,BA:8C:B9:54:50:24,3857007,491996365,4975,6198882,3852032,485797483,7,10101,1775730,10079,1772235,22,3495,2364,18,5512,44,7,79,216660.0,130000.0,-48.0,-35.0,-43.0,-45.0,-42.0,-35.0,-44.0,-46.0,-89.0,-90.0,-87.0,-90.0,41.0,55.0,44.0,45.0,1
2141,62:47:05:9D:EB:15,3862428,504982939,10387,19184375,3852041,485798564,1,9781,4489316,9720,4479878,61,9438,4812,0,10473,84,1,145,229410.0,137640.0,-54.0,-64.0,-58.0,-67.0,-56.0,-66.0,-61.0,-68.0,-89.0,-90.0,-87.0,-90.0,35.0,26.0,29.0,23.0,1
2142,92:69:1D:31:68:E9,3856268,489516272,4227,3717708,3852041,485798564,1,5840,1241359,5656,1199451,184,41908,2353,12,4506,104,1,66,229410.0,130000.0,-52.0,-47.0,-42.0,-48.0,-52.0,-47.0,-43.0,-48.0,-89.0,-90.0,-87.0,-90.0,37.0,43.0,45.0,42.0,1
2143,CC:2F:71:3F:1F:24,5226454,2084143686,1374413,1598345122,3852041,485798564,2222,1160926,1340977569,1160030,1340868899,896,108670,1123709,15,1372549,127219,2219,877,144444.0,43333.0,-70.0,-71.0,-69.0,-71.0,-69.0,-70.0,-68.0,-69.0,-89.0,-90.0,-87.0,-90.0,19.0,19.0,18.0,19.0,1
2144,CC:2F:71:3E:C5:1F,3853084,485926124,1043,127560,3852041,485798564,3,4551,379518,3793,289544,758,89974,1105,15,1497,31,3,54,144444.0,39000.0,-72.0,-73.0,-69.0,-60.0,-71.0,-72.0,-69.0,-60.0,-89.0,-90.0,-87.0,-90.0,17.0,17.0,18.0,30.0,1
2145,BA:8C:B9:54:50:24,3857016,491997446,4975,6198882,3852041,485798564,7,10101,1775730,10079,1772235,22,3495,2364,18,5512,44,7,79,216660.0,130000.0,-48.0,-35.0,-43.0,-45.0,-42.0,-35.0,-44.0,-46.0,-89.0,-90.0,-87.0,-90.0,41.0,55.0,44.0,45.0,1
2146,62:47:05:9D:EB:15,3862429,504982999,10387,19184375,3852042,485798624,1,9781,4489316,9720,4479878,61,9438,4812,0,10473,84,1,145,229410.0,137640.0,-54.0,-64.0,-58.0,-67.0,-56.0,-66.0,-61.0,-68.0,-89.0,-90.0,-87.0,-90.0,35.0,26.0,29.0,23.0,1
2147,92:69:1D:31:68:E9,3856269,489516332,4227,3717708,3852042,485798624,1,5840,1241359,5656,1199451,184,41908,2353,12,4506,104,1,66,229410.0,130000.0,-52.0,-47.0,-42.0,-48.0,-52.0,-47.0,-43.0,-48.0,-89.0,-90.0,-87.0,-90.0,37.0,43.0,45.0,42.0,1
2148,CC:2F:71:3F:1F:24,5226500,2084161116,1374458,1598362492,3852042,485798624,2222,1160951,1340982039,1160055,1340873369,896,108670,1123733,15,1372594,127241,2219,877,144444.0,43333.0,-70.0,-71.0,-69.0,-71.0,-70.0,-71.0,-69.0,-70.0,-89.0,-90.0,-87.0,-90.0,19.0,19.0,18.0,19.0,1
2149,CC:2F:71:3E:C5:1F,3853087,485926386,1043,127560,3852044,485798826,3,4551,379518,3793,289544,758,89974,1105,15,1497,31,3,54,144444.0,39000.0,-72.0,-73.0,-69.0,-60.0,-71.0,-72.0,-69.0,-60.0,-89.0,-91.0,-88.0,-90.0,17.0,18.0,19.0,30.0,1
2150,BA:8C:B9:54:50:24,3857019,491997708,4975,6198882,3852044,485798826,7,10101,1775730,10079,1772235,22,3495,2364,18,5512,44,7,79,216660.0,130000.0,-48.0,-35.0,-43.0,-45.0,-42.0,-35.0,-44.0,-46.0,-89.0,-91.0,-88.0,-90.0,41.0,56.0,45.0,45.0,1
2151,62:47:05:9D:EB:15,3862440,504984310,10390,19184878,3852050,485799432,1,9804,4491317,9743,4481879,61,9438,4816,0,10476,84,1,145,216660.0,130000.0,-57.0,-67.0,-61.0,-67.0,-54.0,-65.0,-59.0,-66.0,-89.0,-91.0,-88.0,-90.0,32.0,24.0,27.0,23.0,1
2152,92:69:1D:31:68:E9,3856277,489517140,4227,3717708,3852050,485799432,1,5840,1241359,5656,1199451,184,41908,2353,12,4506,104,1,66,229410.0,130000.0,-52.0,-47.0,-42.0,-48.0,-52.0,-47.0,-43.0,-48.0,-89.0,-91.0,-88.0,-90.0,37.0,44.0,46.0,42.0,1
2153,CC:2F:71:3F:1F:24,5226561,2084182911,1374511,1598383479,3852050,485799432,2222,1160984,1340987928,1160088,1340879258,896,108670,1123765,15,1372647,127271,2219,877,144444.0,43333.0,-71.0,-70.0,-69.0,-71.0,-71.0,-71.0,-70.0,-72.0,-89.0,-91.0,-88.0,-90.0,18.0,21.0,19.0,19.0,1
2154,CC:2F:71:3E:C5:1F,3853093,485926992,1043,127560,3852050,485799432,3,4551,379518,3793,289544,758,89974,1105,15,1497,31,3,54,144444.0,39000.0,-72.0,-73.0,-69.0,-60.0,-71.0,-72.0,-69.0,-60.0,-89.0,-91.0,-88.0,-90.0,17.0,18.0,19.0,30.0,1
2155,BA:8C:B9:54:50:24,3857027,491998682,4975,6198882,3852052,485799800,7,10101,1775730,10079,1772235,22,3495,2364,18,5512,44,7,79,216660.0,130000.0,-48.0,-35.0,-43.0,-45.0,-42.0,-35.0,-44.0,-46.0,-89.0,-91.0,-88.0,-90.0,41.0,56.0,45.0,45.0,1
2156,62:47:05:9D:EB:15,3862498,505133429,10445,19333518,3852053,485799911,1,9845,4495366,9783,4485757,62,9609,4830,0,10531,84,1,145,216660.0,130000.0,-54.0,-66.0,-58.0,-66.0,-55.0,-65.0,-60.0,-65.0,-89.0,-91.0,-88.0,-90.0,35.0,25.0,30.0,24.0,1
2157,92:69:1D:31:68:E9,3856283,489517881,4227,3717708,3852056,485800173,1,5840,1241359,5656,1199451,184,41908,2353,12,4506,104,1,66,229410.0,130000.0,-52.0,-47.0,-42.0,-48.0,-52.0,-47.0,-43.0,-48.0,-89.0,-91.0,-88.0,-90.0,37.0,44.0,46.0,42.0,1
2158,CC:2F:71:3F:1F:24,5226613,2084201152,1374557,1598400979,3852056,485800173,2222,1161011,1340992630,1160115,1340883960,896,108670,1123791,15,1372693,127300,2219,877,144444.0,43333.0,-70.0,-70.0,-68.0,-70.0,-70.0,-70.0,-68.0,-70.0,-89.0,-91.0,-88.0,-90.0,19.0,21.0,20.0,20.0,1
2159,CC:2F:71:3E:C5:1F,3853099,485927733,1043,127560,3852056,485800173,3,4551,379518,3793,289544,758,89974,1105,15,1497,31,3,54,144444.0,39000.0,-72.0,-73.0,-69.0,-60.0,-71.0,-72.0,-69.0,-60.0,-89.0,-91.0,-88.0,-90.0,17.0,18.0,19.0,30.0,1
2160,BA:8C:B9:54:50:24,3857033,491999257,4975,6198882,3852058,485800375,7,10101,1775730,10079,1772235,22,3495,2364,18,5512,44,7,79,216660.0,130000.0,-48.0,-35.0,-43.0,-45.0,-42.0,-35.0,-44.0,-46.0,-89.0,-91.0,-88.0,-90.0,41.0,56.0,45.0,45.0,1
2161,62:47:05:9D:EB:15,3862507,505134297,10445,19333518,3852062,485800779,1,9862,4496574,9800,4486965,62,9609,4831,0,10531,84,1,145,216660.0,130000.0,-54.0,-66.0,-58.0,-67.0,-56.0,-66.0,-61.0,-68.0,-89.0,-91.0,-88.0,-90.0,35.0,25.0,30.0,23.0,1
2162,92:69:1D:31:68:E9,3856289,489518487,4227,3717708,3852062,485800779,1,5840,1241359,5656,1199451,184,41908,2353,12,4506,104,1,66,229410.0,130000.0,-52.0,-47.0,-42.0,-48.0,-52.0,-47.0,-43.0,-48.0,-89.0,-91.0,-88.0,-90.0,37.0,44.0,46.0,42.0,1
2163,CC:2F:71:3F:1F:24,5226666,2084219388,1374604,1598418609,3852062,485800779,2222,1161037,1340997216,1160141,1340888546,896,108670,1123816,15,1372740,127322,2219,877,144444.0,43333.0,-70.0,-71.0,-69.0,-71.0,-70.0,-70.0,-68.0,-70.0,-89.0,-91.0,-88.0,-90.0,19.0,20.0,19.0,19.0,1
2164,CC:2F:71:3E:C5:1F,3853105,485928339,1043,127560,3852062,485800779,3,4551,379518,3793,289544,758,89974,1105,15,1497,31,3,54,144444.0,39000.0,-72.0,-73.0,-69.0,-60.0,-71.0,-72.0,-69.0,-60.0,-89.0,-91.0,-88.0,-90.0,17.0,18.0,19.0,30.0,1
2165,BA:8C:B9:54:50:24,3857037,491999661,4975,6198882,3852062,485800779,7,10101,1775730,10079,1772235,22,3495,2364,18,5512,44,7,79,216660.0,130000.0,-48.0,-35.0,-43.0,-45.0,-42.0,-35.0,-44.0,-46.0,-89.0,-91.0,-88.0,-90.0,41.0,56.0,45.0,45.0,1
2166,62:47:05:9D:EB:15,3862511,505135179,10447,19334198,3852064,485800981,1,9872,4498272,9810,4488663,62,9609,4833,0,10533,84,1,146,216660.0,130000.0,-54.0,-64.0,-57.0,-68.0,-56.0,-66.0,-61.0,-68.0,-89.0,-91.0,-88.0,-90.0,35.0,27.0,31.0,22.0,1
2167,92:69:1D:31:68:E9,3856291,489518689,4227,3717708,3852064,485800981,1,5840,1241359,5656,1199451,184,41908,2353,12,4506,104,1,66,229410.0,130000.0,-52.0,-47.0,-42.0,-48.0,-52.0,-47.0,-43.0,-48.0,-89.0,-91.0,-88.0,-90.0,37.0,44.0,46.0,42.0,1
2168,CC:2F:71:3F:1F:24,5226724,2084241822,1374658,1598440639,3852066,485801183,2222,1161072,1341003395,1160176,1340894725,896,108670,1123850,15,1372793,127352,2219,877,144444.0,43333.0,-69.0,-70.0,-67.0,-70.0,-69.0,-70.0,-67.0,-70.0,-89.0,-91.0,-88.0,-90.0,20.0,21.0,21.0,20.0,1
2169,CC:2F:71:3E:C5:1F,3853109,485928743,1043,127560,3852066,485801183,3,4551,379518,3793,289544,758,89974,1105,15,1497,31,3,54,144444.0,39000.0,-72.0,-73.0,-69.0,-60.0,-71.0,-72.0,-69.0,-60.0,-89.0,-91.0,-88.0,-90.0,17.0,18.0,19.0,30.0,1
2170,BA:8C:B9:54:50:24,3857043,492000267,4975,6198882,3852068,485801385,7,10101,1775730,10079,1772235,22,3495,2364,18,5512,44,7,79,216660.0,130000.0,-48.0,-35.0,-43.0,-45.0,-42.0,-35.0,-44.0,-46.0,-89.0,-91.0,-88.0,-90.0,41.0,56.0,45.0,45.0,1
2171,62:47:05:9D:EB:15,3862574,505282161,10503,19480514,3852071,485801647,1,9884,4499975,9822,4490366,62,9609,4841,0,10589,84,1,146,229410.0,130000.0,-58.0,-65.0,-60.0,-70.0,-56.0,-66.0,-60.0,-67.0,-89.0,-91.0,-88.0,-90.0,31.0,26.0,28.0,20.0,1
2172,92:69:1D:31:68:E9,3856298,489519355,4227,3717708,3852071,485801647,1,5840,1241359,5656,1199451,184,41908,2353,12,4506,104,1,66,229410.0,130000.0,-52.0,-47.0,-42.0,-48.0,-52.0,-47.0,-43.0,-48.0,-89.0,-91.0,-88.0,-91.0,37.0,44.0,46.0,43.0,1
2173,CC:2F:71:3F:1F:24,5226775,2084259802,1374704,1598458155,3852071,485801647,2222,1161097,1341007865,1160201,1340899195,896,108670,1123874,15,1372840,127370,2219,877,144444.0,43333.0,-69.0,-70.0,-68.0,-70.0,-69.0,-70.0,-67.0,-70.0,-89.0,-91.0,-88.0,-91.0,20.0,21.0,20.0,21.0,1
2174,CC:2F:71:3E:C5:1F,3853114,485929207,1043,127560,3852071,485801647,3,4551,379518,3793,289544,758,89974,1105,15,1497,31,3,54,144444.0,39000.0,-72.0,-73.0,-69.0,-60.0,-71.0,-72.0,-69.0,-60.0,-89.0,-91.0,-88.0,-91.0,17.0,18.0,19.0,31.0,1
2175,BA:8C:B9:54:50:24,3857046,492000529,4975,6198882,3852071,485801647,7,10101,1775730,10079,1772235,22,3495,2364,18,5512,44,7,79,216660.0,130000.0,-48.0,-35.0,-43.0,-45.0,-42.0,-35.0,-44.0,-46.0,-89.0,-91.0,-88.0,-91.0,41.0,56.0,45.0,46.0,1
2176,62:47:05:9D:EB:15,3862580,505283225,10505,19481174,3852075,485802051,1,9886,4500731,9824,4491122,62,9609,4842,0,10591,84,1,146,229410.0,130000.0,-56.0,-64.0,-61.0,-63.0,-56.0,-65.0,-60.0,-66.0,-89.0,-91.0,-88.0,-91.0,33.0,27.0,27.0,28.0,1
2177,92:69:1D:31:68:E9,3856304,489519961,4227,3717708,3852077,485802253,1,5840,1241359,5656,1199451,184,41908,2353,12,4506,104,1,66,229410.0,130000.0,-52.0,-47.0,-42.0,-48.0,-52.0,-47.0,-43.0,-48.0,-89.0,-91.0,-88.0,-91.0,37.0,44.0,46.0,43.0,1
2178,CC:2F:71:3F:1F:24,5226827,2084278068,1374750,1598475815,3852077,485802253,2222,1161125,1341012695,1160229,1340904025,896,108670,1123901,15,1372886,127399,2219,877,144444.0,43333.0,-69.0,-70.0,-68.0,-70.0,-69.0,-70.0,-67.0,-69.0,-89.0,-91.0,-88.0,-91.0,20.0,21.0,20.0,21.0,1
2179,CC:2F:71:3E:C5:1F,3853120,485929813,1043,127560,3852077,485802253,3,4551,379518,3793,289544,758,89974,1105,15,1497,31,3,54,144444.0,39000.0,-72.0,-73.0,-69.0,-60.0,-71.0,-72.0,-69.0,-60.0,-89.0,-91.0,-88.0,-91.0,17.0,18.0,19.0,31.0,1
2180,BA:8C:B9:54:50:24,3857052,492001135,4975,6198882,3852077,485802253,7,10101,1775730,10079,1772235,22,3495,2364,18,5512,44,7,79,216660.0,130000.0,-48.0,-35.0,-43.0,-45.0,-42.0,-35.0,-44.0,-46.0,-90.0,-91.0,-88.0,-91.0,42.0,56.0,45.0,46.0,1
2181,62:47:05:9D:EB:15,3862626,505394392,10546,19591877,3852080,485802515,1,9910,4502972,9848,4493363,62,9609,4846,0,10632,84,1,146,229410.0,137640.0,-54.0,-66.0,-57.0,-66.0,-54.0,-63.0,-59.0,-64.0,-90.0,-91.0,-88.0,-91.0,36.0,25.0,31.0,25.0,1
2182,92:69:1D:31:68:E9,3856307,489520223,4227,3717708,3852080,485802515,1,5840,1241359,5656,1199451,184,41908,2353,12,4506,104,1,66,229410.0,130000.0,-52.0,-47.0,-42.0,-48.0,-52.0,-47.0,-43.0,-48.0,-90.0,-91.0,-88.0,-91.0,38.0,44.0,46.0,43.0,1
2183,CC:2F:71:3F:1F:24,5226875,2084295716,1374795,1598493201,3852080,485802515,2222,1161150,1341017165,1160254,1340908495,896,108670,1123925,15,1372931,127411,2219,877,144444.0,43333.0,-69.0,-70.0,-68.0,-70.0,-69.0,-70.0,-67.0,-69.0,-90.0,-91.0,-88.0,-91.0,21.0,21.0,20.0,21.0,1
2184,CC:2F:71:3E:C5:1F,3853123,485930075,1043,127560,3852080,485802515,3,4551,379518,3793,289544,758,89974,1105,15,1497,31,3,54,144444.0,39000.0,-72.0,-73.0,-69.0,-60.0,-71.0,-72.0,-69.0,-60.0,-90.0,-91.0,-88.0,-91.0,18.0,18.0,19.0,31.0,1
2185,BA:8C:B9:54:50:24,3857055,492001397,4975,6198882,3852080,485802515,7,10101,1775730,10079,1772235,22,3495,2364,18,5512,44,7,79,216660.0,130000.0,-48.0,-35.0,-43.0,-45.0,-42.0,-35.0,-44.0,-46.0,-90.0,-91.0,-88.0,-91.0,42.0,56.0,45.0,46.0,1
2186,62:47:05:9D:EB:15,3862693,505560480,10607,19757359,3852086,485803121,1,9925,4504834,9863,4495225,62,9609,4855,0,10693,84,1,146,229410.0,137640.0,-55.0,-64.0,-59.0,-63.0,-56.0,-65.0,-60.0,-65.0,-90.0,-92.0,-89.0,-92.0,35.0,28.0,30.0,29.0,1
2187,92:69:1D:31:68:E9,3856314,489520945,4228,3717824,3852086,485803121,1,5842,1241495,5658,1199587,184,41908,2353,12,4507,104,1,66,229410.0,130000.0,-52.0,-47.0,-45.0,-47.0,-52.0,-47.0,-44.0,-47.0,-90.0,-92.0,-89.0,-92.0,38.0,45.0,44.0,45.0,1
2188,CC:2F:71:3F:1F:24,5226936,2084317443,1374850,1598514322,3852086,485803121,2222,1161185,1341023195,1160289,1340914525,896,108670,1123957,15,1372986,127438,2219,877,144444.0,39000.0,-69.0,-70.0,-68.0,-69.0,-69.0,-70.0,-67.0,-69.0,-90.0,-92.0,-89.0,-92.0,21.0,22.0,21.0,23.0,1
2189,CC:2F:71:3E:C5:1F,3853130,485930797,1044,127676,3852086,485803121,3,4553,379658,3795,289684,758,89974,1105,15,1498,31,3,54,144444.0,43333.0,-66.0,-67.0,-64.0,-60.0,-69.0,-71.0,-68.0,-60.0,-90.0,-92.0,-89.0,-92.0,24.0,25.0,25.0,32.0,1
2190,BA:8C:B9:54:50:24,3857062,492002119,4976,6198998,3852086,485803121,7,10105,1776002,10083,1772507,22,3495,2364,18,5513,44,7,79,216660.0,130000.0,-40.0,-37.0,-46.0,-52.0,-41.0,-35.0,-44.0,-48.0,-90.0,-92.0,-89.0,-92.0,50.0,55.0,43.0,40.0,1
2191,62:47:05:9D:EB:15,3862696,505560744,10607,19757359,3852089,485803385,1,9955,4506928,9892,4497197,63,9731,4856,0,10693,84,1,146,229410.0,137640.0,-54.0,-66.0,-57.0,-63.0,-56.0,-66.0,-60.0,-65.0,-90.0,-92.0,-89.0,-92.0,36.0,26.0,32.0,29.0,1
2192,92:69:1D:31:68:E9,3856317,489521209,4228,3717824,3852089,485803385,1,5842,1241495,5658,1199587,184,41908,2353,12,4507,104,1,66,229410.0,130000.0,-52.0,-47.0,-45.0,-47.0,-52.0,-47.0,-44.0,-47.0,-90.0,-92.0,-89.0,-92.0,38.0,45.0,44.0,45.0,1
2193,CC:2F:71:3F:1F:24,5226985,2084335167,1374896,1598531782,3852089,485803385,2222,1161210,1341027665,1160314,1340918995,896,108670,1123981,15,1373032,127465,2219,877,144444.0,43333.0,-69.0,-70.0,-67.0,-70.0,-69.0,-70.0,-67.0,-69.0,-90.0,-92.0,-89.0,-92.0,21.0,22.0,22.0,22.0,1
2194,CC:2F:71:3E:C5:1F,3853133,485931061,1044,127676,3852089,485803385,3,4553,379658,3795,289684,758,89974,1105,15,1498,31,3,54,144444.0,43333.0,-66.0,-67.0,-64.0,-60.0,-69.0,-71.0,-68.0,-60.0,-90.0,-92.0,-89.0,-92.0,24.0,25.0,25.0,32.0,1
2195,BA:8C:B9:54:50:24,3857065,492002383,4976,6198998,3852089,485803385,7,10105,1776002,10083,1772507,22,3495,2364,18,5513,44,7,79,216660.0,130000.0,-40.0,-37.0,-46.0,-52.0,-41.0,-35.0,-44.0,-48.0,-90.0,-92.0,-89.0,-92.0,50.0,55.0,43.0,40.0,1
2196,62:47:05:9D:EB:15,3862790,505802367,10693,19998254,3852097,485804113,1,9983,4510662,9920,4500931,63,9731,4869,0,10779,86,1,146,229410.0,137640.0,-55.0,-64.0,-60.0,-64.0,-56.0,-65.0,-61.0,-65.0,-90.0,-92.0,-89.0,-92.0,35.0,28.0,29.0,28.0,1
2197,92:69:1D:31:68:E9,3856325,489521937,4228,3717824,3852097,485804113,1,5842,1241495,5658,1199587,184,41908,2353,12,4507,104,1,66,229410.0,130000.0,-52.0,-47.0,-45.0,-47.0,-52.0,-47.0,-44.0,-47.0,-90.0,-92.0,-89.0,-92.0,38.0,45.0,44.0,45.0,1
2198,CC:2F:71:3F:1F:24,5227040,2084353557,1374943,1598549444,3852097,485804113,2222,1161236,1341032253,1160339,1340923465,897,108788,1124006,15,1373079,127488,2219,877,144444.0,43333.0,-69.0,-70.0,-68.0,-70.0,-69.0,-70.0,-67.0,-69.0,-90.0,-92.0,-89.0,-92.0,21.0,22.0,21.0,22.0,1
2199,CC:2F:71:3E:C5:1F,3853141,485931789,1044,127676,3852097,485804113,3,4553,379658,3795,289684,758,89974,1105,15,1498,31,3,54,144444.0,43333.0,-66.0,-67.0,-64.0,-60.0,-69.0,-71.0,-68.0,-60.0,-90.0,-92.0,-89.0,-92.0,24.0,25.0,25.0,32.0,1
2200,BA:8C:B9:54:50:24,3857075,492003313,4976,6198998,3852099,485804315,7,10106,1776070,10084,1772575,22,3495,2364,18,5513,44,7,79,216660.0,130000.0,-39.0,-36.0,-46.0,-51.0,-41.0,-35.0,-44.0,-49.0,-90.0,-92.0,-89.0,-92.0,51.0,56.0,43.0,41.0,1
2201,62:47:05:9D:EB:15,3862793,505802842,10693,19998254,3852100,485804588,1,9984,4510730,9921,4500999,63,9731,4869,0,10779,86,1,146,229410.0,137640.0,-54.0,-66.0,-58.0,-65.0,-55.0,-65.0,-60.0,-65.0,-90.0,-92.0,-89.0,-92.0,36.0,26.0,31.0,27.0,1
2202,92:69:1D:31:68:E9,3856328,489522412,4228,3717824,3852100,485804588,1,5842,1241495,5658,1199587,184,41908,2353,12,4507,104,1,66,229410.0,130000.0,-52.0,-47.0,-45.0,-47.0,-52.0,-47.0,-44.0,-47.0,-90.0,-92.0,-89.0,-92.0,38.0,45.0,44.0,45.0,1
2203,CC:2F:71:3F:1F:24,5227097,2084375366,1374997,1598570778,3852100,485804588,2222,1161268,1341038039,1160371,1340929251,897,108788,1124037,15,1373133,127522,2219,877,144444.0,43333.0,-73.0,-74.0,-72.0,-73.0,-71.0,-71.0,-69.0,-71.0,-90.0,-92.0,-89.0,-92.0,17.0,18.0,17.0,19.0,1
2204,CC:2F:71:3E:C5:1F,3853146,485932466,1044,127676,3852102,485804790,3,4553,379658,3795,289684,758,89974,1105,15,1498,31,3,54,144444.0,43333.0,-66.0,-67.0,-64.0,-60.0,-69.0,-71.0,-68.0,-60.0,-90.0,-92.0,-89.0,-92.0,24.0,25.0,25.0,32.0,1
2205,BA:8C:B9:54:50:24,3857078,492003788,4976,6198998,3852102,485804790,7,10106,1776070,10084,1772575,22,3495,2364,18,5513,44,7,79,216660.0,130000.0,-39.0,-36.0,-46.0,-51.0,-41.0,-35.0,-44.0,-49.0,-90.0,-92.0,-89.0,-92.0,51.0,56.0,43.0,41.0,1
2206,62:47:05:9D:EB:15,3862889,506065578,10782,20260324,3852107,485805254,1,9999,4512373,9936,4502642,63,9731,4878,0,10868,92,1,146,229410.0,137640.0,-54.0,-66.0,-58.0,-66.0,-56.0,-66.0,-59.0,-66.0,-90.0,-92.0,-89.0,-92.0,36.0,26.0,31.0,26.0,1
2207,92:69:1D:31:68:E9,3856337,489523280,4228,3717824,3852109,485805456,1,5842,1241495,5658,1199587,184,41908,2353,12,4507,104,1,66,229410.0,130000.0,-52.0,-47.0,-45.0,-47.0,-52.0,-47.0,-44.0,-47.0,-90.0,-92.0,-89.0,-92.0,38.0,45.0,44.0,45.0,1
2208,CC:2F:71:3F:1F:24,5227151,2084393604,1375042,1598588148,3852109,485805456,2222,1161293,1341042509,1160396,1340933721,897,108788,1124061,15,1373178,127557,2219,877,144444.0,43333.0,-70.0,-70.0,-68.0,-69.0,-70.0,-70.0,-68.0,-69.0,-90.0,-92.0,-89.0,-92.0,20.0,22.0,21.0,23.0,1
2209,CC:2F:71:3E:C5:1F,3853153,485933132,1044,127676,3852109,485805456,3,4553,379658,3795,289684,758,89974,1105,15,1498,31,3,54,144444.0,43333.0,-66.0,-67.0,-64.0,-60.0,-69.0,-71.0,-68.0,-60.0,-90.0,-92.0,-89.0,-92.0,24.0,25.0,25.0,32.0,1
2210,BA:8C:B9:54:50:24,3857085,492004454,4976,6198998,3852109,485805456,7,10106,1776070,10084,1772575,22,3495,2364,18,5513,44,7,79,216660.0,130000.0,-39.0,-36.0,-46.0,-51.0,-41.0,-35.0,-44.0,-49.0,-90.0,-92.0,-89.0,-92.0,51.0,56.0,43.0,41.0,1
2211,62:47:05:9D:EB:15,3862894,506066250,10783,20260592,3852111,485805658,1,10011,4513305,9948,4503574,63,9731,4880,0,10869,92,1,147,229410.0,137640.0,-55.0,-66.0,-57.0,-66.0,-57.0,-66.0,-60.0,-67.0,-90.0,-92.0,-89.0,-92.0,35.0,26.0,32.0,26.0,1
2212,92:69:1D:31:68:E9,3856339,489523482,4228,3717824,3852111,485805658,1,5842,1241495,5658,1199587,184,41908,2353,12,4507,104,1,66,229410.0,130000.0,-52.0,-47.0,-45.0,-47.0,-52.0,-47.0,-44.0,-47.0,-90.0,-92.0,-89.0,-92.0,38.0,45.0,44.0,45.0,1
2213,CC:2F:71:3F:1F:24,5227199,2084411306,1375088,1598605648,3852111,485805658,2222,1161319,1341047095,1160422,1340938307,897,108788,1124086,15,1373224,127581,2219,877,144444.0,43333.0,-70.0,-71.0,-69.0,-71.0,-70.0,-70.0,-68.0,-70.0,-90.0,-92.0,-89.0,-92.0,20.0,21.0,20.0,21.0,1
2214,CC:2F:71:3E:C5:1F,3853157,485933536,1044,127676,3852113,485805860,3,4553,379658,3795,289684,758,89974,1105,15,1498,31,3,54,144444.0,43333.0,-66.0,-67.0,-64.0,-60.0,-69.0,-71.0,-68.0,-60.0,-90.0,-92.0,-89.0,-92.0,24.0,25.0,25.0,32.0,1
2215,BA:8C:B9:54:50:24,3857091,492005060,4976,6198998,3852115,485806062,7,10106,1776070,10084,1772575,22,3495,2364,18,5513,44,7,79,216660.0,130000.0,-39.0,-36.0,-46.0,-51.0,-41.0,-35.0,-44.0,-49.0,-90.0,-92.0,-89.0,-92.0,51.0,56.0,43.0,41.0,1
2216,62:47:05:9D:EB:15,3862925,506125079,10808,20318815,3852117,485806264,1,10044,4518171,9981,4508440,63,9731,4887,0,10894,92,1,147,229410.0,137640.0,-54.0,-65.0,-57.0,-67.0,-54.0,-63.0,-58.0,-65.0,-90.0,-92.0,-89.0,-92.0,36.0,27.0,32.0,25.0,1
2217,92:69:1D:31:68:E9,3856345,489524088,4228,3717824,3852117,485806264,1,5842,1241495,5658,1199587,184,41908,2353,12,4507,104,1,66,229410.0,130000.0,-52.0,-47.0,-45.0,-47.0,-52.0,-47.0,-44.0,-47.0,-90.0,-92.0,-89.0,-92.0,38.0,45.0,44.0,45.0,1
2218,CC:2F:71:3F:1F:24,5227253,2084429972,1375135,1598623648,3852118,485806324,2222,1161346,1341051785,1160449,1340942997,897,108788,1124111,15,1373271,127614,2219,877,144444.0,43333.0,-70.0,-71.0,-69.0,-70.0,-70.0,-70.0,-68.0,-70.0,-90.0,-92.0,-89.0,-92.0,20.0,21.0,20.0,22.0,1
2219,CC:2F:71:3E:C5:1F,3853162,485934000,1044,127676,3852118,485806324,3,4553,379658,3795,289684,758,89974,1105,15,1498,31,3,54,144444.0,43333.0,-66.0,-67.0,-64.0,-60.0,-69.0,-71.0,-68.0,-60.0,-90.0,-92.0,-89.0,-92.0,24.0,25.0,25.0,32.0,1
2220,BA:8C:B9:54:50:24,3857094,492005322,4976,6198998,3852118,485806324,7,10106,1776070,10084,1772575,22,3495,2364,18,5513,44,7,79,216660.0,130000.0,-39.0,-36.0,-46.0,-51.0,-41.0,-35.0,-44.0,-49.0,-90.0,-92.0,-89.0,-92.0,51.0,56.0,43.0,41.0,1
2221,62:47:05:9D:EB:15,3863062,506499743,10940,20693021,3852122,485806722,1,10095,4523828,10032,4514097,63,9731,4907,0,11025,96,1,147,229410.0,137640.0,-57.0,-67.0,-62.0,-67.0,-57.0,-66.0,-62.0,-67.0,-90.0,-92.0,-89.0,-92.0,33.0,25.0,27.0,25.0,1
2222,92:69:1D:31:68:E9,3856351,489524614,4228,3717824,3852123,485806790,1,5842,1241495,5658,1199587,184,41908,2353,12,4507,104,1,66,229410.0,130000.0,-52.0,-47.0,-45.0,-47.0,-52.0,-47.0,-44.0,-47.0,-90.0,-92.0,-89.0,-92.0,38.0,45.0,44.0,45.0,1
2223,CC:2F:71:3F:1F:24,5227323,2084454635,1375198,1598647643,3852125,485806992,2222,1161390,1341059572,1160493,1340950784,897,108788,1124153,15,1373334,127660,2219,877,144444.0,43333.0,-74.0,-74.0,-72.0,-74.0,-73.0,-73.0,-71.0,-73.0,-90.0,-92.0,-89.0,-92.0,16.0,18.0,17.0,18.0,1
2224,CC:2F:71:3E:C5:1F,3853169,485934668,1044,127676,3852125,485806992,3,4555,379846,3796,289754,759,90092,1106,15,1498,31,3,54,144444.0,43333.0,-71.0,-73.0,-69.0,-60.0,-70.0,-71.0,-67.0,-60.0,-90.0,-92.0,-89.0,-92.0,19.0,19.0,20.0,32.0,1
2225,BA:8C:B9:54:50:24,3857101,492005990,4976,6198998,3852125,485806992,7,10106,1776070,10084,1772575,22,3495,2364,18,5513,44,7,79,216660.0,130000.0,-39.0,-36.0,-46.0,-51.0,-41.0,-35.0,-44.0,-49.0,-90.0,-92.0,-89.0,-92.0,51.0,56.0,43.0,41.0,1
2226,62:47:05:9D:EB:15,3863067,506500215,10940,20693021,3852127,485807194,1,10109,4524780,10046,4515049,63,9731,4907,0,11026,96,1,148,229410.0,137640.0,-54.0,-66.0,-61.0,-68.0,-53.0,-63.0,-59.0,-64.0,-90.0,-92.0,-89.0,-92.0,36.0,26.0,28.0,24.0,1
2227,92:69:1D:31:68:E9,3856355,489525018,4228,3717824,3852127,485807194,1,5842,1241495,5658,1199587,184,41908,2353,12,4507,104,1,66,229410.0,130000.0,-52.0,-47.0,-45.0,-47.0,-52.0,-47.0,-44.0,-47.0,-90.0,-92.0,-89.0,-92.0,38.0,45.0,44.0,45.0,1
2228,CC:2F:71:3F:1F:24,5227371,2084472337,1375244,1598665143,3852127,485807194,2222,1161415,1341064042,1160518,1340955254,897,108788,1124177,15,1373380,127688,2219,877,144444.0,43333.0,-73.0,-74.0,-71.0,-74.0,-73.0,-73.0,-71.0,-73.0,-90.0,-92.0,-89.0,-92.0,17.0,18.0,18.0,18.0,1
2229,CC:2F:71:3E:C5:1F,3853172,485934948,1044,127676,3852128,485807272,3,4555,379846,3796,289754,759,90092,1106,15,1498,31,3,54,144444.0,43333.0,-71.0,-73.0,-69.0,-60.0,-70.0,-71.0,-67.0,-60.0,-90.0,-92.0,-89.0,-92.0,19.0,19.0,20.0,32.0,1
2230,BA:8C:B9:54:50:24,3857104,492006270,4976,6198998,3852128,485807272,7,10106,1776070,10084,1772575,22,3495,2364,18,5513,44,7,79,216660.0,130000.0,-39.0,-36.0,-46.0,-51.0,-41.0,-35.0,-44.0,-49.0,-90.0,-92.0,-89.0,-92.0,51.0,56.0,43.0,41.0,1
2231,62:47:05:9D:EB:15,3863613,508109031,11478,22301093,3852135,485807938,1,10163,4531203,10100,4521472,63,9731,4944,0,11564,139,1,150,229410.0,137640.0,-55.0,-65.0,-58.0,-66.0,-56.0,-65.0,-59.0,-67.0,-90.0,-92.0,-89.0,-92.0,35.0,27.0,31.0,26.0,1
2232,92:69:1D:31:68:E9,3856363,489525762,4228,3717824,3852135,485807938,1,5842,1241495,5658,1199587,184,41908,2353,12,4507,104,1,66,229410.0,130000.0,-52.0,-47.0,-45.0,-47.0,-52.0,-47.0,-44.0,-47.0,-90.0,-92.0,-89.0,-92.0,38.0,45.0,44.0,45.0,1
2233,CC:2F:71:3F:1F:24,5227425,2084490581,1375290,1598682643,3852135,485807938,2222,1161441,1341068628,1160544,1340959840,897,108788,1124202,15,1373426,127714,2219,877,144444.0,43333.0,-70.0,-70.0,-68.0,-70.0,-69.0,-69.0,-68.0,-70.0,-90.0,-92.0,-89.0,-92.0,20.0,22.0,21.0,22.0,1
2234,CC:2F:71:3E:C5:1F,3853179,485935614,1044,127676,3852135,485807938,3,4555,379846,3796,289754,759,90092,1106,15,1498,31,3,54,144444.0,43333.0,-71.0,-73.0,-69.0,-60.0,-70.0,-71.0,-67.0,-60.0,-90.0,-92.0,-89.0,-92.0,19.0,19.0,20.0,32.0,1
2235,BA:8C:B9:54:50:24,3857111,492006936,4976,6198998,3852135,485807938,7,10106,1776070,10084,1772575,22,3495,2364,18,5513,44,7,79,216660.0,130000.0,-39.0,-36.0,-46.0,-51.0,-41.0,-35.0,-44.0,-49.0,-90.0,-92.0,-89.0,-92.0,51.0,56.0,43.0,41.0,1
2236,62:47:05:9D:EB:15,3863629,508141700,11492,22333560,3852137,485808140,1,10172,4532243,10109,4522512,63,9731,4948,0,11578,139,1,150,229410.0,137640.0,-55.0,-64.0,-56.0,-68.0,-56.0,-66.0,-60.0,-68.0,-90.0,-92.0,-89.0,-92.0,35.0,28.0,33.0,24.0,1
2237,92:69:1D:31:68:E9,3856365,489525964,4228,3717824,3852137,485808140,1,5842,1241495,5658,1199587,184,41908,2353,12,4507,104,1,66,229410.0,130000.0,-52.0,-47.0,-45.0,-47.0,-52.0,-47.0,-44.0,-47.0,-90.0,-92.0,-89.0,-92.0,38.0,45.0,44.0,45.0,1
2238,CC:2F:71:3F:1F:24,5227471,2084508023,1375334,1598699883,3852137,485808140,2222,1161466,1341073098,1160569,1340964310,897,108788,1124226,15,1373470,127736,2219,877,144444.0,43333.0,-74.0,-74.0,-72.0,-73.0,-71.0,-72.0,-70.0,-72.0,-90.0,-92.0,-89.0,-92.0,16.0,18.0,17.0,19.0,1
2239,CC:2F:71:3E:C5:1F,3853181,485935816,1044,127676,3852137,485808140,3,4555,379846,3796,289754,759,90092,1106,15,1498,31,3,54,144444.0,43333.0,-71.0,-73.0,-69.0,-60.0,-70.0,-71.0,-67.0,-60.0,-90.0,-92.0,-89.0,-92.0,19.0,19.0,20.0,32.0,1
2240,BA:8C:B9:54:50:24,3857113,492007138,4976,6198998,3852137,485808140,7,10106,1776070,10084,1772575,22,3495,2364,18,5513,44,7,79,216660.0,130000.0,-39.0,-36.0,-46.0,-51.0,-41.0,-35.0,-44.0,-49.0,-90.0,-92.0,-89.0,-92.0,51.0,56.0,43.0,41.0,1
2241,62:47:05:9D:EB:15,3865967,515131747,13823,29322941,3852144,485808806,1,10587,4583591,10524,4573860,63,9731,5217,0,13909,211,1,152,229410.0,137640.0,-57.0,-65.0,-61.0,-68.0,-57.0,-64.0,-60.0,-67.0,-90.0,-92.0,-89.0,-92.0,33.0,27.0,28.0,24.0,1
2242,92:69:1D:31:68:E9,3856372,489526630,4228,3717824,3852144,485808806,1,5842,1241495,5658,1199587,184,41908,2353,12,4507,104,1,66,229410.0,130000.0,-52.0,-47.0,-45.0,-47.0,-52.0,-47.0,-44.0,-47.0,-90.0,-92.0,-89.0,-92.0,38.0,45.0,44.0,45.0,1
2243,CC:2F:71:3F:1F:24,5227529,2084529416,1375385,1598720610,3852144,485808806,2222,1161502,1341079335,1160605,1340970547,897,108788,1124261,15,1373521,127753,2219,877,144444.0,43333.0,-70.0,-70.0,-68.0,-70.0,-70.0,-70.0,-68.0,-70.0,-90.0,-92.0,-89.0,-92.0,20.0,22.0,21.0,22.0,1
2244,CC:2F:71:3E:C5:1F,3853188,485936482,1044,127676,3852144,485808806,3,4555,379846,3796,289754,759,90092,1106,15,1498,31,3,54,144444.0,43333.0,-71.0,-73.0,-69.0,-60.0,-70.0,-71.0,-67.0,-60.0,-90.0,-92.0,-89.0,-92.0,19.0,19.0,20.0,32.0,1
2245,BA:8C:B9:54:50:24,3857120,492007804,4976,6198998,3852144,485808806,7,10106,1776070,10084,1772575,22,3495,2364,18,5513,44,7,79,216660.0,130000.0,-39.0,-36.0,-46.0,-51.0,-41.0,-35.0,-44.0,-49.0,-90.0,-92.0,-89.0,-92.0,51.0,56.0,43.0,41.0,1
2246,62:47:05:9D:EB:15,3865969,515131949,13823,29322941,3852146,485809008,1,10588,4583659,10525,4573928,63,9731,5217,0,13909,211,1,152,229410.0,137640.0,-54.0,-65.0,-57.0,-68.0,-56.0,-64.0,-60.0,-67.0,-90.0,-93.0,-90.0,-93.0,36.0,28.0,33.0,25.0,1
2247,92:69:1D:31:68:E9,3856374,489526832,4228,3717824,3852146,485809008,1,5842,1241495,5658,1199587,184,41908,2353,12,4507,104,1,66,229410.0,130000.0,-52.0,-47.0,-45.0,-47.0,-52.0,-47.0,-44.0,-47.0,-90.0,-93.0,-90.0,-93.0,38.0,46.0,45.0,46.0,1
2248,CC:2F:71:3F:1F:24,5227577,2084547118,1375431,1598738110,3852146,485809008,2222,1161527,1341083805,1160630,1340975017,897,108788,1124285,15,1373567,127784,2219,877,144444.0,43333.0,-70.0,-71.0,-69.0,-71.0,-70.0,-70.0,-68.0,-70.0,-90.0,-93.0,-90.0,-93.0,20.0,22.0,21.0,22.0,1
2249,CC:2F:71:3E:C5:1F,3853190,485936684,1044,127676,3852146,485809008,3,4555,379846,3796,289754,759,90092,1106,15,1498,31,3,54,144444.0,43333.0,-71.0,-73.0,-69.0,-60.0,-70.0,-71.0,-67.0,-60.0,-90.0,-93.0,-90.0,-93.0,19.0,20.0,21.0,33.0,1
2250,BA:8C:B9:54:50:24,3857122,492008006,4976,6198998,3852146,485809008,7,10106,1776070,10084,1772575,22,3495,2364,18,5513,44,7,79,216660.0,130000.0,-39.0,-36.0,-46.0,-51.0,-41.0,-35.0,-44.0,-49.0,-90.0,-93.0,-90.0,-93.0,51.0,57.0,44.0,42.0,1
2251,62:47:05:9D:EB:15,3865975,515132555,13823,29322941,3852152,485809614,1,10588,4583659,10525,4573928,63,9731,5217,0,13909,211,1,152,229410.0,137640.0,-54.0,-65.0,-57.0,-68.0,-56.0,-64.0,-60.0,-67.0,-90.0,-93.0,-90.0,-93.0,36.0,28.0,33.0,25.0,1
2252,92:69:1D:31:68:E9,3856380,489527438,4228,3717824,3852152,485809614,1,5844,1241631,5660,1199723,184,41908,2353,12,4508,104,1,66,229410.0,130000.0,-51.0,-47.0,-45.0,-49.0,-52.0,-47.0,-44.0,-47.0,-90.0,-93.0,-90.0,-93.0,39.0,46.0,45.0,44.0,1
2253,CC:2F:71:3F:1F:24,5227627,2084564964,1375475,1598755350,3852152,485809614,2222,1161552,1341088275,1160655,1340979487,897,108788,1124309,15,1373611,127805,2219,877,144444.0,43333.0,-70.0,-70.0,-69.0,-69.0,-70.0,-71.0,-69.0,-70.0,-90.0,-93.0,-90.0,-93.0,20.0,23.0,21.0,24.0,1
2254,CC:2F:71:3E:C5:1F,3853196,485937290,1044,127676,3852152,485809614,3,4557,379986,3798,289894,759,90092,1106,15,1499,31,3,54,144444.0,43333.0,-71.0,-73.0,-70.0,-60.0,-70.0,-71.0,-68.0,-60.0,-90.0,-93.0,-90.0,-93.0,19.0,20.0,20.0,33.0,1
2255,BA:8C:B9:54:50:24,3857130,492008814,4976,6198998,3852154,485809816,7,10108,1776206,10086,1772711,22,3495,2364,18,5514,44,7,79,216660.0,130000.0,-48.0,-35.0,-43.0,-45.0,-42.0,-35.0,-44.0,-48.0,-90.0,-93.0,-90.0,-93.0,42.0,58.0,47.0,48.0,1
2256,62:47:05:9D:EB:15,3866086,515433786,13931,29623910,3852155,485809876,1,10647,4590707,10584,4580976,63,9731,5237,0,14017,211,1,152,229410.0,137640.0,-54.0,-68.0,-57.0,-67.0,-55.0,-67.0,-59.0,-67.0,-90.0,-93.0,-90.0,-93.0,36.0,25.0,33.0,26.0,1
2257,92:69:1D:31:68:E9,3856383,489527700,4228,3717824,3852155,485809876,1,5844,1241631,5660,1199723,184,41908,2353,12,4508,104,1,66,229410.0,130000.0,-51.0,-47.0,-45.0,-49.0,-52.0,-47.0,-44.0,-47.0,-90.0,-93.0,-90.0,-93.0,39.0,46.0,45.0,44.0,1
2258,CC:2F:71:3F:1F:24,5227675,2084582596,1375520,1598772720,3852155,485809876,2222,1161577,1341092745,1160680,1340983957,897,108788,1124333,15,1373656,127827,2219,877,144444.0,43333.0,-69.0,-69.0,-70.0,-68.0,-69.0,-69.0,-69.0,-68.0,-90.0,-93.0,-90.0,-93.0,21.0,24.0,20.0,25.0,1
2259,CC:2F:71:3E:C5:1F,3853199,485937552,1044,127676,3852155,485809876,3,4557,379986,3798,289894,759,90092,1106,15,1499,31,3,54,144444.0,43333.0,-71.0,-73.0,-70.0,-60.0,-70.0,-71.0,-68.0,-60.0,-90.0,-93.0,-90.0,-93.0,19.0,20.0,20.0,33.0,1
2260,BA:8C:B9:54:50:24,3857131,492008874,4976,6198998,3852155,485809876,7,10108,1776206,10086,1772711,22,3495,2364,18,5514,44,7,79,216660.0,130000.0,-48.0,-35.0,-43.0,-45.0,-42.0,-35.0,-44.0,-48.0,-90.0,-93.0,-90.0,-93.0,42.0,58.0,47.0,48.0,1
2261,62:47:05:9D:EB:15,3866093,515434665,13931,29623910,3852162,485810755,1,10647,4590707,10584,4580976,63,9731,5237,0,14017,211,1,152,229410.0,137640.0,-54.0,-68.0,-57.0,-67.0,-55.0,-67.0,-59.0,-67.0,-90.0,-93.0,-90.0,-93.0,36.0,25.0,33.0,26.0,1
2262,92:69:1D:31:68:E9,3856390,489528579,4228,3717824,3852162,485810755,1,5844,1241631,5660,1199723,184,41908,2353,12,4508,104,1,66,229410.0,130000.0,-51.0,-47.0,-45.0,-49.0,-52.0,-47.0,-44.0,-47.0,-90.0,-93.0,-90.0,-93.0,39.0,46.0,45.0,44.0,1
2263,CC:2F:71:3F:1F:24,5227735,2084604388,1375571,1598793431,3852164,485810957,2222,1161610,1341098634,1160713,1340989846,897,108788,1124365,15,1373707,127851,2219,877,144444.0,43333.0,-73.0,-73.0,-72.0,-72.0,-71.0,-71.0,-70.0,-71.0,-90.0,-93.0,-90.0,-93.0,17.0,20.0,18.0,21.0,1
2264,CC:2F:71:3E:C5:1F,3853208,485938633,1044,127676,3852164,485810957,3,4557,379986,3798,289894,759,90092,1106,15,1499,31,3,54,144444.0,43333.0,-71.0,-73.0,-70.0,-60.0,-70.0,-71.0,-68.0,-60.0,-90.0,-93.0,-90.0,-93.0,19.0,20.0,20.0,33.0,1
2265,BA:8C:B9:54:50:24,3857140,492009955,4976,6198998,3852164,485810957,7,10108,1776206,10086,1772711,22,3495,2364,18,5514,44,7,79,216660.0,130000.0,-48.0,-35.0,-43.0,-45.0,-42.0,-35.0,-44.0,-48.0,-90.0,-93.0,-90.0,-93.0,42.0,58.0,47.0,48.0,1
2266,62:47:05:9D:EB:15,3866245,515762531,14080,29951514,3852165,485811017,1,10758,4611788,10695,4602057,63,9731,5302,0,14166,244,1,152,206470.0,103230.0,-58.0,-69.0,-64.0,-68.0,-58.0,-69.0,-64.0,-67.0,-90.0,-93.0,-90.0,-93.0,32.0,24.0,26.0,25.0,1
2267,92:69:1D:31:68:E9,3856393,489528841,4228,3717824,3852165,485811017,1,5844,1241631,5660,1199723,184,41908,2353,12,4508,104,1,66,229410.0,130000.0,-51.0,-47.0,-45.0,-49.0,-52.0,-47.0,-44.0,-47.0,-90.0,-93.0,-90.0,-93.0,39.0,46.0,45.0,44.0,1
2268,CC:2F:71:3F:1F:24,5227782,2084621964,1375617,1598810947,3852165,485811017,2222,1161636,1341103362,1160739,1340994574,897,108788,1124389,15,1373753,127875,2219,877,144444.0,43333.0,-70.0,-70.0,-69.0,-70.0,-69.0,-69.0,-68.0,-69.0,-90.0,-93.0,-90.0,-93.0,20.0,23.0,21.0,23.0,1
2269,CC:2F:71:3E:C5:1F,3853209,485938693,1044,127676,3852165,485811017,3,4557,379986,3798,289894,759,90092,1106,15,1499,31,3,54,144444.0,43333.0,-71.0,-73.0,-70.0,-60.0,-70.0,-71.0,-68.0,-60.0,-90.0,-93.0,-90.0,-93.0,19.0,20.0,20.0,33.0,1
2270,BA:8C:B9:54:50:24,3857145,492010419,4976,6198998,3852169,485811421,7,10108,1776206,10086,1772711,22,3495,2364,18,5514,44,7,79,216660.0,130000.0,-48.0,-35.0,-43.0,-45.0,-42.0,-35.0,-44.0,-48.0,-90.0,-93.0,-90.0,-93.0,42.0,58.0,47.0,48.0,1
2271,62:47:05:9D:EB:15,3866278,515788736,14107,29977113,3852171,485811623,1,10810,4620794,10747,4611063,63,9731,5325,0,14193,257,1,153,206470.0,103230.0,-57.0,-63.0,-62.0,-63.0,-57.0,-63.0,-61.0,-64.0,-90.0,-93.0,-90.0,-93.0,33.0,30.0,28.0,30.0,1
2272,92:69:1D:31:68:E9,3856401,489529649,4228,3717824,3852173,485811825,1,5844,1241631,5660,1199723,184,41908,2353,12,4508,104,1,66,229410.0,130000.0,-51.0,-47.0,-45.0,-49.0,-52.0,-47.0,-44.0,-47.0,-90.0,-93.0,-90.0,-93.0,39.0,46.0,45.0,44.0,1
2273,CC:2F:71:3F:1F:24,5227835,2084640158,1375662,1598828333,3852173,485811825,2222,1161661,1341107832,1160764,1340999044,897,108788,1124413,15,1373798,127906,2219,877,144444.0,43333.0,-70.0,-70.0,-68.0,-69.0,-69.0,-70.0,-67.0,-69.0,-90.0,-93.0,-90.0,-93.0,20.0,23.0,22.0,24.0,1
2274,CC:2F:71:3E:C5:1F,3853217,485939501,1044,127676,3852173,485811825,3,4557,379986,3798,289894,759,90092,1106,15,1499,31,3,54,144444.0,43333.0,-71.0,-73.0,-70.0,-60.0,-70.0,-71.0,-68.0,-60.0,-90.0,-93.0,-90.0,-93.0,19.0,20.0,20.0,33.0,1
2275,BA:8C:B9:54:50:24,3857149,492010823,4976,6198998,3852173,485811825,7,10108,1776206,10086,1772711,22,3495,2364,18,5514,44,7,79,216660.0,130000.0,-48.0,-35.0,-43.0,-45.0,-42.0,-35.0,-44.0,-48.0,-90.0,-93.0,-90.0,-93.0,42.0,58.0,47.0,48.0,1
2276,62:47:05:9D:EB:15,3866312,515855884,14138,30043948,3852174,485811936,1,10869,4631304,10805,4621402,64,9902,5346,0,14224,257,1,154,195000.0,97500.0,-58.0,-62.0,-58.0,-68.0,-58.0,-60.0,-54.0,-66.0,-90.0,-93.0,-90.0,-93.0,32.0,31.0,32.0,25.0,1
2277,92:69:1D:31:68:E9,3856404,489529962,4228,3717824,3852176,485812138,1,5844,1241631,5660,1199723,184,41908,2353,12,4508,104,1,66,229410.0,130000.0,-51.0,-47.0,-45.0,-49.0,-52.0,-47.0,-44.0,-47.0,-90.0,-93.0,-90.0,-93.0,39.0,46.0,45.0,44.0,1
2278,CC:2F:71:3F:1F:24,5227889,2084659211,1375711,1598846871,3852178,485812340,2222,1161691,1341113374,1160794,1341004586,897,108788,1124442,15,1373847,127927,2219,877,144444.0,43333.0,-70.0,-66.0,-68.0,-72.0,-69.0,-66.0,-68.0,-71.0,-90.0,-93.0,-90.0,-93.0,20.0,27.0,22.0,21.0,1
2279,CC:2F:71:3E:C5:1F,3853222,485940016,1044,127676,3852178,485812340,3,4557,379986,3798,289894,759,90092,1106,15,1499,31,3,54,144444.0,43333.0,-71.0,-73.0,-70.0,-60.0,-70.0,-71.0,-68.0,-60.0,-90.0,-93.0,-90.0,-93.0,19.0,20.0,20.0,33.0,1
2280,BA:8C:B9:54:50:24,3857157,492011600,4976,6198998,3852181,485812602,7,10108,1776206,10086,1772711,22,3495,2364,18,5514,44,7,79,216660.0,130000.0,-48.0,-35.0,-43.0,-45.0,-42.0,-35.0,-44.0,-48.0,-90.0,-93.0,-90.0,-93.0,42.0,58.0,47.0,48.0,1
2281,62:47:05:9D:EB:15,3866390,515880724,14207,30067920,3852183,485812804,1,10990,4682077,10926,4672175,64,9902,5410,0,14293,257,1,154,216660.0,130000.0,-58.0,-63.0,-59.0,-69.0,-58.0,-62.0,-58.0,-68.0,-90.0,-93.0,-90.0,-93.0,32.0,30.0,31.0,24.0,1
2282,92:69:1D:31:68:E9,3856411,489530628,4228,3717824,3852183,485812804,1,5844,1241631,5660,1199723,184,41908,2353,12,4508,104,1,66,229410.0,130000.0,-51.0,-47.0,-45.0,-49.0,-52.0,-47.0,-44.0,-47.0,-90.0,-93.0,-90.0,-93.0,39.0,46.0,45.0,44.0,1
2283,CC:2F:71:3F:1F:24,5227943,2084679486,1375760,1598866682,3852183,485812804,2222,1161719,1341118220,1160822,1341009432,897,108788,1124469,15,1373896,127934,2219,878,130000.0,39000.0,-71.0,-68.0,-67.0,-72.0,-70.0,-68.0,-67.0,-72.0,-90.0,-93.0,-90.0,-93.0,19.0,25.0,23.0,21.0,1
2284,CC:2F:71:3E:C5:1F,3853227,485940480,1044,127676,3852183,485812804,3,4557,379986,3798,289894,759,90092,1106,15,1499,31,3,54,144444.0,43333.0,-71.0,-73.0,-70.0,-60.0,-70.0,-71.0,-68.0,-60.0,-90.0,-93.0,-90.0,-93.0,19.0,20.0,20.0,33.0,1
2285,BA:8C:B9:54:50:24,3857159,492011802,4976,6198998,3852183,485812804,7,10108,1776206,10086,1772711,22,3495,2364,18,5514,44,7,79,216660.0,130000.0,-48.0,-35.0,-43.0,-45.0,-42.0,-35.0,-44.0,-48.0,-90.0,-93.0,-90.0,-93.0,42.0,58.0,47.0,48.0,1
2286,62:47:05:9D:EB:15,3866432,515893416,14245,30080208,3852187,485813208,1,11064,4708459,11000,4698557,64,9902,5445,0,14331,257,1,154,229410.0,137640.0,-56.0,-59.0,-55.0,-66.0,-55.0,-59.0,-55.0,-65.0,-90.0,-93.0,-90.0,-93.0,34.0,34.0,35.0,27.0,1
2287,92:69:1D:31:68:E9,3856415,489531032,4228,3717824,3852187,485813208,1,5844,1241631,5660,1199723,184,41908,2353,12,4508,104,1,66,229410.0,130000.0,-51.0,-47.0,-45.0,-49.0,-52.0,-47.0,-44.0,-47.0,-90.0,-93.0,-90.0,-93.0,39.0,46.0,45.0,44.0,1
2288,CC:2F:71:3F:1F:24,5227993,2084697294,1375806,1598884086,3852187,485813208,2222,1161745,1341122806,1160848,1341014018,897,108788,1124494,15,1373942,127952,2219,878,144444.0,43333.0,-70.0,-68.0,-67.0,-72.0,-70.0,-68.0,-67.0,-72.0,-90.0,-93.0,-90.0,-93.0,20.0,25.0,23.0,21.0,1
2289,CC:2F:71:3E:C5:1F,3853233,485941086,1044,127676,3852189,485813410,3,4557,379986,3798,289894,759,90092,1106,15,1499,31,3,54,144444.0,43333.0,-71.0,-73.0,-70.0,-60.0,-70.0,-71.0,-68.0,-60.0,-90.0,-93.0,-90.0,-93.0,19.0,20.0,20.0,33.0,1
2290,BA:8C:B9:54:50:24,3857165,492012408,4976,6198998,3852189,485813410,7,10108,1776206,10086,1772711,22,3495,2364,18,5514,44,7,79,216660.0,130000.0,-48.0,-35.0,-43.0,-45.0,-42.0,-35.0,-44.0,-48.0,-90.0,-93.0,-90.0,-93.0,42.0,58.0,47.0,48.0,1
2291,62:47:05:9D:EB:15,3866438,515893940,14245,30080208,3852193,485813732,1,11065,4708527,11001,4698625,64,9902,5445,0,14331,257,1,154,229410.0,137640.0,-57.0,-60.0,-54.0,-73.0,-55.0,-59.0,-54.0,-66.0,-90.0,-93.0,-90.0,-93.0,33.0,33.0,36.0,20.0,1
2292,92:69:1D:31:68:E9,3856421,489531556,4228,3717824,3852193,485813732,1,5845,1241699,5661,1199791,184,41908,2353,12,4508,104,1,66,229410.0,130000.0,-51.0,-47.0,-44.0,-47.0,-51.0,-47.0,-44.0,-47.0,-90.0,-93.0,-90.0,-93.0,39.0,46.0,46.0,46.0,1
2293,CC:2F:71:3F:1F:24,5228047,2084715594,1375854,1598901862,3852193,485813732,2222,1161772,1341127506,1160874,1341018604,898,108902,1124520,15,1373990,127972,2219,878,144444.0,43333.0,-70.0,-68.0,-67.0,-72.0,-70.0,-68.0,-67.0,-72.0,-90.0,-93.0,-90.0,-93.0,20.0,25.0,23.0,21.0,1
2294,CC:2F:71:3E:C5:1F,3853238,485941494,1044,127676,3852194,485813818,3,4557,379986,3798,289894,759,90092,1106,15,1499,31,3,54,144444.0,43333.0,-71.0,-73.0,-70.0,-60.0,-70.0,-71.0,-68.0,-60.0,-90.0,-93.0,-90.0,-93.0,19.0,20.0,20.0,33.0,1
2295,BA:8C:B9:54:50:24,3857170,492012816,4976,6198998,3852194,485813818,7,10108,1776206,10086,1772711,22,3495,2364,18,5514,44,7,79,216660.0,130000.0,-48.0,-35.0,-43.0,-45.0,-42.0,-35.0,-44.0,-48.0,-90.0,-93.0,-90.0,-93.0,42.0,58.0,47.0,48.0,1
2296,62:47:05:9D:EB:15,3866448,515895098,14248,30080676,3852200,485814422,1,11085,4710173,11021,4700271,64,9902,5449,0,14334,257,1,154,229410.0,137640.0,-59.0,-64.0,-61.0,-70.0,-56.0,-61.0,-56.0,-67.0,-90.0,-93.0,-90.0,-93.0,31.0,29.0,29.0,23.0,1
2297,92:69:1D:31:68:E9,3856430,489532448,4228,3717824,3852202,485814624,1,5845,1241699,5661,1199791,184,41908,2353,12,4508,104,1,66,229410.0,130000.0,-51.0,-47.0,-44.0,-47.0,-51.0,-47.0,-44.0,-47.0,-90.0,-93.0,-90.0,-93.0,39.0,46.0,46.0,46.0,1
2298,CC:2F:71:3F:1F:24,5228106,2084734530,1375904,1598919906,3852202,485814624,2222,1161803,1341133269,1160902,1341023913,901,109356,1124550,15,1374039,127989,2219,878,144444.0,43333.0,-71.0,-68.0,-67.0,-72.0,-70.0,-68.0,-67.0,-72.0,-90.0,-93.0,-90.0,-93.0,19.0,25.0,23.0,21.0,1
2299,CC:2F:71:3E:C5:1F,3853246,485942300,1044,127676,3852202,485814624,3,4557,379986,3798,289894,759,90092,1106,15,1499,31,3,54,144444.0,43333.0,-71.0,-73.0,-70.0,-60.0,-70.0,-71.0,-68.0,-60.0,-90.0,-93.0,-90.0,-93.0,19.0,20.0,20.0,33.0,1
2300,BA:8C:B9:54:50:24,3857178,492013622,4976,6198998,3852202,485814624,7,10108,1776206,10086,1772711,22,3495,2364,18,5514,44,7,79,216660.0,130000.0,-48.0,-35.0,-43.0,-45.0,-42.0,-35.0,-44.0,-48.0,-90.0,-93.0,-90.0,-93.0,42.0,58.0,47.0,48.0,1
2301,62:47:05:9D:EB:15,3866459,515901716,14255,30086890,3852204,485814826,1,11131,4715633,11067,4705731,64,9902,5460,0,14341,257,1,154,229410.0,137640.0,-57.0,-60.0,-54.0,-72.0,-58.0,-64.0,-59.0,-70.0,-90.0,-93.0,-90.0,-93.0,33.0,33.0,36.0,21.0,1
2302,92:69:1D:31:68:E9,3856433,489532710,4228,3717824,3852205,485814886,1,5845,1241699,5661,1199791,184,41908,2353,12,4508,104,1,66,229410.0,130000.0,-51.0,-47.0,-44.0,-47.0,-51.0,-47.0,-44.0,-47.0,-90.0,-93.0,-90.0,-93.0,39.0,46.0,46.0,46.0,1
2303,CC:2F:71:3F:1F:24,5228160,2084755511,1375955,1598940625,3852205,485814886,2222,1161834,1341138435,1160933,1341029079,901,109356,1124580,15,1374091,127999,2219,878,144444.0,43333.0,-71.0,-68.0,-67.0,-72.0,-70.0,-68.0,-67.0,-72.0,-90.0,-93.0,-90.0,-93.0,19.0,25.0,23.0,21.0,1
2304,CC:2F:71:3E:C5:1F,3853249,485942562,1044,127676,3852205,485814886,3,4557,379986,3798,289894,759,90092,1106,15,1499,31,3,54,144444.0,43333.0,-71.0,-73.0,-70.0,-60.0,-70.0,-71.0,-68.0,-60.0,-90.0,-93.0,-90.0,-93.0,19.0,20.0,20.0,33.0,1
2305,BA:8C:B9:54:50:24,3857181,492013884,4976,6198998,3852205,485814886,7,10108,1776206,10086,1772711,22,3495,2364,18,5514,44,7,79,216660.0,130000.0,-48.0,-35.0,-43.0,-45.0,-42.0,-35.0,-44.0,-48.0,-90.0,-93.0,-90.0,-93.0,42.0,58.0,47.0,48.0,1
2306,62:47:05:9D:EB:15,3866474,515905069,14263,30089577,3852211,485815492,1,11141,4718478,11077,4708576,64,9902,5469,0,14349,257,1,154,229410.0,137640.0,-59.0,-64.0,-59.0,-69.0,-58.0,-63.0,-58.0,-69.0,-90.0,-93.0,-90.0,-93.0,31.0,29.0,31.0,24.0,1
2307,92:69:1D:31:68:E9,3856440,489533432,4229,3717940,3852211,485815492,1,5847,1241835,5663,1199927,184,41908,2353,12,4509,104,1,66,229410.0,130000.0,-51.0,-47.0,-44.0,-47.0,-51.0,-47.0,-43.0,-47.0,-90.0,-93.0,-90.0,-93.0,39.0,46.0,46.0,46.0,1
2308,CC:2F:71:3F:1F:24,5228212,2084773635,1376001,1598958143,3852211,485815492,2222,1161860,1341142975,1160959,1341033619,901,109356,1124604,15,1374137,128013,2219,878,144444.0,43333.0,-71.0,-68.0,-68.0,-72.0,-70.0,-68.0,-67.0,-72.0,-90.0,-93.0,-90.0,-93.0,19.0,25.0,22.0,21.0,1
2309,CC:2F:71:3E:C5:1F,3853256,485943228,1045,127736,3852211,485815492,3,4559,380126,3800,290034,759,90092,1106,15,1500,31,3,54,130000.0,39000.0,-73.0,-72.0,-68.0,-60.0,-69.0,-70.0,-67.0,-60.0,-90.0,-93.0,-90.0,-93.0,17.0,21.0,22.0,33.0,1
2310,BA:8C:B9:54:50:24,3857188,492014606,4977,6199114,3852211,485815492,7,10114,1776614,10092,1773119,22,3495,2364,18,5515,44,7,79,216660.0,130000.0,-48.0,-35.0,-42.0,-45.0,-43.0,-34.0,-42.0,-46.0,-90.0,-93.0,-90.0,-93.0,42.0,58.0,48.0,48.0,1
2311,62:47:05:9D:EB:15,3866478,515905639,14265,30089945,3852213,485815694,1,11181,4721502,11117,4711600,64,9902,5473,0,14351,257,1,155,229410.0,137640.0,-59.0,-64.0,-59.0,-70.0,-59.0,-64.0,-59.0,-70.0,-90.0,-93.0,-90.0,-93.0,31.0,29.0,31.0,23.0,1
2312,92:69:1D:31:68:E9,3856442,489533634,4229,3717940,3852213,485815694,1,5847,1241835,5663,1199927,184,41908,2353,12,4509,104,1,66,229410.0,130000.0,-51.0,-47.0,-44.0,-47.0,-51.0,-47.0,-43.0,-47.0,-90.0,-93.0,-90.0,-93.0,39.0,46.0,46.0,46.0,1
2313,CC:2F:71:3F:1F:24,5228259,2084791223,1376046,1598975529,3852213,485815694,2222,1161885,1341147445,1160984,1341038089,901,109356,1124628,15,1374182,128019,2219,878,144444.0,43333.0,-70.0,-68.0,-67.0,-72.0,-70.0,-68.0,-67.0,-72.0,-90.0,-93.0,-90.0,-93.0,20.0,25.0,23.0,21.0,1
2314,CC:2F:71:3E:C5:1F,3853258,485943430,1045,127736,3852213,485815694,3,4559,380126,3800,290034,759,90092,1106,15,1500,31,3,54,130000.0,39000.0,-73.0,-72.0,-68.0,-60.0,-69.0,-70.0,-67.0,-60.0,-90.0,-93.0,-90.0,-93.0,17.0,21.0,22.0,33.0,1
2315,BA:8C:B9:54:50:24,3857190,492014808,4977,6199114,3852213,485815694,7,10114,1776614,10092,1773119,22,3495,2364,18,5515,44,7,79,216660.0,130000.0,-48.0,-35.0,-42.0,-45.0,-43.0,-34.0,-42.0,-46.0,-90.0,-93.0,-90.0,-93.0,42.0,58.0,48.0,48.0,1
2316,62:47:05:9D:EB:15,3866486,515906367,14265,30089945,3852221,485816422,1,11184,4721706,11120,4711804,64,9902,5473,0,14351,257,1,155,229410.0,137640.0,-57.0,-60.0,-54.0,-72.0,-58.0,-63.0,-58.0,-70.0,-90.0,-93.0,-90.0,-93.0,33.0,33.0,36.0,21.0,1
2317,92:69:1D:31:68:E9,3856450,489534362,4229,3717940,3852221,485816422,1,5847,1241835,5663,1199927,184,41908,2353,12,4509,104,1,66,229410.0,130000.0,-51.0,-47.0,-44.0,-47.0,-51.0,-47.0,-43.0,-47.0,-90.0,-93.0,-90.0,-93.0,39.0,46.0,46.0,46.0,1
2318,CC:2F:71:3F:1F:24,5228321,2084813070,1376100,1598996648,3852221,485816422,2222,1161921,1341153696,1161020,1341044340,901,109356,1124662,15,1374236,128035,2219,878,144444.0,43333.0,-70.0,-68.0,-67.0,-72.0,-70.0,-68.0,-67.0,-72.0,-90.0,-93.0,-90.0,-93.0,20.0,25.0,23.0,21.0,1
2319,CC:2F:71:3E:C5:1F,3853267,485944284,1045,127736,3852222,485816548,3,4561,380314,3801,290104,760,90210,1107,15,1500,31,3,54,130000.0,39000.0,-72.0,-71.0,-68.0,-60.0,-71.0,-71.0,-68.0,-60.0,-90.0,-93.0,-90.0,-93.0,18.0,22.0,22.0,33.0,1
2320,BA:8C:B9:54:50:24,3857199,492015662,4977,6199114,3852222,485816548,7,10114,1776614,10092,1773119,22,3495,2364,18,5515,44,7,79,216660.0,130000.0,-48.0,-35.0,-42.0,-45.0,-43.0,-34.0,-42.0,-46.0,-90.0,-93.0,-90.0,-93.0,42.0,58.0,48.0,48.0,1
2321,62:47:05:9D:EB:15,3866489,515906695,14265,30089945,3852224,485816750,1,11186,4722227,11122,4712325,64,9902,5474,0,14351,257,1,155,229410.0,137640.0,-57.0,-62.0,-58.0,-68.0,-58.0,-63.0,-58.0,-70.0,-90.0,-93.0,-90.0,-93.0,33.0,31.0,32.0,25.0,1
2322,92:69:1D:31:68:E9,3856453,489534690,4229,3717940,3852224,485816750,1,5847,1241835,5663,1199927,184,41908,2353,12,4509,104,1,66,229410.0,130000.0,-51.0,-47.0,-44.0,-47.0,-51.0,-47.0,-43.0,-47.0,-90.0,-93.0,-90.0,-93.0,39.0,46.0,46.0,46.0,1
2323,CC:2F:71:3F:1F:24,5228370,2084831073,1376145,1599014050,3852225,485817023,2222,1161950,1341158720,1161049,1341049364,901,109356,1124687,15,1374281,128054,2219,878,144444.0,43333.0,-71.0,-68.0,-67.0,-72.0,-70.0,-68.0,-67.0,-71.0,-90.0,-93.0,-90.0,-93.0,19.0,25.0,23.0,21.0,1
2324,CC:2F:71:3E:C5:1F,3853270,485944759,1045,127736,3852225,485817023,3,4561,380314,3801,290104,760,90210,1107,15,1500,31,3,54,130000.0,39000.0,-72.0,-71.0,-68.0,-60.0,-71.0,-71.0,-68.0,-60.0,-90.0,-93.0,-90.0,-93.0,18.0,22.0,22.0,33.0,1
2325,BA:8C:B9:54:50:24,3857204,492016339,4977,6199114,3852227,485817225,7,10114,1776614,10092,1773119,22,3495,2364,18,5515,44,7,79,216660.0,130000.0,-48.0,-35.0,-42.0,-45.0,-43.0,-34.0,-42.0,-46.0,-90.0,-93.0,-90.0,-93.0,42.0,58.0,48.0,48.0,1
2326,62:47:05:9D:EB:15,3866501,515913004,14268,30095253,3852233,485817751,1,11209,4723961,11144,4713937,65,10024,5476,0,14354,257,1,155,229410.0,137640.0,-60.0,-64.0,-60.0,-69.0,-59.0,-64.0,-60.0,-69.0,-90.0,-93.0,-90.0,-93.0,30.0,29.0,30.0,24.0,1
2327,92:69:1D:31:68:E9,3856462,489535691,4229,3717940,3852233,485817751,1,5847,1241835,5663,1199927,184,41908,2353,12,4509,104,1,66,229410.0,130000.0,-51.0,-47.0,-44.0,-47.0,-51.0,-47.0,-43.0,-47.0,-90.0,-93.0,-90.0,-93.0,39.0,46.0,46.0,46.0,1
2328,CC:2F:71:3F:1F:24,5228425,2084849447,1376192,1599031696,3852233,485817751,2222,1161975,1341163190,1161074,1341053834,901,109356,1124711,15,1374328,128062,2219,878,144444.0,43333.0,-71.0,-68.0,-66.0,-71.0,-70.0,-68.0,-66.0,-71.0,-90.0,-93.0,-90.0,-93.0,19.0,25.0,24.0,22.0,1
2329,CC:2F:71:3E:C5:1F,3853280,485945689,1045,127736,3852235,485817953,3,4561,380314,3801,290104,760,90210,1107,15,1500,31,3,54,130000.0,39000.0,-72.0,-71.0,-68.0,-60.0,-71.0,-71.0,-68.0,-60.0,-90.0,-93.0,-90.0,-93.0,18.0,22.0,22.0,33.0,1
2330,BA:8C:B9:54:50:24,3857212,492017067,4977,6199114,3852235,485817953,7,10114,1776614,10092,1773119,22,3495,2364,18,5515,44,7,79,216660.0,130000.0,-48.0,-35.0,-42.0,-45.0,-43.0,-34.0,-42.0,-46.0,-90.0,-93.0,-90.0,-93.0,42.0,58.0,48.0,48.0,1
2331,62:47:05:9D:EB:15,3866509,515913948,14270,30095591,3852239,485818357,1,11215,4724679,11150,4714655,65,10024,5478,0,14356,257,1,155,229410.0,137640.0,-58.0,-63.0,-60.0,-68.0,-58.0,-63.0,-58.0,-68.0,-90.0,-93.0,-90.0,-93.0,32.0,30.0,30.0,25.0,1
2332,92:69:1D:31:68:E9,3856468,489536297,4229,3717940,3852239,485818357,1,5847,1241835,5663,1199927,184,41908,2353,12,4509,104,1,66,229410.0,130000.0,-51.0,-47.0,-44.0,-47.0,-51.0,-47.0,-43.0,-47.0,-90.0,-93.0,-90.0,-93.0,39.0,46.0,46.0,46.0,1
2333,CC:2F:71:3F:1F:24,5228481,2084868031,1376240,1599049472,3852241,485818559,2222,1162002,1341167892,1161101,1341058536,901,109356,1124737,15,1374376,128066,2219,878,144444.0,43333.0,-70.0,-66.0,-67.0,-70.0,-70.0,-66.0,-67.0,-69.0,-90.0,-93.0,-90.0,-93.0,20.0,27.0,23.0,23.0,1
2334,CC:2F:71:3E:C5:1F,3853286,485946295,1045,127736,3852241,485818559,3,4561,380314,3801,290104,760,90210,1107,15,1500,31,3,54,130000.0,39000.0,-72.0,-71.0,-68.0,-60.0,-71.0,-71.0,-68.0,-60.0,-90.0,-93.0,-90.0,-93.0,18.0,22.0,22.0,33.0,1
2335,BA:8C:B9:54:50:24,3857218,492017673,4977,6199114,3852241,485818559,7,10114,1776614,10092,1773119,22,3495,2364,18,5515,44,7,79,216660.0,130000.0,-48.0,-35.0,-42.0,-45.0,-43.0,-34.0,-42.0,-46.0,-90.0,-93.0,-90.0,-93.0,42.0,58.0,48.0,48.0,1
2336,62:47:05:9D:EB:15,3866515,515914720,14270,30095591,3852245,485819129,1,11223,4725391,11158,4715367,65,10024,5480,0,14356,257,1,155,229410.0,137640.0,-56.0,-61.0,-72.0,-68.0,-58.0,-62.0,-61.0,-66.0,-90.0,-93.0,-89.0,-92.0,34.0,32.0,17.0,24.0,1
2337,92:69:1D:31:68:E9,3856474,489537069,4229,3717940,3852245,485819129,1,5847,1241835,5663,1199927,184,41908,2353,12,4509,104,1,66,229410.0,130000.0,-51.0,-47.0,-44.0,-47.0,-51.0,-47.0,-43.0,-47.0,-90.0,-93.0,-89.0,-92.0,39.0,46.0,45.0,45.0,1
2338,CC:2F:71:3F:1F:24,5228539,2084889704,1376294,1599070575,3852245,485819129,2222,1162040,1341175485,1161139,1341066129,901,109356,1124770,15,1374430,128085,2219,878,144444.0,43333.0,-68.0,-69.0,-68.0,-70.0,-68.0,-69.0,-68.0,-70.0,-90.0,-93.0,-89.0,-92.0,22.0,24.0,21.0,22.0,1
2339,CC:2F:71:3E:C5:1F,3853291,485946925,1045,127736,3852246,485819189,3,4561,380314,3801,290104,760,90210,1107,15,1500,31,3,54,130000.0,39000.0,-72.0,-71.0,-68.0,-60.0,-71.0,-71.0,-68.0,-60.0,-90.0,-93.0,-89.0,-92.0,18.0,22.0,21.0,32.0,1
2340,BA:8C:B9:54:50:24,3857223,492018303,4977,6199114,3852246,485819189,7,10114,1776614,10092,1773119,22,3495,2364,18,5515,44,7,79,216660.0,130000.0,-48.0,-35.0,-42.0,-45.0,-43.0,-34.0,-42.0,-46.0,-90.0,-93.0,-89.0,-92.0,42.0,58.0,47.0,47.0,1
2341,62:47:05:9D:EB:15,3866559,515956995,14309,30137402,3852250,485819593,1,11306,4744064,11241,4734040,65,10024,5525,0,14395,257,1,155,229410.0,137640.0,-54.0,-62.0,-61.0,-62.0,-53.0,-62.0,-59.0,-61.0,-90.0,-92.0,-89.0,-92.0,36.0,30.0,28.0,30.0,1
2342,92:69:1D:31:68:E9,3856481,489537735,4229,3717940,3852252,485819795,1,5847,1241835,5663,1199927,184,41908,2353,12,4509,104,1,66,229410.0,130000.0,-51.0,-47.0,-44.0,-47.0,-51.0,-47.0,-43.0,-47.0,-90.0,-92.0,-89.0,-92.0,39.0,45.0,45.0,45.0,1
2343,CC:2F:71:3F:1F:24,5228592,2084907886,1376340,1599088091,3852252,485819795,2222,1162067,1341180187,1161166,1341070831,901,109356,1124796,15,1374476,128112,2219,878,144444.0,43333.0,-69.0,-70.0,-67.0,-70.0,-69.0,-70.0,-67.0,-69.0,-90.0,-92.0,-89.0,-92.0,21.0,22.0,22.0,22.0,1
2344,CC:2F:71:3E:C5:1F,3853297,485947531,1045,127736,3852252,485819795,3,4561,380314,3801,290104,760,90210,1107,15,1500,31,3,54,130000.0,39000.0,-72.0,-71.0,-68.0,-60.0,-71.0,-71.0,-68.0,-60.0,-90.0,-92.0,-89.0,-92.0,18.0,21.0,21.0,32.0,1
2345,BA:8C:B9:54:50:24,3857229,492018909,4977,6199114,3852252,485819795,7,10114,1776614,10092,1773119,22,3495,2364,18,5515,44,7,79,216660.0,130000.0,-48.0,-35.0,-42.0,-45.0,-43.0,-34.0,-42.0,-46.0,-90.0,-92.0,-89.0,-92.0,42.0,57.0,47.0,47.0,1
2346,62:47:05:9D:EB:15,3866610,516061222,14356,30241225,3852254,485819997,1,11370,4754605,11305,4744581,65,10024,5562,0,14442,257,1,155,229410.0,137640.0,-53.0,-66.0,-61.0,-64.0,-53.0,-65.0,-60.0,-64.0,-90.0,-92.0,-89.0,-92.0,37.0,26.0,28.0,28.0,1
2347,92:69:1D:31:68:E9,3856483,489537937,4229,3717940,3852254,485819997,1,5847,1241835,5663,1199927,184,41908,2353,12,4509,104,1,66,229410.0,130000.0,-51.0,-47.0,-44.0,-47.0,-51.0,-47.0,-43.0,-47.0,-90.0,-92.0,-89.0,-92.0,39.0,45.0,45.0,45.0,1
2348,CC:2F:71:3F:1F:24,5228641,2084925718,1376387,1599105721,3852254,485819997,2222,1162097,1341185237,1161196,1341075881,901,109356,1124825,15,1374523,128148,2219,878,144444.0,43333.0,-69.0,-69.0,-68.0,-69.0,-69.0,-69.0,-67.0,-69.0,-90.0,-92.0,-89.0,-92.0,21.0,23.0,21.0,23.0,1
2349,CC:2F:71:3E:C5:1F,3853299,485947733,1045,127736,3852254,485819997,3,4561,380314,3801,290104,760,90210,1107,15,1500,31,3,54,130000.0,39000.0,-72.0,-71.0,-68.0,-60.0,-71.0,-71.0,-68.0,-60.0,-90.0,-92.0,-89.0,-92.0,18.0,21.0,21.0,32.0,1
2350,BA:8C:B9:54:50:24,3857231,492019111,4977,6199114,3852254,485819997,7,10114,1776614,10092,1773119,22,3495,2364,18,5515,44,7,79,216660.0,130000.0,-48.0,-35.0,-42.0,-45.0,-43.0,-34.0,-42.0,-46.0,-90.0,-92.0,-89.0,-92.0,42.0,57.0,47.0,47.0,1
2351,62:47:05:9D:EB:15,3866619,516062548,14358,30241885,3852261,485820663,1,11384,4756290,11319,4746266,65,10024,5564,0,14444,257,1,155,229410.0,137640.0,-55.0,-66.0,-60.0,-63.0,-55.0,-65.0,-60.0,-63.0,-90.0,-92.0,-89.0,-92.0,35.0,26.0,29.0,29.0,1
2352,92:69:1D:31:68:E9,3856490,489538603,4229,3717940,3852261,485820663,1,5847,1241835,5663,1199927,184,41908,2353,12,4509,104,1,66,229410.0,130000.0,-51.0,-47.0,-44.0,-47.0,-51.0,-47.0,-43.0,-47.0,-90.0,-92.0,-89.0,-92.0,39.0,45.0,45.0,45.0,1
2353,CC:2F:71:3F:1F:24,5228702,2084947487,1376441,1599126824,3852261,485820663,2222,1162133,1341191692,1161232,1341082336,901,109356,1124857,15,1374577,128199,2219,878,144444.0,43333.0,-70.0,-70.0,-68.0,-70.0,-70.0,-70.0,-68.0,-70.0,-90.0,-92.0,-89.0,-92.0,20.0,22.0,21.0,22.0,1
2354,CC:2F:71:3E:C5:1F,3853306,485948399,1045,127736,3852261,485820663,3,4561,380314,3801,290104,760,90210,1107,15,1500,31,3,54,130000.0,39000.0,-72.0,-71.0,-68.0,-60.0,-71.0,-71.0,-68.0,-60.0,-90.0,-92.0,-89.0,-92.0,18.0,21.0,21.0,32.0,1
2355,BA:8C:B9:54:50:24,3857238,492019777,4977,6199114,3852261,485820663,7,10114,1776614,10092,1773119,22,3495,2364,18,5515,44,7,79,216660.0,130000.0,-48.0,-35.0,-42.0,-45.0,-43.0,-34.0,-42.0,-46.0,-90.0,-92.0,-89.0,-92.0,42.0,57.0,47.0,47.0,1
2356,62:47:05:9D:EB:15,3866657,516161393,14394,30340528,3852263,485820865,1,11424,4760353,11359,4750329,65,10024,5576,0,14480,257,1,155,229410.0,137640.0,-52.0,-66.0,-58.0,-62.0,-53.0,-65.0,-59.0,-62.0,-90.0,-92.0,-88.0,-91.0,38.0,26.0,30.0,29.0,1
2357,92:69:1D:31:68:E9,3856492,489538805,4229,3717940,3852263,485820865,1,5847,1241835,5663,1199927,184,41908,2353,12,4509,104,1,66,229410.0,130000.0,-51.0,-47.0,-44.0,-47.0,-51.0,-47.0,-43.0,-47.0,-90.0,-92.0,-88.0,-91.0,39.0,45.0,44.0,44.0,1
2358,CC:2F:71:3F:1F:24,5228750,2084965189,1376487,1599144324,3852263,485820865,2222,1162159,1341196278,1161258,1341086922,901,109356,1124882,15,1374623,128242,2219,878,144444.0,43333.0,-69.0,-70.0,-68.0,-70.0,-69.0,-69.0,-68.0,-69.0,-90.0,-92.0,-88.0,-91.0,21.0,22.0,20.0,21.0,1
2359,CC:2F:71:3E:C5:1F,3853308,485948601,1045,127736,3852263,485820865,3,4561,380314,3801,290104,760,90210,1107,15,1500,31,3,54,130000.0,39000.0,-72.0,-71.0,-68.0,-60.0,-71.0,-71.0,-68.0,-60.0,-90.0,-92.0,-88.0,-91.0,18.0,21.0,20.0,31.0,1
2360,BA:8C:B9:54:50:24,3857240,492019979,4977,6199114,3852263,485820865,7,10114,1776614,10092,1773119,22,3495,2364,18,5515,44,7,79,216660.0,130000.0,-48.0,-35.0,-42.0,-45.0,-43.0,-34.0,-42.0,-46.0,-90.0,-92.0,-88.0,-91.0,42.0,57.0,46.0,46.0,1
2361,62:47:05:9D:EB:15,3866664,516162519,14396,30341188,3852268,485821331,1,11458,4763654,11393,4753630,65,10024,5582,0,14482,257,1,155,229410.0,137640.0,-57.0,-68.0,-62.0,-65.0,-55.0,-67.0,-60.0,-64.0,-90.0,-92.0,-88.0,-91.0,33.0,24.0,26.0,26.0,1
2362,92:69:1D:31:68:E9,3856499,489539473,4229,3717940,3852270,485821533,1,5847,1241835,5663,1199927,184,41908,2353,12,4509,104,1,66,229410.0,130000.0,-51.0,-47.0,-44.0,-47.0,-51.0,-47.0,-43.0,-47.0,-90.0,-92.0,-88.0,-91.0,39.0,45.0,44.0,44.0,1
2363,CC:2F:71:3F:1F:24,5228804,2084983503,1376534,1599161970,3852270,485821533,2222,1162192,1341202010,1161290,1341092536,902,109474,1124908,15,1374670,128284,2219,878,144444.0,43333.0,-70.0,-70.0,-67.0,-69.0,-70.0,-70.0,-67.0,-69.0,-90.0,-92.0,-88.0,-91.0,20.0,22.0,21.0,22.0,1
2364,CC:2F:71:3E:C5:1F,3853316,485949329,1045,127736,3852271,485821593,3,4561,380314,3801,290104,760,90210,1107,15,1500,31,3,54,130000.0,39000.0,-72.0,-71.0,-68.0,-60.0,-71.0,-71.0,-68.0,-60.0,-90.0,-92.0,-88.0,-91.0,18.0,21.0,20.0,31.0,1
2365,BA:8C:B9:54:50:24,3857248,492020707,4977,6199114,3852271,485821593,7,10114,1776614,10092,1773119,22,3495,2364,18,5515,44,7,79,216660.0,130000.0,-48.0,-35.0,-42.0,-45.0,-43.0,-34.0,-42.0,-46.0,-90.0,-92.0,-88.0,-91.0,42.0,57.0,46.0,46.0,1
2366,62:47:05:9D:EB:15,3866699,516243082,14426,30421287,3852273,485821795,1,11496,4767257,11431,4757233,65,10024,5592,0,14512,257,1,158,229410.0,137640.0,-55.0,-69.0,-58.0,-63.0,-57.0,-71.0,-60.0,-66.0,-90.0,-92.0,-88.0,-91.0,35.0,23.0,30.0,28.0,1
2367,92:69:1D:31:68:E9,3856502,489539735,4229,3717940,3852273,485821795,1,5847,1241835,5663,1199927,184,41908,2353,12,4509,104,1,66,229410.0,130000.0,-51.0,-47.0,-44.0,-47.0,-51.0,-47.0,-43.0,-47.0,-90.0,-92.0,-88.0,-91.0,39.0,45.0,44.0,44.0,1
2368,CC:2F:71:3F:1F:24,5228854,2085001395,1376581,1599179600,3852273,485821795,2222,1162219,1341206916,1161317,1341097442,902,109474,1124932,15,1374717,128322,2219,878,144444.0,43333.0,-70.0,-70.0,-68.0,-70.0,-70.0,-70.0,-68.0,-69.0,-90.0,-92.0,-88.0,-91.0,20.0,22.0,20.0,21.0,1
2369,CC:2F:71:3E:C5:1F,3853318,485949531,1045,127736,3852273,485821795,3,4561,380314,3801,290104,760,90210,1107,15,1500,31,3,54,130000.0,39000.0,-72.0,-71.0,-68.0,-60.0,-71.0,-71.0,-68.0,-60.0,-90.0,-92.0,-88.0,-91.0,18.0,21.0,20.0,31.0,1
2370,BA:8C:B9:54:50:24,3857250,492020909,4977,6199114,3852273,485821795,7,10114,1776614,10092,1773119,22,3495,2364,18,5515,44,7,79,216660.0,130000.0,-48.0,-35.0,-42.0,-45.0,-43.0,-34.0,-42.0,-46.0,-90.0,-92.0,-88.0,-91.0,42.0,57.0,46.0,46.0,1
2371,62:47:05:9D:EB:15,3866705,516243688,14426,30421287,3852279,485822401,1,11509,4768217,11444,4758193,65,10024,5593,0,14512,257,1,158,229410.0,137640.0,-54.0,-70.0,-60.0,-64.0,-57.0,-70.0,-62.0,-65.0,-90.0,-92.0,-88.0,-91.0,36.0,22.0,28.0,27.0,1
2372,92:69:1D:31:68:E9,3856508,489540341,4229,3717940,3852279,485822401,1,5847,1241835,5663,1199927,184,41908,2353,12,4509,104,1,66,229410.0,130000.0,-51.0,-47.0,-44.0,-47.0,-51.0,-47.0,-43.0,-47.0,-90.0,-91.0,-88.0,-90.0,39.0,44.0,44.0,43.0,1
2373,CC:2F:71:3F:1F:24,5228913,2085022974,1376634,1599200573,3852279,485822401,2222,1162253,1341212943,1161351,1341103469,902,109474,1124964,15,1374770,128363,2219,878,144444.0,43333.0,-70.0,-70.0,-68.0,-70.0,-70.0,-70.0,-68.0,-69.0,-90.0,-91.0,-88.0,-90.0,20.0,21.0,20.0,20.0,1
2374,CC:2F:71:3E:C5:1F,3853324,485950137,1045,127736,3852279,485822401,3,4562,380384,3802,290174,760,90210,1107,15,1501,31,3,54,130000.0,39000.0,-73.0,-73.0,-68.0,-60.0,-71.0,-71.0,-68.0,-60.0,-90.0,-91.0,-88.0,-90.0,17.0,18.0,20.0,30.0,1
2375,BA:8C:B9:54:50:24,3857256,492021515,4977,6199114,3852279,485822401,7,10116,1776750,10094,1773255,22,3495,2364,18,5516,44,7,79,216660.0,130000.0,-48.0,-35.0,-42.0,-45.0,-43.0,-34.0,-42.0,-46.0,-90.0,-91.0,-88.0,-90.0,42.0,56.0,46.0,45.0,1
2376,62:47:05:9D:EB:15,3866710,516244630,14428,30421967,3852282,485822663,1,11522,4770142,11457,4760118,65,10024,5595,0,14514,257,1,159,229410.0,137640.0,-54.0,-67.0,-58.0,-66.0,-57.0,-70.0,-62.0,-69.0,-90.0,-91.0,-88.0,-90.0,36.0,24.0,30.0,24.0,1
2377,92:69:1D:31:68:E9,3856511,489540603,4229,3717940,3852282,485822663,1,5849,1241971,5665,1200063,184,41908,2353,12,4510,104,1,66,229410.0,130000.0,-51.0,-47.0,-44.0,-47.0,-51.0,-47.0,-43.0,-47.0,-90.0,-91.0,-88.0,-90.0,39.0,44.0,44.0,43.0,1
2378,CC:2F:71:3F:1F:24,5228962,2085040720,1376680,1599218057,3852282,485822663,2222,1162281,1341217761,1161379,1341108287,902,109474,1124991,15,1374816,128395,2219,878,144444.0,43333.0,-70.0,-70.0,-68.0,-70.0,-70.0,-69.0,-68.0,-70.0,-90.0,-91.0,-88.0,-90.0,20.0,21.0,20.0,20.0,1
2379,CC:2F:71:3E:C5:1F,3853329,485950601,1045,127736,3852284,485822865,3,4563,380454,3803,290244,760,90210,1107,15,1501,31,3,54,130000.0,39000.0,-73.0,-73.0,-68.0,-60.0,-71.0,-71.0,-68.0,-60.0,-90.0,-91.0,-88.0,-90.0,17.0,18.0,20.0,30.0,1
2380,BA:8C:B9:54:50:24,3857261,492021979,4977,6199114,3852284,485822865,7,10117,1776818,10095,1773323,22,3495,2364,18,5516,44,7,79,216660.0,130000.0,-39.0,-36.0,-45.0,-51.0,-42.0,-34.0,-42.0,-47.0,-90.0,-91.0,-88.0,-90.0,51.0,55.0,43.0,39.0,1
2381,62:47:05:9D:EB:15,3866754,516346612,14466,30523343,3852288,485823269,1,11548,4773523,11483,4763499,65,10024,5608,0,14552,257,1,159,229410.0,137640.0,-58.0,-68.0,-62.0,-67.0,-56.0,-67.0,-61.0,-67.0,-90.0,-91.0,-88.0,-90.0,32.0,23.0,26.0,23.0,1
2382,92:69:1D:31:68:E9,3856517,489541209,4229,3717940,3852288,485823269,1,5849,1241971,5665,1200063,184,41908,2353,12,4510,104,1,66,229410.0,130000.0,-51.0,-47.0,-44.0,-47.0,-51.0,-47.0,-43.0,-47.0,-90.0,-91.0,-88.0,-90.0,39.0,44.0,44.0,43.0,1
2383,CC:2F:71:3F:1F:24,5229015,2085058860,1376727,1599235591,3852288,485823269,2222,1162313,1341223323,1161411,1341113849,902,109474,1125018,15,1374863,128425,2219,878,144444.0,39000.0,-70.0,-70.0,-68.0,-70.0,-70.0,-69.0,-67.0,-69.0,-90.0,-91.0,-88.0,-90.0,20.0,21.0,20.0,20.0,1
2384,CC:2F:71:3E:C5:1F,3853333,485951005,1045,127736,3852288,485823269,3,4563,380454,3803,290244,760,90210,1107,15,1501,31,3,54,130000.0,39000.0,-73.0,-73.0,-68.0,-60.0,-71.0,-71.0,-68.0,-60.0,-90.0,-91.0,-88.0,-90.0,17.0,18.0,20.0,30.0,1
2385,BA:8C:B9:54:50:24,3857265,492022383,4977,6199114,3852288,485823269,7,10117,1776818,10095,1773323,22,3495,2364,18,5516,44,7,79,216660.0,130000.0,-39.0,-36.0,-45.0,-51.0,-42.0,-34.0,-42.0,-47.0,-90.0,-91.0,-88.0,-90.0,51.0,55.0,43.0,39.0,1
2386,62:47:05:9D:EB:15,3866757,516347087,14466,30523343,3852291,485823744,1,11549,4773591,11484,4763567,65,10024,5608,0,14552,257,1,159,229410.0,137640.0,-54.0,-68.0,-58.0,-66.0,-56.0,-67.0,-60.0,-66.0,-90.0,-91.0,-87.0,-90.0,36.0,23.0,29.0,24.0,1
2387,92:69:1D:31:68:E9,3856520,489541684,4229,3717940,3852291,485823744,1,5849,1241971,5665,1200063,184,41908,2353,12,4510,104,1,66,229410.0,130000.0,-51.0,-47.0,-44.0,-47.0,-51.0,-47.0,-43.0,-47.0,-90.0,-91.0,-87.0,-90.0,39.0,44.0,43.0,43.0,1
2388,CC:2F:71:3F:1F:24,5229068,2085077171,1376774,1599253165,3852294,485824006,2222,1162343,1341228497,1161441,1341119023,902,109474,1125045,15,1374910,128461,2219,878,144444.0,43333.0,-70.0,-70.0,-68.0,-70.0,-69.0,-69.0,-68.0,-69.0,-90.0,-91.0,-87.0,-90.0,20.0,21.0,19.0,20.0,1
2389,CC:2F:71:3E:C5:1F,3853339,485951742,1045,127736,3852294,485824006,3,4563,380454,3803,290244,760,90210,1107,15,1501,31,3,54,130000.0,39000.0,-73.0,-73.0,-68.0,-60.0,-71.0,-71.0,-68.0,-60.0,-90.0,-91.0,-87.0,-90.0,17.0,18.0,19.0,30.0,1
2390,BA:8C:B9:54:50:24,3857273,492023322,4977,6199114,3852296,485824208,7,10117,1776818,10095,1773323,22,3495,2364,18,5516,44,7,79,216660.0,130000.0,-39.0,-36.0,-45.0,-51.0,-42.0,-34.0,-42.0,-47.0,-90.0,-91.0,-87.0,-90.0,51.0,55.0,42.0,39.0,1
2391,62:47:05:9D:EB:15,3866801,516445596,14503,30621186,3852298,485824410,1,11584,4777570,11519,4767546,65,10024,5621,0,14589,277,1,163,216660.0,130000.0,-54.0,-68.0,-57.0,-67.0,-54.0,-66.0,-59.0,-65.0,-90.0,-91.0,-87.0,-90.0,36.0,23.0,30.0,23.0,1
2392,92:69:1D:31:68:E9,3856527,489542350,4229,3717940,3852298,485824410,1,5849,1241971,5665,1200063,184,41908,2353,12,4510,104,1,66,229410.0,130000.0,-51.0,-47.0,-44.0,-47.0,-51.0,-47.0,-43.0,-47.0,-90.0,-91.0,-87.0,-90.0,39.0,44.0,43.0,43.0,1
2393,CC:2F:71:3F:1F:24,5229128,2085098938,1376830,1599274528,3852298,485824410,2222,1162378,1341234679,1161476,1341125205,902,109474,1125078,15,1374966,128504,2219,878,144444.0,43333.0,-71.0,-70.0,-69.0,-70.0,-70.0,-70.0,-69.0,-70.0,-90.0,-91.0,-87.0,-90.0,19.0,21.0,18.0,20.0,1
2394,CC:2F:71:3E:C5:1F,3853343,485952146,1045,127736,3852298,485824410,3,4563,380454,3803,290244,760,90210,1107,15,1501,31,3,54,130000.0,39000.0,-73.0,-73.0,-68.0,-60.0,-71.0,-71.0,-68.0,-60.0,-90.0,-91.0,-87.0,-90.0,17.0,18.0,19.0,30.0,1
2395,BA:8C:B9:54:50:24,3857277,492023726,4977,6199114,3852300,485824612,7,10117,1776818,10095,1773323,22,3495,2364,18,5516,44,7,79,216660.0,130000.0,-39.0,-36.0,-45.0,-51.0,-42.0,-34.0,-42.0,-47.0,-90.0,-91.0,-87.0,-90.0,51.0,55.0,42.0,39.0,1
2396,62:47:05:9D:EB:15,3866806,516446508,14504,30621694,3852302,485824814,1,11587,4778704,11522,4768680,65,10024,5623,0,14590,277,1,163,216660.0,130000.0,-41.0,-46.0,-48.0,-50.0,-49.0,-59.0,-55.0,-59.0,-90.0,-91.0,-87.0,-90.0,49.0,45.0,39.0,40.0,1
2397,92:69:1D:31:68:E9,3856531,489542754,4229,3717940,3852302,485824814,1,5849,1241971,5665,1200063,184,41908,2353,12,4510,104,1,66,229410.0,130000.0,-51.0,-47.0,-44.0,-47.0,-51.0,-47.0,-43.0,-47.0,-89.0,-90.0,-87.0,-90.0,38.0,43.0,43.0,43.0,1
2398,CC:2F:71:3F:1F:24,5229181,2085117229,1376878,1599292304,3852303,485824925,2222,1162405,1341239395,1161503,1341129921,902,109474,1125103,15,1375014,128531,2219,878,144444.0,43333.0,-70.0,-70.0,-69.0,-70.0,-70.0,-70.0,-69.0,-69.0,-89.0,-90.0,-87.0,-90.0,19.0,20.0,18.0,20.0,1
2399,CC:2F:71:3E:C5:1F,3853350,485952863,1045,127736,3852305,485825127,3,4563,380454,3803,290244,760,90210,1107,15,1501,31,3,54,130000.0,39000.0,-73.0,-73.0,-68.0,-60.0,-71.0,-71.0,-68.0,-60.0,-89.0,-90.0,-87.0,-90.0,16.0,17.0,19.0,30.0,1
2400,BA:8C:B9:54:50:24,3857282,492024241,4977,6199114,3852305,485825127,7,10117,1776818,10095,1773323,22,3495,2364,18,5516,44,7,79,216660.0,130000.0,-39.0,-36.0,-45.0,-51.0,-42.0,-34.0,-42.0,-47.0,-89.0,-90.0,-87.0,-90.0,50.0,54.0,42.0,39.0,1
2401,62:47:05:9D:EB:15,3866816,516448492,14508,30623103,3852308,485825389,1,11638,4784129,11572,4773934,66,10195,5629,0,14594,277,1,163,216660.0,130000.0,-45.0,-46.0,-45.0,-49.0,-45.0,-45.0,-45.0,-48.0,-89.0,-90.0,-87.0,-90.0,44.0,44.0,42.0,41.0,1
2402,92:69:1D:31:68:E9,3856537,489543329,4229,3717940,3852308,485825389,1,5849,1241971,5665,1200063,184,41908,2353,12,4510,104,1,66,229410.0,130000.0,-51.0,-47.0,-44.0,-47.0,-51.0,-47.0,-43.0,-47.0,-89.0,-90.0,-87.0,-90.0,38.0,43.0,43.0,43.0,1
2403,CC:2F:71:3F:1F:24,5229233,2085135323,1376925,1599309934,3852308,485825389,2222,1162434,1341244329,1161532,1341134855,902,109474,1125131,15,1375061,128551,2219,878,144444.0,43333.0,-71.0,-69.0,-69.0,-70.0,-70.0,-69.0,-68.0,-70.0,-89.0,-90.0,-87.0,-90.0,18.0,21.0,18.0,20.0,1
2404,CC:2F:71:3E:C5:1F,3853355,485953327,1045,127736,3852310,485825591,3,4563,380454,3803,290244,760,90210,1107,15,1501,31,3,54,130000.0,39000.0,-73.0,-73.0,-68.0,-60.0,-71.0,-71.0,-68.0,-60.0,-89.0,-90.0,-87.0,-90.0,16.0,17.0,19.0,30.0,1
2405,BA:8C:B9:54:50:24,3857287,492024705,4977,6199114,3852310,485825591,7,10117,1776818,10095,1773323,22,3495,2364,18,5516,44,7,79,216660.0,130000.0,-39.0,-36.0,-45.0,-51.0,-42.0,-34.0,-42.0,-47.0,-89.0,-90.0,-86.0,-89.0,50.0,54.0,41.0,38.0,1
2406,62:47:05:9D:EB:15,3866845,516458214,14533,30632421,3852312,485825793,1,11729,4807821,11663,4797626,66,10195,5665,0,14619,277,1,163,229410.0,137640.0,-47.0,-48.0,-51.0,-50.0,-47.0,-48.0,-50.0,-50.0,-89.0,-90.0,-86.0,-89.0,42.0,42.0,35.0,39.0,1
2407,92:69:1D:31:68:E9,3856543,489543935,4229,3717940,3852314,485825995,1,5849,1241971,5665,1200063,184,41908,2353,12,4510,104,1,66,229410.0,130000.0,-51.0,-47.0,-44.0,-47.0,-51.0,-47.0,-43.0,-47.0,-89.0,-90.0,-86.0,-89.0,38.0,43.0,42.0,42.0,1
2408,CC:2F:71:3F:1F:24,5229286,2085153559,1376972,1599327564,3852314,485825995,2222,1162460,1341248915,1161558,1341139441,902,109474,1125156,15,1375108,128579,2219,878,144444.0,43333.0,-71.0,-69.0,-69.0,-70.0,-70.0,-69.0,-68.0,-70.0,-89.0,-90.0,-86.0,-89.0,18.0,21.0,17.0,19.0,1
2409,CC:2F:71:3E:C5:1F,3853359,485953731,1045,127736,3852314,485825995,3,4563,380454,3803,290244,760,90210,1107,15,1501,31,3,54,130000.0,39000.0,-73.0,-73.0,-68.0,-60.0,-71.0,-71.0,-68.0,-60.0,-89.0,-90.0,-86.0,-89.0,16.0,17.0,18.0,29.0,1
2410,BA:8C:B9:54:50:24,3857291,492025109,4977,6199114,3852314,485825995,7,10117,1776818,10095,1773323,22,3495,2364,18,5516,44,7,79,216660.0,130000.0,-39.0,-36.0,-45.0,-51.0,-42.0,-34.0,-42.0,-47.0,-89.0,-90.0,-86.0,-89.0,50.0,54.0,41.0,38.0,1
2411,62:47:05:9D:EB:15,3866849,516458618,14533,30632421,3852316,485826197,1,11736,4808297,11670,4798102,66,10195,5665,0,14619,277,1,163,229410.0,137640.0,-44.0,-43.0,-45.0,-47.0,-46.0,-47.0,-50.0,-49.0,-89.0,-90.0,-86.0,-89.0,45.0,47.0,41.0,42.0,1
2412,92:69:1D:31:68:E9,3856547,489544339,4229,3717940,3852318,485826399,1,5849,1241971,5665,1200063,184,41908,2353,12,4510,104,1,66,229410.0,130000.0,-51.0,-47.0,-44.0,-47.0,-51.0,-47.0,-43.0,-47.0,-89.0,-90.0,-86.0,-89.0,38.0,43.0,42.0,42.0,1
2413,CC:2F:71:3F:1F:24,5229346,2085175256,1377027,1599348797,3852319,485826459,2222,1162498,1341255352,1161596,1341145878,902,109474,1125191,15,1375163,128613,2219,878,144444.0,43333.0,-71.0,-69.0,-68.0,-70.0,-70.0,-69.0,-68.0,-69.0,-89.0,-90.0,-86.0,-89.0,18.0,21.0,18.0,19.0,1
2414,CC:2F:71:3E:C5:1F,3853364,485954195,1045,127736,3852319,485826459,3,4563,380454,3803,290244,760,90210,1107,15,1501,31,3,54,130000.0,39000.0,-73.0,-73.0,-68.0,-60.0,-71.0,-71.0,-68.0,-60.0,-89.0,-90.0,-86.0,-89.0,16.0,17.0,18.0,29.0,1
2415,BA:8C:B9:54:50:24,3857296,492025573,4977,6199114,3852319,485826459,7,10117,1776818,10095,1773323,22,3495,2364,18,5516,44,7,79,216660.0,130000.0,-39.0,-36.0,-45.0,-51.0,-42.0,-34.0,-42.0,-47.0,-89.0,-90.0,-86.0,-89.0,50.0,54.0,41.0,38.0,1
2416,62:47:05:9D:EB:15,3866859,516459828,14536,30632965,3852323,485826863,1,11749,4809425,11683,4799230,66,10195,5668,0,14622,279,1,163,229410.0,137640.0,-47.0,-48.0,-51.0,-50.0,-45.0,-44.0,-48.0,-46.0,-89.0,-89.0,-86.0,-88.0,42.0,41.0,35.0,38.0,1
2417,92:69:1D:31:68:E9,3856552,489544803,4229,3717940,3852323,485826863,1,5849,1241971,5665,1200063,184,41908,2353,12,4510,104,1,66,229410.0,130000.0,-51.0,-47.0,-44.0,-47.0,-51.0,-47.0,-43.0,-47.0,-89.0,-89.0,-86.0,-88.0,38.0,42.0,42.0,41.0,1
2418,CC:2F:71:3F:1F:24,5229398,2085193436,1377075,1599366573,3852323,485826863,2222,1162527,1341260286,1161625,1341150812,902,109474,1125219,15,1375211,128642,2219,878,144444.0,43333.0,-71.0,-69.0,-69.0,-70.0,-70.0,-69.0,-68.0,-69.0,-89.0,-89.0,-86.0,-88.0,18.0,20.0,17.0,18.0,1
2419,CC:2F:71:3E:C5:1F,3853368,485954599,1045,127736,3852323,485826863,3,4563,380454,3803,290244,760,90210,1107,15,1501,31,3,54,130000.0,39000.0,-73.0,-73.0,-68.0,-60.0,-71.0,-71.0,-68.0,-60.0,-89.0,-89.0,-86.0,-88.0,16.0,16.0,18.0,28.0,1
2420,BA:8C:B9:54:50:24,3857300,492025977,4977,6199114,3852323,485826863,7,10117,1776818,10095,1773323,22,3495,2364,18,5516,44,7,79,216660.0,130000.0,-39.0,-36.0,-45.0,-51.0,-42.0,-34.0,-42.0,-47.0,-89.0,-89.0,-86.0,-88.0,50.0,53.0,41.0,37.0,1
2421,62:47:05:9D:EB:15,3866882,516472843,14555,30645576,3852327,485827267,1,11798,4817051,11732,4806856,66,10195,5685,0,14641,279,1,163,229410.0,137640.0,-46.0,-46.0,-48.0,-49.0,-43.0,-43.0,-45.0,-46.0,-89.0,-89.0,-86.0,-88.0,43.0,43.0,38.0,39.0,1
2422,92:69:1D:31:68:E9,3856556,489545207,4229,3717940,3852327,485827267,1,5849,1241971,5665,1200063,184,41908,2353,12,4510,104,1,66,229410.0,130000.0,-51.0,-47.0,-44.0,-47.0,-51.0,-47.0,-43.0,-47.0,-89.0,-89.0,-86.0,-88.0,38.0,42.0,42.0,41.0,1
2423,CC:2F:71:3F:1F:24,5229450,2085211616,1377123,1599384349,3852327,485827267,2222,1162555,1341265180,1161653,1341155706,902,109474,1125244,15,1375259,128658,2219,878,144444.0,43333.0,-74.0,-72.0,-71.0,-72.0,-71.0,-69.0,-69.0,-70.0,-89.0,-89.0,-86.0,-88.0,15.0,17.0,15.0,16.0,1
2424,CC:2F:71:3E:C5:1F,3853372,485955003,1045,127736,3852327,485827267,3,4563,380454,3803,290244,760,90210,1107,15,1501,31,3,54,130000.0,39000.0,-73.0,-73.0,-68.0,-60.0,-71.0,-71.0,-68.0,-60.0,-89.0,-89.0,-86.0,-88.0,16.0,16.0,18.0,28.0,1
2425,BA:8C:B9:54:50:24,3857304,492026381,4977,6199114,3852327,485827267,7,10117,1776818,10095,1773323,22,3495,2364,18,5516,44,7,79,216660.0,130000.0,-39.0,-36.0,-45.0,-51.0,-42.0,-34.0,-42.0,-47.0,-89.0,-89.0,-86.0,-88.0,50.0,53.0,41.0,37.0,1
2426,62:47:05:9D:EB:15,3866950,516535472,14618,30707741,3852332,485827731,1,11899,4835875,11833,4825680,66,10195,5735,0,14704,279,1,163,229410.0,137640.0,-46.0,-46.0,-46.0,-47.0,-44.0,-44.0,-44.0,-45.0,-89.0,-89.0,-86.0,-88.0,43.0,43.0,40.0,41.0,1
2427,92:69:1D:31:68:E9,3856561,489545671,4229,3717940,3852332,485827731,1,5849,1241971,5665,1200063,184,41908,2353,12,4510,104,1,66,229410.0,130000.0,-51.0,-47.0,-44.0,-47.0,-51.0,-47.0,-43.0,-47.0,-89.0,-89.0,-86.0,-88.0,38.0,42.0,42.0,41.0,1
2428,CC:2F:71:3F:1F:24,5229503,2085229856,1377171,1599402125,3852332,485827731,2222,1162583,1341270108,1161681,1341160634,902,109474,1125270,15,1375307,128681,2219,878,144444.0,43333.0,-71.0,-70.0,-69.0,-70.0,-70.0,-69.0,-68.0,-69.0,-89.0,-89.0,-86.0,-88.0,18.0,19.0,17.0,18.0,1
2429,CC:2F:71:3E:C5:1F,3853377,485955467,1045,127736,3852332,485827731,3,4563,380454,3803,290244,760,90210,1107,15,1501,31,3,54,130000.0,39000.0,-73.0,-73.0,-68.0,-60.0,-71.0,-71.0,-68.0,-60.0,-89.0,-89.0,-86.0,-88.0,16.0,16.0,18.0,28.0,1
2430,BA:8C:B9:54:50:24,3857309,492026845,4977,6199114,3852332,485827731,7,10117,1776818,10095,1773323,22,3495,2364,18,5516,44,7,79,216660.0,130000.0,-39.0,-36.0,-45.0,-51.0,-42.0,-34.0,-42.0,-47.0,-89.0,-89.0,-85.0,-88.0,50.0,53.0,40.0,37.0,1
2431,62:47:05:9D:EB:15,3866971,516545222,14635,30717087,3852336,485828135,1,11931,4840252,11865,4830057,66,10195,5752,0,14721,279,1,163,229410.0,137640.0,-47.0,-45.0,-44.0,-47.0,-47.0,-45.0,-44.0,-46.0,-89.0,-89.0,-85.0,-88.0,42.0,44.0,41.0,41.0,1
2432,92:69:1D:31:68:E9,3856566,489546191,4230,3718056,3852336,485828135,1,5851,1242107,5667,1200199,184,41908,2353,12,4511,104,1,66,229410.0,130000.0,-52.0,-47.0,-42.0,-49.0,-51.0,-47.0,-43.0,-47.0,-89.0,-89.0,-85.0,-88.0,37.0,42.0,43.0,39.0,1
2433,CC:2F:71:3F:1F:24,5229563,2085251623,1377227,1599423488,3852336,485828135,2222,1162618,1341276257,1161716,1341166783,902,109474,1125302,15,1375363,128688,2219,878,144444.0,43333.0,-71.0,-69.0,-69.0,-70.0,-71.0,-69.0,-69.0,-70.0,-89.0,-89.0,-85.0,-88.0,18.0,20.0,16.0,18.0,1
2434,CC:2F:71:3E:C5:1F,3853382,485955931,1046,127796,3852336,485828135,3,4565,380594,3805,290384,760,90210,1107,15,1502,31,3,54,130000.0,39000.0,-73.0,-73.0,-69.0,-60.0,-72.0,-71.0,-67.0,-60.0,-89.0,-89.0,-85.0,-88.0,16.0,16.0,16.0,28.0,1
2435,BA:8C:B9:54:50:24,3857314,492027365,4978,6199230,3852336,485828135,7,10119,1776954,10097,1773459,22,3495,2364,18,5517,44,7,79,216660.0,130000.0,-39.0,-36.0,-46.0,-52.0,-41.0,-35.0,-43.0,-48.0,-89.0,-89.0,-85.0,-88.0,50.0,53.0,39.0,36.0,1
2436,62:47:05:9D:EB:15,3866986,516551559,14645,30722960,3852341,485828599,1,11974,4844436,11908,4834241,66,10195,5765,0,14731,279,1,163,229410.0,137640.0,-46.0,-43.0,-41.0,-44.0,-47.0,-45.0,-44.0,-46.0,-89.0,-89.0,-85.0,-87.0,43.0,46.0,44.0,43.0,1
2437,92:69:1D:31:68:E9,3856571,489546655,4230,3718056,3852341,485828599,1,5851,1242107,5667,1200199,184,41908,2353,12,4511,104,1,66,229410.0,130000.0,-52.0,-47.0,-42.0,-49.0,-51.0,-47.0,-43.0,-47.0,-89.0,-89.0,-85.0,-87.0,37.0,42.0,43.0,38.0,1
2438,CC:2F:71:3F:1F:24,5229613,2085269457,1377272,1599440858,3852341,485828599,2222,1162647,1341281393,1161745,1341171919,902,109474,1125327,15,1375408,128706,2219,878,144444.0,43333.0,-71.0,-69.0,-69.0,-70.0,-71.0,-69.0,-69.0,-70.0,-89.0,-89.0,-85.0,-87.0,18.0,20.0,16.0,17.0,1
2439,CC:2F:71:3E:C5:1F,3853387,485956395,1046,127796,3852341,485828599,3,4565,380594,3805,290384,760,90210,1107,15,1502,31,3,54,130000.0,39000.0,-73.0,-73.0,-69.0,-60.0,-72.0,-71.0,-67.0,-60.0,-89.0,-89.0,-85.0,-87.0,16.0,16.0,16.0,27.0,1
2440,BA:8C:B9:54:50:24,3857319,492027829,4978,6199230,3852341,485828599,7,10119,1776954,10097,1773459,22,3495,2364,18,5517,44,7,79,216660.0,130000.0,-39.0,-36.0,-46.0,-52.0,-41.0,-35.0,-43.0,-48.0,-89.0,-89.0,-85.0,-87.0,50.0,53.0,39.0,35.0,1
2441,62:47:05:9D:EB:15,3866993,516553310,14648,30724307,3852345,485829003,1,11978,4845076,11912,4834881,66,10195,5768,0,14734,279,1,163,229410.0,137640.0,-46.0,-45.0,-47.0,-49.0,-46.0,-44.0,-44.0,-46.0,-89.0,-89.0,-85.0,-87.0,43.0,44.0,38.0,38.0,1
2442,92:69:1D:31:68:E9,3856575,489547059,4230,3718056,3852345,485829003,1,5851,1242107,5667,1200199,184,41908,2353,12,4511,104,1,66,229410.0,130000.0,-52.0,-47.0,-42.0,-49.0,-51.0,-47.0,-43.0,-47.0,-89.0,-89.0,-85.0,-87.0,37.0,42.0,43.0,38.0,1
2443,CC:2F:71:3F:1F:24,5229663,2085287377,1377318,1599458374,3852345,485829003,2222,1162677,1341286661,1161775,1341177187,902,109474,1125353,15,1375454,128722,2219,878,144444.0,43333.0,-70.0,-68.0,-69.0,-70.0,-72.0,-70.0,-70.0,-71.0,-89.0,-89.0,-85.0,-87.0,19.0,21.0,16.0,17.0,1
2444,CC:2F:71:3E:C5:1F,3853393,485957001,1046,127796,3852347,485829205,3,4565,380594,3805,290384,760,90210,1107,15,1502,31,3,54,130000.0,39000.0,-73.0,-73.0,-69.0,-60.0,-72.0,-71.0,-67.0,-60.0,-89.0,-89.0,-85.0,-87.0,16.0,16.0,16.0,27.0,1
2445,BA:8C:B9:54:50:24,3857325,492028435,4978,6199230,3852347,485829205,7,10119,1776954,10097,1773459,22,3495,2364,18,5517,44,7,79,216660.0,130000.0,-39.0,-36.0,-46.0,-52.0,-41.0,-35.0,-43.0,-48.0,-89.0,-89.0,-85.0,-87.0,50.0,53.0,39.0,35.0,1
2446,62:47:05:9D:EB:15,3866999,516554223,14649,30724543,3852350,485829680,1,11983,4845544,11917,4835349,66,10195,5770,0,14735,279,1,163,229410.0,137640.0,-47.0,-56.0,-50.0,-55.0,-43.0,-44.0,-45.0,-48.0,-89.0,-89.0,-85.0,-87.0,42.0,33.0,35.0,32.0,1
2447,92:69:1D:31:68:E9,3856580,489547736,4230,3718056,3852350,485829680,1,5851,1242107,5667,1200199,184,41908,2353,12,4511,104,1,66,229410.0,130000.0,-52.0,-47.0,-42.0,-49.0,-51.0,-47.0,-43.0,-47.0,-89.0,-89.0,-85.0,-87.0,37.0,42.0,43.0,38.0,1
2448,CC:2F:71:3F:1F:24,5229720,2085308895,1377370,1599479215,3852350,485829680,2222,1162715,1341293208,1161813,1341183734,902,109474,1125387,15,1375506,128744,2219,878,144444.0,43333.0,-70.0,-68.0,-69.0,-69.0,-70.0,-68.0,-68.0,-69.0,-89.0,-89.0,-85.0,-87.0,19.0,21.0,16.0,18.0,1
2449,CC:2F:71:3E:C5:1F,3853396,485957476,1046,127796,3852350,485829680,3,4565,380594,3805,290384,760,90210,1107,15,1502,31,3,54,130000.0,39000.0,-73.0,-73.0,-69.0,-60.0,-72.0,-71.0,-67.0,-60.0,-89.0,-89.0,-85.0,-87.0,16.0,16.0,16.0,27.0,1
2450,BA:8C:B9:54:50:24,3857328,492028910,4978,6199230,3852350,485829680,7,10119,1776954,10097,1773459,22,3495,2364,18,5517,44,7,79,216660.0,130000.0,-39.0,-36.0,-46.0,-52.0,-41.0,-35.0,-43.0,-48.0,-89.0,-89.0,-85.0,-87.0,50.0,53.0,39.0,35.0,1
2451,62:47:05:9D:EB:15,3867004,516554687,14649,30724543,3852355,485830144,1,11983,4845544,11917,4835349,66,10195,5770,0,14735,279,1,163,229410.0,137640.0,-47.0,-56.0,-50.0,-55.0,-43.0,-44.0,-45.0,-48.0,-89.0,-89.0,-85.0,-87.0,42.0,33.0,35.0,32.0,1
2452,92:69:1D:31:68:E9,3856587,489548402,4230,3718056,3852357,485830346,1,5851,1242107,5667,1200199,184,41908,2353,12,4511,104,1,66,229410.0,130000.0,-52.0,-47.0,-42.0,-49.0,-51.0,-47.0,-43.0,-47.0,-89.0,-89.0,-85.0,-87.0,37.0,42.0,43.0,38.0,1
2453,CC:2F:71:3F:1F:24,5229773,2085327061,1377416,1599496715,3852357,485830346,2222,1162742,1341298020,1161840,1341188546,902,109474,1125412,15,1375552,128766,2219,878,144444.0,43333.0,-70.0,-68.0,-69.0,-69.0,-69.0,-67.0,-68.0,-69.0,-89.0,-88.0,-84.0,-87.0,19.0,20.0,15.0,18.0,1
2454,CC:2F:71:3E:C5:1F,3853403,485958142,1046,127796,3852357,485830346,3,4565,380594,3805,290384,760,90210,1107,15,1502,31,3,54,130000.0,39000.0,-73.0,-73.0,-69.0,-60.0,-72.0,-71.0,-67.0,-60.0,-89.0,-88.0,-84.0,-87.0,16.0,15.0,15.0,27.0,1
2455,BA:8C:B9:54:50:24,3857335,492029576,4978,6199230,3852357,485830346,7,10119,1776954,10097,1773459,22,3495,2364,18,5517,44,7,79,216660.0,130000.0,-39.0,-36.0,-46.0,-52.0,-41.0,-35.0,-43.0,-48.0,-89.0,-88.0,-84.0,-87.0,50.0,52.0,38.0,35.0,1
2456,62:47:05:9D:EB:15,3867010,516555322,14650,30724712,3852360,485830610,1,11992,4846353,11925,4836036,67,10317,5773,0,14736,279,1,163,229410.0,137640.0,-46.0,-41.0,-44.0,-50.0,-45.0,-41.0,-44.0,-50.0,-89.0,-88.0,-84.0,-87.0,43.0,47.0,40.0,37.0,1
2457,92:69:1D:31:68:E9,3856590,489548666,4230,3718056,3852360,485830610,1,5851,1242107,5667,1200199,184,41908,2353,12,4511,104,1,66,229410.0,130000.0,-52.0,-47.0,-42.0,-49.0,-51.0,-47.0,-43.0,-47.0,-89.0,-88.0,-84.0,-87.0,37.0,41.0,42.0,38.0,1
2458,CC:2F:71:3F:1F:24,5229822,2085344825,1377462,1599514215,3852360,485830610,2222,1162768,1341302700,1161866,1341193226,902,109474,1125436,15,1375598,128783,2219,878,144444.0,43333.0,-72.0,-68.0,-70.0,-71.0,-71.0,-68.0,-70.0,-70.0,-89.0,-88.0,-84.0,-87.0,17.0,20.0,14.0,16.0,1
2459,CC:2F:71:3E:C5:1F,3853406,485958406,1046,127796,3852360,485830610,3,4565,380594,3805,290384,760,90210,1107,15,1502,31,3,54,130000.0,39000.0,-73.0,-73.0,-69.0,-60.0,-72.0,-71.0,-67.0,-60.0,-89.0,-88.0,-84.0,-87.0,16.0,15.0,15.0,27.0,1
2460,BA:8C:B9:54:50:24,3857340,492030042,4978,6199230,3852362,485830812,7,10119,1776954,10097,1773459,22,3495,2364,18,5517,44,7,79,216660.0,130000.0,-39.0,-36.0,-46.0,-52.0,-41.0,-35.0,-43.0,-48.0,-89.0,-88.0,-84.0,-87.0,50.0,52.0,38.0,35.0,1
2461,62:47:05:9D:EB:15,3867017,516555988,14650,30724712,3852367,485831276,1,12008,4847441,11941,4837124,67,10317,5773,0,14736,279,1,163,229410.0,137640.0,-42.0,-35.0,-37.0,-48.0,-45.0,-40.0,-43.0,-50.0,-89.0,-88.0,-84.0,-87.0,47.0,53.0,47.0,39.0,1
2462,92:69:1D:31:68:E9,3856597,489549332,4230,3718056,3852367,485831276,1,5851,1242107,5667,1200199,184,41908,2353,12,4511,104,1,66,229410.0,130000.0,-52.0,-47.0,-42.0,-49.0,-51.0,-47.0,-43.0,-47.0,-89.0,-88.0,-84.0,-87.0,37.0,41.0,42.0,38.0,1
2463,CC:2F:71:3F:1F:24,5229877,2085363251,1377510,1599531975,3852367,485831276,2222,1162795,1341307512,1161893,1341198038,902,109474,1125461,15,1375646,128806,2219,878,144444.0,43333.0,-72.0,-68.0,-69.0,-71.0,-71.0,-67.0,-69.0,-70.0,-89.0,-88.0,-84.0,-87.0,17.0,20.0,15.0,16.0,1
2464,CC:2F:71:3E:C5:1F,3853413,485959072,1046,127796,3852367,485831276,3,4565,380594,3805,290384,760,90210,1107,15,1502,31,3,54,130000.0,39000.0,-73.0,-73.0,-69.0,-60.0,-72.0,-71.0,-67.0,-60.0,-89.0,-88.0,-84.0,-87.0,16.0,15.0,15.0,27.0,1
2465,BA:8C:B9:54:50:24,3857345,492030506,4978,6199230,3852367,485831276,7,10119,1776954,10097,1773459,22,3495,2364,18,5517,44,7,79,216660.0,130000.0,-39.0,-36.0,-46.0,-52.0,-41.0,-35.0,-43.0,-48.0,-89.0,-88.0,-84.0,-87.0,50.0,52.0,38.0,35.0,1
2466,62:47:05:9D:EB:15,3867019,516556190,14650,30724712,3852369,485831478,1,12008,4847441,11941,4837124,67,10317,5773,0,14736,279,1,163,229410.0,137640.0,-42.0,-35.0,-37.0,-48.0,-45.0,-40.0,-43.0,-50.0,-89.0,-88.0,-84.0,-86.0,47.0,53.0,47.0,38.0,1
2467,92:69:1D:31:68:E9,3856599,489549534,4230,3718056,3852369,485831478,1,5851,1242107,5667,1200199,184,41908,2353,12,4511,104,1,66,229410.0,130000.0,-52.0,-47.0,-42.0,-49.0,-51.0,-47.0,-43.0,-47.0,-89.0,-88.0,-84.0,-86.0,37.0,41.0,42.0,37.0,1
2468,CC:2F:71:3F:1F:24,5229937,2085385016,1377566,1599553336,3852371,485831680,2222,1162832,1341314086,1161930,1341204612,902,109474,1125495,15,1375702,128808,2219,878,144444.0,43333.0,-72.0,-69.0,-70.0,-73.0,-72.0,-68.0,-69.0,-72.0,-89.0,-88.0,-84.0,-86.0,17.0,19.0,14.0,13.0,1
2469,CC:2F:71:3E:C5:1F,3853417,485959476,1046,127796,3852371,485831680,3,4565,380594,3805,290384,760,90210,1107,15,1502,31,3,54,130000.0,39000.0,-73.0,-73.0,-69.0,-60.0,-72.0,-71.0,-67.0,-60.0,-89.0,-88.0,-84.0,-86.0,16.0,15.0,15.0,26.0,1
2470,BA:8C:B9:54:50:24,3857349,492030910,4978,6199230,3852371,485831680,7,10119,1776954,10097,1773459,22,3495,2364,18,5517,44,7,79,216660.0,130000.0,-39.0,-36.0,-46.0,-52.0,-41.0,-35.0,-43.0,-48.0,-89.0,-88.0,-84.0,-86.0,50.0,52.0,38.0,34.0,1
2471,62:47:05:9D:EB:15,3867040,516564164,14665,30732080,3852375,485832084,1,12052,4880410,11985,4870093,67,10317,5795,0,14751,279,1,163,229410.0,137640.0,-46.0,-43.0,-44.0,-50.0,-45.0,-43.0,-44.0,-50.0,-88.0,-87.0,-84.0,-86.0,42.0,44.0,40.0,36.0,1
2472,92:69:1D:31:68:E9,3856605,489550140,4230,3718056,3852375,485832084,1,5851,1242107,5667,1200199,184,41908,2353,12,4511,104,1,66,229410.0,130000.0,-52.0,-47.0,-42.0,-49.0,-51.0,-47.0,-43.0,-47.0,-88.0,-87.0,-84.0,-86.0,36.0,40.0,42.0,37.0,1
2473,CC:2F:71:3F:1F:24,5229988,2085403050,1377613,1599570966,3852375,485832084,2222,1162860,1341318904,1161958,1341209430,902,109474,1125522,15,1375749,128822,2219,878,144444.0,43333.0,-71.0,-69.0,-69.0,-70.0,-71.0,-68.0,-69.0,-70.0,-88.0,-87.0,-84.0,-86.0,17.0,18.0,15.0,16.0,1
2474,CC:2F:71:3E:C5:1F,3853421,485959880,1046,127796,3852375,485832084,3,4565,380594,3805,290384,760,90210,1107,15,1502,31,3,54,130000.0,39000.0,-73.0,-73.0,-69.0,-60.0,-72.0,-71.0,-67.0,-60.0,-88.0,-87.0,-84.0,-86.0,15.0,14.0,15.0,26.0,1
2475,BA:8C:B9:54:50:24,3857353,492031314,4978,6199230,3852375,485832084,7,10119,1776954,10097,1773459,22,3495,2364,18,5517,44,7,79,216660.0,130000.0,-39.0,-36.0,-46.0,-52.0,-41.0,-35.0,-43.0,-48.0,-88.0,-87.0,-84.0,-86.0,49.0,51.0,38.0,34.0,1
2476,62:47:05:9D:EB:15,3867051,516568595,14670,30735985,3852381,485832610,1,12085,4883260,12018,4872943,67,10317,5799,0,14756,279,1,164,229410.0,137640.0,-42.0,-35.0,-38.0,-47.0,-45.0,-41.0,-43.0,-49.0,-88.0,-87.0,-84.0,-86.0,46.0,52.0,46.0,39.0,1
2477,92:69:1D:31:68:E9,3856611,489550666,4230,3718056,3852381,485832610,1,5852,1242175,5668,1200267,184,41908,2353,12,4511,104,1,66,229410.0,130000.0,-52.0,-47.0,-45.0,-47.0,-51.0,-47.0,-43.0,-47.0,-88.0,-87.0,-84.0,-86.0,36.0,40.0,39.0,39.0,1
2478,CC:2F:71:3F:1F:24,5230040,2085421020,1377659,1599588410,3852381,485832610,2222,1162892,1341324054,1161987,1341214226,905,109828,1125548,15,1375795,128845,2219,880,130000.0,39000.0,-72.0,-69.0,-69.0,-71.0,-71.0,-68.0,-69.0,-70.0,-88.0,-87.0,-84.0,-86.0,16.0,18.0,15.0,15.0,1
2479,CC:2F:71:3E:C5:1F,3853427,485960406,1046,127796,3852381,485832610,3,4565,380594,3805,290384,760,90210,1107,15,1502,31,3,54,130000.0,39000.0,-73.0,-73.0,-69.0,-60.0,-72.0,-71.0,-67.0,-60.0,-88.0,-87.0,-84.0,-86.0,15.0,14.0,15.0,26.0,1
2480,BA:8C:B9:54:50:24,3857361,492032042,4978,6199230,3852383,485832812,7,10119,1776954,10097,1773459,22,3495,2364,18,5517,44,7,79,216660.0,130000.0,-39.0,-36.0,-46.0,-52.0,-41.0,-35.0,-43.0,-48.0,-88.0,-87.0,-84.0,-86.0,49.0,51.0,38.0,34.0,1
2481,62:47:05:9D:EB:15,3867060,516571159,14675,30738145,3852385,485833014,1,12106,4889962,12039,4879645,67,10317,5807,0,14761,279,1,164,229410.0,137640.0,-45.0,-40.0,-41.0,-52.0,-43.0,-39.0,-40.0,-50.0,-88.0,-87.0,-84.0,-86.0,43.0,47.0,43.0,34.0,1
2482,92:69:1D:31:68:E9,3856615,489551070,4230,3718056,3852385,485833014,1,5852,1242175,5668,1200267,184,41908,2353,12,4511,104,1,66,229410.0,130000.0,-52.0,-47.0,-45.0,-47.0,-51.0,-47.0,-43.0,-47.0,-88.0,-87.0,-84.0,-86.0,36.0,40.0,39.0,39.0,1
2483,CC:2F:71:3F:1F:24,5230089,2085438698,1377704,1599605684,3852385,485833014,2222,1162920,1341329138,1162015,1341219310,905,109828,1125572,15,1375840,128875,2219,880,144444.0,43333.0,-71.0,-68.0,-69.0,-71.0,-72.0,-69.0,-69.0,-71.0,-88.0,-87.0,-84.0,-86.0,17.0,19.0,15.0,15.0,1
2484,CC:2F:71:3E:C5:1F,3853431,485960810,1046,127796,3852385,485833014,3,4565,380594,3805,290384,760,90210,1107,15,1502,31,3,54,130000.0,39000.0,-73.0,-73.0,-69.0,-60.0,-72.0,-71.0,-67.0,-60.0,-88.0,-87.0,-84.0,-86.0,15.0,14.0,15.0,26.0,1
2485,BA:8C:B9:54:50:24,3857365,492032446,4978,6199230,3852387,485833216,7,10119,1776954,10097,1773459,22,3495,2364,18,5517,44,7,79,216660.0,130000.0,-39.0,-36.0,-46.0,-52.0,-41.0,-35.0,-43.0,-48.0,-88.0,-87.0,-84.0,-86.0,49.0,51.0,38.0,34.0,1
2486,62:47:05:9D:EB:15,3867075,516575483,14685,30742005,3852390,485833478,1,12149,4894978,12082,4884661,67,10317,5821,0,14771,279,1,164,229410.0,137640.0,-44.0,-39.0,-41.0,-52.0,-44.0,-39.0,-41.0,-52.0,-88.0,-87.0,-84.0,-86.0,44.0,48.0,43.0,34.0,1
2487,92:69:1D:31:68:E9,3856620,489551534,4230,3718056,3852390,485833478,1,5852,1242175,5668,1200267,184,41908,2353,12,4511,104,1,66,229410.0,130000.0,-52.0,-47.0,-45.0,-47.0,-51.0,-47.0,-43.0,-47.0,-88.0,-87.0,-84.0,-86.0,36.0,40.0,39.0,39.0,1
2488,CC:2F:71:3F:1F:24,5230148,2085460205,1377756,1599626525,3852392,485833680,2222,1162953,1341334981,1162048,1341225153,905,109828,1125603,15,1375892,128921,2219,880,144444.0,43333.0,-71.0,-69.0,-69.0,-71.0,-71.0,-68.0,-69.0,-71.0,-88.0,-87.0,-84.0,-86.0,17.0,18.0,15.0,15.0,1
2489,CC:2F:71:3E:C5:1F,3853438,485961476,1046,127796,3852392,485833680,3,4565,380594,3805,290384,760,90210,1107,15,1502,31,3,54,130000.0,39000.0,-73.0,-73.0,-69.0,-60.0,-72.0,-71.0,-67.0,-60.0,-88.0,-87.0,-84.0,-86.0,15.0,14.0,15.0,26.0,1
2490,BA:8C:B9:54:50:24,3857370,492032910,4978,6199230,3852392,485833680,7,10119,1776954,10097,1773459,22,3495,2364,18,5517,44,7,79,216660.0,130000.0,-39.0,-36.0,-46.0,-52.0,-41.0,-35.0,-43.0,-48.0,-88.0,-87.0,-84.0,-86.0,49.0,51.0,38.0,34.0,1
2491,62:47:05:9D:EB:15,3867080,516575949,14685,30742005,3852395,485833944,1,12150,4895046,12083,4884729,67,10317,5821,0,14771,279,1,164,229410.0,137640.0,-42.0,-35.0,-38.0,-52.0,-43.0,-38.0,-40.0,-52.0,-88.0,-87.0,-84.0,-86.0,46.0,52.0,46.0,34.0,1
2492,92:69:1D:31:68:E9,3856625,489552000,4230,3718056,3852395,485833944,1,5852,1242175,5668,1200267,184,41908,2353,12,4511,104,1,66,229410.0,130000.0,-52.0,-47.0,-45.0,-47.0,-51.0,-47.0,-43.0,-47.0,-88.0,-87.0,-84.0,-86.0,36.0,40.0,39.0,39.0,1
2493,CC:2F:71:3F:1F:24,5230211,2085483828,1377804,1599644285,3852407,485839543,2222,1162981,1341339923,1162076,1341230095,905,109828,1125628,15,1375940,128961,2219,880,144444.0,43333.0,-72.0,-69.0,-70.0,-71.0,-72.0,-68.0,-69.0,-70.0,-88.0,-87.0,-84.0,-86.0,16.0,18.0,14.0,15.0,1
2494,CC:2F:71:3E:C5:1F,3853455,485967541,1046,127796,3852409,485839745,3,4567,380782,3806,290454,761,90328,1108,15,1502,31,3,54,130000.0,39000.0,-73.0,-72.0,-69.0,-60.0,-72.0,-72.0,-68.0,-60.0,-88.0,-87.0,-84.0,-86.0,15.0,15.0,15.0,26.0,1
2495,BA:8C:B9:54:50:24,3857387,492038975,4978,6199230,3852409,485839745,7,10119,1776954,10097,1773459,22,3495,2364,18,5517,44,7,79,216660.0,130000.0,-39.0,-36.0,-46.0,-52.0,-41.0,-35.0,-43.0,-48.0,-88.0,-87.0,-84.0,-86.0,49.0,51.0,38.0,34.0,1
2496,62:47:05:9D:EB:15,3867114,516588375,14690,30742802,3852424,485845573,1,12179,4897658,12112,4887341,67,10317,5827,0,14776,279,1,164,229410.0,137640.0,-46.0,-45.0,-40.0,-47.0,-43.0,-42.0,-38.0,-45.0,-88.0,-87.0,-84.0,-86.0,42.0,42.0,44.0,39.0,1
2497,92:69:1D:31:68:E9,3856654,489563629,4230,3718056,3852424,485845573,1,5855,1242546,5670,1200403,185,42143,2354,12,4511,104,1,66,229410.0,130000.0,-52.0,-48.0,-42.0,-49.0,-52.0,-47.0,-43.0,-48.0,-88.0,-87.0,-84.0,-86.0,36.0,39.0,42.0,37.0,1
2498,CC:2F:71:3F:1F:24,5230274,2085507374,1377850,1599661801,3852424,485845573,2222,1163008,1341344749,1162103,1341234921,905,109828,1125652,15,1375986,128988,2219,880,144444.0,43333.0,-70.0,-69.0,-69.0,-71.0,-70.0,-69.0,-69.0,-71.0,-88.0,-87.0,-84.0,-86.0,18.0,18.0,15.0,15.0,1
2499,CC:2F:71:3E:C5:1F,3853470,485973369,1046,127796,3852424,485845573,3,4567,380782,3806,290454,761,90328,1108,15,1502,31,3,54,130000.0,39000.0,-73.0,-72.0,-69.0,-60.0,-72.0,-72.0,-68.0,-60.0,-88.0,-87.0,-84.0,-86.0,15.0,15.0,15.0,26.0,1
2500,BA:8C:B9:54:50:24,3857403,492044863,4978,6199230,3852425,485845633,7,10122,1777158,10100,1773663,22,3495,2364,18,5518,44,7,79,216660.0,130000.0,-48.0,-35.0,-42.0,-45.0,-41.0,-36.0,-44.0,-50.0,-88.0,-87.0,-84.0,-86.0,40.0,52.0,42.0,41.0,1
2501,62:47:05:9D:EB:15,3867119,516588847,14690,30742802,3852429,485846045,1,12209,4900034,12142,4889717,67,10317,5831,0,14776,279,1,164,229410.0,137640.0,-44.0,-38.0,-35.0,-47.0,-46.0,-43.0,-39.0,-50.0,-89.0,-87.0,-84.0,-86.0,45.0,49.0,49.0,39.0,1
2502,92:69:1D:31:68:E9,3856661,489564303,4230,3718056,3852431,485846247,1,5855,1242546,5670,1200403,185,42143,2354,12,4511,104,1,66,229410.0,130000.0,-52.0,-48.0,-42.0,-49.0,-52.0,-47.0,-43.0,-48.0,-89.0,-87.0,-84.0,-86.0,37.0,39.0,42.0,37.0,1
2503,CC:2F:71:3F:1F:24,5230329,2085525808,1377898,1599679561,3852431,485846247,2222,1163037,1341349745,1162132,1341239917,905,109828,1125679,15,1376034,129016,2219,880,144444.0,43333.0,-71.0,-69.0,-70.0,-73.0,-71.0,-69.0,-69.0,-72.0,-89.0,-87.0,-84.0,-86.0,18.0,18.0,14.0,13.0,1
2504,CC:2F:71:3E:C5:1F,3853477,485974043,1046,127796,3852431,485846247,3,4567,380782,3806,290454,761,90328,1108,15,1502,31,3,54,130000.0,39000.0,-73.0,-72.0,-69.0,-60.0,-72.0,-72.0,-68.0,-60.0,-89.0,-87.0,-84.0,-86.0,16.0,15.0,15.0,26.0,1
2505,BA:8C:B9:54:50:24,3857409,492045477,4978,6199230,3852431,485846247,7,10122,1777158,10100,1773663,22,3495,2364,18,5518,44,7,79,216660.0,130000.0,-48.0,-35.0,-42.0,-45.0,-41.0,-36.0,-44.0,-50.0,-89.0,-87.0,-84.0,-86.0,41.0,52.0,42.0,41.0,1
2506,62:47:05:9D:EB:15,3867126,516589726,14690,30742802,3852436,485846924,1,12211,4900303,12144,4889986,67,10317,5832,0,14776,279,1,164,229410.0,137640.0,-44.0,-42.0,-42.0,-54.0,-45.0,-42.0,-39.0,-51.0,-89.0,-87.0,-84.0,-86.0,45.0,45.0,42.0,32.0,1
2507,92:69:1D:31:68:E9,3856666,489564980,4230,3718056,3852436,485846924,1,5855,1242546,5670,1200403,185,42143,2354,12,4511,104,1,66,229410.0,130000.0,-52.0,-48.0,-42.0,-49.0,-52.0,-47.0,-43.0,-48.0,-89.0,-87.0,-84.0,-86.0,37.0,39.0,42.0,37.0,1
2508,CC:2F:71:3F:1F:24,5230387,2085547472,1377951,1599700548,3852436,485846924,2222,1163072,1341356069,1162167,1341246241,905,109828,1125711,15,1376087,129025,2219,880,144444.0,43333.0,-70.0,-70.0,-69.0,-72.0,-71.0,-69.0,-69.0,-72.0,-89.0,-87.0,-84.0,-86.0,19.0,17.0,15.0,14.0,1
2509,CC:2F:71:3E:C5:1F,3853484,485974922,1046,127796,3852438,485847126,3,4567,380782,3806,290454,761,90328,1108,15,1502,31,3,54,130000.0,39000.0,-73.0,-72.0,-69.0,-60.0,-72.0,-72.0,-68.0,-60.0,-89.0,-87.0,-84.0,-86.0,16.0,15.0,15.0,26.0,1
2510,BA:8C:B9:54:50:24,3857416,492046356,4978,6199230,3852438,485847126,7,10122,1777158,10100,1773663,22,3495,2364,18,5518,44,7,79,216660.0,130000.0,-48.0,-35.0,-42.0,-45.0,-41.0,-36.0,-44.0,-50.0,-89.0,-87.0,-84.0,-86.0,41.0,52.0,42.0,41.0,1
2511,62:47:05:9D:EB:15,3867132,516590320,14691,30742932,3852441,485847388,1,12234,4901867,12167,4891550,67,10317,5832,0,14777,279,1,164,216660.0,130000.0,-41.0,-35.0,-38.0,-50.0,-41.0,-37.0,-39.0,-50.0,-89.0,-87.0,-84.0,-86.0,48.0,52.0,46.0,36.0,1
2512,92:69:1D:31:68:E9,3856671,489565444,4230,3718056,3852441,485847388,1,5855,1242546,5670,1200403,185,42143,2354,12,4511,104,1,66,229410.0,130000.0,-52.0,-48.0,-42.0,-49.0,-52.0,-47.0,-43.0,-48.0,-89.0,-87.0,-84.0,-86.0,37.0,39.0,42.0,37.0,1
2513,CC:2F:71:3F:1F:24,5230440,2085565696,1377999,1599718308,3852441,485847388,2222,1163099,1341360771,1162194,1341250943,905,109828,1125737,15,1376135,129031,2219,880,144444.0,43333.0,-73.0,-71.0,-72.0,-73.0,-72.0,-70.0,-70.0,-72.0,-89.0,-87.0,-84.0,-86.0,16.0,16.0,12.0,13.0,1
2514,CC:2F:71:3E:C5:1F,3853487,485975184,1046,127796,3852441,485847388,3,4567,380782,3806,290454,761,90328,1108,15,1502,31,3,54,130000.0,39000.0,-73.0,-72.0,-69.0,-60.0,-72.0,-72.0,-68.0,-60.0,-89.0,-87.0,-84.0,-86.0,16.0,15.0,15.0,26.0,1
2515,BA:8C:B9:54:50:24,3857419,492046618,4978,6199230,3852441,485847388,7,10122,1777158,10100,1773663,22,3495,2364,18,5518,44,7,79,216660.0,130000.0,-48.0,-35.0,-42.0,-45.0,-41.0,-36.0,-44.0,-50.0,-89.0,-87.0,-84.0,-86.0,41.0,52.0,42.0,41.0,1
2516,62:47:05:9D:EB:15,3867136,516590724,14691,30742932,3852445,485847792,1,12234,4901867,12167,4891550,67,10317,5832,0,14777,279,1,164,216660.0,130000.0,-41.0,-35.0,-38.0,-50.0,-41.0,-37.0,-39.0,-50.0,-89.0,-87.0,-84.0,-86.0,48.0,52.0,46.0,36.0,1
2517,92:69:1D:31:68:E9,3856677,489566050,4230,3718056,3852447,485847994,1,5855,1242546,5670,1200403,185,42143,2354,12,4511,104,1,66,229410.0,130000.0,-52.0,-48.0,-42.0,-49.0,-52.0,-47.0,-43.0,-48.0,-89.0,-87.0,-84.0,-86.0,37.0,39.0,42.0,37.0,1
2518,CC:2F:71:3F:1F:24,5230493,2085583932,1378046,1599735938,3852447,485847994,2222,1163128,1341365943,1162223,1341256115,905,109828,1125762,15,1376182,129034,2219,880,144444.0,43333.0,-70.0,-68.0,-68.0,-71.0,-70.0,-68.0,-68.0,-71.0,-89.0,-87.0,-84.0,-86.0,19.0,19.0,16.0,15.0,1
2519,CC:2F:71:3E:C5:1F,3853493,485975790,1046,127796,3852447,485847994,3,4567,380782,3806,290454,761,90328,1108,15,1502,31,3,54,130000.0,39000.0,-73.0,-72.0,-69.0,-60.0,-72.0,-72.0,-68.0,-60.0,-89.0,-87.0,-84.0,-86.0,16.0,15.0,15.0,26.0,1
2520,BA:8C:B9:54:50:24,3857425,492047224,4978,6199230,3852447,485847994,7,10122,1777158,10100,1773663,22,3495,2364,18,5518,44,7,79,216660.0,130000.0,-48.0,-35.0,-42.0,-45.0,-41.0,-36.0,-44.0,-50.0,-89.0,-87.0,-84.0,-86.0,41.0,52.0,42.0,41.0,1
2521,62:47:05:9D:EB:15,3867163,516608749,14711,30760074,3852452,485848675,1,12290,4909052,12222,4898564,68,10488,5848,0,14797,279,1,164,229410.0,130000.0,-41.0,-36.0,-40.0,-49.0,-43.0,-38.0,-42.0,-50.0,-89.0,-87.0,-84.0,-86.0,48.0,51.0,44.0,37.0,1
2522,92:69:1D:31:68:E9,3856682,489566731,4230,3718056,3852452,485848675,1,5855,1242546,5670,1200403,185,42143,2354,12,4511,104,1,66,229410.0,130000.0,-52.0,-48.0,-42.0,-49.0,-52.0,-47.0,-43.0,-48.0,-89.0,-87.0,-84.0,-86.0,37.0,39.0,42.0,37.0,1
2523,CC:2F:71:3F:1F:24,5230550,2085605454,1378098,1599756779,3852452,485848675,2222,1163166,1341372555,1162261,1341262727,905,109828,1125798,15,1376234,129048,2219,880,144444.0,43333.0,-70.0,-68.0,-68.0,-70.0,-70.0,-68.0,-68.0,-70.0,-89.0,-87.0,-84.0,-86.0,19.0,19.0,16.0,16.0,1
2524,CC:2F:71:3E:C5:1F,3853498,485976471,1046,127796,3852452,485848675,3,4567,380782,3806,290454,761,90328,1108,15,1502,31,3,54,130000.0,39000.0,-73.0,-72.0,-69.0,-60.0,-72.0,-72.0,-68.0,-60.0,-89.0,-87.0,-84.0,-86.0,16.0,15.0,15.0,26.0,1
2525,BA:8C:B9:54:50:24,3857431,492047965,4978,6199230,3852453,485848735,7,10122,1777158,10100,1773663,22,3495,2364,18,5518,44,7,79,216660.0,130000.0,-48.0,-35.0,-42.0,-45.0,-41.0,-36.0,-44.0,-50.0,-89.0,-87.0,-84.0,-86.0,41.0,52.0,42.0,41.0,1
2526,62:47:05:9D:EB:15,3867174,516611111,14715,30761770,3852459,485849341,1,12320,4911962,12252,4901474,68,10488,5854,0,14801,279,1,164,229410.0,130000.0,-41.0,-35.0,-38.0,-49.0,-44.0,-39.0,-42.0,-51.0,-89.0,-87.0,-84.0,-86.0,48.0,52.0,46.0,37.0,1
2527,92:69:1D:31:68:E9,3856689,489567397,4230,3718056,3852459,485849341,1,5855,1242546,5670,1200403,185,42143,2354,12,4511,104,1,66,229410.0,130000.0,-52.0,-48.0,-42.0,-49.0,-52.0,-47.0,-43.0,-48.0,-89.0,-87.0,-84.0,-86.0,37.0,39.0,42.0,37.0,1
2528,CC:2F:71:3F:1F:24,5230605,2085623880,1378146,1599774539,3852459,485849341,2222,1163193,1341377319,1162288,1341267491,905,109828,1125823,15,1376282,129075,2219,880,144444.0,43333.0,-70.0,-69.0,-68.0,-70.0,-70.0,-68.0,-68.0,-69.0,-89.0,-87.0,-84.0,-86.0,19.0,18.0,16.0,16.0,1
2529,CC:2F:71:3E:C5:1F,3853505,485977137,1046,127796,3852459,485849341,3,4567,380782,3806,290454,761,90328,1108,15,1502,31,3,54,130000.0,39000.0,-73.0,-72.0,-69.0,-60.0,-72.0,-72.0,-68.0,-60.0,-89.0,-87.0,-84.0,-86.0,16.0,15.0,15.0,26.0,1
2530,BA:8C:B9:54:50:24,3857437,492048571,4978,6199230,3852459,485849341,7,10122,1777158,10100,1773663,22,3495,2364,18,5518,44,7,79,216660.0,130000.0,-48.0,-35.0,-42.0,-45.0,-41.0,-36.0,-44.0,-50.0,-89.0,-87.0,-84.0,-86.0,41.0,52.0,42.0,41.0,1
2531,62:47:05:9D:EB:15,3867177,516611443,14716,30761900,3852461,485849543,1,12343,4913783,12275,4903295,68,10488,5856,0,14802,279,1,165,229410.0,130000.0,-40.0,-37.0,-38.0,-47.0,-40.0,-37.0,-38.0,-47.0,-89.0,-87.0,-84.0,-86.0,49.0,50.0,46.0,39.0,1
2532,92:69:1D:31:68:E9,3856691,489567599,4230,3718056,3852461,485849543,1,5855,1242546,5670,1200403,185,42143,2354,12,4511,104,1,66,229410.0,130000.0,-52.0,-48.0,-42.0,-49.0,-52.0,-47.0,-43.0,-48.0,-89.0,-87.0,-84.0,-86.0,37.0,39.0,42.0,37.0,1
2533,CC:2F:71:3F:1F:24,5230653,2085641582,1378192,1599792039,3852461,485849543,2222,1163220,1341382021,1162315,1341272193,905,109828,1125849,15,1376328,129105,2219,880,144444.0,43333.0,-71.0,-70.0,-69.0,-70.0,-70.0,-69.0,-68.0,-70.0,-89.0,-87.0,-84.0,-86.0,18.0,17.0,15.0,16.0,1
2534,CC:2F:71:3E:C5:1F,3853509,485977541,1046,127796,3852463,485849745,3,4567,380782,3806,290454,761,90328,1108,15,1502,31,3,54,130000.0,39000.0,-73.0,-72.0,-69.0,-60.0,-72.0,-72.0,-68.0,-60.0,-89.0,-87.0,-84.0,-86.0,16.0,15.0,15.0,26.0,1
2535,BA:8C:B9:54:50:24,3857441,492048975,4978,6199230,3852463,485849745,7,10122,1777158,10100,1773663,22,3495,2364,18,5518,44,7,79,216660.0,130000.0,-48.0,-35.0,-42.0,-45.0,-41.0,-36.0,-44.0,-50.0,-89.0,-87.0,-84.0,-86.0,41.0,52.0,42.0,41.0,1
2536,62:47:05:9D:EB:15,3867184,516612109,14716,30761900,3852468,485850209,1,12344,4913851,12276,4903363,68,10488,5856,0,14802,279,1,165,229410.0,130000.0,-41.0,-36.0,-38.0,-49.0,-40.0,-36.0,-38.0,-47.0,-89.0,-87.0,-84.0,-86.0,48.0,51.0,46.0,37.0,1
2537,92:69:1D:31:68:E9,3856698,489568265,4230,3718056,3852468,485850209,1,5855,1242546,5670,1200403,185,42143,2354,12,4511,104,1,66,229410.0,130000.0,-52.0,-48.0,-42.0,-49.0,-52.0,-47.0,-43.0,-48.0,-89.0,-87.0,-84.0,-86.0,37.0,39.0,42.0,37.0,1
2538,CC:2F:71:3F:1F:24,5230707,2085659878,1378239,1599809669,3852468,485850209,2222,1163251,1341387435,1162346,1341277607,905,109828,1125875,15,1376375,129120,2219,880,144444.0,43333.0,-71.0,-70.0,-68.0,-72.0,-70.0,-69.0,-68.0,-71.0,-89.0,-87.0,-84.0,-86.0,18.0,17.0,16.0,14.0,1
2539,CC:2F:71:3E:C5:1F,3853514,485978005,1046,127796,3852468,485850209,3,4567,380782,3806,290454,761,90328,1108,15,1502,31,3,54,130000.0,39000.0,-73.0,-72.0,-69.0,-60.0,-72.0,-72.0,-68.0,-60.0,-89.0,-87.0,-84.0,-86.0,16.0,15.0,15.0,26.0,1
2540,BA:8C:B9:54:50:24,3857446,492049439,4978,6199230,3852468,485850209,7,10122,1777158,10100,1773663,22,3495,2364,18,5518,44,7,79,216660.0,130000.0,-48.0,-35.0,-42.0,-45.0,-41.0,-36.0,-44.0,-50.0,-89.0,-87.0,-84.0,-86.0,41.0,52.0,42.0,41.0,1
2541,62:47:05:9D:EB:15,3867196,516617589,14726,30767178,3852470,485850411,1,12366,4917709,12298,4907221,68,10488,5866,0,14812,279,1,165,229410.0,137640.0,-42.0,-43.0,-51.0,-51.0,-45.0,-43.0,-49.0,-50.0,-89.0,-87.0,-84.0,-86.0,47.0,44.0,33.0,35.0,1
2542,92:69:1D:31:68:E9,3856702,489568669,4230,3718056,3852472,485850613,1,5855,1242546,5670,1200403,185,42143,2354,12,4511,104,1,66,229410.0,130000.0,-52.0,-48.0,-42.0,-49.0,-52.0,-47.0,-43.0,-48.0,-89.0,-87.0,-84.0,-86.0,37.0,39.0,42.0,37.0,1
2543,CC:2F:71:3F:1F:24,5230768,2085681835,1378296,1599831222,3852472,485850613,2222,1163290,1341394096,1162385,1341284268,905,109828,1125910,15,1376432,129121,2219,880,144444.0,43333.0,-71.0,-69.0,-68.0,-71.0,-71.0,-69.0,-67.0,-71.0,-89.0,-87.0,-84.0,-86.0,18.0,18.0,16.0,15.0,1
2544,CC:2F:71:3E:C5:1F,3853518,485978409,1046,127796,3852472,485850613,3,4567,380782,3806,290454,761,90328,1108,15,1502,31,3,54,130000.0,39000.0,-73.0,-72.0,-69.0,-60.0,-72.0,-72.0,-68.0,-60.0,-89.0,-87.0,-84.0,-86.0,16.0,15.0,15.0,26.0,1
2545,BA:8C:B9:54:50:24,3857450,492049843,4978,6199230,3852472,485850613,7,10122,1777158,10100,1773663,22,3495,2364,18,5518,44,7,79,216660.0,130000.0,-48.0,-35.0,-42.0,-45.0,-41.0,-36.0,-44.0,-50.0,-89.0,-87.0,-84.0,-86.0,41.0,52.0,42.0,41.0,1
2546,62:47:05:9D:EB:15,3867220,516637067,14744,30786050,3852476,485851017,1,12420,4924969,12352,4914481,68,10488,5884,0,14830,279,1,166,229410.0,137640.0,-44.0,-45.0,-41.0,-47.0,-44.0,-44.0,-43.0,-47.0,-89.0,-87.0,-84.0,-86.0,45.0,42.0,43.0,39.0,1
2547,92:69:1D:31:68:E9,3856706,489569073,4230,3718056,3852476,485851017,1,5855,1242546,5670,1200403,185,42143,2354,12,4511,104,1,66,229410.0,130000.0,-52.0,-48.0,-42.0,-49.0,-52.0,-47.0,-43.0,-48.0,-89.0,-87.0,-84.0,-86.0,37.0,39.0,42.0,37.0,1
2548,CC:2F:71:3F:1F:24,5230819,2085699815,1378342,1599848738,3852477,485851077,2222,1163315,1341398566,1162410,1341288738,905,109828,1125934,15,1376478,129125,2219,880,144444.0,43333.0,-71.0,-70.0,-69.0,-70.0,-71.0,-70.0,-70.0,-70.0,-89.0,-87.0,-84.0,-86.0,18.0,17.0,15.0,16.0,1
2549,CC:2F:71:3E:C5:1F,3853523,485978873,1046,127796,3852477,485851077,3,4567,380782,3806,290454,761,90328,1108,15,1502,31,3,54,130000.0,39000.0,-73.0,-72.0,-69.0,-60.0,-72.0,-72.0,-68.0,-60.0,-89.0,-87.0,-84.0,-86.0,16.0,15.0,15.0,26.0,1
2550,BA:8C:B9:54:50:24,3857455,492050307,4978,6199230,3852477,485851077,7,10122,1777158,10100,1773663,22,3495,2364,18,5518,44,7,79,216660.0,130000.0,-48.0,-35.0,-42.0,-45.0,-41.0,-36.0,-44.0,-50.0,-89.0,-87.0,-84.0,-86.0,41.0,52.0,42.0,41.0,1
2551,62:47:05:9D:EB:15,3867231,516640051,14750,30788570,3852481,485851481,1,12454,4928487,12386,4917999,68,10488,5891,0,14836,279,1,167,229410.0,137640.0,-41.0,-36.0,-39.0,-48.0,-41.0,-40.0,-40.0,-50.0,-89.0,-87.0,-84.0,-86.0,48.0,51.0,45.0,38.0,1
2552,92:69:1D:31:68:E9,3856711,489569537,4230,3718056,3852481,485851481,1,5855,1242546,5670,1200403,185,42143,2354,12,4511,104,1,66,229410.0,130000.0,-52.0,-48.0,-42.0,-49.0,-52.0,-47.0,-43.0,-48.0,-89.0,-87.0,-84.0,-86.0,37.0,39.0,42.0,37.0,1
2553,CC:2F:71:3F:1F:24,5230871,2085717965,1378390,1599866484,3852481,485851481,2222,1163343,1341403384,1162438,1341293556,905,109828,1125961,15,1376526,129141,2219,880,144444.0,43333.0,-69.0,-68.0,-68.0,-70.0,-69.0,-67.0,-67.0,-69.0,-89.0,-87.0,-84.0,-86.0,20.0,19.0,16.0,16.0,1
2554,CC:2F:71:3E:C5:1F,3853528,485979393,1047,127912,3852481,485851481,3,4569,380922,3808,290594,761,90328,1108,15,1503,31,3,54,130000.0,39000.0,-71.0,-72.0,-69.0,-60.0,-72.0,-72.0,-68.0,-60.0,-89.0,-87.0,-84.0,-86.0,18.0,15.0,15.0,26.0,1
2555,BA:8C:B9:54:50:24,3857462,492051029,4979,6199346,3852483,485851683,7,10124,1777294,10102,1773799,22,3495,2364,18,5519,44,7,79,216660.0,130000.0,-48.0,-35.0,-42.0,-45.0,-41.0,-36.0,-44.0,-50.0,-89.0,-87.0,-84.0,-86.0,41.0,52.0,42.0,41.0,1
2556,62:47:05:9D:EB:15,3867236,516640571,14751,30788686,3852485,485851885,1,12465,4929416,12397,4918928,68,10488,5892,0,14837,279,1,167,229410.0,137640.0,-46.0,-41.0,-42.0,-51.0,-43.0,-38.0,-40.0,-50.0,-89.0,-87.0,-84.0,-86.0,43.0,46.0,42.0,35.0,1
2557,92:69:1D:31:68:E9,3856716,489570057,4231,3718172,3852485,485851885,1,5857,1242682,5672,1200539,185,42143,2354,12,4512,104,1,66,229410.0,130000.0,-53.0,-47.0,-42.0,-49.0,-52.0,-47.0,-43.0,-48.0,-89.0,-87.0,-84.0,-86.0,36.0,40.0,42.0,37.0,1
2558,CC:2F:71:3F:1F:24,5230923,2085736129,1378438,1599884244,3852485,485851885,2222,1163372,1341408380,1162467,1341298552,905,109828,1125988,15,1376574,129149,2219,880,144444.0,43333.0,-69.0,-69.0,-69.0,-71.0,-69.0,-68.0,-68.0,-71.0,-89.0,-87.0,-84.0,-86.0,20.0,18.0,15.0,15.0,1
2559,CC:2F:71:3E:C5:1F,3853532,485979797,1047,127912,3852485,485851885,3,4569,380922,3808,290594,761,90328,1108,15,1503,31,3,54,130000.0,39000.0,-71.0,-72.0,-69.0,-60.0,-72.0,-72.0,-68.0,-60.0,-89.0,-87.0,-84.0,-86.0,18.0,15.0,15.0,26.0,1
2560,BA:8C:B9:54:50:24,3857464,492051231,4979,6199346,3852485,485851885,7,10124,1777294,10102,1773799,22,3495,2364,18,5519,44,7,79,216660.0,130000.0,-48.0,-35.0,-42.0,-45.0,-41.0,-36.0,-44.0,-50.0,-89.0,-87.0,-84.0,-86.0,41.0,52.0,42.0,41.0,1
2561,62:47:05:9D:EB:15,3867242,516641165,14752,30788816,3852490,485852349,1,12473,4929960,12405,4919472,68,10488,5892,0,14838,279,1,167,229410.0,137640.0,-48.0,-38.0,-38.0,-51.0,-45.0,-40.0,-41.0,-50.0,-89.0,-87.0,-84.0,-86.0,41.0,49.0,46.0,35.0,1
2562,92:69:1D:31:68:E9,3856721,489570521,4231,3718172,3852490,485852349,1,5857,1242682,5672,1200539,185,42143,2354,12,4512,104,1,66,229410.0,130000.0,-53.0,-47.0,-42.0,-49.0,-52.0,-47.0,-43.0,-48.0,-89.0,-87.0,-84.0,-86.0,36.0,40.0,42.0,37.0,1
2563,CC:2F:71:3F:1F:24,5230979,2085757304,1378489,1599904955,3852490,485852349,2222,1163405,1341414237,1162500,1341304409,905,109828,1126018,15,1376625,129149,2219,880,144444.0,43333.0,-70.0,-69.0,-69.0,-72.0,-69.0,-69.0,-68.0,-71.0,-89.0,-87.0,-84.0,-86.0,19.0,18.0,15.0,14.0,1
2564,CC:2F:71:3E:C5:1F,3853539,485980463,1047,127912,3852492,485852551,3,4569,380922,3808,290594,761,90328,1108,15,1503,31,3,54,130000.0,39000.0,-71.0,-72.0,-69.0,-60.0,-72.0,-72.0,-68.0,-60.0,-89.0,-87.0,-84.0,-86.0,18.0,15.0,15.0,26.0,1
2565,BA:8C:B9:54:50:24,3857471,492051897,4979,6199346,3852492,485852551,7,10125,1777362,10103,1773867,22,3495,2364,18,5519,44,7,79,216660.0,130000.0,-40.0,-37.0,-46.0,-52.0,-41.0,-36.0,-45.0,-50.0,-89.0,-87.0,-84.0,-86.0,49.0,50.0,38.0,34.0,1
2566,62:47:05:9D:EB:15,3867247,516641699,14753,30788946,3852494,485852753,1,12501,4932045,12433,4921557,68,10488,5893,0,14839,279,1,167,229410.0,137640.0,-43.0,-37.0,-37.0,-47.0,-42.0,-37.0,-37.0,-47.0,-89.0,-87.0,-84.0,-86.0,46.0,50.0,47.0,39.0,1
2567,92:69:1D:31:68:E9,3856725,489570925,4231,3718172,3852494,485852753,1,5857,1242682,5672,1200539,185,42143,2354,12,4512,104,1,66,229410.0,130000.0,-53.0,-47.0,-42.0,-49.0,-52.0,-47.0,-43.0,-48.0,-89.0,-87.0,-84.0,-86.0,36.0,40.0,42.0,37.0,1
2568,CC:2F:71:3F:1F:24,5231030,2085775338,1378536,1599922585,3852494,485852753,2222,1163430,1341418707,1162525,1341308879,905,109828,1126042,15,1376672,129150,2219,880,144444.0,43333.0,-70.0,-69.0,-70.0,-73.0,-69.0,-68.0,-69.0,-72.0,-89.0,-87.0,-84.0,-86.0,19.0,18.0,14.0,13.0,1
2569,CC:2F:71:3E:C5:1F,3853541,485980665,1047,127912,3852494,485852753,3,4569,380922,3808,290594,761,90328,1108,15,1503,31,3,54,130000.0,39000.0,-71.0,-72.0,-69.0,-60.0,-72.0,-72.0,-68.0,-60.0,-89.0,-87.0,-84.0,-86.0,18.0,15.0,15.0,26.0,1
2570,BA:8C:B9:54:50:24,3857475,492052301,4979,6199346,3852496,485852955,7,10125,1777362,10103,1773867,22,3495,2364,18,5519,44,7,79,216660.0,130000.0,-40.0,-37.0,-46.0,-52.0,-41.0,-36.0,-45.0,-50.0,-89.0,-87.0,-84.0,-86.0,49.0,50.0,38.0,34.0,1
2571,62:47:05:9D:EB:15,3867261,516644055,14762,30790625,3852499,485853430,1,12546,4952241,12478,4941753,68,10488,5907,0,14848,279,1,167,229410.0,137640.0,-42.0,-35.0,-36.0,-43.0,-45.0,-39.0,-40.0,-47.0,-89.0,-87.0,-84.0,-86.0,47.0,52.0,48.0,43.0,1
2572,92:69:1D:31:68:E9,3856730,489571602,4231,3718172,3852499,485853430,1,5857,1242682,5672,1200539,185,42143,2354,12,4512,104,1,66,229410.0,130000.0,-53.0,-47.0,-42.0,-49.0,-52.0,-47.0,-43.0,-48.0,-89.0,-87.0,-84.0,-86.0,36.0,40.0,42.0,37.0,1
2573,CC:2F:71:3F:1F:24,5231082,2085793645,1378583,1599940215,3852499,485853430,2222,1163459,1341423827,1162554,1341313999,905,109828,1126067,15,1376719,129152,2219,880,144444.0,43333.0,-69.0,-69.0,-70.0,-73.0,-70.0,-69.0,-70.0,-73.0,-89.0,-87.0,-84.0,-86.0,20.0,18.0,14.0,13.0,1
2574,CC:2F:71:3E:C5:1F,3853549,485981604,1047,127912,3852502,485853692,3,4569,380922,3808,290594,761,90328,1108,15,1503,31,3,54,130000.0,39000.0,-71.0,-72.0,-69.0,-60.0,-72.0,-72.0,-68.0,-60.0,-89.0,-87.0,-84.0,-86.0,18.0,15.0,15.0,26.0,1
2575,BA:8C:B9:54:50:24,3857483,492053240,4979,6199346,3852504,485853894,7,10125,1777362,10103,1773867,22,3495,2364,18,5519,44,7,79,216660.0,130000.0,-40.0,-37.0,-46.0,-52.0,-41.0,-36.0,-45.0,-50.0,-89.0,-87.0,-84.0,-86.0,49.0,50.0,38.0,34.0,1
2576,62:47:05:9D:EB:15,3867266,516644519,14762,30790625,3852504,485853894,1,12546,4952241,12478,4941753,68,10488,5907,0,14848,279,1,167,229410.0,137640.0,-42.0,-35.0,-36.0,-43.0,-45.0,-39.0,-40.0,-47.0,-89.0,-87.0,-84.0,-86.0,47.0,52.0,48.0,43.0,1
2577,92:69:1D:31:68:E9,3856735,489572066,4231,3718172,3852504,485853894,1,5857,1242682,5672,1200539,185,42143,2354,12,4512,104,1,66,229410.0,130000.0,-53.0,-47.0,-42.0,-49.0,-52.0,-47.0,-43.0,-48.0,-89.0,-87.0,-84.0,-86.0,36.0,40.0,42.0,37.0,1
2578,CC:2F:71:3F:1F:24,5231135,2085811755,1378629,1599957659,3852506,485854096,2222,1163488,1341428823,1162583,1341318995,905,109828,1126094,15,1376765,129157,2219,880,144444.0,39000.0,-70.0,-69.0,-70.0,-72.0,-69.0,-68.0,-69.0,-72.0,-89.0,-87.0,-84.0,-86.0,19.0,18.0,14.0,14.0,1
2579,CC:2F:71:3E:C5:1F,3853553,485982008,1047,127912,3852506,485854096,3,4569,380922,3808,290594,761,90328,1108,15,1503,31,3,54,130000.0,39000.0,-71.0,-72.0,-69.0,-60.0,-72.0,-72.0,-68.0,-60.0,-89.0,-87.0,-84.0,-86.0,18.0,15.0,15.0,26.0,1
2580,BA:8C:B9:54:50:24,3857485,492053442,4979,6199346,3852506,485854096,7,10125,1777362,10103,1773867,22,3495,2364,18,5519,44,7,79,216660.0,130000.0,-40.0,-37.0,-46.0,-52.0,-41.0,-36.0,-45.0,-50.0,-89.0,-87.0,-84.0,-86.0,49.0,50.0,38.0,34.0,1
2581,62:47:05:9D:EB:15,3867284,516655548,14776,30801250,3852508,485854298,1,12587,4959671,12519,4949183,68,10488,5924,0,14861,279,1,168,229410.0,137640.0,-42.0,-37.0,-39.0,-40.0,-44.0,-39.0,-41.0,-43.0,-89.0,-87.0,-84.0,-86.0,47.0,50.0,45.0,46.0,1
2582,92:69:1D:31:68:E9,3856741,489572672,4231,3718172,3852510,485854500,1,5857,1242682,5672,1200539,185,42143,2354,12,4512,104,1,66,229410.0,130000.0,-53.0,-47.0,-42.0,-49.0,-52.0,-47.0,-43.0,-48.0,-89.0,-87.0,-84.0,-86.0,36.0,40.0,42.0,37.0,1
2583,CC:2F:71:3F:1F:24,5231195,2085833389,1378683,1599978687,3852512,485854702,2222,1163525,1341435232,1162620,1341325404,905,109828,1126128,15,1376819,129159,2219,880,144444.0,43333.0,-70.0,-69.0,-70.0,-73.0,-69.0,-69.0,-69.0,-73.0,-89.0,-87.0,-84.0,-86.0,19.0,18.0,14.0,13.0,1
2584,CC:2F:71:3E:C5:1F,3853559,485982614,1047,127912,3852512,485854702,3,4569,380922,3808,290594,761,90328,1108,15,1503,31,3,54,130000.0,39000.0,-71.0,-72.0,-69.0,-60.0,-72.0,-72.0,-68.0,-60.0,-89.0,-87.0,-84.0,-86.0,18.0,15.0,15.0,26.0,1
2585,BA:8C:B9:54:50:24,3857491,492054048,4979,6199346,3852512,485854702,7,10125,1777362,10103,1773867,22,3495,2364,18,5519,44,7,79,216660.0,130000.0,-40.0,-37.0,-46.0,-52.0,-41.0,-36.0,-45.0,-50.0,-89.0,-87.0,-84.0,-86.0,49.0,50.0,38.0,34.0,1
2586,62:47:05:9D:EB:15,3867431,516836578,14918,30981816,3852513,485854762,1,12833,5057353,12765,5046865,68,10488,6064,0,15004,279,1,168,229410.0,137640.0,-46.0,-41.0,-44.0,-45.0,-44.0,-40.0,-43.0,-43.0,-89.0,-87.0,-84.0,-86.0,43.0,46.0,40.0,41.0,1
2587,92:69:1D:31:68:E9,3856746,489573136,4231,3718172,3852515,485854964,1,5857,1242682,5672,1200539,185,42143,2354,12,4512,104,1,66,229410.0,130000.0,-53.0,-47.0,-42.0,-49.0,-52.0,-47.0,-43.0,-48.0,-89.0,-87.0,-84.0,-86.0,36.0,40.0,42.0,37.0,1
2588,CC:2F:71:3F:1F:24,5231243,2085851037,1378728,1599996073,3852515,485854964,2222,1163553,1341440174,1162648,1341330346,905,109828,1126153,15,1376864,129162,2219,880,144444.0,43333.0,-69.0,-69.0,-70.0,-72.0,-69.0,-69.0,-69.0,-72.0,-89.0,-87.0,-84.0,-86.0,20.0,18.0,14.0,14.0,1
2589,CC:2F:71:3E:C5:1F,3853562,485982876,1047,127912,3852515,485854964,3,4569,380922,3808,290594,761,90328,1108,15,1503,31,3,54,130000.0,39000.0,-71.0,-72.0,-69.0,-60.0,-72.0,-72.0,-68.0,-60.0,-89.0,-87.0,-84.0,-86.0,18.0,15.0,15.0,26.0,1
2590,BA:8C:B9:54:50:24,3857494,492054310,4979,6199346,3852515,485854964,7,10125,1777362,10103,1773867,22,3495,2364,18,5519,44,7,79,216660.0,130000.0,-40.0,-37.0,-46.0,-52.0,-41.0,-36.0,-45.0,-50.0,-89.0,-87.0,-84.0,-86.0,49.0,50.0,38.0,34.0,1
2591,62:47:05:9D:EB:15,3867623,517277441,15106,31422275,3852517,485855166,1,12980,5088095,12912,5077607,68,10488,6150,0,15192,279,1,168,229410.0,137640.0,-46.0,-41.0,-44.0,-45.0,-42.0,-38.0,-40.0,-41.0,-89.0,-87.0,-84.0,-86.0,43.0,46.0,40.0,41.0,1
2592,92:69:1D:31:68:E9,3856750,489573540,4231,3718172,3852519,485855368,1,5857,1242682,5672,1200539,185,42143,2354,12,4512,104,1,66,229410.0,130000.0,-53.0,-47.0,-42.0,-49.0,-52.0,-47.0,-43.0,-48.0,-89.0,-87.0,-84.0,-86.0,36.0,40.0,42.0,37.0,1
2593,CC:2F:71:3F:1F:24,5231292,2085868827,1378773,1600013459,3852519,485855368,2222,1163580,1341445018,1162675,1341335190,905,109828,1126178,15,1376909,129162,2219,880,144444.0,43333.0,-69.0,-69.0,-70.0,-73.0,-69.0,-69.0,-69.0,-72.0,-89.0,-87.0,-84.0,-86.0,20.0,18.0,14.0,13.0,1
2594,CC:2F:71:3E:C5:1F,3853568,485983482,1047,127912,3852521,485855570,3,4569,380922,3808,290594,761,90328,1108,15,1503,31,3,54,130000.0,39000.0,-71.0,-72.0,-69.0,-60.0,-72.0,-72.0,-68.0,-60.0,-89.0,-87.0,-84.0,-86.0,18.0,15.0,15.0,26.0,1
2595,BA:8C:B9:54:50:24,3857500,492054916,4979,6199346,3852521,485855570,7,10125,1777362,10103,1773867,22,3495,2364,18,5519,44,7,79,216660.0,130000.0,-40.0,-37.0,-46.0,-52.0,-41.0,-36.0,-45.0,-50.0,-89.0,-87.0,-84.0,-86.0,49.0,50.0,38.0,34.0,1
2596,62:47:05:9D:EB:15,3867717,517406846,15193,31551012,3852524,485855834,1,13104,5117886,13036,5107398,68,10488,6221,0,15279,279,1,168,229410.0,137640.0,-46.0,-40.0,-42.0,-45.0,-45.0,-39.0,-42.0,-44.0,-89.0,-87.0,-84.0,-86.0,43.0,47.0,42.0,41.0,1
2597,92:69:1D:31:68:E9,3856755,489574006,4231,3718172,3852524,485855834,1,5857,1242682,5672,1200539,185,42143,2354,12,4512,104,1,66,229410.0,130000.0,-53.0,-47.0,-42.0,-49.0,-52.0,-47.0,-43.0,-48.0,-89.0,-87.0,-84.0,-86.0,36.0,40.0,42.0,37.0,1
2598,CC:2F:71:3F:1F:24,5231343,2085886739,1378818,1600030845,3852525,485855894,2222,1163605,1341449488,1162700,1341339660,905,109828,1126202,15,1376954,129163,2219,880,144444.0,43333.0,-70.0,-69.0,-70.0,-73.0,-69.0,-69.0,-69.0,-72.0,-89.0,-87.0,-84.0,-86.0,19.0,18.0,14.0,13.0,1
2599,CC:2F:71:3E:C5:1F,3853572,485983806,1047,127912,3852525,485855894,3,4571,381110,3809,290664,762,90446,1109,15,1503,31,3,54,130000.0,39000.0,-71.0,-71.0,-69.0,-59.0,-71.0,-72.0,-68.0,-59.0,-89.0,-87.0,-84.0,-86.0,18.0,16.0,15.0,27.0,1
2600,BA:8C:B9:54:50:24,3857504,492055240,4979,6199346,3852525,485855894,7,10125,1777362,10103,1773867,22,3495,2364,18,5519,44,7,79,216660.0,130000.0,-40.0,-37.0,-46.0,-52.0,-41.0,-36.0,-45.0,-50.0,-89.0,-87.0,-84.0,-86.0,49.0,50.0,38.0,34.0,1
2601,62:47:05:9D:EB:15,3868560,519754210,16031,33897912,3852529,485856298,1,13362,5158465,13294,5147977,68,10488,6407,0,16117,279,1,168,229410.0,137640.0,-46.0,-40.0,-43.0,-45.0,-45.0,-39.0,-41.0,-44.0,-89.0,-87.0,-84.0,-86.0,43.0,47.0,41.0,41.0,1
2602,92:69:1D:31:68:E9,3856762,489574672,4231,3718172,3852531,485856500,1,5857,1242682,5672,1200539,185,42143,2354,12,4512,104,1,66,229410.0,130000.0,-53.0,-47.0,-42.0,-49.0,-52.0,-47.0,-43.0,-48.0,-89.0,-87.0,-84.0,-86.0,36.0,40.0,42.0,37.0,1
2603,CC:2F:71:3F:1F:24,5231411,2085911226,1378880,1600054726,3852531,485856500,2222,1163651,1341457631,1162746,1341347803,905,109828,1126244,15,1377016,129163,2219,880,144444.0,43333.0,-70.0,-69.0,-70.0,-73.0,-69.0,-69.0,-69.0,-72.0,-89.0,-87.0,-84.0,-86.0,19.0,18.0,14.0,13.0,1
2604,CC:2F:71:3E:C5:1F,3853578,485984412,1047,127912,3852531,485856500,3,4571,381110,3809,290664,762,90446,1109,15,1503,31,3,54,130000.0,39000.0,-71.0,-71.0,-69.0,-59.0,-71.0,-72.0,-68.0,-59.0,-89.0,-87.0,-84.0,-86.0,18.0,16.0,15.0,27.0,1
2605,BA:8C:B9:54:50:24,3857510,492055846,4979,6199346,3852531,485856500,7,10125,1777362,10103,1773867,22,3495,2364,18,5519,44,7,79,216660.0,130000.0,-40.0,-37.0,-46.0,-52.0,-41.0,-36.0,-45.0,-50.0,-89.0,-87.0,-84.0,-86.0,49.0,50.0,38.0,34.0,1
2606,62:47:05:9D:EB:15,3868580,519759718,16046,33902954,3852534,485856764,1,13412,5170088,13344,5159600,68,10488,6424,0,16132,279,1,168,229410.0,137640.0,-46.0,-41.0,-43.0,-46.0,-43.0,-37.0,-39.0,-42.0,-89.0,-87.0,-84.0,-86.0,43.0,46.0,41.0,40.0,1
2607,92:69:1D:31:68:E9,3856765,489574936,4231,3718172,3852534,485856764,1,5857,1242682,5672,1200539,185,42143,2354,12,4512,104,1,66,229410.0,130000.0,-53.0,-47.0,-42.0,-49.0,-52.0,-47.0,-43.0,-48.0,-89.0,-87.0,-84.0,-86.0,36.0,40.0,42.0,37.0,1
2608,CC:2F:71:3F:1F:24,5231459,2085928876,1378925,1600072112,3852534,485856764,2222,1163682,1341463175,1162776,1341353229,906,109946,1126270,15,1377061,129164,2219,880,144444.0,43333.0,-69.0,-68.0,-69.0,-72.0,-68.0,-68.0,-69.0,-72.0,-89.0,-87.0,-84.0,-86.0,20.0,19.0,15.0,14.0,1
2609,CC:2F:71:3E:C5:1F,3853581,485984676,1047,127912,3852534,485856764,3,4571,381110,3809,290664,762,90446,1109,15,1503,31,3,54,130000.0,39000.0,-71.0,-71.0,-69.0,-59.0,-71.0,-72.0,-68.0,-59.0,-89.0,-87.0,-84.0,-86.0,18.0,16.0,15.0,27.0,1
2610,BA:8C:B9:54:50:24,3857513,492056110,4979,6199346,3852534,485856764,7,10125,1777362,10103,1773867,22,3495,2364,18,5519,44,7,79,216660.0,130000.0,-40.0,-37.0,-46.0,-52.0,-41.0,-36.0,-45.0,-50.0,-89.0,-87.0,-84.0,-86.0,49.0,50.0,38.0,34.0,1
2611,62:47:05:9D:EB:15,3868597,519764226,16055,33906734,3852542,485857492,1,13453,5173841,13384,5163231,69,10610,6435,0,16141,279,1,168,229410.0,137640.0,-42.0,-35.0,-38.0,-40.0,-46.0,-40.0,-42.0,-45.0,-89.0,-87.0,-84.0,-86.0,47.0,52.0,46.0,46.0,1
2612,92:69:1D:31:68:E9,3856773,489575664,4231,3718172,3852542,485857492,1,5857,1242682,5672,1200539,185,42143,2354,12,4512,104,1,66,229410.0,130000.0,-53.0,-47.0,-42.0,-49.0,-52.0,-47.0,-43.0,-48.0,-89.0,-87.0,-84.0,-86.0,36.0,40.0,42.0,37.0,1
2613,CC:2F:71:3F:1F:24,5231512,2085946974,1378970,1600089482,3852542,485857492,2222,1163709,1341467953,1162803,1341358007,906,109946,1126294,15,1377106,129165,2219,880,144444.0,43333.0,-69.0,-68.0,-69.0,-71.0,-68.0,-68.0,-68.0,-71.0,-89.0,-87.0,-84.0,-86.0,20.0,19.0,15.0,15.0,1
2614,CC:2F:71:3E:C5:1F,3853589,485985404,1047,127912,3852542,485857492,3,4571,381110,3809,290664,762,90446,1109,15,1503,31,3,54,130000.0,39000.0,-71.0,-71.0,-69.0,-59.0,-71.0,-72.0,-68.0,-59.0,-89.0,-87.0,-84.0,-86.0,18.0,16.0,15.0,27.0,1
2615,BA:8C:B9:54:50:24,3857521,492056838,4979,6199346,3852542,485857492,7,10125,1777362,10103,1773867,22,3495,2364,18,5519,44,7,79,216660.0,130000.0,-40.0,-37.0,-46.0,-52.0,-41.0,-36.0,-45.0,-50.0,-89.0,-87.0,-84.0,-86.0,49.0,50.0,38.0,34.0,1
2616,62:47:05:9D:EB:15,3868622,519786810,16078,33929116,3852544,485857694,1,13508,5186894,13439,5176284,69,10610,6459,0,16164,279,1,168,229410.0,137640.0,-41.0,-35.0,-38.0,-40.0,-45.0,-40.0,-42.0,-44.0,-89.0,-87.0,-84.0,-86.0,48.0,52.0,46.0,46.0,1
2617,92:69:1D:31:68:E9,3856775,489575866,4231,3718172,3852544,485857694,1,5857,1242682,5672,1200539,185,42143,2354,12,4512,104,1,66,229410.0,130000.0,-53.0,-47.0,-42.0,-49.0,-52.0,-47.0,-43.0,-48.0,-89.0,-87.0,-84.0,-86.0,36.0,40.0,42.0,37.0,1
2618,CC:2F:71:3F:1F:24,5231559,2085964546,1379015,1600106852,3852544,485857694,2222,1163736,1341472669,1162830,1341362723,906,109946,1126319,15,1377151,129168,2219,880,144444.0,43333.0,-69.0,-68.0,-69.0,-72.0,-69.0,-68.0,-69.0,-72.0,-89.0,-87.0,-84.0,-86.0,20.0,19.0,15.0,14.0,1
2619,CC:2F:71:3E:C5:1F,3853591,485985606,1047,127912,3852544,485857694,3,4571,381110,3809,290664,762,90446,1109,15,1503,31,3,54,130000.0,39000.0,-71.0,-71.0,-69.0,-59.0,-71.0,-72.0,-68.0,-59.0,-89.0,-87.0,-84.0,-86.0,18.0,16.0,15.0,27.0,1
2620,BA:8C:B9:54:50:24,3857525,492057242,4979,6199346,3852546,485857896,7,10125,1777362,10103,1773867,22,3495,2364,18,5519,44,7,79,216660.0,130000.0,-40.0,-37.0,-46.0,-52.0,-41.0,-36.0,-45.0,-50.0,-89.0,-87.0,-84.0,-86.0,49.0,50.0,38.0,34.0,1
2621,62:47:05:9D:EB:15,3868851,520402531,16301,34544231,3852550,485858300,1,13556,5198918,13487,5188308,69,10610,6496,0,16387,279,1,168,229410.0,137640.0,-62.0,-64.0,-57.0,-65.0,-62.0,-63.0,-56.0,-64.0,-89.0,-88.0,-84.0,-86.0,27.0,24.0,27.0,21.0,1
2622,92:69:1D:31:68:E9,3856781,489576472,4231,3718172,3852550,485858300,1,5859,1242818,5674,1200675,185,42143,2354,12,4513,104,1,66,229410.0,130000.0,-52.0,-48.0,-44.0,-48.0,-52.0,-48.0,-43.0,-48.0,-89.0,-88.0,-84.0,-86.0,37.0,40.0,40.0,38.0,1
2623,CC:2F:71:3F:1F:24,5231619,2085986569,1379068,1600128209,3852551,485858360,2222,1163771,1341478934,1162865,1341368988,906,109946,1126352,15,1377204,129204,2219,880,144444.0,43333.0,-71.0,-68.0,-70.0,-72.0,-70.0,-67.0,-70.0,-72.0,-89.0,-88.0,-84.0,-86.0,18.0,20.0,14.0,14.0,1
2624,CC:2F:71:3E:C5:1F,3853598,485986272,1047,127912,3852551,485858360,3,4571,381110,3809,290664,762,90446,1109,15,1503,31,3,54,130000.0,39000.0,-71.0,-71.0,-69.0,-59.0,-71.0,-72.0,-68.0,-59.0,-89.0,-88.0,-84.0,-86.0,18.0,17.0,15.0,27.0,1
2625,BA:8C:B9:54:50:24,3857530,492057706,4979,6199346,3852551,485858360,7,10127,1777498,10105,1774003,22,3495,2364,18,5520,44,7,79,216660.0,130000.0,-48.0,-35.0,-42.0,-45.0,-43.0,-36.0,-44.0,-49.0,-89.0,-88.0,-84.0,-86.0,41.0,53.0,42.0,41.0,1
2626,62:47:05:9D:EB:15,3868856,520405201,16303,34546639,3852553,485858562,1,13574,5201358,13505,5190748,69,10610,6500,0,16389,279,1,168,229410.0,137640.0,-60.0,-63.0,-54.0,-58.0,-62.0,-62.0,-54.0,-62.0,-89.0,-88.0,-84.0,-86.0,29.0,25.0,30.0,28.0,1
2627,92:69:1D:31:68:E9,3856784,489576734,4231,3718172,3852553,485858562,1,5859,1242818,5674,1200675,185,42143,2354,12,4513,104,1,66,229410.0,130000.0,-52.0,-48.0,-44.0,-48.0,-52.0,-48.0,-43.0,-48.0,-89.0,-88.0,-84.0,-86.0,37.0,40.0,40.0,38.0,1
2628,CC:2F:71:3F:1F:24,5231666,2086004085,1379113,1600145523,3852553,485858562,2222,1163796,1341483404,1162890,1341373458,906,109946,1126376,15,1377249,129231,2219,880,130000.0,43333.0,-69.0,-67.0,-67.0,-70.0,-70.0,-67.0,-67.0,-70.0,-89.0,-88.0,-84.0,-86.0,20.0,21.0,17.0,16.0,1
2629,CC:2F:71:3E:C5:1F,3853602,485986676,1047,127912,3852555,485858764,3,4571,381110,3809,290664,762,90446,1109,15,1503,31,3,54,130000.0,39000.0,-71.0,-71.0,-69.0,-59.0,-71.0,-72.0,-68.0,-59.0,-89.0,-88.0,-84.0,-86.0,18.0,17.0,15.0,27.0,1
2630,BA:8C:B9:54:50:24,3857534,492058110,4979,6199346,3852555,485858764,7,10127,1777498,10105,1774003,22,3495,2364,18,5520,44,7,79,216660.0,130000.0,-48.0,-35.0,-42.0,-45.0,-43.0,-36.0,-44.0,-49.0,-89.0,-88.0,-84.0,-86.0,41.0,53.0,42.0,41.0,1
2631,62:47:05:9D:EB:15,3868873,520410227,16313,34550786,3852560,485859441,1,13610,5208616,13541,5198006,69,10610,6510,0,16399,279,1,168,229410.0,137640.0,-60.0,-67.0,-59.0,-60.0,-59.0,-66.0,-58.0,-60.0,-89.0,-88.0,-84.0,-86.0,29.0,21.0,25.0,26.0,1
2632,92:69:1D:31:68:E9,3856791,489577613,4231,3718172,3852560,485859441,1,5859,1242818,5674,1200675,185,42143,2354,12,4513,104,1,66,229410.0,130000.0,-52.0,-48.0,-44.0,-48.0,-52.0,-48.0,-43.0,-48.0,-89.0,-88.0,-84.0,-86.0,37.0,40.0,40.0,38.0,1
2633,CC:2F:71:3F:1F:24,5231719,2086022480,1379159,1600163039,3852560,485859441,2222,1163821,1341487874,1162915,1341377928,906,109946,1126400,15,1377295,129232,2219,880,130000.0,43333.0,-68.0,-67.0,-67.0,-70.0,-68.0,-67.0,-67.0,-70.0,-89.0,-88.0,-84.0,-85.0,21.0,21.0,17.0,15.0,1
2634,CC:2F:71:3E:C5:1F,3853607,485987353,1047,127912,3852560,485859441,3,4571,381110,3809,290664,762,90446,1109,15,1503,31,3,54,130000.0,39000.0,-71.0,-71.0,-69.0,-59.0,-71.0,-72.0,-68.0,-59.0,-89.0,-88.0,-84.0,-85.0,18.0,17.0,15.0,26.0,1
2635,BA:8C:B9:54:50:24,3857539,492058787,4979,6199346,3852560,485859441,7,10127,1777498,10105,1774003,22,3495,2364,18,5520,44,7,79,216660.0,130000.0,-48.0,-35.0,-42.0,-45.0,-43.0,-36.0,-44.0,-49.0,-89.0,-88.0,-84.0,-85.0,41.0,53.0,42.0,40.0,1
2636,62:47:05:9D:EB:15,3868876,520410489,16313,34550786,3852563,485859703,1,13629,5209908,13560,5199298,69,10610,6510,0,16399,279,1,168,229410.0,137640.0,-54.0,-62.0,-55.0,-58.0,-58.0,-67.0,-58.0,-59.0,-89.0,-88.0,-84.0,-85.0,35.0,26.0,29.0,27.0,1
2637,92:69:1D:31:68:E9,3856794,489577875,4231,3718172,3852563,485859703,1,5859,1242818,5674,1200675,185,42143,2354,12,4513,104,1,66,229410.0,130000.0,-52.0,-48.0,-44.0,-48.0,-52.0,-48.0,-43.0,-48.0,-89.0,-88.0,-84.0,-85.0,37.0,40.0,40.0,37.0,1
2638,CC:2F:71:3F:1F:24,5231771,2086040702,1379206,1600180797,3852565,485859905,2222,1163853,1341493184,1162947,1341383238,906,109946,1126429,15,1377342,129232,2219,880,130000.0,43333.0,-69.0,-67.0,-68.0,-69.0,-69.0,-67.0,-67.0,-69.0,-89.0,-88.0,-84.0,-85.0,20.0,21.0,16.0,16.0,1
2639,CC:2F:71:3E:C5:1F,3853612,485987817,1047,127912,3852565,485859905,3,4571,381110,3809,290664,762,90446,1109,15,1503,31,3,54,130000.0,39000.0,-71.0,-71.0,-69.0,-59.0,-71.0,-72.0,-68.0,-59.0,-89.0,-88.0,-84.0,-85.0,18.0,17.0,15.0,26.0,1
2640,BA:8C:B9:54:50:24,3857544,492059251,4979,6199346,3852565,485859905,7,10127,1777498,10105,1774003,22,3495,2364,18,5520,44,7,79,216660.0,130000.0,-48.0,-35.0,-42.0,-45.0,-43.0,-36.0,-44.0,-49.0,-89.0,-88.0,-84.0,-85.0,41.0,53.0,42.0,40.0,1
2641,62:47:05:9D:EB:15,3868882,520411095,16313,34550786,3852569,485860309,1,13629,5209908,13560,5199298,69,10610,6510,0,16399,279,1,168,229410.0,137640.0,-54.0,-62.0,-55.0,-58.0,-58.0,-67.0,-58.0,-59.0,-89.0,-88.0,-84.0,-85.0,35.0,26.0,29.0,27.0,1
2642,92:69:1D:31:68:E9,3856800,489578481,4231,3718172,3852569,485860309,1,5859,1242818,5674,1200675,185,42143,2354,12,4513,104,1,66,229410.0,130000.0,-52.0,-48.0,-44.0,-48.0,-52.0,-48.0,-43.0,-48.0,-89.0,-88.0,-84.0,-85.0,37.0,40.0,40.0,37.0,1
2643,CC:2F:71:3F:1F:24,5232234,2086577884,1379665,1600717575,3852569,485860309,2222,1164048,1341526908,1163142,1341416962,906,109946,1126618,15,1377801,129232,2219,880,144444.0,43333.0,-70.0,-67.0,-68.0,-69.0,-70.0,-67.0,-67.0,-68.0,-89.0,-88.0,-84.0,-85.0,19.0,21.0,16.0,16.0,1
2644,CC:2F:71:3E:C5:1F,3853616,485988221,1047,127912,3852569,485860309,3,4571,381110,3809,290664,762,90446,1109,15,1503,31,3,54,130000.0,39000.0,-71.0,-71.0,-69.0,-59.0,-71.0,-72.0,-68.0,-59.0,-89.0,-88.0,-84.0,-85.0,18.0,17.0,15.0,26.0,1
2645,BA:8C:B9:54:50:24,3857550,492059857,4979,6199346,3852571,485860511,7,10127,1777498,10105,1774003,22,3495,2364,18,5520,44,7,79,216660.0,130000.0,-48.0,-35.0,-42.0,-45.0,-43.0,-36.0,-44.0,-49.0,-89.0,-88.0,-84.0,-85.0,41.0,53.0,42.0,40.0,1
2646,62:47:05:9D:EB:15,3868889,520411819,16315,34550995,3852574,485860824,1,13644,5213496,13574,5202715,70,10781,6514,0,16401,279,1,169,216660.0,130000.0,-61.0,-70.0,-59.0,-61.0,-60.0,-69.0,-58.0,-61.0,-89.0,-88.0,-84.0,-85.0,28.0,18.0,25.0,24.0,1
2647,92:69:1D:31:68:E9,3856806,489579056,4231,3718172,3852575,485860884,1,5859,1242818,5674,1200675,185,42143,2354,12,4513,104,1,66,229410.0,130000.0,-52.0,-48.0,-44.0,-48.0,-52.0,-48.0,-43.0,-48.0,-89.0,-88.0,-84.0,-85.0,37.0,40.0,40.0,37.0,1
2648,CC:2F:71:3F:1F:24,5232530,2086888097,1379955,1601027213,3852575,485860884,2222,1164200,1341549737,1163294,1341439791,906,109946,1126766,15,1378091,129243,2219,880,144444.0,43333.0,-73.0,-70.0,-71.0,-72.0,-73.0,-70.0,-71.0,-72.0,-89.0,-88.0,-84.0,-85.0,16.0,18.0,13.0,13.0,1
2649,CC:2F:71:3E:C5:1F,3853622,485988796,1047,127912,3852575,485860884,3,4571,381110,3809,290664,762,90446,1109,15,1503,31,3,54,130000.0,39000.0,-71.0,-71.0,-69.0,-59.0,-71.0,-72.0,-68.0,-59.0,-89.0,-88.0,-84.0,-85.0,18.0,17.0,15.0,26.0,1
2650,BA:8C:B9:54:50:24,3857556,492060432,4979,6199346,3852577,485861086,7,10127,1777498,10105,1774003,22,3495,2364,18,5520,44,7,79,216660.0,130000.0,-48.0,-35.0,-42.0,-45.0,-43.0,-36.0,-44.0,-49.0,-89.0,-88.0,-84.0,-85.0,41.0,53.0,42.0,40.0,1
2651,62:47:05:9D:EB:15,3868907,520421273,16328,34559985,3852579,485861288,1,13669,5217763,13599,5206982,70,10781,6525,0,16414,279,1,169,216660.0,130000.0,-57.0,-69.0,-54.0,-59.0,-60.0,-68.0,-57.0,-60.0,-89.0,-88.0,-84.0,-85.0,32.0,19.0,30.0,26.0,1
2652,92:69:1D:31:68:E9,3856810,489579460,4231,3718172,3852579,485861288,1,5859,1242818,5674,1200675,185,42143,2354,12,4513,104,1,66,229410.0,130000.0,-52.0,-48.0,-44.0,-48.0,-52.0,-48.0,-43.0,-48.0,-89.0,-88.0,-84.0,-85.0,37.0,40.0,40.0,37.0,1
2653,CC:2F:71:3F:1F:24,5232939,2087363866,1380358,1601502376,3852581,485861490,2222,1164394,1341579104,1163488,1341469158,906,109946,1126955,15,1378494,129244,2219,880,144444.0,43333.0,-70.0,-67.0,-69.0,-70.0,-70.0,-67.0,-68.0,-70.0,-89.0,-88.0,-84.0,-85.0,19.0,21.0,15.0,15.0,1
2654,CC:2F:71:3E:C5:1F,3853628,485989402,1047,127912,3852581,485861490,3,4571,381110,3809,290664,762,90446,1109,15,1503,31,3,54,130000.0,39000.0,-71.0,-71.0,-69.0,-59.0,-71.0,-72.0,-68.0,-59.0,-89.0,-88.0,-84.0,-85.0,18.0,17.0,15.0,26.0,1
2655,BA:8C:B9:54:50:24,3857560,492060836,4979,6199346,3852581,485861490,7,10127,1777498,10105,1774003,22,3495,2364,18,5520,44,7,79,216660.0,130000.0,-48.0,-35.0,-42.0,-45.0,-43.0,-36.0,-44.0,-49.0,-89.0,-88.0,-84.0,-85.0,41.0,53.0,42.0,40.0,1
2656,62:47:05:9D:EB:15,3868911,520421677,16328,34559985,3852583,485861692,1,13669,5217763,13599,5206982,70,10781,6525,0,16414,279,1,169,216660.0,130000.0,-57.0,-69.0,-54.0,-59.0,-60.0,-68.0,-57.0,-60.0,-89.0,-88.0,-84.0,-85.0,32.0,19.0,30.0,26.0,1
2657,92:69:1D:31:68:E9,3856816,489580066,4231,3718172,3852585,485861894,1,5859,1242818,5674,1200675,185,42143,2354,12,4513,104,1,66,229410.0,130000.0,-52.0,-48.0,-44.0,-48.0,-52.0,-48.0,-43.0,-48.0,-89.0,-88.0,-84.0,-85.0,37.0,40.0,40.0,37.0,1
2658,CC:2F:71:3F:1F:24,5233019,2087415875,1380434,1601553981,3852585,485861894,2222,1164437,1341585662,1163531,1341475716,906,109946,1126997,15,1378570,129244,2219,880,144444.0,43333.0,-70.0,-67.0,-68.0,-70.0,-70.0,-67.0,-68.0,-70.0,-89.0,-88.0,-84.0,-85.0,19.0,21.0,16.0,15.0,1
2659,CC:2F:71:3E:C5:1F,3853632,485989806,1047,127912,3852585,485861894,3,4571,381110,3809,290664,762,90446,1109,15,1503,31,3,54,130000.0,39000.0,-71.0,-71.0,-69.0,-59.0,-71.0,-72.0,-68.0,-59.0,-89.0,-88.0,-84.0,-85.0,18.0,17.0,15.0,26.0,1
2660,BA:8C:B9:54:50:24,3857566,492061442,4979,6199346,3852587,485862096,7,10127,1777498,10105,1774003,22,3495,2364,18,5520,44,7,79,216660.0,130000.0,-48.0,-35.0,-42.0,-45.0,-43.0,-36.0,-44.0,-49.0,-89.0,-88.0,-84.0,-85.0,41.0,53.0,42.0,40.0,1
2661,62:47:05:9D:EB:15,3868927,520426743,16339,34564587,3852588,485862156,1,13702,5227546,13632,5216765,70,10781,6537,0,16425,279,1,169,229410.0,130000.0,-61.0,-68.0,-57.0,-60.0,-58.0,-67.0,-55.0,-58.0,-89.0,-88.0,-84.0,-85.0,28.0,20.0,27.0,25.0,1
2662,92:69:1D:31:68:E9,3856821,489580530,4231,3718172,3852590,485862358,1,5860,1242886,5675,1200743,185,42143,2354,12,4513,104,1,66,229410.0,130000.0,-52.0,-48.0,-44.0,-48.0,-52.0,-48.0,-43.0,-48.0,-89.0,-88.0,-84.0,-85.0,37.0,40.0,40.0,37.0,1
2663,CC:2F:71:3F:1F:24,5233070,2087433855,1380480,1601571497,3852590,485862358,2222,1164465,1341590494,1163559,1341480548,906,109946,1127023,15,1378616,129244,2219,880,144444.0,43333.0,-71.0,-67.0,-68.0,-70.0,-70.0,-67.0,-67.0,-69.0,-89.0,-88.0,-84.0,-85.0,18.0,21.0,16.0,15.0,1
2664,CC:2F:71:3E:C5:1F,3853637,485990270,1047,127912,3852590,485862358,3,4571,381110,3809,290664,762,90446,1109,15,1503,31,3,54,130000.0,39000.0,-71.0,-71.0,-69.0,-59.0,-71.0,-72.0,-68.0,-59.0,-89.0,-88.0,-84.0,-85.0,18.0,17.0,15.0,26.0,1
2665,BA:8C:B9:54:50:24,3857569,492061704,4979,6199346,3852590,485862358,7,10127,1777498,10105,1774003,22,3495,2364,18,5520,44,7,79,216660.0,130000.0,-48.0,-35.0,-42.0,-45.0,-43.0,-36.0,-44.0,-49.0,-89.0,-88.0,-84.0,-85.0,41.0,53.0,42.0,40.0,1
2666,62:47:05:9D:EB:15,3868933,520427349,16339,34564587,3852594,485862762,1,13703,5227614,13633,5216833,70,10781,6537,0,16425,279,1,169,229410.0,130000.0,-57.0,-68.0,-53.0,-59.0,-58.0,-67.0,-55.0,-58.0,-89.0,-88.0,-84.0,-85.0,32.0,20.0,31.0,26.0,1
2667,92:69:1D:31:68:E9,3856825,489580934,4231,3718172,3852594,485862762,1,5860,1242886,5675,1200743,185,42143,2354,12,4513,104,1,66,229410.0,130000.0,-52.0,-48.0,-44.0,-48.0,-52.0,-48.0,-43.0,-48.0,-89.0,-88.0,-84.0,-85.0,37.0,40.0,40.0,37.0,1
2668,CC:2F:71:3F:1F:24,5233122,2087451961,1380526,1601588997,3852596,485862964,2222,1164490,1341594964,1163584,1341485018,906,109946,1127047,15,1378662,129245,2219,880,144444.0,43333.0,-71.0,-67.0,-68.0,-70.0,-70.0,-66.0,-67.0,-69.0,-89.0,-88.0,-84.0,-85.0,18.0,21.0,16.0,15.0,1
2669,CC:2F:71:3E:C5:1F,3853643,485990876,1047,127912,3852596,485862964,3,4571,381110,3809,290664,762,90446,1109,15,1503,31,3,54,130000.0,39000.0,-71.0,-71.0,-69.0,-59.0,-71.0,-72.0,-68.0,-59.0,-89.0,-88.0,-84.0,-85.0,18.0,17.0,15.0,26.0,1
2670,BA:8C:B9:54:50:24,3857575,492062310,4979,6199346,3852596,485862964,7,10127,1777498,10105,1774003,22,3495,2364,18,5520,44,7,79,216660.0,130000.0,-48.0,-35.0,-42.0,-45.0,-43.0,-36.0,-44.0,-49.0,-89.0,-88.0,-84.0,-85.0,41.0,53.0,42.0,40.0,1
2671,62:47:05:9D:EB:15,3868939,520428072,16340,34564846,3852599,485863226,1,13718,5229009,13648,5218228,70,10781,6541,0,16426,279,1,169,229410.0,130000.0,-61.0,-69.0,-58.0,-60.0,-59.0,-68.0,-55.0,-59.0,-89.0,-88.0,-84.0,-85.0,28.0,19.0,26.0,25.0,1
2672,92:69:1D:31:68:E9,3856830,489581398,4231,3718172,3852599,485863226,1,5860,1242886,5675,1200743,185,42143,2354,12,4513,104,1,66,229410.0,130000.0,-52.0,-48.0,-44.0,-48.0,-52.0,-48.0,-43.0,-48.0,-89.0,-88.0,-84.0,-85.0,37.0,40.0,40.0,37.0,1
2673,CC:2F:71:3F:1F:24,5233179,2087473340,1380580,1601610114,3852599,485863226,2222,1164525,1341601085,1163619,1341491139,906,109946,1127081,15,1378716,129245,2219,880,144444.0,43333.0,-70.0,-67.0,-68.0,-70.0,-70.0,-67.0,-68.0,-70.0,-89.0,-88.0,-84.0,-85.0,19.0,21.0,16.0,15.0,1
2674,CC:2F:71:3E:C5:1F,3853646,485991138,1047,127912,3852599,485863226,3,4571,381110,3809,290664,762,90446,1109,15,1503,31,3,54,130000.0,39000.0,-71.0,-71.0,-69.0,-59.0,-71.0,-72.0,-68.0,-59.0,-89.0,-88.0,-84.0,-85.0,18.0,17.0,15.0,26.0,1
2675,BA:8C:B9:54:50:24,3857578,492062572,4979,6199346,3852599,485863226,7,10127,1777498,10105,1774003,22,3495,2364,18,5520,44,7,79,216660.0,130000.0,-48.0,-35.0,-42.0,-45.0,-43.0,-36.0,-44.0,-49.0,-89.0,-88.0,-84.0,-85.0,41.0,53.0,42.0,40.0,1
2676,62:47:05:9D:EB:15,3868997,520479916,16392,34616084,3852605,485863832,1,13809,5281030,13739,5270249,70,10781,6590,0,16478,279,1,169,229410.0,137640.0,-61.0,-69.0,-57.0,-60.0,-60.0,-68.0,-57.0,-60.0,-89.0,-88.0,-84.0,-85.0,28.0,19.0,27.0,25.0,1
2677,92:69:1D:31:68:E9,3856837,489582120,4232,3718288,3852605,485863832,1,5862,1243022,5677,1200879,185,42143,2354,12,4514,104,1,66,229410.0,130000.0,-52.0,-48.0,-44.0,-48.0,-52.0,-47.0,-43.0,-48.0,-89.0,-88.0,-84.0,-85.0,37.0,40.0,40.0,37.0,1
2678,CC:2F:71:3F:1F:24,5233233,2087491708,1380628,1601627876,3852605,485863832,2222,1164554,1341605973,1163648,1341496027,906,109946,1127108,15,1378764,129247,2219,880,144444.0,43333.0,-74.0,-70.0,-71.0,-72.0,-71.0,-68.0,-69.0,-70.0,-89.0,-88.0,-84.0,-85.0,15.0,18.0,13.0,13.0,1
2679,CC:2F:71:3E:C5:1F,3853653,485991860,1048,128028,3852605,485863832,3,4573,381250,3811,290804,762,90446,1109,15,1504,31,3,54,130000.0,39000.0,-73.0,-73.0,-68.0,-59.0,-71.0,-70.0,-68.0,-59.0,-89.0,-88.0,-84.0,-85.0,16.0,15.0,16.0,26.0,1
2680,BA:8C:B9:54:50:24,3857586,492063356,4980,6199462,3852606,485863894,7,10131,1777770,10109,1774275,22,3495,2364,18,5521,44,7,79,216660.0,130000.0,-48.0,-35.0,-42.0,-45.0,-43.0,-35.0,-43.0,-47.0,-89.0,-88.0,-84.0,-85.0,41.0,53.0,42.0,40.0,1
2681,62:47:05:9D:EB:15,3869006,520481835,16398,34617739,3852608,485864096,1,13841,5283850,13770,5272947,71,10903,6599,0,16484,279,1,169,229410.0,137640.0,-58.0,-63.0,-60.0,-64.0,-57.0,-67.0,-55.0,-61.0,-89.0,-88.0,-84.0,-85.0,31.0,25.0,24.0,21.0,1
2682,92:69:1D:31:68:E9,3856840,489582384,4232,3718288,3852608,485864096,1,5862,1243022,5677,1200879,185,42143,2354,12,4514,104,1,66,229410.0,130000.0,-52.0,-48.0,-44.0,-48.0,-52.0,-47.0,-43.0,-48.0,-89.0,-88.0,-84.0,-85.0,37.0,40.0,40.0,37.0,1
2683,CC:2F:71:3F:1F:24,5233283,2087509602,1380675,1601645506,3852608,485864096,2222,1164580,1341610559,1163674,1341500613,906,109946,1127133,15,1378811,129254,2219,880,144444.0,43333.0,-69.0,-67.0,-71.0,-70.0,-69.0,-66.0,-70.0,-69.0,-89.0,-88.0,-84.0,-85.0,20.0,21.0,13.0,15.0,1
2684,CC:2F:71:3E:C5:1F,3853656,485992124,1048,128028,3852608,485864096,3,4573,381250,3811,290804,762,90446,1109,15,1504,31,3,54,130000.0,39000.0,-73.0,-73.0,-68.0,-59.0,-71.0,-70.0,-68.0,-59.0,-89.0,-88.0,-84.0,-85.0,16.0,15.0,16.0,26.0,1
2685,BA:8C:B9:54:50:24,3857588,492063558,4980,6199462,3852608,485864096,7,10131,1777770,10109,1774275,22,3495,2364,18,5521,44,7,79,216660.0,130000.0,-48.0,-35.0,-42.0,-45.0,-43.0,-35.0,-43.0,-47.0,-89.0,-88.0,-84.0,-85.0,41.0,53.0,42.0,40.0,1
2686,62:47:05:9D:EB:15,3869018,520487757,16403,34622995,3852615,485864762,1,13884,5288831,13813,5277928,71,10903,6605,0,16489,279,1,169,229410.0,137640.0,-62.0,-61.0,-55.0,-66.0,-60.0,-59.0,-53.0,-64.0,-89.0,-88.0,-84.0,-85.0,27.0,27.0,29.0,19.0,1
2687,92:69:1D:31:68:E9,3856847,489583050,4232,3718288,3852615,485864762,1,5862,1243022,5677,1200879,185,42143,2354,12,4514,104,1,66,229410.0,130000.0,-52.0,-48.0,-44.0,-48.0,-52.0,-47.0,-43.0,-48.0,-89.0,-88.0,-84.0,-85.0,37.0,40.0,40.0,37.0,1
2688,CC:2F:71:3F:1F:24,5233337,2087527898,1380722,1601663136,3852615,485864762,2222,1164608,1341615377,1163702,1341505431,906,109946,1127160,15,1378858,129276,2219,880,144444.0,43333.0,-69.0,-66.0,-69.0,-69.0,-69.0,-66.0,-69.0,-68.0,-89.0,-88.0,-84.0,-85.0,20.0,22.0,15.0,16.0,1
2689,CC:2F:71:3E:C5:1F,3853663,485992790,1048,128028,3852615,485864762,3,4573,381250,3811,290804,762,90446,1109,15,1504,31,3,54,130000.0,39000.0,-73.0,-73.0,-68.0,-59.0,-71.0,-70.0,-68.0,-59.0,-89.0,-88.0,-84.0,-85.0,16.0,15.0,16.0,26.0,1
2690,BA:8C:B9:54:50:24,3857595,492064224,4980,6199462,3852615,485864762,7,10131,1777770,10109,1774275,22,3495,2364,18,5521,44,7,79,216660.0,130000.0,-48.0,-35.0,-42.0,-45.0,-43.0,-35.0,-43.0,-47.0,-89.0,-88.0,-84.0,-85.0,41.0,53.0,42.0,40.0,1
2691,62:47:05:9D:EB:15,3869036,520491152,16417,34626000,3852619,485865152,1,13904,5307978,13833,5297075,71,10903,6617,0,16503,279,1,169,229410.0,137640.0,-54.0,-56.0,-52.0,-59.0,-59.0,-58.0,-52.0,-61.0,-89.0,-88.0,-84.0,-85.0,35.0,32.0,32.0,26.0,1
2692,92:69:1D:31:68:E9,3856852,489583713,4232,3718288,3852620,485865425,1,5862,1243022,5677,1200879,185,42143,2354,12,4514,104,1,66,229410.0,130000.0,-52.0,-48.0,-44.0,-48.0,-52.0,-47.0,-43.0,-48.0,-89.0,-88.0,-84.0,-85.0,37.0,40.0,40.0,37.0,1
2693,CC:2F:71:3F:1F:24,5233396,2087549662,1380776,1601684237,3852620,485865425,2222,1164645,1341621686,1163738,1341511622,907,110064,1127195,15,1378912,129294,2219,880,144444.0,43333.0,-69.0,-66.0,-70.0,-68.0,-69.0,-66.0,-69.0,-68.0,-89.0,-88.0,-84.0,-85.0,20.0,22.0,14.0,17.0,1
2694,CC:2F:71:3E:C5:1F,3853668,485993453,1048,128028,3852620,485865425,3,4573,381250,3811,290804,762,90446,1109,15,1504,31,3,54,130000.0,39000.0,-73.0,-73.0,-68.0,-59.0,-71.0,-70.0,-68.0,-59.0,-89.0,-88.0,-84.0,-85.0,16.0,15.0,16.0,26.0,1
2695,BA:8C:B9:54:50:24,3857600,492064887,4980,6199462,3852620,485865425,7,10131,1777770,10109,1774275,22,3495,2364,18,5521,44,7,79,216660.0,130000.0,-48.0,-35.0,-42.0,-45.0,-43.0,-35.0,-43.0,-47.0,-89.0,-88.0,-84.0,-85.0,41.0,53.0,42.0,40.0,1
2696,62:47:05:9D:EB:15,3869048,520492908,16421,34626817,3852627,485866091,1,13934,5310459,13863,5299556,71,10903,6622,0,16507,279,1,169,229410.0,137640.0,-55.0,-63.0,-53.0,-63.0,-57.0,-62.0,-57.0,-62.0,-89.0,-88.0,-84.0,-85.0,34.0,25.0,31.0,22.0,1
2697,92:69:1D:31:68:E9,3856859,489584379,4232,3718288,3852627,485866091,1,5862,1243022,5677,1200879,185,42143,2354,12,4514,104,1,66,229410.0,130000.0,-52.0,-48.0,-44.0,-48.0,-52.0,-47.0,-43.0,-48.0,-89.0,-88.0,-84.0,-85.0,37.0,40.0,40.0,37.0,1
2698,CC:2F:71:3F:1F:24,5233451,2087568088,1380824,1601701997,3852627,485866091,2222,1164672,1341626388,1163765,1341516324,907,110064,1127221,15,1378960,129296,2219,880,144444.0,43333.0,-69.0,-68.0,-70.0,-69.0,-69.0,-68.0,-69.0,-68.0,-89.0,-88.0,-84.0,-85.0,20.0,20.0,14.0,16.0,1
2699,CC:2F:71:3E:C5:1F,3853675,485994119,1048,128028,3852627,485866091,3,4573,381250,3811,290804,762,90446,1109,15,1504,31,3,54,130000.0,39000.0,-73.0,-73.0,-68.0,-59.0,-71.0,-70.0,-68.0,-59.0,-89.0,-88.0,-84.0,-85.0,16.0,15.0,16.0,26.0,1
2700,BA:8C:B9:54:50:24,3857607,492065553,4980,6199462,3852627,485866091,7,10131,1777770,10109,1774275,22,3495,2364,18,5521,44,7,79,216660.0,130000.0,-48.0,-35.0,-42.0,-45.0,-43.0,-35.0,-43.0,-47.0,-89.0,-88.0,-84.0,-85.0,41.0,53.0,42.0,40.0,1
2701,62:47:05:9D:EB:15,3869050,520493110,16421,34626817,3852629,485866293,1,13934,5310459,13863,5299556,71,10903,6622,0,16507,279,1,169,229410.0,137640.0,-55.0,-63.0,-53.0,-63.0,-57.0,-62.0,-57.0,-62.0,-89.0,-88.0,-84.0,-85.0,34.0,25.0,31.0,22.0,1
2702,92:69:1D:31:68:E9,3856861,489584581,4232,3718288,3852629,485866293,1,5862,1243022,5677,1200879,185,42143,2354,12,4514,104,1,66,229410.0,130000.0,-52.0,-48.0,-44.0,-48.0,-52.0,-47.0,-43.0,-48.0,-89.0,-88.0,-84.0,-85.0,37.0,40.0,40.0,37.0,1
2703,CC:2F:71:3F:1F:24,5233499,2087585790,1380870,1601719497,3852629,485866293,2222,1164697,1341630858,1163790,1341520794,907,110064,1127245,15,1379006,129339,2219,880,144444.0,43333.0,-69.0,-67.0,-68.0,-70.0,-69.0,-66.0,-68.0,-71.0,-89.0,-88.0,-84.0,-85.0,20.0,21.0,16.0,15.0,1
2704,CC:2F:71:3E:C5:1F,3853677,485994321,1048,128028,3852629,485866293,3,4573,381250,3811,290804,762,90446,1109,15,1504,31,3,54,130000.0,39000.0,-73.0,-73.0,-68.0,-59.0,-71.0,-70.0,-68.0,-59.0,-89.0,-88.0,-84.0,-85.0,16.0,15.0,16.0,26.0,1
2705,BA:8C:B9:54:50:24,3857611,492065957,4980,6199462,3852631,485866495,7,10131,1777770,10109,1774275,22,3495,2364,18,5521,44,7,79,216660.0,130000.0,-48.0,-35.0,-42.0,-45.0,-43.0,-35.0,-43.0,-47.0,-89.0,-88.0,-84.0,-85.0,41.0,53.0,42.0,40.0,1
2706,62:47:05:9D:EB:15,3869059,520494343,16422,34627076,3852637,485867267,1,13942,5311222,13871,5300319,71,10903,6625,0,16508,279,1,169,229410.0,137640.0,-59.0,-61.0,-58.0,-58.0,-56.0,-58.0,-55.0,-58.0,-89.0,-88.0,-84.0,-85.0,30.0,27.0,26.0,27.0,1
2707,92:69:1D:31:68:E9,3856869,489585555,4232,3718288,3852637,485867267,1,5862,1243022,5677,1200879,185,42143,2354,12,4514,104,1,66,229410.0,130000.0,-52.0,-48.0,-44.0,-48.0,-52.0,-47.0,-43.0,-48.0,-89.0,-88.0,-84.0,-85.0,37.0,40.0,40.0,37.0,1
2708,CC:2F:71:3F:1F:24,5233553,2087604280,1380916,1601737013,3852637,485867267,2222,1164723,1341635444,1163816,1341525380,907,110064,1127270,15,1379052,129365,2219,880,144444.0,43333.0,-69.0,-67.0,-67.0,-68.0,-69.0,-67.0,-67.0,-68.0,-89.0,-88.0,-84.0,-85.0,20.0,21.0,17.0,17.0,1
2709,CC:2F:71:3E:C5:1F,3853685,485995295,1048,128028,3852637,485867267,3,4573,381250,3811,290804,762,90446,1109,15,1504,31,3,54,130000.0,39000.0,-73.0,-73.0,-68.0,-59.0,-71.0,-70.0,-68.0,-59.0,-89.0,-88.0,-84.0,-85.0,16.0,15.0,16.0,26.0,1
2710,BA:8C:B9:54:50:24,3857619,492066931,4980,6199462,3852639,485867469,7,10131,1777770,10109,1774275,22,3495,2364,18,5521,44,7,79,216660.0,130000.0,-48.0,-35.0,-42.0,-45.0,-43.0,-35.0,-43.0,-47.0,-89.0,-88.0,-84.0,-85.0,41.0,53.0,42.0,40.0,1
2711,62:47:05:9D:EB:15,3869066,520496069,16426,34628540,3852640,485867529,1,13968,5315819,13897,5304916,71,10903,6630,0,16512,279,1,169,229410.0,137640.0,-58.0,-58.0,-56.0,-56.0,-56.0,-58.0,-56.0,-56.0,-89.0,-88.0,-84.0,-85.0,31.0,30.0,28.0,29.0,1
2712,92:69:1D:31:68:E9,3856872,489585817,4232,3718288,3852640,485867529,1,5862,1243022,5677,1200879,185,42143,2354,12,4514,104,1,66,229410.0,130000.0,-52.0,-48.0,-44.0,-48.0,-52.0,-47.0,-43.0,-48.0,-89.0,-88.0,-84.0,-85.0,37.0,40.0,40.0,37.0,1
2713,CC:2F:71:3F:1F:24,5233612,2087625845,1380970,1601758114,3852642,485867731,2222,1164758,1341641566,1163851,1341531502,907,110064,1127304,15,1379106,129397,2219,880,144444.0,43333.0,-73.0,-72.0,-72.0,-74.0,-71.0,-70.0,-70.0,-72.0,-89.0,-88.0,-84.0,-85.0,16.0,16.0,12.0,11.0,1
2714,CC:2F:71:3E:C5:1F,3853690,485995759,1048,128028,3852642,485867731,3,4573,381250,3811,290804,762,90446,1109,15,1504,31,3,54,130000.0,39000.0,-73.0,-73.0,-68.0,-59.0,-71.0,-70.0,-68.0,-59.0,-89.0,-88.0,-84.0,-85.0,16.0,15.0,16.0,26.0,1
2715,BA:8C:B9:54:50:24,3857624,492067395,4980,6199462,3852644,485867933,7,10131,1777770,10109,1774275,22,3495,2364,18,5521,44,7,79,216660.0,130000.0,-48.0,-35.0,-42.0,-45.0,-43.0,-35.0,-43.0,-47.0,-89.0,-88.0,-84.0,-85.0,41.0,53.0,42.0,40.0,1
2716,62:47:05:9D:EB:15,3869084,520500440,16438,34632305,3852646,485868135,1,13986,5318738,13915,5307835,71,10903,6642,0,16524,279,1,169,229410.0,137640.0,-57.0,-54.0,-56.0,-61.0,-60.0,-56.0,-58.0,-61.0,-89.0,-88.0,-84.0,-85.0,32.0,34.0,28.0,24.0,1
2717,92:69:1D:31:68:E9,3856878,489586423,4232,3718288,3852646,485868135,1,5862,1243022,5677,1200879,185,42143,2354,12,4514,104,1,66,229410.0,130000.0,-52.0,-48.0,-44.0,-48.0,-52.0,-47.0,-43.0,-48.0,-89.0,-88.0,-84.0,-85.0,37.0,40.0,40.0,37.0,1
2718,CC:2F:71:3F:1F:24,5233665,2087644081,1381017,1601775744,3852648,485868337,2222,1164785,1341646268,1163878,1341536204,907,110064,1127330,15,1379153,129424,2219,880,144444.0,43333.0,-71.0,-70.0,-69.0,-70.0,-71.0,-70.0,-68.0,-69.0,-89.0,-88.0,-84.0,-85.0,18.0,18.0,15.0,15.0,1
2719,CC:2F:71:3E:C5:1F,3853696,485996365,1048,128028,3852648,485868337,3,4573,381250,3811,290804,762,90446,1109,15,1504,31,3,54,130000.0,39000.0,-73.0,-73.0,-68.0,-59.0,-71.0,-70.0,-68.0,-59.0,-89.0,-88.0,-84.0,-85.0,16.0,15.0,16.0,26.0,1
2720,BA:8C:B9:54:50:24,3857628,492067799,4980,6199462,3852648,485868337,7,10131,1777770,10109,1774275,22,3495,2364,18,5521,44,7,79,216660.0,130000.0,-48.0,-35.0,-42.0,-45.0,-43.0,-35.0,-43.0,-47.0,-89.0,-88.0,-84.0,-85.0,41.0,53.0,42.0,40.0,1
2721,62:47:05:9D:EB:15,3869089,520500904,16438,34632305,3852651,485868599,1,14000,5319922,13929,5309019,71,10903,6644,0,16524,279,1,169,229410.0,137640.0,-58.0,-55.0,-58.0,-61.0,-58.0,-55.0,-58.0,-61.0,-89.0,-88.0,-84.0,-85.0,31.0,33.0,26.0,24.0,1
2722,92:69:1D:31:68:E9,3856883,489586887,4232,3718288,3852651,485868599,1,5862,1243022,5677,1200879,185,42143,2354,12,4514,104,1,66,229410.0,130000.0,-52.0,-48.0,-44.0,-48.0,-52.0,-47.0,-43.0,-48.0,-89.0,-88.0,-84.0,-85.0,37.0,40.0,40.0,37.0,1
2723,CC:2F:71:3F:1F:24,5233714,2087661785,1381061,1601792984,3852653,485868801,2222,1164810,1341650738,1163903,1341540674,907,110064,1127354,15,1379197,129443,2219,880,144444.0,43333.0,-70.0,-69.0,-68.0,-67.0,-70.0,-68.0,-68.0,-67.0,-89.0,-88.0,-84.0,-85.0,19.0,19.0,16.0,18.0,1
2724,CC:2F:71:3E:C5:1F,3853701,485996829,1048,128028,3852653,485868801,3,4573,381250,3811,290804,762,90446,1109,15,1504,31,3,54,130000.0,39000.0,-73.0,-73.0,-68.0,-59.0,-71.0,-70.0,-68.0,-59.0,-89.0,-88.0,-84.0,-85.0,16.0,15.0,16.0,26.0,1
2725,BA:8C:B9:54:50:24,3857636,492068527,4980,6199462,3852656,485869065,7,10131,1777770,10109,1774275,22,3495,2364,18,5521,44,7,79,216660.0,130000.0,-48.0,-35.0,-42.0,-45.0,-43.0,-35.0,-43.0,-47.0,-89.0,-88.0,-84.0,-85.0,41.0,53.0,42.0,40.0,1
2726,62:47:05:9D:EB:15,3869097,520501702,16439,34632435,3852658,485869267,1,14019,5321266,13948,5310363,71,10903,6645,0,16525,279,1,169,229410.0,137640.0,-57.0,-53.0,-56.0,-65.0,-58.0,-55.0,-58.0,-63.0,-88.0,-88.0,-84.0,-85.0,31.0,35.0,28.0,20.0,1
2727,92:69:1D:31:68:E9,3856890,489587555,4232,3718288,3852658,485869267,1,5862,1243022,5677,1200879,185,42143,2354,12,4514,104,1,66,229410.0,130000.0,-52.0,-48.0,-44.0,-48.0,-52.0,-47.0,-43.0,-48.0,-88.0,-88.0,-84.0,-85.0,36.0,40.0,40.0,37.0,1
2728,CC:2F:71:3F:1F:24,5233772,2087683222,1381114,1601813955,3852658,485869267,2222,1164844,1341656743,1163937,1341546679,907,110064,1127387,15,1379250,129459,2219,880,144444.0,43333.0,-70.0,-69.0,-69.0,-67.0,-69.0,-68.0,-68.0,-66.0,-88.0,-88.0,-84.0,-85.0,18.0,19.0,15.0,18.0,1
2729,CC:2F:71:3E:C5:1F,3853706,485997295,1048,128028,3852658,485869267,3,4575,381438,3812,290874,763,90564,1110,15,1504,31,3,55,130000.0,39000.0,-80.0,-82.0,-75.0,-71.0,-71.0,-72.0,-69.0,-61.0,-88.0,-88.0,-84.0,-85.0,8.0,6.0,9.0,14.0,1
2730,BA:8C:B9:54:50:24,3857638,492068729,4980,6199462,3852658,485869267,7,10131,1777770,10109,1774275,22,3495,2364,18,5521,44,7,79,216660.0,130000.0,-48.0,-35.0,-42.0,-45.0,-43.0,-35.0,-43.0,-47.0,-88.0,-88.0,-84.0,-85.0,40.0,53.0,42.0,40.0,1
2731,62:47:05:9D:EB:15,3869099,520501904,16439,34632435,3852660,485869469,1,14020,5321334,13949,5310431,71,10903,6645,0,16525,279,1,169,229410.0,137640.0,-58.0,-58.0,-61.0,-62.0,-58.0,-55.0,-58.0,-63.0,-88.0,-88.0,-84.0,-85.0,30.0,30.0,23.0,23.0,1
2732,92:69:1D:31:68:E9,3856894,489587959,4232,3718288,3852662,485869671,1,5862,1243022,5677,1200879,185,42143,2354,12,4514,104,1,66,229410.0,130000.0,-52.0,-48.0,-44.0,-48.0,-52.0,-47.0,-43.0,-48.0,-88.0,-88.0,-84.0,-85.0,36.0,40.0,40.0,37.0,1
2733,CC:2F:71:3F:1F:24,5233821,2087700996,1381159,1601831325,3852662,485869671,2222,1164869,1341661213,1163962,1341551149,907,110064,1127411,15,1379295,129477,2219,880,144444.0,43333.0,-70.0,-69.0,-68.0,-66.0,-69.0,-69.0,-68.0,-66.0,-88.0,-88.0,-84.0,-85.0,18.0,19.0,16.0,19.0,1
2734,CC:2F:71:3E:C5:1F,3853712,485997901,1048,128028,3852664,485869873,3,4575,381438,3812,290874,763,90564,1110,15,1504,31,3,55,130000.0,39000.0,-80.0,-82.0,-75.0,-71.0,-71.0,-72.0,-69.0,-61.0,-88.0,-88.0,-84.0,-85.0,8.0,6.0,9.0,14.0,1
2735,BA:8C:B9:54:50:24,3857645,492069395,4980,6199462,3852665,485869933,7,10131,1777770,10109,1774275,22,3495,2364,18,5521,44,7,79,216660.0,130000.0,-48.0,-35.0,-42.0,-45.0,-43.0,-35.0,-43.0,-47.0,-88.0,-88.0,-84.0,-85.0,40.0,53.0,42.0,40.0,1
2736,62:47:05:9D:EB:15,3869106,520502570,16439,34632435,3852667,485870135,1,14020,5321334,13949,5310431,71,10903,6645,0,16525,279,1,169,229410.0,137640.0,-58.0,-58.0,-61.0,-62.0,-58.0,-55.0,-58.0,-63.0,-88.0,-88.0,-84.0,-85.0,30.0,30.0,23.0,23.0,1
2737,92:69:1D:31:68:E9,3856899,489588423,4232,3718288,3852667,485870135,1,5862,1243022,5677,1200879,185,42143,2354,12,4514,104,1,66,229410.0,130000.0,-52.0,-48.0,-44.0,-48.0,-52.0,-47.0,-43.0,-48.0,-88.0,-88.0,-84.0,-85.0,36.0,40.0,40.0,37.0,1
2738,CC:2F:71:3F:1F:24,5233871,2087718774,1381204,1601848639,3852667,485870135,2222,1164897,1341666031,1163990,1341555967,907,110064,1127438,15,1379340,129495,2219,880,130000.0,39000.0,-70.0,-69.0,-68.0,-67.0,-70.0,-69.0,-68.0,-67.0,-88.0,-88.0,-84.0,-85.0,18.0,19.0,16.0,18.0,1
2739,CC:2F:71:3E:C5:1F,3853715,485998163,1048,128028,3852667,485870135,3,4575,381438,3812,290874,763,90564,1110,15,1504,31,3,55,130000.0,39000.0,-80.0,-82.0,-75.0,-71.0,-71.0,-72.0,-69.0,-61.0,-88.0,-88.0,-84.0,-85.0,8.0,6.0,9.0,14.0,1
2740,BA:8C:B9:54:50:24,3857647,492069597,4980,6199462,3852667,485870135,7,10131,1777770,10109,1774275,22,3495,2364,18,5521,44,7,79,216660.0,130000.0,-48.0,-35.0,-42.0,-45.0,-43.0,-35.0,-43.0,-47.0,-88.0,-88.0,-84.0,-85.0,40.0,53.0,42.0,40.0,1
2741,62:47:05:9D:EB:15,3869110,520502974,16439,34632435,3852671,485870539,1,14020,5321334,13949,5310431,71,10903,6645,0,16525,279,1,169,229410.0,137640.0,-58.0,-58.0,-61.0,-62.0,-58.0,-55.0,-58.0,-63.0,-88.0,-88.0,-84.0,-85.0,30.0,30.0,23.0,23.0,1
2742,92:69:1D:31:68:E9,3856905,489589029,4232,3718288,3852673,485870741,1,5862,1243022,5677,1200879,185,42143,2354,12,4514,104,1,66,229410.0,130000.0,-52.0,-48.0,-44.0,-48.0,-52.0,-47.0,-43.0,-48.0,-88.0,-88.0,-84.0,-85.0,36.0,40.0,40.0,37.0,1
2743,CC:2F:71:3F:1F:24,5233923,2087736768,1381250,1601866027,3852673,485870741,2222,1164922,1341670501,1164015,1341560437,907,110064,1127462,15,1379386,129508,2219,880,144444.0,43333.0,-70.0,-69.0,-68.0,-67.0,-70.0,-68.0,-68.0,-67.0,-88.0,-88.0,-84.0,-85.0,18.0,19.0,16.0,18.0,1
2744,CC:2F:71:3E:C5:1F,3853721,485998769,1048,128028,3852673,485870741,3,4575,381438,3812,290874,763,90564,1110,15,1504,31,3,55,130000.0,39000.0,-80.0,-82.0,-75.0,-71.0,-71.0,-72.0,-69.0,-61.0,-88.0,-88.0,-84.0,-85.0,8.0,6.0,9.0,14.0,1
2745,BA:8C:B9:54:50:24,3857653,492070203,4980,6199462,3852673,485870741,7,10131,1777770,10109,1774275,22,3495,2364,18,5521,44,7,79,216660.0,130000.0,-48.0,-35.0,-42.0,-45.0,-43.0,-35.0,-43.0,-47.0,-88.0,-88.0,-84.0,-85.0,40.0,53.0,42.0,40.0,1
2746,62:47:05:9D:EB:15,3869119,520505968,16443,34634965,3852676,485871003,1,14035,5324763,13964,5313860,71,10903,6651,0,16529,279,1,169,229410.0,137640.0,-59.0,-57.0,-59.0,-61.0,-58.0,-56.0,-58.0,-61.0,-88.0,-88.0,-84.0,-85.0,29.0,31.0,25.0,24.0,1
2747,92:69:1D:31:68:E9,3856908,489589291,4232,3718288,3852676,485871003,1,5864,1243158,5679,1201015,185,42143,2354,12,4515,104,1,66,229410.0,130000.0,-52.0,-47.0,-42.0,-49.0,-52.0,-47.0,-43.0,-48.0,-88.0,-88.0,-84.0,-85.0,36.0,41.0,42.0,36.0,1
2748,CC:2F:71:3F:1F:24,5233980,2087758147,1381304,1601887144,3852676,485871003,2222,1164955,1341676390,1164048,1341566326,907,110064,1127494,15,1379440,129532,2219,880,144444.0,43333.0,-70.0,-70.0,-69.0,-68.0,-70.0,-70.0,-69.0,-67.0,-88.0,-88.0,-84.0,-85.0,18.0,18.0,15.0,17.0,1
2749,CC:2F:71:3E:C5:1F,3853724,485999031,1048,128028,3852676,485871003,3,4575,381438,3812,290874,763,90564,1110,15,1504,31,3,55,130000.0,39000.0,-80.0,-82.0,-75.0,-71.0,-71.0,-72.0,-69.0,-61.0,-88.0,-88.0,-84.0,-85.0,8.0,6.0,9.0,14.0,1
2750,BA:8C:B9:54:50:24,3857656,492070465,4980,6199462,3852676,485871003,7,10136,1778110,10114,1774615,22,3495,2364,18,5522,44,7,79,216660.0,130000.0,-40.0,-36.0,-45.0,-51.0,-42.0,-35.0,-44.0,-48.0,-88.0,-88.0,-84.0,-85.0,48.0,52.0,39.0,34.0,1
2751,62:47:05:9D:EB:15,3869126,520506704,16444,34635095,3852682,485871609,1,14036,5324831,13965,5313928,71,10903,6651,0,16530,279,1,169,229410.0,137640.0,-58.0,-54.0,-56.0,-64.0,-58.0,-56.0,-58.0,-61.0,-88.0,-88.0,-84.0,-85.0,30.0,34.0,28.0,21.0,1
2752,92:69:1D:31:68:E9,3856914,489589897,4232,3718288,3852682,485871609,1,5864,1243158,5679,1201015,185,42143,2354,12,4515,104,1,66,229410.0,130000.0,-52.0,-47.0,-42.0,-49.0,-52.0,-47.0,-43.0,-48.0,-88.0,-88.0,-84.0,-85.0,36.0,41.0,42.0,36.0,1
2753,CC:2F:71:3F:1F:24,5234033,2087776383,1381351,1601904774,3852682,485871609,2222,1164981,1341680976,1164074,1341570912,907,110064,1127519,15,1379487,129549,2219,880,144444.0,43333.0,-70.0,-70.0,-69.0,-68.0,-70.0,-70.0,-68.0,-67.0,-88.0,-88.0,-84.0,-85.0,18.0,18.0,15.0,17.0,1
2754,CC:2F:71:3E:C5:1F,3853730,485999637,1048,128028,3852682,485871609,3,4575,381438,3812,290874,763,90564,1110,15,1504,31,3,55,130000.0,39000.0,-80.0,-82.0,-75.0,-71.0,-71.0,-72.0,-69.0,-61.0,-88.0,-88.0,-84.0,-85.0,8.0,6.0,9.0,14.0,1
2755,BA:8C:B9:54:50:24,3857662,492071071,4980,6199462,3852682,485871609,7,10136,1778110,10114,1774615,22,3495,2364,18,5522,44,7,79,216660.0,130000.0,-40.0,-36.0,-45.0,-51.0,-42.0,-35.0,-44.0,-48.0,-88.0,-88.0,-84.0,-85.0,48.0,52.0,39.0,34.0,1
2756,62:47:05:9D:EB:15,3869129,520507179,16444,34635095,3852685,485872084,1,14036,5324831,13965,5313928,71,10903,6651,0,16530,279,1,169,229410.0,137640.0,-58.0,-54.0,-56.0,-64.0,-58.0,-56.0,-58.0,-61.0,-88.0,-88.0,-84.0,-85.0,30.0,34.0,28.0,21.0,1
2757,92:69:1D:31:68:E9,3856917,489590372,4232,3718288,3852685,485872084,1,5864,1243158,5679,1201015,185,42143,2354,12,4515,104,1,66,229410.0,130000.0,-52.0,-47.0,-42.0,-49.0,-52.0,-47.0,-43.0,-48.0,-88.0,-88.0,-84.0,-85.0,36.0,41.0,42.0,36.0,1
2758,CC:2F:71:3F:1F:24,5234081,2087794228,1381396,1601922144,3852685,485872084,2222,1165006,1341685446,1164099,1341575382,907,110064,1127543,15,1379532,129575,2219,880,144444.0,43333.0,-71.0,-68.0,-70.0,-70.0,-70.0,-68.0,-69.0,-70.0,-88.0,-88.0,-84.0,-85.0,17.0,20.0,14.0,15.0,1
2759,CC:2F:71:3E:C5:1F,3853733,486000112,1048,128028,3852685,485872084,3,4575,381438,3812,290874,763,90564,1110,15,1504,31,3,55,130000.0,39000.0,-80.0,-82.0,-75.0,-71.0,-71.0,-72.0,-69.0,-61.0,-88.0,-88.0,-84.0,-85.0,8.0,6.0,9.0,14.0,1
2760,BA:8C:B9:54:50:24,3857666,492071606,4980,6199462,3852686,485872144,7,10136,1778110,10114,1774615,22,3495,2364,18,5522,44,7,79,216660.0,130000.0,-40.0,-36.0,-45.0,-51.0,-42.0,-35.0,-44.0,-48.0,-88.0,-88.0,-84.0,-85.0,48.0,52.0,39.0,34.0,1
2761,62:47:05:9D:EB:15,3869157,520529895,16465,34657145,3852692,485872750,1,14065,5331789,13994,5320886,71,10903,6662,0,16551,282,1,169,229410.0,137640.0,-55.0,-59.0,-53.0,-60.0,-54.0,-58.0,-52.0,-60.0,-88.0,-87.0,-84.0,-85.0,33.0,28.0,31.0,25.0,1
2762,92:69:1D:31:68:E9,3856924,489591038,4232,3718288,3852692,485872750,1,5864,1243158,5679,1201015,185,42143,2354,12,4515,104,1,66,229410.0,130000.0,-52.0,-47.0,-42.0,-49.0,-52.0,-47.0,-43.0,-48.0,-88.0,-87.0,-84.0,-85.0,36.0,40.0,42.0,36.0,1
2763,CC:2F:71:3F:1F:24,5234134,2087812410,1381442,1601939660,3852692,485872750,2222,1165032,1341690032,1164125,1341579968,907,110064,1127568,15,1379578,129592,2219,880,144444.0,43333.0,-69.0,-66.0,-67.0,-69.0,-69.0,-66.0,-67.0,-69.0,-88.0,-87.0,-84.0,-85.0,19.0,21.0,17.0,16.0,1
2764,CC:2F:71:3E:C5:1F,3853740,486000778,1048,128028,3852692,485872750,3,4575,381438,3812,290874,763,90564,1110,15,1504,31,3,55,130000.0,39000.0,-80.0,-82.0,-75.0,-71.0,-71.0,-72.0,-69.0,-61.0,-88.0,-87.0,-84.0,-85.0,8.0,5.0,9.0,14.0,1
2765,BA:8C:B9:54:50:24,3857672,492072212,4980,6199462,3852692,485872750,7,10136,1778110,10114,1774615,22,3495,2364,18,5522,44,7,79,216660.0,130000.0,-40.0,-36.0,-45.0,-51.0,-42.0,-35.0,-44.0,-48.0,-88.0,-87.0,-84.0,-85.0,48.0,51.0,39.0,34.0,1
2766,62:47:05:9D:EB:15,3869161,520530396,16467,34657444,3852694,485872952,1,14068,5332084,13997,5321181,71,10903,6663,0,16553,282,1,169,229410.0,137640.0,-58.0,-55.0,-53.0,-60.0,-55.0,-57.0,-52.0,-59.0,-88.0,-87.0,-84.0,-85.0,30.0,32.0,31.0,25.0,1
2767,92:69:1D:31:68:E9,3856926,489591240,4232,3718288,3852694,485872952,1,5864,1243158,5679,1201015,185,42143,2354,12,4515,104,1,66,229410.0,130000.0,-52.0,-47.0,-42.0,-49.0,-52.0,-47.0,-43.0,-48.0,-88.0,-87.0,-84.0,-85.0,36.0,40.0,42.0,36.0,1
2768,CC:2F:71:3F:1F:24,5234189,2087833599,1381495,1601960647,3852694,485872952,2222,1165066,1341695991,1164159,1341585927,907,110064,1127600,15,1379631,129606,2219,880,144444.0,43333.0,-71.0,-68.0,-68.0,-69.0,-70.0,-67.0,-68.0,-69.0,-88.0,-87.0,-84.0,-85.0,17.0,19.0,16.0,16.0,1
2769,CC:2F:71:3E:C5:1F,3853743,486001091,1048,128028,3852695,485873063,3,4575,381438,3812,290874,763,90564,1110,15,1504,31,3,55,130000.0,39000.0,-80.0,-82.0,-75.0,-71.0,-71.0,-72.0,-69.0,-61.0,-88.0,-87.0,-84.0,-85.0,8.0,5.0,9.0,14.0,1
2770,BA:8C:B9:54:50:24,3857675,492072525,4980,6199462,3852695,485873063,7,10136,1778110,10114,1774615,22,3495,2364,18,5522,44,7,79,216660.0,130000.0,-40.0,-36.0,-45.0,-51.0,-42.0,-35.0,-44.0,-48.0,-88.0,-87.0,-84.0,-85.0,48.0,51.0,39.0,34.0,1
2771,62:47:05:9D:EB:15,3869184,520535455,16482,34661726,3852702,485873729,1,14116,5355027,14044,5343953,72,11074,6681,0,16568,282,1,169,216660.0,130000.0,-57.0,-54.0,-49.0,-56.0,-58.0,-54.0,-51.0,-58.0,-88.0,-87.0,-84.0,-85.0,31.0,33.0,35.0,29.0,1
2772,92:69:1D:31:68:E9,3856934,489592017,4232,3718288,3852702,485873729,1,5864,1243158,5679,1201015,185,42143,2354,12,4515,104,1,66,229410.0,130000.0,-52.0,-47.0,-42.0,-49.0,-52.0,-47.0,-43.0,-48.0,-88.0,-87.0,-84.0,-85.0,36.0,40.0,42.0,36.0,1
2773,CC:2F:71:3F:1F:24,5234245,2087852136,1381543,1601978407,3852702,485873729,2222,1165091,1341700461,1164184,1341590397,907,110064,1127624,15,1379679,129612,2219,880,144444.0,43333.0,-71.0,-69.0,-68.0,-69.0,-71.0,-69.0,-67.0,-69.0,-88.0,-87.0,-84.0,-85.0,17.0,18.0,16.0,16.0,1
2774,CC:2F:71:3E:C5:1F,3853750,486001757,1048,128028,3852702,485873729,3,4575,381438,3812,290874,763,90564,1110,15,1504,31,3,55,130000.0,39000.0,-80.0,-82.0,-75.0,-71.0,-71.0,-72.0,-69.0,-61.0,-88.0,-87.0,-84.0,-85.0,8.0,5.0,9.0,14.0,1
2775,BA:8C:B9:54:50:24,3857682,492073191,4980,6199462,3852702,485873729,7,10136,1778110,10114,1774615,22,3495,2364,18,5522,44,7,79,216660.0,130000.0,-40.0,-36.0,-45.0,-51.0,-42.0,-35.0,-44.0,-48.0,-88.0,-87.0,-84.0,-85.0,48.0,51.0,39.0,34.0,1
2776,62:47:05:9D:EB:15,3869188,520535969,16484,34662038,3852704,485873931,1,14146,5357371,14074,5346297,72,11074,6685,0,16570,282,1,169,216660.0,130000.0,-56.0,-54.0,-49.0,-55.0,-58.0,-55.0,-51.0,-58.0,-88.0,-87.0,-84.0,-85.0,32.0,33.0,35.0,30.0,1
2777,92:69:1D:31:68:E9,3856936,489592219,4232,3718288,3852704,485873931,1,5864,1243158,5679,1201015,185,42143,2354,12,4515,104,1,66,229410.0,130000.0,-52.0,-47.0,-42.0,-49.0,-52.0,-47.0,-43.0,-48.0,-88.0,-87.0,-84.0,-85.0,36.0,40.0,42.0,36.0,1
2778,CC:2F:71:3F:1F:24,5234294,2087869968,1381590,1601996037,3852704,485873931,2222,1165121,1341705635,1164214,1341595571,907,110064,1127651,15,1379726,129617,2219,880,144444.0,43333.0,-72.0,-68.0,-68.0,-70.0,-72.0,-68.0,-67.0,-69.0,-88.0,-87.0,-84.0,-85.0,16.0,19.0,16.0,15.0,1
2779,CC:2F:71:3E:C5:1F,3853752,486001959,1048,128028,3852704,485873931,3,4575,381438,3812,290874,763,90564,1110,15,1504,31,3,55,130000.0,39000.0,-80.0,-82.0,-75.0,-71.0,-71.0,-72.0,-69.0,-61.0,-88.0,-87.0,-84.0,-85.0,8.0,5.0,9.0,14.0,1
2780,BA:8C:B9:54:50:24,3857686,492073595,4980,6199462,3852706,485874133,7,10136,1778110,10114,1774615,22,3495,2364,18,5522,44,7,79,216660.0,130000.0,-40.0,-36.0,-45.0,-51.0,-42.0,-35.0,-44.0,-48.0,-88.0,-87.0,-84.0,-85.0,48.0,51.0,39.0,34.0,1
2781,62:47:05:9D:EB:15,3869199,520537546,16489,34663009,3852710,485874537,1,14180,5360120,14108,5349046,72,11074,6691,0,16575,282,1,169,216660.0,130000.0,-60.0,-57.0,-53.0,-59.0,-60.0,-57.0,-52.0,-58.0,-88.0,-87.0,-84.0,-85.0,28.0,30.0,31.0,26.0,1
2782,92:69:1D:31:68:E9,3856942,489592825,4232,3718288,3852710,485874537,1,5864,1243158,5679,1201015,185,42143,2354,12,4515,104,1,66,229410.0,130000.0,-52.0,-47.0,-42.0,-49.0,-52.0,-47.0,-43.0,-48.0,-88.0,-87.0,-84.0,-85.0,36.0,40.0,42.0,36.0,1
2783,CC:2F:71:3F:1F:24,5234345,2087887944,1381635,1602013407,3852710,485874537,2222,1165147,1341710331,1164240,1341600267,907,110064,1127675,15,1379771,129619,2219,880,144444.0,43333.0,-72.0,-68.0,-68.0,-69.0,-72.0,-68.0,-67.0,-69.0,-88.0,-87.0,-84.0,-85.0,16.0,19.0,16.0,16.0,1
2784,CC:2F:71:3E:C5:1F,3853758,486002565,1048,128028,3852710,485874537,3,4575,381438,3812,290874,763,90564,1110,15,1504,31,3,55,130000.0,39000.0,-80.0,-82.0,-75.0,-71.0,-71.0,-72.0,-69.0,-61.0,-88.0,-87.0,-84.0,-85.0,8.0,5.0,9.0,14.0,1
2785,BA:8C:B9:54:50:24,3857691,492074059,4980,6199462,3852711,485874597,7,10136,1778110,10114,1774615,22,3495,2364,18,5522,44,7,79,216660.0,130000.0,-40.0,-36.0,-45.0,-51.0,-42.0,-35.0,-44.0,-48.0,-88.0,-87.0,-84.0,-85.0,48.0,51.0,39.0,34.0,1
2786,62:47:05:9D:EB:15,3869203,520537938,16490,34663139,3852713,485874799,1,14203,5361775,14131,5350701,72,11074,6692,0,16575,282,1,169,216660.0,130000.0,-55.0,-56.0,-51.0,-62.0,-55.0,-55.0,-50.0,-60.0,-88.0,-88.0,-85.0,-85.0,33.0,32.0,34.0,23.0,1
2787,92:69:1D:31:68:E9,3856945,489593087,4232,3718288,3852713,485874799,1,5864,1243158,5679,1201015,185,42143,2354,12,4515,104,1,66,229410.0,130000.0,-52.0,-47.0,-42.0,-49.0,-52.0,-47.0,-43.0,-48.0,-88.0,-88.0,-85.0,-85.0,36.0,41.0,43.0,36.0,1
2788,CC:2F:71:3F:1F:24,5234402,2087909249,1381687,1602034248,3852715,485875001,2222,1165180,1341716220,1164273,1341606156,907,110064,1127707,15,1379823,129621,2219,880,144444.0,43333.0,-76.0,-71.0,-72.0,-76.0,-74.0,-69.0,-70.0,-74.0,-88.0,-88.0,-85.0,-85.0,12.0,17.0,13.0,9.0,1
2789,CC:2F:71:3E:C5:1F,3853763,486003029,1048,128028,3852715,485875001,3,4575,381438,3812,290874,763,90564,1110,15,1504,31,3,55,130000.0,39000.0,-80.0,-82.0,-75.0,-71.0,-71.0,-72.0,-69.0,-61.0,-88.0,-88.0,-85.0,-85.0,8.0,6.0,10.0,14.0,1
2790,BA:8C:B9:54:50:24,3857695,492074463,4980,6199462,3852715,485875001,7,10136,1778110,10114,1774615,22,3495,2364,18,5522,44,7,79,216660.0,130000.0,-40.0,-36.0,-45.0,-51.0,-42.0,-35.0,-44.0,-48.0,-88.0,-88.0,-85.0,-85.0,48.0,52.0,40.0,34.0,1
2791,62:47:05:9D:EB:15,3869213,520540435,16494,34665030,3852719,485875405,1,14225,5364225,14153,5353151,72,11074,6698,0,16580,282,1,169,216660.0,130000.0,-55.0,-54.0,-50.0,-66.0,-56.0,-55.0,-52.0,-67.0,-88.0,-88.0,-85.0,-85.0,33.0,34.0,35.0,19.0,1
2792,92:69:1D:31:68:E9,3856951,489593693,4232,3718288,3852719,485875405,1,5864,1243158,5679,1201015,185,42143,2354,12,4515,104,1,66,229410.0,130000.0,-52.0,-47.0,-42.0,-49.0,-52.0,-47.0,-43.0,-48.0,-88.0,-88.0,-85.0,-85.0,36.0,41.0,43.0,36.0,1
2793,CC:2F:71:3F:1F:24,5234451,2087927023,1381732,1602051618,3852719,485875405,2222,1165205,1341720690,1164298,1341610626,907,110064,1127731,15,1379868,129624,2219,880,144444.0,43333.0,-72.0,-69.0,-69.0,-72.0,-72.0,-69.0,-69.0,-72.0,-88.0,-88.0,-85.0,-85.0,16.0,19.0,16.0,13.0,1
2794,CC:2F:71:3E:C5:1F,3853767,486003433,1048,128028,3852719,485875405,3,4575,381438,3812,290874,763,90564,1110,15,1504,31,3,55,130000.0,39000.0,-80.0,-82.0,-75.0,-71.0,-71.0,-72.0,-69.0,-61.0,-88.0,-88.0,-85.0,-85.0,8.0,6.0,10.0,14.0,1
2795,BA:8C:B9:54:50:24,3857699,492074867,4980,6199462,3852719,485875405,7,10136,1778110,10114,1774615,22,3495,2364,18,5522,44,7,79,216660.0,130000.0,-40.0,-36.0,-45.0,-51.0,-42.0,-35.0,-44.0,-48.0,-88.0,-88.0,-85.0,-85.0,48.0,52.0,40.0,34.0,1
2796,62:47:05:9D:EB:15,3869218,520540899,16494,34665030,3852724,485875869,1,14225,5364225,14153,5353151,72,11074,6698,0,16580,282,1,169,216660.0,130000.0,-55.0,-54.0,-50.0,-66.0,-56.0,-55.0,-52.0,-67.0,-88.0,-88.0,-85.0,-85.0,33.0,34.0,35.0,19.0,1
2797,92:69:1D:31:68:E9,3856956,489594157,4232,3718288,3852724,485875869,1,5864,1243158,5679,1201015,185,42143,2354,12,4515,104,1,66,229410.0,130000.0,-52.0,-47.0,-42.0,-49.0,-52.0,-47.0,-43.0,-48.0,-88.0,-88.0,-85.0,-85.0,36.0,41.0,43.0,36.0,1
2798,CC:2F:71:3F:1F:24,5234500,2087944727,1381776,1602068858,3852724,485875869,2222,1165230,1341725160,1164323,1341615096,907,110064,1127755,15,1379912,129630,2219,880,144444.0,43333.0,-71.0,-68.0,-69.0,-71.0,-70.0,-68.0,-69.0,-71.0,-88.0,-88.0,-85.0,-85.0,17.0,20.0,16.0,14.0,1
2799,CC:2F:71:3E:C5:1F,3853772,486003897,1048,128028,3852724,485875869,3,4575,381438,3812,290874,763,90564,1110,15,1504,31,3,55,130000.0,39000.0,-80.0,-82.0,-75.0,-71.0,-71.0,-72.0,-69.0,-61.0,-88.0,-88.0,-85.0,-85.0,8.0,6.0,10.0,14.0,1
2800,BA:8C:B9:54:50:24,3857704,492075331,4980,6199462,3852724,485875869,7,10136,1778110,10114,1774615,22,3495,2364,18,5522,44,7,79,216660.0,130000.0,-40.0,-36.0,-45.0,-51.0,-42.0,-35.0,-44.0,-48.0,-88.0,-88.0,-85.0,-85.0,48.0,52.0,40.0,34.0,1
2801,62:47:05:9D:EB:15,3869224,520541588,16496,34665315,3852728,485876273,1,14241,5365456,14169,5354382,72,11074,6700,0,16582,282,1,169,216660.0,130000.0,-55.0,-55.0,-51.0,-64.0,-55.0,-55.0,-53.0,-64.0,-88.0,-88.0,-85.0,-85.0,33.0,33.0,34.0,21.0,1
2802,92:69:1D:31:68:E9,3856961,489594677,4233,3718404,3852728,485876273,1,5866,1243294,5681,1201151,185,42143,2354,12,4516,104,1,66,229410.0,130000.0,-53.0,-48.0,-42.0,-49.0,-52.0,-47.0,-43.0,-48.0,-88.0,-88.0,-85.0,-85.0,35.0,40.0,43.0,36.0,1
2803,CC:2F:71:3F:1F:24,5234549,2087962487,1381821,1602086214,3852728,485876273,2222,1165257,1341729770,1164350,1341619706,907,110064,1127779,15,1379957,129637,2219,880,144444.0,43333.0,-71.0,-67.0,-69.0,-71.0,-70.0,-67.0,-69.0,-71.0,-88.0,-88.0,-85.0,-85.0,17.0,21.0,16.0,14.0,1
2804,CC:2F:71:3E:C5:1F,3853777,486004417,1049,128144,3852728,485876273,3,4577,381578,3814,291014,763,90564,1110,15,1505,31,3,55,130000.0,39000.0,-68.0,-64.0,-65.0,-59.0,-71.0,-71.0,-68.0,-60.0,-88.0,-88.0,-85.0,-85.0,20.0,24.0,20.0,26.0,1
2805,BA:8C:B9:54:50:24,3857709,492075851,4981,6199578,3852728,485876273,7,10138,1778246,10116,1774751,22,3495,2364,18,5523,44,7,79,216660.0,130000.0,-48.0,-35.0,-43.0,-46.0,-43.0,-35.0,-44.0,-49.0,-88.0,-88.0,-85.0,-85.0,40.0,53.0,42.0,39.0,1
2806,62:47:05:9D:EB:15,3869228,520541992,16496,34665315,3852732,485876677,1,14241,5365456,14169,5354382,72,11074,6700,0,16582,282,1,169,216660.0,130000.0,-55.0,-55.0,-51.0,-64.0,-55.0,-55.0,-53.0,-64.0,-88.0,-88.0,-85.0,-85.0,33.0,33.0,34.0,21.0,1
2807,92:69:1D:31:68:E9,3856965,489595081,4233,3718404,3852732,485876677,1,5866,1243294,5681,1201151,185,42143,2354,12,4516,104,1,66,229410.0,130000.0,-53.0,-48.0,-42.0,-49.0,-52.0,-47.0,-43.0,-48.0,-88.0,-88.0,-85.0,-85.0,35.0,40.0,43.0,36.0,1
2808,CC:2F:71:3F:1F:24,5234606,2087983862,1381874,1602107185,3852732,485876677,2222,1165290,1341735615,1164383,1341625551,907,110064,1127810,15,1380010,129652,2219,880,144444.0,43333.0,-71.0,-68.0,-70.0,-71.0,-70.0,-67.0,-69.0,-71.0,-88.0,-88.0,-85.0,-85.0,17.0,20.0,15.0,14.0,1
2809,CC:2F:71:3E:C5:1F,3853781,486004821,1049,128144,3852732,485876677,3,4577,381578,3814,291014,763,90564,1110,15,1505,31,3,55,130000.0,39000.0,-68.0,-64.0,-65.0,-59.0,-71.0,-71.0,-68.0,-60.0,-88.0,-88.0,-85.0,-85.0,20.0,24.0,20.0,26.0,1
2810,BA:8C:B9:54:50:24,3857715,492076377,4981,6199578,3852734,485876799,7,10138,1778246,10116,1774751,22,3495,2364,18,5523,44,7,79,216660.0,130000.0,-48.0,-35.0,-43.0,-46.0,-43.0,-35.0,-44.0,-49.0,-88.0,-88.0,-85.0,-85.0,40.0,53.0,42.0,39.0,1
2811,62:47:05:9D:EB:15,3869235,520542580,16496,34665315,3852739,485877265,1,14260,5366748,14188,5355674,72,11074,6700,0,16582,282,1,169,216660.0,130000.0,-55.0,-55.0,-51.0,-64.0,-55.0,-55.0,-50.0,-64.0,-88.0,-88.0,-85.0,-85.0,33.0,33.0,34.0,21.0,1
2812,92:69:1D:31:68:E9,3856972,489595669,4233,3718404,3852739,485877265,1,5866,1243294,5681,1201151,185,42143,2354,12,4516,104,1,66,229410.0,130000.0,-53.0,-48.0,-42.0,-49.0,-52.0,-47.0,-43.0,-48.0,-88.0,-88.0,-85.0,-85.0,35.0,40.0,43.0,36.0,1
2813,CC:2F:71:3F:1F:24,5234658,2088001820,1381919,1602124555,3852739,485877265,2222,1165319,1341740817,1164411,1341630635,908,110182,1127835,15,1380055,129660,2219,880,144444.0,43333.0,-71.0,-68.0,-69.0,-72.0,-70.0,-67.0,-69.0,-71.0,-88.0,-88.0,-85.0,-85.0,17.0,20.0,16.0,13.0,1
2814,CC:2F:71:3E:C5:1F,3853788,486005409,1049,128144,3852739,485877265,3,4579,381766,3815,291084,764,90682,1111,15,1505,31,3,55,130000.0,39000.0,-71.0,-71.0,-69.0,-59.0,-71.0,-71.0,-68.0,-60.0,-88.0,-88.0,-85.0,-85.0,17.0,17.0,16.0,26.0,1
2815,BA:8C:B9:54:50:24,3857722,492077045,4981,6199578,3852741,485877467,7,10138,1778246,10116,1774751,22,3495,2364,18,5523,44,7,79,216660.0,130000.0,-48.0,-35.0,-43.0,-46.0,-43.0,-35.0,-44.0,-49.0,-88.0,-88.0,-85.0,-85.0,40.0,53.0,42.0,39.0,1
2816,62:47:05:9D:EB:15,3869241,520543319,16496,34665315,3852745,485878004,1,14262,5366938,14189,5355742,73,11196,6701,0,16582,282,1,169,216660.0,130000.0,-56.0,-55.0,-54.0,-64.0,-55.0,-55.0,-51.0,-64.0,-88.0,-88.0,-85.0,-85.0,32.0,33.0,31.0,21.0,1
2817,92:69:1D:31:68:E9,3856978,489596408,4233,3718404,3852745,485878004,1,5866,1243294,5681,1201151,185,42143,2354,12,4516,104,1,66,229410.0,130000.0,-53.0,-48.0,-42.0,-49.0,-52.0,-47.0,-43.0,-48.0,-88.0,-88.0,-85.0,-85.0,35.0,40.0,43.0,36.0,1
2818,CC:2F:71:3F:1F:24,5234709,2088019945,1381964,1602141941,3852745,485878004,2222,1165347,1341745949,1164439,1341635767,908,110182,1127859,15,1380100,129667,2219,880,144444.0,43333.0,-77.0,-73.0,-75.0,-77.0,-74.0,-71.0,-72.0,-75.0,-88.0,-88.0,-85.0,-85.0,11.0,15.0,10.0,8.0,1
2819,CC:2F:71:3E:C5:1F,3853794,486006148,1049,128144,3852745,485878004,3,4579,381766,3815,291084,764,90682,1111,15,1505,31,3,55,130000.0,39000.0,-71.0,-71.0,-69.0,-59.0,-71.0,-71.0,-68.0,-60.0,-88.0,-88.0,-85.0,-85.0,17.0,17.0,16.0,26.0,1
2820,BA:8C:B9:54:50:24,3857728,492077784,4981,6199578,3852747,485878206,7,10138,1778246,10116,1774751,22,3495,2364,18,5523,44,7,79,216660.0,130000.0,-48.0,-35.0,-43.0,-46.0,-43.0,-35.0,-44.0,-49.0,-88.0,-88.0,-85.0,-85.0,40.0,53.0,42.0,39.0,1
2821,62:47:05:9D:EB:15,3869248,520544898,16498,34666430,3852750,485878468,1,14271,5370201,14198,5359005,73,11196,6704,0,16584,282,1,169,229410.0,130000.0,-56.0,-54.0,-53.0,-63.0,-55.0,-54.0,-52.0,-63.0,-88.0,-88.0,-85.0,-85.0,32.0,34.0,32.0,22.0,1
2822,92:69:1D:31:68:E9,3856983,489596872,4233,3718404,3852750,485878468,1,5866,1243294,5681,1201151,185,42143,2354,12,4516,104,1,66,229410.0,130000.0,-53.0,-48.0,-42.0,-49.0,-52.0,-47.0,-43.0,-48.0,-88.0,-88.0,-85.0,-85.0,35.0,40.0,43.0,36.0,1
2823,CC:2F:71:3F:1F:24,5234761,2088037997,1382009,1602159327,3852752,485878670,2222,1165379,1341751609,1164471,1341641427,908,110182,1127887,15,1380145,129676,2219,880,144444.0,43333.0,-71.0,-68.0,-69.0,-72.0,-71.0,-68.0,-69.0,-72.0,-88.0,-88.0,-85.0,-85.0,17.0,20.0,16.0,13.0,1
2824,CC:2F:71:3E:C5:1F,3853801,486006814,1049,128144,3852752,485878670,3,4579,381766,3815,291084,764,90682,1111,15,1505,31,3,55,130000.0,39000.0,-71.0,-71.0,-69.0,-59.0,-71.0,-71.0,-68.0,-60.0,-88.0,-88.0,-85.0,-85.0,17.0,17.0,16.0,26.0,1
2825,BA:8C:B9:54:50:24,3857733,492078248,4981,6199578,3852752,485878670,7,10138,1778246,10116,1774751,22,3495,2364,18,5523,44,7,79,216660.0,130000.0,-48.0,-35.0,-43.0,-46.0,-43.0,-35.0,-44.0,-49.0,-88.0,-88.0,-85.0,-85.0,40.0,53.0,42.0,39.0,1
2826,62:47:05:9D:EB:15,3869253,520545376,16499,34666504,3852754,485878872,1,14308,5372821,14235,5361625,73,11196,6706,0,16585,282,1,170,229410.0,130000.0,-58.0,-58.0,-53.0,-66.0,-56.0,-55.0,-54.0,-64.0,-89.0,-88.0,-85.0,-86.0,31.0,30.0,32.0,20.0,1
2827,92:69:1D:31:68:E9,3856987,489597276,4233,3718404,3852754,485878872,1,5866,1243294,5681,1201151,185,42143,2354,12,4516,104,1,66,229410.0,130000.0,-53.0,-48.0,-42.0,-49.0,-52.0,-47.0,-43.0,-48.0,-89.0,-88.0,-85.0,-86.0,36.0,40.0,43.0,37.0,1
2828,CC:2F:71:3F:1F:24,5234815,2088059040,1382061,1602180168,3852754,485878872,2222,1165411,1341757382,1164503,1341647200,908,110182,1127918,15,1380197,129687,2219,880,144444.0,43333.0,-71.0,-67.0,-69.0,-72.0,-73.0,-70.0,-71.0,-74.0,-89.0,-88.0,-85.0,-86.0,18.0,21.0,16.0,14.0,1
2829,CC:2F:71:3E:C5:1F,3853805,486007218,1049,128144,3852756,485879074,3,4579,381766,3815,291084,764,90682,1111,15,1505,31,3,55,130000.0,39000.0,-71.0,-71.0,-69.0,-59.0,-71.0,-71.0,-68.0,-60.0,-89.0,-88.0,-85.0,-86.0,18.0,17.0,16.0,27.0,1
2830,BA:8C:B9:54:50:24,3857737,492078652,4981,6199578,3852756,485879074,7,10138,1778246,10116,1774751,22,3495,2364,18,5523,44,7,79,216660.0,130000.0,-48.0,-35.0,-43.0,-46.0,-43.0,-35.0,-44.0,-49.0,-89.0,-88.0,-85.0,-86.0,41.0,53.0,42.0,40.0,1
2831,62:47:05:9D:EB:15,3869257,520545780,16499,34666504,3852758,485879276,1,14331,5374385,14258,5363189,73,11196,6706,0,16585,282,1,170,229410.0,130000.0,-55.0,-55.0,-50.0,-62.0,-54.0,-54.0,-51.0,-62.0,-89.0,-88.0,-85.0,-86.0,34.0,33.0,35.0,24.0,1
2832,92:69:1D:31:68:E9,3856991,489597680,4233,3718404,3852758,485879276,1,5866,1243294,5681,1201151,185,42143,2354,12,4516,104,1,66,229410.0,130000.0,-53.0,-48.0,-42.0,-49.0,-52.0,-47.0,-43.0,-48.0,-89.0,-88.0,-85.0,-86.0,36.0,40.0,43.0,37.0,1
2833,CC:2F:71:3F:1F:24,5234867,2088077146,1382107,1602197668,3852760,485879478,2222,1165437,1341761968,1164529,1341651786,908,110182,1127943,15,1380243,129706,2219,880,144444.0,43333.0,-71.0,-68.0,-70.0,-72.0,-72.0,-69.0,-70.0,-73.0,-89.0,-88.0,-85.0,-86.0,18.0,20.0,15.0,14.0,1
2834,CC:2F:71:3E:C5:1F,3853810,486007682,1049,128144,3852761,485879538,3,4579,381766,3815,291084,764,90682,1111,15,1505,31,3,55,130000.0,39000.0,-71.0,-71.0,-69.0,-59.0,-71.0,-71.0,-68.0,-60.0,-89.0,-88.0,-85.0,-86.0,18.0,17.0,16.0,27.0,1
2835,BA:8C:B9:54:50:24,3857742,492079116,4981,6199578,3852761,485879538,7,10138,1778246,10116,1774751,22,3495,2364,18,5523,44,7,79,216660.0,130000.0,-48.0,-35.0,-43.0,-46.0,-43.0,-35.0,-44.0,-49.0,-89.0,-88.0,-85.0,-86.0,41.0,53.0,42.0,40.0,1
2836,62:47:05:9D:EB:15,3869266,520547148,16503,34667408,3852763,485879740,1,14369,5386740,14296,5375544,73,11196,6713,0,16589,282,1,170,229410.0,130000.0,-54.0,-54.0,-49.0,-62.0,-53.0,-52.0,-50.0,-61.0,-89.0,-88.0,-85.0,-86.0,35.0,34.0,36.0,24.0,1
2837,92:69:1D:31:68:E9,3856998,489598346,4233,3718404,3852765,485879942,1,5866,1243294,5681,1201151,185,42143,2354,12,4516,104,1,66,229410.0,130000.0,-53.0,-48.0,-42.0,-49.0,-52.0,-47.0,-43.0,-48.0,-89.0,-88.0,-85.0,-86.0,36.0,40.0,43.0,37.0,1
2838,CC:2F:71:3F:1F:24,5234917,2088094924,1382152,1602214982,3852765,485879942,2222,1165466,1341766998,1164558,1341656816,908,110182,1127969,15,1380288,129712,2219,880,130000.0,39000.0,-74.0,-71.0,-72.0,-76.0,-73.0,-70.0,-72.0,-75.0,-89.0,-88.0,-85.0,-86.0,15.0,17.0,13.0,10.0,1
2839,CC:2F:71:3E:C5:1F,3853814,486008086,1049,128144,3852765,485879942,3,4579,381766,3815,291084,764,90682,1111,15,1505,31,3,55,130000.0,39000.0,-71.0,-71.0,-69.0,-59.0,-71.0,-71.0,-68.0,-60.0,-89.0,-88.0,-85.0,-86.0,18.0,17.0,16.0,27.0,1
2840,BA:8C:B9:54:50:24,3857748,492079722,4981,6199578,3852767,485880144,7,10138,1778246,10116,1774751,22,3495,2364,18,5523,44,7,79,216660.0,130000.0,-48.0,-35.0,-43.0,-46.0,-43.0,-35.0,-44.0,-49.0,-89.0,-88.0,-85.0,-86.0,41.0,53.0,42.0,40.0,1
2841,62:47:05:9D:EB:15,3869279,520549617,16512,34669473,3852767,485880144,1,14395,5406483,14322,5395287,73,11196,6725,0,16598,282,1,170,229410.0,137640.0,-55.0,-54.0,-52.0,-63.0,-54.0,-53.0,-51.0,-62.0,-89.0,-88.0,-85.0,-86.0,34.0,34.0,33.0,23.0,1
2842,92:69:1D:31:68:E9,3857000,489598548,4233,3718404,3852767,485880144,1,5866,1243294,5681,1201151,185,42143,2354,12,4516,104,1,66,229410.0,130000.0,-53.0,-48.0,-42.0,-49.0,-52.0,-47.0,-43.0,-48.0,-89.0,-88.0,-85.0,-86.0,36.0,40.0,43.0,37.0,1
2843,CC:2F:71:3F:1F:24,5234973,2088116073,1382204,1602235727,3852769,485880346,2222,1165499,1341772949,1164591,1341662767,908,110182,1128000,15,1380340,129718,2219,880,144444.0,43333.0,-74.0,-70.0,-72.0,-75.0,-74.0,-70.0,-72.0,-75.0,-89.0,-88.0,-85.0,-86.0,15.0,18.0,13.0,11.0,1
2844,CC:2F:71:3E:C5:1F,3853818,486008490,1049,128144,3852769,485880346,3,4579,381766,3815,291084,764,90682,1111,15,1505,31,3,55,130000.0,39000.0,-71.0,-71.0,-69.0,-59.0,-71.0,-71.0,-68.0,-60.0,-89.0,-88.0,-85.0,-86.0,18.0,17.0,16.0,27.0,1
2845,BA:8C:B9:54:50:24,3857750,492079924,4981,6199578,3852769,485880346,7,10138,1778246,10116,1774751,22,3495,2364,18,5523,44,7,79,216660.0,130000.0,-48.0,-35.0,-43.0,-46.0,-43.0,-35.0,-44.0,-49.0,-89.0,-88.0,-85.0,-86.0,41.0,53.0,42.0,40.0,1
2846,62:47:05:9D:EB:15,3869286,520550283,16512,34669473,3852774,485880810,1,14396,5406551,14323,5395355,73,11196,6725,0,16598,282,1,170,229410.0,137640.0,-54.0,-53.0,-56.0,-62.0,-54.0,-53.0,-52.0,-62.0,-89.0,-88.0,-85.0,-86.0,35.0,35.0,29.0,24.0,1
2847,92:69:1D:31:68:E9,3857007,489599214,4233,3718404,3852774,485880810,1,5867,1243362,5682,1201219,185,42143,2354,12,4516,104,1,66,229410.0,130000.0,-51.0,-48.0,-43.0,-47.0,-52.0,-47.0,-43.0,-48.0,-89.0,-88.0,-85.0,-86.0,38.0,40.0,42.0,39.0,1
2848,CC:2F:71:3F:1F:24,5235024,2088134037,1382250,1602253227,3852774,485880810,2222,1165527,1341777891,1164619,1341667709,908,110182,1128025,15,1380386,129741,2219,880,144444.0,43333.0,-71.0,-68.0,-70.0,-72.0,-73.0,-70.0,-71.0,-74.0,-89.0,-88.0,-85.0,-86.0,18.0,20.0,15.0,14.0,1
2849,CC:2F:71:3E:C5:1F,3853825,486009156,1049,128144,3852776,485881012,3,4579,381766,3815,291084,764,90682,1111,15,1505,31,3,55,130000.0,39000.0,-71.0,-71.0,-69.0,-59.0,-71.0,-71.0,-68.0,-60.0,-89.0,-88.0,-85.0,-86.0,18.0,17.0,16.0,27.0,1
2850,BA:8C:B9:54:50:24,3857757,492080590,4981,6199578,3852776,485881012,7,10138,1778246,10116,1774751,22,3495,2364,18,5523,44,7,79,216660.0,130000.0,-48.0,-35.0,-43.0,-46.0,-43.0,-35.0,-44.0,-49.0,-89.0,-88.0,-85.0,-86.0,41.0,53.0,42.0,40.0,1
2851,62:47:05:9D:EB:15,3869293,520551939,16517,34670927,3852776,485881012,1,14425,5411545,14352,5400349,73,11196,6730,0,16603,282,1,170,229410.0,137640.0,-52.0,-52.0,-50.0,-60.0,-52.0,-52.0,-50.0,-59.0,-89.0,-89.0,-86.0,-86.0,37.0,37.0,36.0,26.0,1
2852,92:69:1D:31:68:E9,3857011,489599618,4233,3718404,3852778,485881214,1,5867,1243362,5682,1201219,185,42143,2354,12,4516,104,1,66,229410.0,130000.0,-51.0,-48.0,-43.0,-47.0,-52.0,-47.0,-43.0,-48.0,-89.0,-89.0,-86.0,-86.0,38.0,41.0,43.0,39.0,1
2853,CC:2F:71:3F:1F:24,5235076,2088152201,1382298,1602270987,3852778,485881214,2222,1165553,1341782539,1164645,1341672357,908,110182,1128049,15,1380434,129759,2219,880,144444.0,43333.0,-74.0,-71.0,-72.0,-75.0,-73.0,-70.0,-71.0,-75.0,-89.0,-89.0,-86.0,-86.0,15.0,18.0,14.0,11.0,1
2854,CC:2F:71:3E:C5:1F,3853827,486009358,1049,128144,3852778,485881214,3,4579,381766,3815,291084,764,90682,1111,15,1505,31,3,55,130000.0,39000.0,-71.0,-71.0,-69.0,-59.0,-71.0,-71.0,-68.0,-60.0,-89.0,-89.0,-86.0,-86.0,18.0,18.0,17.0,27.0,1
2855,BA:8C:B9:54:50:24,3857759,492080792,4981,6199578,3852778,485881214,7,10138,1778246,10116,1774751,22,3495,2364,18,5523,44,7,79,216660.0,130000.0,-48.0,-35.0,-43.0,-46.0,-43.0,-35.0,-44.0,-49.0,-89.0,-89.0,-86.0,-86.0,41.0,54.0,43.0,40.0,1
2856,62:47:05:9D:EB:15,3869300,520552675,16518,34671057,3852782,485881618,1,14427,5411733,14354,5400537,73,11196,6731,0,16604,282,1,170,229410.0,137640.0,-54.0,-54.0,-49.0,-61.0,-52.0,-52.0,-50.0,-60.0,-89.0,-89.0,-86.0,-86.0,35.0,35.0,37.0,25.0,1
2857,92:69:1D:31:68:E9,3857017,489600224,4233,3718404,3852784,485881820,1,5867,1243362,5682,1201219,185,42143,2354,12,4516,104,1,66,229410.0,130000.0,-51.0,-48.0,-43.0,-47.0,-52.0,-47.0,-43.0,-48.0,-89.0,-89.0,-86.0,-86.0,38.0,41.0,43.0,39.0,1
2858,CC:2F:71:3F:1F:24,5235129,2088170437,1382345,1602288617,3852784,485881820,2222,1165580,1341787493,1164672,1341677311,908,110182,1128073,15,1380481,129783,2219,880,144444.0,43333.0,-74.0,-71.0,-73.0,-75.0,-73.0,-70.0,-72.0,-74.0,-89.0,-89.0,-86.0,-86.0,15.0,18.0,13.0,11.0,1
2859,CC:2F:71:3E:C5:1F,3853833,486009964,1049,128144,3852784,485881820,3,4579,381766,3815,291084,764,90682,1111,15,1505,31,3,55,130000.0,39000.0,-71.0,-71.0,-69.0,-59.0,-71.0,-71.0,-68.0,-60.0,-89.0,-89.0,-86.0,-86.0,18.0,18.0,17.0,27.0,1
2860,BA:8C:B9:54:50:24,3857766,492081458,4981,6199578,3852785,485881880,7,10138,1778246,10116,1774751,22,3495,2364,18,5523,44,7,79,216660.0,130000.0,-48.0,-35.0,-43.0,-46.0,-43.0,-35.0,-44.0,-49.0,-89.0,-89.0,-86.0,-86.0,41.0,54.0,43.0,40.0,1
2861,62:47:05:9D:EB:15,3869307,520553469,16520,34671387,3852787,485882082,1,14431,5412200,14358,5401004,73,11196,6734,0,16606,282,1,170,229410.0,137640.0,-56.0,-55.0,-53.0,-64.0,-54.0,-53.0,-51.0,-62.0,-89.0,-89.0,-86.0,-86.0,33.0,34.0,33.0,22.0,1
2862,92:69:1D:31:68:E9,3857020,489600486,4233,3718404,3852787,485882082,1,5867,1243362,5682,1201219,185,42143,2354,12,4516,104,1,66,229410.0,130000.0,-51.0,-48.0,-43.0,-47.0,-52.0,-47.0,-43.0,-48.0,-89.0,-89.0,-86.0,-86.0,38.0,41.0,43.0,39.0,1
2863,CC:2F:71:3F:1F:24,5235185,2088191686,1382398,1602309604,3852787,485882082,2222,1165614,1341793513,1164706,1341683331,908,110182,1128105,15,1380534,129791,2219,880,144444.0,43333.0,-76.0,-73.0,-74.0,-77.0,-73.0,-70.0,-71.0,-74.0,-89.0,-89.0,-86.0,-86.0,13.0,16.0,12.0,9.0,1
2864,CC:2F:71:3E:C5:1F,3853838,486010428,1049,128144,3852789,485882284,3,4579,381766,3815,291084,764,90682,1111,15,1505,31,3,55,130000.0,39000.0,-71.0,-71.0,-69.0,-59.0,-71.0,-71.0,-68.0,-60.0,-89.0,-89.0,-86.0,-86.0,18.0,18.0,17.0,27.0,1
2865,BA:8C:B9:54:50:24,3857770,492081862,4981,6199578,3852789,485882284,7,10138,1778246,10116,1774751,22,3495,2364,18,5523,44,7,79,216660.0,130000.0,-48.0,-35.0,-43.0,-46.0,-43.0,-35.0,-44.0,-49.0,-89.0,-89.0,-86.0,-86.0,41.0,54.0,43.0,40.0,1
2866,62:47:05:9D:EB:15,3869361,520595386,16545,34701675,3852816,485893711,1,14473,5441212,14400,5430016,73,11196,6764,0,16630,282,1,170,229410.0,137640.0,-55.0,-56.0,-53.0,-63.0,-54.0,-56.0,-51.0,-62.0,-89.0,-89.0,-86.0,-86.0,34.0,33.0,33.0,23.0,1
2867,92:69:1D:31:68:E9,3857049,489612115,4233,3718404,3852816,485893711,1,5870,1243733,5684,1201355,186,42378,2355,12,4516,104,1,66,229410.0,130000.0,-53.0,-48.0,-42.0,-49.0,-51.0,-48.0,-43.0,-48.0,-89.0,-89.0,-86.0,-86.0,36.0,41.0,44.0,37.0,1
2868,CC:2F:71:3F:1F:24,5235262,2088221091,1382446,1602327380,3852816,485893711,2222,1165644,1341798733,1164736,1341688551,908,110182,1128131,15,1380582,129800,2219,880,144444.0,43333.0,-71.0,-67.0,-69.0,-71.0,-70.0,-67.0,-69.0,-71.0,-89.0,-89.0,-86.0,-86.0,18.0,22.0,17.0,15.0,1
2869,CC:2F:71:3E:C5:1F,3853865,486021855,1049,128144,3852816,485893711,3,4579,381766,3815,291084,764,90682,1111,15,1505,31,3,55,130000.0,39000.0,-71.0,-71.0,-69.0,-59.0,-71.0,-71.0,-68.0,-60.0,-89.0,-89.0,-86.0,-86.0,18.0,18.0,17.0,27.0,1
2870,BA:8C:B9:54:50:24,3857797,492093289,4981,6199578,3852816,485893711,7,10138,1778246,10116,1774751,22,3495,2364,18,5523,44,7,79,216660.0,130000.0,-48.0,-35.0,-43.0,-46.0,-43.0,-35.0,-44.0,-49.0,-89.0,-89.0,-86.0,-86.0,41.0,54.0,43.0,40.0,1
2871,62:47:05:9D:EB:15,3869499,520960914,16680,35066941,3852819,485893973,1,14603,5458983,14530,5447787,73,11196,6847,0,16766,282,1,170,229410.0,137640.0,-53.0,-55.0,-49.0,-62.0,-54.0,-56.0,-51.0,-63.0,-89.0,-89.0,-86.0,-86.0,36.0,34.0,37.0,24.0,1
2872,92:69:1D:31:68:E9,3857054,489612579,4233,3718404,3852821,485894175,1,5870,1243733,5684,1201355,186,42378,2355,12,4516,104,1,66,229410.0,130000.0,-53.0,-48.0,-42.0,-49.0,-51.0,-48.0,-43.0,-48.0,-89.0,-89.0,-86.0,-86.0,36.0,41.0,44.0,37.0,1
2873,CC:2F:71:3F:1F:24,5235314,2088239185,1382493,1602345010,3852821,485894175,2222,1165674,1341803893,1164766,1341693711,908,110182,1128159,15,1380629,129809,2219,880,144444.0,43333.0,-71.0,-67.0,-69.0,-72.0,-70.0,-67.0,-69.0,-71.0,-89.0,-89.0,-86.0,-86.0,18.0,22.0,17.0,14.0,1
2874,CC:2F:71:3E:C5:1F,3853870,486022319,1049,128144,3852821,485894175,3,4581,381906,3817,291224,764,90682,1111,16,1506,32,3,55,130000.0,39000.0,-72.0,-72.0,-69.0,-60.0,-72.0,-72.0,-69.0,-61.0,-89.0,-89.0,-86.0,-86.0,17.0,17.0,17.0,26.0,1
2875,BA:8C:B9:54:50:24,3857802,492093753,4981,6199578,3852821,485894175,7,10140,1778382,10118,1774887,22,3495,2364,18,5524,44,7,79,216660.0,130000.0,-50.0,-35.0,-43.0,-45.0,-43.0,-35.0,-44.0,-49.0,-89.0,-89.0,-86.0,-86.0,39.0,54.0,43.0,41.0,1
2876,62:47:05:9D:EB:15,3869514,520964075,16689,35069496,3852825,485894579,1,14620,5465720,14547,5454524,73,11196,6856,0,16775,282,1,170,229410.0,137640.0,-53.0,-54.0,-51.0,-62.0,-53.0,-55.0,-51.0,-62.0,-89.0,-89.0,-86.0,-86.0,36.0,35.0,35.0,24.0,1
2877,92:69:1D:31:68:E9,3857058,489612983,4233,3718404,3852825,485894579,1,5870,1243733,5684,1201355,186,42378,2355,12,4516,104,1,66,229410.0,130000.0,-53.0,-48.0,-42.0,-49.0,-51.0,-48.0,-43.0,-48.0,-89.0,-89.0,-86.0,-86.0,36.0,41.0,44.0,37.0,1
2878,CC:2F:71:3F:1F:24,5235365,2088257219,1382540,1602362640,3852825,485894579,2222,1165704,1341809019,1164796,1341698837,908,110182,1128186,15,1380676,129826,2219,880,144444.0,43333.0,-70.0,-67.0,-70.0,-71.0,-70.0,-67.0,-69.0,-71.0,-89.0,-89.0,-86.0,-86.0,19.0,22.0,16.0,15.0,1
2879,CC:2F:71:3E:C5:1F,3853874,486022723,1049,128144,3852825,485894579,3,4581,381906,3817,291224,764,90682,1111,16,1506,32,3,55,130000.0,39000.0,-72.0,-72.0,-69.0,-60.0,-72.0,-72.0,-69.0,-61.0,-89.0,-89.0,-86.0,-86.0,17.0,17.0,17.0,26.0,1
2880,BA:8C:B9:54:50:24,3857806,492094157,4981,6199578,3852825,485894579,7,10140,1778382,10118,1774887,22,3495,2364,18,5524,44,7,79,216660.0,130000.0,-50.0,-35.0,-43.0,-45.0,-43.0,-35.0,-44.0,-49.0,-89.0,-89.0,-86.0,-86.0,39.0,54.0,43.0,41.0,1
2881,62:47:05:9D:EB:15,3869525,520966293,16695,35071037,3852830,485895256,1,14646,5469428,14573,5458232,73,11196,6863,0,16781,282,1,170,229410.0,137640.0,-54.0,-55.0,-52.0,-63.0,-54.0,-55.0,-52.0,-63.0,-89.0,-89.0,-86.0,-86.0,35.0,34.0,34.0,23.0,1
2882,92:69:1D:31:68:E9,3857063,489613660,4233,3718404,3852830,485895256,1,5870,1243733,5684,1201355,186,42378,2355,12,4516,104,1,66,229410.0,130000.0,-53.0,-48.0,-42.0,-49.0,-51.0,-48.0,-43.0,-48.0,-89.0,-89.0,-86.0,-86.0,36.0,41.0,44.0,37.0,1
2883,CC:2F:71:3F:1F:24,5235424,2088278997,1382594,1602383741,3852830,485895256,2222,1165741,1341815450,1164833,1341705268,908,110182,1128219,15,1380730,129829,2219,880,144444.0,43333.0,-71.0,-68.0,-69.0,-71.0,-70.0,-67.0,-69.0,-71.0,-89.0,-89.0,-86.0,-86.0,18.0,21.0,17.0,15.0,1
2884,CC:2F:71:3E:C5:1F,3853880,486023460,1049,128144,3852831,485895316,3,4581,381906,3817,291224,764,90682,1111,16,1506,32,3,55,130000.0,39000.0,-72.0,-72.0,-69.0,-60.0,-72.0,-72.0,-69.0,-61.0,-89.0,-89.0,-86.0,-86.0,17.0,17.0,17.0,26.0,1
2885,BA:8C:B9:54:50:24,3857812,492094894,4981,6199578,3852831,485895316,7,10140,1778382,10118,1774887,22,3495,2364,18,5524,44,7,79,216660.0,130000.0,-50.0,-35.0,-43.0,-45.0,-43.0,-35.0,-44.0,-49.0,-89.0,-89.0,-86.0,-86.0,39.0,54.0,43.0,41.0,1
2886,62:47:05:9D:EB:15,3869532,520967275,16697,35071555,3852835,485895720,1,14658,5470530,14585,5459334,73,11196,6867,0,16783,282,1,170,229410.0,137640.0,-53.0,-55.0,-49.0,-62.0,-54.0,-55.0,-51.0,-63.0,-89.0,-89.0,-86.0,-86.0,36.0,34.0,37.0,24.0,1
2887,92:69:1D:31:68:E9,3857068,489614124,4233,3718404,3852835,485895720,1,5870,1243733,5684,1201355,186,42378,2355,12,4516,104,1,66,229410.0,130000.0,-53.0,-48.0,-42.0,-49.0,-51.0,-48.0,-43.0,-48.0,-89.0,-89.0,-86.0,-86.0,36.0,41.0,44.0,37.0,1
2888,CC:2F:71:3F:1F:24,5235477,2088297221,1382642,1602401501,3852835,485895720,2222,1165768,1341820294,1164860,1341710112,908,110182,1128244,15,1380778,129834,2219,880,144444.0,43333.0,-71.0,-67.0,-70.0,-71.0,-70.0,-67.0,-69.0,-71.0,-89.0,-89.0,-86.0,-86.0,18.0,22.0,16.0,15.0,1
2889,CC:2F:71:3E:C5:1F,3853884,486023864,1049,128144,3852835,485895720,3,4581,381906,3817,291224,764,90682,1111,16,1506,32,3,55,130000.0,39000.0,-72.0,-72.0,-69.0,-60.0,-72.0,-72.0,-69.0,-61.0,-89.0,-89.0,-86.0,-86.0,17.0,17.0,17.0,26.0,1
2890,BA:8C:B9:54:50:24,3857816,492095298,4981,6199578,3852835,485895720,7,10140,1778382,10118,1774887,22,3495,2364,18,5524,44,7,79,216660.0,130000.0,-50.0,-35.0,-43.0,-45.0,-43.0,-35.0,-44.0,-49.0,-89.0,-89.0,-86.0,-86.0,39.0,54.0,43.0,41.0,1
2891,62:47:05:9D:EB:15,3869538,520968047,16697,35071555,3852841,485896492,1,14658,5470530,14585,5459334,73,11196,6867,0,16783,282,1,170,229410.0,137640.0,-53.0,-55.0,-49.0,-62.0,-54.0,-55.0,-51.0,-63.0,-89.0,-89.0,-86.0,-86.0,36.0,34.0,37.0,24.0,1
2892,92:69:1D:31:68:E9,3857074,489614896,4233,3718404,3852841,485896492,1,5870,1243733,5684,1201355,186,42378,2355,12,4516,104,1,66,229410.0,130000.0,-53.0,-48.0,-42.0,-49.0,-51.0,-48.0,-43.0,-48.0,-89.0,-89.0,-86.0,-86.0,36.0,41.0,44.0,37.0,1
2893,CC:2F:71:3F:1F:24,5235531,2088315753,1382690,1602419261,3852841,485896492,2222,1165796,1341825300,1164888,1341715118,908,110182,1128269,15,1380826,129834,2219,880,144444.0,43333.0,-71.0,-68.0,-70.0,-72.0,-71.0,-67.0,-70.0,-71.0,-89.0,-89.0,-86.0,-86.0,18.0,21.0,16.0,14.0,1
2894,CC:2F:71:3E:C5:1F,3853890,486024636,1049,128144,3852841,485896492,3,4581,381906,3817,291224,764,90682,1111,16,1506,32,3,55,130000.0,39000.0,-72.0,-72.0,-69.0,-60.0,-72.0,-72.0,-69.0,-61.0,-89.0,-89.0,-86.0,-86.0,17.0,17.0,17.0,26.0,1
2895,BA:8C:B9:54:50:24,3857823,492096181,4981,6199578,3852842,485896603,7,10140,1778382,10118,1774887,22,3495,2364,18,5524,44,7,79,216660.0,130000.0,-50.0,-35.0,-43.0,-45.0,-43.0,-35.0,-44.0,-49.0,-89.0,-89.0,-86.0,-86.0,39.0,54.0,43.0,41.0,1
2896,62:47:05:9D:EB:15,3869545,520968791,16698,35071724,3852847,485897067,1,14685,5472612,14611,5461245,74,11367,6870,0,16784,282,1,170,229410.0,137640.0,-53.0,-55.0,-49.0,-62.0,-55.0,-56.0,-52.0,-64.0,-89.0,-89.0,-86.0,-86.0,36.0,34.0,37.0,24.0,1
2897,92:69:1D:31:68:E9,3857080,489615471,4233,3718404,3852847,485897067,1,5870,1243733,5684,1201355,186,42378,2355,12,4516,104,1,66,229410.0,130000.0,-53.0,-48.0,-42.0,-49.0,-51.0,-48.0,-43.0,-48.0,-89.0,-89.0,-86.0,-86.0,36.0,41.0,44.0,37.0,1
2898,CC:2F:71:3F:1F:24,5235585,2088334088,1382738,1602437021,3852847,485897067,2222,1165822,1341829886,1164914,1341719704,908,110182,1128294,15,1380874,129838,2219,880,144444.0,43333.0,-76.0,-73.0,-74.0,-77.0,-72.0,-69.0,-71.0,-73.0,-89.0,-89.0,-86.0,-86.0,13.0,16.0,12.0,9.0,1
2899,CC:2F:71:3E:C5:1F,3853896,486025211,1049,128144,3852847,485897067,3,4581,381906,3817,291224,764,90682,1111,16,1506,32,3,55,130000.0,39000.0,-72.0,-72.0,-69.0,-60.0,-72.0,-72.0,-69.0,-61.0,-89.0,-89.0,-86.0,-86.0,17.0,17.0,17.0,26.0,1
2900,BA:8C:B9:54:50:24,3857828,492096645,4981,6199578,3852847,485897067,7,10140,1778382,10118,1774887,22,3495,2364,18,5524,44,7,79,216660.0,130000.0,-50.0,-35.0,-43.0,-45.0,-43.0,-35.0,-44.0,-49.0,-89.0,-89.0,-86.0,-86.0,39.0,54.0,43.0,41.0,1
2901,62:47:05:9D:EB:15,3869550,520969311,16699,35071840,3852851,485897471,1,14688,5472854,14614,5461487,74,11367,6871,0,16785,282,1,170,229410.0,137640.0,-53.0,-55.0,-49.0,-62.0,-54.0,-56.0,-51.0,-63.0,-89.0,-89.0,-86.0,-86.0,36.0,34.0,37.0,24.0,1
2902,92:69:1D:31:68:E9,3857084,489615875,4233,3718404,3852851,485897471,1,5870,1243733,5684,1201355,186,42378,2355,12,4516,104,1,66,229410.0,130000.0,-53.0,-48.0,-42.0,-49.0,-51.0,-48.0,-43.0,-48.0,-89.0,-89.0,-86.0,-86.0,36.0,41.0,44.0,37.0,1
2903,CC:2F:71:3F:1F:24,5235645,2088355981,1382794,1602458510,3852851,485897471,2222,1165861,1341836485,1164953,1341726303,908,110182,1128332,15,1380930,129852,2219,880,144444.0,43333.0,-71.0,-68.0,-70.0,-72.0,-70.0,-67.0,-69.0,-71.0,-89.0,-89.0,-86.0,-86.0,18.0,21.0,16.0,14.0,1
2904,CC:2F:71:3E:C5:1F,3853900,486025615,1049,128144,3852851,485897471,3,4581,381906,3817,291224,764,90682,1111,16,1506,32,3,55,130000.0,39000.0,-72.0,-72.0,-69.0,-60.0,-72.0,-72.0,-69.0,-61.0,-89.0,-89.0,-86.0,-86.0,17.0,17.0,17.0,26.0,1
2905,BA:8C:B9:54:50:24,3857832,492097049,4981,6199578,3852851,485897471,7,10140,1778382,10118,1774887,22,3495,2364,18,5524,44,7,79,216660.0,130000.0,-50.0,-35.0,-43.0,-45.0,-43.0,-35.0,-44.0,-49.0,-89.0,-89.0,-86.0,-86.0,39.0,54.0,43.0,41.0,1
2906,62:47:05:9D:EB:15,3869554,520969715,16699,35071840,3852855,485897875,1,14688,5472854,14614,5461487,74,11367,6871,0,16785,282,1,170,229410.0,137640.0,-53.0,-55.0,-49.0,-62.0,-54.0,-56.0,-51.0,-63.0,-89.0,-89.0,-86.0,-86.0,36.0,34.0,37.0,24.0,1
2907,92:69:1D:31:68:E9,3857088,489616279,4233,3718404,3852855,485897875,1,5870,1243733,5684,1201355,186,42378,2355,12,4516,104,1,66,229410.0,130000.0,-53.0,-48.0,-42.0,-49.0,-51.0,-48.0,-43.0,-48.0,-89.0,-89.0,-86.0,-86.0,36.0,41.0,44.0,37.0,1
2908,CC:2F:71:3F:1F:24,5235697,2088374075,1382841,1602476140,3852856,485897935,2222,1165890,1341841419,1164982,1341731237,908,110182,1128360,15,1380977,129866,2219,880,144444.0,43333.0,-75.0,-73.0,-74.0,-77.0,-74.0,-71.0,-72.0,-75.0,-89.0,-89.0,-86.0,-86.0,14.0,16.0,12.0,9.0,1
2909,CC:2F:71:3E:C5:1F,3853905,486026079,1049,128144,3852856,485897935,3,4581,381906,3817,291224,764,90682,1111,16,1506,32,3,55,130000.0,39000.0,-72.0,-72.0,-69.0,-60.0,-72.0,-72.0,-69.0,-61.0,-89.0,-89.0,-86.0,-86.0,17.0,17.0,17.0,26.0,1
2910,BA:8C:B9:54:50:24,3857837,492097513,4981,6199578,3852856,485897935,7,10140,1778382,10118,1774887,22,3495,2364,18,5524,44,7,79,216660.0,130000.0,-50.0,-35.0,-43.0,-45.0,-43.0,-35.0,-44.0,-49.0,-89.0,-89.0,-86.0,-86.0,39.0,54.0,43.0,41.0,1
2911,62:47:05:9D:EB:15,3869559,520970179,16699,35071840,3852860,485898339,1,14688,5472854,14614,5461487,74,11367,6871,0,16785,282,1,170,229410.0,137640.0,-53.0,-55.0,-49.0,-62.0,-54.0,-56.0,-51.0,-63.0,-89.0,-89.0,-86.0,-87.0,36.0,34.0,37.0,25.0,1
2912,92:69:1D:31:68:E9,3857093,489616743,4233,3718404,3852860,485898339,1,5870,1243733,5684,1201355,186,42378,2355,12,4516,104,1,66,229410.0,130000.0,-53.0,-48.0,-42.0,-49.0,-51.0,-48.0,-43.0,-48.0,-89.0,-89.0,-86.0,-87.0,36.0,41.0,44.0,38.0,1
2913,CC:2F:71:3F:1F:24,5235748,2088392109,1382888,1602493770,3852860,485898339,2222,1165916,1341846005,1165008,1341735823,908,110182,1128385,15,1381024,129888,2219,880,144444.0,43333.0,-70.0,-67.0,-68.0,-71.0,-70.0,-67.0,-68.0,-71.0,-89.0,-89.0,-86.0,-87.0,19.0,22.0,18.0,16.0,1
2914,CC:2F:71:3E:C5:1F,3853909,486026483,1049,128144,3852860,485898339,3,4581,381906,3817,291224,764,90682,1111,16,1506,32,3,55,130000.0,39000.0,-72.0,-72.0,-69.0,-60.0,-72.0,-72.0,-69.0,-61.0,-89.0,-89.0,-86.0,-87.0,17.0,17.0,17.0,27.0,1
2915,BA:8C:B9:54:50:24,3857841,492097917,4981,6199578,3852860,485898339,7,10140,1778382,10118,1774887,22,3495,2364,18,5524,44,7,79,216660.0,130000.0,-50.0,-35.0,-43.0,-45.0,-43.0,-35.0,-44.0,-49.0,-89.0,-89.0,-86.0,-87.0,39.0,54.0,43.0,42.0,1
2916,62:47:05:9D:EB:15,3869564,520970842,16700,35072099,3852864,485898743,1,14711,5474561,14637,5463194,74,11367,6873,0,16786,282,1,170,229410.0,137640.0,-54.0,-55.0,-50.0,-63.0,-54.0,-54.0,-50.0,-62.0,-89.0,-89.0,-86.0,-87.0,35.0,34.0,36.0,24.0,1
2917,92:69:1D:31:68:E9,3857097,489617147,4233,3718404,3852864,485898743,1,5870,1243733,5684,1201355,186,42378,2355,12,4516,104,1,66,229410.0,130000.0,-53.0,-48.0,-42.0,-49.0,-51.0,-48.0,-43.0,-48.0,-89.0,-89.0,-86.0,-87.0,36.0,41.0,44.0,38.0,1
2918,CC:2F:71:3F:1F:24,5235807,2088413806,1382943,1602515063,3852864,485898743,2222,1165951,1341852172,1165043,1341741990,908,110182,1128419,15,1381079,129899,2219,880,144444.0,43333.0,-71.0,-67.0,-69.0,-72.0,-70.0,-67.0,-69.0,-71.0,-89.0,-89.0,-86.0,-87.0,18.0,22.0,17.0,15.0,1
2919,CC:2F:71:3E:C5:1F,3853913,486026887,1049,128144,3852864,485898743,3,4581,381906,3817,291224,764,90682,1111,16,1506,32,3,55,130000.0,39000.0,-72.0,-72.0,-69.0,-60.0,-72.0,-72.0,-69.0,-61.0,-89.0,-89.0,-86.0,-87.0,17.0,17.0,17.0,27.0,1
2920,BA:8C:B9:54:50:24,3857847,492098523,4981,6199578,3852866,485898945,7,10140,1778382,10118,1774887,22,3495,2364,18,5524,44,7,79,216660.0,130000.0,-50.0,-35.0,-43.0,-45.0,-43.0,-35.0,-44.0,-49.0,-89.0,-89.0,-86.0,-87.0,39.0,54.0,43.0,42.0,1
2921,62:47:05:9D:EB:15,3869573,520972781,16704,35073574,3852869,485899207,1,14735,5478101,14661,5466734,74,11367,6876,0,16790,282,1,170,229410.0,137640.0,-55.0,-54.0,-58.0,-62.0,-53.0,-53.0,-51.0,-61.0,-89.0,-89.0,-86.0,-87.0,34.0,35.0,28.0,25.0,1
2922,92:69:1D:31:68:E9,3857102,489617611,4233,3718404,3852869,485899207,1,5870,1243733,5684,1201355,186,42378,2355,12,4516,104,1,66,229410.0,130000.0,-53.0,-48.0,-42.0,-49.0,-51.0,-48.0,-43.0,-48.0,-89.0,-89.0,-86.0,-87.0,36.0,41.0,44.0,38.0,1
2923,CC:2F:71:3F:1F:24,5235857,2088431640,1382988,1602532433,3852869,485899207,2222,1165977,1341856758,1165069,1341746576,908,110182,1128444,15,1381124,129904,2219,880,144444.0,43333.0,-71.0,-67.0,-69.0,-72.0,-70.0,-67.0,-69.0,-72.0,-89.0,-89.0,-86.0,-87.0,18.0,22.0,17.0,15.0,1
2924,CC:2F:71:3E:C5:1F,3853918,486027351,1049,128144,3852869,485899207,3,4581,381906,3817,291224,764,90682,1111,16,1506,32,3,55,130000.0,39000.0,-72.0,-72.0,-69.0,-60.0,-72.0,-72.0,-69.0,-61.0,-89.0,-89.0,-86.0,-87.0,17.0,17.0,17.0,27.0,1
2925,BA:8C:B9:54:50:24,3857852,492098987,4981,6199578,3852871,485899409,7,10140,1778382,10118,1774887,22,3495,2364,18,5524,44,7,79,216660.0,130000.0,-50.0,-35.0,-43.0,-45.0,-43.0,-35.0,-44.0,-49.0,-89.0,-89.0,-86.0,-87.0,39.0,54.0,43.0,42.0,1
2926,62:47:05:9D:EB:15,3869598,520981876,16725,35082265,3852873,485899611,1,14787,5484874,14713,5473507,74,11367,6897,0,16811,282,1,170,229410.0,137640.0,-54.0,-55.0,-50.0,-62.0,-54.0,-55.0,-49.0,-62.0,-89.0,-89.0,-86.0,-87.0,35.0,34.0,36.0,25.0,1
2927,92:69:1D:31:68:E9,3857107,489618131,4234,3718520,3852873,485899611,1,5872,1243869,5686,1201491,186,42378,2355,12,4517,104,1,66,229410.0,137640.0,-51.0,-48.0,-44.0,-47.0,-51.0,-48.0,-43.0,-48.0,-89.0,-89.0,-86.0,-87.0,38.0,41.0,42.0,40.0,1
2928,CC:2F:71:3F:1F:24,5235908,2088449660,1383035,1602550049,3852873,485899611,2222,1166007,1341862060,1165099,1341751878,908,110182,1128471,15,1381171,129915,2219,880,144444.0,43333.0,-71.0,-68.0,-70.0,-72.0,-71.0,-67.0,-69.0,-72.0,-89.0,-89.0,-86.0,-87.0,18.0,21.0,16.0,15.0,1
2929,CC:2F:71:3E:C5:1F,3853923,486027871,1050,128260,3852873,485899611,3,4583,382046,3819,291364,764,90682,1111,16,1507,32,3,55,130000.0,39000.0,-72.0,-72.0,-69.0,-60.0,-71.0,-70.0,-68.0,-59.0,-89.0,-89.0,-86.0,-87.0,17.0,17.0,17.0,27.0,1
2930,BA:8C:B9:54:50:24,3857859,492099709,4982,6199694,3852877,485900015,7,10142,1778518,10120,1775023,22,3495,2364,18,5525,44,7,79,216660.0,130000.0,-48.0,-35.0,-43.0,-45.0,-43.0,-35.0,-44.0,-49.0,-89.0,-89.0,-86.0,-87.0,41.0,54.0,43.0,42.0,1
2931,62:47:05:9D:EB:15,3869620,520991002,16743,35090987,3852877,485900015,1,14826,5488941,14752,5477574,74,11367,6917,0,16829,282,1,170,229410.0,137640.0,-54.0,-54.0,-50.0,-62.0,-56.0,-55.0,-52.0,-64.0,-89.0,-89.0,-86.0,-87.0,35.0,35.0,36.0,25.0,1
2932,92:69:1D:31:68:E9,3857111,489618535,4234,3718520,3852877,485900015,1,5872,1243869,5686,1201491,186,42378,2355,12,4517,104,1,66,229410.0,137640.0,-51.0,-48.0,-44.0,-47.0,-51.0,-48.0,-43.0,-48.0,-89.0,-89.0,-86.0,-87.0,38.0,41.0,42.0,40.0,1
2933,CC:2F:71:3F:1F:24,5235961,2088467816,1383082,1602567679,3852879,485900137,2222,1166033,1341866646,1165125,1341756464,908,110182,1128496,15,1381218,129929,2219,880,144444.0,43333.0,-70.0,-67.0,-69.0,-72.0,-72.0,-69.0,-70.0,-73.0,-89.0,-89.0,-86.0,-87.0,19.0,22.0,17.0,15.0,1
2934,CC:2F:71:3E:C5:1F,3853929,486028397,1050,128260,3852879,485900137,3,4583,382046,3819,291364,764,90682,1111,16,1507,32,3,55,130000.0,39000.0,-72.0,-72.0,-69.0,-60.0,-71.0,-70.0,-68.0,-59.0,-89.0,-89.0,-86.0,-87.0,17.0,17.0,17.0,27.0,1
2935,BA:8C:B9:54:50:24,3857863,492100033,4982,6199694,3852881,485900339,7,10142,1778518,10120,1775023,22,3495,2364,18,5525,44,7,79,216660.0,130000.0,-48.0,-35.0,-43.0,-45.0,-43.0,-35.0,-44.0,-49.0,-89.0,-89.0,-86.0,-87.0,41.0,54.0,43.0,42.0,1
2936,62:47:05:9D:EB:15,3869670,521011015,16787,35110474,3852883,485900541,1,14896,5507918,14821,5496429,75,11489,6962,0,16873,283,1,171,216660.0,130000.0,-54.0,-54.0,-49.0,-62.0,-55.0,-55.0,-51.0,-63.0,-89.0,-90.0,-87.0,-87.0,35.0,36.0,38.0,25.0,1
2937,92:69:1D:31:68:E9,3857117,489619061,4234,3718520,3852883,485900541,1,5872,1243869,5686,1201491,186,42378,2355,12,4517,104,1,66,229410.0,137640.0,-51.0,-48.0,-44.0,-47.0,-51.0,-48.0,-43.0,-48.0,-89.0,-90.0,-87.0,-87.0,38.0,42.0,43.0,40.0,1
2938,CC:2F:71:3F:1F:24,5236024,2088490249,1383138,1602589372,3852886,485900877,2222,1166069,1341873118,1165161,1341762936,908,110182,1128529,15,1381274,129949,2219,880,130000.0,39000.0,-71.0,-67.0,-69.0,-72.0,-70.0,-67.0,-68.0,-71.0,-89.0,-90.0,-87.0,-87.0,18.0,23.0,18.0,15.0,1
2939,CC:2F:71:3E:C5:1F,3853937,486029205,1050,128260,3852887,485900945,3,4583,382046,3819,291364,764,90682,1111,16,1507,32,3,55,130000.0,39000.0,-72.0,-72.0,-69.0,-60.0,-71.0,-70.0,-68.0,-59.0,-89.0,-90.0,-87.0,-87.0,17.0,18.0,18.0,27.0,1
2940,BA:8C:B9:54:50:24,3857869,492100639,4982,6199694,3852887,485900945,7,10143,1778586,10121,1775091,22,3495,2364,18,5525,44,7,79,216660.0,130000.0,-40.0,-36.0,-45.0,-52.0,-43.0,-35.0,-44.0,-49.0,-89.0,-90.0,-87.0,-87.0,49.0,54.0,42.0,35.0,1
2941,62:47:05:9D:EB:15,3869693,521019755,16805,35118537,3852888,485901218,1,14936,5512136,14861,5500647,75,11489,6980,0,16891,283,1,171,229410.0,130000.0,-54.0,-55.0,-49.0,-62.0,-54.0,-54.0,-50.0,-62.0,-89.0,-90.0,-87.0,-87.0,35.0,35.0,38.0,25.0,1
2942,92:69:1D:31:68:E9,3857122,489619738,4234,3718520,3852888,485901218,1,5872,1243869,5686,1201491,186,42378,2355,12,4517,104,1,66,229410.0,137640.0,-51.0,-48.0,-44.0,-47.0,-51.0,-48.0,-43.0,-48.0,-89.0,-90.0,-87.0,-87.0,38.0,42.0,43.0,40.0,1
2943,CC:2F:71:3F:1F:24,5236074,2088508180,1383184,1602606760,3852890,485901420,2222,1166096,1341877820,1165188,1341767638,908,110182,1128555,15,1381320,129960,2219,880,144444.0,43333.0,-71.0,-67.0,-69.0,-72.0,-70.0,-67.0,-69.0,-72.0,-89.0,-90.0,-87.0,-87.0,18.0,23.0,18.0,15.0,1
2944,CC:2F:71:3E:C5:1F,3853940,486029680,1050,128260,3852890,485901420,3,4583,382046,3819,291364,764,90682,1111,16,1507,32,3,55,130000.0,39000.0,-72.0,-72.0,-69.0,-60.0,-71.0,-70.0,-68.0,-59.0,-89.0,-90.0,-87.0,-87.0,17.0,18.0,18.0,27.0,1
2945,BA:8C:B9:54:50:24,3857872,492101114,4982,6199694,3852890,485901420,7,10143,1778586,10121,1775091,22,3495,2364,18,5525,44,7,79,216660.0,130000.0,-40.0,-36.0,-45.0,-52.0,-43.0,-35.0,-44.0,-49.0,-89.0,-90.0,-87.0,-87.0,49.0,54.0,42.0,35.0,1
2946,62:47:05:9D:EB:15,3869700,521020421,16805,35118537,3852895,485901884,1,14945,5512748,14870,5501259,75,11489,6980,0,16891,283,1,171,229410.0,130000.0,-54.0,-55.0,-50.0,-62.0,-54.0,-54.0,-49.0,-62.0,-89.0,-90.0,-87.0,-87.0,35.0,35.0,37.0,25.0,1
2947,92:69:1D:31:68:E9,3857131,489620606,4234,3718520,3852897,485902086,1,5872,1243869,5686,1201491,186,42378,2355,12,4517,104,1,66,229410.0,137640.0,-51.0,-48.0,-44.0,-47.0,-51.0,-48.0,-43.0,-48.0,-89.0,-90.0,-87.0,-87.0,38.0,42.0,43.0,40.0,1
2948,CC:2F:71:3F:1F:24,5236130,2088526864,1383233,1602624778,3852897,485902086,2222,1166126,1341883024,1165218,1341772842,908,110182,1128583,15,1381369,129967,2219,880,144444.0,43333.0,-71.0,-67.0,-69.0,-72.0,-70.0,-67.0,-69.0,-71.0,-89.0,-90.0,-87.0,-87.0,18.0,23.0,18.0,15.0,1
2949,CC:2F:71:3E:C5:1F,3853947,486030346,1050,128260,3852897,485902086,3,4583,382046,3819,291364,764,90682,1111,16,1507,32,3,55,130000.0,39000.0,-72.0,-72.0,-69.0,-60.0,-71.0,-70.0,-68.0,-59.0,-89.0,-90.0,-87.0,-87.0,17.0,18.0,18.0,27.0,1
2950,BA:8C:B9:54:50:24,3857879,492101780,4982,6199694,3852897,485902086,7,10143,1778586,10121,1775091,22,3495,2364,18,5525,44,7,79,216660.0,130000.0,-40.0,-36.0,-45.0,-52.0,-43.0,-35.0,-44.0,-49.0,-89.0,-90.0,-87.0,-87.0,49.0,54.0,42.0,35.0,1
2951,62:47:05:9D:EB:15,3869708,521022524,16808,35120174,3852900,485902350,1,14950,5513312,14875,5501823,75,11489,6983,0,16894,283,1,171,229410.0,130000.0,-55.0,-54.0,-58.0,-62.0,-54.0,-54.0,-52.0,-62.0,-89.0,-90.0,-87.0,-87.0,34.0,36.0,29.0,25.0,1
2952,92:69:1D:31:68:E9,3857134,489620870,4234,3718520,3852900,485902350,1,5872,1243869,5686,1201491,186,42378,2355,12,4517,104,1,66,229410.0,137640.0,-51.0,-48.0,-44.0,-47.0,-51.0,-48.0,-43.0,-48.0,-89.0,-90.0,-87.0,-87.0,38.0,42.0,43.0,40.0,1
2953,CC:2F:71:3F:1F:24,5236180,2088544758,1383280,1602642408,3852900,485902350,2222,1166152,1341887612,1165243,1341777312,909,110300,1128608,15,1381416,129981,2219,880,144444.0,43333.0,-71.0,-67.0,-69.0,-72.0,-70.0,-67.0,-69.0,-71.0,-89.0,-90.0,-87.0,-87.0,18.0,23.0,18.0,15.0,1
2954,CC:2F:71:3E:C5:1F,3853952,486030812,1050,128260,3852902,485902552,3,4583,382046,3819,291364,764,90682,1111,16,1507,32,3,55,130000.0,39000.0,-72.0,-72.0,-69.0,-60.0,-71.0,-70.0,-68.0,-59.0,-89.0,-90.0,-87.0,-87.0,17.0,18.0,18.0,27.0,1
2955,BA:8C:B9:54:50:24,3857884,492102246,4982,6199694,3852902,485902552,7,10143,1778586,10121,1775091,22,3495,2364,18,5525,44,7,79,216660.0,130000.0,-40.0,-36.0,-45.0,-52.0,-43.0,-35.0,-44.0,-49.0,-89.0,-90.0,-87.0,-87.0,49.0,54.0,42.0,35.0,1
2956,62:47:05:9D:EB:15,3869726,521036574,16822,35133820,3852904,485902754,1,14988,5538256,14913,5526767,75,11489,7006,0,16908,283,1,173,229410.0,137640.0,-57.0,-57.0,-54.0,-65.0,-56.0,-56.0,-52.0,-64.0,-89.0,-90.0,-87.0,-87.0,32.0,33.0,33.0,22.0,1
2957,92:69:1D:31:68:E9,3857142,489621598,4234,3718520,3852908,485903078,1,5872,1243869,5686,1201491,186,42378,2355,12,4517,104,1,66,229410.0,137640.0,-51.0,-48.0,-44.0,-47.0,-51.0,-48.0,-43.0,-48.0,-89.0,-90.0,-87.0,-87.0,38.0,42.0,43.0,40.0,1
2958,CC:2F:71:3F:1F:24,5236243,2088566733,1383335,1602663655,3852908,485903078,2222,1166188,1341893804,1165279,1341783504,909,110300,1128642,15,1381471,129996,2219,880,144444.0,43333.0,-71.0,-67.0,-69.0,-72.0,-70.0,-67.0,-69.0,-71.0,-89.0,-90.0,-87.0,-87.0,18.0,23.0,18.0,15.0,1
2959,CC:2F:71:3E:C5:1F,3853958,486031338,1050,128260,3852908,485903078,3,4585,382234,3820,291434,765,90800,1112,16,1507,32,3,55,130000.0,39000.0,-72.0,-71.0,-69.0,-60.0,-71.0,-71.0,-69.0,-59.0,-89.0,-90.0,-87.0,-87.0,17.0,19.0,18.0,27.0,1
2960,BA:8C:B9:54:50:24,3857890,492102772,4982,6199694,3852908,485903078,7,10143,1778586,10121,1775091,22,3495,2364,18,5525,44,7,79,216660.0,130000.0,-40.0,-36.0,-45.0,-52.0,-43.0,-35.0,-44.0,-49.0,-89.0,-90.0,-87.0,-87.0,49.0,54.0,42.0,35.0,1
2961,62:47:05:9D:EB:15,3869746,521042159,16838,35139081,3852908,485903078,1,15049,5572697,14974,5561208,75,11489,7032,0,16924,283,1,173,229410.0,137640.0,-54.0,-55.0,-50.0,-62.0,-55.0,-55.0,-53.0,-63.0,-89.0,-90.0,-87.0,-87.0,35.0,35.0,37.0,25.0,1
2962,92:69:1D:31:68:E9,3857144,489621800,4234,3718520,3852910,485903280,1,5872,1243869,5686,1201491,186,42378,2355,12,4517,104,1,66,229410.0,137640.0,-51.0,-48.0,-44.0,-47.0,-51.0,-48.0,-43.0,-48.0,-89.0,-90.0,-87.0,-87.0,38.0,42.0,43.0,40.0,1
2963,CC:2F:71:3F:1F:24,5236293,2088584637,1383381,1602681155,3852912,485903482,2222,1166216,1341898622,1165307,1341788322,909,110300,1128669,15,1381517,130002,2219,880,144444.0,43333.0,-71.0,-68.0,-70.0,-72.0,-70.0,-67.0,-69.0,-72.0,-89.0,-90.0,-87.0,-87.0,18.0,22.0,17.0,15.0,1
2964,CC:2F:71:3E:C5:1F,3853962,486031742,1050,128260,3852912,485903482,3,4585,382234,3820,291434,765,90800,1112,16,1507,32,3,55,130000.0,39000.0,-72.0,-71.0,-69.0,-60.0,-71.0,-71.0,-69.0,-59.0,-89.0,-90.0,-87.0,-87.0,17.0,19.0,18.0,27.0,1
2965,BA:8C:B9:54:50:24,3857894,492103176,4982,6199694,3852912,485903482,7,10143,1778586,10121,1775091,22,3495,2364,18,5525,44,7,79,216660.0,130000.0,-40.0,-36.0,-45.0,-52.0,-43.0,-35.0,-44.0,-49.0,-89.0,-90.0,-87.0,-87.0,49.0,54.0,42.0,35.0,1
2966,62:47:05:9D:EB:15,3870509,523245327,17593,37341441,3852916,485903886,1,15223,5603413,15148,5591924,75,11489,7147,0,17647,283,1,174,229410.0,137640.0,-55.0,-54.0,-60.0,-62.0,-56.0,-55.0,-53.0,-64.0,-89.0,-90.0,-87.0,-87.0,34.0,36.0,27.0,25.0,1
2967,92:69:1D:31:68:E9,3857150,489622406,4234,3718520,3852916,485903886,1,5872,1243869,5686,1201491,186,42378,2355,12,4517,104,1,66,229410.0,137640.0,-51.0,-48.0,-44.0,-47.0,-51.0,-48.0,-43.0,-48.0,-89.0,-90.0,-87.0,-87.0,38.0,42.0,43.0,40.0,1
2968,CC:2F:71:3F:1F:24,5236345,2088602801,1383429,1602698915,3852916,485903886,2222,1166247,1341903864,1165338,1341793564,909,110300,1128697,15,1381565,130012,2219,880,144444.0,43333.0,-71.0,-67.0,-69.0,-72.0,-72.0,-68.0,-70.0,-73.0,-89.0,-90.0,-87.0,-87.0,18.0,23.0,18.0,15.0,1
2969,CC:2F:71:3E:C5:1F,3853966,486032146,1050,128260,3852916,485903886,3,4585,382234,3820,291434,765,90800,1112,16,1507,32,3,55,130000.0,39000.0,-72.0,-71.0,-69.0,-60.0,-71.0,-71.0,-69.0,-59.0,-89.0,-90.0,-87.0,-87.0,17.0,19.0,18.0,27.0,1
2970,BA:8C:B9:54:50:24,3857898,492103580,4982,6199694,3852916,485903886,7,10143,1778586,10121,1775091,22,3495,2364,18,5525,44,7,79,216660.0,130000.0,-40.0,-36.0,-45.0,-52.0,-43.0,-35.0,-44.0,-49.0,-89.0,-90.0,-87.0,-87.0,49.0,54.0,42.0,35.0,1
2971,62:47:05:9D:EB:15,3870655,523611047,17734,37706697,3852921,485904350,1,15284,5616439,15209,5604950,75,11489,7187,0,17820,283,1,175,229410.0,137640.0,-54.0,-54.0,-50.0,-62.0,-56.0,-55.0,-53.0,-64.0,-89.0,-90.0,-87.0,-87.0,35.0,36.0,37.0,25.0,1
2972,92:69:1D:31:68:E9,3857155,489622870,4234,3718520,3852921,485904350,1,5872,1243869,5686,1201491,186,42378,2355,12,4517,104,1,66,229410.0,137640.0,-51.0,-48.0,-44.0,-47.0,-51.0,-48.0,-43.0,-48.0,-89.0,-90.0,-87.0,-87.0,38.0,42.0,43.0,40.0,1
2973,CC:2F:71:3F:1F:24,5236398,2088621025,1383477,1602716675,3852921,485904350,2222,1166277,1341909166,1165368,1341798866,909,110300,1128724,15,1381613,130019,2219,880,144444.0,43333.0,-71.0,-68.0,-69.0,-72.0,-71.0,-68.0,-69.0,-72.0,-89.0,-90.0,-87.0,-87.0,18.0,22.0,18.0,15.0,1
2974,CC:2F:71:3E:C5:1F,3853971,486032610,1050,128260,3852921,485904350,3,4585,382234,3820,291434,765,90800,1112,16,1507,32,3,55,130000.0,39000.0,-72.0,-71.0,-69.0,-60.0,-71.0,-71.0,-69.0,-59.0,-89.0,-90.0,-87.0,-87.0,17.0,19.0,18.0,27.0,1
2975,BA:8C:B9:54:50:24,3857903,492104044,4982,6199694,3852921,485904350,7,10143,1778586,10121,1775091,22,3495,2364,18,5525,44,7,79,216660.0,130000.0,-40.0,-36.0,-45.0,-52.0,-43.0,-35.0,-44.0,-49.0,-89.0,-90.0,-87.0,-87.0,49.0,54.0,42.0,35.0,1
2976,62:47:05:9D:EB:15,3870662,523612228,17737,37707474,3852925,485904754,1,15315,5618976,15240,5607487,75,11489,7193,0,17823,283,1,175,229410.0,137640.0,-58.0,-57.0,-55.0,-65.0,-57.0,-57.0,-54.0,-65.0,-90.0,-90.0,-87.0,-88.0,32.0,33.0,32.0,23.0,1
2977,92:69:1D:31:68:E9,3857159,489623274,4234,3718520,3852925,485904754,1,5872,1243869,5686,1201491,186,42378,2355,12,4517,104,1,66,229410.0,137640.0,-51.0,-48.0,-44.0,-47.0,-51.0,-48.0,-43.0,-48.0,-90.0,-90.0,-87.0,-88.0,39.0,42.0,43.0,41.0,1
2978,CC:2F:71:3F:1F:24,5236467,2088645686,1383542,1602740932,3852925,485904754,2222,1166326,1341917931,1165417,1341807631,909,110300,1128768,15,1381678,130042,2219,880,144444.0,43333.0,-77.0,-74.0,-76.0,-78.0,-73.0,-70.0,-72.0,-74.0,-90.0,-90.0,-87.0,-88.0,13.0,16.0,11.0,10.0,1
2979,CC:2F:71:3E:C5:1F,3853975,486033014,1050,128260,3852925,485904754,3,4585,382234,3820,291434,765,90800,1112,16,1507,32,3,55,130000.0,39000.0,-72.0,-71.0,-69.0,-60.0,-71.0,-71.0,-69.0,-59.0,-90.0,-90.0,-87.0,-88.0,18.0,19.0,18.0,28.0,1
2980,BA:8C:B9:54:50:24,3857907,492104448,4982,6199694,3852925,485904754,7,10143,1778586,10121,1775091,22,3495,2364,18,5525,44,7,79,216660.0,130000.0,-40.0,-36.0,-45.0,-52.0,-43.0,-35.0,-44.0,-49.0,-90.0,-90.0,-87.0,-88.0,50.0,54.0,42.0,36.0,1
2981,62:47:05:9D:EB:15,3871692,526718353,18762,40813135,3852930,485905218,1,15535,5653056,15460,5641567,75,11489,7334,0,18848,354,1,175,229410.0,137640.0,-58.0,-58.0,-56.0,-66.0,-57.0,-57.0,-55.0,-65.0,-89.0,-90.0,-87.0,-87.0,31.0,32.0,31.0,21.0,1
2982,92:69:1D:31:68:E9,3857164,489623738,4234,3718520,3852930,485905218,1,5872,1243869,5686,1201491,186,42378,2355,12,4517,104,1,66,229410.0,137640.0,-51.0,-48.0,-44.0,-47.0,-51.0,-48.0,-43.0,-48.0,-89.0,-90.0,-87.0,-87.0,38.0,42.0,43.0,40.0,1
2983,CC:2F:71:3F:1F:24,5236520,2088663926,1383590,1602758708,3852930,485905218,2222,1166353,1341922633,1165444,1341812333,909,110300,1128794,15,1381726,130045,2219,880,144444.0,43333.0,-70.0,-67.0,-69.0,-71.0,-74.0,-71.0,-73.0,-75.0,-89.0,-90.0,-87.0,-87.0,19.0,23.0,18.0,16.0,1
2984,CC:2F:71:3E:C5:1F,3853980,486033478,1050,128260,3852930,485905218,3,4585,382234,3820,291434,765,90800,1112,16,1507,32,3,55,130000.0,39000.0,-72.0,-71.0,-69.0,-60.0,-71.0,-71.0,-69.0,-59.0,-89.0,-90.0,-87.0,-87.0,17.0,19.0,18.0,27.0,1
2985,BA:8C:B9:54:50:24,3857912,492104912,4982,6199694,3852930,485905218,7,10143,1778586,10121,1775091,22,3495,2364,18,5525,44,7,79,216660.0,130000.0,-40.0,-36.0,-45.0,-52.0,-43.0,-35.0,-44.0,-49.0,-89.0,-90.0,-87.0,-87.0,49.0,54.0,42.0,35.0,1
2986,62:47:05:9D:EB:15,3871850,527108294,18916,41202672,3852934,485905622,1,15626,5670863,15551,5659374,75,11489,7392,0,19002,354,1,175,229410.0,137640.0,-58.0,-57.0,-56.0,-66.0,-58.0,-57.0,-55.0,-66.0,-89.0,-90.0,-87.0,-87.0,31.0,33.0,31.0,21.0,1
2987,92:69:1D:31:68:E9,3857168,489624142,4234,3718520,3852934,485905622,1,5872,1243869,5686,1201491,186,42378,2355,12,4517,104,1,66,229410.0,137640.0,-51.0,-48.0,-44.0,-47.0,-51.0,-48.0,-43.0,-48.0,-89.0,-90.0,-87.0,-87.0,38.0,42.0,43.0,40.0,1
2988,CC:2F:71:3F:1F:24,5236572,2088682106,1383638,1602776484,3852934,485905622,2222,1166380,1341927445,1165471,1341817145,909,110300,1128819,15,1381774,130049,2219,880,144444.0,43333.0,-70.0,-67.0,-68.0,-71.0,-70.0,-67.0,-68.0,-71.0,-89.0,-90.0,-87.0,-87.0,19.0,23.0,19.0,16.0,1
2989,CC:2F:71:3E:C5:1F,3853984,486033882,1050,128260,3852934,485905622,3,4585,382234,3820,291434,765,90800,1112,16,1507,32,3,55,130000.0,39000.0,-72.0,-71.0,-69.0,-60.0,-71.0,-71.0,-69.0,-59.0,-89.0,-90.0,-87.0,-87.0,17.0,19.0,18.0,27.0,1
2990,BA:8C:B9:54:50:24,3857916,492105316,4982,6199694,3852934,485905622,7,10143,1778586,10121,1775091,22,3495,2364,18,5525,44,7,79,216660.0,130000.0,-40.0,-36.0,-45.0,-52.0,-43.0,-35.0,-44.0,-49.0,-89.0,-90.0,-87.0,-87.0,49.0,54.0,42.0,35.0,1
2991,62:47:05:9D:EB:15,3871856,527110176,18918,41204150,3852938,485906026,1,15641,5672138,15566,5660649,75,11489,7395,0,19004,354,1,175,229410.0,137640.0,-55.0,-56.0,-51.0,-65.0,-53.0,-54.0,-51.0,-61.0,-89.0,-90.0,-87.0,-87.0,34.0,34.0,36.0,22.0,1
2992,92:69:1D:31:68:E9,3857172,489624546,4234,3718520,3852938,485906026,1,5872,1243869,5686,1201491,186,42378,2355,12,4517,104,1,66,229410.0,137640.0,-51.0,-48.0,-44.0,-47.0,-51.0,-48.0,-43.0,-48.0,-89.0,-90.0,-87.0,-87.0,38.0,42.0,43.0,40.0,1
2993,CC:2F:71:3F:1F:24,5236630,2088703611,1383692,1602797585,3852938,485906026,2222,1166415,1341933708,1165506,1341823408,909,110300,1128852,15,1381828,130055,2219,880,144444.0,43333.0,-70.0,-67.0,-69.0,-71.0,-70.0,-66.0,-68.0,-70.0,-89.0,-90.0,-87.0,-87.0,19.0,23.0,18.0,16.0,1
2994,CC:2F:71:3E:C5:1F,3853988,486034286,1050,128260,3852938,485906026,3,4586,382304,3821,291504,765,90800,1112,16,1508,32,3,55,130000.0,39000.0,-72.0,-72.0,-70.0,-60.0,-71.0,-71.0,-69.0,-59.0,-89.0,-90.0,-87.0,-87.0,17.0,18.0,17.0,27.0,1
2995,BA:8C:B9:54:50:24,3857922,492105922,4982,6199694,3852940,485906228,7,10145,1778722,10123,1775227,22,3495,2364,18,5526,44,7,79,216660.0,130000.0,-48.0,-35.0,-43.0,-45.0,-44.0,-35.0,-44.0,-48.0,-89.0,-90.0,-87.0,-87.0,41.0,55.0,44.0,42.0,1
2996,62:47:05:9D:EB:15,3871869,527115578,18926,41209088,3852943,485906490,1,15681,5680176,15606,5668687,75,11489,7404,0,19012,354,1,175,229410.0,137640.0,-55.0,-56.0,-51.0,-65.0,-53.0,-53.0,-51.0,-61.0,-89.0,-90.0,-87.0,-87.0,34.0,34.0,36.0,22.0,1
2997,92:69:1D:31:68:E9,3857177,489625010,4234,3718520,3852943,485906490,1,5874,1244005,5688,1201627,186,42378,2355,13,4518,105,1,66,229410.0,137640.0,-53.0,-48.0,-42.0,-49.0,-51.0,-48.0,-43.0,-48.0,-89.0,-90.0,-87.0,-87.0,36.0,42.0,45.0,38.0,1
2998,CC:2F:71:3F:1F:24,5236681,2088721559,1383738,1602815069,3852943,485906490,2222,1166449,1341939582,1165540,1341829282,909,110300,1128881,15,1381874,130063,2219,880,144444.0,43333.0,-71.0,-67.0,-69.0,-71.0,-70.0,-67.0,-68.0,-71.0,-89.0,-90.0,-87.0,-87.0,18.0,23.0,18.0,16.0,1
2999,CC:2F:71:3E:C5:1F,3853993,486034750,1050,128260,3852943,485906490,3,4587,382374,3822,291574,765,90800,1112,16,1508,32,3,55,130000.0,39000.0,-72.0,-72.0,-70.0,-60.0,-71.0,-71.0,-69.0,-59.0,-89.0,-90.0,-87.0,-87.0,17.0,18.0,17.0,27.0,1
3000,BA:8C:B9:54:50:24,3857925,492106184,4982,6199694,3852943,485906490,7,10145,1778722,10123,1775227,22,3495,2364,18,5526,44,7,79,216660.0,130000.0,-48.0,-35.0,-43.0,-45.0,-44.0,-35.0,-44.0,-48.0,-89.0,-90.0,-87.0,-87.0,41.0,55.0,44.0,42.0,1
3001,62:47:05:9D:EB:15,3871873,527115982,18926,41209088,3852947,485906894,1,15681,5680176,15606,5668687,75,11489,7404,0,19012,354,1,175,229410.0,137640.0,-55.0,-56.0,-51.0,-65.0,-53.0,-53.0,-51.0,-61.0,-89.0,-90.0,-87.0,-87.0,34.0,34.0,36.0,22.0,1
3002,92:69:1D:31:68:E9,3857181,489625414,4234,3718520,3852947,485906894,1,5874,1244005,5688,1201627,186,42378,2355,13,4518,105,1,66,229410.0,137640.0,-53.0,-48.0,-42.0,-49.0,-51.0,-48.0,-43.0,-48.0,-89.0,-90.0,-87.0,-87.0,36.0,42.0,45.0,38.0,1
3003,CC:2F:71:3F:1F:24,5236734,2088739795,1383785,1602832699,3852949,485907096,2222,1166481,1341945036,1165572,1341834736,909,110300,1128910,15,1381921,130069,2219,880,144444.0,43333.0,-71.0,-67.0,-70.0,-71.0,-70.0,-67.0,-69.0,-71.0,-89.0,-90.0,-87.0,-87.0,18.0,23.0,17.0,16.0,1
3004,CC:2F:71:3E:C5:1F,3854000,486035629,1050,128260,3852950,485907369,3,4587,382374,3822,291574,765,90800,1112,16,1508,32,3,55,130000.0,39000.0,-72.0,-72.0,-70.0,-60.0,-71.0,-71.0,-69.0,-59.0,-89.0,-90.0,-87.0,-87.0,17.0,18.0,17.0,27.0,1
3005,BA:8C:B9:54:50:24,3857932,492107063,4982,6199694,3852950,485907369,7,10145,1778722,10123,1775227,22,3495,2364,18,5526,44,7,79,216660.0,130000.0,-48.0,-35.0,-43.0,-45.0,-44.0,-35.0,-44.0,-48.0,-89.0,-90.0,-87.0,-87.0,41.0,55.0,44.0,42.0,1
3006,62:47:05:9D:EB:15,3871879,527116719,18926,41209088,3852953,485907631,1,15681,5680176,15606,5668687,75,11489,7404,0,19012,354,1,175,229410.0,137640.0,-55.0,-56.0,-51.0,-65.0,-53.0,-53.0,-51.0,-61.0,-89.0,-90.0,-87.0,-87.0,34.0,34.0,36.0,22.0,1
3007,92:69:1D:31:68:E9,3857187,489626151,4234,3718520,3852953,485907631,1,5874,1244005,5688,1201627,186,42378,2355,13,4518,105,1,66,229410.0,137640.0,-53.0,-48.0,-42.0,-49.0,-51.0,-48.0,-43.0,-48.0,-89.0,-90.0,-87.0,-87.0,36.0,42.0,45.0,38.0,1
3008,CC:2F:71:3F:1F:24,5236785,2088757960,1383832,1602850329,3852953,485907631,2222,1166517,1341951078,1165608,1341840778,909,110300,1128941,15,1381968,130078,2219,880,144444.0,43333.0,-70.0,-67.0,-69.0,-71.0,-70.0,-67.0,-69.0,-71.0,-89.0,-90.0,-87.0,-87.0,19.0,23.0,18.0,16.0,1
3009,CC:2F:71:3E:C5:1F,3854003,486035891,1050,128260,3852953,485907631,3,4587,382374,3822,291574,765,90800,1112,16,1508,32,3,55,130000.0,39000.0,-72.0,-72.0,-70.0,-60.0,-71.0,-71.0,-69.0,-59.0,-89.0,-90.0,-87.0,-87.0,17.0,18.0,17.0,27.0,1
3010,BA:8C:B9:54:50:24,3857935,492107325,4982,6199694,3852953,485907631,7,10145,1778722,10123,1775227,22,3495,2364,18,5526,44,7,79,216660.0,130000.0,-48.0,-35.0,-43.0,-45.0,-44.0,-35.0,-44.0,-48.0,-89.0,-90.0,-87.0,-87.0,41.0,55.0,44.0,42.0,1
3011,62:47:05:9D:EB:15,3871883,527117123,18926,41209088,3852957,485908035,1,15681,5680176,15606,5668687,75,11489,7404,0,19012,354,1,175,229410.0,137640.0,-55.0,-56.0,-51.0,-65.0,-53.0,-53.0,-51.0,-61.0,-89.0,-90.0,-87.0,-87.0,34.0,34.0,36.0,22.0,1
3012,92:69:1D:31:68:E9,3857193,489626757,4234,3718520,3852959,485908237,1,5874,1244005,5688,1201627,186,42378,2355,13,4518,105,1,66,229410.0,137640.0,-53.0,-48.0,-42.0,-49.0,-51.0,-48.0,-43.0,-48.0,-89.0,-90.0,-87.0,-87.0,36.0,42.0,45.0,38.0,1
3013,CC:2F:71:3F:1F:24,5236846,2088779797,1383887,1602871560,3852959,485908237,2222,1166556,1341957789,1165647,1341847489,909,110300,1128974,15,1382023,130090,2219,880,144444.0,43333.0,-72.0,-68.0,-70.0,-72.0,-71.0,-68.0,-70.0,-72.0,-89.0,-90.0,-87.0,-87.0,17.0,22.0,17.0,15.0,1
3014,CC:2F:71:3E:C5:1F,3854009,486036497,1050,128260,3852959,485908237,3,4587,382374,3822,291574,765,90800,1112,16,1508,32,3,55,130000.0,39000.0,-72.0,-72.0,-70.0,-60.0,-71.0,-71.0,-69.0,-59.0,-89.0,-90.0,-87.0,-87.0,17.0,18.0,17.0,27.0,1
3015,BA:8C:B9:54:50:24,3857941,492107931,4982,6199694,3852959,485908237,7,10145,1778722,10123,1775227,22,3495,2364,18,5526,44,7,79,216660.0,130000.0,-48.0,-35.0,-43.0,-45.0,-44.0,-35.0,-44.0,-48.0,-89.0,-90.0,-87.0,-87.0,41.0,55.0,44.0,42.0,1
3016,62:47:05:9D:EB:15,3871890,527118762,18926,41209088,3852964,485909674,1,15683,5680415,15607,5668755,76,11660,7405,0,19012,354,1,175,229410.0,137640.0,-57.0,-56.0,-54.0,-65.0,-54.0,-54.0,-51.0,-62.0,-89.0,-90.0,-87.0,-87.0,32.0,34.0,33.0,22.0,1
3017,92:69:1D:31:68:E9,3857198,489628194,4234,3718520,3852964,485909674,1,5874,1244005,5688,1201627,186,42378,2355,13,4518,105,1,66,229410.0,137640.0,-53.0,-48.0,-42.0,-49.0,-51.0,-48.0,-43.0,-48.0,-89.0,-90.0,-87.0,-87.0,36.0,42.0,45.0,38.0,1
3018,CC:2F:71:3F:1F:24,5236898,2088798880,1383934,1602889206,3852964,485909674,2222,1166581,1341962259,1165672,1341851959,909,110300,1128998,15,1382070,130112,2219,880,144444.0,43333.0,-71.0,-67.0,-69.0,-72.0,-71.0,-67.0,-69.0,-72.0,-89.0,-90.0,-87.0,-87.0,18.0,23.0,18.0,15.0,1
3019,CC:2F:71:3E:C5:1F,3854014,486037934,1050,128260,3852964,485909674,3,4587,382374,3822,291574,765,90800,1112,16,1508,32,3,55,130000.0,39000.0,-72.0,-72.0,-70.0,-60.0,-71.0,-71.0,-69.0,-59.0,-89.0,-90.0,-87.0,-87.0,17.0,18.0,17.0,27.0,1
3020,BA:8C:B9:54:50:24,3857946,492109368,4982,6199694,3852964,485909674,7,10145,1778722,10123,1775227,22,3495,2364,18,5526,44,7,79,216660.0,130000.0,-48.0,-35.0,-43.0,-45.0,-44.0,-35.0,-44.0,-48.0,-89.0,-90.0,-87.0,-87.0,41.0,55.0,44.0,42.0,1
3021,62:47:05:9D:EB:15,3871897,527119428,18926,41209088,3852971,485910340,1,15684,5680483,15608,5668823,76,11660,7405,0,19012,354,1,175,229410.0,137640.0,-55.0,-54.0,-50.0,-63.0,-54.0,-54.0,-51.0,-62.0,-89.0,-90.0,-87.0,-87.0,34.0,36.0,37.0,24.0,1
3022,92:69:1D:31:68:E9,3857205,489628860,4234,3718520,3852971,485910340,1,5874,1244005,5688,1201627,186,42378,2355,13,4518,105,1,66,229410.0,137640.0,-53.0,-48.0,-42.0,-49.0,-51.0,-48.0,-43.0,-48.0,-89.0,-90.0,-87.0,-87.0,36.0,42.0,45.0,38.0,1
3023,CC:2F:71:3F:1F:24,5236951,2088817046,1383980,1602906706,3852971,485910340,2222,1166610,1341967335,1165701,1341857035,909,110300,1129025,15,1382116,130139,2219,880,144444.0,43333.0,-71.0,-67.0,-69.0,-72.0,-70.0,-67.0,-69.0,-71.0,-89.0,-90.0,-87.0,-87.0,18.0,23.0,18.0,15.0,1
3024,CC:2F:71:3E:C5:1F,3854023,486039724,1050,128260,3852973,485911464,3,4587,382374,3822,291574,765,90800,1112,16,1508,32,3,55,130000.0,39000.0,-72.0,-72.0,-70.0,-60.0,-71.0,-71.0,-69.0,-59.0,-89.0,-90.0,-87.0,-87.0,17.0,18.0,17.0,27.0,1
3025,BA:8C:B9:54:50:24,3857955,492111158,4982,6199694,3852973,485911464,7,10145,1778722,10123,1775227,22,3495,2364,18,5526,44,7,79,216660.0,130000.0,-48.0,-35.0,-43.0,-45.0,-44.0,-35.0,-44.0,-48.0,-89.0,-90.0,-87.0,-87.0,41.0,55.0,44.0,42.0,1
3026,62:47:05:9D:EB:15,3871914,527124656,18939,41212990,3852975,485911666,1,15722,5690742,15646,5679082,76,11660,7418,0,19025,354,1,175,229410.0,137640.0,-58.0,-56.0,-55.0,-65.0,-57.0,-56.0,-54.0,-64.0,-89.0,-90.0,-87.0,-87.0,31.0,34.0,32.0,22.0,1
3027,92:69:1D:31:68:E9,3857209,489630186,4234,3718520,3852975,485911666,1,5874,1244005,5688,1201627,186,42378,2355,13,4518,105,1,66,229410.0,137640.0,-53.0,-48.0,-42.0,-49.0,-51.0,-48.0,-43.0,-48.0,-89.0,-90.0,-87.0,-87.0,36.0,42.0,45.0,38.0,1
3028,CC:2F:71:3F:1F:24,5237002,2088836018,1384027,1602924352,3852975,485911666,2222,1166636,1341971921,1165727,1341861621,909,110300,1129050,15,1382163,130162,2219,880,144444.0,43333.0,-71.0,-68.0,-69.0,-72.0,-70.0,-67.0,-69.0,-71.0,-89.0,-90.0,-87.0,-87.0,18.0,22.0,18.0,15.0,1
3029,CC:2F:71:3E:C5:1F,3854025,486039926,1050,128260,3852975,485911666,3,4587,382374,3822,291574,765,90800,1112,16,1508,32,3,55,130000.0,39000.0,-72.0,-72.0,-70.0,-60.0,-71.0,-71.0,-69.0,-59.0,-89.0,-90.0,-87.0,-87.0,17.0,18.0,17.0,27.0,1
3030,BA:8C:B9:54:50:24,3857959,492111562,4982,6199694,3852977,485911868,7,10145,1778722,10123,1775227,22,3495,2364,18,5526,44,7,79,216660.0,130000.0,-48.0,-35.0,-43.0,-45.0,-44.0,-35.0,-44.0,-48.0,-89.0,-90.0,-87.0,-87.0,41.0,55.0,44.0,42.0,1
3031,62:47:05:9D:EB:15,3871924,527126317,18942,41213985,3852982,485912332,1,15735,5691754,15659,5680094,76,11660,7420,0,19028,354,1,175,229410.0,137640.0,-54.0,-54.0,-56.0,-66.0,-53.0,-53.0,-51.0,-63.0,-89.0,-90.0,-87.0,-87.0,35.0,36.0,31.0,21.0,1
3032,92:69:1D:31:68:E9,3857218,489631976,4234,3718520,3852984,485913456,1,5875,1244073,5689,1201695,186,42378,2355,13,4518,105,1,66,229410.0,137640.0,-51.0,-49.0,-44.0,-47.0,-51.0,-48.0,-43.0,-48.0,-89.0,-90.0,-87.0,-87.0,38.0,41.0,43.0,40.0,1
3033,CC:2F:71:3F:1F:24,5237064,2088858779,1384080,1602945323,3852984,485913456,2222,1166674,1341978404,1165765,1341868104,909,110300,1129086,15,1382216,130164,2219,880,144444.0,43333.0,-72.0,-68.0,-69.0,-69.0,-72.0,-68.0,-69.0,-69.0,-89.0,-90.0,-87.0,-87.0,17.0,22.0,18.0,18.0,1
3034,CC:2F:71:3E:C5:1F,3854034,486041716,1050,128260,3852984,485913456,3,4587,382374,3822,291574,765,90800,1112,16,1508,32,3,55,130000.0,39000.0,-72.0,-72.0,-70.0,-60.0,-71.0,-71.0,-69.0,-59.0,-89.0,-90.0,-87.0,-87.0,17.0,18.0,17.0,27.0,1
3035,BA:8C:B9:54:50:24,3857966,492113150,4982,6199694,3852984,485913456,7,10145,1778722,10123,1775227,22,3495,2364,18,5526,44,7,79,216660.0,130000.0,-48.0,-35.0,-43.0,-45.0,-44.0,-35.0,-44.0,-48.0,-89.0,-90.0,-87.0,-87.0,41.0,55.0,44.0,42.0,1
3036,62:47:05:9D:EB:15,3871928,527127643,18942,41213985,3852986,485913658,1,15735,5691754,15659,5680094,76,11660,7420,0,19028,354,1,175,229410.0,137640.0,-54.0,-54.0,-56.0,-66.0,-53.0,-53.0,-51.0,-63.0,-89.0,-90.0,-87.0,-87.0,35.0,36.0,31.0,21.0,1
3037,92:69:1D:31:68:E9,3857220,489632178,4234,3718520,3852986,485913658,1,5875,1244073,5689,1201695,186,42378,2355,13,4518,105,1,66,229410.0,137640.0,-51.0,-49.0,-44.0,-47.0,-51.0,-48.0,-43.0,-48.0,-89.0,-90.0,-87.0,-87.0,38.0,41.0,43.0,40.0,1
3038,CC:2F:71:3F:1F:24,5237113,2088876499,1384127,1602962841,3852986,485913658,2222,1166706,1341984062,1165797,1341873762,909,110300,1129113,15,1382263,130164,2219,880,144444.0,39000.0,-71.0,-67.0,-70.0,-69.0,-71.0,-67.0,-69.0,-69.0,-89.0,-90.0,-87.0,-87.0,18.0,23.0,17.0,18.0,1
3039,CC:2F:71:3E:C5:1F,3854038,486042120,1050,128260,3852988,485913860,3,4587,382374,3822,291574,765,90800,1112,16,1508,32,3,55,130000.0,39000.0,-72.0,-72.0,-70.0,-60.0,-71.0,-71.0,-69.0,-59.0,-89.0,-90.0,-87.0,-87.0,17.0,18.0,17.0,27.0,1
3040,BA:8C:B9:54:50:24,3857970,492113554,4982,6199694,3852988,485913860,7,10145,1778722,10123,1775227,22,3495,2364,18,5526,44,7,79,216660.0,130000.0,-48.0,-35.0,-43.0,-45.0,-44.0,-35.0,-44.0,-48.0,-89.0,-90.0,-87.0,-87.0,41.0,55.0,44.0,42.0,1
3041,62:47:05:9D:EB:15,3871934,527128249,18942,41213985,3852992,485914264,1,15735,5691754,15659,5680094,76,11660,7420,0,19028,354,1,175,229410.0,137640.0,-54.0,-54.0,-56.0,-66.0,-53.0,-53.0,-51.0,-63.0,-89.0,-90.0,-87.0,-87.0,35.0,36.0,31.0,21.0,1
3042,92:69:1D:31:68:E9,3857226,489632784,4234,3718520,3852992,485914264,1,5875,1244073,5689,1201695,186,42378,2355,13,4518,105,1,66,229410.0,137640.0,-51.0,-49.0,-44.0,-47.0,-51.0,-48.0,-43.0,-48.0,-89.0,-90.0,-86.0,-87.0,38.0,41.0,42.0,40.0,1
3043,CC:2F:71:3F:1F:24,5237167,2088894809,1384175,1602980545,3852992,485914264,2222,1166735,1341989010,1165826,1341878710,909,110300,1129140,15,1382311,130175,2219,880,144444.0,43333.0,-73.0,-67.0,-70.0,-71.0,-73.0,-68.0,-70.0,-71.0,-89.0,-90.0,-86.0,-87.0,16.0,23.0,16.0,16.0,1
3044,CC:2F:71:3E:C5:1F,3854042,486042524,1050,128260,3852992,485914264,3,4587,382374,3822,291574,765,90800,1112,16,1508,32,3,55,130000.0,39000.0,-72.0,-72.0,-70.0,-60.0,-71.0,-71.0,-69.0,-59.0,-89.0,-90.0,-86.0,-87.0,17.0,18.0,16.0,27.0,1
3045,BA:8C:B9:54:50:24,3857976,492114160,4982,6199694,3852994,485914466,7,10145,1778722,10123,1775227,22,3495,2364,18,5526,44,7,79,216660.0,130000.0,-48.0,-35.0,-43.0,-45.0,-44.0,-35.0,-44.0,-48.0,-89.0,-90.0,-86.0,-87.0,41.0,55.0,43.0,42.0,1
3046,62:47:05:9D:EB:15,3871937,527128511,18942,41213985,3852995,485914526,1,15735,5691754,15659,5680094,76,11660,7420,0,19028,354,1,175,229410.0,137640.0,-54.0,-54.0,-56.0,-66.0,-53.0,-53.0,-51.0,-63.0,-89.0,-90.0,-86.0,-87.0,35.0,36.0,30.0,21.0,1
3047,92:69:1D:31:68:E9,3857231,489633248,4234,3718520,3852997,485914728,1,5875,1244073,5689,1201695,186,42378,2355,13,4518,105,1,66,229410.0,137640.0,-51.0,-49.0,-44.0,-47.0,-51.0,-48.0,-43.0,-48.0,-89.0,-90.0,-86.0,-87.0,38.0,41.0,42.0,40.0,1
3048,CC:2F:71:3F:1F:24,5237219,2088912903,1384222,1602998175,3852997,485914728,2222,1166764,1341994020,1165855,1341883720,909,110300,1129166,15,1382358,130204,2219,880,144444.0,43333.0,-71.0,-68.0,-70.0,-70.0,-71.0,-67.0,-69.0,-69.0,-89.0,-90.0,-86.0,-87.0,18.0,22.0,16.0,17.0,1
3049,CC:2F:71:3E:C5:1F,3854047,486042988,1050,128260,3852997,485914728,3,4587,382374,3822,291574,765,90800,1112,16,1508,32,3,55,130000.0,39000.0,-72.0,-72.0,-70.0,-60.0,-71.0,-71.0,-69.0,-59.0,-89.0,-90.0,-86.0,-87.0,17.0,18.0,16.0,27.0,1
3050,BA:8C:B9:54:50:24,3857979,492114422,4982,6199694,3852997,485914728,7,10145,1778722,10123,1775227,22,3495,2364,18,5526,44,7,79,216660.0,130000.0,-48.0,-35.0,-43.0,-45.0,-44.0,-35.0,-44.0,-48.0,-89.0,-90.0,-86.0,-87.0,41.0,55.0,43.0,42.0,1
3051,62:47:05:9D:EB:15,3871946,527129605,18945,41214473,3853001,485915132,1,15758,5694010,15682,5682350,76,11660,7428,0,19031,354,1,177,216660.0,130000.0,-59.0,-65.0,-64.0,-64.0,-59.0,-65.0,-63.0,-64.0,-89.0,-90.0,-86.0,-87.0,30.0,25.0,22.0,23.0,1
3052,92:69:1D:31:68:E9,3857236,489633712,4235,3718580,3853001,485915132,1,5877,1244209,5691,1201831,186,42378,2355,13,4519,105,1,66,216660.0,130000.0,-52.0,-47.0,-42.0,-49.0,-51.0,-47.0,-42.0,-48.0,-89.0,-90.0,-86.0,-87.0,37.0,43.0,44.0,38.0,1
3053,CC:2F:71:3F:1F:24,5237278,2088934522,1384277,1603019390,3853001,485915132,2222,1166801,1342000670,1165892,1341890370,909,110300,1129198,15,1382413,130222,2219,880,144444.0,43333.0,-71.0,-68.0,-71.0,-70.0,-70.0,-67.0,-70.0,-69.0,-89.0,-90.0,-86.0,-87.0,18.0,22.0,15.0,17.0,1
3054,CC:2F:71:3E:C5:1F,3854052,486043508,1051,128376,3853001,485915132,3,4589,382514,3824,291714,765,90800,1112,16,1509,32,3,55,130000.0,39000.0,-72.0,-72.0,-68.0,-60.0,-72.0,-71.0,-69.0,-59.0,-89.0,-90.0,-86.0,-87.0,17.0,18.0,18.0,27.0,1
3055,BA:8C:B9:54:50:24,3857987,492115206,4983,6199810,3853004,485915396,7,10147,1778858,10125,1775363,22,3495,2364,18,5527,44,7,79,216660.0,130000.0,-40.0,-37.0,-46.0,-52.0,-43.0,-35.0,-44.0,-49.0,-89.0,-90.0,-86.0,-87.0,49.0,53.0,40.0,35.0,1
3056,62:47:05:9D:EB:15,3872096,527573511,19089,41657853,3853007,485915658,1,15781,5698493,15705,5686833,76,11660,7442,0,19175,354,1,177,216660.0,130000.0,-50.0,-57.0,-57.0,-59.0,-50.0,-59.0,-56.0,-58.0,-89.0,-90.0,-86.0,-87.0,39.0,33.0,29.0,28.0,1
3057,92:69:1D:31:68:E9,3857242,489634238,4235,3718580,3853007,485915658,1,5877,1244209,5691,1201831,186,42378,2355,13,4519,105,1,66,216660.0,130000.0,-52.0,-47.0,-42.0,-49.0,-51.0,-47.0,-42.0,-48.0,-89.0,-90.0,-86.0,-87.0,37.0,43.0,44.0,38.0,1
3058,CC:2F:71:3F:1F:24,5237332,2088952824,1384325,1603037166,3853007,485915658,2222,1166829,1342005488,1165920,1341895188,909,110300,1129225,15,1382461,130248,2219,880,144444.0,43333.0,-73.0,-71.0,-73.0,-72.0,-72.0,-70.0,-72.0,-72.0,-89.0,-90.0,-86.0,-87.0,16.0,19.0,13.0,15.0,1
3059,CC:2F:71:3E:C5:1F,3854058,486044034,1051,128376,3853007,485915658,3,4591,382702,3825,291784,766,90918,1113,16,1509,32,3,55,130000.0,39000.0,-73.0,-72.0,-67.0,-60.0,-72.0,-71.0,-68.0,-59.0,-89.0,-90.0,-86.0,-87.0,16.0,18.0,19.0,27.0,1
3060,BA:8C:B9:54:50:24,3857992,492115670,4983,6199810,3853009,485915860,7,10147,1778858,10125,1775363,22,3495,2364,18,5527,44,7,79,216660.0,130000.0,-40.0,-37.0,-46.0,-52.0,-43.0,-35.0,-44.0,-49.0,-89.0,-90.0,-86.0,-87.0,49.0,53.0,40.0,35.0,1
3061,62:47:05:9D:EB:15,3872990,530258230,19977,44341980,3853013,485916250,1,15931,5724557,15855,5712897,76,11660,7543,0,20063,355,1,177,229410.0,137640.0,-51.0,-61.0,-56.0,-55.0,-50.0,-59.0,-55.0,-54.0,-89.0,-90.0,-86.0,-87.0,38.0,29.0,30.0,32.0,1
3062,92:69:1D:31:68:E9,3857248,489634830,4235,3718580,3853013,485916250,1,5877,1244209,5691,1201831,186,42378,2355,13,4519,105,1,66,216660.0,130000.0,-52.0,-47.0,-42.0,-49.0,-51.0,-47.0,-42.0,-48.0,-89.0,-90.0,-86.0,-87.0,37.0,43.0,44.0,38.0,1
3063,CC:2F:71:3F:1F:24,5237384,2088970932,1384371,1603054682,3853013,485916250,2222,1166861,1342010740,1165951,1341900322,910,110418,1129254,15,1382507,130258,2219,880,144444.0,43333.0,-73.0,-71.0,-73.0,-73.0,-73.0,-70.0,-72.0,-72.0,-89.0,-90.0,-86.0,-87.0,16.0,19.0,13.0,14.0,1
3064,CC:2F:71:3E:C5:1F,3854064,486044626,1051,128376,3853013,485916250,3,4591,382702,3825,291784,766,90918,1113,16,1509,32,3,55,130000.0,39000.0,-73.0,-72.0,-67.0,-60.0,-72.0,-71.0,-68.0,-59.0,-89.0,-90.0,-86.0,-87.0,16.0,18.0,19.0,27.0,1
3065,BA:8C:B9:54:50:24,3857998,492116262,4983,6199810,3853015,485916452,7,10147,1778858,10125,1775363,22,3495,2364,18,5527,44,7,79,216660.0,130000.0,-40.0,-37.0,-46.0,-52.0,-43.0,-35.0,-44.0,-49.0,-89.0,-90.0,-86.0,-87.0,49.0,53.0,40.0,35.0,1
3066,62:47:05:9D:EB:15,3872996,530259166,19978,44342239,3853018,485916927,1,15935,5724972,15859,5713312,76,11660,7545,0,20064,355,1,177,229410.0,137640.0,-53.0,-58.0,-56.0,-54.0,-51.0,-59.0,-56.0,-54.0,-89.0,-90.0,-86.0,-87.0,36.0,32.0,30.0,33.0,1
3067,92:69:1D:31:68:E9,3857253,489635507,4235,3718580,3853018,485916927,1,5877,1244209,5691,1201831,186,42378,2355,13,4519,105,1,66,216660.0,130000.0,-52.0,-47.0,-42.0,-49.0,-51.0,-47.0,-42.0,-48.0,-89.0,-90.0,-86.0,-87.0,37.0,43.0,44.0,38.0,1
3068,CC:2F:71:3F:1F:24,5237445,2088992926,1384425,1603075797,3853020,485917129,2222,1166897,1342017261,1165987,1341906843,910,110418,1129287,15,1382561,130260,2219,880,144444.0,43333.0,-72.0,-70.0,-72.0,-72.0,-72.0,-70.0,-71.0,-71.0,-89.0,-90.0,-86.0,-87.0,17.0,20.0,14.0,15.0,1
3069,CC:2F:71:3E:C5:1F,3854071,486045505,1051,128376,3853020,485917129,3,4591,382702,3825,291784,766,90918,1113,16,1509,32,3,55,130000.0,39000.0,-73.0,-72.0,-67.0,-60.0,-72.0,-71.0,-68.0,-59.0,-89.0,-90.0,-86.0,-87.0,16.0,18.0,19.0,27.0,1
3070,BA:8C:B9:54:50:24,3858005,492117141,4983,6199810,3853022,485917331,7,10147,1778858,10125,1775363,22,3495,2364,18,5527,44,7,79,216660.0,130000.0,-40.0,-37.0,-46.0,-52.0,-43.0,-35.0,-44.0,-49.0,-89.0,-90.0,-86.0,-87.0,49.0,53.0,40.0,35.0,1
3071,62:47:05:9D:EB:15,3873003,530260148,19980,44342757,3853023,485917391,1,15968,5727502,15892,5715842,76,11660,7549,0,20066,355,1,177,229410.0,137640.0,-48.0,-58.0,-52.0,-52.0,-51.0,-59.0,-55.0,-55.0,-89.0,-90.0,-86.0,-87.0,41.0,32.0,34.0,35.0,1
3072,92:69:1D:31:68:E9,3857258,489635971,4235,3718580,3853023,485917391,1,5877,1244209,5691,1201831,186,42378,2355,13,4519,105,1,66,216660.0,130000.0,-52.0,-47.0,-42.0,-49.0,-51.0,-47.0,-42.0,-48.0,-89.0,-90.0,-86.0,-87.0,37.0,43.0,44.0,38.0,1
3073,CC:2F:71:3F:1F:24,5237496,2089010886,1384472,1603093427,3853024,485917459,2222,1166926,1342022399,1166016,1341911981,910,110418,1129313,15,1382608,130261,2219,880,144444.0,43333.0,-73.0,-71.0,-72.0,-72.0,-73.0,-71.0,-72.0,-72.0,-89.0,-90.0,-86.0,-87.0,16.0,19.0,14.0,15.0,1
3074,CC:2F:71:3E:C5:1F,3854075,486045835,1051,128376,3853024,485917459,3,4591,382702,3825,291784,766,90918,1113,16,1509,32,3,55,130000.0,39000.0,-73.0,-72.0,-67.0,-60.0,-72.0,-71.0,-68.0,-59.0,-89.0,-90.0,-86.0,-87.0,16.0,18.0,19.0,27.0,1
3075,BA:8C:B9:54:50:24,3858008,492117403,4983,6199810,3853025,485917593,7,10147,1778858,10125,1775363,22,3495,2364,18,5527,44,7,79,216660.0,130000.0,-40.0,-37.0,-46.0,-52.0,-43.0,-35.0,-44.0,-49.0,-89.0,-90.0,-86.0,-87.0,49.0,53.0,40.0,35.0,1
3076,62:47:05:9D:EB:15,3873008,530260683,19981,44342888,3853027,485917795,1,15970,5727699,15894,5716039,76,11660,7550,0,20067,355,1,177,229410.0,137640.0,-53.0,-59.0,-57.0,-55.0,-50.0,-58.0,-55.0,-54.0,-89.0,-90.0,-86.0,-87.0,36.0,31.0,29.0,32.0,1
3077,92:69:1D:31:68:E9,3857264,489636577,4235,3718580,3853029,485917997,1,5877,1244209,5691,1201831,186,42378,2355,13,4519,105,1,66,216660.0,130000.0,-52.0,-47.0,-42.0,-49.0,-51.0,-47.0,-42.0,-48.0,-89.0,-90.0,-86.0,-87.0,37.0,43.0,44.0,38.0,1
3078,CC:2F:71:3F:1F:24,5237550,2089029380,1384517,1603110813,3853033,485918567,2222,1166952,1342027095,1166042,1341916677,910,110418,1129337,15,1382653,130264,2219,880,144444.0,43333.0,-72.0,-70.0,-71.0,-72.0,-72.0,-70.0,-71.0,-71.0,-89.0,-90.0,-86.0,-87.0,17.0,20.0,15.0,15.0,1
3079,CC:2F:71:3E:C5:1F,3854084,486046943,1051,128376,3853033,485918567,3,4591,382702,3825,291784,766,90918,1113,16,1509,32,3,55,130000.0,39000.0,-73.0,-72.0,-67.0,-60.0,-72.0,-71.0,-68.0,-59.0,-89.0,-90.0,-86.0,-87.0,16.0,18.0,19.0,27.0,1
3080,BA:8C:B9:54:50:24,3858016,492118377,4983,6199810,3853033,485918567,7,10147,1778858,10125,1775363,22,3495,2364,18,5527,44,7,79,216660.0,130000.0,-40.0,-37.0,-46.0,-52.0,-43.0,-35.0,-44.0,-49.0,-89.0,-90.0,-86.0,-87.0,49.0,53.0,40.0,35.0,1
3081,62:47:05:9D:EB:15,3873160,530705072,20126,44786445,3853034,485918627,1,16005,5732202,15929,5720542,76,11660,7566,0,20212,355,1,177,229410.0,137640.0,-59.0,-66.0,-63.0,-65.0,-56.0,-64.0,-60.0,-61.0,-89.0,-90.0,-86.0,-87.0,30.0,24.0,23.0,22.0,1
3082,92:69:1D:31:68:E9,3857269,489637207,4235,3718580,3853034,485918627,1,5877,1244209,5691,1201831,186,42378,2355,13,4519,105,1,66,216660.0,130000.0,-52.0,-47.0,-42.0,-49.0,-51.0,-47.0,-42.0,-48.0,-89.0,-90.0,-86.0,-87.0,37.0,43.0,44.0,38.0,1
3083,CC:2F:71:3F:1F:24,5237598,2089047012,1384562,1603128183,3853036,485918829,2222,1166977,1342031565,1166067,1341921147,910,110418,1129361,15,1382698,130277,2219,880,144444.0,43333.0,-70.0,-67.0,-68.0,-69.0,-70.0,-67.0,-69.0,-69.0,-89.0,-90.0,-86.0,-87.0,19.0,23.0,18.0,18.0,1
3084,CC:2F:71:3E:C5:1F,3854087,486047205,1051,128376,3853036,485918829,3,4591,382702,3825,291784,766,90918,1113,16,1509,32,3,55,130000.0,39000.0,-73.0,-72.0,-67.0,-60.0,-72.0,-71.0,-68.0,-59.0,-89.0,-90.0,-86.0,-87.0,16.0,18.0,19.0,27.0,1
3085,BA:8C:B9:54:50:24,3858019,492118639,4983,6199810,3853036,485918829,7,10147,1778858,10125,1775363,22,3495,2364,18,5527,44,7,79,216660.0,130000.0,-40.0,-37.0,-46.0,-52.0,-43.0,-35.0,-44.0,-49.0,-89.0,-90.0,-86.0,-87.0,49.0,53.0,40.0,35.0,1
3086,62:47:05:9D:EB:15,3873171,530706588,20129,44787153,3853042,485919435,1,16014,5733070,15938,5721410,76,11660,7568,0,20215,355,1,177,229410.0,137640.0,-53.0,-64.0,-58.0,-62.0,-56.0,-65.0,-61.0,-64.0,-89.0,-90.0,-86.0,-87.0,36.0,26.0,28.0,25.0,1
3087,92:69:1D:31:68:E9,3857277,489638015,4235,3718580,3853042,485919435,1,5877,1244209,5691,1201831,186,42378,2355,13,4519,105,1,66,216660.0,130000.0,-52.0,-47.0,-42.0,-49.0,-51.0,-47.0,-42.0,-48.0,-89.0,-90.0,-86.0,-87.0,37.0,43.0,44.0,38.0,1
3088,CC:2F:71:3F:1F:24,5237659,2089068911,1384617,1603149476,3853042,485919435,2222,1167013,1342037848,1166103,1341927430,910,110418,1129396,15,1382753,130289,2219,880,144444.0,43333.0,-70.0,-67.0,-69.0,-68.0,-70.0,-67.0,-68.0,-68.0,-89.0,-90.0,-86.0,-87.0,19.0,23.0,17.0,19.0,1
3089,CC:2F:71:3E:C5:1F,3854093,486047811,1051,128376,3853042,485919435,3,4591,382702,3825,291784,766,90918,1113,16,1509,32,3,55,130000.0,39000.0,-73.0,-72.0,-67.0,-60.0,-72.0,-71.0,-68.0,-59.0,-89.0,-90.0,-86.0,-87.0,16.0,18.0,19.0,27.0,1
3090,BA:8C:B9:54:50:24,3858025,492119245,4983,6199810,3853042,485919435,7,10147,1778858,10125,1775363,22,3495,2364,18,5527,44,7,79,216660.0,130000.0,-40.0,-37.0,-46.0,-52.0,-43.0,-35.0,-44.0,-49.0,-89.0,-90.0,-86.0,-87.0,49.0,53.0,40.0,35.0,1
3091,62:47:05:9D:EB:15,3873318,531150129,20274,45230492,3853044,485919637,1,16064,5739018,15988,5727358,76,11660,7585,0,20360,381,1,177,229410.0,137640.0,-56.0,-61.0,-59.0,-59.0,-56.0,-60.0,-59.0,-59.0,-89.0,-89.0,-86.0,-87.0,33.0,28.0,27.0,28.0,1
3092,92:69:1D:31:68:E9,3857279,489638217,4235,3718580,3853044,485919637,1,5877,1244209,5691,1201831,186,42378,2355,13,4519,105,1,66,216660.0,130000.0,-52.0,-47.0,-42.0,-49.0,-51.0,-47.0,-42.0,-48.0,-89.0,-89.0,-86.0,-87.0,37.0,42.0,44.0,38.0,1
3093,CC:2F:71:3F:1F:24,5237707,2089086613,1384663,1603166976,3853044,485919637,2222,1167041,1342042666,1166131,1341932248,910,110418,1129423,15,1382799,130293,2219,880,144444.0,43333.0,-71.0,-67.0,-68.0,-69.0,-70.0,-67.0,-68.0,-68.0,-89.0,-89.0,-86.0,-87.0,18.0,22.0,18.0,18.0,1
3094,CC:2F:71:3E:C5:1F,3854095,486048013,1051,128376,3853044,485919637,3,4591,382702,3825,291784,766,90918,1113,16,1509,32,3,55,130000.0,39000.0,-73.0,-72.0,-67.0,-60.0,-72.0,-71.0,-68.0,-59.0,-89.0,-89.0,-86.0,-87.0,16.0,17.0,19.0,27.0,1
3095,BA:8C:B9:54:50:24,3858027,492119447,4983,6199810,3853044,485919637,7,10147,1778858,10125,1775363,22,3495,2364,18,5527,44,7,79,216660.0,130000.0,-40.0,-37.0,-46.0,-52.0,-43.0,-35.0,-44.0,-49.0,-89.0,-89.0,-86.0,-87.0,49.0,52.0,40.0,35.0,1
3096,62:47:05:9D:EB:15,3873325,531150795,20274,45230492,3853051,485920303,1,16065,5739086,15989,5727426,76,11660,7585,0,20360,381,1,177,229410.0,137640.0,-54.0,-62.0,-56.0,-61.0,-55.0,-61.0,-58.0,-59.0,-89.0,-89.0,-86.0,-87.0,35.0,27.0,30.0,26.0,1
3097,92:69:1D:31:68:E9,3857286,489638883,4235,3718580,3853051,485920303,1,5877,1244209,5691,1201831,186,42378,2355,13,4519,105,1,66,216660.0,130000.0,-52.0,-47.0,-42.0,-49.0,-51.0,-47.0,-42.0,-48.0,-89.0,-89.0,-86.0,-87.0,37.0,42.0,44.0,38.0,1
3098,CC:2F:71:3F:1F:24,5237760,2089104779,1384709,1603184476,3853051,485920303,2222,1167071,1342047732,1166161,1341937314,910,110418,1129450,15,1382845,130296,2219,880,144444.0,43333.0,-71.0,-68.0,-68.0,-68.0,-71.0,-67.0,-68.0,-68.0,-89.0,-89.0,-86.0,-87.0,18.0,21.0,18.0,19.0,1
3099,CC:2F:71:3E:C5:1F,3854102,486048679,1051,128376,3853051,485920303,3,4591,382702,3825,291784,766,90918,1113,16,1509,32,3,55,130000.0,39000.0,-73.0,-72.0,-67.0,-60.0,-72.0,-71.0,-68.0,-59.0,-89.0,-89.0,-86.0,-87.0,16.0,17.0,19.0,27.0,1
3100,BA:8C:B9:54:50:24,3858034,492120113,4983,6199810,3853051,485920303,7,10147,1778858,10125,1775363,22,3495,2364,18,5527,44,7,79,216660.0,130000.0,-40.0,-37.0,-46.0,-52.0,-43.0,-35.0,-44.0,-49.0,-89.0,-89.0,-86.0,-87.0,49.0,52.0,40.0,35.0,1
3101,62:47:05:9D:EB:15,3873327,531150997,20274,45230492,3853053,485920505,1,16066,5739154,15990,5727494,76,11660,7585,0,20360,381,1,177,229410.0,137640.0,-52.0,-59.0,-58.0,-53.0,-55.0,-60.0,-58.0,-58.0,-89.0,-89.0,-86.0,-87.0,37.0,30.0,28.0,34.0,1
3102,92:69:1D:31:68:E9,3857289,489639147,4235,3718580,3853054,485920567,1,5877,1244209,5691,1201831,186,42378,2355,13,4519,105,1,66,216660.0,130000.0,-52.0,-47.0,-42.0,-49.0,-51.0,-47.0,-42.0,-48.0,-89.0,-89.0,-86.0,-87.0,37.0,42.0,44.0,38.0,1
3103,CC:2F:71:3F:1F:24,5237811,2089122803,1384757,1603202236,3853054,485920567,2222,1167099,1342052550,1166189,1341942132,910,110418,1129477,15,1382893,130299,2219,880,144444.0,43333.0,-71.0,-67.0,-68.0,-69.0,-71.0,-67.0,-68.0,-68.0,-89.0,-89.0,-86.0,-87.0,18.0,22.0,18.0,18.0,1
3104,CC:2F:71:3E:C5:1F,3854105,486048943,1051,128376,3853054,485920567,3,4591,382702,3825,291784,766,90918,1113,16,1509,32,3,55,130000.0,39000.0,-73.0,-72.0,-67.0,-60.0,-72.0,-71.0,-68.0,-59.0,-89.0,-89.0,-86.0,-87.0,16.0,17.0,19.0,27.0,1
3105,BA:8C:B9:54:50:24,3858037,492120377,4983,6199810,3853054,485920567,7,10156,1779470,10134,1775975,22,3495,2364,18,5527,44,7,79,216660.0,130000.0,-40.0,-37.0,-46.0,-52.0,-40.0,-36.0,-45.0,-51.0,-89.0,-89.0,-86.0,-87.0,49.0,52.0,40.0,35.0,1
3106,62:47:05:9D:EB:15,3873481,531595303,20420,45674070,3853061,485921233,1,16093,5743076,16016,5731294,77,11782,7598,0,20506,381,1,177,229410.0,137640.0,-52.0,-59.0,-57.0,-53.0,-55.0,-60.0,-57.0,-57.0,-89.0,-89.0,-86.0,-87.0,37.0,30.0,29.0,34.0,1
3107,92:69:1D:31:68:E9,3857296,489639813,4235,3718580,3853061,485921233,1,5877,1244209,5691,1201831,186,42378,2355,13,4519,105,1,66,216660.0,130000.0,-52.0,-47.0,-42.0,-49.0,-51.0,-47.0,-42.0,-48.0,-89.0,-89.0,-86.0,-87.0,37.0,42.0,44.0,38.0,1
3108,CC:2F:71:3F:1F:24,5237874,2089144830,1384813,1603223597,3853061,485921233,2222,1167133,1342058554,1166223,1341948136,910,110418,1129510,15,1382949,130301,2219,880,144444.0,43333.0,-71.0,-67.0,-68.0,-69.0,-71.0,-67.0,-68.0,-69.0,-89.0,-89.0,-86.0,-87.0,18.0,22.0,18.0,18.0,1
3109,CC:2F:71:3E:C5:1F,3854112,486049609,1051,128376,3853061,485921233,3,4591,382702,3825,291784,766,90918,1113,16,1509,32,3,55,130000.0,39000.0,-73.0,-72.0,-67.0,-60.0,-72.0,-71.0,-68.0,-59.0,-89.0,-89.0,-86.0,-87.0,16.0,17.0,19.0,27.0,1
3110,BA:8C:B9:54:50:24,3858044,492121043,4983,6199810,3853061,485921233,7,10156,1779470,10134,1775975,22,3495,2364,18,5527,44,7,79,216660.0,130000.0,-40.0,-37.0,-46.0,-52.0,-40.0,-36.0,-45.0,-51.0,-89.0,-89.0,-86.0,-87.0,49.0,52.0,40.0,35.0,1
3111,62:47:05:9D:EB:15,3873483,531595505,20420,45674070,3853063,485921435,1,16093,5743076,16016,5731294,77,11782,7598,0,20506,381,1,177,229410.0,137640.0,-52.0,-59.0,-57.0,-53.0,-55.0,-60.0,-57.0,-57.0,-89.0,-89.0,-86.0,-87.0,37.0,30.0,29.0,34.0,1
3112,92:69:1D:31:68:E9,3857298,489640015,4235,3718580,3853063,485921435,1,5877,1244209,5691,1201831,186,42378,2355,13,4519,105,1,66,216660.0,130000.0,-52.0,-47.0,-42.0,-49.0,-51.0,-47.0,-42.0,-48.0,-89.0,-89.0,-86.0,-87.0,37.0,42.0,44.0,38.0,1
3113,CC:2F:71:3F:1F:24,5237923,2089162662,1384860,1603241227,3853063,485921435,2222,1167161,1342063372,1166251,1341952954,910,110418,1129537,15,1382996,130303,2219,880,144444.0,43333.0,-72.0,-68.0,-69.0,-70.0,-71.0,-67.0,-68.0,-69.0,-89.0,-89.0,-86.0,-87.0,17.0,21.0,17.0,17.0,1
3114,CC:2F:71:3E:C5:1F,3854114,486049811,1051,128376,3853063,485921435,3,4591,382702,3825,291784,766,90918,1113,16,1509,32,3,55,130000.0,39000.0,-73.0,-72.0,-67.0,-60.0,-72.0,-71.0,-68.0,-59.0,-89.0,-89.0,-86.0,-87.0,16.0,17.0,19.0,27.0,1
3115,BA:8C:B9:54:50:24,3858046,492121245,4983,6199810,3853063,485921435,7,10156,1779470,10134,1775975,22,3495,2364,18,5527,44,7,79,216660.0,130000.0,-40.0,-37.0,-46.0,-52.0,-40.0,-36.0,-45.0,-51.0,-89.0,-89.0,-86.0,-87.0,49.0,52.0,40.0,35.0,1
3116,62:47:05:9D:EB:15,3873489,531596111,20420,45674070,3853069,485922041,1,16093,5743076,16016,5731294,77,11782,7598,0,20506,381,1,177,229410.0,137640.0,-52.0,-59.0,-57.0,-53.0,-55.0,-60.0,-57.0,-57.0,-89.0,-89.0,-86.0,-87.0,37.0,30.0,29.0,34.0,1
3117,92:69:1D:31:68:E9,3857304,489640621,4235,3718580,3853069,485922041,1,5879,1244345,5693,1201967,186,42378,2355,13,4520,105,1,66,216660.0,130000.0,-52.0,-48.0,-43.0,-48.0,-51.0,-47.0,-42.0,-48.0,-89.0,-89.0,-86.0,-87.0,37.0,41.0,43.0,39.0,1
3118,CC:2F:71:3F:1F:24,5237977,2089181028,1384908,1603258987,3853069,485922041,2222,1167190,1342068448,1166280,1341958030,910,110418,1129564,15,1383044,130309,2219,880,144444.0,43333.0,-77.0,-74.0,-75.0,-75.0,-74.0,-71.0,-71.0,-72.0,-89.0,-89.0,-86.0,-87.0,12.0,15.0,11.0,12.0,1
3119,CC:2F:71:3E:C5:1F,3854120,486050417,1051,128376,3853069,485922041,3,4593,382842,3827,291924,766,90918,1113,16,1510,32,3,55,130000.0,39000.0,-72.0,-71.0,-69.0,-60.0,-72.0,-71.0,-68.0,-60.0,-89.0,-89.0,-86.0,-87.0,17.0,18.0,17.0,27.0,1
3120,BA:8C:B9:54:50:24,3858053,492121911,4983,6199810,3853070,485922101,7,10156,1779470,10134,1775975,22,3495,2364,18,5527,44,7,79,216660.0,130000.0,-40.0,-37.0,-46.0,-52.0,-40.0,-36.0,-45.0,-51.0,-89.0,-89.0,-86.0,-87.0,49.0,52.0,40.0,35.0,1
3121,62:47:05:9D:EB:15,3873493,531596982,20421,45674679,3853072,485922303,1,16106,5744030,16029,5732248,77,11782,7599,0,20507,381,1,177,229410.0,137640.0,-54.0,-60.0,-55.0,-60.0,-52.0,-57.0,-54.0,-55.0,-89.0,-89.0,-86.0,-87.0,35.0,29.0,31.0,27.0,1
3122,92:69:1D:31:68:E9,3857307,489640883,4235,3718580,3853072,485922303,1,5879,1244345,5693,1201967,186,42378,2355,13,4520,105,1,66,216660.0,130000.0,-52.0,-48.0,-43.0,-48.0,-51.0,-47.0,-42.0,-48.0,-89.0,-89.0,-86.0,-87.0,37.0,41.0,43.0,39.0,1
3123,CC:2F:71:3F:1F:24,5238026,2089198790,1384954,1603276487,3853072,485922303,2222,1167219,1342073396,1166309,1341962978,910,110418,1129591,15,1383090,130311,2219,880,144444.0,43333.0,-71.0,-67.0,-68.0,-69.0,-71.0,-67.0,-68.0,-69.0,-89.0,-89.0,-86.0,-87.0,18.0,22.0,18.0,18.0,1
3124,CC:2F:71:3E:C5:1F,3854125,486050881,1051,128376,3853074,485922505,3,4593,382842,3827,291924,766,90918,1113,16,1510,32,3,55,130000.0,39000.0,-72.0,-71.0,-69.0,-60.0,-72.0,-71.0,-68.0,-60.0,-89.0,-89.0,-86.0,-87.0,17.0,18.0,17.0,27.0,1
3125,BA:8C:B9:54:50:24,3858057,492122315,4983,6199810,3853074,485922505,7,10157,1779538,10135,1776043,22,3495,2364,18,5527,44,7,79,216660.0,130000.0,-40.0,-37.0,-46.0,-51.0,-40.0,-36.0,-45.0,-51.0,-89.0,-89.0,-86.0,-87.0,49.0,52.0,40.0,36.0,1
3126,62:47:05:9D:EB:15,3873500,531597861,20421,45674679,3853079,485923182,1,16106,5744030,16029,5732248,77,11782,7599,0,20507,381,1,177,229410.0,137640.0,-54.0,-60.0,-55.0,-60.0,-52.0,-57.0,-54.0,-55.0,-89.0,-89.0,-86.0,-87.0,35.0,29.0,31.0,27.0,1
3127,92:69:1D:31:68:E9,3857314,489641762,4235,3718580,3853079,485923182,1,5879,1244345,5693,1201967,186,42378,2355,13,4520,105,1,66,216660.0,130000.0,-52.0,-48.0,-43.0,-48.0,-51.0,-47.0,-42.0,-48.0,-89.0,-89.0,-86.0,-87.0,37.0,41.0,43.0,39.0,1
3128,CC:2F:71:3F:1F:24,5238087,2089220770,1385008,1603297588,3853079,485923182,2222,1167253,1342079544,1166343,1341969126,910,110418,1129623,15,1383144,130313,2219,880,144444.0,43333.0,-71.0,-68.0,-68.0,-69.0,-70.0,-67.0,-67.0,-68.0,-89.0,-89.0,-86.0,-87.0,18.0,21.0,18.0,18.0,1
3129,CC:2F:71:3E:C5:1F,3854130,486051558,1051,128376,3853079,485923182,3,4593,382842,3827,291924,766,90918,1113,16,1510,32,3,55,130000.0,39000.0,-72.0,-71.0,-69.0,-60.0,-72.0,-71.0,-68.0,-60.0,-89.0,-89.0,-86.0,-87.0,17.0,18.0,17.0,27.0,1
3130,BA:8C:B9:54:50:24,3858062,492122992,4983,6199810,3853079,485923182,7,10157,1779538,10135,1776043,22,3495,2364,18,5527,44,7,79,216660.0,130000.0,-40.0,-37.0,-46.0,-51.0,-40.0,-36.0,-45.0,-51.0,-89.0,-89.0,-86.0,-87.0,49.0,52.0,40.0,36.0,1
3131,62:47:05:9D:EB:15,3873503,531598123,20421,45674679,3853082,485923444,1,16106,5744030,16029,5732248,77,11782,7599,0,20507,381,1,177,229410.0,137640.0,-54.0,-60.0,-55.0,-60.0,-52.0,-57.0,-54.0,-55.0,-89.0,-89.0,-86.0,-87.0,35.0,29.0,31.0,27.0,1
3132,92:69:1D:31:68:E9,3857319,489642226,4235,3718580,3853084,485923646,1,5879,1244345,5693,1201967,186,42378,2355,13,4520,105,1,66,216660.0,130000.0,-52.0,-48.0,-43.0,-48.0,-51.0,-47.0,-42.0,-48.0,-89.0,-89.0,-86.0,-87.0,37.0,41.0,43.0,39.0,1
3133,CC:2F:71:3F:1F:24,5238137,2089238604,1385053,1603314958,3853084,485923646,2222,1167281,1342084424,1166371,1341974006,910,110418,1129649,15,1383189,130317,2219,880,144444.0,43333.0,-71.0,-67.0,-68.0,-69.0,-71.0,-67.0,-68.0,-69.0,-89.0,-89.0,-86.0,-87.0,18.0,22.0,18.0,18.0,1
3134,CC:2F:71:3E:C5:1F,3854135,486052022,1051,128376,3853084,485923646,3,4593,382842,3827,291924,766,90918,1113,16,1510,32,3,55,130000.0,39000.0,-72.0,-71.0,-69.0,-60.0,-72.0,-71.0,-68.0,-60.0,-89.0,-89.0,-86.0,-87.0,17.0,18.0,17.0,27.0,1
3135,BA:8C:B9:54:50:24,3858069,492123658,4983,6199810,3853086,485923848,7,10157,1779538,10135,1776043,22,3495,2364,18,5527,44,7,79,216660.0,130000.0,-40.0,-37.0,-46.0,-51.0,-40.0,-36.0,-45.0,-51.0,-89.0,-89.0,-86.0,-87.0,49.0,52.0,40.0,36.0,1
3136,62:47:05:9D:EB:15,3873509,531598729,20421,45674679,3853088,485924050,1,16106,5744030,16029,5732248,77,11782,7599,0,20507,381,1,177,229410.0,137640.0,-54.0,-60.0,-55.0,-60.0,-52.0,-57.0,-54.0,-55.0,-89.0,-89.0,-86.0,-87.0,35.0,29.0,31.0,27.0,1
3137,92:69:1D:31:68:E9,3857323,489642630,4235,3718580,3853088,485924050,1,5879,1244345,5693,1201967,186,42378,2355,13,4520,105,1,66,216660.0,130000.0,-52.0,-48.0,-43.0,-48.0,-51.0,-47.0,-42.0,-48.0,-89.0,-89.0,-86.0,-87.0,37.0,41.0,43.0,39.0,1
3138,CC:2F:71:3F:1F:24,5238187,2089256452,1385099,1603332402,3853088,485924050,2222,1167308,1342089188,1166398,1341978770,910,110418,1129674,15,1383235,130318,2219,880,130000.0,39000.0,-71.0,-67.0,-68.0,-69.0,-71.0,-67.0,-68.0,-68.0,-89.0,-89.0,-86.0,-87.0,18.0,22.0,18.0,18.0,1
3139,CC:2F:71:3E:C5:1F,3854139,486052426,1051,128376,3853088,485924050,3,4593,382842,3827,291924,766,90918,1113,16,1510,32,3,55,130000.0,39000.0,-72.0,-71.0,-69.0,-60.0,-72.0,-71.0,-68.0,-60.0,-89.0,-89.0,-86.0,-87.0,17.0,18.0,17.0,27.0,1
3140,BA:8C:B9:54:50:24,3858071,492123860,4983,6199810,3853088,485924050,7,10157,1779538,10135,1776043,22,3495,2364,18,5527,44,7,79,216660.0,130000.0,-40.0,-37.0,-46.0,-51.0,-40.0,-36.0,-45.0,-51.0,-89.0,-89.0,-86.0,-87.0,49.0,52.0,40.0,36.0,1
3141,62:47:05:9D:EB:15,3873517,531600539,20424,45675974,3853093,485924565,1,16112,5746419,16034,5734466,78,11953,7602,0,20510,382,1,177,229410.0,137640.0,-54.0,-60.0,-55.0,-60.0,-54.0,-59.0,-56.0,-57.0,-89.0,-89.0,-86.0,-87.0,35.0,29.0,31.0,27.0,1
3142,92:69:1D:31:68:E9,3857328,489643145,4235,3718580,3853093,485924565,1,5879,1244345,5693,1201967,186,42378,2355,13,4520,105,1,66,216660.0,130000.0,-52.0,-48.0,-43.0,-48.0,-51.0,-47.0,-42.0,-48.0,-89.0,-89.0,-86.0,-87.0,37.0,41.0,43.0,39.0,1
3143,CC:2F:71:3F:1F:24,5238247,2089278086,1385154,1603353521,3853093,485924565,2222,1167342,1342095335,1166432,1341984917,910,110418,1129706,15,1383290,130322,2219,880,144444.0,43333.0,-71.0,-67.0,-68.0,-69.0,-71.0,-67.0,-68.0,-69.0,-89.0,-89.0,-86.0,-87.0,18.0,22.0,18.0,18.0,1
3144,CC:2F:71:3E:C5:1F,3854147,486053203,1051,128376,3853096,485924827,3,4593,382842,3827,291924,766,90918,1113,16,1510,32,3,55,130000.0,39000.0,-72.0,-71.0,-69.0,-60.0,-72.0,-71.0,-68.0,-60.0,-89.0,-89.0,-86.0,-87.0,17.0,18.0,17.0,27.0,1
3145,BA:8C:B9:54:50:24,3858081,492124839,4983,6199810,3853098,485925029,7,10157,1779538,10135,1776043,22,3495,2364,18,5527,44,7,79,216660.0,130000.0,-40.0,-37.0,-46.0,-51.0,-40.0,-36.0,-45.0,-51.0,-89.0,-89.0,-86.0,-87.0,49.0,52.0,40.0,36.0,1
3146,62:47:05:9D:EB:15,3873524,531601341,20426,45676312,3853098,485925029,1,16134,5748201,16056,5736248,78,11953,7606,0,20512,382,1,177,229410.0,137640.0,-54.0,-60.0,-55.0,-60.0,-56.0,-60.0,-57.0,-58.0,-89.0,-89.0,-86.0,-87.0,35.0,29.0,31.0,27.0,1
3147,92:69:1D:31:68:E9,3857333,489643609,4235,3718580,3853098,485925029,1,5879,1244345,5693,1201967,186,42378,2355,13,4520,105,1,66,216660.0,130000.0,-52.0,-48.0,-43.0,-48.0,-51.0,-47.0,-42.0,-48.0,-89.0,-89.0,-86.0,-87.0,37.0,41.0,43.0,39.0,1
3148,CC:2F:71:3F:1F:24,5238299,2089296180,1385201,1603371151,3853098,485925029,2222,1167369,1342100037,1166459,1341989619,910,110418,1129732,15,1383337,130325,2219,880,144444.0,43333.0,-71.0,-67.0,-68.0,-69.0,-71.0,-67.0,-68.0,-69.0,-89.0,-89.0,-86.0,-87.0,18.0,22.0,18.0,18.0,1
3149,CC:2F:71:3E:C5:1F,3854149,486053405,1051,128376,3853098,485925029,3,4593,382842,3827,291924,766,90918,1113,16,1510,32,3,55,130000.0,39000.0,-72.0,-71.0,-69.0,-60.0,-72.0,-71.0,-68.0,-60.0,-89.0,-89.0,-86.0,-87.0,17.0,18.0,17.0,27.0,1
3150,BA:8C:B9:54:50:24,3858081,492124839,4983,6199810,3853098,485925029,7,10157,1779538,10135,1776043,22,3495,2364,18,5527,44,7,79,216660.0,130000.0,-40.0,-37.0,-46.0,-51.0,-40.0,-36.0,-45.0,-51.0,-89.0,-89.0,-86.0,-87.0,49.0,52.0,40.0,36.0,1
3151,62:47:05:9D:EB:15,3873531,531602174,20429,45676741,3853102,485925433,1,16138,5748677,16060,5736724,78,11953,7609,0,20515,382,1,177,229410.0,137640.0,-56.0,-61.0,-58.0,-58.0,-55.0,-60.0,-57.0,-58.0,-89.0,-89.0,-86.0,-87.0,33.0,28.0,28.0,29.0,1
3152,92:69:1D:31:68:E9,3857339,489644215,4235,3718580,3853104,485925635,1,5879,1244345,5693,1201967,186,42378,2355,13,4520,105,1,66,216660.0,130000.0,-52.0,-48.0,-43.0,-48.0,-51.0,-47.0,-42.0,-48.0,-89.0,-89.0,-86.0,-87.0,37.0,41.0,43.0,39.0,1
3153,CC:2F:71:3F:1F:24,5238355,2089314764,1385249,1603388927,3853106,485925837,2222,1167396,1342104833,1166486,1341994415,910,110418,1129757,15,1383385,130327,2219,880,144444.0,43333.0,-71.0,-67.0,-68.0,-69.0,-71.0,-67.0,-68.0,-69.0,-89.0,-89.0,-86.0,-87.0,18.0,22.0,18.0,18.0,1
3154,CC:2F:71:3E:C5:1F,3854157,486054213,1051,128376,3853106,485925837,3,4593,382842,3827,291924,766,90918,1113,16,1510,32,3,55,130000.0,39000.0,-72.0,-71.0,-69.0,-60.0,-72.0,-71.0,-68.0,-60.0,-89.0,-89.0,-86.0,-87.0,17.0,18.0,17.0,27.0,1
3155,BA:8C:B9:54:50:24,3858089,492125647,4983,6199810,3853106,485925837,7,10157,1779538,10135,1776043,22,3495,2364,18,5527,44,7,79,216660.0,130000.0,-40.0,-37.0,-46.0,-51.0,-40.0,-36.0,-45.0,-51.0,-89.0,-89.0,-86.0,-87.0,49.0,52.0,40.0,36.0,1
3156,62:47:05:9D:EB:15,3873539,531603140,20432,45677243,3853107,485925897,1,16157,5750267,16079,5738314,78,11953,7612,0,20518,382,1,177,216660.0,130000.0,-53.0,-59.0,-56.0,-54.0,-52.0,-57.0,-53.0,-54.0,-89.0,-89.0,-86.0,-87.0,36.0,30.0,30.0,33.0,1
3157,92:69:1D:31:68:E9,3857342,489644477,4235,3718580,3853107,485925897,1,5879,1244345,5693,1201967,186,42378,2355,13,4520,105,1,66,216660.0,130000.0,-52.0,-48.0,-43.0,-48.0,-51.0,-47.0,-42.0,-48.0,-89.0,-89.0,-86.0,-87.0,37.0,41.0,43.0,39.0,1
3158,CC:2F:71:3F:1F:24,5238404,2089332584,1385297,1603406687,3853107,485925897,2222,1167424,1342109651,1166514,1341999233,910,110418,1129784,15,1383433,130328,2219,880,144444.0,43333.0,-71.0,-67.0,-68.0,-69.0,-70.0,-67.0,-67.0,-68.0,-89.0,-89.0,-86.0,-87.0,18.0,22.0,18.0,18.0,1
3159,CC:2F:71:3E:C5:1F,3854160,486054475,1051,128376,3853109,485926099,3,4593,382842,3827,291924,766,90918,1113,16,1510,32,3,55,130000.0,39000.0,-72.0,-71.0,-69.0,-60.0,-72.0,-71.0,-68.0,-60.0,-89.0,-89.0,-86.0,-87.0,17.0,18.0,17.0,27.0,1
3160,BA:8C:B9:54:50:24,3858092,492125909,4983,6199810,3853109,485926099,7,10157,1779538,10135,1776043,22,3495,2364,18,5527,44,7,79,216660.0,130000.0,-40.0,-37.0,-46.0,-51.0,-40.0,-36.0,-45.0,-51.0,-89.0,-89.0,-86.0,-87.0,49.0,52.0,40.0,36.0,1
3161,62:47:05:9D:EB:15,3873547,531604174,20434,45677671,3853113,485926503,1,16180,5752117,16102,5740164,78,11953,7616,0,20520,382,1,177,216660.0,130000.0,-60.0,-64.0,-60.0,-64.0,-60.0,-63.0,-59.0,-64.0,-89.0,-89.0,-86.0,-87.0,29.0,25.0,26.0,23.0,1
3162,92:69:1D:31:68:E9,3857350,489645285,4235,3718580,3853115,485926705,1,5879,1244345,5693,1201967,186,42378,2355,13,4520,105,1,66,216660.0,130000.0,-52.0,-48.0,-43.0,-48.0,-51.0,-47.0,-42.0,-48.0,-89.0,-89.0,-86.0,-87.0,37.0,41.0,43.0,39.0,1
3163,CC:2F:71:3F:1F:24,5238467,2089354623,1385352,1603427918,3853115,485926705,2222,1167459,1342115725,1166549,1342005307,910,110418,1129817,15,1383488,130330,2219,880,144444.0,43333.0,-71.0,-68.0,-68.0,-69.0,-71.0,-67.0,-68.0,-69.0,-89.0,-89.0,-86.0,-87.0,18.0,21.0,18.0,18.0,1
3164,CC:2F:71:3E:C5:1F,3854166,486055081,1051,128376,3853115,485926705,3,4593,382842,3827,291924,766,90918,1113,16,1510,32,3,55,130000.0,39000.0,-72.0,-71.0,-69.0,-60.0,-72.0,-71.0,-68.0,-60.0,-89.0,-89.0,-86.0,-87.0,17.0,18.0,17.0,27.0,1
3165,BA:8C:B9:54:50:24,3858098,492126515,4983,6199810,3853115,485926705,7,10157,1779538,10135,1776043,22,3495,2364,18,5527,44,7,79,216660.0,130000.0,-40.0,-37.0,-46.0,-51.0,-40.0,-36.0,-45.0,-51.0,-89.0,-89.0,-86.0,-87.0,49.0,52.0,40.0,36.0,1
3166,62:47:05:9D:EB:15,3873550,531604635,20435,45677930,3853115,485926705,1,16185,5752600,16107,5740647,78,11953,7618,0,20521,382,1,177,216660.0,130000.0,-63.0,-65.0,-60.0,-72.0,-59.0,-62.0,-59.0,-64.0,-89.0,-89.0,-86.0,-87.0,26.0,24.0,26.0,15.0,1
3167,92:69:1D:31:68:E9,3857352,489645487,4235,3718580,3853117,485926907,1,5879,1244345,5693,1201967,186,42378,2355,13,4520,105,1,66,216660.0,130000.0,-52.0,-48.0,-43.0,-48.0,-51.0,-47.0,-42.0,-48.0,-89.0,-89.0,-86.0,-87.0,37.0,41.0,43.0,39.0,1
3168,CC:2F:71:3F:1F:24,5238515,2089372325,1385398,1603445418,3853117,485926907,2222,1167487,1342120543,1166577,1342010125,910,110418,1129844,15,1383534,130333,2219,880,144444.0,43333.0,-71.0,-67.0,-68.0,-69.0,-71.0,-67.0,-68.0,-69.0,-89.0,-89.0,-86.0,-87.0,18.0,22.0,18.0,18.0,1
3169,CC:2F:71:3E:C5:1F,3854169,486055343,1051,128376,3853118,485926967,3,4593,382842,3827,291924,766,90918,1113,16,1510,32,3,55,130000.0,39000.0,-72.0,-71.0,-69.0,-60.0,-72.0,-71.0,-68.0,-60.0,-89.0,-89.0,-86.0,-87.0,17.0,18.0,17.0,27.0,1
3170,BA:8C:B9:54:50:24,3858101,492126777,4983,6199810,3853118,485926967,7,10157,1779538,10135,1776043,22,3495,2364,18,5527,44,7,79,216660.0,130000.0,-40.0,-37.0,-46.0,-51.0,-40.0,-36.0,-45.0,-51.0,-89.0,-89.0,-86.0,-87.0,49.0,52.0,40.0,36.0,1
3171,62:47:05:9D:EB:15,3873563,531606035,20439,45678462,3853124,485927573,1,16206,5754221,16128,5742268,78,11953,7621,0,20525,382,1,177,216660.0,130000.0,-53.0,-57.0,-53.0,-58.0,-54.0,-57.0,-54.0,-59.0,-89.0,-89.0,-86.0,-87.0,36.0,32.0,33.0,29.0,1
3172,92:69:1D:31:68:E9,3857360,489646213,4236,3718640,3853124,485927573,1,5880,1244413,5694,1202035,186,42378,2355,13,4521,105,1,66,216660.0,130000.0,-51.0,-48.0,-45.0,-47.0,-51.0,-47.0,-42.0,-48.0,-89.0,-89.0,-86.0,-87.0,38.0,41.0,41.0,40.0,1
3173,CC:2F:71:3F:1F:24,5238571,2089390755,1385447,1603463182,3853124,485927573,2222,1167515,1342125423,1166605,1342015005,910,110418,1129870,15,1383584,130346,2219,880,144444.0,43333.0,-71.0,-67.0,-68.0,-70.0,-71.0,-67.0,-68.0,-69.0,-89.0,-89.0,-86.0,-87.0,18.0,22.0,18.0,17.0,1
3174,CC:2F:71:3E:C5:1F,3854176,486056065,1052,128492,3853124,485927573,3,4596,383052,3830,292134,766,90918,1113,16,1511,32,3,55,130000.0,39000.0,-80.0,-83.0,-75.0,-71.0,-72.0,-71.0,-68.0,-61.0,-89.0,-89.0,-86.0,-87.0,9.0,6.0,11.0,16.0,1
3175,BA:8C:B9:54:50:24,3858108,492127499,4984,6199926,3853124,485927573,7,10161,1779810,10139,1776315,22,3495,2364,18,5528,44,7,79,216660.0,130000.0,-48.0,-35.0,-43.0,-45.0,-44.0,-36.0,-44.0,-48.0,-89.0,-89.0,-86.0,-87.0,41.0,54.0,43.0,42.0,1
3176,62:47:05:9D:EB:15,3873567,531606543,20441,45678768,3853126,485927775,1,16226,5757550,16148,5745597,78,11953,7625,0,20527,382,1,177,216660.0,130000.0,-62.0,-62.0,-60.0,-60.0,-60.0,-62.0,-58.0,-62.0,-89.0,-89.0,-86.0,-87.0,27.0,27.0,26.0,27.0,1
3177,92:69:1D:31:68:E9,3857362,489646415,4236,3718640,3853126,485927775,1,5881,1244481,5695,1202103,186,42378,2355,13,4521,105,1,66,216660.0,130000.0,-51.0,-48.0,-45.0,-47.0,-51.0,-47.0,-43.0,-48.0,-89.0,-89.0,-86.0,-87.0,38.0,41.0,41.0,40.0,1
3178,CC:2F:71:3F:1F:24,5238626,2089409786,1385500,1603482011,3853126,485927775,2222,1167550,1342131182,1166640,1342020764,910,110418,1129904,15,1383637,130346,2219,880,144444.0,43333.0,-71.0,-67.0,-68.0,-69.0,-71.0,-67.0,-68.0,-69.0,-89.0,-89.0,-86.0,-87.0,18.0,22.0,18.0,18.0,1
3179,CC:2F:71:3E:C5:1F,3854178,486056267,1052,128492,3853126,485927775,3,4596,383052,3830,292134,766,90918,1113,16,1511,32,3,55,130000.0,39000.0,-80.0,-83.0,-75.0,-71.0,-72.0,-71.0,-68.0,-61.0,-89.0,-89.0,-86.0,-87.0,9.0,6.0,11.0,16.0,1
3180,BA:8C:B9:54:50:24,3858110,492127701,4984,6199926,3853126,485927775,7,10161,1779810,10139,1776315,22,3495,2364,18,5528,44,7,79,216660.0,130000.0,-48.0,-35.0,-43.0,-45.0,-44.0,-36.0,-44.0,-48.0,-89.0,-90.0,-86.0,-88.0,41.0,55.0,43.0,43.0,1
3181,62:47:05:9D:EB:15,3873593,531625232,20460,45696791,3853133,485928441,1,16264,5762475,16186,5750522,78,11953,7644,0,20546,382,1,177,229410.0,130000.0,-56.0,-61.0,-54.0,-60.0,-57.0,-61.0,-57.0,-60.0,-89.0,-90.0,-86.0,-88.0,33.0,29.0,32.0,28.0,1
3182,92:69:1D:31:68:E9,3857369,489647081,4236,3718640,3853133,485928441,1,5881,1244481,5695,1202103,186,42378,2355,13,4521,105,1,66,216660.0,130000.0,-51.0,-48.0,-45.0,-47.0,-51.0,-47.0,-43.0,-48.0,-89.0,-90.0,-86.0,-88.0,38.0,42.0,41.0,41.0,1
3183,CC:2F:71:3F:1F:24,5238687,2089431553,1385554,1603503112,3853133,485928441,2222,1167584,1342137187,1166674,1342026769,910,110418,1129937,15,1383691,130348,2219,880,144444.0,43333.0,-71.0,-67.0,-67.0,-69.0,-71.0,-67.0,-67.0,-69.0,-89.0,-90.0,-86.0,-88.0,18.0,23.0,19.0,19.0,1
3184,CC:2F:71:3E:C5:1F,3854185,486056933,1052,128492,3853133,485928441,3,4596,383052,3830,292134,766,90918,1113,16,1511,32,3,55,130000.0,39000.0,-80.0,-83.0,-75.0,-71.0,-72.0,-71.0,-68.0,-61.0,-89.0,-90.0,-86.0,-88.0,9.0,7.0,11.0,17.0,1
3185,BA:8C:B9:54:50:24,3858117,492128367,4984,6199926,3853133,485928441,7,10161,1779810,10139,1776315,22,3495,2364,18,5528,44,7,79,216660.0,130000.0,-48.0,-35.0,-43.0,-45.0,-44.0,-36.0,-44.0,-48.0,-89.0,-90.0,-86.0,-88.0,41.0,55.0,43.0,43.0,1
3186,62:47:05:9D:EB:15,3873595,531625434,20460,45696791,3853135,485928643,1,16264,5762475,16186,5750522,78,11953,7644,0,20546,382,1,177,229410.0,130000.0,-56.0,-61.0,-54.0,-60.0,-57.0,-61.0,-57.0,-60.0,-89.0,-90.0,-86.0,-88.0,33.0,29.0,32.0,28.0,1
3187,92:69:1D:31:68:E9,3857371,489647283,4236,3718640,3853135,485928643,1,5881,1244481,5695,1202103,186,42378,2355,13,4521,105,1,66,216660.0,130000.0,-51.0,-48.0,-45.0,-47.0,-51.0,-47.0,-43.0,-48.0,-89.0,-90.0,-86.0,-88.0,38.0,42.0,41.0,41.0,1
3188,CC:2F:71:3F:1F:24,5238736,2089449385,1385601,1603520742,3853135,485928643,2222,1167616,1342142593,1166706,1342032175,910,110418,1129966,15,1383738,130350,2219,880,144444.0,43333.0,-72.0,-68.0,-69.0,-69.0,-71.0,-67.0,-68.0,-69.0,-89.0,-90.0,-86.0,-88.0,17.0,22.0,17.0,19.0,1
3189,CC:2F:71:3E:C5:1F,3854187,486057135,1052,128492,3853135,485928643,3,4596,383052,3830,292134,766,90918,1113,16,1511,32,3,55,130000.0,39000.0,-80.0,-83.0,-75.0,-71.0,-72.0,-71.0,-68.0,-61.0,-89.0,-90.0,-86.0,-88.0,9.0,7.0,11.0,17.0,1
3190,BA:8C:B9:54:50:24,3858119,492128569,4984,6199926,3853135,485928643,7,10161,1779810,10139,1776315,22,3495,2364,18,5528,44,7,79,216660.0,130000.0,-48.0,-35.0,-43.0,-45.0,-44.0,-36.0,-44.0,-48.0,-89.0,-90.0,-86.0,-88.0,41.0,55.0,43.0,43.0,1
3191,62:47:05:9D:EB:15,3873602,531626313,20460,45696791,3853142,485929522,1,16264,5762475,16186,5750522,78,11953,7644,0,20546,382,1,177,229410.0,130000.0,-56.0,-61.0,-54.0,-60.0,-57.0,-61.0,-57.0,-60.0,-89.0,-90.0,-86.0,-88.0,33.0,29.0,32.0,28.0,1
3192,92:69:1D:31:68:E9,3857378,489648162,4236,3718640,3853142,485929522,1,5882,1244549,5696,1202171,186,42378,2355,13,4521,105,1,66,216660.0,130000.0,-52.0,-48.0,-45.0,-47.0,-51.0,-47.0,-43.0,-47.0,-89.0,-90.0,-86.0,-88.0,37.0,42.0,41.0,41.0,1
3193,CC:2F:71:3F:1F:24,5238792,2089468084,1385649,1603538502,3853143,485929582,2222,1167645,1342147779,1166735,1342037361,910,110418,1129992,15,1383786,130350,2219,880,144444.0,43333.0,-74.0,-71.0,-71.0,-72.0,-72.0,-68.0,-69.0,-70.0,-89.0,-90.0,-86.0,-88.0,15.0,19.0,15.0,16.0,1
3194,CC:2F:71:3E:C5:1F,3854195,486058074,1052,128492,3853143,485929582,3,4596,383052,3830,292134,766,90918,1113,16,1511,32,3,55,130000.0,39000.0,-80.0,-83.0,-75.0,-71.0,-72.0,-71.0,-68.0,-61.0,-89.0,-90.0,-86.0,-88.0,9.0,7.0,11.0,17.0,1
3195,BA:8C:B9:54:50:24,3858127,492129508,4984,6199926,3853143,485929582,7,10161,1779810,10139,1776315,22,3495,2364,18,5528,44,7,79,216660.0,130000.0,-48.0,-35.0,-43.0,-45.0,-44.0,-36.0,-44.0,-48.0,-89.0,-90.0,-86.0,-88.0,41.0,55.0,43.0,43.0,1
3196,62:47:05:9D:EB:15,3873606,531626637,20460,45696791,3853146,485929846,1,16267,5762733,16188,5750658,79,12075,7645,0,20546,382,1,178,229410.0,130000.0,-53.0,-51.0,-61.0,-53.0,-56.0,-58.0,-59.0,-58.0,-89.0,-90.0,-86.0,-88.0,36.0,39.0,25.0,35.0,1
3197,92:69:1D:31:68:E9,3857382,489648486,4236,3718640,3853146,485929846,1,5884,1244685,5698,1202307,186,42378,2355,13,4521,105,1,66,216660.0,130000.0,-52.0,-48.0,-42.0,-48.0,-51.0,-48.0,-43.0,-48.0,-89.0,-90.0,-86.0,-87.0,37.0,42.0,44.0,39.0,1
3198,CC:2F:71:3F:1F:24,5238841,2089485848,1385695,1603556002,3853146,485929846,2222,1167677,1342153327,1166767,1342042909,910,110418,1130020,15,1383832,130355,2219,880,144444.0,43333.0,-71.0,-67.0,-68.0,-68.0,-71.0,-67.0,-68.0,-69.0,-89.0,-90.0,-86.0,-87.0,18.0,23.0,18.0,19.0,1
3199,CC:2F:71:3E:C5:1F,3854198,486058338,1052,128492,3853146,485929846,3,4596,383052,3830,292134,766,90918,1113,16,1511,32,3,55,130000.0,39000.0,-80.0,-83.0,-75.0,-71.0,-72.0,-71.0,-68.0,-61.0,-89.0,-90.0,-86.0,-87.0,9.0,7.0,11.0,16.0,1
3200,BA:8C:B9:54:50:24,3858130,492129772,4984,6199926,3853146,485929846,7,10161,1779810,10139,1776315,22,3495,2364,18,5528,44,7,79,216660.0,130000.0,-48.0,-35.0,-43.0,-45.0,-44.0,-36.0,-44.0,-48.0,-89.0,-90.0,-86.0,-87.0,41.0,55.0,43.0,42.0,1
3201,62:47:05:9D:EB:15,3873612,531627243,20460,45696791,3853152,485930452,1,16267,5762733,16188,5750658,79,12075,7645,0,20546,382,1,178,229410.0,130000.0,-53.0,-51.0,-61.0,-53.0,-56.0,-58.0,-59.0,-58.0,-89.0,-90.0,-86.0,-87.0,36.0,39.0,25.0,34.0,1
3202,92:69:1D:31:68:E9,3857388,489649092,4236,3718640,3853152,485930452,1,5884,1244685,5698,1202307,186,42378,2355,13,4521,105,1,66,216660.0,130000.0,-52.0,-48.0,-42.0,-48.0,-51.0,-48.0,-43.0,-48.0,-89.0,-90.0,-86.0,-87.0,37.0,42.0,44.0,39.0,1
3203,CC:2F:71:3F:1F:24,5238900,2089507425,1385748,1603576973,3853152,485930452,2222,1167712,1342159557,1166802,1342049139,910,110418,1130053,15,1383885,130357,2219,880,144444.0,43333.0,-73.0,-68.0,-69.0,-69.0,-72.0,-68.0,-69.0,-69.0,-89.0,-90.0,-86.0,-87.0,16.0,22.0,17.0,18.0,1
3204,CC:2F:71:3E:C5:1F,3854204,486058944,1052,128492,3853152,485930452,3,4596,383052,3830,292134,766,90918,1113,16,1511,32,3,55,130000.0,39000.0,-80.0,-83.0,-75.0,-71.0,-72.0,-71.0,-68.0,-61.0,-89.0,-90.0,-86.0,-87.0,9.0,7.0,11.0,16.0,1
3205,BA:8C:B9:54:50:24,3858136,492130378,4984,6199926,3853152,485930452,7,10161,1779810,10139,1776315,22,3495,2364,18,5528,44,7,79,216660.0,130000.0,-48.0,-35.0,-43.0,-45.0,-44.0,-36.0,-44.0,-48.0,-89.0,-90.0,-86.0,-87.0,41.0,55.0,43.0,42.0,1
3206,62:47:05:9D:EB:15,3873615,531627505,20460,45696791,3853155,485930714,1,16267,5762733,16188,5750658,79,12075,7645,0,20546,382,1,178,229410.0,130000.0,-53.0,-51.0,-61.0,-53.0,-56.0,-58.0,-59.0,-58.0,-89.0,-90.0,-86.0,-87.0,36.0,39.0,25.0,34.0,1
3207,92:69:1D:31:68:E9,3857391,489649354,4236,3718640,3853155,485930714,1,5884,1244685,5698,1202307,186,42378,2355,13,4521,105,1,66,216660.0,130000.0,-52.0,-48.0,-42.0,-48.0,-51.0,-48.0,-43.0,-48.0,-89.0,-90.0,-86.0,-87.0,37.0,42.0,44.0,39.0,1
3208,CC:2F:71:3F:1F:24,5238950,2089525317,1385795,1603594603,3853155,485930714,2222,1167738,1342164143,1166828,1342053725,910,110418,1130078,15,1383932,130357,2219,880,144444.0,43333.0,-72.0,-67.0,-68.0,-69.0,-73.0,-68.0,-69.0,-70.0,-89.0,-90.0,-86.0,-87.0,17.0,23.0,18.0,18.0,1
3209,CC:2F:71:3E:C5:1F,3854209,486059408,1052,128492,3853157,485930916,3,4596,383052,3830,292134,766,90918,1113,16,1511,32,3,55,130000.0,39000.0,-80.0,-83.0,-75.0,-71.0,-72.0,-71.0,-68.0,-61.0,-89.0,-90.0,-86.0,-87.0,9.0,7.0,11.0,16.0,1
3210,BA:8C:B9:54:50:24,3858143,492131044,4984,6199926,3853159,485931118,7,10161,1779810,10139,1776315,22,3495,2364,18,5528,44,7,79,216660.0,130000.0,-48.0,-35.0,-43.0,-45.0,-44.0,-36.0,-44.0,-48.0,-89.0,-90.0,-86.0,-87.0,41.0,55.0,43.0,42.0,1
3211,62:47:05:9D:EB:15,3873622,531628173,20460,45696791,3853162,485931382,1,16267,5762733,16188,5750658,79,12075,7645,0,20546,382,1,178,229410.0,130000.0,-53.0,-51.0,-61.0,-53.0,-56.0,-58.0,-59.0,-58.0,-89.0,-90.0,-86.0,-88.0,36.0,39.0,25.0,35.0,1
3212,92:69:1D:31:68:E9,3857398,489650022,4236,3718640,3853162,485931382,1,5884,1244685,5698,1202307,186,42378,2355,13,4521,105,1,66,216660.0,130000.0,-52.0,-48.0,-42.0,-48.0,-51.0,-48.0,-43.0,-48.0,-89.0,-90.0,-86.0,-88.0,37.0,42.0,44.0,40.0,1
3213,CC:2F:71:3F:1F:24,5239002,2089543355,1385840,1603611973,3853162,485931382,2222,1167764,1342168729,1166854,1342058311,910,110418,1130103,15,1383977,130357,2219,880,144444.0,43333.0,-71.0,-67.0,-68.0,-69.0,-71.0,-67.0,-68.0,-69.0,-89.0,-90.0,-86.0,-88.0,18.0,23.0,18.0,19.0,1
3214,CC:2F:71:3E:C5:1F,3854214,486059874,1052,128492,3853162,485931382,3,4598,383240,3831,292204,767,91036,1114,16,1511,32,3,55,130000.0,39000.0,-71.0,-71.0,-69.0,-60.0,-72.0,-71.0,-68.0,-61.0,-89.0,-90.0,-86.0,-88.0,18.0,19.0,17.0,28.0,1
3215,BA:8C:B9:54:50:24,3858146,492131308,4984,6199926,3853162,485931382,7,10161,1779810,10139,1776315,22,3495,2364,18,5528,44,7,79,216660.0,130000.0,-48.0,-35.0,-43.0,-45.0,-44.0,-36.0,-44.0,-48.0,-89.0,-90.0,-86.0,-88.0,41.0,55.0,43.0,43.0,1
3216,62:47:05:9D:EB:15,3873625,531628437,20460,45696791,3853165,485931646,1,16267,5762733,16188,5750658,79,12075,7645,0,20546,382,1,178,229410.0,130000.0,-53.0,-51.0,-61.0,-53.0,-56.0,-58.0,-59.0,-58.0,-89.0,-90.0,-86.0,-88.0,36.0,39.0,25.0,35.0,1
3217,92:69:1D:31:68:E9,3857403,489650488,4236,3718640,3853167,485931848,1,5884,1244685,5698,1202307,186,42378,2355,13,4521,105,1,66,216660.0,130000.0,-52.0,-48.0,-42.0,-48.0,-51.0,-48.0,-43.0,-48.0,-89.0,-90.0,-86.0,-88.0,37.0,42.0,44.0,40.0,1
3218,CC:2F:71:3F:1F:24,5239061,2089564852,1385893,1603632944,3853168,485931908,2222,1167800,1342175032,1166889,1342064496,911,110536,1130136,15,1384030,130358,2219,880,144444.0,43333.0,-73.0,-67.0,-69.0,-71.0,-71.0,-66.0,-68.0,-70.0,-89.0,-90.0,-86.0,-88.0,16.0,23.0,17.0,17.0,1
3219,CC:2F:71:3E:C5:1F,3854222,486060602,1052,128492,3853170,485932110,3,4598,383240,3831,292204,767,91036,1114,16,1511,32,3,55,130000.0,39000.0,-71.0,-71.0,-69.0,-60.0,-72.0,-71.0,-68.0,-61.0,-89.0,-90.0,-86.0,-88.0,18.0,19.0,17.0,28.0,1
3220,BA:8C:B9:54:50:24,3858154,492132036,4984,6199926,3853170,485932110,7,10161,1779810,10139,1776315,22,3495,2364,18,5528,44,7,79,216660.0,130000.0,-48.0,-35.0,-43.0,-45.0,-44.0,-36.0,-44.0,-48.0,-89.0,-90.0,-86.0,-88.0,41.0,55.0,43.0,43.0,1
3221,62:47:05:9D:EB:15,3873656,531651584,20482,45719148,3853174,485932436,1,16317,5805204,16236,5792885,81,12319,7678,0,20568,382,1,178,229410.0,137640.0,-43.0,-46.0,-43.0,-50.0,-42.0,-46.0,-40.0,-45.0,-89.0,-90.0,-86.0,-88.0,46.0,44.0,43.0,38.0,1
3222,92:69:1D:31:68:E9,3857410,489651076,4236,3718640,3853174,485932436,1,5885,1244753,5699,1202375,186,42378,2355,13,4521,105,1,66,216660.0,130000.0,-52.0,-48.0,-44.0,-48.0,-51.0,-48.0,-43.0,-47.0,-89.0,-90.0,-86.0,-88.0,37.0,42.0,42.0,40.0,1
3223,CC:2F:71:3F:1F:24,5239112,2089582766,1385938,1603650330,3853174,485932436,2222,1167825,1342179502,1166914,1342068966,911,110536,1130160,15,1384075,130358,2219,880,144444.0,43333.0,-76.0,-70.0,-68.0,-72.0,-74.0,-69.0,-68.0,-71.0,-89.0,-90.0,-86.0,-88.0,13.0,20.0,18.0,16.0,1
3224,CC:2F:71:3E:C5:1F,3854226,486060928,1052,128492,3853174,485932436,3,4598,383240,3831,292204,767,91036,1114,16,1511,32,3,55,130000.0,39000.0,-71.0,-71.0,-69.0,-60.0,-72.0,-71.0,-68.0,-61.0,-89.0,-90.0,-86.0,-88.0,18.0,19.0,17.0,28.0,1
3225,BA:8C:B9:54:50:24,3858158,492132362,4984,6199926,3853174,485932436,7,10161,1779810,10139,1776315,22,3495,2364,18,5528,44,7,79,216660.0,130000.0,-48.0,-35.0,-43.0,-45.0,-44.0,-36.0,-44.0,-48.0,-89.0,-90.0,-86.0,-88.0,41.0,55.0,43.0,43.0,1
3226,62:47:05:9D:EB:15,3873861,532195943,20683,46263103,3853178,485932840,1,16370,5823608,16289,5811289,81,12319,7717,0,20769,403,1,178,229410.0,137640.0,-43.0,-58.0,-44.0,-52.0,-45.0,-53.0,-47.0,-50.0,-89.0,-90.0,-86.0,-88.0,46.0,32.0,42.0,36.0,1
3227,92:69:1D:31:68:E9,3857414,489651480,4236,3718640,3853178,485932840,1,5885,1244753,5699,1202375,186,42378,2355,13,4521,105,1,66,216660.0,130000.0,-52.0,-48.0,-44.0,-48.0,-51.0,-48.0,-43.0,-47.0,-89.0,-90.0,-86.0,-88.0,37.0,42.0,42.0,40.0,1
3228,CC:2F:71:3F:1F:24,5239163,2089600742,1385983,1603667700,3853180,485933042,2222,1167850,1342183972,1166939,1342073436,911,110536,1130184,15,1384120,130358,2219,880,144444.0,43333.0,-74.0,-70.0,-69.0,-72.0,-75.0,-69.0,-70.0,-71.0,-89.0,-90.0,-86.0,-88.0,15.0,20.0,17.0,16.0,1
3229,CC:2F:71:3E:C5:1F,3854232,486061534,1052,128492,3853180,485933042,3,4598,383240,3831,292204,767,91036,1114,16,1511,32,3,55,130000.0,39000.0,-71.0,-71.0,-69.0,-60.0,-72.0,-71.0,-68.0,-61.0,-89.0,-90.0,-86.0,-88.0,18.0,19.0,17.0,28.0,1
3230,BA:8C:B9:54:50:24,3858166,492133141,4984,6199926,3853182,485933215,7,10161,1779810,10139,1776315,22,3495,2364,18,5528,44,7,79,216660.0,130000.0,-48.0,-35.0,-43.0,-45.0,-44.0,-36.0,-44.0,-48.0,-89.0,-90.0,-86.0,-88.0,41.0,55.0,43.0,43.0,1
3231,62:47:05:9D:EB:15,3874094,532803940,20908,46870401,3853186,485933539,1,16495,5840946,16411,5828212,84,12734,7796,0,20994,403,1,178,229410.0,137640.0,-40.0,-53.0,-42.0,-51.0,-44.0,-55.0,-42.0,-51.0,-89.0,-90.0,-86.0,-88.0,49.0,37.0,44.0,37.0,1
3232,92:69:1D:31:68:E9,3857422,489652179,4236,3718640,3853186,485933539,1,5885,1244753,5699,1202375,186,42378,2355,13,4521,105,1,66,216660.0,130000.0,-52.0,-48.0,-44.0,-48.0,-51.0,-48.0,-43.0,-47.0,-89.0,-90.0,-86.0,-88.0,37.0,42.0,42.0,40.0,1
3233,CC:2F:71:3F:1F:24,5239214,2089618609,1386028,1603685070,3853186,485933539,2222,1167876,1342188620,1166965,1342078084,911,110536,1130208,15,1384165,130358,2219,880,144444.0,43333.0,-74.0,-70.0,-68.0,-74.0,-73.0,-69.0,-67.0,-74.0,-89.0,-90.0,-86.0,-88.0,15.0,20.0,18.0,14.0,1
3234,CC:2F:71:3E:C5:1F,3854238,486062031,1052,128492,3853186,485933539,3,4598,383240,3831,292204,767,91036,1114,16,1511,32,3,55,130000.0,39000.0,-71.0,-71.0,-69.0,-60.0,-72.0,-71.0,-68.0,-61.0,-89.0,-90.0,-86.0,-88.0,18.0,19.0,17.0,28.0,1
3235,BA:8C:B9:54:50:24,3858172,492133667,4984,6199926,3853188,485933741,7,10161,1779810,10139,1776315,22,3495,2364,18,5528,44,7,79,216660.0,130000.0,-48.0,-35.0,-43.0,-45.0,-44.0,-36.0,-44.0,-48.0,-89.0,-90.0,-86.0,-88.0,41.0,55.0,43.0,43.0,1
3236,62:47:05:9D:EB:15,3874118,532813730,20913,46873875,3853205,485939855,1,16536,5844165,16451,5831260,85,12905,7802,0,20999,403,1,178,229410.0,137640.0,-45.0,-55.0,-44.0,-53.0,-43.0,-54.0,-43.0,-52.0,-89.0,-90.0,-86.0,-88.0,44.0,35.0,42.0,35.0,1
3237,92:69:1D:31:68:E9,3857441,489658495,4236,3718640,3853205,485939855,1,5888,1245124,5701,1202511,187,42613,2356,13,4521,105,1,66,216660.0,130000.0,-52.0,-48.0,-44.0,-47.0,-52.0,-48.0,-44.0,-48.0,-89.0,-90.0,-86.0,-88.0,37.0,42.0,42.0,41.0,1
3238,CC:2F:71:3F:1F:24,5239297,2089651224,1386081,1603705945,3853216,485945279,2222,1167915,1342195360,1167004,1342084824,911,110536,1130241,15,1384218,130358,2219,880,144444.0,39000.0,-74.0,-70.0,-68.0,-75.0,-76.0,-72.0,-70.0,-76.0,-89.0,-90.0,-86.0,-88.0,15.0,20.0,18.0,13.0,1
3239,CC:2F:71:3E:C5:1F,3854268,486073771,1052,128492,3853216,485945279,3,4598,383240,3831,292204,767,91036,1114,16,1511,32,3,55,130000.0,39000.0,-71.0,-71.0,-69.0,-60.0,-72.0,-71.0,-68.0,-61.0,-89.0,-90.0,-86.0,-88.0,18.0,19.0,17.0,28.0,1
3240,BA:8C:B9:54:50:24,3858200,492145205,4984,6199926,3853216,485945279,7,10161,1779810,10139,1776315,22,3495,2364,18,5528,44,7,79,216660.0,130000.0,-48.0,-35.0,-43.0,-45.0,-44.0,-36.0,-44.0,-48.0,-89.0,-90.0,-86.0,-88.0,41.0,55.0,43.0,43.0,1
3241,62:47:05:9D:EB:15,3874138,532821107,20918,46875455,3853220,485945652,1,16554,5848179,16468,5835103,86,13076,7808,0,21004,403,1,178,229410.0,137640.0,-40.0,-53.0,-42.0,-51.0,-44.0,-54.0,-43.0,-52.0,-89.0,-90.0,-86.0,-88.0,49.0,37.0,44.0,37.0,1
3242,92:69:1D:31:68:E9,3857458,489664494,4236,3718640,3853222,485945854,1,5888,1245124,5701,1202511,187,42613,2356,13,4521,105,1,66,216660.0,130000.0,-52.0,-48.0,-44.0,-47.0,-52.0,-48.0,-44.0,-48.0,-89.0,-90.0,-86.0,-88.0,37.0,42.0,42.0,41.0,1
3243,CC:2F:71:3F:1F:24,5239351,2089669503,1386129,1603723649,3853222,485945854,2222,1167941,1342199946,1167030,1342089410,911,110536,1130266,15,1384266,130358,2219,880,144444.0,43333.0,-76.0,-73.0,-71.0,-77.0,-76.0,-72.0,-71.0,-77.0,-89.0,-90.0,-86.0,-88.0,13.0,17.0,15.0,11.0,1
3244,CC:2F:71:3E:C5:1F,3854274,486074346,1052,128492,3853222,485945854,3,4600,383380,3833,292344,767,91036,1114,16,1512,32,3,55,130000.0,39000.0,-71.0,-71.0,-70.0,-60.0,-72.0,-71.0,-69.0,-61.0,-89.0,-90.0,-86.0,-88.0,18.0,19.0,16.0,28.0,1
3245,BA:8C:B9:54:50:24,3858206,492145780,4984,6199926,3853222,485945854,7,10163,1779946,10141,1776451,22,3495,2364,18,5529,44,7,79,216660.0,130000.0,-40.0,-37.0,-46.0,-52.0,-43.0,-36.0,-44.0,-49.0,-89.0,-90.0,-86.0,-88.0,49.0,53.0,40.0,36.0,1
3246,62:47:05:9D:EB:15,3874146,532822012,20920,46875754,3853226,485946258,1,16568,5849274,16482,5836198,86,13076,7810,0,21006,403,1,178,229410.0,137640.0,-46.0,-58.0,-40.0,-50.0,-44.0,-54.0,-41.0,-51.0,-89.0,-90.0,-87.0,-88.0,43.0,32.0,47.0,38.0,1
3247,92:69:1D:31:68:E9,3857462,489664898,4236,3718640,3853226,485946258,1,5888,1245124,5701,1202511,187,42613,2356,13,4521,105,1,66,216660.0,130000.0,-52.0,-48.0,-44.0,-47.0,-52.0,-48.0,-44.0,-48.0,-89.0,-90.0,-87.0,-88.0,37.0,42.0,43.0,41.0,1
3248,CC:2F:71:3F:1F:24,5239401,2089687407,1386175,1603741149,3853226,485946258,2222,1167967,1342204674,1167056,1342094138,911,110536,1130290,15,1384312,130358,2219,880,144444.0,43333.0,-77.0,-73.0,-71.0,-77.0,-74.0,-70.0,-69.0,-75.0,-89.0,-90.0,-87.0,-88.0,12.0,17.0,16.0,11.0,1
3249,CC:2F:71:3E:C5:1F,3854280,486074952,1052,128492,3853228,485946460,3,4600,383380,3833,292344,767,91036,1114,16,1512,32,3,55,130000.0,39000.0,-71.0,-71.0,-70.0,-60.0,-72.0,-71.0,-69.0,-61.0,-89.0,-90.0,-87.0,-88.0,18.0,19.0,17.0,28.0,1
3250,BA:8C:B9:54:50:24,3858212,492146386,4984,6199926,3853228,485946460,7,10164,1780014,10142,1776519,22,3495,2364,18,5529,44,7,79,216660.0,130000.0,-48.0,-35.0,-43.0,-45.0,-44.0,-36.0,-44.0,-48.0,-89.0,-90.0,-87.0,-88.0,41.0,55.0,44.0,43.0,1
3251,62:47:05:9D:EB:15,3874160,532826036,20929,46879101,3853231,485946935,1,16588,5870273,16502,5857197,86,13076,7822,0,21015,403,1,178,229410.0,137640.0,-46.0,-58.0,-39.0,-49.0,-45.0,-55.0,-42.0,-51.0,-89.0,-90.0,-87.0,-88.0,43.0,32.0,48.0,39.0,1
3252,92:69:1D:31:68:E9,3857467,489665575,4236,3718640,3853231,485946935,1,5888,1245124,5701,1202511,187,42613,2356,13,4521,105,1,66,216660.0,130000.0,-52.0,-48.0,-44.0,-47.0,-52.0,-48.0,-44.0,-48.0,-89.0,-90.0,-87.0,-88.0,37.0,42.0,43.0,41.0,1
3253,CC:2F:71:3F:1F:24,5239452,2089705584,1386221,1603758649,3853231,485946935,2222,1167994,1342209518,1167083,1342098982,911,110536,1130315,15,1384358,130362,2219,880,144444.0,43333.0,-77.0,-72.0,-71.0,-77.0,-75.0,-71.0,-70.0,-76.0,-89.0,-90.0,-87.0,-88.0,12.0,18.0,16.0,11.0,1
3254,CC:2F:71:3E:C5:1F,3854283,486075427,1052,128492,3853231,485946935,3,4600,383380,3833,292344,767,91036,1114,16,1512,32,3,55,130000.0,39000.0,-71.0,-71.0,-70.0,-60.0,-72.0,-71.0,-69.0,-61.0,-89.0,-90.0,-87.0,-88.0,18.0,19.0,17.0,28.0,1
3255,BA:8C:B9:54:50:24,3858215,492146861,4984,6199926,3853231,485946935,7,10167,1780218,10145,1776723,22,3495,2364,18,5529,44,7,79,216660.0,130000.0,-48.0,-35.0,-43.0,-45.0,-46.0,-35.0,-43.0,-46.0,-89.0,-90.0,-87.0,-88.0,41.0,55.0,44.0,43.0,1
3256,62:47:05:9D:EB:15,3874169,532827303,20933,46879904,3853236,485947399,1,16613,5872440,16527,5859364,86,13076,7829,0,21019,403,1,178,229410.0,137640.0,-45.0,-55.0,-44.0,-53.0,-45.0,-55.0,-44.0,-52.0,-89.0,-90.0,-87.0,-88.0,44.0,35.0,43.0,35.0,1
3257,92:69:1D:31:68:E9,3857472,489666039,4236,3718640,3853236,485947399,1,5888,1245124,5701,1202511,187,42613,2356,13,4521,105,1,66,216660.0,130000.0,-52.0,-48.0,-44.0,-47.0,-52.0,-48.0,-44.0,-48.0,-89.0,-90.0,-87.0,-88.0,37.0,42.0,43.0,41.0,1
3258,CC:2F:71:3F:1F:24,5239511,2089727091,1386273,1603779490,3853238,485947601,2222,1168034,1342216683,1167123,1342106147,911,110536,1130346,15,1384410,130362,2219,880,144444.0,43333.0,-74.0,-70.0,-68.0,-74.0,-73.0,-69.0,-67.0,-74.0,-89.0,-90.0,-87.0,-88.0,15.0,20.0,19.0,14.0,1
3259,CC:2F:71:3E:C5:1F,3854290,486076093,1052,128492,3853238,485947601,3,4600,383380,3833,292344,767,91036,1114,16,1512,32,3,55,130000.0,39000.0,-71.0,-71.0,-70.0,-60.0,-72.0,-71.0,-69.0,-61.0,-89.0,-90.0,-87.0,-88.0,18.0,19.0,17.0,28.0,1
3260,BA:8C:B9:54:50:24,3858222,492147527,4984,6199926,3853238,485947601,7,10167,1780218,10145,1776723,22,3495,2364,18,5529,44,7,79,216660.0,130000.0,-48.0,-35.0,-43.0,-45.0,-46.0,-35.0,-43.0,-46.0,-89.0,-90.0,-87.0,-88.0,41.0,55.0,44.0,43.0,1
3261,62:47:05:9D:EB:15,3874173,532827707,20933,46879904,3853240,485947803,1,16617,5872712,16531,5859636,86,13076,7829,0,21019,403,1,178,229410.0,137640.0,-46.0,-58.0,-40.0,-50.0,-45.0,-55.0,-43.0,-52.0,-89.0,-90.0,-87.0,-88.0,43.0,32.0,47.0,38.0,1
3262,92:69:1D:31:68:E9,3857476,489666443,4236,3718640,3853240,485947803,1,5888,1245124,5701,1202511,187,42613,2356,13,4521,105,1,66,216660.0,130000.0,-52.0,-48.0,-44.0,-47.0,-52.0,-48.0,-44.0,-48.0,-89.0,-90.0,-87.0,-88.0,37.0,42.0,43.0,41.0,1
3263,CC:2F:71:3F:1F:24,5239558,2089744663,1386318,1603796860,3853240,485947803,2222,1168059,1342221153,1167148,1342110617,911,110536,1130370,15,1384455,130362,2219,880,144444.0,43333.0,-74.0,-70.0,-68.0,-74.0,-73.0,-70.0,-67.0,-74.0,-89.0,-90.0,-87.0,-88.0,15.0,20.0,19.0,14.0,1
3264,CC:2F:71:3E:C5:1F,3854294,486076663,1052,128492,3853242,485948171,3,4600,383380,3833,292344,767,91036,1114,16,1512,32,3,55,130000.0,39000.0,-71.0,-71.0,-70.0,-60.0,-72.0,-71.0,-69.0,-61.0,-89.0,-90.0,-87.0,-88.0,18.0,19.0,17.0,28.0,1
3265,BA:8C:B9:54:50:24,3858226,492148097,4984,6199926,3853242,485948171,7,10167,1780218,10145,1776723,22,3495,2364,18,5529,44,7,79,216660.0,130000.0,-48.0,-35.0,-43.0,-45.0,-46.0,-35.0,-43.0,-46.0,-89.0,-90.0,-87.0,-88.0,41.0,55.0,44.0,43.0,1
3266,62:47:05:9D:EB:15,3874183,532828910,20934,46880073,3853249,485948837,1,16620,5873059,16534,5859983,86,13076,7831,0,21020,405,1,178,229410.0,137640.0,-45.0,-55.0,-43.0,-53.0,-44.0,-55.0,-43.0,-52.0,-89.0,-90.0,-87.0,-88.0,44.0,35.0,44.0,35.0,1
3267,92:69:1D:31:68:E9,3857485,489667477,4236,3718640,3853249,485948837,1,5888,1245124,5701,1202511,187,42613,2356,13,4521,105,1,66,216660.0,130000.0,-52.0,-48.0,-44.0,-47.0,-52.0,-48.0,-44.0,-48.0,-89.0,-90.0,-87.0,-88.0,37.0,42.0,43.0,41.0,1
3268,CC:2F:71:3F:1F:24,5239614,2089763343,1386365,1603814506,3853249,485948837,2222,1168085,1342225753,1167174,1342115217,911,110536,1130394,15,1384502,130362,2219,880,144444.0,43333.0,-73.0,-70.0,-67.0,-74.0,-72.0,-69.0,-67.0,-73.0,-89.0,-90.0,-87.0,-88.0,16.0,20.0,20.0,14.0,1
3269,CC:2F:71:3E:C5:1F,3854301,486077329,1052,128492,3853249,485948837,3,4600,383380,3833,292344,767,91036,1114,16,1512,32,3,55,130000.0,39000.0,-71.0,-71.0,-70.0,-60.0,-72.0,-71.0,-69.0,-61.0,-89.0,-90.0,-87.0,-88.0,18.0,19.0,17.0,28.0,1
3270,BA:8C:B9:54:50:24,3858233,492148763,4984,6199926,3853249,485948837,7,10167,1780218,10145,1776723,22,3495,2364,18,5529,44,7,79,216660.0,130000.0,-48.0,-35.0,-43.0,-45.0,-46.0,-35.0,-43.0,-46.0,-89.0,-90.0,-87.0,-88.0,41.0,55.0,44.0,43.0,1
3271,62:47:05:9D:EB:15,3874185,532829112,20934,46880073,3853251,485949039,1,16629,5873671,16543,5860595,86,13076,7831,0,21020,405,1,178,229410.0,137640.0,-46.0,-58.0,-40.0,-50.0,-45.0,-55.0,-42.0,-52.0,-89.0,-90.0,-87.0,-88.0,43.0,32.0,47.0,38.0,1
3272,92:69:1D:31:68:E9,3857487,489667679,4236,3718640,3853251,485949039,1,5888,1245124,5701,1202511,187,42613,2356,13,4521,105,1,66,216660.0,130000.0,-52.0,-48.0,-44.0,-47.0,-52.0,-48.0,-44.0,-48.0,-89.0,-90.0,-87.0,-88.0,37.0,42.0,43.0,41.0,1
3273,CC:2F:71:3F:1F:24,5239669,2089784516,1386418,1603835477,3853251,485949039,2222,1168120,1342231874,1167209,1342121338,911,110536,1130428,15,1384555,130362,2219,880,144444.0,43333.0,-72.0,-69.0,-67.0,-73.0,-72.0,-69.0,-67.0,-73.0,-89.0,-90.0,-87.0,-88.0,17.0,21.0,20.0,15.0,1
3274,CC:2F:71:3E:C5:1F,3854305,486077733,1052,128492,3853253,485949241,3,4600,383380,3833,292344,767,91036,1114,16,1512,32,3,55,130000.0,39000.0,-71.0,-71.0,-70.0,-60.0,-72.0,-71.0,-69.0,-61.0,-89.0,-90.0,-87.0,-88.0,18.0,19.0,17.0,28.0,1
3275,BA:8C:B9:54:50:24,3858237,492149167,4984,6199926,3853253,485949241,7,10167,1780218,10145,1776723,22,3495,2364,18,5529,44,7,79,216660.0,130000.0,-48.0,-35.0,-43.0,-45.0,-46.0,-35.0,-43.0,-46.0,-89.0,-90.0,-87.0,-88.0,41.0,55.0,44.0,43.0,1
3276,62:47:05:9D:EB:15,3874191,532829718,20934,46880073,3853257,485949645,1,16629,5873671,16543,5860595,86,13076,7831,0,21020,405,1,178,229410.0,137640.0,-46.0,-58.0,-40.0,-50.0,-45.0,-55.0,-42.0,-52.0,-89.0,-90.0,-87.0,-88.0,43.0,32.0,47.0,38.0,1
3277,92:69:1D:31:68:E9,3857493,489668285,4236,3718640,3853257,485949645,1,5888,1245124,5701,1202511,187,42613,2356,13,4521,105,1,66,216660.0,130000.0,-52.0,-48.0,-44.0,-47.0,-52.0,-48.0,-44.0,-48.0,-89.0,-90.0,-87.0,-88.0,37.0,42.0,43.0,41.0,1
3278,CC:2F:71:3F:1F:24,5239722,2089802768,1386465,1603853123,3853257,485949645,2222,1168146,1342236460,1167235,1342125924,911,110536,1130453,15,1384602,130364,2219,880,144444.0,43333.0,-72.0,-69.0,-67.0,-73.0,-72.0,-69.0,-67.0,-73.0,-89.0,-90.0,-87.0,-88.0,17.0,21.0,20.0,15.0,1
3279,CC:2F:71:3E:C5:1F,3854309,486078137,1052,128492,3853257,485949645,3,4600,383380,3833,292344,767,91036,1114,16,1512,32,3,55,130000.0,39000.0,-71.0,-71.0,-70.0,-60.0,-72.0,-71.0,-69.0,-61.0,-89.0,-90.0,-87.0,-88.0,18.0,19.0,17.0,28.0,1
3280,BA:8C:B9:54:50:24,3858241,492149571,4984,6199926,3853257,485949645,7,10167,1780218,10145,1776723,22,3495,2364,18,5529,44,7,79,216660.0,130000.0,-48.0,-35.0,-43.0,-45.0,-46.0,-35.0,-43.0,-46.0,-89.0,-90.0,-87.0,-88.0,41.0,55.0,44.0,43.0,1
3281,62:47:05:9D:EB:15,3874203,532836739,20943,46886832,3853260,485949907,1,16648,5892759,16562,5879683,86,13076,7841,0,21029,413,1,178,229410.0,137640.0,-40.0,-53.0,-43.0,-51.0,-43.0,-54.0,-42.0,-51.0,-89.0,-90.0,-87.0,-88.0,49.0,37.0,44.0,37.0,1
3282,92:69:1D:31:68:E9,3857498,489668749,4236,3718640,3853262,485950109,1,5888,1245124,5701,1202511,187,42613,2356,13,4521,105,1,66,216660.0,130000.0,-52.0,-48.0,-44.0,-47.0,-52.0,-48.0,-44.0,-48.0,-89.0,-90.0,-87.0,-88.0,37.0,42.0,43.0,41.0,1
3283,CC:2F:71:3F:1F:24,5239775,2089821008,1386513,1603870899,3853262,485950109,2222,1168172,1342241046,1167261,1342130510,911,110536,1130478,15,1384650,130364,2219,880,144444.0,43333.0,-74.0,-68.0,-66.0,-72.0,-74.0,-68.0,-66.0,-72.0,-89.0,-90.0,-87.0,-88.0,15.0,22.0,21.0,16.0,1
3284,CC:2F:71:3E:C5:1F,3854314,486078601,1052,128492,3853262,485950109,3,4600,383380,3833,292344,767,91036,1114,16,1512,32,3,55,130000.0,39000.0,-71.0,-71.0,-70.0,-60.0,-72.0,-71.0,-69.0,-61.0,-89.0,-90.0,-87.0,-88.0,18.0,19.0,17.0,28.0,1
3285,BA:8C:B9:54:50:24,3858246,492150035,4984,6199926,3853262,485950109,7,10167,1780218,10145,1776723,22,3495,2364,18,5529,44,7,79,216660.0,130000.0,-48.0,-35.0,-43.0,-45.0,-46.0,-35.0,-43.0,-46.0,-89.0,-90.0,-87.0,-88.0,41.0,55.0,44.0,43.0,1
3286,62:47:05:9D:EB:15,3874209,532837345,20943,46886832,3853266,485950513,1,16648,5892759,16562,5879683,86,13076,7841,0,21029,413,1,178,229410.0,137640.0,-40.0,-53.0,-43.0,-51.0,-43.0,-54.0,-42.0,-51.0,-89.0,-90.0,-87.0,-88.0,49.0,37.0,44.0,37.0,1
3287,92:69:1D:31:68:E9,3857502,489669153,4236,3718640,3853266,485950513,1,5888,1245124,5701,1202511,187,42613,2356,13,4521,105,1,66,216660.0,130000.0,-52.0,-48.0,-44.0,-47.0,-52.0,-48.0,-44.0,-48.0,-89.0,-90.0,-87.0,-88.0,37.0,42.0,43.0,41.0,1
3288,CC:2F:71:3F:1F:24,5239824,2089838798,1386558,1603888285,3853266,485950513,2222,1168198,1342245774,1167287,1342135238,911,110536,1130502,15,1384695,130364,2219,880,144444.0,43333.0,-74.0,-68.0,-67.0,-72.0,-74.0,-68.0,-67.0,-72.0,-89.0,-90.0,-87.0,-88.0,15.0,22.0,20.0,16.0,1
3289,CC:2F:71:3E:C5:1F,3854318,486079005,1052,128492,3853266,485950513,3,4600,383380,3833,292344,767,91036,1114,16,1512,32,3,55,130000.0,39000.0,-71.0,-71.0,-70.0,-60.0,-72.0,-71.0,-69.0,-61.0,-89.0,-90.0,-87.0,-88.0,18.0,19.0,17.0,28.0,1
3290,BA:8C:B9:54:50:24,3858250,492150439,4984,6199926,3853266,485950513,7,10167,1780218,10145,1776723,22,3495,2364,18,5529,44,7,79,216660.0,130000.0,-48.0,-35.0,-43.0,-45.0,-46.0,-35.0,-43.0,-46.0,-89.0,-90.0,-87.0,-88.0,41.0,55.0,44.0,43.0,1
