sample,station,tx_total_pkts,tx_total_bytes,tx_ucast_pkts,tx_ucast_bytes,tx_mcast_bcast_pkts,tx_mcast_bcast_bytes,tx_failures,rx_data_pkts,rx_data_bytes,rx_ucast_pkts,rx_ucast_bytes,rx_mcast_bcast_pkts,rx_mcast_bcast_bytes,rx_decrypt_succeeds,tx_data_pkts_retried,tx_total_pkts_sent,tx_pkts_retries,tx_pkts_retry_exhausted,rx_total_pkts_retried,rate_last_tx_pkt_min,rate_last_tx_pkt_max,per_antenna_rssi_last_rx_data_frame_1,per_antenna_rssi_last_rx_data_frame_2,per_antenna_rssi_last_rx_data_frame_3,per_antenna_rssi_last_rx_data_frame_4,per_antenna_avg_rssi_rx_data_frames_1,per_antenna_avg_rssi_rx_data_frames_2,per_antenna_avg_rssi_rx_data_frames_3,per_antenna_avg_rssi_rx_data_frames_4,per_antenna_noise_floor_1,per_antenna_noise_floor_2,per_antenna_noise_floor_3,per_antenna_noise_floor_4,sinr_per_antenna_1,sinr_per_antenna_2,sinr_per_antenna_3,sinr_per_antenna_4,attack
1,CC:2F:71:3F:1F:24,3938956,685241139,177782,210837699,3761174,474403440,27,149163,170912252,149099,170904250,64,8002,143030,6,177779,18961,24,129,130000.0,43333.0,-68.0,-66.0,-70.0,-71.0,-68.0,-66.0,-69.0,-70.0,-90.0,-93.0,-90.0,-93.0,22.0,27.0,20.0,22.0,1
2,CC:2F:71:3E:C5:1F,3761253,474413170,79,9730,3761174,474403440,0,304,26338,246,19308,58,7030,86,2,105,4,0,5,144444.0,39000.0,-71.0,-71.0,-68.0,-60.0,-71.0,-70.0,-67.0,-60.0,-90.0,-93.0,-90.0,-93.0,19.0,22.0,22.0,33.0,1
3,BA:8C:B9:54:50:24,3761433,474485195,259,81755,3761174,474403440,0,1102,126701,1084,123855,18,2846,178,2,360,4,0,7,216660.0,130000.0,-40.0,-37.0,-45.0,-51.0,-42.0,-35.0,-43.0,-47.0,-90.0,-93.0,-90.0,-93.0,50.0,56.0,45.0,42.0,1
4,92:69:1D:31:68:E9,3773948,489655169,12774,15251729,3761174,474403440,3,19205,3550821,18511,3391199,694,159622,6440,105,14024,252,3,250,229410.0,130000.0,-51.0,-47.0,-42.0,-49.0,-51.0,-47.0,-43.0,-49.0,-90.0,-93.0,-90.0,-93.0,39.0,46.0,48.0,44.0,1
5,CC:2F:71:3F:1F:24,3939064,685360987,177890,210957547,3761174,474403440,27,149255,171026866,149191,171018864,64,8002,143117,6,177888,18965,24,129,117000.0,39000.0,-69.0,-66.0,-70.0,-69.0,-69.0,-66.0,-69.0,-69.0,-90.0,-93.0,-90.0,-93.0,21.0,27.0,20.0,24.0,1
6,CC:2F:71:3E:C5:1F,3761253,474413170,79,9730,3761174,474403440,0,304,26338,246,19308,58,7030,86,2,105,4,0,5,144444.0,39000.0,-71.0,-71.0,-68.0,-60.0,-71.0,-70.0,-67.0,-60.0,-90.0,-93.0,-90.0,-93.0,19.0,22.0,22.0,33.0,1
7,BA:8C:B9:54:50:24,3761435,474485397,259,81755,3761176,474403642,0,1102,126701,1084,123855,18,2846,178,2,360,4,0,7,216660.0,130000.0,-40.0,-37.0,-45.0,-51.0,-42.0,-35.0,-43.0,-47.0,-90.0,-93.0,-90.0,-93.0,50.0,56.0,45.0,42.0,1
8,92:69:1D:31:68:E9,3773950,489655371,12774,15251729,3761176,474403642,3,19205,3550821,18511,3391199,694,159622,6440,105,14024,252,3,250,229410.0,130000.0,-51.0,-47.0,-42.0,-49.0,-51.0,-47.0,-43.0,-49.0,-90.0,-93.0,-90.0,-93.0,39.0,46.0,48.0,44.0,1
9,CC:2F:71:3F:1F:24,3939178,685481383,177996,211077135,3761182,474404248,27,149349,171143108,149285,171135106,64,8002,143208,6,177994,18965,24,129,130000.0,43333.0,-70.0,-66.0,-70.0,-70.0,-70.0,-66.0,-69.0,-70.0,-90.0,-93.0,-90.0,-93.0,20.0,27.0,20.0,23.0,1
10,CC:2F:71:3E:C5:1F,3761261,474413978,79,9730,3761182,474404248,0,304,26338,246,19308,58,7030,86,2,105,4,0,5,144444.0,39000.0,-71.0,-71.0,-68.0,-60.0,-71.0,-70.0,-67.0,-60.0,-90.0,-93.0,-90.0,-93.0,19.0,22.0,22.0,33.0,1
11,BA:8C:B9:54:50:24,3761441,474486003,259,81755,3761182,474404248,0,1102,126701,1084,123855,18,2846,178,2,360,4,0,7,216660.0,130000.0,-40.0,-37.0,-45.0,-51.0,-42.0,-35.0,-43.0,-47.0,-90.0,-93.0,-90.0,-93.0,50.0,56.0,45.0,42.0,1
12,92:69:1D:31:68:E9,3773956,489655977,12774,15251729,3761182,474404248,3,19205,3550821,18511,3391199,694,159622,6440,105,14024,252,3,250,229410.0,130000.0,-51.0,-47.0,-42.0,-49.0,-51.0,-47.0,-43.0,-49.0,-90.0,-93.0,-90.0,-93.0,39.0,46.0,48.0,44.0,1
13,CC:2F:71:3F:1F:24,3939292,685603190,178109,211198882,3761183,474404308,27,149444,171249948,149380,171241946,64,8002,143303,6,178106,18965,24,129,130000.0,43333.0,-70.0,-66.0,-70.0,-71.0,-70.0,-66.0,-69.0,-70.0,-90.0,-93.0,-90.0,-93.0,20.0,27.0,20.0,22.0,1
14,CC:2F:71:3E:C5:1F,3761262,474414038,79,9730,3761183,474404308,0,304,26338,246,19308,58,7030,86,2,105,4,0,5,144444.0,39000.0,-71.0,-71.0,-68.0,-60.0,-71.0,-70.0,-67.0,-60.0,-90.0,-93.0,-90.0,-93.0,19.0,22.0,22.0,33.0,1
15,BA:8C:B9:54:50:24,3761444,474486265,259,81755,3761185,474404510,0,1102,126701,1084,123855,18,2846,178,2,360,4,0,7,216660.0,130000.0,-40.0,-37.0,-45.0,-51.0,-42.0,-35.0,-43.0,-47.0,-90.0,-93.0,-90.0,-93.0,50.0,56.0,45.0,42.0,1
16,92:69:1D:31:68:E9,3773959,489656239,12774,15251729,3761185,474404510,3,19206,3550889,18512,3391267,694,159622,6440,105,14024,252,3,250,229410.0,130000.0,-53.0,-46.0,-42.0,-48.0,-51.0,-47.0,-43.0,-49.0,-90.0,-93.0,-90.0,-93.0,37.0,47.0,48.0,45.0,1
17,CC:2F:71:3F:1F:24,3939403,685721832,178216,211317120,3761187,474404712,27,149533,171358490,149469,171350488,64,8002,143392,6,178214,18965,24,129,144444.0,43333.0,-70.0,-66.0,-69.0,-71.0,-70.0,-66.0,-69.0,-70.0,-90.0,-93.0,-90.0,-93.0,20.0,27.0,21.0,22.0,1
18,CC:2F:71:3E:C5:1F,3761270,474414846,79,9730,3761191,474405116,0,304,26338,246,19308,58,7030,86,2,105,4,0,5,144444.0,39000.0,-71.0,-71.0,-68.0,-60.0,-71.0,-70.0,-67.0,-60.0,-90.0,-93.0,-90.0,-93.0,19.0,22.0,22.0,33.0,1
19,BA:8C:B9:54:50:24,3761450,474486871,259,81755,3761191,474405116,0,1102,126701,1084,123855,18,2846,178,2,360,4,0,7,216660.0,130000.0,-40.0,-37.0,-45.0,-51.0,-42.0,-35.0,-43.0,-47.0,-90.0,-93.0,-90.0,-93.0,50.0,56.0,45.0,42.0,1
20,92:69:1D:31:68:E9,3773965,489656845,12774,15251729,3761191,474405116,3,19206,3550889,18512,3391267,694,159622,6440,105,14024,252,3,250,229410.0,130000.0,-53.0,-46.0,-42.0,-48.0,-51.0,-47.0,-43.0,-49.0,-90.0,-93.0,-90.0,-93.0,37.0,47.0,48.0,45.0,1
21,CC:2F:71:3F:1F:24,3939513,685840512,178322,211435396,3761191,474405116,27,149623,171468558,149559,171460556,64,8002,143480,6,178320,18965,24,129,144444.0,43333.0,-72.0,-67.0,-70.0,-71.0,-72.0,-67.0,-70.0,-71.0,-90.0,-93.0,-90.0,-93.0,18.0,26.0,20.0,22.0,1
22,CC:2F:71:3E:C5:1F,3761270,474414846,79,9730,3761191,474405116,0,304,26338,246,19308,58,7030,86,2,105,4,0,5,144444.0,39000.0,-71.0,-71.0,-68.0,-60.0,-71.0,-70.0,-67.0,-60.0,-90.0,-93.0,-90.0,-93.0,19.0,22.0,22.0,33.0,1
23,BA:8C:B9:54:50:24,3761451,474486931,259,81755,3761192,474405176,0,1102,126701,1084,123855,18,2846,178,2,360,4,0,7,216660.0,130000.0,-40.0,-37.0,-45.0,-51.0,-42.0,-35.0,-43.0,-47.0,-90.0,-93.0,-90.0,-93.0,50.0,56.0,45.0,42.0,1
24,92:69:1D:31:68:E9,3773968,489657107,12774,15251729,3761194,474405378,3,19206,3550889,18512,3391267,694,159622,6440,105,14024,252,3,250,229410.0,130000.0,-53.0,-46.0,-42.0,-48.0,-51.0,-47.0,-43.0,-49.0,-90.0,-93.0,-90.0,-93.0,37.0,47.0,48.0,45.0,1
25,CC:2F:71:3F:1F:24,3939630,685961480,178431,211555472,3761199,474406008,27,149713,171577172,149648,171569056,65,8116,143570,6,178429,18966,24,129,144444.0,43333.0,-72.0,-67.0,-70.0,-71.0,-72.0,-67.0,-70.0,-71.0,-90.0,-93.0,-90.0,-93.0,18.0,26.0,20.0,22.0,1
26,CC:2F:71:3E:C5:1F,3761280,474415988,80,9846,3761200,474406142,0,306,26478,248,19448,58,7030,86,2,106,4,0,5,144444.0,39000.0,-72.0,-70.0,-67.0,-61.0,-71.0,-70.0,-67.0,-60.0,-90.0,-93.0,-90.0,-93.0,18.0,23.0,23.0,32.0,1
27,BA:8C:B9:54:50:24,3761460,474488013,260,81871,3761200,474406142,0,1104,126837,1086,123991,18,2846,178,2,361,4,0,7,216660.0,130000.0,-48.0,-35.0,-43.0,-45.0,-43.0,-35.0,-43.0,-47.0,-90.0,-93.0,-90.0,-93.0,42.0,58.0,47.0,48.0,1
28,92:69:1D:31:68:E9,3773978,489658257,12775,15251845,3761203,474406412,3,19208,3551025,18514,3391403,694,159622,6440,105,14025,252,3,250,229410.0,130000.0,-53.0,-46.0,-42.0,-48.0,-52.0,-47.0,-42.0,-48.0,-90.0,-93.0,-90.0,-93.0,37.0,47.0,48.0,45.0,1
29,CC:2F:71:3F:1F:24,3939743,686079006,178537,211672308,3761206,474406698,27,149803,171683046,149735,171674476,68,8570,143660,6,178535,18966,24,129,144444.0,43333.0,-72.0,-67.0,-70.0,-71.0,-72.0,-67.0,-70.0,-71.0,-90.0,-93.0,-90.0,-93.0,18.0,26.0,20.0,22.0,1
30,CC:2F:71:3E:C5:1F,3761286,474416544,80,9846,3761206,474406698,0,306,26478,248,19448,58,7030,86,2,106,4,0,5,144444.0,39000.0,-72.0,-70.0,-67.0,-61.0,-71.0,-70.0,-67.0,-60.0,-90.0,-93.0,-90.0,-93.0,18.0,23.0,23.0,32.0,1
31,BA:8C:B9:54:50:24,3761466,474488569,260,81871,3761206,474406698,0,1104,126837,1086,123991,18,2846,178,2,361,4,0,7,216660.0,130000.0,-48.0,-35.0,-43.0,-45.0,-43.0,-35.0,-43.0,-47.0,-90.0,-93.0,-90.0,-93.0,42.0,58.0,47.0,48.0,1
32,92:69:1D:31:68:E9,3773983,489658745,12775,15251845,3761208,474406900,3,19208,3551025,18514,3391403,694,159622,6440,105,14025,252,3,250,229410.0,130000.0,-53.0,-46.0,-42.0,-48.0,-52.0,-47.0,-42.0,-48.0,-90.0,-93.0,-90.0,-93.0,37.0,47.0,48.0,45.0,1
33,CC:2F:71:3F:1F:24,3939862,686201331,178651,211794169,3761211,474407162,27,149902,171791773,149834,171783203,68,8570,143759,6,178649,18966,24,129,144444.0,43333.0,-72.0,-67.0,-70.0,-71.0,-72.0,-67.0,-70.0,-71.0,-90.0,-93.0,-90.0,-93.0,18.0,26.0,20.0,22.0,1
34,CC:2F:71:3E:C5:1F,3761291,474417008,80,9846,3761211,474407162,0,306,26478,248,19448,58,7030,86,2,106,4,0,5,144444.0,39000.0,-72.0,-70.0,-67.0,-61.0,-71.0,-70.0,-67.0,-60.0,-90.0,-93.0,-90.0,-93.0,18.0,23.0,23.0,32.0,1
35,BA:8C:B9:54:50:24,3761471,474489033,260,81871,3761211,474407162,0,1104,126837,1086,123991,18,2846,178,2,361,4,0,7,216660.0,130000.0,-48.0,-35.0,-43.0,-45.0,-43.0,-35.0,-43.0,-47.0,-90.0,-93.0,-90.0,-93.0,42.0,58.0,47.0,48.0,1
36,92:69:1D:31:68:E9,3773989,489659343,12775,15251845,3761214,474407498,3,19208,3551025,18514,3391403,694,159622,6440,105,14025,252,3,250,229410.0,130000.0,-53.0,-46.0,-42.0,-48.0,-52.0,-47.0,-42.0,-48.0,-90.0,-93.0,-90.0,-93.0,37.0,47.0,48.0,45.0,1
37,CC:2F:71:3F:1F:24,3939972,686319995,178757,211912429,3761215,474407566,27,149990,171897309,149922,171888739,68,8570,143847,6,178755,18966,24,129,144444.0,43333.0,-72.0,-67.0,-70.0,-71.0,-72.0,-67.0,-70.0,-71.0,-90.0,-93.0,-90.0,-93.0,18.0,26.0,20.0,22.0,1
38,CC:2F:71:3E:C5:1F,3761295,474417412,80,9846,3761215,474407566,0,306,26478,248,19448,58,7030,86,2,106,4,0,5,144444.0,39000.0,-72.0,-70.0,-67.0,-61.0,-71.0,-70.0,-67.0,-60.0,-90.0,-93.0,-90.0,-93.0,18.0,23.0,23.0,32.0,1
39,BA:8C:B9:54:50:24,3761475,474489437,260,81871,3761215,474407566,0,1104,126837,1086,123991,18,2846,178,2,361,4,0,7,216660.0,130000.0,-48.0,-35.0,-43.0,-45.0,-43.0,-35.0,-43.0,-47.0,-90.0,-93.0,-90.0,-93.0,42.0,58.0,47.0,48.0,1
40,92:69:1D:31:68:E9,3773990,489659411,12775,15251845,3761215,474407566,3,19208,3551025,18514,3391403,694,159622,6440,105,14025,252,3,250,229410.0,130000.0,-53.0,-46.0,-42.0,-48.0,-52.0,-47.0,-42.0,-48.0,-90.0,-93.0,-90.0,-93.0,37.0,47.0,48.0,45.0,1
41,CC:2F:71:3F:1F:24,3940080,686436975,178861,212029005,3761219,474407970,27,150080,172004501,150012,171995931,68,8570,143937,6,178859,18966,24,129,144444.0,43333.0,-72.0,-67.0,-70.0,-71.0,-72.0,-67.0,-70.0,-71.0,-90.0,-93.0,-90.0,-93.0,18.0,26.0,20.0,22.0,1
42,CC:2F:71:3E:C5:1F,3761299,474417816,80,9846,3761219,474407970,0,306,26478,248,19448,58,7030,86,2,106,4,0,5,144444.0,39000.0,-72.0,-70.0,-67.0,-61.0,-71.0,-70.0,-67.0,-60.0,-90.0,-93.0,-90.0,-93.0,18.0,23.0,23.0,32.0,1
43,BA:8C:B9:54:50:24,3761479,474489841,260,81871,3761219,474407970,0,1104,126837,1086,123991,18,2846,178,2,361,4,0,7,216660.0,130000.0,-48.0,-35.0,-43.0,-45.0,-43.0,-35.0,-43.0,-47.0,-90.0,-93.0,-90.0,-93.0,42.0,58.0,47.0,48.0,1
44,92:69:1D:31:68:E9,3773994,489659815,12775,15251845,3761219,474407970,3,19208,3551025,18514,3391403,694,159622,6440,105,14025,252,3,250,229410.0,130000.0,-53.0,-46.0,-42.0,-48.0,-52.0,-47.0,-42.0,-48.0,-90.0,-93.0,-90.0,-93.0,37.0,47.0,48.0,45.0,1
45,CC:2F:71:3F:1F:24,3940190,686555569,178966,212147135,3761224,474408434,27,150168,172111461,150100,172102891,68,8570,144025,6,178964,18967,24,129,144444.0,43333.0,-72.0,-67.0,-70.0,-71.0,-72.0,-67.0,-70.0,-71.0,-90.0,-93.0,-90.0,-93.0,18.0,26.0,20.0,22.0,1
46,CC:2F:71:3E:C5:1F,3761304,474418280,80,9846,3761224,474408434,0,306,26478,248,19448,58,7030,86,2,106,4,0,5,144444.0,39000.0,-72.0,-70.0,-67.0,-61.0,-71.0,-70.0,-67.0,-60.0,-90.0,-93.0,-90.0,-93.0,18.0,23.0,23.0,32.0,1
47,BA:8C:B9:54:50:24,3761484,474490305,260,81871,3761224,474408434,0,1104,126837,1086,123991,18,2846,178,2,361,4,0,7,216660.0,130000.0,-48.0,-35.0,-43.0,-45.0,-43.0,-35.0,-43.0,-47.0,-90.0,-93.0,-90.0,-93.0,42.0,58.0,47.0,48.0,1
48,92:69:1D:31:68:E9,3773999,489660279,12775,15251845,3761224,474408434,3,19208,3551025,18514,3391403,694,159622,6440,105,14025,252,3,250,229410.0,130000.0,-53.0,-46.0,-42.0,-48.0,-52.0,-47.0,-42.0,-48.0,-90.0,-93.0,-90.0,-93.0,37.0,47.0,48.0,45.0,1
49,CC:2F:71:3F:1F:24,3940303,686674586,179073,212265413,3761230,474409173,27,150262,172222035,150194,172213465,68,8570,144117,6,179071,18982,24,130,144444.0,43333.0,-71.0,-67.0,-69.0,-70.0,-71.0,-67.0,-68.0,-69.0,-90.0,-93.0,-90.0,-93.0,19.0,26.0,21.0,23.0,1
50,CC:2F:71:3E:C5:1F,3761310,474419019,80,9846,3761230,474409173,0,308,26666,249,19518,59,7148,87,2,106,4,0,5,144444.0,39000.0,-72.0,-72.0,-66.0,-60.0,-71.0,-70.0,-67.0,-60.0,-90.0,-93.0,-90.0,-93.0,18.0,21.0,24.0,33.0,1
51,BA:8C:B9:54:50:24,3761490,474491044,260,81871,3761230,474409173,0,1104,126837,1086,123991,18,2846,178,2,361,4,0,7,216660.0,130000.0,-48.0,-35.0,-43.0,-45.0,-43.0,-35.0,-43.0,-47.0,-90.0,-93.0,-90.0,-93.0,42.0,58.0,47.0,48.0,1
52,92:69:1D:31:68:E9,3774005,489661018,12775,15251845,3761230,474409173,3,19208,3551025,18514,3391403,694,159622,6440,105,14025,252,3,250,229410.0,130000.0,-53.0,-46.0,-42.0,-48.0,-52.0,-47.0,-42.0,-48.0,-90.0,-93.0,-90.0,-93.0,37.0,47.0,48.0,45.0,1
53,CC:2F:71:3F:1F:24,3940415,686793442,179180,212383803,3761235,474409639,27,150358,172334301,150289,172325613,69,8688,144209,6,179178,18990,24,131,144444.0,43333.0,-71.0,-68.0,-69.0,-69.0,-70.0,-67.0,-68.0,-69.0,-90.0,-93.0,-90.0,-93.0,19.0,25.0,21.0,24.0,1
54,CC:2F:71:3E:C5:1F,3761315,474419485,80,9846,3761235,474409639,0,308,26666,249,19518,59,7148,87,2,106,4,0,5,144444.0,39000.0,-72.0,-72.0,-66.0,-60.0,-71.0,-70.0,-67.0,-60.0,-90.0,-93.0,-90.0,-93.0,18.0,21.0,24.0,33.0,1
55,BA:8C:B9:54:50:24,3761495,474491510,260,81871,3761235,474409639,0,1104,126837,1086,123991,18,2846,178,2,361,4,0,7,216660.0,130000.0,-48.0,-35.0,-43.0,-45.0,-43.0,-35.0,-43.0,-47.0,-90.0,-93.0,-90.0,-93.0,42.0,58.0,47.0,48.0,1
56,92:69:1D:31:68:E9,3774010,489661484,12775,15251845,3761235,474409639,3,19208,3551025,18514,3391403,694,159622,6440,105,14025,252,3,250,229410.0,130000.0,-53.0,-46.0,-42.0,-48.0,-52.0,-47.0,-42.0,-48.0,-90.0,-93.0,-90.0,-93.0,37.0,47.0,48.0,45.0,1
57,CC:2F:71:3F:1F:24,3940531,686915435,179293,212505534,3761238,474409901,27,150460,172449267,150391,172440579,69,8688,144304,6,179291,19004,24,131,144444.0,43333.0,-71.0,-67.0,-69.0,-71.0,-70.0,-67.0,-69.0,-71.0,-90.0,-93.0,-90.0,-93.0,19.0,26.0,21.0,22.0,1
58,CC:2F:71:3E:C5:1F,3761320,474419949,80,9846,3761240,474410103,0,308,26666,249,19518,59,7148,87,2,106,4,0,5,144444.0,39000.0,-72.0,-72.0,-66.0,-60.0,-71.0,-70.0,-67.0,-60.0,-90.0,-93.0,-90.0,-93.0,18.0,21.0,24.0,33.0,1
59,BA:8C:B9:54:50:24,3761500,474491974,260,81871,3761240,474410103,0,1104,126837,1086,123991,18,2846,178,2,361,4,0,7,216660.0,130000.0,-48.0,-35.0,-43.0,-45.0,-43.0,-35.0,-43.0,-47.0,-90.0,-93.0,-90.0,-93.0,42.0,58.0,47.0,48.0,1
60,92:69:1D:31:68:E9,3774015,489661948,12775,15251845,3761240,474410103,3,19208,3551025,18514,3391403,694,159622,6440,105,14025,252,3,250,229410.0,130000.0,-53.0,-46.0,-42.0,-48.0,-52.0,-47.0,-42.0,-48.0,-90.0,-93.0,-90.0,-93.0,37.0,47.0,48.0,45.0,1
61,CC:2F:71:3F:1F:24,3940642,687034171,179398,212623664,3761244,474410507,27,150552,172562443,150483,172553755,69,8688,144392,6,179396,19017,24,131,144444.0,43333.0,-71.0,-66.0,-69.0,-72.0,-71.0,-66.0,-69.0,-72.0,-90.0,-93.0,-90.0,-93.0,19.0,27.0,21.0,21.0,1
62,CC:2F:71:3E:C5:1F,3761324,474420353,80,9846,3761244,474410507,0,308,26666,249,19518,59,7148,87,2,106,4,0,5,144444.0,39000.0,-72.0,-72.0,-66.0,-60.0,-71.0,-70.0,-67.0,-60.0,-90.0,-93.0,-90.0,-93.0,18.0,21.0,24.0,33.0,1
63,BA:8C:B9:54:50:24,3761504,474492378,260,81871,3761244,474410507,0,1104,126837,1086,123991,18,2846,178,2,361,4,0,7,216660.0,130000.0,-48.0,-35.0,-43.0,-45.0,-43.0,-35.0,-43.0,-47.0,-90.0,-93.0,-90.0,-93.0,42.0,58.0,47.0,48.0,1
64,92:69:1D:31:68:E9,3774019,489662352,12775,15251845,3761244,474410507,3,19208,3551025,18514,3391403,694,159622,6440,105,14025,252,3,250,229410.0,130000.0,-53.0,-46.0,-42.0,-48.0,-52.0,-47.0,-42.0,-48.0,-90.0,-93.0,-90.0,-93.0,37.0,47.0,48.0,45.0,1
65,CC:2F:71:3F:1F:24,3940752,687152823,179505,212742054,3761247,474410769,27,150641,172669519,150572,172660831,69,8688,144481,6,179503,19017,24,131,144444.0,43333.0,-72.0,-66.0,-69.0,-71.0,-71.0,-66.0,-69.0,-71.0,-90.0,-93.0,-90.0,-93.0,18.0,27.0,21.0,22.0,1
66,CC:2F:71:3E:C5:1F,3761327,474420615,80,9846,3761247,474410769,0,308,26666,249,19518,59,7148,87,2,106,4,0,5,144444.0,39000.0,-72.0,-72.0,-66.0,-60.0,-71.0,-70.0,-67.0,-60.0,-90.0,-93.0,-90.0,-93.0,18.0,21.0,24.0,33.0,1
67,BA:8C:B9:54:50:24,3761507,474492640,260,81871,3761247,474410769,0,1104,126837,1086,123991,18,2846,178,2,361,4,0,7,216660.0,130000.0,-48.0,-35.0,-43.0,-45.0,-43.0,-35.0,-43.0,-47.0,-90.0,-93.0,-90.0,-93.0,42.0,58.0,47.0,48.0,1
68,92:69:1D:31:68:E9,3774024,489662816,12775,15251845,3761249,474410971,3,19208,3551025,18514,3391403,694,159622,6440,105,14025,252,3,250,229410.0,130000.0,-53.0,-46.0,-42.0,-48.0,-52.0,-47.0,-42.0,-48.0,-90.0,-93.0,-90.0,-93.0,37.0,47.0,48.0,45.0,1
69,CC:2F:71:3F:1F:24,3940865,687273243,179612,212861868,3761253,474411375,27,150738,172786303,150669,172777615,69,8688,144570,6,179610,19017,24,131,144444.0,43333.0,-71.0,-66.0,-69.0,-71.0,-71.0,-66.0,-69.0,-71.0,-90.0,-93.0,-89.0,-93.0,19.0,27.0,20.0,22.0,1
70,CC:2F:71:3E:C5:1F,3761333,474421221,80,9846,3761253,474411375,0,308,26666,249,19518,59,7148,87,2,106,4,0,5,144444.0,39000.0,-72.0,-72.0,-66.0,-60.0,-71.0,-70.0,-67.0,-60.0,-90.0,-93.0,-89.0,-93.0,18.0,21.0,23.0,33.0,1
71,BA:8C:B9:54:50:24,3761513,474493246,260,81871,3761253,474411375,0,1104,126837,1086,123991,18,2846,178,2,361,4,0,7,216660.0,130000.0,-48.0,-35.0,-43.0,-45.0,-43.0,-35.0,-43.0,-47.0,-90.0,-93.0,-89.0,-93.0,42.0,58.0,46.0,48.0,1
72,92:69:1D:31:68:E9,3774028,489663220,12775,15251845,3761253,474411375,3,19208,3551025,18514,3391403,694,159622,6440,105,14025,252,3,250,229410.0,130000.0,-53.0,-46.0,-42.0,-48.0,-52.0,-47.0,-42.0,-48.0,-90.0,-93.0,-89.0,-93.0,37.0,47.0,47.0,45.0,1
73,CC:2F:71:3F:1F:24,3940974,687391835,179719,212980258,3761255,474411577,27,150831,172898171,150762,172889483,69,8688,144659,6,179717,19018,24,131,144444.0,43333.0,-71.0,-66.0,-69.0,-71.0,-71.0,-66.0,-69.0,-71.0,-90.0,-93.0,-89.0,-93.0,19.0,27.0,20.0,22.0,1
74,CC:2F:71:3E:C5:1F,3761335,474421423,80,9846,3761255,474411577,0,308,26666,249,19518,59,7148,87,2,106,4,0,5,144444.0,39000.0,-72.0,-72.0,-66.0,-60.0,-71.0,-70.0,-67.0,-60.0,-90.0,-93.0,-89.0,-93.0,18.0,21.0,23.0,33.0,1
75,BA:8C:B9:54:50:24,3761515,474493448,260,81871,3761255,474411577,0,1104,126837,1086,123991,18,2846,178,2,361,4,0,7,216660.0,130000.0,-48.0,-35.0,-43.0,-45.0,-43.0,-35.0,-43.0,-47.0,-90.0,-93.0,-89.0,-93.0,42.0,58.0,46.0,48.0,1
76,92:69:1D:31:68:E9,3774032,489663624,12775,15251845,3761257,474411779,3,19208,3551025,18514,3391403,694,159622,6440,105,14025,252,3,250,229410.0,130000.0,-53.0,-46.0,-42.0,-48.0,-52.0,-47.0,-42.0,-48.0,-90.0,-93.0,-89.0,-93.0,37.0,47.0,47.0,45.0,1
77,CC:2F:71:3F:1F:24,3941097,687516046,179835,213103803,3761262,474412243,27,150932,173008569,150863,172999881,69,8688,144759,6,179833,19020,24,131,144444.0,43333.0,-72.0,-67.0,-70.0,-72.0,-72.0,-67.0,-70.0,-71.0,-90.0,-91.0,-89.0,-92.0,18.0,24.0,19.0,20.0,1
78,CC:2F:71:3E:C5:1F,3761342,474422089,80,9846,3761262,474412243,0,310,26806,251,19658,59,7148,87,2,107,4,0,5,144444.0,39000.0,-72.0,-71.0,-67.0,-60.0,-71.0,-70.0,-67.0,-60.0,-90.0,-91.0,-89.0,-92.0,18.0,20.0,22.0,32.0,1
79,BA:8C:B9:54:50:24,3761522,474494114,260,81871,3761262,474412243,0,1108,127109,1090,124263,18,2846,178,2,362,4,0,7,216660.0,130000.0,-40.0,-37.0,-45.0,-51.0,-44.0,-36.0,-44.0,-48.0,-90.0,-91.0,-89.0,-92.0,50.0,54.0,44.0,41.0,1
80,92:69:1D:31:68:E9,3774037,489664088,12775,15251845,3761262,474412243,3,19210,3551161,18516,3391539,694,159622,6440,105,14026,252,3,250,229410.0,130000.0,-52.0,-46.0,-42.0,-49.0,-52.0,-46.0,-42.0,-48.0,-90.0,-91.0,-89.0,-92.0,38.0,45.0,47.0,43.0,1
81,CC:2F:71:3F:1F:24,3941206,687634638,179942,213222193,3761264,474412445,27,151027,173125079,150958,173116391,69,8688,144847,6,179940,19021,24,131,144444.0,43333.0,-75.0,-70.0,-73.0,-74.0,-75.0,-69.0,-72.0,-74.0,-90.0,-91.0,-88.0,-91.0,15.0,21.0,15.0,17.0,1
82,CC:2F:71:3E:C5:1F,3761344,474422291,80,9846,3761264,474412445,0,310,26806,251,19658,59,7148,87,2,107,4,0,5,144444.0,39000.0,-72.0,-71.0,-67.0,-60.0,-71.0,-70.0,-67.0,-60.0,-90.0,-91.0,-88.0,-91.0,18.0,20.0,21.0,31.0,1
83,BA:8C:B9:54:50:24,3761524,474494316,260,81871,3761264,474412445,0,1108,127109,1090,124263,18,2846,178,2,362,4,0,7,216660.0,130000.0,-40.0,-37.0,-45.0,-51.0,-44.0,-36.0,-44.0,-48.0,-90.0,-91.0,-88.0,-91.0,50.0,54.0,43.0,40.0,1
84,92:69:1D:31:68:E9,3774039,489664290,12775,15251845,3761264,474412445,3,19210,3551161,18516,3391539,694,159622,6440,105,14026,252,3,250,229410.0,130000.0,-52.0,-46.0,-42.0,-49.0,-52.0,-46.0,-42.0,-48.0,-90.0,-91.0,-88.0,-91.0,38.0,45.0,46.0,42.0,1
85,CC:2F:71:3F:1F:24,3941319,687753634,180049,213340583,3761270,474413051,27,151118,173235405,151049,173226717,69,8688,144935,6,180047,19021,24,131,144444.0,43333.0,-73.0,-67.0,-70.0,-71.0,-77.0,-71.0,-74.0,-76.0,-90.0,-91.0,-88.0,-91.0,17.0,24.0,18.0,20.0,1
86,CC:2F:71:3E:C5:1F,3761350,474422897,80,9846,3761270,474413051,0,310,26806,251,19658,59,7148,87,2,107,4,0,5,144444.0,39000.0,-72.0,-71.0,-67.0,-60.0,-71.0,-70.0,-67.0,-60.0,-90.0,-91.0,-88.0,-91.0,18.0,20.0,21.0,31.0,1
87,BA:8C:B9:54:50:24,3761530,474494922,260,81871,3761270,474413051,0,1109,127177,1091,124331,18,2846,178,2,362,4,0,7,216660.0,130000.0,-40.0,-37.0,-46.0,-51.0,-44.0,-36.0,-44.0,-48.0,-90.0,-91.0,-88.0,-91.0,50.0,54.0,42.0,40.0,1
88,92:69:1D:31:68:E9,3774045,489664896,12775,15251845,3761270,474413051,3,19210,3551161,18516,3391539,694,159622,6440,105,14026,252,3,250,229410.0,130000.0,-52.0,-46.0,-42.0,-49.0,-52.0,-46.0,-42.0,-48.0,-90.0,-91.0,-88.0,-91.0,38.0,45.0,46.0,42.0,1
89,CC:2F:71:3F:1F:24,3941730,688267661,180457,213854348,3761273,474413313,27,151327,173368446,151258,173359758,69,8688,145137,6,180453,19021,24,131,144444.0,43333.0,-72.0,-66.0,-69.0,-71.0,-72.0,-66.0,-69.0,-71.0,-90.0,-91.0,-88.0,-91.0,18.0,25.0,19.0,20.0,1
90,CC:2F:71:3E:C5:1F,3761353,474423159,80,9846,3761273,474413313,0,310,26806,251,19658,59,7148,87,2,107,4,0,5,144444.0,39000.0,-72.0,-71.0,-67.0,-60.0,-71.0,-70.0,-67.0,-60.0,-90.0,-91.0,-88.0,-91.0,18.0,20.0,21.0,31.0,1
91,BA:8C:B9:54:50:24,3761533,474495184,260,81871,3761273,474413313,0,1109,127177,1091,124331,18,2846,178,2,362,4,0,7,216660.0,130000.0,-40.0,-37.0,-46.0,-51.0,-44.0,-36.0,-44.0,-48.0,-90.0,-91.0,-88.0,-91.0,50.0,54.0,42.0,40.0,1
92,92:69:1D:31:68:E9,3774048,489665158,12775,15251845,3761273,474413313,3,19210,3551161,18516,3391539,694,159622,6440,105,14026,252,3,250,229410.0,130000.0,-52.0,-46.0,-42.0,-49.0,-52.0,-46.0,-42.0,-48.0,-90.0,-91.0,-88.0,-91.0,38.0,45.0,46.0,42.0,1
93,CC:2F:71:3F:1F:24,3942331,688981811,181052,214567892,3761279,474413919,27,151646,173517289,151577,173508601,69,8688,145447,6,181050,19021,24,131,144444.0,43333.0,-72.0,-66.0,-70.0,-71.0,-72.0,-66.0,-69.0,-71.0,-90.0,-91.0,-88.0,-91.0,18.0,25.0,18.0,20.0,1
94,CC:2F:71:3E:C5:1F,3761359,474423765,80,9846,3761279,474413919,0,310,26806,251,19658,59,7148,87,2,107,4,0,5,144444.0,39000.0,-72.0,-71.0,-67.0,-60.0,-71.0,-70.0,-67.0,-60.0,-90.0,-91.0,-88.0,-91.0,18.0,20.0,21.0,31.0,1
95,BA:8C:B9:54:50:24,3761539,474495790,260,81871,3761279,474413919,0,1109,127177,1091,124331,18,2846,178,2,362,4,0,7,216660.0,130000.0,-40.0,-37.0,-46.0,-51.0,-44.0,-36.0,-44.0,-48.0,-90.0,-91.0,-88.0,-91.0,50.0,54.0,42.0,40.0,1
96,92:69:1D:31:68:E9,3774054,489665764,12775,15251845,3761279,474413919,3,19210,3551161,18516,3391539,694,159622,6440,105,14026,252,3,250,229410.0,130000.0,-52.0,-46.0,-42.0,-49.0,-52.0,-46.0,-42.0,-48.0,-90.0,-91.0,-88.0,-91.0,38.0,45.0,46.0,42.0,1
97,CC:2F:71:3F:1F:24,3942668,689382253,181387,214968132,3761281,474414121,27,151847,173644457,151778,173635769,69,8688,145639,6,181384,19025,24,131,144444.0,43333.0,-74.0,-68.0,-70.0,-71.0,-73.0,-67.0,-70.0,-70.0,-90.0,-91.0,-88.0,-91.0,16.0,23.0,18.0,20.0,1
98,CC:2F:71:3E:C5:1F,3761362,474424027,80,9846,3761282,474414181,0,310,26806,251,19658,59,7148,87,2,107,4,0,5,144444.0,39000.0,-72.0,-71.0,-67.0,-60.0,-71.0,-70.0,-67.0,-60.0,-90.0,-91.0,-88.0,-91.0,18.0,20.0,21.0,31.0,1
99,BA:8C:B9:54:50:24,3761542,474496052,260,81871,3761282,474414181,0,1109,127177,1091,124331,18,2846,178,2,362,4,0,7,216660.0,130000.0,-40.0,-37.0,-46.0,-51.0,-44.0,-36.0,-44.0,-48.0,-90.0,-91.0,-88.0,-91.0,50.0,54.0,42.0,40.0,1
100,92:69:1D:31:68:E9,3774057,489666026,12775,15251845,3761282,474414181,3,19210,3551161,18516,3391539,694,159622,6440,105,14026,252,3,250,229410.0,130000.0,-52.0,-46.0,-42.0,-49.0,-52.0,-46.0,-42.0,-48.0,-90.0,-91.0,-88.0,-91.0,38.0,45.0,46.0,42.0,1
101,CC:2F:71:3F:1F:24,3942781,689501123,181493,215086336,3761288,474414787,27,151943,173762411,151874,173753723,69,8688,145728,6,181491,19057,24,131,130000.0,43333.0,-71.0,-67.0,-71.0,-72.0,-71.0,-66.0,-70.0,-72.0,-90.0,-91.0,-88.0,-91.0,19.0,24.0,17.0,19.0,1
102,CC:2F:71:3E:C5:1F,3761368,474424633,80,9846,3761288,474414787,0,310,26806,251,19658,59,7148,87,2,107,4,0,5,144444.0,39000.0,-72.0,-71.0,-67.0,-60.0,-71.0,-70.0,-67.0,-60.0,-90.0,-91.0,-88.0,-91.0,18.0,20.0,21.0,31.0,1
103,BA:8C:B9:54:50:24,3761548,474496658,260,81871,3761288,474414787,0,1109,127177,1091,124331,18,2846,178,2,362,4,0,7,216660.0,130000.0,-40.0,-37.0,-46.0,-51.0,-44.0,-36.0,-44.0,-48.0,-90.0,-91.0,-88.0,-91.0,50.0,54.0,42.0,40.0,1
104,92:69:1D:31:68:E9,3774063,489666632,12775,15251845,3761288,474414787,3,19210,3551161,18516,3391539,694,159622,6440,105,14026,252,3,250,229410.0,130000.0,-52.0,-46.0,-42.0,-49.0,-52.0,-46.0,-42.0,-48.0,-90.0,-91.0,-88.0,-91.0,38.0,45.0,46.0,42.0,1
105,CC:2F:71:3F:1F:24,3942890,689619690,181599,215204428,3761291,474415262,27,152043,173878109,151974,173869421,69,8688,145821,6,181597,19067,24,131,130000.0,43333.0,-72.0,-70.0,-73.0,-73.0,-71.0,-69.0,-72.0,-72.0,-90.0,-91.0,-88.0,-91.0,18.0,21.0,15.0,18.0,1
106,CC:2F:71:3E:C5:1F,3761371,474425108,80,9846,3761291,474415262,0,310,26806,251,19658,59,7148,87,2,107,4,0,5,144444.0,39000.0,-72.0,-71.0,-67.0,-60.0,-71.0,-70.0,-67.0,-60.0,-90.0,-91.0,-88.0,-91.0,18.0,20.0,21.0,31.0,1
107,BA:8C:B9:54:50:24,3761551,474497133,260,81871,3761291,474415262,0,1109,127177,1091,124331,18,2846,178,2,362,4,0,7,216660.0,130000.0,-40.0,-37.0,-46.0,-51.0,-44.0,-36.0,-44.0,-48.0,-90.0,-91.0,-88.0,-91.0,50.0,54.0,42.0,40.0,1
108,92:69:1D:31:68:E9,3774066,489667107,12775,15251845,3761291,474415262,3,19210,3551161,18516,3391539,694,159622,6440,105,14026,252,3,250,229410.0,130000.0,-52.0,-46.0,-42.0,-49.0,-52.0,-46.0,-42.0,-48.0,-90.0,-91.0,-88.0,-91.0,38.0,45.0,46.0,42.0,1
109,CC:2F:71:3F:1F:24,3943044,689798217,181746,215382289,3761298,474415928,27,152156,173995906,152087,173987218,69,8688,145925,6,181743,19170,24,131,115556.0,28889.0,-74.0,-71.0,-73.0,-74.0,-73.0,-70.0,-72.0,-73.0,-90.0,-91.0,-88.0,-91.0,16.0,20.0,15.0,17.0,1
110,CC:2F:71:3E:C5:1F,3761378,474425774,80,9846,3761298,474415928,0,310,26806,251,19658,59,7148,87,2,107,4,0,5,144444.0,39000.0,-72.0,-71.0,-67.0,-60.0,-71.0,-70.0,-67.0,-60.0,-90.0,-91.0,-88.0,-91.0,18.0,20.0,21.0,31.0,1
111,BA:8C:B9:54:50:24,3761558,474497799,260,81871,3761298,474415928,0,1109,127177,1091,124331,18,2846,178,2,362,4,0,7,216660.0,130000.0,-40.0,-37.0,-46.0,-51.0,-44.0,-36.0,-44.0,-48.0,-90.0,-91.0,-88.0,-91.0,50.0,54.0,42.0,40.0,1
112,92:69:1D:31:68:E9,3774073,489667773,12775,15251845,3761298,474415928,3,19210,3551161,18516,3391539,694,159622,6440,105,14026,252,3,250,229410.0,130000.0,-52.0,-46.0,-42.0,-49.0,-52.0,-46.0,-42.0,-48.0,-90.0,-91.0,-88.0,-91.0,38.0,45.0,46.0,42.0,1
113,CC:2F:71:3F:1F:24,3943158,689918598,181858,215502468,3761300,474416130,27,152263,174119942,152194,174111254,69,8688,146022,6,181856,19170,24,131,115556.0,28889.0,-74.0,-70.0,-73.0,-72.0,-72.0,-68.0,-71.0,-70.0,-90.0,-91.0,-88.0,-91.0,16.0,21.0,15.0,19.0,1
114,CC:2F:71:3E:C5:1F,3761380,474425976,80,9846,3761300,474416130,0,310,26806,251,19658,59,7148,87,2,107,4,0,5,144444.0,39000.0,-72.0,-71.0,-67.0,-60.0,-71.0,-70.0,-67.0,-60.0,-90.0,-91.0,-88.0,-91.0,18.0,20.0,21.0,31.0,1
115,BA:8C:B9:54:50:24,3761560,474498001,260,81871,3761300,474416130,0,1109,127177,1091,124331,18,2846,178,2,362,4,0,7,216660.0,130000.0,-40.0,-37.0,-46.0,-51.0,-44.0,-36.0,-44.0,-48.0,-90.0,-91.0,-88.0,-91.0,50.0,54.0,42.0,40.0,1
116,92:69:1D:31:68:E9,3774075,489667975,12775,15251845,3761300,474416130,3,19210,3551161,18516,3391539,694,159622,6440,105,14026,252,3,250,229410.0,130000.0,-52.0,-46.0,-42.0,-49.0,-52.0,-46.0,-42.0,-48.0,-90.0,-91.0,-88.0,-91.0,38.0,45.0,46.0,42.0,1
117,CC:2F:71:3F:1F:24,3943269,690037392,181965,215620858,3761304,474416534,27,152359,174233638,152290,174224950,69,8688,146114,6,181963,19172,24,131,115556.0,28889.0,-72.0,-70.0,-74.0,-73.0,-72.0,-69.0,-72.0,-72.0,-90.0,-91.0,-88.0,-91.0,18.0,21.0,14.0,18.0,1
118,CC:2F:71:3E:C5:1F,3761386,474426582,80,9846,3761306,474416736,0,310,26806,251,19658,59,7148,87,2,107,4,0,5,144444.0,39000.0,-72.0,-71.0,-67.0,-60.0,-71.0,-70.0,-67.0,-60.0,-90.0,-91.0,-88.0,-91.0,18.0,20.0,21.0,31.0,1
119,BA:8C:B9:54:50:24,3761566,474498607,260,81871,3761306,474416736,0,1109,127177,1091,124331,18,2846,178,2,362,4,0,7,216660.0,130000.0,-40.0,-37.0,-46.0,-51.0,-44.0,-36.0,-44.0,-48.0,-90.0,-91.0,-88.0,-91.0,50.0,54.0,42.0,40.0,1
120,92:69:1D:31:68:E9,3774081,489668581,12775,15251845,3761306,474416736,3,19210,3551161,18516,3391539,694,159622,6440,105,14026,252,3,250,229410.0,130000.0,-52.0,-46.0,-42.0,-49.0,-52.0,-46.0,-42.0,-48.0,-90.0,-91.0,-88.0,-91.0,38.0,45.0,46.0,42.0,1
121,CC:2F:71:3F:1F:24,3943383,690160386,182074,215743388,3761309,474416998,27,152458,174350570,152389,174341882,69,8688,146209,6,182072,19178,24,131,130000.0,43333.0,-72.0,-70.0,-75.0,-71.0,-71.0,-68.0,-74.0,-70.0,-90.0,-91.0,-88.0,-91.0,18.0,21.0,13.0,20.0,1
122,CC:2F:71:3E:C5:1F,3761389,474426844,80,9846,3761309,474416998,0,310,26806,251,19658,59,7148,87,2,107,4,0,5,144444.0,39000.0,-72.0,-71.0,-67.0,-60.0,-71.0,-70.0,-67.0,-60.0,-90.0,-91.0,-88.0,-91.0,18.0,20.0,21.0,31.0,1
123,BA:8C:B9:54:50:24,3761569,474498869,260,81871,3761309,474416998,0,1109,127177,1091,124331,18,2846,178,2,362,4,0,7,216660.0,130000.0,-40.0,-37.0,-46.0,-51.0,-44.0,-36.0,-44.0,-48.0,-90.0,-91.0,-88.0,-91.0,50.0,54.0,42.0,40.0,1
124,92:69:1D:31:68:E9,3774084,489668843,12775,15251845,3761309,474416998,3,19210,3551161,18516,3391539,694,159622,6440,105,14026,252,3,250,229410.0,130000.0,-52.0,-46.0,-42.0,-49.0,-52.0,-46.0,-42.0,-48.0,-90.0,-91.0,-88.0,-91.0,38.0,45.0,46.0,42.0,1
125,CC:2F:71:3F:1F:24,3943492,690278920,182179,215861518,3761313,474417402,27,152554,174462992,152485,174454304,69,8688,146300,6,182177,19179,24,131,130000.0,43333.0,-73.0,-71.0,-73.0,-73.0,-74.0,-70.0,-73.0,-73.0,-90.0,-91.0,-88.0,-91.0,17.0,20.0,15.0,18.0,1
126,CC:2F:71:3E:C5:1F,3761393,474427248,80,9846,3761313,474417402,0,310,26806,251,19658,59,7148,87,2,107,4,0,5,144444.0,39000.0,-72.0,-71.0,-67.0,-60.0,-71.0,-70.0,-67.0,-60.0,-90.0,-91.0,-88.0,-91.0,18.0,20.0,21.0,31.0,1
127,BA:8C:B9:54:50:24,3761575,474499475,260,81871,3761315,474417604,0,1109,127177,1091,124331,18,2846,178,2,362,4,0,7,216660.0,130000.0,-40.0,-37.0,-46.0,-51.0,-44.0,-36.0,-44.0,-48.0,-90.0,-91.0,-88.0,-91.0,50.0,54.0,42.0,40.0,1
128,92:69:1D:31:68:E9,3774090,489669449,12775,15251845,3761315,474417604,3,19210,3551161,18516,3391539,694,159622,6440,105,14026,252,3,250,229410.0,130000.0,-52.0,-46.0,-42.0,-49.0,-52.0,-46.0,-42.0,-48.0,-90.0,-91.0,-88.0,-91.0,38.0,45.0,46.0,42.0,1
129,CC:2F:71:3F:1F:24,3943607,690403538,182290,215985732,3761317,474417806,27,152658,174587758,152589,174579070,69,8688,146395,6,182288,19204,24,131,130000.0,39000.0,-70.0,-67.0,-72.0,-70.0,-69.0,-67.0,-72.0,-70.0,-90.0,-91.0,-88.0,-90.0,20.0,24.0,16.0,20.0,1
130,CC:2F:71:3E:C5:1F,3761398,474427712,80,9846,3761318,474417866,0,310,26806,251,19658,59,7148,87,2,107,4,0,5,144444.0,39000.0,-72.0,-71.0,-67.0,-60.0,-71.0,-70.0,-67.0,-60.0,-90.0,-91.0,-88.0,-90.0,18.0,20.0,21.0,30.0,1
131,BA:8C:B9:54:50:24,3761578,474499737,260,81871,3761318,474417866,0,1109,127177,1091,124331,18,2846,178,2,362,4,0,7,216660.0,130000.0,-40.0,-37.0,-46.0,-51.0,-44.0,-36.0,-44.0,-48.0,-90.0,-91.0,-88.0,-90.0,50.0,54.0,42.0,39.0,1
132,92:69:1D:31:68:E9,3774093,489669711,12775,15251845,3761318,474417866,3,19210,3551161,18516,3391539,694,159622,6440,105,14026,252,3,250,229410.0,130000.0,-52.0,-46.0,-42.0,-49.0,-52.0,-46.0,-42.0,-48.0,-90.0,-91.0,-88.0,-90.0,38.0,45.0,46.0,41.0,1
133,CC:2F:71:3F:1F:24,3943728,690527381,182406,216109111,3761322,474418270,27,152766,174704829,152697,174696141,69,8688,146497,6,182403,19239,24,131,117000.0,39000.0,-69.0,-66.0,-71.0,-68.0,-69.0,-66.0,-71.0,-68.0,-90.0,-91.0,-88.0,-90.0,21.0,25.0,17.0,22.0,1
134,CC:2F:71:3E:C5:1F,3761405,474428434,81,9962,3761324,474418472,0,312,26946,253,19798,59,7148,87,2,108,4,0,5,144444.0,39000.0,-69.0,-70.0,-67.0,-60.0,-71.0,-70.0,-66.0,-60.0,-89.0,-91.0,-88.0,-90.0,20.0,21.0,21.0,30.0,1
135,BA:8C:B9:54:50:24,3761585,474500459,261,81987,3761324,474418472,0,1113,127449,1095,124603,18,2846,178,2,363,4,0,7,216660.0,130000.0,-48.0,-35.0,-43.0,-45.0,-42.0,-35.0,-44.0,-48.0,-89.0,-91.0,-88.0,-90.0,41.0,56.0,45.0,45.0,1
136,92:69:1D:31:68:E9,3774100,489670433,12776,15251961,3761324,474418472,3,19212,3551297,18518,3391675,694,159622,6440,105,14027,252,3,250,229410.0,137640.0,-51.0,-47.0,-43.0,-49.0,-52.0,-46.0,-42.0,-48.0,-89.0,-91.0,-88.0,-90.0,38.0,44.0,45.0,41.0,1
137,CC:2F:71:3F:1F:24,3943845,690655515,182519,216236841,3761326,474418674,27,152869,174829261,152800,174820573,69,8688,146596,6,182517,19239,24,131,130000.0,43333.0,-70.0,-66.0,-71.0,-69.0,-69.0,-66.0,-71.0,-69.0,-89.0,-91.0,-88.0,-90.0,19.0,25.0,17.0,21.0,1
138,CC:2F:71:3E:C5:1F,3761407,474428636,81,9962,3761326,474418674,0,312,26946,253,19798,59,7148,87,2,108,4,0,5,144444.0,39000.0,-69.0,-70.0,-67.0,-60.0,-71.0,-70.0,-66.0,-60.0,-89.0,-91.0,-88.0,-90.0,20.0,21.0,21.0,30.0,1
139,BA:8C:B9:54:50:24,3761587,474500661,261,81987,3761326,474418674,0,1113,127449,1095,124603,18,2846,178,2,363,4,0,7,216660.0,130000.0,-48.0,-35.0,-43.0,-45.0,-42.0,-35.0,-44.0,-48.0,-89.0,-91.0,-88.0,-90.0,41.0,56.0,45.0,45.0,1
140,92:69:1D:31:68:E9,3774102,489670635,12776,15251961,3761326,474418674,3,19212,3551297,18518,3391675,694,159622,6440,105,14027,252,3,250,229410.0,137640.0,-51.0,-47.0,-43.0,-49.0,-52.0,-46.0,-42.0,-48.0,-89.0,-91.0,-88.0,-90.0,38.0,44.0,45.0,41.0,1
141,CC:2F:71:3F:1F:24,3943954,690773701,182625,216354765,3761329,474418936,27,152967,174943511,152898,174934823,69,8688,146687,6,182623,19262,24,131,130000.0,39000.0,-70.0,-66.0,-72.0,-68.0,-69.0,-65.0,-71.0,-67.0,-89.0,-90.0,-87.0,-90.0,19.0,24.0,15.0,22.0,1
142,CC:2F:71:3E:C5:1F,3761412,474429100,81,9962,3761331,474419138,0,312,26946,253,19798,59,7148,87,2,108,4,0,5,144444.0,39000.0,-69.0,-70.0,-67.0,-60.0,-71.0,-70.0,-66.0,-60.0,-89.0,-90.0,-87.0,-90.0,20.0,20.0,20.0,30.0,1
143,BA:8C:B9:54:50:24,3761594,474501327,261,81987,3761333,474419340,0,1113,127449,1095,124603,18,2846,178,2,363,4,0,7,216660.0,130000.0,-48.0,-35.0,-43.0,-45.0,-42.0,-35.0,-44.0,-48.0,-89.0,-90.0,-87.0,-90.0,41.0,55.0,44.0,45.0,1
144,92:69:1D:31:68:E9,3774109,489671301,12776,15251961,3761333,474419340,3,19212,3551297,18518,3391675,694,159622,6440,105,14027,252,3,250,229410.0,137640.0,-51.0,-47.0,-43.0,-49.0,-52.0,-46.0,-42.0,-48.0,-89.0,-90.0,-87.0,-90.0,38.0,43.0,44.0,41.0,1
145,CC:2F:71:3F:1F:24,3944071,690895925,182736,216476383,3761335,474419542,27,153067,175057627,152998,175048939,69,8688,146783,6,182734,19283,24,131,115556.0,28889.0,-73.0,-70.0,-74.0,-71.0,-73.0,-70.0,-74.0,-71.0,-89.0,-90.0,-87.0,-90.0,16.0,20.0,13.0,19.0,1
146,CC:2F:71:3E:C5:1F,3761416,474429504,81,9962,3761335,474419542,0,312,26946,253,19798,59,7148,87,2,108,4,0,5,144444.0,39000.0,-69.0,-70.0,-67.0,-60.0,-71.0,-70.0,-66.0,-60.0,-89.0,-90.0,-87.0,-90.0,20.0,20.0,20.0,30.0,1
147,BA:8C:B9:54:50:24,3761596,474501529,261,81987,3761335,474419542,0,1113,127449,1095,124603,18,2846,178,2,363,4,0,7,216660.0,130000.0,-48.0,-35.0,-43.0,-45.0,-42.0,-35.0,-44.0,-48.0,-89.0,-90.0,-87.0,-90.0,41.0,55.0,44.0,45.0,1
148,92:69:1D:31:68:E9,3774111,489671503,12776,15251961,3761335,474419542,3,19212,3551297,18518,3391675,694,159622,6440,105,14027,252,3,250,229410.0,137640.0,-51.0,-47.0,-43.0,-49.0,-52.0,-46.0,-42.0,-48.0,-89.0,-90.0,-87.0,-90.0,38.0,43.0,44.0,41.0,1
149,CC:2F:71:3F:1F:24,3944186,691016368,182848,216596562,3761338,474419806,27,153171,175174140,153101,175165334,70,8806,146881,6,182846,19283,24,131,115556.0,28889.0,-72.0,-70.0,-75.0,-71.0,-72.0,-69.0,-74.0,-71.0,-89.0,-90.0,-87.0,-90.0,17.0,20.0,12.0,19.0,1
150,CC:2F:71:3E:C5:1F,3761421,474429970,81,9962,3761340,474420008,0,312,26946,253,19798,59,7148,87,2,108,4,0,5,144444.0,39000.0,-69.0,-70.0,-67.0,-60.0,-71.0,-70.0,-66.0,-60.0,-89.0,-90.0,-87.0,-89.0,20.0,20.0,20.0,29.0,1
151,BA:8C:B9:54:50:24,3761602,474502129,261,81987,3761341,474420142,0,1113,127449,1095,124603,18,2846,178,2,363,4,0,7,216660.0,130000.0,-48.0,-35.0,-43.0,-45.0,-42.0,-35.0,-44.0,-48.0,-89.0,-90.0,-87.0,-89.0,41.0,55.0,44.0,44.0,1
152,92:69:1D:31:68:E9,3774117,489672103,12776,15251961,3761341,474420142,3,19212,3551297,18518,3391675,694,159622,6440,105,14027,252,3,250,229410.0,137640.0,-51.0,-47.0,-43.0,-49.0,-52.0,-46.0,-42.0,-48.0,-89.0,-90.0,-87.0,-89.0,38.0,43.0,44.0,40.0,1
153,CC:2F:71:3F:1F:24,3944302,691136656,182956,216716058,3761346,474420598,27,153273,175297104,153203,175288298,70,8806,146973,6,182954,19294,24,131,117000.0,39000.0,-70.0,-67.0,-72.0,-69.0,-69.0,-66.0,-71.0,-68.0,-89.0,-90.0,-87.0,-89.0,19.0,23.0,15.0,20.0,1
154,CC:2F:71:3E:C5:1F,3761427,474430560,81,9962,3761346,474420598,0,312,26946,253,19798,59,7148,87,2,108,4,0,5,144444.0,39000.0,-69.0,-70.0,-67.0,-60.0,-71.0,-70.0,-66.0,-60.0,-89.0,-90.0,-87.0,-89.0,20.0,20.0,20.0,29.0,1
155,BA:8C:B9:54:50:24,3761607,474502585,261,81987,3761346,474420598,0,1113,127449,1095,124603,18,2846,178,2,363,4,0,7,216660.0,130000.0,-48.0,-35.0,-43.0,-45.0,-42.0,-35.0,-44.0,-48.0,-89.0,-90.0,-87.0,-89.0,41.0,55.0,44.0,44.0,1
156,92:69:1D:31:68:E9,3774122,489672559,12776,15251961,3761346,474420598,3,19212,3551297,18518,3391675,694,159622,6440,105,14027,252,3,250,229410.0,137640.0,-51.0,-47.0,-43.0,-49.0,-52.0,-46.0,-42.0,-48.0,-89.0,-90.0,-87.0,-89.0,38.0,43.0,44.0,40.0,1
157,CC:2F:71:3F:1F:24,3944413,691259491,183064,216838418,3761349,474421073,27,153371,175413822,153301,175405016,70,8806,147068,6,183062,19345,24,131,117000.0,39000.0,-73.0,-70.0,-74.0,-71.0,-73.0,-69.0,-73.0,-70.0,-89.0,-90.0,-87.0,-89.0,16.0,20.0,13.0,18.0,1
158,CC:2F:71:3E:C5:1F,3761432,474431237,81,9962,3761351,474421275,0,312,26946,253,19798,59,7148,87,2,108,4,0,5,144444.0,39000.0,-69.0,-70.0,-67.0,-60.0,-71.0,-70.0,-66.0,-60.0,-89.0,-90.0,-87.0,-89.0,20.0,20.0,20.0,29.0,1
159,BA:8C:B9:54:50:24,3761612,474503262,261,81987,3761351,474421275,0,1113,127449,1095,124603,18,2846,178,2,363,4,0,7,216660.0,130000.0,-48.0,-35.0,-43.0,-45.0,-42.0,-35.0,-44.0,-48.0,-89.0,-90.0,-87.0,-89.0,41.0,55.0,44.0,44.0,1
160,92:69:1D:31:68:E9,3774127,489673236,12776,15251961,3761351,474421275,3,19212,3551297,18518,3391675,694,159622,6440,105,14027,252,3,250,229410.0,137640.0,-51.0,-47.0,-43.0,-49.0,-52.0,-46.0,-42.0,-48.0,-89.0,-90.0,-87.0,-89.0,38.0,43.0,44.0,40.0,1
161,CC:2F:71:3F:1F:24,3944526,691379505,183170,216957766,3761356,474421739,27,153470,175531000,153400,175522194,70,8806,147160,6,183168,19379,24,131,115556.0,26000.0,-69.0,-66.0,-71.0,-68.0,-69.0,-65.0,-70.0,-67.0,-89.0,-91.0,-87.0,-90.0,20.0,25.0,16.0,22.0,1
162,CC:2F:71:3E:C5:1F,3761437,474431701,81,9962,3761356,474421739,0,312,26946,253,19798,59,7148,87,2,108,4,0,5,144444.0,39000.0,-69.0,-70.0,-67.0,-60.0,-71.0,-70.0,-66.0,-60.0,-89.0,-91.0,-87.0,-90.0,20.0,21.0,20.0,30.0,1
163,BA:8C:B9:54:50:24,3761617,474503726,261,81987,3761356,474421739,0,1113,127449,1095,124603,18,2846,178,2,363,4,0,7,216660.0,130000.0,-48.0,-35.0,-43.0,-45.0,-42.0,-35.0,-44.0,-48.0,-89.0,-91.0,-87.0,-90.0,41.0,56.0,44.0,45.0,1
164,92:69:1D:31:68:E9,3774132,489673700,12776,15251961,3761356,474421739,3,19212,3551297,18518,3391675,694,159622,6440,105,14027,252,3,250,229410.0,137640.0,-51.0,-47.0,-43.0,-49.0,-52.0,-46.0,-42.0,-48.0,-89.0,-91.0,-87.0,-90.0,38.0,44.0,44.0,41.0,1
165,CC:2F:71:3F:1F:24,3944642,691502882,183284,217080941,3761358,474421941,27,153575,175649066,153505,175640260,70,8806,147258,6,183281,19379,24,131,115556.0,28889.0,-70.0,-67.0,-71.0,-68.0,-70.0,-66.0,-71.0,-68.0,-89.0,-91.0,-87.0,-90.0,19.0,24.0,16.0,22.0,1
166,CC:2F:71:3E:C5:1F,3761439,474431903,81,9962,3761358,474421941,0,312,26946,253,19798,59,7148,87,2,108,4,0,5,144444.0,39000.0,-69.0,-70.0,-67.0,-60.0,-71.0,-70.0,-66.0,-60.0,-89.0,-91.0,-87.0,-90.0,20.0,21.0,20.0,30.0,1
167,BA:8C:B9:54:50:24,3761619,474503928,261,81987,3761358,474421941,0,1113,127449,1095,124603,18,2846,178,2,363,4,0,7,216660.0,130000.0,-48.0,-35.0,-43.0,-45.0,-42.0,-35.0,-44.0,-48.0,-89.0,-91.0,-87.0,-90.0,41.0,56.0,44.0,45.0,1
168,92:69:1D:31:68:E9,3774136,489674104,12776,15251961,3761360,474422143,3,19212,3551297,18518,3391675,694,159622,6440,105,14027,252,3,250,229410.0,137640.0,-51.0,-47.0,-43.0,-49.0,-52.0,-46.0,-42.0,-48.0,-89.0,-91.0,-87.0,-90.0,38.0,44.0,44.0,41.0,1
169,CC:2F:71:3F:1F:24,3944754,691621356,183390,217198809,3761364,474422547,27,153671,175762990,153601,175754184,70,8806,147348,6,183388,19388,24,131,115556.0,28889.0,-70.0,-66.0,-71.0,-68.0,-71.0,-67.0,-72.0,-69.0,-89.0,-91.0,-87.0,-90.0,19.0,25.0,16.0,22.0,1
170,CC:2F:71:3E:C5:1F,3761445,474432509,81,9962,3761364,474422547,0,312,26946,253,19798,59,7148,87,2,108,4,0,5,144444.0,39000.0,-69.0,-70.0,-67.0,-60.0,-71.0,-70.0,-66.0,-60.0,-89.0,-91.0,-87.0,-90.0,20.0,21.0,20.0,30.0,1
171,BA:8C:B9:54:50:24,3761625,474504534,261,81987,3761364,474422547,0,1113,127449,1095,124603,18,2846,178,2,363,4,0,7,216660.0,130000.0,-48.0,-35.0,-43.0,-45.0,-42.0,-35.0,-44.0,-48.0,-89.0,-91.0,-87.0,-90.0,41.0,56.0,44.0,45.0,1
172,92:69:1D:31:68:E9,3774140,489674508,12776,15251961,3761364,474422547,3,19212,3551297,18518,3391675,694,159622,6440,105,14027,252,3,250,229410.0,137640.0,-51.0,-47.0,-43.0,-49.0,-52.0,-46.0,-42.0,-48.0,-89.0,-91.0,-87.0,-90.0,38.0,44.0,44.0,41.0,1
173,CC:2F:71:3F:1F:24,3944862,691741234,183496,217318493,3761366,474422741,27,153766,175876576,153696,175867770,70,8806,147438,6,183494,19388,24,131,115556.0,28889.0,-70.0,-66.0,-71.0,-68.0,-70.0,-66.0,-70.0,-67.0,-90.0,-92.0,-88.0,-91.0,20.0,26.0,17.0,23.0,1
174,CC:2F:71:3E:C5:1F,3761447,474432703,81,9962,3761366,474422741,0,312,26946,253,19798,59,7148,87,2,108,4,0,5,144444.0,39000.0,-69.0,-70.0,-67.0,-60.0,-71.0,-70.0,-66.0,-60.0,-90.0,-92.0,-88.0,-91.0,21.0,22.0,21.0,31.0,1
175,BA:8C:B9:54:50:24,3761628,474504796,261,81987,3761367,474422809,0,1113,127449,1095,124603,18,2846,178,2,363,4,0,7,216660.0,130000.0,-48.0,-35.0,-43.0,-45.0,-42.0,-35.0,-44.0,-48.0,-90.0,-92.0,-88.0,-91.0,42.0,57.0,45.0,46.0,1
176,92:69:1D:31:68:E9,3774143,489674770,12776,15251961,3761367,474422809,3,19212,3551297,18518,3391675,694,159622,6440,105,14027,252,3,250,229410.0,137640.0,-51.0,-47.0,-43.0,-49.0,-52.0,-46.0,-42.0,-48.0,-90.0,-92.0,-88.0,-91.0,39.0,45.0,45.0,42.0,1
177,CC:2F:71:3F:1F:24,3944987,691865655,183602,217436641,3761385,474429014,27,153863,175990502,153793,175981696,70,8806,147530,6,183599,19388,24,131,130000.0,39000.0,-70.0,-66.0,-71.0,-68.0,-70.0,-66.0,-71.0,-68.0,-90.0,-92.0,-88.0,-91.0,20.0,26.0,17.0,23.0,1
178,CC:2F:71:3E:C5:1F,3761466,474438976,81,9962,3761385,474429014,0,312,26946,253,19798,59,7148,87,2,108,4,0,5,144444.0,39000.0,-69.0,-70.0,-67.0,-60.0,-71.0,-70.0,-66.0,-60.0,-90.0,-92.0,-88.0,-91.0,21.0,22.0,21.0,31.0,1
179,BA:8C:B9:54:50:24,3761657,474516425,261,81987,3761396,474434438,0,1113,127449,1095,124603,18,2846,178,2,363,4,0,7,216660.0,130000.0,-48.0,-35.0,-43.0,-45.0,-42.0,-35.0,-44.0,-48.0,-90.0,-92.0,-88.0,-91.0,42.0,57.0,45.0,46.0,1
180,92:69:1D:31:68:E9,3774172,489686399,12776,15251961,3761396,474434438,3,19216,3551736,18521,3391879,695,159857,6441,105,14027,252,3,250,229410.0,137640.0,-51.0,-48.0,-42.0,-48.0,-51.0,-48.0,-43.0,-48.0,-90.0,-92.0,-88.0,-91.0,39.0,44.0,46.0,43.0,1
181,CC:2F:71:3F:1F:24,3945124,692006882,183726,217572242,3761398,474434640,27,153975,176119601,153905,176110795,70,8806,147636,6,183724,19399,24,131,130000.0,43333.0,-70.0,-66.0,-71.0,-68.0,-70.0,-66.0,-71.0,-68.0,-90.0,-92.0,-88.0,-91.0,20.0,26.0,17.0,23.0,1
182,CC:2F:71:3E:C5:1F,3761479,474444602,81,9962,3761398,474434640,0,313,27016,254,19868,59,7148,87,2,109,4,0,5,144444.0,39000.0,-69.0,-70.0,-66.0,-60.0,-70.0,-70.0,-66.0,-60.0,-90.0,-92.0,-88.0,-91.0,21.0,22.0,22.0,31.0,1
183,BA:8C:B9:54:50:24,3761659,474516627,261,81987,3761398,474434640,0,1115,127585,1097,124739,18,2846,178,2,364,4,0,7,216660.0,130000.0,-48.0,-35.0,-43.0,-45.0,-43.0,-35.0,-44.0,-47.0,-90.0,-92.0,-88.0,-91.0,42.0,57.0,45.0,46.0,1
184,92:69:1D:31:68:E9,3774175,489686661,12776,15251961,3761399,474434700,3,19216,3551736,18521,3391879,695,159857,6441,105,14027,252,3,250,229410.0,137640.0,-51.0,-48.0,-42.0,-48.0,-51.0,-48.0,-43.0,-48.0,-90.0,-92.0,-88.0,-91.0,39.0,44.0,46.0,43.0,1
185,CC:2F:71:3F:1F:24,3945240,692126238,183832,217690502,3761408,474435736,27,154071,176231893,154001,176223087,70,8806,147726,6,183830,19399,24,131,130000.0,43333.0,-69.0,-66.0,-70.0,-68.0,-69.0,-66.0,-70.0,-68.0,-90.0,-92.0,-88.0,-91.0,21.0,26.0,18.0,23.0,1
186,CC:2F:71:3E:C5:1F,3761489,474445698,81,9962,3761408,474435736,0,316,27274,256,20008,60,7266,88,2,109,4,0,5,144444.0,39000.0,-69.0,-70.0,-66.0,-60.0,-69.0,-70.0,-66.0,-60.0,-90.0,-92.0,-88.0,-91.0,21.0,22.0,22.0,31.0,1
187,BA:8C:B9:54:50:24,3761669,474517723,261,81987,3761408,474435736,0,1115,127585,1097,124739,18,2846,178,2,364,4,0,7,216660.0,130000.0,-48.0,-35.0,-43.0,-45.0,-43.0,-35.0,-44.0,-47.0,-90.0,-92.0,-88.0,-91.0,42.0,57.0,45.0,46.0,1
188,92:69:1D:31:68:E9,3774184,489687697,12776,15251961,3761408,474435736,3,19216,3551736,18521,3391879,695,159857,6441,105,14027,252,3,250,229410.0,137640.0,-51.0,-48.0,-42.0,-48.0,-51.0,-48.0,-43.0,-48.0,-90.0,-92.0,-88.0,-91.0,39.0,44.0,46.0,43.0,1
189,CC:2F:71:3F:1F:24,3945345,692242552,183937,217806816,3761408,474435736,27,154167,176345817,154097,176337011,70,8806,147816,6,183935,19410,24,131,130000.0,39000.0,-69.0,-66.0,-70.0,-67.0,-69.0,-66.0,-70.0,-67.0,-90.0,-92.0,-88.0,-91.0,21.0,26.0,18.0,24.0,1
190,CC:2F:71:3E:C5:1F,3761491,474445900,81,9962,3761410,474435938,0,316,27274,256,20008,60,7266,88,2,109,4,0,5,144444.0,39000.0,-69.0,-70.0,-66.0,-60.0,-69.0,-70.0,-66.0,-60.0,-90.0,-92.0,-88.0,-91.0,21.0,22.0,22.0,31.0,1
191,BA:8C:B9:54:50:24,3761671,474517925,261,81987,3761410,474435938,0,1115,127585,1097,124739,18,2846,178,2,364,4,0,7,216660.0,130000.0,-48.0,-35.0,-43.0,-45.0,-43.0,-35.0,-44.0,-47.0,-90.0,-92.0,-88.0,-91.0,42.0,57.0,45.0,46.0,1
192,92:69:1D:31:68:E9,3774186,489687899,12776,15251961,3761410,474435938,3,19216,3551736,18521,3391879,695,159857,6441,105,14027,252,3,250,229410.0,137640.0,-51.0,-48.0,-42.0,-48.0,-51.0,-48.0,-43.0,-48.0,-90.0,-92.0,-88.0,-91.0,39.0,44.0,46.0,43.0,1
193,CC:2F:71:3F:1F:24,3945466,692369244,184049,217932640,3761417,474436604,27,154267,176465693,154197,176456887,70,8806,147912,6,184047,19436,24,131,115556.0,28889.0,-69.0,-66.0,-70.0,-67.0,-69.0,-65.0,-70.0,-67.0,-90.0,-92.0,-88.0,-91.0,21.0,26.0,18.0,24.0,1
194,CC:2F:71:3E:C5:1F,3761498,474446566,81,9962,3761417,474436604,0,316,27274,256,20008,60,7266,88,2,109,4,0,5,144444.0,39000.0,-69.0,-70.0,-66.0,-60.0,-69.0,-70.0,-66.0,-60.0,-90.0,-92.0,-88.0,-91.0,21.0,22.0,22.0,31.0,1
195,BA:8C:B9:54:50:24,3761678,474518591,261,81987,3761417,474436604,0,1115,127585,1097,124739,18,2846,178,2,364,4,0,7,216660.0,130000.0,-48.0,-35.0,-43.0,-45.0,-43.0,-35.0,-44.0,-47.0,-90.0,-92.0,-88.0,-91.0,42.0,57.0,45.0,46.0,1
196,92:69:1D:31:68:E9,3774193,489688565,12776,15251961,3761417,474436604,3,19216,3551736,18521,3391879,695,159857,6441,105,14027,252,3,250,229410.0,137640.0,-51.0,-48.0,-42.0,-48.0,-51.0,-48.0,-43.0,-48.0,-90.0,-92.0,-88.0,-91.0,39.0,44.0,46.0,43.0,1
197,CC:2F:71:3F:1F:24,3945581,692492549,184164,218055945,3761417,474436604,27,154372,176583772,154302,176574966,70,8806,148011,6,184161,19444,24,132,104000.0,26000.0,-69.0,-65.0,-70.0,-67.0,-69.0,-65.0,-70.0,-67.0,-90.0,-92.0,-88.0,-91.0,21.0,27.0,18.0,24.0,1
198,CC:2F:71:3E:C5:1F,3761498,474446566,81,9962,3761417,474436604,0,316,27274,256,20008,60,7266,88,2,109,4,0,5,144444.0,39000.0,-69.0,-70.0,-66.0,-60.0,-69.0,-70.0,-66.0,-60.0,-90.0,-92.0,-88.0,-91.0,21.0,22.0,22.0,31.0,1
199,BA:8C:B9:54:50:24,3761680,474518793,261,81987,3761419,474436806,0,1115,127585,1097,124739,18,2846,178,2,364,4,0,7,216660.0,130000.0,-48.0,-35.0,-43.0,-45.0,-43.0,-35.0,-44.0,-47.0,-90.0,-92.0,-88.0,-91.0,42.0,57.0,45.0,46.0,1
200,92:69:1D:31:68:E9,3774195,489688767,12776,15251961,3761419,474436806,3,19216,3551736,18521,3391879,695,159857,6441,105,14027,252,3,250,229410.0,137640.0,-51.0,-48.0,-42.0,-48.0,-51.0,-48.0,-43.0,-48.0,-90.0,-92.0,-88.0,-91.0,39.0,44.0,46.0,43.0,1
201,CC:2F:71:3F:1F:24,3945696,692611635,184271,218174223,3761425,474437412,27,154464,176695496,154394,176686690,70,8806,148101,6,184269,19444,24,132,115556.0,28889.0,-69.0,-65.0,-70.0,-68.0,-69.0,-65.0,-70.0,-67.0,-90.0,-92.0,-88.0,-91.0,21.0,27.0,18.0,23.0,1
202,CC:2F:71:3E:C5:1F,3761506,474447374,81,9962,3761425,474437412,0,316,27274,256,20008,60,7266,88,2,109,4,0,5,144444.0,39000.0,-69.0,-70.0,-66.0,-60.0,-69.0,-70.0,-66.0,-60.0,-90.0,-92.0,-88.0,-91.0,21.0,22.0,22.0,31.0,1
203,BA:8C:B9:54:50:24,3761686,474519399,261,81987,3761425,474437412,0,1115,127585,1097,124739,18,2846,178,2,364,4,0,7,216660.0,130000.0,-48.0,-35.0,-43.0,-45.0,-43.0,-35.0,-44.0,-47.0,-90.0,-92.0,-88.0,-91.0,42.0,57.0,45.0,46.0,1
204,92:69:1D:31:68:E9,3774201,489689373,12776,15251961,3761425,474437412,3,19216,3551736,18521,3391879,695,159857,6441,105,14027,252,3,250,229410.0,137640.0,-51.0,-48.0,-42.0,-48.0,-51.0,-48.0,-43.0,-48.0,-90.0,-92.0,-88.0,-91.0,39.0,44.0,46.0,43.0,1
205,CC:2F:71:3F:1F:24,3945804,692730085,184378,218292613,3761426,474437472,27,154560,176809466,154490,176800660,70,8806,148190,6,184376,19444,24,132,115556.0,28889.0,-69.0,-65.0,-70.0,-68.0,-69.0,-65.0,-70.0,-68.0,-90.0,-92.0,-88.0,-91.0,21.0,27.0,18.0,23.0,1
206,CC:2F:71:3E:C5:1F,3761507,474447434,81,9962,3761426,474437472,0,316,27274,256,20008,60,7266,88,2,109,4,0,5,144444.0,39000.0,-69.0,-70.0,-66.0,-60.0,-69.0,-70.0,-66.0,-60.0,-90.0,-92.0,-88.0,-91.0,21.0,22.0,22.0,31.0,1
207,BA:8C:B9:54:50:24,3761689,474519661,261,81987,3761428,474437674,0,1115,127585,1097,124739,18,2846,178,2,364,4,0,7,216660.0,130000.0,-48.0,-35.0,-43.0,-45.0,-43.0,-35.0,-44.0,-47.0,-90.0,-92.0,-88.0,-91.0,42.0,57.0,45.0,46.0,1
208,92:69:1D:31:68:E9,3774204,489689635,12776,15251961,3761428,474437674,3,19216,3551736,18521,3391879,695,159857,6441,105,14027,252,3,250,229410.0,137640.0,-51.0,-48.0,-42.0,-48.0,-51.0,-48.0,-43.0,-48.0,-90.0,-92.0,-88.0,-91.0,39.0,44.0,46.0,43.0,1
209,CC:2F:71:3F:1F:24,3945920,692849388,184485,218410835,3761435,474438553,27,154661,176925484,154591,176916678,70,8806,148282,6,184483,19444,24,132,130000.0,39000.0,-69.0,-66.0,-70.0,-68.0,-69.0,-65.0,-70.0,-68.0,-90.0,-92.0,-88.0,-91.0,21.0,26.0,18.0,23.0,1
210,CC:2F:71:3E:C5:1F,3761516,474448515,81,9962,3761435,474438553,0,316,27274,256,20008,60,7266,88,2,109,4,0,5,144444.0,39000.0,-69.0,-70.0,-66.0,-60.0,-69.0,-70.0,-66.0,-60.0,-90.0,-92.0,-88.0,-91.0,21.0,22.0,22.0,31.0,1
211,BA:8C:B9:54:50:24,3761696,474520540,261,81987,3761435,474438553,0,1115,127585,1097,124739,18,2846,178,2,364,4,0,7,216660.0,130000.0,-48.0,-35.0,-43.0,-45.0,-43.0,-35.0,-44.0,-47.0,-90.0,-92.0,-88.0,-91.0,42.0,57.0,45.0,46.0,1
212,92:69:1D:31:68:E9,3774211,489690514,12776,15251961,3761435,474438553,3,19216,3551736,18521,3391879,695,159857,6441,105,14027,252,3,250,229410.0,137640.0,-51.0,-48.0,-42.0,-48.0,-51.0,-48.0,-43.0,-48.0,-90.0,-92.0,-88.0,-91.0,39.0,44.0,46.0,43.0,1
213,CC:2F:71:3F:1F:24,3946036,692974701,184601,218536148,3761435,474438553,27,154769,177043965,154699,177035159,70,8806,148385,6,184599,19456,24,132,130000.0,43333.0,-69.0,-66.0,-70.0,-68.0,-69.0,-65.0,-70.0,-68.0,-90.0,-92.0,-88.0,-91.0,21.0,26.0,18.0,23.0,1
214,CC:2F:71:3E:C5:1F,3761516,474448515,81,9962,3761435,474438553,0,316,27274,256,20008,60,7266,88,2,109,4,0,5,144444.0,39000.0,-69.0,-70.0,-66.0,-60.0,-69.0,-70.0,-66.0,-60.0,-90.0,-92.0,-88.0,-91.0,21.0,22.0,22.0,31.0,1
215,BA:8C:B9:54:50:24,3761696,474520540,261,81987,3761435,474438553,0,1115,127585,1097,124739,18,2846,178,2,364,4,0,7,216660.0,130000.0,-48.0,-35.0,-43.0,-45.0,-43.0,-35.0,-44.0,-47.0,-90.0,-92.0,-88.0,-91.0,42.0,57.0,45.0,46.0,1
216,92:69:1D:31:68:E9,3774212,489690574,12776,15251961,3761436,474438613,3,19216,3551736,18521,3391879,695,159857,6441,105,14027,252,3,250,229410.0,137640.0,-51.0,-48.0,-42.0,-48.0,-51.0,-48.0,-43.0,-48.0,-90.0,-92.0,-88.0,-91.0,39.0,44.0,46.0,43.0,1
217,CC:2F:71:3F:1F:24,3946152,693093959,184708,218654538,3761444,474439421,27,154867,177160713,154797,177151907,70,8806,148477,6,184706,19458,24,132,130000.0,43333.0,-70.0,-67.0,-71.0,-69.0,-70.0,-66.0,-71.0,-69.0,-90.0,-92.0,-88.0,-91.0,20.0,25.0,17.0,22.0,1
218,CC:2F:71:3E:C5:1F,3761525,474449383,81,9962,3761444,474439421,0,316,27274,256,20008,60,7266,88,2,109,4,0,5,144444.0,39000.0,-69.0,-70.0,-66.0,-60.0,-69.0,-70.0,-66.0,-60.0,-90.0,-92.0,-88.0,-91.0,21.0,22.0,22.0,31.0,1
219,BA:8C:B9:54:50:24,3761705,474521408,261,81987,3761444,474439421,0,1115,127585,1097,124739,18,2846,178,2,364,4,0,7,216660.0,130000.0,-48.0,-35.0,-43.0,-45.0,-43.0,-35.0,-44.0,-47.0,-90.0,-92.0,-88.0,-91.0,42.0,57.0,45.0,46.0,1
220,92:69:1D:31:68:E9,3774220,489691382,12776,15251961,3761444,474439421,3,19216,3551736,18521,3391879,695,159857,6441,105,14027,252,3,250,229410.0,137640.0,-51.0,-48.0,-42.0,-48.0,-51.0,-48.0,-43.0,-48.0,-90.0,-92.0,-88.0,-91.0,39.0,44.0,46.0,43.0,1
221,CC:2F:71:3F:1F:24,3946259,693212125,184815,218772704,3761444,474439421,27,154959,177271013,154889,177262207,70,8806,148567,6,184813,19464,24,132,130000.0,43333.0,-69.0,-65.0,-70.0,-68.0,-71.0,-67.0,-72.0,-70.0,-90.0,-92.0,-88.0,-91.0,21.0,27.0,18.0,23.0,1
222,CC:2F:71:3E:C5:1F,3761525,474449383,81,9962,3761444,474439421,0,316,27274,256,20008,60,7266,88,2,109,4,0,5,144444.0,39000.0,-69.0,-70.0,-66.0,-60.0,-69.0,-70.0,-66.0,-60.0,-90.0,-92.0,-88.0,-91.0,21.0,22.0,22.0,31.0,1
223,BA:8C:B9:54:50:24,3761705,474521408,261,81987,3761444,474439421,0,1115,127585,1097,124739,18,2846,178,2,364,4,0,7,216660.0,130000.0,-48.0,-35.0,-43.0,-45.0,-43.0,-35.0,-44.0,-47.0,-90.0,-92.0,-88.0,-91.0,42.0,57.0,45.0,46.0,1
224,92:69:1D:31:68:E9,3774220,489691382,12776,15251961,3761444,474439421,3,19216,3551736,18521,3391879,695,159857,6441,105,14027,252,3,250,229410.0,137640.0,-51.0,-48.0,-42.0,-48.0,-51.0,-48.0,-43.0,-48.0,-90.0,-92.0,-88.0,-91.0,39.0,44.0,46.0,43.0,1
225,CC:2F:71:3F:1F:24,3946376,693332937,184923,218892648,3761453,474440289,27,155060,177391033,154990,177382227,70,8806,148660,6,184921,19465,24,132,130000.0,43333.0,-69.0,-66.0,-70.0,-68.0,-69.0,-66.0,-70.0,-68.0,-90.0,-92.0,-88.0,-91.0,21.0,26.0,18.0,23.0,1
226,CC:2F:71:3E:C5:1F,3761534,474450251,81,9962,3761453,474440289,0,316,27274,256,20008,60,7266,88,2,109,4,0,5,144444.0,39000.0,-69.0,-70.0,-66.0,-60.0,-69.0,-70.0,-66.0,-60.0,-90.0,-92.0,-88.0,-91.0,21.0,22.0,22.0,31.0,1
227,BA:8C:B9:54:50:24,3761714,474522276,261,81987,3761453,474440289,0,1115,127585,1097,124739,18,2846,178,2,364,4,0,7,216660.0,130000.0,-48.0,-35.0,-43.0,-45.0,-43.0,-35.0,-44.0,-47.0,-90.0,-92.0,-88.0,-91.0,42.0,57.0,45.0,46.0,1
228,92:69:1D:31:68:E9,3774229,489692250,12776,15251961,3761453,474440289,3,19216,3551736,18521,3391879,695,159857,6441,105,14027,252,3,250,229410.0,137640.0,-51.0,-48.0,-42.0,-48.0,-51.0,-48.0,-43.0,-48.0,-90.0,-92.0,-88.0,-91.0,39.0,44.0,46.0,43.0,1
229,CC:2F:71:3F:1F:24,3946489,693454612,185036,219014323,3761453,474440289,27,155160,177504356,155090,177495550,70,8806,148755,6,185034,19469,24,132,130000.0,39000.0,-70.0,-66.0,-70.0,-69.0,-69.0,-66.0,-70.0,-68.0,-90.0,-92.0,-88.0,-91.0,20.0,26.0,18.0,22.0,1
230,CC:2F:71:3E:C5:1F,3761534,474450251,81,9962,3761453,474440289,0,316,27274,256,20008,60,7266,88,2,109,4,0,5,144444.0,39000.0,-69.0,-70.0,-66.0,-60.0,-69.0,-70.0,-66.0,-60.0,-90.0,-92.0,-88.0,-91.0,21.0,22.0,22.0,31.0,1
231,BA:8C:B9:54:50:24,3761714,474522276,261,81987,3761453,474440289,0,1115,127585,1097,124739,18,2846,178,2,364,4,0,7,216660.0,130000.0,-48.0,-35.0,-43.0,-45.0,-43.0,-35.0,-44.0,-47.0,-90.0,-92.0,-88.0,-91.0,42.0,57.0,45.0,46.0,1
232,92:69:1D:31:68:E9,3774229,489692250,12776,15251961,3761453,474440289,3,19216,3551736,18521,3391879,695,159857,6441,105,14027,252,3,250,229410.0,137640.0,-51.0,-48.0,-42.0,-48.0,-51.0,-48.0,-43.0,-48.0,-90.0,-92.0,-88.0,-91.0,39.0,44.0,46.0,43.0,1
233,CC:2F:71:3F:1F:24,3946604,693573642,185143,219132545,3761461,474441097,27,155258,177619742,155188,177610936,70,8806,148846,6,185141,19480,24,132,130000.0,43333.0,-69.0,-66.0,-71.0,-68.0,-69.0,-66.0,-70.0,-68.0,-90.0,-92.0,-88.0,-91.0,21.0,26.0,17.0,23.0,1
234,CC:2F:71:3E:C5:1F,3761542,474451059,81,9962,3761461,474441097,0,316,27274,256,20008,60,7266,88,2,109,4,0,5,144444.0,39000.0,-69.0,-70.0,-66.0,-60.0,-69.0,-70.0,-66.0,-60.0,-90.0,-92.0,-88.0,-91.0,21.0,22.0,22.0,31.0,1
235,BA:8C:B9:54:50:24,3761722,474523084,261,81987,3761461,474441097,0,1115,127585,1097,124739,18,2846,178,2,364,4,0,7,216660.0,130000.0,-48.0,-35.0,-43.0,-45.0,-43.0,-35.0,-44.0,-47.0,-90.0,-92.0,-88.0,-91.0,42.0,57.0,45.0,46.0,1
236,92:69:1D:31:68:E9,3774237,489693058,12776,15251961,3761461,474441097,3,19216,3551736,18521,3391879,695,159857,6441,105,14027,252,3,250,229410.0,137640.0,-51.0,-48.0,-42.0,-48.0,-51.0,-48.0,-43.0,-48.0,-90.0,-92.0,-88.0,-91.0,39.0,44.0,46.0,43.0,1
237,CC:2F:71:3F:1F:24,3946713,693693646,185251,219252489,3761462,474441157,27,155355,177729340,155285,177720534,70,8806,148940,6,185249,19482,24,132,130000.0,43333.0,-69.0,-66.0,-71.0,-68.0,-69.0,-66.0,-70.0,-68.0,-90.0,-93.0,-89.0,-92.0,21.0,27.0,18.0,24.0,1
238,CC:2F:71:3E:C5:1F,3761543,474451119,81,9962,3761462,474441157,0,316,27274,256,20008,60,7266,88,2,109,4,0,5,144444.0,39000.0,-69.0,-70.0,-66.0,-60.0,-69.0,-70.0,-66.0,-60.0,-90.0,-93.0,-89.0,-92.0,21.0,23.0,23.0,32.0,1
239,BA:8C:B9:54:50:24,3761723,474523144,261,81987,3761462,474441157,0,1115,127585,1097,124739,18,2846,178,2,364,4,0,7,216660.0,130000.0,-48.0,-35.0,-43.0,-45.0,-43.0,-35.0,-44.0,-47.0,-90.0,-93.0,-89.0,-92.0,42.0,58.0,46.0,47.0,1
240,92:69:1D:31:68:E9,3774238,489693118,12776,15251961,3761462,474441157,3,19216,3551736,18521,3391879,695,159857,6441,105,14027,252,3,250,229410.0,137640.0,-51.0,-48.0,-42.0,-48.0,-51.0,-48.0,-43.0,-48.0,-90.0,-93.0,-89.0,-92.0,39.0,45.0,47.0,44.0,1
241,CC:2F:71:3F:1F:24,3946829,693812808,185359,219370843,3761470,474441965,27,155450,177841568,155380,177832762,70,8806,149031,6,185357,19487,24,132,130000.0,43333.0,-69.0,-66.0,-70.0,-68.0,-69.0,-66.0,-70.0,-68.0,-90.0,-93.0,-89.0,-92.0,21.0,27.0,19.0,24.0,1
242,CC:2F:71:3E:C5:1F,3761552,474452043,82,10078,3761470,474441965,0,318,27414,258,20148,60,7266,88,2,110,4,0,5,144444.0,39000.0,-69.0,-70.0,-66.0,-60.0,-69.0,-70.0,-66.0,-60.0,-90.0,-93.0,-89.0,-92.0,21.0,23.0,23.0,32.0,1
243,BA:8C:B9:54:50:24,3761732,474524068,262,82103,3761470,474441965,0,1121,127993,1103,125147,18,2846,178,2,365,4,0,7,216660.0,130000.0,-40.0,-37.0,-46.0,-51.0,-42.0,-35.0,-43.0,-47.0,-90.0,-93.0,-89.0,-92.0,50.0,56.0,43.0,41.0,1
244,92:69:1D:31:68:E9,3774247,489693986,12777,15252021,3761470,474441965,3,19218,3551872,18523,3392015,695,159857,6441,105,14028,252,3,250,216660.0,130000.0,-51.0,-48.0,-43.0,-48.0,-51.0,-49.0,-43.0,-48.0,-90.0,-93.0,-89.0,-92.0,39.0,45.0,46.0,44.0,1
245,CC:2F:71:3F:1F:24,3946946,693936505,185476,219494540,3761470,474441965,27,155561,177961836,155491,177953030,70,8806,149134,6,185474,19488,24,132,130000.0,43333.0,-69.0,-66.0,-71.0,-68.0,-69.0,-65.0,-70.0,-68.0,-90.0,-93.0,-89.0,-92.0,21.0,27.0,18.0,24.0,1
246,CC:2F:71:3E:C5:1F,3761552,474452043,82,10078,3761470,474441965,0,318,27414,258,20148,60,7266,88,2,110,4,0,5,144444.0,39000.0,-69.0,-70.0,-66.0,-60.0,-69.0,-70.0,-66.0,-60.0,-90.0,-93.0,-89.0,-92.0,21.0,23.0,23.0,32.0,1
247,BA:8C:B9:54:50:24,3761732,474524068,262,82103,3761470,474441965,0,1122,128061,1104,125215,18,2846,178,2,365,4,0,7,216660.0,130000.0,-40.0,-37.0,-45.0,-51.0,-41.0,-35.0,-43.0,-47.0,-90.0,-93.0,-89.0,-92.0,50.0,56.0,44.0,41.0,1
248,92:69:1D:31:68:E9,3774247,489693986,12777,15252021,3761470,474441965,3,19218,3551872,18523,3392015,695,159857,6441,105,14028,252,3,250,216660.0,130000.0,-51.0,-48.0,-43.0,-48.0,-51.0,-49.0,-43.0,-48.0,-90.0,-93.0,-89.0,-92.0,39.0,45.0,46.0,44.0,1
249,CC:2F:71:3F:1F:24,3947063,694057333,185584,219614500,3761479,474442833,27,155664,178080868,155594,178072062,70,8806,149227,6,185582,19488,24,132,130000.0,43333.0,-69.0,-66.0,-70.0,-68.0,-69.0,-65.0,-70.0,-68.0,-90.0,-93.0,-89.0,-92.0,21.0,27.0,19.0,24.0,1
250,CC:2F:71:3E:C5:1F,3761561,474452911,82,10078,3761479,474442833,0,318,27414,258,20148,60,7266,88,2,110,4,0,5,144444.0,39000.0,-69.0,-70.0,-66.0,-60.0,-69.0,-70.0,-66.0,-60.0,-90.0,-93.0,-89.0,-92.0,21.0,23.0,23.0,32.0,1
251,BA:8C:B9:54:50:24,3761741,474524936,262,82103,3761479,474442833,0,1122,128061,1104,125215,18,2846,178,2,365,4,0,7,216660.0,130000.0,-40.0,-37.0,-45.0,-51.0,-41.0,-35.0,-43.0,-47.0,-90.0,-93.0,-89.0,-92.0,50.0,56.0,44.0,41.0,1
252,92:69:1D:31:68:E9,3774256,489694854,12777,15252021,3761479,474442833,3,19218,3551872,18523,3392015,695,159857,6441,105,14028,252,3,250,216660.0,130000.0,-51.0,-48.0,-43.0,-48.0,-51.0,-49.0,-43.0,-48.0,-90.0,-93.0,-89.0,-92.0,39.0,45.0,46.0,44.0,1
253,CC:2F:71:3F:1F:24,3947172,694178455,185693,219735622,3761479,474442833,27,155763,178200594,155693,178191788,70,8806,149319,6,185691,19498,24,132,130000.0,39000.0,-68.0,-66.0,-70.0,-69.0,-68.0,-65.0,-70.0,-68.0,-90.0,-93.0,-89.0,-92.0,22.0,27.0,19.0,23.0,1
254,CC:2F:71:3E:C5:1F,3761561,474452911,82,10078,3761479,474442833,0,318,27414,258,20148,60,7266,88,2,110,4,0,5,144444.0,39000.0,-69.0,-70.0,-66.0,-60.0,-69.0,-70.0,-66.0,-60.0,-90.0,-93.0,-89.0,-92.0,21.0,23.0,23.0,32.0,1
255,BA:8C:B9:54:50:24,3761741,474524936,262,82103,3761479,474442833,0,1122,128061,1104,125215,18,2846,178,2,365,4,0,7,216660.0,130000.0,-40.0,-37.0,-45.0,-51.0,-41.0,-35.0,-43.0,-47.0,-90.0,-93.0,-89.0,-92.0,50.0,56.0,44.0,41.0,1
256,92:69:1D:31:68:E9,3774256,489694854,12777,15252021,3761479,474442833,3,19218,3551872,18523,3392015,695,159857,6441,105,14028,252,3,250,216660.0,130000.0,-51.0,-48.0,-43.0,-48.0,-51.0,-49.0,-43.0,-48.0,-90.0,-93.0,-89.0,-92.0,39.0,45.0,46.0,44.0,1
257,CC:2F:71:3F:1F:24,3947288,694297329,185802,219853830,3761486,474443499,27,155858,178315588,155788,178306782,70,8806,149410,6,185800,19538,24,132,115556.0,26000.0,-69.0,-66.0,-70.0,-68.0,-68.0,-65.0,-70.0,-68.0,-90.0,-93.0,-89.0,-92.0,21.0,27.0,19.0,24.0,1
258,CC:2F:71:3E:C5:1F,3761569,474453639,82,10078,3761487,474443561,0,318,27414,258,20148,60,7266,88,2,110,4,0,5,144444.0,39000.0,-69.0,-70.0,-66.0,-60.0,-69.0,-70.0,-66.0,-60.0,-90.0,-93.0,-89.0,-92.0,21.0,23.0,23.0,32.0,1
259,BA:8C:B9:54:50:24,3761751,474525866,262,82103,3761489,474443763,0,1122,128061,1104,125215,18,2846,178,2,365,4,0,7,216660.0,130000.0,-40.0,-37.0,-45.0,-51.0,-41.0,-35.0,-43.0,-47.0,-90.0,-93.0,-89.0,-92.0,50.0,56.0,44.0,41.0,1
260,92:69:1D:31:68:E9,3774266,489695784,12777,15252021,3761489,474443763,3,19218,3551872,18523,3392015,695,159857,6441,105,14028,252,3,250,216660.0,130000.0,-51.0,-48.0,-43.0,-48.0,-51.0,-49.0,-43.0,-48.0,-90.0,-93.0,-89.0,-92.0,39.0,45.0,46.0,44.0,1
261,CC:2F:71:3F:1F:24,3947407,694422468,185918,219978705,3761489,474443763,27,155967,178434384,155896,178425460,71,8924,149512,6,185916,19539,24,132,104000.0,26000.0,-69.0,-66.0,-70.0,-68.0,-68.0,-65.0,-69.0,-68.0,-90.0,-93.0,-89.0,-92.0,21.0,27.0,19.0,24.0,1
262,CC:2F:71:3E:C5:1F,3761571,474453841,82,10078,3761489,474443763,0,318,27414,258,20148,60,7266,88,2,110,4,0,5,144444.0,39000.0,-69.0,-70.0,-66.0,-60.0,-69.0,-70.0,-66.0,-60.0,-90.0,-93.0,-89.0,-92.0,21.0,23.0,23.0,32.0,1
263,BA:8C:B9:54:50:24,3761752,474526139,262,82103,3761490,474444036,0,1122,128061,1104,125215,18,2846,178,2,365,4,0,7,216660.0,130000.0,-40.0,-37.0,-45.0,-51.0,-41.0,-35.0,-43.0,-47.0,-90.0,-93.0,-89.0,-92.0,50.0,56.0,44.0,41.0,1
264,92:69:1D:31:68:E9,3774267,489696057,12777,15252021,3761490,474444036,3,19218,3551872,18523,3392015,695,159857,6441,105,14028,252,3,250,216660.0,130000.0,-51.0,-48.0,-43.0,-48.0,-51.0,-49.0,-43.0,-48.0,-90.0,-93.0,-89.0,-92.0,39.0,45.0,46.0,44.0,1
265,CC:2F:71:3F:1F:24,3947524,694545855,186028,220101213,3761496,474444642,27,156066,178551348,155995,178542424,71,8924,149607,6,186026,19548,24,132,130000.0,39000.0,-69.0,-65.0,-70.0,-68.0,-68.0,-65.0,-69.0,-68.0,-90.0,-93.0,-89.0,-92.0,21.0,28.0,19.0,24.0,1
266,CC:2F:71:3E:C5:1F,3761580,474454922,82,10078,3761498,474444844,0,318,27414,258,20148,60,7266,88,2,110,4,0,5,144444.0,39000.0,-69.0,-70.0,-66.0,-60.0,-69.0,-70.0,-66.0,-60.0,-90.0,-93.0,-89.0,-92.0,21.0,23.0,23.0,32.0,1
267,BA:8C:B9:54:50:24,3761760,474526947,262,82103,3761498,474444844,0,1122,128061,1104,125215,18,2846,178,2,365,4,0,7,216660.0,130000.0,-40.0,-37.0,-45.0,-51.0,-41.0,-35.0,-43.0,-47.0,-90.0,-93.0,-89.0,-92.0,50.0,56.0,44.0,41.0,1
268,92:69:1D:31:68:E9,3774275,489696865,12777,15252021,3761498,474444844,3,19218,3551872,18523,3392015,695,159857,6441,105,14028,252,3,250,216660.0,130000.0,-51.0,-48.0,-43.0,-48.0,-51.0,-49.0,-43.0,-48.0,-90.0,-93.0,-89.0,-92.0,39.0,45.0,46.0,44.0,1
269,CC:2F:71:3F:1F:24,3947635,694665853,186136,220220949,3761499,474444904,27,156162,178666554,156091,178657630,71,8924,149698,6,186134,19557,24,132,130000.0,43333.0,-69.0,-65.0,-70.0,-68.0,-68.0,-65.0,-70.0,-68.0,-90.0,-93.0,-89.0,-92.0,21.0,28.0,19.0,24.0,1
270,CC:2F:71:3E:C5:1F,3761581,474454982,82,10078,3761499,474444904,0,318,27414,258,20148,60,7266,88,2,110,4,0,5,144444.0,39000.0,-69.0,-70.0,-66.0,-60.0,-69.0,-70.0,-66.0,-60.0,-90.0,-93.0,-89.0,-92.0,21.0,23.0,23.0,32.0,1
271,BA:8C:B9:54:50:24,3761761,474527007,262,82103,3761499,474444904,0,1122,128061,1104,125215,18,2846,178,2,365,4,0,7,216660.0,130000.0,-40.0,-37.0,-45.0,-51.0,-41.0,-35.0,-43.0,-47.0,-90.0,-93.0,-89.0,-92.0,50.0,56.0,44.0,41.0,1
272,92:69:1D:31:68:E9,3774276,489696925,12777,15252021,3761499,474444904,3,19218,3551872,18523,3392015,695,159857,6441,105,14028,252,3,250,216660.0,130000.0,-51.0,-48.0,-43.0,-48.0,-51.0,-49.0,-43.0,-48.0,-90.0,-93.0,-89.0,-92.0,39.0,45.0,46.0,44.0,1
273,CC:2F:71:3F:1F:24,3947747,694783087,186242,220337577,3761505,474445510,27,156260,178783288,156189,178774364,71,8924,149791,6,186240,19566,24,132,130000.0,43333.0,-69.0,-65.0,-70.0,-68.0,-68.0,-65.0,-70.0,-68.0,-90.0,-93.0,-89.0,-92.0,21.0,28.0,19.0,24.0,1
274,CC:2F:71:3E:C5:1F,3761587,474455588,82,10078,3761505,474445510,0,318,27414,258,20148,60,7266,88,2,110,4,0,5,144444.0,39000.0,-69.0,-70.0,-66.0,-60.0,-69.0,-70.0,-66.0,-60.0,-90.0,-93.0,-89.0,-92.0,21.0,23.0,23.0,32.0,1
275,BA:8C:B9:54:50:24,3761769,474527815,262,82103,3761507,474445712,0,1122,128061,1104,125215,18,2846,178,2,365,4,0,7,216660.0,130000.0,-40.0,-37.0,-45.0,-51.0,-41.0,-35.0,-43.0,-47.0,-90.0,-93.0,-89.0,-92.0,50.0,56.0,44.0,41.0,1
276,92:69:1D:31:68:E9,3774284,489697733,12777,15252021,3761507,474445712,3,19218,3551872,18523,3392015,695,159857,6441,105,14028,252,3,250,216660.0,130000.0,-51.0,-48.0,-43.0,-48.0,-51.0,-49.0,-43.0,-48.0,-90.0,-93.0,-89.0,-92.0,39.0,45.0,46.0,44.0,1
277,CC:2F:71:3F:1F:24,3947866,694909604,186359,220463892,3761507,474445712,27,156364,178899861,156293,178890937,71,8924,149888,6,186357,19579,24,132,130000.0,43333.0,-69.0,-66.0,-70.0,-68.0,-68.0,-65.0,-70.0,-68.0,-90.0,-93.0,-89.0,-92.0,21.0,27.0,19.0,24.0,1
278,CC:2F:71:3E:C5:1F,3761589,474455790,82,10078,3761507,474445712,0,318,27414,258,20148,60,7266,88,2,110,4,0,5,144444.0,39000.0,-69.0,-70.0,-66.0,-60.0,-69.0,-70.0,-66.0,-60.0,-90.0,-93.0,-89.0,-92.0,21.0,23.0,23.0,32.0,1
279,BA:8C:B9:54:50:24,3761770,474527875,262,82103,3761508,474445772,0,1122,128061,1104,125215,18,2846,178,2,365,4,0,7,216660.0,130000.0,-40.0,-37.0,-45.0,-51.0,-41.0,-35.0,-43.0,-47.0,-90.0,-93.0,-89.0,-92.0,50.0,56.0,44.0,41.0,1
280,92:69:1D:31:68:E9,3774285,489697793,12777,15252021,3761508,474445772,3,19218,3551872,18523,3392015,695,159857,6441,105,14028,252,3,250,216660.0,130000.0,-51.0,-48.0,-43.0,-48.0,-51.0,-49.0,-43.0,-48.0,-90.0,-93.0,-89.0,-92.0,39.0,45.0,46.0,44.0,1
281,CC:2F:71:3F:1F:24,3947990,695042920,186476,220596542,3761514,474446378,27,156470,179026155,156399,179017231,71,8924,149989,6,186474,19584,24,132,130000.0,43333.0,-69.0,-65.0,-70.0,-68.0,-68.0,-65.0,-70.0,-68.0,-90.0,-93.0,-89.0,-92.0,21.0,28.0,19.0,24.0,1
282,CC:2F:71:3E:C5:1F,3761598,474456658,82,10078,3761516,474446580,0,318,27414,258,20148,60,7266,88,2,110,4,0,5,144444.0,39000.0,-69.0,-70.0,-66.0,-60.0,-69.0,-70.0,-66.0,-60.0,-90.0,-93.0,-89.0,-92.0,21.0,23.0,23.0,32.0,1
283,BA:8C:B9:54:50:24,3761778,474528683,262,82103,3761516,474446580,0,1122,128061,1104,125215,18,2846,178,2,365,4,0,7,216660.0,130000.0,-40.0,-37.0,-45.0,-51.0,-41.0,-35.0,-43.0,-47.0,-90.0,-93.0,-89.0,-92.0,50.0,56.0,44.0,41.0,1
284,92:69:1D:31:68:E9,3774293,489698601,12777,15252021,3761516,474446580,3,19218,3551872,18523,3392015,695,159857,6441,105,14028,252,3,250,216660.0,130000.0,-51.0,-48.0,-43.0,-48.0,-51.0,-49.0,-43.0,-48.0,-90.0,-93.0,-89.0,-92.0,39.0,45.0,46.0,44.0,1
285,CC:2F:71:3F:1F:24,3948100,695161198,186583,220714556,3761517,474446642,27,156563,179138009,156492,179129085,71,8924,150079,6,186581,19610,24,132,130000.0,39000.0,-69.0,-66.0,-70.0,-68.0,-68.0,-65.0,-70.0,-68.0,-90.0,-93.0,-89.0,-92.0,21.0,27.0,19.0,24.0,1
286,CC:2F:71:3E:C5:1F,3761599,474456720,82,10078,3761517,474446642,0,320,27602,259,20218,61,7384,89,2,110,4,0,5,144444.0,39000.0,-69.0,-70.0,-66.0,-60.0,-69.0,-70.0,-66.0,-60.0,-90.0,-93.0,-89.0,-92.0,21.0,23.0,23.0,32.0,1
287,BA:8C:B9:54:50:24,3761779,474528745,262,82103,3761517,474446642,0,1122,128061,1104,125215,18,2846,178,2,365,4,0,7,216660.0,130000.0,-40.0,-37.0,-45.0,-51.0,-41.0,-35.0,-43.0,-47.0,-90.0,-93.0,-89.0,-92.0,50.0,56.0,44.0,41.0,1
288,92:69:1D:31:68:E9,3774294,489698663,12777,15252021,3761517,474446642,3,19218,3551872,18523,3392015,695,159857,6441,105,14028,252,3,250,216660.0,130000.0,-51.0,-48.0,-43.0,-48.0,-51.0,-49.0,-43.0,-48.0,-90.0,-93.0,-89.0,-92.0,39.0,45.0,46.0,44.0,1
289,CC:2F:71:3F:1F:24,3948215,695281656,186691,220834348,3761524,474447308,27,156660,179253535,156589,179244611,71,8924,150169,6,186689,19651,24,132,117000.0,39000.0,-68.0,-66.0,-70.0,-68.0,-68.0,-66.0,-70.0,-68.0,-90.0,-93.0,-89.0,-92.0,22.0,27.0,19.0,24.0,1
290,CC:2F:71:3E:C5:1F,3761606,474457386,82,10078,3761524,474447308,0,320,27602,259,20218,61,7384,89,2,110,4,0,5,144444.0,39000.0,-69.0,-70.0,-66.0,-60.0,-69.0,-70.0,-66.0,-60.0,-90.0,-93.0,-89.0,-92.0,21.0,23.0,23.0,32.0,1
291,BA:8C:B9:54:50:24,3761786,474529411,262,82103,3761524,474447308,0,1124,128197,1106,125351,18,2846,178,2,366,4,0,7,216660.0,130000.0,-48.0,-35.0,-43.0,-45.0,-41.0,-35.0,-43.0,-47.0,-90.0,-93.0,-89.0,-92.0,42.0,58.0,46.0,47.0,1
292,92:69:1D:31:68:E9,3774303,489699531,12777,15252021,3761526,474447510,3,19220,3552008,18525,3392151,695,159857,6441,105,14029,252,3,250,216660.0,130000.0,-52.0,-50.0,-43.0,-47.0,-51.0,-49.0,-43.0,-48.0,-90.0,-93.0,-89.0,-92.0,38.0,43.0,46.0,45.0,1
293,CC:2F:71:3F:1F:24,3948333,695406675,186807,220959165,3761526,474447510,27,156770,179371167,156699,179362243,71,8924,150271,6,186805,19655,24,132,115556.0,28889.0,-69.0,-66.0,-70.0,-68.0,-69.0,-66.0,-70.0,-68.0,-90.0,-93.0,-89.0,-92.0,21.0,27.0,19.0,24.0,1
294,CC:2F:71:3E:C5:1F,3761608,474457588,82,10078,3761526,474447510,0,320,27602,259,20218,61,7384,89,2,110,4,0,5,144444.0,39000.0,-69.0,-70.0,-66.0,-60.0,-69.0,-70.0,-66.0,-60.0,-90.0,-93.0,-89.0,-92.0,21.0,23.0,23.0,32.0,1
295,BA:8C:B9:54:50:24,3761788,474529613,262,82103,3761526,474447510,0,1124,128197,1106,125351,18,2846,178,2,366,4,0,7,216660.0,130000.0,-48.0,-35.0,-43.0,-45.0,-41.0,-35.0,-43.0,-47.0,-90.0,-93.0,-89.0,-92.0,42.0,58.0,46.0,47.0,1
296,92:69:1D:31:68:E9,3774303,489699531,12777,15252021,3761526,474447510,3,19220,3552008,18525,3392151,695,159857,6441,105,14029,252,3,250,216660.0,130000.0,-52.0,-50.0,-43.0,-47.0,-51.0,-49.0,-43.0,-48.0,-90.0,-93.0,-89.0,-92.0,38.0,43.0,46.0,45.0,1
297,CC:2F:71:3F:1F:24,3948446,695525687,186914,221077571,3761532,474448116,27,156867,179486389,156796,179477465,71,8924,150361,6,186912,19656,24,132,115556.0,28889.0,-69.0,-66.0,-71.0,-68.0,-68.0,-66.0,-70.0,-68.0,-90.0,-93.0,-89.0,-92.0,21.0,27.0,18.0,24.0,1
298,CC:2F:71:3E:C5:1F,3761614,474458194,82,10078,3761532,474448116,0,320,27602,259,20218,61,7384,89,2,110,4,0,5,144444.0,39000.0,-69.0,-70.0,-66.0,-60.0,-69.0,-70.0,-66.0,-60.0,-90.0,-93.0,-89.0,-92.0,21.0,23.0,23.0,32.0,1
299,BA:8C:B9:54:50:24,3761794,474530219,262,82103,3761532,474448116,0,1124,128197,1106,125351,18,2846,178,2,366,4,0,7,216660.0,130000.0,-48.0,-35.0,-43.0,-45.0,-41.0,-35.0,-43.0,-47.0,-90.0,-93.0,-89.0,-92.0,42.0,58.0,46.0,47.0,1
300,92:69:1D:31:68:E9,3774311,489700339,12777,15252021,3761534,474448318,3,19220,3552008,18525,3392151,695,159857,6441,105,14029,252,3,250,216660.0,130000.0,-52.0,-50.0,-43.0,-47.0,-51.0,-49.0,-43.0,-48.0,-90.0,-93.0,-89.0,-92.0,38.0,43.0,46.0,45.0,1
301,CC:2F:71:3F:1F:24,3948557,695645517,187022,221197139,3761535,474448378,27,156964,179598845,156893,179589921,71,8924,150452,6,187020,19667,24,132,130000.0,43333.0,-69.0,-66.0,-70.0,-68.0,-69.0,-66.0,-70.0,-68.0,-90.0,-93.0,-89.0,-92.0,21.0,27.0,19.0,24.0,1
302,CC:2F:71:3E:C5:1F,3761617,474458456,82,10078,3761535,474448378,0,320,27602,259,20218,61,7384,89,2,110,4,0,5,144444.0,39000.0,-69.0,-70.0,-66.0,-60.0,-69.0,-70.0,-66.0,-60.0,-90.0,-93.0,-89.0,-92.0,21.0,23.0,23.0,32.0,1
303,BA:8C:B9:54:50:24,3761797,474530481,262,82103,3761535,474448378,0,1124,128197,1106,125351,18,2846,178,2,366,4,0,7,216660.0,130000.0,-48.0,-35.0,-43.0,-45.0,-41.0,-35.0,-43.0,-47.0,-90.0,-93.0,-89.0,-92.0,42.0,58.0,46.0,47.0,1
304,92:69:1D:31:68:E9,3774312,489700399,12777,15252021,3761535,474448378,3,19220,3552008,18525,3392151,695,159857,6441,105,14029,252,3,250,216660.0,130000.0,-52.0,-50.0,-43.0,-47.0,-51.0,-49.0,-43.0,-48.0,-90.0,-93.0,-89.0,-92.0,38.0,43.0,46.0,45.0,1
305,CC:2F:71:3F:1F:24,3948671,695765859,187130,221316875,3761541,474448984,27,157058,179712239,156987,179703315,71,8924,150543,6,187128,19687,24,132,130000.0,43333.0,-69.0,-66.0,-70.0,-68.0,-69.0,-66.0,-70.0,-68.0,-90.0,-93.0,-89.0,-92.0,21.0,27.0,19.0,24.0,1
306,CC:2F:71:3E:C5:1F,3761623,474459062,82,10078,3761541,474448984,0,320,27602,259,20218,61,7384,89,2,110,4,0,5,144444.0,39000.0,-69.0,-70.0,-66.0,-60.0,-69.0,-70.0,-66.0,-60.0,-90.0,-93.0,-89.0,-92.0,21.0,23.0,23.0,32.0,1
307,BA:8C:B9:54:50:24,3761803,474531087,262,82103,3761541,474448984,0,1124,128197,1106,125351,18,2846,178,2,366,4,0,7,216660.0,130000.0,-48.0,-35.0,-43.0,-45.0,-41.0,-35.0,-43.0,-47.0,-90.0,-93.0,-89.0,-92.0,42.0,58.0,46.0,47.0,1
308,92:69:1D:31:68:E9,3774318,489701005,12777,15252021,3761541,474448984,3,19220,3552008,18525,3392151,695,159857,6441,105,14029,252,3,250,216660.0,130000.0,-52.0,-50.0,-43.0,-47.0,-51.0,-49.0,-43.0,-48.0,-90.0,-93.0,-89.0,-92.0,38.0,43.0,46.0,45.0,1
309,CC:2F:71:3F:1F:24,3948789,695889398,187246,221440212,3761543,474449186,27,157160,179823033,157089,179814109,71,8924,150642,6,187243,19718,24,133,130000.0,43333.0,-69.0,-66.0,-71.0,-68.0,-68.0,-66.0,-70.0,-68.0,-90.0,-92.0,-89.0,-92.0,21.0,26.0,18.0,24.0,1
310,CC:2F:71:3E:C5:1F,3761626,474459324,82,10078,3761544,474449246,0,320,27602,259,20218,61,7384,89,2,110,4,0,5,144444.0,39000.0,-69.0,-70.0,-66.0,-60.0,-69.0,-70.0,-66.0,-60.0,-90.0,-92.0,-89.0,-92.0,21.0,22.0,23.0,32.0,1
311,BA:8C:B9:54:50:24,3761806,474531349,262,82103,3761544,474449246,0,1124,128197,1106,125351,18,2846,178,2,366,4,0,7,216660.0,130000.0,-48.0,-35.0,-43.0,-45.0,-41.0,-35.0,-43.0,-47.0,-90.0,-92.0,-89.0,-92.0,42.0,57.0,46.0,47.0,1
312,92:69:1D:31:68:E9,3774321,489701267,12777,15252021,3761544,474449246,3,19220,3552008,18525,3392151,695,159857,6441,105,14029,252,3,250,216660.0,130000.0,-52.0,-50.0,-43.0,-47.0,-51.0,-49.0,-43.0,-48.0,-90.0,-92.0,-89.0,-92.0,38.0,42.0,46.0,45.0,1
313,CC:2F:71:3F:1F:24,3948904,696010024,187354,221560172,3761550,474449852,27,157254,179935083,157183,179926159,71,8924,150733,6,187352,19737,24,133,130000.0,43333.0,-69.0,-66.0,-71.0,-68.0,-69.0,-66.0,-70.0,-68.0,-90.0,-92.0,-89.0,-92.0,21.0,26.0,18.0,24.0,1
314,CC:2F:71:3E:C5:1F,3761632,474459930,82,10078,3761550,474449852,0,320,27602,259,20218,61,7384,89,2,110,4,0,5,144444.0,39000.0,-69.0,-70.0,-66.0,-60.0,-69.0,-70.0,-66.0,-60.0,-90.0,-92.0,-89.0,-92.0,21.0,22.0,23.0,32.0,1
315,BA:8C:B9:54:50:24,3761812,474531955,262,82103,3761550,474449852,0,1124,128197,1106,125351,18,2846,178,2,366,4,0,7,216660.0,130000.0,-48.0,-35.0,-43.0,-45.0,-41.0,-35.0,-43.0,-47.0,-90.0,-92.0,-89.0,-92.0,42.0,57.0,46.0,47.0,1
316,92:69:1D:31:68:E9,3774327,489701873,12777,15252021,3761550,474449852,3,19220,3552008,18525,3392151,695,159857,6441,105,14029,252,3,250,216660.0,130000.0,-52.0,-50.0,-43.0,-47.0,-51.0,-49.0,-43.0,-48.0,-90.0,-92.0,-89.0,-92.0,38.0,42.0,46.0,45.0,1
317,CC:2F:71:3F:1F:24,3949015,696130235,187462,221679908,3761553,474450327,27,157349,180050045,157278,180041121,71,8924,150823,6,187460,19759,24,133,130000.0,43333.0,-69.0,-66.0,-70.0,-68.0,-68.0,-66.0,-70.0,-68.0,-90.0,-92.0,-89.0,-92.0,21.0,26.0,19.0,24.0,1
318,CC:2F:71:3E:C5:1F,3761635,474460405,82,10078,3761553,474450327,0,320,27602,259,20218,61,7384,89,2,110,4,0,5,144444.0,39000.0,-69.0,-70.0,-66.0,-60.0,-69.0,-70.0,-66.0,-60.0,-90.0,-92.0,-89.0,-92.0,21.0,22.0,23.0,32.0,1
319,BA:8C:B9:54:50:24,3761815,474532430,262,82103,3761553,474450327,0,1124,128197,1106,125351,18,2846,178,2,366,4,0,7,216660.0,130000.0,-48.0,-35.0,-43.0,-45.0,-41.0,-35.0,-43.0,-47.0,-90.0,-92.0,-89.0,-92.0,42.0,57.0,46.0,47.0,1
320,92:69:1D:31:68:E9,3774330,489702348,12777,15252021,3761553,474450327,3,19220,3552008,18525,3392151,695,159857,6441,105,14029,252,3,250,216660.0,130000.0,-52.0,-50.0,-43.0,-47.0,-51.0,-49.0,-43.0,-48.0,-90.0,-92.0,-89.0,-92.0,38.0,42.0,46.0,45.0,1
321,CC:2F:71:3F:1F:24,3949128,696250659,187570,221799868,3761558,474450791,27,157441,180160345,157370,180151421,71,8924,150913,6,187567,19775,24,133,130000.0,43333.0,-69.0,-66.0,-71.0,-68.0,-69.0,-66.0,-70.0,-68.0,-90.0,-92.0,-89.0,-92.0,21.0,26.0,18.0,24.0,1
322,CC:2F:71:3E:C5:1F,3761642,474461071,82,10078,3761560,474450993,0,320,27602,259,20218,61,7384,89,2,110,4,0,5,144444.0,39000.0,-69.0,-70.0,-66.0,-60.0,-69.0,-70.0,-66.0,-60.0,-90.0,-92.0,-89.0,-92.0,21.0,22.0,23.0,32.0,1
323,BA:8C:B9:54:50:24,3761822,474533096,262,82103,3761560,474450993,0,1127,128401,1109,125555,18,2846,178,2,366,4,0,7,216660.0,130000.0,-40.0,-37.0,-45.0,-51.0,-42.0,-36.0,-44.0,-49.0,-90.0,-92.0,-89.0,-92.0,50.0,55.0,44.0,41.0,1
324,92:69:1D:31:68:E9,3774337,489703014,12777,15252021,3761560,474450993,3,19220,3552008,18525,3392151,695,159857,6441,105,14029,252,3,250,216660.0,130000.0,-52.0,-50.0,-43.0,-47.0,-51.0,-49.0,-43.0,-48.0,-90.0,-92.0,-89.0,-92.0,38.0,42.0,46.0,45.0,1
325,CC:2F:71:3F:1F:24,3949257,696376045,187695,221924850,3761562,474451195,27,157555,180280235,157484,180271311,71,8924,151021,6,187693,19799,24,133,117000.0,39000.0,-69.0,-66.0,-71.0,-68.0,-69.0,-66.0,-70.0,-68.0,-90.0,-92.0,-89.0,-92.0,21.0,26.0,18.0,24.0,1
326,CC:2F:71:3E:C5:1F,3761644,474461273,82,10078,3761562,474451195,0,320,27602,259,20218,61,7384,89,2,110,4,0,5,144444.0,39000.0,-69.0,-70.0,-66.0,-60.0,-69.0,-70.0,-66.0,-60.0,-90.0,-92.0,-89.0,-92.0,21.0,22.0,23.0,32.0,1
327,BA:8C:B9:54:50:24,3761824,474533298,262,82103,3761562,474451195,0,1128,128469,1110,125623,18,2846,178,2,366,4,0,7,216660.0,130000.0,-48.0,-35.0,-43.0,-45.0,-43.0,-36.0,-44.0,-48.0,-90.0,-92.0,-89.0,-92.0,42.0,57.0,46.0,47.0,1
328,92:69:1D:31:68:E9,3774339,489703216,12777,15252021,3761562,474451195,3,19220,3552008,18525,3392151,695,159857,6441,105,14029,252,3,250,216660.0,130000.0,-52.0,-50.0,-43.0,-47.0,-51.0,-49.0,-43.0,-48.0,-90.0,-92.0,-89.0,-92.0,38.0,42.0,46.0,45.0,1
329,CC:2F:71:3F:1F:24,3949370,696496413,187804,222044814,3761566,474451599,27,157649,180390743,157578,180381819,71,8924,151114,6,187802,19816,24,133,130000.0,43333.0,-69.0,-66.0,-70.0,-68.0,-69.0,-66.0,-70.0,-68.0,-90.0,-92.0,-89.0,-92.0,21.0,26.0,19.0,24.0,1
330,CC:2F:71:3E:C5:1F,3761648,474461677,82,10078,3761566,474451599,0,320,27602,259,20218,61,7384,89,2,110,4,0,5,144444.0,39000.0,-69.0,-70.0,-66.0,-60.0,-69.0,-70.0,-66.0,-60.0,-90.0,-92.0,-89.0,-92.0,21.0,22.0,23.0,32.0,1
331,BA:8C:B9:54:50:24,3761830,474533904,262,82103,3761568,474451801,0,1128,128469,1110,125623,18,2846,178,2,366,4,0,7,216660.0,130000.0,-48.0,-35.0,-43.0,-45.0,-43.0,-36.0,-44.0,-48.0,-90.0,-92.0,-89.0,-92.0,42.0,57.0,46.0,47.0,1
332,92:69:1D:31:68:E9,3774345,489703822,12777,15252021,3761568,474451801,3,19220,3552008,18525,3392151,695,159857,6441,105,14029,252,3,250,216660.0,130000.0,-52.0,-50.0,-43.0,-47.0,-51.0,-49.0,-43.0,-48.0,-90.0,-92.0,-89.0,-92.0,38.0,42.0,46.0,45.0,1
333,CC:2F:71:3F:1F:24,3949484,696618391,187913,222166328,3761571,474452063,27,157748,180507593,157677,180498669,71,8924,151208,6,187910,19828,24,133,130000.0,43333.0,-69.0,-66.0,-71.0,-68.0,-69.0,-66.0,-70.0,-68.0,-90.0,-92.0,-89.0,-92.0,21.0,26.0,18.0,24.0,1
334,CC:2F:71:3E:C5:1F,3761653,474462141,82,10078,3761571,474452063,0,320,27602,259,20218,61,7384,89,2,110,4,0,5,144444.0,39000.0,-69.0,-70.0,-66.0,-60.0,-69.0,-70.0,-66.0,-60.0,-90.0,-92.0,-89.0,-92.0,21.0,22.0,23.0,32.0,1
335,BA:8C:B9:54:50:24,3761833,474534166,262,82103,3761571,474452063,0,1128,128469,1110,125623,18,2846,178,2,366,4,0,7,216660.0,130000.0,-48.0,-35.0,-43.0,-45.0,-43.0,-36.0,-44.0,-48.0,-90.0,-92.0,-89.0,-92.0,42.0,57.0,46.0,47.0,1
336,92:69:1D:31:68:E9,3774348,489704084,12777,15252021,3761571,474452063,3,19221,3552076,18526,3392219,695,159857,6441,105,14029,252,3,250,216660.0,130000.0,-51.0,-48.0,-43.0,-47.0,-51.0,-49.0,-43.0,-48.0,-90.0,-92.0,-89.0,-92.0,39.0,44.0,46.0,45.0,1
337,CC:2F:71:3F:1F:24,3949596,696738475,188021,222286008,3761575,474452467,27,157849,180625021,157778,180616097,71,8924,151301,6,188019,19852,24,133,130000.0,39000.0,-69.0,-66.0,-70.0,-68.0,-69.0,-66.0,-70.0,-68.0,-90.0,-92.0,-89.0,-92.0,21.0,26.0,19.0,24.0,1
338,CC:2F:71:3E:C5:1F,3761657,474462545,82,10078,3761575,474452467,0,320,27602,259,20218,61,7384,89,2,110,4,0,5,144444.0,39000.0,-69.0,-70.0,-66.0,-60.0,-69.0,-70.0,-66.0,-60.0,-90.0,-92.0,-89.0,-92.0,21.0,22.0,23.0,32.0,1
339,BA:8C:B9:54:50:24,3761839,474534772,262,82103,3761577,474452669,0,1128,128469,1110,125623,18,2846,178,2,366,4,0,7,216660.0,130000.0,-48.0,-35.0,-43.0,-45.0,-43.0,-36.0,-44.0,-48.0,-90.0,-92.0,-89.0,-92.0,42.0,57.0,46.0,47.0,1
340,92:69:1D:31:68:E9,3774354,489704690,12777,15252021,3761577,474452669,3,19221,3552076,18526,3392219,695,159857,6441,105,14029,252,3,250,216660.0,130000.0,-51.0,-48.0,-43.0,-47.0,-51.0,-49.0,-43.0,-48.0,-90.0,-92.0,-89.0,-92.0,39.0,44.0,46.0,45.0,1
341,CC:2F:71:3F:1F:24,3949715,696862142,188136,222409271,3761579,474452871,27,157955,180741915,157884,180732991,71,8924,151401,6,188134,19876,24,134,130000.0,43333.0,-69.0,-66.0,-71.0,-68.0,-69.0,-66.0,-70.0,-68.0,-90.0,-92.0,-89.0,-92.0,21.0,26.0,18.0,24.0,1
342,CC:2F:71:3E:C5:1F,3761662,474463009,82,10078,3761580,474452931,0,320,27602,259,20218,61,7384,89,2,110,4,0,5,144444.0,39000.0,-69.0,-70.0,-66.0,-60.0,-69.0,-70.0,-66.0,-60.0,-90.0,-92.0,-89.0,-92.0,21.0,22.0,23.0,32.0,1
343,BA:8C:B9:54:50:24,3761842,474535034,262,82103,3761580,474452931,0,1128,128469,1110,125623,18,2846,178,2,366,4,0,7,216660.0,130000.0,-48.0,-35.0,-43.0,-45.0,-43.0,-36.0,-44.0,-48.0,-90.0,-92.0,-89.0,-92.0,42.0,57.0,46.0,47.0,1
344,92:69:1D:31:68:E9,3774357,489704952,12777,15252021,3761580,474452931,3,19221,3552076,18526,3392219,695,159857,6441,105,14029,252,3,250,216660.0,130000.0,-51.0,-48.0,-43.0,-47.0,-51.0,-49.0,-43.0,-48.0,-90.0,-92.0,-89.0,-92.0,39.0,44.0,46.0,45.0,1
345,CC:2F:71:3F:1F:24,3949831,696982938,188245,222529235,3761586,474453703,27,158053,180855863,157982,180846939,71,8924,151493,6,188243,19902,24,134,117000.0,39000.0,-69.0,-66.0,-70.0,-68.0,-68.0,-66.0,-70.0,-68.0,-90.0,-92.0,-89.0,-92.0,21.0,26.0,19.0,24.0,1
346,CC:2F:71:3E:C5:1F,3761669,474463897,83,10194,3761586,474453703,0,322,27742,261,20358,61,7384,89,2,111,4,0,5,144444.0,43333.0,-70.0,-70.0,-66.0,-60.0,-69.0,-70.0,-66.0,-60.0,-90.0,-92.0,-89.0,-92.0,20.0,22.0,23.0,32.0,1
347,BA:8C:B9:54:50:24,3761851,474536124,263,82219,3761588,474453905,0,1134,128877,1116,126031,18,2846,178,2,367,4,0,7,216660.0,130000.0,-40.0,-36.0,-41.0,-46.0,-41.0,-35.0,-43.0,-47.0,-90.0,-92.0,-89.0,-92.0,50.0,56.0,48.0,46.0,1
348,92:69:1D:31:68:E9,3774366,489705986,12778,15252081,3761588,474453905,3,19223,3552212,18528,3392355,695,159857,6441,105,14030,252,3,251,216660.0,130000.0,-52.0,-50.0,-44.0,-47.0,-51.0,-49.0,-43.0,-47.0,-90.0,-92.0,-89.0,-92.0,38.0,42.0,45.0,45.0,1
349,CC:2F:71:3F:1F:24,3949943,697102966,188353,222648859,3761590,474454107,27,158144,180967471,158073,180958547,71,8924,151582,6,188351,19922,24,134,130000.0,43333.0,-69.0,-66.0,-71.0,-68.0,-69.0,-66.0,-70.0,-68.0,-90.0,-92.0,-89.0,-92.0,21.0,26.0,18.0,24.0,1
350,CC:2F:71:3E:C5:1F,3761673,474464301,83,10194,3761590,474454107,0,322,27742,261,20358,61,7384,89,2,111,4,0,5,144444.0,43333.0,-70.0,-70.0,-66.0,-60.0,-69.0,-70.0,-66.0,-60.0,-90.0,-92.0,-89.0,-92.0,20.0,22.0,23.0,32.0,1
351,BA:8C:B9:54:50:24,3761853,474536326,263,82219,3761590,474454107,0,1134,128877,1116,126031,18,2846,178,2,367,4,0,7,216660.0,130000.0,-40.0,-36.0,-41.0,-46.0,-41.0,-35.0,-43.0,-47.0,-90.0,-92.0,-89.0,-92.0,50.0,56.0,48.0,46.0,1
352,92:69:1D:31:68:E9,3774368,489706188,12778,15252081,3761590,474454107,3,19223,3552212,18528,3392355,695,159857,6441,105,14030,252,3,251,216660.0,130000.0,-52.0,-50.0,-44.0,-47.0,-51.0,-49.0,-43.0,-47.0,-90.0,-92.0,-89.0,-92.0,38.0,42.0,45.0,45.0,1
353,CC:2F:71:3F:1F:24,3950058,697226498,188463,222771927,3761595,474454571,27,158237,181082229,158166,181073305,71,8924,151673,6,188461,19947,24,134,130000.0,43333.0,-69.0,-66.0,-70.0,-68.0,-69.0,-66.0,-70.0,-68.0,-90.0,-92.0,-89.0,-92.0,21.0,26.0,19.0,24.0,1
354,CC:2F:71:3E:C5:1F,3761678,474464765,83,10194,3761595,474454571,0,322,27742,261,20358,61,7384,89,2,111,4,0,5,144444.0,43333.0,-70.0,-70.0,-66.0,-60.0,-69.0,-70.0,-66.0,-60.0,-90.0,-92.0,-89.0,-92.0,20.0,22.0,23.0,32.0,1
355,BA:8C:B9:54:50:24,3761858,474536790,263,82219,3761595,474454571,0,1134,128877,1116,126031,18,2846,178,2,367,4,0,7,216660.0,130000.0,-40.0,-36.0,-41.0,-46.0,-41.0,-35.0,-43.0,-47.0,-90.0,-92.0,-89.0,-92.0,50.0,56.0,48.0,46.0,1
356,92:69:1D:31:68:E9,3774375,489706854,12778,15252081,3761597,474454773,3,19223,3552212,18528,3392355,695,159857,6441,105,14030,252,3,251,216660.0,130000.0,-52.0,-50.0,-44.0,-47.0,-51.0,-49.0,-43.0,-47.0,-90.0,-92.0,-89.0,-92.0,38.0,42.0,45.0,45.0,1
357,CC:2F:71:3F:1F:24,3950181,697352580,188581,222897543,3761600,474455037,27,158346,181201030,158274,181191988,72,9042,151775,6,188579,19970,24,134,117000.0,39000.0,-69.0,-66.0,-70.0,-68.0,-69.0,-66.0,-70.0,-68.0,-90.0,-92.0,-89.0,-92.0,21.0,26.0,19.0,24.0,1
358,CC:2F:71:3E:C5:1F,3761683,474465231,83,10194,3761600,474455037,0,322,27742,261,20358,61,7384,89,2,111,4,0,5,144444.0,43333.0,-70.0,-70.0,-66.0,-60.0,-69.0,-70.0,-66.0,-60.0,-90.0,-92.0,-89.0,-92.0,20.0,22.0,23.0,32.0,1
359,BA:8C:B9:54:50:24,3761863,474537256,263,82219,3761600,474455037,0,1134,128877,1116,126031,18,2846,178,2,367,4,0,7,216660.0,130000.0,-40.0,-36.0,-41.0,-46.0,-41.0,-35.0,-43.0,-47.0,-90.0,-92.0,-89.0,-92.0,50.0,56.0,48.0,46.0,1
360,92:69:1D:31:68:E9,3774378,489707118,12778,15252081,3761600,474455037,3,19223,3552212,18528,3392355,695,159857,6441,105,14030,252,3,251,216660.0,130000.0,-52.0,-50.0,-44.0,-47.0,-51.0,-49.0,-43.0,-47.0,-90.0,-92.0,-89.0,-92.0,38.0,42.0,45.0,45.0,1
361,CC:2F:71:3F:1F:24,3950294,697474386,188690,223018945,3761604,474455441,27,158440,181317286,158368,181308244,72,9042,151865,6,188688,19983,24,134,130000.0,43333.0,-69.0,-66.0,-71.0,-68.0,-69.0,-66.0,-70.0,-68.0,-90.0,-92.0,-89.0,-92.0,21.0,26.0,18.0,24.0,1
362,CC:2F:71:3E:C5:1F,3761687,474465635,83,10194,3761604,474455441,0,322,27742,261,20358,61,7384,89,2,111,4,0,5,144444.0,43333.0,-70.0,-70.0,-66.0,-60.0,-69.0,-70.0,-66.0,-60.0,-90.0,-92.0,-89.0,-92.0,20.0,22.0,23.0,32.0,1
363,BA:8C:B9:54:50:24,3761867,474537660,263,82219,3761604,474455441,0,1134,128877,1116,126031,18,2846,178,2,367,4,0,7,216660.0,130000.0,-40.0,-36.0,-41.0,-46.0,-41.0,-35.0,-43.0,-47.0,-90.0,-92.0,-89.0,-92.0,50.0,56.0,48.0,46.0,1
364,92:69:1D:31:68:E9,3774382,489707522,12778,15252081,3761604,474455441,3,19223,3552212,18528,3392355,695,159857,6441,105,14030,252,3,251,216660.0,130000.0,-52.0,-50.0,-44.0,-47.0,-51.0,-49.0,-43.0,-47.0,-90.0,-92.0,-89.0,-92.0,38.0,42.0,45.0,45.0,1
365,CC:2F:71:3F:1F:24,3950406,697593256,188797,223137351,3761609,474455905,27,158533,181429424,158461,181420382,72,9042,151953,6,188795,19994,24,134,130000.0,43333.0,-69.0,-66.0,-70.0,-68.0,-69.0,-66.0,-70.0,-68.0,-90.0,-92.0,-89.0,-92.0,21.0,26.0,19.0,24.0,1
366,CC:2F:71:3E:C5:1F,3761692,474466099,83,10194,3761609,474455905,0,322,27742,261,20358,61,7384,89,2,111,4,0,5,144444.0,43333.0,-70.0,-70.0,-66.0,-60.0,-69.0,-70.0,-66.0,-60.0,-90.0,-92.0,-89.0,-92.0,20.0,22.0,23.0,32.0,1
367,BA:8C:B9:54:50:24,3761872,474538124,263,82219,3761609,474455905,0,1134,128877,1116,126031,18,2846,178,2,367,4,0,7,216660.0,130000.0,-40.0,-36.0,-41.0,-46.0,-41.0,-35.0,-43.0,-47.0,-90.0,-92.0,-89.0,-92.0,50.0,56.0,48.0,46.0,1
368,92:69:1D:31:68:E9,3774388,489708054,12778,15252081,3761610,474455973,3,19223,3552212,18528,3392355,695,159857,6441,105,14030,252,3,251,216660.0,130000.0,-52.0,-50.0,-44.0,-47.0,-51.0,-49.0,-43.0,-47.0,-90.0,-92.0,-89.0,-92.0,38.0,42.0,45.0,45.0,1
369,CC:2F:71:3F:1F:24,3950528,697726359,188914,223269777,3761614,474456582,27,158639,181560096,158567,181551054,72,9042,152053,6,188912,20011,24,134,130000.0,43333.0,-69.0,-66.0,-70.0,-68.0,-69.0,-66.0,-70.0,-68.0,-90.0,-92.0,-89.0,-92.0,21.0,26.0,19.0,24.0,1
370,CC:2F:71:3E:C5:1F,3761697,474466776,83,10194,3761614,474456582,0,322,27742,261,20358,61,7384,89,2,111,4,0,5,144444.0,43333.0,-70.0,-70.0,-66.0,-60.0,-69.0,-70.0,-66.0,-60.0,-90.0,-92.0,-89.0,-92.0,20.0,22.0,23.0,32.0,1
371,BA:8C:B9:54:50:24,3761877,474538801,263,82219,3761614,474456582,0,1134,128877,1116,126031,18,2846,178,2,367,4,0,7,216660.0,130000.0,-40.0,-36.0,-41.0,-46.0,-41.0,-35.0,-43.0,-47.0,-90.0,-92.0,-89.0,-92.0,50.0,56.0,48.0,46.0,1
372,92:69:1D:31:68:E9,3774394,489708865,12778,15252081,3761616,474456784,3,19223,3552212,18528,3392355,695,159857,6441,105,14030,252,3,251,216660.0,130000.0,-52.0,-50.0,-44.0,-47.0,-51.0,-49.0,-43.0,-47.0,-90.0,-92.0,-89.0,-92.0,38.0,42.0,45.0,45.0,1
373,CC:2F:71:3F:1F:24,3950647,697848476,189028,223391430,3761619,474457046,27,158739,181673457,158667,181664415,72,9042,152148,6,189026,20029,24,134,130000.0,43333.0,-69.0,-66.0,-70.0,-68.0,-69.0,-66.0,-70.0,-68.0,-90.0,-92.0,-89.0,-92.0,21.0,26.0,19.0,24.0,1
374,CC:2F:71:3E:C5:1F,3761702,474467240,83,10194,3761619,474457046,0,322,27742,261,20358,61,7384,89,2,111,4,0,5,144444.0,43333.0,-70.0,-70.0,-66.0,-60.0,-69.0,-70.0,-66.0,-60.0,-90.0,-92.0,-89.0,-92.0,20.0,22.0,23.0,32.0,1
375,BA:8C:B9:54:50:24,3761882,474539265,263,82219,3761619,474457046,0,1134,128877,1116,126031,18,2846,178,2,367,4,0,7,216660.0,130000.0,-40.0,-36.0,-41.0,-46.0,-41.0,-35.0,-43.0,-47.0,-90.0,-92.0,-89.0,-92.0,50.0,56.0,48.0,46.0,1
376,92:69:1D:31:68:E9,3774397,489709127,12778,15252081,3761619,474457046,3,19223,3552212,18528,3392355,695,159857,6441,105,14030,252,3,251,216660.0,130000.0,-52.0,-50.0,-44.0,-47.0,-51.0,-49.0,-43.0,-47.0,-90.0,-92.0,-89.0,-92.0,38.0,42.0,45.0,45.0,1
377,CC:2F:71:3F:1F:24,3950757,697967156,189134,223509706,3761623,474457450,27,158831,181786633,158759,181777591,72,9042,152236,6,189131,20038,24,134,130000.0,43333.0,-69.0,-66.0,-71.0,-68.0,-68.0,-66.0,-70.0,-68.0,-90.0,-92.0,-89.0,-92.0,21.0,26.0,18.0,24.0,1
378,CC:2F:71:3E:C5:1F,3761706,474467644,83,10194,3761623,474457450,0,322,27742,261,20358,61,7384,89,2,111,4,0,5,144444.0,43333.0,-70.0,-70.0,-66.0,-60.0,-69.0,-70.0,-66.0,-60.0,-90.0,-92.0,-89.0,-92.0,20.0,22.0,23.0,32.0,1
379,BA:8C:B9:54:50:24,3761886,474539669,263,82219,3761623,474457450,0,1134,128877,1116,126031,18,2846,178,2,367,4,0,7,216660.0,130000.0,-40.0,-36.0,-41.0,-46.0,-41.0,-35.0,-43.0,-47.0,-90.0,-92.0,-89.0,-92.0,50.0,56.0,48.0,46.0,1
380,92:69:1D:31:68:E9,3774403,489709733,12778,15252081,3761625,474457652,3,19223,3552212,18528,3392355,695,159857,6441,105,14030,252,3,251,216660.0,130000.0,-52.0,-50.0,-44.0,-47.0,-51.0,-49.0,-43.0,-47.0,-90.0,-92.0,-89.0,-92.0,38.0,42.0,45.0,45.0,1
381,CC:2F:71:3F:1F:24,3950869,698088652,189241,223630736,3761628,474457916,27,158926,181903005,158854,181893963,72,9042,152327,6,189239,20057,24,134,130000.0,43333.0,-70.0,-67.0,-72.0,-69.0,-69.0,-66.0,-71.0,-69.0,-90.0,-92.0,-89.0,-92.0,20.0,25.0,17.0,23.0,1
382,CC:2F:71:3E:C5:1F,3761711,474468110,83,10194,3761628,474457916,0,324,27930,262,20428,62,7502,90,2,111,4,0,5,144444.0,43333.0,-66.0,-64.0,-65.0,-59.0,-69.0,-69.0,-65.0,-59.0,-90.0,-92.0,-89.0,-92.0,24.0,28.0,24.0,33.0,1
383,BA:8C:B9:54:50:24,3761891,474540135,263,82219,3761628,474457916,0,1134,128877,1116,126031,18,2846,178,2,367,4,0,7,216660.0,130000.0,-40.0,-36.0,-41.0,-46.0,-41.0,-35.0,-43.0,-47.0,-90.0,-92.0,-89.0,-92.0,50.0,56.0,48.0,46.0,1
384,92:69:1D:31:68:E9,3774406,489709997,12778,15252081,3761628,474457916,3,19223,3552212,18528,3392355,695,159857,6441,105,14030,252,3,251,216660.0,130000.0,-52.0,-50.0,-44.0,-47.0,-51.0,-49.0,-43.0,-47.0,-90.0,-92.0,-89.0,-92.0,38.0,42.0,45.0,45.0,1
385,CC:2F:71:3F:1F:24,3950979,698208744,189348,223750566,3761631,474458178,27,159027,182018801,158955,182009759,72,9042,152420,6,189346,20064,24,134,130000.0,43333.0,-70.0,-67.0,-72.0,-69.0,-69.0,-67.0,-71.0,-69.0,-90.0,-92.0,-89.0,-92.0,20.0,25.0,17.0,23.0,1
386,CC:2F:71:3E:C5:1F,3761716,474468574,83,10194,3761633,474458380,0,324,27930,262,20428,62,7502,90,2,111,4,0,5,144444.0,43333.0,-66.0,-64.0,-65.0,-59.0,-69.0,-69.0,-65.0,-59.0,-90.0,-92.0,-89.0,-92.0,24.0,28.0,24.0,33.0,1
387,BA:8C:B9:54:50:24,3761896,474540599,263,82219,3761633,474458380,0,1134,128877,1116,126031,18,2846,178,2,367,4,0,7,216660.0,130000.0,-40.0,-36.0,-41.0,-46.0,-41.0,-35.0,-43.0,-47.0,-90.0,-92.0,-89.0,-92.0,50.0,56.0,48.0,46.0,1
388,92:69:1D:31:68:E9,3774413,489710663,12778,15252081,3761635,474458582,3,19223,3552212,18528,3392355,695,159857,6441,105,14030,252,3,251,216660.0,130000.0,-52.0,-50.0,-44.0,-47.0,-51.0,-49.0,-43.0,-47.0,-90.0,-92.0,-89.0,-92.0,38.0,42.0,45.0,45.0,1
389,CC:2F:71:3F:1F:24,3951099,698331059,189462,223872275,3761637,474458784,27,159135,182135866,159063,182126824,72,9042,152519,6,189460,20079,24,134,130000.0,39000.0,-70.0,-67.0,-71.0,-69.0,-69.0,-66.0,-71.0,-69.0,-90.0,-92.0,-89.0,-92.0,20.0,25.0,18.0,23.0,1
390,CC:2F:71:3E:C5:1F,3761720,474468978,83,10194,3761637,474458784,0,324,27930,262,20428,62,7502,90,2,111,4,0,5,144444.0,43333.0,-66.0,-64.0,-65.0,-59.0,-69.0,-69.0,-65.0,-59.0,-90.0,-92.0,-89.0,-92.0,24.0,28.0,24.0,33.0,1
391,BA:8C:B9:54:50:24,3761900,474541003,263,82219,3761637,474458784,0,1134,128877,1116,126031,18,2846,178,2,367,4,0,7,216660.0,130000.0,-40.0,-36.0,-41.0,-46.0,-41.0,-35.0,-43.0,-47.0,-90.0,-92.0,-89.0,-92.0,50.0,56.0,48.0,46.0,1
392,92:69:1D:31:68:E9,3774415,489710865,12778,15252081,3761637,474458784,3,19223,3552212,18528,3392355,695,159857,6441,105,14030,252,3,251,216660.0,130000.0,-52.0,-50.0,-44.0,-47.0,-51.0,-49.0,-43.0,-47.0,-90.0,-92.0,-89.0,-92.0,38.0,42.0,45.0,45.0,1
393,CC:2F:71:3F:1F:24,3951207,698449481,189568,223990495,3761639,474458986,27,159237,182253610,159165,182244568,72,9042,152609,6,189566,20092,24,134,130000.0,43333.0,-69.0,-67.0,-71.0,-69.0,-69.0,-66.0,-71.0,-69.0,-90.0,-92.0,-89.0,-92.0,21.0,25.0,18.0,23.0,1
394,CC:2F:71:3E:C5:1F,3761724,474469382,83,10194,3761641,474459188,0,324,27930,262,20428,62,7502,90,2,111,4,0,5,144444.0,43333.0,-66.0,-64.0,-65.0,-59.0,-69.0,-69.0,-65.0,-59.0,-90.0,-92.0,-89.0,-92.0,24.0,28.0,24.0,33.0,1
395,BA:8C:B9:54:50:24,3761904,474541407,263,82219,3761641,474459188,0,1134,128877,1116,126031,18,2846,178,2,367,4,0,7,216660.0,130000.0,-40.0,-36.0,-41.0,-46.0,-41.0,-35.0,-43.0,-47.0,-90.0,-92.0,-89.0,-92.0,50.0,56.0,48.0,46.0,1
396,92:69:1D:31:68:E9,3774422,489711531,12778,15252081,3761644,474459450,3,19224,3552280,18529,3392423,695,159857,6441,105,14031,252,3,251,216660.0,130000.0,-52.0,-50.0,-44.0,-47.0,-51.0,-49.0,-43.0,-47.0,-90.0,-92.0,-89.0,-92.0,38.0,42.0,45.0,45.0,1
397,CC:2F:71:3F:1F:24,3951321,698571161,189675,224111509,3761646,474459652,27,159333,182371692,159261,182362650,72,9042,152698,6,189673,20123,24,134,130000.0,43333.0,-69.0,-66.0,-71.0,-69.0,-69.0,-66.0,-71.0,-69.0,-90.0,-92.0,-89.0,-92.0,21.0,26.0,18.0,23.0,1
398,CC:2F:71:3E:C5:1F,3761729,474469846,83,10194,3761646,474459652,0,324,27930,262,20428,62,7502,90,2,111,4,0,5,144444.0,43333.0,-66.0,-64.0,-65.0,-59.0,-69.0,-69.0,-65.0,-59.0,-90.0,-92.0,-89.0,-92.0,24.0,28.0,24.0,33.0,1
399,BA:8C:B9:54:50:24,3761909,474541871,263,82219,3761646,474459652,0,1136,129013,1118,126167,18,2846,178,2,368,4,0,7,216660.0,130000.0,-40.0,-37.0,-45.0,-51.0,-41.0,-35.0,-43.0,-47.0,-90.0,-92.0,-89.0,-92.0,50.0,55.0,44.0,41.0,1
400,92:69:1D:31:68:E9,3774424,489711733,12778,15252081,3761646,474459652,3,19225,3552348,18530,3392491,695,159857,6441,105,14031,252,3,251,216660.0,130000.0,-51.0,-48.0,-43.0,-47.0,-51.0,-49.0,-43.0,-47.0,-90.0,-92.0,-89.0,-92.0,39.0,44.0,46.0,45.0,1
401,CC:2F:71:3F:1F:24,3951432,698691492,189784,224231638,3761648,474459854,27,159431,182484312,159359,182475270,72,9042,152791,6,189782,20139,24,134,130000.0,43333.0,-69.0,-67.0,-71.0,-69.0,-69.0,-66.0,-71.0,-69.0,-90.0,-92.0,-89.0,-92.0,21.0,25.0,18.0,23.0,1
402,CC:2F:71:3E:C5:1F,3761731,474470048,83,10194,3761648,474459854,0,324,27930,262,20428,62,7502,90,2,111,4,0,5,144444.0,43333.0,-66.0,-64.0,-65.0,-59.0,-69.0,-69.0,-65.0,-59.0,-90.0,-92.0,-89.0,-92.0,24.0,28.0,24.0,33.0,1
403,BA:8C:B9:54:50:24,3761913,474542275,263,82219,3761650,474460056,0,1136,129013,1118,126167,18,2846,178,2,368,4,0,7,216660.0,130000.0,-40.0,-37.0,-45.0,-51.0,-41.0,-35.0,-43.0,-47.0,-90.0,-92.0,-89.0,-92.0,50.0,55.0,44.0,41.0,1
404,92:69:1D:31:68:E9,3774430,489712339,12778,15252081,3761652,474460258,3,19225,3552348,18530,3392491,695,159857,6441,105,14031,252,3,251,216660.0,130000.0,-51.0,-48.0,-43.0,-47.0,-51.0,-49.0,-43.0,-47.0,-90.0,-92.0,-89.0,-92.0,39.0,44.0,46.0,45.0,1
405,CC:2F:71:3F:1F:24,3951552,698816643,189899,224356325,3761653,474460318,27,159535,182598013,159463,182588971,72,9042,152892,6,189897,20156,24,134,130000.0,43333.0,-69.0,-66.0,-70.0,-68.0,-69.0,-66.0,-70.0,-68.0,-90.0,-91.0,-88.0,-91.0,21.0,25.0,18.0,23.0,1
406,CC:2F:71:3E:C5:1F,3761738,474470714,83,10194,3761655,474460520,0,324,27930,262,20428,62,7502,90,2,111,4,0,5,144444.0,43333.0,-66.0,-64.0,-65.0,-59.0,-69.0,-69.0,-65.0,-59.0,-90.0,-91.0,-88.0,-91.0,24.0,27.0,23.0,32.0,1
407,BA:8C:B9:54:50:24,3761918,474542739,263,82219,3761655,474460520,0,1137,129081,1119,126235,18,2846,178,2,368,4,0,7,216660.0,130000.0,-40.0,-37.0,-45.0,-51.0,-41.0,-35.0,-43.0,-47.0,-90.0,-91.0,-88.0,-91.0,50.0,54.0,43.0,40.0,1
408,92:69:1D:31:68:E9,3774433,489712601,12778,15252081,3761655,474460520,3,19225,3552348,18530,3392491,695,159857,6441,105,14031,252,3,251,216660.0,130000.0,-51.0,-48.0,-43.0,-47.0,-51.0,-49.0,-43.0,-47.0,-90.0,-91.0,-88.0,-91.0,39.0,43.0,45.0,44.0,1
409,CC:2F:71:3F:1F:24,3951663,698935397,190006,224474675,3761657,474460722,27,159627,182709765,159555,182700723,72,9042,152980,6,190004,20160,24,134,130000.0,43333.0,-69.0,-67.0,-71.0,-69.0,-69.0,-66.0,-70.0,-68.0,-90.0,-91.0,-88.0,-91.0,21.0,24.0,17.0,22.0,1
410,CC:2F:71:3E:C5:1F,3761740,474470916,83,10194,3761657,474460722,0,324,27930,262,20428,62,7502,90,2,111,4,0,5,144444.0,43333.0,-66.0,-64.0,-65.0,-59.0,-69.0,-69.0,-65.0,-59.0,-90.0,-91.0,-88.0,-91.0,24.0,27.0,23.0,32.0,1
411,BA:8C:B9:54:50:24,3761920,474542941,263,82219,3761657,474460722,0,1137,129081,1119,126235,18,2846,178,2,368,4,0,7,216660.0,130000.0,-40.0,-37.0,-45.0,-51.0,-41.0,-35.0,-43.0,-47.0,-90.0,-91.0,-88.0,-91.0,50.0,54.0,43.0,40.0,1
412,92:69:1D:31:68:E9,3774437,489713005,12778,15252081,3761659,474460924,3,19225,3552348,18530,3392491,695,159857,6441,105,14031,252,3,251,216660.0,130000.0,-51.0,-48.0,-43.0,-47.0,-51.0,-49.0,-43.0,-47.0,-90.0,-91.0,-88.0,-91.0,39.0,43.0,45.0,44.0,1
413,CC:2F:71:3F:1F:24,3951775,699058609,190114,224597483,3761661,474461126,27,159724,182829387,159652,182820345,72,9042,153070,6,190111,20173,24,134,130000.0,43333.0,-69.0,-66.0,-71.0,-69.0,-69.0,-66.0,-71.0,-69.0,-90.0,-91.0,-88.0,-91.0,21.0,25.0,17.0,22.0,1
414,CC:2F:71:3E:C5:1F,3761744,474471320,83,10194,3761661,474461126,0,324,27930,262,20428,62,7502,90,2,111,4,0,5,144444.0,43333.0,-66.0,-64.0,-65.0,-59.0,-69.0,-69.0,-65.0,-59.0,-90.0,-91.0,-88.0,-91.0,24.0,27.0,23.0,32.0,1
415,BA:8C:B9:54:50:24,3761926,474543547,263,82219,3761663,474461328,0,1137,129081,1119,126235,18,2846,178,2,368,4,0,7,216660.0,130000.0,-40.0,-37.0,-45.0,-51.0,-41.0,-35.0,-43.0,-47.0,-90.0,-91.0,-88.0,-91.0,50.0,54.0,43.0,40.0,1
416,92:69:1D:31:68:E9,3774441,489713409,12778,15252081,3761663,474461328,3,19225,3552348,18530,3392491,695,159857,6441,105,14031,252,3,251,216660.0,130000.0,-51.0,-48.0,-43.0,-47.0,-51.0,-49.0,-43.0,-47.0,-90.0,-91.0,-88.0,-91.0,39.0,43.0,45.0,44.0,1
417,CC:2F:71:3F:1F:24,3951886,699178549,190220,224716959,3761666,474461590,27,159820,182941747,159748,182932705,72,9042,153162,6,190218,20201,24,134,130000.0,43333.0,-69.0,-67.0,-71.0,-69.0,-69.0,-66.0,-71.0,-68.0,-90.0,-91.0,-88.0,-91.0,21.0,24.0,17.0,22.0,1
418,CC:2F:71:3E:C5:1F,3761749,474471784,83,10194,3761666,474461590,0,324,27930,262,20428,62,7502,90,2,111,4,0,5,144444.0,43333.0,-66.0,-64.0,-65.0,-59.0,-69.0,-69.0,-65.0,-59.0,-90.0,-91.0,-88.0,-91.0,24.0,27.0,23.0,32.0,1
419,BA:8C:B9:54:50:24,3761929,474543809,263,82219,3761666,474461590,0,1137,129081,1119,126235,18,2846,178,2,368,4,0,7,216660.0,130000.0,-40.0,-37.0,-45.0,-51.0,-41.0,-35.0,-43.0,-47.0,-90.0,-91.0,-88.0,-91.0,50.0,54.0,43.0,40.0,1
420,92:69:1D:31:68:E9,3774446,489713873,12778,15252081,3761668,474461792,3,19225,3552348,18530,3392491,695,159857,6441,105,14031,252,3,251,216660.0,130000.0,-51.0,-48.0,-43.0,-47.0,-51.0,-49.0,-43.0,-47.0,-90.0,-91.0,-88.0,-91.0,39.0,43.0,45.0,44.0,1
421,CC:2F:71:3F:1F:24,3952004,699303021,190333,224840754,3761671,474462267,27,159922,183056635,159850,183047593,72,9042,153260,6,190331,20218,24,134,130000.0,43333.0,-69.0,-66.0,-71.0,-69.0,-69.0,-66.0,-71.0,-69.0,-90.0,-91.0,-88.0,-91.0,21.0,25.0,17.0,22.0,1
422,CC:2F:71:3E:C5:1F,3761754,474472461,83,10194,3761671,474462267,0,324,27930,262,20428,62,7502,90,2,111,4,0,5,144444.0,43333.0,-66.0,-64.0,-65.0,-59.0,-69.0,-69.0,-65.0,-59.0,-90.0,-91.0,-88.0,-91.0,24.0,27.0,23.0,32.0,1
423,BA:8C:B9:54:50:24,3761934,474544486,263,82219,3761671,474462267,0,1137,129081,1119,126235,18,2846,178,2,368,4,0,7,216660.0,130000.0,-40.0,-37.0,-45.0,-51.0,-41.0,-35.0,-43.0,-47.0,-90.0,-91.0,-88.0,-91.0,50.0,54.0,43.0,40.0,1
424,92:69:1D:31:68:E9,3774451,489714550,12778,15252081,3761673,474462469,3,19225,3552348,18530,3392491,695,159857,6441,105,14031,252,3,251,216660.0,130000.0,-51.0,-48.0,-43.0,-47.0,-51.0,-49.0,-43.0,-47.0,-90.0,-91.0,-88.0,-91.0,39.0,43.0,45.0,44.0,1
425,CC:2F:71:3F:1F:24,3952114,699421645,190439,224958974,3761675,474462671,27,160012,183168141,159940,183159099,72,9042,153347,6,190437,20227,24,134,130000.0,43333.0,-69.0,-66.0,-71.0,-69.0,-69.0,-66.0,-70.0,-69.0,-90.0,-91.0,-88.0,-91.0,21.0,25.0,17.0,22.0,1
426,CC:2F:71:3E:C5:1F,3761758,474472865,83,10194,3761675,474462671,0,324,27930,262,20428,62,7502,90,2,111,4,0,5,144444.0,43333.0,-66.0,-64.0,-65.0,-59.0,-69.0,-69.0,-65.0,-59.0,-90.0,-91.0,-88.0,-91.0,24.0,27.0,23.0,32.0,1
427,BA:8C:B9:54:50:24,3761938,474544890,263,82219,3761675,474462671,0,1137,129081,1119,126235,18,2846,178,2,368,4,0,7,216660.0,130000.0,-40.0,-37.0,-45.0,-51.0,-41.0,-35.0,-43.0,-47.0,-90.0,-91.0,-88.0,-91.0,50.0,54.0,43.0,40.0,1
428,92:69:1D:31:68:E9,3774456,489715014,12778,15252081,3761678,474462933,3,19225,3552348,18530,3392491,695,159857,6441,105,14031,252,3,251,216660.0,130000.0,-51.0,-48.0,-43.0,-47.0,-51.0,-49.0,-43.0,-47.0,-90.0,-91.0,-88.0,-91.0,39.0,43.0,45.0,44.0,1
429,CC:2F:71:3F:1F:24,3952224,699540255,190544,225077120,3761680,474463135,27,160103,183278387,160031,183269345,72,9042,153435,6,190542,20236,24,134,130000.0,43333.0,-69.0,-67.0,-71.0,-69.0,-69.0,-66.0,-71.0,-69.0,-90.0,-91.0,-88.0,-91.0,21.0,24.0,17.0,22.0,1
430,CC:2F:71:3E:C5:1F,3761763,474473329,83,10194,3761680,474463135,0,324,27930,262,20428,62,7502,90,2,111,4,0,5,144444.0,43333.0,-66.0,-64.0,-65.0,-59.0,-69.0,-69.0,-65.0,-59.0,-90.0,-91.0,-88.0,-91.0,24.0,27.0,23.0,32.0,1
431,BA:8C:B9:54:50:24,3761943,474545354,263,82219,3761680,474463135,0,1137,129081,1119,126235,18,2846,178,2,368,4,0,7,216660.0,130000.0,-40.0,-37.0,-45.0,-51.0,-41.0,-35.0,-43.0,-47.0,-90.0,-91.0,-88.0,-91.0,50.0,54.0,43.0,40.0,1
432,92:69:1D:31:68:E9,3774458,489715216,12778,15252081,3761680,474463135,3,19225,3552348,18530,3392491,695,159857,6441,105,14031,252,3,251,216660.0,130000.0,-51.0,-48.0,-43.0,-47.0,-51.0,-49.0,-43.0,-47.0,-90.0,-91.0,-88.0,-91.0,39.0,43.0,45.0,44.0,1
433,CC:2F:71:3F:1F:24,3952332,699658451,190648,225194912,3761684,474463539,27,160194,183391447,160122,183382405,72,9042,153522,6,190646,20253,24,134,130000.0,43333.0,-69.0,-67.0,-71.0,-69.0,-69.0,-66.0,-71.0,-69.0,-90.0,-91.0,-88.0,-91.0,21.0,24.0,17.0,22.0,1
434,CC:2F:71:3E:C5:1F,3761767,474473733,83,10194,3761684,474463539,0,324,27930,262,20428,62,7502,90,2,111,4,0,5,144444.0,43333.0,-66.0,-64.0,-65.0,-59.0,-69.0,-69.0,-65.0,-59.0,-90.0,-91.0,-88.0,-91.0,24.0,27.0,23.0,32.0,1
435,BA:8C:B9:54:50:24,3761947,474545758,263,82219,3761684,474463539,0,1137,129081,1119,126235,18,2846,178,2,368,4,0,7,216660.0,130000.0,-40.0,-37.0,-45.0,-51.0,-41.0,-35.0,-43.0,-47.0,-90.0,-91.0,-88.0,-91.0,50.0,54.0,43.0,40.0,1
436,92:69:1D:31:68:E9,3774462,489715620,12778,15252081,3761684,474463539,3,19225,3552348,18530,3392491,695,159857,6441,105,14031,252,3,251,216660.0,130000.0,-51.0,-48.0,-43.0,-47.0,-51.0,-49.0,-43.0,-47.0,-90.0,-91.0,-88.0,-91.0,39.0,43.0,45.0,44.0,1
437,CC:2F:71:3F:1F:24,3952450,699779014,190761,225315011,3761689,474464003,27,160291,183501484,160219,183492442,72,9042,153616,6,190759,20271,24,134,130000.0,43333.0,-73.0,-70.0,-75.0,-72.0,-70.0,-67.0,-72.0,-69.0,-90.0,-91.0,-88.0,-91.0,17.0,21.0,13.0,19.0,1
438,CC:2F:71:3E:C5:1F,3761772,474474197,83,10194,3761689,474464003,0,324,27930,262,20428,62,7502,90,2,111,4,0,5,144444.0,43333.0,-66.0,-64.0,-65.0,-59.0,-69.0,-69.0,-65.0,-59.0,-90.0,-91.0,-88.0,-91.0,24.0,27.0,23.0,32.0,1
439,BA:8C:B9:54:50:24,3761952,474546222,263,82219,3761689,474464003,0,1137,129081,1119,126235,18,2846,178,2,368,4,0,7,216660.0,130000.0,-40.0,-37.0,-45.0,-51.0,-41.0,-35.0,-43.0,-47.0,-90.0,-91.0,-88.0,-91.0,50.0,54.0,43.0,40.0,1
440,92:69:1D:31:68:E9,3774467,489716084,12778,15252081,3761689,474464003,3,19225,3552348,18530,3392491,695,159857,6441,105,14031,252,3,251,216660.0,130000.0,-51.0,-48.0,-43.0,-47.0,-51.0,-49.0,-43.0,-47.0,-90.0,-91.0,-88.0,-91.0,39.0,43.0,45.0,44.0,1
441,CC:2F:71:3F:1F:24,3952561,699899248,190868,225434841,3761693,474464407,27,160388,183621054,160316,183612012,72,9042,153704,6,190866,20283,24,134,130000.0,43333.0,-70.0,-67.0,-72.0,-69.0,-69.0,-67.0,-71.0,-69.0,-90.0,-91.0,-88.0,-91.0,20.0,24.0,16.0,22.0,1
442,CC:2F:71:3E:C5:1F,3761776,474474601,83,10194,3761693,474464407,0,324,27930,262,20428,62,7502,90,2,111,4,0,5,144444.0,43333.0,-66.0,-64.0,-65.0,-59.0,-69.0,-69.0,-65.0,-59.0,-90.0,-91.0,-88.0,-91.0,24.0,27.0,23.0,32.0,1
443,BA:8C:B9:54:50:24,3761956,474546626,263,82219,3761693,474464407,0,1137,129081,1119,126235,18,2846,178,2,368,4,0,7,216660.0,130000.0,-40.0,-37.0,-45.0,-51.0,-41.0,-35.0,-43.0,-47.0,-90.0,-91.0,-88.0,-91.0,50.0,54.0,43.0,40.0,1
444,92:69:1D:31:68:E9,3774471,489716488,12778,15252081,3761693,474464407,3,19225,3552348,18530,3392491,695,159857,6441,105,14031,252,3,251,216660.0,130000.0,-51.0,-48.0,-43.0,-47.0,-51.0,-49.0,-43.0,-47.0,-90.0,-91.0,-88.0,-91.0,39.0,43.0,45.0,44.0,1
445,CC:2F:71:3F:1F:24,3952669,700017220,190972,225552409,3761697,474464811,27,160481,183734566,160409,183725524,72,9042,153791,6,190970,20301,24,134,130000.0,43333.0,-73.0,-70.0,-74.0,-72.0,-72.0,-69.0,-73.0,-71.0,-90.0,-91.0,-88.0,-91.0,17.0,21.0,14.0,19.0,1
446,CC:2F:71:3E:C5:1F,3761780,474475005,83,10194,3761697,474464811,0,324,27930,262,20428,62,7502,90,2,111,4,0,5,144444.0,43333.0,-66.0,-64.0,-65.0,-59.0,-69.0,-69.0,-65.0,-59.0,-90.0,-91.0,-88.0,-91.0,24.0,27.0,23.0,32.0,1
447,BA:8C:B9:54:50:24,3761960,474547030,263,82219,3761697,474464811,0,1137,129081,1119,126235,18,2846,178,2,368,4,0,7,216660.0,130000.0,-40.0,-37.0,-45.0,-51.0,-41.0,-35.0,-43.0,-47.0,-90.0,-91.0,-88.0,-91.0,50.0,54.0,43.0,40.0,1
448,92:69:1D:31:68:E9,3774475,489716892,12778,15252081,3761697,474464811,3,19225,3552348,18530,3392491,695,159857,6441,105,14031,252,3,251,216660.0,130000.0,-51.0,-48.0,-43.0,-47.0,-51.0,-49.0,-43.0,-47.0,-90.0,-91.0,-88.0,-91.0,39.0,43.0,45.0,44.0,1
449,CC:2F:71:3F:1F:24,3952780,700135960,191078,225670685,3761702,474465275,27,160586,183863630,160514,183854588,72,9042,153882,6,191076,20312,24,134,130000.0,43333.0,-69.0,-67.0,-71.0,-69.0,-70.0,-67.0,-71.0,-69.0,-90.0,-91.0,-88.0,-91.0,21.0,24.0,17.0,22.0,1
450,CC:2F:71:3E:C5:1F,3761785,474475469,83,10194,3761702,474465275,0,324,27930,262,20428,62,7502,90,2,111,4,0,5,144444.0,43333.0,-66.0,-64.0,-65.0,-59.0,-69.0,-69.0,-65.0,-59.0,-90.0,-91.0,-88.0,-91.0,24.0,27.0,23.0,32.0,1
451,BA:8C:B9:54:50:24,3761965,474547494,263,82219,3761702,474465275,0,1137,129081,1119,126235,18,2846,178,2,368,4,0,7,216660.0,130000.0,-40.0,-37.0,-45.0,-51.0,-41.0,-35.0,-43.0,-47.0,-90.0,-91.0,-88.0,-91.0,50.0,54.0,43.0,40.0,1
452,92:69:1D:31:68:E9,3774481,489717472,12779,15252197,3761702,474465275,3,19226,3552416,18531,3392559,695,159857,6441,105,14032,252,3,251,216660.0,130000.0,-52.0,-50.0,-43.0,-47.0,-51.0,-49.0,-43.0,-47.0,-90.0,-91.0,-88.0,-91.0,38.0,41.0,45.0,44.0,1
453,CC:2F:71:3F:1F:24,3952900,700262575,191194,225796896,3761706,474465679,27,160685,183979505,160613,183970463,72,9042,153979,6,191191,20326,24,134,130000.0,39000.0,-69.0,-67.0,-71.0,-69.0,-69.0,-66.0,-71.0,-69.0,-90.0,-92.0,-88.0,-91.0,21.0,25.0,17.0,22.0,1
454,CC:2F:71:3E:C5:1F,3761790,474475933,84,10254,3761706,474465679,0,326,28070,264,20568,62,7502,90,2,112,4,0,5,130000.0,39000.0,-70.0,-70.0,-66.0,-60.0,-69.0,-69.0,-66.0,-61.0,-90.0,-92.0,-88.0,-91.0,20.0,22.0,22.0,31.0,1
455,BA:8C:B9:54:50:24,3761970,474548014,264,82335,3761706,474465679,0,1139,129217,1121,126371,18,2846,178,2,369,4,0,7,229410.0,130000.0,-40.0,-37.0,-45.0,-51.0,-41.0,-35.0,-43.0,-48.0,-90.0,-92.0,-88.0,-91.0,50.0,55.0,43.0,40.0,1
456,92:69:1D:31:68:E9,3774485,489717876,12779,15252197,3761706,474465679,3,19227,3552484,18532,3392627,695,159857,6441,105,14032,252,3,251,216660.0,130000.0,-52.0,-48.0,-43.0,-47.0,-51.0,-49.0,-43.0,-47.0,-90.0,-92.0,-88.0,-91.0,38.0,44.0,45.0,44.0,1
457,CC:2F:71:3F:1F:24,3953010,700379707,191299,225913562,3761711,474466145,27,160774,184089471,160702,184080429,72,9042,154065,6,191297,20336,24,134,130000.0,43333.0,-70.0,-67.0,-71.0,-69.0,-69.0,-66.0,-71.0,-69.0,-90.0,-92.0,-88.0,-91.0,20.0,25.0,17.0,22.0,1
458,CC:2F:71:3E:C5:1F,3761795,474476399,84,10254,3761711,474466145,0,328,28258,265,20638,63,7620,91,2,112,4,0,5,130000.0,39000.0,-71.0,-70.0,-66.0,-60.0,-70.0,-69.0,-66.0,-61.0,-90.0,-92.0,-88.0,-91.0,19.0,22.0,22.0,31.0,1
459,BA:8C:B9:54:50:24,3761975,474548480,264,82335,3761711,474466145,0,1139,129217,1121,126371,18,2846,178,2,369,4,0,7,229410.0,130000.0,-40.0,-37.0,-45.0,-51.0,-41.0,-35.0,-43.0,-48.0,-90.0,-92.0,-88.0,-91.0,50.0,55.0,43.0,40.0,1
460,92:69:1D:31:68:E9,3774490,489718342,12779,15252197,3761711,474466145,3,19227,3552484,18532,3392627,695,159857,6441,105,14032,252,3,251,216660.0,130000.0,-52.0,-48.0,-43.0,-47.0,-51.0,-49.0,-43.0,-47.0,-90.0,-92.0,-88.0,-91.0,38.0,44.0,45.0,44.0,1
461,CC:2F:71:3F:1F:24,3953120,700498205,191404,226031596,3761716,474466609,27,160869,184200243,160797,184191201,72,9042,154156,6,191402,20344,24,134,130000.0,43333.0,-69.0,-66.0,-71.0,-69.0,-69.0,-66.0,-71.0,-69.0,-90.0,-92.0,-88.0,-91.0,21.0,26.0,17.0,22.0,1
462,CC:2F:71:3E:C5:1F,3761800,474476863,84,10254,3761716,474466609,0,328,28258,265,20638,63,7620,91,2,112,4,0,5,130000.0,39000.0,-71.0,-70.0,-66.0,-60.0,-70.0,-69.0,-66.0,-61.0,-90.0,-92.0,-88.0,-91.0,19.0,22.0,22.0,31.0,1
463,BA:8C:B9:54:50:24,3761980,474548944,264,82335,3761716,474466609,0,1139,129217,1121,126371,18,2846,178,2,369,4,0,7,229410.0,130000.0,-40.0,-37.0,-45.0,-51.0,-41.0,-35.0,-43.0,-48.0,-90.0,-92.0,-88.0,-91.0,50.0,55.0,43.0,40.0,1
464,92:69:1D:31:68:E9,3774495,489718806,12779,15252197,3761716,474466609,3,19227,3552484,18532,3392627,695,159857,6441,105,14032,252,3,251,216660.0,130000.0,-52.0,-48.0,-43.0,-47.0,-51.0,-49.0,-43.0,-47.0,-90.0,-92.0,-88.0,-91.0,38.0,44.0,45.0,44.0,1
465,CC:2F:71:3F:1F:24,3953231,700616791,191511,226149778,3761720,474467013,27,160965,184315431,160893,184306389,72,9042,154246,6,191509,20364,24,134,130000.0,43333.0,-69.0,-66.0,-70.0,-68.0,-69.0,-66.0,-70.0,-68.0,-90.0,-92.0,-88.0,-91.0,21.0,26.0,18.0,23.0,1
466,CC:2F:71:3E:C5:1F,3761804,474477267,84,10254,3761720,474467013,0,328,28258,265,20638,63,7620,91,2,112,4,0,5,130000.0,39000.0,-71.0,-70.0,-66.0,-60.0,-70.0,-69.0,-66.0,-61.0,-90.0,-92.0,-88.0,-91.0,19.0,22.0,22.0,31.0,1
467,BA:8C:B9:54:50:24,3761984,474549348,264,82335,3761720,474467013,0,1139,129217,1121,126371,18,2846,178,2,369,4,0,7,229410.0,130000.0,-40.0,-37.0,-45.0,-51.0,-41.0,-35.0,-43.0,-48.0,-90.0,-92.0,-88.0,-91.0,50.0,55.0,43.0,40.0,1
468,92:69:1D:31:68:E9,3774499,489719210,12779,15252197,3761720,474467013,3,19227,3552484,18532,3392627,695,159857,6441,105,14032,252,3,251,216660.0,130000.0,-52.0,-48.0,-43.0,-47.0,-51.0,-49.0,-43.0,-47.0,-90.0,-92.0,-88.0,-91.0,38.0,44.0,45.0,44.0,1
469,CC:2F:71:3F:1F:24,3953350,700738964,191625,226271487,3761725,474467477,27,161065,184430041,160993,184420999,72,9042,154341,6,191623,20375,24,134,130000.0,39000.0,-69.0,-66.0,-71.0,-68.0,-69.0,-66.0,-70.0,-68.0,-90.0,-92.0,-88.0,-91.0,21.0,26.0,17.0,23.0,1
470,CC:2F:71:3E:C5:1F,3761809,474477731,84,10254,3761725,474467477,0,328,28258,265,20638,63,7620,91,2,112,4,0,5,130000.0,39000.0,-71.0,-70.0,-66.0,-60.0,-70.0,-69.0,-66.0,-61.0,-90.0,-92.0,-88.0,-91.0,19.0,22.0,22.0,31.0,1
471,BA:8C:B9:54:50:24,3761989,474549812,264,82335,3761725,474467477,0,1139,129217,1121,126371,18,2846,178,2,369,4,0,7,229410.0,130000.0,-40.0,-37.0,-45.0,-51.0,-41.0,-35.0,-43.0,-48.0,-90.0,-92.0,-88.0,-91.0,50.0,55.0,43.0,40.0,1
472,92:69:1D:31:68:E9,3774504,489719674,12779,15252197,3761725,474467477,3,19227,3552484,18532,3392627,695,159857,6441,105,14032,252,3,251,216660.0,130000.0,-52.0,-48.0,-43.0,-47.0,-51.0,-49.0,-43.0,-47.0,-90.0,-92.0,-88.0,-91.0,38.0,44.0,45.0,44.0,1
473,CC:2F:71:3F:1F:24,3953461,700857490,191731,226389483,3761730,474468007,27,161161,184543819,161089,184534777,72,9042,154430,6,191729,20383,24,134,130000.0,43333.0,-69.0,-66.0,-70.0,-68.0,-69.0,-66.0,-70.0,-68.0,-90.0,-92.0,-88.0,-91.0,21.0,26.0,18.0,23.0,1
474,CC:2F:71:3E:C5:1F,3761814,474478261,84,10254,3761730,474468007,0,328,28258,265,20638,63,7620,91,2,112,4,0,5,130000.0,39000.0,-71.0,-70.0,-66.0,-60.0,-70.0,-69.0,-66.0,-61.0,-90.0,-92.0,-88.0,-91.0,19.0,22.0,22.0,31.0,1
475,BA:8C:B9:54:50:24,3761994,474550342,264,82335,3761730,474468007,0,1139,129217,1121,126371,18,2846,178,2,369,4,0,7,229410.0,130000.0,-40.0,-37.0,-45.0,-51.0,-41.0,-35.0,-43.0,-48.0,-90.0,-92.0,-88.0,-91.0,50.0,55.0,43.0,40.0,1
476,92:69:1D:31:68:E9,3774509,489720204,12779,15252197,3761730,474468007,3,19227,3552484,18532,3392627,695,159857,6441,105,14032,252,3,251,216660.0,130000.0,-52.0,-48.0,-43.0,-47.0,-51.0,-49.0,-43.0,-47.0,-90.0,-92.0,-88.0,-91.0,38.0,44.0,45.0,44.0,1
477,CC:2F:71:3F:1F:24,3953572,700975019,191837,226506335,3761735,474468684,27,161251,184652605,161179,184643563,72,9042,154517,6,191835,20396,24,134,130000.0,43333.0,-69.0,-66.0,-71.0,-68.0,-69.0,-66.0,-70.0,-68.0,-90.0,-92.0,-88.0,-91.0,21.0,26.0,17.0,23.0,1
478,CC:2F:71:3E:C5:1F,3761819,474478938,84,10254,3761735,474468684,0,328,28258,265,20638,63,7620,91,2,112,4,0,5,130000.0,39000.0,-71.0,-70.0,-66.0,-60.0,-70.0,-69.0,-66.0,-61.0,-90.0,-92.0,-88.0,-91.0,19.0,22.0,22.0,31.0,1
479,BA:8C:B9:54:50:24,3761999,474551019,264,82335,3761735,474468684,0,1139,129217,1121,126371,18,2846,178,2,369,4,0,7,229410.0,130000.0,-40.0,-37.0,-45.0,-51.0,-41.0,-35.0,-43.0,-48.0,-90.0,-92.0,-88.0,-91.0,50.0,55.0,43.0,40.0,1
480,92:69:1D:31:68:E9,3774514,489720881,12779,15252197,3761735,474468684,3,19227,3552484,18532,3392627,695,159857,6441,105,14032,252,3,251,216660.0,130000.0,-52.0,-48.0,-43.0,-47.0,-51.0,-49.0,-43.0,-47.0,-90.0,-92.0,-88.0,-91.0,38.0,44.0,45.0,44.0,1
481,CC:2F:71:3F:1F:24,3953683,701094959,191943,226625811,3761740,474469148,27,161347,184769325,161275,184760283,72,9042,154605,6,191941,20413,24,134,130000.0,43333.0,-69.0,-66.0,-71.0,-68.0,-69.0,-66.0,-70.0,-68.0,-90.0,-91.0,-88.0,-91.0,21.0,25.0,17.0,23.0,1
482,CC:2F:71:3E:C5:1F,3761824,474479402,84,10254,3761740,474469148,0,328,28258,265,20638,63,7620,91,2,112,4,0,5,130000.0,39000.0,-71.0,-70.0,-66.0,-60.0,-70.0,-69.0,-66.0,-61.0,-90.0,-91.0,-88.0,-91.0,19.0,21.0,22.0,31.0,1
483,BA:8C:B9:54:50:24,3762004,474551483,264,82335,3761740,474469148,0,1139,129217,1121,126371,18,2846,178,2,369,4,0,7,229410.0,130000.0,-40.0,-37.0,-45.0,-51.0,-41.0,-35.0,-43.0,-48.0,-90.0,-91.0,-88.0,-91.0,50.0,54.0,43.0,40.0,1
484,92:69:1D:31:68:E9,3774519,489721345,12779,15252197,3761740,474469148,3,19227,3552484,18532,3392627,695,159857,6441,105,14032,252,3,251,216660.0,130000.0,-52.0,-48.0,-43.0,-47.0,-51.0,-49.0,-43.0,-47.0,-90.0,-91.0,-88.0,-91.0,38.0,43.0,45.0,44.0,1
485,CC:2F:71:3F:1F:24,3953792,701213509,192048,226743957,3761744,474469552,27,161441,184885719,161369,184876677,72,9042,154692,6,192046,20428,24,134,130000.0,43333.0,-69.0,-66.0,-70.0,-68.0,-69.0,-66.0,-70.0,-68.0,-90.0,-91.0,-88.0,-91.0,21.0,25.0,18.0,23.0,1
486,CC:2F:71:3E:C5:1F,3761828,474479806,84,10254,3761744,474469552,0,328,28258,265,20638,63,7620,91,2,112,4,0,5,130000.0,39000.0,-71.0,-70.0,-66.0,-60.0,-70.0,-69.0,-66.0,-61.0,-90.0,-91.0,-88.0,-91.0,19.0,21.0,22.0,31.0,1
487,BA:8C:B9:54:50:24,3762008,474551887,264,82335,3761744,474469552,0,1139,129217,1121,126371,18,2846,178,2,369,4,0,7,229410.0,130000.0,-40.0,-37.0,-45.0,-51.0,-41.0,-35.0,-43.0,-48.0,-90.0,-91.0,-88.0,-91.0,50.0,54.0,43.0,40.0,1
488,92:69:1D:31:68:E9,3774523,489721749,12779,15252197,3761744,474469552,3,19227,3552484,18532,3392627,695,159857,6441,105,14032,252,3,251,216660.0,130000.0,-52.0,-48.0,-43.0,-47.0,-51.0,-49.0,-43.0,-47.0,-90.0,-91.0,-88.0,-91.0,38.0,43.0,45.0,44.0,1
489,CC:2F:71:3F:1F:24,3953911,701337120,192163,226867164,3761748,474469956,27,161544,184999547,161472,184990505,72,9042,154789,6,192161,20445,24,134,130000.0,43333.0,-69.0,-66.0,-71.0,-68.0,-69.0,-66.0,-70.0,-68.0,-90.0,-91.0,-88.0,-91.0,21.0,25.0,17.0,23.0,1
490,CC:2F:71:3E:C5:1F,3761832,474480210,84,10254,3761748,474469956,0,328,28258,265,20638,63,7620,91,2,112,4,0,5,130000.0,39000.0,-71.0,-70.0,-66.0,-60.0,-70.0,-69.0,-66.0,-61.0,-90.0,-91.0,-88.0,-91.0,19.0,21.0,22.0,31.0,1
491,BA:8C:B9:54:50:24,3762012,474552291,264,82335,3761748,474469956,0,1139,129217,1121,126371,18,2846,178,2,369,4,0,7,229410.0,130000.0,-40.0,-37.0,-45.0,-51.0,-41.0,-35.0,-43.0,-48.0,-90.0,-91.0,-88.0,-91.0,50.0,54.0,43.0,40.0,1
492,92:69:1D:31:68:E9,3774527,489722153,12779,15252197,3761748,474469956,3,19227,3552484,18532,3392627,695,159857,6441,105,14032,252,3,251,216660.0,130000.0,-52.0,-48.0,-43.0,-47.0,-51.0,-49.0,-43.0,-47.0,-90.0,-91.0,-88.0,-91.0,38.0,43.0,45.0,44.0,1
493,CC:2F:71:3F:1F:24,3954023,701455990,192270,226985570,3761753,474470420,27,161636,185111369,161564,185102327,72,9042,154878,6,192268,20452,24,134,130000.0,43333.0,-69.0,-66.0,-71.0,-68.0,-68.0,-66.0,-70.0,-68.0,-90.0,-91.0,-88.0,-91.0,21.0,25.0,17.0,23.0,1
494,CC:2F:71:3E:C5:1F,3761837,474480674,84,10254,3761753,474470420,0,328,28258,265,20638,63,7620,91,2,112,4,0,5,130000.0,39000.0,-71.0,-70.0,-66.0,-60.0,-70.0,-69.0,-66.0,-61.0,-90.0,-91.0,-88.0,-91.0,19.0,21.0,22.0,31.0,1
495,BA:8C:B9:54:50:24,3762017,474552755,264,82335,3761753,474470420,0,1139,129217,1121,126371,18,2846,178,2,369,4,0,7,229410.0,130000.0,-40.0,-37.0,-45.0,-51.0,-41.0,-35.0,-43.0,-48.0,-90.0,-91.0,-88.0,-91.0,50.0,54.0,43.0,40.0,1
496,92:69:1D:31:68:E9,3774532,489722617,12779,15252197,3761753,474470420,3,19228,3552552,18533,3392695,695,159857,6441,105,14032,252,3,251,216660.0,130000.0,-52.0,-48.0,-43.0,-47.0,-51.0,-49.0,-43.0,-47.0,-90.0,-91.0,-88.0,-91.0,38.0,43.0,45.0,44.0,1
497,CC:2F:71:3F:1F:24,3954156,701588307,192377,227106600,3761779,474481707,27,161735,185225539,161662,185216379,73,9160,154971,6,192375,20472,24,134,130000.0,43333.0,-69.0,-66.0,-70.0,-68.0,-69.0,-66.0,-70.0,-68.0,-90.0,-91.0,-88.0,-91.0,21.0,25.0,18.0,23.0,1
498,CC:2F:71:3E:C5:1F,3761865,474492163,84,10254,3761781,474481909,0,328,28258,265,20638,63,7620,91,2,112,4,0,5,130000.0,39000.0,-71.0,-70.0,-66.0,-60.0,-70.0,-69.0,-66.0,-61.0,-90.0,-91.0,-88.0,-91.0,19.0,21.0,22.0,31.0,1
499,BA:8C:B9:54:50:24,3762045,474564244,264,82335,3761781,474481909,0,1139,129217,1121,126371,18,2846,178,2,369,4,0,7,229410.0,130000.0,-40.0,-37.0,-45.0,-51.0,-41.0,-35.0,-43.0,-48.0,-90.0,-91.0,-88.0,-91.0,50.0,54.0,43.0,40.0,1
500,92:69:1D:31:68:E9,3774560,489734106,12779,15252197,3761781,474481909,3,19231,3552923,18535,3392831,696,160092,6442,105,14032,252,3,251,216660.0,130000.0,-52.0,-48.0,-43.0,-47.0,-52.0,-48.0,-43.0,-47.0,-90.0,-91.0,-88.0,-91.0,38.0,43.0,45.0,44.0,1
501,CC:2F:71:3F:1F:24,3954274,701713449,192489,227231136,3761785,474482313,27,161838,185347631,161765,185338471,73,9160,155068,6,192487,20491,24,134,130000.0,43333.0,-69.0,-66.0,-71.0,-68.0,-69.0,-66.0,-70.0,-68.0,-90.0,-91.0,-88.0,-91.0,21.0,25.0,17.0,23.0,1
502,CC:2F:71:3E:C5:1F,3761870,474492627,84,10254,3761786,474482373,0,329,28328,266,20708,63,7620,91,2,113,4,0,5,130000.0,39000.0,-70.0,-70.0,-67.0,-60.0,-70.0,-69.0,-66.0,-61.0,-90.0,-91.0,-88.0,-91.0,20.0,21.0,21.0,31.0,1
503,BA:8C:B9:54:50:24,3762050,474564708,264,82335,3761786,474482373,0,1140,129285,1122,126439,18,2846,178,3,370,5,0,7,229410.0,130000.0,-40.0,-37.0,-46.0,-51.0,-41.0,-36.0,-44.0,-49.0,-90.0,-91.0,-88.0,-91.0,50.0,54.0,42.0,40.0,1
504,92:69:1D:31:68:E9,3774565,489734570,12779,15252197,3761786,474482373,3,19231,3552923,18535,3392831,696,160092,6442,105,14032,252,3,251,216660.0,130000.0,-52.0,-48.0,-43.0,-47.0,-52.0,-48.0,-43.0,-47.0,-90.0,-91.0,-88.0,-91.0,38.0,43.0,45.0,44.0,1
505,CC:2F:71:3F:1F:24,3954391,701835672,192601,227352729,3761790,474482943,27,161940,185467733,161867,185458573,73,9160,155161,6,192599,20495,24,134,130000.0,43333.0,-69.0,-66.0,-71.0,-68.0,-69.0,-66.0,-70.0,-68.0,-90.0,-91.0,-88.0,-91.0,21.0,25.0,17.0,23.0,1
506,CC:2F:71:3E:C5:1F,3761876,474493399,84,10254,3761792,474483145,0,330,28398,267,20778,63,7620,91,2,113,4,0,5,130000.0,39000.0,-70.0,-70.0,-66.0,-60.0,-70.0,-69.0,-66.0,-61.0,-90.0,-91.0,-88.0,-91.0,20.0,21.0,22.0,31.0,1
507,BA:8C:B9:54:50:24,3762056,474565480,264,82335,3761792,474483145,0,1141,129353,1123,126507,18,2846,178,3,370,5,0,7,229410.0,130000.0,-48.0,-35.0,-43.0,-45.0,-42.0,-36.0,-44.0,-48.0,-90.0,-91.0,-88.0,-91.0,42.0,56.0,45.0,46.0,1
508,92:69:1D:31:68:E9,3774571,489735342,12779,15252197,3761792,474483145,3,19231,3552923,18535,3392831,696,160092,6442,105,14032,252,3,251,216660.0,130000.0,-52.0,-48.0,-43.0,-47.0,-52.0,-48.0,-43.0,-47.0,-90.0,-91.0,-88.0,-91.0,38.0,43.0,45.0,44.0,1
509,CC:2F:71:3F:1F:24,3954504,701954460,192708,227470911,3761796,474483549,27,162037,185585927,161964,185576767,73,9160,155249,6,192705,20517,24,134,130000.0,43333.0,-69.0,-66.0,-71.0,-68.0,-68.0,-66.0,-70.0,-68.0,-90.0,-91.0,-88.0,-91.0,21.0,25.0,17.0,23.0,1
510,CC:2F:71:3E:C5:1F,3761880,474493803,84,10254,3761796,474483549,0,330,28398,267,20778,63,7620,91,2,113,4,0,5,130000.0,39000.0,-70.0,-70.0,-66.0,-60.0,-70.0,-69.0,-66.0,-61.0,-90.0,-91.0,-88.0,-91.0,20.0,21.0,22.0,31.0,1
511,BA:8C:B9:54:50:24,3762060,474565884,264,82335,3761796,474483549,0,1141,129353,1123,126507,18,2846,178,3,370,5,0,7,229410.0,130000.0,-48.0,-35.0,-43.0,-45.0,-42.0,-36.0,-44.0,-48.0,-90.0,-91.0,-88.0,-91.0,42.0,56.0,45.0,46.0,1
512,92:69:1D:31:68:E9,3774575,489735746,12779,15252197,3761796,474483549,3,19231,3552923,18535,3392831,696,160092,6442,105,14032,252,3,251,216660.0,130000.0,-52.0,-48.0,-43.0,-47.0,-52.0,-48.0,-43.0,-47.0,-90.0,-91.0,-88.0,-91.0,38.0,43.0,45.0,44.0,1
513,CC:2F:71:3F:1F:24,3954617,702076494,192818,227592683,3761799,474483811,27,162134,185702653,162061,185693493,73,9160,155341,6,192815,20526,24,134,130000.0,43333.0,-69.0,-66.0,-71.0,-68.0,-69.0,-66.0,-70.0,-68.0,-90.0,-91.0,-88.0,-91.0,21.0,25.0,17.0,23.0,1
514,CC:2F:71:3E:C5:1F,3761885,474494267,84,10254,3761801,474484013,0,330,28398,267,20778,63,7620,91,2,113,4,0,5,130000.0,39000.0,-70.0,-70.0,-66.0,-60.0,-70.0,-69.0,-66.0,-61.0,-90.0,-91.0,-88.0,-91.0,20.0,21.0,22.0,31.0,1
515,BA:8C:B9:54:50:24,3762065,474566348,264,82335,3761801,474484013,0,1141,129353,1123,126507,18,2846,178,3,370,5,0,7,229410.0,130000.0,-48.0,-35.0,-43.0,-45.0,-42.0,-36.0,-44.0,-48.0,-90.0,-91.0,-88.0,-91.0,42.0,56.0,45.0,46.0,1
516,92:69:1D:31:68:E9,3774580,489736210,12779,15252197,3761801,474484013,3,19231,3552923,18535,3392831,696,160092,6442,105,14032,252,3,251,216660.0,130000.0,-52.0,-48.0,-43.0,-47.0,-52.0,-48.0,-43.0,-47.0,-90.0,-91.0,-88.0,-91.0,38.0,43.0,45.0,44.0,1
517,CC:2F:71:3F:1F:24,3954731,702195510,192926,227711093,3761805,474484417,27,162226,185814381,162153,185805221,73,9160,155430,6,192924,20544,24,134,117000.0,39000.0,-69.0,-66.0,-70.0,-68.0,-69.0,-66.0,-70.0,-68.0,-90.0,-91.0,-88.0,-91.0,21.0,25.0,18.0,23.0,1
518,CC:2F:71:3E:C5:1F,3761889,474494671,84,10254,3761805,474484417,0,330,28398,267,20778,63,7620,91,2,113,4,0,5,130000.0,39000.0,-70.0,-70.0,-66.0,-60.0,-70.0,-69.0,-66.0,-61.0,-90.0,-91.0,-88.0,-91.0,20.0,21.0,22.0,31.0,1
519,BA:8C:B9:54:50:24,3762069,474566752,264,82335,3761805,474484417,0,1141,129353,1123,126507,18,2846,178,3,370,5,0,7,229410.0,130000.0,-48.0,-35.0,-43.0,-45.0,-42.0,-36.0,-44.0,-48.0,-90.0,-91.0,-88.0,-91.0,42.0,56.0,45.0,46.0,1
520,92:69:1D:31:68:E9,3774584,489736614,12779,15252197,3761805,474484417,3,19231,3552923,18535,3392831,696,160092,6442,105,14032,252,3,251,216660.0,130000.0,-52.0,-48.0,-43.0,-47.0,-52.0,-48.0,-43.0,-47.0,-90.0,-91.0,-88.0,-91.0,38.0,43.0,45.0,44.0,1
521,CC:2F:71:3F:1F:24,3954848,702319031,193041,227834412,3761807,474484619,27,162328,185927976,162255,185918816,73,9160,155528,6,193039,20557,24,134,130000.0,43333.0,-69.0,-66.0,-71.0,-68.0,-68.0,-66.0,-70.0,-68.0,-90.0,-91.0,-88.0,-91.0,21.0,25.0,17.0,23.0,1
522,CC:2F:71:3E:C5:1F,3761893,474495075,84,10254,3761809,474484821,0,330,28398,267,20778,63,7620,91,2,113,4,0,5,130000.0,39000.0,-70.0,-70.0,-66.0,-60.0,-70.0,-69.0,-66.0,-61.0,-90.0,-91.0,-88.0,-91.0,20.0,21.0,22.0,31.0,1
523,BA:8C:B9:54:50:24,3762073,474567156,264,82335,3761809,474484821,0,1141,129353,1123,126507,18,2846,178,3,370,5,0,7,229410.0,130000.0,-48.0,-35.0,-43.0,-45.0,-42.0,-36.0,-44.0,-48.0,-90.0,-91.0,-88.0,-91.0,42.0,56.0,45.0,46.0,1
524,92:69:1D:31:68:E9,3774588,489737018,12779,15252197,3761809,474484821,3,19231,3552923,18535,3392831,696,160092,6442,105,14032,252,3,251,216660.0,130000.0,-52.0,-48.0,-43.0,-47.0,-52.0,-48.0,-43.0,-47.0,-90.0,-91.0,-88.0,-91.0,38.0,43.0,45.0,44.0,1
525,CC:2F:71:3F:1F:24,3954961,702436549,193147,227951264,3761814,474485285,27,162423,186044500,162350,186035340,73,9160,155615,6,193145,20565,24,134,130000.0,43333.0,-69.0,-66.0,-71.0,-68.0,-69.0,-66.0,-70.0,-68.0,-90.0,-92.0,-89.0,-92.0,21.0,26.0,18.0,24.0,1
526,CC:2F:71:3E:C5:1F,3761898,474495539,84,10254,3761814,474485285,0,330,28398,267,20778,63,7620,91,2,113,4,0,5,130000.0,39000.0,-70.0,-70.0,-66.0,-60.0,-70.0,-69.0,-66.0,-61.0,-90.0,-92.0,-89.0,-92.0,20.0,22.0,23.0,32.0,1
527,BA:8C:B9:54:50:24,3762078,474567620,264,82335,3761814,474485285,0,1141,129353,1123,126507,18,2846,178,3,370,5,0,7,229410.0,130000.0,-48.0,-35.0,-43.0,-45.0,-42.0,-36.0,-44.0,-48.0,-90.0,-92.0,-89.0,-92.0,42.0,57.0,46.0,47.0,1
528,92:69:1D:31:68:E9,3774593,489737482,12779,15252197,3761814,474485285,3,19231,3552923,18535,3392831,696,160092,6442,105,14032,252,3,251,216660.0,130000.0,-52.0,-48.0,-43.0,-47.0,-52.0,-48.0,-43.0,-47.0,-90.0,-92.0,-89.0,-92.0,38.0,44.0,46.0,45.0,1
529,CC:2F:71:3F:1F:24,3955070,702555076,193253,228069316,3761817,474485760,27,162513,186154568,162440,186145408,73,9160,155703,6,193251,20579,24,134,130000.0,43333.0,-69.0,-66.0,-70.0,-68.0,-69.0,-66.0,-70.0,-68.0,-90.0,-92.0,-89.0,-92.0,21.0,26.0,19.0,24.0,1
530,CC:2F:71:3E:C5:1F,3761901,474496014,84,10254,3761817,474485760,0,330,28398,267,20778,63,7620,91,2,113,4,0,5,130000.0,39000.0,-70.0,-70.0,-66.0,-60.0,-70.0,-69.0,-66.0,-61.0,-90.0,-92.0,-89.0,-92.0,20.0,22.0,23.0,32.0,1
531,BA:8C:B9:54:50:24,3762083,474568297,264,82335,3761819,474485962,0,1141,129353,1123,126507,18,2846,178,3,370,5,0,7,229410.0,130000.0,-48.0,-35.0,-43.0,-45.0,-42.0,-36.0,-44.0,-48.0,-90.0,-92.0,-89.0,-92.0,42.0,57.0,46.0,47.0,1
532,92:69:1D:31:68:E9,3774598,489738159,12779,15252197,3761819,474485962,3,19231,3552923,18535,3392831,696,160092,6442,105,14032,252,3,251,216660.0,130000.0,-52.0,-48.0,-43.0,-47.0,-52.0,-48.0,-43.0,-47.0,-90.0,-92.0,-89.0,-92.0,38.0,44.0,46.0,45.0,1
533,CC:2F:71:3F:1F:24,3955183,702675512,193360,228189146,3761823,474486366,27,162606,186269284,162533,186260124,73,9160,155792,6,193358,20586,24,134,130000.0,43333.0,-69.0,-66.0,-71.0,-68.0,-69.0,-66.0,-70.0,-68.0,-90.0,-92.0,-89.0,-92.0,21.0,26.0,18.0,24.0,1
534,CC:2F:71:3E:C5:1F,3761908,474496680,84,10254,3761824,474486426,0,330,28398,267,20778,63,7620,91,2,113,4,0,5,130000.0,39000.0,-70.0,-70.0,-66.0,-60.0,-70.0,-69.0,-66.0,-61.0,-90.0,-92.0,-89.0,-92.0,20.0,22.0,23.0,32.0,1
535,BA:8C:B9:54:50:24,3762088,474568761,264,82335,3761824,474486426,0,1141,129353,1123,126507,18,2846,178,3,370,5,0,7,229410.0,130000.0,-48.0,-35.0,-43.0,-45.0,-42.0,-36.0,-44.0,-48.0,-90.0,-92.0,-89.0,-92.0,42.0,57.0,46.0,47.0,1
536,92:69:1D:31:68:E9,3774603,489738623,12779,15252197,3761824,474486426,3,19231,3552923,18535,3392831,696,160092,6442,105,14032,252,3,251,216660.0,130000.0,-52.0,-48.0,-43.0,-47.0,-52.0,-48.0,-43.0,-47.0,-90.0,-92.0,-89.0,-92.0,38.0,44.0,46.0,45.0,1
537,CC:2F:71:3F:1F:24,3955299,702797521,193473,228310893,3761826,474486628,27,162704,186380785,162631,186371625,73,9160,155887,6,193471,20597,24,134,130000.0,43333.0,-69.0,-66.0,-70.0,-68.0,-69.0,-66.0,-70.0,-68.0,-90.0,-92.0,-89.0,-92.0,21.0,26.0,19.0,24.0,1
538,CC:2F:71:3E:C5:1F,3761910,474496882,84,10254,3761826,474486628,0,330,28398,267,20778,63,7620,91,2,113,4,0,5,130000.0,39000.0,-70.0,-70.0,-66.0,-60.0,-70.0,-69.0,-66.0,-61.0,-90.0,-92.0,-89.0,-92.0,20.0,22.0,23.0,32.0,1
539,BA:8C:B9:54:50:24,3762090,474568963,264,82335,3761826,474486628,0,1141,129353,1123,126507,18,2846,178,3,370,5,0,7,229410.0,130000.0,-48.0,-35.0,-43.0,-45.0,-42.0,-36.0,-44.0,-48.0,-90.0,-92.0,-89.0,-92.0,42.0,57.0,46.0,47.0,1
540,92:69:1D:31:68:E9,3774607,489739027,12779,15252197,3761828,474486830,3,19231,3552923,18535,3392831,696,160092,6442,105,14032,252,3,251,216660.0,130000.0,-52.0,-48.0,-43.0,-47.0,-52.0,-48.0,-43.0,-47.0,-90.0,-92.0,-89.0,-92.0,38.0,44.0,46.0,45.0,1
541,CC:2F:71:3F:1F:24,3955407,702914351,193579,228427521,3761828,474486830,27,162794,186490853,162721,186481693,73,9160,155975,6,193577,20617,24,134,130000.0,43333.0,-69.0,-66.0,-71.0,-68.0,-69.0,-66.0,-70.0,-68.0,-90.0,-92.0,-89.0,-92.0,21.0,26.0,18.0,24.0,1
542,CC:2F:71:3E:C5:1F,3761914,474497286,84,10254,3761830,474487032,0,330,28398,267,20778,63,7620,91,2,113,4,0,5,130000.0,39000.0,-70.0,-70.0,-66.0,-60.0,-70.0,-69.0,-66.0,-61.0,-90.0,-92.0,-89.0,-92.0,20.0,22.0,23.0,32.0,1
543,BA:8C:B9:54:50:24,3762094,474569367,264,82335,3761830,474487032,0,1141,129353,1123,126507,18,2846,178,3,370,5,0,7,229410.0,130000.0,-48.0,-35.0,-43.0,-45.0,-42.0,-36.0,-44.0,-48.0,-90.0,-92.0,-89.0,-92.0,42.0,57.0,46.0,47.0,1
544,92:69:1D:31:68:E9,3774611,489739431,12779,15252197,3761832,474487234,3,19231,3552923,18535,3392831,696,160092,6442,105,14032,252,3,251,216660.0,130000.0,-52.0,-48.0,-43.0,-47.0,-52.0,-48.0,-43.0,-47.0,-90.0,-92.0,-89.0,-92.0,38.0,44.0,46.0,45.0,1
545,CC:2F:71:3F:1F:24,3955520,703033293,193685,228545797,3761835,474487496,27,162886,186602653,162813,186593493,73,9160,156063,6,193683,20625,24,134,130000.0,43333.0,-69.0,-66.0,-70.0,-68.0,-69.0,-66.0,-70.0,-68.0,-90.0,-92.0,-88.0,-91.0,21.0,26.0,18.0,23.0,1
546,CC:2F:71:3E:C5:1F,3761919,474497750,84,10254,3761835,474487496,0,330,28398,267,20778,63,7620,91,2,113,4,0,5,130000.0,39000.0,-70.0,-70.0,-66.0,-60.0,-70.0,-69.0,-66.0,-61.0,-90.0,-92.0,-88.0,-91.0,20.0,22.0,22.0,31.0,1
547,BA:8C:B9:54:50:24,3762099,474569831,264,82335,3761835,474487496,0,1141,129353,1123,126507,18,2846,178,3,370,5,0,7,229410.0,130000.0,-48.0,-35.0,-43.0,-45.0,-42.0,-36.0,-44.0,-48.0,-90.0,-92.0,-88.0,-91.0,42.0,57.0,45.0,46.0,1
548,92:69:1D:31:68:E9,3774614,489739693,12779,15252197,3761835,474487496,3,19231,3552923,18535,3392831,696,160092,6442,105,14032,252,3,251,216660.0,130000.0,-52.0,-48.0,-43.0,-47.0,-52.0,-48.0,-43.0,-47.0,-90.0,-92.0,-88.0,-91.0,38.0,44.0,45.0,44.0,1
549,CC:2F:71:3F:1F:24,3955629,703151901,193792,228664203,3761837,474487698,27,162975,186709729,162902,186700569,73,9160,156152,6,193790,20633,24,134,130000.0,43333.0,-70.0,-67.0,-71.0,-69.0,-70.0,-67.0,-71.0,-69.0,-90.0,-92.0,-88.0,-91.0,20.0,25.0,17.0,22.0,1
550,CC:2F:71:3E:C5:1F,3761921,474497952,84,10254,3761837,474487698,0,330,28398,267,20778,63,7620,91,2,113,4,0,5,130000.0,39000.0,-70.0,-70.0,-66.0,-60.0,-70.0,-69.0,-66.0,-61.0,-90.0,-92.0,-88.0,-91.0,20.0,22.0,22.0,31.0,1
551,BA:8C:B9:54:50:24,3762103,474570235,264,82335,3761839,474487900,0,1141,129353,1123,126507,18,2846,178,3,370,5,0,7,229410.0,130000.0,-48.0,-35.0,-43.0,-45.0,-42.0,-36.0,-44.0,-48.0,-90.0,-92.0,-88.0,-91.0,42.0,57.0,45.0,46.0,1
552,92:69:1D:31:68:E9,3774620,489740299,12779,15252197,3761841,474488102,3,19231,3552923,18535,3392831,696,160092,6442,105,14032,252,3,251,216660.0,130000.0,-52.0,-48.0,-43.0,-47.0,-52.0,-48.0,-43.0,-47.0,-90.0,-92.0,-88.0,-91.0,38.0,44.0,45.0,44.0,1
553,CC:2F:71:3F:1F:24,3955749,703274160,193906,228785856,3761843,474488304,27,163075,186825763,163002,186816603,73,9160,156247,6,193904,20649,24,134,130000.0,43333.0,-70.0,-67.0,-71.0,-69.0,-69.0,-67.0,-71.0,-69.0,-90.0,-92.0,-88.0,-91.0,20.0,25.0,17.0,22.0,1
554,CC:2F:71:3E:C5:1F,3761927,474498558,84,10254,3761843,474488304,0,330,28398,267,20778,63,7620,91,2,113,4,0,5,130000.0,39000.0,-70.0,-70.0,-66.0,-60.0,-70.0,-69.0,-66.0,-61.0,-90.0,-92.0,-88.0,-91.0,20.0,22.0,22.0,31.0,1
555,BA:8C:B9:54:50:24,3762107,474570639,264,82335,3761843,474488304,0,1141,129353,1123,126507,18,2846,178,3,370,5,0,7,229410.0,130000.0,-48.0,-35.0,-43.0,-45.0,-42.0,-36.0,-44.0,-48.0,-90.0,-92.0,-88.0,-91.0,42.0,57.0,45.0,46.0,1
556,92:69:1D:31:68:E9,3774622,489740501,12779,15252197,3761843,474488304,3,19231,3552923,18535,3392831,696,160092,6442,105,14032,252,3,251,216660.0,130000.0,-52.0,-48.0,-43.0,-47.0,-52.0,-48.0,-43.0,-47.0,-90.0,-92.0,-88.0,-91.0,38.0,44.0,45.0,44.0,1
557,CC:2F:71:3F:1F:24,3955858,703392698,194012,228904132,3761846,474488566,27,163174,186947161,163101,186938001,73,9160,156335,6,194010,20655,24,134,130000.0,43333.0,-72.0,-70.0,-74.0,-72.0,-72.0,-70.0,-74.0,-72.0,-90.0,-92.0,-88.0,-91.0,18.0,22.0,14.0,19.0,1
558,CC:2F:71:3E:C5:1F,3761930,474498820,84,10254,3761846,474488566,0,330,28398,267,20778,63,7620,91,2,113,4,0,5,130000.0,39000.0,-70.0,-70.0,-66.0,-60.0,-70.0,-69.0,-66.0,-61.0,-90.0,-92.0,-88.0,-91.0,20.0,22.0,22.0,31.0,1
559,BA:8C:B9:54:50:24,3762110,474570901,264,82335,3761846,474488566,0,1141,129353,1123,126507,18,2846,178,3,370,5,0,7,229410.0,130000.0,-48.0,-35.0,-43.0,-45.0,-42.0,-36.0,-44.0,-48.0,-90.0,-92.0,-88.0,-91.0,42.0,57.0,45.0,46.0,1
560,92:69:1D:31:68:E9,3774627,489740965,12779,15252197,3761848,474488768,3,19231,3552923,18535,3392831,696,160092,6442,105,14032,252,3,251,216660.0,130000.0,-52.0,-48.0,-43.0,-47.0,-52.0,-48.0,-43.0,-47.0,-90.0,-92.0,-88.0,-91.0,38.0,44.0,45.0,44.0,1
561,CC:2F:71:3F:1F:24,3955972,703511658,194120,229022486,3761852,474489172,27,163271,187068107,163198,187058947,73,9160,156423,6,194118,20668,24,134,130000.0,39000.0,-73.0,-70.0,-75.0,-72.0,-72.0,-69.0,-74.0,-71.0,-90.0,-92.0,-88.0,-91.0,17.0,22.0,13.0,19.0,1
562,CC:2F:71:3E:C5:1F,3761937,474499486,85,10314,3761852,474489172,0,332,28538,269,20918,63,7620,91,2,114,4,0,5,130000.0,39000.0,-70.0,-70.0,-66.0,-60.0,-70.0,-70.0,-66.0,-61.0,-90.0,-92.0,-88.0,-91.0,20.0,22.0,22.0,31.0,1
563,BA:8C:B9:54:50:24,3762117,474571567,265,82395,3761852,474489172,0,1143,129489,1125,126643,18,2846,178,3,371,5,0,7,229410.0,130000.0,-40.0,-37.0,-46.0,-51.0,-42.0,-36.0,-44.0,-49.0,-90.0,-92.0,-88.0,-91.0,50.0,55.0,42.0,40.0,1
564,92:69:1D:31:68:E9,3774632,489741485,12780,15252313,3761852,474489172,3,19233,3553059,18537,3392967,696,160092,6442,105,14033,252,3,251,216660.0,130000.0,-52.0,-48.0,-43.0,-47.0,-52.0,-48.0,-43.0,-47.0,-90.0,-92.0,-88.0,-91.0,38.0,44.0,45.0,44.0,1
565,CC:2F:71:3F:1F:24,3956080,703629856,194226,229140482,3761854,474489374,27,163361,187178251,163288,187169091,73,9160,156509,6,194223,20674,24,134,130000.0,43333.0,-72.0,-70.0,-74.0,-72.0,-72.0,-69.0,-74.0,-71.0,-90.0,-92.0,-88.0,-91.0,18.0,22.0,14.0,19.0,1
566,CC:2F:71:3E:C5:1F,3761939,474499688,85,10314,3761854,474489374,0,332,28538,269,20918,63,7620,91,2,114,4,0,5,130000.0,39000.0,-70.0,-70.0,-66.0,-60.0,-70.0,-70.0,-66.0,-61.0,-90.0,-92.0,-88.0,-91.0,20.0,22.0,22.0,31.0,1
567,BA:8C:B9:54:50:24,3762120,474571829,265,82395,3761855,474489434,0,1144,129557,1126,126711,18,2846,178,3,371,5,0,7,229410.0,130000.0,-40.0,-37.0,-46.0,-51.0,-42.0,-36.0,-45.0,-49.0,-90.0,-92.0,-88.0,-91.0,50.0,55.0,42.0,40.0,1
568,92:69:1D:31:68:E9,3774635,489741747,12780,15252313,3761855,474489434,3,19233,3553059,18537,3392967,696,160092,6442,105,14033,252,3,251,216660.0,130000.0,-52.0,-48.0,-43.0,-47.0,-52.0,-48.0,-43.0,-47.0,-90.0,-92.0,-88.0,-91.0,38.0,44.0,45.0,44.0,1
569,CC:2F:71:3F:1F:24,3956211,703760777,194348,229270613,3761863,474490164,27,163477,187307862,163403,187298584,74,9278,156615,6,194346,20682,24,134,130000.0,43333.0,-69.0,-66.0,-71.0,-69.0,-72.0,-69.0,-74.0,-72.0,-90.0,-92.0,-88.0,-91.0,21.0,26.0,17.0,22.0,1
570,CC:2F:71:3E:C5:1F,3761948,474500478,85,10314,3761863,474490164,0,334,28726,270,20988,64,7738,92,2,114,4,0,5,130000.0,39000.0,-70.0,-70.0,-66.0,-60.0,-70.0,-70.0,-66.0,-60.0,-90.0,-92.0,-88.0,-91.0,20.0,22.0,22.0,31.0,1
571,BA:8C:B9:54:50:24,3762128,474572559,265,82395,3761863,474490164,0,1144,129557,1126,126711,18,2846,178,3,371,5,0,7,229410.0,130000.0,-40.0,-37.0,-46.0,-51.0,-42.0,-36.0,-45.0,-49.0,-90.0,-92.0,-88.0,-91.0,50.0,55.0,42.0,40.0,1
572,92:69:1D:31:68:E9,3774643,489742477,12780,15252313,3761863,474490164,3,19233,3553059,18537,3392967,696,160092,6442,105,14033,252,3,251,216660.0,130000.0,-52.0,-48.0,-43.0,-47.0,-52.0,-48.0,-43.0,-47.0,-90.0,-92.0,-88.0,-91.0,38.0,44.0,45.0,44.0,1
573,CC:2F:71:3F:1F:24,3956320,703879161,194455,229388795,3761865,474490366,27,163573,187424496,163499,187415218,74,9278,156703,6,194453,20691,24,134,130000.0,43333.0,-73.0,-70.0,-74.0,-73.0,-73.0,-70.0,-74.0,-72.0,-90.0,-92.0,-88.0,-91.0,17.0,22.0,14.0,18.0,1
574,CC:2F:71:3E:C5:1F,3761950,474500680,85,10314,3761865,474490366,0,334,28726,270,20988,64,7738,92,2,114,4,0,5,130000.0,39000.0,-70.0,-70.0,-66.0,-60.0,-70.0,-70.0,-66.0,-60.0,-90.0,-92.0,-88.0,-91.0,20.0,22.0,22.0,31.0,1
575,BA:8C:B9:54:50:24,3762130,474572761,265,82395,3761865,474490366,0,1144,129557,1126,126711,18,2846,178,3,371,5,0,7,229410.0,130000.0,-40.0,-37.0,-46.0,-51.0,-42.0,-36.0,-45.0,-49.0,-90.0,-92.0,-88.0,-91.0,50.0,55.0,42.0,40.0,1
576,92:69:1D:31:68:E9,3774645,489742679,12780,15252313,3761865,474490366,3,19233,3553059,18537,3392967,696,160092,6442,105,14033,252,3,251,216660.0,130000.0,-52.0,-48.0,-43.0,-47.0,-52.0,-48.0,-43.0,-47.0,-90.0,-92.0,-88.0,-91.0,38.0,44.0,45.0,44.0,1
577,CC:2F:71:3F:1F:24,3956433,703998103,194561,229507071,3761872,474491032,27,163667,187537904,163593,187528626,74,9278,156793,6,194559,20691,24,134,130000.0,43333.0,-70.0,-66.0,-71.0,-69.0,-72.0,-68.0,-73.0,-71.0,-90.0,-92.0,-88.0,-91.0,20.0,26.0,17.0,22.0,1
578,CC:2F:71:3E:C5:1F,3761957,474501346,85,10314,3761872,474491032,0,334,28726,270,20988,64,7738,92,2,114,4,0,5,130000.0,39000.0,-70.0,-70.0,-66.0,-60.0,-70.0,-70.0,-66.0,-60.0,-90.0,-92.0,-88.0,-91.0,20.0,22.0,22.0,31.0,1
579,BA:8C:B9:54:50:24,3762137,474573427,265,82395,3761872,474491032,0,1144,129557,1126,126711,18,2846,178,3,371,5,0,7,229410.0,130000.0,-40.0,-37.0,-46.0,-51.0,-42.0,-36.0,-45.0,-49.0,-90.0,-92.0,-88.0,-91.0,50.0,55.0,42.0,40.0,1
580,92:69:1D:31:68:E9,3774652,489743345,12780,15252313,3761872,474491032,3,19233,3553059,18537,3392967,696,160092,6442,105,14033,252,3,251,216660.0,130000.0,-52.0,-48.0,-43.0,-47.0,-52.0,-48.0,-43.0,-47.0,-90.0,-92.0,-88.0,-91.0,38.0,44.0,45.0,44.0,1
581,CC:2F:71:3F:1F:24,3956540,704115027,194666,229623793,3761874,474491234,27,163761,187651546,163687,187642268,74,9278,156880,6,194664,20691,24,134,130000.0,43333.0,-70.0,-66.0,-71.0,-70.0,-70.0,-66.0,-71.0,-69.0,-90.0,-92.0,-88.0,-91.0,20.0,26.0,17.0,21.0,1
582,CC:2F:71:3E:C5:1F,3761959,474501548,85,10314,3761874,474491234,0,334,28726,270,20988,64,7738,92,2,114,4,0,5,130000.0,39000.0,-70.0,-70.0,-66.0,-60.0,-70.0,-70.0,-66.0,-60.0,-90.0,-92.0,-88.0,-91.0,20.0,22.0,22.0,31.0,1
583,BA:8C:B9:54:50:24,3762139,474573629,265,82395,3761874,474491234,0,1144,129557,1126,126711,18,2846,178,3,371,5,0,7,229410.0,130000.0,-40.0,-37.0,-46.0,-51.0,-42.0,-36.0,-45.0,-49.0,-90.0,-92.0,-88.0,-91.0,50.0,55.0,42.0,40.0,1
584,92:69:1D:31:68:E9,3774655,489743820,12780,15252313,3761875,474491507,3,19233,3553059,18537,3392967,696,160092,6442,105,14033,252,3,251,216660.0,130000.0,-52.0,-48.0,-43.0,-47.0,-52.0,-48.0,-43.0,-47.0,-90.0,-92.0,-88.0,-91.0,38.0,44.0,45.0,44.0,1
585,CC:2F:71:3F:1F:24,3956660,704238853,194779,229746740,3761881,474492113,27,163861,187767579,163787,187758301,74,9278,156975,6,194777,20695,24,134,130000.0,43333.0,-70.0,-66.0,-71.0,-69.0,-69.0,-66.0,-70.0,-69.0,-90.0,-92.0,-88.0,-91.0,20.0,26.0,17.0,22.0,1
586,CC:2F:71:3E:C5:1F,3761966,474502427,85,10314,3761881,474492113,0,334,28726,270,20988,64,7738,92,2,114,4,0,5,130000.0,39000.0,-70.0,-70.0,-66.0,-60.0,-70.0,-70.0,-66.0,-60.0,-90.0,-92.0,-88.0,-91.0,20.0,22.0,22.0,31.0,1
587,BA:8C:B9:54:50:24,3762146,474574508,265,82395,3761881,474492113,0,1144,129557,1126,126711,18,2846,178,3,371,5,0,7,229410.0,130000.0,-40.0,-37.0,-46.0,-51.0,-42.0,-36.0,-45.0,-49.0,-90.0,-92.0,-88.0,-91.0,50.0,55.0,42.0,40.0,1
588,92:69:1D:31:68:E9,3774661,489744426,12780,15252313,3761881,474492113,3,19233,3553059,18537,3392967,696,160092,6442,105,14033,252,3,251,216660.0,130000.0,-52.0,-48.0,-43.0,-47.0,-52.0,-48.0,-43.0,-47.0,-90.0,-92.0,-88.0,-91.0,38.0,44.0,45.0,44.0,1
589,CC:2F:71:3F:1F:24,3956771,704358021,194887,229865646,3761884,474492375,27,163954,187878105,163880,187868827,74,9278,157064,6,194885,20695,24,134,130000.0,43333.0,-70.0,-66.0,-71.0,-70.0,-70.0,-66.0,-70.0,-70.0,-90.0,-92.0,-88.0,-91.0,20.0,26.0,17.0,21.0,1
590,CC:2F:71:3E:C5:1F,3761969,474502689,85,10314,3761884,474492375,0,334,28726,270,20988,64,7738,92,2,114,4,0,5,130000.0,39000.0,-70.0,-70.0,-66.0,-60.0,-70.0,-70.0,-66.0,-60.0,-90.0,-92.0,-88.0,-91.0,20.0,22.0,22.0,31.0,1
591,BA:8C:B9:54:50:24,3762149,474574770,265,82395,3761884,474492375,0,1144,129557,1126,126711,18,2846,178,3,371,5,0,7,229410.0,130000.0,-40.0,-37.0,-46.0,-51.0,-42.0,-36.0,-45.0,-49.0,-90.0,-92.0,-88.0,-91.0,50.0,55.0,42.0,40.0,1
592,92:69:1D:31:68:E9,3774664,489744688,12780,15252313,3761884,474492375,3,19233,3553059,18537,3392967,696,160092,6442,105,14033,252,3,251,216660.0,130000.0,-52.0,-48.0,-43.0,-47.0,-52.0,-48.0,-43.0,-47.0,-90.0,-92.0,-88.0,-91.0,38.0,44.0,45.0,44.0,1
593,CC:2F:71:3F:1F:24,3956884,704476865,194994,229983884,3761890,474492981,27,164048,187990325,163974,187981047,74,9278,157152,6,194992,20700,24,134,130000.0,39000.0,-69.0,-66.0,-71.0,-69.0,-69.0,-66.0,-70.0,-69.0,-90.0,-92.0,-88.0,-91.0,21.0,26.0,17.0,22.0,1
594,CC:2F:71:3E:C5:1F,3761975,474503295,85,10314,3761890,474492981,0,334,28726,270,20988,64,7738,92,2,114,4,0,5,130000.0,39000.0,-70.0,-70.0,-66.0,-60.0,-70.0,-70.0,-66.0,-60.0,-90.0,-92.0,-88.0,-91.0,20.0,22.0,22.0,31.0,1
595,BA:8C:B9:54:50:24,3762155,474575376,265,82395,3761890,474492981,0,1144,129557,1126,126711,18,2846,178,3,371,5,0,7,229410.0,130000.0,-40.0,-37.0,-46.0,-51.0,-42.0,-36.0,-45.0,-49.0,-90.0,-92.0,-88.0,-91.0,50.0,55.0,42.0,40.0,1
596,92:69:1D:31:68:E9,3774670,489745294,12780,15252313,3761890,474492981,3,19233,3553059,18537,3392967,696,160092,6442,105,14033,252,3,251,216660.0,130000.0,-52.0,-48.0,-43.0,-47.0,-52.0,-48.0,-43.0,-47.0,-90.0,-92.0,-88.0,-91.0,38.0,44.0,45.0,44.0,1
597,CC:2F:71:3F:1F:24,3956992,704593863,195100,230100680,3761892,474493183,27,164138,188100407,164064,188091129,74,9278,157239,6,195098,20701,24,134,130000.0,43333.0,-69.0,-67.0,-70.0,-69.0,-69.0,-66.0,-70.0,-69.0,-90.0,-92.0,-88.0,-91.0,21.0,25.0,18.0,22.0,1
598,CC:2F:71:3E:C5:1F,3761977,474503497,85,10314,3761892,474493183,0,334,28726,270,20988,64,7738,92,2,114,4,0,5,130000.0,39000.0,-70.0,-70.0,-66.0,-60.0,-70.0,-70.0,-66.0,-60.0,-90.0,-92.0,-88.0,-91.0,20.0,22.0,22.0,31.0,1
599,BA:8C:B9:54:50:24,3762157,474575578,265,82395,3761892,474493183,0,1144,129557,1126,126711,18,2846,178,3,371,5,0,7,229410.0,130000.0,-40.0,-37.0,-46.0,-51.0,-42.0,-36.0,-45.0,-49.0,-90.0,-93.0,-89.0,-92.0,50.0,56.0,43.0,41.0,1
600,92:69:1D:31:68:E9,3774673,489745556,12780,15252313,3761893,474493243,3,19233,3553059,18537,3392967,696,160092,6442,105,14033,252,3,251,216660.0,130000.0,-52.0,-48.0,-43.0,-47.0,-52.0,-48.0,-43.0,-47.0,-90.0,-93.0,-89.0,-92.0,38.0,45.0,46.0,45.0,1
601,CC:2F:71:3F:1F:24,3957112,704716276,195213,230222427,3761899,474493849,27,164236,188211969,164162,188202691,74,9278,157333,6,195211,20703,24,134,130000.0,43333.0,-69.0,-66.0,-70.0,-68.0,-69.0,-66.0,-70.0,-68.0,-90.0,-93.0,-89.0,-92.0,21.0,27.0,19.0,24.0,1
602,CC:2F:71:3E:C5:1F,3761984,474504163,85,10314,3761899,474493849,0,334,28726,270,20988,64,7738,92,2,114,4,0,5,130000.0,39000.0,-70.0,-70.0,-66.0,-60.0,-70.0,-70.0,-66.0,-60.0,-90.0,-93.0,-89.0,-92.0,20.0,23.0,23.0,32.0,1
603,BA:8C:B9:54:50:24,3762164,474576244,265,82395,3761899,474493849,0,1144,129557,1126,126711,18,2846,178,3,371,5,0,7,229410.0,130000.0,-40.0,-37.0,-46.0,-51.0,-42.0,-36.0,-45.0,-49.0,-90.0,-93.0,-89.0,-92.0,50.0,56.0,43.0,41.0,1
604,92:69:1D:31:68:E9,3774679,489746162,12780,15252313,3761899,474493849,3,19233,3553059,18537,3392967,696,160092,6442,105,14033,252,3,251,216660.0,130000.0,-52.0,-48.0,-43.0,-47.0,-52.0,-48.0,-43.0,-47.0,-90.0,-93.0,-89.0,-92.0,38.0,45.0,46.0,45.0,1
605,CC:2F:71:3F:1F:24,3957218,704832846,195317,230338795,3761901,474494051,27,164326,188319175,164252,188309897,74,9278,157422,6,195315,20709,24,134,130000.0,43333.0,-70.0,-66.0,-71.0,-69.0,-69.0,-66.0,-70.0,-69.0,-90.0,-93.0,-89.0,-92.0,20.0,27.0,18.0,23.0,1
606,CC:2F:71:3E:C5:1F,3761986,474504365,85,10314,3761901,474494051,0,334,28726,270,20988,64,7738,92,2,114,4,0,5,130000.0,39000.0,-70.0,-70.0,-66.0,-60.0,-70.0,-70.0,-66.0,-60.0,-90.0,-93.0,-89.0,-92.0,20.0,23.0,23.0,32.0,1
607,BA:8C:B9:54:50:24,3762166,474576446,265,82395,3761901,474494051,0,1144,129557,1126,126711,18,2846,178,3,371,5,0,7,229410.0,130000.0,-40.0,-37.0,-46.0,-51.0,-42.0,-36.0,-45.0,-49.0,-90.0,-93.0,-89.0,-92.0,50.0,56.0,43.0,41.0,1
608,92:69:1D:31:68:E9,3774681,489746364,12780,15252313,3761901,474494051,3,19233,3553059,18537,3392967,696,160092,6442,105,14033,252,3,251,216660.0,130000.0,-52.0,-48.0,-43.0,-47.0,-52.0,-48.0,-43.0,-47.0,-90.0,-93.0,-89.0,-92.0,38.0,45.0,46.0,45.0,1
609,CC:2F:71:3F:1F:24,3957333,704953472,195425,230458755,3761908,474494717,27,164421,188434151,164347,188424873,74,9278,157511,6,195423,20710,24,134,130000.0,43333.0,-69.0,-66.0,-70.0,-68.0,-69.0,-66.0,-70.0,-68.0,-90.0,-93.0,-89.0,-92.0,21.0,27.0,19.0,24.0,1
610,CC:2F:71:3E:C5:1F,3761993,474505031,85,10314,3761908,474494717,0,335,28796,271,21058,64,7738,92,2,115,4,0,5,130000.0,39000.0,-79.0,-86.0,-74.0,-72.0,-71.0,-72.0,-67.0,-61.0,-90.0,-93.0,-89.0,-92.0,11.0,7.0,15.0,20.0,1
611,BA:8C:B9:54:50:24,3762173,474577112,265,82395,3761908,474494717,0,1146,129693,1128,126847,18,2846,178,3,372,5,0,7,229410.0,130000.0,-48.0,-35.0,-43.0,-45.0,-43.0,-36.0,-44.0,-48.0,-90.0,-93.0,-89.0,-92.0,42.0,58.0,46.0,47.0,1
612,92:69:1D:31:68:E9,3774688,489747030,12780,15252313,3761908,474494717,3,19235,3553195,18539,3393103,696,160092,6442,105,14034,252,3,251,216660.0,130000.0,-52.0,-50.0,-43.0,-47.0,-52.0,-49.0,-43.0,-47.0,-90.0,-93.0,-89.0,-92.0,38.0,43.0,46.0,45.0,1
613,CC:2F:71:3F:1F:24,3957440,705071804,195530,230576885,3761910,474494919,27,164517,188552201,164443,188542923,74,9278,157600,6,195528,20711,24,134,130000.0,43333.0,-69.0,-66.0,-70.0,-69.0,-69.0,-66.0,-70.0,-68.0,-90.0,-93.0,-89.0,-92.0,21.0,27.0,19.0,23.0,1
614,CC:2F:71:3E:C5:1F,3761995,474505233,85,10314,3761910,474494919,0,336,28866,272,21128,64,7738,92,2,115,4,0,5,130000.0,39000.0,-70.0,-70.0,-67.0,-60.0,-71.0,-72.0,-67.0,-61.0,-90.0,-93.0,-89.0,-92.0,20.0,23.0,22.0,32.0,1
615,BA:8C:B9:54:50:24,3762175,474577314,265,82395,3761910,474494919,0,1146,129693,1128,126847,18,2846,178,3,372,5,0,7,229410.0,130000.0,-48.0,-35.0,-43.0,-45.0,-43.0,-36.0,-44.0,-48.0,-90.0,-93.0,-89.0,-92.0,42.0,58.0,46.0,47.0,1
616,92:69:1D:31:68:E9,3774690,489747232,12780,15252313,3761910,474494919,3,19235,3553195,18539,3393103,696,160092,6442,105,14034,252,3,251,216660.0,130000.0,-52.0,-50.0,-43.0,-47.0,-52.0,-49.0,-43.0,-47.0,-90.0,-93.0,-89.0,-92.0,38.0,43.0,46.0,45.0,1
617,CC:2F:71:3F:1F:24,3957559,705194719,195643,230699194,3761916,474495525,27,164616,188662407,164542,188653129,74,9278,157696,6,195641,20727,24,134,130000.0,43333.0,-69.0,-66.0,-70.0,-69.0,-69.0,-66.0,-70.0,-68.0,-90.0,-93.0,-89.0,-92.0,21.0,27.0,19.0,23.0,1
618,CC:2F:71:3E:C5:1F,3762001,474505839,85,10314,3761916,474495525,0,336,28866,272,21128,64,7738,92,2,115,4,0,5,130000.0,39000.0,-70.0,-70.0,-67.0,-60.0,-71.0,-72.0,-67.0,-61.0,-90.0,-93.0,-89.0,-92.0,20.0,23.0,22.0,32.0,1
619,BA:8C:B9:54:50:24,3762181,474577920,265,82395,3761916,474495525,0,1146,129693,1128,126847,18,2846,178,3,372,5,0,7,229410.0,130000.0,-48.0,-35.0,-43.0,-45.0,-43.0,-36.0,-44.0,-48.0,-90.0,-93.0,-89.0,-92.0,42.0,58.0,46.0,47.0,1
620,92:69:1D:31:68:E9,3774696,489747838,12780,15252313,3761916,474495525,3,19235,3553195,18539,3393103,696,160092,6442,105,14034,252,3,251,216660.0,130000.0,-52.0,-50.0,-43.0,-47.0,-52.0,-49.0,-43.0,-47.0,-90.0,-93.0,-89.0,-92.0,38.0,43.0,46.0,45.0,1
621,CC:2F:71:3F:1F:24,3957667,705312903,195748,230817116,3761919,474495787,27,164714,188783483,164640,188774205,74,9278,157784,6,195746,20731,24,134,130000.0,43333.0,-69.0,-66.0,-70.0,-69.0,-69.0,-66.0,-70.0,-68.0,-90.0,-93.0,-89.0,-92.0,21.0,27.0,19.0,23.0,1
622,CC:2F:71:3E:C5:1F,3762004,474506101,85,10314,3761919,474495787,0,336,28866,272,21128,64,7738,92,2,115,4,0,5,130000.0,39000.0,-70.0,-70.0,-67.0,-60.0,-71.0,-72.0,-67.0,-61.0,-90.0,-93.0,-89.0,-92.0,20.0,23.0,22.0,32.0,1
623,BA:8C:B9:54:50:24,3762184,474578182,265,82395,3761919,474495787,0,1146,129693,1128,126847,18,2846,178,3,372,5,0,7,229410.0,130000.0,-48.0,-35.0,-43.0,-45.0,-43.0,-36.0,-44.0,-48.0,-90.0,-93.0,-89.0,-92.0,42.0,58.0,46.0,47.0,1
624,92:69:1D:31:68:E9,3774699,489748100,12780,15252313,3761919,474495787,3,19235,3553195,18539,3393103,696,160092,6442,105,14034,252,3,251,216660.0,130000.0,-52.0,-50.0,-43.0,-47.0,-52.0,-49.0,-43.0,-47.0,-90.0,-93.0,-89.0,-92.0,38.0,43.0,46.0,45.0,1
625,CC:2F:71:3F:1F:24,3957782,705436575,195857,230940182,3761925,474496393,27,164813,188903315,164739,188894037,74,9278,157875,6,195854,20731,24,134,130000.0,43333.0,-69.0,-66.0,-70.0,-69.0,-69.0,-66.0,-70.0,-68.0,-90.0,-93.0,-89.0,-92.0,21.0,27.0,19.0,23.0,1
626,CC:2F:71:3E:C5:1F,3762010,474506707,85,10314,3761925,474496393,0,336,28866,272,21128,64,7738,92,2,115,4,0,5,130000.0,39000.0,-70.0,-70.0,-67.0,-60.0,-71.0,-72.0,-67.0,-61.0,-90.0,-93.0,-89.0,-92.0,20.0,23.0,22.0,32.0,1
627,BA:8C:B9:54:50:24,3762190,474578788,265,82395,3761925,474496393,0,1146,129693,1128,126847,18,2846,178,3,372,5,0,7,229410.0,130000.0,-48.0,-35.0,-43.0,-45.0,-43.0,-36.0,-44.0,-48.0,-90.0,-93.0,-89.0,-92.0,42.0,58.0,46.0,47.0,1
628,92:69:1D:31:68:E9,3774705,489748706,12780,15252313,3761925,474496393,3,19235,3553195,18539,3393103,696,160092,6442,105,14034,252,3,251,216660.0,130000.0,-52.0,-50.0,-43.0,-47.0,-52.0,-49.0,-43.0,-47.0,-90.0,-93.0,-89.0,-92.0,38.0,43.0,46.0,45.0,1
629,CC:2F:71:3F:1F:24,3957887,705553071,195960,231056476,3761927,474496595,27,164912,189024739,164838,189015461,74,9278,157963,6,195958,20738,24,134,130000.0,39000.0,-69.0,-66.0,-70.0,-69.0,-68.0,-66.0,-70.0,-68.0,-90.0,-93.0,-89.0,-92.0,21.0,27.0,19.0,23.0,1
630,CC:2F:71:3E:C5:1F,3762012,474506909,85,10314,3761927,474496595,0,336,28866,272,21128,64,7738,92,2,115,4,0,5,130000.0,39000.0,-70.0,-70.0,-67.0,-60.0,-71.0,-72.0,-67.0,-61.0,-90.0,-93.0,-89.0,-92.0,20.0,23.0,22.0,32.0,1
631,BA:8C:B9:54:50:24,3762192,474578990,265,82395,3761927,474496595,0,1146,129693,1128,126847,18,2846,178,3,372,5,0,7,229410.0,130000.0,-48.0,-35.0,-43.0,-45.0,-43.0,-36.0,-44.0,-48.0,-90.0,-93.0,-89.0,-92.0,42.0,58.0,46.0,47.0,1
632,92:69:1D:31:68:E9,3774707,489748908,12780,15252313,3761927,474496595,3,19235,3553195,18539,3393103,696,160092,6442,105,14034,252,3,251,216660.0,130000.0,-52.0,-50.0,-43.0,-47.0,-52.0,-49.0,-43.0,-47.0,-90.0,-93.0,-89.0,-92.0,38.0,43.0,46.0,45.0,1
633,CC:2F:71:3F:1F:24,3958010,705681514,196076,231184253,3761934,474497261,27,165023,189150001,164949,189140723,74,9278,158061,6,196074,20738,24,134,130000.0,43333.0,-69.0,-66.0,-70.0,-68.0,-69.0,-66.0,-70.0,-68.0,-90.0,-93.0,-89.0,-92.0,21.0,27.0,19.0,24.0,1
634,CC:2F:71:3E:C5:1F,3762019,474507575,85,10314,3761934,474497261,0,336,28866,272,21128,64,7738,92,2,115,4,0,5,130000.0,39000.0,-70.0,-70.0,-67.0,-60.0,-71.0,-72.0,-67.0,-61.0,-90.0,-93.0,-89.0,-92.0,20.0,23.0,22.0,32.0,1
635,BA:8C:B9:54:50:24,3762199,474579656,265,82395,3761934,474497261,0,1146,129693,1128,126847,18,2846,178,3,372,5,0,7,229410.0,130000.0,-48.0,-35.0,-43.0,-45.0,-43.0,-36.0,-44.0,-48.0,-90.0,-93.0,-89.0,-92.0,42.0,58.0,46.0,47.0,1
636,92:69:1D:31:68:E9,3774714,489749574,12780,15252313,3761934,474497261,3,19235,3553195,18539,3393103,696,160092,6442,105,14034,252,3,251,216660.0,130000.0,-52.0,-50.0,-43.0,-47.0,-52.0,-49.0,-43.0,-47.0,-90.0,-93.0,-89.0,-92.0,38.0,43.0,46.0,45.0,1
637,CC:2F:71:3F:1F:24,3958120,705801634,196183,231303898,3761937,474497736,27,165118,189262112,165044,189252834,74,9278,158154,6,196181,20742,24,134,130000.0,43333.0,-69.0,-66.0,-70.0,-69.0,-69.0,-66.0,-70.0,-68.0,-90.0,-93.0,-89.0,-92.0,21.0,27.0,19.0,23.0,1
638,CC:2F:71:3E:C5:1F,3762022,474508050,85,10314,3761937,474497736,0,336,28866,272,21128,64,7738,92,2,115,4,0,5,130000.0,39000.0,-70.0,-70.0,-67.0,-60.0,-71.0,-72.0,-67.0,-61.0,-90.0,-93.0,-89.0,-92.0,20.0,23.0,22.0,32.0,1
639,BA:8C:B9:54:50:24,3762202,474580131,265,82395,3761937,474497736,0,1146,129693,1128,126847,18,2846,178,3,372,5,0,7,229410.0,130000.0,-48.0,-35.0,-43.0,-45.0,-43.0,-36.0,-44.0,-48.0,-90.0,-93.0,-89.0,-92.0,42.0,58.0,46.0,47.0,1
640,92:69:1D:31:68:E9,3774717,489750049,12780,15252313,3761937,474497736,3,19235,3553195,18539,3393103,696,160092,6442,105,14034,252,3,251,216660.0,130000.0,-52.0,-50.0,-43.0,-47.0,-52.0,-49.0,-43.0,-47.0,-90.0,-93.0,-89.0,-92.0,38.0,43.0,46.0,45.0,1
641,CC:2F:71:3F:1F:24,3958232,705920446,196288,231422044,3761944,474498402,27,165209,189372296,165135,189363018,74,9278,158243,6,196286,20743,24,134,130000.0,43333.0,-69.0,-66.0,-70.0,-68.0,-69.0,-66.0,-70.0,-68.0,-90.0,-93.0,-89.0,-92.0,21.0,27.0,19.0,24.0,1
642,CC:2F:71:3E:C5:1F,3762029,474508716,85,10314,3761944,474498402,0,336,28866,272,21128,64,7738,92,2,115,4,0,5,130000.0,39000.0,-70.0,-70.0,-67.0,-60.0,-71.0,-72.0,-67.0,-61.0,-90.0,-93.0,-89.0,-92.0,20.0,23.0,22.0,32.0,1
643,BA:8C:B9:54:50:24,3762209,474580797,265,82395,3761944,474498402,0,1146,129693,1128,126847,18,2846,178,3,372,5,0,7,229410.0,130000.0,-48.0,-35.0,-43.0,-45.0,-43.0,-36.0,-44.0,-48.0,-90.0,-93.0,-89.0,-92.0,42.0,58.0,46.0,47.0,1
644,92:69:1D:31:68:E9,3774724,489750715,12780,15252313,3761944,474498402,3,19235,3553195,18539,3393103,696,160092,6442,105,14034,252,3,251,216660.0,130000.0,-52.0,-50.0,-43.0,-47.0,-52.0,-49.0,-43.0,-47.0,-90.0,-93.0,-89.0,-92.0,38.0,43.0,46.0,45.0,1
645,CC:2F:71:3F:1F:24,3958339,706038794,196393,231540190,3761946,474498604,27,165299,189481050,165225,189471772,74,9278,158330,6,196391,20743,24,134,130000.0,43333.0,-69.0,-66.0,-70.0,-69.0,-69.0,-66.0,-70.0,-68.0,-90.0,-93.0,-89.0,-92.0,21.0,27.0,19.0,23.0,1
646,CC:2F:71:3E:C5:1F,3762031,474508918,85,10314,3761946,474498604,0,336,28866,272,21128,64,7738,92,2,115,4,0,5,130000.0,39000.0,-70.0,-70.0,-67.0,-60.0,-71.0,-72.0,-67.0,-61.0,-90.0,-93.0,-89.0,-92.0,20.0,23.0,22.0,32.0,1
647,BA:8C:B9:54:50:24,3762211,474580999,265,82395,3761946,474498604,0,1146,129693,1128,126847,18,2846,178,3,372,5,0,7,229410.0,130000.0,-48.0,-35.0,-43.0,-45.0,-43.0,-36.0,-44.0,-48.0,-90.0,-93.0,-89.0,-92.0,42.0,58.0,46.0,47.0,1
648,92:69:1D:31:68:E9,3774726,489750917,12780,15252313,3761946,474498604,3,19235,3553195,18539,3393103,696,160092,6442,105,14034,252,3,251,216660.0,130000.0,-52.0,-50.0,-43.0,-47.0,-52.0,-49.0,-43.0,-47.0,-90.0,-93.0,-89.0,-92.0,38.0,43.0,46.0,45.0,1
649,CC:2F:71:3F:1F:24,3958467,706163593,196515,231664383,3761952,474499210,27,165418,189603526,165344,189594248,74,9278,158437,6,196513,20759,24,134,130000.0,43333.0,-69.0,-66.0,-70.0,-68.0,-69.0,-66.0,-70.0,-68.0,-90.0,-93.0,-89.0,-92.0,21.0,27.0,19.0,24.0,1
650,CC:2F:71:3E:C5:1F,3762037,474509524,85,10314,3761952,474499210,0,336,28866,272,21128,64,7738,92,2,115,4,0,5,130000.0,39000.0,-70.0,-70.0,-67.0,-60.0,-71.0,-72.0,-67.0,-61.0,-90.0,-93.0,-89.0,-92.0,20.0,23.0,22.0,32.0,1
651,BA:8C:B9:54:50:24,3762217,474581605,265,82395,3761952,474499210,0,1146,129693,1128,126847,18,2846,178,3,372,5,0,7,229410.0,130000.0,-48.0,-35.0,-43.0,-45.0,-43.0,-36.0,-44.0,-48.0,-90.0,-93.0,-89.0,-92.0,42.0,58.0,46.0,47.0,1
652,92:69:1D:31:68:E9,3774732,489751523,12780,15252313,3761952,474499210,3,19235,3553195,18539,3393103,696,160092,6442,105,14034,252,3,251,216660.0,130000.0,-52.0,-50.0,-43.0,-47.0,-52.0,-49.0,-43.0,-47.0,-90.0,-93.0,-89.0,-92.0,38.0,43.0,46.0,45.0,1
653,CC:2F:71:3F:1F:24,3958578,706283815,196623,231784343,3761955,474499472,27,165511,189715598,165437,189706320,74,9278,158526,6,196621,20759,24,134,130000.0,43333.0,-69.0,-66.0,-70.0,-68.0,-69.0,-66.0,-70.0,-68.0,-90.0,-93.0,-89.0,-92.0,21.0,27.0,19.0,24.0,1
654,CC:2F:71:3E:C5:1F,3762040,474509786,85,10314,3761955,474499472,0,336,28866,272,21128,64,7738,92,2,115,4,0,5,130000.0,39000.0,-70.0,-70.0,-67.0,-60.0,-71.0,-72.0,-67.0,-61.0,-90.0,-93.0,-89.0,-92.0,20.0,23.0,22.0,32.0,1
655,BA:8C:B9:54:50:24,3762220,474581867,265,82395,3761955,474499472,0,1146,129693,1128,126847,18,2846,178,3,372,5,0,7,229410.0,130000.0,-48.0,-35.0,-43.0,-45.0,-43.0,-36.0,-44.0,-48.0,-90.0,-93.0,-89.0,-92.0,42.0,58.0,46.0,47.0,1
656,92:69:1D:31:68:E9,3774735,489751785,12780,15252313,3761955,474499472,3,19235,3553195,18539,3393103,696,160092,6442,105,14034,252,3,251,216660.0,130000.0,-52.0,-50.0,-43.0,-47.0,-52.0,-49.0,-43.0,-47.0,-90.0,-93.0,-89.0,-92.0,38.0,43.0,46.0,45.0,1
657,CC:2F:71:3F:1F:24,3958687,706402253,196728,231902377,3761959,474499876,27,165609,189831126,165535,189821848,74,9278,158616,6,196726,20763,24,134,117000.0,39000.0,-69.0,-66.0,-70.0,-68.0,-69.0,-66.0,-70.0,-68.0,-90.0,-93.0,-89.0,-92.0,21.0,27.0,19.0,24.0,1
658,CC:2F:71:3E:C5:1F,3762046,474510392,85,10314,3761961,474500078,0,336,28866,272,21128,64,7738,92,2,115,4,0,5,130000.0,39000.0,-70.0,-70.0,-67.0,-60.0,-71.0,-72.0,-67.0,-61.0,-90.0,-93.0,-89.0,-92.0,20.0,23.0,22.0,32.0,1
659,BA:8C:B9:54:50:24,3762226,474582473,265,82395,3761961,474500078,0,1146,129693,1128,126847,18,2846,178,3,372,5,0,7,229410.0,130000.0,-48.0,-35.0,-43.0,-45.0,-43.0,-36.0,-44.0,-48.0,-90.0,-93.0,-89.0,-92.0,42.0,58.0,46.0,47.0,1
660,92:69:1D:31:68:E9,3774741,489752391,12780,15252313,3761961,474500078,3,19236,3553263,18540,3393171,696,160092,6442,105,14034,252,3,251,216660.0,130000.0,-53.0,-48.0,-43.0,-48.0,-52.0,-49.0,-43.0,-47.0,-90.0,-93.0,-89.0,-92.0,37.0,45.0,46.0,44.0,1
661,CC:2F:71:3F:1F:24,3958802,706528591,196839,232028311,3761963,474500280,27,165707,189950694,165633,189941416,74,9278,158710,6,196837,20763,24,134,130000.0,43333.0,-73.0,-70.0,-74.0,-72.0,-71.0,-68.0,-72.0,-70.0,-90.0,-93.0,-89.0,-92.0,17.0,23.0,15.0,20.0,1
662,CC:2F:71:3E:C5:1F,3762048,474510594,85,10314,3761963,474500280,0,336,28866,272,21128,64,7738,92,2,115,4,0,5,130000.0,39000.0,-70.0,-70.0,-67.0,-60.0,-71.0,-72.0,-67.0,-61.0,-90.0,-93.0,-89.0,-92.0,20.0,23.0,22.0,32.0,1
663,BA:8C:B9:54:50:24,3762228,474582675,265,82395,3761963,474500280,0,1146,129693,1128,126847,18,2846,178,3,372,5,0,7,229410.0,130000.0,-48.0,-35.0,-43.0,-45.0,-43.0,-36.0,-44.0,-48.0,-90.0,-93.0,-89.0,-92.0,42.0,58.0,46.0,47.0,1
664,92:69:1D:31:68:E9,3774744,489752653,12780,15252313,3761964,474500340,3,19236,3553263,18540,3393171,696,160092,6442,105,14034,252,3,251,216660.0,130000.0,-53.0,-48.0,-43.0,-48.0,-52.0,-49.0,-43.0,-47.0,-90.0,-92.0,-89.0,-92.0,37.0,44.0,46.0,44.0,1
665,CC:2F:71:3F:1F:24,3958926,706653042,196954,232151728,3761972,474501314,27,165808,190065547,165734,190056269,74,9278,158806,6,196952,20763,24,134,130000.0,43333.0,-70.0,-67.0,-71.0,-70.0,-70.0,-67.0,-71.0,-69.0,-90.0,-92.0,-89.0,-92.0,20.0,25.0,18.0,22.0,1
666,CC:2F:71:3E:C5:1F,3762058,474511744,86,10430,3761972,474501314,0,338,29006,274,21268,64,7738,92,2,116,4,0,5,130000.0,39000.0,-70.0,-70.0,-66.0,-61.0,-71.0,-72.0,-67.0,-61.0,-90.0,-92.0,-89.0,-92.0,20.0,22.0,23.0,31.0,1
667,BA:8C:B9:54:50:24,3762238,474583825,266,82511,3761972,474501314,0,1150,129965,1132,127119,18,2846,178,3,373,5,0,7,229410.0,130000.0,-48.0,-35.0,-43.0,-45.0,-42.0,-36.0,-44.0,-48.0,-90.0,-92.0,-89.0,-92.0,42.0,57.0,46.0,47.0,1
668,92:69:1D:31:68:E9,3774753,489753743,12781,15252429,3761972,474501314,3,19238,3553399,18542,3393307,696,160092,6442,105,14035,252,3,251,216660.0,130000.0,-52.0,-48.0,-43.0,-48.0,-52.0,-48.0,-43.0,-47.0,-90.0,-92.0,-89.0,-92.0,38.0,44.0,46.0,44.0,1
669,CC:2F:71:3F:1F:24,3959034,706772720,197060,232271204,3761974,474501516,27,165904,190183615,165830,190174337,74,9278,158896,6,197058,20767,24,134,130000.0,43333.0,-73.0,-70.0,-74.0,-72.0,-72.0,-70.0,-74.0,-72.0,-90.0,-92.0,-89.0,-92.0,17.0,22.0,15.0,20.0,1
670,CC:2F:71:3E:C5:1F,3762060,474511946,86,10430,3761974,474501516,0,338,29006,274,21268,64,7738,92,2,116,4,0,5,130000.0,39000.0,-70.0,-70.0,-66.0,-61.0,-71.0,-72.0,-67.0,-61.0,-90.0,-92.0,-89.0,-92.0,20.0,22.0,23.0,31.0,1
671,BA:8C:B9:54:50:24,3762240,474584027,266,82511,3761974,474501516,0,1150,129965,1132,127119,18,2846,178,3,373,5,0,7,229410.0,130000.0,-48.0,-35.0,-43.0,-45.0,-42.0,-36.0,-44.0,-48.0,-90.0,-92.0,-89.0,-92.0,42.0,57.0,46.0,47.0,1
672,92:69:1D:31:68:E9,3774755,489753945,12781,15252429,3761974,474501516,3,19238,3553399,18542,3393307,696,160092,6442,105,14035,252,3,251,216660.0,130000.0,-52.0,-48.0,-43.0,-48.0,-52.0,-48.0,-43.0,-47.0,-90.0,-92.0,-89.0,-92.0,38.0,44.0,46.0,44.0,1
673,CC:2F:71:3F:1F:24,3959147,706893148,197167,232391034,3761980,474502114,27,166000,190297461,165926,190288183,74,9278,158987,6,197165,20767,24,134,130000.0,43333.0,-69.0,-66.0,-70.0,-68.0,-69.0,-66.0,-70.0,-68.0,-90.0,-93.0,-89.0,-92.0,21.0,27.0,19.0,24.0,1
674,CC:2F:71:3E:C5:1F,3762066,474512544,86,10430,3761980,474502114,0,338,29006,274,21268,64,7738,92,2,116,4,0,5,130000.0,39000.0,-70.0,-70.0,-66.0,-61.0,-71.0,-72.0,-67.0,-61.0,-90.0,-93.0,-89.0,-92.0,20.0,23.0,23.0,31.0,1
675,BA:8C:B9:54:50:24,3762247,474584693,266,82511,3761981,474502182,0,1150,129965,1132,127119,18,2846,178,3,373,5,0,7,229410.0,130000.0,-48.0,-35.0,-43.0,-45.0,-42.0,-36.0,-44.0,-48.0,-90.0,-93.0,-89.0,-92.0,42.0,58.0,46.0,47.0,1
676,92:69:1D:31:68:E9,3774762,489754611,12781,15252429,3761981,474502182,3,19238,3553399,18542,3393307,696,160092,6442,105,14035,252,3,251,216660.0,130000.0,-52.0,-48.0,-43.0,-48.0,-52.0,-48.0,-43.0,-47.0,-90.0,-93.0,-89.0,-92.0,38.0,45.0,46.0,44.0,1
677,CC:2F:71:3F:1F:24,3959256,707011684,197274,232509440,3761982,474502244,27,166090,190404669,166015,190395273,75,9396,159076,6,197271,20767,24,134,130000.0,43333.0,-69.0,-66.0,-70.0,-68.0,-69.0,-66.0,-70.0,-68.0,-90.0,-93.0,-89.0,-92.0,21.0,27.0,19.0,24.0,1
678,CC:2F:71:3E:C5:1F,3762070,474512876,86,10430,3761984,474502446,0,338,29006,274,21268,64,7738,92,2,116,4,0,5,130000.0,39000.0,-70.0,-70.0,-66.0,-61.0,-71.0,-72.0,-67.0,-61.0,-90.0,-93.0,-89.0,-92.0,20.0,23.0,23.0,31.0,1
679,BA:8C:B9:54:50:24,3762250,474584957,266,82511,3761984,474502446,0,1150,129965,1132,127119,18,2846,178,3,373,5,0,7,229410.0,130000.0,-48.0,-35.0,-43.0,-45.0,-42.0,-36.0,-44.0,-48.0,-90.0,-93.0,-89.0,-92.0,42.0,58.0,46.0,47.0,1
680,92:69:1D:31:68:E9,3774765,489754875,12781,15252429,3761984,474502446,3,19238,3553399,18542,3393307,696,160092,6442,105,14035,252,3,251,216660.0,130000.0,-52.0,-48.0,-43.0,-48.0,-52.0,-48.0,-43.0,-47.0,-90.0,-93.0,-89.0,-92.0,38.0,45.0,46.0,44.0,1
681,CC:2F:71:3F:1F:24,3959375,707133813,197387,232630963,3761988,474502850,27,166189,190517837,166114,190508441,75,9396,159172,6,197385,20772,24,134,130000.0,43333.0,-69.0,-66.0,-70.0,-68.0,-69.0,-66.0,-70.0,-68.0,-90.0,-93.0,-89.0,-92.0,21.0,27.0,19.0,24.0,1
682,CC:2F:71:3E:C5:1F,3762074,474513280,86,10430,3761988,474502850,0,338,29006,274,21268,64,7738,92,2,116,4,0,5,130000.0,39000.0,-70.0,-70.0,-66.0,-61.0,-71.0,-72.0,-67.0,-61.0,-90.0,-93.0,-89.0,-92.0,20.0,23.0,23.0,31.0,1
683,BA:8C:B9:54:50:24,3762254,474585361,266,82511,3761988,474502850,0,1150,129965,1132,127119,18,2846,178,3,373,5,0,7,229410.0,130000.0,-48.0,-35.0,-43.0,-45.0,-42.0,-36.0,-44.0,-48.0,-90.0,-93.0,-89.0,-92.0,42.0,58.0,46.0,47.0,1
684,92:69:1D:31:68:E9,3774769,489755279,12781,15252429,3761988,474502850,3,19238,3553399,18542,3393307,696,160092,6442,105,14035,252,3,251,216660.0,130000.0,-52.0,-48.0,-43.0,-48.0,-52.0,-48.0,-43.0,-47.0,-90.0,-93.0,-89.0,-92.0,38.0,45.0,46.0,44.0,1
685,CC:2F:71:3F:1F:24,3959485,707252481,197494,232749369,3761991,474503112,27,166281,190629575,166206,190620179,75,9396,159261,6,197492,20772,24,134,130000.0,43333.0,-69.0,-66.0,-70.0,-69.0,-69.0,-66.0,-70.0,-68.0,-90.0,-93.0,-89.0,-92.0,21.0,27.0,19.0,23.0,1
686,CC:2F:71:3E:C5:1F,3762077,474513542,86,10430,3761991,474503112,0,338,29006,274,21268,64,7738,92,2,116,4,0,5,130000.0,39000.0,-70.0,-70.0,-66.0,-61.0,-71.0,-72.0,-67.0,-61.0,-90.0,-93.0,-89.0,-92.0,20.0,23.0,23.0,31.0,1
687,BA:8C:B9:54:50:24,3762259,474585825,266,82511,3761993,474503314,0,1150,129965,1132,127119,18,2846,178,3,373,5,0,7,229410.0,130000.0,-48.0,-35.0,-43.0,-45.0,-42.0,-36.0,-44.0,-48.0,-90.0,-93.0,-89.0,-92.0,42.0,58.0,46.0,47.0,1
688,92:69:1D:31:68:E9,3774774,489755743,12781,15252429,3761993,474503314,3,19238,3553399,18542,3393307,696,160092,6442,105,14035,252,3,251,216660.0,130000.0,-52.0,-48.0,-43.0,-48.0,-52.0,-48.0,-43.0,-47.0,-90.0,-93.0,-89.0,-92.0,38.0,45.0,46.0,44.0,1
689,CC:2F:71:3F:1F:24,3959599,707373078,197601,232869087,3761998,474503991,27,166377,190746139,166302,190736743,75,9396,159351,6,197599,20776,24,134,117000.0,39000.0,-70.0,-67.0,-71.0,-70.0,-69.0,-66.0,-70.0,-69.0,-90.0,-93.0,-89.0,-92.0,20.0,26.0,18.0,22.0,1
690,CC:2F:71:3E:C5:1F,3762084,474514421,86,10430,3761998,474503991,0,338,29006,274,21268,64,7738,92,2,116,4,0,5,130000.0,39000.0,-70.0,-70.0,-66.0,-61.0,-71.0,-72.0,-67.0,-61.0,-90.0,-93.0,-89.0,-92.0,20.0,23.0,23.0,31.0,1
691,BA:8C:B9:54:50:24,3762264,474586502,266,82511,3761998,474503991,0,1150,129965,1132,127119,18,2846,178,3,373,5,0,7,229410.0,130000.0,-48.0,-35.0,-43.0,-45.0,-42.0,-36.0,-44.0,-48.0,-90.0,-93.0,-89.0,-92.0,42.0,58.0,46.0,47.0,1
692,92:69:1D:31:68:E9,3774779,489756420,12781,15252429,3761998,474503991,3,19238,3553399,18542,3393307,696,160092,6442,105,14035,252,3,251,216660.0,130000.0,-52.0,-48.0,-43.0,-48.0,-52.0,-48.0,-43.0,-47.0,-90.0,-93.0,-89.0,-92.0,38.0,45.0,46.0,44.0,1
693,CC:2F:71:3F:1F:24,3959706,707491258,197706,232987065,3762000,474504193,27,166471,190858171,166396,190848775,75,9396,159441,6,197704,20777,24,134,130000.0,39000.0,-69.0,-66.0,-71.0,-69.0,-69.0,-66.0,-70.0,-69.0,-90.0,-93.0,-89.0,-92.0,21.0,27.0,18.0,23.0,1
694,CC:2F:71:3E:C5:1F,3762086,474514623,86,10430,3762000,474504193,0,338,29006,274,21268,64,7738,92,2,116,4,0,5,130000.0,39000.0,-70.0,-70.0,-66.0,-61.0,-71.0,-72.0,-67.0,-61.0,-90.0,-93.0,-89.0,-92.0,20.0,23.0,23.0,31.0,1
695,BA:8C:B9:54:50:24,3762268,474586906,266,82511,3762002,474504395,0,1150,129965,1132,127119,18,2846,178,3,373,5,0,7,229410.0,130000.0,-48.0,-35.0,-43.0,-45.0,-42.0,-36.0,-44.0,-48.0,-90.0,-93.0,-89.0,-92.0,42.0,58.0,46.0,47.0,1
696,92:69:1D:31:68:E9,3774783,489756824,12781,15252429,3762002,474504395,3,19238,3553399,18542,3393307,696,160092,6442,105,14035,252,3,251,216660.0,130000.0,-52.0,-48.0,-43.0,-48.0,-52.0,-48.0,-43.0,-47.0,-90.0,-93.0,-89.0,-92.0,38.0,45.0,46.0,44.0,1
697,CC:2F:71:3F:1F:24,3959826,707614985,197821,233110328,3762005,474504657,27,166572,190971602,166497,190962206,75,9396,159538,6,197819,20780,24,134,130000.0,43333.0,-70.0,-66.0,-71.0,-69.0,-69.0,-66.0,-70.0,-69.0,-90.0,-93.0,-89.0,-92.0,20.0,27.0,18.0,23.0,1
698,CC:2F:71:3E:C5:1F,3762093,474515289,86,10430,3762007,474504859,0,338,29006,274,21268,64,7738,92,2,116,4,0,5,130000.0,39000.0,-70.0,-70.0,-66.0,-61.0,-71.0,-72.0,-67.0,-61.0,-90.0,-93.0,-89.0,-92.0,20.0,23.0,23.0,31.0,1
699,BA:8C:B9:54:50:24,3762273,474587370,266,82511,3762007,474504859,0,1150,129965,1132,127119,18,2846,178,3,373,5,0,7,229410.0,130000.0,-48.0,-35.0,-43.0,-45.0,-42.0,-36.0,-44.0,-48.0,-90.0,-93.0,-89.0,-92.0,42.0,58.0,46.0,47.0,1
700,92:69:1D:31:68:E9,3774788,489757288,12781,15252429,3762007,474504859,3,19238,3553399,18542,3393307,696,160092,6442,105,14035,252,3,251,216660.0,130000.0,-52.0,-48.0,-43.0,-48.0,-52.0,-48.0,-43.0,-47.0,-90.0,-93.0,-89.0,-92.0,38.0,45.0,46.0,44.0,1
701,CC:2F:71:3F:1F:24,3959938,707733687,197929,233228626,3762009,474505061,27,166669,191085548,166594,191076152,75,9396,159629,6,197927,20785,24,134,130000.0,43333.0,-70.0,-66.0,-70.0,-69.0,-69.0,-66.0,-70.0,-69.0,-90.0,-93.0,-89.0,-92.0,20.0,27.0,19.0,23.0,1
702,CC:2F:71:3E:C5:1F,3762095,474515491,86,10430,3762009,474505061,0,338,29006,274,21268,64,7738,92,2,116,4,0,5,130000.0,39000.0,-70.0,-70.0,-66.0,-61.0,-71.0,-72.0,-67.0,-61.0,-90.0,-93.0,-89.0,-92.0,20.0,23.0,23.0,31.0,1
703,BA:8C:B9:54:50:24,3762275,474587572,266,82511,3762009,474505061,0,1150,129965,1132,127119,18,2846,178,3,373,5,0,7,229410.0,130000.0,-48.0,-35.0,-43.0,-45.0,-42.0,-36.0,-44.0,-48.0,-90.0,-93.0,-89.0,-92.0,42.0,58.0,46.0,47.0,1
704,92:69:1D:31:68:E9,3774792,489757692,12781,15252429,3762011,474505263,3,19238,3553399,18542,3393307,696,160092,6442,105,14035,252,3,251,216660.0,130000.0,-52.0,-48.0,-43.0,-48.0,-52.0,-48.0,-43.0,-47.0,-90.0,-93.0,-89.0,-92.0,38.0,45.0,46.0,44.0,1
705,CC:2F:71:3F:1F:24,3960051,707855535,198037,233350010,3762014,474505525,27,166766,191202402,166691,191193006,75,9396,159719,6,198035,20785,24,134,130000.0,43333.0,-69.0,-66.0,-70.0,-69.0,-69.0,-66.0,-70.0,-69.0,-90.0,-93.0,-89.0,-92.0,21.0,27.0,19.0,23.0,1
706,CC:2F:71:3E:C5:1F,3762100,474515955,86,10430,3762014,474505525,0,338,29006,274,21268,64,7738,92,2,116,4,0,5,130000.0,39000.0,-70.0,-70.0,-66.0,-61.0,-71.0,-72.0,-67.0,-61.0,-90.0,-93.0,-89.0,-92.0,20.0,23.0,23.0,31.0,1
707,BA:8C:B9:54:50:24,3762282,474588238,266,82511,3762016,474505727,0,1150,129965,1132,127119,18,2846,178,3,373,5,0,7,229410.0,130000.0,-48.0,-35.0,-43.0,-45.0,-42.0,-36.0,-44.0,-48.0,-90.0,-93.0,-89.0,-92.0,42.0,58.0,46.0,47.0,1
708,92:69:1D:31:68:E9,3774797,489758156,12781,15252429,3762016,474505727,3,19238,3553399,18542,3393307,696,160092,6442,105,14035,252,3,251,216660.0,130000.0,-52.0,-48.0,-43.0,-48.0,-52.0,-48.0,-43.0,-47.0,-90.0,-93.0,-89.0,-92.0,38.0,45.0,46.0,44.0,1
709,CC:2F:71:3F:1F:24,3960163,707977323,198145,233471394,3762018,474505929,27,166858,191315550,166783,191306154,75,9396,159809,6,198143,20785,24,134,130000.0,43333.0,-69.0,-66.0,-70.0,-69.0,-69.0,-66.0,-70.0,-68.0,-90.0,-93.0,-89.0,-92.0,21.0,27.0,19.0,23.0,1
710,CC:2F:71:3E:C5:1F,3762104,474516359,86,10430,3762018,474505929,0,338,29006,274,21268,64,7738,92,2,116,4,0,5,130000.0,39000.0,-70.0,-70.0,-66.0,-61.0,-71.0,-72.0,-67.0,-61.0,-90.0,-93.0,-89.0,-92.0,20.0,23.0,23.0,31.0,1
711,BA:8C:B9:54:50:24,3762284,474588440,266,82511,3762018,474505929,0,1150,129965,1132,127119,18,2846,178,3,373,5,0,7,229410.0,130000.0,-48.0,-35.0,-43.0,-45.0,-42.0,-36.0,-44.0,-48.0,-90.0,-93.0,-89.0,-92.0,42.0,58.0,46.0,47.0,1
712,92:69:1D:31:68:E9,3774801,489758560,12781,15252429,3762020,474506131,3,19238,3553399,18542,3393307,696,160092,6442,105,14035,252,3,251,216660.0,130000.0,-52.0,-48.0,-43.0,-48.0,-52.0,-48.0,-43.0,-47.0,-90.0,-92.0,-89.0,-92.0,38.0,44.0,46.0,44.0,1
713,CC:2F:71:3F:1F:24,3960282,708100905,198259,233594510,3762023,474506395,27,166961,191433394,166886,191423998,75,9396,159907,6,198257,20791,24,134,130000.0,43333.0,-69.0,-66.0,-71.0,-69.0,-69.0,-66.0,-70.0,-69.0,-90.0,-92.0,-89.0,-92.0,21.0,26.0,18.0,23.0,1
714,CC:2F:71:3E:C5:1F,3762109,474516825,86,10430,3762023,474506395,0,340,29194,275,21338,65,7856,93,2,116,4,0,5,130000.0,39000.0,-70.0,-70.0,-66.0,-60.0,-71.0,-72.0,-67.0,-61.0,-90.0,-92.0,-89.0,-92.0,20.0,22.0,23.0,32.0,1
715,BA:8C:B9:54:50:24,3762291,474589108,266,82511,3762025,474506597,0,1150,129965,1132,127119,18,2846,178,3,373,5,0,7,229410.0,130000.0,-48.0,-35.0,-43.0,-45.0,-42.0,-36.0,-44.0,-48.0,-90.0,-92.0,-89.0,-92.0,42.0,57.0,46.0,47.0,1
716,92:69:1D:31:68:E9,3774806,489759026,12781,15252429,3762025,474506597,3,19238,3553399,18542,3393307,696,160092,6442,105,14035,252,3,251,216660.0,130000.0,-52.0,-48.0,-43.0,-48.0,-52.0,-48.0,-43.0,-47.0,-90.0,-92.0,-89.0,-92.0,38.0,44.0,46.0,44.0,1
717,CC:2F:71:3F:1F:24,3960392,708219515,198364,233712656,3762028,474506859,27,167049,191541792,166974,191532396,75,9396,159994,6,198362,20792,24,134,130000.0,43333.0,-69.0,-66.0,-70.0,-69.0,-69.0,-66.0,-70.0,-69.0,-90.0,-92.0,-89.0,-92.0,21.0,26.0,19.0,23.0,1
718,CC:2F:71:3E:C5:1F,3762114,474517289,86,10430,3762028,474506859,0,340,29194,275,21338,65,7856,93,2,116,4,0,5,130000.0,39000.0,-70.0,-70.0,-66.0,-60.0,-71.0,-72.0,-67.0,-61.0,-90.0,-92.0,-89.0,-92.0,20.0,22.0,23.0,32.0,1
719,BA:8C:B9:54:50:24,3762294,474589370,266,82511,3762028,474506859,0,1154,130237,1136,127391,18,2846,178,3,373,5,0,7,229410.0,130000.0,-40.0,-37.0,-45.0,-51.0,-41.0,-36.0,-44.0,-49.0,-90.0,-92.0,-89.0,-92.0,50.0,55.0,44.0,41.0,1
720,92:69:1D:31:68:E9,3774809,489759288,12781,15252429,3762028,474506859,3,19240,3553535,18544,3393443,696,160092,6442,105,14036,252,3,251,216660.0,130000.0,-52.0,-48.0,-43.0,-48.0,-52.0,-48.0,-43.0,-47.0,-90.0,-92.0,-89.0,-92.0,38.0,44.0,46.0,44.0,1
721,CC:2F:71:3F:1F:24,3960503,708338213,198471,233830950,3762032,474507263,27,167144,191656988,167069,191647592,75,9396,160081,6,198469,20796,24,134,117000.0,39000.0,-69.0,-66.0,-71.0,-69.0,-69.0,-66.0,-70.0,-69.0,-90.0,-93.0,-89.0,-92.0,21.0,27.0,18.0,23.0,1
722,CC:2F:71:3E:C5:1F,3762118,474517693,86,10430,3762032,474507263,0,340,29194,275,21338,65,7856,93,2,116,4,0,5,130000.0,39000.0,-70.0,-70.0,-66.0,-60.0,-71.0,-72.0,-67.0,-61.0,-90.0,-93.0,-89.0,-92.0,20.0,23.0,23.0,32.0,1
723,BA:8C:B9:54:50:24,3762298,474589774,266,82511,3762032,474507263,0,1154,130237,1136,127391,18,2846,178,3,373,5,0,7,229410.0,130000.0,-40.0,-37.0,-45.0,-51.0,-41.0,-36.0,-44.0,-49.0,-90.0,-93.0,-89.0,-92.0,50.0,56.0,44.0,41.0,1
724,92:69:1D:31:68:E9,3774815,489759894,12781,15252429,3762034,474507465,3,19240,3553535,18544,3393443,696,160092,6442,105,14036,252,3,251,216660.0,130000.0,-52.0,-48.0,-43.0,-48.0,-52.0,-48.0,-43.0,-47.0,-90.0,-93.0,-89.0,-92.0,38.0,45.0,46.0,44.0,1
725,CC:2F:71:3F:1F:24,3960613,708456781,198577,233949114,3762036,474507667,27,167236,191766194,167161,191756798,75,9396,160168,6,198575,20796,24,134,130000.0,43333.0,-69.0,-66.0,-70.0,-69.0,-69.0,-66.0,-70.0,-69.0,-90.0,-93.0,-89.0,-92.0,21.0,27.0,19.0,23.0,1
726,CC:2F:71:3E:C5:1F,3762122,474518097,86,10430,3762036,474507667,0,340,29194,275,21338,65,7856,93,2,116,4,0,5,130000.0,39000.0,-70.0,-70.0,-66.0,-60.0,-71.0,-72.0,-67.0,-61.0,-90.0,-93.0,-89.0,-92.0,20.0,23.0,23.0,32.0,1
727,BA:8C:B9:54:50:24,3762302,474590178,266,82511,3762036,474507667,0,1155,130305,1137,127459,18,2846,178,3,373,5,0,7,229410.0,130000.0,-48.0,-35.0,-43.0,-45.0,-42.0,-36.0,-43.0,-48.0,-90.0,-93.0,-89.0,-92.0,42.0,58.0,46.0,47.0,1
728,92:69:1D:31:68:E9,3774817,489760096,12781,15252429,3762036,474507667,3,19240,3553535,18544,3393443,696,160092,6442,105,14036,252,3,251,216660.0,130000.0,-52.0,-48.0,-43.0,-48.0,-52.0,-48.0,-43.0,-47.0,-90.0,-93.0,-89.0,-92.0,38.0,45.0,46.0,44.0,1
729,CC:2F:71:3F:1F:24,3960731,708580416,198690,234072285,3762041,474508131,27,167337,191879591,167262,191870195,75,9396,160264,6,198688,20796,24,134,130000.0,43333.0,-69.0,-67.0,-71.0,-69.0,-69.0,-67.0,-71.0,-69.0,-90.0,-92.0,-89.0,-92.0,21.0,25.0,18.0,23.0,1
730,CC:2F:71:3E:C5:1F,3762127,474518561,86,10430,3762041,474508131,0,340,29194,275,21338,65,7856,93,2,116,4,0,5,130000.0,39000.0,-70.0,-70.0,-66.0,-60.0,-71.0,-72.0,-67.0,-61.0,-90.0,-92.0,-89.0,-92.0,20.0,22.0,23.0,32.0,1
731,BA:8C:B9:54:50:24,3762307,474590642,266,82511,3762041,474508131,0,1155,130305,1137,127459,18,2846,178,3,373,5,0,7,229410.0,130000.0,-48.0,-35.0,-43.0,-45.0,-42.0,-36.0,-43.0,-48.0,-90.0,-92.0,-89.0,-92.0,42.0,57.0,46.0,47.0,1
732,92:69:1D:31:68:E9,3774822,489760560,12781,15252429,3762041,474508131,3,19240,3553535,18544,3393443,696,160092,6442,105,14036,252,3,251,216660.0,130000.0,-52.0,-48.0,-43.0,-48.0,-52.0,-48.0,-43.0,-47.0,-90.0,-92.0,-89.0,-92.0,38.0,44.0,46.0,44.0,1
733,CC:2F:71:3F:1F:24,3960843,708701980,198798,234193445,3762045,474508535,27,167429,191990097,167354,191980701,75,9396,160353,6,198796,20802,24,134,130000.0,43333.0,-70.0,-66.0,-71.0,-69.0,-69.0,-66.0,-70.0,-69.0,-90.0,-93.0,-89.0,-92.0,20.0,27.0,18.0,23.0,1
734,CC:2F:71:3E:C5:1F,3762131,474518965,86,10430,3762045,474508535,0,340,29194,275,21338,65,7856,93,2,116,4,0,5,130000.0,39000.0,-70.0,-70.0,-66.0,-60.0,-71.0,-72.0,-67.0,-61.0,-90.0,-93.0,-89.0,-92.0,20.0,23.0,23.0,32.0,1
735,BA:8C:B9:54:50:24,3762311,474591046,266,82511,3762045,474508535,0,1155,130305,1137,127459,18,2846,178,3,373,5,0,7,229410.0,130000.0,-48.0,-35.0,-43.0,-45.0,-42.0,-36.0,-43.0,-48.0,-90.0,-93.0,-89.0,-92.0,42.0,58.0,46.0,47.0,1
736,92:69:1D:31:68:E9,3774826,489760964,12781,15252429,3762045,474508535,3,19240,3553535,18544,3393443,696,160092,6442,105,14036,252,3,251,216660.0,130000.0,-52.0,-48.0,-43.0,-48.0,-52.0,-48.0,-43.0,-47.0,-90.0,-93.0,-89.0,-92.0,38.0,45.0,46.0,44.0,1
737,CC:2F:71:3F:1F:24,3960952,708820294,198904,234311497,3762048,474508797,27,167523,192103695,167448,192094299,75,9396,160442,6,198902,20806,24,134,130000.0,43333.0,-69.0,-66.0,-71.0,-69.0,-69.0,-66.0,-70.0,-69.0,-90.0,-93.0,-89.0,-92.0,21.0,27.0,18.0,23.0,1
738,CC:2F:71:3E:C5:1F,3762136,474519429,86,10430,3762050,474508999,0,340,29194,275,21338,65,7856,93,2,116,4,0,5,130000.0,39000.0,-70.0,-70.0,-66.0,-60.0,-71.0,-72.0,-67.0,-61.0,-90.0,-93.0,-89.0,-92.0,20.0,23.0,23.0,32.0,1
739,BA:8C:B9:54:50:24,3762316,474591510,266,82511,3762050,474508999,0,1155,130305,1137,127459,18,2846,178,3,373,5,0,7,229410.0,130000.0,-48.0,-35.0,-43.0,-45.0,-42.0,-36.0,-43.0,-48.0,-90.0,-93.0,-89.0,-92.0,42.0,58.0,46.0,47.0,1
740,92:69:1D:31:68:E9,3774831,489761428,12781,15252429,3762050,474508999,3,19240,3553535,18544,3393443,696,160092,6442,105,14036,252,3,251,216660.0,130000.0,-52.0,-48.0,-43.0,-48.0,-52.0,-48.0,-43.0,-47.0,-90.0,-93.0,-89.0,-92.0,38.0,45.0,46.0,44.0,1
741,CC:2F:71:3F:1F:24,3961064,708939176,199010,234429773,3762054,474509403,27,167613,192213887,167538,192204491,75,9396,160528,6,199008,20806,24,134,130000.0,43333.0,-70.0,-66.0,-71.0,-69.0,-69.0,-66.0,-70.0,-68.0,-90.0,-93.0,-89.0,-92.0,20.0,27.0,18.0,23.0,1
742,CC:2F:71:3E:C5:1F,3762140,474519833,86,10430,3762054,474509403,0,340,29194,275,21338,65,7856,93,2,116,4,0,5,130000.0,39000.0,-70.0,-70.0,-66.0,-60.0,-71.0,-72.0,-67.0,-61.0,-90.0,-93.0,-89.0,-92.0,20.0,23.0,23.0,32.0,1
743,BA:8C:B9:54:50:24,3762320,474591914,266,82511,3762054,474509403,0,1155,130305,1137,127459,18,2846,178,3,373,5,0,7,229410.0,130000.0,-48.0,-35.0,-43.0,-45.0,-42.0,-36.0,-43.0,-48.0,-90.0,-93.0,-89.0,-92.0,42.0,58.0,46.0,47.0,1
744,92:69:1D:31:68:E9,3774835,489761832,12781,15252429,3762054,474509403,3,19240,3553535,18544,3393443,696,160092,6442,105,14036,252,3,251,216660.0,130000.0,-52.0,-48.0,-43.0,-48.0,-52.0,-48.0,-43.0,-47.0,-90.0,-93.0,-89.0,-92.0,38.0,45.0,46.0,44.0,1
745,CC:2F:71:3F:1F:24,3961182,709064282,199125,234554404,3762057,474509878,27,167712,192328434,167637,192319038,75,9396,160625,6,199123,20810,24,134,130000.0,43333.0,-69.0,-66.0,-71.0,-69.0,-69.0,-66.0,-70.0,-69.0,-90.0,-93.0,-89.0,-92.0,21.0,27.0,18.0,23.0,1
746,CC:2F:71:3E:C5:1F,3762145,474520510,86,10430,3762059,474510080,0,340,29194,275,21338,65,7856,93,2,116,4,0,5,130000.0,39000.0,-70.0,-70.0,-66.0,-60.0,-71.0,-72.0,-67.0,-61.0,-90.0,-93.0,-89.0,-92.0,20.0,23.0,23.0,32.0,1
747,BA:8C:B9:54:50:24,3762325,474592591,266,82511,3762059,474510080,0,1155,130305,1137,127459,18,2846,178,3,373,5,0,7,229410.0,130000.0,-48.0,-35.0,-43.0,-45.0,-42.0,-36.0,-43.0,-48.0,-90.0,-93.0,-89.0,-92.0,42.0,58.0,46.0,47.0,1
748,92:69:1D:31:68:E9,3774840,489762509,12781,15252429,3762059,474510080,3,19240,3553535,18544,3393443,696,160092,6442,105,14036,252,3,251,216660.0,130000.0,-52.0,-48.0,-43.0,-48.0,-52.0,-48.0,-43.0,-47.0,-90.0,-93.0,-89.0,-92.0,38.0,45.0,46.0,44.0,1
749,CC:2F:71:3F:1F:24,3961295,709184424,199231,234673880,3762064,474510544,27,167803,192438838,167728,192429442,75,9396,160712,6,199229,20816,24,134,130000.0,43333.0,-69.0,-66.0,-70.0,-69.0,-69.0,-66.0,-70.0,-69.0,-90.0,-93.0,-89.0,-92.0,21.0,27.0,19.0,23.0,1
750,CC:2F:71:3E:C5:1F,3762150,474520974,86,10430,3762064,474510544,0,340,29194,275,21338,65,7856,93,2,116,4,0,5,130000.0,39000.0,-70.0,-70.0,-66.0,-60.0,-71.0,-72.0,-67.0,-61.0,-90.0,-93.0,-89.0,-92.0,20.0,23.0,23.0,32.0,1
751,BA:8C:B9:54:50:24,3762330,474593055,266,82511,3762064,474510544,0,1155,130305,1137,127459,18,2846,178,3,373,5,0,7,229410.0,130000.0,-48.0,-35.0,-43.0,-45.0,-42.0,-36.0,-43.0,-48.0,-90.0,-93.0,-89.0,-92.0,42.0,58.0,46.0,47.0,1
752,92:69:1D:31:68:E9,3774845,489762973,12781,15252429,3762064,474510544,3,19240,3553535,18544,3393443,696,160092,6442,105,14036,252,3,251,216660.0,130000.0,-52.0,-48.0,-43.0,-48.0,-52.0,-48.0,-43.0,-47.0,-90.0,-93.0,-89.0,-92.0,38.0,45.0,46.0,44.0,1
753,CC:2F:71:3F:1F:24,3961406,709305970,199338,234795022,3762068,474510948,27,167909,192570976,167834,192561580,75,9396,160803,6,199336,20821,24,134,117000.0,39000.0,-68.0,-66.0,-70.0,-68.0,-68.0,-66.0,-70.0,-68.0,-90.0,-93.0,-89.0,-92.0,22.0,27.0,19.0,24.0,1
754,CC:2F:71:3E:C5:1F,3762154,474521378,86,10430,3762068,474510948,0,340,29194,275,21338,65,7856,93,2,116,4,0,5,130000.0,39000.0,-70.0,-70.0,-66.0,-60.0,-71.0,-72.0,-67.0,-61.0,-90.0,-93.0,-89.0,-92.0,20.0,23.0,23.0,32.0,1
755,BA:8C:B9:54:50:24,3762334,474593459,266,82511,3762068,474510948,0,1155,130305,1137,127459,18,2846,178,3,373,5,0,7,229410.0,130000.0,-48.0,-35.0,-43.0,-45.0,-42.0,-36.0,-43.0,-48.0,-90.0,-93.0,-89.0,-92.0,42.0,58.0,46.0,47.0,1
756,92:69:1D:31:68:E9,3774849,489763377,12781,15252429,3762068,474510948,3,19240,3553535,18544,3393443,696,160092,6442,105,14036,252,3,251,216660.0,130000.0,-52.0,-48.0,-43.0,-48.0,-52.0,-48.0,-43.0,-47.0,-90.0,-93.0,-89.0,-92.0,38.0,45.0,46.0,44.0,1
757,CC:2F:71:3F:1F:24,3961516,709426024,199445,234914740,3762071,474511284,27,168000,192684036,167925,192674640,75,9396,160890,6,199442,20821,24,134,130000.0,43333.0,-69.0,-66.0,-70.0,-68.0,-69.0,-66.0,-70.0,-68.0,-90.0,-93.0,-89.0,-92.0,21.0,27.0,19.0,24.0,1
758,CC:2F:71:3E:C5:1F,3762158,474521782,86,10430,3762072,474511352,0,340,29194,275,21338,65,7856,93,2,116,4,0,5,130000.0,39000.0,-70.0,-70.0,-66.0,-60.0,-71.0,-72.0,-67.0,-61.0,-90.0,-93.0,-89.0,-92.0,20.0,23.0,23.0,32.0,1
759,BA:8C:B9:54:50:24,3762338,474593863,266,82511,3762072,474511352,0,1155,130305,1137,127459,18,2846,178,3,373,5,0,7,229410.0,130000.0,-48.0,-35.0,-43.0,-45.0,-42.0,-36.0,-43.0,-48.0,-90.0,-93.0,-89.0,-92.0,42.0,58.0,46.0,47.0,1
760,92:69:1D:31:68:E9,3774853,489763781,12781,15252429,3762072,474511352,3,19240,3553535,18544,3393443,696,160092,6442,105,14036,252,3,251,216660.0,130000.0,-52.0,-48.0,-43.0,-48.0,-52.0,-48.0,-43.0,-47.0,-90.0,-93.0,-89.0,-92.0,38.0,45.0,46.0,44.0,1
761,CC:2F:71:3F:1F:24,3961632,709546547,199557,235034933,3762075,474511614,27,168098,192795523,168023,192786127,75,9396,160986,6,199555,20821,24,134,130000.0,43333.0,-69.0,-66.0,-70.0,-69.0,-69.0,-66.0,-70.0,-68.0,-90.0,-93.0,-89.0,-92.0,21.0,27.0,19.0,23.0,1
762,CC:2F:71:3E:C5:1F,3762163,474522246,86,10430,3762077,474511816,0,340,29194,275,21338,65,7856,93,2,116,4,0,5,130000.0,39000.0,-70.0,-70.0,-66.0,-60.0,-71.0,-72.0,-67.0,-61.0,-90.0,-93.0,-89.0,-92.0,20.0,23.0,23.0,32.0,1
763,BA:8C:B9:54:50:24,3762343,474594327,266,82511,3762077,474511816,0,1155,130305,1137,127459,18,2846,178,3,373,5,0,7,229410.0,130000.0,-48.0,-35.0,-43.0,-45.0,-42.0,-36.0,-43.0,-48.0,-90.0,-93.0,-89.0,-92.0,42.0,58.0,46.0,47.0,1
764,92:69:1D:31:68:E9,3774858,489764245,12781,15252429,3762077,474511816,3,19240,3553535,18544,3393443,696,160092,6442,105,14036,252,3,251,216660.0,130000.0,-52.0,-48.0,-43.0,-48.0,-52.0,-48.0,-43.0,-47.0,-90.0,-93.0,-89.0,-92.0,38.0,45.0,46.0,44.0,1
765,CC:2F:71:3F:1F:24,3961744,709666687,199665,235154669,3762079,474512018,27,168197,192916701,168122,192907305,75,9396,161076,6,199663,20825,24,134,130000.0,43333.0,-69.0,-66.0,-70.0,-69.0,-69.0,-65.0,-70.0,-69.0,-90.0,-93.0,-89.0,-92.0,21.0,27.0,19.0,23.0,1
766,CC:2F:71:3E:C5:1F,3762165,474522448,86,10430,3762079,474512018,0,340,29194,275,21338,65,7856,93,2,116,4,0,5,130000.0,39000.0,-70.0,-70.0,-66.0,-60.0,-71.0,-72.0,-67.0,-61.0,-90.0,-93.0,-89.0,-92.0,20.0,23.0,23.0,32.0,1
767,BA:8C:B9:54:50:24,3762345,474594529,266,82511,3762079,474512018,0,1155,130305,1137,127459,18,2846,178,3,373,5,0,7,229410.0,130000.0,-48.0,-35.0,-43.0,-45.0,-42.0,-36.0,-43.0,-48.0,-90.0,-93.0,-89.0,-92.0,42.0,58.0,46.0,47.0,1
768,92:69:1D:31:68:E9,3774862,489764649,12781,15252429,3762081,474512220,3,19240,3553535,18544,3393443,696,160092,6442,105,14036,252,3,251,216660.0,130000.0,-52.0,-48.0,-43.0,-48.0,-52.0,-48.0,-43.0,-47.0,-90.0,-93.0,-89.0,-92.0,38.0,45.0,46.0,44.0,1
769,CC:2F:71:3F:1F:24,3961855,709785427,199771,235272945,3762084,474512482,27,168290,193028743,168215,193019347,75,9396,161164,6,199769,20825,24,134,130000.0,43333.0,-69.0,-66.0,-70.0,-69.0,-69.0,-66.0,-70.0,-69.0,-90.0,-93.0,-89.0,-92.0,21.0,27.0,19.0,23.0,1
770,CC:2F:71:3E:C5:1F,3762172,474523114,86,10430,3762086,474512684,0,340,29194,275,21338,65,7856,93,2,116,4,0,5,130000.0,39000.0,-70.0,-70.0,-66.0,-60.0,-71.0,-72.0,-67.0,-61.0,-90.0,-93.0,-89.0,-92.0,20.0,23.0,23.0,32.0,1
771,BA:8C:B9:54:50:24,3762352,474595195,266,82511,3762086,474512684,0,1155,130305,1137,127459,18,2846,178,3,373,5,0,7,229410.0,130000.0,-48.0,-35.0,-43.0,-45.0,-42.0,-36.0,-43.0,-48.0,-90.0,-93.0,-89.0,-92.0,42.0,58.0,46.0,47.0,1
772,92:69:1D:31:68:E9,3774867,489765113,12781,15252429,3762086,474512684,3,19240,3553535,18544,3393443,696,160092,6442,105,14036,252,3,251,216660.0,130000.0,-52.0,-48.0,-43.0,-48.0,-52.0,-48.0,-43.0,-47.0,-90.0,-93.0,-89.0,-92.0,38.0,45.0,46.0,44.0,1
773,CC:2F:71:3F:1F:24,3961967,709907201,199879,235394315,3762088,474512886,27,168390,193149209,168315,193139813,75,9396,161254,6,199877,20825,24,135,130000.0,43333.0,-69.0,-66.0,-71.0,-68.0,-69.0,-66.0,-70.0,-68.0,-90.0,-93.0,-89.0,-92.0,21.0,27.0,18.0,24.0,1
774,CC:2F:71:3E:C5:1F,3762175,474523432,87,10546,3762088,474512886,0,342,29334,277,21478,65,7856,93,2,117,4,0,5,130000.0,39000.0,-70.0,-70.0,-66.0,-60.0,-71.0,-72.0,-67.0,-61.0,-90.0,-93.0,-89.0,-92.0,20.0,23.0,23.0,32.0,1
775,BA:8C:B9:54:50:24,3762355,474595513,267,82627,3762088,474512886,0,1157,130441,1139,127595,18,2846,178,3,374,5,0,7,229410.0,130000.0,-40.0,-37.0,-45.0,-51.0,-42.0,-36.0,-44.0,-49.0,-90.0,-93.0,-89.0,-92.0,50.0,56.0,44.0,41.0,1
776,92:69:1D:31:68:E9,3774872,489765633,12782,15252545,3762090,474513088,3,19242,3553671,18546,3393579,696,160092,6442,105,14037,252,3,251,216660.0,130000.0,-52.0,-48.0,-42.0,-48.0,-52.0,-48.0,-42.0,-47.0,-90.0,-93.0,-89.0,-92.0,38.0,45.0,47.0,44.0,1
777,CC:2F:71:3F:1F:24,3962087,710032366,199995,235519076,3762092,474513290,27,168497,193273278,168422,193263882,75,9396,161352,6,199993,20831,24,135,130000.0,43333.0,-69.0,-66.0,-70.0,-69.0,-69.0,-66.0,-70.0,-68.0,-90.0,-93.0,-89.0,-92.0,21.0,27.0,19.0,23.0,1
778,CC:2F:71:3E:C5:1F,3762181,474524038,87,10546,3762094,474513492,0,342,29334,277,21478,65,7856,93,2,117,4,0,5,130000.0,39000.0,-70.0,-70.0,-66.0,-60.0,-71.0,-72.0,-67.0,-61.0,-90.0,-93.0,-89.0,-92.0,20.0,23.0,23.0,32.0,1
779,BA:8C:B9:54:50:24,3762361,474596119,267,82627,3762094,474513492,0,1157,130441,1139,127595,18,2846,178,3,374,5,0,7,229410.0,130000.0,-40.0,-37.0,-45.0,-51.0,-42.0,-36.0,-44.0,-49.0,-90.0,-93.0,-89.0,-92.0,50.0,56.0,44.0,41.0,1
780,92:69:1D:31:68:E9,3774876,489766037,12782,15252545,3762094,474513492,3,19242,3553671,18546,3393579,696,160092,6442,105,14037,252,3,251,216660.0,130000.0,-52.0,-48.0,-42.0,-48.0,-52.0,-48.0,-42.0,-47.0,-90.0,-93.0,-89.0,-92.0,38.0,45.0,47.0,44.0,1
781,CC:2F:71:3F:1F:24,3962199,710151236,200102,235637482,3762097,474513754,27,168587,193383360,168512,193373964,75,9396,161439,6,200100,20831,24,135,130000.0,43333.0,-69.0,-66.0,-70.0,-68.0,-69.0,-66.0,-70.0,-68.0,-90.0,-93.0,-89.0,-92.0,21.0,27.0,19.0,24.0,1
782,CC:2F:71:3E:C5:1F,3762184,474524300,87,10546,3762097,474513754,0,342,29334,277,21478,65,7856,93,2,117,4,0,5,130000.0,39000.0,-70.0,-70.0,-66.0,-60.0,-71.0,-72.0,-67.0,-61.0,-90.0,-93.0,-89.0,-92.0,20.0,23.0,23.0,32.0,1
783,BA:8C:B9:54:50:24,3762364,474596381,267,82627,3762097,474513754,0,1157,130441,1139,127595,18,2846,178,3,374,5,0,7,229410.0,130000.0,-40.0,-37.0,-45.0,-51.0,-42.0,-36.0,-44.0,-49.0,-90.0,-93.0,-89.0,-92.0,50.0,56.0,44.0,41.0,1
784,92:69:1D:31:68:E9,3774879,489766299,12782,15252545,3762097,474513754,3,19242,3553671,18546,3393579,696,160092,6442,105,14037,252,3,251,216660.0,130000.0,-52.0,-48.0,-42.0,-48.0,-52.0,-48.0,-42.0,-47.0,-90.0,-93.0,-89.0,-92.0,38.0,45.0,47.0,44.0,1
785,CC:2F:71:3F:1F:24,3962310,710271414,200209,235757256,3762101,474514158,27,168682,193498466,168607,193489070,75,9396,161529,6,200207,20835,24,135,117000.0,39000.0,-69.0,-66.0,-71.0,-68.0,-69.0,-66.0,-70.0,-68.0,-90.0,-93.0,-89.0,-92.0,21.0,27.0,18.0,24.0,1
786,CC:2F:71:3E:C5:1F,3762190,474524906,87,10546,3762103,474514360,0,342,29334,277,21478,65,7856,93,2,117,4,0,5,130000.0,39000.0,-70.0,-70.0,-66.0,-60.0,-71.0,-72.0,-67.0,-61.0,-90.0,-93.0,-89.0,-92.0,20.0,23.0,23.0,32.0,1
787,BA:8C:B9:54:50:24,3762370,474596987,267,82627,3762103,474514360,0,1157,130441,1139,127595,18,2846,178,3,374,5,0,7,229410.0,130000.0,-40.0,-37.0,-45.0,-51.0,-42.0,-36.0,-44.0,-49.0,-90.0,-93.0,-89.0,-92.0,50.0,56.0,44.0,41.0,1
788,92:69:1D:31:68:E9,3774885,489766905,12782,15252545,3762103,474514360,3,19242,3553671,18546,3393579,696,160092,6442,105,14037,252,3,251,216660.0,130000.0,-52.0,-48.0,-42.0,-48.0,-52.0,-48.0,-42.0,-47.0,-90.0,-93.0,-89.0,-92.0,38.0,45.0,47.0,44.0,1
789,CC:2F:71:3F:1F:24,3962421,710391300,200318,235876940,3762103,474514360,27,168774,193607414,168699,193598018,75,9396,161620,6,200316,20838,24,135,130000.0,43333.0,-69.0,-66.0,-70.0,-68.0,-69.0,-66.0,-70.0,-68.0,-90.0,-93.0,-89.0,-92.0,21.0,27.0,19.0,24.0,1
790,CC:2F:71:3E:C5:1F,3762190,474524906,87,10546,3762103,474514360,0,342,29334,277,21478,65,7856,93,2,117,4,0,5,130000.0,39000.0,-70.0,-70.0,-66.0,-60.0,-71.0,-72.0,-67.0,-61.0,-90.0,-93.0,-89.0,-92.0,20.0,23.0,23.0,32.0,1
791,BA:8C:B9:54:50:24,3762372,474597189,267,82627,3762105,474514562,0,1157,130441,1139,127595,18,2846,178,3,374,5,0,7,229410.0,130000.0,-40.0,-37.0,-45.0,-51.0,-42.0,-36.0,-44.0,-49.0,-90.0,-93.0,-89.0,-92.0,50.0,56.0,44.0,41.0,1
792,92:69:1D:31:68:E9,3774887,489767107,12782,15252545,3762105,474514562,3,19242,3553671,18546,3393579,696,160092,6442,105,14037,252,3,251,216660.0,130000.0,-52.0,-48.0,-42.0,-48.0,-52.0,-48.0,-42.0,-47.0,-90.0,-93.0,-89.0,-92.0,38.0,45.0,47.0,44.0,1
793,CC:2F:71:3F:1F:24,3962542,710513839,200431,235998687,3762111,474515152,27,168875,193723577,168800,193714181,75,9396,161715,6,200429,20838,24,135,130000.0,43333.0,-69.0,-66.0,-70.0,-69.0,-69.0,-66.0,-70.0,-69.0,-90.0,-93.0,-89.0,-92.0,21.0,27.0,19.0,23.0,1
794,CC:2F:71:3E:C5:1F,3762200,474525900,87,10546,3762113,474515354,0,342,29334,277,21478,65,7856,93,2,117,4,0,5,130000.0,39000.0,-70.0,-70.0,-66.0,-60.0,-71.0,-72.0,-67.0,-61.0,-90.0,-93.0,-89.0,-92.0,20.0,23.0,23.0,32.0,1
795,BA:8C:B9:54:50:24,3762380,474597981,267,82627,3762113,474515354,0,1157,130441,1139,127595,18,2846,178,3,374,5,0,7,229410.0,130000.0,-40.0,-37.0,-45.0,-51.0,-42.0,-36.0,-44.0,-49.0,-90.0,-93.0,-89.0,-92.0,50.0,56.0,44.0,41.0,1
796,92:69:1D:31:68:E9,3774895,489767899,12782,15252545,3762113,474515354,3,19242,3553671,18546,3393579,696,160092,6442,105,14037,252,3,251,216660.0,130000.0,-52.0,-48.0,-42.0,-48.0,-52.0,-48.0,-42.0,-47.0,-90.0,-93.0,-89.0,-92.0,38.0,45.0,47.0,44.0,1
797,CC:2F:71:3F:1F:24,3962651,710632354,200536,236116665,3762115,474515689,27,168969,193838425,168893,193828911,76,9514,161804,6,200534,20843,24,135,130000.0,39000.0,-69.0,-66.0,-70.0,-69.0,-68.0,-66.0,-70.0,-69.0,-90.0,-93.0,-89.0,-92.0,21.0,27.0,19.0,23.0,1
798,CC:2F:71:3E:C5:1F,3762202,474526235,87,10546,3762115,474515689,0,342,29334,277,21478,65,7856,93,2,117,4,0,5,130000.0,39000.0,-70.0,-70.0,-66.0,-60.0,-71.0,-72.0,-67.0,-61.0,-90.0,-93.0,-89.0,-92.0,20.0,23.0,23.0,32.0,1
799,BA:8C:B9:54:50:24,3762382,474598316,267,82627,3762115,474515689,0,1157,130441,1139,127595,18,2846,178,3,374,5,0,7,229410.0,130000.0,-40.0,-37.0,-45.0,-51.0,-42.0,-36.0,-44.0,-49.0,-90.0,-93.0,-89.0,-92.0,50.0,56.0,44.0,41.0,1
800,92:69:1D:31:68:E9,3774897,489768234,12782,15252545,3762115,474515689,3,19242,3553671,18546,3393579,696,160092,6442,105,14037,252,3,251,216660.0,130000.0,-52.0,-48.0,-42.0,-48.0,-52.0,-48.0,-42.0,-47.0,-90.0,-93.0,-89.0,-92.0,38.0,45.0,47.0,44.0,1
801,CC:2F:71:3F:1F:24,3962770,710757620,200648,236241265,3762122,474516355,27,169069,193958455,168993,193948941,76,9514,161897,6,200646,20845,24,135,130000.0,43333.0,-69.0,-66.0,-71.0,-69.0,-68.0,-66.0,-70.0,-69.0,-90.0,-93.0,-89.0,-92.0,21.0,27.0,18.0,23.0,1
802,CC:2F:71:3E:C5:1F,3762211,474527103,87,10546,3762124,474516557,0,342,29334,277,21478,65,7856,93,2,117,4,0,5,130000.0,39000.0,-70.0,-70.0,-66.0,-60.0,-71.0,-72.0,-67.0,-61.0,-90.0,-93.0,-89.0,-92.0,20.0,23.0,23.0,32.0,1
803,BA:8C:B9:54:50:24,3762391,474599184,267,82627,3762124,474516557,0,1157,130441,1139,127595,18,2846,178,3,374,5,0,7,229410.0,130000.0,-40.0,-37.0,-45.0,-51.0,-42.0,-36.0,-44.0,-49.0,-90.0,-93.0,-89.0,-92.0,50.0,56.0,44.0,41.0,1
804,92:69:1D:31:68:E9,3774906,489769102,12782,15252545,3762124,474516557,3,19242,3553671,18546,3393579,696,160092,6442,105,14037,252,3,251,216660.0,130000.0,-52.0,-48.0,-42.0,-48.0,-52.0,-48.0,-42.0,-47.0,-90.0,-93.0,-89.0,-92.0,38.0,45.0,47.0,44.0,1
805,CC:2F:71:3F:1F:24,3962879,710877652,200755,236361095,3762124,474516557,27,169163,194071849,169087,194062335,76,9514,161988,6,200753,20846,24,135,130000.0,43333.0,-69.0,-66.0,-70.0,-69.0,-68.0,-66.0,-70.0,-69.0,-90.0,-93.0,-89.0,-92.0,21.0,27.0,19.0,23.0,1
806,CC:2F:71:3E:C5:1F,3762211,474527103,87,10546,3762124,474516557,0,342,29334,277,21478,65,7856,93,2,117,4,0,5,130000.0,39000.0,-70.0,-70.0,-66.0,-60.0,-71.0,-72.0,-67.0,-61.0,-90.0,-93.0,-89.0,-92.0,20.0,23.0,23.0,32.0,1
807,BA:8C:B9:54:50:24,3762391,474599184,267,82627,3762124,474516557,0,1157,130441,1139,127595,18,2846,178,3,374,5,0,7,229410.0,130000.0,-40.0,-37.0,-45.0,-51.0,-42.0,-36.0,-44.0,-49.0,-90.0,-93.0,-89.0,-92.0,50.0,56.0,44.0,41.0,1
808,92:69:1D:31:68:E9,3774908,489769304,12782,15252545,3762126,474516759,3,19242,3553671,18546,3393579,696,160092,6442,105,14037,252,3,251,216660.0,130000.0,-52.0,-48.0,-42.0,-48.0,-52.0,-48.0,-42.0,-47.0,-90.0,-93.0,-89.0,-92.0,38.0,45.0,47.0,44.0,1
809,CC:2F:71:3F:1F:24,3962998,710998357,200868,236481194,3762130,474517163,27,169261,194184869,169185,194175355,76,9514,162082,6,200866,20850,24,135,130000.0,43333.0,-69.0,-66.0,-70.0,-68.0,-69.0,-66.0,-70.0,-68.0,-90.0,-93.0,-89.0,-92.0,21.0,27.0,19.0,24.0,1
810,CC:2F:71:3E:C5:1F,3762219,474527911,87,10546,3762132,474517365,0,342,29334,277,21478,65,7856,93,2,117,4,0,5,130000.0,39000.0,-70.0,-70.0,-66.0,-60.0,-71.0,-72.0,-67.0,-61.0,-90.0,-93.0,-89.0,-92.0,20.0,23.0,23.0,32.0,1
811,BA:8C:B9:54:50:24,3762399,474599992,267,82627,3762132,474517365,0,1157,130441,1139,127595,18,2846,178,3,374,5,0,7,229410.0,130000.0,-40.0,-37.0,-45.0,-51.0,-42.0,-36.0,-44.0,-49.0,-90.0,-93.0,-89.0,-92.0,50.0,56.0,44.0,41.0,1
812,92:69:1D:31:68:E9,3774914,489769910,12782,15252545,3762132,474517365,3,19242,3553671,18546,3393579,696,160092,6442,105,14037,252,3,251,216660.0,130000.0,-52.0,-48.0,-42.0,-48.0,-52.0,-48.0,-42.0,-47.0,-90.0,-93.0,-89.0,-92.0,38.0,45.0,47.0,44.0,1
813,CC:2F:71:3F:1F:24,3963108,711119873,200975,236602448,3762133,474517425,27,169359,194306135,169283,194296621,76,9514,162169,6,200973,20850,24,135,130000.0,43333.0,-68.0,-66.0,-70.0,-69.0,-68.0,-66.0,-70.0,-69.0,-90.0,-93.0,-89.0,-92.0,22.0,27.0,19.0,23.0,1
814,CC:2F:71:3E:C5:1F,3762220,474527971,87,10546,3762133,474517425,0,342,29334,277,21478,65,7856,93,2,117,4,0,5,130000.0,39000.0,-70.0,-70.0,-66.0,-60.0,-71.0,-72.0,-67.0,-61.0,-90.0,-93.0,-89.0,-92.0,20.0,23.0,23.0,32.0,1
815,BA:8C:B9:54:50:24,3762400,474600052,267,82627,3762133,474517425,0,1157,130441,1139,127595,18,2846,178,3,374,5,0,7,229410.0,130000.0,-40.0,-37.0,-45.0,-51.0,-42.0,-36.0,-44.0,-49.0,-90.0,-93.0,-89.0,-92.0,50.0,56.0,44.0,41.0,1
816,92:69:1D:31:68:E9,3774915,489769970,12782,15252545,3762133,474517425,3,19242,3553671,18546,3393579,696,160092,6442,105,14037,252,3,251,216660.0,130000.0,-52.0,-48.0,-42.0,-48.0,-52.0,-48.0,-42.0,-47.0,-90.0,-93.0,-89.0,-92.0,38.0,45.0,47.0,44.0,1
817,CC:2F:71:3F:1F:24,3963233,711245796,201082,236722166,3762151,474523630,27,169448,194414635,169372,194405121,76,9514,162258,6,201079,20854,24,135,117000.0,39000.0,-69.0,-66.0,-71.0,-69.0,-68.0,-66.0,-70.0,-69.0,-90.0,-93.0,-89.0,-92.0,21.0,27.0,18.0,23.0,1
818,CC:2F:71:3E:C5:1F,3762240,474534378,87,10546,3762153,474523832,0,342,29334,277,21478,65,7856,93,2,117,4,0,5,130000.0,39000.0,-70.0,-70.0,-66.0,-60.0,-71.0,-72.0,-67.0,-61.0,-90.0,-93.0,-89.0,-92.0,20.0,23.0,23.0,32.0,1
819,BA:8C:B9:54:50:24,3762420,474606459,267,82627,3762153,474523832,0,1157,130441,1139,127595,18,2846,178,3,374,5,0,7,229410.0,130000.0,-40.0,-37.0,-45.0,-51.0,-42.0,-36.0,-44.0,-49.0,-90.0,-93.0,-89.0,-92.0,50.0,56.0,44.0,41.0,1
820,92:69:1D:31:68:E9,3774946,489781801,12782,15252545,3762164,474529256,3,19246,3554110,18549,3393783,697,160327,6443,105,14037,252,3,251,216660.0,130000.0,-53.0,-48.0,-42.0,-48.0,-52.0,-48.0,-43.0,-48.0,-90.0,-93.0,-89.0,-92.0,37.0,45.0,47.0,44.0,1
821,CC:2F:71:3F:1F:24,3963363,711385316,201198,236855998,3762165,474529318,27,169550,194538937,169474,194529423,76,9514,162360,6,201196,20854,24,135,130000.0,43333.0,-69.0,-66.0,-70.0,-69.0,-68.0,-66.0,-70.0,-69.0,-90.0,-93.0,-89.0,-92.0,21.0,27.0,19.0,23.0,1
822,CC:2F:71:3E:C5:1F,3762252,474539864,87,10546,3762165,474529318,0,344,29522,278,21548,66,7974,94,2,117,4,0,5,130000.0,39000.0,-70.0,-70.0,-67.0,-60.0,-70.0,-70.0,-66.0,-60.0,-90.0,-93.0,-89.0,-92.0,20.0,23.0,22.0,32.0,1
823,BA:8C:B9:54:50:24,3762435,474612207,267,82627,3762168,474529580,0,1157,130441,1139,127595,18,2846,178,3,374,5,0,7,229410.0,130000.0,-40.0,-37.0,-45.0,-51.0,-42.0,-36.0,-44.0,-49.0,-91.0,-93.0,-89.0,-92.0,51.0,56.0,44.0,41.0,1
824,92:69:1D:31:68:E9,3774950,489782125,12782,15252545,3762168,474529580,3,19246,3554110,18549,3393783,697,160327,6443,105,14037,252,3,251,216660.0,130000.0,-53.0,-48.0,-42.0,-48.0,-52.0,-48.0,-43.0,-48.0,-91.0,-93.0,-89.0,-92.0,38.0,45.0,47.0,44.0,1
825,CC:2F:71:3F:1F:24,3963487,711509723,201311,236979169,3762176,474530554,27,169650,194650642,169574,194641128,76,9514,162459,6,201308,20854,24,135,130000.0,43333.0,-69.0,-66.0,-70.0,-69.0,-68.0,-66.0,-70.0,-69.0,-91.0,-93.0,-89.0,-92.0,22.0,27.0,19.0,23.0,1
826,CC:2F:71:3E:C5:1F,3762263,474541100,87,10546,3762176,474530554,0,344,29522,278,21548,66,7974,94,2,117,4,0,5,130000.0,39000.0,-70.0,-70.0,-67.0,-60.0,-70.0,-70.0,-66.0,-60.0,-91.0,-93.0,-89.0,-92.0,21.0,23.0,22.0,32.0,1
827,BA:8C:B9:54:50:24,3762443,474613181,267,82627,3762176,474530554,0,1160,130645,1142,127799,18,2846,178,4,375,6,0,7,229410.0,130000.0,-48.0,-35.0,-43.0,-45.0,-44.0,-36.0,-44.0,-48.0,-91.0,-93.0,-89.0,-92.0,43.0,58.0,46.0,47.0,1
828,92:69:1D:31:68:E9,3774958,489783099,12782,15252545,3762176,474530554,3,19246,3554110,18549,3393783,697,160327,6443,105,14037,252,3,251,216660.0,130000.0,-53.0,-48.0,-42.0,-48.0,-52.0,-48.0,-43.0,-48.0,-91.0,-93.0,-89.0,-92.0,38.0,45.0,47.0,44.0,1
829,CC:2F:71:3F:1F:24,3963592,711627645,201416,237097091,3762176,474530554,27,169742,194762600,169666,194753086,76,9514,162546,6,201414,20858,24,135,130000.0,43333.0,-69.0,-66.0,-70.0,-69.0,-68.0,-66.0,-70.0,-69.0,-91.0,-93.0,-89.0,-92.0,22.0,27.0,19.0,23.0,1
830,CC:2F:71:3E:C5:1F,3762263,474541100,87,10546,3762176,474530554,0,344,29522,278,21548,66,7974,94,2,117,4,0,5,130000.0,39000.0,-70.0,-70.0,-67.0,-60.0,-70.0,-70.0,-66.0,-60.0,-91.0,-93.0,-89.0,-92.0,21.0,23.0,22.0,32.0,1
831,BA:8C:B9:54:50:24,3762445,474613383,267,82627,3762178,474530756,0,1160,130645,1142,127799,18,2846,178,4,375,6,0,7,229410.0,130000.0,-48.0,-35.0,-43.0,-45.0,-44.0,-36.0,-44.0,-48.0,-91.0,-93.0,-89.0,-92.0,43.0,58.0,46.0,47.0,1
832,92:69:1D:31:68:E9,3774960,489783301,12782,15252545,3762178,474530756,3,19246,3554110,18549,3393783,697,160327,6443,105,14037,252,3,251,216660.0,130000.0,-53.0,-48.0,-42.0,-48.0,-52.0,-48.0,-43.0,-48.0,-91.0,-93.0,-89.0,-92.0,38.0,45.0,47.0,44.0,1
833,CC:2F:71:3F:1F:24,3963711,711751581,201526,237220159,3762185,474531422,27,169841,194883750,169765,194874236,76,9514,162638,6,201524,20858,24,135,130000.0,43333.0,-69.0,-66.0,-70.0,-68.0,-69.0,-66.0,-70.0,-68.0,-90.0,-93.0,-89.0,-92.0,21.0,27.0,19.0,24.0,1
834,CC:2F:71:3E:C5:1F,3762272,474541968,87,10546,3762185,474531422,0,344,29522,278,21548,66,7974,94,2,117,4,0,5,130000.0,39000.0,-70.0,-70.0,-67.0,-60.0,-70.0,-70.0,-66.0,-60.0,-90.0,-93.0,-89.0,-92.0,20.0,23.0,22.0,32.0,1
835,BA:8C:B9:54:50:24,3762452,474614049,267,82627,3762185,474531422,0,1160,130645,1142,127799,18,2846,178,4,375,6,0,7,229410.0,130000.0,-48.0,-35.0,-43.0,-45.0,-44.0,-36.0,-44.0,-48.0,-90.0,-93.0,-89.0,-92.0,42.0,58.0,46.0,47.0,1
836,92:69:1D:31:68:E9,3774967,489783967,12782,15252545,3762185,474531422,3,19246,3554110,18549,3393783,697,160327,6443,105,14037,252,3,251,216660.0,130000.0,-53.0,-48.0,-42.0,-48.0,-52.0,-48.0,-43.0,-48.0,-90.0,-93.0,-89.0,-92.0,37.0,45.0,47.0,44.0,1
837,CC:2F:71:3F:1F:24,3963816,711869727,201631,237338305,3762185,474531422,27,169943,195005680,169867,194996166,76,9514,162725,6,201629,20858,24,135,130000.0,43333.0,-69.0,-66.0,-71.0,-69.0,-69.0,-66.0,-70.0,-68.0,-90.0,-93.0,-89.0,-92.0,21.0,27.0,18.0,23.0,1
838,CC:2F:71:3E:C5:1F,3762272,474541968,87,10546,3762185,474531422,0,344,29522,278,21548,66,7974,94,2,117,4,0,5,130000.0,39000.0,-70.0,-70.0,-67.0,-60.0,-70.0,-70.0,-66.0,-60.0,-90.0,-93.0,-89.0,-92.0,20.0,23.0,22.0,32.0,1
839,BA:8C:B9:54:50:24,3762454,474614251,267,82627,3762187,474531624,0,1160,130645,1142,127799,18,2846,178,4,375,6,0,7,229410.0,130000.0,-48.0,-35.0,-43.0,-45.0,-44.0,-36.0,-44.0,-48.0,-90.0,-93.0,-89.0,-92.0,42.0,58.0,46.0,47.0,1
840,92:69:1D:31:68:E9,3774969,489784169,12782,15252545,3762187,474531624,3,19246,3554110,18549,3393783,697,160327,6443,105,14037,252,3,251,216660.0,130000.0,-53.0,-48.0,-42.0,-48.0,-52.0,-48.0,-43.0,-48.0,-90.0,-93.0,-89.0,-92.0,37.0,45.0,47.0,44.0,1
841,CC:2F:71:3F:1F:24,3963938,711993612,201745,237461382,3762193,474532230,27,170043,195121713,169967,195112199,76,9514,162820,6,201742,20868,24,135,130000.0,43333.0,-69.0,-66.0,-70.0,-68.0,-69.0,-66.0,-70.0,-68.0,-90.0,-93.0,-89.0,-92.0,21.0,27.0,19.0,24.0,1
842,CC:2F:71:3E:C5:1F,3762280,474542776,87,10546,3762193,474532230,0,344,29522,278,21548,66,7974,94,2,117,4,0,5,130000.0,39000.0,-70.0,-70.0,-67.0,-60.0,-70.0,-70.0,-66.0,-60.0,-90.0,-93.0,-89.0,-92.0,20.0,23.0,22.0,32.0,1
843,BA:8C:B9:54:50:24,3762460,474614857,267,82627,3762193,474532230,0,1160,130645,1142,127799,18,2846,178,4,375,6,0,7,229410.0,130000.0,-48.0,-35.0,-43.0,-45.0,-44.0,-36.0,-44.0,-48.0,-90.0,-93.0,-89.0,-92.0,42.0,58.0,46.0,47.0,1
844,92:69:1D:31:68:E9,3774975,489784775,12782,15252545,3762193,474532230,3,19246,3554110,18549,3393783,697,160327,6443,105,14037,252,3,251,216660.0,130000.0,-53.0,-48.0,-42.0,-48.0,-52.0,-48.0,-43.0,-48.0,-90.0,-93.0,-89.0,-92.0,37.0,45.0,47.0,44.0,1
845,CC:2F:71:3F:1F:24,3964046,712113278,201852,237580988,3762194,474532290,27,170136,195235331,170060,195225817,76,9514,162909,6,201850,20882,24,135,130000.0,43333.0,-69.0,-66.0,-70.0,-69.0,-69.0,-65.0,-70.0,-68.0,-90.0,-93.0,-89.0,-92.0,21.0,27.0,19.0,23.0,1
846,CC:2F:71:3E:C5:1F,3762281,474542836,87,10546,3762194,474532290,0,344,29522,278,21548,66,7974,94,2,117,4,0,5,130000.0,39000.0,-70.0,-70.0,-67.0,-60.0,-70.0,-70.0,-66.0,-60.0,-90.0,-93.0,-89.0,-92.0,20.0,23.0,22.0,32.0,1
847,BA:8C:B9:54:50:24,3762461,474614917,267,82627,3762194,474532290,0,1160,130645,1142,127799,18,2846,178,4,375,6,0,7,229410.0,130000.0,-48.0,-35.0,-43.0,-45.0,-44.0,-36.0,-44.0,-48.0,-90.0,-93.0,-89.0,-92.0,42.0,58.0,46.0,47.0,1
848,92:69:1D:31:68:E9,3774978,489785037,12782,15252545,3762196,474532492,3,19246,3554110,18549,3393783,697,160327,6443,105,14037,252,3,251,216660.0,130000.0,-53.0,-48.0,-42.0,-48.0,-52.0,-48.0,-43.0,-48.0,-90.0,-93.0,-89.0,-92.0,37.0,45.0,47.0,44.0,1
849,CC:2F:71:3F:1F:24,3964160,712233875,201959,237700706,3762201,474533169,27,170227,195348377,170151,195338863,76,9514,162997,6,201957,20887,24,135,130000.0,39000.0,-68.0,-66.0,-71.0,-68.0,-68.0,-66.0,-71.0,-68.0,-90.0,-93.0,-89.0,-92.0,22.0,27.0,18.0,24.0,1
850,CC:2F:71:3E:C5:1F,3762288,474543715,87,10546,3762201,474533169,0,344,29522,278,21548,66,7974,94,2,117,4,0,5,130000.0,39000.0,-70.0,-70.0,-67.0,-60.0,-70.0,-70.0,-66.0,-60.0,-90.0,-93.0,-89.0,-92.0,20.0,23.0,22.0,32.0,1
851,BA:8C:B9:54:50:24,3762470,474615998,267,82627,3762203,474533371,0,1160,130645,1142,127799,18,2846,178,4,375,6,0,7,229410.0,130000.0,-48.0,-35.0,-43.0,-45.0,-44.0,-36.0,-44.0,-48.0,-90.0,-93.0,-89.0,-92.0,42.0,58.0,46.0,47.0,1
852,92:69:1D:31:68:E9,3774985,489785916,12782,15252545,3762203,474533371,3,19246,3554110,18549,3393783,697,160327,6443,105,14037,252,3,251,216660.0,130000.0,-53.0,-48.0,-42.0,-48.0,-52.0,-48.0,-43.0,-48.0,-90.0,-93.0,-89.0,-92.0,37.0,45.0,47.0,44.0,1
853,CC:2F:71:3F:1F:24,3964272,712353961,202069,237820590,3762203,474533371,27,170325,195465344,170249,195455830,76,9514,163088,6,202066,20891,24,135,130000.0,43333.0,-68.0,-66.0,-73.0,-69.0,-68.0,-66.0,-72.0,-69.0,-90.0,-93.0,-89.0,-92.0,22.0,27.0,16.0,23.0,1
854,CC:2F:71:3E:C5:1F,3762290,474543917,87,10546,3762203,474533371,0,344,29522,278,21548,66,7974,94,2,117,4,0,5,130000.0,39000.0,-70.0,-70.0,-67.0,-60.0,-70.0,-70.0,-66.0,-60.0,-90.0,-93.0,-89.0,-92.0,20.0,23.0,22.0,32.0,1
855,BA:8C:B9:54:50:24,3762471,474616058,267,82627,3762204,474533431,0,1160,130645,1142,127799,18,2846,178,4,375,6,0,7,229410.0,130000.0,-48.0,-35.0,-43.0,-45.0,-44.0,-36.0,-44.0,-48.0,-90.0,-93.0,-89.0,-92.0,42.0,58.0,46.0,47.0,1
856,92:69:1D:31:68:E9,3774988,489786178,12782,15252545,3762206,474533633,3,19246,3554110,18549,3393783,697,160327,6443,105,14037,252,3,251,216660.0,130000.0,-53.0,-48.0,-42.0,-48.0,-52.0,-48.0,-43.0,-48.0,-90.0,-93.0,-89.0,-92.0,37.0,45.0,47.0,44.0,1
857,CC:2F:71:3F:1F:24,3964394,712477211,202184,237943174,3762210,474534037,27,170429,195580713,170353,195571199,76,9514,163187,6,202182,20892,24,135,130000.0,43333.0,-68.0,-65.0,-73.0,-69.0,-68.0,-65.0,-72.0,-68.0,-90.0,-93.0,-89.0,-92.0,22.0,28.0,16.0,23.0,1
858,CC:2F:71:3E:C5:1F,3762297,474544583,87,10546,3762210,474534037,0,344,29522,278,21548,66,7974,94,2,117,4,0,5,130000.0,39000.0,-70.0,-70.0,-67.0,-60.0,-70.0,-70.0,-66.0,-60.0,-90.0,-93.0,-89.0,-92.0,20.0,23.0,22.0,32.0,1
859,BA:8C:B9:54:50:24,3762479,474616866,267,82627,3762212,474534239,0,1160,130645,1142,127799,18,2846,178,4,375,6,0,7,229410.0,130000.0,-48.0,-35.0,-43.0,-45.0,-44.0,-36.0,-44.0,-48.0,-90.0,-93.0,-89.0,-92.0,42.0,58.0,46.0,47.0,1
860,92:69:1D:31:68:E9,3774994,489786784,12782,15252545,3762212,474534239,3,19246,3554110,18549,3393783,697,160327,6443,105,14037,252,3,251,216660.0,130000.0,-53.0,-48.0,-42.0,-48.0,-52.0,-48.0,-43.0,-48.0,-90.0,-93.0,-89.0,-92.0,37.0,45.0,47.0,44.0,1
861,CC:2F:71:3F:1F:24,3964855,713097218,202643,238562979,3762212,474534239,27,170650,195713575,170574,195704061,76,9514,163405,6,202641,20906,24,135,130000.0,43333.0,-67.0,-65.0,-70.0,-71.0,-67.0,-65.0,-70.0,-71.0,-90.0,-93.0,-89.0,-92.0,23.0,28.0,19.0,21.0,1
862,CC:2F:71:3E:C5:1F,3762299,474544785,87,10546,3762212,474534239,0,344,29522,278,21548,66,7974,94,2,117,4,0,5,130000.0,39000.0,-70.0,-70.0,-67.0,-60.0,-70.0,-70.0,-66.0,-60.0,-90.0,-93.0,-89.0,-92.0,20.0,23.0,22.0,32.0,1
863,BA:8C:B9:54:50:24,3762479,474616866,267,82627,3762212,474534239,0,1160,130645,1142,127799,18,2846,178,4,375,6,0,7,229410.0,130000.0,-48.0,-35.0,-43.0,-45.0,-44.0,-36.0,-44.0,-48.0,-90.0,-93.0,-89.0,-92.0,42.0,58.0,46.0,47.0,1
864,92:69:1D:31:68:E9,3774996,489786986,12782,15252545,3762214,474534441,3,19246,3554110,18549,3393783,697,160327,6443,105,14037,252,3,251,216660.0,130000.0,-53.0,-48.0,-42.0,-48.0,-52.0,-48.0,-43.0,-48.0,-90.0,-93.0,-89.0,-92.0,37.0,45.0,47.0,44.0,1
865,CC:2F:71:3F:1F:24,3965073,713287236,202854,238752331,3762219,474534905,27,170818,195848580,170742,195839066,76,9514,163561,6,202852,20916,24,135,130000.0,43333.0,-68.0,-65.0,-69.0,-69.0,-68.0,-65.0,-68.0,-69.0,-90.0,-93.0,-89.0,-92.0,22.0,28.0,20.0,23.0,1
866,CC:2F:71:3E:C5:1F,3762306,474545451,87,10546,3762219,474534905,0,344,29522,278,21548,66,7974,94,2,117,4,0,5,130000.0,39000.0,-70.0,-70.0,-67.0,-60.0,-70.0,-70.0,-66.0,-60.0,-90.0,-93.0,-89.0,-92.0,20.0,23.0,22.0,32.0,1
867,BA:8C:B9:54:50:24,3762488,474617734,267,82627,3762221,474535107,0,1160,130645,1142,127799,18,2846,178,4,375,6,0,7,229410.0,130000.0,-48.0,-35.0,-43.0,-45.0,-44.0,-36.0,-44.0,-48.0,-90.0,-93.0,-89.0,-92.0,42.0,58.0,46.0,47.0,1
868,92:69:1D:31:68:E9,3775003,489787652,12782,15252545,3762221,474535107,3,19246,3554110,18549,3393783,697,160327,6443,105,14037,252,3,251,216660.0,130000.0,-53.0,-48.0,-42.0,-48.0,-52.0,-48.0,-43.0,-48.0,-90.0,-93.0,-89.0,-92.0,37.0,45.0,47.0,44.0,1
869,CC:2F:71:3F:1F:24,3965182,713407268,202961,238872161,3762221,474535107,27,170914,195965084,170838,195955570,76,9514,163649,6,202959,20916,24,135,130000.0,43333.0,-68.0,-65.0,-68.0,-69.0,-68.0,-65.0,-68.0,-69.0,-90.0,-93.0,-89.0,-92.0,22.0,28.0,21.0,23.0,1
870,CC:2F:71:3E:C5:1F,3762308,474545653,87,10546,3762221,474535107,0,344,29522,278,21548,66,7974,94,2,117,4,0,5,130000.0,39000.0,-70.0,-70.0,-67.0,-60.0,-70.0,-70.0,-66.0,-60.0,-90.0,-93.0,-89.0,-92.0,20.0,23.0,22.0,32.0,1
871,BA:8C:B9:54:50:24,3762488,474617734,267,82627,3762221,474535107,0,1160,130645,1142,127799,18,2846,178,4,375,6,0,7,229410.0,130000.0,-48.0,-35.0,-43.0,-45.0,-44.0,-36.0,-44.0,-48.0,-90.0,-93.0,-89.0,-92.0,42.0,58.0,46.0,47.0,1
872,92:69:1D:31:68:E9,3775003,489787652,12782,15252545,3762221,474535107,3,19246,3554110,18549,3393783,697,160327,6443,105,14037,252,3,251,216660.0,130000.0,-53.0,-48.0,-42.0,-48.0,-52.0,-48.0,-43.0,-48.0,-90.0,-93.0,-89.0,-92.0,37.0,45.0,47.0,44.0,1
873,CC:2F:71:3F:1F:24,3965294,713527350,203067,238991637,3762227,474535713,27,171014,196087664,170938,196078150,76,9514,163737,6,203065,20920,24,135,130000.0,43333.0,-68.0,-65.0,-68.0,-70.0,-68.0,-65.0,-68.0,-69.0,-90.0,-93.0,-89.0,-92.0,22.0,28.0,21.0,22.0,1
874,CC:2F:71:3E:C5:1F,3762314,474546259,87,10546,3762227,474535713,0,344,29522,278,21548,66,7974,94,2,117,4,0,5,130000.0,39000.0,-70.0,-70.0,-67.0,-60.0,-70.0,-70.0,-66.0,-60.0,-90.0,-93.0,-89.0,-92.0,20.0,23.0,22.0,32.0,1
875,BA:8C:B9:54:50:24,3762494,474618340,267,82627,3762227,474535713,0,1160,130645,1142,127799,18,2846,178,4,375,6,0,7,229410.0,130000.0,-48.0,-35.0,-43.0,-45.0,-44.0,-36.0,-44.0,-48.0,-90.0,-93.0,-89.0,-92.0,42.0,58.0,46.0,47.0,1
876,92:69:1D:31:68:E9,3775011,489788460,12782,15252545,3762229,474535915,3,19246,3554110,18549,3393783,697,160327,6443,105,14037,252,3,251,216660.0,130000.0,-53.0,-48.0,-42.0,-48.0,-52.0,-48.0,-43.0,-48.0,-90.0,-93.0,-89.0,-92.0,37.0,45.0,47.0,44.0,1
877,CC:2F:71:3F:1F:24,3965403,713645874,203173,239109899,3762230,474535975,27,171108,196204090,171032,196194576,76,9514,163824,6,203171,20920,24,135,130000.0,43333.0,-68.0,-65.0,-68.0,-69.0,-68.0,-65.0,-68.0,-69.0,-90.0,-93.0,-89.0,-92.0,22.0,28.0,21.0,23.0,1
878,CC:2F:71:3E:C5:1F,3762317,474546521,87,10546,3762230,474535975,0,344,29522,278,21548,66,7974,94,2,117,4,0,5,130000.0,39000.0,-70.0,-70.0,-67.0,-60.0,-70.0,-70.0,-66.0,-60.0,-90.0,-93.0,-89.0,-92.0,20.0,23.0,22.0,32.0,1
879,BA:8C:B9:54:50:24,3762498,474618718,268,82743,3762230,474535975,0,1163,130849,1145,128003,18,2846,178,4,376,6,0,7,229410.0,130000.0,-41.0,-34.0,-42.0,-46.0,-43.0,-35.0,-43.0,-47.0,-90.0,-93.0,-89.0,-92.0,49.0,59.0,47.0,46.0,1
880,92:69:1D:31:68:E9,3775013,489788636,12783,15252661,3762230,474535975,3,19247,3554178,18550,3393851,697,160327,6443,105,14038,252,3,251,216660.0,130000.0,-51.0,-47.0,-42.0,-48.0,-52.0,-48.0,-43.0,-48.0,-90.0,-93.0,-89.0,-92.0,39.0,46.0,47.0,44.0,1
881,CC:2F:71:3F:1F:24,3965524,713769715,203287,239233072,3762237,474536643,27,171216,196326913,171140,196317399,76,9514,163922,6,203285,20924,24,135,117000.0,39000.0,-68.0,-65.0,-69.0,-69.0,-68.0,-65.0,-68.0,-69.0,-90.0,-93.0,-89.0,-92.0,22.0,28.0,20.0,23.0,1
882,CC:2F:71:3E:C5:1F,3762325,474547305,88,10662,3762237,474536643,0,348,29850,281,21758,67,8092,95,2,118,4,0,5,130000.0,39000.0,-72.0,-71.0,-67.0,-60.0,-70.0,-70.0,-66.0,-60.0,-90.0,-93.0,-89.0,-92.0,18.0,22.0,22.0,32.0,1
883,BA:8C:B9:54:50:24,3762505,474619386,268,82743,3762237,474536643,0,1164,130917,1146,128071,18,2846,178,4,376,6,0,7,229410.0,130000.0,-48.0,-35.0,-43.0,-45.0,-44.0,-35.0,-43.0,-46.0,-90.0,-93.0,-89.0,-92.0,42.0,58.0,46.0,47.0,1
884,92:69:1D:31:68:E9,3775020,489789304,12783,15252661,3762237,474536643,3,19248,3554246,18551,3393919,697,160327,6443,105,14038,252,3,251,216660.0,130000.0,-52.0,-47.0,-42.0,-48.0,-52.0,-48.0,-43.0,-48.0,-90.0,-93.0,-89.0,-92.0,38.0,46.0,47.0,44.0,1
885,CC:2F:71:3F:1F:24,3965634,713888273,203394,239351366,3762240,474536907,27,171316,196451227,171239,196441595,77,9632,164010,6,203392,20924,24,135,130000.0,43333.0,-69.0,-66.0,-69.0,-70.0,-68.0,-66.0,-69.0,-69.0,-90.0,-93.0,-89.0,-92.0,21.0,27.0,20.0,22.0,1
886,CC:2F:71:3E:C5:1F,3762328,474547569,88,10662,3762240,474536907,0,348,29850,281,21758,67,8092,95,2,118,4,0,5,130000.0,39000.0,-72.0,-71.0,-67.0,-60.0,-70.0,-70.0,-66.0,-60.0,-90.0,-93.0,-89.0,-92.0,18.0,22.0,22.0,32.0,1
887,BA:8C:B9:54:50:24,3762509,474619710,268,82743,3762241,474536967,0,1165,130985,1147,128139,18,2846,178,4,376,6,0,7,229410.0,130000.0,-40.0,-37.0,-45.0,-51.0,-44.0,-35.0,-43.0,-46.0,-90.0,-93.0,-89.0,-92.0,50.0,56.0,44.0,41.0,1
888,92:69:1D:31:68:E9,3775024,489789628,12783,15252661,3762241,474536967,3,19248,3554246,18551,3393919,697,160327,6443,105,14038,252,3,251,216660.0,130000.0,-52.0,-47.0,-42.0,-48.0,-52.0,-48.0,-43.0,-48.0,-90.0,-93.0,-89.0,-92.0,38.0,46.0,47.0,44.0,1
889,CC:2F:71:3F:1F:24,3965749,714007461,203502,239469888,3762247,474537573,27,171410,196564639,171333,196555007,77,9632,164099,6,203500,20924,24,135,130000.0,43333.0,-69.0,-66.0,-69.0,-69.0,-69.0,-66.0,-69.0,-69.0,-90.0,-93.0,-89.0,-92.0,21.0,27.0,20.0,23.0,1
890,CC:2F:71:3E:C5:1F,3762335,474548235,88,10662,3762247,474537573,0,348,29850,281,21758,67,8092,95,2,118,4,0,5,130000.0,39000.0,-72.0,-71.0,-67.0,-60.0,-70.0,-70.0,-66.0,-60.0,-90.0,-93.0,-89.0,-92.0,18.0,22.0,22.0,32.0,1
891,BA:8C:B9:54:50:24,3762515,474620316,268,82743,3762247,474537573,0,1165,130985,1147,128139,18,2846,178,4,376,6,0,7,229410.0,130000.0,-40.0,-37.0,-45.0,-51.0,-44.0,-35.0,-43.0,-46.0,-90.0,-93.0,-89.0,-92.0,50.0,56.0,44.0,41.0,1
892,92:69:1D:31:68:E9,3775030,489790234,12783,15252661,3762247,474537573,3,19248,3554246,18551,3393919,697,160327,6443,105,14038,252,3,251,216660.0,130000.0,-52.0,-47.0,-42.0,-48.0,-52.0,-48.0,-43.0,-48.0,-90.0,-93.0,-89.0,-92.0,38.0,46.0,47.0,44.0,1
893,CC:2F:71:3F:1F:24,3965857,714124291,203608,239586516,3762249,474537775,27,171500,196674721,171423,196665089,77,9632,164186,6,203606,20928,24,135,130000.0,43333.0,-69.0,-66.0,-70.0,-69.0,-68.0,-66.0,-69.0,-69.0,-90.0,-93.0,-89.0,-92.0,21.0,27.0,19.0,23.0,1
894,CC:2F:71:3E:C5:1F,3762337,474548437,88,10662,3762249,474537775,0,348,29850,281,21758,67,8092,95,2,118,4,0,5,130000.0,39000.0,-72.0,-71.0,-67.0,-60.0,-70.0,-70.0,-66.0,-60.0,-90.0,-93.0,-89.0,-92.0,18.0,22.0,22.0,32.0,1
895,BA:8C:B9:54:50:24,3762517,474620518,268,82743,3762249,474537775,0,1165,130985,1147,128139,18,2846,178,4,376,6,0,7,229410.0,130000.0,-40.0,-37.0,-45.0,-51.0,-44.0,-35.0,-43.0,-46.0,-90.0,-93.0,-89.0,-92.0,50.0,56.0,44.0,41.0,1
896,92:69:1D:31:68:E9,3775032,489790436,12783,15252661,3762249,474537775,3,19248,3554246,18551,3393919,697,160327,6443,105,14038,252,3,251,216660.0,130000.0,-52.0,-47.0,-42.0,-48.0,-52.0,-48.0,-43.0,-48.0,-90.0,-93.0,-89.0,-92.0,38.0,46.0,47.0,44.0,1
897,CC:2F:71:3F:1F:24,3965980,714247156,203724,239708715,3762256,474538441,27,171599,196786370,171522,196776738,77,9632,164283,6,203722,20928,24,135,130000.0,43333.0,-69.0,-66.0,-69.0,-70.0,-69.0,-66.0,-69.0,-70.0,-90.0,-93.0,-89.0,-92.0,21.0,27.0,20.0,22.0,1
898,CC:2F:71:3E:C5:1F,3762344,474549103,88,10662,3762256,474538441,0,348,29850,281,21758,67,8092,95,2,118,4,0,5,130000.0,39000.0,-72.0,-71.0,-67.0,-60.0,-70.0,-70.0,-66.0,-60.0,-90.0,-93.0,-89.0,-92.0,18.0,22.0,22.0,32.0,1
899,BA:8C:B9:54:50:24,3762524,474621184,268,82743,3762256,474538441,0,1165,130985,1147,128139,18,2846,178,4,376,6,0,7,229410.0,130000.0,-40.0,-37.0,-45.0,-51.0,-44.0,-35.0,-43.0,-46.0,-90.0,-93.0,-89.0,-92.0,50.0,56.0,44.0,41.0,1
900,92:69:1D:31:68:E9,3775039,489791102,12783,15252661,3762256,474538441,3,19248,3554246,18551,3393919,697,160327,6443,105,14038,252,3,251,216660.0,130000.0,-52.0,-47.0,-42.0,-48.0,-52.0,-48.0,-43.0,-48.0,-90.0,-93.0,-89.0,-92.0,38.0,46.0,47.0,44.0,1
901,CC:2F:71:3F:1F:24,3966087,714365504,203829,239826861,3762258,474538643,27,171687,196894768,171610,196885136,77,9632,164370,6,203827,20928,24,135,130000.0,43333.0,-70.0,-67.0,-71.0,-69.0,-69.0,-65.0,-71.0,-68.0,-90.0,-93.0,-89.0,-92.0,20.0,26.0,18.0,23.0,1
902,CC:2F:71:3E:C5:1F,3762346,474549305,88,10662,3762258,474538643,0,348,29850,281,21758,67,8092,95,2,118,4,0,5,130000.0,39000.0,-72.0,-71.0,-67.0,-60.0,-70.0,-70.0,-66.0,-60.0,-90.0,-93.0,-89.0,-92.0,18.0,22.0,22.0,32.0,1
903,BA:8C:B9:54:50:24,3762526,474621386,268,82743,3762258,474538643,0,1165,130985,1147,128139,18,2846,178,4,376,6,0,7,229410.0,130000.0,-40.0,-37.0,-45.0,-51.0,-44.0,-35.0,-43.0,-46.0,-90.0,-93.0,-89.0,-92.0,50.0,56.0,44.0,41.0,1
904,92:69:1D:31:68:E9,3775042,489791577,12783,15252661,3762259,474538916,3,19248,3554246,18551,3393919,697,160327,6443,105,14038,252,3,251,216660.0,130000.0,-52.0,-47.0,-42.0,-48.0,-52.0,-48.0,-43.0,-48.0,-90.0,-93.0,-89.0,-92.0,38.0,46.0,47.0,44.0,1
905,CC:2F:71:3F:1F:24,3966197,714483991,203934,239944671,3762263,474539320,27,171775,197001822,171698,196992190,77,9632,164457,6,203932,20945,24,135,117000.0,39000.0,-68.0,-66.0,-71.0,-68.0,-68.0,-66.0,-71.0,-69.0,-90.0,-93.0,-89.0,-92.0,22.0,27.0,18.0,24.0,1
906,CC:2F:71:3E:C5:1F,3762353,474550184,88,10662,3762265,474539522,0,348,29850,281,21758,67,8092,95,2,118,4,0,5,130000.0,39000.0,-72.0,-71.0,-67.0,-60.0,-70.0,-70.0,-66.0,-60.0,-90.0,-93.0,-89.0,-92.0,18.0,22.0,22.0,32.0,1
907,BA:8C:B9:54:50:24,3762533,474622265,268,82743,3762265,474539522,0,1165,130985,1147,128139,18,2846,178,4,376,6,0,7,229410.0,130000.0,-40.0,-37.0,-45.0,-51.0,-44.0,-35.0,-43.0,-46.0,-90.0,-93.0,-89.0,-92.0,50.0,56.0,44.0,41.0,1
908,92:69:1D:31:68:E9,3775048,489792183,12783,15252661,3762265,474539522,3,19248,3554246,18551,3393919,697,160327,6443,105,14038,252,3,251,216660.0,130000.0,-52.0,-47.0,-42.0,-48.0,-52.0,-48.0,-43.0,-48.0,-90.0,-93.0,-89.0,-92.0,38.0,46.0,47.0,44.0,1
909,CC:2F:71:3F:1F:24,3966308,714604043,204040,240064259,3762268,474539784,27,171869,197115578,171792,197105946,77,9632,164545,6,204038,20947,24,135,130000.0,43333.0,-70.0,-67.0,-71.0,-67.0,-70.0,-66.0,-71.0,-67.0,-90.0,-93.0,-89.0,-91.0,20.0,26.0,18.0,24.0,1
910,CC:2F:71:3E:C5:1F,3762356,474550446,88,10662,3762268,474539784,0,348,29850,281,21758,67,8092,95,2,118,4,0,5,130000.0,39000.0,-72.0,-71.0,-67.0,-60.0,-70.0,-70.0,-66.0,-60.0,-90.0,-93.0,-89.0,-91.0,18.0,22.0,22.0,31.0,1
911,BA:8C:B9:54:50:24,3762536,474622527,268,82743,3762268,474539784,0,1165,130985,1147,128139,18,2846,178,4,376,6,0,7,229410.0,130000.0,-40.0,-37.0,-45.0,-51.0,-44.0,-35.0,-43.0,-46.0,-90.0,-93.0,-89.0,-91.0,50.0,56.0,44.0,40.0,1
912,92:69:1D:31:68:E9,3775051,489792445,12783,15252661,3762268,474539784,3,19248,3554246,18551,3393919,697,160327,6443,105,14038,252,3,251,216660.0,130000.0,-52.0,-47.0,-42.0,-48.0,-52.0,-48.0,-43.0,-48.0,-90.0,-93.0,-89.0,-91.0,38.0,46.0,47.0,43.0,1
913,CC:2F:71:3F:1F:24,3966426,714729060,204154,240188872,3762272,474540188,27,171973,197232088,171896,197222456,77,9632,164643,6,204152,20960,24,135,117000.0,39000.0,-67.0,-66.0,-70.0,-68.0,-67.0,-66.0,-70.0,-68.0,-90.0,-92.0,-88.0,-91.0,23.0,26.0,18.0,23.0,1
914,CC:2F:71:3E:C5:1F,3762362,474551052,88,10662,3762274,474540390,0,348,29850,281,21758,67,8092,95,2,118,4,0,5,130000.0,39000.0,-72.0,-71.0,-67.0,-60.0,-70.0,-70.0,-66.0,-60.0,-90.0,-92.0,-88.0,-91.0,18.0,21.0,21.0,31.0,1
915,BA:8C:B9:54:50:24,3762542,474623133,268,82743,3762274,474540390,0,1165,130985,1147,128139,18,2846,178,4,376,6,0,7,229410.0,130000.0,-40.0,-37.0,-45.0,-51.0,-44.0,-35.0,-43.0,-46.0,-90.0,-92.0,-88.0,-91.0,50.0,55.0,43.0,40.0,1
916,92:69:1D:31:68:E9,3775057,489793051,12783,15252661,3762274,474540390,3,19248,3554246,18551,3393919,697,160327,6443,105,14038,252,3,251,216660.0,130000.0,-52.0,-47.0,-42.0,-48.0,-52.0,-48.0,-43.0,-48.0,-90.0,-92.0,-88.0,-91.0,38.0,45.0,46.0,43.0,1
917,CC:2F:71:3F:1F:24,3966535,714846074,204259,240305482,3762276,474540592,27,172065,197344110,171988,197334478,77,9632,164730,6,204257,20961,24,135,130000.0,43333.0,-68.0,-67.0,-71.0,-69.0,-68.0,-66.0,-71.0,-68.0,-90.0,-92.0,-88.0,-91.0,22.0,25.0,17.0,22.0,1
918,CC:2F:71:3E:C5:1F,3762364,474551254,88,10662,3762276,474540592,0,348,29850,281,21758,67,8092,95,2,118,4,0,5,130000.0,39000.0,-72.0,-71.0,-67.0,-60.0,-70.0,-70.0,-66.0,-60.0,-90.0,-92.0,-88.0,-91.0,18.0,21.0,21.0,31.0,1
919,BA:8C:B9:54:50:24,3762545,474623395,268,82743,3762277,474540652,0,1165,130985,1147,128139,18,2846,178,4,376,6,0,7,229410.0,130000.0,-40.0,-37.0,-45.0,-51.0,-44.0,-35.0,-43.0,-46.0,-90.0,-92.0,-88.0,-91.0,50.0,55.0,43.0,40.0,1
920,92:69:1D:31:68:E9,3775060,489793313,12783,15252661,3762277,474540652,3,19248,3554246,18551,3393919,697,160327,6443,105,14038,252,3,251,216660.0,130000.0,-52.0,-47.0,-42.0,-48.0,-52.0,-48.0,-43.0,-48.0,-90.0,-92.0,-88.0,-91.0,38.0,45.0,46.0,43.0,1
921,CC:2F:71:3F:1F:24,3966646,714966238,204365,240425182,3762281,474541056,27,172162,197462242,172085,197452610,77,9632,164819,6,204363,20963,24,135,130000.0,43333.0,-68.0,-67.0,-70.0,-69.0,-68.0,-66.0,-70.0,-68.0,-90.0,-92.0,-88.0,-91.0,22.0,25.0,18.0,22.0,1
922,CC:2F:71:3E:C5:1F,3762371,474551920,88,10662,3762283,474541258,0,348,29850,281,21758,67,8092,95,2,118,4,0,5,130000.0,39000.0,-72.0,-71.0,-67.0,-60.0,-70.0,-70.0,-66.0,-60.0,-90.0,-92.0,-88.0,-91.0,18.0,21.0,21.0,31.0,1
923,BA:8C:B9:54:50:24,3762551,474624001,268,82743,3762283,474541258,0,1165,130985,1147,128139,18,2846,178,4,376,6,0,7,229410.0,130000.0,-40.0,-37.0,-45.0,-51.0,-44.0,-35.0,-43.0,-46.0,-90.0,-92.0,-88.0,-91.0,50.0,55.0,43.0,40.0,1
924,92:69:1D:31:68:E9,3775066,489793919,12783,15252661,3762283,474541258,3,19248,3554246,18551,3393919,697,160327,6443,105,14038,252,3,251,216660.0,130000.0,-52.0,-47.0,-42.0,-48.0,-52.0,-48.0,-43.0,-48.0,-90.0,-92.0,-88.0,-91.0,38.0,45.0,46.0,43.0,1
925,CC:2F:71:3F:1F:24,3966755,715083140,204470,240541680,3762285,474541460,27,172251,197572194,172174,197562562,77,9632,164906,6,204468,20967,24,135,130000.0,43333.0,-69.0,-66.0,-71.0,-69.0,-69.0,-66.0,-70.0,-69.0,-90.0,-92.0,-88.0,-91.0,21.0,26.0,17.0,22.0,1
926,CC:2F:71:3E:C5:1F,3762373,474552122,88,10662,3762285,474541460,0,348,29850,281,21758,67,8092,95,2,118,4,0,5,130000.0,39000.0,-72.0,-71.0,-67.0,-60.0,-70.0,-70.0,-66.0,-60.0,-90.0,-92.0,-88.0,-91.0,18.0,21.0,21.0,31.0,1
927,BA:8C:B9:54:50:24,3762553,474624203,268,82743,3762285,474541460,0,1165,130985,1147,128139,18,2846,178,4,376,6,0,7,229410.0,130000.0,-40.0,-37.0,-45.0,-51.0,-44.0,-35.0,-43.0,-46.0,-90.0,-92.0,-88.0,-91.0,50.0,55.0,43.0,40.0,1
928,92:69:1D:31:68:E9,3775068,489794121,12783,15252661,3762285,474541460,3,19248,3554246,18551,3393919,697,160327,6443,105,14038,252,3,251,216660.0,130000.0,-52.0,-47.0,-42.0,-48.0,-52.0,-48.0,-43.0,-48.0,-90.0,-92.0,-88.0,-91.0,38.0,45.0,46.0,43.0,1
929,CC:2F:71:3F:1F:24,3966871,715206573,204583,240664851,3762288,474541722,27,172349,197682527,172272,197672895,77,9632,165001,6,204581,20967,24,135,130000.0,43333.0,-69.0,-66.0,-70.0,-69.0,-68.0,-66.0,-70.0,-69.0,-90.0,-92.0,-88.0,-91.0,21.0,26.0,18.0,22.0,1
930,CC:2F:71:3E:C5:1F,3762378,474552586,88,10662,3762290,474541924,0,349,29920,282,21828,67,8092,95,2,119,4,0,5,130000.0,39000.0,-70.0,-70.0,-66.0,-60.0,-70.0,-70.0,-66.0,-60.0,-90.0,-92.0,-88.0,-91.0,20.0,22.0,22.0,31.0,1
931,BA:8C:B9:54:50:24,3762560,474624869,268,82743,3762292,474542126,0,1165,130985,1147,128139,18,2846,178,4,376,6,0,7,229410.0,130000.0,-40.0,-37.0,-45.0,-51.0,-44.0,-35.0,-43.0,-46.0,-90.0,-92.0,-88.0,-91.0,50.0,55.0,43.0,40.0,1
932,92:69:1D:31:68:E9,3775075,489794787,12783,15252661,3762292,474542126,3,19249,3554314,18552,3393987,697,160327,6443,105,14039,252,3,251,216660.0,130000.0,-51.0,-48.0,-42.0,-48.0,-52.0,-48.0,-42.0,-48.0,-90.0,-92.0,-88.0,-91.0,39.0,44.0,46.0,43.0,1
933,CC:2F:71:3F:1F:24,3966984,715325553,204690,240783225,3762294,474542328,27,172445,197799229,172368,197789597,77,9632,165088,6,204688,20967,24,135,130000.0,43333.0,-69.0,-66.0,-71.0,-69.0,-68.0,-66.0,-70.0,-69.0,-90.0,-92.0,-88.0,-91.0,21.0,26.0,17.0,22.0,1
934,CC:2F:71:3E:C5:1F,3762382,474552990,88,10662,3762294,474542328,0,350,29990,283,21898,67,8092,95,2,119,4,0,5,130000.0,39000.0,-71.0,-71.0,-66.0,-60.0,-71.0,-70.0,-66.0,-60.0,-90.0,-92.0,-88.0,-91.0,19.0,21.0,22.0,31.0,1
935,BA:8C:B9:54:50:24,3762562,474625071,268,82743,3762294,474542328,0,1167,131121,1149,128275,18,2846,178,4,377,6,0,7,229410.0,130000.0,-49.0,-35.0,-43.0,-45.0,-43.0,-35.0,-43.0,-47.0,-90.0,-92.0,-88.0,-91.0,41.0,57.0,45.0,46.0,1
936,92:69:1D:31:68:E9,3775077,489794989,12783,15252661,3762294,474542328,3,19250,3554382,18553,3394055,697,160327,6443,105,14039,252,3,251,216660.0,130000.0,-51.0,-48.0,-43.0,-48.0,-52.0,-48.0,-43.0,-48.0,-90.0,-92.0,-88.0,-91.0,39.0,44.0,45.0,43.0,1
937,CC:2F:71:3F:1F:24,3967092,715443863,204796,240901333,3762296,474542530,27,172533,197907627,172456,197897995,77,9632,165175,6,204794,20967,24,135,144444.0,43333.0,-68.0,-67.0,-71.0,-69.0,-68.0,-67.0,-71.0,-69.0,-90.0,-92.0,-88.0,-91.0,22.0,25.0,17.0,22.0,1
938,CC:2F:71:3E:C5:1F,3762384,474553192,88,10662,3762296,474542530,0,350,29990,283,21898,67,8092,95,2,119,4,0,5,130000.0,39000.0,-71.0,-71.0,-66.0,-60.0,-71.0,-70.0,-66.0,-60.0,-90.0,-92.0,-88.0,-91.0,19.0,21.0,22.0,31.0,1
939,BA:8C:B9:54:50:24,3762566,474625475,268,82743,3762298,474542732,0,1167,131121,1149,128275,18,2846,178,4,377,6,0,7,229410.0,130000.0,-49.0,-35.0,-43.0,-45.0,-43.0,-35.0,-43.0,-47.0,-90.0,-92.0,-88.0,-91.0,41.0,57.0,45.0,46.0,1
940,92:69:1D:31:68:E9,3775083,489795595,12783,15252661,3762300,474542934,3,19250,3554382,18553,3394055,697,160327,6443,105,14039,252,3,251,216660.0,130000.0,-51.0,-48.0,-43.0,-48.0,-52.0,-48.0,-43.0,-48.0,-90.0,-92.0,-88.0,-91.0,39.0,44.0,45.0,43.0,1
941,CC:2F:71:3F:1F:24,3967205,715561751,204902,241018555,3762303,474543196,27,172628,198024185,172551,198014553,77,9632,165262,6,204900,20968,24,135,144444.0,43333.0,-69.0,-67.0,-71.0,-69.0,-69.0,-67.0,-71.0,-68.0,-90.0,-92.0,-88.0,-91.0,21.0,25.0,17.0,22.0,1
942,CC:2F:71:3E:C5:1F,3762391,474553858,88,10662,3762303,474543196,0,350,29990,283,21898,67,8092,95,2,119,4,0,5,130000.0,39000.0,-71.0,-71.0,-66.0,-60.0,-71.0,-70.0,-66.0,-60.0,-90.0,-92.0,-88.0,-91.0,19.0,21.0,22.0,31.0,1
943,BA:8C:B9:54:50:24,3762571,474625939,268,82743,3762303,474543196,0,1167,131121,1149,128275,18,2846,178,4,377,6,0,7,229410.0,130000.0,-49.0,-35.0,-43.0,-45.0,-43.0,-35.0,-43.0,-47.0,-90.0,-92.0,-88.0,-91.0,41.0,57.0,45.0,46.0,1
944,92:69:1D:31:68:E9,3775086,489795857,12783,15252661,3762303,474543196,3,19250,3554382,18553,3394055,697,160327,6443,105,14039,252,3,251,216660.0,130000.0,-51.0,-48.0,-43.0,-48.0,-52.0,-48.0,-43.0,-48.0,-90.0,-92.0,-88.0,-91.0,39.0,44.0,45.0,43.0,1
945,CC:2F:71:3F:1F:24,3967321,715685254,205016,241141856,3762305,474543398,27,172731,198140959,172654,198131327,77,9632,165358,6,205013,20975,24,135,144444.0,43333.0,-68.0,-67.0,-71.0,-68.0,-68.0,-66.0,-71.0,-68.0,-90.0,-92.0,-88.0,-91.0,22.0,25.0,17.0,23.0,1
946,CC:2F:71:3E:C5:1F,3762393,474554060,88,10662,3762305,474543398,0,350,29990,283,21898,67,8092,95,2,119,4,0,5,130000.0,39000.0,-71.0,-71.0,-66.0,-60.0,-71.0,-70.0,-66.0,-60.0,-90.0,-92.0,-88.0,-91.0,19.0,21.0,22.0,31.0,1
947,BA:8C:B9:54:50:24,3762573,474626141,268,82743,3762305,474543398,0,1167,131121,1149,128275,18,2846,178,4,377,6,0,7,229410.0,130000.0,-49.0,-35.0,-43.0,-45.0,-43.0,-35.0,-43.0,-47.0,-90.0,-92.0,-88.0,-91.0,41.0,57.0,45.0,46.0,1
948,92:69:1D:31:68:E9,3775090,489796261,12783,15252661,3762307,474543600,3,19250,3554382,18553,3394055,697,160327,6443,105,14039,252,3,251,216660.0,130000.0,-51.0,-48.0,-43.0,-48.0,-52.0,-48.0,-43.0,-48.0,-90.0,-92.0,-88.0,-91.0,39.0,44.0,45.0,43.0,1
949,CC:2F:71:3F:1F:24,3967431,715802452,205120,241258448,3762311,474544004,27,172820,198248063,172743,198238431,77,9632,165445,6,205118,20984,24,135,144444.0,43333.0,-68.0,-67.0,-72.0,-69.0,-68.0,-67.0,-72.0,-69.0,-90.0,-92.0,-88.0,-91.0,22.0,25.0,16.0,22.0,1
950,CC:2F:71:3E:C5:1F,3762399,474554666,88,10662,3762311,474544004,0,350,29990,283,21898,67,8092,95,2,119,4,0,5,130000.0,39000.0,-71.0,-71.0,-66.0,-60.0,-71.0,-70.0,-66.0,-60.0,-90.0,-92.0,-88.0,-91.0,19.0,21.0,22.0,31.0,1
951,BA:8C:B9:54:50:24,3762579,474626747,268,82743,3762311,474544004,0,1167,131121,1149,128275,18,2846,178,4,377,6,0,7,229410.0,130000.0,-49.0,-35.0,-43.0,-45.0,-43.0,-35.0,-43.0,-47.0,-90.0,-92.0,-88.0,-91.0,41.0,57.0,45.0,46.0,1
952,92:69:1D:31:68:E9,3775094,489796665,12783,15252661,3762311,474544004,3,19250,3554382,18553,3394055,697,160327,6443,105,14039,252,3,251,216660.0,130000.0,-51.0,-48.0,-43.0,-48.0,-52.0,-48.0,-43.0,-48.0,-90.0,-92.0,-88.0,-91.0,39.0,44.0,45.0,43.0,1
953,CC:2F:71:3F:1F:24,3967538,715920730,205224,241376464,3762314,474544266,27,172912,198359895,172835,198350263,77,9632,165533,6,205222,20986,24,135,144444.0,43333.0,-68.0,-67.0,-72.0,-69.0,-68.0,-67.0,-71.0,-69.0,-90.0,-92.0,-88.0,-91.0,22.0,25.0,16.0,22.0,1
954,CC:2F:71:3E:C5:1F,3762402,474554928,88,10662,3762314,474544266,0,350,29990,283,21898,67,8092,95,2,119,4,0,5,130000.0,39000.0,-71.0,-71.0,-66.0,-60.0,-71.0,-70.0,-66.0,-60.0,-90.0,-92.0,-88.0,-91.0,19.0,21.0,22.0,31.0,1
955,BA:8C:B9:54:50:24,3762582,474627009,268,82743,3762314,474544266,0,1167,131121,1149,128275,18,2846,178,4,377,6,0,7,229410.0,130000.0,-49.0,-35.0,-43.0,-45.0,-43.0,-35.0,-43.0,-47.0,-90.0,-92.0,-88.0,-91.0,41.0,57.0,45.0,46.0,1
956,92:69:1D:31:68:E9,3775099,489797129,12783,15252661,3762316,474544468,3,19250,3554382,18553,3394055,697,160327,6443,105,14039,252,3,251,216660.0,130000.0,-51.0,-48.0,-43.0,-48.0,-52.0,-48.0,-43.0,-48.0,-90.0,-92.0,-88.0,-91.0,39.0,44.0,45.0,43.0,1
957,CC:2F:71:3F:1F:24,3967653,716042993,205332,241497848,3762321,474545145,27,173011,198481263,172934,198471631,77,9632,165622,6,205330,20987,24,135,144444.0,43333.0,-69.0,-67.0,-72.0,-69.0,-69.0,-67.0,-72.0,-69.0,-90.0,-92.0,-88.0,-91.0,21.0,25.0,16.0,22.0,1
958,CC:2F:71:3E:C5:1F,3762409,474555807,88,10662,3762321,474545145,0,350,29990,283,21898,67,8092,95,2,119,4,0,5,130000.0,39000.0,-71.0,-71.0,-66.0,-60.0,-71.0,-70.0,-66.0,-60.0,-90.0,-92.0,-88.0,-91.0,19.0,21.0,22.0,31.0,1
959,BA:8C:B9:54:50:24,3762589,474627888,268,82743,3762321,474545145,0,1167,131121,1149,128275,18,2846,178,4,377,6,0,7,229410.0,130000.0,-49.0,-35.0,-43.0,-45.0,-43.0,-35.0,-43.0,-47.0,-90.0,-92.0,-88.0,-91.0,41.0,57.0,45.0,46.0,1
960,92:69:1D:31:68:E9,3775104,489797806,12783,15252661,3762321,474545145,3,19250,3554382,18553,3394055,697,160327,6443,105,14039,252,3,251,216660.0,130000.0,-51.0,-48.0,-43.0,-48.0,-52.0,-48.0,-43.0,-48.0,-90.0,-92.0,-88.0,-91.0,39.0,44.0,45.0,43.0,1
961,CC:2F:71:3F:1F:24,3967769,716165002,205445,241619595,3762324,474545407,27,173114,198597896,173037,198588264,77,9632,165718,6,205443,20989,24,135,144444.0,43333.0,-69.0,-67.0,-72.0,-69.0,-68.0,-67.0,-71.0,-69.0,-90.0,-92.0,-88.0,-91.0,21.0,25.0,16.0,22.0,1
962,CC:2F:71:3E:C5:1F,3762412,474556069,88,10662,3762324,474545407,0,350,29990,283,21898,67,8092,95,2,119,4,0,5,130000.0,39000.0,-71.0,-71.0,-66.0,-60.0,-71.0,-70.0,-66.0,-60.0,-89.0,-91.0,-88.0,-90.0,18.0,20.0,22.0,30.0,1
963,BA:8C:B9:54:50:24,3762592,474628150,268,82743,3762324,474545407,0,1167,131121,1149,128275,18,2846,178,4,377,6,0,7,229410.0,130000.0,-49.0,-35.0,-43.0,-45.0,-43.0,-35.0,-43.0,-47.0,-89.0,-91.0,-88.0,-90.0,40.0,56.0,45.0,45.0,1
964,92:69:1D:31:68:E9,3775109,489798270,12783,15252661,3762326,474545609,3,19250,3554382,18553,3394055,697,160327,6443,105,14039,252,3,251,216660.0,130000.0,-51.0,-48.0,-43.0,-48.0,-52.0,-48.0,-43.0,-48.0,-89.0,-91.0,-88.0,-90.0,38.0,43.0,45.0,42.0,1
965,CC:2F:71:3F:1F:24,3967882,716284014,205552,241738001,3762330,474546013,27,173206,198709634,173129,198700002,77,9632,165807,6,205550,20989,24,135,144444.0,43333.0,-69.0,-67.0,-72.0,-69.0,-69.0,-67.0,-72.0,-69.0,-89.0,-91.0,-88.0,-90.0,20.0,24.0,16.0,21.0,1
966,CC:2F:71:3E:C5:1F,3762418,474556675,88,10662,3762330,474546013,0,350,29990,283,21898,67,8092,95,2,119,4,0,5,130000.0,39000.0,-71.0,-71.0,-66.0,-60.0,-71.0,-70.0,-66.0,-60.0,-89.0,-91.0,-88.0,-90.0,18.0,20.0,22.0,30.0,1
967,BA:8C:B9:54:50:24,3762598,474628756,268,82743,3762330,474546013,0,1167,131121,1149,128275,18,2846,178,4,377,6,0,7,229410.0,130000.0,-49.0,-35.0,-43.0,-45.0,-43.0,-35.0,-43.0,-47.0,-89.0,-91.0,-88.0,-90.0,40.0,56.0,45.0,45.0,1
968,92:69:1D:31:68:E9,3775113,489798674,12783,15252661,3762330,474546013,3,19250,3554382,18553,3394055,697,160327,6443,105,14039,252,3,251,216660.0,130000.0,-51.0,-48.0,-43.0,-48.0,-52.0,-48.0,-43.0,-48.0,-89.0,-91.0,-88.0,-90.0,38.0,43.0,45.0,42.0,1
969,CC:2F:71:3F:1F:24,3967988,716400808,205656,241854593,3762332,474546215,27,173298,198824262,173221,198814630,77,9632,165893,6,205654,20990,24,135,144444.0,43333.0,-72.0,-70.0,-75.0,-72.0,-71.0,-70.0,-74.0,-72.0,-89.0,-91.0,-88.0,-90.0,17.0,21.0,13.0,18.0,1
970,CC:2F:71:3E:C5:1F,3762420,474556877,88,10662,3762332,474546215,0,350,29990,283,21898,67,8092,95,2,119,4,0,5,130000.0,39000.0,-71.0,-71.0,-66.0,-60.0,-71.0,-70.0,-66.0,-60.0,-89.0,-91.0,-88.0,-90.0,18.0,20.0,22.0,30.0,1
971,BA:8C:B9:54:50:24,3762600,474628958,268,82743,3762332,474546215,0,1167,131121,1149,128275,18,2846,178,4,377,6,0,7,229410.0,130000.0,-49.0,-35.0,-43.0,-45.0,-43.0,-35.0,-43.0,-47.0,-89.0,-91.0,-88.0,-90.0,40.0,56.0,45.0,45.0,1
972,92:69:1D:31:68:E9,3775115,489798876,12783,15252661,3762332,474546215,3,19250,3554382,18553,3394055,697,160327,6443,105,14039,252,3,251,216660.0,130000.0,-51.0,-48.0,-43.0,-48.0,-52.0,-48.0,-43.0,-48.0,-89.0,-91.0,-88.0,-90.0,38.0,43.0,45.0,42.0,1
973,CC:2F:71:3F:1F:24,3968105,716524542,205766,241977661,3762339,474546881,27,173394,198940952,173317,198931320,77,9632,165984,6,205764,20992,24,135,144444.0,43333.0,-68.0,-67.0,-71.0,-69.0,-68.0,-66.0,-71.0,-68.0,-89.0,-91.0,-88.0,-90.0,21.0,24.0,17.0,21.0,1
974,CC:2F:71:3E:C5:1F,3762427,474557543,88,10662,3762339,474546881,0,350,29990,283,21898,67,8092,95,2,119,4,0,5,130000.0,39000.0,-71.0,-71.0,-66.0,-60.0,-71.0,-70.0,-66.0,-60.0,-89.0,-91.0,-88.0,-90.0,18.0,20.0,22.0,30.0,1
975,BA:8C:B9:54:50:24,3762607,474629624,268,82743,3762339,474546881,0,1167,131121,1149,128275,18,2846,178,4,377,6,0,7,229410.0,130000.0,-49.0,-35.0,-43.0,-45.0,-43.0,-35.0,-43.0,-47.0,-89.0,-91.0,-88.0,-90.0,40.0,56.0,45.0,45.0,1
976,92:69:1D:31:68:E9,3775122,489799542,12783,15252661,3762339,474546881,3,19250,3554382,18553,3394055,697,160327,6443,105,14039,252,3,251,216660.0,130000.0,-51.0,-48.0,-43.0,-48.0,-52.0,-48.0,-43.0,-48.0,-89.0,-91.0,-88.0,-90.0,38.0,43.0,45.0,42.0,1
977,CC:2F:71:3F:1F:24,3968237,716656287,205896,242109204,3762341,474547083,27,173517,199068080,173440,199058448,77,9632,166095,6,205894,20995,24,137,144444.0,43333.0,-68.0,-67.0,-72.0,-69.0,-68.0,-67.0,-71.0,-69.0,-88.0,-90.0,-87.0,-90.0,20.0,23.0,15.0,21.0,1
978,CC:2F:71:3E:C5:1F,3762429,474557745,88,10662,3762341,474547083,0,350,29990,283,21898,67,8092,95,2,119,4,0,5,130000.0,39000.0,-71.0,-71.0,-66.0,-60.0,-71.0,-70.0,-66.0,-60.0,-88.0,-90.0,-87.0,-90.0,17.0,19.0,21.0,30.0,1
979,BA:8C:B9:54:50:24,3762611,474630028,268,82743,3762343,474547285,0,1167,131121,1149,128275,18,2846,178,4,377,6,0,7,229410.0,130000.0,-49.0,-35.0,-43.0,-45.0,-43.0,-35.0,-43.0,-47.0,-88.0,-90.0,-87.0,-90.0,39.0,55.0,44.0,45.0,1
980,92:69:1D:31:68:E9,3775126,489799946,12783,15252661,3762343,474547285,3,19251,3554450,18554,3394123,697,160327,6443,105,14039,252,3,251,216660.0,130000.0,-51.0,-49.0,-44.0,-47.0,-51.0,-48.0,-43.0,-48.0,-88.0,-90.0,-87.0,-90.0,37.0,41.0,43.0,43.0,1
981,CC:2F:71:3F:1F:24,3968354,716783067,206007,242235378,3762347,474547689,27,173619,199189638,173542,199180006,77,9632,166192,6,206005,20996,24,138,144444.0,43333.0,-68.0,-67.0,-72.0,-69.0,-68.0,-67.0,-71.0,-69.0,-88.0,-90.0,-87.0,-90.0,20.0,23.0,15.0,21.0,1
982,CC:2F:71:3E:C5:1F,3762435,474558351,88,10662,3762347,474547689,0,350,29990,283,21898,67,8092,95,2,119,4,0,5,130000.0,39000.0,-71.0,-71.0,-66.0,-60.0,-71.0,-70.0,-66.0,-60.0,-88.0,-90.0,-87.0,-90.0,17.0,19.0,21.0,30.0,1
983,BA:8C:B9:54:50:24,3762615,474630432,268,82743,3762347,474547689,0,1167,131121,1149,128275,18,2846,178,4,377,6,0,7,229410.0,130000.0,-49.0,-35.0,-43.0,-45.0,-43.0,-35.0,-43.0,-47.0,-88.0,-90.0,-87.0,-90.0,39.0,55.0,44.0,45.0,1
984,92:69:1D:31:68:E9,3775131,489800410,12783,15252661,3762348,474547749,3,19251,3554450,18554,3394123,697,160327,6443,105,14039,252,3,251,216660.0,130000.0,-51.0,-49.0,-44.0,-47.0,-51.0,-48.0,-43.0,-48.0,-88.0,-90.0,-87.0,-90.0,37.0,41.0,43.0,43.0,1
985,CC:2F:71:3F:1F:24,3968466,716902089,206114,242353770,3762352,474548319,27,173712,199304368,173635,199294736,77,9632,166280,6,206112,20996,24,138,144444.0,43333.0,-68.0,-67.0,-71.0,-69.0,-68.0,-67.0,-71.0,-68.0,-88.0,-90.0,-87.0,-90.0,20.0,23.0,16.0,21.0,1
986,CC:2F:71:3E:C5:1F,3762441,474559097,89,10778,3762352,474548319,0,352,30130,285,22038,67,8092,95,2,120,4,0,5,130000.0,39000.0,-70.0,-70.0,-67.0,-60.0,-71.0,-70.0,-66.0,-60.0,-88.0,-90.0,-87.0,-90.0,18.0,20.0,20.0,30.0,1
987,BA:8C:B9:54:50:24,3762621,474631178,269,82859,3762352,474548319,0,1169,131257,1151,128411,18,2846,178,4,378,6,0,7,229410.0,130000.0,-39.0,-37.0,-45.0,-51.0,-42.0,-35.0,-43.0,-48.0,-88.0,-90.0,-87.0,-90.0,49.0,53.0,42.0,39.0,1
988,92:69:1D:31:68:E9,3775138,489801298,12784,15252777,3762354,474548521,3,19253,3554586,18556,3394259,697,160327,6443,105,14040,252,3,251,216660.0,130000.0,-51.0,-49.0,-43.0,-48.0,-51.0,-48.0,-42.0,-47.0,-88.0,-90.0,-87.0,-90.0,37.0,41.0,44.0,42.0,1
989,CC:2F:71:3F:1F:24,3968577,717020841,206219,242471916,3762358,474548925,27,173802,199411778,173725,199402146,77,9632,166367,6,206217,20997,24,138,144444.0,43333.0,-68.0,-67.0,-71.0,-69.0,-67.0,-67.0,-71.0,-68.0,-88.0,-90.0,-87.0,-90.0,20.0,23.0,16.0,21.0,1
990,CC:2F:71:3E:C5:1F,3762447,474559703,89,10778,3762358,474548925,0,352,30130,285,22038,67,8092,95,2,120,4,0,5,130000.0,39000.0,-70.0,-70.0,-67.0,-60.0,-71.0,-70.0,-66.0,-60.0,-88.0,-90.0,-87.0,-90.0,18.0,20.0,20.0,30.0,1
991,BA:8C:B9:54:50:24,3762627,474631784,269,82859,3762358,474548925,0,1169,131257,1151,128411,18,2846,178,4,378,6,0,7,229410.0,130000.0,-39.0,-37.0,-45.0,-51.0,-42.0,-35.0,-43.0,-48.0,-88.0,-90.0,-87.0,-90.0,49.0,53.0,42.0,39.0,1
992,92:69:1D:31:68:E9,3775142,489801702,12784,15252777,3762358,474548925,3,19253,3554586,18556,3394259,697,160327,6443,105,14040,252,3,251,216660.0,130000.0,-51.0,-49.0,-43.0,-48.0,-51.0,-48.0,-42.0,-47.0,-88.0,-90.0,-87.0,-90.0,37.0,41.0,44.0,42.0,1
993,CC:2F:71:3F:1F:24,3968692,717142720,206331,242593533,3762361,474549187,27,173901,199524903,173824,199515271,77,9632,166461,6,206329,20997,24,138,144444.0,43333.0,-68.0,-67.0,-71.0,-69.0,-67.0,-67.0,-71.0,-69.0,-88.0,-90.0,-87.0,-90.0,20.0,23.0,16.0,21.0,1
994,CC:2F:71:3E:C5:1F,3762450,474559965,89,10778,3762361,474549187,0,352,30130,285,22038,67,8092,95,2,120,4,0,5,130000.0,39000.0,-70.0,-70.0,-67.0,-60.0,-71.0,-70.0,-66.0,-60.0,-88.0,-90.0,-87.0,-90.0,18.0,20.0,20.0,30.0,1
995,BA:8C:B9:54:50:24,3762630,474632046,269,82859,3762361,474549187,0,1169,131257,1151,128411,18,2846,178,4,378,6,0,7,229410.0,130000.0,-39.0,-37.0,-45.0,-51.0,-42.0,-35.0,-43.0,-48.0,-88.0,-90.0,-87.0,-90.0,49.0,53.0,42.0,39.0,1
996,92:69:1D:31:68:E9,3775147,489802166,12784,15252777,3762363,474549389,3,19253,3554586,18556,3394259,697,160327,6443,105,14040,252,3,251,216660.0,130000.0,-51.0,-49.0,-43.0,-48.0,-51.0,-48.0,-42.0,-47.0,-88.0,-90.0,-87.0,-90.0,37.0,41.0,44.0,42.0,1
997,CC:2F:71:3F:1F:24,3968806,717261862,206439,242712069,3762367,474549793,27,173998,199640316,173921,199630684,77,9632,166551,6,206437,20998,24,138,144444.0,43333.0,-68.0,-67.0,-71.0,-69.0,-68.0,-67.0,-71.0,-69.0,-88.0,-90.0,-87.0,-90.0,20.0,23.0,16.0,21.0,1
998,CC:2F:71:3E:C5:1F,3762456,474560571,89,10778,3762367,474549793,0,352,30130,285,22038,67,8092,95,2,120,4,0,5,130000.0,39000.0,-70.0,-70.0,-67.0,-60.0,-71.0,-70.0,-66.0,-60.0,-88.0,-90.0,-87.0,-90.0,18.0,20.0,20.0,30.0,1
999,BA:8C:B9:54:50:24,3762636,474632652,269,82859,3762367,474549793,0,1169,131257,1151,128411,18,2846,178,4,378,6,0,7,229410.0,130000.0,-39.0,-37.0,-45.0,-51.0,-42.0,-35.0,-43.0,-48.0,-88.0,-90.0,-87.0,-90.0,49.0,53.0,42.0,39.0,1
1000,92:69:1D:31:68:E9,3775151,489802570,12784,15252777,3762367,474549793,3,19253,3554586,18556,3394259,697,160327,6443,105,14040,252,3,251,216660.0,130000.0,-51.0,-49.0,-43.0,-48.0,-51.0,-48.0,-42.0,-47.0,-88.0,-90.0,-87.0,-90.0,37.0,41.0,44.0,42.0,1
1001,CC:2F:71:3F:1F:24,3968913,717380200,206545,242830345,3762368,474549855,27,174095,199755526,174017,199745776,78,9750,166642,6,206543,20999,24,138,144444.0,43333.0,-68.0,-67.0,-71.0,-69.0,-67.0,-66.0,-71.0,-69.0,-88.0,-90.0,-87.0,-90.0,20.0,23.0,16.0,21.0,1
1002,CC:2F:71:3E:C5:1F,3762459,474560835,89,10778,3762370,474550057,0,352,30130,285,22038,67,8092,95,2,120,4,0,5,130000.0,39000.0,-70.0,-70.0,-67.0,-60.0,-71.0,-70.0,-66.0,-60.0,-88.0,-90.0,-87.0,-90.0,18.0,20.0,20.0,30.0,1
1003,BA:8C:B9:54:50:24,3762639,474632916,269,82859,3762370,474550057,0,1169,131257,1151,128411,18,2846,178,4,378,6,0,7,229410.0,130000.0,-39.0,-37.0,-45.0,-51.0,-42.0,-35.0,-43.0,-48.0,-88.0,-90.0,-87.0,-90.0,49.0,53.0,42.0,39.0,1
1004,92:69:1D:31:68:E9,3775156,489803036,12784,15252777,3762372,474550259,3,19253,3554586,18556,3394259,697,160327,6443,105,14040,252,3,251,216660.0,130000.0,-51.0,-49.0,-43.0,-48.0,-51.0,-48.0,-42.0,-47.0,-88.0,-90.0,-87.0,-90.0,37.0,41.0,44.0,42.0,1
1005,CC:2F:71:3F:1F:24,3969027,717499214,206650,242948491,3762377,474550723,27,174188,199870256,174110,199860506,78,9750,166730,6,206648,20999,24,138,144444.0,43333.0,-68.0,-67.0,-71.0,-69.0,-68.0,-67.0,-71.0,-69.0,-88.0,-90.0,-87.0,-90.0,20.0,23.0,16.0,21.0,1
1006,CC:2F:71:3E:C5:1F,3762466,474561501,89,10778,3762377,474550723,0,352,30130,285,22038,67,8092,95,2,120,4,0,5,130000.0,39000.0,-70.0,-70.0,-67.0,-60.0,-71.0,-70.0,-66.0,-60.0,-88.0,-90.0,-87.0,-90.0,18.0,20.0,20.0,30.0,1
1007,BA:8C:B9:54:50:24,3762646,474633582,269,82859,3762377,474550723,0,1169,131257,1151,128411,18,2846,178,4,378,6,0,7,229410.0,130000.0,-39.0,-37.0,-45.0,-51.0,-42.0,-35.0,-43.0,-48.0,-88.0,-90.0,-87.0,-90.0,49.0,53.0,42.0,39.0,1
1008,92:69:1D:31:68:E9,3775161,489803500,12784,15252777,3762377,474550723,3,19253,3554586,18556,3394259,697,160327,6443,105,14040,252,3,251,216660.0,130000.0,-51.0,-49.0,-43.0,-48.0,-51.0,-48.0,-42.0,-47.0,-88.0,-90.0,-87.0,-90.0,37.0,41.0,44.0,42.0,1
1009,CC:2F:71:3F:1F:24,3969140,717620947,206763,243070224,3762377,474550723,27,174287,199981863,174209,199972113,78,9750,166826,6,206761,21000,24,138,144444.0,43333.0,-68.0,-67.0,-71.0,-69.0,-68.0,-67.0,-71.0,-69.0,-88.0,-90.0,-87.0,-90.0,20.0,23.0,16.0,21.0,1
1010,CC:2F:71:3E:C5:1F,3762469,474561976,89,10778,3762380,474551198,0,352,30130,285,22038,67,8092,95,2,120,4,0,5,130000.0,39000.0,-70.0,-70.0,-67.0,-60.0,-71.0,-70.0,-66.0,-60.0,-88.0,-90.0,-87.0,-90.0,18.0,20.0,20.0,30.0,1
1011,BA:8C:B9:54:50:24,3762649,474634057,269,82859,3762380,474551198,0,1169,131257,1151,128411,18,2846,178,4,378,6,0,7,229410.0,130000.0,-39.0,-37.0,-45.0,-51.0,-42.0,-35.0,-43.0,-48.0,-88.0,-90.0,-87.0,-90.0,49.0,53.0,42.0,39.0,1
1012,92:69:1D:31:68:E9,3775164,489803975,12784,15252777,3762380,474551198,3,19253,3554586,18556,3394259,697,160327,6443,105,14040,252,3,251,216660.0,130000.0,-51.0,-49.0,-43.0,-48.0,-51.0,-48.0,-42.0,-47.0,-88.0,-90.0,-87.0,-90.0,37.0,41.0,44.0,42.0,1
1013,CC:2F:71:3F:1F:24,3969255,717741786,206871,243190184,3762384,474551602,27,174383,200099817,174305,200090067,78,9750,166915,6,206868,21003,24,138,144444.0,43333.0,-68.0,-67.0,-72.0,-69.0,-68.0,-67.0,-71.0,-69.0,-88.0,-90.0,-87.0,-90.0,20.0,23.0,15.0,21.0,1
1014,CC:2F:71:3E:C5:1F,3762473,474562380,89,10778,3762384,474551602,0,352,30130,285,22038,67,8092,95,2,120,4,0,5,130000.0,39000.0,-70.0,-70.0,-67.0,-60.0,-71.0,-70.0,-66.0,-60.0,-88.0,-90.0,-87.0,-90.0,18.0,20.0,20.0,30.0,1
1015,BA:8C:B9:54:50:24,3762655,474634663,269,82859,3762386,474551804,0,1169,131257,1151,128411,18,2846,178,4,378,6,0,7,229410.0,130000.0,-39.0,-37.0,-45.0,-51.0,-42.0,-35.0,-43.0,-48.0,-88.0,-90.0,-87.0,-90.0,49.0,53.0,42.0,39.0,1
1016,92:69:1D:31:68:E9,3775170,489804581,12784,15252777,3762386,474551804,3,19253,3554586,18556,3394259,697,160327,6443,105,14040,252,3,251,216660.0,130000.0,-51.0,-49.0,-43.0,-48.0,-51.0,-48.0,-42.0,-47.0,-88.0,-90.0,-87.0,-90.0,37.0,41.0,44.0,42.0,1
1017,CC:2F:71:3F:1F:24,3969364,717860324,206977,243308460,3762387,474551864,27,174479,200215273,174401,200205523,78,9750,167003,6,206975,21004,24,138,144444.0,43333.0,-68.0,-67.0,-71.0,-69.0,-67.0,-66.0,-71.0,-69.0,-88.0,-90.0,-87.0,-90.0,20.0,23.0,16.0,21.0,1
1018,CC:2F:71:3E:C5:1F,3762476,474562642,89,10778,3762387,474551864,0,352,30130,285,22038,67,8092,95,2,120,4,0,5,130000.0,39000.0,-70.0,-70.0,-67.0,-60.0,-71.0,-70.0,-66.0,-60.0,-88.0,-90.0,-87.0,-90.0,18.0,20.0,20.0,30.0,1
1019,BA:8C:B9:54:50:24,3762656,474634723,269,82859,3762387,474551864,0,1169,131257,1151,128411,18,2846,178,4,378,6,0,7,229410.0,130000.0,-39.0,-37.0,-45.0,-51.0,-42.0,-35.0,-43.0,-48.0,-88.0,-90.0,-87.0,-90.0,49.0,53.0,42.0,39.0,1
1020,92:69:1D:31:68:E9,3775173,489804843,12784,15252777,3762389,474552066,3,19253,3554586,18556,3394259,697,160327,6443,105,14040,252,3,251,216660.0,130000.0,-51.0,-49.0,-43.0,-48.0,-51.0,-48.0,-42.0,-47.0,-88.0,-90.0,-87.0,-90.0,37.0,41.0,44.0,42.0,1
1021,CC:2F:71:3F:1F:24,3969476,717979094,207083,243426624,3762393,474552470,27,174572,200328613,174494,200318863,78,9750,167092,6,207081,21004,24,138,144444.0,39000.0,-68.0,-67.0,-71.0,-69.0,-68.0,-67.0,-71.0,-69.0,-88.0,-90.0,-87.0,-90.0,20.0,23.0,16.0,21.0,1
1022,CC:2F:71:3E:C5:1F,3762482,474563248,89,10778,3762393,474552470,0,352,30130,285,22038,67,8092,95,2,120,4,0,5,130000.0,39000.0,-70.0,-70.0,-67.0,-60.0,-71.0,-70.0,-66.0,-60.0,-88.0,-90.0,-87.0,-90.0,18.0,20.0,20.0,30.0,1
1023,BA:8C:B9:54:50:24,3762662,474635329,269,82859,3762393,474552470,0,1169,131257,1151,128411,18,2846,178,4,378,6,0,7,229410.0,130000.0,-39.0,-37.0,-45.0,-51.0,-42.0,-35.0,-43.0,-48.0,-88.0,-90.0,-87.0,-90.0,49.0,53.0,42.0,39.0,1
1024,92:69:1D:31:68:E9,3775177,489805247,12784,15252777,3762393,474552470,3,19253,3554586,18556,3394259,697,160327,6443,105,14040,252,3,251,216660.0,130000.0,-51.0,-49.0,-43.0,-48.0,-51.0,-48.0,-42.0,-47.0,-88.0,-90.0,-87.0,-90.0,37.0,41.0,44.0,42.0,1
1025,CC:2F:71:3F:1F:24,3969590,718099363,207194,243546631,3762396,474552732,27,174672,200441928,174594,200432178,78,9750,167187,6,207192,21004,24,138,144444.0,43333.0,-68.0,-67.0,-72.0,-70.0,-68.0,-67.0,-71.0,-69.0,-88.0,-90.0,-87.0,-90.0,20.0,23.0,15.0,20.0,1
1026,CC:2F:71:3E:C5:1F,3762485,474563510,89,10778,3762396,474552732,0,352,30130,285,22038,67,8092,95,2,120,4,0,5,130000.0,39000.0,-70.0,-70.0,-67.0,-60.0,-71.0,-70.0,-66.0,-60.0,-88.0,-90.0,-87.0,-90.0,18.0,20.0,20.0,30.0,1
1027,BA:8C:B9:54:50:24,3762665,474635591,269,82859,3762396,474552732,0,1169,131257,1151,128411,18,2846,178,4,378,6,0,7,229410.0,130000.0,-39.0,-37.0,-45.0,-51.0,-42.0,-35.0,-43.0,-48.0,-88.0,-90.0,-87.0,-90.0,49.0,53.0,42.0,39.0,1
1028,92:69:1D:31:68:E9,3775182,489805711,12784,15252777,3762398,474552934,3,19253,3554586,18556,3394259,697,160327,6443,105,14040,252,3,251,216660.0,130000.0,-51.0,-49.0,-43.0,-48.0,-51.0,-48.0,-42.0,-47.0,-89.0,-90.0,-87.0,-90.0,38.0,41.0,44.0,42.0,1
1029,CC:2F:71:3F:1F:24,3969702,718219659,207301,243666461,3762401,474553198,27,174769,200557306,174691,200547556,78,9750,167277,6,207299,21004,24,139,144444.0,43333.0,-68.0,-66.0,-71.0,-69.0,-67.0,-66.0,-71.0,-68.0,-89.0,-90.0,-87.0,-90.0,21.0,24.0,16.0,21.0,1
1030,CC:2F:71:3E:C5:1F,3762492,474564178,89,10778,3762403,474553400,0,354,30318,286,22108,68,8210,96,2,120,4,0,5,130000.0,39000.0,-70.0,-70.0,-66.0,-60.0,-70.0,-70.0,-66.0,-60.0,-89.0,-90.0,-87.0,-90.0,19.0,20.0,21.0,30.0,1
1031,BA:8C:B9:54:50:24,3762672,474636259,269,82859,3762403,474553400,0,1169,131257,1151,128411,18,2846,178,4,378,6,0,7,229410.0,130000.0,-39.0,-37.0,-45.0,-51.0,-42.0,-35.0,-43.0,-48.0,-89.0,-90.0,-87.0,-90.0,50.0,53.0,42.0,39.0,1
1032,92:69:1D:31:68:E9,3775187,489806177,12784,15252777,3762403,474553400,3,19253,3554586,18556,3394259,697,160327,6443,105,14040,252,3,251,216660.0,130000.0,-51.0,-49.0,-43.0,-48.0,-51.0,-48.0,-42.0,-47.0,-89.0,-90.0,-87.0,-90.0,38.0,41.0,44.0,42.0,1
1033,CC:2F:71:3F:1F:24,3969815,718339593,207408,243784867,3762407,474554726,27,174861,200669328,174783,200659578,78,9750,167364,6,207406,21004,24,139,144444.0,43333.0,-68.0,-66.0,-71.0,-69.0,-67.0,-66.0,-71.0,-69.0,-89.0,-90.0,-87.0,-90.0,21.0,24.0,16.0,21.0,1
1034,CC:2F:71:3E:C5:1F,3762496,474565504,89,10778,3762407,474554726,0,354,30318,286,22108,68,8210,96,2,120,4,0,5,130000.0,39000.0,-70.0,-70.0,-66.0,-60.0,-70.0,-70.0,-66.0,-60.0,-89.0,-90.0,-87.0,-90.0,19.0,20.0,21.0,30.0,1
1035,BA:8C:B9:54:50:24,3762676,474637585,269,82859,3762407,474554726,0,1169,131257,1151,128411,18,2846,178,4,378,6,0,7,229410.0,130000.0,-39.0,-37.0,-45.0,-51.0,-42.0,-35.0,-43.0,-48.0,-89.0,-90.0,-87.0,-90.0,50.0,53.0,42.0,39.0,1
1036,92:69:1D:31:68:E9,3775191,489807503,12784,15252777,3762407,474554726,3,19253,3554586,18556,3394259,697,160327,6443,105,14040,252,3,251,216660.0,130000.0,-51.0,-49.0,-43.0,-48.0,-51.0,-48.0,-42.0,-47.0,-89.0,-90.0,-87.0,-90.0,38.0,41.0,44.0,42.0,1
1037,CC:2F:71:3F:1F:24,3969928,718462865,207516,243907675,3762412,474555190,27,174957,200785986,174879,200776236,78,9750,167456,6,207514,21008,24,139,144444.0,43333.0,-68.0,-66.0,-71.0,-69.0,-67.0,-66.0,-71.0,-69.0,-89.0,-90.0,-87.0,-90.0,21.0,24.0,16.0,21.0,1
1038,CC:2F:71:3E:C5:1F,3762503,474566170,89,10778,3762414,474555392,0,354,30318,286,22108,68,8210,96,2,120,4,0,5,130000.0,39000.0,-70.0,-70.0,-66.0,-60.0,-70.0,-70.0,-66.0,-60.0,-89.0,-90.0,-87.0,-90.0,19.0,20.0,21.0,30.0,1
1039,BA:8C:B9:54:50:24,3762683,474638251,269,82859,3762414,474555392,0,1171,131393,1153,128547,18,2846,178,4,379,6,0,7,229410.0,130000.0,-40.0,-37.0,-45.0,-51.0,-42.0,-36.0,-44.0,-49.0,-89.0,-90.0,-87.0,-90.0,49.0,53.0,42.0,39.0,1
1040,92:69:1D:31:68:E9,3775198,489808169,12784,15252777,3762414,474555392,3,19255,3554722,18558,3394395,697,160327,6443,105,14041,252,3,251,216660.0,130000.0,-51.0,-48.0,-43.0,-48.0,-50.0,-48.0,-42.0,-47.0,-89.0,-90.0,-87.0,-90.0,38.0,42.0,44.0,42.0,1
1041,CC:2F:71:3F:1F:24,3970049,718587824,207631,244031106,3762418,474556718,27,175058,200902121,174980,200892371,78,9750,167553,6,207628,21011,24,139,144444.0,43333.0,-68.0,-66.0,-71.0,-69.0,-67.0,-66.0,-71.0,-69.0,-89.0,-90.0,-87.0,-90.0,21.0,24.0,16.0,21.0,1
1042,CC:2F:71:3E:C5:1F,3762507,474567496,89,10778,3762418,474556718,0,354,30318,286,22108,68,8210,96,2,120,4,0,5,130000.0,39000.0,-70.0,-70.0,-66.0,-60.0,-70.0,-70.0,-66.0,-60.0,-89.0,-90.0,-87.0,-90.0,19.0,20.0,21.0,30.0,1
1043,BA:8C:B9:54:50:24,3762687,474639577,269,82859,3762418,474556718,0,1171,131393,1153,128547,18,2846,178,4,379,6,0,7,229410.0,130000.0,-40.0,-37.0,-45.0,-51.0,-42.0,-36.0,-44.0,-49.0,-89.0,-90.0,-87.0,-90.0,49.0,53.0,42.0,39.0,1
1044,92:69:1D:31:68:E9,3775202,489809495,12784,15252777,3762418,474556718,3,19255,3554722,18558,3394395,697,160327,6443,105,14041,252,3,251,216660.0,130000.0,-51.0,-48.0,-43.0,-48.0,-50.0,-48.0,-42.0,-47.0,-89.0,-90.0,-87.0,-90.0,38.0,42.0,44.0,42.0,1
1045,CC:2F:71:3F:1F:24,3970163,718711424,207741,244154302,3762422,474557122,27,175150,201013857,175072,201004107,78,9750,167645,6,207739,21012,24,139,144444.0,43333.0,-68.0,-66.0,-71.0,-69.0,-67.0,-66.0,-71.0,-68.0,-89.0,-90.0,-87.0,-90.0,21.0,24.0,16.0,21.0,1
1046,CC:2F:71:3E:C5:1F,3762511,474567900,89,10778,3762422,474557122,0,354,30318,286,22108,68,8210,96,2,120,4,0,5,130000.0,39000.0,-70.0,-70.0,-66.0,-60.0,-70.0,-70.0,-66.0,-60.0,-89.0,-90.0,-87.0,-90.0,19.0,20.0,21.0,30.0,1
1047,BA:8C:B9:54:50:24,3762693,474640183,269,82859,3762424,474557324,0,1172,131461,1154,128615,18,2846,178,4,379,6,0,7,229410.0,130000.0,-40.0,-37.0,-45.0,-50.0,-41.0,-36.0,-44.0,-50.0,-89.0,-90.0,-87.0,-90.0,49.0,53.0,42.0,40.0,1
1048,92:69:1D:31:68:E9,3775208,489810101,12784,15252777,3762424,474557324,3,19255,3554722,18558,3394395,697,160327,6443,105,14041,252,3,251,216660.0,130000.0,-51.0,-48.0,-43.0,-48.0,-50.0,-48.0,-42.0,-47.0,-89.0,-90.0,-87.0,-90.0,38.0,42.0,44.0,42.0,1
1049,CC:2F:71:3F:1F:24,3970278,718832972,207849,244274262,3762429,474558710,27,175243,201128573,175165,201118823,78,9750,167734,6,207847,21012,24,139,144444.0,43333.0,-68.0,-66.0,-71.0,-69.0,-67.0,-66.0,-71.0,-69.0,-89.0,-90.0,-87.0,-90.0,21.0,24.0,16.0,21.0,1
1050,CC:2F:71:3E:C5:1F,3762518,474569488,89,10778,3762429,474558710,0,354,30318,286,22108,68,8210,96,2,120,4,0,5,130000.0,39000.0,-70.0,-70.0,-66.0,-60.0,-70.0,-70.0,-66.0,-60.0,-89.0,-90.0,-87.0,-90.0,19.0,20.0,21.0,30.0,1
1051,BA:8C:B9:54:50:24,3762698,474641569,269,82859,3762429,474558710,0,1172,131461,1154,128615,18,2846,178,4,379,6,0,7,229410.0,130000.0,-40.0,-37.0,-45.0,-50.0,-41.0,-36.0,-44.0,-50.0,-89.0,-90.0,-87.0,-90.0,49.0,53.0,42.0,40.0,1
1052,92:69:1D:31:68:E9,3775213,489811487,12784,15252777,3762429,474558710,3,19255,3554722,18558,3394395,697,160327,6443,105,14041,252,3,251,216660.0,130000.0,-51.0,-48.0,-43.0,-48.0,-50.0,-48.0,-42.0,-47.0,-89.0,-90.0,-87.0,-90.0,38.0,42.0,44.0,42.0,1
1053,CC:2F:71:3F:1F:24,3970388,718951652,207955,244392538,3762433,474559114,27,175333,201235841,175255,201226091,78,9750,167822,6,207953,21013,24,139,144444.0,43333.0,-67.0,-66.0,-71.0,-69.0,-67.0,-66.0,-71.0,-69.0,-88.0,-90.0,-87.0,-90.0,21.0,24.0,16.0,21.0,1
1054,CC:2F:71:3E:C5:1F,3762522,474569892,89,10778,3762433,474559114,0,354,30318,286,22108,68,8210,96,2,120,4,0,5,130000.0,39000.0,-70.0,-70.0,-66.0,-60.0,-70.0,-70.0,-66.0,-60.0,-88.0,-90.0,-87.0,-90.0,18.0,20.0,21.0,30.0,1
1055,BA:8C:B9:54:50:24,3762704,474642175,269,82859,3762435,474559316,0,1172,131461,1154,128615,18,2846,178,4,379,6,0,7,229410.0,130000.0,-40.0,-37.0,-45.0,-50.0,-41.0,-36.0,-44.0,-50.0,-88.0,-90.0,-87.0,-90.0,48.0,53.0,42.0,40.0,1
1056,92:69:1D:31:68:E9,3775219,489812093,12784,15252777,3762435,474559316,3,19255,3554722,18558,3394395,697,160327,6443,105,14041,252,3,251,216660.0,130000.0,-51.0,-48.0,-43.0,-48.0,-50.0,-48.0,-42.0,-47.0,-88.0,-90.0,-87.0,-90.0,37.0,42.0,44.0,42.0,1
1057,CC:2F:71:3F:1F:24,3970507,719075417,208069,244515839,3762438,474559578,27,175437,201353077,175359,201343327,78,9750,167919,6,208067,21015,24,139,144444.0,43333.0,-68.0,-66.0,-71.0,-69.0,-67.0,-66.0,-71.0,-69.0,-88.0,-90.0,-87.0,-90.0,20.0,24.0,16.0,21.0,1
1058,CC:2F:71:3E:C5:1F,3762527,474570356,89,10778,3762438,474559578,0,354,30318,286,22108,68,8210,96,2,120,4,0,5,130000.0,39000.0,-70.0,-70.0,-66.0,-60.0,-70.0,-70.0,-66.0,-60.0,-88.0,-90.0,-87.0,-90.0,18.0,20.0,21.0,30.0,1
1059,BA:8C:B9:54:50:24,3762707,474642437,269,82859,3762438,474559578,0,1172,131461,1154,128615,18,2846,178,4,379,6,0,7,229410.0,130000.0,-40.0,-37.0,-45.0,-50.0,-41.0,-36.0,-44.0,-50.0,-88.0,-90.0,-87.0,-90.0,48.0,53.0,42.0,40.0,1
1060,92:69:1D:31:68:E9,3775222,489812355,12784,15252777,3762438,474559578,3,19255,3554722,18558,3394395,697,160327,6443,105,14041,252,3,251,216660.0,130000.0,-51.0,-48.0,-43.0,-48.0,-50.0,-48.0,-42.0,-47.0,-88.0,-90.0,-87.0,-90.0,37.0,42.0,44.0,42.0,1
1061,CC:2F:71:3F:1F:24,3970618,719194227,208176,244634245,3762442,474559982,27,175528,201463261,175450,201453511,78,9750,168008,6,208174,21015,24,139,144444.0,43333.0,-68.0,-66.0,-71.0,-69.0,-67.0,-66.0,-71.0,-69.0,-88.0,-90.0,-87.0,-90.0,20.0,24.0,16.0,21.0,1
1062,CC:2F:71:3E:C5:1F,3762531,474570760,89,10778,3762442,474559982,0,354,30318,286,22108,68,8210,96,2,120,4,0,5,130000.0,39000.0,-70.0,-70.0,-66.0,-60.0,-70.0,-70.0,-66.0,-60.0,-88.0,-90.0,-87.0,-90.0,18.0,20.0,21.0,30.0,1
1063,BA:8C:B9:54:50:24,3762713,474643043,269,82859,3762444,474560184,0,1172,131461,1154,128615,18,2846,178,4,379,6,0,7,229410.0,130000.0,-40.0,-37.0,-45.0,-50.0,-41.0,-36.0,-44.0,-50.0,-88.0,-90.0,-87.0,-90.0,48.0,53.0,42.0,40.0,1
1064,92:69:1D:31:68:E9,3775228,489812961,12784,15252777,3762444,474560184,3,19255,3554722,18558,3394395,697,160327,6443,105,14041,252,3,251,216660.0,130000.0,-51.0,-48.0,-43.0,-48.0,-50.0,-48.0,-42.0,-47.0,-88.0,-90.0,-87.0,-90.0,37.0,42.0,44.0,42.0,1
1065,CC:2F:71:3F:1F:24,3970735,719323928,208288,244763269,3762447,474560659,27,175624,201584049,175546,201574299,78,9750,168102,6,208286,21017,24,141,144444.0,43333.0,-68.0,-66.0,-71.0,-69.0,-67.0,-66.0,-71.0,-69.0,-88.0,-90.0,-87.0,-90.0,20.0,24.0,16.0,21.0,1
1066,CC:2F:71:3E:C5:1F,3762536,474571437,89,10778,3762447,474560659,0,354,30318,286,22108,68,8210,96,2,120,4,0,5,130000.0,39000.0,-70.0,-70.0,-66.0,-60.0,-70.0,-70.0,-66.0,-60.0,-88.0,-90.0,-87.0,-90.0,18.0,20.0,21.0,30.0,1
1067,BA:8C:B9:54:50:24,3762716,474643518,269,82859,3762447,474560659,0,1172,131461,1154,128615,18,2846,178,4,379,6,0,7,229410.0,130000.0,-40.0,-37.0,-45.0,-50.0,-41.0,-36.0,-44.0,-50.0,-88.0,-90.0,-87.0,-90.0,48.0,53.0,42.0,40.0,1
1068,92:69:1D:31:68:E9,3775231,489813436,12784,15252777,3762447,474560659,3,19255,3554722,18558,3394395,697,160327,6443,105,14041,252,3,251,216660.0,130000.0,-51.0,-48.0,-43.0,-48.0,-50.0,-48.0,-42.0,-47.0,-88.0,-90.0,-87.0,-90.0,37.0,42.0,44.0,42.0,1
1069,CC:2F:71:3F:1F:24,3970846,719442668,208394,244881545,3762452,474561123,27,175720,201696359,175642,201686609,78,9750,168193,6,208392,21021,24,141,144444.0,43333.0,-68.0,-66.0,-71.0,-69.0,-68.0,-66.0,-71.0,-69.0,-89.0,-91.0,-88.0,-90.0,21.0,25.0,17.0,21.0,1
1070,CC:2F:71:3E:C5:1F,3762541,474571901,89,10778,3762452,474561123,0,354,30318,286,22108,68,8210,96,2,120,4,0,5,130000.0,39000.0,-70.0,-70.0,-66.0,-60.0,-70.0,-70.0,-66.0,-60.0,-89.0,-91.0,-88.0,-90.0,19.0,21.0,22.0,30.0,1
1071,BA:8C:B9:54:50:24,3762723,474644184,269,82859,3762454,474561325,0,1172,131461,1154,128615,18,2846,178,4,379,6,0,7,229410.0,130000.0,-40.0,-37.0,-45.0,-50.0,-41.0,-36.0,-44.0,-50.0,-89.0,-91.0,-88.0,-90.0,49.0,54.0,43.0,40.0,1
1072,92:69:1D:31:68:E9,3775238,489814102,12784,15252777,3762454,474561325,3,19255,3554722,18558,3394395,697,160327,6443,105,14041,252,3,251,216660.0,130000.0,-51.0,-48.0,-43.0,-48.0,-50.0,-48.0,-42.0,-47.0,-89.0,-91.0,-88.0,-90.0,38.0,43.0,45.0,42.0,1
1073,CC:2F:71:3F:1F:24,3970964,719564935,208508,245003408,3762456,474561527,27,175819,201809500,175741,201799750,78,9750,168288,6,208506,21021,24,141,144444.0,43333.0,-68.0,-66.0,-71.0,-69.0,-67.0,-66.0,-71.0,-69.0,-89.0,-91.0,-88.0,-90.0,21.0,25.0,17.0,21.0,1
1074,CC:2F:71:3E:C5:1F,3762545,474572305,89,10778,3762456,474561527,0,354,30318,286,22108,68,8210,96,2,120,4,0,5,130000.0,39000.0,-70.0,-70.0,-66.0,-60.0,-70.0,-70.0,-66.0,-60.0,-89.0,-91.0,-88.0,-90.0,19.0,21.0,22.0,30.0,1
1075,BA:8C:B9:54:50:24,3762725,474644386,269,82859,3762456,474561527,0,1172,131461,1154,128615,18,2846,178,4,379,6,0,7,229410.0,130000.0,-40.0,-37.0,-45.0,-50.0,-41.0,-36.0,-44.0,-50.0,-89.0,-91.0,-88.0,-90.0,49.0,54.0,43.0,40.0,1
1076,92:69:1D:31:68:E9,3775240,489814304,12784,15252777,3762456,474561527,3,19255,3554722,18558,3394395,697,160327,6443,105,14041,252,3,251,216660.0,130000.0,-51.0,-48.0,-43.0,-48.0,-50.0,-48.0,-42.0,-47.0,-89.0,-91.0,-88.0,-90.0,38.0,43.0,45.0,42.0,1
1077,CC:2F:71:3F:1F:24,3971076,719683825,208614,245121684,3762462,474562141,27,175909,201916768,175831,201907018,78,9750,168376,6,208612,21025,24,141,144444.0,43333.0,-68.0,-67.0,-71.0,-69.0,-67.0,-66.0,-71.0,-69.0,-89.0,-91.0,-88.0,-90.0,21.0,24.0,17.0,21.0,1
1078,CC:2F:71:3E:C5:1F,3762551,474572919,89,10778,3762462,474562141,0,354,30318,286,22108,68,8210,96,2,120,4,0,5,130000.0,39000.0,-70.0,-70.0,-66.0,-60.0,-70.0,-70.0,-66.0,-60.0,-89.0,-91.0,-88.0,-90.0,19.0,21.0,22.0,30.0,1
1079,BA:8C:B9:54:50:24,3762731,474645000,269,82859,3762462,474562141,0,1172,131461,1154,128615,18,2846,178,4,379,6,0,7,229410.0,130000.0,-40.0,-37.0,-45.0,-50.0,-41.0,-36.0,-44.0,-50.0,-89.0,-91.0,-88.0,-90.0,49.0,54.0,43.0,40.0,1
1080,92:69:1D:31:68:E9,3775248,489815120,12784,15252777,3762464,474562343,3,19255,3554722,18558,3394395,697,160327,6443,105,14041,252,3,251,216660.0,130000.0,-51.0,-48.0,-43.0,-48.0,-50.0,-48.0,-42.0,-47.0,-89.0,-91.0,-88.0,-90.0,38.0,43.0,45.0,42.0,1
1081,CC:2F:71:3F:1F:24,3971187,719802565,208720,245239960,3762467,474562605,27,175997,202023728,175919,202013978,78,9750,168464,6,208718,21026,24,141,144444.0,43333.0,-69.0,-67.0,-72.0,-69.0,-68.0,-67.0,-71.0,-69.0,-89.0,-91.0,-88.0,-90.0,20.0,24.0,16.0,21.0,1
1082,CC:2F:71:3E:C5:1F,3762556,474573383,89,10778,3762467,474562605,0,354,30318,286,22108,68,8210,96,2,120,4,0,5,130000.0,39000.0,-70.0,-70.0,-66.0,-60.0,-70.0,-70.0,-66.0,-60.0,-89.0,-91.0,-88.0,-90.0,19.0,21.0,22.0,30.0,1
1083,BA:8C:B9:54:50:24,3762736,474645464,269,82859,3762467,474562605,0,1172,131461,1154,128615,18,2846,178,4,379,6,0,7,229410.0,130000.0,-40.0,-37.0,-45.0,-50.0,-41.0,-36.0,-44.0,-50.0,-89.0,-91.0,-88.0,-90.0,49.0,54.0,43.0,40.0,1
1084,92:69:1D:31:68:E9,3775251,489815382,12784,15252777,3762467,474562605,3,19255,3554722,18558,3394395,697,160327,6443,105,14041,252,3,251,216660.0,130000.0,-51.0,-48.0,-43.0,-48.0,-50.0,-48.0,-42.0,-47.0,-89.0,-91.0,-88.0,-90.0,38.0,43.0,45.0,42.0,1
1085,CC:2F:71:3F:1F:24,3971298,719921375,208827,245358366,3762471,474563009,27,176091,202140012,176013,202130262,78,9750,168552,6,208825,21026,24,141,144444.0,43333.0,-68.0,-66.0,-71.0,-69.0,-67.0,-66.0,-71.0,-69.0,-90.0,-92.0,-88.0,-90.0,22.0,26.0,17.0,21.0,1
1086,CC:2F:71:3E:C5:1F,3762560,474573787,89,10778,3762471,474563009,0,354,30318,286,22108,68,8210,96,2,120,4,0,5,130000.0,39000.0,-70.0,-70.0,-66.0,-60.0,-70.0,-70.0,-66.0,-60.0,-90.0,-92.0,-88.0,-90.0,20.0,22.0,22.0,30.0,1
1087,BA:8C:B9:54:50:24,3762740,474645868,269,82859,3762471,474563009,0,1172,131461,1154,128615,18,2846,178,4,379,6,0,7,229410.0,130000.0,-40.0,-37.0,-45.0,-50.0,-41.0,-36.0,-44.0,-50.0,-90.0,-92.0,-88.0,-90.0,50.0,55.0,43.0,40.0,1
1088,92:69:1D:31:68:E9,3775255,489815786,12784,15252777,3762471,474563009,3,19255,3554722,18558,3394395,697,160327,6443,105,14041,252,3,251,216660.0,130000.0,-51.0,-48.0,-43.0,-48.0,-50.0,-48.0,-42.0,-47.0,-90.0,-92.0,-88.0,-90.0,39.0,44.0,45.0,42.0,1
1089,CC:2F:71:3F:1F:24,3971437,720049451,208961,245485978,3762476,474563473,27,176211,202256143,176133,202246393,78,9750,168664,6,208959,21027,24,141,144444.0,43333.0,-68.0,-66.0,-71.0,-69.0,-67.0,-66.0,-71.0,-69.0,-90.0,-92.0,-88.0,-90.0,22.0,26.0,17.0,21.0,1
1090,CC:2F:71:3E:C5:1F,3762565,474574251,89,10778,3762476,474563473,0,354,30318,286,22108,68,8210,96,2,120,4,0,5,130000.0,39000.0,-70.0,-70.0,-66.0,-60.0,-70.0,-70.0,-66.0,-60.0,-90.0,-92.0,-88.0,-91.0,20.0,22.0,22.0,31.0,1
1091,BA:8C:B9:54:50:24,3762745,474646332,269,82859,3762476,474563473,0,1172,131461,1154,128615,18,2846,178,4,379,6,0,7,229410.0,130000.0,-40.0,-37.0,-45.0,-50.0,-41.0,-36.0,-44.0,-50.0,-90.0,-92.0,-88.0,-91.0,50.0,55.0,43.0,41.0,1
1092,92:69:1D:31:68:E9,3775260,489816250,12784,15252777,3762476,474563473,3,19255,3554722,18558,3394395,697,160327,6443,105,14041,252,3,251,216660.0,130000.0,-51.0,-48.0,-43.0,-48.0,-50.0,-48.0,-42.0,-47.0,-90.0,-92.0,-88.0,-91.0,39.0,44.0,45.0,43.0,1
1093,CC:2F:71:3F:1F:24,3971550,720169863,209069,245605924,3762481,474563939,27,176303,202367931,176224,202358063,79,9868,168753,6,209067,21029,24,141,144444.0,43333.0,-68.0,-66.0,-71.0,-69.0,-67.0,-66.0,-71.0,-69.0,-90.0,-92.0,-88.0,-91.0,22.0,26.0,17.0,22.0,1
1094,CC:2F:71:3E:C5:1F,3762571,474574833,90,10894,3762481,474563939,0,356,30458,288,22248,68,8210,96,2,121,4,0,5,130000.0,39000.0,-70.0,-70.0,-66.0,-60.0,-71.0,-71.0,-66.0,-61.0,-90.0,-92.0,-88.0,-91.0,20.0,22.0,22.0,31.0,1
1095,BA:8C:B9:54:50:24,3762751,474646914,270,82975,3762481,474563939,0,1174,131597,1156,128751,18,2846,178,4,380,6,0,7,229410.0,130000.0,-48.0,-35.0,-43.0,-45.0,-42.0,-36.0,-44.0,-49.0,-90.0,-92.0,-88.0,-91.0,42.0,57.0,45.0,46.0,1
1096,92:69:1D:31:68:E9,3775266,489816832,12785,15252893,3762481,474563939,3,19257,3554858,18560,3394531,697,160327,6443,105,14042,252,3,251,216660.0,130000.0,-51.0,-49.0,-45.0,-47.0,-50.0,-48.0,-43.0,-47.0,-90.0,-92.0,-88.0,-91.0,39.0,43.0,43.0,44.0,1
1097,CC:2F:71:3F:1F:24,3971660,720289967,209175,245725624,3762485,474564343,27,176396,202478505,176317,202468637,79,9868,168843,6,209173,21031,24,141,144444.0,43333.0,-68.0,-67.0,-71.0,-69.0,-68.0,-66.0,-70.0,-69.0,-90.0,-92.0,-88.0,-91.0,22.0,25.0,17.0,22.0,1
1098,CC:2F:71:3E:C5:1F,3762575,474575237,90,10894,3762485,474564343,0,356,30458,288,22248,68,8210,96,2,121,4,0,5,130000.0,39000.0,-70.0,-70.0,-66.0,-60.0,-71.0,-71.0,-66.0,-61.0,-90.0,-92.0,-88.0,-91.0,20.0,22.0,22.0,31.0,1
1099,BA:8C:B9:54:50:24,3762755,474647318,270,82975,3762485,474564343,0,1174,131597,1156,128751,18,2846,178,4,380,6,0,7,229410.0,130000.0,-48.0,-35.0,-43.0,-45.0,-42.0,-36.0,-44.0,-49.0,-90.0,-92.0,-88.0,-91.0,42.0,57.0,45.0,46.0,1
1100,92:69:1D:31:68:E9,3775270,489817236,12785,15252893,3762485,474564343,3,19257,3554858,18560,3394531,697,160327,6443,105,14042,252,3,251,216660.0,130000.0,-51.0,-49.0,-45.0,-47.0,-50.0,-48.0,-43.0,-47.0,-90.0,-92.0,-88.0,-91.0,39.0,43.0,43.0,44.0,1
1101,CC:2F:71:3F:1F:24,3971771,720408707,209281,245843900,3762490,474564807,27,176489,202591797,176410,202581929,79,9868,168932,6,209279,21031,24,141,144444.0,43333.0,-68.0,-66.0,-71.0,-69.0,-68.0,-66.0,-71.0,-69.0,-90.0,-92.0,-88.0,-91.0,22.0,26.0,17.0,22.0,1
1102,CC:2F:71:3E:C5:1F,3762580,474575701,90,10894,3762490,474564807,0,356,30458,288,22248,68,8210,96,2,121,4,0,5,130000.0,39000.0,-70.0,-70.0,-66.0,-60.0,-71.0,-71.0,-66.0,-61.0,-90.0,-92.0,-88.0,-91.0,20.0,22.0,22.0,31.0,1
1103,BA:8C:B9:54:50:24,3762760,474647782,270,82975,3762490,474564807,0,1174,131597,1156,128751,18,2846,178,4,380,6,0,7,229410.0,130000.0,-48.0,-35.0,-43.0,-45.0,-42.0,-36.0,-44.0,-49.0,-90.0,-92.0,-88.0,-91.0,42.0,57.0,45.0,46.0,1
1104,92:69:1D:31:68:E9,3775275,489817700,12785,15252893,3762490,474564807,3,19257,3554858,18560,3394531,697,160327,6443,105,14042,252,3,251,216660.0,130000.0,-51.0,-49.0,-45.0,-47.0,-50.0,-48.0,-43.0,-47.0,-90.0,-92.0,-88.0,-91.0,39.0,43.0,43.0,44.0,1
1105,CC:2F:71:3F:1F:24,3971888,720530858,209394,245965647,3762494,474565211,27,176588,202706290,176509,202696422,79,9868,169026,6,209391,21032,24,141,144444.0,43333.0,-68.0,-66.0,-71.0,-69.0,-68.0,-66.0,-70.0,-69.0,-90.0,-92.0,-88.0,-91.0,22.0,26.0,17.0,22.0,1
1106,CC:2F:71:3E:C5:1F,3762584,474576105,90,10894,3762494,474565211,0,356,30458,288,22248,68,8210,96,2,121,4,0,5,130000.0,39000.0,-70.0,-70.0,-66.0,-60.0,-71.0,-71.0,-66.0,-61.0,-90.0,-92.0,-88.0,-91.0,20.0,22.0,22.0,31.0,1
1107,BA:8C:B9:54:50:24,3762764,474648186,270,82975,3762494,474565211,0,1174,131597,1156,128751,18,2846,178,4,380,6,0,7,229410.0,130000.0,-48.0,-35.0,-43.0,-45.0,-42.0,-36.0,-44.0,-49.0,-90.0,-92.0,-88.0,-91.0,42.0,57.0,45.0,46.0,1
1108,92:69:1D:31:68:E9,3775279,489818104,12785,15252893,3762494,474565211,3,19257,3554858,18560,3394531,697,160327,6443,105,14042,252,3,251,216660.0,130000.0,-51.0,-49.0,-45.0,-47.0,-50.0,-48.0,-43.0,-47.0,-90.0,-92.0,-88.0,-91.0,39.0,43.0,43.0,44.0,1
1109,CC:2F:71:3F:1F:24,3971999,720649500,209501,246083885,3762498,474565615,27,176684,202819992,176605,202810124,79,9868,169117,6,209499,21032,24,141,144444.0,43333.0,-69.0,-67.0,-72.0,-69.0,-68.0,-67.0,-71.0,-69.0,-90.0,-92.0,-88.0,-91.0,21.0,25.0,16.0,22.0,1
1110,CC:2F:71:3E:C5:1F,3762588,474576509,90,10894,3762498,474565615,0,356,30458,288,22248,68,8210,96,2,121,4,0,5,130000.0,39000.0,-70.0,-70.0,-66.0,-60.0,-71.0,-71.0,-66.0,-61.0,-90.0,-92.0,-88.0,-91.0,20.0,22.0,22.0,31.0,1
1111,BA:8C:B9:54:50:24,3762768,474648590,270,82975,3762498,474565615,0,1174,131597,1156,128751,18,2846,178,4,380,6,0,7,229410.0,130000.0,-48.0,-35.0,-43.0,-45.0,-42.0,-36.0,-44.0,-49.0,-90.0,-92.0,-88.0,-91.0,42.0,57.0,45.0,46.0,1
1112,92:69:1D:31:68:E9,3775283,489818508,12785,15252893,3762498,474565615,3,19257,3554858,18560,3394531,697,160327,6443,105,14042,252,3,251,216660.0,130000.0,-51.0,-49.0,-45.0,-47.0,-50.0,-48.0,-43.0,-47.0,-90.0,-92.0,-88.0,-91.0,39.0,43.0,43.0,44.0,1
1113,CC:2F:71:3F:1F:24,3972112,720769812,209609,246203733,3762503,474566079,27,176776,202928854,176697,202918986,79,9868,169208,6,209607,21033,24,141,144444.0,43333.0,-68.0,-66.0,-71.0,-69.0,-71.0,-69.0,-74.0,-72.0,-90.0,-92.0,-88.0,-91.0,22.0,26.0,17.0,22.0,1
1114,CC:2F:71:3E:C5:1F,3762593,474576973,90,10894,3762503,474566079,0,356,30458,288,22248,68,8210,96,2,121,4,0,5,130000.0,39000.0,-70.0,-70.0,-66.0,-60.0,-71.0,-71.0,-66.0,-61.0,-90.0,-92.0,-88.0,-91.0,20.0,22.0,22.0,31.0,1
1115,BA:8C:B9:54:50:24,3762774,474649180,270,82975,3762504,474566205,0,1174,131597,1156,128751,18,2846,178,4,380,6,0,7,229410.0,130000.0,-48.0,-35.0,-43.0,-45.0,-42.0,-36.0,-44.0,-49.0,-90.0,-92.0,-88.0,-91.0,42.0,57.0,45.0,46.0,1
1116,92:69:1D:31:68:E9,3775289,489819098,12785,15252893,3762504,474566205,3,19257,3554858,18560,3394531,697,160327,6443,105,14042,252,3,251,216660.0,130000.0,-51.0,-49.0,-45.0,-47.0,-50.0,-48.0,-43.0,-47.0,-90.0,-92.0,-88.0,-91.0,39.0,43.0,43.0,44.0,1
1117,CC:2F:71:3F:1F:24,3972226,720890575,209717,246323693,3762509,474566882,27,176867,203039010,176788,203029142,79,9868,169299,6,209715,21034,24,141,144444.0,43333.0,-68.0,-66.0,-71.0,-69.0,-68.0,-66.0,-71.0,-69.0,-90.0,-92.0,-88.0,-91.0,22.0,26.0,17.0,22.0,1
1118,CC:2F:71:3E:C5:1F,3762599,474577776,90,10894,3762509,474566882,0,356,30458,288,22248,68,8210,96,2,121,4,0,5,130000.0,39000.0,-70.0,-70.0,-66.0,-60.0,-71.0,-71.0,-66.0,-61.0,-90.0,-92.0,-88.0,-91.0,20.0,22.0,22.0,31.0,1
1119,BA:8C:B9:54:50:24,3762779,474649857,270,82975,3762509,474566882,0,1174,131597,1156,128751,18,2846,178,4,380,6,0,7,229410.0,130000.0,-48.0,-35.0,-43.0,-45.0,-42.0,-36.0,-44.0,-49.0,-90.0,-92.0,-88.0,-91.0,42.0,57.0,45.0,46.0,1
1120,92:69:1D:31:68:E9,3775294,489819775,12785,15252893,3762509,474566882,3,19257,3554858,18560,3394531,697,160327,6443,105,14042,252,3,251,216660.0,130000.0,-51.0,-49.0,-45.0,-47.0,-50.0,-48.0,-43.0,-47.0,-90.0,-92.0,-88.0,-91.0,39.0,43.0,43.0,44.0,1
1121,CC:2F:71:3F:1F:24,3972346,721015262,209832,246447916,3762514,474567346,27,176966,203152133,176887,203142265,79,9868,169396,6,209830,21035,24,141,144444.0,43333.0,-67.0,-66.0,-71.0,-69.0,-67.0,-66.0,-70.0,-68.0,-90.0,-92.0,-88.0,-91.0,23.0,26.0,17.0,22.0,1
1122,CC:2F:71:3E:C5:1F,3762604,474578240,90,10894,3762514,474567346,0,356,30458,288,22248,68,8210,96,2,121,4,0,5,130000.0,39000.0,-70.0,-70.0,-66.0,-60.0,-71.0,-71.0,-66.0,-61.0,-90.0,-92.0,-88.0,-91.0,20.0,22.0,22.0,31.0,1
1123,BA:8C:B9:54:50:24,3762785,474650383,270,82975,3762515,474567408,0,1174,131597,1156,128751,18,2846,178,4,380,6,0,7,229410.0,130000.0,-48.0,-35.0,-43.0,-45.0,-42.0,-36.0,-44.0,-49.0,-90.0,-92.0,-88.0,-91.0,42.0,57.0,45.0,46.0,1
1124,92:69:1D:31:68:E9,3775300,489820301,12785,15252893,3762515,474567408,3,19257,3554858,18560,3394531,697,160327,6443,105,14042,252,3,251,216660.0,130000.0,-51.0,-49.0,-45.0,-47.0,-50.0,-48.0,-43.0,-47.0,-90.0,-92.0,-88.0,-91.0,39.0,43.0,43.0,44.0,1
1125,CC:2F:71:3F:1F:24,3972458,721136982,209939,246569170,3762519,474567812,27,177062,203267183,176983,203257315,79,9868,169489,6,209937,21063,24,141,144444.0,43333.0,-68.0,-66.0,-71.0,-68.0,-68.0,-66.0,-71.0,-68.0,-90.0,-92.0,-88.0,-91.0,22.0,26.0,17.0,23.0,1
1126,CC:2F:71:3E:C5:1F,3762609,474578706,90,10894,3762519,474567812,0,358,30646,289,22318,69,8328,97,2,121,4,0,5,130000.0,39000.0,-70.0,-70.0,-66.0,-60.0,-70.0,-70.0,-66.0,-61.0,-90.0,-92.0,-88.0,-91.0,20.0,22.0,22.0,31.0,1
1127,BA:8C:B9:54:50:24,3762789,474650787,270,82975,3762519,474567812,0,1174,131597,1156,128751,18,2846,178,4,380,6,0,7,229410.0,130000.0,-48.0,-35.0,-43.0,-45.0,-42.0,-36.0,-44.0,-49.0,-90.0,-92.0,-88.0,-91.0,42.0,57.0,45.0,46.0,1
1128,92:69:1D:31:68:E9,3775304,489820705,12785,15252893,3762519,474567812,3,19257,3554858,18560,3394531,697,160327,6443,105,14042,252,3,251,216660.0,130000.0,-51.0,-49.0,-45.0,-47.0,-50.0,-48.0,-43.0,-47.0,-90.0,-92.0,-88.0,-91.0,39.0,43.0,43.0,44.0,1
1129,CC:2F:71:3F:1F:24,3972565,721255274,210044,246687260,3762521,474568014,27,177152,203377265,177073,203367397,79,9868,169576,6,210042,21107,24,141,130000.0,43333.0,-68.0,-66.0,-71.0,-69.0,-68.0,-66.0,-71.0,-68.0,-90.0,-92.0,-88.0,-91.0,22.0,26.0,17.0,22.0,1
1130,CC:2F:71:3E:C5:1F,3762613,474579110,90,10894,3762523,474568216,0,358,30646,289,22318,69,8328,97,2,121,4,0,5,130000.0,39000.0,-70.0,-70.0,-66.0,-60.0,-70.0,-70.0,-66.0,-61.0,-90.0,-92.0,-88.0,-91.0,20.0,22.0,22.0,31.0,1
1131,BA:8C:B9:54:50:24,3762793,474651191,270,82975,3762523,474568216,0,1174,131597,1156,128751,18,2846,178,4,380,6,0,7,229410.0,130000.0,-48.0,-35.0,-43.0,-45.0,-42.0,-36.0,-44.0,-49.0,-90.0,-92.0,-88.0,-91.0,42.0,57.0,45.0,46.0,1
1132,92:69:1D:31:68:E9,3775308,489821109,12785,15252893,3762523,474568216,3,19257,3554858,18560,3394531,697,160327,6443,105,14042,252,3,251,216660.0,130000.0,-51.0,-49.0,-45.0,-47.0,-50.0,-48.0,-43.0,-47.0,-90.0,-92.0,-88.0,-91.0,39.0,43.0,43.0,44.0,1
1133,CC:2F:71:3F:1F:24,3972678,721375640,210150,246806960,3762528,474568680,27,177249,203488633,177170,203478765,79,9868,169667,6,210148,21107,24,141,130000.0,43333.0,-67.0,-66.0,-71.0,-69.0,-67.0,-66.0,-71.0,-69.0,-90.0,-91.0,-88.0,-90.0,23.0,25.0,17.0,21.0,1
1134,CC:2F:71:3E:C5:1F,3762618,474579574,90,10894,3762528,474568680,0,358,30646,289,22318,69,8328,97,2,121,4,0,5,130000.0,39000.0,-70.0,-70.0,-66.0,-60.0,-70.0,-70.0,-66.0,-61.0,-90.0,-91.0,-88.0,-90.0,20.0,21.0,22.0,30.0,1
1135,BA:8C:B9:54:50:24,3762798,474651655,270,82975,3762528,474568680,0,1174,131597,1156,128751,18,2846,178,4,380,6,0,7,229410.0,130000.0,-48.0,-35.0,-43.0,-45.0,-42.0,-36.0,-44.0,-49.0,-90.0,-91.0,-88.0,-90.0,42.0,56.0,45.0,45.0,1
1136,92:69:1D:31:68:E9,3775313,489821573,12785,15252893,3762528,474568680,3,19257,3554858,18560,3394531,697,160327,6443,105,14042,252,3,251,216660.0,130000.0,-51.0,-49.0,-45.0,-47.0,-50.0,-48.0,-43.0,-47.0,-90.0,-91.0,-88.0,-90.0,39.0,42.0,43.0,43.0,1
1137,CC:2F:71:3F:1F:24,3972806,721504742,210264,246930261,3762542,474574481,27,177351,203604978,177272,203595110,79,9868,169764,6,210262,21107,24,141,130000.0,43333.0,-69.0,-67.0,-72.0,-69.0,-68.0,-67.0,-72.0,-68.0,-90.0,-91.0,-88.0,-90.0,21.0,24.0,16.0,21.0,1
1138,CC:2F:71:3E:C5:1F,3762634,474585577,90,10894,3762544,474574683,0,358,30646,289,22318,69,8328,97,2,121,4,0,5,130000.0,39000.0,-70.0,-70.0,-66.0,-60.0,-70.0,-70.0,-66.0,-61.0,-90.0,-91.0,-88.0,-90.0,20.0,21.0,22.0,30.0,1
1139,BA:8C:B9:54:50:24,3762814,474657658,270,82975,3762544,474574683,0,1174,131597,1156,128751,18,2846,178,4,380,6,0,7,229410.0,130000.0,-48.0,-35.0,-43.0,-45.0,-42.0,-36.0,-44.0,-49.0,-90.0,-91.0,-88.0,-90.0,42.0,56.0,45.0,45.0,1
1140,92:69:1D:31:68:E9,3775340,489833000,12785,15252893,3762555,474580107,3,19261,3555297,18563,3394735,698,160562,6444,105,14042,252,3,251,216660.0,130000.0,-52.0,-49.0,-45.0,-48.0,-51.0,-48.0,-44.0,-48.0,-90.0,-91.0,-88.0,-90.0,38.0,42.0,43.0,42.0,1
1141,CC:2F:71:3F:1F:24,3972933,721636520,210374,247056009,3762559,474580511,27,177455,203732622,177376,203722754,79,9868,169858,6,210372,21107,24,141,144444.0,43333.0,-68.0,-66.0,-72.0,-68.0,-68.0,-66.0,-71.0,-68.0,-90.0,-91.0,-88.0,-90.0,22.0,25.0,16.0,22.0,1
1142,CC:2F:71:3E:C5:1F,3762649,474591405,90,10894,3762559,474580511,0,358,30646,289,22318,69,8328,97,2,121,4,0,5,130000.0,39000.0,-70.0,-70.0,-66.0,-60.0,-70.0,-70.0,-66.0,-61.0,-90.0,-91.0,-88.0,-90.0,20.0,21.0,22.0,30.0,1
1143,BA:8C:B9:54:50:24,3762829,474663486,270,82975,3762559,474580511,0,1174,131597,1156,128751,18,2846,178,4,380,6,0,7,229410.0,130000.0,-48.0,-35.0,-43.0,-45.0,-42.0,-36.0,-44.0,-49.0,-90.0,-91.0,-88.0,-90.0,42.0,56.0,45.0,45.0,1
1144,92:69:1D:31:68:E9,3775344,489833404,12785,15252893,3762559,474580511,3,19261,3555297,18563,3394735,698,160562,6444,105,14042,252,3,251,216660.0,130000.0,-52.0,-49.0,-45.0,-48.0,-51.0,-48.0,-44.0,-48.0,-90.0,-91.0,-88.0,-90.0,38.0,42.0,43.0,42.0,1
1145,CC:2F:71:3F:1F:24,3973044,721755426,210480,247174285,3762564,474581141,27,177546,203844244,177467,203834376,79,9868,169946,6,210478,21107,24,141,144444.0,43333.0,-68.0,-66.0,-71.0,-68.0,-68.0,-66.0,-71.0,-68.0,-90.0,-91.0,-88.0,-90.0,22.0,25.0,17.0,22.0,1
1146,CC:2F:71:3E:C5:1F,3762654,474592035,90,10894,3762564,474581141,0,358,30646,289,22318,69,8328,97,2,121,4,0,5,130000.0,39000.0,-70.0,-70.0,-66.0,-60.0,-70.0,-70.0,-66.0,-61.0,-90.0,-91.0,-88.0,-90.0,20.0,21.0,22.0,30.0,1
1147,BA:8C:B9:54:50:24,3762834,474664116,270,82975,3762564,474581141,0,1176,131733,1158,128887,18,2846,178,4,381,6,0,7,229410.0,130000.0,-48.0,-35.0,-43.0,-45.0,-41.0,-36.0,-44.0,-49.0,-90.0,-91.0,-88.0,-90.0,42.0,56.0,45.0,45.0,1
1148,92:69:1D:31:68:E9,3775351,489834236,12785,15252893,3762566,474581343,3,19261,3555297,18563,3394735,698,160562,6444,105,14042,252,3,251,216660.0,130000.0,-52.0,-49.0,-45.0,-48.0,-51.0,-48.0,-44.0,-48.0,-90.0,-91.0,-88.0,-90.0,38.0,42.0,43.0,42.0,1
1149,CC:2F:71:3F:1F:24,3973156,721874308,210586,247292561,3762570,474581747,27,177641,203957782,177562,203947914,79,9868,170036,6,210583,21107,24,141,144444.0,43333.0,-68.0,-66.0,-71.0,-69.0,-68.0,-66.0,-71.0,-69.0,-90.0,-91.0,-88.0,-90.0,22.0,25.0,17.0,21.0,1
1150,CC:2F:71:3E:C5:1F,3762660,474592641,90,10894,3762570,474581747,0,358,30646,289,22318,69,8328,97,2,121,4,0,5,130000.0,39000.0,-70.0,-70.0,-66.0,-60.0,-70.0,-70.0,-66.0,-61.0,-90.0,-91.0,-88.0,-90.0,20.0,21.0,22.0,30.0,1
1151,BA:8C:B9:54:50:24,3762840,474664722,270,82975,3762570,474581747,0,1176,131733,1158,128887,18,2846,178,4,381,6,0,7,229410.0,130000.0,-48.0,-35.0,-43.0,-45.0,-41.0,-36.0,-44.0,-49.0,-90.0,-91.0,-88.0,-90.0,42.0,56.0,45.0,45.0,1
1152,92:69:1D:31:68:E9,3775355,489834640,12785,15252893,3762570,474581747,3,19261,3555297,18563,3394735,698,160562,6444,105,14042,252,3,251,216660.0,130000.0,-52.0,-49.0,-45.0,-48.0,-51.0,-48.0,-44.0,-48.0,-90.0,-91.0,-88.0,-90.0,38.0,42.0,43.0,42.0,1
1153,CC:2F:71:3F:1F:24,3973275,722001107,210702,247419098,3762573,474582009,27,177748,204079063,177669,204069195,79,9868,170137,6,210700,21108,24,141,144444.0,43333.0,-68.0,-67.0,-71.0,-69.0,-68.0,-66.0,-71.0,-68.0,-90.0,-91.0,-88.0,-90.0,22.0,24.0,17.0,21.0,1
1154,CC:2F:71:3E:C5:1F,3762663,474592903,90,10894,3762573,474582009,0,358,30646,289,22318,69,8328,97,2,121,4,0,5,130000.0,39000.0,-70.0,-70.0,-66.0,-60.0,-70.0,-70.0,-66.0,-61.0,-90.0,-91.0,-88.0,-90.0,20.0,21.0,22.0,30.0,1
1155,BA:8C:B9:54:50:24,3762843,474664984,270,82975,3762573,474582009,0,1176,131733,1158,128887,18,2846,178,4,381,6,0,7,229410.0,130000.0,-48.0,-35.0,-43.0,-45.0,-41.0,-36.0,-44.0,-49.0,-90.0,-91.0,-88.0,-90.0,42.0,56.0,45.0,45.0,1
1156,92:69:1D:31:68:E9,3775358,489834902,12785,15252893,3762573,474582009,3,19261,3555297,18563,3394735,698,160562,6444,105,14042,252,3,251,216660.0,130000.0,-52.0,-49.0,-45.0,-48.0,-51.0,-48.0,-44.0,-48.0,-90.0,-91.0,-88.0,-90.0,38.0,42.0,43.0,42.0,1
1157,CC:2F:71:3F:1F:24,3973388,722120119,210809,247537504,3762579,474582615,27,177845,204193321,177766,204183453,79,9868,170225,6,210807,21108,24,141,144444.0,43333.0,-68.0,-66.0,-71.0,-69.0,-68.0,-66.0,-71.0,-69.0,-90.0,-91.0,-88.0,-90.0,22.0,25.0,17.0,21.0,1
1158,CC:2F:71:3E:C5:1F,3762669,474593509,90,10894,3762579,474582615,0,358,30646,289,22318,69,8328,97,2,121,4,0,5,130000.0,39000.0,-70.0,-70.0,-66.0,-60.0,-70.0,-70.0,-66.0,-61.0,-90.0,-91.0,-88.0,-90.0,20.0,21.0,22.0,30.0,1
1159,BA:8C:B9:54:50:24,3762849,474665590,270,82975,3762579,474582615,0,1176,131733,1158,128887,18,2846,178,4,381,6,0,7,229410.0,130000.0,-48.0,-35.0,-43.0,-45.0,-41.0,-36.0,-44.0,-49.0,-90.0,-91.0,-88.0,-90.0,42.0,56.0,45.0,45.0,1
1160,92:69:1D:31:68:E9,3775364,489835508,12785,15252893,3762579,474582615,3,19261,3555297,18563,3394735,698,160562,6444,105,14042,252,3,251,216660.0,130000.0,-52.0,-49.0,-45.0,-48.0,-51.0,-48.0,-44.0,-48.0,-90.0,-91.0,-88.0,-90.0,38.0,42.0,43.0,42.0,1
1161,CC:2F:71:3F:1F:24,3973497,722240151,210916,247657334,3762581,474582817,27,177938,204308051,177859,204298183,79,9868,170313,6,210913,21108,24,141,144444.0,43333.0,-68.0,-67.0,-71.0,-69.0,-68.0,-66.0,-71.0,-69.0,-90.0,-91.0,-88.0,-90.0,22.0,24.0,17.0,21.0,1
1162,CC:2F:71:3E:C5:1F,3762671,474593711,90,10894,3762581,474582817,0,358,30646,289,22318,69,8328,97,2,121,4,0,5,130000.0,39000.0,-70.0,-70.0,-66.0,-60.0,-70.0,-70.0,-66.0,-61.0,-90.0,-91.0,-88.0,-90.0,20.0,21.0,22.0,30.0,1
1163,BA:8C:B9:54:50:24,3762851,474665792,270,82975,3762581,474582817,0,1176,131733,1158,128887,18,2846,178,4,381,6,0,7,229410.0,130000.0,-48.0,-35.0,-43.0,-45.0,-41.0,-36.0,-44.0,-49.0,-90.0,-91.0,-88.0,-90.0,42.0,56.0,45.0,45.0,1
1164,92:69:1D:31:68:E9,3775366,489835710,12785,15252893,3762581,474582817,3,19261,3555297,18563,3394735,698,160562,6444,105,14042,252,3,251,216660.0,130000.0,-52.0,-49.0,-45.0,-48.0,-51.0,-48.0,-44.0,-48.0,-90.0,-91.0,-88.0,-90.0,38.0,42.0,43.0,42.0,1
1165,CC:2F:71:3F:1F:24,3973608,722358891,211022,247775610,3762586,474583281,27,178031,204418515,177952,204408647,79,9868,170404,6,211020,21108,24,141,144444.0,43333.0,-69.0,-67.0,-72.0,-70.0,-68.0,-66.0,-71.0,-69.0,-90.0,-91.0,-88.0,-90.0,21.0,24.0,16.0,20.0,1
1166,CC:2F:71:3E:C5:1F,3762676,474594175,90,10894,3762586,474583281,0,358,30646,289,22318,69,8328,97,2,121,4,0,5,130000.0,39000.0,-70.0,-70.0,-66.0,-60.0,-70.0,-70.0,-66.0,-61.0,-90.0,-91.0,-88.0,-90.0,20.0,21.0,22.0,30.0,1
1167,BA:8C:B9:54:50:24,3762858,474666458,270,82975,3762588,474583483,0,1176,131733,1158,128887,18,2846,178,4,381,6,0,7,229410.0,130000.0,-48.0,-35.0,-43.0,-45.0,-41.0,-36.0,-44.0,-49.0,-90.0,-91.0,-88.0,-90.0,42.0,56.0,45.0,45.0,1
1168,92:69:1D:31:68:E9,3775373,489836376,12785,15252893,3762588,474583483,3,19261,3555297,18563,3394735,698,160562,6444,105,14042,252,3,251,216660.0,130000.0,-52.0,-49.0,-45.0,-48.0,-51.0,-48.0,-44.0,-48.0,-90.0,-91.0,-88.0,-90.0,38.0,42.0,43.0,42.0,1
1169,CC:2F:71:3F:1F:24,3973721,722480059,211133,247896576,3762588,474583483,27,178132,204537526,178053,204527658,79,9868,170499,6,211131,21108,24,141,144444.0,43333.0,-68.0,-67.0,-72.0,-69.0,-68.0,-67.0,-71.0,-69.0,-90.0,-91.0,-88.0,-90.0,22.0,24.0,16.0,21.0,1
1170,CC:2F:71:3E:C5:1F,3762681,474594852,90,10894,3762591,474583958,0,358,30646,289,22318,69,8328,97,2,121,4,0,5,130000.0,39000.0,-70.0,-70.0,-66.0,-60.0,-70.0,-70.0,-66.0,-61.0,-90.0,-91.0,-88.0,-90.0,20.0,21.0,22.0,30.0,1
1171,BA:8C:B9:54:50:24,3762861,474666933,270,82975,3762591,474583958,0,1176,131733,1158,128887,18,2846,178,4,381,6,0,7,229410.0,130000.0,-48.0,-35.0,-43.0,-45.0,-41.0,-36.0,-44.0,-49.0,-90.0,-91.0,-88.0,-90.0,42.0,56.0,45.0,45.0,1
1172,92:69:1D:31:68:E9,3775376,489836851,12785,15252893,3762591,474583958,3,19261,3555297,18563,3394735,698,160562,6444,105,14042,252,3,251,216660.0,130000.0,-52.0,-49.0,-45.0,-48.0,-51.0,-48.0,-44.0,-48.0,-90.0,-91.0,-88.0,-90.0,38.0,42.0,43.0,42.0,1
1173,CC:2F:71:3F:1F:24,3973837,722601549,211242,248017187,3762595,474584362,27,178229,204648448,178150,204638580,79,9868,170591,6,211240,21108,24,141,144444.0,43333.0,-68.0,-67.0,-72.0,-69.0,-68.0,-67.0,-71.0,-69.0,-90.0,-91.0,-88.0,-90.0,22.0,24.0,16.0,21.0,1
1174,CC:2F:71:3E:C5:1F,3762685,474595256,90,10894,3762595,474584362,0,358,30646,289,22318,69,8328,97,2,121,4,0,5,130000.0,39000.0,-70.0,-70.0,-66.0,-60.0,-70.0,-70.0,-66.0,-61.0,-90.0,-91.0,-88.0,-90.0,20.0,21.0,22.0,30.0,1
1175,BA:8C:B9:54:50:24,3762865,474667337,270,82975,3762595,474584362,0,1176,131733,1158,128887,18,2846,178,4,381,6,0,7,229410.0,130000.0,-48.0,-35.0,-43.0,-45.0,-41.0,-36.0,-44.0,-49.0,-90.0,-91.0,-88.0,-90.0,42.0,56.0,45.0,45.0,1
1176,92:69:1D:31:68:E9,3775384,489837741,12787,15253177,3762597,474584564,3,19266,3555717,18568,3395155,698,160562,6445,105,14044,252,3,251,216660.0,130000.0,-51.0,-49.0,-44.0,-48.0,-51.0,-49.0,-44.0,-48.0,-90.0,-91.0,-88.0,-90.0,39.0,42.0,44.0,42.0,1
1177,CC:2F:71:3F:1F:24,3973946,722721511,211348,248136887,3762598,474584624,27,178320,204760056,178241,204750188,79,9868,170680,6,211346,21109,24,141,144444.0,1000.0,-68.0,-67.0,-71.0,-69.0,-68.0,-67.0,-71.0,-69.0,-90.0,-91.0,-88.0,-90.0,22.0,24.0,17.0,21.0,1
1178,CC:2F:71:3E:C5:1F,3762690,474595720,90,10894,3762600,474584826,0,358,30646,289,22318,69,8328,97,2,121,4,0,5,130000.0,39000.0,-70.0,-70.0,-66.0,-60.0,-70.0,-70.0,-66.0,-61.0,-90.0,-91.0,-88.0,-90.0,20.0,21.0,22.0,30.0,1
1179,BA:8C:B9:54:50:24,3762870,474667801,270,82975,3762600,474584826,0,1176,131733,1158,128887,18,2846,178,4,381,6,0,7,229410.0,130000.0,-48.0,-35.0,-43.0,-45.0,-41.0,-36.0,-44.0,-49.0,-90.0,-91.0,-88.0,-90.0,42.0,56.0,45.0,45.0,1
1180,92:69:1D:31:68:E9,3775387,489838003,12787,15253177,3762600,474584826,3,19266,3555717,18568,3395155,698,160562,6445,105,14044,252,3,251,216660.0,130000.0,-51.0,-49.0,-44.0,-48.0,-51.0,-49.0,-44.0,-48.0,-90.0,-91.0,-88.0,-90.0,39.0,42.0,44.0,42.0,1
1181,CC:2F:71:3F:1F:24,3974058,722840281,211454,248255051,3762604,474585230,27,178413,204870676,178334,204860808,79,9868,170769,6,211452,21112,24,141,144444.0,43333.0,-68.0,-67.0,-72.0,-69.0,-68.0,-67.0,-71.0,-69.0,-90.0,-91.0,-88.0,-91.0,22.0,24.0,16.0,22.0,1
1182,CC:2F:71:3E:C5:1F,3762694,474596124,90,10894,3762604,474585230,0,358,30646,289,22318,69,8328,97,2,121,4,0,5,130000.0,39000.0,-70.0,-70.0,-66.0,-60.0,-70.0,-70.0,-66.0,-61.0,-90.0,-91.0,-88.0,-91.0,20.0,21.0,22.0,31.0,1
1183,BA:8C:B9:54:50:24,3762874,474668205,270,82975,3762604,474585230,0,1176,131733,1158,128887,18,2846,178,4,381,6,0,7,229410.0,130000.0,-48.0,-35.0,-43.0,-45.0,-41.0,-36.0,-44.0,-49.0,-90.0,-91.0,-88.0,-91.0,42.0,56.0,45.0,46.0,1
1184,92:69:1D:31:68:E9,3775391,489838407,12787,15253177,3762604,474585230,3,19266,3555717,18568,3395155,698,160562,6445,105,14044,252,3,251,216660.0,130000.0,-51.0,-49.0,-44.0,-48.0,-51.0,-49.0,-44.0,-48.0,-90.0,-91.0,-88.0,-91.0,39.0,42.0,44.0,43.0,1
1185,CC:2F:71:3F:1F:24,3974168,722958949,211561,248373457,3762607,474585492,27,178503,204979400,178424,204969532,79,9868,170857,6,211559,21112,24,141,144444.0,43333.0,-68.0,-67.0,-72.0,-69.0,-68.0,-67.0,-71.0,-69.0,-90.0,-91.0,-88.0,-91.0,22.0,24.0,16.0,22.0,1
1186,CC:2F:71:3E:C5:1F,3762697,474596386,90,10894,3762607,474585492,0,358,30646,289,22318,69,8328,97,2,121,4,0,5,130000.0,39000.0,-70.0,-70.0,-66.0,-60.0,-70.0,-70.0,-66.0,-61.0,-90.0,-91.0,-88.0,-91.0,20.0,21.0,22.0,31.0,1
1187,BA:8C:B9:54:50:24,3762879,474668669,270,82975,3762609,474585694,0,1176,131733,1158,128887,18,2846,178,4,381,6,0,7,229410.0,130000.0,-48.0,-35.0,-43.0,-45.0,-41.0,-36.0,-44.0,-49.0,-90.0,-91.0,-88.0,-91.0,42.0,56.0,45.0,46.0,1
1188,92:69:1D:31:68:E9,3775418,489844456,12809,15258762,3762609,474585694,3,19301,3592418,18603,3431856,698,160562,6469,105,14066,252,3,251,229410.0,130000.0,-50.0,-48.0,-43.0,-48.0,-51.0,-50.0,-46.0,-50.0,-90.0,-91.0,-88.0,-91.0,40.0,43.0,45.0,43.0,1
1189,CC:2F:71:3F:1F:24,3974287,723082726,211674,248496628,3762613,474586098,27,178604,205095641,178525,205085773,79,9868,170953,6,211672,21112,24,142,144444.0,43333.0,-69.0,-67.0,-72.0,-69.0,-69.0,-67.0,-72.0,-69.0,-90.0,-91.0,-88.0,-91.0,21.0,24.0,16.0,22.0,1
1190,CC:2F:71:3E:C5:1F,3762703,474596992,90,10894,3762613,474586098,0,358,30646,289,22318,69,8328,97,2,121,4,0,5,130000.0,39000.0,-70.0,-70.0,-66.0,-60.0,-70.0,-70.0,-66.0,-61.0,-90.0,-91.0,-88.0,-91.0,20.0,21.0,22.0,31.0,1
1191,BA:8C:B9:54:50:24,3762883,474669073,270,82975,3762613,474586098,0,1176,131733,1158,128887,18,2846,178,4,381,6,0,7,229410.0,130000.0,-48.0,-35.0,-43.0,-45.0,-41.0,-36.0,-44.0,-49.0,-90.0,-91.0,-88.0,-91.0,42.0,56.0,45.0,46.0,1
1192,92:69:1D:31:68:E9,3775427,489848503,12814,15262405,3762613,474586098,3,19306,3592956,18608,3432394,698,160562,6471,105,14071,252,3,251,229410.0,130000.0,-50.0,-48.0,-43.0,-48.0,-51.0,-49.0,-45.0,-50.0,-90.0,-91.0,-88.0,-91.0,40.0,43.0,45.0,43.0,1
1193,CC:2F:71:3F:1F:24,3974396,723201334,211781,248615034,3762615,474586300,27,178695,205205825,178616,205195957,79,9868,171042,6,211779,21113,24,142,144444.0,43333.0,-72.0,-70.0,-75.0,-72.0,-72.0,-70.0,-75.0,-72.0,-90.0,-91.0,-88.0,-91.0,18.0,21.0,13.0,19.0,1
1194,CC:2F:71:3E:C5:1F,3762705,474597194,90,10894,3762615,474586300,0,358,30646,289,22318,69,8328,97,2,121,4,0,5,130000.0,39000.0,-70.0,-70.0,-66.0,-60.0,-70.0,-70.0,-66.0,-61.0,-90.0,-91.0,-88.0,-91.0,20.0,21.0,22.0,31.0,1
1195,BA:8C:B9:54:50:24,3762885,474669275,270,82975,3762615,474586300,0,1176,131733,1158,128887,18,2846,178,4,381,6,0,7,229410.0,130000.0,-48.0,-35.0,-43.0,-45.0,-41.0,-36.0,-44.0,-49.0,-90.0,-91.0,-88.0,-91.0,42.0,56.0,45.0,46.0,1
1196,92:69:1D:31:68:E9,3775431,489848907,12814,15262405,3762617,474586502,3,19306,3592956,18608,3432394,698,160562,6471,105,14071,252,3,251,229410.0,130000.0,-50.0,-48.0,-43.0,-48.0,-51.0,-49.0,-45.0,-50.0,-90.0,-91.0,-88.0,-91.0,40.0,43.0,45.0,43.0,1
1197,CC:2F:71:3F:1F:24,3974509,723320276,211887,248733310,3762622,474586966,27,178794,205324141,178715,205314273,79,9868,171133,6,211885,21113,24,142,144444.0,43333.0,-68.0,-67.0,-72.0,-69.0,-68.0,-67.0,-71.0,-69.0,-90.0,-91.0,-88.0,-91.0,22.0,24.0,16.0,22.0,1
1198,CC:2F:71:3E:C5:1F,3762712,474597860,90,10894,3762622,474586966,0,358,30646,289,22318,69,8328,97,2,121,4,0,5,130000.0,39000.0,-70.0,-70.0,-66.0,-60.0,-70.0,-70.0,-66.0,-61.0,-90.0,-91.0,-88.0,-91.0,20.0,21.0,22.0,31.0,1
1199,BA:8C:B9:54:50:24,3762892,474669941,270,82975,3762622,474586966,0,1176,131733,1158,128887,18,2846,178,4,381,6,0,7,229410.0,130000.0,-48.0,-35.0,-43.0,-45.0,-41.0,-36.0,-44.0,-49.0,-90.0,-91.0,-88.0,-91.0,42.0,56.0,45.0,46.0,1
1200,92:69:1D:31:68:E9,3775436,489849371,12814,15262405,3762622,474586966,3,19306,3592956,18608,3432394,698,160562,6471,105,14071,252,3,251,229410.0,130000.0,-50.0,-48.0,-43.0,-48.0,-51.0,-49.0,-45.0,-50.0,-90.0,-91.0,-88.0,-91.0,40.0,43.0,45.0,43.0,1
1201,CC:2F:71:3F:1F:24,3974619,723440424,211995,248853256,3762624,474587168,27,178888,205437535,178809,205427667,79,9868,171224,6,211993,21113,24,142,144444.0,43333.0,-68.0,-67.0,-71.0,-69.0,-68.0,-67.0,-71.0,-69.0,-90.0,-91.0,-88.0,-91.0,22.0,24.0,17.0,22.0,1
1202,CC:2F:71:3E:C5:1F,3762715,474598178,91,11010,3762624,474587168,0,360,30786,291,22458,69,8328,97,2,122,4,0,5,130000.0,39000.0,-71.0,-70.0,-67.0,-60.0,-71.0,-70.0,-66.0,-61.0,-90.0,-91.0,-88.0,-91.0,19.0,21.0,21.0,31.0,1
1203,BA:8C:B9:54:50:24,3762895,474670259,271,83091,3762624,474587168,0,1178,131869,1160,129023,18,2846,178,4,382,6,0,8,229410.0,130000.0,-40.0,-37.0,-45.0,-51.0,-42.0,-36.0,-44.0,-49.0,-90.0,-91.0,-88.0,-91.0,50.0,54.0,43.0,40.0,1
1204,92:69:1D:31:68:E9,3775443,489850123,12817,15262753,3762626,474587370,3,19312,3593444,18614,3432882,698,160562,6473,105,14074,252,3,252,229410.0,130000.0,-50.0,-48.0,-42.0,-48.0,-50.0,-48.0,-43.0,-48.0,-90.0,-91.0,-88.0,-91.0,40.0,43.0,46.0,43.0,1
1205,CC:2F:71:3F:1F:24,3974740,723562969,212109,248975133,3762631,474587836,27,178989,205548438,178909,205538452,80,9986,171320,6,212107,21136,24,142,144444.0,43333.0,-68.0,-66.0,-71.0,-69.0,-68.0,-66.0,-71.0,-68.0,-90.0,-91.0,-88.0,-91.0,22.0,25.0,17.0,22.0,1
1206,CC:2F:71:3E:C5:1F,3762722,474598846,91,11010,3762631,474587836,0,360,30786,291,22458,69,8328,97,2,122,4,0,5,130000.0,39000.0,-71.0,-70.0,-67.0,-60.0,-71.0,-70.0,-66.0,-61.0,-90.0,-91.0,-88.0,-91.0,19.0,21.0,21.0,31.0,1
1207,BA:8C:B9:54:50:24,3762902,474670927,271,83091,3762631,474587836,0,1179,131937,1161,129091,18,2846,178,4,382,6,0,8,229410.0,130000.0,-40.0,-37.0,-45.0,-51.0,-42.0,-36.0,-44.0,-49.0,-90.0,-91.0,-88.0,-91.0,50.0,54.0,43.0,40.0,1
1208,92:69:1D:31:68:E9,3775448,489850589,12817,15262753,3762631,474587836,3,19312,3593444,18614,3432882,698,160562,6473,105,14074,252,3,252,229410.0,130000.0,-50.0,-48.0,-42.0,-48.0,-50.0,-48.0,-43.0,-48.0,-90.0,-91.0,-88.0,-91.0,40.0,43.0,46.0,43.0,1
1209,CC:2F:71:3F:1F:24,3974850,723683061,212216,249094963,3762634,474588098,27,179083,205658956,179003,205648970,80,9986,171413,6,212214,21148,24,142,144444.0,43333.0,-68.0,-66.0,-71.0,-68.0,-68.0,-66.0,-71.0,-68.0,-90.0,-91.0,-88.0,-91.0,22.0,25.0,17.0,23.0,1
1210,CC:2F:71:3E:C5:1F,3762725,474599108,91,11010,3762634,474588098,0,360,30786,291,22458,69,8328,97,2,122,4,0,5,130000.0,39000.0,-71.0,-70.0,-67.0,-60.0,-71.0,-70.0,-66.0,-61.0,-90.0,-91.0,-88.0,-91.0,19.0,21.0,21.0,31.0,1
1211,BA:8C:B9:54:50:24,3762905,474671189,271,83091,3762634,474588098,0,1179,131937,1161,129091,18,2846,178,4,382,6,0,8,229410.0,130000.0,-40.0,-37.0,-45.0,-51.0,-42.0,-36.0,-44.0,-49.0,-90.0,-91.0,-88.0,-91.0,50.0,54.0,43.0,40.0,1
1212,92:69:1D:31:68:E9,3775453,489851053,12817,15262753,3762636,474588300,3,19312,3593444,18614,3432882,698,160562,6473,105,14074,252,3,252,229410.0,130000.0,-50.0,-48.0,-42.0,-48.0,-50.0,-48.0,-43.0,-48.0,-90.0,-91.0,-88.0,-91.0,40.0,43.0,46.0,43.0,1
1213,CC:2F:71:3F:1F:24,3974966,723806863,212326,249218159,3762640,474588704,27,179185,205777764,179105,205767778,80,9986,171509,6,212324,21186,24,143,144444.0,43333.0,-68.0,-67.0,-71.0,-68.0,-68.0,-67.0,-71.0,-68.0,-90.0,-91.0,-88.0,-90.0,22.0,24.0,17.0,22.0,1
1214,CC:2F:71:3E:C5:1F,3762731,474599714,91,11010,3762640,474588704,0,360,30786,291,22458,69,8328,97,2,122,4,0,5,130000.0,39000.0,-71.0,-70.0,-67.0,-60.0,-71.0,-70.0,-66.0,-61.0,-90.0,-91.0,-88.0,-90.0,19.0,21.0,21.0,30.0,1
1215,BA:8C:B9:54:50:24,3762911,474671795,271,83091,3762640,474588704,0,1179,131937,1161,129091,18,2846,178,4,382,6,0,8,229410.0,130000.0,-40.0,-37.0,-45.0,-51.0,-42.0,-36.0,-44.0,-49.0,-90.0,-91.0,-88.0,-90.0,50.0,54.0,43.0,39.0,1
1216,92:69:1D:31:68:E9,3775457,489851457,12817,15262753,3762640,474588704,3,19312,3593444,18614,3432882,698,160562,6473,105,14074,252,3,252,229410.0,130000.0,-50.0,-48.0,-42.0,-48.0,-50.0,-48.0,-43.0,-48.0,-90.0,-91.0,-88.0,-90.0,40.0,43.0,46.0,42.0,1
1217,CC:2F:71:3F:1F:24,3975076,723926787,212433,249337821,3762643,474588966,27,179279,205892624,179199,205882638,80,9986,171599,6,212431,21223,24,143,130000.0,43333.0,-68.0,-67.0,-71.0,-68.0,-68.0,-66.0,-71.0,-68.0,-90.0,-91.0,-88.0,-90.0,22.0,24.0,17.0,22.0,1
1218,CC:2F:71:3E:C5:1F,3762734,474599976,91,11010,3762643,474588966,0,360,30786,291,22458,69,8328,97,2,122,4,0,5,130000.0,39000.0,-71.0,-70.0,-67.0,-60.0,-71.0,-70.0,-66.0,-61.0,-90.0,-91.0,-88.0,-90.0,19.0,21.0,21.0,30.0,1
1219,BA:8C:B9:54:50:24,3762914,474672057,271,83091,3762643,474588966,0,1179,131937,1161,129091,18,2846,178,4,382,6,0,8,229410.0,130000.0,-40.0,-37.0,-45.0,-51.0,-42.0,-36.0,-44.0,-49.0,-90.0,-91.0,-88.0,-91.0,50.0,54.0,43.0,40.0,1
1220,92:69:1D:31:68:E9,3775460,489851719,12817,15262753,3762643,474588966,3,19312,3593444,18614,3432882,698,160562,6473,105,14074,252,3,252,229410.0,130000.0,-50.0,-48.0,-42.0,-48.0,-50.0,-48.0,-43.0,-48.0,-90.0,-91.0,-88.0,-91.0,40.0,43.0,46.0,43.0,1
1221,CC:2F:71:3F:1F:24,3975199,724051146,212550,249461574,3762649,474589572,27,179383,206010699,179303,206000713,80,9986,171696,6,212547,21223,24,143,130000.0,43333.0,-68.0,-67.0,-71.0,-69.0,-68.0,-67.0,-71.0,-68.0,-90.0,-91.0,-88.0,-91.0,22.0,24.0,17.0,22.0,1
1222,CC:2F:71:3E:C5:1F,3762740,474600582,91,11010,3762649,474589572,0,360,30786,291,22458,69,8328,97,2,122,4,0,5,130000.0,39000.0,-71.0,-70.0,-67.0,-60.0,-71.0,-70.0,-66.0,-61.0,-90.0,-91.0,-88.0,-91.0,19.0,21.0,21.0,31.0,1
1223,BA:8C:B9:54:50:24,3762920,474672663,271,83091,3762649,474589572,0,1179,131937,1161,129091,18,2846,178,4,382,6,0,8,229410.0,130000.0,-40.0,-37.0,-45.0,-51.0,-42.0,-36.0,-44.0,-49.0,-90.0,-91.0,-88.0,-91.0,50.0,54.0,43.0,40.0,1
1224,92:69:1D:31:68:E9,3775466,489852325,12817,15262753,3762649,474589572,3,19312,3593444,18614,3432882,698,160562,6473,105,14074,252,3,252,229410.0,130000.0,-50.0,-48.0,-42.0,-48.0,-50.0,-48.0,-43.0,-48.0,-90.0,-91.0,-88.0,-91.0,40.0,43.0,46.0,43.0,1
1225,CC:2F:71:3F:1F:24,3975309,724169775,212657,249579728,3762652,474590047,27,179481,206123539,179401,206113553,80,9986,171788,6,212655,21223,24,143,130000.0,39000.0,-68.0,-66.0,-71.0,-69.0,-67.0,-66.0,-71.0,-69.0,-90.0,-91.0,-88.0,-90.0,22.0,25.0,17.0,21.0,1
1226,CC:2F:71:3E:C5:1F,3762743,474601057,91,11010,3762652,474590047,0,360,30786,291,22458,69,8328,97,2,122,4,0,5,130000.0,39000.0,-71.0,-70.0,-67.0,-60.0,-71.0,-70.0,-66.0,-61.0,-90.0,-91.0,-88.0,-90.0,19.0,21.0,21.0,30.0,1
1227,BA:8C:B9:54:50:24,3762923,474673138,271,83091,3762652,474590047,0,1179,131937,1161,129091,18,2846,178,4,382,6,0,8,229410.0,130000.0,-40.0,-37.0,-45.0,-51.0,-42.0,-36.0,-44.0,-49.0,-90.0,-91.0,-88.0,-90.0,50.0,54.0,43.0,39.0,1
1228,92:69:1D:31:68:E9,3775469,489852800,12817,15262753,3762652,474590047,3,19312,3593444,18614,3432882,698,160562,6473,105,14074,252,3,252,229410.0,130000.0,-50.0,-48.0,-42.0,-48.0,-50.0,-48.0,-43.0,-48.0,-90.0,-91.0,-88.0,-90.0,40.0,43.0,46.0,42.0,1
1229,CC:2F:71:3F:1F:24,3975424,724290289,212765,249699576,3762659,474590713,27,179577,206238727,179497,206228741,80,9986,171878,6,212762,21225,24,143,144444.0,43333.0,-68.0,-66.0,-71.0,-69.0,-67.0,-66.0,-71.0,-69.0,-90.0,-91.0,-88.0,-90.0,22.0,25.0,17.0,21.0,1
1230,CC:2F:71:3E:C5:1F,3762750,474601723,91,11010,3762659,474590713,0,360,30786,291,22458,69,8328,97,2,122,4,0,5,130000.0,39000.0,-71.0,-70.0,-67.0,-60.0,-71.0,-70.0,-66.0,-61.0,-90.0,-91.0,-88.0,-90.0,19.0,21.0,21.0,30.0,1
1231,BA:8C:B9:54:50:24,3762930,474673804,271,83091,3762659,474590713,0,1179,131937,1161,129091,18,2846,178,4,382,6,0,8,229410.0,130000.0,-40.0,-37.0,-45.0,-51.0,-42.0,-36.0,-44.0,-49.0,-90.0,-91.0,-88.0,-90.0,50.0,54.0,43.0,39.0,1
1232,92:69:1D:31:68:E9,3775476,489853466,12817,15262753,3762659,474590713,3,19312,3593444,18614,3432882,698,160562,6473,105,14074,252,3,252,229410.0,130000.0,-50.0,-48.0,-42.0,-48.0,-50.0,-48.0,-43.0,-48.0,-90.0,-91.0,-88.0,-90.0,40.0,43.0,46.0,42.0,1
1233,CC:2F:71:3F:1F:24,3975531,724407213,212870,249816298,3762661,474590915,27,179672,206353813,179592,206343827,80,9986,171966,6,212868,21225,24,143,144444.0,43333.0,-67.0,-66.0,-71.0,-69.0,-67.0,-66.0,-71.0,-69.0,-90.0,-91.0,-88.0,-90.0,23.0,25.0,17.0,21.0,1
1234,CC:2F:71:3E:C5:1F,3762752,474601925,91,11010,3762661,474590915,0,360,30786,291,22458,69,8328,97,2,122,4,0,5,130000.0,39000.0,-71.0,-70.0,-67.0,-60.0,-71.0,-70.0,-66.0,-61.0,-90.0,-91.0,-88.0,-90.0,19.0,21.0,21.0,30.0,1
1235,BA:8C:B9:54:50:24,3762933,474674068,271,83091,3762662,474590977,0,1179,131937,1161,129091,18,2846,178,4,382,6,0,8,229410.0,130000.0,-40.0,-37.0,-45.0,-51.0,-42.0,-36.0,-44.0,-49.0,-90.0,-91.0,-88.0,-90.0,50.0,54.0,43.0,39.0,1
1236,92:69:1D:31:68:E9,3775479,489853730,12817,15262753,3762662,474590977,3,19312,3593444,18614,3432882,698,160562,6473,105,14074,252,3,252,229410.0,130000.0,-50.0,-48.0,-42.0,-48.0,-50.0,-48.0,-43.0,-48.0,-90.0,-91.0,-88.0,-90.0,40.0,43.0,46.0,42.0,1
1237,CC:2F:71:3F:1F:24,3975654,724531504,212986,249939921,3762668,474591583,27,179776,206471782,179696,206461796,80,9986,172065,6,212984,21226,24,143,144444.0,43333.0,-67.0,-66.0,-71.0,-69.0,-67.0,-66.0,-71.0,-69.0,-90.0,-91.0,-88.0,-90.0,23.0,25.0,17.0,21.0,1
1238,CC:2F:71:3E:C5:1F,3762759,474602593,91,11010,3762668,474591583,0,362,30974,292,22528,70,8446,98,2,122,4,0,5,130000.0,39000.0,-70.0,-70.0,-66.0,-60.0,-71.0,-70.0,-66.0,-61.0,-90.0,-91.0,-88.0,-90.0,20.0,21.0,22.0,30.0,1
1239,BA:8C:B9:54:50:24,3762939,474674674,271,83091,3762668,474591583,0,1179,131937,1161,129091,18,2846,178,4,382,6,0,8,229410.0,130000.0,-40.0,-37.0,-45.0,-51.0,-42.0,-36.0,-44.0,-49.0,-90.0,-91.0,-88.0,-90.0,50.0,54.0,43.0,39.0,1
1240,92:69:1D:31:68:E9,3775485,489854336,12817,15262753,3762668,474591583,3,19312,3593444,18614,3432882,698,160562,6473,105,14074,252,3,252,229410.0,130000.0,-50.0,-48.0,-42.0,-48.0,-50.0,-48.0,-43.0,-48.0,-90.0,-91.0,-88.0,-90.0,40.0,43.0,46.0,42.0,1
1241,CC:2F:71:3F:1F:24,3975764,724651596,213093,250059751,3762671,474591845,27,179866,206580540,179786,206570554,80,9986,172154,6,213091,21227,24,143,144444.0,43333.0,-68.0,-66.0,-71.0,-69.0,-67.0,-66.0,-71.0,-69.0,-90.0,-91.0,-88.0,-90.0,22.0,25.0,17.0,21.0,1
1242,CC:2F:71:3E:C5:1F,3762762,474602855,91,11010,3762671,474591845,0,362,30974,292,22528,70,8446,98,2,122,4,0,5,130000.0,39000.0,-70.0,-70.0,-66.0,-60.0,-71.0,-70.0,-66.0,-61.0,-90.0,-91.0,-88.0,-90.0,20.0,21.0,22.0,30.0,1
1243,BA:8C:B9:54:50:24,3762942,474674936,271,83091,3762671,474591845,0,1179,131937,1161,129091,18,2846,178,4,382,6,0,8,229410.0,130000.0,-40.0,-37.0,-45.0,-51.0,-42.0,-36.0,-44.0,-49.0,-90.0,-91.0,-88.0,-90.0,50.0,54.0,43.0,39.0,1
1244,92:69:1D:31:68:E9,3775488,489854598,12817,15262753,3762671,474591845,3,19312,3593444,18614,3432882,698,160562,6473,105,14074,252,3,252,229410.0,130000.0,-50.0,-48.0,-42.0,-48.0,-50.0,-48.0,-43.0,-48.0,-90.0,-91.0,-88.0,-90.0,40.0,43.0,46.0,42.0,1
1245,CC:2F:71:3F:1F:24,3975877,724772032,213200,250179581,3762677,474592451,27,179963,206694768,179883,206684782,80,9986,172243,6,213198,21228,24,143,144444.0,43333.0,-67.0,-66.0,-71.0,-69.0,-67.0,-66.0,-71.0,-69.0,-90.0,-91.0,-88.0,-90.0,23.0,25.0,17.0,21.0,1
1246,CC:2F:71:3E:C5:1F,3762768,474603461,91,11010,3762677,474592451,0,362,30974,292,22528,70,8446,98,2,122,4,0,5,130000.0,39000.0,-70.0,-70.0,-66.0,-60.0,-71.0,-70.0,-66.0,-61.0,-90.0,-91.0,-88.0,-90.0,20.0,21.0,22.0,30.0,1
1247,BA:8C:B9:54:50:24,3762948,474675542,271,83091,3762677,474592451,0,1179,131937,1161,129091,18,2846,178,4,382,6,0,8,229410.0,130000.0,-40.0,-37.0,-45.0,-51.0,-42.0,-36.0,-44.0,-49.0,-90.0,-91.0,-88.0,-90.0,50.0,54.0,43.0,39.0,1
1248,92:69:1D:31:68:E9,3775494,489855204,12817,15262753,3762677,474592451,3,19312,3593444,18614,3432882,698,160562,6473,105,14074,252,3,252,229410.0,130000.0,-50.0,-48.0,-42.0,-48.0,-50.0,-48.0,-43.0,-48.0,-90.0,-91.0,-88.0,-90.0,40.0,43.0,46.0,42.0,1
1249,CC:2F:71:3F:1F:24,3975986,724890640,213307,250297987,3762679,474592653,27,180057,206809614,179977,206799628,80,9986,172332,6,213305,21228,24,143,144444.0,43333.0,-67.0,-66.0,-71.0,-69.0,-67.0,-66.0,-71.0,-69.0,-90.0,-91.0,-88.0,-90.0,23.0,25.0,17.0,21.0,1
1250,CC:2F:71:3E:C5:1F,3762771,474603723,91,11010,3762680,474592713,0,362,30974,292,22528,70,8446,98,2,122,4,0,5,130000.0,39000.0,-70.0,-70.0,-66.0,-60.0,-71.0,-70.0,-66.0,-61.0,-90.0,-91.0,-88.0,-90.0,20.0,21.0,22.0,30.0,1
1251,BA:8C:B9:54:50:24,3762951,474675804,271,83091,3762680,474592713,0,1179,131937,1161,129091,18,2846,178,4,382,6,0,8,229410.0,130000.0,-40.0,-37.0,-45.0,-51.0,-42.0,-36.0,-44.0,-49.0,-90.0,-91.0,-88.0,-90.0,50.0,54.0,43.0,39.0,1
1252,92:69:1D:31:68:E9,3775497,489855466,12817,15262753,3762680,474592713,3,19313,3593512,18615,3432950,698,160562,6473,105,14075,252,3,252,229410.0,130000.0,-51.0,-48.0,-43.0,-47.0,-50.0,-48.0,-43.0,-48.0,-90.0,-91.0,-88.0,-91.0,39.0,43.0,45.0,44.0,1
1253,CC:2F:71:3F:1F:24,3976107,725014591,213421,250421272,3762686,474593319,27,180162,206929117,180082,206919131,80,9986,172429,6,213419,21231,24,143,144444.0,43333.0,-68.0,-67.0,-72.0,-70.0,-73.0,-71.0,-76.0,-74.0,-90.0,-91.0,-88.0,-91.0,22.0,24.0,16.0,21.0,1
1254,CC:2F:71:3E:C5:1F,3762777,474604329,91,11010,3762686,474593319,0,362,30974,292,22528,70,8446,98,2,122,4,0,5,130000.0,39000.0,-70.0,-70.0,-66.0,-60.0,-71.0,-70.0,-66.0,-61.0,-90.0,-91.0,-88.0,-91.0,20.0,21.0,22.0,31.0,1
1255,BA:8C:B9:54:50:24,3762957,474676410,271,83091,3762686,474593319,0,1181,132073,1163,129227,18,2846,178,4,383,6,0,8,229410.0,130000.0,-48.0,-35.0,-43.0,-45.0,-43.0,-36.0,-44.0,-48.0,-90.0,-91.0,-88.0,-91.0,42.0,56.0,45.0,46.0,1
1256,92:69:1D:31:68:E9,3775503,489856072,12817,15262753,3762686,474593319,3,19314,3593580,18616,3433018,698,160562,6473,105,14075,252,3,252,229410.0,130000.0,-51.0,-48.0,-43.0,-47.0,-50.0,-48.0,-43.0,-48.0,-90.0,-91.0,-88.0,-91.0,39.0,43.0,45.0,44.0,1
1257,CC:2F:71:3F:1F:24,3976218,725136307,213530,250542786,3762688,474593521,27,180257,207045489,180177,207035503,80,9986,172520,6,213528,21233,24,143,144444.0,43333.0,-71.0,-70.0,-75.0,-72.0,-70.0,-69.0,-74.0,-71.0,-90.0,-91.0,-88.0,-91.0,19.0,21.0,13.0,19.0,1
1258,CC:2F:71:3E:C5:1F,3762779,474604531,91,11010,3762688,474593521,0,362,30974,292,22528,70,8446,98,2,122,4,0,5,130000.0,39000.0,-70.0,-70.0,-66.0,-60.0,-71.0,-70.0,-66.0,-61.0,-90.0,-91.0,-88.0,-91.0,20.0,21.0,22.0,31.0,1
1259,BA:8C:B9:54:50:24,3762959,474676612,271,83091,3762688,474593521,0,1181,132073,1163,129227,18,2846,178,4,383,6,0,8,229410.0,130000.0,-48.0,-35.0,-43.0,-45.0,-43.0,-36.0,-44.0,-48.0,-90.0,-91.0,-88.0,-91.0,42.0,56.0,45.0,46.0,1
1260,92:69:1D:31:68:E9,3775505,489856274,12817,15262753,3762688,474593521,3,19314,3593580,18616,3433018,698,160562,6473,105,14075,252,3,252,229410.0,130000.0,-51.0,-48.0,-43.0,-47.0,-50.0,-48.0,-43.0,-48.0,-90.0,-91.0,-88.0,-91.0,39.0,43.0,45.0,44.0,1
1261,CC:2F:71:3F:1F:24,3976331,725255249,213636,250661062,3762695,474594187,27,180345,207152449,180265,207142463,80,9986,172608,6,213634,21234,24,143,144444.0,43333.0,-71.0,-70.0,-75.0,-72.0,-71.0,-70.0,-75.0,-72.0,-90.0,-91.0,-88.0,-91.0,19.0,21.0,13.0,19.0,1
1262,CC:2F:71:3E:C5:1F,3762786,474605197,91,11010,3762695,474594187,0,362,30974,292,22528,70,8446,98,2,122,4,0,5,130000.0,39000.0,-70.0,-70.0,-66.0,-60.0,-71.0,-70.0,-66.0,-61.0,-90.0,-91.0,-88.0,-91.0,20.0,21.0,22.0,31.0,1
1263,BA:8C:B9:54:50:24,3762966,474677278,271,83091,3762695,474594187,0,1181,132073,1163,129227,18,2846,178,4,383,6,0,8,229410.0,130000.0,-48.0,-35.0,-43.0,-45.0,-43.0,-36.0,-44.0,-48.0,-90.0,-91.0,-88.0,-91.0,42.0,56.0,45.0,46.0,1
1264,92:69:1D:31:68:E9,3775512,489856940,12817,15262753,3762695,474594187,3,19314,3593580,18616,3433018,698,160562,6473,105,14075,252,3,252,229410.0,130000.0,-51.0,-48.0,-43.0,-47.0,-50.0,-48.0,-43.0,-48.0,-90.0,-91.0,-88.0,-91.0,39.0,43.0,45.0,44.0,1
1265,CC:2F:71:3F:1F:24,3976455,725385546,213760,250791359,3762695,474594187,27,180452,207271267,180372,207261281,80,9986,172708,6,213758,21242,24,144,144444.0,43333.0,-71.0,-70.0,-75.0,-72.0,-71.0,-70.0,-74.0,-72.0,-90.0,-91.0,-88.0,-91.0,19.0,21.0,13.0,19.0,1
1266,CC:2F:71:3E:C5:1F,3762787,474605331,91,11010,3762696,474594321,0,362,30974,292,22528,70,8446,98,2,122,4,0,5,130000.0,39000.0,-70.0,-70.0,-66.0,-60.0,-71.0,-70.0,-66.0,-61.0,-90.0,-91.0,-88.0,-91.0,20.0,21.0,22.0,31.0,1
1267,BA:8C:B9:54:50:24,3762968,474677480,271,83091,3762697,474594389,0,1181,132073,1163,129227,18,2846,178,4,383,6,0,8,229410.0,130000.0,-48.0,-35.0,-43.0,-45.0,-43.0,-36.0,-44.0,-48.0,-90.0,-91.0,-88.0,-91.0,42.0,56.0,45.0,46.0,1
1268,92:69:1D:31:68:E9,3775514,489857142,12817,15262753,3762697,474594389,3,19314,3593580,18616,3433018,698,160562,6473,105,14075,252,3,252,229410.0,130000.0,-51.0,-48.0,-43.0,-47.0,-50.0,-48.0,-43.0,-48.0,-90.0,-91.0,-88.0,-91.0,39.0,43.0,45.0,44.0,1
1269,CC:2F:71:3F:1F:24,3976578,725511209,213875,250916214,3762703,474594995,27,180554,207386261,180474,207376275,80,9986,172807,6,213873,21250,24,145,144444.0,43333.0,-71.0,-70.0,-75.0,-72.0,-71.0,-70.0,-75.0,-72.0,-90.0,-91.0,-88.0,-91.0,19.0,21.0,13.0,19.0,1
1270,CC:2F:71:3E:C5:1F,3762794,474606005,91,11010,3762703,474594995,0,362,30974,292,22528,70,8446,98,2,122,4,0,5,130000.0,39000.0,-70.0,-70.0,-66.0,-60.0,-71.0,-70.0,-66.0,-61.0,-90.0,-91.0,-88.0,-91.0,20.0,21.0,22.0,31.0,1
1271,BA:8C:B9:54:50:24,3762974,474678086,271,83091,3762703,474594995,0,1181,132073,1163,129227,18,2846,178,4,383,6,0,8,229410.0,130000.0,-48.0,-35.0,-43.0,-45.0,-43.0,-36.0,-44.0,-48.0,-90.0,-91.0,-88.0,-91.0,42.0,56.0,45.0,46.0,1
1272,92:69:1D:31:68:E9,3775520,489857748,12817,15262753,3762703,474594995,3,19314,3593580,18616,3433018,698,160562,6473,105,14075,252,3,252,229410.0,130000.0,-51.0,-48.0,-43.0,-47.0,-50.0,-48.0,-43.0,-48.0,-90.0,-91.0,-88.0,-91.0,39.0,43.0,45.0,44.0,1
1273,CC:2F:71:3F:1F:24,3976686,725631099,213982,251036044,3762704,474595055,27,180646,207499423,180566,207489437,80,9986,172896,6,213980,21253,24,145,144444.0,43333.0,-71.0,-70.0,-75.0,-72.0,-70.0,-69.0,-74.0,-72.0,-90.0,-91.0,-88.0,-91.0,19.0,21.0,13.0,19.0,1
1274,CC:2F:71:3E:C5:1F,3762795,474606065,91,11010,3762704,474595055,0,362,30974,292,22528,70,8446,98,2,122,4,0,5,130000.0,39000.0,-70.0,-70.0,-66.0,-60.0,-71.0,-70.0,-66.0,-61.0,-90.0,-91.0,-88.0,-91.0,20.0,21.0,22.0,31.0,1
1275,BA:8C:B9:54:50:24,3762977,474678348,271,83091,3762706,474595257,0,1181,132073,1163,129227,18,2846,178,4,383,6,0,8,229410.0,130000.0,-48.0,-35.0,-43.0,-45.0,-43.0,-36.0,-44.0,-48.0,-90.0,-91.0,-88.0,-91.0,42.0,56.0,45.0,46.0,1
1276,92:69:1D:31:68:E9,3775523,489858010,12817,15262753,3762706,474595257,3,19314,3593580,18616,3433018,698,160562,6473,105,14075,252,3,252,229410.0,130000.0,-51.0,-48.0,-43.0,-47.0,-50.0,-48.0,-43.0,-48.0,-90.0,-91.0,-88.0,-91.0,39.0,43.0,45.0,44.0,1
1277,CC:2F:71:3F:1F:24,3976803,725752140,214090,251156004,3762713,474596136,27,180739,207612763,180659,207602777,80,9986,172985,6,214088,21260,24,145,144444.0,43333.0,-71.0,-70.0,-75.0,-72.0,-70.0,-69.0,-74.0,-71.0,-90.0,-91.0,-88.0,-91.0,19.0,21.0,13.0,19.0,1
1278,CC:2F:71:3E:C5:1F,3762804,474607146,91,11010,3762713,474596136,0,362,30974,292,22528,70,8446,98,2,122,4,0,5,130000.0,39000.0,-70.0,-70.0,-66.0,-60.0,-71.0,-70.0,-66.0,-61.0,-90.0,-91.0,-88.0,-91.0,20.0,21.0,22.0,31.0,1
1279,BA:8C:B9:54:50:24,3762984,474679227,271,83091,3762713,474596136,0,1181,132073,1163,129227,18,2846,178,4,383,6,0,8,229410.0,130000.0,-48.0,-35.0,-43.0,-45.0,-43.0,-36.0,-44.0,-48.0,-90.0,-91.0,-88.0,-91.0,42.0,56.0,45.0,46.0,1
1280,92:69:1D:31:68:E9,3775530,489858889,12817,15262753,3762713,474596136,3,19314,3593580,18616,3433018,698,160562,6473,105,14075,252,3,252,229410.0,130000.0,-51.0,-48.0,-43.0,-47.0,-50.0,-48.0,-43.0,-48.0,-90.0,-91.0,-88.0,-91.0,39.0,43.0,45.0,44.0,1
1281,CC:2F:71:3F:1F:24,3976910,725871970,214197,251275834,3762713,474596136,27,180832,207727493,180752,207717507,80,9986,173073,6,214194,21264,24,145,144444.0,43333.0,-71.0,-70.0,-75.0,-72.0,-69.0,-67.0,-72.0,-70.0,-90.0,-91.0,-88.0,-91.0,19.0,21.0,13.0,19.0,1
1282,CC:2F:71:3E:C5:1F,3762805,474607206,91,11010,3762714,474596196,0,362,30974,292,22528,70,8446,98,2,122,4,0,5,130000.0,39000.0,-70.0,-70.0,-66.0,-60.0,-71.0,-70.0,-66.0,-61.0,-90.0,-91.0,-88.0,-91.0,20.0,21.0,22.0,31.0,1
1283,BA:8C:B9:54:50:24,3762985,474679287,271,83091,3762714,474596196,0,1181,132073,1163,129227,18,2846,178,4,383,6,0,8,229410.0,130000.0,-48.0,-35.0,-43.0,-45.0,-43.0,-36.0,-44.0,-48.0,-90.0,-91.0,-88.0,-91.0,42.0,56.0,45.0,46.0,1
1284,92:69:1D:31:68:E9,3775533,489859151,12817,15262753,3762716,474596398,3,19314,3593580,18616,3433018,698,160562,6473,105,14075,252,3,252,229410.0,130000.0,-51.0,-48.0,-43.0,-47.0,-50.0,-48.0,-43.0,-48.0,-90.0,-91.0,-88.0,-91.0,39.0,43.0,45.0,44.0,1
1285,CC:2F:71:3F:1F:24,3977032,725994585,214310,251397581,3762722,474597004,27,180933,207841325,180853,207831339,80,9986,173169,6,214308,21274,24,145,144444.0,43333.0,-67.0,-66.0,-71.0,-69.0,-67.0,-66.0,-71.0,-68.0,-90.0,-91.0,-88.0,-91.0,23.0,25.0,17.0,22.0,1
1286,CC:2F:71:3E:C5:1F,3762813,474608014,91,11010,3762722,474597004,0,362,30974,292,22528,70,8446,98,2,122,4,0,5,130000.0,39000.0,-70.0,-70.0,-66.0,-60.0,-71.0,-70.0,-66.0,-61.0,-90.0,-91.0,-88.0,-91.0,20.0,21.0,22.0,31.0,1
1287,BA:8C:B9:54:50:24,3762993,474680095,271,83091,3762722,474597004,0,1181,132073,1163,129227,18,2846,178,4,383,6,0,8,229410.0,130000.0,-48.0,-35.0,-43.0,-45.0,-43.0,-36.0,-44.0,-48.0,-90.0,-91.0,-88.0,-91.0,42.0,56.0,45.0,46.0,1
1288,92:69:1D:31:68:E9,3775539,489859757,12817,15262753,3762722,474597004,3,19314,3593580,18616,3433018,698,160562,6473,105,14075,252,3,252,229410.0,130000.0,-51.0,-48.0,-43.0,-47.0,-50.0,-48.0,-43.0,-48.0,-90.0,-91.0,-88.0,-91.0,39.0,43.0,45.0,44.0,1
1289,CC:2F:71:3F:1F:24,3977140,726114545,214418,251517541,3762722,474597004,27,181032,207961113,180952,207951127,80,9986,173260,6,214416,21277,24,145,144444.0,43333.0,-71.0,-70.0,-75.0,-73.0,-70.0,-69.0,-74.0,-71.0,-90.0,-91.0,-88.0,-91.0,19.0,21.0,13.0,18.0,1
1290,CC:2F:71:3E:C5:1F,3762813,474608014,91,11010,3762722,474597004,0,362,30974,292,22528,70,8446,98,2,122,4,0,5,130000.0,39000.0,-70.0,-70.0,-66.0,-60.0,-71.0,-70.0,-66.0,-61.0,-90.0,-91.0,-88.0,-91.0,20.0,21.0,22.0,31.0,1
1291,BA:8C:B9:54:50:24,3762993,474680095,271,83091,3762722,474597004,0,1181,132073,1163,129227,18,2846,178,4,383,6,0,8,229410.0,130000.0,-48.0,-35.0,-43.0,-45.0,-43.0,-36.0,-44.0,-48.0,-90.0,-91.0,-88.0,-91.0,42.0,56.0,45.0,46.0,1
1292,92:69:1D:31:68:E9,3775541,489859959,12817,15262753,3762724,474597206,3,19314,3593580,18616,3433018,698,160562,6473,105,14075,252,3,252,229410.0,130000.0,-51.0,-48.0,-43.0,-47.0,-50.0,-48.0,-43.0,-48.0,-90.0,-91.0,-88.0,-91.0,39.0,43.0,45.0,44.0,1
1293,CC:2F:71:3F:1F:24,3977254,726233621,214524,251635817,3762730,474597804,27,181127,208077607,181047,208067621,80,9986,173348,6,214522,21299,24,145,144444.0,43333.0,-69.0,-67.0,-71.0,-69.0,-69.0,-67.0,-71.0,-69.0,-90.0,-91.0,-88.0,-91.0,21.0,24.0,17.0,22.0,1
1294,CC:2F:71:3E:C5:1F,3762822,474608882,91,11010,3762731,474597872,0,362,30974,292,22528,70,8446,98,2,122,4,0,5,130000.0,39000.0,-70.0,-70.0,-66.0,-60.0,-71.0,-70.0,-66.0,-61.0,-90.0,-91.0,-88.0,-91.0,20.0,21.0,22.0,31.0,1
1295,BA:8C:B9:54:50:24,3763002,474680963,271,83091,3762731,474597872,0,1181,132073,1163,129227,18,2846,178,4,383,6,0,8,229410.0,130000.0,-48.0,-35.0,-43.0,-45.0,-43.0,-36.0,-44.0,-48.0,-90.0,-91.0,-88.0,-91.0,42.0,56.0,45.0,46.0,1
1296,92:69:1D:31:68:E9,3775548,489860625,12817,15262753,3762731,474597872,3,19314,3593580,18616,3433018,698,160562,6473,105,14075,252,3,252,229410.0,130000.0,-51.0,-48.0,-43.0,-47.0,-50.0,-48.0,-43.0,-48.0,-90.0,-91.0,-88.0,-91.0,39.0,43.0,45.0,44.0,1
1297,CC:2F:71:3F:1F:24,3977362,726353463,214631,251755591,3762731,474597872,27,181230,208202359,181150,208192373,80,9986,173437,6,214629,21311,24,145,130000.0,43333.0,-69.0,-66.0,-72.0,-68.0,-69.0,-66.0,-72.0,-68.0,-90.0,-91.0,-88.0,-91.0,21.0,25.0,16.0,23.0,1
1298,CC:2F:71:3E:C5:1F,3762822,474608882,91,11010,3762731,474597872,0,362,30974,292,22528,70,8446,98,2,122,4,0,5,130000.0,39000.0,-70.0,-70.0,-66.0,-60.0,-71.0,-70.0,-66.0,-61.0,-90.0,-91.0,-88.0,-91.0,20.0,21.0,22.0,31.0,1
1299,BA:8C:B9:54:50:24,3763002,474680963,271,83091,3762731,474597872,0,1181,132073,1163,129227,18,2846,178,4,383,6,0,8,229410.0,130000.0,-48.0,-35.0,-43.0,-45.0,-43.0,-36.0,-44.0,-48.0,-90.0,-91.0,-88.0,-91.0,42.0,56.0,45.0,46.0,1
1300,92:69:1D:31:68:E9,3775548,489860625,12817,15262753,3762731,474597872,3,19315,3593648,18617,3433086,698,160562,6473,105,14075,252,3,252,229410.0,130000.0,-51.0,-48.0,-43.0,-48.0,-50.0,-48.0,-42.0,-48.0,-90.0,-91.0,-88.0,-91.0,39.0,43.0,45.0,43.0,1
1301,CC:2F:71:3F:1F:24,3977492,726481818,214755,251883340,3762737,474598478,27,181344,208322501,181264,208312515,80,9986,173543,6,214753,21311,24,145,130000.0,43333.0,-69.0,-66.0,-73.0,-69.0,-69.0,-66.0,-72.0,-69.0,-90.0,-91.0,-88.0,-91.0,21.0,25.0,15.0,22.0,1
1302,CC:2F:71:3E:C5:1F,3762830,474609690,91,11010,3762739,474598680,0,362,30974,292,22528,70,8446,98,2,122,4,0,5,130000.0,39000.0,-70.0,-70.0,-66.0,-60.0,-71.0,-70.0,-66.0,-61.0,-90.0,-91.0,-88.0,-91.0,20.0,21.0,22.0,31.0,1
1303,BA:8C:B9:54:50:24,3763010,474681771,271,83091,3762739,474598680,0,1181,132073,1163,129227,18,2846,178,4,383,6,0,8,229410.0,130000.0,-48.0,-35.0,-43.0,-45.0,-43.0,-36.0,-44.0,-48.0,-90.0,-91.0,-88.0,-91.0,42.0,56.0,45.0,46.0,1
1304,92:69:1D:31:68:E9,3775556,489861433,12817,15262753,3762739,474598680,3,19315,3593648,18617,3433086,698,160562,6473,105,14075,252,3,252,229410.0,130000.0,-51.0,-48.0,-43.0,-48.0,-50.0,-48.0,-42.0,-48.0,-90.0,-91.0,-88.0,-91.0,39.0,43.0,45.0,43.0,1
1305,CC:2F:71:3F:1F:24,3977605,726602170,214863,252003062,3762742,474599108,27,181447,208451523,181367,208441537,80,9986,173631,6,214861,21315,24,145,130000.0,43333.0,-73.0,-70.0,-74.0,-72.0,-72.0,-69.0,-73.0,-71.0,-90.0,-91.0,-88.0,-91.0,17.0,21.0,14.0,19.0,1
1306,CC:2F:71:3E:C5:1F,3762834,474610234,92,11126,3762742,474599108,0,363,31044,293,22598,70,8446,98,2,123,4,0,5,130000.0,39000.0,-70.0,-70.0,-66.0,-60.0,-70.0,-70.0,-66.0,-60.0,-90.0,-91.0,-88.0,-91.0,20.0,21.0,22.0,31.0,1
1307,BA:8C:B9:54:50:24,3763014,474682315,272,83207,3762742,474599108,0,1182,132141,1164,129295,18,2846,178,4,384,6,0,8,229410.0,130000.0,-48.0,-35.0,-43.0,-45.0,-43.0,-36.0,-44.0,-48.0,-90.0,-91.0,-88.0,-91.0,42.0,56.0,45.0,46.0,1
1308,92:69:1D:31:68:E9,3775560,489861977,12818,15262869,3762742,474599108,3,19317,3593784,18619,3433222,698,160562,6473,105,14076,252,3,252,229410.0,137640.0,-52.0,-49.0,-42.0,-48.0,-51.0,-48.0,-42.0,-48.0,-90.0,-91.0,-88.0,-91.0,38.0,42.0,46.0,43.0,1
1309,CC:2F:71:3F:1F:24,3977718,726723790,214970,252124076,3762748,474599714,27,181543,208570887,181463,208560901,80,9986,173721,6,214968,21320,24,145,130000.0,43333.0,-74.0,-73.0,-77.0,-75.0,-70.0,-69.0,-73.0,-71.0,-90.0,-91.0,-88.0,-91.0,16.0,18.0,11.0,16.0,1
1310,CC:2F:71:3E:C5:1F,3762840,474610840,92,11126,3762748,474599714,0,364,31114,294,22668,70,8446,98,2,123,4,0,5,130000.0,39000.0,-70.0,-70.0,-66.0,-60.0,-70.0,-70.0,-66.0,-60.0,-90.0,-91.0,-88.0,-91.0,20.0,21.0,22.0,31.0,1
1311,BA:8C:B9:54:50:24,3763022,474683123,272,83207,3762750,474599916,0,1183,132209,1165,129363,18,2846,178,4,384,6,0,8,229410.0,130000.0,-40.0,-37.0,-46.0,-51.0,-43.0,-36.0,-44.0,-48.0,-90.0,-91.0,-88.0,-91.0,50.0,54.0,42.0,40.0,1
1312,92:69:1D:31:68:E9,3775568,489862785,12818,15262869,3762750,474599916,3,19317,3593784,18619,3433222,698,160562,6473,105,14076,252,3,252,229410.0,137640.0,-52.0,-49.0,-42.0,-48.0,-51.0,-48.0,-42.0,-48.0,-90.0,-91.0,-88.0,-91.0,38.0,42.0,46.0,43.0,1
1313,CC:2F:71:3F:1F:24,3977827,726843822,215077,252243906,3762750,474599916,27,181640,208690381,181560,208680395,80,9986,173811,6,215075,21320,24,145,130000.0,43333.0,-69.0,-67.0,-72.0,-68.0,-69.0,-67.0,-72.0,-68.0,-90.0,-91.0,-88.0,-91.0,21.0,24.0,16.0,23.0,1
1314,CC:2F:71:3E:C5:1F,3762843,474611102,92,11126,3762751,474599976,0,364,31114,294,22668,70,8446,98,2,123,4,0,5,130000.0,39000.0,-70.0,-70.0,-66.0,-60.0,-70.0,-70.0,-66.0,-60.0,-90.0,-91.0,-88.0,-91.0,20.0,21.0,22.0,31.0,1
1315,BA:8C:B9:54:50:24,3763023,474683183,272,83207,3762751,474599976,0,1183,132209,1165,129363,18,2846,178,4,384,6,0,8,229410.0,130000.0,-40.0,-37.0,-46.0,-51.0,-43.0,-36.0,-44.0,-48.0,-90.0,-91.0,-88.0,-91.0,50.0,54.0,42.0,40.0,1
1316,92:69:1D:31:68:E9,3775569,489862845,12818,15262869,3762751,474599976,3,19317,3593784,18619,3433222,698,160562,6473,105,14076,252,3,252,229410.0,137640.0,-52.0,-49.0,-42.0,-48.0,-51.0,-48.0,-42.0,-48.0,-90.0,-91.0,-88.0,-91.0,38.0,42.0,46.0,43.0,1
1317,CC:2F:71:3F:1F:24,3977947,726967435,215190,252366853,3762757,474600582,27,181744,208808386,181664,208798400,80,9986,173908,6,215188,21330,24,145,130000.0,43333.0,-68.0,-66.0,-71.0,-67.0,-68.0,-66.0,-70.0,-67.0,-90.0,-91.0,-88.0,-91.0,22.0,25.0,17.0,24.0,1
1318,CC:2F:71:3E:C5:1F,3762849,474611708,92,11126,3762757,474600582,0,364,31114,294,22668,70,8446,98,2,123,4,0,5,130000.0,39000.0,-70.0,-70.0,-66.0,-60.0,-70.0,-70.0,-66.0,-60.0,-90.0,-91.0,-88.0,-91.0,20.0,21.0,22.0,31.0,1
1319,BA:8C:B9:54:50:24,3763031,474683991,272,83207,3762759,474600784,0,1183,132209,1165,129363,18,2846,178,4,384,6,0,8,229410.0,130000.0,-40.0,-37.0,-46.0,-51.0,-43.0,-36.0,-44.0,-48.0,-90.0,-91.0,-88.0,-91.0,50.0,54.0,42.0,40.0,1
1320,92:69:1D:31:68:E9,3775577,489863653,12818,15262869,3762759,474600784,3,19317,3593784,18619,3433222,698,160562,6473,105,14076,252,3,252,229410.0,137640.0,-52.0,-49.0,-42.0,-48.0,-51.0,-48.0,-42.0,-48.0,-90.0,-91.0,-88.0,-91.0,38.0,42.0,46.0,43.0,1
1321,CC:2F:71:3F:1F:24,3978057,727087529,215297,252486683,3762760,474600846,27,181836,208920112,181755,208910008,81,10104,173998,6,215295,21330,24,145,130000.0,43333.0,-70.0,-67.0,-71.0,-68.0,-69.0,-67.0,-71.0,-68.0,-90.0,-91.0,-88.0,-91.0,20.0,24.0,17.0,23.0,1
1322,CC:2F:71:3E:C5:1F,3762852,474611972,92,11126,3762760,474600846,0,364,31114,294,22668,70,8446,98,2,123,4,0,5,130000.0,39000.0,-70.0,-70.0,-66.0,-60.0,-70.0,-70.0,-66.0,-60.0,-90.0,-91.0,-88.0,-91.0,20.0,21.0,22.0,31.0,1
1323,BA:8C:B9:54:50:24,3763032,474684053,272,83207,3762760,474600846,0,1183,132209,1165,129363,18,2846,178,4,384,6,0,8,229410.0,130000.0,-40.0,-37.0,-46.0,-51.0,-43.0,-36.0,-44.0,-48.0,-90.0,-91.0,-88.0,-91.0,50.0,54.0,42.0,40.0,1
1324,92:69:1D:31:68:E9,3775578,489863715,12818,15262869,3762760,474600846,3,19317,3593784,18619,3433222,698,160562,6473,105,14076,252,3,252,229410.0,137640.0,-52.0,-49.0,-42.0,-48.0,-51.0,-48.0,-42.0,-48.0,-90.0,-91.0,-88.0,-91.0,38.0,42.0,46.0,43.0,1
1325,CC:2F:71:3F:1F:24,3978173,727211021,215406,252609509,3762767,474601512,27,181932,209039462,181851,209029358,81,10104,174089,6,215404,21334,24,145,117000.0,39000.0,-68.0,-67.0,-72.0,-69.0,-68.0,-67.0,-71.0,-69.0,-90.0,-91.0,-88.0,-91.0,22.0,24.0,16.0,22.0,1
1326,CC:2F:71:3E:C5:1F,3762859,474612638,92,11126,3762767,474601512,0,364,31114,294,22668,70,8446,98,2,123,4,0,5,130000.0,39000.0,-70.0,-70.0,-66.0,-60.0,-70.0,-70.0,-66.0,-60.0,-90.0,-91.0,-88.0,-91.0,20.0,21.0,22.0,31.0,1
1327,BA:8C:B9:54:50:24,3763040,474684853,272,83207,3762768,474601646,0,1183,132209,1165,129363,18,2846,178,4,384,6,0,8,229410.0,130000.0,-40.0,-37.0,-46.0,-51.0,-43.0,-36.0,-44.0,-48.0,-90.0,-91.0,-88.0,-91.0,50.0,54.0,42.0,40.0,1
1328,92:69:1D:31:68:E9,3775587,489864583,12818,15262869,3762769,474601714,3,19317,3593784,18619,3433222,698,160562,6473,105,14076,252,3,252,229410.0,137640.0,-52.0,-49.0,-42.0,-48.0,-51.0,-48.0,-42.0,-48.0,-90.0,-91.0,-88.0,-91.0,38.0,42.0,46.0,43.0,1
1329,CC:2F:71:3F:1F:24,3978284,727332401,215515,252730687,3762769,474601714,27,182030,209157758,181949,209147654,81,10104,174179,6,215513,21342,24,145,130000.0,43333.0,-71.0,-70.0,-73.0,-71.0,-70.0,-69.0,-73.0,-71.0,-90.0,-91.0,-88.0,-91.0,19.0,21.0,15.0,20.0,1
1330,CC:2F:71:3E:C5:1F,3762862,474613113,92,11126,3762770,474601987,0,364,31114,294,22668,70,8446,98,2,123,4,0,5,130000.0,39000.0,-70.0,-70.0,-66.0,-60.0,-70.0,-70.0,-66.0,-60.0,-90.0,-91.0,-88.0,-91.0,20.0,21.0,22.0,31.0,1
1331,BA:8C:B9:54:50:24,3763042,474685194,272,83207,3762770,474601987,0,1185,132345,1167,129499,18,2846,178,4,384,6,0,8,229410.0,130000.0,-40.0,-37.0,-46.0,-51.0,-42.0,-36.0,-44.0,-49.0,-90.0,-91.0,-88.0,-90.0,50.0,54.0,42.0,39.0,1
1332,92:69:1D:31:68:E9,3775588,489864856,12818,15262869,3762770,474601987,3,19317,3593784,18619,3433222,698,160562,6473,105,14076,252,3,252,229410.0,137640.0,-52.0,-49.0,-42.0,-48.0,-51.0,-48.0,-42.0,-48.0,-90.0,-91.0,-88.0,-90.0,38.0,42.0,46.0,42.0,1
1333,CC:2F:71:3F:1F:24,3978405,727456581,215629,252853988,3762776,474602593,27,182129,209272286,182048,209262182,81,10104,174274,6,215627,21342,24,145,130000.0,43333.0,-73.0,-70.0,-77.0,-72.0,-72.0,-69.0,-75.0,-72.0,-90.0,-91.0,-88.0,-90.0,17.0,21.0,11.0,18.0,1
1334,CC:2F:71:3E:C5:1F,3762868,474613719,92,11126,3762776,474602593,0,364,31114,294,22668,70,8446,98,2,123,4,0,5,130000.0,39000.0,-70.0,-70.0,-66.0,-60.0,-70.0,-70.0,-66.0,-60.0,-90.0,-91.0,-88.0,-90.0,20.0,21.0,22.0,30.0,1
1335,BA:8C:B9:54:50:24,3763048,474685800,272,83207,3762776,474602593,0,1186,132413,1168,129567,18,2846,178,4,384,6,0,8,229410.0,130000.0,-48.0,-35.0,-43.0,-45.0,-43.0,-36.0,-44.0,-48.0,-90.0,-91.0,-88.0,-90.0,42.0,56.0,45.0,45.0,1
1336,92:69:1D:31:68:E9,3775594,489865462,12818,15262869,3762776,474602593,3,19317,3593784,18619,3433222,698,160562,6473,105,14076,252,3,252,229410.0,137640.0,-52.0,-49.0,-42.0,-48.0,-51.0,-48.0,-42.0,-48.0,-90.0,-91.0,-88.0,-90.0,38.0,42.0,46.0,42.0,1
1337,CC:2F:71:3F:1F:24,3978514,727576207,215735,252973352,3762779,474602855,27,182226,209390686,182145,209380582,81,10104,174361,6,215733,21356,24,145,117000.0,39000.0,-69.0,-66.0,-71.0,-70.0,-72.0,-69.0,-74.0,-72.0,-90.0,-91.0,-88.0,-90.0,21.0,25.0,17.0,20.0,1
1338,CC:2F:71:3E:C5:1F,3762871,474613981,92,11126,3762779,474602855,0,364,31114,294,22668,70,8446,98,2,123,4,0,5,130000.0,39000.0,-70.0,-70.0,-66.0,-60.0,-70.0,-70.0,-66.0,-60.0,-90.0,-91.0,-88.0,-90.0,20.0,21.0,22.0,30.0,1
1339,BA:8C:B9:54:50:24,3763051,474686062,272,83207,3762779,474602855,0,1186,132413,1168,129567,18,2846,178,4,384,6,0,8,229410.0,130000.0,-48.0,-35.0,-43.0,-45.0,-43.0,-36.0,-44.0,-48.0,-90.0,-91.0,-88.0,-90.0,42.0,56.0,45.0,45.0,1
1340,92:69:1D:31:68:E9,3775597,489865724,12818,15262869,3762779,474602855,3,19317,3593784,18619,3433222,698,160562,6473,105,14076,252,3,252,229410.0,137640.0,-52.0,-49.0,-42.0,-48.0,-51.0,-48.0,-42.0,-48.0,-90.0,-91.0,-88.0,-90.0,38.0,42.0,46.0,42.0,1
1341,CC:2F:71:3F:1F:24,3978624,727696199,215841,253092940,3762783,474603259,27,182318,209503896,182237,209493792,81,10104,174450,6,215839,21358,24,145,130000.0,43333.0,-70.0,-66.0,-69.0,-67.0,-70.0,-66.0,-69.0,-67.0,-90.0,-91.0,-88.0,-90.0,20.0,25.0,19.0,23.0,1
1342,CC:2F:71:3E:C5:1F,3762877,474614587,92,11126,3762785,474603461,0,364,31114,294,22668,70,8446,98,2,123,4,0,5,130000.0,39000.0,-70.0,-70.0,-66.0,-60.0,-70.0,-70.0,-66.0,-60.0,-90.0,-91.0,-88.0,-90.0,20.0,21.0,22.0,30.0,1
1343,BA:8C:B9:54:50:24,3763057,474686668,272,83207,3762785,474603461,0,1186,132413,1168,129567,18,2846,178,4,384,6,0,8,229410.0,130000.0,-48.0,-35.0,-43.0,-45.0,-43.0,-36.0,-44.0,-48.0,-90.0,-91.0,-88.0,-90.0,42.0,56.0,45.0,45.0,1
1344,92:69:1D:31:68:E9,3775603,489866330,12818,15262869,3762785,474603461,3,19317,3593784,18619,3433222,698,160562,6473,105,14076,252,3,252,229410.0,137640.0,-52.0,-49.0,-42.0,-48.0,-51.0,-48.0,-42.0,-48.0,-90.0,-91.0,-88.0,-90.0,38.0,42.0,46.0,42.0,1
1345,CC:2F:71:3F:1F:24,3978735,727816363,215947,253212640,3762788,474603723,27,182413,209623158,182332,209613054,81,10104,174538,6,215945,21358,24,145,130000.0,43333.0,-70.0,-66.0,-72.0,-72.0,-70.0,-66.0,-72.0,-72.0,-90.0,-91.0,-88.0,-90.0,20.0,25.0,16.0,18.0,1
1346,CC:2F:71:3E:C5:1F,3762880,474614849,92,11126,3762788,474603723,0,364,31114,294,22668,70,8446,98,2,123,4,0,5,130000.0,39000.0,-70.0,-70.0,-66.0,-60.0,-70.0,-70.0,-66.0,-60.0,-90.0,-91.0,-88.0,-90.0,20.0,21.0,22.0,30.0,1
1347,BA:8C:B9:54:50:24,3763060,474686930,272,83207,3762788,474603723,0,1190,132685,1172,129839,18,2846,178,4,384,6,0,8,229410.0,130000.0,-48.0,-35.0,-43.0,-45.0,-44.0,-36.0,-44.0,-48.0,-90.0,-91.0,-88.0,-90.0,42.0,56.0,45.0,45.0,1
1348,92:69:1D:31:68:E9,3775606,489866592,12818,15262869,3762788,474603723,3,19317,3593784,18619,3433222,698,160562,6473,105,14076,252,3,252,229410.0,137640.0,-52.0,-49.0,-42.0,-48.0,-51.0,-48.0,-42.0,-48.0,-90.0,-91.0,-88.0,-90.0,38.0,42.0,46.0,42.0,1
1349,CC:2F:71:3F:1F:24,3979301,728497414,216509,253893287,3762792,474604127,27,182690,209762855,182609,209752751,81,10104,174811,6,216507,21368,24,145,144444.0,43333.0,-70.0,-66.0,-72.0,-70.0,-70.0,-66.0,-72.0,-69.0,-90.0,-91.0,-88.0,-90.0,20.0,25.0,16.0,20.0,1
1350,CC:2F:71:3E:C5:1F,3762887,474615517,92,11126,3762795,474604391,0,365,31232,294,22668,71,8564,99,2,123,4,0,5,130000.0,39000.0,-71.0,-70.0,-67.0,-60.0,-70.0,-70.0,-66.0,-60.0,-90.0,-91.0,-88.0,-90.0,19.0,21.0,21.0,30.0,1
1351,BA:8C:B9:54:50:24,3763067,474687598,272,83207,3762795,474604391,0,1190,132685,1172,129839,18,2846,178,4,384,6,0,8,229410.0,130000.0,-48.0,-35.0,-43.0,-45.0,-44.0,-36.0,-44.0,-48.0,-90.0,-91.0,-88.0,-90.0,42.0,56.0,45.0,45.0,1
1352,92:69:1D:31:68:E9,3775613,489867260,12818,15262869,3762795,474604391,3,19317,3593784,18619,3433222,698,160562,6473,105,14076,252,3,252,229410.0,137640.0,-52.0,-49.0,-42.0,-48.0,-51.0,-48.0,-42.0,-48.0,-90.0,-91.0,-88.0,-90.0,38.0,42.0,46.0,42.0,1
1353,CC:2F:71:3F:1F:24,3979803,729108132,217006,254503539,3762797,474604593,27,182957,209898672,182876,209888568,81,10104,175070,6,217003,21368,24,145,144444.0,43333.0,-70.0,-67.0,-73.0,-69.0,-70.0,-66.0,-72.0,-69.0,-90.0,-91.0,-88.0,-90.0,20.0,24.0,15.0,21.0,1
1354,CC:2F:71:3E:C5:1F,3762889,474615719,92,11126,3762797,474604593,0,366,31302,295,22738,71,8564,99,2,123,4,0,5,130000.0,39000.0,-71.0,-70.0,-66.0,-60.0,-70.0,-70.0,-66.0,-60.0,-90.0,-91.0,-88.0,-90.0,19.0,21.0,22.0,30.0,1
1355,BA:8C:B9:54:50:24,3763069,474687800,272,83207,3762797,474604593,0,1190,132685,1172,129839,18,2846,178,4,384,6,0,8,229410.0,130000.0,-48.0,-35.0,-43.0,-45.0,-44.0,-36.0,-44.0,-48.0,-90.0,-91.0,-88.0,-90.0,42.0,56.0,45.0,45.0,1
1356,92:69:1D:31:68:E9,3775615,489867462,12818,15262869,3762797,474604593,3,19317,3593784,18619,3433222,698,160562,6473,105,14076,252,3,252,229410.0,137640.0,-52.0,-49.0,-42.0,-48.0,-51.0,-48.0,-42.0,-48.0,-90.0,-91.0,-88.0,-90.0,38.0,42.0,46.0,42.0,1
1357,CC:2F:71:3F:1F:24,3979917,729232958,217115,254627901,3762802,474605057,27,183057,210021210,182976,210011106,81,10104,175161,6,217113,21370,24,145,144444.0,43333.0,-70.0,-67.0,-73.0,-70.0,-70.0,-67.0,-72.0,-69.0,-90.0,-91.0,-88.0,-90.0,20.0,24.0,15.0,20.0,1
1358,CC:2F:71:3E:C5:1F,3762895,474616317,92,11126,3762803,474605191,0,366,31302,295,22738,71,8564,99,2,123,4,0,5,130000.0,39000.0,-71.0,-70.0,-66.0,-60.0,-70.0,-70.0,-66.0,-60.0,-90.0,-91.0,-88.0,-90.0,19.0,21.0,22.0,30.0,1
1359,BA:8C:B9:54:50:24,3763075,474688398,272,83207,3762803,474605191,0,1190,132685,1172,129839,18,2846,178,4,384,6,0,8,229410.0,130000.0,-48.0,-35.0,-43.0,-45.0,-44.0,-36.0,-44.0,-48.0,-90.0,-91.0,-88.0,-90.0,42.0,56.0,45.0,45.0,1
1360,92:69:1D:31:68:E9,3775622,489868128,12818,15262869,3762804,474605259,3,19319,3593920,18621,3433358,698,160562,6473,105,14077,252,3,252,229410.0,137640.0,-52.0,-47.0,-42.0,-49.0,-51.0,-47.0,-42.0,-48.0,-90.0,-91.0,-88.0,-90.0,38.0,44.0,46.0,41.0,1
1361,CC:2F:71:3F:1F:24,3980028,729351768,217222,254746307,3762806,474605461,27,183153,210137620,183072,210127516,81,10104,175250,6,217220,21372,24,145,144444.0,43333.0,-73.0,-70.0,-75.0,-73.0,-73.0,-70.0,-75.0,-73.0,-90.0,-91.0,-88.0,-90.0,17.0,21.0,13.0,17.0,1
1362,CC:2F:71:3E:C5:1F,3762898,474616587,92,11126,3762806,474605461,0,366,31302,295,22738,71,8564,99,2,123,4,0,5,130000.0,39000.0,-71.0,-70.0,-66.0,-60.0,-70.0,-70.0,-66.0,-60.0,-90.0,-91.0,-88.0,-90.0,19.0,21.0,22.0,30.0,1
1363,BA:8C:B9:54:50:24,3763078,474688668,272,83207,3762806,474605461,0,1190,132685,1172,129839,18,2846,178,4,384,6,0,8,229410.0,130000.0,-48.0,-35.0,-43.0,-45.0,-44.0,-36.0,-44.0,-48.0,-90.0,-91.0,-88.0,-90.0,42.0,56.0,45.0,45.0,1
1364,92:69:1D:31:68:E9,3775624,489868330,12818,15262869,3762806,474605461,3,19319,3593920,18621,3433358,698,160562,6473,105,14077,252,3,252,229410.0,137640.0,-52.0,-47.0,-42.0,-49.0,-51.0,-47.0,-42.0,-48.0,-90.0,-91.0,-88.0,-90.0,38.0,44.0,46.0,41.0,1
1365,CC:2F:71:3F:1F:24,3980160,729480636,217350,254874771,3762810,474605865,27,183255,210246936,183174,210236832,81,10104,175352,6,217347,21374,24,145,144444.0,43333.0,-70.0,-66.0,-72.0,-68.0,-70.0,-66.0,-71.0,-68.0,-90.0,-91.0,-88.0,-90.0,20.0,25.0,16.0,22.0,1
1366,CC:2F:71:3E:C5:1F,3762902,474616991,92,11126,3762810,474605865,0,366,31302,295,22738,71,8564,99,2,123,4,0,5,130000.0,39000.0,-71.0,-70.0,-66.0,-60.0,-70.0,-70.0,-66.0,-60.0,-90.0,-91.0,-88.0,-90.0,19.0,21.0,22.0,30.0,1
1367,BA:8C:B9:54:50:24,3763082,474689072,272,83207,3762810,474605865,0,1191,132753,1173,129907,18,2846,178,4,384,6,0,8,229410.0,130000.0,-40.0,-37.0,-45.0,-51.0,-44.0,-36.0,-44.0,-48.0,-90.0,-91.0,-88.0,-90.0,50.0,54.0,43.0,39.0,1
1368,92:69:1D:31:68:E9,3775630,489868936,12818,15262869,3762812,474606067,3,19319,3593920,18621,3433358,698,160562,6473,105,14077,252,3,252,229410.0,137640.0,-52.0,-47.0,-42.0,-49.0,-51.0,-47.0,-42.0,-48.0,-90.0,-91.0,-88.0,-90.0,38.0,44.0,46.0,41.0,1
1369,CC:2F:71:3F:1F:24,3980312,729622904,217497,255016575,3762815,474606329,27,183383,210363975,183302,210353871,81,10104,175480,6,217497,21374,24,145,144444.0,43333.0,-70.0,-66.0,-71.0,-68.0,-70.0,-66.0,-71.0,-68.0,-90.0,-91.0,-88.0,-90.0,20.0,25.0,17.0,22.0,1
1370,CC:2F:71:3E:C5:1F,3762907,474617455,92,11126,3762815,474606329,0,366,31302,295,22738,71,8564,99,2,123,4,0,5,130000.0,39000.0,-71.0,-70.0,-66.0,-60.0,-70.0,-70.0,-66.0,-60.0,-90.0,-91.0,-88.0,-90.0,19.0,21.0,22.0,30.0,1
1371,BA:8C:B9:54:50:24,3763087,474689536,272,83207,3762815,474606329,0,1191,132753,1173,129907,18,2846,178,4,384,6,0,8,229410.0,130000.0,-40.0,-37.0,-45.0,-51.0,-44.0,-36.0,-44.0,-48.0,-90.0,-91.0,-88.0,-90.0,50.0,54.0,43.0,39.0,1
1372,92:69:1D:31:68:E9,3775633,489869198,12818,15262869,3762815,474606329,3,19319,3593920,18621,3433358,698,160562,6473,105,14077,252,3,252,229410.0,137640.0,-52.0,-47.0,-42.0,-49.0,-51.0,-47.0,-42.0,-48.0,-90.0,-91.0,-88.0,-90.0,38.0,44.0,46.0,41.0,1
1373,CC:2F:71:3F:1F:24,3980431,729742796,217612,255136063,3762819,474606733,27,183482,210473633,183401,210463529,81,10104,175578,6,217612,21374,24,145,144444.0,43333.0,-70.0,-67.0,-71.0,-69.0,-69.0,-67.0,-71.0,-69.0,-90.0,-91.0,-88.0,-90.0,20.0,24.0,17.0,21.0,1
1374,CC:2F:71:3E:C5:1F,3762911,474617859,92,11126,3762819,474606733,0,366,31302,295,22738,71,8564,99,2,123,4,0,5,130000.0,39000.0,-71.0,-70.0,-66.0,-60.0,-70.0,-70.0,-66.0,-60.0,-90.0,-91.0,-88.0,-90.0,19.0,21.0,22.0,30.0,1
1375,BA:8C:B9:54:50:24,3763091,474689940,272,83207,3762819,474606733,0,1191,132753,1173,129907,18,2846,178,4,384,6,0,8,229410.0,130000.0,-40.0,-37.0,-45.0,-51.0,-44.0,-36.0,-44.0,-48.0,-90.0,-91.0,-88.0,-90.0,50.0,54.0,43.0,39.0,1
1376,92:69:1D:31:68:E9,3775637,489869602,12818,15262869,3762819,474606733,3,19319,3593920,18621,3433358,698,160562,6473,105,14077,252,3,252,229410.0,137640.0,-52.0,-47.0,-42.0,-49.0,-51.0,-47.0,-42.0,-48.0,-90.0,-91.0,-88.0,-90.0,38.0,44.0,46.0,41.0,1
1377,CC:2F:71:3F:1F:24,3980543,729861666,217719,255254469,3762824,474607197,27,183573,210585255,183492,210575151,81,10104,175666,6,217719,21374,24,145,144444.0,43333.0,-70.0,-67.0,-72.0,-69.0,-69.0,-66.0,-71.0,-69.0,-90.0,-91.0,-88.0,-90.0,20.0,24.0,16.0,21.0,1
1378,CC:2F:71:3E:C5:1F,3762916,474618323,92,11126,3762824,474607197,0,366,31302,295,22738,71,8564,99,2,123,4,0,5,130000.0,39000.0,-71.0,-70.0,-66.0,-60.0,-70.0,-70.0,-66.0,-60.0,-90.0,-91.0,-88.0,-90.0,19.0,21.0,22.0,30.0,1
1379,BA:8C:B9:54:50:24,3763096,474690404,272,83207,3762824,474607197,0,1191,132753,1173,129907,18,2846,178,4,384,6,0,8,229410.0,130000.0,-40.0,-37.0,-45.0,-51.0,-44.0,-36.0,-44.0,-48.0,-90.0,-91.0,-88.0,-90.0,50.0,54.0,43.0,39.0,1
1380,92:69:1D:31:68:E9,3775642,489870066,12818,15262869,3762824,474607197,3,19319,3593920,18621,3433358,698,160562,6473,105,14077,252,3,252,229410.0,137640.0,-52.0,-47.0,-42.0,-49.0,-51.0,-47.0,-42.0,-48.0,-90.0,-91.0,-88.0,-90.0,38.0,44.0,46.0,41.0,1
1381,CC:2F:71:3F:1F:24,3980653,729980390,217827,255372991,3762826,474607399,27,183666,210700017,183585,210689913,81,10104,175753,6,217826,21374,24,145,144444.0,43333.0,-70.0,-66.0,-71.0,-70.0,-69.0,-66.0,-71.0,-69.0,-90.0,-91.0,-88.0,-90.0,20.0,25.0,17.0,20.0,1
1382,CC:2F:71:3E:C5:1F,3762920,474618727,92,11126,3762828,474607601,0,366,31302,295,22738,71,8564,99,2,123,4,0,5,130000.0,39000.0,-71.0,-70.0,-66.0,-60.0,-70.0,-70.0,-66.0,-60.0,-90.0,-91.0,-88.0,-90.0,19.0,21.0,22.0,30.0,1
1383,BA:8C:B9:54:50:24,3763100,474690808,272,83207,3762828,474607601,0,1191,132753,1173,129907,18,2846,178,4,384,6,0,8,229410.0,130000.0,-40.0,-37.0,-45.0,-51.0,-44.0,-36.0,-44.0,-48.0,-90.0,-91.0,-88.0,-90.0,50.0,54.0,43.0,39.0,1
1384,92:69:1D:31:68:E9,3775646,489870470,12818,15262869,3762828,474607601,3,19319,3593920,18621,3433358,698,160562,6473,105,14077,252,3,252,229410.0,137640.0,-52.0,-47.0,-42.0,-49.0,-51.0,-47.0,-42.0,-48.0,-90.0,-91.0,-88.0,-90.0,38.0,44.0,46.0,41.0,1
1385,CC:2F:71:3F:1F:24,3980777,730109232,217944,255500954,3762833,474608278,27,183774,210827130,183693,210817026,81,10104,175852,6,217943,21376,24,145,144444.0,43333.0,-70.0,-67.0,-71.0,-70.0,-70.0,-66.0,-71.0,-69.0,-90.0,-91.0,-88.0,-90.0,20.0,24.0,17.0,20.0,1
1386,CC:2F:71:3E:C5:1F,3762925,474619404,92,11126,3762833,474608278,0,366,31302,295,22738,71,8564,99,2,123,4,0,5,130000.0,39000.0,-71.0,-70.0,-66.0,-60.0,-70.0,-70.0,-66.0,-60.0,-90.0,-91.0,-88.0,-90.0,19.0,21.0,22.0,30.0,1
1387,BA:8C:B9:54:50:24,3763105,474691485,272,83207,3762833,474608278,0,1191,132753,1173,129907,18,2846,178,4,384,6,0,8,229410.0,130000.0,-40.0,-37.0,-45.0,-51.0,-44.0,-36.0,-44.0,-48.0,-90.0,-91.0,-88.0,-90.0,50.0,54.0,43.0,39.0,1
1388,92:69:1D:31:68:E9,3775651,489871147,12818,15262869,3762833,474608278,3,19319,3593920,18621,3433358,698,160562,6473,105,14077,252,3,252,229410.0,137640.0,-52.0,-47.0,-42.0,-49.0,-51.0,-47.0,-42.0,-48.0,-90.0,-91.0,-88.0,-90.0,38.0,44.0,46.0,41.0,1
1389,CC:2F:71:3F:1F:24,3980887,730227900,218051,255619360,3762836,474608540,27,183868,210942134,183787,210932030,81,10104,175940,6,218051,21376,24,145,144444.0,43333.0,-70.0,-67.0,-71.0,-70.0,-70.0,-66.0,-71.0,-69.0,-90.0,-91.0,-88.0,-90.0,20.0,24.0,17.0,20.0,1
1390,CC:2F:71:3E:C5:1F,3762928,474619666,92,11126,3762836,474608540,0,366,31302,295,22738,71,8564,99,2,123,4,0,5,130000.0,39000.0,-71.0,-70.0,-66.0,-60.0,-70.0,-70.0,-66.0,-60.0,-90.0,-91.0,-88.0,-90.0,19.0,21.0,22.0,30.0,1
1391,BA:8C:B9:54:50:24,3763110,474691949,272,83207,3762838,474608742,0,1191,132753,1173,129907,18,2846,178,4,384,6,0,8,229410.0,130000.0,-40.0,-37.0,-45.0,-51.0,-44.0,-36.0,-44.0,-48.0,-90.0,-91.0,-88.0,-90.0,50.0,54.0,43.0,39.0,1
1392,92:69:1D:31:68:E9,3775656,489871611,12818,15262869,3762838,474608742,3,19319,3593920,18621,3433358,698,160562,6473,105,14077,252,3,252,229410.0,137640.0,-52.0,-47.0,-42.0,-49.0,-51.0,-47.0,-42.0,-48.0,-90.0,-91.0,-88.0,-90.0,38.0,44.0,46.0,41.0,1
1393,CC:2F:71:3F:1F:24,3980998,730346652,218156,255737506,3762842,474609146,27,183961,211052908,183880,211042804,81,10104,176028,6,218156,21380,24,145,144444.0,43333.0,-70.0,-67.0,-72.0,-70.0,-70.0,-66.0,-71.0,-69.0,-90.0,-91.0,-88.0,-90.0,20.0,24.0,16.0,20.0,1
1394,CC:2F:71:3E:C5:1F,3762934,474620272,92,11126,3762842,474609146,0,366,31302,295,22738,71,8564,99,2,123,4,0,5,130000.0,39000.0,-71.0,-70.0,-66.0,-60.0,-70.0,-70.0,-66.0,-60.0,-90.0,-91.0,-88.0,-90.0,19.0,21.0,22.0,30.0,1
1395,BA:8C:B9:54:50:24,3763114,474692353,272,83207,3762842,474609146,0,1191,132753,1173,129907,18,2846,178,4,384,6,0,8,229410.0,130000.0,-40.0,-37.0,-45.0,-51.0,-44.0,-36.0,-44.0,-48.0,-90.0,-91.0,-88.0,-90.0,50.0,54.0,43.0,39.0,1
1396,92:69:1D:31:68:E9,3775660,489872015,12818,15262869,3762842,474609146,3,19319,3593920,18621,3433358,698,160562,6473,105,14077,252,3,252,229410.0,137640.0,-52.0,-47.0,-42.0,-49.0,-51.0,-47.0,-42.0,-48.0,-90.0,-91.0,-88.0,-90.0,38.0,44.0,46.0,41.0,1
1397,CC:2F:71:3F:1F:24,3981105,730465000,218261,255855652,3762844,474609348,27,184051,211164414,183970,211154310,81,10104,176115,6,218261,21380,24,145,144444.0,43333.0,-70.0,-67.0,-72.0,-70.0,-70.0,-66.0,-71.0,-70.0,-90.0,-91.0,-88.0,-90.0,20.0,24.0,16.0,20.0,1
1398,CC:2F:71:3E:C5:1F,3762936,474620474,92,11126,3762844,474609348,0,366,31302,295,22738,71,8564,99,2,123,4,0,5,130000.0,39000.0,-71.0,-70.0,-66.0,-60.0,-70.0,-70.0,-66.0,-60.0,-90.0,-91.0,-88.0,-90.0,19.0,21.0,22.0,30.0,1
1399,BA:8C:B9:54:50:24,3763116,474692555,272,83207,3762844,474609348,0,1191,132753,1173,129907,18,2846,178,4,384,6,0,8,229410.0,130000.0,-40.0,-37.0,-45.0,-51.0,-44.0,-36.0,-44.0,-48.0,-90.0,-91.0,-88.0,-90.0,50.0,54.0,43.0,39.0,1
1400,92:69:1D:31:68:E9,3775662,489872217,12818,15262869,3762844,474609348,3,19319,3593920,18621,3433358,698,160562,6473,105,14077,252,3,252,229410.0,137640.0,-52.0,-47.0,-42.0,-49.0,-51.0,-47.0,-42.0,-48.0,-90.0,-91.0,-88.0,-90.0,38.0,44.0,46.0,41.0,1
1401,CC:2F:71:3F:1F:24,3981217,730585236,218366,255975222,3762851,474610014,27,184143,211276214,184062,211266110,81,10104,176203,6,218365,21380,24,145,144444.0,43333.0,-70.0,-67.0,-71.0,-69.0,-70.0,-67.0,-71.0,-69.0,-90.0,-91.0,-88.0,-90.0,20.0,24.0,17.0,21.0,1
1402,CC:2F:71:3E:C5:1F,3762943,474621140,92,11126,3762851,474610014,0,366,31302,295,22738,71,8564,99,2,123,4,0,5,130000.0,39000.0,-71.0,-70.0,-66.0,-60.0,-70.0,-70.0,-66.0,-60.0,-90.0,-91.0,-88.0,-90.0,19.0,21.0,22.0,30.0,1
1403,BA:8C:B9:54:50:24,3763123,474693221,272,83207,3762851,474610014,0,1191,132753,1173,129907,18,2846,178,4,384,6,0,8,229410.0,130000.0,-40.0,-37.0,-45.0,-51.0,-44.0,-36.0,-44.0,-48.0,-90.0,-91.0,-88.0,-90.0,50.0,54.0,43.0,39.0,1
1404,92:69:1D:31:68:E9,3775669,489872883,12818,15262869,3762851,474610014,3,19319,3593920,18621,3433358,698,160562,6473,105,14077,252,3,252,229410.0,137640.0,-52.0,-47.0,-42.0,-49.0,-51.0,-47.0,-42.0,-48.0,-90.0,-91.0,-88.0,-90.0,38.0,44.0,46.0,41.0,1
1405,CC:2F:71:3F:1F:24,3981331,730707055,218478,256096839,3762853,474610216,27,184244,211392363,184163,211382259,81,10104,176299,6,218478,21380,24,145,144444.0,43333.0,-70.0,-67.0,-71.0,-71.0,-69.0,-66.0,-70.0,-71.0,-90.0,-91.0,-88.0,-90.0,20.0,24.0,17.0,19.0,1
1406,CC:2F:71:3E:C5:1F,3762945,474621342,92,11126,3762853,474610216,0,366,31302,295,22738,71,8564,99,2,123,4,0,5,130000.0,39000.0,-71.0,-70.0,-66.0,-60.0,-70.0,-70.0,-66.0,-60.0,-90.0,-91.0,-88.0,-90.0,19.0,21.0,22.0,30.0,1
1407,BA:8C:B9:54:50:24,3763125,474693423,272,83207,3762853,474610216,0,1191,132753,1173,129907,18,2846,178,4,384,6,0,8,229410.0,130000.0,-40.0,-37.0,-45.0,-51.0,-44.0,-36.0,-44.0,-48.0,-90.0,-91.0,-88.0,-90.0,50.0,54.0,43.0,39.0,1
1408,92:69:1D:31:68:E9,3775671,489873085,12818,15262869,3762853,474610216,3,19319,3593920,18621,3433358,698,160562,6473,105,14077,252,3,252,229410.0,137640.0,-52.0,-47.0,-42.0,-49.0,-51.0,-47.0,-42.0,-48.0,-90.0,-91.0,-88.0,-90.0,38.0,44.0,46.0,41.0,1
1409,CC:2F:71:3F:1F:24,3981442,730824383,218583,256213561,3762859,474610822,27,184337,211504373,184256,211494269,81,10104,176387,6,218583,21401,24,145,144444.0,43333.0,-70.0,-66.0,-70.0,-70.0,-69.0,-66.0,-70.0,-70.0,-90.0,-91.0,-88.0,-90.0,20.0,25.0,18.0,20.0,1
1410,CC:2F:71:3E:C5:1F,3762952,474622008,92,11126,3762860,474610882,0,366,31302,295,22738,71,8564,99,2,123,4,0,5,130000.0,39000.0,-71.0,-70.0,-66.0,-60.0,-70.0,-70.0,-66.0,-60.0,-90.0,-91.0,-88.0,-90.0,19.0,21.0,22.0,30.0,1
1411,BA:8C:B9:54:50:24,3763132,474694089,272,83207,3762860,474610882,0,1191,132753,1173,129907,18,2846,178,4,384,6,0,8,229410.0,130000.0,-40.0,-37.0,-45.0,-51.0,-44.0,-36.0,-44.0,-48.0,-90.0,-91.0,-88.0,-90.0,50.0,54.0,43.0,39.0,1
1412,92:69:1D:31:68:E9,3775678,489873751,12818,15262869,3762860,474610882,3,19319,3593920,18621,3433358,698,160562,6473,105,14077,252,3,252,229410.0,137640.0,-52.0,-47.0,-42.0,-49.0,-51.0,-47.0,-42.0,-48.0,-90.0,-91.0,-88.0,-90.0,38.0,44.0,46.0,41.0,1
1413,CC:2F:71:3F:1F:24,3981553,730943167,218691,256332083,3762862,474611084,27,184429,211614845,184348,211604741,81,10104,176475,6,218691,21401,24,145,144444.0,43333.0,-69.0,-66.0,-70.0,-70.0,-69.0,-66.0,-70.0,-70.0,-90.0,-91.0,-88.0,-90.0,21.0,25.0,18.0,20.0,1
1414,CC:2F:71:3E:C5:1F,3762955,474622326,93,11242,3762862,474611084,0,368,31442,297,22878,71,8564,99,2,124,4,0,5,130000.0,39000.0,-70.0,-71.0,-68.0,-60.0,-70.0,-70.0,-66.0,-60.0,-90.0,-91.0,-88.0,-90.0,20.0,20.0,20.0,30.0,1
1415,BA:8C:B9:54:50:24,3763135,474694407,273,83323,3762862,474611084,0,1193,132889,1175,130043,18,2846,178,4,385,6,0,8,229410.0,130000.0,-49.0,-35.0,-43.0,-45.0,-46.0,-35.0,-43.0,-46.0,-90.0,-91.0,-88.0,-90.0,41.0,56.0,45.0,45.0,1
1416,92:69:1D:31:68:E9,3775681,489874013,12819,15262929,3762862,474611084,3,19321,3594056,18623,3433494,698,160562,6473,105,14078,252,3,252,216660.0,130000.0,-52.0,-48.0,-42.0,-49.0,-51.0,-47.0,-42.0,-48.0,-90.0,-91.0,-88.0,-90.0,38.0,43.0,46.0,41.0,1
1417,CC:2F:71:3F:1F:24,3982000,731507263,219134,256895775,3762866,474611488,27,184658,211750929,184577,211740825,81,10104,176694,6,219134,21427,24,145,144444.0,43333.0,-70.0,-67.0,-70.0,-70.0,-70.0,-66.0,-70.0,-70.0,-90.0,-91.0,-88.0,-90.0,20.0,24.0,18.0,20.0,1
1418,CC:2F:71:3E:C5:1F,3762961,474622932,93,11242,3762868,474611690,0,368,31442,297,22878,71,8564,99,2,124,4,0,5,130000.0,39000.0,-70.0,-71.0,-68.0,-60.0,-70.0,-70.0,-66.0,-60.0,-90.0,-91.0,-88.0,-90.0,20.0,20.0,20.0,30.0,1
1419,BA:8C:B9:54:50:24,3763141,474695013,273,83323,3762868,474611690,0,1193,132889,1175,130043,18,2846,178,4,385,6,0,8,229410.0,130000.0,-49.0,-35.0,-43.0,-45.0,-46.0,-35.0,-43.0,-46.0,-90.0,-91.0,-88.0,-90.0,41.0,56.0,45.0,45.0,1
1420,92:69:1D:31:68:E9,3775687,489874619,12819,15262929,3762868,474611690,3,19321,3594056,18623,3433494,698,160562,6473,105,14078,252,3,252,216660.0,130000.0,-52.0,-48.0,-42.0,-49.0,-51.0,-47.0,-42.0,-48.0,-90.0,-91.0,-88.0,-90.0,38.0,43.0,46.0,41.0,1
1421,CC:2F:71:3F:1F:24,3982176,731678407,219305,257066455,3762871,474611952,27,184806,211873730,184725,211863626,81,10104,176835,6,219305,21461,24,145,144444.0,43333.0,-69.0,-66.0,-71.0,-69.0,-69.0,-66.0,-71.0,-68.0,-90.0,-91.0,-88.0,-90.0,21.0,25.0,17.0,21.0,1
1422,CC:2F:71:3E:C5:1F,3762964,474623194,93,11242,3762871,474611952,0,368,31442,297,22878,71,8564,99,2,124,4,0,5,130000.0,39000.0,-70.0,-71.0,-68.0,-60.0,-70.0,-70.0,-66.0,-60.0,-90.0,-91.0,-88.0,-90.0,20.0,20.0,20.0,30.0,1
1423,BA:8C:B9:54:50:24,3763144,474695275,273,83323,3762871,474611952,0,1193,132889,1175,130043,18,2846,178,4,385,6,0,8,229410.0,130000.0,-49.0,-35.0,-43.0,-45.0,-46.0,-35.0,-43.0,-46.0,-90.0,-91.0,-88.0,-90.0,41.0,56.0,45.0,45.0,1
1424,92:69:1D:31:68:E9,3775690,489874881,12819,15262929,3762871,474611952,3,19321,3594056,18623,3433494,698,160562,6473,105,14078,252,3,252,216660.0,130000.0,-52.0,-48.0,-42.0,-49.0,-51.0,-47.0,-42.0,-48.0,-90.0,-91.0,-88.0,-90.0,38.0,43.0,46.0,41.0,1
1425,CC:2F:71:3F:1F:24,3982286,731797031,219411,257184675,3762875,474612356,27,184903,211989252,184822,211979148,81,10104,176923,6,219411,21481,24,145,130000.0,43333.0,-68.0,-67.0,-72.0,-67.0,-68.0,-66.0,-72.0,-67.0,-90.0,-91.0,-88.0,-90.0,22.0,24.0,16.0,23.0,1
1426,CC:2F:71:3E:C5:1F,3762970,474623800,93,11242,3762877,474612558,0,368,31442,297,22878,71,8564,99,2,124,4,0,5,130000.0,39000.0,-70.0,-71.0,-68.0,-60.0,-70.0,-70.0,-66.0,-60.0,-90.0,-91.0,-88.0,-90.0,20.0,20.0,20.0,30.0,1
1427,BA:8C:B9:54:50:24,3763150,474695881,273,83323,3762877,474612558,0,1193,132889,1175,130043,18,2846,178,4,385,6,0,8,229410.0,130000.0,-49.0,-35.0,-43.0,-45.0,-46.0,-35.0,-43.0,-46.0,-90.0,-91.0,-88.0,-90.0,41.0,56.0,45.0,45.0,1
1428,92:69:1D:31:68:E9,3775696,489875487,12819,15262929,3762877,474612558,3,19321,3594056,18623,3433494,698,160562,6473,105,14078,252,3,252,216660.0,130000.0,-52.0,-48.0,-42.0,-49.0,-51.0,-47.0,-42.0,-48.0,-90.0,-91.0,-88.0,-90.0,38.0,43.0,46.0,41.0,1
1429,CC:2F:71:3F:1F:24,3982395,731914157,219516,257301397,3762879,474612760,27,184993,212099396,184912,212089292,81,10104,177009,6,219516,21481,24,145,130000.0,43333.0,-68.0,-66.0,-71.0,-67.0,-68.0,-65.0,-70.0,-67.0,-90.0,-91.0,-88.0,-90.0,22.0,25.0,17.0,23.0,1
1430,CC:2F:71:3E:C5:1F,3762972,474624002,93,11242,3762879,474612760,0,368,31442,297,22878,71,8564,99,2,124,4,0,5,130000.0,39000.0,-70.0,-71.0,-68.0,-60.0,-70.0,-70.0,-66.0,-60.0,-90.0,-91.0,-88.0,-90.0,20.0,20.0,20.0,30.0,1
1431,BA:8C:B9:54:50:24,3763152,474696083,273,83323,3762879,474612760,0,1193,132889,1175,130043,18,2846,178,4,385,6,0,8,229410.0,130000.0,-49.0,-35.0,-43.0,-45.0,-46.0,-35.0,-43.0,-46.0,-90.0,-91.0,-88.0,-90.0,41.0,56.0,45.0,45.0,1
1432,92:69:1D:31:68:E9,3775698,489875689,12819,15262929,3762879,474612760,3,19321,3594056,18623,3433494,698,160562,6473,105,14078,252,3,252,216660.0,130000.0,-52.0,-48.0,-42.0,-49.0,-51.0,-47.0,-42.0,-48.0,-90.0,-91.0,-88.0,-90.0,38.0,43.0,46.0,41.0,1
1433,CC:2F:71:3F:1F:24,3982508,732034413,219624,257421189,3762884,474613224,27,185086,212214126,185005,212204022,81,10104,177097,6,219624,21482,24,145,130000.0,43333.0,-69.0,-67.0,-69.0,-68.0,-69.0,-66.0,-69.0,-67.0,-90.0,-91.0,-88.0,-90.0,21.0,24.0,19.0,22.0,1
1434,CC:2F:71:3E:C5:1F,3762977,474624466,93,11242,3762884,474613224,0,368,31442,297,22878,71,8564,99,2,124,4,0,5,130000.0,39000.0,-70.0,-71.0,-68.0,-60.0,-70.0,-70.0,-66.0,-60.0,-90.0,-91.0,-88.0,-90.0,20.0,20.0,20.0,30.0,1
1435,BA:8C:B9:54:50:24,3763159,474696749,273,83323,3762886,474613426,0,1193,132889,1175,130043,18,2846,178,4,385,6,0,8,229410.0,130000.0,-49.0,-35.0,-43.0,-45.0,-46.0,-35.0,-43.0,-46.0,-90.0,-91.0,-88.0,-90.0,41.0,56.0,45.0,45.0,1
1436,92:69:1D:31:68:E9,3775705,489876355,12819,15262929,3762886,474613426,3,19321,3594056,18623,3433494,698,160562,6473,105,14078,252,3,252,216660.0,130000.0,-52.0,-48.0,-42.0,-49.0,-51.0,-47.0,-42.0,-48.0,-90.0,-91.0,-88.0,-90.0,38.0,43.0,46.0,41.0,1
1437,CC:2F:71:3F:1F:24,3982631,732158639,219740,257544550,3762891,474614089,27,185193,212331063,185111,212320841,82,10222,177198,6,219740,21487,24,145,130000.0,43333.0,-68.0,-67.0,-70.0,-69.0,-67.0,-66.0,-70.0,-69.0,-90.0,-91.0,-88.0,-90.0,22.0,24.0,18.0,21.0,1
1438,CC:2F:71:3E:C5:1F,3762984,474625331,93,11242,3762891,474614089,0,368,31442,297,22878,71,8564,99,2,124,4,0,5,130000.0,39000.0,-70.0,-71.0,-68.0,-60.0,-70.0,-70.0,-66.0,-60.0,-90.0,-91.0,-88.0,-90.0,20.0,20.0,20.0,30.0,1
1439,BA:8C:B9:54:50:24,3763164,474697412,273,83323,3762891,474614089,0,1193,132889,1175,130043,18,2846,178,4,385,6,0,8,229410.0,130000.0,-49.0,-35.0,-43.0,-45.0,-46.0,-35.0,-43.0,-46.0,-90.0,-91.0,-88.0,-90.0,41.0,56.0,45.0,45.0,1
1440,92:69:1D:31:68:E9,3775710,489877018,12819,15262929,3762891,474614089,3,19321,3594056,18623,3433494,698,160562,6473,105,14078,252,3,252,216660.0,130000.0,-52.0,-48.0,-42.0,-49.0,-51.0,-47.0,-42.0,-48.0,-90.0,-91.0,-88.0,-90.0,38.0,43.0,46.0,41.0,1
1441,CC:2F:71:3F:1F:24,3982741,732277319,219846,257662826,3762895,474614493,27,185291,212447969,185209,212437747,82,10222,177289,6,219846,21488,24,145,130000.0,43333.0,-69.0,-66.0,-70.0,-68.0,-68.0,-66.0,-70.0,-67.0,-90.0,-91.0,-88.0,-90.0,21.0,25.0,18.0,22.0,1
1442,CC:2F:71:3E:C5:1F,3762988,474625735,93,11242,3762895,474614493,0,368,31442,297,22878,71,8564,99,2,124,4,0,5,130000.0,39000.0,-70.0,-71.0,-68.0,-60.0,-70.0,-70.0,-66.0,-60.0,-90.0,-91.0,-88.0,-90.0,20.0,20.0,20.0,30.0,1
1443,BA:8C:B9:54:50:24,3763171,474698078,273,83323,3762898,474614755,0,1193,132889,1175,130043,18,2846,178,4,385,6,0,8,229410.0,130000.0,-49.0,-35.0,-43.0,-45.0,-46.0,-35.0,-43.0,-46.0,-90.0,-91.0,-88.0,-90.0,41.0,56.0,45.0,45.0,1
1444,92:69:1D:31:68:E9,3775717,489877684,12819,15262929,3762898,474614755,3,19321,3594056,18623,3433494,698,160562,6473,105,14078,252,3,252,216660.0,130000.0,-52.0,-48.0,-42.0,-49.0,-51.0,-47.0,-42.0,-48.0,-90.0,-91.0,-88.0,-90.0,38.0,43.0,46.0,41.0,1
1445,CC:2F:71:3F:1F:24,3982858,732402425,219958,257787468,3762900,474614957,27,185391,212567927,185309,212557705,82,10222,177383,6,219958,21501,24,145,130000.0,43333.0,-69.0,-65.0,-70.0,-67.0,-69.0,-65.0,-69.0,-67.0,-90.0,-91.0,-88.0,-90.0,21.0,26.0,18.0,23.0,1
1446,CC:2F:71:3E:C5:1F,3762993,474626199,93,11242,3762900,474614957,0,368,31442,297,22878,71,8564,99,2,124,4,0,5,130000.0,39000.0,-70.0,-71.0,-68.0,-60.0,-70.0,-70.0,-66.0,-60.0,-90.0,-91.0,-88.0,-90.0,20.0,20.0,20.0,30.0,1
1447,BA:8C:B9:54:50:24,3763173,474698280,273,83323,3762900,474614957,0,1193,132889,1175,130043,18,2846,178,4,385,6,0,8,229410.0,130000.0,-49.0,-35.0,-43.0,-45.0,-46.0,-35.0,-43.0,-46.0,-90.0,-91.0,-88.0,-90.0,41.0,56.0,45.0,45.0,1
1448,92:69:1D:31:68:E9,3775719,489877886,12819,15262929,3762900,474614957,3,19321,3594056,18623,3433494,698,160562,6473,105,14078,252,3,252,216660.0,130000.0,-52.0,-48.0,-42.0,-49.0,-51.0,-47.0,-42.0,-48.0,-90.0,-91.0,-88.0,-90.0,38.0,43.0,46.0,41.0,1
1449,CC:2F:71:3F:1F:24,3982968,732520881,220064,257905520,3762904,474615361,27,185485,212684197,185403,212673975,82,10222,177472,6,220064,21513,24,145,130000.0,43333.0,-69.0,-66.0,-69.0,-67.0,-69.0,-66.0,-69.0,-67.0,-90.0,-91.0,-88.0,-90.0,21.0,25.0,19.0,23.0,1
1450,CC:2F:71:3E:C5:1F,3762997,474626603,93,11242,3762904,474615361,0,368,31442,297,22878,71,8564,99,2,124,4,0,5,130000.0,39000.0,-70.0,-71.0,-68.0,-60.0,-70.0,-70.0,-66.0,-60.0,-90.0,-91.0,-88.0,-90.0,20.0,20.0,20.0,30.0,1
1451,BA:8C:B9:54:50:24,3763179,474698886,273,83323,3762906,474615563,0,1193,132889,1175,130043,18,2846,178,4,385,6,0,8,229410.0,130000.0,-49.0,-35.0,-43.0,-45.0,-46.0,-35.0,-43.0,-46.0,-90.0,-91.0,-88.0,-90.0,41.0,56.0,45.0,45.0,1
1452,92:69:1D:31:68:E9,3775725,489878492,12819,15262929,3762906,474615563,3,19321,3594056,18623,3433494,698,160562,6473,105,14078,252,3,252,216660.0,130000.0,-52.0,-48.0,-42.0,-49.0,-51.0,-47.0,-42.0,-48.0,-90.0,-91.0,-88.0,-90.0,38.0,43.0,46.0,41.0,1
1453,CC:2F:71:3F:1F:24,3983086,732644180,220177,258028355,3762909,474615825,27,185597,212810530,185515,212800308,82,10222,177569,6,220177,21536,24,145,130000.0,39000.0,-68.0,-66.0,-71.0,-68.0,-68.0,-66.0,-70.0,-67.0,-90.0,-91.0,-88.0,-90.0,22.0,25.0,17.0,22.0,1
1454,CC:2F:71:3E:C5:1F,3763002,474627067,93,11242,3762909,474615825,0,368,31442,297,22878,71,8564,99,2,124,4,0,5,130000.0,39000.0,-70.0,-71.0,-68.0,-60.0,-70.0,-70.0,-66.0,-60.0,-90.0,-91.0,-88.0,-90.0,20.0,20.0,20.0,30.0,1
1455,BA:8C:B9:54:50:24,3763182,474699148,273,83323,3762909,474615825,0,1193,132889,1175,130043,18,2846,178,4,385,6,0,8,229410.0,130000.0,-49.0,-35.0,-43.0,-45.0,-46.0,-35.0,-43.0,-46.0,-90.0,-91.0,-88.0,-90.0,41.0,56.0,45.0,45.0,1
1456,92:69:1D:31:68:E9,3775728,489878754,12819,15262929,3762909,474615825,3,19321,3594056,18623,3433494,698,160562,6473,105,14078,252,3,252,216660.0,130000.0,-52.0,-48.0,-42.0,-49.0,-51.0,-47.0,-42.0,-48.0,-90.0,-91.0,-88.0,-90.0,38.0,43.0,46.0,41.0,1
1457,CC:2F:71:3F:1F:24,3983195,732762618,220282,258146389,3762913,474616229,27,185695,212931716,185613,212921494,82,10222,177656,6,220282,21541,24,145,130000.0,43333.0,-68.0,-66.0,-71.0,-68.0,-68.0,-66.0,-70.0,-68.0,-90.0,-91.0,-88.0,-90.0,22.0,25.0,17.0,22.0,1
1458,CC:2F:71:3E:C5:1F,3763018,474633070,93,11242,3762925,474621828,0,368,31442,297,22878,71,8564,99,2,124,4,0,5,130000.0,39000.0,-70.0,-71.0,-68.0,-60.0,-70.0,-70.0,-66.0,-60.0,-90.0,-91.0,-88.0,-90.0,20.0,20.0,20.0,30.0,1
1459,BA:8C:B9:54:50:24,3763200,474705347,273,83323,3762927,474622024,0,1193,132889,1175,130043,18,2846,178,4,385,6,0,8,229410.0,130000.0,-49.0,-35.0,-43.0,-45.0,-46.0,-35.0,-43.0,-46.0,-90.0,-91.0,-88.0,-90.0,41.0,56.0,45.0,45.0,1
1460,92:69:1D:31:68:E9,3775747,489885021,12819,15262929,3762928,474622092,3,19325,3594495,18626,3433698,699,160797,6474,105,14078,252,3,252,216660.0,130000.0,-51.0,-48.0,-42.0,-49.0,-51.0,-48.0,-42.0,-48.0,-90.0,-91.0,-88.0,-90.0,39.0,43.0,46.0,41.0,1
1461,CC:2F:71:3F:1F:24,3983334,732899929,220393,258272211,3762941,474627718,27,185796,213057432,185714,213047210,82,10222,177749,6,220393,21546,24,145,130000.0,43333.0,-68.0,-67.0,-71.0,-67.0,-68.0,-66.0,-71.0,-67.0,-90.0,-91.0,-88.0,-90.0,22.0,24.0,17.0,23.0,1
1462,CC:2F:71:3E:C5:1F,3763034,474638960,93,11242,3762941,474627718,0,370,31630,298,22948,72,8682,100,2,124,4,0,5,130000.0,39000.0,-70.0,-71.0,-67.0,-60.0,-70.0,-70.0,-66.0,-60.0,-90.0,-91.0,-88.0,-90.0,20.0,20.0,21.0,30.0,1
1463,BA:8C:B9:54:50:24,3763214,474711041,273,83323,3762941,474627718,0,1193,132889,1175,130043,18,2846,178,4,385,6,0,8,229410.0,130000.0,-49.0,-35.0,-43.0,-45.0,-46.0,-35.0,-43.0,-46.0,-90.0,-91.0,-88.0,-90.0,41.0,56.0,45.0,45.0,1
1464,92:69:1D:31:68:E9,3775760,489890647,12819,15262929,3762941,474627718,3,19325,3594495,18626,3433698,699,160797,6474,105,14078,252,3,252,216660.0,130000.0,-51.0,-48.0,-42.0,-49.0,-51.0,-48.0,-42.0,-48.0,-90.0,-91.0,-88.0,-90.0,39.0,43.0,46.0,41.0,1
1465,CC:2F:71:3F:1F:24,3983444,733018705,220498,258390357,3762946,474628348,27,185887,213167692,185805,213157470,82,10222,177836,6,220498,21546,24,145,130000.0,43333.0,-68.0,-67.0,-71.0,-67.0,-68.0,-66.0,-71.0,-67.0,-90.0,-91.0,-88.0,-90.0,22.0,24.0,17.0,23.0,1
1466,CC:2F:71:3E:C5:1F,3763039,474639590,93,11242,3762946,474628348,0,370,31630,298,22948,72,8682,100,2,124,4,0,5,130000.0,39000.0,-70.0,-71.0,-67.0,-60.0,-70.0,-70.0,-66.0,-60.0,-90.0,-91.0,-88.0,-90.0,20.0,20.0,21.0,30.0,1
1467,BA:8C:B9:54:50:24,3763221,474711873,273,83323,3762948,474628550,0,1195,133025,1177,130179,18,2846,178,4,386,6,0,8,229410.0,130000.0,-40.0,-37.0,-45.0,-51.0,-45.0,-35.0,-43.0,-47.0,-90.0,-91.0,-88.0,-90.0,50.0,54.0,43.0,39.0,1
1468,92:69:1D:31:68:E9,3775769,489891681,12819,15262929,3762950,474628752,3,19325,3594495,18626,3433698,699,160797,6474,105,14078,252,3,252,216660.0,130000.0,-51.0,-48.0,-42.0,-49.0,-51.0,-48.0,-42.0,-48.0,-90.0,-91.0,-88.0,-90.0,39.0,43.0,46.0,41.0,1
1469,CC:2F:71:3F:1F:24,3983563,733141002,220611,258512048,3762952,474628954,27,185998,213291889,185916,213281667,82,10222,177935,6,220611,21552,24,145,117000.0,39000.0,-68.0,-67.0,-71.0,-67.0,-68.0,-66.0,-70.0,-67.0,-90.0,-91.0,-88.0,-89.0,22.0,24.0,17.0,22.0,1
1470,CC:2F:71:3E:C5:1F,3763045,474640196,93,11242,3762952,474628954,0,370,31630,298,22948,72,8682,100,2,124,4,0,5,130000.0,39000.0,-70.0,-71.0,-67.0,-60.0,-70.0,-70.0,-66.0,-60.0,-90.0,-91.0,-88.0,-89.0,20.0,20.0,21.0,29.0,1
1471,BA:8C:B9:54:50:24,3763225,474712277,273,83323,3762952,474628954,0,1195,133025,1177,130179,18,2846,178,4,386,6,0,8,229410.0,130000.0,-40.0,-37.0,-45.0,-51.0,-45.0,-35.0,-43.0,-47.0,-90.0,-91.0,-88.0,-89.0,50.0,54.0,43.0,38.0,1
1472,92:69:1D:31:68:E9,3775771,489891883,12819,15262929,3762952,474628954,3,19325,3594495,18626,3433698,699,160797,6474,105,14078,252,3,252,216660.0,130000.0,-51.0,-48.0,-42.0,-49.0,-51.0,-48.0,-42.0,-48.0,-90.0,-91.0,-88.0,-89.0,39.0,43.0,46.0,40.0,1
1473,CC:2F:71:3F:1F:24,3983672,733260796,220717,258631580,3762955,474629216,27,186090,213405113,186008,213394891,82,10222,178023,6,220717,21552,24,145,130000.0,43333.0,-68.0,-66.0,-71.0,-67.0,-68.0,-66.0,-70.0,-67.0,-90.0,-91.0,-88.0,-89.0,22.0,25.0,17.0,22.0,1
1474,CC:2F:71:3E:C5:1F,3763048,474640458,93,11242,3762955,474629216,0,370,31630,298,22948,72,8682,100,2,124,4,0,5,130000.0,39000.0,-70.0,-71.0,-67.0,-60.0,-70.0,-70.0,-66.0,-60.0,-90.0,-91.0,-88.0,-89.0,20.0,20.0,21.0,29.0,1
1475,BA:8C:B9:54:50:24,3763230,474712741,273,83323,3762957,474629418,0,1195,133025,1177,130179,18,2846,178,4,386,6,0,8,229410.0,130000.0,-40.0,-37.0,-45.0,-51.0,-45.0,-35.0,-43.0,-47.0,-90.0,-91.0,-88.0,-89.0,50.0,54.0,43.0,38.0,1
1476,92:69:1D:31:68:E9,3775776,489892347,12819,15262929,3762957,474629418,3,19325,3594495,18626,3433698,699,160797,6474,105,14078,252,3,252,216660.0,130000.0,-51.0,-48.0,-42.0,-49.0,-51.0,-48.0,-42.0,-48.0,-90.0,-91.0,-88.0,-89.0,39.0,43.0,46.0,40.0,1
1477,CC:2F:71:3F:1F:24,3983783,733379548,220822,258749726,3762961,474629822,27,186185,213523107,186103,213512885,82,10222,178109,6,220822,21552,24,145,130000.0,43333.0,-68.0,-66.0,-71.0,-67.0,-68.0,-66.0,-71.0,-67.0,-90.0,-91.0,-88.0,-89.0,22.0,25.0,17.0,22.0,1
1478,CC:2F:71:3E:C5:1F,3763054,474641064,93,11242,3762961,474629822,0,370,31630,298,22948,72,8682,100,2,124,4,0,5,130000.0,39000.0,-70.0,-71.0,-67.0,-60.0,-70.0,-70.0,-66.0,-60.0,-90.0,-91.0,-88.0,-89.0,20.0,20.0,21.0,29.0,1
1479,BA:8C:B9:54:50:24,3763234,474713145,273,83323,3762961,474629822,0,1195,133025,1177,130179,18,2846,178,4,386,6,0,8,229410.0,130000.0,-40.0,-37.0,-45.0,-51.0,-45.0,-35.0,-43.0,-47.0,-90.0,-91.0,-88.0,-89.0,50.0,54.0,43.0,38.0,1
1480,92:69:1D:31:68:E9,3775780,489892751,12819,15262929,3762961,474629822,3,19325,3594495,18626,3433698,699,160797,6474,105,14078,252,3,252,216660.0,130000.0,-51.0,-48.0,-42.0,-49.0,-51.0,-48.0,-42.0,-48.0,-90.0,-91.0,-88.0,-89.0,39.0,43.0,46.0,40.0,1
1481,CC:2F:71:3F:1F:24,3983890,733497728,220927,258867704,3762963,474630024,27,186275,213634613,186193,213624391,82,10222,178196,6,220926,21556,24,145,130000.0,39000.0,-69.0,-67.0,-71.0,-68.0,-69.0,-67.0,-71.0,-68.0,-90.0,-91.0,-88.0,-89.0,21.0,24.0,17.0,21.0,1
1482,CC:2F:71:3E:C5:1F,3763056,474641266,93,11242,3762963,474630024,0,370,31630,298,22948,72,8682,100,2,124,4,0,5,130000.0,39000.0,-70.0,-71.0,-67.0,-60.0,-70.0,-70.0,-66.0,-60.0,-90.0,-91.0,-88.0,-89.0,20.0,20.0,21.0,29.0,1
1483,BA:8C:B9:54:50:24,3763236,474713347,273,83323,3762963,474630024,0,1195,133025,1177,130179,18,2846,178,4,386,6,0,8,229410.0,130000.0,-40.0,-37.0,-45.0,-51.0,-45.0,-35.0,-43.0,-47.0,-90.0,-91.0,-88.0,-89.0,50.0,54.0,43.0,38.0,1
1484,92:69:1D:31:68:E9,3775782,489892953,12819,15262929,3762963,474630024,3,19325,3594495,18626,3433698,699,160797,6474,105,14078,252,3,252,216660.0,130000.0,-51.0,-48.0,-42.0,-49.0,-51.0,-48.0,-42.0,-48.0,-90.0,-91.0,-88.0,-89.0,39.0,43.0,46.0,40.0,1
1485,CC:2F:71:3F:1F:24,3984010,733620085,221040,258989395,3762970,474630690,27,186380,213754330,186298,213744108,82,10222,178292,6,221040,21557,24,145,130000.0,43333.0,-68.0,-67.0,-71.0,-68.0,-68.0,-67.0,-71.0,-68.0,-90.0,-91.0,-88.0,-89.0,22.0,24.0,17.0,21.0,1
1486,CC:2F:71:3E:C5:1F,3763063,474641932,93,11242,3762970,474630690,0,370,31630,298,22948,72,8682,100,2,124,4,0,5,130000.0,39000.0,-70.0,-71.0,-67.0,-60.0,-70.0,-70.0,-66.0,-60.0,-89.0,-91.0,-88.0,-89.0,19.0,20.0,21.0,29.0,1
1487,BA:8C:B9:54:50:24,3763243,474714013,273,83323,3762970,474630690,0,1195,133025,1177,130179,18,2846,178,4,386,6,0,8,229410.0,130000.0,-40.0,-37.0,-45.0,-51.0,-45.0,-35.0,-43.0,-47.0,-89.0,-91.0,-88.0,-89.0,49.0,54.0,43.0,38.0,1
1488,92:69:1D:31:68:E9,3775789,489893619,12819,15262929,3762970,474630690,3,19325,3594495,18626,3433698,699,160797,6474,105,14078,252,3,252,216660.0,130000.0,-51.0,-48.0,-42.0,-49.0,-51.0,-48.0,-42.0,-48.0,-89.0,-91.0,-88.0,-89.0,38.0,43.0,46.0,40.0,1
1489,CC:2F:71:3F:1F:24,3984117,733738433,221145,259107541,3762972,474630892,27,186474,213869238,186392,213859016,82,10222,178380,6,221145,21557,24,145,130000.0,43333.0,-68.0,-67.0,-71.0,-67.0,-68.0,-66.0,-70.0,-67.0,-89.0,-91.0,-88.0,-89.0,21.0,24.0,17.0,22.0,1
1490,CC:2F:71:3E:C5:1F,3763065,474642134,93,11242,3762972,474630892,0,370,31630,298,22948,72,8682,100,2,124,4,0,5,130000.0,39000.0,-70.0,-71.0,-67.0,-60.0,-70.0,-70.0,-66.0,-60.0,-89.0,-91.0,-88.0,-89.0,19.0,20.0,21.0,29.0,1
1491,BA:8C:B9:54:50:24,3763245,474714215,273,83323,3762972,474630892,0,1195,133025,1177,130179,18,2846,178,4,386,6,0,8,229410.0,130000.0,-40.0,-37.0,-45.0,-51.0,-45.0,-35.0,-43.0,-47.0,-89.0,-91.0,-88.0,-89.0,49.0,54.0,43.0,38.0,1
1492,92:69:1D:31:68:E9,3775792,489894094,12819,15262929,3762973,474631165,3,19325,3594495,18626,3433698,699,160797,6474,105,14078,252,3,252,216660.0,130000.0,-51.0,-48.0,-42.0,-49.0,-51.0,-48.0,-42.0,-48.0,-89.0,-91.0,-88.0,-89.0,38.0,43.0,46.0,40.0,1
1493,CC:2F:71:3F:1F:24,3984229,733857234,221250,259225463,3762979,474631771,27,186566,213979790,186484,213969568,82,10222,178468,6,221250,21562,24,145,130000.0,43333.0,-68.0,-67.0,-71.0,-68.0,-68.0,-66.0,-71.0,-67.0,-89.0,-91.0,-88.0,-89.0,21.0,24.0,17.0,21.0,1
1494,CC:2F:71:3E:C5:1F,3763072,474643013,93,11242,3762979,474631771,0,370,31630,298,22948,72,8682,100,2,124,4,0,5,130000.0,39000.0,-70.0,-71.0,-67.0,-60.0,-70.0,-70.0,-66.0,-60.0,-89.0,-91.0,-88.0,-89.0,19.0,20.0,21.0,29.0,1
1495,BA:8C:B9:54:50:24,3763252,474715094,273,83323,3762979,474631771,0,1195,133025,1177,130179,18,2846,178,4,386,6,0,8,229410.0,130000.0,-40.0,-37.0,-45.0,-51.0,-45.0,-35.0,-43.0,-47.0,-89.0,-91.0,-88.0,-89.0,49.0,54.0,43.0,38.0,1
1496,92:69:1D:31:68:E9,3775798,489894700,12819,15262929,3762979,474631771,3,19325,3594495,18626,3433698,699,160797,6474,105,14078,252,3,252,216660.0,130000.0,-51.0,-48.0,-42.0,-49.0,-51.0,-48.0,-42.0,-48.0,-89.0,-91.0,-88.0,-89.0,38.0,43.0,46.0,40.0,1
1497,CC:2F:71:3F:1F:24,3984337,733975642,221355,259343609,3762982,474632033,27,186659,214090392,186577,214080170,82,10222,178556,6,221355,21562,24,145,130000.0,43333.0,-68.0,-66.0,-71.0,-68.0,-68.0,-66.0,-71.0,-68.0,-89.0,-91.0,-88.0,-89.0,21.0,25.0,17.0,21.0,1
1498,CC:2F:71:3E:C5:1F,3763075,474643275,93,11242,3762982,474632033,0,370,31630,298,22948,72,8682,100,2,124,4,0,5,130000.0,39000.0,-70.0,-71.0,-67.0,-60.0,-70.0,-70.0,-66.0,-60.0,-89.0,-91.0,-88.0,-89.0,19.0,20.0,21.0,29.0,1
1499,BA:8C:B9:54:50:24,3763255,474715356,273,83323,3762982,474632033,0,1195,133025,1177,130179,18,2846,178,4,386,6,0,8,229410.0,130000.0,-40.0,-37.0,-45.0,-51.0,-45.0,-35.0,-43.0,-47.0,-89.0,-91.0,-88.0,-89.0,49.0,54.0,43.0,38.0,1
1500,92:69:1D:31:68:E9,3775801,489894962,12819,15262929,3762982,474632033,3,19325,3594495,18626,3433698,699,160797,6474,105,14078,252,3,252,216660.0,130000.0,-51.0,-48.0,-42.0,-49.0,-51.0,-48.0,-42.0,-48.0,-89.0,-91.0,-88.0,-89.0,38.0,43.0,46.0,40.0,1
1501,CC:2F:71:3F:1F:24,3984455,734098657,221467,259466018,3762988,474632639,27,186760,214205341,186678,214195119,82,10222,178650,6,221467,21562,24,145,130000.0,43333.0,-68.0,-67.0,-71.0,-68.0,-68.0,-67.0,-71.0,-68.0,-89.0,-91.0,-88.0,-89.0,21.0,24.0,17.0,21.0,1
1502,CC:2F:71:3E:C5:1F,3763081,474643881,93,11242,3762988,474632639,0,370,31630,298,22948,72,8682,100,2,124,4,0,5,130000.0,39000.0,-70.0,-71.0,-67.0,-60.0,-70.0,-70.0,-66.0,-60.0,-89.0,-90.0,-87.0,-89.0,19.0,19.0,20.0,29.0,1
1503,BA:8C:B9:54:50:24,3763261,474715962,273,83323,3762988,474632639,0,1195,133025,1177,130179,18,2846,178,4,386,6,0,8,229410.0,130000.0,-40.0,-37.0,-45.0,-51.0,-45.0,-35.0,-43.0,-47.0,-89.0,-90.0,-87.0,-89.0,49.0,53.0,42.0,38.0,1
1504,92:69:1D:31:68:E9,3775807,489895568,12819,15262929,3762988,474632639,3,19325,3594495,18626,3433698,699,160797,6474,105,14078,252,3,252,216660.0,130000.0,-51.0,-48.0,-42.0,-49.0,-51.0,-48.0,-42.0,-48.0,-89.0,-90.0,-87.0,-89.0,38.0,42.0,45.0,40.0,1
1505,CC:2F:71:3F:1F:24,3984562,734216781,221572,259583940,3762990,474632841,27,186855,214320507,186773,214310285,82,10222,178738,6,221572,21569,24,145,130000.0,43333.0,-68.0,-67.0,-71.0,-68.0,-68.0,-66.0,-71.0,-68.0,-89.0,-90.0,-87.0,-89.0,21.0,23.0,16.0,21.0,1
1506,CC:2F:71:3E:C5:1F,3763083,474644083,93,11242,3762990,474632841,0,370,31630,298,22948,72,8682,100,2,124,4,0,5,130000.0,39000.0,-70.0,-71.0,-67.0,-60.0,-70.0,-70.0,-66.0,-60.0,-89.0,-90.0,-87.0,-89.0,19.0,19.0,20.0,29.0,1
1507,BA:8C:B9:54:50:24,3763264,474716224,273,83323,3762991,474632901,0,1195,133025,1177,130179,18,2846,178,4,386,6,0,8,229410.0,130000.0,-40.0,-37.0,-45.0,-51.0,-45.0,-35.0,-43.0,-47.0,-89.0,-90.0,-87.0,-89.0,49.0,53.0,42.0,38.0,1
1508,92:69:1D:31:68:E9,3775810,489895830,12819,15262929,3762991,474632901,3,19325,3594495,18626,3433698,699,160797,6474,105,14078,252,3,252,216660.0,130000.0,-51.0,-48.0,-42.0,-49.0,-51.0,-48.0,-42.0,-48.0,-89.0,-90.0,-87.0,-89.0,38.0,42.0,45.0,40.0,1
1509,CC:2F:71:3F:1F:24,3984674,734335593,221677,259702086,3762997,474633507,27,186949,214435525,186867,214425303,82,10222,178825,6,221677,21569,24,145,130000.0,43333.0,-68.0,-66.0,-71.0,-68.0,-67.0,-66.0,-70.0,-68.0,-89.0,-90.0,-87.0,-89.0,21.0,24.0,16.0,21.0,1
1510,CC:2F:71:3E:C5:1F,3763090,474644749,93,11242,3762997,474633507,0,370,31630,298,22948,72,8682,100,2,124,4,0,5,130000.0,39000.0,-70.0,-71.0,-67.0,-60.0,-70.0,-70.0,-66.0,-60.0,-89.0,-90.0,-87.0,-89.0,19.0,19.0,20.0,29.0,1
1511,BA:8C:B9:54:50:24,3763270,474716830,273,83323,3762997,474633507,0,1195,133025,1177,130179,18,2846,178,4,386,6,0,8,229410.0,130000.0,-40.0,-37.0,-45.0,-51.0,-45.0,-35.0,-43.0,-47.0,-89.0,-90.0,-87.0,-89.0,49.0,53.0,42.0,38.0,1
1512,92:69:1D:31:68:E9,3775816,489896436,12819,15262929,3762997,474633507,3,19325,3594495,18626,3433698,699,160797,6474,105,14078,252,3,252,216660.0,130000.0,-51.0,-48.0,-42.0,-49.0,-51.0,-48.0,-42.0,-48.0,-89.0,-90.0,-87.0,-89.0,38.0,42.0,45.0,40.0,1
1513,CC:2F:71:3F:1F:24,3984779,734453571,221782,259820064,3762997,474633507,27,187039,214545593,186957,214535371,82,10222,178913,6,221782,21573,24,145,130000.0,39000.0,-68.0,-66.0,-71.0,-67.0,-67.0,-66.0,-70.0,-67.0,-89.0,-90.0,-87.0,-89.0,21.0,24.0,16.0,22.0,1
1514,CC:2F:71:3E:C5:1F,3763090,474644749,93,11242,3762997,474633507,0,370,31630,298,22948,72,8682,100,2,124,4,0,5,130000.0,39000.0,-70.0,-71.0,-67.0,-60.0,-70.0,-70.0,-66.0,-60.0,-89.0,-90.0,-87.0,-89.0,19.0,19.0,20.0,29.0,1
1515,BA:8C:B9:54:50:24,3763272,474717032,273,83323,3762999,474633709,0,1195,133025,1177,130179,18,2846,178,4,386,6,0,8,229410.0,130000.0,-40.0,-37.0,-45.0,-51.0,-45.0,-35.0,-43.0,-47.0,-89.0,-90.0,-87.0,-89.0,49.0,53.0,42.0,38.0,1
1516,92:69:1D:31:68:E9,3775818,489896638,12819,15262929,3762999,474633709,3,19325,3594495,18626,3433698,699,160797,6474,105,14078,252,3,252,216660.0,130000.0,-51.0,-48.0,-42.0,-49.0,-51.0,-48.0,-42.0,-48.0,-89.0,-90.0,-87.0,-89.0,38.0,42.0,45.0,40.0,1
1517,CC:2F:71:3F:1F:24,3984901,734577554,221895,259943179,3763006,474634375,27,187135,214656848,187053,214646626,82,10222,179007,6,221895,21573,24,145,130000.0,43333.0,-68.0,-66.0,-71.0,-67.0,-68.0,-66.0,-70.0,-67.0,-89.0,-90.0,-87.0,-89.0,21.0,24.0,16.0,22.0,1
1518,CC:2F:71:3E:C5:1F,3763099,474645617,93,11242,3763006,474634375,0,370,31630,298,22948,72,8682,100,2,124,4,0,5,130000.0,39000.0,-70.0,-71.0,-67.0,-60.0,-70.0,-70.0,-66.0,-60.0,-89.0,-90.0,-87.0,-89.0,19.0,19.0,20.0,29.0,1
1519,BA:8C:B9:54:50:24,3763279,474717698,273,83323,3763006,474634375,0,1195,133025,1177,130179,18,2846,178,4,386,6,0,8,229410.0,130000.0,-40.0,-37.0,-45.0,-51.0,-45.0,-35.0,-43.0,-47.0,-89.0,-90.0,-87.0,-89.0,49.0,53.0,42.0,38.0,1
1520,92:69:1D:31:68:E9,3775825,489897304,12819,15262929,3763006,474634375,3,19325,3594495,18626,3433698,699,160797,6474,105,14078,252,3,252,216660.0,130000.0,-51.0,-48.0,-42.0,-49.0,-51.0,-48.0,-42.0,-48.0,-89.0,-90.0,-87.0,-89.0,38.0,42.0,45.0,40.0,1
1521,CC:2F:71:3F:1F:24,3985007,734695816,222001,260061441,3763006,474634375,27,187229,214771852,187147,214761630,82,10222,179095,6,222001,21573,24,145,130000.0,43333.0,-68.0,-66.0,-71.0,-68.0,-68.0,-66.0,-71.0,-68.0,-89.0,-90.0,-87.0,-89.0,21.0,24.0,16.0,21.0,1
1522,CC:2F:71:3E:C5:1F,3763104,474646450,98,12075,3763006,474634375,0,378,32585,306,23903,72,8682,105,2,129,4,0,5,130000.0,39000.0,-70.0,-70.0,-66.0,-60.0,-70.0,-70.0,-66.0,-60.0,-89.0,-90.0,-87.0,-89.0,19.0,20.0,21.0,29.0,1
1523,BA:8C:B9:54:50:24,3763280,474717814,274,83439,3763006,474634375,0,1197,133161,1179,130315,18,2846,178,4,387,6,0,8,229410.0,137640.0,-40.0,-37.0,-46.0,-51.0,-43.0,-36.0,-44.0,-48.0,-89.0,-90.0,-87.0,-89.0,49.0,53.0,41.0,38.0,1
1524,92:69:1D:31:68:E9,3775826,489897364,12820,15262989,3763006,474634375,3,19327,3594631,18628,3433834,699,160797,6474,105,14079,252,3,252,216660.0,130000.0,-51.0,-48.0,-43.0,-49.0,-51.0,-48.0,-43.0,-48.0,-89.0,-90.0,-87.0,-89.0,38.0,42.0,44.0,40.0,1
1525,CC:2F:71:3F:1F:24,3985120,734814546,222106,260179363,3763014,474635183,27,187319,214881934,187237,214871712,82,10222,179182,6,222106,21578,24,145,130000.0,43333.0,-68.0,-66.0,-70.0,-69.0,-67.0,-66.0,-70.0,-68.0,-89.0,-90.0,-87.0,-89.0,21.0,24.0,17.0,20.0,1
1526,CC:2F:71:3E:C5:1F,3763112,474647258,98,12075,3763014,474635183,0,378,32585,306,23903,72,8682,105,2,129,4,0,5,130000.0,39000.0,-70.0,-70.0,-66.0,-60.0,-70.0,-70.0,-66.0,-60.0,-89.0,-90.0,-87.0,-89.0,19.0,20.0,21.0,29.0,1
1527,BA:8C:B9:54:50:24,3763288,474718622,274,83439,3763014,474635183,0,1197,133161,1179,130315,18,2846,178,4,387,6,0,8,229410.0,137640.0,-40.0,-37.0,-46.0,-51.0,-43.0,-36.0,-44.0,-48.0,-89.0,-90.0,-87.0,-89.0,49.0,53.0,41.0,38.0,1
1528,92:69:1D:31:68:E9,3775834,489898172,12820,15262989,3763014,474635183,3,19327,3594631,18628,3433834,699,160797,6474,105,14079,252,3,252,216660.0,130000.0,-51.0,-48.0,-43.0,-49.0,-51.0,-48.0,-43.0,-48.0,-89.0,-90.0,-87.0,-89.0,38.0,42.0,44.0,40.0,1
1529,CC:2F:71:3F:1F:24,3985226,734932528,222211,260297285,3763015,474635243,27,187411,214993672,187329,214983450,82,10222,179271,6,222210,21582,24,145,130000.0,43333.0,-68.0,-66.0,-71.0,-68.0,-67.0,-66.0,-71.0,-67.0,-89.0,-90.0,-87.0,-89.0,21.0,24.0,16.0,21.0,1
1530,CC:2F:71:3E:C5:1F,3763113,474647318,98,12075,3763015,474635243,0,378,32585,306,23903,72,8682,105,2,129,4,0,5,130000.0,39000.0,-70.0,-70.0,-66.0,-60.0,-70.0,-70.0,-66.0,-60.0,-89.0,-90.0,-87.0,-89.0,19.0,20.0,21.0,29.0,1
1531,BA:8C:B9:54:50:24,3763289,474718682,274,83439,3763015,474635243,0,1198,133229,1180,130383,18,2846,178,4,387,6,0,8,229410.0,137640.0,-40.0,-37.0,-45.0,-50.0,-42.0,-36.0,-44.0,-49.0,-89.0,-90.0,-87.0,-89.0,49.0,53.0,42.0,39.0,1
1532,92:69:1D:31:68:E9,3775835,489898232,12820,15262989,3763015,474635243,3,19327,3594631,18628,3433834,699,160797,6474,105,14079,252,3,252,216660.0,130000.0,-51.0,-48.0,-43.0,-49.0,-51.0,-48.0,-43.0,-48.0,-89.0,-90.0,-87.0,-89.0,38.0,42.0,44.0,40.0,1
1533,CC:2F:71:3F:1F:24,3985347,735055059,222325,260419148,3763022,474635911,27,187520,215116491,187438,215106269,82,10222,179371,6,222325,21583,24,145,130000.0,43333.0,-67.0,-66.0,-71.0,-68.0,-66.0,-66.0,-70.0,-68.0,-89.0,-90.0,-87.0,-89.0,22.0,24.0,16.0,21.0,1
1534,CC:2F:71:3E:C5:1F,3763122,474648188,98,12075,3763024,474636113,0,380,32773,307,23973,73,8800,106,2,129,4,0,5,130000.0,39000.0,-70.0,-71.0,-66.0,-60.0,-70.0,-70.0,-66.0,-60.0,-89.0,-90.0,-87.0,-89.0,19.0,19.0,21.0,29.0,1
1535,BA:8C:B9:54:50:24,3763298,474719552,274,83439,3763024,474636113,0,1198,133229,1180,130383,18,2846,178,4,387,6,0,8,229410.0,137640.0,-40.0,-37.0,-45.0,-50.0,-42.0,-36.0,-44.0,-49.0,-89.0,-90.0,-87.0,-89.0,49.0,53.0,42.0,39.0,1
1536,92:69:1D:31:68:E9,3775844,489899102,12820,15262989,3763024,474636113,3,19327,3594631,18628,3433834,699,160797,6474,105,14079,252,3,252,216660.0,130000.0,-51.0,-48.0,-43.0,-49.0,-51.0,-48.0,-43.0,-48.0,-89.0,-90.0,-87.0,-89.0,38.0,42.0,44.0,40.0,1
1537,CC:2F:71:3F:1F:24,3985455,735174737,222431,260538624,3763024,474636113,27,187616,215235883,187534,215225661,82,10222,179459,6,222431,21589,24,145,130000.0,43333.0,-67.0,-66.0,-71.0,-68.0,-67.0,-66.0,-71.0,-68.0,-89.0,-90.0,-87.0,-89.0,22.0,24.0,16.0,21.0,1
1538,CC:2F:71:3E:C5:1F,3763122,474648188,98,12075,3763024,474636113,0,380,32773,307,23973,73,8800,106,2,129,4,0,5,130000.0,39000.0,-70.0,-71.0,-66.0,-60.0,-70.0,-70.0,-66.0,-60.0,-89.0,-90.0,-87.0,-89.0,19.0,19.0,21.0,29.0,1
1539,BA:8C:B9:54:50:24,3763298,474719552,274,83439,3763024,474636113,0,1198,133229,1180,130383,18,2846,178,4,387,6,0,8,229410.0,137640.0,-40.0,-37.0,-45.0,-50.0,-42.0,-36.0,-44.0,-49.0,-89.0,-90.0,-87.0,-89.0,49.0,53.0,42.0,39.0,1
1540,92:69:1D:31:68:E9,3775845,489899162,12820,15262989,3763025,474636173,3,19327,3594631,18628,3433834,699,160797,6474,105,14079,252,3,252,216660.0,130000.0,-51.0,-48.0,-43.0,-49.0,-51.0,-48.0,-43.0,-48.0,-89.0,-90.0,-87.0,-89.0,38.0,42.0,44.0,40.0,1
1541,CC:2F:71:3F:1F:24,3985567,735293549,222536,260656770,3763031,474636779,27,187713,215352653,187631,215342431,82,10222,179547,6,222536,21590,24,145,130000.0,43333.0,-67.0,-66.0,-71.0,-69.0,-67.0,-66.0,-71.0,-68.0,-89.0,-90.0,-87.0,-89.0,22.0,24.0,16.0,20.0,1
1542,CC:2F:71:3E:C5:1F,3763131,474649056,98,12075,3763033,474636981,0,380,32773,307,23973,73,8800,106,2,129,4,0,5,130000.0,39000.0,-70.0,-71.0,-66.0,-60.0,-70.0,-70.0,-66.0,-60.0,-89.0,-90.0,-87.0,-89.0,19.0,19.0,21.0,29.0,1
1543,BA:8C:B9:54:50:24,3763307,474720420,274,83439,3763033,474636981,0,1198,133229,1180,130383,18,2846,178,4,387,6,0,8,229410.0,137640.0,-40.0,-37.0,-45.0,-50.0,-42.0,-36.0,-44.0,-49.0,-89.0,-90.0,-87.0,-89.0,49.0,53.0,42.0,39.0,1
1544,92:69:1D:31:68:E9,3775853,489899970,12820,15262989,3763033,474636981,3,19327,3594631,18628,3433834,699,160797,6474,105,14079,252,3,252,216660.0,130000.0,-51.0,-48.0,-43.0,-49.0,-51.0,-48.0,-43.0,-48.0,-89.0,-90.0,-87.0,-89.0,38.0,42.0,44.0,40.0,1
1545,CC:2F:71:3F:1F:24,3985675,735413426,222641,260776172,3763034,474637254,27,187810,215472147,187728,215461925,82,10222,179637,6,222641,21601,24,145,130000.0,39000.0,-67.0,-66.0,-71.0,-69.0,-67.0,-66.0,-71.0,-69.0,-89.0,-90.0,-87.0,-89.0,22.0,24.0,16.0,20.0,1
1546,CC:2F:71:3E:C5:1F,3763132,474649329,98,12075,3763034,474637254,0,380,32773,307,23973,73,8800,106,2,129,4,0,5,130000.0,39000.0,-70.0,-71.0,-66.0,-60.0,-70.0,-70.0,-66.0,-60.0,-89.0,-90.0,-87.0,-89.0,19.0,19.0,21.0,29.0,1
1547,BA:8C:B9:54:50:24,3763308,474720693,274,83439,3763034,474637254,0,1198,133229,1180,130383,18,2846,178,4,387,6,0,8,229410.0,137640.0,-40.0,-37.0,-45.0,-50.0,-42.0,-36.0,-44.0,-49.0,-89.0,-90.0,-87.0,-89.0,49.0,53.0,42.0,39.0,1
1548,92:69:1D:31:68:E9,3775854,489900243,12820,15262989,3763034,474637254,3,19327,3594631,18628,3433834,699,160797,6474,105,14079,252,3,252,216660.0,130000.0,-51.0,-48.0,-43.0,-49.0,-51.0,-48.0,-43.0,-48.0,-89.0,-90.0,-87.0,-89.0,38.0,42.0,44.0,40.0,1
1549,CC:2F:71:3F:1F:24,3985789,735532450,222748,260894530,3763041,474637920,27,187910,215589885,187828,215579663,82,10222,179728,6,222748,21602,24,145,130000.0,43333.0,-67.0,-67.0,-72.0,-68.0,-67.0,-66.0,-71.0,-68.0,-89.0,-90.0,-87.0,-89.0,22.0,23.0,15.0,21.0,1
1550,CC:2F:71:3E:C5:1F,3763142,474650313,99,12191,3763043,474638122,0,382,32949,309,24149,73,8800,107,2,130,4,0,5,130000.0,39000.0,-70.0,-70.0,-66.0,-60.0,-70.0,-70.0,-66.0,-60.0,-89.0,-90.0,-87.0,-89.0,19.0,20.0,21.0,29.0,1
1551,BA:8C:B9:54:50:24,3763317,474721561,274,83439,3763043,474638122,0,1198,133229,1180,130383,18,2846,178,4,387,6,0,8,229410.0,137640.0,-40.0,-37.0,-45.0,-50.0,-42.0,-36.0,-44.0,-49.0,-89.0,-90.0,-87.0,-89.0,49.0,53.0,42.0,39.0,1
1552,92:69:1D:31:68:E9,3775863,489901111,12820,15262989,3763043,474638122,3,19327,3594631,18628,3433834,699,160797,6474,105,14079,252,3,252,216660.0,130000.0,-51.0,-48.0,-43.0,-49.0,-51.0,-48.0,-43.0,-48.0,-89.0,-90.0,-87.0,-89.0,38.0,42.0,44.0,40.0,1
1553,CC:2F:71:3F:1F:24,3985901,735655201,222858,261017079,3763043,474638122,27,188008,215705323,187926,215695101,82,10222,179821,6,222858,21619,24,145,130000.0,43333.0,-67.0,-67.0,-71.0,-69.0,-67.0,-66.0,-71.0,-69.0,-89.0,-90.0,-87.0,-89.0,22.0,23.0,16.0,20.0,1
1554,CC:2F:71:3E:C5:1F,3763143,474650429,100,12307,3763043,474638122,0,385,33195,312,24395,73,8800,108,2,131,4,0,5,144444.0,39000.0,-70.0,-70.0,-66.0,-60.0,-70.0,-70.0,-66.0,-60.0,-89.0,-90.0,-87.0,-89.0,19.0,20.0,21.0,29.0,1
1555,BA:8C:B9:54:50:24,3763317,474721561,274,83439,3763043,474638122,0,1198,133229,1180,130383,18,2846,178,4,387,6,0,8,229410.0,137640.0,-40.0,-37.0,-45.0,-50.0,-42.0,-36.0,-44.0,-49.0,-89.0,-90.0,-87.0,-89.0,49.0,53.0,42.0,39.0,1
1556,92:69:1D:31:68:E9,3775863,489901111,12820,15262989,3763043,474638122,3,19327,3594631,18628,3433834,699,160797,6474,105,14079,252,3,252,216660.0,130000.0,-51.0,-48.0,-43.0,-49.0,-51.0,-48.0,-43.0,-48.0,-89.0,-90.0,-87.0,-89.0,38.0,42.0,44.0,40.0,1
1557,CC:2F:71:3F:1F:24,3986011,735773881,222964,261135355,3763047,474638526,27,188104,215820415,188022,215810193,82,10222,179911,6,222964,21625,24,145,130000.0,43333.0,-67.0,-67.0,-71.0,-69.0,-67.0,-66.0,-71.0,-68.0,-89.0,-90.0,-87.0,-88.0,22.0,23.0,16.0,19.0,1
1558,CC:2F:71:3E:C5:1F,3763151,474651237,100,12307,3763051,474638930,0,385,33195,312,24395,73,8800,108,2,131,4,0,5,144444.0,39000.0,-70.0,-70.0,-66.0,-60.0,-70.0,-70.0,-66.0,-60.0,-89.0,-90.0,-87.0,-88.0,19.0,20.0,21.0,28.0,1
1559,BA:8C:B9:54:50:24,3763325,474722369,274,83439,3763051,474638930,0,1198,133229,1180,130383,18,2846,178,4,387,6,0,8,229410.0,137640.0,-40.0,-37.0,-45.0,-50.0,-42.0,-36.0,-44.0,-49.0,-89.0,-90.0,-87.0,-88.0,49.0,53.0,42.0,38.0,1
1560,92:69:1D:31:68:E9,3775871,489901919,12820,15262989,3763051,474638930,3,19327,3594631,18628,3433834,699,160797,6474,105,14079,252,3,252,216660.0,130000.0,-51.0,-48.0,-43.0,-49.0,-51.0,-48.0,-43.0,-48.0,-89.0,-90.0,-87.0,-88.0,38.0,42.0,44.0,39.0,1
1561,CC:2F:71:3F:1F:24,3986121,735892435,223069,261253445,3763052,474638990,27,188200,215937087,188118,215926865,82,10222,179999,6,223069,21646,24,145,117000.0,39000.0,-67.0,-66.0,-71.0,-69.0,-67.0,-66.0,-71.0,-68.0,-89.0,-90.0,-87.0,-88.0,22.0,24.0,16.0,19.0,1
1562,CC:2F:71:3E:C5:1F,3763152,474651297,100,12307,3763052,474638990,0,385,33195,312,24395,73,8800,108,2,131,4,0,5,144444.0,39000.0,-70.0,-70.0,-66.0,-60.0,-70.0,-70.0,-66.0,-60.0,-89.0,-90.0,-87.0,-88.0,19.0,20.0,21.0,28.0,1
1563,BA:8C:B9:54:50:24,3763326,474722429,274,83439,3763052,474638990,0,1198,133229,1180,130383,18,2846,178,4,387,6,0,8,229410.0,137640.0,-40.0,-37.0,-45.0,-50.0,-42.0,-36.0,-44.0,-49.0,-89.0,-90.0,-87.0,-88.0,49.0,53.0,42.0,38.0,1
1564,92:69:1D:31:68:E9,3775872,489901979,12820,15262989,3763052,474638990,3,19327,3594631,18628,3433834,699,160797,6474,105,14079,252,3,252,216660.0,130000.0,-51.0,-48.0,-43.0,-49.0,-51.0,-48.0,-43.0,-48.0,-89.0,-90.0,-87.0,-88.0,38.0,42.0,44.0,39.0,1
1565,CC:2F:71:3F:1F:24,3986229,736010677,223174,261371423,3763055,474639254,27,188296,216052277,188213,216041937,83,10340,180089,6,223174,21649,24,145,130000.0,43333.0,-67.0,-67.0,-71.0,-69.0,-66.0,-67.0,-70.0,-68.0,-89.0,-90.0,-87.0,-88.0,22.0,23.0,16.0,19.0,1
1566,CC:2F:71:3E:C5:1F,3763159,474651965,100,12307,3763059,474639658,0,385,33195,312,24395,73,8800,108,2,131,4,0,5,144444.0,39000.0,-70.0,-70.0,-66.0,-60.0,-70.0,-70.0,-66.0,-60.0,-89.0,-90.0,-87.0,-88.0,19.0,20.0,21.0,28.0,1
1567,BA:8C:B9:54:50:24,3763335,474723299,274,83439,3763061,474639860,0,1198,133229,1180,130383,18,2846,178,4,387,6,0,8,229410.0,137640.0,-40.0,-37.0,-45.0,-50.0,-42.0,-36.0,-44.0,-49.0,-89.0,-90.0,-87.0,-88.0,49.0,53.0,42.0,38.0,1
1568,92:69:1D:31:68:E9,3775881,489902849,12820,15262989,3763061,474639860,3,19327,3594631,18628,3433834,699,160797,6474,105,14079,252,3,252,216660.0,130000.0,-51.0,-48.0,-43.0,-49.0,-51.0,-48.0,-43.0,-48.0,-89.0,-90.0,-87.0,-88.0,38.0,42.0,44.0,39.0,1
1569,CC:2F:71:3F:1F:24,3986352,736133612,223291,261493752,3763061,474639860,27,188396,216164042,188313,216153702,83,10340,180187,6,223291,21653,24,145,130000.0,43333.0,-67.0,-67.0,-71.0,-69.0,-67.0,-67.0,-71.0,-69.0,-89.0,-90.0,-87.0,-88.0,22.0,23.0,16.0,19.0,1
1570,CC:2F:71:3E:C5:1F,3763161,474652167,100,12307,3763061,474639860,0,385,33195,312,24395,73,8800,108,2,131,4,0,5,144444.0,39000.0,-70.0,-70.0,-66.0,-60.0,-70.0,-70.0,-66.0,-60.0,-89.0,-90.0,-87.0,-88.0,19.0,20.0,21.0,28.0,1
1571,BA:8C:B9:54:50:24,3763335,474723299,274,83439,3763061,474639860,0,1198,133229,1180,130383,18,2846,178,4,387,6,0,8,229410.0,137640.0,-40.0,-37.0,-45.0,-50.0,-42.0,-36.0,-44.0,-49.0,-89.0,-90.0,-87.0,-88.0,49.0,53.0,42.0,38.0,1
1572,92:69:1D:31:68:E9,3775881,489902849,12820,15262989,3763061,474639860,3,19327,3594631,18628,3433834,699,160797,6474,105,14079,252,3,252,216660.0,130000.0,-51.0,-48.0,-43.0,-49.0,-51.0,-48.0,-43.0,-48.0,-89.0,-90.0,-87.0,-88.0,38.0,42.0,44.0,39.0,1
1573,CC:2F:71:3F:1F:24,3986460,736251796,223396,261611674,3763064,474640122,27,188487,216275774,188404,216265434,83,10340,180274,6,223396,21659,24,145,130000.0,43333.0,-67.0,-67.0,-71.0,-69.0,-67.0,-66.0,-71.0,-69.0,-89.0,-91.0,-87.0,-89.0,22.0,24.0,16.0,20.0,1
1574,CC:2F:71:3E:C5:1F,3763166,474652631,100,12307,3763066,474640324,0,385,33195,312,24395,73,8800,108,2,131,4,0,5,144444.0,39000.0,-70.0,-70.0,-66.0,-60.0,-70.0,-70.0,-66.0,-60.0,-89.0,-91.0,-87.0,-89.0,19.0,21.0,21.0,29.0,1
1575,BA:8C:B9:54:50:24,3763344,474724167,274,83439,3763070,474640728,0,1200,133365,1182,130519,18,2846,178,4,388,6,0,8,229410.0,137640.0,-40.0,-37.0,-45.0,-51.0,-41.0,-36.0,-45.0,-50.0,-89.0,-91.0,-87.0,-89.0,49.0,54.0,42.0,38.0,1
1576,92:69:1D:31:68:E9,3775890,489903717,12820,15262989,3763070,474640728,3,19329,3594767,18630,3433970,699,160797,6474,105,14080,252,3,252,216660.0,130000.0,-51.0,-49.0,-42.0,-49.0,-51.0,-48.0,-43.0,-48.0,-89.0,-91.0,-87.0,-89.0,38.0,42.0,45.0,40.0,1
1577,CC:2F:71:3F:1F:24,3986572,736370454,223502,261729726,3763070,474640728,27,188579,216386184,188496,216375844,83,10340,180363,6,223502,21664,24,145,130000.0,43333.0,-67.0,-67.0,-72.0,-69.0,-67.0,-67.0,-71.0,-69.0,-89.0,-90.0,-87.0,-88.0,22.0,23.0,15.0,19.0,1
1578,CC:2F:71:3E:C5:1F,3763170,474653035,100,12307,3763070,474640728,0,385,33195,312,24395,73,8800,108,2,131,4,0,5,144444.0,39000.0,-70.0,-70.0,-66.0,-60.0,-70.0,-70.0,-66.0,-60.0,-89.0,-90.0,-87.0,-88.0,19.0,20.0,21.0,28.0,1
1579,BA:8C:B9:54:50:24,3763344,474724167,274,83439,3763070,474640728,0,1200,133365,1182,130519,18,2846,178,4,388,6,0,8,229410.0,137640.0,-40.0,-37.0,-45.0,-51.0,-41.0,-36.0,-45.0,-50.0,-89.0,-90.0,-87.0,-88.0,49.0,53.0,42.0,37.0,1
1580,92:69:1D:31:68:E9,3775890,489903717,12820,15262989,3763070,474640728,3,19329,3594767,18630,3433970,699,160797,6474,105,14080,252,3,252,216660.0,130000.0,-51.0,-49.0,-42.0,-49.0,-51.0,-48.0,-43.0,-48.0,-89.0,-90.0,-87.0,-88.0,38.0,41.0,45.0,39.0,1
1581,CC:2F:71:3F:1F:24,3986682,736490546,223609,261849556,3763073,474640990,27,188677,216503070,188594,216492730,83,10340,180452,6,223609,21668,24,145,130000.0,43333.0,-67.0,-67.0,-71.0,-69.0,-66.0,-66.0,-71.0,-68.0,-89.0,-90.0,-87.0,-88.0,22.0,23.0,16.0,19.0,1
1582,CC:2F:71:3E:C5:1F,3763173,474653297,100,12307,3763073,474640990,0,385,33195,312,24395,73,8800,108,2,131,4,0,5,144444.0,39000.0,-70.0,-70.0,-66.0,-60.0,-70.0,-70.0,-66.0,-60.0,-89.0,-90.0,-87.0,-88.0,19.0,20.0,21.0,28.0,1
1583,BA:8C:B9:54:50:24,3763349,474724631,274,83439,3763075,474641192,0,1200,133365,1182,130519,18,2846,178,4,388,6,0,8,229410.0,137640.0,-40.0,-37.0,-45.0,-51.0,-41.0,-36.0,-45.0,-50.0,-89.0,-90.0,-87.0,-88.0,49.0,53.0,42.0,37.0,1
1584,92:69:1D:31:68:E9,3775899,489904585,12820,15262989,3763079,474641596,3,19329,3594767,18630,3433970,699,160797,6474,105,14080,252,3,252,216660.0,130000.0,-51.0,-49.0,-42.0,-49.0,-51.0,-48.0,-43.0,-48.0,-89.0,-90.0,-87.0,-88.0,38.0,41.0,45.0,39.0,1
1585,CC:2F:71:3F:1F:24,3986804,736613127,223725,261971531,3763079,474641596,27,188778,216616470,188695,216606130,83,10340,180550,6,223725,21676,24,145,130000.0,43333.0,-67.0,-67.0,-71.0,-69.0,-67.0,-67.0,-71.0,-69.0,-89.0,-90.0,-87.0,-88.0,22.0,23.0,16.0,19.0,1
1586,CC:2F:71:3E:C5:1F,3763179,474653903,100,12307,3763079,474641596,0,385,33195,312,24395,73,8800,108,2,131,4,0,5,144444.0,39000.0,-70.0,-70.0,-66.0,-60.0,-70.0,-70.0,-66.0,-60.0,-89.0,-90.0,-87.0,-88.0,19.0,20.0,21.0,28.0,1
1587,BA:8C:B9:54:50:24,3763353,474725035,274,83439,3763079,474641596,0,1200,133365,1182,130519,18,2846,178,4,388,6,0,8,229410.0,137640.0,-40.0,-37.0,-45.0,-51.0,-41.0,-36.0,-45.0,-50.0,-89.0,-90.0,-87.0,-88.0,49.0,53.0,42.0,37.0,1
1588,92:69:1D:31:68:E9,3775899,489904585,12820,15262989,3763079,474641596,3,19329,3594767,18630,3433970,699,160797,6474,105,14080,252,3,252,216660.0,130000.0,-51.0,-49.0,-42.0,-49.0,-51.0,-48.0,-43.0,-48.0,-89.0,-90.0,-87.0,-88.0,38.0,41.0,45.0,39.0,1
1589,CC:2F:71:3F:1F:24,3986912,736733029,223831,262091231,3763081,474641798,27,188876,216727858,188793,216717518,83,10340,180642,6,223831,21677,24,145,130000.0,43333.0,-67.0,-67.0,-72.0,-69.0,-66.0,-67.0,-71.0,-69.0,-89.0,-90.0,-87.0,-88.0,22.0,23.0,15.0,19.0,1
1590,CC:2F:71:3E:C5:1F,3763181,474654105,100,12307,3763081,474641798,0,385,33195,312,24395,73,8800,108,2,131,4,0,5,144444.0,39000.0,-70.0,-70.0,-66.0,-60.0,-70.0,-70.0,-66.0,-60.0,-89.0,-90.0,-87.0,-88.0,19.0,20.0,21.0,28.0,1
1591,BA:8C:B9:54:50:24,3763357,474725439,274,83439,3763083,474642000,0,1200,133365,1182,130519,18,2846,178,4,388,6,0,8,229410.0,137640.0,-40.0,-37.0,-45.0,-51.0,-41.0,-36.0,-45.0,-50.0,-89.0,-90.0,-87.0,-88.0,49.0,53.0,42.0,37.0,1
1592,92:69:1D:31:68:E9,3775907,489905393,12820,15262989,3763087,474642404,3,19329,3594767,18630,3433970,699,160797,6474,105,14080,252,3,252,216660.0,130000.0,-51.0,-49.0,-42.0,-49.0,-51.0,-48.0,-43.0,-48.0,-89.0,-90.0,-87.0,-88.0,38.0,41.0,45.0,39.0,1
1593,CC:2F:71:3F:1F:24,3987025,736853339,223937,262210875,3763088,474642464,27,188969,216839958,188886,216829618,83,10340,180730,6,223937,21683,24,145,130000.0,39000.0,-67.0,-67.0,-71.0,-69.0,-66.0,-66.0,-71.0,-68.0,-89.0,-90.0,-87.0,-88.0,22.0,23.0,16.0,19.0,1
1594,CC:2F:71:3E:C5:1F,3763188,474654771,100,12307,3763088,474642464,0,385,33195,312,24395,73,8800,108,2,131,4,0,5,144444.0,39000.0,-70.0,-70.0,-66.0,-60.0,-70.0,-70.0,-66.0,-60.0,-89.0,-90.0,-87.0,-88.0,19.0,20.0,21.0,28.0,1
1595,BA:8C:B9:54:50:24,3763362,474725903,274,83439,3763088,474642464,0,1200,133365,1182,130519,18,2846,178,4,388,6,0,8,229410.0,137640.0,-40.0,-37.0,-45.0,-51.0,-41.0,-36.0,-45.0,-50.0,-89.0,-90.0,-87.0,-88.0,49.0,53.0,42.0,37.0,1
1596,92:69:1D:31:68:E9,3775908,489905453,12820,15262989,3763088,474642464,3,19329,3594767,18630,3433970,699,160797,6474,105,14080,252,3,252,216660.0,130000.0,-51.0,-49.0,-42.0,-49.0,-51.0,-48.0,-43.0,-48.0,-89.0,-90.0,-87.0,-88.0,38.0,41.0,45.0,39.0,1
1597,CC:2F:71:3F:1F:24,3987134,736974627,224044,262331961,3763090,474642666,27,189063,216957652,188980,216947312,83,10340,180819,6,224044,21694,24,145,130000.0,43333.0,-67.0,-67.0,-71.0,-69.0,-67.0,-66.0,-71.0,-69.0,-89.0,-90.0,-87.0,-88.0,22.0,23.0,16.0,19.0,1
1598,CC:2F:71:3E:C5:1F,3763190,474654973,100,12307,3763090,474642666,0,385,33195,312,24395,73,8800,108,2,131,4,0,5,144444.0,39000.0,-70.0,-70.0,-66.0,-60.0,-70.0,-70.0,-66.0,-60.0,-89.0,-90.0,-87.0,-88.0,19.0,20.0,21.0,28.0,1
1599,BA:8C:B9:54:50:24,3763367,474726580,274,83439,3763093,474643141,0,1200,133365,1182,130519,18,2846,178,4,388,6,0,8,229410.0,137640.0,-40.0,-37.0,-45.0,-51.0,-41.0,-36.0,-45.0,-50.0,-89.0,-90.0,-87.0,-88.0,49.0,53.0,42.0,37.0,1
1600,92:69:1D:31:68:E9,3775917,489906534,12820,15262989,3763097,474643545,3,19329,3594767,18630,3433970,699,160797,6474,105,14080,252,3,252,216660.0,130000.0,-51.0,-49.0,-42.0,-49.0,-51.0,-48.0,-43.0,-48.0,-89.0,-90.0,-87.0,-88.0,38.0,41.0,45.0,39.0,1
1601,CC:2F:71:3F:1F:24,3987253,737097123,224156,262453578,3763097,474643545,27,189170,217081874,189087,217071534,83,10340,180913,6,224156,21694,24,145,130000.0,43333.0,-67.0,-67.0,-71.0,-68.0,-66.0,-66.0,-70.0,-68.0,-89.0,-90.0,-87.0,-88.0,22.0,23.0,16.0,20.0,1
1602,CC:2F:71:3E:C5:1F,3763197,474655852,100,12307,3763097,474643545,0,385,33195,312,24395,73,8800,108,2,131,4,0,5,144444.0,39000.0,-70.0,-70.0,-66.0,-60.0,-70.0,-70.0,-66.0,-60.0,-89.0,-90.0,-87.0,-88.0,19.0,20.0,21.0,28.0,1
1603,BA:8C:B9:54:50:24,3763371,474726984,274,83439,3763097,474643545,0,1200,133365,1182,130519,18,2846,178,4,388,6,0,8,229410.0,137640.0,-40.0,-37.0,-45.0,-51.0,-41.0,-36.0,-45.0,-50.0,-89.0,-90.0,-87.0,-88.0,49.0,53.0,42.0,37.0,1
1604,92:69:1D:31:68:E9,3775917,489906534,12820,15262989,3763097,474643545,3,19329,3594767,18630,3433970,699,160797,6474,105,14080,252,3,252,216660.0,130000.0,-51.0,-49.0,-42.0,-49.0,-51.0,-48.0,-43.0,-48.0,-89.0,-90.0,-87.0,-88.0,38.0,41.0,45.0,39.0,1
1605,CC:2F:71:3F:1F:24,3987359,737216529,224261,262572924,3763098,474643605,27,189269,217203162,189186,217192822,83,10340,181002,6,224261,21702,24,145,130000.0,43333.0,-67.0,-67.0,-71.0,-69.0,-67.0,-66.0,-71.0,-68.0,-89.0,-90.0,-87.0,-88.0,22.0,23.0,16.0,19.0,1
1606,CC:2F:71:3E:C5:1F,3763200,474656114,100,12307,3763100,474643807,0,385,33195,312,24395,73,8800,108,2,131,4,0,5,144444.0,39000.0,-70.0,-70.0,-66.0,-60.0,-70.0,-70.0,-66.0,-60.0,-89.0,-90.0,-87.0,-88.0,19.0,20.0,21.0,28.0,1
1607,BA:8C:B9:54:50:24,3763374,474727246,274,83439,3763100,474643807,0,1204,133637,1186,130791,18,2846,178,4,388,6,0,8,229410.0,137640.0,-40.0,-37.0,-45.0,-51.0,-41.0,-36.0,-45.0,-50.0,-89.0,-90.0,-87.0,-88.0,49.0,53.0,42.0,37.0,1
1608,92:69:1D:31:68:E9,3775924,489907200,12820,15262989,3763104,474644211,3,19329,3594767,18630,3433970,699,160797,6474,105,14080,252,3,252,216660.0,130000.0,-51.0,-49.0,-42.0,-49.0,-51.0,-48.0,-43.0,-48.0,-89.0,-90.0,-87.0,-88.0,38.0,41.0,45.0,39.0,1
1609,CC:2F:71:3F:1F:24,3987472,737335427,224366,262691014,3763106,474644413,27,189359,217313324,189276,217302984,83,10340,181089,6,224366,21704,24,145,130000.0,39000.0,-67.0,-67.0,-71.0,-69.0,-66.0,-66.0,-71.0,-68.0,-88.0,-89.0,-87.0,-88.0,21.0,22.0,16.0,19.0,1
1610,CC:2F:71:3E:C5:1F,3763206,474656720,100,12307,3763106,474644413,0,385,33195,312,24395,73,8800,108,2,131,4,0,5,144444.0,39000.0,-70.0,-70.0,-66.0,-60.0,-70.0,-70.0,-66.0,-60.0,-88.0,-89.0,-87.0,-88.0,18.0,19.0,21.0,28.0,1
1611,BA:8C:B9:54:50:24,3763404,474733863,298,89450,3763106,474644413,0,1233,139281,1215,136435,18,2846,199,4,412,6,0,8,229410.0,130000.0,-48.0,-35.0,-42.0,-45.0,-45.0,-37.0,-45.0,-49.0,-88.0,-89.0,-87.0,-88.0,40.0,54.0,45.0,43.0,1
1612,92:69:1D:31:68:E9,3775926,489907402,12820,15262989,3763106,474644413,3,19329,3594767,18630,3433970,699,160797,6474,105,14080,252,3,252,216660.0,130000.0,-51.0,-49.0,-42.0,-49.0,-51.0,-48.0,-43.0,-48.0,-88.0,-89.0,-87.0,-88.0,37.0,40.0,45.0,39.0,1
1613,CC:2F:71:3F:1F:24,3987578,737454959,224472,262810546,3763106,474644413,27,189456,217430190,189373,217419850,83,10340,181177,6,224472,21713,24,145,130000.0,43333.0,-67.0,-66.0,-71.0,-69.0,-67.0,-66.0,-71.0,-67.0,-88.0,-89.0,-87.0,-88.0,21.0,23.0,16.0,19.0,1
1614,CC:2F:71:3E:C5:1F,3763209,474656982,100,12307,3763109,474644675,0,385,33195,312,24395,73,8800,108,2,131,4,0,5,144444.0,39000.0,-70.0,-70.0,-66.0,-60.0,-70.0,-70.0,-66.0,-60.0,-88.0,-89.0,-87.0,-88.0,18.0,19.0,21.0,28.0,1
1615,BA:8C:B9:54:50:24,3763407,474734125,298,89450,3763109,474644675,0,1233,139281,1215,136435,18,2846,199,4,412,6,0,8,229410.0,130000.0,-48.0,-35.0,-42.0,-45.0,-45.0,-37.0,-45.0,-49.0,-88.0,-89.0,-87.0,-88.0,40.0,54.0,45.0,43.0,1
1616,92:69:1D:31:68:E9,3775933,489908068,12820,15262989,3763113,474645079,3,19329,3594767,18630,3433970,699,160797,6474,105,14080,252,3,252,216660.0,130000.0,-51.0,-49.0,-42.0,-49.0,-51.0,-48.0,-43.0,-48.0,-88.0,-89.0,-87.0,-88.0,37.0,40.0,45.0,39.0,1
1617,CC:2F:71:3F:1F:24,3987699,737577444,224584,262932163,3763115,474645281,27,189561,217551287,189478,217540947,83,10340,181271,6,224584,21713,24,145,130000.0,43333.0,-67.0,-67.0,-72.0,-69.0,-67.0,-67.0,-71.0,-69.0,-88.0,-89.0,-87.0,-88.0,21.0,22.0,15.0,19.0,1
1618,CC:2F:71:3E:C5:1F,3763215,474657588,100,12307,3763115,474645281,0,385,33195,312,24395,73,8800,108,2,131,4,0,5,144444.0,39000.0,-70.0,-70.0,-66.0,-60.0,-70.0,-70.0,-66.0,-60.0,-88.0,-89.0,-87.0,-88.0,18.0,19.0,21.0,28.0,1
1619,BA:8C:B9:54:50:24,3763413,474734731,298,89450,3763115,474645281,0,1233,139281,1215,136435,18,2846,199,4,412,6,0,8,229410.0,130000.0,-48.0,-35.0,-42.0,-45.0,-45.0,-37.0,-45.0,-49.0,-88.0,-89.0,-87.0,-88.0,40.0,54.0,45.0,43.0,1
1620,92:69:1D:31:68:E9,3775935,489908270,12820,15262989,3763115,474645281,3,19330,3594835,18631,3434038,699,160797,6474,105,14080,252,3,252,216660.0,130000.0,-53.0,-49.0,-42.0,-49.0,-51.0,-48.0,-43.0,-48.0,-88.0,-89.0,-87.0,-88.0,35.0,40.0,45.0,39.0,1
1621,CC:2F:71:3F:1F:24,3987804,737695366,224689,263050085,3763115,474645281,27,189654,217664751,189571,217654411,83,10340,181358,6,224689,21721,24,145,130000.0,43333.0,-67.0,-66.0,-71.0,-69.0,-67.0,-66.0,-71.0,-67.0,-89.0,-90.0,-87.0,-88.0,22.0,24.0,16.0,19.0,1
1622,CC:2F:71:3E:C5:1F,3763215,474657588,100,12307,3763115,474645281,0,385,33195,312,24395,73,8800,108,2,131,4,0,5,144444.0,39000.0,-70.0,-70.0,-66.0,-60.0,-70.0,-70.0,-66.0,-60.0,-89.0,-90.0,-87.0,-88.0,19.0,20.0,21.0,28.0,1
1623,BA:8C:B9:54:50:24,3763415,474734933,298,89450,3763117,474645483,0,1233,139281,1215,136435,18,2846,199,4,412,6,0,8,229410.0,130000.0,-48.0,-35.0,-42.0,-45.0,-45.0,-37.0,-45.0,-49.0,-89.0,-90.0,-87.0,-88.0,41.0,55.0,45.0,43.0,1
1624,92:69:1D:31:68:E9,3775937,489908472,12820,15262989,3763117,474645483,3,19330,3594835,18631,3434038,699,160797,6474,105,14080,252,3,252,216660.0,130000.0,-53.0,-49.0,-42.0,-49.0,-51.0,-48.0,-43.0,-48.0,-89.0,-90.0,-87.0,-88.0,36.0,41.0,45.0,39.0,1
1625,CC:2F:71:3F:1F:24,3987919,737815934,224795,263169785,3763124,474646149,27,189749,217781199,189666,217770859,83,10340,181447,6,224795,21721,24,145,130000.0,43333.0,-67.0,-67.0,-71.0,-64.0,-67.0,-66.0,-71.0,-67.0,-89.0,-90.0,-87.0,-88.0,22.0,23.0,16.0,24.0,1
1626,CC:2F:71:3E:C5:1F,3763226,474658824,100,12307,3763126,474646517,0,385,33195,312,24395,73,8800,108,2,131,4,0,5,144444.0,39000.0,-70.0,-70.0,-66.0,-60.0,-70.0,-70.0,-66.0,-60.0,-89.0,-90.0,-87.0,-88.0,19.0,20.0,21.0,28.0,1
1627,BA:8C:B9:54:50:24,3763424,474735967,298,89450,3763126,474646517,0,1233,139281,1215,136435,18,2846,199,4,412,6,0,8,229410.0,130000.0,-48.0,-35.0,-42.0,-45.0,-45.0,-37.0,-45.0,-49.0,-89.0,-90.0,-87.0,-88.0,41.0,55.0,45.0,43.0,1
1628,92:69:1D:31:68:E9,3775946,489909506,12820,15262989,3763126,474646517,3,19330,3594835,18631,3434038,699,160797,6474,105,14080,252,3,252,216660.0,130000.0,-53.0,-49.0,-42.0,-49.0,-51.0,-48.0,-43.0,-48.0,-89.0,-90.0,-87.0,-88.0,36.0,41.0,45.0,39.0,1
1629,CC:2F:71:3F:1F:24,3988033,737942144,224907,263295627,3763126,474646517,27,189853,217910231,189770,217899891,83,10340,181541,6,224907,21732,24,145,130000.0,43333.0,-67.0,-67.0,-71.0,-69.0,-67.0,-67.0,-71.0,-69.0,-89.0,-90.0,-87.0,-88.0,22.0,23.0,16.0,19.0,1
1630,CC:2F:71:3E:C5:1F,3763229,474659086,101,12367,3763128,474646719,0,387,33335,314,24535,73,8800,108,2,132,4,0,5,144444.0,39000.0,-70.0,-71.0,-66.0,-60.0,-69.0,-69.0,-65.0,-60.0,-89.0,-90.0,-87.0,-88.0,19.0,19.0,21.0,28.0,1
1631,BA:8C:B9:54:50:24,3763427,474736285,299,89566,3763128,474646719,0,1239,139689,1221,136843,18,2846,199,4,413,6,0,8,229410.0,130000.0,-39.0,-38.0,-45.0,-51.0,-42.0,-35.0,-43.0,-46.0,-89.0,-90.0,-87.0,-88.0,50.0,52.0,42.0,37.0,1
1632,92:69:1D:31:68:E9,3775951,489910026,12821,15263105,3763130,474646921,3,19332,3594971,18633,3434174,699,160797,6474,105,14081,252,3,252,216660.0,130000.0,-53.0,-49.0,-42.0,-49.0,-51.0,-48.0,-43.0,-48.0,-89.0,-90.0,-87.0,-88.0,36.0,41.0,45.0,39.0,1
1633,CC:2F:71:3F:1F:24,3988166,738069580,225032,263422255,3763134,474647325,27,189967,218031480,189884,218021140,83,10340,181649,6,225032,21735,24,145,130000.0,43333.0,-67.0,-66.0,-71.0,-69.0,-67.0,-66.0,-71.0,-69.0,-89.0,-90.0,-87.0,-88.0,22.0,24.0,16.0,19.0,1
1634,CC:2F:71:3E:C5:1F,3763235,474659692,101,12367,3763134,474647325,0,387,33335,314,24535,73,8800,108,2,132,4,0,5,144444.0,39000.0,-70.0,-71.0,-66.0,-60.0,-69.0,-69.0,-65.0,-60.0,-89.0,-90.0,-87.0,-88.0,19.0,19.0,21.0,28.0,1
1635,BA:8C:B9:54:50:24,3763433,474736891,299,89566,3763134,474647325,0,1239,139689,1221,136843,18,2846,199,4,413,6,0,8,229410.0,130000.0,-39.0,-38.0,-45.0,-51.0,-42.0,-35.0,-43.0,-46.0,-89.0,-90.0,-87.0,-88.0,50.0,52.0,42.0,37.0,1
1636,92:69:1D:31:68:E9,3775955,489910430,12821,15263105,3763134,474647325,3,19332,3594971,18633,3434174,699,160797,6474,105,14081,252,3,252,216660.0,130000.0,-53.0,-49.0,-42.0,-49.0,-51.0,-48.0,-43.0,-48.0,-89.0,-90.0,-87.0,-88.0,36.0,41.0,45.0,39.0,1
1637,CC:2F:71:3F:1F:24,3988271,738187432,225136,263540047,3763135,474647385,27,190057,218141562,189974,218131222,83,10340,181736,6,225136,21740,24,145,130000.0,43333.0,-67.0,-67.0,-71.0,-69.0,-67.0,-66.0,-71.0,-68.0,-89.0,-90.0,-87.0,-88.0,22.0,23.0,16.0,19.0,1
1638,CC:2F:71:3E:C5:1F,3763236,474659752,101,12367,3763135,474647385,0,387,33335,314,24535,73,8800,108,2,132,4,0,5,144444.0,39000.0,-70.0,-71.0,-66.0,-60.0,-69.0,-69.0,-65.0,-60.0,-89.0,-90.0,-87.0,-88.0,19.0,19.0,21.0,28.0,1
1639,BA:8C:B9:54:50:24,3763435,474737067,300,89682,3763135,474647385,0,1244,140071,1226,137225,18,2846,200,4,414,6,0,8,229410.0,130000.0,-51.0,-35.0,-43.0,-44.0,-43.0,-37.0,-44.0,-47.0,-89.0,-90.0,-87.0,-88.0,38.0,55.0,44.0,44.0,1
1640,92:69:1D:31:68:E9,3775960,489910894,12821,15263105,3763139,474647789,3,19332,3594971,18633,3434174,699,160797,6474,105,14081,252,3,252,216660.0,130000.0,-53.0,-49.0,-42.0,-49.0,-51.0,-48.0,-43.0,-48.0,-89.0,-90.0,-87.0,-88.0,36.0,41.0,45.0,39.0,1
1641,CC:2F:71:3F:1F:24,3988386,738308070,225243,263659877,3763143,474648193,27,190153,218258140,190070,218247800,83,10340,181825,6,225243,21741,24,145,130000.0,43333.0,-67.0,-67.0,-71.0,-69.0,-67.0,-66.0,-71.0,-67.0,-89.0,-90.0,-87.0,-88.0,22.0,23.0,16.0,19.0,1
1642,CC:2F:71:3E:C5:1F,3763244,474660560,101,12367,3763143,474648193,0,387,33335,314,24535,73,8800,108,2,132,4,0,5,144444.0,39000.0,-70.0,-71.0,-66.0,-60.0,-69.0,-69.0,-65.0,-60.0,-89.0,-90.0,-87.0,-88.0,19.0,19.0,21.0,28.0,1
1643,BA:8C:B9:54:50:24,3763443,474737875,300,89682,3763143,474648193,0,1244,140071,1226,137225,18,2846,200,4,414,6,0,8,229410.0,130000.0,-51.0,-35.0,-43.0,-44.0,-43.0,-37.0,-44.0,-47.0,-89.0,-90.0,-87.0,-88.0,38.0,55.0,44.0,44.0,1
1644,92:69:1D:31:68:E9,3775964,489911298,12821,15263105,3763143,474648193,3,19332,3594971,18633,3434174,699,160797,6474,105,14081,252,3,252,216660.0,130000.0,-53.0,-49.0,-42.0,-49.0,-51.0,-48.0,-43.0,-48.0,-89.0,-90.0,-87.0,-88.0,36.0,41.0,45.0,39.0,1
1645,CC:2F:71:3F:1F:24,3988493,738427830,225349,263779577,3763144,474648253,27,190244,218369748,190161,218359408,83,10340,181914,6,225349,21741,24,145,130000.0,43333.0,-67.0,-67.0,-71.0,-69.0,-67.0,-67.0,-71.0,-69.0,-89.0,-90.0,-87.0,-88.0,22.0,23.0,16.0,19.0,1
1646,CC:2F:71:3E:C5:1F,3763245,474660620,101,12367,3763144,474648253,0,387,33335,314,24535,73,8800,108,2,132,4,0,5,144444.0,39000.0,-70.0,-71.0,-66.0,-60.0,-69.0,-69.0,-65.0,-60.0,-89.0,-90.0,-87.0,-88.0,19.0,19.0,21.0,28.0,1
1647,BA:8C:B9:54:50:24,3763445,474737997,300,89682,3763145,474648315,0,1244,140071,1226,137225,18,2846,200,4,414,6,0,8,229410.0,130000.0,-51.0,-35.0,-43.0,-44.0,-43.0,-37.0,-44.0,-47.0,-89.0,-90.0,-87.0,-88.0,38.0,55.0,44.0,44.0,1
1648,92:69:1D:31:68:E9,3775968,489911622,12821,15263105,3763147,474648517,3,19332,3594971,18633,3434174,699,160797,6474,105,14081,252,3,252,216660.0,130000.0,-53.0,-49.0,-42.0,-49.0,-51.0,-48.0,-43.0,-48.0,-89.0,-90.0,-87.0,-88.0,36.0,41.0,45.0,39.0,1
1649,CC:2F:71:3F:1F:24,3988617,738554755,225464,263905632,3763153,474649123,27,190351,218496660,190268,218486320,83,10340,182012,6,225464,21746,24,145,130000.0,43333.0,-67.0,-66.0,-72.0,-69.0,-67.0,-65.0,-71.0,-67.0,-89.0,-90.0,-87.0,-88.0,22.0,24.0,15.0,19.0,1
1650,CC:2F:71:3E:C5:1F,3763254,474661490,101,12367,3763153,474649123,0,389,33523,315,24605,74,8918,109,2,132,4,0,5,144444.0,39000.0,-70.0,-70.0,-66.0,-60.0,-69.0,-69.0,-65.0,-60.0,-89.0,-90.0,-87.0,-88.0,19.0,20.0,21.0,28.0,1
1651,BA:8C:B9:54:50:24,3763453,474738805,300,89682,3763153,474649123,0,1244,140071,1226,137225,18,2846,200,4,414,6,0,8,229410.0,130000.0,-51.0,-35.0,-43.0,-44.0,-43.0,-37.0,-44.0,-47.0,-89.0,-90.0,-87.0,-88.0,38.0,55.0,44.0,44.0,1
1652,92:69:1D:31:68:E9,3775974,489912228,12821,15263105,3763153,474649123,3,19332,3594971,18633,3434174,699,160797,6474,105,14081,252,3,252,216660.0,130000.0,-53.0,-49.0,-42.0,-49.0,-51.0,-48.0,-43.0,-48.0,-89.0,-90.0,-87.0,-88.0,36.0,41.0,45.0,39.0,1
1653,CC:2F:71:3F:1F:24,3988723,738674374,225569,264024978,3763154,474649396,27,190444,218611438,190361,218601098,83,10340,182100,6,225569,21750,24,145,130000.0,43333.0,-67.0,-67.0,-71.0,-69.0,-67.0,-67.0,-71.0,-69.0,-89.0,-90.0,-87.0,-88.0,22.0,23.0,16.0,19.0,1
1654,CC:2F:71:3E:C5:1F,3763255,474661763,101,12367,3763154,474649396,0,389,33523,315,24605,74,8918,109,2,132,4,0,5,144444.0,39000.0,-70.0,-70.0,-66.0,-60.0,-69.0,-69.0,-65.0,-60.0,-89.0,-90.0,-87.0,-88.0,19.0,20.0,21.0,28.0,1
1655,BA:8C:B9:54:50:24,3763454,474739078,300,89682,3763154,474649396,0,1244,140071,1226,137225,18,2846,200,4,414,6,0,8,229410.0,130000.0,-51.0,-35.0,-43.0,-44.0,-43.0,-37.0,-44.0,-47.0,-89.0,-90.0,-87.0,-88.0,38.0,55.0,44.0,44.0,1
1656,92:69:1D:31:68:E9,3775977,489912703,12821,15263105,3763156,474649598,3,19332,3594971,18633,3434174,699,160797,6474,105,14081,252,3,252,216660.0,130000.0,-53.0,-49.0,-42.0,-49.0,-51.0,-48.0,-43.0,-48.0,-89.0,-90.0,-87.0,-88.0,36.0,41.0,45.0,39.0,1
1657,CC:2F:71:3F:1F:24,3988840,738795022,225676,264144696,3763164,474650326,27,190537,218723390,190453,218712932,84,10458,182190,6,225676,21755,24,145,117000.0,39000.0,-67.0,-66.0,-71.0,-69.0,-67.0,-66.0,-71.0,-69.0,-89.0,-90.0,-87.0,-88.0,22.0,24.0,16.0,19.0,1
1658,CC:2F:71:3E:C5:1F,3763265,474662693,101,12367,3763164,474650326,0,389,33523,315,24605,74,8918,109,2,132,4,0,5,144444.0,39000.0,-70.0,-70.0,-66.0,-60.0,-69.0,-69.0,-65.0,-60.0,-89.0,-90.0,-87.0,-88.0,19.0,20.0,21.0,28.0,1
1659,BA:8C:B9:54:50:24,3763464,474740008,300,89682,3763164,474650326,0,1244,140071,1226,137225,18,2846,200,4,414,6,0,8,229410.0,130000.0,-51.0,-35.0,-43.0,-44.0,-43.0,-37.0,-44.0,-47.0,-89.0,-90.0,-87.0,-88.0,38.0,55.0,44.0,44.0,1
1660,92:69:1D:31:68:E9,3775985,489913431,12821,15263105,3763164,474650326,3,19332,3594971,18633,3434174,699,160797,6474,105,14081,252,3,252,216660.0,130000.0,-53.0,-49.0,-42.0,-49.0,-51.0,-48.0,-43.0,-48.0,-89.0,-90.0,-87.0,-88.0,36.0,41.0,45.0,39.0,1
1661,CC:2F:71:3F:1F:24,3988946,738914610,225782,264264284,3763164,474650326,27,190625,218831788,190541,218821330,84,10458,182277,6,225782,21757,24,145,130000.0,43333.0,-67.0,-66.0,-72.0,-64.0,-67.0,-66.0,-71.0,-68.0,-89.0,-90.0,-87.0,-88.0,22.0,24.0,15.0,24.0,1
1662,CC:2F:71:3E:C5:1F,3763265,474662693,101,12367,3763164,474650326,0,389,33523,315,24605,74,8918,109,2,132,4,0,5,144444.0,39000.0,-70.0,-70.0,-66.0,-60.0,-69.0,-69.0,-65.0,-60.0,-89.0,-90.0,-87.0,-88.0,19.0,20.0,21.0,28.0,1
1663,BA:8C:B9:54:50:24,3763464,474740008,300,89682,3763164,474650326,0,1244,140071,1226,137225,18,2846,200,4,414,6,0,8,229410.0,130000.0,-51.0,-35.0,-43.0,-44.0,-43.0,-37.0,-44.0,-47.0,-89.0,-90.0,-87.0,-88.0,38.0,55.0,44.0,44.0,1
1664,92:69:1D:31:68:E9,3775987,489913633,12821,15263105,3763166,474650528,3,19332,3594971,18633,3434174,699,160797,6474,105,14081,252,3,252,216660.0,130000.0,-53.0,-49.0,-42.0,-49.0,-51.0,-48.0,-43.0,-48.0,-89.0,-90.0,-87.0,-88.0,36.0,41.0,45.0,39.0,1
1665,CC:2F:71:3F:1F:24,3989066,739035597,225894,264384463,3763172,474651134,27,190723,218944702,190639,218934244,84,10458,182372,6,225894,21758,24,145,130000.0,43333.0,-67.0,-67.0,-72.0,-67.0,-67.0,-67.0,-71.0,-68.0,-89.0,-90.0,-87.0,-88.0,22.0,23.0,15.0,21.0,1
1666,CC:2F:71:3E:C5:1F,3763273,474663501,101,12367,3763172,474651134,0,389,33523,315,24605,74,8918,109,2,132,4,0,5,144444.0,39000.0,-70.0,-70.0,-66.0,-60.0,-69.0,-69.0,-65.0,-60.0,-89.0,-90.0,-87.0,-88.0,19.0,20.0,21.0,28.0,1
1667,BA:8C:B9:54:50:24,3763472,474740816,300,89682,3763172,474651134,0,1244,140071,1226,137225,18,2846,200,4,414,6,0,8,229410.0,130000.0,-51.0,-35.0,-43.0,-44.0,-43.0,-37.0,-44.0,-47.0,-89.0,-90.0,-87.0,-88.0,38.0,55.0,44.0,44.0,1
1668,92:69:1D:31:68:E9,3775993,489914239,12821,15263105,3763172,474651134,3,19332,3594971,18633,3434174,699,160797,6474,105,14081,252,3,252,216660.0,130000.0,-53.0,-49.0,-42.0,-49.0,-51.0,-48.0,-43.0,-48.0,-89.0,-90.0,-87.0,-88.0,36.0,41.0,45.0,39.0,1
1669,CC:2F:71:3F:1F:24,3989176,739157003,226003,264505809,3763173,474651194,27,190817,219058268,190733,219047810,84,10458,182461,6,226003,21763,24,145,130000.0,39000.0,-67.0,-66.0,-71.0,-69.0,-67.0,-66.0,-71.0,-69.0,-89.0,-90.0,-87.0,-88.0,22.0,24.0,16.0,19.0,1
1670,CC:2F:71:3E:C5:1F,3763274,474663561,101,12367,3763173,474651194,0,389,33523,315,24605,74,8918,109,2,132,4,0,5,144444.0,39000.0,-70.0,-70.0,-66.0,-60.0,-69.0,-69.0,-65.0,-60.0,-89.0,-90.0,-87.0,-88.0,19.0,20.0,21.0,28.0,1
1671,BA:8C:B9:54:50:24,3763473,474740876,300,89682,3763173,474651194,0,1244,140071,1226,137225,18,2846,200,4,414,6,0,8,229410.0,130000.0,-51.0,-35.0,-43.0,-44.0,-43.0,-37.0,-44.0,-47.0,-89.0,-90.0,-87.0,-88.0,38.0,55.0,44.0,44.0,1
1672,92:69:1D:31:68:E9,3775996,489914501,12821,15263105,3763175,474651396,3,19332,3594971,18633,3434174,699,160797,6474,105,14081,252,3,252,216660.0,130000.0,-53.0,-49.0,-42.0,-49.0,-51.0,-48.0,-43.0,-48.0,-89.0,-90.0,-87.0,-88.0,36.0,41.0,45.0,39.0,1
1673,CC:2F:71:3F:1F:24,3989290,739276031,226109,264624029,3763181,474652002,27,190909,219172868,190825,219162410,84,10458,182549,6,226109,21764,24,145,130000.0,43333.0,-67.0,-67.0,-71.0,-69.0,-67.0,-66.0,-71.0,-68.0,-88.0,-90.0,-87.0,-88.0,21.0,23.0,16.0,19.0,1
1674,CC:2F:71:3E:C5:1F,3763282,474664369,101,12367,3763181,474652002,0,389,33523,315,24605,74,8918,109,2,132,4,0,5,144444.0,39000.0,-70.0,-70.0,-66.0,-60.0,-69.0,-69.0,-65.0,-60.0,-88.0,-90.0,-87.0,-88.0,18.0,20.0,21.0,28.0,1
1675,BA:8C:B9:54:50:24,3763481,474741684,300,89682,3763181,474652002,0,1244,140071,1226,137225,18,2846,200,4,414,6,0,8,229410.0,130000.0,-51.0,-35.0,-43.0,-44.0,-43.0,-37.0,-44.0,-47.0,-88.0,-90.0,-87.0,-88.0,37.0,55.0,44.0,44.0,1
1676,92:69:1D:31:68:E9,3776002,489915107,12821,15263105,3763181,474652002,3,19332,3594971,18633,3434174,699,160797,6474,105,14081,252,3,252,216660.0,130000.0,-53.0,-49.0,-42.0,-49.0,-51.0,-48.0,-43.0,-48.0,-88.0,-90.0,-87.0,-88.0,35.0,41.0,45.0,39.0,1
1677,CC:2F:71:3F:1F:24,3989396,739394237,226214,264742175,3763182,474652062,27,190999,219283078,190915,219272620,84,10458,182636,6,226214,21764,24,145,130000.0,43333.0,-67.0,-67.0,-71.0,-64.0,-67.0,-66.0,-71.0,-68.0,-88.0,-90.0,-87.0,-88.0,21.0,23.0,16.0,24.0,1
1678,CC:2F:71:3E:C5:1F,3763283,474664429,101,12367,3763182,474652062,0,389,33523,315,24605,74,8918,109,2,132,4,0,5,144444.0,39000.0,-70.0,-70.0,-66.0,-60.0,-69.0,-69.0,-65.0,-60.0,-88.0,-90.0,-87.0,-88.0,18.0,20.0,21.0,28.0,1
1679,BA:8C:B9:54:50:24,3763482,474741744,300,89682,3763182,474652062,0,1244,140071,1226,137225,18,2846,200,4,414,6,0,8,229410.0,130000.0,-51.0,-35.0,-43.0,-44.0,-43.0,-37.0,-44.0,-47.0,-88.0,-90.0,-87.0,-88.0,37.0,55.0,44.0,44.0,1
1680,92:69:1D:31:68:E9,3776005,489915369,12821,15263105,3763184,474652264,3,19332,3594971,18633,3434174,699,160797,6474,105,14081,252,3,252,216660.0,130000.0,-53.0,-49.0,-42.0,-49.0,-51.0,-48.0,-43.0,-48.0,-88.0,-90.0,-87.0,-88.0,35.0,41.0,45.0,39.0,1
1681,CC:2F:71:3F:1F:24,3989521,739522912,226331,264870042,3763190,474652870,27,191101,219399441,191017,219388983,84,10458,182736,6,226331,21771,24,145,130000.0,43333.0,-68.0,-67.0,-71.0,-69.0,-68.0,-68.0,-71.0,-69.0,-88.0,-90.0,-87.0,-88.0,20.0,23.0,16.0,19.0,1
1682,CC:2F:71:3E:C5:1F,3763291,474665237,101,12367,3763190,474652870,0,391,33663,317,24745,74,8918,109,2,133,4,0,5,144444.0,39000.0,-64.0,-65.0,-65.0,-60.0,-68.0,-69.0,-65.0,-60.0,-88.0,-90.0,-87.0,-88.0,24.0,25.0,22.0,28.0,1
1683,BA:8C:B9:54:50:24,3763490,474742552,300,89682,3763190,474652870,0,1246,140207,1228,137361,18,2846,200,4,415,6,0,8,229410.0,130000.0,-48.0,-35.0,-42.0,-45.0,-44.0,-37.0,-45.0,-48.0,-88.0,-90.0,-87.0,-88.0,40.0,55.0,45.0,43.0,1
1684,92:69:1D:31:68:E9,3776011,489915975,12821,15263105,3763190,474652870,3,19334,3595107,18635,3434310,699,160797,6474,105,14082,252,3,252,216660.0,130000.0,-52.0,-49.0,-44.0,-47.0,-51.0,-48.0,-43.0,-48.0,-88.0,-90.0,-87.0,-88.0,36.0,41.0,43.0,41.0,1
1685,CC:2F:71:3F:1F:24,3989625,739640914,226435,264988044,3763190,474652870,27,191203,219522423,191119,219511965,84,10458,182826,6,226435,21772,24,145,130000.0,43333.0,-67.0,-67.0,-71.0,-69.0,-67.0,-66.0,-70.0,-68.0,-88.0,-90.0,-87.0,-88.0,21.0,23.0,16.0,19.0,1
1686,CC:2F:71:3E:C5:1F,3763291,474665237,101,12367,3763190,474652870,0,391,33663,317,24745,74,8918,109,2,133,4,0,5,144444.0,39000.0,-64.0,-65.0,-65.0,-60.0,-68.0,-69.0,-65.0,-60.0,-88.0,-90.0,-87.0,-88.0,24.0,25.0,22.0,28.0,1
1687,BA:8C:B9:54:50:24,3763490,474742552,300,89682,3763190,474652870,0,1246,140207,1228,137361,18,2846,200,4,415,6,0,8,229410.0,130000.0,-48.0,-35.0,-42.0,-45.0,-44.0,-37.0,-45.0,-48.0,-88.0,-90.0,-87.0,-88.0,40.0,55.0,45.0,43.0,1
1688,92:69:1D:31:68:E9,3776013,489916177,12821,15263105,3763192,474653072,3,19334,3595107,18635,3434310,699,160797,6474,105,14082,252,3,252,216660.0,130000.0,-52.0,-49.0,-44.0,-47.0,-51.0,-48.0,-43.0,-48.0,-88.0,-90.0,-87.0,-88.0,36.0,41.0,43.0,41.0,1
1689,CC:2F:71:3F:1F:24,3989740,739761426,226541,265107688,3763199,474653738,27,191299,219637611,191215,219627153,84,10458,182916,6,226541,21780,24,145,117000.0,39000.0,-67.0,-67.0,-71.0,-69.0,-67.0,-67.0,-70.0,-69.0,-88.0,-90.0,-87.0,-88.0,21.0,23.0,16.0,19.0,1
1690,CC:2F:71:3E:C5:1F,3763300,474666105,101,12367,3763199,474653738,0,391,33663,317,24745,74,8918,109,2,133,4,0,5,144444.0,39000.0,-64.0,-65.0,-65.0,-60.0,-68.0,-69.0,-65.0,-60.0,-88.0,-90.0,-87.0,-88.0,24.0,25.0,22.0,28.0,1
1691,BA:8C:B9:54:50:24,3763499,474743420,300,89682,3763199,474653738,0,1247,140275,1229,137429,18,2846,200,4,415,6,0,8,229410.0,130000.0,-40.0,-37.0,-45.0,-51.0,-44.0,-37.0,-45.0,-48.0,-88.0,-90.0,-87.0,-88.0,48.0,53.0,42.0,37.0,1
1692,92:69:1D:31:68:E9,3776020,489916843,12821,15263105,3763199,474653738,3,19334,3595107,18635,3434310,699,160797,6474,105,14082,252,3,252,216660.0,130000.0,-52.0,-49.0,-44.0,-47.0,-51.0,-48.0,-43.0,-48.0,-88.0,-90.0,-87.0,-88.0,36.0,41.0,43.0,41.0,1
1693,CC:2F:71:3F:1F:24,3989848,739881218,226649,265227480,3763199,474653738,27,191393,219753975,191309,219743517,84,10458,183004,6,226649,21783,24,145,130000.0,43333.0,-67.0,-67.0,-71.0,-69.0,-67.0,-66.0,-70.0,-69.0,-88.0,-90.0,-87.0,-88.0,21.0,23.0,16.0,19.0,1
1694,CC:2F:71:3E:C5:1F,3763300,474666105,101,12367,3763199,474653738,0,391,33663,317,24745,74,8918,109,2,133,4,0,5,144444.0,39000.0,-64.0,-65.0,-65.0,-60.0,-68.0,-69.0,-65.0,-60.0,-88.0,-90.0,-87.0,-88.0,24.0,25.0,22.0,28.0,1
1695,BA:8C:B9:54:50:24,3763499,474743420,300,89682,3763199,474653738,0,1247,140275,1229,137429,18,2846,200,4,415,6,0,8,229410.0,130000.0,-40.0,-37.0,-45.0,-51.0,-44.0,-37.0,-45.0,-48.0,-88.0,-90.0,-87.0,-88.0,48.0,53.0,42.0,37.0,1
1696,92:69:1D:31:68:E9,3776022,489917045,12821,15263105,3763201,474653940,3,19334,3595107,18635,3434310,699,160797,6474,105,14082,252,3,252,216660.0,130000.0,-52.0,-49.0,-44.0,-47.0,-51.0,-48.0,-43.0,-48.0,-88.0,-90.0,-87.0,-88.0,36.0,41.0,43.0,41.0,1
1697,CC:2F:71:3F:1F:24,3989968,740003643,226761,265349097,3763207,474654546,27,191491,219867010,191407,219856552,84,10458,183098,6,226761,21783,24,145,130000.0,43333.0,-67.0,-67.0,-71.0,-69.0,-67.0,-67.0,-70.0,-68.0,-88.0,-90.0,-87.0,-88.0,21.0,23.0,16.0,19.0,1
1698,CC:2F:71:3E:C5:1F,3763308,474666913,101,12367,3763207,474654546,0,391,33663,317,24745,74,8918,109,2,133,4,0,5,144444.0,39000.0,-64.0,-65.0,-65.0,-60.0,-68.0,-69.0,-65.0,-60.0,-88.0,-90.0,-87.0,-88.0,24.0,25.0,22.0,28.0,1
1699,BA:8C:B9:54:50:24,3763507,474744228,300,89682,3763207,474654546,0,1247,140275,1229,137429,18,2846,200,4,415,6,0,8,229410.0,130000.0,-40.0,-37.0,-45.0,-51.0,-44.0,-37.0,-45.0,-48.0,-88.0,-90.0,-87.0,-88.0,48.0,53.0,42.0,37.0,1
1700,92:69:1D:31:68:E9,3776028,489917651,12821,15263105,3763207,474654546,3,19334,3595107,18635,3434310,699,160797,6474,105,14082,252,3,252,216660.0,130000.0,-52.0,-49.0,-44.0,-47.0,-51.0,-48.0,-43.0,-48.0,-88.0,-90.0,-87.0,-88.0,36.0,41.0,43.0,41.0,1
1701,CC:2F:71:3F:1F:24,3990075,740121755,226867,265467149,3763208,474654606,27,191580,219974196,191496,219963738,84,10458,183186,6,226867,21787,24,145,130000.0,43333.0,-67.0,-67.0,-70.0,-69.0,-67.0,-67.0,-70.0,-68.0,-88.0,-90.0,-87.0,-88.0,21.0,23.0,17.0,19.0,1
1702,CC:2F:71:3E:C5:1F,3763309,474666973,101,12367,3763208,474654606,0,391,33663,317,24745,74,8918,109,2,133,4,0,5,144444.0,39000.0,-64.0,-65.0,-65.0,-60.0,-68.0,-69.0,-65.0,-60.0,-88.0,-90.0,-87.0,-88.0,24.0,25.0,22.0,28.0,1
1703,BA:8C:B9:54:50:24,3763508,474744288,300,89682,3763208,474654606,0,1247,140275,1229,137429,18,2846,200,4,415,6,0,8,229410.0,130000.0,-40.0,-37.0,-45.0,-51.0,-44.0,-37.0,-45.0,-48.0,-88.0,-90.0,-87.0,-88.0,48.0,53.0,42.0,37.0,1
1704,92:69:1D:31:68:E9,3776029,489917711,12821,15263105,3763208,474654606,3,19334,3595107,18635,3434310,699,160797,6474,105,14082,252,3,252,216660.0,130000.0,-52.0,-49.0,-44.0,-47.0,-51.0,-48.0,-43.0,-48.0,-88.0,-90.0,-87.0,-88.0,36.0,41.0,43.0,41.0,1
1705,CC:2F:71:3F:1F:24,3990188,740239486,226973,265584001,3763215,474655485,27,191669,220082724,191585,220072266,84,10458,183273,6,226973,21787,24,145,130000.0,43333.0,-68.0,-67.0,-72.0,-69.0,-67.0,-67.0,-71.0,-69.0,-88.0,-90.0,-87.0,-88.0,20.0,23.0,15.0,19.0,1
1706,CC:2F:71:3E:C5:1F,3763316,474667852,101,12367,3763215,474655485,0,391,33663,317,24745,74,8918,109,2,133,4,0,5,144444.0,39000.0,-64.0,-65.0,-65.0,-60.0,-68.0,-69.0,-65.0,-60.0,-89.0,-90.0,-87.0,-88.0,25.0,25.0,22.0,28.0,1
1707,BA:8C:B9:54:50:24,3763517,474745369,300,89682,3763217,474655687,0,1247,140275,1229,137429,18,2846,200,4,415,6,0,8,229410.0,130000.0,-40.0,-37.0,-45.0,-51.0,-44.0,-37.0,-45.0,-48.0,-89.0,-90.0,-87.0,-88.0,49.0,53.0,42.0,37.0,1
1708,92:69:1D:31:68:E9,3776038,489918792,12821,15263105,3763217,474655687,3,19334,3595107,18635,3434310,699,160797,6474,105,14082,252,3,252,216660.0,130000.0,-52.0,-49.0,-44.0,-47.0,-51.0,-48.0,-43.0,-48.0,-89.0,-90.0,-87.0,-88.0,37.0,41.0,43.0,41.0,1
1709,CC:2F:71:3F:1F:24,3990297,740358094,227080,265702407,3763217,474655687,27,191762,220196044,191678,220185586,84,10458,183360,6,227080,21787,24,145,130000.0,43333.0,-70.0,-70.0,-74.0,-72.0,-69.0,-69.0,-73.0,-71.0,-89.0,-90.0,-87.0,-88.0,19.0,20.0,13.0,16.0,1
1710,CC:2F:71:3E:C5:1F,3763319,474668114,101,12367,3763218,474655747,0,391,33663,317,24745,74,8918,109,2,133,4,0,5,144444.0,39000.0,-64.0,-65.0,-65.0,-60.0,-68.0,-69.0,-65.0,-60.0,-89.0,-90.0,-87.0,-88.0,25.0,25.0,22.0,28.0,1
1711,BA:8C:B9:54:50:24,3763518,474745429,300,89682,3763218,474655747,0,1247,140275,1229,137429,18,2846,200,4,415,6,0,8,229410.0,130000.0,-40.0,-37.0,-45.0,-51.0,-44.0,-37.0,-45.0,-48.0,-89.0,-90.0,-87.0,-88.0,49.0,53.0,42.0,37.0,1
1712,92:69:1D:31:68:E9,3776039,489918852,12821,15263105,3763218,474655747,3,19334,3595107,18635,3434310,699,160797,6474,105,14082,252,3,252,216660.0,130000.0,-52.0,-49.0,-44.0,-47.0,-51.0,-48.0,-43.0,-48.0,-89.0,-90.0,-87.0,-88.0,37.0,41.0,43.0,41.0,1
1713,CC:2F:71:3F:1F:24,3990414,740478527,227192,265822376,3763222,474656151,27,191857,220304431,191773,220293973,84,10458,183453,6,227192,21791,24,145,130000.0,43333.0,-67.0,-67.0,-71.0,-68.0,-67.0,-66.0,-70.0,-68.0,-89.0,-90.0,-87.0,-88.0,22.0,23.0,16.0,20.0,1
1714,CC:2F:71:3E:C5:1F,3763323,474668518,101,12367,3763222,474656151,0,391,33663,317,24745,74,8918,109,2,133,4,0,5,144444.0,39000.0,-64.0,-65.0,-65.0,-60.0,-68.0,-69.0,-65.0,-60.0,-89.0,-90.0,-87.0,-88.0,25.0,25.0,22.0,28.0,1
1715,BA:8C:B9:54:50:24,3763524,474746035,300,89682,3763224,474656353,0,1247,140275,1229,137429,18,2846,200,4,415,6,0,8,229410.0,130000.0,-40.0,-37.0,-45.0,-51.0,-44.0,-37.0,-45.0,-48.0,-89.0,-90.0,-87.0,-88.0,49.0,53.0,42.0,37.0,1
1716,92:69:1D:31:68:E9,3776047,489919660,12821,15263105,3763226,474656555,3,19334,3595107,18635,3434310,699,160797,6474,105,14082,252,3,252,216660.0,130000.0,-52.0,-49.0,-44.0,-47.0,-51.0,-48.0,-43.0,-48.0,-89.0,-90.0,-87.0,-88.0,37.0,41.0,43.0,41.0,1
1717,CC:2F:71:3F:1F:24,3990525,740597337,227299,265940782,3763226,474656555,27,191947,220414499,191863,220404041,84,10458,183541,6,227299,21792,24,145,130000.0,43333.0,-67.0,-67.0,-71.0,-68.0,-67.0,-66.0,-71.0,-68.0,-89.0,-90.0,-87.0,-88.0,22.0,23.0,16.0,20.0,1
1718,CC:2F:71:3E:C5:1F,3763327,474668922,101,12367,3763226,474656555,0,391,33663,317,24745,74,8918,109,2,133,4,0,5,144444.0,39000.0,-64.0,-65.0,-65.0,-60.0,-68.0,-69.0,-65.0,-60.0,-89.0,-90.0,-87.0,-88.0,25.0,25.0,22.0,28.0,1
1719,BA:8C:B9:54:50:24,3763526,474746237,300,89682,3763226,474656555,0,1247,140275,1229,137429,18,2846,200,4,415,6,0,8,229410.0,130000.0,-40.0,-37.0,-45.0,-51.0,-44.0,-37.0,-45.0,-48.0,-89.0,-90.0,-87.0,-88.0,49.0,53.0,42.0,37.0,1
1720,92:69:1D:31:68:E9,3776047,489919660,12821,15263105,3763226,474656555,3,19334,3595107,18635,3434310,699,160797,6474,105,14082,252,3,252,216660.0,130000.0,-52.0,-49.0,-44.0,-47.0,-51.0,-48.0,-43.0,-48.0,-89.0,-90.0,-87.0,-88.0,37.0,41.0,43.0,41.0,1
1721,CC:2F:71:3F:1F:24,3990635,740714523,227404,266057504,3763231,474657019,27,192037,220523331,191953,220512873,84,10458,183627,6,227404,21793,24,145,130000.0,43333.0,-67.0,-67.0,-71.0,-68.0,-67.0,-66.0,-71.0,-68.0,-89.0,-90.0,-87.0,-88.0,22.0,23.0,16.0,20.0,1
1722,CC:2F:71:3E:C5:1F,3763332,474669386,101,12367,3763231,474657019,0,391,33663,317,24745,74,8918,109,2,133,4,0,5,144444.0,39000.0,-64.0,-65.0,-65.0,-60.0,-68.0,-69.0,-65.0,-60.0,-89.0,-90.0,-87.0,-88.0,25.0,25.0,22.0,28.0,1
1723,BA:8C:B9:54:50:24,3763531,474746701,300,89682,3763231,474657019,0,1247,140275,1229,137429,18,2846,200,4,415,6,0,8,229410.0,130000.0,-40.0,-37.0,-45.0,-51.0,-44.0,-37.0,-45.0,-48.0,-89.0,-90.0,-87.0,-88.0,49.0,53.0,42.0,37.0,1
1724,92:69:1D:31:68:E9,3776056,489920528,12821,15263105,3763235,474657423,3,19334,3595107,18635,3434310,699,160797,6474,105,14082,252,3,252,216660.0,130000.0,-52.0,-49.0,-44.0,-47.0,-51.0,-48.0,-43.0,-48.0,-89.0,-90.0,-87.0,-88.0,37.0,41.0,43.0,41.0,1
1725,CC:2F:71:3F:1F:24,3990748,740836345,227513,266178922,3763235,474657423,27,192132,220639715,192048,220629257,84,10458,183718,6,227513,21802,24,145,130000.0,43333.0,-67.0,-67.0,-71.0,-68.0,-67.0,-66.0,-70.0,-68.0,-89.0,-90.0,-87.0,-88.0,22.0,23.0,16.0,20.0,1
1726,CC:2F:71:3E:C5:1F,3763336,474669790,101,12367,3763235,474657423,0,391,33663,317,24745,74,8918,109,2,133,4,0,5,144444.0,39000.0,-64.0,-65.0,-65.0,-60.0,-68.0,-69.0,-65.0,-60.0,-89.0,-90.0,-87.0,-88.0,25.0,25.0,22.0,28.0,1
1727,BA:8C:B9:54:50:24,3763535,474747105,300,89682,3763235,474657423,0,1247,140275,1229,137429,18,2846,200,4,415,6,0,8,229410.0,130000.0,-40.0,-37.0,-45.0,-51.0,-44.0,-37.0,-45.0,-48.0,-89.0,-90.0,-87.0,-88.0,49.0,53.0,42.0,37.0,1
1728,92:69:1D:31:68:E9,3776056,489920528,12821,15263105,3763235,474657423,3,19334,3595107,18635,3434310,699,160797,6474,105,14082,252,3,252,216660.0,130000.0,-52.0,-49.0,-44.0,-47.0,-51.0,-48.0,-43.0,-48.0,-89.0,-90.0,-87.0,-88.0,37.0,41.0,43.0,41.0,1
1729,CC:2F:71:3F:1F:24,3990867,740959956,227628,266302129,3763239,474657827,27,192234,220753179,192150,220742721,84,10458,183815,6,227627,21810,24,145,130000.0,43333.0,-67.0,-67.0,-71.0,-69.0,-67.0,-66.0,-70.0,-69.0,-89.0,-90.0,-87.0,-88.0,22.0,23.0,16.0,19.0,1
1730,CC:2F:71:3E:C5:1F,3763340,474670194,101,12367,3763239,474657827,0,391,33663,317,24745,74,8918,109,2,133,4,0,5,144444.0,39000.0,-64.0,-65.0,-65.0,-60.0,-68.0,-69.0,-65.0,-60.0,-89.0,-90.0,-87.0,-88.0,25.0,25.0,22.0,28.0,1
1731,BA:8C:B9:54:50:24,3763539,474747509,300,89682,3763239,474657827,0,1247,140275,1229,137429,18,2846,200,4,415,6,0,8,229410.0,130000.0,-40.0,-37.0,-45.0,-51.0,-44.0,-37.0,-45.0,-48.0,-89.0,-90.0,-87.0,-88.0,49.0,53.0,42.0,37.0,1
1732,92:69:1D:31:68:E9,3776060,489920932,12821,15263105,3763239,474657827,3,19334,3595107,18635,3434310,699,160797,6474,105,14082,252,3,252,216660.0,130000.0,-52.0,-49.0,-44.0,-47.0,-51.0,-48.0,-43.0,-48.0,-89.0,-90.0,-87.0,-88.0,37.0,41.0,43.0,41.0,1
1733,CC:2F:71:3F:1F:24,3990983,741083436,227739,266425145,3763244,474658291,27,192327,220869291,192243,220858833,84,10458,183906,6,227739,21816,24,145,130000.0,39000.0,-67.0,-67.0,-71.0,-69.0,-70.0,-70.0,-74.0,-72.0,-89.0,-90.0,-87.0,-88.0,22.0,23.0,16.0,19.0,1
1734,CC:2F:71:3E:C5:1F,3763346,474670774,102,12483,3763244,474658291,0,392,33733,318,24815,74,8918,109,2,134,4,0,5,144444.0,39000.0,-70.0,-70.0,-66.0,-60.0,-68.0,-69.0,-65.0,-60.0,-89.0,-90.0,-87.0,-88.0,19.0,20.0,21.0,28.0,1
1735,BA:8C:B9:54:50:24,3763545,474748089,301,89798,3763244,474658291,0,1248,140343,1230,137497,18,2846,200,4,416,6,0,8,229410.0,130000.0,-40.0,-37.0,-45.0,-51.0,-44.0,-37.0,-45.0,-48.0,-89.0,-90.0,-87.0,-88.0,49.0,53.0,42.0,37.0,1
1736,92:69:1D:31:68:E9,3776066,489921512,12822,15263221,3763244,474658291,3,19336,3595243,18637,3434446,699,160797,6474,105,14083,252,3,252,216660.0,130000.0,-53.0,-49.0,-42.0,-49.0,-52.0,-48.0,-43.0,-48.0,-89.0,-90.0,-87.0,-88.0,36.0,41.0,45.0,39.0,1
1737,CC:2F:71:3F:1F:24,3991093,741202044,227845,266543349,3763248,474658695,27,192418,220980975,192334,220970517,84,10458,183993,6,227845,21816,24,145,130000.0,43333.0,-67.0,-67.0,-71.0,-69.0,-67.0,-67.0,-71.0,-69.0,-89.0,-90.0,-87.0,-88.0,22.0,23.0,16.0,19.0,1
1738,CC:2F:71:3E:C5:1F,3763350,474671178,102,12483,3763248,474658695,0,393,33803,319,24885,74,8918,109,2,134,4,0,5,144444.0,39000.0,-70.0,-71.0,-66.0,-60.0,-68.0,-69.0,-65.0,-60.0,-89.0,-91.0,-87.0,-89.0,19.0,20.0,21.0,29.0,1
1739,BA:8C:B9:54:50:24,3763549,474748493,301,89798,3763248,474658695,0,1249,140411,1231,137565,18,2846,200,4,416,6,0,8,229410.0,130000.0,-40.0,-37.0,-45.0,-51.0,-43.0,-37.0,-44.0,-49.0,-89.0,-91.0,-87.0,-89.0,49.0,54.0,42.0,38.0,1
1740,92:69:1D:31:68:E9,3776070,489921916,12822,15263221,3763248,474658695,3,19336,3595243,18637,3434446,699,160797,6474,105,14083,252,3,252,216660.0,130000.0,-53.0,-49.0,-42.0,-49.0,-52.0,-48.0,-43.0,-48.0,-89.0,-91.0,-87.0,-89.0,36.0,42.0,45.0,40.0,1
1741,CC:2F:71:3F:1F:24,3991202,741320370,227950,266661271,3763252,474659099,27,192509,221094035,192425,221083577,84,10458,184080,6,227950,21821,24,145,130000.0,43333.0,-67.0,-67.0,-71.0,-69.0,-67.0,-67.0,-71.0,-69.0,-89.0,-91.0,-87.0,-89.0,22.0,24.0,16.0,20.0,1
1742,CC:2F:71:3E:C5:1F,3763355,474671642,102,12483,3763253,474659159,0,393,33803,319,24885,74,8918,109,2,134,4,0,5,144444.0,39000.0,-70.0,-71.0,-66.0,-60.0,-68.0,-69.0,-65.0,-60.0,-89.0,-91.0,-87.0,-89.0,19.0,20.0,21.0,29.0,1
1743,BA:8C:B9:54:50:24,3763554,474748957,301,89798,3763253,474659159,0,1249,140411,1231,137565,18,2846,200,4,416,6,0,8,229410.0,130000.0,-40.0,-37.0,-45.0,-51.0,-43.0,-37.0,-44.0,-49.0,-89.0,-91.0,-87.0,-89.0,49.0,54.0,42.0,38.0,1
1744,92:69:1D:31:68:E9,3776075,489922380,12822,15263221,3763253,474659159,3,19336,3595243,18637,3434446,699,160797,6474,105,14083,252,3,252,216660.0,130000.0,-53.0,-49.0,-42.0,-49.0,-52.0,-48.0,-43.0,-48.0,-89.0,-91.0,-87.0,-89.0,36.0,42.0,45.0,40.0,1
1745,CC:2F:71:3F:1F:24,3991319,741442451,228062,266782888,3763257,474659563,27,192611,221214614,192527,221204156,84,10458,184174,6,228062,21822,24,145,130000.0,43333.0,-67.0,-67.0,-71.0,-69.0,-67.0,-66.0,-70.0,-69.0,-89.0,-91.0,-87.0,-89.0,22.0,24.0,16.0,20.0,1
1746,CC:2F:71:3E:C5:1F,3763359,474672046,102,12483,3763257,474659563,0,393,33803,319,24885,74,8918,109,2,134,4,0,5,144444.0,39000.0,-70.0,-71.0,-66.0,-60.0,-68.0,-69.0,-65.0,-60.0,-89.0,-91.0,-87.0,-89.0,19.0,20.0,21.0,29.0,1
1747,BA:8C:B9:54:50:24,3763558,474749361,301,89798,3763257,474659563,0,1249,140411,1231,137565,18,2846,200,4,416,6,0,8,229410.0,130000.0,-40.0,-37.0,-45.0,-51.0,-43.0,-37.0,-44.0,-49.0,-89.0,-91.0,-87.0,-89.0,49.0,54.0,42.0,38.0,1
1748,92:69:1D:31:68:E9,3776079,489922784,12822,15263221,3763257,474659563,3,19336,3595243,18637,3434446,699,160797,6474,105,14083,252,3,252,216660.0,130000.0,-53.0,-49.0,-42.0,-49.0,-52.0,-48.0,-43.0,-48.0,-89.0,-91.0,-87.0,-89.0,36.0,42.0,45.0,40.0,1
1749,CC:2F:71:3F:1F:24,3991428,741560833,228167,266900866,3763261,474659967,27,192705,221328160,192621,221317702,84,10458,184261,6,228167,21827,24,145,130000.0,39000.0,-67.0,-67.0,-71.0,-69.0,-67.0,-67.0,-71.0,-69.0,-89.0,-91.0,-87.0,-89.0,22.0,24.0,16.0,20.0,1
1750,CC:2F:71:3E:C5:1F,3763363,474672450,102,12483,3763261,474659967,0,393,33803,319,24885,74,8918,109,2,134,4,0,5,144444.0,39000.0,-70.0,-71.0,-66.0,-60.0,-68.0,-69.0,-65.0,-60.0,-89.0,-91.0,-87.0,-89.0,19.0,20.0,21.0,29.0,1
1751,BA:8C:B9:54:50:24,3763562,474749765,301,89798,3763261,474659967,0,1249,140411,1231,137565,18,2846,200,4,416,6,0,8,229410.0,130000.0,-40.0,-37.0,-45.0,-51.0,-43.0,-37.0,-44.0,-49.0,-89.0,-91.0,-87.0,-89.0,49.0,54.0,42.0,38.0,1
1752,92:69:1D:31:68:E9,3776083,489923188,12822,15263221,3763261,474659967,3,19336,3595243,18637,3434446,699,160797,6474,105,14083,252,3,252,216660.0,130000.0,-53.0,-49.0,-42.0,-49.0,-52.0,-48.0,-43.0,-48.0,-89.0,-91.0,-87.0,-89.0,36.0,42.0,45.0,40.0,1
1753,CC:2F:71:3F:1F:24,3991539,741679349,228273,267018918,3763266,474660431,27,192798,221441480,192714,221431022,84,10458,184348,6,228273,21833,24,145,130000.0,39000.0,-68.0,-67.0,-71.0,-69.0,-67.0,-66.0,-71.0,-69.0,-89.0,-91.0,-87.0,-89.0,21.0,24.0,16.0,20.0,1
1754,CC:2F:71:3E:C5:1F,3763368,474672914,102,12483,3763266,474660431,0,393,33803,319,24885,74,8918,109,2,134,4,0,5,144444.0,39000.0,-70.0,-71.0,-66.0,-60.0,-68.0,-69.0,-65.0,-60.0,-89.0,-91.0,-87.0,-89.0,19.0,20.0,21.0,29.0,1
1755,BA:8C:B9:54:50:24,3763567,474750229,301,89798,3763266,474660431,0,1249,140411,1231,137565,18,2846,200,4,416,6,0,8,229410.0,130000.0,-40.0,-37.0,-45.0,-51.0,-43.0,-37.0,-44.0,-49.0,-89.0,-91.0,-87.0,-89.0,49.0,54.0,42.0,38.0,1
1756,92:69:1D:31:68:E9,3776088,489923652,12822,15263221,3763266,474660431,3,19336,3595243,18637,3434446,699,160797,6474,105,14083,252,3,252,216660.0,130000.0,-53.0,-49.0,-42.0,-49.0,-52.0,-48.0,-43.0,-48.0,-89.0,-91.0,-87.0,-89.0,36.0,42.0,45.0,40.0,1
1757,CC:2F:71:3F:1F:24,3991652,741799715,228380,267138692,3763272,474661023,27,192896,221562530,192811,221551954,85,10576,184438,6,228379,21833,24,145,130000.0,43333.0,-67.0,-67.0,-71.0,-68.0,-67.0,-67.0,-71.0,-68.0,-89.0,-91.0,-87.0,-89.0,22.0,24.0,16.0,21.0,1
1758,CC:2F:71:3E:C5:1F,3763374,474673506,102,12483,3763272,474661023,0,393,33803,319,24885,74,8918,109,2,134,4,0,5,144444.0,39000.0,-70.0,-71.0,-66.0,-60.0,-68.0,-69.0,-65.0,-60.0,-89.0,-91.0,-87.0,-89.0,19.0,20.0,21.0,29.0,1
1759,BA:8C:B9:54:50:24,3763573,474750821,301,89798,3763272,474661023,0,1249,140411,1231,137565,18,2846,200,4,416,6,0,8,229410.0,130000.0,-40.0,-37.0,-45.0,-51.0,-43.0,-37.0,-44.0,-49.0,-89.0,-91.0,-87.0,-89.0,49.0,54.0,42.0,38.0,1
1760,92:69:1D:31:68:E9,3776094,489924244,12822,15263221,3763272,474661023,3,19336,3595243,18637,3434446,699,160797,6474,105,14083,252,3,252,216660.0,130000.0,-53.0,-49.0,-42.0,-49.0,-52.0,-48.0,-43.0,-48.0,-89.0,-91.0,-87.0,-89.0,36.0,42.0,45.0,40.0,1
1761,CC:2F:71:3F:1F:24,3991771,741922045,228494,267260345,3763277,474661700,27,192995,221674119,192910,221663543,85,10576,184536,6,228494,21837,24,145,130000.0,43333.0,-68.0,-67.0,-72.0,-69.0,-70.0,-69.0,-73.0,-71.0,-89.0,-91.0,-87.0,-89.0,21.0,24.0,15.0,20.0,1
1762,CC:2F:71:3E:C5:1F,3763379,474674183,102,12483,3763277,474661700,0,393,33803,319,24885,74,8918,109,2,134,4,0,5,144444.0,39000.0,-70.0,-71.0,-66.0,-60.0,-68.0,-69.0,-65.0,-60.0,-89.0,-91.0,-87.0,-89.0,19.0,20.0,21.0,29.0,1
1763,BA:8C:B9:54:50:24,3763578,474751498,301,89798,3763277,474661700,0,1249,140411,1231,137565,18,2846,200,4,416,6,0,8,229410.0,130000.0,-40.0,-37.0,-45.0,-51.0,-43.0,-37.0,-44.0,-49.0,-89.0,-91.0,-87.0,-89.0,49.0,54.0,42.0,38.0,1
1764,92:69:1D:31:68:E9,3776099,489924921,12822,15263221,3763277,474661700,3,19336,3595243,18637,3434446,699,160797,6474,105,14083,252,3,252,216660.0,130000.0,-53.0,-49.0,-42.0,-49.0,-52.0,-48.0,-43.0,-48.0,-89.0,-91.0,-87.0,-89.0,36.0,42.0,45.0,40.0,1
1765,CC:2F:71:3F:1F:24,3991885,742042531,228602,267380305,3763283,474662226,27,193090,221790519,193005,221779943,85,10576,184625,6,228602,21837,24,145,130000.0,43333.0,-67.0,-67.0,-72.0,-69.0,-67.0,-67.0,-71.0,-69.0,-89.0,-91.0,-87.0,-89.0,22.0,24.0,15.0,20.0,1
1766,CC:2F:71:3E:C5:1F,3763385,474674709,102,12483,3763283,474662226,0,394,33921,319,24885,75,9036,110,2,134,4,0,5,144444.0,39000.0,-70.0,-71.0,-66.0,-60.0,-69.0,-70.0,-65.0,-60.0,-89.0,-91.0,-87.0,-89.0,19.0,20.0,21.0,29.0,1
1767,BA:8C:B9:54:50:24,3763584,474752024,301,89798,3763283,474662226,0,1249,140411,1231,137565,18,2846,200,4,416,6,0,8,229410.0,130000.0,-40.0,-37.0,-45.0,-51.0,-43.0,-37.0,-44.0,-49.0,-89.0,-91.0,-87.0,-89.0,49.0,54.0,42.0,38.0,1
1768,92:69:1D:31:68:E9,3776105,489925447,12822,15263221,3763283,474662226,3,19336,3595243,18637,3434446,699,160797,6474,105,14083,252,3,252,216660.0,130000.0,-53.0,-49.0,-42.0,-49.0,-52.0,-48.0,-43.0,-48.0,-89.0,-91.0,-87.0,-89.0,36.0,42.0,45.0,40.0,1
1769,CC:2F:71:3F:1F:24,3991995,742162677,228710,267500249,3763285,474662428,27,193182,221905119,193097,221894543,85,10576,184713,6,228710,21837,24,145,130000.0,43333.0,-70.0,-70.0,-74.0,-72.0,-69.0,-69.0,-73.0,-71.0,-89.0,-91.0,-87.0,-89.0,19.0,21.0,13.0,17.0,1
1770,CC:2F:71:3E:C5:1F,3763387,474674911,102,12483,3763285,474662428,0,395,33991,320,24955,75,9036,110,2,134,4,0,5,144444.0,39000.0,-70.0,-71.0,-66.0,-60.0,-69.0,-70.0,-65.0,-60.0,-89.0,-91.0,-87.0,-89.0,19.0,20.0,21.0,29.0,1
1771,BA:8C:B9:54:50:24,3763588,474752428,301,89798,3763287,474662630,0,1249,140411,1231,137565,18,2846,200,4,416,6,0,8,229410.0,130000.0,-40.0,-37.0,-45.0,-51.0,-43.0,-37.0,-44.0,-49.0,-89.0,-91.0,-87.0,-89.0,49.0,54.0,42.0,38.0,1
1772,92:69:1D:31:68:E9,3776109,489925851,12822,15263221,3763287,474662630,3,19336,3595243,18637,3434446,699,160797,6474,105,14083,252,3,252,216660.0,130000.0,-53.0,-49.0,-42.0,-49.0,-52.0,-48.0,-43.0,-48.0,-89.0,-91.0,-87.0,-89.0,36.0,42.0,45.0,40.0,1
1773,CC:2F:71:3F:1F:24,3992107,742279911,228816,267616877,3763291,474663034,27,193273,222018193,193188,222007617,85,10576,184799,6,228816,21841,24,145,130000.0,43333.0,-70.0,-70.0,-74.0,-72.0,-69.0,-69.0,-73.0,-71.0,-89.0,-91.0,-87.0,-89.0,19.0,21.0,13.0,17.0,1
1774,CC:2F:71:3E:C5:1F,3763394,474675577,102,12483,3763292,474663094,0,395,33991,320,24955,75,9036,110,2,134,4,0,5,144444.0,39000.0,-70.0,-71.0,-66.0,-60.0,-69.0,-70.0,-65.0,-60.0,-89.0,-91.0,-87.0,-89.0,19.0,20.0,21.0,29.0,1
1775,BA:8C:B9:54:50:24,3763593,474752892,301,89798,3763292,474663094,0,1249,140411,1231,137565,18,2846,200,4,416,6,0,8,229410.0,130000.0,-40.0,-37.0,-45.0,-51.0,-43.0,-37.0,-44.0,-49.0,-89.0,-91.0,-87.0,-89.0,49.0,54.0,42.0,38.0,1
1776,92:69:1D:31:68:E9,3776114,489926315,12822,15263221,3763292,474663094,3,19336,3595243,18637,3434446,699,160797,6474,105,14083,252,3,252,216660.0,130000.0,-53.0,-49.0,-42.0,-49.0,-52.0,-48.0,-43.0,-48.0,-89.0,-91.0,-87.0,-89.0,36.0,42.0,45.0,40.0,1
1777,CC:2F:71:3F:1F:24,3992223,742401920,228929,267738624,3763294,474663296,27,193372,222129819,193287,222119243,85,10576,184895,6,228929,21842,24,145,130000.0,43333.0,-70.0,-70.0,-74.0,-72.0,-69.0,-69.0,-73.0,-71.0,-89.0,-91.0,-87.0,-89.0,19.0,21.0,13.0,17.0,1
1778,CC:2F:71:3E:C5:1F,3763396,474675779,102,12483,3763294,474663296,0,395,33991,320,24955,75,9036,110,2,134,4,0,5,144444.0,39000.0,-70.0,-71.0,-66.0,-60.0,-69.0,-70.0,-65.0,-60.0,-89.0,-91.0,-87.0,-89.0,19.0,20.0,21.0,29.0,1
1779,BA:8C:B9:54:50:24,3763597,474753296,301,89798,3763296,474663498,0,1249,140411,1231,137565,18,2846,200,4,416,6,0,8,229410.0,130000.0,-40.0,-37.0,-45.0,-51.0,-43.0,-37.0,-44.0,-49.0,-89.0,-91.0,-87.0,-89.0,49.0,54.0,42.0,38.0,1
1780,92:69:1D:31:68:E9,3776118,489926719,12822,15263221,3763296,474663498,3,19337,3595311,18638,3434514,699,160797,6474,105,14083,252,3,252,216660.0,130000.0,-53.0,-49.0,-42.0,-49.0,-52.0,-48.0,-43.0,-48.0,-89.0,-91.0,-87.0,-89.0,36.0,42.0,45.0,40.0,1
1781,CC:2F:71:3F:1F:24,3992359,742531843,229036,267856918,3763323,474674925,27,193466,222243227,193381,222232651,85,10576,184985,6,229036,21851,24,145,117000.0,39000.0,-70.0,-70.0,-74.0,-72.0,-69.0,-68.0,-73.0,-70.0,-89.0,-91.0,-87.0,-89.0,19.0,21.0,13.0,17.0,1
1782,CC:2F:71:3E:C5:1F,3763425,474687408,102,12483,3763323,474674925,0,395,33991,320,24955,75,9036,110,2,134,4,0,5,144444.0,39000.0,-70.0,-71.0,-66.0,-60.0,-69.0,-70.0,-65.0,-60.0,-89.0,-91.0,-87.0,-89.0,19.0,20.0,21.0,29.0,1
1783,BA:8C:B9:54:50:24,3763624,474764723,301,89798,3763323,474674925,0,1249,140411,1231,137565,18,2846,200,4,416,6,0,8,229410.0,130000.0,-40.0,-37.0,-45.0,-51.0,-43.0,-37.0,-44.0,-49.0,-89.0,-91.0,-87.0,-89.0,49.0,54.0,42.0,38.0,1
1784,92:69:1D:31:68:E9,3776145,489938146,12822,15263221,3763323,474674925,3,19340,3595682,18640,3434650,700,161032,6475,105,14083,252,3,252,216660.0,130000.0,-53.0,-49.0,-43.0,-49.0,-52.0,-49.0,-43.0,-48.0,-89.0,-91.0,-87.0,-89.0,36.0,42.0,44.0,40.0,1
1785,CC:2F:71:3F:1F:24,3992468,742651693,229142,267976506,3763326,474675187,27,193558,222353621,193473,222343045,85,10576,185074,6,229142,21851,24,145,130000.0,43333.0,-71.0,-70.0,-74.0,-72.0,-70.0,-70.0,-74.0,-71.0,-89.0,-91.0,-87.0,-89.0,18.0,21.0,13.0,17.0,1
1786,CC:2F:71:3E:C5:1F,3763428,474687670,102,12483,3763326,474675187,0,395,33991,320,24955,75,9036,110,2,134,4,0,5,144444.0,39000.0,-70.0,-71.0,-66.0,-60.0,-69.0,-70.0,-65.0,-60.0,-89.0,-91.0,-87.0,-89.0,19.0,20.0,21.0,29.0,1
1787,BA:8C:B9:54:50:24,3763627,474764985,301,89798,3763326,474675187,0,1249,140411,1231,137565,18,2846,200,4,416,6,0,8,229410.0,130000.0,-40.0,-37.0,-45.0,-51.0,-43.0,-37.0,-44.0,-49.0,-89.0,-91.0,-87.0,-89.0,49.0,54.0,42.0,38.0,1
1788,92:69:1D:31:68:E9,3776150,489938610,12822,15263221,3763328,474675389,3,19340,3595682,18640,3434650,700,161032,6475,105,14083,252,3,252,216660.0,130000.0,-53.0,-49.0,-43.0,-49.0,-52.0,-49.0,-43.0,-48.0,-89.0,-91.0,-87.0,-89.0,36.0,42.0,44.0,40.0,1
1789,CC:2F:71:3F:1F:24,3992581,742769389,229247,268093228,3763334,474676161,27,193646,222460657,193561,222450081,85,10576,185160,6,229247,21851,24,145,130000.0,43333.0,-73.0,-72.0,-77.0,-74.0,-71.0,-70.0,-75.0,-72.0,-89.0,-91.0,-87.0,-88.0,16.0,19.0,10.0,14.0,1
1790,CC:2F:71:3E:C5:1F,3763436,474688644,102,12483,3763334,474676161,0,395,33991,320,24955,75,9036,110,2,134,4,0,5,144444.0,39000.0,-70.0,-71.0,-66.0,-60.0,-69.0,-70.0,-65.0,-60.0,-89.0,-91.0,-87.0,-88.0,19.0,20.0,21.0,28.0,1
1791,BA:8C:B9:54:50:24,3763635,474765959,301,89798,3763334,474676161,0,1253,140683,1235,137837,18,2846,200,5,417,7,0,8,229410.0,130000.0,-40.0,-37.0,-45.0,-51.0,-43.0,-36.0,-43.0,-48.0,-89.0,-91.0,-87.0,-88.0,49.0,54.0,42.0,37.0,1
1792,92:69:1D:31:68:E9,3776156,489939382,12822,15263221,3763334,474676161,3,19340,3595682,18640,3434650,700,161032,6475,105,14083,252,3,252,216660.0,130000.0,-53.0,-49.0,-43.0,-49.0,-52.0,-49.0,-43.0,-48.0,-89.0,-91.0,-87.0,-88.0,36.0,42.0,44.0,39.0,1
1793,CC:2F:71:3F:1F:24,3992697,742892668,229361,268216305,3763336,474676363,27,193747,222578287,193662,222567711,85,10576,185255,6,229360,21855,24,146,130000.0,43333.0,-67.0,-66.0,-71.0,-68.0,-67.0,-66.0,-71.0,-68.0,-89.0,-91.0,-87.0,-88.0,22.0,25.0,16.0,20.0,1
1794,CC:2F:71:3E:C5:1F,3763438,474688846,102,12483,3763336,474676363,0,395,33991,320,24955,75,9036,110,2,134,4,0,5,144444.0,39000.0,-70.0,-71.0,-66.0,-60.0,-69.0,-70.0,-65.0,-60.0,-89.0,-91.0,-87.0,-88.0,19.0,20.0,21.0,28.0,1
1795,BA:8C:B9:54:50:24,3763637,474766161,301,89798,3763336,474676363,0,1253,140683,1235,137837,18,2846,200,5,417,7,0,8,229410.0,130000.0,-40.0,-37.0,-45.0,-51.0,-43.0,-36.0,-43.0,-48.0,-89.0,-91.0,-87.0,-88.0,49.0,54.0,42.0,37.0,1
1796,92:69:1D:31:68:E9,3776160,489939786,12822,15263221,3763338,474676565,3,19340,3595682,18640,3434650,700,161032,6475,105,14083,252,3,252,216660.0,130000.0,-53.0,-49.0,-43.0,-49.0,-52.0,-49.0,-43.0,-48.0,-89.0,-91.0,-87.0,-88.0,36.0,42.0,44.0,39.0,1
1797,CC:2F:71:3F:1F:24,3992811,743011740,229468,268334711,3763343,474677029,27,193844,222699329,193759,222688753,85,10576,185343,6,229468,21855,24,146,130000.0,43333.0,-70.0,-70.0,-75.0,-72.0,-70.0,-70.0,-74.0,-72.0,-89.0,-91.0,-87.0,-88.0,19.0,21.0,12.0,16.0,1
1798,CC:2F:71:3E:C5:1F,3763445,474689512,102,12483,3763343,474677029,0,395,33991,320,24955,75,9036,110,2,134,4,0,5,144444.0,39000.0,-70.0,-71.0,-66.0,-60.0,-69.0,-70.0,-65.0,-60.0,-89.0,-91.0,-87.0,-88.0,19.0,20.0,21.0,28.0,1
1799,BA:8C:B9:54:50:24,3763644,474766827,301,89798,3763343,474677029,0,1253,140683,1235,137837,18,2846,200,5,417,7,0,8,229410.0,130000.0,-40.0,-37.0,-45.0,-51.0,-43.0,-36.0,-43.0,-48.0,-89.0,-91.0,-87.0,-88.0,49.0,54.0,42.0,37.0,1
1800,92:69:1D:31:68:E9,3776165,489940250,12822,15263221,3763343,474677029,3,19340,3595682,18640,3434650,700,161032,6475,105,14083,252,3,252,216660.0,130000.0,-53.0,-49.0,-43.0,-49.0,-52.0,-49.0,-43.0,-48.0,-89.0,-91.0,-87.0,-88.0,36.0,42.0,44.0,39.0,1
1801,CC:2F:71:3F:1F:24,3992920,743131604,229575,268454373,3763345,474677231,27,193940,222817455,193855,222806879,85,10576,185430,6,229575,21869,24,146,130000.0,39000.0,-67.0,-67.0,-71.0,-70.0,-68.0,-68.0,-72.0,-71.0,-89.0,-91.0,-87.0,-88.0,22.0,24.0,16.0,18.0,1
1802,CC:2F:71:3E:C5:1F,3763447,474689714,102,12483,3763345,474677231,0,395,33991,320,24955,75,9036,110,2,134,4,0,5,144444.0,39000.0,-70.0,-71.0,-66.0,-60.0,-69.0,-70.0,-65.0,-60.0,-89.0,-91.0,-87.0,-88.0,19.0,20.0,21.0,28.0,1
1803,BA:8C:B9:54:50:24,3763646,474767029,301,89798,3763345,474677231,0,1253,140683,1235,137837,18,2846,200,5,417,7,0,8,229410.0,130000.0,-40.0,-37.0,-45.0,-51.0,-43.0,-36.0,-43.0,-48.0,-89.0,-91.0,-87.0,-88.0,49.0,54.0,42.0,37.0,1
1804,92:69:1D:31:68:E9,3776167,489940452,12822,15263221,3763345,474677231,3,19340,3595682,18640,3434650,700,161032,6475,105,14083,252,3,252,216660.0,130000.0,-53.0,-49.0,-43.0,-49.0,-52.0,-49.0,-43.0,-48.0,-89.0,-91.0,-87.0,-88.0,36.0,42.0,44.0,39.0,1
1805,CC:2F:71:3F:1F:24,3993030,743249836,229681,268572201,3763349,474677635,27,194044,222942227,193959,222931651,85,10576,185520,6,229680,21900,24,146,130000.0,39000.0,-71.0,-70.0,-74.0,-73.0,-70.0,-70.0,-74.0,-73.0,-89.0,-91.0,-87.0,-88.0,18.0,21.0,13.0,15.0,1
1806,CC:2F:71:3E:C5:1F,3763453,474690320,102,12483,3763351,474677837,0,395,33991,320,24955,75,9036,110,2,134,4,0,5,144444.0,39000.0,-70.0,-71.0,-66.0,-60.0,-69.0,-70.0,-65.0,-60.0,-89.0,-91.0,-87.0,-88.0,19.0,20.0,21.0,28.0,1
1807,BA:8C:B9:54:50:24,3763653,474767695,301,89798,3763352,474677897,0,1253,140683,1235,137837,18,2846,200,5,417,7,0,8,229410.0,130000.0,-40.0,-37.0,-45.0,-51.0,-43.0,-36.0,-43.0,-48.0,-89.0,-91.0,-87.0,-88.0,49.0,54.0,42.0,37.0,1
1808,92:69:1D:31:68:E9,3776174,489941118,12822,15263221,3763352,474677897,3,19340,3595682,18640,3434650,700,161032,6475,105,14083,252,3,252,216660.0,130000.0,-53.0,-49.0,-43.0,-49.0,-52.0,-49.0,-43.0,-48.0,-89.0,-91.0,-87.0,-88.0,36.0,42.0,44.0,39.0,1
1809,CC:2F:71:3F:1F:24,3993151,743377853,229797,268699754,3763354,474678099,27,194162,223073012,194077,223062436,85,10576,185625,6,229797,21947,24,146,130000.0,43333.0,-71.0,-70.0,-75.0,-73.0,-69.0,-69.0,-73.0,-72.0,-89.0,-91.0,-87.0,-88.0,18.0,21.0,12.0,15.0,1
1810,CC:2F:71:3E:C5:1F,3763456,474690582,102,12483,3763354,474678099,0,395,33991,320,24955,75,9036,110,2,134,4,0,5,144444.0,39000.0,-70.0,-71.0,-66.0,-60.0,-69.0,-70.0,-65.0,-60.0,-89.0,-91.0,-87.0,-88.0,19.0,20.0,21.0,28.0,1
1811,BA:8C:B9:54:50:24,3763655,474767897,301,89798,3763354,474678099,0,1256,140887,1238,138041,18,2846,200,5,417,7,0,8,229410.0,130000.0,-48.0,-35.0,-42.0,-45.0,-43.0,-36.0,-43.0,-48.0,-89.0,-91.0,-87.0,-88.0,41.0,56.0,45.0,43.0,1
1812,92:69:1D:31:68:E9,3776176,489941320,12822,15263221,3763354,474678099,3,19340,3595682,18640,3434650,700,161032,6475,105,14083,252,3,252,216660.0,130000.0,-53.0,-49.0,-43.0,-49.0,-52.0,-49.0,-43.0,-48.0,-89.0,-91.0,-87.0,-88.0,36.0,42.0,44.0,39.0,1
1813,CC:2F:71:3F:1F:24,3993261,743496396,229902,268817620,3763359,474678776,27,194253,223186072,194168,223175496,85,10576,185712,6,229902,21985,24,146,115556.0,28889.0,-70.0,-70.0,-75.0,-73.0,-70.0,-69.0,-74.0,-72.0,-89.0,-91.0,-87.0,-88.0,19.0,21.0,12.0,15.0,1
1814,CC:2F:71:3E:C5:1F,3763463,474691461,102,12483,3763361,474678978,0,395,33991,320,24955,75,9036,110,2,134,4,0,5,144444.0,39000.0,-70.0,-71.0,-66.0,-60.0,-69.0,-70.0,-65.0,-60.0,-89.0,-91.0,-87.0,-88.0,19.0,20.0,21.0,28.0,1
1815,BA:8C:B9:54:50:24,3763662,474768776,301,89798,3763361,474678978,0,1257,140955,1239,138109,18,2846,200,5,417,7,0,8,229410.0,130000.0,-40.0,-37.0,-45.0,-51.0,-43.0,-36.0,-43.0,-48.0,-89.0,-91.0,-87.0,-88.0,49.0,54.0,42.0,37.0,1
1816,92:69:1D:31:68:E9,3776183,489942199,12822,15263221,3763361,474678978,3,19340,3595682,18640,3434650,700,161032,6475,105,14083,252,3,252,216660.0,130000.0,-53.0,-49.0,-43.0,-49.0,-52.0,-49.0,-43.0,-48.0,-89.0,-91.0,-87.0,-88.0,36.0,42.0,44.0,39.0,1
1817,CC:2F:71:3F:1F:24,3993371,743613582,230007,268934342,3763364,474679240,27,194345,223299324,194260,223288748,85,10576,185798,6,230007,21985,24,146,115556.0,28889.0,-67.0,-67.0,-71.0,-69.0,-69.0,-68.0,-73.0,-71.0,-89.0,-91.0,-87.0,-88.0,22.0,24.0,16.0,19.0,1
1818,CC:2F:71:3E:C5:1F,3763466,474691723,102,12483,3763364,474679240,0,395,33991,320,24955,75,9036,110,2,134,4,0,5,144444.0,39000.0,-70.0,-71.0,-66.0,-60.0,-69.0,-70.0,-65.0,-60.0,-89.0,-91.0,-87.0,-88.0,19.0,20.0,21.0,28.0,1
1819,BA:8C:B9:54:50:24,3763665,474769038,301,89798,3763364,474679240,0,1257,140955,1239,138109,18,2846,200,5,417,7,0,8,229410.0,130000.0,-40.0,-37.0,-45.0,-51.0,-43.0,-36.0,-43.0,-48.0,-89.0,-91.0,-87.0,-88.0,49.0,54.0,42.0,37.0,1
1820,92:69:1D:31:68:E9,3776186,489942461,12822,15263221,3763364,474679240,3,19340,3595682,18640,3434650,700,161032,6475,105,14083,252,3,252,216660.0,130000.0,-53.0,-49.0,-43.0,-49.0,-52.0,-49.0,-43.0,-48.0,-89.0,-91.0,-87.0,-88.0,36.0,42.0,44.0,39.0,1
1821,CC:2F:71:3F:1F:24,3993483,743733722,230115,269054078,3763368,474679644,27,194441,223420140,194356,223409564,85,10576,185886,6,230115,21995,24,146,115556.0,28889.0,-71.0,-70.0,-75.0,-72.0,-70.0,-69.0,-74.0,-72.0,-89.0,-91.0,-87.0,-88.0,18.0,21.0,12.0,16.0,1
1822,CC:2F:71:3E:C5:1F,3763472,474692329,102,12483,3763370,474679846,0,395,33991,320,24955,75,9036,110,2,134,4,0,5,144444.0,39000.0,-70.0,-71.0,-66.0,-60.0,-69.0,-70.0,-65.0,-60.0,-89.0,-91.0,-87.0,-88.0,19.0,20.0,21.0,28.0,1
1823,BA:8C:B9:54:50:24,3763671,474769644,301,89798,3763370,474679846,0,1257,140955,1239,138109,18,2846,200,5,417,7,0,8,229410.0,130000.0,-40.0,-37.0,-45.0,-51.0,-43.0,-36.0,-43.0,-48.0,-89.0,-91.0,-87.0,-88.0,49.0,54.0,42.0,37.0,1
1824,92:69:1D:31:68:E9,3776192,489943067,12822,15263221,3763370,474679846,3,19340,3595682,18640,3434650,700,161032,6475,105,14083,252,3,252,216660.0,130000.0,-53.0,-49.0,-43.0,-49.0,-52.0,-49.0,-43.0,-48.0,-89.0,-91.0,-87.0,-88.0,36.0,42.0,44.0,39.0,1
1825,CC:2F:71:3F:1F:24,3993604,743863515,230232,269183467,3763372,474680048,27,194545,223540958,194460,223530382,85,10576,185985,6,230232,21995,24,146,115556.0,28889.0,-70.0,-70.0,-74.0,-72.0,-69.0,-69.0,-73.0,-72.0,-89.0,-91.0,-87.0,-88.0,19.0,21.0,13.0,16.0,1
1826,CC:2F:71:3E:C5:1F,3763474,474692531,102,12483,3763372,474680048,0,395,33991,320,24955,75,9036,110,2,134,4,0,5,144444.0,39000.0,-70.0,-71.0,-66.0,-60.0,-69.0,-70.0,-65.0,-60.0,-89.0,-91.0,-87.0,-88.0,19.0,20.0,21.0,28.0,1
1827,BA:8C:B9:54:50:24,3763673,474769846,301,89798,3763372,474680048,0,1257,140955,1239,138109,18,2846,200,5,417,7,0,8,229410.0,130000.0,-40.0,-37.0,-45.0,-51.0,-43.0,-36.0,-43.0,-48.0,-89.0,-91.0,-87.0,-88.0,49.0,54.0,42.0,37.0,1
1828,92:69:1D:31:68:E9,3776194,489943269,12822,15263221,3763372,474680048,3,19340,3595682,18640,3434650,700,161032,6475,105,14083,252,3,252,216660.0,130000.0,-53.0,-49.0,-43.0,-49.0,-52.0,-49.0,-43.0,-48.0,-89.0,-91.0,-87.0,-88.0,36.0,42.0,44.0,39.0,1
1829,CC:2F:71:3F:1F:24,3993716,743985121,230339,269304609,3763377,474680512,27,194639,223655856,194554,223645280,85,10576,186076,6,230339,22005,24,146,104000.0,26000.0,-67.0,-67.0,-72.0,-70.0,-69.0,-68.0,-73.0,-71.0,-89.0,-91.0,-87.0,-88.0,22.0,24.0,15.0,18.0,1
1830,CC:2F:71:3E:C5:1F,3763481,474693197,102,12483,3763379,474680714,0,395,33991,320,24955,75,9036,110,2,134,4,0,5,144444.0,39000.0,-70.0,-71.0,-66.0,-60.0,-69.0,-70.0,-65.0,-60.0,-89.0,-91.0,-87.0,-88.0,19.0,20.0,21.0,28.0,1
1831,BA:8C:B9:54:50:24,3763680,474770512,301,89798,3763379,474680714,0,1257,140955,1239,138109,18,2846,200,5,417,7,0,8,229410.0,130000.0,-40.0,-37.0,-45.0,-51.0,-43.0,-36.0,-43.0,-48.0,-89.0,-91.0,-87.0,-88.0,49.0,54.0,42.0,37.0,1
1832,92:69:1D:31:68:E9,3776201,489943935,12822,15263221,3763379,474680714,3,19340,3595682,18640,3434650,700,161032,6475,105,14083,252,3,252,216660.0,130000.0,-53.0,-49.0,-43.0,-49.0,-52.0,-49.0,-43.0,-48.0,-89.0,-91.0,-87.0,-88.0,36.0,42.0,44.0,39.0,1
1833,CC:2F:71:3F:1F:24,3993827,744103819,230446,269422903,3763381,474680916,27,194736,223778240,194651,223767664,85,10576,186163,6,230446,22005,24,146,115556.0,28889.0,-70.0,-70.0,-74.0,-72.0,-70.0,-70.0,-74.0,-72.0,-89.0,-91.0,-87.0,-88.0,19.0,21.0,13.0,16.0,1
1834,CC:2F:71:3E:C5:1F,3763483,474693399,102,12483,3763381,474680916,0,395,33991,320,24955,75,9036,110,2,134,4,0,5,144444.0,39000.0,-70.0,-71.0,-66.0,-60.0,-69.0,-70.0,-65.0,-60.0,-89.0,-91.0,-87.0,-88.0,19.0,20.0,21.0,28.0,1
1835,BA:8C:B9:54:50:24,3763682,474770714,301,89798,3763381,474680916,0,1257,140955,1239,138109,18,2846,200,5,417,7,0,8,229410.0,130000.0,-40.0,-37.0,-45.0,-51.0,-43.0,-36.0,-43.0,-48.0,-89.0,-91.0,-87.0,-88.0,49.0,54.0,42.0,37.0,1
1836,92:69:1D:31:68:E9,3776203,489944137,12822,15263221,3763381,474680916,3,19340,3595682,18640,3434650,700,161032,6475,105,14083,252,3,252,216660.0,130000.0,-53.0,-49.0,-43.0,-49.0,-52.0,-49.0,-43.0,-48.0,-89.0,-91.0,-87.0,-88.0,36.0,42.0,44.0,39.0,1
1837,CC:2F:71:3F:1F:24,3993939,744225551,230554,269544231,3763385,474681320,27,194832,223897714,194747,223887138,85,10576,186252,6,230554,22009,24,146,117000.0,39000.0,-68.0,-67.0,-72.0,-70.0,-69.0,-68.0,-73.0,-71.0,-89.0,-91.0,-87.0,-88.0,21.0,24.0,15.0,18.0,1
1838,CC:2F:71:3E:C5:1F,3763489,474694005,102,12483,3763387,474681522,0,395,33991,320,24955,75,9036,110,2,134,4,0,5,144444.0,39000.0,-70.0,-71.0,-66.0,-60.0,-69.0,-70.0,-65.0,-60.0,-89.0,-91.0,-87.0,-88.0,19.0,20.0,21.0,28.0,1
1839,BA:8C:B9:54:50:24,3763689,474771380,301,89798,3763388,474681582,0,1257,140955,1239,138109,18,2846,200,5,417,7,0,8,229410.0,130000.0,-40.0,-37.0,-45.0,-51.0,-43.0,-36.0,-43.0,-48.0,-89.0,-91.0,-87.0,-88.0,49.0,54.0,42.0,37.0,1
1840,92:69:1D:31:68:E9,3776210,489944803,12822,15263221,3763388,474681582,3,19340,3595682,18640,3434650,700,161032,6475,105,14083,252,3,252,216660.0,130000.0,-53.0,-49.0,-43.0,-49.0,-52.0,-49.0,-43.0,-48.0,-89.0,-91.0,-87.0,-88.0,36.0,42.0,44.0,39.0,1
1841,CC:2F:71:3F:1F:24,3994061,744349230,230671,269667446,3763390,474681784,27,194935,224014221,194850,224003645,85,10576,186349,6,230671,22034,24,146,130000.0,43333.0,-71.0,-70.0,-75.0,-72.0,-70.0,-69.0,-74.0,-72.0,-89.0,-91.0,-87.0,-89.0,18.0,21.0,12.0,17.0,1
1842,CC:2F:71:3E:C5:1F,3763493,474694383,103,12599,3763390,474681784,0,397,34131,322,25095,75,9036,110,2,135,4,0,5,144444.0,39000.0,-70.0,-71.0,-66.0,-60.0,-69.0,-70.0,-66.0,-60.0,-89.0,-91.0,-87.0,-89.0,19.0,20.0,21.0,29.0,1
1843,BA:8C:B9:54:50:24,3763692,474771698,302,89914,3763390,474681784,0,1259,141091,1241,138245,18,2846,200,5,418,7,0,8,229410.0,130000.0,-40.0,-37.0,-45.0,-51.0,-43.0,-36.0,-44.0,-48.0,-89.0,-91.0,-87.0,-89.0,49.0,54.0,42.0,38.0,1
1844,92:69:1D:31:68:E9,3776213,489945121,12823,15263337,3763390,474681784,3,19342,3595818,18642,3434786,700,161032,6475,105,14084,252,3,252,216660.0,130000.0,-54.0,-49.0,-43.0,-49.0,-52.0,-49.0,-43.0,-48.0,-89.0,-91.0,-87.0,-89.0,35.0,42.0,44.0,40.0,1
1845,CC:2F:71:3F:1F:24,3994172,744467816,230778,269785628,3763394,474682188,27,195025,224124317,194940,224113741,85,10576,186435,6,230778,22064,24,146,130000.0,43333.0,-75.0,-75.0,-79.0,-78.0,-70.0,-70.0,-74.0,-73.0,-89.0,-91.0,-87.0,-89.0,14.0,16.0,8.0,11.0,1
1846,CC:2F:71:3E:C5:1F,3763497,474694787,103,12599,3763394,474682188,0,397,34131,322,25095,75,9036,110,2,135,4,0,5,144444.0,39000.0,-70.0,-71.0,-66.0,-60.0,-69.0,-70.0,-66.0,-60.0,-89.0,-91.0,-87.0,-89.0,19.0,20.0,21.0,29.0,1
1847,BA:8C:B9:54:50:24,3763696,474772102,302,89914,3763394,474682188,0,1259,141091,1241,138245,18,2846,200,5,418,7,0,8,229410.0,130000.0,-40.0,-37.0,-45.0,-51.0,-43.0,-36.0,-44.0,-48.0,-89.0,-91.0,-87.0,-89.0,49.0,54.0,42.0,38.0,1
1848,92:69:1D:31:68:E9,3776219,489945727,12823,15263337,3763396,474682390,3,19342,3595818,18642,3434786,700,161032,6475,105,14084,252,3,252,216660.0,130000.0,-54.0,-49.0,-43.0,-49.0,-52.0,-49.0,-43.0,-48.0,-89.0,-91.0,-87.0,-89.0,35.0,42.0,44.0,40.0,1
1849,CC:2F:71:3F:1F:24,3994283,744586556,230884,269903904,3763399,474682652,27,195121,224245147,195036,224234571,85,10576,186522,6,230884,22080,24,146,130000.0,43333.0,-68.0,-67.0,-72.0,-70.0,-67.0,-67.0,-71.0,-69.0,-89.0,-91.0,-87.0,-89.0,21.0,24.0,15.0,19.0,1
1850,CC:2F:71:3E:C5:1F,3763502,474695251,103,12599,3763399,474682652,0,397,34131,322,25095,75,9036,110,2,135,4,0,5,144444.0,39000.0,-70.0,-71.0,-66.0,-60.0,-69.0,-70.0,-66.0,-60.0,-89.0,-91.0,-87.0,-89.0,19.0,20.0,21.0,29.0,1
1851,BA:8C:B9:54:50:24,3763701,474772566,302,89914,3763399,474682652,0,1260,141159,1242,138313,18,2846,200,5,418,7,0,8,229410.0,130000.0,-48.0,-35.0,-42.0,-45.0,-43.0,-36.0,-44.0,-48.0,-89.0,-91.0,-87.0,-89.0,41.0,56.0,45.0,44.0,1
1852,92:69:1D:31:68:E9,3776222,489945989,12823,15263337,3763399,474682652,3,19342,3595818,18642,3434786,700,161032,6475,105,14084,252,3,252,216660.0,130000.0,-54.0,-49.0,-43.0,-49.0,-52.0,-49.0,-43.0,-48.0,-89.0,-91.0,-87.0,-89.0,35.0,42.0,44.0,40.0,1
1853,CC:2F:71:3F:1F:24,3994395,744705036,230991,270021918,3763404,474683118,27,195217,224358933,195130,224348121,87,10812,186612,6,230991,22106,24,147,130000.0,39000.0,-68.0,-67.0,-72.0,-70.0,-67.0,-67.0,-71.0,-69.0,-89.0,-91.0,-87.0,-88.0,21.0,24.0,15.0,18.0,1
1854,CC:2F:71:3E:C5:1F,3763507,474695717,103,12599,3763404,474683118,0,397,34131,322,25095,75,9036,110,2,135,4,0,5,144444.0,39000.0,-70.0,-71.0,-66.0,-60.0,-69.0,-70.0,-66.0,-60.0,-89.0,-91.0,-87.0,-88.0,19.0,20.0,21.0,28.0,1
1855,BA:8C:B9:54:50:24,3763706,474773032,302,89914,3763404,474683118,0,1260,141159,1242,138313,18,2846,200,5,418,7,0,8,229410.0,130000.0,-48.0,-35.0,-42.0,-45.0,-43.0,-36.0,-44.0,-48.0,-89.0,-91.0,-87.0,-88.0,41.0,56.0,45.0,43.0,1
1856,92:69:1D:31:68:E9,3776227,489946455,12823,15263337,3763404,474683118,3,19342,3595818,18642,3434786,700,161032,6475,105,14084,252,3,252,216660.0,130000.0,-54.0,-49.0,-43.0,-49.0,-52.0,-49.0,-43.0,-48.0,-89.0,-91.0,-87.0,-88.0,35.0,42.0,44.0,39.0,1
1857,CC:2F:71:3F:1F:24,3994506,744823622,231098,270140100,3763408,474683522,27,195311,224469465,195224,224458653,87,10812,186704,6,231098,22142,24,147,130000.0,39000.0,-70.0,-70.0,-74.0,-72.0,-70.0,-70.0,-74.0,-72.0,-89.0,-91.0,-87.0,-88.0,19.0,21.0,13.0,16.0,1
1858,CC:2F:71:3E:C5:1F,3763511,474696121,103,12599,3763408,474683522,0,397,34131,322,25095,75,9036,110,2,135,4,0,5,144444.0,39000.0,-70.0,-71.0,-66.0,-60.0,-69.0,-70.0,-66.0,-60.0,-89.0,-91.0,-87.0,-88.0,19.0,20.0,21.0,28.0,1
1859,BA:8C:B9:54:50:24,3763710,474773436,302,89914,3763408,474683522,0,1260,141159,1242,138313,18,2846,200,5,418,7,0,8,229410.0,130000.0,-48.0,-35.0,-42.0,-45.0,-43.0,-36.0,-44.0,-48.0,-89.0,-91.0,-87.0,-88.0,41.0,56.0,45.0,43.0,1
1860,92:69:1D:31:68:E9,3776231,489946859,12823,15263337,3763408,474683522,3,19342,3595818,18642,3434786,700,161032,6475,105,14084,252,3,252,216660.0,130000.0,-54.0,-49.0,-43.0,-49.0,-52.0,-49.0,-43.0,-48.0,-89.0,-91.0,-87.0,-88.0,35.0,42.0,44.0,39.0,1
1861,CC:2F:71:3F:1F:24,3994623,744947129,231212,270263345,3763411,474683784,27,195410,224584086,195323,224573274,87,10812,186798,6,231212,22162,24,147,130000.0,43333.0,-70.0,-70.0,-75.0,-72.0,-69.0,-69.0,-73.0,-71.0,-89.0,-91.0,-87.0,-88.0,19.0,21.0,12.0,16.0,1
1862,CC:2F:71:3E:C5:1F,3763516,474696585,103,12599,3763413,474683986,0,397,34131,322,25095,75,9036,110,2,135,4,0,5,144444.0,39000.0,-70.0,-71.0,-66.0,-60.0,-69.0,-70.0,-66.0,-60.0,-89.0,-91.0,-87.0,-88.0,19.0,20.0,21.0,28.0,1
1863,BA:8C:B9:54:50:24,3763715,474773900,302,89914,3763413,474683986,0,1260,141159,1242,138313,18,2846,200,5,418,7,0,8,229410.0,130000.0,-48.0,-35.0,-42.0,-45.0,-43.0,-36.0,-44.0,-48.0,-89.0,-91.0,-87.0,-88.0,41.0,56.0,45.0,43.0,1
1864,92:69:1D:31:68:E9,3776236,489947323,12823,15263337,3763413,474683986,3,19342,3595818,18642,3434786,700,161032,6475,105,14084,252,3,252,216660.0,130000.0,-54.0,-49.0,-43.0,-49.0,-52.0,-49.0,-43.0,-48.0,-89.0,-91.0,-87.0,-88.0,35.0,42.0,44.0,39.0,1
1865,CC:2F:71:3F:1F:24,3994734,745064457,231317,270380067,3763417,474684390,27,195506,224700602,195419,224689790,87,10812,186888,6,231317,22180,24,147,130000.0,43333.0,-70.0,-70.0,-74.0,-73.0,-70.0,-69.0,-73.0,-72.0,-89.0,-91.0,-87.0,-88.0,19.0,21.0,13.0,15.0,1
1866,CC:2F:71:3E:C5:1F,3763521,474697262,103,12599,3763418,474684663,0,397,34131,322,25095,75,9036,110,2,135,4,0,5,144444.0,39000.0,-70.0,-71.0,-66.0,-60.0,-69.0,-70.0,-66.0,-60.0,-89.0,-91.0,-87.0,-88.0,19.0,20.0,21.0,28.0,1
1867,BA:8C:B9:54:50:24,3763720,474774577,302,89914,3763418,474684663,0,1260,141159,1242,138313,18,2846,200,5,418,7,0,8,229410.0,130000.0,-48.0,-35.0,-42.0,-45.0,-43.0,-36.0,-44.0,-48.0,-89.0,-91.0,-87.0,-88.0,41.0,56.0,45.0,43.0,1
1868,92:69:1D:31:68:E9,3776241,489948000,12823,15263337,3763418,474684663,3,19342,3595818,18642,3434786,700,161032,6475,105,14084,252,3,252,216660.0,130000.0,-54.0,-49.0,-43.0,-49.0,-52.0,-49.0,-43.0,-48.0,-89.0,-91.0,-87.0,-88.0,35.0,42.0,44.0,39.0,1
1869,CC:2F:71:3F:1F:24,3994845,745184432,231424,270499505,3763421,474684927,27,195600,224816872,195513,224806060,87,10812,186977,6,231424,22202,24,147,130000.0,39000.0,-71.0,-70.0,-74.0,-73.0,-70.0,-70.0,-74.0,-72.0,-89.0,-91.0,-87.0,-89.0,18.0,21.0,13.0,16.0,1
1870,CC:2F:71:3E:C5:1F,3763526,474697728,103,12599,3763423,474685129,0,399,34319,323,25165,76,9154,111,2,135,4,0,5,144444.0,39000.0,-70.0,-71.0,-66.0,-60.0,-70.0,-70.0,-66.0,-60.0,-89.0,-91.0,-87.0,-89.0,19.0,20.0,21.0,29.0,1
1871,BA:8C:B9:54:50:24,3763725,474775043,302,89914,3763423,474685129,0,1260,141159,1242,138313,18,2846,200,5,418,7,0,8,229410.0,130000.0,-48.0,-35.0,-42.0,-45.0,-43.0,-36.0,-44.0,-48.0,-89.0,-91.0,-87.0,-89.0,41.0,56.0,45.0,44.0,1
1872,92:69:1D:31:68:E9,3776247,489948526,12823,15263337,3763424,474685189,3,19342,3595818,18642,3434786,700,161032,6475,105,14084,252,3,252,216660.0,130000.0,-54.0,-49.0,-43.0,-49.0,-52.0,-49.0,-43.0,-48.0,-89.0,-91.0,-87.0,-89.0,35.0,42.0,44.0,40.0,1
1873,CC:2F:71:3F:1F:24,3994959,745303224,231531,270617631,3763428,474685593,27,195697,224933880,195610,224923068,87,10812,187064,6,231531,22219,24,147,130000.0,43333.0,-73.0,-73.0,-77.0,-75.0,-71.0,-70.0,-75.0,-73.0,-89.0,-91.0,-87.0,-89.0,16.0,18.0,10.0,14.0,1
1874,CC:2F:71:3E:C5:1F,3763531,474698192,103,12599,3763428,474685593,0,399,34319,323,25165,76,9154,111,2,135,4,0,5,144444.0,39000.0,-70.0,-71.0,-66.0,-60.0,-70.0,-70.0,-66.0,-60.0,-89.0,-91.0,-87.0,-89.0,19.0,20.0,21.0,29.0,1
1875,BA:8C:B9:54:50:24,3763730,474775507,302,89914,3763428,474685593,0,1260,141159,1242,138313,18,2846,200,5,418,7,0,8,229410.0,130000.0,-48.0,-35.0,-42.0,-45.0,-43.0,-36.0,-44.0,-48.0,-89.0,-91.0,-87.0,-89.0,41.0,56.0,45.0,44.0,1
1876,92:69:1D:31:68:E9,3776251,489948930,12823,15263337,3763428,474685593,3,19342,3595818,18642,3434786,700,161032,6475,105,14084,252,3,252,216660.0,130000.0,-54.0,-49.0,-43.0,-49.0,-52.0,-49.0,-43.0,-48.0,-89.0,-91.0,-87.0,-89.0,35.0,42.0,44.0,40.0,1
1877,CC:2F:71:3F:1F:24,3995076,745425377,231646,270739582,3763430,474685795,27,195798,225050171,195711,225039359,87,10812,187159,6,231646,22245,24,147,130000.0,39000.0,-67.0,-67.0,-71.0,-70.0,-67.0,-67.0,-71.0,-69.0,-89.0,-91.0,-87.0,-89.0,22.0,24.0,16.0,19.0,1
1878,CC:2F:71:3E:C5:1F,3763533,474698394,103,12599,3763430,474685795,0,399,34319,323,25165,76,9154,111,2,135,4,0,5,144444.0,39000.0,-70.0,-71.0,-66.0,-60.0,-70.0,-70.0,-66.0,-60.0,-89.0,-91.0,-87.0,-89.0,19.0,20.0,21.0,29.0,1
1879,BA:8C:B9:54:50:24,3763734,474775911,302,89914,3763432,474685997,0,1260,141159,1242,138313,18,2846,200,5,418,7,0,8,229410.0,130000.0,-48.0,-35.0,-42.0,-45.0,-43.0,-36.0,-44.0,-48.0,-89.0,-91.0,-87.0,-89.0,41.0,56.0,45.0,44.0,1
1880,92:69:1D:31:68:E9,3776255,489949334,12823,15263337,3763432,474685997,3,19342,3595818,18642,3434786,700,161032,6475,105,14084,252,3,252,216660.0,130000.0,-54.0,-49.0,-43.0,-49.0,-52.0,-49.0,-43.0,-48.0,-89.0,-91.0,-87.0,-89.0,35.0,42.0,44.0,40.0,1
1881,CC:2F:71:3F:1F:24,3995195,745550363,231758,270863902,3763437,474686461,27,195895,225163945,195808,225153133,87,10812,187255,6,231758,22292,24,147,130000.0,39000.0,-67.0,-67.0,-71.0,-69.0,-67.0,-67.0,-71.0,-69.0,-89.0,-91.0,-87.0,-89.0,22.0,24.0,16.0,20.0,1
1882,CC:2F:71:3E:C5:1F,3763540,474699060,103,12599,3763437,474686461,0,399,34319,323,25165,76,9154,111,2,135,4,0,5,144444.0,39000.0,-70.0,-71.0,-66.0,-60.0,-70.0,-70.0,-66.0,-60.0,-89.0,-91.0,-87.0,-89.0,19.0,20.0,21.0,29.0,1
1883,BA:8C:B9:54:50:24,3763739,474776375,302,89914,3763437,474686461,0,1260,141159,1242,138313,18,2846,200,5,418,7,0,8,229410.0,130000.0,-48.0,-35.0,-42.0,-45.0,-43.0,-36.0,-44.0,-48.0,-89.0,-91.0,-87.0,-89.0,41.0,56.0,45.0,44.0,1
1884,92:69:1D:31:68:E9,3776260,489949798,12823,15263337,3763437,474686461,3,19342,3595818,18642,3434786,700,161032,6475,105,14084,252,3,252,216660.0,130000.0,-54.0,-49.0,-43.0,-49.0,-52.0,-49.0,-43.0,-48.0,-89.0,-91.0,-87.0,-89.0,35.0,42.0,44.0,40.0,1
1885,CC:2F:71:3F:1F:24,3995305,745670455,231866,270983792,3763439,474686663,27,195991,225281875,195904,225271063,87,10812,187345,6,231866,22317,24,147,130000.0,43333.0,-71.0,-70.0,-74.0,-73.0,-70.0,-70.0,-74.0,-72.0,-89.0,-91.0,-87.0,-89.0,18.0,21.0,13.0,16.0,1
1886,CC:2F:71:3E:C5:1F,3763542,474699262,103,12599,3763439,474686663,0,399,34319,323,25165,76,9154,111,2,135,4,0,5,144444.0,39000.0,-70.0,-71.0,-66.0,-60.0,-70.0,-70.0,-66.0,-60.0,-89.0,-91.0,-87.0,-89.0,19.0,20.0,21.0,29.0,1
1887,BA:8C:B9:54:50:24,3763743,474776779,302,89914,3763441,474686865,0,1260,141159,1242,138313,18,2846,200,5,418,7,0,8,229410.0,130000.0,-48.0,-35.0,-42.0,-45.0,-43.0,-36.0,-44.0,-48.0,-89.0,-91.0,-87.0,-89.0,41.0,56.0,45.0,44.0,1
1888,92:69:1D:31:68:E9,3776264,489950202,12823,15263337,3763441,474686865,3,19342,3595818,18642,3434786,700,161032,6475,105,14084,252,3,252,216660.0,130000.0,-54.0,-49.0,-43.0,-49.0,-52.0,-49.0,-43.0,-48.0,-89.0,-91.0,-87.0,-89.0,35.0,42.0,44.0,40.0,1
1889,CC:2F:71:3F:1F:24,3995417,745789113,231972,271101844,3763445,474687269,27,196093,225404929,196006,225394117,87,10812,187434,6,231972,22338,24,147,130000.0,43333.0,-67.0,-67.0,-71.0,-69.0,-67.0,-67.0,-71.0,-69.0,-89.0,-91.0,-87.0,-89.0,22.0,24.0,16.0,20.0,1
1890,CC:2F:71:3E:C5:1F,3763548,474699868,103,12599,3763445,474687269,0,399,34319,323,25165,76,9154,111,2,135,4,0,5,144444.0,39000.0,-70.0,-71.0,-66.0,-60.0,-70.0,-70.0,-66.0,-60.0,-89.0,-91.0,-87.0,-89.0,19.0,20.0,21.0,29.0,1
1891,BA:8C:B9:54:50:24,3763747,474777183,302,89914,3763445,474687269,0,1260,141159,1242,138313,18,2846,200,5,418,7,0,8,229410.0,130000.0,-48.0,-35.0,-42.0,-45.0,-43.0,-36.0,-44.0,-48.0,-89.0,-91.0,-87.0,-89.0,41.0,56.0,45.0,44.0,1
1892,92:69:1D:31:68:E9,3776268,489950606,12823,15263337,3763445,474687269,3,19342,3595818,18642,3434786,700,161032,6475,105,14084,252,3,252,216660.0,130000.0,-54.0,-49.0,-43.0,-49.0,-52.0,-49.0,-43.0,-48.0,-89.0,-91.0,-87.0,-89.0,35.0,42.0,44.0,40.0,1
1893,CC:2F:71:3F:1F:24,3995534,745911252,232086,271223721,3763448,474687531,27,196200,225526599,196113,225515787,87,10812,187531,6,232086,22354,24,147,130000.0,43333.0,-70.0,-70.0,-74.0,-73.0,-70.0,-70.0,-74.0,-72.0,-89.0,-91.0,-87.0,-89.0,19.0,21.0,13.0,16.0,1
1894,CC:2F:71:3E:C5:1F,3763551,474700130,103,12599,3763448,474687531,0,400,34389,324,25235,76,9154,111,2,136,4,0,5,144444.0,39000.0,-70.0,-71.0,-66.0,-60.0,-70.0,-70.0,-66.0,-60.0,-89.0,-91.0,-87.0,-89.0,19.0,20.0,21.0,29.0,1
1895,BA:8C:B9:54:50:24,3763750,474777445,302,89914,3763448,474687531,0,1262,141295,1244,138449,18,2846,200,5,419,7,0,8,229410.0,130000.0,-40.0,-37.0,-45.0,-51.0,-43.0,-36.0,-44.0,-48.0,-89.0,-91.0,-87.0,-89.0,49.0,54.0,42.0,38.0,1
1896,92:69:1D:31:68:E9,3776273,489951070,12823,15263337,3763450,474687733,3,19344,3595954,18644,3434922,700,161032,6475,105,14085,252,3,252,216660.0,130000.0,-53.0,-48.0,-42.0,-49.0,-52.0,-49.0,-43.0,-48.0,-89.0,-91.0,-87.0,-89.0,36.0,43.0,45.0,40.0,1
1897,CC:2F:71:3F:1F:24,3995647,746030024,232193,271341887,3763454,474688137,27,196293,225641485,196206,225630673,87,10812,187617,6,232192,22378,24,147,130000.0,43333.0,-71.0,-70.0,-74.0,-72.0,-69.0,-69.0,-72.0,-70.0,-89.0,-91.0,-87.0,-89.0,18.0,21.0,13.0,17.0,1
1898,CC:2F:71:3E:C5:1F,3763557,474700736,103,12599,3763454,474688137,0,401,34459,325,25305,76,9154,111,2,136,4,0,5,144444.0,39000.0,-70.0,-71.0,-66.0,-60.0,-70.0,-70.0,-66.0,-60.0,-89.0,-91.0,-87.0,-89.0,19.0,20.0,21.0,29.0,1
1899,BA:8C:B9:54:50:24,3763756,474778051,302,89914,3763454,474688137,0,1262,141295,1244,138449,18,2846,200,5,419,7,0,8,229410.0,130000.0,-40.0,-37.0,-45.0,-51.0,-43.0,-36.0,-44.0,-48.0,-89.0,-91.0,-87.0,-89.0,49.0,54.0,42.0,38.0,1
1900,92:69:1D:31:68:E9,3776277,489951474,12823,15263337,3763454,474688137,3,19344,3595954,18644,3434922,700,161032,6475,105,14085,252,3,252,216660.0,130000.0,-53.0,-48.0,-42.0,-49.0,-52.0,-49.0,-43.0,-48.0,-89.0,-91.0,-87.0,-89.0,36.0,43.0,45.0,40.0,1
1901,CC:2F:71:3F:1F:24,3995754,746146948,232298,271458609,3763456,474688339,27,196390,225758131,196303,225747319,87,10812,187707,6,232298,22381,24,147,130000.0,43333.0,-68.0,-67.0,-71.0,-69.0,-69.0,-68.0,-72.0,-70.0,-89.0,-91.0,-87.0,-89.0,21.0,24.0,16.0,20.0,1
1902,CC:2F:71:3E:C5:1F,3763559,474700938,103,12599,3763456,474688339,0,401,34459,325,25305,76,9154,111,2,136,4,0,5,144444.0,39000.0,-70.0,-71.0,-66.0,-60.0,-70.0,-70.0,-66.0,-60.0,-89.0,-91.0,-87.0,-89.0,19.0,20.0,21.0,29.0,1
1903,BA:8C:B9:54:50:24,3763758,474778253,302,89914,3763456,474688339,0,1262,141295,1244,138449,18,2846,200,5,419,7,0,8,229410.0,130000.0,-40.0,-37.0,-45.0,-51.0,-43.0,-36.0,-44.0,-48.0,-89.0,-91.0,-87.0,-89.0,49.0,54.0,42.0,38.0,1
1904,92:69:1D:31:68:E9,3776282,489951938,12823,15263337,3763459,474688601,3,19344,3595954,18644,3434922,700,161032,6475,105,14085,252,3,252,216660.0,130000.0,-53.0,-48.0,-42.0,-49.0,-52.0,-49.0,-43.0,-48.0,-89.0,-91.0,-87.0,-89.0,36.0,43.0,45.0,40.0,1
1905,CC:2F:71:3F:1F:24,3995869,746267350,232406,271578345,3763463,474689005,27,196486,225876071,196399,225865259,87,10812,187797,6,232406,22385,24,147,130000.0,43333.0,-69.0,-67.0,-72.0,-70.0,-68.0,-67.0,-71.0,-69.0,-89.0,-90.0,-87.0,-88.0,20.0,23.0,15.0,18.0,1
1906,CC:2F:71:3E:C5:1F,3763566,474701604,103,12599,3763463,474689005,0,401,34459,325,25305,76,9154,111,2,136,4,0,5,144444.0,39000.0,-70.0,-71.0,-66.0,-60.0,-70.0,-70.0,-66.0,-60.0,-89.0,-90.0,-87.0,-88.0,19.0,19.0,21.0,28.0,1
1907,BA:8C:B9:54:50:24,3763765,474778919,302,89914,3763463,474689005,0,1262,141295,1244,138449,18,2846,200,5,419,7,0,8,229410.0,130000.0,-40.0,-37.0,-45.0,-51.0,-43.0,-36.0,-44.0,-48.0,-89.0,-90.0,-87.0,-88.0,49.0,53.0,42.0,37.0,1
1908,92:69:1D:31:68:E9,3776286,489952342,12823,15263337,3763463,474689005,3,19344,3595954,18644,3434922,700,161032,6475,105,14085,252,3,252,216660.0,130000.0,-53.0,-48.0,-42.0,-49.0,-52.0,-49.0,-43.0,-48.0,-89.0,-90.0,-87.0,-88.0,36.0,42.0,45.0,39.0,1
1909,CC:2F:71:3F:1F:24,3995985,746388067,232520,271698860,3763465,474689207,27,196588,225989686,196501,225978874,87,10812,187894,6,232520,22386,24,147,130000.0,43333.0,-71.0,-70.0,-73.0,-72.0,-71.0,-69.0,-73.0,-71.0,-89.0,-90.0,-87.0,-88.0,18.0,20.0,14.0,16.0,1
1910,CC:2F:71:3E:C5:1F,3763568,474701806,103,12599,3763465,474689207,0,401,34459,325,25305,76,9154,111,2,136,4,0,5,144444.0,39000.0,-70.0,-71.0,-66.0,-60.0,-70.0,-70.0,-66.0,-60.0,-89.0,-90.0,-87.0,-88.0,19.0,19.0,21.0,28.0,1
1911,BA:8C:B9:54:50:24,3763767,474779121,302,89914,3763465,474689207,0,1262,141295,1244,138449,18,2846,200,5,419,7,0,8,229410.0,130000.0,-40.0,-37.0,-45.0,-51.0,-43.0,-36.0,-44.0,-48.0,-89.0,-90.0,-87.0,-88.0,49.0,53.0,42.0,37.0,1
1912,92:69:1D:31:68:E9,3776288,489952544,12823,15263337,3763465,474689207,3,19344,3595954,18644,3434922,700,161032,6475,105,14085,252,3,252,216660.0,130000.0,-53.0,-48.0,-42.0,-49.0,-52.0,-49.0,-43.0,-48.0,-89.0,-90.0,-87.0,-88.0,36.0,42.0,45.0,39.0,1
1913,CC:2F:71:3F:1F:24,3996100,746508525,232628,271818652,3763472,474689873,27,196684,226106550,196597,226095738,87,10812,187982,6,232628,22394,24,147,130000.0,39000.0,-69.0,-67.0,-71.0,-69.0,-69.0,-67.0,-71.0,-68.0,-89.0,-90.0,-87.0,-88.0,20.0,23.0,16.0,19.0,1
1914,CC:2F:71:3E:C5:1F,3763575,474702472,103,12599,3763472,474689873,0,401,34459,325,25305,76,9154,111,2,136,4,0,5,144444.0,39000.0,-70.0,-71.0,-66.0,-60.0,-70.0,-70.0,-66.0,-60.0,-89.0,-90.0,-87.0,-88.0,19.0,19.0,21.0,28.0,1
1915,BA:8C:B9:54:50:24,3763774,474779787,302,89914,3763472,474689873,0,1262,141295,1244,138449,18,2846,200,5,419,7,0,8,229410.0,130000.0,-40.0,-37.0,-45.0,-51.0,-43.0,-36.0,-44.0,-48.0,-89.0,-90.0,-87.0,-88.0,49.0,53.0,42.0,37.0,1
1916,92:69:1D:31:68:E9,3776295,489953210,12823,15263337,3763472,474689873,3,19344,3595954,18644,3434922,700,161032,6475,105,14085,252,3,252,216660.0,130000.0,-53.0,-48.0,-42.0,-49.0,-52.0,-49.0,-43.0,-48.0,-89.0,-90.0,-87.0,-88.0,36.0,42.0,45.0,39.0,1
1917,CC:2F:71:3F:1F:24,3996209,746627077,232735,271937002,3763474,474690075,27,196774,226216632,196687,226205820,87,10812,188069,6,232735,22395,24,147,130000.0,43333.0,-70.0,-67.0,-71.0,-69.0,-70.0,-67.0,-70.0,-69.0,-89.0,-90.0,-87.0,-88.0,19.0,23.0,16.0,19.0,1
1918,CC:2F:71:3E:C5:1F,3763577,474702674,103,12599,3763474,474690075,0,401,34459,325,25305,76,9154,111,2,136,4,0,5,144444.0,39000.0,-70.0,-71.0,-66.0,-60.0,-70.0,-70.0,-66.0,-60.0,-89.0,-90.0,-87.0,-88.0,19.0,19.0,21.0,28.0,1
1919,BA:8C:B9:54:50:24,3763776,474779989,302,89914,3763474,474690075,0,1262,141295,1244,138449,18,2846,200,5,419,7,0,8,229410.0,130000.0,-40.0,-37.0,-45.0,-51.0,-43.0,-36.0,-44.0,-48.0,-89.0,-90.0,-87.0,-88.0,49.0,53.0,42.0,37.0,1
1920,92:69:1D:31:68:E9,3776297,489953412,12823,15263337,3763474,474690075,3,19344,3595954,18644,3434922,700,161032,6475,105,14085,252,3,252,216660.0,130000.0,-53.0,-48.0,-42.0,-49.0,-52.0,-49.0,-43.0,-48.0,-89.0,-90.0,-87.0,-88.0,36.0,42.0,45.0,39.0,1
1921,CC:2F:71:3F:1F:24,3996324,746747748,232843,272056794,3763481,474690954,27,196869,226333146,196782,226322334,87,10812,188159,6,232843,22407,24,147,130000.0,39000.0,-69.0,-67.0,-71.0,-69.0,-69.0,-66.0,-71.0,-68.0,-89.0,-90.0,-87.0,-88.0,20.0,23.0,16.0,19.0,1
1922,CC:2F:71:3E:C5:1F,3763584,474703553,103,12599,3763481,474690954,0,401,34459,325,25305,76,9154,111,2,136,4,0,5,144444.0,39000.0,-70.0,-71.0,-66.0,-60.0,-70.0,-70.0,-66.0,-60.0,-89.0,-90.0,-87.0,-88.0,19.0,19.0,21.0,28.0,1
1923,BA:8C:B9:54:50:24,3763783,474780868,302,89914,3763481,474690954,0,1262,141295,1244,138449,18,2846,200,5,419,7,0,8,229410.0,130000.0,-40.0,-37.0,-45.0,-51.0,-43.0,-36.0,-44.0,-48.0,-89.0,-90.0,-87.0,-88.0,49.0,53.0,42.0,37.0,1
1924,92:69:1D:31:68:E9,3776304,489954291,12823,15263337,3763481,474690954,3,19344,3595954,18644,3434922,700,161032,6475,105,14085,252,3,252,216660.0,130000.0,-53.0,-48.0,-42.0,-49.0,-52.0,-49.0,-43.0,-48.0,-89.0,-90.0,-87.0,-88.0,36.0,42.0,45.0,39.0,1
1925,CC:2F:71:3F:1F:24,3996438,746869499,232956,272178485,3763482,474691014,27,196967,226446133,196880,226435321,87,10812,188253,6,232956,22408,24,147,130000.0,43333.0,-71.0,-68.0,-73.0,-70.0,-70.0,-68.0,-72.0,-69.0,-89.0,-90.0,-87.0,-88.0,18.0,22.0,14.0,18.0,1
1926,CC:2F:71:3E:C5:1F,3763587,474703815,103,12599,3763484,474691216,0,401,34459,325,25305,76,9154,111,2,136,4,0,5,144444.0,39000.0,-70.0,-71.0,-66.0,-60.0,-70.0,-70.0,-66.0,-60.0,-89.0,-90.0,-87.0,-88.0,19.0,19.0,21.0,28.0,1
1927,BA:8C:B9:54:50:24,3763786,474781130,302,89914,3763484,474691216,0,1262,141295,1244,138449,18,2846,200,5,419,7,0,8,229410.0,130000.0,-40.0,-37.0,-45.0,-51.0,-43.0,-36.0,-44.0,-48.0,-89.0,-90.0,-87.0,-88.0,49.0,53.0,42.0,37.0,1
1928,92:69:1D:31:68:E9,3776307,489954553,12823,15263337,3763484,474691216,3,19344,3595954,18644,3434922,700,161032,6475,105,14085,252,3,252,216660.0,130000.0,-53.0,-48.0,-42.0,-49.0,-52.0,-49.0,-43.0,-48.0,-89.0,-90.0,-87.0,-88.0,36.0,42.0,45.0,39.0,1
1929,CC:2F:71:3F:1F:24,3996549,746988251,233061,272296631,3763488,474691620,27,197062,226563971,196975,226553159,87,10812,188341,6,233061,22409,24,147,130000.0,1000.0,-70.0,-67.0,-69.0,-68.0,-69.0,-66.0,-70.0,-67.0,-89.0,-90.0,-87.0,-88.0,19.0,23.0,18.0,20.0,1
1930,CC:2F:71:3E:C5:1F,3763593,474704421,103,12599,3763490,474691822,0,401,34459,325,25305,76,9154,111,2,136,4,0,5,144444.0,39000.0,-70.0,-71.0,-66.0,-60.0,-70.0,-70.0,-66.0,-60.0,-89.0,-90.0,-87.0,-88.0,19.0,19.0,21.0,28.0,1
1931,BA:8C:B9:54:50:24,3763792,474781736,302,89914,3763490,474691822,0,1262,141295,1244,138449,18,2846,200,5,419,7,0,8,229410.0,130000.0,-40.0,-37.0,-45.0,-51.0,-43.0,-36.0,-44.0,-48.0,-89.0,-90.0,-87.0,-88.0,49.0,53.0,42.0,37.0,1
1932,92:69:1D:31:68:E9,3776313,489955159,12823,15263337,3763490,474691822,3,19344,3595954,18644,3434922,700,161032,6475,105,14085,252,3,252,216660.0,130000.0,-53.0,-48.0,-42.0,-49.0,-52.0,-49.0,-43.0,-48.0,-89.0,-90.0,-87.0,-88.0,36.0,42.0,45.0,39.0,1
1933,CC:2F:71:3F:1F:24,3996656,747106263,233166,272414441,3763490,474691822,27,197157,226674695,197070,226663883,87,10812,188432,6,233166,22413,24,147,130000.0,43333.0,-70.0,-66.0,-70.0,-68.0,-69.0,-66.0,-70.0,-68.0,-89.0,-90.0,-87.0,-88.0,19.0,24.0,17.0,20.0,1
1934,CC:2F:71:3E:C5:1F,3763593,474704421,103,12599,3763490,474691822,0,401,34459,325,25305,76,9154,111,2,136,4,0,5,144444.0,39000.0,-70.0,-71.0,-66.0,-60.0,-70.0,-70.0,-66.0,-60.0,-89.0,-90.0,-87.0,-88.0,19.0,19.0,21.0,28.0,1
1935,BA:8C:B9:54:50:24,3763794,474781938,302,89914,3763492,474692024,0,1262,141295,1244,138449,18,2846,200,5,419,7,0,8,229410.0,130000.0,-40.0,-37.0,-45.0,-51.0,-43.0,-36.0,-44.0,-48.0,-89.0,-90.0,-87.0,-88.0,49.0,53.0,42.0,37.0,1
1936,92:69:1D:31:68:E9,3776315,489955361,12823,15263337,3763492,474692024,3,19344,3595954,18644,3434922,700,161032,6475,105,14085,252,3,252,216660.0,130000.0,-53.0,-48.0,-42.0,-49.0,-52.0,-49.0,-43.0,-48.0,-89.0,-90.0,-87.0,-88.0,36.0,42.0,45.0,39.0,1
1937,CC:2F:71:3F:1F:24,3996769,747226517,233272,272534029,3763497,474692488,27,197246,226784647,197159,226773835,87,10812,188519,6,233272,22422,24,147,117000.0,39000.0,-71.0,-65.0,-70.0,-73.0,-71.0,-65.0,-70.0,-72.0,-89.0,-90.0,-87.0,-88.0,18.0,25.0,17.0,15.0,1
1938,CC:2F:71:3E:C5:1F,3763600,474705087,103,12599,3763497,474692488,0,401,34459,325,25305,76,9154,111,2,136,4,0,5,144444.0,39000.0,-70.0,-71.0,-66.0,-60.0,-70.0,-70.0,-66.0,-60.0,-89.0,-90.0,-87.0,-88.0,19.0,19.0,21.0,28.0,1
1939,BA:8C:B9:54:50:24,3763801,474782604,302,89914,3763499,474692690,0,1262,141295,1244,138449,18,2846,200,5,419,7,0,8,229410.0,130000.0,-40.0,-37.0,-45.0,-51.0,-43.0,-36.0,-44.0,-48.0,-89.0,-90.0,-87.0,-88.0,49.0,53.0,42.0,37.0,1
1940,92:69:1D:31:68:E9,3776322,489956027,12823,15263337,3763499,474692690,3,19345,3596022,18645,3434990,700,161032,6475,105,14085,252,3,252,216660.0,130000.0,-52.0,-50.0,-45.0,-47.0,-52.0,-49.0,-43.0,-48.0,-89.0,-90.0,-87.0,-88.0,37.0,40.0,42.0,41.0,1
1941,CC:2F:71:3F:1F:24,3996885,747351332,233386,272658642,3763499,474692690,27,197350,226905636,197263,226894824,87,10812,188616,6,233386,22422,24,147,130000.0,43333.0,-71.0,-66.0,-67.0,-70.0,-70.0,-66.0,-67.0,-70.0,-89.0,-90.0,-87.0,-88.0,18.0,24.0,20.0,18.0,1
1942,CC:2F:71:3E:C5:1F,3763602,474705289,103,12599,3763499,474692690,0,401,34459,325,25305,76,9154,111,2,136,4,0,5,144444.0,39000.0,-70.0,-71.0,-66.0,-60.0,-70.0,-70.0,-66.0,-60.0,-89.0,-90.0,-87.0,-88.0,19.0,19.0,21.0,28.0,1
1943,BA:8C:B9:54:50:24,3763803,474782806,302,89914,3763501,474692892,0,1262,141295,1244,138449,18,2846,200,5,419,7,0,8,229410.0,130000.0,-40.0,-37.0,-45.0,-51.0,-43.0,-36.0,-44.0,-48.0,-89.0,-90.0,-87.0,-88.0,49.0,53.0,42.0,37.0,1
1944,92:69:1D:31:68:E9,3776324,489956229,12823,15263337,3763501,474692892,3,19345,3596022,18645,3434990,700,161032,6475,105,14085,252,3,252,216660.0,130000.0,-52.0,-50.0,-45.0,-47.0,-52.0,-49.0,-43.0,-48.0,-89.0,-90.0,-87.0,-88.0,37.0,40.0,42.0,41.0,1
1945,CC:2F:71:3F:1F:24,3997466,748039915,233960,273346559,3763506,474693356,27,197643,227051449,197556,227040637,87,10812,188904,6,233960,22422,24,147,130000.0,43333.0,-70.0,-66.0,-68.0,-70.0,-70.0,-66.0,-67.0,-70.0,-89.0,-90.0,-87.0,-88.0,19.0,24.0,19.0,18.0,1
1946,CC:2F:71:3E:C5:1F,3763609,474705955,103,12599,3763506,474693356,0,401,34459,325,25305,76,9154,111,2,136,4,0,5,144444.0,39000.0,-70.0,-71.0,-66.0,-60.0,-70.0,-70.0,-66.0,-60.0,-89.0,-90.0,-87.0,-88.0,19.0,19.0,21.0,28.0,1
1947,BA:8C:B9:54:50:24,3763808,474783270,302,89914,3763506,474693356,0,1262,141295,1244,138449,18,2846,200,5,419,7,0,8,229410.0,130000.0,-40.0,-37.0,-45.0,-51.0,-43.0,-36.0,-44.0,-48.0,-89.0,-90.0,-87.0,-88.0,49.0,53.0,42.0,37.0,1
1948,92:69:1D:31:68:E9,3776331,489956895,12823,15263337,3763508,474693558,3,19345,3596022,18645,3434990,700,161032,6475,105,14085,252,3,252,216660.0,130000.0,-52.0,-50.0,-45.0,-47.0,-52.0,-49.0,-43.0,-48.0,-89.0,-90.0,-87.0,-88.0,37.0,40.0,42.0,41.0,1
1949,CC:2F:71:3F:1F:24,3997577,748160077,234067,273466151,3763510,474693926,27,197741,227168233,197654,227157421,87,10812,188994,6,234067,22426,24,147,130000.0,43333.0,-70.0,-66.0,-67.0,-70.0,-70.0,-66.0,-67.0,-70.0,-89.0,-90.0,-87.0,-88.0,19.0,24.0,20.0,18.0,1
1950,CC:2F:71:3E:C5:1F,3763614,474706641,104,12715,3763510,474693926,0,403,34599,327,25445,76,9154,111,2,137,4,0,5,144444.0,39000.0,-70.0,-70.0,-67.0,-60.0,-70.0,-70.0,-66.0,-60.0,-89.0,-90.0,-87.0,-88.0,19.0,20.0,20.0,28.0,1
1951,BA:8C:B9:54:50:24,3763813,474783956,303,90030,3763510,474693926,0,1264,141431,1246,138585,18,2846,200,5,420,7,0,8,229410.0,130000.0,-48.0,-35.0,-43.0,-45.0,-43.0,-36.0,-44.0,-48.0,-89.0,-90.0,-87.0,-88.0,41.0,55.0,44.0,43.0,1
1952,92:69:1D:31:68:E9,3776336,489957581,12824,15263453,3763512,474694128,3,19347,3596158,18647,3435126,700,161032,6475,105,14086,252,3,252,216660.0,130000.0,-52.0,-49.0,-44.0,-47.0,-52.0,-48.0,-43.0,-48.0,-89.0,-90.0,-87.0,-88.0,37.0,41.0,43.0,41.0,1
1953,CC:2F:71:3F:1F:24,3997689,748278959,234173,273584427,3763516,474694532,27,197839,227285279,197752,227274467,87,10812,189083,6,234173,22426,24,147,130000.0,43333.0,-70.0,-66.0,-67.0,-70.0,-70.0,-66.0,-67.0,-70.0,-89.0,-89.0,-87.0,-88.0,19.0,23.0,20.0,18.0,1
1954,CC:2F:71:3E:C5:1F,3763621,474707309,104,12715,3763517,474694594,0,403,34599,327,25445,76,9154,111,2,137,4,0,5,144444.0,39000.0,-70.0,-70.0,-67.0,-60.0,-70.0,-70.0,-66.0,-60.0,-89.0,-89.0,-87.0,-88.0,19.0,19.0,20.0,28.0,1
1955,BA:8C:B9:54:50:24,3763820,474784624,303,90030,3763517,474694594,0,1264,141431,1246,138585,18,2846,200,5,420,7,0,8,229410.0,130000.0,-48.0,-35.0,-43.0,-45.0,-43.0,-36.0,-44.0,-48.0,-89.0,-89.0,-87.0,-88.0,41.0,54.0,44.0,43.0,1
1956,92:69:1D:31:68:E9,3776341,489958047,12824,15263453,3763517,474694594,3,19347,3596158,18647,3435126,700,161032,6475,105,14086,252,3,252,216660.0,130000.0,-52.0,-49.0,-44.0,-47.0,-52.0,-48.0,-43.0,-48.0,-89.0,-89.0,-87.0,-88.0,37.0,40.0,43.0,41.0,1
1957,CC:2F:71:3F:1F:24,3997809,748402007,234289,273707151,3763520,474694856,27,197949,227406873,197861,227395943,88,10930,189183,6,234289,22426,24,147,130000.0,43333.0,-71.0,-67.0,-68.0,-70.0,-70.0,-66.0,-67.0,-70.0,-89.0,-89.0,-87.0,-88.0,18.0,22.0,19.0,18.0,1
1958,CC:2F:71:3E:C5:1F,3763624,474707571,104,12715,3763520,474694856,0,403,34599,327,25445,76,9154,111,2,137,4,0,5,144444.0,39000.0,-70.0,-70.0,-67.0,-60.0,-70.0,-70.0,-66.0,-60.0,-89.0,-89.0,-87.0,-88.0,19.0,19.0,20.0,28.0,1
1959,BA:8C:B9:54:50:24,3763823,474784886,303,90030,3763520,474694856,0,1264,141431,1246,138585,18,2846,200,5,420,7,0,8,229410.0,130000.0,-48.0,-35.0,-43.0,-45.0,-43.0,-36.0,-44.0,-48.0,-89.0,-89.0,-87.0,-88.0,41.0,54.0,44.0,43.0,1
1960,92:69:1D:31:68:E9,3776344,489958309,12824,15263453,3763520,474694856,3,19347,3596158,18647,3435126,700,161032,6475,105,14086,252,3,252,216660.0,130000.0,-52.0,-49.0,-44.0,-47.0,-52.0,-48.0,-43.0,-48.0,-89.0,-89.0,-87.0,-88.0,37.0,40.0,43.0,41.0,1
1961,CC:2F:71:3F:1F:24,3997927,748524062,234401,273828600,3763526,474695462,27,198047,227518582,197959,227507652,88,10930,189277,6,234401,22430,24,147,144444.0,43333.0,-70.0,-66.0,-67.0,-70.0,-71.0,-67.0,-68.0,-71.0,-89.0,-89.0,-87.0,-88.0,19.0,23.0,20.0,18.0,1
1962,CC:2F:71:3E:C5:1F,3763630,474708177,104,12715,3763526,474695462,0,403,34599,327,25445,76,9154,111,2,137,4,0,5,144444.0,39000.0,-70.0,-70.0,-67.0,-60.0,-70.0,-70.0,-66.0,-60.0,-89.0,-89.0,-87.0,-88.0,19.0,19.0,20.0,28.0,1
1963,BA:8C:B9:54:50:24,3763829,474785492,303,90030,3763526,474695462,0,1268,141703,1250,138857,18,2846,200,5,420,7,0,8,229410.0,130000.0,-48.0,-35.0,-43.0,-45.0,-44.0,-36.0,-44.0,-48.0,-89.0,-89.0,-87.0,-88.0,41.0,54.0,44.0,43.0,1
1964,92:69:1D:31:68:E9,3776350,489958915,12824,15263453,3763526,474695462,3,19347,3596158,18647,3435126,700,161032,6475,105,14086,252,3,252,216660.0,130000.0,-52.0,-49.0,-44.0,-47.0,-52.0,-48.0,-43.0,-48.0,-89.0,-89.0,-87.0,-88.0,37.0,40.0,43.0,41.0,1
1965,CC:2F:71:3F:1F:24,3998036,748645462,234508,273949798,3763528,474695664,27,198144,227636776,198056,227625846,88,10930,189367,6,234508,22441,24,148,130000.0,43333.0,-70.0,-66.0,-68.0,-70.0,-70.0,-66.0,-67.0,-70.0,-89.0,-89.0,-87.0,-88.0,19.0,23.0,19.0,18.0,1
1966,CC:2F:71:3E:C5:1F,3763632,474708379,104,12715,3763528,474695664,0,403,34599,327,25445,76,9154,111,2,137,4,0,5,144444.0,39000.0,-70.0,-70.0,-67.0,-60.0,-70.0,-70.0,-66.0,-60.0,-89.0,-89.0,-87.0,-88.0,19.0,19.0,20.0,28.0,1
1967,BA:8C:B9:54:50:24,3763831,474785694,303,90030,3763528,474695664,0,1268,141703,1250,138857,18,2846,200,5,420,7,0,8,229410.0,130000.0,-48.0,-35.0,-43.0,-45.0,-44.0,-36.0,-44.0,-48.0,-89.0,-89.0,-87.0,-88.0,41.0,54.0,44.0,43.0,1
1968,92:69:1D:31:68:E9,3776352,489959117,12824,15263453,3763528,474695664,3,19347,3596158,18647,3435126,700,161032,6475,105,14086,252,3,252,216660.0,130000.0,-52.0,-49.0,-44.0,-47.0,-52.0,-48.0,-43.0,-48.0,-89.0,-89.0,-87.0,-88.0,37.0,40.0,43.0,41.0,1
1969,CC:2F:71:3F:1F:24,3998149,748764180,234614,274067850,3763535,474696330,27,198234,227748282,198146,227737352,88,10930,189454,6,234614,22444,24,148,130000.0,43333.0,-70.0,-66.0,-67.0,-70.0,-70.0,-66.0,-67.0,-70.0,-89.0,-89.0,-87.0,-88.0,19.0,23.0,20.0,18.0,1
1970,CC:2F:71:3E:C5:1F,3763639,474709045,104,12715,3763535,474696330,0,403,34599,327,25445,76,9154,111,2,137,4,0,5,144444.0,39000.0,-70.0,-70.0,-67.0,-60.0,-70.0,-70.0,-66.0,-60.0,-89.0,-89.0,-87.0,-88.0,19.0,19.0,20.0,28.0,1
1971,BA:8C:B9:54:50:24,3763838,474786360,303,90030,3763535,474696330,0,1268,141703,1250,138857,18,2846,200,5,420,7,0,8,229410.0,130000.0,-48.0,-35.0,-43.0,-45.0,-44.0,-36.0,-44.0,-48.0,-89.0,-89.0,-87.0,-88.0,41.0,54.0,44.0,43.0,1
1972,92:69:1D:31:68:E9,3776359,489959783,12824,15263453,3763535,474696330,3,19347,3596158,18647,3435126,700,161032,6475,105,14086,252,3,252,216660.0,130000.0,-52.0,-49.0,-44.0,-47.0,-52.0,-48.0,-43.0,-48.0,-89.0,-89.0,-87.0,-88.0,37.0,40.0,43.0,41.0,1
1973,CC:2F:71:3F:1F:24,3998259,748884485,234721,274187680,3763538,474696805,27,198326,227860068,198238,227849138,88,10930,189543,6,234721,22444,24,148,130000.0,43333.0,-71.0,-67.0,-68.0,-71.0,-71.0,-66.0,-68.0,-70.0,-89.0,-89.0,-87.0,-88.0,18.0,22.0,19.0,17.0,1
1974,CC:2F:71:3E:C5:1F,3763642,474709520,104,12715,3763538,474696805,0,403,34599,327,25445,76,9154,111,2,137,4,0,5,144444.0,39000.0,-70.0,-70.0,-67.0,-60.0,-70.0,-70.0,-66.0,-60.0,-89.0,-89.0,-87.0,-88.0,19.0,19.0,20.0,28.0,1
1975,BA:8C:B9:54:50:24,3763841,474786835,303,90030,3763538,474696805,0,1268,141703,1250,138857,18,2846,200,5,420,7,0,8,229410.0,130000.0,-48.0,-35.0,-43.0,-45.0,-44.0,-36.0,-44.0,-48.0,-89.0,-89.0,-87.0,-88.0,41.0,54.0,44.0,43.0,1
1976,92:69:1D:31:68:E9,3776362,489960258,12824,15263453,3763538,474696805,3,19347,3596158,18647,3435126,700,161032,6475,105,14086,252,3,252,216660.0,130000.0,-52.0,-49.0,-44.0,-47.0,-52.0,-48.0,-43.0,-48.0,-89.0,-89.0,-87.0,-88.0,37.0,40.0,43.0,41.0,1
1977,CC:2F:71:3F:1F:24,3998379,749006674,234834,274309203,3763545,474697471,27,198430,227980893,198342,227969963,88,10930,189638,6,234834,22454,24,148,130000.0,43333.0,-74.0,-69.0,-71.0,-73.0,-74.0,-69.0,-71.0,-73.0,-89.0,-89.0,-87.0,-88.0,15.0,20.0,16.0,15.0,1
1978,CC:2F:71:3E:C5:1F,3763649,474710186,104,12715,3763545,474697471,0,403,34599,327,25445,76,9154,111,2,137,4,0,5,144444.0,39000.0,-70.0,-70.0,-67.0,-60.0,-70.0,-70.0,-66.0,-60.0,-89.0,-89.0,-87.0,-88.0,19.0,19.0,20.0,28.0,1
1979,BA:8C:B9:54:50:24,3763848,474787501,303,90030,3763545,474697471,0,1268,141703,1250,138857,18,2846,200,5,420,7,0,8,229410.0,130000.0,-48.0,-35.0,-43.0,-45.0,-44.0,-36.0,-44.0,-48.0,-89.0,-89.0,-87.0,-88.0,41.0,54.0,44.0,43.0,1
1980,92:69:1D:31:68:E9,3776369,489960924,12824,15263453,3763545,474697471,3,19347,3596158,18647,3435126,700,161032,6475,105,14086,252,3,252,216660.0,130000.0,-52.0,-49.0,-44.0,-47.0,-52.0,-48.0,-43.0,-48.0,-89.0,-89.0,-87.0,-88.0,37.0,40.0,43.0,41.0,1
1981,CC:2F:71:3F:1F:24,3998487,749126576,234940,274428903,3763547,474697673,27,198534,228107073,198446,228096143,88,10930,189728,6,234940,22454,24,148,130000.0,43333.0,-74.0,-70.0,-71.0,-73.0,-73.0,-69.0,-70.0,-72.0,-89.0,-89.0,-87.0,-88.0,15.0,19.0,16.0,15.0,1
1982,CC:2F:71:3E:C5:1F,3763651,474710388,104,12715,3763547,474697673,0,403,34599,327,25445,76,9154,111,2,137,4,0,5,144444.0,39000.0,-70.0,-70.0,-67.0,-60.0,-70.0,-70.0,-66.0,-60.0,-89.0,-89.0,-87.0,-88.0,19.0,19.0,20.0,28.0,1
1983,BA:8C:B9:54:50:24,3763850,474787703,303,90030,3763547,474697673,0,1268,141703,1250,138857,18,2846,200,5,420,7,0,8,229410.0,130000.0,-48.0,-35.0,-43.0,-45.0,-44.0,-36.0,-44.0,-48.0,-89.0,-89.0,-87.0,-88.0,41.0,54.0,44.0,43.0,1
1984,92:69:1D:31:68:E9,3776371,489961126,12824,15263453,3763547,474697673,3,19347,3596158,18647,3435126,700,161032,6475,105,14086,252,3,252,216660.0,130000.0,-52.0,-49.0,-44.0,-47.0,-52.0,-48.0,-43.0,-48.0,-89.0,-89.0,-87.0,-88.0,37.0,40.0,43.0,41.0,1
1985,CC:2F:71:3F:1F:24,3998599,749245346,235046,274547067,3763553,474698279,27,198626,228218953,198538,228208023,88,10930,189816,6,235046,22458,24,148,117000.0,39000.0,-73.0,-69.0,-71.0,-72.0,-73.0,-69.0,-70.0,-72.0,-89.0,-89.0,-87.0,-88.0,16.0,20.0,16.0,16.0,1
1986,CC:2F:71:3E:C5:1F,3763657,474710994,104,12715,3763553,474698279,0,403,34599,327,25445,76,9154,111,2,137,4,0,5,144444.0,39000.0,-70.0,-70.0,-67.0,-60.0,-70.0,-70.0,-66.0,-60.0,-89.0,-89.0,-87.0,-88.0,19.0,19.0,20.0,28.0,1
1987,BA:8C:B9:54:50:24,3763856,474788309,303,90030,3763553,474698279,0,1268,141703,1250,138857,18,2846,200,5,420,7,0,8,229410.0,130000.0,-48.0,-35.0,-43.0,-45.0,-44.0,-36.0,-44.0,-48.0,-89.0,-89.0,-87.0,-88.0,41.0,54.0,44.0,43.0,1
1988,92:69:1D:31:68:E9,3776377,489961732,12824,15263453,3763553,474698279,3,19347,3596158,18647,3435126,700,161032,6475,105,14086,252,3,252,216660.0,130000.0,-52.0,-49.0,-44.0,-47.0,-52.0,-48.0,-43.0,-48.0,-89.0,-89.0,-87.0,-88.0,37.0,40.0,43.0,41.0,1
1989,CC:2F:71:3F:1F:24,3998710,749365388,235153,274666785,3763557,474698603,27,198721,228336777,198633,228325847,88,10930,189905,6,235153,22458,24,148,130000.0,43333.0,-70.0,-66.0,-68.0,-70.0,-70.0,-66.0,-67.0,-70.0,-89.0,-89.0,-87.0,-88.0,19.0,23.0,19.0,18.0,1
1990,CC:2F:71:3E:C5:1F,3763661,474711318,104,12715,3763557,474698603,0,405,34787,328,25515,77,9272,112,2,137,4,0,5,144444.0,39000.0,-70.0,-70.0,-67.0,-60.0,-70.0,-70.0,-66.0,-60.0,-89.0,-89.0,-87.0,-88.0,19.0,19.0,20.0,28.0,1
1991,BA:8C:B9:54:50:24,3763860,474788633,303,90030,3763557,474698603,0,1268,141703,1250,138857,18,2846,200,5,420,7,0,8,229410.0,130000.0,-48.0,-35.0,-43.0,-45.0,-44.0,-36.0,-44.0,-48.0,-89.0,-89.0,-87.0,-88.0,41.0,54.0,44.0,43.0,1
1992,92:69:1D:31:68:E9,3776381,489962056,12824,15263453,3763557,474698603,3,19347,3596158,18647,3435126,700,161032,6475,105,14086,252,3,252,216660.0,130000.0,-52.0,-49.0,-44.0,-47.0,-52.0,-48.0,-43.0,-48.0,-89.0,-89.0,-87.0,-88.0,37.0,40.0,43.0,41.0,1
1993,CC:2F:71:3F:1F:24,3998828,749489083,235266,274789942,3763562,474699141,27,198820,228446918,198732,228435988,88,10930,190004,6,235266,22458,24,148,130000.0,43333.0,-70.0,-66.0,-67.0,-70.0,-70.0,-66.0,-67.0,-69.0,-89.0,-89.0,-87.0,-88.0,19.0,23.0,20.0,18.0,1
1994,CC:2F:71:3E:C5:1F,3763667,474711924,104,12715,3763563,474699209,0,405,34787,328,25515,77,9272,112,2,137,4,0,5,144444.0,39000.0,-70.0,-70.0,-67.0,-60.0,-70.0,-70.0,-66.0,-60.0,-89.0,-89.0,-87.0,-88.0,19.0,19.0,20.0,28.0,1
1995,BA:8C:B9:54:50:24,3763866,474789239,303,90030,3763563,474699209,0,1268,141703,1250,138857,18,2846,200,5,420,7,0,8,229410.0,130000.0,-48.0,-35.0,-43.0,-45.0,-44.0,-36.0,-44.0,-48.0,-89.0,-89.0,-87.0,-88.0,41.0,54.0,44.0,43.0,1
1996,92:69:1D:31:68:E9,3776387,489962662,12824,15263453,3763563,474699209,3,19347,3596158,18647,3435126,700,161032,6475,105,14086,252,3,252,216660.0,130000.0,-52.0,-49.0,-44.0,-47.0,-52.0,-48.0,-43.0,-48.0,-89.0,-89.0,-87.0,-88.0,37.0,40.0,43.0,41.0,1
1997,CC:2F:71:3F:1F:24,3999135,749853782,235570,275154371,3763565,474699411,27,199002,228568849,198914,228557919,88,10930,190184,6,235570,22474,24,148,144444.0,43333.0,-70.0,-66.0,-67.0,-70.0,-70.0,-66.0,-67.0,-69.0,-89.0,-89.0,-87.0,-88.0,19.0,23.0,20.0,18.0,1
1998,CC:2F:71:3E:C5:1F,3763669,474712126,104,12715,3763565,474699411,0,405,34787,328,25515,77,9272,112,2,137,4,0,5,144444.0,39000.0,-70.0,-70.0,-67.0,-60.0,-70.0,-70.0,-66.0,-60.0,-89.0,-89.0,-87.0,-88.0,19.0,19.0,20.0,28.0,1
1999,BA:8C:B9:54:50:24,3763868,474789441,303,90030,3763565,474699411,0,1268,141703,1250,138857,18,2846,200,5,420,7,0,8,229410.0,130000.0,-48.0,-35.0,-43.0,-45.0,-44.0,-36.0,-44.0,-48.0,-89.0,-89.0,-87.0,-88.0,41.0,54.0,44.0,43.0,1
2000,92:69:1D:31:68:E9,3776389,489962864,12824,15263453,3763565,474699411,3,19347,3596158,18647,3435126,700,161032,6475,105,14086,252,3,252,216660.0,130000.0,-52.0,-49.0,-44.0,-47.0,-52.0,-48.0,-43.0,-48.0,-89.0,-89.0,-87.0,-88.0,37.0,40.0,43.0,41.0,1
2001,CC:2F:71:3F:1F:24,3999440,750219747,235870,275519872,3763570,474699875,27,199175,228692563,199087,228681633,88,10930,190355,6,235870,22496,24,148,144444.0,43333.0,-73.0,-70.0,-71.0,-73.0,-73.0,-69.0,-70.0,-72.0,-89.0,-89.0,-87.0,-88.0,16.0,19.0,16.0,15.0,1
2002,CC:2F:71:3E:C5:1F,3763674,474712590,104,12715,3763570,474699875,0,405,34787,328,25515,77,9272,112,2,137,4,0,5,144444.0,39000.0,-70.0,-70.0,-67.0,-60.0,-70.0,-70.0,-66.0,-60.0,-89.0,-89.0,-87.0,-88.0,19.0,19.0,20.0,28.0,1
2003,BA:8C:B9:54:50:24,3763875,474790107,303,90030,3763572,474700077,0,1270,141839,1252,138993,18,2846,200,5,421,7,0,8,229410.0,130000.0,-48.0,-35.0,-43.0,-45.0,-45.0,-35.0,-43.0,-47.0,-89.0,-89.0,-87.0,-88.0,41.0,54.0,44.0,43.0,1
2004,92:69:1D:31:68:E9,3776396,489963530,12824,15263453,3763572,474700077,3,19349,3596294,18649,3435262,700,161032,6475,105,14087,252,3,252,216660.0,130000.0,-52.0,-47.0,-42.0,-48.0,-52.0,-48.0,-42.0,-48.0,-89.0,-89.0,-87.0,-88.0,37.0,42.0,45.0,40.0,1
2005,CC:2F:71:3F:1F:24,3999749,750586246,236175,275885967,3763574,474700279,27,199359,228816257,199271,228805327,88,10930,190535,6,236175,22540,24,148,130000.0,43333.0,-74.0,-70.0,-71.0,-73.0,-73.0,-70.0,-71.0,-73.0,-89.0,-89.0,-87.0,-88.0,15.0,19.0,16.0,15.0,1
2006,CC:2F:71:3E:C5:1F,3763678,474712994,104,12715,3763574,474700279,0,405,34787,328,25515,77,9272,112,2,137,4,0,5,144444.0,39000.0,-70.0,-70.0,-67.0,-60.0,-70.0,-70.0,-66.0,-60.0,-89.0,-89.0,-87.0,-88.0,19.0,19.0,20.0,28.0,1
2007,BA:8C:B9:54:50:24,3763877,474790309,303,90030,3763574,474700279,0,1270,141839,1252,138993,18,2846,200,5,421,7,0,8,229410.0,130000.0,-48.0,-35.0,-43.0,-45.0,-45.0,-35.0,-43.0,-47.0,-89.0,-89.0,-87.0,-88.0,41.0,54.0,44.0,43.0,1
2008,92:69:1D:31:68:E9,3776398,489963732,12824,15263453,3763574,474700279,3,19349,3596294,18649,3435262,700,161032,6475,105,14087,252,3,252,216660.0,130000.0,-52.0,-47.0,-42.0,-48.0,-52.0,-48.0,-42.0,-48.0,-89.0,-89.0,-87.0,-88.0,37.0,42.0,45.0,40.0,1
2009,CC:2F:71:3F:1F:24,3999862,750706644,236284,276005961,3763578,474700683,27,199455,228931443,199367,228920513,88,10930,190626,6,236284,22551,24,148,130000.0,43333.0,-74.0,-70.0,-72.0,-73.0,-73.0,-69.0,-70.0,-72.0,-89.0,-89.0,-87.0,-88.0,15.0,19.0,15.0,15.0,1
2010,CC:2F:71:3E:C5:1F,3763683,474713458,104,12715,3763579,474700743,0,405,34787,328,25515,77,9272,112,2,137,4,0,5,144444.0,39000.0,-70.0,-70.0,-67.0,-60.0,-70.0,-70.0,-66.0,-60.0,-89.0,-89.0,-87.0,-88.0,19.0,19.0,20.0,28.0,1
2011,BA:8C:B9:54:50:24,3763884,474790975,303,90030,3763581,474700945,0,1271,141907,1253,139061,18,2846,200,5,421,7,0,8,229410.0,130000.0,-48.0,-35.0,-42.0,-45.0,-46.0,-35.0,-43.0,-46.0,-89.0,-89.0,-87.0,-88.0,41.0,54.0,45.0,43.0,1
2012,92:69:1D:31:68:E9,3776405,489964398,12824,15263453,3763581,474700945,3,19349,3596294,18649,3435262,700,161032,6475,105,14087,252,3,252,216660.0,130000.0,-52.0,-47.0,-42.0,-48.0,-52.0,-48.0,-42.0,-48.0,-89.0,-89.0,-87.0,-88.0,37.0,42.0,45.0,40.0,1
2013,CC:2F:71:3F:1F:24,3999973,750826808,236390,276125661,3763583,474701147,27,199550,229049267,199462,229038337,88,10930,190715,6,236390,22551,24,148,130000.0,43333.0,-73.0,-69.0,-70.0,-73.0,-72.0,-68.0,-69.0,-72.0,-89.0,-89.0,-87.0,-88.0,16.0,20.0,17.0,15.0,1
2014,CC:2F:71:3E:C5:1F,3763687,474713862,104,12715,3763583,474701147,0,405,34787,328,25515,77,9272,112,2,137,4,0,5,144444.0,39000.0,-70.0,-70.0,-67.0,-60.0,-70.0,-70.0,-66.0,-60.0,-89.0,-89.0,-87.0,-88.0,19.0,19.0,20.0,28.0,1
2015,BA:8C:B9:54:50:24,3763886,474791177,303,90030,3763583,474701147,0,1271,141907,1253,139061,18,2846,200,5,421,7,0,8,229410.0,130000.0,-48.0,-35.0,-42.0,-45.0,-46.0,-35.0,-43.0,-46.0,-89.0,-89.0,-87.0,-88.0,41.0,54.0,45.0,43.0,1
2016,92:69:1D:31:68:E9,3776407,489964600,12824,15263453,3763583,474701147,3,19349,3596294,18649,3435262,700,161032,6475,105,14087,252,3,252,216660.0,130000.0,-52.0,-47.0,-42.0,-48.0,-52.0,-48.0,-42.0,-48.0,-89.0,-89.0,-87.0,-88.0,37.0,42.0,45.0,40.0,1
2017,CC:2F:71:3F:1F:24,4000085,750947116,236498,276245565,3763587,474701551,27,199644,229162703,199556,229151773,88,10930,190806,6,236498,22551,24,148,144444.0,39000.0,-70.0,-66.0,-67.0,-70.0,-70.0,-66.0,-68.0,-70.0,-89.0,-89.0,-87.0,-87.0,19.0,23.0,20.0,17.0,1
2018,CC:2F:71:3E:C5:1F,3763691,474714266,104,12715,3763587,474701551,0,405,34787,328,25515,77,9272,112,2,137,4,0,5,144444.0,39000.0,-70.0,-70.0,-67.0,-60.0,-70.0,-70.0,-66.0,-60.0,-89.0,-89.0,-87.0,-87.0,19.0,19.0,20.0,27.0,1
2019,BA:8C:B9:54:50:24,3763892,474791783,303,90030,3763589,474701753,0,1271,141907,1253,139061,18,2846,200,5,421,7,0,8,229410.0,130000.0,-48.0,-35.0,-42.0,-45.0,-46.0,-35.0,-43.0,-46.0,-89.0,-89.0,-87.0,-87.0,41.0,54.0,45.0,42.0,1
2020,92:69:1D:31:68:E9,3776413,489965206,12824,15263453,3763589,474701753,3,19349,3596294,18649,3435262,700,161032,6475,105,14087,252,3,252,216660.0,130000.0,-52.0,-47.0,-42.0,-48.0,-52.0,-48.0,-42.0,-48.0,-89.0,-89.0,-87.0,-87.0,37.0,42.0,45.0,39.0,1
2021,CC:2F:71:3F:1F:24,4000206,751072453,236614,276370438,3763592,474702015,27,199746,229279002,199658,229268072,88,10930,190904,6,236614,22555,24,148,144444.0,43333.0,-70.0,-66.0,-68.0,-70.0,-70.0,-66.0,-67.0,-69.0,-89.0,-89.0,-87.0,-87.0,19.0,23.0,19.0,17.0,1
2022,CC:2F:71:3E:C5:1F,3763696,474714730,104,12715,3763592,474702015,0,405,34787,328,25515,77,9272,112,2,137,4,0,5,144444.0,39000.0,-70.0,-70.0,-67.0,-60.0,-70.0,-70.0,-66.0,-60.0,-89.0,-89.0,-87.0,-87.0,19.0,19.0,20.0,27.0,1
2023,BA:8C:B9:54:50:24,3763895,474792045,303,90030,3763592,474702015,0,1271,141907,1253,139061,18,2846,200,5,421,7,0,8,229410.0,130000.0,-48.0,-35.0,-42.0,-45.0,-46.0,-35.0,-43.0,-46.0,-89.0,-89.0,-87.0,-87.0,41.0,54.0,45.0,42.0,1
2024,92:69:1D:31:68:E9,3776416,489965468,12824,15263453,3763592,474702015,3,19349,3596294,18649,3435262,700,161032,6475,105,14087,252,3,252,216660.0,130000.0,-52.0,-47.0,-42.0,-48.0,-52.0,-48.0,-42.0,-48.0,-89.0,-90.0,-87.0,-88.0,37.0,43.0,45.0,40.0,1
2025,CC:2F:71:3F:1F:24,4000460,751403727,236864,276701308,3763596,474702419,27,199886,229403536,199798,229392606,88,10930,191040,6,236864,22556,24,148,144444.0,43333.0,-71.0,-66.0,-67.0,-68.0,-71.0,-66.0,-67.0,-68.0,-89.0,-90.0,-87.0,-88.0,18.0,24.0,20.0,20.0,1
2026,CC:2F:71:3E:C5:1F,3763702,474715336,104,12715,3763598,474702621,0,405,34787,328,25515,77,9272,112,2,137,4,0,5,144444.0,39000.0,-70.0,-70.0,-67.0,-60.0,-70.0,-70.0,-66.0,-60.0,-89.0,-90.0,-87.0,-88.0,19.0,20.0,20.0,28.0,1
2027,BA:8C:B9:54:50:24,3763902,474792924,303,90030,3763599,474702894,0,1271,141907,1253,139061,18,2846,200,5,421,7,0,8,229410.0,130000.0,-48.0,-35.0,-42.0,-45.0,-46.0,-35.0,-43.0,-46.0,-89.0,-90.0,-87.0,-88.0,41.0,55.0,45.0,43.0,1
2028,92:69:1D:31:68:E9,3776423,489966347,12824,15263453,3763599,474702894,3,19349,3596294,18649,3435262,700,161032,6475,105,14087,252,3,252,216660.0,130000.0,-52.0,-47.0,-42.0,-48.0,-52.0,-48.0,-42.0,-48.0,-89.0,-90.0,-87.0,-88.0,37.0,43.0,45.0,40.0,1
2029,CC:2F:71:3F:1F:24,4000827,751814347,237226,277111251,3763601,474703096,27,200115,229538198,200027,229527268,88,10930,191260,6,237226,22572,24,148,144444.0,43333.0,-71.0,-66.0,-69.0,-68.0,-71.0,-66.0,-68.0,-68.0,-89.0,-89.0,-87.0,-87.0,18.0,23.0,18.0,19.0,1
2030,CC:2F:71:3E:C5:1F,3763705,474715811,104,12715,3763601,474703096,0,405,34787,328,25515,77,9272,112,2,137,4,0,5,144444.0,39000.0,-70.0,-70.0,-67.0,-60.0,-70.0,-70.0,-66.0,-60.0,-89.0,-89.0,-87.0,-87.0,19.0,19.0,20.0,27.0,1
2031,BA:8C:B9:54:50:24,3763904,474793126,303,90030,3763601,474703096,0,1271,141907,1253,139061,18,2846,200,5,421,7,0,8,229410.0,130000.0,-48.0,-35.0,-42.0,-45.0,-46.0,-35.0,-43.0,-46.0,-89.0,-89.0,-87.0,-87.0,41.0,54.0,45.0,42.0,1
2032,92:69:1D:31:68:E9,3776426,489966609,12824,15263453,3763602,474703156,3,19349,3596294,18649,3435262,700,161032,6475,105,14087,252,3,252,216660.0,130000.0,-52.0,-47.0,-42.0,-48.0,-52.0,-48.0,-42.0,-48.0,-89.0,-89.0,-87.0,-87.0,37.0,42.0,45.0,39.0,1
2033,CC:2F:71:3F:1F:24,4001285,752388464,237679,277684904,3763606,474703560,27,200352,229672844,200264,229661914,88,10930,191493,6,237679,22624,24,148,144444.0,43333.0,-70.0,-66.0,-67.0,-69.0,-70.0,-66.0,-67.0,-69.0,-89.0,-89.0,-87.0,-87.0,19.0,23.0,20.0,18.0,1
2034,CC:2F:71:3E:C5:1F,3763710,474716275,104,12715,3763606,474703560,0,405,34787,328,25515,77,9272,112,2,137,4,0,5,144444.0,39000.0,-70.0,-70.0,-67.0,-60.0,-70.0,-70.0,-66.0,-60.0,-89.0,-89.0,-87.0,-87.0,19.0,19.0,20.0,27.0,1
2035,BA:8C:B9:54:50:24,3763911,474793792,303,90030,3763608,474703762,0,1271,141907,1253,139061,18,2846,200,5,421,7,0,8,229410.0,130000.0,-48.0,-35.0,-42.0,-45.0,-46.0,-35.0,-43.0,-46.0,-89.0,-89.0,-87.0,-87.0,41.0,54.0,45.0,42.0,1
2036,92:69:1D:31:68:E9,3776432,489967215,12824,15263453,3763608,474703762,3,19349,3596294,18649,3435262,700,161032,6475,105,14087,252,3,252,216660.0,130000.0,-52.0,-47.0,-42.0,-48.0,-52.0,-48.0,-42.0,-48.0,-89.0,-89.0,-87.0,-87.0,37.0,42.0,45.0,39.0,1
2037,CC:2F:71:3F:1F:24,4001794,753001700,238184,278297736,3763610,474703964,27,200632,229809508,200544,229798578,88,10930,191761,6,238184,22626,24,148,144444.0,43333.0,-70.0,-66.0,-67.0,-69.0,-70.0,-66.0,-67.0,-69.0,-89.0,-89.0,-87.0,-87.0,19.0,23.0,20.0,18.0,1
2038,CC:2F:71:3E:C5:1F,3763714,474716679,104,12715,3763610,474703964,0,405,34787,328,25515,77,9272,112,2,137,4,0,5,144444.0,39000.0,-70.0,-70.0,-67.0,-60.0,-70.0,-70.0,-66.0,-60.0,-89.0,-89.0,-87.0,-87.0,19.0,19.0,20.0,27.0,1
2039,BA:8C:B9:54:50:24,3763913,474793994,303,90030,3763610,474703964,0,1271,141907,1253,139061,18,2846,200,5,421,7,0,8,229410.0,130000.0,-48.0,-35.0,-42.0,-45.0,-46.0,-35.0,-43.0,-46.0,-89.0,-89.0,-87.0,-87.0,41.0,54.0,45.0,42.0,1
2040,92:69:1D:31:68:E9,3776434,489967417,12824,15263453,3763610,474703964,3,19349,3596294,18649,3435262,700,161032,6475,105,14087,252,3,252,216660.0,130000.0,-52.0,-47.0,-42.0,-48.0,-52.0,-48.0,-42.0,-48.0,-89.0,-89.0,-87.0,-87.0,37.0,42.0,45.0,39.0,1
2041,CC:2F:71:3F:1F:24,4002318,753628454,238703,278924026,3763615,474704428,27,200928,229950630,200840,229939700,88,10930,192041,6,238703,22627,24,148,144444.0,43333.0,-73.0,-70.0,-70.0,-73.0,-73.0,-69.0,-70.0,-72.0,-89.0,-89.0,-87.0,-87.0,16.0,19.0,17.0,14.0,1
2042,CC:2F:71:3E:C5:1F,3763719,474717143,104,12715,3763615,474704428,0,405,34787,328,25515,77,9272,112,2,137,4,0,5,144444.0,39000.0,-70.0,-70.0,-67.0,-60.0,-70.0,-70.0,-66.0,-60.0,-89.0,-89.0,-87.0,-87.0,19.0,19.0,20.0,27.0,1
2043,BA:8C:B9:54:50:24,3763920,474794660,303,90030,3763617,474704630,0,1271,141907,1253,139061,18,2846,200,5,421,7,0,8,229410.0,130000.0,-48.0,-35.0,-42.0,-45.0,-46.0,-35.0,-43.0,-46.0,-89.0,-89.0,-87.0,-87.0,41.0,54.0,45.0,42.0,1
2044,92:69:1D:31:68:E9,3776441,489968083,12824,15263453,3763617,474704630,3,19349,3596294,18649,3435262,700,161032,6475,105,14087,252,3,252,216660.0,130000.0,-52.0,-47.0,-42.0,-48.0,-52.0,-48.0,-42.0,-48.0,-89.0,-89.0,-87.0,-87.0,37.0,42.0,45.0,39.0,1
2045,CC:2F:71:3F:1F:24,4002429,753747264,238810,279042432,3763619,474704832,27,201020,230062462,200932,230051532,88,10930,192129,6,238810,22629,24,148,144444.0,43333.0,-73.0,-70.0,-71.0,-73.0,-71.0,-68.0,-69.0,-71.0,-89.0,-89.0,-87.0,-87.0,16.0,19.0,16.0,14.0,1
2046,CC:2F:71:3E:C5:1F,3763723,474717547,104,12715,3763619,474704832,0,405,34787,328,25515,77,9272,112,2,137,4,0,5,144444.0,39000.0,-70.0,-70.0,-67.0,-60.0,-70.0,-70.0,-66.0,-60.0,-89.0,-89.0,-87.0,-87.0,19.0,19.0,20.0,27.0,1
2047,BA:8C:B9:54:50:24,3763922,474794862,303,90030,3763619,474704832,0,1271,141907,1253,139061,18,2846,200,5,421,7,0,8,229410.0,130000.0,-48.0,-35.0,-42.0,-45.0,-46.0,-35.0,-43.0,-46.0,-89.0,-89.0,-87.0,-87.0,41.0,54.0,45.0,42.0,1
2048,92:69:1D:31:68:E9,3776443,489968285,12824,15263453,3763619,474704832,3,19349,3596294,18649,3435262,700,161032,6475,105,14087,252,3,252,216660.0,130000.0,-52.0,-47.0,-42.0,-48.0,-52.0,-48.0,-42.0,-48.0,-89.0,-89.0,-87.0,-87.0,37.0,42.0,45.0,39.0,1
2049,CC:2F:71:3F:1F:24,4002539,753865944,238916,279160708,3763623,474705236,27,201108,230170860,201020,230159930,88,10930,192216,6,238916,22632,24,148,144444.0,43333.0,-70.0,-66.0,-67.0,-69.0,-70.0,-66.0,-67.0,-69.0,-89.0,-89.0,-86.0,-87.0,19.0,23.0,19.0,18.0,1
2050,CC:2F:71:3E:C5:1F,3763727,474717951,104,12715,3763623,474705236,0,405,34787,328,25515,77,9272,112,2,137,4,0,5,144444.0,39000.0,-70.0,-70.0,-67.0,-60.0,-70.0,-70.0,-66.0,-60.0,-89.0,-89.0,-86.0,-87.0,19.0,19.0,19.0,27.0,1
2051,BA:8C:B9:54:50:24,3763926,474795266,303,90030,3763623,474705236,0,1271,141907,1253,139061,18,2846,200,5,421,7,0,8,229410.0,130000.0,-48.0,-35.0,-42.0,-45.0,-46.0,-35.0,-43.0,-46.0,-89.0,-89.0,-86.0,-87.0,41.0,54.0,44.0,42.0,1
2052,92:69:1D:31:68:E9,3776447,489968689,12824,15263453,3763623,474705236,3,19349,3596294,18649,3435262,700,161032,6475,105,14087,252,3,252,216660.0,130000.0,-52.0,-47.0,-42.0,-48.0,-52.0,-48.0,-42.0,-48.0,-89.0,-89.0,-86.0,-87.0,37.0,42.0,44.0,39.0,1
2053,CC:2F:71:3F:1F:24,4002650,753986166,239024,279280668,3763626,474705498,27,201198,230279476,201110,230268546,88,10930,192306,6,239024,22634,24,148,144444.0,43333.0,-70.0,-66.0,-67.0,-70.0,-70.0,-66.0,-67.0,-69.0,-89.0,-89.0,-86.0,-87.0,19.0,23.0,19.0,17.0,1
2054,CC:2F:71:3E:C5:1F,3763732,474718415,104,12715,3763628,474705700,0,405,34787,328,25515,77,9272,112,2,137,4,0,5,144444.0,39000.0,-70.0,-70.0,-67.0,-60.0,-70.0,-70.0,-66.0,-60.0,-89.0,-89.0,-86.0,-87.0,19.0,19.0,19.0,27.0,1
2055,BA:8C:B9:54:50:24,3763931,474795730,303,90030,3763628,474705700,0,1271,141907,1253,139061,18,2846,200,5,421,7,0,8,229410.0,130000.0,-48.0,-35.0,-42.0,-45.0,-46.0,-35.0,-43.0,-46.0,-88.0,-88.0,-86.0,-86.0,40.0,53.0,44.0,41.0,1
2056,92:69:1D:31:68:E9,3776453,489969269,12825,15263569,3763628,474705700,3,19350,3596362,18650,3435330,700,161032,6475,105,14088,252,3,252,216660.0,130000.0,-52.0,-47.0,-42.0,-48.0,-52.0,-48.0,-42.0,-48.0,-88.0,-88.0,-86.0,-86.0,36.0,41.0,44.0,38.0,1
2057,CC:2F:71:3F:1F:24,4002775,754115751,239143,279409647,3763632,474706104,27,201307,230406575,201219,230395645,88,10930,192407,6,239143,22636,24,148,144444.0,43333.0,-70.0,-67.0,-68.0,-70.0,-70.0,-67.0,-68.0,-69.0,-88.0,-88.0,-86.0,-86.0,18.0,21.0,18.0,16.0,1
2058,CC:2F:71:3E:C5:1F,3763737,474718935,105,12831,3763632,474706104,0,407,34927,330,25655,77,9272,112,2,138,4,0,5,144444.0,39000.0,-70.0,-69.0,-67.0,-60.0,-70.0,-70.0,-66.0,-60.0,-88.0,-88.0,-86.0,-86.0,18.0,19.0,19.0,26.0,1
2059,BA:8C:B9:54:50:24,3763936,474796250,304,90146,3763632,474706104,0,1273,142043,1255,139197,18,2846,200,5,422,7,0,8,229410.0,130000.0,-40.0,-37.0,-45.0,-50.0,-45.0,-35.0,-43.0,-47.0,-88.0,-88.0,-86.0,-86.0,48.0,51.0,41.0,36.0,1
2060,92:69:1D:31:68:E9,3776457,489969673,12825,15263569,3763632,474706104,3,19351,3596430,18651,3435398,700,161032,6475,105,14088,252,3,252,216660.0,130000.0,-52.0,-47.0,-42.0,-48.0,-52.0,-47.0,-42.0,-47.0,-88.0,-88.0,-86.0,-86.0,36.0,41.0,44.0,38.0,1
2061,CC:2F:71:3F:1F:24,4002884,754234359,239250,279528053,3763634,474706306,27,201398,230516821,201310,230505891,88,10930,192495,6,239250,22637,24,148,144444.0,43333.0,-74.0,-70.0,-70.0,-73.0,-73.0,-69.0,-70.0,-72.0,-88.0,-88.0,-86.0,-86.0,14.0,18.0,16.0,13.0,1
2062,CC:2F:71:3E:C5:1F,3763741,474719339,105,12831,3763636,474706508,0,407,34927,330,25655,77,9272,112,2,138,4,0,5,144444.0,39000.0,-70.0,-69.0,-67.0,-60.0,-70.0,-70.0,-66.0,-60.0,-88.0,-88.0,-86.0,-86.0,18.0,19.0,19.0,26.0,1
2063,BA:8C:B9:54:50:24,3763940,474796654,304,90146,3763636,474706508,0,1273,142043,1255,139197,18,2846,200,5,422,7,0,8,229410.0,130000.0,-40.0,-37.0,-45.0,-50.0,-45.0,-35.0,-43.0,-47.0,-88.0,-88.0,-86.0,-86.0,48.0,51.0,41.0,36.0,1
2064,92:69:1D:31:68:E9,3776461,489970077,12825,15263569,3763636,474706508,3,19351,3596430,18651,3435398,700,161032,6475,105,14088,252,3,252,216660.0,130000.0,-52.0,-47.0,-42.0,-48.0,-52.0,-47.0,-42.0,-47.0,-88.0,-88.0,-86.0,-86.0,36.0,41.0,44.0,38.0,1
2065,CC:2F:71:3F:1F:24,4002994,754352969,239355,279646199,3763639,474706770,27,201489,230628553,201401,230617623,88,10930,192582,6,239355,22639,24,148,144444.0,43333.0,-70.0,-66.0,-68.0,-70.0,-72.0,-69.0,-70.0,-71.0,-88.0,-88.0,-86.0,-86.0,18.0,22.0,18.0,16.0,1
2066,CC:2F:71:3E:C5:1F,3763746,474719803,105,12831,3763641,474706972,0,407,34927,330,25655,77,9272,112,2,138,4,0,5,144444.0,39000.0,-70.0,-69.0,-67.0,-60.0,-70.0,-70.0,-66.0,-60.0,-88.0,-88.0,-86.0,-86.0,18.0,19.0,19.0,26.0,1
2067,BA:8C:B9:54:50:24,3763945,474797118,304,90146,3763641,474706972,0,1273,142043,1255,139197,18,2846,200,5,422,7,0,8,229410.0,130000.0,-40.0,-37.0,-45.0,-50.0,-45.0,-35.0,-43.0,-47.0,-88.0,-88.0,-86.0,-86.0,48.0,51.0,41.0,36.0,1
2068,92:69:1D:31:68:E9,3776466,489970541,12825,15263569,3763641,474706972,3,19351,3596430,18651,3435398,700,161032,6475,105,14088,252,3,252,216660.0,130000.0,-52.0,-47.0,-42.0,-48.0,-52.0,-47.0,-42.0,-47.0,-88.0,-88.0,-86.0,-86.0,36.0,41.0,44.0,38.0,1
2069,CC:2F:71:3F:1F:24,4003273,754685420,239630,279978246,3763643,474707174,27,201663,230756807,201575,230745877,88,10930,192748,6,239630,22658,24,148,144444.0,43333.0,-70.0,-66.0,-67.0,-69.0,-70.0,-66.0,-67.0,-69.0,-88.0,-88.0,-86.0,-86.0,18.0,22.0,19.0,17.0,1
2070,CC:2F:71:3E:C5:1F,3763748,474720005,105,12831,3763643,474707174,0,407,34927,330,25655,77,9272,112,2,138,4,0,5,144444.0,39000.0,-70.0,-69.0,-67.0,-60.0,-70.0,-70.0,-66.0,-60.0,-88.0,-88.0,-86.0,-86.0,18.0,19.0,19.0,26.0,1
2071,BA:8C:B9:54:50:24,3763947,474797320,304,90146,3763643,474707174,0,1273,142043,1255,139197,18,2846,200,5,422,7,0,8,229410.0,130000.0,-40.0,-37.0,-45.0,-50.0,-45.0,-35.0,-43.0,-47.0,-88.0,-88.0,-86.0,-86.0,48.0,51.0,41.0,36.0,1
2072,92:69:1D:31:68:E9,3776470,489970945,12825,15263569,3763645,474707376,3,19351,3596430,18651,3435398,700,161032,6475,105,14088,252,3,252,216660.0,130000.0,-52.0,-47.0,-42.0,-48.0,-52.0,-47.0,-42.0,-47.0,-88.0,-88.0,-86.0,-86.0,36.0,41.0,44.0,38.0,1
2073,CC:2F:71:3F:1F:24,4003617,755089460,239969,280381822,3763648,474707638,27,201865,230883269,201777,230872339,88,10930,192941,6,239965,22674,24,149,144444.0,43333.0,-70.0,-66.0,-67.0,-70.0,-70.0,-66.0,-67.0,-69.0,-88.0,-88.0,-86.0,-86.0,18.0,22.0,19.0,16.0,1
2074,CC:2F:71:3E:C5:1F,3763755,474720671,105,12831,3763650,474707840,0,407,34927,330,25655,77,9272,112,2,138,4,0,5,144444.0,39000.0,-70.0,-69.0,-67.0,-60.0,-70.0,-70.0,-66.0,-60.0,-88.0,-88.0,-86.0,-86.0,18.0,19.0,19.0,26.0,1
2075,BA:8C:B9:54:50:24,3763954,474797986,304,90146,3763650,474707840,0,1273,142043,1255,139197,18,2846,200,5,422,7,0,8,229410.0,130000.0,-40.0,-37.0,-45.0,-50.0,-45.0,-35.0,-43.0,-47.0,-88.0,-88.0,-86.0,-86.0,48.0,51.0,41.0,36.0,1
2076,92:69:1D:31:68:E9,3776475,489971409,12825,15263569,3763650,474707840,3,19351,3596430,18651,3435398,700,161032,6475,105,14088,252,3,252,216660.0,130000.0,-52.0,-47.0,-42.0,-48.0,-52.0,-47.0,-42.0,-47.0,-88.0,-88.0,-86.0,-86.0,36.0,41.0,44.0,38.0,1
2077,CC:2F:71:3F:1F:24,4004098,755699683,240446,280991641,3763652,474708042,27,202109,231020205,202021,231009275,88,10930,193182,6,240446,22702,24,149,144444.0,43333.0,-70.0,-66.0,-67.0,-70.0,-70.0,-66.0,-67.0,-69.0,-88.0,-88.0,-86.0,-86.0,18.0,22.0,19.0,16.0,1
2078,CC:2F:71:3E:C5:1F,3763757,474720873,105,12831,3763652,474708042,0,407,34927,330,25655,77,9272,112,2,138,4,0,5,144444.0,39000.0,-70.0,-69.0,-67.0,-60.0,-70.0,-70.0,-66.0,-60.0,-88.0,-88.0,-86.0,-86.0,18.0,19.0,19.0,26.0,1
2079,BA:8C:B9:54:50:24,3763956,474798188,304,90146,3763652,474708042,0,1273,142043,1255,139197,18,2846,200,5,422,7,0,8,229410.0,130000.0,-40.0,-37.0,-45.0,-50.0,-45.0,-35.0,-43.0,-47.0,-88.0,-88.0,-86.0,-86.0,48.0,51.0,41.0,36.0,1
2080,92:69:1D:31:68:E9,3776479,489971813,12825,15263569,3763654,474708244,3,19351,3596430,18651,3435398,700,161032,6475,105,14088,252,3,252,216660.0,130000.0,-52.0,-47.0,-42.0,-48.0,-52.0,-47.0,-42.0,-47.0,-88.0,-88.0,-86.0,-86.0,36.0,41.0,44.0,38.0,1
2081,CC:2F:71:3F:1F:24,4004210,755818762,240552,281109917,3763658,474708845,27,202199,231130273,202111,231119343,88,10930,193270,6,240552,22703,24,149,144444.0,43333.0,-70.0,-66.0,-67.0,-69.0,-70.0,-66.0,-67.0,-69.0,-87.0,-88.0,-86.0,-86.0,17.0,22.0,19.0,17.0,1
2082,CC:2F:71:3E:C5:1F,3763763,474721676,105,12831,3763658,474708845,0,407,34927,330,25655,77,9272,112,2,138,4,0,5,144444.0,39000.0,-70.0,-69.0,-67.0,-60.0,-70.0,-70.0,-66.0,-60.0,-87.0,-88.0,-86.0,-86.0,17.0,19.0,19.0,26.0,1
2083,BA:8C:B9:54:50:24,3763964,474799193,304,90146,3763660,474709047,0,1273,142043,1255,139197,18,2846,200,5,422,7,0,8,229410.0,130000.0,-40.0,-37.0,-45.0,-50.0,-45.0,-35.0,-43.0,-47.0,-87.0,-88.0,-86.0,-86.0,47.0,51.0,41.0,36.0,1
2084,92:69:1D:31:68:E9,3776485,489972616,12825,15263569,3763660,474709047,3,19351,3596430,18651,3435398,700,161032,6475,105,14088,252,3,252,216660.0,130000.0,-52.0,-47.0,-42.0,-48.0,-52.0,-47.0,-42.0,-47.0,-87.0,-88.0,-86.0,-86.0,35.0,41.0,44.0,38.0,1
2085,CC:2F:71:3F:1F:24,4004324,755940812,240661,281231503,3763663,474709309,27,202295,231242381,202207,231231451,88,10930,193362,6,240662,22710,24,149,144444.0,43333.0,-70.0,-66.0,-68.0,-69.0,-70.0,-66.0,-67.0,-69.0,-87.0,-88.0,-86.0,-86.0,17.0,22.0,18.0,17.0,1
2086,CC:2F:71:3E:C5:1F,3763768,474722140,105,12831,3763663,474709309,0,407,34927,330,25655,77,9272,112,2,138,4,0,5,144444.0,39000.0,-70.0,-69.0,-67.0,-60.0,-70.0,-70.0,-66.0,-60.0,-87.0,-88.0,-86.0,-86.0,17.0,19.0,19.0,26.0,1
2087,BA:8C:B9:54:50:24,3763967,474799455,304,90146,3763663,474709309,0,1273,142043,1255,139197,18,2846,200,5,422,7,0,8,229410.0,130000.0,-40.0,-37.0,-45.0,-50.0,-45.0,-35.0,-43.0,-47.0,-87.0,-88.0,-86.0,-86.0,47.0,51.0,41.0,36.0,1
2088,92:69:1D:31:68:E9,3776490,489973080,12825,15263569,3763665,474709511,3,19351,3596430,18651,3435398,700,161032,6475,105,14088,252,3,252,216660.0,130000.0,-52.0,-47.0,-42.0,-48.0,-52.0,-47.0,-42.0,-47.0,-87.0,-88.0,-86.0,-86.0,35.0,41.0,44.0,38.0,1
2089,CC:2F:71:3F:1F:24,4004434,756060916,240767,281351203,3763667,474709713,27,202392,231359203,202304,231348273,88,10930,193452,6,240768,22712,24,149,144444.0,43333.0,-70.0,-66.0,-67.0,-69.0,-70.0,-66.0,-67.0,-69.0,-87.0,-88.0,-86.0,-86.0,17.0,22.0,19.0,17.0,1
2090,CC:2F:71:3E:C5:1F,3763772,474722544,105,12831,3763667,474709713,0,407,34927,330,25655,77,9272,112,2,138,4,0,5,144444.0,39000.0,-70.0,-69.0,-67.0,-60.0,-70.0,-70.0,-66.0,-60.0,-87.0,-88.0,-86.0,-86.0,17.0,19.0,19.0,26.0,1
2091,BA:8C:B9:54:50:24,3763971,474799859,304,90146,3763667,474709713,0,1273,142043,1255,139197,18,2846,200,5,422,7,0,8,229410.0,130000.0,-40.0,-37.0,-45.0,-50.0,-45.0,-35.0,-43.0,-47.0,-87.0,-88.0,-86.0,-86.0,47.0,51.0,41.0,36.0,1
2092,92:69:1D:31:68:E9,3776492,489973282,12825,15263569,3763667,474709713,3,19351,3596430,18651,3435398,700,161032,6475,105,14088,252,3,252,216660.0,130000.0,-52.0,-47.0,-42.0,-48.0,-52.0,-47.0,-42.0,-47.0,-87.0,-88.0,-86.0,-86.0,35.0,41.0,44.0,38.0,1
2093,CC:2F:71:3F:1F:24,4004553,756181835,240881,281471656,3763672,474710179,27,202490,231469267,202402,231458337,88,10930,193548,6,240882,22712,24,149,144444.0,43333.0,-69.0,-67.0,-69.0,-70.0,-69.0,-67.0,-68.0,-70.0,-87.0,-88.0,-86.0,-86.0,18.0,21.0,17.0,16.0,1
2094,CC:2F:71:3E:C5:1F,3763777,474723010,105,12831,3763672,474710179,0,409,35115,331,25725,78,9390,113,2,138,4,0,5,144444.0,39000.0,-71.0,-72.0,-66.0,-60.0,-70.0,-70.0,-66.0,-60.0,-87.0,-88.0,-86.0,-86.0,16.0,16.0,20.0,26.0,1
2095,BA:8C:B9:54:50:24,3763976,474800325,304,90146,3763672,474710179,0,1273,142043,1255,139197,18,2846,200,5,422,7,0,8,229410.0,130000.0,-40.0,-37.0,-45.0,-50.0,-45.0,-35.0,-43.0,-47.0,-87.0,-88.0,-86.0,-86.0,47.0,51.0,41.0,36.0,1
2096,92:69:1D:31:68:E9,3776497,489973748,12825,15263569,3763672,474710179,3,19351,3596430,18651,3435398,700,161032,6475,105,14088,252,3,252,216660.0,130000.0,-52.0,-47.0,-42.0,-48.0,-52.0,-47.0,-42.0,-47.0,-87.0,-88.0,-86.0,-86.0,35.0,41.0,44.0,38.0,1
2097,CC:2F:71:3F:1F:24,4004664,756301999,240987,281591356,3763677,474710643,27,202585,231584479,202497,231573549,88,10930,193635,6,240987,22732,24,149,144444.0,43333.0,-69.0,-66.0,-71.0,-68.0,-68.0,-66.0,-71.0,-67.0,-87.0,-88.0,-86.0,-86.0,18.0,22.0,15.0,18.0,1
2098,CC:2F:71:3E:C5:1F,3763782,474723474,105,12831,3763677,474710643,0,409,35115,331,25725,78,9390,113,2,138,4,0,5,144444.0,39000.0,-71.0,-72.0,-66.0,-60.0,-70.0,-70.0,-66.0,-60.0,-87.0,-88.0,-86.0,-86.0,16.0,16.0,20.0,26.0,1
2099,BA:8C:B9:54:50:24,3763981,474800789,304,90146,3763677,474710643,0,1273,142043,1255,139197,18,2846,200,5,422,7,0,8,229410.0,130000.0,-40.0,-37.0,-45.0,-50.0,-45.0,-35.0,-43.0,-47.0,-87.0,-88.0,-86.0,-86.0,47.0,51.0,41.0,36.0,1
2100,92:69:1D:31:68:E9,3776502,489974212,12825,15263569,3763677,474710643,3,19352,3596498,18652,3435466,700,161032,6475,105,14088,252,3,252,216660.0,130000.0,-52.0,-47.0,-42.0,-48.0,-52.0,-47.0,-42.0,-47.0,-87.0,-88.0,-86.0,-86.0,35.0,41.0,44.0,38.0,1
2101,CC:2F:71:3F:1F:24,4004801,756437848,241097,281715778,3763704,474722070,27,202680,231702279,202592,231691349,88,10930,193728,6,241098,22772,24,149,130000.0,43333.0,-70.0,-66.0,-72.0,-68.0,-70.0,-66.0,-71.0,-67.0,-87.0,-88.0,-86.0,-86.0,17.0,22.0,14.0,18.0,1
2102,CC:2F:71:3E:C5:1F,3763809,474734901,105,12831,3763704,474722070,0,409,35115,331,25725,78,9390,113,2,138,4,0,5,144444.0,39000.0,-71.0,-72.0,-66.0,-60.0,-70.0,-70.0,-66.0,-60.0,-87.0,-88.0,-86.0,-86.0,16.0,16.0,20.0,26.0,1
2103,BA:8C:B9:54:50:24,3764008,474812216,304,90146,3763704,474722070,0,1273,142043,1255,139197,18,2846,200,5,422,7,0,8,229410.0,130000.0,-40.0,-37.0,-45.0,-50.0,-45.0,-35.0,-43.0,-47.0,-87.0,-88.0,-86.0,-86.0,47.0,51.0,41.0,36.0,1
2104,92:69:1D:31:68:E9,3776529,489985639,12825,15263569,3763704,474722070,3,19355,3596869,18654,3435602,701,161267,6476,105,14088,252,3,252,216660.0,130000.0,-52.0,-47.0,-42.0,-48.0,-52.0,-47.0,-42.0,-48.0,-87.0,-88.0,-86.0,-86.0,35.0,41.0,44.0,38.0,1
2105,CC:2F:71:3F:1F:24,4004913,756559398,241204,281836864,3763709,474722534,27,202780,231823545,202692,231812615,88,10930,193821,6,241205,22772,24,149,130000.0,43333.0,-68.0,-67.0,-70.0,-67.0,-68.0,-67.0,-69.0,-67.0,-87.0,-88.0,-86.0,-86.0,19.0,21.0,16.0,19.0,1
2106,CC:2F:71:3E:C5:1F,3763814,474735365,105,12831,3763709,474722534,0,409,35115,331,25725,78,9390,113,2,138,4,0,5,144444.0,39000.0,-71.0,-72.0,-66.0,-60.0,-70.0,-70.0,-66.0,-60.0,-87.0,-88.0,-86.0,-86.0,16.0,16.0,20.0,26.0,1
2107,BA:8C:B9:54:50:24,3764013,474812680,304,90146,3763709,474722534,0,1273,142043,1255,139197,18,2846,200,5,422,7,0,8,229410.0,130000.0,-40.0,-37.0,-45.0,-50.0,-45.0,-35.0,-43.0,-47.0,-87.0,-88.0,-86.0,-86.0,47.0,51.0,41.0,36.0,1
2108,92:69:1D:31:68:E9,3776536,489986305,12825,15263569,3763711,474722736,3,19355,3596869,18654,3435602,701,161267,6476,105,14088,252,3,252,216660.0,130000.0,-52.0,-47.0,-42.0,-48.0,-52.0,-47.0,-42.0,-48.0,-87.0,-88.0,-86.0,-86.0,35.0,41.0,44.0,38.0,1
2109,CC:2F:71:3F:1F:24,4005034,756684733,241318,281961365,3763716,474723368,27,202885,231938864,202796,231927816,89,11048,193921,6,241319,22776,24,149,130000.0,43333.0,-72.0,-71.0,-74.0,-70.0,-71.0,-70.0,-73.0,-69.0,-87.0,-88.0,-86.0,-86.0,15.0,17.0,12.0,16.0,1
2110,CC:2F:71:3E:C5:1F,3763821,474736199,105,12831,3763716,474723368,0,409,35115,331,25725,78,9390,113,2,138,4,0,5,144444.0,39000.0,-71.0,-72.0,-66.0,-60.0,-70.0,-70.0,-66.0,-60.0,-87.0,-88.0,-86.0,-86.0,16.0,16.0,20.0,26.0,1
2111,BA:8C:B9:54:50:24,3764020,474813514,304,90146,3763716,474723368,0,1275,142179,1257,139333,18,2846,200,5,423,7,0,8,229410.0,130000.0,-40.0,-37.0,-45.0,-51.0,-44.0,-36.0,-43.0,-47.0,-87.0,-88.0,-86.0,-86.0,47.0,51.0,41.0,35.0,1
2112,92:69:1D:31:68:E9,3776541,489986937,12825,15263569,3763716,474723368,3,19355,3596869,18654,3435602,701,161267,6476,105,14088,252,3,252,216660.0,130000.0,-52.0,-47.0,-42.0,-48.0,-52.0,-47.0,-42.0,-48.0,-87.0,-88.0,-86.0,-86.0,35.0,41.0,44.0,38.0,1
2113,CC:2F:71:3F:1F:24,4005147,756806651,241427,282082879,3763720,474723772,27,202982,232059782,202893,232048734,89,11048,194011,6,241427,22778,24,149,130000.0,43333.0,-72.0,-70.0,-74.0,-70.0,-71.0,-70.0,-74.0,-70.0,-87.0,-88.0,-86.0,-86.0,15.0,18.0,12.0,16.0,1
2114,CC:2F:71:3E:C5:1F,3763825,474736603,105,12831,3763720,474723772,0,409,35115,331,25725,78,9390,113,2,138,4,0,5,144444.0,39000.0,-71.0,-72.0,-66.0,-60.0,-70.0,-70.0,-66.0,-60.0,-87.0,-88.0,-86.0,-86.0,16.0,16.0,20.0,26.0,1
2115,BA:8C:B9:54:50:24,3764024,474813918,304,90146,3763720,474723772,0,1275,142179,1257,139333,18,2846,200,5,423,7,0,8,229410.0,130000.0,-40.0,-37.0,-45.0,-51.0,-44.0,-36.0,-43.0,-47.0,-87.0,-88.0,-86.0,-86.0,47.0,51.0,41.0,35.0,1
2116,92:69:1D:31:68:E9,3776547,489987543,12825,15263569,3763722,474723974,3,19355,3596869,18654,3435602,701,161267,6476,105,14088,252,3,252,216660.0,130000.0,-52.0,-47.0,-42.0,-48.0,-52.0,-47.0,-42.0,-48.0,-87.0,-88.0,-86.0,-86.0,35.0,41.0,44.0,38.0,1
2117,CC:2F:71:3F:1F:24,4005259,756925521,241534,282201285,3763725,474724236,27,203073,232169966,202984,232158918,89,11048,194100,6,241535,22778,24,149,130000.0,43333.0,-72.0,-70.0,-74.0,-70.0,-71.0,-69.0,-73.0,-70.0,-87.0,-88.0,-86.0,-86.0,15.0,18.0,12.0,16.0,1
2118,CC:2F:71:3E:C5:1F,3763830,474737067,105,12831,3763725,474724236,0,409,35115,331,25725,78,9390,113,2,138,4,0,5,144444.0,39000.0,-71.0,-72.0,-66.0,-60.0,-70.0,-70.0,-66.0,-60.0,-87.0,-88.0,-86.0,-85.0,16.0,16.0,20.0,25.0,1
2119,BA:8C:B9:54:50:24,3764029,474814382,304,90146,3763725,474724236,0,1275,142179,1257,139333,18,2846,200,5,423,7,0,8,229410.0,130000.0,-40.0,-37.0,-45.0,-51.0,-44.0,-36.0,-43.0,-47.0,-87.0,-88.0,-86.0,-85.0,47.0,51.0,41.0,34.0,1
2120,92:69:1D:31:68:E9,3776550,489987805,12825,15263569,3763725,474724236,3,19355,3596869,18654,3435602,701,161267,6476,105,14088,252,3,252,216660.0,130000.0,-52.0,-47.0,-42.0,-48.0,-52.0,-47.0,-42.0,-48.0,-87.0,-88.0,-86.0,-85.0,35.0,41.0,44.0,37.0,1
2121,CC:2F:71:3F:1F:24,4005369,757045401,241640,282320761,3763729,474724640,27,203167,232284812,203078,232273764,89,11048,194189,6,241641,22783,24,149,130000.0,43333.0,-71.0,-70.0,-73.0,-71.0,-71.0,-70.0,-73.0,-71.0,-87.0,-88.0,-86.0,-85.0,16.0,18.0,13.0,14.0,1
2122,CC:2F:71:3E:C5:1F,3763834,474737471,105,12831,3763729,474724640,0,409,35115,331,25725,78,9390,113,2,138,4,0,5,144444.0,39000.0,-71.0,-72.0,-66.0,-60.0,-70.0,-70.0,-66.0,-60.0,-87.0,-88.0,-86.0,-85.0,16.0,16.0,20.0,25.0,1
2123,BA:8C:B9:54:50:24,3764033,474814786,304,90146,3763729,474724640,0,1275,142179,1257,139333,18,2846,200,5,423,7,0,8,229410.0,130000.0,-40.0,-37.0,-45.0,-51.0,-44.0,-36.0,-43.0,-47.0,-87.0,-88.0,-86.0,-85.0,47.0,51.0,41.0,34.0,1
2124,92:69:1D:31:68:E9,3776554,489988209,12825,15263569,3763729,474724640,3,19355,3596869,18654,3435602,701,161267,6476,105,14088,252,3,252,216660.0,130000.0,-52.0,-47.0,-42.0,-48.0,-52.0,-47.0,-42.0,-48.0,-87.0,-88.0,-86.0,-85.0,35.0,41.0,44.0,37.0,1
2125,CC:2F:71:3F:1F:24,4005478,757163727,241745,282438683,3763733,474725044,27,203269,232405356,203180,232394308,89,11048,194279,6,241746,22787,24,149,130000.0,43333.0,-72.0,-69.0,-72.0,-70.0,-70.0,-68.0,-70.0,-69.0,-87.0,-88.0,-86.0,-85.0,15.0,19.0,14.0,15.0,1
2126,CC:2F:71:3E:C5:1F,3763838,474737875,105,12831,3763733,474725044,0,409,35115,331,25725,78,9390,113,2,138,4,0,5,144444.0,39000.0,-71.0,-72.0,-66.0,-60.0,-70.0,-70.0,-66.0,-60.0,-87.0,-88.0,-86.0,-85.0,16.0,16.0,20.0,25.0,1
2127,BA:8C:B9:54:50:24,3764037,474815190,304,90146,3763733,474725044,0,1275,142179,1257,139333,18,2846,200,5,423,7,0,8,229410.0,130000.0,-40.0,-37.0,-45.0,-51.0,-44.0,-36.0,-43.0,-47.0,-87.0,-88.0,-86.0,-85.0,47.0,51.0,41.0,34.0,1
2128,92:69:1D:31:68:E9,3776559,489988673,12825,15263569,3763734,474725104,3,19355,3596869,18654,3435602,701,161267,6476,105,14088,252,3,252,216660.0,130000.0,-52.0,-47.0,-42.0,-48.0,-52.0,-47.0,-42.0,-48.0,-87.0,-88.0,-86.0,-85.0,35.0,41.0,44.0,37.0,1
2129,CC:2F:71:3F:1F:24,4005597,757288748,241859,282563240,3763738,474725508,27,203371,232525907,203282,232514859,89,11048,194375,6,241859,22791,24,149,130000.0,39000.0,-68.0,-67.0,-70.0,-68.0,-68.0,-67.0,-70.0,-68.0,-87.0,-88.0,-86.0,-85.0,19.0,21.0,16.0,17.0,1
2130,CC:2F:71:3E:C5:1F,3763843,474738339,105,12831,3763738,474725508,0,409,35115,331,25725,78,9390,113,2,138,4,0,5,144444.0,39000.0,-71.0,-72.0,-66.0,-60.0,-70.0,-70.0,-66.0,-60.0,-87.0,-88.0,-86.0,-85.0,16.0,16.0,20.0,25.0,1
2131,BA:8C:B9:54:50:24,3764042,474815654,304,90146,3763738,474725508,0,1275,142179,1257,139333,18,2846,200,5,423,7,0,8,229410.0,130000.0,-40.0,-37.0,-45.0,-51.0,-44.0,-36.0,-43.0,-47.0,-87.0,-88.0,-86.0,-85.0,47.0,51.0,41.0,34.0,1
2132,92:69:1D:31:68:E9,3776563,489989077,12825,15263569,3763738,474725508,3,19355,3596869,18654,3435602,701,161267,6476,105,14088,252,3,252,216660.0,130000.0,-52.0,-47.0,-42.0,-48.0,-52.0,-47.0,-42.0,-48.0,-87.0,-88.0,-86.0,-85.0,35.0,41.0,44.0,37.0,1
2133,CC:2F:71:3F:1F:24,4005708,757409069,241965,282682884,3763743,474726185,27,203461,232636103,203372,232625055,89,11048,194463,6,241966,22791,24,149,130000.0,43333.0,-69.0,-67.0,-70.0,-68.0,-68.0,-67.0,-70.0,-68.0,-87.0,-88.0,-86.0,-85.0,18.0,21.0,16.0,17.0,1
2134,CC:2F:71:3E:C5:1F,3763848,474739016,105,12831,3763743,474726185,0,409,35115,331,25725,78,9390,113,2,138,4,0,5,144444.0,39000.0,-71.0,-72.0,-66.0,-60.0,-70.0,-70.0,-66.0,-60.0,-87.0,-89.0,-86.0,-86.0,16.0,17.0,20.0,26.0,1
2135,BA:8C:B9:54:50:24,3764047,474816331,304,90146,3763743,474726185,0,1275,142179,1257,139333,18,2846,200,5,423,7,0,8,229410.0,130000.0,-40.0,-37.0,-45.0,-51.0,-44.0,-36.0,-43.0,-47.0,-87.0,-89.0,-86.0,-86.0,47.0,52.0,41.0,35.0,1
2136,92:69:1D:31:68:E9,3776568,489989754,12825,15263569,3763743,474726185,3,19355,3596869,18654,3435602,701,161267,6476,105,14088,252,3,252,216660.0,130000.0,-52.0,-47.0,-42.0,-48.0,-52.0,-47.0,-42.0,-48.0,-87.0,-89.0,-86.0,-86.0,35.0,42.0,44.0,38.0,1
2137,CC:2F:71:3F:1F:24,4005818,757527679,242070,282801030,3763748,474726649,27,203555,232751011,203466,232739963,89,11048,194551,6,242071,22791,24,149,130000.0,43333.0,-69.0,-66.0,-70.0,-68.0,-69.0,-66.0,-70.0,-68.0,-87.0,-89.0,-86.0,-86.0,18.0,23.0,16.0,18.0,1
2138,CC:2F:71:3E:C5:1F,3763853,474739480,105,12831,3763748,474726649,0,409,35115,331,25725,78,9390,113,2,138,4,0,5,144444.0,39000.0,-71.0,-72.0,-66.0,-60.0,-70.0,-70.0,-66.0,-60.0,-87.0,-89.0,-86.0,-86.0,16.0,17.0,20.0,26.0,1
2139,BA:8C:B9:54:50:24,3764052,474816795,304,90146,3763748,474726649,0,1275,142179,1257,139333,18,2846,200,5,423,7,0,8,229410.0,130000.0,-40.0,-37.0,-45.0,-51.0,-44.0,-36.0,-43.0,-47.0,-87.0,-89.0,-86.0,-86.0,47.0,52.0,41.0,35.0,1
2140,92:69:1D:31:68:E9,3776573,489990218,12825,15263569,3763748,474726649,3,19355,3596869,18654,3435602,701,161267,6476,105,14088,252,3,252,216660.0,130000.0,-52.0,-47.0,-42.0,-48.0,-52.0,-47.0,-42.0,-48.0,-87.0,-89.0,-86.0,-86.0,35.0,42.0,44.0,38.0,1
2141,CC:2F:71:3F:1F:24,4005927,757646005,242175,282918952,3763752,474727053,27,203646,232862727,203557,232851679,89,11048,194638,6,242176,22797,24,149,130000.0,43333.0,-68.0,-67.0,-70.0,-68.0,-68.0,-66.0,-70.0,-68.0,-87.0,-89.0,-86.0,-86.0,19.0,22.0,16.0,18.0,1
2142,CC:2F:71:3E:C5:1F,3763857,474739884,105,12831,3763752,474727053,0,409,35115,331,25725,78,9390,113,2,138,4,0,5,144444.0,39000.0,-71.0,-72.0,-66.0,-60.0,-70.0,-70.0,-66.0,-60.0,-87.0,-89.0,-86.0,-86.0,16.0,17.0,20.0,26.0,1
2143,BA:8C:B9:54:50:24,3764056,474817199,304,90146,3763752,474727053,0,1275,142179,1257,139333,18,2846,200,5,423,7,0,8,229410.0,130000.0,-40.0,-37.0,-45.0,-51.0,-44.0,-36.0,-43.0,-47.0,-87.0,-89.0,-86.0,-86.0,47.0,52.0,41.0,35.0,1
2144,92:69:1D:31:68:E9,3776577,489990622,12825,15263569,3763752,474727053,3,19355,3596869,18654,3435602,701,161267,6476,105,14088,252,3,252,216660.0,130000.0,-52.0,-47.0,-42.0,-48.0,-52.0,-47.0,-42.0,-48.0,-87.0,-89.0,-86.0,-86.0,35.0,42.0,44.0,38.0,1
2145,CC:2F:71:3F:1F:24,4006045,757769696,242289,283042239,3763756,474727457,27,203747,232978962,203658,232967914,89,11048,194734,6,242290,22798,24,149,130000.0,43333.0,-69.0,-67.0,-71.0,-68.0,-68.0,-67.0,-70.0,-68.0,-87.0,-89.0,-86.0,-86.0,18.0,22.0,15.0,18.0,1
2146,CC:2F:71:3E:C5:1F,3763861,474740288,105,12831,3763756,474727457,0,409,35115,331,25725,78,9390,113,2,138,4,0,5,144444.0,39000.0,-71.0,-72.0,-66.0,-60.0,-70.0,-70.0,-66.0,-60.0,-87.0,-89.0,-86.0,-86.0,16.0,17.0,20.0,26.0,1
2147,BA:8C:B9:54:50:24,3764060,474817603,304,90146,3763756,474727457,0,1275,142179,1257,139333,18,2846,200,5,423,7,0,8,229410.0,130000.0,-40.0,-37.0,-45.0,-51.0,-44.0,-36.0,-43.0,-47.0,-87.0,-89.0,-86.0,-86.0,47.0,52.0,41.0,35.0,1
2148,92:69:1D:31:68:E9,3776581,489991026,12825,15263569,3763756,474727457,3,19355,3596869,18654,3435602,701,161267,6476,105,14088,252,3,252,216660.0,130000.0,-52.0,-47.0,-42.0,-48.0,-52.0,-47.0,-42.0,-48.0,-87.0,-89.0,-86.0,-86.0,35.0,42.0,44.0,38.0,1
2149,CC:2F:71:3F:1F:24,4006155,757888306,242394,283160385,3763761,474727921,27,203836,233087476,203747,233076428,89,11048,194822,6,242395,22798,24,149,130000.0,43333.0,-69.0,-67.0,-71.0,-68.0,-68.0,-67.0,-70.0,-68.0,-87.0,-89.0,-86.0,-86.0,18.0,22.0,15.0,18.0,1
2150,CC:2F:71:3E:C5:1F,3763866,474740752,105,12831,3763761,474727921,0,409,35115,331,25725,78,9390,113,2,138,4,0,5,144444.0,39000.0,-71.0,-72.0,-66.0,-60.0,-70.0,-70.0,-66.0,-60.0,-87.0,-89.0,-86.0,-86.0,16.0,17.0,20.0,26.0,1
2151,BA:8C:B9:54:50:24,3764065,474818067,304,90146,3763761,474727921,0,1275,142179,1257,139333,18,2846,200,5,423,7,0,8,229410.0,130000.0,-40.0,-37.0,-45.0,-51.0,-44.0,-36.0,-43.0,-47.0,-87.0,-89.0,-86.0,-86.0,47.0,52.0,41.0,35.0,1
2152,92:69:1D:31:68:E9,3776586,489991490,12825,15263569,3763761,474727921,3,19355,3596869,18654,3435602,701,161267,6476,105,14088,252,3,252,216660.0,130000.0,-52.0,-47.0,-42.0,-48.0,-52.0,-47.0,-42.0,-48.0,-87.0,-89.0,-86.0,-86.0,35.0,42.0,44.0,38.0,1
2153,CC:2F:71:3F:1F:24,4006266,758006892,242501,283278567,3763765,474728325,27,203929,233202220,203840,233191172,89,11048,194909,6,242502,22803,24,149,130000.0,43333.0,-70.0,-67.0,-71.0,-68.0,-69.0,-67.0,-70.0,-68.0,-87.0,-89.0,-86.0,-86.0,17.0,22.0,15.0,18.0,1
2154,CC:2F:71:3E:C5:1F,3763870,474741156,105,12831,3763765,474728325,0,409,35115,331,25725,78,9390,113,2,138,4,0,5,144444.0,39000.0,-71.0,-72.0,-66.0,-60.0,-70.0,-70.0,-66.0,-60.0,-87.0,-89.0,-86.0,-86.0,16.0,17.0,20.0,26.0,1
2155,BA:8C:B9:54:50:24,3764069,474818471,304,90146,3763765,474728325,0,1275,142179,1257,139333,18,2846,200,5,423,7,0,8,229410.0,130000.0,-40.0,-37.0,-45.0,-51.0,-44.0,-36.0,-43.0,-47.0,-87.0,-89.0,-86.0,-86.0,47.0,52.0,41.0,35.0,1
2156,92:69:1D:31:68:E9,3776590,489991894,12825,15263569,3763765,474728325,3,19355,3596869,18654,3435602,701,161267,6476,105,14088,252,3,252,216660.0,130000.0,-52.0,-47.0,-42.0,-48.0,-52.0,-47.0,-42.0,-48.0,-87.0,-89.0,-86.0,-86.0,35.0,42.0,44.0,38.0,1
2157,CC:2F:71:3F:1F:24,4006375,758125500,242608,283396973,3763767,474728527,27,204025,233321598,203936,233310550,89,11048,194998,6,242609,22804,24,149,130000.0,43333.0,-74.0,-72.0,-75.0,-73.0,-72.0,-70.0,-74.0,-71.0,-87.0,-89.0,-86.0,-86.0,13.0,17.0,11.0,13.0,1
2158,CC:2F:71:3E:C5:1F,3763872,474741358,105,12831,3763767,474728527,0,409,35115,331,25725,78,9390,113,2,138,4,0,5,144444.0,39000.0,-71.0,-72.0,-66.0,-60.0,-70.0,-70.0,-66.0,-60.0,-87.0,-89.0,-86.0,-86.0,16.0,17.0,20.0,26.0,1
2159,BA:8C:B9:54:50:24,3764071,474818673,304,90146,3763767,474728527,0,1275,142179,1257,139333,18,2846,200,5,423,7,0,8,229410.0,130000.0,-40.0,-37.0,-45.0,-51.0,-44.0,-36.0,-43.0,-47.0,-87.0,-89.0,-86.0,-86.0,47.0,52.0,41.0,35.0,1
2160,92:69:1D:31:68:E9,3776595,489992358,12825,15263569,3763770,474728789,3,19355,3596869,18654,3435602,701,161267,6476,105,14088,252,3,252,216660.0,130000.0,-52.0,-47.0,-42.0,-48.0,-52.0,-47.0,-42.0,-48.0,-87.0,-89.0,-86.0,-86.0,35.0,42.0,44.0,38.0,1
2161,CC:2F:71:3F:1F:24,4006494,758247715,242722,283518724,3763772,474728991,27,204123,233433099,204034,233422051,89,11048,195093,6,242723,22809,24,149,117000.0,39000.0,-69.0,-66.0,-71.0,-69.0,-69.0,-66.0,-70.0,-68.0,-87.0,-89.0,-86.0,-86.0,18.0,23.0,15.0,17.0,1
2162,CC:2F:71:3E:C5:1F,3763880,474742140,106,12947,3763774,474729193,0,410,35185,332,25795,78,9390,113,2,139,4,0,5,144444.0,39000.0,-70.0,-70.0,-66.0,-60.0,-70.0,-70.0,-66.0,-60.0,-87.0,-89.0,-86.0,-86.0,17.0,19.0,20.0,26.0,1
2163,BA:8C:B9:54:50:24,3764079,474819455,305,90262,3763774,474729193,0,1276,142247,1258,139401,18,2846,200,5,424,7,0,8,229410.0,130000.0,-40.0,-37.0,-45.0,-51.0,-43.0,-36.0,-44.0,-48.0,-87.0,-89.0,-86.0,-86.0,47.0,52.0,41.0,35.0,1
2164,92:69:1D:31:68:E9,3776600,489992878,12826,15263685,3763774,474729193,3,19357,3597005,18656,3435738,701,161267,6476,105,14089,252,3,252,216660.0,130000.0,-52.0,-47.0,-43.0,-48.0,-52.0,-47.0,-42.0,-48.0,-87.0,-89.0,-86.0,-86.0,35.0,42.0,43.0,38.0,1
2165,CC:2F:71:3F:1F:24,4006606,758367883,242829,283638426,3763777,474729457,27,204224,233554779,204134,233543613,90,11166,195183,6,242830,22809,24,149,130000.0,43333.0,-70.0,-67.0,-72.0,-69.0,-69.0,-66.0,-71.0,-69.0,-87.0,-89.0,-86.0,-86.0,17.0,22.0,14.0,17.0,1
2166,CC:2F:71:3E:C5:1F,3763883,474742404,106,12947,3763777,474729457,0,411,35255,333,25865,78,9390,113,2,139,4,0,5,144444.0,39000.0,-70.0,-71.0,-66.0,-60.0,-70.0,-70.0,-66.0,-60.0,-87.0,-89.0,-86.0,-86.0,17.0,18.0,20.0,26.0,1
2167,BA:8C:B9:54:50:24,3764082,474819719,305,90262,3763777,474729457,0,1277,142315,1259,139469,18,2846,200,5,424,7,0,8,229410.0,130000.0,-48.0,-35.0,-42.0,-45.0,-44.0,-36.0,-43.0,-47.0,-88.0,-90.0,-87.0,-86.0,40.0,55.0,45.0,41.0,1
2168,92:69:1D:31:68:E9,3776605,489993344,12826,15263685,3763779,474729659,3,19357,3597005,18656,3435738,701,161267,6476,105,14089,252,3,252,216660.0,130000.0,-52.0,-47.0,-43.0,-48.0,-52.0,-47.0,-42.0,-48.0,-88.0,-90.0,-87.0,-86.0,36.0,43.0,44.0,38.0,1
2169,CC:2F:71:3F:1F:24,4006713,758484737,242933,283755018,3763780,474729719,27,204314,233666299,204224,233655133,90,11166,195269,6,242934,22809,24,149,130000.0,43333.0,-70.0,-66.0,-71.0,-69.0,-69.0,-66.0,-71.0,-68.0,-88.0,-90.0,-87.0,-86.0,18.0,24.0,16.0,17.0,1
2170,CC:2F:71:3E:C5:1F,3763890,474743070,106,12947,3763784,474730123,0,411,35255,333,25865,78,9390,113,2,139,4,0,5,144444.0,39000.0,-70.0,-71.0,-66.0,-60.0,-70.0,-70.0,-66.0,-60.0,-88.0,-90.0,-87.0,-86.0,18.0,19.0,21.0,26.0,1
2171,BA:8C:B9:54:50:24,3764089,474820385,305,90262,3763784,474730123,0,1278,142383,1260,139537,18,2846,200,5,424,7,0,8,229410.0,130000.0,-39.0,-37.0,-46.0,-51.0,-42.0,-36.0,-44.0,-48.0,-88.0,-90.0,-87.0,-86.0,49.0,53.0,41.0,35.0,1
2172,92:69:1D:31:68:E9,3776610,489993808,12826,15263685,3763784,474730123,3,19357,3597005,18656,3435738,701,161267,6476,105,14089,252,3,252,216660.0,130000.0,-52.0,-47.0,-43.0,-48.0,-52.0,-47.0,-42.0,-48.0,-88.0,-90.0,-87.0,-86.0,36.0,43.0,44.0,38.0,1
2173,CC:2F:71:3F:1F:24,4006824,758603321,243038,283872996,3763786,474730325,27,204404,233773761,204314,233762595,90,11166,195355,6,243039,22816,24,150,144444.0,43333.0,-70.0,-67.0,-71.0,-69.0,-70.0,-66.0,-71.0,-69.0,-88.0,-90.0,-87.0,-86.0,18.0,23.0,16.0,17.0,1
2174,CC:2F:71:3E:C5:1F,3763892,474743272,106,12947,3763786,474730325,0,411,35255,333,25865,78,9390,113,2,139,4,0,5,144444.0,39000.0,-70.0,-71.0,-66.0,-60.0,-70.0,-70.0,-66.0,-60.0,-88.0,-90.0,-87.0,-86.0,18.0,19.0,21.0,26.0,1
2175,BA:8C:B9:54:50:24,3764091,474820587,305,90262,3763786,474730325,0,1278,142383,1260,139537,18,2846,200,5,424,7,0,8,229410.0,130000.0,-39.0,-37.0,-46.0,-51.0,-42.0,-36.0,-44.0,-48.0,-88.0,-90.0,-87.0,-86.0,49.0,53.0,41.0,35.0,1
2176,92:69:1D:31:68:E9,3776612,489994010,12826,15263685,3763786,474730325,3,19357,3597005,18656,3435738,701,161267,6476,105,14089,252,3,252,216660.0,130000.0,-52.0,-47.0,-43.0,-48.0,-52.0,-47.0,-42.0,-48.0,-88.0,-90.0,-87.0,-86.0,36.0,43.0,44.0,38.0,1
2177,CC:2F:71:3F:1F:24,4006940,758727198,243152,283996671,3763788,474730527,27,204503,233888237,204413,233877071,90,11166,195451,6,243152,22826,24,150,130000.0,43333.0,-73.0,-70.0,-74.0,-72.0,-73.0,-70.0,-74.0,-72.0,-88.0,-90.0,-87.0,-86.0,15.0,20.0,13.0,14.0,1
2178,CC:2F:71:3E:C5:1F,3763898,474743878,106,12947,3763792,474730931,0,411,35255,333,25865,78,9390,113,2,139,4,0,5,144444.0,39000.0,-70.0,-71.0,-66.0,-60.0,-70.0,-70.0,-66.0,-60.0,-88.0,-90.0,-87.0,-86.0,18.0,19.0,21.0,26.0,1
2179,BA:8C:B9:54:50:24,3764097,474821193,305,90262,3763792,474730931,0,1278,142383,1260,139537,18,2846,200,5,424,7,0,8,229410.0,130000.0,-39.0,-37.0,-46.0,-51.0,-42.0,-36.0,-44.0,-48.0,-88.0,-90.0,-87.0,-86.0,49.0,53.0,41.0,35.0,1
2180,92:69:1D:31:68:E9,3776618,489994616,12826,15263685,3763792,474730931,3,19357,3597005,18656,3435738,701,161267,6476,105,14089,252,3,252,216660.0,130000.0,-52.0,-47.0,-43.0,-48.0,-52.0,-47.0,-42.0,-48.0,-88.0,-90.0,-87.0,-86.0,36.0,43.0,44.0,38.0,1
2181,CC:2F:71:3F:1F:24,4007052,758846010,243257,284114817,3763795,474731193,27,204601,234009519,204511,233998353,90,11166,195538,6,243257,22826,24,150,130000.0,43333.0,-72.0,-69.0,-73.0,-72.0,-72.0,-69.0,-73.0,-71.0,-88.0,-90.0,-87.0,-86.0,16.0,21.0,14.0,14.0,1
2182,CC:2F:71:3E:C5:1F,3763901,474744140,106,12947,3763795,474731193,0,411,35255,333,25865,78,9390,113,2,139,4,0,5,144444.0,39000.0,-70.0,-71.0,-66.0,-60.0,-70.0,-70.0,-66.0,-60.0,-88.0,-90.0,-87.0,-86.0,18.0,19.0,21.0,26.0,1
2183,BA:8C:B9:54:50:24,3764100,474821455,305,90262,3763795,474731193,0,1278,142383,1260,139537,18,2846,200,5,424,7,0,8,229410.0,130000.0,-39.0,-37.0,-46.0,-51.0,-42.0,-36.0,-44.0,-48.0,-88.0,-90.0,-87.0,-86.0,49.0,53.0,41.0,35.0,1
2184,92:69:1D:31:68:E9,3776621,489994878,12826,15263685,3763795,474731193,3,19357,3597005,18656,3435738,701,161267,6476,105,14089,252,3,252,216660.0,130000.0,-52.0,-47.0,-43.0,-48.0,-52.0,-47.0,-42.0,-48.0,-88.0,-90.0,-87.0,-86.0,36.0,43.0,44.0,38.0,1
2185,CC:2F:71:3F:1F:24,4007159,758962710,243362,284231315,3763797,474731395,27,204694,234121449,204604,234110283,90,11166,195626,6,243363,22835,24,150,130000.0,43333.0,-69.0,-66.0,-71.0,-69.0,-69.0,-66.0,-71.0,-68.0,-88.0,-90.0,-87.0,-86.0,19.0,24.0,16.0,17.0,1
2186,CC:2F:71:3E:C5:1F,3763903,474744342,106,12947,3763797,474731395,0,411,35255,333,25865,78,9390,113,2,139,4,0,5,144444.0,39000.0,-70.0,-71.0,-66.0,-60.0,-70.0,-70.0,-66.0,-60.0,-88.0,-90.0,-87.0,-86.0,18.0,19.0,21.0,26.0,1
2187,BA:8C:B9:54:50:24,3764106,474822061,305,90262,3763801,474731799,0,1278,142383,1260,139537,18,2846,200,5,424,7,0,8,229410.0,130000.0,-39.0,-37.0,-46.0,-51.0,-42.0,-36.0,-44.0,-48.0,-88.0,-90.0,-87.0,-86.0,49.0,53.0,41.0,35.0,1
2188,92:69:1D:31:68:E9,3776627,489995484,12826,15263685,3763801,474731799,3,19357,3597005,18656,3435738,701,161267,6476,105,14089,252,3,252,216660.0,130000.0,-52.0,-47.0,-43.0,-48.0,-52.0,-47.0,-42.0,-48.0,-88.0,-90.0,-87.0,-86.0,36.0,43.0,44.0,38.0,1
2189,CC:2F:71:3F:1F:24,4007272,759081865,243468,284349591,3763804,474732274,27,204786,234234735,204696,234223569,90,11166,195713,6,243469,22835,24,150,130000.0,43333.0,-69.0,-66.0,-70.0,-69.0,-69.0,-66.0,-70.0,-68.0,-88.0,-90.0,-87.0,-86.0,19.0,24.0,17.0,17.0,1
2190,CC:2F:71:3E:C5:1F,3763910,474745221,106,12947,3763804,474732274,0,411,35255,333,25865,78,9390,113,2,139,4,0,5,144444.0,39000.0,-70.0,-71.0,-66.0,-60.0,-70.0,-70.0,-66.0,-60.0,-88.0,-90.0,-87.0,-86.0,18.0,19.0,21.0,26.0,1
2191,BA:8C:B9:54:50:24,3764109,474822536,305,90262,3763804,474732274,0,1278,142383,1260,139537,18,2846,200,5,424,7,0,8,229410.0,130000.0,-39.0,-37.0,-46.0,-51.0,-42.0,-36.0,-44.0,-48.0,-88.0,-90.0,-87.0,-86.0,49.0,53.0,41.0,35.0,1
2192,92:69:1D:31:68:E9,3776630,489995959,12826,15263685,3763804,474732274,3,19357,3597005,18656,3435738,701,161267,6476,105,14089,252,3,252,216660.0,130000.0,-52.0,-47.0,-43.0,-48.0,-52.0,-47.0,-42.0,-48.0,-88.0,-90.0,-87.0,-86.0,36.0,43.0,44.0,38.0,1
2193,CC:2F:71:3F:1F:24,4007389,759205742,243582,284473206,3763807,474732536,27,204890,234354143,204800,234342977,90,11166,195810,6,243583,22836,24,150,130000.0,39000.0,-69.0,-67.0,-71.0,-69.0,-69.0,-66.0,-70.0,-68.0,-88.0,-90.0,-87.0,-86.0,19.0,23.0,16.0,17.0,1
2194,CC:2F:71:3E:C5:1F,3763913,474745483,106,12947,3763807,474732536,0,411,35255,333,25865,78,9390,113,2,139,4,0,5,144444.0,39000.0,-70.0,-71.0,-66.0,-60.0,-70.0,-70.0,-66.0,-60.0,-88.0,-90.0,-87.0,-86.0,18.0,19.0,21.0,26.0,1
2195,BA:8C:B9:54:50:24,3764116,474823202,305,90262,3763811,474732940,0,1278,142383,1260,139537,18,2846,200,5,424,7,0,8,229410.0,130000.0,-39.0,-37.0,-46.0,-51.0,-42.0,-36.0,-44.0,-48.0,-88.0,-90.0,-87.0,-86.0,49.0,53.0,41.0,35.0,1
2196,92:69:1D:31:68:E9,3776637,489996625,12826,15263685,3763811,474732940,3,19357,3597005,18656,3435738,701,161267,6476,105,14089,252,3,252,216660.0,130000.0,-52.0,-47.0,-43.0,-48.0,-52.0,-47.0,-42.0,-48.0,-88.0,-90.0,-87.0,-86.0,36.0,43.0,44.0,38.0,1
2197,CC:2F:71:3F:1F:24,4007501,759325768,243688,284592626,3763813,474733142,27,204989,234472667,204899,234461501,90,11166,195901,6,243689,22852,24,150,130000.0,43333.0,-69.0,-67.0,-70.0,-69.0,-69.0,-66.0,-70.0,-69.0,-88.0,-90.0,-87.0,-86.0,19.0,23.0,17.0,17.0,1
2198,CC:2F:71:3E:C5:1F,3763919,474746089,106,12947,3763813,474733142,0,411,35255,333,25865,78,9390,113,2,139,4,0,5,144444.0,39000.0,-70.0,-71.0,-66.0,-60.0,-70.0,-70.0,-66.0,-60.0,-88.0,-90.0,-87.0,-86.0,18.0,19.0,21.0,26.0,1
2199,BA:8C:B9:54:50:24,3764118,474823404,305,90262,3763813,474733142,0,1278,142383,1260,139537,18,2846,200,5,424,7,0,8,229410.0,130000.0,-39.0,-37.0,-46.0,-51.0,-42.0,-36.0,-44.0,-48.0,-88.0,-90.0,-87.0,-86.0,49.0,53.0,41.0,35.0,1
2200,92:69:1D:31:68:E9,3776639,489996827,12826,15263685,3763813,474733142,3,19357,3597005,18656,3435738,701,161267,6476,105,14089,252,3,252,216660.0,130000.0,-52.0,-47.0,-43.0,-48.0,-52.0,-47.0,-42.0,-48.0,-88.0,-90.0,-87.0,-86.0,36.0,43.0,44.0,38.0,1
2201,CC:2F:71:3F:1F:24,4007608,759442454,243792,284709050,3763816,474733404,27,205082,234588849,204992,234577683,90,11166,195987,6,243793,22852,24,150,130000.0,43333.0,-69.0,-67.0,-70.0,-69.0,-69.0,-66.0,-70.0,-69.0,-88.0,-90.0,-87.0,-86.0,19.0,23.0,17.0,17.0,1
2202,CC:2F:71:3E:C5:1F,3763922,474746351,106,12947,3763816,474733404,0,411,35255,333,25865,78,9390,113,2,139,4,0,5,144444.0,39000.0,-70.0,-71.0,-66.0,-60.0,-70.0,-70.0,-66.0,-60.0,-88.0,-90.0,-87.0,-86.0,18.0,19.0,21.0,26.0,1
2203,BA:8C:B9:54:50:24,3764125,474824070,305,90262,3763820,474733808,0,1278,142383,1260,139537,18,2846,200,5,424,7,0,8,229410.0,130000.0,-39.0,-37.0,-46.0,-51.0,-42.0,-36.0,-44.0,-48.0,-88.0,-90.0,-87.0,-86.0,49.0,53.0,41.0,35.0,1
2204,92:69:1D:31:68:E9,3776646,489997493,12826,15263685,3763820,474733808,3,19357,3597005,18656,3435738,701,161267,6476,105,14089,252,3,252,216660.0,130000.0,-52.0,-47.0,-43.0,-48.0,-52.0,-47.0,-42.0,-48.0,-88.0,-90.0,-87.0,-86.0,36.0,43.0,44.0,38.0,1
2205,CC:2F:71:3F:1F:24,4007724,759568880,243902,284834870,3763822,474734010,27,205183,234713077,205093,234701911,90,11166,196082,6,243903,22855,24,150,130000.0,39000.0,-70.0,-67.0,-71.0,-70.0,-70.0,-67.0,-71.0,-69.0,-88.0,-90.0,-87.0,-86.0,18.0,23.0,16.0,16.0,1
2206,CC:2F:71:3E:C5:1F,3763928,474746957,106,12947,3763822,474734010,0,411,35255,333,25865,78,9390,113,2,139,4,0,5,144444.0,39000.0,-70.0,-71.0,-66.0,-60.0,-70.0,-70.0,-66.0,-60.0,-88.0,-90.0,-87.0,-86.0,18.0,19.0,21.0,26.0,1
2207,BA:8C:B9:54:50:24,3764127,474824272,305,90262,3763822,474734010,0,1278,142383,1260,139537,18,2846,200,5,424,7,0,8,229410.0,130000.0,-39.0,-37.0,-46.0,-51.0,-42.0,-36.0,-44.0,-48.0,-88.0,-90.0,-87.0,-86.0,49.0,53.0,41.0,35.0,1
2208,92:69:1D:31:68:E9,3776648,489997695,12826,15263685,3763822,474734010,3,19357,3597005,18656,3435738,701,161267,6476,105,14089,252,3,252,216660.0,130000.0,-52.0,-47.0,-43.0,-48.0,-52.0,-47.0,-42.0,-48.0,-88.0,-90.0,-87.0,-86.0,36.0,43.0,44.0,38.0,1
2209,CC:2F:71:3F:1F:24,4007840,759690723,244015,284956449,3763825,474734274,27,205284,234829368,205194,234818202,90,11166,196177,6,244016,22859,24,150,130000.0,43333.0,-69.0,-66.0,-71.0,-68.0,-69.0,-66.0,-70.0,-68.0,-88.0,-90.0,-86.0,-86.0,19.0,24.0,15.0,18.0,1
2210,CC:2F:71:3E:C5:1F,3763931,474747221,106,12947,3763825,474734274,0,413,35443,334,25935,79,9508,114,2,139,4,0,5,144444.0,39000.0,-70.0,-70.0,-66.0,-60.0,-70.0,-70.0,-66.0,-60.0,-88.0,-90.0,-86.0,-86.0,18.0,20.0,20.0,26.0,1
2211,BA:8C:B9:54:50:24,3764134,474824940,305,90262,3763829,474734678,0,1278,142383,1260,139537,18,2846,200,5,424,7,0,8,229410.0,130000.0,-39.0,-37.0,-46.0,-51.0,-42.0,-36.0,-44.0,-48.0,-88.0,-90.0,-86.0,-86.0,49.0,53.0,40.0,35.0,1
2212,92:69:1D:31:68:E9,3776655,489998363,12826,15263685,3763829,474734678,3,19357,3597005,18656,3435738,701,161267,6476,105,14089,252,3,252,216660.0,130000.0,-52.0,-47.0,-43.0,-48.0,-52.0,-47.0,-42.0,-48.0,-88.0,-90.0,-86.0,-86.0,36.0,43.0,43.0,38.0,1
2213,CC:2F:71:3F:1F:24,4007952,759809535,244120,285074595,3763832,474734940,27,205373,234939334,205283,234928168,90,11166,196263,6,244121,22859,24,150,130000.0,43333.0,-69.0,-67.0,-71.0,-68.0,-69.0,-67.0,-70.0,-68.0,-88.0,-90.0,-86.0,-86.0,19.0,23.0,15.0,18.0,1
2214,CC:2F:71:3E:C5:1F,3763938,474747887,106,12947,3763832,474734940,0,413,35443,334,25935,79,9508,114,2,139,4,0,5,144444.0,39000.0,-70.0,-70.0,-66.0,-60.0,-70.0,-70.0,-66.0,-60.0,-88.0,-90.0,-86.0,-86.0,18.0,20.0,20.0,26.0,1
2215,BA:8C:B9:54:50:24,3764137,474825202,305,90262,3763832,474734940,0,1278,142383,1260,139537,18,2846,200,5,424,7,0,8,229410.0,130000.0,-39.0,-37.0,-46.0,-51.0,-42.0,-36.0,-44.0,-48.0,-88.0,-90.0,-86.0,-86.0,49.0,53.0,40.0,35.0,1
2216,92:69:1D:31:68:E9,3776658,489998625,12826,15263685,3763832,474734940,3,19357,3597005,18656,3435738,701,161267,6476,105,14089,252,3,252,216660.0,130000.0,-52.0,-47.0,-43.0,-48.0,-52.0,-47.0,-42.0,-48.0,-88.0,-90.0,-86.0,-86.0,36.0,43.0,43.0,38.0,1
2217,CC:2F:71:3F:1F:24,4008058,759926105,244224,285190963,3763834,474735142,27,205466,235049950,205376,235038784,90,11166,196350,6,244225,22863,24,150,130000.0,43333.0,-68.0,-66.0,-70.0,-69.0,-68.0,-66.0,-70.0,-68.0,-88.0,-90.0,-86.0,-86.0,20.0,24.0,16.0,17.0,1
2218,CC:2F:71:3E:C5:1F,3763940,474748089,106,12947,3763834,474735142,0,413,35443,334,25935,79,9508,114,2,139,4,0,5,144444.0,39000.0,-70.0,-70.0,-66.0,-60.0,-70.0,-70.0,-66.0,-60.0,-88.0,-90.0,-86.0,-86.0,18.0,20.0,20.0,26.0,1
2219,BA:8C:B9:54:50:24,3764139,474825404,305,90262,3763834,474735142,0,1280,142519,1262,139673,18,2846,200,5,425,7,0,8,229410.0,130000.0,-48.0,-35.0,-42.0,-45.0,-42.0,-36.0,-44.0,-48.0,-88.0,-90.0,-86.0,-86.0,40.0,55.0,44.0,41.0,1
2220,92:69:1D:31:68:E9,3776664,489999231,12826,15263685,3763838,474735546,3,19359,3597141,18658,3435874,701,161267,6476,105,14090,252,3,252,216660.0,130000.0,-52.0,-47.0,-42.0,-48.0,-52.0,-47.0,-42.0,-48.0,-88.0,-90.0,-86.0,-86.0,36.0,43.0,44.0,38.0,1
2221,CC:2F:71:3F:1F:24,4008169,760044857,244329,285309109,3763840,474735748,27,205558,235163126,205468,235151960,90,11166,196438,6,244330,22863,24,150,130000.0,43333.0,-68.0,-66.0,-69.0,-68.0,-68.0,-66.0,-69.0,-68.0,-88.0,-90.0,-86.0,-86.0,20.0,24.0,17.0,18.0,1
2222,CC:2F:71:3E:C5:1F,3763946,474748695,106,12947,3763840,474735748,0,413,35443,334,25935,79,9508,114,2,139,4,0,5,144444.0,39000.0,-70.0,-70.0,-66.0,-60.0,-70.0,-70.0,-66.0,-60.0,-88.0,-90.0,-86.0,-86.0,18.0,20.0,20.0,26.0,1
2223,BA:8C:B9:54:50:24,3764145,474826010,305,90262,3763840,474735748,0,1280,142519,1262,139673,18,2846,200,5,425,7,0,8,229410.0,130000.0,-48.0,-35.0,-42.0,-45.0,-42.0,-36.0,-44.0,-48.0,-88.0,-90.0,-86.0,-86.0,40.0,55.0,44.0,41.0,1
2224,92:69:1D:31:68:E9,3776666,489999433,12826,15263685,3763840,474735748,3,19359,3597141,18658,3435874,701,161267,6476,105,14090,252,3,252,216660.0,130000.0,-52.0,-47.0,-42.0,-48.0,-52.0,-47.0,-42.0,-48.0,-88.0,-90.0,-86.0,-86.0,36.0,43.0,44.0,38.0,1
2225,CC:2F:71:3F:1F:24,4008283,760165126,244440,285429116,3763843,474736010,27,205655,235276070,205565,235264904,90,11166,196530,6,244441,22865,24,150,130000.0,39000.0,-68.0,-67.0,-70.0,-68.0,-68.0,-67.0,-70.0,-68.0,-88.0,-90.0,-86.0,-86.0,20.0,23.0,16.0,18.0,1
2226,CC:2F:71:3E:C5:1F,3763949,474748957,106,12947,3763843,474736010,0,413,35443,334,25935,79,9508,114,2,139,4,0,5,144444.0,39000.0,-70.0,-70.0,-66.0,-60.0,-70.0,-70.0,-66.0,-60.0,-88.0,-90.0,-86.0,-86.0,18.0,20.0,20.0,26.0,1
2227,BA:8C:B9:54:50:24,3764148,474826272,305,90262,3763843,474736010,0,1280,142519,1262,139673,18,2846,200,5,425,7,0,8,229410.0,130000.0,-48.0,-35.0,-42.0,-45.0,-42.0,-36.0,-44.0,-48.0,-88.0,-90.0,-86.0,-86.0,40.0,55.0,44.0,41.0,1
2228,92:69:1D:31:68:E9,3776671,489999897,12826,15263685,3763845,474736212,3,19359,3597141,18658,3435874,701,161267,6476,105,14090,252,3,252,216660.0,130000.0,-52.0,-47.0,-42.0,-48.0,-52.0,-47.0,-42.0,-48.0,-88.0,-90.0,-86.0,-86.0,36.0,43.0,44.0,38.0,1
2229,CC:2F:71:3F:1F:24,4008396,760288300,244549,285551886,3763847,474736414,27,205755,235398850,205665,235387684,90,11166,196622,6,244550,22872,24,151,130000.0,43333.0,-69.0,-67.0,-70.0,-67.0,-68.0,-66.0,-70.0,-66.0,-88.0,-90.0,-86.0,-86.0,19.0,23.0,16.0,19.0,1
2230,CC:2F:71:3E:C5:1F,3763955,474749563,106,12947,3763849,474736616,0,413,35443,334,25935,79,9508,114,2,139,4,0,5,144444.0,39000.0,-70.0,-70.0,-66.0,-60.0,-70.0,-70.0,-66.0,-60.0,-88.0,-90.0,-86.0,-86.0,18.0,20.0,20.0,26.0,1
2231,BA:8C:B9:54:50:24,3764154,474826878,305,90262,3763849,474736616,0,1280,142519,1262,139673,18,2846,200,5,425,7,0,8,229410.0,130000.0,-48.0,-35.0,-42.0,-45.0,-42.0,-36.0,-44.0,-48.0,-88.0,-90.0,-86.0,-86.0,40.0,55.0,44.0,41.0,1
2232,92:69:1D:31:68:E9,3776675,490000301,12826,15263685,3763849,474736616,3,19359,3597141,18658,3435874,701,161267,6476,105,14090,252,3,252,216660.0,130000.0,-52.0,-47.0,-42.0,-48.0,-52.0,-47.0,-42.0,-48.0,-88.0,-90.0,-86.0,-86.0,36.0,43.0,44.0,38.0,1
2233,CC:2F:71:3F:1F:24,4008505,760406850,244654,285670032,3763851,474736818,27,205854,235521718,205764,235510552,90,11166,196709,6,244655,22872,24,151,130000.0,43333.0,-68.0,-66.0,-70.0,-68.0,-68.0,-66.0,-70.0,-67.0,-88.0,-90.0,-86.0,-86.0,20.0,24.0,16.0,18.0,1
2234,CC:2F:71:3E:C5:1F,3763958,474749825,106,12947,3763852,474736878,0,413,35443,334,25935,79,9508,114,2,139,4,0,5,144444.0,39000.0,-70.0,-70.0,-66.0,-60.0,-70.0,-70.0,-66.0,-60.0,-88.0,-90.0,-86.0,-86.0,18.0,20.0,20.0,26.0,1
2235,BA:8C:B9:54:50:24,3764157,474827140,305,90262,3763852,474736878,0,1280,142519,1262,139673,18,2846,200,5,425,7,0,8,229410.0,130000.0,-48.0,-35.0,-42.0,-45.0,-42.0,-36.0,-44.0,-48.0,-88.0,-90.0,-86.0,-86.0,40.0,55.0,44.0,41.0,1
2236,92:69:1D:31:68:E9,3776680,490000765,12826,15263685,3763854,474737080,3,19359,3597141,18658,3435874,701,161267,6476,105,14090,252,3,252,216660.0,130000.0,-52.0,-47.0,-42.0,-48.0,-52.0,-47.0,-42.0,-48.0,-88.0,-90.0,-86.0,-86.0,36.0,43.0,44.0,38.0,1
2237,CC:2F:71:3F:1F:24,4008616,760525422,244760,285788140,3763856,474737282,27,205943,235631670,205853,235620504,90,11166,196796,6,244761,22874,24,151,144444.0,43333.0,-69.0,-66.0,-71.0,-68.0,-69.0,-66.0,-70.0,-68.0,-88.0,-90.0,-87.0,-86.0,19.0,24.0,16.0,18.0,1
2238,CC:2F:71:3E:C5:1F,3763962,474750229,106,12947,3763856,474737282,0,413,35443,334,25935,79,9508,114,2,139,4,0,5,144444.0,39000.0,-70.0,-70.0,-66.0,-60.0,-70.0,-70.0,-66.0,-60.0,-88.0,-90.0,-87.0,-86.0,18.0,20.0,21.0,26.0,1
2239,BA:8C:B9:54:50:24,3764161,474827544,305,90262,3763856,474737282,0,1280,142519,1262,139673,18,2846,200,5,425,7,0,8,229410.0,130000.0,-48.0,-35.0,-42.0,-45.0,-42.0,-36.0,-44.0,-48.0,-88.0,-90.0,-87.0,-86.0,40.0,55.0,45.0,41.0,1
2240,92:69:1D:31:68:E9,3776684,490001169,12826,15263685,3763858,474737484,3,19359,3597141,18658,3435874,701,161267,6476,105,14090,252,3,252,216660.0,130000.0,-52.0,-47.0,-42.0,-48.0,-52.0,-47.0,-42.0,-48.0,-88.0,-90.0,-87.0,-86.0,36.0,43.0,45.0,38.0,1
2241,CC:2F:71:3F:1F:24,4008737,760649722,244876,285911763,3763861,474737959,27,206047,235749679,205957,235738513,90,11166,196892,6,244877,22878,24,151,144444.0,43333.0,-70.0,-67.0,-71.0,-68.0,-69.0,-66.0,-70.0,-68.0,-88.0,-90.0,-87.0,-86.0,18.0,23.0,16.0,18.0,1
2242,CC:2F:71:3E:C5:1F,3763967,474750906,106,12947,3763861,474737959,0,413,35443,334,25935,79,9508,114,2,139,4,0,5,144444.0,39000.0,-70.0,-70.0,-66.0,-60.0,-70.0,-70.0,-66.0,-60.0,-88.0,-90.0,-87.0,-86.0,18.0,20.0,21.0,26.0,1
2243,BA:8C:B9:54:50:24,3764166,474828221,305,90262,3763861,474737959,0,1280,142519,1262,139673,18,2846,200,5,425,7,0,8,229410.0,130000.0,-48.0,-35.0,-42.0,-45.0,-42.0,-36.0,-44.0,-48.0,-88.0,-90.0,-87.0,-86.0,40.0,55.0,45.0,41.0,1
2244,92:69:1D:31:68:E9,3776687,490001644,12826,15263685,3763861,474737959,3,19359,3597141,18658,3435874,701,161267,6476,105,14090,252,3,252,216660.0,130000.0,-52.0,-47.0,-42.0,-48.0,-52.0,-47.0,-42.0,-48.0,-88.0,-90.0,-87.0,-86.0,36.0,43.0,45.0,38.0,1
2245,CC:2F:71:3F:1F:24,4008848,760767038,244982,286028615,3763866,474738423,27,206137,235856871,206047,235845705,90,11166,196982,6,244983,22894,24,151,144444.0,43333.0,-70.0,-67.0,-71.0,-68.0,-69.0,-66.0,-70.0,-68.0,-88.0,-90.0,-87.0,-86.0,18.0,23.0,16.0,18.0,1
2246,CC:2F:71:3E:C5:1F,3763972,474751370,106,12947,3763866,474738423,0,413,35443,334,25935,79,9508,114,2,139,4,0,5,144444.0,39000.0,-70.0,-70.0,-66.0,-60.0,-70.0,-70.0,-66.0,-60.0,-88.0,-90.0,-87.0,-86.0,18.0,20.0,21.0,26.0,1
2247,BA:8C:B9:54:50:24,3764171,474828685,305,90262,3763866,474738423,0,1280,142519,1262,139673,18,2846,200,5,425,7,0,8,229410.0,130000.0,-48.0,-35.0,-42.0,-45.0,-42.0,-36.0,-44.0,-48.0,-88.0,-90.0,-87.0,-86.0,40.0,55.0,45.0,41.0,1
2248,92:69:1D:31:68:E9,3776692,490002108,12826,15263685,3763866,474738423,3,19359,3597141,18658,3435874,701,161267,6476,105,14090,252,3,252,216660.0,130000.0,-52.0,-47.0,-42.0,-48.0,-52.0,-47.0,-42.0,-48.0,-88.0,-90.0,-87.0,-86.0,36.0,43.0,45.0,38.0,1
2249,CC:2F:71:3F:1F:24,4008957,760885588,245087,286146761,3763870,474738827,27,206228,235969931,206138,235958765,90,11166,197069,6,245088,22897,24,151,144444.0,43333.0,-73.0,-70.0,-74.0,-71.0,-72.0,-69.0,-73.0,-70.0,-88.0,-90.0,-87.0,-86.0,15.0,20.0,13.0,15.0,1
2250,CC:2F:71:3E:C5:1F,3763976,474751774,106,12947,3763870,474738827,0,413,35443,334,25935,79,9508,114,2,139,4,0,5,144444.0,39000.0,-70.0,-70.0,-66.0,-60.0,-70.0,-70.0,-66.0,-60.0,-88.0,-90.0,-87.0,-86.0,18.0,20.0,21.0,26.0,1
2251,BA:8C:B9:54:50:24,3764175,474829089,305,90262,3763870,474738827,0,1280,142519,1262,139673,18,2846,200,5,425,7,0,8,229410.0,130000.0,-48.0,-35.0,-42.0,-45.0,-42.0,-36.0,-44.0,-48.0,-88.0,-90.0,-87.0,-86.0,40.0,55.0,45.0,41.0,1
2252,92:69:1D:31:68:E9,3776696,490002512,12826,15263685,3763870,474738827,3,19359,3597141,18658,3435874,701,161267,6476,105,14090,252,3,252,216660.0,130000.0,-52.0,-47.0,-42.0,-48.0,-52.0,-47.0,-42.0,-48.0,-88.0,-90.0,-87.0,-86.0,36.0,43.0,45.0,38.0,1
2253,CC:2F:71:3F:1F:24,4009067,761004268,245193,286265037,3763874,474739231,27,206320,236083169,206230,236072003,90,11166,197156,6,245194,22903,24,151,144444.0,43333.0,-70.0,-67.0,-71.0,-69.0,-70.0,-67.0,-71.0,-68.0,-88.0,-90.0,-87.0,-86.0,18.0,23.0,16.0,17.0,1
2254,CC:2F:71:3E:C5:1F,3763980,474752178,106,12947,3763874,474739231,0,413,35443,334,25935,79,9508,114,2,139,4,0,5,144444.0,39000.0,-70.0,-70.0,-66.0,-60.0,-70.0,-70.0,-66.0,-60.0,-88.0,-90.0,-87.0,-86.0,18.0,20.0,21.0,26.0,1
2255,BA:8C:B9:54:50:24,3764179,474829493,305,90262,3763874,474739231,0,1280,142519,1262,139673,18,2846,200,5,425,7,0,8,229410.0,130000.0,-48.0,-35.0,-42.0,-45.0,-42.0,-36.0,-44.0,-48.0,-88.0,-90.0,-87.0,-86.0,40.0,55.0,45.0,41.0,1
2256,92:69:1D:31:68:E9,3776700,490002916,12826,15263685,3763874,474739231,3,19359,3597141,18658,3435874,701,161267,6476,105,14090,252,3,252,216660.0,130000.0,-52.0,-47.0,-42.0,-48.0,-52.0,-47.0,-42.0,-48.0,-88.0,-90.0,-87.0,-86.0,36.0,43.0,45.0,38.0,1
2257,CC:2F:71:3F:1F:24,4009185,761126576,245308,286387083,3763877,474739493,27,206423,236199681,206333,236188515,90,11166,197251,6,245309,22918,24,151,144444.0,43333.0,-73.0,-70.0,-74.0,-71.0,-71.0,-68.0,-72.0,-70.0,-88.0,-90.0,-87.0,-86.0,15.0,20.0,13.0,15.0,1
2258,CC:2F:71:3E:C5:1F,3763985,474752642,106,12947,3763879,474739695,0,413,35443,334,25935,79,9508,114,2,139,4,0,5,144444.0,39000.0,-70.0,-70.0,-66.0,-60.0,-70.0,-70.0,-66.0,-60.0,-88.0,-90.0,-87.0,-86.0,18.0,20.0,21.0,26.0,1
2259,BA:8C:B9:54:50:24,3764184,474829957,305,90262,3763879,474739695,0,1280,142519,1262,139673,18,2846,200,5,425,7,0,8,229410.0,130000.0,-48.0,-35.0,-42.0,-45.0,-42.0,-36.0,-44.0,-48.0,-88.0,-90.0,-87.0,-86.0,40.0,55.0,45.0,41.0,1
2260,92:69:1D:31:68:E9,3776705,490003380,12826,15263685,3763879,474739695,3,19360,3597209,18659,3435942,701,161267,6476,105,14090,252,3,252,216660.0,130000.0,-52.0,-48.0,-42.0,-47.0,-52.0,-47.0,-42.0,-48.0,-88.0,-90.0,-87.0,-86.0,36.0,42.0,45.0,39.0,1
2261,CC:2F:71:3F:1F:24,4009297,761245458,245414,286505359,3763883,474740099,27,206515,236311481,206425,236300315,90,11166,197339,6,245415,22931,24,151,144444.0,43333.0,-69.0,-66.0,-70.0,-68.0,-69.0,-66.0,-70.0,-67.0,-88.0,-90.0,-87.0,-86.0,19.0,24.0,17.0,18.0,1
2262,CC:2F:71:3E:C5:1F,3763989,474753046,106,12947,3763883,474740099,0,413,35443,334,25935,79,9508,114,2,139,4,0,5,144444.0,39000.0,-70.0,-70.0,-66.0,-60.0,-70.0,-70.0,-66.0,-60.0,-88.0,-90.0,-87.0,-86.0,18.0,20.0,21.0,26.0,1
2263,BA:8C:B9:54:50:24,3764188,474830361,305,90262,3763883,474740099,0,1280,142519,1262,139673,18,2846,200,5,425,7,0,8,229410.0,130000.0,-48.0,-35.0,-42.0,-45.0,-42.0,-36.0,-44.0,-48.0,-88.0,-90.0,-87.0,-86.0,40.0,55.0,45.0,41.0,1
2264,92:69:1D:31:68:E9,3776709,490003784,12826,15263685,3763883,474740099,3,19360,3597209,18659,3435942,701,161267,6476,105,14090,252,3,252,216660.0,130000.0,-52.0,-48.0,-42.0,-47.0,-52.0,-47.0,-42.0,-48.0,-88.0,-90.0,-87.0,-86.0,36.0,42.0,45.0,39.0,1
2265,CC:2F:71:3F:1F:24,4009408,761367174,245523,286626873,3763885,474740301,27,206609,236423785,206519,236412619,90,11166,197429,6,245524,22944,24,151,144444.0,43333.0,-70.0,-67.0,-71.0,-69.0,-70.0,-67.0,-71.0,-68.0,-88.0,-90.0,-87.0,-86.0,18.0,23.0,16.0,17.0,1
2266,CC:2F:71:3E:C5:1F,3763993,474753450,106,12947,3763887,474740503,0,413,35443,334,25935,79,9508,114,2,139,4,0,5,144444.0,39000.0,-70.0,-70.0,-66.0,-60.0,-70.0,-70.0,-66.0,-60.0,-88.0,-90.0,-87.0,-86.0,18.0,20.0,21.0,26.0,1
2267,BA:8C:B9:54:50:24,3764193,474830825,305,90262,3763888,474740563,0,1280,142519,1262,139673,18,2846,200,5,425,7,0,8,229410.0,130000.0,-48.0,-35.0,-42.0,-45.0,-42.0,-36.0,-44.0,-48.0,-88.0,-90.0,-87.0,-86.0,40.0,55.0,45.0,41.0,1
2268,92:69:1D:31:68:E9,3776714,490004248,12826,15263685,3763888,474740563,3,19360,3597209,18659,3435942,701,161267,6476,105,14090,252,3,252,216660.0,130000.0,-52.0,-48.0,-42.0,-47.0,-52.0,-47.0,-42.0,-48.0,-88.0,-90.0,-87.0,-86.0,36.0,42.0,45.0,39.0,1
2269,CC:2F:71:3F:1F:24,4009524,761486600,245630,286745265,3763894,474741335,27,206702,236537077,206612,236525911,90,11166,197518,6,245631,22949,24,151,144444.0,43333.0,-70.0,-67.0,-71.0,-69.0,-70.0,-67.0,-71.0,-68.0,-88.0,-90.0,-87.0,-86.0,18.0,23.0,16.0,17.0,1
2270,CC:2F:71:3E:C5:1F,3764001,474754398,107,13063,3763894,474741335,0,415,35583,336,26075,79,9508,114,2,140,4,0,5,144444.0,39000.0,-70.0,-70.0,-66.0,-60.0,-70.0,-70.0,-66.0,-60.0,-88.0,-90.0,-87.0,-86.0,18.0,20.0,21.0,26.0,1
2271,BA:8C:B9:54:50:24,3764200,474831713,306,90378,3763894,474741335,0,1282,142655,1264,139809,18,2846,200,5,426,7,0,8,229410.0,137640.0,-40.0,-37.0,-46.0,-51.0,-42.0,-36.0,-44.0,-48.0,-88.0,-90.0,-87.0,-86.0,48.0,53.0,41.0,35.0,1
2272,92:69:1D:31:68:E9,3776721,490005136,12827,15263801,3763894,474741335,3,19362,3597345,18661,3436078,701,161267,6476,105,14091,252,3,252,216660.0,130000.0,-52.0,-47.0,-42.0,-47.0,-52.0,-47.0,-42.0,-47.0,-88.0,-90.0,-87.0,-86.0,36.0,43.0,45.0,39.0,1
2273,CC:2F:71:3F:1F:24,4009638,761606995,245742,286865458,3763896,474741537,27,206807,236654095,206717,236642929,90,11166,197612,6,245743,22954,24,151,144444.0,43333.0,-70.0,-67.0,-71.0,-69.0,-72.0,-69.0,-73.0,-70.0,-88.0,-90.0,-87.0,-86.0,18.0,23.0,16.0,17.0,1
2274,CC:2F:71:3E:C5:1F,3764003,474754600,107,13063,3763896,474741537,0,415,35583,336,26075,79,9508,114,2,140,4,0,5,144444.0,39000.0,-70.0,-70.0,-66.0,-60.0,-70.0,-70.0,-66.0,-60.0,-88.0,-90.0,-87.0,-86.0,18.0,20.0,21.0,26.0,1
2275,BA:8C:B9:54:50:24,3764204,474832117,306,90378,3763898,474741739,0,1282,142655,1264,139809,18,2846,200,5,426,7,0,8,229410.0,137640.0,-40.0,-37.0,-46.0,-51.0,-42.0,-36.0,-44.0,-48.0,-88.0,-90.0,-87.0,-86.0,48.0,53.0,41.0,35.0,1
2276,92:69:1D:31:68:E9,3776725,490005540,12827,15263801,3763898,474741739,3,19362,3597345,18661,3436078,701,161267,6476,105,14091,252,3,252,216660.0,130000.0,-52.0,-47.0,-42.0,-47.0,-52.0,-47.0,-42.0,-47.0,-88.0,-90.0,-87.0,-86.0,36.0,43.0,45.0,39.0,1
2277,CC:2F:71:3F:1F:24,4009750,761725807,245847,286983604,3763903,474742203,27,206902,236772043,206812,236760877,90,11166,197699,6,245847,22962,24,151,144444.0,43333.0,-72.0,-70.0,-74.0,-71.0,-72.0,-70.0,-74.0,-71.0,-88.0,-90.0,-87.0,-86.0,16.0,20.0,13.0,15.0,1
2278,CC:2F:71:3E:C5:1F,3764010,474755266,107,13063,3763903,474742203,0,415,35583,336,26075,79,9508,114,2,140,4,0,5,144444.0,39000.0,-70.0,-70.0,-66.0,-60.0,-70.0,-70.0,-66.0,-60.0,-88.0,-90.0,-87.0,-86.0,18.0,20.0,21.0,26.0,1
2279,BA:8C:B9:54:50:24,3764209,474832581,306,90378,3763903,474742203,0,1282,142655,1264,139809,18,2846,200,5,426,7,0,8,229410.0,137640.0,-40.0,-37.0,-46.0,-51.0,-42.0,-36.0,-44.0,-48.0,-88.0,-90.0,-87.0,-86.0,48.0,53.0,41.0,35.0,1
2280,92:69:1D:31:68:E9,3776730,490006004,12827,15263801,3763903,474742203,3,19362,3597345,18661,3436078,701,161267,6476,105,14091,252,3,252,216660.0,130000.0,-52.0,-47.0,-42.0,-47.0,-52.0,-47.0,-42.0,-47.0,-88.0,-90.0,-87.0,-86.0,36.0,43.0,45.0,39.0,1
2281,CC:2F:71:3F:1F:24,4009857,761844155,245952,287101750,3763905,474742405,27,206998,236887321,206908,236876155,90,11166,197786,6,245953,22963,24,151,144444.0,43333.0,-73.0,-70.0,-74.0,-72.0,-73.0,-70.0,-74.0,-71.0,-88.0,-90.0,-87.0,-86.0,15.0,20.0,13.0,14.0,1
2282,CC:2F:71:3E:C5:1F,3764012,474755468,107,13063,3763905,474742405,0,415,35583,336,26075,79,9508,114,2,140,4,0,5,144444.0,39000.0,-70.0,-70.0,-66.0,-60.0,-70.0,-70.0,-66.0,-60.0,-88.0,-90.0,-87.0,-86.0,18.0,20.0,21.0,26.0,1
2283,BA:8C:B9:54:50:24,3764211,474832783,306,90378,3763905,474742405,0,1282,142655,1264,139809,18,2846,200,5,426,7,0,8,229410.0,137640.0,-40.0,-37.0,-46.0,-51.0,-42.0,-36.0,-44.0,-48.0,-88.0,-90.0,-87.0,-86.0,48.0,53.0,41.0,35.0,1
2284,92:69:1D:31:68:E9,3776734,490006408,12827,15263801,3763907,474742607,3,19362,3597345,18661,3436078,701,161267,6476,105,14091,252,3,252,216660.0,130000.0,-52.0,-47.0,-42.0,-47.0,-52.0,-47.0,-42.0,-47.0,-88.0,-90.0,-87.0,-86.0,36.0,43.0,45.0,39.0,1
2285,CC:2F:71:3F:1F:24,4009968,761962965,246059,287220156,3763909,474742809,27,207099,237014625,207009,237003459,90,11166,197873,6,246060,22970,24,151,144444.0,43333.0,-73.0,-70.0,-74.0,-72.0,-73.0,-70.0,-74.0,-71.0,-88.0,-90.0,-87.0,-86.0,15.0,20.0,13.0,14.0,1
2286,CC:2F:71:3E:C5:1F,3764018,474756074,107,13063,3763911,474743011,0,415,35583,336,26075,79,9508,114,2,140,4,0,5,144444.0,39000.0,-70.0,-70.0,-66.0,-60.0,-70.0,-70.0,-66.0,-60.0,-88.0,-90.0,-87.0,-86.0,18.0,20.0,21.0,26.0,1
2287,BA:8C:B9:54:50:24,3764217,474833389,306,90378,3763911,474743011,0,1282,142655,1264,139809,18,2846,200,5,426,7,0,8,229410.0,137640.0,-40.0,-37.0,-46.0,-51.0,-42.0,-36.0,-44.0,-48.0,-88.0,-90.0,-87.0,-86.0,48.0,53.0,41.0,35.0,1
2288,92:69:1D:31:68:E9,3776738,490006812,12827,15263801,3763911,474743011,3,19362,3597345,18661,3436078,701,161267,6476,105,14091,252,3,252,216660.0,130000.0,-52.0,-47.0,-42.0,-47.0,-52.0,-47.0,-42.0,-47.0,-88.0,-90.0,-87.0,-86.0,36.0,43.0,45.0,39.0,1
2289,CC:2F:71:3F:1F:24,4010096,762088203,246182,287344930,3763914,474743273,27,207216,237137802,207126,237126636,90,11166,197981,6,246183,22980,24,151,144444.0,43333.0,-73.0,-70.0,-74.0,-71.0,-72.0,-69.0,-73.0,-71.0,-88.0,-90.0,-87.0,-86.0,15.0,20.0,13.0,15.0,1
2290,CC:2F:71:3E:C5:1F,3764021,474756336,107,13063,3763914,474743273,0,415,35583,336,26075,79,9508,114,2,140,4,0,5,144444.0,39000.0,-70.0,-70.0,-66.0,-60.0,-70.0,-70.0,-66.0,-60.0,-88.0,-90.0,-87.0,-86.0,18.0,20.0,21.0,26.0,1
2291,BA:8C:B9:54:50:24,3764220,474833651,306,90378,3763914,474743273,0,1282,142655,1264,139809,18,2846,200,5,426,7,0,8,229410.0,137640.0,-40.0,-37.0,-46.0,-51.0,-42.0,-36.0,-44.0,-48.0,-88.0,-90.0,-87.0,-86.0,48.0,53.0,41.0,35.0,1
2292,92:69:1D:31:68:E9,3776743,490007276,12827,15263801,3763916,474743475,3,19362,3597345,18661,3436078,701,161267,6476,105,14091,252,3,252,216660.0,130000.0,-52.0,-47.0,-42.0,-47.0,-52.0,-47.0,-42.0,-47.0,-88.0,-90.0,-87.0,-86.0,36.0,43.0,45.0,39.0,1
2293,CC:2F:71:3F:1F:24,4010208,762207075,246289,287463336,3763919,474743739,27,207308,237249540,207218,237238374,90,11166,198070,6,246290,22987,24,151,144444.0,43333.0,-72.0,-69.0,-73.0,-71.0,-72.0,-69.0,-73.0,-71.0,-88.0,-90.0,-87.0,-86.0,16.0,21.0,14.0,15.0,1
2294,CC:2F:71:3E:C5:1F,3764028,474757004,107,13063,3763921,474743941,0,417,35771,337,26145,80,9626,115,2,140,4,0,5,144444.0,39000.0,-70.0,-71.0,-66.0,-60.0,-70.0,-70.0,-66.0,-60.0,-88.0,-90.0,-87.0,-86.0,18.0,19.0,21.0,26.0,1
2295,BA:8C:B9:54:50:24,3764227,474834319,306,90378,3763921,474743941,0,1282,142655,1264,139809,18,2846,200,5,426,7,0,8,229410.0,137640.0,-40.0,-37.0,-46.0,-51.0,-42.0,-36.0,-44.0,-48.0,-88.0,-90.0,-87.0,-86.0,48.0,53.0,41.0,35.0,1
2296,92:69:1D:31:68:E9,3776749,490008015,12827,15263801,3763922,474744214,3,19362,3597345,18661,3436078,701,161267,6476,105,14091,252,3,252,216660.0,130000.0,-52.0,-47.0,-42.0,-47.0,-52.0,-47.0,-42.0,-47.0,-88.0,-90.0,-87.0,-86.0,36.0,43.0,45.0,39.0,1
2297,CC:2F:71:3F:1F:24,4010319,762324536,246394,287580058,3763925,474744478,27,207401,237361630,207310,237350346,91,11284,198157,6,246395,23008,24,151,144444.0,43333.0,-69.0,-67.0,-71.0,-68.0,-69.0,-67.0,-70.0,-68.0,-88.0,-90.0,-87.0,-86.0,19.0,23.0,16.0,18.0,1
2298,CC:2F:71:3E:C5:1F,3764032,474757541,107,13063,3763925,474744478,0,417,35771,337,26145,80,9626,115,2,140,4,0,5,144444.0,39000.0,-70.0,-71.0,-66.0,-60.0,-70.0,-70.0,-66.0,-60.0,-88.0,-90.0,-87.0,-86.0,18.0,19.0,21.0,26.0,1
2299,BA:8C:B9:54:50:24,3764231,474834856,306,90378,3763925,474744478,0,1282,142655,1264,139809,18,2846,200,5,426,7,0,8,229410.0,137640.0,-40.0,-37.0,-46.0,-51.0,-42.0,-36.0,-44.0,-48.0,-88.0,-90.0,-87.0,-86.0,48.0,53.0,41.0,35.0,1
2300,92:69:1D:31:68:E9,3776752,490008279,12827,15263801,3763925,474744478,3,19362,3597345,18661,3436078,701,161267,6476,105,14091,252,3,252,216660.0,130000.0,-52.0,-47.0,-42.0,-47.0,-52.0,-47.0,-42.0,-47.0,-88.0,-90.0,-87.0,-86.0,36.0,43.0,45.0,39.0,1
2301,CC:2F:71:3F:1F:24,4010432,762444946,246502,287700004,3763930,474744942,27,207492,237470380,207401,237459096,91,11284,198246,6,246502,23021,24,151,144444.0,43333.0,-69.0,-66.0,-70.0,-68.0,-69.0,-66.0,-70.0,-68.0,-88.0,-90.0,-87.0,-86.0,19.0,24.0,17.0,18.0,1
2302,CC:2F:71:3E:C5:1F,3764037,474758005,107,13063,3763930,474744942,0,417,35771,337,26145,80,9626,115,2,140,4,0,5,144444.0,39000.0,-70.0,-71.0,-66.0,-60.0,-70.0,-70.0,-66.0,-60.0,-88.0,-90.0,-87.0,-86.0,18.0,19.0,21.0,26.0,1
2303,BA:8C:B9:54:50:24,3764238,474835522,306,90378,3763932,474745144,0,1282,142655,1264,139809,18,2846,200,5,426,7,0,8,229410.0,137640.0,-40.0,-37.0,-46.0,-51.0,-42.0,-36.0,-44.0,-48.0,-88.0,-90.0,-87.0,-86.0,48.0,53.0,41.0,35.0,1
2304,92:69:1D:31:68:E9,3776759,490008945,12827,15263801,3763932,474745144,3,19362,3597345,18661,3436078,701,161267,6476,105,14091,252,3,252,216660.0,130000.0,-52.0,-47.0,-42.0,-47.0,-52.0,-47.0,-42.0,-47.0,-88.0,-90.0,-87.0,-86.0,36.0,43.0,45.0,39.0,1
2305,CC:2F:71:3F:1F:24,4010541,762562072,246607,287816726,3763934,474745346,27,207586,237585336,207495,237574052,91,11284,198334,6,246608,23030,24,151,144444.0,43333.0,-69.0,-67.0,-71.0,-68.0,-69.0,-66.0,-70.0,-68.0,-88.0,-90.0,-87.0,-86.0,19.0,23.0,16.0,18.0,1
2306,CC:2F:71:3E:C5:1F,3764041,474758409,107,13063,3763934,474745346,0,417,35771,337,26145,80,9626,115,2,140,4,0,5,144444.0,39000.0,-70.0,-71.0,-66.0,-60.0,-70.0,-70.0,-66.0,-60.0,-88.0,-90.0,-87.0,-86.0,18.0,19.0,21.0,26.0,1
2307,BA:8C:B9:54:50:24,3764240,474835724,306,90378,3763934,474745346,0,1282,142655,1264,139809,18,2846,200,5,426,7,0,8,229410.0,137640.0,-40.0,-37.0,-46.0,-51.0,-42.0,-36.0,-44.0,-48.0,-88.0,-90.0,-87.0,-86.0,48.0,53.0,41.0,35.0,1
2308,92:69:1D:31:68:E9,3776761,490009147,12827,15263801,3763934,474745346,3,19362,3597345,18661,3436078,701,161267,6476,105,14091,252,3,252,216660.0,130000.0,-52.0,-47.0,-42.0,-47.0,-52.0,-47.0,-42.0,-47.0,-88.0,-90.0,-87.0,-86.0,36.0,43.0,45.0,39.0,1
2309,CC:2F:71:3F:1F:24,4010660,762685837,246721,287940027,3763939,474745810,27,207688,237704557,207597,237693273,91,11284,198429,6,246722,23041,24,151,144444.0,43333.0,-69.0,-67.0,-70.0,-68.0,-69.0,-67.0,-71.0,-68.0,-88.0,-90.0,-87.0,-86.0,19.0,23.0,17.0,18.0,1
2310,CC:2F:71:3E:C5:1F,3764046,474758873,107,13063,3763939,474745810,0,417,35771,337,26145,80,9626,115,2,140,4,0,5,144444.0,39000.0,-70.0,-71.0,-66.0,-60.0,-70.0,-70.0,-66.0,-60.0,-88.0,-90.0,-87.0,-86.0,18.0,19.0,21.0,26.0,1
2311,BA:8C:B9:54:50:24,3764245,474836188,306,90378,3763939,474745810,0,1282,142655,1264,139809,18,2846,200,5,426,7,0,8,229410.0,137640.0,-40.0,-37.0,-46.0,-51.0,-42.0,-36.0,-44.0,-48.0,-88.0,-90.0,-87.0,-86.0,48.0,53.0,41.0,35.0,1
2312,92:69:1D:31:68:E9,3776768,490009813,12827,15263801,3763941,474746012,3,19365,3597549,18664,3436282,701,161267,6476,105,14091,252,3,252,216660.0,130000.0,-52.0,-47.0,-42.0,-47.0,-51.0,-47.0,-42.0,-47.0,-88.0,-90.0,-87.0,-86.0,36.0,43.0,45.0,39.0,1
2313,CC:2F:71:3F:1F:24,4010771,762804647,246828,288058433,3763943,474746214,27,207783,237816955,207692,237805671,91,11284,198517,6,246828,23052,24,151,144444.0,43333.0,-70.0,-67.0,-71.0,-68.0,-69.0,-66.0,-70.0,-68.0,-88.0,-90.0,-87.0,-86.0,18.0,23.0,16.0,18.0,1
2314,CC:2F:71:3E:C5:1F,3764050,474759277,107,13063,3763943,474746214,0,417,35771,337,26145,80,9626,115,2,140,4,0,5,144444.0,39000.0,-70.0,-71.0,-66.0,-60.0,-70.0,-70.0,-66.0,-60.0,-88.0,-90.0,-87.0,-86.0,18.0,19.0,21.0,26.0,1
2315,BA:8C:B9:54:50:24,3764249,474836592,306,90378,3763943,474746214,0,1282,142655,1264,139809,18,2846,200,5,426,7,0,8,229410.0,137640.0,-40.0,-37.0,-46.0,-51.0,-42.0,-36.0,-44.0,-48.0,-88.0,-90.0,-87.0,-86.0,48.0,53.0,41.0,35.0,1
2316,92:69:1D:31:68:E9,3776770,490010015,12827,15263801,3763943,474746214,3,19365,3597549,18664,3436282,701,161267,6476,105,14091,252,3,252,216660.0,130000.0,-52.0,-47.0,-42.0,-47.0,-51.0,-47.0,-42.0,-47.0,-88.0,-90.0,-87.0,-86.0,36.0,43.0,45.0,39.0,1
2317,CC:2F:71:3F:1F:24,4010882,762923457,246935,288176839,3763947,474746618,27,207878,237936217,207787,237924933,91,11284,198605,6,246936,23066,24,151,144444.0,43333.0,-73.0,-70.0,-74.0,-71.0,-72.0,-69.0,-73.0,-70.0,-88.0,-90.0,-87.0,-86.0,15.0,20.0,13.0,15.0,1
2318,CC:2F:71:3E:C5:1F,3764054,474759681,107,13063,3763947,474746618,0,417,35771,337,26145,80,9626,115,2,140,4,0,5,144444.0,39000.0,-70.0,-71.0,-66.0,-60.0,-70.0,-70.0,-66.0,-60.0,-88.0,-90.0,-87.0,-86.0,18.0,19.0,21.0,26.0,1
2319,BA:8C:B9:54:50:24,3764253,474836996,306,90378,3763947,474746618,0,1282,142655,1264,139809,18,2846,200,5,426,7,0,8,229410.0,137640.0,-40.0,-37.0,-46.0,-51.0,-42.0,-36.0,-44.0,-48.0,-88.0,-90.0,-87.0,-86.0,48.0,53.0,41.0,35.0,1
2320,92:69:1D:31:68:E9,3776776,490010621,12827,15263801,3763949,474746820,3,19365,3597549,18664,3436282,701,161267,6476,105,14091,252,3,252,216660.0,130000.0,-52.0,-47.0,-42.0,-47.0,-51.0,-47.0,-42.0,-47.0,-88.0,-90.0,-87.0,-86.0,36.0,43.0,45.0,39.0,1
2321,CC:2F:71:3F:1F:24,4010996,763045421,247044,288298339,3763952,474747082,27,207981,238055125,207890,238043841,91,11284,198700,6,247045,23077,24,152,144444.0,43333.0,-70.0,-67.0,-71.0,-69.0,-70.0,-67.0,-71.0,-69.0,-88.0,-90.0,-87.0,-86.0,18.0,23.0,16.0,17.0,1
2322,CC:2F:71:3E:C5:1F,3764059,474760145,107,13063,3763952,474747082,0,417,35771,337,26145,80,9626,115,2,140,4,0,5,144444.0,39000.0,-70.0,-71.0,-66.0,-60.0,-70.0,-70.0,-66.0,-60.0,-88.0,-90.0,-87.0,-86.0,18.0,19.0,21.0,26.0,1
2323,BA:8C:B9:54:50:24,3764258,474837460,306,90378,3763952,474747082,0,1282,142655,1264,139809,18,2846,200,5,426,7,0,8,229410.0,137640.0,-40.0,-37.0,-46.0,-51.0,-42.0,-36.0,-44.0,-48.0,-88.0,-90.0,-87.0,-86.0,48.0,53.0,41.0,35.0,1
2324,92:69:1D:31:68:E9,3776779,490010883,12827,15263801,3763952,474747082,3,19365,3597549,18664,3436282,701,161267,6476,105,14091,252,3,252,216660.0,130000.0,-52.0,-47.0,-42.0,-47.0,-51.0,-47.0,-42.0,-47.0,-88.0,-90.0,-87.0,-86.0,36.0,43.0,45.0,39.0,1
2325,CC:2F:71:3F:1F:24,4011115,763167726,247159,288420240,3763956,474747486,27,208084,238170286,207993,238159002,91,11284,198797,6,247160,23086,24,152,144444.0,43333.0,-69.0,-66.0,-70.0,-68.0,-69.0,-66.0,-70.0,-68.0,-88.0,-90.0,-86.0,-86.0,19.0,24.0,16.0,18.0,1
2326,CC:2F:71:3E:C5:1F,3764063,474760549,107,13063,3763956,474747486,0,419,35911,339,26285,80,9626,115,2,141,4,0,5,144444.0,39000.0,-70.0,-71.0,-66.0,-60.0,-70.0,-70.0,-66.0,-60.0,-88.0,-90.0,-86.0,-86.0,18.0,19.0,20.0,26.0,1
2327,BA:8C:B9:54:50:24,3764262,474837864,306,90378,3763956,474747486,0,1284,142791,1266,139945,18,2846,200,5,427,7,0,8,229410.0,137640.0,-48.0,-35.0,-43.0,-45.0,-44.0,-35.0,-43.0,-47.0,-88.0,-90.0,-86.0,-86.0,40.0,55.0,43.0,41.0,1
2328,92:69:1D:31:68:E9,3776785,490011489,12827,15263801,3763958,474747688,3,19365,3597549,18664,3436282,701,161267,6476,105,14091,252,3,252,216660.0,130000.0,-52.0,-47.0,-42.0,-47.0,-51.0,-47.0,-42.0,-47.0,-88.0,-90.0,-86.0,-86.0,36.0,43.0,44.0,39.0,1
2329,CC:2F:71:3F:1F:24,4011225,763287830,247265,288539940,3763960,474747890,27,208179,238288228,208088,238276944,91,11284,198885,6,247266,23093,24,153,144444.0,43333.0,-70.0,-67.0,-72.0,-68.0,-69.0,-66.0,-71.0,-68.0,-88.0,-90.0,-87.0,-86.0,18.0,23.0,15.0,18.0,1
2330,CC:2F:71:3E:C5:1F,3764067,474760953,107,13063,3763960,474747890,0,419,35911,339,26285,80,9626,115,2,141,4,0,5,144444.0,39000.0,-70.0,-71.0,-66.0,-60.0,-70.0,-70.0,-66.0,-60.0,-88.0,-90.0,-87.0,-86.0,18.0,19.0,21.0,26.0,1
2331,BA:8C:B9:54:50:24,3764266,474838268,306,90378,3763960,474747890,0,1285,142859,1267,140013,18,2846,200,5,427,7,0,8,229410.0,137640.0,-40.0,-37.0,-45.0,-51.0,-43.0,-36.0,-44.0,-48.0,-88.0,-90.0,-87.0,-86.0,48.0,53.0,42.0,35.0,1
2332,92:69:1D:31:68:E9,3776787,490011691,12827,15263801,3763960,474747890,3,19365,3597549,18664,3436282,701,161267,6476,105,14091,252,3,252,216660.0,130000.0,-52.0,-47.0,-42.0,-47.0,-51.0,-47.0,-42.0,-47.0,-88.0,-90.0,-87.0,-86.0,36.0,43.0,45.0,39.0,1
2333,CC:2F:71:3F:1F:24,4011336,763406570,247371,288658216,3763965,474748354,27,208270,238401288,208179,238390004,91,11284,198972,6,247372,23097,24,153,144444.0,43333.0,-70.0,-67.0,-72.0,-69.0,-72.0,-69.0,-73.0,-71.0,-88.0,-90.0,-87.0,-86.0,18.0,23.0,15.0,17.0,1
2334,CC:2F:71:3E:C5:1F,3764072,474761417,107,13063,3763965,474748354,0,419,35911,339,26285,80,9626,115,2,141,4,0,5,144444.0,39000.0,-70.0,-71.0,-66.0,-60.0,-70.0,-70.0,-66.0,-60.0,-88.0,-90.0,-87.0,-86.0,18.0,19.0,21.0,26.0,1
2335,BA:8C:B9:54:50:24,3764271,474838732,306,90378,3763965,474748354,0,1285,142859,1267,140013,18,2846,200,5,427,7,0,8,229410.0,137640.0,-40.0,-37.0,-45.0,-51.0,-43.0,-36.0,-44.0,-48.0,-88.0,-90.0,-87.0,-86.0,48.0,53.0,42.0,35.0,1
2336,92:69:1D:31:68:E9,3776792,490012155,12827,15263801,3763965,474748354,3,19365,3597549,18664,3436282,701,161267,6476,105,14091,252,3,252,216660.0,130000.0,-52.0,-47.0,-42.0,-47.0,-51.0,-47.0,-42.0,-47.0,-88.0,-90.0,-87.0,-86.0,36.0,43.0,45.0,39.0,1
2337,CC:2F:71:3F:1F:24,4011446,763525250,247477,288776492,3763969,474748758,27,208361,238514348,208270,238503064,91,11284,199059,6,247478,23110,24,153,144444.0,43333.0,-72.0,-70.0,-73.0,-72.0,-72.0,-69.0,-73.0,-71.0,-88.0,-90.0,-87.0,-86.0,16.0,20.0,14.0,14.0,1
2338,CC:2F:71:3E:C5:1F,3764076,474761821,107,13063,3763969,474748758,0,419,35911,339,26285,80,9626,115,2,141,4,0,5,144444.0,39000.0,-70.0,-71.0,-66.0,-60.0,-70.0,-70.0,-66.0,-60.0,-88.0,-90.0,-87.0,-86.0,18.0,19.0,21.0,26.0,1
2339,BA:8C:B9:54:50:24,3764275,474839136,306,90378,3763969,474748758,0,1285,142859,1267,140013,18,2846,200,5,427,7,0,8,229410.0,137640.0,-40.0,-37.0,-45.0,-51.0,-43.0,-36.0,-44.0,-48.0,-88.0,-90.0,-87.0,-86.0,48.0,53.0,42.0,35.0,1
2340,92:69:1D:31:68:E9,3776796,490012559,12827,15263801,3763969,474748758,3,19365,3597549,18664,3436282,701,161267,6476,105,14091,252,3,252,216660.0,130000.0,-52.0,-47.0,-42.0,-47.0,-51.0,-47.0,-42.0,-47.0,-88.0,-90.0,-87.0,-86.0,36.0,43.0,45.0,39.0,1
2341,CC:2F:71:3F:1F:24,4011564,763647531,247591,288898369,3763973,474749162,27,208464,238635043,208373,238623759,91,11284,199154,6,247592,23120,24,153,144444.0,43333.0,-73.0,-70.0,-74.0,-71.0,-72.0,-69.0,-73.0,-70.0,-88.0,-90.0,-86.0,-86.0,15.0,20.0,12.0,15.0,1
2342,CC:2F:71:3E:C5:1F,3764081,474762285,107,13063,3763974,474749222,0,419,35911,339,26285,80,9626,115,2,141,4,0,5,144444.0,39000.0,-70.0,-71.0,-66.0,-60.0,-70.0,-70.0,-66.0,-60.0,-88.0,-90.0,-86.0,-86.0,18.0,19.0,20.0,26.0,1
2343,BA:8C:B9:54:50:24,3764280,474839600,306,90378,3763974,474749222,0,1285,142859,1267,140013,18,2846,200,5,427,7,0,8,229410.0,137640.0,-40.0,-37.0,-45.0,-51.0,-43.0,-36.0,-44.0,-48.0,-88.0,-90.0,-86.0,-86.0,48.0,53.0,41.0,35.0,1
2344,92:69:1D:31:68:E9,3776801,490013023,12827,15263801,3763974,474749222,3,19365,3597549,18664,3436282,701,161267,6476,105,14091,252,3,252,216660.0,130000.0,-52.0,-47.0,-42.0,-47.0,-51.0,-47.0,-42.0,-47.0,-88.0,-90.0,-86.0,-86.0,36.0,43.0,44.0,39.0,1
2345,CC:2F:71:3F:1F:24,4011673,763765957,247697,289016533,3763976,474749424,27,208553,238743571,208462,238732287,91,11284,199241,6,247698,23137,24,153,144444.0,43333.0,-73.0,-70.0,-74.0,-71.0,-73.0,-70.0,-74.0,-71.0,-88.0,-90.0,-87.0,-86.0,15.0,20.0,13.0,15.0,1
2346,CC:2F:71:3E:C5:1F,3764085,474762689,107,13063,3763978,474749626,0,419,35911,339,26285,80,9626,115,2,141,4,0,5,144444.0,39000.0,-70.0,-71.0,-66.0,-60.0,-70.0,-70.0,-66.0,-60.0,-88.0,-90.0,-87.0,-86.0,18.0,19.0,21.0,26.0,1
2347,BA:8C:B9:54:50:24,3764284,474840004,306,90378,3763978,474749626,0,1285,142859,1267,140013,18,2846,200,5,427,7,0,8,229410.0,137640.0,-40.0,-37.0,-45.0,-51.0,-43.0,-36.0,-44.0,-48.0,-88.0,-90.0,-87.0,-86.0,48.0,53.0,42.0,35.0,1
2348,92:69:1D:31:68:E9,3776805,490013427,12827,15263801,3763978,474749626,3,19365,3597549,18664,3436282,701,161267,6476,105,14091,252,3,252,216660.0,130000.0,-52.0,-47.0,-42.0,-47.0,-51.0,-47.0,-42.0,-47.0,-88.0,-90.0,-87.0,-86.0,36.0,43.0,45.0,39.0,1
2349,CC:2F:71:3F:1F:24,4011788,763888348,247805,289138045,3763983,474750303,27,208648,238855641,208557,238844357,91,11284,199335,6,247806,23151,24,153,144444.0,43333.0,-72.0,-70.0,-74.0,-71.0,-72.0,-69.0,-73.0,-70.0,-88.0,-90.0,-87.0,-86.0,16.0,20.0,13.0,15.0,1
2350,CC:2F:71:3E:C5:1F,3764090,474763366,107,13063,3763983,474750303,0,419,35911,339,26285,80,9626,115,2,141,4,0,5,144444.0,39000.0,-70.0,-71.0,-66.0,-60.0,-70.0,-70.0,-66.0,-60.0,-88.0,-90.0,-87.0,-86.0,18.0,19.0,21.0,26.0,1
2351,BA:8C:B9:54:50:24,3764289,474840681,306,90378,3763983,474750303,0,1285,142859,1267,140013,18,2846,200,5,427,7,0,8,229410.0,137640.0,-40.0,-37.0,-45.0,-51.0,-43.0,-36.0,-44.0,-48.0,-88.0,-90.0,-87.0,-86.0,48.0,53.0,42.0,35.0,1
2352,92:69:1D:31:68:E9,3776810,490014104,12827,15263801,3763983,474750303,3,19365,3597549,18664,3436282,701,161267,6476,105,14091,252,3,252,216660.0,130000.0,-52.0,-47.0,-42.0,-47.0,-51.0,-47.0,-42.0,-47.0,-88.0,-90.0,-87.0,-86.0,36.0,43.0,45.0,39.0,1
2353,CC:2F:71:3F:1F:24,4011897,764006886,247911,289256321,3763986,474750565,27,208741,238969139,208650,238957855,91,11284,199423,6,247912,23177,24,153,144444.0,43333.0,-68.0,-67.0,-71.0,-67.0,-68.0,-66.0,-70.0,-66.0,-88.0,-90.0,-87.0,-86.0,20.0,23.0,16.0,19.0,1
2354,CC:2F:71:3E:C5:1F,3764094,474763762,107,13063,3763987,474750699,0,419,35911,339,26285,80,9626,115,2,141,4,0,5,144444.0,39000.0,-70.0,-71.0,-66.0,-60.0,-70.0,-70.0,-66.0,-60.0,-88.0,-90.0,-87.0,-86.0,18.0,19.0,21.0,26.0,1
2355,BA:8C:B9:54:50:24,3764294,474841145,306,90378,3763988,474750767,0,1285,142859,1267,140013,18,2846,200,5,427,7,0,8,229410.0,137640.0,-40.0,-37.0,-45.0,-51.0,-43.0,-36.0,-44.0,-48.0,-88.0,-90.0,-87.0,-86.0,48.0,53.0,42.0,35.0,1
2356,92:69:1D:31:68:E9,3776815,490014568,12827,15263801,3763988,474750767,3,19365,3597549,18664,3436282,701,161267,6476,105,14091,252,3,252,216660.0,130000.0,-52.0,-47.0,-42.0,-47.0,-51.0,-47.0,-42.0,-47.0,-88.0,-90.0,-87.0,-86.0,36.0,43.0,45.0,39.0,1
2357,CC:2F:71:3F:1F:24,4012015,764129053,248023,289377882,3763992,474751171,27,208844,239089929,208753,239078645,91,11284,199517,6,248024,23213,24,153,130000.0,43333.0,-68.0,-66.0,-71.0,-67.0,-68.0,-66.0,-71.0,-67.0,-88.0,-90.0,-87.0,-86.0,20.0,24.0,16.0,19.0,1
2358,CC:2F:71:3E:C5:1F,3764099,474764234,107,13063,3763992,474751171,0,419,35911,339,26285,80,9626,115,2,141,4,0,5,144444.0,39000.0,-70.0,-71.0,-66.0,-60.0,-70.0,-70.0,-66.0,-60.0,-88.0,-90.0,-87.0,-86.0,18.0,19.0,21.0,26.0,1
2359,BA:8C:B9:54:50:24,3764298,474841549,306,90378,3763992,474751171,0,1285,142859,1267,140013,18,2846,200,5,427,7,0,8,229410.0,137640.0,-40.0,-37.0,-45.0,-51.0,-43.0,-36.0,-44.0,-48.0,-88.0,-90.0,-87.0,-86.0,48.0,53.0,42.0,35.0,1
2360,92:69:1D:31:68:E9,3776819,490014972,12827,15263801,3763992,474751171,3,19365,3597549,18664,3436282,701,161267,6476,105,14091,252,3,252,216660.0,130000.0,-52.0,-47.0,-42.0,-47.0,-51.0,-47.0,-42.0,-47.0,-88.0,-90.0,-87.0,-86.0,36.0,43.0,45.0,39.0,1
2361,CC:2F:71:3F:1F:24,4012132,764250403,248130,289496120,3764002,474754283,27,208941,239212313,208850,239201029,91,11284,199604,6,248131,23217,24,153,130000.0,39000.0,-69.0,-67.0,-71.0,-68.0,-69.0,-67.0,-70.0,-68.0,-88.0,-90.0,-87.0,-86.0,19.0,23.0,16.0,18.0,1
2362,CC:2F:71:3E:C5:1F,3764109,474767346,107,13063,3764002,474754283,0,419,35911,339,26285,80,9626,115,2,141,4,0,5,144444.0,39000.0,-70.0,-71.0,-66.0,-60.0,-70.0,-70.0,-66.0,-60.0,-88.0,-90.0,-87.0,-86.0,18.0,19.0,21.0,26.0,1
2363,BA:8C:B9:54:50:24,3764308,474844661,306,90378,3764002,474754283,0,1285,142859,1267,140013,18,2846,200,5,427,7,0,8,229410.0,137640.0,-40.0,-37.0,-45.0,-51.0,-43.0,-36.0,-44.0,-48.0,-88.0,-90.0,-87.0,-86.0,48.0,53.0,42.0,35.0,1
2364,92:69:1D:31:68:E9,3776831,490018286,12827,15263801,3764004,474754485,3,19365,3597549,18664,3436282,701,161267,6476,105,14091,252,3,252,216660.0,130000.0,-52.0,-47.0,-42.0,-47.0,-51.0,-47.0,-42.0,-47.0,-88.0,-90.0,-87.0,-86.0,36.0,43.0,45.0,39.0,1
2365,CC:2F:71:3F:1F:24,4012244,764369159,248235,289614210,3764009,474754949,27,209034,239327185,208943,239315901,91,11284,199691,6,248236,23217,24,153,130000.0,43333.0,-69.0,-66.0,-70.0,-68.0,-71.0,-68.0,-72.0,-70.0,-88.0,-90.0,-87.0,-86.0,19.0,24.0,17.0,18.0,1
2366,CC:2F:71:3E:C5:1F,3764116,474768012,107,13063,3764009,474754949,0,419,35911,339,26285,80,9626,115,2,141,4,0,5,144444.0,39000.0,-70.0,-71.0,-66.0,-60.0,-70.0,-70.0,-66.0,-60.0,-88.0,-90.0,-87.0,-86.0,18.0,19.0,21.0,26.0,1
2367,BA:8C:B9:54:50:24,3764315,474845327,306,90378,3764009,474754949,0,1285,142859,1267,140013,18,2846,200,5,427,7,0,8,229410.0,137640.0,-40.0,-37.0,-45.0,-51.0,-43.0,-36.0,-44.0,-48.0,-88.0,-90.0,-87.0,-86.0,48.0,53.0,42.0,35.0,1
2368,92:69:1D:31:68:E9,3776836,490018750,12827,15263801,3764009,474754949,3,19365,3597549,18664,3436282,701,161267,6476,105,14091,252,3,252,216660.0,130000.0,-52.0,-47.0,-42.0,-47.0,-51.0,-47.0,-42.0,-47.0,-88.0,-90.0,-87.0,-86.0,36.0,43.0,45.0,39.0,1
2369,CC:2F:71:3F:1F:24,4012352,764489061,248341,289733910,3764011,474755151,27,209125,239440245,209034,239428961,91,11284,199778,6,248342,23217,24,153,130000.0,43333.0,-72.0,-70.0,-73.0,-71.0,-71.0,-68.0,-72.0,-70.0,-88.0,-90.0,-87.0,-86.0,16.0,20.0,14.0,15.0,1
2370,CC:2F:71:3E:C5:1F,3764118,474768214,107,13063,3764011,474755151,0,419,35911,339,26285,80,9626,115,2,141,4,0,5,144444.0,39000.0,-70.0,-71.0,-66.0,-60.0,-70.0,-70.0,-66.0,-60.0,-88.0,-90.0,-87.0,-86.0,18.0,19.0,21.0,26.0,1
2371,BA:8C:B9:54:50:24,3764317,474845529,306,90378,3764011,474755151,0,1285,142859,1267,140013,18,2846,200,5,427,7,0,8,229410.0,137640.0,-40.0,-37.0,-45.0,-51.0,-43.0,-36.0,-44.0,-48.0,-88.0,-90.0,-87.0,-86.0,48.0,53.0,42.0,35.0,1
2372,92:69:1D:31:68:E9,3776838,490018952,12827,15263801,3764011,474755151,3,19365,3597549,18664,3436282,701,161267,6476,105,14091,252,3,252,216660.0,130000.0,-52.0,-47.0,-42.0,-47.0,-51.0,-47.0,-42.0,-47.0,-88.0,-90.0,-87.0,-86.0,36.0,43.0,45.0,39.0,1
2373,CC:2F:71:3F:1F:24,4012469,764609506,248452,289853749,3764017,474755757,27,209227,239560824,209136,239549540,91,11284,199872,6,248453,23222,24,153,130000.0,43333.0,-71.0,-70.0,-74.0,-71.0,-72.0,-70.0,-73.0,-71.0,-88.0,-90.0,-87.0,-86.0,17.0,20.0,13.0,15.0,1
2374,CC:2F:71:3E:C5:1F,3764125,474768880,107,13063,3764018,474755817,0,419,35911,339,26285,80,9626,115,2,141,4,0,5,144444.0,39000.0,-70.0,-71.0,-66.0,-60.0,-70.0,-70.0,-66.0,-60.0,-88.0,-90.0,-87.0,-86.0,18.0,19.0,21.0,26.0,1
2375,BA:8C:B9:54:50:24,3764324,474846195,306,90378,3764018,474755817,0,1285,142859,1267,140013,18,2846,200,5,427,7,0,8,229410.0,137640.0,-40.0,-37.0,-45.0,-51.0,-43.0,-36.0,-44.0,-48.0,-88.0,-90.0,-87.0,-86.0,48.0,53.0,42.0,35.0,1
2376,92:69:1D:31:68:E9,3776845,490019618,12827,15263801,3764018,474755817,3,19365,3597549,18664,3436282,701,161267,6476,105,14091,252,3,252,216660.0,130000.0,-52.0,-47.0,-42.0,-47.0,-51.0,-47.0,-42.0,-47.0,-88.0,-90.0,-87.0,-86.0,36.0,43.0,45.0,39.0,1
2377,CC:2F:71:3F:1F:24,4012580,764729646,248559,289973565,3764021,474756081,27,209317,239672316,209226,239661032,91,11284,199960,6,248560,23222,24,153,130000.0,43333.0,-68.0,-66.0,-69.0,-68.0,-68.0,-66.0,-70.0,-67.0,-88.0,-90.0,-87.0,-86.0,20.0,24.0,18.0,18.0,1
2378,CC:2F:71:3E:C5:1F,3764129,474769260,108,13179,3764021,474756081,0,422,36169,341,26425,81,9744,116,2,142,4,0,5,144444.0,39000.0,-70.0,-70.0,-66.0,-60.0,-70.0,-70.0,-66.0,-60.0,-88.0,-90.0,-87.0,-86.0,18.0,20.0,21.0,26.0,1
2379,BA:8C:B9:54:50:24,3764328,474846519,307,90438,3764021,474756081,0,1287,142995,1269,140149,18,2846,200,5,428,7,0,8,216660.0,130000.0,-40.0,-37.0,-46.0,-51.0,-44.0,-36.0,-44.0,-48.0,-88.0,-90.0,-87.0,-86.0,48.0,53.0,41.0,35.0,1
2380,92:69:1D:31:68:E9,3776849,490019998,12828,15263917,3764021,474756081,3,19367,3597685,18666,3436418,701,161267,6476,105,14092,252,3,252,216660.0,130000.0,-52.0,-48.0,-42.0,-47.0,-51.0,-47.0,-42.0,-47.0,-88.0,-90.0,-87.0,-86.0,36.0,42.0,45.0,39.0,1
2381,CC:2F:71:3F:1F:24,4012691,764848382,248664,290091695,3764027,474756687,27,209409,239785634,209318,239774350,91,11284,200047,6,248665,23224,24,153,130000.0,43333.0,-69.0,-66.0,-70.0,-68.0,-69.0,-66.0,-70.0,-67.0,-88.0,-90.0,-87.0,-86.0,19.0,24.0,17.0,18.0,1
2382,CC:2F:71:3E:C5:1F,3764135,474769866,108,13179,3764027,474756687,0,423,36239,342,26495,81,9744,116,2,142,4,0,5,144444.0,39000.0,-70.0,-70.0,-66.0,-60.0,-70.0,-70.0,-66.0,-60.0,-88.0,-90.0,-87.0,-86.0,18.0,20.0,21.0,26.0,1
2383,BA:8C:B9:54:50:24,3764334,474847125,307,90438,3764027,474756687,0,1287,142995,1269,140149,18,2846,200,5,428,7,0,8,216660.0,130000.0,-40.0,-37.0,-46.0,-51.0,-44.0,-36.0,-44.0,-48.0,-88.0,-90.0,-87.0,-86.0,48.0,53.0,41.0,35.0,1
2384,92:69:1D:31:68:E9,3776855,490020604,12828,15263917,3764027,474756687,3,19367,3597685,18666,3436418,701,161267,6476,105,14092,252,3,252,216660.0,130000.0,-52.0,-48.0,-42.0,-47.0,-51.0,-47.0,-42.0,-47.0,-88.0,-90.0,-87.0,-86.0,36.0,42.0,45.0,39.0,1
2385,CC:2F:71:3F:1F:24,4012799,764966566,248769,290209617,3764030,474756949,27,209500,239896038,209409,239884754,91,11284,200134,6,248770,23228,24,153,130000.0,43333.0,-69.0,-66.0,-70.0,-68.0,-68.0,-66.0,-70.0,-68.0,-88.0,-90.0,-87.0,-86.0,19.0,24.0,17.0,18.0,1
2386,CC:2F:71:3E:C5:1F,3764138,474770128,108,13179,3764030,474756949,0,423,36239,342,26495,81,9744,116,2,142,4,0,5,144444.0,39000.0,-70.0,-70.0,-66.0,-60.0,-70.0,-70.0,-66.0,-60.0,-88.0,-90.0,-87.0,-86.0,18.0,20.0,21.0,26.0,1
2387,BA:8C:B9:54:50:24,3764337,474847387,307,90438,3764030,474756949,0,1287,142995,1269,140149,18,2846,200,5,428,7,0,8,216660.0,130000.0,-40.0,-37.0,-46.0,-51.0,-44.0,-36.0,-44.0,-48.0,-88.0,-90.0,-87.0,-86.0,48.0,53.0,41.0,35.0,1
2388,92:69:1D:31:68:E9,3776858,490020866,12828,15263917,3764030,474756949,3,19367,3597685,18666,3436418,701,161267,6476,105,14092,252,3,252,216660.0,130000.0,-52.0,-48.0,-42.0,-47.0,-51.0,-47.0,-42.0,-47.0,-88.0,-90.0,-87.0,-86.0,36.0,42.0,45.0,39.0,1
2389,CC:2F:71:3F:1F:24,4012918,765088919,248882,290331364,3764036,474757555,27,209599,240009173,209508,239997889,91,11284,200229,6,248883,23228,24,153,130000.0,43333.0,-69.0,-66.0,-70.0,-68.0,-69.0,-66.0,-70.0,-68.0,-88.0,-90.0,-87.0,-86.0,19.0,24.0,17.0,18.0,1
2390,CC:2F:71:3E:C5:1F,3764144,474770734,108,13179,3764036,474757555,0,423,36239,342,26495,81,9744,116,2,142,4,0,5,144444.0,39000.0,-70.0,-70.0,-66.0,-60.0,-70.0,-70.0,-66.0,-60.0,-88.0,-90.0,-87.0,-86.0,18.0,20.0,21.0,26.0,1
2391,BA:8C:B9:54:50:24,3764343,474847993,307,90438,3764036,474757555,0,1287,142995,1269,140149,18,2846,200,5,428,7,0,8,216660.0,130000.0,-40.0,-37.0,-46.0,-51.0,-44.0,-36.0,-44.0,-48.0,-88.0,-90.0,-87.0,-86.0,48.0,53.0,41.0,35.0,1
2392,92:69:1D:31:68:E9,3776864,490021472,12828,15263917,3764036,474757555,3,19367,3597685,18666,3436418,701,161267,6476,105,14092,252,3,252,216660.0,130000.0,-52.0,-48.0,-42.0,-47.0,-51.0,-47.0,-42.0,-47.0,-88.0,-90.0,-87.0,-86.0,36.0,42.0,45.0,39.0,1
2393,CC:2F:71:3F:1F:24,4013024,765207083,248988,290449528,3764036,474757555,27,209691,240119661,209600,240108377,91,11284,200317,6,248989,23232,24,153,117000.0,39000.0,-69.0,-66.0,-70.0,-68.0,-69.0,-66.0,-70.0,-68.0,-88.0,-90.0,-87.0,-86.0,19.0,24.0,17.0,18.0,1
2394,CC:2F:71:3E:C5:1F,3764146,474770936,108,13179,3764038,474757757,0,423,36239,342,26495,81,9744,116,2,142,4,0,5,144444.0,39000.0,-70.0,-70.0,-66.0,-60.0,-70.0,-70.0,-66.0,-60.0,-88.0,-90.0,-87.0,-86.0,18.0,20.0,21.0,26.0,1
2395,BA:8C:B9:54:50:24,3764345,474848195,307,90438,3764038,474757757,0,1287,142995,1269,140149,18,2846,200,5,428,7,0,8,216660.0,130000.0,-40.0,-37.0,-46.0,-51.0,-44.0,-36.0,-44.0,-48.0,-88.0,-90.0,-87.0,-86.0,48.0,53.0,41.0,35.0,1
2396,92:69:1D:31:68:E9,3776866,490021674,12828,15263917,3764038,474757757,3,19367,3597685,18666,3436418,701,161267,6476,105,14092,252,3,252,216660.0,130000.0,-52.0,-48.0,-42.0,-47.0,-51.0,-47.0,-42.0,-47.0,-88.0,-90.0,-87.0,-86.0,36.0,42.0,45.0,39.0,1
2397,CC:2F:71:3F:1F:24,4013141,765330647,249096,290572224,3764045,474758423,27,209788,240240689,209697,240229405,91,11284,200406,6,249096,23232,24,153,130000.0,43333.0,-69.0,-66.0,-70.0,-68.0,-69.0,-66.0,-70.0,-68.0,-88.0,-90.0,-87.0,-86.0,19.0,24.0,17.0,18.0,1
2398,CC:2F:71:3E:C5:1F,3764153,474771602,108,13179,3764045,474758423,0,423,36239,342,26495,81,9744,116,2,142,4,0,5,144444.0,39000.0,-70.0,-70.0,-66.0,-60.0,-70.0,-70.0,-66.0,-60.0,-88.0,-90.0,-87.0,-86.0,18.0,20.0,21.0,26.0,1
2399,BA:8C:B9:54:50:24,3764352,474848861,307,90438,3764045,474758423,0,1287,142995,1269,140149,18,2846,200,5,428,7,0,8,216660.0,130000.0,-40.0,-37.0,-46.0,-51.0,-44.0,-36.0,-44.0,-48.0,-88.0,-90.0,-87.0,-86.0,48.0,53.0,41.0,35.0,1
2400,92:69:1D:31:68:E9,3776873,490022340,12828,15263917,3764045,474758423,3,19367,3597685,18666,3436418,701,161267,6476,105,14092,252,3,252,216660.0,130000.0,-52.0,-48.0,-42.0,-47.0,-51.0,-47.0,-42.0,-47.0,-88.0,-90.0,-87.0,-86.0,36.0,42.0,45.0,39.0,1
2401,CC:2F:71:3F:1F:24,4013245,765447239,249200,290688816,3764045,474758423,27,209879,240352453,209788,240341169,91,11284,200493,6,249201,23232,24,153,130000.0,43333.0,-69.0,-66.0,-70.0,-68.0,-69.0,-66.0,-70.0,-68.0,-88.0,-90.0,-87.0,-86.0,19.0,24.0,17.0,18.0,1
2402,CC:2F:71:3E:C5:1F,3764153,474771602,108,13179,3764045,474758423,0,423,36239,342,26495,81,9744,116,2,142,4,0,5,144444.0,39000.0,-70.0,-70.0,-66.0,-60.0,-70.0,-70.0,-66.0,-60.0,-88.0,-90.0,-87.0,-86.0,18.0,20.0,21.0,26.0,1
2403,BA:8C:B9:54:50:24,3764356,474849462,307,90438,3764049,474759024,0,1287,142995,1269,140149,18,2846,200,5,428,7,0,8,216660.0,130000.0,-40.0,-37.0,-46.0,-51.0,-44.0,-36.0,-44.0,-48.0,-88.0,-90.0,-87.0,-86.0,48.0,53.0,41.0,35.0,1
2404,92:69:1D:31:68:E9,3776877,490022941,12828,15263917,3764049,474759024,3,19367,3597685,18666,3436418,701,161267,6476,105,14092,252,3,252,216660.0,130000.0,-52.0,-48.0,-42.0,-47.0,-51.0,-47.0,-42.0,-47.0,-88.0,-90.0,-87.0,-86.0,36.0,42.0,45.0,39.0,1
2405,CC:2F:71:3F:1F:24,4013366,765569709,249311,290810079,3764055,474759630,27,209977,240464082,209886,240452798,91,11284,200588,6,249312,23236,24,153,130000.0,43333.0,-69.0,-66.0,-70.0,-68.0,-69.0,-66.0,-70.0,-68.0,-88.0,-90.0,-87.0,-86.0,19.0,24.0,17.0,18.0,1
2406,CC:2F:71:3E:C5:1F,3764163,474772809,108,13179,3764055,474759630,0,423,36239,342,26495,81,9744,116,2,142,4,0,5,144444.0,39000.0,-70.0,-70.0,-66.0,-60.0,-70.0,-70.0,-66.0,-60.0,-88.0,-90.0,-87.0,-86.0,18.0,20.0,21.0,26.0,1
2407,BA:8C:B9:54:50:24,3764363,474850128,307,90438,3764056,474759690,0,1287,142995,1269,140149,18,2846,200,5,428,7,0,8,216660.0,130000.0,-40.0,-37.0,-46.0,-51.0,-44.0,-36.0,-44.0,-48.0,-88.0,-90.0,-87.0,-86.0,48.0,53.0,41.0,35.0,1
2408,92:69:1D:31:68:E9,3776884,490023607,12828,15263917,3764056,474759690,3,19367,3597685,18666,3436418,701,161267,6476,105,14092,252,3,252,216660.0,130000.0,-52.0,-48.0,-42.0,-47.0,-51.0,-47.0,-42.0,-47.0,-88.0,-90.0,-87.0,-86.0,36.0,42.0,45.0,39.0,1
2409,CC:2F:71:3F:1F:24,4013475,765691153,249419,290931463,3764056,474759690,27,210072,240580564,209981,240569280,91,11284,200678,6,249420,23236,24,153,130000.0,43333.0,-69.0,-67.0,-71.0,-69.0,-72.0,-69.0,-73.0,-71.0,-88.0,-90.0,-87.0,-86.0,19.0,23.0,16.0,17.0,1
2410,CC:2F:71:3E:C5:1F,3764164,474772869,108,13179,3764056,474759690,0,423,36239,342,26495,81,9744,116,2,142,4,0,5,144444.0,39000.0,-70.0,-70.0,-66.0,-60.0,-70.0,-70.0,-66.0,-60.0,-88.0,-90.0,-87.0,-86.0,18.0,20.0,21.0,26.0,1
2411,BA:8C:B9:54:50:24,3764363,474850128,307,90438,3764056,474759690,0,1287,142995,1269,140149,18,2846,200,5,428,7,0,8,216660.0,130000.0,-40.0,-37.0,-46.0,-51.0,-44.0,-36.0,-44.0,-48.0,-88.0,-90.0,-87.0,-86.0,48.0,53.0,41.0,35.0,1
2412,92:69:1D:31:68:E9,3776884,490023607,12828,15263917,3764056,474759690,3,19367,3597685,18666,3436418,701,161267,6476,105,14092,252,3,252,216660.0,130000.0,-52.0,-48.0,-42.0,-47.0,-51.0,-47.0,-42.0,-47.0,-88.0,-90.0,-87.0,-86.0,36.0,42.0,45.0,39.0,1
2413,CC:2F:71:3F:1F:24,4013591,765811921,249527,291051423,3764064,474760498,27,210169,240693130,210078,240681846,91,11284,200768,6,249528,23236,24,153,130000.0,43333.0,-69.0,-66.0,-70.0,-68.0,-69.0,-66.0,-70.0,-68.0,-88.0,-90.0,-87.0,-86.0,19.0,24.0,17.0,18.0,1
2414,CC:2F:71:3E:C5:1F,3764172,474773677,108,13179,3764064,474760498,0,423,36239,342,26495,81,9744,116,2,142,4,0,5,144444.0,39000.0,-70.0,-70.0,-66.0,-60.0,-70.0,-70.0,-66.0,-60.0,-88.0,-90.0,-87.0,-86.0,18.0,20.0,21.0,26.0,1
2415,BA:8C:B9:54:50:24,3764371,474850936,307,90438,3764064,474760498,0,1287,142995,1269,140149,18,2846,200,5,428,7,0,8,216660.0,130000.0,-40.0,-37.0,-46.0,-51.0,-44.0,-36.0,-44.0,-48.0,-88.0,-90.0,-87.0,-86.0,48.0,53.0,41.0,35.0,1
2416,92:69:1D:31:68:E9,3776892,490024415,12828,15263917,3764064,474760498,3,19367,3597685,18666,3436418,701,161267,6476,105,14092,252,3,252,216660.0,130000.0,-52.0,-48.0,-42.0,-47.0,-51.0,-47.0,-42.0,-47.0,-88.0,-90.0,-87.0,-86.0,36.0,42.0,45.0,39.0,1
2417,CC:2F:71:3F:1F:24,4013698,765931457,249633,291170899,3764065,474760558,27,210266,240811172,210175,240799888,91,11284,200860,6,249634,23240,24,153,130000.0,43333.0,-69.0,-66.0,-70.0,-68.0,-69.0,-66.0,-70.0,-68.0,-88.0,-90.0,-87.0,-86.0,19.0,24.0,17.0,18.0,1
2418,CC:2F:71:3E:C5:1F,3764173,474773737,108,13179,3764065,474760558,0,423,36239,342,26495,81,9744,116,2,142,4,0,5,144444.0,39000.0,-70.0,-70.0,-66.0,-60.0,-70.0,-70.0,-66.0,-60.0,-88.0,-90.0,-87.0,-86.0,18.0,20.0,21.0,26.0,1
2419,BA:8C:B9:54:50:24,3764372,474850996,307,90438,3764065,474760558,0,1287,142995,1269,140149,18,2846,200,5,428,7,0,8,216660.0,130000.0,-40.0,-37.0,-46.0,-51.0,-44.0,-36.0,-44.0,-48.0,-88.0,-90.0,-87.0,-86.0,48.0,53.0,41.0,35.0,1
2420,92:69:1D:31:68:E9,3776893,490024475,12828,15263917,3764065,474760558,3,19367,3597685,18666,3436418,701,161267,6476,105,14092,252,3,252,216660.0,130000.0,-52.0,-48.0,-42.0,-47.0,-51.0,-47.0,-42.0,-47.0,-88.0,-90.0,-87.0,-86.0,36.0,42.0,45.0,39.0,1
2421,CC:2F:71:3F:1F:24,4013820,766055566,249747,291294200,3764073,474761366,27,210367,240927401,210276,240916117,91,11284,200956,6,249748,23240,24,153,130000.0,43333.0,-69.0,-66.0,-70.0,-68.0,-69.0,-66.0,-70.0,-68.0,-88.0,-90.0,-87.0,-86.0,19.0,24.0,17.0,18.0,1
2422,CC:2F:71:3E:C5:1F,3764181,474774545,108,13179,3764073,474761366,0,423,36239,342,26495,81,9744,116,2,142,4,0,5,144444.0,39000.0,-70.0,-70.0,-66.0,-60.0,-70.0,-70.0,-66.0,-60.0,-88.0,-90.0,-87.0,-86.0,18.0,20.0,21.0,26.0,1
2423,BA:8C:B9:54:50:24,3764392,474857403,307,90438,3764085,474766965,0,1287,142995,1269,140149,18,2846,200,5,428,7,0,8,216660.0,130000.0,-40.0,-37.0,-46.0,-51.0,-44.0,-36.0,-44.0,-48.0,-88.0,-90.0,-87.0,-86.0,48.0,53.0,41.0,35.0,1
2424,92:69:1D:31:68:E9,3776913,490030882,12828,15263917,3764085,474766965,3,19371,3598124,18669,3436622,702,161502,6477,105,14092,252,3,252,216660.0,130000.0,-51.0,-49.0,-43.0,-45.0,-51.0,-48.0,-43.0,-46.0,-88.0,-90.0,-87.0,-86.0,37.0,41.0,44.0,41.0,1
2425,CC:2F:71:3F:1F:24,4013954,766192467,249858,291420078,3764096,474772389,27,210469,241050591,210378,241039307,91,11284,201049,6,249859,23244,24,153,130000.0,39000.0,-69.0,-66.0,-71.0,-68.0,-69.0,-66.0,-70.0,-68.0,-88.0,-90.0,-87.0,-86.0,19.0,24.0,16.0,18.0,1
2426,CC:2F:71:3E:C5:1F,3764204,474785568,108,13179,3764096,474772389,0,423,36239,342,26495,81,9744,116,2,142,4,0,5,144444.0,39000.0,-70.0,-70.0,-66.0,-60.0,-70.0,-70.0,-66.0,-60.0,-88.0,-90.0,-87.0,-86.0,18.0,20.0,21.0,26.0,1
2427,BA:8C:B9:54:50:24,3764403,474862827,307,90438,3764096,474772389,0,1287,142995,1269,140149,18,2846,200,5,428,7,0,8,216660.0,130000.0,-40.0,-37.0,-46.0,-51.0,-44.0,-36.0,-44.0,-48.0,-88.0,-90.0,-87.0,-86.0,48.0,53.0,41.0,35.0,1
2428,92:69:1D:31:68:E9,3776924,490036306,12828,15263917,3764096,474772389,3,19371,3598124,18669,3436622,702,161502,6477,105,14092,252,3,252,216660.0,130000.0,-51.0,-49.0,-43.0,-45.0,-51.0,-48.0,-43.0,-46.0,-88.0,-90.0,-87.0,-86.0,37.0,41.0,44.0,41.0,1
2429,CC:2F:71:3F:1F:24,4014073,766312115,249965,291538428,3764108,474773687,27,210567,241163261,210475,241151859,92,11402,201141,6,249966,23244,24,153,130000.0,43333.0,-69.0,-66.0,-70.0,-68.0,-69.0,-66.0,-70.0,-68.0,-88.0,-90.0,-87.0,-86.0,19.0,24.0,17.0,18.0,1
2430,CC:2F:71:3E:C5:1F,3764216,474786866,108,13179,3764108,474773687,0,423,36239,342,26495,81,9744,116,2,142,4,0,5,144444.0,39000.0,-70.0,-70.0,-66.0,-60.0,-70.0,-70.0,-66.0,-60.0,-88.0,-90.0,-87.0,-86.0,18.0,20.0,21.0,26.0,1
2431,BA:8C:B9:54:50:24,3764415,474864125,307,90438,3764108,474773687,0,1287,142995,1269,140149,18,2846,200,5,428,7,0,8,216660.0,130000.0,-40.0,-37.0,-46.0,-51.0,-44.0,-36.0,-44.0,-48.0,-88.0,-90.0,-87.0,-86.0,48.0,53.0,41.0,35.0,1
2432,92:69:1D:31:68:E9,3776936,490037604,12828,15263917,3764108,474773687,3,19371,3598124,18669,3436622,702,161502,6477,105,14092,252,3,252,216660.0,130000.0,-51.0,-49.0,-43.0,-45.0,-51.0,-48.0,-43.0,-46.0,-88.0,-90.0,-87.0,-86.0,37.0,41.0,44.0,41.0,1
2433,CC:2F:71:3F:1F:24,4014181,766432075,250073,291658388,3764108,474773687,27,210663,241279825,210571,241268423,92,11402,201231,6,250074,23244,24,153,130000.0,43333.0,-69.0,-66.0,-71.0,-68.0,-69.0,-66.0,-70.0,-68.0,-88.0,-90.0,-87.0,-86.0,19.0,24.0,16.0,18.0,1
2434,CC:2F:71:3E:C5:1F,3764216,474786866,108,13179,3764108,474773687,0,425,36379,344,26635,81,9744,116,2,143,4,0,5,144444.0,39000.0,-66.0,-65.0,-65.0,-60.0,-69.0,-69.0,-65.0,-60.0,-88.0,-90.0,-87.0,-86.0,22.0,25.0,22.0,26.0,1
2435,BA:8C:B9:54:50:24,3764415,474864125,307,90438,3764108,474773687,0,1289,143131,1271,140285,18,2846,200,5,429,7,0,8,216660.0,130000.0,-40.0,-37.0,-45.0,-50.0,-43.0,-36.0,-44.0,-48.0,-88.0,-90.0,-87.0,-86.0,48.0,53.0,42.0,36.0,1
2436,92:69:1D:31:68:E9,3776936,490037604,12828,15263917,3764108,474773687,3,19371,3598124,18669,3436622,702,161502,6477,105,14092,252,3,252,216660.0,130000.0,-51.0,-49.0,-43.0,-45.0,-51.0,-48.0,-43.0,-46.0,-88.0,-90.0,-87.0,-86.0,37.0,41.0,44.0,41.0,1
2437,CC:2F:71:3F:1F:24,4014301,766554276,250185,291779781,3764116,474774495,27,210766,241397769,210674,241386367,92,11402,201326,6,250186,23249,24,153,130000.0,43333.0,-69.0,-67.0,-71.0,-68.0,-71.0,-69.0,-73.0,-70.0,-88.0,-90.0,-87.0,-86.0,19.0,23.0,16.0,18.0,1
2438,CC:2F:71:3E:C5:1F,3764224,474787674,108,13179,3764116,474774495,0,425,36379,344,26635,81,9744,116,2,143,4,0,5,144444.0,39000.0,-66.0,-65.0,-65.0,-60.0,-69.0,-69.0,-65.0,-60.0,-88.0,-90.0,-87.0,-86.0,22.0,25.0,22.0,26.0,1
2439,BA:8C:B9:54:50:24,3764424,474864993,307,90438,3764117,474774555,0,1289,143131,1271,140285,18,2846,200,5,429,7,0,8,216660.0,130000.0,-40.0,-37.0,-45.0,-50.0,-43.0,-36.0,-44.0,-48.0,-88.0,-90.0,-87.0,-86.0,48.0,53.0,42.0,36.0,1
2440,92:69:1D:31:68:E9,3776945,490038472,12828,15263917,3764117,474774555,3,19371,3598124,18669,3436622,702,161502,6477,105,14092,252,3,252,216660.0,130000.0,-51.0,-49.0,-43.0,-45.0,-51.0,-48.0,-43.0,-46.0,-88.0,-90.0,-87.0,-86.0,37.0,41.0,44.0,41.0,1
2441,CC:2F:71:3F:1F:24,4014407,766672482,250290,291897927,3764117,474774555,27,210865,241516635,210773,241505233,92,11402,201414,6,250291,23249,24,153,130000.0,43333.0,-70.0,-67.0,-71.0,-68.0,-71.0,-69.0,-72.0,-70.0,-88.0,-90.0,-87.0,-86.0,18.0,23.0,16.0,18.0,1
2442,CC:2F:71:3E:C5:1F,3764225,474787734,108,13179,3764117,474774555,0,425,36379,344,26635,81,9744,116,2,143,4,0,5,144444.0,39000.0,-66.0,-65.0,-65.0,-60.0,-69.0,-69.0,-65.0,-60.0,-88.0,-90.0,-87.0,-86.0,22.0,25.0,22.0,26.0,1
2443,BA:8C:B9:54:50:24,3764424,474864993,307,90438,3764117,474774555,0,1289,143131,1271,140285,18,2846,200,5,429,7,0,8,216660.0,130000.0,-40.0,-37.0,-45.0,-50.0,-43.0,-36.0,-44.0,-48.0,-88.0,-90.0,-87.0,-86.0,48.0,53.0,42.0,36.0,1
2444,92:69:1D:31:68:E9,3776945,490038472,12828,15263917,3764117,474774555,3,19371,3598124,18669,3436622,702,161502,6477,105,14092,252,3,252,216660.0,130000.0,-51.0,-49.0,-43.0,-45.0,-51.0,-48.0,-43.0,-46.0,-88.0,-90.0,-87.0,-86.0,37.0,41.0,44.0,41.0,1
2445,CC:2F:71:3F:1F:24,4014521,766792990,250396,292017627,3764125,474775363,27,210966,241636887,210874,241625485,92,11402,201503,6,250397,23249,24,153,130000.0,43333.0,-69.0,-66.0,-70.0,-68.0,-69.0,-66.0,-70.0,-68.0,-88.0,-90.0,-87.0,-86.0,19.0,24.0,17.0,18.0,1
2446,CC:2F:71:3E:C5:1F,3764233,474788542,108,13179,3764125,474775363,0,425,36379,344,26635,81,9744,116,2,143,4,0,5,144444.0,39000.0,-66.0,-65.0,-65.0,-60.0,-69.0,-69.0,-65.0,-60.0,-88.0,-90.0,-87.0,-86.0,22.0,25.0,22.0,26.0,1
2447,BA:8C:B9:54:50:24,3764432,474865801,307,90438,3764125,474775363,0,1289,143131,1271,140285,18,2846,200,5,429,7,0,8,216660.0,130000.0,-40.0,-37.0,-45.0,-50.0,-43.0,-36.0,-44.0,-48.0,-88.0,-90.0,-86.0,-87.0,48.0,53.0,41.0,37.0,1
2448,92:69:1D:31:68:E9,3776953,490039280,12828,15263917,3764125,474775363,3,19371,3598124,18669,3436622,702,161502,6477,105,14092,252,3,252,216660.0,130000.0,-51.0,-49.0,-43.0,-45.0,-51.0,-48.0,-43.0,-46.0,-88.0,-90.0,-86.0,-87.0,37.0,41.0,43.0,42.0,1
2449,CC:2F:71:3F:1F:24,4014630,766912786,250504,292137363,3764126,474775423,27,211056,241746955,210964,241735553,92,11402,201591,6,250505,23254,24,153,130000.0,43333.0,-68.0,-67.0,-70.0,-68.0,-68.0,-67.0,-70.0,-67.0,-88.0,-90.0,-86.0,-87.0,20.0,23.0,16.0,19.0,1
2450,CC:2F:71:3E:C5:1F,3764234,474788602,108,13179,3764126,474775423,0,425,36379,344,26635,81,9744,116,2,143,4,0,5,144444.0,39000.0,-66.0,-65.0,-65.0,-60.0,-69.0,-69.0,-65.0,-60.0,-88.0,-90.0,-86.0,-87.0,22.0,25.0,21.0,27.0,1
2451,BA:8C:B9:54:50:24,3764433,474865861,307,90438,3764126,474775423,0,1289,143131,1271,140285,18,2846,200,5,429,7,0,8,216660.0,130000.0,-40.0,-37.0,-45.0,-50.0,-43.0,-36.0,-44.0,-48.0,-88.0,-90.0,-86.0,-87.0,48.0,53.0,41.0,37.0,1
2452,92:69:1D:31:68:E9,3776954,490039340,12828,15263917,3764126,474775423,3,19371,3598124,18669,3436622,702,161502,6477,105,14092,252,3,252,216660.0,130000.0,-51.0,-49.0,-43.0,-45.0,-51.0,-48.0,-43.0,-46.0,-88.0,-90.0,-86.0,-87.0,37.0,41.0,43.0,42.0,1
2453,CC:2F:71:3F:1F:24,4014750,767035255,250618,292259226,3764132,474776029,27,211153,241856926,211061,241845524,92,11402,201687,6,250619,23254,24,153,130000.0,43333.0,-69.0,-66.0,-70.0,-67.0,-68.0,-66.0,-69.0,-67.0,-88.0,-90.0,-87.0,-87.0,19.0,24.0,17.0,20.0,1
2454,CC:2F:71:3E:C5:1F,3764242,474789410,108,13179,3764134,474776231,0,425,36379,344,26635,81,9744,116,2,143,4,0,5,144444.0,39000.0,-66.0,-65.0,-65.0,-60.0,-69.0,-69.0,-65.0,-60.0,-88.0,-90.0,-87.0,-87.0,22.0,25.0,22.0,27.0,1
2455,BA:8C:B9:54:50:24,3764441,474866669,307,90438,3764134,474776231,0,1289,143131,1271,140285,18,2846,200,5,429,7,0,8,216660.0,130000.0,-40.0,-37.0,-45.0,-50.0,-43.0,-36.0,-44.0,-48.0,-88.0,-90.0,-87.0,-87.0,48.0,53.0,42.0,37.0,1
2456,92:69:1D:31:68:E9,3776962,490040148,12828,15263917,3764134,474776231,3,19371,3598124,18669,3436622,702,161502,6477,105,14092,252,3,252,216660.0,130000.0,-51.0,-49.0,-43.0,-45.0,-51.0,-48.0,-43.0,-46.0,-88.0,-90.0,-87.0,-87.0,37.0,41.0,44.0,42.0,1
2457,CC:2F:71:3F:1F:24,4014860,767155112,250725,292378608,3764135,474776504,27,211247,241969006,211155,241957604,92,11402,201777,6,250726,23273,24,153,130000.0,43333.0,-68.0,-66.0,-70.0,-69.0,-68.0,-66.0,-70.0,-69.0,-88.0,-90.0,-87.0,-87.0,20.0,24.0,17.0,18.0,1
2458,CC:2F:71:3E:C5:1F,3764243,474789683,108,13179,3764135,474776504,0,425,36379,344,26635,81,9744,116,2,143,4,0,5,144444.0,39000.0,-66.0,-65.0,-65.0,-60.0,-69.0,-69.0,-65.0,-60.0,-88.0,-90.0,-87.0,-87.0,22.0,25.0,22.0,27.0,1
2459,BA:8C:B9:54:50:24,3764442,474866942,307,90438,3764135,474776504,0,1289,143131,1271,140285,18,2846,200,5,429,7,0,8,216660.0,130000.0,-40.0,-37.0,-45.0,-50.0,-43.0,-36.0,-44.0,-48.0,-88.0,-90.0,-87.0,-87.0,48.0,53.0,42.0,37.0,1
2460,92:69:1D:31:68:E9,3776963,490040421,12828,15263917,3764135,474776504,3,19371,3598124,18669,3436622,702,161502,6477,105,14092,252,3,252,216660.0,130000.0,-51.0,-49.0,-43.0,-45.0,-51.0,-48.0,-43.0,-46.0,-88.0,-90.0,-87.0,-87.0,37.0,41.0,44.0,42.0,1
2461,CC:2F:71:3F:1F:24,4014973,767274054,250831,292496884,3764142,474777170,27,211340,242079422,211248,242068020,92,11402,201868,6,250832,23274,24,153,130000.0,43333.0,-70.0,-66.0,-72.0,-70.0,-69.0,-66.0,-72.0,-69.0,-88.0,-90.0,-87.0,-87.0,18.0,24.0,15.0,17.0,1
2462,CC:2F:71:3E:C5:1F,3764250,474790349,108,13179,3764142,474777170,0,425,36379,344,26635,81,9744,116,2,143,4,0,5,144444.0,39000.0,-66.0,-65.0,-65.0,-60.0,-69.0,-69.0,-65.0,-60.0,-88.0,-90.0,-87.0,-87.0,22.0,25.0,22.0,27.0,1
2463,BA:8C:B9:54:50:24,3764449,474867608,307,90438,3764142,474777170,0,1289,143131,1271,140285,18,2846,200,5,429,7,0,8,216660.0,130000.0,-40.0,-37.0,-45.0,-50.0,-43.0,-36.0,-44.0,-48.0,-88.0,-90.0,-87.0,-87.0,48.0,53.0,42.0,37.0,1
2464,92:69:1D:31:68:E9,3776972,490041289,12828,15263917,3764144,474777372,3,19371,3598124,18669,3436622,702,161502,6477,105,14092,252,3,252,216660.0,130000.0,-51.0,-49.0,-43.0,-45.0,-51.0,-48.0,-43.0,-46.0,-88.0,-90.0,-87.0,-87.0,37.0,41.0,44.0,42.0,1
2465,CC:2F:71:3F:1F:24,4015083,767395304,250939,292617932,3764144,474777372,27,211435,242193008,211343,242181606,92,11402,201958,6,250940,23282,24,153,144444.0,39000.0,-69.0,-66.0,-72.0,-68.0,-68.0,-66.0,-70.0,-68.0,-88.0,-90.0,-87.0,-87.0,19.0,24.0,15.0,19.0,1
2466,CC:2F:71:3E:C5:1F,3764252,474790551,108,13179,3764144,474777372,0,425,36379,344,26635,81,9744,116,2,143,4,0,5,144444.0,39000.0,-66.0,-65.0,-65.0,-60.0,-69.0,-69.0,-65.0,-60.0,-88.0,-90.0,-87.0,-87.0,22.0,25.0,22.0,27.0,1
2467,BA:8C:B9:54:50:24,3764451,474867810,307,90438,3764144,474777372,0,1289,143131,1271,140285,18,2846,200,5,429,7,0,8,216660.0,130000.0,-40.0,-37.0,-45.0,-50.0,-43.0,-36.0,-44.0,-48.0,-88.0,-90.0,-87.0,-87.0,48.0,53.0,42.0,37.0,1
2468,92:69:1D:31:68:E9,3776972,490041289,12828,15263917,3764144,474777372,3,19371,3598124,18669,3436622,702,161502,6477,105,14092,252,3,252,216660.0,130000.0,-51.0,-49.0,-43.0,-45.0,-51.0,-48.0,-43.0,-46.0,-88.0,-90.0,-87.0,-87.0,37.0,41.0,44.0,42.0,1
2469,CC:2F:71:3F:1F:24,4015204,767518386,251054,292740408,3764150,474777978,27,211536,242305059,211444,242293657,92,11402,202057,6,251055,23292,24,153,130000.0,43333.0,-71.0,-67.0,-71.0,-70.0,-71.0,-66.0,-70.0,-70.0,-88.0,-90.0,-87.0,-87.0,17.0,23.0,16.0,17.0,1
2470,CC:2F:71:3E:C5:1F,3764258,474791157,108,13179,3764150,474777978,0,425,36379,344,26635,81,9744,116,2,143,4,0,5,144444.0,39000.0,-66.0,-65.0,-65.0,-60.0,-69.0,-69.0,-65.0,-60.0,-88.0,-90.0,-87.0,-87.0,22.0,25.0,22.0,27.0,1
2471,BA:8C:B9:54:50:24,3764458,474868476,307,90438,3764151,474778038,0,1289,143131,1271,140285,18,2846,200,5,429,7,0,8,216660.0,130000.0,-40.0,-37.0,-45.0,-50.0,-43.0,-36.0,-44.0,-48.0,-88.0,-90.0,-87.0,-87.0,48.0,53.0,42.0,37.0,1
2472,92:69:1D:31:68:E9,3776979,490041955,12828,15263917,3764151,474778038,3,19371,3598124,18669,3436622,702,161502,6477,105,14092,252,3,252,216660.0,130000.0,-51.0,-49.0,-43.0,-45.0,-51.0,-48.0,-43.0,-46.0,-88.0,-90.0,-87.0,-87.0,37.0,41.0,44.0,42.0,1
2473,CC:2F:71:3F:1F:24,4015314,767638366,251161,292860126,3764153,474778240,27,211625,242413559,211533,242402157,92,11402,202146,6,251162,23298,24,153,117000.0,39000.0,-74.0,-71.0,-72.0,-72.0,-71.0,-68.0,-70.0,-70.0,-88.0,-90.0,-87.0,-87.0,14.0,19.0,15.0,15.0,1
2474,CC:2F:71:3E:C5:1F,3764261,474791419,108,13179,3764153,474778240,0,425,36379,344,26635,81,9744,116,2,143,4,0,5,144444.0,39000.0,-66.0,-65.0,-65.0,-60.0,-69.0,-69.0,-65.0,-60.0,-88.0,-90.0,-87.0,-87.0,22.0,25.0,22.0,27.0,1
2475,BA:8C:B9:54:50:24,3764460,474868678,307,90438,3764153,474778240,0,1289,143131,1271,140285,18,2846,200,5,429,7,0,8,216660.0,130000.0,-40.0,-37.0,-45.0,-50.0,-43.0,-36.0,-44.0,-48.0,-88.0,-90.0,-87.0,-87.0,48.0,53.0,42.0,37.0,1
2476,92:69:1D:31:68:E9,3776981,490042157,12828,15263917,3764153,474778240,3,19371,3598124,18669,3436622,702,161502,6477,105,14092,252,3,252,216660.0,130000.0,-51.0,-49.0,-43.0,-45.0,-51.0,-48.0,-43.0,-46.0,-88.0,-90.0,-87.0,-87.0,37.0,41.0,44.0,42.0,1
2477,CC:2F:71:3F:1F:24,4016020,768528338,251862,293749560,3764158,474778778,27,211953,242563017,211861,242551615,92,11402,202470,6,251863,23298,24,153,130000.0,43333.0,-71.0,-69.0,-69.0,-70.0,-71.0,-68.0,-69.0,-70.0,-88.0,-90.0,-87.0,-87.0,17.0,21.0,18.0,17.0,1
2478,CC:2F:71:3E:C5:1F,3764267,474792025,108,13179,3764159,474778846,0,425,36379,344,26635,81,9744,116,2,143,4,0,5,144444.0,39000.0,-66.0,-65.0,-65.0,-60.0,-69.0,-69.0,-65.0,-60.0,-88.0,-90.0,-87.0,-87.0,22.0,25.0,22.0,27.0,1
2479,BA:8C:B9:54:50:24,3764466,474869284,307,90438,3764159,474778846,0,1289,143131,1271,140285,18,2846,200,5,429,7,0,8,216660.0,130000.0,-40.0,-37.0,-45.0,-50.0,-43.0,-36.0,-44.0,-48.0,-88.0,-90.0,-87.0,-87.0,48.0,53.0,42.0,37.0,1
2480,92:69:1D:31:68:E9,3776987,490042763,12828,15263917,3764159,474778846,3,19371,3598124,18669,3436622,702,161502,6477,105,14092,252,3,252,216660.0,130000.0,-51.0,-49.0,-43.0,-45.0,-51.0,-48.0,-43.0,-46.0,-88.0,-90.0,-87.0,-87.0,37.0,41.0,44.0,42.0,1
2481,CC:2F:71:3F:1F:24,4016184,768690639,252022,293911531,3764162,474779108,27,212083,242679339,211991,242667937,92,11402,202598,6,252023,23299,24,153,130000.0,43333.0,-73.0,-69.0,-68.0,-69.0,-73.0,-68.0,-67.0,-69.0,-88.0,-90.0,-87.0,-87.0,15.0,21.0,19.0,18.0,1
2482,CC:2F:71:3E:C5:1F,3764270,474792287,108,13179,3764162,474779108,0,425,36379,344,26635,81,9744,116,2,143,4,0,5,144444.0,39000.0,-66.0,-65.0,-65.0,-60.0,-69.0,-69.0,-65.0,-60.0,-88.0,-90.0,-87.0,-87.0,22.0,25.0,22.0,27.0,1
2483,BA:8C:B9:54:50:24,3764469,474869546,307,90438,3764162,474779108,0,1289,143131,1271,140285,18,2846,200,5,429,7,0,8,216660.0,130000.0,-40.0,-37.0,-45.0,-50.0,-43.0,-36.0,-44.0,-48.0,-88.0,-90.0,-87.0,-87.0,48.0,53.0,42.0,37.0,1
2484,92:69:1D:31:68:E9,3776990,490043025,12828,15263917,3764162,474779108,3,19371,3598124,18669,3436622,702,161502,6477,105,14092,252,3,252,216660.0,130000.0,-51.0,-49.0,-43.0,-45.0,-51.0,-48.0,-43.0,-46.0,-88.0,-90.0,-87.0,-87.0,37.0,41.0,44.0,42.0,1
2485,CC:2F:71:3F:1F:24,4016294,768809137,252128,294029625,3764166,474779512,27,212175,242792595,212083,242781193,92,11402,202686,6,252129,23300,24,153,144444.0,43333.0,-70.0,-68.0,-68.0,-68.0,-71.0,-68.0,-67.0,-68.0,-88.0,-90.0,-87.0,-87.0,18.0,22.0,19.0,19.0,1
2486,CC:2F:71:3E:C5:1F,3764277,474793009,109,13295,3764168,474779714,0,427,36519,346,26775,81,9744,116,2,144,4,0,5,144444.0,39000.0,-72.0,-71.0,-66.0,-60.0,-69.0,-69.0,-65.0,-60.0,-88.0,-90.0,-87.0,-87.0,16.0,19.0,21.0,27.0,1
2487,BA:8C:B9:54:50:24,3764476,474870212,308,90498,3764168,474779714,0,1291,143267,1273,140421,18,2846,200,5,430,7,0,8,216660.0,130000.0,-40.0,-37.0,-46.0,-51.0,-42.0,-36.0,-44.0,-49.0,-88.0,-90.0,-87.0,-87.0,48.0,53.0,41.0,36.0,1
2488,92:69:1D:31:68:E9,3776997,490043747,12829,15264033,3764168,474779714,3,19373,3598260,18671,3436758,702,161502,6477,105,14093,252,3,252,216660.0,130000.0,-51.0,-47.0,-41.0,-47.0,-51.0,-48.0,-43.0,-46.0,-88.0,-90.0,-87.0,-87.0,37.0,43.0,46.0,40.0,1
2489,CC:2F:71:3F:1F:24,4016405,768929371,252235,294149455,3764170,474779916,27,212266,242904203,212174,242892801,92,11402,202775,6,252236,23300,24,153,144444.0,43333.0,-71.0,-68.0,-68.0,-68.0,-71.0,-68.0,-68.0,-68.0,-88.0,-90.0,-87.0,-87.0,17.0,22.0,19.0,19.0,1
2490,CC:2F:71:3E:C5:1F,3764279,474793211,109,13295,3764170,474779916,0,427,36519,346,26775,81,9744,116,2,144,4,0,5,144444.0,39000.0,-72.0,-71.0,-66.0,-60.0,-69.0,-69.0,-65.0,-60.0,-88.0,-90.0,-87.0,-87.0,16.0,19.0,21.0,27.0,1
2491,BA:8C:B9:54:50:24,3764478,474870414,308,90498,3764170,474779916,0,1291,143267,1273,140421,18,2846,200,5,430,7,0,8,216660.0,130000.0,-40.0,-37.0,-46.0,-51.0,-42.0,-36.0,-44.0,-49.0,-88.0,-90.0,-87.0,-87.0,48.0,53.0,41.0,36.0,1
2492,92:69:1D:31:68:E9,3776999,490043949,12829,15264033,3764170,474779916,3,19373,3598260,18671,3436758,702,161502,6477,105,14093,252,3,252,216660.0,130000.0,-51.0,-47.0,-41.0,-47.0,-51.0,-48.0,-43.0,-46.0,-88.0,-90.0,-87.0,-87.0,37.0,43.0,46.0,40.0,1
2493,CC:2F:71:3F:1F:24,4016517,769048173,252341,294267731,3764176,474780442,27,212355,243014155,212263,243002753,92,11402,202862,6,252342,23300,24,153,144444.0,43333.0,-71.0,-68.0,-68.0,-69.0,-71.0,-68.0,-68.0,-68.0,-88.0,-90.0,-87.0,-87.0,17.0,22.0,19.0,18.0,1
2494,CC:2F:71:3E:C5:1F,3764285,474793737,109,13295,3764176,474780442,0,429,36707,347,26845,82,9862,117,2,144,4,0,5,144444.0,39000.0,-71.0,-71.0,-66.0,-60.0,-70.0,-69.0,-65.0,-59.0,-88.0,-90.0,-87.0,-87.0,17.0,19.0,21.0,27.0,1
2495,BA:8C:B9:54:50:24,3764484,474870940,308,90498,3764176,474780442,0,1292,143335,1274,140489,18,2846,200,5,430,7,0,8,216660.0,130000.0,-40.0,-37.0,-46.0,-51.0,-41.0,-36.0,-45.0,-50.0,-88.0,-90.0,-87.0,-87.0,48.0,53.0,41.0,36.0,1
2496,92:69:1D:31:68:E9,3777007,490044677,12829,15264033,3764178,474780644,3,19373,3598260,18671,3436758,702,161502,6477,105,14093,252,3,252,216660.0,130000.0,-51.0,-47.0,-41.0,-47.0,-51.0,-48.0,-43.0,-46.0,-88.0,-90.0,-87.0,-87.0,37.0,43.0,46.0,40.0,1
2497,CC:2F:71:3F:1F:24,4016634,769171748,252454,294390902,3764180,474780846,27,212454,243127314,212362,243115912,92,11402,202957,6,252455,23304,24,153,144444.0,43333.0,-78.0,-74.0,-75.0,-75.0,-75.0,-71.0,-72.0,-72.0,-88.0,-90.0,-87.0,-87.0,10.0,16.0,12.0,12.0,1
2498,CC:2F:71:3E:C5:1F,3764289,474794141,109,13295,3764180,474780846,0,429,36707,347,26845,82,9862,117,2,144,4,0,5,144444.0,39000.0,-71.0,-71.0,-66.0,-60.0,-70.0,-69.0,-65.0,-59.0,-88.0,-90.0,-87.0,-87.0,17.0,19.0,21.0,27.0,1
2499,BA:8C:B9:54:50:24,3764488,474871344,308,90498,3764180,474780846,0,1292,143335,1274,140489,18,2846,200,5,430,7,0,8,216660.0,130000.0,-40.0,-37.0,-46.0,-51.0,-41.0,-36.0,-45.0,-50.0,-88.0,-90.0,-87.0,-87.0,48.0,53.0,41.0,36.0,1
2500,92:69:1D:31:68:E9,3777009,490044879,12829,15264033,3764180,474780846,3,19373,3598260,18671,3436758,702,161502,6477,105,14093,252,3,252,216660.0,130000.0,-51.0,-47.0,-41.0,-47.0,-51.0,-48.0,-43.0,-46.0,-88.0,-90.0,-87.0,-87.0,37.0,43.0,46.0,40.0,1
2501,CC:2F:71:3F:1F:24,4016743,769291722,252559,294510472,3764184,474781250,27,212544,243238806,212452,243227404,92,11402,203045,6,252560,23311,24,153,144444.0,43333.0,-72.0,-68.0,-69.0,-69.0,-71.0,-68.0,-69.0,-69.0,-88.0,-91.0,-87.0,-87.0,16.0,23.0,18.0,18.0,1
2502,CC:2F:71:3E:C5:1F,3764294,474794605,109,13295,3764185,474781310,0,429,36707,347,26845,82,9862,117,2,144,4,0,5,144444.0,39000.0,-71.0,-71.0,-66.0,-60.0,-70.0,-69.0,-65.0,-59.0,-88.0,-91.0,-87.0,-87.0,17.0,20.0,21.0,27.0,1
2503,BA:8C:B9:54:50:24,3764493,474871808,308,90498,3764185,474781310,0,1292,143335,1274,140489,18,2846,200,5,430,7,0,8,216660.0,130000.0,-40.0,-37.0,-46.0,-51.0,-41.0,-36.0,-45.0,-50.0,-88.0,-91.0,-87.0,-87.0,48.0,54.0,41.0,36.0,1
2504,92:69:1D:31:68:E9,3777014,490045343,12829,15264033,3764185,474781310,3,19373,3598260,18671,3436758,702,161502,6477,105,14093,252,3,252,216660.0,130000.0,-51.0,-47.0,-41.0,-47.0,-51.0,-48.0,-43.0,-46.0,-88.0,-91.0,-87.0,-87.0,37.0,44.0,46.0,40.0,1
2505,CC:2F:71:3F:1F:24,4017049,769657761,252860,294876047,3764189,474781714,27,212731,243369963,212639,243358561,92,11402,203225,6,252861,23440,24,153,130000.0,43333.0,-71.0,-68.0,-69.0,-68.0,-71.0,-68.0,-69.0,-68.0,-88.0,-91.0,-87.0,-87.0,17.0,23.0,18.0,19.0,1
2506,CC:2F:71:3E:C5:1F,3764298,474795009,109,13295,3764189,474781714,0,429,36707,347,26845,82,9862,117,2,144,4,0,5,144444.0,39000.0,-71.0,-71.0,-66.0,-60.0,-70.0,-69.0,-65.0,-59.0,-88.0,-91.0,-87.0,-87.0,17.0,20.0,21.0,27.0,1
2507,BA:8C:B9:54:50:24,3764497,474872212,308,90498,3764189,474781714,0,1292,143335,1274,140489,18,2846,200,5,430,7,0,8,216660.0,130000.0,-40.0,-37.0,-46.0,-51.0,-41.0,-36.0,-45.0,-50.0,-88.0,-91.0,-87.0,-87.0,48.0,54.0,41.0,36.0,1
2508,92:69:1D:31:68:E9,3777018,490045747,12829,15264033,3764189,474781714,3,19373,3598260,18671,3436758,702,161502,6477,105,14093,252,3,252,216660.0,130000.0,-51.0,-47.0,-41.0,-47.0,-51.0,-48.0,-43.0,-46.0,-88.0,-91.0,-87.0,-87.0,37.0,44.0,46.0,40.0,1
2509,CC:2F:71:3F:1F:24,4017367,770028474,253172,295246021,3764195,474782453,27,212917,243491465,212824,243479945,93,11520,203411,6,253173,23457,24,154,130000.0,43333.0,-70.0,-67.0,-70.0,-69.0,-70.0,-67.0,-70.0,-69.0,-88.0,-91.0,-87.0,-87.0,18.0,24.0,17.0,18.0,1
2510,CC:2F:71:3E:C5:1F,3764304,474795748,109,13295,3764195,474782453,0,429,36707,347,26845,82,9862,117,2,144,4,0,5,144444.0,39000.0,-71.0,-71.0,-66.0,-60.0,-70.0,-69.0,-65.0,-59.0,-88.0,-91.0,-87.0,-87.0,17.0,20.0,21.0,27.0,1
2511,BA:8C:B9:54:50:24,3764503,474872951,308,90498,3764195,474782453,0,1296,143607,1278,140761,18,2846,200,5,430,7,0,8,216660.0,130000.0,-40.0,-37.0,-46.0,-52.0,-40.0,-37.0,-45.0,-51.0,-89.0,-91.0,-87.0,-88.0,49.0,54.0,41.0,36.0,1
2512,92:69:1D:31:68:E9,3777024,490046486,12829,15264033,3764195,474782453,3,19373,3598260,18671,3436758,702,161502,6477,105,14093,252,3,252,216660.0,130000.0,-51.0,-47.0,-41.0,-47.0,-51.0,-48.0,-43.0,-46.0,-89.0,-91.0,-87.0,-88.0,38.0,44.0,46.0,41.0,1
2513,CC:2F:71:3F:1F:24,4017864,770635475,253664,295852558,3764200,474782917,27,213174,243624036,213081,243612516,93,11520,203667,6,253665,23457,24,154,144444.0,43333.0,-71.0,-68.0,-70.0,-69.0,-70.0,-68.0,-70.0,-69.0,-89.0,-91.0,-87.0,-88.0,18.0,23.0,17.0,19.0,1
2514,CC:2F:71:3E:C5:1F,3764309,474796212,109,13295,3764200,474782917,0,429,36707,347,26845,82,9862,117,2,144,4,0,5,144444.0,39000.0,-71.0,-71.0,-66.0,-60.0,-70.0,-69.0,-65.0,-59.0,-89.0,-91.0,-87.0,-88.0,18.0,20.0,21.0,28.0,1
2515,BA:8C:B9:54:50:24,3764508,474873415,308,90498,3764200,474782917,0,1296,143607,1278,140761,18,2846,200,5,430,7,0,8,216660.0,130000.0,-40.0,-37.0,-46.0,-52.0,-40.0,-37.0,-45.0,-51.0,-89.0,-91.0,-87.0,-88.0,49.0,54.0,41.0,36.0,1
2516,92:69:1D:31:68:E9,3777029,490046950,12829,15264033,3764200,474782917,3,19373,3598260,18671,3436758,702,161502,6477,105,14093,252,3,252,216660.0,130000.0,-51.0,-47.0,-41.0,-47.0,-51.0,-48.0,-43.0,-46.0,-89.0,-91.0,-87.0,-88.0,38.0,44.0,46.0,41.0,1
2517,CC:2F:71:3F:1F:24,4018166,770999696,253962,296216375,3764204,474783321,27,213345,243743112,213252,243731592,93,11520,203835,6,253963,23457,24,154,144444.0,43333.0,-71.0,-67.0,-71.0,-71.0,-71.0,-67.0,-71.0,-70.0,-89.0,-91.0,-87.0,-88.0,18.0,24.0,16.0,17.0,1
2518,CC:2F:71:3E:C5:1F,3764313,474796616,109,13295,3764204,474783321,0,429,36707,347,26845,82,9862,117,2,144,4,0,5,144444.0,39000.0,-71.0,-71.0,-66.0,-60.0,-70.0,-69.0,-65.0,-59.0,-89.0,-91.0,-87.0,-88.0,18.0,20.0,21.0,28.0,1
2519,BA:8C:B9:54:50:24,3764512,474873819,308,90498,3764204,474783321,0,1296,143607,1278,140761,18,2846,200,5,430,7,0,8,216660.0,130000.0,-40.0,-37.0,-46.0,-52.0,-40.0,-37.0,-45.0,-51.0,-89.0,-91.0,-87.0,-88.0,49.0,54.0,41.0,36.0,1
2520,92:69:1D:31:68:E9,3777033,490047354,12829,15264033,3764204,474783321,3,19373,3598260,18671,3436758,702,161502,6477,105,14093,252,3,252,216660.0,130000.0,-51.0,-47.0,-41.0,-47.0,-51.0,-48.0,-43.0,-46.0,-89.0,-91.0,-87.0,-88.0,38.0,44.0,46.0,41.0,1
2521,CC:2F:71:3F:1F:24,4018275,771118246,254067,296334521,3764208,474783725,27,213435,243853208,213342,243841688,93,11520,203921,6,254068,23458,24,154,144444.0,43333.0,-72.0,-68.0,-72.0,-71.0,-71.0,-67.0,-71.0,-71.0,-89.0,-91.0,-87.0,-89.0,17.0,23.0,15.0,18.0,1
2522,CC:2F:71:3E:C5:1F,3764317,474797020,109,13295,3764208,474783725,0,429,36707,347,26845,82,9862,117,2,144,4,0,5,144444.0,39000.0,-71.0,-71.0,-66.0,-60.0,-70.0,-69.0,-65.0,-59.0,-89.0,-91.0,-87.0,-89.0,18.0,20.0,21.0,29.0,1
2523,BA:8C:B9:54:50:24,3764516,474874223,308,90498,3764208,474783725,0,1299,143811,1281,140965,18,2846,200,5,430,7,0,8,216660.0,130000.0,-40.0,-37.0,-46.0,-51.0,-40.0,-37.0,-45.0,-51.0,-89.0,-91.0,-87.0,-89.0,49.0,54.0,41.0,38.0,1
2524,92:69:1D:31:68:E9,3777037,490047758,12829,15264033,3764208,474783725,3,19373,3598260,18671,3436758,702,161502,6477,105,14093,252,3,252,216660.0,130000.0,-51.0,-47.0,-41.0,-47.0,-51.0,-48.0,-43.0,-46.0,-89.0,-91.0,-87.0,-89.0,38.0,44.0,46.0,42.0,1
2525,CC:2F:71:3F:1F:24,4018383,771235230,254172,296451243,3764211,474783987,27,213530,243969516,213437,243957996,93,11520,204008,6,254173,23458,24,154,144444.0,43333.0,-71.0,-67.0,-71.0,-71.0,-71.0,-67.0,-70.0,-70.0,-89.0,-91.0,-87.0,-89.0,18.0,24.0,16.0,18.0,1
2526,CC:2F:71:3E:C5:1F,3764322,474797484,109,13295,3764213,474784189,0,429,36707,347,26845,82,9862,117,2,144,4,0,5,144444.0,39000.0,-71.0,-71.0,-66.0,-60.0,-70.0,-69.0,-65.0,-59.0,-89.0,-91.0,-87.0,-89.0,18.0,20.0,21.0,29.0,1
2527,BA:8C:B9:54:50:24,3764521,474874687,308,90498,3764213,474784189,0,1301,143947,1283,141101,18,2846,200,5,430,7,0,8,216660.0,130000.0,-48.0,-35.0,-43.0,-45.0,-41.0,-36.0,-45.0,-50.0,-89.0,-91.0,-87.0,-89.0,41.0,56.0,44.0,44.0,1
2528,92:69:1D:31:68:E9,3777042,490048222,12829,15264033,3764213,474784189,3,19373,3598260,18671,3436758,702,161502,6477,105,14093,252,3,252,216660.0,130000.0,-51.0,-47.0,-41.0,-47.0,-51.0,-48.0,-43.0,-46.0,-89.0,-91.0,-87.0,-89.0,38.0,44.0,46.0,42.0,1
2529,CC:2F:71:3F:1F:24,4018493,771353852,254276,296569259,3764217,474784593,27,213618,244076570,213525,244065050,93,11520,204095,6,254277,23458,24,154,144444.0,43333.0,-71.0,-67.0,-71.0,-71.0,-71.0,-67.0,-70.0,-71.0,-89.0,-91.0,-87.0,-89.0,18.0,24.0,16.0,18.0,1
2530,CC:2F:71:3E:C5:1F,3764326,474797888,109,13295,3764217,474784593,0,429,36707,347,26845,82,9862,117,2,144,4,0,5,144444.0,39000.0,-71.0,-71.0,-66.0,-60.0,-70.0,-69.0,-65.0,-59.0,-89.0,-91.0,-87.0,-89.0,18.0,20.0,21.0,29.0,1
2531,BA:8C:B9:54:50:24,3764525,474875091,308,90498,3764217,474784593,0,1301,143947,1283,141101,18,2846,200,5,430,7,0,8,216660.0,130000.0,-48.0,-35.0,-43.0,-45.0,-41.0,-36.0,-45.0,-50.0,-89.0,-91.0,-87.0,-89.0,41.0,56.0,44.0,44.0,1
2532,92:69:1D:31:68:E9,3777046,490048626,12829,15264033,3764217,474784593,3,19373,3598260,18671,3436758,702,161502,6477,105,14093,252,3,252,216660.0,130000.0,-51.0,-47.0,-41.0,-47.0,-51.0,-48.0,-43.0,-46.0,-89.0,-91.0,-87.0,-89.0,38.0,44.0,46.0,42.0,1
2533,CC:2F:71:3F:1F:24,4018609,771477355,254390,296692560,3764219,474784795,27,213714,244186483,213621,244174963,93,11520,204190,6,254391,23459,24,154,144444.0,43333.0,-72.0,-68.0,-71.0,-71.0,-71.0,-68.0,-71.0,-70.0,-89.0,-91.0,-88.0,-89.0,17.0,23.0,17.0,18.0,1
2534,CC:2F:71:3E:C5:1F,3764328,474798090,109,13295,3764219,474784795,0,429,36707,347,26845,82,9862,117,2,144,4,0,5,144444.0,39000.0,-71.0,-71.0,-66.0,-60.0,-70.0,-69.0,-65.0,-59.0,-89.0,-91.0,-88.0,-89.0,18.0,20.0,22.0,29.0,1
2535,BA:8C:B9:54:50:24,3764530,474875555,308,90498,3764222,474785057,0,1301,143947,1283,141101,18,2846,200,5,430,7,0,8,216660.0,130000.0,-48.0,-35.0,-43.0,-45.0,-41.0,-36.0,-45.0,-50.0,-89.0,-91.0,-88.0,-89.0,41.0,56.0,45.0,44.0,1
2536,92:69:1D:31:68:E9,3777051,490049090,12829,15264033,3764222,474785057,3,19373,3598260,18671,3436758,702,161502,6477,105,14093,252,3,252,216660.0,130000.0,-51.0,-47.0,-41.0,-47.0,-51.0,-48.0,-43.0,-46.0,-89.0,-91.0,-88.0,-89.0,38.0,44.0,47.0,42.0,1
2537,CC:2F:71:3F:1F:24,4018721,771596167,254495,296810706,3764226,474785461,27,213808,244301501,213715,244289981,93,11520,204277,6,254496,23460,24,154,144444.0,43333.0,-71.0,-68.0,-71.0,-71.0,-71.0,-68.0,-71.0,-71.0,-89.0,-91.0,-88.0,-89.0,18.0,23.0,17.0,18.0,1
2538,CC:2F:71:3E:C5:1F,3764335,474798756,109,13295,3764226,474785461,0,430,36777,348,26915,82,9862,117,2,145,4,0,5,144444.0,39000.0,-71.0,-71.0,-66.0,-60.0,-70.0,-70.0,-65.0,-59.0,-89.0,-91.0,-88.0,-89.0,18.0,20.0,22.0,29.0,1
2539,BA:8C:B9:54:50:24,3764534,474875959,308,90498,3764226,474785461,0,1301,143947,1283,141101,18,2846,200,5,430,7,0,8,216660.0,130000.0,-48.0,-35.0,-43.0,-45.0,-41.0,-36.0,-45.0,-50.0,-89.0,-91.0,-88.0,-89.0,41.0,56.0,45.0,44.0,1
2540,92:69:1D:31:68:E9,3777055,490049494,12829,15264033,3764226,474785461,3,19375,3598396,18673,3436894,702,161502,6477,105,14094,252,3,252,216660.0,130000.0,-51.0,-48.0,-42.0,-47.0,-51.0,-48.0,-43.0,-47.0,-89.0,-91.0,-88.0,-89.0,38.0,43.0,46.0,42.0,1
2541,CC:2F:71:3F:1F:24,4018829,771714615,254601,296928952,3764228,474785663,27,213903,244418001,213810,244406481,93,11520,204365,6,254602,23460,24,154,144444.0,43333.0,-72.0,-68.0,-71.0,-71.0,-71.0,-68.0,-71.0,-71.0,-89.0,-91.0,-88.0,-89.0,17.0,23.0,17.0,18.0,1
2542,CC:2F:71:3E:C5:1F,3764337,474798958,109,13295,3764228,474785663,0,431,36847,349,26985,82,9862,117,2,145,4,0,5,144444.0,39000.0,-71.0,-71.0,-67.0,-60.0,-70.0,-70.0,-66.0,-59.0,-89.0,-91.0,-88.0,-89.0,18.0,20.0,21.0,29.0,1
2543,BA:8C:B9:54:50:24,3764536,474876161,308,90498,3764228,474785663,0,1301,143947,1283,141101,18,2846,200,5,430,7,0,8,216660.0,130000.0,-48.0,-35.0,-43.0,-45.0,-41.0,-36.0,-45.0,-50.0,-89.0,-91.0,-88.0,-89.0,41.0,56.0,45.0,44.0,1
2544,92:69:1D:31:68:E9,3777059,490049898,12829,15264033,3764230,474785865,3,19375,3598396,18673,3436894,702,161502,6477,105,14094,252,3,252,216660.0,130000.0,-51.0,-48.0,-42.0,-47.0,-51.0,-48.0,-43.0,-47.0,-89.0,-91.0,-88.0,-89.0,38.0,43.0,46.0,42.0,1
2545,CC:2F:71:3F:1F:24,4018941,771832373,254706,297046044,3764235,474786329,27,213994,244526871,213901,244515351,93,11520,204452,6,254707,23461,24,154,144444.0,43333.0,-72.0,-67.0,-71.0,-71.0,-71.0,-67.0,-71.0,-71.0,-89.0,-91.0,-88.0,-89.0,17.0,24.0,17.0,18.0,1
2546,CC:2F:71:3E:C5:1F,3764344,474799624,109,13295,3764235,474786329,0,431,36847,349,26985,82,9862,117,2,145,4,0,5,144444.0,39000.0,-71.0,-71.0,-67.0,-60.0,-70.0,-70.0,-66.0,-59.0,-89.0,-91.0,-88.0,-89.0,18.0,20.0,21.0,29.0,1
2547,BA:8C:B9:54:50:24,3764543,474876827,308,90498,3764235,474786329,0,1301,143947,1283,141101,18,2846,200,5,430,7,0,8,216660.0,130000.0,-48.0,-35.0,-43.0,-45.0,-41.0,-36.0,-45.0,-50.0,-89.0,-91.0,-88.0,-89.0,41.0,56.0,45.0,44.0,1
2548,92:69:1D:31:68:E9,3777064,490050362,12829,15264033,3764235,474786329,3,19375,3598396,18673,3436894,702,161502,6477,105,14094,252,3,252,216660.0,130000.0,-51.0,-48.0,-42.0,-47.0,-51.0,-48.0,-43.0,-47.0,-89.0,-91.0,-88.0,-89.0,38.0,43.0,46.0,42.0,1
2549,CC:2F:71:3F:1F:24,4019055,771954250,254820,297167921,3764235,474786329,27,214092,244638642,213999,244627122,93,11520,204546,6,254821,23461,24,154,144444.0,43333.0,-72.0,-68.0,-72.0,-71.0,-71.0,-68.0,-71.0,-71.0,-89.0,-92.0,-88.0,-89.0,17.0,24.0,16.0,18.0,1
2550,CC:2F:71:3E:C5:1F,3764346,474799826,109,13295,3764237,474786531,0,431,36847,349,26985,82,9862,117,2,145,4,0,5,144444.0,39000.0,-71.0,-71.0,-67.0,-60.0,-70.0,-70.0,-66.0,-59.0,-89.0,-92.0,-88.0,-89.0,18.0,21.0,21.0,29.0,1
2551,BA:8C:B9:54:50:24,3764545,474877029,308,90498,3764237,474786531,0,1301,143947,1283,141101,18,2846,200,5,430,7,0,8,216660.0,130000.0,-48.0,-35.0,-43.0,-45.0,-41.0,-36.0,-45.0,-50.0,-89.0,-92.0,-88.0,-89.0,41.0,57.0,45.0,44.0,1
2552,92:69:1D:31:68:E9,3777068,490050766,12829,15264033,3764239,474786733,3,19375,3598396,18673,3436894,702,161502,6477,105,14094,252,3,252,216660.0,130000.0,-51.0,-48.0,-42.0,-47.0,-51.0,-48.0,-43.0,-47.0,-89.0,-92.0,-88.0,-89.0,38.0,44.0,46.0,42.0,1
2553,CC:2F:71:3F:1F:24,4019169,772074758,254926,297287621,3764243,474787137,27,214182,244750134,214089,244738614,93,11520,204634,6,254926,23462,24,154,144444.0,43333.0,-71.0,-68.0,-71.0,-70.0,-71.0,-68.0,-70.0,-70.0,-89.0,-92.0,-88.0,-90.0,18.0,24.0,17.0,20.0,1
2554,CC:2F:71:3E:C5:1F,3764352,474800432,109,13295,3764243,474787137,0,431,36847,349,26985,82,9862,117,2,145,4,0,5,144444.0,39000.0,-71.0,-71.0,-67.0,-60.0,-70.0,-70.0,-66.0,-59.0,-89.0,-92.0,-88.0,-90.0,18.0,21.0,21.0,30.0,1
2555,BA:8C:B9:54:50:24,3764551,474877635,308,90498,3764243,474787137,0,1301,143947,1283,141101,18,2846,200,5,430,7,0,8,216660.0,130000.0,-48.0,-35.0,-43.0,-45.0,-41.0,-36.0,-45.0,-50.0,-89.0,-92.0,-88.0,-90.0,41.0,57.0,45.0,45.0,1
2556,92:69:1D:31:68:E9,3777072,490051170,12829,15264033,3764243,474787137,3,19375,3598396,18673,3436894,702,161502,6477,105,14094,252,3,252,216660.0,130000.0,-51.0,-48.0,-42.0,-47.0,-51.0,-48.0,-43.0,-47.0,-89.0,-92.0,-88.0,-90.0,38.0,44.0,46.0,43.0,1
2557,CC:2F:71:3F:1F:24,4019277,772196200,255033,297409003,3764244,474787197,27,214279,244869626,214186,244858106,93,11520,204725,6,255034,23462,24,154,144444.0,43333.0,-71.0,-68.0,-71.0,-70.0,-71.0,-68.0,-70.0,-70.0,-89.0,-92.0,-88.0,-90.0,18.0,24.0,17.0,20.0,1
2558,CC:2F:71:3E:C5:1F,3764355,474800694,109,13295,3764246,474787399,0,431,36847,349,26985,82,9862,117,2,145,4,0,5,144444.0,39000.0,-71.0,-71.0,-67.0,-60.0,-70.0,-70.0,-66.0,-59.0,-89.0,-92.0,-88.0,-90.0,18.0,21.0,21.0,30.0,1
2559,BA:8C:B9:54:50:24,3764554,474877897,308,90498,3764246,474787399,0,1301,143947,1283,141101,18,2846,200,5,430,7,0,8,216660.0,130000.0,-48.0,-35.0,-43.0,-45.0,-41.0,-36.0,-45.0,-50.0,-89.0,-92.0,-88.0,-90.0,41.0,57.0,45.0,45.0,1
2560,92:69:1D:31:68:E9,3777077,490051634,12829,15264033,3764248,474787601,3,19375,3598396,18673,3436894,702,161502,6477,105,14094,252,3,252,216660.0,130000.0,-51.0,-48.0,-42.0,-47.0,-51.0,-48.0,-43.0,-47.0,-89.0,-92.0,-88.0,-90.0,38.0,44.0,46.0,43.0,1
2561,CC:2F:71:3F:1F:24,4019390,772315216,255139,297527279,3764251,474787937,27,214370,244980014,214277,244968494,93,11520,204812,6,255140,23463,24,154,144444.0,43333.0,-71.0,-68.0,-71.0,-70.0,-71.0,-68.0,-70.0,-70.0,-89.0,-92.0,-88.0,-90.0,18.0,24.0,17.0,20.0,1
2562,CC:2F:71:3E:C5:1F,3764360,474801232,109,13295,3764251,474787937,0,431,36847,349,26985,82,9862,117,2,145,4,0,5,144444.0,39000.0,-71.0,-71.0,-67.0,-60.0,-70.0,-70.0,-66.0,-59.0,-89.0,-92.0,-88.0,-90.0,18.0,21.0,21.0,30.0,1
2563,BA:8C:B9:54:50:24,3764560,474878503,308,90498,3764252,474788005,0,1301,143947,1283,141101,18,2846,200,5,430,7,0,8,216660.0,130000.0,-48.0,-35.0,-43.0,-45.0,-41.0,-36.0,-45.0,-50.0,-89.0,-92.0,-88.0,-90.0,41.0,57.0,45.0,45.0,1
2564,92:69:1D:31:68:E9,3777082,490052311,12829,15264033,3764253,474788278,3,19375,3598396,18673,3436894,702,161502,6477,105,14094,252,3,252,216660.0,130000.0,-51.0,-48.0,-42.0,-47.0,-51.0,-48.0,-43.0,-47.0,-89.0,-92.0,-88.0,-90.0,38.0,44.0,46.0,43.0,1
2565,CC:2F:71:3F:1F:24,4019502,772435490,255249,297647212,3764253,474788278,27,214466,245091283,214373,245079763,93,11520,204905,6,255250,23463,24,154,144444.0,43333.0,-71.0,-68.0,-70.0,-70.0,-71.0,-68.0,-70.0,-70.0,-89.0,-92.0,-88.0,-90.0,18.0,24.0,18.0,20.0,1
2566,CC:2F:71:3E:C5:1F,3764364,474801775,109,13295,3764255,474788480,0,431,36847,349,26985,82,9862,117,2,145,4,0,5,144444.0,39000.0,-71.0,-71.0,-67.0,-60.0,-70.0,-70.0,-66.0,-59.0,-89.0,-92.0,-88.0,-90.0,18.0,21.0,21.0,30.0,1
2567,BA:8C:B9:54:50:24,3764563,474878978,308,90498,3764255,474788480,0,1301,143947,1283,141101,18,2846,200,5,430,7,0,8,216660.0,130000.0,-48.0,-35.0,-43.0,-45.0,-41.0,-36.0,-45.0,-50.0,-89.0,-92.0,-88.0,-90.0,41.0,57.0,45.0,45.0,1
2568,92:69:1D:31:68:E9,3777084,490052513,12829,15264033,3764255,474788480,3,19375,3598396,18673,3436894,702,161502,6477,105,14094,252,3,252,216660.0,130000.0,-51.0,-48.0,-42.0,-47.0,-51.0,-48.0,-43.0,-47.0,-89.0,-92.0,-88.0,-90.0,38.0,44.0,46.0,43.0,1
2569,CC:2F:71:3F:1F:24,4019614,772554302,255354,297765358,3764260,474788944,27,214557,245200105,214464,245188585,93,11520,204993,6,255355,23463,24,154,144444.0,43333.0,-70.0,-68.0,-69.0,-68.0,-70.0,-68.0,-69.0,-68.0,-90.0,-92.0,-89.0,-90.0,20.0,24.0,20.0,22.0,1
2570,CC:2F:71:3E:C5:1F,3764369,474802239,109,13295,3764260,474788944,0,431,36847,349,26985,82,9862,117,2,145,4,0,5,144444.0,39000.0,-71.0,-71.0,-67.0,-60.0,-70.0,-70.0,-66.0,-59.0,-90.0,-92.0,-89.0,-90.0,19.0,21.0,22.0,30.0,1
2571,BA:8C:B9:54:50:24,3764570,474879644,308,90498,3764262,474789146,0,1301,143947,1283,141101,18,2846,200,5,430,7,0,8,216660.0,130000.0,-48.0,-35.0,-43.0,-45.0,-41.0,-36.0,-45.0,-50.0,-90.0,-92.0,-89.0,-90.0,42.0,57.0,46.0,45.0,1
2572,92:69:1D:31:68:E9,3777091,490053179,12829,15264033,3764262,474789146,3,19375,3598396,18673,3436894,702,161502,6477,105,14094,252,3,252,216660.0,130000.0,-51.0,-48.0,-42.0,-47.0,-51.0,-48.0,-43.0,-47.0,-90.0,-92.0,-89.0,-90.0,39.0,44.0,47.0,43.0,1
2573,CC:2F:71:3F:1F:24,4019723,772674317,255461,297885171,3764262,474789146,27,214656,245320008,214563,245308488,93,11520,205084,6,255462,23518,24,154,130000.0,43333.0,-70.0,-64.0,-69.0,-71.0,-70.0,-64.0,-68.0,-70.0,-90.0,-92.0,-89.0,-90.0,20.0,28.0,20.0,19.0,1
2574,CC:2F:71:3E:C5:1F,3764371,474802441,109,13295,3764262,474789146,0,431,36847,349,26985,82,9862,117,2,145,4,0,5,144444.0,39000.0,-71.0,-71.0,-67.0,-60.0,-70.0,-70.0,-66.0,-59.0,-90.0,-92.0,-89.0,-90.0,19.0,21.0,22.0,30.0,1
2575,BA:8C:B9:54:50:24,3764572,474879846,308,90498,3764264,474789348,0,1301,143947,1283,141101,18,2846,200,5,430,7,0,8,216660.0,130000.0,-48.0,-35.0,-43.0,-45.0,-41.0,-36.0,-45.0,-50.0,-90.0,-92.0,-89.0,-90.0,42.0,57.0,46.0,45.0,1
2576,92:69:1D:31:68:E9,3777093,490053381,12829,15264033,3764264,474789348,3,19375,3598396,18673,3436894,702,161502,6477,105,14094,252,3,252,216660.0,130000.0,-51.0,-48.0,-42.0,-47.0,-51.0,-48.0,-43.0,-47.0,-90.0,-92.0,-89.0,-90.0,39.0,44.0,47.0,43.0,1
2577,CC:2F:71:3F:1F:24,4019835,772792849,255566,298003037,3764269,474789812,27,214748,245433184,214655,245421664,93,11520,205172,6,255567,23532,24,154,115556.0,28889.0,-69.0,-67.0,-71.0,-68.0,-68.0,-66.0,-70.0,-68.0,-90.0,-92.0,-89.0,-90.0,21.0,25.0,18.0,22.0,1
2578,CC:2F:71:3E:C5:1F,3764378,474803107,109,13295,3764269,474789812,0,431,36847,349,26985,82,9862,117,2,145,4,0,5,144444.0,39000.0,-71.0,-71.0,-67.0,-60.0,-70.0,-70.0,-66.0,-59.0,-90.0,-92.0,-89.0,-90.0,19.0,21.0,22.0,30.0,1
2579,BA:8C:B9:54:50:24,3764577,474880310,308,90498,3764269,474789812,0,1301,143947,1283,141101,18,2846,200,5,430,7,0,8,216660.0,130000.0,-48.0,-35.0,-43.0,-45.0,-41.0,-36.0,-45.0,-50.0,-90.0,-92.0,-89.0,-90.0,42.0,57.0,46.0,45.0,1
2580,92:69:1D:31:68:E9,3777098,490053845,12829,15264033,3764269,474789812,3,19375,3598396,18673,3436894,702,161502,6477,105,14094,252,3,252,216660.0,130000.0,-51.0,-48.0,-42.0,-47.0,-51.0,-48.0,-43.0,-47.0,-90.0,-92.0,-89.0,-90.0,39.0,44.0,47.0,43.0,1
2581,CC:2F:71:3F:1F:24,4019942,772911029,255671,298121015,3764271,474790014,27,214844,245551232,214751,245539712,93,11520,205260,6,255672,23534,24,154,130000.0,43333.0,-71.0,-66.0,-71.0,-67.0,-70.0,-66.0,-70.0,-67.0,-90.0,-92.0,-89.0,-90.0,19.0,26.0,18.0,23.0,1
2582,CC:2F:71:3E:C5:1F,3764380,474803309,109,13295,3764271,474790014,0,431,36847,349,26985,82,9862,117,2,145,4,0,5,144444.0,39000.0,-71.0,-71.0,-67.0,-60.0,-70.0,-70.0,-66.0,-59.0,-90.0,-92.0,-89.0,-90.0,19.0,21.0,22.0,30.0,1
2583,BA:8C:B9:54:50:24,3764581,474880714,308,90498,3764273,474790216,0,1301,143947,1283,141101,18,2846,200,5,430,7,0,8,216660.0,130000.0,-48.0,-35.0,-43.0,-45.0,-41.0,-36.0,-45.0,-50.0,-90.0,-92.0,-89.0,-90.0,42.0,57.0,46.0,45.0,1
2584,92:69:1D:31:68:E9,3777102,490054249,12829,15264033,3764273,474790216,3,19376,3598464,18674,3436962,702,161502,6477,105,14094,252,3,252,216660.0,130000.0,-51.0,-47.0,-42.0,-47.0,-51.0,-48.0,-43.0,-47.0,-90.0,-92.0,-89.0,-90.0,39.0,45.0,47.0,43.0,1
2585,CC:2F:71:3F:1F:24,4020061,773035840,255786,298245422,3764275,474790418,27,214943,245665712,214850,245654192,93,11520,205357,6,255787,23579,24,154,117000.0,39000.0,-70.0,-66.0,-70.0,-68.0,-69.0,-66.0,-69.0,-68.0,-90.0,-92.0,-89.0,-91.0,20.0,26.0,19.0,23.0,1
2586,CC:2F:71:3E:C5:1F,3764386,474803915,109,13295,3764277,474790620,0,431,36847,349,26985,82,9862,117,2,145,4,0,5,144444.0,39000.0,-71.0,-71.0,-67.0,-60.0,-70.0,-70.0,-66.0,-59.0,-90.0,-92.0,-89.0,-91.0,19.0,21.0,22.0,31.0,1
2587,BA:8C:B9:54:50:24,3764585,474881118,308,90498,3764277,474790620,0,1301,143947,1283,141101,18,2846,200,5,430,7,0,8,216660.0,130000.0,-48.0,-35.0,-43.0,-45.0,-41.0,-36.0,-45.0,-50.0,-90.0,-92.0,-89.0,-91.0,42.0,57.0,46.0,46.0,1
2588,92:69:1D:31:68:E9,3777106,490054653,12829,15264033,3764277,474790620,3,19376,3598464,18674,3436962,702,161502,6477,105,14094,252,3,252,216660.0,130000.0,-51.0,-47.0,-42.0,-47.0,-51.0,-48.0,-43.0,-47.0,-90.0,-92.0,-89.0,-91.0,39.0,45.0,47.0,44.0,1
2589,CC:2F:71:3F:1F:24,4020173,773155854,255893,298364972,3764280,474790882,27,215031,245772782,214938,245761262,93,11520,205444,6,255893,23579,24,154,130000.0,43333.0,-68.0,-66.0,-71.0,-67.0,-69.0,-66.0,-70.0,-68.0,-90.0,-92.0,-89.0,-91.0,22.0,26.0,18.0,24.0,1
2590,CC:2F:71:3E:C5:1F,3764391,474804545,109,13295,3764282,474791250,0,431,36847,349,26985,82,9862,117,2,145,4,0,5,144444.0,39000.0,-71.0,-71.0,-67.0,-60.0,-70.0,-70.0,-66.0,-59.0,-90.0,-92.0,-89.0,-91.0,19.0,21.0,22.0,31.0,1
2591,BA:8C:B9:54:50:24,3764592,474881950,308,90498,3764284,474791452,0,1301,143947,1283,141101,18,2846,200,5,430,7,0,8,216660.0,130000.0,-48.0,-35.0,-43.0,-45.0,-41.0,-36.0,-45.0,-50.0,-90.0,-92.0,-89.0,-91.0,42.0,57.0,46.0,46.0,1
2592,92:69:1D:31:68:E9,3777113,490055485,12829,15264033,3764284,474791452,3,19376,3598464,18674,3436962,702,161502,6477,105,14094,252,3,252,216660.0,130000.0,-51.0,-47.0,-42.0,-47.0,-51.0,-48.0,-43.0,-47.0,-90.0,-92.0,-89.0,-91.0,39.0,45.0,47.0,44.0,1
2593,CC:2F:71:3F:1F:24,4020288,773277846,256002,298486192,3764286,474791654,27,215122,245885814,215029,245874294,93,11520,205533,6,256003,23583,24,154,117000.0,39000.0,-70.0,-66.0,-71.0,-67.0,-69.0,-66.0,-71.0,-67.0,-90.0,-92.0,-89.0,-91.0,20.0,26.0,18.0,24.0,1
2594,CC:2F:71:3E:C5:1F,3764398,474805267,110,13411,3764288,474791856,0,433,36987,351,27125,82,9862,117,2,146,4,0,5,144444.0,43333.0,-70.0,-70.0,-66.0,-60.0,-71.0,-70.0,-66.0,-59.0,-90.0,-92.0,-89.0,-91.0,20.0,22.0,23.0,31.0,1
2595,BA:8C:B9:54:50:24,3764597,474882470,309,90614,3764288,474791856,0,1303,144083,1285,141237,18,2846,200,5,431,7,0,8,216660.0,130000.0,-40.0,-37.0,-46.0,-51.0,-42.0,-36.0,-45.0,-49.0,-90.0,-92.0,-89.0,-91.0,50.0,55.0,43.0,40.0,1
2596,92:69:1D:31:68:E9,3777118,490056005,12830,15264149,3764288,474791856,3,19378,3598600,18676,3437098,702,161502,6477,105,14095,252,3,252,216660.0,130000.0,-51.0,-48.0,-42.0,-48.0,-51.0,-47.0,-42.0,-47.0,-90.0,-92.0,-89.0,-91.0,39.0,44.0,47.0,43.0,1
2597,CC:2F:71:3F:1F:24,4020398,773396234,256107,298604114,3764291,474792120,27,215213,245997422,215120,245985902,93,11520,205622,6,256108,23594,24,154,130000.0,39000.0,-69.0,-66.0,-71.0,-69.0,-69.0,-66.0,-71.0,-68.0,-90.0,-93.0,-89.0,-92.0,21.0,27.0,18.0,23.0,1
2598,CC:2F:71:3E:C5:1F,3764401,474805531,110,13411,3764291,474792120,0,435,37175,352,27195,83,9980,118,2,146,4,0,5,144444.0,43333.0,-71.0,-71.0,-65.0,-60.0,-70.0,-70.0,-66.0,-59.0,-90.0,-93.0,-89.0,-92.0,19.0,22.0,24.0,32.0,1
2599,BA:8C:B9:54:50:24,3764602,474882936,309,90614,3764293,474792322,0,1303,144083,1285,141237,18,2846,200,5,431,7,0,8,216660.0,130000.0,-40.0,-37.0,-46.0,-51.0,-42.0,-36.0,-45.0,-49.0,-90.0,-93.0,-89.0,-92.0,50.0,56.0,43.0,41.0,1
2600,92:69:1D:31:68:E9,3777123,490056471,12830,15264149,3764293,474792322,3,19378,3598600,18676,3437098,702,161502,6477,105,14095,252,3,252,216660.0,130000.0,-51.0,-48.0,-42.0,-48.0,-51.0,-47.0,-42.0,-47.0,-90.0,-93.0,-89.0,-92.0,39.0,45.0,47.0,44.0,1
2601,CC:2F:71:3F:1F:24,4020515,773518203,256219,298725619,3764296,474792584,27,215311,246110347,215218,246098827,93,11520,205717,6,256220,23598,24,154,130000.0,43333.0,-69.0,-66.0,-71.0,-68.0,-69.0,-66.0,-70.0,-67.0,-90.0,-93.0,-89.0,-92.0,21.0,27.0,18.0,24.0,1
2602,CC:2F:71:3E:C5:1F,3764408,474806197,110,13411,3764298,474792786,0,435,37175,352,27195,83,9980,118,2,146,4,0,5,144444.0,43333.0,-71.0,-71.0,-65.0,-60.0,-70.0,-70.0,-66.0,-59.0,-90.0,-93.0,-89.0,-92.0,19.0,22.0,24.0,32.0,1
2603,BA:8C:B9:54:50:24,3764607,474883400,309,90614,3764298,474792786,0,1303,144083,1285,141237,18,2846,200,5,431,7,0,8,216660.0,130000.0,-40.0,-37.0,-46.0,-51.0,-42.0,-36.0,-45.0,-49.0,-90.0,-93.0,-89.0,-92.0,50.0,56.0,43.0,41.0,1
2604,92:69:1D:31:68:E9,3777128,490056935,12830,15264149,3764298,474792786,3,19378,3598600,18676,3437098,702,161502,6477,105,14095,252,3,252,216660.0,130000.0,-51.0,-48.0,-42.0,-48.0,-51.0,-47.0,-42.0,-47.0,-90.0,-93.0,-89.0,-92.0,39.0,45.0,47.0,44.0,1
2605,CC:2F:71:3F:1F:24,4020625,773638307,256325,298845319,3764300,474792988,27,215407,246226953,215314,246215433,93,11520,205804,6,256326,23602,24,154,130000.0,43333.0,-69.0,-66.0,-70.0,-68.0,-69.0,-66.0,-70.0,-68.0,-90.0,-93.0,-89.0,-92.0,21.0,27.0,19.0,24.0,1
2606,CC:2F:71:3E:C5:1F,3764410,474806399,110,13411,3764300,474792988,0,435,37175,352,27195,83,9980,118,2,146,4,0,5,144444.0,43333.0,-71.0,-71.0,-65.0,-60.0,-70.0,-70.0,-66.0,-59.0,-90.0,-93.0,-89.0,-92.0,19.0,22.0,24.0,32.0,1
2607,BA:8C:B9:54:50:24,3764611,474883804,309,90614,3764302,474793190,0,1303,144083,1285,141237,18,2846,200,5,431,7,0,8,216660.0,130000.0,-40.0,-37.0,-46.0,-51.0,-42.0,-36.0,-45.0,-49.0,-90.0,-93.0,-89.0,-92.0,50.0,56.0,43.0,41.0,1
2608,92:69:1D:31:68:E9,3777132,490057339,12830,15264149,3764302,474793190,3,19378,3598600,18676,3437098,702,161502,6477,105,14095,252,3,252,216660.0,130000.0,-51.0,-48.0,-42.0,-48.0,-51.0,-47.0,-42.0,-47.0,-90.0,-93.0,-89.0,-92.0,39.0,45.0,47.0,44.0,1
2609,CC:2F:71:3F:1F:24,4020736,773755385,256431,298961933,3764305,474793452,27,215498,246337127,215405,246325607,93,11520,205893,6,256432,23607,24,154,130000.0,43333.0,-69.0,-65.0,-70.0,-68.0,-69.0,-65.0,-70.0,-68.0,-90.0,-93.0,-89.0,-92.0,21.0,28.0,19.0,24.0,1
2610,CC:2F:71:3E:C5:1F,3764415,474806863,110,13411,3764305,474793452,0,435,37175,352,27195,83,9980,118,2,146,4,0,5,144444.0,43333.0,-71.0,-71.0,-65.0,-60.0,-70.0,-70.0,-66.0,-59.0,-90.0,-93.0,-89.0,-92.0,19.0,22.0,24.0,32.0,1
2611,BA:8C:B9:54:50:24,3764614,474884066,309,90614,3764305,474793452,0,1303,144083,1285,141237,18,2846,200,5,431,7,0,8,216660.0,130000.0,-40.0,-37.0,-46.0,-51.0,-42.0,-36.0,-45.0,-49.0,-90.0,-93.0,-89.0,-92.0,50.0,56.0,43.0,41.0,1
2612,92:69:1D:31:68:E9,3777137,490057803,12830,15264149,3764307,474793654,3,19378,3598600,18676,3437098,702,161502,6477,105,14095,252,3,252,216660.0,130000.0,-51.0,-48.0,-42.0,-48.0,-51.0,-47.0,-42.0,-47.0,-90.0,-93.0,-89.0,-92.0,39.0,45.0,47.0,44.0,1
2613,CC:2F:71:3F:1F:24,4020848,773875749,256539,299081893,3764309,474793856,27,215589,246448735,215496,246437215,93,11520,205982,6,256540,23609,24,154,130000.0,43333.0,-69.0,-66.0,-71.0,-68.0,-69.0,-65.0,-70.0,-68.0,-90.0,-93.0,-90.0,-92.0,21.0,27.0,19.0,24.0,1
2614,CC:2F:71:3E:C5:1F,3764419,474807267,110,13411,3764309,474793856,0,435,37175,352,27195,83,9980,118,2,146,4,0,5,144444.0,43333.0,-71.0,-71.0,-65.0,-60.0,-70.0,-70.0,-66.0,-59.0,-90.0,-93.0,-90.0,-92.0,19.0,22.0,25.0,32.0,1
2615,BA:8C:B9:54:50:24,3764618,474884470,309,90614,3764309,474793856,0,1303,144083,1285,141237,18,2846,200,5,431,7,0,8,216660.0,130000.0,-40.0,-37.0,-46.0,-51.0,-42.0,-36.0,-45.0,-49.0,-90.0,-93.0,-90.0,-92.0,50.0,56.0,44.0,41.0,1
2616,92:69:1D:31:68:E9,3777141,490058207,12830,15264149,3764311,474794058,3,19378,3598600,18676,3437098,702,161502,6477,105,14095,252,3,252,216660.0,130000.0,-51.0,-48.0,-42.0,-48.0,-51.0,-47.0,-42.0,-47.0,-90.0,-93.0,-90.0,-92.0,39.0,45.0,48.0,44.0,1
2617,CC:2F:71:3F:1F:24,4020976,773999773,256662,299205240,3764314,474794533,27,215696,246562011,215603,246550491,93,11520,206085,6,256663,23610,24,154,130000.0,43333.0,-69.0,-65.0,-71.0,-68.0,-69.0,-65.0,-70.0,-68.0,-90.0,-93.0,-90.0,-92.0,21.0,28.0,19.0,24.0,1
2618,CC:2F:71:3E:C5:1F,3764424,474807944,110,13411,3764314,474794533,0,435,37175,352,27195,83,9980,118,2,146,4,0,5,144444.0,43333.0,-71.0,-71.0,-65.0,-60.0,-70.0,-70.0,-66.0,-59.0,-90.0,-93.0,-90.0,-92.0,19.0,22.0,25.0,32.0,1
2619,BA:8C:B9:54:50:24,3764623,474885147,309,90614,3764314,474794533,0,1303,144083,1285,141237,18,2846,200,5,431,7,0,8,216660.0,130000.0,-40.0,-37.0,-46.0,-51.0,-42.0,-36.0,-45.0,-49.0,-90.0,-93.0,-90.0,-92.0,50.0,56.0,44.0,41.0,1
2620,92:69:1D:31:68:E9,3777146,490058884,12830,15264149,3764316,474794735,3,19378,3598600,18676,3437098,702,161502,6477,105,14095,252,3,252,216660.0,130000.0,-51.0,-48.0,-42.0,-48.0,-51.0,-47.0,-42.0,-47.0,-90.0,-93.0,-90.0,-92.0,39.0,45.0,48.0,44.0,1
2621,CC:2F:71:3F:1F:24,4021088,774119843,256769,299324846,3764319,474794997,27,215784,246670409,215691,246658889,93,11520,206172,6,256770,23621,24,154,130000.0,43333.0,-70.0,-66.0,-71.0,-68.0,-69.0,-65.0,-70.0,-68.0,-90.0,-93.0,-90.0,-92.0,20.0,27.0,19.0,24.0,1
2622,CC:2F:71:3E:C5:1F,3764429,474808408,110,13411,3764319,474794997,0,435,37175,352,27195,83,9980,118,2,146,4,0,5,144444.0,43333.0,-71.0,-71.0,-65.0,-60.0,-70.0,-70.0,-66.0,-59.0,-90.0,-93.0,-90.0,-92.0,19.0,22.0,25.0,32.0,1
2623,BA:8C:B9:54:50:24,3764628,474885611,309,90614,3764319,474794997,0,1303,144083,1285,141237,18,2846,200,5,431,7,0,8,216660.0,130000.0,-40.0,-37.0,-46.0,-51.0,-42.0,-36.0,-45.0,-49.0,-90.0,-93.0,-90.0,-92.0,50.0,56.0,44.0,41.0,1
2624,92:69:1D:31:68:E9,3777151,490059348,12830,15264149,3764321,474795199,3,19378,3598600,18676,3437098,702,161502,6477,105,14095,252,3,252,216660.0,130000.0,-51.0,-48.0,-42.0,-48.0,-51.0,-47.0,-42.0,-47.0,-90.0,-93.0,-90.0,-92.0,39.0,45.0,48.0,44.0,1
2625,CC:2F:71:3F:1F:24,4021196,774236839,256873,299441438,3764323,474795401,27,215872,246777369,215779,246765849,93,11520,206260,6,256874,23622,24,154,130000.0,43333.0,-69.0,-66.0,-70.0,-68.0,-69.0,-66.0,-70.0,-68.0,-90.0,-93.0,-90.0,-92.0,21.0,27.0,20.0,24.0,1
2626,CC:2F:71:3E:C5:1F,3764433,474808812,110,13411,3764323,474795401,0,435,37175,352,27195,83,9980,118,2,146,4,0,5,144444.0,43333.0,-71.0,-71.0,-65.0,-60.0,-70.0,-70.0,-66.0,-59.0,-90.0,-93.0,-90.0,-92.0,19.0,22.0,25.0,32.0,1
2627,BA:8C:B9:54:50:24,3764632,474886015,309,90614,3764323,474795401,0,1303,144083,1285,141237,18,2846,200,5,431,7,0,8,216660.0,130000.0,-40.0,-37.0,-46.0,-51.0,-42.0,-36.0,-45.0,-49.0,-90.0,-93.0,-90.0,-92.0,50.0,56.0,44.0,41.0,1
2628,92:69:1D:31:68:E9,3777153,490059550,12830,15264149,3764323,474795401,3,19378,3598600,18676,3437098,702,161502,6477,105,14095,252,3,252,216660.0,130000.0,-51.0,-48.0,-42.0,-48.0,-51.0,-47.0,-42.0,-47.0,-90.0,-93.0,-90.0,-92.0,39.0,45.0,48.0,44.0,1
2629,CC:2F:71:3F:1F:24,4021307,774355537,256980,299559732,3764327,474795805,27,215964,246887779,215871,246876259,93,11520,206349,6,256981,23628,24,154,117000.0,39000.0,-69.0,-66.0,-71.0,-68.0,-69.0,-66.0,-71.0,-68.0,-90.0,-93.0,-90.0,-92.0,21.0,27.0,19.0,24.0,1
2630,CC:2F:71:3E:C5:1F,3764437,474809216,110,13411,3764327,474795805,0,435,37175,352,27195,83,9980,118,2,146,4,0,5,144444.0,43333.0,-71.0,-71.0,-65.0,-60.0,-70.0,-70.0,-66.0,-59.0,-90.0,-93.0,-90.0,-92.0,19.0,22.0,25.0,32.0,1
2631,BA:8C:B9:54:50:24,3764636,474886419,309,90614,3764327,474795805,0,1303,144083,1285,141237,18,2846,200,5,431,7,0,8,216660.0,130000.0,-40.0,-37.0,-46.0,-51.0,-42.0,-36.0,-45.0,-49.0,-90.0,-93.0,-90.0,-92.0,50.0,56.0,44.0,41.0,1
2632,92:69:1D:31:68:E9,3777157,490059954,12830,15264149,3764327,474795805,3,19378,3598600,18676,3437098,702,161502,6477,105,14095,252,3,252,216660.0,130000.0,-51.0,-48.0,-42.0,-48.0,-51.0,-47.0,-42.0,-47.0,-90.0,-93.0,-90.0,-92.0,39.0,45.0,48.0,44.0,1
2633,CC:2F:71:3F:1F:24,4021423,774477376,257091,299681107,3764332,474796269,27,216065,247003001,215972,246991481,93,11520,206444,6,257092,23628,24,154,130000.0,43333.0,-70.0,-67.0,-72.0,-70.0,-69.0,-66.0,-71.0,-69.0,-90.0,-93.0,-90.0,-92.0,20.0,26.0,18.0,22.0,1
2634,CC:2F:71:3E:C5:1F,3764442,474809680,110,13411,3764332,474796269,0,435,37175,352,27195,83,9980,118,2,146,4,0,5,144444.0,43333.0,-71.0,-71.0,-65.0,-60.0,-70.0,-70.0,-66.0,-59.0,-90.0,-93.0,-90.0,-92.0,19.0,22.0,25.0,32.0,1
2635,BA:8C:B9:54:50:24,3764641,474886883,309,90614,3764332,474796269,0,1303,144083,1285,141237,18,2846,200,5,431,7,0,8,216660.0,130000.0,-40.0,-37.0,-46.0,-51.0,-42.0,-36.0,-45.0,-49.0,-90.0,-93.0,-89.0,-92.0,50.0,56.0,43.0,41.0,1
2636,92:69:1D:31:68:E9,3777162,490060418,12830,15264149,3764332,474796269,3,19378,3598600,18676,3437098,702,161502,6477,105,14095,252,3,252,216660.0,130000.0,-51.0,-48.0,-42.0,-48.0,-51.0,-47.0,-42.0,-47.0,-90.0,-93.0,-89.0,-92.0,39.0,45.0,47.0,44.0,1
2637,CC:2F:71:3F:1F:24,4021531,774594372,257195,299797699,3764336,474796673,27,216154,247111639,216061,247100119,93,11520,206530,6,257196,23628,24,154,130000.0,43333.0,-69.0,-66.0,-71.0,-68.0,-68.0,-66.0,-71.0,-68.0,-90.0,-93.0,-89.0,-92.0,21.0,27.0,18.0,24.0,1
2638,CC:2F:71:3E:C5:1F,3764446,474810084,110,13411,3764336,474796673,0,435,37175,352,27195,83,9980,118,2,146,4,0,5,144444.0,43333.0,-71.0,-71.0,-65.0,-60.0,-70.0,-70.0,-66.0,-59.0,-90.0,-93.0,-89.0,-92.0,19.0,22.0,24.0,32.0,1
2639,BA:8C:B9:54:50:24,3764645,474887287,309,90614,3764336,474796673,0,1303,144083,1285,141237,18,2846,200,5,431,7,0,8,216660.0,130000.0,-40.0,-37.0,-46.0,-51.0,-42.0,-36.0,-45.0,-49.0,-90.0,-93.0,-89.0,-92.0,50.0,56.0,43.0,41.0,1
2640,92:69:1D:31:68:E9,3777166,490060822,12830,15264149,3764336,474796673,3,19378,3598600,18676,3437098,702,161502,6477,105,14095,252,3,252,216660.0,130000.0,-51.0,-48.0,-42.0,-48.0,-51.0,-47.0,-42.0,-47.0,-90.0,-93.0,-89.0,-92.0,39.0,45.0,47.0,44.0,1
2641,CC:2F:71:3F:1F:24,4021640,774712698,257300,299915621,3764340,474797077,27,216247,247222511,216154,247210991,93,11520,206617,6,257301,23634,24,154,130000.0,43333.0,-68.0,-66.0,-71.0,-68.0,-68.0,-65.0,-71.0,-68.0,-90.0,-93.0,-89.0,-92.0,22.0,27.0,18.0,24.0,1
2642,CC:2F:71:3E:C5:1F,3764450,474810488,110,13411,3764340,474797077,0,435,37175,352,27195,83,9980,118,2,146,4,0,5,144444.0,43333.0,-71.0,-71.0,-65.0,-60.0,-70.0,-70.0,-66.0,-59.0,-90.0,-93.0,-89.0,-92.0,19.0,22.0,24.0,32.0,1
2643,BA:8C:B9:54:50:24,3764651,474887813,309,90614,3764342,474797199,0,1303,144083,1285,141237,18,2846,200,5,431,7,0,8,216660.0,130000.0,-40.0,-37.0,-46.0,-51.0,-42.0,-36.0,-45.0,-49.0,-90.0,-93.0,-89.0,-92.0,50.0,56.0,43.0,41.0,1
2644,92:69:1D:31:68:E9,3777172,490061348,12830,15264149,3764342,474797199,3,19378,3598600,18676,3437098,702,161502,6477,105,14095,252,3,252,216660.0,130000.0,-51.0,-48.0,-42.0,-48.0,-51.0,-47.0,-42.0,-47.0,-90.0,-93.0,-89.0,-92.0,39.0,45.0,47.0,44.0,1
2645,CC:2F:71:3F:1F:24,4021753,774832494,257405,300033767,3764348,474798727,27,216343,247340609,216249,247328971,94,11638,206705,6,257406,23635,24,154,130000.0,43333.0,-69.0,-66.0,-72.0,-68.0,-69.0,-65.0,-71.0,-68.0,-90.0,-93.0,-89.0,-92.0,21.0,27.0,17.0,24.0,1
2646,CC:2F:71:3E:C5:1F,3764458,474812138,110,13411,3764348,474798727,0,436,37245,353,27265,83,9980,118,2,147,4,0,5,144444.0,43333.0,-70.0,-71.0,-66.0,-60.0,-70.0,-70.0,-66.0,-60.0,-90.0,-93.0,-89.0,-92.0,20.0,22.0,23.0,32.0,1
2647,BA:8C:B9:54:50:24,3764657,474889341,309,90614,3764348,474798727,0,1305,144219,1287,141373,18,2846,200,5,432,7,0,8,216660.0,130000.0,-40.0,-37.0,-46.0,-51.0,-43.0,-36.0,-44.0,-48.0,-90.0,-93.0,-89.0,-92.0,50.0,56.0,43.0,41.0,1
2648,92:69:1D:31:68:E9,3777178,490062876,12830,15264149,3764348,474798727,3,19381,3598804,18679,3437302,702,161502,6477,105,14096,252,3,252,216660.0,130000.0,-52.0,-51.0,-43.0,-48.0,-51.0,-49.0,-43.0,-48.0,-90.0,-93.0,-89.0,-92.0,38.0,42.0,46.0,44.0,1
2649,CC:2F:71:3F:1F:24,4021875,774959613,257523,300160482,3764352,474799131,27,216452,247463662,216358,247452024,94,11638,206806,6,257524,23638,24,154,130000.0,43333.0,-69.0,-65.0,-71.0,-68.0,-69.0,-65.0,-71.0,-68.0,-90.0,-93.0,-89.0,-92.0,21.0,28.0,18.0,24.0,1
2650,CC:2F:71:3E:C5:1F,3764462,474812542,110,13411,3764352,474799131,0,437,37315,354,27335,83,9980,118,2,147,4,0,5,144444.0,43333.0,-70.0,-71.0,-66.0,-60.0,-70.0,-70.0,-66.0,-60.0,-90.0,-93.0,-89.0,-92.0,20.0,22.0,23.0,32.0,1
2651,BA:8C:B9:54:50:24,3764661,474889745,309,90614,3764352,474799131,0,1305,144219,1287,141373,18,2846,200,5,432,7,0,8,216660.0,130000.0,-40.0,-37.0,-46.0,-51.0,-43.0,-36.0,-44.0,-48.0,-90.0,-93.0,-89.0,-92.0,50.0,56.0,43.0,41.0,1
2652,92:69:1D:31:68:E9,3777182,490063280,12830,15264149,3764352,474799131,3,19383,3598940,18681,3437438,702,161502,6477,105,14096,252,3,252,216660.0,130000.0,-51.0,-48.0,-42.0,-47.0,-51.0,-49.0,-43.0,-48.0,-90.0,-93.0,-89.0,-92.0,39.0,45.0,47.0,45.0,1
2653,CC:2F:71:3F:1F:24,4021994,775087153,257635,300286434,3764359,474800719,27,216551,247580626,216457,247568988,94,11638,206901,6,257636,23644,24,154,130000.0,43333.0,-69.0,-66.0,-72.0,-68.0,-69.0,-65.0,-71.0,-68.0,-90.0,-93.0,-89.0,-92.0,21.0,27.0,17.0,24.0,1
2654,CC:2F:71:3E:C5:1F,3764469,474814130,110,13411,3764359,474800719,0,437,37315,354,27335,83,9980,118,2,147,4,0,5,144444.0,43333.0,-70.0,-71.0,-66.0,-60.0,-70.0,-70.0,-66.0,-60.0,-90.0,-93.0,-89.0,-92.0,20.0,22.0,23.0,32.0,1
2655,BA:8C:B9:54:50:24,3764668,474891333,309,90614,3764359,474800719,0,1306,144287,1288,141441,18,2846,200,5,432,7,0,8,216660.0,130000.0,-40.0,-37.0,-46.0,-51.0,-43.0,-36.0,-44.0,-48.0,-90.0,-93.0,-89.0,-92.0,50.0,56.0,43.0,41.0,1
2656,92:69:1D:31:68:E9,3777189,490064868,12830,15264149,3764359,474800719,3,19383,3598940,18681,3437438,702,161502,6477,105,14096,252,3,252,216660.0,130000.0,-51.0,-48.0,-42.0,-47.0,-51.0,-49.0,-43.0,-48.0,-90.0,-93.0,-89.0,-92.0,39.0,45.0,47.0,45.0,1
2657,CC:2F:71:3F:1F:24,4022106,775210141,257743,300409018,3764363,474801123,27,216644,247692438,216550,247680800,94,11638,206994,6,257744,23648,24,154,130000.0,43333.0,-69.0,-65.0,-71.0,-68.0,-69.0,-65.0,-71.0,-68.0,-90.0,-93.0,-89.0,-92.0,21.0,28.0,18.0,24.0,1
2658,CC:2F:71:3E:C5:1F,3764473,474814534,110,13411,3764363,474801123,0,437,37315,354,27335,83,9980,118,2,147,4,0,5,144444.0,43333.0,-70.0,-71.0,-66.0,-60.0,-70.0,-70.0,-66.0,-60.0,-90.0,-93.0,-89.0,-92.0,20.0,22.0,23.0,32.0,1
2659,BA:8C:B9:54:50:24,3764672,474891737,309,90614,3764363,474801123,0,1306,144287,1288,141441,18,2846,200,5,432,7,0,8,216660.0,130000.0,-40.0,-37.0,-46.0,-51.0,-43.0,-36.0,-44.0,-48.0,-90.0,-93.0,-89.0,-92.0,50.0,56.0,43.0,41.0,1
2660,92:69:1D:31:68:E9,3777193,490065272,12830,15264149,3764363,474801123,3,19383,3598940,18681,3437438,702,161502,6477,105,14096,252,3,252,216660.0,130000.0,-51.0,-48.0,-42.0,-47.0,-51.0,-49.0,-43.0,-48.0,-90.0,-93.0,-89.0,-92.0,39.0,45.0,47.0,45.0,1
2661,CC:2F:71:3F:1F:24,4022217,775329815,257848,300527164,3764369,474802651,27,216735,247805498,216641,247793860,94,11638,207081,6,257849,23649,24,154,130000.0,43333.0,-69.0,-66.0,-72.0,-69.0,-69.0,-66.0,-72.0,-68.0,-90.0,-93.0,-89.0,-92.0,21.0,27.0,17.0,23.0,1
2662,CC:2F:71:3E:C5:1F,3764479,474816062,110,13411,3764369,474802651,0,437,37315,354,27335,83,9980,118,2,147,4,0,5,144444.0,43333.0,-70.0,-71.0,-66.0,-60.0,-70.0,-70.0,-66.0,-60.0,-90.0,-93.0,-89.0,-92.0,20.0,22.0,23.0,32.0,1
2663,BA:8C:B9:54:50:24,3764678,474893265,309,90614,3764369,474802651,0,1306,144287,1288,141441,18,2846,200,5,432,7,0,8,216660.0,130000.0,-40.0,-37.0,-46.0,-51.0,-43.0,-36.0,-44.0,-48.0,-90.0,-93.0,-89.0,-92.0,50.0,56.0,43.0,41.0,1
2664,92:69:1D:31:68:E9,3777199,490066800,12830,15264149,3764369,474802651,3,19383,3598940,18681,3437438,702,161502,6477,105,14096,252,3,252,216660.0,130000.0,-51.0,-48.0,-42.0,-47.0,-51.0,-49.0,-43.0,-48.0,-90.0,-93.0,-89.0,-92.0,39.0,45.0,47.0,45.0,1
2665,CC:2F:71:3F:1F:24,4022335,775453450,257961,300650335,3764374,474803115,27,216832,247918293,216738,247906655,94,11638,207176,6,257962,23649,24,154,130000.0,43333.0,-73.0,-69.0,-76.0,-72.0,-72.0,-69.0,-74.0,-71.0,-90.0,-93.0,-89.0,-92.0,17.0,24.0,13.0,20.0,1
2666,CC:2F:71:3E:C5:1F,3764484,474816526,110,13411,3764374,474803115,0,437,37315,354,27335,83,9980,118,2,147,4,0,5,144444.0,43333.0,-70.0,-71.0,-66.0,-60.0,-70.0,-70.0,-66.0,-60.0,-90.0,-93.0,-89.0,-92.0,20.0,22.0,23.0,32.0,1
2667,BA:8C:B9:54:50:24,3764683,474893729,309,90614,3764374,474803115,0,1306,144287,1288,141441,18,2846,200,5,432,7,0,8,216660.0,130000.0,-40.0,-37.0,-46.0,-51.0,-43.0,-36.0,-44.0,-48.0,-90.0,-93.0,-89.0,-92.0,50.0,56.0,43.0,41.0,1
2668,92:69:1D:31:68:E9,3777204,490067264,12830,15264149,3764374,474803115,3,19383,3598940,18681,3437438,702,161502,6477,105,14096,252,3,252,216660.0,130000.0,-51.0,-48.0,-42.0,-47.0,-51.0,-49.0,-43.0,-48.0,-90.0,-93.0,-89.0,-92.0,39.0,45.0,47.0,45.0,1
2669,CC:2F:71:3F:1F:24,4022443,775570222,258065,300766703,3764378,474803519,27,216924,248028811,216830,248017173,94,11638,207263,6,258066,23663,24,154,130000.0,43333.0,-69.0,-66.0,-72.0,-68.0,-69.0,-66.0,-71.0,-68.0,-90.0,-93.0,-89.0,-92.0,21.0,27.0,17.0,24.0,1
2670,CC:2F:71:3E:C5:1F,3764489,474817203,110,13411,3764379,474803792,0,437,37315,354,27335,83,9980,118,2,147,4,0,5,144444.0,43333.0,-70.0,-71.0,-66.0,-60.0,-70.0,-70.0,-66.0,-60.0,-90.0,-93.0,-89.0,-92.0,20.0,22.0,23.0,32.0,1
2671,BA:8C:B9:54:50:24,3764688,474894406,309,90614,3764379,474803792,0,1306,144287,1288,141441,18,2846,200,5,432,7,0,8,216660.0,130000.0,-40.0,-37.0,-46.0,-51.0,-43.0,-36.0,-44.0,-48.0,-90.0,-93.0,-89.0,-92.0,50.0,56.0,43.0,41.0,1
2672,92:69:1D:31:68:E9,3777209,490067941,12830,15264149,3764379,474803792,3,19383,3598940,18681,3437438,702,161502,6477,105,14096,252,3,252,216660.0,130000.0,-51.0,-48.0,-42.0,-47.0,-51.0,-49.0,-43.0,-48.0,-90.0,-93.0,-89.0,-92.0,39.0,45.0,47.0,45.0,1
2673,CC:2F:71:3F:1F:24,4022556,775689141,258172,300884885,3764384,474804256,27,217019,248148087,216925,248136449,94,11638,207350,6,258173,23667,24,154,130000.0,43333.0,-70.0,-67.0,-72.0,-69.0,-69.0,-67.0,-72.0,-69.0,-90.0,-93.0,-89.0,-92.0,20.0,26.0,17.0,23.0,1
2674,CC:2F:71:3E:C5:1F,3764494,474817667,110,13411,3764384,474804256,0,437,37315,354,27335,83,9980,118,2,147,4,0,5,144444.0,43333.0,-70.0,-71.0,-66.0,-60.0,-70.0,-70.0,-66.0,-60.0,-90.0,-93.0,-89.0,-92.0,20.0,22.0,23.0,32.0,1
2675,BA:8C:B9:54:50:24,3764693,474894870,309,90614,3764384,474804256,0,1306,144287,1288,141441,18,2846,200,5,432,7,0,8,216660.0,130000.0,-40.0,-37.0,-46.0,-51.0,-43.0,-36.0,-44.0,-48.0,-90.0,-93.0,-89.0,-92.0,50.0,56.0,43.0,41.0,1
2676,92:69:1D:31:68:E9,3777214,490068405,12830,15264149,3764384,474804256,3,19383,3598940,18681,3437438,702,161502,6477,105,14096,252,3,252,216660.0,130000.0,-51.0,-48.0,-42.0,-47.0,-51.0,-49.0,-43.0,-48.0,-90.0,-93.0,-89.0,-92.0,39.0,45.0,47.0,45.0,1
2677,CC:2F:71:3F:1F:24,4022664,775806137,258276,301001477,3764388,474804660,27,217114,248260705,217020,248249067,94,11638,207436,6,258277,23667,24,154,130000.0,43333.0,-72.0,-70.0,-76.0,-72.0,-71.0,-68.0,-74.0,-70.0,-90.0,-93.0,-89.0,-92.0,18.0,23.0,13.0,20.0,1
2678,CC:2F:71:3E:C5:1F,3764498,474818071,110,13411,3764388,474804660,0,437,37315,354,27335,83,9980,118,2,147,4,0,5,144444.0,43333.0,-70.0,-71.0,-66.0,-60.0,-70.0,-70.0,-66.0,-60.0,-90.0,-93.0,-89.0,-92.0,20.0,22.0,23.0,32.0,1
2679,BA:8C:B9:54:50:24,3764697,474895274,309,90614,3764388,474804660,0,1306,144287,1288,141441,18,2846,200,5,432,7,0,8,216660.0,130000.0,-40.0,-37.0,-46.0,-51.0,-43.0,-36.0,-44.0,-48.0,-90.0,-93.0,-89.0,-92.0,50.0,56.0,43.0,41.0,1
2680,92:69:1D:31:68:E9,3777218,490068809,12830,15264149,3764388,474804660,3,19383,3598940,18681,3437438,702,161502,6477,105,14096,252,3,252,216660.0,130000.0,-51.0,-48.0,-42.0,-47.0,-51.0,-49.0,-43.0,-48.0,-90.0,-93.0,-89.0,-92.0,39.0,45.0,47.0,45.0,1
2681,CC:2F:71:3F:1F:24,4022781,775929712,258389,301124648,3764392,474805064,27,217213,248375185,217119,248363547,94,11638,207531,6,258389,23667,24,154,130000.0,43333.0,-73.0,-70.0,-75.0,-71.0,-72.0,-70.0,-75.0,-71.0,-90.0,-93.0,-89.0,-92.0,17.0,23.0,14.0,21.0,1
2682,CC:2F:71:3E:C5:1F,3764502,474818475,110,13411,3764392,474805064,0,437,37315,354,27335,83,9980,118,2,147,4,0,5,144444.0,43333.0,-70.0,-71.0,-66.0,-60.0,-70.0,-70.0,-66.0,-60.0,-90.0,-93.0,-89.0,-92.0,20.0,22.0,23.0,32.0,1
2683,BA:8C:B9:54:50:24,3764701,474895678,309,90614,3764392,474805064,0,1306,144287,1288,141441,18,2846,200,5,432,7,0,8,216660.0,130000.0,-40.0,-37.0,-46.0,-51.0,-43.0,-36.0,-44.0,-48.0,-90.0,-93.0,-89.0,-92.0,50.0,56.0,43.0,41.0,1
2684,92:69:1D:31:68:E9,3777222,490069213,12830,15264149,3764392,474805064,3,19383,3598940,18681,3437438,702,161502,6477,105,14096,252,3,252,216660.0,130000.0,-51.0,-48.0,-42.0,-47.0,-51.0,-49.0,-43.0,-48.0,-90.0,-93.0,-89.0,-92.0,39.0,45.0,47.0,45.0,1
2685,CC:2F:71:3F:1F:24,4022891,776048098,258494,301242570,3764397,474805528,27,217309,248489031,217215,248477393,94,11638,207622,6,258495,23672,24,154,130000.0,43333.0,-72.0,-70.0,-76.0,-71.0,-71.0,-68.0,-74.0,-70.0,-90.0,-93.0,-89.0,-92.0,18.0,23.0,13.0,21.0,1
2686,CC:2F:71:3E:C5:1F,3764507,474818939,110,13411,3764397,474805528,0,437,37315,354,27335,83,9980,118,2,147,4,0,5,144444.0,43333.0,-70.0,-71.0,-66.0,-60.0,-70.0,-70.0,-66.0,-60.0,-90.0,-93.0,-89.0,-92.0,20.0,22.0,23.0,32.0,1
2687,BA:8C:B9:54:50:24,3764706,474896142,309,90614,3764397,474805528,0,1306,144287,1288,141441,18,2846,200,5,432,7,0,8,216660.0,130000.0,-40.0,-37.0,-46.0,-51.0,-43.0,-36.0,-44.0,-48.0,-90.0,-93.0,-89.0,-92.0,50.0,56.0,43.0,41.0,1
2688,92:69:1D:31:68:E9,3777227,490069677,12830,15264149,3764397,474805528,3,19383,3598940,18681,3437438,702,161502,6477,105,14096,252,3,252,216660.0,130000.0,-51.0,-48.0,-42.0,-47.0,-51.0,-49.0,-43.0,-48.0,-90.0,-93.0,-89.0,-92.0,39.0,45.0,47.0,45.0,1
2689,CC:2F:71:3F:1F:24,4022997,776164892,258598,301359162,3764399,474805730,27,217401,248602221,217307,248590583,94,11638,207709,6,258599,23672,24,154,130000.0,43333.0,-72.0,-70.0,-76.0,-72.0,-72.0,-69.0,-75.0,-71.0,-90.0,-93.0,-89.0,-92.0,18.0,23.0,13.0,20.0,1
2690,CC:2F:71:3E:C5:1F,3764511,474819343,110,13411,3764401,474805932,0,437,37315,354,27335,83,9980,118,2,147,4,0,5,144444.0,43333.0,-70.0,-71.0,-66.0,-60.0,-70.0,-70.0,-66.0,-60.0,-90.0,-93.0,-89.0,-92.0,20.0,22.0,23.0,32.0,1
2691,BA:8C:B9:54:50:24,3764710,474896546,309,90614,3764401,474805932,0,1306,144287,1288,141441,18,2846,200,5,432,7,0,8,216660.0,130000.0,-40.0,-37.0,-46.0,-51.0,-43.0,-36.0,-44.0,-48.0,-90.0,-93.0,-89.0,-92.0,50.0,56.0,43.0,41.0,1
2692,92:69:1D:31:68:E9,3777231,490070081,12830,15264149,3764401,474805932,3,19383,3598940,18681,3437438,702,161502,6477,105,14096,252,3,252,216660.0,130000.0,-51.0,-48.0,-42.0,-47.0,-51.0,-49.0,-43.0,-48.0,-90.0,-93.0,-89.0,-92.0,39.0,45.0,47.0,45.0,1
2693,CC:2F:71:3F:1F:24,4023110,776285216,258705,301478880,3764405,474806336,27,217495,248715835,217401,248704197,94,11638,207798,6,258706,23677,24,154,117000.0,39000.0,-69.0,-66.0,-73.0,-69.0,-69.0,-66.0,-72.0,-69.0,-90.0,-93.0,-89.0,-92.0,21.0,27.0,16.0,23.0,1
2694,CC:2F:71:3E:C5:1F,3764515,474819747,110,13411,3764405,474806336,0,437,37315,354,27335,83,9980,118,2,147,4,0,5,144444.0,43333.0,-70.0,-71.0,-66.0,-60.0,-70.0,-70.0,-66.0,-60.0,-90.0,-93.0,-89.0,-92.0,20.0,22.0,23.0,32.0,1
2695,BA:8C:B9:54:50:24,3764714,474896950,309,90614,3764405,474806336,0,1306,144287,1288,141441,18,2846,200,5,432,7,0,8,216660.0,130000.0,-40.0,-37.0,-46.0,-51.0,-43.0,-36.0,-44.0,-48.0,-90.0,-93.0,-89.0,-92.0,50.0,56.0,43.0,41.0,1
2696,92:69:1D:31:68:E9,3777235,490070485,12830,15264149,3764405,474806336,3,19383,3598940,18681,3437438,702,161502,6477,105,14096,252,3,252,216660.0,130000.0,-51.0,-48.0,-42.0,-47.0,-51.0,-49.0,-43.0,-48.0,-90.0,-93.0,-89.0,-92.0,39.0,45.0,47.0,45.0,1
2697,CC:2F:71:3F:1F:24,4023225,776406983,258817,301600385,3764408,474806598,27,217593,248827398,217499,248815760,94,11638,207892,6,258818,23677,24,154,130000.0,43333.0,-72.0,-70.0,-76.0,-72.0,-71.0,-68.0,-74.0,-70.0,-90.0,-93.0,-89.0,-92.0,18.0,23.0,13.0,20.0,1
2698,CC:2F:71:3E:C5:1F,3764521,474820271,111,13471,3764410,474806800,0,438,37385,355,27405,83,9980,118,2,148,4,0,5,130000.0,39000.0,-70.0,-70.0,-66.0,-60.0,-70.0,-70.0,-66.0,-60.0,-90.0,-93.0,-89.0,-92.0,20.0,23.0,23.0,32.0,1
2699,BA:8C:B9:54:50:24,3764719,474897414,309,90614,3764410,474806800,0,1306,144287,1288,141441,18,2846,200,5,432,7,0,8,216660.0,130000.0,-40.0,-37.0,-46.0,-51.0,-43.0,-36.0,-44.0,-48.0,-90.0,-93.0,-89.0,-92.0,50.0,56.0,43.0,41.0,1
2700,92:69:1D:31:68:E9,3777241,490071065,12831,15264265,3764410,474806800,3,19385,3599076,18683,3437574,702,161502,6477,105,14097,252,3,252,216660.0,130000.0,-50.0,-48.0,-42.0,-47.0,-51.0,-49.0,-43.0,-48.0,-90.0,-93.0,-89.0,-92.0,40.0,45.0,47.0,45.0,1
2701,CC:2F:71:3F:1F:24,4023340,776530497,258926,301723293,3764414,474807204,27,217686,248942142,217592,248930504,94,11638,207983,6,258927,23677,24,154,130000.0,43333.0,-69.0,-66.0,-73.0,-68.0,-69.0,-66.0,-72.0,-68.0,-90.0,-93.0,-89.0,-92.0,21.0,27.0,16.0,24.0,1
2702,CC:2F:71:3E:C5:1F,3764525,474820675,111,13471,3764414,474807204,0,439,37455,356,27475,83,9980,118,2,148,4,0,5,130000.0,39000.0,-79.0,-86.0,-75.0,-71.0,-71.0,-72.0,-67.0,-61.0,-90.0,-93.0,-89.0,-92.0,11.0,7.0,14.0,21.0,1
2703,BA:8C:B9:54:50:24,3764724,474897934,310,90730,3764414,474807204,0,1312,144695,1294,141849,18,2846,200,5,433,7,0,8,216660.0,130000.0,-48.0,-35.0,-43.0,-45.0,-42.0,-35.0,-44.0,-47.0,-90.0,-93.0,-89.0,-92.0,42.0,58.0,46.0,47.0,1
2704,92:69:1D:31:68:E9,3777245,490071469,12831,15264265,3764414,474807204,3,19385,3599076,18683,3437574,702,161502,6477,105,14097,252,3,252,216660.0,130000.0,-50.0,-48.0,-42.0,-47.0,-51.0,-49.0,-43.0,-48.0,-90.0,-93.0,-89.0,-92.0,40.0,45.0,47.0,45.0,1
2705,CC:2F:71:3F:1F:24,4023449,776650237,259032,301842769,3764417,474807468,27,217776,249052196,217682,249040558,94,11638,208072,6,259033,23681,24,154,130000.0,43333.0,-69.0,-66.0,-72.0,-68.0,-68.0,-66.0,-72.0,-68.0,-90.0,-93.0,-90.0,-92.0,21.0,27.0,18.0,24.0,1
2706,CC:2F:71:3E:C5:1F,3764531,474821201,111,13471,3764420,474807730,0,441,37643,357,27545,84,10098,119,2,148,4,0,5,130000.0,39000.0,-70.0,-70.0,-66.0,-60.0,-71.0,-72.0,-67.0,-61.0,-90.0,-93.0,-90.0,-92.0,20.0,23.0,24.0,32.0,1
2707,BA:8C:B9:54:50:24,3764730,474898460,310,90730,3764420,474807730,0,1312,144695,1294,141849,18,2846,200,5,433,7,0,8,216660.0,130000.0,-48.0,-35.0,-43.0,-45.0,-42.0,-35.0,-44.0,-47.0,-90.0,-93.0,-90.0,-92.0,42.0,58.0,47.0,47.0,1
2708,92:69:1D:31:68:E9,3777251,490071995,12831,15264265,3764420,474807730,3,19385,3599076,18683,3437574,702,161502,6477,105,14097,252,3,252,216660.0,130000.0,-50.0,-48.0,-42.0,-47.0,-51.0,-49.0,-43.0,-48.0,-90.0,-93.0,-90.0,-92.0,40.0,45.0,48.0,45.0,1
2709,CC:2F:71:3F:1F:24,4023562,776769179,259138,301961045,3764424,474808134,27,217866,249163702,217772,249152064,94,11638,208159,6,259139,23682,24,154,130000.0,43333.0,-69.0,-67.0,-72.0,-68.0,-69.0,-67.0,-72.0,-68.0,-90.0,-93.0,-90.0,-92.0,21.0,26.0,18.0,24.0,1
2710,CC:2F:71:3E:C5:1F,3764535,474821605,111,13471,3764424,474808134,0,441,37643,357,27545,84,10098,119,2,148,4,0,5,130000.0,39000.0,-70.0,-70.0,-66.0,-60.0,-71.0,-72.0,-67.0,-61.0,-90.0,-93.0,-90.0,-92.0,20.0,23.0,24.0,32.0,1
2711,BA:8C:B9:54:50:24,3764734,474898864,310,90730,3764424,474808134,0,1312,144695,1294,141849,18,2846,200,5,433,7,0,8,216660.0,130000.0,-48.0,-35.0,-43.0,-45.0,-42.0,-35.0,-44.0,-47.0,-90.0,-93.0,-90.0,-92.0,42.0,58.0,47.0,47.0,1
2712,92:69:1D:31:68:E9,3777255,490072399,12831,15264265,3764424,474808134,3,19385,3599076,18683,3437574,702,161502,6477,105,14097,252,3,252,216660.0,130000.0,-50.0,-48.0,-42.0,-47.0,-51.0,-49.0,-43.0,-48.0,-90.0,-93.0,-90.0,-92.0,40.0,45.0,48.0,45.0,1
2713,CC:2F:71:3F:1F:24,4023676,776890998,259250,302082662,3764426,474808336,27,217964,249276738,217870,249265100,94,11638,208253,6,259251,23683,24,154,130000.0,43333.0,-69.0,-67.0,-72.0,-68.0,-68.0,-66.0,-72.0,-68.0,-90.0,-93.0,-90.0,-92.0,21.0,26.0,18.0,24.0,1
2714,CC:2F:71:3E:C5:1F,3764537,474821807,111,13471,3764426,474808336,0,441,37643,357,27545,84,10098,119,2,148,4,0,5,130000.0,39000.0,-70.0,-70.0,-66.0,-60.0,-71.0,-72.0,-67.0,-61.0,-90.0,-93.0,-90.0,-92.0,20.0,23.0,24.0,32.0,1
2715,BA:8C:B9:54:50:24,3764736,474899066,310,90730,3764426,474808336,0,1312,144695,1294,141849,18,2846,200,5,433,7,0,8,216660.0,130000.0,-48.0,-35.0,-43.0,-45.0,-42.0,-35.0,-44.0,-47.0,-90.0,-93.0,-90.0,-92.0,42.0,58.0,47.0,47.0,1
2716,92:69:1D:31:68:E9,3777259,490072803,12831,15264265,3764428,474808538,3,19385,3599076,18683,3437574,702,161502,6477,105,14097,252,3,252,216660.0,130000.0,-50.0,-48.0,-42.0,-47.0,-51.0,-49.0,-43.0,-48.0,-90.0,-93.0,-90.0,-92.0,40.0,45.0,48.0,45.0,1
2717,CC:2F:71:3F:1F:24,4023789,777012622,259358,302203822,3764431,474808800,27,218055,249388332,217961,249376694,94,11638,208343,6,259359,23690,24,154,130000.0,43333.0,-69.0,-66.0,-72.0,-68.0,-68.0,-66.0,-72.0,-68.0,-90.0,-93.0,-90.0,-92.0,21.0,27.0,18.0,24.0,1
2718,CC:2F:71:3E:C5:1F,3764544,474822473,111,13471,3764433,474809002,0,441,37643,357,27545,84,10098,119,2,148,4,0,5,130000.0,39000.0,-70.0,-70.0,-66.0,-60.0,-71.0,-72.0,-67.0,-61.0,-90.0,-93.0,-90.0,-92.0,20.0,23.0,24.0,32.0,1
2719,BA:8C:B9:54:50:24,3764743,474899732,310,90730,3764433,474809002,0,1312,144695,1294,141849,18,2846,200,5,433,7,0,8,216660.0,130000.0,-48.0,-35.0,-43.0,-45.0,-42.0,-35.0,-44.0,-47.0,-90.0,-93.0,-90.0,-92.0,42.0,58.0,47.0,47.0,1
2720,92:69:1D:31:68:E9,3777264,490073267,12831,15264265,3764433,474809002,3,19385,3599076,18683,3437574,702,161502,6477,105,14097,252,3,252,216660.0,130000.0,-50.0,-48.0,-42.0,-47.0,-51.0,-49.0,-43.0,-48.0,-90.0,-93.0,-90.0,-92.0,40.0,45.0,48.0,45.0,1
2721,CC:2F:71:3F:1F:24,4023899,777129654,259464,302320450,3764435,474809204,27,218144,249498298,218050,249486660,94,11638,208429,6,259465,23694,24,154,130000.0,43333.0,-69.0,-67.0,-73.0,-68.0,-69.0,-67.0,-72.0,-68.0,-90.0,-93.0,-90.0,-92.0,21.0,26.0,17.0,24.0,1
2722,CC:2F:71:3E:C5:1F,3764546,474822675,111,13471,3764435,474809204,0,441,37643,357,27545,84,10098,119,2,148,4,0,5,130000.0,39000.0,-70.0,-70.0,-66.0,-60.0,-71.0,-72.0,-67.0,-61.0,-90.0,-93.0,-90.0,-92.0,20.0,23.0,24.0,32.0,1
2723,BA:8C:B9:54:50:24,3764745,474899934,310,90730,3764435,474809204,0,1312,144695,1294,141849,18,2846,200,5,433,7,0,8,216660.0,130000.0,-48.0,-35.0,-43.0,-45.0,-42.0,-35.0,-44.0,-47.0,-90.0,-93.0,-90.0,-92.0,42.0,58.0,47.0,47.0,1
2724,92:69:1D:31:68:E9,3777268,490073671,12831,15264265,3764437,474809406,3,19385,3599076,18683,3437574,702,161502,6477,105,14097,252,3,252,216660.0,130000.0,-50.0,-48.0,-42.0,-47.0,-51.0,-49.0,-43.0,-48.0,-90.0,-93.0,-90.0,-92.0,40.0,45.0,48.0,45.0,1
2725,CC:2F:71:3F:1F:24,4024013,777251729,259572,302441722,3764441,474810007,27,218244,249611074,218150,249599436,94,11638,208525,6,259573,23699,24,154,117000.0,39000.0,-68.0,-66.0,-72.0,-68.0,-68.0,-66.0,-72.0,-68.0,-90.0,-93.0,-90.0,-92.0,22.0,27.0,18.0,24.0,1
2726,CC:2F:71:3E:C5:1F,3764554,474823680,111,13471,3764443,474810209,0,441,37643,357,27545,84,10098,119,2,148,4,0,5,130000.0,39000.0,-70.0,-70.0,-66.0,-60.0,-71.0,-72.0,-67.0,-61.0,-90.0,-93.0,-90.0,-92.0,20.0,23.0,24.0,32.0,1
2727,BA:8C:B9:54:50:24,3764753,474900939,310,90730,3764443,474810209,0,1312,144695,1294,141849,18,2846,200,5,433,7,0,8,216660.0,130000.0,-48.0,-35.0,-43.0,-45.0,-42.0,-35.0,-44.0,-47.0,-90.0,-93.0,-90.0,-92.0,42.0,58.0,47.0,47.0,1
2728,92:69:1D:31:68:E9,3777274,490074474,12831,15264265,3764443,474810209,3,19385,3599076,18683,3437574,702,161502,6477,105,14097,252,3,252,216660.0,130000.0,-50.0,-48.0,-42.0,-47.0,-51.0,-49.0,-43.0,-48.0,-90.0,-93.0,-90.0,-92.0,40.0,45.0,48.0,45.0,1
2729,CC:2F:71:3F:1F:24,4024131,777373604,259685,302563133,3764446,474810471,27,218348,249729030,218254,249717392,94,11638,208622,6,259686,23704,24,154,130000.0,43333.0,-69.0,-66.0,-72.0,-69.0,-69.0,-66.0,-72.0,-69.0,-90.0,-93.0,-90.0,-92.0,21.0,27.0,18.0,23.0,1
2730,CC:2F:71:3E:C5:1F,3764557,474823942,111,13471,3764446,474810471,0,441,37643,357,27545,84,10098,119,2,148,4,0,5,130000.0,39000.0,-70.0,-70.0,-66.0,-60.0,-71.0,-72.0,-67.0,-61.0,-90.0,-93.0,-90.0,-92.0,20.0,23.0,24.0,32.0,1
2731,BA:8C:B9:54:50:24,3764756,474901201,310,90730,3764446,474810471,0,1312,144695,1294,141849,18,2846,200,5,433,7,0,8,216660.0,130000.0,-48.0,-35.0,-43.0,-45.0,-42.0,-35.0,-44.0,-47.0,-90.0,-93.0,-90.0,-92.0,42.0,58.0,47.0,47.0,1
2732,92:69:1D:31:68:E9,3777279,490074938,12831,15264265,3764448,474810673,3,19385,3599076,18683,3437574,702,161502,6477,105,14097,252,3,252,216660.0,130000.0,-50.0,-48.0,-42.0,-47.0,-51.0,-49.0,-43.0,-48.0,-90.0,-93.0,-90.0,-92.0,40.0,45.0,48.0,45.0,1
2733,CC:2F:71:3F:1F:24,4024240,777492154,259790,302681279,3764450,474810875,27,218440,249838158,218346,249826520,94,11638,208710,6,259791,23704,24,154,130000.0,43333.0,-68.0,-66.0,-73.0,-68.0,-68.0,-66.0,-72.0,-68.0,-90.0,-93.0,-90.0,-92.0,22.0,27.0,17.0,24.0,1
2734,CC:2F:71:3E:C5:1F,3764561,474824346,111,13471,3764450,474810875,0,441,37643,357,27545,84,10098,119,2,148,4,0,5,130000.0,39000.0,-70.0,-70.0,-66.0,-60.0,-71.0,-72.0,-67.0,-61.0,-90.0,-93.0,-90.0,-92.0,20.0,23.0,24.0,32.0,1
2735,BA:8C:B9:54:50:24,3764762,474901807,310,90730,3764452,474811077,0,1312,144695,1294,141849,18,2846,200,5,433,7,0,8,216660.0,130000.0,-48.0,-35.0,-43.0,-45.0,-42.0,-35.0,-44.0,-47.0,-90.0,-93.0,-90.0,-92.0,42.0,58.0,47.0,47.0,1
2736,92:69:1D:31:68:E9,3777283,490075342,12831,15264265,3764452,474811077,3,19385,3599076,18683,3437574,702,161502,6477,105,14097,252,3,252,216660.0,130000.0,-50.0,-48.0,-42.0,-47.0,-51.0,-49.0,-43.0,-48.0,-90.0,-93.0,-90.0,-92.0,40.0,45.0,48.0,45.0,1
2737,CC:2F:71:3F:1F:24,4024350,777610610,259896,302799331,3764454,474811279,27,218531,249949780,218437,249938142,94,11638,208798,6,259897,23709,24,154,130000.0,43333.0,-68.0,-66.0,-73.0,-68.0,-68.0,-66.0,-72.0,-68.0,-90.0,-93.0,-90.0,-92.0,22.0,27.0,17.0,24.0,1
2738,CC:2F:71:3E:C5:1F,3764565,474824750,111,13471,3764454,474811279,0,441,37643,357,27545,84,10098,119,2,148,4,0,5,130000.0,39000.0,-70.0,-70.0,-66.0,-60.0,-71.0,-72.0,-67.0,-61.0,-90.0,-93.0,-90.0,-92.0,20.0,23.0,24.0,32.0,1
2739,BA:8C:B9:54:50:24,3764765,474902069,310,90730,3764455,474811339,0,1312,144695,1294,141849,18,2846,200,5,433,7,0,8,216660.0,130000.0,-48.0,-35.0,-43.0,-45.0,-42.0,-35.0,-44.0,-47.0,-90.0,-93.0,-90.0,-92.0,42.0,58.0,47.0,47.0,1
2740,92:69:1D:31:68:E9,3777286,490075604,12831,15264265,3764455,474811339,3,19385,3599076,18683,3437574,702,161502,6477,105,14097,252,3,252,216660.0,130000.0,-50.0,-48.0,-42.0,-47.0,-51.0,-49.0,-43.0,-48.0,-90.0,-93.0,-90.0,-92.0,40.0,45.0,48.0,45.0,1
2741,CC:2F:71:3F:1F:24,4024462,777732328,260003,302920585,3764459,474811743,27,218627,250064954,218533,250053316,94,11638,208889,6,260004,23709,24,154,130000.0,43333.0,-68.0,-66.0,-72.0,-69.0,-68.0,-66.0,-72.0,-68.0,-90.0,-93.0,-90.0,-92.0,22.0,27.0,18.0,23.0,1
2742,CC:2F:71:3E:C5:1F,3764570,474825214,111,13471,3764459,474811743,0,441,37643,357,27545,84,10098,119,2,148,4,0,5,130000.0,39000.0,-70.0,-70.0,-66.0,-60.0,-71.0,-72.0,-67.0,-61.0,-90.0,-93.0,-90.0,-92.0,20.0,23.0,24.0,32.0,1
2743,BA:8C:B9:54:50:24,3764771,474902675,310,90730,3764461,474811945,0,1312,144695,1294,141849,18,2846,200,5,433,7,0,8,216660.0,130000.0,-48.0,-35.0,-43.0,-45.0,-42.0,-35.0,-44.0,-47.0,-90.0,-93.0,-90.0,-92.0,42.0,58.0,47.0,47.0,1
2744,92:69:1D:31:68:E9,3777292,490076210,12831,15264265,3764461,474811945,3,19386,3599144,18684,3437642,702,161502,6477,105,14097,252,3,252,216660.0,130000.0,-52.0,-47.0,-45.0,-50.0,-51.0,-49.0,-44.0,-49.0,-90.0,-93.0,-90.0,-92.0,38.0,46.0,45.0,42.0,1
2745,CC:2F:71:3F:1F:24,4024601,777865372,260115,303042202,3764486,474823170,27,218727,250182425,218633,250170787,94,11638,208983,6,260116,23710,24,154,130000.0,43333.0,-68.0,-66.0,-73.0,-68.0,-68.0,-66.0,-72.0,-68.0,-90.0,-93.0,-90.0,-92.0,22.0,27.0,17.0,24.0,1
2746,CC:2F:71:3E:C5:1F,3764597,474836641,111,13471,3764486,474823170,0,441,37643,357,27545,84,10098,119,2,148,4,0,5,130000.0,39000.0,-70.0,-70.0,-66.0,-60.0,-71.0,-72.0,-67.0,-61.0,-90.0,-93.0,-90.0,-92.0,20.0,23.0,24.0,32.0,1
2747,BA:8C:B9:54:50:24,3764796,474913900,310,90730,3764486,474823170,0,1312,144695,1294,141849,18,2846,200,5,433,7,0,8,216660.0,130000.0,-48.0,-35.0,-43.0,-45.0,-42.0,-35.0,-44.0,-47.0,-90.0,-93.0,-90.0,-92.0,42.0,58.0,47.0,47.0,1
2748,92:69:1D:31:68:E9,3777317,490087435,12831,15264265,3764486,474823170,3,19389,3599515,18686,3437778,703,161737,6478,105,14097,252,3,252,216660.0,130000.0,-51.0,-47.0,-42.0,-48.0,-51.0,-48.0,-43.0,-48.0,-90.0,-93.0,-90.0,-92.0,39.0,46.0,48.0,44.0,1
2749,CC:2F:71:3F:1F:24,4024710,777983618,260220,303160124,3764490,474823494,27,218820,250292857,218725,250281101,95,11756,209073,6,260221,23714,24,154,130000.0,43333.0,-67.0,-66.0,-72.0,-68.0,-67.0,-66.0,-72.0,-68.0,-90.0,-93.0,-90.0,-92.0,23.0,27.0,18.0,24.0,1
2750,CC:2F:71:3E:C5:1F,3764601,474836965,111,13471,3764490,474823494,0,441,37643,357,27545,84,10098,119,2,148,4,0,5,130000.0,39000.0,-70.0,-70.0,-66.0,-60.0,-71.0,-72.0,-67.0,-61.0,-90.0,-93.0,-90.0,-92.0,20.0,23.0,24.0,32.0,1
2751,BA:8C:B9:54:50:24,3764804,474914628,310,90730,3764494,474823898,0,1312,144695,1294,141849,18,2846,200,5,433,7,0,8,216660.0,130000.0,-48.0,-35.0,-43.0,-45.0,-42.0,-35.0,-44.0,-47.0,-90.0,-93.0,-90.0,-92.0,42.0,58.0,47.0,47.0,1
2752,92:69:1D:31:68:E9,3777325,490088163,12831,15264265,3764494,474823898,3,19389,3599515,18686,3437778,703,161737,6478,105,14097,252,3,252,216660.0,130000.0,-51.0,-47.0,-42.0,-48.0,-51.0,-48.0,-43.0,-48.0,-90.0,-93.0,-90.0,-92.0,39.0,46.0,48.0,44.0,1
2753,CC:2F:71:3F:1F:24,4024826,778107400,260328,303282932,3764498,474824468,27,218914,250409251,218819,250397495,95,11756,209163,6,260329,23714,24,154,130000.0,43333.0,-68.0,-66.0,-72.0,-68.0,-67.0,-66.0,-72.0,-68.0,-90.0,-93.0,-90.0,-92.0,22.0,27.0,18.0,24.0,1
2754,CC:2F:71:3E:C5:1F,3764609,474837939,111,13471,3764498,474824468,0,443,37783,359,27685,84,10098,119,2,149,4,0,5,130000.0,39000.0,-70.0,-70.0,-66.0,-60.0,-71.0,-72.0,-67.0,-61.0,-90.0,-93.0,-90.0,-92.0,20.0,23.0,24.0,32.0,1
2755,BA:8C:B9:54:50:24,3764808,474915198,310,90730,3764498,474824468,0,1314,144831,1296,141985,18,2846,200,5,434,7,0,8,216660.0,130000.0,-40.0,-37.0,-45.0,-51.0,-42.0,-35.0,-44.0,-47.0,-90.0,-93.0,-90.0,-92.0,50.0,56.0,45.0,41.0,1
2756,92:69:1D:31:68:E9,3777329,490088733,12831,15264265,3764498,474824468,3,19389,3599515,18686,3437778,703,161737,6478,105,14097,252,3,252,216660.0,130000.0,-51.0,-47.0,-42.0,-48.0,-51.0,-48.0,-43.0,-48.0,-90.0,-93.0,-90.0,-92.0,39.0,46.0,48.0,44.0,1
2757,CC:2F:71:3F:1F:24,4024933,778225636,260433,303400966,3764500,474824670,27,219005,250522311,218910,250510555,95,11756,209250,6,260434,23718,24,154,117000.0,39000.0,-68.0,-66.0,-73.0,-68.0,-68.0,-66.0,-72.0,-68.0,-90.0,-93.0,-90.0,-92.0,22.0,27.0,17.0,24.0,1
2758,CC:2F:71:3E:C5:1F,3764611,474838141,111,13471,3764500,474824670,0,443,37783,359,27685,84,10098,119,2,149,4,0,5,130000.0,39000.0,-70.0,-70.0,-66.0,-60.0,-71.0,-72.0,-67.0,-61.0,-90.0,-93.0,-90.0,-92.0,20.0,23.0,24.0,32.0,1
2759,BA:8C:B9:54:50:24,3764812,474915602,310,90730,3764502,474824872,0,1314,144831,1296,141985,18,2846,200,5,434,7,0,8,216660.0,130000.0,-40.0,-37.0,-45.0,-51.0,-42.0,-35.0,-44.0,-47.0,-90.0,-93.0,-90.0,-92.0,50.0,56.0,45.0,41.0,1
2760,92:69:1D:31:68:E9,3777335,490089339,12831,15264265,3764504,474825074,3,19389,3599515,18686,3437778,703,161737,6478,105,14097,252,3,252,216660.0,130000.0,-51.0,-47.0,-42.0,-48.0,-51.0,-48.0,-43.0,-48.0,-90.0,-93.0,-90.0,-92.0,39.0,46.0,48.0,44.0,1
2761,CC:2F:71:3F:1F:24,4025055,778349607,260548,303524271,3764507,474825336,27,219105,250635519,219010,250623763,95,11756,209346,6,260549,23718,24,154,130000.0,43333.0,-68.0,-66.0,-73.0,-68.0,-68.0,-66.0,-73.0,-68.0,-90.0,-93.0,-90.0,-92.0,22.0,27.0,17.0,24.0,1
2762,CC:2F:71:3E:C5:1F,3764618,474838807,111,13471,3764507,474825336,0,443,37783,359,27685,84,10098,119,2,149,4,0,5,130000.0,39000.0,-70.0,-70.0,-66.0,-60.0,-71.0,-72.0,-67.0,-61.0,-90.0,-93.0,-90.0,-92.0,20.0,23.0,24.0,32.0,1
2763,BA:8C:B9:54:50:24,3764817,474916066,310,90730,3764507,474825336,0,1314,144831,1296,141985,18,2846,200,5,434,7,0,8,216660.0,130000.0,-40.0,-37.0,-45.0,-51.0,-42.0,-35.0,-44.0,-47.0,-90.0,-93.0,-90.0,-92.0,50.0,56.0,45.0,41.0,1
2764,92:69:1D:31:68:E9,3777338,490089601,12831,15264265,3764507,474825336,3,19389,3599515,18686,3437778,703,161737,6478,105,14097,252,3,252,216660.0,130000.0,-51.0,-47.0,-42.0,-48.0,-51.0,-48.0,-43.0,-48.0,-90.0,-93.0,-90.0,-92.0,39.0,46.0,48.0,44.0,1
2765,CC:2F:71:3F:1F:24,4025162,778467955,260653,303642417,3764509,474825538,27,219198,250747641,219103,250735885,95,11756,209434,6,260654,23718,24,154,130000.0,43333.0,-68.0,-66.0,-73.0,-69.0,-68.0,-66.0,-72.0,-68.0,-90.0,-93.0,-90.0,-92.0,22.0,27.0,17.0,23.0,1
2766,CC:2F:71:3E:C5:1F,3764620,474839009,111,13471,3764509,474825538,0,443,37783,359,27685,84,10098,119,2,149,4,0,5,130000.0,39000.0,-70.0,-70.0,-66.0,-60.0,-71.0,-72.0,-67.0,-61.0,-90.0,-93.0,-90.0,-92.0,20.0,23.0,24.0,32.0,1
2767,BA:8C:B9:54:50:24,3764819,474916268,310,90730,3764509,474825538,0,1314,144831,1296,141985,18,2846,200,5,434,7,0,8,216660.0,130000.0,-40.0,-37.0,-45.0,-51.0,-42.0,-35.0,-44.0,-47.0,-90.0,-93.0,-90.0,-92.0,50.0,56.0,45.0,41.0,1
2768,92:69:1D:31:68:E9,3777340,490089803,12831,15264265,3764509,474825538,3,19389,3599515,18686,3437778,703,161737,6478,105,14097,252,3,252,216660.0,130000.0,-51.0,-47.0,-42.0,-48.0,-51.0,-48.0,-43.0,-48.0,-90.0,-93.0,-90.0,-92.0,39.0,46.0,48.0,44.0,1
2769,CC:2F:71:3F:1F:24,4025274,778586669,260759,303760525,3764515,474826144,27,219289,250855039,219194,250843283,95,11756,209522,6,260759,23726,24,154,144444.0,43333.0,-68.0,-66.0,-73.0,-69.0,-68.0,-66.0,-72.0,-69.0,-90.0,-93.0,-90.0,-92.0,22.0,27.0,17.0,23.0,1
2770,CC:2F:71:3E:C5:1F,3764626,474839615,111,13471,3764515,474826144,0,443,37783,359,27685,84,10098,119,2,149,4,0,5,130000.0,39000.0,-70.0,-70.0,-66.0,-60.0,-71.0,-72.0,-67.0,-61.0,-90.0,-93.0,-90.0,-92.0,20.0,23.0,24.0,32.0,1
2771,BA:8C:B9:54:50:24,3764825,474916874,310,90730,3764515,474826144,0,1314,144831,1296,141985,18,2846,200,5,434,7,0,8,216660.0,130000.0,-40.0,-37.0,-45.0,-51.0,-42.0,-35.0,-44.0,-47.0,-90.0,-93.0,-90.0,-92.0,50.0,56.0,45.0,41.0,1
2772,92:69:1D:31:68:E9,3777347,490090469,12831,15264265,3764516,474826204,3,19389,3599515,18686,3437778,703,161737,6478,105,14097,252,3,252,216660.0,130000.0,-51.0,-47.0,-42.0,-48.0,-51.0,-48.0,-43.0,-48.0,-90.0,-93.0,-90.0,-92.0,39.0,46.0,48.0,44.0,1
2773,CC:2F:71:3F:1F:24,4025384,778708017,260866,303881611,3764518,474826406,27,219385,250974531,219290,250962775,95,11756,209612,6,260867,23732,24,154,117000.0,39000.0,-68.0,-66.0,-73.0,-69.0,-68.0,-66.0,-72.0,-69.0,-90.0,-93.0,-90.0,-92.0,22.0,27.0,17.0,23.0,1
2774,CC:2F:71:3E:C5:1F,3764629,474839877,111,13471,3764518,474826406,0,443,37783,359,27685,84,10098,119,2,149,4,0,5,130000.0,39000.0,-70.0,-70.0,-66.0,-60.0,-71.0,-72.0,-67.0,-61.0,-90.0,-93.0,-90.0,-92.0,20.0,23.0,24.0,32.0,1
2775,BA:8C:B9:54:50:24,3764828,474917136,310,90730,3764518,474826406,0,1314,144831,1296,141985,18,2846,200,5,434,7,0,8,216660.0,130000.0,-40.0,-37.0,-45.0,-51.0,-42.0,-35.0,-44.0,-47.0,-90.0,-93.0,-90.0,-92.0,50.0,56.0,45.0,41.0,1
2776,92:69:1D:31:68:E9,3777349,490090671,12831,15264265,3764518,474826406,3,19389,3599515,18686,3437778,703,161737,6478,105,14097,252,3,252,216660.0,130000.0,-51.0,-47.0,-42.0,-48.0,-51.0,-48.0,-43.0,-48.0,-90.0,-93.0,-90.0,-92.0,39.0,46.0,48.0,44.0,1
2777,CC:2F:71:3F:1F:24,4025504,778831955,260979,304004670,3764525,474827285,27,219485,251090692,219390,251078936,95,11756,209707,6,260980,23732,24,154,130000.0,43333.0,-68.0,-66.0,-72.0,-68.0,-68.0,-66.0,-72.0,-68.0,-90.0,-93.0,-90.0,-92.0,22.0,27.0,18.0,24.0,1
2778,CC:2F:71:3E:C5:1F,3764636,474840756,111,13471,3764525,474827285,0,443,37783,359,27685,84,10098,119,2,149,4,0,5,130000.0,39000.0,-70.0,-70.0,-66.0,-60.0,-71.0,-72.0,-67.0,-61.0,-90.0,-93.0,-90.0,-92.0,20.0,23.0,24.0,32.0,1
2779,BA:8C:B9:54:50:24,3764835,474918015,310,90730,3764525,474827285,0,1314,144831,1296,141985,18,2846,200,5,434,7,0,8,216660.0,130000.0,-40.0,-37.0,-45.0,-51.0,-42.0,-35.0,-44.0,-47.0,-90.0,-93.0,-90.0,-92.0,50.0,56.0,45.0,41.0,1
2780,92:69:1D:31:68:E9,3777356,490091550,12831,15264265,3764525,474827285,3,19389,3599515,18686,3437778,703,161737,6478,105,14097,252,3,252,216660.0,130000.0,-51.0,-47.0,-42.0,-48.0,-51.0,-48.0,-43.0,-48.0,-90.0,-93.0,-90.0,-92.0,39.0,46.0,48.0,44.0,1
2781,CC:2F:71:3F:1F:24,4025612,778950139,261084,304122592,3764528,474827547,27,219580,251204430,219485,251192674,95,11756,209793,6,261085,23736,24,154,130000.0,43333.0,-68.0,-66.0,-73.0,-69.0,-68.0,-66.0,-72.0,-69.0,-90.0,-93.0,-90.0,-92.0,22.0,27.0,17.0,23.0,1
2782,CC:2F:71:3E:C5:1F,3764639,474841018,111,13471,3764528,474827547,0,443,37783,359,27685,84,10098,119,2,149,4,0,5,130000.0,39000.0,-70.0,-70.0,-66.0,-60.0,-71.0,-72.0,-67.0,-61.0,-90.0,-93.0,-90.0,-92.0,20.0,23.0,24.0,32.0,1
2783,BA:8C:B9:54:50:24,3764838,474918277,310,90730,3764528,474827547,0,1314,144831,1296,141985,18,2846,200,5,434,7,0,8,216660.0,130000.0,-40.0,-37.0,-45.0,-51.0,-42.0,-35.0,-44.0,-47.0,-90.0,-93.0,-90.0,-92.0,50.0,56.0,45.0,41.0,1
2784,92:69:1D:31:68:E9,3777359,490091812,12831,15264265,3764528,474827547,3,19389,3599515,18686,3437778,703,161737,6478,105,14097,252,3,252,216660.0,130000.0,-51.0,-47.0,-42.0,-48.0,-51.0,-48.0,-43.0,-48.0,-90.0,-93.0,-90.0,-92.0,39.0,46.0,48.0,44.0,1
2785,CC:2F:71:3F:1F:24,4025723,779068891,261189,304240738,3764534,474828153,27,219677,251321048,219582,251309292,95,11756,209885,6,261190,23736,24,154,130000.0,43333.0,-69.0,-66.0,-73.0,-69.0,-68.0,-66.0,-73.0,-69.0,-90.0,-93.0,-90.0,-92.0,21.0,27.0,17.0,23.0,1
2786,CC:2F:71:3E:C5:1F,3764645,474841624,111,13471,3764534,474828153,0,443,37783,359,27685,84,10098,119,2,149,4,0,5,130000.0,39000.0,-70.0,-70.0,-66.0,-60.0,-71.0,-72.0,-67.0,-61.0,-90.0,-93.0,-90.0,-92.0,20.0,23.0,24.0,32.0,1
2787,BA:8C:B9:54:50:24,3764844,474918883,310,90730,3764534,474828153,0,1314,144831,1296,141985,18,2846,200,5,434,7,0,8,216660.0,130000.0,-40.0,-37.0,-45.0,-51.0,-42.0,-35.0,-44.0,-47.0,-90.0,-93.0,-90.0,-92.0,50.0,56.0,45.0,41.0,1
2788,92:69:1D:31:68:E9,3777365,490092418,12831,15264265,3764534,474828153,3,19389,3599515,18686,3437778,703,161737,6478,105,14097,252,3,252,216660.0,130000.0,-51.0,-47.0,-42.0,-48.0,-51.0,-48.0,-43.0,-48.0,-90.0,-93.0,-90.0,-92.0,39.0,46.0,48.0,44.0,1
2789,CC:2F:71:3F:1F:24,4025832,779190291,261296,304361936,3764536,474828355,27,219769,251434238,219674,251422482,95,11756,209975,6,261297,23738,24,154,130000.0,39000.0,-72.0,-70.0,-76.0,-72.0,-72.0,-70.0,-76.0,-72.0,-90.0,-93.0,-90.0,-92.0,18.0,23.0,14.0,20.0,1
2790,CC:2F:71:3E:C5:1F,3764647,474841826,111,13471,3764536,474828355,0,443,37783,359,27685,84,10098,119,2,149,4,0,5,130000.0,39000.0,-70.0,-70.0,-66.0,-60.0,-71.0,-72.0,-67.0,-61.0,-90.0,-93.0,-90.0,-92.0,20.0,23.0,24.0,32.0,1
2791,BA:8C:B9:54:50:24,3764846,474919085,310,90730,3764536,474828355,0,1314,144831,1296,141985,18,2846,200,5,434,7,0,8,216660.0,130000.0,-40.0,-37.0,-45.0,-51.0,-42.0,-35.0,-44.0,-47.0,-90.0,-93.0,-90.0,-92.0,50.0,56.0,45.0,41.0,1
2792,92:69:1D:31:68:E9,3777367,490092620,12831,15264265,3764536,474828355,3,19389,3599515,18686,3437778,703,161737,6478,105,14097,252,3,252,216660.0,130000.0,-51.0,-47.0,-42.0,-48.0,-51.0,-48.0,-43.0,-48.0,-90.0,-93.0,-90.0,-92.0,39.0,46.0,48.0,44.0,1
2793,CC:2F:71:3F:1F:24,4025952,779315384,261409,304486363,3764543,474829021,27,219872,251553589,219777,251541833,95,11756,210070,6,261408,23760,24,154,130000.0,43333.0,-68.0,-66.0,-74.0,-69.0,-71.0,-69.0,-76.0,-72.0,-90.0,-93.0,-90.0,-92.0,22.0,27.0,16.0,23.0,1
2794,CC:2F:71:3E:C5:1F,3764654,474842492,111,13471,3764543,474829021,0,443,37783,359,27685,84,10098,119,2,149,4,0,5,130000.0,39000.0,-70.0,-70.0,-66.0,-60.0,-71.0,-72.0,-67.0,-61.0,-90.0,-93.0,-90.0,-92.0,20.0,23.0,24.0,32.0,1
2795,BA:8C:B9:54:50:24,3764853,474919751,310,90730,3764543,474829021,0,1314,144831,1296,141985,18,2846,200,5,434,7,0,8,216660.0,130000.0,-40.0,-37.0,-45.0,-51.0,-42.0,-35.0,-44.0,-47.0,-90.0,-93.0,-90.0,-92.0,50.0,56.0,45.0,41.0,1
2796,92:69:1D:31:68:E9,3777374,490093286,12831,15264265,3764543,474829021,3,19389,3599515,18686,3437778,703,161737,6478,105,14097,252,3,252,216660.0,130000.0,-51.0,-47.0,-42.0,-48.0,-51.0,-48.0,-43.0,-48.0,-90.0,-93.0,-90.0,-92.0,39.0,46.0,48.0,44.0,1
2797,CC:2F:71:3F:1F:24,4026059,779434932,261514,304605709,3764545,474829223,27,219965,251668319,219870,251656563,95,11756,210158,6,261514,23762,24,154,130000.0,43333.0,-72.0,-70.0,-77.0,-72.0,-71.0,-69.0,-76.0,-71.0,-90.0,-93.0,-90.0,-92.0,18.0,23.0,13.0,20.0,1
2798,CC:2F:71:3E:C5:1F,3764656,474842694,111,13471,3764545,474829223,0,443,37783,359,27685,84,10098,119,2,149,4,0,5,130000.0,39000.0,-70.0,-70.0,-66.0,-60.0,-71.0,-72.0,-67.0,-61.0,-90.0,-93.0,-90.0,-92.0,20.0,23.0,24.0,32.0,1
2799,BA:8C:B9:54:50:24,3764855,474919953,310,90730,3764545,474829223,0,1314,144831,1296,141985,18,2846,200,5,434,7,0,8,216660.0,130000.0,-40.0,-37.0,-45.0,-51.0,-42.0,-35.0,-44.0,-47.0,-90.0,-93.0,-90.0,-92.0,50.0,56.0,45.0,41.0,1
2800,92:69:1D:31:68:E9,3777376,490093488,12831,15264265,3764545,474829223,3,19389,3599515,18686,3437778,703,161737,6478,105,14097,252,3,252,216660.0,130000.0,-51.0,-47.0,-42.0,-48.0,-51.0,-48.0,-43.0,-48.0,-90.0,-93.0,-90.0,-92.0,39.0,46.0,48.0,44.0,1
2801,CC:2F:71:3F:1F:24,4026171,779555014,261620,304725185,3764551,474829829,27,220058,251783035,219963,251771279,95,11756,210247,6,261621,23765,24,154,130000.0,43333.0,-73.0,-70.0,-76.0,-72.0,-72.0,-70.0,-76.0,-72.0,-90.0,-93.0,-90.0,-92.0,17.0,23.0,14.0,20.0,1
2802,CC:2F:71:3E:C5:1F,3764662,474843300,111,13471,3764551,474829829,0,443,37783,359,27685,84,10098,119,2,149,4,0,5,130000.0,39000.0,-70.0,-70.0,-66.0,-60.0,-71.0,-72.0,-67.0,-61.0,-90.0,-93.0,-90.0,-92.0,20.0,23.0,24.0,32.0,1
2803,BA:8C:B9:54:50:24,3764862,474920619,310,90730,3764552,474829889,0,1315,144899,1297,142053,18,2846,200,5,434,7,0,8,216660.0,130000.0,-40.0,-37.0,-45.0,-51.0,-42.0,-35.0,-44.0,-47.0,-90.0,-93.0,-90.0,-92.0,50.0,56.0,45.0,41.0,1
2804,92:69:1D:31:68:E9,3777383,490094154,12831,15264265,3764552,474829889,3,19389,3599515,18686,3437778,703,161737,6478,105,14097,252,3,252,216660.0,130000.0,-51.0,-47.0,-42.0,-48.0,-51.0,-48.0,-43.0,-48.0,-90.0,-93.0,-90.0,-92.0,39.0,46.0,48.0,44.0,1
2805,CC:2F:71:3F:1F:24,4026282,779676534,261728,304846443,3764554,474830091,27,220151,251899175,220056,251887419,95,11756,210336,6,261729,23769,24,154,117000.0,39000.0,-69.0,-67.0,-73.0,-69.0,-73.0,-71.0,-76.0,-73.0,-90.0,-93.0,-90.0,-92.0,21.0,26.0,17.0,23.0,1
2806,CC:2F:71:3E:C5:1F,3764666,474843622,112,13531,3764554,474830091,0,445,37923,361,27825,84,10098,119,2,150,4,0,5,130000.0,39000.0,-70.0,-69.0,-66.0,-60.0,-71.0,-71.0,-67.0,-61.0,-90.0,-93.0,-90.0,-92.0,20.0,24.0,24.0,32.0,1
2807,BA:8C:B9:54:50:24,3764865,474920937,311,90846,3764554,474830091,0,1320,145239,1302,142393,18,2846,200,5,435,9,0,8,216660.0,130000.0,-49.0,-35.0,-43.0,-45.0,-42.0,-36.0,-44.0,-49.0,-90.0,-93.0,-90.0,-92.0,41.0,58.0,47.0,47.0,1
2808,92:69:1D:31:68:E9,3777386,490094472,12832,15264381,3764554,474830091,3,19391,3599651,18688,3437914,703,161737,6478,105,14098,252,3,252,216660.0,130000.0,-53.0,-47.0,-42.0,-48.0,-51.0,-47.0,-43.0,-48.0,-90.0,-93.0,-90.0,-92.0,37.0,46.0,48.0,44.0,1
2809,CC:2F:71:3F:1F:24,4026402,779800329,261842,304969632,3764560,474830697,27,220251,252012461,220156,252000705,95,11756,210433,6,261843,23770,24,154,130000.0,43333.0,-75.0,-73.0,-78.0,-76.0,-75.0,-73.0,-77.0,-75.0,-90.0,-93.0,-90.0,-92.0,15.0,20.0,12.0,16.0,1
2810,CC:2F:71:3E:C5:1F,3764672,474844228,112,13531,3764560,474830697,0,445,37923,361,27825,84,10098,119,2,150,4,0,5,130000.0,39000.0,-70.0,-69.0,-66.0,-60.0,-71.0,-71.0,-67.0,-61.0,-90.0,-93.0,-90.0,-92.0,20.0,24.0,24.0,32.0,1
2811,BA:8C:B9:54:50:24,3764871,474921543,311,90846,3764560,474830697,0,1323,145443,1305,142597,18,2846,200,5,435,9,0,8,216660.0,130000.0,-48.0,-35.0,-43.0,-45.0,-44.0,-36.0,-44.0,-48.0,-90.0,-93.0,-90.0,-92.0,42.0,58.0,47.0,47.0,1
2812,92:69:1D:31:68:E9,3777392,490095078,12832,15264381,3764560,474830697,3,19391,3599651,18688,3437914,703,161737,6478,105,14098,252,3,252,216660.0,130000.0,-53.0,-47.0,-42.0,-48.0,-51.0,-47.0,-43.0,-48.0,-90.0,-93.0,-90.0,-92.0,37.0,46.0,48.0,44.0,1
2813,CC:2F:71:3F:1F:24,4026512,779918705,261948,305087684,3764564,474831021,27,220351,252129789,220255,252117915,96,11874,210524,6,261949,23774,24,154,130000.0,43333.0,-70.0,-67.0,-72.0,-69.0,-73.0,-70.0,-75.0,-73.0,-90.0,-93.0,-90.0,-92.0,20.0,26.0,18.0,23.0,1
2814,CC:2F:71:3E:C5:1F,3764676,474844552,112,13531,3764564,474831021,0,445,37923,361,27825,84,10098,119,2,150,4,0,5,130000.0,39000.0,-70.0,-69.0,-66.0,-60.0,-71.0,-71.0,-67.0,-61.0,-90.0,-93.0,-90.0,-92.0,20.0,24.0,24.0,32.0,1
2815,BA:8C:B9:54:50:24,3764875,474921867,311,90846,3764564,474831021,0,1326,145647,1308,142801,18,2846,200,5,435,9,0,8,216660.0,130000.0,-40.0,-37.0,-45.0,-51.0,-43.0,-36.0,-44.0,-48.0,-90.0,-93.0,-90.0,-92.0,50.0,56.0,45.0,41.0,1
2816,92:69:1D:31:68:E9,3777396,490095402,12832,15264381,3764564,474831021,3,19391,3599651,18688,3437914,703,161737,6478,105,14098,252,3,252,216660.0,130000.0,-53.0,-47.0,-42.0,-48.0,-51.0,-47.0,-43.0,-48.0,-90.0,-93.0,-90.0,-92.0,37.0,46.0,48.0,44.0,1
2817,CC:2F:71:3F:1F:24,4026623,780038657,262053,305207030,3764570,474831627,27,220443,252242965,220347,252231091,96,11874,210612,6,262053,23781,24,154,130000.0,43333.0,-75.0,-72.0,-78.0,-75.0,-75.0,-72.0,-78.0,-75.0,-90.0,-93.0,-90.0,-92.0,15.0,21.0,12.0,17.0,1
2818,CC:2F:71:3E:C5:1F,3764682,474845158,112,13531,3764570,474831627,0,445,37923,361,27825,84,10098,119,2,150,4,0,5,130000.0,39000.0,-70.0,-69.0,-66.0,-60.0,-71.0,-71.0,-67.0,-61.0,-90.0,-93.0,-90.0,-92.0,20.0,24.0,24.0,32.0,1
2819,BA:8C:B9:54:50:24,3764881,474922473,311,90846,3764570,474831627,0,1326,145647,1308,142801,18,2846,200,5,435,9,0,8,216660.0,130000.0,-40.0,-37.0,-45.0,-51.0,-43.0,-36.0,-44.0,-48.0,-90.0,-93.0,-90.0,-92.0,50.0,56.0,45.0,41.0,1
2820,92:69:1D:31:68:E9,3777402,490096008,12832,15264381,3764570,474831627,3,19391,3599651,18688,3437914,703,161737,6478,105,14098,252,3,252,216660.0,130000.0,-53.0,-47.0,-42.0,-48.0,-51.0,-47.0,-43.0,-48.0,-90.0,-93.0,-90.0,-92.0,37.0,46.0,48.0,44.0,1
2821,CC:2F:71:3F:1F:24,4026731,780158335,262159,305326506,3764572,474831829,27,220538,252360899,220442,252349025,96,11874,210700,6,262159,23788,24,154,130000.0,43333.0,-77.0,-73.0,-78.0,-75.0,-74.0,-71.0,-76.0,-73.0,-90.0,-93.0,-90.0,-92.0,13.0,20.0,12.0,17.0,1
2822,CC:2F:71:3E:C5:1F,3764684,474845360,112,13531,3764572,474831829,0,445,37923,361,27825,84,10098,119,2,150,4,0,5,130000.0,39000.0,-70.0,-69.0,-66.0,-60.0,-71.0,-71.0,-67.0,-61.0,-90.0,-93.0,-90.0,-92.0,20.0,24.0,24.0,32.0,1
2823,BA:8C:B9:54:50:24,3764883,474922675,311,90846,3764572,474831829,0,1326,145647,1308,142801,18,2846,200,5,435,9,0,8,216660.0,130000.0,-40.0,-37.0,-45.0,-51.0,-43.0,-36.0,-44.0,-48.0,-90.0,-93.0,-90.0,-92.0,50.0,56.0,45.0,41.0,1
2824,92:69:1D:31:68:E9,3777404,490096210,12832,15264381,3764572,474831829,3,19391,3599651,18688,3437914,703,161737,6478,105,14098,252,3,252,216660.0,130000.0,-53.0,-47.0,-42.0,-48.0,-51.0,-47.0,-43.0,-48.0,-90.0,-93.0,-90.0,-92.0,37.0,46.0,48.0,44.0,1
2825,CC:2F:71:3F:1F:24,4026850,780280618,262271,305448123,3764579,474832495,27,220644,252476469,220548,252464595,96,11874,210798,6,262272,23788,24,154,130000.0,43333.0,-69.0,-66.0,-72.0,-68.0,-71.0,-69.0,-74.0,-70.0,-90.0,-93.0,-90.0,-92.0,21.0,27.0,18.0,24.0,1
2826,CC:2F:71:3E:C5:1F,3764691,474846026,112,13531,3764579,474832495,0,445,37923,361,27825,84,10098,119,2,150,4,0,5,130000.0,39000.0,-70.0,-69.0,-66.0,-60.0,-71.0,-71.0,-67.0,-61.0,-90.0,-93.0,-90.0,-92.0,20.0,24.0,24.0,32.0,1
2827,BA:8C:B9:54:50:24,3764890,474923341,311,90846,3764579,474832495,0,1326,145647,1308,142801,18,2846,200,5,435,9,0,8,216660.0,130000.0,-40.0,-37.0,-45.0,-51.0,-43.0,-36.0,-44.0,-48.0,-90.0,-93.0,-90.0,-92.0,50.0,56.0,45.0,41.0,1
2828,92:69:1D:31:68:E9,3777411,490096876,12832,15264381,3764579,474832495,3,19391,3599651,18688,3437914,703,161737,6478,105,14098,252,3,252,216660.0,130000.0,-53.0,-47.0,-42.0,-48.0,-51.0,-47.0,-43.0,-48.0,-90.0,-93.0,-90.0,-92.0,37.0,46.0,48.0,44.0,1
2829,CC:2F:71:3F:1F:24,4026957,780398742,262376,305566045,3764581,474832697,27,220738,252594191,220642,252582317,96,11874,210885,6,262377,23792,24,154,130000.0,43333.0,-76.0,-73.0,-79.0,-76.0,-74.0,-71.0,-77.0,-74.0,-90.0,-93.0,-90.0,-92.0,14.0,20.0,11.0,16.0,1
2830,CC:2F:71:3E:C5:1F,3764693,474846228,112,13531,3764581,474832697,0,445,37923,361,27825,84,10098,119,2,150,4,0,5,130000.0,39000.0,-70.0,-69.0,-66.0,-60.0,-71.0,-71.0,-67.0,-61.0,-90.0,-93.0,-90.0,-92.0,20.0,24.0,24.0,32.0,1
2831,BA:8C:B9:54:50:24,3764892,474923543,311,90846,3764581,474832697,0,1326,145647,1308,142801,18,2846,200,5,435,9,0,8,216660.0,130000.0,-40.0,-37.0,-45.0,-51.0,-43.0,-36.0,-44.0,-48.0,-90.0,-93.0,-90.0,-92.0,50.0,56.0,45.0,41.0,1
2832,92:69:1D:31:68:E9,3777414,490097351,12832,15264381,3764582,474832970,3,19391,3599651,18688,3437914,703,161737,6478,105,14098,252,3,252,216660.0,130000.0,-53.0,-47.0,-42.0,-48.0,-51.0,-47.0,-43.0,-48.0,-90.0,-93.0,-90.0,-92.0,37.0,46.0,48.0,44.0,1
2833,CC:2F:71:3F:1F:24,4027069,780517767,262481,305684191,3764588,474833576,27,220829,252707251,220733,252695377,96,11874,210972,6,262482,23792,24,154,130000.0,43333.0,-70.0,-66.0,-73.0,-69.0,-70.0,-67.0,-74.0,-70.0,-90.0,-93.0,-89.0,-92.0,20.0,27.0,16.0,23.0,1
2834,CC:2F:71:3E:C5:1F,3764700,474847107,112,13531,3764588,474833576,0,445,37923,361,27825,84,10098,119,2,150,4,0,5,130000.0,39000.0,-70.0,-69.0,-66.0,-60.0,-71.0,-71.0,-67.0,-61.0,-90.0,-93.0,-89.0,-92.0,20.0,24.0,23.0,32.0,1
2835,BA:8C:B9:54:50:24,3764900,474924482,311,90846,3764589,474833636,0,1326,145647,1308,142801,18,2846,200,5,435,9,0,8,216660.0,130000.0,-40.0,-37.0,-45.0,-51.0,-43.0,-36.0,-44.0,-48.0,-90.0,-93.0,-89.0,-92.0,50.0,56.0,44.0,41.0,1
2836,92:69:1D:31:68:E9,3777421,490098017,12832,15264381,3764589,474833636,3,19391,3599651,18688,3437914,703,161737,6478,105,14098,252,3,252,216660.0,130000.0,-53.0,-47.0,-42.0,-48.0,-51.0,-47.0,-43.0,-48.0,-90.0,-93.0,-89.0,-92.0,37.0,46.0,47.0,44.0,1
2837,CC:2F:71:3F:1F:24,4027177,780636063,262586,305802225,3764591,474833838,27,220917,252814211,220821,252802337,96,11874,211060,6,262587,23802,24,154,117000.0,39000.0,-69.0,-67.0,-71.0,-70.0,-69.0,-66.0,-71.0,-69.0,-90.0,-93.0,-89.0,-92.0,21.0,26.0,18.0,22.0,1
2838,CC:2F:71:3E:C5:1F,3764703,474847369,112,13531,3764591,474833838,0,445,37923,361,27825,84,10098,119,2,150,4,0,5,130000.0,39000.0,-70.0,-69.0,-66.0,-60.0,-71.0,-71.0,-67.0,-61.0,-90.0,-93.0,-89.0,-92.0,20.0,24.0,23.0,32.0,1
2839,BA:8C:B9:54:50:24,3764902,474924684,311,90846,3764591,474833838,0,1326,145647,1308,142801,18,2846,200,5,435,9,0,8,216660.0,130000.0,-40.0,-37.0,-45.0,-51.0,-43.0,-36.0,-44.0,-48.0,-90.0,-93.0,-89.0,-92.0,50.0,56.0,44.0,41.0,1
2840,92:69:1D:31:68:E9,3777423,490098219,12832,15264381,3764591,474833838,3,19391,3599651,18688,3437914,703,161737,6478,105,14098,252,3,252,216660.0,130000.0,-53.0,-47.0,-42.0,-48.0,-51.0,-47.0,-43.0,-48.0,-90.0,-93.0,-89.0,-92.0,37.0,46.0,47.0,44.0,1
2841,CC:2F:71:3F:1F:24,4027296,780759728,262699,305925284,3764597,474834444,27,221015,252927232,220919,252915358,96,11874,211155,6,262700,23808,24,154,130000.0,43333.0,-69.0,-67.0,-72.0,-69.0,-68.0,-66.0,-71.0,-68.0,-90.0,-93.0,-89.0,-92.0,21.0,26.0,17.0,23.0,1
2842,CC:2F:71:3E:C5:1F,3764709,474847975,112,13531,3764597,474834444,0,445,37923,361,27825,84,10098,119,2,150,4,0,5,130000.0,39000.0,-70.0,-69.0,-66.0,-60.0,-71.0,-71.0,-67.0,-61.0,-90.0,-93.0,-89.0,-92.0,20.0,24.0,23.0,32.0,1
2843,BA:8C:B9:54:50:24,3764908,474925290,311,90846,3764597,474834444,0,1326,145647,1308,142801,18,2846,200,5,435,9,0,8,216660.0,130000.0,-40.0,-37.0,-45.0,-51.0,-43.0,-36.0,-44.0,-48.0,-90.0,-93.0,-89.0,-92.0,50.0,56.0,44.0,41.0,1
2844,92:69:1D:31:68:E9,3777429,490098825,12832,15264381,3764597,474834444,3,19391,3599651,18688,3437914,703,161737,6478,105,14098,252,3,252,216660.0,130000.0,-53.0,-47.0,-42.0,-48.0,-51.0,-47.0,-43.0,-48.0,-90.0,-93.0,-89.0,-92.0,37.0,46.0,47.0,44.0,1
2845,CC:2F:71:3F:1F:24,4027405,780879466,262805,306044760,3764600,474834706,27,221109,253040654,221013,253028780,96,11874,211244,6,262806,23814,24,154,130000.0,43333.0,-68.0,-67.0,-71.0,-68.0,-68.0,-66.0,-71.0,-67.0,-90.0,-93.0,-89.0,-92.0,22.0,26.0,18.0,24.0,1
2846,CC:2F:71:3E:C5:1F,3764712,474848237,112,13531,3764600,474834706,0,445,37923,361,27825,84,10098,119,2,150,4,0,5,130000.0,39000.0,-70.0,-69.0,-66.0,-60.0,-71.0,-71.0,-67.0,-61.0,-90.0,-93.0,-89.0,-92.0,20.0,24.0,23.0,32.0,1
2847,BA:8C:B9:54:50:24,3764911,474925552,311,90846,3764600,474834706,0,1326,145647,1308,142801,18,2846,200,5,435,9,0,8,216660.0,130000.0,-40.0,-37.0,-45.0,-51.0,-43.0,-36.0,-44.0,-48.0,-90.0,-93.0,-89.0,-92.0,50.0,56.0,44.0,41.0,1
2848,92:69:1D:31:68:E9,3777432,490099087,12832,15264381,3764600,474834706,3,19391,3599651,18688,3437914,703,161737,6478,105,14098,252,3,252,216660.0,130000.0,-53.0,-47.0,-42.0,-48.0,-51.0,-47.0,-43.0,-48.0,-90.0,-93.0,-89.0,-92.0,37.0,46.0,47.0,44.0,1
2849,CC:2F:71:3F:1F:24,4027516,780998218,262910,306162906,3764606,474835312,27,221198,253150606,221102,253138732,96,11874,211331,6,262911,23816,24,154,130000.0,43333.0,-69.0,-66.0,-72.0,-68.0,-68.0,-66.0,-72.0,-68.0,-90.0,-93.0,-89.0,-92.0,21.0,27.0,17.0,24.0,1
2850,CC:2F:71:3E:C5:1F,3764718,474848843,112,13531,3764606,474835312,0,445,37923,361,27825,84,10098,119,2,150,4,0,5,130000.0,39000.0,-70.0,-69.0,-66.0,-60.0,-71.0,-71.0,-67.0,-61.0,-90.0,-93.0,-89.0,-92.0,20.0,24.0,23.0,32.0,1
2851,BA:8C:B9:54:50:24,3764917,474926158,311,90846,3764606,474835312,0,1326,145647,1308,142801,18,2846,200,5,435,9,0,8,216660.0,130000.0,-40.0,-37.0,-45.0,-51.0,-43.0,-36.0,-44.0,-48.0,-90.0,-93.0,-89.0,-92.0,50.0,56.0,44.0,41.0,1
2852,92:69:1D:31:68:E9,3777438,490099693,12832,15264381,3764606,474835312,3,19391,3599651,18688,3437914,703,161737,6478,105,14098,252,3,252,216660.0,130000.0,-53.0,-47.0,-42.0,-48.0,-51.0,-47.0,-43.0,-48.0,-90.0,-93.0,-89.0,-92.0,37.0,46.0,47.0,44.0,1
2853,CC:2F:71:3F:1F:24,4027623,781116566,263015,306281052,3764608,474835514,27,221292,253262748,221196,253250874,96,11874,211420,6,263016,23816,24,154,130000.0,43333.0,-69.0,-67.0,-73.0,-68.0,-69.0,-67.0,-72.0,-68.0,-90.0,-93.0,-89.0,-92.0,21.0,26.0,16.0,24.0,1
2854,CC:2F:71:3E:C5:1F,3764720,474849045,112,13531,3764608,474835514,0,445,37923,361,27825,84,10098,119,2,150,4,0,5,130000.0,39000.0,-70.0,-69.0,-66.0,-60.0,-71.0,-71.0,-67.0,-61.0,-90.0,-93.0,-89.0,-92.0,20.0,24.0,23.0,32.0,1
2855,BA:8C:B9:54:50:24,3764919,474926360,311,90846,3764608,474835514,0,1326,145647,1308,142801,18,2846,200,5,435,9,0,8,216660.0,130000.0,-40.0,-37.0,-45.0,-51.0,-43.0,-36.0,-44.0,-48.0,-90.0,-93.0,-89.0,-92.0,50.0,56.0,44.0,41.0,1
2856,92:69:1D:31:68:E9,3777440,490099895,12832,15264381,3764608,474835514,3,19391,3599651,18688,3437914,703,161737,6478,105,14098,252,3,252,216660.0,130000.0,-53.0,-47.0,-42.0,-48.0,-51.0,-47.0,-43.0,-48.0,-90.0,-93.0,-89.0,-92.0,37.0,46.0,47.0,44.0,1
2857,CC:2F:71:3F:1F:24,4027740,781237160,263124,306400918,3764616,474836242,27,221386,253374829,221290,253362955,96,11874,211511,6,263125,23820,24,154,130000.0,43333.0,-69.0,-67.0,-73.0,-68.0,-69.0,-67.0,-72.0,-68.0,-90.0,-93.0,-89.0,-92.0,21.0,26.0,16.0,24.0,1
2858,CC:2F:71:3E:C5:1F,3764728,474849773,112,13531,3764616,474836242,0,447,38111,362,27895,85,10216,120,2,150,4,0,5,130000.0,39000.0,-70.0,-70.0,-66.0,-60.0,-70.0,-69.0,-66.0,-60.0,-90.0,-93.0,-89.0,-92.0,20.0,23.0,23.0,32.0,1
2859,BA:8C:B9:54:50:24,3764927,474927088,311,90846,3764616,474836242,0,1326,145647,1308,142801,18,2846,200,5,435,9,0,8,216660.0,130000.0,-40.0,-37.0,-45.0,-51.0,-43.0,-36.0,-44.0,-48.0,-90.0,-93.0,-89.0,-92.0,50.0,56.0,44.0,41.0,1
2860,92:69:1D:31:68:E9,3777448,490100623,12832,15264381,3764616,474836242,3,19391,3599651,18688,3437914,703,161737,6478,105,14098,252,3,252,216660.0,130000.0,-53.0,-47.0,-42.0,-48.0,-51.0,-47.0,-43.0,-48.0,-90.0,-93.0,-89.0,-92.0,37.0,46.0,47.0,44.0,1
2861,CC:2F:71:3F:1F:24,4027857,781359355,263239,306522911,3764618,474836444,27,221486,253485100,221390,253473226,96,11874,211610,6,263240,23820,24,154,130000.0,43333.0,-68.0,-66.0,-72.0,-67.0,-68.0,-66.0,-72.0,-68.0,-90.0,-93.0,-89.0,-92.0,22.0,27.0,17.0,25.0,1
2862,CC:2F:71:3E:C5:1F,3764730,474849975,112,13531,3764618,474836444,0,447,38111,362,27895,85,10216,120,2,150,4,0,5,130000.0,39000.0,-70.0,-70.0,-66.0,-60.0,-70.0,-69.0,-66.0,-60.0,-90.0,-93.0,-89.0,-92.0,20.0,23.0,23.0,32.0,1
2863,BA:8C:B9:54:50:24,3764929,474927290,311,90846,3764618,474836444,0,1328,145783,1310,142937,18,2846,200,5,436,9,0,8,216660.0,130000.0,-40.0,-37.0,-45.0,-50.0,-42.0,-36.0,-44.0,-49.0,-90.0,-93.0,-89.0,-92.0,50.0,56.0,44.0,42.0,1
2864,92:69:1D:31:68:E9,3777450,490100825,12832,15264381,3764618,474836444,3,19393,3599787,18690,3438050,703,161737,6478,105,14099,252,3,252,216660.0,130000.0,-52.0,-49.0,-44.0,-52.0,-51.0,-47.0,-43.0,-49.0,-90.0,-93.0,-89.0,-92.0,38.0,44.0,45.0,40.0,1
2865,CC:2F:71:3F:1F:24,4027968,781479365,263346,306642517,3764622,474836848,27,221581,253598652,221485,253586778,96,11874,211699,6,263347,23827,24,154,130000.0,43333.0,-68.0,-66.0,-72.0,-68.0,-68.0,-66.0,-72.0,-67.0,-90.0,-93.0,-89.0,-92.0,22.0,27.0,17.0,24.0,1
2866,CC:2F:71:3E:C5:1F,3764736,474850581,112,13531,3764624,474837050,0,447,38111,362,27895,85,10216,120,2,150,4,0,5,130000.0,39000.0,-70.0,-70.0,-66.0,-60.0,-70.0,-69.0,-66.0,-60.0,-90.0,-93.0,-89.0,-92.0,20.0,23.0,23.0,32.0,1
2867,BA:8C:B9:54:50:24,3764935,474927896,311,90846,3764624,474837050,0,1328,145783,1310,142937,18,2846,200,5,436,9,0,8,216660.0,130000.0,-40.0,-37.0,-45.0,-50.0,-42.0,-36.0,-44.0,-49.0,-90.0,-93.0,-89.0,-92.0,50.0,56.0,44.0,42.0,1
2868,92:69:1D:31:68:E9,3777457,490101491,12832,15264381,3764625,474837110,3,19393,3599787,18690,3438050,703,161737,6478,105,14099,252,3,252,216660.0,130000.0,-52.0,-49.0,-44.0,-52.0,-51.0,-47.0,-43.0,-49.0,-90.0,-93.0,-89.0,-92.0,38.0,44.0,45.0,40.0,1
2869,CC:2F:71:3F:1F:24,4028081,781599789,263454,306762477,3764627,474837312,27,221672,253708884,221576,253697010,96,11874,211788,6,263455,23827,24,154,130000.0,43333.0,-68.0,-66.0,-72.0,-68.0,-68.0,-66.0,-72.0,-68.0,-90.0,-93.0,-89.0,-92.0,22.0,27.0,17.0,24.0,1
2870,CC:2F:71:3E:C5:1F,3764739,474850843,112,13531,3764627,474837312,0,447,38111,362,27895,85,10216,120,2,150,4,0,5,130000.0,39000.0,-70.0,-70.0,-66.0,-60.0,-70.0,-69.0,-66.0,-60.0,-90.0,-93.0,-89.0,-92.0,20.0,23.0,23.0,32.0,1
2871,BA:8C:B9:54:50:24,3764938,474928158,311,90846,3764627,474837312,0,1332,146055,1314,143209,18,2846,200,5,436,9,0,8,216660.0,130000.0,-40.0,-37.0,-45.0,-51.0,-41.0,-36.0,-44.0,-49.0,-90.0,-93.0,-89.0,-92.0,50.0,56.0,44.0,41.0,1
2872,92:69:1D:31:68:E9,3777459,490101693,12832,15264381,3764627,474837312,3,19393,3599787,18690,3438050,703,161737,6478,105,14099,252,3,252,216660.0,130000.0,-52.0,-49.0,-44.0,-52.0,-51.0,-47.0,-43.0,-49.0,-90.0,-93.0,-89.0,-92.0,38.0,44.0,45.0,40.0,1
2873,CC:2F:71:3F:1F:24,4028194,781721425,263561,306883507,3764633,474837918,27,221764,253823498,221668,253811624,96,11874,211877,6,263562,23831,24,155,130000.0,43333.0,-68.0,-66.0,-72.0,-68.0,-68.0,-66.0,-72.0,-68.0,-90.0,-93.0,-89.0,-92.0,22.0,27.0,17.0,24.0,1
2874,CC:2F:71:3E:C5:1F,3764745,474851449,112,13531,3764633,474837918,0,447,38111,362,27895,85,10216,120,2,150,4,0,5,130000.0,39000.0,-70.0,-70.0,-66.0,-60.0,-70.0,-69.0,-66.0,-60.0,-90.0,-93.0,-89.0,-92.0,20.0,23.0,23.0,32.0,1
2875,BA:8C:B9:54:50:24,3764944,474928764,311,90846,3764633,474837918,0,1332,146055,1314,143209,18,2846,200,5,436,9,0,8,216660.0,130000.0,-40.0,-37.0,-45.0,-51.0,-41.0,-36.0,-44.0,-49.0,-90.0,-93.0,-89.0,-92.0,50.0,56.0,44.0,41.0,1
2876,92:69:1D:31:68:E9,3777465,490102299,12832,15264381,3764633,474837918,3,19393,3599787,18690,3438050,703,161737,6478,105,14099,252,3,252,216660.0,130000.0,-52.0,-49.0,-44.0,-52.0,-51.0,-47.0,-43.0,-49.0,-90.0,-93.0,-89.0,-92.0,38.0,44.0,45.0,40.0,1
2877,CC:2F:71:3F:1F:24,4028309,781844786,263675,307006808,3764634,474837978,27,221861,253934855,221765,253922981,96,11874,211973,6,263676,23831,24,155,130000.0,43333.0,-68.0,-66.0,-72.0,-68.0,-68.0,-66.0,-72.0,-68.0,-90.0,-93.0,-89.0,-92.0,22.0,27.0,17.0,24.0,1
2878,CC:2F:71:3E:C5:1F,3764748,474851711,112,13531,3764636,474838180,0,447,38111,362,27895,85,10216,120,2,150,4,0,5,130000.0,39000.0,-70.0,-70.0,-66.0,-60.0,-70.0,-69.0,-66.0,-60.0,-90.0,-93.0,-89.0,-92.0,20.0,23.0,23.0,32.0,1
2879,BA:8C:B9:54:50:24,3764947,474929026,311,90846,3764636,474838180,0,1332,146055,1314,143209,18,2846,200,5,436,9,0,8,216660.0,130000.0,-40.0,-37.0,-45.0,-51.0,-41.0,-36.0,-44.0,-49.0,-90.0,-93.0,-89.0,-92.0,50.0,56.0,44.0,41.0,1
2880,92:69:1D:31:68:E9,3777468,490102561,12832,15264381,3764636,474838180,3,19393,3599787,18690,3438050,703,161737,6478,105,14099,252,3,252,216660.0,130000.0,-52.0,-49.0,-44.0,-52.0,-51.0,-47.0,-43.0,-49.0,-90.0,-93.0,-89.0,-92.0,38.0,44.0,45.0,40.0,1
2881,CC:2F:71:3F:1F:24,4028421,781963500,263781,307124916,3764640,474838584,27,221952,254047915,221856,254036041,96,11874,212060,6,263782,23835,24,155,130000.0,39000.0,-68.0,-66.0,-72.0,-68.0,-68.0,-66.0,-72.0,-67.0,-90.0,-93.0,-89.0,-92.0,22.0,27.0,17.0,24.0,1
2882,CC:2F:71:3E:C5:1F,3764754,474852317,112,13531,3764642,474838786,0,447,38111,362,27895,85,10216,120,2,150,4,0,5,130000.0,39000.0,-70.0,-70.0,-66.0,-60.0,-70.0,-69.0,-66.0,-60.0,-90.0,-93.0,-89.0,-92.0,20.0,23.0,23.0,32.0,1
2883,BA:8C:B9:54:50:24,3764953,474929632,311,90846,3764642,474838786,0,1332,146055,1314,143209,18,2846,200,5,436,9,0,8,216660.0,130000.0,-40.0,-37.0,-45.0,-51.0,-41.0,-36.0,-44.0,-49.0,-90.0,-93.0,-89.0,-92.0,50.0,56.0,44.0,41.0,1
2884,92:69:1D:31:68:E9,3777474,490103167,12832,15264381,3764642,474838786,3,19393,3599787,18690,3438050,703,161737,6478,105,14099,252,3,252,216660.0,130000.0,-52.0,-49.0,-44.0,-52.0,-51.0,-47.0,-43.0,-49.0,-90.0,-93.0,-89.0,-92.0,38.0,44.0,45.0,40.0,1
2885,CC:2F:71:3F:1F:24,4028530,782082195,263887,307243136,3764643,474839059,27,222043,254159599,221947,254147725,96,11874,212147,6,263888,23836,24,155,130000.0,43333.0,-68.0,-66.0,-73.0,-68.0,-68.0,-66.0,-72.0,-67.0,-90.0,-93.0,-89.0,-92.0,22.0,27.0,16.0,24.0,1
2886,CC:2F:71:3E:C5:1F,3764755,474852590,112,13531,3764643,474839059,0,447,38111,362,27895,85,10216,120,2,150,4,0,5,130000.0,39000.0,-70.0,-70.0,-66.0,-60.0,-70.0,-69.0,-66.0,-60.0,-90.0,-93.0,-89.0,-92.0,20.0,23.0,23.0,32.0,1
2887,BA:8C:B9:54:50:24,3764956,474930107,311,90846,3764645,474839261,0,1332,146055,1314,143209,18,2846,200,5,436,9,0,8,216660.0,130000.0,-40.0,-37.0,-45.0,-51.0,-41.0,-36.0,-44.0,-49.0,-90.0,-93.0,-89.0,-92.0,50.0,56.0,44.0,41.0,1
2888,92:69:1D:31:68:E9,3777477,490103642,12832,15264381,3764645,474839261,3,19393,3599787,18690,3438050,703,161737,6478,105,14099,252,3,252,216660.0,130000.0,-52.0,-49.0,-44.0,-52.0,-51.0,-47.0,-43.0,-49.0,-90.0,-93.0,-89.0,-92.0,38.0,44.0,45.0,40.0,1
2889,CC:2F:71:3F:1F:24,4028644,782201267,263994,307361542,3764650,474839725,27,222135,254269899,222039,254258025,96,11874,212237,6,263995,23836,24,155,130000.0,43333.0,-69.0,-67.0,-73.0,-69.0,-68.0,-66.0,-72.0,-68.0,-90.0,-93.0,-89.0,-92.0,21.0,26.0,16.0,23.0,1
2890,CC:2F:71:3E:C5:1F,3764762,474853256,112,13531,3764650,474839725,0,447,38111,362,27895,85,10216,120,2,150,4,0,5,130000.0,39000.0,-70.0,-70.0,-66.0,-60.0,-70.0,-69.0,-66.0,-60.0,-90.0,-93.0,-89.0,-92.0,20.0,23.0,23.0,32.0,1
2891,BA:8C:B9:54:50:24,3764963,474930773,311,90846,3764652,474839927,0,1332,146055,1314,143209,18,2846,200,5,436,9,0,8,216660.0,130000.0,-40.0,-37.0,-45.0,-51.0,-41.0,-36.0,-44.0,-49.0,-90.0,-93.0,-89.0,-92.0,50.0,56.0,44.0,41.0,1
2892,92:69:1D:31:68:E9,3777484,490104308,12832,15264381,3764652,474839927,3,19393,3599787,18690,3438050,703,161737,6478,105,14099,252,3,252,216660.0,130000.0,-52.0,-49.0,-44.0,-52.0,-51.0,-47.0,-43.0,-49.0,-90.0,-93.0,-89.0,-92.0,38.0,44.0,45.0,40.0,1
2893,CC:2F:71:3F:1F:24,4028759,782321568,264107,307481641,3764652,474839927,27,222231,254378368,222135,254366494,96,11874,212330,6,264108,23840,24,155,130000.0,43333.0,-68.0,-66.0,-72.0,-67.0,-68.0,-66.0,-72.0,-67.0,-90.0,-93.0,-89.0,-92.0,22.0,27.0,17.0,25.0,1
2894,CC:2F:71:3E:C5:1F,3764764,474853458,112,13531,3764652,474839927,0,447,38111,362,27895,85,10216,120,2,150,4,0,5,130000.0,39000.0,-70.0,-70.0,-66.0,-60.0,-70.0,-69.0,-66.0,-60.0,-90.0,-93.0,-89.0,-92.0,20.0,23.0,23.0,32.0,1
2895,BA:8C:B9:54:50:24,3764963,474930773,311,90846,3764652,474839927,0,1332,146055,1314,143209,18,2846,200,5,436,9,0,8,216660.0,130000.0,-40.0,-37.0,-45.0,-51.0,-41.0,-36.0,-44.0,-49.0,-90.0,-93.0,-89.0,-92.0,50.0,56.0,44.0,41.0,1
2896,92:69:1D:31:68:E9,3777484,490104308,12832,15264381,3764652,474839927,3,19393,3599787,18690,3438050,703,161737,6478,105,14099,252,3,252,216660.0,130000.0,-52.0,-49.0,-44.0,-52.0,-51.0,-47.0,-43.0,-49.0,-90.0,-93.0,-89.0,-92.0,38.0,44.0,45.0,40.0,1
2897,CC:2F:71:3F:1F:24,4028870,782441802,264214,307601471,3764656,474840331,27,222323,254492968,222227,254481094,96,11874,212418,6,264215,23840,24,155,130000.0,43333.0,-68.0,-66.0,-73.0,-67.0,-68.0,-66.0,-72.0,-67.0,-90.0,-93.0,-89.0,-92.0,22.0,27.0,16.0,25.0,1
2898,CC:2F:71:3E:C5:1F,3764770,474854064,112,13531,3764658,474840533,0,447,38111,362,27895,85,10216,120,2,150,4,0,5,130000.0,39000.0,-70.0,-70.0,-66.0,-60.0,-70.0,-69.0,-66.0,-60.0,-90.0,-93.0,-89.0,-92.0,20.0,23.0,23.0,32.0,1
2899,BA:8C:B9:54:50:24,3764969,474931379,311,90846,3764658,474840533,0,1332,146055,1314,143209,18,2846,200,5,436,9,0,8,216660.0,130000.0,-40.0,-37.0,-45.0,-51.0,-41.0,-36.0,-44.0,-49.0,-90.0,-93.0,-89.0,-92.0,50.0,56.0,44.0,41.0,1
2900,92:69:1D:31:68:E9,3777492,490105116,12832,15264381,3764660,474840735,3,19393,3599787,18690,3438050,703,161737,6478,105,14099,252,3,252,216660.0,130000.0,-52.0,-49.0,-44.0,-52.0,-51.0,-47.0,-43.0,-49.0,-90.0,-93.0,-89.0,-92.0,38.0,44.0,45.0,40.0,1
2901,CC:2F:71:3F:1F:24,4028980,782560412,264319,307719617,3764661,474840795,27,222414,254604732,222318,254592858,96,11874,212505,6,264320,23840,24,155,130000.0,43333.0,-68.0,-66.0,-73.0,-68.0,-68.0,-66.0,-72.0,-68.0,-90.0,-93.0,-89.0,-92.0,22.0,27.0,16.0,24.0,1
2902,CC:2F:71:3E:C5:1F,3764773,474854326,112,13531,3764661,474840795,0,447,38111,362,27895,85,10216,120,2,150,4,0,5,130000.0,39000.0,-70.0,-70.0,-66.0,-60.0,-70.0,-69.0,-66.0,-60.0,-90.0,-93.0,-89.0,-92.0,20.0,23.0,23.0,32.0,1
2903,BA:8C:B9:54:50:24,3764972,474931641,311,90846,3764661,474840795,0,1332,146055,1314,143209,18,2846,200,5,436,9,0,8,216660.0,130000.0,-40.0,-37.0,-45.0,-51.0,-41.0,-36.0,-44.0,-49.0,-90.0,-93.0,-89.0,-92.0,50.0,56.0,44.0,41.0,1
2904,92:69:1D:31:68:E9,3777493,490105176,12832,15264381,3764661,474840795,3,19394,3599855,18691,3438118,703,161737,6478,105,14099,252,3,252,216660.0,130000.0,-50.0,-48.0,-42.0,-49.0,-51.0,-47.0,-43.0,-49.0,-90.0,-93.0,-89.0,-92.0,40.0,45.0,47.0,43.0,1
2905,CC:2F:71:3F:1F:24,4029089,782678738,264424,307837539,3764665,474841199,27,222503,254714698,222407,254702824,96,11874,212591,6,264424,23849,24,155,130000.0,43333.0,-68.0,-66.0,-73.0,-68.0,-68.0,-66.0,-72.0,-68.0,-90.0,-93.0,-89.0,-92.0,22.0,27.0,16.0,24.0,1
2906,CC:2F:71:3E:C5:1F,3764777,474854730,112,13531,3764665,474841199,0,447,38111,362,27895,85,10216,120,2,150,4,0,5,130000.0,39000.0,-70.0,-70.0,-66.0,-60.0,-70.0,-69.0,-66.0,-60.0,-90.0,-93.0,-89.0,-92.0,20.0,23.0,23.0,32.0,1
2907,BA:8C:B9:54:50:24,3764978,474932247,311,90846,3764667,474841401,0,1332,146055,1314,143209,18,2846,200,5,436,9,0,8,216660.0,130000.0,-40.0,-37.0,-45.0,-51.0,-41.0,-36.0,-44.0,-49.0,-90.0,-93.0,-89.0,-92.0,50.0,56.0,44.0,41.0,1
2908,92:69:1D:31:68:E9,3777499,490105782,12832,15264381,3764667,474841401,3,19394,3599855,18691,3438118,703,161737,6478,105,14099,252,3,252,216660.0,130000.0,-50.0,-48.0,-42.0,-49.0,-51.0,-47.0,-43.0,-49.0,-90.0,-93.0,-89.0,-92.0,40.0,45.0,47.0,43.0,1
2909,CC:2F:71:3F:1F:24,4029206,782800819,264536,307959156,3764670,474841663,27,222605,254835277,222509,254823403,96,11874,212685,6,264536,23850,24,155,130000.0,43333.0,-68.0,-66.0,-72.0,-67.0,-68.0,-66.0,-72.0,-67.0,-90.0,-93.0,-89.0,-92.0,22.0,27.0,17.0,25.0,1
2910,CC:2F:71:3E:C5:1F,3764782,474855194,112,13531,3764670,474841663,0,447,38111,362,27895,85,10216,120,2,150,4,0,5,130000.0,39000.0,-70.0,-70.0,-66.0,-60.0,-70.0,-69.0,-66.0,-60.0,-90.0,-93.0,-89.0,-92.0,20.0,23.0,23.0,32.0,1
2911,BA:8C:B9:54:50:24,3764981,474932509,311,90846,3764670,474841663,0,1332,146055,1314,143209,18,2846,200,5,436,9,0,8,216660.0,130000.0,-40.0,-37.0,-45.0,-51.0,-41.0,-36.0,-44.0,-49.0,-90.0,-93.0,-89.0,-92.0,50.0,56.0,44.0,41.0,1
2912,92:69:1D:31:68:E9,3777502,490106044,12832,15264381,3764670,474841663,3,19394,3599855,18691,3438118,703,161737,6478,105,14099,252,3,252,216660.0,130000.0,-50.0,-48.0,-42.0,-49.0,-51.0,-47.0,-43.0,-49.0,-90.0,-93.0,-89.0,-92.0,40.0,45.0,47.0,43.0,1
2913,CC:2F:71:3F:1F:24,4029319,782919871,264643,308077436,3764676,474842435,27,222697,254947125,222601,254935251,96,11874,212773,6,264644,23854,24,155,117000.0,39000.0,-68.0,-66.0,-72.0,-68.0,-68.0,-66.0,-72.0,-67.0,-90.0,-93.0,-89.0,-92.0,22.0,27.0,17.0,24.0,1
2914,CC:2F:71:3E:C5:1F,3764789,474856082,113,13647,3764676,474842435,0,449,38251,364,28035,85,10216,120,2,151,4,0,5,130000.0,39000.0,-71.0,-70.0,-66.0,-60.0,-70.0,-69.0,-66.0,-60.0,-90.0,-93.0,-89.0,-92.0,19.0,23.0,23.0,32.0,1
2915,BA:8C:B9:54:50:24,3764990,474933599,312,90962,3764678,474842637,0,1335,146259,1317,143413,18,2846,200,5,437,9,0,8,216660.0,130000.0,-40.0,-37.0,-45.0,-51.0,-41.0,-36.0,-44.0,-50.0,-90.0,-93.0,-89.0,-92.0,50.0,56.0,44.0,41.0,1
2916,92:69:1D:31:68:E9,3777511,490107134,12833,15264497,3764678,474842637,3,19396,3599991,18693,3438254,703,161737,6478,105,14100,252,3,252,216660.0,130000.0,-52.0,-51.0,-44.0,-49.0,-51.0,-48.0,-43.0,-49.0,-90.0,-93.0,-89.0,-92.0,38.0,42.0,45.0,43.0,1
2917,CC:2F:71:3F:1F:24,4029427,783036755,264747,308193916,3764680,474842839,27,222787,255057303,222691,255045429,96,11874,212860,6,264748,23854,24,155,130000.0,43333.0,-68.0,-66.0,-72.0,-68.0,-68.0,-66.0,-72.0,-67.0,-90.0,-93.0,-89.0,-92.0,22.0,27.0,17.0,24.0,1
2918,CC:2F:71:3E:C5:1F,3764793,474856486,113,13647,3764680,474842839,0,449,38251,364,28035,85,10216,120,2,151,4,0,5,130000.0,39000.0,-71.0,-70.0,-66.0,-60.0,-70.0,-69.0,-66.0,-60.0,-90.0,-93.0,-89.0,-92.0,19.0,23.0,23.0,32.0,1
2919,BA:8C:B9:54:50:24,3764992,474933801,312,90962,3764680,474842839,0,1335,146259,1317,143413,18,2846,200,5,437,9,0,8,216660.0,130000.0,-40.0,-37.0,-45.0,-51.0,-41.0,-36.0,-44.0,-50.0,-90.0,-93.0,-89.0,-92.0,50.0,56.0,44.0,41.0,1
2920,92:69:1D:31:68:E9,3777513,490107336,12833,15264497,3764680,474842839,3,19396,3599991,18693,3438254,703,161737,6478,105,14100,252,3,252,216660.0,130000.0,-52.0,-51.0,-44.0,-49.0,-51.0,-48.0,-43.0,-49.0,-90.0,-93.0,-89.0,-92.0,38.0,42.0,45.0,43.0,1
2921,CC:2F:71:3F:1F:24,4029538,783155495,264853,308312192,3764685,474843303,27,222882,255173793,222786,255161919,96,11874,212946,6,264853,23854,24,155,130000.0,43333.0,-68.0,-66.0,-72.0,-67.0,-68.0,-66.0,-72.0,-67.0,-90.0,-93.0,-89.0,-92.0,22.0,27.0,17.0,25.0,1
2922,CC:2F:71:3E:C5:1F,3764798,474856950,113,13647,3764685,474843303,0,449,38251,364,28035,85,10216,120,2,151,4,0,5,130000.0,39000.0,-71.0,-70.0,-66.0,-60.0,-70.0,-69.0,-66.0,-60.0,-90.0,-93.0,-89.0,-92.0,19.0,23.0,23.0,32.0,1
2923,BA:8C:B9:54:50:24,3764997,474934265,312,90962,3764685,474843303,0,1335,146259,1317,143413,18,2846,200,5,437,9,0,8,216660.0,130000.0,-40.0,-37.0,-45.0,-51.0,-41.0,-36.0,-44.0,-50.0,-90.0,-93.0,-89.0,-92.0,50.0,56.0,44.0,41.0,1
2924,92:69:1D:31:68:E9,3777518,490107800,12833,15264497,3764685,474843303,3,19396,3599991,18693,3438254,703,161737,6478,105,14100,252,3,252,216660.0,130000.0,-52.0,-51.0,-44.0,-49.0,-51.0,-48.0,-43.0,-49.0,-90.0,-93.0,-89.0,-92.0,38.0,42.0,45.0,43.0,1
2925,CC:2F:71:3F:1F:24,4029654,783277292,264965,308433585,3764689,474843707,27,222980,255286766,222884,255274892,96,11874,213041,6,264966,23858,24,155,130000.0,43333.0,-68.0,-66.0,-72.0,-67.0,-68.0,-66.0,-72.0,-67.0,-90.0,-93.0,-89.0,-92.0,22.0,27.0,17.0,25.0,1
2926,CC:2F:71:3E:C5:1F,3764802,474857354,113,13647,3764689,474843707,0,449,38251,364,28035,85,10216,120,2,151,4,0,5,130000.0,39000.0,-71.0,-70.0,-66.0,-60.0,-70.0,-69.0,-66.0,-60.0,-90.0,-93.0,-89.0,-92.0,19.0,23.0,23.0,32.0,1
2927,BA:8C:B9:54:50:24,3765001,474934669,312,90962,3764689,474843707,0,1335,146259,1317,143413,18,2846,200,5,437,9,0,8,216660.0,130000.0,-40.0,-37.0,-45.0,-51.0,-41.0,-36.0,-44.0,-50.0,-90.0,-93.0,-89.0,-92.0,50.0,56.0,44.0,41.0,1
2928,92:69:1D:31:68:E9,3777522,490108204,12833,15264497,3764689,474843707,3,19396,3599991,18693,3438254,703,161737,6478,105,14100,252,3,252,216660.0,130000.0,-52.0,-51.0,-44.0,-49.0,-51.0,-48.0,-43.0,-49.0,-90.0,-93.0,-89.0,-92.0,38.0,42.0,45.0,43.0,1
2929,CC:2F:71:3F:1F:24,4029764,783396011,265071,308551900,3764693,474844111,27,223071,255395551,222975,255383677,96,11874,213131,6,265072,23858,24,155,130000.0,43333.0,-68.0,-66.0,-73.0,-68.0,-68.0,-66.0,-72.0,-67.0,-90.0,-93.0,-89.0,-92.0,22.0,27.0,16.0,24.0,1
2930,CC:2F:71:3E:C5:1F,3764806,474857758,113,13647,3764693,474844111,0,449,38251,364,28035,85,10216,120,2,151,4,0,5,130000.0,39000.0,-71.0,-70.0,-66.0,-60.0,-70.0,-69.0,-66.0,-60.0,-90.0,-93.0,-89.0,-92.0,19.0,23.0,23.0,32.0,1
2931,BA:8C:B9:54:50:24,3765005,474935073,312,90962,3764693,474844111,0,1335,146259,1317,143413,18,2846,200,5,437,9,0,8,216660.0,130000.0,-40.0,-37.0,-45.0,-51.0,-41.0,-36.0,-44.0,-50.0,-90.0,-93.0,-89.0,-92.0,50.0,56.0,44.0,41.0,1
2932,92:69:1D:31:68:E9,3777526,490108608,12833,15264497,3764693,474844111,3,19396,3599991,18693,3438254,703,161737,6478,105,14100,252,3,252,216660.0,130000.0,-52.0,-51.0,-44.0,-49.0,-51.0,-48.0,-43.0,-49.0,-90.0,-93.0,-89.0,-92.0,38.0,42.0,45.0,43.0,1
2933,CC:2F:71:3F:1F:24,4029873,783513067,265175,308668492,3764698,474844575,27,223160,255505517,223064,255493643,96,11874,213217,6,265176,23858,24,155,130000.0,43333.0,-68.0,-66.0,-73.0,-67.0,-68.0,-66.0,-72.0,-67.0,-90.0,-93.0,-89.0,-92.0,22.0,27.0,16.0,25.0,1
2934,CC:2F:71:3E:C5:1F,3764811,474858222,113,13647,3764698,474844575,0,449,38251,364,28035,85,10216,120,2,151,4,0,5,130000.0,39000.0,-71.0,-70.0,-66.0,-60.0,-70.0,-69.0,-66.0,-60.0,-90.0,-93.0,-89.0,-92.0,19.0,23.0,23.0,32.0,1
2935,BA:8C:B9:54:50:24,3765010,474935537,312,90962,3764698,474844575,0,1335,146259,1317,143413,18,2846,200,5,437,9,0,8,216660.0,130000.0,-40.0,-37.0,-45.0,-51.0,-41.0,-36.0,-44.0,-50.0,-90.0,-93.0,-89.0,-92.0,50.0,56.0,44.0,41.0,1
2936,92:69:1D:31:68:E9,3777531,490109072,12833,15264497,3764698,474844575,3,19396,3599991,18693,3438254,703,161737,6478,105,14100,252,3,252,216660.0,130000.0,-52.0,-51.0,-44.0,-49.0,-51.0,-48.0,-43.0,-49.0,-90.0,-93.0,-89.0,-92.0,38.0,42.0,45.0,43.0,1
2937,CC:2F:71:3F:1F:24,4029985,783633139,265282,308788098,3764703,474845041,27,223254,255618975,223157,255606983,97,11992,213307,6,265283,23862,24,155,130000.0,43333.0,-68.0,-66.0,-72.0,-67.0,-68.0,-66.0,-72.0,-67.0,-90.0,-93.0,-89.0,-92.0,22.0,27.0,17.0,25.0,1
2938,CC:2F:71:3E:C5:1F,3764816,474858688,113,13647,3764703,474845041,0,449,38251,364,28035,85,10216,120,2,151,4,0,5,130000.0,39000.0,-71.0,-70.0,-66.0,-60.0,-70.0,-69.0,-66.0,-60.0,-90.0,-93.0,-89.0,-92.0,19.0,23.0,23.0,32.0,1
2939,BA:8C:B9:54:50:24,3765016,474936276,312,90962,3764704,474845314,0,1335,146259,1317,143413,18,2846,200,5,437,9,0,8,216660.0,130000.0,-40.0,-37.0,-45.0,-51.0,-41.0,-36.0,-44.0,-50.0,-90.0,-93.0,-89.0,-92.0,50.0,56.0,44.0,41.0,1
2940,92:69:1D:31:68:E9,3777537,490109811,12833,15264497,3764704,474845314,3,19396,3599991,18693,3438254,703,161737,6478,105,14100,252,3,252,216660.0,130000.0,-52.0,-51.0,-44.0,-49.0,-51.0,-48.0,-43.0,-49.0,-90.0,-93.0,-89.0,-92.0,38.0,42.0,45.0,43.0,1
2941,CC:2F:71:3F:1F:24,4030112,783758457,265404,308912739,3764708,474845718,27,223363,255730983,223266,255718991,97,11992,213414,6,265405,23862,24,155,130000.0,43333.0,-68.0,-66.0,-73.0,-67.0,-68.0,-66.0,-72.0,-67.0,-90.0,-93.0,-89.0,-92.0,22.0,27.0,16.0,25.0,1
2942,CC:2F:71:3E:C5:1F,3764821,474859365,113,13647,3764708,474845718,0,449,38251,364,28035,85,10216,120,2,151,4,0,5,130000.0,39000.0,-71.0,-70.0,-66.0,-60.0,-70.0,-69.0,-66.0,-60.0,-90.0,-93.0,-89.0,-92.0,19.0,23.0,23.0,32.0,1
2943,BA:8C:B9:54:50:24,3765021,474936740,312,90962,3764709,474845778,0,1335,146259,1317,143413,18,2846,200,5,437,9,0,8,216660.0,130000.0,-40.0,-37.0,-45.0,-51.0,-41.0,-36.0,-44.0,-50.0,-90.0,-93.0,-89.0,-92.0,50.0,56.0,44.0,41.0,1
2944,92:69:1D:31:68:E9,3777542,490110275,12833,15264497,3764709,474845778,3,19396,3599991,18693,3438254,703,161737,6478,105,14100,252,3,252,216660.0,130000.0,-52.0,-51.0,-44.0,-49.0,-51.0,-48.0,-43.0,-49.0,-90.0,-93.0,-89.0,-92.0,38.0,42.0,45.0,43.0,1
2945,CC:2F:71:3F:1F:24,4030224,783877271,265511,309031089,3764713,474846182,27,223451,255839381,223354,255827389,97,11992,213501,6,265512,23866,24,155,117000.0,39000.0,-68.0,-66.0,-72.0,-68.0,-68.0,-66.0,-72.0,-68.0,-90.0,-93.0,-89.0,-92.0,22.0,27.0,17.0,24.0,1
2946,CC:2F:71:3E:C5:1F,3764826,474859829,113,13647,3764713,474846182,0,449,38251,364,28035,85,10216,120,2,151,4,0,5,130000.0,39000.0,-71.0,-70.0,-66.0,-60.0,-70.0,-69.0,-66.0,-60.0,-90.0,-93.0,-89.0,-92.0,19.0,23.0,23.0,32.0,1
2947,BA:8C:B9:54:50:24,3765025,474937144,312,90962,3764713,474846182,0,1335,146259,1317,143413,18,2846,200,5,437,9,0,8,216660.0,130000.0,-40.0,-37.0,-45.0,-51.0,-41.0,-36.0,-44.0,-50.0,-90.0,-93.0,-89.0,-92.0,50.0,56.0,44.0,41.0,1
2948,92:69:1D:31:68:E9,3777546,490110679,12833,15264497,3764713,474846182,3,19396,3599991,18693,3438254,703,161737,6478,105,14100,252,3,252,216660.0,130000.0,-52.0,-51.0,-44.0,-49.0,-51.0,-48.0,-43.0,-49.0,-90.0,-93.0,-89.0,-92.0,38.0,42.0,45.0,43.0,1
2949,CC:2F:71:3F:1F:24,4030335,783995913,265618,309149327,3764717,474846586,27,223545,255954227,223448,255942235,97,11992,213590,6,265619,23866,24,155,130000.0,43333.0,-69.0,-66.0,-73.0,-68.0,-68.0,-66.0,-72.0,-68.0,-90.0,-93.0,-89.0,-92.0,21.0,27.0,16.0,24.0,1
2950,CC:2F:71:3E:C5:1F,3764830,474860233,113,13647,3764717,474846586,0,449,38251,364,28035,85,10216,120,2,151,4,0,5,130000.0,39000.0,-71.0,-70.0,-66.0,-60.0,-70.0,-69.0,-66.0,-60.0,-90.0,-93.0,-89.0,-92.0,19.0,23.0,23.0,32.0,1
2951,BA:8C:B9:54:50:24,3765029,474937548,312,90962,3764717,474846586,0,1335,146259,1317,143413,18,2846,200,5,437,9,0,8,216660.0,130000.0,-40.0,-37.0,-45.0,-51.0,-41.0,-36.0,-44.0,-50.0,-90.0,-93.0,-89.0,-92.0,50.0,56.0,44.0,41.0,1
2952,92:69:1D:31:68:E9,3777550,490111083,12833,15264497,3764717,474846586,3,19396,3599991,18693,3438254,703,161737,6478,105,14100,252,3,252,216660.0,130000.0,-52.0,-51.0,-44.0,-49.0,-51.0,-48.0,-43.0,-49.0,-90.0,-93.0,-89.0,-92.0,38.0,42.0,45.0,43.0,1
2953,CC:2F:71:3F:1F:24,4030451,784121127,265729,309274077,3764722,474847050,27,223645,256075619,223548,256063627,97,11992,213684,6,265730,23866,24,155,130000.0,43333.0,-68.0,-66.0,-72.0,-68.0,-68.0,-66.0,-71.0,-68.0,-90.0,-93.0,-89.0,-92.0,22.0,27.0,17.0,24.0,1
2954,CC:2F:71:3E:C5:1F,3764835,474860697,113,13647,3764722,474847050,0,449,38251,364,28035,85,10216,120,2,151,4,0,5,130000.0,39000.0,-71.0,-70.0,-66.0,-60.0,-70.0,-69.0,-66.0,-60.0,-90.0,-93.0,-89.0,-92.0,19.0,23.0,23.0,32.0,1
2955,BA:8C:B9:54:50:24,3765034,474938012,312,90962,3764722,474847050,0,1335,146259,1317,143413,18,2846,200,5,437,9,0,8,216660.0,130000.0,-40.0,-37.0,-45.0,-51.0,-41.0,-36.0,-44.0,-50.0,-90.0,-93.0,-89.0,-92.0,50.0,56.0,44.0,41.0,1
2956,92:69:1D:31:68:E9,3777555,490111547,12833,15264497,3764722,474847050,3,19396,3599991,18693,3438254,703,161737,6478,105,14100,252,3,252,216660.0,130000.0,-52.0,-51.0,-44.0,-49.0,-51.0,-48.0,-43.0,-49.0,-90.0,-93.0,-89.0,-92.0,38.0,42.0,45.0,43.0,1
2957,CC:2F:71:3F:1F:24,4030568,784243054,265842,309395600,3764726,474847454,27,223743,256184325,223646,256172333,97,11992,213777,6,265843,23872,24,155,130000.0,43333.0,-68.0,-66.0,-72.0,-68.0,-68.0,-66.0,-72.0,-68.0,-90.0,-93.0,-89.0,-92.0,22.0,27.0,17.0,24.0,1
2958,CC:2F:71:3E:C5:1F,3764839,474861101,113,13647,3764726,474847454,0,449,38251,364,28035,85,10216,120,2,151,4,0,5,130000.0,39000.0,-71.0,-70.0,-66.0,-60.0,-70.0,-69.0,-66.0,-60.0,-90.0,-93.0,-89.0,-92.0,19.0,23.0,23.0,32.0,1
2959,BA:8C:B9:54:50:24,3765038,474938416,312,90962,3764726,474847454,0,1335,146259,1317,143413,18,2846,200,5,437,9,0,8,216660.0,130000.0,-40.0,-37.0,-45.0,-51.0,-41.0,-36.0,-44.0,-50.0,-90.0,-93.0,-89.0,-92.0,50.0,56.0,44.0,41.0,1
2960,92:69:1D:31:68:E9,3777559,490111951,12833,15264497,3764726,474847454,3,19396,3599991,18693,3438254,703,161737,6478,105,14100,252,3,252,216660.0,130000.0,-52.0,-51.0,-44.0,-49.0,-51.0,-48.0,-43.0,-49.0,-90.0,-93.0,-89.0,-92.0,38.0,42.0,45.0,43.0,1
2961,CC:2F:71:3F:1F:24,4030678,784361666,265947,309513746,3764731,474847920,27,223832,256292853,223735,256280861,97,11992,213866,6,265948,23872,24,155,130000.0,43333.0,-68.0,-66.0,-73.0,-67.0,-68.0,-66.0,-72.0,-67.0,-90.0,-93.0,-89.0,-92.0,22.0,27.0,16.0,25.0,1
2962,CC:2F:71:3E:C5:1F,3764844,474861567,113,13647,3764731,474847920,0,450,38369,364,28035,86,10334,121,2,151,4,0,5,130000.0,39000.0,-70.0,-70.0,-66.0,-60.0,-70.0,-69.0,-66.0,-60.0,-90.0,-93.0,-89.0,-92.0,20.0,23.0,23.0,32.0,1
2963,BA:8C:B9:54:50:24,3765043,474938882,312,90962,3764731,474847920,0,1335,146259,1317,143413,18,2846,200,5,437,9,0,8,216660.0,130000.0,-40.0,-37.0,-45.0,-51.0,-41.0,-36.0,-44.0,-50.0,-90.0,-93.0,-89.0,-92.0,50.0,56.0,44.0,41.0,1
2964,92:69:1D:31:68:E9,3777564,490112417,12833,15264497,3764731,474847920,3,19396,3599991,18693,3438254,703,161737,6478,105,14100,252,3,252,216660.0,130000.0,-52.0,-51.0,-44.0,-49.0,-51.0,-48.0,-43.0,-49.0,-90.0,-93.0,-89.0,-92.0,38.0,42.0,45.0,43.0,1
2965,CC:2F:71:3F:1F:24,4030788,784480276,266052,309631892,3764736,474848384,27,223926,256406311,223829,256394319,97,11992,213953,6,266053,23872,24,155,130000.0,43333.0,-68.0,-66.0,-73.0,-68.0,-68.0,-66.0,-72.0,-68.0,-90.0,-93.0,-89.0,-92.0,22.0,27.0,16.0,24.0,1
2966,CC:2F:71:3E:C5:1F,3764849,474862031,113,13647,3764736,474848384,0,451,38439,365,28105,86,10334,121,2,151,4,0,5,130000.0,39000.0,-70.0,-70.0,-66.0,-60.0,-70.0,-69.0,-66.0,-60.0,-90.0,-93.0,-89.0,-92.0,20.0,23.0,23.0,32.0,1
2967,BA:8C:B9:54:50:24,3765048,474939346,312,90962,3764736,474848384,0,1335,146259,1317,143413,18,2846,200,5,437,9,0,8,216660.0,130000.0,-40.0,-37.0,-45.0,-51.0,-41.0,-36.0,-44.0,-50.0,-90.0,-93.0,-89.0,-92.0,50.0,56.0,44.0,41.0,1
2968,92:69:1D:31:68:E9,3777569,490112881,12833,15264497,3764736,474848384,3,19396,3599991,18693,3438254,703,161737,6478,105,14100,252,3,252,216660.0,130000.0,-52.0,-51.0,-44.0,-49.0,-51.0,-48.0,-43.0,-49.0,-90.0,-93.0,-89.0,-92.0,38.0,42.0,45.0,43.0,1
2969,CC:2F:71:3F:1F:24,4030899,784600286,266159,309751498,3764740,474848788,27,224025,256527383,223928,256515391,97,11992,214042,6,266160,23876,24,155,130000.0,43333.0,-68.0,-66.0,-73.0,-67.0,-68.0,-66.0,-72.0,-67.0,-90.0,-93.0,-89.0,-92.0,22.0,27.0,16.0,25.0,1
2970,CC:2F:71:3E:C5:1F,3764853,474862435,113,13647,3764740,474848788,0,451,38439,365,28105,86,10334,121,2,151,4,0,5,130000.0,39000.0,-70.0,-70.0,-66.0,-60.0,-70.0,-69.0,-66.0,-60.0,-90.0,-93.0,-89.0,-92.0,20.0,23.0,23.0,32.0,1
2971,BA:8C:B9:54:50:24,3765052,474939750,312,90962,3764740,474848788,0,1337,146395,1319,143549,18,2846,200,5,438,9,0,8,216660.0,130000.0,-40.0,-37.0,-45.0,-50.0,-41.0,-36.0,-44.0,-50.0,-90.0,-93.0,-89.0,-92.0,50.0,56.0,44.0,42.0,1
2972,92:69:1D:31:68:E9,3777573,490113285,12833,15264497,3764740,474848788,3,19398,3600127,18695,3438390,703,161737,6478,105,14101,252,3,252,216660.0,130000.0,-52.0,-50.0,-44.0,-51.0,-51.0,-49.0,-43.0,-49.0,-90.0,-93.0,-89.0,-92.0,38.0,43.0,45.0,41.0,1
2973,CC:2F:71:3F:1F:24,4031021,784724573,266277,309875381,3764744,474849192,27,224129,256643913,224032,256631921,97,11992,214142,6,266278,23877,24,155,130000.0,43333.0,-68.0,-66.0,-72.0,-67.0,-68.0,-66.0,-72.0,-67.0,-90.0,-93.0,-89.0,-92.0,22.0,27.0,17.0,25.0,1
2974,CC:2F:71:3E:C5:1F,3764858,474862899,113,13647,3764745,474849252,0,451,38439,365,28105,86,10334,121,2,151,4,0,5,130000.0,39000.0,-70.0,-70.0,-66.0,-60.0,-70.0,-69.0,-66.0,-60.0,-90.0,-93.0,-89.0,-92.0,20.0,23.0,23.0,32.0,1
2975,BA:8C:B9:54:50:24,3765057,474940214,312,90962,3764745,474849252,0,1338,146463,1320,143617,18,2846,200,5,438,9,0,8,216660.0,130000.0,-48.0,-35.0,-43.0,-45.0,-41.0,-36.0,-44.0,-50.0,-90.0,-93.0,-89.0,-92.0,42.0,58.0,46.0,47.0,1
2976,92:69:1D:31:68:E9,3777578,490113749,12833,15264497,3764745,474849252,3,19398,3600127,18695,3438390,703,161737,6478,105,14101,252,3,252,216660.0,130000.0,-52.0,-50.0,-44.0,-51.0,-51.0,-49.0,-43.0,-49.0,-90.0,-93.0,-89.0,-92.0,38.0,43.0,45.0,41.0,1
2977,CC:2F:71:3F:1F:24,4031129,784842925,266382,309993471,3764747,474849454,27,224216,256750757,224119,256738765,97,11992,214229,6,266383,23879,24,155,130000.0,39000.0,-69.0,-66.0,-72.0,-68.0,-68.0,-66.0,-72.0,-68.0,-90.0,-92.0,-89.0,-92.0,21.0,26.0,17.0,24.0,1
2978,CC:2F:71:3E:C5:1F,3764862,474863303,113,13647,3764749,474849656,0,451,38439,365,28105,86,10334,121,2,151,4,0,5,130000.0,39000.0,-70.0,-70.0,-66.0,-60.0,-70.0,-69.0,-66.0,-60.0,-90.0,-92.0,-89.0,-92.0,20.0,22.0,23.0,32.0,1
2979,BA:8C:B9:54:50:24,3765061,474940618,312,90962,3764749,474849656,0,1338,146463,1320,143617,18,2846,200,5,438,9,0,8,216660.0,130000.0,-48.0,-35.0,-43.0,-45.0,-41.0,-36.0,-44.0,-50.0,-90.0,-92.0,-89.0,-92.0,42.0,57.0,46.0,47.0,1
2980,92:69:1D:31:68:E9,3777582,490114153,12833,15264497,3764749,474849656,3,19398,3600127,18695,3438390,703,161737,6478,105,14101,252,3,252,216660.0,130000.0,-52.0,-50.0,-44.0,-51.0,-51.0,-49.0,-43.0,-49.0,-90.0,-92.0,-89.0,-92.0,38.0,42.0,45.0,41.0,1
2981,CC:2F:71:3F:1F:24,4031241,784961625,266488,310111565,3764753,474850060,27,224304,256857721,224207,256845729,97,11992,214316,6,266488,23886,24,155,130000.0,43333.0,-72.0,-70.0,-76.0,-71.0,-72.0,-70.0,-76.0,-71.0,-90.0,-92.0,-89.0,-92.0,18.0,22.0,13.0,21.0,1
2982,CC:2F:71:3E:C5:1F,3764866,474863707,113,13647,3764753,474850060,0,451,38439,365,28105,86,10334,121,2,151,4,0,5,130000.0,39000.0,-70.0,-70.0,-66.0,-60.0,-70.0,-69.0,-66.0,-60.0,-90.0,-92.0,-89.0,-92.0,20.0,22.0,23.0,32.0,1
2983,BA:8C:B9:54:50:24,3765065,474941022,312,90962,3764753,474850060,0,1338,146463,1320,143617,18,2846,200,5,438,9,0,8,216660.0,130000.0,-48.0,-35.0,-43.0,-45.0,-41.0,-36.0,-44.0,-50.0,-90.0,-92.0,-89.0,-92.0,42.0,57.0,46.0,47.0,1
2984,92:69:1D:31:68:E9,3777586,490114557,12833,15264497,3764753,474850060,3,19398,3600127,18695,3438390,703,161737,6478,105,14101,252,3,252,216660.0,130000.0,-52.0,-50.0,-44.0,-51.0,-51.0,-49.0,-43.0,-49.0,-90.0,-92.0,-89.0,-92.0,38.0,42.0,45.0,41.0,1
2985,CC:2F:71:3F:1F:24,4031349,785080033,266593,310229711,3764756,474850322,27,224401,256977371,224304,256965379,97,11992,214404,6,266594,23886,24,155,130000.0,43333.0,-69.0,-67.0,-73.0,-68.0,-68.0,-67.0,-72.0,-68.0,-90.0,-92.0,-89.0,-92.0,21.0,25.0,16.0,24.0,1
2986,CC:2F:71:3E:C5:1F,3764871,474864171,113,13647,3764758,474850524,0,451,38439,365,28105,86,10334,121,2,151,4,0,5,130000.0,39000.0,-70.0,-70.0,-66.0,-60.0,-70.0,-69.0,-66.0,-60.0,-90.0,-92.0,-89.0,-92.0,20.0,22.0,23.0,32.0,1
2987,BA:8C:B9:54:50:24,3765070,474941486,312,90962,3764758,474850524,0,1338,146463,1320,143617,18,2846,200,5,438,9,0,8,216660.0,130000.0,-48.0,-35.0,-43.0,-45.0,-41.0,-36.0,-44.0,-50.0,-90.0,-92.0,-89.0,-92.0,42.0,57.0,46.0,47.0,1
2988,92:69:1D:31:68:E9,3777591,490115021,12833,15264497,3764758,474850524,3,19398,3600127,18695,3438390,703,161737,6478,105,14101,252,3,252,216660.0,130000.0,-52.0,-50.0,-44.0,-51.0,-51.0,-49.0,-43.0,-49.0,-90.0,-92.0,-89.0,-92.0,38.0,42.0,45.0,41.0,1
2989,CC:2F:71:3F:1F:24,4031469,785202292,266707,310351364,3764762,474850928,27,224502,257090706,224405,257078714,97,11992,214501,6,266707,23895,24,155,130000.0,43333.0,-69.0,-67.0,-73.0,-68.0,-68.0,-66.0,-72.0,-68.0,-90.0,-92.0,-89.0,-92.0,21.0,25.0,16.0,24.0,1
2990,CC:2F:71:3E:C5:1F,3764875,474864575,113,13647,3764762,474850928,0,451,38439,365,28105,86,10334,121,2,151,4,0,5,130000.0,39000.0,-70.0,-70.0,-66.0,-60.0,-70.0,-69.0,-66.0,-60.0,-90.0,-92.0,-89.0,-92.0,20.0,22.0,23.0,32.0,1
2991,BA:8C:B9:54:50:24,3765074,474941890,312,90962,3764762,474850928,0,1338,146463,1320,143617,18,2846,200,5,438,9,0,8,216660.0,130000.0,-48.0,-35.0,-43.0,-45.0,-41.0,-36.0,-44.0,-50.0,-90.0,-92.0,-89.0,-92.0,42.0,57.0,46.0,47.0,1
2992,92:69:1D:31:68:E9,3777595,490115425,12833,15264497,3764762,474850928,3,19398,3600127,18695,3438390,703,161737,6478,105,14101,252,3,252,216660.0,130000.0,-52.0,-50.0,-44.0,-51.0,-51.0,-49.0,-43.0,-49.0,-90.0,-92.0,-89.0,-92.0,38.0,42.0,45.0,41.0,1
2993,CC:2F:71:3F:1F:24,4031580,785325575,266815,310474172,3764765,474851403,27,224596,257208400,224499,257196408,97,11992,214590,6,266816,23895,24,155,130000.0,43333.0,-72.0,-70.0,-76.0,-71.0,-71.0,-69.0,-75.0,-70.0,-90.0,-92.0,-89.0,-92.0,18.0,22.0,13.0,21.0,1
2994,CC:2F:71:3E:C5:1F,3764880,474865252,113,13647,3764767,474851605,0,451,38439,365,28105,86,10334,121,2,151,4,0,5,130000.0,39000.0,-70.0,-70.0,-66.0,-60.0,-70.0,-69.0,-66.0,-60.0,-90.0,-92.0,-89.0,-92.0,20.0,22.0,23.0,32.0,1
2995,BA:8C:B9:54:50:24,3765079,474942567,312,90962,3764767,474851605,0,1338,146463,1320,143617,18,2846,200,5,438,9,0,8,216660.0,130000.0,-48.0,-35.0,-43.0,-45.0,-41.0,-36.0,-44.0,-50.0,-90.0,-92.0,-89.0,-92.0,42.0,57.0,46.0,47.0,1
2996,92:69:1D:31:68:E9,3777600,490116102,12833,15264497,3764767,474851605,3,19398,3600127,18695,3438390,703,161737,6478,105,14101,252,3,252,216660.0,130000.0,-52.0,-50.0,-44.0,-51.0,-51.0,-49.0,-43.0,-49.0,-90.0,-92.0,-89.0,-92.0,38.0,42.0,45.0,41.0,1
2997,CC:2F:71:3F:1F:24,4031692,785444387,266920,310592318,3764772,474852069,27,224687,257320116,224590,257308124,97,11992,214677,6,266921,23895,24,155,130000.0,43333.0,-72.0,-70.0,-76.0,-71.0,-72.0,-70.0,-76.0,-71.0,-90.0,-92.0,-89.0,-92.0,18.0,22.0,13.0,21.0,1
2998,CC:2F:71:3E:C5:1F,3764885,474865716,113,13647,3764772,474852069,0,451,38439,365,28105,86,10334,121,2,151,4,0,5,130000.0,39000.0,-70.0,-70.0,-66.0,-60.0,-70.0,-69.0,-66.0,-60.0,-90.0,-92.0,-89.0,-92.0,20.0,22.0,23.0,32.0,1
2999,BA:8C:B9:54:50:24,3765084,474943031,312,90962,3764772,474852069,0,1338,146463,1320,143617,18,2846,200,5,438,9,0,8,216660.0,130000.0,-48.0,-35.0,-43.0,-45.0,-41.0,-36.0,-44.0,-50.0,-90.0,-92.0,-89.0,-92.0,42.0,57.0,46.0,47.0,1
3000,92:69:1D:31:68:E9,3777605,490116566,12833,15264497,3764772,474852069,3,19398,3600127,18695,3438390,703,161737,6478,105,14101,252,3,252,216660.0,130000.0,-52.0,-50.0,-44.0,-51.0,-51.0,-49.0,-43.0,-49.0,-90.0,-92.0,-89.0,-92.0,38.0,42.0,45.0,41.0,1
3001,CC:2F:71:3F:1F:24,4031798,785560957,267024,310708686,3764774,474852271,27,224782,257433792,224685,257421800,97,11992,214764,6,267025,23899,24,155,130000.0,43333.0,-68.0,-66.0,-72.0,-68.0,-68.0,-66.0,-72.0,-67.0,-90.0,-92.0,-89.0,-92.0,22.0,26.0,17.0,24.0,1
3002,CC:2F:71:3E:C5:1F,3764889,474866120,113,13647,3764776,474852473,0,451,38439,365,28105,86,10334,121,2,151,4,0,5,130000.0,39000.0,-70.0,-70.0,-66.0,-60.0,-70.0,-69.0,-66.0,-60.0,-90.0,-92.0,-89.0,-92.0,20.0,22.0,23.0,32.0,1
3003,BA:8C:B9:54:50:24,3765088,474943435,312,90962,3764776,474852473,0,1338,146463,1320,143617,18,2846,200,5,438,9,0,8,216660.0,130000.0,-48.0,-35.0,-43.0,-45.0,-41.0,-36.0,-44.0,-50.0,-90.0,-92.0,-89.0,-92.0,42.0,57.0,46.0,47.0,1
3004,92:69:1D:31:68:E9,3777609,490116970,12833,15264497,3764776,474852473,3,19398,3600127,18695,3438390,703,161737,6478,105,14101,252,3,252,216660.0,130000.0,-52.0,-50.0,-44.0,-51.0,-51.0,-49.0,-43.0,-49.0,-90.0,-92.0,-89.0,-92.0,38.0,42.0,45.0,41.0,1
3005,CC:2F:71:3F:1F:24,4031912,785682264,267134,310829589,3764778,474852675,27,224878,257546595,224781,257534603,97,11992,214856,6,267135,23900,24,155,130000.0,43333.0,-69.0,-66.0,-73.0,-68.0,-68.0,-66.0,-72.0,-68.0,-90.0,-92.0,-89.0,-92.0,21.0,26.0,16.0,24.0,1
3006,CC:2F:71:3E:C5:1F,3764891,474866322,113,13647,3764778,474852675,0,451,38439,365,28105,86,10334,121,2,151,4,0,5,130000.0,39000.0,-70.0,-70.0,-66.0,-60.0,-70.0,-69.0,-66.0,-60.0,-90.0,-92.0,-89.0,-92.0,20.0,22.0,23.0,32.0,1
3007,BA:8C:B9:54:50:24,3765093,474943899,312,90962,3764781,474852937,0,1338,146463,1320,143617,18,2846,200,5,438,9,0,8,216660.0,130000.0,-48.0,-35.0,-43.0,-45.0,-41.0,-36.0,-44.0,-50.0,-90.0,-92.0,-89.0,-92.0,42.0,57.0,46.0,47.0,1
3008,92:69:1D:31:68:E9,3777614,490117434,12833,15264497,3764781,474852937,3,19398,3600127,18695,3438390,703,161737,6478,105,14101,252,3,252,216660.0,130000.0,-52.0,-50.0,-44.0,-51.0,-51.0,-49.0,-43.0,-49.0,-90.0,-92.0,-89.0,-92.0,38.0,42.0,45.0,41.0,1
3009,CC:2F:71:3F:1F:24,4032030,785808192,267247,310955053,3764783,474853139,27,224978,257664969,224881,257652977,97,11992,214953,6,267248,23900,24,155,130000.0,43333.0,-69.0,-67.0,-73.0,-68.0,-69.0,-66.0,-72.0,-68.0,-90.0,-92.0,-89.0,-92.0,21.0,25.0,16.0,24.0,1
3010,CC:2F:71:3E:C5:1F,3764898,474866988,113,13647,3764785,474853341,0,451,38439,365,28105,86,10334,121,2,151,4,0,5,130000.0,39000.0,-70.0,-70.0,-66.0,-60.0,-70.0,-69.0,-66.0,-60.0,-90.0,-92.0,-89.0,-92.0,20.0,22.0,23.0,32.0,1
3011,BA:8C:B9:54:50:24,3765097,474944303,312,90962,3764785,474853341,0,1338,146463,1320,143617,18,2846,200,5,438,9,0,8,216660.0,130000.0,-48.0,-35.0,-43.0,-45.0,-41.0,-36.0,-44.0,-50.0,-90.0,-92.0,-89.0,-92.0,42.0,57.0,46.0,47.0,1
3012,92:69:1D:31:68:E9,3777618,490117838,12833,15264497,3764785,474853341,3,19398,3600127,18695,3438390,703,161737,6478,105,14101,252,3,252,216660.0,130000.0,-52.0,-50.0,-44.0,-51.0,-51.0,-49.0,-43.0,-49.0,-90.0,-92.0,-89.0,-92.0,38.0,42.0,45.0,41.0,1
3013,CC:2F:71:3F:1F:24,4032140,785925224,267353,311071681,3764787,474853543,27,225070,257776735,224973,257764743,97,11992,215040,6,267354,23904,24,155,130000.0,43333.0,-69.0,-67.0,-73.0,-68.0,-68.0,-66.0,-72.0,-68.0,-90.0,-92.0,-89.0,-92.0,21.0,25.0,16.0,24.0,1
3014,CC:2F:71:3E:C5:1F,3764900,474867190,113,13647,3764787,474853543,0,451,38439,365,28105,86,10334,121,2,151,4,0,5,130000.0,39000.0,-70.0,-70.0,-66.0,-60.0,-70.0,-69.0,-66.0,-60.0,-90.0,-92.0,-89.0,-92.0,20.0,22.0,23.0,32.0,1
3015,BA:8C:B9:54:50:24,3765101,474944707,312,90962,3764789,474853745,0,1338,146463,1320,143617,18,2846,200,5,438,9,0,8,216660.0,130000.0,-48.0,-35.0,-43.0,-45.0,-41.0,-36.0,-44.0,-50.0,-90.0,-92.0,-89.0,-92.0,42.0,57.0,46.0,47.0,1
3016,92:69:1D:31:68:E9,3777622,490118242,12833,15264497,3764789,474853745,3,19398,3600127,18695,3438390,703,161737,6478,105,14101,252,3,252,216660.0,130000.0,-52.0,-50.0,-44.0,-51.0,-51.0,-49.0,-43.0,-49.0,-90.0,-92.0,-89.0,-92.0,38.0,42.0,45.0,41.0,1
3017,CC:2F:71:3F:1F:24,4032250,786045316,267460,311191511,3764790,474853805,27,225167,257892163,225070,257880171,97,11992,215129,6,267461,23904,24,155,130000.0,43333.0,-69.0,-67.0,-72.0,-68.0,-68.0,-67.0,-72.0,-68.0,-90.0,-92.0,-89.0,-92.0,21.0,25.0,17.0,24.0,1
3018,CC:2F:71:3E:C5:1F,3764905,474867654,113,13647,3764792,474854007,0,451,38439,365,28105,86,10334,121,2,151,4,0,5,130000.0,39000.0,-70.0,-70.0,-66.0,-60.0,-70.0,-69.0,-66.0,-60.0,-90.0,-92.0,-89.0,-92.0,20.0,22.0,23.0,32.0,1
3019,BA:8C:B9:54:50:24,3765106,474945171,312,90962,3764794,474854209,0,1338,146463,1320,143617,18,2846,200,5,438,9,0,8,216660.0,130000.0,-48.0,-35.0,-43.0,-45.0,-41.0,-36.0,-44.0,-50.0,-90.0,-92.0,-89.0,-92.0,42.0,57.0,46.0,47.0,1
3020,92:69:1D:31:68:E9,3777627,490118706,12833,15264497,3764794,474854209,3,19398,3600127,18695,3438390,703,161737,6478,105,14101,252,3,252,216660.0,130000.0,-52.0,-50.0,-44.0,-51.0,-51.0,-49.0,-43.0,-49.0,-90.0,-92.0,-89.0,-92.0,38.0,42.0,45.0,41.0,1
3021,CC:2F:71:3F:1F:24,4032361,786162462,267565,311308051,3764796,474854411,27,225258,258003799,225161,257991807,97,11992,215216,6,267566,23908,24,155,130000.0,39000.0,-68.0,-66.0,-73.0,-67.0,-68.0,-66.0,-72.0,-67.0,-90.0,-92.0,-89.0,-92.0,22.0,26.0,16.0,25.0,1
3022,CC:2F:71:3E:C5:1F,3764910,474868174,114,13763,3764796,474854411,0,453,38579,367,28245,86,10334,121,2,152,4,0,5,130000.0,39000.0,-70.0,-70.0,-66.0,-60.0,-70.0,-69.0,-66.0,-60.0,-90.0,-92.0,-89.0,-92.0,20.0,22.0,23.0,32.0,1
3023,BA:8C:B9:54:50:24,3765111,474945691,313,91078,3764798,474854613,0,1340,146599,1322,143753,18,2846,200,5,439,9,0,8,216660.0,130000.0,-48.0,-35.0,-43.0,-45.0,-42.0,-36.0,-44.0,-49.0,-90.0,-92.0,-89.0,-92.0,42.0,57.0,46.0,47.0,1
3024,92:69:1D:31:68:E9,3777632,490119226,12834,15264613,3764798,474854613,3,19400,3600263,18697,3438526,703,161737,6478,105,14102,252,3,252,229410.0,130000.0,-52.0,-48.0,-42.0,-49.0,-51.0,-49.0,-43.0,-50.0,-90.0,-92.0,-89.0,-92.0,38.0,44.0,47.0,43.0,1
3025,CC:2F:71:3F:1F:24,4032478,786286039,267680,311431426,3764798,474854613,27,225362,258124706,225265,258112714,97,11992,215312,6,267681,23908,24,155,130000.0,43333.0,-70.0,-67.0,-73.0,-69.0,-69.0,-67.0,-72.0,-68.0,-90.0,-92.0,-89.0,-92.0,20.0,25.0,16.0,23.0,1
3026,CC:2F:71:3E:C5:1F,3764914,474868578,114,13763,3764800,474854815,0,453,38579,367,28245,86,10334,121,2,152,4,0,5,130000.0,39000.0,-70.0,-70.0,-66.0,-60.0,-70.0,-69.0,-66.0,-60.0,-90.0,-92.0,-89.0,-92.0,20.0,22.0,23.0,32.0,1
3027,BA:8C:B9:54:50:24,3765115,474946095,313,91078,3764802,474855017,0,1340,146599,1322,143753,18,2846,200,5,439,9,0,8,216660.0,130000.0,-48.0,-35.0,-43.0,-45.0,-42.0,-36.0,-44.0,-49.0,-90.0,-92.0,-89.0,-92.0,42.0,57.0,46.0,47.0,1
3028,92:69:1D:31:68:E9,3777636,490119630,12834,15264613,3764802,474855017,3,19400,3600263,18697,3438526,703,161737,6478,105,14102,252,3,252,229410.0,130000.0,-52.0,-48.0,-42.0,-49.0,-51.0,-49.0,-43.0,-50.0,-90.0,-92.0,-89.0,-92.0,38.0,44.0,47.0,43.0,1
3029,CC:2F:71:3F:1F:24,4032595,786405924,267790,311550645,3764805,474855279,27,225458,258232827,225361,258220835,97,11992,215404,6,267790,23908,24,155,130000.0,43333.0,-69.0,-67.0,-72.0,-68.0,-69.0,-67.0,-71.0,-67.0,-90.0,-92.0,-89.0,-92.0,21.0,25.0,17.0,24.0,1
3030,CC:2F:71:3E:C5:1F,3764919,474869042,114,13763,3764805,474855279,0,453,38579,367,28245,86,10334,121,2,152,4,0,5,130000.0,39000.0,-70.0,-70.0,-66.0,-60.0,-70.0,-69.0,-66.0,-60.0,-90.0,-92.0,-89.0,-92.0,20.0,22.0,23.0,32.0,1
3031,BA:8C:B9:54:50:24,3765118,474946357,313,91078,3764805,474855279,0,1340,146599,1322,143753,18,2846,200,5,439,9,0,8,216660.0,130000.0,-48.0,-35.0,-43.0,-45.0,-42.0,-36.0,-44.0,-49.0,-90.0,-92.0,-89.0,-92.0,42.0,57.0,46.0,47.0,1
3032,92:69:1D:31:68:E9,3777639,490119892,12834,15264613,3764805,474855279,3,19400,3600263,18697,3438526,703,161737,6478,105,14102,252,3,252,229410.0,130000.0,-52.0,-48.0,-42.0,-49.0,-51.0,-49.0,-43.0,-50.0,-90.0,-92.0,-89.0,-92.0,38.0,44.0,47.0,43.0,1
3033,CC:2F:71:3F:1F:24,4032702,786524048,267895,311668567,3764807,474855481,27,225550,258347427,225453,258335435,97,11992,215492,6,267896,23912,24,155,130000.0,43333.0,-69.0,-67.0,-72.0,-68.0,-69.0,-67.0,-72.0,-68.0,-90.0,-92.0,-89.0,-92.0,21.0,25.0,17.0,24.0,1
3034,CC:2F:71:3E:C5:1F,3764921,474869244,114,13763,3764807,474855481,0,453,38579,367,28245,86,10334,121,2,152,4,0,5,130000.0,39000.0,-70.0,-70.0,-66.0,-60.0,-70.0,-69.0,-66.0,-60.0,-90.0,-92.0,-89.0,-92.0,20.0,22.0,23.0,32.0,1
3035,BA:8C:B9:54:50:24,3765122,474946761,313,91078,3764809,474855683,0,1340,146599,1322,143753,18,2846,200,5,439,9,0,8,216660.0,130000.0,-48.0,-35.0,-43.0,-45.0,-42.0,-36.0,-44.0,-49.0,-90.0,-92.0,-89.0,-92.0,42.0,57.0,46.0,47.0,1
3036,92:69:1D:31:68:E9,3777645,490120498,12834,15264613,3764811,474855885,3,19400,3600263,18697,3438526,703,161737,6478,105,14102,252,3,252,229410.0,130000.0,-52.0,-48.0,-42.0,-49.0,-51.0,-49.0,-43.0,-50.0,-90.0,-92.0,-89.0,-92.0,38.0,44.0,47.0,43.0,1
3037,CC:2F:71:3F:1F:24,4032813,786642800,268000,311786713,3764813,474856087,27,225640,258458933,225543,258446941,97,11992,215579,6,268001,23912,24,155,130000.0,43333.0,-76.0,-73.0,-78.0,-74.0,-72.0,-70.0,-75.0,-71.0,-90.0,-92.0,-89.0,-91.0,14.0,19.0,11.0,17.0,1
3038,CC:2F:71:3E:C5:1F,3764927,474869850,114,13763,3764813,474856087,0,453,38579,367,28245,86,10334,121,2,152,4,0,5,130000.0,39000.0,-70.0,-70.0,-66.0,-60.0,-70.0,-69.0,-66.0,-60.0,-90.0,-92.0,-89.0,-91.0,20.0,22.0,23.0,31.0,1
3039,BA:8C:B9:54:50:24,3765126,474947165,313,91078,3764813,474856087,0,1340,146599,1322,143753,18,2846,200,5,439,9,0,8,216660.0,130000.0,-48.0,-35.0,-43.0,-45.0,-42.0,-36.0,-44.0,-49.0,-90.0,-92.0,-89.0,-91.0,42.0,57.0,46.0,46.0,1
3040,92:69:1D:31:68:E9,3777648,490120760,12834,15264613,3764814,474856147,3,19400,3600263,18697,3438526,703,161737,6478,105,14102,252,3,252,229410.0,130000.0,-52.0,-48.0,-42.0,-49.0,-51.0,-49.0,-43.0,-50.0,-90.0,-92.0,-89.0,-91.0,38.0,44.0,47.0,42.0,1
3041,CC:2F:71:3F:1F:24,4032931,786766517,268115,311910168,3764816,474856349,27,225741,258575186,225644,258563194,97,11992,215675,6,268116,23913,24,155,130000.0,43333.0,-68.0,-67.0,-72.0,-68.0,-68.0,-67.0,-72.0,-68.0,-90.0,-92.0,-89.0,-91.0,22.0,25.0,17.0,23.0,1
3042,CC:2F:71:3E:C5:1F,3764930,474870112,114,13763,3764816,474856349,0,453,38579,367,28245,86,10334,121,2,152,4,0,5,130000.0,39000.0,-70.0,-70.0,-66.0,-60.0,-70.0,-69.0,-66.0,-60.0,-90.0,-92.0,-89.0,-91.0,20.0,22.0,23.0,31.0,1
3043,BA:8C:B9:54:50:24,3765131,474947629,313,91078,3764818,474856551,0,1340,146599,1322,143753,18,2846,200,5,439,9,0,8,216660.0,130000.0,-48.0,-35.0,-43.0,-45.0,-42.0,-36.0,-44.0,-49.0,-90.0,-92.0,-89.0,-92.0,42.0,57.0,46.0,47.0,1
3044,92:69:1D:31:68:E9,3777654,490121366,12834,15264613,3764820,474856753,3,19400,3600263,18697,3438526,703,161737,6478,105,14102,252,3,252,229410.0,130000.0,-52.0,-48.0,-42.0,-49.0,-51.0,-49.0,-43.0,-50.0,-90.0,-92.0,-89.0,-92.0,38.0,44.0,47.0,43.0,1
3045,CC:2F:71:3F:1F:24,4033044,786885380,268220,312028090,3764824,474857290,27,225831,258683818,225733,258671708,98,12110,215764,6,268221,23918,24,155,130000.0,43333.0,-68.0,-66.0,-73.0,-68.0,-68.0,-66.0,-73.0,-68.0,-90.0,-92.0,-89.0,-92.0,22.0,26.0,16.0,24.0,1
3046,CC:2F:71:3E:C5:1F,3764938,474871053,114,13763,3764824,474857290,0,453,38579,367,28245,86,10334,121,2,152,4,0,5,130000.0,39000.0,-70.0,-70.0,-66.0,-60.0,-70.0,-69.0,-66.0,-60.0,-90.0,-92.0,-89.0,-92.0,20.0,22.0,23.0,32.0,1
3047,BA:8C:B9:54:50:24,3765137,474948368,313,91078,3764824,474857290,0,1340,146599,1322,143753,18,2846,200,5,439,9,0,8,216660.0,130000.0,-48.0,-35.0,-43.0,-45.0,-42.0,-36.0,-44.0,-49.0,-90.0,-92.0,-89.0,-92.0,42.0,57.0,46.0,47.0,1
3048,92:69:1D:31:68:E9,3777658,490121903,12834,15264613,3764824,474857290,3,19400,3600263,18697,3438526,703,161737,6478,105,14102,252,3,252,229410.0,130000.0,-52.0,-48.0,-42.0,-49.0,-51.0,-49.0,-43.0,-50.0,-90.0,-92.0,-89.0,-92.0,38.0,44.0,47.0,43.0,1
3049,CC:2F:71:3F:1F:24,4033153,787005338,268325,312147660,3764828,474857678,27,225922,258794098,225824,258781988,98,12110,215853,6,268326,23918,24,155,130000.0,43333.0,-69.0,-66.0,-72.0,-68.0,-69.0,-66.0,-72.0,-68.0,-90.0,-92.0,-89.0,-92.0,21.0,26.0,17.0,24.0,1
3050,CC:2F:71:3E:C5:1F,3764942,474871441,114,13763,3764828,474857678,0,453,38579,367,28245,86,10334,121,2,152,4,0,5,130000.0,39000.0,-70.0,-70.0,-66.0,-60.0,-70.0,-69.0,-66.0,-60.0,-90.0,-92.0,-89.0,-92.0,20.0,22.0,23.0,32.0,1
3051,BA:8C:B9:54:50:24,3765141,474948756,313,91078,3764828,474857678,0,1340,146599,1322,143753,18,2846,200,5,439,9,0,8,216660.0,130000.0,-48.0,-35.0,-43.0,-45.0,-42.0,-36.0,-44.0,-49.0,-90.0,-92.0,-89.0,-92.0,42.0,57.0,46.0,47.0,1
3052,92:69:1D:31:68:E9,3777666,490122695,12834,15264613,3764832,474858082,3,19400,3600263,18697,3438526,703,161737,6478,105,14102,252,3,252,229410.0,130000.0,-52.0,-48.0,-42.0,-49.0,-51.0,-49.0,-43.0,-50.0,-90.0,-92.0,-89.0,-92.0,38.0,44.0,47.0,43.0,1
3053,CC:2F:71:3F:1F:24,4033264,787123978,268430,312265694,3764834,474858284,27,226010,258901214,225912,258889104,98,12110,215939,6,268431,23923,24,155,117000.0,39000.0,-69.0,-66.0,-72.0,-68.0,-68.0,-66.0,-72.0,-68.0,-90.0,-93.0,-89.0,-92.0,21.0,27.0,17.0,24.0,1
3054,CC:2F:71:3E:C5:1F,3764948,474872047,114,13763,3764834,474858284,0,453,38579,367,28245,86,10334,121,2,152,4,0,5,130000.0,39000.0,-70.0,-70.0,-66.0,-60.0,-70.0,-69.0,-66.0,-60.0,-90.0,-93.0,-89.0,-92.0,20.0,23.0,23.0,32.0,1
3055,BA:8C:B9:54:50:24,3765147,474949362,313,91078,3764834,474858284,0,1340,146599,1322,143753,18,2846,200,5,439,9,0,8,216660.0,130000.0,-48.0,-35.0,-43.0,-45.0,-42.0,-36.0,-44.0,-49.0,-90.0,-93.0,-89.0,-92.0,42.0,58.0,46.0,47.0,1
3056,92:69:1D:31:68:E9,3777668,490122897,12834,15264613,3764834,474858284,3,19400,3600263,18697,3438526,703,161737,6478,105,14102,252,3,252,229410.0,130000.0,-52.0,-48.0,-42.0,-49.0,-51.0,-49.0,-43.0,-50.0,-90.0,-93.0,-89.0,-92.0,38.0,45.0,47.0,43.0,1
3057,CC:2F:71:3F:1F:24,4033377,787245443,268541,312386957,3764836,474858486,27,226109,259017117,226011,259005007,98,12110,216034,6,268542,23926,24,155,130000.0,39000.0,-69.0,-66.0,-72.0,-68.0,-69.0,-66.0,-72.0,-68.0,-90.0,-93.0,-89.0,-92.0,21.0,27.0,17.0,24.0,1
3058,CC:2F:71:3E:C5:1F,3764951,474872311,114,13763,3764837,474858548,0,454,38697,367,28245,87,10452,122,2,152,4,0,5,130000.0,39000.0,-70.0,-70.0,-66.0,-60.0,-70.0,-70.0,-66.0,-60.0,-90.0,-93.0,-89.0,-92.0,20.0,23.0,23.0,32.0,1
3059,BA:8C:B9:54:50:24,3765150,474949626,313,91078,3764837,474858548,0,1340,146599,1322,143753,18,2846,200,5,439,9,0,8,216660.0,130000.0,-48.0,-35.0,-43.0,-45.0,-42.0,-36.0,-44.0,-49.0,-90.0,-93.0,-89.0,-92.0,42.0,58.0,46.0,47.0,1
3060,92:69:1D:31:68:E9,3777671,490123161,12834,15264613,3764837,474858548,3,19400,3600263,18697,3438526,703,161737,6478,105,14102,252,3,252,229410.0,130000.0,-52.0,-48.0,-42.0,-49.0,-51.0,-49.0,-43.0,-50.0,-90.0,-93.0,-89.0,-92.0,38.0,45.0,47.0,43.0,1
3061,CC:2F:71:3F:1F:24,4033489,787362651,268645,312503437,3764844,474859214,27,226205,259135085,226107,259122975,98,12110,216122,6,268646,23926,24,155,130000.0,43333.0,-69.0,-66.0,-73.0,-68.0,-68.0,-66.0,-72.0,-68.0,-90.0,-93.0,-89.0,-92.0,21.0,27.0,16.0,24.0,1
3062,CC:2F:71:3E:C5:1F,3764958,474872977,114,13763,3764844,474859214,0,455,38767,368,28315,87,10452,122,2,152,4,0,5,130000.0,39000.0,-70.0,-70.0,-66.0,-60.0,-70.0,-70.0,-66.0,-60.0,-90.0,-93.0,-89.0,-92.0,20.0,23.0,23.0,32.0,1
3063,BA:8C:B9:54:50:24,3765157,474950292,313,91078,3764844,474859214,0,1340,146599,1322,143753,18,2846,200,5,439,9,0,8,216660.0,130000.0,-48.0,-35.0,-43.0,-45.0,-42.0,-36.0,-44.0,-49.0,-90.0,-93.0,-89.0,-92.0,42.0,58.0,46.0,47.0,1
3064,92:69:1D:31:68:E9,3777678,490123827,12834,15264613,3764844,474859214,3,19400,3600263,18697,3438526,703,161737,6478,105,14102,252,3,252,229410.0,130000.0,-52.0,-48.0,-42.0,-49.0,-51.0,-49.0,-43.0,-50.0,-90.0,-93.0,-89.0,-92.0,38.0,45.0,47.0,43.0,1
3065,CC:2F:71:3F:1F:24,4033610,787486634,268752,312621619,3764858,474865015,27,226297,259246965,226199,259234855,98,12110,216210,6,268753,23932,24,155,130000.0,43333.0,-68.0,-66.0,-72.0,-68.0,-68.0,-66.0,-72.0,-67.0,-90.0,-93.0,-89.0,-92.0,22.0,27.0,17.0,24.0,1
3066,CC:2F:71:3E:C5:1F,3764972,474878778,114,13763,3764858,474865015,0,455,38767,368,28315,87,10452,122,2,152,4,0,5,130000.0,39000.0,-70.0,-70.0,-66.0,-60.0,-70.0,-70.0,-66.0,-60.0,-90.0,-93.0,-89.0,-92.0,20.0,23.0,23.0,32.0,1
3067,BA:8C:B9:54:50:24,3765171,474956093,313,91078,3764858,474865015,0,1340,146599,1322,143753,18,2846,200,5,439,9,0,8,216660.0,130000.0,-48.0,-35.0,-43.0,-45.0,-42.0,-36.0,-44.0,-49.0,-90.0,-93.0,-89.0,-92.0,42.0,58.0,46.0,47.0,1
3068,92:69:1D:31:68:E9,3777694,490129830,12834,15264613,3764860,474865217,3,19404,3600702,18700,3438730,704,161972,6479,105,14102,252,3,252,229410.0,130000.0,-51.0,-48.0,-42.0,-49.0,-52.0,-48.0,-43.0,-49.0,-90.0,-93.0,-89.0,-92.0,39.0,45.0,47.0,43.0,1
3069,CC:2F:71:3F:1F:24,4033741,787620652,268866,312749607,3764875,474871045,27,226403,259373197,226305,259361087,98,12110,216310,6,268867,23932,24,155,130000.0,43333.0,-70.0,-67.0,-74.0,-69.0,-71.0,-69.0,-75.0,-70.0,-90.0,-93.0,-89.0,-92.0,20.0,26.0,15.0,23.0,1
3070,CC:2F:71:3E:C5:1F,3764989,474884808,114,13763,3764875,474871045,0,455,38767,368,28315,87,10452,122,2,152,4,0,5,130000.0,39000.0,-70.0,-70.0,-66.0,-60.0,-70.0,-70.0,-66.0,-60.0,-90.0,-93.0,-89.0,-92.0,20.0,23.0,23.0,32.0,1
3071,BA:8C:B9:54:50:24,3765188,474962123,313,91078,3764875,474871045,0,1340,146599,1322,143753,18,2846,200,5,439,9,0,8,216660.0,130000.0,-48.0,-35.0,-43.0,-45.0,-42.0,-36.0,-44.0,-49.0,-90.0,-93.0,-89.0,-92.0,42.0,58.0,46.0,47.0,1
3072,92:69:1D:31:68:E9,3777709,490135658,12834,15264613,3764875,474871045,3,19404,3600702,18700,3438730,704,161972,6479,105,14102,252,3,252,229410.0,130000.0,-51.0,-48.0,-42.0,-49.0,-52.0,-48.0,-43.0,-49.0,-90.0,-93.0,-89.0,-92.0,39.0,45.0,47.0,43.0,1
3073,CC:2F:71:3F:1F:24,4033860,787743159,268980,312871484,3764880,474871675,27,226508,259487406,226410,259475296,98,12110,216408,6,268981,23932,24,155,130000.0,43333.0,-69.0,-67.0,-73.0,-69.0,-69.0,-67.0,-73.0,-68.0,-90.0,-93.0,-89.0,-92.0,21.0,26.0,16.0,23.0,1
3074,CC:2F:71:3E:C5:1F,3764994,474885438,114,13763,3764880,474871675,0,455,38767,368,28315,87,10452,122,2,152,4,0,5,130000.0,39000.0,-70.0,-70.0,-66.0,-60.0,-70.0,-70.0,-66.0,-60.0,-90.0,-93.0,-89.0,-92.0,20.0,23.0,23.0,32.0,1
3075,BA:8C:B9:54:50:24,3765193,474962753,313,91078,3764880,474871675,0,1340,146599,1322,143753,18,2846,200,5,439,9,0,8,216660.0,130000.0,-48.0,-35.0,-43.0,-45.0,-42.0,-36.0,-44.0,-49.0,-90.0,-93.0,-89.0,-92.0,42.0,58.0,46.0,47.0,1
3076,92:69:1D:31:68:E9,3777716,490136490,12834,15264613,3764882,474871877,3,19404,3600702,18700,3438730,704,161972,6479,105,14102,252,3,252,229410.0,130000.0,-51.0,-48.0,-42.0,-49.0,-52.0,-48.0,-43.0,-49.0,-90.0,-93.0,-89.0,-92.0,39.0,45.0,47.0,43.0,1
3077,CC:2F:71:3F:1F:24,4033972,787861817,269086,312989536,3764886,474872281,27,226598,259597474,226500,259585364,98,12110,216496,6,269087,23939,24,155,130000.0,43333.0,-72.0,-70.0,-76.0,-72.0,-71.0,-69.0,-75.0,-70.0,-90.0,-93.0,-89.0,-92.0,18.0,23.0,13.0,20.0,1
3078,CC:2F:71:3E:C5:1F,3765000,474886044,114,13763,3764886,474872281,0,455,38767,368,28315,87,10452,122,2,152,4,0,5,130000.0,39000.0,-70.0,-70.0,-66.0,-60.0,-70.0,-70.0,-66.0,-60.0,-90.0,-93.0,-89.0,-92.0,20.0,23.0,23.0,32.0,1
3079,BA:8C:B9:54:50:24,3765199,474963359,313,91078,3764886,474872281,0,1343,146803,1325,143957,18,2846,200,5,440,9,0,8,216660.0,130000.0,-48.0,-35.0,-43.0,-45.0,-43.0,-36.0,-44.0,-48.0,-90.0,-93.0,-89.0,-92.0,42.0,58.0,46.0,47.0,1
3080,92:69:1D:31:68:E9,3777720,490136894,12834,15264613,3764886,474872281,3,19404,3600702,18700,3438730,704,161972,6479,105,14102,252,3,252,229410.0,130000.0,-51.0,-48.0,-42.0,-49.0,-52.0,-48.0,-43.0,-49.0,-90.0,-93.0,-89.0,-92.0,39.0,45.0,47.0,43.0,1
3081,CC:2F:71:3F:1F:24,4034082,787982037,269193,313109494,3764889,474872543,27,226695,259716980,226597,259704870,98,12110,216586,6,269194,23939,24,155,130000.0,43333.0,-72.0,-70.0,-76.0,-71.0,-72.0,-70.0,-76.0,-71.0,-90.0,-93.0,-89.0,-92.0,18.0,23.0,13.0,21.0,1
3082,CC:2F:71:3E:C5:1F,3765003,474886306,114,13763,3764889,474872543,0,455,38767,368,28315,87,10452,122,2,152,4,0,5,130000.0,39000.0,-70.0,-70.0,-66.0,-60.0,-70.0,-70.0,-66.0,-60.0,-90.0,-93.0,-89.0,-92.0,20.0,23.0,23.0,32.0,1
3083,BA:8C:B9:54:50:24,3765202,474963621,313,91078,3764889,474872543,0,1343,146803,1325,143957,18,2846,200,5,440,9,0,8,216660.0,130000.0,-48.0,-35.0,-43.0,-45.0,-43.0,-36.0,-44.0,-48.0,-90.0,-93.0,-89.0,-92.0,42.0,58.0,46.0,47.0,1
3084,92:69:1D:31:68:E9,3777723,490137156,12834,15264613,3764889,474872543,3,19404,3600702,18700,3438730,704,161972,6479,105,14102,252,3,252,229410.0,130000.0,-51.0,-48.0,-42.0,-49.0,-52.0,-48.0,-43.0,-49.0,-90.0,-93.0,-89.0,-92.0,39.0,45.0,47.0,43.0,1
3085,CC:2F:71:3F:1F:24,4034194,788100807,269299,313227658,3764895,474873149,27,226783,259825378,226685,259813268,98,12110,216673,6,269300,23943,24,155,130000.0,39000.0,-73.0,-70.0,-76.0,-71.0,-72.0,-70.0,-76.0,-71.0,-90.0,-93.0,-89.0,-92.0,17.0,23.0,13.0,21.0,1
3086,CC:2F:71:3E:C5:1F,3765009,474886912,114,13763,3764895,474873149,0,455,38767,368,28315,87,10452,122,2,152,4,0,5,130000.0,39000.0,-70.0,-70.0,-66.0,-60.0,-70.0,-70.0,-66.0,-60.0,-90.0,-93.0,-89.0,-92.0,20.0,23.0,23.0,32.0,1
3087,BA:8C:B9:54:50:24,3765208,474964227,313,91078,3764895,474873149,0,1343,146803,1325,143957,18,2846,200,5,440,9,0,8,216660.0,130000.0,-48.0,-35.0,-43.0,-45.0,-43.0,-36.0,-44.0,-48.0,-90.0,-93.0,-89.0,-92.0,42.0,58.0,46.0,47.0,1
3088,92:69:1D:31:68:E9,3777729,490137762,12834,15264613,3764895,474873149,3,19404,3600702,18700,3438730,704,161972,6479,105,14102,252,3,252,229410.0,130000.0,-51.0,-48.0,-42.0,-49.0,-52.0,-48.0,-43.0,-49.0,-90.0,-93.0,-89.0,-92.0,39.0,45.0,47.0,43.0,1
3089,CC:2F:71:3F:1F:24,4034310,788222774,269413,313349423,3764897,474873351,27,226881,259935538,226783,259923428,98,12110,216769,6,269414,23943,24,155,130000.0,43333.0,-69.0,-67.0,-74.0,-68.0,-70.0,-68.0,-74.0,-69.0,-90.0,-93.0,-89.0,-92.0,21.0,26.0,15.0,24.0,1
3090,CC:2F:71:3E:C5:1F,3765011,474887114,114,13763,3764897,474873351,0,455,38767,368,28315,87,10452,122,2,152,4,0,5,130000.0,39000.0,-70.0,-70.0,-66.0,-60.0,-70.0,-70.0,-66.0,-60.0,-90.0,-93.0,-89.0,-92.0,20.0,23.0,23.0,32.0,1
3091,BA:8C:B9:54:50:24,3765210,474964429,313,91078,3764897,474873351,0,1343,146803,1325,143957,18,2846,200,5,440,9,0,8,216660.0,130000.0,-48.0,-35.0,-43.0,-45.0,-43.0,-36.0,-44.0,-48.0,-90.0,-93.0,-89.0,-92.0,42.0,58.0,46.0,47.0,1
3092,92:69:1D:31:68:E9,3777731,490137964,12834,15264613,3764897,474873351,3,19404,3600702,18700,3438730,704,161972,6479,105,14102,252,3,252,229410.0,130000.0,-51.0,-48.0,-42.0,-49.0,-52.0,-48.0,-43.0,-49.0,-90.0,-93.0,-89.0,-92.0,39.0,45.0,47.0,43.0,1
3093,CC:2F:71:3F:1F:24,4034423,788343140,269519,313469123,3764904,474874017,27,226972,260045816,226874,260033706,98,12110,216857,6,269519,23944,24,155,130000.0,43333.0,-72.0,-70.0,-77.0,-71.0,-72.0,-70.0,-76.0,-71.0,-90.0,-93.0,-89.0,-92.0,18.0,23.0,12.0,21.0,1
3094,CC:2F:71:3E:C5:1F,3765018,474887780,114,13763,3764904,474874017,0,455,38767,368,28315,87,10452,122,2,152,4,0,5,130000.0,39000.0,-70.0,-70.0,-66.0,-60.0,-70.0,-70.0,-66.0,-60.0,-90.0,-93.0,-89.0,-92.0,20.0,23.0,23.0,32.0,1
3095,BA:8C:B9:54:50:24,3765217,474965095,313,91078,3764904,474874017,0,1343,146803,1325,143957,18,2846,200,5,440,9,0,8,216660.0,130000.0,-48.0,-35.0,-43.0,-45.0,-43.0,-36.0,-44.0,-48.0,-90.0,-93.0,-89.0,-92.0,42.0,58.0,46.0,47.0,1
3096,92:69:1D:31:68:E9,3777738,490138630,12834,15264613,3764904,474874017,3,19404,3600702,18700,3438730,704,161972,6479,105,14102,252,3,252,229410.0,130000.0,-51.0,-48.0,-42.0,-49.0,-52.0,-48.0,-43.0,-49.0,-90.0,-93.0,-89.0,-92.0,39.0,45.0,47.0,43.0,1
3097,CC:2F:71:3F:1F:24,4034530,788461264,269624,313587045,3764906,474874219,27,227068,260162442,226970,260150332,98,12110,216946,6,269625,23948,24,155,130000.0,43333.0,-68.0,-66.0,-72.0,-68.0,-68.0,-66.0,-72.0,-68.0,-91.0,-93.0,-90.0,-92.0,23.0,27.0,18.0,24.0,1
3098,CC:2F:71:3E:C5:1F,3765020,474887982,114,13763,3764906,474874219,0,455,38767,368,28315,87,10452,122,2,152,4,0,5,130000.0,39000.0,-70.0,-70.0,-66.0,-60.0,-70.0,-70.0,-66.0,-60.0,-91.0,-93.0,-90.0,-92.0,21.0,23.0,24.0,32.0,1
3099,BA:8C:B9:54:50:24,3765219,474965297,313,91078,3764906,474874219,0,1343,146803,1325,143957,18,2846,200,5,440,9,0,8,216660.0,130000.0,-48.0,-35.0,-43.0,-45.0,-43.0,-36.0,-44.0,-48.0,-91.0,-93.0,-90.0,-92.0,43.0,58.0,47.0,47.0,1
3100,92:69:1D:31:68:E9,3777740,490138832,12834,15264613,3764906,474874219,3,19404,3600702,18700,3438730,704,161972,6479,105,14102,252,3,252,229410.0,130000.0,-51.0,-48.0,-42.0,-49.0,-52.0,-48.0,-43.0,-49.0,-91.0,-93.0,-90.0,-92.0,40.0,45.0,48.0,43.0,1
3101,CC:2F:71:3F:1F:24,4034640,788579863,269729,313704967,3764911,474874896,27,227161,260275810,227063,260263700,98,12110,217033,6,269730,23951,24,155,130000.0,43333.0,-68.0,-66.0,-72.0,-68.0,-68.0,-66.0,-72.0,-67.0,-91.0,-93.0,-90.0,-92.0,23.0,27.0,18.0,24.0,1
3102,CC:2F:71:3E:C5:1F,3765026,474888793,114,13763,3764912,474875030,0,455,38767,368,28315,87,10452,122,2,152,4,0,5,130000.0,39000.0,-70.0,-70.0,-66.0,-60.0,-70.0,-70.0,-66.0,-60.0,-91.0,-93.0,-90.0,-92.0,21.0,23.0,24.0,32.0,1
3103,BA:8C:B9:54:50:24,3765226,474966176,313,91078,3764913,474875098,0,1343,146803,1325,143957,18,2846,200,5,440,9,0,8,216660.0,130000.0,-48.0,-35.0,-43.0,-45.0,-43.0,-36.0,-44.0,-48.0,-91.0,-93.0,-90.0,-92.0,43.0,58.0,47.0,47.0,1
3104,92:69:1D:31:68:E9,3777747,490139711,12834,15264613,3764913,474875098,3,19404,3600702,18700,3438730,704,161972,6479,105,14102,252,3,252,229410.0,130000.0,-51.0,-48.0,-42.0,-49.0,-52.0,-48.0,-43.0,-49.0,-91.0,-93.0,-90.0,-92.0,40.0,45.0,48.0,43.0,1
3105,CC:2F:71:3F:1F:24,4034758,788702074,269842,313826714,3764916,474875360,27,227258,260387168,227160,260375058,98,12110,217129,6,269843,23951,24,155,130000.0,43333.0,-69.0,-66.0,-72.0,-68.0,-69.0,-66.0,-71.0,-68.0,-91.0,-93.0,-90.0,-92.0,22.0,27.0,18.0,24.0,1
3106,CC:2F:71:3E:C5:1F,3765030,474889123,114,13763,3764916,474875360,0,455,38767,368,28315,87,10452,122,2,152,4,0,5,130000.0,39000.0,-70.0,-70.0,-66.0,-60.0,-70.0,-70.0,-66.0,-60.0,-91.0,-93.0,-90.0,-92.0,21.0,23.0,24.0,32.0,1
3107,BA:8C:B9:54:50:24,3765229,474966438,313,91078,3764916,474875360,0,1343,146803,1325,143957,18,2846,200,5,440,9,0,8,216660.0,130000.0,-48.0,-35.0,-43.0,-45.0,-43.0,-36.0,-44.0,-48.0,-91.0,-93.0,-90.0,-92.0,43.0,58.0,47.0,47.0,1
3108,92:69:1D:31:68:E9,3777750,490139973,12834,15264613,3764916,474875360,3,19404,3600702,18700,3438730,704,161972,6479,105,14102,252,3,252,229410.0,130000.0,-51.0,-48.0,-42.0,-49.0,-52.0,-48.0,-43.0,-49.0,-91.0,-93.0,-90.0,-92.0,40.0,45.0,48.0,43.0,1
3109,CC:2F:71:3F:1F:24,4034869,788820660,269949,313944896,3764920,474875764,27,227348,260495930,227250,260483820,98,12110,217217,6,269950,23957,24,156,130000.0,43333.0,-69.0,-65.0,-72.0,-69.0,-69.0,-65.0,-71.0,-68.0,-91.0,-93.0,-90.0,-92.0,22.0,28.0,18.0,23.0,1
3110,CC:2F:71:3E:C5:1F,3765034,474889527,114,13763,3764920,474875764,0,455,38767,368,28315,87,10452,122,2,152,4,0,5,130000.0,39000.0,-70.0,-70.0,-66.0,-60.0,-70.0,-70.0,-66.0,-60.0,-91.0,-93.0,-90.0,-92.0,21.0,23.0,24.0,32.0,1
3111,BA:8C:B9:54:50:24,3765233,474966842,313,91078,3764920,474875764,0,1343,146803,1325,143957,18,2846,200,5,440,9,0,8,216660.0,130000.0,-48.0,-35.0,-43.0,-45.0,-43.0,-36.0,-44.0,-48.0,-91.0,-93.0,-90.0,-92.0,43.0,58.0,47.0,47.0,1
3112,92:69:1D:31:68:E9,3777754,490140377,12834,15264613,3764920,474875764,3,19404,3600702,18700,3438730,704,161972,6479,105,14102,252,3,252,229410.0,130000.0,-51.0,-48.0,-42.0,-49.0,-52.0,-48.0,-43.0,-49.0,-91.0,-93.0,-90.0,-92.0,40.0,45.0,48.0,43.0,1
3113,CC:2F:71:3F:1F:24,4034978,788939030,270056,314063064,3764922,474875966,27,227445,260613990,227347,260601880,98,12110,217307,6,270057,23961,24,156,130000.0,43333.0,-69.0,-66.0,-72.0,-69.0,-68.0,-65.0,-72.0,-69.0,-90.0,-93.0,-90.0,-92.0,21.0,27.0,18.0,23.0,1
3114,CC:2F:71:3E:C5:1F,3765039,474889991,114,13763,3764925,474876228,0,455,38767,368,28315,87,10452,122,2,152,4,0,5,130000.0,39000.0,-70.0,-70.0,-66.0,-60.0,-70.0,-70.0,-66.0,-60.0,-90.0,-93.0,-90.0,-92.0,20.0,23.0,24.0,32.0,1
3115,BA:8C:B9:54:50:24,3765238,474967306,313,91078,3764925,474876228,0,1343,146803,1325,143957,18,2846,200,5,440,9,0,8,216660.0,130000.0,-48.0,-35.0,-43.0,-45.0,-43.0,-36.0,-44.0,-48.0,-90.0,-93.0,-90.0,-92.0,42.0,58.0,47.0,47.0,1
3116,92:69:1D:31:68:E9,3777759,490140841,12834,15264613,3764925,474876228,3,19404,3600702,18700,3438730,704,161972,6479,105,14102,252,3,252,229410.0,130000.0,-51.0,-48.0,-42.0,-49.0,-52.0,-48.0,-43.0,-49.0,-90.0,-93.0,-90.0,-92.0,39.0,45.0,48.0,43.0,1
3117,CC:2F:71:3F:1F:24,4035090,789057730,270161,314181098,3764929,474876632,27,227540,260729014,227442,260716904,98,12110,217396,6,270162,23969,24,156,117000.0,39000.0,-68.0,-65.0,-71.0,-68.0,-68.0,-65.0,-71.0,-67.0,-90.0,-93.0,-90.0,-92.0,22.0,28.0,19.0,24.0,1
3118,CC:2F:71:3E:C5:1F,3765043,474890395,114,13763,3764929,474876632,0,455,38767,368,28315,87,10452,122,2,152,4,0,5,130000.0,39000.0,-70.0,-70.0,-66.0,-60.0,-70.0,-70.0,-66.0,-60.0,-90.0,-93.0,-90.0,-92.0,20.0,23.0,24.0,32.0,1
3119,BA:8C:B9:54:50:24,3765242,474967710,313,91078,3764929,474876632,0,1343,146803,1325,143957,18,2846,200,5,440,9,0,8,216660.0,130000.0,-48.0,-35.0,-43.0,-45.0,-43.0,-36.0,-44.0,-48.0,-90.0,-93.0,-90.0,-92.0,42.0,58.0,47.0,47.0,1
3120,92:69:1D:31:68:E9,3777763,490141245,12834,15264613,3764929,474876632,3,19404,3600702,18700,3438730,704,161972,6479,105,14102,252,3,252,229410.0,130000.0,-51.0,-48.0,-42.0,-49.0,-52.0,-48.0,-43.0,-49.0,-90.0,-93.0,-90.0,-92.0,39.0,45.0,48.0,43.0,1
3121,CC:2F:71:3F:1F:24,4035207,789183467,270276,314306633,3764931,474876834,27,227642,260846805,227544,260834695,98,12110,217493,6,270277,23970,24,156,130000.0,43333.0,-69.0,-66.0,-70.0,-68.0,-68.0,-66.0,-70.0,-68.0,-90.0,-93.0,-90.0,-92.0,21.0,27.0,20.0,24.0,1
3122,CC:2F:71:3E:C5:1F,3765045,474890597,114,13763,3764931,474876834,0,455,38767,368,28315,87,10452,122,2,152,4,0,5,130000.0,39000.0,-70.0,-70.0,-66.0,-60.0,-70.0,-70.0,-66.0,-60.0,-90.0,-93.0,-90.0,-92.0,20.0,23.0,24.0,32.0,1
3123,BA:8C:B9:54:50:24,3765246,474968114,313,91078,3764933,474877036,0,1343,146803,1325,143957,18,2846,200,5,440,9,0,8,216660.0,130000.0,-48.0,-35.0,-43.0,-45.0,-43.0,-36.0,-44.0,-48.0,-90.0,-93.0,-90.0,-92.0,42.0,58.0,47.0,47.0,1
3124,92:69:1D:31:68:E9,3777767,490141649,12834,15264613,3764933,474877036,3,19404,3600702,18700,3438730,704,161972,6479,105,14102,252,3,252,229410.0,130000.0,-51.0,-48.0,-42.0,-49.0,-52.0,-48.0,-43.0,-49.0,-90.0,-93.0,-90.0,-92.0,39.0,45.0,48.0,43.0,1
3125,CC:2F:71:3F:1F:24,4035319,789300855,270381,314423355,3764938,474877500,27,227734,260955681,227636,260943571,98,12110,217583,6,270382,23970,24,156,130000.0,43333.0,-69.0,-66.0,-71.0,-68.0,-69.0,-66.0,-70.0,-68.0,-90.0,-93.0,-90.0,-92.0,21.0,27.0,19.0,24.0,1
3126,CC:2F:71:3E:C5:1F,3765052,474891263,114,13763,3764938,474877500,0,455,38767,368,28315,87,10452,122,2,152,4,0,5,130000.0,39000.0,-70.0,-70.0,-66.0,-60.0,-70.0,-70.0,-66.0,-60.0,-90.0,-93.0,-90.0,-92.0,20.0,23.0,24.0,32.0,1
3127,BA:8C:B9:54:50:24,3765251,474968578,313,91078,3764938,474877500,0,1343,146803,1325,143957,18,2846,200,5,440,9,0,8,216660.0,130000.0,-48.0,-35.0,-43.0,-45.0,-43.0,-36.0,-44.0,-48.0,-90.0,-93.0,-90.0,-92.0,42.0,58.0,47.0,47.0,1
3128,92:69:1D:31:68:E9,3777772,490142113,12834,15264613,3764938,474877500,3,19404,3600702,18700,3438730,704,161972,6479,105,14102,252,3,252,229410.0,130000.0,-51.0,-48.0,-42.0,-49.0,-52.0,-48.0,-43.0,-49.0,-90.0,-93.0,-90.0,-92.0,39.0,45.0,48.0,43.0,1
3129,CC:2F:71:3F:1F:24,4035428,789419225,270488,314541523,3764940,474877702,27,227825,261066007,227727,261053897,98,12110,217671,6,270489,23976,24,156,130000.0,43333.0,-69.0,-66.0,-71.0,-67.0,-69.0,-66.0,-70.0,-67.0,-90.0,-93.0,-90.0,-92.0,21.0,27.0,19.0,25.0,1
3130,CC:2F:71:3E:C5:1F,3765059,474892294,119,14592,3764940,474877702,0,462,39652,375,29200,87,10452,127,2,157,4,0,5,130000.0,39000.0,-70.0,-71.0,-66.0,-60.0,-70.0,-70.0,-66.0,-60.0,-90.0,-93.0,-90.0,-92.0,20.0,22.0,24.0,32.0,1
3131,BA:8C:B9:54:50:24,3765256,474969098,314,91194,3764942,474877904,0,1349,147211,1331,144365,18,2846,200,5,441,9,0,8,216660.0,130000.0,-40.0,-37.0,-46.0,-51.0,-41.0,-35.0,-43.0,-47.0,-90.0,-93.0,-90.0,-92.0,50.0,56.0,44.0,41.0,1
3132,92:69:1D:31:68:E9,3777777,490142577,12835,15264673,3764942,474877904,3,19406,3600838,18702,3438866,704,161972,6479,105,14103,252,3,252,229410.0,130000.0,-51.0,-48.0,-44.0,-49.0,-51.0,-48.0,-43.0,-49.0,-90.0,-93.0,-90.0,-92.0,39.0,45.0,46.0,43.0,1
3133,CC:2F:71:3F:1F:24,4035541,789539661,270595,314661353,3764946,474878308,27,227917,261179183,227819,261167073,98,12110,217759,6,270596,23976,24,156,130000.0,43333.0,-69.0,-66.0,-71.0,-67.0,-69.0,-66.0,-71.0,-67.0,-90.0,-93.0,-90.0,-92.0,21.0,27.0,19.0,25.0,1
3134,CC:2F:71:3E:C5:1F,3765065,474892900,119,14592,3764946,474878308,0,463,39722,376,29270,87,10452,127,2,157,4,0,5,130000.0,39000.0,-70.0,-70.0,-66.0,-60.0,-70.0,-70.0,-66.0,-60.0,-90.0,-93.0,-90.0,-92.0,20.0,23.0,24.0,32.0,1
3135,BA:8C:B9:54:50:24,3765260,474969502,314,91194,3764946,474878308,0,1349,147211,1331,144365,18,2846,200,5,441,9,0,8,216660.0,130000.0,-40.0,-37.0,-46.0,-51.0,-41.0,-35.0,-43.0,-47.0,-90.0,-93.0,-90.0,-92.0,50.0,56.0,44.0,41.0,1
3136,92:69:1D:31:68:E9,3777781,490142981,12835,15264673,3764946,474878308,3,19406,3600838,18702,3438866,704,161972,6479,105,14103,252,3,252,229410.0,130000.0,-51.0,-48.0,-44.0,-49.0,-51.0,-48.0,-43.0,-49.0,-90.0,-93.0,-90.0,-92.0,39.0,45.0,46.0,43.0,1
3137,CC:2F:71:3F:1F:24,4035657,789660178,270707,314781546,3764950,474878632,27,228017,261292343,227918,261280115,99,12228,217856,6,270708,23976,24,156,130000.0,43333.0,-69.0,-66.0,-71.0,-67.0,-69.0,-66.0,-71.0,-67.0,-90.0,-93.0,-90.0,-92.0,21.0,27.0,19.0,25.0,1
3138,CC:2F:71:3E:C5:1F,3765069,474893224,119,14592,3764950,474878632,0,463,39722,376,29270,87,10452,127,2,157,4,0,5,130000.0,39000.0,-70.0,-70.0,-66.0,-60.0,-70.0,-70.0,-66.0,-60.0,-90.0,-93.0,-90.0,-92.0,20.0,23.0,24.0,32.0,1
3139,BA:8C:B9:54:50:24,3765264,474969826,314,91194,3764950,474878632,0,1350,147279,1332,144433,18,2846,200,5,441,9,0,8,216660.0,130000.0,-40.0,-37.0,-46.0,-51.0,-41.0,-35.0,-43.0,-47.0,-90.0,-93.0,-90.0,-92.0,50.0,56.0,44.0,41.0,1
3140,92:69:1D:31:68:E9,3777787,490143507,12835,15264673,3764952,474878834,3,19406,3600838,18702,3438866,704,161972,6479,105,14103,252,3,252,229410.0,130000.0,-51.0,-48.0,-44.0,-49.0,-51.0,-48.0,-43.0,-49.0,-90.0,-93.0,-90.0,-92.0,39.0,45.0,46.0,43.0,1
3141,CC:2F:71:3F:1F:24,4035773,789783628,270817,314904390,3764956,474879238,27,228117,261415075,228018,261402847,99,12228,217949,6,270818,23980,24,157,130000.0,43333.0,-69.0,-66.0,-71.0,-68.0,-69.0,-66.0,-71.0,-67.0,-90.0,-93.0,-90.0,-92.0,21.0,27.0,19.0,24.0,1
3142,CC:2F:71:3E:C5:1F,3765075,474893830,119,14592,3764956,474879238,0,463,39722,376,29270,87,10452,127,2,157,4,0,5,130000.0,39000.0,-70.0,-70.0,-66.0,-60.0,-70.0,-70.0,-66.0,-60.0,-90.0,-93.0,-90.0,-92.0,20.0,23.0,24.0,32.0,1
3143,BA:8C:B9:54:50:24,3765270,474970432,314,91194,3764956,474879238,0,1350,147279,1332,144433,18,2846,200,5,441,9,0,8,216660.0,130000.0,-40.0,-37.0,-46.0,-51.0,-41.0,-35.0,-43.0,-47.0,-90.0,-93.0,-90.0,-92.0,50.0,56.0,44.0,41.0,1
3144,92:69:1D:31:68:E9,3777791,490143911,12835,15264673,3764956,474879238,3,19406,3600838,18702,3438866,704,161972,6479,105,14103,252,3,252,229410.0,130000.0,-51.0,-48.0,-44.0,-49.0,-51.0,-48.0,-43.0,-49.0,-90.0,-93.0,-90.0,-92.0,39.0,45.0,46.0,43.0,1
3145,CC:2F:71:3F:1F:24,4035881,789902106,270923,315022666,3764958,474879440,27,228213,261528729,228114,261516501,99,12228,218040,6,270924,23980,24,157,130000.0,43333.0,-69.0,-66.0,-72.0,-68.0,-69.0,-66.0,-71.0,-67.0,-90.0,-93.0,-90.0,-92.0,21.0,27.0,18.0,24.0,1
3146,CC:2F:71:3E:C5:1F,3765078,474894092,119,14592,3764959,474879500,0,463,39722,376,29270,87,10452,127,2,157,4,0,5,130000.0,39000.0,-70.0,-70.0,-66.0,-60.0,-70.0,-70.0,-66.0,-60.0,-90.0,-93.0,-90.0,-92.0,20.0,23.0,24.0,32.0,1
3147,BA:8C:B9:54:50:24,3765273,474970694,314,91194,3764959,474879500,0,1350,147279,1332,144433,18,2846,200,5,441,9,0,8,216660.0,130000.0,-40.0,-37.0,-46.0,-51.0,-41.0,-35.0,-43.0,-47.0,-90.0,-93.0,-90.0,-92.0,50.0,56.0,44.0,41.0,1
3148,92:69:1D:31:68:E9,3777795,490144307,12835,15264673,3764960,474879634,3,19406,3600838,18702,3438866,704,161972,6479,105,14103,252,3,252,229410.0,130000.0,-51.0,-48.0,-44.0,-49.0,-51.0,-48.0,-43.0,-49.0,-90.0,-93.0,-90.0,-92.0,39.0,45.0,46.0,43.0,1
3149,CC:2F:71:3F:1F:24,4035999,790027214,271033,315147046,3764966,474880168,27,228309,261648065,228210,261635837,99,12228,218132,6,271034,23991,24,157,117000.0,39000.0,-69.0,-66.0,-72.0,-68.0,-69.0,-66.0,-71.0,-67.0,-90.0,-93.0,-90.0,-92.0,21.0,27.0,18.0,24.0,1
3150,CC:2F:71:3E:C5:1F,3765085,474894760,119,14592,3764966,474880168,0,464,39840,376,29270,88,10570,128,2,157,4,0,5,130000.0,39000.0,-70.0,-70.0,-66.0,-60.0,-70.0,-70.0,-66.0,-60.0,-90.0,-93.0,-90.0,-92.0,20.0,23.0,24.0,32.0,1
3151,BA:8C:B9:54:50:24,3765280,474971362,314,91194,3764966,474880168,0,1350,147279,1332,144433,18,2846,200,5,441,9,0,8,216660.0,130000.0,-40.0,-37.0,-46.0,-51.0,-41.0,-35.0,-43.0,-47.0,-90.0,-93.0,-90.0,-92.0,50.0,56.0,44.0,41.0,1
3152,92:69:1D:31:68:E9,3777801,490144841,12835,15264673,3764966,474880168,3,19406,3600838,18702,3438866,704,161972,6479,105,14103,252,3,252,229410.0,130000.0,-51.0,-48.0,-44.0,-49.0,-51.0,-48.0,-43.0,-49.0,-90.0,-93.0,-90.0,-92.0,39.0,45.0,46.0,43.0,1
3153,CC:2F:71:3F:1F:24,4036114,790149194,271145,315268551,3764969,474880643,27,228407,261762429,228308,261750201,99,12228,218226,6,271146,23991,24,157,130000.0,43333.0,-69.0,-66.0,-71.0,-68.0,-69.0,-66.0,-71.0,-67.0,-90.0,-93.0,-90.0,-92.0,21.0,27.0,19.0,24.0,1
3154,CC:2F:71:3E:C5:1F,3765088,474895235,119,14592,3764969,474880643,0,465,39910,377,29340,88,10570,128,2,157,4,0,5,130000.0,39000.0,-70.0,-70.0,-66.0,-60.0,-70.0,-70.0,-66.0,-60.0,-90.0,-93.0,-90.0,-92.0,20.0,23.0,24.0,32.0,1
3155,BA:8C:B9:54:50:24,3765283,474971837,314,91194,3764969,474880643,0,1350,147279,1332,144433,18,2846,200,5,441,9,0,8,216660.0,130000.0,-40.0,-37.0,-46.0,-51.0,-41.0,-35.0,-43.0,-47.0,-90.0,-93.0,-90.0,-92.0,50.0,56.0,44.0,41.0,1
3156,92:69:1D:31:68:E9,3777806,490145518,12835,15264673,3764971,474880845,3,19406,3600838,18702,3438866,704,161972,6479,105,14103,252,3,252,229410.0,130000.0,-51.0,-48.0,-44.0,-49.0,-51.0,-48.0,-43.0,-49.0,-90.0,-93.0,-90.0,-92.0,39.0,45.0,46.0,43.0,1
3157,CC:2F:71:3F:1F:24,4036224,790267804,271250,315386697,3764974,474881107,27,228498,261872627,228399,261860399,99,12228,218314,6,271251,23991,24,157,130000.0,43333.0,-69.0,-66.0,-71.0,-68.0,-69.0,-66.0,-71.0,-67.0,-90.0,-92.0,-89.0,-91.0,21.0,26.0,18.0,23.0,1
3158,CC:2F:71:3E:C5:1F,3765096,474896017,120,14708,3764976,474881309,0,467,40086,379,29516,88,10570,129,2,158,4,0,5,130000.0,39000.0,-70.0,-70.0,-66.0,-60.0,-70.0,-70.0,-66.0,-60.0,-90.0,-92.0,-89.0,-91.0,20.0,22.0,23.0,31.0,1
3159,BA:8C:B9:54:50:24,3765290,474972503,314,91194,3764976,474881309,0,1350,147279,1332,144433,18,2846,200,5,441,9,0,8,216660.0,130000.0,-40.0,-37.0,-46.0,-51.0,-41.0,-35.0,-43.0,-47.0,-90.0,-92.0,-89.0,-91.0,50.0,55.0,43.0,40.0,1
3160,92:69:1D:31:68:E9,3777811,490145982,12835,15264673,3764976,474881309,3,19406,3600838,18702,3438866,704,161972,6479,105,14103,252,3,252,229410.0,130000.0,-51.0,-48.0,-44.0,-49.0,-51.0,-48.0,-43.0,-49.0,-90.0,-92.0,-89.0,-91.0,39.0,44.0,45.0,42.0,1
3161,CC:2F:71:3F:1F:24,4036335,790387870,271357,315506359,3764978,474881511,27,228589,261982797,228490,261970569,99,12228,218404,6,271358,23997,24,157,130000.0,43333.0,-69.0,-66.0,-71.0,-68.0,-69.0,-66.0,-71.0,-68.0,-90.0,-92.0,-89.0,-91.0,21.0,26.0,18.0,23.0,1
3162,CC:2F:71:3E:C5:1F,3765099,474896335,121,14824,3764978,474881511,0,470,40332,382,29762,88,10570,130,2,159,4,0,5,130000.0,39000.0,-70.0,-70.0,-66.0,-60.0,-70.0,-70.0,-66.0,-60.0,-90.0,-92.0,-89.0,-91.0,20.0,22.0,23.0,31.0,1
3163,BA:8C:B9:54:50:24,3765292,474972705,314,91194,3764978,474881511,0,1350,147279,1332,144433,18,2846,200,5,441,9,0,8,216660.0,130000.0,-40.0,-37.0,-46.0,-51.0,-41.0,-35.0,-43.0,-47.0,-90.0,-92.0,-89.0,-91.0,50.0,55.0,43.0,40.0,1
3164,92:69:1D:31:68:E9,3777813,490146184,12835,15264673,3764978,474881511,3,19406,3600838,18702,3438866,704,161972,6479,105,14103,252,3,252,229410.0,130000.0,-51.0,-48.0,-44.0,-49.0,-51.0,-48.0,-43.0,-49.0,-90.0,-92.0,-89.0,-91.0,39.0,44.0,45.0,42.0,1
3165,CC:2F:71:3F:1F:24,4036444,790506364,271462,315624449,3764982,474881915,27,228689,262099915,228590,262087687,99,12228,218495,6,271463,23997,24,157,130000.0,43333.0,-69.0,-66.0,-71.0,-68.0,-69.0,-66.0,-71.0,-68.0,-90.0,-92.0,-89.0,-91.0,21.0,26.0,18.0,23.0,1
3166,CC:2F:71:3E:C5:1F,3765103,474896739,121,14824,3764982,474881915,0,470,40332,382,29762,88,10570,130,2,159,4,0,5,130000.0,39000.0,-70.0,-70.0,-66.0,-60.0,-70.0,-70.0,-66.0,-60.0,-90.0,-92.0,-89.0,-91.0,20.0,22.0,23.0,31.0,1
3167,BA:8C:B9:54:50:24,3765296,474973109,314,91194,3764982,474881915,0,1350,147279,1332,144433,18,2846,200,5,441,9,0,8,216660.0,130000.0,-40.0,-37.0,-46.0,-51.0,-41.0,-35.0,-43.0,-47.0,-90.0,-92.0,-89.0,-91.0,50.0,55.0,43.0,40.0,1
3168,92:69:1D:31:68:E9,3777819,490146790,12835,15264673,3764984,474882117,3,19406,3600838,18702,3438866,704,161972,6479,105,14103,252,3,252,229410.0,130000.0,-51.0,-48.0,-44.0,-49.0,-51.0,-48.0,-43.0,-49.0,-90.0,-92.0,-89.0,-91.0,39.0,44.0,45.0,42.0,1
3169,CC:2F:71:3F:1F:24,4036561,790628445,271574,315746066,3764987,474882379,27,228787,262212902,228688,262200674,99,12228,218589,6,271575,23997,24,157,130000.0,43333.0,-69.0,-66.0,-71.0,-68.0,-69.0,-66.0,-71.0,-67.0,-90.0,-92.0,-89.0,-91.0,21.0,26.0,18.0,23.0,1
3170,CC:2F:71:3E:C5:1F,3765108,474897203,121,14824,3764987,474882379,0,470,40332,382,29762,88,10570,130,2,159,4,0,5,130000.0,39000.0,-70.0,-70.0,-66.0,-60.0,-70.0,-70.0,-66.0,-60.0,-90.0,-92.0,-89.0,-91.0,20.0,22.0,23.0,31.0,1
3171,BA:8C:B9:54:50:24,3765301,474973573,314,91194,3764987,474882379,0,1350,147279,1332,144433,18,2846,200,5,441,9,0,8,216660.0,130000.0,-40.0,-37.0,-46.0,-51.0,-41.0,-35.0,-43.0,-47.0,-90.0,-92.0,-89.0,-91.0,50.0,55.0,43.0,40.0,1
3172,92:69:1D:31:68:E9,3777822,490147052,12835,15264673,3764987,474882379,3,19406,3600838,18702,3438866,704,161972,6479,105,14103,252,3,252,229410.0,130000.0,-51.0,-48.0,-44.0,-49.0,-51.0,-48.0,-43.0,-49.0,-90.0,-92.0,-89.0,-91.0,39.0,44.0,45.0,42.0,1
3173,CC:2F:71:3F:1F:24,4036671,790746901,271680,315864118,3764991,474882783,27,228882,262325126,228783,262312898,99,12228,218678,6,271681,24001,24,157,130000.0,43333.0,-69.0,-66.0,-71.0,-68.0,-69.0,-66.0,-71.0,-67.0,-90.0,-92.0,-89.0,-91.0,21.0,26.0,18.0,23.0,1
3174,CC:2F:71:3E:C5:1F,3765112,474897607,121,14824,3764991,474882783,0,470,40332,382,29762,88,10570,130,2,159,4,0,5,130000.0,39000.0,-70.0,-70.0,-66.0,-60.0,-70.0,-70.0,-66.0,-60.0,-90.0,-92.0,-89.0,-91.0,20.0,22.0,23.0,31.0,1
3175,BA:8C:B9:54:50:24,3765305,474973977,314,91194,3764991,474882783,0,1350,147279,1332,144433,18,2846,200,5,441,9,0,8,216660.0,130000.0,-40.0,-37.0,-46.0,-51.0,-41.0,-35.0,-43.0,-47.0,-90.0,-92.0,-89.0,-91.0,50.0,55.0,43.0,40.0,1
3176,92:69:1D:31:68:E9,3777828,490147658,12835,15264673,3764993,474882985,3,19406,3600838,18702,3438866,704,161972,6479,105,14103,252,3,252,229410.0,130000.0,-51.0,-48.0,-44.0,-49.0,-51.0,-48.0,-43.0,-49.0,-90.0,-92.0,-89.0,-91.0,39.0,44.0,45.0,42.0,1
3177,CC:2F:71:3F:1F:24,4036781,790865581,271786,315982394,3764995,474883187,27,228977,262440340,228878,262428112,99,12228,218766,6,271787,24001,24,157,130000.0,43333.0,-69.0,-66.0,-72.0,-68.0,-69.0,-66.0,-71.0,-67.0,-90.0,-92.0,-89.0,-91.0,21.0,26.0,17.0,23.0,1
3178,CC:2F:71:3E:C5:1F,3765117,474898071,121,14824,3764996,474883247,0,470,40332,382,29762,88,10570,130,2,159,4,0,5,130000.0,39000.0,-70.0,-70.0,-66.0,-60.0,-70.0,-70.0,-66.0,-60.0,-90.0,-92.0,-89.0,-91.0,20.0,22.0,23.0,31.0,1
3179,BA:8C:B9:54:50:24,3765310,474974441,314,91194,3764996,474883247,0,1350,147279,1332,144433,18,2846,200,5,441,9,0,8,216660.0,130000.0,-40.0,-37.0,-46.0,-51.0,-41.0,-35.0,-43.0,-47.0,-90.0,-92.0,-89.0,-91.0,50.0,55.0,43.0,40.0,1
3180,92:69:1D:31:68:E9,3777831,490147920,12835,15264673,3764996,474883247,3,19406,3600838,18702,3438866,704,161972,6479,105,14103,252,3,252,229410.0,130000.0,-51.0,-48.0,-44.0,-49.0,-51.0,-48.0,-43.0,-49.0,-90.0,-92.0,-89.0,-91.0,39.0,44.0,45.0,42.0,1
3181,CC:2F:71:3F:1F:24,4036891,790984191,271891,316100540,3765000,474883651,27,229070,262549484,228971,262537256,99,12228,218853,6,271892,24001,24,157,130000.0,43333.0,-69.0,-66.0,-71.0,-68.0,-69.0,-66.0,-71.0,-68.0,-90.0,-92.0,-89.0,-91.0,21.0,26.0,18.0,23.0,1
3182,CC:2F:71:3E:C5:1F,3765121,474898475,121,14824,3765000,474883651,0,470,40332,382,29762,88,10570,130,2,159,4,0,5,130000.0,39000.0,-70.0,-70.0,-66.0,-60.0,-70.0,-70.0,-66.0,-60.0,-90.0,-92.0,-89.0,-91.0,20.0,22.0,23.0,31.0,1
3183,BA:8C:B9:54:50:24,3765314,474974845,314,91194,3765000,474883651,0,1350,147279,1332,144433,18,2846,200,5,441,9,0,8,216660.0,130000.0,-40.0,-37.0,-46.0,-51.0,-41.0,-35.0,-43.0,-47.0,-90.0,-92.0,-89.0,-91.0,50.0,55.0,43.0,40.0,1
3184,92:69:1D:31:68:E9,3777835,490148324,12835,15264673,3765000,474883651,3,19408,3600974,18704,3439002,704,161972,6479,105,14104,252,3,252,229410.0,130000.0,-52.0,-48.0,-43.0,-48.0,-51.0,-48.0,-43.0,-49.0,-90.0,-92.0,-89.0,-91.0,38.0,44.0,46.0,43.0,1
3185,CC:2F:71:3F:1F:24,4037010,791107802,272006,316223747,3765004,474884055,27,229172,262665816,229073,262653588,99,12228,218951,6,272007,24012,24,157,130000.0,43333.0,-69.0,-66.0,-72.0,-68.0,-69.0,-66.0,-71.0,-67.0,-90.0,-92.0,-89.0,-91.0,21.0,26.0,17.0,23.0,1
3186,CC:2F:71:3E:C5:1F,3765125,474898879,121,14824,3765004,474884055,0,472,40472,384,29902,88,10570,130,2,160,4,0,5,130000.0,39000.0,-70.0,-71.0,-66.0,-60.0,-70.0,-70.0,-66.0,-60.0,-90.0,-92.0,-89.0,-91.0,20.0,21.0,23.0,31.0,1
3187,BA:8C:B9:54:50:24,3765318,474975249,314,91194,3765004,474884055,0,1352,147415,1334,144569,18,2846,200,5,442,9,0,8,216660.0,130000.0,-40.0,-37.0,-45.0,-51.0,-40.0,-35.0,-43.0,-48.0,-90.0,-92.0,-89.0,-91.0,50.0,55.0,44.0,40.0,1
3188,92:69:1D:31:68:E9,3777839,490148728,12835,15264673,3765004,474884055,3,19408,3600974,18704,3439002,704,161972,6479,105,14104,252,3,252,229410.0,130000.0,-52.0,-48.0,-43.0,-48.0,-51.0,-48.0,-43.0,-49.0,-90.0,-92.0,-89.0,-91.0,38.0,44.0,46.0,43.0,1
3189,CC:2F:71:3F:1F:24,4037122,791226672,272113,316342153,3765009,474884519,27,229268,262776750,229169,262764522,99,12228,219042,6,272114,24013,24,157,130000.0,43333.0,-69.0,-66.0,-72.0,-68.0,-69.0,-66.0,-71.0,-67.0,-90.0,-92.0,-89.0,-91.0,21.0,26.0,17.0,23.0,1
3190,CC:2F:71:3E:C5:1F,3765130,474899343,121,14824,3765009,474884519,0,472,40472,384,29902,88,10570,130,2,160,4,0,5,130000.0,39000.0,-70.0,-71.0,-66.0,-60.0,-70.0,-70.0,-66.0,-60.0,-90.0,-92.0,-89.0,-91.0,20.0,21.0,23.0,31.0,1
3191,BA:8C:B9:54:50:24,3765323,474975713,314,91194,3765009,474884519,0,1352,147415,1334,144569,18,2846,200,5,442,9,0,8,216660.0,130000.0,-40.0,-37.0,-45.0,-51.0,-40.0,-35.0,-43.0,-48.0,-90.0,-92.0,-89.0,-91.0,50.0,55.0,44.0,40.0,1
3192,92:69:1D:31:68:E9,3777844,490149192,12835,15264673,3765009,474884519,3,19408,3600974,18704,3439002,704,161972,6479,105,14104,252,3,252,229410.0,130000.0,-52.0,-48.0,-43.0,-48.0,-51.0,-48.0,-43.0,-49.0,-90.0,-92.0,-89.0,-91.0,38.0,44.0,46.0,43.0,1
3193,CC:2F:71:3F:1F:24,4037234,791348292,272221,316463369,3765013,474884923,27,229363,262890448,229264,262878220,99,12228,219132,6,272222,24017,24,157,130000.0,39000.0,-69.0,-66.0,-72.0,-68.0,-69.0,-66.0,-71.0,-67.0,-90.0,-92.0,-89.0,-91.0,21.0,26.0,17.0,23.0,1
3194,CC:2F:71:3E:C5:1F,3765134,474899747,121,14824,3765013,474884923,0,472,40472,384,29902,88,10570,130,2,160,4,0,5,130000.0,39000.0,-70.0,-71.0,-66.0,-60.0,-70.0,-70.0,-66.0,-60.0,-90.0,-92.0,-89.0,-91.0,20.0,21.0,23.0,31.0,1
3195,BA:8C:B9:54:50:24,3765327,474976117,314,91194,3765013,474884923,0,1352,147415,1334,144569,18,2846,200,5,442,9,0,8,216660.0,130000.0,-40.0,-37.0,-45.0,-51.0,-40.0,-35.0,-43.0,-48.0,-90.0,-92.0,-89.0,-91.0,50.0,55.0,44.0,40.0,1
3196,92:69:1D:31:68:E9,3777848,490149596,12835,15264673,3765013,474884923,3,19408,3600974,18704,3439002,704,161972,6479,105,14104,252,3,252,229410.0,130000.0,-52.0,-48.0,-43.0,-48.0,-51.0,-48.0,-43.0,-49.0,-90.0,-92.0,-89.0,-91.0,38.0,44.0,46.0,43.0,1
3197,CC:2F:71:3F:1F:24,4037347,791470042,272330,316584715,3765017,474885327,27,229456,263004094,229357,262991866,99,12228,219221,6,272331,24023,24,157,117000.0,39000.0,-69.0,-66.0,-71.0,-68.0,-69.0,-66.0,-71.0,-67.0,-90.0,-92.0,-89.0,-91.0,21.0,26.0,18.0,23.0,1
3198,CC:2F:71:3E:C5:1F,3765138,474900151,121,14824,3765017,474885327,0,472,40472,384,29902,88,10570,130,2,160,4,0,5,130000.0,39000.0,-70.0,-71.0,-66.0,-60.0,-70.0,-70.0,-66.0,-60.0,-90.0,-92.0,-89.0,-91.0,20.0,21.0,23.0,31.0,1
3199,BA:8C:B9:54:50:24,3765331,474976521,314,91194,3765017,474885327,0,1352,147415,1334,144569,18,2846,200,5,442,9,0,8,216660.0,130000.0,-40.0,-37.0,-45.0,-51.0,-40.0,-35.0,-43.0,-48.0,-90.0,-92.0,-89.0,-91.0,50.0,55.0,44.0,40.0,1
3200,92:69:1D:31:68:E9,3777852,490150000,12835,15264673,3765017,474885327,3,19408,3600974,18704,3439002,704,161972,6479,105,14104,252,3,252,229410.0,130000.0,-52.0,-48.0,-43.0,-48.0,-51.0,-48.0,-43.0,-49.0,-90.0,-92.0,-89.0,-91.0,38.0,44.0,46.0,43.0,1
3201,CC:2F:71:3F:1F:24,4037466,791593681,272444,316707890,3765022,474885791,27,229556,263117227,229457,263104999,99,12228,219319,6,272445,24027,24,157,130000.0,43333.0,-68.0,-66.0,-69.0,-69.0,-68.0,-66.0,-69.0,-68.0,-90.0,-92.0,-89.0,-91.0,22.0,26.0,20.0,22.0,1
3202,CC:2F:71:3E:C5:1F,3765143,474900615,121,14824,3765022,474885791,0,472,40472,384,29902,88,10570,130,2,160,4,0,5,130000.0,39000.0,-70.0,-71.0,-66.0,-60.0,-70.0,-70.0,-66.0,-60.0,-90.0,-92.0,-89.0,-91.0,20.0,21.0,23.0,31.0,1
3203,BA:8C:B9:54:50:24,3765336,474976985,314,91194,3765022,474885791,0,1352,147415,1334,144569,18,2846,200,5,442,9,0,8,216660.0,130000.0,-40.0,-37.0,-45.0,-51.0,-40.0,-35.0,-43.0,-48.0,-90.0,-92.0,-89.0,-91.0,50.0,55.0,44.0,40.0,1
3204,92:69:1D:31:68:E9,3777857,490150464,12835,15264673,3765022,474885791,3,19408,3600974,18704,3439002,704,161972,6479,105,14104,252,3,252,229410.0,130000.0,-52.0,-48.0,-43.0,-48.0,-51.0,-48.0,-43.0,-49.0,-90.0,-92.0,-89.0,-91.0,38.0,44.0,46.0,43.0,1
3205,CC:2F:71:3F:1F:24,4037576,791713561,272550,316827366,3765026,474886195,27,229652,263234059,229553,263221831,99,12228,219407,6,272551,24044,24,157,130000.0,43333.0,-69.0,-66.0,-70.0,-68.0,-68.0,-66.0,-70.0,-68.0,-90.0,-92.0,-89.0,-91.0,21.0,26.0,19.0,23.0,1
3206,CC:2F:71:3E:C5:1F,3765147,474901019,121,14824,3765026,474886195,0,472,40472,384,29902,88,10570,130,2,160,4,0,5,130000.0,39000.0,-70.0,-71.0,-66.0,-60.0,-70.0,-70.0,-66.0,-60.0,-90.0,-92.0,-89.0,-91.0,20.0,21.0,23.0,31.0,1
3207,BA:8C:B9:54:50:24,3765341,474977662,314,91194,3765027,474886468,0,1352,147415,1334,144569,18,2846,200,5,442,9,0,8,216660.0,130000.0,-40.0,-37.0,-45.0,-51.0,-40.0,-35.0,-43.0,-48.0,-90.0,-92.0,-89.0,-91.0,50.0,55.0,44.0,40.0,1
3208,92:69:1D:31:68:E9,3777862,490151141,12835,15264673,3765027,474886468,3,19408,3600974,18704,3439002,704,161972,6479,105,14104,252,3,252,229410.0,130000.0,-52.0,-48.0,-43.0,-48.0,-51.0,-48.0,-43.0,-49.0,-90.0,-92.0,-89.0,-91.0,38.0,44.0,46.0,43.0,1
3209,CC:2F:71:3F:1F:24,4037687,791832290,272656,316945418,3765031,474886872,27,229745,263347351,229646,263335123,99,12228,219496,6,272657,24064,24,157,130000.0,43333.0,-68.0,-65.0,-71.0,-68.0,-68.0,-65.0,-70.0,-68.0,-90.0,-92.0,-89.0,-91.0,22.0,27.0,18.0,23.0,1
3210,CC:2F:71:3E:C5:1F,3765153,474901756,121,14824,3765032,474886932,0,472,40472,384,29902,88,10570,130,2,160,4,0,5,130000.0,39000.0,-70.0,-71.0,-66.0,-60.0,-70.0,-70.0,-66.0,-60.0,-90.0,-92.0,-89.0,-91.0,20.0,21.0,23.0,31.0,1
3211,BA:8C:B9:54:50:24,3765346,474978126,314,91194,3765032,474886932,0,1352,147415,1334,144569,18,2846,200,5,442,9,0,8,216660.0,130000.0,-40.0,-37.0,-45.0,-51.0,-40.0,-35.0,-43.0,-48.0,-90.0,-92.0,-89.0,-91.0,50.0,55.0,44.0,40.0,1
3212,92:69:1D:31:68:E9,3777867,490151605,12835,15264673,3765032,474886932,3,19408,3600974,18704,3439002,704,161972,6479,105,14104,252,3,252,229410.0,130000.0,-52.0,-48.0,-43.0,-48.0,-51.0,-48.0,-43.0,-49.0,-90.0,-92.0,-89.0,-91.0,38.0,44.0,46.0,43.0,1
3213,CC:2F:71:3F:1F:24,4037799,791952584,272763,317065248,3765036,474887336,27,229838,263459191,229739,263446963,99,12228,219587,6,272764,24071,24,157,130000.0,43333.0,-70.0,-66.0,-72.0,-68.0,-69.0,-66.0,-72.0,-67.0,-90.0,-92.0,-89.0,-91.0,20.0,26.0,17.0,23.0,1
3214,CC:2F:71:3E:C5:1F,3765157,474902160,121,14824,3765036,474887336,0,472,40472,384,29902,88,10570,130,2,160,4,0,5,130000.0,39000.0,-70.0,-71.0,-66.0,-60.0,-70.0,-70.0,-66.0,-60.0,-90.0,-92.0,-89.0,-91.0,20.0,21.0,23.0,31.0,1
3215,BA:8C:B9:54:50:24,3765350,474978530,314,91194,3765036,474887336,0,1352,147415,1334,144569,18,2846,200,5,442,9,0,8,216660.0,130000.0,-40.0,-37.0,-45.0,-51.0,-40.0,-35.0,-43.0,-48.0,-90.0,-92.0,-89.0,-91.0,50.0,55.0,44.0,40.0,1
3216,92:69:1D:31:68:E9,3777871,490152009,12835,15264673,3765036,474887336,3,19408,3600974,18704,3439002,704,161972,6479,105,14104,252,3,252,229410.0,130000.0,-52.0,-48.0,-43.0,-48.0,-51.0,-48.0,-43.0,-49.0,-90.0,-92.0,-89.0,-91.0,38.0,44.0,46.0,43.0,1
3217,CC:2F:71:3F:1F:24,4037917,792076065,272877,317188325,3765040,474887740,27,229935,263570562,229836,263558334,99,12228,219682,6,272877,24076,24,157,130000.0,43333.0,-69.0,-66.0,-72.0,-69.0,-69.0,-65.0,-71.0,-69.0,-90.0,-92.0,-89.0,-91.0,21.0,26.0,17.0,22.0,1
3218,CC:2F:71:3E:C5:1F,3765161,474902564,121,14824,3765040,474887740,0,472,40472,384,29902,88,10570,130,2,160,4,0,5,130000.0,39000.0,-70.0,-71.0,-66.0,-60.0,-70.0,-70.0,-66.0,-60.0,-90.0,-92.0,-89.0,-91.0,20.0,21.0,23.0,31.0,1
3219,BA:8C:B9:54:50:24,3765354,474978934,314,91194,3765040,474887740,0,1352,147415,1334,144569,18,2846,200,5,442,9,0,8,216660.0,130000.0,-40.0,-37.0,-45.0,-51.0,-40.0,-35.0,-43.0,-48.0,-90.0,-92.0,-89.0,-91.0,50.0,55.0,44.0,40.0,1
3220,92:69:1D:31:68:E9,3777875,490152413,12835,15264673,3765040,474887740,3,19408,3600974,18704,3439002,704,161972,6479,105,14104,252,3,252,229410.0,130000.0,-52.0,-48.0,-43.0,-48.0,-51.0,-48.0,-43.0,-49.0,-90.0,-92.0,-89.0,-91.0,38.0,44.0,46.0,43.0,1
3221,CC:2F:71:3F:1F:24,4038028,792194189,272983,317305985,3765045,474888204,27,230027,263682348,229928,263670120,99,12228,219771,6,272984,24106,24,157,130000.0,43333.0,-70.0,-66.0,-72.0,-67.0,-70.0,-66.0,-71.0,-69.0,-90.0,-92.0,-89.0,-91.0,20.0,26.0,17.0,24.0,1
3222,CC:2F:71:3E:C5:1F,3765166,474903028,121,14824,3765045,474888204,0,472,40472,384,29902,88,10570,130,2,160,4,0,5,130000.0,39000.0,-70.0,-71.0,-66.0,-60.0,-70.0,-70.0,-66.0,-60.0,-90.0,-92.0,-89.0,-91.0,20.0,21.0,23.0,31.0,1
3223,BA:8C:B9:54:50:24,3765359,474979398,314,91194,3765045,474888204,0,1352,147415,1334,144569,18,2846,200,5,442,9,0,8,216660.0,130000.0,-40.0,-37.0,-45.0,-51.0,-40.0,-35.0,-43.0,-48.0,-90.0,-92.0,-89.0,-91.0,50.0,55.0,44.0,40.0,1
3224,92:69:1D:31:68:E9,3777880,490152877,12835,15264673,3765045,474888204,3,19408,3600974,18704,3439002,704,161972,6479,105,14104,252,3,252,229410.0,130000.0,-52.0,-48.0,-43.0,-48.0,-51.0,-48.0,-43.0,-49.0,-90.0,-92.0,-89.0,-91.0,38.0,44.0,46.0,43.0,1
3225,CC:2F:71:3F:1F:24,4038138,792314181,273089,317425573,3765049,474888608,27,230122,263797406,230023,263785178,99,12228,219861,6,273090,24106,24,157,130000.0,39000.0,-68.0,-67.0,-71.0,-69.0,-67.0,-66.0,-70.0,-68.0,-90.0,-92.0,-89.0,-91.0,22.0,25.0,18.0,22.0,1
3226,CC:2F:71:3E:C5:1F,3765170,474903432,121,14824,3765049,474888608,0,472,40472,384,29902,88,10570,130,2,160,4,0,5,130000.0,39000.0,-70.0,-71.0,-66.0,-60.0,-70.0,-70.0,-66.0,-60.0,-90.0,-92.0,-89.0,-91.0,20.0,21.0,23.0,31.0,1
3227,BA:8C:B9:54:50:24,3765363,474979802,314,91194,3765049,474888608,0,1352,147415,1334,144569,18,2846,200,5,442,9,0,8,216660.0,130000.0,-40.0,-37.0,-45.0,-51.0,-40.0,-35.0,-43.0,-48.0,-90.0,-92.0,-89.0,-91.0,50.0,55.0,44.0,40.0,1
3228,92:69:1D:31:68:E9,3777884,490153281,12835,15264673,3765049,474888608,3,19409,3601042,18705,3439070,704,161972,6479,105,14104,252,3,252,229410.0,130000.0,-52.0,-47.0,-42.0,-49.0,-51.0,-48.0,-43.0,-49.0,-90.0,-92.0,-89.0,-91.0,38.0,45.0,47.0,42.0,1
3229,CC:2F:71:3F:1F:24,4038249,792434191,273196,317545179,3765053,474889012,27,230216,263913818,230117,263901590,99,12228,219949,6,273197,24106,24,157,144444.0,43333.0,-69.0,-66.0,-67.0,-69.0,-69.0,-66.0,-67.0,-69.0,-90.0,-92.0,-89.0,-91.0,21.0,26.0,22.0,22.0,1
3230,CC:2F:71:3E:C5:1F,3765174,474903836,121,14824,3765053,474889012,0,472,40472,384,29902,88,10570,130,2,160,4,0,5,130000.0,39000.0,-70.0,-71.0,-66.0,-60.0,-70.0,-70.0,-66.0,-60.0,-90.0,-92.0,-89.0,-91.0,20.0,21.0,23.0,31.0,1
3231,BA:8C:B9:54:50:24,3765367,474980206,314,91194,3765053,474889012,0,1352,147415,1334,144569,18,2846,200,5,442,9,0,8,216660.0,130000.0,-40.0,-37.0,-45.0,-51.0,-40.0,-35.0,-43.0,-48.0,-90.0,-92.0,-89.0,-91.0,50.0,55.0,44.0,40.0,1
3232,92:69:1D:31:68:E9,3777888,490153685,12835,15264673,3765053,474889012,3,19409,3601042,18705,3439070,704,161972,6479,105,14104,252,3,252,229410.0,130000.0,-52.0,-47.0,-42.0,-49.0,-51.0,-48.0,-43.0,-49.0,-90.0,-92.0,-89.0,-91.0,38.0,45.0,47.0,42.0,1
3233,CC:2F:71:3F:1F:24,4038372,792558514,273312,317668670,3765060,474889844,27,230316,264027055,230217,264014827,99,12228,220046,6,273313,24114,24,157,130000.0,43333.0,-72.0,-67.0,-68.0,-72.0,-72.0,-67.0,-68.0,-72.0,-90.0,-92.0,-89.0,-91.0,18.0,25.0,21.0,19.0,1
3234,CC:2F:71:3E:C5:1F,3765181,474904668,121,14824,3765060,474889844,0,472,40472,384,29902,88,10570,130,2,160,4,0,5,130000.0,39000.0,-70.0,-71.0,-66.0,-60.0,-70.0,-70.0,-66.0,-60.0,-90.0,-92.0,-89.0,-91.0,20.0,21.0,23.0,31.0,1
3235,BA:8C:B9:54:50:24,3765375,474981154,315,91310,3765060,474889844,0,1353,147483,1335,144637,18,2846,200,5,443,9,0,8,216660.0,130000.0,-48.0,-35.0,-43.0,-45.0,-41.0,-35.0,-44.0,-48.0,-90.0,-92.0,-89.0,-91.0,42.0,57.0,46.0,46.0,1
3236,92:69:1D:31:68:E9,3777896,490154633,12836,15264789,3765060,474889844,3,19411,3601178,18707,3439206,704,161972,6479,105,14105,252,3,252,229410.0,130000.0,-52.0,-47.0,-42.0,-49.0,-51.0,-47.0,-43.0,-48.0,-90.0,-92.0,-89.0,-91.0,38.0,45.0,47.0,42.0,1
3237,CC:2F:71:3F:1F:24,4038484,792677162,273419,317786852,3765065,474890310,27,230409,264140347,230310,264128119,99,12228,220135,6,273420,24120,24,157,130000.0,43333.0,-72.0,-67.0,-69.0,-72.0,-72.0,-66.0,-68.0,-72.0,-90.0,-92.0,-89.0,-91.0,18.0,25.0,20.0,19.0,1
3238,CC:2F:71:3E:C5:1F,3765187,474905250,122,14940,3765065,474890310,0,476,40800,387,30112,89,10688,131,2,161,4,0,5,130000.0,39000.0,-73.0,-70.0,-67.0,-60.0,-71.0,-70.0,-66.0,-60.0,-90.0,-92.0,-89.0,-91.0,17.0,22.0,22.0,31.0,1
3239,BA:8C:B9:54:50:24,3765380,474981620,315,91310,3765065,474890310,0,1358,147823,1340,144977,18,2846,200,5,443,9,0,8,216660.0,130000.0,-40.0,-37.0,-45.0,-51.0,-41.0,-35.0,-43.0,-47.0,-90.0,-92.0,-89.0,-91.0,50.0,55.0,44.0,40.0,1
3240,92:69:1D:31:68:E9,3777901,490155099,12836,15264789,3765065,474890310,3,19411,3601178,18707,3439206,704,161972,6479,105,14105,252,3,252,229410.0,130000.0,-52.0,-47.0,-42.0,-49.0,-51.0,-47.0,-43.0,-48.0,-90.0,-92.0,-89.0,-91.0,38.0,45.0,47.0,42.0,1
3241,CC:2F:71:3F:1F:24,4038594,792797266,273525,317906552,3765069,474890714,27,230498,264248861,230399,264236633,99,12228,220223,6,273526,24121,24,157,130000.0,43333.0,-72.0,-66.0,-68.0,-72.0,-72.0,-66.0,-68.0,-72.0,-90.0,-92.0,-89.0,-91.0,18.0,26.0,21.0,19.0,1
3242,CC:2F:71:3E:C5:1F,3765191,474905654,122,14940,3765069,474890714,0,476,40800,387,30112,89,10688,131,2,161,4,0,5,130000.0,39000.0,-73.0,-70.0,-67.0,-60.0,-71.0,-70.0,-66.0,-60.0,-90.0,-92.0,-89.0,-91.0,17.0,22.0,22.0,31.0,1
3243,BA:8C:B9:54:50:24,3765385,474982084,315,91310,3765070,474890774,0,1358,147823,1340,144977,18,2846,200,5,443,9,0,8,216660.0,130000.0,-40.0,-37.0,-45.0,-51.0,-41.0,-35.0,-43.0,-47.0,-90.0,-92.0,-89.0,-91.0,50.0,55.0,44.0,40.0,1
3244,92:69:1D:31:68:E9,3777906,490155563,12836,15264789,3765070,474890774,3,19411,3601178,18707,3439206,704,161972,6479,105,14105,252,3,252,229410.0,130000.0,-52.0,-47.0,-42.0,-49.0,-51.0,-47.0,-43.0,-48.0,-90.0,-92.0,-89.0,-91.0,38.0,45.0,47.0,42.0,1
3245,CC:2F:71:3F:1F:24,4038704,792915876,273630,318024698,3765074,474891178,27,230588,264357477,230489,264345249,99,12228,220313,6,273631,24121,24,157,130000.0,43333.0,-72.0,-66.0,-69.0,-73.0,-72.0,-66.0,-68.0,-73.0,-90.0,-92.0,-89.0,-91.0,18.0,26.0,20.0,18.0,1
3246,CC:2F:71:3E:C5:1F,3765196,474906118,122,14940,3765074,474891178,0,476,40800,387,30112,89,10688,131,2,161,4,0,5,130000.0,39000.0,-73.0,-70.0,-67.0,-60.0,-71.0,-70.0,-66.0,-60.0,-90.0,-92.0,-89.0,-91.0,17.0,22.0,22.0,31.0,1
3247,BA:8C:B9:54:50:24,3765389,474982488,315,91310,3765074,474891178,0,1358,147823,1340,144977,18,2846,200,5,443,9,0,8,216660.0,130000.0,-40.0,-37.0,-45.0,-51.0,-41.0,-35.0,-43.0,-47.0,-90.0,-92.0,-89.0,-91.0,50.0,55.0,44.0,40.0,1
3248,92:69:1D:31:68:E9,3777910,490155967,12836,15264789,3765074,474891178,3,19411,3601178,18707,3439206,704,161972,6479,105,14105,252,3,252,229410.0,130000.0,-52.0,-47.0,-42.0,-49.0,-51.0,-47.0,-43.0,-48.0,-90.0,-92.0,-89.0,-91.0,38.0,45.0,47.0,42.0,1
3249,CC:2F:71:3F:1F:24,4038825,793039747,273747,318148165,3765078,474891582,27,230686,264467525,230587,264455297,99,12228,220410,6,273748,24129,24,157,130000.0,43333.0,-72.0,-66.0,-69.0,-73.0,-72.0,-66.0,-68.0,-72.0,-90.0,-92.0,-89.0,-91.0,18.0,26.0,20.0,18.0,1
3250,CC:2F:71:3E:C5:1F,3765200,474906522,122,14940,3765078,474891582,0,476,40800,387,30112,89,10688,131,2,161,4,0,5,130000.0,39000.0,-73.0,-70.0,-67.0,-60.0,-71.0,-70.0,-66.0,-60.0,-90.0,-92.0,-89.0,-91.0,17.0,22.0,22.0,31.0,1
3251,BA:8C:B9:54:50:24,3765393,474982892,315,91310,3765078,474891582,0,1358,147823,1340,144977,18,2846,200,5,443,9,0,8,216660.0,130000.0,-40.0,-37.0,-45.0,-51.0,-41.0,-35.0,-43.0,-47.0,-90.0,-92.0,-89.0,-91.0,50.0,55.0,44.0,40.0,1
3252,92:69:1D:31:68:E9,3777914,490156371,12836,15264789,3765078,474891582,3,19411,3601178,18707,3439206,704,161972,6479,105,14105,252,3,252,229410.0,130000.0,-52.0,-47.0,-42.0,-49.0,-51.0,-47.0,-43.0,-48.0,-90.0,-92.0,-89.0,-91.0,38.0,45.0,47.0,42.0,1
3253,CC:2F:71:3F:1F:24,4038935,793158357,273852,318266311,3765083,474892046,27,230776,264577683,230677,264565455,99,12228,220497,6,273853,24130,24,157,130000.0,43333.0,-72.0,-66.0,-69.0,-73.0,-71.0,-66.0,-69.0,-72.0,-90.0,-92.0,-89.0,-91.0,18.0,26.0,20.0,18.0,1
3254,CC:2F:71:3E:C5:1F,3765205,474906986,122,14940,3765083,474892046,0,476,40800,387,30112,89,10688,131,2,161,4,0,5,130000.0,39000.0,-73.0,-70.0,-67.0,-60.0,-71.0,-70.0,-66.0,-60.0,-90.0,-92.0,-89.0,-91.0,17.0,22.0,22.0,31.0,1
3255,BA:8C:B9:54:50:24,3765398,474983356,315,91310,3765083,474892046,0,1358,147823,1340,144977,18,2846,200,5,443,9,0,8,216660.0,130000.0,-40.0,-37.0,-45.0,-51.0,-41.0,-35.0,-43.0,-47.0,-90.0,-92.0,-89.0,-91.0,50.0,55.0,44.0,40.0,1
3256,92:69:1D:31:68:E9,3777919,490156835,12836,15264789,3765083,474892046,3,19411,3601178,18707,3439206,704,161972,6479,105,14105,252,3,252,229410.0,130000.0,-52.0,-47.0,-42.0,-49.0,-51.0,-47.0,-43.0,-48.0,-90.0,-92.0,-89.0,-91.0,38.0,45.0,47.0,42.0,1
3257,CC:2F:71:3F:1F:24,4039044,793278260,273959,318386012,3765085,474892248,27,230871,264692822,230772,264680594,99,12228,220586,6,273960,24135,24,158,130000.0,39000.0,-72.0,-66.0,-69.0,-72.0,-72.0,-66.0,-68.0,-72.0,-90.0,-92.0,-88.0,-90.0,18.0,26.0,19.0,18.0,1
3258,CC:2F:71:3E:C5:1F,3765209,474907390,122,14940,3765087,474892450,0,476,40800,387,30112,89,10688,131,2,161,4,0,5,130000.0,39000.0,-73.0,-70.0,-67.0,-60.0,-71.0,-70.0,-66.0,-60.0,-90.0,-92.0,-88.0,-90.0,17.0,22.0,21.0,30.0,1
3259,BA:8C:B9:54:50:24,3765402,474983760,315,91310,3765087,474892450,0,1358,147823,1340,144977,18,2846,200,5,443,9,0,8,216660.0,130000.0,-40.0,-37.0,-45.0,-51.0,-41.0,-35.0,-43.0,-47.0,-90.0,-92.0,-88.0,-90.0,50.0,55.0,43.0,39.0,1
3260,92:69:1D:31:68:E9,3777923,490157239,12836,15264789,3765087,474892450,3,19411,3601178,18707,3439206,704,161972,6479,105,14105,252,3,252,229410.0,130000.0,-52.0,-47.0,-42.0,-49.0,-51.0,-47.0,-43.0,-48.0,-90.0,-92.0,-88.0,-90.0,38.0,45.0,46.0,41.0,1
3261,CC:2F:71:3F:1F:24,4039156,793397229,274064,318504102,3765092,474893127,27,230966,264803760,230867,264791532,99,12228,220674,6,274065,24136,24,159,130000.0,43333.0,-72.0,-66.0,-69.0,-73.0,-72.0,-66.0,-69.0,-72.0,-90.0,-92.0,-88.0,-90.0,18.0,26.0,19.0,17.0,1
3262,CC:2F:71:3E:C5:1F,3765214,474908067,122,14940,3765092,474893127,0,476,40800,387,30112,89,10688,131,2,161,4,0,5,130000.0,39000.0,-73.0,-70.0,-67.0,-60.0,-71.0,-70.0,-66.0,-60.0,-90.0,-92.0,-88.0,-90.0,17.0,22.0,21.0,30.0,1
3263,BA:8C:B9:54:50:24,3765407,474984437,315,91310,3765092,474893127,0,1358,147823,1340,144977,18,2846,200,5,443,9,0,8,216660.0,130000.0,-40.0,-37.0,-45.0,-51.0,-41.0,-35.0,-43.0,-47.0,-90.0,-92.0,-88.0,-90.0,50.0,55.0,43.0,39.0,1
3264,92:69:1D:31:68:E9,3777928,490157916,12836,15264789,3765092,474893127,3,19411,3601178,18707,3439206,704,161972,6479,105,14105,252,3,252,229410.0,130000.0,-52.0,-47.0,-42.0,-49.0,-51.0,-47.0,-43.0,-48.0,-90.0,-92.0,-88.0,-90.0,38.0,45.0,46.0,41.0,1
3265,CC:2F:71:3F:1F:24,4039278,793520745,274183,318627356,3765095,474893389,27,231071,264915224,230972,264902996,99,12228,220777,6,274183,24136,24,159,130000.0,43333.0,-72.0,-66.0,-69.0,-73.0,-72.0,-66.0,-69.0,-71.0,-90.0,-92.0,-88.0,-90.0,18.0,26.0,19.0,17.0,1
3266,CC:2F:71:3E:C5:1F,3765217,474908329,122,14940,3765095,474893389,0,476,40800,387,30112,89,10688,131,2,161,4,0,5,130000.0,39000.0,-73.0,-70.0,-67.0,-60.0,-71.0,-70.0,-66.0,-60.0,-90.0,-92.0,-88.0,-90.0,17.0,22.0,21.0,30.0,1
3267,BA:8C:B9:54:50:24,3765412,474984901,315,91310,3765097,474893591,0,1358,147823,1340,144977,18,2846,200,5,443,9,0,8,216660.0,130000.0,-40.0,-37.0,-45.0,-51.0,-41.0,-35.0,-43.0,-47.0,-90.0,-92.0,-88.0,-90.0,50.0,55.0,43.0,39.0,1
3268,92:69:1D:31:68:E9,3777933,490158380,12836,15264789,3765097,474893591,3,19411,3601178,18707,3439206,704,161972,6479,105,14105,252,3,252,229410.0,130000.0,-52.0,-47.0,-42.0,-49.0,-51.0,-47.0,-43.0,-48.0,-90.0,-92.0,-88.0,-90.0,38.0,45.0,46.0,41.0,1
3269,CC:2F:71:3F:1F:24,4039396,793642754,274295,318748759,3765101,474893995,27,231168,265030642,231069,265018414,99,12228,220870,6,274296,24140,24,159,130000.0,43333.0,-70.0,-67.0,-69.0,-72.0,-70.0,-67.0,-68.0,-71.0,-90.0,-92.0,-88.0,-90.0,20.0,25.0,19.0,18.0,1
3270,CC:2F:71:3E:C5:1F,3765223,474908935,122,14940,3765101,474893995,0,476,40800,387,30112,89,10688,131,2,161,4,0,5,130000.0,39000.0,-73.0,-70.0,-67.0,-60.0,-71.0,-70.0,-66.0,-60.0,-90.0,-92.0,-88.0,-90.0,17.0,22.0,21.0,30.0,1
3271,BA:8C:B9:54:50:24,3765416,474985305,315,91310,3765101,474893995,0,1358,147823,1340,144977,18,2846,200,5,443,9,0,8,216660.0,130000.0,-40.0,-37.0,-45.0,-51.0,-41.0,-35.0,-43.0,-47.0,-90.0,-92.0,-88.0,-90.0,50.0,55.0,43.0,39.0,1
3272,92:69:1D:31:68:E9,3777937,490158784,12836,15264789,3765101,474893995,3,19411,3601178,18707,3439206,704,161972,6479,105,14105,252,3,252,229410.0,130000.0,-52.0,-47.0,-42.0,-49.0,-51.0,-47.0,-43.0,-48.0,-90.0,-92.0,-88.0,-90.0,38.0,45.0,46.0,41.0,1
3273,CC:2F:71:3F:1F:24,4039505,793762786,274402,318868589,3765103,474894197,27,231258,265142134,231159,265129906,99,12228,220958,6,274403,24141,24,159,130000.0,43333.0,-71.0,-67.0,-68.0,-70.0,-71.0,-66.0,-68.0,-69.0,-90.0,-92.0,-88.0,-90.0,19.0,25.0,20.0,20.0,1
3274,CC:2F:71:3E:C5:1F,3765225,474909137,122,14940,3765103,474894197,0,476,40800,387,30112,89,10688,131,2,161,4,0,5,130000.0,39000.0,-73.0,-70.0,-67.0,-60.0,-71.0,-70.0,-66.0,-60.0,-90.0,-92.0,-88.0,-90.0,17.0,22.0,21.0,30.0,1
3275,BA:8C:B9:54:50:24,3765421,474985769,315,91310,3765106,474894459,0,1358,147823,1340,144977,18,2846,200,5,443,9,0,8,216660.0,130000.0,-40.0,-37.0,-45.0,-51.0,-41.0,-35.0,-43.0,-47.0,-89.0,-91.0,-88.0,-89.0,49.0,54.0,43.0,38.0,1
3276,92:69:1D:31:68:E9,3777942,490159248,12836,15264789,3765106,474894459,3,19411,3601178,18707,3439206,704,161972,6479,105,14105,252,3,252,229410.0,130000.0,-52.0,-47.0,-42.0,-49.0,-51.0,-47.0,-43.0,-48.0,-89.0,-91.0,-88.0,-89.0,37.0,44.0,46.0,40.0,1
3277,CC:2F:71:3F:1F:24,4039621,793884966,274511,318990103,3765110,474894863,27,231350,265252548,231251,265240320,99,12228,221049,6,274512,24141,24,159,130000.0,43333.0,-71.0,-67.0,-68.0,-70.0,-71.0,-66.0,-68.0,-70.0,-89.0,-91.0,-88.0,-89.0,18.0,24.0,20.0,19.0,1
3278,CC:2F:71:3E:C5:1F,3765232,474909803,122,14940,3765110,474894863,0,476,40800,387,30112,89,10688,131,2,161,4,0,5,130000.0,39000.0,-73.0,-70.0,-67.0,-60.0,-71.0,-70.0,-66.0,-60.0,-89.0,-91.0,-88.0,-89.0,16.0,21.0,21.0,29.0,1
3279,BA:8C:B9:54:50:24,3765425,474986173,315,91310,3765110,474894863,0,1358,147823,1340,144977,18,2846,200,5,443,9,0,8,216660.0,130000.0,-40.0,-37.0,-45.0,-51.0,-41.0,-35.0,-43.0,-47.0,-89.0,-91.0,-88.0,-89.0,49.0,54.0,43.0,38.0,1
3280,92:69:1D:31:68:E9,3777946,490159652,12836,15264789,3765110,474894863,3,19411,3601178,18707,3439206,704,161972,6479,105,14105,252,3,252,229410.0,130000.0,-52.0,-47.0,-42.0,-49.0,-51.0,-47.0,-43.0,-48.0,-89.0,-91.0,-88.0,-89.0,37.0,44.0,46.0,40.0,1
3281,CC:2F:71:3F:1F:24,4040181,794566072,275068,319670945,3765113,474895127,27,231641,265398006,231541,265385660,100,12346,221336,6,275069,24145,24,159,130000.0,43333.0,-70.0,-67.0,-68.0,-70.0,-70.0,-67.0,-68.0,-70.0,-90.0,-92.0,-88.0,-89.0,20.0,25.0,20.0,19.0,1
3282,CC:2F:71:3E:C5:1F,3765235,474910067,122,14940,3765113,474895127,0,476,40800,387,30112,89,10688,131,2,161,4,0,5,130000.0,39000.0,-73.0,-70.0,-67.0,-60.0,-71.0,-70.0,-66.0,-60.0,-90.0,-92.0,-88.0,-89.0,17.0,22.0,21.0,29.0,1
3283,BA:8C:B9:54:50:24,3765430,474986639,315,91310,3765115,474895329,0,1358,147823,1340,144977,18,2846,200,5,443,9,0,8,216660.0,130000.0,-40.0,-37.0,-45.0,-51.0,-41.0,-35.0,-43.0,-47.0,-90.0,-92.0,-88.0,-89.0,50.0,55.0,43.0,38.0,1
3284,92:69:1D:31:68:E9,3777951,490160118,12836,15264789,3765115,474895329,3,19411,3601178,18707,3439206,704,161972,6479,105,14105,252,3,252,229410.0,130000.0,-52.0,-47.0,-42.0,-49.0,-51.0,-47.0,-43.0,-48.0,-90.0,-92.0,-88.0,-89.0,38.0,45.0,46.0,40.0,1
3285,CC:2F:71:3F:1F:24,4040491,794933073,275371,320037280,3765120,474895793,27,231814,265518828,231714,265506482,100,12346,221509,6,275372,24145,24,159,130000.0,43333.0,-70.0,-68.0,-70.0,-70.0,-69.0,-67.0,-69.0,-69.0,-90.0,-92.0,-88.0,-89.0,20.0,24.0,18.0,19.0,1
3286,CC:2F:71:3E:C5:1F,3765242,474910733,122,14940,3765120,474895793,0,476,40800,387,30112,89,10688,131,2,161,4,0,5,130000.0,39000.0,-73.0,-70.0,-67.0,-60.0,-71.0,-70.0,-66.0,-60.0,-90.0,-92.0,-88.0,-89.0,17.0,22.0,21.0,29.0,1
3287,BA:8C:B9:54:50:24,3765435,474987103,315,91310,3765120,474895793,0,1358,147823,1340,144977,18,2846,200,5,443,9,0,8,216660.0,130000.0,-40.0,-37.0,-45.0,-51.0,-41.0,-35.0,-43.0,-47.0,-90.0,-92.0,-88.0,-89.0,50.0,55.0,43.0,38.0,1
3288,92:69:1D:31:68:E9,3777956,490160582,12836,15264789,3765120,474895793,3,19411,3601178,18707,3439206,704,161972,6479,105,14105,252,3,252,229410.0,130000.0,-52.0,-47.0,-42.0,-49.0,-51.0,-47.0,-43.0,-48.0,-90.0,-92.0,-88.0,-89.0,38.0,45.0,46.0,40.0,1
3289,CC:2F:71:3F:1F:24,4040602,795054677,275480,320158682,3765122,474895995,27,231911,265638512,231811,265626166,100,12346,221598,6,275481,24145,24,159,144444.0,39000.0,-70.0,-67.0,-71.0,-69.0,-69.0,-66.0,-70.0,-69.0,-89.0,-92.0,-88.0,-89.0,19.0,25.0,17.0,20.0,1
3290,CC:2F:71:3E:C5:1F,3765244,474910935,122,14940,3765122,474895995,0,478,40940,389,30252,89,10688,131,2,162,4,0,5,130000.0,39000.0,-72.0,-70.0,-65.0,-60.0,-71.0,-70.0,-66.0,-60.0,-89.0,-92.0,-88.0,-89.0,17.0,22.0,23.0,29.0,1
3291,BA:8C:B9:54:50:24,3765439,474987507,315,91310,3765124,474896197,0,1360,147959,1342,145113,18,2846,200,5,444,9,0,8,216660.0,130000.0,-49.0,-35.0,-43.0,-45.0,-42.0,-35.0,-43.0,-47.0,-89.0,-92.0,-88.0,-89.0,40.0,57.0,45.0,44.0,1
3292,92:69:1D:31:68:E9,3777960,490160986,12836,15264789,3765124,474896197,3,19413,3601314,18709,3439342,704,161972,6479,105,14106,252,3,252,229410.0,130000.0,-53.0,-48.0,-44.0,-47.0,-51.0,-47.0,-43.0,-48.0,-89.0,-92.0,-88.0,-89.0,36.0,44.0,44.0,42.0,1
3293,CC:2F:71:3F:1F:24,4041272,795884708,276144,320988107,3765128,474896601,27,232262,265792429,232162,265780083,100,12346,221933,6,276139,24175,24,159,144444.0,43333.0,-69.0,-67.0,-71.0,-68.0,-69.0,-67.0,-70.0,-68.0,-89.0,-92.0,-88.0,-89.0,20.0,25.0,17.0,21.0,1
3294,CC:2F:71:3E:C5:1F,3765250,474911541,122,14940,3765128,474896601,0,478,40940,389,30252,89,10688,131,2,162,4,0,5,130000.0,39000.0,-72.0,-70.0,-65.0,-60.0,-71.0,-70.0,-66.0,-60.0,-89.0,-92.0,-88.0,-89.0,17.0,22.0,23.0,29.0,1
3295,BA:8C:B9:54:50:24,3765443,474987911,315,91310,3765128,474896601,0,1360,147959,1342,145113,18,2846,200,5,444,9,0,8,216660.0,130000.0,-49.0,-35.0,-43.0,-45.0,-42.0,-35.0,-43.0,-47.0,-89.0,-91.0,-88.0,-88.0,40.0,56.0,45.0,43.0,1
3296,92:69:1D:31:68:E9,3777964,490161390,12836,15264789,3765128,474896601,3,19413,3601314,18709,3439342,704,161972,6479,105,14106,252,3,252,229410.0,130000.0,-53.0,-48.0,-44.0,-47.0,-51.0,-47.0,-43.0,-48.0,-89.0,-91.0,-88.0,-88.0,36.0,43.0,44.0,41.0,1
3297,CC:2F:71:3F:1F:24,4041857,796600003,276726,321703140,3765131,474896863,27,232585,265936177,232485,265923831,100,12346,222238,6,276727,24177,24,159,144444.0,43333.0,-69.0,-67.0,-70.0,-68.0,-69.0,-67.0,-70.0,-68.0,-89.0,-91.0,-88.0,-88.0,20.0,24.0,18.0,20.0,1
3298,CC:2F:71:3E:C5:1F,3765253,474911803,122,14940,3765131,474896863,0,478,40940,389,30252,89,10688,131,2,162,4,0,5,130000.0,39000.0,-72.0,-70.0,-65.0,-60.0,-71.0,-70.0,-66.0,-60.0,-89.0,-91.0,-88.0,-88.0,17.0,21.0,23.0,28.0,1
3299,BA:8C:B9:54:50:24,3765448,474988375,315,91310,3765133,474897065,0,1361,148027,1343,145181,18,2846,200,5,444,9,0,8,216660.0,130000.0,-40.0,-37.0,-45.0,-51.0,-41.0,-35.0,-43.0,-47.0,-89.0,-91.0,-88.0,-88.0,49.0,54.0,43.0,37.0,1
3300,92:69:1D:31:68:E9,3777969,490161854,12836,15264789,3765133,474897065,3,19413,3601314,18709,3439342,704,161972,6479,105,14106,252,3,252,229410.0,130000.0,-53.0,-48.0,-44.0,-47.0,-51.0,-47.0,-43.0,-48.0,-89.0,-91.0,-88.0,-88.0,36.0,43.0,44.0,41.0,1
3301,CC:2F:71:3F:1F:24,4042355,797177596,277220,322280329,3765135,474897267,27,232868,266082187,232768,266069841,100,12346,222511,6,277221,24208,24,159,144444.0,43333.0,-69.0,-67.0,-71.0,-69.0,-69.0,-67.0,-70.0,-68.0,-89.0,-91.0,-88.0,-88.0,20.0,24.0,17.0,19.0,1
3302,CC:2F:71:3E:C5:1F,3765257,474912207,122,14940,3765135,474897267,0,478,40940,389,30252,89,10688,131,2,162,4,0,5,130000.0,39000.0,-72.0,-70.0,-65.0,-60.0,-71.0,-70.0,-66.0,-60.0,-89.0,-91.0,-88.0,-88.0,17.0,21.0,23.0,28.0,1
3303,BA:8C:B9:54:50:24,3765452,474988779,315,91310,3765137,474897469,0,1361,148027,1343,145181,18,2846,200,5,444,9,0,8,216660.0,130000.0,-40.0,-37.0,-45.0,-51.0,-41.0,-35.0,-43.0,-47.0,-89.0,-91.0,-88.0,-88.0,49.0,54.0,43.0,37.0,1
3304,92:69:1D:31:68:E9,3777973,490162258,12836,15264789,3765137,474897469,3,19413,3601314,18709,3439342,704,161972,6479,105,14106,252,3,252,229410.0,130000.0,-53.0,-48.0,-44.0,-47.0,-51.0,-47.0,-43.0,-48.0,-89.0,-91.0,-88.0,-88.0,36.0,43.0,44.0,41.0,1
3305,CC:2F:71:3F:1F:24,4042818,797746401,277679,322848730,3765139,474897671,27,233111,266214112,233011,266201766,100,12346,222748,6,277680,24222,24,159,144444.0,43333.0,-69.0,-67.0,-71.0,-68.0,-69.0,-67.0,-70.0,-68.0,-89.0,-91.0,-87.0,-87.0,20.0,24.0,16.0,19.0,1
3306,CC:2F:71:3E:C5:1F,3765261,474912611,122,14940,3765139,474897671,0,478,40940,389,30252,89,10688,131,2,162,4,0,5,130000.0,39000.0,-72.0,-70.0,-65.0,-60.0,-71.0,-70.0,-66.0,-60.0,-89.0,-91.0,-87.0,-87.0,17.0,21.0,22.0,27.0,1
3307,BA:8C:B9:54:50:24,3765457,474989243,315,91310,3765142,474897933,0,1361,148027,1343,145181,18,2846,200,5,444,9,0,8,216660.0,130000.0,-40.0,-37.0,-45.0,-51.0,-41.0,-35.0,-43.0,-47.0,-89.0,-91.0,-87.0,-87.0,49.0,54.0,42.0,36.0,1
3308,92:69:1D:31:68:E9,3777978,490162722,12836,15264789,3765142,474897933,3,19413,3601314,18709,3439342,704,161972,6479,105,14106,252,3,252,229410.0,130000.0,-53.0,-48.0,-44.0,-47.0,-51.0,-47.0,-43.0,-48.0,-89.0,-91.0,-87.0,-87.0,36.0,43.0,43.0,40.0,1
3309,CC:2F:71:3F:1F:24,4042930,797865271,277786,322967136,3765144,474898135,27,233203,266328726,233103,266316380,100,12346,222835,6,277787,24223,24,159,144444.0,43333.0,-68.0,-67.0,-69.0,-69.0,-68.0,-67.0,-69.0,-69.0,-89.0,-91.0,-87.0,-87.0,21.0,24.0,18.0,18.0,1
3310,CC:2F:71:3E:C5:1F,3765266,474913075,122,14940,3765144,474898135,0,478,40940,389,30252,89,10688,131,2,162,4,0,5,130000.0,39000.0,-72.0,-70.0,-65.0,-60.0,-71.0,-70.0,-66.0,-60.0,-89.0,-91.0,-87.0,-87.0,17.0,21.0,22.0,27.0,1
3311,BA:8C:B9:54:50:24,3765461,474989647,315,91310,3765146,474898337,0,1361,148027,1343,145181,18,2846,200,5,444,9,0,8,216660.0,130000.0,-40.0,-37.0,-45.0,-51.0,-41.0,-35.0,-43.0,-47.0,-89.0,-91.0,-87.0,-87.0,49.0,54.0,42.0,36.0,1
3312,92:69:1D:31:68:E9,3777982,490163126,12836,15264789,3765146,474898337,3,19413,3601314,18709,3439342,704,161972,6479,105,14106,252,3,252,229410.0,130000.0,-53.0,-48.0,-44.0,-47.0,-51.0,-47.0,-43.0,-48.0,-89.0,-91.0,-87.0,-87.0,36.0,43.0,43.0,40.0,1
3313,CC:2F:71:3F:1F:24,4043041,797982800,277892,323083988,3765149,474898812,27,233295,266439116,233195,266426770,100,12346,222922,6,277893,24227,24,159,144444.0,43333.0,-69.0,-67.0,-68.0,-68.0,-68.0,-67.0,-67.0,-68.0,-89.0,-91.0,-87.0,-87.0,20.0,24.0,19.0,19.0,1
3314,CC:2F:71:3E:C5:1F,3765271,474913752,122,14940,3765149,474898812,0,478,40940,389,30252,89,10688,131,2,162,4,0,5,130000.0,39000.0,-72.0,-70.0,-65.0,-60.0,-71.0,-70.0,-66.0,-60.0,-89.0,-91.0,-87.0,-87.0,17.0,21.0,22.0,27.0,1
3315,BA:8C:B9:54:50:24,3765464,474990122,315,91310,3765149,474898812,0,1361,148027,1343,145181,18,2846,200,5,444,9,0,8,216660.0,130000.0,-40.0,-37.0,-45.0,-51.0,-41.0,-35.0,-43.0,-47.0,-89.0,-91.0,-87.0,-87.0,49.0,54.0,42.0,36.0,1
3316,92:69:1D:31:68:E9,3777987,490163803,12836,15264789,3765151,474899014,3,19413,3601314,18709,3439342,704,161972,6479,105,14106,252,3,252,229410.0,130000.0,-53.0,-48.0,-44.0,-47.0,-51.0,-47.0,-43.0,-48.0,-89.0,-91.0,-87.0,-87.0,36.0,43.0,43.0,40.0,1
3317,CC:2F:71:3F:1F:24,4043151,798101410,277997,323202134,3765154,474899276,27,233384,266549068,233284,266536722,100,12346,223009,6,277998,24227,24,159,144444.0,43333.0,-69.0,-68.0,-69.0,-69.0,-68.0,-67.0,-68.0,-68.0,-88.0,-90.0,-87.0,-87.0,19.0,22.0,18.0,18.0,1
3318,CC:2F:71:3E:C5:1F,3765276,474914216,122,14940,3765154,474899276,0,478,40940,389,30252,89,10688,131,2,162,4,0,5,130000.0,39000.0,-72.0,-70.0,-65.0,-60.0,-71.0,-70.0,-66.0,-60.0,-88.0,-90.0,-87.0,-87.0,16.0,20.0,22.0,27.0,1
3319,BA:8C:B9:54:50:24,3765469,474990586,315,91310,3765154,474899276,0,1361,148027,1343,145181,18,2846,200,5,444,9,0,8,216660.0,130000.0,-40.0,-37.0,-45.0,-51.0,-41.0,-35.0,-43.0,-47.0,-88.0,-90.0,-87.0,-87.0,48.0,53.0,42.0,36.0,1
3320,92:69:1D:31:68:E9,3777990,490164065,12836,15264789,3765154,474899276,3,19413,3601314,18709,3439342,704,161972,6479,105,14106,252,3,252,229410.0,130000.0,-53.0,-48.0,-44.0,-47.0,-51.0,-47.0,-43.0,-48.0,-88.0,-90.0,-87.0,-87.0,35.0,42.0,43.0,40.0,1
3321,CC:2F:71:3F:1F:24,4043270,798225245,278112,323325565,3765158,474899680,27,233485,266661344,233385,266648998,100,12346,223104,6,278113,24227,24,159,144444.0,43333.0,-69.0,-68.0,-68.0,-69.0,-69.0,-67.0,-68.0,-68.0,-88.0,-90.0,-87.0,-86.0,19.0,22.0,19.0,17.0,1
3322,CC:2F:71:3E:C5:1F,3765280,474914620,122,14940,3765158,474899680,0,478,40940,389,30252,89,10688,131,2,162,4,0,5,130000.0,39000.0,-72.0,-70.0,-65.0,-60.0,-71.0,-70.0,-66.0,-60.0,-88.0,-90.0,-87.0,-86.0,16.0,20.0,22.0,26.0,1
3323,BA:8C:B9:54:50:24,3765473,474990990,315,91310,3765158,474899680,0,1361,148027,1343,145181,18,2846,200,5,444,9,0,8,216660.0,130000.0,-40.0,-37.0,-45.0,-51.0,-41.0,-35.0,-43.0,-47.0,-88.0,-90.0,-87.0,-86.0,48.0,53.0,42.0,35.0,1
3324,92:69:1D:31:68:E9,3777994,490164469,12836,15264789,3765158,474899680,3,19413,3601314,18709,3439342,704,161972,6479,105,14106,252,3,252,229410.0,130000.0,-53.0,-48.0,-44.0,-47.0,-51.0,-47.0,-43.0,-48.0,-88.0,-90.0,-87.0,-86.0,35.0,42.0,43.0,39.0,1
3325,CC:2F:71:3F:1F:24,4043379,798343795,278217,323443711,3765162,474900084,27,233575,266771426,233475,266759080,100,12346,223191,6,278218,24227,24,159,144444.0,43333.0,-69.0,-67.0,-68.0,-68.0,-68.0,-67.0,-68.0,-68.0,-88.0,-90.0,-87.0,-86.0,19.0,23.0,19.0,18.0,1
3326,CC:2F:71:3E:C5:1F,3765284,474915024,122,14940,3765162,474900084,0,478,40940,389,30252,89,10688,131,2,162,4,0,5,130000.0,39000.0,-72.0,-70.0,-65.0,-60.0,-71.0,-70.0,-66.0,-60.0,-88.0,-90.0,-87.0,-86.0,16.0,20.0,22.0,26.0,1
3327,BA:8C:B9:54:50:24,3765477,474991394,315,91310,3765162,474900084,0,1361,148027,1343,145181,18,2846,200,5,444,9,0,8,216660.0,130000.0,-40.0,-37.0,-45.0,-51.0,-41.0,-35.0,-43.0,-47.0,-88.0,-90.0,-87.0,-86.0,48.0,53.0,42.0,35.0,1
3328,92:69:1D:31:68:E9,3777998,490164873,12836,15264789,3765162,474900084,3,19413,3601314,18709,3439342,704,161972,6479,105,14106,252,3,252,229410.0,130000.0,-53.0,-48.0,-44.0,-47.0,-51.0,-47.0,-43.0,-48.0,-88.0,-90.0,-87.0,-86.0,35.0,42.0,43.0,39.0,1
3329,CC:2F:71:3F:1F:24,4043489,798462463,278324,323562117,3765165,474900346,27,233669,266885008,233569,266872662,100,12346,223280,6,278324,24230,24,159,144444.0,43333.0,-69.0,-67.0,-68.0,-68.0,-69.0,-67.0,-68.0,-68.0,-88.0,-90.0,-87.0,-86.0,19.0,23.0,19.0,18.0,1
3330,CC:2F:71:3E:C5:1F,3765287,474915286,122,14940,3765165,474900346,0,478,40940,389,30252,89,10688,131,2,162,4,0,5,130000.0,39000.0,-72.0,-70.0,-65.0,-60.0,-71.0,-70.0,-66.0,-60.0,-88.0,-90.0,-87.0,-86.0,16.0,20.0,22.0,26.0,1
3331,BA:8C:B9:54:50:24,3765482,474991858,315,91310,3765167,474900548,0,1361,148027,1343,145181,18,2846,200,5,444,9,0,8,216660.0,130000.0,-40.0,-37.0,-45.0,-51.0,-41.0,-35.0,-43.0,-47.0,-88.0,-90.0,-87.0,-86.0,48.0,53.0,42.0,35.0,1
3332,92:69:1D:31:68:E9,3778003,490165337,12836,15264789,3765167,474900548,3,19413,3601314,18709,3439342,704,161972,6479,105,14106,252,3,252,229410.0,130000.0,-53.0,-48.0,-44.0,-47.0,-51.0,-47.0,-43.0,-48.0,-88.0,-90.0,-87.0,-86.0,35.0,42.0,43.0,39.0,1
3333,CC:2F:71:3F:1F:24,4043601,798581345,278430,323680393,3765171,474900952,27,233765,266997444,233665,266985098,100,12346,223370,6,278431,24230,24,159,144444.0,43333.0,-69.0,-67.0,-68.0,-69.0,-69.0,-67.0,-67.0,-69.0,-88.0,-90.0,-86.0,-86.0,19.0,23.0,18.0,17.0,1
3334,CC:2F:71:3E:C5:1F,3765293,474915892,122,14940,3765171,474900952,0,478,40940,389,30252,89,10688,131,2,162,4,0,5,130000.0,39000.0,-72.0,-70.0,-65.0,-60.0,-71.0,-70.0,-66.0,-60.0,-88.0,-90.0,-86.0,-86.0,16.0,20.0,21.0,26.0,1
3335,BA:8C:B9:54:50:24,3765486,474992262,315,91310,3765171,474900952,0,1361,148027,1343,145181,18,2846,200,5,444,9,0,8,216660.0,130000.0,-40.0,-37.0,-45.0,-51.0,-41.0,-35.0,-43.0,-47.0,-88.0,-90.0,-86.0,-86.0,48.0,53.0,41.0,35.0,1
3336,92:69:1D:31:68:E9,3778007,490165741,12836,15264789,3765171,474900952,3,19413,3601314,18709,3439342,704,161972,6479,105,14106,252,3,252,229410.0,130000.0,-53.0,-48.0,-44.0,-47.0,-51.0,-47.0,-43.0,-48.0,-88.0,-90.0,-86.0,-86.0,35.0,42.0,42.0,39.0,1
3337,CC:2F:71:3F:1F:24,4043715,798701684,278542,323800530,3765173,474901154,27,233866,267112389,233766,267100043,100,12346,223464,6,278543,24254,24,159,130000.0,43333.0,-71.0,-68.0,-67.0,-68.0,-71.0,-68.0,-67.0,-68.0,-88.0,-89.0,-86.0,-85.0,17.0,21.0,19.0,17.0,1
3338,CC:2F:71:3E:C5:1F,3765295,474916094,122,14940,3765173,474901154,0,478,40940,389,30252,89,10688,131,2,162,4,0,5,130000.0,39000.0,-72.0,-70.0,-65.0,-60.0,-71.0,-70.0,-66.0,-60.0,-88.0,-89.0,-86.0,-85.0,16.0,19.0,21.0,25.0,1
3339,BA:8C:B9:54:50:24,3765488,474992464,315,91310,3765173,474901154,0,1361,148027,1343,145181,18,2846,200,5,444,9,0,8,216660.0,130000.0,-40.0,-37.0,-45.0,-51.0,-41.0,-35.0,-43.0,-47.0,-88.0,-89.0,-86.0,-85.0,48.0,52.0,41.0,34.0,1
3340,92:69:1D:31:68:E9,3778012,490166205,12836,15264789,3765176,474901416,3,19413,3601314,18709,3439342,704,161972,6479,105,14106,252,3,252,229410.0,130000.0,-53.0,-48.0,-44.0,-47.0,-51.0,-47.0,-43.0,-48.0,-88.0,-89.0,-86.0,-85.0,35.0,41.0,42.0,38.0,1
3341,CC:2F:71:3F:1F:24,4043830,798822296,278650,323920476,3765180,474901820,27,233959,267223009,233859,267210663,100,12346,223553,6,278651,24254,24,159,130000.0,43333.0,-70.0,-66.0,-68.0,-68.0,-70.0,-66.0,-68.0,-67.0,-88.0,-89.0,-86.0,-85.0,18.0,23.0,18.0,17.0,1
3342,CC:2F:71:3E:C5:1F,3765303,474916876,123,15056,3765180,474901820,0,480,41080,391,30392,89,10688,131,2,163,4,0,5,130000.0,39000.0,-71.0,-70.0,-67.0,-60.0,-72.0,-69.0,-66.0,-60.0,-88.0,-89.0,-86.0,-85.0,17.0,19.0,19.0,25.0,1
3343,BA:8C:B9:54:50:24,3765496,474993246,316,91426,3765180,474901820,0,1367,148435,1349,145589,18,2846,200,5,445,9,0,8,216660.0,130000.0,-40.0,-37.0,-45.0,-51.0,-43.0,-37.0,-44.0,-48.0,-88.0,-89.0,-86.0,-85.0,48.0,52.0,41.0,34.0,1
3344,92:69:1D:31:68:E9,3778017,490166725,12837,15264905,3765180,474901820,3,19415,3601450,18711,3439478,704,161972,6479,105,14107,252,3,252,229410.0,130000.0,-52.0,-47.0,-42.0,-48.0,-52.0,-47.0,-42.0,-48.0,-88.0,-89.0,-86.0,-85.0,36.0,42.0,44.0,37.0,1
3345,CC:2F:71:3F:1F:24,4043937,798939052,278755,324037030,3765182,474902022,27,234048,267331523,233948,267319177,100,12346,223641,6,278756,24254,24,159,144444.0,43333.0,-70.0,-66.0,-68.0,-68.0,-69.0,-66.0,-68.0,-68.0,-88.0,-89.0,-86.0,-85.0,18.0,23.0,18.0,17.0,1
3346,CC:2F:71:3E:C5:1F,3765305,474917078,123,15056,3765182,474902022,0,480,41080,391,30392,89,10688,131,2,163,4,0,5,130000.0,39000.0,-71.0,-70.0,-67.0,-60.0,-72.0,-69.0,-66.0,-60.0,-88.0,-89.0,-86.0,-85.0,17.0,19.0,19.0,25.0,1
3347,BA:8C:B9:54:50:24,3765498,474993448,316,91426,3765182,474902022,0,1367,148435,1349,145589,18,2846,200,5,445,9,0,8,216660.0,130000.0,-40.0,-37.0,-45.0,-51.0,-43.0,-37.0,-44.0,-48.0,-88.0,-89.0,-86.0,-85.0,48.0,52.0,41.0,34.0,1
3348,92:69:1D:31:68:E9,3778021,490167129,12837,15264905,3765184,474902224,3,19415,3601450,18711,3439478,704,161972,6479,105,14107,252,3,252,229410.0,130000.0,-52.0,-47.0,-42.0,-48.0,-52.0,-47.0,-42.0,-48.0,-88.0,-89.0,-86.0,-85.0,36.0,42.0,44.0,37.0,1
3349,CC:2F:71:3F:1F:24,4044049,799057864,278860,324155176,3765189,474902688,27,234143,267443793,234043,267431447,100,12346,223729,6,278861,24254,24,159,144444.0,43333.0,-70.0,-66.0,-68.0,-68.0,-70.0,-66.0,-68.0,-68.0,-87.0,-89.0,-85.0,-84.0,17.0,23.0,17.0,16.0,1
3350,CC:2F:71:3E:C5:1F,3765312,474917744,123,15056,3765189,474902688,0,480,41080,391,30392,89,10688,131,2,163,4,0,5,130000.0,39000.0,-71.0,-70.0,-67.0,-60.0,-72.0,-69.0,-66.0,-60.0,-87.0,-89.0,-85.0,-84.0,16.0,19.0,18.0,24.0,1
3351,BA:8C:B9:54:50:24,3765505,474994114,316,91426,3765189,474902688,0,1367,148435,1349,145589,18,2846,200,5,445,9,0,8,216660.0,130000.0,-40.0,-37.0,-45.0,-51.0,-43.0,-37.0,-44.0,-48.0,-87.0,-89.0,-85.0,-84.0,47.0,52.0,40.0,33.0,1
3352,92:69:1D:31:68:E9,3778026,490167593,12837,15264905,3765189,474902688,3,19415,3601450,18711,3439478,704,161972,6479,105,14107,252,3,252,229410.0,130000.0,-52.0,-47.0,-42.0,-48.0,-52.0,-47.0,-42.0,-48.0,-87.0,-89.0,-85.0,-84.0,35.0,42.0,43.0,36.0,1
3353,CC:2F:71:3F:1F:24,4044157,799177766,278966,324274876,3765191,474902890,27,234241,267563479,234141,267551133,100,12346,223818,6,278966,24255,24,159,144444.0,43333.0,-69.0,-66.0,-68.0,-68.0,-69.0,-66.0,-67.0,-68.0,-87.0,-88.0,-85.0,-83.0,18.0,22.0,17.0,15.0,1
3354,CC:2F:71:3E:C5:1F,3765314,474917946,123,15056,3765191,474902890,0,480,41080,391,30392,89,10688,131,2,163,4,0,5,130000.0,39000.0,-71.0,-70.0,-67.0,-60.0,-72.0,-69.0,-66.0,-60.0,-87.0,-88.0,-85.0,-83.0,16.0,18.0,18.0,23.0,1
3355,BA:8C:B9:54:50:24,3765507,474994316,316,91426,3765191,474902890,0,1367,148435,1349,145589,18,2846,200,5,445,9,0,8,216660.0,130000.0,-40.0,-37.0,-45.0,-51.0,-43.0,-37.0,-44.0,-48.0,-87.0,-88.0,-85.0,-83.0,47.0,51.0,40.0,32.0,1
3356,92:69:1D:31:68:E9,3778028,490167795,12837,15264905,3765191,474902890,3,19415,3601450,18711,3439478,704,161972,6479,105,14107,252,3,252,229410.0,130000.0,-52.0,-47.0,-42.0,-48.0,-52.0,-47.0,-42.0,-48.0,-87.0,-88.0,-85.0,-83.0,35.0,41.0,43.0,35.0,1
3357,CC:2F:71:3F:1F:24,4044281,799301215,279076,324394809,3765205,474906406,27,234340,267673708,234240,267661362,100,12346,223915,6,279077,24255,24,159,144444.0,43333.0,-70.0,-66.0,-68.0,-68.0,-69.0,-66.0,-68.0,-68.0,-87.0,-88.0,-85.0,-83.0,17.0,22.0,17.0,15.0,1
3358,CC:2F:71:3E:C5:1F,3765328,474921462,123,15056,3765205,474906406,0,480,41080,391,30392,89,10688,131,2,163,4,0,5,130000.0,39000.0,-71.0,-70.0,-67.0,-60.0,-72.0,-69.0,-66.0,-60.0,-87.0,-88.0,-85.0,-83.0,16.0,18.0,18.0,23.0,1
3359,BA:8C:B9:54:50:24,3765521,474997832,316,91426,3765205,474906406,0,1367,148435,1349,145589,18,2846,200,5,445,9,0,8,216660.0,130000.0,-40.0,-37.0,-45.0,-51.0,-43.0,-37.0,-44.0,-48.0,-87.0,-88.0,-85.0,-83.0,47.0,51.0,40.0,32.0,1
3360,92:69:1D:31:68:E9,3778042,490171311,12837,15264905,3765205,474906406,3,19415,3601450,18711,3439478,704,161972,6479,105,14107,252,3,252,229410.0,130000.0,-52.0,-47.0,-42.0,-48.0,-52.0,-47.0,-42.0,-48.0,-87.0,-88.0,-85.0,-83.0,35.0,41.0,43.0,35.0,1
3361,CC:2F:71:3F:1F:24,4044388,799419493,279180,324512825,3765208,474906668,27,234427,267779128,234327,267766782,100,12346,224002,6,279181,24255,24,159,144444.0,43333.0,-70.0,-66.0,-68.0,-68.0,-69.0,-66.0,-67.0,-68.0,-87.0,-88.0,-85.0,-83.0,17.0,22.0,17.0,15.0,1
3362,CC:2F:71:3E:C5:1F,3765331,474921724,123,15056,3765208,474906668,0,480,41080,391,30392,89,10688,131,2,163,4,0,5,130000.0,39000.0,-71.0,-70.0,-67.0,-60.0,-72.0,-69.0,-66.0,-60.0,-87.0,-88.0,-85.0,-83.0,16.0,18.0,18.0,23.0,1
3363,BA:8C:B9:54:50:24,3765524,474998094,316,91426,3765208,474906668,0,1367,148435,1349,145589,18,2846,200,5,445,9,0,8,216660.0,130000.0,-40.0,-37.0,-45.0,-51.0,-43.0,-37.0,-44.0,-48.0,-87.0,-88.0,-85.0,-83.0,47.0,51.0,40.0,32.0,1
3364,92:69:1D:31:68:E9,3778046,490171635,12837,15264905,3765209,474906730,3,19415,3601450,18711,3439478,704,161972,6479,105,14107,252,3,252,229410.0,130000.0,-52.0,-47.0,-42.0,-48.0,-52.0,-47.0,-42.0,-48.0,-87.0,-88.0,-85.0,-83.0,35.0,41.0,43.0,35.0,1
3365,CC:2F:71:3F:1F:24,4044500,799536869,279285,324629533,3765215,474907336,27,234521,267892528,234420,267880064,101,12464,224092,6,279286,24255,24,159,144444.0,43333.0,-70.0,-66.0,-68.0,-68.0,-69.0,-66.0,-68.0,-68.0,-87.0,-88.0,-85.0,-83.0,17.0,22.0,17.0,15.0,1
3366,CC:2F:71:3E:C5:1F,3765338,474922392,123,15056,3765215,474907336,0,480,41080,391,30392,89,10688,131,2,163,4,0,5,130000.0,39000.0,-71.0,-70.0,-67.0,-60.0,-72.0,-69.0,-66.0,-60.0,-87.0,-88.0,-85.0,-83.0,16.0,18.0,18.0,23.0,1
3367,BA:8C:B9:54:50:24,3765531,474998762,316,91426,3765215,474907336,0,1367,148435,1349,145589,18,2846,200,5,445,9,0,8,216660.0,130000.0,-40.0,-37.0,-45.0,-51.0,-43.0,-37.0,-44.0,-48.0,-87.0,-88.0,-85.0,-83.0,47.0,51.0,40.0,32.0,1
3368,92:69:1D:31:68:E9,3778052,490172241,12837,15264905,3765215,474907336,3,19415,3601450,18711,3439478,704,161972,6479,105,14107,252,3,252,229410.0,130000.0,-52.0,-47.0,-42.0,-48.0,-52.0,-47.0,-42.0,-48.0,-87.0,-88.0,-85.0,-83.0,35.0,41.0,43.0,35.0,1
3369,CC:2F:71:3F:1F:24,4044610,799655746,279391,324747809,3765219,474907937,27,234615,268004606,234514,267992142,101,12464,224181,6,279392,24256,24,159,144444.0,43333.0,-70.0,-66.0,-68.0,-69.0,-70.0,-66.0,-68.0,-69.0,-87.0,-88.0,-85.0,-83.0,17.0,22.0,17.0,14.0,1
3370,CC:2F:71:3E:C5:1F,3765342,474922993,123,15056,3765219,474907937,0,480,41080,391,30392,89,10688,131,2,163,4,0,5,130000.0,39000.0,-71.0,-70.0,-67.0,-60.0,-72.0,-69.0,-66.0,-60.0,-87.0,-88.0,-84.0,-83.0,16.0,18.0,17.0,23.0,1
3371,BA:8C:B9:54:50:24,3765535,474999363,316,91426,3765219,474907937,0,1367,148435,1349,145589,18,2846,200,5,445,9,0,8,216660.0,130000.0,-40.0,-37.0,-45.0,-51.0,-43.0,-37.0,-44.0,-48.0,-87.0,-88.0,-84.0,-83.0,47.0,51.0,39.0,32.0,1
3372,92:69:1D:31:68:E9,3778056,490172842,12837,15264905,3765219,474907937,3,19415,3601450,18711,3439478,704,161972,6479,105,14107,252,3,252,229410.0,130000.0,-52.0,-47.0,-42.0,-48.0,-52.0,-47.0,-42.0,-48.0,-87.0,-88.0,-84.0,-83.0,35.0,41.0,42.0,35.0,1
3373,CC:2F:71:3F:1F:24,4044731,799779645,279504,324870980,3765227,474908665,27,234717,268120951,234616,268108487,101,12464,224278,6,279505,24260,24,159,144444.0,43333.0,-70.0,-67.0,-69.0,-69.0,-70.0,-67.0,-68.0,-69.0,-87.0,-88.0,-84.0,-83.0,17.0,21.0,15.0,14.0,1
3374,CC:2F:71:3E:C5:1F,3765350,474923721,123,15056,3765227,474908665,0,482,41268,392,30462,90,10806,132,2,163,4,0,5,130000.0,39000.0,-72.0,-70.0,-67.0,-60.0,-72.0,-70.0,-66.0,-60.0,-87.0,-88.0,-84.0,-83.0,15.0,18.0,17.0,23.0,1
3375,BA:8C:B9:54:50:24,3765543,475000091,316,91426,3765227,474908665,0,1367,148435,1349,145589,18,2846,200,5,445,9,0,8,216660.0,130000.0,-40.0,-37.0,-45.0,-51.0,-43.0,-37.0,-44.0,-48.0,-87.0,-88.0,-84.0,-83.0,47.0,51.0,39.0,32.0,1
3376,92:69:1D:31:68:E9,3778064,490173570,12837,15264905,3765227,474908665,3,19415,3601450,18711,3439478,704,161972,6479,105,14107,252,3,252,229410.0,130000.0,-52.0,-47.0,-42.0,-48.0,-52.0,-47.0,-42.0,-48.0,-87.0,-88.0,-84.0,-83.0,35.0,41.0,42.0,35.0,1
3377,CC:2F:71:3F:1F:24,4044840,799898253,279611,324989386,3765229,474908867,27,234807,268229643,234706,268217179,101,12464,224366,6,279612,24260,24,159,144444.0,43333.0,-70.0,-67.0,-69.0,-69.0,-71.0,-67.0,-69.0,-69.0,-87.0,-88.0,-84.0,-83.0,17.0,21.0,15.0,14.0,1
3378,CC:2F:71:3E:C5:1F,3765352,474923923,123,15056,3765229,474908867,0,482,41268,392,30462,90,10806,132,2,163,4,0,5,130000.0,39000.0,-72.0,-70.0,-67.0,-60.0,-72.0,-70.0,-66.0,-60.0,-87.0,-88.0,-84.0,-83.0,15.0,18.0,17.0,23.0,1
3379,BA:8C:B9:54:50:24,3765545,475000293,316,91426,3765229,474908867,0,1367,148435,1349,145589,18,2846,200,5,445,9,0,8,216660.0,130000.0,-40.0,-37.0,-45.0,-51.0,-43.0,-37.0,-44.0,-48.0,-87.0,-88.0,-84.0,-83.0,47.0,51.0,39.0,32.0,1
3380,92:69:1D:31:68:E9,3778066,490173772,12837,15264905,3765229,474908867,3,19415,3601450,18711,3439478,704,161972,6479,105,14107,252,3,252,229410.0,130000.0,-52.0,-47.0,-42.0,-48.0,-52.0,-47.0,-42.0,-48.0,-87.0,-88.0,-84.0,-83.0,35.0,41.0,42.0,35.0,1
3381,CC:2F:71:3F:1F:24,4044950,800016933,279717,325107662,3765233,474909271,27,234896,268339595,234795,268327131,101,12464,224453,6,279718,24260,24,159,144444.0,43333.0,-70.0,-66.0,-68.0,-69.0,-69.0,-66.0,-68.0,-68.0,-87.0,-87.0,-84.0,-82.0,17.0,21.0,16.0,13.0,1
3382,CC:2F:71:3E:C5:1F,3765359,474924589,123,15056,3765236,474909533,0,482,41268,392,30462,90,10806,132,2,163,4,0,5,130000.0,39000.0,-72.0,-70.0,-67.0,-60.0,-72.0,-70.0,-66.0,-60.0,-87.0,-87.0,-84.0,-82.0,15.0,17.0,17.0,22.0,1
3383,BA:8C:B9:54:50:24,3765552,475000959,316,91426,3765236,474909533,0,1367,148435,1349,145589,18,2846,200,5,445,9,0,8,216660.0,130000.0,-40.0,-37.0,-45.0,-51.0,-43.0,-37.0,-44.0,-48.0,-87.0,-87.0,-84.0,-82.0,47.0,50.0,39.0,31.0,1
3384,92:69:1D:31:68:E9,3778073,490174438,12837,15264905,3765236,474909533,3,19415,3601450,18711,3439478,704,161972,6479,105,14107,252,3,252,229410.0,130000.0,-52.0,-47.0,-42.0,-48.0,-52.0,-47.0,-42.0,-48.0,-87.0,-87.0,-84.0,-82.0,35.0,40.0,42.0,34.0,1
3385,CC:2F:71:3F:1F:24,4045062,800137227,279824,325227492,3765238,474909735,27,234991,268448901,234890,268436437,101,12464,224547,6,279825,24261,24,159,144444.0,43333.0,-70.0,-66.0,-68.0,-69.0,-69.0,-66.0,-68.0,-69.0,-87.0,-87.0,-84.0,-82.0,17.0,21.0,16.0,13.0,1
3386,CC:2F:71:3E:C5:1F,3765361,474924791,123,15056,3765238,474909735,0,482,41268,392,30462,90,10806,132,2,163,4,0,5,130000.0,39000.0,-72.0,-70.0,-67.0,-60.0,-72.0,-70.0,-66.0,-60.0,-87.0,-87.0,-84.0,-82.0,15.0,17.0,17.0,22.0,1
3387,BA:8C:B9:54:50:24,3765554,475001161,316,91426,3765238,474909735,0,1367,148435,1349,145589,18,2846,200,5,445,9,0,8,216660.0,130000.0,-40.0,-37.0,-45.0,-51.0,-43.0,-37.0,-44.0,-48.0,-87.0,-87.0,-84.0,-82.0,47.0,50.0,39.0,31.0,1
3388,92:69:1D:31:68:E9,3778075,490174640,12837,15264905,3765238,474909735,3,19416,3601518,18712,3439546,704,161972,6479,105,14107,252,3,252,229410.0,130000.0,-52.0,-47.0,-41.0,-48.0,-52.0,-47.0,-42.0,-48.0,-87.0,-87.0,-84.0,-82.0,35.0,40.0,43.0,34.0,1
3389,CC:2F:71:3F:1F:24,4045203,800270531,279938,325349369,3765265,474921162,27,235096,268567312,234995,268554848,101,12464,224642,6,279939,24262,24,159,144444.0,43333.0,-70.0,-66.0,-68.0,-69.0,-69.0,-66.0,-67.0,-68.0,-87.0,-87.0,-84.0,-82.0,17.0,21.0,16.0,13.0,1
3390,CC:2F:71:3E:C5:1F,3765390,474936420,123,15056,3765267,474921364,0,482,41268,392,30462,90,10806,132,2,163,4,0,5,130000.0,39000.0,-72.0,-70.0,-67.0,-60.0,-72.0,-70.0,-66.0,-60.0,-87.0,-87.0,-84.0,-82.0,15.0,17.0,17.0,22.0,1
3391,BA:8C:B9:54:50:24,3765583,475012790,316,91426,3765267,474921364,0,1367,148435,1349,145589,18,2846,200,5,445,9,0,8,216660.0,130000.0,-40.0,-37.0,-45.0,-51.0,-43.0,-37.0,-44.0,-48.0,-87.0,-87.0,-84.0,-82.0,47.0,50.0,39.0,31.0,1
3392,92:69:1D:31:68:E9,3778104,490186269,12837,15264905,3765267,474921364,3,19419,3601889,18714,3439682,705,162207,6480,105,14107,252,3,252,229410.0,130000.0,-52.0,-47.0,-42.0,-48.0,-52.0,-47.0,-42.0,-48.0,-87.0,-87.0,-84.0,-82.0,35.0,40.0,42.0,34.0,1
3393,CC:2F:71:3F:1F:24,4045315,800389401,280045,325467775,3765270,474921626,27,235185,268674388,235084,268661924,101,12464,224731,6,280046,24262,24,159,144444.0,43333.0,-70.0,-66.0,-68.0,-69.0,-69.0,-66.0,-68.0,-69.0,-87.0,-87.0,-84.0,-82.0,17.0,21.0,16.0,13.0,1
3394,CC:2F:71:3E:C5:1F,3765393,474936682,123,15056,3765270,474921626,0,482,41268,392,30462,90,10806,132,2,163,4,0,5,130000.0,39000.0,-72.0,-70.0,-67.0,-60.0,-72.0,-70.0,-66.0,-60.0,-87.0,-87.0,-84.0,-82.0,15.0,17.0,17.0,22.0,1
3395,BA:8C:B9:54:50:24,3765586,475013052,316,91426,3765270,474921626,0,1367,148435,1349,145589,18,2846,200,5,445,9,0,8,216660.0,130000.0,-40.0,-37.0,-45.0,-51.0,-43.0,-37.0,-44.0,-48.0,-87.0,-87.0,-84.0,-82.0,47.0,50.0,39.0,31.0,1
3396,92:69:1D:31:68:E9,3778107,490186531,12837,15264905,3765270,474921626,3,19419,3601889,18714,3439682,705,162207,6480,105,14107,252,3,252,229410.0,130000.0,-52.0,-47.0,-42.0,-48.0,-52.0,-47.0,-42.0,-48.0,-87.0,-87.0,-84.0,-82.0,35.0,40.0,42.0,34.0,1
3397,CC:2F:71:3F:1F:24,4045427,800509873,280151,325587475,3765276,474922398,27,235278,268787808,235177,268775344,101,12464,224820,6,280152,24264,24,159,144444.0,43333.0,-70.0,-66.0,-69.0,-69.0,-69.0,-66.0,-68.0,-69.0,-87.0,-87.0,-84.0,-83.0,17.0,21.0,15.0,14.0,1
3398,CC:2F:71:3E:C5:1F,3765401,474937656,123,15056,3765278,474922600,0,484,41408,394,30602,90,10806,132,2,164,4,0,5,130000.0,39000.0,-69.0,-70.0,-66.0,-60.0,-71.0,-70.0,-66.0,-60.0,-87.0,-87.0,-84.0,-83.0,18.0,17.0,18.0,23.0,1
3399,BA:8C:B9:54:50:24,3765594,475014026,316,91426,3765278,474922600,0,1370,148639,1352,145793,18,2846,200,6,446,12,0,8,216660.0,130000.0,-40.0,-37.0,-45.0,-51.0,-41.0,-37.0,-45.0,-49.0,-87.0,-87.0,-84.0,-83.0,47.0,50.0,39.0,32.0,1
3400,92:69:1D:31:68:E9,3778115,490187505,12837,15264905,3765278,474922600,3,19419,3601889,18714,3439682,705,162207,6480,105,14107,252,3,252,229410.0,130000.0,-52.0,-47.0,-42.0,-48.0,-52.0,-47.0,-42.0,-48.0,-87.0,-87.0,-84.0,-83.0,35.0,40.0,42.0,35.0,1
