sample,station,tx_total_pkts,tx_total_bytes,tx_ucast_pkts,tx_ucast_bytes,tx_mcast_bcast_pkts,tx_mcast_bcast_bytes,tx_failures,rx_data_pkts,rx_data_bytes,rx_ucast_pkts,rx_ucast_bytes,rx_mcast_bcast_pkts,rx_mcast_bcast_bytes,rx_decrypt_succeeds,tx_data_pkts_retried,tx_total_pkts_sent,tx_pkts_retries,tx_pkts_retry_exhausted,rx_total_pkts_retried,rate_last_tx_pkt_min,rate_last_tx_pkt_max,per_antenna_rssi_last_rx_data_frame_1,per_antenna_rssi_last_rx_data_frame_2,per_antenna_rssi_last_rx_data_frame_3,per_antenna_rssi_last_rx_data_frame_4,per_antenna_avg_rssi_rx_data_frames_1,per_antenna_avg_rssi_rx_data_frames_2,per_antenna_avg_rssi_rx_data_frames_3,per_antenna_avg_rssi_rx_data_frames_4,per_antenna_noise_floor_1,per_antenna_noise_floor_2,per_antenna_noise_floor_3,per_antenna_noise_floor_4,sinr_per_antenna_1,sinr_per_antenna_2,sinr_per_antenna_3,sinr_per_antenna_4,attack
1,62:47:05:9D:EB:15,3852587,497208200,6732,12179900,3845855,485028300,1,6930,3799150,6880,3791492,50,7658,3308,0,6794,56,1,125,216660.0,130000.0,-44.0,-45.0,-35.0,-47.0,-43.0,-45.0,-36.0,-46.0,-90.0,-93.0,-90.0,-93.0,46.0,48.0,55.0,46.0,1
2,92:69:1D:31:68:E9,3849893,488680185,4038,3651885,3845855,485028300,1,5362,1154569,5194,1116421,168,38148,2199,12,4287,103,1,60,229410.0,130000.0,-52.0,-48.0,-45.0,-47.0,-52.0,-47.0,-43.0,-47.0,-90.0,-93.0,-90.0,-93.0,38.0,45.0,45.0,46.0,1
3,CC:2F:71:3F:1F:24,4990063,1792006357,1144208,1306978057,3845855,485028300,1730,957967,1081385716,957143,1081286118,824,99598,925782,15,1142833,119389,1727,751,130000.0,43333.0,-70.0,-69.0,-67.0,-74.0,-70.0,-69.0,-66.0,-73.0,-90.0,-93.0,-90.0,-93.0,20.0,24.0,23.0,19.0,1
4,CC:2F:71:3E:C5:1F,3846834,485148017,979,119717,3845855,485028300,2,4242,354243,3530,269697,712,84546,1038,13,1406,28,2,54,144444.0,39000.0,-72.0,-71.0,-61.0,-60.0,-72.0,-71.0,-67.0,-60.0,-90.0,-93.0,-90.0,-93.0,18.0,22.0,29.0,33.0,1
5,BA:8C:B9:54:50:24,3850780,491221524,4922,6192962,3845858,485028562,7,9709,1748726,9687,1745231,22,3495,2358,17,5418,41,7,70,216660.0,130000.0,-49.0,-35.0,-43.0,-45.0,-45.0,-34.0,-43.0,-46.0,-90.0,-93.0,-90.0,-93.0,41.0,58.0,47.0,48.0,1
6,62:47:05:9D:EB:15,3852596,497209004,6732,12179900,3845864,485029104,1,6930,3799150,6880,3791492,50,7658,3308,0,6794,56,1,125,216660.0,130000.0,-44.0,-45.0,-35.0,-47.0,-43.0,-45.0,-36.0,-46.0,-90.0,-93.0,-90.0,-93.0,46.0,48.0,55.0,46.0,1
7,92:69:1D:31:68:E9,3849902,488680989,4038,3651885,3845864,485029104,1,5362,1154569,5194,1116421,168,38148,2199,12,4287,103,1,60,229410.0,130000.0,-52.0,-48.0,-45.0,-47.0,-52.0,-47.0,-43.0,-47.0,-90.0,-93.0,-90.0,-93.0,38.0,45.0,45.0,46.0,1
8,CC:2F:71:3F:1F:24,4990264,1792251363,1144400,1307222259,3845864,485029104,1730,958138,1081615072,957314,1081515474,824,99598,925953,15,1143025,119391,1727,751,144444.0,43333.0,-69.0,-68.0,-67.0,-74.0,-69.0,-68.0,-66.0,-73.0,-90.0,-93.0,-90.0,-93.0,21.0,25.0,23.0,19.0,1
9,CC:2F:71:3E:C5:1F,3846844,485148937,980,119833,3845864,485029104,2,4243,354313,3531,269767,712,84546,1038,13,1407,28,2,54,144444.0,39000.0,-72.0,-73.0,-70.0,-61.0,-72.0,-71.0,-67.0,-60.0,-90.0,-93.0,-90.0,-93.0,18.0,20.0,20.0,32.0,1
10,BA:8C:B9:54:50:24,3850786,491222066,4922,6192962,3845864,485029104,7,9709,1748726,9687,1745231,22,3495,2358,17,5418,41,7,70,216660.0,130000.0,-49.0,-35.0,-43.0,-45.0,-45.0,-34.0,-43.0,-46.0,-90.0,-93.0,-90.0,-93.0,41.0,58.0,47.0,48.0,1
11,62:47:05:9D:EB:15,3852598,497209206,6732,12179900,3845866,485029306,1,6930,3799150,6880,3791492,50,7658,3308,0,6794,56,1,125,216660.0,130000.0,-44.0,-45.0,-35.0,-47.0,-43.0,-45.0,-36.0,-46.0,-91.0,-93.0,-90.0,-93.0,47.0,48.0,55.0,46.0,1
12,92:69:1D:31:68:E9,3849905,488681307,4039,3652001,3845866,485029306,1,5364,1154705,5196,1116557,168,38148,2199,12,4288,103,1,60,229410.0,130000.0,-53.0,-47.0,-42.0,-48.0,-52.0,-47.0,-43.0,-47.0,-91.0,-93.0,-90.0,-93.0,38.0,46.0,48.0,45.0,1
13,CC:2F:71:3F:1F:24,4990462,1792496325,1144593,1307466757,3845869,485029568,1730,958309,1081844428,957485,1081744830,824,99598,926124,15,1143218,119396,1727,751,144444.0,43333.0,-69.0,-69.0,-68.0,-74.0,-69.0,-68.0,-67.0,-74.0,-91.0,-93.0,-90.0,-93.0,22.0,24.0,22.0,19.0,1
14,CC:2F:71:3E:C5:1F,3846851,485149603,980,119833,3845871,485029770,2,4244,354383,3532,269837,712,84546,1038,13,1407,28,2,54,144444.0,39000.0,-82.0,-84.0,-75.0,-71.0,-73.0,-73.0,-68.0,-61.0,-91.0,-93.0,-90.0,-93.0,9.0,9.0,15.0,22.0,1
15,BA:8C:B9:54:50:24,3850795,491222910,4923,6193078,3845872,485029832,7,9711,1748862,9689,1745367,22,3495,2358,17,5419,41,7,70,216660.0,130000.0,-51.0,-35.0,-43.0,-45.0,-44.0,-35.0,-43.0,-47.0,-91.0,-93.0,-90.0,-93.0,40.0,58.0,47.0,48.0,1
16,62:47:05:9D:EB:15,3852608,497210110,6733,12180016,3845875,485030094,1,6932,3799286,6882,3791628,50,7658,3308,0,6795,56,1,125,216660.0,130000.0,-43.0,-45.0,-35.0,-48.0,-43.0,-46.0,-36.0,-46.0,-91.0,-93.0,-90.0,-93.0,48.0,48.0,55.0,45.0,1
17,92:69:1D:31:68:E9,3849914,488682095,4039,3652001,3845875,485030094,1,5364,1154705,5196,1116557,168,38148,2199,12,4288,103,1,60,229410.0,130000.0,-53.0,-47.0,-42.0,-48.0,-52.0,-47.0,-43.0,-47.0,-91.0,-93.0,-90.0,-93.0,38.0,46.0,48.0,45.0,1
18,CC:2F:71:3F:1F:24,4990668,1792744820,1144793,1307714726,3845875,485030094,1730,958487,1082075094,957662,1081975378,825,99716,926302,15,1143418,119396,1727,751,144444.0,43333.0,-69.0,-69.0,-66.0,-74.0,-69.0,-68.0,-66.0,-74.0,-91.0,-93.0,-90.0,-93.0,22.0,24.0,24.0,19.0,1
19,CC:2F:71:3E:C5:1F,3846855,485149927,980,119833,3845875,485030094,2,4244,354383,3532,269837,712,84546,1038,13,1407,28,2,54,144444.0,39000.0,-82.0,-84.0,-75.0,-71.0,-73.0,-73.0,-68.0,-61.0,-91.0,-93.0,-90.0,-93.0,9.0,9.0,15.0,22.0,1
20,BA:8C:B9:54:50:24,3850798,491223172,4923,6193078,3845875,485030094,7,9711,1748862,9689,1745367,22,3495,2358,17,5419,41,7,70,216660.0,130000.0,-51.0,-35.0,-43.0,-45.0,-44.0,-35.0,-43.0,-47.0,-91.0,-93.0,-90.0,-93.0,40.0,58.0,47.0,48.0,1
21,62:47:05:9D:EB:15,3852612,497210645,6733,12180016,3845879,485030629,1,6932,3799286,6882,3791628,50,7658,3308,0,6795,56,1,125,216660.0,130000.0,-43.0,-45.0,-35.0,-48.0,-43.0,-46.0,-36.0,-46.0,-91.0,-93.0,-90.0,-93.0,48.0,48.0,55.0,45.0,1
22,92:69:1D:31:68:E9,3849922,488683034,4039,3652001,3845883,485031033,1,5364,1154705,5196,1116557,168,38148,2199,12,4288,103,1,60,229410.0,130000.0,-53.0,-47.0,-42.0,-48.0,-52.0,-47.0,-43.0,-47.0,-91.0,-93.0,-90.0,-93.0,38.0,46.0,48.0,45.0,1
23,CC:2F:71:3F:1F:24,4990871,1792993365,1144988,1307962332,3845883,485031033,1730,958662,1082309214,957837,1082209498,825,99716,926475,15,1143613,119399,1727,751,144444.0,43333.0,-70.0,-69.0,-67.0,-74.0,-69.0,-68.0,-66.0,-74.0,-91.0,-93.0,-90.0,-93.0,21.0,24.0,23.0,19.0,1
24,CC:2F:71:3E:C5:1F,3846863,485150866,980,119833,3845883,485031033,2,4244,354383,3532,269837,712,84546,1038,13,1407,28,2,54,144444.0,39000.0,-82.0,-84.0,-75.0,-71.0,-73.0,-73.0,-68.0,-61.0,-91.0,-93.0,-90.0,-93.0,9.0,9.0,15.0,22.0,1
25,BA:8C:B9:54:50:24,3850806,491224111,4923,6193078,3845883,485031033,7,9711,1748862,9689,1745367,22,3495,2358,17,5419,41,7,70,216660.0,130000.0,-51.0,-35.0,-43.0,-45.0,-44.0,-35.0,-43.0,-47.0,-91.0,-93.0,-90.0,-93.0,40.0,58.0,47.0,48.0,1
26,62:47:05:9D:EB:15,3852620,497211373,6733,12180016,3845887,485031357,1,6932,3799286,6882,3791628,50,7658,3308,0,6795,56,1,125,216660.0,130000.0,-43.0,-45.0,-35.0,-48.0,-43.0,-46.0,-36.0,-46.0,-91.0,-93.0,-90.0,-93.0,48.0,48.0,55.0,45.0,1
27,92:69:1D:31:68:E9,3849926,488683358,4039,3652001,3845887,485031357,1,5364,1154705,5196,1116557,168,38148,2199,12,4288,103,1,60,229410.0,130000.0,-53.0,-47.0,-42.0,-48.0,-52.0,-47.0,-43.0,-47.0,-91.0,-93.0,-90.0,-93.0,38.0,46.0,48.0,45.0,1
28,CC:2F:71:3F:1F:24,4991069,1793236879,1145182,1308205522,3845887,485031357,1730,958835,1082540372,958010,1082440656,825,99716,926646,15,1143807,119400,1727,751,144444.0,43333.0,-70.0,-69.0,-67.0,-74.0,-70.0,-69.0,-67.0,-74.0,-91.0,-93.0,-90.0,-93.0,21.0,24.0,23.0,19.0,1
29,CC:2F:71:3E:C5:1F,3846867,485151190,980,119833,3845887,485031357,2,4246,354571,3533,269907,713,84664,1039,13,1407,28,2,54,144444.0,39000.0,-73.0,-72.0,-70.0,-61.0,-73.0,-73.0,-68.0,-61.0,-91.0,-93.0,-90.0,-93.0,18.0,21.0,20.0,32.0,1
30,BA:8C:B9:54:50:24,3850811,491224495,4923,6193078,3845888,485031417,7,9711,1748862,9689,1745367,22,3495,2358,17,5419,41,7,70,216660.0,130000.0,-51.0,-35.0,-43.0,-45.0,-44.0,-35.0,-43.0,-47.0,-91.0,-93.0,-90.0,-93.0,40.0,58.0,47.0,48.0,1
31,62:47:05:9D:EB:15,3852628,497212099,6733,12180016,3845895,485032083,1,6932,3799286,6882,3791628,50,7658,3308,0,6795,56,1,125,216660.0,130000.0,-43.0,-45.0,-35.0,-48.0,-43.0,-46.0,-36.0,-46.0,-91.0,-93.0,-90.0,-93.0,48.0,48.0,55.0,45.0,1
32,92:69:1D:31:68:E9,3849934,488684084,4039,3652001,3845895,485032083,1,5364,1154705,5196,1116557,168,38148,2199,12,4288,103,1,60,229410.0,130000.0,-53.0,-47.0,-42.0,-48.0,-52.0,-47.0,-43.0,-47.0,-91.0,-93.0,-90.0,-93.0,38.0,46.0,48.0,45.0,1
33,CC:2F:71:3F:1F:24,4991270,1793483527,1145375,1308451444,3845895,485032083,1730,959007,1082769844,958182,1082670128,825,99716,926818,15,1144000,119402,1727,751,144444.0,43333.0,-70.0,-69.0,-67.0,-74.0,-70.0,-69.0,-67.0,-74.0,-91.0,-93.0,-90.0,-93.0,21.0,24.0,23.0,19.0,1
34,CC:2F:71:3E:C5:1F,3846875,485151916,980,119833,3845895,485032083,2,4246,354571,3533,269907,713,84664,1039,13,1407,28,2,54,144444.0,39000.0,-73.0,-72.0,-70.0,-61.0,-73.0,-73.0,-68.0,-61.0,-91.0,-93.0,-90.0,-93.0,18.0,21.0,20.0,32.0,1
35,BA:8C:B9:54:50:24,3850818,491225161,4923,6193078,3845895,485032083,7,9711,1748862,9689,1745367,22,3495,2358,17,5419,41,7,70,216660.0,130000.0,-51.0,-35.0,-43.0,-45.0,-44.0,-35.0,-43.0,-47.0,-91.0,-93.0,-90.0,-93.0,40.0,58.0,47.0,48.0,1
36,62:47:05:9D:EB:15,3852632,497212669,6733,12180016,3845899,485032653,1,6932,3799286,6882,3791628,50,7658,3308,0,6795,56,1,125,216660.0,130000.0,-43.0,-45.0,-35.0,-48.0,-43.0,-46.0,-36.0,-46.0,-91.0,-93.0,-90.0,-93.0,48.0,48.0,55.0,45.0,1
37,92:69:1D:31:68:E9,3849938,488684654,4039,3652001,3845899,485032653,1,5364,1154705,5196,1116557,168,38148,2199,12,4288,103,1,60,229410.0,130000.0,-53.0,-47.0,-42.0,-48.0,-52.0,-47.0,-43.0,-47.0,-91.0,-93.0,-90.0,-93.0,38.0,46.0,48.0,45.0,1
38,CC:2F:71:3F:1F:24,4991469,1793734551,1145570,1308701898,3845899,485032653,1730,959183,1083005476,958358,1082905760,825,99716,926994,15,1144195,119406,1727,751,144444.0,43333.0,-71.0,-69.0,-67.0,-74.0,-70.0,-69.0,-67.0,-74.0,-91.0,-93.0,-90.0,-93.0,20.0,24.0,23.0,19.0,1
39,CC:2F:71:3E:C5:1F,3846880,485152546,980,119833,3845900,485032713,2,4246,354571,3533,269907,713,84664,1039,13,1407,28,2,54,144444.0,39000.0,-73.0,-72.0,-70.0,-61.0,-73.0,-73.0,-68.0,-61.0,-91.0,-93.0,-90.0,-93.0,18.0,21.0,20.0,32.0,1
40,BA:8C:B9:54:50:24,3850825,491225993,4923,6193078,3845902,485032915,7,9711,1748862,9689,1745367,22,3495,2358,17,5419,41,7,70,216660.0,130000.0,-51.0,-35.0,-43.0,-45.0,-44.0,-35.0,-43.0,-47.0,-91.0,-93.0,-90.0,-93.0,40.0,58.0,47.0,48.0,1
41,62:47:05:9D:EB:15,3852638,497213193,6733,12180016,3845905,485033177,1,6932,3799286,6882,3791628,50,7658,3308,0,6795,56,1,125,216660.0,130000.0,-43.0,-45.0,-35.0,-48.0,-43.0,-46.0,-36.0,-46.0,-91.0,-93.0,-90.0,-93.0,48.0,48.0,55.0,45.0,1
42,92:69:1D:31:68:E9,3849946,488685380,4039,3652001,3845907,485033379,1,5364,1154705,5196,1116557,168,38148,2199,12,4288,103,1,60,229410.0,130000.0,-53.0,-47.0,-42.0,-48.0,-52.0,-47.0,-43.0,-47.0,-91.0,-93.0,-90.0,-93.0,38.0,46.0,48.0,45.0,1
43,CC:2F:71:3F:1F:24,4991676,1793981692,1145769,1308948313,3845907,485033379,1730,959358,1083232944,958533,1083133228,825,99716,927169,15,1144394,119406,1727,751,144444.0,43333.0,-70.0,-69.0,-67.0,-74.0,-70.0,-69.0,-67.0,-74.0,-91.0,-93.0,-90.0,-93.0,21.0,24.0,23.0,19.0,1
44,CC:2F:71:3E:C5:1F,3846887,485153212,980,119833,3845907,485033379,2,4246,354571,3533,269907,713,84664,1039,13,1407,28,2,54,144444.0,39000.0,-73.0,-72.0,-70.0,-61.0,-73.0,-73.0,-68.0,-61.0,-91.0,-93.0,-90.0,-93.0,18.0,21.0,20.0,32.0,1
45,BA:8C:B9:54:50:24,3850832,491226659,4923,6193078,3845909,485033581,7,9711,1748862,9689,1745367,22,3495,2358,17,5419,41,7,70,216660.0,130000.0,-51.0,-35.0,-43.0,-45.0,-44.0,-35.0,-43.0,-47.0,-91.0,-93.0,-90.0,-93.0,40.0,58.0,47.0,48.0,1
46,62:47:05:9D:EB:15,3852643,497213657,6733,12180016,3845910,485033641,1,6932,3799286,6882,3791628,50,7658,3308,0,6795,56,1,125,216660.0,130000.0,-43.0,-45.0,-35.0,-48.0,-43.0,-46.0,-36.0,-46.0,-91.0,-93.0,-90.0,-93.0,48.0,48.0,55.0,45.0,1
47,92:69:1D:31:68:E9,3849949,488685642,4039,3652001,3845910,485033641,1,5364,1154705,5196,1116557,168,38148,2199,12,4288,103,1,60,229410.0,130000.0,-53.0,-47.0,-42.0,-48.0,-52.0,-47.0,-43.0,-47.0,-91.0,-93.0,-90.0,-93.0,38.0,46.0,48.0,45.0,1
48,CC:2F:71:3F:1F:24,4991875,1794226784,1145963,1309192941,3845912,485033843,1730,959530,1083462416,958705,1083362700,825,99716,927341,15,1144587,119407,1727,751,144444.0,43333.0,-70.0,-69.0,-67.0,-74.0,-70.0,-69.0,-67.0,-74.0,-91.0,-93.0,-90.0,-93.0,21.0,24.0,23.0,19.0,1
49,CC:2F:71:3E:C5:1F,3846892,485153676,980,119833,3845912,485033843,2,4246,354571,3533,269907,713,84664,1039,13,1407,28,2,54,144444.0,39000.0,-73.0,-72.0,-70.0,-61.0,-73.0,-73.0,-68.0,-61.0,-91.0,-93.0,-90.0,-93.0,18.0,21.0,20.0,32.0,1
50,BA:8C:B9:54:50:24,3850835,491226921,4923,6193078,3845912,485033843,7,9711,1748862,9689,1745367,22,3495,2358,17,5419,41,7,70,216660.0,130000.0,-51.0,-35.0,-43.0,-45.0,-44.0,-35.0,-43.0,-47.0,-91.0,-93.0,-90.0,-93.0,40.0,58.0,47.0,48.0,1
51,62:47:05:9D:EB:15,3852650,497214323,6733,12180016,3845917,485034307,1,6932,3799286,6882,3791628,50,7658,3308,0,6795,56,1,125,216660.0,130000.0,-43.0,-45.0,-35.0,-48.0,-43.0,-46.0,-36.0,-46.0,-91.0,-93.0,-90.0,-93.0,48.0,48.0,55.0,45.0,1
52,92:69:1D:31:68:E9,3849956,488686308,4039,3652001,3845917,485034307,1,5364,1154705,5196,1116557,168,38148,2199,12,4288,103,1,60,229410.0,130000.0,-53.0,-47.0,-42.0,-48.0,-52.0,-47.0,-43.0,-47.0,-91.0,-93.0,-90.0,-93.0,38.0,46.0,48.0,45.0,1
53,CC:2F:71:3F:1F:24,4992070,1794469932,1146153,1309435625,3845917,485034307,1730,959702,1083691888,958877,1083592172,825,99716,927513,15,1144778,119408,1727,751,144444.0,43333.0,-70.0,-69.0,-67.0,-74.0,-70.0,-69.0,-67.0,-73.0,-91.0,-93.0,-90.0,-93.0,21.0,24.0,23.0,19.0,1
54,CC:2F:71:3E:C5:1F,3846900,485154402,980,119833,3845920,485034569,2,4246,354571,3533,269907,713,84664,1039,13,1407,28,2,54,144444.0,39000.0,-73.0,-72.0,-70.0,-61.0,-73.0,-73.0,-68.0,-61.0,-91.0,-93.0,-90.0,-93.0,18.0,21.0,20.0,32.0,1
55,BA:8C:B9:54:50:24,3850843,491227647,4923,6193078,3845920,485034569,7,9711,1748862,9689,1745367,22,3495,2358,17,5419,41,7,70,216660.0,130000.0,-51.0,-35.0,-43.0,-45.0,-44.0,-35.0,-43.0,-47.0,-91.0,-93.0,-90.0,-93.0,40.0,58.0,47.0,48.0,1
56,62:47:05:9D:EB:15,3852656,497214847,6733,12180016,3845923,485034831,1,6932,3799286,6882,3791628,50,7658,3308,0,6795,56,1,125,216660.0,130000.0,-43.0,-45.0,-35.0,-48.0,-43.0,-46.0,-36.0,-46.0,-91.0,-93.0,-90.0,-93.0,48.0,48.0,55.0,45.0,1
57,92:69:1D:31:68:E9,3849962,488686832,4039,3652001,3845923,485034831,1,5364,1154705,5196,1116557,168,38148,2199,12,4288,103,1,60,229410.0,130000.0,-53.0,-47.0,-42.0,-48.0,-52.0,-47.0,-43.0,-47.0,-91.0,-93.0,-90.0,-93.0,38.0,46.0,48.0,45.0,1
58,CC:2F:71:3F:1F:24,4992271,1794718062,1146348,1309683231,3845923,485034831,1730,959876,1083924468,959051,1083824752,825,99716,927687,15,1144973,119408,1727,751,144444.0,43333.0,-70.0,-69.0,-67.0,-73.0,-70.0,-69.0,-67.0,-73.0,-91.0,-93.0,-90.0,-93.0,21.0,24.0,23.0,20.0,1
59,CC:2F:71:3E:C5:1F,3846903,485154664,980,119833,3845923,485034831,2,4246,354571,3533,269907,713,84664,1039,13,1407,28,2,54,144444.0,39000.0,-73.0,-72.0,-70.0,-61.0,-73.0,-73.0,-68.0,-61.0,-91.0,-93.0,-90.0,-93.0,18.0,21.0,20.0,32.0,1
60,BA:8C:B9:54:50:24,3850846,491227909,4923,6193078,3845923,485034831,7,9711,1748862,9689,1745367,22,3495,2358,17,5419,41,7,70,216660.0,130000.0,-51.0,-35.0,-43.0,-45.0,-44.0,-35.0,-43.0,-47.0,-91.0,-93.0,-90.0,-93.0,40.0,58.0,47.0,48.0,1
61,62:47:05:9D:EB:15,3852660,497215251,6733,12180016,3845927,485035235,1,6933,3799354,6883,3791696,50,7658,3308,0,6795,56,1,125,216660.0,130000.0,-43.0,-46.0,-35.0,-49.0,-43.0,-46.0,-36.0,-46.0,-91.0,-93.0,-90.0,-93.0,48.0,47.0,55.0,44.0,1
62,92:69:1D:31:68:E9,3849968,488687438,4039,3652001,3845929,485035437,1,5364,1154705,5196,1116557,168,38148,2199,12,4288,103,1,60,229410.0,130000.0,-53.0,-47.0,-42.0,-48.0,-52.0,-47.0,-43.0,-47.0,-91.0,-93.0,-90.0,-93.0,38.0,46.0,48.0,45.0,1
63,CC:2F:71:3F:1F:24,4992473,1794967956,1146544,1309932519,3845929,485035437,1730,960051,1084157218,959226,1084057502,825,99716,927862,15,1145168,119410,1727,751,144444.0,43333.0,-70.0,-69.0,-67.0,-73.0,-70.0,-69.0,-67.0,-73.0,-91.0,-93.0,-90.0,-93.0,21.0,24.0,23.0,20.0,1
64,CC:2F:71:3E:C5:1F,3846910,485155330,980,119833,3845930,485035497,2,4246,354571,3533,269907,713,84664,1039,13,1407,28,2,54,144444.0,39000.0,-73.0,-72.0,-70.0,-61.0,-73.0,-73.0,-68.0,-61.0,-91.0,-93.0,-90.0,-93.0,18.0,21.0,20.0,32.0,1
65,BA:8C:B9:54:50:24,3850853,491228575,4923,6193078,3845930,485035497,7,9711,1748862,9689,1745367,22,3495,2358,17,5419,41,7,70,216660.0,130000.0,-51.0,-35.0,-43.0,-45.0,-44.0,-35.0,-43.0,-47.0,-91.0,-93.0,-90.0,-93.0,40.0,58.0,47.0,48.0,1
66,62:47:05:9D:EB:15,3852666,497215775,6733,12180016,3845933,485035759,1,6933,3799354,6883,3791696,50,7658,3308,0,6795,56,1,125,216660.0,130000.0,-43.0,-46.0,-35.0,-49.0,-43.0,-46.0,-36.0,-46.0,-91.0,-93.0,-90.0,-93.0,48.0,47.0,55.0,44.0,1
67,92:69:1D:31:68:E9,3849972,488687760,4039,3652001,3845933,485035759,1,5366,1154841,5198,1116693,168,38148,2199,12,4289,103,1,60,229410.0,130000.0,-51.0,-48.0,-44.0,-48.0,-52.0,-47.0,-43.0,-47.0,-91.0,-93.0,-90.0,-93.0,40.0,45.0,46.0,45.0,1
68,CC:2F:71:3F:1F:24,4992682,1795223905,1146749,1310188146,3845933,485035759,1730,960241,1084400799,959416,1084301083,825,99716,928048,15,1145374,119420,1727,751,144444.0,43333.0,-69.0,-69.0,-67.0,-73.0,-69.0,-69.0,-66.0,-72.0,-91.0,-93.0,-90.0,-93.0,22.0,24.0,23.0,20.0,1
69,CC:2F:71:3E:C5:1F,3846913,485155592,980,119833,3845933,485035759,2,4248,354711,3535,270047,713,84664,1039,13,1408,28,2,54,144444.0,39000.0,-72.0,-73.0,-70.0,-61.0,-73.0,-73.0,-68.0,-62.0,-91.0,-93.0,-90.0,-93.0,19.0,20.0,20.0,32.0,1
70,BA:8C:B9:54:50:24,3850856,491228837,4923,6193078,3845933,485035759,7,9716,1749202,9694,1745707,22,3495,2358,17,5420,41,7,70,216660.0,130000.0,-48.0,-35.0,-43.0,-45.0,-44.0,-35.0,-43.0,-48.0,-91.0,-93.0,-90.0,-93.0,43.0,58.0,47.0,48.0,1
71,62:47:05:9D:EB:15,3852673,497216441,6733,12180016,3845940,485036425,1,6933,3799354,6883,3791696,50,7658,3308,0,6795,56,1,125,216660.0,130000.0,-43.0,-46.0,-35.0,-49.0,-43.0,-46.0,-36.0,-46.0,-90.0,-93.0,-90.0,-93.0,47.0,47.0,55.0,44.0,1
72,92:69:1D:31:68:E9,3849979,488688426,4039,3652001,3845940,485036425,1,5366,1154841,5198,1116693,168,38148,2199,12,4289,103,1,60,229410.0,130000.0,-51.0,-48.0,-44.0,-48.0,-52.0,-47.0,-43.0,-47.0,-90.0,-93.0,-90.0,-93.0,39.0,45.0,46.0,45.0,1
73,CC:2F:71:3F:1F:24,4992882,1795469013,1146942,1310432588,3845940,485036425,1730,960414,1084631811,959589,1084532095,825,99716,928221,15,1145567,119467,1727,751,130000.0,43333.0,-70.0,-68.0,-66.0,-75.0,-69.0,-68.0,-66.0,-74.0,-90.0,-93.0,-90.0,-93.0,20.0,25.0,24.0,18.0,1
74,CC:2F:71:3E:C5:1F,3846920,485156258,980,119833,3845940,485036425,2,4248,354711,3535,270047,713,84664,1039,13,1408,28,2,54,144444.0,39000.0,-72.0,-73.0,-70.0,-61.0,-73.0,-73.0,-68.0,-62.0,-90.0,-93.0,-90.0,-93.0,18.0,20.0,20.0,32.0,1
75,BA:8C:B9:54:50:24,3850863,491229503,4923,6193078,3845940,485036425,7,9716,1749202,9694,1745707,22,3495,2358,17,5420,41,7,70,216660.0,130000.0,-48.0,-35.0,-43.0,-45.0,-44.0,-35.0,-43.0,-48.0,-90.0,-93.0,-90.0,-93.0,42.0,58.0,47.0,48.0,1
76,62:47:05:9D:EB:15,3852677,497216763,6733,12180016,3845944,485036747,1,6933,3799354,6883,3791696,50,7658,3308,0,6795,56,1,125,216660.0,130000.0,-43.0,-46.0,-35.0,-49.0,-43.0,-46.0,-36.0,-46.0,-90.0,-93.0,-90.0,-93.0,47.0,47.0,55.0,44.0,1
77,92:69:1D:31:68:E9,3849983,488688748,4039,3652001,3845944,485036747,1,5366,1154841,5198,1116693,168,38148,2199,12,4289,103,1,60,229410.0,130000.0,-51.0,-48.0,-44.0,-48.0,-52.0,-47.0,-43.0,-47.0,-90.0,-93.0,-90.0,-93.0,39.0,45.0,46.0,45.0,1
78,CC:2F:71:3F:1F:24,4993097,1795738917,1147153,1310702170,3845944,485036747,1730,960606,1084886651,959781,1084786935,825,99716,928413,15,1145778,119475,1727,753,144444.0,43333.0,-70.0,-69.0,-67.0,-74.0,-70.0,-68.0,-66.0,-73.0,-90.0,-93.0,-90.0,-93.0,20.0,24.0,23.0,19.0,1
79,CC:2F:71:3E:C5:1F,3846924,485156580,980,119833,3845944,485036747,2,4248,354711,3535,270047,713,84664,1039,13,1408,28,2,54,144444.0,39000.0,-72.0,-73.0,-70.0,-61.0,-73.0,-73.0,-68.0,-62.0,-90.0,-93.0,-90.0,-93.0,18.0,20.0,20.0,32.0,1
80,BA:8C:B9:54:50:24,3850869,491230027,4923,6193078,3845946,485036949,7,9717,1749270,9695,1745775,22,3495,2358,17,5420,41,7,70,216660.0,130000.0,-48.0,-35.0,-42.0,-45.0,-44.0,-35.0,-43.0,-48.0,-90.0,-93.0,-90.0,-93.0,42.0,58.0,48.0,48.0,1
81,62:47:05:9D:EB:15,3852684,497217429,6733,12180016,3845951,485037413,1,6933,3799354,6883,3791696,50,7658,3308,0,6795,56,1,125,216660.0,130000.0,-43.0,-46.0,-35.0,-49.0,-43.0,-46.0,-36.0,-46.0,-90.0,-93.0,-90.0,-93.0,47.0,47.0,55.0,44.0,1
82,92:69:1D:31:68:E9,3849990,488689414,4039,3652001,3845951,485037413,1,5366,1154841,5198,1116693,168,38148,2199,12,4289,103,1,60,229410.0,130000.0,-51.0,-48.0,-44.0,-48.0,-52.0,-47.0,-43.0,-47.0,-90.0,-93.0,-90.0,-93.0,39.0,45.0,46.0,45.0,1
83,CC:2F:71:3F:1F:24,4993299,1795985852,1147347,1310948166,3845952,485037686,1730,960778,1085116123,959953,1085016407,825,99716,928585,15,1145972,119486,1727,753,130000.0,43333.0,-70.0,-69.0,-68.0,-73.0,-70.0,-68.0,-68.0,-72.0,-90.0,-93.0,-90.0,-93.0,20.0,24.0,22.0,20.0,1
84,CC:2F:71:3E:C5:1F,3846932,485157519,980,119833,3845952,485037686,2,4248,354711,3535,270047,713,84664,1039,13,1408,28,2,54,144444.0,39000.0,-72.0,-73.0,-70.0,-61.0,-73.0,-73.0,-68.0,-62.0,-90.0,-93.0,-90.0,-93.0,18.0,20.0,20.0,32.0,1
85,BA:8C:B9:54:50:24,3850875,491230764,4923,6193078,3845952,485037686,7,9717,1749270,9695,1745775,22,3495,2358,17,5420,41,7,70,216660.0,130000.0,-48.0,-35.0,-42.0,-45.0,-44.0,-35.0,-43.0,-48.0,-90.0,-93.0,-90.0,-93.0,42.0,58.0,48.0,48.0,1
86,62:47:05:9D:EB:15,3852687,497217904,6733,12180016,3845954,485037888,1,6933,3799354,6883,3791696,50,7658,3308,0,6795,56,1,125,216660.0,130000.0,-43.0,-46.0,-35.0,-49.0,-43.0,-46.0,-36.0,-46.0,-90.0,-93.0,-90.0,-93.0,47.0,47.0,55.0,44.0,1
87,92:69:1D:31:68:E9,3849993,488689889,4039,3652001,3845954,485037888,1,5366,1154841,5198,1116693,168,38148,2199,12,4289,103,1,60,229410.0,130000.0,-51.0,-48.0,-44.0,-48.0,-52.0,-47.0,-43.0,-47.0,-90.0,-93.0,-90.0,-93.0,39.0,45.0,46.0,45.0,1
88,CC:2F:71:3F:1F:24,4993489,1796225630,1147535,1311187742,3845954,485037888,1730,960946,1085342283,960121,1085242567,825,99716,928753,15,1146160,119486,1727,753,130000.0,43333.0,-71.0,-69.0,-67.0,-72.0,-71.0,-69.0,-67.0,-72.0,-90.0,-93.0,-90.0,-93.0,19.0,24.0,23.0,21.0,1
89,CC:2F:71:3E:C5:1F,3846935,485157781,980,119833,3845955,485037948,2,4248,354711,3535,270047,713,84664,1039,13,1408,28,2,54,144444.0,39000.0,-72.0,-73.0,-70.0,-61.0,-73.0,-73.0,-68.0,-62.0,-90.0,-93.0,-90.0,-93.0,18.0,20.0,20.0,32.0,1
90,BA:8C:B9:54:50:24,3850880,491231228,4923,6193078,3845957,485038150,7,9717,1749270,9695,1745775,22,3495,2358,17,5420,41,7,70,216660.0,130000.0,-48.0,-35.0,-42.0,-45.0,-44.0,-35.0,-43.0,-48.0,-90.0,-93.0,-90.0,-93.0,42.0,58.0,48.0,48.0,1
91,62:47:05:9D:EB:15,3852695,497218630,6733,12180016,3845962,485038614,1,6933,3799354,6883,3791696,50,7658,3308,0,6795,56,1,125,216660.0,130000.0,-43.0,-46.0,-35.0,-49.0,-43.0,-46.0,-36.0,-46.0,-90.0,-93.0,-90.0,-93.0,47.0,47.0,55.0,44.0,1
92,92:69:1D:31:68:E9,3850001,488690615,4039,3652001,3845962,485038614,1,5366,1154841,5198,1116693,168,38148,2199,12,4289,103,1,60,229410.0,130000.0,-51.0,-48.0,-44.0,-48.0,-52.0,-47.0,-43.0,-47.0,-90.0,-93.0,-90.0,-93.0,39.0,45.0,46.0,45.0,1
93,CC:2F:71:3F:1F:24,4993695,1796473897,1147733,1311435283,3845962,485038614,1730,961124,1085572975,960299,1085473259,825,99716,928931,15,1146358,119486,1727,753,144444.0,43333.0,-70.0,-68.0,-68.0,-73.0,-70.0,-68.0,-68.0,-72.0,-90.0,-93.0,-90.0,-93.0,20.0,25.0,22.0,20.0,1
94,CC:2F:71:3E:C5:1F,3846942,485158447,980,119833,3845962,485038614,2,4248,354711,3535,270047,713,84664,1039,13,1408,28,2,54,144444.0,39000.0,-72.0,-73.0,-70.0,-61.0,-73.0,-73.0,-68.0,-62.0,-90.0,-93.0,-90.0,-93.0,18.0,20.0,20.0,32.0,1
95,BA:8C:B9:54:50:24,3850885,491231692,4923,6193078,3845962,485038614,7,9717,1749270,9695,1745775,22,3495,2358,17,5420,41,7,70,216660.0,130000.0,-48.0,-35.0,-42.0,-45.0,-44.0,-35.0,-43.0,-48.0,-90.0,-93.0,-90.0,-93.0,42.0,58.0,48.0,48.0,1
96,62:47:05:9D:EB:15,3852698,497218892,6733,12180016,3845965,485038876,1,6933,3799354,6883,3791696,50,7658,3308,0,6795,56,1,125,216660.0,130000.0,-43.0,-46.0,-35.0,-49.0,-43.0,-46.0,-36.0,-46.0,-90.0,-93.0,-90.0,-93.0,47.0,47.0,55.0,44.0,1
97,92:69:1D:31:68:E9,3850004,488690877,4039,3652001,3845965,485038876,1,5366,1154841,5198,1116693,168,38148,2199,12,4289,103,1,60,229410.0,130000.0,-51.0,-48.0,-44.0,-48.0,-52.0,-47.0,-43.0,-47.0,-90.0,-93.0,-90.0,-93.0,39.0,45.0,46.0,45.0,1
98,CC:2F:71:3F:1F:24,4993887,1796715289,1147922,1311676413,3845965,485038876,1730,961291,1085796241,960466,1085696525,825,99716,929098,15,1146546,119487,1727,753,144444.0,43333.0,-71.0,-68.0,-69.0,-74.0,-71.0,-68.0,-68.0,-74.0,-90.0,-93.0,-90.0,-93.0,19.0,25.0,21.0,19.0,1
99,CC:2F:71:3E:C5:1F,3846947,485158911,980,119833,3845967,485039078,2,4248,354711,3535,270047,713,84664,1039,13,1408,28,2,54,144444.0,39000.0,-72.0,-73.0,-70.0,-61.0,-73.0,-73.0,-68.0,-62.0,-90.0,-93.0,-90.0,-93.0,18.0,20.0,20.0,32.0,1
100,BA:8C:B9:54:50:24,3850890,491232156,4923,6193078,3845967,485039078,7,9717,1749270,9695,1745775,22,3495,2358,17,5420,41,7,70,216660.0,130000.0,-48.0,-35.0,-42.0,-45.0,-44.0,-35.0,-43.0,-48.0,-90.0,-93.0,-90.0,-93.0,42.0,58.0,48.0,48.0,1
101,62:47:05:9D:EB:15,3852706,497219618,6733,12180016,3845973,485039602,1,6933,3799354,6883,3791696,50,7658,3308,0,6795,56,1,125,216660.0,130000.0,-43.0,-46.0,-35.0,-49.0,-43.0,-46.0,-36.0,-46.0,-90.0,-93.0,-90.0,-93.0,47.0,47.0,55.0,44.0,1
102,92:69:1D:31:68:E9,3850012,488691603,4039,3652001,3845973,485039602,1,5366,1154841,5198,1116693,168,38148,2199,12,4289,103,1,60,229410.0,130000.0,-51.0,-48.0,-44.0,-48.0,-52.0,-47.0,-43.0,-47.0,-90.0,-93.0,-90.0,-93.0,39.0,45.0,46.0,45.0,1
103,CC:2F:71:3F:1F:24,4994084,1796957145,1148111,1311917543,3845973,485039602,1730,961461,1086025509,960636,1085925793,825,99716,929268,15,1146736,119487,1727,753,144444.0,43333.0,-71.0,-68.0,-69.0,-74.0,-71.0,-68.0,-68.0,-74.0,-90.0,-93.0,-90.0,-93.0,19.0,25.0,21.0,19.0,1
104,CC:2F:71:3E:C5:1F,3846955,485159637,980,119833,3845975,485039804,2,4248,354711,3535,270047,713,84664,1039,13,1408,28,2,54,144444.0,39000.0,-72.0,-73.0,-70.0,-61.0,-73.0,-73.0,-68.0,-62.0,-90.0,-93.0,-90.0,-93.0,18.0,20.0,20.0,32.0,1
105,BA:8C:B9:54:50:24,3850898,491232882,4923,6193078,3845975,485039804,7,9717,1749270,9695,1745775,22,3495,2358,17,5420,41,7,70,216660.0,130000.0,-48.0,-35.0,-42.0,-45.0,-44.0,-35.0,-43.0,-48.0,-90.0,-93.0,-90.0,-93.0,42.0,58.0,48.0,48.0,1
106,62:47:05:9D:EB:15,3852708,497219820,6733,12180016,3845975,485039804,1,6933,3799354,6883,3791696,50,7658,3308,0,6795,56,1,125,216660.0,130000.0,-43.0,-46.0,-35.0,-49.0,-43.0,-46.0,-36.0,-46.0,-90.0,-93.0,-90.0,-93.0,47.0,47.0,55.0,44.0,1
107,92:69:1D:31:68:E9,3850017,488692067,4039,3652001,3845978,485040066,1,5366,1154841,5198,1116693,168,38148,2199,12,4289,103,1,60,229410.0,130000.0,-51.0,-48.0,-44.0,-48.0,-52.0,-47.0,-43.0,-47.0,-90.0,-93.0,-90.0,-93.0,39.0,45.0,46.0,45.0,1
108,CC:2F:71:3F:1F:24,4994278,1797198739,1148300,1312158673,3845978,485040066,1730,961631,1086253367,960806,1086153651,825,99716,929437,15,1146925,119488,1727,754,144444.0,43333.0,-71.0,-69.0,-69.0,-74.0,-71.0,-68.0,-69.0,-74.0,-90.0,-93.0,-90.0,-93.0,19.0,24.0,21.0,19.0,1
109,CC:2F:71:3E:C5:1F,3846958,485159899,980,119833,3845978,485040066,2,4248,354711,3535,270047,713,84664,1039,13,1408,28,2,54,144444.0,39000.0,-72.0,-73.0,-70.0,-61.0,-73.0,-73.0,-68.0,-62.0,-90.0,-93.0,-90.0,-93.0,18.0,20.0,20.0,32.0,1
110,BA:8C:B9:54:50:24,3850901,491233144,4923,6193078,3845978,485040066,7,9717,1749270,9695,1745775,22,3495,2358,17,5420,41,7,70,216660.0,130000.0,-48.0,-35.0,-42.0,-45.0,-44.0,-35.0,-43.0,-48.0,-90.0,-93.0,-90.0,-93.0,42.0,58.0,48.0,48.0,1
111,62:47:05:9D:EB:15,3852715,497220486,6733,12180016,3845982,485040470,1,6933,3799354,6883,3791696,50,7658,3308,0,6795,56,1,125,216660.0,130000.0,-43.0,-46.0,-35.0,-49.0,-43.0,-46.0,-36.0,-46.0,-90.0,-93.0,-90.0,-93.0,47.0,47.0,55.0,44.0,1
112,92:69:1D:31:68:E9,3850021,488692471,4039,3652001,3845982,485040470,1,5366,1154841,5198,1116693,168,38148,2199,12,4289,103,1,60,229410.0,130000.0,-51.0,-48.0,-44.0,-48.0,-52.0,-47.0,-43.0,-47.0,-90.0,-93.0,-90.0,-93.0,39.0,45.0,46.0,45.0,1
113,CC:2F:71:3F:1F:24,4994475,1797443583,1148491,1312402911,3845984,485040672,1730,961803,1086482839,960978,1086383123,825,99716,929609,15,1147115,119489,1727,754,144444.0,43333.0,-71.0,-68.0,-69.0,-74.0,-71.0,-68.0,-68.0,-74.0,-90.0,-93.0,-90.0,-93.0,19.0,25.0,21.0,19.0,1
114,CC:2F:71:3E:C5:1F,3846964,485160505,980,119833,3845984,485040672,2,4248,354711,3535,270047,713,84664,1039,13,1408,28,2,54,144444.0,39000.0,-72.0,-73.0,-70.0,-61.0,-73.0,-73.0,-68.0,-62.0,-90.0,-93.0,-90.0,-93.0,18.0,20.0,20.0,32.0,1
115,BA:8C:B9:54:50:24,3850907,491233750,4923,6193078,3845984,485040672,7,9717,1749270,9695,1745775,22,3495,2358,17,5420,41,7,70,216660.0,130000.0,-48.0,-35.0,-42.0,-45.0,-44.0,-35.0,-43.0,-48.0,-90.0,-93.0,-90.0,-93.0,42.0,58.0,48.0,48.0,1
116,62:47:05:9D:EB:15,3852721,497221010,6733,12180016,3845988,485040994,1,6933,3799354,6883,3791696,50,7658,3308,0,6795,56,1,125,216660.0,130000.0,-43.0,-46.0,-35.0,-49.0,-43.0,-46.0,-36.0,-46.0,-90.0,-93.0,-90.0,-93.0,47.0,47.0,55.0,44.0,1
117,92:69:1D:31:68:E9,3850027,488692995,4039,3652001,3845988,485040994,1,5366,1154841,5198,1116693,168,38148,2199,12,4289,103,1,60,229410.0,130000.0,-51.0,-48.0,-44.0,-48.0,-52.0,-47.0,-43.0,-47.0,-90.0,-93.0,-90.0,-93.0,39.0,45.0,46.0,45.0,1
118,CC:2F:71:3F:1F:24,4994674,1797685514,1148686,1312644520,3845988,485040994,1730,961977,1086707334,961152,1086607618,825,99716,929783,15,1147311,119490,1727,754,144444.0,43333.0,-71.0,-68.0,-69.0,-74.0,-70.0,-68.0,-68.0,-74.0,-90.0,-93.0,-90.0,-93.0,19.0,25.0,21.0,19.0,1
119,CC:2F:71:3E:C5:1F,3846968,485160827,980,119833,3845988,485040994,2,4248,354711,3535,270047,713,84664,1039,13,1408,28,2,54,144444.0,39000.0,-72.0,-73.0,-70.0,-61.0,-73.0,-73.0,-68.0,-62.0,-90.0,-93.0,-90.0,-93.0,18.0,20.0,20.0,32.0,1
120,BA:8C:B9:54:50:24,3850911,491234072,4923,6193078,3845988,485040994,7,9717,1749270,9695,1745775,22,3495,2358,17,5420,41,7,70,216660.0,130000.0,-48.0,-35.0,-42.0,-45.0,-44.0,-35.0,-43.0,-48.0,-90.0,-93.0,-90.0,-93.0,42.0,58.0,48.0,48.0,1
121,62:47:05:9D:EB:15,3852728,497221676,6733,12180016,3845995,485041660,1,6933,3799354,6883,3791696,50,7658,3308,0,6795,56,1,125,216660.0,130000.0,-43.0,-46.0,-35.0,-49.0,-43.0,-46.0,-36.0,-46.0,-90.0,-93.0,-90.0,-93.0,47.0,47.0,55.0,44.0,1
122,92:69:1D:31:68:E9,3850034,488693661,4039,3652001,3845995,485041660,1,5366,1154841,5198,1116693,168,38148,2199,12,4289,103,1,60,229410.0,130000.0,-51.0,-48.0,-44.0,-48.0,-52.0,-47.0,-43.0,-47.0,-90.0,-93.0,-90.0,-93.0,39.0,45.0,46.0,45.0,1
123,CC:2F:71:3F:1F:24,4994872,1797930418,1148877,1312888758,3845995,485041660,1730,962151,1086938532,961326,1086838816,825,99716,929956,15,1147502,119491,1727,754,144444.0,43333.0,-71.0,-68.0,-68.0,-74.0,-70.0,-68.0,-68.0,-74.0,-90.0,-93.0,-90.0,-93.0,19.0,25.0,22.0,19.0,1
124,CC:2F:71:3E:C5:1F,3846975,485161493,980,119833,3845995,485041660,2,4248,354711,3535,270047,713,84664,1039,13,1408,28,2,54,144444.0,39000.0,-72.0,-73.0,-70.0,-61.0,-73.0,-73.0,-68.0,-62.0,-90.0,-93.0,-90.0,-93.0,18.0,20.0,20.0,32.0,1
125,BA:8C:B9:54:50:24,3850918,491234738,4923,6193078,3845995,485041660,7,9717,1749270,9695,1745775,22,3495,2358,17,5420,41,7,70,216660.0,130000.0,-48.0,-35.0,-42.0,-45.0,-44.0,-35.0,-43.0,-48.0,-90.0,-93.0,-90.0,-93.0,42.0,58.0,48.0,48.0,1
126,62:47:05:9D:EB:15,3852731,497221938,6733,12180016,3845998,485041922,1,6933,3799354,6883,3791696,50,7658,3308,0,6795,56,1,125,216660.0,130000.0,-43.0,-46.0,-35.0,-49.0,-43.0,-46.0,-36.0,-46.0,-90.0,-93.0,-90.0,-93.0,47.0,47.0,55.0,44.0,1
127,92:69:1D:31:68:E9,3850038,488693983,4039,3652001,3845999,485041982,1,5366,1154841,5198,1116693,168,38148,2199,12,4289,103,1,60,229410.0,130000.0,-51.0,-48.0,-44.0,-48.0,-52.0,-47.0,-43.0,-47.0,-90.0,-93.0,-90.0,-93.0,39.0,45.0,46.0,45.0,1
128,CC:2F:71:3F:1F:24,4995065,1798171870,1149066,1313129888,3845999,485041982,1730,962320,1087166246,961495,1087066530,825,99716,930124,15,1147691,119491,1727,754,144444.0,43333.0,-71.0,-69.0,-68.0,-74.0,-71.0,-68.0,-68.0,-74.0,-90.0,-93.0,-90.0,-93.0,19.0,24.0,22.0,19.0,1
129,CC:2F:71:3E:C5:1F,3846979,485161815,980,119833,3845999,485041982,2,4248,354711,3535,270047,713,84664,1039,13,1408,28,2,54,144444.0,39000.0,-72.0,-73.0,-70.0,-61.0,-73.0,-73.0,-68.0,-62.0,-90.0,-93.0,-90.0,-93.0,18.0,20.0,20.0,32.0,1
130,BA:8C:B9:54:50:24,3850924,491235262,4923,6193078,3846001,485042184,7,9717,1749270,9695,1745775,22,3495,2358,17,5420,41,7,70,216660.0,130000.0,-48.0,-35.0,-42.0,-45.0,-44.0,-35.0,-43.0,-48.0,-90.0,-93.0,-90.0,-93.0,42.0,58.0,48.0,48.0,1
131,62:47:05:9D:EB:15,3852738,497222604,6733,12180016,3846005,485042588,1,6933,3799354,6883,3791696,50,7658,3308,0,6795,56,1,125,216660.0,130000.0,-43.0,-46.0,-35.0,-49.0,-43.0,-46.0,-36.0,-46.0,-90.0,-93.0,-90.0,-93.0,47.0,47.0,55.0,44.0,1
132,92:69:1D:31:68:E9,3850045,488694705,4040,3652117,3846005,485042588,1,5368,1154977,5200,1116829,168,38148,2199,12,4290,103,1,60,229410.0,130000.0,-51.0,-48.0,-43.0,-47.0,-51.0,-48.0,-43.0,-47.0,-90.0,-93.0,-90.0,-93.0,39.0,45.0,47.0,46.0,1
133,CC:2F:71:3F:1F:24,4995263,1798413914,1149257,1313371266,3846006,485042648,1730,962489,1087392512,961664,1087292796,825,99716,930293,15,1147882,119492,1727,754,144444.0,43333.0,-71.0,-69.0,-68.0,-75.0,-70.0,-68.0,-68.0,-74.0,-90.0,-93.0,-90.0,-93.0,19.0,24.0,22.0,18.0,1
134,CC:2F:71:3E:C5:1F,3846987,485162597,981,119949,3846006,485042648,2,4250,354851,3537,270187,713,84664,1039,13,1409,28,2,54,144444.0,39000.0,-72.0,-73.0,-70.0,-61.0,-73.0,-73.0,-70.0,-62.0,-90.0,-93.0,-90.0,-93.0,18.0,20.0,20.0,32.0,1
135,BA:8C:B9:54:50:24,3850930,491235842,4924,6193194,3846006,485042648,7,9719,1749406,9697,1745911,22,3495,2358,17,5421,41,7,70,216660.0,130000.0,-49.0,-35.0,-42.0,-46.0,-43.0,-35.0,-43.0,-48.0,-90.0,-93.0,-90.0,-93.0,41.0,58.0,48.0,47.0,1
136,62:47:05:9D:EB:15,3852742,497222982,6734,12180132,3846008,485042850,1,6935,3799490,6885,3791832,50,7658,3308,0,6796,56,1,125,216660.0,130000.0,-43.0,-44.0,-35.0,-48.0,-43.0,-45.0,-35.0,-47.0,-90.0,-93.0,-90.0,-93.0,47.0,49.0,55.0,45.0,1
137,92:69:1D:31:68:E9,3850048,488694967,4040,3652117,3846008,485042850,1,5368,1154977,5200,1116829,168,38148,2199,12,4290,103,1,60,229410.0,130000.0,-51.0,-48.0,-43.0,-47.0,-51.0,-48.0,-43.0,-47.0,-90.0,-93.0,-90.0,-93.0,39.0,45.0,47.0,46.0,1
138,CC:2F:71:3F:1F:24,4995456,1798655448,1149446,1313612396,3846010,485043052,1730,962657,1087618672,961832,1087518956,825,99716,930461,15,1148071,119493,1727,754,144444.0,43333.0,-70.0,-68.0,-68.0,-72.0,-70.0,-68.0,-68.0,-72.0,-90.0,-93.0,-90.0,-93.0,20.0,25.0,22.0,21.0,1
139,CC:2F:71:3E:C5:1F,3846991,485163001,981,119949,3846010,485043052,2,4250,354851,3537,270187,713,84664,1039,13,1409,28,2,54,144444.0,39000.0,-72.0,-73.0,-70.0,-61.0,-73.0,-73.0,-70.0,-62.0,-90.0,-93.0,-90.0,-93.0,18.0,20.0,20.0,32.0,1
140,BA:8C:B9:54:50:24,3850935,491236308,4924,6193194,3846011,485043114,7,9719,1749406,9697,1745911,22,3495,2358,17,5421,41,7,70,216660.0,130000.0,-49.0,-35.0,-42.0,-46.0,-43.0,-35.0,-43.0,-48.0,-90.0,-93.0,-90.0,-93.0,41.0,58.0,48.0,47.0,1
141,62:47:05:9D:EB:15,3852751,497223770,6734,12180132,3846017,485043638,1,6935,3799490,6885,3791832,50,7658,3308,0,6796,56,1,125,216660.0,130000.0,-43.0,-44.0,-35.0,-48.0,-43.0,-45.0,-35.0,-47.0,-90.0,-93.0,-90.0,-93.0,47.0,49.0,55.0,45.0,1
142,92:69:1D:31:68:E9,3850057,488695755,4040,3652117,3846017,485043638,1,5368,1154977,5200,1116829,168,38148,2199,12,4290,103,1,60,229410.0,130000.0,-51.0,-48.0,-43.0,-47.0,-51.0,-48.0,-43.0,-47.0,-90.0,-93.0,-90.0,-93.0,39.0,45.0,47.0,46.0,1
143,CC:2F:71:3F:1F:24,4995661,1798900895,1149644,1313857257,3846017,485043638,1730,962836,1087846606,962010,1087746772,826,99834,930640,15,1148268,119496,1727,754,144444.0,43333.0,-70.0,-69.0,-67.0,-73.0,-69.0,-69.0,-67.0,-73.0,-90.0,-93.0,-90.0,-93.0,20.0,24.0,23.0,20.0,1
144,CC:2F:71:3E:C5:1F,3846998,485163587,981,119949,3846017,485043638,2,4250,354851,3537,270187,713,84664,1039,13,1409,28,2,54,144444.0,39000.0,-72.0,-73.0,-70.0,-61.0,-73.0,-73.0,-70.0,-62.0,-90.0,-93.0,-90.0,-93.0,18.0,20.0,20.0,32.0,1
145,BA:8C:B9:54:50:24,3850941,491236832,4924,6193194,3846017,485043638,7,9719,1749406,9697,1745911,22,3495,2358,17,5421,41,7,70,216660.0,130000.0,-49.0,-35.0,-42.0,-46.0,-43.0,-35.0,-43.0,-48.0,-90.0,-93.0,-90.0,-93.0,41.0,58.0,48.0,47.0,1
146,62:47:05:9D:EB:15,3852755,497224305,6734,12180132,3846021,485044173,1,6935,3799490,6885,3791832,50,7658,3308,0,6796,56,1,125,216660.0,130000.0,-43.0,-44.0,-35.0,-48.0,-43.0,-45.0,-35.0,-47.0,-90.0,-93.0,-90.0,-93.0,47.0,49.0,55.0,45.0,1
147,92:69:1D:31:68:E9,3850063,488696492,4040,3652117,3846023,485044375,1,5368,1154977,5200,1116829,168,38148,2199,12,4290,103,1,60,229410.0,130000.0,-51.0,-48.0,-43.0,-47.0,-51.0,-48.0,-43.0,-47.0,-90.0,-93.0,-90.0,-93.0,39.0,45.0,47.0,46.0,1
148,CC:2F:71:3F:1F:24,4995859,1799143152,1149836,1314098777,3846023,485044375,1730,963006,1088071630,962180,1087971796,826,99834,930810,15,1148461,119518,1727,754,144444.0,43333.0,-70.0,-69.0,-68.0,-73.0,-69.0,-68.0,-68.0,-72.0,-90.0,-93.0,-90.0,-93.0,20.0,24.0,22.0,20.0,1
149,CC:2F:71:3E:C5:1F,3847004,485164324,981,119949,3846023,485044375,2,4250,354851,3537,270187,713,84664,1039,13,1409,28,2,54,144444.0,39000.0,-72.0,-73.0,-70.0,-61.0,-73.0,-73.0,-70.0,-62.0,-90.0,-93.0,-90.0,-93.0,18.0,20.0,20.0,32.0,1
150,BA:8C:B9:54:50:24,3850947,491237569,4924,6193194,3846023,485044375,7,9719,1749406,9697,1745911,22,3495,2358,17,5421,41,7,70,216660.0,130000.0,-49.0,-35.0,-42.0,-46.0,-43.0,-35.0,-43.0,-48.0,-90.0,-93.0,-90.0,-93.0,41.0,58.0,48.0,47.0,1
151,62:47:05:9D:EB:15,3852763,497225031,6734,12180132,3846029,485044899,1,6935,3799490,6885,3791832,50,7658,3308,0,6796,56,1,125,216660.0,130000.0,-43.0,-44.0,-35.0,-48.0,-43.0,-45.0,-35.0,-47.0,-90.0,-93.0,-90.0,-93.0,47.0,49.0,55.0,45.0,1
152,92:69:1D:31:68:E9,3850069,488697016,4040,3652117,3846029,485044899,1,5368,1154977,5200,1116829,168,38148,2199,12,4290,103,1,60,229410.0,130000.0,-51.0,-48.0,-43.0,-47.0,-51.0,-48.0,-43.0,-47.0,-90.0,-93.0,-90.0,-93.0,39.0,45.0,47.0,46.0,1
153,CC:2F:71:3F:1F:24,4996059,1799388248,1150030,1314343349,3846029,485044899,1730,963181,1088304368,962355,1088204534,826,99834,930984,15,1148655,119551,1727,754,130000.0,43333.0,-70.0,-68.0,-68.0,-72.0,-70.0,-68.0,-68.0,-72.0,-90.0,-93.0,-90.0,-93.0,20.0,25.0,22.0,21.0,1
154,CC:2F:71:3E:C5:1F,3847010,485164848,981,119949,3846029,485044899,2,4250,354851,3537,270187,713,84664,1039,13,1409,28,2,54,144444.0,39000.0,-72.0,-73.0,-70.0,-61.0,-73.0,-73.0,-70.0,-62.0,-90.0,-93.0,-90.0,-93.0,18.0,20.0,20.0,32.0,1
155,BA:8C:B9:54:50:24,3850953,491238093,4924,6193194,3846029,485044899,7,9719,1749406,9697,1745911,22,3495,2358,17,5421,41,7,70,216660.0,130000.0,-49.0,-35.0,-42.0,-46.0,-43.0,-35.0,-43.0,-48.0,-90.0,-93.0,-90.0,-93.0,41.0,58.0,48.0,47.0,1
156,62:47:05:9D:EB:15,3852767,497225435,6734,12180132,3846033,485045303,1,6935,3799490,6885,3791832,50,7658,3308,0,6796,56,1,125,216660.0,130000.0,-43.0,-44.0,-35.0,-48.0,-43.0,-45.0,-35.0,-47.0,-90.0,-93.0,-90.0,-93.0,47.0,49.0,55.0,45.0,1
157,92:69:1D:31:68:E9,3850073,488697420,4040,3652117,3846033,485045303,1,5368,1154977,5200,1116829,168,38148,2199,12,4290,103,1,60,229410.0,130000.0,-51.0,-48.0,-43.0,-47.0,-51.0,-48.0,-43.0,-47.0,-90.0,-93.0,-90.0,-93.0,39.0,45.0,47.0,46.0,1
158,CC:2F:71:3F:1F:24,4996254,1799630081,1150221,1314584778,3846033,485045303,1730,963357,1088532933,962531,1088433099,826,99834,931159,15,1148845,119551,1727,754,130000.0,43333.0,-70.0,-68.0,-69.0,-72.0,-70.0,-68.0,-68.0,-71.0,-90.0,-93.0,-90.0,-93.0,20.0,25.0,21.0,21.0,1
159,CC:2F:71:3E:C5:1F,3847014,485165252,981,119949,3846033,485045303,2,4250,354851,3537,270187,713,84664,1039,13,1409,28,2,54,144444.0,39000.0,-72.0,-73.0,-70.0,-61.0,-73.0,-73.0,-70.0,-62.0,-90.0,-93.0,-90.0,-93.0,18.0,20.0,20.0,32.0,1
160,BA:8C:B9:54:50:24,3850960,491238759,4924,6193194,3846036,485045565,7,9719,1749406,9697,1745911,22,3495,2358,17,5421,41,7,70,216660.0,130000.0,-49.0,-35.0,-42.0,-46.0,-43.0,-35.0,-43.0,-48.0,-90.0,-93.0,-90.0,-93.0,41.0,58.0,48.0,47.0,1
161,62:47:05:9D:EB:15,3852772,497225899,6734,12180132,3846038,485045767,1,6935,3799490,6885,3791832,50,7658,3308,0,6796,56,1,125,216660.0,130000.0,-43.0,-44.0,-35.0,-48.0,-43.0,-45.0,-35.0,-47.0,-90.0,-93.0,-90.0,-93.0,47.0,49.0,55.0,45.0,1
162,92:69:1D:31:68:E9,3850078,488697884,4040,3652117,3846038,485045767,1,5368,1154977,5200,1116829,168,38148,2199,12,4290,103,1,60,229410.0,130000.0,-51.0,-48.0,-43.0,-47.0,-51.0,-48.0,-43.0,-47.0,-90.0,-93.0,-90.0,-93.0,39.0,45.0,47.0,46.0,1
163,CC:2F:71:3F:1F:24,4996451,1799871897,1150413,1314826130,3846038,485045767,1730,963529,1088759585,962703,1088659751,826,99834,931331,15,1149038,119556,1727,754,144444.0,43333.0,-71.0,-68.0,-69.0,-72.0,-70.0,-68.0,-68.0,-71.0,-90.0,-93.0,-90.0,-93.0,19.0,25.0,21.0,21.0,1
164,CC:2F:71:3E:C5:1F,3847019,485165716,981,119949,3846038,485045767,2,4250,354851,3537,270187,713,84664,1039,13,1409,28,2,54,144444.0,39000.0,-72.0,-73.0,-70.0,-61.0,-73.0,-73.0,-70.0,-62.0,-90.0,-93.0,-90.0,-93.0,18.0,20.0,20.0,32.0,1
165,BA:8C:B9:54:50:24,3850962,491238961,4924,6193194,3846038,485045767,7,9719,1749406,9697,1745911,22,3495,2358,17,5421,41,7,70,216660.0,130000.0,-49.0,-35.0,-42.0,-46.0,-43.0,-35.0,-43.0,-48.0,-90.0,-93.0,-90.0,-93.0,41.0,58.0,48.0,47.0,1
166,62:47:05:9D:EB:15,3852778,497226423,6734,12180132,3846044,485046291,1,6935,3799490,6885,3791832,50,7658,3308,0,6796,56,1,125,216660.0,130000.0,-43.0,-44.0,-35.0,-48.0,-43.0,-45.0,-35.0,-47.0,-90.0,-93.0,-90.0,-93.0,47.0,49.0,55.0,45.0,1
167,92:69:1D:31:68:E9,3850084,488698408,4040,3652117,3846044,485046291,1,5368,1154977,5200,1116829,168,38148,2199,12,4290,103,1,60,229410.0,130000.0,-51.0,-48.0,-43.0,-47.0,-51.0,-48.0,-43.0,-47.0,-90.0,-93.0,-90.0,-93.0,39.0,45.0,47.0,46.0,1
168,CC:2F:71:3F:1F:24,4996668,1800120638,1150622,1315074145,3846046,485046493,1730,963719,1088989685,962893,1088889851,826,99834,931521,15,1149247,119561,1727,755,144444.0,43333.0,-71.0,-68.0,-69.0,-72.0,-70.0,-68.0,-68.0,-71.0,-90.0,-93.0,-90.0,-93.0,19.0,25.0,21.0,21.0,1
169,CC:2F:71:3E:C5:1F,3847027,485166442,981,119949,3846046,485046493,2,4250,354851,3537,270187,713,84664,1039,13,1409,28,2,54,144444.0,39000.0,-72.0,-73.0,-70.0,-61.0,-73.0,-73.0,-70.0,-62.0,-90.0,-93.0,-90.0,-93.0,18.0,20.0,20.0,32.0,1
170,BA:8C:B9:54:50:24,3850970,491239687,4924,6193194,3846046,485046493,7,9719,1749406,9697,1745911,22,3495,2358,17,5421,41,7,70,216660.0,130000.0,-49.0,-35.0,-42.0,-46.0,-43.0,-35.0,-43.0,-48.0,-90.0,-93.0,-90.0,-93.0,41.0,58.0,48.0,47.0,1
171,62:47:05:9D:EB:15,3852783,497226887,6734,12180132,3846049,485046755,1,6935,3799490,6885,3791832,50,7658,3308,0,6796,56,1,125,216660.0,130000.0,-43.0,-44.0,-35.0,-48.0,-43.0,-45.0,-35.0,-47.0,-90.0,-93.0,-90.0,-93.0,47.0,49.0,55.0,45.0,1
172,92:69:1D:31:68:E9,3850089,488698872,4040,3652117,3846049,485046755,1,5368,1154977,5200,1116829,168,38148,2199,12,4290,103,1,60,229410.0,130000.0,-51.0,-48.0,-43.0,-47.0,-51.0,-48.0,-43.0,-47.0,-90.0,-93.0,-90.0,-93.0,39.0,45.0,47.0,46.0,1
173,CC:2F:71:3F:1F:24,4996863,1800362420,1150814,1315315665,3846049,485046755,1730,963888,1089215961,963062,1089116127,826,99834,931690,15,1149439,119563,1727,755,144444.0,43333.0,-71.0,-68.0,-69.0,-72.0,-70.0,-68.0,-69.0,-71.0,-90.0,-93.0,-90.0,-93.0,19.0,25.0,21.0,21.0,1
174,CC:2F:71:3E:C5:1F,3847030,485166704,981,119949,3846049,485046755,2,4250,354851,3537,270187,713,84664,1039,13,1409,28,2,54,144444.0,39000.0,-72.0,-73.0,-70.0,-61.0,-73.0,-73.0,-70.0,-62.0,-90.0,-93.0,-90.0,-93.0,18.0,20.0,20.0,32.0,1
175,BA:8C:B9:54:50:24,3850973,491239949,4924,6193194,3846049,485046755,7,9719,1749406,9697,1745911,22,3495,2358,17,5421,41,7,70,216660.0,130000.0,-49.0,-35.0,-42.0,-46.0,-43.0,-35.0,-43.0,-48.0,-90.0,-93.0,-90.0,-93.0,41.0,58.0,48.0,47.0,1
176,62:47:05:9D:EB:15,3852787,497227291,6734,12180132,3846053,485047159,1,6935,3799490,6885,3791832,50,7658,3308,0,6796,56,1,125,216660.0,130000.0,-43.0,-44.0,-35.0,-48.0,-43.0,-45.0,-35.0,-47.0,-90.0,-93.0,-90.0,-93.0,47.0,49.0,55.0,45.0,1
177,92:69:1D:31:68:E9,3850096,488699538,4040,3652117,3846056,485047421,1,5369,1155045,5201,1116897,168,38148,2199,12,4290,103,1,61,229410.0,130000.0,-51.0,-48.0,-44.0,-47.0,-51.0,-47.0,-43.0,-47.0,-90.0,-93.0,-90.0,-93.0,39.0,45.0,46.0,46.0,1
178,CC:2F:71:3F:1F:24,4997060,1800604276,1151003,1315556795,3846057,485047481,1730,964056,1089442121,963230,1089342287,826,99834,931858,15,1149628,119566,1727,755,144444.0,43333.0,-71.0,-68.0,-69.0,-72.0,-70.0,-68.0,-68.0,-71.0,-90.0,-93.0,-90.0,-93.0,19.0,25.0,21.0,21.0,1
179,CC:2F:71:3E:C5:1F,3847038,485167430,981,119949,3846057,485047481,2,4250,354851,3537,270187,713,84664,1039,13,1409,28,2,54,144444.0,39000.0,-72.0,-73.0,-70.0,-61.0,-73.0,-73.0,-70.0,-62.0,-90.0,-93.0,-90.0,-93.0,18.0,20.0,20.0,32.0,1
180,BA:8C:B9:54:50:24,3850981,491240675,4924,6193194,3846057,485047481,7,9719,1749406,9697,1745911,22,3495,2358,17,5421,41,7,70,216660.0,130000.0,-49.0,-35.0,-42.0,-46.0,-43.0,-35.0,-43.0,-48.0,-90.0,-93.0,-90.0,-93.0,41.0,58.0,48.0,47.0,1
181,62:47:05:9D:EB:15,3852793,497227815,6734,12180132,3846059,485047683,1,6935,3799490,6885,3791832,50,7658,3308,0,6796,56,1,125,216660.0,130000.0,-43.0,-44.0,-35.0,-48.0,-43.0,-45.0,-35.0,-47.0,-90.0,-93.0,-90.0,-93.0,47.0,49.0,55.0,45.0,1
182,92:69:1D:31:68:E9,3850099,488699800,4040,3652117,3846059,485047683,1,5369,1155045,5201,1116897,168,38148,2199,12,4290,103,1,61,229410.0,130000.0,-51.0,-48.0,-44.0,-47.0,-51.0,-47.0,-43.0,-47.0,-90.0,-93.0,-90.0,-93.0,39.0,45.0,46.0,46.0,1
183,CC:2F:71:3F:1F:24,4997251,1800845608,1151192,1315797925,3846059,485047683,1730,964224,1089668309,963398,1089568475,826,99834,932026,15,1149817,119567,1727,755,144444.0,43333.0,-70.0,-68.0,-69.0,-72.0,-70.0,-68.0,-68.0,-72.0,-90.0,-93.0,-90.0,-93.0,20.0,25.0,21.0,21.0,1
184,CC:2F:71:3E:C5:1F,3847040,485167632,981,119949,3846059,485047683,2,4250,354851,3537,270187,713,84664,1039,13,1409,28,2,54,144444.0,39000.0,-72.0,-73.0,-70.0,-61.0,-73.0,-73.0,-70.0,-62.0,-90.0,-93.0,-90.0,-93.0,18.0,20.0,20.0,32.0,1
185,BA:8C:B9:54:50:24,3850984,491240939,4924,6193194,3846060,485047745,7,9719,1749406,9697,1745911,22,3495,2358,17,5421,41,7,70,216660.0,130000.0,-49.0,-35.0,-42.0,-46.0,-43.0,-35.0,-43.0,-48.0,-90.0,-93.0,-90.0,-93.0,41.0,58.0,48.0,47.0,1
186,62:47:05:9D:EB:15,3852801,497228543,6734,12180132,3846067,485048411,1,6935,3799490,6885,3791832,50,7658,3308,0,6796,56,1,125,216660.0,130000.0,-43.0,-44.0,-35.0,-48.0,-43.0,-45.0,-35.0,-47.0,-90.0,-93.0,-90.0,-93.0,47.0,49.0,55.0,45.0,1
187,92:69:1D:31:68:E9,3850107,488700528,4040,3652117,3846067,485048411,1,5369,1155045,5201,1116897,168,38148,2199,12,4290,103,1,61,229410.0,130000.0,-51.0,-48.0,-44.0,-47.0,-51.0,-47.0,-43.0,-47.0,-90.0,-93.0,-90.0,-93.0,39.0,45.0,46.0,46.0,1
188,CC:2F:71:3F:1F:24,4997449,1801089020,1151382,1316040609,3846067,485048411,1730,964396,1089897837,963570,1089798003,826,99834,932196,15,1150006,119568,1727,755,144444.0,43333.0,-70.0,-68.0,-69.0,-72.0,-70.0,-68.0,-69.0,-71.0,-90.0,-93.0,-90.0,-93.0,20.0,25.0,21.0,21.0,1
189,CC:2F:71:3E:C5:1F,3847050,485168562,981,119949,3846069,485048613,2,4252,355039,3538,270257,714,84782,1040,13,1409,28,2,54,144444.0,39000.0,-72.0,-72.0,-69.0,-60.0,-72.0,-72.0,-69.0,-60.0,-90.0,-93.0,-90.0,-93.0,18.0,21.0,21.0,33.0,1
190,BA:8C:B9:54:50:24,3850993,491241807,4924,6193194,3846069,485048613,7,9719,1749406,9697,1745911,22,3495,2358,17,5421,41,7,70,216660.0,130000.0,-49.0,-35.0,-42.0,-46.0,-43.0,-35.0,-43.0,-48.0,-90.0,-93.0,-90.0,-93.0,41.0,58.0,48.0,47.0,1
191,62:47:05:9D:EB:15,3852805,497228865,6734,12180132,3846071,485048733,1,6936,3799558,6886,3791900,50,7658,3308,0,6797,56,1,125,216660.0,130000.0,-45.0,-50.0,-44.0,-44.0,-43.0,-45.0,-36.0,-47.0,-90.0,-93.0,-90.0,-93.0,45.0,43.0,46.0,49.0,1
192,92:69:1D:31:68:E9,3850111,488700850,4040,3652117,3846071,485048733,1,5369,1155045,5201,1116897,168,38148,2199,12,4290,103,1,61,229410.0,130000.0,-51.0,-48.0,-44.0,-47.0,-51.0,-47.0,-43.0,-47.0,-90.0,-93.0,-90.0,-93.0,39.0,45.0,46.0,46.0,1
193,CC:2F:71:3F:1F:24,4997651,1801334189,1151580,1316285456,3846071,485048733,1730,964576,1090128738,963750,1090028904,826,99834,932375,15,1150205,119569,1727,755,144444.0,43333.0,-71.0,-68.0,-69.0,-71.0,-70.0,-68.0,-69.0,-71.0,-90.0,-93.0,-90.0,-93.0,19.0,25.0,21.0,22.0,1
194,CC:2F:71:3E:C5:1F,3847052,485168682,981,119949,3846071,485048733,2,4252,355039,3538,270257,714,84782,1040,13,1409,28,2,54,144444.0,39000.0,-72.0,-72.0,-69.0,-60.0,-72.0,-72.0,-69.0,-60.0,-90.0,-93.0,-90.0,-93.0,18.0,21.0,21.0,33.0,1
195,BA:8C:B9:54:50:24,3850997,491242129,4924,6193194,3846073,485048935,7,9721,1749542,9699,1746047,22,3495,2358,17,5422,41,7,70,216660.0,130000.0,-48.0,-35.0,-43.0,-46.0,-45.0,-35.0,-43.0,-47.0,-90.0,-93.0,-90.0,-93.0,42.0,58.0,47.0,47.0,1
196,62:47:05:9D:EB:15,3852835,497240554,6734,12180132,3846101,485060422,1,6937,3799626,6887,3791968,50,7658,3308,0,6797,56,1,125,216660.0,130000.0,-43.0,-44.0,-37.0,-48.0,-43.0,-45.0,-36.0,-47.0,-90.0,-93.0,-90.0,-93.0,47.0,49.0,53.0,45.0,1
197,92:69:1D:31:68:E9,3850143,488712741,4040,3652117,3846103,485060624,1,5372,1155416,5203,1117033,169,38383,2200,12,4290,103,1,61,229410.0,130000.0,-51.0,-48.0,-44.0,-47.0,-51.0,-48.0,-44.0,-47.0,-90.0,-93.0,-90.0,-93.0,39.0,45.0,46.0,46.0,1
198,CC:2F:71:3F:1F:24,4997884,1801604434,1151781,1316543810,3846103,485060624,1730,964757,1090372070,963931,1090272236,826,99834,932556,15,1150406,119576,1727,755,144444.0,43333.0,-71.0,-68.0,-69.0,-71.0,-71.0,-68.0,-68.0,-71.0,-90.0,-93.0,-90.0,-93.0,19.0,25.0,21.0,22.0,1
199,CC:2F:71:3E:C5:1F,3847084,485180573,981,119949,3846103,485060624,2,4252,355039,3538,270257,714,84782,1040,13,1409,28,2,54,144444.0,39000.0,-72.0,-72.0,-69.0,-60.0,-72.0,-72.0,-69.0,-60.0,-90.0,-93.0,-90.0,-93.0,18.0,21.0,21.0,33.0,1
200,BA:8C:B9:54:50:24,3851027,491253818,4924,6193194,3846103,485060624,7,9721,1749542,9699,1746047,22,3495,2358,17,5422,41,7,70,216660.0,130000.0,-48.0,-35.0,-43.0,-46.0,-45.0,-35.0,-43.0,-47.0,-90.0,-93.0,-90.0,-93.0,42.0,58.0,47.0,47.0,1
201,62:47:05:9D:EB:15,3852838,497240816,6734,12180132,3846104,485060684,1,6937,3799626,6887,3791968,50,7658,3308,0,6797,56,1,125,216660.0,130000.0,-43.0,-44.0,-37.0,-48.0,-43.0,-45.0,-36.0,-47.0,-90.0,-93.0,-90.0,-93.0,47.0,49.0,53.0,45.0,1
202,92:69:1D:31:68:E9,3850146,488713003,4040,3652117,3846106,485060886,1,5372,1155416,5203,1117033,169,38383,2200,12,4290,103,1,61,229410.0,130000.0,-51.0,-48.0,-44.0,-47.0,-51.0,-48.0,-44.0,-47.0,-91.0,-93.0,-90.0,-93.0,40.0,45.0,46.0,46.0,1
203,CC:2F:71:3F:1F:24,4998086,1801855709,1151980,1316794823,3846106,485060886,1730,964933,1090607825,964107,1090507991,826,99834,932732,15,1150605,119587,1727,755,144444.0,43333.0,-71.0,-68.0,-68.0,-72.0,-70.0,-68.0,-68.0,-72.0,-91.0,-93.0,-90.0,-93.0,20.0,25.0,22.0,21.0,1
204,CC:2F:71:3E:C5:1F,3847088,485180895,981,119949,3846107,485060946,2,4252,355039,3538,270257,714,84782,1040,13,1409,28,2,54,144444.0,39000.0,-72.0,-72.0,-69.0,-60.0,-72.0,-72.0,-69.0,-60.0,-91.0,-93.0,-90.0,-93.0,19.0,21.0,21.0,33.0,1
205,BA:8C:B9:54:50:24,3851031,491254140,4924,6193194,3846107,485060946,7,9721,1749542,9699,1746047,22,3495,2358,17,5422,41,7,70,216660.0,130000.0,-48.0,-35.0,-43.0,-46.0,-45.0,-35.0,-43.0,-47.0,-91.0,-93.0,-90.0,-93.0,43.0,58.0,47.0,47.0,1
206,62:47:05:9D:EB:15,3852847,497241684,6734,12180132,3846113,485061552,1,6937,3799626,6887,3791968,50,7658,3308,0,6797,56,1,125,216660.0,130000.0,-43.0,-44.0,-37.0,-48.0,-43.0,-45.0,-36.0,-47.0,-91.0,-93.0,-90.0,-93.0,48.0,49.0,53.0,45.0,1
207,92:69:1D:31:68:E9,3850153,488713669,4040,3652117,3846113,485061552,1,5372,1155416,5203,1117033,169,38383,2200,12,4290,103,1,61,229410.0,130000.0,-51.0,-48.0,-44.0,-47.0,-51.0,-48.0,-44.0,-47.0,-91.0,-93.0,-90.0,-93.0,40.0,45.0,46.0,46.0,1
208,CC:2F:71:3F:1F:24,4998290,1802104384,1152176,1317042559,3846114,485061825,1730,965106,1090840261,964280,1090740427,826,99834,932905,15,1150801,119595,1727,755,144444.0,43333.0,-70.0,-68.0,-69.0,-72.0,-70.0,-68.0,-68.0,-71.0,-91.0,-93.0,-90.0,-93.0,21.0,25.0,21.0,21.0,1
209,CC:2F:71:3E:C5:1F,3847095,485181774,981,119949,3846114,485061825,2,4252,355039,3538,270257,714,84782,1040,13,1409,28,2,54,144444.0,39000.0,-72.0,-72.0,-69.0,-60.0,-72.0,-72.0,-69.0,-60.0,-91.0,-93.0,-90.0,-93.0,19.0,21.0,21.0,33.0,1
210,BA:8C:B9:54:50:24,3851038,491255019,4924,6193194,3846114,485061825,7,9721,1749542,9699,1746047,22,3495,2358,17,5422,41,7,70,216660.0,130000.0,-48.0,-35.0,-43.0,-46.0,-45.0,-35.0,-43.0,-47.0,-91.0,-93.0,-90.0,-93.0,43.0,58.0,47.0,47.0,1
211,62:47:05:9D:EB:15,3852851,497242219,6734,12180132,3846117,485062087,1,6937,3799626,6887,3791968,50,7658,3308,0,6797,56,1,125,216660.0,130000.0,-43.0,-44.0,-37.0,-48.0,-43.0,-45.0,-36.0,-47.0,-91.0,-93.0,-90.0,-93.0,48.0,49.0,53.0,45.0,1
212,92:69:1D:31:68:E9,3850157,488714204,4040,3652117,3846117,485062087,1,5372,1155416,5203,1117033,169,38383,2200,12,4290,103,1,61,229410.0,130000.0,-51.0,-48.0,-44.0,-47.0,-51.0,-48.0,-44.0,-47.0,-91.0,-93.0,-90.0,-93.0,40.0,45.0,46.0,46.0,1
213,CC:2F:71:3F:1F:24,4998500,1802369476,1152383,1317307389,3846117,485062087,1730,965288,1091088345,964462,1090988511,826,99834,933087,15,1151008,119603,1727,755,144444.0,43333.0,-70.0,-68.0,-69.0,-72.0,-70.0,-68.0,-68.0,-71.0,-91.0,-93.0,-90.0,-93.0,21.0,25.0,21.0,21.0,1
214,CC:2F:71:3E:C5:1F,3847100,485182238,981,119949,3846119,485062289,2,4252,355039,3538,270257,714,84782,1040,13,1409,28,2,54,144444.0,39000.0,-72.0,-72.0,-69.0,-60.0,-72.0,-72.0,-69.0,-60.0,-91.0,-93.0,-90.0,-93.0,19.0,21.0,21.0,33.0,1
215,BA:8C:B9:54:50:24,3851043,491255483,4924,6193194,3846119,485062289,7,9721,1749542,9699,1746047,22,3495,2358,17,5422,41,7,70,216660.0,130000.0,-48.0,-35.0,-43.0,-46.0,-45.0,-35.0,-43.0,-47.0,-91.0,-93.0,-90.0,-93.0,43.0,58.0,47.0,47.0,1
216,62:47:05:9D:EB:15,3852865,497243815,6740,12181002,3846125,485062813,1,6945,3800583,6895,3792925,50,7658,3313,0,6803,56,1,125,229410.0,130000.0,-43.0,-44.0,-36.0,-48.0,-44.0,-47.0,-39.0,-47.0,-91.0,-93.0,-90.0,-93.0,48.0,49.0,54.0,45.0,1
217,92:69:1D:31:68:E9,3850165,488714930,4040,3652117,3846125,485062813,1,5372,1155416,5203,1117033,169,38383,2200,12,4290,103,1,61,229410.0,130000.0,-51.0,-48.0,-44.0,-47.0,-51.0,-48.0,-44.0,-47.0,-91.0,-93.0,-90.0,-93.0,40.0,45.0,46.0,46.0,1
218,CC:2F:71:3F:1F:24,4998707,1802615193,1152582,1317552380,3846125,485062813,1730,965464,1091315957,964638,1091216123,826,99834,933263,15,1151207,119609,1727,755,144444.0,43333.0,-70.0,-68.0,-68.0,-72.0,-70.0,-68.0,-68.0,-71.0,-91.0,-93.0,-90.0,-93.0,21.0,25.0,22.0,21.0,1
219,CC:2F:71:3E:C5:1F,3847106,485182762,981,119949,3846125,485062813,2,4252,355039,3538,270257,714,84782,1040,13,1409,28,2,54,144444.0,39000.0,-72.0,-72.0,-69.0,-60.0,-72.0,-72.0,-69.0,-60.0,-91.0,-93.0,-90.0,-93.0,19.0,21.0,21.0,33.0,1
220,BA:8C:B9:54:50:24,3851049,491256007,4924,6193194,3846125,485062813,7,9721,1749542,9699,1746047,22,3495,2358,17,5422,41,7,70,216660.0,130000.0,-48.0,-35.0,-43.0,-46.0,-45.0,-35.0,-43.0,-47.0,-91.0,-93.0,-90.0,-93.0,43.0,58.0,47.0,47.0,1
221,62:47:05:9D:EB:15,3852871,497245051,6741,12181608,3846130,485063443,1,6946,3800651,6896,3792993,50,7658,3313,0,6804,56,1,125,229410.0,130000.0,-43.0,-45.0,-37.0,-49.0,-44.0,-47.0,-39.0,-47.0,-90.0,-92.0,-90.0,-92.0,47.0,47.0,53.0,43.0,1
222,92:69:1D:31:68:E9,3850172,488715762,4040,3652117,3846132,485063645,1,5372,1155416,5203,1117033,169,38383,2200,12,4290,103,1,61,229410.0,130000.0,-51.0,-48.0,-44.0,-47.0,-51.0,-48.0,-44.0,-47.0,-90.0,-92.0,-90.0,-92.0,39.0,44.0,46.0,45.0,1
223,CC:2F:71:3F:1F:24,4998908,1802860653,1152776,1317797008,3846132,485063645,1730,965637,1091546969,964811,1091447135,826,99834,933436,15,1151401,119615,1727,755,144444.0,43333.0,-71.0,-68.0,-69.0,-72.0,-70.0,-68.0,-68.0,-71.0,-90.0,-92.0,-90.0,-92.0,19.0,24.0,21.0,20.0,1
224,CC:2F:71:3E:C5:1F,3847113,485183594,981,119949,3846132,485063645,2,4252,355039,3538,270257,714,84782,1040,13,1409,28,2,54,144444.0,39000.0,-72.0,-72.0,-69.0,-60.0,-72.0,-72.0,-69.0,-60.0,-90.0,-92.0,-90.0,-92.0,18.0,20.0,21.0,32.0,1
225,BA:8C:B9:54:50:24,3851056,491256839,4924,6193194,3846132,485063645,7,9721,1749542,9699,1746047,22,3495,2358,17,5422,41,7,70,216660.0,130000.0,-48.0,-35.0,-43.0,-46.0,-45.0,-35.0,-43.0,-47.0,-90.0,-92.0,-90.0,-92.0,42.0,57.0,47.0,46.0,1
226,62:47:05:9D:EB:15,3852878,497245717,6741,12181608,3846137,485064109,1,6947,3800719,6897,3793061,50,7658,3313,0,6804,56,1,125,229410.0,130000.0,-43.0,-45.0,-36.0,-48.0,-44.0,-47.0,-39.0,-47.0,-90.0,-92.0,-90.0,-92.0,47.0,47.0,54.0,44.0,1
227,92:69:1D:31:68:E9,3850177,488716226,4040,3652117,3846137,485064109,1,5372,1155416,5203,1117033,169,38383,2200,12,4290,103,1,61,229410.0,130000.0,-51.0,-48.0,-44.0,-47.0,-51.0,-48.0,-44.0,-47.0,-90.0,-92.0,-90.0,-92.0,39.0,44.0,46.0,45.0,1
228,CC:2F:71:3F:1F:24,4999106,1803104191,1152969,1318040082,3846137,485064109,1730,965806,1091774697,964980,1091674863,826,99834,933605,15,1151594,119626,1727,755,144444.0,43333.0,-71.0,-68.0,-69.0,-72.0,-70.0,-68.0,-68.0,-71.0,-90.0,-92.0,-90.0,-92.0,19.0,24.0,21.0,20.0,1
229,CC:2F:71:3E:C5:1F,3847119,485184118,981,119949,3846138,485064169,2,4252,355039,3538,270257,714,84782,1040,13,1409,28,2,54,144444.0,39000.0,-72.0,-72.0,-69.0,-60.0,-72.0,-72.0,-69.0,-60.0,-90.0,-92.0,-90.0,-92.0,18.0,20.0,21.0,32.0,1
230,BA:8C:B9:54:50:24,3851062,491257363,4924,6193194,3846138,485064169,7,9721,1749542,9699,1746047,22,3495,2358,17,5422,41,7,70,216660.0,130000.0,-48.0,-35.0,-43.0,-46.0,-45.0,-35.0,-43.0,-47.0,-90.0,-92.0,-90.0,-92.0,42.0,57.0,47.0,46.0,1
231,62:47:05:9D:EB:15,3852883,497246181,6741,12181608,3846142,485064573,1,6947,3800719,6897,3793061,50,7658,3313,0,6804,56,1,125,229410.0,130000.0,-43.0,-45.0,-36.0,-48.0,-44.0,-47.0,-39.0,-47.0,-90.0,-92.0,-90.0,-92.0,47.0,47.0,54.0,44.0,1
232,92:69:1D:31:68:E9,3850182,488716690,4040,3652117,3846142,485064573,1,5372,1155416,5203,1117033,169,38383,2200,12,4290,103,1,61,229410.0,130000.0,-51.0,-48.0,-44.0,-47.0,-51.0,-48.0,-44.0,-47.0,-90.0,-92.0,-90.0,-92.0,39.0,44.0,46.0,45.0,1
233,CC:2F:71:3F:1F:24,4999303,1803346175,1153161,1318281602,3846142,485064573,1730,965979,1092002875,965153,1091903041,826,99834,933777,15,1151786,119643,1727,755,144444.0,43333.0,-71.0,-68.0,-69.0,-72.0,-70.0,-68.0,-68.0,-72.0,-90.0,-92.0,-90.0,-92.0,19.0,24.0,21.0,20.0,1
234,CC:2F:71:3E:C5:1F,3847123,485184522,981,119949,3846142,485064573,2,4252,355039,3538,270257,714,84782,1040,13,1409,28,2,54,144444.0,39000.0,-72.0,-72.0,-69.0,-60.0,-72.0,-72.0,-69.0,-60.0,-90.0,-92.0,-90.0,-92.0,18.0,20.0,21.0,32.0,1
235,BA:8C:B9:54:50:24,3851068,491257969,4924,6193194,3846144,485064775,7,9721,1749542,9699,1746047,22,3495,2358,17,5422,41,7,70,216660.0,130000.0,-48.0,-35.0,-43.0,-46.0,-45.0,-35.0,-43.0,-47.0,-90.0,-92.0,-90.0,-92.0,42.0,57.0,47.0,46.0,1
236,62:47:05:9D:EB:15,3852888,497246645,6741,12181608,3846147,485065037,1,6947,3800719,6897,3793061,50,7658,3313,0,6804,56,1,125,229410.0,130000.0,-43.0,-45.0,-36.0,-48.0,-44.0,-47.0,-39.0,-47.0,-90.0,-92.0,-90.0,-92.0,47.0,47.0,54.0,44.0,1
237,92:69:1D:31:68:E9,3850187,488717154,4040,3652117,3846147,485065037,1,5372,1155416,5203,1117033,169,38383,2200,12,4290,103,1,61,229410.0,130000.0,-51.0,-48.0,-44.0,-47.0,-51.0,-48.0,-44.0,-47.0,-90.0,-92.0,-90.0,-92.0,39.0,44.0,46.0,45.0,1
238,CC:2F:71:3F:1F:24,4999510,1803603699,1153363,1318538662,3846147,485065037,1730,966157,1092244435,965331,1092144601,826,99834,933955,15,1151988,119657,1727,755,144444.0,43333.0,-70.0,-68.0,-69.0,-72.0,-70.0,-68.0,-69.0,-72.0,-90.0,-92.0,-90.0,-92.0,20.0,24.0,21.0,20.0,1
239,CC:2F:71:3E:C5:1F,3847128,485184986,981,119949,3846147,485065037,2,4252,355039,3538,270257,714,84782,1040,13,1409,28,2,54,144444.0,39000.0,-72.0,-72.0,-69.0,-60.0,-72.0,-72.0,-69.0,-60.0,-90.0,-92.0,-90.0,-92.0,18.0,20.0,21.0,32.0,1
240,BA:8C:B9:54:50:24,3851072,491258291,4924,6193194,3846148,485065097,7,9721,1749542,9699,1746047,22,3495,2358,17,5422,41,7,70,216660.0,130000.0,-48.0,-35.0,-43.0,-46.0,-45.0,-35.0,-43.0,-47.0,-90.0,-92.0,-90.0,-92.0,42.0,57.0,47.0,46.0,1
241,62:47:05:9D:EB:15,3852894,497247169,6741,12181608,3846153,485065561,1,6947,3800719,6897,3793061,50,7658,3313,0,6804,56,1,125,229410.0,130000.0,-43.0,-45.0,-36.0,-48.0,-44.0,-47.0,-39.0,-47.0,-90.0,-92.0,-90.0,-92.0,47.0,47.0,54.0,44.0,1
242,92:69:1D:31:68:E9,3850193,488717678,4040,3652117,3846153,485065561,1,5372,1155416,5203,1117033,169,38383,2200,12,4290,103,1,61,229410.0,130000.0,-51.0,-48.0,-44.0,-47.0,-51.0,-48.0,-44.0,-47.0,-90.0,-92.0,-90.0,-92.0,39.0,44.0,46.0,45.0,1
243,CC:2F:71:3F:1F:24,4999717,1803850898,1153564,1318785337,3846153,485065561,1730,966333,1092472019,965507,1092372185,826,99834,934131,15,1152189,119678,1727,755,144444.0,43333.0,-72.0,-70.0,-70.0,-73.0,-73.0,-71.0,-71.0,-75.0,-90.0,-92.0,-90.0,-92.0,18.0,22.0,20.0,19.0,1
244,CC:2F:71:3E:C5:1F,3847138,485185914,981,119949,3846157,485065965,2,4252,355039,3538,270257,714,84782,1040,13,1409,28,2,54,144444.0,39000.0,-72.0,-72.0,-69.0,-60.0,-72.0,-72.0,-69.0,-60.0,-90.0,-92.0,-90.0,-92.0,18.0,20.0,21.0,32.0,1
245,BA:8C:B9:54:50:24,3851081,491259159,4924,6193194,3846157,485065965,7,9721,1749542,9699,1746047,22,3495,2358,17,5422,41,7,70,216660.0,130000.0,-48.0,-35.0,-43.0,-46.0,-45.0,-35.0,-43.0,-47.0,-90.0,-92.0,-90.0,-92.0,42.0,57.0,47.0,46.0,1
246,62:47:05:9D:EB:15,3852900,497247749,6742,12181724,3846158,485066025,1,6950,3800961,6900,3793303,50,7658,3314,0,6805,56,1,125,229410.0,130000.0,-43.0,-45.0,-36.0,-48.0,-44.0,-46.0,-38.0,-47.0,-90.0,-93.0,-90.0,-92.0,47.0,48.0,54.0,44.0,1
247,92:69:1D:31:68:E9,3850198,488718142,4040,3652117,3846158,485066025,1,5372,1155416,5203,1117033,169,38383,2200,12,4290,103,1,61,229410.0,130000.0,-51.0,-48.0,-44.0,-47.0,-51.0,-48.0,-44.0,-47.0,-90.0,-93.0,-90.0,-92.0,39.0,45.0,46.0,45.0,1
248,CC:2F:71:3F:1F:24,4999919,1804103500,1153761,1319037475,3846158,485066025,1730,966511,1092710983,965685,1092611149,826,99834,934309,15,1152386,119710,1727,757,144444.0,43333.0,-70.0,-68.0,-69.0,-72.0,-70.0,-68.0,-68.0,-72.0,-90.0,-93.0,-90.0,-92.0,20.0,25.0,21.0,20.0,1
249,CC:2F:71:3E:C5:1F,3847139,485185974,981,119949,3846158,485066025,2,4252,355039,3538,270257,714,84782,1040,13,1409,28,2,54,144444.0,39000.0,-72.0,-72.0,-69.0,-60.0,-72.0,-72.0,-69.0,-60.0,-90.0,-93.0,-90.0,-92.0,18.0,21.0,21.0,32.0,1
250,BA:8C:B9:54:50:24,3851082,491259219,4924,6193194,3846158,485066025,7,9721,1749542,9699,1746047,22,3495,2358,17,5422,41,7,70,216660.0,130000.0,-48.0,-35.0,-43.0,-46.0,-45.0,-35.0,-43.0,-47.0,-90.0,-93.0,-90.0,-92.0,42.0,58.0,47.0,46.0,1
251,62:47:05:9D:EB:15,3852905,497248213,6742,12181724,3846163,485066489,1,6951,3801029,6901,3793371,50,7658,3314,0,6805,56,1,125,229410.0,130000.0,-45.0,-51.0,-44.0,-45.0,-43.0,-46.0,-38.0,-47.0,-90.0,-93.0,-90.0,-92.0,45.0,42.0,46.0,47.0,1
252,92:69:1D:31:68:E9,3850205,488718808,4040,3652117,3846165,485066691,1,5372,1155416,5203,1117033,169,38383,2200,12,4290,103,1,61,229410.0,130000.0,-51.0,-48.0,-44.0,-47.0,-51.0,-48.0,-44.0,-47.0,-90.0,-93.0,-90.0,-92.0,39.0,45.0,46.0,45.0,1
253,CC:2F:71:3F:1F:24,5000117,1804345572,1153952,1319278881,3846165,485066691,1730,966677,1092934063,965851,1092834229,826,99834,934475,15,1152577,119729,1727,757,144444.0,43333.0,-71.0,-69.0,-69.0,-72.0,-70.0,-68.0,-68.0,-72.0,-90.0,-93.0,-90.0,-92.0,19.0,24.0,21.0,20.0,1
254,CC:2F:71:3E:C5:1F,3847149,485186902,981,119949,3846168,485066953,2,4252,355039,3538,270257,714,84782,1040,13,1409,28,2,54,144444.0,39000.0,-72.0,-72.0,-69.0,-60.0,-72.0,-72.0,-69.0,-60.0,-90.0,-93.0,-90.0,-92.0,18.0,21.0,21.0,32.0,1
255,BA:8C:B9:54:50:24,3851092,491260147,4924,6193194,3846168,485066953,7,9721,1749542,9699,1746047,22,3495,2358,17,5422,41,7,70,216660.0,130000.0,-48.0,-35.0,-43.0,-46.0,-45.0,-35.0,-43.0,-47.0,-90.0,-93.0,-90.0,-92.0,42.0,58.0,47.0,46.0,1
256,62:47:05:9D:EB:15,3852910,497248677,6742,12181724,3846168,485066953,1,6951,3801029,6901,3793371,50,7658,3314,0,6805,56,1,125,229410.0,130000.0,-45.0,-51.0,-44.0,-45.0,-43.0,-46.0,-38.0,-47.0,-90.0,-93.0,-90.0,-92.0,45.0,42.0,46.0,47.0,1
257,92:69:1D:31:68:E9,3850209,488719186,4041,3652233,3846168,485066953,1,5374,1155552,5205,1117169,169,38383,2200,12,4291,103,1,61,229410.0,130000.0,-52.0,-48.0,-44.0,-47.0,-51.0,-48.0,-44.0,-47.0,-90.0,-93.0,-89.0,-92.0,38.0,45.0,45.0,45.0,1
258,CC:2F:71:3F:1F:24,5000313,1804587318,1154145,1319520365,3846168,485066953,1730,966848,1093163419,966022,1093063585,826,99834,934646,15,1152770,119776,1727,757,130000.0,39000.0,-69.0,-69.0,-69.0,-74.0,-69.0,-69.0,-68.0,-74.0,-90.0,-93.0,-89.0,-92.0,21.0,24.0,20.0,18.0,1
259,CC:2F:71:3E:C5:1F,3847150,485187018,982,120065,3846168,485066953,2,4254,355179,3540,270397,714,84782,1040,13,1410,28,2,54,144444.0,39000.0,-73.0,-72.0,-70.0,-61.0,-72.0,-72.0,-69.0,-60.0,-90.0,-93.0,-89.0,-92.0,17.0,21.0,19.0,31.0,1
260,BA:8C:B9:54:50:24,3851093,491260263,4925,6193310,3846168,485066953,7,9723,1749678,9701,1746183,22,3495,2358,17,5423,41,7,70,216660.0,130000.0,-40.0,-37.0,-45.0,-51.0,-44.0,-35.0,-43.0,-47.0,-90.0,-93.0,-89.0,-92.0,50.0,56.0,44.0,41.0,1
261,62:47:05:9D:EB:15,3852918,497249459,6743,12181840,3846175,485067619,1,6953,3801165,6903,3793507,50,7658,3314,0,6806,56,1,125,229410.0,130000.0,-43.0,-44.0,-36.0,-49.0,-43.0,-46.0,-38.0,-47.0,-90.0,-93.0,-89.0,-92.0,47.0,49.0,53.0,43.0,1
262,92:69:1D:31:68:E9,3850218,488720054,4041,3652233,3846177,485067821,1,5374,1155552,5205,1117169,169,38383,2200,12,4291,103,1,61,229410.0,130000.0,-52.0,-48.0,-44.0,-47.0,-51.0,-48.0,-44.0,-47.0,-90.0,-93.0,-89.0,-92.0,38.0,45.0,45.0,45.0,1
263,CC:2F:71:3F:1F:24,5000514,1804829650,1154337,1319761829,3846177,485067821,1730,967020,1093390043,966194,1093290209,826,99834,934818,15,1152962,119780,1727,757,130000.0,43333.0,-70.0,-69.0,-68.0,-74.0,-69.0,-68.0,-68.0,-74.0,-90.0,-93.0,-89.0,-92.0,20.0,24.0,21.0,18.0,1
264,CC:2F:71:3E:C5:1F,3847159,485187886,982,120065,3846177,485067821,2,4254,355179,3540,270397,714,84782,1040,13,1410,28,2,54,144444.0,39000.0,-73.0,-72.0,-70.0,-61.0,-72.0,-72.0,-69.0,-60.0,-90.0,-93.0,-89.0,-92.0,17.0,21.0,19.0,31.0,1
265,BA:8C:B9:54:50:24,3851103,491261191,4925,6193310,3846178,485067881,7,9723,1749678,9701,1746183,22,3495,2358,17,5423,41,7,70,216660.0,130000.0,-40.0,-37.0,-45.0,-51.0,-44.0,-35.0,-43.0,-47.0,-90.0,-93.0,-89.0,-92.0,50.0,56.0,44.0,41.0,1
266,62:47:05:9D:EB:15,3852922,497249781,6743,12181840,3846179,485067941,1,6953,3801165,6903,3793507,50,7658,3314,0,6806,56,1,125,229410.0,130000.0,-43.0,-44.0,-36.0,-49.0,-43.0,-46.0,-38.0,-47.0,-90.0,-93.0,-89.0,-92.0,47.0,49.0,53.0,43.0,1
267,92:69:1D:31:68:E9,3850220,488720174,4041,3652233,3846179,485067941,1,5374,1155552,5205,1117169,169,38383,2200,12,4291,103,1,61,229410.0,130000.0,-52.0,-48.0,-44.0,-47.0,-51.0,-48.0,-44.0,-47.0,-90.0,-93.0,-89.0,-92.0,38.0,45.0,45.0,45.0,1
268,CC:2F:71:3F:1F:24,5000715,1805074537,1154536,1320006596,3846179,485067941,1730,967195,1093616087,966369,1093516253,826,99834,934993,15,1153161,119784,1727,757,130000.0,43333.0,-69.0,-69.0,-68.0,-75.0,-69.0,-69.0,-68.0,-74.0,-90.0,-93.0,-89.0,-92.0,21.0,24.0,21.0,17.0,1
269,CC:2F:71:3E:C5:1F,3847161,485188006,982,120065,3846179,485067941,2,4254,355179,3540,270397,714,84782,1040,13,1410,28,2,54,144444.0,39000.0,-73.0,-72.0,-70.0,-61.0,-72.0,-72.0,-69.0,-60.0,-90.0,-93.0,-89.0,-92.0,17.0,21.0,19.0,31.0,1
270,BA:8C:B9:54:50:24,3851104,491261251,4925,6193310,3846179,485067941,7,9724,1749746,9702,1746251,22,3495,2358,17,5423,41,7,70,216660.0,130000.0,-48.0,-35.0,-42.0,-46.0,-44.0,-35.0,-43.0,-47.0,-90.0,-93.0,-89.0,-92.0,42.0,58.0,47.0,46.0,1
271,62:47:05:9D:EB:15,3852929,497250660,6743,12181840,3846186,485068820,1,6953,3801165,6903,3793507,50,7658,3314,0,6806,56,1,125,229410.0,130000.0,-43.0,-44.0,-36.0,-49.0,-43.0,-46.0,-38.0,-47.0,-90.0,-93.0,-89.0,-92.0,47.0,49.0,53.0,43.0,1
272,92:69:1D:31:68:E9,3850230,488721315,4041,3652233,3846189,485069082,1,5374,1155552,5205,1117169,169,38383,2200,12,4291,103,1,61,229410.0,130000.0,-52.0,-48.0,-44.0,-47.0,-51.0,-48.0,-44.0,-47.0,-90.0,-93.0,-89.0,-92.0,38.0,45.0,45.0,45.0,1
273,CC:2F:71:3F:1F:24,5000918,1805317314,1154729,1320248232,3846189,485069082,1730,967366,1093844009,966540,1093744175,826,99834,935164,15,1153354,119788,1727,757,130000.0,43333.0,-69.0,-69.0,-68.0,-75.0,-69.0,-69.0,-67.0,-75.0,-90.0,-93.0,-89.0,-92.0,21.0,24.0,21.0,17.0,1
274,CC:2F:71:3E:C5:1F,3847171,485189147,982,120065,3846189,485069082,2,4254,355179,3540,270397,714,84782,1040,13,1410,28,2,54,144444.0,39000.0,-73.0,-72.0,-70.0,-61.0,-72.0,-72.0,-69.0,-60.0,-90.0,-93.0,-89.0,-92.0,17.0,21.0,19.0,31.0,1
275,BA:8C:B9:54:50:24,3851114,491262392,4925,6193310,3846189,485069082,7,9724,1749746,9702,1746251,22,3495,2358,17,5423,41,7,70,216660.0,130000.0,-48.0,-35.0,-42.0,-46.0,-44.0,-35.0,-43.0,-47.0,-90.0,-93.0,-89.0,-92.0,42.0,58.0,47.0,46.0,1
276,62:47:05:9D:EB:15,3852934,497251044,6743,12181840,3846191,485069204,1,6953,3801165,6903,3793507,50,7658,3314,0,6806,56,1,125,229410.0,130000.0,-43.0,-44.0,-36.0,-49.0,-43.0,-46.0,-38.0,-47.0,-90.0,-93.0,-89.0,-92.0,47.0,49.0,53.0,43.0,1
277,92:69:1D:31:68:E9,3850232,488721437,4041,3652233,3846191,485069204,1,5374,1155552,5205,1117169,169,38383,2200,12,4291,103,1,61,229410.0,130000.0,-52.0,-48.0,-44.0,-47.0,-51.0,-48.0,-44.0,-47.0,-90.0,-93.0,-89.0,-92.0,38.0,45.0,45.0,45.0,1
278,CC:2F:71:3F:1F:24,5001112,1805558732,1154921,1320489528,3846191,485069204,1730,967535,1094070313,966709,1093970479,826,99834,935333,15,1153546,119792,1727,757,130000.0,43333.0,-69.0,-69.0,-69.0,-76.0,-69.0,-69.0,-68.0,-76.0,-90.0,-93.0,-89.0,-92.0,21.0,24.0,20.0,16.0,1
279,CC:2F:71:3E:C5:1F,3847173,485189269,982,120065,3846191,485069204,2,4256,355367,3541,270467,715,84900,1041,13,1410,28,2,54,144444.0,39000.0,-73.0,-72.0,-69.0,-61.0,-72.0,-71.0,-69.0,-60.0,-90.0,-93.0,-89.0,-92.0,17.0,21.0,20.0,31.0,1
280,BA:8C:B9:54:50:24,3851116,491262514,4925,6193310,3846191,485069204,7,9724,1749746,9702,1746251,22,3495,2358,17,5423,41,7,70,216660.0,130000.0,-48.0,-35.0,-42.0,-46.0,-44.0,-35.0,-43.0,-47.0,-90.0,-93.0,-89.0,-92.0,42.0,58.0,47.0,46.0,1
281,62:47:05:9D:EB:15,3852941,497251710,6743,12181840,3846198,485069870,1,6953,3801165,6903,3793507,50,7658,3314,0,6806,56,1,125,229410.0,130000.0,-43.0,-44.0,-36.0,-49.0,-43.0,-46.0,-38.0,-47.0,-90.0,-93.0,-89.0,-92.0,47.0,49.0,53.0,43.0,1
282,92:69:1D:31:68:E9,3850241,488722305,4041,3652233,3846200,485070072,1,5374,1155552,5205,1117169,169,38383,2200,12,4291,103,1,61,229410.0,130000.0,-52.0,-48.0,-44.0,-47.0,-51.0,-48.0,-44.0,-47.0,-90.0,-93.0,-89.0,-92.0,38.0,45.0,45.0,45.0,1
283,CC:2F:71:3F:1F:24,5001314,1805801180,1155114,1320731108,3846200,485070072,1730,967705,1094298133,966879,1094198299,826,99834,935502,15,1153739,119793,1727,757,130000.0,39000.0,-69.0,-69.0,-69.0,-76.0,-69.0,-69.0,-68.0,-76.0,-90.0,-93.0,-89.0,-93.0,21.0,24.0,20.0,17.0,1
284,CC:2F:71:3E:C5:1F,3847182,485190137,982,120065,3846200,485070072,2,4256,355367,3541,270467,715,84900,1041,13,1410,28,2,54,144444.0,39000.0,-73.0,-72.0,-69.0,-61.0,-72.0,-71.0,-69.0,-60.0,-90.0,-93.0,-89.0,-93.0,17.0,21.0,20.0,32.0,1
285,BA:8C:B9:54:50:24,3851125,491263382,4925,6193310,3846200,485070072,7,9724,1749746,9702,1746251,22,3495,2358,17,5423,41,7,70,216660.0,130000.0,-48.0,-35.0,-42.0,-46.0,-44.0,-35.0,-43.0,-47.0,-90.0,-93.0,-89.0,-93.0,42.0,58.0,47.0,47.0,1
286,62:47:05:9D:EB:15,3852944,497251972,6743,12181840,3846201,485070132,1,6953,3801165,6903,3793507,50,7658,3314,0,6806,56,1,125,229410.0,130000.0,-43.0,-44.0,-36.0,-49.0,-43.0,-46.0,-38.0,-47.0,-90.0,-93.0,-89.0,-93.0,47.0,49.0,53.0,44.0,1
287,92:69:1D:31:68:E9,3850242,488722365,4041,3652233,3846201,485070132,1,5374,1155552,5205,1117169,169,38383,2200,12,4291,103,1,61,229410.0,130000.0,-52.0,-48.0,-44.0,-47.0,-51.0,-48.0,-44.0,-47.0,-90.0,-93.0,-89.0,-93.0,38.0,45.0,45.0,46.0,1
288,CC:2F:71:3F:1F:24,5001509,1806043208,1155308,1320973076,3846201,485070132,1730,967875,1094524577,967049,1094424743,826,99834,935672,15,1153933,119807,1727,757,130000.0,43333.0,-69.0,-69.0,-69.0,-77.0,-69.0,-68.0,-68.0,-76.0,-90.0,-93.0,-89.0,-93.0,21.0,24.0,20.0,16.0,1
289,CC:2F:71:3E:C5:1F,3847183,485190197,982,120065,3846201,485070132,2,4256,355367,3541,270467,715,84900,1041,13,1410,28,2,54,144444.0,39000.0,-73.0,-72.0,-69.0,-61.0,-72.0,-71.0,-69.0,-60.0,-90.0,-93.0,-89.0,-93.0,17.0,21.0,20.0,32.0,1
290,BA:8C:B9:54:50:24,3851127,491263502,4925,6193310,3846202,485070192,7,9724,1749746,9702,1746251,22,3495,2358,17,5423,41,7,70,216660.0,130000.0,-48.0,-35.0,-42.0,-46.0,-44.0,-35.0,-43.0,-47.0,-90.0,-93.0,-89.0,-93.0,42.0,58.0,47.0,47.0,1
291,62:47:05:9D:EB:15,3852954,497252900,6743,12181840,3846211,485071060,1,6953,3801165,6903,3793507,50,7658,3314,0,6806,56,1,125,229410.0,130000.0,-43.0,-44.0,-36.0,-49.0,-43.0,-46.0,-38.0,-47.0,-90.0,-93.0,-89.0,-93.0,47.0,49.0,53.0,44.0,1
292,92:69:1D:31:68:E9,3850252,488723293,4041,3652233,3846211,485071060,1,5374,1155552,5205,1117169,169,38383,2200,12,4291,103,1,61,229410.0,130000.0,-52.0,-48.0,-44.0,-47.0,-51.0,-48.0,-44.0,-47.0,-90.0,-93.0,-89.0,-93.0,38.0,45.0,45.0,46.0,1
293,CC:2F:71:3F:1F:24,5001718,1806289127,1155507,1321218067,3846211,485071060,1730,968049,1094750562,967223,1094650728,826,99834,935846,15,1154132,119807,1727,757,130000.0,43333.0,-69.0,-69.0,-68.0,-76.0,-69.0,-69.0,-68.0,-76.0,-90.0,-93.0,-89.0,-93.0,21.0,24.0,21.0,17.0,1
294,CC:2F:71:3E:C5:1F,3847193,485191125,982,120065,3846211,485071060,2,4256,355367,3541,270467,715,84900,1041,13,1410,28,2,54,144444.0,39000.0,-73.0,-72.0,-69.0,-61.0,-72.0,-71.0,-69.0,-60.0,-90.0,-93.0,-89.0,-93.0,17.0,21.0,20.0,32.0,1
295,BA:8C:B9:54:50:24,3851136,491264370,4925,6193310,3846211,485071060,7,9724,1749746,9702,1746251,22,3495,2358,17,5423,41,7,70,216660.0,130000.0,-48.0,-35.0,-42.0,-46.0,-44.0,-35.0,-43.0,-47.0,-90.0,-93.0,-89.0,-93.0,42.0,58.0,47.0,47.0,1
296,62:47:05:9D:EB:15,3852954,497252900,6743,12181840,3846211,485071060,1,6953,3801165,6903,3793507,50,7658,3314,0,6806,56,1,125,229410.0,130000.0,-43.0,-44.0,-36.0,-49.0,-43.0,-46.0,-38.0,-47.0,-90.0,-93.0,-89.0,-93.0,47.0,49.0,53.0,44.0,1
297,92:69:1D:31:68:E9,3850252,488723293,4041,3652233,3846211,485071060,1,5374,1155552,5205,1117169,169,38383,2200,12,4291,103,1,61,229410.0,130000.0,-52.0,-48.0,-44.0,-47.0,-51.0,-48.0,-44.0,-47.0,-90.0,-93.0,-89.0,-93.0,38.0,45.0,45.0,46.0,1
298,CC:2F:71:3F:1F:24,5001910,1806530423,1155699,1321459363,3846211,485071060,1730,968219,1094978378,967393,1094878544,826,99834,936016,15,1154324,119815,1727,757,130000.0,43333.0,-69.0,-69.0,-69.0,-77.0,-69.0,-69.0,-68.0,-76.0,-90.0,-93.0,-89.0,-93.0,21.0,24.0,20.0,16.0,1
299,CC:2F:71:3E:C5:1F,3847194,485191185,982,120065,3846212,485071120,2,4256,355367,3541,270467,715,84900,1041,13,1410,28,2,54,144444.0,39000.0,-73.0,-72.0,-69.0,-61.0,-72.0,-71.0,-69.0,-60.0,-90.0,-93.0,-89.0,-93.0,17.0,21.0,20.0,32.0,1
300,BA:8C:B9:54:50:24,3851139,491264632,4925,6193310,3846214,485071322,7,9724,1749746,9702,1746251,22,3495,2358,17,5423,41,7,70,216660.0,130000.0,-48.0,-35.0,-42.0,-46.0,-44.0,-35.0,-43.0,-47.0,-90.0,-93.0,-89.0,-93.0,42.0,58.0,47.0,47.0,1
301,62:47:05:9D:EB:15,3852964,497253828,6743,12181840,3846221,485071988,1,6953,3801165,6903,3793507,50,7658,3314,0,6806,56,1,125,229410.0,130000.0,-43.0,-44.0,-36.0,-49.0,-43.0,-46.0,-38.0,-47.0,-90.0,-93.0,-89.0,-93.0,47.0,49.0,53.0,44.0,1
302,92:69:1D:31:68:E9,3850262,488724221,4041,3652233,3846221,485071988,1,5374,1155552,5205,1117169,169,38383,2200,12,4291,103,1,61,229410.0,130000.0,-52.0,-48.0,-44.0,-47.0,-51.0,-48.0,-44.0,-47.0,-90.0,-93.0,-89.0,-93.0,38.0,45.0,45.0,46.0,1
303,CC:2F:71:3F:1F:24,5002116,1806779087,1155895,1321707099,3846221,485071988,1730,968396,1095211278,967570,1095111444,826,99834,936193,15,1154520,119815,1727,757,130000.0,43333.0,-69.0,-69.0,-68.0,-76.0,-69.0,-69.0,-68.0,-76.0,-90.0,-93.0,-89.0,-93.0,21.0,24.0,21.0,17.0,1
304,CC:2F:71:3E:C5:1F,3847203,485192053,982,120065,3846221,485071988,2,4256,355367,3541,270467,715,84900,1041,13,1410,28,2,54,144444.0,39000.0,-73.0,-72.0,-69.0,-61.0,-72.0,-71.0,-69.0,-60.0,-90.0,-93.0,-89.0,-93.0,17.0,21.0,20.0,32.0,1
305,BA:8C:B9:54:50:24,3851146,491265298,4925,6193310,3846221,485071988,7,9724,1749746,9702,1746251,22,3495,2358,17,5423,41,7,70,216660.0,130000.0,-48.0,-35.0,-42.0,-46.0,-44.0,-35.0,-43.0,-47.0,-90.0,-93.0,-89.0,-93.0,42.0,58.0,47.0,47.0,1
306,62:47:05:9D:EB:15,3852966,497253950,6743,12181840,3846223,485072110,1,6953,3801165,6903,3793507,50,7658,3314,0,6806,56,1,125,229410.0,130000.0,-43.0,-44.0,-36.0,-49.0,-43.0,-46.0,-38.0,-47.0,-90.0,-93.0,-89.0,-93.0,47.0,49.0,53.0,44.0,1
307,92:69:1D:31:68:E9,3850264,488724343,4041,3652233,3846223,485072110,1,5374,1155552,5205,1117169,169,38383,2200,12,4291,103,1,61,229410.0,130000.0,-52.0,-48.0,-44.0,-47.0,-51.0,-48.0,-44.0,-47.0,-90.0,-93.0,-89.0,-93.0,38.0,45.0,45.0,46.0,1
308,CC:2F:71:3F:1F:24,5002312,1807020875,1156087,1321948563,3846225,485072312,1730,968571,1095438252,967744,1095338300,827,99952,936368,15,1154712,119817,1727,757,130000.0,39000.0,-69.0,-69.0,-68.0,-76.0,-69.0,-69.0,-68.0,-76.0,-90.0,-93.0,-89.0,-93.0,21.0,24.0,21.0,17.0,1
309,CC:2F:71:3E:C5:1F,3847207,485192377,982,120065,3846225,485072312,2,4256,355367,3541,270467,715,84900,1041,13,1410,28,2,54,144444.0,39000.0,-73.0,-72.0,-69.0,-61.0,-72.0,-71.0,-69.0,-60.0,-90.0,-93.0,-89.0,-93.0,17.0,21.0,20.0,32.0,1
310,BA:8C:B9:54:50:24,3851150,491265622,4925,6193310,3846225,485072312,7,9724,1749746,9702,1746251,22,3495,2358,17,5423,41,7,70,216660.0,130000.0,-48.0,-35.0,-42.0,-46.0,-44.0,-35.0,-43.0,-47.0,-90.0,-93.0,-89.0,-93.0,42.0,58.0,47.0,47.0,1
311,62:47:05:9D:EB:15,3852975,497254818,6743,12181840,3846232,485072978,1,6953,3801165,6903,3793507,50,7658,3314,0,6806,56,1,125,229410.0,130000.0,-43.0,-44.0,-36.0,-49.0,-43.0,-46.0,-38.0,-47.0,-90.0,-93.0,-89.0,-93.0,47.0,49.0,53.0,44.0,1
312,92:69:1D:31:68:E9,3850273,488725211,4041,3652233,3846232,485072978,1,5374,1155552,5205,1117169,169,38383,2200,12,4291,103,1,61,229410.0,130000.0,-52.0,-48.0,-44.0,-47.0,-51.0,-48.0,-44.0,-47.0,-90.0,-93.0,-89.0,-93.0,38.0,45.0,45.0,46.0,1
313,CC:2F:71:3F:1F:24,5002512,1807264447,1156280,1322191469,3846232,485072978,1730,968741,1095667506,967914,1095567554,827,99952,936537,15,1154905,119825,1727,757,130000.0,43333.0,-69.0,-69.0,-68.0,-76.0,-69.0,-69.0,-68.0,-76.0,-90.0,-93.0,-89.0,-93.0,21.0,24.0,21.0,17.0,1
314,CC:2F:71:3E:C5:1F,3847214,485193043,982,120065,3846232,485072978,2,4256,355367,3541,270467,715,84900,1041,13,1410,28,2,54,144444.0,39000.0,-73.0,-72.0,-69.0,-61.0,-72.0,-71.0,-69.0,-60.0,-90.0,-93.0,-89.0,-93.0,17.0,21.0,20.0,32.0,1
315,BA:8C:B9:54:50:24,3851157,491266288,4925,6193310,3846232,485072978,7,9724,1749746,9702,1746251,22,3495,2358,17,5423,41,7,70,216660.0,130000.0,-48.0,-35.0,-42.0,-46.0,-44.0,-35.0,-43.0,-47.0,-90.0,-93.0,-89.0,-93.0,42.0,58.0,47.0,47.0,1
316,62:47:05:9D:EB:15,3852976,497254878,6743,12181840,3846233,485073038,1,6954,3801233,6904,3793575,50,7658,3314,0,6807,56,1,125,229410.0,130000.0,-44.0,-45.0,-36.0,-49.0,-43.0,-46.0,-37.0,-47.0,-90.0,-93.0,-89.0,-93.0,46.0,48.0,53.0,44.0,1
317,92:69:1D:31:68:E9,3850277,488725533,4041,3652233,3846236,485073300,1,5376,1155688,5207,1117305,169,38383,2200,12,4292,103,1,61,229410.0,130000.0,-52.0,-48.0,-42.0,-49.0,-51.0,-48.0,-44.0,-47.0,-90.0,-93.0,-89.0,-93.0,38.0,45.0,47.0,44.0,1
318,CC:2F:71:3F:1F:24,5002717,1807511444,1156481,1322438144,3846236,485073300,1730,968921,1095896978,968094,1095797026,827,99952,936717,15,1155106,119825,1727,757,130000.0,43333.0,-69.0,-69.0,-69.0,-77.0,-69.0,-69.0,-68.0,-76.0,-90.0,-93.0,-89.0,-93.0,21.0,24.0,20.0,16.0,1
319,CC:2F:71:3E:C5:1F,3847218,485193365,982,120065,3846236,485073300,2,4258,355507,3543,270607,715,84900,1041,13,1411,28,2,54,144444.0,39000.0,-67.0,-65.0,-64.0,-61.0,-71.0,-70.0,-68.0,-60.0,-90.0,-93.0,-89.0,-93.0,23.0,28.0,25.0,32.0,1
320,BA:8C:B9:54:50:24,3851163,491266812,4925,6193310,3846238,485073502,7,9726,1749882,9704,1746387,22,3495,2358,17,5424,41,7,70,216660.0,130000.0,-50.0,-35.0,-43.0,-45.0,-44.0,-35.0,-43.0,-47.0,-90.0,-93.0,-89.0,-93.0,40.0,58.0,46.0,48.0,1
321,62:47:05:9D:EB:15,3852985,497255746,6743,12181840,3846242,485073906,1,6955,3801301,6905,3793643,50,7658,3314,0,6807,56,1,125,229410.0,130000.0,-44.0,-45.0,-36.0,-49.0,-43.0,-46.0,-37.0,-47.0,-90.0,-93.0,-89.0,-93.0,46.0,48.0,53.0,44.0,1
322,92:69:1D:31:68:E9,3850283,488726139,4041,3652233,3846242,485073906,1,5376,1155688,5207,1117305,169,38383,2200,12,4292,103,1,61,229410.0,130000.0,-52.0,-48.0,-42.0,-49.0,-51.0,-48.0,-44.0,-47.0,-90.0,-93.0,-89.0,-93.0,38.0,45.0,47.0,44.0,1
323,CC:2F:71:3F:1F:24,5002915,1807753346,1156673,1322679440,3846242,485073906,1730,969090,1096123254,968263,1096023302,827,99952,936886,15,1155298,119831,1727,757,130000.0,43333.0,-69.0,-69.0,-69.0,-77.0,-69.0,-69.0,-68.0,-76.0,-90.0,-93.0,-89.0,-93.0,21.0,24.0,20.0,16.0,1
324,CC:2F:71:3E:C5:1F,3847224,485193971,982,120065,3846242,485073906,2,4258,355507,3543,270607,715,84900,1041,13,1411,28,2,54,144444.0,39000.0,-67.0,-65.0,-64.0,-61.0,-71.0,-70.0,-68.0,-60.0,-90.0,-93.0,-89.0,-93.0,23.0,28.0,25.0,32.0,1
325,BA:8C:B9:54:50:24,3851167,491267216,4925,6193310,3846242,485073906,7,9726,1749882,9704,1746387,22,3495,2358,17,5424,41,7,70,216660.0,130000.0,-50.0,-35.0,-43.0,-45.0,-44.0,-35.0,-43.0,-47.0,-90.0,-93.0,-89.0,-93.0,40.0,58.0,46.0,48.0,1
326,62:47:05:9D:EB:15,3852987,497255866,6743,12181840,3846244,485074026,1,6955,3801301,6905,3793643,50,7658,3314,0,6807,56,1,125,229410.0,130000.0,-44.0,-45.0,-36.0,-49.0,-43.0,-46.0,-37.0,-47.0,-90.0,-93.0,-89.0,-93.0,46.0,48.0,53.0,44.0,1
327,92:69:1D:31:68:E9,3850287,488726461,4041,3652233,3846246,485074228,1,5376,1155688,5207,1117305,169,38383,2200,12,4292,103,1,61,229410.0,130000.0,-52.0,-48.0,-42.0,-49.0,-51.0,-48.0,-44.0,-47.0,-90.0,-93.0,-89.0,-93.0,38.0,45.0,47.0,44.0,1
328,CC:2F:71:3F:1F:24,5003111,1807995188,1156865,1322920960,3846246,485074228,1730,969257,1096347874,968430,1096247922,827,99952,937053,15,1155489,119832,1727,757,130000.0,43333.0,-69.0,-69.0,-68.0,-76.0,-69.0,-69.0,-68.0,-76.0,-90.0,-93.0,-89.0,-93.0,21.0,24.0,21.0,17.0,1
329,CC:2F:71:3E:C5:1F,3847230,485194495,982,120065,3846248,485074430,2,4258,355507,3543,270607,715,84900,1041,13,1411,28,2,54,144444.0,39000.0,-67.0,-65.0,-64.0,-61.0,-71.0,-70.0,-68.0,-60.0,-90.0,-93.0,-89.0,-93.0,23.0,28.0,25.0,32.0,1
330,BA:8C:B9:54:50:24,3851175,491267942,4925,6193310,3846250,485074632,7,9726,1749882,9704,1746387,22,3495,2358,17,5424,41,7,70,216660.0,130000.0,-50.0,-35.0,-43.0,-45.0,-44.0,-35.0,-43.0,-47.0,-90.0,-93.0,-89.0,-93.0,40.0,58.0,46.0,48.0,1
331,62:47:05:9D:EB:15,3852997,497257007,6743,12181840,3846254,485075167,1,6955,3801301,6905,3793643,50,7658,3314,0,6807,56,1,125,229410.0,130000.0,-44.0,-45.0,-36.0,-49.0,-43.0,-46.0,-37.0,-47.0,-90.0,-93.0,-89.0,-93.0,46.0,48.0,53.0,44.0,1
332,92:69:1D:31:68:E9,3850295,488727400,4041,3652233,3846254,485075167,1,5376,1155688,5207,1117305,169,38383,2200,12,4292,103,1,61,229410.0,130000.0,-52.0,-48.0,-42.0,-49.0,-51.0,-48.0,-44.0,-47.0,-90.0,-93.0,-89.0,-93.0,38.0,45.0,47.0,44.0,1
333,CC:2F:71:3F:1F:24,5003313,1808240699,1157059,1323165532,3846254,485075167,1730,969435,1096579592,968608,1096479640,827,99952,937231,15,1155684,119838,1727,758,130000.0,39000.0,-69.0,-69.0,-69.0,-77.0,-69.0,-69.0,-68.0,-76.0,-90.0,-93.0,-89.0,-93.0,21.0,24.0,20.0,16.0,1
334,CC:2F:71:3E:C5:1F,3847236,485195232,982,120065,3846254,485075167,2,4258,355507,3543,270607,715,84900,1041,13,1411,28,2,54,144444.0,39000.0,-67.0,-65.0,-64.0,-61.0,-71.0,-70.0,-68.0,-60.0,-90.0,-93.0,-89.0,-93.0,23.0,28.0,25.0,32.0,1
335,BA:8C:B9:54:50:24,3851179,491268477,4925,6193310,3846254,485075167,7,9726,1749882,9704,1746387,22,3495,2358,17,5424,41,7,70,216660.0,130000.0,-50.0,-35.0,-43.0,-45.0,-44.0,-35.0,-43.0,-47.0,-90.0,-93.0,-89.0,-93.0,40.0,58.0,46.0,48.0,1
336,62:47:05:9D:EB:15,3853002,497257471,6743,12181840,3846259,485075631,1,6955,3801301,6905,3793643,50,7658,3314,0,6807,56,1,125,229410.0,130000.0,-44.0,-45.0,-36.0,-49.0,-43.0,-46.0,-37.0,-47.0,-90.0,-93.0,-89.0,-93.0,46.0,48.0,53.0,44.0,1
337,92:69:1D:31:68:E9,3850300,488727864,4041,3652233,3846259,485075631,1,5376,1155688,5207,1117305,169,38383,2200,12,4292,103,1,61,229410.0,130000.0,-52.0,-48.0,-42.0,-49.0,-51.0,-48.0,-44.0,-47.0,-90.0,-93.0,-89.0,-93.0,38.0,45.0,47.0,44.0,1
338,CC:2F:71:3F:1F:24,5003522,1808496961,1157261,1323421128,3846261,485075833,1730,969619,1096819138,968792,1096719186,827,99952,937415,15,1155886,119840,1727,759,130000.0,43333.0,-69.0,-69.0,-70.0,-76.0,-69.0,-69.0,-69.0,-76.0,-90.0,-93.0,-89.0,-93.0,21.0,24.0,19.0,17.0,1
339,CC:2F:71:3E:C5:1F,3847244,485195958,982,120065,3846262,485075893,2,4258,355507,3543,270607,715,84900,1041,13,1411,28,2,54,144444.0,39000.0,-67.0,-65.0,-64.0,-61.0,-71.0,-70.0,-68.0,-60.0,-90.0,-93.0,-89.0,-93.0,23.0,28.0,25.0,32.0,1
340,BA:8C:B9:54:50:24,3851187,491269203,4925,6193310,3846262,485075893,7,9726,1749882,9704,1746387,22,3495,2358,17,5424,41,7,70,216660.0,130000.0,-50.0,-35.0,-43.0,-45.0,-44.0,-35.0,-43.0,-47.0,-90.0,-93.0,-89.0,-93.0,40.0,58.0,46.0,48.0,1
341,62:47:05:9D:EB:15,3853007,497257935,6743,12181840,3846264,485076095,1,6955,3801301,6905,3793643,50,7658,3314,0,6807,56,1,125,229410.0,130000.0,-44.0,-45.0,-36.0,-49.0,-43.0,-46.0,-37.0,-47.0,-90.0,-93.0,-89.0,-93.0,46.0,48.0,53.0,44.0,1
342,92:69:1D:31:68:E9,3850305,488728328,4041,3652233,3846264,485076095,1,5376,1155688,5207,1117305,169,38383,2200,12,4292,103,1,61,229410.0,130000.0,-52.0,-48.0,-42.0,-49.0,-51.0,-48.0,-44.0,-47.0,-90.0,-93.0,-89.0,-93.0,38.0,45.0,47.0,44.0,1
343,CC:2F:71:3F:1F:24,5003725,1808742050,1157460,1323665895,3846265,485076155,1730,969801,1097048911,968974,1096948959,827,99952,937596,15,1156085,119846,1727,759,130000.0,43333.0,-69.0,-69.0,-69.0,-76.0,-69.0,-69.0,-68.0,-76.0,-90.0,-93.0,-89.0,-93.0,21.0,24.0,20.0,17.0,1
344,CC:2F:71:3E:C5:1F,3847247,485196220,982,120065,3846265,485076155,2,4258,355507,3543,270607,715,84900,1041,13,1411,28,2,54,144444.0,39000.0,-67.0,-65.0,-64.0,-61.0,-71.0,-70.0,-68.0,-60.0,-90.0,-93.0,-89.0,-93.0,23.0,28.0,25.0,32.0,1
345,BA:8C:B9:54:50:24,3851190,491269465,4925,6193310,3846265,485076155,7,9726,1749882,9704,1746387,22,3495,2358,17,5424,41,7,70,216660.0,130000.0,-50.0,-35.0,-43.0,-45.0,-44.0,-35.0,-43.0,-47.0,-90.0,-93.0,-89.0,-93.0,40.0,58.0,46.0,48.0,1
346,62:47:05:9D:EB:15,3853012,497258399,6743,12181840,3846269,485076559,1,6955,3801301,6905,3793643,50,7658,3314,0,6807,56,1,125,229410.0,130000.0,-44.0,-45.0,-36.0,-49.0,-43.0,-46.0,-37.0,-47.0,-90.0,-94.0,-90.0,-93.0,46.0,49.0,54.0,44.0,1
347,92:69:1D:31:68:E9,3850312,488728994,4041,3652233,3846271,485076761,1,5376,1155688,5207,1117305,169,38383,2200,12,4292,103,1,61,229410.0,130000.0,-52.0,-48.0,-42.0,-49.0,-51.0,-48.0,-44.0,-47.0,-90.0,-94.0,-90.0,-93.0,38.0,46.0,48.0,44.0,1
348,CC:2F:71:3F:1F:24,5003924,1808985730,1157653,1323908969,3846271,485076761,1730,969976,1097277391,969149,1097177439,827,99952,937770,15,1156278,119846,1727,759,130000.0,43333.0,-69.0,-69.0,-68.0,-77.0,-69.0,-69.0,-68.0,-76.0,-90.0,-94.0,-90.0,-93.0,21.0,25.0,22.0,16.0,1
349,CC:2F:71:3E:C5:1F,3847253,485196826,982,120065,3846271,485076761,2,4258,355507,3543,270607,715,84900,1041,13,1411,28,2,54,144444.0,39000.0,-67.0,-65.0,-64.0,-61.0,-71.0,-70.0,-68.0,-60.0,-90.0,-94.0,-90.0,-93.0,23.0,29.0,26.0,32.0,1
350,BA:8C:B9:54:50:24,3851196,491270071,4925,6193310,3846271,485076761,7,9726,1749882,9704,1746387,22,3495,2358,17,5424,41,7,70,216660.0,130000.0,-50.0,-35.0,-43.0,-45.0,-44.0,-35.0,-43.0,-47.0,-90.0,-94.0,-90.0,-93.0,40.0,59.0,47.0,48.0,1
351,62:47:05:9D:EB:15,3853018,497258923,6743,12181840,3846275,485077083,1,6955,3801301,6905,3793643,50,7658,3314,0,6807,56,1,125,229410.0,130000.0,-44.0,-45.0,-36.0,-49.0,-43.0,-46.0,-37.0,-47.0,-90.0,-94.0,-90.0,-93.0,46.0,49.0,54.0,44.0,1
352,92:69:1D:31:68:E9,3850316,488729316,4041,3652233,3846275,485077083,1,5376,1155688,5207,1117305,169,38383,2200,12,4292,103,1,61,229410.0,130000.0,-52.0,-48.0,-42.0,-49.0,-51.0,-48.0,-44.0,-47.0,-90.0,-94.0,-90.0,-93.0,38.0,46.0,48.0,44.0,1
353,CC:2F:71:3F:1F:24,5004119,1809225794,1157844,1324148711,3846275,485077083,1730,970144,1097503579,969317,1097403627,827,99952,937938,15,1156469,119851,1727,760,130000.0,43333.0,-69.0,-69.0,-68.0,-76.0,-69.0,-69.0,-68.0,-76.0,-90.0,-94.0,-90.0,-93.0,21.0,25.0,22.0,17.0,1
354,CC:2F:71:3E:C5:1F,3847257,485197148,982,120065,3846275,485077083,2,4258,355507,3543,270607,715,84900,1041,13,1411,28,2,54,144444.0,39000.0,-67.0,-65.0,-64.0,-61.0,-71.0,-70.0,-68.0,-60.0,-90.0,-94.0,-90.0,-93.0,23.0,29.0,26.0,32.0,1
355,BA:8C:B9:54:50:24,3851200,491270393,4925,6193310,3846275,485077083,7,9726,1749882,9704,1746387,22,3495,2358,17,5424,41,7,70,216660.0,130000.0,-50.0,-35.0,-43.0,-45.0,-44.0,-35.0,-43.0,-47.0,-90.0,-94.0,-90.0,-93.0,40.0,59.0,47.0,48.0,1
356,62:47:05:9D:EB:15,3853025,497259589,6743,12181840,3846282,485077749,1,6955,3801301,6905,3793643,50,7658,3314,0,6807,56,1,125,229410.0,130000.0,-44.0,-45.0,-36.0,-49.0,-43.0,-46.0,-37.0,-47.0,-90.0,-94.0,-90.0,-93.0,46.0,49.0,54.0,44.0,1
357,92:69:1D:31:68:E9,3850323,488729982,4041,3652233,3846282,485077749,1,5376,1155688,5207,1117305,169,38383,2200,12,4292,103,1,61,229410.0,130000.0,-52.0,-48.0,-42.0,-49.0,-51.0,-48.0,-44.0,-47.0,-90.0,-94.0,-90.0,-93.0,38.0,46.0,48.0,44.0,1
358,CC:2F:71:3F:1F:24,5004320,1809469650,1158038,1324391901,3846282,485077749,1730,970316,1097733055,969489,1097633103,827,99952,938109,15,1156663,119851,1727,760,130000.0,43333.0,-69.0,-69.0,-68.0,-76.0,-69.0,-69.0,-68.0,-76.0,-90.0,-94.0,-90.0,-93.0,21.0,25.0,22.0,17.0,1
359,CC:2F:71:3E:C5:1F,3847264,485197814,982,120065,3846282,485077749,2,4258,355507,3543,270607,715,84900,1041,13,1411,28,2,54,144444.0,39000.0,-67.0,-65.0,-64.0,-61.0,-71.0,-70.0,-68.0,-60.0,-90.0,-94.0,-90.0,-93.0,23.0,29.0,26.0,32.0,1
360,BA:8C:B9:54:50:24,3851209,491271261,4925,6193310,3846284,485077951,7,9726,1749882,9704,1746387,22,3495,2358,17,5424,41,7,70,216660.0,130000.0,-50.0,-35.0,-43.0,-45.0,-44.0,-35.0,-43.0,-47.0,-90.0,-94.0,-90.0,-93.0,40.0,59.0,47.0,48.0,1
361,62:47:05:9D:EB:15,3853028,497259851,6743,12181840,3846285,485078011,1,6955,3801301,6905,3793643,50,7658,3314,0,6807,56,1,125,229410.0,130000.0,-44.0,-45.0,-36.0,-49.0,-43.0,-46.0,-37.0,-47.0,-90.0,-94.0,-90.0,-93.0,46.0,49.0,54.0,44.0,1
362,92:69:1D:31:68:E9,3850326,488730244,4041,3652233,3846285,485078011,1,5376,1155688,5207,1117305,169,38383,2200,12,4292,103,1,61,229410.0,130000.0,-52.0,-48.0,-42.0,-49.0,-51.0,-48.0,-44.0,-47.0,-90.0,-94.0,-90.0,-93.0,38.0,46.0,48.0,44.0,1
363,CC:2F:71:3F:1F:24,5004514,1809709878,1158229,1324631867,3846285,485078011,1730,970483,1097956251,969656,1097856299,827,99952,938276,15,1156853,119852,1727,760,130000.0,43333.0,-69.0,-69.0,-69.0,-76.0,-69.0,-69.0,-68.0,-76.0,-90.0,-94.0,-90.0,-93.0,21.0,25.0,21.0,17.0,1
364,CC:2F:71:3E:C5:1F,3847267,485198076,982,120065,3846285,485078011,2,4258,355507,3543,270607,715,84900,1041,13,1411,28,2,54,144444.0,39000.0,-67.0,-65.0,-64.0,-61.0,-71.0,-70.0,-68.0,-60.0,-90.0,-94.0,-90.0,-93.0,23.0,29.0,26.0,32.0,1
365,BA:8C:B9:54:50:24,3851211,491271381,4925,6193310,3846286,485078071,7,9726,1749882,9704,1746387,22,3495,2358,17,5424,41,7,70,216660.0,130000.0,-50.0,-35.0,-43.0,-45.0,-44.0,-35.0,-43.0,-47.0,-90.0,-94.0,-90.0,-93.0,40.0,59.0,47.0,48.0,1
366,62:47:05:9D:EB:15,3853035,497260517,6743,12181840,3846292,485078677,1,6955,3801301,6905,3793643,50,7658,3314,0,6807,56,1,125,229410.0,130000.0,-44.0,-45.0,-36.0,-49.0,-43.0,-46.0,-37.0,-47.0,-90.0,-94.0,-90.0,-93.0,46.0,49.0,54.0,44.0,1
367,92:69:1D:31:68:E9,3850333,488730910,4041,3652233,3846292,485078677,1,5377,1155756,5208,1117373,169,38383,2200,12,4292,103,1,61,229410.0,130000.0,-52.0,-48.0,-44.0,-47.0,-51.0,-48.0,-44.0,-47.0,-90.0,-94.0,-90.0,-93.0,38.0,46.0,46.0,46.0,1
368,CC:2F:71:3F:1F:24,5004727,1809960497,1158433,1324881618,3846294,485078879,1730,970665,1098190316,969838,1098090364,827,99952,938458,15,1157058,119858,1727,760,130000.0,43333.0,-69.0,-69.0,-69.0,-76.0,-69.0,-69.0,-68.0,-76.0,-90.0,-94.0,-90.0,-93.0,21.0,25.0,21.0,17.0,1
369,CC:2F:71:3E:C5:1F,3847276,485198944,982,120065,3846294,485078879,2,4258,355507,3543,270607,715,84900,1041,13,1411,28,2,54,144444.0,39000.0,-67.0,-65.0,-64.0,-61.0,-71.0,-70.0,-68.0,-60.0,-90.0,-94.0,-90.0,-93.0,23.0,29.0,26.0,32.0,1
370,BA:8C:B9:54:50:24,3851220,491272249,4925,6193310,3846295,485078939,7,9726,1749882,9704,1746387,22,3495,2358,17,5424,41,7,70,216660.0,130000.0,-50.0,-35.0,-43.0,-45.0,-44.0,-35.0,-43.0,-47.0,-90.0,-94.0,-90.0,-93.0,40.0,59.0,47.0,48.0,1
371,62:47:05:9D:EB:15,3853038,497260779,6743,12181840,3846295,485078939,1,6955,3801301,6905,3793643,50,7658,3314,0,6807,56,1,125,229410.0,130000.0,-44.0,-45.0,-36.0,-49.0,-43.0,-46.0,-37.0,-47.0,-90.0,-94.0,-90.0,-93.0,46.0,49.0,54.0,44.0,1
372,92:69:1D:31:68:E9,3850337,488731298,4041,3652233,3846296,485079065,1,5377,1155756,5208,1117373,169,38383,2200,12,4292,103,1,61,229410.0,130000.0,-52.0,-48.0,-44.0,-47.0,-51.0,-48.0,-44.0,-47.0,-90.0,-94.0,-90.0,-93.0,38.0,46.0,46.0,46.0,1
373,CC:2F:71:3F:1F:24,5004921,1810202203,1158625,1325123138,3846296,485079065,1730,970836,1098416824,970009,1098316872,827,99952,938629,15,1157250,119858,1727,760,130000.0,43333.0,-69.0,-69.0,-68.0,-76.0,-69.0,-69.0,-68.0,-76.0,-90.0,-94.0,-90.0,-93.0,21.0,25.0,22.0,17.0,1
374,CC:2F:71:3E:C5:1F,3847278,485199130,982,120065,3846296,485079065,2,4258,355507,3543,270607,715,84900,1041,13,1411,28,2,54,144444.0,39000.0,-67.0,-65.0,-64.0,-61.0,-71.0,-70.0,-68.0,-60.0,-90.0,-94.0,-90.0,-93.0,23.0,29.0,26.0,32.0,1
375,BA:8C:B9:54:50:24,3851221,491272375,4925,6193310,3846296,485079065,7,9726,1749882,9704,1746387,22,3495,2358,17,5424,41,7,70,216660.0,130000.0,-50.0,-35.0,-43.0,-45.0,-44.0,-35.0,-43.0,-47.0,-90.0,-94.0,-90.0,-93.0,40.0,59.0,47.0,48.0,1
376,62:47:05:9D:EB:15,3853047,497261631,6743,12181840,3846304,485079791,1,6955,3801301,6905,3793643,50,7658,3314,0,6807,56,1,125,229410.0,130000.0,-44.0,-45.0,-36.0,-49.0,-43.0,-46.0,-37.0,-47.0,-91.0,-94.0,-90.0,-93.0,47.0,49.0,54.0,44.0,1
377,92:69:1D:31:68:E9,3850347,488732226,4041,3652233,3846306,485079993,1,5377,1155756,5208,1117373,169,38383,2200,12,4292,103,1,61,229410.0,130000.0,-52.0,-48.0,-44.0,-47.0,-51.0,-48.0,-44.0,-47.0,-91.0,-94.0,-90.0,-93.0,39.0,46.0,46.0,46.0,1
378,CC:2F:71:3F:1F:24,5005124,1810445981,1158818,1325365988,3846306,485079993,1730,971005,1098643100,970178,1098543148,827,99952,938798,15,1157443,119863,1727,760,130000.0,43333.0,-69.0,-69.0,-70.0,-76.0,-69.0,-69.0,-68.0,-76.0,-91.0,-94.0,-90.0,-93.0,22.0,25.0,20.0,17.0,1
379,CC:2F:71:3E:C5:1F,3847288,485200058,982,120065,3846306,485079993,2,4258,355507,3543,270607,715,84900,1041,13,1411,28,2,54,144444.0,39000.0,-67.0,-65.0,-64.0,-61.0,-71.0,-70.0,-68.0,-60.0,-91.0,-94.0,-90.0,-93.0,24.0,29.0,26.0,32.0,1
380,BA:8C:B9:54:50:24,3851231,491273303,4925,6193310,3846306,485079993,7,9726,1749882,9704,1746387,22,3495,2358,17,5424,41,7,70,216660.0,130000.0,-50.0,-35.0,-43.0,-45.0,-44.0,-35.0,-43.0,-47.0,-91.0,-94.0,-90.0,-93.0,41.0,59.0,47.0,48.0,1
381,62:47:05:9D:EB:15,3853051,497262009,6744,12181956,3846307,485080053,1,6957,3801437,6907,3793779,50,7658,3314,0,6808,56,1,125,229410.0,130000.0,-43.0,-44.0,-36.0,-50.0,-43.0,-45.0,-36.0,-48.0,-91.0,-94.0,-90.0,-93.0,48.0,50.0,54.0,43.0,1
382,92:69:1D:31:68:E9,3850349,488732402,4042,3652349,3846307,485080053,1,5379,1155892,5210,1117509,169,38383,2200,12,4293,103,1,61,229410.0,130000.0,-51.0,-48.0,-44.0,-47.0,-51.0,-48.0,-43.0,-47.0,-91.0,-94.0,-90.0,-93.0,40.0,46.0,46.0,46.0,1
383,CC:2F:71:3F:1F:24,5005318,1810687693,1159011,1325607640,3846307,485080053,1730,971177,1098871176,970350,1098771224,827,99952,938970,15,1157636,119863,1727,760,130000.0,43333.0,-69.0,-69.0,-68.0,-76.0,-69.0,-69.0,-68.0,-76.0,-91.0,-94.0,-90.0,-93.0,22.0,25.0,22.0,17.0,1
384,CC:2F:71:3E:C5:1F,3847290,485200234,983,120181,3846307,485080053,2,4260,355647,3545,270747,715,84900,1041,13,1412,28,2,54,144444.0,39000.0,-73.0,-72.0,-70.0,-61.0,-72.0,-70.0,-69.0,-60.0,-91.0,-94.0,-90.0,-93.0,18.0,22.0,20.0,32.0,1
385,BA:8C:B9:54:50:24,3851233,491273479,4926,6193426,3846307,485080053,7,9728,1750018,9706,1746523,22,3495,2358,17,5425,41,7,70,216660.0,130000.0,-51.0,-35.0,-43.0,-45.0,-45.0,-35.0,-43.0,-47.0,-91.0,-94.0,-90.0,-93.0,40.0,59.0,47.0,48.0,1
386,62:47:05:9D:EB:15,3853059,497262817,6744,12181956,3846315,485080861,1,6957,3801437,6907,3793779,50,7658,3314,0,6808,56,1,125,229410.0,130000.0,-43.0,-44.0,-36.0,-50.0,-43.0,-45.0,-36.0,-48.0,-91.0,-94.0,-90.0,-93.0,48.0,50.0,54.0,43.0,1
387,92:69:1D:31:68:E9,3850358,488733270,4042,3652349,3846316,485080921,1,5379,1155892,5210,1117509,169,38383,2200,12,4293,103,1,61,229410.0,130000.0,-51.0,-48.0,-44.0,-47.0,-51.0,-48.0,-43.0,-47.0,-91.0,-94.0,-90.0,-93.0,40.0,46.0,46.0,46.0,1
388,CC:2F:71:3F:1F:24,5005517,1810931245,1159201,1325850324,3846316,485080921,1730,971347,1099099006,970520,1098999054,827,99952,939139,15,1157826,119863,1727,760,130000.0,43333.0,-69.0,-69.0,-68.0,-76.0,-69.0,-69.0,-68.0,-76.0,-91.0,-94.0,-90.0,-93.0,22.0,25.0,22.0,17.0,1
389,CC:2F:71:3E:C5:1F,3847299,485201102,983,120181,3846316,485080921,2,4260,355647,3545,270747,715,84900,1041,13,1412,28,2,54,144444.0,39000.0,-73.0,-72.0,-70.0,-61.0,-72.0,-70.0,-69.0,-60.0,-91.0,-94.0,-90.0,-93.0,18.0,22.0,20.0,32.0,1
390,BA:8C:B9:54:50:24,3851243,491274407,4926,6193426,3846317,485080981,7,9728,1750018,9706,1746523,22,3495,2358,17,5425,41,7,70,216660.0,130000.0,-51.0,-35.0,-43.0,-45.0,-45.0,-35.0,-43.0,-47.0,-91.0,-94.0,-90.0,-93.0,40.0,59.0,47.0,48.0,1
391,62:47:05:9D:EB:15,3853061,497262937,6744,12181956,3846317,485080981,1,6957,3801437,6907,3793779,50,7658,3314,0,6808,56,1,125,229410.0,130000.0,-43.0,-44.0,-36.0,-50.0,-43.0,-45.0,-36.0,-48.0,-91.0,-94.0,-90.0,-93.0,48.0,50.0,54.0,43.0,1
392,92:69:1D:31:68:E9,3850359,488733330,4042,3652349,3846317,485080981,1,5379,1155892,5210,1117509,169,38383,2200,12,4293,103,1,61,229410.0,130000.0,-51.0,-48.0,-44.0,-47.0,-51.0,-48.0,-43.0,-47.0,-91.0,-94.0,-90.0,-93.0,40.0,46.0,46.0,46.0,1
393,CC:2F:71:3F:1F:24,5005717,1811178920,1159400,1326097939,3846317,485080981,1730,971525,1099329670,970698,1099229718,827,99952,939317,15,1158025,119867,1727,760,130000.0,43333.0,-69.0,-69.0,-69.0,-76.0,-69.0,-69.0,-68.0,-76.0,-91.0,-94.0,-90.0,-93.0,22.0,25.0,21.0,17.0,1
394,CC:2F:71:3E:C5:1F,3847300,485201162,983,120181,3846317,485080981,2,4260,355647,3545,270747,715,84900,1041,13,1412,28,2,54,144444.0,39000.0,-73.0,-72.0,-70.0,-61.0,-72.0,-70.0,-69.0,-60.0,-91.0,-94.0,-90.0,-93.0,18.0,22.0,20.0,32.0,1
395,BA:8C:B9:54:50:24,3851245,491274609,4926,6193426,3846319,485081183,7,9728,1750018,9706,1746523,22,3495,2358,17,5425,41,7,70,216660.0,130000.0,-51.0,-35.0,-43.0,-45.0,-45.0,-35.0,-43.0,-47.0,-91.0,-94.0,-90.0,-93.0,40.0,59.0,47.0,48.0,1
396,62:47:05:9D:EB:15,3853071,497264078,6744,12181956,3846327,485082122,1,6957,3801437,6907,3793779,50,7658,3314,0,6808,56,1,125,229410.0,130000.0,-43.0,-44.0,-36.0,-50.0,-43.0,-45.0,-36.0,-48.0,-91.0,-94.0,-90.0,-93.0,48.0,50.0,54.0,43.0,1
397,92:69:1D:31:68:E9,3850369,488734471,4042,3652349,3846327,485082122,1,5379,1155892,5210,1117509,169,38383,2200,12,4293,103,1,61,229410.0,130000.0,-51.0,-48.0,-44.0,-47.0,-51.0,-48.0,-43.0,-47.0,-91.0,-94.0,-90.0,-93.0,40.0,46.0,46.0,46.0,1
398,CC:2F:71:3F:1F:24,5005918,1811424299,1159591,1326342177,3846327,485082122,1730,971694,1099557370,970867,1099457418,827,99952,939486,15,1158215,119867,1727,760,130000.0,43333.0,-69.0,-69.0,-68.0,-77.0,-69.0,-69.0,-68.0,-76.0,-91.0,-94.0,-90.0,-93.0,22.0,25.0,22.0,16.0,1
399,CC:2F:71:3E:C5:1F,3847310,485202303,983,120181,3846327,485082122,2,4260,355647,3545,270747,715,84900,1041,13,1412,28,2,54,144444.0,39000.0,-73.0,-72.0,-70.0,-61.0,-72.0,-70.0,-69.0,-60.0,-91.0,-94.0,-90.0,-93.0,18.0,22.0,20.0,32.0,1
400,BA:8C:B9:54:50:24,3851253,491275548,4926,6193426,3846327,485082122,7,9728,1750018,9706,1746523,22,3495,2358,17,5425,41,7,70,216660.0,130000.0,-51.0,-35.0,-43.0,-45.0,-45.0,-35.0,-43.0,-47.0,-91.0,-94.0,-90.0,-93.0,40.0,59.0,47.0,48.0,1
401,62:47:05:9D:EB:15,3853073,497264198,6744,12181956,3846329,485082242,1,6957,3801437,6907,3793779,50,7658,3314,0,6808,56,1,125,229410.0,130000.0,-43.0,-44.0,-36.0,-50.0,-43.0,-45.0,-36.0,-48.0,-91.0,-94.0,-90.0,-93.0,48.0,50.0,54.0,43.0,1
402,92:69:1D:31:68:E9,3850371,488734591,4042,3652349,3846329,485082242,1,5379,1155892,5210,1117509,169,38383,2200,12,4293,103,1,61,229410.0,130000.0,-51.0,-48.0,-44.0,-47.0,-51.0,-48.0,-43.0,-47.0,-91.0,-94.0,-90.0,-93.0,40.0,46.0,46.0,46.0,1
403,CC:2F:71:3F:1F:24,5006110,1811666879,1159781,1326584637,3846329,485082242,1730,971863,1099785070,971036,1099685118,827,99952,939655,15,1158406,119871,1727,760,130000.0,43333.0,-69.0,-69.0,-68.0,-76.0,-69.0,-69.0,-68.0,-76.0,-91.0,-94.0,-90.0,-93.0,22.0,25.0,22.0,17.0,1
404,CC:2F:71:3E:C5:1F,3847314,485202625,983,120181,3846331,485082444,2,4260,355647,3545,270747,715,84900,1041,13,1412,28,2,54,144444.0,39000.0,-73.0,-72.0,-70.0,-61.0,-72.0,-70.0,-69.0,-60.0,-91.0,-94.0,-90.0,-93.0,18.0,22.0,20.0,32.0,1
405,BA:8C:B9:54:50:24,3851257,491275870,4926,6193426,3846331,485082444,7,9728,1750018,9706,1746523,22,3495,2358,17,5425,41,7,70,216660.0,130000.0,-51.0,-35.0,-43.0,-45.0,-45.0,-35.0,-43.0,-47.0,-91.0,-94.0,-90.0,-93.0,40.0,59.0,47.0,48.0,1
406,62:47:05:9D:EB:15,3853083,497265128,6744,12181956,3846339,485083172,1,6957,3801437,6907,3793779,50,7658,3314,0,6808,56,1,125,229410.0,130000.0,-43.0,-44.0,-36.0,-50.0,-43.0,-45.0,-36.0,-48.0,-91.0,-94.0,-90.0,-93.0,48.0,50.0,54.0,43.0,1
407,92:69:1D:31:68:E9,3850383,488735889,4042,3652349,3846341,485083540,1,5379,1155892,5210,1117509,169,38383,2200,12,4293,103,1,61,229410.0,130000.0,-51.0,-48.0,-44.0,-47.0,-51.0,-48.0,-43.0,-47.0,-91.0,-94.0,-90.0,-93.0,40.0,46.0,46.0,46.0,1
408,CC:2F:71:3F:1F:24,5006312,1811910861,1159971,1326827321,3846341,485083540,1730,972034,1100014428,971206,1099914358,828,100070,939826,15,1158596,119871,1727,760,130000.0,43333.0,-69.0,-69.0,-69.0,-76.0,-69.0,-69.0,-68.0,-76.0,-91.0,-94.0,-90.0,-93.0,22.0,25.0,21.0,17.0,1
409,CC:2F:71:3E:C5:1F,3847324,485203721,983,120181,3846341,485083540,2,4260,355647,3545,270747,715,84900,1041,13,1412,28,2,54,144444.0,39000.0,-73.0,-72.0,-70.0,-61.0,-72.0,-70.0,-69.0,-60.0,-91.0,-94.0,-90.0,-93.0,18.0,22.0,20.0,32.0,1
410,BA:8C:B9:54:50:24,3851267,491276966,4926,6193426,3846341,485083540,7,9728,1750018,9706,1746523,22,3495,2358,17,5425,41,7,70,216660.0,130000.0,-51.0,-35.0,-43.0,-45.0,-45.0,-35.0,-43.0,-47.0,-91.0,-94.0,-90.0,-93.0,40.0,59.0,47.0,48.0,1
411,62:47:05:9D:EB:15,3853085,497265496,6744,12181956,3846341,485083540,1,6957,3801437,6907,3793779,50,7658,3314,0,6808,56,1,125,229410.0,130000.0,-43.0,-44.0,-36.0,-50.0,-43.0,-45.0,-36.0,-48.0,-91.0,-94.0,-90.0,-93.0,48.0,50.0,54.0,43.0,1
412,92:69:1D:31:68:E9,3850385,488736091,4042,3652349,3846343,485083742,1,5379,1155892,5210,1117509,169,38383,2200,12,4293,103,1,61,229410.0,130000.0,-51.0,-48.0,-44.0,-47.0,-51.0,-48.0,-43.0,-47.0,-91.0,-94.0,-90.0,-93.0,40.0,46.0,46.0,46.0,1
413,CC:2F:71:3F:1F:24,5006504,1812152309,1160161,1327068567,3846343,485083742,1730,972204,1100240810,971376,1100140740,828,100070,939996,15,1158786,119872,1727,760,130000.0,43333.0,-69.0,-69.0,-68.0,-77.0,-69.0,-69.0,-68.0,-76.0,-91.0,-94.0,-90.0,-93.0,22.0,25.0,22.0,16.0,1
414,CC:2F:71:3E:C5:1F,3847327,485203983,983,120181,3846344,485083802,2,4260,355647,3545,270747,715,84900,1041,13,1412,28,2,54,144444.0,39000.0,-73.0,-72.0,-70.0,-61.0,-72.0,-70.0,-69.0,-60.0,-91.0,-94.0,-90.0,-93.0,18.0,22.0,20.0,32.0,1
415,BA:8C:B9:54:50:24,3851271,491277288,4926,6193426,3846345,485083862,7,9728,1750018,9706,1746523,22,3495,2358,17,5425,41,7,70,216660.0,130000.0,-51.0,-35.0,-43.0,-45.0,-45.0,-35.0,-43.0,-47.0,-91.0,-94.0,-90.0,-93.0,40.0,59.0,47.0,48.0,1
416,62:47:05:9D:EB:15,3853095,497266424,6744,12181956,3846351,485084468,1,6957,3801437,6907,3793779,50,7658,3314,0,6808,56,1,125,229410.0,130000.0,-43.0,-44.0,-36.0,-50.0,-43.0,-45.0,-36.0,-48.0,-91.0,-94.0,-90.0,-93.0,48.0,50.0,54.0,43.0,1
417,92:69:1D:31:68:E9,3850393,488736817,4042,3652349,3846351,485084468,1,5379,1155892,5210,1117509,169,38383,2200,12,4293,103,1,61,229410.0,130000.0,-51.0,-48.0,-44.0,-47.0,-51.0,-48.0,-43.0,-47.0,-91.0,-94.0,-90.0,-93.0,40.0,46.0,46.0,46.0,1
418,CC:2F:71:3F:1F:24,5006709,1812397542,1160358,1327313074,3846351,485084468,1730,972380,1100466971,971552,1100366901,828,100070,940172,15,1158982,119877,1727,760,130000.0,43333.0,-69.0,-69.0,-69.0,-76.0,-69.0,-69.0,-68.0,-76.0,-91.0,-94.0,-90.0,-93.0,22.0,25.0,21.0,17.0,1
419,CC:2F:71:3E:C5:1F,3847334,485204649,983,120181,3846351,485084468,2,4260,355647,3545,270747,715,84900,1041,13,1412,28,2,54,144444.0,39000.0,-73.0,-72.0,-70.0,-61.0,-72.0,-70.0,-69.0,-60.0,-91.0,-94.0,-90.0,-93.0,18.0,22.0,20.0,32.0,1
420,BA:8C:B9:54:50:24,3851277,491277894,4926,6193426,3846351,485084468,7,9728,1750018,9706,1746523,22,3495,2358,17,5425,41,7,70,216660.0,130000.0,-51.0,-35.0,-43.0,-45.0,-45.0,-35.0,-43.0,-47.0,-91.0,-94.0,-90.0,-93.0,40.0,59.0,47.0,48.0,1
421,62:47:05:9D:EB:15,3853098,497266686,6744,12181956,3846354,485084730,1,6957,3801437,6907,3793779,50,7658,3314,0,6808,56,1,125,229410.0,130000.0,-43.0,-44.0,-36.0,-50.0,-43.0,-45.0,-36.0,-48.0,-91.0,-93.0,-90.0,-93.0,48.0,49.0,54.0,43.0,1
422,92:69:1D:31:68:E9,3850396,488737079,4042,3652349,3846354,485084730,1,5379,1155892,5210,1117509,169,38383,2200,12,4293,103,1,61,229410.0,130000.0,-51.0,-48.0,-44.0,-47.0,-51.0,-48.0,-43.0,-47.0,-91.0,-93.0,-90.0,-93.0,40.0,45.0,46.0,46.0,1
423,CC:2F:71:3F:1F:24,5006903,1812640618,1160549,1327555888,3846354,485084730,1730,972549,1100694671,971721,1100594601,828,100070,940341,15,1159173,119877,1727,760,130000.0,43333.0,-69.0,-69.0,-68.0,-77.0,-69.0,-69.0,-68.0,-76.0,-91.0,-93.0,-90.0,-93.0,22.0,24.0,22.0,16.0,1
424,CC:2F:71:3E:C5:1F,3847337,485204911,983,120181,3846354,485084730,2,4260,355647,3545,270747,715,84900,1041,13,1412,28,2,54,144444.0,39000.0,-73.0,-72.0,-70.0,-61.0,-72.0,-70.0,-69.0,-60.0,-91.0,-93.0,-90.0,-93.0,18.0,21.0,20.0,32.0,1
425,BA:8C:B9:54:50:24,3851282,491278358,4926,6193426,3846356,485084932,7,9728,1750018,9706,1746523,22,3495,2358,17,5425,41,7,70,216660.0,130000.0,-51.0,-35.0,-43.0,-45.0,-45.0,-35.0,-43.0,-47.0,-91.0,-93.0,-90.0,-93.0,40.0,58.0,47.0,48.0,1
426,62:47:05:9D:EB:15,3853106,497267412,6744,12181956,3846362,485085456,1,6957,3801437,6907,3793779,50,7658,3314,0,6808,56,1,125,229410.0,130000.0,-43.0,-44.0,-36.0,-50.0,-43.0,-45.0,-36.0,-48.0,-91.0,-93.0,-90.0,-93.0,48.0,49.0,54.0,43.0,1
427,92:69:1D:31:68:E9,3850404,488737805,4042,3652349,3846362,485085456,1,5379,1155892,5210,1117509,169,38383,2200,12,4293,103,1,61,229410.0,130000.0,-51.0,-48.0,-44.0,-47.0,-51.0,-48.0,-43.0,-47.0,-91.0,-93.0,-90.0,-93.0,40.0,45.0,46.0,46.0,1
428,CC:2F:71:3F:1F:24,5007105,1812887172,1160743,1327801716,3846362,485085456,1730,972725,1100927455,971897,1100827385,828,100070,940517,15,1159368,119886,1727,760,130000.0,43333.0,-69.0,-69.0,-69.0,-76.0,-69.0,-69.0,-68.0,-76.0,-91.0,-93.0,-90.0,-93.0,22.0,24.0,21.0,17.0,1
429,CC:2F:71:3E:C5:1F,3847345,485205637,983,120181,3846362,485085456,2,4260,355647,3545,270747,715,84900,1041,13,1412,28,2,54,144444.0,39000.0,-73.0,-72.0,-70.0,-61.0,-72.0,-70.0,-69.0,-60.0,-91.0,-93.0,-90.0,-93.0,18.0,21.0,20.0,32.0,1
430,BA:8C:B9:54:50:24,3851288,491278882,4926,6193426,3846362,485085456,7,9728,1750018,9706,1746523,22,3495,2358,17,5425,41,7,70,216660.0,130000.0,-51.0,-35.0,-43.0,-45.0,-45.0,-35.0,-43.0,-47.0,-91.0,-93.0,-90.0,-93.0,40.0,58.0,47.0,48.0,1
431,62:47:05:9D:EB:15,3853109,497267674,6744,12181956,3846365,485085718,1,6957,3801437,6907,3793779,50,7658,3314,0,6808,56,1,125,229410.0,130000.0,-43.0,-44.0,-36.0,-50.0,-43.0,-45.0,-36.0,-48.0,-91.0,-93.0,-90.0,-93.0,48.0,49.0,54.0,43.0,1
432,92:69:1D:31:68:E9,3850407,488738067,4042,3652349,3846365,485085718,1,5379,1155892,5210,1117509,169,38383,2200,12,4293,103,1,61,229410.0,130000.0,-51.0,-48.0,-44.0,-47.0,-51.0,-48.0,-43.0,-47.0,-91.0,-93.0,-90.0,-93.0,40.0,45.0,46.0,46.0,1
433,CC:2F:71:3F:1F:24,5007300,1813128896,1160933,1328042976,3846367,485085920,1730,972894,1101153731,972066,1101053661,828,100070,940686,15,1159558,119886,1727,760,130000.0,43333.0,-69.0,-69.0,-69.0,-77.0,-69.0,-69.0,-68.0,-76.0,-91.0,-93.0,-90.0,-93.0,22.0,24.0,21.0,16.0,1
434,CC:2F:71:3E:C5:1F,3847350,485206101,983,120181,3846367,485085920,2,4260,355647,3545,270747,715,84900,1041,13,1412,28,2,54,144444.0,39000.0,-73.0,-72.0,-70.0,-61.0,-72.0,-70.0,-69.0,-60.0,-91.0,-93.0,-90.0,-93.0,18.0,21.0,20.0,32.0,1
435,BA:8C:B9:54:50:24,3851293,491279346,4926,6193426,3846367,485085920,7,9728,1750018,9706,1746523,22,3495,2358,17,5425,41,7,70,216660.0,130000.0,-51.0,-35.0,-43.0,-45.0,-45.0,-35.0,-43.0,-47.0,-91.0,-93.0,-90.0,-93.0,40.0,58.0,47.0,48.0,1
436,62:47:05:9D:EB:15,3853115,497268280,6744,12181956,3846371,485086324,1,6958,3801505,6908,3793847,50,7658,3314,0,6808,56,1,125,229410.0,130000.0,-44.0,-44.0,-35.0,-49.0,-43.0,-45.0,-36.0,-48.0,-91.0,-93.0,-90.0,-93.0,47.0,49.0,55.0,44.0,1
437,92:69:1D:31:68:E9,3850413,488738673,4042,3652349,3846371,485086324,1,5379,1155892,5210,1117509,169,38383,2200,12,4293,103,1,61,229410.0,130000.0,-51.0,-48.0,-44.0,-47.0,-51.0,-48.0,-43.0,-47.0,-91.0,-93.0,-90.0,-93.0,40.0,45.0,46.0,46.0,1
438,CC:2F:71:3F:1F:24,5007494,1813373408,1161123,1328287084,3846371,485086324,1730,973065,1101383087,972237,1101283017,828,100070,940857,15,1159748,119886,1727,760,130000.0,43333.0,-69.0,-69.0,-68.0,-76.0,-69.0,-69.0,-68.0,-76.0,-91.0,-93.0,-90.0,-93.0,22.0,24.0,22.0,17.0,1
439,CC:2F:71:3E:C5:1F,3847355,485206565,983,120181,3846372,485086384,2,4260,355647,3545,270747,715,84900,1041,13,1412,28,2,54,144444.0,39000.0,-73.0,-72.0,-70.0,-61.0,-72.0,-70.0,-69.0,-60.0,-91.0,-93.0,-90.0,-93.0,18.0,21.0,20.0,32.0,1
440,BA:8C:B9:54:50:24,3851298,491279810,4926,6193426,3846372,485086384,7,9728,1750018,9706,1746523,22,3495,2358,17,5425,41,7,70,216660.0,130000.0,-51.0,-35.0,-43.0,-45.0,-45.0,-35.0,-43.0,-47.0,-91.0,-93.0,-90.0,-93.0,40.0,58.0,47.0,48.0,1
441,62:47:05:9D:EB:15,3853120,497268664,6744,12181956,3846376,485086708,1,6958,3801505,6908,3793847,50,7658,3314,0,6808,56,1,125,229410.0,130000.0,-44.0,-44.0,-35.0,-49.0,-43.0,-45.0,-36.0,-48.0,-91.0,-93.0,-90.0,-93.0,47.0,49.0,55.0,44.0,1
442,92:69:1D:31:68:E9,3850420,488739259,4042,3652349,3846378,485086910,1,5381,1156028,5212,1117645,169,38383,2200,12,4294,103,1,61,229410.0,130000.0,-51.0,-48.0,-44.0,-47.0,-51.0,-47.0,-43.0,-47.0,-91.0,-93.0,-90.0,-93.0,40.0,45.0,46.0,46.0,1
443,CC:2F:71:3F:1F:24,5007701,1813621739,1161323,1328534829,3846378,485086910,1730,973241,1101610883,972413,1101510813,828,100070,941033,15,1159948,119891,1727,760,130000.0,43333.0,-69.0,-69.0,-69.0,-77.0,-69.0,-69.0,-69.0,-77.0,-91.0,-93.0,-90.0,-93.0,22.0,24.0,21.0,16.0,1
444,CC:2F:71:3E:C5:1F,3847361,485207091,983,120181,3846378,485086910,2,4263,355905,3547,270887,716,85018,1042,13,1413,28,2,54,144444.0,39000.0,-73.0,-72.0,-70.0,-61.0,-72.0,-71.0,-69.0,-60.0,-91.0,-93.0,-90.0,-93.0,18.0,21.0,20.0,32.0,1
445,BA:8C:B9:54:50:24,3851306,491280538,4926,6193426,3846380,485087112,7,9730,1750154,9708,1746659,22,3495,2358,17,5426,41,7,70,216660.0,130000.0,-48.0,-35.0,-42.0,-45.0,-45.0,-35.0,-43.0,-47.0,-91.0,-93.0,-90.0,-93.0,43.0,58.0,48.0,48.0,1
446,62:47:05:9D:EB:15,3853127,497269330,6744,12181956,3846383,485087374,1,6958,3801505,6908,3793847,50,7658,3314,0,6808,56,1,125,229410.0,130000.0,-44.0,-44.0,-35.0,-49.0,-43.0,-45.0,-36.0,-48.0,-91.0,-93.0,-90.0,-93.0,47.0,49.0,55.0,44.0,1
447,92:69:1D:31:68:E9,3850425,488739723,4042,3652349,3846383,485087374,1,5381,1156028,5212,1117645,169,38383,2200,12,4294,103,1,61,229410.0,130000.0,-51.0,-48.0,-44.0,-47.0,-51.0,-47.0,-43.0,-47.0,-91.0,-93.0,-90.0,-93.0,40.0,45.0,46.0,46.0,1
448,CC:2F:71:3F:1F:24,5007904,1813873033,1161521,1328785659,3846383,485087374,1730,973422,1101851413,972594,1101751343,828,100070,941213,15,1160146,119891,1727,760,130000.0,43333.0,-70.0,-69.0,-68.0,-76.0,-69.0,-69.0,-68.0,-76.0,-91.0,-93.0,-90.0,-93.0,21.0,24.0,22.0,17.0,1
449,CC:2F:71:3E:C5:1F,3847366,485207555,983,120181,3846383,485087374,2,4263,355905,3547,270887,716,85018,1042,13,1413,28,2,54,144444.0,39000.0,-73.0,-72.0,-70.0,-61.0,-72.0,-71.0,-69.0,-60.0,-91.0,-93.0,-90.0,-93.0,18.0,21.0,20.0,32.0,1
450,BA:8C:B9:54:50:24,3851309,491280800,4926,6193426,3846383,485087374,7,9730,1750154,9708,1746659,22,3495,2358,17,5426,41,7,70,216660.0,130000.0,-48.0,-35.0,-42.0,-45.0,-45.0,-35.0,-43.0,-47.0,-91.0,-93.0,-90.0,-93.0,43.0,58.0,48.0,48.0,1
451,62:47:05:9D:EB:15,3853133,497269854,6744,12181956,3846389,485087898,1,6958,3801505,6908,3793847,50,7658,3314,0,6808,56,1,125,229410.0,130000.0,-44.0,-44.0,-35.0,-49.0,-43.0,-45.0,-36.0,-48.0,-90.0,-92.0,-89.0,-92.0,46.0,48.0,54.0,43.0,1
452,92:69:1D:31:68:E9,3850431,488740247,4042,3652349,3846389,485087898,1,5381,1156028,5212,1117645,169,38383,2200,12,4294,103,1,61,229410.0,130000.0,-51.0,-48.0,-44.0,-47.0,-51.0,-47.0,-43.0,-47.0,-90.0,-92.0,-89.0,-92.0,39.0,44.0,45.0,45.0,1
453,CC:2F:71:3F:1F:24,5008103,1814116349,1161712,1329028249,3846391,485088100,1730,973593,1102077983,972765,1101977913,828,100070,941383,15,1160337,119895,1727,760,130000.0,43333.0,-70.0,-69.0,-68.0,-76.0,-70.0,-69.0,-68.0,-75.0,-90.0,-92.0,-89.0,-92.0,20.0,23.0,21.0,16.0,1
454,CC:2F:71:3E:C5:1F,3847374,485208281,983,120181,3846391,485088100,2,4263,355905,3547,270887,716,85018,1042,13,1413,28,2,54,144444.0,39000.0,-73.0,-72.0,-70.0,-61.0,-72.0,-71.0,-69.0,-60.0,-90.0,-92.0,-89.0,-92.0,17.0,20.0,19.0,31.0,1
455,BA:8C:B9:54:50:24,3851319,491281728,4926,6193426,3846393,485088302,7,9731,1750222,9709,1746727,22,3495,2358,17,5426,41,7,70,216660.0,130000.0,-40.0,-36.0,-45.0,-51.0,-45.0,-35.0,-43.0,-47.0,-90.0,-92.0,-89.0,-92.0,50.0,56.0,44.0,41.0,1
456,62:47:05:9D:EB:15,3853139,497270609,6744,12181956,3846395,485088653,1,6958,3801505,6908,3793847,50,7658,3314,0,6808,56,1,125,229410.0,130000.0,-44.0,-44.0,-35.0,-49.0,-43.0,-45.0,-36.0,-48.0,-90.0,-92.0,-89.0,-92.0,46.0,48.0,54.0,43.0,1
457,92:69:1D:31:68:E9,3850437,488741002,4042,3652349,3846395,485088653,1,5381,1156028,5212,1117645,169,38383,2200,12,4294,103,1,61,229410.0,130000.0,-51.0,-48.0,-44.0,-47.0,-51.0,-47.0,-43.0,-47.0,-90.0,-92.0,-89.0,-92.0,39.0,44.0,45.0,45.0,1
458,CC:2F:71:3F:1F:24,5008300,1814359906,1161904,1329271193,3846396,485088713,1730,973764,1102308805,972936,1102208735,828,100070,941553,15,1160529,119895,1727,760,130000.0,43333.0,-70.0,-69.0,-68.0,-76.0,-69.0,-69.0,-68.0,-76.0,-90.0,-92.0,-89.0,-92.0,20.0,23.0,21.0,16.0,1
459,CC:2F:71:3E:C5:1F,3847379,485208894,983,120181,3846396,485088713,2,4263,355905,3547,270887,716,85018,1042,13,1413,28,2,54,144444.0,39000.0,-73.0,-72.0,-70.0,-61.0,-72.0,-71.0,-69.0,-60.0,-90.0,-92.0,-89.0,-92.0,17.0,20.0,19.0,31.0,1
460,BA:8C:B9:54:50:24,3851322,491282139,4926,6193426,3846396,485088713,7,9731,1750222,9709,1746727,22,3495,2358,17,5426,41,7,70,216660.0,130000.0,-40.0,-36.0,-45.0,-51.0,-45.0,-35.0,-43.0,-47.0,-90.0,-92.0,-89.0,-92.0,50.0,56.0,44.0,41.0,1
461,62:47:05:9D:EB:15,3853144,497271073,6744,12181956,3846400,485089117,1,6958,3801505,6908,3793847,50,7658,3314,0,6808,56,1,125,229410.0,130000.0,-44.0,-44.0,-35.0,-49.0,-43.0,-45.0,-36.0,-48.0,-90.0,-92.0,-89.0,-92.0,46.0,48.0,54.0,43.0,1
462,92:69:1D:31:68:E9,3850442,488741466,4042,3652349,3846400,485089117,1,5381,1156028,5212,1117645,169,38383,2200,12,4294,103,1,61,229410.0,130000.0,-51.0,-48.0,-44.0,-47.0,-51.0,-47.0,-43.0,-47.0,-90.0,-92.0,-89.0,-92.0,39.0,44.0,45.0,45.0,1
463,CC:2F:71:3F:1F:24,5008498,1814602032,1162096,1329512713,3846402,485089319,1730,973933,1102535081,973105,1102435011,828,100070,941722,15,1160721,119895,1727,760,130000.0,43333.0,-70.0,-69.0,-68.0,-76.0,-70.0,-69.0,-68.0,-75.0,-90.0,-92.0,-89.0,-92.0,20.0,23.0,21.0,16.0,1
464,CC:2F:71:3E:C5:1F,3847388,485209762,983,120181,3846405,485089581,2,4263,355905,3547,270887,716,85018,1042,13,1413,28,2,54,144444.0,39000.0,-73.0,-72.0,-70.0,-61.0,-72.0,-71.0,-69.0,-60.0,-90.0,-92.0,-89.0,-92.0,17.0,20.0,19.0,31.0,1
465,BA:8C:B9:54:50:24,3851331,491283007,4926,6193426,3846405,485089581,7,9731,1750222,9709,1746727,22,3495,2358,17,5426,41,7,70,216660.0,130000.0,-40.0,-36.0,-45.0,-51.0,-45.0,-35.0,-43.0,-47.0,-90.0,-92.0,-89.0,-92.0,50.0,56.0,44.0,41.0,1
466,62:47:05:9D:EB:15,3853150,497271597,6744,12181956,3846406,485089641,1,6958,3801505,6908,3793847,50,7658,3314,0,6808,56,1,125,229410.0,130000.0,-44.0,-44.0,-35.0,-49.0,-43.0,-45.0,-36.0,-48.0,-90.0,-92.0,-89.0,-92.0,46.0,48.0,54.0,43.0,1
467,92:69:1D:31:68:E9,3850448,488741990,4042,3652349,3846406,485089641,1,5381,1156028,5212,1117645,169,38383,2200,12,4294,103,1,61,229410.0,130000.0,-51.0,-48.0,-44.0,-47.0,-51.0,-47.0,-43.0,-47.0,-90.0,-92.0,-89.0,-92.0,39.0,44.0,45.0,45.0,1
468,CC:2F:71:3F:1F:24,5008703,1814850229,1162297,1329760588,3846406,485089641,1730,974113,1102766005,973285,1102665935,828,100070,941902,15,1160922,119900,1727,760,130000.0,43333.0,-70.0,-69.0,-68.0,-76.0,-70.0,-69.0,-68.0,-75.0,-90.0,-92.0,-89.0,-92.0,20.0,23.0,21.0,16.0,1
469,CC:2F:71:3E:C5:1F,3847389,485209822,983,120181,3846406,485089641,2,4263,355905,3547,270887,716,85018,1042,13,1413,28,2,54,144444.0,39000.0,-73.0,-72.0,-70.0,-61.0,-72.0,-71.0,-69.0,-60.0,-90.0,-92.0,-89.0,-92.0,17.0,20.0,19.0,31.0,1
470,BA:8C:B9:54:50:24,3851334,491283269,4926,6193426,3846408,485089843,7,9731,1750222,9709,1746727,22,3495,2358,17,5426,41,7,70,216660.0,130000.0,-40.0,-36.0,-45.0,-51.0,-45.0,-35.0,-43.0,-47.0,-90.0,-92.0,-89.0,-92.0,50.0,56.0,44.0,41.0,1
471,62:47:05:9D:EB:15,3853157,497272263,6744,12181956,3846413,485090307,1,6958,3801505,6908,3793847,50,7658,3314,0,6808,56,1,125,229410.0,130000.0,-44.0,-44.0,-35.0,-49.0,-43.0,-45.0,-36.0,-48.0,-90.0,-92.0,-89.0,-92.0,46.0,48.0,54.0,43.0,1
472,92:69:1D:31:68:E9,3850455,488742656,4042,3652349,3846413,485090307,1,5381,1156028,5212,1117645,169,38383,2200,12,4294,103,1,61,229410.0,130000.0,-51.0,-48.0,-44.0,-47.0,-51.0,-47.0,-43.0,-47.0,-90.0,-92.0,-89.0,-92.0,39.0,44.0,45.0,45.0,1
473,CC:2F:71:3F:1F:24,5008902,1815092357,1162487,1330001848,3846415,485090509,1730,974282,1102992281,973454,1102892211,828,100070,942071,15,1161112,119901,1727,760,130000.0,43333.0,-70.0,-69.0,-68.0,-76.0,-70.0,-69.0,-68.0,-76.0,-90.0,-92.0,-89.0,-92.0,20.0,23.0,21.0,16.0,1
474,CC:2F:71:3E:C5:1F,3847398,485210690,983,120181,3846415,485090509,2,4263,355905,3547,270887,716,85018,1042,13,1413,28,2,54,144444.0,39000.0,-73.0,-72.0,-70.0,-61.0,-72.0,-71.0,-69.0,-60.0,-90.0,-92.0,-89.0,-92.0,17.0,20.0,19.0,31.0,1
475,BA:8C:B9:54:50:24,3851341,491283935,4926,6193426,3846415,485090509,7,9731,1750222,9709,1746727,22,3495,2358,17,5426,41,7,70,216660.0,130000.0,-40.0,-36.0,-45.0,-51.0,-45.0,-35.0,-43.0,-47.0,-90.0,-92.0,-89.0,-92.0,50.0,56.0,44.0,41.0,1
476,62:47:05:9D:EB:15,3853161,497272585,6744,12181956,3846417,485090629,1,6958,3801505,6908,3793847,50,7658,3314,0,6808,56,1,125,229410.0,130000.0,-44.0,-44.0,-35.0,-49.0,-43.0,-45.0,-36.0,-48.0,-90.0,-92.0,-89.0,-92.0,46.0,48.0,54.0,43.0,1
477,92:69:1D:31:68:E9,3850459,488742978,4042,3652349,3846417,485090629,1,5381,1156028,5212,1117645,169,38383,2200,12,4294,103,1,61,229410.0,130000.0,-51.0,-48.0,-44.0,-47.0,-51.0,-47.0,-43.0,-47.0,-90.0,-92.0,-89.0,-92.0,39.0,44.0,45.0,45.0,1
478,CC:2F:71:3F:1F:24,5009098,1815336881,1162681,1330246252,3846417,485090629,1730,974453,1103221693,973625,1103121623,828,100070,942242,15,1161306,119907,1727,760,130000.0,43333.0,-70.0,-69.0,-68.0,-76.0,-69.0,-69.0,-68.0,-76.0,-90.0,-92.0,-89.0,-92.0,20.0,23.0,21.0,16.0,1
479,CC:2F:71:3E:C5:1F,3847402,485211012,983,120181,3846419,485090831,2,4263,355905,3547,270887,716,85018,1042,13,1413,28,2,54,144444.0,39000.0,-73.0,-72.0,-70.0,-61.0,-72.0,-71.0,-69.0,-60.0,-90.0,-92.0,-89.0,-92.0,17.0,20.0,19.0,31.0,1
480,BA:8C:B9:54:50:24,3851345,491284257,4926,6193426,3846419,485090831,7,9731,1750222,9709,1746727,22,3495,2358,17,5426,41,7,70,216660.0,130000.0,-40.0,-36.0,-45.0,-51.0,-45.0,-35.0,-43.0,-47.0,-90.0,-92.0,-89.0,-92.0,50.0,56.0,44.0,41.0,1
481,62:47:05:9D:EB:15,3853169,497273393,6744,12181956,3846425,485091437,1,6958,3801505,6908,3793847,50,7658,3314,0,6808,56,1,125,229410.0,130000.0,-44.0,-44.0,-35.0,-49.0,-43.0,-45.0,-36.0,-48.0,-90.0,-92.0,-89.0,-92.0,46.0,48.0,54.0,43.0,1
482,92:69:1D:31:68:E9,3850467,488743786,4042,3652349,3846425,485091437,1,5381,1156028,5212,1117645,169,38383,2200,12,4294,103,1,61,229410.0,130000.0,-51.0,-48.0,-44.0,-47.0,-51.0,-47.0,-43.0,-47.0,-90.0,-92.0,-89.0,-92.0,39.0,44.0,45.0,45.0,1
483,CC:2F:71:3F:1F:24,5009300,1815582317,1162875,1330490880,3846425,485091437,1730,974622,1103447969,973794,1103347899,828,100070,942411,15,1161500,119907,1727,760,130000.0,43333.0,-70.0,-69.0,-68.0,-76.0,-70.0,-69.0,-68.0,-76.0,-90.0,-92.0,-89.0,-92.0,20.0,23.0,21.0,16.0,1
484,CC:2F:71:3E:C5:1F,3847409,485211678,983,120181,3846426,485091497,2,4263,355905,3547,270887,716,85018,1042,13,1413,28,2,54,144444.0,39000.0,-73.0,-72.0,-70.0,-61.0,-72.0,-71.0,-69.0,-60.0,-90.0,-92.0,-89.0,-92.0,17.0,20.0,19.0,31.0,1
485,BA:8C:B9:54:50:24,3851352,491284923,4926,6193426,3846426,485091497,7,9731,1750222,9709,1746727,22,3495,2358,17,5426,41,7,70,216660.0,130000.0,-40.0,-36.0,-45.0,-51.0,-45.0,-35.0,-43.0,-47.0,-90.0,-92.0,-89.0,-92.0,50.0,56.0,44.0,41.0,1
486,62:47:05:9D:EB:15,3853170,497273453,6744,12181956,3846426,485091497,1,6958,3801505,6908,3793847,50,7658,3314,0,6808,56,1,125,229410.0,130000.0,-44.0,-44.0,-35.0,-49.0,-43.0,-45.0,-36.0,-48.0,-90.0,-92.0,-89.0,-92.0,46.0,48.0,54.0,43.0,1
487,92:69:1D:31:68:E9,3850470,488744048,4042,3652349,3846428,485091699,1,5381,1156028,5212,1117645,169,38383,2200,12,4294,103,1,61,229410.0,130000.0,-51.0,-48.0,-44.0,-47.0,-51.0,-47.0,-43.0,-47.0,-90.0,-92.0,-89.0,-92.0,39.0,44.0,45.0,45.0,1
488,CC:2F:71:3F:1F:24,5009495,1815824029,1163066,1330732270,3846429,485091759,1730,974795,1103677557,973967,1103577487,828,100070,942584,15,1161691,119907,1727,760,130000.0,43333.0,-70.0,-69.0,-68.0,-76.0,-70.0,-69.0,-68.0,-76.0,-90.0,-92.0,-89.0,-92.0,20.0,23.0,21.0,16.0,1
489,CC:2F:71:3E:C5:1F,3847412,485211940,983,120181,3846429,485091759,2,4263,355905,3547,270887,716,85018,1042,13,1413,28,2,54,144444.0,39000.0,-73.0,-72.0,-70.0,-61.0,-72.0,-71.0,-69.0,-60.0,-90.0,-92.0,-89.0,-92.0,17.0,20.0,19.0,31.0,1
490,BA:8C:B9:54:50:24,3851355,491285185,4926,6193426,3846429,485091759,7,9731,1750222,9709,1746727,22,3495,2358,17,5426,41,7,70,216660.0,130000.0,-40.0,-36.0,-45.0,-51.0,-45.0,-35.0,-43.0,-47.0,-90.0,-92.0,-89.0,-92.0,50.0,56.0,44.0,41.0,1
491,62:47:05:9D:EB:15,3853180,497274381,6744,12181956,3846436,485092425,1,6958,3801505,6908,3793847,50,7658,3314,0,6808,56,1,125,229410.0,130000.0,-44.0,-44.0,-35.0,-49.0,-43.0,-45.0,-36.0,-48.0,-90.0,-92.0,-89.0,-92.0,46.0,48.0,54.0,43.0,1
492,92:69:1D:31:68:E9,3850478,488744774,4042,3652349,3846436,485092425,1,5381,1156028,5212,1117645,169,38383,2200,12,4294,103,1,61,229410.0,130000.0,-51.0,-48.0,-44.0,-47.0,-51.0,-47.0,-43.0,-47.0,-90.0,-92.0,-89.0,-92.0,39.0,44.0,45.0,45.0,1
493,CC:2F:71:3F:1F:24,5009705,1816075678,1163269,1330983253,3846436,485092425,1730,974976,1103911417,974148,1103811347,828,100070,942765,15,1161894,119914,1727,760,130000.0,43333.0,-70.0,-69.0,-68.0,-76.0,-70.0,-69.0,-68.0,-76.0,-90.0,-92.0,-89.0,-92.0,20.0,23.0,21.0,16.0,1
494,CC:2F:71:3E:C5:1F,3847419,485212606,983,120181,3846436,485092425,2,4263,355905,3547,270887,716,85018,1042,13,1413,28,2,54,144444.0,39000.0,-73.0,-72.0,-70.0,-61.0,-72.0,-71.0,-69.0,-60.0,-90.0,-92.0,-89.0,-92.0,17.0,20.0,19.0,31.0,1
495,BA:8C:B9:54:50:24,3851362,491285851,4926,6193426,3846436,485092425,7,9731,1750222,9709,1746727,22,3495,2358,17,5426,41,7,70,216660.0,130000.0,-40.0,-36.0,-45.0,-51.0,-45.0,-35.0,-43.0,-47.0,-90.0,-92.0,-89.0,-92.0,50.0,56.0,44.0,41.0,1
496,62:47:05:9D:EB:15,3853183,497274643,6744,12181956,3846439,485092687,1,6958,3801505,6908,3793847,50,7658,3314,0,6808,56,1,125,229410.0,130000.0,-44.0,-44.0,-35.0,-49.0,-43.0,-45.0,-36.0,-48.0,-90.0,-92.0,-89.0,-92.0,46.0,48.0,54.0,43.0,1
497,92:69:1D:31:68:E9,3850481,488745036,4042,3652349,3846439,485092687,1,5381,1156028,5212,1117645,169,38383,2200,12,4294,103,1,61,229410.0,130000.0,-51.0,-48.0,-44.0,-47.0,-51.0,-47.0,-43.0,-47.0,-90.0,-92.0,-89.0,-92.0,39.0,44.0,45.0,45.0,1
498,CC:2F:71:3F:1F:24,5009899,1816317330,1163460,1331224643,3846439,485092687,1730,975144,1104137647,974316,1104037577,828,100070,942933,15,1162085,119916,1727,760,130000.0,43333.0,-70.0,-69.0,-68.0,-76.0,-69.0,-69.0,-68.0,-76.0,-90.0,-92.0,-89.0,-92.0,20.0,23.0,21.0,16.0,1
499,CC:2F:71:3E:C5:1F,3847422,485212868,983,120181,3846439,485092687,2,4263,355905,3547,270887,716,85018,1042,13,1413,28,2,54,144444.0,39000.0,-73.0,-72.0,-70.0,-61.0,-72.0,-71.0,-69.0,-60.0,-90.0,-92.0,-89.0,-92.0,17.0,20.0,19.0,31.0,1
500,BA:8C:B9:54:50:24,3851365,491286113,4926,6193426,3846439,485092687,7,9731,1750222,9709,1746727,22,3495,2358,17,5426,41,7,70,216660.0,130000.0,-40.0,-36.0,-45.0,-51.0,-45.0,-35.0,-43.0,-47.0,-90.0,-92.0,-89.0,-92.0,50.0,56.0,44.0,41.0,1
501,62:47:05:9D:EB:15,3853190,497275309,6744,12181956,3846446,485093353,1,6958,3801505,6908,3793847,50,7658,3314,0,6808,56,1,125,229410.0,130000.0,-44.0,-44.0,-35.0,-49.0,-43.0,-45.0,-36.0,-48.0,-90.0,-92.0,-89.0,-92.0,46.0,48.0,54.0,43.0,1
502,92:69:1D:31:68:E9,3850489,488745762,4042,3652349,3846447,485093413,1,5381,1156028,5212,1117645,169,38383,2200,12,4294,103,1,61,229410.0,130000.0,-51.0,-48.0,-44.0,-47.0,-51.0,-47.0,-43.0,-47.0,-90.0,-92.0,-89.0,-92.0,39.0,44.0,45.0,45.0,1
503,CC:2F:71:3F:1F:24,5010101,1816562460,1163654,1331469047,3846447,485093413,1730,975316,1104367119,974488,1104267049,828,100070,943105,15,1162279,119921,1727,760,130000.0,43333.0,-70.0,-69.0,-68.0,-76.0,-69.0,-69.0,-68.0,-76.0,-90.0,-92.0,-89.0,-92.0,20.0,23.0,21.0,16.0,1
504,CC:2F:71:3E:C5:1F,3847430,485213594,983,120181,3846447,485093413,2,4263,355905,3547,270887,716,85018,1042,13,1413,28,2,54,144444.0,39000.0,-73.0,-72.0,-70.0,-61.0,-72.0,-71.0,-69.0,-60.0,-90.0,-92.0,-89.0,-92.0,17.0,20.0,19.0,31.0,1
505,BA:8C:B9:54:50:24,3851373,491286839,4926,6193426,3846447,485093413,7,9731,1750222,9709,1746727,22,3495,2358,17,5426,41,7,70,216660.0,130000.0,-40.0,-36.0,-45.0,-51.0,-45.0,-35.0,-43.0,-47.0,-90.0,-92.0,-89.0,-92.0,50.0,56.0,44.0,41.0,1
506,62:47:05:9D:EB:15,3853194,497275633,6744,12181956,3846450,485093677,1,6958,3801505,6908,3793847,50,7658,3314,0,6808,56,1,125,229410.0,130000.0,-44.0,-44.0,-35.0,-49.0,-43.0,-45.0,-36.0,-48.0,-90.0,-92.0,-89.0,-92.0,46.0,48.0,54.0,43.0,1
507,92:69:1D:31:68:E9,3850493,488746142,4043,3652465,3846450,485093677,1,5383,1156164,5214,1117781,169,38383,2200,12,4295,103,1,61,229410.0,130000.0,-52.0,-48.0,-42.0,-49.0,-51.0,-47.0,-43.0,-47.0,-90.0,-92.0,-89.0,-92.0,38.0,44.0,47.0,43.0,1
508,CC:2F:71:3F:1F:24,5010296,1816807094,1163846,1331713417,3846450,485093677,1730,975487,1104596475,974659,1104496405,828,100070,943276,15,1162471,119922,1727,760,130000.0,43333.0,-70.0,-69.0,-68.0,-76.0,-69.0,-69.0,-68.0,-76.0,-90.0,-92.0,-89.0,-92.0,20.0,23.0,21.0,16.0,1
509,CC:2F:71:3E:C5:1F,3847434,485213974,984,120297,3846450,485093677,2,4267,356233,3550,271097,717,85136,1043,13,1414,28,2,54,144444.0,43333.0,-73.0,-72.0,-70.0,-61.0,-73.0,-72.0,-70.0,-61.0,-90.0,-92.0,-89.0,-92.0,17.0,20.0,19.0,31.0,1
510,BA:8C:B9:54:50:24,3851378,491287279,4927,6193542,3846451,485093737,7,9733,1750358,9711,1746863,22,3495,2358,17,5427,41,7,70,216660.0,130000.0,-48.0,-35.0,-43.0,-45.0,-46.0,-35.0,-43.0,-46.0,-90.0,-92.0,-89.0,-92.0,42.0,57.0,46.0,47.0,1
511,62:47:05:9D:EB:15,3853202,497276415,6745,12182072,3846457,485094343,1,6960,3801641,6910,3793983,50,7658,3314,0,6809,56,1,125,229410.0,130000.0,-44.0,-45.0,-36.0,-50.0,-43.0,-44.0,-35.0,-49.0,-90.0,-92.0,-89.0,-92.0,46.0,47.0,53.0,42.0,1
512,92:69:1D:31:68:E9,3850500,488746808,4043,3652465,3846457,485094343,1,5383,1156164,5214,1117781,169,38383,2200,12,4295,103,1,61,229410.0,130000.0,-52.0,-48.0,-42.0,-49.0,-51.0,-47.0,-43.0,-47.0,-90.0,-92.0,-89.0,-92.0,38.0,44.0,47.0,43.0,1
513,CC:2F:71:3F:1F:24,5010494,1817049150,1164037,1331954807,3846457,485094343,1730,975657,1104822867,974829,1104722797,828,100070,943446,15,1162662,119922,1727,760,130000.0,43333.0,-70.0,-70.0,-68.0,-76.0,-69.0,-69.0,-68.0,-76.0,-90.0,-92.0,-89.0,-92.0,20.0,22.0,21.0,16.0,1
514,CC:2F:71:3E:C5:1F,3847442,485214700,984,120297,3846458,485094403,2,4267,356233,3550,271097,717,85136,1043,13,1414,28,2,54,144444.0,43333.0,-73.0,-72.0,-70.0,-61.0,-73.0,-72.0,-70.0,-61.0,-90.0,-92.0,-89.0,-92.0,17.0,20.0,19.0,31.0,1
515,BA:8C:B9:54:50:24,3851385,491287945,4927,6193542,3846458,485094403,7,9733,1750358,9711,1746863,22,3495,2358,17,5427,41,7,70,216660.0,130000.0,-48.0,-35.0,-43.0,-45.0,-46.0,-35.0,-43.0,-46.0,-90.0,-92.0,-89.0,-92.0,42.0,57.0,46.0,47.0,1
516,62:47:05:9D:EB:15,3853207,497276799,6745,12182072,3846462,485094727,1,6960,3801641,6910,3793983,50,7658,3314,0,6809,56,1,125,229410.0,130000.0,-44.0,-45.0,-36.0,-50.0,-43.0,-44.0,-35.0,-49.0,-90.0,-92.0,-89.0,-92.0,46.0,47.0,53.0,42.0,1
517,92:69:1D:31:68:E9,3850505,488747192,4043,3652465,3846462,485094727,1,5383,1156164,5214,1117781,169,38383,2200,12,4295,103,1,61,229410.0,130000.0,-52.0,-48.0,-42.0,-49.0,-51.0,-47.0,-43.0,-47.0,-90.0,-92.0,-89.0,-92.0,38.0,44.0,47.0,43.0,1
518,CC:2F:71:3F:1F:24,5010697,1817294171,1164235,1332199444,3846462,485094727,1730,975836,1105050802,975007,1104950614,829,100188,943625,15,1162860,119942,1727,760,130000.0,43333.0,-70.0,-69.0,-68.0,-77.0,-70.0,-69.0,-68.0,-76.0,-90.0,-92.0,-89.0,-92.0,20.0,23.0,21.0,15.0,1
519,CC:2F:71:3E:C5:1F,3847446,485215024,984,120297,3846462,485094727,2,4267,356233,3550,271097,717,85136,1043,13,1414,28,2,54,144444.0,43333.0,-73.0,-72.0,-70.0,-61.0,-73.0,-72.0,-70.0,-61.0,-90.0,-92.0,-89.0,-92.0,17.0,20.0,19.0,31.0,1
520,BA:8C:B9:54:50:24,3851389,491288269,4927,6193542,3846462,485094727,7,9733,1750358,9711,1746863,22,3495,2358,17,5427,41,7,70,216660.0,130000.0,-48.0,-35.0,-43.0,-45.0,-46.0,-35.0,-43.0,-46.0,-90.0,-92.0,-89.0,-92.0,42.0,57.0,46.0,47.0,1
521,62:47:05:9D:EB:15,3853215,497277738,6745,12182072,3846470,485095666,1,6960,3801641,6910,3793983,50,7658,3314,0,6809,56,1,125,229410.0,130000.0,-44.0,-45.0,-36.0,-50.0,-43.0,-44.0,-35.0,-49.0,-90.0,-92.0,-89.0,-92.0,46.0,47.0,53.0,42.0,1
522,92:69:1D:31:68:E9,3850513,488748131,4043,3652465,3846470,485095666,1,5383,1156164,5214,1117781,169,38383,2200,12,4295,103,1,61,229410.0,130000.0,-52.0,-48.0,-42.0,-49.0,-51.0,-47.0,-43.0,-47.0,-90.0,-92.0,-89.0,-92.0,38.0,44.0,47.0,43.0,1
523,CC:2F:71:3F:1F:24,5010899,1817541148,1164429,1332445482,3846470,485095666,1730,976008,1105281744,975179,1105181556,829,100188,943796,15,1163054,119942,1727,761,130000.0,43333.0,-70.0,-69.0,-68.0,-75.0,-70.0,-69.0,-68.0,-75.0,-90.0,-92.0,-89.0,-92.0,20.0,23.0,21.0,17.0,1
524,CC:2F:71:3E:C5:1F,3847454,485215963,984,120297,3846470,485095666,2,4267,356233,3550,271097,717,85136,1043,13,1414,28,2,54,144444.0,43333.0,-73.0,-72.0,-70.0,-61.0,-73.0,-72.0,-70.0,-61.0,-90.0,-92.0,-89.0,-92.0,17.0,20.0,19.0,31.0,1
525,BA:8C:B9:54:50:24,3851397,491289208,4927,6193542,3846470,485095666,7,9733,1750358,9711,1746863,22,3495,2358,17,5427,41,7,70,216660.0,130000.0,-48.0,-35.0,-43.0,-45.0,-46.0,-35.0,-43.0,-46.0,-90.0,-92.0,-89.0,-92.0,42.0,57.0,46.0,47.0,1
526,62:47:05:9D:EB:15,3853218,497278000,6745,12182072,3846473,485095928,1,6960,3801641,6910,3793983,50,7658,3314,0,6809,56,1,125,229410.0,130000.0,-44.0,-45.0,-36.0,-50.0,-43.0,-44.0,-35.0,-49.0,-90.0,-92.0,-89.0,-92.0,46.0,47.0,53.0,42.0,1
527,92:69:1D:31:68:E9,3850516,488748393,4043,3652465,3846473,485095928,1,5383,1156164,5214,1117781,169,38383,2200,12,4295,103,1,61,229410.0,130000.0,-52.0,-48.0,-42.0,-49.0,-51.0,-47.0,-43.0,-47.0,-90.0,-92.0,-89.0,-92.0,38.0,44.0,47.0,43.0,1
528,CC:2F:71:3F:1F:24,5011093,1817783986,1164619,1332687998,3846474,485095988,1730,976178,1105510984,975349,1105410796,829,100188,943966,15,1163244,119951,1727,761,144444.0,43333.0,-71.0,-68.0,-67.0,-74.0,-71.0,-68.0,-66.0,-73.0,-90.0,-92.0,-89.0,-92.0,19.0,24.0,22.0,18.0,1
529,CC:2F:71:3E:C5:1F,3847458,485216285,984,120297,3846474,485095988,2,4267,356233,3550,271097,717,85136,1043,13,1414,28,2,54,144444.0,43333.0,-73.0,-72.0,-70.0,-61.0,-73.0,-72.0,-70.0,-61.0,-90.0,-92.0,-89.0,-92.0,17.0,20.0,19.0,31.0,1
530,BA:8C:B9:54:50:24,3851401,491289530,4927,6193542,3846474,485095988,7,9733,1750358,9711,1746863,22,3495,2358,17,5427,41,7,70,216660.0,130000.0,-48.0,-35.0,-43.0,-45.0,-46.0,-35.0,-43.0,-46.0,-90.0,-92.0,-89.0,-92.0,42.0,57.0,46.0,47.0,1
531,62:47:05:9D:EB:15,3853225,497278666,6745,12182072,3846480,485096594,1,6960,3801641,6910,3793983,50,7658,3314,0,6809,56,1,125,229410.0,130000.0,-44.0,-45.0,-36.0,-50.0,-43.0,-44.0,-35.0,-49.0,-90.0,-92.0,-89.0,-92.0,46.0,47.0,53.0,42.0,1
532,92:69:1D:31:68:E9,3850523,488749059,4043,3652465,3846480,485096594,1,5383,1156164,5214,1117781,169,38383,2200,12,4295,103,1,61,229410.0,130000.0,-52.0,-48.0,-42.0,-49.0,-51.0,-47.0,-43.0,-47.0,-90.0,-92.0,-89.0,-92.0,38.0,44.0,47.0,43.0,1
533,CC:2F:71:3F:1F:24,5011296,1818032441,1164816,1332935847,3846480,485096594,1730,976356,1105744102,975527,1105643914,829,100188,944144,15,1163441,119959,1727,761,130000.0,43333.0,-70.0,-69.0,-66.0,-73.0,-70.0,-69.0,-66.0,-73.0,-90.0,-92.0,-89.0,-92.0,20.0,23.0,23.0,19.0,1
534,CC:2F:71:3E:C5:1F,3847464,485216891,984,120297,3846480,485096594,2,4267,356233,3550,271097,717,85136,1043,13,1414,28,2,54,144444.0,43333.0,-73.0,-72.0,-70.0,-61.0,-73.0,-72.0,-70.0,-61.0,-90.0,-92.0,-89.0,-92.0,17.0,20.0,19.0,31.0,1
535,BA:8C:B9:54:50:24,3851407,491290136,4927,6193542,3846480,485096594,7,9733,1750358,9711,1746863,22,3495,2358,17,5427,41,7,70,216660.0,130000.0,-48.0,-35.0,-43.0,-45.0,-46.0,-35.0,-43.0,-46.0,-90.0,-92.0,-89.0,-92.0,42.0,57.0,46.0,47.0,1
536,62:47:05:9D:EB:15,3853228,497278928,6745,12182072,3846483,485096856,1,6960,3801641,6910,3793983,50,7658,3314,0,6809,56,1,125,229410.0,130000.0,-44.0,-45.0,-36.0,-50.0,-43.0,-44.0,-35.0,-49.0,-90.0,-92.0,-89.0,-92.0,46.0,47.0,53.0,42.0,1
537,92:69:1D:31:68:E9,3850526,488749321,4043,3652465,3846483,485096856,1,5383,1156164,5214,1117781,169,38383,2200,12,4295,103,1,61,229410.0,130000.0,-52.0,-48.0,-42.0,-49.0,-51.0,-47.0,-43.0,-47.0,-90.0,-92.0,-89.0,-92.0,38.0,44.0,47.0,43.0,1
538,CC:2F:71:3F:1F:24,5011493,1818277261,1165009,1333180345,3846484,485096916,1730,976527,1105973458,975698,1105873270,829,100188,944315,15,1163634,119961,1727,761,130000.0,43333.0,-70.0,-69.0,-66.0,-74.0,-70.0,-69.0,-66.0,-73.0,-90.0,-92.0,-89.0,-92.0,20.0,23.0,23.0,18.0,1
539,CC:2F:71:3E:C5:1F,3847468,485217213,984,120297,3846484,485096916,2,4267,356233,3550,271097,717,85136,1043,13,1414,28,2,54,144444.0,43333.0,-73.0,-72.0,-70.0,-61.0,-73.0,-72.0,-70.0,-61.0,-90.0,-92.0,-89.0,-92.0,17.0,20.0,19.0,31.0,1
540,BA:8C:B9:54:50:24,3851411,491290458,4927,6193542,3846484,485096916,7,9733,1750358,9711,1746863,22,3495,2358,17,5427,41,7,70,216660.0,130000.0,-48.0,-35.0,-43.0,-45.0,-46.0,-35.0,-43.0,-46.0,-90.0,-92.0,-89.0,-92.0,42.0,57.0,46.0,47.0,1
541,62:47:05:9D:EB:15,3853237,497279714,6745,12182072,3846492,485097642,1,6960,3801641,6910,3793983,50,7658,3314,0,6809,56,1,125,229410.0,130000.0,-44.0,-45.0,-36.0,-50.0,-43.0,-44.0,-35.0,-49.0,-90.0,-92.0,-89.0,-92.0,46.0,47.0,53.0,42.0,1
542,92:69:1D:31:68:E9,3850535,488750107,4043,3652465,3846492,485097642,1,5383,1156164,5214,1117781,169,38383,2200,12,4295,103,1,61,229410.0,130000.0,-52.0,-48.0,-42.0,-49.0,-51.0,-47.0,-43.0,-47.0,-90.0,-92.0,-89.0,-92.0,38.0,44.0,47.0,43.0,1
543,CC:2F:71:3F:1F:24,5011719,1818541188,1165227,1333443546,3846492,485097642,1730,976727,1106220366,975897,1106120064,830,100302,944514,15,1163852,119972,1727,762,130000.0,43333.0,-70.0,-69.0,-66.0,-73.0,-70.0,-69.0,-65.0,-73.0,-90.0,-92.0,-89.0,-92.0,20.0,23.0,23.0,19.0,1
544,CC:2F:71:3E:C5:1F,3847478,485218141,984,120297,3846494,485097844,2,4267,356233,3550,271097,717,85136,1043,13,1414,28,2,54,144444.0,43333.0,-73.0,-72.0,-70.0,-61.0,-73.0,-72.0,-70.0,-61.0,-90.0,-92.0,-89.0,-92.0,17.0,20.0,19.0,31.0,1
545,BA:8C:B9:54:50:24,3851421,491291386,4927,6193542,3846494,485097844,7,9733,1750358,9711,1746863,22,3495,2358,17,5427,41,7,70,216660.0,130000.0,-48.0,-35.0,-43.0,-45.0,-46.0,-35.0,-43.0,-46.0,-90.0,-92.0,-89.0,-92.0,42.0,57.0,46.0,47.0,1
546,62:47:05:9D:EB:15,3853243,497280262,6745,12182072,3846498,485098190,1,6960,3801641,6910,3793983,50,7658,3314,0,6809,56,1,125,229410.0,130000.0,-44.0,-45.0,-36.0,-50.0,-43.0,-44.0,-35.0,-49.0,-90.0,-92.0,-89.0,-92.0,46.0,47.0,53.0,42.0,1
547,92:69:1D:31:68:E9,3850541,488750655,4043,3652465,3846498,485098190,1,5383,1156164,5214,1117781,169,38383,2200,12,4295,103,1,61,229410.0,130000.0,-52.0,-48.0,-42.0,-49.0,-51.0,-47.0,-43.0,-47.0,-90.0,-92.0,-89.0,-92.0,38.0,44.0,47.0,43.0,1
548,CC:2F:71:3F:1F:24,5011918,1818786234,1165420,1333688044,3846498,485098190,1730,976901,1106450176,976068,1106349420,833,100756,944688,15,1164045,119973,1727,762,130000.0,43333.0,-71.0,-69.0,-67.0,-76.0,-71.0,-69.0,-67.0,-76.0,-90.0,-92.0,-89.0,-92.0,19.0,23.0,22.0,16.0,1
549,CC:2F:71:3E:C5:1F,3847483,485218621,984,120297,3846499,485098324,2,4267,356233,3550,271097,717,85136,1043,13,1414,28,2,54,144444.0,43333.0,-73.0,-72.0,-70.0,-61.0,-73.0,-72.0,-70.0,-61.0,-90.0,-92.0,-89.0,-92.0,17.0,20.0,19.0,31.0,1
550,BA:8C:B9:54:50:24,3851426,491291866,4927,6193542,3846499,485098324,7,9733,1750358,9711,1746863,22,3495,2358,17,5427,41,7,70,216660.0,130000.0,-48.0,-35.0,-43.0,-45.0,-46.0,-35.0,-43.0,-46.0,-90.0,-92.0,-89.0,-92.0,42.0,57.0,46.0,47.0,1
551,62:47:05:9D:EB:15,3853250,497280928,6745,12182072,3846505,485098856,1,6960,3801641,6910,3793983,50,7658,3314,0,6809,56,1,125,229410.0,130000.0,-44.0,-45.0,-36.0,-50.0,-43.0,-44.0,-35.0,-49.0,-90.0,-92.0,-89.0,-92.0,46.0,47.0,53.0,42.0,1
552,92:69:1D:31:68:E9,3850550,488751523,4043,3652465,3846507,485099058,1,5384,1156232,5215,1117849,169,38383,2200,12,4295,103,1,61,229410.0,130000.0,-52.0,-47.0,-44.0,-47.0,-51.0,-47.0,-43.0,-47.0,-90.0,-92.0,-89.0,-92.0,38.0,45.0,45.0,45.0,1
553,CC:2F:71:3F:1F:24,5012123,1819031682,1165615,1333932564,3846508,485099118,1730,977073,1106679638,976240,1106578882,833,100756,944860,15,1164240,119986,1727,762,130000.0,43333.0,-69.0,-69.0,-69.0,-73.0,-69.0,-69.0,-69.0,-73.0,-90.0,-92.0,-89.0,-92.0,21.0,23.0,20.0,19.0,1
554,CC:2F:71:3E:C5:1F,3847492,485219415,984,120297,3846508,485099118,2,4267,356233,3550,271097,717,85136,1043,13,1414,28,2,54,144444.0,43333.0,-73.0,-72.0,-70.0,-61.0,-73.0,-72.0,-70.0,-61.0,-90.0,-92.0,-89.0,-92.0,17.0,20.0,19.0,31.0,1
555,BA:8C:B9:54:50:24,3851435,491292660,4927,6193542,3846508,485099118,7,9733,1750358,9711,1746863,22,3495,2358,17,5427,41,7,70,216660.0,130000.0,-48.0,-35.0,-43.0,-45.0,-46.0,-35.0,-43.0,-46.0,-90.0,-92.0,-89.0,-92.0,42.0,57.0,46.0,47.0,1
556,62:47:05:9D:EB:15,3853253,497281190,6745,12182072,3846508,485099118,1,6960,3801641,6910,3793983,50,7658,3314,0,6809,56,1,125,229410.0,130000.0,-44.0,-45.0,-36.0,-50.0,-43.0,-44.0,-35.0,-49.0,-90.0,-92.0,-89.0,-92.0,46.0,47.0,53.0,42.0,1
557,92:69:1D:31:68:E9,3850551,488751583,4043,3652465,3846508,485099118,1,5384,1156232,5215,1117849,169,38383,2200,12,4295,103,1,61,229410.0,130000.0,-52.0,-47.0,-44.0,-47.0,-51.0,-47.0,-43.0,-47.0,-90.0,-92.0,-89.0,-92.0,38.0,45.0,45.0,45.0,1
558,CC:2F:71:3F:1F:24,5012315,1819277138,1165807,1334178020,3846508,485099118,1730,977244,1106909104,976411,1106808348,833,100756,945030,15,1164431,119998,1727,762,117000.0,39000.0,-69.0,-69.0,-68.0,-74.0,-69.0,-69.0,-68.0,-74.0,-90.0,-92.0,-89.0,-92.0,21.0,23.0,21.0,18.0,1
559,CC:2F:71:3E:C5:1F,3847496,485219819,984,120297,3846512,485099522,2,4267,356233,3550,271097,717,85136,1043,13,1414,28,2,54,144444.0,43333.0,-73.0,-72.0,-70.0,-61.0,-73.0,-72.0,-70.0,-61.0,-90.0,-92.0,-89.0,-92.0,17.0,20.0,19.0,31.0,1
560,BA:8C:B9:54:50:24,3851441,491293266,4927,6193542,3846514,485099724,7,9733,1750358,9711,1746863,22,3495,2358,17,5427,41,7,70,216660.0,130000.0,-48.0,-35.0,-43.0,-45.0,-46.0,-35.0,-43.0,-46.0,-90.0,-92.0,-89.0,-92.0,42.0,57.0,46.0,47.0,1
561,62:47:05:9D:EB:15,3853262,497282058,6745,12182072,3846517,485099986,1,6960,3801641,6910,3793983,50,7658,3314,0,6809,56,1,125,229410.0,130000.0,-44.0,-45.0,-36.0,-50.0,-43.0,-44.0,-35.0,-49.0,-90.0,-92.0,-89.0,-92.0,46.0,47.0,53.0,42.0,1
562,92:69:1D:31:68:E9,3850561,488752511,4043,3652465,3846518,485100046,1,5384,1156232,5215,1117849,169,38383,2200,12,4295,103,1,61,229410.0,130000.0,-52.0,-47.0,-44.0,-47.0,-51.0,-47.0,-43.0,-47.0,-90.0,-92.0,-89.0,-92.0,38.0,45.0,45.0,45.0,1
563,CC:2F:71:3F:1F:24,5012520,1819524136,1166002,1334424090,3846518,485100046,1730,977418,1107144532,976585,1107043776,833,100756,945202,15,1164627,120007,1727,762,130000.0,43333.0,-69.0,-69.0,-68.0,-75.0,-69.0,-69.0,-68.0,-75.0,-90.0,-92.0,-89.0,-92.0,21.0,23.0,21.0,17.0,1
564,CC:2F:71:3E:C5:1F,3847502,485220343,984,120297,3846518,485100046,2,4268,356303,3551,271167,717,85136,1043,13,1415,28,2,54,144444.0,43333.0,-71.0,-73.0,-69.0,-61.0,-72.0,-72.0,-69.0,-61.0,-90.0,-92.0,-89.0,-92.0,19.0,19.0,20.0,31.0,1
565,BA:8C:B9:54:50:24,3851445,491293588,4927,6193542,3846518,485100046,7,9737,1750630,9715,1747135,22,3495,2358,17,5428,41,7,70,216660.0,130000.0,-39.0,-37.0,-45.0,-52.0,-44.0,-35.0,-43.0,-47.0,-90.0,-92.0,-89.0,-92.0,51.0,55.0,44.0,40.0,1
566,62:47:05:9D:EB:15,3853264,497282178,6745,12182072,3846519,485100106,1,6961,3801709,6911,3794051,50,7658,3314,0,6810,56,1,125,229410.0,130000.0,-43.0,-46.0,-36.0,-49.0,-43.0,-44.0,-35.0,-49.0,-90.0,-92.0,-89.0,-92.0,47.0,46.0,53.0,43.0,1
567,92:69:1D:31:68:E9,3850580,488758776,4043,3652465,3846537,485106311,1,5387,1156603,5217,1117985,170,38618,2201,12,4295,103,1,61,229410.0,130000.0,-52.0,-47.0,-44.0,-47.0,-51.0,-47.0,-43.0,-48.0,-90.0,-92.0,-89.0,-92.0,38.0,45.0,45.0,45.0,1
568,CC:2F:71:3F:1F:24,5012759,1819809450,1166222,1334703139,3846537,485106311,1730,977619,1107409403,976786,1107308647,833,100756,945401,15,1164847,120020,1727,765,130000.0,43333.0,-69.0,-68.0,-69.0,-74.0,-69.0,-68.0,-69.0,-74.0,-90.0,-92.0,-89.0,-92.0,21.0,24.0,20.0,18.0,1
569,CC:2F:71:3E:C5:1F,3847521,485226608,984,120297,3846537,485106311,2,4269,356373,3552,271237,717,85136,1043,13,1415,28,2,54,144444.0,43333.0,-71.0,-73.0,-69.0,-61.0,-72.0,-72.0,-69.0,-61.0,-90.0,-92.0,-89.0,-92.0,19.0,19.0,20.0,31.0,1
570,BA:8C:B9:54:50:24,3851475,491305277,4927,6193542,3846548,485111735,7,9737,1750630,9715,1747135,22,3495,2358,17,5428,41,7,70,216660.0,130000.0,-39.0,-37.0,-45.0,-52.0,-44.0,-35.0,-43.0,-47.0,-90.0,-92.0,-89.0,-92.0,51.0,55.0,44.0,40.0,1
571,62:47:05:9D:EB:15,3853296,497294069,6745,12182072,3846551,485111997,1,6962,3801777,6912,3794119,50,7658,3314,0,6810,56,1,125,229410.0,130000.0,-44.0,-46.0,-36.0,-49.0,-43.0,-45.0,-35.0,-49.0,-90.0,-92.0,-89.0,-92.0,46.0,46.0,53.0,43.0,1
572,92:69:1D:31:68:E9,3850594,488764462,4043,3652465,3846551,485111997,1,5387,1156603,5217,1117985,170,38618,2201,12,4295,103,1,61,229410.0,130000.0,-52.0,-47.0,-44.0,-47.0,-51.0,-47.0,-43.0,-48.0,-90.0,-92.0,-89.0,-92.0,38.0,45.0,45.0,45.0,1
573,CC:2F:71:3F:1F:24,5012971,1820065252,1166420,1334953255,3846551,485111997,1730,977798,1107651345,976965,1107550589,833,100756,945576,15,1165045,120088,1727,766,130000.0,39000.0,-70.0,-68.0,-67.0,-75.0,-70.0,-68.0,-67.0,-74.0,-90.0,-92.0,-89.0,-92.0,20.0,24.0,22.0,17.0,1
574,CC:2F:71:3E:C5:1F,3847535,485232294,984,120297,3846551,485111997,2,4269,356373,3552,271237,717,85136,1043,13,1415,28,2,54,144444.0,43333.0,-71.0,-73.0,-69.0,-61.0,-72.0,-72.0,-69.0,-61.0,-90.0,-92.0,-89.0,-92.0,19.0,19.0,20.0,31.0,1
575,BA:8C:B9:54:50:24,3851478,491305539,4927,6193542,3846551,485111997,7,9737,1750630,9715,1747135,22,3495,2358,17,5428,41,7,70,216660.0,130000.0,-39.0,-37.0,-45.0,-52.0,-44.0,-35.0,-43.0,-47.0,-90.0,-92.0,-89.0,-92.0,51.0,55.0,44.0,40.0,1
576,62:47:05:9D:EB:15,3853303,497294735,6745,12182072,3846558,485112663,1,6962,3801777,6912,3794119,50,7658,3314,0,6810,56,1,125,229410.0,130000.0,-44.0,-46.0,-36.0,-49.0,-43.0,-45.0,-35.0,-49.0,-90.0,-92.0,-89.0,-92.0,46.0,46.0,53.0,43.0,1
577,92:69:1D:31:68:E9,3850602,488765188,4043,3652465,3846559,485112723,1,5387,1156603,5217,1117985,170,38618,2201,12,4295,103,1,61,229410.0,130000.0,-52.0,-47.0,-44.0,-47.0,-51.0,-47.0,-43.0,-48.0,-90.0,-92.0,-89.0,-92.0,38.0,45.0,45.0,45.0,1
578,CC:2F:71:3F:1F:24,5013171,1820310122,1166612,1335197399,3846559,485112723,1730,977973,1107882527,977140,1107781771,833,100756,945746,15,1165237,120141,1727,766,130000.0,43333.0,-70.0,-68.0,-68.0,-73.0,-70.0,-68.0,-67.0,-73.0,-90.0,-92.0,-89.0,-92.0,20.0,24.0,21.0,19.0,1
579,CC:2F:71:3E:C5:1F,3847543,485233020,984,120297,3846559,485112723,2,4269,356373,3552,271237,717,85136,1043,13,1415,28,2,54,144444.0,43333.0,-71.0,-73.0,-69.0,-61.0,-72.0,-72.0,-69.0,-61.0,-90.0,-92.0,-89.0,-92.0,19.0,19.0,20.0,31.0,1
580,BA:8C:B9:54:50:24,3851486,491306265,4927,6193542,3846559,485112723,7,9737,1750630,9715,1747135,22,3495,2358,17,5428,41,7,70,216660.0,130000.0,-39.0,-37.0,-45.0,-52.0,-44.0,-35.0,-43.0,-47.0,-90.0,-92.0,-89.0,-92.0,51.0,55.0,44.0,40.0,1
581,62:47:05:9D:EB:15,3853307,497295270,6745,12182072,3846562,485113198,1,6962,3801777,6912,3794119,50,7658,3314,0,6810,56,1,125,229410.0,130000.0,-44.0,-46.0,-36.0,-49.0,-43.0,-45.0,-35.0,-49.0,-90.0,-92.0,-89.0,-92.0,46.0,46.0,53.0,43.0,1
582,92:69:1D:31:68:E9,3850605,488765663,4043,3652465,3846562,485113198,1,5387,1156603,5217,1117985,170,38618,2201,12,4295,103,1,61,229410.0,130000.0,-52.0,-47.0,-44.0,-47.0,-51.0,-47.0,-43.0,-48.0,-90.0,-92.0,-89.0,-92.0,38.0,45.0,45.0,45.0,1
583,CC:2F:71:3F:1F:24,5013368,1820554833,1166806,1335441635,3846562,485113198,1730,978151,1108122761,977318,1108022005,833,100756,945917,15,1165431,120182,1727,766,130000.0,43333.0,-71.0,-68.0,-67.0,-73.0,-70.0,-68.0,-67.0,-73.0,-90.0,-92.0,-89.0,-92.0,19.0,24.0,22.0,19.0,1
584,CC:2F:71:3E:C5:1F,3847546,485233495,984,120297,3846562,485113198,2,4269,356373,3552,271237,717,85136,1043,13,1415,28,2,54,144444.0,43333.0,-71.0,-73.0,-69.0,-61.0,-72.0,-72.0,-69.0,-61.0,-90.0,-92.0,-89.0,-92.0,19.0,19.0,20.0,31.0,1
585,BA:8C:B9:54:50:24,3851490,491306800,4927,6193542,3846563,485113258,7,9737,1750630,9715,1747135,22,3495,2358,17,5428,41,7,70,216660.0,130000.0,-39.0,-37.0,-45.0,-52.0,-44.0,-35.0,-43.0,-47.0,-90.0,-92.0,-89.0,-92.0,51.0,55.0,44.0,40.0,1
586,62:47:05:9D:EB:15,3853315,497295996,6745,12182072,3846570,485113924,1,6962,3801777,6912,3794119,50,7658,3314,0,6810,56,1,125,229410.0,130000.0,-44.0,-46.0,-36.0,-49.0,-43.0,-45.0,-35.0,-49.0,-90.0,-91.0,-88.0,-91.0,46.0,45.0,52.0,42.0,1
587,92:69:1D:31:68:E9,3850613,488766389,4043,3652465,3846570,485113924,1,5387,1156603,5217,1117985,170,38618,2201,12,4295,103,1,61,229410.0,130000.0,-52.0,-47.0,-44.0,-47.0,-51.0,-47.0,-43.0,-48.0,-90.0,-91.0,-88.0,-91.0,38.0,44.0,44.0,44.0,1
588,CC:2F:71:3F:1F:24,5013570,1820802797,1167000,1335688873,3846570,485113924,1730,978329,1108361581,977496,1108260825,833,100756,946090,15,1165625,120209,1727,766,130000.0,43333.0,-70.0,-68.0,-68.0,-73.0,-70.0,-68.0,-67.0,-73.0,-90.0,-91.0,-88.0,-91.0,20.0,23.0,20.0,18.0,1
589,CC:2F:71:3E:C5:1F,3847554,485234221,984,120297,3846570,485113924,2,4269,356373,3552,271237,717,85136,1043,13,1415,28,2,54,144444.0,43333.0,-71.0,-73.0,-69.0,-61.0,-72.0,-72.0,-69.0,-61.0,-90.0,-91.0,-88.0,-91.0,19.0,18.0,19.0,30.0,1
590,BA:8C:B9:54:50:24,3851497,491307466,4927,6193542,3846570,485113924,7,9737,1750630,9715,1747135,22,3495,2358,17,5428,41,7,70,216660.0,130000.0,-39.0,-37.0,-45.0,-52.0,-44.0,-35.0,-43.0,-47.0,-90.0,-91.0,-88.0,-91.0,51.0,54.0,43.0,39.0,1
591,62:47:05:9D:EB:15,3853318,497296258,6745,12182072,3846573,485114186,1,6964,3801913,6914,3794255,50,7658,3314,0,6810,56,1,125,229410.0,130000.0,-43.0,-45.0,-36.0,-48.0,-43.0,-45.0,-35.0,-49.0,-90.0,-91.0,-88.0,-91.0,47.0,46.0,52.0,43.0,1
592,92:69:1D:31:68:E9,3850616,488766651,4043,3652465,3846573,485114186,1,5387,1156603,5217,1117985,170,38618,2201,12,4295,103,1,61,229410.0,130000.0,-52.0,-47.0,-44.0,-47.0,-51.0,-47.0,-43.0,-48.0,-90.0,-91.0,-88.0,-91.0,38.0,44.0,44.0,44.0,1
593,CC:2F:71:3F:1F:24,5013775,1821050892,1167200,1335936338,3846575,485114554,1730,978517,1108602395,977684,1108501639,833,100756,946267,15,1165825,120257,1727,766,115556.0,28889.0,-70.0,-68.0,-67.0,-74.0,-70.0,-68.0,-67.0,-73.0,-90.0,-91.0,-88.0,-91.0,20.0,23.0,21.0,17.0,1
594,CC:2F:71:3E:C5:1F,3847559,485234851,984,120297,3846575,485114554,2,4269,356373,3552,271237,717,85136,1043,13,1415,28,2,54,144444.0,43333.0,-71.0,-73.0,-69.0,-61.0,-72.0,-72.0,-69.0,-61.0,-89.0,-91.0,-88.0,-91.0,18.0,18.0,19.0,30.0,1
595,BA:8C:B9:54:50:24,3851502,491308096,4927,6193542,3846575,485114554,7,9737,1750630,9715,1747135,22,3495,2358,17,5428,41,7,70,216660.0,130000.0,-39.0,-37.0,-45.0,-52.0,-44.0,-35.0,-43.0,-47.0,-89.0,-91.0,-88.0,-91.0,50.0,54.0,43.0,39.0,1
596,62:47:05:9D:EB:15,3853327,497297292,6745,12182072,3846582,485115220,1,6964,3801913,6914,3794255,50,7658,3314,0,6810,56,1,125,229410.0,130000.0,-43.0,-45.0,-36.0,-48.0,-43.0,-45.0,-35.0,-49.0,-89.0,-91.0,-88.0,-91.0,46.0,46.0,52.0,43.0,1
597,92:69:1D:31:68:E9,3850625,488767685,4043,3652465,3846582,485115220,1,5387,1156603,5217,1117985,170,38618,2201,12,4295,103,1,61,229410.0,130000.0,-52.0,-47.0,-44.0,-47.0,-51.0,-47.0,-43.0,-48.0,-89.0,-91.0,-88.0,-91.0,37.0,44.0,44.0,44.0,1
598,CC:2F:71:3F:1F:24,5013973,1821292948,1167391,1336177728,3846582,485115220,1730,978694,1108838521,977861,1108737765,833,100756,946437,15,1166016,120258,1727,766,115556.0,28889.0,-71.0,-68.0,-67.0,-74.0,-70.0,-68.0,-67.0,-73.0,-89.0,-91.0,-88.0,-91.0,18.0,23.0,21.0,17.0,1
599,CC:2F:71:3E:C5:1F,3847566,485235517,984,120297,3846582,485115220,2,4269,356373,3552,271237,717,85136,1043,13,1415,28,2,54,144444.0,43333.0,-71.0,-73.0,-69.0,-61.0,-72.0,-72.0,-69.0,-61.0,-89.0,-91.0,-88.0,-91.0,18.0,18.0,19.0,30.0,1
600,BA:8C:B9:54:50:24,3851512,491309024,4927,6193542,3846585,485115482,7,9737,1750630,9715,1747135,22,3495,2358,17,5428,41,7,70,216660.0,130000.0,-39.0,-37.0,-45.0,-52.0,-44.0,-35.0,-43.0,-47.0,-89.0,-91.0,-88.0,-91.0,50.0,54.0,43.0,39.0,1
601,62:47:05:9D:EB:15,3853330,497297554,6745,12182072,3846585,485115482,1,6964,3801913,6914,3794255,50,7658,3314,0,6810,56,1,125,229410.0,130000.0,-43.0,-45.0,-36.0,-48.0,-43.0,-45.0,-35.0,-49.0,-90.0,-92.0,-89.0,-91.0,47.0,47.0,53.0,43.0,1
602,92:69:1D:31:68:E9,3850628,488767947,4043,3652465,3846585,485115482,1,5387,1156603,5217,1117985,170,38618,2201,12,4295,103,1,61,229410.0,130000.0,-52.0,-47.0,-44.0,-47.0,-51.0,-47.0,-43.0,-48.0,-90.0,-92.0,-89.0,-91.0,38.0,45.0,45.0,44.0,1
603,CC:2F:71:3F:1F:24,5014173,1821540782,1167587,1336425240,3846586,485115542,1730,978866,1109070855,978033,1108970099,833,100756,946608,15,1166211,120263,1727,766,115556.0,28889.0,-70.0,-69.0,-67.0,-73.0,-70.0,-68.0,-67.0,-73.0,-90.0,-92.0,-89.0,-91.0,20.0,23.0,22.0,18.0,1
604,CC:2F:71:3E:C5:1F,3847570,485235839,984,120297,3846586,485115542,2,4269,356373,3552,271237,717,85136,1043,13,1415,28,2,54,144444.0,43333.0,-71.0,-73.0,-69.0,-61.0,-72.0,-72.0,-69.0,-61.0,-90.0,-92.0,-89.0,-91.0,19.0,19.0,20.0,30.0,1
605,BA:8C:B9:54:50:24,3851513,491309084,4927,6193542,3846586,485115542,7,9737,1750630,9715,1747135,22,3495,2358,17,5428,41,7,70,216660.0,130000.0,-39.0,-37.0,-45.0,-52.0,-44.0,-35.0,-43.0,-47.0,-90.0,-92.0,-89.0,-91.0,51.0,55.0,44.0,39.0,1
606,62:47:05:9D:EB:15,3853337,497298220,6745,12182072,3846592,485116148,1,6964,3801913,6914,3794255,50,7658,3314,0,6810,56,1,125,229410.0,130000.0,-43.0,-45.0,-36.0,-48.0,-43.0,-45.0,-35.0,-49.0,-90.0,-92.0,-89.0,-91.0,47.0,47.0,53.0,43.0,1
607,92:69:1D:31:68:E9,3850635,488768613,4043,3652465,3846592,485116148,1,5387,1156603,5217,1117985,170,38618,2201,12,4295,103,1,61,229410.0,130000.0,-52.0,-47.0,-44.0,-47.0,-51.0,-47.0,-43.0,-48.0,-90.0,-92.0,-89.0,-91.0,38.0,45.0,45.0,44.0,1
608,CC:2F:71:3F:1F:24,5014375,1821787418,1167781,1336671068,3846594,485116350,1730,979037,1109301663,978204,1109200907,833,100756,946779,15,1166406,120269,1727,767,115556.0,28889.0,-71.0,-68.0,-66.0,-74.0,-70.0,-68.0,-66.0,-73.0,-90.0,-92.0,-89.0,-91.0,19.0,24.0,23.0,17.0,1
609,CC:2F:71:3E:C5:1F,3847578,485236647,984,120297,3846594,485116350,2,4269,356373,3552,271237,717,85136,1043,13,1415,28,2,54,144444.0,43333.0,-71.0,-73.0,-69.0,-61.0,-72.0,-72.0,-69.0,-61.0,-90.0,-92.0,-89.0,-91.0,19.0,19.0,20.0,30.0,1
610,BA:8C:B9:54:50:24,3851521,491309892,4927,6193542,3846594,485116350,7,9737,1750630,9715,1747135,22,3495,2358,17,5428,41,7,70,216660.0,130000.0,-39.0,-37.0,-45.0,-52.0,-44.0,-35.0,-43.0,-47.0,-90.0,-92.0,-89.0,-91.0,51.0,55.0,44.0,39.0,1
611,62:47:05:9D:EB:15,3853341,497298542,6745,12182072,3846596,485116470,1,6964,3801913,6914,3794255,50,7658,3314,0,6810,56,1,125,229410.0,130000.0,-43.0,-45.0,-36.0,-48.0,-43.0,-45.0,-35.0,-49.0,-89.0,-91.0,-88.0,-91.0,46.0,46.0,52.0,43.0,1
612,92:69:1D:31:68:E9,3850639,488768935,4043,3652465,3846596,485116470,1,5387,1156603,5217,1117985,170,38618,2201,12,4295,103,1,61,229410.0,130000.0,-52.0,-47.0,-44.0,-47.0,-51.0,-47.0,-43.0,-48.0,-89.0,-91.0,-88.0,-91.0,37.0,44.0,44.0,44.0,1
613,CC:2F:71:3F:1F:24,5014587,1822047830,1167991,1336931360,3846596,485116470,1730,979226,1109538518,978393,1109437762,833,100756,946965,15,1166614,120278,1727,767,115556.0,28889.0,-71.0,-68.0,-67.0,-73.0,-70.0,-68.0,-66.0,-73.0,-89.0,-91.0,-88.0,-91.0,18.0,23.0,21.0,18.0,1
614,CC:2F:71:3E:C5:1F,3847580,485236767,984,120297,3846596,485116470,2,4269,356373,3552,271237,717,85136,1043,13,1415,28,2,54,144444.0,43333.0,-71.0,-73.0,-69.0,-61.0,-72.0,-72.0,-69.0,-61.0,-89.0,-91.0,-88.0,-91.0,18.0,18.0,19.0,30.0,1
615,BA:8C:B9:54:50:24,3851523,491310012,4927,6193542,3846596,485116470,7,9737,1750630,9715,1747135,22,3495,2358,17,5428,41,7,70,216660.0,130000.0,-39.0,-37.0,-45.0,-52.0,-44.0,-35.0,-43.0,-47.0,-89.0,-91.0,-88.0,-91.0,50.0,54.0,43.0,39.0,1
616,62:47:05:9D:EB:15,3853350,497299410,6745,12182072,3846605,485117338,1,6967,3802117,6917,3794459,50,7658,3314,0,6810,56,1,125,229410.0,130000.0,-44.0,-46.0,-36.0,-48.0,-43.0,-46.0,-37.0,-47.0,-89.0,-91.0,-88.0,-91.0,45.0,45.0,52.0,43.0,1
617,92:69:1D:31:68:E9,3850648,488769803,4043,3652465,3846605,485117338,1,5387,1156603,5217,1117985,170,38618,2201,12,4295,103,1,61,229410.0,130000.0,-52.0,-47.0,-44.0,-47.0,-51.0,-47.0,-43.0,-48.0,-89.0,-91.0,-88.0,-91.0,37.0,44.0,44.0,44.0,1
618,CC:2F:71:3F:1F:24,5015416,1823153261,1168811,1338035923,3846605,485117338,1730,979645,1109816701,978812,1109715945,833,100756,947374,15,1167436,120278,1727,767,115556.0,28889.0,-70.0,-69.0,-67.0,-74.0,-70.0,-69.0,-67.0,-73.0,-89.0,-91.0,-88.0,-91.0,19.0,22.0,21.0,17.0,1
619,CC:2F:71:3E:C5:1F,3847589,485237635,984,120297,3846605,485117338,2,4269,356373,3552,271237,717,85136,1043,13,1415,28,2,54,144444.0,43333.0,-71.0,-73.0,-69.0,-61.0,-72.0,-72.0,-69.0,-61.0,-89.0,-91.0,-88.0,-91.0,18.0,18.0,19.0,30.0,1
620,BA:8C:B9:54:50:24,3851532,491310880,4927,6193542,3846605,485117338,7,9737,1750630,9715,1747135,22,3495,2358,17,5428,41,7,70,216660.0,130000.0,-39.0,-37.0,-45.0,-52.0,-44.0,-35.0,-43.0,-47.0,-89.0,-91.0,-88.0,-91.0,50.0,54.0,43.0,39.0,1
621,62:47:05:9D:EB:15,3853351,497299470,6745,12182072,3846606,485117398,1,6968,3802185,6918,3794527,50,7658,3314,0,6810,56,1,125,229410.0,130000.0,-45.0,-51.0,-43.0,-44.0,-43.0,-47.0,-37.0,-47.0,-89.0,-91.0,-88.0,-91.0,44.0,40.0,45.0,47.0,1
622,92:69:1D:31:68:E9,3850649,488769863,4043,3652465,3846606,485117398,1,5387,1156603,5217,1117985,170,38618,2201,12,4295,103,1,61,229410.0,130000.0,-52.0,-47.0,-44.0,-47.0,-51.0,-47.0,-43.0,-48.0,-89.0,-91.0,-88.0,-91.0,37.0,44.0,44.0,44.0,1
623,CC:2F:71:3F:1F:24,5015849,1823705878,1169243,1338588480,3846606,485117398,1730,979918,1110060964,979085,1109960208,833,100756,947645,15,1167868,120288,1727,767,115556.0,28889.0,-70.0,-69.0,-67.0,-73.0,-70.0,-69.0,-67.0,-73.0,-89.0,-91.0,-88.0,-91.0,19.0,22.0,21.0,18.0,1
624,CC:2F:71:3E:C5:1F,3847591,485237755,984,120297,3846607,485117458,2,4269,356373,3552,271237,717,85136,1043,13,1415,28,2,54,144444.0,43333.0,-71.0,-73.0,-69.0,-61.0,-72.0,-72.0,-69.0,-61.0,-89.0,-91.0,-88.0,-91.0,18.0,18.0,19.0,30.0,1
625,BA:8C:B9:54:50:24,3851534,491311000,4927,6193542,3846607,485117458,7,9737,1750630,9715,1747135,22,3495,2358,17,5428,41,7,70,216660.0,130000.0,-39.0,-37.0,-45.0,-52.0,-44.0,-35.0,-43.0,-47.0,-89.0,-91.0,-88.0,-91.0,50.0,54.0,43.0,39.0,1
626,62:47:05:9D:EB:15,3853361,497300454,6746,12182188,3846615,485118266,1,6969,3802253,6919,3794595,50,7658,3314,0,6811,56,1,125,229410.0,130000.0,-44.0,-46.0,-36.0,-48.0,-43.0,-47.0,-37.0,-47.0,-89.0,-91.0,-88.0,-90.0,45.0,45.0,52.0,42.0,1
627,92:69:1D:31:68:E9,3850659,488770847,4044,3652581,3846615,485118266,1,5389,1156739,5219,1118121,170,38618,2201,12,4296,103,1,61,229410.0,130000.0,-52.0,-48.0,-44.0,-48.0,-51.0,-47.0,-44.0,-48.0,-89.0,-91.0,-88.0,-90.0,37.0,43.0,44.0,42.0,1
628,CC:2F:71:3F:1F:24,5016053,1823951266,1169438,1338833000,3846615,485118266,1730,980092,1110293654,979259,1110192898,833,100756,947816,15,1168063,120295,1727,767,115556.0,28889.0,-71.0,-68.0,-67.0,-73.0,-70.0,-68.0,-67.0,-73.0,-89.0,-91.0,-88.0,-90.0,18.0,23.0,21.0,17.0,1
629,CC:2F:71:3E:C5:1F,3847601,485238683,985,120357,3846616,485118326,2,4271,356513,3554,271377,717,85136,1043,13,1416,28,2,54,130000.0,39000.0,-71.0,-73.0,-69.0,-61.0,-72.0,-72.0,-69.0,-61.0,-89.0,-91.0,-88.0,-90.0,18.0,18.0,19.0,29.0,1
630,BA:8C:B9:54:50:24,3851544,491311984,4928,6193658,3846616,485118326,7,9743,1751038,9721,1747543,22,3495,2358,17,5429,41,7,70,216660.0,130000.0,-40.0,-36.0,-46.0,-51.0,-40.0,-35.0,-44.0,-48.0,-89.0,-91.0,-88.0,-90.0,49.0,55.0,42.0,39.0,1
631,62:47:05:9D:EB:15,3853362,497300514,6746,12182188,3846616,485118326,1,6970,3802321,6920,3794663,50,7658,3314,0,6811,56,1,125,229410.0,130000.0,-43.0,-45.0,-36.0,-48.0,-43.0,-46.0,-37.0,-46.0,-89.0,-91.0,-87.0,-90.0,46.0,46.0,51.0,42.0,1
632,92:69:1D:31:68:E9,3850660,488770907,4044,3652581,3846616,485118326,1,5389,1156739,5219,1118121,170,38618,2201,12,4296,103,1,61,229410.0,130000.0,-52.0,-48.0,-44.0,-48.0,-51.0,-47.0,-44.0,-48.0,-89.0,-91.0,-87.0,-90.0,37.0,43.0,43.0,42.0,1
633,CC:2F:71:3F:1F:24,5016245,1824192716,1169629,1339074390,3846616,485118326,1730,980265,1110523440,979432,1110422684,833,100756,947984,15,1168253,120295,1727,767,115556.0,28889.0,-71.0,-69.0,-67.0,-74.0,-71.0,-69.0,-67.0,-74.0,-89.0,-91.0,-87.0,-90.0,18.0,22.0,20.0,16.0,1
634,CC:2F:71:3E:C5:1F,3847601,485238683,985,120357,3846616,485118326,2,4271,356513,3554,271377,717,85136,1043,13,1416,28,2,54,130000.0,39000.0,-71.0,-73.0,-69.0,-61.0,-72.0,-72.0,-69.0,-61.0,-89.0,-91.0,-87.0,-90.0,18.0,18.0,18.0,29.0,1
635,BA:8C:B9:54:50:24,3851547,491312320,4928,6193658,3846619,485118662,7,9743,1751038,9721,1747543,22,3495,2358,17,5429,41,7,70,216660.0,130000.0,-40.0,-36.0,-46.0,-51.0,-40.0,-35.0,-44.0,-48.0,-89.0,-91.0,-87.0,-90.0,49.0,55.0,41.0,39.0,1
636,62:47:05:9D:EB:15,3853372,497301442,6746,12182188,3846626,485119254,1,6970,3802321,6920,3794663,50,7658,3314,0,6811,56,1,125,229410.0,130000.0,-43.0,-45.0,-36.0,-48.0,-43.0,-46.0,-37.0,-46.0,-89.0,-90.0,-87.0,-89.0,46.0,45.0,51.0,41.0,1
637,92:69:1D:31:68:E9,3850670,488771835,4044,3652581,3846626,485119254,1,5389,1156739,5219,1118121,170,38618,2201,12,4296,103,1,61,229410.0,130000.0,-52.0,-48.0,-44.0,-48.0,-51.0,-47.0,-44.0,-48.0,-89.0,-90.0,-87.0,-89.0,37.0,42.0,43.0,41.0,1
638,CC:2F:71:3F:1F:24,5016641,1824680891,1170015,1339561637,3846626,485119254,1730,980529,1110779162,979696,1110678406,833,100756,948238,15,1168640,120302,1727,768,115556.0,28889.0,-70.0,-68.0,-67.0,-73.0,-70.0,-68.0,-67.0,-73.0,-89.0,-90.0,-87.0,-89.0,19.0,22.0,20.0,16.0,1
639,CC:2F:71:3E:C5:1F,3847611,485239611,985,120357,3846626,485119254,2,4271,356513,3554,271377,717,85136,1043,13,1416,28,2,54,130000.0,39000.0,-71.0,-73.0,-69.0,-61.0,-72.0,-72.0,-69.0,-61.0,-89.0,-90.0,-87.0,-89.0,18.0,17.0,18.0,28.0,1
640,BA:8C:B9:54:50:24,3851554,491312912,4928,6193658,3846626,485119254,7,9744,1751106,9722,1747611,22,3495,2358,17,5429,41,7,70,216660.0,130000.0,-40.0,-36.0,-45.0,-51.0,-40.0,-35.0,-44.0,-48.0,-89.0,-90.0,-87.0,-89.0,49.0,54.0,42.0,38.0,1
641,62:47:05:9D:EB:15,3853374,497301775,6746,12182188,3846628,485119587,1,6970,3802321,6920,3794663,50,7658,3314,0,6811,56,1,125,229410.0,130000.0,-43.0,-45.0,-36.0,-48.0,-43.0,-46.0,-37.0,-46.0,-89.0,-90.0,-87.0,-89.0,46.0,45.0,51.0,41.0,1
642,92:69:1D:31:68:E9,3850672,488772168,4044,3652581,3846628,485119587,1,5389,1156739,5219,1118121,170,38618,2201,12,4296,103,1,61,229410.0,130000.0,-52.0,-48.0,-44.0,-48.0,-51.0,-47.0,-44.0,-48.0,-89.0,-90.0,-87.0,-89.0,37.0,42.0,43.0,41.0,1
643,CC:2F:71:3F:1F:24,5017031,1825171522,1170403,1340051935,3846628,485119587,1730,980798,1111025502,979965,1110924746,833,100756,948499,15,1169027,120327,1727,769,115556.0,28889.0,-70.0,-69.0,-67.0,-73.0,-70.0,-69.0,-67.0,-73.0,-89.0,-90.0,-87.0,-89.0,19.0,21.0,20.0,16.0,1
644,CC:2F:71:3E:C5:1F,3847613,485239944,985,120357,3846628,485119587,2,4271,356513,3554,271377,717,85136,1043,13,1416,28,2,54,130000.0,39000.0,-71.0,-73.0,-69.0,-61.0,-72.0,-72.0,-69.0,-61.0,-89.0,-90.0,-87.0,-89.0,18.0,17.0,18.0,28.0,1
645,BA:8C:B9:54:50:24,3851560,491313649,4928,6193658,3846632,485119991,7,9744,1751106,9722,1747611,22,3495,2358,17,5429,41,7,70,216660.0,130000.0,-40.0,-36.0,-45.0,-51.0,-40.0,-35.0,-44.0,-48.0,-89.0,-90.0,-87.0,-89.0,49.0,54.0,42.0,38.0,1
646,62:47:05:9D:EB:15,3853382,497302583,6746,12182188,3846636,485120395,1,6970,3802321,6920,3794663,50,7658,3314,0,6811,56,1,125,229410.0,130000.0,-43.0,-45.0,-36.0,-48.0,-43.0,-46.0,-37.0,-46.0,-89.0,-90.0,-87.0,-89.0,46.0,45.0,51.0,41.0,1
647,92:69:1D:31:68:E9,3850681,488773036,4044,3652581,3846637,485120455,1,5389,1156739,5219,1118121,170,38618,2201,12,4296,103,1,61,229410.0,130000.0,-52.0,-48.0,-44.0,-48.0,-51.0,-47.0,-44.0,-48.0,-89.0,-90.0,-87.0,-89.0,37.0,42.0,43.0,41.0,1
648,CC:2F:71:3F:1F:24,5017616,1825904771,1170979,1340784316,3846637,485120455,1730,981149,1111280099,980316,1111179343,833,100756,948846,15,1169598,120342,1727,769,115556.0,28889.0,-70.0,-69.0,-67.0,-73.0,-70.0,-68.0,-67.0,-73.0,-89.0,-90.0,-87.0,-89.0,19.0,21.0,20.0,16.0,1
649,CC:2F:71:3E:C5:1F,3847624,485240934,985,120357,3846639,485120577,2,4272,356631,3554,271377,718,85254,1044,13,1416,28,2,54,130000.0,39000.0,-71.0,-73.0,-68.0,-61.0,-71.0,-72.0,-69.0,-61.0,-89.0,-90.0,-87.0,-89.0,18.0,17.0,19.0,28.0,1
650,BA:8C:B9:54:50:24,3851567,491314235,4928,6193658,3846639,485120577,7,9744,1751106,9722,1747611,22,3495,2358,17,5429,41,7,70,216660.0,130000.0,-40.0,-36.0,-45.0,-51.0,-40.0,-35.0,-44.0,-48.0,-89.0,-90.0,-87.0,-89.0,49.0,54.0,42.0,38.0,1
651,62:47:05:9D:EB:15,3853385,497302765,6746,12182188,3846639,485120577,1,6970,3802321,6920,3794663,50,7658,3314,0,6811,56,1,125,229410.0,130000.0,-43.0,-45.0,-36.0,-48.0,-43.0,-46.0,-37.0,-46.0,-89.0,-90.0,-87.0,-89.0,46.0,45.0,51.0,41.0,1
652,92:69:1D:31:68:E9,3850683,488773158,4044,3652581,3846639,485120577,1,5389,1156739,5219,1118121,170,38618,2201,12,4296,103,1,61,229410.0,130000.0,-52.0,-48.0,-44.0,-48.0,-51.0,-47.0,-44.0,-48.0,-89.0,-90.0,-87.0,-89.0,37.0,42.0,43.0,41.0,1
653,CC:2F:71:3F:1F:24,5018016,1826399804,1171373,1341278823,3846643,485120981,1730,981419,1111533667,980586,1111432911,833,100756,949109,15,1169998,120357,1727,769,115556.0,28889.0,-70.0,-69.0,-67.0,-74.0,-70.0,-69.0,-67.0,-73.0,-89.0,-90.0,-87.0,-89.0,19.0,21.0,20.0,15.0,1
654,CC:2F:71:3E:C5:1F,3847629,485241400,985,120357,3846644,485121043,2,4274,356771,3556,271517,718,85254,1044,13,1416,28,2,54,130000.0,39000.0,-82.0,-82.0,-75.0,-71.0,-72.0,-74.0,-69.0,-62.0,-89.0,-90.0,-87.0,-89.0,7.0,8.0,12.0,18.0,1
655,BA:8C:B9:54:50:24,3851573,491314761,4928,6193658,3846645,485121103,7,9744,1751106,9722,1747611,22,3495,2358,17,5429,41,7,70,216660.0,130000.0,-40.0,-36.0,-45.0,-51.0,-40.0,-35.0,-44.0,-48.0,-89.0,-90.0,-87.0,-89.0,49.0,54.0,42.0,38.0,1
656,62:47:05:9D:EB:15,3853395,497303695,6746,12182188,3846649,485121507,1,6970,3802321,6920,3794663,50,7658,3314,0,6811,56,1,125,229410.0,130000.0,-43.0,-45.0,-36.0,-48.0,-43.0,-46.0,-37.0,-46.0,-89.0,-90.0,-87.0,-89.0,46.0,45.0,51.0,41.0,1
657,92:69:1D:31:68:E9,3850693,488774088,4044,3652581,3846649,485121507,1,5389,1156739,5219,1118121,170,38618,2201,12,4296,103,1,61,229410.0,130000.0,-52.0,-48.0,-44.0,-48.0,-51.0,-47.0,-44.0,-48.0,-89.0,-90.0,-87.0,-89.0,37.0,42.0,43.0,41.0,1
658,CC:2F:71:3F:1F:24,5018410,1826888063,1171761,1341766556,3846649,485121507,1730,981693,1111779247,980859,1111678373,834,100874,949373,15,1170386,120357,1727,769,115556.0,28889.0,-70.0,-69.0,-67.0,-72.0,-70.0,-69.0,-66.0,-72.0,-89.0,-90.0,-87.0,-89.0,19.0,21.0,20.0,17.0,1
659,CC:2F:71:3E:C5:1F,3847634,485241864,985,120357,3846649,485121507,2,4274,356771,3556,271517,718,85254,1044,13,1416,28,2,54,130000.0,39000.0,-82.0,-82.0,-75.0,-71.0,-72.0,-74.0,-69.0,-62.0,-89.0,-90.0,-87.0,-89.0,7.0,8.0,12.0,18.0,1
660,BA:8C:B9:54:50:24,3851577,491315165,4928,6193658,3846649,485121507,7,9744,1751106,9722,1747611,22,3495,2358,17,5429,41,7,70,216660.0,130000.0,-40.0,-36.0,-45.0,-51.0,-40.0,-35.0,-44.0,-48.0,-89.0,-90.0,-87.0,-89.0,49.0,54.0,42.0,38.0,1
661,62:47:05:9D:EB:15,3853399,497304017,6746,12182188,3846653,485121829,1,6970,3802321,6920,3794663,50,7658,3314,0,6811,56,1,125,229410.0,130000.0,-43.0,-45.0,-36.0,-48.0,-43.0,-46.0,-37.0,-46.0,-88.0,-90.0,-86.0,-89.0,45.0,45.0,50.0,41.0,1
662,92:69:1D:31:68:E9,3850697,488774410,4044,3652581,3846653,485121829,1,5389,1156739,5219,1118121,170,38618,2201,12,4296,103,1,61,229410.0,130000.0,-52.0,-48.0,-44.0,-48.0,-51.0,-47.0,-44.0,-48.0,-88.0,-90.0,-86.0,-89.0,36.0,42.0,42.0,41.0,1
663,CC:2F:71:3F:1F:24,5018609,1827132749,1171954,1342010718,3846655,485122031,1730,981872,1112021177,981038,1111920303,834,100874,949543,15,1170579,120372,1727,769,130000.0,39000.0,-71.0,-69.0,-68.0,-72.0,-70.0,-69.0,-67.0,-72.0,-88.0,-90.0,-86.0,-89.0,17.0,21.0,18.0,17.0,1
664,CC:2F:71:3E:C5:1F,3847640,485242388,985,120357,3846655,485122031,2,4274,356771,3556,271517,718,85254,1044,13,1416,28,2,54,130000.0,39000.0,-82.0,-82.0,-75.0,-71.0,-72.0,-74.0,-69.0,-62.0,-88.0,-90.0,-86.0,-89.0,6.0,8.0,11.0,18.0,1
665,BA:8C:B9:54:50:24,3851583,491315689,4928,6193658,3846655,485122031,7,9744,1751106,9722,1747611,22,3495,2358,17,5429,41,7,70,216660.0,130000.0,-40.0,-36.0,-45.0,-51.0,-40.0,-35.0,-44.0,-48.0,-88.0,-90.0,-86.0,-89.0,48.0,54.0,41.0,38.0,1
666,62:47:05:9D:EB:15,3853406,497304683,6746,12182188,3846660,485122495,1,6970,3802321,6920,3794663,50,7658,3314,0,6811,56,1,125,229410.0,130000.0,-43.0,-45.0,-36.0,-48.0,-43.0,-46.0,-37.0,-46.0,-88.0,-90.0,-86.0,-89.0,45.0,45.0,50.0,41.0,1
667,92:69:1D:31:68:E9,3850704,488775076,4044,3652581,3846660,485122495,1,5389,1156739,5219,1118121,170,38618,2201,12,4296,103,1,61,229410.0,130000.0,-52.0,-48.0,-44.0,-48.0,-51.0,-47.0,-44.0,-48.0,-88.0,-90.0,-86.0,-89.0,36.0,42.0,42.0,41.0,1
668,CC:2F:71:3F:1F:24,5018809,1827377977,1172149,1342255482,3846660,485122495,1730,982049,1112254436,981215,1112153562,834,100874,949715,15,1170774,120381,1727,769,130000.0,43333.0,-70.0,-69.0,-67.0,-72.0,-69.0,-69.0,-66.0,-72.0,-88.0,-90.0,-86.0,-89.0,18.0,21.0,19.0,17.0,1
669,CC:2F:71:3E:C5:1F,3847645,485242852,985,120357,3846660,485122495,2,4274,356771,3556,271517,718,85254,1044,13,1416,28,2,54,130000.0,39000.0,-82.0,-82.0,-75.0,-71.0,-72.0,-74.0,-69.0,-62.0,-88.0,-90.0,-86.0,-89.0,6.0,8.0,11.0,18.0,1
670,BA:8C:B9:54:50:24,3851588,491316153,4928,6193658,3846660,485122495,7,9744,1751106,9722,1747611,22,3495,2358,17,5429,41,7,70,216660.0,130000.0,-40.0,-36.0,-45.0,-51.0,-40.0,-35.0,-44.0,-48.0,-88.0,-90.0,-86.0,-89.0,48.0,54.0,41.0,38.0,1
671,62:47:05:9D:EB:15,3853410,497305087,6746,12182188,3846664,485122899,1,6970,3802321,6920,3794663,50,7658,3314,0,6811,56,1,125,229410.0,130000.0,-43.0,-45.0,-36.0,-48.0,-43.0,-46.0,-37.0,-46.0,-88.0,-90.0,-86.0,-89.0,45.0,45.0,50.0,41.0,1
672,92:69:1D:31:68:E9,3850708,488775480,4044,3652581,3846664,485122899,1,5389,1156739,5219,1118121,170,38618,2201,12,4296,103,1,61,229410.0,130000.0,-52.0,-48.0,-44.0,-48.0,-51.0,-47.0,-44.0,-48.0,-88.0,-90.0,-86.0,-89.0,36.0,42.0,42.0,41.0,1
673,CC:2F:71:3F:1F:24,5019005,1827621255,1172340,1342498296,3846665,485122959,1730,982219,1112483690,981385,1112382816,834,100874,949884,15,1170965,120385,1727,769,130000.0,43333.0,-70.0,-70.0,-67.0,-73.0,-70.0,-70.0,-67.0,-73.0,-88.0,-90.0,-86.0,-89.0,18.0,20.0,19.0,16.0,1
674,CC:2F:71:3E:C5:1F,3847653,485243578,985,120357,3846668,485123221,2,4274,356771,3556,271517,718,85254,1044,13,1416,28,2,54,130000.0,39000.0,-82.0,-82.0,-75.0,-71.0,-72.0,-74.0,-69.0,-62.0,-88.0,-90.0,-86.0,-89.0,6.0,8.0,11.0,18.0,1
675,BA:8C:B9:54:50:24,3851596,491316879,4928,6193658,3846668,485123221,7,9744,1751106,9722,1747611,22,3495,2358,17,5429,41,7,70,216660.0,130000.0,-40.0,-36.0,-45.0,-51.0,-40.0,-35.0,-44.0,-48.0,-88.0,-90.0,-86.0,-89.0,48.0,54.0,41.0,38.0,1
676,62:47:05:9D:EB:15,3853416,497305611,6746,12182188,3846670,485123423,1,6970,3802321,6920,3794663,50,7658,3314,0,6811,56,1,125,229410.0,130000.0,-43.0,-45.0,-36.0,-48.0,-43.0,-46.0,-37.0,-46.0,-88.0,-89.0,-86.0,-88.0,45.0,44.0,50.0,40.0,1
677,92:69:1D:31:68:E9,3850714,488776004,4044,3652581,3846670,485123423,1,5389,1156739,5219,1118121,170,38618,2201,12,4296,103,1,61,229410.0,130000.0,-52.0,-48.0,-44.0,-48.0,-51.0,-47.0,-44.0,-48.0,-88.0,-89.0,-86.0,-88.0,36.0,41.0,42.0,40.0,1
678,CC:2F:71:3F:1F:24,5019210,1827869464,1172540,1342746041,3846670,485123423,1730,982402,1112719451,981568,1112618577,834,100874,950062,15,1171164,120398,1727,770,130000.0,43333.0,-71.0,-69.0,-67.0,-72.0,-71.0,-69.0,-66.0,-72.0,-88.0,-89.0,-86.0,-88.0,17.0,20.0,19.0,16.0,1
679,CC:2F:71:3E:C5:1F,3847655,485243780,985,120357,3846670,485123423,2,4274,356771,3556,271517,718,85254,1044,13,1416,28,2,54,130000.0,39000.0,-82.0,-82.0,-75.0,-71.0,-72.0,-74.0,-69.0,-62.0,-88.0,-89.0,-86.0,-88.0,6.0,7.0,11.0,17.0,1
680,BA:8C:B9:54:50:24,3851598,491317081,4928,6193658,3846670,485123423,7,9744,1751106,9722,1747611,22,3495,2358,17,5429,41,7,70,216660.0,130000.0,-40.0,-36.0,-45.0,-51.0,-40.0,-35.0,-44.0,-48.0,-88.0,-89.0,-86.0,-88.0,48.0,53.0,41.0,37.0,1
681,62:47:05:9D:EB:15,3853421,497306075,6746,12182188,3846675,485123887,1,6970,3802321,6920,3794663,50,7658,3314,0,6811,56,1,125,229410.0,130000.0,-43.0,-45.0,-36.0,-48.0,-43.0,-46.0,-37.0,-46.0,-88.0,-89.0,-85.0,-88.0,45.0,44.0,49.0,40.0,1
682,92:69:1D:31:68:E9,3850721,488776670,4044,3652581,3846677,485124089,1,5389,1156739,5219,1118121,170,38618,2201,12,4296,103,1,61,229410.0,130000.0,-52.0,-48.0,-44.0,-48.0,-51.0,-47.0,-44.0,-48.0,-88.0,-89.0,-85.0,-88.0,36.0,41.0,41.0,40.0,1
683,CC:2F:71:3F:1F:24,5019408,1828111520,1172731,1342987431,3846677,485124089,1730,982578,1112955181,981744,1112854307,834,100874,950233,15,1171356,120399,1727,770,130000.0,43333.0,-73.0,-70.0,-66.0,-72.0,-72.0,-69.0,-66.0,-72.0,-88.0,-89.0,-85.0,-88.0,15.0,19.0,19.0,16.0,1
684,CC:2F:71:3E:C5:1F,3847662,485244446,985,120357,3846677,485124089,2,4274,356771,3556,271517,718,85254,1044,13,1416,28,2,54,130000.0,39000.0,-82.0,-82.0,-75.0,-71.0,-72.0,-74.0,-69.0,-62.0,-88.0,-89.0,-85.0,-88.0,6.0,7.0,10.0,17.0,1
685,BA:8C:B9:54:50:24,3851605,491317747,4928,6193658,3846677,485124089,7,9744,1751106,9722,1747611,22,3495,2358,17,5429,41,7,70,216660.0,130000.0,-40.0,-36.0,-45.0,-51.0,-40.0,-35.0,-44.0,-48.0,-88.0,-89.0,-85.0,-88.0,48.0,53.0,40.0,37.0,1
686,62:47:05:9D:EB:15,3853427,497306599,6746,12182188,3846681,485124411,1,6970,3802321,6920,3794663,50,7658,3314,0,6811,56,1,125,229410.0,130000.0,-43.0,-45.0,-36.0,-48.0,-43.0,-46.0,-37.0,-46.0,-88.0,-89.0,-85.0,-87.0,45.0,44.0,49.0,39.0,1
687,92:69:1D:31:68:E9,3850725,488776992,4044,3652581,3846681,485124411,1,5391,1156875,5221,1118257,170,38618,2201,12,4297,103,1,61,229410.0,130000.0,-52.0,-47.0,-43.0,-49.0,-51.0,-47.0,-44.0,-48.0,-88.0,-89.0,-85.0,-87.0,36.0,42.0,42.0,38.0,1
688,CC:2F:71:3F:1F:24,5019605,1828354720,1172924,1343230309,3846681,485124411,1730,982756,1113188233,981922,1113087359,834,100874,950407,15,1171549,120399,1727,770,144444.0,43333.0,-71.0,-69.0,-67.0,-74.0,-71.0,-69.0,-67.0,-74.0,-88.0,-89.0,-85.0,-87.0,17.0,20.0,18.0,13.0,1
689,CC:2F:71:3E:C5:1F,3847666,485244768,985,120357,3846681,485124411,2,4276,356911,3558,271657,718,85254,1044,13,1417,28,2,54,130000.0,39000.0,-73.0,-73.0,-69.0,-60.0,-72.0,-74.0,-69.0,-62.0,-88.0,-89.0,-85.0,-87.0,15.0,16.0,16.0,27.0,1
690,BA:8C:B9:54:50:24,3851609,491318069,4928,6193658,3846681,485124411,7,9746,1751242,9724,1747747,22,3495,2358,17,5430,41,7,70,216660.0,130000.0,-48.0,-35.0,-42.0,-45.0,-41.0,-35.0,-43.0,-47.0,-88.0,-89.0,-85.0,-87.0,40.0,54.0,43.0,42.0,1
691,62:47:05:9D:EB:15,3853434,497307265,6746,12182188,3846688,485125077,1,6972,3802457,6922,3794799,50,7658,3314,0,6812,56,1,125,229410.0,130000.0,-43.0,-45.0,-36.0,-49.0,-43.0,-46.0,-37.0,-47.0,-88.0,-89.0,-85.0,-87.0,45.0,44.0,49.0,38.0,1
692,92:69:1D:31:68:E9,3850732,488777658,4044,3652581,3846688,485125077,1,5391,1156875,5221,1118257,170,38618,2201,12,4297,103,1,61,229410.0,130000.0,-52.0,-47.0,-43.0,-49.0,-51.0,-47.0,-44.0,-48.0,-88.0,-89.0,-85.0,-87.0,36.0,42.0,42.0,38.0,1
693,CC:2F:71:3F:1F:24,5019803,1828596776,1173115,1343471699,3846688,485125077,1730,982929,1113418005,982095,1113317131,834,100874,950576,15,1171740,120399,1727,770,144444.0,43333.0,-72.0,-69.0,-66.0,-73.0,-72.0,-69.0,-66.0,-72.0,-88.0,-88.0,-85.0,-87.0,16.0,19.0,19.0,14.0,1
694,CC:2F:71:3E:C5:1F,3847673,485245434,985,120357,3846688,485125077,2,4276,356911,3558,271657,718,85254,1044,13,1417,28,2,54,130000.0,39000.0,-73.0,-73.0,-69.0,-60.0,-72.0,-74.0,-69.0,-62.0,-88.0,-88.0,-85.0,-87.0,15.0,15.0,16.0,27.0,1
695,BA:8C:B9:54:50:24,3851616,491318735,4928,6193658,3846688,485125077,7,9746,1751242,9724,1747747,22,3495,2358,17,5430,41,7,70,216660.0,130000.0,-48.0,-35.0,-42.0,-45.0,-41.0,-35.0,-43.0,-47.0,-88.0,-88.0,-85.0,-87.0,40.0,53.0,43.0,42.0,1
696,62:47:05:9D:EB:15,3853438,497307753,6748,12182474,3846690,485125279,1,6975,3802791,6925,3795133,50,7658,3316,0,6814,56,1,125,229410.0,137640.0,-46.0,-49.0,-40.0,-47.0,-44.0,-46.0,-37.0,-47.0,-88.0,-88.0,-85.0,-87.0,42.0,39.0,45.0,40.0,1
697,92:69:1D:31:68:E9,3850734,488777860,4044,3652581,3846690,485125279,1,5391,1156875,5221,1118257,170,38618,2201,12,4297,103,1,61,229410.0,130000.0,-52.0,-47.0,-43.0,-49.0,-51.0,-47.0,-44.0,-48.0,-88.0,-88.0,-85.0,-87.0,36.0,41.0,42.0,38.0,1
698,CC:2F:71:3F:1F:24,5020004,1828842229,1173313,1343716890,3846691,485125339,1730,983110,1113650561,982276,1113549687,834,100874,950753,15,1171938,120410,1727,770,130000.0,43333.0,-72.0,-69.0,-66.0,-72.0,-72.0,-69.0,-66.0,-71.0,-88.0,-88.0,-85.0,-87.0,16.0,19.0,19.0,15.0,1
699,CC:2F:71:3E:C5:1F,3847676,485245696,985,120357,3846691,485125339,2,4276,356911,3558,271657,718,85254,1044,13,1417,28,2,54,130000.0,39000.0,-73.0,-73.0,-69.0,-60.0,-72.0,-74.0,-69.0,-62.0,-88.0,-88.0,-85.0,-87.0,15.0,15.0,16.0,27.0,1
700,BA:8C:B9:54:50:24,3851620,491319057,4928,6193658,3846692,485125399,7,9746,1751242,9724,1747747,22,3495,2358,17,5430,41,7,70,216660.0,130000.0,-48.0,-35.0,-42.0,-45.0,-41.0,-35.0,-43.0,-47.0,-88.0,-88.0,-85.0,-87.0,40.0,53.0,43.0,42.0,1
701,62:47:05:9D:EB:15,3853446,497308479,6748,12182474,3846698,485126005,1,6976,3802859,6926,3795201,50,7658,3316,0,6814,56,1,125,229410.0,137640.0,-42.0,-45.0,-35.0,-48.0,-43.0,-46.0,-36.0,-47.0,-88.0,-88.0,-85.0,-87.0,46.0,43.0,50.0,39.0,1
702,92:69:1D:31:68:E9,3850742,488778586,4044,3652581,3846698,485126005,1,5391,1156875,5221,1118257,170,38618,2201,12,4297,103,1,61,229410.0,130000.0,-52.0,-47.0,-43.0,-49.0,-51.0,-47.0,-44.0,-48.0,-88.0,-88.0,-85.0,-87.0,36.0,41.0,42.0,38.0,1
703,CC:2F:71:3F:1F:24,5020202,1829083893,1173504,1343957888,3846698,485126005,1730,983286,1113884949,982452,1113784075,834,100874,950923,15,1172129,120431,1727,770,130000.0,43333.0,-71.0,-71.0,-67.0,-72.0,-71.0,-70.0,-66.0,-72.0,-88.0,-88.0,-85.0,-87.0,17.0,17.0,18.0,15.0,1
704,CC:2F:71:3E:C5:1F,3847683,485246362,985,120357,3846698,485126005,2,4276,356911,3558,271657,718,85254,1044,13,1417,28,2,54,130000.0,39000.0,-73.0,-73.0,-69.0,-60.0,-72.0,-74.0,-69.0,-62.0,-88.0,-88.0,-85.0,-87.0,15.0,15.0,16.0,27.0,1
705,BA:8C:B9:54:50:24,3851627,491319936,4928,6193658,3846699,485126278,7,9746,1751242,9724,1747747,22,3495,2358,17,5430,41,7,70,216660.0,130000.0,-48.0,-35.0,-42.0,-45.0,-41.0,-35.0,-43.0,-47.0,-88.0,-88.0,-85.0,-87.0,40.0,53.0,43.0,42.0,1
706,62:47:05:9D:EB:15,3853450,497309014,6748,12182474,3846702,485126540,1,6976,3802859,6926,3795201,50,7658,3316,0,6814,56,1,125,229410.0,137640.0,-42.0,-45.0,-35.0,-48.0,-43.0,-46.0,-36.0,-47.0,-88.0,-88.0,-85.0,-87.0,46.0,43.0,50.0,39.0,1
707,92:69:1D:31:68:E9,3850746,488779121,4044,3652581,3846702,485126540,1,5391,1156875,5221,1118257,170,38618,2201,12,4297,103,1,61,229410.0,130000.0,-52.0,-47.0,-43.0,-49.0,-51.0,-47.0,-44.0,-48.0,-88.0,-88.0,-85.0,-87.0,36.0,41.0,42.0,38.0,1
708,CC:2F:71:3F:1F:24,5020411,1829347518,1173709,1344220978,3846702,485126540,1730,983472,1114134871,982638,1114033997,834,100874,951106,15,1172334,120432,1727,771,130000.0,43333.0,-72.0,-70.0,-65.0,-72.0,-71.0,-69.0,-65.0,-72.0,-88.0,-88.0,-85.0,-87.0,16.0,18.0,20.0,15.0,1
709,CC:2F:71:3E:C5:1F,3847687,485246897,985,120357,3846702,485126540,2,4276,356911,3558,271657,718,85254,1044,13,1417,28,2,54,130000.0,39000.0,-73.0,-73.0,-69.0,-60.0,-72.0,-74.0,-69.0,-62.0,-88.0,-88.0,-85.0,-87.0,15.0,15.0,16.0,27.0,1
710,BA:8C:B9:54:50:24,3851630,491320198,4928,6193658,3846702,485126540,7,9746,1751242,9724,1747747,22,3495,2358,17,5430,41,7,70,216660.0,130000.0,-48.0,-35.0,-42.0,-45.0,-41.0,-35.0,-43.0,-47.0,-88.0,-88.0,-85.0,-87.0,40.0,53.0,43.0,42.0,1
711,62:47:05:9D:EB:15,3853458,497309740,6748,12182474,3846710,485127266,1,6976,3802859,6926,3795201,50,7658,3316,0,6814,56,1,125,229410.0,137640.0,-42.0,-45.0,-35.0,-48.0,-43.0,-46.0,-36.0,-47.0,-88.0,-88.0,-85.0,-87.0,46.0,43.0,50.0,39.0,1
712,92:69:1D:31:68:E9,3850754,488779847,4044,3652581,3846710,485127266,1,5391,1156875,5221,1118257,170,38618,2201,12,4297,103,1,61,229410.0,130000.0,-52.0,-47.0,-43.0,-49.0,-51.0,-47.0,-44.0,-48.0,-88.0,-88.0,-85.0,-87.0,36.0,41.0,42.0,38.0,1
713,CC:2F:71:3F:1F:24,5020836,1829858080,1174126,1344730814,3846710,485127266,1730,983757,1114399805,982923,1114298931,834,100874,951380,15,1172751,120511,1727,771,115556.0,28889.0,-74.0,-74.0,-71.0,-77.0,-73.0,-73.0,-69.0,-76.0,-88.0,-88.0,-85.0,-87.0,14.0,14.0,14.0,10.0,1
714,CC:2F:71:3E:C5:1F,3847695,485247623,985,120357,3846710,485127266,2,4276,356911,3558,271657,718,85254,1044,13,1417,28,2,54,130000.0,39000.0,-73.0,-73.0,-69.0,-60.0,-72.0,-74.0,-69.0,-62.0,-88.0,-88.0,-85.0,-87.0,15.0,15.0,16.0,27.0,1
715,BA:8C:B9:54:50:24,3851638,491320924,4928,6193658,3846710,485127266,7,9746,1751242,9724,1747747,22,3495,2358,17,5430,41,7,70,216660.0,130000.0,-48.0,-35.0,-42.0,-45.0,-41.0,-35.0,-43.0,-47.0,-88.0,-88.0,-85.0,-87.0,40.0,53.0,43.0,42.0,1
716,62:47:05:9D:EB:15,3853461,497310002,6748,12182474,3846713,485127528,1,6976,3802859,6926,3795201,50,7658,3316,0,6814,56,1,125,229410.0,137640.0,-42.0,-45.0,-35.0,-48.0,-43.0,-46.0,-36.0,-47.0,-88.0,-89.0,-85.0,-87.0,46.0,44.0,50.0,39.0,1
717,92:69:1D:31:68:E9,3850757,488780109,4044,3652581,3846713,485127528,1,5391,1156875,5221,1118257,170,38618,2201,12,4297,103,1,61,229410.0,130000.0,-52.0,-47.0,-43.0,-49.0,-51.0,-47.0,-44.0,-48.0,-88.0,-89.0,-85.0,-87.0,36.0,42.0,42.0,38.0,1
718,CC:2F:71:3F:1F:24,5021388,1830564425,1174675,1345436897,3846713,485127528,1730,984095,1114668663,983261,1114567789,834,100874,951708,15,1173300,120516,1727,771,117000.0,39000.0,-72.0,-71.0,-68.0,-73.0,-72.0,-71.0,-67.0,-73.0,-88.0,-89.0,-85.0,-87.0,16.0,18.0,17.0,14.0,1
719,CC:2F:71:3E:C5:1F,3847698,485247885,985,120357,3846713,485127528,2,4276,356911,3558,271657,718,85254,1044,13,1417,28,2,54,130000.0,39000.0,-73.0,-73.0,-69.0,-60.0,-72.0,-74.0,-69.0,-62.0,-88.0,-89.0,-85.0,-87.0,15.0,16.0,16.0,27.0,1
720,BA:8C:B9:54:50:24,3851641,491321186,4928,6193658,3846713,485127528,7,9746,1751242,9724,1747747,22,3495,2358,17,5430,41,7,70,216660.0,130000.0,-48.0,-35.0,-42.0,-45.0,-41.0,-35.0,-43.0,-47.0,-88.0,-89.0,-85.0,-87.0,40.0,54.0,43.0,42.0,1
721,62:47:05:9D:EB:15,3853467,497310608,6748,12182474,3846719,485128134,1,6976,3802859,6926,3795201,50,7658,3316,0,6814,56,1,125,229410.0,137640.0,-42.0,-45.0,-35.0,-48.0,-43.0,-46.0,-36.0,-47.0,-88.0,-89.0,-85.0,-87.0,46.0,44.0,50.0,39.0,1
722,92:69:1D:31:68:E9,3850764,488780775,4044,3652581,3846720,485128194,1,5391,1156875,5221,1118257,170,38618,2201,12,4297,103,1,61,229410.0,130000.0,-52.0,-47.0,-43.0,-49.0,-51.0,-47.0,-44.0,-48.0,-88.0,-89.0,-85.0,-87.0,36.0,42.0,42.0,38.0,1
723,CC:2F:71:3F:1F:24,5022003,1831309573,1175283,1346181379,3846720,485128194,1730,984480,1114946682,983646,1114845808,834,100874,952078,15,1173908,120551,1727,771,130000.0,43333.0,-71.0,-70.0,-68.0,-74.0,-71.0,-70.0,-67.0,-74.0,-88.0,-89.0,-85.0,-87.0,17.0,19.0,17.0,13.0,1
724,CC:2F:71:3E:C5:1F,3847706,485248611,985,120357,3846721,485128254,2,4276,356911,3558,271657,718,85254,1044,13,1417,28,2,54,130000.0,39000.0,-73.0,-73.0,-69.0,-60.0,-72.0,-74.0,-69.0,-62.0,-88.0,-89.0,-85.0,-87.0,15.0,16.0,16.0,27.0,1
725,BA:8C:B9:54:50:24,3851649,491321912,4928,6193658,3846721,485128254,7,9746,1751242,9724,1747747,22,3495,2358,17,5430,41,7,70,216660.0,130000.0,-48.0,-35.0,-42.0,-45.0,-41.0,-35.0,-43.0,-47.0,-88.0,-89.0,-85.0,-87.0,40.0,54.0,43.0,42.0,1
726,62:47:05:9D:EB:15,3853471,497310930,6748,12182474,3846723,485128456,1,6976,3802859,6926,3795201,50,7658,3316,0,6814,56,1,125,229410.0,137640.0,-42.0,-45.0,-35.0,-48.0,-43.0,-46.0,-36.0,-47.0,-88.0,-89.0,-85.0,-87.0,46.0,44.0,50.0,39.0,1
727,92:69:1D:31:68:E9,3850767,488781037,4044,3652581,3846723,485128456,1,5391,1156875,5221,1118257,170,38618,2201,12,4297,103,1,61,229410.0,130000.0,-52.0,-47.0,-43.0,-49.0,-51.0,-47.0,-44.0,-48.0,-88.0,-89.0,-85.0,-87.0,36.0,42.0,42.0,38.0,1
728,CC:2F:71:3F:1F:24,5022627,1832091728,1175904,1346963272,3846723,485128456,1730,984868,1115220746,984034,1115119872,834,100874,952460,15,1174529,120552,1727,771,130000.0,43333.0,-75.0,-72.0,-71.0,-76.0,-74.0,-71.0,-70.0,-75.0,-88.0,-89.0,-85.0,-87.0,13.0,17.0,14.0,11.0,1
729,CC:2F:71:3E:C5:1F,3847708,485248813,985,120357,3846723,485128456,2,4276,356911,3558,271657,718,85254,1044,13,1417,28,2,54,130000.0,39000.0,-73.0,-73.0,-69.0,-60.0,-72.0,-74.0,-69.0,-62.0,-88.0,-89.0,-85.0,-87.0,15.0,16.0,16.0,27.0,1
730,BA:8C:B9:54:50:24,3851656,491322652,4928,6193658,3846728,485128994,7,9746,1751242,9724,1747747,22,3495,2358,17,5430,41,7,70,216660.0,130000.0,-48.0,-35.0,-42.0,-45.0,-41.0,-35.0,-43.0,-47.0,-88.0,-89.0,-85.0,-87.0,40.0,54.0,43.0,42.0,1
731,62:47:05:9D:EB:15,3853479,497311656,6749,12182534,3846730,485129122,1,6979,3803105,6929,3795447,50,7658,3317,0,6815,56,1,125,229410.0,137640.0,-43.0,-45.0,-35.0,-49.0,-44.0,-46.0,-37.0,-47.0,-88.0,-89.0,-86.0,-88.0,45.0,44.0,51.0,39.0,1
732,92:69:1D:31:68:E9,3850774,488781703,4044,3652581,3846730,485129122,1,5391,1156875,5221,1118257,170,38618,2201,12,4297,103,1,61,229410.0,130000.0,-52.0,-47.0,-43.0,-49.0,-51.0,-47.0,-44.0,-48.0,-88.0,-89.0,-86.0,-88.0,36.0,42.0,43.0,39.0,1
733,CC:2F:71:3F:1F:24,5023287,1832927823,1176557,1347798701,3846730,485129122,1730,985265,1115486065,984431,1115385191,834,100874,952844,15,1175181,120567,1727,772,130000.0,43333.0,-75.0,-73.0,-71.0,-77.0,-73.0,-71.0,-69.0,-75.0,-88.0,-89.0,-86.0,-88.0,13.0,16.0,15.0,11.0,1
734,CC:2F:71:3E:C5:1F,3847715,485249479,985,120357,3846730,485129122,2,4276,356911,3558,271657,718,85254,1044,13,1417,28,2,54,130000.0,39000.0,-73.0,-73.0,-69.0,-60.0,-72.0,-74.0,-69.0,-62.0,-88.0,-89.0,-86.0,-88.0,15.0,16.0,17.0,28.0,1
735,BA:8C:B9:54:50:24,3851658,491322780,4928,6193658,3846730,485129122,7,9746,1751242,9724,1747747,22,3495,2358,17,5430,41,7,70,216660.0,130000.0,-48.0,-35.0,-42.0,-45.0,-41.0,-35.0,-43.0,-47.0,-88.0,-89.0,-86.0,-88.0,40.0,54.0,44.0,43.0,1
736,62:47:05:9D:EB:15,3853483,497311978,6749,12182534,3846734,485129444,1,6979,3803105,6929,3795447,50,7658,3317,0,6815,56,1,125,229410.0,137640.0,-43.0,-45.0,-35.0,-49.0,-44.0,-46.0,-37.0,-47.0,-88.0,-89.0,-86.0,-88.0,45.0,44.0,51.0,39.0,1
737,92:69:1D:31:68:E9,3850778,488782025,4044,3652581,3846734,485129444,1,5392,1156943,5222,1118325,170,38618,2201,12,4297,103,1,61,229410.0,130000.0,-52.0,-47.0,-42.0,-49.0,-51.0,-47.0,-44.0,-48.0,-88.0,-89.0,-86.0,-88.0,36.0,42.0,44.0,39.0,1
738,CC:2F:71:3F:1F:24,5023807,1833567657,1177071,1348438011,3846736,485129646,1730,985602,1115747663,984768,1115646789,834,100874,953172,15,1175696,120584,1727,772,130000.0,43333.0,-72.0,-69.0,-68.0,-72.0,-71.0,-69.0,-68.0,-72.0,-88.0,-89.0,-86.0,-88.0,16.0,20.0,18.0,16.0,1
739,CC:2F:71:3E:C5:1F,3847723,485250205,985,120357,3846738,485129848,2,4276,356911,3558,271657,718,85254,1044,13,1417,28,2,54,130000.0,39000.0,-73.0,-73.0,-69.0,-60.0,-72.0,-74.0,-69.0,-62.0,-88.0,-89.0,-86.0,-88.0,15.0,16.0,17.0,28.0,1
740,BA:8C:B9:54:50:24,3851668,491323708,4928,6193658,3846740,485130050,7,9746,1751242,9724,1747747,22,3495,2358,17,5430,41,7,70,216660.0,130000.0,-48.0,-35.0,-42.0,-45.0,-41.0,-35.0,-43.0,-47.0,-88.0,-89.0,-86.0,-88.0,40.0,54.0,44.0,43.0,1
741,62:47:05:9D:EB:15,3853489,497312584,6749,12182534,3846740,485130050,1,6979,3803105,6929,3795447,50,7658,3317,0,6815,56,1,125,229410.0,137640.0,-43.0,-45.0,-35.0,-49.0,-44.0,-46.0,-37.0,-47.0,-88.0,-89.0,-86.0,-88.0,45.0,44.0,51.0,39.0,1
742,92:69:1D:31:68:E9,3850784,488782631,4044,3652581,3846740,485130050,1,5392,1156943,5222,1118325,170,38618,2201,12,4297,103,1,61,229410.0,130000.0,-52.0,-47.0,-42.0,-49.0,-51.0,-47.0,-44.0,-48.0,-88.0,-89.0,-86.0,-88.0,36.0,42.0,44.0,39.0,1
743,CC:2F:71:3F:1F:24,5024006,1833817051,1177266,1348687001,3846740,485130050,1730,985787,1115993077,984953,1115892203,834,100874,953349,15,1175891,120602,1727,773,144444.0,43333.0,-72.0,-70.0,-68.0,-72.0,-71.0,-69.0,-67.0,-71.0,-88.0,-89.0,-86.0,-88.0,16.0,19.0,18.0,16.0,1
744,CC:2F:71:3E:C5:1F,3847725,485250407,985,120357,3846740,485130050,2,4276,356911,3558,271657,718,85254,1044,13,1417,28,2,54,130000.0,39000.0,-73.0,-73.0,-69.0,-60.0,-72.0,-74.0,-69.0,-62.0,-88.0,-89.0,-86.0,-88.0,15.0,16.0,17.0,28.0,1
745,BA:8C:B9:54:50:24,3851668,491323708,4928,6193658,3846740,485130050,7,9746,1751242,9724,1747747,22,3495,2358,17,5430,41,7,70,216660.0,130000.0,-48.0,-35.0,-42.0,-45.0,-41.0,-35.0,-43.0,-47.0,-88.0,-89.0,-86.0,-88.0,40.0,54.0,44.0,43.0,1
746,62:47:05:9D:EB:15,3853495,497313174,6749,12182534,3846746,485130640,1,6979,3803105,6929,3795447,50,7658,3317,0,6815,56,1,125,229410.0,137640.0,-43.0,-45.0,-35.0,-49.0,-44.0,-46.0,-37.0,-47.0,-88.0,-89.0,-86.0,-88.0,45.0,44.0,51.0,39.0,1
747,92:69:1D:31:68:E9,3850794,488783625,4044,3652581,3846750,485131044,1,5392,1156943,5222,1118325,170,38618,2201,12,4297,103,1,61,229410.0,130000.0,-52.0,-47.0,-42.0,-49.0,-51.0,-47.0,-44.0,-48.0,-88.0,-89.0,-86.0,-88.0,36.0,42.0,44.0,39.0,1
748,CC:2F:71:3F:1F:24,5024208,1834063837,1177458,1348932793,3846750,485131044,1730,985967,1116233653,985133,1116132779,834,100874,953521,15,1176083,120623,1727,773,144444.0,43333.0,-71.0,-69.0,-67.0,-71.0,-71.0,-69.0,-67.0,-71.0,-88.0,-89.0,-86.0,-88.0,17.0,20.0,19.0,17.0,1
749,CC:2F:71:3E:C5:1F,3847735,485251401,985,120357,3846750,485131044,2,4276,356911,3558,271657,718,85254,1044,13,1417,28,2,54,130000.0,39000.0,-73.0,-73.0,-69.0,-60.0,-72.0,-74.0,-69.0,-62.0,-88.0,-89.0,-86.0,-88.0,15.0,16.0,17.0,28.0,1
750,BA:8C:B9:54:50:24,3851678,491324702,4928,6193658,3846750,485131044,7,9746,1751242,9724,1747747,22,3495,2358,17,5430,41,7,70,216660.0,130000.0,-48.0,-35.0,-42.0,-45.0,-41.0,-35.0,-43.0,-47.0,-88.0,-89.0,-86.0,-88.0,40.0,54.0,44.0,43.0,1
751,62:47:05:9D:EB:15,3853499,497313578,6749,12182534,3846750,485131044,1,6979,3803105,6929,3795447,50,7658,3317,0,6815,56,1,125,229410.0,137640.0,-43.0,-45.0,-35.0,-49.0,-44.0,-46.0,-37.0,-47.0,-88.0,-89.0,-86.0,-88.0,45.0,44.0,51.0,39.0,1
752,92:69:1D:31:68:E9,3850795,488783741,4045,3652697,3846750,485131044,1,5394,1157079,5224,1118461,170,38618,2201,12,4298,103,1,61,229410.0,130000.0,-52.0,-47.0,-43.0,-49.0,-51.0,-47.0,-43.0,-47.0,-88.0,-89.0,-86.0,-88.0,36.0,42.0,43.0,39.0,1
753,CC:2F:71:3F:1F:24,5024775,1834773611,1178025,1349642567,3846750,485131044,1730,986321,1116492892,985487,1116392018,834,100874,953871,15,1176650,120638,1727,773,130000.0,43333.0,-72.0,-69.0,-67.0,-71.0,-72.0,-69.0,-67.0,-71.0,-88.0,-89.0,-86.0,-88.0,16.0,20.0,19.0,17.0,1
754,CC:2F:71:3E:C5:1F,3847736,485251461,986,120417,3846750,485131044,2,4278,357051,3560,271797,718,85254,1044,13,1418,28,2,54,130000.0,39000.0,-72.0,-73.0,-69.0,-60.0,-73.0,-74.0,-69.0,-61.0,-88.0,-89.0,-86.0,-88.0,16.0,16.0,17.0,28.0,1
755,BA:8C:B9:54:50:24,3851679,491324818,4929,6193774,3846750,485131044,7,9750,1751514,9728,1748019,22,3495,2358,17,5431,41,7,70,216660.0,130000.0,-48.0,-35.0,-43.0,-45.0,-43.0,-35.0,-43.0,-47.0,-88.0,-89.0,-86.0,-88.0,40.0,54.0,43.0,43.0,1
756,62:47:05:9D:EB:15,3853508,497314502,6750,12182650,3846758,485131852,1,6981,3803241,6931,3795583,50,7658,3317,0,6816,56,1,125,229410.0,137640.0,-45.0,-50.0,-46.0,-45.0,-44.0,-47.0,-38.0,-47.0,-88.0,-90.0,-86.0,-88.0,43.0,40.0,40.0,43.0,1
757,92:69:1D:31:68:E9,3850803,488784549,4045,3652697,3846758,485131852,1,5394,1157079,5224,1118461,170,38618,2201,12,4298,103,1,61,229410.0,130000.0,-52.0,-47.0,-43.0,-49.0,-51.0,-47.0,-43.0,-47.0,-88.0,-90.0,-86.0,-88.0,36.0,43.0,43.0,39.0,1
758,CC:2F:71:3F:1F:24,5025167,1835264252,1178409,1350132400,3846758,485131852,1730,986576,1116736079,985742,1116635205,834,100874,954122,15,1177033,120688,1727,773,130000.0,43333.0,-71.0,-69.0,-67.0,-71.0,-70.0,-68.0,-67.0,-70.0,-88.0,-90.0,-86.0,-88.0,17.0,21.0,19.0,17.0,1
759,CC:2F:71:3E:C5:1F,3847744,485252269,986,120417,3846758,485131852,2,4278,357051,3560,271797,718,85254,1044,13,1418,28,2,54,130000.0,39000.0,-72.0,-73.0,-69.0,-60.0,-73.0,-74.0,-69.0,-61.0,-88.0,-90.0,-86.0,-88.0,16.0,17.0,17.0,28.0,1
760,BA:8C:B9:54:50:24,3851687,491325626,4929,6193774,3846758,485131852,7,9750,1751514,9728,1748019,22,3495,2358,17,5431,41,7,70,216660.0,130000.0,-48.0,-35.0,-43.0,-45.0,-43.0,-35.0,-43.0,-47.0,-88.0,-90.0,-86.0,-88.0,40.0,55.0,43.0,43.0,1
761,62:47:05:9D:EB:15,3853509,497314562,6750,12182650,3846759,485131912,1,6981,3803241,6931,3795583,50,7658,3317,0,6816,56,1,125,229410.0,137640.0,-45.0,-50.0,-46.0,-45.0,-44.0,-47.0,-38.0,-47.0,-89.0,-90.0,-87.0,-89.0,44.0,40.0,41.0,44.0,1
762,92:69:1D:31:68:E9,3850804,488784609,4045,3652697,3846759,485131912,1,5394,1157079,5224,1118461,170,38618,2201,12,4298,103,1,61,229410.0,130000.0,-52.0,-47.0,-43.0,-49.0,-51.0,-47.0,-43.0,-47.0,-89.0,-90.0,-87.0,-89.0,37.0,43.0,44.0,40.0,1
763,CC:2F:71:3F:1F:24,5025358,1835505572,1178599,1350373660,3846759,485131912,1730,986751,1116968885,985917,1116868011,834,100874,954294,15,1177224,120688,1727,773,130000.0,43333.0,-71.0,-69.0,-67.0,-71.0,-71.0,-69.0,-66.0,-70.0,-89.0,-90.0,-87.0,-89.0,18.0,21.0,20.0,18.0,1
764,CC:2F:71:3E:C5:1F,3847747,485252531,986,120417,3846761,485132114,2,4278,357051,3560,271797,718,85254,1044,13,1418,28,2,54,130000.0,39000.0,-72.0,-73.0,-69.0,-60.0,-73.0,-74.0,-69.0,-61.0,-89.0,-90.0,-87.0,-89.0,17.0,17.0,18.0,29.0,1
765,BA:8C:B9:54:50:24,3851690,491325888,4929,6193774,3846761,485132114,7,9750,1751514,9728,1748019,22,3495,2358,17,5431,41,7,70,216660.0,130000.0,-48.0,-35.0,-43.0,-45.0,-43.0,-35.0,-43.0,-47.0,-89.0,-90.0,-87.0,-89.0,41.0,55.0,44.0,44.0,1
766,62:47:05:9D:EB:15,3853518,497315643,6750,12182650,3846768,485132993,1,6981,3803241,6931,3795583,50,7658,3317,0,6816,56,1,125,229410.0,137640.0,-45.0,-50.0,-46.0,-45.0,-44.0,-47.0,-38.0,-47.0,-89.0,-90.0,-87.0,-89.0,44.0,40.0,41.0,44.0,1
767,92:69:1D:31:68:E9,3850813,488785690,4045,3652697,3846768,485132993,1,5394,1157079,5224,1118461,170,38618,2201,12,4298,103,1,61,229410.0,130000.0,-52.0,-47.0,-43.0,-49.0,-51.0,-47.0,-43.0,-47.0,-89.0,-90.0,-87.0,-89.0,37.0,43.0,44.0,40.0,1
768,CC:2F:71:3F:1F:24,5025560,1835752407,1178792,1350619414,3846768,485132993,1730,986936,1117215965,986102,1117115091,834,100874,954467,15,1177417,120690,1727,774,144444.0,43333.0,-71.0,-69.0,-66.0,-71.0,-71.0,-69.0,-66.0,-70.0,-89.0,-90.0,-87.0,-89.0,18.0,21.0,21.0,18.0,1
769,CC:2F:71:3E:C5:1F,3847754,485253410,986,120417,3846768,485132993,2,4278,357051,3560,271797,718,85254,1044,13,1418,28,2,54,130000.0,39000.0,-72.0,-73.0,-69.0,-60.0,-73.0,-74.0,-69.0,-61.0,-89.0,-90.0,-87.0,-89.0,17.0,17.0,18.0,29.0,1
770,BA:8C:B9:54:50:24,3851697,491326767,4929,6193774,3846768,485132993,7,9750,1751514,9728,1748019,22,3495,2358,17,5431,41,7,70,216660.0,130000.0,-48.0,-35.0,-43.0,-45.0,-43.0,-35.0,-43.0,-47.0,-89.0,-90.0,-87.0,-89.0,41.0,55.0,44.0,44.0,1
771,62:47:05:9D:EB:15,3853519,497315703,6750,12182650,3846769,485133053,1,6981,3803241,6931,3795583,50,7658,3317,0,6816,56,1,125,229410.0,137640.0,-45.0,-50.0,-46.0,-45.0,-44.0,-47.0,-38.0,-47.0,-89.0,-90.0,-87.0,-89.0,44.0,40.0,41.0,44.0,1
772,92:69:1D:31:68:E9,3850816,488785952,4045,3652697,3846771,485133255,1,5394,1157079,5224,1118461,170,38618,2201,12,4298,103,1,61,229410.0,130000.0,-52.0,-47.0,-43.0,-49.0,-51.0,-47.0,-43.0,-47.0,-89.0,-91.0,-87.0,-90.0,37.0,44.0,44.0,41.0,1
773,CC:2F:71:3F:1F:24,5025754,1835995483,1178983,1350862228,3846771,485133255,1730,987106,1117445205,986272,1117344331,834,100874,954637,15,1177608,120697,1727,774,144444.0,43333.0,-71.0,-69.0,-66.0,-71.0,-71.0,-69.0,-66.0,-70.0,-89.0,-91.0,-87.0,-90.0,18.0,22.0,21.0,19.0,1
774,CC:2F:71:3E:C5:1F,3847757,485253672,986,120417,3846771,485133255,2,4278,357051,3560,271797,718,85254,1044,13,1418,28,2,54,130000.0,39000.0,-72.0,-73.0,-69.0,-60.0,-73.0,-74.0,-69.0,-61.0,-89.0,-91.0,-87.0,-90.0,17.0,18.0,18.0,30.0,1
775,BA:8C:B9:54:50:24,3851700,491327029,4929,6193774,3846771,485133255,7,9750,1751514,9728,1748019,22,3495,2358,17,5431,41,7,70,216660.0,130000.0,-48.0,-35.0,-43.0,-45.0,-43.0,-35.0,-43.0,-47.0,-89.0,-91.0,-87.0,-90.0,41.0,56.0,44.0,45.0,1
776,62:47:05:9D:EB:15,3853527,497316511,6750,12182650,3846777,485133861,1,6981,3803241,6931,3795583,50,7658,3317,0,6816,56,1,125,229410.0,137640.0,-45.0,-50.0,-46.0,-45.0,-44.0,-47.0,-38.0,-47.0,-89.0,-91.0,-87.0,-90.0,44.0,41.0,41.0,45.0,1
777,92:69:1D:31:68:E9,3850822,488786558,4045,3652697,3846777,485133861,1,5394,1157079,5224,1118461,170,38618,2201,12,4298,103,1,61,229410.0,130000.0,-52.0,-47.0,-43.0,-49.0,-51.0,-47.0,-43.0,-47.0,-89.0,-91.0,-87.0,-90.0,37.0,44.0,44.0,41.0,1
778,CC:2F:71:3F:1F:24,5025961,1836244174,1179184,1351110313,3846777,485133861,1730,987287,1117676315,986453,1117575441,834,100874,954818,15,1177809,120703,1727,776,144444.0,43333.0,-71.0,-69.0,-67.0,-71.0,-71.0,-69.0,-66.0,-71.0,-89.0,-91.0,-87.0,-90.0,18.0,22.0,20.0,19.0,1
779,CC:2F:71:3E:C5:1F,3847765,485254646,986,120417,3846779,485134229,2,4278,357051,3560,271797,718,85254,1044,13,1418,28,2,54,130000.0,39000.0,-72.0,-73.0,-69.0,-60.0,-73.0,-74.0,-69.0,-61.0,-89.0,-91.0,-87.0,-90.0,17.0,18.0,18.0,30.0,1
780,BA:8C:B9:54:50:24,3851708,491328003,4929,6193774,3846779,485134229,7,9750,1751514,9728,1748019,22,3495,2358,17,5431,41,7,70,216660.0,130000.0,-48.0,-35.0,-43.0,-45.0,-43.0,-35.0,-43.0,-47.0,-89.0,-91.0,-87.0,-90.0,41.0,56.0,44.0,45.0,1
781,62:47:05:9D:EB:15,3853529,497316879,6750,12182650,3846779,485134229,1,6981,3803241,6931,3795583,50,7658,3317,0,6816,56,1,125,229410.0,137640.0,-45.0,-50.0,-46.0,-45.0,-44.0,-47.0,-38.0,-47.0,-89.0,-91.0,-87.0,-90.0,44.0,41.0,41.0,45.0,1
782,92:69:1D:31:68:E9,3850827,488787188,4045,3652697,3846782,485134491,1,5394,1157079,5224,1118461,170,38618,2201,12,4298,103,1,61,229410.0,130000.0,-52.0,-47.0,-43.0,-49.0,-51.0,-47.0,-43.0,-47.0,-89.0,-91.0,-87.0,-90.0,37.0,44.0,44.0,41.0,1
783,CC:2F:71:3F:1F:24,5026158,1836489172,1179376,1351354681,3846782,485134491,1730,987458,1117905669,986623,1117804681,835,100988,954989,15,1178001,120707,1727,776,144444.0,43333.0,-71.0,-69.0,-66.0,-71.0,-71.0,-69.0,-66.0,-71.0,-89.0,-91.0,-87.0,-90.0,18.0,22.0,21.0,19.0,1
784,CC:2F:71:3E:C5:1F,3847768,485254908,986,120417,3846782,485134491,2,4278,357051,3560,271797,718,85254,1044,13,1418,28,2,54,130000.0,39000.0,-72.0,-73.0,-69.0,-60.0,-73.0,-74.0,-69.0,-61.0,-89.0,-91.0,-87.0,-90.0,17.0,18.0,18.0,30.0,1
785,BA:8C:B9:54:50:24,3851711,491328265,4929,6193774,3846782,485134491,7,9750,1751514,9728,1748019,22,3495,2358,17,5431,41,7,70,216660.0,130000.0,-48.0,-35.0,-43.0,-45.0,-43.0,-35.0,-43.0,-47.0,-89.0,-91.0,-87.0,-90.0,41.0,56.0,44.0,45.0,1
786,62:47:05:9D:EB:15,3853541,497317959,6750,12182650,3846791,485135309,1,6981,3803241,6931,3795583,50,7658,3317,0,6816,56,1,125,229410.0,137640.0,-45.0,-50.0,-46.0,-45.0,-44.0,-47.0,-38.0,-47.0,-89.0,-91.0,-88.0,-90.0,44.0,41.0,42.0,45.0,1
787,92:69:1D:31:68:E9,3850837,488788140,4045,3652697,3846792,485135443,1,5394,1157079,5224,1118461,170,38618,2201,12,4298,103,1,61,229410.0,130000.0,-52.0,-47.0,-43.0,-49.0,-51.0,-47.0,-43.0,-47.0,-89.0,-91.0,-88.0,-90.0,37.0,44.0,45.0,41.0,1
788,CC:2F:71:3F:1F:24,5026358,1836731384,1179566,1351595941,3846792,485135443,1730,987631,1118132515,986793,1118031073,838,101442,955162,15,1178190,120712,1727,776,144444.0,43333.0,-71.0,-69.0,-66.0,-72.0,-71.0,-69.0,-66.0,-72.0,-89.0,-91.0,-88.0,-90.0,18.0,22.0,22.0,18.0,1
789,CC:2F:71:3E:C5:1F,3847778,485255860,986,120417,3846792,485135443,2,4278,357051,3560,271797,718,85254,1044,13,1418,28,2,54,130000.0,39000.0,-72.0,-73.0,-69.0,-60.0,-73.0,-74.0,-69.0,-61.0,-89.0,-91.0,-88.0,-90.0,17.0,18.0,19.0,30.0,1
790,BA:8C:B9:54:50:24,3851721,491329217,4929,6193774,3846792,485135443,7,9750,1751514,9728,1748019,22,3495,2358,17,5431,41,7,70,216660.0,130000.0,-48.0,-35.0,-43.0,-45.0,-43.0,-35.0,-43.0,-47.0,-89.0,-91.0,-88.0,-90.0,41.0,56.0,45.0,45.0,1
791,62:47:05:9D:EB:15,3853542,497318093,6750,12182650,3846792,485135443,1,6981,3803241,6931,3795583,50,7658,3317,0,6816,56,1,125,229410.0,137640.0,-45.0,-50.0,-46.0,-45.0,-44.0,-47.0,-38.0,-47.0,-89.0,-91.0,-88.0,-91.0,44.0,41.0,42.0,46.0,1
792,92:69:1D:31:68:E9,3850839,488788342,4045,3652697,3846794,485135645,1,5394,1157079,5224,1118461,170,38618,2201,12,4298,103,1,61,229410.0,130000.0,-52.0,-47.0,-43.0,-49.0,-51.0,-47.0,-43.0,-47.0,-89.0,-91.0,-88.0,-91.0,37.0,44.0,45.0,42.0,1
793,CC:2F:71:3F:1F:24,5026552,1836974474,1179758,1351838829,3846794,485135645,1730,987801,1118358935,986963,1118257493,838,101442,955332,15,1178383,120753,1727,776,130000.0,43333.0,-72.0,-69.0,-66.0,-72.0,-72.0,-68.0,-66.0,-72.0,-89.0,-91.0,-88.0,-91.0,17.0,22.0,22.0,19.0,1
794,CC:2F:71:3E:C5:1F,3847780,485256062,986,120417,3846794,485135645,2,4278,357051,3560,271797,718,85254,1044,13,1418,28,2,54,130000.0,39000.0,-72.0,-73.0,-69.0,-60.0,-73.0,-74.0,-69.0,-61.0,-89.0,-91.0,-88.0,-91.0,17.0,18.0,19.0,31.0,1
795,BA:8C:B9:54:50:24,3851723,491329419,4929,6193774,3846794,485135645,7,9750,1751514,9728,1748019,22,3495,2358,17,5431,41,7,70,216660.0,130000.0,-48.0,-35.0,-43.0,-45.0,-43.0,-35.0,-43.0,-47.0,-89.0,-91.0,-88.0,-91.0,41.0,56.0,45.0,46.0,1
796,62:47:05:9D:EB:15,3853552,497319023,6750,12182650,3846802,485136373,1,6981,3803241,6931,3795583,50,7658,3317,0,6816,56,1,125,229410.0,137640.0,-45.0,-50.0,-46.0,-45.0,-44.0,-47.0,-38.0,-47.0,-89.0,-91.0,-88.0,-91.0,44.0,41.0,42.0,46.0,1
797,92:69:1D:31:68:E9,3850847,488789070,4045,3652697,3846802,485136373,1,5394,1157079,5224,1118461,170,38618,2201,12,4298,103,1,61,229410.0,130000.0,-52.0,-47.0,-43.0,-49.0,-51.0,-47.0,-43.0,-47.0,-90.0,-92.0,-88.0,-91.0,38.0,45.0,45.0,42.0,1
798,CC:2F:71:3F:1F:24,5026760,1837224483,1179958,1352088110,3846802,485136373,1730,987981,1118592775,987142,1118491215,839,101560,955512,15,1178583,120766,1727,778,130000.0,39000.0,-72.0,-69.0,-66.0,-73.0,-72.0,-69.0,-66.0,-72.0,-90.0,-92.0,-88.0,-91.0,18.0,23.0,22.0,18.0,1
799,CC:2F:71:3E:C5:1F,3847788,485256790,986,120417,3846802,485136373,2,4278,357051,3560,271797,718,85254,1044,13,1418,28,2,54,130000.0,39000.0,-72.0,-73.0,-69.0,-60.0,-73.0,-74.0,-69.0,-61.0,-90.0,-92.0,-88.0,-91.0,18.0,19.0,19.0,31.0,1
800,BA:8C:B9:54:50:24,3851731,491330147,4929,6193774,3846802,485136373,7,9750,1751514,9728,1748019,22,3495,2358,17,5431,41,7,70,216660.0,130000.0,-48.0,-35.0,-43.0,-45.0,-43.0,-35.0,-43.0,-47.0,-90.0,-92.0,-88.0,-91.0,42.0,57.0,45.0,46.0,1
801,62:47:05:9D:EB:15,3853555,497319287,6750,12182650,3846805,485136637,1,6981,3803241,6931,3795583,50,7658,3317,0,6816,56,1,125,229410.0,137640.0,-45.0,-50.0,-46.0,-45.0,-44.0,-47.0,-38.0,-47.0,-90.0,-92.0,-88.0,-91.0,45.0,42.0,42.0,46.0,1
802,92:69:1D:31:68:E9,3850850,488789334,4045,3652697,3846805,485136637,1,5394,1157079,5224,1118461,170,38618,2201,12,4298,103,1,61,229410.0,130000.0,-52.0,-47.0,-43.0,-49.0,-51.0,-47.0,-43.0,-47.0,-90.0,-92.0,-88.0,-91.0,38.0,45.0,45.0,42.0,1
803,CC:2F:71:3F:1F:24,5026953,1837465895,1180148,1352329258,3846805,485136637,1730,988150,1118819051,987311,1118717491,839,101560,955681,15,1178773,120767,1727,778,130000.0,43333.0,-72.0,-69.0,-66.0,-73.0,-72.0,-68.0,-66.0,-73.0,-90.0,-92.0,-88.0,-91.0,18.0,23.0,22.0,18.0,1
804,CC:2F:71:3E:C5:1F,3847793,485257256,986,120417,3846807,485136839,2,4280,357239,3561,271867,719,85372,1045,13,1418,28,2,54,130000.0,39000.0,-72.0,-73.0,-69.0,-60.0,-73.0,-74.0,-69.0,-61.0,-90.0,-92.0,-88.0,-91.0,18.0,19.0,19.0,31.0,1
805,BA:8C:B9:54:50:24,3851736,491330613,4929,6193774,3846807,485136839,7,9750,1751514,9728,1748019,22,3495,2358,17,5431,41,7,70,216660.0,130000.0,-48.0,-35.0,-43.0,-45.0,-43.0,-35.0,-43.0,-47.0,-90.0,-92.0,-88.0,-91.0,42.0,57.0,45.0,46.0,1
806,62:47:05:9D:EB:15,3853561,497319893,6750,12182650,3846811,485137243,1,6982,3803309,6932,3795651,50,7658,3317,0,6816,56,1,125,229410.0,137640.0,-43.0,-45.0,-35.0,-48.0,-43.0,-46.0,-37.0,-47.0,-90.0,-92.0,-88.0,-91.0,47.0,47.0,53.0,43.0,1
807,92:69:1D:31:68:E9,3850856,488789940,4045,3652697,3846811,485137243,1,5394,1157079,5224,1118461,170,38618,2201,12,4298,103,1,61,229410.0,130000.0,-52.0,-47.0,-43.0,-49.0,-51.0,-47.0,-43.0,-47.0,-90.0,-92.0,-88.0,-91.0,38.0,45.0,45.0,42.0,1
808,CC:2F:71:3F:1F:24,5027156,1837717343,1180345,1352580100,3846811,485137243,1730,988326,1119054723,987487,1118953163,839,101560,955857,15,1178970,120767,1727,778,130000.0,43333.0,-72.0,-68.0,-66.0,-73.0,-72.0,-68.0,-66.0,-73.0,-90.0,-92.0,-88.0,-91.0,18.0,24.0,22.0,18.0,1
809,CC:2F:71:3E:C5:1F,3847797,485257660,986,120417,3846811,485137243,2,4280,357239,3561,271867,719,85372,1045,13,1418,28,2,54,130000.0,39000.0,-72.0,-73.0,-69.0,-60.0,-73.0,-74.0,-69.0,-61.0,-90.0,-92.0,-88.0,-91.0,18.0,19.0,19.0,31.0,1
810,BA:8C:B9:54:50:24,3851740,491331017,4929,6193774,3846811,485137243,7,9750,1751514,9728,1748019,22,3495,2358,17,5431,41,7,70,216660.0,130000.0,-48.0,-35.0,-43.0,-45.0,-43.0,-35.0,-43.0,-47.0,-90.0,-92.0,-88.0,-91.0,42.0,57.0,45.0,46.0,1
811,62:47:05:9D:EB:15,3853564,497320155,6750,12182650,3846814,485137505,1,6982,3803309,6932,3795651,50,7658,3317,0,6816,56,1,125,229410.0,137640.0,-43.0,-45.0,-35.0,-48.0,-43.0,-46.0,-37.0,-47.0,-90.0,-92.0,-89.0,-91.0,47.0,47.0,54.0,43.0,1
812,92:69:1D:31:68:E9,3850861,488790404,4045,3652697,3846816,485137707,1,5396,1157215,5226,1118597,170,38618,2201,12,4299,103,1,62,229410.0,130000.0,-52.0,-47.0,-44.0,-46.0,-51.0,-47.0,-43.0,-47.0,-90.0,-92.0,-89.0,-91.0,38.0,45.0,45.0,45.0,1
813,CC:2F:71:3F:1F:24,5027352,1837958973,1180536,1352821266,3846816,485137707,1730,988503,1119293459,987664,1119191899,839,101560,956026,15,1179161,120771,1727,779,130000.0,43333.0,-72.0,-68.0,-66.0,-73.0,-72.0,-68.0,-66.0,-72.0,-90.0,-92.0,-89.0,-91.0,18.0,24.0,23.0,18.0,1
814,CC:2F:71:3E:C5:1F,3847802,485258124,986,120417,3846816,485137707,2,4280,357239,3561,271867,719,85372,1045,13,1418,28,2,54,130000.0,39000.0,-72.0,-73.0,-69.0,-60.0,-73.0,-74.0,-69.0,-61.0,-90.0,-92.0,-89.0,-91.0,18.0,19.0,20.0,31.0,1
815,BA:8C:B9:54:50:24,3851745,491331481,4929,6193774,3846816,485137707,7,9752,1751650,9730,1748155,22,3495,2358,17,5432,41,7,70,216660.0,130000.0,-39.0,-37.0,-45.0,-52.0,-43.0,-35.0,-42.0,-46.0,-90.0,-92.0,-89.0,-91.0,51.0,55.0,44.0,39.0,1
816,62:47:05:9D:EB:15,3853570,497320761,6750,12182650,3846820,485138111,1,6982,3803309,6932,3795651,50,7658,3317,0,6816,56,1,125,229410.0,137640.0,-43.0,-45.0,-35.0,-48.0,-43.0,-46.0,-37.0,-47.0,-90.0,-92.0,-89.0,-92.0,47.0,47.0,54.0,44.0,1
817,92:69:1D:31:68:E9,3850865,488790808,4045,3652697,3846820,485138111,1,5396,1157215,5226,1118597,170,38618,2201,12,4299,103,1,62,229410.0,130000.0,-52.0,-47.0,-44.0,-46.0,-51.0,-47.0,-43.0,-47.0,-90.0,-92.0,-89.0,-92.0,38.0,45.0,45.0,46.0,1
818,CC:2F:71:3F:1F:24,5027572,1838232338,1180752,1353094227,3846820,485138111,1730,988703,1119551087,987864,1119449527,839,101560,956221,15,1179376,120773,1727,779,130000.0,43333.0,-72.0,-68.0,-66.0,-72.0,-71.0,-68.0,-66.0,-72.0,-90.0,-92.0,-89.0,-92.0,18.0,24.0,23.0,20.0,1
819,CC:2F:71:3E:C5:1F,3847806,485258528,986,120417,3846820,485138111,2,4280,357239,3561,271867,719,85372,1045,13,1418,28,2,54,130000.0,39000.0,-72.0,-73.0,-69.0,-60.0,-73.0,-74.0,-69.0,-61.0,-90.0,-92.0,-89.0,-92.0,18.0,19.0,20.0,32.0,1
820,BA:8C:B9:54:50:24,3851749,491331885,4929,6193774,3846820,485138111,7,9752,1751650,9730,1748155,22,3495,2358,17,5432,41,7,70,216660.0,130000.0,-39.0,-37.0,-45.0,-52.0,-43.0,-35.0,-42.0,-46.0,-90.0,-92.0,-89.0,-92.0,51.0,55.0,44.0,40.0,1
821,62:47:05:9D:EB:15,3853575,497321225,6750,12182650,3846825,485138575,1,6982,3803309,6932,3795651,50,7658,3317,0,6816,56,1,125,229410.0,137640.0,-43.0,-45.0,-35.0,-48.0,-43.0,-46.0,-37.0,-47.0,-90.0,-92.0,-89.0,-92.0,47.0,47.0,54.0,44.0,1
822,92:69:1D:31:68:E9,3850870,488791272,4045,3652697,3846825,485138575,1,5396,1157215,5226,1118597,170,38618,2201,12,4299,103,1,62,229410.0,130000.0,-52.0,-47.0,-44.0,-46.0,-51.0,-47.0,-43.0,-47.0,-90.0,-92.0,-89.0,-92.0,38.0,45.0,45.0,46.0,1
823,CC:2F:71:3F:1F:24,5027767,1838473838,1180942,1353335263,3846825,485138575,1730,988886,1119796229,988047,1119694669,839,101560,956393,15,1179567,120782,1727,779,130000.0,43333.0,-72.0,-68.0,-66.0,-73.0,-72.0,-68.0,-66.0,-72.0,-90.0,-92.0,-89.0,-92.0,18.0,24.0,23.0,19.0,1
824,CC:2F:71:3E:C5:1F,3847813,485259194,986,120417,3846827,485138777,2,4280,357239,3561,271867,719,85372,1045,13,1418,28,2,54,130000.0,39000.0,-72.0,-73.0,-69.0,-60.0,-73.0,-74.0,-69.0,-61.0,-90.0,-92.0,-89.0,-92.0,18.0,19.0,20.0,32.0,1
825,BA:8C:B9:54:50:24,3851758,491332753,4929,6193774,3846829,485138979,7,9753,1751718,9731,1748223,22,3495,2358,17,5432,41,7,70,216660.0,130000.0,-39.0,-36.0,-45.0,-51.0,-43.0,-35.0,-42.0,-46.0,-90.0,-92.0,-89.0,-92.0,51.0,56.0,44.0,41.0,1
826,62:47:05:9D:EB:15,3853580,497321902,6750,12182650,3846830,485139252,1,6982,3803309,6932,3795651,50,7658,3317,0,6816,56,1,125,229410.0,137640.0,-43.0,-45.0,-35.0,-48.0,-43.0,-46.0,-37.0,-47.0,-90.0,-92.0,-89.0,-92.0,47.0,47.0,54.0,44.0,1
827,92:69:1D:31:68:E9,3850875,488791949,4045,3652697,3846830,485139252,1,5396,1157215,5226,1118597,170,38618,2201,12,4299,103,1,62,229410.0,130000.0,-52.0,-47.0,-44.0,-46.0,-51.0,-47.0,-43.0,-47.0,-90.0,-92.0,-89.0,-92.0,38.0,45.0,45.0,46.0,1
828,CC:2F:71:3F:1F:24,5027967,1838722107,1181137,1353582855,3846830,485139252,1730,989069,1120042757,988230,1119941197,839,101560,956567,15,1179762,120782,1727,779,130000.0,43333.0,-72.0,-68.0,-66.0,-72.0,-72.0,-68.0,-66.0,-72.0,-90.0,-92.0,-89.0,-92.0,18.0,24.0,23.0,20.0,1
829,CC:2F:71:3E:C5:1F,3847816,485259669,986,120417,3846830,485139252,2,4280,357239,3561,271867,719,85372,1045,13,1418,28,2,54,130000.0,39000.0,-72.0,-73.0,-69.0,-60.0,-73.0,-74.0,-69.0,-61.0,-90.0,-92.0,-89.0,-92.0,18.0,19.0,20.0,32.0,1
830,BA:8C:B9:54:50:24,3851759,491333026,4929,6193774,3846830,485139252,7,9753,1751718,9731,1748223,22,3495,2358,17,5432,41,7,70,216660.0,130000.0,-39.0,-36.0,-45.0,-51.0,-43.0,-35.0,-42.0,-46.0,-90.0,-92.0,-89.0,-92.0,51.0,56.0,44.0,41.0,1
831,62:47:05:9D:EB:15,3853584,497322306,6750,12182650,3846834,485139656,1,6982,3803309,6932,3795651,50,7658,3317,0,6816,56,1,125,229410.0,137640.0,-43.0,-45.0,-35.0,-48.0,-43.0,-46.0,-37.0,-47.0,-90.0,-92.0,-89.0,-92.0,47.0,47.0,54.0,44.0,1
832,92:69:1D:31:68:E9,3850881,488792555,4045,3652697,3846836,485139858,1,5396,1157215,5226,1118597,170,38618,2201,12,4299,103,1,62,229410.0,130000.0,-52.0,-47.0,-44.0,-46.0,-51.0,-47.0,-43.0,-47.0,-90.0,-92.0,-89.0,-92.0,38.0,45.0,45.0,46.0,1
833,CC:2F:71:3F:1F:24,5028174,1838967906,1181336,1353827846,3846838,485140060,1730,989253,1120282797,988414,1120181237,839,101560,956743,15,1179961,120784,1727,779,130000.0,43333.0,-71.0,-68.0,-66.0,-72.0,-71.0,-68.0,-66.0,-72.0,-90.0,-92.0,-89.0,-92.0,19.0,24.0,23.0,20.0,1
834,CC:2F:71:3E:C5:1F,3847825,485260537,986,120417,3846839,485140120,2,4280,357239,3561,271867,719,85372,1045,13,1418,28,2,54,130000.0,39000.0,-72.0,-73.0,-69.0,-60.0,-73.0,-74.0,-69.0,-61.0,-90.0,-92.0,-89.0,-92.0,18.0,19.0,20.0,32.0,1
835,BA:8C:B9:54:50:24,3851768,491333894,4929,6193774,3846839,485140120,7,9753,1751718,9731,1748223,22,3495,2358,17,5432,41,7,70,216660.0,130000.0,-39.0,-36.0,-45.0,-51.0,-43.0,-35.0,-42.0,-46.0,-90.0,-92.0,-89.0,-92.0,51.0,56.0,44.0,41.0,1
836,62:47:05:9D:EB:15,3853589,497322770,6750,12182650,3846839,485140120,1,6982,3803309,6932,3795651,50,7658,3317,0,6816,56,1,125,229410.0,137640.0,-43.0,-45.0,-35.0,-48.0,-43.0,-46.0,-37.0,-47.0,-90.0,-92.0,-89.0,-92.0,47.0,47.0,54.0,44.0,1
837,92:69:1D:31:68:E9,3850884,488792817,4045,3652697,3846839,485140120,1,5396,1157215,5226,1118597,170,38618,2201,12,4299,103,1,62,229410.0,130000.0,-52.0,-47.0,-44.0,-46.0,-51.0,-47.0,-43.0,-47.0,-90.0,-92.0,-89.0,-92.0,38.0,45.0,45.0,46.0,1
838,CC:2F:71:3F:1F:24,5028368,1839212296,1181529,1354072176,3846839,485140120,1730,989433,1120523405,988594,1120421845,839,101560,956915,15,1180154,120789,1727,779,144444.0,43333.0,-72.0,-68.0,-66.0,-72.0,-71.0,-68.0,-66.0,-72.0,-90.0,-92.0,-89.0,-92.0,18.0,24.0,23.0,20.0,1
839,CC:2F:71:3E:C5:1F,3847825,485260537,986,120417,3846839,485140120,2,4280,357239,3561,271867,719,85372,1045,13,1418,28,2,54,130000.0,39000.0,-72.0,-73.0,-69.0,-60.0,-73.0,-74.0,-69.0,-61.0,-90.0,-92.0,-89.0,-92.0,18.0,19.0,20.0,32.0,1
840,BA:8C:B9:54:50:24,3851768,491333894,4929,6193774,3846839,485140120,7,9753,1751718,9731,1748223,22,3495,2358,17,5432,41,7,70,216660.0,130000.0,-39.0,-36.0,-45.0,-51.0,-43.0,-35.0,-42.0,-46.0,-90.0,-92.0,-89.0,-92.0,51.0,56.0,44.0,41.0,1
841,62:47:05:9D:EB:15,3853597,497323578,6750,12182650,3846847,485140928,1,6982,3803309,6932,3795651,50,7658,3317,0,6816,56,1,125,229410.0,137640.0,-43.0,-45.0,-35.0,-48.0,-43.0,-46.0,-37.0,-47.0,-90.0,-92.0,-89.0,-92.0,47.0,47.0,54.0,44.0,1
842,92:69:1D:31:68:E9,3850892,488793625,4045,3652697,3846847,485140928,1,5396,1157215,5226,1118597,170,38618,2201,12,4299,103,1,62,229410.0,130000.0,-52.0,-47.0,-44.0,-46.0,-51.0,-47.0,-43.0,-47.0,-90.0,-92.0,-89.0,-92.0,38.0,45.0,45.0,46.0,1
843,CC:2F:71:3F:1F:24,5028572,1839463520,1181725,1354322592,3846847,485140928,1730,989611,1120765175,988772,1120663615,839,101560,957089,15,1180350,120807,1727,779,117000.0,39000.0,-72.0,-68.0,-67.0,-71.0,-72.0,-68.0,-66.0,-70.0,-90.0,-92.0,-89.0,-92.0,18.0,24.0,22.0,21.0,1
844,CC:2F:71:3E:C5:1F,3847833,485261345,986,120417,3846847,485140928,2,4280,357239,3561,271867,719,85372,1045,13,1418,28,2,54,130000.0,39000.0,-72.0,-73.0,-69.0,-60.0,-73.0,-74.0,-69.0,-61.0,-90.0,-92.0,-89.0,-92.0,18.0,19.0,20.0,32.0,1
845,BA:8C:B9:54:50:24,3851776,491334702,4929,6193774,3846847,485140928,7,9753,1751718,9731,1748223,22,3495,2358,17,5432,41,7,70,216660.0,130000.0,-39.0,-36.0,-45.0,-51.0,-43.0,-35.0,-42.0,-46.0,-90.0,-92.0,-89.0,-92.0,51.0,56.0,44.0,41.0,1
846,62:47:05:9D:EB:15,3853598,497323638,6750,12182650,3846848,485140988,1,6982,3803309,6932,3795651,50,7658,3317,0,6816,56,1,125,229410.0,137640.0,-43.0,-45.0,-35.0,-48.0,-43.0,-46.0,-37.0,-47.0,-90.0,-92.0,-89.0,-91.0,47.0,47.0,54.0,43.0,1
847,92:69:1D:31:68:E9,3850893,488793685,4045,3652697,3846848,485140988,1,5396,1157215,5226,1118597,170,38618,2201,12,4299,103,1,62,229410.0,130000.0,-52.0,-47.0,-44.0,-46.0,-51.0,-47.0,-43.0,-47.0,-90.0,-92.0,-89.0,-91.0,38.0,45.0,45.0,45.0,1
848,CC:2F:71:3F:1F:24,5028766,1839707966,1181918,1354566978,3846848,485140988,1730,989788,1121003855,988949,1120902295,839,101560,957260,15,1180543,120807,1727,779,130000.0,43333.0,-71.0,-68.0,-65.0,-71.0,-70.0,-68.0,-65.0,-71.0,-90.0,-92.0,-89.0,-91.0,19.0,24.0,24.0,20.0,1
849,CC:2F:71:3E:C5:1F,3847834,485261405,986,120417,3846848,485140988,2,4280,357239,3561,271867,719,85372,1045,13,1418,28,2,54,130000.0,39000.0,-72.0,-73.0,-69.0,-60.0,-73.0,-74.0,-69.0,-61.0,-90.0,-92.0,-89.0,-91.0,18.0,19.0,20.0,31.0,1
850,BA:8C:B9:54:50:24,3851779,491334964,4929,6193774,3846850,485141190,7,9753,1751718,9731,1748223,22,3495,2358,17,5432,41,7,70,216660.0,130000.0,-39.0,-36.0,-45.0,-51.0,-43.0,-35.0,-42.0,-46.0,-90.0,-92.0,-89.0,-91.0,51.0,56.0,44.0,40.0,1
851,62:47:05:9D:EB:15,3853606,497324446,6750,12182650,3846856,485141796,1,6982,3803309,6932,3795651,50,7658,3317,0,6816,56,1,125,229410.0,137640.0,-43.0,-45.0,-35.0,-48.0,-43.0,-46.0,-37.0,-47.0,-90.0,-92.0,-89.0,-91.0,47.0,47.0,54.0,43.0,1
852,92:69:1D:31:68:E9,3850901,488794493,4045,3652697,3846856,485141796,1,5396,1157215,5226,1118597,170,38618,2201,12,4299,103,1,62,229410.0,130000.0,-52.0,-47.0,-44.0,-46.0,-51.0,-47.0,-43.0,-47.0,-90.0,-92.0,-89.0,-91.0,38.0,45.0,45.0,45.0,1
853,CC:2F:71:3F:1F:24,5028972,1839953565,1182116,1354811769,3846856,485141796,1730,989977,1121247313,989138,1121145753,839,101560,957439,15,1180741,120807,1727,780,130000.0,39000.0,-72.0,-69.0,-66.0,-71.0,-71.0,-69.0,-66.0,-71.0,-90.0,-92.0,-89.0,-91.0,18.0,23.0,23.0,20.0,1
854,CC:2F:71:3E:C5:1F,3847842,485262213,986,120417,3846856,485141796,2,4280,357239,3561,271867,719,85372,1045,13,1418,28,2,54,130000.0,39000.0,-72.0,-73.0,-69.0,-60.0,-73.0,-74.0,-69.0,-61.0,-90.0,-92.0,-89.0,-91.0,18.0,19.0,20.0,31.0,1
855,BA:8C:B9:54:50:24,3851785,491335570,4929,6193774,3846856,485141796,7,9753,1751718,9731,1748223,22,3495,2358,17,5432,41,7,70,216660.0,130000.0,-39.0,-36.0,-45.0,-51.0,-43.0,-35.0,-42.0,-46.0,-90.0,-92.0,-89.0,-91.0,51.0,56.0,44.0,40.0,1
856,62:47:05:9D:EB:15,3853606,497324446,6750,12182650,3846856,485141796,1,6982,3803309,6932,3795651,50,7658,3317,0,6816,56,1,125,229410.0,137640.0,-43.0,-45.0,-35.0,-48.0,-43.0,-46.0,-37.0,-47.0,-90.0,-92.0,-89.0,-91.0,47.0,47.0,54.0,43.0,1
857,92:69:1D:31:68:E9,3850901,488794493,4045,3652697,3846856,485141796,1,5396,1157215,5226,1118597,170,38618,2201,12,4299,103,1,62,229410.0,130000.0,-52.0,-47.0,-44.0,-46.0,-51.0,-47.0,-43.0,-47.0,-90.0,-92.0,-89.0,-91.0,38.0,45.0,45.0,45.0,1
858,CC:2F:71:3F:1F:24,5029162,1840194713,1182306,1355052917,3846856,485141796,1730,990159,1121488257,989320,1121386697,839,101560,957609,15,1180931,120809,1727,780,144444.0,43333.0,-71.0,-69.0,-66.0,-71.0,-71.0,-69.0,-66.0,-71.0,-90.0,-92.0,-89.0,-91.0,19.0,23.0,23.0,20.0,1
859,CC:2F:71:3E:C5:1F,3847843,485262273,986,120417,3846857,485141856,2,4280,357239,3561,271867,719,85372,1045,13,1418,28,2,54,130000.0,39000.0,-72.0,-73.0,-69.0,-60.0,-73.0,-74.0,-69.0,-61.0,-90.0,-92.0,-89.0,-91.0,18.0,19.0,20.0,31.0,1
860,BA:8C:B9:54:50:24,3851788,491335832,4929,6193774,3846859,485142058,7,9753,1751718,9731,1748223,22,3495,2358,17,5432,41,7,70,216660.0,130000.0,-39.0,-36.0,-45.0,-51.0,-43.0,-35.0,-42.0,-46.0,-90.0,-92.0,-89.0,-91.0,51.0,56.0,44.0,40.0,1
861,62:47:05:9D:EB:15,3853615,497325314,6750,12182650,3846865,485142664,1,6982,3803309,6932,3795651,50,7658,3317,0,6816,56,1,125,229410.0,137640.0,-43.0,-45.0,-35.0,-48.0,-43.0,-46.0,-37.0,-47.0,-90.0,-91.0,-88.0,-91.0,47.0,46.0,53.0,43.0,1
862,92:69:1D:31:68:E9,3850910,488795361,4045,3652697,3846865,485142664,1,5396,1157215,5226,1118597,170,38618,2201,12,4299,103,1,62,229410.0,130000.0,-52.0,-47.0,-44.0,-46.0,-51.0,-47.0,-43.0,-47.0,-90.0,-91.0,-88.0,-91.0,38.0,44.0,44.0,45.0,1
863,CC:2F:71:3F:1F:24,5029363,1840438525,1182498,1355295861,3846865,485142664,1730,990333,1121718209,989494,1121616649,839,101560,957779,15,1181123,120810,1727,780,144444.0,43333.0,-73.0,-69.0,-66.0,-71.0,-72.0,-69.0,-66.0,-71.0,-90.0,-91.0,-88.0,-91.0,17.0,22.0,22.0,20.0,1
864,CC:2F:71:3E:C5:1F,3847851,485263081,986,120417,3846865,485142664,2,4280,357239,3561,271867,719,85372,1045,13,1418,28,2,54,130000.0,39000.0,-72.0,-73.0,-69.0,-60.0,-73.0,-74.0,-69.0,-61.0,-90.0,-91.0,-88.0,-91.0,18.0,18.0,19.0,31.0,1
865,BA:8C:B9:54:50:24,3851794,491336438,4929,6193774,3846865,485142664,7,9753,1751718,9731,1748223,22,3495,2358,17,5432,41,7,70,216660.0,130000.0,-39.0,-36.0,-45.0,-51.0,-43.0,-35.0,-42.0,-46.0,-90.0,-91.0,-88.0,-91.0,51.0,55.0,43.0,40.0,1
866,62:47:05:9D:EB:15,3853615,497325314,6750,12182650,3846865,485142664,1,6982,3803309,6932,3795651,50,7658,3317,0,6816,56,1,125,229410.0,137640.0,-43.0,-45.0,-35.0,-48.0,-43.0,-46.0,-37.0,-47.0,-89.0,-91.0,-88.0,-90.0,46.0,46.0,53.0,42.0,1
867,92:69:1D:31:68:E9,3850910,488795361,4045,3652697,3846865,485142664,1,5396,1157215,5226,1118597,170,38618,2201,12,4299,103,1,62,229410.0,130000.0,-52.0,-47.0,-44.0,-46.0,-51.0,-47.0,-43.0,-47.0,-89.0,-91.0,-88.0,-90.0,37.0,44.0,44.0,44.0,1
868,CC:2F:71:3F:1F:24,5029553,1840681225,1182688,1355538561,3846865,485142664,1730,990511,1121952691,989672,1121851131,839,101560,957954,15,1181313,120817,1727,780,144444.0,43333.0,-72.0,-69.0,-66.0,-71.0,-72.0,-69.0,-66.0,-71.0,-89.0,-91.0,-88.0,-90.0,17.0,22.0,22.0,19.0,1
869,CC:2F:71:3E:C5:1F,3847855,485263485,986,120417,3846869,485143068,2,4280,357239,3561,271867,719,85372,1045,13,1418,28,2,54,130000.0,39000.0,-72.0,-73.0,-69.0,-60.0,-73.0,-74.0,-69.0,-61.0,-89.0,-91.0,-88.0,-90.0,17.0,18.0,19.0,30.0,1
870,BA:8C:B9:54:50:24,3851798,491336842,4929,6193774,3846869,485143068,7,9753,1751718,9731,1748223,22,3495,2358,17,5432,41,7,70,216660.0,130000.0,-39.0,-36.0,-45.0,-51.0,-43.0,-35.0,-42.0,-46.0,-89.0,-91.0,-88.0,-90.0,50.0,55.0,43.0,39.0,1
871,62:47:05:9D:EB:15,3853624,497326182,6750,12182650,3846874,485143532,1,6982,3803309,6932,3795651,50,7658,3317,0,6816,56,1,125,229410.0,137640.0,-43.0,-45.0,-35.0,-48.0,-43.0,-46.0,-37.0,-47.0,-89.0,-90.0,-87.0,-90.0,46.0,45.0,52.0,42.0,1
872,92:69:1D:31:68:E9,3850919,488796229,4045,3652697,3846874,485143532,1,5396,1157215,5226,1118597,170,38618,2201,12,4299,103,1,62,229410.0,130000.0,-52.0,-47.0,-44.0,-46.0,-51.0,-47.0,-43.0,-47.0,-89.0,-90.0,-87.0,-90.0,37.0,43.0,43.0,44.0,1
873,CC:2F:71:3F:1F:24,5029903,1841132351,1183029,1355988819,3846874,485143532,1730,990739,1122198915,989900,1122097355,839,101560,958172,15,1181654,120825,1727,780,144444.0,43333.0,-73.0,-69.0,-66.0,-71.0,-72.0,-69.0,-66.0,-71.0,-89.0,-90.0,-87.0,-90.0,16.0,21.0,21.0,19.0,1
874,CC:2F:71:3E:C5:1F,3847860,485263949,986,120417,3846874,485143532,2,4280,357239,3561,271867,719,85372,1045,13,1418,28,2,54,130000.0,39000.0,-72.0,-73.0,-69.0,-60.0,-73.0,-74.0,-69.0,-61.0,-89.0,-90.0,-87.0,-90.0,17.0,17.0,18.0,30.0,1
875,BA:8C:B9:54:50:24,3851803,491337306,4929,6193774,3846874,485143532,7,9753,1751718,9731,1748223,22,3495,2358,17,5432,41,7,70,216660.0,130000.0,-39.0,-36.0,-45.0,-51.0,-43.0,-35.0,-42.0,-46.0,-89.0,-90.0,-87.0,-90.0,50.0,54.0,42.0,39.0,1
876,62:47:05:9D:EB:15,3853624,497326182,6750,12182650,3846874,485143532,1,6982,3803309,6932,3795651,50,7658,3317,0,6816,56,1,125,229410.0,137640.0,-43.0,-45.0,-35.0,-48.0,-43.0,-46.0,-37.0,-47.0,-89.0,-90.0,-87.0,-90.0,46.0,45.0,52.0,42.0,1
877,92:69:1D:31:68:E9,3850924,488796749,4046,3652813,3846878,485143936,1,5398,1157351,5228,1118733,170,38618,2201,12,4300,103,1,62,229410.0,137640.0,-52.0,-47.0,-44.0,-46.0,-52.0,-47.0,-43.0,-47.0,-89.0,-90.0,-87.0,-90.0,37.0,43.0,43.0,44.0,1
878,CC:2F:71:3F:1F:24,5030359,1841669571,1183481,1356525635,3846878,485143936,1730,991052,1122453638,990213,1122352078,839,101560,958481,15,1182106,120847,1727,781,144444.0,43333.0,-72.0,-68.0,-66.0,-70.0,-72.0,-68.0,-66.0,-70.0,-89.0,-90.0,-87.0,-89.0,17.0,22.0,21.0,19.0,1
879,CC:2F:71:3E:C5:1F,3847865,485264469,987,120533,3846878,485143936,2,4282,357379,3563,272007,719,85372,1045,13,1419,28,2,54,130000.0,39000.0,-72.0,-73.0,-69.0,-60.0,-72.0,-72.0,-69.0,-60.0,-89.0,-90.0,-87.0,-89.0,17.0,17.0,18.0,29.0,1
880,BA:8C:B9:54:50:24,3851808,491337826,4930,6193890,3846878,485143936,7,9761,1752262,9739,1748767,22,3495,2358,17,5433,41,7,70,216660.0,130000.0,-48.0,-35.0,-43.0,-46.0,-41.0,-35.0,-42.0,-46.0,-89.0,-90.0,-87.0,-89.0,41.0,55.0,44.0,43.0,1
881,62:47:05:9D:EB:15,3853633,497327106,6751,12182766,3846882,485144340,1,6984,3803445,6934,3795787,50,7658,3317,0,6817,56,1,125,216660.0,130000.0,-43.0,-45.0,-35.0,-47.0,-43.0,-46.0,-37.0,-47.0,-89.0,-90.0,-87.0,-89.0,46.0,45.0,52.0,42.0,1
882,92:69:1D:31:68:E9,3850930,488797381,4048,3653041,3846882,485144340,1,5403,1157771,5233,1119153,170,38618,2202,12,4302,103,1,62,229410.0,137640.0,-53.0,-47.0,-43.0,-49.0,-52.0,-47.0,-44.0,-47.0,-89.0,-90.0,-87.0,-89.0,36.0,43.0,44.0,40.0,1
883,CC:2F:71:3F:1F:24,5030752,1842157696,1183868,1357013234,3846884,485144462,1730,991316,1122693529,990477,1122591969,839,101560,958743,15,1182493,120897,1727,781,144444.0,43333.0,-73.0,-70.0,-67.0,-72.0,-73.0,-70.0,-66.0,-71.0,-89.0,-90.0,-87.0,-89.0,16.0,20.0,20.0,17.0,1
884,CC:2F:71:3E:C5:1F,3847871,485264995,987,120533,3846884,485144462,2,4283,357497,3563,272007,720,85490,1046,13,1419,28,2,54,130000.0,39000.0,-72.0,-72.0,-69.0,-60.0,-72.0,-72.0,-69.0,-60.0,-89.0,-90.0,-87.0,-89.0,17.0,18.0,18.0,29.0,1
885,BA:8C:B9:54:50:24,3851814,491338352,4930,6193890,3846884,485144462,7,9761,1752262,9739,1748767,22,3495,2358,17,5433,41,7,70,216660.0,130000.0,-48.0,-35.0,-43.0,-46.0,-41.0,-35.0,-42.0,-46.0,-89.0,-90.0,-87.0,-89.0,41.0,55.0,44.0,43.0,1
886,62:47:05:9D:EB:15,3853639,497327632,6751,12182766,3846888,485144866,1,6984,3803445,6934,3795787,50,7658,3317,0,6817,56,1,125,216660.0,130000.0,-43.0,-45.0,-35.0,-47.0,-43.0,-46.0,-37.0,-47.0,-89.0,-90.0,-87.0,-89.0,46.0,45.0,52.0,42.0,1
887,92:69:1D:31:68:E9,3850936,488797907,4048,3653041,3846888,485144866,1,5403,1157771,5233,1119153,170,38618,2202,12,4302,103,1,62,229410.0,137640.0,-53.0,-47.0,-43.0,-49.0,-52.0,-47.0,-44.0,-47.0,-89.0,-90.0,-87.0,-89.0,36.0,43.0,44.0,40.0,1
888,CC:2F:71:3F:1F:24,5031139,1842645179,1184251,1357500313,3846888,485144866,1730,991567,1122936267,990728,1122834707,839,101560,958990,15,1182875,120904,1727,781,144444.0,43333.0,-72.0,-68.0,-66.0,-72.0,-72.0,-68.0,-66.0,-71.0,-89.0,-90.0,-87.0,-89.0,17.0,22.0,21.0,17.0,1
889,CC:2F:71:3E:C5:1F,3847875,485265399,987,120533,3846888,485144866,2,4284,357567,3564,272077,720,85490,1046,13,1419,28,2,54,130000.0,39000.0,-72.0,-72.0,-69.0,-60.0,-72.0,-72.0,-69.0,-60.0,-89.0,-90.0,-87.0,-89.0,17.0,18.0,18.0,29.0,1
890,BA:8C:B9:54:50:24,3851818,491338756,4930,6193890,3846888,485144866,7,9761,1752262,9739,1748767,22,3495,2358,17,5433,41,7,70,216660.0,130000.0,-48.0,-35.0,-43.0,-46.0,-41.0,-35.0,-42.0,-46.0,-89.0,-90.0,-87.0,-89.0,41.0,55.0,44.0,43.0,1
891,62:47:05:9D:EB:15,3853644,497328309,6751,12182766,3846893,485145543,1,6984,3803445,6934,3795787,50,7658,3317,0,6817,56,1,125,216660.0,130000.0,-43.0,-45.0,-35.0,-47.0,-43.0,-46.0,-37.0,-47.0,-89.0,-90.0,-87.0,-89.0,46.0,45.0,52.0,42.0,1
892,92:69:1D:31:68:E9,3850941,488798584,4048,3653041,3846893,485145543,1,5403,1157771,5233,1119153,170,38618,2202,12,4302,103,1,62,229410.0,137640.0,-53.0,-47.0,-43.0,-49.0,-52.0,-47.0,-44.0,-47.0,-89.0,-90.0,-87.0,-89.0,36.0,43.0,44.0,40.0,1
893,CC:2F:71:3F:1F:24,5031335,1842887232,1184442,1357741689,3846893,485145543,1730,991743,1123172021,990904,1123070461,839,101560,959160,15,1183067,120904,1727,781,144444.0,43333.0,-72.0,-68.0,-66.0,-71.0,-72.0,-68.0,-66.0,-71.0,-89.0,-90.0,-87.0,-89.0,17.0,22.0,21.0,18.0,1
894,CC:2F:71:3E:C5:1F,3847880,485266076,987,120533,3846893,485145543,2,4284,357567,3564,272077,720,85490,1046,13,1419,28,2,54,130000.0,39000.0,-72.0,-72.0,-69.0,-60.0,-72.0,-72.0,-69.0,-60.0,-89.0,-90.0,-87.0,-89.0,17.0,18.0,18.0,29.0,1
895,BA:8C:B9:54:50:24,3851823,491339433,4930,6193890,3846893,485145543,7,9761,1752262,9739,1748767,22,3495,2358,17,5433,41,7,70,216660.0,130000.0,-48.0,-35.0,-43.0,-46.0,-41.0,-35.0,-42.0,-46.0,-89.0,-90.0,-87.0,-89.0,41.0,55.0,44.0,43.0,1
896,62:47:05:9D:EB:15,3853649,497328773,6751,12182766,3846898,485146007,1,6984,3803445,6934,3795787,50,7658,3317,0,6817,56,1,125,216660.0,130000.0,-43.0,-45.0,-35.0,-47.0,-43.0,-46.0,-37.0,-47.0,-88.0,-89.0,-86.0,-88.0,45.0,44.0,51.0,41.0,1
897,92:69:1D:31:68:E9,3850946,488799048,4048,3653041,3846898,485146007,1,5403,1157771,5233,1119153,170,38618,2202,12,4302,103,1,62,229410.0,137640.0,-53.0,-47.0,-43.0,-49.0,-52.0,-47.0,-44.0,-47.0,-88.0,-89.0,-86.0,-88.0,35.0,42.0,43.0,39.0,1
898,CC:2F:71:3F:1F:24,5031530,1843128956,1184632,1357982949,3846898,485146007,1730,991915,1123401625,991076,1123300065,839,101560,959329,15,1183257,120904,1727,781,144444.0,43333.0,-72.0,-69.0,-66.0,-72.0,-72.0,-68.0,-66.0,-71.0,-88.0,-89.0,-86.0,-88.0,16.0,20.0,20.0,16.0,1
899,CC:2F:71:3E:C5:1F,3847885,485266540,987,120533,3846898,485146007,2,4284,357567,3564,272077,720,85490,1046,13,1419,28,2,54,130000.0,39000.0,-72.0,-72.0,-69.0,-60.0,-72.0,-72.0,-69.0,-60.0,-88.0,-89.0,-86.0,-88.0,16.0,17.0,17.0,28.0,1
900,BA:8C:B9:54:50:24,3851830,491340099,4930,6193890,3846900,485146209,7,9761,1752262,9739,1748767,22,3495,2358,17,5433,41,7,70,216660.0,130000.0,-48.0,-35.0,-43.0,-46.0,-41.0,-35.0,-42.0,-46.0,-88.0,-89.0,-86.0,-88.0,40.0,54.0,43.0,42.0,1
901,62:47:05:9D:EB:15,3853653,497329177,6751,12182766,3846902,485146411,1,6984,3803445,6934,3795787,50,7658,3317,0,6817,56,1,125,216660.0,130000.0,-43.0,-45.0,-35.0,-47.0,-43.0,-46.0,-37.0,-47.0,-88.0,-89.0,-86.0,-88.0,45.0,44.0,51.0,41.0,1
902,92:69:1D:31:68:E9,3850950,488799452,4048,3653041,3846902,485146411,1,5403,1157771,5233,1119153,170,38618,2202,12,4302,103,1,62,229410.0,137640.0,-53.0,-47.0,-43.0,-49.0,-52.0,-47.0,-44.0,-47.0,-88.0,-89.0,-86.0,-88.0,35.0,42.0,43.0,39.0,1
903,CC:2F:71:3F:1F:24,5031728,1843373988,1184826,1358227577,3846902,485146411,1730,992087,1123633973,991248,1123532413,839,101560,959499,15,1183451,120906,1727,781,144444.0,43333.0,-70.0,-70.0,-66.0,-71.0,-70.0,-70.0,-66.0,-70.0,-88.0,-89.0,-86.0,-88.0,18.0,19.0,20.0,17.0,1
904,CC:2F:71:3E:C5:1F,3847889,485266944,987,120533,3846902,485146411,2,4284,357567,3564,272077,720,85490,1046,13,1419,28,2,54,130000.0,39000.0,-72.0,-72.0,-69.0,-60.0,-72.0,-72.0,-69.0,-60.0,-88.0,-89.0,-86.0,-88.0,16.0,17.0,17.0,28.0,1
905,BA:8C:B9:54:50:24,3851832,491340301,4930,6193890,3846902,485146411,7,9761,1752262,9739,1748767,22,3495,2358,17,5433,41,7,70,216660.0,130000.0,-48.0,-35.0,-43.0,-46.0,-41.0,-35.0,-42.0,-46.0,-88.0,-89.0,-86.0,-88.0,40.0,54.0,43.0,42.0,1
906,62:47:05:9D:EB:15,3853657,497329581,6751,12182766,3846906,485146815,1,6987,3803649,6937,3795991,50,7658,3317,0,6817,56,1,125,216660.0,130000.0,-44.0,-45.0,-36.0,-49.0,-43.0,-46.0,-37.0,-47.0,-88.0,-89.0,-86.0,-88.0,44.0,44.0,50.0,39.0,1
907,92:69:1D:31:68:E9,3850954,488799856,4048,3653041,3846906,485146815,1,5403,1157771,5233,1119153,170,38618,2202,12,4302,103,1,62,229410.0,137640.0,-53.0,-47.0,-43.0,-49.0,-52.0,-47.0,-44.0,-47.0,-88.0,-89.0,-86.0,-88.0,35.0,42.0,43.0,39.0,1
908,CC:2F:71:3F:1F:24,5031934,1843622563,1185026,1358475546,3846908,485147017,1730,992268,1123869356,991429,1123767796,839,101560,959676,15,1183651,120909,1727,781,144444.0,43333.0,-70.0,-70.0,-66.0,-71.0,-70.0,-69.0,-65.0,-71.0,-88.0,-89.0,-86.0,-88.0,18.0,19.0,20.0,17.0,1
909,CC:2F:71:3E:C5:1F,3847896,485267610,987,120533,3846909,485147077,2,4284,357567,3564,272077,720,85490,1046,13,1419,28,2,54,130000.0,39000.0,-72.0,-72.0,-69.0,-60.0,-72.0,-72.0,-69.0,-60.0,-88.0,-89.0,-86.0,-88.0,16.0,17.0,17.0,28.0,1
910,BA:8C:B9:54:50:24,3851839,491340967,4930,6193890,3846909,485147077,7,9761,1752262,9739,1748767,22,3495,2358,17,5433,41,7,70,216660.0,130000.0,-48.0,-35.0,-43.0,-46.0,-41.0,-35.0,-42.0,-46.0,-88.0,-89.0,-86.0,-88.0,40.0,54.0,43.0,42.0,1
911,62:47:05:9D:EB:15,3853662,497330045,6751,12182766,3846911,485147279,1,6987,3803649,6937,3795991,50,7658,3317,0,6817,56,1,125,216660.0,130000.0,-44.0,-45.0,-36.0,-49.0,-43.0,-46.0,-37.0,-47.0,-88.0,-89.0,-86.0,-87.0,44.0,44.0,50.0,38.0,1
912,92:69:1D:31:68:E9,3850961,488800552,4050,3653273,3846911,485147279,1,5407,1158123,5237,1119505,170,38618,2204,12,4304,103,1,62,229410.0,137640.0,-51.0,-48.0,-45.0,-45.0,-51.0,-48.0,-44.0,-47.0,-88.0,-89.0,-86.0,-87.0,37.0,41.0,41.0,42.0,1
913,CC:2F:71:3F:1F:24,5032140,1843884119,1185229,1358736840,3846911,485147279,1730,992458,1124128336,991619,1124026776,839,101560,959858,15,1183854,120957,1727,781,130000.0,43333.0,-70.0,-68.0,-66.0,-71.0,-70.0,-68.0,-66.0,-71.0,-88.0,-89.0,-86.0,-87.0,18.0,21.0,20.0,16.0,1
914,CC:2F:71:3E:C5:1F,3847898,485267812,987,120533,3846911,485147279,2,4284,357567,3564,272077,720,85490,1046,13,1419,28,2,54,130000.0,39000.0,-72.0,-72.0,-69.0,-60.0,-72.0,-72.0,-69.0,-60.0,-88.0,-89.0,-86.0,-87.0,16.0,17.0,17.0,27.0,1
915,BA:8C:B9:54:50:24,3851841,491341169,4930,6193890,3846911,485147279,7,9761,1752262,9739,1748767,22,3495,2358,17,5433,41,7,70,216660.0,130000.0,-48.0,-35.0,-43.0,-46.0,-41.0,-35.0,-42.0,-46.0,-88.0,-89.0,-86.0,-87.0,40.0,54.0,43.0,41.0,1
916,62:47:05:9D:EB:15,3853668,497330651,6751,12182766,3846917,485147885,1,6987,3803649,6937,3795991,50,7658,3317,0,6817,56,1,125,216660.0,130000.0,-44.0,-45.0,-36.0,-49.0,-43.0,-46.0,-37.0,-47.0,-88.0,-88.0,-85.0,-86.0,44.0,43.0,49.0,37.0,1
917,92:69:1D:31:68:E9,3850967,488801158,4050,3653273,3846917,485147885,1,5407,1158123,5237,1119505,170,38618,2204,12,4304,103,1,62,229410.0,137640.0,-51.0,-48.0,-45.0,-45.0,-51.0,-48.0,-44.0,-47.0,-88.0,-88.0,-85.0,-86.0,37.0,40.0,40.0,41.0,1
918,CC:2F:71:3F:1F:24,5032338,1844127669,1185421,1358979784,3846917,485147885,1730,992631,1124360924,991792,1124259364,839,101560,960027,15,1184046,120957,1727,781,130000.0,43333.0,-70.0,-69.0,-66.0,-71.0,-70.0,-69.0,-66.0,-71.0,-88.0,-88.0,-85.0,-86.0,18.0,19.0,19.0,15.0,1
919,CC:2F:71:3E:C5:1F,3847904,485268418,987,120533,3846917,485147885,2,4284,357567,3564,272077,720,85490,1046,13,1419,28,2,54,130000.0,39000.0,-72.0,-72.0,-69.0,-60.0,-72.0,-72.0,-69.0,-60.0,-88.0,-88.0,-85.0,-86.0,16.0,16.0,16.0,26.0,1
920,BA:8C:B9:54:50:24,3851847,491341775,4930,6193890,3846917,485147885,7,9761,1752262,9739,1748767,22,3495,2358,17,5433,41,7,70,216660.0,130000.0,-48.0,-35.0,-43.0,-46.0,-41.0,-35.0,-42.0,-46.0,-88.0,-88.0,-85.0,-86.0,40.0,53.0,42.0,40.0,1
921,62:47:05:9D:EB:15,3853672,497330975,6751,12182766,3846921,485148209,1,6987,3803649,6937,3795991,50,7658,3317,0,6817,56,1,125,216660.0,130000.0,-44.0,-45.0,-36.0,-49.0,-43.0,-46.0,-37.0,-47.0,-88.0,-88.0,-85.0,-86.0,44.0,43.0,49.0,37.0,1
922,92:69:1D:31:68:E9,3850971,488801482,4050,3653273,3846921,485148209,1,5408,1158191,5238,1119573,170,38618,2204,12,4304,103,1,62,229410.0,137640.0,-51.0,-48.0,-42.0,-49.0,-51.0,-48.0,-44.0,-47.0,-88.0,-88.0,-85.0,-86.0,37.0,40.0,43.0,37.0,1
923,CC:2F:71:3F:1F:24,5032550,1844375745,1185629,1359227536,3846921,485148209,1730,992825,1124598675,991984,1124496879,841,101796,960213,15,1184254,120959,1727,782,144444.0,43333.0,-71.0,-69.0,-67.0,-73.0,-71.0,-68.0,-67.0,-72.0,-88.0,-88.0,-85.0,-86.0,17.0,19.0,18.0,13.0,1
924,CC:2F:71:3E:C5:1F,3847908,485268742,987,120533,3846921,485148209,2,4284,357567,3564,272077,720,85490,1046,13,1419,28,2,54,130000.0,39000.0,-72.0,-72.0,-69.0,-60.0,-72.0,-72.0,-69.0,-60.0,-88.0,-88.0,-85.0,-86.0,16.0,16.0,16.0,26.0,1
925,BA:8C:B9:54:50:24,3851851,491342099,4930,6193890,3846921,485148209,7,9761,1752262,9739,1748767,22,3495,2358,17,5433,41,7,70,216660.0,130000.0,-48.0,-35.0,-43.0,-46.0,-41.0,-35.0,-42.0,-46.0,-88.0,-88.0,-85.0,-86.0,40.0,53.0,42.0,40.0,1
926,62:47:05:9D:EB:15,3853678,497331581,6751,12182766,3846927,485148815,1,6987,3803649,6937,3795991,50,7658,3317,0,6817,56,1,125,216660.0,130000.0,-44.0,-45.0,-36.0,-49.0,-43.0,-46.0,-37.0,-47.0,-88.0,-88.0,-85.0,-86.0,44.0,43.0,49.0,37.0,1
927,92:69:1D:31:68:E9,3850977,488802088,4050,3653273,3846927,485148815,1,5408,1158191,5238,1119573,170,38618,2204,12,4304,103,1,62,229410.0,137640.0,-51.0,-48.0,-42.0,-49.0,-51.0,-48.0,-44.0,-47.0,-87.0,-88.0,-85.0,-86.0,36.0,40.0,43.0,37.0,1
928,CC:2F:71:3F:1F:24,5032746,1844617611,1185819,1359468796,3846927,485148815,1730,993002,1124836007,992161,1124734211,841,101796,960382,15,1184444,120959,1727,782,144444.0,43333.0,-70.0,-69.0,-67.0,-71.0,-70.0,-69.0,-66.0,-71.0,-87.0,-88.0,-85.0,-86.0,17.0,19.0,18.0,15.0,1
929,CC:2F:71:3E:C5:1F,3847914,485269348,987,120533,3846927,485148815,2,4284,357567,3564,272077,720,85490,1046,13,1419,28,2,54,130000.0,39000.0,-72.0,-72.0,-69.0,-60.0,-72.0,-72.0,-69.0,-60.0,-87.0,-88.0,-85.0,-86.0,15.0,16.0,16.0,26.0,1
930,BA:8C:B9:54:50:24,3851857,491342705,4930,6193890,3846927,485148815,7,9761,1752262,9739,1748767,22,3495,2358,17,5433,41,7,70,216660.0,130000.0,-48.0,-35.0,-43.0,-46.0,-41.0,-35.0,-42.0,-46.0,-87.0,-88.0,-85.0,-86.0,39.0,53.0,42.0,40.0,1
931,62:47:05:9D:EB:15,3853680,497331783,6751,12182766,3846929,485149017,1,6987,3803649,6937,3795991,50,7658,3317,0,6817,56,1,125,216660.0,130000.0,-44.0,-45.0,-36.0,-49.0,-43.0,-46.0,-37.0,-47.0,-87.0,-88.0,-85.0,-86.0,43.0,43.0,49.0,37.0,1
932,92:69:1D:31:68:E9,3850980,488802350,4050,3653273,3846930,485149077,1,5408,1158191,5238,1119573,170,38618,2204,12,4304,103,1,62,229410.0,137640.0,-51.0,-48.0,-42.0,-49.0,-51.0,-48.0,-44.0,-47.0,-87.0,-88.0,-85.0,-86.0,36.0,40.0,43.0,37.0,1
933,CC:2F:71:3F:1F:24,5032939,1844857709,1186009,1359708632,3846930,485149077,1730,993172,1125065303,992331,1124963507,841,101796,960548,15,1184634,120963,1727,782,144444.0,43333.0,-70.0,-69.0,-67.0,-72.0,-70.0,-69.0,-67.0,-71.0,-87.0,-88.0,-85.0,-86.0,17.0,19.0,18.0,14.0,1
934,CC:2F:71:3E:C5:1F,3847917,485269610,987,120533,3846930,485149077,2,4284,357567,3564,272077,720,85490,1046,13,1419,28,2,54,130000.0,39000.0,-72.0,-72.0,-69.0,-60.0,-72.0,-72.0,-69.0,-60.0,-87.0,-88.0,-85.0,-86.0,15.0,16.0,16.0,26.0,1
935,BA:8C:B9:54:50:24,3851860,491342967,4930,6193890,3846930,485149077,7,9761,1752262,9739,1748767,22,3495,2358,17,5433,41,7,70,216660.0,130000.0,-48.0,-35.0,-43.0,-46.0,-41.0,-35.0,-42.0,-46.0,-87.0,-88.0,-85.0,-86.0,39.0,53.0,42.0,40.0,1
936,62:47:05:9D:EB:15,3853687,497332449,6751,12182766,3846936,485149683,1,6987,3803649,6937,3795991,50,7658,3317,0,6817,56,1,125,216660.0,130000.0,-44.0,-45.0,-36.0,-49.0,-43.0,-46.0,-37.0,-47.0,-87.0,-87.0,-84.0,-85.0,43.0,42.0,48.0,36.0,1
937,92:69:1D:31:68:E9,3850986,488802956,4050,3653273,3846936,485149683,1,5408,1158191,5238,1119573,170,38618,2204,12,4304,103,1,62,229410.0,137640.0,-51.0,-48.0,-42.0,-49.0,-51.0,-48.0,-44.0,-47.0,-87.0,-87.0,-84.0,-85.0,36.0,39.0,42.0,36.0,1
938,CC:2F:71:3F:1F:24,5033136,1845098281,1186200,1359948598,3846936,485149683,1730,993350,1125301437,992509,1125199641,841,101796,960717,15,1184825,120964,1727,782,144444.0,43333.0,-71.0,-69.0,-67.0,-74.0,-71.0,-68.0,-67.0,-74.0,-87.0,-87.0,-84.0,-85.0,16.0,18.0,17.0,11.0,1
939,CC:2F:71:3E:C5:1F,3847937,485276017,987,120533,3846950,485155484,2,4286,357707,3566,272217,720,85490,1046,13,1420,28,2,54,130000.0,39000.0,-73.0,-72.0,-70.0,-61.0,-72.0,-72.0,-69.0,-60.0,-87.0,-87.0,-84.0,-85.0,14.0,15.0,14.0,24.0,1
940,BA:8C:B9:54:50:24,3851880,491349374,4930,6193890,3846950,485155484,7,9764,1752466,9742,1748971,22,3495,2358,17,5434,41,7,70,216660.0,130000.0,-48.0,-35.0,-42.0,-45.0,-43.0,-35.0,-42.0,-46.0,-87.0,-87.0,-84.0,-85.0,39.0,52.0,42.0,40.0,1
941,62:47:05:9D:EB:15,3853712,497343674,6751,12182766,3846961,485160908,1,6989,3803785,6939,3796127,50,7658,3317,0,6818,56,1,125,216660.0,130000.0,-45.0,-50.0,-48.0,-45.0,-43.0,-46.0,-38.0,-47.0,-87.0,-87.0,-84.0,-85.0,42.0,37.0,36.0,40.0,1
942,92:69:1D:31:68:E9,3851013,488814383,4050,3653273,3846963,485161110,1,5411,1158562,5240,1119709,171,38853,2205,12,4304,103,1,62,229410.0,137640.0,-51.0,-48.0,-44.0,-46.0,-51.0,-48.0,-44.0,-47.0,-87.0,-87.0,-84.0,-85.0,36.0,39.0,40.0,39.0,1
943,CC:2F:71:3F:1F:24,5033383,1845382997,1186420,1360221887,3846963,485161110,1730,993550,1125557544,992709,1125455748,841,101796,960915,15,1185045,120980,1727,782,144444.0,43333.0,-70.0,-70.0,-67.0,-72.0,-70.0,-69.0,-66.0,-72.0,-87.0,-87.0,-84.0,-85.0,17.0,17.0,17.0,13.0,1
944,CC:2F:71:3E:C5:1F,3847950,485281643,987,120533,3846963,485161110,2,4286,357707,3566,272217,720,85490,1046,13,1420,28,2,54,130000.0,39000.0,-73.0,-72.0,-70.0,-61.0,-72.0,-72.0,-69.0,-60.0,-87.0,-87.0,-84.0,-85.0,14.0,15.0,14.0,24.0,1
945,BA:8C:B9:54:50:24,3851893,491355000,4930,6193890,3846963,485161110,7,9764,1752466,9742,1748971,22,3495,2358,17,5434,41,7,70,216660.0,130000.0,-48.0,-35.0,-42.0,-45.0,-43.0,-35.0,-42.0,-46.0,-87.0,-87.0,-84.0,-85.0,39.0,52.0,42.0,40.0,1
946,62:47:05:9D:EB:15,3853719,497344340,6751,12182766,3846968,485161574,1,6989,3803785,6939,3796127,50,7658,3317,0,6818,56,1,125,216660.0,130000.0,-45.0,-50.0,-48.0,-45.0,-43.0,-46.0,-38.0,-47.0,-87.0,-87.0,-84.0,-85.0,42.0,37.0,36.0,40.0,1
947,92:69:1D:31:68:E9,3851020,488815049,4050,3653273,3846970,485161776,1,5411,1158562,5240,1119709,171,38853,2205,12,4304,103,1,62,229410.0,137640.0,-51.0,-48.0,-44.0,-46.0,-51.0,-48.0,-44.0,-47.0,-87.0,-87.0,-84.0,-85.0,36.0,39.0,40.0,39.0,1
948,CC:2F:71:3F:1F:24,5033584,1845628291,1186614,1360466515,3846970,485161776,1730,993725,1125791782,992884,1125689986,841,101796,961086,15,1185239,120988,1727,782,144444.0,43333.0,-71.0,-70.0,-66.0,-71.0,-70.0,-69.0,-66.0,-70.0,-87.0,-87.0,-84.0,-85.0,16.0,17.0,18.0,14.0,1
949,CC:2F:71:3E:C5:1F,3847957,485282309,987,120533,3846970,485161776,2,4286,357707,3566,272217,720,85490,1046,13,1420,28,2,54,130000.0,39000.0,-73.0,-72.0,-70.0,-61.0,-72.0,-72.0,-69.0,-60.0,-87.0,-87.0,-84.0,-85.0,14.0,15.0,14.0,24.0,1
950,BA:8C:B9:54:50:24,3851900,491355666,4930,6193890,3846970,485161776,7,9764,1752466,9742,1748971,22,3495,2358,17,5434,41,7,70,216660.0,130000.0,-48.0,-35.0,-42.0,-45.0,-43.0,-35.0,-42.0,-46.0,-87.0,-87.0,-84.0,-85.0,39.0,52.0,42.0,40.0,1
951,62:47:05:9D:EB:15,3853724,497345017,6751,12182766,3846973,485162251,1,6989,3803785,6939,3796127,50,7658,3317,0,6818,56,1,125,216660.0,130000.0,-45.0,-50.0,-48.0,-45.0,-43.0,-46.0,-38.0,-47.0,-87.0,-87.0,-84.0,-84.0,42.0,37.0,36.0,39.0,1
952,92:69:1D:31:68:E9,3851023,488815524,4050,3653273,3846973,485162251,1,5411,1158562,5240,1119709,171,38853,2205,12,4304,103,1,62,229410.0,137640.0,-51.0,-48.0,-44.0,-46.0,-51.0,-48.0,-44.0,-47.0,-87.0,-87.0,-84.0,-84.0,36.0,39.0,40.0,38.0,1
953,CC:2F:71:3F:1F:24,5033778,1845870156,1186805,1360707905,3846973,485162251,1730,993896,1126019866,993055,1125918070,841,101796,961253,15,1185430,120992,1727,782,144444.0,43333.0,-70.0,-69.0,-66.0,-70.0,-70.0,-69.0,-65.0,-70.0,-87.0,-87.0,-84.0,-84.0,17.0,18.0,18.0,14.0,1
954,CC:2F:71:3E:C5:1F,3847960,485282784,987,120533,3846973,485162251,2,4286,357707,3566,272217,720,85490,1046,13,1420,28,2,54,130000.0,39000.0,-73.0,-72.0,-70.0,-61.0,-72.0,-72.0,-69.0,-60.0,-87.0,-87.0,-84.0,-84.0,14.0,15.0,14.0,23.0,1
955,BA:8C:B9:54:50:24,3851903,491356141,4930,6193890,3846973,485162251,7,9764,1752466,9742,1748971,22,3495,2358,17,5434,41,7,70,216660.0,130000.0,-48.0,-35.0,-42.0,-45.0,-43.0,-35.0,-42.0,-46.0,-87.0,-87.0,-84.0,-84.0,39.0,52.0,42.0,39.0,1
956,62:47:05:9D:EB:15,3853731,497345683,6751,12182766,3846980,485162917,1,6989,3803785,6939,3796127,50,7658,3317,0,6818,56,1,125,216660.0,130000.0,-45.0,-50.0,-48.0,-45.0,-43.0,-46.0,-38.0,-47.0,-87.0,-87.0,-84.0,-84.0,42.0,37.0,36.0,39.0,1
957,92:69:1D:31:68:E9,3851030,488816190,4050,3653273,3846980,485162917,1,5411,1158562,5240,1119709,171,38853,2205,12,4304,103,1,62,229410.0,137640.0,-51.0,-48.0,-44.0,-46.0,-51.0,-48.0,-44.0,-47.0,-87.0,-87.0,-84.0,-84.0,36.0,39.0,40.0,38.0,1
958,CC:2F:71:3F:1F:24,5033981,1846118558,1187001,1360955641,3846980,485162917,1730,994075,1126263162,993234,1126161366,841,101796,961426,15,1185626,120999,1727,782,144444.0,43333.0,-70.0,-70.0,-67.0,-71.0,-70.0,-70.0,-66.0,-70.0,-87.0,-87.0,-84.0,-84.0,17.0,17.0,17.0,13.0,1
959,CC:2F:71:3E:C5:1F,3847967,485283450,987,120533,3846980,485162917,2,4286,357707,3566,272217,720,85490,1046,13,1420,28,2,54,130000.0,39000.0,-73.0,-72.0,-70.0,-61.0,-72.0,-72.0,-69.0,-60.0,-87.0,-87.0,-84.0,-84.0,14.0,15.0,14.0,23.0,1
960,BA:8C:B9:54:50:24,3851910,491356807,4930,6193890,3846980,485162917,7,9764,1752466,9742,1748971,22,3495,2358,17,5434,41,7,70,216660.0,130000.0,-48.0,-35.0,-42.0,-45.0,-43.0,-35.0,-42.0,-46.0,-87.0,-87.0,-84.0,-84.0,39.0,52.0,42.0,39.0,1
961,62:47:05:9D:EB:15,3853733,497345885,6751,12182766,3846982,485163119,1,6989,3803785,6939,3796127,50,7658,3317,0,6818,56,1,125,216660.0,130000.0,-45.0,-50.0,-48.0,-45.0,-43.0,-46.0,-38.0,-47.0,-87.0,-87.0,-84.0,-84.0,42.0,37.0,36.0,39.0,1
962,92:69:1D:31:68:E9,3851032,488816392,4050,3653273,3846982,485163119,1,5411,1158562,5240,1119709,171,38853,2205,12,4304,103,1,62,229410.0,137640.0,-51.0,-48.0,-44.0,-46.0,-51.0,-48.0,-44.0,-47.0,-87.0,-87.0,-84.0,-84.0,36.0,39.0,40.0,38.0,1
963,CC:2F:71:3F:1F:24,5034181,1846363621,1187199,1361200502,3846982,485163119,1730,994254,1126496842,993413,1126395046,841,101796,961601,15,1185824,121004,1727,782,144444.0,43333.0,-71.0,-70.0,-67.0,-71.0,-70.0,-70.0,-66.0,-71.0,-87.0,-87.0,-84.0,-84.0,16.0,17.0,17.0,13.0,1
964,CC:2F:71:3E:C5:1F,3847969,485283652,987,120533,3846982,485163119,2,4286,357707,3566,272217,720,85490,1046,13,1420,28,2,54,130000.0,39000.0,-73.0,-72.0,-70.0,-61.0,-72.0,-72.0,-69.0,-60.0,-87.0,-87.0,-84.0,-84.0,14.0,15.0,14.0,23.0,1
965,BA:8C:B9:54:50:24,3851914,491357211,4930,6193890,3846984,485163321,7,9764,1752466,9742,1748971,22,3495,2358,17,5434,41,7,70,216660.0,130000.0,-48.0,-35.0,-42.0,-45.0,-43.0,-35.0,-42.0,-46.0,-87.0,-87.0,-84.0,-84.0,39.0,52.0,42.0,39.0,1
966,62:47:05:9D:EB:15,3853741,497346859,6751,12182766,3846990,485164093,1,6989,3803785,6939,3796127,50,7658,3317,0,6818,56,1,125,216660.0,130000.0,-45.0,-50.0,-48.0,-45.0,-43.0,-46.0,-38.0,-47.0,-87.0,-87.0,-84.0,-84.0,42.0,37.0,36.0,39.0,1
967,92:69:1D:31:68:E9,3851040,488817366,4050,3653273,3846990,485164093,1,5411,1158562,5240,1119709,171,38853,2205,12,4304,103,1,62,229410.0,137640.0,-51.0,-48.0,-44.0,-46.0,-51.0,-48.0,-44.0,-47.0,-87.0,-87.0,-84.0,-84.0,36.0,39.0,40.0,38.0,1
968,CC:2F:71:3F:1F:24,5034377,1846602733,1187387,1361438640,3846990,485164093,1730,994426,1126723668,993585,1126621872,841,101796,961769,15,1186012,121009,1727,782,144444.0,43333.0,-70.0,-70.0,-66.0,-71.0,-70.0,-70.0,-66.0,-70.0,-87.0,-87.0,-84.0,-84.0,17.0,17.0,18.0,13.0,1
969,CC:2F:71:3E:C5:1F,3847977,485284626,987,120533,3846990,485164093,2,4286,357707,3566,272217,720,85490,1046,13,1420,28,2,54,130000.0,39000.0,-73.0,-72.0,-70.0,-61.0,-72.0,-72.0,-69.0,-60.0,-87.0,-87.0,-84.0,-84.0,14.0,15.0,14.0,23.0,1
970,BA:8C:B9:54:50:24,3851920,491357983,4930,6193890,3846990,485164093,7,9764,1752466,9742,1748971,22,3495,2358,17,5434,41,7,70,216660.0,130000.0,-48.0,-35.0,-42.0,-45.0,-43.0,-35.0,-42.0,-46.0,-87.0,-87.0,-84.0,-84.0,39.0,52.0,42.0,39.0,1
971,62:47:05:9D:EB:15,3853744,497347121,6751,12182766,3846993,485164355,1,6989,3803785,6939,3796127,50,7658,3317,0,6818,56,1,125,216660.0,130000.0,-45.0,-50.0,-48.0,-45.0,-43.0,-46.0,-38.0,-47.0,-87.0,-87.0,-84.0,-84.0,42.0,37.0,36.0,39.0,1
972,92:69:1D:31:68:E9,3851043,488817628,4050,3653273,3846993,485164355,1,5411,1158562,5240,1119709,171,38853,2205,12,4304,103,1,62,229410.0,137640.0,-51.0,-48.0,-44.0,-46.0,-51.0,-48.0,-44.0,-47.0,-87.0,-87.0,-84.0,-84.0,36.0,39.0,40.0,38.0,1
973,CC:2F:71:3F:1F:24,5034570,1846844255,1187577,1361679900,3846993,485164355,1730,994599,1126957598,993758,1126855802,841,101796,961937,15,1186202,121016,1727,782,144444.0,43333.0,-71.0,-70.0,-66.0,-71.0,-70.0,-70.0,-66.0,-71.0,-87.0,-87.0,-84.0,-84.0,16.0,17.0,18.0,13.0,1
974,CC:2F:71:3E:C5:1F,3847980,485284888,987,120533,3846993,485164355,2,4286,357707,3566,272217,720,85490,1046,13,1420,28,2,54,130000.0,39000.0,-73.0,-72.0,-70.0,-61.0,-72.0,-72.0,-69.0,-60.0,-87.0,-87.0,-84.0,-84.0,14.0,15.0,14.0,23.0,1
975,BA:8C:B9:54:50:24,3851925,491358447,4930,6193890,3846995,485164557,7,9764,1752466,9742,1748971,22,3495,2358,17,5434,41,7,70,216660.0,130000.0,-48.0,-35.0,-42.0,-45.0,-43.0,-35.0,-42.0,-46.0,-87.0,-87.0,-84.0,-84.0,39.0,52.0,42.0,39.0,1
976,62:47:05:9D:EB:15,3853750,497347727,6751,12182766,3846999,485164961,1,6989,3803785,6939,3796127,50,7658,3317,0,6818,56,1,125,216660.0,130000.0,-45.0,-50.0,-48.0,-45.0,-43.0,-46.0,-38.0,-47.0,-87.0,-87.0,-84.0,-84.0,42.0,37.0,36.0,39.0,1
977,92:69:1D:31:68:E9,3851049,488818234,4050,3653273,3846999,485164961,1,5411,1158562,5240,1119709,171,38853,2205,12,4304,103,1,62,229410.0,137640.0,-51.0,-48.0,-44.0,-46.0,-51.0,-48.0,-44.0,-47.0,-87.0,-87.0,-84.0,-84.0,36.0,39.0,40.0,38.0,1
978,CC:2F:71:3F:1F:24,5034768,1847089229,1187769,1361924268,3846999,485164961,1730,994782,1127200258,993941,1127098462,841,101796,962108,15,1186394,121025,1727,782,144444.0,43333.0,-70.0,-70.0,-66.0,-71.0,-70.0,-69.0,-66.0,-70.0,-87.0,-87.0,-84.0,-84.0,17.0,17.0,18.0,13.0,1
979,CC:2F:71:3E:C5:1F,3847986,485285494,987,120533,3846999,485164961,2,4286,357707,3566,272217,720,85490,1046,13,1420,28,2,54,130000.0,39000.0,-73.0,-72.0,-70.0,-61.0,-72.0,-72.0,-69.0,-60.0,-87.0,-87.0,-84.0,-84.0,14.0,15.0,14.0,23.0,1
980,BA:8C:B9:54:50:24,3851929,491358851,4930,6193890,3846999,485164961,7,9764,1752466,9742,1748971,22,3495,2358,17,5434,41,7,70,216660.0,130000.0,-48.0,-35.0,-42.0,-45.0,-43.0,-35.0,-42.0,-46.0,-87.0,-87.0,-84.0,-84.0,39.0,52.0,42.0,39.0,1
981,62:47:05:9D:EB:15,3853753,497347989,6751,12182766,3847002,485165223,1,6989,3803785,6939,3796127,50,7658,3317,0,6818,56,1,125,216660.0,130000.0,-45.0,-50.0,-48.0,-45.0,-43.0,-46.0,-38.0,-47.0,-87.0,-87.0,-84.0,-84.0,42.0,37.0,36.0,39.0,1
982,92:69:1D:31:68:E9,3851052,488818496,4050,3653273,3847002,485165223,1,5411,1158562,5240,1119709,171,38853,2205,12,4304,103,1,62,229410.0,137640.0,-51.0,-48.0,-44.0,-46.0,-51.0,-48.0,-44.0,-47.0,-87.0,-87.0,-84.0,-84.0,36.0,39.0,40.0,38.0,1
983,CC:2F:71:3F:1F:24,5034973,1847336277,1187969,1362170852,3847004,485165425,1730,994968,1127433724,994127,1127331928,841,101796,962286,15,1186594,121035,1727,782,144444.0,43333.0,-71.0,-70.0,-66.0,-71.0,-70.0,-70.0,-66.0,-70.0,-87.0,-87.0,-84.0,-84.0,16.0,17.0,18.0,13.0,1
984,CC:2F:71:3E:C5:1F,3847991,485285958,987,120533,3847004,485165425,2,4286,357707,3566,272217,720,85490,1046,13,1420,28,2,54,130000.0,39000.0,-73.0,-72.0,-70.0,-61.0,-72.0,-72.0,-69.0,-60.0,-87.0,-87.0,-84.0,-84.0,14.0,15.0,14.0,23.0,1
985,BA:8C:B9:54:50:24,3851936,491359517,4930,6193890,3847006,485165627,7,9764,1752466,9742,1748971,22,3495,2358,17,5434,41,7,70,216660.0,130000.0,-48.0,-35.0,-42.0,-45.0,-43.0,-35.0,-42.0,-46.0,-87.0,-87.0,-84.0,-84.0,39.0,52.0,42.0,39.0,1
986,62:47:05:9D:EB:15,3853759,497348595,6751,12182766,3847008,485165829,1,6989,3803785,6939,3796127,50,7658,3317,0,6818,56,1,125,216660.0,130000.0,-45.0,-50.0,-48.0,-45.0,-43.0,-46.0,-38.0,-47.0,-87.0,-87.0,-84.0,-84.0,42.0,37.0,36.0,39.0,1
987,92:69:1D:31:68:E9,3851058,488819102,4050,3653273,3847008,485165829,1,5411,1158562,5240,1119709,171,38853,2205,12,4304,103,1,62,229410.0,137640.0,-51.0,-48.0,-44.0,-46.0,-51.0,-48.0,-44.0,-47.0,-87.0,-87.0,-84.0,-84.0,36.0,39.0,40.0,38.0,1
988,CC:2F:71:3F:1F:24,5035167,1847576517,1188159,1362410688,3847008,485165829,1730,995142,1127669208,994301,1127567412,841,101796,962454,15,1186784,121039,1727,782,144444.0,43333.0,-70.0,-69.0,-65.0,-71.0,-70.0,-69.0,-66.0,-70.0,-87.0,-87.0,-84.0,-84.0,17.0,18.0,19.0,13.0,1
989,CC:2F:71:3E:C5:1F,3847995,485286362,987,120533,3847008,485165829,2,4286,357707,3566,272217,720,85490,1046,13,1420,28,2,54,130000.0,39000.0,-73.0,-72.0,-70.0,-61.0,-72.0,-72.0,-69.0,-60.0,-87.0,-87.0,-84.0,-84.0,14.0,15.0,14.0,23.0,1
990,BA:8C:B9:54:50:24,3851938,491359719,4930,6193890,3847008,485165829,7,9764,1752466,9742,1748971,22,3495,2358,17,5434,41,7,70,216660.0,130000.0,-48.0,-35.0,-42.0,-45.0,-43.0,-35.0,-42.0,-46.0,-87.0,-87.0,-84.0,-84.0,39.0,52.0,42.0,39.0,1
991,62:47:05:9D:EB:15,3853763,497348999,6751,12182766,3847012,485166233,1,6990,3803853,6940,3796195,50,7658,3317,0,6818,56,1,125,216660.0,130000.0,-44.0,-45.0,-36.0,-49.0,-43.0,-46.0,-38.0,-47.0,-87.0,-87.0,-84.0,-84.0,43.0,42.0,48.0,35.0,1
992,92:69:1D:31:68:E9,3851063,488819574,4050,3653273,3847013,485166301,1,5411,1158562,5240,1119709,171,38853,2205,12,4304,103,1,62,229410.0,137640.0,-51.0,-48.0,-44.0,-46.0,-51.0,-48.0,-44.0,-47.0,-87.0,-87.0,-84.0,-84.0,36.0,39.0,40.0,38.0,1
993,CC:2F:71:3F:1F:24,5035381,1847846355,1188367,1362679920,3847014,485166435,1730,995338,1127934602,994497,1127832806,841,101796,962641,15,1186992,121057,1727,783,144444.0,43333.0,-70.0,-70.0,-65.0,-70.0,-70.0,-70.0,-65.0,-70.0,-87.0,-87.0,-84.0,-84.0,17.0,17.0,19.0,14.0,1
994,CC:2F:71:3E:C5:1F,3848001,485286968,987,120533,3847014,485166435,2,4286,357707,3566,272217,720,85490,1046,13,1420,28,2,54,130000.0,39000.0,-73.0,-72.0,-70.0,-61.0,-72.0,-72.0,-69.0,-60.0,-87.0,-87.0,-84.0,-84.0,14.0,15.0,14.0,23.0,1
995,BA:8C:B9:54:50:24,3851944,491360325,4930,6193890,3847014,485166435,7,9764,1752466,9742,1748971,22,3495,2358,17,5434,41,7,70,216660.0,130000.0,-48.0,-35.0,-42.0,-45.0,-43.0,-35.0,-42.0,-46.0,-87.0,-87.0,-84.0,-84.0,39.0,52.0,42.0,39.0,1
996,62:47:05:9D:EB:15,3853768,497349463,6751,12182766,3847017,485166697,1,6990,3803853,6940,3796195,50,7658,3317,0,6818,56,1,125,216660.0,130000.0,-44.0,-45.0,-36.0,-49.0,-43.0,-46.0,-38.0,-47.0,-87.0,-87.0,-84.0,-84.0,43.0,42.0,48.0,35.0,1
997,92:69:1D:31:68:E9,3851067,488819970,4050,3653273,3847017,485166697,1,5411,1158562,5240,1119709,171,38853,2205,12,4304,103,1,62,229410.0,137640.0,-51.0,-48.0,-44.0,-46.0,-51.0,-48.0,-44.0,-47.0,-87.0,-87.0,-84.0,-84.0,36.0,39.0,40.0,38.0,1
998,CC:2F:71:3F:1F:24,5035583,1848091538,1188566,1362924841,3847017,485166697,1730,995517,1128168296,994676,1128066500,841,101796,962815,15,1187191,121096,1727,783,130000.0,43333.0,-70.0,-70.0,-66.0,-70.0,-69.0,-70.0,-65.0,-70.0,-87.0,-87.0,-84.0,-84.0,17.0,17.0,18.0,14.0,1
999,CC:2F:71:3E:C5:1F,3848005,485287346,988,120649,3847017,485166697,2,4287,357777,3567,272287,720,85490,1046,13,1421,28,2,54,130000.0,39000.0,-72.0,-71.0,-69.0,-60.0,-72.0,-72.0,-69.0,-60.0,-87.0,-87.0,-84.0,-84.0,15.0,16.0,15.0,24.0,1
1000,BA:8C:B9:54:50:24,3851950,491360905,4931,6194006,3847019,485166899,7,9766,1752602,9744,1749107,22,3495,2358,17,5435,41,7,70,216660.0,130000.0,-39.0,-37.0,-46.0,-52.0,-42.0,-35.0,-43.0,-47.0,-87.0,-87.0,-84.0,-84.0,48.0,50.0,38.0,32.0,1
1001,62:47:05:9D:EB:15,3853773,497349927,6752,12182826,3847021,485167101,1,6991,3803921,6941,3796263,50,7658,3317,0,6819,56,1,125,216660.0,130000.0,-44.0,-45.0,-36.0,-48.0,-44.0,-46.0,-38.0,-47.0,-87.0,-87.0,-84.0,-84.0,43.0,42.0,48.0,36.0,1
1002,92:69:1D:31:68:E9,3851074,488820692,4051,3653389,3847023,485167303,1,5413,1158698,5242,1119845,171,38853,2205,12,4305,103,1,62,216660.0,130000.0,-50.0,-50.0,-47.0,-47.0,-51.0,-48.0,-45.0,-47.0,-87.0,-87.0,-84.0,-84.0,37.0,37.0,37.0,37.0,1
1003,CC:2F:71:3F:1F:24,5035780,1848333310,1188757,1363166007,3847023,485167303,1730,995692,1128401148,994851,1128299352,841,101796,962986,15,1187382,121100,1727,783,130000.0,43333.0,-70.0,-70.0,-65.0,-70.0,-69.0,-70.0,-65.0,-70.0,-87.0,-87.0,-84.0,-84.0,17.0,17.0,19.0,14.0,1
1004,CC:2F:71:3E:C5:1F,3848011,485287952,988,120649,3847023,485167303,2,4288,357847,3568,272357,720,85490,1046,13,1421,28,2,54,130000.0,39000.0,-72.0,-71.0,-69.0,-60.0,-72.0,-71.0,-69.0,-60.0,-87.0,-87.0,-84.0,-84.0,15.0,16.0,15.0,24.0,1
1005,BA:8C:B9:54:50:24,3851954,491361309,4931,6194006,3847023,485167303,7,9766,1752602,9744,1749107,22,3495,2358,17,5435,41,7,70,216660.0,130000.0,-39.0,-37.0,-46.0,-52.0,-42.0,-35.0,-43.0,-47.0,-87.0,-87.0,-84.0,-84.0,48.0,50.0,38.0,32.0,1
1006,62:47:05:9D:EB:15,3853778,497350391,6752,12182826,3847026,485167565,1,6992,3803989,6942,3796331,50,7658,3317,0,6819,56,1,125,216660.0,130000.0,-43.0,-45.0,-36.0,-47.0,-44.0,-46.0,-38.0,-47.0,-87.0,-87.0,-84.0,-84.0,44.0,42.0,48.0,37.0,1
1007,92:69:1D:31:68:E9,3851077,488820954,4051,3653389,3847026,485167565,1,5413,1158698,5242,1119845,171,38853,2205,12,4305,103,1,62,216660.0,130000.0,-50.0,-50.0,-47.0,-47.0,-51.0,-48.0,-45.0,-47.0,-87.0,-87.0,-84.0,-84.0,37.0,37.0,37.0,37.0,1
1008,CC:2F:71:3F:1F:24,5035978,1848579472,1188950,1363411705,3847028,485167767,1730,995876,1128645174,995035,1128543378,841,101796,963159,15,1187575,121103,1727,783,130000.0,43333.0,-70.0,-70.0,-66.0,-70.0,-69.0,-70.0,-65.0,-70.0,-87.0,-87.0,-84.0,-84.0,17.0,17.0,18.0,14.0,1
1009,CC:2F:71:3E:C5:1F,3848016,485288416,988,120649,3847028,485167767,2,4288,357847,3568,272357,720,85490,1046,13,1421,28,2,54,130000.0,39000.0,-72.0,-71.0,-69.0,-60.0,-72.0,-71.0,-69.0,-60.0,-87.0,-87.0,-84.0,-84.0,15.0,16.0,15.0,24.0,1
1010,BA:8C:B9:54:50:24,3851959,491361773,4931,6194006,3847028,485167767,7,9767,1752670,9745,1749175,22,3495,2358,17,5435,41,7,71,216660.0,130000.0,-48.0,-35.0,-42.0,-45.0,-43.0,-35.0,-43.0,-47.0,-87.0,-87.0,-84.0,-84.0,39.0,52.0,42.0,39.0,1
1011,62:47:05:9D:EB:15,3853784,497350997,6752,12182826,3847032,485168171,1,6992,3803989,6942,3796331,50,7658,3317,0,6819,56,1,125,216660.0,130000.0,-43.0,-45.0,-36.0,-47.0,-44.0,-46.0,-38.0,-47.0,-87.0,-87.0,-84.0,-84.0,44.0,42.0,48.0,37.0,1
1012,92:69:1D:31:68:E9,3851084,488821833,4051,3653389,3847033,485168444,1,5413,1158698,5242,1119845,171,38853,2205,12,4305,103,1,62,216660.0,130000.0,-50.0,-50.0,-47.0,-47.0,-51.0,-48.0,-45.0,-47.0,-87.0,-87.0,-84.0,-84.0,37.0,37.0,37.0,37.0,1
1013,CC:2F:71:3F:1F:24,5036174,1848822683,1189141,1363654239,3847033,485168444,1730,996052,1128879634,995211,1128777838,841,101796,963330,15,1187766,121126,1727,784,130000.0,43333.0,-70.0,-70.0,-66.0,-70.0,-69.0,-70.0,-66.0,-70.0,-87.0,-87.0,-84.0,-84.0,17.0,17.0,18.0,14.0,1
1014,CC:2F:71:3E:C5:1F,3848021,485289093,988,120649,3847033,485168444,2,4288,357847,3568,272357,720,85490,1046,13,1421,28,2,54,130000.0,39000.0,-72.0,-71.0,-69.0,-60.0,-72.0,-71.0,-69.0,-60.0,-87.0,-87.0,-84.0,-84.0,15.0,16.0,15.0,24.0,1
1015,BA:8C:B9:54:50:24,3851964,491362450,4931,6194006,3847033,485168444,7,9767,1752670,9745,1749175,22,3495,2358,17,5435,41,7,71,216660.0,130000.0,-48.0,-35.0,-42.0,-45.0,-43.0,-35.0,-43.0,-47.0,-87.0,-87.0,-84.0,-84.0,39.0,52.0,42.0,39.0,1
1016,62:47:05:9D:EB:15,3853788,497351534,6752,12182826,3847036,485168708,1,6992,3803989,6942,3796331,50,7658,3317,0,6819,56,1,125,216660.0,130000.0,-43.0,-45.0,-36.0,-47.0,-44.0,-46.0,-38.0,-47.0,-87.0,-87.0,-84.0,-84.0,44.0,42.0,48.0,37.0,1
1017,92:69:1D:31:68:E9,3851089,488822299,4051,3653389,3847038,485168910,1,5413,1158698,5242,1119845,171,38853,2205,12,4305,103,1,62,216660.0,130000.0,-50.0,-50.0,-47.0,-47.0,-51.0,-48.0,-45.0,-47.0,-87.0,-87.0,-84.0,-84.0,37.0,37.0,37.0,37.0,1
1018,CC:2F:71:3F:1F:24,5036380,1849069810,1189342,1363900900,3847038,485168910,1730,996235,1129113843,995394,1129012047,841,101796,963507,15,1187967,121127,1727,784,130000.0,43333.0,-69.0,-70.0,-66.0,-70.0,-69.0,-70.0,-65.0,-70.0,-87.0,-87.0,-84.0,-84.0,18.0,17.0,18.0,14.0,1
1019,CC:2F:71:3E:C5:1F,3848026,485289559,988,120649,3847038,485168910,2,4290,358035,3569,272427,721,85608,1047,13,1421,28,2,54,130000.0,39000.0,-72.0,-71.0,-69.0,-60.0,-72.0,-71.0,-69.0,-60.0,-87.0,-87.0,-84.0,-84.0,15.0,16.0,15.0,24.0,1
1020,BA:8C:B9:54:50:24,3851969,491362916,4931,6194006,3847038,485168910,7,9767,1752670,9745,1749175,22,3495,2358,17,5435,41,7,71,216660.0,130000.0,-48.0,-35.0,-42.0,-45.0,-43.0,-35.0,-43.0,-47.0,-87.0,-87.0,-84.0,-84.0,39.0,52.0,42.0,39.0,1
1021,62:47:05:9D:EB:15,3853795,497352200,6752,12182826,3847043,485169374,1,6992,3803989,6942,3796331,50,7658,3317,0,6819,56,1,125,216660.0,130000.0,-43.0,-45.0,-36.0,-47.0,-44.0,-46.0,-38.0,-47.0,-87.0,-87.0,-84.0,-84.0,44.0,42.0,48.0,37.0,1
1022,92:69:1D:31:68:E9,3851094,488822763,4051,3653389,3847043,485169374,1,5413,1158698,5242,1119845,171,38853,2205,12,4305,103,1,62,216660.0,130000.0,-50.0,-50.0,-47.0,-47.0,-51.0,-48.0,-45.0,-47.0,-87.0,-87.0,-84.0,-84.0,37.0,37.0,37.0,37.0,1
1023,CC:2F:71:3F:1F:24,5036574,1849309756,1189531,1364140382,3847043,485169374,1730,996411,1129345369,995570,1129243573,841,101796,963678,15,1188156,121133,1727,784,130000.0,43333.0,-70.0,-70.0,-65.0,-70.0,-70.0,-70.0,-65.0,-69.0,-87.0,-87.0,-84.0,-84.0,17.0,17.0,19.0,14.0,1
1024,CC:2F:71:3E:C5:1F,3848032,485290085,988,120649,3847044,485169436,2,4290,358035,3569,272427,721,85608,1047,13,1421,28,2,54,130000.0,39000.0,-72.0,-71.0,-69.0,-60.0,-72.0,-71.0,-69.0,-60.0,-87.0,-87.0,-84.0,-84.0,15.0,16.0,15.0,24.0,1
1025,BA:8C:B9:54:50:24,3851975,491363442,4931,6194006,3847044,485169436,7,9767,1752670,9745,1749175,22,3495,2358,17,5435,41,7,71,216660.0,130000.0,-48.0,-35.0,-42.0,-45.0,-43.0,-35.0,-43.0,-47.0,-87.0,-87.0,-84.0,-84.0,39.0,52.0,42.0,39.0,1
1026,62:47:05:9D:EB:15,3853800,497352666,6752,12182826,3847048,485169840,1,6992,3803989,6942,3796331,50,7658,3317,0,6819,56,1,125,216660.0,130000.0,-43.0,-45.0,-36.0,-47.0,-44.0,-46.0,-38.0,-47.0,-87.0,-87.0,-84.0,-84.0,44.0,42.0,48.0,37.0,1
1027,92:69:1D:31:68:E9,3851099,488823229,4051,3653389,3847048,485169840,1,5413,1158698,5242,1119845,171,38853,2205,12,4305,103,1,62,216660.0,130000.0,-50.0,-50.0,-47.0,-47.0,-51.0,-48.0,-45.0,-47.0,-87.0,-87.0,-84.0,-84.0,37.0,37.0,37.0,37.0,1
1028,CC:2F:71:3F:1F:24,5036787,1849576734,1189739,1364406894,3847048,485169840,1730,996605,1129604879,995763,1129502965,842,101914,963866,15,1188364,121133,1727,785,130000.0,43333.0,-70.0,-70.0,-65.0,-70.0,-69.0,-70.0,-65.0,-70.0,-87.0,-87.0,-84.0,-84.0,17.0,17.0,19.0,14.0,1
1029,CC:2F:71:3E:C5:1F,3848036,485290489,988,120649,3847048,485169840,2,4290,358035,3569,272427,721,85608,1047,13,1421,28,2,54,130000.0,39000.0,-72.0,-71.0,-69.0,-60.0,-72.0,-71.0,-69.0,-60.0,-87.0,-87.0,-84.0,-84.0,15.0,16.0,15.0,24.0,1
1030,BA:8C:B9:54:50:24,3851979,491363846,4931,6194006,3847048,485169840,7,9767,1752670,9745,1749175,22,3495,2358,17,5435,41,7,71,216660.0,130000.0,-48.0,-35.0,-42.0,-45.0,-43.0,-35.0,-43.0,-47.0,-87.0,-87.0,-84.0,-84.0,39.0,52.0,42.0,39.0,1
1031,62:47:05:9D:EB:15,3853805,497353130,6752,12182826,3847053,485170304,1,6992,3803989,6942,3796331,50,7658,3317,0,6819,56,1,125,216660.0,130000.0,-43.0,-45.0,-36.0,-47.0,-44.0,-46.0,-38.0,-47.0,-87.0,-87.0,-84.0,-84.0,44.0,42.0,48.0,37.0,1
1032,92:69:1D:31:68:E9,3851104,488823693,4051,3653389,3847053,485170304,1,5413,1158698,5242,1119845,171,38853,2205,12,4305,103,1,62,216660.0,130000.0,-50.0,-50.0,-47.0,-47.0,-51.0,-48.0,-45.0,-47.0,-87.0,-87.0,-84.0,-84.0,37.0,37.0,37.0,37.0,1
1033,CC:2F:71:3F:1F:24,5036984,1849818606,1189931,1364648302,3847053,485170304,1730,996780,1129837687,995938,1129735773,842,101914,964034,15,1188556,121141,1727,785,117000.0,39000.0,-70.0,-70.0,-65.0,-70.0,-70.0,-70.0,-65.0,-70.0,-87.0,-87.0,-84.0,-84.0,17.0,17.0,19.0,14.0,1
1034,CC:2F:71:3E:C5:1F,3848043,485291155,988,120649,3847055,485170506,2,4290,358035,3569,272427,721,85608,1047,13,1421,28,2,54,130000.0,39000.0,-72.0,-71.0,-69.0,-60.0,-72.0,-71.0,-69.0,-60.0,-87.0,-87.0,-84.0,-84.0,15.0,16.0,15.0,24.0,1
1035,BA:8C:B9:54:50:24,3851986,491364512,4931,6194006,3847055,485170506,7,9767,1752670,9745,1749175,22,3495,2358,17,5435,41,7,71,216660.0,130000.0,-48.0,-35.0,-42.0,-45.0,-43.0,-35.0,-43.0,-47.0,-87.0,-87.0,-84.0,-84.0,39.0,52.0,42.0,39.0,1
1036,62:47:05:9D:EB:15,3853809,497353534,6752,12182826,3847057,485170708,1,6992,3803989,6942,3796331,50,7658,3317,0,6819,56,1,125,216660.0,130000.0,-43.0,-45.0,-36.0,-47.0,-44.0,-46.0,-38.0,-47.0,-87.0,-87.0,-84.0,-84.0,44.0,42.0,48.0,37.0,1
1037,92:69:1D:31:68:E9,3851108,488824097,4051,3653389,3847057,485170708,1,5413,1158698,5242,1119845,171,38853,2205,12,4305,103,1,62,216660.0,130000.0,-50.0,-50.0,-47.0,-47.0,-51.0,-48.0,-45.0,-47.0,-87.0,-87.0,-84.0,-84.0,37.0,37.0,37.0,37.0,1
1038,CC:2F:71:3F:1F:24,5037187,1850066737,1190130,1364896029,3847057,485170708,1730,996960,1130072863,996118,1129970949,842,101914,964213,15,1188755,121141,1727,785,130000.0,43333.0,-70.0,-70.0,-65.0,-70.0,-69.0,-70.0,-65.0,-70.0,-87.0,-87.0,-84.0,-84.0,17.0,17.0,19.0,14.0,1
1039,CC:2F:71:3E:C5:1F,3848045,485291357,988,120649,3847057,485170708,2,4290,358035,3569,272427,721,85608,1047,13,1421,28,2,54,130000.0,39000.0,-72.0,-71.0,-69.0,-60.0,-72.0,-71.0,-69.0,-60.0,-87.0,-87.0,-84.0,-84.0,15.0,16.0,15.0,24.0,1
1040,BA:8C:B9:54:50:24,3851988,491364714,4931,6194006,3847057,485170708,7,9767,1752670,9745,1749175,22,3495,2358,17,5435,41,7,71,216660.0,130000.0,-48.0,-35.0,-42.0,-45.0,-43.0,-35.0,-43.0,-47.0,-87.0,-87.0,-84.0,-84.0,39.0,52.0,42.0,39.0,1
1041,62:47:05:9D:EB:15,3853813,497353938,6752,12182826,3847061,485171112,1,6992,3803989,6942,3796331,50,7658,3317,0,6819,56,1,125,216660.0,130000.0,-43.0,-45.0,-36.0,-47.0,-44.0,-46.0,-38.0,-47.0,-87.0,-87.0,-84.0,-84.0,44.0,42.0,48.0,37.0,1
1042,92:69:1D:31:68:E9,3851112,488824501,4051,3653389,3847061,485171112,1,5413,1158698,5242,1119845,171,38853,2205,12,4305,103,1,62,216660.0,130000.0,-50.0,-50.0,-47.0,-47.0,-51.0,-48.0,-45.0,-47.0,-87.0,-87.0,-84.0,-84.0,37.0,37.0,37.0,37.0,1
1043,CC:2F:71:3F:1F:24,5037384,1850308733,1190321,1365137419,3847063,485171314,1730,997137,1130308757,996295,1130206843,842,101914,964383,15,1188946,121141,1727,785,130000.0,43333.0,-70.0,-70.0,-66.0,-70.0,-70.0,-70.0,-66.0,-70.0,-87.0,-87.0,-84.0,-84.0,17.0,17.0,18.0,14.0,1
1044,CC:2F:71:3E:C5:1F,3848051,485291963,988,120649,3847063,485171314,2,4290,358035,3569,272427,721,85608,1047,13,1421,28,2,54,130000.0,39000.0,-72.0,-71.0,-69.0,-60.0,-72.0,-71.0,-69.0,-60.0,-87.0,-87.0,-84.0,-84.0,15.0,16.0,15.0,24.0,1
1045,BA:8C:B9:54:50:24,3851995,491365380,4931,6194006,3847064,485171374,7,9767,1752670,9745,1749175,22,3495,2358,17,5435,41,7,71,216660.0,130000.0,-48.0,-35.0,-42.0,-45.0,-43.0,-35.0,-43.0,-47.0,-87.0,-87.0,-84.0,-84.0,39.0,52.0,42.0,39.0,1
1046,62:47:05:9D:EB:15,3853818,497354402,6752,12182826,3847066,485171576,1,6992,3803989,6942,3796331,50,7658,3317,0,6819,56,1,125,216660.0,130000.0,-43.0,-45.0,-36.0,-47.0,-44.0,-46.0,-38.0,-47.0,-87.0,-86.0,-83.0,-84.0,44.0,41.0,47.0,37.0,1
1047,92:69:1D:31:68:E9,3851117,488824965,4051,3653389,3847066,485171576,1,5413,1158698,5242,1119845,171,38853,2205,12,4305,103,1,62,216660.0,130000.0,-50.0,-50.0,-47.0,-47.0,-51.0,-48.0,-45.0,-47.0,-87.0,-86.0,-83.0,-84.0,37.0,36.0,36.0,37.0,1
1048,CC:2F:71:3F:1F:24,5037579,1850553139,1190513,1365381563,3847066,485171576,1730,997306,1130536667,996464,1130434753,842,101914,964551,15,1189138,121146,1727,785,130000.0,43333.0,-70.0,-70.0,-65.0,-70.0,-70.0,-70.0,-65.0,-70.0,-87.0,-86.0,-83.0,-84.0,17.0,16.0,18.0,14.0,1
1049,CC:2F:71:3E:C5:1F,3848054,485292225,988,120649,3847066,485171576,2,4290,358035,3569,272427,721,85608,1047,13,1421,28,2,54,130000.0,39000.0,-72.0,-71.0,-69.0,-60.0,-72.0,-71.0,-69.0,-60.0,-87.0,-86.0,-83.0,-84.0,15.0,15.0,14.0,24.0,1
1050,BA:8C:B9:54:50:24,3851999,491365784,4931,6194006,3847068,485171778,7,9767,1752670,9745,1749175,22,3495,2358,17,5435,41,7,71,216660.0,130000.0,-48.0,-35.0,-42.0,-45.0,-43.0,-35.0,-43.0,-47.0,-87.0,-86.0,-83.0,-84.0,39.0,51.0,41.0,39.0,1
1051,62:47:05:9D:EB:15,3853824,497355008,6752,12182826,3847072,485172182,1,6992,3803989,6942,3796331,50,7658,3317,0,6819,56,1,125,216660.0,130000.0,-43.0,-45.0,-36.0,-47.0,-44.0,-46.0,-38.0,-47.0,-87.0,-86.0,-83.0,-84.0,44.0,41.0,47.0,37.0,1
1052,92:69:1D:31:68:E9,3851123,488825571,4051,3653389,3847072,485172182,1,5413,1158698,5242,1119845,171,38853,2205,12,4305,103,1,62,216660.0,130000.0,-50.0,-50.0,-47.0,-47.0,-51.0,-48.0,-45.0,-47.0,-87.0,-86.0,-83.0,-84.0,37.0,36.0,36.0,37.0,1
1053,CC:2F:71:3F:1F:24,5037776,1850795135,1190704,1365622953,3847072,485172182,1730,997479,1130769193,996637,1130667279,842,101914,964721,15,1189329,121146,1727,785,130000.0,43333.0,-70.0,-70.0,-66.0,-71.0,-70.0,-70.0,-66.0,-70.0,-87.0,-86.0,-83.0,-84.0,17.0,16.0,17.0,13.0,1
1054,CC:2F:71:3E:C5:1F,3848060,485292831,988,120649,3847072,485172182,2,4290,358035,3569,272427,721,85608,1047,13,1421,28,2,54,130000.0,39000.0,-72.0,-71.0,-69.0,-60.0,-72.0,-71.0,-69.0,-60.0,-87.0,-86.0,-83.0,-84.0,15.0,15.0,14.0,24.0,1
1055,BA:8C:B9:54:50:24,3852003,491366188,4931,6194006,3847072,485172182,7,9767,1752670,9745,1749175,22,3495,2358,17,5435,41,7,71,216660.0,130000.0,-48.0,-35.0,-42.0,-45.0,-43.0,-35.0,-43.0,-47.0,-87.0,-86.0,-83.0,-84.0,39.0,51.0,41.0,39.0,1
1056,62:47:05:9D:EB:15,3853827,497355270,6752,12182826,3847075,485172444,1,6992,3803989,6942,3796331,50,7658,3317,0,6819,56,1,125,216660.0,130000.0,-43.0,-45.0,-36.0,-47.0,-44.0,-46.0,-38.0,-47.0,-87.0,-86.0,-83.0,-84.0,44.0,41.0,47.0,37.0,1
1057,92:69:1D:31:68:E9,3851126,488825833,4051,3653389,3847075,485172444,1,5413,1158698,5242,1119845,171,38853,2205,12,4305,103,1,62,216660.0,130000.0,-50.0,-50.0,-47.0,-47.0,-51.0,-48.0,-45.0,-47.0,-87.0,-86.0,-83.0,-84.0,37.0,36.0,36.0,37.0,1
1058,CC:2F:71:3F:1F:24,5037980,1851040654,1190905,1365868210,3847075,485172444,1730,997663,1131003574,996821,1130901660,842,101914,964899,15,1189530,121146,1727,785,130000.0,39000.0,-70.0,-69.0,-66.0,-70.0,-70.0,-69.0,-65.0,-70.0,-87.0,-86.0,-83.0,-84.0,17.0,17.0,17.0,14.0,1
1059,CC:2F:71:3E:C5:1F,3848065,485293295,988,120649,3847077,485172646,2,4292,358175,3571,272567,721,85608,1047,13,1422,28,2,54,130000.0,39000.0,-71.0,-70.0,-69.0,-60.0,-72.0,-70.0,-69.0,-60.0,-87.0,-86.0,-83.0,-84.0,16.0,16.0,14.0,24.0,1
1060,BA:8C:B9:54:50:24,3852008,491366652,4931,6194006,3847077,485172646,7,9769,1752806,9747,1749311,22,3495,2358,17,5436,41,7,71,216660.0,130000.0,-48.0,-35.0,-42.0,-45.0,-44.0,-35.0,-43.0,-47.0,-87.0,-86.0,-83.0,-84.0,39.0,51.0,41.0,39.0,1
1061,62:47:05:9D:EB:15,3853833,497355876,6752,12182826,3847081,485173050,1,6994,3804125,6944,3796467,50,7658,3317,0,6820,56,1,125,216660.0,130000.0,-44.0,-45.0,-37.0,-49.0,-44.0,-45.0,-37.0,-48.0,-87.0,-86.0,-83.0,-84.0,43.0,41.0,46.0,35.0,1
1062,92:69:1D:31:68:E9,3851132,488826439,4051,3653389,3847081,485173050,1,5415,1158834,5244,1119981,171,38853,2205,12,4306,103,1,62,216660.0,130000.0,-52.0,-47.0,-43.0,-49.0,-51.0,-48.0,-44.0,-47.0,-87.0,-86.0,-83.0,-84.0,35.0,39.0,40.0,35.0,1
1063,CC:2F:71:3F:1F:24,5038179,1851284222,1191098,1366111172,3847081,485173050,1730,997845,1131245814,997003,1131143900,842,101914,965069,15,1189723,121148,1727,785,144444.0,43333.0,-70.0,-70.0,-66.0,-71.0,-70.0,-70.0,-66.0,-71.0,-87.0,-86.0,-83.0,-84.0,17.0,16.0,17.0,13.0,1
1064,CC:2F:71:3E:C5:1F,3848069,485293699,988,120649,3847081,485173050,2,4292,358175,3571,272567,721,85608,1047,13,1422,28,2,54,130000.0,39000.0,-71.0,-70.0,-69.0,-60.0,-72.0,-70.0,-69.0,-60.0,-87.0,-86.0,-83.0,-84.0,16.0,16.0,14.0,24.0,1
1065,BA:8C:B9:54:50:24,3852012,491367056,4931,6194006,3847081,485173050,7,9769,1752806,9747,1749311,22,3495,2358,17,5436,41,7,71,216660.0,130000.0,-48.0,-35.0,-42.0,-45.0,-44.0,-35.0,-43.0,-47.0,-87.0,-86.0,-83.0,-84.0,39.0,51.0,41.0,39.0,1
1066,62:47:05:9D:EB:15,3853835,497356078,6752,12182826,3847083,485173252,1,6994,3804125,6944,3796467,50,7658,3317,0,6820,56,1,125,216660.0,130000.0,-44.0,-45.0,-37.0,-49.0,-44.0,-45.0,-37.0,-48.0,-87.0,-86.0,-83.0,-84.0,43.0,41.0,46.0,35.0,1
1067,92:69:1D:31:68:E9,3851134,488826641,4051,3653389,3847083,485173252,1,5415,1158834,5244,1119981,171,38853,2205,12,4306,103,1,62,216660.0,130000.0,-52.0,-47.0,-43.0,-49.0,-51.0,-48.0,-44.0,-47.0,-87.0,-86.0,-83.0,-84.0,35.0,39.0,40.0,35.0,1
1068,CC:2F:71:3F:1F:24,5038374,1851526016,1191289,1366352562,3847085,485173454,1730,998023,1131481858,997181,1131379944,842,101914,965241,15,1189914,121149,1727,785,144444.0,43333.0,-70.0,-70.0,-66.0,-71.0,-70.0,-70.0,-66.0,-71.0,-87.0,-86.0,-83.0,-84.0,17.0,16.0,17.0,13.0,1
1069,CC:2F:71:3E:C5:1F,3848073,485294103,988,120649,3847085,485173454,2,4292,358175,3571,272567,721,85608,1047,13,1422,28,2,54,130000.0,39000.0,-71.0,-70.0,-69.0,-60.0,-72.0,-70.0,-69.0,-60.0,-87.0,-86.0,-83.0,-84.0,16.0,16.0,14.0,24.0,1
1070,BA:8C:B9:54:50:24,3852019,491367722,4931,6194006,3847088,485173716,7,9769,1752806,9747,1749311,22,3495,2358,17,5436,41,7,71,216660.0,130000.0,-48.0,-35.0,-42.0,-45.0,-44.0,-35.0,-43.0,-47.0,-87.0,-86.0,-83.0,-84.0,39.0,51.0,41.0,39.0,1
1071,62:47:05:9D:EB:15,3853844,497357868,6752,12182826,3847092,485175042,1,6994,3804125,6944,3796467,50,7658,3317,0,6820,56,1,125,216660.0,130000.0,-44.0,-45.0,-37.0,-49.0,-44.0,-45.0,-37.0,-48.0,-87.0,-87.0,-83.0,-84.0,43.0,42.0,46.0,35.0,1
1072,92:69:1D:31:68:E9,3851143,488828431,4051,3653389,3847092,485175042,1,5415,1158834,5244,1119981,171,38853,2205,12,4306,103,1,62,216660.0,130000.0,-52.0,-47.0,-43.0,-49.0,-51.0,-48.0,-44.0,-47.0,-87.0,-87.0,-83.0,-84.0,35.0,40.0,40.0,35.0,1
1073,CC:2F:71:3F:1F:24,5038579,1851773889,1191487,1366598847,3847092,485175042,1730,998204,1131717194,997362,1131615280,842,101914,965418,15,1190112,121149,1727,785,144444.0,43333.0,-70.0,-70.0,-66.0,-72.0,-70.0,-70.0,-66.0,-71.0,-87.0,-87.0,-83.0,-84.0,17.0,17.0,17.0,12.0,1
1074,CC:2F:71:3E:C5:1F,3848080,485295691,988,120649,3847092,485175042,2,4292,358175,3571,272567,721,85608,1047,13,1422,28,2,54,130000.0,39000.0,-71.0,-70.0,-69.0,-60.0,-72.0,-70.0,-69.0,-60.0,-87.0,-87.0,-83.0,-84.0,16.0,17.0,14.0,24.0,1
1075,BA:8C:B9:54:50:24,3852025,491369250,4931,6194006,3847094,485175244,7,9769,1752806,9747,1749311,22,3495,2358,17,5436,41,7,71,216660.0,130000.0,-48.0,-35.0,-42.0,-45.0,-44.0,-35.0,-43.0,-47.0,-87.0,-87.0,-83.0,-84.0,39.0,52.0,41.0,39.0,1
1076,62:47:05:9D:EB:15,3853849,497358545,6752,12182826,3847097,485175719,1,6994,3804125,6944,3796467,50,7658,3317,0,6820,56,1,125,216660.0,130000.0,-44.0,-45.0,-37.0,-49.0,-44.0,-45.0,-37.0,-48.0,-87.0,-87.0,-83.0,-84.0,43.0,42.0,46.0,35.0,1
1077,92:69:1D:31:68:E9,3851148,488829108,4051,3653389,3847097,485175719,1,5415,1158834,5244,1119981,171,38853,2205,12,4306,103,1,62,216660.0,130000.0,-52.0,-47.0,-43.0,-49.0,-51.0,-48.0,-44.0,-47.0,-87.0,-87.0,-83.0,-84.0,35.0,40.0,40.0,35.0,1
1078,CC:2F:71:3F:1F:24,5038778,1852016288,1191679,1366840367,3847099,485175921,1730,998381,1131948930,997539,1131847016,842,101914,965589,15,1190304,121155,1727,785,144444.0,43333.0,-70.0,-70.0,-66.0,-70.0,-70.0,-70.0,-65.0,-70.0,-87.0,-87.0,-83.0,-84.0,17.0,17.0,17.0,14.0,1
1079,CC:2F:71:3E:C5:1F,3848087,485296570,988,120649,3847099,485175921,2,4292,358175,3571,272567,721,85608,1047,13,1422,28,2,54,130000.0,39000.0,-71.0,-70.0,-69.0,-60.0,-72.0,-70.0,-69.0,-60.0,-87.0,-87.0,-83.0,-84.0,16.0,17.0,14.0,24.0,1
1080,BA:8C:B9:54:50:24,3852032,491371051,4931,6194006,3847101,485177045,7,9769,1752806,9747,1749311,22,3495,2358,17,5436,41,7,71,216660.0,130000.0,-48.0,-35.0,-42.0,-45.0,-44.0,-35.0,-43.0,-47.0,-87.0,-87.0,-83.0,-84.0,39.0,52.0,41.0,39.0,1
1081,62:47:05:9D:EB:15,3853856,497360133,6752,12182826,3847104,485177307,1,6994,3804125,6944,3796467,50,7658,3317,0,6820,56,1,125,216660.0,130000.0,-44.0,-45.0,-37.0,-49.0,-44.0,-45.0,-37.0,-48.0,-87.0,-87.0,-83.0,-84.0,43.0,42.0,46.0,35.0,1
1082,92:69:1D:31:68:E9,3851155,488830696,4051,3653389,3847104,485177307,1,5415,1158834,5244,1119981,171,38853,2205,12,4306,103,1,62,216660.0,130000.0,-52.0,-47.0,-43.0,-49.0,-51.0,-48.0,-44.0,-47.0,-87.0,-87.0,-83.0,-84.0,35.0,40.0,40.0,35.0,1
1083,CC:2F:71:3F:1F:24,5038978,1852259565,1191872,1367082056,3847106,485177509,1730,998562,1132186801,997720,1132084887,842,101914,965763,15,1190497,121181,1727,786,144444.0,43333.0,-71.0,-70.0,-66.0,-71.0,-70.0,-70.0,-66.0,-70.0,-87.0,-86.0,-83.0,-84.0,16.0,16.0,17.0,13.0,1
1084,CC:2F:71:3E:C5:1F,3848094,485298158,988,120649,3847106,485177509,2,4292,358175,3571,272567,721,85608,1047,13,1422,28,2,54,130000.0,39000.0,-71.0,-70.0,-69.0,-60.0,-72.0,-70.0,-69.0,-60.0,-87.0,-86.0,-83.0,-84.0,16.0,16.0,14.0,24.0,1
1085,BA:8C:B9:54:50:24,3852037,491371515,4931,6194006,3847106,485177509,7,9769,1752806,9747,1749311,22,3495,2358,17,5436,41,7,71,216660.0,130000.0,-48.0,-35.0,-42.0,-45.0,-44.0,-35.0,-43.0,-47.0,-87.0,-86.0,-83.0,-84.0,39.0,51.0,41.0,39.0,1
1086,62:47:05:9D:EB:15,3853860,497360537,6752,12182826,3847108,485177711,1,6994,3804125,6944,3796467,50,7658,3317,0,6820,56,1,125,216660.0,130000.0,-44.0,-45.0,-37.0,-49.0,-44.0,-45.0,-37.0,-48.0,-87.0,-86.0,-83.0,-84.0,43.0,41.0,46.0,35.0,1
1087,92:69:1D:31:68:E9,3851161,488831302,4051,3653389,3847110,485177913,1,5415,1158834,5244,1119981,171,38853,2205,12,4306,103,1,62,216660.0,130000.0,-52.0,-47.0,-43.0,-49.0,-51.0,-48.0,-44.0,-47.0,-87.0,-86.0,-83.0,-84.0,35.0,39.0,40.0,35.0,1
1088,CC:2F:71:3F:1F:24,5039172,1852501229,1192062,1367323316,3847110,485177913,1730,998738,1132424097,997896,1132322183,842,101914,965931,15,1190687,121181,1727,786,144444.0,43333.0,-71.0,-70.0,-66.0,-71.0,-71.0,-69.0,-65.0,-71.0,-87.0,-86.0,-83.0,-84.0,16.0,16.0,17.0,13.0,1
1089,CC:2F:71:3E:C5:1F,3848100,485299686,988,120649,3847112,485179037,2,4292,358175,3571,272567,721,85608,1047,13,1422,28,2,54,130000.0,39000.0,-71.0,-70.0,-69.0,-60.0,-72.0,-70.0,-69.0,-60.0,-87.0,-86.0,-83.0,-84.0,16.0,16.0,14.0,24.0,1
1090,BA:8C:B9:54:50:24,3852043,491373043,4931,6194006,3847112,485179037,7,9769,1752806,9747,1749311,22,3495,2358,17,5436,41,7,71,216660.0,130000.0,-48.0,-35.0,-42.0,-45.0,-44.0,-35.0,-43.0,-47.0,-87.0,-86.0,-83.0,-84.0,39.0,51.0,41.0,39.0,1
1091,62:47:05:9D:EB:15,3853866,497362065,6752,12182826,3847114,485179239,1,6994,3804125,6944,3796467,50,7658,3317,0,6820,56,1,125,216660.0,130000.0,-44.0,-45.0,-37.0,-49.0,-44.0,-45.0,-37.0,-48.0,-87.0,-86.0,-83.0,-84.0,43.0,41.0,46.0,35.0,1
1092,92:69:1D:31:68:E9,3851167,488832830,4051,3653389,3847116,485179441,1,5415,1158834,5244,1119981,171,38853,2205,12,4306,103,1,62,216660.0,130000.0,-52.0,-47.0,-43.0,-49.0,-51.0,-48.0,-44.0,-47.0,-87.0,-86.0,-83.0,-84.0,35.0,39.0,40.0,35.0,1
1093,CC:2F:71:3F:1F:24,5039375,1852747488,1192259,1367568047,3847116,485179441,1730,998920,1132658139,998078,1132556225,842,101914,966108,15,1190884,121182,1727,786,144444.0,43333.0,-71.0,-70.0,-65.0,-72.0,-71.0,-69.0,-65.0,-71.0,-87.0,-86.0,-83.0,-84.0,16.0,16.0,18.0,12.0,1
1094,CC:2F:71:3E:C5:1F,3848104,485300090,988,120649,3847116,485179441,2,4292,358175,3571,272567,721,85608,1047,13,1422,28,2,54,130000.0,39000.0,-71.0,-70.0,-69.0,-60.0,-72.0,-70.0,-69.0,-60.0,-87.0,-86.0,-83.0,-84.0,16.0,16.0,14.0,24.0,1
1095,BA:8C:B9:54:50:24,3852048,491373507,4931,6194006,3847117,485179501,7,9769,1752806,9747,1749311,22,3495,2358,17,5436,41,7,71,216660.0,130000.0,-48.0,-35.0,-42.0,-45.0,-44.0,-35.0,-43.0,-47.0,-87.0,-86.0,-83.0,-84.0,39.0,51.0,41.0,39.0,1
1096,62:47:05:9D:EB:15,3853873,497362731,6752,12182826,3847121,485179905,1,6994,3804125,6944,3796467,50,7658,3317,0,6820,56,1,125,216660.0,130000.0,-44.0,-45.0,-37.0,-49.0,-44.0,-45.0,-37.0,-48.0,-87.0,-86.0,-83.0,-84.0,43.0,41.0,46.0,35.0,1
1097,92:69:1D:31:68:E9,3851172,488833294,4051,3653389,3847121,485179905,1,5415,1158834,5244,1119981,171,38853,2205,12,4306,103,1,62,216660.0,130000.0,-52.0,-47.0,-43.0,-49.0,-51.0,-48.0,-44.0,-47.0,-87.0,-86.0,-83.0,-84.0,35.0,39.0,40.0,35.0,1
1098,CC:2F:71:3F:1F:24,5039570,1852989212,1192449,1367809307,3847121,485179905,1730,999110,1132907279,998268,1132805365,842,101914,966280,15,1191074,121183,1727,786,144444.0,43333.0,-71.0,-70.0,-66.0,-71.0,-71.0,-70.0,-65.0,-71.0,-87.0,-86.0,-83.0,-84.0,16.0,16.0,17.0,13.0,1
1099,CC:2F:71:3E:C5:1F,3848109,485300554,988,120649,3847121,485179905,2,4292,358175,3571,272567,721,85608,1047,13,1422,28,2,54,130000.0,39000.0,-71.0,-70.0,-69.0,-60.0,-72.0,-70.0,-69.0,-60.0,-87.0,-86.0,-83.0,-84.0,16.0,16.0,14.0,24.0,1
1100,BA:8C:B9:54:50:24,3852052,491373911,4931,6194006,3847121,485179905,7,9769,1752806,9747,1749311,22,3495,2358,17,5436,41,7,71,216660.0,130000.0,-48.0,-35.0,-42.0,-45.0,-44.0,-35.0,-43.0,-47.0,-87.0,-86.0,-83.0,-84.0,39.0,51.0,41.0,39.0,1
1101,62:47:05:9D:EB:15,3853877,497363135,6752,12182826,3847125,485180309,1,6994,3804125,6944,3796467,50,7658,3317,0,6820,56,1,125,216660.0,130000.0,-44.0,-45.0,-37.0,-49.0,-44.0,-45.0,-37.0,-48.0,-87.0,-86.0,-83.0,-84.0,43.0,41.0,46.0,35.0,1
1102,92:69:1D:31:68:E9,3851176,488833698,4051,3653389,3847125,485180309,1,5415,1158834,5244,1119981,171,38853,2205,12,4306,103,1,62,216660.0,130000.0,-52.0,-47.0,-43.0,-49.0,-51.0,-48.0,-44.0,-47.0,-87.0,-86.0,-83.0,-84.0,35.0,39.0,40.0,35.0,1
1103,CC:2F:71:3F:1F:24,5039767,1853234114,1192642,1368053805,3847125,485180309,1730,999288,1133143341,998446,1133041427,842,101914,966453,15,1191267,121184,1727,786,144444.0,43333.0,-71.0,-70.0,-66.0,-71.0,-70.0,-69.0,-65.0,-71.0,-87.0,-86.0,-83.0,-84.0,16.0,16.0,17.0,13.0,1
1104,CC:2F:71:3E:C5:1F,3848113,485300958,988,120649,3847125,485180309,2,4292,358175,3571,272567,721,85608,1047,13,1422,28,2,54,130000.0,39000.0,-71.0,-70.0,-69.0,-60.0,-72.0,-70.0,-69.0,-60.0,-87.0,-86.0,-83.0,-84.0,16.0,16.0,14.0,24.0,1
1105,BA:8C:B9:54:50:24,3852056,491374315,4931,6194006,3847125,485180309,7,9769,1752806,9747,1749311,22,3495,2358,17,5436,41,7,71,216660.0,130000.0,-48.0,-35.0,-42.0,-45.0,-44.0,-35.0,-43.0,-47.0,-87.0,-86.0,-83.0,-84.0,39.0,51.0,41.0,39.0,1
1106,62:47:05:9D:EB:15,3853882,497363599,6752,12182826,3847130,485180773,1,6994,3804125,6944,3796467,50,7658,3317,0,6820,56,1,125,216660.0,130000.0,-44.0,-45.0,-37.0,-49.0,-44.0,-45.0,-37.0,-48.0,-87.0,-86.0,-83.0,-84.0,43.0,41.0,46.0,35.0,1
1107,92:69:1D:31:68:E9,3851181,488834162,4051,3653389,3847130,485180773,1,5416,1158902,5245,1120049,171,38853,2205,12,4306,103,1,62,216660.0,130000.0,-51.0,-47.0,-44.0,-45.0,-51.0,-48.0,-44.0,-47.0,-87.0,-86.0,-83.0,-84.0,36.0,39.0,39.0,39.0,1
1108,CC:2F:71:3F:1F:24,5039966,1853477754,1192836,1368296981,3847130,485180773,1730,999465,1133373511,998623,1133271597,842,101914,966627,15,1191461,121185,1727,786,144444.0,43333.0,-71.0,-70.0,-65.0,-71.0,-71.0,-70.0,-65.0,-71.0,-87.0,-86.0,-83.0,-84.0,16.0,16.0,18.0,13.0,1
1109,CC:2F:71:3E:C5:1F,3848118,485301422,988,120649,3847130,485180773,2,4292,358175,3571,272567,721,85608,1047,13,1422,28,2,54,130000.0,39000.0,-71.0,-70.0,-69.0,-60.0,-72.0,-70.0,-69.0,-60.0,-87.0,-86.0,-83.0,-84.0,16.0,16.0,14.0,24.0,1
1110,BA:8C:B9:54:50:24,3852061,491374779,4931,6194006,3847130,485180773,7,9769,1752806,9747,1749311,22,3495,2358,17,5436,41,7,71,216660.0,130000.0,-48.0,-35.0,-42.0,-45.0,-44.0,-35.0,-43.0,-47.0,-87.0,-86.0,-83.0,-84.0,39.0,51.0,41.0,39.0,1
1111,62:47:05:9D:EB:15,3853886,497364003,6752,12182826,3847134,485181177,1,6994,3804125,6944,3796467,50,7658,3317,0,6820,56,1,125,216660.0,130000.0,-44.0,-45.0,-37.0,-49.0,-44.0,-45.0,-37.0,-48.0,-87.0,-86.0,-83.0,-84.0,43.0,41.0,46.0,35.0,1
1112,92:69:1D:31:68:E9,3851185,488834566,4051,3653389,3847134,485181177,1,5416,1158902,5245,1120049,171,38853,2205,12,4306,103,1,62,216660.0,130000.0,-51.0,-47.0,-44.0,-45.0,-51.0,-48.0,-44.0,-47.0,-87.0,-86.0,-83.0,-84.0,36.0,39.0,39.0,39.0,1
1113,CC:2F:71:3F:1F:24,5040169,1853724573,1193035,1368543396,3847134,485181177,1730,999648,1133609079,998806,1133507165,842,101914,966806,15,1191660,121186,1727,786,144444.0,43333.0,-71.0,-70.0,-65.0,-72.0,-70.0,-70.0,-65.0,-71.0,-87.0,-86.0,-83.0,-84.0,16.0,16.0,18.0,12.0,1
1114,CC:2F:71:3E:C5:1F,3848122,485301826,988,120649,3847134,485181177,2,4292,358175,3571,272567,721,85608,1047,13,1422,28,2,54,130000.0,39000.0,-71.0,-70.0,-69.0,-60.0,-72.0,-70.0,-69.0,-60.0,-87.0,-86.0,-83.0,-84.0,16.0,16.0,14.0,24.0,1
1115,BA:8C:B9:54:50:24,3852065,491375183,4931,6194006,3847134,485181177,7,9769,1752806,9747,1749311,22,3495,2358,17,5436,41,7,71,216660.0,130000.0,-48.0,-35.0,-42.0,-45.0,-44.0,-35.0,-43.0,-47.0,-87.0,-86.0,-83.0,-84.0,39.0,51.0,41.0,39.0,1
1116,62:47:05:9D:EB:15,3853890,497364407,6752,12182826,3847138,485181581,1,6994,3804125,6944,3796467,50,7658,3317,0,6820,56,1,125,216660.0,130000.0,-44.0,-45.0,-37.0,-49.0,-44.0,-45.0,-37.0,-48.0,-87.0,-86.0,-83.0,-84.0,43.0,41.0,46.0,35.0,1
1117,92:69:1D:31:68:E9,3851189,488834970,4051,3653389,3847138,485181581,1,5416,1158902,5245,1120049,171,38853,2205,12,4306,103,1,62,216660.0,130000.0,-51.0,-47.0,-44.0,-45.0,-51.0,-48.0,-44.0,-47.0,-87.0,-86.0,-83.0,-84.0,36.0,39.0,39.0,39.0,1
1118,CC:2F:71:3F:1F:24,5040364,1853966363,1193225,1368784656,3847139,485181707,1730,999820,1133841455,998978,1133739541,842,101914,966974,15,1191850,121187,1727,786,144444.0,43333.0,-70.0,-70.0,-66.0,-72.0,-70.0,-69.0,-65.0,-71.0,-87.0,-86.0,-83.0,-84.0,17.0,16.0,17.0,12.0,1
1119,CC:2F:71:3E:C5:1F,3848127,485302356,988,120649,3847139,485181707,2,4292,358175,3571,272567,721,85608,1047,13,1422,28,2,54,130000.0,39000.0,-71.0,-70.0,-69.0,-60.0,-72.0,-70.0,-69.0,-60.0,-87.0,-86.0,-83.0,-84.0,16.0,16.0,14.0,24.0,1
1120,BA:8C:B9:54:50:24,3852070,491375713,4931,6194006,3847139,485181707,7,9769,1752806,9747,1749311,22,3495,2358,17,5436,41,7,71,216660.0,130000.0,-48.0,-35.0,-42.0,-45.0,-44.0,-35.0,-43.0,-47.0,-87.0,-86.0,-83.0,-84.0,39.0,51.0,41.0,39.0,1
1121,62:47:05:9D:EB:15,3853896,497364997,6752,12182826,3847144,485182171,1,6994,3804125,6944,3796467,50,7658,3317,0,6820,56,1,125,216660.0,130000.0,-44.0,-45.0,-37.0,-49.0,-44.0,-45.0,-37.0,-48.0,-87.0,-86.0,-83.0,-84.0,43.0,41.0,46.0,35.0,1
1122,92:69:1D:31:68:E9,3851195,488835560,4051,3653389,3847144,485182171,1,5416,1158902,5245,1120049,171,38853,2205,12,4306,103,1,62,216660.0,130000.0,-51.0,-47.0,-44.0,-45.0,-51.0,-48.0,-44.0,-47.0,-87.0,-86.0,-83.0,-84.0,36.0,39.0,39.0,39.0,1
1123,CC:2F:71:3F:1F:24,5040562,1854208463,1193418,1369026292,3847144,485182171,1730,999997,1134077349,999155,1133975435,842,101914,967144,15,1192043,121188,1727,786,144444.0,43333.0,-71.0,-70.0,-66.0,-70.0,-70.0,-70.0,-66.0,-70.0,-87.0,-86.0,-83.0,-84.0,16.0,16.0,17.0,14.0,1
1124,CC:2F:71:3E:C5:1F,3848133,485302936,989,120765,3847144,485182171,2,4293,358245,3572,272637,721,85608,1047,13,1423,28,2,54,130000.0,39000.0,-73.0,-72.0,-69.0,-60.0,-72.0,-71.0,-69.0,-60.0,-87.0,-86.0,-83.0,-84.0,14.0,14.0,14.0,24.0,1
1125,BA:8C:B9:54:50:24,3852075,491376177,4931,6194006,3847144,485182171,7,9769,1752806,9747,1749311,22,3495,2358,17,5436,41,7,71,216660.0,130000.0,-48.0,-35.0,-42.0,-45.0,-44.0,-35.0,-43.0,-47.0,-87.0,-86.0,-83.0,-84.0,39.0,51.0,41.0,39.0,1
1126,62:47:05:9D:EB:15,3853901,497365517,6753,12182942,3847148,485182575,1,6996,3804261,6946,3796603,50,7658,3317,0,6821,56,1,125,216660.0,130000.0,-45.0,-51.0,-45.0,-45.0,-44.0,-47.0,-39.0,-47.0,-87.0,-86.0,-83.0,-84.0,42.0,35.0,38.0,39.0,1
1127,92:69:1D:31:68:E9,3851200,488836024,4052,3653449,3847148,485182575,1,5418,1159038,5247,1120185,171,38853,2205,12,4307,103,1,62,216660.0,130000.0,-51.0,-48.0,-45.0,-45.0,-51.0,-47.0,-44.0,-46.0,-87.0,-86.0,-83.0,-84.0,36.0,38.0,38.0,39.0,1
1128,CC:2F:71:3F:1F:24,5040757,1854453105,1193609,1369270530,3847148,485182575,1730,1000174,1134317523,999332,1134215609,842,101914,967314,15,1192234,121188,1727,786,144444.0,43333.0,-71.0,-70.0,-66.0,-72.0,-71.0,-70.0,-66.0,-71.0,-87.0,-86.0,-83.0,-84.0,16.0,16.0,17.0,12.0,1
1129,CC:2F:71:3E:C5:1F,3848137,485303340,989,120765,3847148,485182575,2,4294,358315,3573,272707,721,85608,1047,13,1423,28,2,54,130000.0,39000.0,-73.0,-71.0,-69.0,-61.0,-72.0,-71.0,-69.0,-60.0,-87.0,-86.0,-83.0,-84.0,14.0,15.0,14.0,23.0,1
1130,BA:8C:B9:54:50:24,3852080,491376697,4932,6194122,3847148,485182575,7,9771,1752942,9749,1749447,22,3495,2358,17,5437,41,7,71,229410.0,130000.0,-48.0,-35.0,-42.0,-45.0,-44.0,-35.0,-43.0,-47.0,-87.0,-86.0,-83.0,-84.0,39.0,51.0,41.0,39.0,1
1131,62:47:05:9D:EB:15,3853908,497366105,6753,12182942,3847155,485183163,1,6996,3804261,6946,3796603,50,7658,3317,0,6821,56,1,125,216660.0,130000.0,-45.0,-51.0,-45.0,-45.0,-44.0,-47.0,-39.0,-47.0,-87.0,-86.0,-83.0,-84.0,42.0,35.0,38.0,39.0,1
1132,92:69:1D:31:68:E9,3851207,488836612,4052,3653449,3847155,485183163,1,5418,1159038,5247,1120185,171,38853,2205,12,4307,103,1,62,216660.0,130000.0,-51.0,-48.0,-45.0,-45.0,-51.0,-47.0,-44.0,-46.0,-87.0,-86.0,-83.0,-84.0,36.0,38.0,38.0,39.0,1
1133,CC:2F:71:3F:1F:24,5040959,1854696740,1193804,1369513577,3847155,485183163,1730,1000356,1134551609,999513,1134449577,843,102032,967490,15,1192428,121189,1727,786,144444.0,43333.0,-71.0,-70.0,-66.0,-72.0,-71.0,-70.0,-66.0,-71.0,-87.0,-86.0,-83.0,-84.0,16.0,16.0,17.0,12.0,1
1134,CC:2F:71:3E:C5:1F,3848144,485303928,989,120765,3847155,485183163,2,4296,358503,3574,272777,722,85726,1048,13,1423,28,2,54,130000.0,39000.0,-72.0,-72.0,-69.0,-60.0,-72.0,-71.0,-69.0,-60.0,-87.0,-86.0,-83.0,-84.0,15.0,14.0,14.0,24.0,1
1135,BA:8C:B9:54:50:24,3852087,491377285,4932,6194122,3847155,485183163,7,9771,1752942,9749,1749447,22,3495,2358,17,5437,41,7,71,229410.0,130000.0,-48.0,-35.0,-42.0,-45.0,-44.0,-35.0,-43.0,-47.0,-87.0,-86.0,-83.0,-84.0,39.0,51.0,41.0,39.0,1
1136,62:47:05:9D:EB:15,3853912,497366509,6753,12182942,3847159,485183567,1,6996,3804261,6946,3796603,50,7658,3317,0,6821,56,1,125,216660.0,130000.0,-45.0,-51.0,-45.0,-45.0,-44.0,-47.0,-39.0,-47.0,-87.0,-86.0,-83.0,-84.0,42.0,35.0,38.0,39.0,1
1137,92:69:1D:31:68:E9,3851212,488837289,4052,3653449,3847160,485183840,1,5418,1159038,5247,1120185,171,38853,2205,12,4307,103,1,62,216660.0,130000.0,-51.0,-48.0,-45.0,-45.0,-51.0,-47.0,-44.0,-46.0,-87.0,-86.0,-83.0,-84.0,36.0,38.0,38.0,39.0,1
1138,CC:2F:71:3F:1F:24,5041157,1854940491,1193997,1369756651,3847160,485183840,1730,1000532,1134788735,999689,1134686703,843,102032,967661,15,1192622,121189,1727,786,144444.0,43333.0,-71.0,-70.0,-66.0,-72.0,-70.0,-70.0,-65.0,-71.0,-87.0,-86.0,-83.0,-84.0,16.0,16.0,17.0,12.0,1
1139,CC:2F:71:3E:C5:1F,3848149,485304605,989,120765,3847160,485183840,2,4296,358503,3574,272777,722,85726,1048,13,1423,28,2,54,130000.0,39000.0,-72.0,-72.0,-69.0,-60.0,-72.0,-71.0,-69.0,-60.0,-87.0,-86.0,-83.0,-84.0,15.0,14.0,14.0,24.0,1
1140,BA:8C:B9:54:50:24,3852092,491377962,4932,6194122,3847160,485183840,7,9771,1752942,9749,1749447,22,3495,2358,17,5437,41,7,71,229410.0,130000.0,-48.0,-35.0,-42.0,-45.0,-44.0,-35.0,-43.0,-47.0,-87.0,-86.0,-83.0,-84.0,39.0,51.0,41.0,39.0,1
1141,62:47:05:9D:EB:15,3853917,497367186,6753,12182942,3847164,485184244,1,6996,3804261,6946,3796603,50,7658,3317,0,6821,56,1,125,216660.0,130000.0,-45.0,-51.0,-45.0,-45.0,-44.0,-47.0,-39.0,-47.0,-87.0,-86.0,-83.0,-84.0,42.0,35.0,38.0,39.0,1
1142,92:69:1D:31:68:E9,3851216,488837693,4052,3653449,3847164,485184244,1,5418,1159038,5247,1120185,171,38853,2205,12,4307,103,1,62,216660.0,130000.0,-51.0,-48.0,-45.0,-45.0,-51.0,-47.0,-44.0,-46.0,-87.0,-86.0,-83.0,-84.0,36.0,38.0,38.0,39.0,1
1143,CC:2F:71:3F:1F:24,5041353,1855185263,1194189,1370001019,3847164,485184244,1730,1000710,1135027673,999867,1134925641,843,102032,967832,15,1192814,121189,1727,786,144444.0,43333.0,-70.0,-69.0,-65.0,-71.0,-70.0,-69.0,-65.0,-70.0,-87.0,-86.0,-83.0,-84.0,17.0,17.0,18.0,13.0,1
1144,CC:2F:71:3E:C5:1F,3848153,485305009,989,120765,3847164,485184244,2,4296,358503,3574,272777,722,85726,1048,13,1423,28,2,54,130000.0,39000.0,-72.0,-72.0,-69.0,-60.0,-72.0,-71.0,-69.0,-60.0,-87.0,-86.0,-83.0,-84.0,15.0,14.0,14.0,24.0,1
1145,BA:8C:B9:54:50:24,3852097,491378426,4932,6194122,3847165,485184304,7,9771,1752942,9749,1749447,22,3495,2358,17,5437,41,7,71,229410.0,130000.0,-48.0,-35.0,-42.0,-45.0,-44.0,-35.0,-43.0,-47.0,-87.0,-86.0,-83.0,-84.0,39.0,51.0,41.0,39.0,1
1146,62:47:05:9D:EB:15,3853922,497367650,6753,12182942,3847169,485184708,1,6996,3804261,6946,3796603,50,7658,3317,0,6821,56,1,125,216660.0,130000.0,-45.0,-51.0,-45.0,-45.0,-44.0,-47.0,-39.0,-47.0,-87.0,-86.0,-83.0,-84.0,42.0,35.0,38.0,39.0,1
1147,92:69:1D:31:68:E9,3851221,488838157,4052,3653449,3847169,485184708,1,5418,1159038,5247,1120185,171,38853,2205,12,4307,103,1,62,216660.0,130000.0,-51.0,-48.0,-45.0,-45.0,-51.0,-47.0,-44.0,-46.0,-87.0,-86.0,-83.0,-84.0,36.0,38.0,38.0,39.0,1
1148,CC:2F:71:3F:1F:24,5041558,1855433696,1194389,1370248988,3847169,485184708,1730,1000895,1135264957,1000052,1135162925,843,102032,968012,15,1193014,121192,1727,786,144444.0,43333.0,-70.0,-69.0,-66.0,-71.0,-70.0,-69.0,-66.0,-71.0,-87.0,-86.0,-83.0,-84.0,17.0,17.0,17.0,13.0,1
1149,CC:2F:71:3E:C5:1F,3848160,485305675,989,120765,3847171,485184910,2,4296,358503,3574,272777,722,85726,1048,13,1423,28,2,54,130000.0,39000.0,-72.0,-72.0,-69.0,-60.0,-72.0,-71.0,-69.0,-60.0,-87.0,-86.0,-83.0,-84.0,15.0,14.0,14.0,24.0,1
1150,BA:8C:B9:54:50:24,3852105,491379234,4932,6194122,3847173,485185112,7,9771,1752942,9749,1749447,22,3495,2358,17,5437,41,7,71,229410.0,130000.0,-48.0,-35.0,-42.0,-45.0,-44.0,-35.0,-43.0,-47.0,-87.0,-86.0,-83.0,-84.0,39.0,51.0,41.0,39.0,1
1151,62:47:05:9D:EB:15,3853928,497368422,6753,12182942,3847175,485185480,1,6996,3804261,6946,3796603,50,7658,3317,0,6821,56,1,125,216660.0,130000.0,-45.0,-51.0,-45.0,-45.0,-44.0,-47.0,-39.0,-47.0,-87.0,-86.0,-83.0,-84.0,42.0,35.0,38.0,39.0,1
1152,92:69:1D:31:68:E9,3851227,488838929,4052,3653449,3847175,485185480,1,5418,1159038,5247,1120185,171,38853,2205,12,4307,103,1,62,216660.0,130000.0,-51.0,-48.0,-45.0,-45.0,-51.0,-47.0,-44.0,-46.0,-87.0,-86.0,-83.0,-84.0,36.0,38.0,38.0,39.0,1
1153,CC:2F:71:3F:1F:24,5041759,1855682074,1194584,1370496594,3847175,485185480,1730,1001076,1135505933,1000233,1135403901,843,102032,968184,15,1193209,121192,1727,787,144444.0,43333.0,-70.0,-69.0,-67.0,-72.0,-70.0,-69.0,-66.0,-71.0,-87.0,-86.0,-83.0,-84.0,17.0,17.0,16.0,12.0,1
1154,CC:2F:71:3E:C5:1F,3848164,485306245,989,120765,3847175,485185480,2,4296,358503,3574,272777,722,85726,1048,13,1423,28,2,54,130000.0,39000.0,-72.0,-72.0,-69.0,-60.0,-72.0,-71.0,-69.0,-60.0,-87.0,-86.0,-83.0,-84.0,15.0,14.0,14.0,24.0,1
1155,BA:8C:B9:54:50:24,3852107,491379602,4932,6194122,3847175,485185480,7,9771,1752942,9749,1749447,22,3495,2358,17,5437,41,7,71,229410.0,130000.0,-48.0,-35.0,-42.0,-45.0,-44.0,-35.0,-43.0,-47.0,-87.0,-86.0,-83.0,-84.0,39.0,51.0,41.0,39.0,1
1156,62:47:05:9D:EB:15,3853933,497368886,6753,12182942,3847180,485185944,1,6996,3804261,6946,3796603,50,7658,3317,0,6821,56,1,125,216660.0,130000.0,-45.0,-51.0,-45.0,-45.0,-44.0,-47.0,-39.0,-47.0,-87.0,-86.0,-83.0,-84.0,42.0,35.0,38.0,39.0,1
1157,92:69:1D:31:68:E9,3851234,488839595,4052,3653449,3847182,485186146,1,5418,1159038,5247,1120185,171,38853,2205,12,4307,103,1,62,216660.0,130000.0,-51.0,-48.0,-45.0,-45.0,-51.0,-47.0,-44.0,-46.0,-87.0,-86.0,-83.0,-84.0,36.0,38.0,38.0,39.0,1
1158,CC:2F:71:3F:1F:24,5041959,1855927182,1194777,1370741036,3847182,485186146,1730,1001252,1135744511,1000409,1135642479,843,102032,968353,15,1193402,121193,1727,787,130000.0,39000.0,-70.0,-69.0,-65.0,-71.0,-70.0,-69.0,-65.0,-71.0,-87.0,-86.0,-83.0,-84.0,17.0,17.0,18.0,13.0,1
1159,CC:2F:71:3E:C5:1F,3848173,485307113,989,120765,3847184,485186348,2,4296,358503,3574,272777,722,85726,1048,13,1423,28,2,54,130000.0,39000.0,-72.0,-72.0,-69.0,-60.0,-72.0,-71.0,-69.0,-60.0,-87.0,-86.0,-83.0,-84.0,15.0,14.0,14.0,24.0,1
1160,BA:8C:B9:54:50:24,3852116,491380470,4932,6194122,3847184,485186348,7,9771,1752942,9749,1749447,22,3495,2358,17,5437,41,7,71,229410.0,130000.0,-48.0,-35.0,-42.0,-45.0,-44.0,-35.0,-43.0,-47.0,-87.0,-86.0,-83.0,-84.0,39.0,51.0,41.0,39.0,1
1161,62:47:05:9D:EB:15,3853937,497369290,6753,12182942,3847184,485186348,1,6996,3804261,6946,3796603,50,7658,3317,0,6821,56,1,125,216660.0,130000.0,-45.0,-51.0,-45.0,-45.0,-44.0,-47.0,-39.0,-47.0,-87.0,-86.0,-83.0,-84.0,42.0,35.0,38.0,39.0,1
1162,92:69:1D:31:68:E9,3851236,488839797,4052,3653449,3847184,485186348,1,5418,1159038,5247,1120185,171,38853,2205,12,4307,103,1,62,216660.0,130000.0,-51.0,-48.0,-45.0,-45.0,-51.0,-47.0,-44.0,-46.0,-87.0,-86.0,-83.0,-84.0,36.0,38.0,38.0,39.0,1
1163,CC:2F:71:3F:1F:24,5042151,1856168532,1194967,1370982184,3847184,485186348,1730,1001426,1135979981,1000583,1135877949,843,102032,968522,15,1193592,121193,1727,787,144444.0,43333.0,-70.0,-70.0,-66.0,-71.0,-70.0,-70.0,-65.0,-70.0,-87.0,-86.0,-83.0,-84.0,17.0,16.0,17.0,13.0,1
1164,CC:2F:71:3E:C5:1F,3848175,485307315,989,120765,3847186,485186550,2,4296,358503,3574,272777,722,85726,1048,13,1423,28,2,54,130000.0,39000.0,-72.0,-72.0,-69.0,-60.0,-72.0,-71.0,-69.0,-60.0,-87.0,-86.0,-83.0,-84.0,15.0,14.0,14.0,24.0,1
1165,BA:8C:B9:54:50:24,3852120,491380874,4932,6194122,3847188,485186752,7,9771,1752942,9749,1749447,22,3495,2358,17,5437,41,7,71,229410.0,130000.0,-48.0,-35.0,-42.0,-45.0,-44.0,-35.0,-43.0,-47.0,-87.0,-86.0,-83.0,-84.0,39.0,51.0,41.0,39.0,1
1166,62:47:05:9D:EB:15,3853943,497369896,6753,12182942,3847190,485186954,1,6996,3804261,6946,3796603,50,7658,3317,0,6821,56,1,125,216660.0,130000.0,-45.0,-51.0,-45.0,-45.0,-44.0,-47.0,-39.0,-47.0,-87.0,-86.0,-83.0,-84.0,42.0,35.0,38.0,39.0,1
1167,92:69:1D:31:68:E9,3851244,488840605,4052,3653449,3847192,485187156,1,5418,1159038,5247,1120185,171,38853,2205,12,4307,103,1,62,216660.0,130000.0,-51.0,-48.0,-45.0,-45.0,-51.0,-47.0,-44.0,-46.0,-87.0,-86.0,-83.0,-84.0,36.0,38.0,38.0,39.0,1
1168,CC:2F:71:3F:1F:24,5042356,1856414071,1195164,1371226915,3847192,485187156,1730,1001603,1136207960,1000760,1136105928,843,102032,968697,15,1193789,121193,1727,787,144444.0,43333.0,-70.0,-70.0,-65.0,-71.0,-70.0,-69.0,-64.0,-70.0,-87.0,-86.0,-83.0,-84.0,17.0,16.0,18.0,13.0,1
1169,CC:2F:71:3E:C5:1F,3848181,485307921,989,120765,3847192,485187156,2,4296,358503,3574,272777,722,85726,1048,13,1423,28,2,54,130000.0,39000.0,-72.0,-72.0,-69.0,-60.0,-72.0,-71.0,-69.0,-60.0,-87.0,-86.0,-83.0,-84.0,15.0,14.0,14.0,24.0,1
1170,BA:8C:B9:54:50:24,3852125,491381338,4932,6194122,3847193,485187216,7,9771,1752942,9749,1749447,22,3495,2358,17,5437,41,7,71,229410.0,130000.0,-48.0,-35.0,-42.0,-45.0,-44.0,-35.0,-43.0,-47.0,-87.0,-86.0,-83.0,-84.0,39.0,51.0,41.0,39.0,1
1171,62:47:05:9D:EB:15,3853946,497370158,6753,12182942,3847193,485187216,1,6996,3804261,6946,3796603,50,7658,3317,0,6821,56,1,125,216660.0,130000.0,-45.0,-51.0,-45.0,-45.0,-44.0,-47.0,-39.0,-47.0,-87.0,-86.0,-83.0,-84.0,42.0,35.0,38.0,39.0,1
1172,92:69:1D:31:68:E9,3851245,488840665,4052,3653449,3847193,485187216,1,5418,1159038,5247,1120185,171,38853,2205,12,4307,103,1,62,216660.0,130000.0,-51.0,-48.0,-45.0,-45.0,-51.0,-47.0,-44.0,-46.0,-87.0,-86.0,-83.0,-84.0,36.0,38.0,38.0,39.0,1
1173,CC:2F:71:3F:1F:24,5042551,1856658701,1195356,1371471283,3847195,485187418,1730,1001781,1136442812,1000938,1136340780,843,102032,968869,15,1193981,121193,1727,787,144444.0,43333.0,-70.0,-70.0,-65.0,-71.0,-70.0,-70.0,-65.0,-71.0,-87.0,-86.0,-83.0,-84.0,17.0,16.0,18.0,13.0,1
1174,CC:2F:71:3E:C5:1F,3848186,485308385,989,120765,3847197,485187620,2,4296,358503,3574,272777,722,85726,1048,13,1423,28,2,54,130000.0,39000.0,-72.0,-72.0,-69.0,-60.0,-72.0,-71.0,-69.0,-60.0,-87.0,-86.0,-83.0,-84.0,15.0,14.0,14.0,24.0,1
1175,BA:8C:B9:54:50:24,3852129,491381742,4932,6194122,3847197,485187620,7,9771,1752942,9749,1749447,22,3495,2358,17,5437,41,7,71,229410.0,130000.0,-48.0,-35.0,-42.0,-45.0,-44.0,-35.0,-43.0,-47.0,-87.0,-86.0,-83.0,-84.0,39.0,51.0,41.0,39.0,1
1176,62:47:05:9D:EB:15,3853954,497370966,6753,12182942,3847201,485188024,1,6997,3804329,6947,3796671,50,7658,3317,0,6821,56,1,125,216660.0,130000.0,-43.0,-44.0,-36.0,-48.0,-44.0,-46.0,-38.0,-47.0,-87.0,-86.0,-83.0,-84.0,44.0,42.0,47.0,36.0,1
1177,92:69:1D:31:68:E9,3851253,488841473,4052,3653449,3847201,485188024,1,5418,1159038,5247,1120185,171,38853,2205,12,4307,103,1,62,216660.0,130000.0,-51.0,-48.0,-45.0,-45.0,-51.0,-47.0,-44.0,-46.0,-87.0,-86.0,-83.0,-84.0,36.0,38.0,38.0,39.0,1
1178,CC:2F:71:3F:1F:24,5042747,1856900567,1195546,1371712543,3847201,485188024,1730,1001956,1136677126,1001113,1136575094,843,102032,969035,15,1194171,121194,1727,787,144444.0,43333.0,-70.0,-70.0,-64.0,-71.0,-70.0,-70.0,-64.0,-70.0,-87.0,-86.0,-83.0,-84.0,17.0,16.0,19.0,13.0,1
1179,CC:2F:71:3E:C5:1F,3848190,485308789,989,120765,3847201,485188024,2,4296,358503,3574,272777,722,85726,1048,13,1423,28,2,54,130000.0,39000.0,-72.0,-72.0,-69.0,-60.0,-72.0,-71.0,-69.0,-60.0,-87.0,-86.0,-83.0,-84.0,15.0,14.0,14.0,24.0,1
1180,BA:8C:B9:54:50:24,3852133,491382146,4932,6194122,3847201,485188024,7,9771,1752942,9749,1749447,22,3495,2358,17,5437,41,7,71,229410.0,130000.0,-48.0,-35.0,-42.0,-45.0,-44.0,-35.0,-43.0,-47.0,-87.0,-86.0,-83.0,-84.0,39.0,51.0,41.0,39.0,1
1181,62:47:05:9D:EB:15,3853957,497371228,6753,12182942,3847204,485188286,1,6997,3804329,6947,3796671,50,7658,3317,0,6821,56,1,125,216660.0,130000.0,-43.0,-44.0,-36.0,-48.0,-44.0,-46.0,-38.0,-47.0,-87.0,-86.0,-83.0,-84.0,44.0,42.0,47.0,36.0,1
1182,92:69:1D:31:68:E9,3851257,488841869,4052,3653449,3847205,485188420,1,5418,1159038,5247,1120185,171,38853,2205,12,4307,103,1,62,216660.0,130000.0,-51.0,-48.0,-45.0,-45.0,-51.0,-47.0,-44.0,-46.0,-87.0,-86.0,-83.0,-84.0,36.0,38.0,38.0,39.0,1
1183,CC:2F:71:3F:1F:24,5042941,1857142209,1195736,1371953789,3847205,485188420,1730,1002141,1136924070,1001298,1136822038,843,102032,969207,15,1194361,121194,1727,787,144444.0,43333.0,-70.0,-69.0,-65.0,-70.0,-70.0,-69.0,-65.0,-70.0,-87.0,-87.0,-83.0,-84.0,17.0,18.0,18.0,14.0,1
1184,CC:2F:71:3E:C5:1F,3848195,485309253,989,120765,3847206,485188488,2,4297,358573,3575,272847,722,85726,1048,13,1424,28,2,54,130000.0,39000.0,-74.0,-72.0,-73.0,-70.0,-72.0,-71.0,-69.0,-61.0,-87.0,-87.0,-83.0,-84.0,13.0,15.0,10.0,14.0,1
1185,BA:8C:B9:54:50:24,3852138,491382610,4932,6194122,3847206,485188488,7,9772,1753010,9750,1749515,22,3495,2358,17,5438,41,7,71,229410.0,130000.0,-40.0,-36.0,-45.0,-51.0,-43.0,-35.0,-43.0,-48.0,-87.0,-87.0,-83.0,-84.0,47.0,51.0,38.0,33.0,1
1186,62:47:05:9D:EB:15,3853963,497371834,6753,12182942,3847210,485188892,1,6997,3804329,6947,3796671,50,7658,3317,0,6821,56,1,125,216660.0,130000.0,-43.0,-44.0,-36.0,-48.0,-44.0,-46.0,-38.0,-47.0,-87.0,-87.0,-83.0,-84.0,44.0,43.0,47.0,36.0,1
1187,92:69:1D:31:68:E9,3851262,488842341,4052,3653449,3847210,485188892,1,5420,1159174,5249,1120321,171,38853,2205,12,4308,103,1,62,216660.0,130000.0,-51.0,-48.0,-45.0,-45.0,-51.0,-47.0,-44.0,-46.0,-87.0,-87.0,-83.0,-84.0,36.0,39.0,38.0,39.0,1
1188,CC:2F:71:3F:1F:24,5043151,1857399972,1195941,1372211080,3847210,485188892,1730,1002330,1137171751,1001487,1137069719,843,102032,969391,15,1194566,121195,1727,787,144444.0,43333.0,-71.0,-70.0,-66.0,-71.0,-70.0,-70.0,-66.0,-71.0,-87.0,-87.0,-83.0,-84.0,16.0,17.0,17.0,13.0,1
1189,CC:2F:71:3E:C5:1F,3848199,485309657,989,120765,3847210,485188892,2,4298,358643,3576,272917,722,85726,1048,13,1424,28,2,54,130000.0,39000.0,-80.0,-82.0,-76.0,-72.0,-73.0,-72.0,-70.0,-62.0,-87.0,-87.0,-83.0,-84.0,7.0,5.0,7.0,12.0,1
1190,BA:8C:B9:54:50:24,3852142,491383014,4932,6194122,3847210,485188892,7,9773,1753078,9751,1749583,22,3495,2358,17,5438,41,7,71,229410.0,130000.0,-48.0,-35.0,-42.0,-45.0,-44.0,-35.0,-43.0,-47.0,-87.0,-87.0,-83.0,-84.0,39.0,52.0,41.0,39.0,1
1191,62:47:05:9D:EB:15,3853965,497372036,6753,12182942,3847212,485189094,1,6997,3804329,6947,3796671,50,7658,3317,0,6821,56,1,125,216660.0,130000.0,-43.0,-44.0,-36.0,-48.0,-44.0,-46.0,-38.0,-47.0,-87.0,-87.0,-83.0,-84.0,44.0,43.0,47.0,36.0,1
1192,92:69:1D:31:68:E9,3851266,488842745,4052,3653449,3847214,485189296,1,5420,1159174,5249,1120321,171,38853,2205,12,4308,103,1,62,216660.0,130000.0,-51.0,-48.0,-45.0,-45.0,-51.0,-47.0,-44.0,-46.0,-87.0,-87.0,-83.0,-84.0,36.0,39.0,38.0,39.0,1
1193,CC:2F:71:3F:1F:24,5043346,1857643190,1196132,1372453894,3847214,485189296,1730,1002511,1137416773,1001668,1137314741,843,102032,969561,15,1194757,121195,1727,787,144444.0,43333.0,-71.0,-70.0,-66.0,-71.0,-71.0,-70.0,-66.0,-71.0,-87.0,-87.0,-83.0,-84.0,16.0,17.0,17.0,13.0,1
1194,CC:2F:71:3E:C5:1F,3848204,485310121,989,120765,3847215,485189356,2,4298,358643,3576,272917,722,85726,1048,13,1424,28,2,54,130000.0,39000.0,-80.0,-82.0,-76.0,-72.0,-73.0,-72.0,-70.0,-62.0,-87.0,-87.0,-83.0,-84.0,7.0,5.0,7.0,12.0,1
1195,BA:8C:B9:54:50:24,3852147,491383478,4932,6194122,3847215,485189356,7,9773,1753078,9751,1749583,22,3495,2358,17,5438,41,7,71,229410.0,130000.0,-48.0,-35.0,-42.0,-45.0,-44.0,-35.0,-43.0,-47.0,-87.0,-87.0,-83.0,-84.0,39.0,52.0,41.0,39.0,1
1196,62:47:05:9D:EB:15,3853972,497372702,6753,12182942,3847219,485189760,1,6997,3804329,6947,3796671,50,7658,3317,0,6821,56,1,125,216660.0,130000.0,-43.0,-44.0,-36.0,-48.0,-44.0,-46.0,-38.0,-47.0,-87.0,-86.0,-83.0,-84.0,44.0,42.0,47.0,36.0,1
1197,92:69:1D:31:68:E9,3851271,488843209,4052,3653449,3847219,485189760,1,5420,1159174,5249,1120321,171,38853,2205,12,4308,103,1,62,216660.0,130000.0,-51.0,-48.0,-45.0,-45.0,-51.0,-47.0,-44.0,-46.0,-87.0,-86.0,-83.0,-84.0,36.0,38.0,38.0,39.0,1
1198,CC:2F:71:3F:1F:24,5043545,1857889692,1196326,1372699932,3847219,485189760,1730,1002686,1137652349,1001843,1137550317,843,102032,969733,15,1194951,121195,1727,787,144444.0,43333.0,-70.0,-70.0,-65.0,-70.0,-70.0,-69.0,-65.0,-70.0,-87.0,-86.0,-83.0,-84.0,17.0,16.0,18.0,14.0,1
1199,CC:2F:71:3E:C5:1F,3848208,485310525,989,120765,3847219,485189760,2,4298,358643,3576,272917,722,85726,1048,13,1424,28,2,54,130000.0,39000.0,-80.0,-82.0,-76.0,-72.0,-73.0,-72.0,-70.0,-62.0,-87.0,-86.0,-83.0,-84.0,7.0,4.0,7.0,12.0,1
1200,BA:8C:B9:54:50:24,3852151,491383882,4932,6194122,3847219,485189760,7,9774,1753146,9752,1749651,22,3495,2358,17,5438,41,7,71,229410.0,130000.0,-39.0,-36.0,-46.0,-51.0,-44.0,-35.0,-43.0,-47.0,-87.0,-86.0,-83.0,-84.0,48.0,50.0,37.0,33.0,1
1201,62:47:05:9D:EB:15,3853977,497373379,6753,12182942,3847224,485190437,1,7000,3804533,6950,3796875,50,7658,3317,0,6821,56,1,125,216660.0,130000.0,-44.0,-45.0,-37.0,-49.0,-44.0,-46.0,-38.0,-47.0,-87.0,-86.0,-83.0,-84.0,43.0,41.0,46.0,35.0,1
1202,92:69:1D:31:68:E9,3851276,488843886,4052,3653449,3847224,485190437,1,5420,1159174,5249,1120321,171,38853,2205,12,4308,103,1,62,216660.0,130000.0,-51.0,-48.0,-45.0,-45.0,-51.0,-47.0,-44.0,-46.0,-87.0,-86.0,-83.0,-84.0,36.0,38.0,38.0,39.0,1
1203,CC:2F:71:3F:1F:24,5043741,1858134495,1196517,1372944058,3847224,485190437,1730,1002863,1137891199,1002020,1137789167,843,102032,969901,15,1195140,121195,1727,787,144444.0,43333.0,-70.0,-70.0,-65.0,-72.0,-70.0,-70.0,-66.0,-72.0,-87.0,-86.0,-83.0,-84.0,17.0,16.0,18.0,12.0,1
1204,CC:2F:71:3E:C5:1F,3848213,485311202,989,120765,3847224,485190437,2,4298,358643,3576,272917,722,85726,1048,13,1424,28,2,54,130000.0,39000.0,-80.0,-82.0,-76.0,-72.0,-73.0,-72.0,-70.0,-62.0,-87.0,-86.0,-83.0,-84.0,7.0,4.0,7.0,12.0,1
1205,BA:8C:B9:54:50:24,3852156,491384559,4932,6194122,3847224,485190437,7,9774,1753146,9752,1749651,22,3495,2358,17,5438,41,7,71,229410.0,130000.0,-39.0,-36.0,-46.0,-51.0,-44.0,-35.0,-43.0,-47.0,-87.0,-86.0,-83.0,-84.0,48.0,50.0,37.0,33.0,1
1206,62:47:05:9D:EB:15,3853982,497373843,6753,12182942,3847229,485190901,1,7000,3804533,6950,3796875,50,7658,3317,0,6821,56,1,125,216660.0,130000.0,-44.0,-45.0,-37.0,-49.0,-44.0,-46.0,-38.0,-47.0,-87.0,-86.0,-83.0,-84.0,43.0,41.0,46.0,35.0,1
1207,92:69:1D:31:68:E9,3851281,488844350,4052,3653449,3847229,485190901,1,5420,1159174,5249,1120321,171,38853,2205,12,4308,103,1,62,216660.0,130000.0,-51.0,-48.0,-45.0,-45.0,-51.0,-47.0,-44.0,-46.0,-87.0,-86.0,-83.0,-84.0,36.0,38.0,38.0,39.0,1
1208,CC:2F:71:3F:1F:24,5043942,1858378136,1196713,1373187235,3847229,485190901,1730,1003049,1138131553,1002206,1138029521,843,102032,970078,15,1195337,121195,1727,787,144444.0,43333.0,-70.0,-70.0,-66.0,-71.0,-69.0,-69.0,-66.0,-71.0,-87.0,-86.0,-83.0,-84.0,17.0,16.0,17.0,13.0,1
1209,CC:2F:71:3E:C5:1F,3848218,485311666,989,120765,3847229,485190901,2,4298,358643,3576,272917,722,85726,1048,13,1424,28,2,54,130000.0,39000.0,-80.0,-82.0,-76.0,-72.0,-73.0,-72.0,-70.0,-62.0,-87.0,-86.0,-83.0,-84.0,7.0,4.0,7.0,12.0,1
1210,BA:8C:B9:54:50:24,3852161,491385023,4932,6194122,3847229,485190901,7,9774,1753146,9752,1749651,22,3495,2358,17,5438,41,7,71,229410.0,130000.0,-39.0,-36.0,-46.0,-51.0,-44.0,-35.0,-43.0,-47.0,-87.0,-86.0,-83.0,-84.0,48.0,50.0,37.0,33.0,1
1211,62:47:05:9D:EB:15,3853986,497374247,6753,12182942,3847233,485191305,1,7000,3804533,6950,3796875,50,7658,3317,0,6821,56,1,125,216660.0,130000.0,-44.0,-45.0,-37.0,-49.0,-44.0,-46.0,-38.0,-47.0,-87.0,-86.0,-83.0,-84.0,43.0,41.0,46.0,35.0,1
1212,92:69:1D:31:68:E9,3851285,488844754,4052,3653449,3847233,485191305,1,5420,1159174,5249,1120321,171,38853,2205,12,4308,103,1,62,216660.0,130000.0,-51.0,-48.0,-45.0,-45.0,-51.0,-47.0,-44.0,-46.0,-87.0,-86.0,-83.0,-84.0,36.0,38.0,38.0,39.0,1
1213,CC:2F:71:3F:1F:24,5044144,1858633784,1196911,1373442479,3847233,485191305,1730,1003241,1138389377,1002398,1138287345,843,102032,970259,15,1195536,121195,1727,787,144444.0,43333.0,-70.0,-69.0,-66.0,-71.0,-69.0,-69.0,-66.0,-71.0,-87.0,-86.0,-83.0,-84.0,17.0,17.0,17.0,13.0,1
1214,CC:2F:71:3E:C5:1F,3848222,485312070,989,120765,3847233,485191305,2,4298,358643,3576,272917,722,85726,1048,13,1424,28,2,54,130000.0,39000.0,-80.0,-82.0,-76.0,-72.0,-73.0,-72.0,-70.0,-62.0,-87.0,-86.0,-83.0,-84.0,7.0,4.0,7.0,12.0,1
1215,BA:8C:B9:54:50:24,3852165,491385427,4932,6194122,3847233,485191305,7,9774,1753146,9752,1749651,22,3495,2358,17,5438,41,7,71,229410.0,130000.0,-39.0,-36.0,-46.0,-51.0,-44.0,-35.0,-43.0,-47.0,-87.0,-86.0,-83.0,-84.0,48.0,50.0,37.0,33.0,1
1216,62:47:05:9D:EB:15,3853990,497374651,6753,12182942,3847237,485191709,1,7000,3804533,6950,3796875,50,7658,3317,0,6821,56,1,125,216660.0,130000.0,-44.0,-45.0,-37.0,-49.0,-44.0,-46.0,-38.0,-47.0,-87.0,-86.0,-83.0,-84.0,43.0,41.0,46.0,35.0,1
1217,92:69:1D:31:68:E9,3851289,488845158,4052,3653449,3847237,485191709,1,5420,1159174,5249,1120321,171,38853,2205,12,4308,103,1,62,216660.0,130000.0,-51.0,-48.0,-45.0,-45.0,-51.0,-47.0,-44.0,-46.0,-87.0,-86.0,-83.0,-84.0,36.0,38.0,38.0,39.0,1
1218,CC:2F:71:3F:1F:24,5044343,1858881724,1197105,1373689955,3847238,485191769,1730,1003417,1138627941,1002574,1138525909,843,102032,970431,15,1195730,121197,1727,787,144444.0,43333.0,-70.0,-69.0,-66.0,-71.0,-70.0,-69.0,-66.0,-70.0,-87.0,-86.0,-83.0,-84.0,17.0,17.0,17.0,13.0,1
1219,CC:2F:71:3E:C5:1F,3848227,485312534,989,120765,3847238,485191769,2,4298,358643,3576,272917,722,85726,1048,13,1424,28,2,54,130000.0,39000.0,-80.0,-82.0,-76.0,-72.0,-73.0,-72.0,-70.0,-62.0,-87.0,-86.0,-83.0,-84.0,7.0,4.0,7.0,12.0,1
1220,BA:8C:B9:54:50:24,3852170,491385891,4932,6194122,3847238,485191769,7,9774,1753146,9752,1749651,22,3495,2358,17,5438,41,7,71,229410.0,130000.0,-39.0,-36.0,-46.0,-51.0,-44.0,-35.0,-43.0,-47.0,-87.0,-86.0,-83.0,-84.0,48.0,50.0,37.0,33.0,1
1221,62:47:05:9D:EB:15,3853995,497375115,6753,12182942,3847242,485192173,1,7000,3804533,6950,3796875,50,7658,3317,0,6821,56,1,125,216660.0,130000.0,-44.0,-45.0,-37.0,-49.0,-44.0,-46.0,-38.0,-47.0,-87.0,-86.0,-83.0,-84.0,43.0,41.0,46.0,35.0,1
1222,92:69:1D:31:68:E9,3851294,488845622,4052,3653449,3847242,485192173,1,5420,1159174,5249,1120321,171,38853,2205,12,4308,103,1,62,216660.0,130000.0,-51.0,-48.0,-45.0,-45.0,-51.0,-47.0,-44.0,-46.0,-87.0,-86.0,-83.0,-84.0,36.0,38.0,38.0,39.0,1
1223,CC:2F:71:3F:1F:24,5044544,1859126859,1197302,1373934686,3847242,485192173,1730,1003597,1138861846,1002754,1138759814,843,102032,970606,15,1195927,121197,1727,787,144444.0,43333.0,-70.0,-69.0,-66.0,-72.0,-69.0,-69.0,-65.0,-71.0,-87.0,-86.0,-83.0,-84.0,17.0,17.0,17.0,12.0,1
1224,CC:2F:71:3E:C5:1F,3848233,485313140,989,120765,3847244,485192375,2,4298,358643,3576,272917,722,85726,1048,13,1424,28,2,54,130000.0,39000.0,-80.0,-82.0,-76.0,-72.0,-73.0,-72.0,-70.0,-62.0,-87.0,-86.0,-83.0,-84.0,7.0,4.0,7.0,12.0,1
1225,BA:8C:B9:54:50:24,3852176,491386497,4932,6194122,3847244,485192375,7,9774,1753146,9752,1749651,22,3495,2358,17,5438,41,7,71,229410.0,130000.0,-39.0,-36.0,-46.0,-51.0,-44.0,-35.0,-43.0,-47.0,-87.0,-86.0,-83.0,-84.0,48.0,50.0,37.0,33.0,1
1226,62:47:05:9D:EB:15,3853999,497375519,6753,12182942,3847246,485192577,1,7000,3804533,6950,3796875,50,7658,3317,0,6821,56,1,125,216660.0,130000.0,-44.0,-45.0,-37.0,-49.0,-44.0,-46.0,-38.0,-47.0,-87.0,-86.0,-83.0,-84.0,43.0,41.0,46.0,35.0,1
1227,92:69:1D:31:68:E9,3851298,488846026,4052,3653449,3847246,485192577,1,5420,1159174,5249,1120321,171,38853,2205,12,4308,103,1,62,216660.0,130000.0,-51.0,-48.0,-45.0,-45.0,-51.0,-47.0,-44.0,-46.0,-87.0,-86.0,-83.0,-84.0,36.0,38.0,38.0,39.0,1
1228,CC:2F:71:3F:1F:24,5044739,1859368653,1197493,1374176076,3847246,485192577,1730,1003775,1139100732,1002932,1138998700,843,102032,970775,15,1196118,121197,1727,787,144444.0,43333.0,-70.0,-70.0,-66.0,-72.0,-70.0,-69.0,-65.0,-71.0,-87.0,-86.0,-83.0,-84.0,17.0,16.0,17.0,12.0,1
1229,CC:2F:71:3E:C5:1F,3848235,485313342,989,120765,3847246,485192577,2,4298,358643,3576,272917,722,85726,1048,13,1424,28,2,54,130000.0,39000.0,-80.0,-82.0,-76.0,-72.0,-73.0,-72.0,-70.0,-62.0,-87.0,-86.0,-83.0,-84.0,7.0,4.0,7.0,12.0,1
1230,BA:8C:B9:54:50:24,3852178,491386699,4932,6194122,3847246,485192577,7,9774,1753146,9752,1749651,22,3495,2358,17,5438,41,7,71,229410.0,130000.0,-39.0,-36.0,-46.0,-51.0,-44.0,-35.0,-43.0,-47.0,-87.0,-86.0,-83.0,-84.0,48.0,50.0,37.0,33.0,1
1231,62:47:05:9D:EB:15,3854004,497375983,6753,12182942,3847251,485193041,1,7000,3804533,6950,3796875,50,7658,3317,0,6821,56,1,125,216660.0,130000.0,-44.0,-45.0,-37.0,-49.0,-44.0,-46.0,-38.0,-47.0,-87.0,-86.0,-83.0,-84.0,43.0,41.0,46.0,35.0,1
1232,92:69:1D:31:68:E9,3851303,488846490,4052,3653449,3847251,485193041,1,5420,1159174,5249,1120321,171,38853,2205,12,4308,103,1,62,216660.0,130000.0,-51.0,-48.0,-45.0,-45.0,-51.0,-47.0,-44.0,-46.0,-87.0,-86.0,-83.0,-84.0,36.0,38.0,38.0,39.0,1
1233,CC:2F:71:3F:1F:24,5044940,1859613947,1197687,1374420704,3847253,485193243,1730,1003956,1139344190,1003113,1139242158,843,102032,970947,15,1196312,121197,1727,787,144444.0,43333.0,-70.0,-70.0,-65.0,-71.0,-69.0,-70.0,-65.0,-71.0,-87.0,-86.0,-83.0,-84.0,17.0,16.0,18.0,13.0,1
1234,CC:2F:71:3E:C5:1F,3848244,485314210,989,120765,3847255,485193445,2,4298,358643,3576,272917,722,85726,1048,13,1424,28,2,54,130000.0,39000.0,-80.0,-82.0,-76.0,-72.0,-73.0,-72.0,-70.0,-62.0,-87.0,-86.0,-83.0,-84.0,7.0,4.0,7.0,12.0,1
1235,BA:8C:B9:54:50:24,3852187,491387567,4932,6194122,3847255,485193445,7,9774,1753146,9752,1749651,22,3495,2358,17,5438,41,7,71,229410.0,130000.0,-39.0,-36.0,-46.0,-51.0,-44.0,-35.0,-43.0,-47.0,-87.0,-86.0,-83.0,-84.0,48.0,50.0,37.0,33.0,1
1236,62:47:05:9D:EB:15,3854008,497376387,6753,12182942,3847255,485193445,1,7000,3804533,6950,3796875,50,7658,3317,0,6821,56,1,125,216660.0,130000.0,-44.0,-45.0,-37.0,-49.0,-44.0,-46.0,-38.0,-47.0,-87.0,-86.0,-83.0,-84.0,43.0,41.0,46.0,35.0,1
1237,92:69:1D:31:68:E9,3851307,488846894,4052,3653449,3847255,485193445,1,5420,1159174,5249,1120321,171,38853,2205,12,4308,103,1,62,216660.0,130000.0,-51.0,-48.0,-45.0,-45.0,-51.0,-47.0,-44.0,-46.0,-87.0,-86.0,-83.0,-84.0,36.0,38.0,38.0,39.0,1
1238,CC:2F:71:3F:1F:24,5045135,1859858647,1197880,1374665202,3847255,485193445,1730,1004132,1139579892,1003289,1139477860,843,102032,971118,15,1196505,121197,1727,787,144444.0,43333.0,-69.0,-70.0,-65.0,-72.0,-69.0,-69.0,-65.0,-71.0,-87.0,-86.0,-83.0,-84.0,18.0,16.0,18.0,12.0,1
1239,CC:2F:71:3E:C5:1F,3848244,485314210,989,120765,3847255,485193445,2,4298,358643,3576,272917,722,85726,1048,13,1424,28,2,54,130000.0,39000.0,-80.0,-82.0,-76.0,-72.0,-73.0,-72.0,-70.0,-62.0,-87.0,-86.0,-83.0,-84.0,7.0,4.0,7.0,12.0,1
1240,BA:8C:B9:54:50:24,3852187,491387567,4932,6194122,3847255,485193445,7,9774,1753146,9752,1749651,22,3495,2358,17,5438,41,7,71,229410.0,130000.0,-39.0,-36.0,-46.0,-51.0,-44.0,-35.0,-43.0,-47.0,-87.0,-87.0,-83.0,-84.0,48.0,51.0,37.0,33.0,1
1241,62:47:05:9D:EB:15,3854014,497376993,6753,12182942,3847261,485194051,1,7000,3804533,6950,3796875,50,7658,3317,0,6821,56,1,125,216660.0,130000.0,-44.0,-45.0,-37.0,-49.0,-44.0,-46.0,-38.0,-47.0,-87.0,-87.0,-83.0,-84.0,43.0,42.0,46.0,35.0,1
1242,92:69:1D:31:68:E9,3851313,488847500,4052,3653449,3847261,485194051,1,5420,1159174,5249,1120321,171,38853,2205,12,4308,103,1,62,216660.0,130000.0,-51.0,-48.0,-45.0,-45.0,-51.0,-47.0,-44.0,-46.0,-87.0,-87.0,-83.0,-84.0,36.0,39.0,38.0,39.0,1
1243,CC:2F:71:3F:1F:24,5045344,1860104636,1198080,1374910323,3847264,485194313,1730,1004318,1139817273,1003475,1139715241,843,102032,971299,15,1196705,121197,1727,787,144444.0,43333.0,-69.0,-70.0,-65.0,-72.0,-69.0,-69.0,-65.0,-72.0,-87.0,-87.0,-83.0,-84.0,18.0,17.0,18.0,12.0,1
1244,CC:2F:71:3E:C5:1F,3848253,485315078,989,120765,3847264,485194313,2,4298,358643,3576,272917,722,85726,1048,13,1424,28,2,54,130000.0,39000.0,-80.0,-82.0,-76.0,-72.0,-73.0,-72.0,-70.0,-62.0,-87.0,-87.0,-83.0,-84.0,7.0,5.0,7.0,12.0,1
1245,BA:8C:B9:54:50:24,3852196,491388435,4932,6194122,3847264,485194313,7,9774,1753146,9752,1749651,22,3495,2358,17,5438,41,7,71,229410.0,130000.0,-39.0,-36.0,-46.0,-51.0,-44.0,-35.0,-43.0,-47.0,-87.0,-87.0,-83.0,-84.0,48.0,51.0,37.0,33.0,1
1246,62:47:05:9D:EB:15,3854018,497377371,6754,12183058,3847264,485194313,1,7001,3804601,6951,3796943,50,7658,3317,0,6822,56,1,125,216660.0,130000.0,-44.0,-46.0,-36.0,-49.0,-44.0,-46.0,-38.0,-47.0,-87.0,-87.0,-83.0,-84.0,43.0,41.0,47.0,35.0,1
1247,92:69:1D:31:68:E9,3851317,488847878,4053,3653565,3847264,485194313,1,5422,1159310,5251,1120457,171,38853,2205,12,4309,103,1,62,216660.0,130000.0,-52.0,-47.0,-42.0,-49.0,-51.0,-47.0,-43.0,-46.0,-87.0,-87.0,-83.0,-84.0,35.0,40.0,41.0,35.0,1
1248,CC:2F:71:3F:1F:24,5045541,1860352474,1198277,1375158161,3847264,485194313,1730,1004498,1140057897,1003655,1139955865,843,102032,971473,15,1196902,121200,1727,787,144444.0,43333.0,-70.0,-70.0,-66.0,-73.0,-70.0,-70.0,-65.0,-72.0,-87.0,-87.0,-83.0,-84.0,17.0,17.0,17.0,11.0,1
1249,CC:2F:71:3E:C5:1F,3848254,485315194,990,120881,3847264,485194313,2,4300,358783,3578,273057,722,85726,1048,13,1425,28,2,54,130000.0,39000.0,-72.0,-71.0,-69.0,-60.0,-73.0,-72.0,-70.0,-62.0,-87.0,-87.0,-83.0,-84.0,15.0,16.0,14.0,24.0,1
1250,BA:8C:B9:54:50:24,3852199,491388697,4933,6194182,3847266,485194515,7,9780,1753554,9758,1750059,22,3495,2358,17,5439,41,7,71,229410.0,130000.0,-48.0,-35.0,-43.0,-45.0,-43.0,-34.0,-42.0,-46.0,-87.0,-87.0,-83.0,-84.0,39.0,52.0,40.0,39.0,1
1251,62:47:05:9D:EB:15,3854026,497378179,6754,12183058,3847272,485195121,1,7002,3804669,6952,3797011,50,7658,3317,0,6822,56,1,125,216660.0,130000.0,-44.0,-45.0,-36.0,-50.0,-44.0,-46.0,-38.0,-47.0,-87.0,-87.0,-83.0,-84.0,43.0,42.0,47.0,34.0,1
1252,92:69:1D:31:68:E9,3851325,488848686,4053,3653565,3847272,485195121,1,5422,1159310,5251,1120457,171,38853,2205,12,4309,103,1,62,216660.0,130000.0,-52.0,-47.0,-42.0,-49.0,-51.0,-47.0,-43.0,-46.0,-87.0,-87.0,-83.0,-84.0,35.0,40.0,41.0,35.0,1
1253,CC:2F:71:3F:1F:24,5045744,1860595611,1198472,1375400490,3847272,485195121,1730,1004673,1140284998,1003830,1140182966,843,102032,971648,15,1197097,121200,1727,787,144444.0,43333.0,-70.0,-69.0,-66.0,-72.0,-70.0,-69.0,-65.0,-71.0,-87.0,-87.0,-83.0,-84.0,17.0,18.0,17.0,12.0,1
1254,CC:2F:71:3E:C5:1F,3848262,485316002,990,120881,3847272,485195121,2,4300,358783,3578,273057,722,85726,1048,13,1425,28,2,54,130000.0,39000.0,-72.0,-71.0,-69.0,-60.0,-73.0,-72.0,-70.0,-62.0,-87.0,-87.0,-83.0,-84.0,15.0,16.0,14.0,24.0,1
1255,BA:8C:B9:54:50:24,3852205,491389303,4933,6194182,3847272,485195121,7,9780,1753554,9758,1750059,22,3495,2358,17,5439,41,7,71,229410.0,130000.0,-48.0,-35.0,-43.0,-45.0,-43.0,-34.0,-42.0,-46.0,-87.0,-87.0,-83.0,-84.0,39.0,52.0,40.0,39.0,1
1256,62:47:05:9D:EB:15,3854027,497378239,6754,12183058,3847273,485195181,1,7002,3804669,6952,3797011,50,7658,3317,0,6822,56,1,125,216660.0,130000.0,-44.0,-45.0,-36.0,-50.0,-44.0,-46.0,-38.0,-47.0,-87.0,-87.0,-83.0,-84.0,43.0,42.0,47.0,34.0,1
1257,92:69:1D:31:68:E9,3851326,488848746,4053,3653565,3847273,485195181,1,5422,1159310,5251,1120457,171,38853,2205,12,4309,103,1,62,216660.0,130000.0,-52.0,-47.0,-42.0,-49.0,-51.0,-47.0,-43.0,-46.0,-87.0,-87.0,-83.0,-84.0,35.0,40.0,41.0,35.0,1
1258,CC:2F:71:3F:1F:24,5045940,1860840203,1198665,1375644820,3847275,485195383,1730,1004845,1140516018,1004002,1140413986,843,102032,971818,15,1197290,121200,1727,787,144444.0,43333.0,-70.0,-69.0,-66.0,-71.0,-70.0,-69.0,-66.0,-71.0,-87.0,-87.0,-83.0,-84.0,17.0,18.0,17.0,13.0,1
1259,CC:2F:71:3E:C5:1F,3848267,485316466,990,120881,3847277,485195585,2,4300,358783,3578,273057,722,85726,1048,13,1425,28,2,54,130000.0,39000.0,-72.0,-71.0,-69.0,-60.0,-73.0,-72.0,-70.0,-62.0,-87.0,-87.0,-83.0,-84.0,15.0,16.0,14.0,24.0,1
1260,BA:8C:B9:54:50:24,3852210,491389767,4933,6194182,3847277,485195585,7,9780,1753554,9758,1750059,22,3495,2358,17,5439,41,7,71,229410.0,130000.0,-48.0,-35.0,-43.0,-45.0,-43.0,-34.0,-42.0,-46.0,-87.0,-87.0,-83.0,-84.0,39.0,52.0,40.0,39.0,1
1261,62:47:05:9D:EB:15,3854036,497379320,6754,12183058,3847282,485196262,1,7002,3804669,6952,3797011,50,7658,3317,0,6822,56,1,125,216660.0,130000.0,-44.0,-45.0,-36.0,-50.0,-44.0,-46.0,-38.0,-47.0,-87.0,-87.0,-83.0,-84.0,43.0,42.0,47.0,34.0,1
1262,92:69:1D:31:68:E9,3851335,488849827,4053,3653565,3847282,485196262,1,5422,1159310,5251,1120457,171,38853,2205,12,4309,103,1,62,216660.0,130000.0,-52.0,-47.0,-42.0,-49.0,-51.0,-47.0,-43.0,-46.0,-87.0,-87.0,-83.0,-84.0,35.0,40.0,41.0,35.0,1
1263,CC:2F:71:3F:1F:24,5046147,1861089051,1198865,1375892789,3847282,485196262,1730,1005026,1140748477,1004183,1140646445,843,102032,971997,15,1197490,121201,1727,787,144444.0,43333.0,-70.0,-69.0,-65.0,-72.0,-70.0,-69.0,-65.0,-71.0,-87.0,-87.0,-83.0,-84.0,17.0,18.0,18.0,12.0,1
1264,CC:2F:71:3E:C5:1F,3848272,485317143,990,120881,3847282,485196262,2,4300,358783,3578,273057,722,85726,1048,13,1425,28,2,54,130000.0,39000.0,-72.0,-71.0,-69.0,-60.0,-73.0,-72.0,-70.0,-62.0,-87.0,-87.0,-83.0,-84.0,15.0,16.0,14.0,24.0,1
1265,BA:8C:B9:54:50:24,3852215,491390444,4933,6194182,3847282,485196262,7,9780,1753554,9758,1750059,22,3495,2358,17,5439,41,7,71,229410.0,130000.0,-48.0,-35.0,-43.0,-45.0,-43.0,-34.0,-42.0,-46.0,-87.0,-87.0,-83.0,-84.0,39.0,52.0,40.0,39.0,1
1266,62:47:05:9D:EB:15,3854036,497379320,6754,12183058,3847282,485196262,1,7002,3804669,6952,3797011,50,7658,3317,0,6822,56,1,125,216660.0,130000.0,-44.0,-45.0,-36.0,-50.0,-44.0,-46.0,-38.0,-47.0,-87.0,-87.0,-83.0,-84.0,43.0,42.0,47.0,34.0,1
1267,92:69:1D:31:68:E9,3851337,488850029,4053,3653565,3847284,485196464,1,5422,1159310,5251,1120457,171,38853,2205,12,4309,103,1,62,216660.0,130000.0,-52.0,-47.0,-42.0,-49.0,-51.0,-47.0,-43.0,-46.0,-87.0,-87.0,-83.0,-84.0,35.0,40.0,41.0,35.0,1
1268,CC:2F:71:3F:1F:24,5046341,1861330645,1199054,1376133919,3847287,485196726,1730,1005204,1140988739,1004361,1140886707,843,102032,972166,15,1197679,121202,1727,787,144444.0,43333.0,-70.0,-70.0,-66.0,-72.0,-70.0,-69.0,-66.0,-72.0,-87.0,-87.0,-83.0,-84.0,17.0,17.0,17.0,12.0,1
1269,CC:2F:71:3E:C5:1F,3848277,485317607,990,120881,3847287,485196726,2,4300,358783,3578,273057,722,85726,1048,13,1425,28,2,54,130000.0,39000.0,-72.0,-71.0,-69.0,-60.0,-73.0,-72.0,-70.0,-62.0,-87.0,-87.0,-83.0,-84.0,15.0,16.0,14.0,24.0,1
1270,BA:8C:B9:54:50:24,3852220,491390908,4933,6194182,3847287,485196726,7,9780,1753554,9758,1750059,22,3495,2358,17,5439,41,7,71,229410.0,130000.0,-48.0,-35.0,-43.0,-45.0,-43.0,-34.0,-42.0,-46.0,-87.0,-87.0,-83.0,-84.0,39.0,52.0,40.0,39.0,1
1271,62:47:05:9D:EB:15,3854045,497380188,6754,12183058,3847291,485197130,1,7002,3804669,6952,3797011,50,7658,3317,0,6822,56,1,125,216660.0,130000.0,-44.0,-45.0,-36.0,-50.0,-44.0,-46.0,-38.0,-47.0,-87.0,-87.0,-84.0,-85.0,43.0,42.0,48.0,35.0,1
1272,92:69:1D:31:68:E9,3851344,488850695,4053,3653565,3847291,485197130,1,5422,1159310,5251,1120457,171,38853,2205,12,4309,103,1,62,216660.0,130000.0,-52.0,-47.0,-42.0,-49.0,-51.0,-47.0,-43.0,-46.0,-87.0,-87.0,-84.0,-85.0,35.0,40.0,42.0,36.0,1
1273,CC:2F:71:3F:1F:24,5046539,1861578511,1199248,1376381381,3847291,485197130,1730,1005379,1141222977,1004536,1141120945,843,102032,972339,15,1197873,121202,1727,787,144444.0,43333.0,-71.0,-70.0,-66.0,-72.0,-70.0,-69.0,-66.0,-72.0,-87.0,-87.0,-84.0,-85.0,16.0,17.0,18.0,13.0,1
1274,CC:2F:71:3E:C5:1F,3848281,485318011,990,120881,3847291,485197130,2,4300,358783,3578,273057,722,85726,1048,13,1425,28,2,54,130000.0,39000.0,-72.0,-71.0,-69.0,-60.0,-73.0,-72.0,-70.0,-62.0,-87.0,-87.0,-84.0,-85.0,15.0,16.0,15.0,25.0,1
1275,BA:8C:B9:54:50:24,3852224,491391312,4933,6194182,3847291,485197130,7,9780,1753554,9758,1750059,22,3495,2358,17,5439,41,7,71,229410.0,130000.0,-48.0,-35.0,-43.0,-45.0,-43.0,-34.0,-42.0,-46.0,-87.0,-87.0,-84.0,-85.0,39.0,52.0,41.0,40.0,1
1276,62:47:05:9D:EB:15,3854049,497380592,6754,12183058,3847295,485197534,1,7002,3804669,6952,3797011,50,7658,3317,0,6822,56,1,125,216660.0,130000.0,-44.0,-45.0,-36.0,-50.0,-44.0,-46.0,-38.0,-47.0,-87.0,-87.0,-84.0,-85.0,43.0,42.0,48.0,35.0,1
1277,92:69:1D:31:68:E9,3851348,488851099,4053,3653565,3847295,485197534,1,5422,1159310,5251,1120457,171,38853,2205,12,4309,103,1,62,216660.0,130000.0,-52.0,-47.0,-42.0,-49.0,-51.0,-47.0,-43.0,-46.0,-87.0,-87.0,-84.0,-85.0,35.0,40.0,42.0,36.0,1
1278,CC:2F:71:3F:1F:24,5046734,1861821729,1199439,1376624195,3847295,485197534,1730,1005556,1141463109,1004713,1141361077,843,102032,972508,15,1198064,121202,1727,787,144444.0,43333.0,-72.0,-70.0,-67.0,-73.0,-72.0,-69.0,-66.0,-73.0,-87.0,-87.0,-84.0,-85.0,15.0,17.0,17.0,12.0,1
1279,CC:2F:71:3E:C5:1F,3848285,485318415,990,120881,3847295,485197534,2,4300,358783,3578,273057,722,85726,1048,13,1425,28,2,54,130000.0,39000.0,-72.0,-71.0,-69.0,-60.0,-73.0,-72.0,-70.0,-62.0,-87.0,-87.0,-84.0,-85.0,15.0,16.0,15.0,25.0,1
1280,BA:8C:B9:54:50:24,3852228,491391716,4933,6194182,3847295,485197534,7,9780,1753554,9758,1750059,22,3495,2358,17,5439,41,7,71,229410.0,130000.0,-48.0,-35.0,-43.0,-45.0,-43.0,-34.0,-42.0,-46.0,-87.0,-87.0,-84.0,-85.0,39.0,52.0,41.0,40.0,1
1281,62:47:05:9D:EB:15,3854055,497381118,6754,12183058,3847301,485198060,1,7002,3804669,6952,3797011,50,7658,3317,0,6822,56,1,125,216660.0,130000.0,-44.0,-45.0,-36.0,-50.0,-44.0,-46.0,-38.0,-47.0,-87.0,-87.0,-84.0,-85.0,43.0,42.0,48.0,35.0,1
1282,92:69:1D:31:68:E9,3851354,488851625,4053,3653565,3847301,485198060,1,5422,1159310,5251,1120457,171,38853,2205,12,4309,103,1,62,216660.0,130000.0,-52.0,-47.0,-42.0,-49.0,-51.0,-47.0,-43.0,-46.0,-87.0,-87.0,-84.0,-85.0,35.0,40.0,42.0,36.0,1
1283,CC:2F:71:3F:1F:24,5046938,1862069964,1199637,1376871904,3847301,485198060,1730,1005735,1141696942,1004892,1141594910,843,102032,972684,15,1198261,121210,1727,787,144444.0,43333.0,-71.0,-70.0,-66.0,-72.0,-71.0,-69.0,-66.0,-72.0,-87.0,-87.0,-84.0,-85.0,16.0,17.0,18.0,13.0,1
1284,CC:2F:71:3E:C5:1F,3848291,485318941,990,120881,3847301,485198060,2,4302,358971,3579,273127,723,85844,1049,13,1425,28,2,54,130000.0,39000.0,-81.0,-83.0,-75.0,-72.0,-74.0,-73.0,-70.0,-64.0,-87.0,-87.0,-84.0,-85.0,6.0,4.0,9.0,13.0,1
1285,BA:8C:B9:54:50:24,3852234,491392242,4933,6194182,3847301,485198060,7,9780,1753554,9758,1750059,22,3495,2358,17,5439,41,7,71,229410.0,130000.0,-48.0,-35.0,-43.0,-45.0,-43.0,-34.0,-42.0,-46.0,-87.0,-87.0,-84.0,-85.0,39.0,52.0,41.0,40.0,1
1286,62:47:05:9D:EB:15,3854059,497381522,6754,12183058,3847305,485198464,1,7002,3804669,6952,3797011,50,7658,3317,0,6822,56,1,125,216660.0,130000.0,-44.0,-45.0,-36.0,-50.0,-44.0,-46.0,-38.0,-47.0,-87.0,-87.0,-84.0,-85.0,43.0,42.0,48.0,35.0,1
1287,92:69:1D:31:68:E9,3851358,488852029,4053,3653565,3847305,485198464,1,5422,1159310,5251,1120457,171,38853,2205,12,4309,103,1,62,216660.0,130000.0,-52.0,-47.0,-42.0,-49.0,-51.0,-47.0,-43.0,-46.0,-87.0,-87.0,-84.0,-85.0,35.0,40.0,42.0,36.0,1
1288,CC:2F:71:3F:1F:24,5047134,1862313351,1199829,1377114887,3847305,485198464,1730,1005911,1141932669,1005068,1141830637,843,102032,972856,15,1198454,121210,1727,787,144444.0,43333.0,-70.0,-69.0,-65.0,-72.0,-70.0,-69.0,-65.0,-72.0,-87.0,-87.0,-84.0,-85.0,17.0,18.0,19.0,13.0,1
1289,CC:2F:71:3E:C5:1F,3848295,485319345,990,120881,3847305,485198464,2,4302,358971,3579,273127,723,85844,1049,13,1425,28,2,54,130000.0,39000.0,-81.0,-83.0,-75.0,-72.0,-74.0,-73.0,-70.0,-64.0,-87.0,-87.0,-83.0,-84.0,6.0,4.0,8.0,12.0,1
1290,BA:8C:B9:54:50:24,3852238,491392646,4933,6194182,3847305,485198464,7,9780,1753554,9758,1750059,22,3495,2358,17,5439,41,7,71,229410.0,130000.0,-48.0,-35.0,-43.0,-45.0,-43.0,-34.0,-42.0,-46.0,-87.0,-87.0,-83.0,-84.0,39.0,52.0,40.0,39.0,1
1291,62:47:05:9D:EB:15,3854063,497381926,6754,12183058,3847309,485198868,1,7002,3804669,6952,3797011,50,7658,3317,0,6822,56,1,125,216660.0,130000.0,-44.0,-45.0,-36.0,-50.0,-44.0,-46.0,-38.0,-47.0,-87.0,-87.0,-83.0,-84.0,43.0,42.0,47.0,34.0,1
1292,92:69:1D:31:68:E9,3851363,488852493,4053,3653565,3847310,485198928,1,5423,1159378,5252,1120525,171,38853,2205,12,4309,103,1,62,216660.0,130000.0,-51.0,-48.0,-45.0,-45.0,-51.0,-47.0,-44.0,-46.0,-87.0,-87.0,-83.0,-84.0,36.0,39.0,38.0,39.0,1
1293,CC:2F:71:3F:1F:24,5047331,1862559607,1200021,1377360679,3847310,485198928,1730,1006082,1142163463,1005239,1142061431,843,102032,973026,15,1198646,121210,1727,787,144444.0,43333.0,-69.0,-69.0,-65.0,-72.0,-69.0,-69.0,-65.0,-71.0,-87.0,-87.0,-83.0,-84.0,18.0,18.0,18.0,12.0,1
1294,CC:2F:71:3E:C5:1F,3848300,485319809,990,120881,3847310,485198928,2,4302,358971,3579,273127,723,85844,1049,13,1425,28,2,54,130000.0,39000.0,-81.0,-83.0,-75.0,-72.0,-74.0,-73.0,-70.0,-64.0,-87.0,-87.0,-83.0,-84.0,6.0,4.0,8.0,12.0,1
1295,BA:8C:B9:54:50:24,3852243,491393110,4933,6194182,3847310,485198928,7,9780,1753554,9758,1750059,22,3495,2358,17,5439,41,7,71,229410.0,130000.0,-48.0,-35.0,-43.0,-45.0,-43.0,-34.0,-42.0,-46.0,-87.0,-87.0,-83.0,-84.0,39.0,52.0,40.0,39.0,1
1296,62:47:05:9D:EB:15,3854069,497382452,6754,12183058,3847315,485199394,1,7002,3804669,6952,3797011,50,7658,3317,0,6822,56,1,125,216660.0,130000.0,-44.0,-45.0,-36.0,-50.0,-44.0,-46.0,-38.0,-47.0,-87.0,-87.0,-83.0,-84.0,43.0,42.0,47.0,34.0,1
1297,92:69:1D:31:68:E9,3851368,488852959,4053,3653565,3847315,485199394,1,5423,1159378,5252,1120525,171,38853,2205,12,4309,103,1,62,216660.0,130000.0,-51.0,-48.0,-45.0,-45.0,-51.0,-47.0,-44.0,-46.0,-87.0,-87.0,-83.0,-84.0,36.0,39.0,38.0,39.0,1
1298,CC:2F:71:3F:1F:24,5047544,1862809382,1200229,1377609988,3847315,485199394,1730,1006276,1142402485,1005432,1142300335,844,102150,973216,15,1198854,121210,1727,787,144444.0,43333.0,-70.0,-70.0,-66.0,-71.0,-70.0,-70.0,-66.0,-71.0,-87.0,-87.0,-83.0,-84.0,17.0,17.0,17.0,13.0,1
1299,CC:2F:71:3E:C5:1F,3848307,485320477,990,120881,3847317,485199596,2,4302,358971,3579,273127,723,85844,1049,13,1425,28,2,54,130000.0,39000.0,-81.0,-83.0,-75.0,-72.0,-74.0,-73.0,-70.0,-64.0,-87.0,-87.0,-83.0,-84.0,6.0,4.0,8.0,12.0,1
1300,BA:8C:B9:54:50:24,3852250,491393778,4933,6194182,3847317,485199596,7,9780,1753554,9758,1750059,22,3495,2358,17,5439,41,7,71,229410.0,130000.0,-48.0,-35.0,-43.0,-45.0,-43.0,-34.0,-42.0,-46.0,-87.0,-87.0,-83.0,-84.0,39.0,52.0,40.0,39.0,1
1301,62:47:05:9D:EB:15,3854073,497382856,6754,12183058,3847319,485199798,1,7002,3804669,6952,3797011,50,7658,3317,0,6822,56,1,125,216660.0,130000.0,-44.0,-45.0,-36.0,-50.0,-44.0,-46.0,-38.0,-47.0,-87.0,-87.0,-83.0,-84.0,43.0,42.0,47.0,34.0,1
1302,92:69:1D:31:68:E9,3851372,488853363,4053,3653565,3847319,485199798,1,5423,1159378,5252,1120525,171,38853,2205,12,4309,103,1,62,216660.0,130000.0,-51.0,-48.0,-45.0,-45.0,-51.0,-47.0,-44.0,-46.0,-87.0,-87.0,-83.0,-84.0,36.0,39.0,38.0,39.0,1
1303,CC:2F:71:3F:1F:24,5047739,1863054024,1200420,1377854226,3847319,485199798,1730,1006454,1142642829,1005610,1142540679,844,102150,973386,15,1199045,121211,1727,787,144444.0,43333.0,-71.0,-71.0,-67.0,-72.0,-70.0,-70.0,-66.0,-71.0,-87.0,-87.0,-83.0,-84.0,16.0,16.0,16.0,12.0,1
1304,CC:2F:71:3E:C5:1F,3848309,485320679,990,120881,3847319,485199798,2,4302,358971,3579,273127,723,85844,1049,13,1425,28,2,54,130000.0,39000.0,-81.0,-83.0,-75.0,-72.0,-74.0,-73.0,-70.0,-64.0,-87.0,-87.0,-83.0,-84.0,6.0,4.0,8.0,12.0,1
1305,BA:8C:B9:54:50:24,3852252,491393980,4933,6194182,3847319,485199798,7,9780,1753554,9758,1750059,22,3495,2358,17,5439,41,7,71,229410.0,130000.0,-48.0,-35.0,-43.0,-45.0,-43.0,-34.0,-42.0,-46.0,-87.0,-87.0,-83.0,-84.0,39.0,52.0,40.0,39.0,1
1306,62:47:05:9D:EB:15,3854078,497383320,6754,12183058,3847324,485200262,1,7002,3804669,6952,3797011,50,7658,3317,0,6822,56,1,125,216660.0,130000.0,-44.0,-45.0,-36.0,-50.0,-44.0,-46.0,-38.0,-47.0,-87.0,-87.0,-83.0,-84.0,43.0,42.0,47.0,34.0,1
1307,92:69:1D:31:68:E9,3851379,488854029,4053,3653565,3847326,485200464,1,5423,1159378,5252,1120525,171,38853,2205,12,4309,103,1,62,216660.0,130000.0,-51.0,-48.0,-45.0,-45.0,-51.0,-47.0,-44.0,-46.0,-87.0,-87.0,-83.0,-84.0,36.0,39.0,38.0,39.0,1
1308,CC:2F:71:3F:1F:24,5047936,1863295950,1200610,1378095486,3847326,485200464,1730,1006627,1142875275,1005783,1142773125,844,102150,973554,15,1199235,121211,1727,787,144444.0,43333.0,-69.0,-70.0,-65.0,-71.0,-69.0,-70.0,-65.0,-71.0,-87.0,-87.0,-83.0,-84.0,18.0,17.0,18.0,13.0,1
1309,CC:2F:71:3E:C5:1F,3848316,485321345,990,120881,3847326,485200464,2,4304,359111,3581,273267,723,85844,1049,13,1426,28,2,54,130000.0,39000.0,-72.0,-71.0,-70.0,-60.0,-74.0,-73.0,-71.0,-64.0,-87.0,-87.0,-83.0,-84.0,15.0,16.0,13.0,24.0,1
1310,BA:8C:B9:54:50:24,3852259,491394646,4933,6194182,3847326,485200464,7,9783,1753758,9761,1750263,22,3495,2358,18,5440,43,7,71,229410.0,130000.0,-48.0,-35.0,-42.0,-45.0,-43.0,-34.0,-42.0,-46.0,-87.0,-87.0,-83.0,-84.0,39.0,52.0,41.0,39.0,1
1311,62:47:05:9D:EB:15,3854105,497394747,6754,12183058,3847351,485211689,1,7004,3804805,6954,3797147,50,7658,3317,0,6823,56,1,125,216660.0,130000.0,-44.0,-46.0,-36.0,-48.0,-43.0,-45.0,-36.0,-48.0,-87.0,-87.0,-83.0,-84.0,43.0,41.0,47.0,36.0,1
1312,92:69:1D:31:68:E9,3851404,488865254,4053,3653565,3847351,485211689,1,5426,1159749,5254,1120661,172,39088,2206,12,4309,103,1,62,216660.0,130000.0,-52.0,-47.0,-42.0,-49.0,-51.0,-48.0,-43.0,-47.0,-87.0,-87.0,-83.0,-84.0,35.0,40.0,41.0,35.0,1
1313,CC:2F:71:3F:1F:24,5048162,1863564233,1200811,1378352544,3847351,485211689,1730,1006816,1143122687,1005972,1143020537,844,102150,973736,15,1199436,121211,1727,787,144444.0,43333.0,-70.0,-70.0,-65.0,-71.0,-69.0,-69.0,-65.0,-70.0,-87.0,-87.0,-83.0,-84.0,17.0,17.0,18.0,13.0,1
1314,CC:2F:71:3E:C5:1F,3848341,485332570,990,120881,3847351,485211689,2,4304,359111,3581,273267,723,85844,1049,13,1426,28,2,54,130000.0,39000.0,-72.0,-71.0,-70.0,-60.0,-74.0,-73.0,-71.0,-64.0,-87.0,-87.0,-83.0,-84.0,15.0,16.0,13.0,24.0,1
1315,BA:8C:B9:54:50:24,3852284,491405871,4933,6194182,3847351,485211689,7,9783,1753758,9761,1750263,22,3495,2358,18,5440,43,7,71,229410.0,130000.0,-48.0,-35.0,-42.0,-45.0,-43.0,-34.0,-42.0,-46.0,-87.0,-87.0,-83.0,-84.0,39.0,52.0,41.0,39.0,1
1316,62:47:05:9D:EB:15,3854112,497395413,6754,12183058,3847358,485212355,1,7004,3804805,6954,3797147,50,7658,3317,0,6823,56,1,125,216660.0,130000.0,-44.0,-46.0,-36.0,-48.0,-43.0,-45.0,-36.0,-48.0,-87.0,-87.0,-83.0,-84.0,43.0,41.0,47.0,36.0,1
1317,92:69:1D:31:68:E9,3851411,488865920,4053,3653565,3847358,485212355,1,5426,1159749,5254,1120661,172,39088,2206,12,4309,103,1,62,216660.0,130000.0,-52.0,-47.0,-42.0,-49.0,-51.0,-48.0,-43.0,-47.0,-87.0,-87.0,-83.0,-84.0,35.0,40.0,41.0,35.0,1
1318,CC:2F:71:3F:1F:24,5048367,1863808336,1201009,1378595981,3847358,485212355,1730,1006998,1143358284,1006154,1143256134,844,102150,973910,15,1199634,121211,1727,787,144444.0,43333.0,-69.0,-69.0,-66.0,-70.0,-69.0,-69.0,-65.0,-70.0,-87.0,-87.0,-83.0,-84.0,18.0,18.0,17.0,14.0,1
1319,CC:2F:71:3E:C5:1F,3848348,485333236,990,120881,3847358,485212355,2,4304,359111,3581,273267,723,85844,1049,13,1426,28,2,54,130000.0,39000.0,-72.0,-71.0,-70.0,-60.0,-74.0,-73.0,-71.0,-64.0,-87.0,-87.0,-83.0,-84.0,15.0,16.0,13.0,24.0,1
1320,BA:8C:B9:54:50:24,3852291,491406537,4933,6194182,3847358,485212355,7,9783,1753758,9761,1750263,22,3495,2358,18,5440,43,7,71,229410.0,130000.0,-48.0,-35.0,-42.0,-45.0,-43.0,-34.0,-42.0,-46.0,-87.0,-87.0,-83.0,-84.0,39.0,52.0,41.0,39.0,1
1321,62:47:05:9D:EB:15,3854114,497395615,6754,12183058,3847360,485212557,1,7004,3804805,6954,3797147,50,7658,3317,0,6823,56,1,125,216660.0,130000.0,-44.0,-46.0,-36.0,-48.0,-43.0,-45.0,-36.0,-48.0,-87.0,-87.0,-83.0,-84.0,43.0,41.0,47.0,36.0,1
1322,92:69:1D:31:68:E9,3851413,488866122,4053,3653565,3847360,485212557,1,5426,1159749,5254,1120661,172,39088,2206,12,4309,103,1,62,216660.0,130000.0,-52.0,-47.0,-42.0,-49.0,-51.0,-48.0,-43.0,-47.0,-87.0,-87.0,-83.0,-84.0,35.0,40.0,41.0,35.0,1
1323,CC:2F:71:3F:1F:24,5048565,1864057826,1201205,1378845269,3847360,485212557,1730,1007179,1143599104,1006335,1143496954,844,102150,974087,15,1199830,121212,1727,787,144444.0,43333.0,-69.0,-70.0,-66.0,-71.0,-69.0,-69.0,-65.0,-70.0,-87.0,-87.0,-83.0,-84.0,18.0,17.0,17.0,13.0,1
1324,CC:2F:71:3E:C5:1F,3848351,485333711,990,120881,3847361,485212830,2,4304,359111,3581,273267,723,85844,1049,13,1426,28,2,54,130000.0,39000.0,-72.0,-71.0,-70.0,-60.0,-74.0,-73.0,-71.0,-64.0,-87.0,-87.0,-83.0,-84.0,15.0,16.0,13.0,24.0,1
1325,BA:8C:B9:54:50:24,3852294,491407012,4933,6194182,3847361,485212830,7,9783,1753758,9761,1750263,22,3495,2358,18,5440,43,7,71,229410.0,130000.0,-48.0,-35.0,-42.0,-45.0,-43.0,-34.0,-42.0,-46.0,-87.0,-87.0,-83.0,-84.0,39.0,52.0,41.0,39.0,1
1326,62:47:05:9D:EB:15,3854121,497396494,6754,12183058,3847367,485213436,1,7004,3804805,6954,3797147,50,7658,3317,0,6823,56,1,125,216660.0,130000.0,-44.0,-46.0,-36.0,-48.0,-43.0,-45.0,-36.0,-48.0,-87.0,-87.0,-83.0,-84.0,43.0,41.0,47.0,36.0,1
1327,92:69:1D:31:68:E9,3851420,488867001,4053,3653565,3847367,485213436,1,5426,1159749,5254,1120661,172,39088,2206,12,4309,103,1,62,216660.0,130000.0,-52.0,-47.0,-42.0,-49.0,-51.0,-48.0,-43.0,-47.0,-87.0,-87.0,-83.0,-84.0,35.0,40.0,41.0,35.0,1
1328,CC:2F:71:3F:1F:24,5048767,1864309159,1201400,1379095723,3847367,485213436,1730,1007356,1143837838,1006512,1143735688,844,102150,974261,15,1200025,121214,1727,787,144444.0,43333.0,-69.0,-70.0,-65.0,-71.0,-69.0,-69.0,-65.0,-71.0,-87.0,-87.0,-83.0,-84.0,18.0,17.0,18.0,13.0,1
1329,CC:2F:71:3E:C5:1F,3848357,485334317,990,120881,3847367,485213436,2,4304,359111,3581,273267,723,85844,1049,13,1426,28,2,54,130000.0,39000.0,-72.0,-71.0,-70.0,-60.0,-74.0,-73.0,-71.0,-64.0,-87.0,-87.0,-83.0,-84.0,15.0,16.0,13.0,24.0,1
1330,BA:8C:B9:54:50:24,3852300,491407618,4933,6194182,3847367,485213436,7,9783,1753758,9761,1750263,22,3495,2358,18,5440,43,7,71,229410.0,130000.0,-48.0,-35.0,-42.0,-45.0,-43.0,-34.0,-42.0,-46.0,-87.0,-87.0,-83.0,-84.0,39.0,52.0,41.0,39.0,1
1331,62:47:05:9D:EB:15,3854124,497396756,6754,12183058,3847370,485213698,1,7004,3804805,6954,3797147,50,7658,3317,0,6823,56,1,125,216660.0,130000.0,-44.0,-46.0,-36.0,-48.0,-43.0,-45.0,-36.0,-48.0,-87.0,-87.0,-83.0,-84.0,43.0,41.0,47.0,36.0,1
1332,92:69:1D:31:68:E9,3851423,488867263,4053,3653565,3847370,485213698,1,5426,1159749,5254,1120661,172,39088,2206,12,4309,103,1,62,216660.0,130000.0,-52.0,-47.0,-42.0,-49.0,-51.0,-48.0,-43.0,-47.0,-87.0,-87.0,-83.0,-84.0,35.0,40.0,41.0,35.0,1
1333,CC:2F:71:3F:1F:24,5048962,1864553789,1201592,1379340091,3847370,485213698,1730,1007528,1144068858,1006684,1143966708,844,102150,974431,15,1200217,121214,1727,787,144444.0,43333.0,-69.0,-70.0,-65.0,-71.0,-69.0,-69.0,-65.0,-70.0,-87.0,-87.0,-83.0,-84.0,18.0,17.0,18.0,13.0,1
1334,CC:2F:71:3E:C5:1F,3848362,485334781,990,120881,3847372,485213900,2,4304,359111,3581,273267,723,85844,1049,13,1426,28,2,54,130000.0,39000.0,-72.0,-71.0,-70.0,-60.0,-74.0,-73.0,-71.0,-64.0,-87.0,-87.0,-83.0,-84.0,15.0,16.0,13.0,24.0,1
1335,BA:8C:B9:54:50:24,3852307,491408284,4933,6194182,3847374,485214102,7,9783,1753758,9761,1750263,22,3495,2358,18,5440,43,7,71,229410.0,130000.0,-48.0,-35.0,-42.0,-45.0,-43.0,-34.0,-42.0,-46.0,-87.0,-87.0,-83.0,-84.0,39.0,52.0,41.0,39.0,1
1336,62:47:05:9D:EB:15,3854132,497397730,6754,12183058,3847378,485214672,1,7004,3804805,6954,3797147,50,7658,3317,0,6823,56,1,125,216660.0,130000.0,-44.0,-46.0,-36.0,-48.0,-43.0,-45.0,-36.0,-48.0,-87.0,-87.0,-83.0,-84.0,43.0,41.0,47.0,36.0,1
1337,92:69:1D:31:68:E9,3851431,488868237,4053,3653565,3847378,485214672,1,5426,1159749,5254,1120661,172,39088,2206,12,4309,103,1,62,216660.0,130000.0,-52.0,-47.0,-42.0,-49.0,-51.0,-48.0,-43.0,-47.0,-87.0,-87.0,-84.0,-84.0,35.0,40.0,42.0,35.0,1
1338,CC:2F:71:3F:1F:24,5049171,1864805710,1201793,1379591038,3847378,485214672,1730,1007710,1144304308,1006866,1144202158,844,102150,974609,15,1200416,121214,1727,787,144444.0,43333.0,-70.0,-70.0,-67.0,-72.0,-70.0,-70.0,-66.0,-72.0,-87.0,-87.0,-84.0,-84.0,17.0,17.0,17.0,12.0,1
1339,CC:2F:71:3E:C5:1F,3848368,485335553,990,120881,3847378,485214672,2,4304,359111,3581,273267,723,85844,1049,13,1426,28,2,54,130000.0,39000.0,-72.0,-71.0,-70.0,-60.0,-74.0,-73.0,-71.0,-64.0,-87.0,-87.0,-84.0,-84.0,15.0,16.0,14.0,24.0,1
1340,BA:8C:B9:54:50:24,3852311,491408854,4933,6194182,3847378,485214672,7,9783,1753758,9761,1750263,22,3495,2358,18,5440,43,7,71,229410.0,130000.0,-48.0,-35.0,-42.0,-45.0,-43.0,-34.0,-42.0,-46.0,-87.0,-87.0,-84.0,-84.0,39.0,52.0,42.0,39.0,1
1341,62:47:05:9D:EB:15,3854135,497397992,6754,12183058,3847381,485214934,1,7004,3804805,6954,3797147,50,7658,3317,0,6823,56,1,125,216660.0,130000.0,-44.0,-46.0,-36.0,-48.0,-43.0,-45.0,-36.0,-48.0,-87.0,-87.0,-84.0,-84.0,43.0,41.0,48.0,36.0,1
1342,92:69:1D:31:68:E9,3851436,488868701,4053,3653565,3847383,485215136,1,5426,1159749,5254,1120661,172,39088,2206,12,4309,103,1,62,216660.0,130000.0,-52.0,-47.0,-42.0,-49.0,-51.0,-48.0,-43.0,-47.0,-87.0,-87.0,-84.0,-84.0,35.0,40.0,42.0,35.0,1
1343,CC:2F:71:3F:1F:24,5049366,1865044567,1201981,1379829229,3847385,485215338,1730,1007887,1144540255,1007043,1144438105,844,102150,974778,15,1200605,121221,1727,787,144444.0,43333.0,-69.0,-70.0,-67.0,-72.0,-69.0,-70.0,-67.0,-72.0,-87.0,-87.0,-84.0,-84.0,18.0,17.0,17.0,12.0,1
1344,CC:2F:71:3E:C5:1F,3848375,485336219,990,120881,3847385,485215338,2,4304,359111,3581,273267,723,85844,1049,13,1426,28,2,54,130000.0,39000.0,-72.0,-71.0,-70.0,-60.0,-74.0,-73.0,-71.0,-64.0,-87.0,-87.0,-84.0,-84.0,15.0,16.0,14.0,24.0,1
1345,BA:8C:B9:54:50:24,3852318,491409520,4933,6194182,3847385,485215338,7,9783,1753758,9761,1750263,22,3495,2358,18,5440,43,7,71,229410.0,130000.0,-48.0,-35.0,-42.0,-45.0,-43.0,-34.0,-42.0,-46.0,-87.0,-87.0,-84.0,-84.0,39.0,52.0,42.0,39.0,1
1346,62:47:05:9D:EB:15,3854141,497398598,6754,12183058,3847387,485215540,1,7004,3804805,6954,3797147,50,7658,3317,0,6823,56,1,125,216660.0,130000.0,-44.0,-46.0,-36.0,-48.0,-43.0,-45.0,-36.0,-48.0,-87.0,-87.0,-84.0,-84.0,43.0,41.0,48.0,36.0,1
1347,92:69:1D:31:68:E9,3851440,488869105,4053,3653565,3847387,485215540,1,5426,1159749,5254,1120661,172,39088,2206,12,4309,103,1,62,216660.0,130000.0,-52.0,-47.0,-42.0,-49.0,-51.0,-48.0,-43.0,-47.0,-87.0,-87.0,-84.0,-84.0,35.0,40.0,42.0,35.0,1
1348,CC:2F:71:3F:1F:24,5049558,1865286015,1202171,1380070475,3847387,485215540,1730,1008066,1144777733,1007222,1144675583,844,102150,974951,15,1200796,121224,1727,787,144444.0,43333.0,-69.0,-70.0,-67.0,-72.0,-69.0,-70.0,-67.0,-72.0,-87.0,-87.0,-84.0,-84.0,18.0,17.0,17.0,12.0,1
1349,CC:2F:71:3E:C5:1F,3848377,485336421,990,120881,3847387,485215540,2,4304,359111,3581,273267,723,85844,1049,13,1426,28,2,54,130000.0,39000.0,-72.0,-71.0,-70.0,-60.0,-74.0,-73.0,-71.0,-64.0,-87.0,-87.0,-84.0,-84.0,15.0,16.0,14.0,24.0,1
1350,BA:8C:B9:54:50:24,3852322,491409924,4933,6194182,3847389,485215742,7,9783,1753758,9761,1750263,22,3495,2358,18,5440,43,7,71,229410.0,130000.0,-48.0,-35.0,-42.0,-45.0,-43.0,-34.0,-42.0,-46.0,-87.0,-87.0,-84.0,-84.0,39.0,52.0,42.0,39.0,1
1351,62:47:05:9D:EB:15,3854145,497399002,6754,12183058,3847391,485215944,1,7004,3804805,6954,3797147,50,7658,3317,0,6823,56,1,125,216660.0,130000.0,-44.0,-46.0,-36.0,-48.0,-43.0,-45.0,-36.0,-48.0,-87.0,-87.0,-84.0,-84.0,43.0,41.0,48.0,36.0,1
1352,92:69:1D:31:68:E9,3851444,488869509,4053,3653565,3847391,485215944,1,5426,1159749,5254,1120661,172,39088,2206,12,4309,103,1,62,216660.0,130000.0,-52.0,-47.0,-42.0,-49.0,-51.0,-48.0,-43.0,-47.0,-87.0,-87.0,-84.0,-84.0,35.0,40.0,42.0,35.0,1
1353,CC:2F:71:3F:1F:24,5049753,1865527751,1202360,1380311605,3847393,485216146,1730,1008243,1145015211,1007399,1144913061,844,102150,975120,15,1200985,121224,1727,787,144444.0,43333.0,-69.0,-70.0,-68.0,-71.0,-69.0,-70.0,-67.0,-71.0,-87.0,-87.0,-84.0,-84.0,18.0,17.0,16.0,13.0,1
1354,CC:2F:71:3E:C5:1F,3848383,485337027,990,120881,3847393,485216146,2,4304,359111,3581,273267,723,85844,1049,13,1426,28,2,54,130000.0,39000.0,-72.0,-71.0,-70.0,-60.0,-74.0,-73.0,-71.0,-64.0,-87.0,-87.0,-84.0,-84.0,15.0,16.0,14.0,24.0,1
1355,BA:8C:B9:54:50:24,3852326,491410328,4933,6194182,3847393,485216146,7,9783,1753758,9761,1750263,22,3495,2358,18,5440,43,7,71,229410.0,130000.0,-48.0,-35.0,-42.0,-45.0,-43.0,-34.0,-42.0,-46.0,-87.0,-87.0,-84.0,-84.0,39.0,52.0,42.0,39.0,1
1356,62:47:05:9D:EB:15,3854150,497399466,6754,12183058,3847396,485216408,1,7004,3804805,6954,3797147,50,7658,3317,0,6823,56,1,125,216660.0,130000.0,-44.0,-46.0,-36.0,-48.0,-43.0,-45.0,-36.0,-48.0,-87.0,-87.0,-84.0,-84.0,43.0,41.0,48.0,36.0,1
1357,92:69:1D:31:68:E9,3851449,488869973,4053,3653565,3847396,485216408,1,5426,1159749,5254,1120661,172,39088,2206,12,4309,103,1,62,216660.0,130000.0,-52.0,-47.0,-42.0,-49.0,-51.0,-48.0,-43.0,-47.0,-87.0,-87.0,-84.0,-84.0,35.0,40.0,42.0,35.0,1
1358,CC:2F:71:3F:1F:24,5049954,1865772706,1202558,1380556298,3847396,485216408,1730,1008424,1145249264,1007580,1145147114,844,102150,975296,15,1201183,121227,1727,787,144444.0,43333.0,-70.0,-70.0,-68.0,-71.0,-69.0,-69.0,-68.0,-71.0,-87.0,-87.0,-84.0,-84.0,17.0,17.0,16.0,13.0,1
1359,CC:2F:71:3E:C5:1F,3848388,485337491,990,120881,3847398,485216610,2,4304,359111,3581,273267,723,85844,1049,13,1426,28,2,54,130000.0,39000.0,-72.0,-71.0,-70.0,-60.0,-74.0,-73.0,-71.0,-64.0,-87.0,-87.0,-84.0,-84.0,15.0,16.0,14.0,24.0,1
1360,BA:8C:B9:54:50:24,3852331,491410792,4933,6194182,3847398,485216610,7,9783,1753758,9761,1750263,22,3495,2358,18,5440,43,7,71,229410.0,130000.0,-48.0,-35.0,-42.0,-45.0,-43.0,-34.0,-42.0,-46.0,-87.0,-87.0,-84.0,-84.0,39.0,52.0,42.0,39.0,1
1361,62:47:05:9D:EB:15,3854154,497399870,6754,12183058,3847400,485216812,1,7004,3804805,6954,3797147,50,7658,3317,0,6823,56,1,125,216660.0,130000.0,-44.0,-46.0,-36.0,-48.0,-43.0,-45.0,-36.0,-48.0,-87.0,-87.0,-84.0,-84.0,43.0,41.0,48.0,36.0,1
1362,92:69:1D:31:68:E9,3851453,488870377,4053,3653565,3847400,485216812,1,5426,1159749,5254,1120661,172,39088,2206,12,4309,103,1,62,216660.0,130000.0,-52.0,-47.0,-42.0,-49.0,-51.0,-48.0,-43.0,-47.0,-87.0,-87.0,-84.0,-84.0,35.0,40.0,42.0,35.0,1
1363,CC:2F:71:3F:1F:24,5050149,1866014442,1202747,1380797428,3847402,485217014,1730,1008598,1145484776,1007754,1145382626,844,102150,975464,15,1201372,121228,1727,787,144444.0,43333.0,-69.0,-70.0,-67.0,-72.0,-69.0,-70.0,-67.0,-72.0,-86.0,-87.0,-83.0,-84.0,17.0,17.0,16.0,12.0,1
1364,CC:2F:71:3E:C5:1F,3848392,485337895,990,120881,3847402,485217014,2,4304,359111,3581,273267,723,85844,1049,13,1426,28,2,54,130000.0,39000.0,-72.0,-71.0,-70.0,-60.0,-74.0,-73.0,-71.0,-64.0,-86.0,-87.0,-83.0,-84.0,14.0,16.0,13.0,24.0,1
1365,BA:8C:B9:54:50:24,3852337,491411398,4933,6194182,3847404,485217216,7,9783,1753758,9761,1750263,22,3495,2358,18,5440,43,7,71,229410.0,130000.0,-48.0,-35.0,-42.0,-45.0,-43.0,-34.0,-42.0,-46.0,-86.0,-87.0,-83.0,-84.0,38.0,52.0,41.0,39.0,1
1366,62:47:05:9D:EB:15,3854159,497400334,6754,12183058,3847405,485217276,1,7005,3804873,6955,3797215,50,7658,3317,0,6823,56,1,125,216660.0,130000.0,-44.0,-45.0,-36.0,-49.0,-43.0,-45.0,-36.0,-48.0,-86.0,-87.0,-83.0,-84.0,42.0,42.0,47.0,35.0,1
1367,92:69:1D:31:68:E9,3851458,488870841,4053,3653565,3847405,485217276,1,5426,1159749,5254,1120661,172,39088,2206,12,4309,103,1,62,216660.0,130000.0,-52.0,-47.0,-42.0,-49.0,-51.0,-48.0,-43.0,-47.0,-86.0,-87.0,-83.0,-84.0,34.0,40.0,41.0,35.0,1
1368,CC:2F:71:3F:1F:24,5050345,1866256296,1202938,1381038818,3847407,485217478,1730,1008769,1145715598,1007925,1145613448,844,102150,975632,15,1201563,121228,1727,787,144444.0,43333.0,-69.0,-70.0,-67.0,-73.0,-69.0,-69.0,-67.0,-72.0,-86.0,-87.0,-83.0,-84.0,17.0,17.0,16.0,11.0,1
1369,CC:2F:71:3E:C5:1F,3848397,485338359,990,120881,3847407,485217478,2,4304,359111,3581,273267,723,85844,1049,13,1426,28,2,54,130000.0,39000.0,-72.0,-71.0,-70.0,-60.0,-74.0,-73.0,-71.0,-64.0,-86.0,-87.0,-83.0,-84.0,14.0,16.0,13.0,24.0,1
1370,BA:8C:B9:54:50:24,3852340,491411660,4933,6194182,3847407,485217478,7,9783,1753758,9761,1750263,22,3495,2358,18,5440,43,7,71,229410.0,130000.0,-48.0,-35.0,-42.0,-45.0,-43.0,-34.0,-42.0,-46.0,-86.0,-87.0,-83.0,-84.0,38.0,52.0,41.0,39.0,1
1371,62:47:05:9D:EB:15,3854163,497400738,6754,12183058,3847409,485217680,1,7005,3804873,6955,3797215,50,7658,3317,0,6823,56,1,125,216660.0,130000.0,-44.0,-45.0,-36.0,-49.0,-43.0,-45.0,-36.0,-48.0,-86.0,-87.0,-83.0,-84.0,42.0,42.0,47.0,35.0,1
1372,92:69:1D:31:68:E9,3851463,488871361,4054,3653681,3847409,485217680,1,5428,1159885,5256,1120797,172,39088,2206,12,4310,103,1,62,216660.0,130000.0,-52.0,-47.0,-43.0,-49.0,-51.0,-47.0,-43.0,-47.0,-86.0,-87.0,-83.0,-84.0,34.0,40.0,40.0,35.0,1
1373,CC:2F:71:3F:1F:24,5050540,1866498076,1203129,1381280194,3847411,485217882,1730,1008945,1145952894,1008101,1145850744,844,102150,975800,15,1201754,121228,1727,787,144444.0,43333.0,-69.0,-70.0,-67.0,-73.0,-69.0,-69.0,-67.0,-72.0,-86.0,-87.0,-83.0,-84.0,17.0,17.0,16.0,11.0,1
1374,CC:2F:71:3E:C5:1F,3848408,485339798,995,121714,3847413,485218084,2,4310,359926,3587,274082,723,85844,1054,13,1431,28,2,54,130000.0,39000.0,-72.0,-71.0,-69.0,-60.0,-72.0,-71.0,-69.0,-60.0,-86.0,-87.0,-83.0,-84.0,14.0,16.0,14.0,24.0,1
1375,BA:8C:B9:54:50:24,3852347,491412382,4934,6194298,3847413,485218084,7,9785,1753894,9763,1750399,22,3495,2358,18,5441,43,7,71,229410.0,130000.0,-40.0,-37.0,-46.0,-52.0,-44.0,-35.0,-43.0,-46.0,-86.0,-87.0,-83.0,-84.0,46.0,50.0,37.0,32.0,1
1376,62:47:05:9D:EB:15,3854168,497401258,6755,12183174,3847413,485218084,1,7007,3805009,6957,3797351,50,7658,3317,0,6824,56,1,125,216660.0,130000.0,-44.0,-45.0,-36.0,-50.0,-44.0,-45.0,-36.0,-49.0,-86.0,-87.0,-83.0,-84.0,42.0,42.0,47.0,34.0,1
1377,92:69:1D:31:68:E9,3851467,488871765,4054,3653681,3847413,485218084,1,5428,1159885,5256,1120797,172,39088,2206,12,4310,103,1,62,216660.0,130000.0,-52.0,-47.0,-43.0,-49.0,-51.0,-47.0,-43.0,-47.0,-86.0,-87.0,-83.0,-84.0,34.0,40.0,40.0,35.0,1
1378,CC:2F:71:3F:1F:24,5050743,1866747743,1203328,1381529457,3847415,485218286,1730,1009134,1146195322,1008290,1146093172,844,102150,975979,15,1201952,121228,1727,787,144444.0,43333.0,-69.0,-70.0,-67.0,-73.0,-69.0,-69.0,-67.0,-73.0,-86.0,-87.0,-83.0,-84.0,17.0,17.0,16.0,11.0,1
1379,CC:2F:71:3E:C5:1F,3848410,485340000,995,121714,3847415,485218286,2,4310,359926,3587,274082,723,85844,1054,13,1431,28,2,54,130000.0,39000.0,-72.0,-71.0,-69.0,-60.0,-72.0,-71.0,-69.0,-60.0,-86.0,-87.0,-83.0,-84.0,14.0,16.0,14.0,24.0,1
1380,BA:8C:B9:54:50:24,3852349,491412584,4934,6194298,3847415,485218286,7,9785,1753894,9763,1750399,22,3495,2358,18,5441,43,7,71,229410.0,130000.0,-40.0,-37.0,-46.0,-52.0,-44.0,-35.0,-43.0,-46.0,-86.0,-87.0,-83.0,-84.0,46.0,50.0,37.0,32.0,1
1381,62:47:05:9D:EB:15,3854176,497401986,6755,12183174,3847421,485218812,1,7007,3805009,6957,3797351,50,7658,3317,0,6824,56,1,125,216660.0,130000.0,-44.0,-45.0,-36.0,-50.0,-44.0,-45.0,-36.0,-49.0,-86.0,-87.0,-83.0,-84.0,42.0,42.0,47.0,34.0,1
1382,92:69:1D:31:68:E9,3851477,488872695,4054,3653681,3847423,485219014,1,5428,1159885,5256,1120797,172,39088,2206,12,4310,103,1,62,216660.0,130000.0,-52.0,-47.0,-43.0,-49.0,-51.0,-47.0,-43.0,-47.0,-86.0,-87.0,-83.0,-84.0,34.0,40.0,40.0,35.0,1
1383,CC:2F:71:3F:1F:24,5050942,1866991285,1203519,1381772271,3847423,485219014,1730,1009310,1146431088,1008465,1146328820,845,102268,976149,15,1202144,121228,1727,787,144444.0,43333.0,-69.0,-70.0,-67.0,-73.0,-69.0,-69.0,-67.0,-72.0,-86.0,-87.0,-83.0,-84.0,17.0,17.0,16.0,11.0,1
1384,CC:2F:71:3E:C5:1F,3848418,485340728,995,121714,3847423,485219014,2,4310,359926,3587,274082,723,85844,1054,13,1431,28,2,54,130000.0,39000.0,-72.0,-71.0,-69.0,-60.0,-72.0,-71.0,-69.0,-60.0,-86.0,-87.0,-83.0,-84.0,14.0,16.0,14.0,24.0,1
1385,BA:8C:B9:54:50:24,3852357,491413312,4934,6194298,3847423,485219014,7,9786,1753962,9764,1750467,22,3495,2358,18,5441,43,7,71,229410.0,130000.0,-40.0,-37.0,-45.0,-52.0,-44.0,-35.0,-43.0,-47.0,-86.0,-87.0,-83.0,-84.0,46.0,50.0,38.0,32.0,1
1386,62:47:05:9D:EB:15,3854179,497402461,6755,12183174,3847424,485219287,1,7007,3805009,6957,3797351,50,7658,3317,0,6824,56,1,125,216660.0,130000.0,-44.0,-45.0,-36.0,-50.0,-44.0,-45.0,-36.0,-49.0,-86.0,-87.0,-83.0,-84.0,42.0,42.0,47.0,34.0,1
1387,92:69:1D:31:68:E9,3851478,488872968,4054,3653681,3847424,485219287,1,5428,1159885,5256,1120797,172,39088,2206,12,4310,103,1,62,216660.0,130000.0,-52.0,-47.0,-43.0,-49.0,-51.0,-47.0,-43.0,-47.0,-86.0,-87.0,-83.0,-84.0,34.0,40.0,40.0,35.0,1
1388,CC:2F:71:3F:1F:24,5051135,1867232894,1203709,1382013405,3847426,485219489,1730,1009488,1146668450,1008643,1146566182,845,102268,976321,15,1202335,121238,1727,787,144444.0,43333.0,-69.0,-69.0,-67.0,-73.0,-69.0,-69.0,-66.0,-73.0,-86.0,-87.0,-83.0,-84.0,17.0,18.0,16.0,11.0,1
1389,CC:2F:71:3E:C5:1F,3848421,485341203,995,121714,3847426,485219489,2,4310,359926,3587,274082,723,85844,1054,13,1431,28,2,54,130000.0,39000.0,-72.0,-71.0,-69.0,-60.0,-72.0,-71.0,-69.0,-60.0,-86.0,-87.0,-83.0,-84.0,14.0,16.0,14.0,24.0,1
1390,BA:8C:B9:54:50:24,3852360,491413787,4934,6194298,3847426,485219489,7,9786,1753962,9764,1750467,22,3495,2358,18,5441,43,7,71,229410.0,130000.0,-40.0,-37.0,-45.0,-52.0,-44.0,-35.0,-43.0,-47.0,-86.0,-87.0,-83.0,-84.0,46.0,50.0,38.0,32.0,1
1391,62:47:05:9D:EB:15,3854188,497403329,6755,12183174,3847433,485220155,1,7007,3805009,6957,3797351,50,7658,3317,0,6824,56,1,125,216660.0,130000.0,-44.0,-45.0,-36.0,-50.0,-44.0,-45.0,-36.0,-49.0,-86.0,-87.0,-83.0,-84.0,42.0,42.0,47.0,34.0,1
1392,92:69:1D:31:68:E9,3851487,488873836,4054,3653681,3847433,485220155,1,5428,1159885,5256,1120797,172,39088,2206,12,4310,103,1,62,216660.0,130000.0,-52.0,-47.0,-43.0,-49.0,-51.0,-47.0,-43.0,-47.0,-86.0,-87.0,-83.0,-84.0,34.0,40.0,40.0,35.0,1
1393,CC:2F:71:3F:1F:24,5051333,1867474958,1203900,1382254803,3847433,485220155,1730,1009667,1146905130,1008822,1146802862,845,102268,976492,15,1202526,121239,1727,787,144444.0,43333.0,-69.0,-70.0,-68.0,-73.0,-69.0,-69.0,-67.0,-72.0,-86.0,-87.0,-83.0,-84.0,17.0,17.0,15.0,11.0,1
1394,CC:2F:71:3E:C5:1F,3848428,485341869,995,121714,3847433,485220155,2,4310,359926,3587,274082,723,85844,1054,13,1431,28,2,54,130000.0,39000.0,-72.0,-71.0,-69.0,-60.0,-72.0,-71.0,-69.0,-60.0,-86.0,-87.0,-83.0,-84.0,14.0,16.0,14.0,24.0,1
1395,BA:8C:B9:54:50:24,3852367,491414453,4934,6194298,3847433,485220155,7,9786,1753962,9764,1750467,22,3495,2358,18,5441,43,7,71,229410.0,130000.0,-40.0,-37.0,-45.0,-52.0,-44.0,-35.0,-43.0,-47.0,-86.0,-87.0,-83.0,-84.0,46.0,50.0,38.0,32.0,1
1396,62:47:05:9D:EB:15,3854188,497403329,6755,12183174,3847433,485220155,1,7007,3805009,6957,3797351,50,7658,3317,0,6824,56,1,125,216660.0,130000.0,-44.0,-45.0,-36.0,-50.0,-44.0,-45.0,-36.0,-49.0,-86.0,-87.0,-83.0,-84.0,42.0,42.0,47.0,34.0,1
1397,92:69:1D:31:68:E9,3851487,488873836,4054,3653681,3847433,485220155,1,5428,1159885,5256,1120797,172,39088,2206,12,4310,103,1,62,216660.0,130000.0,-52.0,-47.0,-43.0,-49.0,-51.0,-47.0,-43.0,-47.0,-86.0,-87.0,-83.0,-84.0,34.0,40.0,40.0,35.0,1
1398,CC:2F:71:3F:1F:24,5051532,1867721307,1204097,1382500950,3847435,485220357,1730,1009847,1147142810,1009002,1147040542,845,102268,976664,15,1202723,121239,1727,787,144444.0,43333.0,-69.0,-69.0,-67.0,-72.0,-69.0,-69.0,-67.0,-72.0,-86.0,-87.0,-83.0,-84.0,17.0,18.0,16.0,12.0,1
1399,CC:2F:71:3E:C5:1F,3848430,485342071,995,121714,3847435,485220357,2,4310,359926,3587,274082,723,85844,1054,13,1431,28,2,54,130000.0,39000.0,-72.0,-71.0,-69.0,-60.0,-72.0,-71.0,-69.0,-60.0,-86.0,-87.0,-83.0,-84.0,14.0,16.0,14.0,24.0,1
1400,BA:8C:B9:54:50:24,3852369,491414655,4934,6194298,3847435,485220357,7,9786,1753962,9764,1750467,22,3495,2358,18,5441,43,7,71,229410.0,130000.0,-40.0,-37.0,-45.0,-52.0,-44.0,-35.0,-43.0,-47.0,-86.0,-87.0,-83.0,-84.0,46.0,50.0,38.0,32.0,1
1401,62:47:05:9D:EB:15,3854196,497404137,6755,12183174,3847441,485220963,1,7007,3805009,6957,3797351,50,7658,3317,0,6824,56,1,125,216660.0,130000.0,-44.0,-45.0,-36.0,-50.0,-44.0,-45.0,-36.0,-49.0,-86.0,-87.0,-84.0,-84.0,42.0,42.0,48.0,34.0,1
1402,92:69:1D:31:68:E9,3851495,488874644,4054,3653681,3847441,485220963,1,5428,1159885,5256,1120797,172,39088,2206,12,4310,103,1,62,216660.0,130000.0,-52.0,-47.0,-43.0,-49.0,-51.0,-47.0,-43.0,-47.0,-86.0,-87.0,-84.0,-84.0,34.0,40.0,41.0,35.0,1
1403,CC:2F:71:3F:1F:24,5051726,1867961489,1204285,1382740526,3847441,485220963,1730,1010018,1147373688,1009173,1147271420,845,102268,976832,15,1202911,121241,1727,787,144444.0,43333.0,-69.0,-69.0,-68.0,-73.0,-69.0,-69.0,-67.0,-72.0,-86.0,-87.0,-84.0,-84.0,17.0,18.0,16.0,11.0,1
1404,CC:2F:71:3E:C5:1F,3848436,485342677,995,121714,3847441,485220963,2,4310,359926,3587,274082,723,85844,1054,13,1431,28,2,54,130000.0,39000.0,-72.0,-71.0,-69.0,-60.0,-72.0,-71.0,-69.0,-60.0,-86.0,-87.0,-84.0,-84.0,14.0,16.0,15.0,24.0,1
1405,BA:8C:B9:54:50:24,3852375,491415261,4934,6194298,3847441,485220963,7,9786,1753962,9764,1750467,22,3495,2358,18,5441,43,7,71,229410.0,130000.0,-40.0,-37.0,-45.0,-52.0,-44.0,-35.0,-43.0,-47.0,-86.0,-87.0,-84.0,-84.0,46.0,50.0,39.0,32.0,1
1406,62:47:05:9D:EB:15,3854198,497404259,6755,12183174,3847443,485221085,1,7007,3805009,6957,3797351,50,7658,3317,0,6824,56,1,125,216660.0,130000.0,-44.0,-45.0,-36.0,-50.0,-44.0,-45.0,-36.0,-49.0,-86.0,-87.0,-84.0,-84.0,42.0,42.0,48.0,34.0,1
1407,92:69:1D:31:68:E9,3851499,488874968,4054,3653681,3847445,485221287,1,5428,1159885,5256,1120797,172,39088,2206,12,4310,103,1,62,216660.0,130000.0,-52.0,-47.0,-43.0,-49.0,-51.0,-47.0,-43.0,-47.0,-86.0,-87.0,-84.0,-84.0,34.0,40.0,41.0,35.0,1
1408,CC:2F:71:3F:1F:24,5051920,1868204497,1204475,1382983210,3847445,485221287,1730,1010189,1147603162,1009344,1147500894,845,102268,977000,15,1203101,121242,1727,787,144444.0,43333.0,-69.0,-70.0,-67.0,-73.0,-69.0,-69.0,-67.0,-73.0,-86.0,-87.0,-84.0,-84.0,17.0,17.0,17.0,11.0,1
1409,CC:2F:71:3E:C5:1F,3848441,485343117,996,121830,3847445,485221287,2,4316,360430,3592,274468,724,85962,1056,13,1432,28,2,54,130000.0,39000.0,-67.0,-68.0,-65.0,-60.0,-72.0,-72.0,-69.0,-61.0,-86.0,-87.0,-84.0,-84.0,19.0,19.0,19.0,24.0,1
1410,BA:8C:B9:54:50:24,3852379,491415585,4934,6194298,3847445,485221287,7,9786,1753962,9764,1750467,22,3495,2358,18,5441,43,7,71,229410.0,130000.0,-40.0,-37.0,-45.0,-52.0,-44.0,-35.0,-43.0,-47.0,-86.0,-87.0,-84.0,-84.0,46.0,50.0,39.0,32.0,1
1411,62:47:05:9D:EB:15,3854206,497405067,6755,12183174,3847451,485221893,1,7007,3805009,6957,3797351,50,7658,3317,0,6824,56,1,125,216660.0,130000.0,-44.0,-45.0,-36.0,-50.0,-44.0,-45.0,-36.0,-49.0,-86.0,-87.0,-84.0,-84.0,42.0,42.0,48.0,34.0,1
1412,92:69:1D:31:68:E9,3851505,488875574,4054,3653681,3847451,485221893,1,5428,1159885,5256,1120797,172,39088,2206,12,4310,103,1,62,216660.0,130000.0,-52.0,-47.0,-43.0,-49.0,-51.0,-47.0,-43.0,-47.0,-86.0,-87.0,-84.0,-84.0,34.0,40.0,41.0,35.0,1
1413,CC:2F:71:3F:1F:24,5052126,1868452225,1204675,1383230332,3847451,485221893,1730,1010384,1147850544,1009539,1147748276,845,102268,977183,15,1203301,121243,1727,787,144444.0,43333.0,-69.0,-70.0,-67.0,-73.0,-69.0,-69.0,-66.0,-72.0,-86.0,-87.0,-84.0,-84.0,17.0,17.0,17.0,11.0,1
1414,CC:2F:71:3E:C5:1F,3848447,485343723,996,121830,3847451,485221893,2,4316,360430,3592,274468,724,85962,1056,13,1432,28,2,54,130000.0,39000.0,-67.0,-68.0,-65.0,-60.0,-72.0,-72.0,-69.0,-61.0,-86.0,-87.0,-84.0,-84.0,19.0,19.0,19.0,24.0,1
1415,BA:8C:B9:54:50:24,3852385,491416191,4934,6194298,3847451,485221893,7,9786,1753962,9764,1750467,22,3495,2358,18,5441,43,7,71,229410.0,130000.0,-40.0,-37.0,-45.0,-52.0,-44.0,-35.0,-43.0,-47.0,-86.0,-87.0,-84.0,-84.0,46.0,50.0,39.0,32.0,1
1416,62:47:05:9D:EB:15,3854209,497405329,6755,12183174,3847454,485222155,1,7007,3805009,6957,3797351,50,7658,3317,0,6824,56,1,125,216660.0,130000.0,-44.0,-45.0,-36.0,-50.0,-44.0,-45.0,-36.0,-49.0,-86.0,-87.0,-84.0,-84.0,42.0,42.0,48.0,34.0,1
1417,92:69:1D:31:68:E9,3851508,488875836,4054,3653681,3847454,485222155,1,5428,1159885,5256,1120797,172,39088,2206,12,4310,103,1,62,216660.0,130000.0,-52.0,-47.0,-43.0,-49.0,-51.0,-47.0,-43.0,-47.0,-86.0,-87.0,-84.0,-84.0,34.0,40.0,41.0,35.0,1
1418,CC:2F:71:3F:1F:24,5052320,1868693901,1204866,1383471746,3847454,485222155,1730,1010559,1148086214,1009714,1147983946,845,102268,977352,15,1203492,121243,1727,787,144444.0,43333.0,-69.0,-70.0,-67.0,-73.0,-69.0,-69.0,-66.0,-72.0,-86.0,-87.0,-84.0,-84.0,17.0,17.0,17.0,11.0,1
1419,CC:2F:71:3E:C5:1F,3848450,485343985,996,121830,3847454,485222155,2,4316,360430,3592,274468,724,85962,1056,13,1432,28,2,54,130000.0,39000.0,-67.0,-68.0,-65.0,-60.0,-72.0,-72.0,-69.0,-61.0,-86.0,-87.0,-84.0,-84.0,19.0,19.0,19.0,24.0,1
1420,BA:8C:B9:54:50:24,3852388,491416453,4934,6194298,3847454,485222155,7,9786,1753962,9764,1750467,22,3495,2358,18,5441,43,7,71,229410.0,130000.0,-40.0,-37.0,-45.0,-52.0,-44.0,-35.0,-43.0,-47.0,-86.0,-87.0,-84.0,-84.0,46.0,50.0,39.0,32.0,1
1421,62:47:05:9D:EB:15,3854215,497405935,6755,12183174,3847460,485222761,1,7007,3805009,6957,3797351,50,7658,3317,0,6824,56,1,125,216660.0,130000.0,-44.0,-45.0,-36.0,-50.0,-44.0,-45.0,-36.0,-49.0,-86.0,-87.0,-84.0,-84.0,42.0,42.0,48.0,34.0,1
1422,92:69:1D:31:68:E9,3851514,488876442,4054,3653681,3847460,485222761,1,5428,1159885,5256,1120797,172,39088,2206,12,4310,103,1,62,216660.0,130000.0,-52.0,-47.0,-43.0,-49.0,-51.0,-47.0,-43.0,-47.0,-86.0,-87.0,-84.0,-84.0,34.0,40.0,41.0,35.0,1
1423,CC:2F:71:3F:1F:24,5052515,1868935525,1205055,1383712764,3847460,485222761,1730,1010736,1148324922,1009891,1148222654,845,102268,977521,15,1203681,121251,1727,787,144444.0,43333.0,-69.0,-69.0,-65.0,-71.0,-69.0,-69.0,-65.0,-71.0,-86.0,-87.0,-84.0,-84.0,17.0,18.0,19.0,13.0,1
1424,CC:2F:71:3E:C5:1F,3848456,485344591,996,121830,3847460,485222761,2,4316,360430,3592,274468,724,85962,1056,13,1432,28,2,54,130000.0,39000.0,-67.0,-68.0,-65.0,-60.0,-72.0,-72.0,-69.0,-61.0,-86.0,-87.0,-84.0,-84.0,19.0,19.0,19.0,24.0,1
1425,BA:8C:B9:54:50:24,3852394,491417059,4934,6194298,3847460,485222761,7,9786,1753962,9764,1750467,22,3495,2358,18,5441,43,7,71,229410.0,130000.0,-40.0,-37.0,-45.0,-52.0,-44.0,-35.0,-43.0,-47.0,-86.0,-87.0,-84.0,-84.0,46.0,50.0,39.0,32.0,1
1426,62:47:05:9D:EB:15,3854217,497406137,6755,12183174,3847462,485222963,1,7007,3805009,6957,3797351,50,7658,3317,0,6824,56,1,125,216660.0,130000.0,-44.0,-45.0,-36.0,-50.0,-44.0,-45.0,-36.0,-49.0,-86.0,-87.0,-84.0,-84.0,42.0,42.0,48.0,34.0,1
1427,92:69:1D:31:68:E9,3851516,488876644,4054,3653681,3847462,485222963,1,5428,1159885,5256,1120797,172,39088,2206,12,4310,103,1,62,216660.0,130000.0,-52.0,-47.0,-43.0,-49.0,-51.0,-47.0,-43.0,-47.0,-86.0,-87.0,-84.0,-84.0,34.0,40.0,41.0,35.0,1
1428,CC:2F:71:3F:1F:24,5052706,1869176857,1205244,1383953894,3847462,485222963,1730,1010915,1148565376,1010070,1148463108,845,102268,977689,15,1203870,121251,1727,787,144444.0,43333.0,-70.0,-70.0,-66.0,-71.0,-69.0,-70.0,-65.0,-71.0,-86.0,-87.0,-84.0,-84.0,16.0,17.0,18.0,13.0,1
1429,CC:2F:71:3E:C5:1F,3848458,485344793,996,121830,3847462,485222963,2,4316,360430,3592,274468,724,85962,1056,13,1432,28,2,54,130000.0,39000.0,-67.0,-68.0,-65.0,-60.0,-72.0,-72.0,-69.0,-61.0,-86.0,-87.0,-84.0,-84.0,19.0,19.0,19.0,24.0,1
1430,BA:8C:B9:54:50:24,3852396,491417261,4934,6194298,3847462,485222963,7,9786,1753962,9764,1750467,22,3495,2358,18,5441,43,7,71,229410.0,130000.0,-40.0,-37.0,-45.0,-52.0,-44.0,-35.0,-43.0,-47.0,-86.0,-87.0,-84.0,-84.0,46.0,50.0,39.0,32.0,1
1431,62:47:05:9D:EB:15,3854224,497406803,6755,12183174,3847469,485223629,1,7008,3805077,6958,3797419,50,7658,3317,0,6825,56,1,125,216660.0,130000.0,-44.0,-45.0,-36.0,-49.0,-44.0,-45.0,-35.0,-49.0,-87.0,-87.0,-84.0,-84.0,43.0,42.0,48.0,35.0,1
1432,92:69:1D:31:68:E9,3851523,488877310,4054,3653681,3847469,485223629,1,5428,1159885,5256,1120797,172,39088,2206,12,4310,103,1,62,216660.0,130000.0,-52.0,-47.0,-43.0,-49.0,-51.0,-47.0,-43.0,-47.0,-87.0,-87.0,-84.0,-84.0,35.0,40.0,41.0,35.0,1
1433,CC:2F:71:3F:1F:24,5052910,1869420892,1205441,1384197263,3847469,485223629,1730,1011096,1148796486,1010251,1148694218,845,102268,977866,15,1204067,121251,1727,787,144444.0,43333.0,-70.0,-70.0,-65.0,-71.0,-69.0,-69.0,-64.0,-70.0,-87.0,-87.0,-84.0,-84.0,17.0,17.0,19.0,13.0,1
1434,CC:2F:71:3E:C5:1F,3848465,485345459,996,121830,3847469,485223629,2,4316,360430,3592,274468,724,85962,1056,13,1432,28,2,54,130000.0,39000.0,-67.0,-68.0,-65.0,-60.0,-72.0,-72.0,-69.0,-61.0,-87.0,-87.0,-84.0,-84.0,20.0,19.0,19.0,24.0,1
1435,BA:8C:B9:54:50:24,3852403,491417927,4934,6194298,3847469,485223629,7,9790,1754234,9768,1750739,22,3495,2358,18,5442,43,7,72,229410.0,130000.0,-48.0,-35.0,-42.0,-45.0,-44.0,-36.0,-44.0,-48.0,-87.0,-87.0,-84.0,-84.0,39.0,52.0,42.0,39.0,1
1436,62:47:05:9D:EB:15,3854226,497407005,6755,12183174,3847471,485223831,1,7009,3805145,6959,3797487,50,7658,3317,0,6825,56,1,125,216660.0,130000.0,-45.0,-48.0,-44.0,-46.0,-44.0,-45.0,-36.0,-48.0,-87.0,-87.0,-84.0,-84.0,42.0,39.0,40.0,38.0,1
1437,92:69:1D:31:68:E9,3851525,488877512,4054,3653681,3847471,485223831,1,5430,1160021,5258,1120933,172,39088,2206,12,4311,103,1,62,216660.0,130000.0,-51.0,-48.0,-44.0,-45.0,-51.0,-47.0,-43.0,-47.0,-87.0,-87.0,-84.0,-84.0,36.0,39.0,40.0,39.0,1
1438,CC:2F:71:3F:1F:24,5053103,1869663894,1205632,1384440063,3847471,485223831,1730,1011268,1149027400,1010423,1148925132,845,102268,978036,15,1204258,121251,1727,787,144444.0,43333.0,-70.0,-70.0,-65.0,-71.0,-70.0,-69.0,-65.0,-70.0,-87.0,-87.0,-84.0,-84.0,17.0,17.0,19.0,13.0,1
1439,CC:2F:71:3E:C5:1F,3848469,485345863,996,121830,3847473,485224033,2,4316,360430,3592,274468,724,85962,1056,13,1432,28,2,54,130000.0,39000.0,-67.0,-68.0,-65.0,-60.0,-72.0,-72.0,-69.0,-61.0,-87.0,-87.0,-84.0,-84.0,20.0,19.0,19.0,24.0,1
1440,BA:8C:B9:54:50:24,3852407,491418331,4934,6194298,3847473,485224033,7,9790,1754234,9768,1750739,22,3495,2358,18,5442,43,7,72,229410.0,130000.0,-48.0,-35.0,-42.0,-45.0,-44.0,-36.0,-44.0,-48.0,-87.0,-87.0,-84.0,-84.0,39.0,52.0,42.0,39.0,1
1441,62:47:05:9D:EB:15,3854233,497407671,6755,12183174,3847478,485224497,1,7009,3805145,6959,3797487,50,7658,3317,0,6825,56,1,125,216660.0,130000.0,-45.0,-48.0,-44.0,-46.0,-44.0,-45.0,-36.0,-48.0,-87.0,-87.0,-84.0,-84.0,42.0,39.0,40.0,38.0,1
1442,92:69:1D:31:68:E9,3851532,488878178,4054,3653681,3847478,485224497,1,5430,1160021,5258,1120933,172,39088,2206,12,4311,103,1,62,216660.0,130000.0,-51.0,-48.0,-44.0,-45.0,-51.0,-47.0,-43.0,-47.0,-87.0,-87.0,-84.0,-84.0,36.0,39.0,40.0,39.0,1
1443,CC:2F:71:3F:1F:24,5053299,1869905690,1205821,1384681193,3847478,485224497,1730,1011442,1149260246,1010597,1149157978,845,102268,978205,15,1204447,121255,1727,787,144444.0,43333.0,-70.0,-70.0,-65.0,-72.0,-69.0,-70.0,-65.0,-71.0,-87.0,-87.0,-84.0,-84.0,17.0,17.0,19.0,12.0,1
1444,CC:2F:71:3E:C5:1F,3848474,485346327,996,121830,3847478,485224497,2,4316,360430,3592,274468,724,85962,1056,13,1432,28,2,54,130000.0,39000.0,-67.0,-68.0,-65.0,-60.0,-72.0,-72.0,-69.0,-61.0,-87.0,-87.0,-84.0,-84.0,20.0,19.0,19.0,24.0,1
1445,BA:8C:B9:54:50:24,3852412,491418795,4934,6194298,3847478,485224497,7,9790,1754234,9768,1750739,22,3495,2358,18,5442,43,7,72,229410.0,130000.0,-48.0,-35.0,-42.0,-45.0,-44.0,-36.0,-44.0,-48.0,-87.0,-87.0,-84.0,-84.0,39.0,52.0,42.0,39.0,1
1446,62:47:05:9D:EB:15,3854235,497407873,6755,12183174,3847480,485224699,1,7009,3805145,6959,3797487,50,7658,3317,0,6825,56,1,125,216660.0,130000.0,-45.0,-48.0,-44.0,-46.0,-44.0,-45.0,-36.0,-48.0,-87.0,-87.0,-84.0,-84.0,42.0,39.0,40.0,38.0,1
1447,92:69:1D:31:68:E9,3851534,488878380,4054,3653681,3847480,485224699,1,5430,1160021,5258,1120933,172,39088,2206,12,4311,103,1,62,216660.0,130000.0,-51.0,-48.0,-44.0,-45.0,-51.0,-47.0,-43.0,-47.0,-87.0,-87.0,-84.0,-84.0,36.0,39.0,40.0,39.0,1
1448,CC:2F:71:3F:1F:24,5053497,1870153609,1206015,1384928708,3847482,485224901,1730,1011622,1149502161,1010777,1149399893,845,102268,978379,15,1204641,121257,1727,787,144444.0,43333.0,-70.0,-70.0,-66.0,-71.0,-70.0,-70.0,-65.0,-71.0,-87.0,-87.0,-84.0,-84.0,17.0,17.0,18.0,13.0,1
1449,CC:2F:71:3E:C5:1F,3848478,485346731,996,121830,3847482,485224901,2,4316,360430,3592,274468,724,85962,1056,13,1432,28,2,54,130000.0,39000.0,-67.0,-68.0,-65.0,-60.0,-72.0,-72.0,-69.0,-61.0,-87.0,-87.0,-84.0,-84.0,20.0,19.0,19.0,24.0,1
1450,BA:8C:B9:54:50:24,3852419,491419674,4934,6194298,3847485,485225376,7,9790,1754234,9768,1750739,22,3495,2358,18,5442,43,7,72,229410.0,130000.0,-48.0,-35.0,-42.0,-45.0,-44.0,-36.0,-44.0,-48.0,-87.0,-87.0,-84.0,-84.0,39.0,52.0,42.0,39.0,1
1451,62:47:05:9D:EB:15,3854242,497408752,6755,12183174,3847487,485225578,1,7009,3805145,6959,3797487,50,7658,3317,0,6825,56,1,125,216660.0,130000.0,-45.0,-48.0,-44.0,-46.0,-44.0,-45.0,-36.0,-48.0,-87.0,-87.0,-84.0,-84.0,42.0,39.0,40.0,38.0,1
1452,92:69:1D:31:68:E9,3851541,488879259,4054,3653681,3847487,485225578,1,5430,1160021,5258,1120933,172,39088,2206,12,4311,103,1,62,216660.0,130000.0,-51.0,-48.0,-44.0,-45.0,-51.0,-47.0,-43.0,-47.0,-87.0,-87.0,-84.0,-84.0,36.0,39.0,40.0,39.0,1
1453,CC:2F:71:3F:1F:24,5053698,1870398887,1206211,1385173309,3847487,485225578,1730,1011799,1149732774,1010954,1149630506,845,102268,978554,15,1204836,121259,1727,787,144444.0,43333.0,-70.0,-70.0,-65.0,-71.0,-69.0,-70.0,-65.0,-71.0,-87.0,-87.0,-84.0,-84.0,17.0,17.0,19.0,13.0,1
1454,CC:2F:71:3E:C5:1F,3848483,485347408,996,121830,3847487,485225578,2,4316,360430,3592,274468,724,85962,1056,13,1432,28,2,54,130000.0,39000.0,-67.0,-68.0,-65.0,-60.0,-72.0,-72.0,-69.0,-61.0,-87.0,-87.0,-84.0,-84.0,20.0,19.0,19.0,24.0,1
1455,BA:8C:B9:54:50:24,3852421,491419876,4934,6194298,3847487,485225578,7,9790,1754234,9768,1750739,22,3495,2358,18,5442,43,7,72,229410.0,130000.0,-48.0,-35.0,-42.0,-45.0,-44.0,-36.0,-44.0,-48.0,-87.0,-87.0,-84.0,-84.0,39.0,52.0,42.0,39.0,1
1456,62:47:05:9D:EB:15,3854245,497409014,6755,12183174,3847490,485225840,1,7009,3805145,6959,3797487,50,7658,3317,0,6825,56,1,125,216660.0,130000.0,-45.0,-48.0,-44.0,-46.0,-44.0,-45.0,-36.0,-48.0,-87.0,-87.0,-84.0,-84.0,42.0,39.0,40.0,38.0,1
1457,92:69:1D:31:68:E9,3851546,488879723,4054,3653681,3847492,485226042,1,5430,1160021,5258,1120933,172,39088,2206,12,4311,103,1,62,216660.0,130000.0,-51.0,-48.0,-44.0,-45.0,-51.0,-47.0,-43.0,-47.0,-87.0,-87.0,-84.0,-84.0,36.0,39.0,40.0,39.0,1
1458,CC:2F:71:3F:1F:24,5053896,1870643623,1206402,1385417379,3847494,485226244,1730,1011982,1149979544,1011137,1149877276,845,102268,978724,15,1205028,121259,1727,787,144444.0,43333.0,-70.0,-70.0,-65.0,-72.0,-70.0,-70.0,-65.0,-71.0,-87.0,-87.0,-84.0,-84.0,17.0,17.0,19.0,12.0,1
1459,CC:2F:71:3E:C5:1F,3848490,485348074,996,121830,3847494,485226244,2,4316,360430,3592,274468,724,85962,1056,13,1432,28,2,54,130000.0,39000.0,-67.0,-68.0,-65.0,-60.0,-72.0,-72.0,-69.0,-61.0,-87.0,-87.0,-84.0,-84.0,20.0,19.0,19.0,24.0,1
1460,BA:8C:B9:54:50:24,3852430,491420744,4934,6194298,3847496,485226446,7,9790,1754234,9768,1750739,22,3495,2358,18,5442,43,7,72,229410.0,130000.0,-48.0,-35.0,-42.0,-45.0,-44.0,-36.0,-44.0,-48.0,-87.0,-87.0,-84.0,-84.0,39.0,52.0,42.0,39.0,1
1461,62:47:05:9D:EB:15,3854251,497409620,6755,12183174,3847496,485226446,1,7009,3805145,6959,3797487,50,7658,3317,0,6825,56,1,125,216660.0,130000.0,-45.0,-48.0,-44.0,-46.0,-44.0,-45.0,-36.0,-48.0,-87.0,-87.0,-84.0,-84.0,42.0,39.0,40.0,38.0,1
1462,92:69:1D:31:68:E9,3851550,488880127,4054,3653681,3847496,485226446,1,5430,1160021,5258,1120933,172,39088,2206,12,4311,103,1,62,216660.0,130000.0,-51.0,-48.0,-44.0,-45.0,-51.0,-47.0,-43.0,-47.0,-87.0,-87.0,-84.0,-84.0,36.0,39.0,40.0,39.0,1
1463,CC:2F:71:3F:1F:24,5054087,1870884955,1206591,1385658509,3847496,485226446,1730,1012154,1150211920,1011309,1150109652,845,102268,978892,15,1205217,121259,1727,787,144444.0,43333.0,-69.0,-70.0,-65.0,-71.0,-69.0,-70.0,-65.0,-71.0,-87.0,-87.0,-84.0,-84.0,18.0,17.0,19.0,13.0,1
1464,CC:2F:71:3E:C5:1F,3848492,485348276,996,121830,3847496,485226446,2,4316,360430,3592,274468,724,85962,1056,13,1432,28,2,54,130000.0,39000.0,-67.0,-68.0,-65.0,-60.0,-72.0,-72.0,-69.0,-61.0,-87.0,-87.0,-84.0,-84.0,20.0,19.0,19.0,24.0,1
1465,BA:8C:B9:54:50:24,3852430,491420744,4934,6194298,3847496,485226446,7,9790,1754234,9768,1750739,22,3495,2358,18,5442,43,7,72,229410.0,130000.0,-48.0,-35.0,-42.0,-45.0,-44.0,-36.0,-44.0,-48.0,-87.0,-87.0,-84.0,-84.0,39.0,52.0,42.0,39.0,1
1466,62:47:05:9D:EB:15,3854258,497410286,6755,12183174,3847503,485227112,1,7009,3805145,6959,3797487,50,7658,3317,0,6825,56,1,125,216660.0,130000.0,-45.0,-48.0,-44.0,-46.0,-44.0,-45.0,-36.0,-48.0,-87.0,-87.0,-84.0,-84.0,42.0,39.0,40.0,38.0,1
1467,92:69:1D:31:68:E9,3851557,488880793,4054,3653681,3847503,485227112,1,5430,1160021,5258,1120933,172,39088,2206,12,4311,103,1,62,216660.0,130000.0,-51.0,-48.0,-44.0,-45.0,-51.0,-47.0,-43.0,-47.0,-87.0,-87.0,-84.0,-84.0,36.0,39.0,40.0,39.0,1
1468,CC:2F:71:3F:1F:24,5054283,1871126751,1206780,1385899639,3847503,485227112,1730,1012330,1150444870,1011485,1150342602,845,102268,979063,15,1205406,121260,1727,787,144444.0,43333.0,-70.0,-70.0,-65.0,-71.0,-69.0,-69.0,-65.0,-71.0,-87.0,-87.0,-84.0,-84.0,17.0,17.0,19.0,13.0,1
1469,CC:2F:71:3E:C5:1F,3848501,485349144,996,121830,3847505,485227314,2,4316,360430,3592,274468,724,85962,1056,13,1432,28,2,54,130000.0,39000.0,-67.0,-68.0,-65.0,-60.0,-72.0,-72.0,-69.0,-61.0,-87.0,-87.0,-84.0,-84.0,20.0,19.0,19.0,24.0,1
1470,BA:8C:B9:54:50:24,3852439,491421612,4934,6194298,3847505,485227314,7,9790,1754234,9768,1750739,22,3495,2358,18,5442,43,7,72,229410.0,130000.0,-48.0,-35.0,-42.0,-45.0,-44.0,-36.0,-44.0,-48.0,-87.0,-87.0,-84.0,-84.0,39.0,52.0,42.0,39.0,1
1471,62:47:05:9D:EB:15,3854260,497410488,6755,12183174,3847505,485227314,1,7009,3805145,6959,3797487,50,7658,3317,0,6825,56,1,125,216660.0,130000.0,-45.0,-48.0,-44.0,-46.0,-44.0,-45.0,-36.0,-48.0,-87.0,-87.0,-84.0,-84.0,42.0,39.0,40.0,38.0,1
1472,92:69:1D:31:68:E9,3851559,488880995,4054,3653681,3847505,485227314,1,5430,1160021,5258,1120933,172,39088,2206,12,4311,103,1,62,216660.0,130000.0,-51.0,-48.0,-44.0,-45.0,-51.0,-47.0,-43.0,-47.0,-87.0,-87.0,-84.0,-84.0,36.0,39.0,40.0,39.0,1
1473,CC:2F:71:3F:1F:24,5054486,1871377900,1206981,1386150586,3847505,485227314,1730,1012520,1150686564,1011675,1150584296,845,102268,979243,15,1205607,121260,1727,788,144444.0,43333.0,-70.0,-70.0,-65.0,-71.0,-69.0,-70.0,-65.0,-71.0,-87.0,-87.0,-84.0,-84.0,17.0,17.0,19.0,13.0,1
1474,CC:2F:71:3E:C5:1F,3848501,485349144,996,121830,3847505,485227314,2,4316,360430,3592,274468,724,85962,1056,13,1432,28,2,54,130000.0,39000.0,-67.0,-68.0,-65.0,-60.0,-72.0,-72.0,-69.0,-61.0,-87.0,-87.0,-84.0,-84.0,20.0,19.0,19.0,24.0,1
1475,BA:8C:B9:54:50:24,3852439,491421612,4934,6194298,3847505,485227314,7,9790,1754234,9768,1750739,22,3495,2358,18,5442,43,7,72,229410.0,130000.0,-48.0,-35.0,-42.0,-45.0,-44.0,-36.0,-44.0,-48.0,-87.0,-87.0,-84.0,-84.0,39.0,52.0,42.0,39.0,1
1476,62:47:05:9D:EB:15,3854266,497411094,6755,12183174,3847511,485227920,1,7009,3805145,6959,3797487,50,7658,3317,0,6825,56,1,125,216660.0,130000.0,-45.0,-48.0,-44.0,-46.0,-44.0,-45.0,-36.0,-48.0,-87.0,-87.0,-84.0,-84.0,42.0,39.0,40.0,38.0,1
1477,92:69:1D:31:68:E9,3851565,488881601,4054,3653681,3847511,485227920,1,5430,1160021,5258,1120933,172,39088,2206,12,4311,103,1,62,216660.0,130000.0,-51.0,-48.0,-44.0,-45.0,-51.0,-47.0,-43.0,-47.0,-87.0,-87.0,-84.0,-84.0,36.0,39.0,40.0,39.0,1
1478,CC:2F:71:3F:1F:24,5054682,1871618300,1207169,1386390178,3847513,485228122,1730,1012696,1150920870,1011851,1150818602,845,102268,979412,15,1205794,121260,1727,788,144444.0,43333.0,-70.0,-70.0,-65.0,-71.0,-70.0,-70.0,-65.0,-71.0,-87.0,-87.0,-84.0,-84.0,17.0,17.0,19.0,13.0,1
1479,CC:2F:71:3E:C5:1F,3848509,485349952,996,121830,3847513,485228122,2,4316,360430,3592,274468,724,85962,1056,13,1432,28,2,54,130000.0,39000.0,-67.0,-68.0,-65.0,-60.0,-72.0,-72.0,-69.0,-61.0,-87.0,-87.0,-84.0,-84.0,20.0,19.0,19.0,24.0,1
1480,BA:8C:B9:54:50:24,3852447,491422420,4934,6194298,3847513,485228122,7,9790,1754234,9768,1750739,22,3495,2358,18,5442,43,7,72,229410.0,130000.0,-48.0,-35.0,-42.0,-45.0,-44.0,-36.0,-44.0,-48.0,-87.0,-87.0,-84.0,-84.0,39.0,52.0,42.0,39.0,1
1481,62:47:05:9D:EB:15,3854269,497411356,6755,12183174,3847514,485228182,1,7009,3805145,6959,3797487,50,7658,3317,0,6825,56,1,125,216660.0,130000.0,-45.0,-48.0,-44.0,-46.0,-44.0,-45.0,-36.0,-48.0,-87.0,-87.0,-84.0,-84.0,42.0,39.0,40.0,38.0,1
1482,92:69:1D:31:68:E9,3851568,488881863,4054,3653681,3847514,485228182,1,5431,1160089,5259,1121001,172,39088,2206,12,4311,103,1,62,216660.0,130000.0,-51.0,-48.0,-44.0,-45.0,-51.0,-47.0,-43.0,-47.0,-87.0,-87.0,-84.0,-84.0,36.0,39.0,40.0,39.0,1
1483,CC:2F:71:3F:1F:24,5054874,1871861190,1207360,1386633008,3847514,485228182,1730,1012875,1151161362,1012030,1151059094,845,102268,979583,15,1205986,121262,1727,788,144444.0,43333.0,-70.0,-69.0,-66.0,-73.0,-69.0,-69.0,-66.0,-72.0,-87.0,-87.0,-84.0,-84.0,17.0,18.0,18.0,11.0,1
1484,CC:2F:71:3E:C5:1F,3848510,485350012,996,121830,3847514,485228182,2,4316,360430,3592,274468,724,85962,1056,13,1432,28,2,54,130000.0,39000.0,-67.0,-68.0,-65.0,-60.0,-72.0,-72.0,-69.0,-61.0,-87.0,-87.0,-84.0,-84.0,20.0,19.0,19.0,24.0,1
1485,BA:8C:B9:54:50:24,3852450,491422682,4934,6194298,3847516,485228384,7,9790,1754234,9768,1750739,22,3495,2358,18,5442,43,7,72,229410.0,130000.0,-48.0,-35.0,-42.0,-45.0,-44.0,-36.0,-44.0,-48.0,-87.0,-87.0,-84.0,-84.0,39.0,52.0,42.0,39.0,1
1486,62:47:05:9D:EB:15,3854275,497411962,6755,12183174,3847520,485228788,1,7009,3805145,6959,3797487,50,7658,3317,0,6825,56,1,125,216660.0,130000.0,-45.0,-48.0,-44.0,-46.0,-44.0,-45.0,-36.0,-48.0,-87.0,-87.0,-84.0,-84.0,42.0,39.0,40.0,38.0,1
1487,92:69:1D:31:68:E9,3851576,488882671,4054,3653681,3847522,485228990,1,5431,1160089,5259,1121001,172,39088,2206,12,4311,103,1,62,216660.0,130000.0,-51.0,-48.0,-44.0,-45.0,-51.0,-47.0,-43.0,-47.0,-87.0,-87.0,-84.0,-84.0,36.0,39.0,40.0,39.0,1
1488,CC:2F:71:3F:1F:24,5055085,1872121941,1207563,1386892951,3847522,485228990,1730,1013076,1151418502,1012231,1151316234,845,102268,979772,15,1206189,121292,1727,788,144444.0,43333.0,-70.0,-70.0,-67.0,-74.0,-70.0,-69.0,-67.0,-73.0,-87.0,-87.0,-84.0,-84.0,17.0,17.0,17.0,10.0,1
1489,CC:2F:71:3E:C5:1F,3848518,485350820,996,121830,3847522,485228990,2,4316,360430,3592,274468,724,85962,1056,13,1432,28,2,54,130000.0,39000.0,-67.0,-68.0,-65.0,-60.0,-72.0,-72.0,-69.0,-61.0,-87.0,-87.0,-84.0,-84.0,20.0,19.0,19.0,24.0,1
1490,BA:8C:B9:54:50:24,3852456,491423288,4934,6194298,3847522,485228990,7,9790,1754234,9768,1750739,22,3495,2358,18,5442,43,7,72,229410.0,130000.0,-48.0,-35.0,-42.0,-45.0,-44.0,-36.0,-44.0,-48.0,-87.0,-87.0,-84.0,-84.0,39.0,52.0,42.0,39.0,1
1491,62:47:05:9D:EB:15,3854279,497412350,6755,12183174,3847524,485229176,1,7009,3805145,6959,3797487,50,7658,3317,0,6825,56,1,125,216660.0,130000.0,-45.0,-48.0,-44.0,-46.0,-44.0,-45.0,-36.0,-48.0,-87.0,-87.0,-84.0,-84.0,42.0,39.0,40.0,38.0,1
1492,92:69:1D:31:68:E9,3851578,488882857,4054,3653681,3847524,485229176,1,5431,1160089,5259,1121001,172,39088,2206,12,4311,103,1,62,216660.0,130000.0,-51.0,-48.0,-44.0,-45.0,-51.0,-47.0,-43.0,-47.0,-87.0,-87.0,-84.0,-84.0,36.0,39.0,40.0,39.0,1
1493,CC:2F:71:3F:1F:24,5055278,1872363475,1207752,1387134097,3847526,485229378,1730,1013246,1151647770,1012401,1151545502,845,102268,979940,15,1206378,121294,1727,788,144444.0,43333.0,-70.0,-70.0,-67.0,-74.0,-70.0,-69.0,-67.0,-73.0,-87.0,-87.0,-84.0,-84.0,17.0,17.0,17.0,10.0,1
1494,CC:2F:71:3E:C5:1F,3848522,485351208,996,121830,3847526,485229378,2,4316,360430,3592,274468,724,85962,1056,13,1432,28,2,54,130000.0,39000.0,-67.0,-68.0,-65.0,-60.0,-72.0,-72.0,-69.0,-61.0,-87.0,-87.0,-84.0,-84.0,20.0,19.0,19.0,24.0,1
1495,BA:8C:B9:54:50:24,3852460,491423676,4934,6194298,3847526,485229378,7,9790,1754234,9768,1750739,22,3495,2358,18,5442,43,7,72,229410.0,130000.0,-48.0,-35.0,-42.0,-45.0,-44.0,-36.0,-44.0,-48.0,-87.0,-87.0,-84.0,-84.0,39.0,52.0,42.0,39.0,1
1496,62:47:05:9D:EB:15,3854288,497413274,6756,12183290,3847532,485229984,1,7010,3805213,6960,3797555,50,7658,3317,0,6826,56,1,125,216660.0,130000.0,-43.0,-45.0,-36.0,-49.0,-44.0,-45.0,-36.0,-48.0,-87.0,-87.0,-84.0,-84.0,44.0,42.0,48.0,35.0,1
1497,92:69:1D:31:68:E9,3851587,488883781,4055,3653797,3847532,485229984,1,5433,1160225,5261,1121137,172,39088,2206,12,4312,103,1,62,216660.0,130000.0,-51.0,-47.0,-45.0,-45.0,-51.0,-47.0,-43.0,-46.0,-87.0,-87.0,-84.0,-84.0,36.0,40.0,39.0,39.0,1
1498,CC:2F:71:3F:1F:24,5055474,1872605343,1207942,1387375359,3847532,485229984,1730,1013417,1151877248,1012572,1151774980,845,102268,980108,15,1206568,121296,1727,788,144444.0,43333.0,-70.0,-70.0,-67.0,-73.0,-70.0,-69.0,-66.0,-73.0,-87.0,-87.0,-84.0,-84.0,17.0,17.0,17.0,11.0,1
1499,CC:2F:71:3E:C5:1F,3848529,485351930,997,121946,3847532,485229984,2,4318,360570,3594,274608,724,85962,1056,13,1433,28,2,54,130000.0,39000.0,-72.0,-72.0,-68.0,-60.0,-72.0,-72.0,-69.0,-61.0,-87.0,-87.0,-84.0,-84.0,15.0,15.0,16.0,24.0,1
1500,BA:8C:B9:54:50:24,3852467,491424398,4935,6194414,3847532,485229984,7,9792,1754370,9770,1750875,22,3495,2358,18,5443,43,7,72,229410.0,130000.0,-48.0,-35.0,-43.0,-45.0,-43.0,-36.0,-44.0,-49.0,-87.0,-87.0,-84.0,-84.0,39.0,52.0,41.0,39.0,1
1501,62:47:05:9D:EB:15,3854289,497413336,6756,12183290,3847533,485230046,1,7011,3805281,6961,3797623,50,7658,3317,0,6826,56,1,125,216660.0,130000.0,-44.0,-45.0,-36.0,-49.0,-44.0,-45.0,-37.0,-48.0,-87.0,-87.0,-84.0,-84.0,43.0,42.0,48.0,35.0,1
1502,92:69:1D:31:68:E9,3851588,488883843,4055,3653797,3847533,485230046,1,5433,1160225,5261,1121137,172,39088,2206,12,4312,103,1,62,216660.0,130000.0,-51.0,-47.0,-45.0,-45.0,-51.0,-47.0,-43.0,-46.0,-87.0,-87.0,-84.0,-84.0,36.0,40.0,39.0,39.0,1
1503,CC:2F:71:3F:1F:24,5055668,1872846983,1208133,1387616735,3847535,485230248,1730,1013594,1152110400,1012748,1152008014,846,102386,980279,15,1206759,121299,1727,788,144444.0,43333.0,-70.0,-69.0,-67.0,-74.0,-70.0,-69.0,-67.0,-73.0,-87.0,-87.0,-84.0,-84.0,17.0,18.0,17.0,10.0,1
1504,CC:2F:71:3E:C5:1F,3848532,485352194,997,121946,3847535,485230248,2,4318,360570,3594,274608,724,85962,1056,13,1433,28,2,54,130000.0,39000.0,-72.0,-72.0,-68.0,-60.0,-72.0,-72.0,-69.0,-61.0,-87.0,-87.0,-84.0,-84.0,15.0,15.0,16.0,24.0,1
1505,BA:8C:B9:54:50:24,3852470,491424662,4935,6194414,3847535,485230248,7,9792,1754370,9770,1750875,22,3495,2358,18,5443,43,7,72,229410.0,130000.0,-48.0,-35.0,-43.0,-45.0,-43.0,-36.0,-44.0,-49.0,-87.0,-87.0,-84.0,-84.0,39.0,52.0,41.0,39.0,1
1506,62:47:05:9D:EB:15,3854298,497414204,6756,12183290,3847542,485230914,1,7011,3805281,6961,3797623,50,7658,3317,0,6826,56,1,125,216660.0,130000.0,-44.0,-45.0,-36.0,-49.0,-44.0,-45.0,-37.0,-48.0,-87.0,-87.0,-84.0,-84.0,43.0,42.0,48.0,35.0,1
1507,92:69:1D:31:68:E9,3851597,488884711,4055,3653797,3847542,485230914,1,5433,1160225,5261,1121137,172,39088,2206,12,4312,103,1,62,216660.0,130000.0,-51.0,-47.0,-45.0,-45.0,-51.0,-47.0,-43.0,-46.0,-87.0,-87.0,-84.0,-84.0,36.0,40.0,39.0,39.0,1
1508,CC:2F:71:3F:1F:24,5055873,1873095358,1208331,1387864444,3847542,485230914,1730,1013775,1152345783,1012929,1152243397,846,102386,980456,15,1206957,121305,1727,788,144444.0,43333.0,-70.0,-70.0,-67.0,-73.0,-70.0,-69.0,-67.0,-73.0,-87.0,-87.0,-84.0,-84.0,17.0,17.0,17.0,11.0,1
1509,CC:2F:71:3E:C5:1F,3848539,485352860,997,121946,3847542,485230914,2,4318,360570,3594,274608,724,85962,1056,13,1433,28,2,54,130000.0,39000.0,-72.0,-72.0,-68.0,-60.0,-72.0,-72.0,-69.0,-61.0,-87.0,-87.0,-84.0,-84.0,15.0,15.0,16.0,24.0,1
1510,BA:8C:B9:54:50:24,3852477,491425328,4935,6194414,3847542,485230914,7,9792,1754370,9770,1750875,22,3495,2358,18,5443,43,7,72,229410.0,130000.0,-48.0,-35.0,-43.0,-45.0,-43.0,-36.0,-44.0,-49.0,-87.0,-87.0,-84.0,-84.0,39.0,52.0,41.0,39.0,1
1511,62:47:05:9D:EB:15,3854301,497414679,6756,12183290,3847545,485231389,1,7011,3805281,6961,3797623,50,7658,3317,0,6826,56,1,125,216660.0,130000.0,-44.0,-45.0,-36.0,-49.0,-44.0,-45.0,-37.0,-48.0,-87.0,-87.0,-84.0,-84.0,43.0,42.0,48.0,35.0,1
1512,92:69:1D:31:68:E9,3851600,488885186,4055,3653797,3847545,485231389,1,5433,1160225,5261,1121137,172,39088,2206,12,4312,103,1,62,216660.0,130000.0,-51.0,-47.0,-45.0,-45.0,-51.0,-47.0,-43.0,-46.0,-87.0,-87.0,-84.0,-84.0,36.0,40.0,39.0,39.0,1
1513,CC:2F:71:3F:1F:24,5056065,1873335525,1208520,1388104136,3847545,485231389,1730,1013947,1152576739,1013101,1152474353,846,102386,980623,15,1207146,121305,1727,788,144444.0,43333.0,-69.0,-70.0,-68.0,-73.0,-69.0,-69.0,-67.0,-73.0,-87.0,-87.0,-84.0,-84.0,18.0,17.0,16.0,11.0,1
1514,CC:2F:71:3E:C5:1F,3848542,485353335,997,121946,3847545,485231389,2,4318,360570,3594,274608,724,85962,1056,13,1433,28,2,54,130000.0,39000.0,-72.0,-72.0,-68.0,-60.0,-72.0,-72.0,-69.0,-61.0,-87.0,-87.0,-84.0,-84.0,15.0,15.0,16.0,24.0,1
1515,BA:8C:B9:54:50:24,3852480,491425803,4935,6194414,3847545,485231389,7,9792,1754370,9770,1750875,22,3495,2358,18,5443,43,7,72,229410.0,130000.0,-48.0,-35.0,-43.0,-45.0,-43.0,-36.0,-44.0,-49.0,-87.0,-87.0,-84.0,-84.0,39.0,52.0,41.0,39.0,1
1516,62:47:05:9D:EB:15,3854308,497415345,6756,12183290,3847552,485232055,1,7011,3805281,6961,3797623,50,7658,3317,0,6826,56,1,125,216660.0,130000.0,-44.0,-45.0,-36.0,-49.0,-44.0,-45.0,-37.0,-48.0,-87.0,-87.0,-84.0,-84.0,43.0,42.0,48.0,35.0,1
1517,92:69:1D:31:68:E9,3851607,488885852,4055,3653797,3847552,485232055,1,5433,1160225,5261,1121137,172,39088,2206,12,4312,103,1,62,216660.0,130000.0,-51.0,-47.0,-45.0,-45.0,-51.0,-47.0,-43.0,-46.0,-87.0,-87.0,-84.0,-84.0,36.0,40.0,39.0,39.0,1
1518,CC:2F:71:3F:1F:24,5056263,1873579005,1208711,1388346950,3847552,485232055,1730,1014128,1152821663,1013282,1152719277,846,102386,980792,15,1207337,121305,1727,788,144444.0,43333.0,-69.0,-69.0,-65.0,-71.0,-69.0,-69.0,-65.0,-71.0,-87.0,-87.0,-84.0,-84.0,18.0,18.0,19.0,13.0,1
1519,CC:2F:71:3E:C5:1F,3848549,485354001,997,121946,3847552,485232055,2,4318,360570,3594,274608,724,85962,1056,13,1433,28,2,54,130000.0,39000.0,-72.0,-72.0,-68.0,-60.0,-72.0,-72.0,-69.0,-61.0,-87.0,-87.0,-84.0,-84.0,15.0,15.0,16.0,24.0,1
1520,BA:8C:B9:54:50:24,3852487,491426469,4935,6194414,3847552,485232055,7,9792,1754370,9770,1750875,22,3495,2358,18,5443,43,7,72,229410.0,130000.0,-48.0,-35.0,-43.0,-45.0,-43.0,-36.0,-44.0,-49.0,-87.0,-87.0,-84.0,-84.0,39.0,52.0,41.0,39.0,1
1521,62:47:05:9D:EB:15,3854310,497415547,6756,12183290,3847554,485232257,1,7011,3805281,6961,3797623,50,7658,3317,0,6826,56,1,125,216660.0,130000.0,-44.0,-45.0,-36.0,-49.0,-44.0,-45.0,-37.0,-48.0,-87.0,-87.0,-84.0,-84.0,43.0,42.0,48.0,35.0,1
1522,92:69:1D:31:68:E9,3851609,488886054,4055,3653797,3847554,485232257,1,5433,1160225,5261,1121137,172,39088,2206,12,4312,103,1,62,216660.0,130000.0,-51.0,-47.0,-45.0,-45.0,-51.0,-47.0,-43.0,-46.0,-87.0,-87.0,-84.0,-84.0,36.0,40.0,39.0,39.0,1
1523,CC:2F:71:3F:1F:24,5056465,1873836135,1208911,1388603878,3847554,485232257,1730,1014319,1153077887,1013473,1152975501,846,102386,980975,15,1207537,121306,1727,788,144444.0,43333.0,-69.0,-69.0,-65.0,-71.0,-69.0,-69.0,-65.0,-71.0,-87.0,-87.0,-84.0,-84.0,18.0,18.0,19.0,13.0,1
1524,CC:2F:71:3E:C5:1F,3848553,485354405,997,121946,3847556,485232459,2,4318,360570,3594,274608,724,85962,1056,13,1433,28,2,54,130000.0,39000.0,-72.0,-72.0,-68.0,-60.0,-72.0,-72.0,-69.0,-61.0,-87.0,-87.0,-84.0,-84.0,15.0,15.0,16.0,24.0,1
1525,BA:8C:B9:54:50:24,3852493,491427241,4935,6194414,3847558,485232827,7,9792,1754370,9770,1750875,22,3495,2358,18,5443,43,7,72,229410.0,130000.0,-48.0,-35.0,-43.0,-45.0,-43.0,-36.0,-44.0,-49.0,-87.0,-87.0,-84.0,-84.0,39.0,52.0,41.0,39.0,1
1526,62:47:05:9D:EB:15,3854318,497416521,6756,12183290,3847562,485233231,1,7011,3805281,6961,3797623,50,7658,3317,0,6826,56,1,125,216660.0,130000.0,-44.0,-45.0,-36.0,-49.0,-44.0,-45.0,-37.0,-48.0,-87.0,-87.0,-84.0,-84.0,43.0,42.0,48.0,35.0,1
1527,92:69:1D:31:68:E9,3851617,488887028,4055,3653797,3847562,485233231,1,5433,1160225,5261,1121137,172,39088,2206,12,4312,103,1,62,216660.0,130000.0,-51.0,-47.0,-45.0,-45.0,-51.0,-47.0,-43.0,-46.0,-87.0,-87.0,-84.0,-84.0,36.0,40.0,39.0,39.0,1
1528,CC:2F:71:3F:1F:24,5056674,1874085194,1209112,1388851963,3847562,485233231,1730,1014511,1153324664,1013665,1153222278,846,102386,981155,15,1207736,121307,1727,788,144444.0,43333.0,-69.0,-69.0,-65.0,-71.0,-69.0,-69.0,-65.0,-71.0,-87.0,-87.0,-84.0,-84.0,18.0,18.0,19.0,13.0,1
1529,CC:2F:71:3E:C5:1F,3848559,485355177,997,121946,3847562,485233231,2,4318,360570,3594,274608,724,85962,1056,13,1433,28,2,54,130000.0,39000.0,-72.0,-72.0,-68.0,-60.0,-72.0,-72.0,-69.0,-61.0,-87.0,-87.0,-84.0,-84.0,15.0,15.0,16.0,24.0,1
1530,BA:8C:B9:54:50:24,3852497,491427645,4935,6194414,3847562,485233231,7,9792,1754370,9770,1750875,22,3495,2358,18,5443,43,7,72,229410.0,130000.0,-48.0,-35.0,-43.0,-45.0,-43.0,-36.0,-44.0,-49.0,-87.0,-87.0,-84.0,-84.0,39.0,52.0,41.0,39.0,1
1531,62:47:05:9D:EB:15,3854321,497416783,6756,12183290,3847565,485233493,1,7011,3805281,6961,3797623,50,7658,3317,0,6826,56,1,125,216660.0,130000.0,-44.0,-45.0,-36.0,-49.0,-44.0,-45.0,-37.0,-48.0,-87.0,-87.0,-84.0,-84.0,43.0,42.0,48.0,35.0,1
1532,92:69:1D:31:68:E9,3851622,488887492,4055,3653797,3847567,485233695,1,5433,1160225,5261,1121137,172,39088,2206,12,4312,103,1,62,216660.0,130000.0,-51.0,-47.0,-45.0,-45.0,-51.0,-47.0,-43.0,-46.0,-87.0,-87.0,-84.0,-84.0,36.0,40.0,39.0,39.0,1
1533,CC:2F:71:3F:1F:24,5056889,1874355278,1209322,1389121583,3847567,485233695,1730,1014708,1153587596,1013862,1153485210,846,102386,981344,15,1207948,121309,1727,789,144444.0,43333.0,-70.0,-69.0,-65.0,-71.0,-70.0,-69.0,-64.0,-70.0,-87.0,-87.0,-84.0,-84.0,17.0,18.0,19.0,13.0,1
1534,CC:2F:71:3E:C5:1F,3848566,485355843,997,121946,3847569,485233897,2,4318,360570,3594,274608,724,85962,1056,13,1433,28,2,54,130000.0,39000.0,-72.0,-72.0,-68.0,-60.0,-72.0,-72.0,-69.0,-61.0,-87.0,-87.0,-84.0,-84.0,15.0,15.0,16.0,24.0,1
1535,BA:8C:B9:54:50:24,3852504,491428311,4935,6194414,3847569,485233897,7,9792,1754370,9770,1750875,22,3495,2358,18,5443,43,7,72,229410.0,130000.0,-48.0,-35.0,-43.0,-45.0,-43.0,-36.0,-44.0,-49.0,-87.0,-87.0,-84.0,-84.0,39.0,52.0,41.0,39.0,1
1536,62:47:05:9D:EB:15,3854327,497417389,6756,12183290,3847571,485234099,1,7011,3805281,6961,3797623,50,7658,3317,0,6826,56,1,125,216660.0,130000.0,-44.0,-45.0,-36.0,-49.0,-44.0,-45.0,-37.0,-48.0,-87.0,-87.0,-84.0,-84.0,43.0,42.0,48.0,35.0,1
1537,92:69:1D:31:68:E9,3851626,488887896,4055,3653797,3847571,485234099,1,5433,1160225,5261,1121137,172,39088,2206,12,4312,103,1,62,216660.0,130000.0,-51.0,-47.0,-45.0,-45.0,-51.0,-47.0,-43.0,-46.0,-87.0,-87.0,-84.0,-84.0,36.0,40.0,39.0,39.0,1
1538,CC:2F:71:3F:1F:24,5057084,1874597072,1209513,1389362973,3847571,485234099,1730,1014887,1153829352,1014041,1153726966,846,102386,981513,15,1208139,121309,1727,789,144444.0,43333.0,-69.0,-69.0,-65.0,-71.0,-69.0,-69.0,-65.0,-71.0,-87.0,-87.0,-84.0,-84.0,18.0,18.0,19.0,13.0,1
1539,CC:2F:71:3E:C5:1F,3848568,485356045,997,121946,3847571,485234099,2,4318,360570,3594,274608,724,85962,1056,13,1433,28,2,54,130000.0,39000.0,-72.0,-72.0,-68.0,-60.0,-72.0,-72.0,-69.0,-61.0,-87.0,-87.0,-84.0,-84.0,15.0,15.0,16.0,24.0,1
1540,BA:8C:B9:54:50:24,3852506,491428513,4935,6194414,3847571,485234099,7,9792,1754370,9770,1750875,22,3495,2358,18,5443,43,7,72,229410.0,130000.0,-48.0,-35.0,-43.0,-45.0,-43.0,-36.0,-44.0,-49.0,-87.0,-87.0,-84.0,-84.0,39.0,52.0,41.0,39.0,1
1541,62:47:05:9D:EB:15,3854332,497417853,6756,12183290,3847576,485234563,1,7011,3805281,6961,3797623,50,7658,3317,0,6826,56,1,125,216660.0,130000.0,-44.0,-45.0,-36.0,-49.0,-44.0,-45.0,-37.0,-48.0,-87.0,-87.0,-84.0,-84.0,43.0,42.0,48.0,35.0,1
1542,92:69:1D:31:68:E9,3851633,488888562,4055,3653797,3847578,485234765,1,5433,1160225,5261,1121137,172,39088,2206,12,4312,103,1,62,216660.0,130000.0,-51.0,-47.0,-45.0,-45.0,-51.0,-47.0,-43.0,-46.0,-87.0,-87.0,-84.0,-84.0,36.0,40.0,39.0,39.0,1
1543,CC:2F:71:3F:1F:24,5057289,1874845447,1209711,1389610682,3847578,485234765,1730,1015067,1154064585,1014221,1153962199,846,102386,981688,15,1208334,121310,1727,789,144444.0,43333.0,-70.0,-69.0,-65.0,-71.0,-69.0,-69.0,-65.0,-71.0,-87.0,-87.0,-84.0,-84.0,17.0,18.0,19.0,13.0,1
1544,CC:2F:71:3E:C5:1F,3848575,485356711,997,121946,3847578,485234765,2,4318,360570,3594,274608,724,85962,1056,13,1433,28,2,54,130000.0,39000.0,-72.0,-72.0,-68.0,-60.0,-72.0,-72.0,-69.0,-61.0,-87.0,-87.0,-84.0,-84.0,15.0,15.0,16.0,24.0,1
1545,BA:8C:B9:54:50:24,3852513,491429179,4935,6194414,3847578,485234765,7,9792,1754370,9770,1750875,22,3495,2358,18,5443,43,7,72,229410.0,130000.0,-48.0,-35.0,-43.0,-45.0,-43.0,-36.0,-44.0,-49.0,-87.0,-87.0,-84.0,-84.0,39.0,52.0,41.0,39.0,1
1546,62:47:05:9D:EB:15,3854336,497418257,6756,12183290,3847580,485234967,1,7011,3805281,6961,3797623,50,7658,3317,0,6826,56,1,125,216660.0,130000.0,-44.0,-45.0,-36.0,-49.0,-44.0,-45.0,-37.0,-48.0,-87.0,-87.0,-84.0,-84.0,43.0,42.0,48.0,35.0,1
1547,92:69:1D:31:68:E9,3851635,488888764,4055,3653797,3847580,485234967,1,5433,1160225,5261,1121137,172,39088,2206,12,4312,103,1,62,216660.0,130000.0,-51.0,-47.0,-45.0,-45.0,-51.0,-47.0,-43.0,-46.0,-87.0,-87.0,-84.0,-84.0,36.0,40.0,39.0,39.0,1
1548,CC:2F:71:3F:1F:24,5057481,1875086909,1209901,1389851942,3847580,485234967,1730,1015247,1154300889,1014401,1154198503,846,102386,981860,15,1208527,121310,1727,789,144444.0,43333.0,-70.0,-69.0,-65.0,-71.0,-69.0,-69.0,-65.0,-71.0,-87.0,-87.0,-84.0,-84.0,17.0,18.0,19.0,13.0,1
1549,CC:2F:71:3E:C5:1F,3848577,485356913,997,121946,3847580,485234967,2,4318,360570,3594,274608,724,85962,1056,13,1433,28,2,54,130000.0,39000.0,-72.0,-72.0,-68.0,-60.0,-72.0,-72.0,-69.0,-61.0,-87.0,-87.0,-84.0,-84.0,15.0,15.0,16.0,24.0,1
1550,BA:8C:B9:54:50:24,3852515,491429381,4935,6194414,3847580,485234967,7,9792,1754370,9770,1750875,22,3495,2358,18,5443,43,7,72,229410.0,130000.0,-48.0,-35.0,-43.0,-45.0,-43.0,-36.0,-44.0,-49.0,-87.0,-87.0,-84.0,-84.0,39.0,52.0,41.0,39.0,1
1551,62:47:05:9D:EB:15,3854348,497421571,6756,12183290,3847592,485238281,1,7012,3805349,6962,3797691,50,7658,3317,0,6826,56,1,125,216660.0,130000.0,-44.0,-46.0,-36.0,-49.0,-44.0,-45.0,-37.0,-48.0,-87.0,-87.0,-84.0,-84.0,43.0,41.0,48.0,35.0,1
1552,92:69:1D:31:68:E9,3851649,488892280,4055,3653797,3847594,485238483,1,5433,1160225,5261,1121137,172,39088,2206,12,4312,103,1,62,216660.0,130000.0,-51.0,-47.0,-45.0,-45.0,-51.0,-47.0,-43.0,-46.0,-87.0,-87.0,-84.0,-84.0,36.0,40.0,39.0,39.0,1
1553,CC:2F:71:3F:1F:24,5057685,1875331617,1210090,1390093072,3847595,485238545,1730,1015426,1154539829,1014580,1154437443,846,102386,982031,15,1208716,121311,1727,789,144444.0,43333.0,-70.0,-69.0,-65.0,-71.0,-70.0,-69.0,-65.0,-71.0,-87.0,-87.0,-84.0,-84.0,17.0,18.0,19.0,13.0,1
1554,CC:2F:71:3E:C5:1F,3848592,485360491,997,121946,3847595,485238545,2,4319,360688,3594,274608,725,86080,1057,13,1433,28,2,54,130000.0,39000.0,-72.0,-72.0,-69.0,-60.0,-72.0,-72.0,-69.0,-61.0,-87.0,-87.0,-84.0,-84.0,15.0,15.0,15.0,24.0,1
1555,BA:8C:B9:54:50:24,3852531,491433019,4935,6194414,3847596,485238605,7,9792,1754370,9770,1750875,22,3495,2358,18,5443,43,7,72,229410.0,130000.0,-48.0,-35.0,-43.0,-45.0,-43.0,-36.0,-44.0,-49.0,-87.0,-87.0,-84.0,-84.0,39.0,52.0,41.0,39.0,1
1556,62:47:05:9D:EB:15,3854354,497422097,6756,12183290,3847598,485238807,1,7012,3805349,6962,3797691,50,7658,3317,0,6826,56,1,125,216660.0,130000.0,-44.0,-46.0,-36.0,-49.0,-44.0,-45.0,-37.0,-48.0,-87.0,-87.0,-84.0,-84.0,43.0,41.0,48.0,35.0,1
1557,92:69:1D:31:68:E9,3851653,488892604,4055,3653797,3847598,485238807,1,5435,1160361,5263,1121273,172,39088,2206,12,4313,103,1,62,216660.0,130000.0,-51.0,-48.0,-44.0,-45.0,-51.0,-47.0,-44.0,-45.0,-87.0,-87.0,-84.0,-84.0,36.0,39.0,40.0,39.0,1
1558,CC:2F:71:3F:1F:24,5057878,1875572971,1210280,1390334164,3847598,485238807,1730,1015605,1154776525,1014759,1154674139,846,102386,982200,15,1208906,121312,1727,789,144444.0,43333.0,-70.0,-69.0,-65.0,-71.0,-70.0,-69.0,-65.0,-71.0,-87.0,-87.0,-84.0,-84.0,17.0,18.0,19.0,13.0,1
1559,CC:2F:71:3E:C5:1F,3848595,485360753,997,121946,3847598,485238807,2,4320,360758,3595,274678,725,86080,1057,13,1433,28,2,54,130000.0,39000.0,-72.0,-72.0,-69.0,-60.0,-71.0,-71.0,-68.0,-60.0,-87.0,-87.0,-84.0,-84.0,15.0,15.0,15.0,24.0,1
1560,BA:8C:B9:54:50:24,3852535,491433423,4935,6194414,3847600,485239009,7,9794,1754506,9772,1751011,22,3495,2358,18,5444,43,7,72,229410.0,130000.0,-48.0,-35.0,-43.0,-45.0,-44.0,-36.0,-44.0,-48.0,-87.0,-87.0,-84.0,-84.0,39.0,52.0,41.0,39.0,1
1561,62:47:05:9D:EB:15,3854360,497422703,6756,12183290,3847604,485239413,1,7012,3805349,6962,3797691,50,7658,3317,0,6826,56,1,125,216660.0,130000.0,-44.0,-46.0,-36.0,-49.0,-44.0,-45.0,-37.0,-48.0,-87.0,-87.0,-84.0,-84.0,43.0,41.0,48.0,35.0,1
1562,92:69:1D:31:68:E9,3851659,488893210,4055,3653797,3847604,485239413,1,5435,1160361,5263,1121273,172,39088,2206,12,4313,103,1,62,216660.0,130000.0,-51.0,-48.0,-44.0,-45.0,-51.0,-47.0,-44.0,-45.0,-87.0,-87.0,-84.0,-84.0,36.0,39.0,40.0,39.0,1
1563,CC:2F:71:3F:1F:24,5058086,1875821806,1210482,1390582393,3847604,485239413,1730,1015788,1155010807,1014942,1154908421,846,102386,982380,15,1209108,121313,1727,790,144444.0,43333.0,-70.0,-70.0,-66.0,-71.0,-70.0,-69.0,-65.0,-71.0,-87.0,-87.0,-84.0,-84.0,17.0,17.0,18.0,13.0,1
1564,CC:2F:71:3E:C5:1F,3848601,485361359,997,121946,3847604,485239413,2,4320,360758,3595,274678,725,86080,1057,13,1433,28,2,54,130000.0,39000.0,-72.0,-72.0,-69.0,-60.0,-71.0,-71.0,-68.0,-60.0,-87.0,-87.0,-84.0,-84.0,15.0,15.0,15.0,24.0,1
1565,BA:8C:B9:54:50:24,3852539,491433827,4935,6194414,3847604,485239413,7,9794,1754506,9772,1751011,22,3495,2358,18,5444,43,7,72,229410.0,130000.0,-48.0,-35.0,-43.0,-45.0,-44.0,-36.0,-44.0,-48.0,-87.0,-87.0,-84.0,-84.0,39.0,52.0,41.0,39.0,1
1566,62:47:05:9D:EB:15,3854363,497422965,6756,12183290,3847607,485239675,1,7012,3805349,6962,3797691,50,7658,3317,0,6826,56,1,125,216660.0,130000.0,-44.0,-46.0,-36.0,-49.0,-44.0,-45.0,-37.0,-48.0,-87.0,-87.0,-84.0,-84.0,43.0,41.0,48.0,35.0,1
1567,92:69:1D:31:68:E9,3851662,488893472,4055,3653797,3847607,485239675,1,5435,1160361,5263,1121273,172,39088,2206,12,4313,103,1,62,216660.0,130000.0,-51.0,-48.0,-44.0,-45.0,-51.0,-47.0,-44.0,-45.0,-87.0,-87.0,-84.0,-84.0,36.0,39.0,40.0,39.0,1
1568,CC:2F:71:3F:1F:24,5058281,1876063588,1210674,1390823913,3847607,485239675,1730,1015963,1155245079,1015117,1155142693,846,102386,982549,15,1209300,121313,1727,790,144444.0,43333.0,-69.0,-70.0,-66.0,-71.0,-69.0,-70.0,-65.0,-71.0,-87.0,-87.0,-84.0,-84.0,18.0,17.0,18.0,13.0,1
1569,CC:2F:71:3E:C5:1F,3848606,485361823,997,121946,3847609,485239877,2,4320,360758,3595,274678,725,86080,1057,13,1433,28,2,54,130000.0,39000.0,-72.0,-72.0,-69.0,-60.0,-71.0,-71.0,-68.0,-60.0,-87.0,-87.0,-84.0,-84.0,15.0,15.0,15.0,24.0,1
1570,BA:8C:B9:54:50:24,3852544,491434291,4935,6194414,3847609,485239877,7,9802,1755050,9780,1751555,22,3495,2358,18,5444,43,7,72,229410.0,130000.0,-40.0,-37.0,-46.0,-51.0,-46.0,-35.0,-43.0,-46.0,-87.0,-87.0,-84.0,-84.0,47.0,50.0,38.0,33.0,1
1571,62:47:05:9D:EB:15,3854369,497423571,6756,12183290,3847613,485240281,1,7012,3805349,6962,3797691,50,7658,3317,0,6826,56,1,125,216660.0,130000.0,-44.0,-46.0,-36.0,-49.0,-44.0,-45.0,-37.0,-48.0,-87.0,-87.0,-84.0,-84.0,43.0,41.0,48.0,35.0,1
1572,92:69:1D:31:68:E9,3851669,488894351,4055,3653797,3847614,485240554,1,5435,1160361,5263,1121273,172,39088,2206,12,4313,103,1,62,216660.0,130000.0,-51.0,-48.0,-44.0,-45.0,-51.0,-47.0,-44.0,-45.0,-87.0,-87.0,-84.0,-84.0,36.0,39.0,40.0,39.0,1
1573,CC:2F:71:3F:1F:24,5058479,1876305857,1210865,1391065303,3847614,485240554,1730,1016137,1155474811,1015291,1155372425,846,102386,982721,15,1209491,121314,1727,790,144444.0,43333.0,-70.0,-70.0,-65.0,-71.0,-70.0,-70.0,-65.0,-71.0,-87.0,-87.0,-84.0,-84.0,17.0,17.0,19.0,13.0,1
1574,CC:2F:71:3E:C5:1F,3848613,485362702,997,121946,3847616,485240756,2,4320,360758,3595,274678,725,86080,1057,13,1433,28,2,54,130000.0,39000.0,-72.0,-72.0,-69.0,-60.0,-71.0,-71.0,-68.0,-60.0,-87.0,-87.0,-84.0,-84.0,15.0,15.0,15.0,24.0,1
1575,BA:8C:B9:54:50:24,3852551,491435170,4935,6194414,3847616,485240756,7,9802,1755050,9780,1751555,22,3495,2358,18,5444,43,7,72,229410.0,130000.0,-40.0,-37.0,-46.0,-51.0,-46.0,-35.0,-43.0,-46.0,-87.0,-87.0,-84.0,-84.0,47.0,50.0,38.0,33.0,1
1576,62:47:05:9D:EB:15,3854372,497424046,6756,12183290,3847616,485240756,1,7015,3805553,6965,3797895,50,7658,3317,0,6826,56,1,125,216660.0,130000.0,-44.0,-45.0,-36.0,-49.0,-44.0,-46.0,-38.0,-48.0,-87.0,-87.0,-84.0,-84.0,43.0,42.0,48.0,35.0,1
1577,92:69:1D:31:68:E9,3851673,488894755,4055,3653797,3847618,485240958,1,5435,1160361,5263,1121273,172,39088,2206,12,4313,103,1,62,216660.0,130000.0,-51.0,-48.0,-44.0,-45.0,-51.0,-47.0,-44.0,-45.0,-87.0,-87.0,-84.0,-84.0,36.0,39.0,40.0,39.0,1
1578,CC:2F:71:3F:1F:24,5058674,1876550499,1211056,1391309541,3847618,485240958,1730,1016312,1155710425,1015466,1155608039,846,102386,982892,15,1209682,121314,1727,790,144444.0,43333.0,-70.0,-70.0,-65.0,-71.0,-70.0,-70.0,-65.0,-71.0,-87.0,-87.0,-84.0,-84.0,17.0,17.0,19.0,13.0,1
1579,CC:2F:71:3E:C5:1F,3848615,485362904,997,121946,3847618,485240958,2,4320,360758,3595,274678,725,86080,1057,13,1433,28,2,54,130000.0,39000.0,-72.0,-72.0,-69.0,-60.0,-71.0,-71.0,-68.0,-60.0,-87.0,-87.0,-84.0,-84.0,15.0,15.0,15.0,24.0,1
1580,BA:8C:B9:54:50:24,3852554,491435432,4935,6194414,3847619,485241018,7,9802,1755050,9780,1751555,22,3495,2358,18,5444,43,7,72,229410.0,130000.0,-40.0,-37.0,-46.0,-51.0,-46.0,-35.0,-43.0,-46.0,-87.0,-87.0,-84.0,-84.0,47.0,50.0,38.0,33.0,1
1581,62:47:05:9D:EB:15,3854379,497424712,6756,12183290,3847623,485241422,1,7015,3805553,6965,3797895,50,7658,3317,0,6826,56,1,125,216660.0,130000.0,-44.0,-45.0,-36.0,-49.0,-44.0,-46.0,-38.0,-48.0,-87.0,-87.0,-84.0,-84.0,43.0,42.0,48.0,35.0,1
1582,92:69:1D:31:68:E9,3851678,488895219,4055,3653797,3847623,485241422,1,5435,1160361,5263,1121273,172,39088,2206,12,4313,103,1,62,216660.0,130000.0,-51.0,-48.0,-44.0,-45.0,-51.0,-47.0,-44.0,-45.0,-87.0,-87.0,-84.0,-84.0,36.0,39.0,40.0,39.0,1
1583,CC:2F:71:3F:1F:24,5058879,1876798874,1211254,1391557250,3847625,485241624,1730,1016498,1155952092,1015652,1155849706,846,102386,983070,15,1209880,121314,1727,790,144444.0,43333.0,-70.0,-70.0,-65.0,-72.0,-70.0,-69.0,-65.0,-71.0,-87.0,-87.0,-84.0,-84.0,17.0,17.0,19.0,12.0,1
1584,CC:2F:71:3E:C5:1F,3848622,485363570,997,121946,3847625,485241624,2,4320,360758,3595,274678,725,86080,1057,13,1433,28,2,54,130000.0,39000.0,-72.0,-72.0,-69.0,-60.0,-71.0,-71.0,-68.0,-60.0,-87.0,-87.0,-84.0,-84.0,15.0,15.0,15.0,24.0,1
1585,BA:8C:B9:54:50:24,3852560,491436038,4935,6194414,3847625,485241624,7,9802,1755050,9780,1751555,22,3495,2358,18,5444,43,7,72,229410.0,130000.0,-40.0,-37.0,-46.0,-51.0,-46.0,-35.0,-43.0,-46.0,-87.0,-87.0,-84.0,-84.0,47.0,50.0,38.0,33.0,1
1586,62:47:05:9D:EB:15,3854381,497424914,6756,12183290,3847625,485241624,1,7015,3805553,6965,3797895,50,7658,3317,0,6826,56,1,125,216660.0,130000.0,-44.0,-45.0,-36.0,-49.0,-44.0,-46.0,-38.0,-48.0,-87.0,-87.0,-84.0,-84.0,43.0,42.0,48.0,35.0,1
1587,92:69:1D:31:68:E9,3851682,488895623,4055,3653797,3847627,485241826,1,5435,1160361,5263,1121273,172,39088,2206,12,4313,103,1,62,216660.0,130000.0,-51.0,-48.0,-44.0,-45.0,-51.0,-47.0,-44.0,-45.0,-87.0,-87.0,-84.0,-84.0,36.0,39.0,40.0,39.0,1
1588,CC:2F:71:3F:1F:24,5059074,1877043574,1211447,1391801748,3847627,485241826,1730,1016678,1156195476,1015832,1156093090,846,102386,983240,15,1210071,121315,1727,791,144444.0,43333.0,-71.0,-70.0,-66.0,-72.0,-70.0,-70.0,-65.0,-71.0,-87.0,-87.0,-84.0,-84.0,16.0,17.0,18.0,12.0,1
1589,CC:2F:71:3E:C5:1F,3848624,485363772,997,121946,3847627,485241826,2,4320,360758,3595,274678,725,86080,1057,13,1433,28,2,54,130000.0,39000.0,-72.0,-72.0,-69.0,-60.0,-71.0,-71.0,-68.0,-60.0,-87.0,-87.0,-84.0,-84.0,15.0,15.0,15.0,24.0,1
1590,BA:8C:B9:54:50:24,3852564,491436442,4935,6194414,3847629,485242028,7,9802,1755050,9780,1751555,22,3495,2358,18,5444,43,7,72,229410.0,130000.0,-40.0,-37.0,-46.0,-51.0,-46.0,-35.0,-43.0,-46.0,-87.0,-87.0,-84.0,-84.0,47.0,50.0,38.0,33.0,1
1591,62:47:05:9D:EB:15,3854390,497425782,6756,12183290,3847634,485242492,1,7015,3805553,6965,3797895,50,7658,3317,0,6826,56,1,125,216660.0,130000.0,-44.0,-45.0,-36.0,-49.0,-44.0,-46.0,-38.0,-48.0,-87.0,-87.0,-84.0,-84.0,43.0,42.0,48.0,35.0,1
1592,92:69:1D:31:68:E9,3851689,488896289,4055,3653797,3847634,485242492,1,5435,1160361,5263,1121273,172,39088,2206,12,4313,103,1,62,216660.0,130000.0,-51.0,-48.0,-44.0,-45.0,-51.0,-47.0,-44.0,-45.0,-87.0,-87.0,-84.0,-84.0,36.0,39.0,40.0,39.0,1
1593,CC:2F:71:3F:1F:24,5059272,1877287054,1211638,1392044562,3847634,485242492,1730,1016859,1156436072,1016013,1156333686,846,102386,983413,15,1210264,121316,1727,791,144444.0,43333.0,-70.0,-69.0,-65.0,-71.0,-70.0,-69.0,-65.0,-71.0,-87.0,-87.0,-84.0,-84.0,17.0,18.0,19.0,13.0,1
1594,CC:2F:71:3E:C5:1F,3848631,485364438,997,121946,3847634,485242492,2,4320,360758,3595,274678,725,86080,1057,13,1433,28,2,54,130000.0,39000.0,-72.0,-72.0,-69.0,-60.0,-71.0,-71.0,-68.0,-60.0,-87.0,-87.0,-84.0,-84.0,15.0,15.0,15.0,24.0,1
1595,BA:8C:B9:54:50:24,3852569,491436906,4935,6194414,3847634,485242492,7,9802,1755050,9780,1751555,22,3495,2358,18,5444,43,7,72,229410.0,130000.0,-40.0,-37.0,-46.0,-51.0,-46.0,-35.0,-43.0,-46.0,-87.0,-87.0,-84.0,-84.0,47.0,50.0,38.0,33.0,1
1596,62:47:05:9D:EB:15,3854392,497425984,6756,12183290,3847636,485242694,1,7016,3805621,6966,3797963,50,7658,3317,0,6826,56,1,125,216660.0,130000.0,-44.0,-45.0,-36.0,-49.0,-44.0,-46.0,-38.0,-48.0,-87.0,-87.0,-84.0,-84.0,43.0,42.0,48.0,35.0,1
1597,92:69:1D:31:68:E9,3851691,488896491,4055,3653797,3847636,485242694,1,5435,1160361,5263,1121273,172,39088,2206,12,4313,103,1,62,216660.0,130000.0,-51.0,-48.0,-44.0,-45.0,-51.0,-47.0,-44.0,-45.0,-87.0,-87.0,-84.0,-84.0,36.0,39.0,40.0,39.0,1
1598,CC:2F:71:3F:1F:24,5059467,1877530272,1211829,1392287376,3847638,485242896,1730,1017032,1156668646,1016186,1156566260,846,102386,983583,15,1210455,121316,1727,791,144444.0,43333.0,-70.0,-70.0,-65.0,-72.0,-70.0,-69.0,-65.0,-71.0,-87.0,-87.0,-84.0,-84.0,17.0,17.0,19.0,12.0,1
1599,CC:2F:71:3E:C5:1F,3848635,485364842,997,121946,3847638,485242896,2,4320,360758,3595,274678,725,86080,1057,13,1433,28,2,54,130000.0,39000.0,-72.0,-72.0,-69.0,-60.0,-71.0,-71.0,-68.0,-60.0,-87.0,-87.0,-84.0,-84.0,15.0,15.0,15.0,24.0,1
1600,BA:8C:B9:54:50:24,3852573,491437310,4935,6194414,3847638,485242896,7,9802,1755050,9780,1751555,22,3495,2358,18,5444,43,7,72,229410.0,130000.0,-40.0,-37.0,-46.0,-51.0,-46.0,-35.0,-43.0,-46.0,-87.0,-87.0,-84.0,-84.0,47.0,50.0,38.0,33.0,1
1601,62:47:05:9D:EB:15,3854398,497426590,6756,12183290,3847642,485243300,1,7017,3805689,6967,3798031,50,7658,3317,0,6826,56,1,125,216660.0,130000.0,-44.0,-50.0,-45.0,-44.0,-43.0,-46.0,-38.0,-47.0,-87.0,-87.0,-84.0,-84.0,43.0,37.0,39.0,40.0,1
1602,92:69:1D:31:68:E9,3851697,488897097,4055,3653797,3847642,485243300,1,5435,1160361,5263,1121273,172,39088,2206,12,4313,103,1,62,216660.0,130000.0,-51.0,-48.0,-44.0,-45.0,-51.0,-47.0,-44.0,-45.0,-87.0,-87.0,-84.0,-84.0,36.0,39.0,40.0,39.0,1
1603,CC:2F:71:3F:1F:24,5059671,1877778633,1212029,1392535333,3847642,485243300,1730,1017214,1156902711,1016368,1156800325,846,102386,983761,15,1210655,121316,1727,791,144444.0,43333.0,-70.0,-70.0,-66.0,-71.0,-70.0,-69.0,-65.0,-70.0,-87.0,-87.0,-84.0,-84.0,17.0,17.0,18.0,13.0,1
1604,CC:2F:71:3E:C5:1F,3848639,485365246,997,121946,3847642,485243300,2,4320,360758,3595,274678,725,86080,1057,13,1433,28,2,54,130000.0,39000.0,-72.0,-72.0,-69.0,-60.0,-71.0,-71.0,-68.0,-60.0,-87.0,-87.0,-84.0,-84.0,15.0,15.0,15.0,24.0,1
1605,BA:8C:B9:54:50:24,3852578,491437774,4935,6194414,3847643,485243360,7,9802,1755050,9780,1751555,22,3495,2358,18,5444,43,7,72,229410.0,130000.0,-40.0,-37.0,-46.0,-51.0,-46.0,-35.0,-43.0,-46.0,-87.0,-87.0,-84.0,-84.0,47.0,50.0,38.0,33.0,1
1606,62:47:05:9D:EB:15,3854403,497427054,6756,12183290,3847647,485243764,1,7017,3805689,6967,3798031,50,7658,3317,0,6826,56,1,125,216660.0,130000.0,-44.0,-50.0,-45.0,-44.0,-43.0,-46.0,-38.0,-47.0,-87.0,-87.0,-84.0,-84.0,43.0,37.0,39.0,40.0,1
1607,92:69:1D:31:68:E9,3851702,488897561,4055,3653797,3847647,485243764,1,5435,1160361,5263,1121273,172,39088,2206,12,4313,103,1,62,216660.0,130000.0,-51.0,-48.0,-44.0,-45.0,-51.0,-47.0,-44.0,-45.0,-87.0,-87.0,-84.0,-84.0,36.0,39.0,40.0,39.0,1
1608,CC:2F:71:3F:1F:24,5059865,1878020227,1212218,1392776463,3847647,485243764,1730,1017384,1157131965,1016538,1157029579,846,102386,983930,15,1210844,121316,1727,791,144444.0,43333.0,-70.0,-70.0,-67.0,-71.0,-70.0,-70.0,-66.0,-71.0,-87.0,-87.0,-84.0,-84.0,17.0,17.0,17.0,13.0,1
1609,CC:2F:71:3E:C5:1F,3848644,485365710,997,121946,3847647,485243764,2,4320,360758,3595,274678,725,86080,1057,13,1433,28,2,54,130000.0,39000.0,-72.0,-72.0,-69.0,-60.0,-71.0,-71.0,-68.0,-60.0,-87.0,-87.0,-84.0,-84.0,15.0,15.0,15.0,24.0,1
1610,BA:8C:B9:54:50:24,3852582,491438178,4935,6194414,3847647,485243764,7,9802,1755050,9780,1751555,22,3495,2358,18,5444,43,7,72,229410.0,130000.0,-40.0,-37.0,-46.0,-51.0,-46.0,-35.0,-43.0,-46.0,-87.0,-87.0,-84.0,-84.0,47.0,50.0,38.0,33.0,1
1611,62:47:05:9D:EB:15,3854407,497427458,6756,12183290,3847651,485244168,1,7017,3805689,6967,3798031,50,7658,3317,0,6826,56,1,125,216660.0,130000.0,-44.0,-50.0,-45.0,-44.0,-43.0,-46.0,-38.0,-47.0,-87.0,-87.0,-84.0,-84.0,43.0,37.0,39.0,40.0,1
1612,92:69:1D:31:68:E9,3851706,488897965,4055,3653797,3847651,485244168,1,5435,1160361,5263,1121273,172,39088,2206,12,4313,103,1,62,216660.0,130000.0,-51.0,-48.0,-44.0,-45.0,-51.0,-47.0,-44.0,-45.0,-87.0,-87.0,-84.0,-84.0,36.0,39.0,40.0,39.0,1
1613,CC:2F:71:3F:1F:24,5060058,1878261761,1212407,1393017593,3847651,485244168,1730,1017561,1157370673,1016715,1157268287,846,102386,984099,15,1211033,121317,1727,791,144444.0,43333.0,-71.0,-70.0,-66.0,-72.0,-71.0,-70.0,-66.0,-72.0,-87.0,-87.0,-84.0,-84.0,16.0,17.0,18.0,12.0,1
1614,CC:2F:71:3E:C5:1F,3848648,485366114,997,121946,3847651,485244168,2,4320,360758,3595,274678,725,86080,1057,13,1433,28,2,54,130000.0,39000.0,-72.0,-72.0,-69.0,-60.0,-71.0,-71.0,-68.0,-60.0,-87.0,-87.0,-84.0,-84.0,15.0,15.0,15.0,24.0,1
1615,BA:8C:B9:54:50:24,3852586,491438582,4935,6194414,3847651,485244168,7,9802,1755050,9780,1751555,22,3495,2358,18,5444,43,7,72,229410.0,130000.0,-40.0,-37.0,-46.0,-51.0,-46.0,-35.0,-43.0,-46.0,-87.0,-87.0,-84.0,-84.0,47.0,50.0,38.0,33.0,1
1616,62:47:05:9D:EB:15,3854412,497427922,6756,12183290,3847656,485244632,1,7017,3805689,6967,3798031,50,7658,3317,0,6826,56,1,125,216660.0,130000.0,-44.0,-50.0,-45.0,-44.0,-43.0,-46.0,-38.0,-47.0,-87.0,-87.0,-84.0,-84.0,43.0,37.0,39.0,40.0,1
1617,92:69:1D:31:68:E9,3851711,488898429,4055,3653797,3847656,485244632,1,5435,1160361,5263,1121273,172,39088,2206,12,4313,103,1,62,216660.0,130000.0,-51.0,-48.0,-44.0,-45.0,-51.0,-47.0,-44.0,-45.0,-87.0,-87.0,-84.0,-84.0,36.0,39.0,40.0,39.0,1
1618,CC:2F:71:3F:1F:24,5060262,1878518911,1212606,1393274279,3847656,485244632,1730,1017747,1157623443,1016901,1157521057,846,102386,984277,15,1211232,121318,1727,791,144444.0,43333.0,-72.0,-68.0,-66.0,-73.0,-72.0,-68.0,-66.0,-72.0,-87.0,-87.0,-84.0,-84.0,15.0,19.0,18.0,11.0,1
1619,CC:2F:71:3E:C5:1F,3848653,485366578,997,121946,3847656,485244632,2,4320,360758,3595,274678,725,86080,1057,13,1433,28,2,54,130000.0,39000.0,-72.0,-72.0,-69.0,-60.0,-71.0,-71.0,-68.0,-60.0,-87.0,-87.0,-84.0,-84.0,15.0,15.0,15.0,24.0,1
1620,BA:8C:B9:54:50:24,3852591,491439046,4935,6194414,3847656,485244632,7,9802,1755050,9780,1751555,22,3495,2358,18,5444,43,7,72,229410.0,130000.0,-40.0,-37.0,-46.0,-51.0,-46.0,-35.0,-43.0,-46.0,-87.0,-87.0,-84.0,-84.0,47.0,50.0,38.0,33.0,1
1621,62:47:05:9D:EB:15,3854417,497428442,6757,12183406,3847660,485245036,1,7018,3805757,6968,3798099,50,7658,3317,0,6827,56,1,125,216660.0,130000.0,-43.0,-45.0,-36.0,-49.0,-43.0,-46.0,-38.0,-47.0,-87.0,-87.0,-84.0,-84.0,44.0,42.0,48.0,35.0,1
1622,92:69:1D:31:68:E9,3851716,488898949,4056,3653913,3847660,485245036,1,5437,1160497,5265,1121409,172,39088,2206,12,4314,103,1,62,216660.0,130000.0,-52.0,-48.0,-42.0,-49.0,-51.0,-47.0,-43.0,-46.0,-87.0,-87.0,-84.0,-84.0,35.0,39.0,42.0,35.0,1
1623,CC:2F:71:3F:1F:24,5060465,1878764308,1212805,1393519272,3847660,485245036,1730,1017930,1157859539,1017084,1157757153,846,102386,984453,15,1211431,121318,1727,792,144444.0,43333.0,-71.0,-69.0,-66.0,-72.0,-70.0,-69.0,-66.0,-72.0,-87.0,-87.0,-84.0,-84.0,16.0,18.0,18.0,12.0,1
1624,CC:2F:71:3E:C5:1F,3848658,485367098,998,122062,3847660,485245036,2,4322,360898,3597,274818,725,86080,1057,13,1434,28,2,54,130000.0,39000.0,-73.0,-73.0,-69.0,-60.0,-71.0,-71.0,-68.0,-60.0,-87.0,-87.0,-84.0,-84.0,14.0,14.0,15.0,24.0,1
1625,BA:8C:B9:54:50:24,3852596,491439566,4936,6194530,3847660,485245036,7,9804,1755186,9782,1751691,22,3495,2358,18,5445,43,7,72,229410.0,130000.0,-48.0,-35.0,-43.0,-45.0,-46.0,-35.0,-43.0,-46.0,-87.0,-87.0,-84.0,-84.0,39.0,52.0,41.0,39.0,1
1626,62:47:05:9D:EB:15,3854421,497428846,6757,12183406,3847664,485245440,1,7019,3805825,6969,3798167,50,7658,3317,0,6827,56,1,125,216660.0,130000.0,-43.0,-45.0,-36.0,-49.0,-43.0,-46.0,-38.0,-47.0,-87.0,-87.0,-84.0,-85.0,44.0,42.0,48.0,36.0,1
1627,92:69:1D:31:68:E9,3851720,488899353,4056,3653913,3847664,485245440,1,5437,1160497,5265,1121409,172,39088,2206,12,4314,103,1,62,216660.0,130000.0,-52.0,-48.0,-42.0,-49.0,-51.0,-47.0,-43.0,-46.0,-87.0,-87.0,-84.0,-85.0,35.0,39.0,42.0,36.0,1
1628,CC:2F:71:3F:1F:24,5060660,1879008950,1212996,1393763510,3847664,485245440,1730,1018113,1158103509,1017267,1158001123,846,102386,984623,15,1211621,121318,1727,792,144444.0,43333.0,-70.0,-69.0,-66.0,-73.0,-70.0,-69.0,-66.0,-73.0,-87.0,-87.0,-84.0,-85.0,17.0,18.0,18.0,12.0,1
1629,CC:2F:71:3E:C5:1F,3848663,485367562,998,122062,3847665,485245500,2,4322,360898,3597,274818,725,86080,1057,13,1434,28,2,54,130000.0,39000.0,-73.0,-73.0,-69.0,-60.0,-71.0,-71.0,-68.0,-60.0,-87.0,-87.0,-84.0,-85.0,14.0,14.0,15.0,25.0,1
1630,BA:8C:B9:54:50:24,3852603,491440232,4936,6194530,3847667,485245702,7,9804,1755186,9782,1751691,22,3495,2358,18,5445,43,7,72,229410.0,130000.0,-48.0,-35.0,-43.0,-45.0,-46.0,-35.0,-43.0,-46.0,-87.0,-87.0,-84.0,-85.0,39.0,52.0,41.0,40.0,1
1631,62:47:05:9D:EB:15,3854427,497429372,6757,12183406,3847670,485245966,1,7019,3805825,6969,3798167,50,7658,3317,0,6827,56,1,125,216660.0,130000.0,-43.0,-45.0,-36.0,-49.0,-43.0,-46.0,-38.0,-47.0,-87.0,-87.0,-83.0,-84.0,44.0,42.0,47.0,35.0,1
1632,92:69:1D:31:68:E9,3851726,488899879,4056,3653913,3847670,485245966,1,5437,1160497,5265,1121409,172,39088,2206,12,4314,103,1,62,216660.0,130000.0,-52.0,-48.0,-42.0,-49.0,-51.0,-47.0,-43.0,-46.0,-87.0,-87.0,-83.0,-84.0,35.0,39.0,41.0,35.0,1
1633,CC:2F:71:3F:1F:24,5060855,1879250606,1213185,1394004640,3847670,485245966,1730,1018293,1158339801,1017446,1158237297,847,102504,984796,15,1211811,121322,1727,793,144444.0,43333.0,-71.0,-69.0,-67.0,-72.0,-71.0,-69.0,-66.0,-72.0,-87.0,-87.0,-83.0,-84.0,16.0,18.0,16.0,12.0,1
1634,CC:2F:71:3E:C5:1F,3848668,485368028,998,122062,3847670,485245966,2,4322,360898,3597,274818,725,86080,1057,13,1434,28,2,54,130000.0,39000.0,-73.0,-73.0,-69.0,-60.0,-71.0,-71.0,-68.0,-60.0,-87.0,-87.0,-83.0,-84.0,14.0,14.0,14.0,24.0,1
1635,BA:8C:B9:54:50:24,3852606,491440496,4936,6194530,3847670,485245966,7,9804,1755186,9782,1751691,22,3495,2358,18,5445,43,7,72,229410.0,130000.0,-48.0,-35.0,-43.0,-45.0,-46.0,-35.0,-43.0,-46.0,-87.0,-87.0,-83.0,-84.0,39.0,52.0,40.0,39.0,1
1636,62:47:05:9D:EB:15,3854432,497430049,6757,12183406,3847675,485246643,1,7019,3805825,6969,3798167,50,7658,3317,0,6827,56,1,125,216660.0,130000.0,-43.0,-45.0,-36.0,-49.0,-43.0,-46.0,-38.0,-47.0,-87.0,-87.0,-83.0,-84.0,44.0,42.0,47.0,35.0,1
1637,92:69:1D:31:68:E9,3851731,488900556,4056,3653913,3847675,485246643,1,5437,1160497,5265,1121409,172,39088,2206,12,4314,103,1,62,216660.0,130000.0,-52.0,-48.0,-42.0,-49.0,-51.0,-47.0,-43.0,-46.0,-87.0,-87.0,-83.0,-84.0,35.0,39.0,41.0,35.0,1
1638,CC:2F:71:3F:1F:24,5061061,1879499324,1213384,1394252479,3847677,485246845,1730,1018479,1158582990,1017632,1158480486,847,102504,984972,15,1212010,121359,1727,793,144444.0,43333.0,-71.0,-69.0,-67.0,-73.0,-71.0,-69.0,-67.0,-72.0,-87.0,-87.0,-83.0,-84.0,16.0,18.0,16.0,11.0,1
1639,CC:2F:71:3E:C5:1F,3848675,485368907,998,122062,3847677,485246845,2,4322,360898,3597,274818,725,86080,1057,13,1434,28,2,54,130000.0,39000.0,-73.0,-73.0,-69.0,-60.0,-71.0,-71.0,-68.0,-60.0,-87.0,-87.0,-83.0,-84.0,14.0,14.0,14.0,24.0,1
1640,BA:8C:B9:54:50:24,3852613,491441375,4936,6194530,3847677,485246845,7,9804,1755186,9782,1751691,22,3495,2358,18,5445,43,7,72,229410.0,130000.0,-48.0,-35.0,-43.0,-45.0,-46.0,-35.0,-43.0,-46.0,-87.0,-87.0,-83.0,-84.0,39.0,52.0,40.0,39.0,1
1641,62:47:05:9D:EB:15,3854437,497430513,6757,12183406,3847680,485247107,1,7019,3805825,6969,3798167,50,7658,3317,0,6827,56,1,125,216660.0,130000.0,-43.0,-45.0,-36.0,-49.0,-43.0,-46.0,-38.0,-47.0,-87.0,-87.0,-83.0,-84.0,44.0,42.0,47.0,35.0,1
1642,92:69:1D:31:68:E9,3851736,488901020,4056,3653913,3847680,485247107,1,5437,1160497,5265,1121409,172,39088,2206,12,4314,103,1,62,216660.0,130000.0,-52.0,-48.0,-42.0,-49.0,-51.0,-47.0,-43.0,-46.0,-87.0,-87.0,-83.0,-84.0,35.0,39.0,41.0,35.0,1
1643,CC:2F:71:3F:1F:24,5061254,1879740846,1213574,1394493739,3847680,485247107,1730,1018656,1158816184,1017809,1158713680,847,102504,985144,15,1212200,121411,1727,793,144444.0,43333.0,-71.0,-70.0,-67.0,-73.0,-71.0,-70.0,-67.0,-72.0,-87.0,-87.0,-83.0,-84.0,16.0,17.0,16.0,11.0,1
1644,CC:2F:71:3E:C5:1F,3848678,485369169,998,122062,3847680,485247107,2,4322,360898,3597,274818,725,86080,1057,13,1434,28,2,54,130000.0,39000.0,-73.0,-73.0,-69.0,-60.0,-71.0,-71.0,-68.0,-60.0,-87.0,-87.0,-83.0,-84.0,14.0,14.0,14.0,24.0,1
1645,BA:8C:B9:54:50:24,3852616,491441637,4936,6194530,3847680,485247107,7,9804,1755186,9782,1751691,22,3495,2358,18,5445,43,7,72,229410.0,130000.0,-48.0,-35.0,-43.0,-45.0,-46.0,-35.0,-43.0,-46.0,-87.0,-87.0,-83.0,-84.0,39.0,52.0,40.0,39.0,1
1646,62:47:05:9D:EB:15,3854441,497430917,6757,12183406,3847684,485247511,1,7019,3805825,6969,3798167,50,7658,3317,0,6827,56,1,125,216660.0,130000.0,-43.0,-45.0,-36.0,-49.0,-43.0,-46.0,-38.0,-47.0,-87.0,-87.0,-83.0,-84.0,44.0,42.0,47.0,35.0,1
1647,92:69:1D:31:68:E9,3851742,488901626,4056,3653913,3847686,485247713,1,5437,1160497,5265,1121409,172,39088,2206,12,4314,103,1,62,216660.0,130000.0,-52.0,-48.0,-42.0,-49.0,-51.0,-47.0,-43.0,-46.0,-87.0,-87.0,-83.0,-84.0,35.0,39.0,41.0,35.0,1
1648,CC:2F:71:3F:1F:24,5061450,1879984136,1213764,1394736423,3847686,485247713,1730,1018833,1159054892,1017986,1158952388,847,102504,985313,15,1212389,121429,1727,793,144444.0,43333.0,-71.0,-70.0,-70.0,-72.0,-71.0,-69.0,-69.0,-72.0,-87.0,-87.0,-83.0,-84.0,16.0,17.0,13.0,12.0,1
1649,CC:2F:71:3E:C5:1F,3848684,485369775,998,122062,3847686,485247713,2,4322,360898,3597,274818,725,86080,1057,13,1434,28,2,54,130000.0,39000.0,-73.0,-73.0,-69.0,-60.0,-71.0,-71.0,-68.0,-60.0,-87.0,-87.0,-83.0,-84.0,14.0,14.0,14.0,24.0,1
1650,BA:8C:B9:54:50:24,3852622,491442243,4936,6194530,3847686,485247713,7,9804,1755186,9782,1751691,22,3495,2358,18,5445,43,7,72,229410.0,130000.0,-48.0,-35.0,-43.0,-45.0,-46.0,-35.0,-43.0,-46.0,-87.0,-87.0,-83.0,-84.0,39.0,52.0,40.0,39.0,1
1651,62:47:05:9D:EB:15,3854445,497431321,6757,12183406,3847688,485247915,1,7019,3805825,6969,3798167,50,7658,3317,0,6827,56,1,125,216660.0,130000.0,-43.0,-45.0,-36.0,-49.0,-43.0,-46.0,-38.0,-47.0,-87.0,-87.0,-83.0,-84.0,44.0,42.0,47.0,35.0,1
1652,92:69:1D:31:68:E9,3851744,488901828,4056,3653913,3847688,485247915,1,5437,1160497,5265,1121409,172,39088,2206,12,4314,103,1,62,216660.0,130000.0,-52.0,-48.0,-42.0,-49.0,-51.0,-47.0,-43.0,-46.0,-87.0,-87.0,-83.0,-84.0,35.0,39.0,41.0,35.0,1
1653,CC:2F:71:3F:1F:24,5061643,1880227152,1213955,1394979237,3847688,485247915,1730,1019013,1159296938,1018166,1159194434,847,102504,985484,15,1212581,121429,1727,793,144444.0,43333.0,-71.0,-70.0,-67.0,-73.0,-70.0,-70.0,-67.0,-72.0,-87.0,-87.0,-83.0,-84.0,16.0,17.0,16.0,11.0,1
1654,CC:2F:71:3E:C5:1F,3848687,485370037,998,122062,3847689,485247975,2,4322,360898,3597,274818,725,86080,1057,13,1434,28,2,54,130000.0,39000.0,-73.0,-73.0,-69.0,-60.0,-71.0,-71.0,-68.0,-60.0,-87.0,-87.0,-83.0,-84.0,14.0,14.0,14.0,24.0,1
1655,BA:8C:B9:54:50:24,3852626,491442567,4936,6194530,3847690,485248037,7,9804,1755186,9782,1751691,22,3495,2358,18,5445,43,7,72,229410.0,130000.0,-48.0,-35.0,-43.0,-45.0,-46.0,-35.0,-43.0,-46.0,-87.0,-87.0,-83.0,-84.0,39.0,52.0,40.0,39.0,1
1656,62:47:05:9D:EB:15,3854451,497431847,6757,12183406,3847694,485248441,1,7019,3805825,6969,3798167,50,7658,3317,0,6827,56,1,125,216660.0,130000.0,-43.0,-45.0,-36.0,-49.0,-43.0,-46.0,-38.0,-47.0,-87.0,-87.0,-83.0,-84.0,44.0,42.0,47.0,35.0,1
1657,92:69:1D:31:68:E9,3851752,488902556,4056,3653913,3847696,485248643,1,5437,1160497,5265,1121409,172,39088,2206,12,4314,103,1,62,216660.0,130000.0,-52.0,-48.0,-42.0,-49.0,-51.0,-47.0,-43.0,-46.0,-87.0,-87.0,-83.0,-84.0,35.0,39.0,41.0,35.0,1
1658,CC:2F:71:3F:1F:24,5061854,1880481895,1214158,1395233252,3847696,485248643,1730,1019203,1159543450,1018356,1159440946,847,102504,985668,15,1212784,121429,1727,793,144444.0,43333.0,-70.0,-70.0,-67.0,-73.0,-70.0,-69.0,-67.0,-72.0,-87.0,-87.0,-83.0,-84.0,17.0,17.0,16.0,11.0,1
1659,CC:2F:71:3E:C5:1F,3848694,485370705,998,122062,3847696,485248643,2,4324,361086,3598,274888,726,86198,1058,13,1434,28,2,54,130000.0,39000.0,-71.0,-71.0,-69.0,-60.0,-72.0,-72.0,-68.0,-60.0,-87.0,-87.0,-83.0,-84.0,16.0,16.0,14.0,24.0,1
1660,BA:8C:B9:54:50:24,3852632,491443173,4936,6194530,3847696,485248643,7,9804,1755186,9782,1751691,22,3495,2358,18,5445,43,7,72,229410.0,130000.0,-48.0,-35.0,-43.0,-45.0,-46.0,-35.0,-43.0,-46.0,-87.0,-87.0,-83.0,-84.0,39.0,52.0,40.0,39.0,1
1661,62:47:05:9D:EB:15,3854455,497432251,6757,12183406,3847698,485248845,1,7019,3805825,6969,3798167,50,7658,3317,0,6827,56,1,125,216660.0,130000.0,-43.0,-45.0,-36.0,-49.0,-43.0,-46.0,-38.0,-47.0,-87.0,-87.0,-83.0,-84.0,44.0,42.0,47.0,35.0,1
1662,92:69:1D:31:68:E9,3851754,488902758,4056,3653913,3847698,485248845,1,5437,1160497,5265,1121409,172,39088,2206,12,4314,103,1,62,216660.0,130000.0,-52.0,-48.0,-42.0,-49.0,-51.0,-47.0,-43.0,-46.0,-87.0,-87.0,-83.0,-84.0,35.0,39.0,41.0,35.0,1
1663,CC:2F:71:3F:1F:24,5062045,1880723227,1214347,1395474382,3847698,485248845,1730,1019378,1159776282,1018531,1159673778,847,102504,985837,15,1212973,121429,1727,793,144444.0,43333.0,-71.0,-70.0,-67.0,-72.0,-71.0,-69.0,-67.0,-71.0,-87.0,-87.0,-83.0,-84.0,16.0,17.0,16.0,12.0,1
1664,CC:2F:71:3E:C5:1F,3848698,485371109,998,122062,3847700,485249047,2,4324,361086,3598,274888,726,86198,1058,13,1434,28,2,54,130000.0,39000.0,-71.0,-71.0,-69.0,-60.0,-72.0,-72.0,-68.0,-60.0,-87.0,-87.0,-83.0,-84.0,16.0,16.0,14.0,24.0,1
1665,BA:8C:B9:54:50:24,3852636,491443577,4936,6194530,3847700,485249047,7,9804,1755186,9782,1751691,22,3495,2358,18,5445,43,7,72,229410.0,130000.0,-48.0,-35.0,-43.0,-45.0,-46.0,-35.0,-43.0,-46.0,-87.0,-87.0,-83.0,-84.0,39.0,52.0,40.0,39.0,1
1666,62:47:05:9D:EB:15,3854462,497432917,6757,12183406,3847705,485249511,1,7019,3805825,6969,3798167,50,7658,3317,0,6827,56,1,125,216660.0,130000.0,-43.0,-45.0,-36.0,-49.0,-43.0,-46.0,-38.0,-47.0,-87.0,-87.0,-83.0,-84.0,44.0,42.0,47.0,35.0,1
1667,92:69:1D:31:68:E9,3851761,488903424,4056,3653913,3847705,485249511,1,5438,1160565,5266,1121477,172,39088,2206,12,4314,103,1,62,216660.0,130000.0,-52.0,-47.0,-44.0,-47.0,-51.0,-47.0,-43.0,-46.0,-87.0,-87.0,-83.0,-84.0,35.0,40.0,39.0,37.0,1
1668,CC:2F:71:3F:1F:24,5062244,1880968247,1214539,1395718736,3847705,485249511,1730,1019555,1160014952,1018708,1159912448,847,102504,986008,15,1213165,121430,1727,793,144444.0,43333.0,-71.0,-70.0,-67.0,-72.0,-71.0,-69.0,-67.0,-71.0,-87.0,-87.0,-83.0,-84.0,16.0,17.0,16.0,12.0,1
1669,CC:2F:71:3E:C5:1F,3848705,485371775,998,122062,3847707,485249713,2,4324,361086,3598,274888,726,86198,1058,13,1434,28,2,54,130000.0,39000.0,-71.0,-71.0,-69.0,-60.0,-72.0,-72.0,-68.0,-60.0,-87.0,-87.0,-83.0,-84.0,16.0,16.0,14.0,24.0,1
1670,BA:8C:B9:54:50:24,3852643,491444243,4936,6194530,3847707,485249713,7,9804,1755186,9782,1751691,22,3495,2358,18,5445,43,7,72,229410.0,130000.0,-48.0,-35.0,-43.0,-45.0,-46.0,-35.0,-43.0,-46.0,-87.0,-87.0,-83.0,-84.0,39.0,52.0,40.0,39.0,1
1671,62:47:05:9D:EB:15,3854464,497433119,6757,12183406,3847707,485249713,1,7019,3805825,6969,3798167,50,7658,3317,0,6827,56,1,125,216660.0,130000.0,-43.0,-45.0,-36.0,-49.0,-43.0,-46.0,-38.0,-47.0,-87.0,-87.0,-83.0,-84.0,44.0,42.0,47.0,35.0,1
1672,92:69:1D:31:68:E9,3851765,488903828,4056,3653913,3847709,485249915,1,5438,1160565,5266,1121477,172,39088,2206,12,4314,103,1,62,216660.0,130000.0,-52.0,-47.0,-44.0,-47.0,-51.0,-47.0,-43.0,-46.0,-87.0,-87.0,-83.0,-84.0,35.0,40.0,39.0,37.0,1
1673,CC:2F:71:3F:1F:24,5062442,1881217551,1214733,1395967636,3847709,485249915,1730,1019727,1160247272,1018880,1160144768,847,102504,986180,15,1213359,121432,1727,793,144444.0,43333.0,-71.0,-70.0,-67.0,-72.0,-70.0,-69.0,-67.0,-72.0,-87.0,-87.0,-83.0,-84.0,16.0,17.0,16.0,12.0,1
1674,CC:2F:71:3E:C5:1F,3848707,485371977,998,122062,3847709,485249915,2,4324,361086,3598,274888,726,86198,1058,13,1434,28,2,54,130000.0,39000.0,-71.0,-71.0,-69.0,-60.0,-72.0,-72.0,-68.0,-60.0,-87.0,-87.0,-83.0,-84.0,16.0,16.0,14.0,24.0,1
1675,BA:8C:B9:54:50:24,3852645,491444445,4936,6194530,3847709,485249915,7,9804,1755186,9782,1751691,22,3495,2358,18,5445,43,7,72,229410.0,130000.0,-48.0,-35.0,-43.0,-45.0,-46.0,-35.0,-43.0,-46.0,-87.0,-87.0,-83.0,-84.0,39.0,52.0,40.0,39.0,1
1676,62:47:05:9D:EB:15,3854470,497433725,6757,12183406,3847713,485250319,1,7019,3805825,6969,3798167,50,7658,3317,0,6827,56,1,125,216660.0,130000.0,-43.0,-45.0,-36.0,-49.0,-43.0,-46.0,-38.0,-47.0,-87.0,-87.0,-83.0,-84.0,44.0,42.0,47.0,35.0,1
1677,92:69:1D:31:68:E9,3851769,488904232,4056,3653913,3847713,485250319,1,5438,1160565,5266,1121477,172,39088,2206,12,4314,103,1,62,216660.0,130000.0,-52.0,-47.0,-44.0,-47.0,-51.0,-47.0,-43.0,-46.0,-87.0,-87.0,-83.0,-84.0,35.0,40.0,39.0,37.0,1
1678,CC:2F:71:3F:1F:24,5062661,1881465399,1214945,1396214818,3847716,485250581,1730,1019930,1160488784,1019083,1160386280,847,102504,986376,15,1213571,121432,1727,793,144444.0,43333.0,-70.0,-70.0,-66.0,-73.0,-70.0,-70.0,-66.0,-72.0,-87.0,-87.0,-83.0,-84.0,17.0,17.0,17.0,11.0,1
1679,CC:2F:71:3E:C5:1F,3848714,485372643,998,122062,3847716,485250581,2,4324,361086,3598,274888,726,86198,1058,13,1434,28,2,54,130000.0,39000.0,-71.0,-71.0,-69.0,-60.0,-72.0,-72.0,-68.0,-60.0,-87.0,-87.0,-83.0,-84.0,16.0,16.0,14.0,24.0,1
1680,BA:8C:B9:54:50:24,3852652,491445111,4936,6194530,3847716,485250581,7,9804,1755186,9782,1751691,22,3495,2358,18,5445,43,7,72,229410.0,130000.0,-48.0,-35.0,-43.0,-45.0,-46.0,-35.0,-43.0,-46.0,-87.0,-87.0,-83.0,-84.0,39.0,52.0,40.0,39.0,1
1681,62:47:05:9D:EB:15,3854475,497434189,6757,12183406,3847718,485250783,1,7019,3805825,6969,3798167,50,7658,3317,0,6827,56,1,125,216660.0,130000.0,-43.0,-45.0,-36.0,-49.0,-43.0,-46.0,-38.0,-47.0,-87.0,-87.0,-83.0,-84.0,44.0,42.0,47.0,35.0,1
1682,92:69:1D:31:68:E9,3851774,488904696,4056,3653913,3847718,485250783,1,5438,1160565,5266,1121477,172,39088,2206,12,4314,103,1,62,216660.0,130000.0,-52.0,-47.0,-44.0,-47.0,-51.0,-47.0,-43.0,-46.0,-87.0,-87.0,-83.0,-84.0,35.0,40.0,39.0,37.0,1
1683,CC:2F:71:3F:1F:24,5062854,1881709839,1215136,1396459056,3847718,485250783,1730,1020105,1160723138,1019258,1160620634,847,102504,986546,15,1213762,121434,1727,793,144444.0,43333.0,-72.0,-69.0,-67.0,-72.0,-71.0,-69.0,-66.0,-72.0,-87.0,-87.0,-83.0,-84.0,15.0,18.0,16.0,12.0,1
1684,CC:2F:71:3E:C5:1F,3848718,485373047,998,122062,3847720,485250985,2,4326,361226,3600,275028,726,86198,1058,13,1435,28,2,54,130000.0,39000.0,-72.0,-73.0,-68.0,-60.0,-72.0,-72.0,-68.0,-60.0,-87.0,-87.0,-83.0,-84.0,15.0,14.0,15.0,24.0,1
1685,BA:8C:B9:54:50:24,3852668,491451114,4936,6194530,3847732,485256584,7,9806,1755322,9784,1751827,22,3495,2358,18,5446,43,7,72,229410.0,130000.0,-48.0,-35.0,-43.0,-45.0,-45.0,-35.0,-44.0,-47.0,-87.0,-87.0,-83.0,-84.0,39.0,52.0,40.0,39.0,1
1686,62:47:05:9D:EB:15,3854504,497445818,6757,12183406,3847747,485262412,1,7021,3805961,6971,3798303,50,7658,3317,0,6828,56,1,125,216660.0,130000.0,-43.0,-45.0,-36.0,-48.0,-43.0,-45.0,-37.0,-48.0,-87.0,-87.0,-83.0,-84.0,44.0,42.0,47.0,36.0,1
1687,92:69:1D:31:68:E9,3851803,488916325,4056,3653913,3847747,485262412,1,5441,1160936,5268,1121613,173,39323,2207,12,4314,103,1,62,216660.0,130000.0,-52.0,-47.0,-43.0,-48.0,-51.0,-47.0,-43.0,-47.0,-87.0,-87.0,-83.0,-84.0,35.0,40.0,40.0,36.0,1
1688,CC:2F:71:3F:1F:24,5063082,1881975290,1215335,1396712878,3847747,485262412,1730,1020291,1160973122,1019444,1160870618,847,102504,986723,15,1213961,121435,1727,794,144444.0,43333.0,-72.0,-69.0,-67.0,-72.0,-71.0,-69.0,-66.0,-72.0,-87.0,-87.0,-83.0,-84.0,15.0,18.0,16.0,12.0,1
1689,CC:2F:71:3E:C5:1F,3848745,485384474,998,122062,3847747,485262412,2,4326,361226,3600,275028,726,86198,1058,13,1435,28,2,54,130000.0,39000.0,-72.0,-73.0,-68.0,-60.0,-72.0,-72.0,-68.0,-60.0,-87.0,-87.0,-83.0,-84.0,15.0,14.0,15.0,24.0,1
1690,BA:8C:B9:54:50:24,3852683,491456942,4936,6194530,3847747,485262412,7,9806,1755322,9784,1751827,22,3495,2358,18,5446,43,7,72,229410.0,130000.0,-48.0,-35.0,-43.0,-45.0,-45.0,-35.0,-44.0,-47.0,-87.0,-87.0,-83.0,-84.0,39.0,52.0,40.0,39.0,1
1691,62:47:05:9D:EB:15,3854507,497446080,6757,12183406,3847750,485262674,1,7021,3805961,6971,3798303,50,7658,3317,0,6828,56,1,125,216660.0,130000.0,-43.0,-45.0,-36.0,-48.0,-43.0,-45.0,-37.0,-48.0,-87.0,-87.0,-83.0,-84.0,44.0,42.0,47.0,36.0,1
1692,92:69:1D:31:68:E9,3851806,488916587,4056,3653913,3847750,485262674,1,5441,1160936,5268,1121613,173,39323,2207,12,4314,103,1,62,216660.0,130000.0,-52.0,-47.0,-43.0,-48.0,-51.0,-47.0,-43.0,-47.0,-87.0,-87.0,-83.0,-84.0,35.0,40.0,40.0,36.0,1
1693,CC:2F:71:3F:1F:24,5063281,1882220998,1215529,1396958122,3847752,485262876,1730,1020468,1161207993,1019621,1161105489,847,102504,986896,15,1214155,121437,1727,794,144444.0,43333.0,-71.0,-69.0,-66.0,-72.0,-71.0,-69.0,-66.0,-71.0,-87.0,-87.0,-83.0,-84.0,16.0,18.0,17.0,12.0,1
1694,CC:2F:71:3E:C5:1F,3848750,485384938,998,122062,3847752,485262876,2,4326,361226,3600,275028,726,86198,1058,13,1435,28,2,54,130000.0,39000.0,-72.0,-73.0,-68.0,-60.0,-72.0,-72.0,-68.0,-60.0,-87.0,-87.0,-83.0,-84.0,15.0,14.0,15.0,24.0,1
1695,BA:8C:B9:54:50:24,3852688,491457406,4936,6194530,3847752,485262876,7,9806,1755322,9784,1751827,22,3495,2358,18,5446,43,7,72,229410.0,130000.0,-48.0,-35.0,-43.0,-45.0,-45.0,-35.0,-44.0,-47.0,-87.0,-87.0,-83.0,-84.0,39.0,52.0,40.0,39.0,1
1696,62:47:05:9D:EB:15,3854514,497446959,6757,12183406,3847757,485263553,1,7021,3805961,6971,3798303,50,7658,3317,0,6828,56,1,125,216660.0,130000.0,-43.0,-45.0,-36.0,-48.0,-43.0,-45.0,-37.0,-48.0,-87.0,-87.0,-83.0,-84.0,44.0,42.0,47.0,36.0,1
1697,92:69:1D:31:68:E9,3851813,488917466,4056,3653913,3847757,485263553,1,5441,1160936,5268,1121613,173,39323,2207,12,4314,103,1,62,216660.0,130000.0,-52.0,-47.0,-43.0,-48.0,-51.0,-47.0,-43.0,-47.0,-87.0,-87.0,-83.0,-84.0,35.0,40.0,40.0,36.0,1
1698,CC:2F:71:3F:1F:24,5063480,1882465400,1215723,1397201847,3847757,485263553,1730,1020644,1161436599,1019797,1161334095,847,102504,987071,15,1214349,121438,1727,794,144444.0,43333.0,-72.0,-69.0,-66.0,-72.0,-71.0,-69.0,-66.0,-72.0,-87.0,-87.0,-83.0,-84.0,15.0,18.0,17.0,12.0,1
1699,CC:2F:71:3E:C5:1F,3848755,485385615,998,122062,3847757,485263553,2,4326,361226,3600,275028,726,86198,1058,13,1435,28,2,54,130000.0,39000.0,-72.0,-73.0,-68.0,-60.0,-72.0,-72.0,-68.0,-60.0,-87.0,-87.0,-83.0,-84.0,15.0,14.0,15.0,24.0,1
1700,BA:8C:B9:54:50:24,3852693,491458083,4936,6194530,3847757,485263553,7,9806,1755322,9784,1751827,22,3495,2358,18,5446,43,7,72,229410.0,130000.0,-48.0,-35.0,-43.0,-45.0,-45.0,-35.0,-44.0,-47.0,-87.0,-87.0,-83.0,-84.0,39.0,52.0,40.0,39.0,1
1701,62:47:05:9D:EB:15,3854518,497447363,6757,12183406,3847761,485263957,1,7021,3805961,6971,3798303,50,7658,3317,0,6828,56,1,125,216660.0,130000.0,-43.0,-45.0,-36.0,-48.0,-43.0,-45.0,-37.0,-48.0,-87.0,-87.0,-83.0,-84.0,44.0,42.0,47.0,36.0,1
1702,92:69:1D:31:68:E9,3851817,488917870,4056,3653913,3847761,485263957,1,5441,1160936,5268,1121613,173,39323,2207,12,4314,103,1,62,216660.0,130000.0,-52.0,-47.0,-43.0,-48.0,-51.0,-47.0,-43.0,-47.0,-87.0,-87.0,-83.0,-84.0,35.0,40.0,40.0,36.0,1
1703,CC:2F:71:3F:1F:24,5063680,1882713470,1215918,1397449453,3847762,485264017,1730,1020822,1161676805,1019975,1161574301,847,102504,987244,15,1214544,121438,1727,794,144444.0,43333.0,-72.0,-69.0,-67.0,-72.0,-71.0,-69.0,-66.0,-72.0,-87.0,-87.0,-83.0,-84.0,15.0,18.0,16.0,12.0,1
1704,CC:2F:71:3E:C5:1F,3848760,485386079,998,122062,3847762,485264017,2,4326,361226,3600,275028,726,86198,1058,13,1435,28,2,54,130000.0,39000.0,-72.0,-73.0,-68.0,-60.0,-72.0,-72.0,-68.0,-60.0,-87.0,-87.0,-83.0,-84.0,15.0,14.0,15.0,24.0,1
1705,BA:8C:B9:54:50:24,3852698,491458547,4936,6194530,3847762,485264017,7,9806,1755322,9784,1751827,22,3495,2358,18,5446,43,7,72,229410.0,130000.0,-48.0,-35.0,-43.0,-45.0,-45.0,-35.0,-44.0,-47.0,-87.0,-87.0,-83.0,-84.0,39.0,52.0,40.0,39.0,1
1706,62:47:05:9D:EB:15,3854523,497447827,6757,12183406,3847766,485264421,1,7021,3805961,6971,3798303,50,7658,3317,0,6828,56,1,125,216660.0,130000.0,-43.0,-45.0,-36.0,-48.0,-43.0,-45.0,-37.0,-48.0,-87.0,-87.0,-83.0,-84.0,44.0,42.0,47.0,36.0,1
1707,92:69:1D:31:68:E9,3851822,488918334,4056,3653913,3847766,485264421,1,5441,1160936,5268,1121613,173,39323,2207,12,4314,103,1,62,216660.0,130000.0,-52.0,-47.0,-43.0,-48.0,-51.0,-47.0,-43.0,-47.0,-87.0,-87.0,-83.0,-84.0,35.0,40.0,40.0,36.0,1
1708,CC:2F:71:3F:1F:24,5063878,1882958502,1216112,1397694081,3847766,485264421,1730,1021001,1161914807,1020154,1161812303,847,102504,987414,15,1214738,121439,1727,794,144444.0,43333.0,-70.0,-70.0,-66.0,-72.0,-70.0,-70.0,-66.0,-71.0,-87.0,-87.0,-83.0,-84.0,17.0,17.0,17.0,12.0,1
1709,CC:2F:71:3E:C5:1F,3848764,485386483,998,122062,3847766,485264421,2,4326,361226,3600,275028,726,86198,1058,13,1435,28,2,54,130000.0,39000.0,-72.0,-73.0,-68.0,-60.0,-72.0,-72.0,-68.0,-60.0,-87.0,-87.0,-83.0,-84.0,15.0,14.0,15.0,24.0,1
1710,BA:8C:B9:54:50:24,3852702,491458951,4936,6194530,3847766,485264421,7,9806,1755322,9784,1751827,22,3495,2358,18,5446,43,7,72,229410.0,130000.0,-48.0,-35.0,-43.0,-45.0,-45.0,-35.0,-44.0,-47.0,-87.0,-87.0,-83.0,-84.0,39.0,52.0,40.0,39.0,1
1711,62:47:05:9D:EB:15,3854530,497448677,6757,12183406,3847773,485265271,1,7021,3805961,6971,3798303,50,7658,3317,0,6828,56,1,125,216660.0,130000.0,-43.0,-45.0,-36.0,-48.0,-43.0,-45.0,-37.0,-48.0,-87.0,-87.0,-83.0,-84.0,44.0,42.0,47.0,36.0,1
1712,92:69:1D:31:68:E9,3851829,488919184,4056,3653913,3847773,485265271,1,5441,1160936,5268,1121613,173,39323,2207,12,4314,103,1,62,216660.0,130000.0,-52.0,-47.0,-43.0,-48.0,-51.0,-47.0,-43.0,-47.0,-87.0,-87.0,-83.0,-84.0,35.0,40.0,40.0,36.0,1
1713,CC:2F:71:3F:1F:24,5064085,1883207321,1216312,1397942050,3847773,485265271,1730,1021182,1162151566,1020335,1162049062,847,102504,987591,15,1214938,121439,1727,794,144444.0,43333.0,-71.0,-70.0,-66.0,-71.0,-70.0,-69.0,-66.0,-71.0,-87.0,-87.0,-83.0,-84.0,16.0,17.0,17.0,13.0,1
1714,CC:2F:71:3E:C5:1F,3848771,485387333,998,122062,3847773,485265271,2,4326,361226,3600,275028,726,86198,1058,13,1435,28,2,54,130000.0,39000.0,-72.0,-73.0,-68.0,-60.0,-72.0,-72.0,-68.0,-60.0,-87.0,-87.0,-83.0,-84.0,15.0,14.0,15.0,24.0,1
1715,BA:8C:B9:54:50:24,3852709,491459801,4936,6194530,3847773,485265271,7,9806,1755322,9784,1751827,22,3495,2358,18,5446,43,7,72,229410.0,130000.0,-48.0,-35.0,-43.0,-45.0,-45.0,-35.0,-44.0,-47.0,-87.0,-87.0,-83.0,-84.0,39.0,52.0,40.0,39.0,1
1716,62:47:05:9D:EB:15,3854535,497449141,6757,12183406,3847778,485265735,1,7021,3805961,6971,3798303,50,7658,3317,0,6828,56,1,125,216660.0,130000.0,-43.0,-45.0,-36.0,-48.0,-43.0,-45.0,-37.0,-48.0,-87.0,-87.0,-83.0,-84.0,44.0,42.0,47.0,36.0,1
1717,92:69:1D:31:68:E9,3851834,488919648,4056,3653913,3847778,485265735,1,5441,1160936,5268,1121613,173,39323,2207,12,4314,103,1,62,216660.0,130000.0,-52.0,-47.0,-43.0,-48.0,-51.0,-47.0,-43.0,-47.0,-87.0,-87.0,-83.0,-84.0,35.0,40.0,40.0,36.0,1
1718,CC:2F:71:3F:1F:24,5064281,1883452023,1216503,1398186288,3847778,485265735,1730,1021358,1162390130,1020511,1162287626,847,102504,987761,15,1215129,121439,1727,794,144444.0,43333.0,-71.0,-70.0,-66.0,-72.0,-71.0,-70.0,-66.0,-71.0,-87.0,-87.0,-83.0,-84.0,16.0,17.0,17.0,12.0,1
1719,CC:2F:71:3E:C5:1F,3848776,485387797,998,122062,3847778,485265735,2,4326,361226,3600,275028,726,86198,1058,13,1435,28,2,54,130000.0,39000.0,-72.0,-73.0,-68.0,-60.0,-72.0,-72.0,-68.0,-60.0,-87.0,-87.0,-83.0,-84.0,15.0,14.0,15.0,24.0,1
1720,BA:8C:B9:54:50:24,3852714,491460265,4936,6194530,3847778,485265735,7,9806,1755322,9784,1751827,22,3495,2358,18,5446,43,7,72,229410.0,130000.0,-48.0,-35.0,-43.0,-45.0,-45.0,-35.0,-44.0,-47.0,-87.0,-87.0,-83.0,-84.0,39.0,52.0,40.0,39.0,1
1721,62:47:05:9D:EB:15,3854539,497449545,6757,12183406,3847782,485266139,1,7021,3805961,6971,3798303,50,7658,3317,0,6828,56,1,125,216660.0,130000.0,-43.0,-45.0,-36.0,-48.0,-43.0,-45.0,-37.0,-48.0,-87.0,-87.0,-83.0,-84.0,44.0,42.0,47.0,36.0,1
1722,92:69:1D:31:68:E9,3851838,488920052,4056,3653913,3847782,485266139,1,5441,1160936,5268,1121613,173,39323,2207,12,4314,103,1,62,216660.0,130000.0,-52.0,-47.0,-43.0,-48.0,-51.0,-47.0,-43.0,-47.0,-87.0,-87.0,-83.0,-84.0,35.0,40.0,40.0,36.0,1
1723,CC:2F:71:3F:1F:24,5064475,1883693687,1216693,1398427548,3847782,485266139,1730,1021532,1162624238,1020685,1162521734,847,102504,987929,15,1215319,121439,1727,794,144444.0,43333.0,-70.0,-70.0,-66.0,-70.0,-70.0,-70.0,-66.0,-70.0,-87.0,-87.0,-83.0,-84.0,17.0,17.0,17.0,14.0,1
1724,CC:2F:71:3E:C5:1F,3848780,485388201,998,122062,3847782,485266139,2,4326,361226,3600,275028,726,86198,1058,13,1435,28,2,54,130000.0,39000.0,-72.0,-73.0,-68.0,-60.0,-72.0,-72.0,-68.0,-60.0,-87.0,-87.0,-83.0,-84.0,15.0,14.0,15.0,24.0,1
1725,BA:8C:B9:54:50:24,3852718,491460669,4936,6194530,3847782,485266139,7,9806,1755322,9784,1751827,22,3495,2358,18,5446,43,7,72,229410.0,130000.0,-48.0,-35.0,-43.0,-45.0,-45.0,-35.0,-44.0,-47.0,-87.0,-87.0,-83.0,-84.0,39.0,52.0,40.0,39.0,1
1726,62:47:05:9D:EB:15,3854543,497449949,6757,12183406,3847786,485266543,1,7021,3805961,6971,3798303,50,7658,3317,0,6828,56,1,125,216660.0,130000.0,-43.0,-45.0,-36.0,-48.0,-43.0,-45.0,-37.0,-48.0,-87.0,-87.0,-83.0,-84.0,44.0,42.0,47.0,36.0,1
1727,92:69:1D:31:68:E9,3851843,488920516,4056,3653913,3847787,485266603,1,5441,1160936,5268,1121613,173,39323,2207,12,4314,103,1,62,216660.0,130000.0,-52.0,-47.0,-43.0,-48.0,-51.0,-47.0,-43.0,-47.0,-87.0,-87.0,-83.0,-84.0,35.0,40.0,40.0,36.0,1
1728,CC:2F:71:3F:1F:24,5064669,1883935281,1216882,1398668678,3847787,485266603,1730,1021706,1162856860,1020859,1162754356,847,102504,988098,15,1215508,121440,1727,794,144444.0,43333.0,-70.0,-70.0,-66.0,-71.0,-70.0,-70.0,-66.0,-71.0,-87.0,-87.0,-83.0,-84.0,17.0,17.0,17.0,13.0,1
1729,CC:2F:71:3E:C5:1F,3848785,485388665,998,122062,3847787,485266603,2,4326,361226,3600,275028,726,86198,1058,13,1435,28,2,54,130000.0,39000.0,-72.0,-73.0,-68.0,-60.0,-72.0,-72.0,-68.0,-60.0,-87.0,-87.0,-83.0,-84.0,15.0,14.0,15.0,24.0,1
1730,BA:8C:B9:54:50:24,3852725,491461335,4936,6194530,3847789,485266805,7,9806,1755322,9784,1751827,22,3495,2358,18,5446,43,7,72,229410.0,130000.0,-48.0,-35.0,-43.0,-45.0,-45.0,-35.0,-44.0,-47.0,-87.0,-87.0,-83.0,-84.0,39.0,52.0,40.0,39.0,1
1731,62:47:05:9D:EB:15,3854548,497450413,6757,12183406,3847791,485267007,1,7021,3805961,6971,3798303,50,7658,3317,0,6828,56,1,125,216660.0,130000.0,-43.0,-45.0,-36.0,-48.0,-43.0,-45.0,-37.0,-48.0,-87.0,-87.0,-83.0,-84.0,44.0,42.0,47.0,36.0,1
1732,92:69:1D:31:68:E9,3851847,488920920,4056,3653913,3847791,485267007,1,5441,1160936,5268,1121613,173,39323,2207,12,4314,103,1,62,216660.0,130000.0,-52.0,-47.0,-43.0,-48.0,-51.0,-47.0,-43.0,-47.0,-87.0,-87.0,-83.0,-84.0,35.0,40.0,40.0,36.0,1
1733,CC:2F:71:3F:1F:24,5064870,1884180418,1217079,1398913411,3847791,485267007,1730,1021891,1163095833,1021044,1162993329,847,102504,988274,15,1215705,121441,1727,794,144444.0,43333.0,-72.0,-69.0,-66.0,-73.0,-72.0,-69.0,-66.0,-72.0,-87.0,-87.0,-83.0,-84.0,15.0,18.0,17.0,11.0,1
1734,CC:2F:71:3E:C5:1F,3848789,485389069,998,122062,3847791,485267007,2,4326,361226,3600,275028,726,86198,1058,13,1435,28,2,54,130000.0,39000.0,-72.0,-73.0,-68.0,-60.0,-72.0,-72.0,-68.0,-60.0,-87.0,-87.0,-83.0,-84.0,15.0,14.0,15.0,24.0,1
1735,BA:8C:B9:54:50:24,3852729,491461739,4936,6194530,3847793,485267209,7,9806,1755322,9784,1751827,22,3495,2358,18,5446,43,7,72,229410.0,130000.0,-48.0,-35.0,-43.0,-45.0,-45.0,-35.0,-44.0,-47.0,-87.0,-87.0,-83.0,-84.0,39.0,52.0,40.0,39.0,1
1736,62:47:05:9D:EB:15,3854552,497450817,6757,12183406,3847795,485267411,1,7022,3806029,6972,3798371,50,7658,3317,0,6828,56,1,125,216660.0,130000.0,-44.0,-46.0,-36.0,-47.0,-43.0,-45.0,-37.0,-47.0,-87.0,-87.0,-83.0,-84.0,43.0,41.0,47.0,37.0,1
1737,92:69:1D:31:68:E9,3851851,488921324,4056,3653913,3847795,485267411,1,5441,1160936,5268,1121613,173,39323,2207,12,4314,103,1,62,216660.0,130000.0,-52.0,-47.0,-43.0,-48.0,-51.0,-47.0,-43.0,-47.0,-87.0,-87.0,-83.0,-84.0,35.0,40.0,40.0,36.0,1
1738,CC:2F:71:3F:1F:24,5065066,1884422284,1217269,1399154671,3847797,485267613,1730,1022070,1163333473,1021223,1163230969,847,102504,988443,15,1215895,121443,1727,794,144444.0,43333.0,-72.0,-69.0,-67.0,-73.0,-71.0,-69.0,-67.0,-72.0,-87.0,-87.0,-83.0,-84.0,15.0,18.0,16.0,11.0,1
1739,CC:2F:71:3E:C5:1F,3848795,485389675,998,122062,3847797,485267613,2,4326,361226,3600,275028,726,86198,1058,13,1435,28,2,54,130000.0,39000.0,-72.0,-73.0,-68.0,-60.0,-72.0,-72.0,-68.0,-60.0,-87.0,-87.0,-83.0,-84.0,15.0,14.0,15.0,24.0,1
1740,BA:8C:B9:54:50:24,3852733,491462143,4936,6194530,3847797,485267613,7,9806,1755322,9784,1751827,22,3495,2358,18,5446,43,7,72,229410.0,130000.0,-48.0,-35.0,-43.0,-45.0,-45.0,-35.0,-44.0,-47.0,-87.0,-87.0,-83.0,-84.0,39.0,52.0,40.0,39.0,1
1741,62:47:05:9D:EB:15,3854557,497451281,6757,12183406,3847800,485267875,1,7022,3806029,6972,3798371,50,7658,3317,0,6828,56,1,125,216660.0,130000.0,-44.0,-46.0,-36.0,-47.0,-43.0,-45.0,-37.0,-47.0,-87.0,-87.0,-83.0,-84.0,43.0,41.0,47.0,37.0,1
1742,92:69:1D:31:68:E9,3851856,488921788,4056,3653913,3847800,485267875,1,5441,1160936,5268,1121613,173,39323,2207,12,4314,103,1,62,216660.0,130000.0,-52.0,-47.0,-43.0,-48.0,-51.0,-47.0,-43.0,-47.0,-87.0,-87.0,-83.0,-84.0,35.0,40.0,40.0,36.0,1
1743,CC:2F:71:3F:1F:24,5065260,1884666784,1217460,1399398909,3847800,485267875,1730,1022243,1163565999,1021396,1163463495,847,102504,988613,15,1216086,121447,1727,794,144444.0,43333.0,-72.0,-70.0,-67.0,-73.0,-72.0,-69.0,-67.0,-72.0,-87.0,-87.0,-83.0,-84.0,15.0,17.0,16.0,11.0,1
1744,CC:2F:71:3E:C5:1F,3848800,485390139,998,122062,3847802,485268077,2,4326,361226,3600,275028,726,86198,1058,13,1435,28,2,54,130000.0,39000.0,-72.0,-73.0,-68.0,-60.0,-72.0,-72.0,-68.0,-60.0,-87.0,-87.0,-83.0,-84.0,15.0,14.0,15.0,24.0,1
1745,BA:8C:B9:54:50:24,3852738,491462607,4936,6194530,3847802,485268077,7,9806,1755322,9784,1751827,22,3495,2358,18,5446,43,7,72,229410.0,130000.0,-48.0,-35.0,-43.0,-45.0,-45.0,-35.0,-44.0,-47.0,-87.0,-87.0,-83.0,-84.0,39.0,52.0,40.0,39.0,1
1746,62:47:05:9D:EB:15,3854564,497452003,6758,12183522,3847806,485268481,1,7023,3806097,6973,3798439,50,7658,3317,0,6829,56,1,125,216660.0,130000.0,-43.0,-45.0,-36.0,-47.0,-43.0,-45.0,-37.0,-47.0,-87.0,-87.0,-83.0,-84.0,44.0,42.0,47.0,37.0,1
1747,92:69:1D:31:68:E9,3851863,488922510,4057,3654029,3847806,485268481,1,5443,1161072,5270,1121749,173,39323,2207,12,4315,103,1,62,216660.0,130000.0,-52.0,-48.0,-42.0,-48.0,-52.0,-47.0,-43.0,-48.0,-87.0,-87.0,-83.0,-84.0,35.0,39.0,41.0,36.0,1
1748,CC:2F:71:3F:1F:24,5065458,1884911760,1217652,1399643279,3847806,485268481,1730,1022414,1163796793,1021567,1163694289,847,102504,988783,15,1216278,121447,1727,794,144444.0,43333.0,-73.0,-69.0,-67.0,-72.0,-73.0,-69.0,-66.0,-72.0,-87.0,-87.0,-83.0,-84.0,14.0,18.0,16.0,12.0,1
1749,CC:2F:71:3E:C5:1F,3848805,485390659,999,122178,3847806,485268481,2,4328,361366,3602,275168,726,86198,1058,13,1436,28,2,54,130000.0,39000.0,-72.0,-73.0,-68.0,-60.0,-71.0,-72.0,-68.0,-60.0,-87.0,-87.0,-83.0,-84.0,15.0,14.0,15.0,24.0,1
1750,BA:8C:B9:54:50:24,3852743,491463127,4937,6194646,3847806,485268481,7,9812,1755730,9790,1752235,22,3495,2358,18,5447,43,7,72,229410.0,130000.0,-48.0,-35.0,-43.0,-45.0,-44.0,-35.0,-43.0,-46.0,-87.0,-87.0,-83.0,-84.0,39.0,52.0,40.0,39.0,1
1751,62:47:05:9D:EB:15,3854566,497452205,6758,12183522,3847808,485268683,1,7024,3806165,6974,3798507,50,7658,3317,0,6829,56,1,125,216660.0,130000.0,-43.0,-45.0,-36.0,-47.0,-43.0,-45.0,-37.0,-47.0,-87.0,-87.0,-83.0,-84.0,44.0,42.0,47.0,37.0,1
1752,92:69:1D:31:68:E9,3851868,488922974,4057,3654029,3847811,485268945,1,5443,1161072,5270,1121749,173,39323,2207,12,4315,103,1,62,216660.0,130000.0,-52.0,-48.0,-42.0,-48.0,-52.0,-47.0,-43.0,-48.0,-87.0,-87.0,-83.0,-84.0,35.0,39.0,41.0,36.0,1
1753,CC:2F:71:3F:1F:24,5065663,1885160193,1217852,1399891248,3847811,485268945,1730,1022594,1164027836,1021747,1163925332,847,102504,988962,15,1216478,121447,1727,794,144444.0,43333.0,-73.0,-69.0,-66.0,-72.0,-72.0,-69.0,-66.0,-72.0,-87.0,-87.0,-83.0,-84.0,14.0,18.0,17.0,12.0,1
1754,CC:2F:71:3E:C5:1F,3848810,485391123,999,122178,3847811,485268945,2,4328,361366,3602,275168,726,86198,1058,13,1436,28,2,54,130000.0,39000.0,-72.0,-73.0,-68.0,-60.0,-71.0,-72.0,-68.0,-60.0,-87.0,-87.0,-83.0,-84.0,15.0,14.0,15.0,24.0,1
1755,BA:8C:B9:54:50:24,3852748,491463591,4937,6194646,3847811,485268945,7,9812,1755730,9790,1752235,22,3495,2358,18,5447,43,7,72,229410.0,130000.0,-48.0,-35.0,-43.0,-45.0,-44.0,-35.0,-43.0,-46.0,-87.0,-87.0,-83.0,-84.0,39.0,52.0,40.0,39.0,1
1756,62:47:05:9D:EB:15,3854573,497452871,6758,12183522,3847815,485269349,1,7024,3806165,6974,3798507,50,7658,3317,0,6829,56,1,125,216660.0,130000.0,-43.0,-45.0,-36.0,-47.0,-43.0,-45.0,-37.0,-47.0,-87.0,-87.0,-83.0,-84.0,44.0,42.0,47.0,37.0,1
1757,92:69:1D:31:68:E9,3851872,488923378,4057,3654029,3847815,485269349,1,5443,1161072,5270,1121749,173,39323,2207,12,4315,103,1,62,216660.0,130000.0,-52.0,-48.0,-42.0,-48.0,-52.0,-47.0,-43.0,-48.0,-87.0,-87.0,-83.0,-84.0,35.0,39.0,41.0,36.0,1
1758,CC:2F:71:3F:1F:24,5065859,1885401949,1218044,1400132600,3847815,485269349,1730,1022768,1164257734,1021921,1164155230,847,102504,989132,15,1216670,121451,1727,794,144444.0,43333.0,-73.0,-70.0,-67.0,-73.0,-73.0,-70.0,-67.0,-73.0,-87.0,-87.0,-83.0,-84.0,14.0,17.0,16.0,11.0,1
1759,CC:2F:71:3E:C5:1F,3848814,485391527,999,122178,3847815,485269349,2,4328,361366,3602,275168,726,86198,1058,13,1436,28,2,54,130000.0,39000.0,-72.0,-73.0,-68.0,-60.0,-71.0,-72.0,-68.0,-60.0,-87.0,-87.0,-83.0,-84.0,15.0,14.0,15.0,24.0,1
1760,BA:8C:B9:54:50:24,3852753,491464268,4937,6194646,3847816,485269622,7,9813,1755798,9791,1752303,22,3495,2358,18,5447,43,7,72,229410.0,130000.0,-40.0,-37.0,-45.0,-51.0,-44.0,-35.0,-43.0,-46.0,-87.0,-87.0,-83.0,-84.0,47.0,50.0,38.0,33.0,1
1761,62:47:05:9D:EB:15,3854579,497453610,6758,12183522,3847821,485270088,1,7024,3806165,6974,3798507,50,7658,3317,0,6829,56,1,125,216660.0,130000.0,-43.0,-45.0,-36.0,-47.0,-43.0,-45.0,-37.0,-47.0,-87.0,-87.0,-83.0,-84.0,44.0,42.0,47.0,37.0,1
1762,92:69:1D:31:68:E9,3851878,488924117,4057,3654029,3847821,485270088,1,5443,1161072,5270,1121749,173,39323,2207,12,4315,103,1,62,216660.0,130000.0,-52.0,-48.0,-42.0,-48.0,-52.0,-47.0,-43.0,-48.0,-87.0,-87.0,-83.0,-84.0,35.0,39.0,41.0,36.0,1
1763,CC:2F:71:3F:1F:24,5066365,1886089091,1218544,1400819003,3847821,485270088,1730,1023054,1164517770,1022206,1164415148,848,102622,989410,15,1217170,121451,1727,794,144444.0,43333.0,-73.0,-70.0,-67.0,-73.0,-73.0,-70.0,-67.0,-73.0,-87.0,-87.0,-83.0,-84.0,14.0,17.0,16.0,11.0,1
1764,CC:2F:71:3E:C5:1F,3848820,485392266,999,122178,3847821,485270088,2,4328,361366,3602,275168,726,86198,1058,13,1436,28,2,54,130000.0,39000.0,-72.0,-73.0,-68.0,-60.0,-71.0,-72.0,-68.0,-60.0,-87.0,-87.0,-83.0,-84.0,15.0,14.0,15.0,24.0,1
1765,BA:8C:B9:54:50:24,3852758,491464734,4937,6194646,3847821,485270088,7,9813,1755798,9791,1752303,22,3495,2358,18,5447,43,7,72,229410.0,130000.0,-40.0,-37.0,-45.0,-51.0,-44.0,-35.0,-43.0,-46.0,-87.0,-87.0,-83.0,-84.0,47.0,50.0,38.0,33.0,1
1766,62:47:05:9D:EB:15,3854584,497454074,6758,12183522,3847826,485270552,1,7024,3806165,6974,3798507,50,7658,3317,0,6829,56,1,125,216660.0,130000.0,-43.0,-45.0,-36.0,-47.0,-43.0,-45.0,-37.0,-47.0,-87.0,-87.0,-83.0,-84.0,44.0,42.0,47.0,37.0,1
1767,92:69:1D:31:68:E9,3851883,488924581,4057,3654029,3847826,485270552,1,5443,1161072,5270,1121749,173,39323,2207,12,4315,103,1,62,216660.0,130000.0,-52.0,-48.0,-42.0,-48.0,-52.0,-47.0,-43.0,-48.0,-87.0,-88.0,-84.0,-85.0,35.0,40.0,42.0,37.0,1
1768,CC:2F:71:3F:1F:24,5066911,1886706869,1219085,1401436317,3847826,485270552,1730,1023416,1164779662,1022568,1164677040,848,102622,989768,15,1217711,121461,1727,794,144444.0,43333.0,-73.0,-70.0,-67.0,-73.0,-73.0,-70.0,-66.0,-72.0,-87.0,-88.0,-84.0,-85.0,14.0,18.0,17.0,12.0,1
1769,CC:2F:71:3E:C5:1F,3848825,485392730,999,122178,3847826,485270552,2,4328,361366,3602,275168,726,86198,1058,13,1436,28,2,54,130000.0,39000.0,-72.0,-73.0,-68.0,-60.0,-71.0,-72.0,-68.0,-60.0,-87.0,-88.0,-84.0,-85.0,15.0,15.0,16.0,25.0,1
1770,BA:8C:B9:54:50:24,3852763,491465198,4937,6194646,3847826,485270552,7,9813,1755798,9791,1752303,22,3495,2358,18,5447,43,7,72,229410.0,130000.0,-40.0,-37.0,-45.0,-51.0,-44.0,-35.0,-43.0,-46.0,-87.0,-88.0,-84.0,-85.0,47.0,51.0,39.0,34.0,1
1771,62:47:05:9D:EB:15,3854588,497454478,6758,12183522,3847830,485270956,1,7024,3806165,6974,3798507,50,7658,3317,0,6829,56,1,125,216660.0,130000.0,-43.0,-45.0,-36.0,-47.0,-43.0,-45.0,-37.0,-47.0,-87.0,-88.0,-84.0,-85.0,44.0,43.0,48.0,38.0,1
1772,92:69:1D:31:68:E9,3851887,488924985,4057,3654029,3847830,485270956,1,5443,1161072,5270,1121749,173,39323,2207,12,4315,103,1,62,216660.0,130000.0,-52.0,-48.0,-42.0,-48.0,-52.0,-47.0,-43.0,-48.0,-87.0,-88.0,-84.0,-85.0,35.0,40.0,42.0,37.0,1
1773,CC:2F:71:3F:1F:24,5067441,1887396885,1219611,1402125929,3847830,485270956,1730,1023729,1165029183,1022881,1164926561,848,102622,990076,15,1218237,121461,1727,794,144444.0,43333.0,-73.0,-70.0,-68.0,-73.0,-72.0,-70.0,-68.0,-73.0,-87.0,-88.0,-84.0,-85.0,14.0,18.0,16.0,12.0,1
1774,CC:2F:71:3E:C5:1F,3848831,485393336,999,122178,3847832,485271158,2,4328,361366,3602,275168,726,86198,1058,13,1436,28,2,54,130000.0,39000.0,-72.0,-73.0,-68.0,-60.0,-71.0,-72.0,-68.0,-60.0,-87.0,-88.0,-84.0,-85.0,15.0,15.0,16.0,25.0,1
1775,BA:8C:B9:54:50:24,3852769,491465804,4937,6194646,3847832,485271158,7,9813,1755798,9791,1752303,22,3495,2358,18,5447,43,7,72,229410.0,130000.0,-40.0,-37.0,-45.0,-51.0,-44.0,-35.0,-43.0,-46.0,-87.0,-88.0,-85.0,-86.0,47.0,51.0,40.0,35.0,1
1776,62:47:05:9D:EB:15,3854593,497454942,6758,12183522,3847835,485271420,1,7024,3806165,6974,3798507,50,7658,3317,0,6829,56,1,125,216660.0,130000.0,-43.0,-45.0,-36.0,-47.0,-43.0,-45.0,-37.0,-47.0,-87.0,-88.0,-85.0,-86.0,44.0,43.0,49.0,39.0,1
1777,92:69:1D:31:68:E9,3851892,488925449,4057,3654029,3847835,485271420,1,5443,1161072,5270,1121749,173,39323,2207,12,4315,103,1,62,216660.0,130000.0,-52.0,-48.0,-42.0,-48.0,-52.0,-47.0,-43.0,-48.0,-87.0,-88.0,-85.0,-86.0,35.0,40.0,43.0,38.0,1
1778,CC:2F:71:3F:1F:24,5068094,1888182092,1220259,1402910672,3847835,485271420,1730,1024139,1165295715,1023291,1165193093,848,102622,990483,15,1218883,121461,1727,794,144444.0,43333.0,-73.0,-70.0,-67.0,-73.0,-73.0,-70.0,-67.0,-73.0,-87.0,-88.0,-85.0,-86.0,14.0,18.0,18.0,13.0,1
1779,CC:2F:71:3E:C5:1F,3848834,485393598,999,122178,3847835,485271420,2,4328,361366,3602,275168,726,86198,1058,13,1436,28,2,54,130000.0,39000.0,-72.0,-73.0,-68.0,-60.0,-71.0,-72.0,-68.0,-60.0,-87.0,-88.0,-85.0,-86.0,15.0,15.0,17.0,26.0,1
1780,BA:8C:B9:54:50:24,3852772,491466066,4937,6194646,3847835,485271420,7,9813,1755798,9791,1752303,22,3495,2358,18,5447,43,7,72,229410.0,130000.0,-40.0,-37.0,-45.0,-51.0,-44.0,-35.0,-43.0,-46.0,-87.0,-88.0,-85.0,-86.0,47.0,51.0,40.0,35.0,1
1781,62:47:05:9D:EB:15,3854598,497455408,6758,12183522,3847840,485271886,1,7024,3806165,6974,3798507,50,7658,3317,0,6829,56,1,125,216660.0,130000.0,-43.0,-45.0,-36.0,-47.0,-43.0,-45.0,-37.0,-47.0,-87.0,-88.0,-85.0,-86.0,44.0,43.0,49.0,39.0,1
1782,92:69:1D:31:68:E9,3851897,488925915,4057,3654029,3847840,485271886,1,5443,1161072,5270,1121749,173,39323,2207,12,4315,103,1,62,216660.0,130000.0,-52.0,-48.0,-42.0,-48.0,-52.0,-47.0,-43.0,-48.0,-87.0,-88.0,-85.0,-86.0,35.0,40.0,43.0,38.0,1
1783,CC:2F:71:3F:1F:24,5068689,1888920570,1220847,1403648482,3847842,485272088,1730,1024488,1165555345,1023640,1165452723,848,102622,990831,15,1219473,121461,1727,795,144444.0,43333.0,-75.0,-73.0,-71.0,-75.0,-74.0,-73.0,-71.0,-75.0,-87.0,-88.0,-85.0,-86.0,12.0,15.0,14.0,11.0,1
1784,CC:2F:71:3E:C5:1F,3848841,485394266,999,122178,3847842,485272088,2,4330,361554,3603,275238,727,86316,1059,13,1436,28,2,54,130000.0,39000.0,-71.0,-72.0,-68.0,-60.0,-71.0,-72.0,-68.0,-60.0,-87.0,-88.0,-85.0,-86.0,16.0,16.0,17.0,26.0,1
1785,BA:8C:B9:54:50:24,3852779,491466734,4937,6194646,3847842,485272088,7,9813,1755798,9791,1752303,22,3495,2358,18,5447,43,7,72,229410.0,130000.0,-40.0,-37.0,-45.0,-51.0,-44.0,-35.0,-43.0,-46.0,-87.0,-88.0,-85.0,-86.0,47.0,51.0,40.0,35.0,1
1786,62:47:05:9D:EB:15,3854602,497455812,6758,12183522,3847844,485272290,1,7024,3806165,6974,3798507,50,7658,3317,0,6829,56,1,125,216660.0,130000.0,-43.0,-45.0,-36.0,-47.0,-43.0,-45.0,-37.0,-47.0,-88.0,-89.0,-85.0,-86.0,45.0,44.0,49.0,39.0,1
1787,92:69:1D:31:68:E9,3851901,488926319,4057,3654029,3847844,485272290,1,5443,1161072,5270,1121749,173,39323,2207,12,4315,103,1,62,216660.0,130000.0,-52.0,-48.0,-42.0,-48.0,-52.0,-47.0,-43.0,-48.0,-88.0,-89.0,-85.0,-86.0,36.0,41.0,43.0,38.0,1
1788,CC:2F:71:3F:1F:24,5069077,1889411618,1221233,1404139328,3847844,485272290,1730,1024747,1165803295,1023899,1165700673,848,102622,991086,15,1219859,121463,1727,795,144444.0,43333.0,-72.0,-70.0,-69.0,-71.0,-71.0,-70.0,-68.0,-71.0,-88.0,-89.0,-85.0,-86.0,16.0,19.0,16.0,15.0,1
1789,CC:2F:71:3E:C5:1F,3848843,485394468,999,122178,3847844,485272290,2,4330,361554,3603,275238,727,86316,1059,13,1436,28,2,54,130000.0,39000.0,-71.0,-72.0,-68.0,-60.0,-71.0,-72.0,-68.0,-60.0,-88.0,-89.0,-85.0,-86.0,17.0,17.0,17.0,26.0,1
1790,BA:8C:B9:54:50:24,3852781,491466936,4937,6194646,3847844,485272290,7,9813,1755798,9791,1752303,22,3495,2358,18,5447,43,7,72,229410.0,130000.0,-40.0,-37.0,-45.0,-51.0,-44.0,-35.0,-43.0,-46.0,-88.0,-89.0,-85.0,-86.0,48.0,52.0,40.0,35.0,1
1791,62:47:05:9D:EB:15,3854609,497456478,6758,12183522,3847851,485272956,1,7024,3806165,6974,3798507,50,7658,3317,0,6829,56,1,125,216660.0,130000.0,-43.0,-45.0,-36.0,-47.0,-43.0,-45.0,-37.0,-47.0,-88.0,-89.0,-85.0,-87.0,45.0,44.0,49.0,40.0,1
1792,92:69:1D:31:68:E9,3851908,488926985,4057,3654029,3847851,485272956,1,5443,1161072,5270,1121749,173,39323,2207,12,4315,103,1,62,216660.0,130000.0,-52.0,-48.0,-42.0,-48.0,-52.0,-47.0,-43.0,-48.0,-88.0,-89.0,-85.0,-87.0,36.0,41.0,43.0,39.0,1
1793,CC:2F:71:3F:1F:24,5069275,1889653674,1221424,1404380718,3847851,485272956,1730,1024919,1166032795,1024071,1165930173,848,102622,991256,15,1220050,121466,1727,795,144444.0,43333.0,-71.0,-70.0,-68.0,-71.0,-71.0,-70.0,-68.0,-71.0,-88.0,-89.0,-85.0,-87.0,17.0,19.0,17.0,16.0,1
1794,CC:2F:71:3E:C5:1F,3848850,485395134,999,122178,3847851,485272956,2,4330,361554,3603,275238,727,86316,1059,13,1436,28,2,54,130000.0,39000.0,-71.0,-72.0,-68.0,-60.0,-71.0,-72.0,-68.0,-60.0,-88.0,-89.0,-85.0,-87.0,17.0,17.0,17.0,27.0,1
1795,BA:8C:B9:54:50:24,3852790,491467888,4939,6194932,3847851,485272956,7,9817,1756202,9795,1752707,22,3495,2360,18,5449,44,7,72,229410.0,130000.0,-39.0,-36.0,-46.0,-52.0,-42.0,-36.0,-44.0,-48.0,-88.0,-89.0,-85.0,-87.0,49.0,53.0,39.0,35.0,1
1796,62:47:05:9D:EB:15,3854611,497456680,6758,12183522,3847853,485273158,1,7024,3806165,6974,3798507,50,7658,3317,0,6829,56,1,125,216660.0,130000.0,-43.0,-45.0,-36.0,-47.0,-43.0,-45.0,-37.0,-47.0,-88.0,-89.0,-85.0,-87.0,45.0,44.0,49.0,40.0,1
1797,92:69:1D:31:68:E9,3851910,488927187,4057,3654029,3847853,485273158,1,5443,1161072,5270,1121749,173,39323,2207,12,4315,103,1,62,216660.0,130000.0,-52.0,-48.0,-42.0,-48.0,-52.0,-47.0,-43.0,-48.0,-88.0,-89.0,-85.0,-87.0,36.0,41.0,43.0,39.0,1
1798,CC:2F:71:3F:1F:24,5069469,1889895396,1221616,1404622238,3847853,485273158,1730,1025088,1166259071,1024240,1166156449,848,102622,991425,15,1220242,121467,1727,795,144444.0,43333.0,-72.0,-70.0,-68.0,-71.0,-71.0,-69.0,-68.0,-71.0,-88.0,-89.0,-85.0,-87.0,16.0,19.0,17.0,16.0,1
1799,CC:2F:71:3E:C5:1F,3848852,485395336,999,122178,3847853,485273158,2,4330,361554,3603,275238,727,86316,1059,13,1436,28,2,54,130000.0,39000.0,-71.0,-72.0,-68.0,-60.0,-71.0,-72.0,-68.0,-60.0,-88.0,-89.0,-85.0,-87.0,17.0,17.0,17.0,27.0,1
1800,BA:8C:B9:54:50:24,3852794,491468292,4939,6194932,3847855,485273360,7,9817,1756202,9795,1752707,22,3495,2360,18,5449,44,7,72,229410.0,130000.0,-39.0,-36.0,-46.0,-52.0,-42.0,-36.0,-44.0,-48.0,-88.0,-89.0,-86.0,-87.0,49.0,53.0,40.0,35.0,1
1801,62:47:05:9D:EB:15,3854618,497457346,6758,12183522,3847860,485273824,1,7024,3806165,6974,3798507,50,7658,3317,0,6829,56,1,125,216660.0,130000.0,-43.0,-45.0,-36.0,-47.0,-43.0,-45.0,-37.0,-47.0,-88.0,-89.0,-86.0,-87.0,45.0,44.0,50.0,40.0,1
1802,92:69:1D:31:68:E9,3851917,488927853,4057,3654029,3847860,485273824,1,5443,1161072,5270,1121749,173,39323,2207,12,4315,103,1,62,216660.0,130000.0,-52.0,-48.0,-42.0,-48.0,-52.0,-47.0,-43.0,-48.0,-88.0,-89.0,-86.0,-87.0,36.0,41.0,44.0,39.0,1
1803,CC:2F:71:3F:1F:24,5069666,1890135898,1221806,1404862074,3847860,485273824,1730,1025255,1166482267,1024407,1166379645,848,102622,991592,15,1220432,121467,1727,795,144444.0,43333.0,-71.0,-70.0,-68.0,-74.0,-71.0,-69.0,-67.0,-73.0,-88.0,-89.0,-86.0,-87.0,17.0,19.0,18.0,13.0,1
1804,CC:2F:71:3E:C5:1F,3848859,485396002,999,122178,3847860,485273824,2,4330,361554,3603,275238,727,86316,1059,13,1436,28,2,54,130000.0,39000.0,-71.0,-72.0,-68.0,-60.0,-71.0,-72.0,-68.0,-60.0,-88.0,-89.0,-86.0,-87.0,17.0,17.0,18.0,27.0,1
1805,BA:8C:B9:54:50:24,3852801,491468958,4939,6194932,3847862,485274026,7,9817,1756202,9795,1752707,22,3495,2360,18,5449,44,7,72,229410.0,130000.0,-39.0,-36.0,-46.0,-52.0,-42.0,-36.0,-44.0,-48.0,-88.0,-89.0,-86.0,-87.0,49.0,53.0,40.0,35.0,1
1806,62:47:05:9D:EB:15,3854620,497457548,6758,12183522,3847862,485274026,1,7024,3806165,6974,3798507,50,7658,3317,0,6829,56,1,125,216660.0,130000.0,-43.0,-45.0,-36.0,-47.0,-43.0,-45.0,-37.0,-47.0,-88.0,-90.0,-86.0,-88.0,45.0,45.0,50.0,41.0,1
1807,92:69:1D:31:68:E9,3851919,488928055,4057,3654029,3847862,485274026,1,5445,1161208,5272,1121885,173,39323,2207,12,4316,103,1,62,216660.0,130000.0,-51.0,-47.0,-42.0,-48.0,-51.0,-47.0,-43.0,-48.0,-88.0,-90.0,-86.0,-88.0,37.0,43.0,44.0,40.0,1
1808,CC:2F:71:3F:1F:24,5069866,1890379585,1222004,1405105559,3847862,485274026,1730,1025436,1166710462,1024588,1166607840,848,102622,991773,15,1220630,121469,1727,795,144444.0,43333.0,-73.0,-71.0,-69.0,-74.0,-73.0,-70.0,-69.0,-74.0,-88.0,-90.0,-86.0,-88.0,15.0,19.0,17.0,14.0,1
1809,CC:2F:71:3E:C5:1F,3848861,485396204,999,122178,3847862,485274026,2,4330,361554,3603,275238,727,86316,1059,13,1436,28,2,54,130000.0,39000.0,-71.0,-72.0,-68.0,-60.0,-71.0,-72.0,-68.0,-60.0,-88.0,-90.0,-86.0,-88.0,17.0,18.0,18.0,28.0,1
1810,BA:8C:B9:54:50:24,3852803,491469160,4939,6194932,3847864,485274228,7,9817,1756202,9795,1752707,22,3495,2360,18,5449,44,7,72,229410.0,130000.0,-39.0,-36.0,-46.0,-52.0,-42.0,-36.0,-44.0,-48.0,-88.0,-90.0,-86.0,-88.0,49.0,54.0,40.0,36.0,1
1811,62:47:05:9D:EB:15,3854626,497458154,6758,12183522,3847868,485274632,1,7026,3806301,6976,3798643,50,7658,3317,0,6830,56,1,125,216660.0,130000.0,-43.0,-45.0,-36.0,-48.0,-43.0,-45.0,-36.0,-47.0,-88.0,-90.0,-87.0,-88.0,45.0,45.0,51.0,40.0,1
1812,92:69:1D:31:68:E9,3851925,488928661,4057,3654029,3847868,485274632,1,5445,1161208,5272,1121885,173,39323,2207,12,4316,103,1,62,216660.0,130000.0,-51.0,-47.0,-42.0,-48.0,-51.0,-47.0,-43.0,-48.0,-88.0,-90.0,-87.0,-88.0,37.0,43.0,45.0,40.0,1
1813,CC:2F:71:3F:1F:24,5070066,1890621913,1222196,1405347079,3847870,485274834,1730,1025605,1166936738,1024757,1166834116,848,102622,991942,15,1220822,121470,1727,795,144444.0,43333.0,-72.0,-70.0,-68.0,-73.0,-72.0,-70.0,-68.0,-72.0,-88.0,-90.0,-87.0,-88.0,16.0,20.0,19.0,15.0,1
1814,CC:2F:71:3E:C5:1F,3848869,485397012,999,122178,3847870,485274834,2,4330,361554,3603,275238,727,86316,1059,13,1436,28,2,54,130000.0,39000.0,-71.0,-72.0,-68.0,-60.0,-71.0,-72.0,-68.0,-60.0,-88.0,-90.0,-87.0,-88.0,17.0,18.0,19.0,28.0,1
1815,BA:8C:B9:54:50:24,3852809,491469766,4939,6194932,3847870,485274834,7,9817,1756202,9795,1752707,22,3495,2360,18,5449,44,7,72,229410.0,130000.0,-39.0,-36.0,-46.0,-52.0,-42.0,-36.0,-44.0,-48.0,-88.0,-90.0,-87.0,-88.0,49.0,54.0,41.0,36.0,1
1816,62:47:05:9D:EB:15,3854629,497458416,6758,12183522,3847871,485274894,1,7026,3806301,6976,3798643,50,7658,3317,0,6830,56,1,125,216660.0,130000.0,-43.0,-45.0,-36.0,-48.0,-43.0,-45.0,-36.0,-47.0,-88.0,-90.0,-87.0,-88.0,45.0,45.0,51.0,40.0,1
1817,92:69:1D:31:68:E9,3851928,488928923,4057,3654029,3847871,485274894,1,5445,1161208,5272,1121885,173,39323,2207,12,4316,103,1,62,216660.0,130000.0,-51.0,-47.0,-42.0,-48.0,-51.0,-47.0,-43.0,-48.0,-89.0,-90.0,-87.0,-89.0,38.0,43.0,45.0,41.0,1
1818,CC:2F:71:3F:1F:24,5070260,1890866471,1222389,1405591577,3847871,485274894,1730,1025777,1167166224,1024929,1167063602,848,102622,992113,15,1221014,121470,1727,795,144444.0,43333.0,-73.0,-70.0,-68.0,-73.0,-73.0,-70.0,-68.0,-73.0,-89.0,-90.0,-87.0,-89.0,16.0,20.0,19.0,16.0,1
1819,CC:2F:71:3E:C5:1F,3848872,485397274,999,122178,3847873,485275096,2,4330,361554,3603,275238,727,86316,1059,13,1436,28,2,54,130000.0,39000.0,-71.0,-72.0,-68.0,-60.0,-71.0,-72.0,-68.0,-60.0,-89.0,-90.0,-87.0,-89.0,18.0,18.0,19.0,29.0,1
1820,BA:8C:B9:54:50:24,3852812,491470028,4939,6194932,3847873,485275096,7,9817,1756202,9795,1752707,22,3495,2360,18,5449,44,7,72,229410.0,130000.0,-39.0,-36.0,-46.0,-52.0,-42.0,-36.0,-44.0,-48.0,-89.0,-90.0,-87.0,-89.0,50.0,54.0,41.0,37.0,1
1821,62:47:05:9D:EB:15,3854636,497459295,6758,12183522,3847878,485275773,1,7026,3806301,6976,3798643,50,7658,3317,0,6830,56,1,125,216660.0,130000.0,-43.0,-45.0,-36.0,-48.0,-43.0,-45.0,-36.0,-47.0,-89.0,-90.0,-87.0,-89.0,46.0,45.0,51.0,41.0,1
1822,92:69:1D:31:68:E9,3851937,488930004,4057,3654029,3847880,485275975,1,5445,1161208,5272,1121885,173,39323,2207,12,4316,103,1,62,216660.0,130000.0,-51.0,-47.0,-42.0,-48.0,-51.0,-47.0,-43.0,-48.0,-89.0,-90.0,-87.0,-89.0,38.0,43.0,45.0,41.0,1
1823,CC:2F:71:3F:1F:24,5070459,1891108812,1222579,1405832837,3847880,485275975,1730,1025946,1167393980,1025098,1167291358,848,102622,992282,15,1221205,121470,1727,795,144444.0,43333.0,-76.0,-74.0,-73.0,-76.0,-75.0,-73.0,-72.0,-75.0,-89.0,-90.0,-87.0,-89.0,13.0,16.0,14.0,13.0,1
1824,CC:2F:71:3E:C5:1F,3848879,485398153,999,122178,3847880,485275975,2,4330,361554,3603,275238,727,86316,1059,13,1436,28,2,54,130000.0,39000.0,-71.0,-72.0,-68.0,-60.0,-71.0,-72.0,-68.0,-60.0,-89.0,-90.0,-87.0,-89.0,18.0,18.0,19.0,29.0,1
1825,BA:8C:B9:54:50:24,3852819,491470907,4939,6194932,3847880,485275975,7,9817,1756202,9795,1752707,22,3495,2360,18,5449,44,7,72,229410.0,130000.0,-39.0,-36.0,-46.0,-52.0,-42.0,-36.0,-44.0,-48.0,-89.0,-91.0,-87.0,-89.0,50.0,55.0,41.0,37.0,1
1826,62:47:05:9D:EB:15,3854639,497459557,6758,12183522,3847881,485276035,1,7026,3806301,6976,3798643,50,7658,3317,0,6830,56,1,125,216660.0,130000.0,-43.0,-45.0,-36.0,-48.0,-43.0,-45.0,-36.0,-47.0,-89.0,-91.0,-87.0,-89.0,46.0,46.0,51.0,41.0,1
1827,92:69:1D:31:68:E9,3851940,488930266,4057,3654029,3847883,485276237,1,5445,1161208,5272,1121885,173,39323,2207,12,4316,103,1,62,216660.0,130000.0,-51.0,-47.0,-42.0,-48.0,-51.0,-47.0,-43.0,-48.0,-89.0,-91.0,-87.0,-89.0,38.0,44.0,45.0,41.0,1
1828,CC:2F:71:3F:1F:24,5070660,1891353921,1222777,1406077684,3847883,485276237,1730,1026124,1167623373,1025276,1167520751,848,102622,992459,15,1221403,121470,1727,795,144444.0,43333.0,-72.0,-70.0,-68.0,-73.0,-72.0,-69.0,-67.0,-72.0,-89.0,-91.0,-87.0,-89.0,17.0,21.0,19.0,16.0,1
1829,CC:2F:71:3E:C5:1F,3848882,485398415,999,122178,3847883,485276237,2,4330,361554,3603,275238,727,86316,1059,13,1436,28,2,54,130000.0,39000.0,-71.0,-72.0,-68.0,-60.0,-71.0,-72.0,-68.0,-60.0,-89.0,-91.0,-87.0,-89.0,18.0,19.0,19.0,29.0,1
1830,BA:8C:B9:54:50:24,3852823,491471285,4940,6195048,3847883,485276237,7,9820,1756448,9798,1752953,22,3495,2361,18,5450,44,7,72,229410.0,130000.0,-39.0,-36.0,-45.0,-51.0,-42.0,-37.0,-45.0,-50.0,-89.0,-91.0,-87.0,-89.0,50.0,55.0,42.0,38.0,1
1831,62:47:05:9D:EB:15,3854647,497460365,6758,12183522,3847889,485276843,1,7026,3806301,6976,3798643,50,7658,3317,0,6830,56,1,125,216660.0,130000.0,-43.0,-45.0,-36.0,-48.0,-43.0,-45.0,-36.0,-47.0,-89.0,-91.0,-88.0,-90.0,46.0,46.0,52.0,42.0,1
1832,92:69:1D:31:68:E9,3851946,488930872,4057,3654029,3847889,485276843,1,5445,1161208,5272,1121885,173,39323,2207,12,4316,103,1,62,216660.0,130000.0,-51.0,-47.0,-42.0,-48.0,-51.0,-47.0,-43.0,-48.0,-89.0,-91.0,-88.0,-90.0,38.0,44.0,46.0,42.0,1
1833,CC:2F:71:3F:1F:24,5070861,1891604981,1222972,1406328138,3847889,485276843,1730,1026299,1167858987,1025451,1167756365,848,102622,992634,15,1221598,121470,1727,795,144444.0,43333.0,-72.0,-70.0,-67.0,-72.0,-72.0,-70.0,-67.0,-72.0,-89.0,-91.0,-88.0,-90.0,17.0,21.0,21.0,18.0,1
1834,CC:2F:71:3E:C5:1F,3848888,485399021,999,122178,3847889,485276843,2,4330,361554,3603,275238,727,86316,1059,13,1436,28,2,54,130000.0,39000.0,-71.0,-72.0,-68.0,-60.0,-71.0,-72.0,-68.0,-60.0,-89.0,-91.0,-88.0,-90.0,18.0,19.0,20.0,30.0,1
1835,BA:8C:B9:54:50:24,3852829,491471891,4940,6195048,3847889,485276843,7,9820,1756448,9798,1752953,22,3495,2361,18,5450,44,7,72,229410.0,130000.0,-39.0,-36.0,-45.0,-51.0,-42.0,-37.0,-45.0,-50.0,-89.0,-91.0,-88.0,-90.0,50.0,55.0,43.0,39.0,1
1836,62:47:05:9D:EB:15,3854649,497460567,6758,12183522,3847891,485277045,1,7026,3806301,6976,3798643,50,7658,3317,0,6830,56,1,125,216660.0,130000.0,-43.0,-45.0,-36.0,-48.0,-43.0,-45.0,-36.0,-47.0,-89.0,-92.0,-88.0,-91.0,46.0,47.0,52.0,43.0,1
1837,92:69:1D:31:68:E9,3851948,488931074,4057,3654029,3847891,485277045,1,5445,1161208,5272,1121885,173,39323,2207,12,4316,103,1,62,216660.0,130000.0,-51.0,-47.0,-42.0,-48.0,-51.0,-47.0,-43.0,-48.0,-89.0,-92.0,-88.0,-91.0,38.0,45.0,46.0,43.0,1
1838,CC:2F:71:3F:1F:24,5071051,1891843335,1223160,1406566290,3847891,485277045,1730,1026465,1168082067,1025617,1167979445,848,102622,992800,15,1221786,121470,1727,795,144444.0,43333.0,-72.0,-70.0,-68.0,-73.0,-72.0,-70.0,-67.0,-73.0,-89.0,-92.0,-88.0,-91.0,17.0,22.0,20.0,18.0,1
1839,CC:2F:71:3E:C5:1F,3848890,485399223,999,122178,3847891,485277045,2,4330,361554,3603,275238,727,86316,1059,13,1436,28,2,54,130000.0,39000.0,-71.0,-72.0,-68.0,-60.0,-71.0,-72.0,-68.0,-60.0,-89.0,-92.0,-88.0,-91.0,18.0,20.0,20.0,31.0,1
1840,BA:8C:B9:54:50:24,3852831,491472093,4940,6195048,3847891,485277045,7,9820,1756448,9798,1752953,22,3495,2361,18,5450,44,7,72,229410.0,130000.0,-39.0,-36.0,-45.0,-51.0,-42.0,-37.0,-45.0,-50.0,-89.0,-92.0,-88.0,-91.0,50.0,56.0,43.0,40.0,1
1841,62:47:05:9D:EB:15,3854656,497461233,6758,12183522,3847898,485277711,1,7026,3806301,6976,3798643,50,7658,3317,0,6830,56,1,125,216660.0,130000.0,-43.0,-45.0,-36.0,-48.0,-43.0,-45.0,-36.0,-47.0,-89.0,-92.0,-88.0,-91.0,46.0,47.0,52.0,43.0,1
1842,92:69:1D:31:68:E9,3851955,488931740,4057,3654029,3847898,485277711,1,5445,1161208,5272,1121885,173,39323,2207,12,4316,103,1,62,216660.0,130000.0,-51.0,-47.0,-42.0,-48.0,-51.0,-47.0,-43.0,-48.0,-90.0,-92.0,-89.0,-91.0,39.0,45.0,47.0,43.0,1
1843,CC:2F:71:3F:1F:24,5071256,1892091710,1223358,1406813999,3847898,485277711,1730,1026643,1168312782,1025795,1168210160,848,102622,992978,15,1221984,121470,1727,795,144444.0,43333.0,-72.0,-70.0,-68.0,-72.0,-71.0,-69.0,-67.0,-72.0,-90.0,-92.0,-89.0,-91.0,18.0,22.0,21.0,19.0,1
1844,CC:2F:71:3E:C5:1F,3848897,485399889,999,122178,3847898,485277711,2,4330,361554,3603,275238,727,86316,1059,13,1436,28,2,54,130000.0,39000.0,-71.0,-72.0,-68.0,-60.0,-71.0,-72.0,-68.0,-60.0,-90.0,-92.0,-89.0,-91.0,19.0,20.0,21.0,31.0,1
1845,BA:8C:B9:54:50:24,3852838,491472759,4940,6195048,3847898,485277711,7,9820,1756448,9798,1752953,22,3495,2361,18,5450,44,7,72,229410.0,130000.0,-39.0,-36.0,-45.0,-51.0,-42.0,-37.0,-45.0,-50.0,-90.0,-92.0,-89.0,-91.0,51.0,56.0,44.0,40.0,1
1846,62:47:05:9D:EB:15,3854658,497461435,6758,12183522,3847900,485277913,1,7026,3806301,6976,3798643,50,7658,3317,0,6830,56,1,125,216660.0,130000.0,-43.0,-45.0,-36.0,-48.0,-43.0,-45.0,-36.0,-47.0,-90.0,-92.0,-89.0,-91.0,47.0,47.0,53.0,43.0,1
1847,92:69:1D:31:68:E9,3851957,488931942,4057,3654029,3847900,485277913,1,5445,1161208,5272,1121885,173,39323,2207,12,4316,103,1,62,216660.0,130000.0,-51.0,-47.0,-42.0,-48.0,-51.0,-47.0,-43.0,-48.0,-90.0,-92.0,-89.0,-91.0,39.0,45.0,47.0,43.0,1
1848,CC:2F:71:3F:1F:24,5071451,1892336426,1223551,1407058513,3847900,485277913,1730,1026812,1168539156,1025964,1168436534,848,102622,993147,15,1222177,121470,1727,795,144444.0,43333.0,-72.0,-70.0,-68.0,-73.0,-72.0,-70.0,-67.0,-72.0,-90.0,-92.0,-89.0,-91.0,18.0,22.0,21.0,18.0,1
1849,CC:2F:71:3E:C5:1F,3848899,485400091,999,122178,3847900,485277913,2,4330,361554,3603,275238,727,86316,1059,13,1436,28,2,54,130000.0,39000.0,-71.0,-72.0,-68.0,-60.0,-71.0,-72.0,-68.0,-60.0,-90.0,-92.0,-89.0,-91.0,19.0,20.0,21.0,31.0,1
1850,BA:8C:B9:54:50:24,3852842,491473163,4940,6195048,3847902,485278115,7,9820,1756448,9798,1752953,22,3495,2361,18,5450,44,7,72,229410.0,130000.0,-39.0,-36.0,-45.0,-51.0,-42.0,-37.0,-45.0,-50.0,-90.0,-92.0,-89.0,-91.0,51.0,56.0,44.0,40.0,1
1851,62:47:05:9D:EB:15,3854665,497462101,6758,12183522,3847907,485278579,1,7026,3806301,6976,3798643,50,7658,3317,0,6830,56,1,125,216660.0,130000.0,-43.0,-45.0,-36.0,-48.0,-43.0,-45.0,-36.0,-47.0,-90.0,-92.0,-89.0,-91.0,47.0,47.0,53.0,43.0,1
1852,92:69:1D:31:68:E9,3851964,488932608,4057,3654029,3847907,485278579,1,5446,1161276,5273,1121953,173,39323,2207,12,4316,103,1,62,216660.0,130000.0,-52.0,-47.0,-44.0,-47.0,-51.0,-47.0,-43.0,-48.0,-90.0,-92.0,-89.0,-91.0,38.0,45.0,45.0,44.0,1
1853,CC:2F:71:3F:1F:24,5071647,1892576814,1223740,1407298235,3847907,485278579,1730,1026980,1168765316,1026132,1168662694,848,102622,993315,15,1222366,121470,1727,795,144444.0,43333.0,-72.0,-70.0,-67.0,-72.0,-72.0,-70.0,-67.0,-72.0,-90.0,-92.0,-89.0,-91.0,18.0,22.0,22.0,19.0,1
1854,CC:2F:71:3E:C5:1F,3848906,485400757,999,122178,3847907,485278579,2,4330,361554,3603,275238,727,86316,1059,13,1436,28,2,54,130000.0,39000.0,-71.0,-72.0,-68.0,-60.0,-71.0,-72.0,-68.0,-60.0,-90.0,-92.0,-89.0,-91.0,19.0,20.0,21.0,31.0,1
1855,BA:8C:B9:54:50:24,3852847,491473627,4940,6195048,3847907,485278579,7,9820,1756448,9798,1752953,22,3495,2361,18,5450,44,7,72,229410.0,130000.0,-39.0,-36.0,-45.0,-51.0,-42.0,-37.0,-45.0,-50.0,-90.0,-92.0,-89.0,-91.0,51.0,56.0,44.0,40.0,1
1856,62:47:05:9D:EB:15,3854667,497462303,6758,12183522,3847909,485278781,1,7026,3806301,6976,3798643,50,7658,3317,0,6830,56,1,125,216660.0,130000.0,-43.0,-45.0,-36.0,-48.0,-43.0,-45.0,-36.0,-47.0,-90.0,-92.0,-89.0,-92.0,47.0,47.0,53.0,44.0,1
1857,92:69:1D:31:68:E9,3851966,488932810,4057,3654029,3847909,485278781,1,5446,1161276,5273,1121953,173,39323,2207,12,4316,103,1,62,216660.0,130000.0,-52.0,-47.0,-44.0,-47.0,-51.0,-47.0,-43.0,-48.0,-90.0,-92.0,-89.0,-92.0,38.0,45.0,45.0,45.0,1
1858,CC:2F:71:3F:1F:24,5071840,1892819678,1223931,1407540897,3847909,485278781,1730,1027152,1168994788,1026304,1168892166,848,102622,993487,15,1222557,121470,1727,795,144444.0,43333.0,-71.0,-68.0,-67.0,-73.0,-71.0,-68.0,-67.0,-72.0,-90.0,-92.0,-89.0,-92.0,19.0,24.0,22.0,19.0,1
1859,CC:2F:71:3E:C5:1F,3848908,485400959,999,122178,3847909,485278781,2,4330,361554,3603,275238,727,86316,1059,13,1436,28,2,54,130000.0,39000.0,-71.0,-72.0,-68.0,-60.0,-71.0,-72.0,-68.0,-60.0,-90.0,-92.0,-89.0,-92.0,19.0,20.0,21.0,32.0,1
1860,BA:8C:B9:54:50:24,3852851,491474031,4940,6195048,3847911,485278983,7,9820,1756448,9798,1752953,22,3495,2361,18,5450,44,7,72,229410.0,130000.0,-39.0,-36.0,-45.0,-51.0,-42.0,-37.0,-45.0,-50.0,-90.0,-92.0,-89.0,-92.0,51.0,56.0,44.0,41.0,1
1861,62:47:05:9D:EB:15,3854673,497462909,6758,12183522,3847915,485279387,1,7026,3806301,6976,3798643,50,7658,3317,0,6830,56,1,125,216660.0,130000.0,-43.0,-45.0,-36.0,-48.0,-43.0,-45.0,-36.0,-47.0,-90.0,-93.0,-89.0,-92.0,47.0,48.0,53.0,44.0,1
1862,92:69:1D:31:68:E9,3851972,488933416,4057,3654029,3847915,485279387,1,5446,1161276,5273,1121953,173,39323,2207,12,4316,103,1,62,216660.0,130000.0,-52.0,-47.0,-44.0,-47.0,-51.0,-47.0,-43.0,-48.0,-90.0,-93.0,-89.0,-92.0,38.0,46.0,45.0,45.0,1
1863,CC:2F:71:3F:1F:24,5072046,1893068269,1224131,1407788882,3847915,485279387,1730,1027330,1169225517,1026482,1169122895,848,102622,993665,15,1222757,121472,1727,795,144444.0,43333.0,-70.0,-69.0,-66.0,-73.0,-69.0,-69.0,-66.0,-73.0,-90.0,-93.0,-89.0,-92.0,20.0,24.0,23.0,19.0,1
1864,CC:2F:71:3E:C5:1F,3848914,485401565,999,122178,3847915,485279387,2,4330,361554,3603,275238,727,86316,1059,13,1436,28,2,54,130000.0,39000.0,-71.0,-72.0,-68.0,-60.0,-71.0,-72.0,-68.0,-60.0,-90.0,-93.0,-89.0,-92.0,19.0,21.0,21.0,32.0,1
1865,BA:8C:B9:54:50:24,3852855,491474435,4940,6195048,3847915,485279387,7,9820,1756448,9798,1752953,22,3495,2361,18,5450,44,7,72,229410.0,130000.0,-39.0,-36.0,-45.0,-51.0,-42.0,-37.0,-45.0,-50.0,-90.0,-93.0,-89.0,-92.0,51.0,57.0,44.0,41.0,1
1866,62:47:05:9D:EB:15,3854677,497463297,6758,12183522,3847919,485279775,1,7026,3806301,6976,3798643,50,7658,3317,0,6830,56,1,125,216660.0,130000.0,-43.0,-45.0,-36.0,-48.0,-43.0,-45.0,-36.0,-47.0,-90.0,-93.0,-89.0,-92.0,47.0,48.0,53.0,44.0,1
1867,92:69:1D:31:68:E9,3851976,488933804,4057,3654029,3847919,485279775,1,5446,1161276,5273,1121953,173,39323,2207,12,4316,103,1,62,216660.0,130000.0,-52.0,-47.0,-44.0,-47.0,-51.0,-47.0,-43.0,-48.0,-90.0,-93.0,-90.0,-93.0,38.0,46.0,46.0,46.0,1
1868,CC:2F:71:3F:1F:24,5072238,1893309673,1224319,1408029898,3847919,485279775,1730,1027498,1169450253,1026650,1169347631,848,102622,993833,15,1222945,121475,1727,795,144444.0,43333.0,-69.0,-68.0,-69.0,-74.0,-69.0,-68.0,-68.0,-73.0,-90.0,-93.0,-90.0,-93.0,21.0,25.0,21.0,19.0,1
1869,CC:2F:71:3E:C5:1F,3848918,485401953,999,122178,3847919,485279775,2,4330,361554,3603,275238,727,86316,1059,13,1436,28,2,54,130000.0,39000.0,-71.0,-72.0,-68.0,-60.0,-71.0,-72.0,-68.0,-60.0,-90.0,-93.0,-90.0,-93.0,19.0,21.0,22.0,33.0,1
1870,BA:8C:B9:54:50:24,3852863,491475227,4940,6195048,3847923,485280179,7,9820,1756448,9798,1752953,22,3495,2361,18,5450,44,7,72,229410.0,130000.0,-39.0,-36.0,-45.0,-51.0,-42.0,-37.0,-45.0,-50.0,-90.0,-93.0,-90.0,-93.0,51.0,57.0,45.0,42.0,1
1871,62:47:05:9D:EB:15,3854683,497463903,6758,12183522,3847925,485280381,1,7026,3806301,6976,3798643,50,7658,3317,0,6830,56,1,125,216660.0,130000.0,-43.0,-45.0,-36.0,-48.0,-43.0,-45.0,-36.0,-47.0,-90.0,-93.0,-90.0,-93.0,47.0,48.0,54.0,45.0,1
1872,92:69:1D:31:68:E9,3851983,488934526,4058,3654145,3847925,485280381,1,5448,1161412,5275,1122089,173,39323,2207,12,4317,103,1,62,216660.0,130000.0,-51.0,-48.0,-44.0,-47.0,-51.0,-47.0,-43.0,-47.0,-90.0,-93.0,-90.0,-93.0,39.0,45.0,46.0,46.0,1
1873,CC:2F:71:3F:1F:24,5072436,1893551801,1224511,1408271420,3847925,485280381,1730,1027670,1169678329,1026822,1169575707,848,102622,994005,15,1223137,121476,1727,795,144444.0,43333.0,-69.0,-69.0,-70.0,-73.0,-69.0,-68.0,-69.0,-73.0,-90.0,-93.0,-90.0,-93.0,21.0,24.0,20.0,20.0,1
1874,CC:2F:71:3E:C5:1F,3848925,485402675,1000,122294,3847925,485280381,2,4332,361694,3605,275378,727,86316,1059,13,1437,28,2,54,130000.0,39000.0,-72.0,-71.0,-69.0,-61.0,-71.0,-72.0,-68.0,-60.0,-90.0,-93.0,-90.0,-93.0,18.0,22.0,21.0,32.0,1
1875,BA:8C:B9:54:50:24,3852866,491475545,4941,6195164,3847925,485280381,7,9824,1756720,9802,1753225,22,3495,2361,18,5451,44,7,72,229410.0,130000.0,-40.0,-36.0,-45.0,-51.0,-41.0,-35.0,-44.0,-49.0,-90.0,-93.0,-90.0,-93.0,50.0,57.0,45.0,42.0,1
1876,62:47:05:9D:EB:15,3854688,497464343,6759,12183638,3847929,485280705,1,7028,3806437,6978,3798779,50,7658,3317,0,6831,56,1,125,216660.0,130000.0,-45.0,-45.0,-36.0,-47.0,-43.0,-45.0,-36.0,-47.0,-91.0,-93.0,-90.0,-93.0,46.0,48.0,54.0,46.0,1
1877,92:69:1D:31:68:E9,3851987,488934850,4058,3654145,3847929,485280705,1,5448,1161412,5275,1122089,173,39323,2207,12,4317,103,1,62,216660.0,130000.0,-51.0,-48.0,-44.0,-47.0,-51.0,-47.0,-43.0,-47.0,-91.0,-93.0,-90.0,-93.0,40.0,45.0,46.0,46.0,1
1878,CC:2F:71:3F:1F:24,5072628,1893790293,1224699,1408509588,3847929,485280705,1730,1027838,1169901643,1026989,1169798903,849,102740,994173,15,1223325,121479,1727,795,144444.0,43333.0,-69.0,-69.0,-70.0,-73.0,-69.0,-68.0,-69.0,-73.0,-91.0,-93.0,-90.0,-93.0,22.0,24.0,20.0,20.0,1
1879,CC:2F:71:3E:C5:1F,3848933,485403403,1000,122294,3847933,485281109,2,4332,361694,3605,275378,727,86316,1059,13,1437,28,2,54,130000.0,39000.0,-72.0,-71.0,-69.0,-61.0,-71.0,-72.0,-68.0,-60.0,-91.0,-93.0,-90.0,-93.0,19.0,22.0,21.0,32.0,1
1880,BA:8C:B9:54:50:24,3852874,491476273,4941,6195164,3847933,485281109,7,9824,1756720,9802,1753225,22,3495,2361,18,5451,44,7,72,229410.0,130000.0,-40.0,-36.0,-45.0,-51.0,-41.0,-35.0,-44.0,-49.0,-91.0,-93.0,-90.0,-93.0,51.0,57.0,45.0,42.0,1
1881,62:47:05:9D:EB:15,3854694,497464949,6759,12183638,3847935,485281311,1,7028,3806437,6978,3798779,50,7658,3317,0,6831,56,1,125,216660.0,130000.0,-45.0,-45.0,-36.0,-47.0,-43.0,-45.0,-36.0,-47.0,-91.0,-93.0,-90.0,-93.0,46.0,48.0,54.0,46.0,1
1882,92:69:1D:31:68:E9,3851993,488935456,4058,3654145,3847935,485281311,1,5448,1161412,5275,1122089,173,39323,2207,12,4317,103,1,62,216660.0,130000.0,-51.0,-48.0,-44.0,-47.0,-51.0,-47.0,-43.0,-47.0,-91.0,-93.0,-90.0,-93.0,40.0,45.0,46.0,46.0,1
1883,CC:2F:71:3F:1F:24,5072837,1894042122,1224902,1408760811,3847935,485281311,1730,1028018,1170133959,1027169,1170031219,849,102740,994353,15,1223528,121484,1727,795,144444.0,43333.0,-70.0,-68.0,-69.0,-74.0,-70.0,-68.0,-69.0,-74.0,-91.0,-93.0,-90.0,-93.0,21.0,25.0,21.0,19.0,1
1884,CC:2F:71:3E:C5:1F,3848935,485403605,1000,122294,3847935,485281311,2,4332,361694,3605,275378,727,86316,1059,13,1437,28,2,54,130000.0,39000.0,-72.0,-71.0,-69.0,-61.0,-71.0,-72.0,-68.0,-60.0,-91.0,-93.0,-90.0,-93.0,19.0,22.0,21.0,32.0,1
1885,BA:8C:B9:54:50:24,3852877,491476748,4941,6195164,3847936,485281584,7,9824,1756720,9802,1753225,22,3495,2361,18,5451,44,7,72,229410.0,130000.0,-40.0,-36.0,-45.0,-51.0,-41.0,-35.0,-44.0,-49.0,-91.0,-93.0,-90.0,-93.0,51.0,57.0,45.0,42.0,1
1886,62:47:05:9D:EB:15,3854697,497465424,6759,12183638,3847938,485281786,1,7028,3806437,6978,3798779,50,7658,3317,0,6831,56,1,125,216660.0,130000.0,-45.0,-45.0,-36.0,-47.0,-43.0,-45.0,-36.0,-47.0,-91.0,-93.0,-90.0,-93.0,46.0,48.0,54.0,46.0,1
1887,92:69:1D:31:68:E9,3851998,488936133,4058,3654145,3847940,485281988,1,5448,1161412,5275,1122089,173,39323,2207,12,4317,103,1,62,216660.0,130000.0,-51.0,-48.0,-44.0,-47.0,-51.0,-47.0,-43.0,-47.0,-91.0,-93.0,-90.0,-93.0,40.0,45.0,46.0,46.0,1
1888,CC:2F:71:3F:1F:24,5073034,1894284277,1225092,1409002087,3847942,485282190,1730,1028188,1170361885,1027339,1170259145,849,102740,994522,15,1223718,121484,1727,795,144444.0,43333.0,-69.0,-68.0,-68.0,-73.0,-69.0,-68.0,-68.0,-73.0,-91.0,-93.0,-90.0,-93.0,22.0,25.0,22.0,20.0,1
1889,CC:2F:71:3E:C5:1F,3848944,485404686,1000,122294,3847944,485282392,2,4332,361694,3605,275378,727,86316,1059,13,1437,28,2,54,130000.0,39000.0,-72.0,-71.0,-69.0,-61.0,-71.0,-72.0,-68.0,-60.0,-91.0,-93.0,-90.0,-93.0,19.0,22.0,21.0,32.0,1
1890,BA:8C:B9:54:50:24,3852885,491477556,4941,6195164,3847944,485282392,7,9824,1756720,9802,1753225,22,3495,2361,18,5451,44,7,72,229410.0,130000.0,-40.0,-36.0,-45.0,-51.0,-41.0,-35.0,-44.0,-49.0,-91.0,-93.0,-90.0,-93.0,51.0,57.0,45.0,42.0,1
1891,62:47:05:9D:EB:15,3854704,497466090,6759,12183638,3847945,485282452,1,7028,3806437,6978,3798779,50,7658,3317,0,6831,56,1,125,216660.0,130000.0,-45.0,-45.0,-36.0,-47.0,-43.0,-45.0,-36.0,-47.0,-91.0,-93.0,-90.0,-93.0,46.0,48.0,54.0,46.0,1
1892,92:69:1D:31:68:E9,3852003,488936597,4058,3654145,3847945,485282452,1,5448,1161412,5275,1122089,173,39323,2207,12,4317,103,1,62,216660.0,130000.0,-51.0,-48.0,-44.0,-47.0,-51.0,-47.0,-43.0,-47.0,-91.0,-93.0,-90.0,-93.0,40.0,45.0,46.0,46.0,1
1893,CC:2F:71:3F:1F:24,5073229,1894528923,1225284,1409246471,3847945,485282452,1730,1028358,1170591153,1027509,1170488413,849,102740,994692,15,1223910,121487,1727,795,144444.0,43333.0,-70.0,-68.0,-69.0,-72.0,-70.0,-68.0,-69.0,-72.0,-91.0,-93.0,-90.0,-93.0,21.0,25.0,21.0,21.0,1
1894,CC:2F:71:3E:C5:1F,3848945,485404746,1000,122294,3847945,485282452,2,4332,361694,3605,275378,727,86316,1059,13,1437,28,2,54,130000.0,39000.0,-72.0,-71.0,-69.0,-61.0,-71.0,-72.0,-68.0,-60.0,-91.0,-93.0,-90.0,-93.0,19.0,22.0,21.0,32.0,1
1895,BA:8C:B9:54:50:24,3852886,491477616,4941,6195164,3847945,485282452,7,9824,1756720,9802,1753225,22,3495,2361,18,5451,44,7,72,229410.0,130000.0,-40.0,-36.0,-45.0,-51.0,-41.0,-35.0,-44.0,-49.0,-91.0,-93.0,-90.0,-93.0,51.0,57.0,45.0,42.0,1
1896,62:47:05:9D:EB:15,3854712,497467064,6759,12183638,3847953,485283426,1,7028,3806437,6978,3798779,50,7658,3317,0,6831,56,1,125,216660.0,130000.0,-45.0,-45.0,-36.0,-47.0,-43.0,-45.0,-36.0,-47.0,-91.0,-93.0,-90.0,-93.0,46.0,48.0,54.0,46.0,1
1897,92:69:1D:31:68:E9,3852013,488937773,4058,3654145,3847955,485283628,1,5448,1161412,5275,1122089,173,39323,2207,12,4317,103,1,62,216660.0,130000.0,-51.0,-48.0,-44.0,-47.0,-51.0,-47.0,-43.0,-47.0,-91.0,-93.0,-90.0,-93.0,40.0,45.0,46.0,46.0,1
1898,CC:2F:71:3F:1F:24,5073431,1894774483,1225476,1409490855,3847955,485283628,1730,1028531,1170820839,1027682,1170718099,849,102740,994865,15,1224102,121490,1727,796,144444.0,43333.0,-70.0,-68.0,-68.0,-72.0,-70.0,-68.0,-67.0,-72.0,-91.0,-93.0,-90.0,-93.0,21.0,25.0,22.0,21.0,1
1899,CC:2F:71:3E:C5:1F,3848955,485405922,1000,122294,3847955,485283628,2,4332,361694,3605,275378,727,86316,1059,13,1437,28,2,54,130000.0,39000.0,-72.0,-71.0,-69.0,-61.0,-71.0,-72.0,-68.0,-60.0,-91.0,-93.0,-90.0,-93.0,19.0,22.0,21.0,32.0,1
1900,BA:8C:B9:54:50:24,3852896,491478792,4941,6195164,3847955,485283628,7,9824,1756720,9802,1753225,22,3495,2361,18,5451,44,7,72,229410.0,130000.0,-40.0,-36.0,-45.0,-51.0,-41.0,-35.0,-44.0,-49.0,-91.0,-93.0,-90.0,-93.0,51.0,57.0,45.0,42.0,1
1901,62:47:05:9D:EB:15,3854715,497467326,6759,12183638,3847956,485283688,1,7028,3806437,6978,3798779,50,7658,3317,0,6831,56,1,125,216660.0,130000.0,-45.0,-45.0,-36.0,-47.0,-43.0,-45.0,-36.0,-47.0,-91.0,-93.0,-90.0,-93.0,46.0,48.0,54.0,46.0,1
1902,92:69:1D:31:68:E9,3852014,488937833,4058,3654145,3847956,485283688,1,5448,1161412,5275,1122089,173,39323,2207,12,4317,103,1,62,216660.0,130000.0,-51.0,-48.0,-44.0,-47.0,-51.0,-47.0,-43.0,-47.0,-91.0,-93.0,-90.0,-93.0,40.0,45.0,46.0,46.0,1
1903,CC:2F:71:3F:1F:24,5073626,1895016054,1225670,1409732366,3847956,485283688,1730,1028704,1171045248,1027855,1170942508,849,102740,995038,15,1224296,121490,1727,796,144444.0,43333.0,-70.0,-68.0,-69.0,-71.0,-70.0,-68.0,-68.0,-71.0,-91.0,-93.0,-90.0,-93.0,21.0,25.0,21.0,22.0,1
1904,CC:2F:71:3E:C5:1F,3848956,485405982,1000,122294,3847956,485283688,2,4332,361694,3605,275378,727,86316,1059,13,1437,28,2,54,130000.0,39000.0,-72.0,-71.0,-69.0,-61.0,-71.0,-72.0,-68.0,-60.0,-91.0,-93.0,-90.0,-93.0,19.0,22.0,21.0,32.0,1
1905,BA:8C:B9:54:50:24,3852898,491478914,4941,6195164,3847957,485283750,7,9824,1756720,9802,1753225,22,3495,2361,18,5451,44,7,72,229410.0,130000.0,-40.0,-36.0,-45.0,-51.0,-41.0,-35.0,-44.0,-49.0,-91.0,-93.0,-90.0,-93.0,51.0,57.0,45.0,42.0,1
1906,62:47:05:9D:EB:15,3854724,497468196,6759,12183638,3847965,485284558,1,7028,3806437,6978,3798779,50,7658,3317,0,6831,56,1,125,216660.0,130000.0,-45.0,-45.0,-36.0,-47.0,-43.0,-45.0,-36.0,-47.0,-91.0,-93.0,-90.0,-93.0,46.0,48.0,54.0,46.0,1
1907,92:69:1D:31:68:E9,3852023,488938703,4058,3654145,3847965,485284558,1,5448,1161412,5275,1122089,173,39323,2207,12,4317,103,1,62,216660.0,130000.0,-51.0,-48.0,-44.0,-47.0,-51.0,-47.0,-43.0,-47.0,-91.0,-93.0,-90.0,-93.0,40.0,45.0,46.0,46.0,1
1908,CC:2F:71:3F:1F:24,5073828,1895261424,1225863,1409976866,3847965,485284558,1730,1028876,1171274710,1028027,1171171970,849,102740,995210,15,1224489,121490,1727,796,144444.0,43333.0,-71.0,-68.0,-67.0,-71.0,-70.0,-68.0,-67.0,-71.0,-91.0,-93.0,-90.0,-93.0,20.0,25.0,23.0,22.0,1
1909,CC:2F:71:3E:C5:1F,3848965,485406852,1000,122294,3847965,485284558,2,4334,361882,3606,275448,728,86434,1060,13,1437,28,2,54,130000.0,39000.0,-72.0,-72.0,-68.0,-60.0,-71.0,-72.0,-68.0,-60.0,-91.0,-93.0,-90.0,-93.0,19.0,21.0,22.0,33.0,1
1910,BA:8C:B9:54:50:24,3852906,491479722,4941,6195164,3847965,485284558,7,9824,1756720,9802,1753225,22,3495,2361,18,5451,44,7,72,229410.0,130000.0,-40.0,-36.0,-45.0,-51.0,-41.0,-35.0,-44.0,-49.0,-91.0,-93.0,-90.0,-93.0,51.0,57.0,45.0,42.0,1
1911,62:47:05:9D:EB:15,3854724,497468196,6759,12183638,3847965,485284558,1,7028,3806437,6978,3798779,50,7658,3317,0,6831,56,1,125,216660.0,130000.0,-45.0,-45.0,-36.0,-47.0,-43.0,-45.0,-36.0,-47.0,-91.0,-93.0,-90.0,-93.0,46.0,48.0,54.0,46.0,1
1912,92:69:1D:31:68:E9,3852023,488938703,4058,3654145,3847965,485284558,1,5448,1161412,5275,1122089,173,39323,2207,12,4317,103,1,62,216660.0,130000.0,-51.0,-48.0,-44.0,-47.0,-51.0,-47.0,-43.0,-47.0,-91.0,-93.0,-90.0,-93.0,40.0,45.0,46.0,46.0,1
1913,CC:2F:71:3F:1F:24,5074016,1895501016,1226051,1410216458,3847965,485284558,1730,1029044,1171499446,1028195,1171396706,849,102740,995378,15,1224677,121492,1727,796,144444.0,43333.0,-70.0,-68.0,-67.0,-71.0,-70.0,-68.0,-67.0,-71.0,-91.0,-93.0,-90.0,-93.0,21.0,25.0,23.0,22.0,1
1914,CC:2F:71:3E:C5:1F,3848965,485406852,1000,122294,3847965,485284558,2,4334,361882,3606,275448,728,86434,1060,13,1437,28,2,54,130000.0,39000.0,-72.0,-72.0,-68.0,-60.0,-71.0,-72.0,-68.0,-60.0,-91.0,-93.0,-90.0,-93.0,19.0,21.0,22.0,33.0,1
1915,BA:8C:B9:54:50:24,3852906,491479722,4941,6195164,3847965,485284558,7,9824,1756720,9802,1753225,22,3495,2361,18,5451,44,7,72,229410.0,130000.0,-40.0,-36.0,-45.0,-51.0,-41.0,-35.0,-44.0,-49.0,-91.0,-93.0,-90.0,-93.0,51.0,57.0,45.0,42.0,1
1916,62:47:05:9D:EB:15,3854733,497469064,6759,12183638,3847974,485285426,1,7028,3806437,6978,3798779,50,7658,3317,0,6831,56,1,125,216660.0,130000.0,-45.0,-45.0,-36.0,-47.0,-43.0,-45.0,-36.0,-47.0,-91.0,-93.0,-90.0,-93.0,46.0,48.0,54.0,46.0,1
1917,92:69:1D:31:68:E9,3852032,488939571,4058,3654145,3847974,485285426,1,5448,1161412,5275,1122089,173,39323,2207,12,4317,103,1,62,216660.0,130000.0,-51.0,-48.0,-44.0,-47.0,-51.0,-47.0,-43.0,-47.0,-91.0,-93.0,-90.0,-93.0,40.0,45.0,46.0,46.0,1
1918,CC:2F:71:3F:1F:24,5074222,1895748055,1226248,1410462629,3847974,485285426,1730,1029222,1171730261,1028373,1171627521,849,102740,995554,15,1224874,121493,1727,796,144444.0,43333.0,-71.0,-68.0,-67.0,-72.0,-70.0,-68.0,-67.0,-71.0,-91.0,-93.0,-90.0,-93.0,20.0,25.0,23.0,21.0,1
1919,CC:2F:71:3E:C5:1F,3848974,485407720,1000,122294,3847974,485285426,2,4334,361882,3606,275448,728,86434,1060,13,1437,28,2,54,130000.0,39000.0,-72.0,-72.0,-68.0,-60.0,-71.0,-72.0,-68.0,-60.0,-91.0,-93.0,-90.0,-93.0,19.0,21.0,22.0,33.0,1
1920,BA:8C:B9:54:50:24,3852915,491480590,4941,6195164,3847974,485285426,7,9824,1756720,9802,1753225,22,3495,2361,18,5451,44,7,72,229410.0,130000.0,-40.0,-36.0,-45.0,-51.0,-41.0,-35.0,-44.0,-49.0,-91.0,-93.0,-90.0,-93.0,51.0,57.0,45.0,42.0,1
1921,62:47:05:9D:EB:15,3854733,497469064,6759,12183638,3847974,485285426,1,7028,3806437,6978,3798779,50,7658,3317,0,6831,56,1,125,216660.0,130000.0,-45.0,-45.0,-36.0,-47.0,-43.0,-45.0,-36.0,-47.0,-91.0,-93.0,-90.0,-93.0,46.0,48.0,54.0,46.0,1
1922,92:69:1D:31:68:E9,3852032,488939571,4058,3654145,3847974,485285426,1,5448,1161412,5275,1122089,173,39323,2207,12,4317,103,1,62,216660.0,130000.0,-51.0,-48.0,-44.0,-47.0,-51.0,-47.0,-43.0,-47.0,-91.0,-93.0,-90.0,-93.0,40.0,45.0,46.0,46.0,1
1923,CC:2F:71:3F:1F:24,5074411,1895989201,1226437,1410703775,3847974,485285426,1730,1029391,1171956537,1028542,1171853797,849,102740,995723,15,1225063,121493,1727,796,144444.0,43333.0,-71.0,-68.0,-67.0,-72.0,-70.0,-68.0,-67.0,-71.0,-91.0,-93.0,-90.0,-93.0,20.0,25.0,23.0,21.0,1
1924,CC:2F:71:3E:C5:1F,3848974,485407720,1000,122294,3847974,485285426,2,4334,361882,3606,275448,728,86434,1060,13,1437,28,2,54,130000.0,39000.0,-72.0,-72.0,-68.0,-60.0,-71.0,-72.0,-68.0,-60.0,-91.0,-93.0,-90.0,-93.0,19.0,21.0,22.0,33.0,1
1925,BA:8C:B9:54:50:24,3852915,491480590,4941,6195164,3847974,485285426,7,9824,1756720,9802,1753225,22,3495,2361,18,5451,44,7,72,229410.0,130000.0,-40.0,-36.0,-45.0,-51.0,-41.0,-35.0,-44.0,-49.0,-91.0,-93.0,-90.0,-93.0,51.0,57.0,45.0,42.0,1
1926,62:47:05:9D:EB:15,3854742,497469932,6759,12183638,3847983,485286294,1,7029,3806505,6979,3798847,50,7658,3317,0,6831,56,1,125,216660.0,130000.0,-43.0,-46.0,-36.0,-48.0,-43.0,-45.0,-36.0,-47.0,-91.0,-93.0,-90.0,-93.0,48.0,47.0,54.0,45.0,1
1927,92:69:1D:31:68:E9,3852041,488940439,4058,3654145,3847983,485286294,1,5448,1161412,5275,1122089,173,39323,2207,12,4317,103,1,62,216660.0,130000.0,-51.0,-48.0,-44.0,-47.0,-51.0,-47.0,-43.0,-47.0,-91.0,-93.0,-90.0,-93.0,40.0,45.0,46.0,46.0,1
1928,CC:2F:71:3F:1F:24,5074607,1896228107,1226624,1410941813,3847983,485286294,1730,1029558,1172179733,1028709,1172076993,849,102740,995890,15,1225250,121493,1727,796,144444.0,43333.0,-70.0,-68.0,-67.0,-71.0,-70.0,-68.0,-67.0,-71.0,-91.0,-93.0,-90.0,-93.0,21.0,25.0,23.0,22.0,1
1929,CC:2F:71:3E:C5:1F,3848983,485408588,1000,122294,3847983,485286294,2,4334,361882,3606,275448,728,86434,1060,13,1437,28,2,54,130000.0,39000.0,-72.0,-72.0,-68.0,-60.0,-71.0,-72.0,-68.0,-60.0,-91.0,-93.0,-90.0,-93.0,19.0,21.0,22.0,33.0,1
1930,BA:8C:B9:54:50:24,3852924,491481458,4941,6195164,3847983,485286294,7,9824,1756720,9802,1753225,22,3495,2361,18,5451,44,7,72,229410.0,130000.0,-40.0,-36.0,-45.0,-51.0,-41.0,-35.0,-44.0,-49.0,-91.0,-93.0,-90.0,-93.0,51.0,57.0,45.0,42.0,1
1931,62:47:05:9D:EB:15,3854742,497469932,6759,12183638,3847983,485286294,1,7029,3806505,6979,3798847,50,7658,3317,0,6831,56,1,125,216660.0,130000.0,-43.0,-46.0,-36.0,-48.0,-43.0,-45.0,-36.0,-47.0,-91.0,-93.0,-90.0,-93.0,48.0,47.0,54.0,45.0,1
1932,92:69:1D:31:68:E9,3852041,488940439,4058,3654145,3847983,485286294,1,5450,1161548,5277,1122225,173,39323,2207,12,4318,103,1,62,216660.0,130000.0,-51.0,-47.0,-42.0,-49.0,-51.0,-47.0,-43.0,-47.0,-91.0,-93.0,-90.0,-93.0,40.0,46.0,48.0,44.0,1
1933,CC:2F:71:3F:1F:24,5074796,1896469253,1226813,1411182959,3847983,485286294,1730,1029727,1172406009,1028878,1172303269,849,102740,996059,15,1225439,121494,1727,796,144444.0,43333.0,-71.0,-68.0,-67.0,-71.0,-71.0,-68.0,-67.0,-71.0,-91.0,-93.0,-90.0,-93.0,20.0,25.0,23.0,22.0,1
1934,CC:2F:71:3E:C5:1F,3848983,485408588,1000,122294,3847983,485286294,2,4336,362022,3608,275588,728,86434,1060,13,1438,28,2,54,130000.0,39000.0,-72.0,-71.0,-68.0,-60.0,-71.0,-71.0,-68.0,-60.0,-91.0,-93.0,-90.0,-93.0,19.0,22.0,22.0,33.0,1
1935,BA:8C:B9:54:50:24,3852925,491481526,4941,6195164,3847984,485286362,7,9826,1756856,9804,1753361,22,3495,2361,18,5452,44,7,72,229410.0,130000.0,-59.0,-36.0,-44.0,-43.0,-44.0,-35.0,-44.0,-47.0,-91.0,-93.0,-90.0,-93.0,32.0,57.0,46.0,50.0,1
1936,62:47:05:9D:EB:15,3854750,497470740,6759,12183638,3847991,485287102,1,7029,3806505,6979,3798847,50,7658,3317,0,6831,56,1,125,216660.0,130000.0,-43.0,-46.0,-36.0,-48.0,-43.0,-45.0,-36.0,-47.0,-91.0,-93.0,-90.0,-93.0,48.0,47.0,54.0,45.0,1
1937,92:69:1D:31:68:E9,3852049,488941247,4058,3654145,3847991,485287102,1,5450,1161548,5277,1122225,173,39323,2207,12,4318,103,1,62,216660.0,130000.0,-51.0,-47.0,-42.0,-49.0,-51.0,-47.0,-43.0,-47.0,-91.0,-93.0,-90.0,-93.0,40.0,46.0,48.0,44.0,1
1938,CC:2F:71:3F:1F:24,5074999,1896714548,1227008,1411427446,3847991,485287102,1730,1029904,1172635241,1029055,1172532501,849,102740,996234,15,1225634,121497,1727,796,144444.0,43333.0,-71.0,-68.0,-67.0,-72.0,-71.0,-68.0,-67.0,-71.0,-91.0,-93.0,-90.0,-93.0,20.0,25.0,23.0,21.0,1
1939,CC:2F:71:3E:C5:1F,3848991,485409396,1000,122294,3847991,485287102,2,4336,362022,3608,275588,728,86434,1060,13,1438,28,2,54,130000.0,39000.0,-72.0,-71.0,-68.0,-60.0,-71.0,-71.0,-68.0,-60.0,-91.0,-93.0,-90.0,-93.0,19.0,22.0,22.0,33.0,1
1940,BA:8C:B9:54:50:24,3852932,491482266,4941,6195164,3847991,485287102,7,9826,1756856,9804,1753361,22,3495,2361,18,5452,44,7,72,229410.0,130000.0,-59.0,-36.0,-44.0,-43.0,-44.0,-35.0,-44.0,-47.0,-91.0,-93.0,-90.0,-93.0,32.0,57.0,46.0,50.0,1
1941,62:47:05:9D:EB:15,3854751,497470800,6759,12183638,3847992,485287162,1,7029,3806505,6979,3798847,50,7658,3317,0,6831,56,1,125,216660.0,130000.0,-43.0,-46.0,-36.0,-48.0,-43.0,-45.0,-36.0,-47.0,-91.0,-93.0,-90.0,-93.0,48.0,47.0,54.0,45.0,1
1942,92:69:1D:31:68:E9,3852050,488941307,4058,3654145,3847992,485287162,1,5450,1161548,5277,1122225,173,39323,2207,12,4318,103,1,62,216660.0,130000.0,-51.0,-47.0,-42.0,-49.0,-51.0,-47.0,-43.0,-47.0,-91.0,-93.0,-90.0,-93.0,40.0,46.0,48.0,44.0,1
1943,CC:2F:71:3F:1F:24,5075189,1896955754,1227197,1411668592,3847992,485287162,1730,1030074,1172861695,1029225,1172758955,849,102740,996403,15,1225823,121497,1727,796,144444.0,43333.0,-70.0,-68.0,-69.0,-71.0,-70.0,-68.0,-68.0,-71.0,-91.0,-93.0,-90.0,-93.0,21.0,25.0,21.0,22.0,1
1944,CC:2F:71:3E:C5:1F,3848992,485409456,1000,122294,3847992,485287162,2,4336,362022,3608,275588,728,86434,1060,13,1438,28,2,54,130000.0,39000.0,-72.0,-71.0,-68.0,-60.0,-71.0,-71.0,-68.0,-60.0,-91.0,-93.0,-90.0,-93.0,19.0,22.0,22.0,33.0,1
1945,BA:8C:B9:54:50:24,3852933,491482326,4941,6195164,3847992,485287162,7,9827,1756924,9805,1753429,22,3495,2361,18,5452,44,7,72,229410.0,130000.0,-39.0,-36.0,-45.0,-51.0,-43.0,-35.0,-44.0,-47.0,-91.0,-93.0,-90.0,-93.0,52.0,57.0,45.0,42.0,1
1946,62:47:05:9D:EB:15,3854760,497471881,6759,12183638,3848001,485288243,1,7029,3806505,6979,3798847,50,7658,3317,0,6831,56,1,125,216660.0,130000.0,-43.0,-46.0,-36.0,-48.0,-43.0,-45.0,-36.0,-47.0,-91.0,-93.0,-90.0,-93.0,48.0,47.0,54.0,45.0,1
1947,92:69:1D:31:68:E9,3852059,488942388,4058,3654145,3848001,485288243,1,5450,1161548,5277,1122225,173,39323,2207,12,4318,103,1,62,216660.0,130000.0,-51.0,-47.0,-42.0,-49.0,-51.0,-47.0,-43.0,-47.0,-91.0,-93.0,-90.0,-93.0,40.0,46.0,48.0,44.0,1
1948,CC:2F:71:3F:1F:24,5075388,1897198111,1227387,1411909868,3848001,485288243,1730,1030241,1173086357,1029392,1172983617,849,102740,996570,15,1226013,121497,1727,796,144444.0,43333.0,-71.0,-68.0,-68.0,-72.0,-71.0,-68.0,-67.0,-71.0,-91.0,-93.0,-90.0,-93.0,20.0,25.0,22.0,21.0,1
1949,CC:2F:71:3E:C5:1F,3849001,485410537,1000,122294,3848001,485288243,2,4336,362022,3608,275588,728,86434,1060,13,1438,28,2,54,130000.0,39000.0,-72.0,-71.0,-68.0,-60.0,-71.0,-71.0,-68.0,-60.0,-91.0,-93.0,-90.0,-93.0,19.0,22.0,22.0,33.0,1
1950,BA:8C:B9:54:50:24,3852942,491483407,4941,6195164,3848001,485288243,7,9827,1756924,9805,1753429,22,3495,2361,18,5452,44,7,72,229410.0,130000.0,-39.0,-36.0,-45.0,-51.0,-43.0,-35.0,-44.0,-47.0,-91.0,-93.0,-90.0,-93.0,52.0,57.0,45.0,42.0,1
1951,62:47:05:9D:EB:15,3854760,497471881,6759,12183638,3848001,485288243,1,7029,3806505,6979,3798847,50,7658,3317,0,6831,56,1,125,216660.0,130000.0,-43.0,-46.0,-36.0,-48.0,-43.0,-45.0,-36.0,-47.0,-90.0,-93.0,-89.0,-92.0,47.0,47.0,53.0,44.0,1
1952,92:69:1D:31:68:E9,3852059,488942388,4058,3654145,3848001,485288243,1,5450,1161548,5277,1122225,173,39323,2207,12,4318,103,1,62,216660.0,130000.0,-51.0,-47.0,-42.0,-49.0,-51.0,-47.0,-43.0,-47.0,-90.0,-93.0,-89.0,-92.0,39.0,46.0,47.0,43.0,1
1953,CC:2F:71:3F:1F:24,5075578,1897436455,1227576,1412148152,3848002,485288303,1730,1030410,1173311199,1029561,1173208459,849,102740,996739,15,1226202,121497,1727,796,144444.0,43333.0,-71.0,-68.0,-68.0,-72.0,-70.0,-68.0,-67.0,-71.0,-90.0,-93.0,-89.0,-92.0,19.0,25.0,21.0,20.0,1
1954,CC:2F:71:3E:C5:1F,3849002,485410597,1000,122294,3848002,485288303,2,4336,362022,3608,275588,728,86434,1060,13,1438,28,2,54,130000.0,39000.0,-72.0,-71.0,-68.0,-60.0,-71.0,-71.0,-68.0,-60.0,-90.0,-93.0,-89.0,-92.0,18.0,22.0,21.0,32.0,1
1955,BA:8C:B9:54:50:24,3852945,491483669,4941,6195164,3848004,485288505,7,9827,1756924,9805,1753429,22,3495,2361,18,5452,44,7,72,229410.0,130000.0,-39.0,-36.0,-45.0,-51.0,-43.0,-35.0,-44.0,-47.0,-90.0,-93.0,-89.0,-92.0,51.0,57.0,44.0,41.0,1
1956,62:47:05:9D:EB:15,3854769,497472749,6759,12183638,3848010,485289111,1,7029,3806505,6979,3798847,50,7658,3317,0,6831,56,1,125,216660.0,130000.0,-43.0,-46.0,-36.0,-48.0,-43.0,-45.0,-36.0,-47.0,-90.0,-93.0,-89.0,-92.0,47.0,47.0,53.0,44.0,1
1957,92:69:1D:31:68:E9,3852068,488943256,4058,3654145,3848010,485289111,1,5450,1161548,5277,1122225,173,39323,2207,12,4318,103,1,62,216660.0,130000.0,-51.0,-47.0,-42.0,-49.0,-51.0,-47.0,-43.0,-47.0,-90.0,-93.0,-89.0,-92.0,39.0,46.0,47.0,43.0,1
1958,CC:2F:71:3F:1F:24,5075785,1897684950,1227775,1412395839,3848010,485289111,1730,1030588,1173541943,1029739,1173439203,849,102740,996916,15,1226401,121498,1727,796,144444.0,43333.0,-71.0,-68.0,-67.0,-72.0,-70.0,-68.0,-67.0,-71.0,-90.0,-93.0,-89.0,-92.0,19.0,25.0,22.0,20.0,1
1959,CC:2F:71:3E:C5:1F,3849010,485411405,1000,122294,3848010,485289111,2,4336,362022,3608,275588,728,86434,1060,13,1438,28,2,54,130000.0,39000.0,-72.0,-71.0,-68.0,-60.0,-71.0,-71.0,-68.0,-60.0,-90.0,-93.0,-89.0,-92.0,18.0,22.0,21.0,32.0,1
1960,BA:8C:B9:54:50:24,3852951,491484275,4941,6195164,3848010,485289111,7,9827,1756924,9805,1753429,22,3495,2361,18,5452,44,7,72,229410.0,130000.0,-39.0,-36.0,-45.0,-51.0,-43.0,-35.0,-44.0,-47.0,-90.0,-93.0,-89.0,-92.0,51.0,57.0,44.0,41.0,1
1961,62:47:05:9D:EB:15,3854769,497472749,6759,12183638,3848010,485289111,1,7029,3806505,6979,3798847,50,7658,3317,0,6831,56,1,125,216660.0,130000.0,-43.0,-46.0,-36.0,-48.0,-43.0,-45.0,-36.0,-47.0,-90.0,-93.0,-89.0,-92.0,47.0,47.0,53.0,44.0,1
1962,92:69:1D:31:68:E9,3852068,488943256,4058,3654145,3848010,485289111,1,5450,1161548,5277,1122225,173,39323,2207,12,4318,103,1,62,216660.0,130000.0,-51.0,-47.0,-42.0,-49.0,-51.0,-47.0,-43.0,-47.0,-90.0,-93.0,-89.0,-92.0,39.0,46.0,47.0,43.0,1
1963,CC:2F:71:3F:1F:24,5075978,1897932312,1227968,1412643201,3848010,485289111,1730,1030760,1173774459,1029911,1173671719,849,102740,997088,15,1226594,121499,1727,798,144444.0,43333.0,-71.0,-68.0,-67.0,-71.0,-70.0,-68.0,-67.0,-71.0,-90.0,-93.0,-89.0,-92.0,19.0,25.0,22.0,21.0,1
1964,CC:2F:71:3E:C5:1F,3849012,485411607,1000,122294,3848012,485289313,2,4336,362022,3608,275588,728,86434,1060,13,1438,28,2,54,130000.0,39000.0,-72.0,-71.0,-68.0,-60.0,-71.0,-71.0,-68.0,-60.0,-90.0,-93.0,-89.0,-92.0,18.0,22.0,21.0,32.0,1
1965,BA:8C:B9:54:50:24,3852953,491484477,4941,6195164,3848012,485289313,7,9827,1756924,9805,1753429,22,3495,2361,18,5452,44,7,72,229410.0,130000.0,-39.0,-36.0,-45.0,-51.0,-43.0,-35.0,-44.0,-47.0,-90.0,-93.0,-89.0,-92.0,51.0,57.0,44.0,41.0,1
1966,62:47:05:9D:EB:15,3854778,497473617,6759,12183638,3848019,485289979,1,7029,3806505,6979,3798847,50,7658,3317,0,6831,56,1,125,216660.0,130000.0,-43.0,-46.0,-36.0,-48.0,-43.0,-45.0,-36.0,-47.0,-90.0,-93.0,-89.0,-92.0,47.0,47.0,53.0,44.0,1
1967,92:69:1D:31:68:E9,3852077,488944124,4058,3654145,3848019,485289979,1,5450,1161548,5277,1122225,173,39323,2207,12,4318,103,1,62,216660.0,130000.0,-51.0,-47.0,-42.0,-49.0,-51.0,-47.0,-43.0,-47.0,-90.0,-93.0,-89.0,-92.0,39.0,46.0,47.0,43.0,1
1968,CC:2F:71:3F:1F:24,5076174,1898174066,1228155,1412884087,3848019,485289979,1730,1030929,1174000735,1030080,1173897995,849,102740,997257,15,1226781,121500,1727,798,144444.0,43333.0,-71.0,-69.0,-68.0,-73.0,-71.0,-68.0,-67.0,-72.0,-90.0,-93.0,-89.0,-92.0,19.0,24.0,21.0,19.0,1
1969,CC:2F:71:3E:C5:1F,3849019,485412273,1000,122294,3848019,485289979,2,4336,362022,3608,275588,728,86434,1060,13,1438,28,2,54,130000.0,39000.0,-72.0,-71.0,-68.0,-60.0,-71.0,-71.0,-68.0,-60.0,-90.0,-93.0,-89.0,-92.0,18.0,22.0,21.0,32.0,1
1970,BA:8C:B9:54:50:24,3852960,491485143,4941,6195164,3848019,485289979,7,9827,1756924,9805,1753429,22,3495,2361,18,5452,44,7,72,229410.0,130000.0,-39.0,-36.0,-45.0,-51.0,-43.0,-35.0,-44.0,-47.0,-90.0,-93.0,-89.0,-92.0,51.0,57.0,44.0,41.0,1
1971,62:47:05:9D:EB:15,3854778,497473617,6759,12183638,3848019,485289979,1,7029,3806505,6979,3798847,50,7658,3317,0,6831,56,1,125,216660.0,130000.0,-43.0,-46.0,-36.0,-48.0,-43.0,-45.0,-36.0,-47.0,-90.0,-93.0,-89.0,-92.0,47.0,47.0,53.0,44.0,1
1972,92:69:1D:31:68:E9,3852077,488944124,4058,3654145,3848019,485289979,1,5450,1161548,5277,1122225,173,39323,2207,12,4318,103,1,62,216660.0,130000.0,-51.0,-47.0,-42.0,-49.0,-51.0,-47.0,-43.0,-47.0,-90.0,-93.0,-89.0,-92.0,39.0,46.0,47.0,43.0,1
1973,CC:2F:71:3F:1F:24,5076367,1898415660,1228346,1413125479,3848021,485290181,1730,1031100,1174230109,1030251,1174127369,849,102740,997426,15,1226972,121501,1727,798,144444.0,43333.0,-72.0,-70.0,-67.0,-73.0,-71.0,-70.0,-67.0,-72.0,-90.0,-93.0,-89.0,-92.0,18.0,23.0,22.0,19.0,1
1974,CC:2F:71:3E:C5:1F,3849025,485412879,1000,122294,3848025,485290585,2,4336,362022,3608,275588,728,86434,1060,13,1438,28,2,54,130000.0,39000.0,-72.0,-71.0,-68.0,-60.0,-71.0,-71.0,-68.0,-60.0,-90.0,-93.0,-89.0,-92.0,18.0,22.0,21.0,32.0,1
1975,BA:8C:B9:54:50:24,3852966,491485749,4941,6195164,3848025,485290585,7,9827,1756924,9805,1753429,22,3495,2361,18,5452,44,7,72,229410.0,130000.0,-39.0,-36.0,-45.0,-51.0,-43.0,-35.0,-44.0,-47.0,-90.0,-93.0,-89.0,-92.0,51.0,57.0,44.0,41.0,1
1976,62:47:05:9D:EB:15,3854786,497474425,6759,12183638,3848027,485290787,1,7029,3806505,6979,3798847,50,7658,3317,0,6831,56,1,125,216660.0,130000.0,-43.0,-46.0,-36.0,-48.0,-43.0,-45.0,-36.0,-47.0,-90.0,-93.0,-89.0,-92.0,47.0,47.0,53.0,44.0,1
1977,92:69:1D:31:68:E9,3852086,488944992,4058,3654145,3848028,485290847,1,5450,1161548,5277,1122225,173,39323,2207,12,4318,103,1,62,216660.0,130000.0,-51.0,-47.0,-42.0,-49.0,-51.0,-47.0,-43.0,-47.0,-90.0,-93.0,-89.0,-92.0,39.0,46.0,47.0,43.0,1
1978,CC:2F:71:3F:1F:24,5076571,1898661073,1228543,1413370226,3848028,485290847,1730,1031279,1174460913,1030430,1174358173,849,102740,997603,15,1227169,121501,1727,798,144444.0,43333.0,-72.0,-70.0,-67.0,-73.0,-72.0,-70.0,-67.0,-73.0,-90.0,-93.0,-89.0,-92.0,18.0,23.0,22.0,19.0,1
1979,CC:2F:71:3E:C5:1F,3849028,485413141,1000,122294,3848028,485290847,2,4336,362022,3608,275588,728,86434,1060,13,1438,28,2,54,130000.0,39000.0,-72.0,-71.0,-68.0,-60.0,-71.0,-71.0,-68.0,-60.0,-90.0,-93.0,-89.0,-92.0,18.0,22.0,21.0,32.0,1
1980,BA:8C:B9:54:50:24,3852969,491486011,4941,6195164,3848028,485290847,7,9827,1756924,9805,1753429,22,3495,2361,18,5452,44,7,72,229410.0,130000.0,-39.0,-36.0,-45.0,-51.0,-43.0,-35.0,-44.0,-47.0,-90.0,-93.0,-89.0,-92.0,51.0,57.0,44.0,41.0,1
1981,62:47:05:9D:EB:15,3854787,497474485,6759,12183638,3848028,485290847,1,7029,3806505,6979,3798847,50,7658,3317,0,6831,56,1,125,216660.0,130000.0,-43.0,-46.0,-36.0,-48.0,-43.0,-45.0,-36.0,-47.0,-90.0,-93.0,-89.0,-92.0,47.0,47.0,53.0,44.0,1
1982,92:69:1D:31:68:E9,3852088,488945194,4058,3654145,3848030,485291049,1,5450,1161548,5277,1122225,173,39323,2207,12,4318,103,1,62,216660.0,130000.0,-51.0,-47.0,-42.0,-49.0,-51.0,-47.0,-43.0,-47.0,-90.0,-93.0,-89.0,-92.0,39.0,46.0,47.0,43.0,1
1983,CC:2F:71:3F:1F:24,5076768,1898905933,1228734,1413614480,3848034,485291453,1730,1031450,1174690311,1030601,1174587571,849,102740,997774,15,1227360,121501,1727,798,144444.0,43333.0,-73.0,-69.0,-67.0,-72.0,-73.0,-69.0,-66.0,-71.0,-90.0,-93.0,-89.0,-92.0,17.0,24.0,22.0,20.0,1
1984,CC:2F:71:3E:C5:1F,3849034,485413747,1000,122294,3848034,485291453,2,4336,362022,3608,275588,728,86434,1060,13,1438,28,2,54,130000.0,39000.0,-72.0,-71.0,-68.0,-60.0,-71.0,-71.0,-68.0,-60.0,-90.0,-93.0,-89.0,-92.0,18.0,22.0,21.0,32.0,1
1985,BA:8C:B9:54:50:24,3852975,491486617,4941,6195164,3848034,485291453,7,9827,1756924,9805,1753429,22,3495,2361,18,5452,44,7,72,229410.0,130000.0,-39.0,-36.0,-45.0,-51.0,-43.0,-35.0,-44.0,-47.0,-90.0,-93.0,-89.0,-92.0,51.0,57.0,44.0,41.0,1
1986,62:47:05:9D:EB:15,3854795,497475293,6759,12183638,3848036,485291655,1,7029,3806505,6979,3798847,50,7658,3317,0,6831,56,1,125,216660.0,130000.0,-43.0,-46.0,-36.0,-48.0,-43.0,-45.0,-36.0,-47.0,-90.0,-93.0,-89.0,-92.0,47.0,47.0,53.0,44.0,1
1987,92:69:1D:31:68:E9,3852094,488945800,4058,3654145,3848036,485291655,1,5450,1161548,5277,1122225,173,39323,2207,12,4318,103,1,62,216660.0,130000.0,-51.0,-47.0,-42.0,-49.0,-51.0,-47.0,-43.0,-47.0,-90.0,-93.0,-89.0,-92.0,39.0,46.0,47.0,43.0,1
1988,CC:2F:71:3F:1F:24,5076959,1899147281,1228923,1413855626,3848036,485291655,1730,1031619,1174916587,1030770,1174813847,849,102740,997943,15,1227549,121501,1727,798,144444.0,43333.0,-74.0,-70.0,-67.0,-72.0,-75.0,-71.0,-68.0,-73.0,-90.0,-93.0,-89.0,-92.0,16.0,23.0,22.0,20.0,1
1989,CC:2F:71:3E:C5:1F,3849036,485413949,1000,122294,3848036,485291655,2,4336,362022,3608,275588,728,86434,1060,13,1438,28,2,54,130000.0,39000.0,-72.0,-71.0,-68.0,-60.0,-71.0,-71.0,-68.0,-60.0,-90.0,-93.0,-89.0,-92.0,18.0,22.0,21.0,32.0,1
1990,BA:8C:B9:54:50:24,3852977,491486819,4941,6195164,3848036,485291655,7,9827,1756924,9805,1753429,22,3495,2361,18,5452,44,7,72,229410.0,130000.0,-39.0,-36.0,-45.0,-51.0,-43.0,-35.0,-44.0,-47.0,-90.0,-93.0,-89.0,-92.0,51.0,57.0,44.0,41.0,1
1991,62:47:05:9D:EB:15,3854800,497475757,6759,12183638,3848041,485292119,1,7029,3806505,6979,3798847,50,7658,3317,0,6831,56,1,125,216660.0,130000.0,-43.0,-46.0,-36.0,-48.0,-43.0,-45.0,-36.0,-47.0,-90.0,-93.0,-89.0,-92.0,47.0,47.0,53.0,44.0,1
1992,92:69:1D:31:68:E9,3852099,488946264,4058,3654145,3848041,485292119,1,5450,1161548,5277,1122225,173,39323,2207,12,4318,103,1,62,216660.0,130000.0,-51.0,-47.0,-42.0,-49.0,-51.0,-47.0,-43.0,-47.0,-90.0,-93.0,-89.0,-92.0,39.0,46.0,47.0,43.0,1
1993,CC:2F:71:3F:1F:24,5077156,1899392129,1229115,1414100010,3848041,485292119,1730,1031792,1175144751,1030943,1175042011,849,102740,998116,15,1227740,121502,1727,798,144444.0,43333.0,-77.0,-73.0,-70.0,-75.0,-75.0,-72.0,-69.0,-74.0,-90.0,-93.0,-89.0,-92.0,13.0,20.0,19.0,17.0,1
1994,CC:2F:71:3E:C5:1F,3849045,485414817,1000,122294,3848045,485292523,2,4336,362022,3608,275588,728,86434,1060,13,1438,28,2,54,130000.0,39000.0,-72.0,-71.0,-68.0,-60.0,-71.0,-71.0,-68.0,-60.0,-90.0,-93.0,-89.0,-92.0,18.0,22.0,21.0,32.0,1
1995,BA:8C:B9:54:50:24,3852986,491487687,4941,6195164,3848045,485292523,7,9827,1756924,9805,1753429,22,3495,2361,18,5452,44,7,72,229410.0,130000.0,-39.0,-36.0,-45.0,-51.0,-43.0,-35.0,-44.0,-47.0,-90.0,-93.0,-89.0,-92.0,51.0,57.0,44.0,41.0,1
1996,62:47:05:9D:EB:15,3854805,497476223,6759,12183638,3848046,485292585,1,7029,3806505,6979,3798847,50,7658,3317,0,6831,56,1,125,216660.0,130000.0,-43.0,-46.0,-36.0,-48.0,-43.0,-45.0,-36.0,-47.0,-90.0,-93.0,-89.0,-92.0,47.0,47.0,53.0,44.0,1
1997,92:69:1D:31:68:E9,3852105,488946846,4059,3654261,3848046,485292585,1,5452,1161684,5279,1122361,173,39323,2207,12,4319,103,1,62,216660.0,130000.0,-51.0,-47.0,-43.0,-48.0,-51.0,-47.0,-43.0,-47.0,-90.0,-93.0,-89.0,-92.0,39.0,46.0,46.0,44.0,1
1998,CC:2F:71:3F:1F:24,5077366,1899647098,1229320,1414354513,3848046,485292585,1730,1031975,1175383291,1031126,1175280551,849,102740,998299,15,1227946,121502,1727,798,144444.0,43333.0,-73.0,-70.0,-67.0,-72.0,-73.0,-70.0,-67.0,-72.0,-90.0,-93.0,-89.0,-92.0,17.0,23.0,22.0,20.0,1
1999,CC:2F:71:3E:C5:1F,3849047,485414995,1001,122410,3848046,485292585,2,4340,362350,3611,275798,729,86552,1061,13,1439,28,2,54,144444.0,39000.0,-71.0,-71.0,-68.0,-60.0,-71.0,-70.0,-67.0,-60.0,-90.0,-93.0,-89.0,-92.0,19.0,22.0,21.0,32.0,1
2000,BA:8C:B9:54:50:24,3852988,491487865,4942,6195280,3848046,485292585,7,9829,1757060,9807,1753565,22,3495,2361,18,5453,44,7,72,229410.0,137640.0,-39.0,-36.0,-45.0,-51.0,-43.0,-35.0,-43.0,-47.0,-90.0,-93.0,-89.0,-92.0,51.0,57.0,44.0,41.0,1
2001,62:47:05:9D:EB:15,3854810,497476743,6760,12183754,3848050,485292989,1,7031,3806641,6981,3798983,50,7658,3317,0,6832,56,1,125,216660.0,130000.0,-44.0,-45.0,-38.0,-49.0,-43.0,-45.0,-36.0,-47.0,-90.0,-93.0,-89.0,-92.0,46.0,48.0,51.0,43.0,1
2002,92:69:1D:31:68:E9,3852114,488947714,4059,3654261,3848055,485293453,1,5452,1161684,5279,1122361,173,39323,2207,12,4319,103,1,62,216660.0,130000.0,-51.0,-47.0,-43.0,-48.0,-51.0,-47.0,-43.0,-47.0,-90.0,-93.0,-89.0,-92.0,39.0,46.0,46.0,44.0,1
2003,CC:2F:71:3F:1F:24,5077566,1899892220,1229511,1414598767,3848055,485293453,1730,1032146,1175612871,1031297,1175510131,849,102740,998470,15,1228137,121502,1727,798,144444.0,43333.0,-77.0,-73.0,-70.0,-75.0,-76.0,-72.0,-69.0,-74.0,-90.0,-93.0,-89.0,-92.0,13.0,20.0,19.0,17.0,1
2004,CC:2F:71:3E:C5:1F,3849056,485415863,1001,122410,3848055,485293453,2,4340,362350,3611,275798,729,86552,1061,13,1439,28,2,54,144444.0,39000.0,-71.0,-71.0,-68.0,-60.0,-71.0,-70.0,-67.0,-60.0,-90.0,-93.0,-89.0,-92.0,19.0,22.0,21.0,32.0,1
2005,BA:8C:B9:54:50:24,3852997,491488733,4942,6195280,3848055,485293453,7,9829,1757060,9807,1753565,22,3495,2361,18,5453,44,7,72,229410.0,137640.0,-39.0,-36.0,-45.0,-51.0,-43.0,-35.0,-43.0,-47.0,-90.0,-93.0,-89.0,-92.0,51.0,57.0,44.0,41.0,1
2006,62:47:05:9D:EB:15,3854815,497477207,6760,12183754,3848055,485293453,1,7031,3806641,6981,3798983,50,7658,3317,0,6832,56,1,125,216660.0,130000.0,-44.0,-45.0,-38.0,-49.0,-43.0,-45.0,-36.0,-47.0,-90.0,-93.0,-89.0,-92.0,46.0,48.0,51.0,43.0,1
2007,92:69:1D:31:68:E9,3852114,488947714,4059,3654261,3848055,485293453,1,5452,1161684,5279,1122361,173,39323,2207,12,4319,103,1,62,216660.0,130000.0,-51.0,-47.0,-43.0,-48.0,-51.0,-47.0,-43.0,-47.0,-90.0,-93.0,-89.0,-92.0,39.0,46.0,46.0,44.0,1
2008,CC:2F:71:3F:1F:24,5077755,1900133366,1229700,1414839913,3848055,485293453,1730,1032317,1175840859,1031468,1175738119,849,102740,998640,15,1228326,121502,1727,798,144444.0,43333.0,-77.0,-73.0,-70.0,-75.0,-75.0,-71.0,-69.0,-74.0,-90.0,-93.0,-89.0,-92.0,13.0,20.0,19.0,17.0,1
2009,CC:2F:71:3E:C5:1F,3849056,485415863,1001,122410,3848055,485293453,2,4340,362350,3611,275798,729,86552,1061,13,1439,28,2,54,144444.0,39000.0,-71.0,-71.0,-68.0,-60.0,-71.0,-70.0,-67.0,-60.0,-90.0,-93.0,-89.0,-92.0,19.0,22.0,21.0,32.0,1
2010,BA:8C:B9:54:50:24,3852998,491489006,4942,6195280,3848056,485293726,7,9829,1757060,9807,1753565,22,3495,2361,18,5453,44,7,72,229410.0,137640.0,-39.0,-36.0,-45.0,-51.0,-43.0,-35.0,-43.0,-47.0,-90.0,-93.0,-89.0,-92.0,51.0,57.0,44.0,41.0,1
2011,62:47:05:9D:EB:15,3854824,497478288,6760,12183754,3848064,485294534,1,7031,3806641,6981,3798983,50,7658,3317,0,6832,56,1,125,216660.0,130000.0,-44.0,-45.0,-38.0,-49.0,-43.0,-45.0,-36.0,-47.0,-90.0,-93.0,-89.0,-92.0,46.0,48.0,51.0,43.0,1
2012,92:69:1D:31:68:E9,3852123,488948795,4059,3654261,3848064,485294534,1,5452,1161684,5279,1122361,173,39323,2207,12,4319,103,1,62,216660.0,130000.0,-51.0,-47.0,-43.0,-48.0,-51.0,-47.0,-43.0,-47.0,-90.0,-93.0,-89.0,-92.0,39.0,46.0,46.0,44.0,1
2013,CC:2F:71:3F:1F:24,5077961,1900380618,1229897,1415086084,3848064,485294534,1730,1032493,1176068439,1031644,1175965699,849,102740,998816,15,1228523,121502,1727,798,144444.0,43333.0,-77.0,-73.0,-70.0,-75.0,-76.0,-72.0,-69.0,-74.0,-90.0,-93.0,-89.0,-92.0,13.0,20.0,19.0,17.0,1
2014,CC:2F:71:3E:C5:1F,3849065,485416944,1001,122410,3848064,485294534,2,4340,362350,3611,275798,729,86552,1061,13,1439,28,2,54,144444.0,39000.0,-71.0,-71.0,-68.0,-60.0,-71.0,-70.0,-67.0,-60.0,-90.0,-93.0,-89.0,-92.0,19.0,22.0,21.0,32.0,1
2015,BA:8C:B9:54:50:24,3853006,491489814,4942,6195280,3848064,485294534,7,9829,1757060,9807,1753565,22,3495,2361,18,5453,44,7,72,229410.0,137640.0,-39.0,-36.0,-45.0,-51.0,-43.0,-35.0,-43.0,-47.0,-90.0,-93.0,-89.0,-92.0,51.0,57.0,44.0,41.0,1
2016,62:47:05:9D:EB:15,3854826,497478410,6760,12183754,3848066,485294656,1,7031,3806641,6981,3798983,50,7658,3317,0,6832,56,1,125,216660.0,130000.0,-44.0,-45.0,-38.0,-49.0,-43.0,-45.0,-36.0,-47.0,-90.0,-93.0,-89.0,-92.0,46.0,48.0,51.0,43.0,1
2017,92:69:1D:31:68:E9,3852125,488948917,4059,3654261,3848066,485294656,1,5452,1161684,5279,1122361,173,39323,2207,12,4319,103,1,62,216660.0,130000.0,-51.0,-47.0,-43.0,-48.0,-51.0,-47.0,-43.0,-47.0,-90.0,-93.0,-89.0,-92.0,39.0,46.0,46.0,44.0,1
2018,CC:2F:71:3F:1F:24,5078152,1900623310,1230086,1415328654,3848066,485294656,1730,1032665,1176297913,1031815,1176195055,850,102858,998988,15,1228712,121502,1727,798,144444.0,43333.0,-76.0,-73.0,-70.0,-76.0,-76.0,-73.0,-70.0,-75.0,-90.0,-93.0,-89.0,-92.0,14.0,20.0,19.0,16.0,1
2019,CC:2F:71:3E:C5:1F,3849067,485417066,1001,122410,3848066,485294656,2,4340,362350,3611,275798,729,86552,1061,13,1439,28,2,54,144444.0,39000.0,-71.0,-71.0,-68.0,-60.0,-71.0,-70.0,-67.0,-60.0,-90.0,-93.0,-89.0,-92.0,19.0,22.0,21.0,32.0,1
2020,BA:8C:B9:54:50:24,3853008,491489936,4942,6195280,3848066,485294656,7,9829,1757060,9807,1753565,22,3495,2361,18,5453,44,7,72,229410.0,137640.0,-39.0,-36.0,-45.0,-51.0,-43.0,-35.0,-43.0,-47.0,-90.0,-93.0,-89.0,-92.0,51.0,57.0,44.0,41.0,1
2021,62:47:05:9D:EB:15,3854834,497479218,6760,12183754,3848074,485295464,1,7031,3806641,6981,3798983,50,7658,3317,0,6832,56,1,125,216660.0,130000.0,-44.0,-45.0,-38.0,-49.0,-43.0,-45.0,-36.0,-47.0,-90.0,-93.0,-89.0,-92.0,46.0,48.0,51.0,43.0,1
2022,92:69:1D:31:68:E9,3852133,488949725,4059,3654261,3848074,485295464,1,5452,1161684,5279,1122361,173,39323,2207,12,4319,103,1,62,216660.0,130000.0,-51.0,-47.0,-43.0,-48.0,-51.0,-47.0,-43.0,-47.0,-90.0,-93.0,-89.0,-92.0,39.0,46.0,46.0,44.0,1
2023,CC:2F:71:3F:1F:24,5078349,1900865264,1230275,1415569800,3848074,485295464,1730,1032833,1176524073,1031983,1176421215,850,102858,999156,15,1228901,121506,1727,798,144444.0,43333.0,-76.0,-73.0,-72.0,-76.0,-74.0,-72.0,-71.0,-75.0,-90.0,-93.0,-89.0,-92.0,14.0,20.0,17.0,16.0,1
2024,CC:2F:71:3E:C5:1F,3849075,485417874,1001,122410,3848074,485295464,2,4340,362350,3611,275798,729,86552,1061,13,1439,28,2,54,144444.0,39000.0,-71.0,-71.0,-68.0,-60.0,-71.0,-70.0,-67.0,-60.0,-90.0,-93.0,-89.0,-92.0,19.0,22.0,21.0,32.0,1
2025,BA:8C:B9:54:50:24,3853016,491490744,4942,6195280,3848074,485295464,7,9829,1757060,9807,1753565,22,3495,2361,18,5453,44,7,72,229410.0,137640.0,-39.0,-36.0,-45.0,-51.0,-43.0,-35.0,-43.0,-47.0,-90.0,-93.0,-89.0,-92.0,51.0,57.0,44.0,41.0,1
2026,62:47:05:9D:EB:15,3854835,497479278,6760,12183754,3848075,485295524,1,7031,3806641,6981,3798983,50,7658,3317,0,6832,56,1,125,216660.0,130000.0,-44.0,-45.0,-38.0,-49.0,-43.0,-45.0,-36.0,-47.0,-90.0,-93.0,-89.0,-92.0,46.0,48.0,51.0,43.0,1
2027,92:69:1D:31:68:E9,3852134,488949785,4059,3654261,3848075,485295524,1,5452,1161684,5279,1122361,173,39323,2207,12,4319,103,1,62,216660.0,130000.0,-51.0,-47.0,-43.0,-48.0,-51.0,-47.0,-43.0,-47.0,-90.0,-93.0,-89.0,-92.0,39.0,46.0,46.0,44.0,1
2028,CC:2F:71:3F:1F:24,5078539,1901106470,1230464,1415810946,3848075,485295524,1730,1033001,1176747539,1032151,1176644681,850,102858,999324,15,1229088,121508,1727,798,144444.0,43333.0,-72.0,-69.0,-67.0,-72.0,-72.0,-69.0,-67.0,-72.0,-90.0,-93.0,-89.0,-92.0,18.0,24.0,22.0,20.0,1
2029,CC:2F:71:3E:C5:1F,3849076,485417934,1001,122410,3848075,485295524,2,4340,362350,3611,275798,729,86552,1061,13,1439,28,2,54,144444.0,39000.0,-71.0,-71.0,-68.0,-60.0,-71.0,-70.0,-67.0,-60.0,-90.0,-93.0,-89.0,-92.0,19.0,22.0,21.0,32.0,1
2030,BA:8C:B9:54:50:24,3853017,491490804,4942,6195280,3848075,485295524,7,9829,1757060,9807,1753565,22,3495,2361,18,5453,44,7,72,229410.0,137640.0,-39.0,-36.0,-45.0,-51.0,-43.0,-35.0,-43.0,-47.0,-90.0,-93.0,-89.0,-92.0,51.0,57.0,44.0,41.0,1
2031,62:47:05:9D:EB:15,3854843,497480086,6760,12183754,3848083,485296332,1,7031,3806641,6981,3798983,50,7658,3317,0,6832,56,1,125,216660.0,130000.0,-44.0,-45.0,-38.0,-49.0,-43.0,-45.0,-36.0,-47.0,-90.0,-93.0,-89.0,-92.0,46.0,48.0,51.0,43.0,1
2032,92:69:1D:31:68:E9,3852142,488950593,4059,3654261,3848083,485296332,1,5452,1161684,5279,1122361,173,39323,2207,12,4319,103,1,62,216660.0,130000.0,-51.0,-47.0,-43.0,-48.0,-51.0,-47.0,-43.0,-47.0,-90.0,-93.0,-89.0,-92.0,39.0,46.0,46.0,44.0,1
2033,CC:2F:71:3F:1F:24,5078754,1901367693,1230671,1416071361,3848083,485296332,1730,1033190,1176993853,1032340,1176890995,850,102858,999512,15,1229297,121508,1727,798,144444.0,43333.0,-72.0,-68.0,-67.0,-72.0,-72.0,-68.0,-67.0,-71.0,-90.0,-93.0,-89.0,-92.0,18.0,25.0,22.0,20.0,1
2034,CC:2F:71:3E:C5:1F,3849084,485418742,1001,122410,3848083,485296332,2,4340,362350,3611,275798,729,86552,1061,13,1439,28,2,54,144444.0,39000.0,-71.0,-71.0,-68.0,-60.0,-71.0,-70.0,-67.0,-60.0,-90.0,-93.0,-89.0,-92.0,19.0,22.0,21.0,32.0,1
2035,BA:8C:B9:54:50:24,3853025,491491612,4942,6195280,3848083,485296332,7,9829,1757060,9807,1753565,22,3495,2361,18,5453,44,7,72,229410.0,137640.0,-39.0,-36.0,-45.0,-51.0,-43.0,-35.0,-43.0,-47.0,-90.0,-93.0,-89.0,-92.0,51.0,57.0,44.0,41.0,1
2036,62:47:05:9D:EB:15,3854843,497480086,6760,12183754,3848083,485296332,1,7031,3806641,6981,3798983,50,7658,3317,0,6832,56,1,125,216660.0,130000.0,-44.0,-45.0,-38.0,-49.0,-43.0,-45.0,-36.0,-47.0,-90.0,-93.0,-89.0,-92.0,46.0,48.0,51.0,43.0,1
2037,92:69:1D:31:68:E9,3852142,488950593,4059,3654261,3848083,485296332,1,5452,1161684,5279,1122361,173,39323,2207,12,4319,103,1,62,216660.0,130000.0,-51.0,-47.0,-43.0,-48.0,-51.0,-47.0,-43.0,-47.0,-90.0,-93.0,-89.0,-92.0,39.0,46.0,46.0,44.0,1
2038,CC:2F:71:3F:1F:24,5078942,1901608709,1230859,1416312377,3848083,485296332,1730,1033362,1177221901,1032512,1177119043,850,102858,999684,15,1229485,121508,1727,798,144444.0,43333.0,-72.0,-68.0,-67.0,-71.0,-72.0,-68.0,-67.0,-71.0,-90.0,-93.0,-89.0,-92.0,18.0,25.0,22.0,21.0,1
2039,CC:2F:71:3E:C5:1F,3849084,485418742,1001,122410,3848083,485296332,2,4340,362350,3611,275798,729,86552,1061,13,1439,28,2,54,144444.0,39000.0,-71.0,-71.0,-68.0,-60.0,-71.0,-70.0,-67.0,-60.0,-90.0,-93.0,-89.0,-92.0,19.0,22.0,21.0,32.0,1
2040,BA:8C:B9:54:50:24,3853027,491491814,4942,6195280,3848085,485296534,7,9829,1757060,9807,1753565,22,3495,2361,18,5453,44,7,72,229410.0,137640.0,-39.0,-36.0,-45.0,-51.0,-43.0,-35.0,-43.0,-47.0,-90.0,-93.0,-89.0,-92.0,51.0,57.0,44.0,41.0,1
2041,62:47:05:9D:EB:15,3854852,497480954,6760,12183754,3848092,485297200,1,7031,3806641,6981,3798983,50,7658,3317,0,6832,56,1,125,216660.0,130000.0,-44.0,-45.0,-38.0,-49.0,-43.0,-45.0,-36.0,-47.0,-90.0,-93.0,-89.0,-92.0,46.0,48.0,51.0,43.0,1
2042,92:69:1D:31:68:E9,3852151,488951461,4059,3654261,3848092,485297200,1,5453,1161752,5280,1122429,173,39323,2207,12,4319,103,1,62,216660.0,130000.0,-51.0,-47.0,-42.0,-48.0,-51.0,-47.0,-43.0,-47.0,-90.0,-93.0,-89.0,-92.0,39.0,46.0,47.0,44.0,1
2043,CC:2F:71:3F:1F:24,5079139,1901850593,1231047,1416553393,3848092,485297200,1730,1033530,1177448061,1032680,1177345203,850,102858,999852,15,1229673,121508,1727,798,144444.0,43333.0,-72.0,-69.0,-67.0,-71.0,-72.0,-68.0,-67.0,-71.0,-90.0,-93.0,-89.0,-92.0,18.0,24.0,22.0,21.0,1
2044,CC:2F:71:3E:C5:1F,3849093,485419610,1001,122410,3848092,485297200,2,4340,362350,3611,275798,729,86552,1061,13,1439,28,2,54,144444.0,39000.0,-71.0,-71.0,-68.0,-60.0,-71.0,-70.0,-67.0,-60.0,-90.0,-93.0,-89.0,-92.0,19.0,22.0,21.0,32.0,1
2045,BA:8C:B9:54:50:24,3853034,491492480,4942,6195280,3848092,485297200,7,9829,1757060,9807,1753565,22,3495,2361,18,5453,44,7,72,229410.0,137640.0,-39.0,-36.0,-45.0,-51.0,-43.0,-35.0,-43.0,-47.0,-90.0,-93.0,-89.0,-92.0,51.0,57.0,44.0,41.0,1
2046,62:47:05:9D:EB:15,3854852,497480954,6760,12183754,3848092,485297200,1,7031,3806641,6981,3798983,50,7658,3317,0,6832,56,1,125,216660.0,130000.0,-44.0,-45.0,-38.0,-49.0,-43.0,-45.0,-36.0,-47.0,-90.0,-93.0,-89.0,-92.0,46.0,48.0,51.0,43.0,1
2047,92:69:1D:31:68:E9,3852151,488951461,4059,3654261,3848092,485297200,1,5453,1161752,5280,1122429,173,39323,2207,12,4319,103,1,62,216660.0,130000.0,-51.0,-47.0,-42.0,-48.0,-51.0,-47.0,-43.0,-47.0,-90.0,-93.0,-89.0,-92.0,39.0,46.0,47.0,44.0,1
2048,CC:2F:71:3F:1F:24,5079331,1902094963,1231239,1416797763,3848092,485297200,1730,1033701,1177677407,1032851,1177574549,850,102858,1000023,15,1229865,121508,1727,798,144444.0,43333.0,-72.0,-69.0,-67.0,-71.0,-72.0,-68.0,-67.0,-71.0,-90.0,-93.0,-89.0,-92.0,18.0,24.0,22.0,21.0,1
2049,CC:2F:71:3E:C5:1F,3849095,485419812,1001,122410,3848094,485297402,2,4340,362350,3611,275798,729,86552,1061,13,1439,28,2,54,144444.0,39000.0,-71.0,-71.0,-68.0,-60.0,-71.0,-70.0,-67.0,-60.0,-90.0,-93.0,-89.0,-92.0,19.0,22.0,21.0,32.0,1
2050,BA:8C:B9:54:50:24,3853036,491492682,4942,6195280,3848094,485297402,7,9829,1757060,9807,1753565,22,3495,2361,18,5453,44,7,72,229410.0,137640.0,-39.0,-36.0,-45.0,-51.0,-43.0,-35.0,-43.0,-47.0,-90.0,-93.0,-89.0,-92.0,51.0,57.0,44.0,41.0,1
2051,62:47:05:9D:EB:15,3854861,497481822,6760,12183754,3848101,485298068,1,7031,3806641,6981,3798983,50,7658,3317,0,6832,56,1,125,216660.0,130000.0,-44.0,-45.0,-38.0,-49.0,-43.0,-45.0,-36.0,-47.0,-90.0,-93.0,-89.0,-92.0,46.0,48.0,51.0,43.0,1
2052,92:69:1D:31:68:E9,3852160,488952329,4059,3654261,3848101,485298068,1,5453,1161752,5280,1122429,173,39323,2207,12,4319,103,1,62,216660.0,130000.0,-51.0,-47.0,-42.0,-48.0,-51.0,-47.0,-43.0,-47.0,-90.0,-93.0,-89.0,-92.0,39.0,46.0,47.0,44.0,1
2053,CC:2F:71:3F:1F:24,5079544,1902340381,1231443,1417042313,3848101,485298068,1730,1033886,1177903920,1033036,1177801062,850,102858,1000208,15,1230069,121510,1727,799,144444.0,43333.0,-72.0,-69.0,-67.0,-71.0,-72.0,-68.0,-66.0,-71.0,-90.0,-93.0,-89.0,-92.0,18.0,24.0,22.0,21.0,1
2054,CC:2F:71:3E:C5:1F,3849102,485420478,1001,122410,3848101,485298068,2,4340,362350,3611,275798,729,86552,1061,13,1439,28,2,54,144444.0,39000.0,-71.0,-71.0,-68.0,-60.0,-71.0,-70.0,-67.0,-60.0,-90.0,-93.0,-89.0,-92.0,19.0,22.0,21.0,32.0,1
2055,BA:8C:B9:54:50:24,3853043,491493348,4942,6195280,3848101,485298068,7,9829,1757060,9807,1753565,22,3495,2361,18,5453,44,7,72,229410.0,137640.0,-39.0,-36.0,-45.0,-51.0,-43.0,-35.0,-43.0,-47.0,-90.0,-93.0,-89.0,-92.0,51.0,57.0,44.0,41.0,1
2056,62:47:05:9D:EB:15,3854861,497481822,6760,12183754,3848101,485298068,1,7032,3806709,6982,3799051,50,7658,3317,0,6833,56,1,125,216660.0,130000.0,-44.0,-45.0,-35.0,-48.0,-43.0,-45.0,-36.0,-47.0,-90.0,-93.0,-89.0,-92.0,46.0,48.0,54.0,44.0,1
2057,92:69:1D:31:68:E9,3852162,488952531,4059,3654261,3848103,485298270,1,5453,1161752,5280,1122429,173,39323,2207,12,4319,103,1,62,216660.0,130000.0,-51.0,-47.0,-42.0,-48.0,-51.0,-47.0,-43.0,-47.0,-90.0,-93.0,-89.0,-92.0,39.0,46.0,47.0,44.0,1
2058,CC:2F:71:3F:1F:24,5079750,1902590414,1231635,1417286545,3848115,485303869,1730,1034055,1178130196,1033205,1178027338,850,102858,1000377,15,1230261,121510,1727,799,144444.0,43333.0,-72.0,-69.0,-67.0,-73.0,-72.0,-68.0,-67.0,-73.0,-90.0,-93.0,-89.0,-92.0,18.0,24.0,22.0,19.0,1
2059,CC:2F:71:3E:C5:1F,3849116,485426279,1001,122410,3848115,485303869,2,4342,362490,3613,275938,729,86552,1061,13,1440,28,2,54,144444.0,39000.0,-71.0,-71.0,-68.0,-60.0,-71.0,-70.0,-67.0,-60.0,-90.0,-93.0,-89.0,-92.0,19.0,22.0,21.0,32.0,1
2060,BA:8C:B9:54:50:24,3853057,491499149,4942,6195280,3848115,485303869,7,9832,1757264,9810,1753769,22,3495,2361,18,5454,44,7,72,229410.0,137640.0,-40.0,-37.0,-46.0,-51.0,-43.0,-36.0,-44.0,-49.0,-90.0,-93.0,-89.0,-92.0,50.0,56.0,43.0,41.0,1
2061,62:47:05:9D:EB:15,3854892,497493653,6760,12183754,3848132,485309899,1,7033,3806777,6983,3799119,50,7658,3317,0,6833,56,1,125,216660.0,130000.0,-44.0,-49.0,-44.0,-45.0,-43.0,-45.0,-37.0,-47.0,-90.0,-93.0,-89.0,-92.0,46.0,44.0,45.0,47.0,1
2062,92:69:1D:31:68:E9,3852191,488964160,4059,3654261,3848132,485309899,1,5456,1162123,5282,1122565,174,39558,2208,12,4319,103,1,62,216660.0,130000.0,-52.0,-48.0,-44.0,-47.0,-51.0,-47.0,-43.0,-48.0,-90.0,-93.0,-89.0,-92.0,38.0,45.0,45.0,45.0,1
2063,CC:2F:71:3F:1F:24,5079964,1902847190,1231832,1417537291,3848132,485309899,1730,1034232,1178368792,1033382,1178265934,850,102858,1000554,15,1230458,121510,1727,799,144444.0,43333.0,-72.0,-68.0,-68.0,-73.0,-71.0,-68.0,-68.0,-73.0,-90.0,-93.0,-89.0,-92.0,18.0,25.0,21.0,19.0,1
2064,CC:2F:71:3E:C5:1F,3849133,485432309,1001,122410,3848132,485309899,2,4342,362490,3613,275938,729,86552,1061,13,1440,28,2,54,144444.0,39000.0,-71.0,-71.0,-68.0,-60.0,-71.0,-70.0,-67.0,-60.0,-90.0,-93.0,-89.0,-92.0,19.0,22.0,21.0,32.0,1
2065,BA:8C:B9:54:50:24,3853074,491505179,4942,6195280,3848132,485309899,7,9832,1757264,9810,1753769,22,3495,2361,18,5454,44,7,72,229410.0,137640.0,-40.0,-37.0,-46.0,-51.0,-43.0,-36.0,-44.0,-49.0,-90.0,-93.0,-89.0,-92.0,50.0,56.0,43.0,41.0,1
2066,62:47:05:9D:EB:15,3854895,497493915,6760,12183754,3848135,485310161,1,7033,3806777,6983,3799119,50,7658,3317,0,6833,56,1,125,216660.0,130000.0,-44.0,-49.0,-44.0,-45.0,-43.0,-45.0,-37.0,-47.0,-90.0,-93.0,-89.0,-92.0,46.0,44.0,45.0,47.0,1
2067,92:69:1D:31:68:E9,3852194,488964422,4059,3654261,3848135,485310161,1,5456,1162123,5282,1122565,174,39558,2208,12,4319,103,1,62,216660.0,130000.0,-52.0,-48.0,-44.0,-47.0,-51.0,-47.0,-43.0,-48.0,-90.0,-93.0,-89.0,-92.0,38.0,45.0,45.0,45.0,1
2068,CC:2F:71:3F:1F:24,5080161,1903092112,1232026,1417781951,3848135,485310161,1730,1034402,1178596608,1033552,1178493750,850,102858,1000724,15,1230650,121510,1727,799,144444.0,43333.0,-71.0,-68.0,-69.0,-72.0,-71.0,-68.0,-68.0,-72.0,-90.0,-93.0,-89.0,-93.0,19.0,25.0,20.0,21.0,1
2069,CC:2F:71:3E:C5:1F,3849136,485432571,1001,122410,3848135,485310161,2,4342,362490,3613,275938,729,86552,1061,13,1440,28,2,54,144444.0,39000.0,-71.0,-71.0,-68.0,-60.0,-71.0,-70.0,-67.0,-60.0,-90.0,-93.0,-89.0,-93.0,19.0,22.0,21.0,33.0,1
2070,BA:8C:B9:54:50:24,3853079,491505643,4942,6195280,3848137,485310363,7,9832,1757264,9810,1753769,22,3495,2361,18,5454,44,7,72,229410.0,137640.0,-40.0,-37.0,-46.0,-51.0,-43.0,-36.0,-44.0,-49.0,-90.0,-93.0,-89.0,-93.0,50.0,56.0,43.0,42.0,1
2071,62:47:05:9D:EB:15,3854902,497494794,6760,12183754,3848142,485311040,1,7033,3806777,6983,3799119,50,7658,3317,0,6833,56,1,125,216660.0,130000.0,-44.0,-49.0,-44.0,-45.0,-43.0,-45.0,-37.0,-47.0,-90.0,-93.0,-89.0,-93.0,46.0,44.0,45.0,48.0,1
2072,92:69:1D:31:68:E9,3852201,488965301,4059,3654261,3848142,485311040,1,5456,1162123,5282,1122565,174,39558,2208,12,4319,103,1,62,216660.0,130000.0,-52.0,-48.0,-44.0,-47.0,-51.0,-47.0,-43.0,-48.0,-90.0,-93.0,-89.0,-93.0,38.0,45.0,45.0,46.0,1
2073,CC:2F:71:3F:1F:24,5080368,1903338144,1232226,1418027104,3848142,485311040,1730,1034582,1178827513,1033732,1178724655,850,102858,1000903,15,1230852,121510,1727,799,144444.0,43333.0,-71.0,-68.0,-69.0,-72.0,-71.0,-68.0,-69.0,-72.0,-90.0,-93.0,-89.0,-93.0,19.0,25.0,20.0,21.0,1
2074,CC:2F:71:3E:C5:1F,3849143,485433450,1001,122410,3848142,485311040,2,4342,362490,3613,275938,729,86552,1061,13,1440,28,2,54,144444.0,39000.0,-71.0,-71.0,-68.0,-60.0,-71.0,-70.0,-67.0,-60.0,-90.0,-93.0,-89.0,-93.0,19.0,22.0,21.0,33.0,1
2075,BA:8C:B9:54:50:24,3853084,491506320,4942,6195280,3848142,485311040,7,9832,1757264,9810,1753769,22,3495,2361,18,5454,44,7,72,229410.0,137640.0,-40.0,-37.0,-46.0,-51.0,-43.0,-36.0,-44.0,-49.0,-90.0,-93.0,-89.0,-93.0,50.0,56.0,43.0,42.0,1
2076,62:47:05:9D:EB:15,3854905,497495056,6760,12183754,3848145,485311302,1,7033,3806777,6983,3799119,50,7658,3317,0,6833,56,1,125,216660.0,130000.0,-44.0,-49.0,-44.0,-45.0,-43.0,-45.0,-37.0,-47.0,-90.0,-93.0,-89.0,-92.0,46.0,44.0,45.0,47.0,1
2077,92:69:1D:31:68:E9,3852204,488965563,4059,3654261,3848145,485311302,1,5456,1162123,5282,1122565,174,39558,2208,12,4319,103,1,62,216660.0,130000.0,-52.0,-48.0,-44.0,-47.0,-51.0,-47.0,-43.0,-48.0,-90.0,-93.0,-89.0,-92.0,38.0,45.0,45.0,45.0,1
2078,CC:2F:71:3F:1F:24,5080564,1903580030,1232417,1418268526,3848147,485311504,1730,1034751,1179053789,1033901,1178950931,850,102858,1001072,15,1231043,121510,1727,799,144444.0,43333.0,-72.0,-68.0,-67.0,-73.0,-71.0,-68.0,-67.0,-72.0,-90.0,-93.0,-89.0,-92.0,18.0,25.0,22.0,19.0,1
2079,CC:2F:71:3E:C5:1F,3849148,485433914,1001,122410,3848147,485311504,2,4342,362490,3613,275938,729,86552,1061,13,1440,28,2,54,144444.0,39000.0,-71.0,-71.0,-68.0,-60.0,-71.0,-70.0,-67.0,-60.0,-90.0,-93.0,-89.0,-92.0,19.0,22.0,21.0,32.0,1
2080,BA:8C:B9:54:50:24,3853089,491506784,4942,6195280,3848147,485311504,7,9832,1757264,9810,1753769,22,3495,2361,18,5454,44,7,72,229410.0,137640.0,-40.0,-37.0,-46.0,-51.0,-43.0,-36.0,-44.0,-49.0,-90.0,-93.0,-89.0,-92.0,50.0,56.0,43.0,41.0,1
2081,62:47:05:9D:EB:15,3854911,497495662,6760,12183754,3848151,485311908,1,7033,3806777,6983,3799119,50,7658,3317,0,6833,56,1,125,216660.0,130000.0,-44.0,-49.0,-44.0,-45.0,-43.0,-45.0,-37.0,-47.0,-90.0,-93.0,-89.0,-92.0,46.0,44.0,45.0,47.0,1
2082,92:69:1D:31:68:E9,3852210,488966169,4059,3654261,3848151,485311908,1,5456,1162123,5282,1122565,174,39558,2208,12,4319,103,1,62,216660.0,130000.0,-52.0,-48.0,-44.0,-47.0,-51.0,-47.0,-43.0,-48.0,-90.0,-93.0,-89.0,-92.0,38.0,45.0,45.0,45.0,1
2083,CC:2F:71:3F:1F:24,5080760,1903821986,1232609,1418510078,3848151,485311908,1730,1034920,1179280079,1034070,1179177221,850,102858,1001240,15,1231235,121510,1727,799,144444.0,43333.0,-72.0,-68.0,-68.0,-72.0,-72.0,-68.0,-67.0,-72.0,-90.0,-93.0,-89.0,-92.0,18.0,25.0,21.0,20.0,1
2084,CC:2F:71:3E:C5:1F,3849152,485434318,1001,122410,3848151,485311908,2,4342,362490,3613,275938,729,86552,1061,13,1440,28,2,54,144444.0,39000.0,-71.0,-71.0,-68.0,-60.0,-71.0,-70.0,-67.0,-60.0,-90.0,-93.0,-89.0,-92.0,19.0,22.0,21.0,32.0,1
2085,BA:8C:B9:54:50:24,3853093,491507188,4942,6195280,3848151,485311908,7,9832,1757264,9810,1753769,22,3495,2361,18,5454,44,7,72,229410.0,137640.0,-40.0,-37.0,-46.0,-51.0,-43.0,-36.0,-44.0,-49.0,-90.0,-93.0,-89.0,-92.0,50.0,56.0,43.0,41.0,1
2086,62:47:05:9D:EB:15,3854915,497496232,6760,12183754,3848155,485312478,1,7033,3806777,6983,3799119,50,7658,3317,0,6833,56,1,125,216660.0,130000.0,-44.0,-49.0,-44.0,-45.0,-43.0,-45.0,-37.0,-47.0,-90.0,-92.0,-88.0,-92.0,46.0,43.0,44.0,47.0,1
2087,92:69:1D:31:68:E9,3852216,488966941,4059,3654261,3848157,485312680,1,5456,1162123,5282,1122565,174,39558,2208,12,4319,103,1,62,216660.0,130000.0,-52.0,-48.0,-44.0,-47.0,-51.0,-47.0,-43.0,-48.0,-90.0,-92.0,-88.0,-92.0,38.0,44.0,44.0,45.0,1
2088,CC:2F:71:3F:1F:24,5080965,1904067781,1232808,1418755101,3848157,485312680,1730,1035097,1179509241,1034247,1179406383,850,102858,1001417,15,1231434,121510,1727,799,144444.0,43333.0,-72.0,-68.0,-67.0,-71.0,-72.0,-68.0,-67.0,-71.0,-90.0,-92.0,-88.0,-92.0,18.0,24.0,21.0,21.0,1
2089,CC:2F:71:3E:C5:1F,3849160,485435292,1001,122410,3848159,485312882,2,4342,362490,3613,275938,729,86552,1061,13,1440,28,2,54,144444.0,39000.0,-71.0,-71.0,-68.0,-60.0,-71.0,-70.0,-67.0,-60.0,-90.0,-92.0,-88.0,-92.0,19.0,21.0,20.0,32.0,1
2090,BA:8C:B9:54:50:24,3853103,491508364,4942,6195280,3848161,485313084,7,9832,1757264,9810,1753769,22,3495,2361,18,5454,44,7,72,229410.0,137640.0,-40.0,-37.0,-46.0,-51.0,-43.0,-36.0,-44.0,-49.0,-90.0,-92.0,-88.0,-92.0,50.0,55.0,42.0,41.0,1
2091,62:47:05:9D:EB:15,3854922,497496898,6760,12183754,3848162,485313144,1,7033,3806777,6983,3799119,50,7658,3317,0,6833,56,1,125,216660.0,130000.0,-44.0,-49.0,-44.0,-45.0,-43.0,-45.0,-37.0,-47.0,-90.0,-92.0,-88.0,-92.0,46.0,43.0,44.0,47.0,1
2092,92:69:1D:31:68:E9,3852221,488967405,4059,3654261,3848162,485313144,1,5456,1162123,5282,1122565,174,39558,2208,12,4319,103,1,62,216660.0,130000.0,-52.0,-48.0,-44.0,-47.0,-51.0,-47.0,-43.0,-48.0,-90.0,-92.0,-89.0,-92.0,38.0,44.0,45.0,45.0,1
2093,CC:2F:71:3F:1F:24,5081161,1904309653,1232999,1418996509,3848162,485313144,1730,1035266,1179735507,1034416,1179632649,850,102858,1001586,15,1231625,121510,1727,799,144444.0,43333.0,-72.0,-68.0,-67.0,-71.0,-72.0,-68.0,-67.0,-71.0,-90.0,-92.0,-89.0,-92.0,18.0,24.0,22.0,21.0,1
2094,CC:2F:71:3E:C5:1F,3849163,485435554,1001,122410,3848162,485313144,2,4342,362490,3613,275938,729,86552,1061,13,1440,28,2,54,144444.0,39000.0,-71.0,-71.0,-68.0,-60.0,-71.0,-70.0,-67.0,-60.0,-90.0,-92.0,-89.0,-92.0,19.0,21.0,21.0,32.0,1
2095,BA:8C:B9:54:50:24,3853104,491508424,4942,6195280,3848162,485313144,7,9832,1757264,9810,1753769,22,3495,2361,18,5454,44,7,72,229410.0,137640.0,-40.0,-37.0,-46.0,-51.0,-43.0,-36.0,-44.0,-49.0,-90.0,-92.0,-89.0,-92.0,50.0,55.0,43.0,41.0,1
2096,62:47:05:9D:EB:15,3854926,497497302,6760,12183754,3848166,485313548,1,7033,3806777,6983,3799119,50,7658,3317,0,6833,56,1,125,216660.0,130000.0,-44.0,-49.0,-44.0,-45.0,-43.0,-45.0,-37.0,-47.0,-90.0,-92.0,-89.0,-92.0,46.0,43.0,45.0,47.0,1
2097,92:69:1D:31:68:E9,3852227,488968011,4059,3654261,3848168,485313750,1,5456,1162123,5282,1122565,174,39558,2208,12,4319,103,1,62,216660.0,130000.0,-52.0,-48.0,-44.0,-47.0,-51.0,-47.0,-43.0,-48.0,-90.0,-92.0,-89.0,-92.0,38.0,44.0,45.0,45.0,1
2098,CC:2F:71:3F:1F:24,5081361,1904557767,1233193,1419244017,3848168,485313750,1730,1035440,1179969497,1034590,1179866639,850,102858,1001759,15,1231819,121510,1727,799,144444.0,43333.0,-73.0,-69.0,-68.0,-72.0,-72.0,-69.0,-67.0,-72.0,-90.0,-92.0,-89.0,-92.0,17.0,23.0,21.0,20.0,1
2099,CC:2F:71:3E:C5:1F,3849171,485436362,1001,122410,3848170,485313952,2,4342,362490,3613,275938,729,86552,1061,13,1440,28,2,54,144444.0,39000.0,-71.0,-71.0,-68.0,-60.0,-71.0,-70.0,-67.0,-60.0,-90.0,-92.0,-89.0,-92.0,19.0,21.0,21.0,32.0,1
2100,BA:8C:B9:54:50:24,3853112,491509232,4942,6195280,3848170,485313952,7,9832,1757264,9810,1753769,22,3495,2361,18,5454,44,7,72,229410.0,137640.0,-40.0,-37.0,-46.0,-51.0,-43.0,-36.0,-44.0,-49.0,-90.0,-92.0,-89.0,-92.0,50.0,55.0,43.0,41.0,1
2101,62:47:05:9D:EB:15,3854931,497497766,6760,12183754,3848171,485314012,1,7033,3806777,6983,3799119,50,7658,3317,0,6833,56,1,125,216660.0,130000.0,-44.0,-49.0,-44.0,-45.0,-43.0,-45.0,-37.0,-47.0,-90.0,-92.0,-89.0,-92.0,46.0,43.0,45.0,47.0,1
2102,92:69:1D:31:68:E9,3852230,488968273,4059,3654261,3848171,485314012,1,5456,1162123,5282,1122565,174,39558,2208,12,4319,103,1,62,216660.0,130000.0,-52.0,-48.0,-44.0,-47.0,-51.0,-47.0,-43.0,-48.0,-90.0,-92.0,-89.0,-92.0,38.0,44.0,45.0,45.0,1
2103,CC:2F:71:3F:1F:24,5081553,1904799175,1233382,1419485163,3848171,485314012,1730,1035608,1180195685,1034758,1180092827,850,102858,1001927,15,1232008,121510,1727,799,144444.0,43333.0,-71.0,-68.0,-69.0,-72.0,-71.0,-68.0,-68.0,-72.0,-90.0,-92.0,-89.0,-92.0,19.0,24.0,20.0,20.0,1
2104,CC:2F:71:3E:C5:1F,3849172,485436422,1001,122410,3848171,485314012,2,4342,362490,3613,275938,729,86552,1061,13,1440,28,2,54,144444.0,39000.0,-71.0,-71.0,-68.0,-60.0,-71.0,-70.0,-67.0,-60.0,-90.0,-92.0,-89.0,-92.0,19.0,21.0,21.0,32.0,1
2105,BA:8C:B9:54:50:24,3853113,491509292,4942,6195280,3848171,485314012,7,9832,1757264,9810,1753769,22,3495,2361,18,5454,44,7,72,229410.0,137640.0,-40.0,-37.0,-46.0,-51.0,-43.0,-36.0,-44.0,-49.0,-90.0,-92.0,-89.0,-92.0,50.0,55.0,43.0,41.0,1
2106,62:47:05:9D:EB:15,3854937,497498372,6760,12183754,3848177,485314618,1,7033,3806777,6983,3799119,50,7658,3317,0,6833,56,1,125,216660.0,130000.0,-44.0,-49.0,-44.0,-45.0,-43.0,-45.0,-37.0,-47.0,-90.0,-92.0,-89.0,-92.0,46.0,43.0,45.0,47.0,1
2107,92:69:1D:31:68:E9,3852238,488969081,4059,3654261,3848179,485314820,1,5456,1162123,5282,1122565,174,39558,2208,12,4319,103,1,62,216660.0,130000.0,-52.0,-48.0,-44.0,-47.0,-51.0,-47.0,-43.0,-48.0,-90.0,-92.0,-89.0,-92.0,38.0,44.0,45.0,45.0,1
2108,CC:2F:71:3F:1F:24,5081764,1905054182,1233585,1419739362,3848179,485314820,1730,1035791,1180429784,1034941,1180326926,850,102858,1002110,15,1232209,121511,1727,799,144444.0,43333.0,-71.0,-69.0,-70.0,-73.0,-71.0,-69.0,-69.0,-73.0,-90.0,-92.0,-89.0,-92.0,19.0,23.0,19.0,19.0,1
2109,CC:2F:71:3E:C5:1F,3849180,485437230,1001,122410,3848179,485314820,2,4342,362490,3613,275938,729,86552,1061,13,1440,28,2,54,144444.0,39000.0,-71.0,-71.0,-68.0,-60.0,-71.0,-70.0,-67.0,-60.0,-90.0,-92.0,-89.0,-92.0,19.0,21.0,21.0,32.0,1
2110,BA:8C:B9:54:50:24,3853121,491510100,4942,6195280,3848179,485314820,7,9832,1757264,9810,1753769,22,3495,2361,18,5454,44,7,72,229410.0,137640.0,-40.0,-37.0,-46.0,-51.0,-43.0,-36.0,-44.0,-49.0,-90.0,-92.0,-89.0,-92.0,50.0,55.0,43.0,41.0,1
2111,62:47:05:9D:EB:15,3854939,497498574,6760,12183754,3848179,485314820,1,7034,3806845,6984,3799187,50,7658,3317,0,6833,56,1,125,216660.0,130000.0,-44.0,-45.0,-38.0,-47.0,-43.0,-45.0,-37.0,-47.0,-90.0,-93.0,-89.0,-93.0,46.0,48.0,51.0,46.0,1
2112,92:69:1D:31:68:E9,3852238,488969081,4059,3654261,3848179,485314820,1,5456,1162123,5282,1122565,174,39558,2208,12,4319,103,1,62,216660.0,130000.0,-52.0,-48.0,-44.0,-47.0,-51.0,-47.0,-43.0,-48.0,-90.0,-93.0,-89.0,-93.0,38.0,45.0,45.0,46.0,1
2113,CC:2F:71:3F:1F:24,5081957,1905297272,1233778,1419982452,3848179,485314820,1730,1035962,1180659140,1035112,1180556282,850,102858,1002281,15,1232403,121511,1727,799,144444.0,43333.0,-71.0,-69.0,-68.0,-72.0,-71.0,-69.0,-68.0,-72.0,-90.0,-93.0,-89.0,-93.0,19.0,24.0,21.0,21.0,1
2114,CC:2F:71:3E:C5:1F,3849180,485437230,1001,122410,3848179,485314820,2,4342,362490,3613,275938,729,86552,1061,13,1440,28,2,54,144444.0,39000.0,-71.0,-71.0,-68.0,-60.0,-71.0,-70.0,-67.0,-60.0,-90.0,-93.0,-89.0,-93.0,19.0,22.0,21.0,33.0,1
2115,BA:8C:B9:54:50:24,3853123,491510302,4942,6195280,3848181,485315022,7,9832,1757264,9810,1753769,22,3495,2361,18,5454,44,7,72,229410.0,137640.0,-40.0,-37.0,-46.0,-51.0,-43.0,-36.0,-44.0,-49.0,-90.0,-93.0,-89.0,-93.0,50.0,56.0,43.0,42.0,1
2116,62:47:05:9D:EB:15,3854948,497499442,6760,12183754,3848188,485315688,1,7034,3806845,6984,3799187,50,7658,3317,0,6833,56,1,125,216660.0,130000.0,-44.0,-45.0,-38.0,-47.0,-43.0,-45.0,-37.0,-47.0,-90.0,-93.0,-89.0,-93.0,46.0,48.0,51.0,46.0,1
2117,92:69:1D:31:68:E9,3852247,488969949,4059,3654261,3848188,485315688,1,5456,1162123,5282,1122565,174,39558,2208,12,4319,103,1,62,216660.0,130000.0,-52.0,-48.0,-44.0,-47.0,-51.0,-47.0,-43.0,-48.0,-90.0,-93.0,-89.0,-93.0,38.0,45.0,45.0,46.0,1
2118,CC:2F:71:3F:1F:24,5082159,1905541230,1233971,1420225542,3848188,485315688,1730,1036134,1180890050,1035284,1180787192,850,102858,1002452,15,1232597,121511,1727,799,144444.0,43333.0,-71.0,-69.0,-67.0,-73.0,-71.0,-69.0,-67.0,-72.0,-90.0,-93.0,-89.0,-93.0,19.0,24.0,22.0,20.0,1
2119,CC:2F:71:3E:C5:1F,3849190,485438158,1002,122470,3848188,485315688,2,4343,362560,3614,276008,729,86552,1061,13,1441,28,2,54,144444.0,39000.0,-72.0,-71.0,-68.0,-60.0,-71.0,-70.0,-67.0,-60.0,-90.0,-93.0,-89.0,-93.0,18.0,22.0,21.0,33.0,1
2120,BA:8C:B9:54:50:24,3853131,491511028,4943,6195340,3848188,485315688,7,9833,1757332,9811,1753837,22,3495,2361,18,5455,44,7,72,216660.0,130000.0,-51.0,-34.0,-43.0,-44.0,-43.0,-36.0,-44.0,-49.0,-90.0,-93.0,-89.0,-93.0,39.0,59.0,46.0,49.0,1
2121,62:47:05:9D:EB:15,3854949,497499558,6761,12183870,3848188,485315688,1,7035,3806913,6985,3799255,50,7658,3317,0,6834,56,1,125,216660.0,130000.0,-42.0,-45.0,-36.0,-47.0,-43.0,-45.0,-37.0,-47.0,-90.0,-93.0,-89.0,-93.0,48.0,48.0,53.0,46.0,1
2122,92:69:1D:31:68:E9,3852248,488970065,4060,3654377,3848188,485315688,1,5458,1162259,5284,1122701,174,39558,2208,12,4320,103,1,62,216660.0,130000.0,-52.0,-47.0,-44.0,-48.0,-51.0,-47.0,-43.0,-48.0,-90.0,-93.0,-89.0,-93.0,38.0,46.0,45.0,45.0,1
2123,CC:2F:71:3F:1F:24,5082352,1905782866,1234164,1420467178,3848188,485315688,1730,1036301,1181114684,1035451,1181011826,850,102858,1002618,15,1232790,121512,1727,799,144444.0,43333.0,-71.0,-69.0,-68.0,-73.0,-71.0,-69.0,-68.0,-72.0,-90.0,-93.0,-89.0,-93.0,19.0,24.0,21.0,20.0,1
2124,CC:2F:71:3E:C5:1F,3849192,485438360,1002,122470,3848190,485315890,2,4344,362630,3615,276078,729,86552,1061,13,1441,28,2,54,144444.0,39000.0,-72.0,-71.0,-68.0,-60.0,-71.0,-70.0,-67.0,-60.0,-90.0,-93.0,-89.0,-93.0,18.0,22.0,21.0,33.0,1
2125,BA:8C:B9:54:50:24,3853133,491511230,4943,6195340,3848190,485315890,7,9834,1757400,9812,1753905,22,3495,2361,18,5455,44,7,72,216660.0,130000.0,-40.0,-37.0,-45.0,-51.0,-40.0,-36.0,-45.0,-50.0,-90.0,-93.0,-89.0,-93.0,50.0,56.0,44.0,42.0,1
2126,62:47:05:9D:EB:15,3854958,497500426,6761,12183870,3848197,485316556,1,7036,3806981,6986,3799323,50,7658,3317,0,6834,56,1,125,216660.0,130000.0,-42.0,-45.0,-36.0,-47.0,-43.0,-45.0,-37.0,-47.0,-90.0,-93.0,-89.0,-93.0,48.0,48.0,53.0,46.0,1
2127,92:69:1D:31:68:E9,3852257,488970933,4060,3654377,3848197,485316556,1,5458,1162259,5284,1122701,174,39558,2208,12,4320,103,1,62,216660.0,130000.0,-52.0,-47.0,-44.0,-48.0,-51.0,-47.0,-43.0,-48.0,-90.0,-93.0,-89.0,-93.0,38.0,46.0,45.0,45.0,1
2128,CC:2F:71:3F:1F:24,5082556,1906025373,1234359,1420708817,3848197,485316556,1730,1036478,1181342379,1035628,1181239521,850,102858,1002795,15,1232985,121512,1727,799,144444.0,43333.0,-71.0,-69.0,-67.0,-72.0,-71.0,-69.0,-67.0,-71.0,-90.0,-93.0,-89.0,-93.0,19.0,24.0,22.0,21.0,1
2129,CC:2F:71:3E:C5:1F,3849200,485439086,1002,122470,3848198,485316616,2,4344,362630,3615,276078,729,86552,1061,13,1441,28,2,54,144444.0,39000.0,-72.0,-71.0,-68.0,-60.0,-71.0,-70.0,-67.0,-60.0,-90.0,-93.0,-89.0,-93.0,18.0,22.0,21.0,33.0,1
2130,BA:8C:B9:54:50:24,3853141,491511956,4943,6195340,3848198,485316616,7,9835,1757468,9813,1753973,22,3495,2361,18,5455,44,7,72,216660.0,130000.0,-39.0,-37.0,-45.0,-52.0,-40.0,-36.0,-45.0,-50.0,-90.0,-93.0,-89.0,-93.0,51.0,56.0,44.0,41.0,1
2131,62:47:05:9D:EB:15,3854960,497500572,6761,12183870,3848199,485316702,1,7036,3806981,6986,3799323,50,7658,3317,0,6834,56,1,125,216660.0,130000.0,-42.0,-45.0,-36.0,-47.0,-43.0,-45.0,-37.0,-47.0,-89.0,-92.0,-88.0,-92.0,47.0,47.0,52.0,45.0,1
2132,92:69:1D:31:68:E9,3852261,488971281,4060,3654377,3848201,485316904,1,5458,1162259,5284,1122701,174,39558,2208,12,4320,103,1,62,216660.0,130000.0,-52.0,-47.0,-44.0,-48.0,-51.0,-47.0,-43.0,-48.0,-89.0,-92.0,-88.0,-92.0,37.0,45.0,44.0,44.0,1
2133,CC:2F:71:3F:1F:24,5082750,1906267013,1234549,1420950109,3848201,485316904,1730,1036648,1181567553,1035796,1181464439,852,103114,1002964,15,1233174,121512,1727,802,144444.0,43333.0,-72.0,-68.0,-67.0,-73.0,-71.0,-68.0,-67.0,-73.0,-89.0,-92.0,-88.0,-92.0,17.0,24.0,21.0,19.0,1
2134,CC:2F:71:3E:C5:1F,3849204,485439440,1002,122470,3848202,485316970,2,4344,362630,3615,276078,729,86552,1061,13,1441,28,2,54,144444.0,39000.0,-72.0,-71.0,-68.0,-60.0,-71.0,-70.0,-67.0,-60.0,-89.0,-92.0,-88.0,-92.0,17.0,21.0,20.0,32.0,1
2135,BA:8C:B9:54:50:24,3853147,491512717,4943,6195340,3848204,485317377,7,9835,1757468,9813,1753973,22,3495,2361,18,5455,44,7,72,216660.0,130000.0,-39.0,-37.0,-45.0,-52.0,-40.0,-36.0,-45.0,-50.0,-89.0,-92.0,-88.0,-92.0,50.0,55.0,43.0,40.0,1
2136,62:47:05:9D:EB:15,3854971,497501853,6761,12183870,3848210,485317983,1,7036,3806981,6986,3799323,50,7658,3317,0,6834,56,1,125,216660.0,130000.0,-42.0,-45.0,-36.0,-47.0,-43.0,-45.0,-37.0,-47.0,-89.0,-92.0,-89.0,-92.0,47.0,47.0,53.0,45.0,1
2137,92:69:1D:31:68:E9,3852270,488972360,4060,3654377,3848210,485317983,1,5458,1162259,5284,1122701,174,39558,2208,12,4320,103,1,62,216660.0,130000.0,-52.0,-47.0,-44.0,-48.0,-51.0,-47.0,-43.0,-48.0,-89.0,-92.0,-89.0,-92.0,37.0,45.0,45.0,44.0,1
2138,CC:2F:71:3F:1F:24,5082952,1906509760,1234742,1421191777,3848210,485317983,1730,1036820,1181795671,1035966,1181692245,854,103426,1003136,15,1233368,121512,1727,802,144444.0,43333.0,-72.0,-69.0,-67.0,-73.0,-72.0,-68.0,-67.0,-73.0,-89.0,-92.0,-89.0,-92.0,17.0,23.0,22.0,19.0,1
2139,CC:2F:71:3E:C5:1F,3849212,485440453,1002,122470,3848210,485317983,2,4344,362630,3615,276078,729,86552,1061,13,1441,28,2,54,144444.0,39000.0,-72.0,-71.0,-68.0,-60.0,-71.0,-70.0,-67.0,-60.0,-89.0,-92.0,-89.0,-92.0,17.0,21.0,21.0,32.0,1
2140,BA:8C:B9:54:50:24,3853153,491513323,4943,6195340,3848210,485317983,7,9835,1757468,9813,1753973,22,3495,2361,18,5455,44,7,72,216660.0,130000.0,-39.0,-37.0,-45.0,-52.0,-40.0,-36.0,-45.0,-50.0,-89.0,-92.0,-89.0,-92.0,50.0,55.0,44.0,40.0,1
2141,62:47:05:9D:EB:15,3854974,497502115,6761,12183870,3848213,485318245,1,7036,3806981,6986,3799323,50,7658,3317,0,6834,56,1,125,216660.0,130000.0,-42.0,-45.0,-36.0,-47.0,-43.0,-45.0,-37.0,-47.0,-89.0,-92.0,-89.0,-92.0,47.0,47.0,53.0,45.0,1
2142,92:69:1D:31:68:E9,3852273,488972622,4060,3654377,3848213,485318245,1,5458,1162259,5284,1122701,174,39558,2208,12,4320,103,1,62,216660.0,130000.0,-52.0,-47.0,-44.0,-48.0,-51.0,-47.0,-43.0,-48.0,-89.0,-92.0,-89.0,-92.0,37.0,45.0,45.0,44.0,1
2143,CC:2F:71:3F:1F:24,5083147,1906751574,1234934,1421433329,3848213,485318245,1730,1036991,1182023603,1036137,1181920177,854,103426,1003307,15,1233560,121516,1727,802,144444.0,43333.0,-72.0,-69.0,-68.0,-73.0,-71.0,-68.0,-67.0,-73.0,-89.0,-92.0,-89.0,-92.0,17.0,23.0,21.0,19.0,1
2144,CC:2F:71:3E:C5:1F,3849215,485440715,1002,122470,3848213,485318245,2,4344,362630,3615,276078,729,86552,1061,13,1441,28,2,54,144444.0,39000.0,-72.0,-71.0,-68.0,-60.0,-71.0,-70.0,-67.0,-60.0,-89.0,-92.0,-89.0,-92.0,17.0,21.0,21.0,32.0,1
2145,BA:8C:B9:54:50:24,3853156,491513585,4943,6195340,3848213,485318245,7,9835,1757468,9813,1753973,22,3495,2361,18,5455,44,7,72,216660.0,130000.0,-39.0,-37.0,-45.0,-52.0,-40.0,-36.0,-45.0,-50.0,-89.0,-92.0,-89.0,-92.0,50.0,55.0,44.0,40.0,1
2146,62:47:05:9D:EB:15,3854980,497502721,6761,12183870,3848219,485318851,1,7036,3806981,6986,3799323,50,7658,3317,0,6834,56,1,125,216660.0,130000.0,-42.0,-45.0,-36.0,-47.0,-43.0,-45.0,-37.0,-47.0,-89.0,-92.0,-89.0,-92.0,47.0,47.0,53.0,45.0,1
2147,92:69:1D:31:68:E9,3852279,488973228,4060,3654377,3848219,485318851,1,5458,1162259,5284,1122701,174,39558,2208,12,4320,103,1,62,216660.0,130000.0,-52.0,-47.0,-44.0,-48.0,-51.0,-47.0,-43.0,-48.0,-89.0,-92.0,-89.0,-92.0,37.0,45.0,45.0,44.0,1
2148,CC:2F:71:3F:1F:24,5083351,1906997073,1235132,1421678222,3848219,485318851,1730,1037164,1182247987,1036310,1182144561,854,103426,1003480,15,1233756,121516,1727,802,144444.0,43333.0,-72.0,-69.0,-67.0,-73.0,-72.0,-68.0,-67.0,-73.0,-89.0,-92.0,-89.0,-92.0,17.0,23.0,22.0,19.0,1
2149,CC:2F:71:3E:C5:1F,3849222,485441383,1002,122470,3848220,485318913,2,4345,362748,3615,276078,730,86670,1062,13,1441,28,2,54,144444.0,39000.0,-71.0,-71.0,-68.0,-60.0,-71.0,-71.0,-68.0,-60.0,-89.0,-92.0,-89.0,-92.0,18.0,21.0,21.0,32.0,1
2150,BA:8C:B9:54:50:24,3853163,491514253,4943,6195340,3848220,485318913,7,9835,1757468,9813,1753973,22,3495,2361,18,5455,44,7,72,216660.0,130000.0,-39.0,-37.0,-45.0,-52.0,-40.0,-36.0,-45.0,-50.0,-89.0,-92.0,-89.0,-92.0,50.0,55.0,44.0,40.0,1
2151,62:47:05:9D:EB:15,3854984,497503045,6761,12183870,3848223,485319175,1,7036,3806981,6986,3799323,50,7658,3317,0,6834,56,1,125,216660.0,130000.0,-42.0,-45.0,-36.0,-47.0,-43.0,-45.0,-37.0,-47.0,-89.0,-92.0,-89.0,-92.0,47.0,47.0,53.0,45.0,1
2152,92:69:1D:31:68:E9,3852283,488973552,4060,3654377,3848223,485319175,1,5458,1162259,5284,1122701,174,39558,2208,12,4320,103,1,62,216660.0,130000.0,-52.0,-47.0,-44.0,-48.0,-51.0,-47.0,-43.0,-48.0,-89.0,-92.0,-89.0,-92.0,37.0,45.0,45.0,44.0,1
2153,CC:2F:71:3F:1F:24,5083547,1907239303,1235324,1421920128,3848223,485319175,1730,1037335,1182477377,1036481,1182373951,854,103426,1003651,15,1233950,121516,1727,802,144444.0,43333.0,-72.0,-69.0,-67.0,-73.0,-72.0,-69.0,-67.0,-73.0,-89.0,-92.0,-89.0,-92.0,17.0,23.0,22.0,19.0,1
2154,CC:2F:71:3E:C5:1F,3849225,485441645,1002,122470,3848223,485319175,2,4346,362818,3616,276148,730,86670,1062,13,1441,28,2,54,144444.0,39000.0,-71.0,-71.0,-68.0,-60.0,-71.0,-71.0,-68.0,-60.0,-89.0,-92.0,-89.0,-92.0,18.0,21.0,21.0,32.0,1
2155,BA:8C:B9:54:50:24,3853166,491514515,4943,6195340,3848223,485319175,7,9835,1757468,9813,1753973,22,3495,2361,18,5455,44,7,72,216660.0,130000.0,-39.0,-37.0,-45.0,-52.0,-40.0,-36.0,-45.0,-50.0,-89.0,-92.0,-89.0,-92.0,50.0,55.0,44.0,40.0,1
2156,62:47:05:9D:EB:15,3854990,497503651,6761,12183870,3848229,485319781,1,7036,3806981,6986,3799323,50,7658,3317,0,6834,56,1,125,216660.0,130000.0,-42.0,-45.0,-36.0,-47.0,-43.0,-45.0,-37.0,-47.0,-89.0,-92.0,-89.0,-92.0,47.0,47.0,53.0,45.0,1
2157,92:69:1D:31:68:E9,3852289,488974158,4060,3654377,3848229,485319781,1,5458,1162259,5284,1122701,174,39558,2208,12,4320,103,1,62,216660.0,130000.0,-52.0,-47.0,-44.0,-48.0,-51.0,-47.0,-43.0,-48.0,-89.0,-92.0,-89.0,-92.0,37.0,45.0,45.0,44.0,1
2158,CC:2F:71:3F:1F:24,5083744,1907481163,1235515,1422161382,3848229,485319781,1730,1037505,1182703825,1036651,1182600399,854,103426,1003820,15,1234141,121516,1727,802,144444.0,43333.0,-72.0,-69.0,-67.0,-73.0,-72.0,-68.0,-67.0,-73.0,-89.0,-92.0,-89.0,-92.0,17.0,23.0,22.0,19.0,1
2159,CC:2F:71:3E:C5:1F,3849231,485442251,1002,122470,3848229,485319781,2,4346,362818,3616,276148,730,86670,1062,13,1441,28,2,54,144444.0,39000.0,-71.0,-71.0,-68.0,-60.0,-71.0,-71.0,-68.0,-60.0,-89.0,-92.0,-89.0,-92.0,18.0,21.0,21.0,32.0,1
2160,BA:8C:B9:54:50:24,3853172,491515121,4943,6195340,3848229,485319781,7,9835,1757468,9813,1753973,22,3495,2361,18,5455,44,7,72,216660.0,130000.0,-39.0,-37.0,-45.0,-52.0,-40.0,-36.0,-45.0,-50.0,-89.0,-92.0,-89.0,-92.0,50.0,55.0,44.0,40.0,1
2161,62:47:05:9D:EB:15,3854992,497503853,6761,12183870,3848231,485319983,1,7036,3806981,6986,3799323,50,7658,3317,0,6834,56,1,125,216660.0,130000.0,-42.0,-45.0,-36.0,-47.0,-43.0,-45.0,-37.0,-47.0,-89.0,-92.0,-88.0,-92.0,47.0,47.0,52.0,45.0,1
2162,92:69:1D:31:68:E9,3852291,488974360,4060,3654377,3848231,485319983,1,5458,1162259,5284,1122701,174,39558,2208,12,4320,103,1,62,216660.0,130000.0,-52.0,-47.0,-44.0,-48.0,-51.0,-47.0,-43.0,-48.0,-89.0,-92.0,-88.0,-92.0,37.0,45.0,44.0,44.0,1
2163,CC:2F:71:3F:1F:24,5083936,1907720130,1235705,1422400147,3848231,485319983,1730,1037681,1182934450,1036827,1182831024,854,103426,1003991,15,1234331,121516,1727,802,144444.0,43333.0,-72.0,-69.0,-68.0,-74.0,-72.0,-69.0,-67.0,-73.0,-89.0,-92.0,-88.0,-92.0,17.0,23.0,20.0,18.0,1
2164,CC:2F:71:3E:C5:1F,3849233,485442453,1002,122470,3848231,485319983,2,4346,362818,3616,276148,730,86670,1062,13,1441,28,2,54,144444.0,39000.0,-71.0,-71.0,-68.0,-60.0,-71.0,-71.0,-68.0,-60.0,-89.0,-92.0,-88.0,-92.0,18.0,21.0,20.0,32.0,1
2165,BA:8C:B9:54:50:24,3853174,491515323,4943,6195340,3848231,485319983,7,9835,1757468,9813,1753973,22,3495,2361,18,5455,44,7,72,216660.0,130000.0,-39.0,-37.0,-45.0,-52.0,-40.0,-36.0,-45.0,-50.0,-89.0,-92.0,-88.0,-92.0,50.0,55.0,43.0,40.0,1
2166,62:47:05:9D:EB:15,3854999,497504519,6761,12183870,3848238,485320649,1,7036,3806981,6986,3799323,50,7658,3317,0,6834,56,1,125,216660.0,130000.0,-42.0,-45.0,-36.0,-47.0,-43.0,-45.0,-37.0,-47.0,-89.0,-92.0,-88.0,-92.0,47.0,47.0,52.0,45.0,1
2167,92:69:1D:31:68:E9,3852299,488975088,4060,3654377,3848239,485320711,1,5458,1162259,5284,1122701,174,39558,2208,12,4320,103,1,62,216660.0,130000.0,-52.0,-47.0,-44.0,-48.0,-51.0,-47.0,-43.0,-48.0,-89.0,-92.0,-88.0,-92.0,37.0,45.0,44.0,44.0,1
2168,CC:2F:71:3F:1F:24,5084138,1907967742,1235899,1422647031,3848239,485320711,1730,1037860,1183172108,1037005,1183068564,855,103544,1004165,15,1234525,121516,1727,802,144444.0,43333.0,-72.0,-69.0,-68.0,-73.0,-71.0,-69.0,-67.0,-72.0,-89.0,-92.0,-88.0,-92.0,17.0,23.0,20.0,19.0,1
2169,CC:2F:71:3E:C5:1F,3849241,485443181,1002,122470,3848239,485320711,2,4346,362818,3616,276148,730,86670,1062,13,1441,28,2,54,144444.0,39000.0,-71.0,-71.0,-68.0,-60.0,-71.0,-71.0,-68.0,-60.0,-89.0,-92.0,-88.0,-92.0,18.0,21.0,20.0,32.0,1
2170,BA:8C:B9:54:50:24,3853182,491516051,4943,6195340,3848239,485320711,7,9835,1757468,9813,1753973,22,3495,2361,18,5455,44,7,72,216660.0,130000.0,-39.0,-37.0,-45.0,-52.0,-40.0,-36.0,-45.0,-50.0,-89.0,-92.0,-88.0,-92.0,50.0,55.0,43.0,40.0,1
2171,62:47:05:9D:EB:15,3855002,497504783,6761,12183870,3848241,485320913,1,7036,3806981,6986,3799323,50,7658,3317,0,6834,56,1,125,216660.0,130000.0,-42.0,-45.0,-36.0,-47.0,-43.0,-45.0,-37.0,-47.0,-89.0,-92.0,-88.0,-92.0,47.0,47.0,52.0,45.0,1
2172,92:69:1D:31:68:E9,3852301,488975290,4060,3654377,3848241,485320913,1,5458,1162259,5284,1122701,174,39558,2208,12,4320,103,1,62,216660.0,130000.0,-52.0,-47.0,-44.0,-48.0,-51.0,-47.0,-43.0,-48.0,-89.0,-92.0,-88.0,-92.0,37.0,45.0,44.0,44.0,1
2173,CC:2F:71:3F:1F:24,5084330,1908209220,1236089,1422888307,3848241,485320913,1730,1038038,1183408160,1037183,1183304616,855,103544,1004335,15,1234715,121516,1727,803,144444.0,43333.0,-72.0,-68.0,-66.0,-72.0,-71.0,-68.0,-66.0,-71.0,-89.0,-92.0,-88.0,-92.0,17.0,24.0,22.0,20.0,1
2174,CC:2F:71:3E:C5:1F,3849243,485443383,1002,122470,3848241,485320913,2,4346,362818,3616,276148,730,86670,1062,13,1441,28,2,54,144444.0,39000.0,-71.0,-71.0,-68.0,-60.0,-71.0,-71.0,-68.0,-60.0,-89.0,-92.0,-88.0,-92.0,18.0,21.0,20.0,32.0,1
2175,BA:8C:B9:54:50:24,3853184,491516253,4943,6195340,3848241,485320913,7,9835,1757468,9813,1753973,22,3495,2361,18,5455,44,7,72,216660.0,130000.0,-39.0,-37.0,-45.0,-52.0,-40.0,-36.0,-45.0,-50.0,-89.0,-92.0,-88.0,-92.0,50.0,55.0,43.0,40.0,1
2176,62:47:05:9D:EB:15,3855009,497505449,6761,12183870,3848248,485321579,1,7036,3806981,6986,3799323,50,7658,3317,0,6834,56,1,125,216660.0,130000.0,-42.0,-45.0,-36.0,-47.0,-43.0,-45.0,-37.0,-47.0,-89.0,-91.0,-88.0,-91.0,47.0,46.0,52.0,44.0,1
2177,92:69:1D:31:68:E9,3852308,488975956,4060,3654377,3848248,485321579,1,5458,1162259,5284,1122701,174,39558,2208,12,4320,103,1,62,216660.0,130000.0,-52.0,-47.0,-44.0,-48.0,-51.0,-47.0,-43.0,-48.0,-89.0,-91.0,-88.0,-91.0,37.0,44.0,44.0,43.0,1
2178,CC:2F:71:3F:1F:24,5084525,1908448054,1236277,1423126475,3848248,485321579,1730,1038207,1183635930,1037352,1183532386,855,103544,1004501,15,1234903,121517,1727,803,144444.0,43333.0,-72.0,-68.0,-67.0,-72.0,-71.0,-68.0,-67.0,-71.0,-89.0,-91.0,-88.0,-91.0,17.0,23.0,21.0,19.0,1
2179,CC:2F:71:3E:C5:1F,3849250,485444049,1002,122470,3848248,485321579,2,4346,362818,3616,276148,730,86670,1062,13,1441,28,2,54,144444.0,39000.0,-71.0,-71.0,-68.0,-60.0,-71.0,-71.0,-68.0,-60.0,-89.0,-91.0,-88.0,-91.0,18.0,20.0,20.0,31.0,1
2180,BA:8C:B9:54:50:24,3853191,491516919,4943,6195340,3848248,485321579,7,9835,1757468,9813,1753973,22,3495,2361,18,5455,44,7,72,216660.0,130000.0,-39.0,-37.0,-45.0,-52.0,-40.0,-36.0,-45.0,-50.0,-89.0,-91.0,-88.0,-91.0,50.0,54.0,43.0,39.0,1
2181,62:47:05:9D:EB:15,3855011,497505651,6761,12183870,3848250,485321781,1,7036,3806981,6986,3799323,50,7658,3317,0,6834,56,1,125,216660.0,130000.0,-42.0,-45.0,-36.0,-47.0,-43.0,-45.0,-37.0,-47.0,-89.0,-91.0,-87.0,-90.0,47.0,46.0,51.0,43.0,1
2182,92:69:1D:31:68:E9,3852310,488976158,4060,3654377,3848250,485321781,1,5460,1162395,5286,1122837,174,39558,2208,12,4321,103,1,62,216660.0,130000.0,-51.0,-47.0,-42.0,-48.0,-51.0,-47.0,-43.0,-48.0,-89.0,-91.0,-87.0,-90.0,38.0,44.0,45.0,42.0,1
2183,CC:2F:71:3F:1F:24,5084728,1908696433,1236478,1423374652,3848250,485321781,1730,1038393,1183877629,1037538,1183774085,855,103544,1004680,15,1235104,121517,1727,803,144444.0,43333.0,-72.0,-68.0,-67.0,-72.0,-71.0,-68.0,-68.0,-71.0,-89.0,-91.0,-87.0,-90.0,17.0,23.0,20.0,18.0,1
2184,CC:2F:71:3E:C5:1F,3849252,485444251,1002,122470,3848250,485321781,2,4348,362958,3618,276288,730,86670,1062,14,1442,29,2,54,144444.0,39000.0,-71.0,-71.0,-68.0,-60.0,-71.0,-70.0,-67.0,-61.0,-89.0,-91.0,-87.0,-90.0,18.0,20.0,19.0,30.0,1
2185,BA:8C:B9:54:50:24,3853195,491517323,4943,6195340,3848252,485321983,7,9837,1757604,9815,1754109,22,3495,2361,18,5456,44,7,73,216660.0,130000.0,-48.0,-35.0,-42.0,-45.0,-43.0,-36.0,-44.0,-48.0,-89.0,-91.0,-87.0,-90.0,41.0,56.0,45.0,45.0,1
2186,62:47:05:9D:EB:15,3855017,497506257,6761,12183870,3848256,485322387,1,7038,3807117,6988,3799459,50,7658,3317,0,6835,56,1,125,216660.0,130000.0,-43.0,-45.0,-36.0,-48.0,-43.0,-45.0,-37.0,-47.0,-88.0,-90.0,-87.0,-89.0,45.0,45.0,51.0,41.0,1
2187,92:69:1D:31:68:E9,3852316,488976764,4060,3654377,3848256,485322387,1,5460,1162395,5286,1122837,174,39558,2208,12,4321,103,1,62,216660.0,130000.0,-51.0,-47.0,-42.0,-48.0,-51.0,-47.0,-43.0,-48.0,-88.0,-90.0,-87.0,-89.0,37.0,43.0,45.0,41.0,1
2188,CC:2F:71:3F:1F:24,5084923,1908938185,1236667,1423615798,3848256,485322387,1730,1038568,1184110633,1037713,1184007089,855,103544,1004849,15,1235293,121517,1727,803,144444.0,43333.0,-71.0,-69.0,-67.0,-71.0,-71.0,-68.0,-67.0,-71.0,-88.0,-90.0,-87.0,-89.0,17.0,21.0,20.0,18.0,1
2189,CC:2F:71:3E:C5:1F,3849258,485444857,1002,122470,3848256,485322387,2,4348,362958,3618,276288,730,86670,1062,14,1442,29,2,54,144444.0,39000.0,-71.0,-71.0,-68.0,-60.0,-71.0,-70.0,-67.0,-61.0,-88.0,-90.0,-87.0,-89.0,17.0,19.0,19.0,29.0,1
2190,BA:8C:B9:54:50:24,3853199,491517727,4943,6195340,3848256,485322387,7,9837,1757604,9815,1754109,22,3495,2361,18,5456,44,7,73,216660.0,130000.0,-48.0,-35.0,-42.0,-45.0,-43.0,-36.0,-44.0,-48.0,-88.0,-90.0,-87.0,-89.0,40.0,55.0,45.0,44.0,1
2191,62:47:05:9D:EB:15,3855020,497506519,6761,12183870,3848259,485322649,1,7038,3807117,6988,3799459,50,7658,3317,0,6835,56,1,125,216660.0,130000.0,-43.0,-45.0,-36.0,-48.0,-43.0,-45.0,-37.0,-47.0,-88.0,-90.0,-87.0,-89.0,45.0,45.0,51.0,41.0,1
2192,92:69:1D:31:68:E9,3852319,488977026,4060,3654377,3848259,485322649,1,5460,1162395,5286,1122837,174,39558,2208,12,4321,103,1,62,216660.0,130000.0,-51.0,-47.0,-42.0,-48.0,-51.0,-47.0,-43.0,-48.0,-88.0,-90.0,-87.0,-89.0,37.0,43.0,45.0,41.0,1
2193,CC:2F:71:3F:1F:24,5085118,1909182831,1236859,1423860182,3848259,485322649,1730,1038742,1184344651,1037887,1184241107,855,103544,1005020,15,1235485,121518,1727,803,144444.0,43333.0,-71.0,-69.0,-66.0,-70.0,-71.0,-68.0,-66.0,-70.0,-88.0,-90.0,-87.0,-89.0,17.0,21.0,21.0,19.0,1
2194,CC:2F:71:3E:C5:1F,3849267,485445725,1002,122470,3848265,485323255,2,4348,362958,3618,276288,730,86670,1062,14,1442,29,2,54,144444.0,39000.0,-71.0,-71.0,-68.0,-60.0,-71.0,-70.0,-67.0,-61.0,-88.0,-90.0,-87.0,-89.0,17.0,19.0,19.0,29.0,1
2195,BA:8C:B9:54:50:24,3853218,491519736,4943,6195340,3848275,485324396,7,9841,1757876,9819,1754381,22,3495,2361,18,5456,44,7,73,216660.0,130000.0,-40.0,-37.0,-46.0,-51.0,-44.0,-35.0,-43.0,-47.0,-88.0,-90.0,-87.0,-89.0,48.0,53.0,41.0,38.0,1
2196,62:47:05:9D:EB:15,3855047,497509336,6761,12183870,3848286,485325466,1,7041,3807321,6991,3799663,50,7658,3317,0,6835,56,1,125,216660.0,130000.0,-44.0,-45.0,-35.0,-46.0,-43.0,-45.0,-35.0,-47.0,-88.0,-90.0,-87.0,-89.0,44.0,45.0,52.0,43.0,1
2197,92:69:1D:31:68:E9,3852352,488980449,4060,3654377,3848292,485326072,1,5466,1162803,5292,1123245,174,39558,2208,12,4321,103,1,62,216660.0,130000.0,-52.0,-48.0,-45.0,-48.0,-51.0,-47.0,-43.0,-48.0,-88.0,-90.0,-87.0,-89.0,36.0,42.0,42.0,41.0,1
2198,CC:2F:71:3F:1F:24,5086284,1910862668,1237989,1425536334,3848295,485326334,1730,1039906,1186064009,1039051,1185960465,855,103544,1006135,15,1236614,121518,1727,803,144444.0,43333.0,-72.0,-69.0,-66.0,-70.0,-72.0,-68.0,-66.0,-70.0,-88.0,-90.0,-87.0,-89.0,16.0,21.0,21.0,19.0,1
2199,CC:2F:71:3E:C5:1F,3849303,485449410,1002,122470,3848301,485326940,2,4348,362958,3618,276288,730,86670,1062,14,1442,29,2,54,144444.0,39000.0,-71.0,-71.0,-68.0,-60.0,-71.0,-70.0,-67.0,-61.0,-88.0,-90.0,-87.0,-89.0,17.0,19.0,19.0,29.0,1
2200,BA:8C:B9:54:50:24,3853244,491522280,4943,6195340,3848301,485326940,7,9844,1758080,9822,1754585,22,3495,2361,18,5456,44,7,73,216660.0,130000.0,-40.0,-37.0,-45.0,-51.0,-46.0,-35.0,-42.0,-46.0,-88.0,-90.0,-87.0,-89.0,48.0,53.0,42.0,38.0,1
2201,62:47:05:9D:EB:15,3855065,497511072,6761,12183870,3848304,485327202,1,7043,3807457,6993,3799799,50,7658,3317,0,6835,56,1,125,216660.0,130000.0,-44.0,-45.0,-35.0,-46.0,-43.0,-45.0,-35.0,-46.0,-88.0,-90.0,-87.0,-89.0,44.0,45.0,52.0,43.0,1
2202,92:69:1D:31:68:E9,3852368,488981983,4060,3654377,3848308,485327606,1,5467,1162871,5293,1123313,174,39558,2208,12,4321,103,1,62,216660.0,130000.0,-51.0,-47.0,-42.0,-48.0,-51.0,-47.0,-43.0,-48.0,-88.0,-90.0,-87.0,-89.0,37.0,43.0,45.0,41.0,1
2203,CC:2F:71:3F:1F:24,5086702,1911434930,1238391,1426106996,3848311,485327934,1730,1040301,1186634477,1039446,1186530933,855,103544,1006519,15,1237015,121560,1727,803,144444.0,43333.0,-72.0,-69.0,-67.0,-70.0,-72.0,-69.0,-66.0,-70.0,-88.0,-90.0,-87.0,-89.0,16.0,21.0,20.0,19.0,1
2204,CC:2F:71:3E:C5:1F,3849313,485450404,1002,122470,3848311,485327934,2,4348,362958,3618,276288,730,86670,1062,14,1442,29,2,54,144444.0,39000.0,-71.0,-71.0,-68.0,-60.0,-71.0,-70.0,-67.0,-61.0,-88.0,-90.0,-87.0,-89.0,17.0,19.0,19.0,29.0,1
2205,BA:8C:B9:54:50:24,3853254,491523274,4943,6195340,3848311,485327934,7,9844,1758080,9822,1754585,22,3495,2361,18,5456,44,7,73,216660.0,130000.0,-40.0,-37.0,-45.0,-51.0,-46.0,-35.0,-42.0,-46.0,-88.0,-90.0,-87.0,-89.0,48.0,53.0,42.0,38.0,1
2206,62:47:05:9D:EB:15,3855076,497512184,6762,12183986,3848314,485328198,1,7045,3807593,6995,3799935,50,7658,3317,0,6836,56,1,126,216660.0,130000.0,-43.0,-45.0,-36.0,-47.0,-43.0,-45.0,-35.0,-46.0,-88.0,-90.0,-87.0,-89.0,45.0,45.0,51.0,42.0,1
2207,92:69:1D:31:68:E9,3852375,488982691,4061,3654493,3848314,485328198,1,5469,1163007,5295,1123449,174,39558,2208,12,4322,103,1,62,216660.0,130000.0,-52.0,-47.0,-45.0,-47.0,-51.0,-47.0,-43.0,-47.0,-88.0,-90.0,-87.0,-89.0,36.0,43.0,42.0,42.0,1
2208,CC:2F:71:3F:1F:24,5086962,1911771111,1238648,1426442913,3848314,485328198,1730,1040549,1186967718,1039694,1186864174,855,103544,1006754,15,1237270,121560,1727,804,144444.0,43333.0,-71.0,-68.0,-67.0,-71.0,-71.0,-68.0,-67.0,-71.0,-88.0,-90.0,-87.0,-89.0,17.0,22.0,20.0,18.0,1
2209,CC:2F:71:3E:C5:1F,3849317,485450784,1003,122586,3848314,485328198,2,4352,363286,3621,276498,731,86788,1063,14,1443,29,2,54,144444.0,39000.0,-70.0,-71.0,-67.0,-60.0,-70.0,-70.0,-67.0,-61.0,-88.0,-90.0,-87.0,-89.0,18.0,19.0,20.0,29.0,1
2210,BA:8C:B9:54:50:24,3853260,491523800,4944,6195400,3848316,485328400,7,9849,1758420,9827,1754925,22,3495,2361,18,5457,44,7,73,216660.0,130000.0,-48.0,-35.0,-42.0,-45.0,-44.0,-35.0,-41.0,-46.0,-88.0,-90.0,-87.0,-89.0,40.0,55.0,45.0,44.0,1
2211,62:47:05:9D:EB:15,3855133,497518035,6762,12183986,3848371,485334049,1,7052,3808069,7002,3800411,50,7658,3317,0,6836,56,1,126,216660.0,130000.0,-44.0,-45.0,-36.0,-47.0,-43.0,-45.0,-36.0,-46.0,-87.0,-88.0,-86.0,-88.0,43.0,43.0,50.0,41.0,1
2212,92:69:1D:31:68:E9,3852438,488989148,4061,3654493,3848377,485334655,1,5474,1163347,5300,1123789,174,39558,2208,12,4322,103,1,62,216660.0,130000.0,-51.0,-47.0,-42.0,-48.0,-51.0,-47.0,-42.0,-47.0,-87.0,-88.0,-86.0,-88.0,36.0,41.0,44.0,40.0,1
2213,CC:2F:71:3F:1F:24,5089068,1914854747,1240688,1429519830,3848380,485334917,2158,1042622,1190089014,1041766,1189985352,856,103662,1008767,15,1238849,121603,2155,806,144444.0,43333.0,-71.0,-69.0,-66.0,-71.0,-71.0,-68.0,-66.0,-70.0,-87.0,-88.0,-86.0,-88.0,16.0,19.0,20.0,17.0,1
2214,CC:2F:71:3E:C5:1F,3849392,485458584,1003,122586,3848389,485335998,2,4358,363706,3627,276918,731,86788,1063,14,1444,29,2,54,144444.0,39000.0,-70.0,-71.0,-68.0,-60.0,-70.0,-71.0,-67.0,-60.0,-87.0,-88.0,-86.0,-88.0,17.0,17.0,18.0,28.0,1
2215,BA:8C:B9:54:50:24,3853333,491531398,4944,6195400,3848389,485335998,7,9863,1759372,9841,1755877,22,3495,2361,18,5457,44,7,73,216660.0,130000.0,-48.0,-35.0,-42.0,-45.0,-46.0,-35.0,-43.0,-46.0,-87.0,-88.0,-86.0,-88.0,39.0,53.0,44.0,43.0,1
2216,62:47:05:9D:EB:15,3855160,497520852,6762,12183986,3848398,485336866,1,7057,3808409,7007,3800751,50,7658,3317,0,6836,56,1,126,216660.0,130000.0,-44.0,-45.0,-36.0,-47.0,-43.0,-45.0,-36.0,-46.0,-87.0,-88.0,-86.0,-88.0,43.0,43.0,50.0,41.0,1
2217,92:69:1D:31:68:E9,3852470,488992429,4061,3654493,3848409,485337936,1,5479,1163687,5305,1124129,174,39558,2208,12,4322,103,1,62,216660.0,130000.0,-52.0,-48.0,-42.0,-49.0,-51.0,-47.0,-42.0,-48.0,-87.0,-88.0,-86.0,-88.0,35.0,40.0,44.0,39.0,1
2218,CC:2F:71:3F:1F:24,5090426,1916829452,1242010,1431490850,3848416,485338602,2158,1043850,1191843604,1042994,1191739942,856,103662,1009960,15,1240188,121722,2155,806,144444.0,43333.0,-72.0,-69.0,-67.0,-72.0,-72.0,-69.0,-66.0,-71.0,-87.0,-88.0,-86.0,-88.0,15.0,19.0,19.0,16.0,1
2219,CC:2F:71:3E:C5:1F,3849421,485461390,1003,122586,3848418,485338804,2,4358,363706,3627,276918,731,86788,1063,14,1444,29,2,54,144444.0,39000.0,-70.0,-71.0,-68.0,-60.0,-70.0,-71.0,-67.0,-60.0,-87.0,-88.0,-86.0,-88.0,17.0,17.0,18.0,28.0,1
2220,BA:8C:B9:54:50:24,3853362,491534204,4944,6195400,3848418,485338804,7,9875,1760188,9853,1756693,22,3495,2361,18,5457,44,7,73,216660.0,130000.0,-40.0,-37.0,-46.0,-52.0,-45.0,-35.0,-43.0,-47.0,-87.0,-88.0,-86.0,-88.0,47.0,51.0,40.0,36.0,1
2221,62:47:05:9D:EB:15,3855186,497523396,6762,12183986,3848424,485339410,1,7061,3808681,7011,3801023,50,7658,3317,0,6836,56,1,126,216660.0,130000.0,-44.0,-45.0,-36.0,-47.0,-43.0,-45.0,-36.0,-47.0,-87.0,-88.0,-86.0,-88.0,43.0,43.0,50.0,41.0,1
2222,92:69:1D:31:68:E9,3852485,488993903,4061,3654493,3848424,485339410,1,5482,1163891,5308,1124333,174,39558,2208,12,4322,103,1,62,216660.0,130000.0,-52.0,-48.0,-43.0,-48.0,-52.0,-48.0,-42.0,-48.0,-87.0,-88.0,-86.0,-88.0,35.0,40.0,43.0,40.0,1
2223,CC:2F:71:3F:1F:24,5090960,1917507573,1242536,1432168163,3848424,485339410,2158,1044220,1192214787,1043364,1192111125,856,103662,1010326,15,1240733,121722,2155,807,144444.0,43333.0,-72.0,-69.0,-67.0,-71.0,-72.0,-69.0,-67.0,-71.0,-87.0,-88.0,-86.0,-88.0,15.0,19.0,19.0,17.0,1
2224,CC:2F:71:3E:C5:1F,3849427,485461996,1003,122586,3848424,485339410,2,4358,363706,3627,276918,731,86788,1063,14,1444,29,2,54,144444.0,39000.0,-70.0,-71.0,-68.0,-60.0,-70.0,-71.0,-67.0,-60.0,-87.0,-88.0,-86.0,-88.0,17.0,17.0,18.0,28.0,1
2225,BA:8C:B9:54:50:24,3853368,491534810,4944,6195400,3848424,485339410,7,9875,1760188,9853,1756693,22,3495,2361,18,5457,44,7,73,216660.0,130000.0,-40.0,-37.0,-46.0,-52.0,-45.0,-35.0,-43.0,-47.0,-87.0,-88.0,-86.0,-88.0,47.0,51.0,40.0,36.0,1
2226,62:47:05:9D:EB:15,3855193,497524062,6762,12183986,3848431,485340076,1,7061,3808681,7011,3801023,50,7658,3317,0,6836,56,1,126,216660.0,130000.0,-44.0,-45.0,-36.0,-47.0,-43.0,-45.0,-36.0,-47.0,-87.0,-88.0,-86.0,-88.0,43.0,43.0,50.0,41.0,1
2227,92:69:1D:31:68:E9,3852494,488994771,4061,3654493,3848433,485340278,1,5482,1163891,5308,1124333,174,39558,2208,12,4322,103,1,62,216660.0,130000.0,-52.0,-48.0,-43.0,-48.0,-52.0,-48.0,-42.0,-48.0,-87.0,-88.0,-86.0,-88.0,35.0,40.0,43.0,40.0,1
2228,CC:2F:71:3F:1F:24,5091289,1917944665,1242856,1432604387,3848433,485340278,2158,1044578,1192728495,1043722,1192624833,856,103662,1010664,15,1240992,121722,2155,807,144444.0,43333.0,-72.0,-69.0,-67.0,-72.0,-72.0,-69.0,-66.0,-72.0,-87.0,-88.0,-86.0,-88.0,15.0,19.0,19.0,16.0,1
2229,CC:2F:71:3E:C5:1F,3849456,485464989,1004,122702,3848452,485342287,2,4383,365456,3652,278668,731,86788,1063,14,1444,29,2,54,144444.0,39000.0,-70.0,-71.0,-68.0,-60.0,-70.0,-70.0,-67.0,-60.0,-87.0,-88.0,-86.0,-88.0,17.0,17.0,18.0,28.0,1
2230,BA:8C:B9:54:50:24,3853406,491538671,4945,6195516,3848461,485343155,7,9893,1761412,9871,1757917,22,3495,2361,18,5457,44,7,74,216660.0,130000.0,-40.0,-37.0,-46.0,-52.0,-45.0,-35.0,-43.0,-47.0,-87.0,-88.0,-86.0,-88.0,47.0,51.0,40.0,36.0,1
2231,62:47:05:9D:EB:15,3855233,497528127,6763,12184102,3848470,485344025,1,7067,3809089,7017,3801431,50,7658,3317,0,6837,56,1,126,216660.0,130000.0,-43.0,-45.0,-36.0,-46.0,-43.0,-45.0,-36.0,-46.0,-87.0,-88.0,-86.0,-88.0,44.0,43.0,50.0,42.0,1
2232,92:69:1D:31:68:E9,3852541,488999502,4062,3654609,3848479,485344893,1,5502,1165251,5328,1125693,174,39558,2208,12,4323,103,1,65,216660.0,130000.0,-52.0,-48.0,-43.0,-49.0,-52.0,-47.0,-43.0,-48.0,-87.0,-88.0,-86.0,-88.0,35.0,40.0,43.0,39.0,1
2233,CC:2F:71:3F:1F:24,5093054,1920511907,1244575,1435167014,3848479,485344893,2222,1046165,1195020773,1045308,1194916993,857,103780,1012206,15,1242708,121767,2219,807,144444.0,43333.0,-72.0,-69.0,-67.0,-71.0,-72.0,-68.0,-66.0,-71.0,-87.0,-88.0,-86.0,-88.0,15.0,19.0,19.0,17.0,1
2234,CC:2F:71:3E:C5:1F,3849492,485468463,1004,122702,3848488,485345761,3,4400,366646,3669,279858,731,86788,1063,14,1445,29,3,54,144444.0,39000.0,-71.0,-70.0,-68.0,-60.0,-70.0,-70.0,-67.0,-60.0,-87.0,-88.0,-86.0,-88.0,16.0,18.0,18.0,28.0,1
2235,BA:8C:B9:54:50:24,3853433,491541277,4945,6195516,3848488,485345761,7,9899,1761820,9877,1758325,22,3495,2361,18,5458,44,7,74,216660.0,130000.0,-40.0,-37.0,-46.0,-52.0,-46.0,-35.0,-43.0,-46.0,-87.0,-88.0,-86.0,-88.0,47.0,51.0,40.0,36.0,1
2236,62:47:05:9D:EB:15,3855289,497542360,6763,12184102,3848526,485358258,1,7073,3809497,7023,3801839,50,7658,3317,0,6837,56,1,126,216660.0,130000.0,-44.0,-45.0,-36.0,-47.0,-43.0,-45.0,-36.0,-46.0,-87.0,-88.0,-85.0,-87.0,43.0,43.0,49.0,40.0,1
2237,92:69:1D:31:68:E9,3852588,489012867,4062,3654609,3848526,485358258,1,5507,1165758,5332,1125965,175,39793,2209,12,4323,103,1,65,216660.0,130000.0,-53.0,-48.0,-42.0,-49.0,-52.0,-48.0,-43.0,-48.0,-87.0,-88.0,-85.0,-87.0,34.0,40.0,43.0,38.0,1
2238,CC:2F:71:3F:1F:24,5093797,1921540629,1245271,1436182371,3848526,485358258,2222,1046863,1196041647,1046006,1195937867,857,103780,1012884,15,1243406,121830,2219,807,144444.0,43333.0,-73.0,-70.0,-67.0,-72.0,-73.0,-69.0,-66.0,-71.0,-87.0,-88.0,-85.0,-87.0,14.0,18.0,18.0,15.0,1
2239,CC:2F:71:3E:C5:1F,3849530,485480960,1004,122702,3848526,485358258,3,4400,366646,3669,279858,731,86788,1063,14,1445,29,3,54,144444.0,39000.0,-71.0,-70.0,-68.0,-60.0,-70.0,-70.0,-67.0,-60.0,-87.0,-88.0,-85.0,-87.0,16.0,18.0,17.0,27.0,1
2240,BA:8C:B9:54:50:24,3853471,491553774,4945,6195516,3848526,485358258,7,9906,1762296,9884,1758801,22,3495,2361,18,5458,44,7,74,216660.0,130000.0,-40.0,-37.0,-46.0,-52.0,-43.0,-36.0,-44.0,-49.0,-87.0,-88.0,-85.0,-87.0,47.0,51.0,39.0,35.0,1
2241,62:47:05:9D:EB:15,3855292,497542835,6763,12184102,3848529,485358733,1,7073,3809497,7023,3801839,50,7658,3317,0,6837,56,1,126,216660.0,130000.0,-44.0,-45.0,-36.0,-47.0,-43.0,-45.0,-36.0,-46.0,-87.0,-88.0,-85.0,-87.0,43.0,43.0,49.0,40.0,1
2242,92:69:1D:31:68:E9,3852591,489013342,4062,3654609,3848529,485358733,1,5507,1165758,5332,1125965,175,39793,2209,12,4323,103,1,65,216660.0,130000.0,-53.0,-48.0,-42.0,-49.0,-52.0,-48.0,-43.0,-48.0,-87.0,-88.0,-85.0,-87.0,34.0,40.0,43.0,38.0,1
2243,CC:2F:71:3F:1F:24,5094010,1921793537,1245481,1436434804,3848529,485358733,2222,1047063,1196284140,1046206,1196180360,857,103780,1013079,15,1243616,121833,2219,807,144444.0,43333.0,-73.0,-69.0,-67.0,-72.0,-72.0,-69.0,-67.0,-71.0,-87.0,-88.0,-85.0,-87.0,14.0,19.0,18.0,15.0,1
2244,CC:2F:71:3E:C5:1F,3849533,485481435,1004,122702,3848529,485358733,3,4400,366646,3669,279858,731,86788,1063,14,1445,29,3,54,144444.0,39000.0,-71.0,-70.0,-68.0,-60.0,-70.0,-70.0,-67.0,-60.0,-87.0,-88.0,-85.0,-87.0,16.0,18.0,17.0,27.0,1
2245,BA:8C:B9:54:50:24,3853474,491554249,4945,6195516,3848529,485358733,7,9906,1762296,9884,1758801,22,3495,2361,18,5458,44,7,74,216660.0,130000.0,-40.0,-37.0,-46.0,-52.0,-43.0,-36.0,-44.0,-49.0,-87.0,-88.0,-85.0,-87.0,47.0,51.0,39.0,35.0,1
2246,62:47:05:9D:EB:15,3855299,497543501,6763,12184102,3848536,485359399,1,7073,3809497,7023,3801839,50,7658,3317,0,6837,56,1,126,216660.0,130000.0,-44.0,-45.0,-36.0,-47.0,-43.0,-45.0,-36.0,-46.0,-87.0,-88.0,-85.0,-87.0,43.0,43.0,49.0,40.0,1
2247,92:69:1D:31:68:E9,3852598,489014008,4062,3654609,3848536,485359399,1,5507,1165758,5332,1125965,175,39793,2209,12,4323,103,1,65,216660.0,130000.0,-53.0,-48.0,-42.0,-49.0,-52.0,-48.0,-43.0,-48.0,-87.0,-88.0,-85.0,-87.0,34.0,40.0,43.0,38.0,1
2248,CC:2F:71:3F:1F:24,5094210,1922038717,1245674,1436679318,3848536,485359399,2222,1047238,1196514268,1046381,1196410488,857,103780,1013250,15,1243809,121836,2219,807,144444.0,43333.0,-72.0,-69.0,-68.0,-71.0,-71.0,-68.0,-67.0,-71.0,-87.0,-88.0,-85.0,-87.0,15.0,19.0,17.0,16.0,1
2249,CC:2F:71:3E:C5:1F,3849540,485482101,1004,122702,3848536,485359399,3,4400,366646,3669,279858,731,86788,1063,14,1445,29,3,54,144444.0,39000.0,-71.0,-70.0,-68.0,-60.0,-70.0,-70.0,-67.0,-60.0,-87.0,-88.0,-85.0,-87.0,16.0,18.0,17.0,27.0,1
2250,BA:8C:B9:54:50:24,3853481,491554915,4945,6195516,3848536,485359399,7,9906,1762296,9884,1758801,22,3495,2361,18,5458,44,7,74,216660.0,130000.0,-40.0,-37.0,-46.0,-52.0,-43.0,-36.0,-44.0,-49.0,-87.0,-88.0,-85.0,-87.0,47.0,51.0,39.0,35.0,1
2251,62:47:05:9D:EB:15,3855305,497544273,6763,12184102,3848542,485360171,1,7073,3809497,7023,3801839,50,7658,3317,0,6837,56,1,126,216660.0,130000.0,-44.0,-45.0,-36.0,-47.0,-43.0,-45.0,-36.0,-46.0,-87.0,-88.0,-85.0,-87.0,43.0,43.0,49.0,40.0,1
2252,92:69:1D:31:68:E9,3852611,489015446,4062,3654609,3848549,485360837,1,5507,1165758,5332,1125965,175,39793,2209,12,4323,103,1,65,216660.0,130000.0,-53.0,-48.0,-42.0,-49.0,-52.0,-48.0,-43.0,-48.0,-87.0,-88.0,-85.0,-87.0,34.0,40.0,43.0,38.0,1
2253,CC:2F:71:3F:1F:24,5094673,1922679568,1246124,1437318731,3848549,485360837,2222,1047699,1197174291,1046842,1197070511,857,103780,1013685,15,1244251,121836,2219,807,144444.0,43333.0,-72.0,-69.0,-67.0,-72.0,-72.0,-69.0,-67.0,-71.0,-87.0,-88.0,-85.0,-87.0,15.0,19.0,18.0,15.0,1
2254,CC:2F:71:3E:C5:1F,3849555,485483741,1004,122702,3848551,485361039,3,4400,366646,3669,279858,731,86788,1063,14,1445,29,3,54,144444.0,39000.0,-71.0,-70.0,-68.0,-60.0,-70.0,-70.0,-67.0,-60.0,-87.0,-88.0,-85.0,-87.0,16.0,18.0,17.0,27.0,1
2255,BA:8C:B9:54:50:24,3853500,491556959,4945,6195516,3848555,485361443,7,9911,1762636,9889,1759141,22,3495,2361,18,5458,44,7,74,216660.0,130000.0,-49.0,-35.0,-43.0,-43.0,-44.0,-36.0,-44.0,-48.0,-87.0,-88.0,-85.0,-87.0,38.0,53.0,42.0,44.0,1
2256,62:47:05:9D:EB:15,3855320,497545747,6763,12184102,3848557,485361645,1,7076,3809701,7026,3802043,50,7658,3317,0,6837,56,1,126,216660.0,130000.0,-44.0,-44.0,-35.0,-47.0,-43.0,-45.0,-37.0,-46.0,-87.0,-88.0,-85.0,-87.0,43.0,44.0,50.0,40.0,1
2257,92:69:1D:31:68:E9,3852620,489016314,4062,3654609,3848558,485361705,1,5507,1165758,5332,1125965,175,39793,2209,12,4323,103,1,65,216660.0,130000.0,-53.0,-48.0,-42.0,-49.0,-52.0,-48.0,-43.0,-48.0,-87.0,-88.0,-85.0,-87.0,34.0,40.0,43.0,38.0,1
2258,CC:2F:71:3F:1F:24,5095034,1923173460,1246476,1437811755,3848558,485361705,2222,1048050,1197671311,1047193,1197567531,857,103780,1014019,15,1244599,121836,2219,809,144444.0,43333.0,-71.0,-69.0,-68.0,-72.0,-71.0,-69.0,-68.0,-72.0,-87.0,-88.0,-85.0,-87.0,16.0,19.0,17.0,15.0,1
2259,CC:2F:71:3E:C5:1F,3849562,485484407,1004,122702,3848558,485361705,3,4400,366646,3669,279858,731,86788,1063,14,1445,29,3,54,144444.0,39000.0,-71.0,-70.0,-68.0,-60.0,-70.0,-70.0,-67.0,-60.0,-87.0,-88.0,-85.0,-87.0,16.0,18.0,17.0,27.0,1
2260,BA:8C:B9:54:50:24,3853505,491557423,4945,6195516,3848560,485361907,7,9911,1762636,9889,1759141,22,3495,2361,18,5458,44,7,74,216660.0,130000.0,-49.0,-35.0,-43.0,-43.0,-44.0,-36.0,-44.0,-48.0,-87.0,-88.0,-85.0,-87.0,38.0,53.0,42.0,44.0,1
2261,62:47:05:9D:EB:15,3855329,497546615,6763,12184102,3848566,485362513,1,7077,3809769,7027,3802111,50,7658,3317,0,6837,56,1,126,216660.0,130000.0,-44.0,-45.0,-36.0,-48.0,-44.0,-45.0,-37.0,-46.0,-87.0,-88.0,-85.0,-87.0,43.0,43.0,49.0,39.0,1
2262,92:69:1D:31:68:E9,3852628,489017122,4062,3654609,3848566,485362513,1,5507,1165758,5332,1125965,175,39793,2209,12,4323,103,1,65,216660.0,130000.0,-53.0,-48.0,-42.0,-49.0,-52.0,-48.0,-43.0,-48.0,-87.0,-88.0,-85.0,-87.0,34.0,40.0,43.0,38.0,1
2263,CC:2F:71:3F:1F:24,5095398,1923666079,1246831,1438303506,3848567,485362573,2222,1048407,1198174036,1047550,1198070256,857,103780,1014354,15,1244963,121836,2219,809,144444.0,43333.0,-72.0,-69.0,-67.0,-72.0,-71.0,-69.0,-67.0,-71.0,-87.0,-88.0,-85.0,-87.0,15.0,19.0,18.0,15.0,1
2264,CC:2F:71:3E:C5:1F,3849573,485485477,1004,122702,3848569,485362775,3,4400,366646,3669,279858,731,86788,1063,14,1445,29,3,54,144444.0,39000.0,-71.0,-70.0,-68.0,-60.0,-70.0,-70.0,-67.0,-60.0,-87.0,-88.0,-85.0,-87.0,16.0,18.0,17.0,27.0,1
2265,BA:8C:B9:54:50:24,3853518,491558695,4945,6195516,3848573,485363179,7,9911,1762636,9889,1759141,22,3495,2361,18,5458,44,7,74,216660.0,130000.0,-49.0,-35.0,-43.0,-43.0,-44.0,-36.0,-44.0,-48.0,-87.0,-88.0,-85.0,-87.0,38.0,53.0,42.0,44.0,1
2266,62:47:05:9D:EB:15,3855338,497547483,6763,12184102,3848575,485363381,1,7077,3809769,7027,3802111,50,7658,3317,0,6837,56,1,126,216660.0,130000.0,-44.0,-45.0,-36.0,-48.0,-44.0,-45.0,-37.0,-46.0,-87.0,-88.0,-85.0,-87.0,43.0,43.0,49.0,39.0,1
2267,92:69:1D:31:68:E9,3852638,489018106,4063,3654725,3848575,485363381,1,5509,1165894,5334,1126101,175,39793,2209,12,4324,103,1,65,216660.0,130000.0,-52.0,-47.0,-43.0,-48.0,-52.0,-48.0,-43.0,-48.0,-87.0,-88.0,-85.0,-87.0,35.0,41.0,42.0,39.0,1
2268,CC:2F:71:3F:1F:24,5095659,1924006003,1247084,1438642622,3848575,485363381,2222,1048654,1198519280,1047797,1198415500,857,103780,1014585,15,1245215,121836,2219,809,144444.0,43333.0,-72.0,-69.0,-68.0,-73.0,-71.0,-69.0,-67.0,-72.0,-87.0,-88.0,-85.0,-87.0,15.0,19.0,17.0,14.0,1
2269,CC:2F:71:3E:C5:1F,3849580,485486199,1005,122818,3848575,485363381,3,4402,366786,3671,279998,731,86788,1063,14,1446,29,3,54,144444.0,39000.0,-70.0,-71.0,-68.0,-60.0,-70.0,-70.0,-67.0,-60.0,-87.0,-88.0,-85.0,-87.0,17.0,17.0,17.0,27.0,1
2270,BA:8C:B9:54:50:24,3853522,491559075,4946,6195632,3848576,485363443,7,9913,1762772,9891,1759277,22,3495,2361,18,5459,44,7,74,216660.0,130000.0,-49.0,-36.0,-43.0,-45.0,-45.0,-36.0,-44.0,-47.0,-87.0,-88.0,-85.0,-87.0,38.0,52.0,42.0,42.0,1
2271,62:47:05:9D:EB:15,3855347,497548327,6764,12184218,3848583,485364109,1,7079,3809905,7029,3802247,50,7658,3317,0,6838,56,1,126,216660.0,130000.0,-44.0,-45.0,-36.0,-48.0,-44.0,-45.0,-37.0,-47.0,-87.0,-88.0,-85.0,-87.0,43.0,43.0,49.0,39.0,1
2272,92:69:1D:31:68:E9,3852648,489019036,4063,3654725,3848585,485364311,1,5509,1165894,5334,1126101,175,39793,2209,12,4324,103,1,65,216660.0,130000.0,-52.0,-47.0,-43.0,-48.0,-52.0,-48.0,-43.0,-48.0,-87.0,-88.0,-85.0,-87.0,35.0,41.0,42.0,39.0,1
2273,CC:2F:71:3F:1F:24,5095914,1924332303,1247329,1438967992,3848585,485364311,2222,1048893,1198852314,1048035,1198748416,858,103898,1014808,15,1245464,121836,2219,809,144444.0,43333.0,-72.0,-70.0,-68.0,-72.0,-71.0,-69.0,-67.0,-72.0,-87.0,-88.0,-85.0,-87.0,15.0,18.0,17.0,15.0,1
2274,CC:2F:71:3E:C5:1F,3849590,485487129,1005,122818,3848585,485364311,3,4402,366786,3671,279998,731,86788,1063,14,1446,29,3,54,144444.0,39000.0,-70.0,-71.0,-68.0,-60.0,-70.0,-70.0,-67.0,-60.0,-87.0,-88.0,-85.0,-87.0,17.0,17.0,17.0,27.0,1
2275,BA:8C:B9:54:50:24,3853531,491559943,4946,6195632,3848585,485364311,7,9914,1762840,9892,1759345,22,3495,2361,18,5459,44,7,74,216660.0,130000.0,-49.0,-35.0,-43.0,-45.0,-46.0,-35.0,-43.0,-46.0,-87.0,-88.0,-85.0,-87.0,38.0,53.0,42.0,42.0,1
2276,62:47:05:9D:EB:15,3855349,497548529,6764,12184218,3848585,485364311,1,7079,3809905,7029,3802247,50,7658,3317,0,6838,56,1,126,216660.0,130000.0,-44.0,-45.0,-36.0,-48.0,-44.0,-45.0,-37.0,-47.0,-87.0,-88.0,-85.0,-87.0,43.0,43.0,49.0,39.0,1
2277,92:69:1D:31:68:E9,3852653,489019713,4063,3654725,3848590,485364988,1,5509,1165894,5334,1126101,175,39793,2209,12,4324,103,1,65,216660.0,130000.0,-52.0,-47.0,-43.0,-48.0,-52.0,-48.0,-43.0,-48.0,-87.0,-88.0,-85.0,-87.0,35.0,41.0,42.0,39.0,1
2278,CC:2F:71:3F:1F:24,5096161,1924649081,1247571,1439284093,3848590,485364988,2222,1049123,1199163276,1048265,1199059378,858,103898,1015029,15,1245704,121836,2219,809,144444.0,43333.0,-71.0,-68.0,-66.0,-72.0,-70.0,-68.0,-66.0,-71.0,-87.0,-88.0,-85.0,-87.0,16.0,20.0,19.0,15.0,1
2279,CC:2F:71:3E:C5:1F,3849595,485487806,1005,122818,3848590,485364988,3,4402,366786,3671,279998,731,86788,1063,14,1446,29,3,54,144444.0,39000.0,-70.0,-71.0,-68.0,-60.0,-70.0,-70.0,-67.0,-60.0,-87.0,-88.0,-85.0,-87.0,17.0,17.0,17.0,27.0,1
2280,BA:8C:B9:54:50:24,3853538,491560822,4946,6195632,3848592,485365190,7,9914,1762840,9892,1759345,22,3495,2361,18,5459,44,7,74,216660.0,130000.0,-49.0,-35.0,-43.0,-45.0,-46.0,-35.0,-43.0,-46.0,-87.0,-88.0,-85.0,-87.0,38.0,53.0,42.0,42.0,1
2281,62:47:05:9D:EB:15,3855359,497549670,6764,12184218,3848595,485365452,1,7079,3809905,7029,3802247,50,7658,3317,0,6838,56,1,126,216660.0,130000.0,-44.0,-45.0,-36.0,-48.0,-44.0,-45.0,-37.0,-47.0,-87.0,-88.0,-85.0,-87.0,43.0,43.0,49.0,39.0,1
2282,92:69:1D:31:68:E9,3852658,489020177,4063,3654725,3848595,485365452,1,5509,1165894,5334,1126101,175,39793,2209,12,4324,103,1,65,216660.0,130000.0,-52.0,-47.0,-43.0,-48.0,-52.0,-48.0,-43.0,-48.0,-87.0,-88.0,-85.0,-87.0,35.0,41.0,42.0,39.0,1
2283,CC:2F:71:3F:1F:24,5096370,1924912577,1247775,1439547125,3848595,485365452,2222,1049311,1199416130,1048453,1199312232,858,103898,1015212,15,1245910,121836,2219,809,144444.0,43333.0,-71.0,-69.0,-67.0,-72.0,-70.0,-68.0,-66.0,-71.0,-87.0,-88.0,-85.0,-87.0,16.0,19.0,18.0,15.0,1
2284,CC:2F:71:3E:C5:1F,3849600,485488270,1005,122818,3848595,485365452,3,4402,366786,3671,279998,731,86788,1063,14,1446,29,3,54,144444.0,39000.0,-70.0,-71.0,-68.0,-60.0,-70.0,-70.0,-67.0,-60.0,-87.0,-88.0,-85.0,-87.0,17.0,17.0,17.0,27.0,1
2285,BA:8C:B9:54:50:24,3853541,491561084,4946,6195632,3848595,485365452,7,9914,1762840,9892,1759345,22,3495,2361,18,5459,44,7,74,216660.0,130000.0,-49.0,-35.0,-43.0,-45.0,-46.0,-35.0,-43.0,-46.0,-87.0,-88.0,-85.0,-87.0,38.0,53.0,42.0,42.0,1
2286,62:47:05:9D:EB:15,3855364,497550136,6764,12184218,3848600,485365918,1,7079,3809905,7029,3802247,50,7658,3317,0,6838,56,1,126,216660.0,130000.0,-44.0,-45.0,-36.0,-48.0,-44.0,-45.0,-37.0,-47.0,-87.0,-88.0,-85.0,-87.0,43.0,43.0,49.0,39.0,1
2287,92:69:1D:31:68:E9,3852663,489020643,4063,3654725,3848600,485365918,1,5509,1165894,5334,1126101,175,39793,2209,12,4324,103,1,65,216660.0,130000.0,-52.0,-47.0,-43.0,-48.0,-52.0,-48.0,-43.0,-48.0,-87.0,-88.0,-85.0,-87.0,35.0,41.0,42.0,39.0,1
2288,CC:2F:71:3F:1F:24,5096568,1925154483,1247966,1439788363,3848602,485366120,2222,1049481,1199644050,1048623,1199540152,858,103898,1015380,15,1246101,121838,2219,810,144444.0,43333.0,-71.0,-68.0,-67.0,-71.0,-70.0,-68.0,-66.0,-71.0,-87.0,-88.0,-85.0,-87.0,16.0,20.0,18.0,16.0,1
2289,CC:2F:71:3E:C5:1F,3849607,485488938,1005,122818,3848602,485366120,3,4404,366974,3672,280068,732,86906,1064,14,1446,29,3,54,144444.0,39000.0,-70.0,-71.0,-68.0,-60.0,-70.0,-70.0,-68.0,-60.0,-87.0,-88.0,-85.0,-87.0,17.0,17.0,17.0,27.0,1
2290,BA:8C:B9:54:50:24,3853548,491561752,4946,6195632,3848602,485366120,7,9914,1762840,9892,1759345,22,3495,2361,18,5459,44,7,74,216660.0,130000.0,-49.0,-35.0,-43.0,-45.0,-46.0,-35.0,-43.0,-46.0,-87.0,-88.0,-85.0,-87.0,38.0,53.0,42.0,42.0,1
2291,62:47:05:9D:EB:15,3855368,497550540,6764,12184218,3848604,485366322,1,7079,3809905,7029,3802247,50,7658,3317,0,6838,56,1,126,216660.0,130000.0,-44.0,-45.0,-36.0,-48.0,-44.0,-45.0,-37.0,-47.0,-86.0,-87.0,-85.0,-86.0,42.0,42.0,49.0,38.0,1
2292,92:69:1D:31:68:E9,3852667,489021047,4063,3654725,3848604,485366322,1,5509,1165894,5334,1126101,175,39793,2209,12,4324,103,1,65,216660.0,130000.0,-52.0,-47.0,-43.0,-48.0,-52.0,-48.0,-43.0,-48.0,-86.0,-87.0,-85.0,-86.0,34.0,40.0,42.0,38.0,1
2293,CC:2F:71:3F:1F:24,5096763,1925399171,1248159,1440032849,3848604,485366322,2222,1049657,1199876904,1048799,1199773006,858,103898,1015553,15,1246294,121838,2219,810,144444.0,43333.0,-71.0,-68.0,-66.0,-72.0,-70.0,-68.0,-66.0,-71.0,-86.0,-87.0,-85.0,-86.0,15.0,19.0,19.0,14.0,1
2294,CC:2F:71:3E:C5:1F,3849609,485489140,1005,122818,3848604,485366322,3,4404,366974,3672,280068,732,86906,1064,14,1446,29,3,54,144444.0,39000.0,-70.0,-71.0,-68.0,-60.0,-70.0,-70.0,-68.0,-60.0,-86.0,-87.0,-85.0,-86.0,16.0,16.0,17.0,26.0,1
2295,BA:8C:B9:54:50:24,3853550,491561954,4946,6195632,3848604,485366322,7,9914,1762840,9892,1759345,22,3495,2361,18,5459,44,7,74,216660.0,130000.0,-49.0,-35.0,-43.0,-45.0,-46.0,-35.0,-43.0,-46.0,-86.0,-87.0,-85.0,-86.0,37.0,52.0,42.0,41.0,1
2296,62:47:05:9D:EB:15,3855373,497551004,6764,12184218,3848609,485366786,1,7079,3809905,7029,3802247,50,7658,3317,0,6838,56,1,126,216660.0,130000.0,-44.0,-45.0,-36.0,-48.0,-44.0,-45.0,-37.0,-47.0,-86.0,-87.0,-85.0,-86.0,42.0,42.0,49.0,38.0,1
2297,92:69:1D:31:68:E9,3852674,489021713,4063,3654725,3848611,485366988,1,5509,1165894,5334,1126101,175,39793,2209,12,4324,103,1,65,216660.0,130000.0,-52.0,-47.0,-43.0,-48.0,-52.0,-48.0,-43.0,-48.0,-86.0,-87.0,-85.0,-86.0,34.0,40.0,42.0,38.0,1
2298,CC:2F:71:3F:1F:24,5096968,1925647562,1248357,1440280574,3848611,485366988,2222,1049840,1200112579,1048982,1200008681,858,103898,1015730,15,1246492,121838,2219,810,144444.0,43333.0,-72.0,-69.0,-67.0,-72.0,-71.0,-69.0,-67.0,-72.0,-86.0,-87.0,-85.0,-86.0,14.0,18.0,18.0,14.0,1
2299,CC:2F:71:3E:C5:1F,3849616,485489806,1005,122818,3848611,485366988,3,4404,366974,3672,280068,732,86906,1064,14,1446,29,3,54,144444.0,39000.0,-70.0,-71.0,-68.0,-60.0,-70.0,-70.0,-68.0,-60.0,-86.0,-87.0,-85.0,-86.0,16.0,16.0,17.0,26.0,1
2300,BA:8C:B9:54:50:24,3853557,491562620,4946,6195632,3848611,485366988,7,9914,1762840,9892,1759345,22,3495,2361,18,5459,44,7,74,216660.0,130000.0,-49.0,-35.0,-43.0,-45.0,-46.0,-35.0,-43.0,-46.0,-86.0,-87.0,-84.0,-85.0,37.0,52.0,41.0,40.0,1
2301,62:47:05:9D:EB:15,3855377,497551408,6764,12184218,3848613,485367190,1,7079,3809905,7029,3802247,50,7658,3317,0,6838,56,1,126,216660.0,130000.0,-44.0,-45.0,-36.0,-48.0,-44.0,-45.0,-37.0,-47.0,-86.0,-87.0,-84.0,-85.0,42.0,42.0,48.0,37.0,1
2302,92:69:1D:31:68:E9,3852676,489021915,4063,3654725,3848613,485367190,1,5509,1165894,5334,1126101,175,39793,2209,12,4324,103,1,65,216660.0,130000.0,-52.0,-47.0,-43.0,-48.0,-52.0,-48.0,-43.0,-48.0,-86.0,-87.0,-84.0,-85.0,34.0,40.0,41.0,37.0,1
2303,CC:2F:71:3F:1F:24,5097160,1925890464,1248547,1440523274,3848613,485367190,2222,1050012,1200344927,1049154,1200241029,858,103898,1015900,15,1246682,121839,2219,810,144444.0,43333.0,-71.0,-68.0,-67.0,-72.0,-71.0,-68.0,-67.0,-71.0,-86.0,-87.0,-84.0,-85.0,15.0,19.0,17.0,13.0,1
2304,CC:2F:71:3E:C5:1F,3849618,485490008,1005,122818,3848613,485367190,3,4404,366974,3672,280068,732,86906,1064,14,1446,29,3,54,144444.0,39000.0,-70.0,-71.0,-68.0,-60.0,-70.0,-70.0,-68.0,-60.0,-86.0,-87.0,-84.0,-85.0,16.0,16.0,16.0,25.0,1
2305,BA:8C:B9:54:50:24,3853559,491562822,4946,6195632,3848613,485367190,7,9914,1762840,9892,1759345,22,3495,2361,18,5459,44,7,74,216660.0,130000.0,-49.0,-35.0,-43.0,-45.0,-46.0,-35.0,-43.0,-46.0,-86.0,-87.0,-84.0,-85.0,37.0,52.0,41.0,40.0,1
2306,62:47:05:9D:EB:15,3855384,497552074,6764,12184218,3848620,485367856,1,7079,3809905,7029,3802247,50,7658,3317,0,6838,56,1,126,216660.0,130000.0,-44.0,-45.0,-36.0,-48.0,-44.0,-45.0,-37.0,-47.0,-85.0,-86.0,-83.0,-84.0,41.0,41.0,47.0,36.0,1
2307,92:69:1D:31:68:E9,3852683,489022581,4063,3654725,3848620,485367856,1,5509,1165894,5334,1126101,175,39793,2209,12,4324,103,1,65,216660.0,130000.0,-52.0,-47.0,-43.0,-48.0,-52.0,-48.0,-43.0,-48.0,-85.0,-86.0,-83.0,-84.0,33.0,39.0,40.0,36.0,1
2308,CC:2F:71:3F:1F:24,5097369,1926152478,1248749,1440784622,3848620,485367856,2222,1050197,1200597421,1049339,1200493523,858,103898,1016080,15,1246883,121839,2219,811,144444.0,43333.0,-71.0,-69.0,-68.0,-72.0,-71.0,-69.0,-67.0,-71.0,-85.0,-86.0,-83.0,-84.0,14.0,17.0,15.0,12.0,1
2309,CC:2F:71:3E:C5:1F,3849627,485490876,1005,122818,3848622,485368058,3,4404,366974,3672,280068,732,86906,1064,14,1446,29,3,54,144444.0,39000.0,-70.0,-71.0,-68.0,-60.0,-70.0,-70.0,-68.0,-60.0,-85.0,-86.0,-83.0,-84.0,15.0,15.0,15.0,24.0,1
2310,BA:8C:B9:54:50:24,3853568,491563690,4946,6195632,3848622,485368058,7,9914,1762840,9892,1759345,22,3495,2361,18,5459,44,7,74,216660.0,130000.0,-49.0,-35.0,-43.0,-45.0,-46.0,-35.0,-43.0,-46.0,-85.0,-86.0,-83.0,-84.0,36.0,51.0,40.0,39.0,1
2311,62:47:05:9D:EB:15,3855386,497552276,6764,12184218,3848622,485368058,1,7079,3809905,7029,3802247,50,7658,3317,0,6838,56,1,126,216660.0,130000.0,-44.0,-45.0,-36.0,-48.0,-44.0,-45.0,-37.0,-47.0,-85.0,-86.0,-83.0,-84.0,41.0,41.0,47.0,36.0,1
2312,92:69:1D:31:68:E9,3852685,489022783,4063,3654725,3848622,485368058,1,5509,1165894,5334,1126101,175,39793,2209,12,4324,103,1,65,216660.0,130000.0,-52.0,-47.0,-43.0,-48.0,-52.0,-48.0,-43.0,-48.0,-85.0,-86.0,-83.0,-84.0,33.0,39.0,40.0,36.0,1
2313,CC:2F:71:3F:1F:24,5097573,1926412732,1248951,1441044674,3848622,485368058,2222,1050389,1200853627,1049531,1200749729,858,103898,1016265,15,1247086,121839,2219,811,144444.0,43333.0,-71.0,-69.0,-67.0,-72.0,-71.0,-69.0,-67.0,-71.0,-85.0,-86.0,-83.0,-84.0,14.0,17.0,16.0,12.0,1
2314,CC:2F:71:3E:C5:1F,3849627,485490876,1005,122818,3848622,485368058,3,4404,366974,3672,280068,732,86906,1064,14,1446,29,3,54,144444.0,39000.0,-70.0,-71.0,-68.0,-60.0,-70.0,-70.0,-68.0,-60.0,-85.0,-86.0,-83.0,-84.0,15.0,15.0,15.0,24.0,1
2315,BA:8C:B9:54:50:24,3853568,491563690,4946,6195632,3848622,485368058,7,9914,1762840,9892,1759345,22,3495,2361,18,5459,44,7,74,216660.0,130000.0,-49.0,-35.0,-43.0,-45.0,-46.0,-35.0,-43.0,-46.0,-85.0,-86.0,-83.0,-84.0,36.0,51.0,40.0,39.0,1
2316,62:47:05:9D:EB:15,3855392,497552882,6764,12184218,3848628,485368664,1,7079,3809905,7029,3802247,50,7658,3317,0,6838,56,1,126,216660.0,130000.0,-44.0,-45.0,-36.0,-48.0,-44.0,-45.0,-37.0,-47.0,-85.0,-86.0,-83.0,-84.0,41.0,41.0,47.0,36.0,1
2317,92:69:1D:31:68:E9,3852691,489023389,4063,3654725,3848628,485368664,1,5509,1165894,5334,1126101,175,39793,2209,12,4324,103,1,65,216660.0,130000.0,-52.0,-47.0,-43.0,-48.0,-52.0,-48.0,-43.0,-48.0,-85.0,-86.0,-83.0,-84.0,33.0,39.0,40.0,36.0,1
2318,CC:2F:71:3F:1F:24,5097782,1926661655,1249152,1441292789,3848630,485368866,2222,1050578,1201097266,1049720,1200993368,858,103898,1016442,15,1247285,121839,2219,811,144444.0,43333.0,-72.0,-69.0,-67.0,-72.0,-71.0,-69.0,-67.0,-72.0,-85.0,-86.0,-83.0,-84.0,13.0,17.0,16.0,12.0,1
2319,CC:2F:71:3E:C5:1F,3849635,485491684,1005,122818,3848630,485368866,3,4404,366974,3672,280068,732,86906,1064,14,1446,29,3,54,144444.0,39000.0,-70.0,-71.0,-68.0,-60.0,-70.0,-70.0,-68.0,-60.0,-85.0,-86.0,-83.0,-84.0,15.0,15.0,15.0,24.0,1
2320,BA:8C:B9:54:50:24,3853576,491564498,4946,6195632,3848630,485368866,7,9914,1762840,9892,1759345,22,3495,2361,18,5459,44,7,74,216660.0,130000.0,-49.0,-35.0,-43.0,-45.0,-46.0,-35.0,-43.0,-46.0,-85.0,-86.0,-83.0,-84.0,36.0,51.0,40.0,39.0,1
2321,62:47:05:9D:EB:15,3855395,497553144,6764,12184218,3848631,485368926,1,7079,3809905,7029,3802247,50,7658,3317,0,6838,56,1,126,216660.0,130000.0,-44.0,-45.0,-36.0,-48.0,-44.0,-45.0,-37.0,-47.0,-85.0,-86.0,-83.0,-84.0,41.0,41.0,47.0,36.0,1
2322,92:69:1D:31:68:E9,3852694,489023651,4063,3654725,3848631,485368926,1,5509,1165894,5334,1126101,175,39793,2209,12,4324,103,1,65,216660.0,130000.0,-52.0,-47.0,-43.0,-48.0,-52.0,-48.0,-43.0,-48.0,-85.0,-86.0,-83.0,-84.0,33.0,39.0,40.0,36.0,1
2323,CC:2F:71:3F:1F:24,5097974,1926903121,1249343,1441534195,3848631,485368926,2222,1050753,1201328950,1049895,1201225052,858,103898,1016613,15,1247478,121841,2219,811,144444.0,43333.0,-71.0,-69.0,-67.0,-72.0,-71.0,-69.0,-67.0,-71.0,-85.0,-86.0,-83.0,-84.0,14.0,17.0,16.0,12.0,1
2324,CC:2F:71:3E:C5:1F,3849638,485491946,1005,122818,3848633,485369128,3,4405,367044,3673,280138,732,86906,1064,14,1447,29,3,54,144444.0,39000.0,-70.0,-70.0,-68.0,-60.0,-70.0,-70.0,-68.0,-60.0,-85.0,-86.0,-83.0,-84.0,15.0,16.0,15.0,24.0,1
2325,BA:8C:B9:54:50:24,3853579,491564760,4946,6195632,3848633,485369128,7,9915,1762908,9893,1759413,22,3495,2361,18,5460,44,7,74,216660.0,130000.0,-40.0,-37.0,-46.0,-52.0,-45.0,-36.0,-44.0,-47.0,-85.0,-86.0,-83.0,-84.0,45.0,49.0,37.0,32.0,1
2326,62:47:05:9D:EB:15,3855403,497553952,6764,12184218,3848639,485369734,1,7080,3809973,7030,3802315,50,7658,3317,0,6839,56,1,126,216660.0,130000.0,-45.0,-45.0,-35.0,-47.0,-44.0,-45.0,-36.0,-47.0,-85.0,-86.0,-83.0,-84.0,40.0,41.0,48.0,37.0,1
2327,92:69:1D:31:68:E9,3852702,489024459,4063,3654725,3848639,485369734,1,5511,1166030,5336,1126237,175,39793,2209,12,4325,103,1,65,216660.0,130000.0,-51.0,-47.0,-45.0,-47.0,-51.0,-47.0,-44.0,-48.0,-85.0,-86.0,-83.0,-84.0,34.0,39.0,38.0,37.0,1
2328,CC:2F:71:3F:1F:24,5098176,1927148927,1249537,1441779193,3848639,485369734,2222,1050929,1201561810,1050071,1201457912,858,103898,1016786,15,1247672,121851,2219,811,144444.0,43333.0,-71.0,-69.0,-68.0,-73.0,-71.0,-69.0,-67.0,-72.0,-85.0,-86.0,-83.0,-84.0,14.0,17.0,15.0,11.0,1
2329,CC:2F:71:3E:C5:1F,3849644,485492552,1005,122818,3848639,485369734,3,4406,367114,3674,280208,732,86906,1064,14,1447,29,3,54,144444.0,39000.0,-71.0,-71.0,-68.0,-60.0,-70.0,-70.0,-68.0,-60.0,-85.0,-86.0,-83.0,-84.0,14.0,15.0,15.0,24.0,1
2330,BA:8C:B9:54:50:24,3853585,491565366,4946,6195632,3848639,485369734,7,9916,1762976,9894,1759481,22,3495,2361,18,5460,44,7,74,216660.0,130000.0,-49.0,-35.0,-43.0,-45.0,-45.0,-35.0,-44.0,-47.0,-85.0,-86.0,-83.0,-84.0,36.0,51.0,40.0,39.0,1
2331,62:47:05:9D:EB:15,3855404,497554012,6764,12184218,3848640,485369794,1,7081,3810041,7031,3802383,50,7658,3317,0,6839,56,1,126,216660.0,130000.0,-45.0,-49.0,-45.0,-44.0,-44.0,-45.0,-38.0,-46.0,-85.0,-87.0,-83.0,-84.0,40.0,38.0,38.0,40.0,1
2332,92:69:1D:31:68:E9,3852705,489024721,4063,3654725,3848642,485369996,1,5511,1166030,5336,1126237,175,39793,2209,12,4325,103,1,65,216660.0,130000.0,-51.0,-47.0,-45.0,-47.0,-51.0,-47.0,-44.0,-48.0,-85.0,-87.0,-83.0,-84.0,34.0,40.0,38.0,37.0,1
2333,CC:2F:71:3F:1F:24,5098374,1927396811,1249732,1442026815,3848642,485369996,2222,1051105,1201798908,1050247,1201695010,858,103898,1016959,15,1247867,121855,2219,811,144444.0,43333.0,-71.0,-69.0,-68.0,-71.0,-71.0,-68.0,-67.0,-72.0,-85.0,-87.0,-83.0,-84.0,14.0,18.0,15.0,13.0,1
2334,CC:2F:71:3E:C5:1F,3849647,485492814,1005,122818,3848642,485369996,3,4406,367114,3674,280208,732,86906,1064,14,1447,29,3,54,144444.0,39000.0,-71.0,-71.0,-68.0,-60.0,-70.0,-70.0,-68.0,-60.0,-85.0,-87.0,-83.0,-84.0,14.0,16.0,15.0,24.0,1
2335,BA:8C:B9:54:50:24,3853588,491565628,4946,6195632,3848642,485369996,7,9916,1762976,9894,1759481,22,3495,2361,18,5460,44,7,74,216660.0,130000.0,-49.0,-35.0,-43.0,-45.0,-45.0,-35.0,-44.0,-47.0,-85.0,-87.0,-83.0,-84.0,36.0,52.0,40.0,39.0,1
2336,62:47:05:9D:EB:15,3855412,497554820,6764,12184218,3848648,485370602,1,7081,3810041,7031,3802383,50,7658,3317,0,6839,56,1,126,216660.0,130000.0,-45.0,-49.0,-45.0,-44.0,-44.0,-45.0,-38.0,-46.0,-85.0,-86.0,-82.0,-83.0,40.0,37.0,37.0,39.0,1
2337,92:69:1D:31:68:E9,3852711,489025327,4063,3654725,3848648,485370602,1,5511,1166030,5336,1126237,175,39793,2209,12,4325,103,1,65,216660.0,130000.0,-51.0,-47.0,-45.0,-47.0,-51.0,-47.0,-44.0,-48.0,-85.0,-86.0,-82.0,-83.0,34.0,39.0,37.0,36.0,1
2338,CC:2F:71:3F:1F:24,5098583,1927648783,1249934,1442277908,3848649,485370875,2222,1051287,1202034436,1050429,1201930538,858,103898,1017138,15,1248068,121855,2219,812,144444.0,43333.0,-71.0,-68.0,-66.0,-71.0,-71.0,-68.0,-66.0,-71.0,-85.0,-86.0,-82.0,-83.0,14.0,18.0,16.0,12.0,1
2339,CC:2F:71:3E:C5:1F,3849654,485493693,1005,122818,3848649,485370875,3,4406,367114,3674,280208,732,86906,1064,14,1447,29,3,54,144444.0,39000.0,-71.0,-71.0,-68.0,-60.0,-70.0,-70.0,-68.0,-60.0,-85.0,-86.0,-82.0,-83.0,14.0,15.0,14.0,23.0,1
2340,BA:8C:B9:54:50:24,3853595,491566507,4946,6195632,3848649,485370875,7,9916,1762976,9894,1759481,22,3495,2361,18,5460,44,7,74,216660.0,130000.0,-49.0,-35.0,-43.0,-45.0,-45.0,-35.0,-44.0,-47.0,-85.0,-86.0,-82.0,-83.0,36.0,51.0,39.0,38.0,1
2341,62:47:05:9D:EB:15,3855415,497555295,6764,12184218,3848651,485371077,1,7081,3810041,7031,3802383,50,7658,3317,0,6839,56,1,126,216660.0,130000.0,-45.0,-49.0,-45.0,-44.0,-44.0,-45.0,-38.0,-46.0,-85.0,-86.0,-82.0,-83.0,40.0,37.0,37.0,39.0,1
2342,92:69:1D:31:68:E9,3852714,489025802,4063,3654725,3848651,485371077,1,5511,1166030,5336,1126237,175,39793,2209,12,4325,103,1,65,216660.0,130000.0,-51.0,-47.0,-45.0,-47.0,-51.0,-47.0,-44.0,-48.0,-85.0,-86.0,-82.0,-83.0,34.0,39.0,37.0,36.0,1
2343,CC:2F:71:3F:1F:24,5098777,1927893369,1250126,1442522292,3848651,485371077,2222,1051469,1202276730,1050611,1202172832,858,103898,1017311,15,1248261,121855,2219,812,144444.0,43333.0,-72.0,-69.0,-67.0,-72.0,-71.0,-69.0,-67.0,-71.0,-85.0,-86.0,-82.0,-83.0,13.0,17.0,15.0,11.0,1
2344,CC:2F:71:3E:C5:1F,3849657,485493955,1005,122818,3848652,485371137,3,4406,367114,3674,280208,732,86906,1064,14,1447,29,3,54,144444.0,39000.0,-71.0,-71.0,-68.0,-60.0,-70.0,-70.0,-68.0,-60.0,-85.0,-86.0,-82.0,-83.0,14.0,15.0,14.0,23.0,1
2345,BA:8C:B9:54:50:24,3853599,491566903,4946,6195632,3848653,485371271,7,9916,1762976,9894,1759481,22,3495,2361,18,5460,44,7,74,216660.0,130000.0,-49.0,-35.0,-43.0,-45.0,-45.0,-35.0,-44.0,-47.0,-85.0,-86.0,-82.0,-83.0,36.0,51.0,39.0,38.0,1
2346,62:47:05:9D:EB:15,3855422,497555961,6764,12184218,3848658,485371743,1,7081,3810041,7031,3802383,50,7658,3317,0,6839,56,1,126,216660.0,130000.0,-45.0,-49.0,-45.0,-44.0,-44.0,-45.0,-38.0,-46.0,-85.0,-86.0,-82.0,-83.0,40.0,37.0,37.0,39.0,1
2347,92:69:1D:31:68:E9,3852721,489026468,4063,3654725,3848658,485371743,1,5511,1166030,5336,1126237,175,39793,2209,12,4325,103,1,65,216660.0,130000.0,-51.0,-47.0,-45.0,-47.0,-51.0,-47.0,-44.0,-48.0,-85.0,-86.0,-82.0,-82.0,34.0,39.0,37.0,35.0,1
2348,CC:2F:71:3F:1F:24,5098976,1928138419,1250318,1442766676,3848658,485371743,2222,1051648,1202517080,1050790,1202413182,858,103898,1017483,15,1248453,121855,2219,812,144444.0,43333.0,-72.0,-69.0,-67.0,-72.0,-71.0,-69.0,-66.0,-72.0,-85.0,-86.0,-82.0,-82.0,13.0,17.0,15.0,10.0,1
2349,CC:2F:71:3E:C5:1F,3849663,485494561,1005,122818,3848658,485371743,3,4406,367114,3674,280208,732,86906,1064,14,1447,29,3,54,144444.0,39000.0,-71.0,-71.0,-68.0,-60.0,-70.0,-70.0,-68.0,-60.0,-85.0,-86.0,-82.0,-82.0,14.0,15.0,14.0,22.0,1
2350,BA:8C:B9:54:50:24,3853604,491567375,4946,6195632,3848658,485371743,7,9916,1762976,9894,1759481,22,3495,2361,18,5460,44,7,74,216660.0,130000.0,-49.0,-35.0,-43.0,-45.0,-45.0,-35.0,-44.0,-47.0,-85.0,-86.0,-82.0,-82.0,36.0,51.0,39.0,37.0,1
2351,62:47:05:9D:EB:15,3855424,497556163,6764,12184218,3848660,485371945,1,7084,3810245,7034,3802587,50,7658,3317,0,6839,56,1,126,216660.0,130000.0,-45.0,-45.0,-36.0,-47.0,-44.0,-45.0,-36.0,-47.0,-85.0,-86.0,-82.0,-82.0,40.0,41.0,46.0,35.0,1
2352,92:69:1D:31:68:E9,3852723,489026670,4063,3654725,3848660,485371945,1,5511,1166030,5336,1126237,175,39793,2209,12,4325,103,1,65,216660.0,130000.0,-51.0,-47.0,-45.0,-47.0,-51.0,-47.0,-44.0,-48.0,-85.0,-86.0,-82.0,-82.0,34.0,39.0,37.0,35.0,1
2353,CC:2F:71:3F:1F:24,5099176,1928385997,1250516,1443014052,3848660,485371945,2222,1051833,1202755943,1050975,1202652045,858,103898,1017661,15,1248651,121857,2219,812,144444.0,43333.0,-71.0,-69.0,-66.0,-71.0,-71.0,-68.0,-66.0,-71.0,-85.0,-86.0,-82.0,-82.0,14.0,17.0,16.0,11.0,1
2354,CC:2F:71:3E:C5:1F,3849665,485494763,1005,122818,3848660,485371945,3,4406,367114,3674,280208,732,86906,1064,14,1447,29,3,54,144444.0,39000.0,-71.0,-71.0,-68.0,-60.0,-70.0,-70.0,-68.0,-60.0,-85.0,-86.0,-82.0,-82.0,14.0,15.0,14.0,22.0,1
2355,BA:8C:B9:54:50:24,3853608,491567779,4946,6195632,3848662,485372147,7,9916,1762976,9894,1759481,22,3495,2361,18,5460,44,7,74,216660.0,130000.0,-49.0,-35.0,-43.0,-45.0,-45.0,-35.0,-44.0,-47.0,-85.0,-86.0,-82.0,-82.0,36.0,51.0,39.0,37.0,1
2356,62:47:05:9D:EB:15,3855431,497556829,6764,12184218,3848667,485372611,1,7084,3810245,7034,3802587,50,7658,3317,0,6839,56,1,126,216660.0,130000.0,-45.0,-45.0,-36.0,-47.0,-44.0,-45.0,-36.0,-47.0,-85.0,-86.0,-82.0,-82.0,40.0,41.0,46.0,35.0,1
2357,92:69:1D:31:68:E9,3852730,489027336,4063,3654725,3848667,485372611,1,5511,1166030,5336,1126237,175,39793,2209,12,4325,103,1,65,216660.0,130000.0,-51.0,-47.0,-45.0,-47.0,-51.0,-47.0,-44.0,-48.0,-85.0,-86.0,-82.0,-82.0,34.0,39.0,37.0,35.0,1
2358,CC:2F:71:3F:1F:24,5099376,1928631590,1250709,1443258979,3848667,485372611,2222,1052010,1202991809,1051152,1202887911,858,103898,1017833,15,1248844,121859,2219,812,144444.0,43333.0,-71.0,-69.0,-67.0,-71.0,-71.0,-69.0,-67.0,-71.0,-85.0,-86.0,-82.0,-82.0,14.0,17.0,15.0,11.0,1
2359,CC:2F:71:3E:C5:1F,3849672,485495429,1005,122818,3848667,485372611,3,4406,367114,3674,280208,732,86906,1064,14,1447,29,3,54,144444.0,39000.0,-71.0,-71.0,-68.0,-60.0,-70.0,-70.0,-68.0,-60.0,-85.0,-86.0,-82.0,-82.0,14.0,15.0,14.0,22.0,1
2360,BA:8C:B9:54:50:24,3853613,491568243,4946,6195632,3848667,485372611,7,9916,1762976,9894,1759481,22,3495,2361,18,5460,44,7,74,216660.0,130000.0,-49.0,-35.0,-43.0,-45.0,-45.0,-35.0,-44.0,-47.0,-85.0,-86.0,-82.0,-82.0,36.0,51.0,39.0,37.0,1
2361,62:47:05:9D:EB:15,3855433,497557031,6764,12184218,3848669,485372813,1,7084,3810245,7034,3802587,50,7658,3317,0,6839,56,1,126,216660.0,130000.0,-45.0,-45.0,-36.0,-47.0,-44.0,-45.0,-36.0,-47.0,-84.0,-85.0,-81.0,-82.0,39.0,40.0,45.0,35.0,1
2362,92:69:1D:31:68:E9,3852732,489027538,4063,3654725,3848669,485372813,1,5511,1166030,5336,1126237,175,39793,2209,12,4325,103,1,65,216660.0,130000.0,-51.0,-47.0,-45.0,-47.0,-51.0,-47.0,-44.0,-48.0,-84.0,-85.0,-81.0,-82.0,33.0,38.0,36.0,35.0,1
2363,CC:2F:71:3F:1F:24,5099567,1928872938,1250898,1443500125,3848669,485372813,2222,1052184,1203223041,1051326,1203119143,858,103898,1018003,15,1249033,121859,2219,812,144444.0,43333.0,-71.0,-70.0,-68.0,-71.0,-71.0,-69.0,-67.0,-71.0,-84.0,-85.0,-81.0,-82.0,13.0,15.0,13.0,11.0,1
2364,CC:2F:71:3E:C5:1F,3849674,485495631,1005,122818,3848669,485372813,3,4406,367114,3674,280208,732,86906,1064,14,1447,29,3,54,144444.0,39000.0,-71.0,-71.0,-68.0,-60.0,-70.0,-70.0,-68.0,-60.0,-84.0,-85.0,-81.0,-82.0,13.0,14.0,13.0,22.0,1
2365,BA:8C:B9:54:50:24,3853619,491568849,4946,6195632,3848673,485373217,7,9916,1762976,9894,1759481,22,3495,2361,18,5460,44,7,74,216660.0,130000.0,-49.0,-35.0,-43.0,-45.0,-45.0,-35.0,-44.0,-47.0,-84.0,-85.0,-81.0,-82.0,35.0,50.0,38.0,37.0,1
2366,62:47:05:9D:EB:15,3855439,497557637,6764,12184218,3848675,485373419,1,7084,3810245,7034,3802587,50,7658,3317,0,6839,56,1,126,216660.0,130000.0,-45.0,-45.0,-36.0,-47.0,-44.0,-45.0,-36.0,-47.0,-84.0,-85.0,-81.0,-81.0,39.0,40.0,45.0,34.0,1
2367,92:69:1D:31:68:E9,3852738,489028144,4063,3654725,3848675,485373419,1,5511,1166030,5336,1126237,175,39793,2209,12,4325,103,1,65,216660.0,130000.0,-51.0,-47.0,-45.0,-47.0,-51.0,-47.0,-44.0,-48.0,-84.0,-85.0,-81.0,-81.0,33.0,38.0,36.0,34.0,1
2368,CC:2F:71:3F:1F:24,5099765,1929117914,1251090,1443744495,3848675,485373419,2222,1052360,1203457371,1051502,1203353473,858,103898,1018173,15,1249225,121859,2219,812,144444.0,43333.0,-71.0,-68.0,-66.0,-71.0,-71.0,-68.0,-66.0,-70.0,-84.0,-85.0,-81.0,-81.0,13.0,17.0,15.0,10.0,1
2369,CC:2F:71:3E:C5:1F,3849680,485496237,1005,122818,3848675,485373419,3,4406,367114,3674,280208,732,86906,1064,14,1447,29,3,54,144444.0,39000.0,-71.0,-71.0,-68.0,-60.0,-70.0,-70.0,-68.0,-60.0,-84.0,-85.0,-81.0,-81.0,13.0,14.0,13.0,21.0,1
2370,BA:8C:B9:54:50:24,3853622,491569111,4946,6195632,3848676,485373479,7,9916,1762976,9894,1759481,22,3495,2361,18,5460,44,7,74,216660.0,130000.0,-49.0,-35.0,-43.0,-45.0,-45.0,-35.0,-44.0,-47.0,-84.0,-85.0,-81.0,-81.0,35.0,50.0,38.0,36.0,1
2371,62:47:05:9D:EB:15,3855442,497557899,6764,12184218,3848678,485373681,1,7084,3810245,7034,3802587,50,7658,3317,0,6839,56,1,126,216660.0,130000.0,-45.0,-45.0,-36.0,-47.0,-44.0,-45.0,-36.0,-47.0,-84.0,-85.0,-81.0,-81.0,39.0,40.0,45.0,34.0,1
2372,92:69:1D:31:68:E9,3852741,489028406,4063,3654725,3848678,485373681,1,5512,1166098,5337,1126305,175,39793,2209,12,4325,103,1,65,216660.0,130000.0,-51.0,-48.0,-45.0,-49.0,-51.0,-47.0,-44.0,-48.0,-84.0,-85.0,-81.0,-81.0,33.0,37.0,36.0,32.0,1
2373,CC:2F:71:3F:1F:24,5099965,1929362923,1251287,1443989242,3848678,485373681,2222,1052546,1203694815,1051688,1203590917,858,103898,1018351,15,1249422,121859,2219,812,144444.0,43333.0,-71.0,-69.0,-67.0,-71.0,-71.0,-68.0,-67.0,-70.0,-84.0,-85.0,-81.0,-81.0,13.0,16.0,14.0,10.0,1
2374,CC:2F:71:3E:C5:1F,3849685,485496701,1005,122818,3848680,485373883,3,4406,367114,3674,280208,732,86906,1064,14,1447,29,3,54,144444.0,39000.0,-71.0,-71.0,-68.0,-60.0,-70.0,-70.0,-68.0,-60.0,-84.0,-85.0,-81.0,-81.0,13.0,14.0,13.0,21.0,1
2375,BA:8C:B9:54:50:24,3853628,491569717,4946,6195632,3848682,485374085,7,9916,1762976,9894,1759481,22,3495,2361,18,5460,44,7,74,216660.0,130000.0,-49.0,-35.0,-43.0,-45.0,-45.0,-35.0,-44.0,-47.0,-84.0,-85.0,-81.0,-81.0,35.0,50.0,38.0,36.0,1
2376,62:47:05:9D:EB:15,3855448,497558505,6764,12184218,3848684,485374287,1,7084,3810245,7034,3802587,50,7658,3317,0,6839,56,1,126,216660.0,130000.0,-45.0,-45.0,-36.0,-47.0,-44.0,-45.0,-36.0,-47.0,-84.0,-85.0,-81.0,-81.0,39.0,40.0,45.0,34.0,1
2377,92:69:1D:31:68:E9,3852747,489029012,4063,3654725,3848684,485374287,1,5512,1166098,5337,1126305,175,39793,2209,12,4325,103,1,65,216660.0,130000.0,-51.0,-48.0,-45.0,-49.0,-51.0,-47.0,-44.0,-48.0,-84.0,-85.0,-81.0,-81.0,33.0,37.0,36.0,32.0,1
2378,CC:2F:71:3F:1F:24,5100165,1929611007,1251481,1444236720,3848684,485374287,2222,1052732,1203936295,1051874,1203832397,858,103898,1018526,15,1249616,121859,2219,812,144444.0,43333.0,-72.0,-69.0,-66.0,-71.0,-71.0,-68.0,-66.0,-70.0,-84.0,-85.0,-81.0,-81.0,12.0,16.0,15.0,10.0,1
2379,CC:2F:71:3E:C5:1F,3849689,485497105,1005,122818,3848684,485374287,3,4406,367114,3674,280208,732,86906,1064,14,1447,29,3,54,144444.0,39000.0,-71.0,-71.0,-68.0,-60.0,-70.0,-70.0,-68.0,-60.0,-84.0,-85.0,-81.0,-81.0,13.0,14.0,13.0,21.0,1
2380,BA:8C:B9:54:50:24,3853630,491569919,4946,6195632,3848684,485374287,7,9916,1762976,9894,1759481,22,3495,2361,18,5460,44,7,74,216660.0,130000.0,-49.0,-35.0,-43.0,-45.0,-45.0,-35.0,-44.0,-47.0,-84.0,-85.0,-81.0,-81.0,35.0,50.0,38.0,36.0,1
2381,62:47:05:9D:EB:15,3855451,497558767,6764,12184218,3848687,485374549,1,7084,3810245,7034,3802587,50,7658,3317,0,6839,56,1,126,216660.0,130000.0,-45.0,-45.0,-36.0,-47.0,-44.0,-45.0,-36.0,-47.0,-84.0,-85.0,-81.0,-81.0,39.0,40.0,45.0,34.0,1
2382,92:69:1D:31:68:E9,3852750,489029274,4063,3654725,3848687,485374549,1,5512,1166098,5337,1126305,175,39793,2209,12,4325,103,1,65,216660.0,130000.0,-51.0,-48.0,-45.0,-49.0,-51.0,-47.0,-44.0,-48.0,-84.0,-85.0,-81.0,-81.0,33.0,37.0,36.0,32.0,1
2383,CC:2F:71:3F:1F:24,5100364,1929856057,1251673,1444481104,3848691,485374953,2222,1052913,1204182629,1052055,1204078731,858,103898,1018696,15,1249808,121859,2219,812,144444.0,43333.0,-72.0,-69.0,-68.0,-71.0,-71.0,-68.0,-67.0,-71.0,-84.0,-85.0,-81.0,-81.0,12.0,16.0,13.0,10.0,1
2384,CC:2F:71:3E:C5:1F,3849696,485497771,1005,122818,3848691,485374953,3,4406,367114,3674,280208,732,86906,1064,14,1447,29,3,54,144444.0,39000.0,-71.0,-71.0,-68.0,-60.0,-70.0,-70.0,-68.0,-60.0,-84.0,-85.0,-81.0,-81.0,13.0,14.0,13.0,21.0,1
2385,BA:8C:B9:54:50:24,3853639,491570787,4946,6195632,3848693,485375155,7,9916,1762976,9894,1759481,22,3495,2361,18,5460,44,7,74,216660.0,130000.0,-49.0,-35.0,-43.0,-45.0,-45.0,-35.0,-44.0,-47.0,-84.0,-85.0,-81.0,-81.0,35.0,50.0,38.0,36.0,1
2386,62:47:05:9D:EB:15,3855459,497559615,6765,12184334,3848694,485375281,1,7085,3810313,7035,3802655,50,7658,3317,0,6840,56,1,126,216660.0,130000.0,-44.0,-45.0,-36.0,-48.0,-44.0,-45.0,-36.0,-47.0,-84.0,-85.0,-81.0,-81.0,40.0,40.0,45.0,33.0,1
2387,92:69:1D:31:68:E9,3852758,489030122,4064,3654841,3848694,485375281,1,5514,1166234,5339,1126441,175,39793,2209,12,4326,103,1,65,216660.0,130000.0,-51.0,-47.0,-43.0,-48.0,-51.0,-47.0,-44.0,-47.0,-84.0,-85.0,-81.0,-81.0,33.0,38.0,38.0,33.0,1
2388,CC:2F:71:3F:1F:24,5100559,1930100587,1251865,1444725306,3848694,485375281,2222,1053091,1204418783,1052233,1204314885,858,103898,1018867,15,1250000,121859,2219,812,144444.0,43333.0,-72.0,-69.0,-67.0,-70.0,-71.0,-69.0,-66.0,-71.0,-84.0,-85.0,-81.0,-81.0,12.0,16.0,14.0,11.0,1
2389,CC:2F:71:3E:C5:1F,3849700,485498215,1006,122934,3848694,485375281,3,4408,367254,3676,280348,732,86906,1064,14,1448,29,3,54,144444.0,39000.0,-70.0,-72.0,-67.0,-60.0,-70.0,-71.0,-67.0,-60.0,-84.0,-85.0,-81.0,-81.0,14.0,13.0,14.0,21.0,1
2390,BA:8C:B9:54:50:24,3853643,491571231,4947,6195748,3848696,485375483,7,9918,1763112,9896,1759617,22,3495,2361,18,5461,44,7,74,216660.0,130000.0,-48.0,-35.0,-43.0,-45.0,-45.0,-35.0,-44.0,-47.0,-84.0,-85.0,-81.0,-81.0,36.0,50.0,38.0,36.0,1
2391,62:47:05:9D:EB:15,3855463,497560019,6765,12184334,3848698,485375685,1,7086,3810381,7036,3802723,50,7658,3317,0,6840,56,1,126,216660.0,130000.0,-44.0,-45.0,-36.0,-47.0,-44.0,-45.0,-36.0,-46.0,-84.0,-85.0,-81.0,-81.0,40.0,40.0,45.0,34.0,1
2392,92:69:1D:31:68:E9,3852764,489030728,4064,3654841,3848700,485375887,1,5514,1166234,5339,1126441,175,39793,2209,12,4326,103,1,65,216660.0,130000.0,-51.0,-47.0,-43.0,-48.0,-51.0,-47.0,-44.0,-47.0,-84.0,-85.0,-81.0,-81.0,33.0,38.0,38.0,33.0,1
2393,CC:2F:71:3F:1F:24,5100766,1930349250,1252064,1444973161,3848702,485376089,2222,1053275,1204653125,1052417,1204549227,858,103898,1019048,15,1250199,121859,2219,812,144444.0,43333.0,-72.0,-69.0,-67.0,-70.0,-71.0,-68.0,-66.0,-70.0,-84.0,-85.0,-81.0,-81.0,12.0,16.0,14.0,11.0,1
2394,CC:2F:71:3E:C5:1F,3849709,485499083,1006,122934,3848703,485376149,3,4408,367254,3676,280348,732,86906,1064,14,1448,29,3,54,144444.0,39000.0,-70.0,-72.0,-67.0,-60.0,-70.0,-71.0,-67.0,-60.0,-84.0,-85.0,-81.0,-81.0,14.0,13.0,14.0,21.0,1
2395,BA:8C:B9:54:50:24,3853650,491571897,4947,6195748,3848703,485376149,7,9918,1763112,9896,1759617,22,3495,2361,18,5461,44,7,74,216660.0,130000.0,-48.0,-35.0,-43.0,-45.0,-45.0,-35.0,-44.0,-47.0,-84.0,-85.0,-81.0,-81.0,36.0,50.0,38.0,36.0,1
2396,62:47:05:9D:EB:15,3855468,497560483,6765,12184334,3848703,485376149,1,7086,3810381,7036,3802723,50,7658,3317,0,6840,56,1,126,216660.0,130000.0,-44.0,-45.0,-36.0,-47.0,-44.0,-45.0,-36.0,-46.0,-84.0,-85.0,-81.0,-81.0,40.0,40.0,45.0,34.0,1
2397,92:69:1D:31:68:E9,3852767,489030990,4064,3654841,3848703,485376149,1,5514,1166234,5339,1126441,175,39793,2209,12,4326,103,1,65,216660.0,130000.0,-51.0,-47.0,-43.0,-48.0,-51.0,-47.0,-44.0,-47.0,-84.0,-85.0,-81.0,-81.0,33.0,38.0,38.0,33.0,1
2398,CC:2F:71:3F:1F:24,5100962,1930594026,1252257,1445217675,3848705,485376351,2222,1053451,1204890265,1052593,1204786367,858,103898,1019218,15,1250392,121859,2219,812,144444.0,43333.0,-72.0,-69.0,-67.0,-71.0,-71.0,-68.0,-67.0,-71.0,-84.0,-85.0,-81.0,-81.0,12.0,16.0,14.0,10.0,1
2399,CC:2F:71:3E:C5:1F,3849711,485499285,1006,122934,3848705,485376351,3,4408,367254,3676,280348,732,86906,1064,14,1448,29,3,54,144444.0,39000.0,-70.0,-72.0,-67.0,-60.0,-70.0,-71.0,-67.0,-60.0,-84.0,-85.0,-81.0,-81.0,14.0,13.0,14.0,21.0,1
2400,BA:8C:B9:54:50:24,3853652,491572099,4947,6195748,3848705,485376351,7,9918,1763112,9896,1759617,22,3495,2361,18,5461,44,7,74,216660.0,130000.0,-48.0,-35.0,-43.0,-45.0,-45.0,-35.0,-44.0,-47.0,-84.0,-85.0,-81.0,-81.0,36.0,50.0,38.0,36.0,1
2401,62:47:05:9D:EB:15,3855475,497561362,6765,12184334,3848710,485377028,1,7086,3810381,7036,3802723,50,7658,3317,0,6840,56,1,126,216660.0,130000.0,-44.0,-45.0,-36.0,-47.0,-44.0,-45.0,-36.0,-46.0,-84.0,-85.0,-81.0,-81.0,40.0,40.0,45.0,34.0,1
2402,92:69:1D:31:68:E9,3852776,489032071,4064,3654841,3848712,485377230,1,5514,1166234,5339,1126441,175,39793,2209,12,4326,103,1,65,216660.0,130000.0,-51.0,-47.0,-43.0,-48.0,-51.0,-47.0,-44.0,-47.0,-84.0,-85.0,-81.0,-81.0,33.0,38.0,38.0,33.0,1
2403,CC:2F:71:3F:1F:24,5101162,1930839419,1252450,1445462189,3848712,485377230,2222,1053628,1205128993,1052770,1205025095,858,103898,1019389,15,1250585,121859,2219,812,144444.0,43333.0,-72.0,-69.0,-67.0,-72.0,-72.0,-69.0,-67.0,-71.0,-84.0,-85.0,-81.0,-81.0,12.0,16.0,14.0,9.0,1
2404,CC:2F:71:3E:C5:1F,3849718,485500164,1006,122934,3848712,485377230,3,4408,367254,3676,280348,732,86906,1064,14,1448,29,3,54,144444.0,39000.0,-70.0,-72.0,-67.0,-60.0,-70.0,-71.0,-67.0,-60.0,-85.0,-86.0,-82.0,-82.0,15.0,14.0,15.0,22.0,1
2405,BA:8C:B9:54:50:24,3853659,491572978,4947,6195748,3848712,485377230,7,9918,1763112,9896,1759617,22,3495,2361,18,5461,44,7,74,216660.0,130000.0,-48.0,-35.0,-43.0,-45.0,-45.0,-35.0,-44.0,-47.0,-85.0,-86.0,-82.0,-82.0,37.0,51.0,39.0,37.0,1
2406,62:47:05:9D:EB:15,3855481,497561888,6765,12184334,3848716,485377554,1,7086,3810381,7036,3802723,50,7658,3317,0,6840,56,1,126,216660.0,130000.0,-44.0,-45.0,-36.0,-47.0,-44.0,-45.0,-36.0,-46.0,-85.0,-86.0,-82.0,-82.0,41.0,41.0,46.0,35.0,1
2407,92:69:1D:31:68:E9,3852780,489032395,4064,3654841,3848716,485377554,1,5514,1166234,5339,1126441,175,39793,2209,12,4326,103,1,65,216660.0,130000.0,-51.0,-47.0,-43.0,-48.0,-51.0,-47.0,-44.0,-47.0,-85.0,-86.0,-82.0,-82.0,34.0,39.0,39.0,34.0,1
2408,CC:2F:71:3F:1F:24,5101358,1931082703,1252642,1445705149,3848716,485377554,2222,1053802,1205363067,1052944,1205259169,858,103898,1019558,15,1250777,121859,2219,812,144444.0,43333.0,-71.0,-68.0,-66.0,-70.0,-71.0,-68.0,-66.0,-70.0,-85.0,-86.0,-82.0,-82.0,14.0,18.0,16.0,12.0,1
2409,CC:2F:71:3E:C5:1F,3849722,485500488,1006,122934,3848716,485377554,3,4410,367442,3677,280418,733,87024,1065,14,1448,29,3,54,144444.0,39000.0,-71.0,-71.0,-68.0,-60.0,-70.0,-71.0,-67.0,-60.0,-85.0,-86.0,-82.0,-82.0,14.0,15.0,14.0,22.0,1
2410,BA:8C:B9:54:50:24,3853663,491573302,4947,6195748,3848716,485377554,7,9918,1763112,9896,1759617,22,3495,2361,18,5461,44,7,74,216660.0,130000.0,-48.0,-35.0,-43.0,-45.0,-45.0,-35.0,-44.0,-47.0,-85.0,-86.0,-82.0,-82.0,37.0,51.0,39.0,37.0,1
2411,62:47:05:9D:EB:15,3855488,497562572,6765,12184334,3848723,485378238,1,7086,3810381,7036,3802723,50,7658,3317,0,6840,56,1,126,216660.0,130000.0,-44.0,-45.0,-36.0,-47.0,-44.0,-45.0,-36.0,-46.0,-85.0,-86.0,-82.0,-82.0,41.0,41.0,46.0,35.0,1
2412,92:69:1D:31:68:E9,3852787,489033079,4064,3654841,3848723,485378238,1,5514,1166234,5339,1126441,175,39793,2209,12,4326,103,1,65,216660.0,130000.0,-51.0,-47.0,-43.0,-48.0,-51.0,-47.0,-44.0,-47.0,-85.0,-86.0,-82.0,-82.0,34.0,39.0,39.0,34.0,1
2413,CC:2F:71:3F:1F:24,5101567,1931330316,1252842,1445951710,3848725,485378606,2222,1053989,1205602044,1053131,1205498146,858,103898,1019740,15,1250977,121859,2219,812,144444.0,43333.0,-72.0,-69.0,-67.0,-72.0,-72.0,-69.0,-67.0,-71.0,-85.0,-86.0,-82.0,-82.0,13.0,17.0,15.0,10.0,1
2414,CC:2F:71:3E:C5:1F,3849731,485501540,1006,122934,3848725,485378606,3,4410,367442,3677,280418,733,87024,1065,14,1448,29,3,54,144444.0,39000.0,-71.0,-71.0,-68.0,-60.0,-70.0,-71.0,-67.0,-60.0,-85.0,-86.0,-82.0,-82.0,14.0,15.0,14.0,22.0,1
2415,BA:8C:B9:54:50:24,3853672,491574354,4947,6195748,3848725,485378606,7,9918,1763112,9896,1759617,22,3495,2361,18,5461,44,7,74,216660.0,130000.0,-48.0,-35.0,-43.0,-45.0,-45.0,-35.0,-44.0,-47.0,-85.0,-86.0,-82.0,-82.0,37.0,51.0,39.0,37.0,1
2416,62:47:05:9D:EB:15,3855492,497563142,6765,12184334,3848727,485378808,1,7086,3810381,7036,3802723,50,7658,3317,0,6840,56,1,126,216660.0,130000.0,-44.0,-45.0,-36.0,-47.0,-44.0,-45.0,-36.0,-46.0,-85.0,-87.0,-82.0,-82.0,41.0,42.0,46.0,35.0,1
2417,92:69:1D:31:68:E9,3852791,489033649,4064,3654841,3848727,485378808,1,5514,1166234,5339,1126441,175,39793,2209,12,4326,103,1,65,216660.0,130000.0,-51.0,-47.0,-43.0,-48.0,-51.0,-47.0,-44.0,-47.0,-85.0,-87.0,-82.0,-82.0,34.0,40.0,39.0,34.0,1
2418,CC:2F:71:3F:1F:24,5101765,1931578270,1253038,1446199462,3848727,485378808,2222,1054171,1205841678,1053313,1205737780,858,103898,1019915,15,1251173,121859,2219,813,144444.0,43333.0,-72.0,-69.0,-68.0,-72.0,-72.0,-69.0,-67.0,-71.0,-85.0,-87.0,-82.0,-82.0,13.0,18.0,14.0,10.0,1
2419,CC:2F:71:3E:C5:1F,3849734,485501802,1006,122934,3848728,485378868,3,4410,367442,3677,280418,733,87024,1065,14,1448,29,3,54,144444.0,39000.0,-71.0,-71.0,-68.0,-60.0,-70.0,-71.0,-67.0,-60.0,-85.0,-87.0,-82.0,-82.0,14.0,16.0,14.0,22.0,1
2420,BA:8C:B9:54:50:24,3853675,491574616,4947,6195748,3848728,485378868,7,9918,1763112,9896,1759617,22,3495,2361,18,5461,44,7,74,216660.0,130000.0,-48.0,-35.0,-43.0,-45.0,-45.0,-35.0,-44.0,-47.0,-85.0,-87.0,-82.0,-82.0,37.0,52.0,39.0,37.0,1
2421,62:47:05:9D:EB:15,3855499,497563808,6765,12184334,3848734,485379474,1,7086,3810381,7036,3802723,50,7658,3317,0,6840,56,1,126,216660.0,130000.0,-44.0,-45.0,-36.0,-47.0,-44.0,-45.0,-36.0,-46.0,-85.0,-87.0,-82.0,-82.0,41.0,42.0,46.0,35.0,1
2422,92:69:1D:31:68:E9,3852798,489034315,4064,3654841,3848734,485379474,1,5514,1166234,5339,1126441,175,39793,2209,12,4326,103,1,65,216660.0,130000.0,-51.0,-47.0,-43.0,-48.0,-51.0,-47.0,-44.0,-47.0,-85.0,-87.0,-82.0,-82.0,34.0,40.0,39.0,34.0,1
2423,CC:2F:71:3F:1F:24,5101965,1931826298,1253231,1446446824,3848734,485379474,2222,1054353,1206085486,1053495,1205981588,858,103898,1020088,15,1251366,121859,2219,813,144444.0,43333.0,-72.0,-69.0,-68.0,-71.0,-72.0,-69.0,-67.0,-71.0,-85.0,-87.0,-82.0,-82.0,13.0,18.0,14.0,11.0,1
2424,CC:2F:71:3E:C5:1F,3849740,485502408,1006,122934,3848734,485379474,3,4410,367442,3677,280418,733,87024,1065,14,1448,29,3,54,144444.0,39000.0,-71.0,-71.0,-68.0,-60.0,-70.0,-71.0,-67.0,-60.0,-85.0,-87.0,-82.0,-82.0,14.0,16.0,14.0,22.0,1
2425,BA:8C:B9:54:50:24,3853681,491575222,4947,6195748,3848734,485379474,7,9918,1763112,9896,1759617,22,3495,2361,18,5461,44,7,74,216660.0,130000.0,-48.0,-35.0,-43.0,-45.0,-45.0,-35.0,-44.0,-47.0,-85.0,-87.0,-82.0,-82.0,37.0,52.0,39.0,37.0,1
2426,62:47:05:9D:EB:15,3855501,497564010,6765,12184334,3848736,485379676,1,7086,3810381,7036,3802723,50,7658,3317,0,6840,56,1,126,216660.0,130000.0,-44.0,-45.0,-36.0,-47.0,-44.0,-45.0,-36.0,-46.0,-85.0,-87.0,-82.0,-82.0,41.0,42.0,46.0,35.0,1
2427,92:69:1D:31:68:E9,3852800,489034517,4064,3654841,3848736,485379676,1,5514,1166234,5339,1126441,175,39793,2209,12,4326,103,1,65,216660.0,130000.0,-51.0,-47.0,-43.0,-48.0,-51.0,-47.0,-44.0,-47.0,-85.0,-87.0,-82.0,-82.0,34.0,40.0,39.0,34.0,1
2428,CC:2F:71:3F:1F:24,5102160,1932071014,1253424,1446691338,3848736,485379676,2222,1054526,1206316540,1053668,1206212642,858,103898,1020260,15,1251559,121859,2219,814,144444.0,43333.0,-71.0,-68.0,-67.0,-70.0,-71.0,-68.0,-66.0,-70.0,-85.0,-87.0,-82.0,-82.0,14.0,19.0,15.0,12.0,1
2429,CC:2F:71:3E:C5:1F,3849742,485502610,1006,122934,3848736,485379676,3,4410,367442,3677,280418,733,87024,1065,14,1448,29,3,54,144444.0,39000.0,-71.0,-71.0,-68.0,-60.0,-70.0,-71.0,-67.0,-60.0,-85.0,-87.0,-82.0,-82.0,14.0,16.0,14.0,22.0,1
2430,BA:8C:B9:54:50:24,3853683,491575424,4947,6195748,3848736,485379676,7,9918,1763112,9896,1759617,22,3495,2361,18,5461,44,7,74,216660.0,130000.0,-48.0,-35.0,-43.0,-45.0,-45.0,-35.0,-44.0,-47.0,-85.0,-87.0,-82.0,-82.0,37.0,52.0,39.0,37.0,1
2431,62:47:05:9D:EB:15,3855508,497564676,6765,12184334,3848743,485380342,1,7086,3810381,7036,3802723,50,7658,3317,0,6840,56,1,126,216660.0,130000.0,-44.0,-45.0,-36.0,-47.0,-44.0,-45.0,-36.0,-46.0,-85.0,-87.0,-82.0,-82.0,41.0,42.0,46.0,35.0,1
2432,92:69:1D:31:68:E9,3852807,489035183,4064,3654841,3848743,485380342,1,5514,1166234,5339,1126441,175,39793,2209,12,4326,103,1,65,216660.0,130000.0,-51.0,-47.0,-43.0,-48.0,-51.0,-47.0,-44.0,-47.0,-85.0,-87.0,-82.0,-82.0,34.0,40.0,39.0,34.0,1
2433,CC:2F:71:3F:1F:24,5102368,1932319781,1253625,1446939439,3848743,485380342,2222,1054705,1206548756,1053847,1206444858,858,103898,1020437,15,1251760,121859,2219,814,144444.0,43333.0,-71.0,-69.0,-67.0,-70.0,-71.0,-69.0,-67.0,-70.0,-85.0,-87.0,-82.0,-82.0,14.0,18.0,15.0,12.0,1
2434,CC:2F:71:3E:C5:1F,3849749,485503276,1006,122934,3848743,485380342,3,4410,367442,3677,280418,733,87024,1065,14,1448,29,3,54,144444.0,39000.0,-71.0,-71.0,-68.0,-60.0,-70.0,-71.0,-67.0,-60.0,-85.0,-87.0,-82.0,-82.0,14.0,16.0,14.0,22.0,1
2435,BA:8C:B9:54:50:24,3853690,491576090,4947,6195748,3848743,485380342,7,9918,1763112,9896,1759617,22,3495,2361,18,5461,44,7,74,216660.0,130000.0,-48.0,-35.0,-43.0,-45.0,-45.0,-35.0,-44.0,-47.0,-85.0,-87.0,-82.0,-82.0,37.0,52.0,39.0,37.0,1
2436,62:47:05:9D:EB:15,3855510,497564878,6765,12184334,3848745,485380544,1,7086,3810381,7036,3802723,50,7658,3317,0,6840,56,1,126,216660.0,130000.0,-44.0,-45.0,-36.0,-47.0,-44.0,-45.0,-36.0,-46.0,-85.0,-87.0,-82.0,-82.0,41.0,42.0,46.0,35.0,1
2437,92:69:1D:31:68:E9,3852809,489035385,4064,3654841,3848745,485380544,1,5514,1166234,5339,1126441,175,39793,2209,12,4326,103,1,65,216660.0,130000.0,-51.0,-47.0,-43.0,-48.0,-51.0,-47.0,-44.0,-47.0,-85.0,-87.0,-82.0,-82.0,34.0,40.0,39.0,34.0,1
2438,CC:2F:71:3F:1F:24,5102559,1932559705,1253814,1447179161,3848745,485380544,2222,1054876,1206779592,1054018,1206675694,858,103898,1020604,15,1251949,121859,2219,814,144444.0,43333.0,-71.0,-69.0,-66.0,-71.0,-71.0,-69.0,-66.0,-70.0,-85.0,-87.0,-82.0,-82.0,14.0,18.0,16.0,11.0,1
2439,CC:2F:71:3E:C5:1F,3849751,485503478,1006,122934,3848745,485380544,3,4410,367442,3677,280418,733,87024,1065,14,1448,29,3,54,144444.0,39000.0,-71.0,-71.0,-68.0,-60.0,-70.0,-71.0,-67.0,-60.0,-85.0,-87.0,-82.0,-82.0,14.0,16.0,14.0,22.0,1
2440,BA:8C:B9:54:50:24,3853692,491576292,4947,6195748,3848745,485380544,7,9918,1763112,9896,1759617,22,3495,2361,18,5461,44,7,74,216660.0,130000.0,-48.0,-35.0,-43.0,-45.0,-45.0,-35.0,-44.0,-47.0,-85.0,-87.0,-82.0,-82.0,37.0,52.0,39.0,37.0,1
2441,62:47:05:9D:EB:15,3855517,497565546,6765,12184334,3848752,485381212,1,7087,3810449,7037,3802791,50,7658,3317,0,6840,56,1,126,216660.0,130000.0,-43.0,-44.0,-36.0,-47.0,-44.0,-45.0,-36.0,-46.0,-85.0,-87.0,-82.0,-82.0,42.0,43.0,46.0,35.0,1
2442,92:69:1D:31:68:E9,3852816,489036053,4064,3654841,3848752,485381212,1,5514,1166234,5339,1126441,175,39793,2209,12,4326,103,1,65,216660.0,130000.0,-51.0,-47.0,-43.0,-48.0,-51.0,-47.0,-44.0,-47.0,-85.0,-87.0,-82.0,-82.0,34.0,40.0,39.0,34.0,1
2443,CC:2F:71:3F:1F:24,5102757,1932803133,1254004,1447421861,3848753,485381272,2222,1055052,1207012590,1054193,1206908574,859,104016,1020777,15,1252139,121859,2219,814,144444.0,43333.0,-71.0,-69.0,-66.0,-71.0,-71.0,-68.0,-65.0,-71.0,-85.0,-87.0,-82.0,-82.0,14.0,18.0,16.0,11.0,1
2444,CC:2F:71:3E:C5:1F,3849759,485504206,1006,122934,3848753,485381272,3,4410,367442,3677,280418,733,87024,1065,14,1448,29,3,54,144444.0,39000.0,-71.0,-71.0,-68.0,-60.0,-70.0,-71.0,-67.0,-60.0,-85.0,-87.0,-82.0,-82.0,14.0,16.0,14.0,22.0,1
2445,BA:8C:B9:54:50:24,3853700,491577020,4947,6195748,3848753,485381272,7,9918,1763112,9896,1759617,22,3495,2361,18,5461,44,7,74,216660.0,130000.0,-48.0,-35.0,-43.0,-45.0,-45.0,-35.0,-44.0,-47.0,-85.0,-87.0,-82.0,-82.0,37.0,52.0,39.0,37.0,1
2446,62:47:05:9D:EB:15,3855520,497565808,6765,12184334,3848755,485381474,1,7087,3810449,7037,3802791,50,7658,3317,0,6840,56,1,126,216660.0,130000.0,-43.0,-44.0,-36.0,-47.0,-44.0,-45.0,-36.0,-46.0,-85.0,-86.0,-82.0,-82.0,42.0,42.0,46.0,35.0,1
2447,92:69:1D:31:68:E9,3852819,489036315,4064,3654841,3848755,485381474,1,5514,1166234,5339,1126441,175,39793,2209,12,4326,103,1,65,216660.0,130000.0,-51.0,-47.0,-43.0,-48.0,-51.0,-47.0,-44.0,-47.0,-85.0,-86.0,-82.0,-82.0,34.0,39.0,39.0,34.0,1
2448,CC:2F:71:3F:1F:24,5102957,1933051188,1254202,1447669714,3848755,485381474,2222,1055236,1207249853,1054377,1207145837,859,104016,1020956,15,1252337,121861,2219,814,144444.0,43333.0,-71.0,-68.0,-66.0,-70.0,-71.0,-68.0,-66.0,-70.0,-85.0,-86.0,-82.0,-82.0,14.0,18.0,16.0,12.0,1
2449,CC:2F:71:3E:C5:1F,3849761,485504408,1006,122934,3848755,485381474,3,4412,367582,3679,280558,733,87024,1065,14,1449,29,3,54,144444.0,39000.0,-71.0,-71.0,-68.0,-60.0,-70.0,-71.0,-67.0,-60.0,-85.0,-86.0,-82.0,-82.0,14.0,15.0,14.0,22.0,1
2450,BA:8C:B9:54:50:24,3853702,491577222,4947,6195748,3848755,485381474,7,9920,1763248,9898,1759753,22,3495,2361,18,5462,44,7,74,216660.0,130000.0,-40.0,-37.0,-46.0,-51.0,-45.0,-35.0,-44.0,-47.0,-85.0,-86.0,-82.0,-82.0,45.0,49.0,36.0,31.0,1
2451,62:47:05:9D:EB:15,3855526,497566414,6765,12184334,3848761,485382080,1,7087,3810449,7037,3802791,50,7658,3317,0,6840,56,1,126,216660.0,130000.0,-43.0,-44.0,-36.0,-47.0,-44.0,-45.0,-36.0,-46.0,-85.0,-86.0,-82.0,-82.0,42.0,42.0,46.0,35.0,1
2452,92:69:1D:31:68:E9,3852825,489036921,4064,3654841,3848761,485382080,1,5516,1166370,5341,1126577,175,39793,2209,12,4327,103,1,65,216660.0,130000.0,-52.0,-50.0,-48.0,-49.0,-51.0,-47.0,-44.0,-48.0,-85.0,-86.0,-82.0,-82.0,33.0,36.0,34.0,33.0,1
2453,CC:2F:71:3F:1F:24,5103154,1933293200,1254393,1447911120,3848761,485382080,2222,1055407,1207477883,1054548,1207373867,859,104016,1021126,15,1252528,121861,2219,814,144444.0,43333.0,-71.0,-69.0,-66.0,-72.0,-71.0,-69.0,-66.0,-71.0,-85.0,-86.0,-82.0,-82.0,14.0,17.0,16.0,10.0,1
2454,CC:2F:71:3E:C5:1F,3849767,485505014,1006,122934,3848761,485382080,3,4412,367582,3679,280558,733,87024,1065,14,1449,29,3,54,144444.0,39000.0,-71.0,-71.0,-68.0,-60.0,-70.0,-71.0,-67.0,-60.0,-85.0,-86.0,-82.0,-82.0,14.0,15.0,14.0,22.0,1
2455,BA:8C:B9:54:50:24,3853708,491577828,4947,6195748,3848761,485382080,7,9920,1763248,9898,1759753,22,3495,2361,18,5462,44,7,74,216660.0,130000.0,-40.0,-37.0,-46.0,-51.0,-45.0,-35.0,-44.0,-47.0,-85.0,-86.0,-82.0,-82.0,45.0,49.0,36.0,31.0,1
2456,62:47:05:9D:EB:15,3855529,497566676,6765,12184334,3848764,485382342,1,7087,3810449,7037,3802791,50,7658,3317,0,6840,56,1,126,216660.0,130000.0,-43.0,-44.0,-36.0,-47.0,-44.0,-45.0,-36.0,-46.0,-85.0,-86.0,-82.0,-82.0,42.0,42.0,46.0,35.0,1
2457,92:69:1D:31:68:E9,3852828,489037183,4064,3654841,3848764,485382342,1,5516,1166370,5341,1126577,175,39793,2209,12,4327,103,1,65,216660.0,130000.0,-52.0,-50.0,-48.0,-49.0,-51.0,-47.0,-44.0,-48.0,-85.0,-86.0,-82.0,-82.0,33.0,36.0,34.0,33.0,1
2458,CC:2F:71:3F:1F:24,5103347,1933534738,1254583,1448152396,3848764,485382342,2222,1055578,1207705829,1054719,1207601813,859,104016,1021296,15,1252718,121861,2219,814,144444.0,43333.0,-72.0,-69.0,-66.0,-71.0,-71.0,-69.0,-66.0,-71.0,-85.0,-86.0,-82.0,-82.0,13.0,17.0,16.0,11.0,1
2459,CC:2F:71:3E:C5:1F,3849770,485505276,1006,122934,3848764,485382342,3,4412,367582,3679,280558,733,87024,1065,14,1449,29,3,54,144444.0,39000.0,-71.0,-71.0,-68.0,-60.0,-70.0,-71.0,-67.0,-60.0,-85.0,-86.0,-82.0,-82.0,14.0,15.0,14.0,22.0,1
2460,BA:8C:B9:54:50:24,3853711,491578090,4947,6195748,3848764,485382342,7,9921,1763316,9899,1759821,22,3495,2361,18,5462,44,7,74,216660.0,130000.0,-40.0,-37.0,-46.0,-51.0,-44.0,-36.0,-44.0,-48.0,-85.0,-86.0,-82.0,-82.0,45.0,49.0,36.0,31.0,1
2461,62:47:05:9D:EB:15,3855536,497567555,6765,12184334,3848771,485383221,1,7087,3810449,7037,3802791,50,7658,3317,0,6840,56,1,126,216660.0,130000.0,-43.0,-44.0,-36.0,-47.0,-44.0,-45.0,-36.0,-46.0,-85.0,-86.0,-82.0,-82.0,42.0,42.0,46.0,35.0,1
2462,92:69:1D:31:68:E9,3852835,489038062,4064,3654841,3848771,485383221,1,5516,1166370,5341,1126577,175,39793,2209,12,4327,103,1,65,216660.0,130000.0,-52.0,-50.0,-48.0,-49.0,-51.0,-47.0,-44.0,-48.0,-85.0,-86.0,-82.0,-82.0,33.0,36.0,34.0,33.0,1
2463,CC:2F:71:3F:1F:24,5103544,1933775469,1254773,1448392248,3848771,485383221,2222,1055746,1207930565,1054887,1207826549,859,104016,1021464,15,1252908,121863,2219,814,144444.0,43333.0,-71.0,-69.0,-67.0,-71.0,-71.0,-69.0,-66.0,-71.0,-85.0,-86.0,-82.0,-82.0,14.0,17.0,15.0,11.0,1
2464,CC:2F:71:3E:C5:1F,3849777,485506155,1006,122934,3848771,485383221,3,4412,367582,3679,280558,733,87024,1065,14,1449,29,3,54,144444.0,39000.0,-71.0,-71.0,-68.0,-60.0,-70.0,-71.0,-67.0,-60.0,-85.0,-86.0,-82.0,-82.0,14.0,15.0,14.0,22.0,1
2465,BA:8C:B9:54:50:24,3853720,491579171,4947,6195748,3848773,485383423,7,9921,1763316,9899,1759821,22,3495,2361,18,5462,44,7,74,216660.0,130000.0,-40.0,-37.0,-46.0,-51.0,-44.0,-36.0,-44.0,-48.0,-85.0,-86.0,-82.0,-82.0,45.0,49.0,36.0,31.0,1
2466,62:47:05:9D:EB:15,3855538,497567757,6765,12184334,3848773,485383423,1,7087,3810449,7037,3802791,50,7658,3317,0,6840,56,1,126,216660.0,130000.0,-43.0,-44.0,-36.0,-47.0,-44.0,-45.0,-36.0,-46.0,-85.0,-86.0,-82.0,-82.0,42.0,42.0,46.0,35.0,1
2467,92:69:1D:31:68:E9,3852837,489038264,4064,3654841,3848773,485383423,1,5516,1166370,5341,1126577,175,39793,2209,12,4327,103,1,65,216660.0,130000.0,-52.0,-50.0,-48.0,-49.0,-51.0,-47.0,-44.0,-48.0,-85.0,-86.0,-82.0,-82.0,33.0,36.0,34.0,33.0,1
2468,CC:2F:71:3F:1F:24,5103745,1934022032,1254971,1448638549,3848774,485383483,2222,1055930,1208167857,1055071,1208063841,859,104016,1021640,15,1253106,121864,2219,814,144444.0,43333.0,-71.0,-69.0,-67.0,-71.0,-71.0,-69.0,-66.0,-71.0,-85.0,-86.0,-82.0,-82.0,14.0,17.0,15.0,11.0,1
2469,CC:2F:71:3E:C5:1F,3849780,485506417,1006,122934,3848774,485383483,3,4412,367582,3679,280558,733,87024,1065,14,1449,29,3,54,144444.0,39000.0,-71.0,-71.0,-68.0,-60.0,-70.0,-71.0,-67.0,-60.0,-85.0,-86.0,-82.0,-82.0,14.0,15.0,14.0,22.0,1
2470,BA:8C:B9:54:50:24,3853721,491579231,4947,6195748,3848774,485383483,7,9921,1763316,9899,1759821,22,3495,2361,18,5462,44,7,74,216660.0,130000.0,-40.0,-37.0,-46.0,-51.0,-44.0,-36.0,-44.0,-48.0,-85.0,-86.0,-82.0,-82.0,45.0,49.0,36.0,31.0,1
2471,62:47:05:9D:EB:15,3855545,497568423,6765,12184334,3848780,485384089,1,7087,3810449,7037,3802791,50,7658,3317,0,6840,56,1,126,216660.0,130000.0,-43.0,-44.0,-36.0,-47.0,-44.0,-45.0,-36.0,-46.0,-85.0,-86.0,-82.0,-82.0,42.0,42.0,46.0,35.0,1
2472,92:69:1D:31:68:E9,3852844,489038930,4064,3654841,3848780,485384089,1,5516,1166370,5341,1126577,175,39793,2209,12,4327,103,1,65,216660.0,130000.0,-52.0,-50.0,-48.0,-49.0,-51.0,-47.0,-44.0,-48.0,-85.0,-86.0,-82.0,-82.0,33.0,36.0,34.0,33.0,1
2473,CC:2F:71:3F:1F:24,5103942,1934263986,1255160,1448879695,3848782,485384291,2222,1056106,1208402433,1055247,1208298417,859,104016,1021808,15,1253295,121864,2219,814,144444.0,43333.0,-71.0,-69.0,-66.0,-71.0,-71.0,-68.0,-66.0,-71.0,-85.0,-86.0,-82.0,-82.0,14.0,17.0,16.0,11.0,1
2474,CC:2F:71:3E:C5:1F,3849788,485507225,1006,122934,3848782,485384291,3,4412,367582,3679,280558,733,87024,1065,14,1449,29,3,54,144444.0,39000.0,-71.0,-71.0,-68.0,-60.0,-70.0,-71.0,-67.0,-60.0,-85.0,-86.0,-82.0,-82.0,14.0,15.0,14.0,22.0,1
2475,BA:8C:B9:54:50:24,3853729,491580039,4947,6195748,3848782,485384291,7,9921,1763316,9899,1759821,22,3495,2361,18,5462,44,7,74,216660.0,130000.0,-40.0,-37.0,-46.0,-51.0,-44.0,-36.0,-44.0,-48.0,-85.0,-86.0,-82.0,-82.0,45.0,49.0,36.0,31.0,1
2476,62:47:05:9D:EB:15,3855547,497568625,6765,12184334,3848782,485384291,1,7087,3810449,7037,3802791,50,7658,3317,0,6840,56,1,126,216660.0,130000.0,-43.0,-44.0,-36.0,-47.0,-44.0,-45.0,-36.0,-46.0,-85.0,-86.0,-82.0,-82.0,42.0,42.0,46.0,35.0,1
2477,92:69:1D:31:68:E9,3852846,489039132,4064,3654841,3848782,485384291,1,5516,1166370,5341,1126577,175,39793,2209,12,4327,103,1,65,216660.0,130000.0,-52.0,-50.0,-48.0,-49.0,-51.0,-47.0,-44.0,-48.0,-85.0,-86.0,-82.0,-82.0,33.0,36.0,34.0,33.0,1
2478,CC:2F:71:3F:1F:24,5104132,1934505262,1255350,1449120971,3848782,485384291,2222,1056283,1208639717,1055424,1208535701,859,104016,1021977,15,1253485,121864,2219,814,144444.0,43333.0,-70.0,-68.0,-66.0,-71.0,-70.0,-69.0,-66.0,-71.0,-85.0,-86.0,-82.0,-82.0,15.0,18.0,16.0,11.0,1
2479,CC:2F:71:3E:C5:1F,3849788,485507225,1006,122934,3848782,485384291,3,4412,367582,3679,280558,733,87024,1065,14,1449,29,3,54,144444.0,39000.0,-71.0,-71.0,-68.0,-60.0,-70.0,-71.0,-67.0,-60.0,-85.0,-86.0,-82.0,-82.0,14.0,15.0,14.0,22.0,1
2480,BA:8C:B9:54:50:24,3853733,491580443,4947,6195748,3848786,485384695,7,9921,1763316,9899,1759821,22,3495,2361,18,5462,44,7,74,216660.0,130000.0,-40.0,-37.0,-46.0,-51.0,-44.0,-36.0,-44.0,-48.0,-85.0,-86.0,-82.0,-82.0,45.0,49.0,36.0,31.0,1
2481,62:47:05:9D:EB:15,3855554,497569291,6765,12184334,3848789,485384957,1,7087,3810449,7037,3802791,50,7658,3317,0,6840,56,1,126,216660.0,130000.0,-43.0,-44.0,-36.0,-47.0,-44.0,-45.0,-36.0,-46.0,-85.0,-86.0,-82.0,-82.0,42.0,42.0,46.0,35.0,1
2482,92:69:1D:31:68:E9,3852855,489040000,4064,3654841,3848791,485385159,1,5516,1166370,5341,1126577,175,39793,2209,12,4327,103,1,65,216660.0,130000.0,-52.0,-50.0,-48.0,-49.0,-51.0,-47.0,-44.0,-48.0,-85.0,-86.0,-82.0,-82.0,33.0,36.0,34.0,33.0,1
2483,CC:2F:71:3F:1F:24,5104332,1934747536,1255541,1449362377,3848791,485385159,2222,1056453,1208867701,1055594,1208763685,859,104016,1022145,15,1253675,121864,2219,814,144444.0,43333.0,-71.0,-69.0,-66.0,-71.0,-71.0,-69.0,-66.0,-71.0,-85.0,-86.0,-82.0,-82.0,14.0,17.0,16.0,11.0,1
2484,CC:2F:71:3E:C5:1F,3849797,485508093,1006,122934,3848791,485385159,3,4412,367582,3679,280558,733,87024,1065,14,1449,29,3,54,144444.0,39000.0,-71.0,-71.0,-68.0,-60.0,-70.0,-71.0,-67.0,-60.0,-85.0,-86.0,-82.0,-82.0,14.0,15.0,14.0,22.0,1
2485,BA:8C:B9:54:50:24,3853738,491580907,4947,6195748,3848791,485385159,7,9921,1763316,9899,1759821,22,3495,2361,18,5462,44,7,74,216660.0,130000.0,-40.0,-37.0,-46.0,-51.0,-44.0,-36.0,-44.0,-48.0,-85.0,-86.0,-82.0,-82.0,45.0,49.0,36.0,31.0,1
2486,62:47:05:9D:EB:15,3855556,497569493,6765,12184334,3848791,485385159,1,7087,3810449,7037,3802791,50,7658,3317,0,6840,56,1,126,216660.0,130000.0,-43.0,-44.0,-36.0,-47.0,-44.0,-45.0,-36.0,-46.0,-85.0,-86.0,-82.0,-82.0,42.0,42.0,46.0,35.0,1
2487,92:69:1D:31:68:E9,3852855,489040000,4064,3654841,3848791,485385159,1,5516,1166370,5341,1126577,175,39793,2209,12,4327,103,1,65,216660.0,130000.0,-52.0,-50.0,-48.0,-49.0,-51.0,-47.0,-44.0,-48.0,-85.0,-86.0,-82.0,-82.0,33.0,36.0,34.0,33.0,1
2488,CC:2F:71:3F:1F:24,5104527,1934989007,1255736,1449603848,3848791,485385159,2222,1056637,1209105166,1055778,1209001150,859,104016,1022320,15,1253871,121867,2219,814,144444.0,43333.0,-71.0,-69.0,-67.0,-71.0,-71.0,-69.0,-66.0,-71.0,-85.0,-86.0,-82.0,-82.0,14.0,17.0,15.0,11.0,1
2489,CC:2F:71:3E:C5:1F,3849801,485508497,1006,122934,3848795,485385563,3,4412,367582,3679,280558,733,87024,1065,14,1449,29,3,54,144444.0,39000.0,-71.0,-71.0,-68.0,-60.0,-70.0,-71.0,-67.0,-60.0,-85.0,-86.0,-82.0,-82.0,14.0,15.0,14.0,22.0,1
2490,BA:8C:B9:54:50:24,3853742,491581311,4947,6195748,3848795,485385563,7,9921,1763316,9899,1759821,22,3495,2361,18,5462,44,7,74,216660.0,130000.0,-40.0,-37.0,-46.0,-51.0,-44.0,-36.0,-44.0,-48.0,-85.0,-86.0,-82.0,-82.0,45.0,49.0,36.0,31.0,1
2491,62:47:05:9D:EB:15,3855564,497570301,6765,12184334,3848799,485385967,1,7087,3810449,7037,3802791,50,7658,3317,0,6840,56,1,126,216660.0,130000.0,-43.0,-44.0,-36.0,-47.0,-44.0,-45.0,-36.0,-46.0,-85.0,-86.0,-82.0,-82.0,42.0,42.0,46.0,35.0,1
2492,92:69:1D:31:68:E9,3852863,489040808,4064,3654841,3848799,485385967,1,5516,1166370,5341,1126577,175,39793,2209,12,4327,103,1,65,216660.0,130000.0,-52.0,-50.0,-48.0,-49.0,-51.0,-47.0,-44.0,-48.0,-85.0,-86.0,-82.0,-82.0,33.0,36.0,34.0,33.0,1
2493,CC:2F:71:3F:1F:24,5104730,1935234519,1255930,1449848492,3848800,485386027,2222,1056812,1209342176,1055953,1209238160,859,104016,1022490,15,1254065,121867,2219,814,144444.0,43333.0,-70.0,-69.0,-66.0,-72.0,-70.0,-68.0,-66.0,-71.0,-85.0,-86.0,-82.0,-82.0,15.0,17.0,16.0,10.0,1
2494,CC:2F:71:3E:C5:1F,3849806,485508961,1006,122934,3848800,485386027,3,4412,367582,3679,280558,733,87024,1065,14,1449,29,3,54,144444.0,39000.0,-71.0,-71.0,-68.0,-60.0,-70.0,-71.0,-67.0,-60.0,-85.0,-86.0,-82.0,-82.0,14.0,15.0,14.0,22.0,1
2495,BA:8C:B9:54:50:24,3853747,491581775,4947,6195748,3848800,485386027,7,9921,1763316,9899,1759821,22,3495,2361,18,5462,44,7,74,216660.0,130000.0,-40.0,-37.0,-46.0,-51.0,-44.0,-36.0,-44.0,-48.0,-85.0,-86.0,-82.0,-82.0,45.0,49.0,36.0,31.0,1
2496,62:47:05:9D:EB:15,3855565,497570361,6765,12184334,3848800,485386027,1,7087,3810449,7037,3802791,50,7658,3317,0,6840,56,1,126,216660.0,130000.0,-43.0,-44.0,-36.0,-47.0,-44.0,-45.0,-36.0,-46.0,-85.0,-86.0,-82.0,-82.0,42.0,42.0,46.0,35.0,1
2497,92:69:1D:31:68:E9,3852864,489040868,4064,3654841,3848800,485386027,1,5516,1166370,5341,1126577,175,39793,2209,12,4327,103,1,65,216660.0,130000.0,-52.0,-50.0,-48.0,-49.0,-51.0,-47.0,-44.0,-48.0,-85.0,-86.0,-82.0,-82.0,33.0,36.0,34.0,33.0,1
2498,CC:2F:71:3F:1F:24,5104925,1935476329,1256121,1450089898,3848804,485386431,2222,1056985,1209576106,1056126,1209472090,859,104016,1022658,15,1254256,121871,2219,814,144444.0,43333.0,-70.0,-69.0,-66.0,-71.0,-70.0,-69.0,-65.0,-71.0,-85.0,-86.0,-82.0,-82.0,15.0,17.0,16.0,11.0,1
2499,CC:2F:71:3E:C5:1F,3849810,485509365,1006,122934,3848804,485386431,3,4412,367582,3679,280558,733,87024,1065,14,1449,29,3,54,144444.0,39000.0,-71.0,-71.0,-68.0,-60.0,-70.0,-71.0,-67.0,-60.0,-85.0,-86.0,-82.0,-82.0,14.0,15.0,14.0,22.0,1
2500,BA:8C:B9:54:50:24,3853751,491582179,4947,6195748,3848804,485386431,7,9921,1763316,9899,1759821,22,3495,2361,18,5462,44,7,74,216660.0,130000.0,-40.0,-37.0,-46.0,-51.0,-44.0,-36.0,-44.0,-48.0,-85.0,-86.0,-82.0,-82.0,45.0,49.0,36.0,31.0,1
2501,62:47:05:9D:EB:15,3855573,497571169,6765,12184334,3848808,485386835,1,7087,3810449,7037,3802791,50,7658,3317,0,6840,56,1,126,216660.0,130000.0,-43.0,-44.0,-36.0,-47.0,-44.0,-45.0,-36.0,-46.0,-85.0,-86.0,-82.0,-82.0,42.0,42.0,46.0,35.0,1
2502,92:69:1D:31:68:E9,3852872,489041676,4064,3654841,3848808,485386835,1,5516,1166370,5341,1126577,175,39793,2209,12,4327,103,1,65,216660.0,130000.0,-52.0,-50.0,-48.0,-49.0,-51.0,-47.0,-44.0,-48.0,-85.0,-86.0,-82.0,-82.0,33.0,36.0,34.0,33.0,1
2503,CC:2F:71:3F:1F:24,5105122,1935721247,1256314,1450334412,3848808,485386835,2222,1057162,1209816238,1056303,1209712222,859,104016,1022827,15,1254449,121871,2219,814,144444.0,43333.0,-70.0,-69.0,-66.0,-71.0,-70.0,-68.0,-66.0,-71.0,-85.0,-86.0,-82.0,-82.0,15.0,17.0,16.0,11.0,1
2504,CC:2F:71:3E:C5:1F,3849814,485509769,1006,122934,3848808,485386835,3,4412,367582,3679,280558,733,87024,1065,14,1449,29,3,54,144444.0,39000.0,-71.0,-71.0,-68.0,-60.0,-70.0,-71.0,-67.0,-60.0,-85.0,-86.0,-82.0,-82.0,14.0,15.0,14.0,22.0,1
2505,BA:8C:B9:54:50:24,3853755,491582583,4947,6195748,3848808,485386835,7,9921,1763316,9899,1759821,22,3495,2361,18,5462,44,7,74,216660.0,130000.0,-40.0,-37.0,-46.0,-51.0,-44.0,-36.0,-44.0,-48.0,-85.0,-86.0,-82.0,-82.0,45.0,49.0,36.0,31.0,1
2506,62:47:05:9D:EB:15,3855576,497571431,6765,12184334,3848811,485387097,1,7087,3810449,7037,3802791,50,7658,3317,0,6840,56,1,126,216660.0,130000.0,-43.0,-44.0,-36.0,-47.0,-44.0,-45.0,-36.0,-46.0,-85.0,-86.0,-82.0,-82.0,42.0,42.0,46.0,35.0,1
2507,92:69:1D:31:68:E9,3852877,489042140,4064,3654841,3848813,485387299,1,5516,1166370,5341,1126577,175,39793,2209,12,4327,103,1,65,216660.0,130000.0,-52.0,-50.0,-48.0,-49.0,-51.0,-47.0,-44.0,-48.0,-85.0,-86.0,-82.0,-82.0,33.0,36.0,34.0,33.0,1
2508,CC:2F:71:3F:1F:24,5105325,1935966588,1256512,1450579289,3848813,485387299,2222,1057346,1210052213,1056487,1209948197,859,104016,1023001,15,1254647,121871,2219,814,144444.0,43333.0,-70.0,-69.0,-65.0,-71.0,-70.0,-68.0,-65.0,-71.0,-85.0,-86.0,-82.0,-82.0,15.0,17.0,17.0,11.0,1
2509,CC:2F:71:3E:C5:1F,3849819,485510233,1006,122934,3848813,485387299,3,4412,367582,3679,280558,733,87024,1065,14,1449,29,3,54,144444.0,39000.0,-71.0,-71.0,-68.0,-60.0,-70.0,-71.0,-67.0,-60.0,-85.0,-86.0,-82.0,-82.0,14.0,15.0,14.0,22.0,1
2510,BA:8C:B9:54:50:24,3853760,491583047,4947,6195748,3848813,485387299,7,9921,1763316,9899,1759821,22,3495,2361,18,5462,44,7,74,216660.0,130000.0,-40.0,-37.0,-46.0,-51.0,-44.0,-36.0,-44.0,-48.0,-85.0,-86.0,-82.0,-82.0,45.0,49.0,36.0,31.0,1
2511,62:47:05:9D:EB:15,3855582,497572037,6765,12184334,3848817,485387703,1,7087,3810449,7037,3802791,50,7658,3317,0,6840,56,1,126,216660.0,130000.0,-43.0,-44.0,-36.0,-47.0,-44.0,-45.0,-36.0,-46.0,-85.0,-86.0,-82.0,-82.0,42.0,42.0,46.0,35.0,1
2512,92:69:1D:31:68:E9,3852882,489042660,4065,3654957,3848817,485387703,1,5518,1166506,5343,1126713,175,39793,2209,12,4328,103,1,65,216660.0,130000.0,-51.0,-47.0,-45.0,-47.0,-51.0,-47.0,-44.0,-48.0,-85.0,-86.0,-82.0,-82.0,34.0,39.0,37.0,35.0,1
2513,CC:2F:71:3F:1F:24,5105520,1936208384,1256703,1450820681,3848817,485387703,2222,1057522,1210289449,1056663,1210185433,859,104016,1023171,15,1254838,121873,2219,814,144444.0,43333.0,-70.0,-69.0,-67.0,-72.0,-70.0,-68.0,-66.0,-71.0,-85.0,-86.0,-82.0,-82.0,15.0,17.0,15.0,10.0,1
2514,CC:2F:71:3E:C5:1F,3849824,485510753,1007,123050,3848817,485387703,3,4414,367722,3681,280698,733,87024,1065,14,1450,30,3,54,144444.0,39000.0,-71.0,-71.0,-69.0,-61.0,-70.0,-71.0,-68.0,-60.0,-85.0,-86.0,-82.0,-82.0,14.0,15.0,13.0,21.0,1
2515,BA:8C:B9:54:50:24,3853765,491583567,4948,6195864,3848817,485387703,7,9923,1763452,9901,1759957,22,3495,2361,18,5463,44,7,74,216660.0,130000.0,-48.0,-35.0,-43.0,-45.0,-45.0,-35.0,-44.0,-47.0,-85.0,-86.0,-82.0,-82.0,37.0,51.0,39.0,37.0,1
2516,62:47:05:9D:EB:15,3855587,497572557,6766,12184450,3848821,485388107,1,7089,3810585,7039,3802927,50,7658,3317,0,6841,56,1,126,229410.0,130000.0,-44.0,-45.0,-35.0,-48.0,-44.0,-45.0,-37.0,-47.0,-85.0,-86.0,-82.0,-82.0,41.0,41.0,47.0,34.0,1
2517,92:69:1D:31:68:E9,3852886,489043064,4065,3654957,3848821,485388107,1,5518,1166506,5343,1126713,175,39793,2209,12,4328,103,1,65,216660.0,130000.0,-51.0,-47.0,-45.0,-47.0,-51.0,-47.0,-44.0,-48.0,-85.0,-86.0,-82.0,-82.0,34.0,39.0,37.0,35.0,1
2518,CC:2F:71:3F:1F:24,5105719,1936456412,1256898,1451068305,3848821,485388107,2222,1057706,1210536155,1056847,1210432139,859,104016,1023345,15,1255033,121874,2219,814,144444.0,43333.0,-71.0,-68.0,-66.0,-72.0,-70.0,-68.0,-66.0,-71.0,-85.0,-86.0,-82.0,-82.0,14.0,18.0,16.0,10.0,1
2519,CC:2F:71:3E:C5:1F,3849829,485511217,1007,123050,3848822,485388167,3,4414,367722,3681,280698,733,87024,1065,14,1450,30,3,54,144444.0,39000.0,-71.0,-71.0,-69.0,-61.0,-70.0,-71.0,-68.0,-60.0,-85.0,-86.0,-82.0,-82.0,14.0,15.0,13.0,21.0,1
2520,BA:8C:B9:54:50:24,3853770,491584031,4948,6195864,3848822,485388167,7,9923,1763452,9901,1759957,22,3495,2361,18,5463,44,7,74,216660.0,130000.0,-48.0,-35.0,-43.0,-45.0,-45.0,-35.0,-44.0,-47.0,-85.0,-86.0,-82.0,-82.0,37.0,51.0,39.0,37.0,1
2521,62:47:05:9D:EB:15,3855592,497573021,6766,12184450,3848826,485388571,1,7089,3810585,7039,3802927,50,7658,3317,0,6841,56,1,126,229410.0,130000.0,-44.0,-45.0,-35.0,-48.0,-44.0,-45.0,-37.0,-47.0,-85.0,-86.0,-82.0,-82.0,41.0,41.0,47.0,34.0,1
2522,92:69:1D:31:68:E9,3852891,489043528,4065,3654957,3848826,485388571,1,5518,1166506,5343,1126713,175,39793,2209,12,4328,103,1,65,216660.0,130000.0,-51.0,-47.0,-45.0,-47.0,-51.0,-47.0,-44.0,-48.0,-85.0,-86.0,-82.0,-82.0,34.0,39.0,37.0,35.0,1
2523,CC:2F:71:3F:1F:24,5105921,1936701639,1257095,1451313068,3848826,485388571,2222,1057889,1210773346,1057030,1210669330,859,104016,1023520,15,1255230,121874,2219,814,144444.0,43333.0,-71.0,-68.0,-66.0,-71.0,-70.0,-68.0,-66.0,-71.0,-85.0,-86.0,-82.0,-82.0,14.0,18.0,16.0,11.0,1
2524,CC:2F:71:3E:C5:1F,3849833,485511621,1007,123050,3848826,485388571,3,4414,367722,3681,280698,733,87024,1065,14,1450,30,3,54,144444.0,39000.0,-71.0,-71.0,-69.0,-61.0,-70.0,-71.0,-68.0,-60.0,-85.0,-86.0,-82.0,-82.0,14.0,15.0,13.0,21.0,1
2525,BA:8C:B9:54:50:24,3853774,491584435,4948,6195864,3848826,485388571,7,9923,1763452,9901,1759957,22,3495,2361,18,5463,44,7,74,216660.0,130000.0,-48.0,-35.0,-43.0,-45.0,-45.0,-35.0,-44.0,-47.0,-85.0,-86.0,-82.0,-82.0,37.0,51.0,39.0,37.0,1
2526,62:47:05:9D:EB:15,3855598,497573760,6766,12184450,3848832,485389310,1,7089,3810585,7039,3802927,50,7658,3317,0,6841,56,1,126,229410.0,130000.0,-44.0,-45.0,-35.0,-48.0,-44.0,-45.0,-37.0,-47.0,-85.0,-86.0,-82.0,-82.0,41.0,41.0,47.0,34.0,1
2527,92:69:1D:31:68:E9,3852897,489044267,4065,3654957,3848832,485389310,1,5518,1166506,5343,1126713,175,39793,2209,12,4328,103,1,65,216660.0,130000.0,-51.0,-47.0,-45.0,-47.0,-51.0,-47.0,-44.0,-48.0,-85.0,-86.0,-82.0,-82.0,34.0,39.0,37.0,35.0,1
2528,CC:2F:71:3F:1F:24,5106118,1936943800,1257286,1451554490,3848832,485389310,2222,1058067,1211010842,1057207,1210906708,860,104134,1023689,15,1255421,121874,2219,814,144444.0,43333.0,-70.0,-69.0,-66.0,-71.0,-70.0,-68.0,-66.0,-71.0,-85.0,-86.0,-82.0,-82.0,15.0,17.0,16.0,11.0,1
2529,CC:2F:71:3E:C5:1F,3849839,485512360,1007,123050,3848832,485389310,3,4414,367722,3681,280698,733,87024,1065,14,1450,30,3,54,144444.0,39000.0,-71.0,-71.0,-69.0,-61.0,-70.0,-71.0,-68.0,-60.0,-85.0,-86.0,-82.0,-82.0,14.0,15.0,13.0,21.0,1
2530,BA:8C:B9:54:50:24,3853780,491585174,4948,6195864,3848832,485389310,7,9923,1763452,9901,1759957,22,3495,2361,18,5463,44,7,74,216660.0,130000.0,-48.0,-35.0,-43.0,-45.0,-45.0,-35.0,-44.0,-47.0,-85.0,-86.0,-82.0,-82.0,37.0,51.0,39.0,37.0,1
2531,62:47:05:9D:EB:15,3855603,497574224,6766,12184450,3848837,485389774,1,7089,3810585,7039,3802927,50,7658,3317,0,6841,56,1,126,229410.0,130000.0,-44.0,-45.0,-35.0,-48.0,-44.0,-45.0,-37.0,-47.0,-85.0,-86.0,-82.0,-82.0,41.0,41.0,47.0,34.0,1
2532,92:69:1D:31:68:E9,3852902,489044731,4065,3654957,3848837,485389774,1,5518,1166506,5343,1126713,175,39793,2209,12,4328,103,1,65,216660.0,130000.0,-51.0,-47.0,-45.0,-47.0,-51.0,-47.0,-44.0,-48.0,-85.0,-86.0,-82.0,-82.0,34.0,39.0,37.0,35.0,1
2533,CC:2F:71:3F:1F:24,5106312,1937185426,1257475,1451795652,3848837,485389774,2222,1058240,1211244786,1057380,1211140652,860,104134,1023856,15,1255610,121874,2219,814,144444.0,43333.0,-70.0,-69.0,-67.0,-72.0,-70.0,-69.0,-67.0,-71.0,-85.0,-86.0,-82.0,-82.0,15.0,17.0,15.0,10.0,1
2534,CC:2F:71:3E:C5:1F,3849844,485512824,1007,123050,3848837,485389774,3,4414,367722,3681,280698,733,87024,1065,14,1450,30,3,54,144444.0,39000.0,-71.0,-71.0,-69.0,-61.0,-70.0,-71.0,-68.0,-60.0,-85.0,-86.0,-82.0,-82.0,14.0,15.0,13.0,21.0,1
2535,BA:8C:B9:54:50:24,3853785,491585638,4948,6195864,3848837,485389774,7,9923,1763452,9901,1759957,22,3495,2361,18,5463,44,7,74,216660.0,130000.0,-48.0,-35.0,-43.0,-45.0,-45.0,-35.0,-44.0,-47.0,-85.0,-86.0,-82.0,-82.0,37.0,51.0,39.0,37.0,1
2536,62:47:05:9D:EB:15,3855607,497574628,6766,12184450,3848841,485390178,1,7089,3810585,7039,3802927,50,7658,3317,0,6841,56,1,126,229410.0,130000.0,-44.0,-45.0,-35.0,-48.0,-44.0,-45.0,-37.0,-47.0,-85.0,-86.0,-82.0,-82.0,41.0,41.0,47.0,34.0,1
2537,92:69:1D:31:68:E9,3852906,489045135,4065,3654957,3848841,485390178,1,5518,1166506,5343,1126713,175,39793,2209,12,4328,103,1,65,216660.0,130000.0,-51.0,-47.0,-45.0,-47.0,-51.0,-47.0,-44.0,-48.0,-85.0,-86.0,-82.0,-82.0,34.0,39.0,37.0,35.0,1
2538,CC:2F:71:3F:1F:24,5106505,1937426992,1257664,1452036814,3848841,485390178,2222,1058417,1211483576,1057557,1211379442,860,104134,1024026,15,1255799,121874,2219,814,144444.0,43333.0,-70.0,-69.0,-66.0,-72.0,-70.0,-68.0,-66.0,-71.0,-85.0,-86.0,-82.0,-82.0,15.0,17.0,16.0,10.0,1
2539,CC:2F:71:3E:C5:1F,3849848,485513228,1007,123050,3848841,485390178,3,4414,367722,3681,280698,733,87024,1065,14,1450,30,3,54,144444.0,39000.0,-71.0,-71.0,-69.0,-61.0,-70.0,-71.0,-68.0,-60.0,-85.0,-86.0,-82.0,-82.0,14.0,15.0,13.0,21.0,1
2540,BA:8C:B9:54:50:24,3853789,491586042,4948,6195864,3848841,485390178,7,9923,1763452,9901,1759957,22,3495,2361,18,5463,44,7,74,216660.0,130000.0,-48.0,-35.0,-43.0,-45.0,-45.0,-35.0,-44.0,-47.0,-85.0,-86.0,-82.0,-82.0,37.0,51.0,39.0,37.0,1
2541,62:47:05:9D:EB:15,3855611,497575032,6766,12184450,3848845,485390582,1,7089,3810585,7039,3802927,50,7658,3317,0,6841,56,1,126,229410.0,130000.0,-44.0,-45.0,-35.0,-48.0,-44.0,-45.0,-37.0,-47.0,-85.0,-86.0,-82.0,-82.0,41.0,41.0,47.0,34.0,1
2542,92:69:1D:31:68:E9,3852910,489045539,4065,3654957,3848845,485390582,1,5518,1166506,5343,1126713,175,39793,2209,12,4328,103,1,65,216660.0,130000.0,-51.0,-47.0,-45.0,-47.0,-51.0,-47.0,-44.0,-48.0,-85.0,-86.0,-82.0,-82.0,34.0,39.0,37.0,35.0,1
2543,CC:2F:71:3F:1F:24,5106709,1937675327,1257863,1452284685,3848846,485390642,2222,1058598,1211720335,1057738,1211616201,860,104134,1024203,15,1255998,121874,2219,814,144444.0,43333.0,-71.0,-69.0,-66.0,-72.0,-71.0,-69.0,-66.0,-72.0,-85.0,-86.0,-82.0,-82.0,14.0,17.0,16.0,10.0,1
2544,CC:2F:71:3E:C5:1F,3849853,485513692,1007,123050,3848846,485390642,3,4414,367722,3681,280698,733,87024,1065,14,1450,30,3,54,144444.0,39000.0,-71.0,-71.0,-69.0,-61.0,-70.0,-71.0,-68.0,-60.0,-85.0,-86.0,-82.0,-82.0,14.0,15.0,13.0,21.0,1
2545,BA:8C:B9:54:50:24,3853794,491586506,4948,6195864,3848846,485390642,7,9923,1763452,9901,1759957,22,3495,2361,18,5463,44,7,74,216660.0,130000.0,-48.0,-35.0,-43.0,-45.0,-45.0,-35.0,-44.0,-47.0,-85.0,-86.0,-82.0,-82.0,37.0,51.0,39.0,37.0,1
2546,62:47:05:9D:EB:15,3855616,497575496,6766,12184450,3848850,485391046,1,7089,3810585,7039,3802927,50,7658,3317,0,6841,56,1,126,229410.0,130000.0,-44.0,-45.0,-35.0,-48.0,-44.0,-45.0,-37.0,-47.0,-85.0,-86.0,-82.0,-82.0,41.0,41.0,47.0,34.0,1
2547,92:69:1D:31:68:E9,3852915,489046003,4065,3654957,3848850,485391046,1,5518,1166506,5343,1126713,175,39793,2209,12,4328,103,1,65,216660.0,130000.0,-51.0,-47.0,-45.0,-47.0,-51.0,-47.0,-44.0,-48.0,-85.0,-86.0,-82.0,-82.0,34.0,39.0,37.0,35.0,1
2548,CC:2F:71:3F:1F:24,5106918,1937935987,1258066,1452544739,3848852,485391248,2222,1058789,1211979425,1057929,1211875291,860,104134,1024383,15,1256201,121878,2219,814,144444.0,43333.0,-71.0,-69.0,-67.0,-71.0,-70.0,-68.0,-66.0,-71.0,-85.0,-86.0,-82.0,-82.0,14.0,17.0,15.0,11.0,1
2549,CC:2F:71:3E:C5:1F,3849861,485514500,1007,123050,3848854,485391450,3,4414,367722,3681,280698,733,87024,1065,14,1450,30,3,54,144444.0,39000.0,-71.0,-71.0,-69.0,-61.0,-70.0,-71.0,-68.0,-60.0,-85.0,-86.0,-82.0,-82.0,14.0,15.0,13.0,21.0,1
2550,BA:8C:B9:54:50:24,3853802,491587314,4948,6195864,3848854,485391450,7,9923,1763452,9901,1759957,22,3495,2361,18,5463,44,7,74,216660.0,130000.0,-48.0,-35.0,-43.0,-45.0,-45.0,-35.0,-44.0,-47.0,-85.0,-86.0,-82.0,-82.0,37.0,51.0,39.0,37.0,1
2551,62:47:05:9D:EB:15,3855620,497575900,6766,12184450,3848854,485391450,1,7089,3810585,7039,3802927,50,7658,3317,0,6841,56,1,126,229410.0,130000.0,-44.0,-45.0,-35.0,-48.0,-44.0,-45.0,-37.0,-47.0,-85.0,-86.0,-82.0,-82.0,41.0,41.0,47.0,34.0,1
2552,92:69:1D:31:68:E9,3852919,489046407,4065,3654957,3848854,485391450,1,5518,1166506,5343,1126713,175,39793,2209,12,4328,103,1,65,216660.0,130000.0,-51.0,-47.0,-45.0,-47.0,-51.0,-47.0,-44.0,-48.0,-85.0,-86.0,-82.0,-82.0,34.0,39.0,37.0,35.0,1
2553,CC:2F:71:3F:1F:24,5107111,1938177595,1258257,1452786145,3848854,485391450,2222,1058963,1212214937,1058103,1212110803,860,104134,1024551,15,1256392,121879,2219,814,144444.0,43333.0,-71.0,-69.0,-67.0,-71.0,-71.0,-69.0,-66.0,-71.0,-85.0,-86.0,-82.0,-82.0,14.0,17.0,15.0,11.0,1
2554,CC:2F:71:3E:C5:1F,3849861,485514500,1007,123050,3848854,485391450,3,4414,367722,3681,280698,733,87024,1065,14,1450,30,3,54,144444.0,39000.0,-71.0,-71.0,-69.0,-61.0,-70.0,-71.0,-68.0,-60.0,-85.0,-86.0,-82.0,-82.0,14.0,15.0,13.0,21.0,1
2555,BA:8C:B9:54:50:24,3853802,491587314,4948,6195864,3848854,485391450,7,9923,1763452,9901,1759957,22,3495,2361,18,5463,44,7,74,216660.0,130000.0,-48.0,-35.0,-43.0,-45.0,-45.0,-35.0,-44.0,-47.0,-85.0,-86.0,-82.0,-82.0,37.0,51.0,39.0,37.0,1
2556,62:47:05:9D:EB:15,3855625,497576364,6766,12184450,3848859,485391914,1,7089,3810585,7039,3802927,50,7658,3317,0,6841,56,1,126,229410.0,130000.0,-44.0,-45.0,-35.0,-48.0,-44.0,-45.0,-37.0,-47.0,-85.0,-86.0,-82.0,-82.0,41.0,41.0,47.0,34.0,1
2557,92:69:1D:31:68:E9,3852926,489047073,4065,3654957,3848861,485392116,1,5519,1166574,5344,1126781,175,39793,2209,12,4328,103,1,65,216660.0,130000.0,-51.0,-47.0,-45.0,-47.0,-51.0,-47.0,-44.0,-48.0,-85.0,-86.0,-82.0,-82.0,34.0,39.0,37.0,35.0,1
2558,CC:2F:71:3F:1F:24,5107313,1938422977,1258450,1453030659,3848863,485392318,2222,1059144,1212454213,1058284,1212350079,860,104134,1024722,15,1256583,121879,2219,814,144444.0,43333.0,-71.0,-69.0,-66.0,-72.0,-71.0,-69.0,-66.0,-71.0,-85.0,-86.0,-82.0,-82.0,14.0,17.0,16.0,10.0,1
2559,CC:2F:71:3E:C5:1F,3849870,485515368,1007,123050,3848863,485392318,3,4414,367722,3681,280698,733,87024,1065,14,1450,30,3,54,144444.0,39000.0,-71.0,-71.0,-69.0,-61.0,-70.0,-71.0,-68.0,-60.0,-85.0,-86.0,-82.0,-82.0,14.0,15.0,13.0,21.0,1
2560,BA:8C:B9:54:50:24,3853811,491588182,4948,6195864,3848863,485392318,7,9923,1763452,9901,1759957,22,3495,2361,18,5463,44,7,74,216660.0,130000.0,-48.0,-35.0,-43.0,-45.0,-45.0,-35.0,-44.0,-47.0,-85.0,-86.0,-82.0,-82.0,37.0,51.0,39.0,37.0,1
2561,62:47:05:9D:EB:15,3855630,497576830,6766,12184450,3848864,485392380,1,7089,3810585,7039,3802927,50,7658,3317,0,6841,56,1,126,229410.0,130000.0,-44.0,-45.0,-35.0,-48.0,-44.0,-45.0,-37.0,-47.0,-85.0,-86.0,-82.0,-82.0,41.0,41.0,47.0,34.0,1
2562,92:69:1D:31:68:E9,3852929,489047337,4065,3654957,3848864,485392380,1,5519,1166574,5344,1126781,175,39793,2209,12,4328,103,1,65,216660.0,130000.0,-51.0,-47.0,-45.0,-47.0,-51.0,-47.0,-44.0,-48.0,-85.0,-86.0,-82.0,-82.0,34.0,39.0,37.0,35.0,1
2563,CC:2F:71:3F:1F:24,5107510,1938664808,1258646,1453272428,3848864,485392380,2222,1059323,1212686596,1058463,1212582462,860,104134,1024897,15,1256781,121879,2219,814,144444.0,43333.0,-72.0,-69.0,-67.0,-71.0,-72.0,-69.0,-67.0,-70.0,-85.0,-86.0,-82.0,-82.0,13.0,17.0,15.0,11.0,1
2564,CC:2F:71:3E:C5:1F,3849871,485515430,1007,123050,3848864,485392380,3,4416,367910,3682,280768,734,87142,1066,14,1450,30,3,54,144444.0,39000.0,-71.0,-71.0,-68.0,-61.0,-70.0,-71.0,-68.0,-60.0,-85.0,-86.0,-82.0,-82.0,14.0,15.0,14.0,21.0,1
2565,BA:8C:B9:54:50:24,3853812,491588244,4948,6195864,3848864,485392380,7,9929,1763860,9907,1760365,22,3495,2361,18,5463,44,7,74,216660.0,130000.0,-40.0,-37.0,-46.0,-51.0,-45.0,-35.0,-43.0,-47.0,-85.0,-86.0,-82.0,-82.0,45.0,49.0,36.0,31.0,1
2566,62:47:05:9D:EB:15,3855636,497577436,6766,12184450,3848870,485392986,1,7089,3810585,7039,3802927,50,7658,3317,0,6841,56,1,126,229410.0,130000.0,-44.0,-45.0,-35.0,-48.0,-44.0,-45.0,-37.0,-47.0,-85.0,-86.0,-82.0,-82.0,41.0,41.0,47.0,34.0,1
2567,92:69:1D:31:68:E9,3852935,489047943,4065,3654957,3848870,485392986,1,5519,1166574,5344,1126781,175,39793,2209,12,4328,103,1,65,216660.0,130000.0,-51.0,-47.0,-45.0,-47.0,-51.0,-47.0,-44.0,-48.0,-85.0,-86.0,-82.0,-82.0,34.0,39.0,37.0,35.0,1
2568,CC:2F:71:3F:1F:24,5107710,1938907082,1258837,1453513834,3848873,485393248,2222,1059498,1212917882,1058638,1212813748,860,104134,1025069,15,1256972,121879,2219,814,144444.0,43333.0,-71.0,-69.0,-67.0,-71.0,-71.0,-69.0,-66.0,-70.0,-85.0,-86.0,-82.0,-82.0,14.0,17.0,15.0,11.0,1
2569,CC:2F:71:3E:C5:1F,3849880,485516298,1007,123050,3848873,485393248,3,4416,367910,3682,280768,734,87142,1066,14,1450,30,3,54,144444.0,39000.0,-71.0,-71.0,-68.0,-61.0,-70.0,-71.0,-68.0,-60.0,-85.0,-86.0,-82.0,-82.0,14.0,15.0,14.0,21.0,1
2570,BA:8C:B9:54:50:24,3853821,491589112,4948,6195864,3848873,485393248,7,9929,1763860,9907,1760365,22,3495,2361,18,5463,44,7,74,216660.0,130000.0,-40.0,-37.0,-46.0,-51.0,-45.0,-35.0,-43.0,-47.0,-85.0,-86.0,-82.0,-82.0,45.0,49.0,36.0,31.0,1
2571,62:47:05:9D:EB:15,3855639,497577698,6766,12184450,3848873,485393248,1,7089,3810585,7039,3802927,50,7658,3317,0,6841,56,1,126,229410.0,130000.0,-44.0,-45.0,-35.0,-48.0,-44.0,-45.0,-37.0,-47.0,-84.0,-86.0,-82.0,-82.0,40.0,41.0,47.0,34.0,1
2572,92:69:1D:31:68:E9,3852938,489048205,4065,3654957,3848873,485393248,1,5519,1166574,5344,1126781,175,39793,2209,12,4328,103,1,65,216660.0,130000.0,-51.0,-47.0,-45.0,-47.0,-51.0,-47.0,-44.0,-48.0,-84.0,-86.0,-82.0,-82.0,33.0,39.0,37.0,35.0,1
2573,CC:2F:71:3F:1F:24,5107902,1939148604,1259029,1453755356,3848873,485393248,2222,1059674,1213155026,1058814,1213050892,860,104134,1025238,15,1257164,121880,2219,814,144444.0,43333.0,-72.0,-69.0,-67.0,-72.0,-71.0,-69.0,-66.0,-70.0,-84.0,-86.0,-82.0,-82.0,12.0,17.0,15.0,10.0,1
2574,CC:2F:71:3E:C5:1F,3849880,485516298,1007,123050,3848873,485393248,3,4416,367910,3682,280768,734,87142,1066,14,1450,30,3,54,144444.0,39000.0,-71.0,-71.0,-68.0,-61.0,-70.0,-71.0,-68.0,-60.0,-84.0,-86.0,-82.0,-82.0,13.0,15.0,14.0,21.0,1
2575,BA:8C:B9:54:50:24,3853833,491594711,4948,6195864,3848885,485398847,7,9935,1764268,9913,1760773,22,3495,2361,18,5463,44,7,74,216660.0,130000.0,-48.0,-35.0,-43.0,-45.0,-44.0,-36.0,-44.0,-48.0,-84.0,-86.0,-82.0,-82.0,36.0,51.0,39.0,37.0,1
2576,62:47:05:9D:EB:15,3855668,497589327,6766,12184450,3848902,485404877,1,7090,3810653,7040,3802995,50,7658,3317,0,6842,56,1,126,229410.0,130000.0,-44.0,-45.0,-35.0,-47.0,-44.0,-45.0,-37.0,-47.0,-84.0,-86.0,-82.0,-82.0,40.0,41.0,47.0,35.0,1
2577,92:69:1D:31:68:E9,3852969,489060036,4065,3654957,3848904,485405079,1,5522,1166945,5346,1126917,176,40028,2210,12,4328,103,1,65,216660.0,130000.0,-51.0,-47.0,-43.0,-48.0,-51.0,-47.0,-44.0,-48.0,-84.0,-86.0,-82.0,-82.0,33.0,39.0,39.0,34.0,1
2578,CC:2F:71:3F:1F:24,5108127,1939407927,1259223,1454002848,3848904,485405079,2222,1059853,1213398392,1058993,1213294258,860,104134,1025409,15,1257358,121880,2219,814,144444.0,43333.0,-72.0,-69.0,-67.0,-70.0,-71.0,-69.0,-67.0,-70.0,-84.0,-86.0,-82.0,-82.0,12.0,17.0,15.0,12.0,1
2579,CC:2F:71:3E:C5:1F,3849911,485528129,1007,123050,3848904,485405079,3,4416,367910,3682,280768,734,87142,1066,14,1450,30,3,54,144444.0,39000.0,-71.0,-71.0,-68.0,-61.0,-70.0,-71.0,-68.0,-60.0,-84.0,-86.0,-82.0,-82.0,13.0,15.0,14.0,21.0,1
2580,BA:8C:B9:54:50:24,3853852,491600943,4948,6195864,3848904,485405079,7,9935,1764268,9913,1760773,22,3495,2361,18,5463,44,7,74,216660.0,130000.0,-48.0,-35.0,-43.0,-45.0,-44.0,-36.0,-44.0,-48.0,-84.0,-86.0,-82.0,-82.0,36.0,51.0,39.0,37.0,1
2581,62:47:05:9D:EB:15,3855671,497589589,6766,12184450,3848905,485405139,1,7091,3810721,7041,3803063,50,7658,3317,0,6842,56,1,126,229410.0,130000.0,-45.0,-50.0,-44.0,-46.0,-44.0,-46.0,-38.0,-46.0,-84.0,-86.0,-82.0,-82.0,39.0,36.0,38.0,36.0,1
2582,92:69:1D:31:68:E9,3852970,489060096,4065,3654957,3848905,485405139,1,5522,1166945,5346,1126917,176,40028,2210,12,4328,103,1,65,216660.0,130000.0,-51.0,-47.0,-43.0,-48.0,-51.0,-47.0,-44.0,-48.0,-84.0,-86.0,-82.0,-82.0,33.0,39.0,39.0,34.0,1
2583,CC:2F:71:3F:1F:24,5108325,1939652773,1259420,1454247634,3848905,485405139,2222,1060034,1213630912,1059174,1213526778,860,104134,1025587,15,1257555,121880,2219,814,144444.0,43333.0,-72.0,-69.0,-68.0,-71.0,-71.0,-69.0,-67.0,-71.0,-84.0,-86.0,-82.0,-82.0,12.0,17.0,14.0,11.0,1
2584,CC:2F:71:3E:C5:1F,3849912,485528189,1007,123050,3848905,485405139,3,4416,367910,3682,280768,734,87142,1066,14,1450,30,3,54,144444.0,39000.0,-71.0,-71.0,-68.0,-61.0,-70.0,-71.0,-68.0,-60.0,-84.0,-86.0,-82.0,-82.0,13.0,15.0,14.0,21.0,1
2585,BA:8C:B9:54:50:24,3853855,491601205,4948,6195864,3848907,485405341,7,9935,1764268,9913,1760773,22,3495,2361,18,5463,44,7,74,216660.0,130000.0,-48.0,-35.0,-43.0,-45.0,-44.0,-36.0,-44.0,-48.0,-84.0,-86.0,-82.0,-82.0,36.0,51.0,39.0,37.0,1
2586,62:47:05:9D:EB:15,3855680,497590670,6766,12184450,3848914,485406220,1,7091,3810721,7041,3803063,50,7658,3317,0,6842,56,1,126,229410.0,130000.0,-45.0,-50.0,-44.0,-46.0,-44.0,-46.0,-38.0,-46.0,-85.0,-86.0,-82.0,-82.0,40.0,36.0,38.0,36.0,1
2587,92:69:1D:31:68:E9,3852979,489061177,4065,3654957,3848914,485406220,1,5522,1166945,5346,1126917,176,40028,2210,12,4328,103,1,65,216660.0,130000.0,-51.0,-47.0,-43.0,-48.0,-51.0,-47.0,-44.0,-48.0,-85.0,-86.0,-82.0,-82.0,34.0,39.0,39.0,34.0,1
2588,CC:2F:71:3F:1F:24,5108525,1939897940,1259611,1454491720,3848914,485406220,2222,1060217,1213880382,1059357,1213776248,860,104134,1025755,15,1257745,121880,2219,814,144444.0,43333.0,-71.0,-69.0,-66.0,-70.0,-71.0,-68.0,-66.0,-70.0,-85.0,-86.0,-82.0,-82.0,14.0,17.0,16.0,12.0,1
2589,CC:2F:71:3E:C5:1F,3849921,485529270,1007,123050,3848914,485406220,3,4416,367910,3682,280768,734,87142,1066,14,1450,30,3,54,144444.0,39000.0,-71.0,-71.0,-68.0,-61.0,-70.0,-71.0,-68.0,-60.0,-85.0,-86.0,-82.0,-82.0,14.0,15.0,14.0,21.0,1
2590,BA:8C:B9:54:50:24,3853862,491602084,4948,6195864,3848914,485406220,7,9935,1764268,9913,1760773,22,3495,2361,18,5463,44,7,74,216660.0,130000.0,-48.0,-35.0,-43.0,-45.0,-44.0,-36.0,-44.0,-48.0,-85.0,-86.0,-82.0,-82.0,37.0,51.0,39.0,37.0,1
2591,62:47:05:9D:EB:15,3855680,497590670,6766,12184450,3848914,485406220,1,7091,3810721,7041,3803063,50,7658,3317,0,6842,56,1,126,229410.0,130000.0,-45.0,-50.0,-44.0,-46.0,-44.0,-46.0,-38.0,-46.0,-85.0,-86.0,-82.0,-82.0,40.0,36.0,38.0,36.0,1
2592,92:69:1D:31:68:E9,3852980,489061237,4065,3654957,3848915,485406280,1,5522,1166945,5346,1126917,176,40028,2210,12,4328,103,1,65,216660.0,130000.0,-51.0,-47.0,-43.0,-48.0,-51.0,-47.0,-44.0,-48.0,-85.0,-86.0,-82.0,-82.0,34.0,39.0,39.0,34.0,1
2593,CC:2F:71:3F:1F:24,5108713,1940136038,1259798,1454729758,3848915,485406280,2222,1060396,1214120932,1059536,1214016798,860,104134,1025923,15,1257933,121880,2219,814,144444.0,43333.0,-71.0,-68.0,-66.0,-71.0,-71.0,-68.0,-66.0,-70.0,-85.0,-86.0,-82.0,-82.0,14.0,18.0,16.0,11.0,1
2594,CC:2F:71:3E:C5:1F,3849924,485529532,1007,123050,3848917,485406482,3,4416,367910,3682,280768,734,87142,1066,14,1450,30,3,54,144444.0,39000.0,-71.0,-71.0,-68.0,-61.0,-70.0,-71.0,-68.0,-60.0,-85.0,-86.0,-82.0,-82.0,14.0,15.0,14.0,21.0,1
2595,BA:8C:B9:54:50:24,3853865,491602346,4948,6195864,3848917,485406482,7,9935,1764268,9913,1760773,22,3495,2361,18,5463,44,7,74,216660.0,130000.0,-48.0,-35.0,-43.0,-45.0,-44.0,-36.0,-44.0,-48.0,-85.0,-86.0,-82.0,-82.0,37.0,51.0,39.0,37.0,1
2596,62:47:05:9D:EB:15,3855689,497591538,6766,12184450,3848923,485407088,1,7091,3810721,7041,3803063,50,7658,3317,0,6842,56,1,126,229410.0,130000.0,-45.0,-50.0,-44.0,-46.0,-44.0,-46.0,-38.0,-46.0,-85.0,-86.0,-82.0,-82.0,40.0,36.0,38.0,36.0,1
2597,92:69:1D:31:68:E9,3852988,489062045,4065,3654957,3848923,485407088,1,5522,1166945,5346,1126917,176,40028,2210,12,4328,103,1,65,216660.0,130000.0,-51.0,-47.0,-43.0,-48.0,-51.0,-47.0,-44.0,-48.0,-85.0,-86.0,-82.0,-82.0,34.0,39.0,39.0,34.0,1
2598,CC:2F:71:3F:1F:24,5108912,1940378238,1259989,1454971150,3848923,485407088,2222,1060572,1214356666,1059712,1214252532,860,104134,1026093,15,1258124,121880,2219,814,144444.0,43333.0,-72.0,-69.0,-67.0,-71.0,-71.0,-69.0,-67.0,-70.0,-85.0,-86.0,-82.0,-82.0,13.0,17.0,15.0,11.0,1
2599,CC:2F:71:3E:C5:1F,3849930,485530138,1007,123050,3848923,485407088,3,4416,367910,3682,280768,734,87142,1066,14,1450,30,3,54,144444.0,39000.0,-71.0,-71.0,-68.0,-61.0,-70.0,-71.0,-68.0,-60.0,-85.0,-86.0,-82.0,-82.0,14.0,15.0,14.0,21.0,1
2600,BA:8C:B9:54:50:24,3853871,491602952,4948,6195864,3848923,485407088,7,9935,1764268,9913,1760773,22,3495,2361,18,5463,44,7,74,216660.0,130000.0,-48.0,-35.0,-43.0,-45.0,-44.0,-36.0,-44.0,-48.0,-85.0,-86.0,-82.0,-82.0,37.0,51.0,39.0,37.0,1
2601,62:47:05:9D:EB:15,3855691,497591906,6766,12184450,3848925,485407456,1,7093,3810857,7043,3803199,50,7658,3317,0,6842,56,1,126,229410.0,130000.0,-44.0,-45.0,-35.0,-47.0,-44.0,-46.0,-37.0,-46.0,-85.0,-86.0,-82.0,-82.0,41.0,41.0,47.0,35.0,1
2602,92:69:1D:31:68:E9,3852990,489062413,4065,3654957,3848925,485407456,1,5522,1166945,5346,1126917,176,40028,2210,12,4328,103,1,65,216660.0,130000.0,-51.0,-47.0,-43.0,-48.0,-51.0,-47.0,-44.0,-48.0,-85.0,-86.0,-82.0,-82.0,34.0,39.0,39.0,34.0,1
2603,CC:2F:71:3F:1F:24,5109126,1940629817,1260199,1455222159,3848927,485407658,2222,1060772,1214600829,1059912,1214496695,860,104134,1026283,15,1258332,121880,2219,814,144444.0,43333.0,-72.0,-69.0,-67.0,-71.0,-71.0,-69.0,-67.0,-71.0,-85.0,-86.0,-82.0,-82.0,13.0,17.0,15.0,11.0,1
2604,CC:2F:71:3E:C5:1F,3849934,485530708,1007,123050,3848927,485407658,3,4416,367910,3682,280768,734,87142,1066,14,1450,30,3,54,144444.0,39000.0,-71.0,-71.0,-68.0,-61.0,-70.0,-71.0,-68.0,-60.0,-85.0,-86.0,-82.0,-81.0,14.0,15.0,14.0,20.0,1
2605,BA:8C:B9:54:50:24,3853877,491603724,4948,6195864,3848929,485407860,7,9935,1764268,9913,1760773,22,3495,2361,18,5463,44,7,74,216660.0,130000.0,-48.0,-35.0,-43.0,-45.0,-44.0,-36.0,-44.0,-48.0,-85.0,-86.0,-82.0,-81.0,37.0,51.0,39.0,36.0,1
2606,62:47:05:9D:EB:15,3855700,497592774,6766,12184450,3848934,485408324,1,7094,3810925,7044,3803267,50,7658,3317,0,6842,56,1,126,229410.0,130000.0,-44.0,-45.0,-35.0,-47.0,-44.0,-46.0,-37.0,-46.0,-85.0,-86.0,-82.0,-81.0,41.0,41.0,47.0,34.0,1
2607,92:69:1D:31:68:E9,3852999,489063281,4065,3654957,3848934,485408324,1,5522,1166945,5346,1126917,176,40028,2210,12,4328,103,1,65,216660.0,130000.0,-51.0,-47.0,-43.0,-48.0,-51.0,-47.0,-44.0,-48.0,-85.0,-86.0,-82.0,-81.0,34.0,39.0,39.0,33.0,1
2608,CC:2F:71:3F:1F:24,5109321,1940871499,1260387,1455463175,3848934,485408324,2222,1060946,1214834903,1060086,1214730769,860,104134,1026450,15,1258520,121880,2219,814,144444.0,43333.0,-71.0,-69.0,-67.0,-71.0,-71.0,-69.0,-67.0,-71.0,-85.0,-86.0,-82.0,-81.0,14.0,17.0,15.0,10.0,1
2609,CC:2F:71:3E:C5:1F,3849941,485531374,1007,123050,3848934,485408324,3,4416,367910,3682,280768,734,87142,1066,14,1450,30,3,54,144444.0,39000.0,-71.0,-71.0,-68.0,-61.0,-70.0,-71.0,-68.0,-60.0,-85.0,-86.0,-82.0,-81.0,14.0,15.0,14.0,20.0,1
2610,BA:8C:B9:54:50:24,3853882,491604188,4948,6195864,3848934,485408324,7,9935,1764268,9913,1760773,22,3495,2361,18,5463,44,7,74,216660.0,130000.0,-48.0,-35.0,-43.0,-45.0,-44.0,-36.0,-44.0,-48.0,-85.0,-86.0,-82.0,-81.0,37.0,51.0,39.0,36.0,1
2611,62:47:05:9D:EB:15,3855700,497592774,6766,12184450,3848934,485408324,1,7094,3810925,7044,3803267,50,7658,3317,0,6842,56,1,126,229410.0,130000.0,-44.0,-45.0,-35.0,-47.0,-44.0,-46.0,-37.0,-46.0,-85.0,-86.0,-82.0,-81.0,41.0,41.0,47.0,34.0,1
2612,92:69:1D:31:68:E9,3852999,489063281,4065,3654957,3848934,485408324,1,5522,1166945,5346,1126917,176,40028,2210,12,4328,103,1,65,216660.0,130000.0,-51.0,-47.0,-43.0,-48.0,-51.0,-47.0,-44.0,-48.0,-85.0,-86.0,-82.0,-81.0,34.0,39.0,39.0,33.0,1
2613,CC:2F:71:3F:1F:24,5109521,1941122503,1260583,1455713775,3848938,485408728,2222,1061128,1215078469,1060268,1214974335,860,104134,1026627,15,1258718,121885,2219,814,144444.0,43333.0,-72.0,-69.0,-67.0,-71.0,-72.0,-69.0,-67.0,-71.0,-85.0,-86.0,-82.0,-81.0,13.0,17.0,15.0,10.0,1
2614,CC:2F:71:3E:C5:1F,3849945,485531778,1007,123050,3848938,485408728,3,4416,367910,3682,280768,734,87142,1066,14,1450,30,3,54,144444.0,39000.0,-71.0,-71.0,-68.0,-61.0,-70.0,-71.0,-68.0,-60.0,-85.0,-86.0,-82.0,-81.0,14.0,15.0,14.0,20.0,1
2615,BA:8C:B9:54:50:24,3853886,491604592,4948,6195864,3848938,485408728,7,9935,1764268,9913,1760773,22,3495,2361,18,5463,44,7,74,216660.0,130000.0,-48.0,-35.0,-43.0,-45.0,-44.0,-36.0,-44.0,-48.0,-85.0,-86.0,-82.0,-81.0,37.0,51.0,39.0,36.0,1
2616,62:47:05:9D:EB:15,3855708,497593582,6766,12184450,3848942,485409132,1,7094,3810925,7044,3803267,50,7658,3317,0,6842,56,1,126,229410.0,130000.0,-44.0,-45.0,-35.0,-47.0,-44.0,-46.0,-37.0,-46.0,-85.0,-86.0,-82.0,-81.0,41.0,41.0,47.0,34.0,1
2617,92:69:1D:31:68:E9,3853007,489064089,4065,3654957,3848942,485409132,1,5522,1166945,5346,1126917,176,40028,2210,12,4328,103,1,65,216660.0,130000.0,-51.0,-47.0,-43.0,-48.0,-51.0,-47.0,-44.0,-48.0,-85.0,-86.0,-82.0,-81.0,34.0,39.0,39.0,33.0,1
2618,CC:2F:71:3F:1F:24,5109724,1941367844,1260781,1455958652,3848943,485409192,2222,1061307,1215310711,1060447,1215206577,860,104134,1026803,15,1258916,121886,2219,814,144444.0,43333.0,-71.0,-69.0,-68.0,-71.0,-71.0,-69.0,-68.0,-71.0,-85.0,-86.0,-82.0,-81.0,14.0,17.0,14.0,10.0,1
2619,CC:2F:71:3E:C5:1F,3849950,485532242,1007,123050,3848943,485409192,3,4416,367910,3682,280768,734,87142,1066,14,1450,30,3,54,144444.0,39000.0,-71.0,-71.0,-68.0,-61.0,-70.0,-71.0,-68.0,-60.0,-85.0,-86.0,-82.0,-81.0,14.0,15.0,14.0,20.0,1
2620,BA:8C:B9:54:50:24,3853891,491605056,4948,6195864,3848943,485409192,7,9935,1764268,9913,1760773,22,3495,2361,18,5463,44,7,74,216660.0,130000.0,-48.0,-35.0,-43.0,-45.0,-44.0,-36.0,-44.0,-48.0,-85.0,-86.0,-82.0,-81.0,37.0,51.0,39.0,36.0,1
2621,62:47:05:9D:EB:15,3855709,497593642,6766,12184450,3848943,485409192,1,7094,3810925,7044,3803267,50,7658,3317,0,6842,56,1,126,229410.0,130000.0,-44.0,-45.0,-35.0,-47.0,-44.0,-46.0,-37.0,-46.0,-85.0,-86.0,-82.0,-81.0,41.0,41.0,47.0,34.0,1
2622,92:69:1D:31:68:E9,3853008,489064149,4065,3654957,3848943,485409192,1,5522,1166945,5346,1126917,176,40028,2210,12,4328,103,1,65,216660.0,130000.0,-51.0,-47.0,-43.0,-48.0,-51.0,-47.0,-44.0,-48.0,-85.0,-86.0,-82.0,-81.0,34.0,39.0,39.0,33.0,1
2623,CC:2F:71:3F:1F:24,5109918,1941609524,1260971,1456199928,3848947,485409596,2222,1061483,1215547865,1060623,1215443731,860,104134,1026972,15,1259106,121886,2219,814,144444.0,43333.0,-72.0,-69.0,-67.0,-72.0,-71.0,-69.0,-67.0,-71.0,-85.0,-86.0,-82.0,-81.0,13.0,17.0,15.0,9.0,1
2624,CC:2F:71:3E:C5:1F,3849956,485532848,1007,123050,3848949,485409798,3,4416,367910,3682,280768,734,87142,1066,14,1450,30,3,54,144444.0,39000.0,-71.0,-71.0,-68.0,-61.0,-70.0,-71.0,-68.0,-60.0,-85.0,-86.0,-82.0,-81.0,14.0,15.0,14.0,20.0,1
2625,BA:8C:B9:54:50:24,3853897,491605662,4948,6195864,3848949,485409798,7,9935,1764268,9913,1760773,22,3495,2361,18,5463,44,7,74,216660.0,130000.0,-48.0,-35.0,-43.0,-45.0,-44.0,-36.0,-44.0,-48.0,-85.0,-86.0,-82.0,-81.0,37.0,51.0,39.0,36.0,1
2626,62:47:05:9D:EB:15,3855717,497594450,6766,12184450,3848951,485410000,1,7095,3810993,7045,3803335,50,7658,3317,0,6842,56,1,126,229410.0,130000.0,-47.0,-47.0,-47.0,-46.0,-44.0,-46.0,-39.0,-46.0,-85.0,-86.0,-82.0,-81.0,38.0,39.0,35.0,35.0,1
2627,92:69:1D:31:68:E9,3853016,489064957,4065,3654957,3848951,485410000,1,5522,1166945,5346,1126917,176,40028,2210,12,4328,103,1,65,216660.0,130000.0,-51.0,-47.0,-43.0,-48.0,-51.0,-47.0,-44.0,-48.0,-85.0,-86.0,-82.0,-81.0,34.0,39.0,39.0,33.0,1
2628,CC:2F:71:3F:1F:24,5110113,1941854182,1261162,1456444182,3848951,485410000,2222,1061662,1215784183,1060802,1215680049,860,104134,1027144,15,1259297,121886,2219,814,144444.0,43333.0,-71.0,-69.0,-68.0,-72.0,-71.0,-69.0,-68.0,-71.0,-85.0,-86.0,-82.0,-81.0,14.0,17.0,14.0,9.0,1
2629,CC:2F:71:3E:C5:1F,3849958,485533050,1007,123050,3848951,485410000,3,4416,367910,3682,280768,734,87142,1066,14,1450,30,3,54,144444.0,39000.0,-71.0,-71.0,-68.0,-61.0,-70.0,-71.0,-68.0,-60.0,-85.0,-86.0,-82.0,-81.0,14.0,15.0,14.0,20.0,1
2630,BA:8C:B9:54:50:24,3853899,491605864,4948,6195864,3848951,485410000,7,9935,1764268,9913,1760773,22,3495,2361,18,5463,44,7,74,216660.0,130000.0,-48.0,-35.0,-43.0,-45.0,-44.0,-36.0,-44.0,-48.0,-85.0,-86.0,-82.0,-81.0,37.0,51.0,39.0,36.0,1
2631,62:47:05:9D:EB:15,3855722,497594914,6766,12184450,3848956,485410464,1,7095,3810993,7045,3803335,50,7658,3317,0,6842,56,1,126,229410.0,130000.0,-47.0,-47.0,-47.0,-46.0,-44.0,-46.0,-39.0,-46.0,-85.0,-86.0,-82.0,-81.0,38.0,39.0,35.0,35.0,1
2632,92:69:1D:31:68:E9,3853023,489065623,4065,3654957,3848958,485410666,1,5522,1166945,5346,1126917,176,40028,2210,12,4328,103,1,65,216660.0,130000.0,-51.0,-47.0,-43.0,-48.0,-51.0,-47.0,-44.0,-48.0,-85.0,-86.0,-82.0,-81.0,34.0,39.0,39.0,33.0,1
2633,CC:2F:71:3F:1F:24,5110311,1942096254,1261353,1456685588,3848958,485410666,2222,1061838,1216018681,1060978,1215914547,860,104134,1027313,15,1259488,121887,2219,814,144444.0,43333.0,-71.0,-69.0,-68.0,-71.0,-71.0,-69.0,-67.0,-71.0,-85.0,-86.0,-82.0,-81.0,14.0,17.0,14.0,10.0,1
2634,CC:2F:71:3E:C5:1F,3849965,485533716,1007,123050,3848958,485410666,3,4416,367910,3682,280768,734,87142,1066,14,1450,30,3,54,144444.0,39000.0,-71.0,-71.0,-68.0,-61.0,-70.0,-71.0,-68.0,-60.0,-85.0,-86.0,-82.0,-81.0,14.0,15.0,14.0,20.0,1
2635,BA:8C:B9:54:50:24,3853906,491606530,4948,6195864,3848958,485410666,7,9935,1764268,9913,1760773,22,3495,2361,18,5463,44,7,74,216660.0,130000.0,-48.0,-35.0,-43.0,-45.0,-44.0,-36.0,-44.0,-48.0,-85.0,-86.0,-82.0,-81.0,37.0,51.0,39.0,36.0,1
2636,62:47:05:9D:EB:15,3855726,497595318,6766,12184450,3848960,485410868,1,7095,3810993,7045,3803335,50,7658,3317,0,6842,56,1,126,229410.0,130000.0,-47.0,-47.0,-47.0,-46.0,-44.0,-46.0,-39.0,-46.0,-85.0,-86.0,-82.0,-81.0,38.0,39.0,35.0,35.0,1
2637,92:69:1D:31:68:E9,3853026,489065941,4066,3655073,3848960,485410868,1,5524,1167081,5348,1127053,176,40028,2210,12,4329,103,1,65,229410.0,130000.0,-52.0,-47.0,-42.0,-48.0,-51.0,-47.0,-43.0,-48.0,-85.0,-86.0,-82.0,-81.0,33.0,39.0,40.0,33.0,1
2638,CC:2F:71:3F:1F:24,5110514,1942344557,1261554,1456933689,3848960,485410868,2222,1062021,1216254290,1061161,1216150156,860,104134,1027489,15,1259689,121888,2219,814,144444.0,43333.0,-72.0,-69.0,-67.0,-73.0,-71.0,-69.0,-67.0,-72.0,-85.0,-86.0,-82.0,-81.0,13.0,17.0,15.0,8.0,1
2639,CC:2F:71:3E:C5:1F,3849968,485534034,1008,123166,3848960,485410868,3,4418,368050,3684,280908,734,87142,1066,14,1451,30,3,54,144444.0,39000.0,-71.0,-71.0,-67.0,-60.0,-70.0,-71.0,-68.0,-60.0,-85.0,-86.0,-82.0,-81.0,14.0,15.0,15.0,21.0,1
2640,BA:8C:B9:54:50:24,3853909,491606848,4949,6195980,3848960,485410868,7,9937,1764404,9915,1760909,22,3495,2361,18,5464,44,7,75,216660.0,130000.0,-48.0,-35.0,-43.0,-45.0,-45.0,-35.0,-43.0,-47.0,-85.0,-86.0,-82.0,-81.0,37.0,51.0,39.0,36.0,1
2641,62:47:05:9D:EB:15,3855733,497595984,6767,12184510,3848966,485411474,1,7097,3811129,7047,3803471,50,7658,3317,0,6843,56,1,126,229410.0,130000.0,-43.0,-44.0,-36.0,-45.0,-44.0,-45.0,-37.0,-46.0,-85.0,-86.0,-82.0,-81.0,42.0,42.0,46.0,36.0,1
2642,92:69:1D:31:68:E9,3853033,489066607,4066,3655073,3848967,485411534,1,5524,1167081,5348,1127053,176,40028,2210,12,4329,103,1,65,229410.0,130000.0,-52.0,-47.0,-42.0,-48.0,-51.0,-47.0,-43.0,-48.0,-85.0,-86.0,-82.0,-81.0,33.0,39.0,40.0,33.0,1
2643,CC:2F:71:3F:1F:24,5110712,1942586629,1261745,1457175095,3848967,485411534,2222,1062192,1216485084,1061332,1216380950,860,104134,1027659,15,1259880,121888,2219,814,144444.0,43333.0,-71.0,-69.0,-68.0,-72.0,-71.0,-69.0,-67.0,-71.0,-85.0,-86.0,-82.0,-81.0,14.0,17.0,14.0,9.0,1
2644,CC:2F:71:3E:C5:1F,3849975,485534700,1008,123166,3848967,485411534,3,4418,368050,3684,280908,734,87142,1066,14,1451,30,3,54,144444.0,39000.0,-71.0,-71.0,-67.0,-60.0,-70.0,-71.0,-68.0,-60.0,-85.0,-86.0,-82.0,-81.0,14.0,15.0,15.0,21.0,1
2645,BA:8C:B9:54:50:24,3853916,491607514,4949,6195980,3848967,485411534,7,9937,1764404,9915,1760909,22,3495,2361,18,5464,44,7,75,216660.0,130000.0,-48.0,-35.0,-43.0,-45.0,-45.0,-35.0,-43.0,-47.0,-85.0,-86.0,-82.0,-81.0,37.0,51.0,39.0,36.0,1
2646,62:47:05:9D:EB:15,3855736,497596246,6767,12184510,3848969,485411736,1,7097,3811129,7047,3803471,50,7658,3317,0,6843,56,1,126,229410.0,130000.0,-43.0,-44.0,-36.0,-45.0,-44.0,-45.0,-37.0,-46.0,-85.0,-86.0,-82.0,-81.0,42.0,42.0,46.0,36.0,1
2647,92:69:1D:31:68:E9,3853035,489066809,4066,3655073,3848969,485411736,1,5524,1167081,5348,1127053,176,40028,2210,12,4329,103,1,65,229410.0,130000.0,-52.0,-47.0,-42.0,-48.0,-51.0,-47.0,-43.0,-48.0,-85.0,-86.0,-82.0,-81.0,33.0,39.0,40.0,33.0,1
2648,CC:2F:71:3F:1F:24,5110916,1942846755,1261947,1457435019,3848969,485411736,2222,1062378,1216737876,1061518,1216633742,860,104134,1027840,15,1260082,121894,2219,815,144444.0,43333.0,-72.0,-69.0,-67.0,-71.0,-71.0,-69.0,-67.0,-70.0,-85.0,-86.0,-82.0,-81.0,13.0,17.0,15.0,10.0,1
2649,CC:2F:71:3E:C5:1F,3849977,485534902,1008,123166,3848969,485411736,3,4418,368050,3684,280908,734,87142,1066,14,1451,30,3,54,144444.0,39000.0,-71.0,-71.0,-67.0,-60.0,-70.0,-71.0,-68.0,-60.0,-85.0,-86.0,-82.0,-81.0,14.0,15.0,15.0,21.0,1
2650,BA:8C:B9:54:50:24,3853918,491607716,4949,6195980,3848969,485411736,7,9938,1764472,9916,1760977,22,3495,2361,18,5464,44,7,75,216660.0,130000.0,-48.0,-35.0,-43.0,-45.0,-45.0,-35.0,-43.0,-47.0,-85.0,-86.0,-82.0,-81.0,37.0,51.0,39.0,36.0,1
2651,62:47:05:9D:EB:15,3855743,497597125,6767,12184510,3848976,485412615,1,7097,3811129,7047,3803471,50,7658,3317,0,6843,56,1,126,229410.0,130000.0,-43.0,-44.0,-36.0,-45.0,-44.0,-45.0,-37.0,-46.0,-85.0,-86.0,-82.0,-81.0,42.0,42.0,46.0,36.0,1
2652,92:69:1D:31:68:E9,3853042,489067688,4066,3655073,3848976,485412615,1,5524,1167081,5348,1127053,176,40028,2210,12,4329,103,1,65,229410.0,130000.0,-52.0,-47.0,-42.0,-48.0,-51.0,-47.0,-43.0,-48.0,-85.0,-86.0,-82.0,-81.0,33.0,39.0,40.0,33.0,1
2653,CC:2F:71:3F:1F:24,5111113,1943088910,1262137,1457676295,3848976,485412615,2222,1062551,1216970396,1061691,1216866262,860,104134,1028007,15,1260272,121894,2219,815,144444.0,43333.0,-71.0,-69.0,-67.0,-71.0,-71.0,-69.0,-67.0,-70.0,-85.0,-86.0,-82.0,-81.0,14.0,17.0,15.0,10.0,1
2654,CC:2F:71:3E:C5:1F,3849984,485535781,1008,123166,3848976,485412615,3,4418,368050,3684,280908,734,87142,1066,14,1451,30,3,54,144444.0,39000.0,-71.0,-71.0,-67.0,-60.0,-70.0,-71.0,-68.0,-60.0,-85.0,-86.0,-82.0,-81.0,14.0,15.0,15.0,21.0,1
2655,BA:8C:B9:54:50:24,3853925,491608595,4949,6195980,3848976,485412615,7,9938,1764472,9916,1760977,22,3495,2361,18,5464,44,7,75,216660.0,130000.0,-48.0,-35.0,-43.0,-45.0,-45.0,-35.0,-43.0,-47.0,-85.0,-86.0,-82.0,-81.0,37.0,51.0,39.0,36.0,1
2656,62:47:05:9D:EB:15,3855746,497597387,6767,12184510,3848979,485412877,1,7097,3811129,7047,3803471,50,7658,3317,0,6843,56,1,126,229410.0,130000.0,-43.0,-44.0,-36.0,-45.0,-44.0,-45.0,-37.0,-46.0,-85.0,-86.0,-82.0,-81.0,42.0,42.0,46.0,36.0,1
2657,92:69:1D:31:68:E9,3853045,489067950,4066,3655073,3848979,485412877,1,5524,1167081,5348,1127053,176,40028,2210,12,4329,103,1,65,229410.0,130000.0,-52.0,-47.0,-42.0,-48.0,-51.0,-47.0,-43.0,-48.0,-85.0,-86.0,-82.0,-81.0,33.0,39.0,40.0,33.0,1
2658,CC:2F:71:3F:1F:24,5111315,1943334179,1262336,1457921302,3848979,485412877,2222,1062737,1217210625,1061877,1217106491,860,104134,1028186,15,1260471,121894,2219,815,144444.0,43333.0,-72.0,-69.0,-67.0,-71.0,-71.0,-69.0,-67.0,-71.0,-85.0,-86.0,-82.0,-81.0,13.0,17.0,15.0,10.0,1
2659,CC:2F:71:3E:C5:1F,3849987,485536043,1008,123166,3848979,485412877,3,4418,368050,3684,280908,734,87142,1066,14,1451,30,3,54,144444.0,39000.0,-71.0,-71.0,-67.0,-60.0,-70.0,-71.0,-68.0,-60.0,-85.0,-86.0,-82.0,-81.0,14.0,15.0,15.0,21.0,1
2660,BA:8C:B9:54:50:24,3853928,491608857,4949,6195980,3848979,485412877,7,9938,1764472,9916,1760977,22,3495,2361,18,5464,44,7,75,216660.0,130000.0,-48.0,-35.0,-43.0,-45.0,-45.0,-35.0,-43.0,-47.0,-85.0,-86.0,-82.0,-81.0,37.0,51.0,39.0,36.0,1
2661,62:47:05:9D:EB:15,3855752,497597993,6767,12184510,3848985,485413483,1,7097,3811129,7047,3803471,50,7658,3317,0,6843,56,1,126,229410.0,130000.0,-43.0,-44.0,-36.0,-45.0,-44.0,-45.0,-37.0,-46.0,-85.0,-87.0,-82.0,-81.0,42.0,43.0,46.0,36.0,1
2662,92:69:1D:31:68:E9,3853051,489068556,4066,3655073,3848985,485413483,1,5524,1167081,5348,1127053,176,40028,2210,12,4329,103,1,65,229410.0,130000.0,-52.0,-47.0,-42.0,-48.0,-51.0,-47.0,-43.0,-48.0,-85.0,-87.0,-82.0,-81.0,33.0,40.0,40.0,33.0,1
2663,CC:2F:71:3F:1F:24,5111510,1943573083,1262525,1458159600,3848985,485413483,2222,1062914,1217446609,1062054,1217342475,860,104134,1028353,15,1260660,121896,2219,815,144444.0,43333.0,-72.0,-69.0,-68.0,-71.0,-71.0,-69.0,-67.0,-71.0,-85.0,-87.0,-82.0,-81.0,13.0,18.0,14.0,10.0,1
2664,CC:2F:71:3E:C5:1F,3849993,485536649,1008,123166,3848985,485413483,3,4418,368050,3684,280908,734,87142,1066,14,1451,30,3,54,144444.0,39000.0,-71.0,-71.0,-67.0,-60.0,-70.0,-71.0,-68.0,-60.0,-85.0,-87.0,-82.0,-81.0,14.0,16.0,15.0,21.0,1
2665,BA:8C:B9:54:50:24,3853934,491609463,4949,6195980,3848985,485413483,7,9938,1764472,9916,1760977,22,3495,2361,18,5464,44,7,75,216660.0,130000.0,-48.0,-35.0,-43.0,-45.0,-45.0,-35.0,-43.0,-47.0,-85.0,-87.0,-82.0,-81.0,37.0,52.0,39.0,36.0,1
2666,62:47:05:9D:EB:15,3855754,497598195,6767,12184510,3848987,485413685,1,7097,3811129,7047,3803471,50,7658,3317,0,6843,56,1,126,229410.0,130000.0,-43.0,-44.0,-36.0,-45.0,-44.0,-45.0,-37.0,-46.0,-85.0,-87.0,-82.0,-81.0,42.0,43.0,46.0,36.0,1
2667,92:69:1D:31:68:E9,3853054,489068818,4066,3655073,3848988,485413745,1,5524,1167081,5348,1127053,176,40028,2210,12,4329,103,1,65,229410.0,130000.0,-52.0,-47.0,-42.0,-48.0,-51.0,-47.0,-43.0,-48.0,-85.0,-87.0,-82.0,-81.0,33.0,40.0,40.0,33.0,1
2668,CC:2F:71:3F:1F:24,5111703,1943814621,1262715,1458400876,3848988,485413745,2222,1063094,1217684557,1062234,1217580423,860,104134,1028523,15,1260850,121900,2219,815,144444.0,43333.0,-72.0,-69.0,-67.0,-71.0,-71.0,-69.0,-67.0,-71.0,-85.0,-87.0,-82.0,-81.0,13.0,18.0,15.0,10.0,1
2669,CC:2F:71:3E:C5:1F,3849996,485536911,1008,123166,3848988,485413745,3,4418,368050,3684,280908,734,87142,1066,14,1451,30,3,54,144444.0,39000.0,-71.0,-71.0,-67.0,-60.0,-70.0,-71.0,-68.0,-60.0,-85.0,-87.0,-82.0,-81.0,14.0,16.0,15.0,21.0,1
2670,BA:8C:B9:54:50:24,3853937,491609725,4949,6195980,3848988,485413745,7,9938,1764472,9916,1760977,22,3495,2361,18,5464,44,7,75,216660.0,130000.0,-48.0,-35.0,-43.0,-45.0,-45.0,-35.0,-43.0,-47.0,-85.0,-87.0,-82.0,-81.0,37.0,52.0,39.0,36.0,1
2671,62:47:05:9D:EB:15,3855761,497598861,6767,12184510,3848994,485414351,1,7097,3811129,7047,3803471,50,7658,3317,0,6843,56,1,126,229410.0,130000.0,-43.0,-44.0,-36.0,-45.0,-44.0,-45.0,-37.0,-46.0,-85.0,-87.0,-82.0,-81.0,42.0,43.0,46.0,36.0,1
2672,92:69:1D:31:68:E9,3853060,489069424,4066,3655073,3848994,485414351,1,5524,1167081,5348,1127053,176,40028,2210,12,4329,103,1,65,229410.0,130000.0,-52.0,-47.0,-42.0,-48.0,-51.0,-47.0,-43.0,-48.0,-85.0,-87.0,-82.0,-81.0,33.0,40.0,40.0,33.0,1
2673,CC:2F:71:3F:1F:24,5111900,1944056633,1262906,1458642282,3848994,485414351,2222,1063269,1217917343,1062409,1217813209,860,104134,1028693,15,1261041,121900,2219,815,144444.0,43333.0,-71.0,-69.0,-67.0,-72.0,-71.0,-69.0,-67.0,-71.0,-85.0,-87.0,-82.0,-81.0,14.0,18.0,15.0,9.0,1
2674,CC:2F:71:3E:C5:1F,3850002,485537517,1008,123166,3848994,485414351,3,4418,368050,3684,280908,734,87142,1066,14,1451,30,3,54,144444.0,39000.0,-71.0,-71.0,-67.0,-60.0,-70.0,-71.0,-68.0,-60.0,-85.0,-87.0,-82.0,-81.0,14.0,16.0,15.0,21.0,1
2675,BA:8C:B9:54:50:24,3853945,491610533,4949,6195980,3848996,485414553,7,9938,1764472,9916,1760977,22,3495,2361,18,5464,44,7,75,216660.0,130000.0,-48.0,-35.0,-43.0,-45.0,-45.0,-35.0,-43.0,-47.0,-85.0,-87.0,-82.0,-81.0,37.0,52.0,39.0,36.0,1
2676,62:47:05:9D:EB:15,3855763,497599063,6767,12184510,3848996,485414553,1,7097,3811129,7047,3803471,50,7658,3317,0,6843,56,1,126,229410.0,130000.0,-43.0,-44.0,-36.0,-45.0,-44.0,-45.0,-37.0,-46.0,-85.0,-87.0,-82.0,-81.0,42.0,43.0,46.0,36.0,1
2677,92:69:1D:31:68:E9,3853062,489069626,4066,3655073,3848996,485414553,1,5524,1167081,5348,1127053,176,40028,2210,12,4329,103,1,65,229410.0,130000.0,-52.0,-47.0,-42.0,-48.0,-51.0,-47.0,-43.0,-48.0,-85.0,-87.0,-82.0,-81.0,33.0,40.0,40.0,33.0,1
2678,CC:2F:71:3F:1F:24,5112100,1944304560,1263104,1458890007,3848996,485414553,2222,1063455,1218156185,1062595,1218052051,860,104134,1028873,15,1261239,121901,2219,816,144444.0,43333.0,-71.0,-69.0,-67.0,-71.0,-71.0,-69.0,-67.0,-71.0,-85.0,-87.0,-82.0,-81.0,14.0,18.0,15.0,10.0,1
2679,CC:2F:71:3E:C5:1F,3850004,485537719,1008,123166,3848996,485414553,3,4418,368050,3684,280908,734,87142,1066,14,1451,30,3,54,144444.0,39000.0,-71.0,-71.0,-67.0,-60.0,-70.0,-71.0,-68.0,-60.0,-85.0,-87.0,-82.0,-81.0,14.0,16.0,15.0,21.0,1
2680,BA:8C:B9:54:50:24,3853945,491610533,4949,6195980,3848996,485414553,7,9938,1764472,9916,1760977,22,3495,2361,18,5464,44,7,75,216660.0,130000.0,-48.0,-35.0,-43.0,-45.0,-45.0,-35.0,-43.0,-47.0,-85.0,-87.0,-82.0,-81.0,37.0,52.0,39.0,36.0,1
2681,62:47:05:9D:EB:15,3855770,497599729,6767,12184510,3849003,485415219,1,7097,3811129,7047,3803471,50,7658,3317,0,6843,56,1,126,229410.0,130000.0,-43.0,-44.0,-36.0,-45.0,-44.0,-45.0,-37.0,-46.0,-85.0,-87.0,-82.0,-81.0,42.0,43.0,46.0,36.0,1
2682,92:69:1D:31:68:E9,3853069,489070292,4066,3655073,3849003,485415219,1,5524,1167081,5348,1127053,176,40028,2210,12,4329,103,1,65,229410.0,130000.0,-52.0,-47.0,-42.0,-48.0,-51.0,-47.0,-43.0,-48.0,-85.0,-87.0,-82.0,-81.0,33.0,40.0,40.0,33.0,1
2683,CC:2F:71:3F:1F:24,5112301,1944549812,1263296,1459134391,3849005,485415421,2222,1063631,1218390605,1062771,1218286471,860,104134,1029045,15,1261431,121901,2219,816,144444.0,43333.0,-72.0,-69.0,-67.0,-71.0,-71.0,-69.0,-67.0,-71.0,-85.0,-87.0,-82.0,-81.0,13.0,18.0,15.0,10.0,1
2684,CC:2F:71:3E:C5:1F,3850014,485538649,1008,123166,3849006,485415483,3,4418,368050,3684,280908,734,87142,1066,14,1451,30,3,54,144444.0,39000.0,-71.0,-71.0,-67.0,-60.0,-70.0,-71.0,-68.0,-60.0,-85.0,-87.0,-82.0,-81.0,14.0,16.0,15.0,21.0,1
2685,BA:8C:B9:54:50:24,3853955,491611463,4949,6195980,3849006,485415483,7,9938,1764472,9916,1760977,22,3495,2361,18,5464,44,7,75,216660.0,130000.0,-48.0,-35.0,-43.0,-45.0,-45.0,-35.0,-43.0,-47.0,-85.0,-87.0,-82.0,-81.0,37.0,52.0,39.0,36.0,1
2686,62:47:05:9D:EB:15,3855774,497600055,6767,12184510,3849007,485415545,1,7097,3811129,7047,3803471,50,7658,3317,0,6843,56,1,126,229410.0,130000.0,-43.0,-44.0,-36.0,-45.0,-44.0,-45.0,-37.0,-46.0,-85.0,-87.0,-82.0,-81.0,42.0,43.0,46.0,36.0,1
2687,92:69:1D:31:68:E9,3853073,489070618,4066,3655073,3849007,485415545,1,5524,1167081,5348,1127053,176,40028,2210,12,4329,103,1,65,229410.0,130000.0,-52.0,-47.0,-42.0,-48.0,-51.0,-47.0,-43.0,-48.0,-85.0,-87.0,-82.0,-81.0,33.0,40.0,40.0,33.0,1
2688,CC:2F:71:3F:1F:24,5112495,1944791290,1263488,1459375745,3849007,485415545,2222,1063804,1218620275,1062943,1218516023,861,104252,1029215,15,1261623,121901,2219,816,144444.0,43333.0,-72.0,-69.0,-67.0,-71.0,-71.0,-69.0,-67.0,-71.0,-85.0,-87.0,-82.0,-81.0,13.0,18.0,15.0,10.0,1
2689,CC:2F:71:3E:C5:1F,3850015,485538711,1008,123166,3849007,485415545,3,4420,368238,3685,280978,735,87260,1067,14,1451,30,3,54,144444.0,39000.0,-71.0,-72.0,-68.0,-60.0,-70.0,-71.0,-68.0,-60.0,-85.0,-87.0,-82.0,-81.0,14.0,15.0,14.0,21.0,1
2690,BA:8C:B9:54:50:24,3853956,491611525,4949,6195980,3849007,485415545,7,9938,1764472,9916,1760977,22,3495,2361,18,5464,44,7,75,216660.0,130000.0,-48.0,-35.0,-43.0,-45.0,-45.0,-35.0,-43.0,-47.0,-85.0,-87.0,-82.0,-81.0,37.0,52.0,39.0,36.0,1
2691,62:47:05:9D:EB:15,3855780,497600661,6767,12184510,3849013,485416151,1,7097,3811129,7047,3803471,50,7658,3317,0,6843,56,1,126,229410.0,130000.0,-43.0,-44.0,-36.0,-45.0,-44.0,-45.0,-37.0,-46.0,-85.0,-87.0,-82.0,-81.0,42.0,43.0,46.0,36.0,1
2692,92:69:1D:31:68:E9,3853082,489071486,4066,3655073,3849016,485416413,1,5524,1167081,5348,1127053,176,40028,2210,12,4329,103,1,65,229410.0,130000.0,-52.0,-47.0,-42.0,-48.0,-51.0,-47.0,-43.0,-48.0,-85.0,-87.0,-82.0,-81.0,33.0,40.0,40.0,33.0,1
2693,CC:2F:71:3F:1F:24,5112701,1945036905,1263685,1459620492,3849016,485416413,2222,1063983,1218851238,1063122,1218746986,861,104252,1029390,15,1261819,121901,2219,816,144444.0,43333.0,-73.0,-68.0,-67.0,-73.0,-72.0,-68.0,-68.0,-72.0,-85.0,-87.0,-82.0,-81.0,12.0,19.0,15.0,8.0,1
2694,CC:2F:71:3E:C5:1F,3850024,485539579,1008,123166,3849016,485416413,3,4420,368238,3685,280978,735,87260,1067,14,1451,30,3,54,144444.0,39000.0,-71.0,-72.0,-68.0,-60.0,-70.0,-71.0,-68.0,-60.0,-85.0,-87.0,-82.0,-81.0,14.0,15.0,14.0,21.0,1
2695,BA:8C:B9:54:50:24,3853965,491612393,4949,6195980,3849016,485416413,7,9938,1764472,9916,1760977,22,3495,2361,18,5464,44,7,75,216660.0,130000.0,-48.0,-35.0,-43.0,-45.0,-45.0,-35.0,-43.0,-47.0,-85.0,-87.0,-82.0,-81.0,37.0,52.0,39.0,36.0,1
2696,62:47:05:9D:EB:15,3855783,497600923,6767,12184510,3849016,485416413,1,7097,3811129,7047,3803471,50,7658,3317,0,6843,56,1,126,229410.0,130000.0,-43.0,-44.0,-36.0,-45.0,-44.0,-45.0,-37.0,-46.0,-85.0,-87.0,-82.0,-81.0,42.0,43.0,46.0,36.0,1
2697,92:69:1D:31:68:E9,3853082,489071486,4066,3655073,3849016,485416413,1,5524,1167081,5348,1127053,176,40028,2210,12,4329,103,1,65,229410.0,130000.0,-52.0,-47.0,-42.0,-48.0,-51.0,-47.0,-43.0,-48.0,-85.0,-87.0,-82.0,-81.0,33.0,40.0,40.0,33.0,1
2698,CC:2F:71:3F:1F:24,5112892,1945278311,1263876,1459861898,3849016,485416413,2222,1064158,1219082524,1063297,1218978272,861,104252,1029562,15,1262011,121901,2219,816,144444.0,43333.0,-72.0,-69.0,-69.0,-72.0,-72.0,-68.0,-68.0,-71.0,-85.0,-87.0,-82.0,-81.0,13.0,18.0,13.0,9.0,1
2699,CC:2F:71:3E:C5:1F,3850026,485539781,1008,123166,3849018,485416615,3,4420,368238,3685,280978,735,87260,1067,14,1451,30,3,54,144444.0,39000.0,-71.0,-72.0,-68.0,-60.0,-70.0,-71.0,-68.0,-60.0,-85.0,-87.0,-82.0,-81.0,14.0,15.0,14.0,21.0,1
2700,BA:8C:B9:54:50:24,3853967,491612595,4949,6195980,3849018,485416615,7,9940,1764608,9918,1761113,22,3495,2361,18,5465,44,7,75,216660.0,130000.0,-48.0,-35.0,-43.0,-45.0,-46.0,-35.0,-43.0,-46.0,-85.0,-87.0,-82.0,-81.0,37.0,52.0,39.0,36.0,1
2701,62:47:05:9D:EB:15,3855791,497601731,6767,12184510,3849024,485417221,1,7099,3811265,7049,3803607,50,7658,3317,0,6844,56,1,126,229410.0,130000.0,-44.0,-44.0,-35.0,-48.0,-44.0,-45.0,-39.0,-46.0,-85.0,-87.0,-82.0,-81.0,41.0,43.0,47.0,33.0,1
2702,92:69:1D:31:68:E9,3853090,489072294,4066,3655073,3849024,485417221,1,5526,1167217,5350,1127189,176,40028,2210,12,4330,103,1,65,229410.0,130000.0,-51.0,-47.0,-43.0,-48.0,-51.0,-47.0,-43.0,-48.0,-85.0,-87.0,-82.0,-81.0,34.0,40.0,39.0,33.0,1
2703,CC:2F:71:3F:1F:24,5113090,1945520395,1264066,1460103174,3849024,485417221,2222,1064342,1219324996,1063481,1219220744,861,104252,1029734,15,1262201,121901,2219,816,144444.0,43333.0,-72.0,-69.0,-69.0,-73.0,-72.0,-69.0,-68.0,-72.0,-85.0,-87.0,-82.0,-81.0,13.0,18.0,13.0,8.0,1
2704,CC:2F:71:3E:C5:1F,3850032,485540387,1008,123166,3849024,485417221,3,4420,368238,3685,280978,735,87260,1067,14,1451,30,3,54,144444.0,39000.0,-71.0,-72.0,-68.0,-60.0,-70.0,-71.0,-68.0,-60.0,-85.0,-87.0,-82.0,-81.0,14.0,15.0,14.0,21.0,1
2705,BA:8C:B9:54:50:24,3853973,491613201,4949,6195980,3849024,485417221,7,9940,1764608,9918,1761113,22,3495,2361,18,5465,44,7,75,216660.0,130000.0,-48.0,-35.0,-43.0,-45.0,-46.0,-35.0,-43.0,-46.0,-85.0,-87.0,-82.0,-81.0,37.0,52.0,39.0,36.0,1
2706,62:47:05:9D:EB:15,3855800,497604701,6767,12184510,3849033,485420191,1,7099,3811265,7049,3803607,50,7658,3317,0,6844,56,1,126,229410.0,130000.0,-44.0,-44.0,-35.0,-48.0,-44.0,-45.0,-39.0,-46.0,-85.0,-87.0,-82.0,-81.0,41.0,43.0,47.0,33.0,1
2707,92:69:1D:31:68:E9,3853099,489075264,4066,3655073,3849033,485420191,1,5526,1167217,5350,1127189,176,40028,2210,12,4330,103,1,65,229410.0,130000.0,-51.0,-47.0,-43.0,-48.0,-51.0,-47.0,-43.0,-48.0,-85.0,-87.0,-82.0,-81.0,34.0,40.0,39.0,33.0,1
2708,CC:2F:71:3F:1F:24,5113292,1945767821,1264257,1460347428,3849035,485420393,2222,1064518,1219563602,1063657,1219459350,861,104252,1029904,15,1262392,121905,2219,816,144444.0,43333.0,-72.0,-68.0,-67.0,-73.0,-71.0,-68.0,-68.0,-72.0,-85.0,-87.0,-82.0,-81.0,13.0,19.0,15.0,8.0,1
2709,CC:2F:71:3E:C5:1F,3850043,485543559,1008,123166,3849035,485420393,3,4420,368238,3685,280978,735,87260,1067,14,1451,30,3,54,144444.0,39000.0,-71.0,-72.0,-68.0,-60.0,-70.0,-71.0,-68.0,-60.0,-85.0,-87.0,-82.0,-81.0,14.0,15.0,14.0,21.0,1
2710,BA:8C:B9:54:50:24,3853984,491616373,4949,6195980,3849035,485420393,7,9940,1764608,9918,1761113,22,3495,2361,18,5465,44,7,75,216660.0,130000.0,-48.0,-35.0,-43.0,-45.0,-46.0,-35.0,-43.0,-46.0,-85.0,-87.0,-82.0,-81.0,37.0,52.0,39.0,36.0,1
2711,62:47:05:9D:EB:15,3855811,497606906,6767,12184510,3849044,485422396,1,7099,3811265,7049,3803607,50,7658,3317,0,6844,56,1,126,229410.0,130000.0,-44.0,-44.0,-35.0,-48.0,-44.0,-45.0,-39.0,-46.0,-85.0,-87.0,-82.0,-81.0,41.0,43.0,47.0,33.0,1
2712,92:69:1D:31:68:E9,3853110,489077469,4066,3655073,3849044,485422396,1,5526,1167217,5350,1127189,176,40028,2210,12,4330,103,1,65,229410.0,130000.0,-51.0,-47.0,-43.0,-48.0,-51.0,-47.0,-43.0,-48.0,-85.0,-87.0,-82.0,-81.0,34.0,40.0,39.0,33.0,1
2713,CC:2F:71:3F:1F:24,5113511,1946033351,1264467,1460610955,3849044,485422396,2222,1064725,1219830883,1063864,1219726631,861,104252,1030095,15,1262602,121906,2219,816,144444.0,43333.0,-72.0,-68.0,-68.0,-72.0,-72.0,-68.0,-68.0,-72.0,-85.0,-87.0,-82.0,-81.0,13.0,19.0,14.0,9.0,1
2714,CC:2F:71:3E:C5:1F,3850052,485545562,1008,123166,3849044,485422396,3,4420,368238,3685,280978,735,87260,1067,14,1451,30,3,54,144444.0,39000.0,-71.0,-72.0,-68.0,-60.0,-70.0,-71.0,-68.0,-60.0,-85.0,-87.0,-82.0,-81.0,14.0,15.0,14.0,21.0,1
2715,BA:8C:B9:54:50:24,3853993,491618376,4949,6195980,3849044,485422396,7,9940,1764608,9918,1761113,22,3495,2361,18,5465,44,7,75,216660.0,130000.0,-48.0,-35.0,-43.0,-45.0,-46.0,-35.0,-43.0,-46.0,-85.0,-87.0,-82.0,-81.0,37.0,52.0,39.0,36.0,1
2716,62:47:05:9D:EB:15,3855814,497607168,6767,12184510,3849047,485422658,1,7099,3811265,7049,3803607,50,7658,3317,0,6844,56,1,126,229410.0,130000.0,-44.0,-44.0,-35.0,-48.0,-44.0,-45.0,-39.0,-46.0,-85.0,-87.0,-82.0,-81.0,41.0,43.0,47.0,33.0,1
2717,92:69:1D:31:68:E9,3853113,489077731,4066,3655073,3849047,485422658,1,5526,1167217,5350,1127189,176,40028,2210,12,4330,103,1,65,229410.0,130000.0,-51.0,-47.0,-43.0,-48.0,-51.0,-47.0,-43.0,-48.0,-85.0,-87.0,-82.0,-81.0,34.0,40.0,39.0,33.0,1
2718,CC:2F:71:3F:1F:24,5113706,1946278013,1264659,1460855355,3849047,485422658,2222,1064904,1220068499,1064043,1219964247,861,104252,1030268,15,1262794,121906,2219,816,144444.0,43333.0,-72.0,-68.0,-68.0,-71.0,-72.0,-68.0,-67.0,-71.0,-85.0,-87.0,-82.0,-81.0,13.0,19.0,14.0,10.0,1
2719,CC:2F:71:3E:C5:1F,3850057,485546026,1008,123166,3849049,485422860,3,4420,368238,3685,280978,735,87260,1067,14,1451,30,3,54,144444.0,39000.0,-71.0,-72.0,-68.0,-60.0,-70.0,-71.0,-68.0,-60.0,-85.0,-87.0,-82.0,-81.0,14.0,15.0,14.0,21.0,1
2720,BA:8C:B9:54:50:24,3854000,491619042,4949,6195980,3849051,485423062,7,9940,1764608,9918,1761113,22,3495,2361,18,5465,44,7,75,216660.0,130000.0,-48.0,-35.0,-43.0,-45.0,-46.0,-35.0,-43.0,-46.0,-85.0,-87.0,-82.0,-81.0,37.0,52.0,39.0,36.0,1
2721,62:47:05:9D:EB:15,3855822,497608898,6767,12184510,3849055,485424388,1,7099,3811265,7049,3803607,50,7658,3317,0,6844,56,1,126,229410.0,130000.0,-44.0,-44.0,-35.0,-48.0,-44.0,-45.0,-39.0,-46.0,-85.0,-87.0,-82.0,-81.0,41.0,43.0,47.0,33.0,1
2722,92:69:1D:31:68:E9,3853121,489079461,4066,3655073,3849055,485424388,1,5526,1167217,5350,1127189,176,40028,2210,12,4330,103,1,65,229410.0,130000.0,-51.0,-47.0,-43.0,-48.0,-51.0,-47.0,-43.0,-48.0,-85.0,-87.0,-82.0,-81.0,34.0,40.0,39.0,33.0,1
2723,CC:2F:71:3F:1F:24,5113916,1946539683,1264861,1461115295,3849055,485424388,2222,1065094,1220324491,1064233,1220220239,861,104252,1030450,15,1262996,121906,2219,816,144444.0,43333.0,-72.0,-68.0,-68.0,-73.0,-72.0,-68.0,-68.0,-72.0,-85.0,-87.0,-82.0,-81.0,13.0,19.0,14.0,8.0,1
2724,CC:2F:71:3E:C5:1F,3850063,485547554,1008,123166,3849055,485424388,3,4420,368238,3685,280978,735,87260,1067,14,1451,30,3,54,144444.0,39000.0,-71.0,-72.0,-68.0,-60.0,-70.0,-71.0,-68.0,-60.0,-85.0,-87.0,-82.0,-81.0,14.0,15.0,14.0,21.0,1
2725,BA:8C:B9:54:50:24,3854004,491620368,4949,6195980,3849055,485424388,7,9940,1764608,9918,1761113,22,3495,2361,18,5465,44,7,75,216660.0,130000.0,-48.0,-35.0,-43.0,-45.0,-46.0,-35.0,-43.0,-46.0,-85.0,-87.0,-82.0,-81.0,37.0,52.0,39.0,36.0,1
2726,62:47:05:9D:EB:15,3855824,497609100,6767,12184510,3849057,485424590,1,7102,3811469,7052,3803811,50,7658,3317,0,6844,56,1,126,229410.0,130000.0,-45.0,-45.0,-35.0,-48.0,-44.0,-45.0,-39.0,-46.0,-85.0,-87.0,-82.0,-81.0,40.0,42.0,47.0,33.0,1
2727,92:69:1D:31:68:E9,3853125,489079865,4066,3655073,3849059,485424792,1,5526,1167217,5350,1127189,176,40028,2210,12,4330,103,1,65,229410.0,130000.0,-51.0,-47.0,-43.0,-48.0,-51.0,-47.0,-43.0,-48.0,-85.0,-87.0,-82.0,-81.0,34.0,40.0,39.0,33.0,1
2728,CC:2F:71:3F:1F:24,5114112,1946784487,1265053,1461359695,3849059,485424792,2222,1065277,1220569729,1064416,1220465477,861,104252,1030622,15,1263188,121908,2219,816,144444.0,43333.0,-72.0,-68.0,-68.0,-72.0,-72.0,-68.0,-67.0,-71.0,-85.0,-87.0,-82.0,-81.0,13.0,19.0,14.0,9.0,1
2729,CC:2F:71:3E:C5:1F,3850068,485548026,1008,123166,3849060,485424860,3,4420,368238,3685,280978,735,87260,1067,14,1451,30,3,54,144444.0,39000.0,-71.0,-72.0,-68.0,-60.0,-70.0,-71.0,-68.0,-60.0,-85.0,-87.0,-82.0,-81.0,14.0,15.0,14.0,21.0,1
2730,BA:8C:B9:54:50:24,3854010,491620974,4949,6195980,3849061,485424994,7,9940,1764608,9918,1761113,22,3495,2361,18,5465,44,7,75,216660.0,130000.0,-48.0,-35.0,-43.0,-45.0,-46.0,-35.0,-43.0,-46.0,-85.0,-87.0,-82.0,-81.0,37.0,52.0,39.0,36.0,1
2731,62:47:05:9D:EB:15,3855833,497610890,6767,12184510,3849066,485426380,1,7102,3811469,7052,3803811,50,7658,3317,0,6844,56,1,126,229410.0,130000.0,-45.0,-45.0,-35.0,-48.0,-44.0,-45.0,-39.0,-46.0,-85.0,-87.0,-82.0,-81.0,40.0,42.0,47.0,33.0,1
2732,92:69:1D:31:68:E9,3853132,489081453,4066,3655073,3849066,485426380,1,5526,1167217,5350,1127189,176,40028,2210,12,4330,103,1,65,229410.0,130000.0,-51.0,-47.0,-43.0,-48.0,-51.0,-47.0,-43.0,-48.0,-85.0,-87.0,-82.0,-81.0,34.0,40.0,39.0,33.0,1
2733,CC:2F:71:3F:1F:24,5114320,1947034268,1265254,1461607888,3849066,485426380,2222,1065459,1220801146,1064598,1220696894,861,104252,1030800,15,1263387,121909,2219,816,144444.0,43333.0,-72.0,-68.0,-68.0,-72.0,-72.0,-68.0,-68.0,-71.0,-85.0,-87.0,-82.0,-81.0,13.0,19.0,14.0,9.0,1
2734,CC:2F:71:3E:C5:1F,3850074,485549546,1008,123166,3849066,485426380,3,4420,368238,3685,280978,735,87260,1067,14,1451,30,3,54,144444.0,39000.0,-71.0,-72.0,-68.0,-60.0,-70.0,-71.0,-68.0,-60.0,-85.0,-87.0,-82.0,-81.0,14.0,15.0,14.0,21.0,1
2735,BA:8C:B9:54:50:24,3854015,491622360,4949,6195980,3849066,485426380,7,9940,1764608,9918,1761113,22,3495,2361,18,5465,44,7,75,216660.0,130000.0,-48.0,-35.0,-43.0,-45.0,-46.0,-35.0,-43.0,-46.0,-85.0,-87.0,-82.0,-81.0,37.0,52.0,39.0,36.0,1
2736,62:47:05:9D:EB:15,3855837,497611294,6767,12184510,3849070,485426784,1,7102,3811469,7052,3803811,50,7658,3317,0,6844,56,1,126,229410.0,130000.0,-45.0,-45.0,-35.0,-48.0,-44.0,-45.0,-39.0,-46.0,-85.0,-87.0,-82.0,-81.0,40.0,42.0,47.0,33.0,1
2737,92:69:1D:31:68:E9,3853136,489081857,4066,3655073,3849070,485426784,1,5526,1167217,5350,1127189,176,40028,2210,12,4330,103,1,65,229410.0,130000.0,-51.0,-47.0,-43.0,-48.0,-51.0,-47.0,-43.0,-48.0,-85.0,-87.0,-82.0,-81.0,34.0,40.0,39.0,33.0,1
2738,CC:2F:71:3F:1F:24,5114518,1947279274,1265446,1461852288,3849072,485426986,2222,1065639,1221044502,1064778,1220940250,861,104252,1030973,15,1263581,121909,2219,816,144444.0,43333.0,-72.0,-68.0,-68.0,-71.0,-72.0,-68.0,-68.0,-71.0,-85.0,-87.0,-82.0,-81.0,13.0,19.0,14.0,10.0,1
2739,CC:2F:71:3E:C5:1F,3850080,485550152,1008,123166,3849072,485426986,3,4420,368238,3685,280978,735,87260,1067,14,1451,30,3,54,144444.0,39000.0,-71.0,-72.0,-68.0,-60.0,-70.0,-71.0,-68.0,-60.0,-85.0,-87.0,-82.0,-81.0,14.0,15.0,14.0,21.0,1
2740,BA:8C:B9:54:50:24,3854021,491622966,4949,6195980,3849072,485426986,7,9940,1764608,9918,1761113,22,3495,2361,18,5465,44,7,75,216660.0,130000.0,-48.0,-35.0,-43.0,-45.0,-46.0,-35.0,-43.0,-46.0,-85.0,-87.0,-82.0,-81.0,37.0,52.0,39.0,36.0,1
2741,62:47:05:9D:EB:15,3855842,497611758,6767,12184510,3849075,485427248,1,7102,3811469,7052,3803811,50,7658,3317,0,6844,56,1,126,229410.0,130000.0,-45.0,-45.0,-35.0,-48.0,-44.0,-45.0,-39.0,-46.0,-85.0,-87.0,-82.0,-81.0,40.0,42.0,47.0,33.0,1
2742,92:69:1D:31:68:E9,3853141,489082321,4066,3655073,3849075,485427248,1,5527,1167285,5351,1127257,176,40028,2210,12,4330,103,1,65,229410.0,130000.0,-51.0,-47.0,-43.0,-48.0,-51.0,-47.0,-43.0,-48.0,-85.0,-87.0,-82.0,-81.0,34.0,40.0,39.0,33.0,1
2743,CC:2F:71:3F:1F:24,5114712,1947523806,1265637,1462096558,3849075,485427248,2222,1065820,1221287960,1064959,1221183708,861,104252,1031145,15,1263772,121909,2219,816,144444.0,43333.0,-72.0,-68.0,-68.0,-71.0,-71.0,-68.0,-68.0,-71.0,-85.0,-87.0,-82.0,-81.0,13.0,19.0,14.0,10.0,1
2744,CC:2F:71:3E:C5:1F,3850083,485550414,1008,123166,3849075,485427248,3,4420,368238,3685,280978,735,87260,1067,14,1451,30,3,54,144444.0,39000.0,-71.0,-72.0,-68.0,-60.0,-70.0,-71.0,-68.0,-60.0,-85.0,-87.0,-82.0,-81.0,14.0,15.0,14.0,21.0,1
2745,BA:8C:B9:54:50:24,3854024,491623228,4949,6195980,3849075,485427248,7,9940,1764608,9918,1761113,22,3495,2361,18,5465,44,7,75,216660.0,130000.0,-48.0,-35.0,-43.0,-45.0,-46.0,-35.0,-43.0,-46.0,-85.0,-87.0,-82.0,-81.0,37.0,52.0,39.0,36.0,1
2746,62:47:05:9D:EB:15,3855846,497612162,6767,12184510,3849079,485427652,1,7102,3811469,7052,3803811,50,7658,3317,0,6844,56,1,126,229410.0,130000.0,-45.0,-45.0,-35.0,-48.0,-44.0,-45.0,-39.0,-46.0,-85.0,-87.0,-82.0,-82.0,40.0,42.0,47.0,34.0,1
2747,92:69:1D:31:68:E9,3853147,489082927,4066,3655073,3849081,485427854,1,5527,1167285,5351,1127257,176,40028,2210,12,4330,103,1,65,229410.0,130000.0,-51.0,-47.0,-43.0,-48.0,-51.0,-47.0,-43.0,-48.0,-85.0,-87.0,-82.0,-82.0,34.0,40.0,39.0,34.0,1
2748,CC:2F:71:3F:1F:24,5114909,1947765820,1265828,1462337966,3849081,485427854,2222,1065996,1221520890,1065135,1221416638,861,104252,1031315,15,1263963,121909,2219,816,144444.0,43333.0,-72.0,-68.0,-68.0,-71.0,-71.0,-68.0,-67.0,-71.0,-85.0,-87.0,-82.0,-82.0,13.0,19.0,14.0,11.0,1
2749,CC:2F:71:3E:C5:1F,3850089,485551020,1008,123166,3849081,485427854,3,4420,368238,3685,280978,735,87260,1067,14,1451,30,3,54,144444.0,39000.0,-71.0,-72.0,-68.0,-60.0,-70.0,-71.0,-68.0,-60.0,-85.0,-87.0,-82.0,-82.0,14.0,15.0,14.0,22.0,1
2750,BA:8C:B9:54:50:24,3854032,491624036,4949,6195980,3849083,485428056,7,9940,1764608,9918,1761113,22,3495,2361,18,5465,44,7,75,216660.0,130000.0,-48.0,-35.0,-43.0,-45.0,-46.0,-35.0,-43.0,-46.0,-85.0,-87.0,-82.0,-82.0,37.0,52.0,39.0,37.0,1
2751,62:47:05:9D:EB:15,3855850,497612566,6767,12184510,3849083,485428056,1,7102,3811469,7052,3803811,50,7658,3317,0,6844,56,1,126,229410.0,130000.0,-45.0,-45.0,-35.0,-48.0,-44.0,-45.0,-39.0,-46.0,-85.0,-87.0,-82.0,-82.0,40.0,42.0,47.0,34.0,1
2752,92:69:1D:31:68:E9,3853149,489083129,4066,3655073,3849083,485428056,1,5527,1167285,5351,1127257,176,40028,2210,12,4330,103,1,65,229410.0,130000.0,-51.0,-47.0,-43.0,-48.0,-51.0,-47.0,-43.0,-48.0,-85.0,-87.0,-82.0,-82.0,34.0,40.0,39.0,34.0,1
2753,CC:2F:71:3F:1F:24,5115112,1948017001,1266029,1462588945,3849083,485428056,2222,1066186,1221770239,1065325,1221665987,861,104252,1031494,15,1264164,121910,2219,816,144444.0,43333.0,-71.0,-69.0,-68.0,-71.0,-70.0,-68.0,-67.0,-71.0,-85.0,-87.0,-82.0,-82.0,14.0,18.0,14.0,11.0,1
2754,CC:2F:71:3E:C5:1F,3850091,485551222,1008,123166,3849083,485428056,3,4420,368238,3685,280978,735,87260,1067,14,1451,30,3,54,144444.0,39000.0,-71.0,-72.0,-68.0,-60.0,-70.0,-71.0,-68.0,-60.0,-85.0,-87.0,-82.0,-82.0,14.0,15.0,14.0,22.0,1
2755,BA:8C:B9:54:50:24,3854035,491624298,4949,6195980,3849086,485428318,7,9940,1764608,9918,1761113,22,3495,2361,18,5465,44,7,75,216660.0,130000.0,-48.0,-35.0,-43.0,-45.0,-46.0,-35.0,-43.0,-46.0,-85.0,-87.0,-82.0,-82.0,37.0,52.0,39.0,37.0,1
2756,62:47:05:9D:EB:15,3855857,497613232,6767,12184510,3849090,485428722,1,7102,3811469,7052,3803811,50,7658,3317,0,6844,56,1,126,229410.0,130000.0,-45.0,-45.0,-35.0,-48.0,-44.0,-45.0,-39.0,-46.0,-85.0,-87.0,-82.0,-82.0,40.0,42.0,47.0,34.0,1
2757,92:69:1D:31:68:E9,3853156,489083795,4066,3655073,3849090,485428722,1,5527,1167285,5351,1127257,176,40028,2210,12,4330,103,1,65,229410.0,130000.0,-51.0,-47.0,-43.0,-48.0,-51.0,-47.0,-43.0,-48.0,-85.0,-87.0,-82.0,-82.0,34.0,40.0,39.0,34.0,1
2758,CC:2F:71:3F:1F:24,5115354,1948309967,1266261,1462880917,3849093,485429050,2222,1066400,1222040092,1065539,1221935840,861,104252,1031691,15,1264395,121919,2219,816,144444.0,43333.0,-70.0,-68.0,-67.0,-74.0,-70.0,-68.0,-67.0,-73.0,-85.0,-87.0,-82.0,-82.0,15.0,19.0,15.0,8.0,1
2759,CC:2F:71:3E:C5:1F,3850102,485552332,1009,123282,3849093,485429050,3,4421,368308,3686,281048,735,87260,1067,14,1452,30,3,54,144444.0,39000.0,-68.0,-66.0,-64.0,-60.0,-70.0,-70.0,-67.0,-60.0,-85.0,-87.0,-82.0,-82.0,17.0,21.0,18.0,22.0,1
2760,BA:8C:B9:54:50:24,3854043,491625146,4950,6196096,3849093,485429050,7,9945,1764948,9923,1761453,22,3495,2361,18,5466,44,7,75,216660.0,130000.0,-48.0,-35.0,-43.0,-45.0,-44.0,-35.0,-43.0,-46.0,-85.0,-87.0,-82.0,-82.0,37.0,52.0,39.0,37.0,1
2761,62:47:05:9D:EB:15,3855861,497613676,6768,12184626,3849093,485429050,1,7104,3811605,7054,3803947,50,7658,3317,0,6845,56,1,126,229410.0,130000.0,-46.0,-49.0,-52.0,-46.0,-44.0,-45.0,-39.0,-46.0,-85.0,-87.0,-82.0,-82.0,39.0,38.0,30.0,36.0,1
2762,92:69:1D:31:68:E9,3853160,489084183,4067,3655133,3849093,485429050,1,5529,1167421,5353,1127393,176,40028,2210,12,4331,103,1,65,229410.0,130000.0,-51.0,-47.0,-43.0,-48.0,-51.0,-47.0,-43.0,-47.0,-85.0,-87.0,-82.0,-82.0,34.0,40.0,39.0,34.0,1
2763,CC:2F:71:3F:1F:24,5115548,1948553129,1266453,1463123877,3849095,485429252,2222,1066575,1222277130,1065714,1222172878,861,104252,1031859,15,1264588,121942,2219,816,144444.0,43333.0,-72.0,-69.0,-66.0,-72.0,-71.0,-69.0,-66.0,-72.0,-85.0,-87.0,-82.0,-82.0,13.0,18.0,16.0,10.0,1
2764,CC:2F:71:3E:C5:1F,3850104,485552534,1009,123282,3849095,485429252,3,4422,368378,3687,281118,735,87260,1067,14,1452,30,3,54,144444.0,39000.0,-71.0,-71.0,-69.0,-60.0,-70.0,-70.0,-67.0,-60.0,-85.0,-87.0,-82.0,-82.0,14.0,16.0,13.0,22.0,1
2765,BA:8C:B9:54:50:24,3854045,491625348,4950,6196096,3849095,485429252,7,9945,1764948,9923,1761453,22,3495,2361,18,5466,44,7,75,216660.0,130000.0,-48.0,-35.0,-43.0,-45.0,-44.0,-35.0,-43.0,-46.0,-85.0,-87.0,-82.0,-82.0,37.0,52.0,39.0,37.0,1
2766,62:47:05:9D:EB:15,3855870,497614544,6768,12184626,3849102,485429918,1,7104,3811605,7054,3803947,50,7658,3317,0,6845,56,1,126,229410.0,130000.0,-46.0,-49.0,-52.0,-46.0,-44.0,-45.0,-39.0,-46.0,-85.0,-87.0,-82.0,-82.0,39.0,38.0,30.0,36.0,1
2767,92:69:1D:31:68:E9,3853169,489085051,4067,3655133,3849102,485429918,1,5529,1167421,5353,1127393,176,40028,2210,12,4331,103,1,65,229410.0,130000.0,-51.0,-47.0,-43.0,-48.0,-51.0,-47.0,-43.0,-47.0,-85.0,-87.0,-82.0,-82.0,34.0,40.0,39.0,34.0,1
2768,CC:2F:71:3F:1F:24,5115753,1948800112,1266651,1463370194,3849102,485429918,2222,1066760,1222518666,1065899,1222414414,861,104252,1032037,15,1264786,121970,2219,816,144444.0,43333.0,-72.0,-70.0,-67.0,-72.0,-71.0,-69.0,-66.0,-72.0,-85.0,-87.0,-82.0,-82.0,13.0,17.0,15.0,10.0,1
2769,CC:2F:71:3E:C5:1F,3850111,485553200,1009,123282,3849102,485429918,3,4422,368378,3687,281118,735,87260,1067,14,1452,30,3,54,144444.0,39000.0,-71.0,-71.0,-69.0,-60.0,-70.0,-70.0,-67.0,-60.0,-85.0,-87.0,-82.0,-82.0,14.0,16.0,13.0,22.0,1
2770,BA:8C:B9:54:50:24,3854052,491626014,4950,6196096,3849102,485429918,7,9945,1764948,9923,1761453,22,3495,2361,18,5466,44,7,75,216660.0,130000.0,-48.0,-35.0,-43.0,-45.0,-44.0,-35.0,-43.0,-46.0,-85.0,-87.0,-82.0,-82.0,37.0,52.0,39.0,37.0,1
2771,62:47:05:9D:EB:15,3855872,497614746,6768,12184626,3849104,485430120,1,7104,3811605,7054,3803947,50,7658,3317,0,6845,56,1,126,229410.0,130000.0,-46.0,-49.0,-52.0,-46.0,-44.0,-45.0,-39.0,-46.0,-85.0,-87.0,-82.0,-82.0,39.0,38.0,30.0,36.0,1
2772,92:69:1D:31:68:E9,3853171,489085253,4067,3655133,3849104,485430120,1,5529,1167421,5353,1127393,176,40028,2210,12,4331,103,1,65,229410.0,130000.0,-51.0,-47.0,-43.0,-48.0,-51.0,-47.0,-43.0,-47.0,-85.0,-87.0,-82.0,-82.0,34.0,40.0,39.0,34.0,1
2773,CC:2F:71:3F:1F:24,5116413,1949621153,1267308,1464190760,3849105,485430393,2222,1067152,1222792156,1066291,1222687904,861,104252,1032429,15,1265443,121981,2219,816,144444.0,43333.0,-72.0,-70.0,-67.0,-73.0,-72.0,-69.0,-67.0,-72.0,-85.0,-87.0,-82.0,-82.0,13.0,17.0,15.0,9.0,1
2774,CC:2F:71:3E:C5:1F,3850114,485553675,1009,123282,3849105,485430393,3,4422,368378,3687,281118,735,87260,1067,14,1452,30,3,54,144444.0,39000.0,-71.0,-71.0,-69.0,-60.0,-70.0,-70.0,-67.0,-60.0,-85.0,-87.0,-82.0,-82.0,14.0,16.0,13.0,22.0,1
2775,BA:8C:B9:54:50:24,3854055,491626489,4950,6196096,3849105,485430393,7,9945,1764948,9923,1761453,22,3495,2361,18,5466,44,7,75,216660.0,130000.0,-48.0,-35.0,-43.0,-45.0,-44.0,-35.0,-43.0,-46.0,-85.0,-87.0,-82.0,-82.0,37.0,52.0,39.0,37.0,1
2776,62:47:05:9D:EB:15,3855879,497615625,6768,12184626,3849111,485430999,1,7104,3811605,7054,3803947,50,7658,3317,0,6845,56,1,126,229410.0,130000.0,-46.0,-49.0,-52.0,-46.0,-44.0,-45.0,-39.0,-46.0,-85.0,-86.0,-82.0,-82.0,39.0,37.0,30.0,36.0,1
2777,92:69:1D:31:68:E9,3853178,489086132,4067,3655133,3849111,485430999,1,5529,1167421,5353,1127393,176,40028,2210,12,4331,103,1,65,229410.0,130000.0,-51.0,-47.0,-43.0,-48.0,-51.0,-47.0,-43.0,-47.0,-85.0,-86.0,-82.0,-82.0,34.0,39.0,39.0,34.0,1
2778,CC:2F:71:3F:1F:24,5116806,1950110734,1267695,1464679735,3849111,485430999,2222,1067412,1223039578,1066551,1222935326,861,104252,1032685,15,1265830,121985,2219,816,144444.0,43333.0,-72.0,-69.0,-68.0,-72.0,-72.0,-69.0,-67.0,-72.0,-85.0,-86.0,-82.0,-82.0,13.0,17.0,14.0,10.0,1
2779,CC:2F:71:3E:C5:1F,3850120,485554281,1009,123282,3849111,485430999,3,4422,368378,3687,281118,735,87260,1067,14,1452,30,3,54,144444.0,39000.0,-71.0,-71.0,-69.0,-60.0,-70.0,-70.0,-67.0,-60.0,-85.0,-86.0,-82.0,-82.0,14.0,15.0,13.0,22.0,1
2780,BA:8C:B9:54:50:24,3854062,491627155,4950,6196096,3849112,485431059,7,9945,1764948,9923,1761453,22,3495,2361,18,5466,44,7,75,216660.0,130000.0,-48.0,-35.0,-43.0,-45.0,-44.0,-35.0,-43.0,-46.0,-85.0,-86.0,-82.0,-82.0,37.0,51.0,39.0,37.0,1
2781,62:47:05:9D:EB:15,3855882,497615887,6768,12184626,3849114,485431261,1,7104,3811605,7054,3803947,50,7658,3317,0,6845,56,1,126,229410.0,130000.0,-46.0,-49.0,-52.0,-46.0,-44.0,-45.0,-39.0,-46.0,-85.0,-86.0,-82.0,-82.0,39.0,37.0,30.0,36.0,1
2782,92:69:1D:31:68:E9,3853182,489086456,4067,3655133,3849115,485431323,1,5529,1167421,5353,1127393,176,40028,2210,12,4331,103,1,65,229410.0,130000.0,-51.0,-47.0,-43.0,-48.0,-51.0,-47.0,-43.0,-47.0,-85.0,-86.0,-82.0,-82.0,34.0,39.0,39.0,34.0,1
2783,CC:2F:71:3F:1F:24,5117003,1950355572,1267888,1464924249,3849115,485431323,2222,1067587,1223271120,1066726,1223166868,861,104252,1032857,15,1266023,122008,2219,816,144444.0,43333.0,-71.0,-70.0,-67.0,-72.0,-71.0,-69.0,-67.0,-72.0,-85.0,-86.0,-82.0,-82.0,14.0,16.0,15.0,10.0,1
2784,CC:2F:71:3E:C5:1F,3850124,485554605,1009,123282,3849115,485431323,3,4424,368566,3688,281188,736,87378,1068,14,1452,30,3,54,144444.0,39000.0,-71.0,-70.0,-69.0,-60.0,-70.0,-70.0,-67.0,-60.0,-85.0,-86.0,-82.0,-82.0,14.0,16.0,13.0,22.0,1
2785,BA:8C:B9:54:50:24,3854065,491627419,4950,6196096,3849115,485431323,7,9945,1764948,9923,1761453,22,3495,2361,18,5466,44,7,75,216660.0,130000.0,-48.0,-35.0,-43.0,-45.0,-44.0,-35.0,-43.0,-46.0,-85.0,-86.0,-82.0,-82.0,37.0,51.0,39.0,37.0,1
2786,62:47:05:9D:EB:15,3855891,497616923,6768,12184626,3849123,485432297,1,7104,3811605,7054,3803947,50,7658,3317,0,6845,56,1,126,229410.0,130000.0,-46.0,-49.0,-52.0,-46.0,-44.0,-45.0,-39.0,-46.0,-85.0,-86.0,-82.0,-82.0,39.0,37.0,30.0,36.0,1
2787,92:69:1D:31:68:E9,3853190,489087430,4067,3655133,3849123,485432297,1,5529,1167421,5353,1127393,176,40028,2210,12,4331,103,1,65,229410.0,130000.0,-51.0,-47.0,-43.0,-48.0,-51.0,-47.0,-43.0,-47.0,-85.0,-86.0,-82.0,-82.0,34.0,39.0,39.0,34.0,1
2788,CC:2F:71:3F:1F:24,5117212,1950607780,1268089,1465175483,3849123,485432297,2222,1067772,1223516502,1066911,1223412250,861,104252,1033036,15,1266224,122018,2219,817,144444.0,43333.0,-71.0,-70.0,-68.0,-72.0,-70.0,-69.0,-68.0,-71.0,-85.0,-86.0,-82.0,-82.0,14.0,16.0,14.0,10.0,1
2789,CC:2F:71:3E:C5:1F,3850132,485555579,1009,123282,3849123,485432297,3,4424,368566,3688,281188,736,87378,1068,14,1452,30,3,54,144444.0,39000.0,-71.0,-70.0,-69.0,-60.0,-70.0,-70.0,-67.0,-60.0,-85.0,-86.0,-82.0,-82.0,14.0,16.0,13.0,22.0,1
2790,BA:8C:B9:54:50:24,3854073,491628393,4950,6196096,3849123,485432297,7,9945,1764948,9923,1761453,22,3495,2361,18,5466,44,7,75,216660.0,130000.0,-48.0,-35.0,-43.0,-45.0,-44.0,-35.0,-43.0,-46.0,-85.0,-86.0,-82.0,-82.0,37.0,51.0,39.0,37.0,1
2791,62:47:05:9D:EB:15,3855894,497617185,6768,12184626,3849126,485432559,1,7104,3811605,7054,3803947,50,7658,3317,0,6845,56,1,126,229410.0,130000.0,-46.0,-49.0,-52.0,-46.0,-44.0,-45.0,-39.0,-46.0,-85.0,-86.0,-82.0,-82.0,39.0,37.0,30.0,36.0,1
2792,92:69:1D:31:68:E9,3853193,489087692,4067,3655133,3849126,485432559,1,5529,1167421,5353,1127393,176,40028,2210,12,4331,103,1,65,229410.0,130000.0,-51.0,-47.0,-43.0,-48.0,-51.0,-47.0,-43.0,-47.0,-85.0,-86.0,-82.0,-82.0,34.0,39.0,39.0,34.0,1
2793,CC:2F:71:3F:1F:24,5117420,1950862349,1268294,1465429790,3849126,485432559,2222,1067956,1223757994,1067095,1223653742,861,104252,1033216,15,1266429,122029,2219,817,144444.0,43333.0,-71.0,-69.0,-67.0,-72.0,-70.0,-69.0,-67.0,-71.0,-85.0,-86.0,-82.0,-82.0,14.0,17.0,15.0,10.0,1
2794,CC:2F:71:3E:C5:1F,3850135,485555841,1009,123282,3849126,485432559,3,4424,368566,3688,281188,736,87378,1068,14,1452,30,3,54,144444.0,39000.0,-71.0,-70.0,-69.0,-60.0,-70.0,-70.0,-67.0,-60.0,-85.0,-86.0,-82.0,-82.0,14.0,16.0,13.0,22.0,1
2795,BA:8C:B9:54:50:24,3854076,491628655,4950,6196096,3849126,485432559,7,9945,1764948,9923,1761453,22,3495,2361,18,5466,44,7,75,216660.0,130000.0,-48.0,-35.0,-43.0,-45.0,-44.0,-35.0,-43.0,-46.0,-85.0,-86.0,-82.0,-82.0,37.0,51.0,39.0,37.0,1
2796,62:47:05:9D:EB:15,3855900,497617791,6768,12184626,3849132,485433165,1,7104,3811605,7054,3803947,50,7658,3317,0,6845,56,1,126,229410.0,130000.0,-46.0,-49.0,-52.0,-46.0,-44.0,-45.0,-39.0,-46.0,-85.0,-86.0,-82.0,-82.0,39.0,37.0,30.0,36.0,1
2797,92:69:1D:31:68:E9,3853199,489088298,4067,3655133,3849132,485433165,1,5529,1167421,5353,1127393,176,40028,2210,12,4331,103,1,65,229410.0,130000.0,-51.0,-47.0,-43.0,-48.0,-51.0,-47.0,-43.0,-47.0,-85.0,-86.0,-82.0,-82.0,34.0,39.0,39.0,34.0,1
2798,CC:2F:71:3F:1F:24,5117617,1951104361,1268485,1465671196,3849132,485433165,2222,1068134,1223993928,1067273,1223889676,861,104252,1033389,15,1266620,122038,2219,817,144444.0,43333.0,-71.0,-70.0,-67.0,-73.0,-70.0,-69.0,-67.0,-71.0,-85.0,-86.0,-82.0,-82.0,14.0,16.0,15.0,9.0,1
2799,CC:2F:71:3E:C5:1F,3850141,485556447,1009,123282,3849132,485433165,3,4424,368566,3688,281188,736,87378,1068,14,1452,30,3,54,144444.0,39000.0,-71.0,-70.0,-69.0,-60.0,-70.0,-70.0,-67.0,-60.0,-85.0,-86.0,-82.0,-82.0,14.0,16.0,13.0,22.0,1
2800,BA:8C:B9:54:50:24,3854082,491629261,4950,6196096,3849132,485433165,7,9945,1764948,9923,1761453,22,3495,2361,18,5466,44,7,75,216660.0,130000.0,-48.0,-35.0,-43.0,-45.0,-44.0,-35.0,-43.0,-46.0,-85.0,-86.0,-82.0,-82.0,37.0,51.0,39.0,37.0,1
2801,62:47:05:9D:EB:15,3855903,497618055,6768,12184626,3849135,485433429,1,7104,3811605,7054,3803947,50,7658,3317,0,6845,56,1,126,229410.0,130000.0,-46.0,-49.0,-52.0,-46.0,-44.0,-45.0,-39.0,-46.0,-85.0,-86.0,-82.0,-82.0,39.0,37.0,30.0,36.0,1
2802,92:69:1D:31:68:E9,3853202,489088562,4067,3655133,3849135,485433429,1,5529,1167421,5353,1127393,176,40028,2210,12,4331,103,1,65,229410.0,130000.0,-51.0,-47.0,-43.0,-48.0,-51.0,-47.0,-43.0,-47.0,-85.0,-86.0,-82.0,-82.0,34.0,39.0,39.0,34.0,1
2803,CC:2F:71:3F:1F:24,5117816,1951352307,1268680,1465918818,3849136,485433489,2222,1068319,1224237886,1067457,1224133516,862,104370,1033566,15,1266815,122045,2219,817,144444.0,43333.0,-71.0,-70.0,-67.0,-72.0,-71.0,-70.0,-67.0,-72.0,-85.0,-86.0,-82.0,-82.0,14.0,16.0,15.0,10.0,1
2804,CC:2F:71:3E:C5:1F,3850145,485556771,1009,123282,3849136,485433489,3,4424,368566,3688,281188,736,87378,1068,14,1452,30,3,54,144444.0,39000.0,-71.0,-70.0,-69.0,-60.0,-70.0,-70.0,-67.0,-60.0,-85.0,-86.0,-82.0,-82.0,14.0,16.0,13.0,22.0,1
2805,BA:8C:B9:54:50:24,3854086,491629585,4950,6196096,3849136,485433489,7,9945,1764948,9923,1761453,22,3495,2361,18,5466,44,7,75,216660.0,130000.0,-48.0,-35.0,-43.0,-45.0,-44.0,-35.0,-43.0,-46.0,-85.0,-86.0,-82.0,-82.0,37.0,51.0,39.0,37.0,1
2806,62:47:05:9D:EB:15,3855910,497618721,6768,12184626,3849142,485434095,1,7104,3811605,7054,3803947,50,7658,3317,0,6845,56,1,126,229410.0,130000.0,-46.0,-49.0,-52.0,-46.0,-44.0,-45.0,-39.0,-46.0,-85.0,-86.0,-82.0,-82.0,39.0,37.0,30.0,36.0,1
2807,92:69:1D:31:68:E9,3853209,489089228,4067,3655133,3849142,485434095,1,5529,1167421,5353,1127393,176,40028,2210,12,4331,103,1,65,229410.0,130000.0,-51.0,-47.0,-43.0,-48.0,-51.0,-47.0,-43.0,-47.0,-85.0,-87.0,-82.0,-82.0,34.0,40.0,39.0,34.0,1
2808,CC:2F:71:3F:1F:24,5118014,1951594449,1268872,1466160354,3849142,485434095,2222,1068493,1224467774,1067631,1224363404,862,104370,1033736,15,1267007,122048,2219,817,144444.0,43333.0,-72.0,-70.0,-68.0,-73.0,-71.0,-69.0,-67.0,-72.0,-85.0,-87.0,-82.0,-82.0,13.0,17.0,14.0,9.0,1
2809,CC:2F:71:3E:C5:1F,3850151,485557377,1009,123282,3849142,485434095,3,4424,368566,3688,281188,736,87378,1068,14,1452,30,3,54,144444.0,39000.0,-71.0,-70.0,-69.0,-60.0,-70.0,-70.0,-67.0,-60.0,-85.0,-87.0,-82.0,-82.0,14.0,17.0,13.0,22.0,1
2810,BA:8C:B9:54:50:24,3854092,491630191,4950,6196096,3849142,485434095,7,9945,1764948,9923,1761453,22,3495,2361,18,5466,44,7,75,216660.0,130000.0,-48.0,-35.0,-43.0,-45.0,-44.0,-35.0,-43.0,-46.0,-85.0,-87.0,-82.0,-82.0,37.0,52.0,39.0,37.0,1
2811,62:47:05:9D:EB:15,3855912,497618923,6768,12184626,3849144,485434297,1,7105,3811673,7055,3804015,50,7658,3317,0,6845,56,1,126,229410.0,130000.0,-43.0,-45.0,-37.0,-44.0,-44.0,-45.0,-39.0,-46.0,-85.0,-87.0,-82.0,-82.0,42.0,42.0,45.0,38.0,1
2812,92:69:1D:31:68:E9,3853211,489089430,4067,3655133,3849144,485434297,1,5529,1167421,5353,1127393,176,40028,2210,12,4331,103,1,65,229410.0,130000.0,-51.0,-47.0,-43.0,-48.0,-51.0,-47.0,-43.0,-47.0,-85.0,-87.0,-82.0,-82.0,34.0,40.0,39.0,34.0,1
2813,CC:2F:71:3F:1F:24,5118215,1951842506,1269071,1466408209,3849144,485434297,2222,1068677,1224703457,1067815,1224599087,862,104370,1033916,15,1267206,122049,2219,817,144444.0,43333.0,-71.0,-70.0,-68.0,-72.0,-71.0,-70.0,-67.0,-72.0,-85.0,-87.0,-82.0,-82.0,14.0,17.0,14.0,10.0,1
2814,CC:2F:71:3E:C5:1F,3850153,485557579,1009,123282,3849144,485434297,3,4424,368566,3688,281188,736,87378,1068,14,1452,30,3,54,144444.0,39000.0,-71.0,-70.0,-69.0,-60.0,-70.0,-70.0,-67.0,-60.0,-85.0,-87.0,-82.0,-82.0,14.0,17.0,13.0,22.0,1
2815,BA:8C:B9:54:50:24,3854096,491630595,4950,6196096,3849146,485434499,7,9945,1764948,9923,1761453,22,3495,2361,18,5466,44,7,75,216660.0,130000.0,-48.0,-35.0,-43.0,-45.0,-44.0,-35.0,-43.0,-46.0,-85.0,-87.0,-82.0,-82.0,37.0,52.0,39.0,37.0,1
2816,62:47:05:9D:EB:15,3855919,497619589,6768,12184626,3849151,485434963,1,7105,3811673,7055,3804015,50,7658,3317,0,6845,56,1,126,229410.0,130000.0,-43.0,-45.0,-37.0,-44.0,-44.0,-45.0,-39.0,-46.0,-85.0,-87.0,-82.0,-82.0,42.0,42.0,45.0,38.0,1
2817,92:69:1D:31:68:E9,3853218,489090096,4067,3655133,3849151,485434963,1,5529,1167421,5353,1127393,176,40028,2210,12,4331,103,1,65,229410.0,130000.0,-51.0,-47.0,-43.0,-48.0,-51.0,-47.0,-43.0,-47.0,-85.0,-87.0,-82.0,-82.0,34.0,40.0,39.0,34.0,1
2818,CC:2F:71:3F:1F:24,5118417,1952090794,1269266,1466655831,3849151,485434963,2222,1068858,1224944169,1067996,1224839799,862,104370,1034091,15,1267401,122051,2219,817,144444.0,43333.0,-70.0,-69.0,-67.0,-73.0,-71.0,-69.0,-67.0,-72.0,-85.0,-87.0,-82.0,-82.0,15.0,18.0,15.0,9.0,1
2819,CC:2F:71:3E:C5:1F,3850160,485558245,1009,123282,3849151,485434963,3,4424,368566,3688,281188,736,87378,1068,14,1452,30,3,54,144444.0,39000.0,-71.0,-70.0,-69.0,-60.0,-70.0,-70.0,-67.0,-60.0,-85.0,-87.0,-82.0,-82.0,14.0,17.0,13.0,22.0,1
2820,BA:8C:B9:54:50:24,3854103,491631261,4950,6196096,3849153,485435165,7,9945,1764948,9923,1761453,22,3495,2361,18,5466,44,7,75,216660.0,130000.0,-48.0,-35.0,-43.0,-45.0,-44.0,-35.0,-43.0,-46.0,-85.0,-87.0,-82.0,-82.0,37.0,52.0,39.0,37.0,1
2821,62:47:05:9D:EB:15,3855921,497619791,6768,12184626,3849153,485435165,1,7105,3811673,7055,3804015,50,7658,3317,0,6845,56,1,126,229410.0,130000.0,-43.0,-45.0,-37.0,-44.0,-44.0,-45.0,-39.0,-46.0,-85.0,-87.0,-82.0,-82.0,42.0,42.0,45.0,38.0,1
2822,92:69:1D:31:68:E9,3853220,489090298,4067,3655133,3849153,485435165,1,5531,1167557,5355,1127529,176,40028,2210,12,4332,103,1,65,229410.0,130000.0,-52.0,-47.0,-45.0,-50.0,-51.0,-47.0,-43.0,-48.0,-85.0,-87.0,-82.0,-82.0,33.0,40.0,37.0,32.0,1
2823,CC:2F:71:3F:1F:24,5118611,1952332460,1269456,1466897093,3849155,485435367,2222,1069034,1225178499,1068172,1225074129,862,104370,1034261,15,1267591,122056,2219,817,144444.0,43333.0,-71.0,-70.0,-67.0,-72.0,-70.0,-70.0,-67.0,-72.0,-85.0,-87.0,-82.0,-82.0,14.0,17.0,15.0,10.0,1
2824,CC:2F:71:3E:C5:1F,3850166,485558851,1009,123282,3849157,485435569,3,4426,368706,3690,281328,736,87378,1068,14,1453,30,3,54,144444.0,39000.0,-65.0,-66.0,-63.0,-60.0,-70.0,-69.0,-67.0,-60.0,-85.0,-87.0,-82.0,-82.0,20.0,21.0,19.0,22.0,1
2825,BA:8C:B9:54:50:24,3854107,491631665,4950,6196096,3849157,485435569,7,9947,1765084,9925,1761589,22,3495,2361,18,5467,44,7,75,216660.0,130000.0,-48.0,-35.0,-43.0,-45.0,-43.0,-35.0,-44.0,-47.0,-85.0,-87.0,-82.0,-82.0,37.0,52.0,39.0,37.0,1
2826,62:47:05:9D:EB:15,3855927,497620397,6768,12184626,3849159,485435771,1,7105,3811673,7055,3804015,50,7658,3317,0,6845,56,1,126,229410.0,130000.0,-43.0,-45.0,-37.0,-44.0,-44.0,-45.0,-39.0,-46.0,-86.0,-87.0,-83.0,-83.0,43.0,42.0,46.0,39.0,1
2827,92:69:1D:31:68:E9,3853241,489098913,4079,3662880,3849162,485436033,1,5548,1170751,5372,1130723,176,40028,2223,12,4344,103,1,65,229410.0,130000.0,-52.0,-50.0,-47.0,-50.0,-52.0,-50.0,-46.0,-50.0,-86.0,-87.0,-83.0,-83.0,34.0,37.0,36.0,33.0,1
2828,CC:2F:71:3F:1F:24,5118820,1952593066,1269658,1467157033,3849162,485436033,2222,1069218,1225429411,1068356,1225325041,862,104370,1034440,15,1267791,122056,2219,817,144444.0,43333.0,-71.0,-70.0,-67.0,-71.0,-71.0,-70.0,-67.0,-71.0,-86.0,-87.0,-83.0,-83.0,15.0,17.0,16.0,12.0,1
2829,CC:2F:71:3E:C5:1F,3850171,485559315,1009,123282,3849162,485436033,3,4426,368706,3690,281328,736,87378,1068,14,1453,30,3,54,144444.0,39000.0,-65.0,-66.0,-63.0,-60.0,-70.0,-69.0,-67.0,-60.0,-86.0,-87.0,-83.0,-83.0,21.0,21.0,20.0,23.0,1
2830,BA:8C:B9:54:50:24,3854112,491632129,4950,6196096,3849162,485436033,7,9947,1765084,9925,1761589,22,3495,2361,18,5467,44,7,75,216660.0,130000.0,-48.0,-35.0,-43.0,-45.0,-43.0,-35.0,-44.0,-47.0,-86.0,-87.0,-83.0,-83.0,38.0,52.0,40.0,38.0,1
2831,62:47:05:9D:EB:15,3855930,497620659,6768,12184626,3849162,485436033,1,7105,3811673,7055,3804015,50,7658,3317,0,6845,56,1,126,229410.0,130000.0,-43.0,-45.0,-37.0,-44.0,-44.0,-45.0,-39.0,-46.0,-86.0,-87.0,-83.0,-83.0,43.0,42.0,46.0,39.0,1
2832,92:69:1D:31:68:E9,3853259,489106631,4095,3670396,3849164,485436235,1,5573,1174207,5397,1134179,176,40028,2240,12,4360,103,1,65,229410.0,137640.0,-51.0,-47.0,-45.0,-47.0,-51.0,-49.0,-45.0,-49.0,-86.0,-87.0,-83.0,-83.0,35.0,40.0,38.0,36.0,1
2833,CC:2F:71:3F:1F:24,5119020,1952838087,1269854,1467401650,3849166,485436437,2222,1069396,1225660112,1068534,1225555742,862,104370,1034615,15,1267989,122057,2219,817,144444.0,43333.0,-70.0,-69.0,-67.0,-71.0,-70.0,-69.0,-67.0,-71.0,-86.0,-87.0,-83.0,-83.0,16.0,18.0,16.0,12.0,1
2834,CC:2F:71:3E:C5:1F,3850175,485559719,1009,123282,3849166,485436437,3,4426,368706,3690,281328,736,87378,1068,14,1453,30,3,54,144444.0,39000.0,-65.0,-66.0,-63.0,-60.0,-70.0,-69.0,-67.0,-60.0,-86.0,-87.0,-83.0,-83.0,21.0,21.0,20.0,23.0,1
2835,BA:8C:B9:54:50:24,3854116,491632533,4950,6196096,3849166,485436437,7,9948,1765152,9926,1761657,22,3495,2361,18,5467,44,7,75,216660.0,130000.0,-40.0,-37.0,-46.0,-51.0,-42.0,-35.0,-44.0,-47.0,-86.0,-87.0,-83.0,-83.0,46.0,50.0,37.0,32.0,1
2836,62:47:05:9D:EB:15,3855939,497621740,6768,12184626,3849171,485437114,1,7105,3811673,7055,3804015,50,7658,3317,0,6845,56,1,126,229410.0,130000.0,-43.0,-45.0,-37.0,-44.0,-44.0,-45.0,-39.0,-46.0,-86.0,-87.0,-83.0,-83.0,43.0,42.0,46.0,39.0,1
2837,92:69:1D:31:68:E9,3853315,489132142,4144,3695028,3849171,485437114,1,5633,1201600,5457,1161572,176,40028,2289,12,4408,103,1,65,229410.0,137640.0,-52.0,-50.0,-46.0,-51.0,-52.0,-50.0,-46.0,-51.0,-86.0,-87.0,-83.0,-83.0,34.0,37.0,37.0,32.0,1
2838,CC:2F:71:3F:1F:24,5119216,1953083050,1270045,1467645936,3849171,485437114,2222,1069575,1225900788,1068713,1225796418,862,104370,1034786,15,1268180,122058,2219,817,144444.0,43333.0,-71.0,-70.0,-67.0,-71.0,-71.0,-70.0,-67.0,-71.0,-86.0,-87.0,-83.0,-83.0,15.0,17.0,16.0,12.0,1
2839,CC:2F:71:3E:C5:1F,3850180,485560396,1009,123282,3849171,485437114,3,4426,368706,3690,281328,736,87378,1068,14,1453,30,3,54,144444.0,39000.0,-65.0,-66.0,-63.0,-60.0,-70.0,-69.0,-67.0,-60.0,-86.0,-87.0,-83.0,-83.0,21.0,21.0,20.0,23.0,1
2840,BA:8C:B9:54:50:24,3854121,491633210,4950,6196096,3849171,485437114,7,9948,1765152,9926,1761657,22,3495,2361,18,5467,44,7,75,216660.0,130000.0,-40.0,-37.0,-46.0,-51.0,-42.0,-35.0,-44.0,-47.0,-86.0,-87.0,-83.0,-83.0,46.0,50.0,37.0,32.0,1
2841,62:47:05:9D:EB:15,3855942,497622002,6768,12184626,3849174,485437376,1,7105,3811673,7055,3804015,50,7658,3317,0,6845,56,1,126,229410.0,130000.0,-43.0,-45.0,-37.0,-44.0,-44.0,-45.0,-39.0,-46.0,-86.0,-87.0,-83.0,-83.0,43.0,42.0,46.0,39.0,1
2842,92:69:1D:31:68:E9,3853348,489141867,4172,3704289,3849176,485437578,1,5671,1225257,5495,1185229,176,40028,2313,12,4437,103,1,65,229410.0,137640.0,-51.0,-47.0,-43.0,-48.0,-51.0,-49.0,-45.0,-49.0,-86.0,-87.0,-83.0,-83.0,35.0,40.0,40.0,35.0,1
2843,CC:2F:71:3F:1F:24,5119418,1953337108,1270242,1467899530,3849176,485437578,2222,1069757,1226146064,1068895,1226041694,862,104370,1034962,15,1268377,122062,2219,820,144444.0,43333.0,-71.0,-70.0,-68.0,-71.0,-71.0,-69.0,-67.0,-71.0,-86.0,-87.0,-83.0,-83.0,15.0,17.0,15.0,12.0,1
2844,CC:2F:71:3E:C5:1F,3850187,485561062,1009,123282,3849178,485437780,3,4426,368706,3690,281328,736,87378,1068,14,1453,30,3,54,144444.0,39000.0,-65.0,-66.0,-63.0,-60.0,-70.0,-69.0,-67.0,-60.0,-86.0,-87.0,-83.0,-83.0,21.0,21.0,20.0,23.0,1
2845,BA:8C:B9:54:50:24,3854128,491633876,4950,6196096,3849178,485437780,7,9948,1765152,9926,1761657,22,3495,2361,18,5467,44,7,75,216660.0,130000.0,-40.0,-37.0,-46.0,-51.0,-42.0,-35.0,-44.0,-47.0,-86.0,-87.0,-83.0,-83.0,46.0,50.0,37.0,32.0,1
2846,62:47:05:9D:EB:15,3855948,497622608,6768,12184626,3849180,485437982,1,7105,3811673,7055,3804015,50,7658,3317,0,6845,56,1,126,229410.0,130000.0,-43.0,-45.0,-37.0,-44.0,-44.0,-45.0,-39.0,-46.0,-86.0,-88.0,-83.0,-83.0,43.0,43.0,46.0,39.0,1
2847,92:69:1D:31:68:E9,3853352,489142271,4172,3704289,3849180,485437982,1,5671,1225257,5495,1185229,176,40028,2313,12,4437,103,1,65,229410.0,137640.0,-51.0,-47.0,-43.0,-48.0,-51.0,-49.0,-45.0,-49.0,-86.0,-88.0,-83.0,-83.0,35.0,41.0,40.0,35.0,1
2848,CC:2F:71:3F:1F:24,5119613,1953581782,1270433,1468143800,3849180,485437982,2222,1069935,1226385278,1069073,1226280908,862,104370,1035133,15,1268568,122062,2219,821,144444.0,43333.0,-71.0,-70.0,-68.0,-71.0,-71.0,-69.0,-67.0,-71.0,-86.0,-88.0,-83.0,-83.0,15.0,18.0,15.0,12.0,1
2849,CC:2F:71:3E:C5:1F,3850189,485561264,1009,123282,3849180,485437982,3,4426,368706,3690,281328,736,87378,1068,14,1453,30,3,54,144444.0,39000.0,-65.0,-66.0,-63.0,-60.0,-70.0,-69.0,-67.0,-60.0,-86.0,-88.0,-83.0,-83.0,21.0,22.0,20.0,23.0,1
2850,BA:8C:B9:54:50:24,3854130,491634078,4950,6196096,3849180,485437982,7,9948,1765152,9926,1761657,22,3495,2361,18,5467,44,7,75,216660.0,130000.0,-40.0,-37.0,-46.0,-51.0,-42.0,-35.0,-44.0,-47.0,-86.0,-88.0,-83.0,-83.0,46.0,51.0,37.0,32.0,1
2851,62:47:05:9D:EB:15,3855953,497623072,6768,12184626,3849185,485438446,1,7105,3811673,7055,3804015,50,7658,3317,0,6845,56,1,126,229410.0,130000.0,-43.0,-45.0,-37.0,-44.0,-44.0,-45.0,-39.0,-46.0,-86.0,-88.0,-83.0,-83.0,43.0,43.0,46.0,39.0,1
2852,92:69:1D:31:68:E9,3853358,489142869,4172,3704289,3849186,485438580,1,5671,1225257,5495,1185229,176,40028,2313,12,4437,103,1,65,229410.0,137640.0,-51.0,-47.0,-43.0,-48.0,-51.0,-49.0,-45.0,-49.0,-86.0,-88.0,-83.0,-83.0,35.0,41.0,40.0,35.0,1
2853,CC:2F:71:3F:1F:24,5119820,1953830435,1270633,1468391787,3849187,485438648,2222,1070119,1226622437,1069257,1226518067,862,104370,1035312,15,1268768,122066,2219,821,144444.0,43333.0,-71.0,-70.0,-68.0,-71.0,-71.0,-69.0,-68.0,-71.0,-86.0,-88.0,-83.0,-83.0,15.0,18.0,15.0,12.0,1
2854,CC:2F:71:3E:C5:1F,3850196,485561930,1009,123282,3849187,485438648,3,4426,368706,3690,281328,736,87378,1068,14,1453,30,3,54,144444.0,39000.0,-65.0,-66.0,-63.0,-60.0,-70.0,-69.0,-67.0,-60.0,-86.0,-88.0,-83.0,-83.0,21.0,22.0,20.0,23.0,1
2855,BA:8C:B9:54:50:24,3854137,491634744,4950,6196096,3849187,485438648,7,9948,1765152,9926,1761657,22,3495,2361,18,5467,44,7,75,216660.0,130000.0,-40.0,-37.0,-46.0,-51.0,-42.0,-35.0,-44.0,-47.0,-86.0,-88.0,-83.0,-83.0,46.0,51.0,37.0,32.0,1
2856,62:47:05:9D:EB:15,3855957,497623476,6768,12184626,3849189,485438850,1,7105,3811673,7055,3804015,50,7658,3317,0,6845,56,1,126,229410.0,130000.0,-43.0,-45.0,-37.0,-44.0,-44.0,-45.0,-39.0,-46.0,-87.0,-88.0,-84.0,-84.0,44.0,43.0,47.0,40.0,1
2857,92:69:1D:31:68:E9,3853361,489143139,4172,3704289,3849189,485438850,1,5671,1225257,5495,1185229,176,40028,2313,12,4437,103,1,65,229410.0,137640.0,-51.0,-47.0,-43.0,-48.0,-51.0,-49.0,-45.0,-49.0,-87.0,-88.0,-84.0,-84.0,36.0,41.0,41.0,36.0,1
2858,CC:2F:71:3F:1F:24,5120013,1954074907,1270824,1468636057,3849189,485438850,2222,1070299,1226863123,1069437,1226758753,862,104370,1035483,15,1268959,122066,2219,821,144444.0,43333.0,-71.0,-70.0,-67.0,-71.0,-71.0,-70.0,-67.0,-71.0,-87.0,-88.0,-84.0,-84.0,16.0,18.0,17.0,13.0,1
2859,CC:2F:71:3E:C5:1F,3850198,485562132,1009,123282,3849189,485438850,3,4426,368706,3690,281328,736,87378,1068,14,1453,30,3,54,144444.0,39000.0,-65.0,-66.0,-63.0,-60.0,-70.0,-69.0,-67.0,-60.0,-87.0,-88.0,-84.0,-84.0,22.0,22.0,21.0,24.0,1
2860,BA:8C:B9:54:50:24,3854139,491634946,4950,6196096,3849189,485438850,7,9948,1765152,9926,1761657,22,3495,2361,18,5467,44,7,75,216660.0,130000.0,-40.0,-37.0,-46.0,-51.0,-42.0,-35.0,-44.0,-47.0,-87.0,-88.0,-84.0,-84.0,47.0,51.0,38.0,33.0,1
2861,62:47:05:9D:EB:15,3855963,497624082,6768,12184626,3849195,485439456,1,7105,3811673,7055,3804015,50,7658,3317,0,6845,56,1,126,229410.0,130000.0,-43.0,-45.0,-37.0,-44.0,-44.0,-45.0,-39.0,-46.0,-87.0,-88.0,-84.0,-84.0,44.0,43.0,47.0,40.0,1
2862,92:69:1D:31:68:E9,3853368,489143861,4173,3704405,3849195,485439456,1,5674,1225503,5498,1185475,176,40028,2314,12,4438,103,1,65,229410.0,137640.0,-51.0,-47.0,-43.0,-48.0,-51.0,-49.0,-44.0,-49.0,-87.0,-88.0,-84.0,-84.0,36.0,41.0,41.0,36.0,1
2863,CC:2F:71:3F:1F:24,5120211,1954319913,1271016,1468880457,3849195,485439456,2222,1070470,1227094001,1069608,1226989631,862,104370,1035653,15,1269151,122066,2219,822,144444.0,43333.0,-72.0,-70.0,-67.0,-72.0,-71.0,-69.0,-67.0,-71.0,-87.0,-88.0,-84.0,-84.0,15.0,18.0,17.0,12.0,1
2864,CC:2F:71:3E:C5:1F,3850204,485562738,1009,123282,3849195,485439456,3,4426,368706,3690,281328,736,87378,1068,14,1453,30,3,54,144444.0,39000.0,-65.0,-66.0,-63.0,-60.0,-70.0,-69.0,-67.0,-60.0,-87.0,-88.0,-84.0,-84.0,22.0,22.0,21.0,24.0,1
2865,BA:8C:B9:54:50:24,3854145,491635552,4950,6196096,3849195,485439456,7,9948,1765152,9926,1761657,22,3495,2361,18,5467,44,7,75,216660.0,130000.0,-40.0,-37.0,-46.0,-51.0,-42.0,-35.0,-44.0,-47.0,-87.0,-88.0,-84.0,-84.0,47.0,51.0,38.0,33.0,1
2866,62:47:05:9D:EB:15,3855966,497624344,6768,12184626,3849198,485439718,1,7105,3811673,7055,3804015,50,7658,3317,0,6845,56,1,126,229410.0,130000.0,-43.0,-45.0,-37.0,-44.0,-44.0,-45.0,-39.0,-46.0,-87.0,-88.0,-84.0,-84.0,44.0,43.0,47.0,40.0,1
2867,92:69:1D:31:68:E9,3853371,489144123,4173,3704405,3849198,485439718,1,5674,1225503,5498,1185475,176,40028,2314,12,4438,103,1,65,229410.0,137640.0,-51.0,-47.0,-43.0,-48.0,-51.0,-49.0,-44.0,-49.0,-87.0,-88.0,-84.0,-84.0,36.0,41.0,41.0,36.0,1
2868,CC:2F:71:3F:1F:24,5120412,1954567916,1271214,1469128198,3849198,485439718,2222,1070651,1227330816,1069789,1227226446,862,104370,1035828,15,1269349,122068,2219,822,144444.0,43333.0,-71.0,-68.0,-66.0,-72.0,-71.0,-68.0,-65.0,-71.0,-87.0,-88.0,-84.0,-84.0,16.0,20.0,18.0,12.0,1
2869,CC:2F:71:3E:C5:1F,3850207,485563000,1009,123282,3849198,485439718,3,4426,368706,3690,281328,736,87378,1068,14,1453,30,3,54,144444.0,39000.0,-65.0,-66.0,-63.0,-60.0,-70.0,-69.0,-67.0,-60.0,-87.0,-88.0,-84.0,-84.0,22.0,22.0,21.0,24.0,1
2870,BA:8C:B9:54:50:24,3854148,491635814,4950,6196096,3849198,485439718,7,9948,1765152,9926,1761657,22,3495,2361,18,5467,44,7,75,216660.0,130000.0,-40.0,-37.0,-46.0,-51.0,-42.0,-35.0,-44.0,-47.0,-87.0,-88.0,-84.0,-84.0,47.0,51.0,38.0,33.0,1
2871,62:47:05:9D:EB:15,3855972,497624950,6768,12184626,3849204,485440324,1,7105,3811673,7055,3804015,50,7658,3317,0,6845,56,1,126,229410.0,130000.0,-43.0,-45.0,-37.0,-44.0,-44.0,-45.0,-39.0,-46.0,-87.0,-88.0,-84.0,-84.0,44.0,43.0,47.0,40.0,1
2872,92:69:1D:31:68:E9,3853377,489144729,4173,3704405,3849204,485440324,1,5674,1225503,5498,1185475,176,40028,2314,12,4438,103,1,65,229410.0,137640.0,-51.0,-47.0,-43.0,-48.0,-51.0,-49.0,-44.0,-49.0,-87.0,-88.0,-84.0,-84.0,36.0,41.0,41.0,36.0,1
2873,CC:2F:71:3F:1F:24,5120607,1954809628,1271403,1469369304,3849204,485440324,2222,1070826,1227566450,1069964,1227462080,862,104370,1035998,15,1269538,122129,2219,822,130000.0,43333.0,-70.0,-69.0,-67.0,-76.0,-70.0,-69.0,-67.0,-75.0,-87.0,-88.0,-84.0,-84.0,17.0,19.0,17.0,8.0,1
2874,CC:2F:71:3E:C5:1F,3850213,485563606,1009,123282,3849204,485440324,3,4426,368706,3690,281328,736,87378,1068,14,1453,30,3,54,144444.0,39000.0,-65.0,-66.0,-63.0,-60.0,-70.0,-69.0,-67.0,-60.0,-87.0,-88.0,-84.0,-84.0,22.0,22.0,21.0,24.0,1
2875,BA:8C:B9:54:50:24,3854154,491636420,4950,6196096,3849204,485440324,7,9948,1765152,9926,1761657,22,3495,2361,18,5467,44,7,75,216660.0,130000.0,-40.0,-37.0,-46.0,-51.0,-42.0,-35.0,-44.0,-47.0,-87.0,-88.0,-84.0,-84.0,47.0,51.0,38.0,33.0,1
2876,62:47:05:9D:EB:15,3855975,497625212,6768,12184626,3849207,485440586,1,7105,3811673,7055,3804015,50,7658,3317,0,6845,56,1,126,229410.0,130000.0,-43.0,-45.0,-37.0,-44.0,-44.0,-45.0,-39.0,-46.0,-87.0,-89.0,-84.0,-84.0,44.0,44.0,47.0,40.0,1
2877,92:69:1D:31:68:E9,3853380,489144991,4173,3704405,3849207,485440586,1,5674,1225503,5498,1185475,176,40028,2314,12,4438,103,1,65,229410.0,137640.0,-51.0,-47.0,-43.0,-48.0,-51.0,-49.0,-44.0,-49.0,-87.0,-89.0,-84.0,-84.0,36.0,42.0,41.0,36.0,1
2878,CC:2F:71:3F:1F:24,5120806,1955060634,1271599,1469620048,3849207,485440586,2222,1071011,1227816222,1070149,1227711852,862,104370,1036173,15,1269734,122129,2219,822,130000.0,43333.0,-73.0,-70.0,-68.0,-75.0,-72.0,-70.0,-68.0,-75.0,-87.0,-89.0,-84.0,-84.0,14.0,19.0,16.0,9.0,1
2879,CC:2F:71:3E:C5:1F,3850216,485563868,1009,123282,3849207,485440586,3,4426,368706,3690,281328,736,87378,1068,14,1453,30,3,54,144444.0,39000.0,-65.0,-66.0,-63.0,-60.0,-70.0,-69.0,-67.0,-60.0,-87.0,-89.0,-84.0,-84.0,22.0,23.0,21.0,24.0,1
2880,BA:8C:B9:54:50:24,3854157,491636682,4950,6196096,3849207,485440586,7,9948,1765152,9926,1761657,22,3495,2361,18,5467,44,7,75,216660.0,130000.0,-40.0,-37.0,-46.0,-51.0,-42.0,-35.0,-44.0,-47.0,-87.0,-89.0,-84.0,-84.0,47.0,52.0,38.0,33.0,1
2881,62:47:05:9D:EB:15,3855981,497625818,6768,12184626,3849213,485441192,1,7105,3811673,7055,3804015,50,7658,3317,0,6845,56,1,126,229410.0,130000.0,-43.0,-45.0,-37.0,-44.0,-44.0,-45.0,-39.0,-46.0,-87.0,-89.0,-85.0,-85.0,44.0,44.0,48.0,41.0,1
2882,92:69:1D:31:68:E9,3853387,489145713,4174,3704521,3849213,485441192,1,5676,1225639,5500,1185611,176,40028,2314,12,4439,103,1,65,229410.0,137640.0,-51.0,-48.0,-42.0,-50.0,-51.0,-48.0,-44.0,-48.0,-87.0,-89.0,-85.0,-85.0,36.0,41.0,43.0,35.0,1
2883,CC:2F:71:3F:1F:24,5121004,1955305402,1271791,1469864210,3849213,485441192,2222,1071187,1228053348,1070325,1227948978,862,104370,1036344,15,1269926,122132,2219,822,130000.0,39000.0,-73.0,-71.0,-67.0,-73.0,-73.0,-70.0,-67.0,-73.0,-87.0,-89.0,-85.0,-85.0,14.0,18.0,18.0,12.0,1
2884,CC:2F:71:3E:C5:1F,3850225,485564792,1010,123398,3849215,485441394,3,4428,368846,3692,281468,736,87378,1068,14,1454,30,3,54,144444.0,39000.0,-72.0,-71.0,-70.0,-61.0,-70.0,-69.0,-67.0,-60.0,-87.0,-89.0,-85.0,-85.0,15.0,18.0,15.0,24.0,1
2885,BA:8C:B9:54:50:24,3854166,491637606,4951,6196212,3849215,485441394,7,9950,1765288,9928,1761793,22,3495,2361,18,5468,44,7,75,216660.0,130000.0,-48.0,-35.0,-43.0,-45.0,-44.0,-35.0,-44.0,-46.0,-87.0,-89.0,-85.0,-85.0,39.0,54.0,42.0,40.0,1
2886,62:47:05:9D:EB:15,3855984,497626136,6769,12184742,3849215,485441394,1,7107,3811809,7057,3804151,50,7658,3317,0,6846,56,1,126,229410.0,130000.0,-45.0,-49.0,-47.0,-46.0,-44.0,-45.0,-39.0,-46.0,-87.0,-89.0,-85.0,-85.0,42.0,40.0,38.0,39.0,1
2887,92:69:1D:31:68:E9,3853389,489145915,4174,3704521,3849215,485441394,1,5676,1225639,5500,1185611,176,40028,2314,12,4439,103,1,65,229410.0,137640.0,-51.0,-48.0,-42.0,-50.0,-51.0,-48.0,-44.0,-48.0,-87.0,-89.0,-85.0,-85.0,36.0,41.0,43.0,35.0,1
2888,CC:2F:71:3F:1F:24,5121210,1955554360,1271995,1470112966,3849215,485441394,2222,1071381,1228296366,1070519,1228191996,862,104370,1036528,15,1270130,122141,2219,822,130000.0,43333.0,-70.0,-69.0,-68.0,-70.0,-70.0,-69.0,-68.0,-70.0,-87.0,-89.0,-85.0,-85.0,17.0,20.0,17.0,15.0,1
2889,CC:2F:71:3E:C5:1F,3850226,485564854,1010,123398,3849216,485441456,3,4429,368964,3692,281468,737,87496,1069,14,1454,30,3,54,144444.0,39000.0,-74.0,-71.0,-69.0,-60.0,-71.0,-70.0,-68.0,-60.0,-87.0,-89.0,-85.0,-85.0,13.0,18.0,16.0,25.0,1
2890,BA:8C:B9:54:50:24,3854167,491637668,4951,6196212,3849216,485441456,7,9950,1765288,9928,1761793,22,3495,2361,18,5468,44,7,75,216660.0,130000.0,-48.0,-35.0,-43.0,-45.0,-44.0,-35.0,-44.0,-46.0,-87.0,-89.0,-85.0,-85.0,39.0,54.0,42.0,40.0,1
2891,62:47:05:9D:EB:15,3855992,497626864,6769,12184742,3849223,485442122,1,7107,3811809,7057,3804151,50,7658,3317,0,6846,56,1,126,229410.0,130000.0,-45.0,-49.0,-47.0,-46.0,-44.0,-45.0,-39.0,-46.0,-87.0,-89.0,-85.0,-85.0,42.0,40.0,38.0,39.0,1
2892,92:69:1D:31:68:E9,3853397,489146643,4174,3704521,3849223,485442122,1,5676,1225639,5500,1185611,176,40028,2314,12,4439,103,1,65,229410.0,137640.0,-51.0,-48.0,-42.0,-50.0,-51.0,-48.0,-44.0,-48.0,-87.0,-89.0,-85.0,-85.0,36.0,41.0,43.0,35.0,1
2893,CC:2F:71:3F:1F:24,5121412,1955799434,1272187,1470357110,3849225,485442324,2222,1071554,1228528968,1070692,1228424598,862,104370,1036698,15,1270322,122149,2219,822,130000.0,43333.0,-71.0,-70.0,-68.0,-72.0,-70.0,-69.0,-68.0,-71.0,-87.0,-89.0,-85.0,-85.0,16.0,19.0,17.0,13.0,1
2894,CC:2F:71:3E:C5:1F,3850235,485565722,1010,123398,3849225,485442324,3,4430,369034,3693,281538,737,87496,1069,14,1454,30,3,54,144444.0,39000.0,-74.0,-71.0,-69.0,-60.0,-71.0,-70.0,-68.0,-60.0,-87.0,-89.0,-85.0,-85.0,13.0,18.0,16.0,25.0,1
2895,BA:8C:B9:54:50:24,3854176,491638536,4951,6196212,3849225,485442324,7,9950,1765288,9928,1761793,22,3495,2361,18,5468,44,7,75,216660.0,130000.0,-48.0,-35.0,-43.0,-45.0,-44.0,-35.0,-44.0,-46.0,-87.0,-89.0,-85.0,-85.0,39.0,54.0,42.0,40.0,1
2896,62:47:05:9D:EB:15,3855995,497627339,6769,12184742,3849226,485442597,1,7107,3811809,7057,3804151,50,7658,3317,0,6846,56,1,126,229410.0,130000.0,-45.0,-49.0,-47.0,-46.0,-44.0,-45.0,-39.0,-46.0,-88.0,-89.0,-85.0,-85.0,43.0,40.0,38.0,39.0,1
2897,92:69:1D:31:68:E9,3853400,489147118,4174,3704521,3849226,485442597,1,5676,1225639,5500,1185611,176,40028,2314,12,4439,103,1,65,229410.0,137640.0,-51.0,-48.0,-42.0,-50.0,-51.0,-48.0,-44.0,-48.0,-88.0,-89.0,-85.0,-85.0,37.0,41.0,43.0,35.0,1
2898,CC:2F:71:3F:1F:24,5121603,1956040983,1272377,1470598386,3849226,485442597,2222,1071723,1228756710,1070861,1228652340,862,104370,1036866,15,1270512,122151,2219,822,130000.0,43333.0,-70.0,-70.0,-67.0,-72.0,-70.0,-70.0,-66.0,-72.0,-88.0,-89.0,-85.0,-85.0,18.0,19.0,18.0,13.0,1
2899,CC:2F:71:3E:C5:1F,3850238,485566197,1010,123398,3849228,485442799,3,4430,369034,3693,281538,737,87496,1069,14,1454,30,3,54,144444.0,39000.0,-74.0,-71.0,-69.0,-60.0,-71.0,-70.0,-68.0,-60.0,-88.0,-89.0,-85.0,-85.0,14.0,18.0,16.0,25.0,1
2900,BA:8C:B9:54:50:24,3854179,491639011,4951,6196212,3849228,485442799,7,9950,1765288,9928,1761793,22,3495,2361,18,5468,44,7,75,216660.0,130000.0,-48.0,-35.0,-43.0,-45.0,-44.0,-35.0,-44.0,-46.0,-88.0,-89.0,-85.0,-85.0,40.0,54.0,42.0,40.0,1
2901,62:47:05:9D:EB:15,3856004,497628207,6769,12184742,3849235,485443465,1,7107,3811809,7057,3804151,50,7658,3317,0,6846,56,1,126,229410.0,130000.0,-45.0,-49.0,-47.0,-46.0,-44.0,-45.0,-39.0,-46.0,-88.0,-90.0,-85.0,-86.0,43.0,41.0,38.0,40.0,1
2902,92:69:1D:31:68:E9,3853409,489147986,4174,3704521,3849235,485443465,1,5676,1225639,5500,1185611,176,40028,2314,12,4439,103,1,65,229410.0,137640.0,-51.0,-48.0,-42.0,-50.0,-51.0,-48.0,-44.0,-48.0,-88.0,-90.0,-85.0,-86.0,37.0,42.0,43.0,36.0,1
2903,CC:2F:71:3F:1F:24,5121800,1956282643,1272565,1470839178,3849235,485443465,2222,1071894,1228986094,1071032,1228881724,862,104370,1037035,15,1270700,122159,2219,822,130000.0,43333.0,-70.0,-70.0,-67.0,-74.0,-70.0,-70.0,-67.0,-74.0,-88.0,-90.0,-85.0,-86.0,18.0,20.0,18.0,12.0,1
2904,CC:2F:71:3E:C5:1F,3850245,485566863,1010,123398,3849235,485443465,3,4430,369034,3693,281538,737,87496,1069,14,1454,30,3,54,144444.0,39000.0,-74.0,-71.0,-69.0,-60.0,-71.0,-70.0,-68.0,-60.0,-88.0,-90.0,-85.0,-86.0,14.0,19.0,16.0,26.0,1
2905,BA:8C:B9:54:50:24,3854186,491639677,4951,6196212,3849235,485443465,7,9950,1765288,9928,1761793,22,3495,2361,18,5468,44,7,75,216660.0,130000.0,-48.0,-35.0,-43.0,-45.0,-44.0,-35.0,-44.0,-46.0,-88.0,-90.0,-85.0,-86.0,40.0,55.0,42.0,41.0,1
2906,62:47:05:9D:EB:15,3856004,497628207,6769,12184742,3849235,485443465,1,7107,3811809,7057,3804151,50,7658,3317,0,6846,56,1,126,229410.0,130000.0,-45.0,-49.0,-47.0,-46.0,-44.0,-45.0,-39.0,-46.0,-88.0,-90.0,-86.0,-86.0,43.0,41.0,39.0,40.0,1
2907,92:69:1D:31:68:E9,3853409,489147986,4174,3704521,3849235,485443465,1,5676,1225639,5500,1185611,176,40028,2314,12,4439,103,1,65,229410.0,137640.0,-51.0,-48.0,-42.0,-50.0,-51.0,-48.0,-44.0,-48.0,-88.0,-90.0,-86.0,-86.0,37.0,42.0,44.0,36.0,1
2908,CC:2F:71:3F:1F:24,5121999,1956527592,1272762,1471083925,3849237,485443667,2222,1072078,1229223371,1071216,1229119001,862,104370,1037212,15,1270897,122160,2219,822,130000.0,43333.0,-70.0,-69.0,-69.0,-75.0,-70.0,-69.0,-69.0,-74.0,-88.0,-90.0,-86.0,-86.0,18.0,21.0,17.0,11.0,1
2909,CC:2F:71:3E:C5:1F,3850247,485567065,1010,123398,3849237,485443667,3,4430,369034,3693,281538,737,87496,1069,14,1454,30,3,54,144444.0,39000.0,-74.0,-71.0,-69.0,-60.0,-71.0,-70.0,-68.0,-60.0,-88.0,-90.0,-86.0,-86.0,14.0,19.0,17.0,26.0,1
2910,BA:8C:B9:54:50:24,3854188,491639879,4951,6196212,3849237,485443667,7,9950,1765288,9928,1761793,22,3495,2361,18,5468,44,7,75,216660.0,130000.0,-48.0,-35.0,-43.0,-45.0,-44.0,-35.0,-44.0,-46.0,-88.0,-90.0,-86.0,-86.0,40.0,55.0,43.0,41.0,1
2911,62:47:05:9D:EB:15,3856012,497629015,6769,12184742,3849243,485444273,1,7107,3811809,7057,3804151,50,7658,3317,0,6846,56,1,126,229410.0,130000.0,-45.0,-49.0,-47.0,-46.0,-44.0,-45.0,-39.0,-46.0,-88.0,-90.0,-86.0,-86.0,43.0,41.0,39.0,40.0,1
2912,92:69:1D:31:68:E9,3853417,489148794,4174,3704521,3849243,485444273,1,5676,1225639,5500,1185611,176,40028,2314,12,4439,103,1,65,229410.0,137640.0,-51.0,-48.0,-42.0,-50.0,-51.0,-48.0,-44.0,-48.0,-88.0,-90.0,-86.0,-86.0,37.0,42.0,44.0,36.0,1
2913,CC:2F:71:3F:1F:24,5122196,1956769548,1272953,1471325275,3849243,485444273,2222,1072251,1229455863,1071389,1229351493,862,104370,1037381,15,1271088,122169,2219,822,130000.0,39000.0,-70.0,-69.0,-69.0,-74.0,-69.0,-69.0,-69.0,-74.0,-88.0,-90.0,-86.0,-86.0,18.0,21.0,17.0,12.0,1
2914,CC:2F:71:3E:C5:1F,3850253,485567671,1010,123398,3849243,485444273,3,4430,369034,3693,281538,737,87496,1069,14,1454,30,3,54,144444.0,39000.0,-74.0,-71.0,-69.0,-60.0,-71.0,-70.0,-68.0,-60.0,-88.0,-90.0,-86.0,-86.0,14.0,19.0,17.0,26.0,1
2915,BA:8C:B9:54:50:24,3854194,491640485,4951,6196212,3849243,485444273,7,9950,1765288,9928,1761793,22,3495,2361,18,5468,44,7,75,216660.0,130000.0,-48.0,-35.0,-43.0,-45.0,-44.0,-35.0,-44.0,-46.0,-88.0,-90.0,-86.0,-86.0,40.0,55.0,43.0,41.0,1
2916,62:47:05:9D:EB:15,3856015,497629277,6769,12184742,3849246,485444535,1,7107,3811809,7057,3804151,50,7658,3317,0,6846,56,1,126,229410.0,130000.0,-45.0,-49.0,-47.0,-46.0,-44.0,-45.0,-39.0,-46.0,-88.0,-90.0,-86.0,-86.0,43.0,41.0,39.0,40.0,1
2917,92:69:1D:31:68:E9,3853420,489149056,4174,3704521,3849246,485444535,1,5676,1225639,5500,1185611,176,40028,2314,12,4439,103,1,65,229410.0,137640.0,-51.0,-48.0,-42.0,-50.0,-51.0,-48.0,-44.0,-48.0,-88.0,-90.0,-86.0,-86.0,37.0,42.0,44.0,36.0,1
2918,CC:2F:71:3F:1F:24,5122392,1957016780,1273146,1471572245,3849246,485444535,2222,1072426,1229692999,1071564,1229588629,862,104370,1037552,15,1271281,122197,2219,824,130000.0,43333.0,-71.0,-71.0,-68.0,-76.0,-71.0,-71.0,-68.0,-76.0,-88.0,-90.0,-86.0,-86.0,17.0,19.0,18.0,10.0,1
2919,CC:2F:71:3E:C5:1F,3850257,485568067,1010,123398,3849247,485444669,3,4430,369034,3693,281538,737,87496,1069,14,1454,30,3,54,144444.0,39000.0,-74.0,-71.0,-69.0,-60.0,-71.0,-70.0,-68.0,-60.0,-88.0,-90.0,-86.0,-86.0,14.0,19.0,17.0,26.0,1
2920,BA:8C:B9:54:50:24,3854198,491640881,4951,6196212,3849247,485444669,7,9950,1765288,9928,1761793,22,3495,2361,18,5468,44,7,75,216660.0,130000.0,-48.0,-35.0,-43.0,-45.0,-44.0,-35.0,-44.0,-46.0,-88.0,-90.0,-86.0,-86.0,40.0,55.0,43.0,41.0,1
2921,62:47:05:9D:EB:15,3856054,497640220,6802,12195079,3849252,485445141,1,7151,3824035,7101,3816377,50,7658,3351,0,6879,56,1,126,229410.0,137640.0,-47.0,-49.0,-41.0,-48.0,-47.0,-49.0,-40.0,-48.0,-88.0,-90.0,-86.0,-86.0,41.0,41.0,45.0,38.0,1
2922,92:69:1D:31:68:E9,3853426,489149662,4174,3704521,3849252,485445141,1,5676,1225639,5500,1185611,176,40028,2314,12,4439,103,1,65,229410.0,137640.0,-51.0,-48.0,-42.0,-50.0,-51.0,-48.0,-44.0,-48.0,-88.0,-90.0,-86.0,-86.0,37.0,42.0,44.0,36.0,1
2923,CC:2F:71:3F:1F:24,5122588,1957258678,1273336,1471813537,3849252,485445141,2222,1072599,1229924067,1071737,1229819697,862,104370,1037721,15,1271469,122198,2219,824,130000.0,43333.0,-71.0,-69.0,-67.0,-73.0,-71.0,-69.0,-67.0,-73.0,-88.0,-90.0,-86.0,-86.0,17.0,21.0,19.0,13.0,1
2924,CC:2F:71:3E:C5:1F,3850262,485568539,1010,123398,3849252,485445141,3,4430,369034,3693,281538,737,87496,1069,14,1454,30,3,54,144444.0,39000.0,-74.0,-71.0,-69.0,-60.0,-71.0,-70.0,-68.0,-60.0,-88.0,-90.0,-86.0,-86.0,14.0,19.0,17.0,26.0,1
2925,BA:8C:B9:54:50:24,3854203,491641353,4951,6196212,3849252,485445141,7,9950,1765288,9928,1761793,22,3495,2361,18,5468,44,7,75,216660.0,130000.0,-48.0,-35.0,-43.0,-45.0,-44.0,-35.0,-44.0,-46.0,-88.0,-90.0,-86.0,-86.0,40.0,55.0,43.0,41.0,1
2926,62:47:05:9D:EB:15,3856121,497664753,6866,12219350,3849255,485445403,1,7231,3854995,7181,3847337,50,7658,3419,0,6943,56,1,126,229410.0,137640.0,-48.0,-49.0,-41.0,-47.0,-48.0,-48.0,-42.0,-47.0,-88.0,-90.0,-86.0,-87.0,40.0,41.0,45.0,40.0,1
2927,92:69:1D:31:68:E9,3853429,489149924,4174,3704521,3849255,485445403,1,5677,1225707,5501,1185679,176,40028,2314,12,4439,103,1,65,229410.0,137640.0,-51.0,-47.0,-44.0,-47.0,-51.0,-48.0,-43.0,-48.0,-88.0,-90.0,-86.0,-87.0,37.0,43.0,42.0,40.0,1
2928,CC:2F:71:3F:1F:24,5122788,1957503535,1273533,1472058132,3849255,485445403,2222,1072783,1230164078,1071921,1230059708,862,104370,1037897,15,1271666,122198,2219,824,144444.0,43333.0,-70.0,-69.0,-68.0,-73.0,-69.0,-69.0,-67.0,-73.0,-88.0,-90.0,-86.0,-87.0,18.0,21.0,18.0,14.0,1
2929,CC:2F:71:3E:C5:1F,3850267,485569003,1010,123398,3849257,485445605,3,4430,369034,3693,281538,737,87496,1069,14,1454,30,3,54,144444.0,39000.0,-74.0,-71.0,-69.0,-60.0,-71.0,-70.0,-68.0,-60.0,-88.0,-90.0,-86.0,-87.0,14.0,19.0,17.0,27.0,1
2930,BA:8C:B9:54:50:24,3854208,491641817,4951,6196212,3849257,485445605,7,9950,1765288,9928,1761793,22,3495,2361,18,5468,44,7,75,216660.0,130000.0,-48.0,-35.0,-43.0,-45.0,-44.0,-35.0,-44.0,-46.0,-88.0,-90.0,-86.0,-87.0,40.0,55.0,43.0,42.0,1
2931,62:47:05:9D:EB:15,3856146,497679391,6884,12233320,3849262,485446071,1,7253,3859630,7203,3851972,50,7658,3437,0,6961,56,1,126,229410.0,137640.0,-44.0,-45.0,-36.0,-46.0,-47.0,-48.0,-40.0,-47.0,-88.0,-90.0,-86.0,-87.0,44.0,45.0,50.0,41.0,1
2932,92:69:1D:31:68:E9,3853436,489150592,4174,3704521,3849262,485446071,1,5677,1225707,5501,1185679,176,40028,2314,12,4439,103,1,65,229410.0,137640.0,-51.0,-47.0,-44.0,-47.0,-51.0,-48.0,-43.0,-48.0,-88.0,-90.0,-86.0,-87.0,37.0,43.0,42.0,40.0,1
2933,CC:2F:71:3F:1F:24,5122987,1957745739,1273725,1472299668,3849262,485446071,2222,1072957,1230393922,1072094,1230289434,863,104488,1038068,15,1271858,122210,2219,824,144444.0,43333.0,-71.0,-70.0,-69.0,-73.0,-70.0,-70.0,-68.0,-74.0,-88.0,-90.0,-86.0,-87.0,17.0,20.0,17.0,14.0,1
2934,CC:2F:71:3E:C5:1F,3850272,485569469,1010,123398,3849262,485446071,3,4430,369034,3693,281538,737,87496,1069,14,1454,30,3,54,144444.0,39000.0,-74.0,-71.0,-69.0,-60.0,-71.0,-70.0,-68.0,-60.0,-88.0,-90.0,-86.0,-87.0,14.0,19.0,17.0,27.0,1
2935,BA:8C:B9:54:50:24,3854213,491642283,4951,6196212,3849262,485446071,7,9950,1765288,9928,1761793,22,3495,2361,18,5468,44,7,75,216660.0,130000.0,-48.0,-35.0,-43.0,-45.0,-44.0,-35.0,-44.0,-46.0,-88.0,-90.0,-86.0,-87.0,40.0,55.0,43.0,42.0,1
2936,62:47:05:9D:EB:15,3856148,497679593,6884,12233320,3849264,485446273,1,7253,3859630,7203,3851972,50,7658,3437,0,6961,56,1,126,229410.0,137640.0,-44.0,-45.0,-36.0,-46.0,-47.0,-48.0,-40.0,-47.0,-88.0,-90.0,-86.0,-87.0,44.0,45.0,50.0,41.0,1
2937,92:69:1D:31:68:E9,3853438,489150794,4174,3704521,3849264,485446273,1,5677,1225707,5501,1185679,176,40028,2314,12,4439,103,1,65,229410.0,137640.0,-51.0,-47.0,-44.0,-47.0,-51.0,-48.0,-43.0,-48.0,-88.0,-90.0,-86.0,-87.0,37.0,43.0,42.0,40.0,1
2938,CC:2F:71:3F:1F:24,5123182,1957987381,1273916,1472540906,3849266,485446475,2222,1073139,1230636120,1072276,1230531632,863,104488,1038241,15,1272051,122244,2219,824,117000.0,39000.0,-70.0,-70.0,-68.0,-76.0,-70.0,-70.0,-67.0,-75.0,-88.0,-90.0,-86.0,-87.0,18.0,20.0,18.0,11.0,1
2939,CC:2F:71:3E:C5:1F,3850276,485569873,1010,123398,3849266,485446475,3,4430,369034,3693,281538,737,87496,1069,14,1454,30,3,54,144444.0,39000.0,-74.0,-71.0,-69.0,-60.0,-71.0,-70.0,-68.0,-60.0,-88.0,-90.0,-86.0,-87.0,14.0,19.0,17.0,27.0,1
2940,BA:8C:B9:54:50:24,3854217,491642687,4951,6196212,3849266,485446475,7,9950,1765288,9928,1761793,22,3495,2361,18,5468,44,7,75,216660.0,130000.0,-48.0,-35.0,-43.0,-45.0,-44.0,-35.0,-44.0,-46.0,-88.0,-90.0,-86.0,-87.0,40.0,55.0,43.0,42.0,1
2941,62:47:05:9D:EB:15,3856162,497687791,6891,12240852,3849271,485446939,1,7260,3860450,7210,3852792,50,7658,3441,0,6968,56,1,126,229410.0,137640.0,-43.0,-45.0,-37.0,-46.0,-46.0,-48.0,-40.0,-47.0,-88.0,-90.0,-86.0,-87.0,45.0,45.0,49.0,41.0,1
2942,92:69:1D:31:68:E9,3853445,489151460,4174,3704521,3849271,485446939,1,5677,1225707,5501,1185679,176,40028,2314,12,4439,103,1,65,229410.0,137640.0,-51.0,-47.0,-44.0,-47.0,-51.0,-48.0,-43.0,-48.0,-88.0,-90.0,-86.0,-87.0,37.0,43.0,42.0,40.0,1
2943,CC:2F:71:3F:1F:24,5123383,1958235485,1274112,1472788546,3849271,485446939,2222,1073316,1230876224,1072453,1230771736,863,104488,1038412,15,1272247,122255,2219,824,130000.0,43333.0,-70.0,-70.0,-68.0,-77.0,-70.0,-70.0,-67.0,-75.0,-88.0,-90.0,-86.0,-87.0,18.0,20.0,18.0,10.0,1
2944,CC:2F:71:3E:C5:1F,3850281,485570337,1010,123398,3849271,485446939,3,4430,369034,3693,281538,737,87496,1069,14,1454,30,3,54,144444.0,39000.0,-74.0,-71.0,-69.0,-60.0,-71.0,-70.0,-68.0,-60.0,-88.0,-90.0,-86.0,-87.0,14.0,19.0,17.0,27.0,1
2945,BA:8C:B9:54:50:24,3854222,491643151,4951,6196212,3849271,485446939,7,9950,1765288,9928,1761793,22,3495,2361,18,5468,44,7,75,216660.0,130000.0,-48.0,-35.0,-43.0,-45.0,-44.0,-35.0,-44.0,-46.0,-88.0,-90.0,-86.0,-87.0,40.0,55.0,43.0,42.0,1
2946,62:47:05:9D:EB:15,3856189,497699218,6891,12240852,3849298,485458366,1,7260,3860450,7210,3852792,50,7658,3441,0,6968,56,1,126,229410.0,137640.0,-43.0,-45.0,-37.0,-46.0,-46.0,-48.0,-40.0,-47.0,-88.0,-90.0,-86.0,-87.0,45.0,45.0,49.0,41.0,1
2947,92:69:1D:31:68:E9,3853472,489162887,4174,3704521,3849298,485458366,1,5680,1226078,5503,1185815,177,40263,2315,12,4439,103,1,65,229410.0,137640.0,-51.0,-48.0,-44.0,-46.0,-51.0,-48.0,-44.0,-48.0,-88.0,-90.0,-86.0,-87.0,37.0,42.0,42.0,41.0,1
2948,CC:2F:71:3F:1F:24,5123614,1958500889,1274316,1473042523,3849298,485458366,2222,1073505,1231123969,1072642,1231019481,863,104488,1038594,15,1272451,122264,2219,824,130000.0,43333.0,-71.0,-70.0,-68.0,-76.0,-70.0,-70.0,-68.0,-75.0,-88.0,-90.0,-86.0,-87.0,17.0,20.0,18.0,11.0,1
2949,CC:2F:71:3E:C5:1F,3850308,485581764,1010,123398,3849298,485458366,3,4432,369174,3695,281678,737,87496,1069,14,1455,30,3,54,144444.0,39000.0,-73.0,-72.0,-69.0,-60.0,-71.0,-70.0,-68.0,-60.0,-88.0,-90.0,-86.0,-87.0,15.0,18.0,17.0,27.0,1
2950,BA:8C:B9:54:50:24,3854251,491654780,4951,6196212,3849300,485458568,7,9952,1765424,9930,1761929,22,3495,2361,18,5469,44,7,75,216660.0,130000.0,-39.0,-36.0,-46.0,-52.0,-44.0,-35.0,-44.0,-47.0,-88.0,-90.0,-86.0,-87.0,49.0,54.0,40.0,35.0,1
2951,62:47:05:9D:EB:15,3856195,497699798,6892,12240968,3849303,485458830,1,7263,3860696,7213,3853038,50,7658,3442,0,6969,56,1,126,229410.0,137640.0,-44.0,-46.0,-37.0,-46.0,-45.0,-47.0,-40.0,-47.0,-88.0,-90.0,-86.0,-87.0,44.0,44.0,49.0,41.0,1
2952,92:69:1D:31:68:E9,3853477,489163351,4174,3704521,3849303,485458830,1,5680,1226078,5503,1185815,177,40263,2315,12,4439,103,1,65,229410.0,137640.0,-51.0,-48.0,-44.0,-46.0,-51.0,-48.0,-44.0,-48.0,-88.0,-90.0,-86.0,-87.0,37.0,42.0,42.0,41.0,1
2953,CC:2F:71:3F:1F:24,5123809,1958742629,1274506,1473283799,3849303,485458830,2222,1073677,1231356541,1072814,1231252053,863,104488,1038762,15,1272641,122271,2219,825,130000.0,43333.0,-71.0,-70.0,-68.0,-77.0,-70.0,-70.0,-68.0,-75.0,-88.0,-90.0,-86.0,-87.0,17.0,20.0,18.0,10.0,1
2954,CC:2F:71:3E:C5:1F,3850313,485582228,1010,123398,3849303,485458830,3,4432,369174,3695,281678,737,87496,1069,14,1455,30,3,54,144444.0,39000.0,-73.0,-72.0,-69.0,-60.0,-71.0,-70.0,-68.0,-60.0,-88.0,-90.0,-86.0,-87.0,15.0,18.0,17.0,27.0,1
2955,BA:8C:B9:54:50:24,3854254,491655042,4951,6196212,3849303,485458830,7,9952,1765424,9930,1761929,22,3495,2361,18,5469,44,7,75,216660.0,130000.0,-39.0,-36.0,-46.0,-52.0,-44.0,-35.0,-44.0,-47.0,-88.0,-90.0,-86.0,-87.0,49.0,54.0,40.0,35.0,1
2956,62:47:05:9D:EB:15,3856199,497700202,6892,12240968,3849307,485459234,1,7263,3860696,7213,3853038,50,7658,3442,0,6969,56,1,126,229410.0,137640.0,-44.0,-46.0,-37.0,-46.0,-45.0,-47.0,-40.0,-47.0,-88.0,-90.0,-86.0,-87.0,44.0,44.0,49.0,41.0,1
2957,92:69:1D:31:68:E9,3853481,489163755,4174,3704521,3849307,485459234,1,5680,1226078,5503,1185815,177,40263,2315,12,4439,103,1,65,229410.0,137640.0,-51.0,-48.0,-44.0,-46.0,-51.0,-48.0,-44.0,-48.0,-88.0,-90.0,-86.0,-87.0,37.0,42.0,42.0,41.0,1
2958,CC:2F:71:3F:1F:24,5124003,1958982661,1274696,1473523427,3849307,485459234,2222,1073847,1231582989,1072984,1231478501,863,104488,1038930,15,1272830,122279,2219,825,130000.0,43333.0,-70.0,-70.0,-68.0,-75.0,-70.0,-69.0,-67.0,-75.0,-88.0,-90.0,-86.0,-87.0,18.0,20.0,18.0,12.0,1
2959,CC:2F:71:3E:C5:1F,3850319,485582834,1010,123398,3849309,485459436,3,4432,369174,3695,281678,737,87496,1069,14,1455,30,3,54,144444.0,39000.0,-73.0,-72.0,-69.0,-60.0,-71.0,-70.0,-68.0,-60.0,-88.0,-90.0,-86.0,-87.0,15.0,18.0,17.0,27.0,1
2960,BA:8C:B9:54:50:24,3854263,491656123,4951,6196212,3849312,485459911,7,9952,1765424,9930,1761929,22,3495,2361,18,5469,44,7,75,216660.0,130000.0,-39.0,-36.0,-46.0,-52.0,-44.0,-35.0,-44.0,-47.0,-88.0,-90.0,-86.0,-87.0,49.0,54.0,40.0,35.0,1
2961,62:47:05:9D:EB:15,3856204,497700879,6892,12240968,3849312,485459911,1,7263,3860696,7213,3853038,50,7658,3442,0,6969,56,1,126,229410.0,137640.0,-44.0,-46.0,-37.0,-46.0,-45.0,-47.0,-40.0,-47.0,-88.0,-90.0,-86.0,-87.0,44.0,44.0,49.0,41.0,1
2962,92:69:1D:31:68:E9,3853486,489164432,4174,3704521,3849312,485459911,1,5680,1226078,5503,1185815,177,40263,2315,12,4439,103,1,65,229410.0,137640.0,-51.0,-48.0,-44.0,-46.0,-51.0,-48.0,-44.0,-48.0,-88.0,-90.0,-86.0,-87.0,37.0,42.0,42.0,41.0,1
2963,CC:2F:71:3F:1F:24,5124203,1959226177,1274891,1473766266,3849312,485459911,2222,1074027,1231816784,1073164,1231712296,863,104488,1039106,15,1273026,122284,2219,825,130000.0,43333.0,-70.0,-70.0,-68.0,-76.0,-69.0,-69.0,-67.0,-75.0,-88.0,-90.0,-86.0,-87.0,18.0,20.0,18.0,11.0,1
2964,CC:2F:71:3E:C5:1F,3850322,485583309,1010,123398,3849312,485459911,3,4432,369174,3695,281678,737,87496,1069,14,1455,30,3,54,144444.0,39000.0,-73.0,-72.0,-69.0,-60.0,-71.0,-70.0,-68.0,-60.0,-88.0,-90.0,-86.0,-87.0,15.0,18.0,17.0,27.0,1
2965,BA:8C:B9:54:50:24,3854263,491656123,4951,6196212,3849312,485459911,7,9952,1765424,9930,1761929,22,3495,2361,18,5469,44,7,75,216660.0,130000.0,-39.0,-36.0,-46.0,-52.0,-44.0,-35.0,-44.0,-47.0,-88.0,-90.0,-86.0,-87.0,49.0,54.0,40.0,35.0,1
2966,62:47:05:9D:EB:15,3856209,497701343,6892,12240968,3849317,485460375,1,7263,3860696,7213,3853038,50,7658,3442,0,6969,56,1,126,229410.0,137640.0,-44.0,-46.0,-37.0,-46.0,-45.0,-47.0,-40.0,-47.0,-88.0,-90.0,-86.0,-87.0,44.0,44.0,49.0,41.0,1
2967,92:69:1D:31:68:E9,3853495,489165300,4174,3704521,3849321,485460779,1,5680,1226078,5503,1185815,177,40263,2315,12,4439,103,1,65,229410.0,137640.0,-51.0,-48.0,-44.0,-46.0,-51.0,-48.0,-44.0,-48.0,-88.0,-90.0,-86.0,-87.0,37.0,42.0,42.0,41.0,1
2968,CC:2F:71:3F:1F:24,5124415,1959485803,1275094,1474025024,3849321,485460779,2222,1074217,1232068572,1073354,1231964084,863,104488,1039290,15,1273228,122285,2219,825,130000.0,43333.0,-70.0,-70.0,-68.0,-76.0,-70.0,-69.0,-68.0,-76.0,-88.0,-90.0,-86.0,-87.0,18.0,20.0,18.0,11.0,1
2969,CC:2F:71:3E:C5:1F,3850331,485584177,1010,123398,3849321,485460779,3,4432,369174,3695,281678,737,87496,1069,14,1455,30,3,54,144444.0,39000.0,-73.0,-72.0,-69.0,-60.0,-71.0,-70.0,-68.0,-60.0,-88.0,-90.0,-86.0,-87.0,15.0,18.0,17.0,27.0,1
2970,BA:8C:B9:54:50:24,3854272,491656991,4951,6196212,3849321,485460779,7,9952,1765424,9930,1761929,22,3495,2361,18,5469,44,7,75,216660.0,130000.0,-39.0,-36.0,-46.0,-52.0,-44.0,-35.0,-44.0,-47.0,-88.0,-90.0,-86.0,-87.0,49.0,54.0,40.0,35.0,1
2971,62:47:05:9D:EB:15,3856215,497702115,6892,12240968,3849323,485461147,1,7263,3860696,7213,3853038,50,7658,3442,0,6969,56,1,126,229410.0,137640.0,-44.0,-46.0,-37.0,-46.0,-45.0,-47.0,-40.0,-47.0,-88.0,-90.0,-86.0,-87.0,44.0,44.0,49.0,41.0,1
2972,92:69:1D:31:68:E9,3853497,489165668,4174,3704521,3849323,485461147,1,5680,1226078,5503,1185815,177,40263,2315,12,4439,103,1,65,229410.0,137640.0,-51.0,-48.0,-44.0,-46.0,-51.0,-48.0,-44.0,-48.0,-88.0,-90.0,-86.0,-87.0,37.0,42.0,42.0,41.0,1
2973,CC:2F:71:3F:1F:24,5124609,1959728907,1275286,1474267760,3849323,485461147,2222,1074393,1232307164,1073530,1232202676,863,104488,1039458,15,1273419,122290,2219,825,130000.0,43333.0,-70.0,-69.0,-67.0,-74.0,-70.0,-69.0,-67.0,-73.0,-88.0,-90.0,-86.0,-87.0,18.0,21.0,19.0,13.0,1
2974,CC:2F:71:3E:C5:1F,3850333,485584545,1010,123398,3849323,485461147,3,4432,369174,3695,281678,737,87496,1069,14,1455,30,3,54,144444.0,39000.0,-73.0,-72.0,-69.0,-60.0,-71.0,-70.0,-68.0,-60.0,-88.0,-90.0,-86.0,-87.0,15.0,18.0,17.0,27.0,1
2975,BA:8C:B9:54:50:24,3854274,491657359,4951,6196212,3849323,485461147,7,9952,1765424,9930,1761929,22,3495,2361,18,5469,44,7,75,216660.0,130000.0,-39.0,-36.0,-46.0,-52.0,-44.0,-35.0,-44.0,-47.0,-88.0,-90.0,-86.0,-87.0,49.0,54.0,40.0,35.0,1
2976,62:47:05:9D:EB:15,3856252,497716677,6920,12254662,3849332,485462015,1,7301,3869712,7251,3862054,50,7658,3469,0,6997,56,1,126,229410.0,137640.0,-45.0,-46.0,-37.0,-45.0,-46.0,-48.0,-40.0,-46.0,-88.0,-90.0,-86.0,-87.0,43.0,44.0,49.0,42.0,1
2977,92:69:1D:31:68:E9,3853506,489166536,4174,3704521,3849332,485462015,1,5680,1226078,5503,1185815,177,40263,2315,12,4439,103,1,65,229410.0,137640.0,-51.0,-48.0,-44.0,-46.0,-51.0,-48.0,-44.0,-48.0,-88.0,-90.0,-86.0,-87.0,37.0,42.0,42.0,41.0,1
2978,CC:2F:71:3F:1F:24,5124809,1959971167,1275477,1474509152,3849332,485462015,2222,1074570,1232545862,1073707,1232441374,863,104488,1039627,15,1273612,122294,2219,825,130000.0,43333.0,-70.0,-69.0,-66.0,-74.0,-69.0,-68.0,-66.0,-73.0,-88.0,-90.0,-86.0,-87.0,18.0,21.0,20.0,13.0,1
2979,CC:2F:71:3E:C5:1F,3850342,485585413,1010,123398,3849332,485462015,3,4432,369174,3695,281678,737,87496,1069,14,1455,30,3,54,144444.0,39000.0,-73.0,-72.0,-69.0,-60.0,-71.0,-70.0,-68.0,-60.0,-88.0,-90.0,-86.0,-87.0,15.0,18.0,17.0,27.0,1
2980,BA:8C:B9:54:50:24,3854283,491658227,4951,6196212,3849332,485462015,7,9952,1765424,9930,1761929,22,3495,2361,18,5469,44,7,75,216660.0,130000.0,-39.0,-36.0,-46.0,-52.0,-44.0,-35.0,-44.0,-47.0,-88.0,-90.0,-86.0,-87.0,49.0,54.0,40.0,35.0,1
2981,62:47:05:9D:EB:15,3856252,497716677,6920,12254662,3849332,485462015,1,7301,3869712,7251,3862054,50,7658,3469,0,6997,56,1,126,229410.0,137640.0,-45.0,-46.0,-37.0,-45.0,-46.0,-48.0,-40.0,-46.0,-88.0,-90.0,-86.0,-87.0,43.0,44.0,49.0,42.0,1
2982,92:69:1D:31:68:E9,3853506,489166536,4174,3704521,3849332,485462015,1,5680,1226078,5503,1185815,177,40263,2315,12,4439,103,1,65,229410.0,137640.0,-51.0,-48.0,-44.0,-46.0,-51.0,-48.0,-44.0,-48.0,-88.0,-90.0,-86.0,-87.0,37.0,42.0,42.0,41.0,1
2983,CC:2F:71:3F:1F:24,5125016,1960218714,1275684,1474756699,3849332,485462015,2222,1074760,1232781471,1073897,1232676983,863,104488,1039814,15,1273819,122302,2219,825,130000.0,43333.0,-68.0,-69.0,-67.0,-72.0,-68.0,-68.0,-67.0,-71.0,-88.0,-90.0,-86.0,-87.0,20.0,21.0,19.0,15.0,1
2984,CC:2F:71:3E:C5:1F,3850342,485585413,1010,123398,3849332,485462015,3,4432,369174,3695,281678,737,87496,1069,14,1455,30,3,54,144444.0,39000.0,-73.0,-72.0,-69.0,-60.0,-71.0,-70.0,-68.0,-60.0,-88.0,-90.0,-86.0,-87.0,15.0,18.0,17.0,27.0,1
2985,BA:8C:B9:54:50:24,3854285,491658429,4951,6196212,3849334,485462217,7,9952,1765424,9930,1761929,22,3495,2361,18,5469,44,7,75,216660.0,130000.0,-39.0,-36.0,-46.0,-52.0,-44.0,-35.0,-44.0,-47.0,-88.0,-90.0,-86.0,-87.0,49.0,54.0,40.0,35.0,1
2986,62:47:05:9D:EB:15,3856260,497717485,6920,12254662,3849340,485462823,1,7301,3869712,7251,3862054,50,7658,3469,0,6997,56,1,126,229410.0,137640.0,-45.0,-46.0,-37.0,-45.0,-46.0,-48.0,-40.0,-46.0,-88.0,-90.0,-86.0,-87.0,43.0,44.0,49.0,42.0,1
2987,92:69:1D:31:68:E9,3853514,489167344,4174,3704521,3849340,485462823,1,5680,1226078,5503,1185815,177,40263,2315,12,4439,103,1,65,229410.0,137640.0,-51.0,-48.0,-44.0,-46.0,-51.0,-48.0,-44.0,-48.0,-88.0,-90.0,-86.0,-87.0,37.0,42.0,42.0,41.0,1
2988,CC:2F:71:3F:1F:24,5125218,1960464152,1275878,1475001329,3849340,485462823,2222,1074934,1233014225,1074071,1232909737,863,104488,1039985,15,1274013,122302,2219,825,130000.0,43333.0,-70.0,-70.0,-68.0,-73.0,-70.0,-70.0,-67.0,-73.0,-88.0,-90.0,-86.0,-87.0,18.0,20.0,18.0,14.0,1
2989,CC:2F:71:3E:C5:1F,3850350,485586221,1010,123398,3849340,485462823,3,4432,369174,3695,281678,737,87496,1069,14,1455,30,3,54,144444.0,39000.0,-73.0,-72.0,-69.0,-60.0,-71.0,-70.0,-68.0,-60.0,-88.0,-90.0,-86.0,-87.0,15.0,18.0,17.0,27.0,1
2990,BA:8C:B9:54:50:24,3854291,491659035,4951,6196212,3849340,485462823,7,9952,1765424,9930,1761929,22,3495,2361,18,5469,44,7,75,216660.0,130000.0,-39.0,-36.0,-46.0,-52.0,-44.0,-35.0,-44.0,-47.0,-88.0,-90.0,-86.0,-87.0,49.0,54.0,40.0,35.0,1
2991,62:47:05:9D:EB:15,3856261,497717545,6920,12254662,3849341,485462883,1,7301,3869712,7251,3862054,50,7658,3469,0,6997,56,1,126,229410.0,137640.0,-45.0,-46.0,-37.0,-45.0,-46.0,-48.0,-40.0,-46.0,-88.0,-90.0,-86.0,-87.0,43.0,44.0,49.0,42.0,1
2992,92:69:1D:31:68:E9,3853515,489167404,4174,3704521,3849341,485462883,1,5680,1226078,5503,1185815,177,40263,2315,12,4439,103,1,65,229410.0,137640.0,-51.0,-48.0,-44.0,-46.0,-51.0,-48.0,-44.0,-48.0,-88.0,-90.0,-86.0,-87.0,37.0,42.0,42.0,41.0,1
2993,CC:2F:71:3F:1F:24,5125411,1960705734,1276070,1475242851,3849341,485462883,2222,1075107,1233245297,1074244,1233140809,863,104488,1040155,15,1274205,122302,2219,825,130000.0,43333.0,-70.0,-70.0,-68.0,-74.0,-70.0,-70.0,-67.0,-73.0,-88.0,-90.0,-86.0,-87.0,18.0,20.0,18.0,13.0,1
2994,CC:2F:71:3E:C5:1F,3850353,485586483,1010,123398,3849343,485463085,3,4432,369174,3695,281678,737,87496,1069,14,1455,30,3,54,144444.0,39000.0,-73.0,-72.0,-69.0,-60.0,-71.0,-70.0,-68.0,-60.0,-88.0,-90.0,-86.0,-87.0,15.0,18.0,17.0,27.0,1
2995,BA:8C:B9:54:50:24,3854294,491659297,4951,6196212,3849343,485463085,7,9952,1765424,9930,1761929,22,3495,2361,18,5469,44,7,75,216660.0,130000.0,-39.0,-36.0,-46.0,-52.0,-44.0,-35.0,-44.0,-47.0,-88.0,-90.0,-86.0,-87.0,49.0,54.0,40.0,35.0,1
2996,62:47:05:9D:EB:15,3856269,497718353,6920,12254662,3849349,485463691,1,7302,3869780,7252,3862122,50,7658,3469,0,6997,56,1,126,229410.0,137640.0,-46.0,-47.0,-48.0,-45.0,-46.0,-48.0,-41.0,-45.0,-88.0,-90.0,-86.0,-87.0,42.0,43.0,38.0,42.0,1
2997,92:69:1D:31:68:E9,3853523,489168212,4174,3704521,3849349,485463691,1,5680,1226078,5503,1185815,177,40263,2315,12,4439,103,1,65,229410.0,137640.0,-51.0,-48.0,-44.0,-46.0,-51.0,-48.0,-44.0,-48.0,-88.0,-90.0,-86.0,-87.0,37.0,42.0,42.0,41.0,1
2998,CC:2F:71:3F:1F:24,5125616,1960959728,1276267,1475496037,3849349,485463691,2222,1075290,1233492103,1074427,1233387615,863,104488,1040332,15,1274402,122313,2219,825,144444.0,43333.0,-70.0,-68.0,-68.0,-72.0,-69.0,-68.0,-68.0,-71.0,-88.0,-90.0,-86.0,-87.0,18.0,22.0,18.0,15.0,1
2999,CC:2F:71:3E:C5:1F,3850359,485587089,1010,123398,3849349,485463691,3,4432,369174,3695,281678,737,87496,1069,14,1455,30,3,54,144444.0,39000.0,-73.0,-72.0,-69.0,-60.0,-71.0,-70.0,-68.0,-60.0,-88.0,-90.0,-86.0,-87.0,15.0,18.0,17.0,27.0,1
3000,BA:8C:B9:54:50:24,3854300,491659903,4951,6196212,3849349,485463691,7,9952,1765424,9930,1761929,22,3495,2361,18,5469,44,7,75,216660.0,130000.0,-39.0,-36.0,-46.0,-52.0,-44.0,-35.0,-44.0,-47.0,-88.0,-90.0,-86.0,-87.0,49.0,54.0,40.0,35.0,1
3001,62:47:05:9D:EB:15,3856275,497721507,6923,12257554,3849352,485463953,1,7309,3870576,7259,3862918,50,7658,3472,0,7000,56,1,126,229410.0,137640.0,-43.0,-46.0,-38.0,-45.0,-45.0,-47.0,-40.0,-45.0,-88.0,-90.0,-86.0,-87.0,45.0,44.0,48.0,42.0,1
3002,92:69:1D:31:68:E9,3853526,489168474,4174,3704521,3849352,485463953,1,5680,1226078,5503,1185815,177,40263,2315,12,4439,103,1,65,229410.0,137640.0,-51.0,-48.0,-44.0,-46.0,-51.0,-48.0,-44.0,-48.0,-88.0,-90.0,-86.0,-87.0,37.0,42.0,42.0,41.0,1
3003,CC:2F:71:3F:1F:24,5125824,1961217169,1276472,1475753216,3849352,485463953,2222,1075478,1233739656,1074615,1233635168,863,104488,1040515,15,1274607,122315,2219,825,144444.0,43333.0,-69.0,-68.0,-68.0,-73.0,-69.0,-68.0,-68.0,-72.0,-88.0,-90.0,-86.0,-87.0,19.0,22.0,18.0,14.0,1
3004,CC:2F:71:3E:C5:1F,3850362,485587351,1010,123398,3849352,485463953,3,4432,369174,3695,281678,737,87496,1069,14,1455,30,3,54,144444.0,39000.0,-73.0,-72.0,-69.0,-60.0,-71.0,-70.0,-68.0,-60.0,-88.0,-90.0,-86.0,-87.0,15.0,18.0,17.0,27.0,1
3005,BA:8C:B9:54:50:24,3854303,491660165,4951,6196212,3849352,485463953,7,9952,1765424,9930,1761929,22,3495,2361,18,5469,44,7,75,216660.0,130000.0,-39.0,-36.0,-46.0,-52.0,-44.0,-35.0,-44.0,-47.0,-88.0,-90.0,-86.0,-87.0,49.0,54.0,40.0,35.0,1
3006,62:47:05:9D:EB:15,3856282,497722229,6924,12257670,3849358,485464559,1,7311,3870712,7261,3863054,50,7658,3472,0,7001,56,1,126,229410.0,137640.0,-43.0,-46.0,-37.0,-46.0,-44.0,-46.0,-39.0,-45.0,-88.0,-90.0,-86.0,-87.0,45.0,44.0,49.0,41.0,1
3007,92:69:1D:31:68:E9,3853533,489169196,4175,3704637,3849358,485464559,1,5682,1226214,5505,1185951,177,40263,2315,12,4440,103,1,65,216660.0,130000.0,-52.0,-47.0,-42.0,-49.0,-51.0,-47.0,-43.0,-47.0,-88.0,-90.0,-86.0,-87.0,36.0,43.0,44.0,38.0,1
3008,CC:2F:71:3F:1F:24,5126018,1961455929,1276660,1475991370,3849358,485464559,2222,1075649,1233970506,1074786,1233866018,863,104488,1040681,15,1274795,122318,2219,825,144444.0,43333.0,-69.0,-68.0,-69.0,-72.0,-69.0,-67.0,-68.0,-71.0,-88.0,-90.0,-86.0,-87.0,19.0,22.0,17.0,15.0,1
3009,CC:2F:71:3E:C5:1F,3850373,485588734,1015,124175,3849358,485464559,3,4438,369989,3701,282493,737,87496,1074,14,1460,30,3,54,144444.0,43333.0,-70.0,-70.0,-68.0,-60.0,-71.0,-71.0,-68.0,-60.0,-88.0,-90.0,-86.0,-87.0,18.0,20.0,18.0,27.0,1
3010,BA:8C:B9:54:50:24,3854311,491660949,4952,6196328,3849359,485464621,7,9954,1765560,9932,1762065,22,3495,2361,18,5470,44,7,75,216660.0,130000.0,-48.0,-35.0,-43.0,-45.0,-44.0,-35.0,-44.0,-47.0,-88.0,-90.0,-86.0,-87.0,40.0,55.0,43.0,42.0,1
3011,62:47:05:9D:EB:15,3856285,497722493,6924,12257670,3849361,485464823,1,7311,3870712,7261,3863054,50,7658,3472,0,7001,56,1,126,229410.0,137640.0,-43.0,-46.0,-37.0,-46.0,-44.0,-46.0,-39.0,-45.0,-88.0,-90.0,-86.0,-87.0,45.0,44.0,49.0,41.0,1
3012,92:69:1D:31:68:E9,3853536,489169460,4175,3704637,3849361,485464823,1,5682,1226214,5505,1185951,177,40263,2315,12,4440,103,1,65,216660.0,130000.0,-52.0,-47.0,-42.0,-49.0,-51.0,-47.0,-43.0,-47.0,-88.0,-90.0,-86.0,-87.0,36.0,43.0,44.0,38.0,1
3013,CC:2F:71:3F:1F:24,5126212,1961697599,1276851,1476232776,3849361,485464823,2222,1075825,1234207690,1074961,1234103084,864,104606,1040848,15,1274986,122323,2219,825,144444.0,43333.0,-69.0,-68.0,-68.0,-72.0,-69.0,-68.0,-67.0,-72.0,-88.0,-90.0,-86.0,-87.0,19.0,22.0,18.0,15.0,1
3014,CC:2F:71:3E:C5:1F,3850376,485588998,1015,124175,3849361,485464823,3,4438,369989,3701,282493,737,87496,1074,14,1460,30,3,54,144444.0,43333.0,-70.0,-70.0,-68.0,-60.0,-71.0,-71.0,-68.0,-60.0,-88.0,-90.0,-86.0,-87.0,18.0,20.0,18.0,27.0,1
3015,BA:8C:B9:54:50:24,3854314,491661211,4952,6196328,3849362,485464883,7,9954,1765560,9932,1762065,22,3495,2361,18,5470,44,7,75,216660.0,130000.0,-48.0,-35.0,-43.0,-45.0,-44.0,-35.0,-44.0,-47.0,-88.0,-90.0,-86.0,-87.0,40.0,55.0,43.0,42.0,1
3016,62:47:05:9D:EB:15,3856292,497723159,6924,12257670,3849368,485465489,1,7311,3870712,7261,3863054,50,7658,3472,0,7001,56,1,126,229410.0,137640.0,-43.0,-46.0,-37.0,-46.0,-44.0,-46.0,-39.0,-45.0,-88.0,-90.0,-86.0,-87.0,45.0,44.0,49.0,41.0,1
3017,92:69:1D:31:68:E9,3853543,489170126,4175,3704637,3849368,485465489,1,5682,1226214,5505,1185951,177,40263,2315,12,4440,103,1,65,216660.0,130000.0,-52.0,-47.0,-42.0,-49.0,-51.0,-47.0,-43.0,-47.0,-88.0,-90.0,-86.0,-87.0,36.0,43.0,44.0,38.0,1
3018,CC:2F:71:3F:1F:24,5126417,1961945990,1277049,1476480501,3849368,485465489,2222,1076009,1234446305,1075145,1234341699,864,104606,1041028,15,1275184,122335,2219,825,144444.0,43333.0,-70.0,-69.0,-69.0,-73.0,-69.0,-68.0,-68.0,-72.0,-88.0,-90.0,-86.0,-87.0,18.0,21.0,17.0,14.0,1
3019,CC:2F:71:3E:C5:1F,3850383,485589664,1015,124175,3849368,485465489,3,4438,369989,3701,282493,737,87496,1074,14,1460,30,3,54,144444.0,43333.0,-70.0,-70.0,-68.0,-60.0,-71.0,-71.0,-68.0,-60.0,-88.0,-90.0,-86.0,-87.0,18.0,20.0,18.0,27.0,1
3020,BA:8C:B9:54:50:24,3854320,491661817,4952,6196328,3849368,485465489,7,9955,1765628,9933,1762133,22,3495,2361,18,5470,44,7,76,216660.0,130000.0,-48.0,-35.0,-43.0,-45.0,-44.0,-35.0,-44.0,-47.0,-88.0,-90.0,-86.0,-87.0,40.0,55.0,43.0,42.0,1
3021,62:47:05:9D:EB:15,3856295,497723634,6924,12257670,3849371,485465964,1,7311,3870712,7261,3863054,50,7658,3472,0,7001,56,1,126,229410.0,137640.0,-43.0,-46.0,-37.0,-46.0,-44.0,-46.0,-39.0,-45.0,-88.0,-90.0,-86.0,-87.0,45.0,44.0,49.0,41.0,1
3022,92:69:1D:31:68:E9,3853546,489170601,4175,3704637,3849371,485465964,1,5682,1226214,5505,1185951,177,40263,2315,12,4440,103,1,65,216660.0,130000.0,-52.0,-47.0,-42.0,-49.0,-51.0,-47.0,-43.0,-47.0,-88.0,-90.0,-86.0,-87.0,36.0,43.0,44.0,38.0,1
3023,CC:2F:71:3F:1F:24,5126610,1962187741,1277239,1476721777,3849371,485465964,2222,1076185,1234680741,1075321,1234576135,864,104606,1041198,15,1275374,122340,2219,825,144444.0,43333.0,-70.0,-69.0,-68.0,-75.0,-70.0,-68.0,-68.0,-74.0,-88.0,-90.0,-86.0,-87.0,18.0,21.0,18.0,12.0,1
3024,CC:2F:71:3E:C5:1F,3850388,485590341,1015,124175,3849373,485466166,3,4438,369989,3701,282493,737,87496,1074,14,1460,30,3,54,144444.0,43333.0,-70.0,-70.0,-68.0,-60.0,-71.0,-71.0,-68.0,-60.0,-88.0,-90.0,-86.0,-87.0,18.0,20.0,18.0,27.0,1
3025,BA:8C:B9:54:50:24,3854325,491662494,4952,6196328,3849373,485466166,7,9955,1765628,9933,1762133,22,3495,2361,18,5470,44,7,76,216660.0,130000.0,-48.0,-35.0,-43.0,-45.0,-44.0,-35.0,-44.0,-47.0,-88.0,-90.0,-86.0,-87.0,40.0,55.0,43.0,42.0,1
3026,62:47:05:9D:EB:15,3856302,497724300,6924,12257670,3849378,485466630,1,7311,3870712,7261,3863054,50,7658,3472,0,7001,56,1,126,229410.0,137640.0,-43.0,-46.0,-37.0,-46.0,-44.0,-46.0,-39.0,-45.0,-88.0,-90.0,-86.0,-87.0,45.0,44.0,49.0,41.0,1
3027,92:69:1D:31:68:E9,3853553,489171267,4175,3704637,3849378,485466630,1,5682,1226214,5505,1185951,177,40263,2315,12,4440,103,1,65,216660.0,130000.0,-52.0,-47.0,-42.0,-49.0,-51.0,-47.0,-43.0,-47.0,-88.0,-90.0,-86.0,-87.0,36.0,43.0,44.0,38.0,1
3028,CC:2F:71:3F:1F:24,5126808,1962429813,1277430,1476963183,3849378,485466630,2222,1076356,1234910215,1075492,1234805609,864,104606,1041366,15,1275565,122344,2219,825,144444.0,43333.0,-70.0,-69.0,-68.0,-74.0,-70.0,-69.0,-68.0,-73.0,-88.0,-90.0,-86.0,-87.0,18.0,21.0,18.0,13.0,1
3029,CC:2F:71:3E:C5:1F,3850393,485590805,1015,124175,3849378,485466630,3,4438,369989,3701,282493,737,87496,1074,14,1460,30,3,54,144444.0,43333.0,-70.0,-70.0,-68.0,-60.0,-71.0,-71.0,-68.0,-60.0,-88.0,-90.0,-86.0,-87.0,18.0,20.0,18.0,27.0,1
3030,BA:8C:B9:54:50:24,3854330,491662958,4952,6196328,3849378,485466630,7,9955,1765628,9933,1762133,22,3495,2361,18,5470,44,7,76,216660.0,130000.0,-48.0,-35.0,-43.0,-45.0,-44.0,-35.0,-44.0,-47.0,-88.0,-90.0,-86.0,-87.0,40.0,55.0,43.0,42.0,1
3031,62:47:05:9D:EB:15,3856304,497724502,6924,12257670,3849380,485466832,1,7311,3870712,7261,3863054,50,7658,3472,0,7001,56,1,126,229410.0,137640.0,-43.0,-46.0,-37.0,-46.0,-44.0,-46.0,-39.0,-45.0,-88.0,-90.0,-86.0,-87.0,45.0,44.0,49.0,41.0,1
3032,92:69:1D:31:68:E9,3853555,489171469,4175,3704637,3849380,485466832,1,5682,1226214,5505,1185951,177,40263,2315,12,4440,103,1,65,216660.0,130000.0,-52.0,-47.0,-42.0,-49.0,-51.0,-47.0,-43.0,-47.0,-88.0,-90.0,-86.0,-87.0,36.0,43.0,44.0,38.0,1
3033,CC:2F:71:3F:1F:24,5126998,1962668183,1277618,1477201351,3849380,485466832,2222,1076532,1235147491,1075668,1235042885,864,104606,1041532,15,1275753,122347,2219,825,144444.0,43333.0,-71.0,-69.0,-70.0,-73.0,-70.0,-69.0,-69.0,-73.0,-88.0,-90.0,-86.0,-87.0,17.0,21.0,16.0,14.0,1
3034,CC:2F:71:3E:C5:1F,3850399,485591411,1015,124175,3849384,485467236,3,4438,369989,3701,282493,737,87496,1074,14,1460,30,3,54,144444.0,43333.0,-70.0,-70.0,-68.0,-60.0,-71.0,-71.0,-68.0,-60.0,-88.0,-90.0,-86.0,-87.0,18.0,20.0,18.0,27.0,1
3035,BA:8C:B9:54:50:24,3854336,491663564,4952,6196328,3849384,485467236,7,9955,1765628,9933,1762133,22,3495,2361,18,5470,44,7,76,216660.0,130000.0,-48.0,-35.0,-43.0,-45.0,-44.0,-35.0,-44.0,-47.0,-88.0,-90.0,-86.0,-87.0,40.0,55.0,43.0,42.0,1
3036,62:47:05:9D:EB:15,3856310,497725108,6924,12257670,3849386,485467438,1,7311,3870712,7261,3863054,50,7658,3472,0,7001,56,1,126,229410.0,137640.0,-43.0,-46.0,-37.0,-46.0,-44.0,-46.0,-39.0,-45.0,-88.0,-90.0,-86.0,-87.0,45.0,44.0,49.0,41.0,1
3037,92:69:1D:31:68:E9,3853561,489172075,4175,3704637,3849386,485467438,1,5682,1226214,5505,1185951,177,40263,2315,12,4440,103,1,65,216660.0,130000.0,-52.0,-47.0,-42.0,-49.0,-51.0,-47.0,-43.0,-47.0,-88.0,-90.0,-86.0,-87.0,36.0,43.0,44.0,38.0,1
3038,CC:2F:71:3F:1F:24,5127203,1962913796,1277817,1477446358,3849386,485467438,2222,1076714,1235384395,1075850,1235279789,864,104606,1041708,15,1275952,122356,2219,825,144444.0,43333.0,-70.0,-69.0,-69.0,-74.0,-70.0,-69.0,-69.0,-73.0,-88.0,-90.0,-86.0,-87.0,18.0,21.0,17.0,13.0,1
3039,CC:2F:71:3E:C5:1F,3850403,485591845,1017,124407,3849386,485467438,3,4442,370341,3705,282845,737,87496,1076,14,1462,30,3,54,144444.0,43333.0,-72.0,-72.0,-69.0,-61.0,-70.0,-71.0,-68.0,-60.0,-88.0,-90.0,-86.0,-87.0,16.0,18.0,17.0,26.0,1
3040,BA:8C:B9:54:50:24,3854339,491663826,4952,6196328,3849387,485467498,7,9955,1765628,9933,1762133,22,3495,2361,18,5470,44,7,76,216660.0,130000.0,-48.0,-35.0,-43.0,-45.0,-44.0,-35.0,-44.0,-47.0,-88.0,-90.0,-86.0,-87.0,40.0,55.0,43.0,42.0,1
3041,62:47:05:9D:EB:15,3856319,497730485,6930,12262785,3849389,485467700,1,7326,3872666,7276,3865008,50,7658,3481,0,7007,56,1,126,216660.0,130000.0,-47.0,-49.0,-41.0,-48.0,-45.0,-47.0,-39.0,-47.0,-88.0,-90.0,-86.0,-87.0,41.0,41.0,45.0,39.0,1
3042,92:69:1D:31:68:E9,3853564,489172337,4175,3704637,3849389,485467700,1,5682,1226214,5505,1185951,177,40263,2315,12,4440,103,1,65,216660.0,130000.0,-52.0,-47.0,-42.0,-49.0,-51.0,-47.0,-43.0,-47.0,-88.0,-90.0,-86.0,-87.0,36.0,43.0,44.0,38.0,1
3043,CC:2F:71:3F:1F:24,5127400,1963157236,1278009,1477689334,3849391,485467902,2222,1076887,1235615449,1076023,1235510843,864,104606,1041878,15,1276144,122361,2219,825,144444.0,43333.0,-69.0,-67.0,-67.0,-73.0,-69.0,-68.0,-67.0,-73.0,-88.0,-90.0,-86.0,-87.0,19.0,23.0,19.0,14.0,1
3044,CC:2F:71:3E:C5:1F,3850408,485592309,1017,124407,3849391,485467902,3,4442,370341,3705,282845,737,87496,1076,14,1462,30,3,54,144444.0,43333.0,-72.0,-72.0,-69.0,-61.0,-70.0,-71.0,-68.0,-60.0,-88.0,-90.0,-86.0,-87.0,16.0,18.0,17.0,26.0,1
3045,BA:8C:B9:54:50:24,3854343,491664230,4952,6196328,3849391,485467902,7,9955,1765628,9933,1762133,22,3495,2361,18,5470,44,7,76,216660.0,130000.0,-48.0,-35.0,-43.0,-45.0,-44.0,-35.0,-44.0,-47.0,-88.0,-90.0,-86.0,-87.0,40.0,55.0,43.0,42.0,1
3046,62:47:05:9D:EB:15,3856339,497734524,6944,12266218,3849395,485468306,1,7341,3877341,7291,3869683,50,7658,3493,0,7021,56,1,126,229410.0,130000.0,-43.0,-46.0,-36.0,-47.0,-46.0,-48.0,-41.0,-47.0,-88.0,-90.0,-86.0,-87.0,45.0,44.0,50.0,40.0,1
3047,92:69:1D:31:68:E9,3853570,489172943,4175,3704637,3849395,485468306,1,5682,1226214,5505,1185951,177,40263,2315,12,4440,103,1,65,216660.0,130000.0,-52.0,-47.0,-42.0,-49.0,-51.0,-47.0,-43.0,-47.0,-88.0,-90.0,-86.0,-87.0,36.0,43.0,44.0,38.0,1
3048,CC:2F:71:3F:1F:24,5127596,1963400616,1278201,1477932310,3849395,485468306,2222,1077063,1235852603,1076199,1235747997,864,104606,1042047,15,1276336,122366,2219,825,144444.0,43333.0,-70.0,-68.0,-68.0,-73.0,-69.0,-68.0,-68.0,-72.0,-88.0,-90.0,-86.0,-87.0,18.0,22.0,18.0,14.0,1
3049,CC:2F:71:3E:C5:1F,3850412,485592713,1017,124407,3849395,485468306,3,4442,370341,3705,282845,737,87496,1076,14,1462,30,3,54,144444.0,43333.0,-72.0,-72.0,-69.0,-61.0,-70.0,-71.0,-68.0,-60.0,-88.0,-90.0,-86.0,-87.0,16.0,18.0,17.0,26.0,1
3050,BA:8C:B9:54:50:24,3854347,491664634,4952,6196328,3849395,485468306,7,9955,1765628,9933,1762133,22,3495,2361,18,5470,44,7,76,216660.0,130000.0,-48.0,-35.0,-43.0,-45.0,-44.0,-35.0,-44.0,-47.0,-88.0,-90.0,-86.0,-87.0,40.0,55.0,43.0,42.0,1
3051,62:47:05:9D:EB:15,3856346,497736924,6946,12268154,3849400,485468770,1,7346,3877937,7296,3870279,50,7658,3495,0,7023,56,1,126,229410.0,130000.0,-47.0,-49.0,-43.0,-48.0,-46.0,-47.0,-40.0,-47.0,-88.0,-90.0,-86.0,-87.0,41.0,41.0,43.0,39.0,1
3052,92:69:1D:31:68:E9,3853575,489173407,4175,3704637,3849400,485468770,1,5682,1226214,5505,1185951,177,40263,2315,12,4440,103,1,65,216660.0,130000.0,-52.0,-47.0,-42.0,-49.0,-51.0,-47.0,-43.0,-47.0,-88.0,-90.0,-86.0,-87.0,36.0,43.0,44.0,38.0,1
3053,CC:2F:71:3F:1F:24,5127805,1963658442,1278405,1478189672,3849400,485468770,2222,1077250,1236101119,1076386,1235996513,864,104606,1042229,15,1276538,122378,2219,825,144444.0,43333.0,-70.0,-68.0,-67.0,-73.0,-69.0,-67.0,-67.0,-73.0,-88.0,-90.0,-86.0,-87.0,18.0,22.0,19.0,14.0,1
3054,CC:2F:71:3E:C5:1F,3850417,485593177,1017,124407,3849400,485468770,3,4442,370341,3705,282845,737,87496,1076,14,1462,30,3,54,144444.0,43333.0,-72.0,-72.0,-69.0,-61.0,-70.0,-71.0,-68.0,-60.0,-88.0,-90.0,-86.0,-87.0,16.0,18.0,17.0,26.0,1
3055,BA:8C:B9:54:50:24,3854356,491665502,4952,6196328,3849404,485469174,7,9955,1765628,9933,1762133,22,3495,2361,18,5470,44,7,76,216660.0,130000.0,-48.0,-35.0,-43.0,-45.0,-44.0,-35.0,-44.0,-47.0,-88.0,-90.0,-86.0,-87.0,40.0,55.0,43.0,42.0,1
3056,62:47:05:9D:EB:15,3856350,497737328,6946,12268154,3849404,485469174,1,7347,3878005,7297,3870347,50,7658,3495,0,7023,56,1,126,229410.0,130000.0,-44.0,-46.0,-36.0,-48.0,-45.0,-47.0,-40.0,-47.0,-88.0,-90.0,-86.0,-87.0,44.0,44.0,50.0,39.0,1
3057,92:69:1D:31:68:E9,3853579,489173811,4175,3704637,3849404,485469174,1,5682,1226214,5505,1185951,177,40263,2315,12,4440,103,1,65,216660.0,130000.0,-52.0,-47.0,-42.0,-49.0,-51.0,-47.0,-43.0,-47.0,-88.0,-90.0,-86.0,-87.0,36.0,43.0,44.0,38.0,1
3058,CC:2F:71:3F:1F:24,5128011,1963904820,1278607,1478435646,3849404,485469174,2222,1077444,1236344348,1076580,1236239742,864,104606,1042412,15,1276742,122379,2219,825,144444.0,43333.0,-70.0,-67.0,-67.0,-73.0,-69.0,-67.0,-67.0,-73.0,-88.0,-90.0,-86.0,-87.0,18.0,23.0,19.0,14.0,1
3059,CC:2F:71:3E:C5:1F,3850421,485593581,1017,124407,3849404,485469174,3,4442,370341,3705,282845,737,87496,1076,14,1462,30,3,54,144444.0,43333.0,-72.0,-72.0,-69.0,-61.0,-70.0,-71.0,-68.0,-60.0,-88.0,-90.0,-86.0,-87.0,16.0,18.0,17.0,26.0,1
3060,BA:8C:B9:54:50:24,3854356,491665502,4952,6196328,3849404,485469174,7,9955,1765628,9933,1762133,22,3495,2361,18,5470,44,7,76,216660.0,130000.0,-48.0,-35.0,-43.0,-45.0,-44.0,-35.0,-44.0,-47.0,-88.0,-90.0,-86.0,-87.0,40.0,55.0,43.0,42.0,1
3061,62:47:05:9D:EB:15,3856354,497737732,6946,12268154,3849408,485469578,1,7347,3878005,7297,3870347,50,7658,3495,0,7023,56,1,126,229410.0,130000.0,-44.0,-46.0,-36.0,-48.0,-45.0,-47.0,-40.0,-47.0,-88.0,-90.0,-86.0,-87.0,44.0,44.0,50.0,39.0,1
3062,92:69:1D:31:68:E9,3853583,489174215,4175,3704637,3849408,485469578,1,5682,1226214,5505,1185951,177,40263,2315,12,4440,103,1,65,216660.0,130000.0,-52.0,-47.0,-42.0,-49.0,-51.0,-47.0,-43.0,-47.0,-88.0,-90.0,-86.0,-87.0,36.0,43.0,44.0,38.0,1
3063,CC:2F:71:3F:1F:24,5128209,1964146962,1278799,1478677182,3849410,485469780,2222,1077623,1236579206,1076759,1236474600,864,104606,1042582,15,1276934,122384,2219,825,144444.0,43333.0,-70.0,-68.0,-67.0,-74.0,-69.0,-68.0,-67.0,-73.0,-88.0,-90.0,-86.0,-87.0,18.0,22.0,19.0,13.0,1
3064,CC:2F:71:3E:C5:1F,3850427,485594187,1017,124407,3849410,485469780,3,4442,370341,3705,282845,737,87496,1076,14,1462,30,3,54,144444.0,43333.0,-72.0,-72.0,-69.0,-61.0,-70.0,-71.0,-68.0,-60.0,-88.0,-90.0,-86.0,-87.0,16.0,18.0,17.0,26.0,1
3065,BA:8C:B9:54:50:24,3854365,491666370,4952,6196328,3849413,485470042,7,9955,1765628,9933,1762133,22,3495,2361,18,5470,44,7,76,216660.0,130000.0,-48.0,-35.0,-43.0,-45.0,-44.0,-35.0,-44.0,-47.0,-88.0,-90.0,-86.0,-87.0,40.0,55.0,43.0,42.0,1
3066,62:47:05:9D:EB:15,3856360,497738258,6946,12268154,3849414,485470104,1,7347,3878005,7297,3870347,50,7658,3495,0,7023,56,1,126,229410.0,130000.0,-44.0,-46.0,-36.0,-48.0,-45.0,-47.0,-40.0,-47.0,-88.0,-90.0,-86.0,-87.0,44.0,44.0,50.0,39.0,1
3067,92:69:1D:31:68:E9,3853589,489174741,4175,3704637,3849414,485470104,1,5682,1226214,5505,1185951,177,40263,2315,12,4440,103,1,65,216660.0,130000.0,-52.0,-47.0,-42.0,-49.0,-51.0,-47.0,-43.0,-47.0,-88.0,-90.0,-86.0,-87.0,36.0,43.0,44.0,38.0,1
3068,CC:2F:71:3F:1F:24,5128405,1964388822,1278991,1478918718,3849414,485470104,2222,1077802,1236818188,1076938,1236713582,864,104606,1042752,15,1277126,122388,2219,825,144444.0,43333.0,-70.0,-68.0,-67.0,-74.0,-70.0,-68.0,-67.0,-73.0,-88.0,-90.0,-86.0,-87.0,18.0,22.0,19.0,13.0,1
3069,CC:2F:71:3E:C5:1F,3850431,485594511,1017,124407,3849414,485470104,3,4444,370529,3706,282915,738,87614,1077,14,1462,30,3,54,144444.0,43333.0,-72.0,-73.0,-68.0,-60.0,-70.0,-71.0,-68.0,-60.0,-88.0,-90.0,-86.0,-87.0,16.0,17.0,18.0,27.0,1
3070,BA:8C:B9:54:50:24,3854366,491666432,4952,6196328,3849414,485470104,7,9955,1765628,9933,1762133,22,3495,2361,18,5470,44,7,76,216660.0,130000.0,-48.0,-35.0,-43.0,-45.0,-44.0,-35.0,-44.0,-47.0,-88.0,-90.0,-86.0,-87.0,40.0,55.0,43.0,42.0,1
3071,62:47:05:9D:EB:15,3856364,497738662,6946,12268154,3849418,485470508,1,7347,3878005,7297,3870347,50,7658,3495,0,7023,56,1,126,229410.0,130000.0,-44.0,-46.0,-36.0,-48.0,-45.0,-47.0,-40.0,-47.0,-88.0,-90.0,-86.0,-87.0,44.0,44.0,50.0,39.0,1
3072,92:69:1D:31:68:E9,3853595,489175347,4175,3704637,3849420,485470710,1,5684,1226350,5507,1186087,177,40263,2315,12,4441,103,1,65,216660.0,130000.0,-53.0,-47.0,-42.0,-49.0,-51.0,-47.0,-43.0,-47.0,-88.0,-90.0,-86.0,-87.0,35.0,43.0,44.0,38.0,1
3073,CC:2F:71:3F:1F:24,5128606,1964634144,1279184,1479163232,3849422,485470912,2222,1077977,1237053906,1077113,1236949300,864,104606,1042922,15,1277319,122395,2219,825,144444.0,43333.0,-70.0,-68.0,-68.0,-75.0,-70.0,-68.0,-68.0,-74.0,-88.0,-90.0,-86.0,-87.0,18.0,22.0,18.0,12.0,1
3074,CC:2F:71:3E:C5:1F,3850439,485595319,1017,124407,3849422,485470912,3,4444,370529,3706,282915,738,87614,1077,14,1462,30,3,54,144444.0,43333.0,-72.0,-73.0,-68.0,-60.0,-70.0,-71.0,-68.0,-60.0,-88.0,-90.0,-86.0,-87.0,16.0,17.0,18.0,27.0,1
3075,BA:8C:B9:54:50:24,3854374,491667240,4952,6196328,3849422,485470912,7,9957,1765764,9935,1762269,22,3495,2361,18,5471,44,7,76,216660.0,130000.0,-39.0,-37.0,-45.0,-51.0,-43.0,-35.0,-44.0,-48.0,-88.0,-90.0,-86.0,-87.0,49.0,53.0,41.0,36.0,1
3076,62:47:05:9D:EB:15,3856369,497739126,6946,12268154,3849423,485470972,1,7347,3878005,7297,3870347,50,7658,3495,0,7023,56,1,126,229410.0,130000.0,-44.0,-46.0,-36.0,-48.0,-45.0,-47.0,-40.0,-47.0,-88.0,-90.0,-85.0,-87.0,44.0,44.0,49.0,39.0,1
3077,92:69:1D:31:68:E9,3853598,489175609,4175,3704637,3849423,485470972,1,5684,1226350,5507,1186087,177,40263,2315,12,4441,103,1,65,216660.0,130000.0,-53.0,-47.0,-42.0,-49.0,-51.0,-47.0,-43.0,-47.0,-88.0,-90.0,-85.0,-87.0,35.0,43.0,43.0,38.0,1
3078,CC:2F:71:3F:1F:24,5128803,1964878821,1279380,1479407849,3849423,485470972,2222,1078159,1237290927,1077295,1237186321,864,104606,1043097,15,1277515,122408,2219,826,144444.0,43333.0,-70.0,-69.0,-68.0,-74.0,-70.0,-68.0,-68.0,-74.0,-88.0,-90.0,-85.0,-87.0,18.0,21.0,17.0,13.0,1
3079,CC:2F:71:3E:C5:1F,3850440,485595379,1017,124407,3849423,485470972,3,4444,370529,3706,282915,738,87614,1077,14,1462,30,3,54,144444.0,43333.0,-72.0,-73.0,-68.0,-60.0,-70.0,-71.0,-68.0,-60.0,-88.0,-90.0,-85.0,-87.0,16.0,17.0,17.0,27.0,1
3080,BA:8C:B9:54:50:24,3854375,491667300,4952,6196328,3849423,485470972,7,9957,1765764,9935,1762269,22,3495,2361,18,5471,44,7,76,216660.0,130000.0,-39.0,-37.0,-45.0,-51.0,-43.0,-35.0,-44.0,-48.0,-88.0,-90.0,-85.0,-87.0,49.0,53.0,40.0,36.0,1
3081,62:47:05:9D:EB:15,3856375,497739732,6946,12268154,3849429,485471578,1,7347,3878005,7297,3870347,50,7658,3495,0,7023,56,1,126,229410.0,130000.0,-44.0,-46.0,-36.0,-48.0,-45.0,-47.0,-40.0,-47.0,-88.0,-89.0,-85.0,-86.0,44.0,43.0,49.0,38.0,1
3082,92:69:1D:31:68:E9,3853606,489176417,4175,3704637,3849431,485471780,1,5684,1226350,5507,1186087,177,40263,2315,12,4441,103,1,65,216660.0,130000.0,-53.0,-47.0,-42.0,-49.0,-51.0,-47.0,-43.0,-47.0,-88.0,-89.0,-85.0,-86.0,35.0,42.0,43.0,37.0,1
3083,CC:2F:71:3F:1F:24,5129005,1965127264,1279573,1479655211,3849432,485472053,2222,1078340,1237535935,1077476,1237431329,864,104606,1043270,15,1277708,122422,2219,826,144444.0,43333.0,-70.0,-69.0,-68.0,-75.0,-70.0,-68.0,-67.0,-74.0,-88.0,-89.0,-85.0,-86.0,18.0,20.0,17.0,11.0,1
3084,CC:2F:71:3E:C5:1F,3850449,485596460,1017,124407,3849432,485472053,3,4444,370529,3706,282915,738,87614,1077,14,1462,30,3,54,144444.0,43333.0,-72.0,-73.0,-68.0,-60.0,-70.0,-71.0,-68.0,-60.0,-88.0,-89.0,-85.0,-86.0,16.0,16.0,17.0,26.0,1
3085,BA:8C:B9:54:50:24,3854384,491668381,4952,6196328,3849432,485472053,7,9957,1765764,9935,1762269,22,3495,2361,18,5471,44,7,76,216660.0,130000.0,-39.0,-37.0,-45.0,-51.0,-43.0,-35.0,-44.0,-48.0,-88.0,-89.0,-85.0,-86.0,49.0,52.0,40.0,35.0,1
3086,62:47:05:9D:EB:15,3856378,497740207,6946,12268154,3849432,485472053,1,7347,3878005,7297,3870347,50,7658,3495,0,7023,56,1,126,229410.0,130000.0,-44.0,-46.0,-36.0,-48.0,-45.0,-47.0,-40.0,-47.0,-88.0,-89.0,-85.0,-86.0,44.0,43.0,49.0,38.0,1
3087,92:69:1D:31:68:E9,3853607,489176690,4175,3704637,3849432,485472053,1,5684,1226350,5507,1186087,177,40263,2315,12,4441,103,1,65,216660.0,130000.0,-53.0,-47.0,-42.0,-49.0,-51.0,-47.0,-43.0,-47.0,-88.0,-89.0,-85.0,-86.0,35.0,42.0,43.0,37.0,1
3088,CC:2F:71:3F:1F:24,5129201,1965377864,1279769,1479905811,3849432,485472053,2222,1078528,1237784741,1077664,1237680135,864,104606,1043449,15,1277904,122423,2219,826,144444.0,43333.0,-70.0,-68.0,-68.0,-73.0,-69.0,-68.0,-67.0,-72.0,-88.0,-89.0,-85.0,-86.0,18.0,21.0,17.0,13.0,1
3089,CC:2F:71:3E:C5:1F,3850450,485596520,1017,124407,3849433,485472113,3,4444,370529,3706,282915,738,87614,1077,14,1462,30,3,54,144444.0,43333.0,-72.0,-73.0,-68.0,-60.0,-70.0,-71.0,-68.0,-60.0,-88.0,-89.0,-85.0,-86.0,16.0,16.0,17.0,26.0,1
3090,BA:8C:B9:54:50:24,3854385,491668441,4952,6196328,3849433,485472113,7,9957,1765764,9935,1762269,22,3495,2361,18,5471,44,7,76,216660.0,130000.0,-39.0,-37.0,-45.0,-51.0,-43.0,-35.0,-44.0,-48.0,-88.0,-89.0,-85.0,-86.0,49.0,52.0,40.0,35.0,1
3091,62:47:05:9D:EB:15,3856387,497741075,6946,12268154,3849441,485472921,1,7347,3878005,7297,3870347,50,7658,3495,0,7023,56,1,126,229410.0,130000.0,-44.0,-46.0,-36.0,-48.0,-45.0,-47.0,-40.0,-47.0,-88.0,-89.0,-85.0,-86.0,44.0,43.0,49.0,38.0,1
3092,92:69:1D:31:68:E9,3853616,489177558,4175,3704637,3849441,485472921,1,5684,1226350,5507,1186087,177,40263,2315,12,4441,103,1,65,216660.0,130000.0,-53.0,-47.0,-42.0,-49.0,-51.0,-47.0,-43.0,-47.0,-88.0,-89.0,-85.0,-86.0,35.0,42.0,43.0,37.0,1
3093,CC:2F:71:3F:1F:24,5129401,1965622986,1279960,1480150065,3849441,485472921,2222,1078704,1238021957,1077840,1237917351,864,104606,1043617,15,1278095,122435,2219,826,144444.0,43333.0,-70.0,-68.0,-68.0,-73.0,-69.0,-67.0,-67.0,-72.0,-88.0,-89.0,-85.0,-86.0,18.0,21.0,17.0,13.0,1
3094,CC:2F:71:3E:C5:1F,3850458,485597328,1017,124407,3849441,485472921,3,4444,370529,3706,282915,738,87614,1077,14,1462,30,3,54,144444.0,43333.0,-72.0,-73.0,-68.0,-60.0,-70.0,-71.0,-68.0,-60.0,-88.0,-89.0,-85.0,-86.0,16.0,16.0,17.0,26.0,1
3095,BA:8C:B9:54:50:24,3854393,491669249,4952,6196328,3849441,485472921,7,9957,1765764,9935,1762269,22,3495,2361,18,5471,44,7,76,216660.0,130000.0,-39.0,-37.0,-45.0,-51.0,-43.0,-35.0,-44.0,-48.0,-88.0,-89.0,-85.0,-86.0,49.0,52.0,40.0,35.0,1
3096,62:47:05:9D:EB:15,3856387,497741075,6946,12268154,3849441,485472921,1,7347,3878005,7297,3870347,50,7658,3495,0,7023,56,1,126,229410.0,130000.0,-44.0,-46.0,-36.0,-48.0,-45.0,-47.0,-40.0,-47.0,-88.0,-89.0,-85.0,-86.0,44.0,43.0,49.0,38.0,1
3097,92:69:1D:31:68:E9,3853616,489177558,4175,3704637,3849441,485472921,1,5684,1226350,5507,1186087,177,40263,2315,12,4441,103,1,65,216660.0,130000.0,-53.0,-47.0,-42.0,-49.0,-51.0,-47.0,-43.0,-47.0,-88.0,-89.0,-85.0,-86.0,35.0,42.0,43.0,37.0,1
3098,CC:2F:71:3F:1F:24,5129599,1965867695,1280158,1480394774,3849441,485472921,2222,1078884,1238252938,1078020,1238148332,864,104606,1043794,15,1278293,122438,2219,826,144444.0,43333.0,-69.0,-68.0,-68.0,-72.0,-69.0,-68.0,-67.0,-72.0,-88.0,-89.0,-85.0,-86.0,19.0,21.0,17.0,14.0,1
3099,CC:2F:71:3E:C5:1F,3850458,485597328,1017,124407,3849441,485472921,3,4444,370529,3706,282915,738,87614,1077,14,1462,30,3,54,144444.0,43333.0,-72.0,-73.0,-68.0,-60.0,-70.0,-71.0,-68.0,-60.0,-88.0,-89.0,-85.0,-86.0,16.0,16.0,17.0,26.0,1
3100,BA:8C:B9:54:50:24,3854395,491669451,4952,6196328,3849443,485473123,7,9957,1765764,9935,1762269,22,3495,2361,18,5471,44,7,76,216660.0,130000.0,-39.0,-37.0,-45.0,-51.0,-43.0,-35.0,-44.0,-48.0,-88.0,-89.0,-85.0,-86.0,49.0,52.0,40.0,35.0,1
3101,62:47:05:9D:EB:15,3856396,497741943,6946,12268154,3849450,485473789,1,7347,3878005,7297,3870347,50,7658,3495,0,7023,56,1,126,229410.0,130000.0,-44.0,-46.0,-36.0,-48.0,-45.0,-47.0,-40.0,-47.0,-88.0,-89.0,-85.0,-86.0,44.0,43.0,49.0,38.0,1
3102,92:69:1D:31:68:E9,3853625,489178426,4175,3704637,3849450,485473789,1,5684,1226350,5507,1186087,177,40263,2315,12,4441,103,1,65,216660.0,130000.0,-53.0,-47.0,-42.0,-49.0,-51.0,-47.0,-43.0,-47.0,-88.0,-89.0,-85.0,-86.0,35.0,42.0,43.0,37.0,1
3103,CC:2F:71:3F:1F:24,5129797,1966109709,1280347,1480635920,3849450,485473789,2222,1079059,1238485662,1078195,1238381056,864,104606,1043965,15,1278480,122443,2219,826,144444.0,43333.0,-70.0,-69.0,-68.0,-73.0,-70.0,-68.0,-67.0,-73.0,-88.0,-89.0,-85.0,-86.0,18.0,20.0,17.0,13.0,1
3104,CC:2F:71:3E:C5:1F,3850467,485598196,1017,124407,3849450,485473789,3,4444,370529,3706,282915,738,87614,1077,14,1462,30,3,54,144444.0,43333.0,-72.0,-73.0,-68.0,-60.0,-70.0,-71.0,-68.0,-60.0,-88.0,-89.0,-85.0,-86.0,16.0,16.0,17.0,26.0,1
3105,BA:8C:B9:54:50:24,3854402,491670117,4952,6196328,3849450,485473789,7,9957,1765764,9935,1762269,22,3495,2361,18,5471,44,7,76,216660.0,130000.0,-39.0,-37.0,-45.0,-51.0,-43.0,-35.0,-44.0,-48.0,-88.0,-89.0,-85.0,-86.0,49.0,52.0,40.0,35.0,1
3106,62:47:05:9D:EB:15,3856396,497741943,6946,12268154,3849450,485473789,1,7347,3878005,7297,3870347,50,7658,3495,0,7023,56,1,126,229410.0,130000.0,-44.0,-46.0,-36.0,-48.0,-45.0,-47.0,-40.0,-47.0,-88.0,-89.0,-85.0,-86.0,44.0,43.0,49.0,38.0,1
3107,92:69:1D:31:68:E9,3853625,489178426,4175,3704637,3849450,485473789,1,5684,1226350,5507,1186087,177,40263,2315,12,4441,103,1,65,216660.0,130000.0,-53.0,-47.0,-42.0,-49.0,-51.0,-47.0,-43.0,-47.0,-88.0,-89.0,-85.0,-86.0,35.0,42.0,43.0,37.0,1
3108,CC:2F:71:3F:1F:24,5129988,1966351115,1280538,1480877326,3849450,485473789,2222,1079232,1238719592,1078368,1238614986,864,104606,1044135,15,1278673,122471,2219,826,144444.0,43333.0,-68.0,-69.0,-67.0,-73.0,-68.0,-69.0,-67.0,-73.0,-88.0,-89.0,-85.0,-86.0,20.0,20.0,18.0,13.0,1
3109,CC:2F:71:3E:C5:1F,3850469,485598398,1017,124407,3849452,485473991,3,4444,370529,3706,282915,738,87614,1077,14,1462,30,3,54,144444.0,43333.0,-72.0,-73.0,-68.0,-60.0,-70.0,-71.0,-68.0,-60.0,-88.0,-89.0,-85.0,-86.0,16.0,16.0,17.0,26.0,1
3110,BA:8C:B9:54:50:24,3854404,491670319,4952,6196328,3849452,485473991,7,9957,1765764,9935,1762269,22,3495,2361,18,5471,44,7,76,216660.0,130000.0,-39.0,-37.0,-45.0,-51.0,-43.0,-35.0,-44.0,-48.0,-88.0,-89.0,-85.0,-86.0,49.0,52.0,40.0,35.0,1
3111,62:47:05:9D:EB:15,3856424,497751380,6966,12276783,3849458,485474597,1,7374,3884391,7324,3876733,50,7658,3515,0,7043,56,1,126,229410.0,137640.0,-46.0,-49.0,-42.0,-46.0,-46.0,-49.0,-40.0,-47.0,-88.0,-89.0,-85.0,-86.0,42.0,40.0,43.0,40.0,1
3112,92:69:1D:31:68:E9,3853633,489179234,4175,3704637,3849458,485474597,1,5684,1226350,5507,1186087,177,40263,2315,12,4441,103,1,65,216660.0,130000.0,-53.0,-47.0,-42.0,-49.0,-51.0,-47.0,-43.0,-47.0,-88.0,-89.0,-85.0,-86.0,35.0,42.0,43.0,37.0,1
3113,CC:2F:71:3F:1F:24,5130187,1966596137,1280729,1481121540,3849458,485474597,2222,1079407,1238953836,1078543,1238849230,864,104606,1044306,15,1278864,122532,2219,826,130000.0,43333.0,-70.0,-70.0,-68.0,-73.0,-69.0,-70.0,-67.0,-73.0,-88.0,-89.0,-85.0,-86.0,18.0,19.0,17.0,13.0,1
3114,CC:2F:71:3E:C5:1F,3850476,485599064,1017,124407,3849459,485474657,3,4444,370529,3706,282915,738,87614,1077,14,1462,30,3,54,144444.0,43333.0,-72.0,-73.0,-68.0,-60.0,-70.0,-71.0,-68.0,-60.0,-88.0,-89.0,-85.0,-86.0,16.0,16.0,17.0,26.0,1
3115,BA:8C:B9:54:50:24,3854411,491670985,4952,6196328,3849459,485474657,7,9957,1765764,9935,1762269,22,3495,2361,18,5471,44,7,76,216660.0,130000.0,-39.0,-37.0,-45.0,-51.0,-43.0,-35.0,-44.0,-48.0,-88.0,-89.0,-85.0,-86.0,49.0,52.0,40.0,35.0,1
3116,62:47:05:9D:EB:15,3856425,497751440,6966,12276783,3849459,485474657,1,7375,3884459,7325,3876801,50,7658,3515,0,7043,56,1,126,229410.0,137640.0,-44.0,-46.0,-36.0,-46.0,-45.0,-48.0,-39.0,-46.0,-88.0,-89.0,-85.0,-86.0,44.0,43.0,49.0,40.0,1
3117,92:69:1D:31:68:E9,3853636,489179496,4175,3704637,3849461,485474859,1,5685,1226418,5508,1186155,177,40263,2315,12,4441,103,1,65,216660.0,130000.0,-52.0,-48.0,-44.0,-48.0,-51.0,-48.0,-43.0,-47.0,-88.0,-89.0,-85.0,-86.0,36.0,41.0,41.0,38.0,1
3118,CC:2F:71:3F:1F:24,5130388,1966841058,1280927,1481366199,3849461,485474859,2222,1079598,1239197737,1078734,1239093131,864,104606,1044485,15,1279062,122594,2219,826,115556.0,28889.0,-70.0,-70.0,-67.0,-73.0,-70.0,-70.0,-67.0,-73.0,-88.0,-89.0,-85.0,-86.0,18.0,19.0,18.0,13.0,1
3119,CC:2F:71:3E:C5:1F,3850478,485599266,1017,124407,3849461,485474859,3,4444,370529,3706,282915,738,87614,1077,14,1462,30,3,54,144444.0,43333.0,-72.0,-73.0,-68.0,-60.0,-70.0,-71.0,-68.0,-60.0,-88.0,-89.0,-85.0,-86.0,16.0,16.0,17.0,26.0,1
3120,BA:8C:B9:54:50:24,3854415,491671389,4952,6196328,3849463,485475061,7,9957,1765764,9935,1762269,22,3495,2361,18,5471,44,7,76,216660.0,130000.0,-39.0,-37.0,-45.0,-51.0,-43.0,-35.0,-44.0,-48.0,-88.0,-89.0,-85.0,-86.0,49.0,52.0,40.0,35.0,1
3121,62:47:05:9D:EB:15,3856433,497752248,6966,12276783,3849467,485475465,1,7375,3884459,7325,3876801,50,7658,3515,0,7043,56,1,126,229410.0,137640.0,-44.0,-46.0,-36.0,-46.0,-45.0,-48.0,-39.0,-46.0,-88.0,-89.0,-85.0,-86.0,44.0,43.0,49.0,40.0,1
3122,92:69:1D:31:68:E9,3853642,489180102,4175,3704637,3849467,485475465,1,5685,1226418,5508,1186155,177,40263,2315,12,4441,103,1,65,216660.0,130000.0,-52.0,-48.0,-44.0,-48.0,-51.0,-48.0,-43.0,-47.0,-88.0,-89.0,-85.0,-86.0,36.0,41.0,41.0,38.0,1
3123,CC:2F:71:3F:1F:24,5130586,1967086048,1281119,1481610583,3849467,485475465,2222,1079780,1239440125,1078916,1239335519,864,104606,1044657,15,1279254,122598,2219,826,115556.0,28889.0,-70.0,-69.0,-69.0,-71.0,-70.0,-69.0,-68.0,-71.0,-88.0,-89.0,-85.0,-86.0,18.0,20.0,16.0,15.0,1
3124,CC:2F:71:3E:C5:1F,3850484,485599872,1017,124407,3849467,485475465,3,4444,370529,3706,282915,738,87614,1077,14,1462,30,3,54,144444.0,43333.0,-72.0,-73.0,-68.0,-60.0,-70.0,-71.0,-68.0,-60.0,-88.0,-89.0,-85.0,-86.0,16.0,16.0,17.0,26.0,1
3125,BA:8C:B9:54:50:24,3854419,491671793,4952,6196328,3849467,485475465,7,9957,1765764,9935,1762269,22,3495,2361,18,5471,44,7,76,216660.0,130000.0,-39.0,-37.0,-45.0,-51.0,-43.0,-35.0,-44.0,-48.0,-88.0,-89.0,-85.0,-86.0,49.0,52.0,40.0,35.0,1
3126,62:47:05:9D:EB:15,3856436,497752510,6966,12276783,3849470,485475727,1,7375,3884459,7325,3876801,50,7658,3515,0,7043,56,1,126,229410.0,137640.0,-44.0,-46.0,-36.0,-46.0,-45.0,-48.0,-39.0,-46.0,-88.0,-89.0,-85.0,-86.0,44.0,43.0,49.0,40.0,1
3127,92:69:1D:31:68:E9,3853645,489180364,4175,3704637,3849470,485475727,1,5685,1226418,5508,1186155,177,40263,2315,12,4441,103,1,65,216660.0,130000.0,-52.0,-48.0,-44.0,-48.0,-51.0,-48.0,-43.0,-47.0,-88.0,-89.0,-85.0,-86.0,36.0,41.0,41.0,38.0,1
3128,CC:2F:71:3F:1F:24,5130778,1967327120,1281308,1481851393,3849470,485475727,2222,1079955,1239675725,1079091,1239571119,864,104606,1044826,15,1279443,122601,2219,826,144444.0,43333.0,-70.0,-70.0,-69.0,-73.0,-70.0,-70.0,-68.0,-72.0,-88.0,-89.0,-85.0,-86.0,18.0,19.0,16.0,13.0,1
3129,CC:2F:71:3E:C5:1F,3850489,485600336,1017,124407,3849472,485475929,3,4444,370529,3706,282915,738,87614,1077,14,1462,30,3,54,144444.0,43333.0,-72.0,-73.0,-68.0,-60.0,-70.0,-71.0,-68.0,-60.0,-88.0,-89.0,-85.0,-86.0,16.0,16.0,17.0,26.0,1
3130,BA:8C:B9:54:50:24,3854424,491672257,4952,6196328,3849472,485475929,7,9957,1765764,9935,1762269,22,3495,2361,18,5471,44,7,76,216660.0,130000.0,-39.0,-37.0,-45.0,-51.0,-43.0,-35.0,-44.0,-48.0,-88.0,-89.0,-85.0,-86.0,49.0,52.0,40.0,35.0,1
3131,62:47:05:9D:EB:15,3856444,497753358,6967,12276899,3849477,485476459,1,7377,3884595,7327,3876937,50,7658,3515,0,7044,56,1,126,229410.0,137640.0,-44.0,-45.0,-36.0,-48.0,-45.0,-47.0,-38.0,-46.0,-88.0,-89.0,-85.0,-86.0,44.0,44.0,49.0,38.0,1
3132,92:69:1D:31:68:E9,3853653,489181156,4176,3704697,3849477,485476459,1,5687,1226554,5510,1186291,177,40263,2315,12,4442,103,1,65,216660.0,130000.0,-51.0,-47.0,-42.0,-49.0,-51.0,-47.0,-43.0,-47.0,-88.0,-89.0,-85.0,-86.0,37.0,42.0,43.0,37.0,1
3133,CC:2F:71:3F:1F:24,5130989,1967576273,1281512,1482099814,3849477,485476459,2222,1080145,1239919328,1079281,1239814722,864,104606,1045008,15,1279647,122610,2219,826,130000.0,43333.0,-70.0,-69.0,-67.0,-73.0,-69.0,-68.0,-67.0,-72.0,-88.0,-89.0,-85.0,-86.0,18.0,20.0,18.0,13.0,1
3134,CC:2F:71:3E:C5:1F,3850495,485600982,1018,124523,3849477,485476459,3,4446,370669,3708,283055,738,87614,1077,14,1463,30,3,54,130000.0,39000.0,-71.0,-72.0,-68.0,-60.0,-71.0,-71.0,-68.0,-60.0,-88.0,-89.0,-85.0,-86.0,17.0,17.0,17.0,26.0,1
3135,BA:8C:B9:54:50:24,3854430,491672903,4953,6196444,3849477,485476459,7,9959,1765900,9937,1762405,22,3495,2361,18,5472,44,7,76,216660.0,130000.0,-48.0,-35.0,-43.0,-45.0,-43.0,-35.0,-44.0,-48.0,-88.0,-89.0,-85.0,-86.0,40.0,54.0,42.0,41.0,1
3136,62:47:05:9D:EB:15,3856446,497753560,6967,12276899,3849479,485476661,1,7377,3884595,7327,3876937,50,7658,3515,0,7044,56,1,126,229410.0,137640.0,-44.0,-45.0,-36.0,-48.0,-45.0,-47.0,-38.0,-46.0,-88.0,-89.0,-85.0,-86.0,44.0,44.0,49.0,38.0,1
3137,92:69:1D:31:68:E9,3853655,489181358,4176,3704697,3849479,485476661,1,5687,1226554,5510,1186291,177,40263,2315,12,4442,103,1,65,216660.0,130000.0,-51.0,-47.0,-42.0,-49.0,-51.0,-47.0,-43.0,-47.0,-88.0,-89.0,-85.0,-86.0,37.0,42.0,43.0,37.0,1
3138,CC:2F:71:3F:1F:24,5131182,1967817769,1281703,1482341108,3849479,485476661,2222,1080324,1240156844,1079460,1240052238,864,104606,1045179,15,1279838,122611,2219,826,144444.0,43333.0,-70.0,-70.0,-70.0,-74.0,-70.0,-70.0,-69.0,-74.0,-88.0,-89.0,-85.0,-86.0,18.0,19.0,15.0,12.0,1
3139,CC:2F:71:3E:C5:1F,3850500,485601446,1018,124523,3849482,485476923,3,4446,370669,3708,283055,738,87614,1077,14,1463,30,3,54,130000.0,39000.0,-71.0,-72.0,-68.0,-60.0,-71.0,-71.0,-68.0,-60.0,-88.0,-89.0,-85.0,-86.0,17.0,17.0,17.0,26.0,1
3140,BA:8C:B9:54:50:24,3854435,491673367,4953,6196444,3849482,485476923,7,9959,1765900,9937,1762405,22,3495,2361,18,5472,44,7,76,216660.0,130000.0,-48.0,-35.0,-43.0,-45.0,-43.0,-35.0,-44.0,-48.0,-88.0,-89.0,-85.0,-86.0,40.0,54.0,42.0,41.0,1
3141,62:47:05:9D:EB:15,3856453,497754226,6967,12276899,3849486,485477327,1,7377,3884595,7327,3876937,50,7658,3515,0,7044,56,1,126,229410.0,137640.0,-44.0,-45.0,-36.0,-48.0,-45.0,-47.0,-38.0,-46.0,-88.0,-89.0,-85.0,-86.0,44.0,44.0,49.0,38.0,1
3142,92:69:1D:31:68:E9,3853662,489182024,4176,3704697,3849486,485477327,1,5687,1226554,5510,1186291,177,40263,2315,12,4442,103,1,65,216660.0,130000.0,-51.0,-47.0,-42.0,-49.0,-51.0,-47.0,-43.0,-47.0,-88.0,-89.0,-85.0,-86.0,37.0,42.0,43.0,37.0,1
3143,CC:2F:71:3F:1F:24,5131382,1968062837,1281896,1482585510,3849486,485477327,2222,1080500,1240389718,1079636,1240285112,864,104606,1045352,15,1280031,122635,2219,826,130000.0,43333.0,-73.0,-70.0,-68.0,-73.0,-72.0,-70.0,-68.0,-72.0,-88.0,-89.0,-85.0,-86.0,15.0,19.0,17.0,13.0,1
3144,CC:2F:71:3E:C5:1F,3850504,485601850,1018,124523,3849486,485477327,3,4446,370669,3708,283055,738,87614,1077,14,1463,30,3,54,130000.0,39000.0,-71.0,-72.0,-68.0,-60.0,-71.0,-71.0,-68.0,-60.0,-88.0,-89.0,-85.0,-86.0,17.0,17.0,17.0,26.0,1
3145,BA:8C:B9:54:50:24,3854439,491673771,4953,6196444,3849486,485477327,7,9959,1765900,9937,1762405,22,3495,2361,18,5472,44,7,76,216660.0,130000.0,-48.0,-35.0,-43.0,-45.0,-43.0,-35.0,-44.0,-48.0,-88.0,-89.0,-85.0,-86.0,40.0,54.0,42.0,41.0,1
3146,62:47:05:9D:EB:15,3856456,497754701,6967,12276899,3849489,485477802,1,7377,3884595,7327,3876937,50,7658,3515,0,7044,56,1,126,229410.0,137640.0,-44.0,-45.0,-36.0,-48.0,-45.0,-47.0,-38.0,-46.0,-88.0,-89.0,-85.0,-86.0,44.0,44.0,49.0,38.0,1
3147,92:69:1D:31:68:E9,3853665,489182499,4176,3704697,3849489,485477802,1,5687,1226554,5510,1186291,177,40263,2315,12,4442,103,1,65,216660.0,130000.0,-51.0,-47.0,-42.0,-49.0,-51.0,-47.0,-43.0,-47.0,-88.0,-89.0,-85.0,-86.0,37.0,42.0,43.0,37.0,1
3148,CC:2F:71:3F:1F:24,5131578,1968304528,1282087,1482826524,3849491,485478004,2222,1080674,1240620888,1079810,1240516282,864,104606,1045523,15,1280222,122667,2219,826,130000.0,39000.0,-70.0,-70.0,-68.0,-73.0,-70.0,-70.0,-67.0,-73.0,-88.0,-89.0,-85.0,-86.0,18.0,19.0,17.0,13.0,1
3149,CC:2F:71:3E:C5:1F,3850509,485602527,1018,124523,3849491,485478004,3,4446,370669,3708,283055,738,87614,1077,14,1463,30,3,54,130000.0,39000.0,-71.0,-72.0,-68.0,-60.0,-71.0,-71.0,-68.0,-60.0,-88.0,-89.0,-85.0,-86.0,17.0,17.0,17.0,26.0,1
3150,BA:8C:B9:54:50:24,3854444,491674448,4953,6196444,3849491,485478004,7,9959,1765900,9937,1762405,22,3495,2361,18,5472,44,7,76,216660.0,130000.0,-48.0,-35.0,-43.0,-45.0,-43.0,-35.0,-44.0,-48.0,-88.0,-89.0,-85.0,-86.0,40.0,54.0,42.0,41.0,1
3151,62:47:05:9D:EB:15,3856463,497755367,6967,12276899,3849496,485478468,1,7377,3884595,7327,3876937,50,7658,3515,0,7044,56,1,126,229410.0,137640.0,-44.0,-45.0,-36.0,-48.0,-45.0,-47.0,-38.0,-46.0,-88.0,-89.0,-85.0,-86.0,44.0,44.0,49.0,38.0,1
3152,92:69:1D:31:68:E9,3853673,489183227,4176,3704697,3849497,485478530,1,5687,1226554,5510,1186291,177,40263,2315,12,4442,103,1,65,216660.0,130000.0,-51.0,-47.0,-42.0,-49.0,-51.0,-47.0,-43.0,-47.0,-88.0,-89.0,-85.0,-86.0,37.0,42.0,43.0,37.0,1
3153,CC:2F:71:3F:1F:24,5131784,1968552983,1282287,1483074453,3849497,485478530,2222,1080861,1240861285,1079996,1240756561,865,104724,1045703,15,1280422,122668,2219,826,130000.0,43333.0,-70.0,-69.0,-69.0,-72.0,-70.0,-69.0,-68.0,-71.0,-88.0,-89.0,-85.0,-86.0,18.0,20.0,16.0,14.0,1
3154,CC:2F:71:3E:C5:1F,3850515,485603053,1018,124523,3849497,485478530,3,4446,370669,3708,283055,738,87614,1077,14,1463,30,3,54,130000.0,39000.0,-71.0,-72.0,-68.0,-60.0,-71.0,-71.0,-68.0,-60.0,-88.0,-89.0,-85.0,-86.0,17.0,17.0,17.0,26.0,1
3155,BA:8C:B9:54:50:24,3854450,491674974,4953,6196444,3849497,485478530,7,9959,1765900,9937,1762405,22,3495,2361,18,5472,44,7,76,216660.0,130000.0,-48.0,-35.0,-43.0,-45.0,-43.0,-35.0,-44.0,-48.0,-88.0,-89.0,-85.0,-86.0,40.0,54.0,42.0,41.0,1
3156,62:47:05:9D:EB:15,3856466,497755631,6967,12276899,3849499,485478732,1,7379,3884731,7329,3877073,50,7658,3515,0,7044,56,1,126,229410.0,137640.0,-43.0,-46.0,-37.0,-46.0,-44.0,-47.0,-39.0,-46.0,-88.0,-89.0,-85.0,-86.0,45.0,43.0,48.0,40.0,1
3157,92:69:1D:31:68:E9,3853677,489183631,4176,3704697,3849501,485478934,1,5687,1226554,5510,1186291,177,40263,2315,12,4442,103,1,65,216660.0,130000.0,-51.0,-47.0,-42.0,-49.0,-51.0,-47.0,-43.0,-47.0,-88.0,-89.0,-85.0,-86.0,37.0,42.0,43.0,37.0,1
3158,CC:2F:71:3F:1F:24,5131978,1968794495,1282477,1483315561,3849501,485478934,2222,1081038,1241097117,1080173,1240992393,865,104724,1045874,15,1280612,122671,2219,826,144444.0,43333.0,-71.0,-70.0,-67.0,-72.0,-70.0,-69.0,-66.0,-71.0,-88.0,-89.0,-85.0,-86.0,17.0,19.0,18.0,14.0,1
3159,CC:2F:71:3E:C5:1F,3850521,485603825,1018,124523,3849503,485479302,3,4446,370669,3708,283055,738,87614,1077,14,1463,30,3,54,130000.0,39000.0,-71.0,-72.0,-68.0,-60.0,-71.0,-71.0,-68.0,-60.0,-88.0,-89.0,-85.0,-86.0,17.0,17.0,17.0,26.0,1
3160,BA:8C:B9:54:50:24,3854458,491675948,4953,6196444,3849505,485479504,7,9959,1765900,9937,1762405,22,3495,2361,18,5472,44,7,76,216660.0,130000.0,-48.0,-35.0,-43.0,-45.0,-43.0,-35.0,-44.0,-48.0,-88.0,-89.0,-85.0,-86.0,40.0,54.0,42.0,41.0,1
3161,62:47:05:9D:EB:15,3856475,497756667,6967,12276899,3849508,485479768,1,7379,3884731,7329,3877073,50,7658,3515,0,7044,56,1,126,229410.0,137640.0,-43.0,-46.0,-37.0,-46.0,-44.0,-47.0,-39.0,-46.0,-88.0,-89.0,-85.0,-86.0,45.0,43.0,48.0,40.0,1
3162,92:69:1D:31:68:E9,3853684,489184465,4176,3704697,3849508,485479768,1,5687,1226554,5510,1186291,177,40263,2315,12,4442,103,1,65,216660.0,130000.0,-51.0,-47.0,-42.0,-49.0,-51.0,-47.0,-43.0,-47.0,-88.0,-89.0,-85.0,-86.0,37.0,42.0,43.0,37.0,1
3163,CC:2F:71:3F:1F:24,5132175,1969036493,1282667,1483556725,3849508,485479768,2222,1081212,1241328301,1080347,1241223577,865,104724,1046044,15,1280802,122694,2219,826,117000.0,39000.0,-70.0,-69.0,-68.0,-74.0,-69.0,-69.0,-67.0,-74.0,-88.0,-89.0,-85.0,-86.0,18.0,20.0,17.0,12.0,1
3164,CC:2F:71:3E:C5:1F,3850527,485604351,1018,124523,3849509,485479828,3,4448,370857,3709,283125,739,87732,1078,14,1463,30,3,54,130000.0,39000.0,-71.0,-72.0,-69.0,-60.0,-71.0,-72.0,-68.0,-60.0,-88.0,-89.0,-85.0,-86.0,17.0,17.0,16.0,26.0,1
3165,BA:8C:B9:54:50:24,3854462,491676272,4953,6196444,3849509,485479828,7,9959,1765900,9937,1762405,22,3495,2361,18,5472,44,7,76,216660.0,130000.0,-48.0,-35.0,-43.0,-45.0,-43.0,-35.0,-44.0,-48.0,-88.0,-89.0,-85.0,-86.0,40.0,54.0,42.0,41.0,1
3166,62:47:05:9D:EB:15,3856480,497757131,6967,12276899,3849513,485480232,1,7379,3884731,7329,3877073,50,7658,3515,0,7044,56,1,126,229410.0,137640.0,-43.0,-46.0,-37.0,-46.0,-44.0,-47.0,-39.0,-46.0,-88.0,-89.0,-85.0,-86.0,45.0,43.0,48.0,40.0,1
3167,92:69:1D:31:68:E9,3853689,489184929,4176,3704697,3849513,485480232,1,5687,1226554,5510,1186291,177,40263,2315,12,4442,103,1,65,216660.0,130000.0,-51.0,-47.0,-42.0,-49.0,-51.0,-47.0,-43.0,-47.0,-88.0,-89.0,-85.0,-86.0,37.0,42.0,43.0,37.0,1
3168,CC:2F:71:3F:1F:24,5132376,1969281635,1282861,1483801201,3849515,485480434,2222,1081390,1241565715,1080525,1241460991,865,104724,1046218,15,1280996,122695,2219,827,130000.0,43333.0,-71.0,-70.0,-67.0,-72.0,-70.0,-70.0,-66.0,-72.0,-88.0,-89.0,-85.0,-86.0,17.0,19.0,18.0,14.0,1
3169,CC:2F:71:3E:C5:1F,3850535,485605159,1018,124523,3849517,485480636,3,4448,370857,3709,283125,739,87732,1078,14,1463,30,3,54,130000.0,39000.0,-71.0,-72.0,-69.0,-60.0,-71.0,-72.0,-68.0,-60.0,-88.0,-89.0,-85.0,-86.0,17.0,17.0,16.0,26.0,1
3170,BA:8C:B9:54:50:24,3854470,491677080,4953,6196444,3849517,485480636,7,9959,1765900,9937,1762405,22,3495,2361,18,5472,44,7,76,216660.0,130000.0,-48.0,-35.0,-43.0,-45.0,-43.0,-35.0,-44.0,-48.0,-88.0,-89.0,-85.0,-86.0,40.0,54.0,42.0,41.0,1
3171,62:47:05:9D:EB:15,3856484,497757535,6967,12276899,3849517,485480636,1,7379,3884731,7329,3877073,50,7658,3515,0,7044,56,1,126,229410.0,137640.0,-43.0,-46.0,-37.0,-46.0,-44.0,-47.0,-39.0,-46.0,-88.0,-89.0,-85.0,-86.0,45.0,43.0,48.0,40.0,1
3172,92:69:1D:31:68:E9,3853693,489185333,4176,3704697,3849517,485480636,1,5687,1226554,5510,1186291,177,40263,2315,12,4442,103,1,65,216660.0,130000.0,-51.0,-47.0,-42.0,-49.0,-51.0,-47.0,-43.0,-47.0,-88.0,-89.0,-85.0,-86.0,37.0,42.0,43.0,37.0,1
3173,CC:2F:71:3F:1F:24,5132578,1969529822,1283061,1484049186,3849517,485480636,2222,1081571,1241801126,1080706,1241696402,865,104724,1046395,15,1281196,122698,2219,828,130000.0,43333.0,-72.0,-70.0,-66.0,-72.0,-71.0,-69.0,-66.0,-72.0,-88.0,-89.0,-85.0,-86.0,16.0,19.0,19.0,14.0,1
3174,CC:2F:71:3E:C5:1F,3850535,485605159,1018,124523,3849517,485480636,3,4448,370857,3709,283125,739,87732,1078,14,1463,30,3,54,130000.0,39000.0,-71.0,-72.0,-69.0,-60.0,-71.0,-72.0,-68.0,-60.0,-88.0,-89.0,-85.0,-86.0,17.0,17.0,16.0,26.0,1
3175,BA:8C:B9:54:50:24,3854470,491677080,4953,6196444,3849517,485480636,7,9959,1765900,9937,1762405,22,3495,2361,18,5472,44,7,76,216660.0,130000.0,-48.0,-35.0,-43.0,-45.0,-43.0,-35.0,-44.0,-48.0,-88.0,-89.0,-85.0,-86.0,40.0,54.0,42.0,41.0,1
3176,62:47:05:9D:EB:15,3856489,497757999,6967,12276899,3849522,485481100,1,7379,3884731,7329,3877073,50,7658,3515,0,7044,56,1,126,229410.0,137640.0,-43.0,-46.0,-37.0,-46.0,-44.0,-47.0,-39.0,-46.0,-88.0,-89.0,-85.0,-86.0,45.0,43.0,48.0,40.0,1
3177,92:69:1D:31:68:E9,3853698,489185797,4176,3704697,3849522,485481100,1,5687,1226554,5510,1186291,177,40263,2315,12,4442,103,1,65,216660.0,130000.0,-51.0,-47.0,-42.0,-49.0,-51.0,-47.0,-43.0,-47.0,-88.0,-89.0,-85.0,-86.0,37.0,42.0,43.0,37.0,1
3178,CC:2F:71:3F:1F:24,5132775,1969771596,1283251,1484290294,3849524,485481302,2222,1081751,1242041730,1080886,1241937006,865,104724,1046565,15,1281386,122698,2219,828,144444.0,43333.0,-72.0,-69.0,-67.0,-73.0,-72.0,-69.0,-66.0,-72.0,-88.0,-89.0,-85.0,-86.0,16.0,20.0,18.0,13.0,1
3179,CC:2F:71:3E:C5:1F,3850544,485606027,1018,124523,3849526,485481504,3,4448,370857,3709,283125,739,87732,1078,14,1463,30,3,54,130000.0,39000.0,-71.0,-72.0,-69.0,-60.0,-71.0,-72.0,-68.0,-60.0,-88.0,-89.0,-85.0,-86.0,17.0,17.0,16.0,26.0,1
3180,BA:8C:B9:54:50:24,3854479,491677948,4953,6196444,3849526,485481504,7,9959,1765900,9937,1762405,22,3495,2361,18,5472,44,7,76,216660.0,130000.0,-48.0,-35.0,-43.0,-45.0,-43.0,-35.0,-44.0,-48.0,-88.0,-89.0,-85.0,-86.0,40.0,54.0,42.0,41.0,1
3181,62:47:05:9D:EB:15,3856493,497758403,6967,12276899,3849526,485481504,1,7379,3884731,7329,3877073,50,7658,3515,0,7044,56,1,126,229410.0,137640.0,-43.0,-46.0,-37.0,-46.0,-44.0,-47.0,-39.0,-46.0,-88.0,-89.0,-85.0,-86.0,45.0,43.0,48.0,40.0,1
3182,92:69:1D:31:68:E9,3853702,489186201,4176,3704697,3849526,485481504,1,5687,1226554,5510,1186291,177,40263,2315,12,4442,103,1,65,216660.0,130000.0,-51.0,-47.0,-42.0,-49.0,-51.0,-47.0,-43.0,-47.0,-88.0,-89.0,-85.0,-86.0,37.0,42.0,43.0,37.0,1
3183,CC:2F:71:3F:1F:24,5132970,1970016312,1283444,1484534808,3849526,485481504,2222,1081927,1242273212,1081062,1242168488,865,104724,1046738,15,1281579,122700,2219,828,144444.0,43333.0,-72.0,-69.0,-66.0,-73.0,-72.0,-69.0,-67.0,-73.0,-88.0,-89.0,-85.0,-86.0,16.0,20.0,19.0,13.0,1
3184,CC:2F:71:3E:C5:1F,3850546,485606229,1018,124523,3849528,485481706,3,4448,370857,3709,283125,739,87732,1078,14,1463,30,3,54,130000.0,39000.0,-71.0,-72.0,-69.0,-60.0,-71.0,-72.0,-68.0,-60.0,-88.0,-89.0,-85.0,-86.0,17.0,17.0,16.0,26.0,1
3185,BA:8C:B9:54:50:24,3854481,491678150,4953,6196444,3849528,485481706,7,9959,1765900,9937,1762405,22,3495,2361,18,5472,44,7,76,216660.0,130000.0,-48.0,-35.0,-43.0,-45.0,-43.0,-35.0,-44.0,-48.0,-88.0,-89.0,-85.0,-86.0,40.0,54.0,42.0,41.0,1
3186,62:47:05:9D:EB:15,3856497,497758807,6967,12276899,3849530,485481908,1,7380,3884799,7330,3877141,50,7658,3515,0,7044,56,1,126,229410.0,137640.0,-42.0,-45.0,-37.0,-45.0,-44.0,-46.0,-38.0,-46.0,-88.0,-89.0,-85.0,-86.0,46.0,44.0,48.0,41.0,1
3187,92:69:1D:31:68:E9,3853708,489186807,4176,3704697,3849532,485482110,1,5687,1226554,5510,1186291,177,40263,2315,12,4442,103,1,65,216660.0,130000.0,-51.0,-47.0,-42.0,-49.0,-51.0,-47.0,-43.0,-47.0,-88.0,-89.0,-85.0,-86.0,37.0,42.0,43.0,37.0,1
3188,CC:2F:71:3F:1F:24,5133169,1970258526,1283635,1484776214,3849534,485482312,2222,1082108,1242516740,1081243,1242412016,865,104724,1046909,15,1281770,122701,2219,828,144444.0,43333.0,-72.0,-69.0,-67.0,-73.0,-71.0,-68.0,-66.0,-73.0,-88.0,-89.0,-85.0,-86.0,16.0,20.0,18.0,13.0,1
3189,CC:2F:71:3E:C5:1F,3850553,485606895,1018,124523,3849535,485482372,3,4448,370857,3709,283125,739,87732,1078,14,1463,30,3,54,130000.0,39000.0,-71.0,-72.0,-69.0,-60.0,-71.0,-72.0,-68.0,-60.0,-88.0,-89.0,-85.0,-86.0,17.0,17.0,16.0,26.0,1
3190,BA:8C:B9:54:50:24,3854488,491678816,4953,6196444,3849535,485482372,7,9959,1765900,9937,1762405,22,3495,2361,18,5472,44,7,76,216660.0,130000.0,-48.0,-35.0,-43.0,-45.0,-43.0,-35.0,-44.0,-48.0,-88.0,-89.0,-85.0,-86.0,40.0,54.0,42.0,41.0,1
3191,62:47:05:9D:EB:15,3856502,497759271,6967,12276899,3849535,485482372,1,7380,3884799,7330,3877141,50,7658,3515,0,7044,56,1,126,229410.0,137640.0,-42.0,-45.0,-37.0,-45.0,-44.0,-46.0,-38.0,-46.0,-88.0,-89.0,-85.0,-86.0,46.0,44.0,48.0,41.0,1
3192,92:69:1D:31:68:E9,3853713,489187271,4176,3704697,3849537,485482574,1,5687,1226554,5510,1186291,177,40263,2315,12,4442,103,1,65,216660.0,130000.0,-51.0,-47.0,-42.0,-49.0,-51.0,-47.0,-43.0,-47.0,-88.0,-89.0,-85.0,-86.0,37.0,42.0,43.0,37.0,1
3193,CC:2F:71:3F:1F:24,5133375,1970510011,1283838,1485027437,3849537,485482574,2222,1082293,1242756812,1081428,1242652088,865,104724,1047090,15,1281973,122701,2219,828,144444.0,43333.0,-71.0,-69.0,-67.0,-73.0,-71.0,-69.0,-66.0,-73.0,-88.0,-89.0,-85.0,-86.0,17.0,20.0,18.0,13.0,1
3194,CC:2F:71:3E:C5:1F,3850555,485607097,1018,124523,3849537,485482574,3,4448,370857,3709,283125,739,87732,1078,14,1463,30,3,54,130000.0,39000.0,-71.0,-72.0,-69.0,-60.0,-71.0,-72.0,-68.0,-60.0,-88.0,-89.0,-85.0,-86.0,17.0,17.0,16.0,26.0,1
3195,BA:8C:B9:54:50:24,3854490,491679018,4953,6196444,3849537,485482574,7,9960,1765968,9938,1762473,22,3495,2361,18,5473,44,7,76,216660.0,130000.0,-39.0,-37.0,-45.0,-52.0,-43.0,-35.0,-44.0,-48.0,-88.0,-89.0,-85.0,-86.0,49.0,52.0,40.0,34.0,1
