sample,station,tx_total_pkts,tx_total_bytes,tx_ucast_pkts,tx_ucast_bytes,tx_mcast_bcast_pkts,tx_mcast_bcast_bytes,tx_failures,rx_data_pkts,rx_data_bytes,rx_ucast_pkts,rx_ucast_bytes,rx_mcast_bcast_pkts,rx_mcast_bcast_bytes,rx_decrypt_succeeds,tx_data_pkts_retried,tx_total_pkts_sent,tx_pkts_retries,tx_pkts_retry_exhausted,rx_total_pkts_retried,rate_last_tx_pkt_min,rate_last_tx_pkt_max,per_antenna_rssi_last_rx_data_frame_1,per_antenna_rssi_last_rx_data_frame_2,per_antenna_rssi_last_rx_data_frame_3,per_antenna_rssi_last_rx_data_frame_4,per_antenna_avg_rssi_rx_data_frames_1,per_antenna_avg_rssi_rx_data_frames_2,per_antenna_avg_rssi_rx_data_frames_3,per_antenna_avg_rssi_rx_data_frames_4,per_antenna_noise_floor_1,per_antenna_noise_floor_2,per_antenna_noise_floor_3,per_antenna_noise_floor_4,sinr_per_antenna_1,sinr_per_antenna_2,sinr_per_antenna_3,sinr_per_antenna_4,attack
1,92:69:1D:31:68:E9,3248196,451212093,21035,43604394,3227161,407607699,0,9715,3172257,9638,3159324,77,12933,6421,1,21079,1040,0,90,229410.0,137640.0,-50.0,-50.0,-46.0,-48.0,-49.0,-50.0,-46.0,-48.0,-81.0,-91.0,-83.0,-89.0,31.0,41.0,37.0,41.0,1
2,BA:8C:B9:54:50:24,3257913,474846503,30752,67238804,3227161,407607699,0,11693,3866706,11603,3851447,90,15259,7413,6,30781,5504,0,135,216660.0,130000.0,-47.0,-55.0,-52.0,-64.0,-54.0,-59.0,-57.0,-61.0,-81.0,-91.0,-83.0,-89.0,34.0,36.0,31.0,25.0,1
3,62:47:05:9D:EB:15,3230342,415210711,3181,7603012,3227161,407607699,0,741,141798,711,136173,30,5625,390,0,3212,1151,0,9,229410.0,130000.0,-45.0,-45.0,-45.0,-49.0,-44.0,-45.0,-44.0,-49.0,-81.0,-91.0,-83.0,-89.0,36.0,46.0,38.0,40.0,1
4,F8:59:71:5A:E0:3D,3457308,753162899,230143,345554796,3227165,407608103,3,228785,303291930,223885,302706544,4900,585386,205801,19,232894,5138,3,668,144444.0,43333.0,-67.0,-74.0,-66.0,-70.0,-66.0,-74.0,-65.0,-70.0,-81.0,-91.0,-83.0,-89.0,14.0,17.0,17.0,19.0,1
5,CC:2F:71:3E:C5:1F,3238685,409017283,11520,1409180,3227165,407608103,6,49126,4114698,40587,3102942,8539,1011756,12147,35,16510,188,6,848,144444.0,39000.0,-69.0,-71.0,-70.0,-60.0,-69.0,-72.0,-70.0,-61.0,-81.0,-91.0,-83.0,-89.0,12.0,20.0,13.0,29.0,1
6,CC:2F:71:3F:1F:24,11469922,13055486735,8242757,12647878632,3227165,407608103,94,1834453,1043503012,1825804,1042464024,8649,1038988,1773627,620,8247485,868467,94,6425,86667.0,14444.0,-68.0,-68.0,-76.0,-71.0,-68.0,-68.0,-75.0,-70.0,-81.0,-91.0,-83.0,-89.0,13.0,23.0,7.0,18.0,1
7,92:69:1D:31:68:E9,3248204,451212901,21035,43604394,3227169,407608507,0,9716,3172325,9639,3159392,77,12933,6421,1,21079,1040,0,90,229410.0,137640.0,-54.0,-51.0,-46.0,-50.0,-50.0,-50.0,-46.0,-48.0,-81.0,-91.0,-83.0,-89.0,27.0,40.0,37.0,39.0,1
8,BA:8C:B9:54:50:24,3257921,474847311,30752,67238804,3227169,407608507,0,11693,3866706,11603,3851447,90,15259,7413,6,30781,5504,0,135,216660.0,130000.0,-47.0,-55.0,-52.0,-64.0,-54.0,-59.0,-57.0,-61.0,-81.0,-91.0,-83.0,-89.0,34.0,36.0,31.0,25.0,1
9,62:47:05:9D:EB:15,3230350,415211519,3181,7603012,3227169,407608507,0,741,141798,711,136173,30,5625,390,0,3212,1151,0,9,229410.0,130000.0,-45.0,-45.0,-45.0,-49.0,-44.0,-45.0,-44.0,-49.0,-81.0,-91.0,-83.0,-89.0,36.0,46.0,38.0,40.0,1
10,F8:59:71:5A:E0:3D,3457401,753300115,230231,345691548,3227170,407608567,3,228874,303428990,223974,302843604,4900,585386,205890,19,232982,5139,3,668,144444.0,43333.0,-67.0,-75.0,-67.0,-70.0,-67.0,-74.0,-66.0,-70.0,-81.0,-91.0,-83.0,-89.0,14.0,16.0,16.0,19.0,1
11,CC:2F:71:3E:C5:1F,3238690,409017747,11520,1409180,3227170,407608567,6,49126,4114698,40587,3102942,8539,1011756,12147,35,16510,188,6,848,144444.0,39000.0,-69.0,-71.0,-70.0,-60.0,-69.0,-72.0,-70.0,-61.0,-81.0,-91.0,-83.0,-89.0,12.0,20.0,13.0,29.0,1
12,CC:2F:71:3F:1F:24,11471442,13057802478,8244272,12650193911,3227170,407608567,94,1834889,1043798079,1826240,1042759091,8649,1038988,1774063,620,8248989,868517,94,6425,86667.0,14444.0,-68.0,-68.0,-76.0,-71.0,-68.0,-68.0,-76.0,-70.0,-81.0,-91.0,-83.0,-89.0,13.0,23.0,7.0,18.0,1
13,92:69:1D:31:68:E9,3248209,451213365,21035,43604394,3227174,407608971,0,9716,3172325,9639,3159392,77,12933,6421,1,21079,1040,0,90,229410.0,137640.0,-54.0,-51.0,-46.0,-50.0,-50.0,-50.0,-46.0,-48.0,-81.0,-91.0,-83.0,-89.0,27.0,40.0,37.0,39.0,1
14,BA:8C:B9:54:50:24,3257926,474847775,30752,67238804,3227174,407608971,0,11694,3866774,11604,3851515,90,15259,7413,6,30781,5504,0,135,216660.0,130000.0,-51.0,-56.0,-55.0,-45.0,-54.0,-59.0,-57.0,-61.0,-81.0,-91.0,-83.0,-89.0,30.0,35.0,28.0,44.0,1
15,62:47:05:9D:EB:15,3230355,415211983,3181,7603012,3227174,407608971,0,741,141798,711,136173,30,5625,390,0,3212,1151,0,9,229410.0,130000.0,-45.0,-45.0,-45.0,-49.0,-44.0,-45.0,-44.0,-49.0,-81.0,-91.0,-83.0,-89.0,36.0,46.0,38.0,40.0,1
16,F8:59:71:5A:E0:3D,3457489,753430887,230315,345821916,3227174,407608971,3,228957,303556810,224057,302971424,4900,585386,205973,19,233066,5139,3,668,144444.0,43333.0,-66.0,-74.0,-66.0,-70.0,-66.0,-73.0,-66.0,-70.0,-81.0,-91.0,-83.0,-89.0,15.0,17.0,17.0,19.0,1
17,CC:2F:71:3E:C5:1F,3238696,409018353,11520,1409180,3227176,407609173,6,49126,4114698,40587,3102942,8539,1011756,12147,35,16510,188,6,848,144444.0,39000.0,-69.0,-71.0,-70.0,-60.0,-69.0,-72.0,-70.0,-61.0,-81.0,-91.0,-83.0,-89.0,12.0,20.0,13.0,29.0,1
18,CC:2F:71:3F:1F:24,11473588,13061102030,8246412,12653492857,3227176,407609173,94,1835478,1044117026,1826829,1043078038,8649,1038988,1774652,620,8251127,868699,94,6425,86667.0,14444.0,-68.0,-68.0,-76.0,-71.0,-68.0,-68.0,-75.0,-70.0,-81.0,-91.0,-83.0,-89.0,13.0,23.0,7.0,18.0,1
19,92:69:1D:31:68:E9,3248213,451213769,21035,43604394,3227178,407609375,0,9716,3172325,9639,3159392,77,12933,6421,1,21079,1040,0,90,229410.0,137640.0,-54.0,-51.0,-46.0,-50.0,-50.0,-50.0,-46.0,-48.0,-81.0,-92.0,-83.0,-90.0,27.0,41.0,37.0,40.0,1
20,BA:8C:B9:54:50:24,3257931,474848239,30752,67238804,3227179,407609435,0,11694,3866774,11604,3851515,90,15259,7413,6,30781,5504,0,135,216660.0,130000.0,-51.0,-56.0,-55.0,-45.0,-54.0,-59.0,-57.0,-61.0,-81.0,-92.0,-83.0,-90.0,30.0,36.0,28.0,45.0,1
21,62:47:05:9D:EB:15,3230362,415212649,3181,7603012,3227181,407609637,0,741,141798,711,136173,30,5625,390,0,3212,1151,0,9,229410.0,130000.0,-45.0,-45.0,-45.0,-49.0,-44.0,-45.0,-44.0,-49.0,-81.0,-92.0,-83.0,-90.0,36.0,47.0,38.0,41.0,1
22,F8:59:71:5A:E0:3D,3457609,753604249,230426,345994410,3227183,407609839,3,229068,303728072,224168,303142686,4900,585386,206084,19,233177,5140,3,668,144444.0,43333.0,-66.0,-74.0,-66.0,-70.0,-66.0,-74.0,-66.0,-70.0,-81.0,-92.0,-83.0,-90.0,15.0,18.0,17.0,20.0,1
23,CC:2F:71:3E:C5:1F,3238703,409019019,11520,1409180,3227183,407609839,6,49126,4114698,40587,3102942,8539,1011756,12147,35,16510,188,6,848,144444.0,39000.0,-69.0,-71.0,-70.0,-60.0,-69.0,-72.0,-70.0,-61.0,-81.0,-92.0,-83.0,-90.0,12.0,21.0,13.0,30.0,1
24,CC:2F:71:3F:1F:24,11475229,13063609883,8248046,12656000044,3227183,407609839,94,1836011,1044501339,1827362,1043462351,8649,1038988,1775185,620,8252779,869092,94,6425,86667.0,14444.0,-69.0,-68.0,-76.0,-71.0,-68.0,-68.0,-76.0,-70.0,-81.0,-92.0,-83.0,-90.0,12.0,24.0,7.0,19.0,1
25,92:69:1D:31:68:E9,3248220,451214435,21035,43604394,3227185,407610041,0,9716,3172325,9639,3159392,77,12933,6421,1,21079,1040,0,90,229410.0,137640.0,-54.0,-51.0,-46.0,-50.0,-50.0,-50.0,-46.0,-48.0,-81.0,-92.0,-83.0,-90.0,27.0,41.0,37.0,40.0,1
26,BA:8C:B9:54:50:24,3257939,474849047,30752,67238804,3227187,407610243,0,11694,3866774,11604,3851515,90,15259,7413,6,30781,5504,0,135,216660.0,130000.0,-51.0,-56.0,-55.0,-45.0,-54.0,-59.0,-57.0,-61.0,-81.0,-92.0,-83.0,-90.0,30.0,36.0,28.0,45.0,1
27,62:47:05:9D:EB:15,3230368,415213255,3181,7603012,3227187,407610243,0,741,141798,711,136173,30,5625,390,0,3212,1151,0,9,229410.0,130000.0,-45.0,-45.0,-45.0,-49.0,-44.0,-45.0,-44.0,-49.0,-81.0,-92.0,-83.0,-90.0,36.0,47.0,38.0,41.0,1
28,F8:59:71:5A:E0:3D,3457705,753747621,230518,346137378,3227187,407610243,3,229161,303871390,224261,303286004,4900,585386,206177,19,233269,5140,3,668,144444.0,43333.0,-66.0,-73.0,-67.0,-70.0,-66.0,-72.0,-66.0,-70.0,-81.0,-92.0,-83.0,-90.0,15.0,19.0,16.0,20.0,1
29,CC:2F:71:3E:C5:1F,3238707,409019423,11520,1409180,3227187,407610243,6,49126,4114698,40587,3102942,8539,1011756,12147,35,16510,188,6,848,144444.0,39000.0,-69.0,-71.0,-70.0,-60.0,-69.0,-72.0,-70.0,-61.0,-81.0,-92.0,-83.0,-90.0,12.0,21.0,13.0,30.0,1
30,CC:2F:71:3F:1F:24,11476311,13065238779,8249124,12657628536,3227187,407610243,94,1836394,1044801783,1827745,1043762795,8649,1038988,1775568,620,8253857,869112,94,6425,86667.0,14444.0,-68.0,-68.0,-77.0,-68.0,-67.0,-67.0,-76.0,-67.0,-81.0,-92.0,-83.0,-90.0,13.0,24.0,6.0,22.0,1
31,92:69:1D:31:68:E9,3248226,451215041,21035,43604394,3227191,407610647,0,9716,3172325,9639,3159392,77,12933,6421,1,21079,1040,0,90,229410.0,137640.0,-54.0,-51.0,-46.0,-50.0,-50.0,-50.0,-46.0,-48.0,-81.0,-92.0,-83.0,-90.0,27.0,41.0,37.0,40.0,1
32,BA:8C:B9:54:50:24,3257944,474849511,30752,67238804,3227192,407610707,0,11694,3866774,11604,3851515,90,15259,7413,6,30781,5504,0,135,216660.0,130000.0,-51.0,-56.0,-55.0,-45.0,-54.0,-59.0,-57.0,-61.0,-81.0,-92.0,-83.0,-90.0,30.0,36.0,28.0,45.0,1
33,62:47:05:9D:EB:15,3230375,415213921,3181,7603012,3227194,407610909,0,741,141798,711,136173,30,5625,390,0,3212,1151,0,9,229410.0,130000.0,-45.0,-45.0,-45.0,-49.0,-44.0,-45.0,-44.0,-49.0,-81.0,-92.0,-83.0,-90.0,36.0,47.0,38.0,41.0,1
34,F8:59:71:5A:E0:3D,3457805,753892809,230611,346281900,3227194,407610909,3,229253,304013098,224353,303427712,4900,585386,206269,19,233362,5140,3,668,144444.0,43333.0,-67.0,-73.0,-66.0,-70.0,-66.0,-72.0,-65.0,-69.0,-81.0,-92.0,-83.0,-90.0,14.0,19.0,17.0,20.0,1
35,CC:2F:71:3E:C5:1F,3238714,409020089,11520,1409180,3227194,407610909,6,49126,4114698,40587,3102942,8539,1011756,12147,35,16510,188,6,848,144444.0,39000.0,-69.0,-71.0,-70.0,-60.0,-69.0,-72.0,-70.0,-61.0,-81.0,-92.0,-83.0,-90.0,12.0,21.0,13.0,30.0,1
36,CC:2F:71:3F:1F:24,11477574,13067122818,8250380,12659511909,3227194,407610909,94,1836858,1045132755,1828209,1044093767,8649,1038988,1776029,620,8255113,869244,94,6425,86667.0,14444.0,-69.0,-67.0,-77.0,-68.0,-69.0,-67.0,-76.0,-68.0,-81.0,-92.0,-83.0,-90.0,12.0,25.0,6.0,22.0,1
37,92:69:1D:31:68:E9,3248232,451215778,21035,43604394,3227197,407611384,0,9717,3172393,9640,3159460,77,12933,6421,1,21079,1040,0,90,229410.0,137640.0,-51.0,-52.0,-52.0,-55.0,-50.0,-50.0,-46.0,-49.0,-81.0,-92.0,-83.0,-90.0,30.0,40.0,31.0,35.0,1
38,BA:8C:B9:54:50:24,3257951,474850390,30752,67238804,3227199,407611586,0,11694,3866774,11604,3851515,90,15259,7413,6,30781,5504,0,135,216660.0,130000.0,-51.0,-56.0,-55.0,-45.0,-54.0,-59.0,-57.0,-61.0,-81.0,-92.0,-83.0,-90.0,30.0,36.0,28.0,45.0,1
39,62:47:05:9D:EB:15,3230380,415214598,3181,7603012,3227199,407611586,0,741,141798,711,136173,30,5625,390,0,3212,1151,0,9,229410.0,130000.0,-45.0,-45.0,-45.0,-49.0,-44.0,-45.0,-44.0,-49.0,-81.0,-92.0,-83.0,-90.0,36.0,47.0,38.0,41.0,1
40,F8:59:71:5A:E0:3D,3457899,754031792,230700,346420206,3227199,407611586,3,229343,304151698,224443,303566312,4900,585386,206359,19,233451,5140,3,668,144444.0,43333.0,-67.0,-72.0,-68.0,-70.0,-67.0,-72.0,-67.0,-69.0,-81.0,-92.0,-83.0,-90.0,14.0,20.0,15.0,20.0,1
41,CC:2F:71:3E:C5:1F,3238719,409020766,11520,1409180,3227199,407611586,6,49126,4114698,40587,3102942,8539,1011756,12147,35,16510,188,6,848,144444.0,39000.0,-69.0,-71.0,-70.0,-60.0,-69.0,-72.0,-70.0,-61.0,-81.0,-92.0,-83.0,-90.0,12.0,21.0,13.0,30.0,1
42,CC:2F:71:3F:1F:24,11478460,13068438179,8251259,12660826391,3227201,407611788,94,1837188,1045428757,1828539,1044389769,8649,1038988,1776351,620,8255992,869246,94,6425,86667.0,14444.0,-68.0,-71.0,-74.0,-67.0,-68.0,-70.0,-73.0,-67.0,-81.0,-92.0,-83.0,-90.0,13.0,21.0,9.0,23.0,1
43,92:69:1D:31:68:E9,3248238,451216384,21035,43604394,3227203,407611990,0,9717,3172393,9640,3159460,77,12933,6421,1,21079,1040,0,90,229410.0,137640.0,-51.0,-52.0,-52.0,-55.0,-50.0,-50.0,-46.0,-49.0,-81.0,-92.0,-83.0,-90.0,30.0,40.0,31.0,35.0,1
44,BA:8C:B9:54:50:24,3257956,474850854,30752,67238804,3227204,407612050,0,11694,3866774,11604,3851515,90,15259,7413,6,30781,5504,0,135,216660.0,130000.0,-51.0,-56.0,-55.0,-45.0,-54.0,-59.0,-57.0,-61.0,-81.0,-92.0,-83.0,-90.0,30.0,36.0,28.0,45.0,1
45,62:47:05:9D:EB:15,3230387,415215264,3181,7603012,3227206,407612252,0,741,141798,711,136173,30,5625,390,0,3212,1151,0,9,229410.0,130000.0,-45.0,-45.0,-45.0,-49.0,-44.0,-45.0,-44.0,-49.0,-81.0,-92.0,-83.0,-90.0,36.0,47.0,38.0,41.0,1
46,F8:59:71:5A:E0:3D,3457995,754170764,230789,346558512,3227206,407612252,3,229431,304287260,224531,303701874,4900,585386,206447,19,233540,5142,3,668,144444.0,43333.0,-67.0,-73.0,-65.0,-70.0,-66.0,-73.0,-65.0,-70.0,-81.0,-92.0,-83.0,-90.0,14.0,19.0,18.0,20.0,1
47,CC:2F:71:3E:C5:1F,3238726,409021432,11520,1409180,3227206,407612252,6,49126,4114698,40587,3102942,8539,1011756,12147,35,16510,188,6,848,144444.0,39000.0,-69.0,-71.0,-70.0,-60.0,-69.0,-72.0,-70.0,-61.0,-81.0,-92.0,-83.0,-90.0,12.0,21.0,13.0,30.0,1
48,CC:2F:71:3F:1F:24,11479535,13070037058,8252329,12662424806,3227206,407612252,94,1837576,1045734353,1828927,1044695365,8649,1038988,1776738,620,8257062,869324,94,6425,86667.0,14444.0,-70.0,-65.0,-73.0,-68.0,-70.0,-65.0,-73.0,-68.0,-81.0,-92.0,-83.0,-90.0,11.0,27.0,10.0,22.0,1
49,92:69:1D:31:68:E9,3248250,451217776,21040,43605120,3227210,407612656,0,9731,3177105,9654,3164172,77,12933,6426,1,21084,1040,0,90,216660.0,130000.0,-53.0,-51.0,-45.0,-50.0,-50.0,-50.0,-45.0,-49.0,-81.0,-92.0,-83.0,-90.0,28.0,41.0,38.0,40.0,1
50,BA:8C:B9:54:50:24,3258022,474888582,30812,67275926,3227210,407612656,0,11767,3903200,11677,3887941,90,15259,7468,6,30841,5504,0,135,229410.0,137640.0,-58.0,-56.0,-52.0,-45.0,-53.0,-56.0,-54.0,-50.0,-81.0,-92.0,-83.0,-90.0,23.0,36.0,31.0,45.0,1
51,62:47:05:9D:EB:15,3230395,415216043,3181,7603012,3227214,407613031,0,750,142567,718,136649,32,5918,392,0,3212,1151,0,9,229410.0,130000.0,-53.0,-46.0,-43.0,-45.0,-48.0,-46.0,-43.0,-43.0,-81.0,-92.0,-83.0,-90.0,28.0,46.0,40.0,45.0,1
52,F8:59:71:5A:E0:3D,3458091,754306857,230877,346693826,3227214,407613031,3,229519,304421346,224619,303835960,4900,585386,206535,19,233628,5143,3,668,144444.0,43333.0,-67.0,-73.0,-66.0,-70.0,-67.0,-73.0,-66.0,-70.0,-81.0,-92.0,-83.0,-90.0,14.0,19.0,17.0,20.0,1
53,CC:2F:71:3E:C5:1F,3238734,409022211,11520,1409180,3227214,407613031,6,49126,4114698,40587,3102942,8539,1011756,12147,35,16510,188,6,848,144444.0,39000.0,-69.0,-71.0,-70.0,-60.0,-69.0,-72.0,-70.0,-61.0,-81.0,-92.0,-83.0,-90.0,12.0,21.0,13.0,30.0,1
54,CC:2F:71:3F:1F:24,11481153,13072484554,8253938,12664871461,3227215,407613093,94,1838061,1046038575,1829412,1044999587,8649,1038988,1777221,620,8258670,869357,94,6427,86667.0,14444.0,-69.0,-64.0,-71.0,-67.0,-69.0,-64.0,-70.0,-67.0,-81.0,-92.0,-83.0,-90.0,12.0,28.0,12.0,23.0,1
55,92:69:1D:31:68:E9,3248258,451218531,21041,43605236,3227217,407613295,0,9733,3177241,9656,3164308,77,12933,6426,1,21085,1040,0,90,216660.0,130000.0,-53.0,-51.0,-46.0,-50.0,-50.0,-50.0,-45.0,-49.0,-81.0,-92.0,-83.0,-90.0,28.0,41.0,37.0,40.0,1
56,BA:8C:B9:54:50:24,3258032,474889705,30813,67276042,3227219,407613663,0,11769,3903336,11679,3888077,90,15259,7468,6,30842,5504,0,135,229410.0,137640.0,-47.0,-53.0,-54.0,-59.0,-53.0,-55.0,-54.0,-50.0,-81.0,-92.0,-83.0,-90.0,34.0,39.0,29.0,31.0,1
57,62:47:05:9D:EB:15,3230403,415216962,3182,7603128,3227221,407613834,0,754,142996,720,136785,34,6211,394,0,3213,1151,0,9,229410.0,130000.0,-44.0,-46.0,-38.0,-40.0,-48.0,-45.0,-40.0,-43.0,-81.0,-92.0,-83.0,-90.0,37.0,46.0,45.0,50.0,1
58,F8:59:71:5A:E0:3D,3458190,754444846,230967,346830810,3227223,407614036,3,229608,304557098,224708,303971712,4900,585386,206624,19,233718,5143,3,668,144444.0,43333.0,-66.0,-75.0,-66.0,-71.0,-67.0,-75.0,-65.0,-71.0,-81.0,-92.0,-83.0,-90.0,15.0,17.0,17.0,19.0,1
59,CC:2F:71:3E:C5:1F,3238744,409023332,11521,1409296,3227223,407614036,6,49128,4114838,40589,3103082,8539,1011756,12147,35,16511,188,6,848,144444.0,39000.0,-70.0,-73.0,-70.0,-71.0,-70.0,-72.0,-70.0,-62.0,-81.0,-92.0,-83.0,-90.0,11.0,19.0,13.0,19.0,1
60,CC:2F:71:3F:1F:24,11482831,13075049503,8255608,12667435467,3227223,407614036,94,1838469,1046342143,1829820,1045303155,8649,1038988,1777627,620,8260341,869530,94,6427,115556.0,28889.0,-67.0,-65.0,-73.0,-67.0,-66.0,-65.0,-72.0,-67.0,-81.0,-92.0,-83.0,-90.0,14.0,27.0,10.0,23.0,1
61,92:69:1D:31:68:E9,3248271,451221110,21044,43606670,3227227,407614440,0,9743,3181749,9666,3168816,77,12933,6430,1,21088,1040,0,90,216660.0,130000.0,-53.0,-51.0,-46.0,-51.0,-50.0,-50.0,-46.0,-49.0,-81.0,-92.0,-83.0,-90.0,28.0,41.0,37.0,39.0,1
62,BA:8C:B9:54:50:24,3258040,474890482,30813,67276042,3227227,407614440,0,11769,3903336,11679,3888077,90,15259,7468,6,30842,5504,0,135,229410.0,137640.0,-47.0,-53.0,-54.0,-59.0,-53.0,-55.0,-54.0,-50.0,-81.0,-92.0,-83.0,-90.0,34.0,39.0,29.0,31.0,1
63,62:47:05:9D:EB:15,3230410,415217679,3182,7603128,3227228,407614551,0,769,144119,734,137737,35,6382,395,0,3213,1151,0,9,229410.0,130000.0,-47.0,-40.0,-44.0,-41.0,-46.0,-41.0,-40.0,-43.0,-81.0,-92.0,-83.0,-90.0,34.0,52.0,39.0,49.0,1
64,F8:59:71:5A:E0:3D,3458283,754582113,231055,346967562,3227228,407614551,3,229697,304694200,224797,304108814,4900,585386,206712,19,233806,5157,3,669,144444.0,43333.0,-66.0,-76.0,-65.0,-70.0,-66.0,-77.0,-66.0,-70.0,-81.0,-92.0,-83.0,-90.0,15.0,16.0,18.0,20.0,1
65,CC:2F:71:3E:C5:1F,3238749,409023847,11521,1409296,3227228,407614551,6,49128,4114838,40589,3103082,8539,1011756,12147,35,16511,188,6,848,144444.0,39000.0,-70.0,-73.0,-70.0,-71.0,-70.0,-72.0,-70.0,-62.0,-81.0,-92.0,-83.0,-90.0,11.0,19.0,13.0,19.0,1
66,CC:2F:71:3F:1F:24,11484303,13077283777,8257073,12669669024,3227230,407614753,94,1838882,1046633769,1830233,1045594781,8649,1038988,1778040,620,8261806,869992,94,6427,86667.0,14444.0,-67.0,-63.0,-71.0,-66.0,-67.0,-62.0,-71.0,-66.0,-81.0,-92.0,-83.0,-90.0,14.0,29.0,12.0,24.0,1
67,92:69:1D:31:68:E9,3248276,451221625,21044,43606670,3227232,407614955,0,9743,3181749,9666,3168816,77,12933,6430,1,21088,1040,0,90,216660.0,130000.0,-53.0,-51.0,-46.0,-51.0,-50.0,-50.0,-46.0,-49.0,-81.0,-92.0,-83.0,-90.0,28.0,41.0,37.0,39.0,1
68,BA:8C:B9:54:50:24,3258047,474891199,30813,67276042,3227234,407615157,0,11769,3903336,11679,3888077,90,15259,7468,6,30842,5504,0,135,229410.0,137640.0,-47.0,-53.0,-54.0,-59.0,-53.0,-55.0,-54.0,-50.0,-81.0,-92.0,-83.0,-90.0,34.0,39.0,29.0,31.0,1
69,62:47:05:9D:EB:15,3230416,415218285,3182,7603128,3227234,407615157,0,791,145615,756,139233,35,6382,395,0,3213,1151,0,9,229410.0,130000.0,-40.0,-45.0,-43.0,-40.0,-44.0,-45.0,-42.0,-44.0,-81.0,-92.0,-83.0,-90.0,41.0,47.0,40.0,50.0,1
70,F8:59:71:5A:E0:3D,3458374,754713315,231139,347098098,3227235,407615217,3,229782,304825100,224882,304239714,4900,585386,206797,19,233890,5176,3,669,144444.0,43333.0,-65.0,-75.0,-66.0,-69.0,-65.0,-72.0,-66.0,-70.0,-81.0,-92.0,-83.0,-90.0,16.0,17.0,17.0,21.0,1
71,CC:2F:71:3E:C5:1F,3238756,409024513,11521,1409296,3227235,407615217,6,49128,4114838,40589,3103082,8539,1011756,12147,35,16511,188,6,848,144444.0,39000.0,-70.0,-73.0,-70.0,-71.0,-70.0,-72.0,-70.0,-62.0,-81.0,-92.0,-83.0,-90.0,11.0,19.0,13.0,19.0,1
72,CC:2F:71:3F:1F:24,11485711,13079421146,8258473,12671805665,3227238,407615481,94,1839295,1046930727,1830646,1045891739,8649,1038988,1778453,620,8263205,870016,94,6428,86667.0,14444.0,-72.0,-65.0,-71.0,-67.0,-70.0,-64.0,-71.0,-66.0,-81.0,-92.0,-83.0,-90.0,9.0,27.0,12.0,23.0,1
73,92:69:1D:31:68:E9,3248285,451222415,21044,43606670,3227241,407615745,0,9743,3181749,9666,3168816,77,12933,6430,1,21088,1040,0,90,216660.0,130000.0,-53.0,-51.0,-46.0,-51.0,-50.0,-50.0,-46.0,-49.0,-81.0,-92.0,-83.0,-90.0,28.0,41.0,37.0,39.0,1
74,BA:8C:B9:54:50:24,3258054,474891787,30813,67276042,3227241,407615745,0,11769,3903336,11679,3888077,90,15259,7468,6,30842,5504,0,135,229410.0,137640.0,-47.0,-53.0,-54.0,-59.0,-53.0,-55.0,-54.0,-50.0,-81.0,-92.0,-83.0,-90.0,34.0,39.0,29.0,31.0,1
75,62:47:05:9D:EB:15,3230423,415218873,3182,7603128,3227241,407615745,0,805,146621,769,140117,36,6504,396,0,3213,1151,0,9,229410.0,130000.0,-44.0,-44.0,-39.0,-42.0,-41.0,-46.0,-48.0,-49.0,-81.0,-92.0,-83.0,-90.0,37.0,48.0,44.0,48.0,1
76,F8:59:71:5A:E0:3D,3458463,754842825,231222,347227080,3227241,407615745,3,229866,304954474,224966,304369088,4900,585386,206880,19,233973,5178,3,669,144444.0,43333.0,-66.0,-74.0,-65.0,-68.0,-66.0,-73.0,-64.0,-68.0,-81.0,-92.0,-83.0,-90.0,15.0,18.0,18.0,22.0,1
77,CC:2F:71:3E:C5:1F,3238762,409025041,11521,1409296,3227241,407615745,6,49130,4115026,40590,3103152,8540,1011874,12148,35,16511,188,6,848,144444.0,39000.0,-70.0,-70.0,-70.0,-60.0,-70.0,-72.0,-70.0,-62.0,-81.0,-92.0,-83.0,-90.0,11.0,22.0,13.0,30.0,1
78,CC:2F:71:3F:1F:24,11487090,13081518776,8259847,12673902829,3227243,407615947,94,1839686,1047217921,1831037,1046178933,8649,1038988,1778844,620,8264580,870325,94,6428,78000.0,13000.0,-71.0,-65.0,-71.0,-68.0,-71.0,-65.0,-72.0,-67.0,-81.0,-92.0,-83.0,-90.0,10.0,27.0,12.0,22.0,1
79,92:69:1D:31:68:E9,3248298,451226585,21051,43610234,3227247,407616351,0,9754,3184995,9677,3172062,77,12933,6436,1,21095,1040,0,90,216660.0,130000.0,-55.0,-51.0,-46.0,-51.0,-51.0,-50.0,-46.0,-50.0,-81.0,-92.0,-83.0,-90.0,26.0,41.0,37.0,39.0,1
80,BA:8C:B9:54:50:24,3258061,474892627,30814,67276276,3227247,407616351,0,11775,3906238,11685,3890979,90,15259,7471,6,30843,5504,0,135,229410.0,137640.0,-53.0,-57.0,-56.0,-51.0,-53.0,-55.0,-54.0,-49.0,-81.0,-92.0,-83.0,-90.0,28.0,35.0,27.0,39.0,1
81,62:47:05:9D:EB:15,3230429,415219479,3182,7603128,3227247,407616351,0,805,146621,769,140117,36,6504,396,0,3213,1151,0,9,229410.0,130000.0,-44.0,-44.0,-39.0,-42.0,-41.0,-46.0,-48.0,-49.0,-81.0,-92.0,-83.0,-90.0,37.0,48.0,44.0,48.0,1
82,F8:59:71:5A:E0:3D,3458561,754986287,231314,347369936,3227247,407616351,3,229958,305096224,225058,304510838,4900,585386,206971,19,234065,5181,3,669,144444.0,43333.0,-67.0,-73.0,-66.0,-69.0,-66.0,-73.0,-65.0,-69.0,-81.0,-92.0,-83.0,-90.0,14.0,19.0,17.0,21.0,1
83,CC:2F:71:3E:C5:1F,3238769,409025707,11521,1409296,3227248,407616411,6,49130,4115026,40590,3103152,8540,1011874,12148,35,16511,188,6,848,144444.0,39000.0,-70.0,-70.0,-70.0,-60.0,-70.0,-72.0,-70.0,-62.0,-81.0,-92.0,-83.0,-90.0,11.0,22.0,13.0,30.0,1
84,CC:2F:71:3F:1F:24,11488708,13083995298,8261460,12676378887,3227248,407616411,94,1840167,1047551317,1831518,1046512329,8649,1038988,1779324,620,8266193,870461,94,6430,86667.0,14444.0,-71.0,-64.0,-72.0,-69.0,-70.0,-63.0,-71.0,-68.0,-81.0,-92.0,-83.0,-90.0,10.0,28.0,11.0,21.0,1
85,92:69:1D:31:68:E9,3248304,451227111,21051,43610234,3227253,407616877,0,9754,3184995,9677,3172062,77,12933,6436,1,21095,1040,0,90,216660.0,130000.0,-55.0,-51.0,-46.0,-51.0,-51.0,-50.0,-46.0,-50.0,-81.0,-93.0,-83.0,-90.0,26.0,42.0,37.0,39.0,1
86,BA:8C:B9:54:50:24,3258394,475688455,31141,68071578,3227253,407616877,0,11830,3923567,11740,3908308,90,15259,7513,6,31170,5511,0,139,229410.0,137640.0,-53.0,-57.0,-51.0,-44.0,-53.0,-56.0,-54.0,-50.0,-81.0,-93.0,-83.0,-90.0,28.0,36.0,32.0,46.0,1
87,62:47:05:9D:EB:15,3230446,415225429,3182,7603128,3227264,407622301,0,805,146621,769,140117,36,6504,396,0,3213,1151,0,9,229410.0,130000.0,-44.0,-44.0,-39.0,-42.0,-41.0,-46.0,-48.0,-49.0,-81.0,-93.0,-83.0,-90.0,37.0,49.0,44.0,48.0,1
88,F8:59:71:5A:E0:3D,3458681,755149393,231415,347526890,3227266,407622503,3,230060,305253318,225160,304667932,4900,585386,207072,19,234166,5182,3,669,144444.0,43333.0,-68.0,-71.0,-64.0,-69.0,-66.0,-71.0,-64.0,-69.0,-81.0,-93.0,-83.0,-90.0,13.0,22.0,19.0,21.0,1
89,CC:2F:71:3E:C5:1F,3238798,409037223,11521,1409296,3227277,407627927,6,49130,4115026,40590,3103152,8540,1011874,12148,35,16511,188,6,848,144444.0,39000.0,-70.0,-70.0,-70.0,-60.0,-70.0,-72.0,-70.0,-62.0,-81.0,-93.0,-83.0,-90.0,11.0,23.0,13.0,30.0,1
90,CC:2F:71:3F:1F:24,11490374,13086504456,8263095,12678876327,3227279,407628129,94,1840680,1047924794,1832030,1046885688,8650,1039106,1779837,620,8267827,870549,94,6432,86667.0,14444.0,-71.0,-65.0,-73.0,-68.0,-71.0,-64.0,-72.0,-68.0,-81.0,-93.0,-83.0,-90.0,10.0,28.0,10.0,22.0,1
91,92:69:1D:31:68:E9,3248333,451238627,21051,43610234,3227282,407628393,0,9754,3184995,9677,3172062,77,12933,6436,1,21095,1040,0,90,216660.0,130000.0,-55.0,-51.0,-46.0,-51.0,-51.0,-50.0,-46.0,-50.0,-81.0,-93.0,-83.0,-90.0,26.0,42.0,37.0,39.0,1
92,BA:8C:B9:54:50:24,3258424,475700031,31141,68071578,3227283,407628453,0,11834,3923839,11744,3908580,90,15259,7513,6,31170,5511,0,139,229410.0,137640.0,-55.0,-55.0,-52.0,-45.0,-53.0,-55.0,-53.0,-49.0,-81.0,-93.0,-83.0,-90.0,26.0,38.0,31.0,45.0,1
93,62:47:05:9D:EB:15,3230465,415231581,3182,7603128,3227283,407628453,0,805,146621,769,140117,36,6504,396,0,3213,1151,0,9,229410.0,130000.0,-44.0,-44.0,-39.0,-42.0,-41.0,-46.0,-48.0,-49.0,-81.0,-93.0,-83.0,-90.0,37.0,49.0,44.0,48.0,1
94,F8:59:71:5A:E0:3D,3458798,755307837,231513,347679182,3227285,407628655,3,230159,305404426,225258,304818922,4901,585504,207171,19,234264,5182,3,669,144444.0,43333.0,-66.0,-72.0,-64.0,-69.0,-66.0,-72.0,-64.0,-69.0,-81.0,-93.0,-83.0,-90.0,15.0,21.0,19.0,21.0,1
95,CC:2F:71:3E:C5:1F,3238806,409037951,11521,1409296,3227285,407628655,6,49130,4115026,40590,3103152,8540,1011874,12148,35,16511,188,6,848,144444.0,39000.0,-70.0,-70.0,-70.0,-60.0,-70.0,-72.0,-70.0,-62.0,-81.0,-93.0,-83.0,-90.0,11.0,23.0,13.0,30.0,1
96,CC:2F:71:3F:1F:24,11491740,13088580038,8264455,12680951383,3227285,407628655,94,1841054,1048207338,1832404,1047168232,8650,1039106,1780211,620,8269188,870792,94,6433,104000.0,26000.0,-68.0,-64.0,-71.0,-68.0,-68.0,-63.0,-71.0,-68.0,-81.0,-93.0,-83.0,-90.0,13.0,29.0,12.0,22.0,1
97,92:69:1D:31:68:E9,3248342,451239628,21051,43610234,3227291,407629394,0,9754,3184995,9677,3172062,77,12933,6436,1,21095,1040,0,90,216660.0,130000.0,-55.0,-51.0,-46.0,-51.0,-51.0,-50.0,-46.0,-50.0,-81.0,-93.0,-83.0,-90.0,26.0,42.0,37.0,39.0,1
98,BA:8C:B9:54:50:24,3258452,475707033,31161,68077639,3227291,407629394,0,11876,3935583,11785,3920202,91,15381,7537,6,31190,5514,0,140,229410.0,137640.0,-52.0,-56.0,-55.0,-51.0,-52.0,-55.0,-54.0,-52.0,-81.0,-93.0,-83.0,-90.0,29.0,37.0,28.0,39.0,1
99,62:47:05:9D:EB:15,3230473,415232522,3182,7603128,3227291,407629394,0,805,146621,769,140117,36,6504,396,0,3213,1151,0,9,229410.0,130000.0,-44.0,-44.0,-39.0,-42.0,-41.0,-46.0,-48.0,-49.0,-81.0,-93.0,-83.0,-90.0,37.0,49.0,44.0,48.0,1
100,F8:59:71:5A:E0:3D,3458890,755440728,231598,347811272,3227292,407629456,3,230245,305536908,225344,304951404,4901,585504,207257,19,234349,5183,3,669,144444.0,43333.0,-67.0,-73.0,-65.0,-71.0,-66.0,-73.0,-65.0,-70.0,-81.0,-93.0,-83.0,-90.0,14.0,20.0,18.0,19.0,1
101,CC:2F:71:3E:C5:1F,3238813,409038752,11521,1409296,3227292,407629456,6,49130,4115026,40590,3103152,8540,1011874,12148,35,16511,188,6,848,144444.0,39000.0,-70.0,-70.0,-70.0,-60.0,-70.0,-72.0,-70.0,-62.0,-81.0,-93.0,-83.0,-90.0,11.0,23.0,13.0,30.0,1
102,CC:2F:71:3F:1F:24,11493131,13090687169,8265839,12683057713,3227292,407629456,94,1841483,1048507857,1832833,1047468751,8650,1039106,1780640,620,8270572,871068,94,6435,86667.0,14444.0,-70.0,-65.0,-72.0,-70.0,-70.0,-64.0,-72.0,-69.0,-81.0,-93.0,-83.0,-90.0,11.0,28.0,11.0,20.0,1
103,92:69:1D:31:68:E9,3248347,451240094,21051,43610234,3227296,407629860,0,9759,3185389,9681,3172334,78,13055,6437,1,21095,1040,0,90,216660.0,130000.0,-55.0,-51.0,-46.0,-51.0,-51.0,-50.0,-46.0,-50.0,-81.0,-93.0,-83.0,-90.0,26.0,42.0,37.0,39.0,1
104,BA:8C:B9:54:50:24,3258693,476275516,31397,68645656,3227296,407629860,0,11935,3952704,11844,3937323,91,15381,7572,6,31426,5514,0,140,229410.0,137640.0,-55.0,-56.0,-52.0,-45.0,-53.0,-56.0,-55.0,-50.0,-81.0,-93.0,-83.0,-90.0,26.0,37.0,31.0,45.0,1
105,62:47:05:9D:EB:15,3230479,415233048,3182,7603128,3227297,407629920,0,805,146621,769,140117,36,6504,396,0,3213,1151,0,9,229410.0,130000.0,-44.0,-44.0,-39.0,-42.0,-41.0,-46.0,-48.0,-49.0,-81.0,-93.0,-83.0,-90.0,37.0,49.0,44.0,48.0,1
106,F8:59:71:5A:E0:3D,3458990,755585033,231691,347954911,3227299,407630122,3,230337,305677198,225436,305091694,4901,585504,207349,19,234442,5183,3,669,144444.0,43333.0,-67.0,-74.0,-64.0,-70.0,-66.0,-73.0,-64.0,-69.0,-81.0,-93.0,-83.0,-90.0,14.0,19.0,19.0,20.0,1
107,CC:2F:71:3E:C5:1F,3238820,409039418,11521,1409296,3227299,407630122,6,49130,4115026,40590,3103152,8540,1011874,12148,35,16511,188,6,848,144444.0,39000.0,-70.0,-70.0,-70.0,-60.0,-70.0,-72.0,-70.0,-62.0,-81.0,-93.0,-83.0,-90.0,11.0,23.0,13.0,30.0,1
108,CC:2F:71:3F:1F:24,11494362,13092542024,8267061,12684911700,3227301,407630324,94,1841903,1048824080,1833253,1047784974,8650,1039106,1781060,620,8271792,871111,94,6436,86667.0,14444.0,-69.0,-64.0,-72.0,-68.0,-68.0,-63.0,-71.0,-68.0,-81.0,-93.0,-83.0,-90.0,12.0,29.0,11.0,22.0,1
109,92:69:1D:31:68:E9,3248387,451275976,21083,43645339,3227304,407630637,0,9799,3202785,9721,3189730,78,13055,6463,1,21127,1046,0,90,229410.0,137640.0,-53.0,-50.0,-45.0,-51.0,-50.0,-49.0,-45.0,-48.0,-81.0,-92.0,-83.0,-89.0,28.0,42.0,38.0,38.0,1
110,BA:8C:B9:54:50:24,3258952,476606862,31648,68976225,3227304,407630637,0,12066,3975237,11974,3959685,92,15552,7660,6,31677,5522,0,141,229410.0,137640.0,-55.0,-56.0,-53.0,-45.0,-51.0,-54.0,-52.0,-46.0,-81.0,-92.0,-83.0,-89.0,26.0,36.0,30.0,44.0,1
111,62:47:05:9D:EB:15,3230487,415233876,3182,7603128,3227305,407630748,0,805,146621,769,140117,36,6504,396,0,3213,1151,0,9,229410.0,130000.0,-44.0,-44.0,-39.0,-42.0,-41.0,-46.0,-48.0,-49.0,-81.0,-92.0,-83.0,-89.0,37.0,48.0,44.0,47.0,1
112,F8:59:71:5A:E0:3D,3459090,755728661,231783,348097711,3227307,407630950,3,230429,305818976,225528,305233472,4901,585504,207441,19,234534,5184,3,669,144444.0,43333.0,-68.0,-74.0,-66.0,-72.0,-67.0,-72.0,-66.0,-71.0,-81.0,-92.0,-83.0,-89.0,13.0,18.0,17.0,17.0,1
113,CC:2F:71:3E:C5:1F,3238828,409040246,11521,1409296,3227307,407630950,6,49130,4115026,40590,3103152,8540,1011874,12148,35,16511,188,6,848,144444.0,39000.0,-70.0,-70.0,-70.0,-60.0,-70.0,-72.0,-70.0,-62.0,-81.0,-92.0,-83.0,-89.0,11.0,22.0,13.0,29.0,1
114,CC:2F:71:3F:1F:24,11495506,13094260432,8268199,12686629482,3227307,407630950,94,1842319,1049140087,1833669,1048100981,8650,1039106,1781476,620,8272932,871336,94,6437,86667.0,14444.0,-71.0,-65.0,-72.0,-70.0,-70.0,-64.0,-72.0,-68.0,-81.0,-92.0,-83.0,-89.0,10.0,27.0,11.0,19.0,1
115,92:69:1D:31:68:E9,3248395,451276755,21083,43645339,3227312,407631416,0,9802,3203092,9723,3189866,79,13226,6464,1,21127,1046,0,90,229410.0,137640.0,-54.0,-51.0,-46.0,-52.0,-50.0,-49.0,-45.0,-49.0,-81.0,-92.0,-83.0,-89.0,27.0,41.0,37.0,37.0,1
116,BA:8C:B9:54:50:24,3258965,476608373,31653,68976957,3227312,407631416,0,12075,3976520,11983,3960968,92,15552,7665,6,31682,5522,0,142,229410.0,137640.0,-55.0,-56.0,-51.0,-45.0,-53.0,-56.0,-53.0,-47.0,-81.0,-92.0,-83.0,-89.0,26.0,36.0,32.0,44.0,1
117,62:47:05:9D:EB:15,3230495,415234604,3182,7603128,3227313,407631476,0,808,146879,771,140253,37,6626,397,0,3213,1151,0,9,229410.0,130000.0,-44.0,-38.0,-50.0,-42.0,-43.0,-43.0,-45.0,-45.0,-81.0,-92.0,-83.0,-89.0,37.0,54.0,33.0,47.0,1
118,F8:59:71:5A:E0:3D,3459186,755869047,231873,348237571,3227313,407631476,3,230515,305951458,225614,305365954,4901,585504,207526,19,234624,5186,3,669,144444.0,43333.0,-70.0,-74.0,-67.0,-71.0,-67.0,-73.0,-66.0,-70.0,-81.0,-92.0,-83.0,-89.0,11.0,18.0,16.0,18.0,1
119,CC:2F:71:3E:C5:1F,3238834,409040772,11521,1409296,3227313,407631476,6,49130,4115026,40590,3103152,8540,1011874,12148,35,16511,188,6,848,144444.0,39000.0,-70.0,-70.0,-70.0,-60.0,-70.0,-72.0,-70.0,-62.0,-81.0,-92.0,-83.0,-89.0,11.0,22.0,13.0,29.0,1
120,CC:2F:71:3F:1F:24,11496780,13096188818,8269466,12688557280,3227314,407631538,94,1842739,1049453733,1834089,1048414627,8650,1039106,1781895,620,8274199,871339,94,6438,86667.0,14444.0,-70.0,-64.0,-70.0,-67.0,-70.0,-64.0,-70.0,-66.0,-81.0,-92.0,-83.0,-89.0,11.0,28.0,13.0,22.0,1
121,92:69:1D:31:68:E9,3248401,451277281,21083,43645339,3227318,407631942,0,9802,3203092,9723,3189866,79,13226,6464,1,21127,1046,0,90,229410.0,137640.0,-54.0,-51.0,-46.0,-52.0,-50.0,-49.0,-45.0,-49.0,-81.0,-92.0,-83.0,-89.0,27.0,41.0,37.0,37.0,1
122,BA:8C:B9:54:50:24,3258977,476609987,31659,68978045,3227318,407631942,0,12100,3987323,12008,3971771,92,15552,7673,6,31688,5522,0,142,229410.0,137640.0,-54.0,-57.0,-52.0,-44.0,-56.0,-56.0,-52.0,-46.0,-81.0,-92.0,-83.0,-89.0,27.0,35.0,31.0,45.0,1
123,62:47:05:9D:EB:15,3230500,415235070,3182,7603128,3227318,407631942,0,811,147137,773,140389,38,6748,398,0,3213,1151,0,9,229410.0,130000.0,-48.0,-37.0,-41.0,-40.0,-45.0,-41.0,-43.0,-42.0,-81.0,-92.0,-83.0,-89.0,33.0,55.0,42.0,49.0,1
124,F8:59:71:5A:E0:3D,3459282,756010927,231964,348378985,3227318,407631942,3,230612,306101076,225711,305515572,4901,585504,207622,19,234715,5186,3,670,144444.0,43333.0,-69.0,-71.0,-68.0,-71.0,-67.0,-71.0,-66.0,-71.0,-81.0,-92.0,-83.0,-89.0,12.0,21.0,15.0,18.0,1
125,CC:2F:71:3E:C5:1F,3238839,409041238,11521,1409296,3227318,407631942,6,49130,4115026,40590,3103152,8540,1011874,12148,35,16511,188,6,848,144444.0,39000.0,-70.0,-70.0,-70.0,-60.0,-70.0,-72.0,-70.0,-62.0,-81.0,-92.0,-83.0,-89.0,11.0,22.0,13.0,29.0,1
126,CC:2F:71:3F:1F:24,11498103,13098198298,8270783,12690566154,3227320,407632144,94,1843116,1049741869,1834466,1048702763,8650,1039106,1782272,620,8275516,871456,94,6440,115556.0,28889.0,-73.0,-65.0,-69.0,-68.0,-72.0,-64.0,-68.0,-68.0,-81.0,-92.0,-83.0,-89.0,8.0,27.0,14.0,21.0,1
127,92:69:1D:31:68:E9,3248410,451278149,21083,43645339,3227327,407632810,0,9802,3203092,9723,3189866,79,13226,6464,1,21127,1046,0,90,229410.0,137640.0,-54.0,-51.0,-46.0,-52.0,-50.0,-49.0,-45.0,-49.0,-81.0,-92.0,-83.0,-90.0,27.0,41.0,37.0,38.0,1
128,BA:8C:B9:54:50:24,3258986,476610855,31659,68978045,3227327,407632810,0,12100,3987323,12008,3971771,92,15552,7673,6,31688,5522,0,142,229410.0,137640.0,-54.0,-57.0,-52.0,-44.0,-56.0,-56.0,-52.0,-46.0,-81.0,-92.0,-83.0,-90.0,27.0,35.0,31.0,46.0,1
129,62:47:05:9D:EB:15,3230509,415235938,3182,7603128,3227327,407632810,0,813,147273,775,140525,38,6748,398,0,3213,1151,0,9,229410.0,130000.0,-46.0,-49.0,-46.0,-46.0,-45.0,-41.0,-43.0,-42.0,-81.0,-92.0,-83.0,-90.0,35.0,43.0,37.0,44.0,1
130,F8:59:71:5A:E0:3D,3459443,756245127,232116,348612317,3227327,407632810,3,230764,306333030,225863,305747526,4901,585504,207774,19,234867,5193,3,672,144444.0,43333.0,-66.0,-75.0,-66.0,-71.0,-67.0,-73.0,-65.0,-71.0,-81.0,-92.0,-83.0,-90.0,15.0,17.0,17.0,19.0,1
131,CC:2F:71:3E:C5:1F,3238852,409042510,11521,1409296,3227331,407633214,6,49130,4115026,40590,3103152,8540,1011874,12148,35,16511,188,6,848,144444.0,39000.0,-70.0,-70.0,-70.0,-60.0,-70.0,-72.0,-70.0,-62.0,-81.0,-92.0,-83.0,-90.0,11.0,22.0,13.0,30.0,1
132,CC:2F:71:3F:1F:24,11500021,13101120795,8272690,12693487581,3227331,407633214,94,1843728,1050252137,1835078,1049213031,8650,1039106,1782882,620,8277381,871889,94,6440,115556.0,28889.0,-71.0,-66.0,-73.0,-70.0,-70.0,-66.0,-72.0,-69.0,-81.0,-92.0,-83.0,-90.0,10.0,26.0,10.0,20.0,1
133,92:69:1D:31:68:E9,3248416,451278755,21083,43645339,3227333,407633416,0,9802,3203092,9723,3189866,79,13226,6464,1,21127,1046,0,90,229410.0,137640.0,-54.0,-51.0,-46.0,-52.0,-50.0,-49.0,-45.0,-49.0,-81.0,-92.0,-83.0,-90.0,27.0,41.0,37.0,38.0,1
134,BA:8C:B9:54:50:24,3258992,476611461,31659,68978045,3227333,407633416,0,12100,3987323,12008,3971771,92,15552,7673,6,31688,5522,0,142,229410.0,137640.0,-54.0,-57.0,-52.0,-44.0,-56.0,-56.0,-52.0,-46.0,-81.0,-92.0,-83.0,-90.0,27.0,35.0,31.0,46.0,1
135,62:47:05:9D:EB:15,3230517,415236746,3182,7603128,3227335,407633618,0,814,147341,776,140593,38,6748,398,0,3213,1151,0,9,229410.0,130000.0,-46.0,-38.0,-42.0,-40.0,-45.0,-41.0,-44.0,-42.0,-81.0,-92.0,-83.0,-90.0,35.0,54.0,41.0,50.0,1
136,F8:59:71:5A:E0:3D,3459562,756416935,232226,348783257,3227336,407633678,3,230863,306485770,225962,305900266,4901,585504,207873,19,234977,5198,3,672,144444.0,43333.0,-66.0,-72.0,-64.0,-70.0,-66.0,-73.0,-64.0,-70.0,-81.0,-92.0,-83.0,-90.0,15.0,20.0,19.0,20.0,1
137,CC:2F:71:3E:C5:1F,3238857,409042974,11521,1409296,3227336,407633678,6,49130,4115026,40590,3103152,8540,1011874,12148,35,16511,188,6,848,144444.0,39000.0,-70.0,-70.0,-70.0,-60.0,-70.0,-72.0,-70.0,-62.0,-81.0,-92.0,-83.0,-90.0,11.0,22.0,13.0,30.0,1
138,CC:2F:71:3F:1F:24,11501457,13103274067,8274121,12695640389,3227336,407633678,94,1844204,1050636751,1835554,1049597645,8650,1039106,1783358,620,8278854,872305,94,6441,86667.0,14444.0,-69.0,-64.0,-70.0,-69.0,-68.0,-64.0,-69.0,-68.0,-81.0,-92.0,-83.0,-90.0,12.0,28.0,13.0,21.0,1
139,92:69:1D:31:68:E9,3248423,451279421,21083,43645339,3227340,407634082,0,9802,3203092,9723,3189866,79,13226,6464,1,21127,1046,0,90,229410.0,137640.0,-54.0,-51.0,-46.0,-52.0,-50.0,-49.0,-45.0,-49.0,-81.0,-92.0,-83.0,-89.0,27.0,41.0,37.0,37.0,1
140,BA:8C:B9:54:50:24,3258999,476612127,31659,68978045,3227340,407634082,0,12100,3987323,12008,3971771,92,15552,7673,6,31688,5522,0,142,229410.0,137640.0,-54.0,-57.0,-52.0,-44.0,-56.0,-56.0,-52.0,-46.0,-81.0,-92.0,-83.0,-89.0,27.0,35.0,31.0,45.0,1
141,62:47:05:9D:EB:15,3230522,415237210,3182,7603128,3227340,407634082,0,814,147341,776,140593,38,6748,398,0,3213,1151,0,9,229410.0,130000.0,-46.0,-38.0,-42.0,-40.0,-45.0,-41.0,-44.0,-42.0,-81.0,-92.0,-83.0,-89.0,35.0,54.0,41.0,49.0,1
142,F8:59:71:5A:E0:3D,3459659,756558955,232317,348924671,3227342,407634284,3,230966,306644418,226065,306058914,4901,585504,207976,19,235068,5199,3,673,144444.0,43333.0,-66.0,-74.0,-65.0,-70.0,-66.0,-73.0,-64.0,-69.0,-81.0,-92.0,-83.0,-89.0,15.0,18.0,18.0,19.0,1
143,CC:2F:71:3E:C5:1F,3238863,409043580,11521,1409296,3227342,407634284,6,49130,4115026,40590,3103152,8540,1011874,12148,35,16511,188,6,848,144444.0,39000.0,-70.0,-70.0,-70.0,-60.0,-70.0,-72.0,-70.0,-62.0,-81.0,-92.0,-83.0,-89.0,11.0,22.0,13.0,29.0,1
144,CC:2F:71:3F:1F:24,11502990,13105609677,8275646,12697975191,3227344,407634486,94,1844645,1050950039,1835995,1049910933,8650,1039106,1783799,620,8280379,872512,94,6443,86667.0,14444.0,-68.0,-65.0,-72.0,-68.0,-68.0,-65.0,-71.0,-67.0,-81.0,-92.0,-83.0,-89.0,13.0,27.0,11.0,21.0,1
145,92:69:1D:31:68:E9,3248427,451279825,21083,43645339,3227344,407634486,0,9802,3203092,9723,3189866,79,13226,6464,1,21127,1046,0,90,229410.0,137640.0,-54.0,-51.0,-46.0,-52.0,-50.0,-49.0,-45.0,-49.0,-81.0,-92.0,-83.0,-89.0,27.0,41.0,37.0,37.0,1
146,BA:8C:B9:54:50:24,3259003,476612531,31659,68978045,3227344,407634486,0,12100,3987323,12008,3971771,92,15552,7673,6,31688,5522,0,142,229410.0,137640.0,-54.0,-57.0,-52.0,-44.0,-56.0,-56.0,-52.0,-46.0,-81.0,-92.0,-83.0,-89.0,27.0,35.0,31.0,45.0,1
147,62:47:05:9D:EB:15,3230528,415237816,3182,7603128,3227346,407634688,0,814,147341,776,140593,38,6748,398,0,3213,1151,0,9,229410.0,130000.0,-46.0,-38.0,-42.0,-40.0,-45.0,-41.0,-44.0,-42.0,-81.0,-92.0,-83.0,-89.0,35.0,54.0,41.0,49.0,1
148,F8:59:71:5A:E0:3D,3459754,756699279,232407,349064531,3227347,407634748,3,231056,306783032,226155,306197528,4901,585504,208065,19,235158,5199,3,673,144444.0,43333.0,-66.0,-73.0,-65.0,-70.0,-66.0,-73.0,-65.0,-69.0,-81.0,-92.0,-83.0,-89.0,15.0,19.0,18.0,19.0,1
149,CC:2F:71:3E:C5:1F,3238870,409044246,11521,1409296,3227349,407634950,6,49130,4115026,40590,3103152,8540,1011874,12148,35,16511,188,6,848,144444.0,39000.0,-70.0,-70.0,-70.0,-60.0,-70.0,-72.0,-70.0,-62.0,-81.0,-92.0,-83.0,-89.0,11.0,22.0,13.0,29.0,1
150,CC:2F:71:3F:1F:24,11504205,13107448283,8276856,12699813333,3227349,407634950,94,1845021,1051244397,1836371,1050205291,8650,1039106,1784175,620,8281588,872544,94,6446,86667.0,14444.0,-69.0,-64.0,-73.0,-69.0,-69.0,-64.0,-72.0,-69.0,-81.0,-92.0,-83.0,-89.0,12.0,28.0,10.0,20.0,1
151,92:69:1D:31:68:E9,3248543,451360380,21189,43724851,3227354,407635529,0,9921,3256786,9841,3243325,80,13461,6554,1,21234,1046,0,91,229410.0,137640.0,-50.0,-50.0,-46.0,-48.0,-50.0,-50.0,-45.0,-47.0,-81.0,-92.0,-83.0,-89.0,31.0,42.0,37.0,41.0,1
152,BA:8C:B9:54:50:24,3259013,476613574,31659,68978045,3227354,407635529,0,12100,3987323,12008,3971771,92,15552,7673,6,31688,5522,0,142,229410.0,137640.0,-54.0,-57.0,-52.0,-44.0,-56.0,-56.0,-52.0,-46.0,-81.0,-92.0,-83.0,-89.0,27.0,35.0,31.0,45.0,1
153,62:47:05:9D:EB:15,3230537,415238930,3182,7603128,3227355,407635802,0,814,147341,776,140593,38,6748,398,0,3213,1151,0,9,229410.0,130000.0,-46.0,-38.0,-42.0,-40.0,-45.0,-41.0,-44.0,-42.0,-81.0,-92.0,-83.0,-89.0,35.0,54.0,41.0,49.0,1
154,F8:59:71:5A:E0:3D,3459845,756829315,232490,349193513,3227355,407635802,3,231139,306910852,226238,306325348,4901,585504,208148,19,235241,5199,3,673,144444.0,43333.0,-67.0,-73.0,-64.0,-70.0,-66.0,-73.0,-64.0,-70.0,-81.0,-92.0,-83.0,-89.0,14.0,19.0,19.0,19.0,1
155,CC:2F:71:3E:C5:1F,3238876,409045098,11521,1409296,3227355,407635802,6,49130,4115026,40590,3103152,8540,1011874,12148,35,16511,188,6,848,144444.0,39000.0,-70.0,-70.0,-70.0,-60.0,-70.0,-72.0,-70.0,-62.0,-81.0,-92.0,-83.0,-89.0,11.0,22.0,13.0,29.0,1
156,CC:2F:71:3F:1F:24,11505713,13109740267,8278358,12702104465,3227355,407635802,94,1845443,1051531525,1836793,1050492419,8650,1039106,1784597,620,8283073,872708,94,6447,86667.0,14444.0,-68.0,-63.0,-70.0,-67.0,-68.0,-63.0,-71.0,-67.0,-81.0,-92.0,-83.0,-89.0,13.0,29.0,13.0,22.0,1
157,92:69:1D:31:68:E9,3248548,451361057,21189,43724851,3227359,407636206,0,9931,3257622,9851,3244161,80,13461,6557,1,21234,1046,0,91,229410.0,137640.0,-54.0,-51.0,-45.0,-50.0,-51.0,-51.0,-47.0,-51.0,-81.0,-92.0,-83.0,-89.0,27.0,41.0,38.0,39.0,1
158,BA:8C:B9:54:50:24,3259296,477340075,31937,69703869,3227359,407636206,0,12141,3997451,12049,3981899,92,15552,7699,6,31966,5524,0,142,229410.0,130000.0,-54.0,-56.0,-54.0,-45.0,-51.0,-53.0,-53.0,-48.0,-81.0,-92.0,-83.0,-89.0,27.0,36.0,29.0,44.0,1
159,62:47:05:9D:EB:15,3230541,415239334,3182,7603128,3227359,407636206,0,814,147341,776,140593,38,6748,398,0,3213,1151,0,9,229410.0,130000.0,-46.0,-38.0,-42.0,-40.0,-45.0,-41.0,-44.0,-42.0,-81.0,-92.0,-83.0,-89.0,35.0,54.0,41.0,49.0,1
160,F8:59:71:5A:E0:3D,3459932,756958701,232573,349322495,3227359,407636206,3,231223,307040212,226322,306454708,4901,585504,208232,19,235324,5199,3,673,144444.0,43333.0,-67.0,-74.0,-66.0,-70.0,-67.0,-74.0,-65.0,-70.0,-81.0,-92.0,-83.0,-89.0,14.0,18.0,17.0,19.0,1
161,CC:2F:71:3E:C5:1F,3238880,409045502,11521,1409296,3227359,407636206,6,49130,4115026,40590,3103152,8540,1011874,12148,35,16511,188,6,848,144444.0,39000.0,-70.0,-70.0,-70.0,-60.0,-70.0,-72.0,-70.0,-62.0,-81.0,-92.0,-83.0,-89.0,11.0,22.0,13.0,29.0,1
162,CC:2F:71:3F:1F:24,11506870,13111481621,8279508,12703845153,3227362,407636468,94,1845831,1051830980,1837181,1050791874,8650,1039106,1784985,620,8284241,872748,94,6447,86667.0,14444.0,-68.0,-63.0,-73.0,-68.0,-68.0,-63.0,-72.0,-66.0,-81.0,-92.0,-83.0,-89.0,13.0,29.0,10.0,21.0,1
163,92:69:1D:31:68:E9,3248553,451361521,21189,43724851,3227364,407636670,0,9936,3258014,9856,3244553,80,13461,6558,1,21234,1046,0,92,229410.0,137640.0,-53.0,-51.0,-45.0,-51.0,-51.0,-50.0,-46.0,-50.0,-81.0,-92.0,-83.0,-89.0,28.0,41.0,38.0,38.0,1
164,BA:8C:B9:54:50:24,3259301,477340539,31937,69703869,3227364,407636670,0,12141,3997451,12049,3981899,92,15552,7699,6,31966,5524,0,142,229410.0,130000.0,-54.0,-56.0,-54.0,-45.0,-51.0,-53.0,-53.0,-48.0,-81.0,-92.0,-83.0,-89.0,27.0,36.0,29.0,44.0,1
165,62:47:05:9D:EB:15,3230546,415239798,3182,7603128,3227364,407636670,0,814,147341,776,140593,38,6748,398,0,3213,1151,0,9,229410.0,130000.0,-46.0,-38.0,-42.0,-40.0,-45.0,-41.0,-44.0,-42.0,-81.0,-92.0,-83.0,-89.0,35.0,54.0,41.0,49.0,1
166,F8:59:71:5A:E0:3D,3460027,757099025,232663,349462355,3227364,407636670,3,231312,307177272,226411,306591768,4901,585504,208321,19,235414,5199,3,673,144444.0,43333.0,-67.0,-74.0,-65.0,-70.0,-66.0,-73.0,-65.0,-69.0,-81.0,-92.0,-83.0,-89.0,14.0,18.0,18.0,19.0,1
167,CC:2F:71:3E:C5:1F,3238887,409046168,11521,1409296,3227366,407636872,6,49130,4115026,40590,3103152,8540,1011874,12148,35,16511,188,6,848,144444.0,39000.0,-70.0,-70.0,-70.0,-60.0,-70.0,-72.0,-70.0,-62.0,-81.0,-92.0,-83.0,-89.0,11.0,22.0,13.0,29.0,1
168,CC:2F:71:3F:1F:24,11508389,13113800079,8281023,12706163207,3227366,407636872,94,1846234,1052121876,1837584,1051082770,8650,1039106,1785388,620,8285746,872827,94,6447,130000.0,43333.0,-68.0,-65.0,-73.0,-70.0,-68.0,-64.0,-72.0,-70.0,-81.0,-92.0,-83.0,-89.0,13.0,27.0,10.0,19.0,1
169,92:69:1D:31:68:E9,3248856,452110788,21486,44473512,3227370,407637276,0,9992,3272385,9912,3258924,80,13461,6600,1,21531,1075,0,92,229410.0,137640.0,-68.0,-63.0,-72.0,-68.0,-55.0,-54.0,-53.0,-55.0,-81.0,-92.0,-82.0,-89.0,13.0,29.0,10.0,21.0,1
170,BA:8C:B9:54:50:24,3259308,477341261,31938,69703985,3227370,407637276,0,12143,3997587,12051,3982035,92,15552,7699,6,31967,5524,0,142,229410.0,130000.0,-52.0,-55.0,-56.0,-47.0,-50.0,-53.0,-52.0,-48.0,-81.0,-92.0,-82.0,-89.0,29.0,37.0,26.0,42.0,1
171,62:47:05:9D:EB:15,3230555,415240722,3183,7603244,3227372,407637478,0,816,147477,778,140729,38,6748,398,0,3214,1151,0,9,229410.0,130000.0,-46.0,-49.0,-47.0,-47.0,-45.0,-42.0,-44.0,-42.0,-81.0,-92.0,-82.0,-89.0,35.0,43.0,35.0,42.0,1
172,F8:59:71:5A:E0:3D,3460118,757227377,232746,349589899,3227372,407637478,3,231394,307303594,226493,306718090,4901,585504,208403,19,235496,5201,3,673,144444.0,43333.0,-66.0,-73.0,-64.0,-69.0,-66.0,-73.0,-64.0,-69.0,-81.0,-92.0,-82.0,-89.0,15.0,19.0,18.0,20.0,1
173,CC:2F:71:3E:C5:1F,3238894,409046890,11522,1409412,3227372,407637478,6,49132,4115166,40592,3103292,8540,1011874,12148,35,16512,188,6,848,144444.0,43333.0,-65.0,-63.0,-67.0,-60.0,-70.0,-73.0,-70.0,-64.0,-81.0,-92.0,-82.0,-89.0,16.0,29.0,15.0,29.0,1
174,CC:2F:71:3F:1F:24,11509879,13116069103,8282507,12708431625,3227372,407637478,94,1846628,1052420374,1837978,1051381268,8650,1039106,1785779,620,8287240,872879,94,6448,130000.0,43333.0,-67.0,-64.0,-71.0,-69.0,-67.0,-64.0,-71.0,-69.0,-81.0,-92.0,-82.0,-89.0,14.0,28.0,11.0,20.0,1
175,92:69:1D:31:68:E9,3248865,452112089,21490,44474349,3227375,407637740,0,10010,3282571,9930,3269110,80,13461,6608,1,21535,1075,0,92,229410.0,137640.0,-52.0,-53.0,-52.0,-54.0,-50.0,-50.0,-47.0,-50.0,-81.0,-92.0,-82.0,-89.0,29.0,39.0,30.0,35.0,1
176,BA:8C:B9:54:50:24,3259341,477375075,31964,69737133,3227377,407637942,0,12150,3998515,12058,3982963,92,15552,7703,6,31993,5524,0,142,229410.0,130000.0,-58.0,-53.0,-59.0,-62.0,-52.0,-54.0,-54.0,-55.0,-81.0,-92.0,-82.0,-89.0,23.0,39.0,23.0,27.0,1
177,62:47:05:9D:EB:15,3230560,415241186,3183,7603244,3227377,407637942,0,816,147477,778,140729,38,6748,398,0,3214,1151,0,9,229410.0,130000.0,-46.0,-49.0,-47.0,-47.0,-45.0,-42.0,-44.0,-42.0,-81.0,-92.0,-82.0,-89.0,35.0,43.0,35.0,42.0,1
178,F8:59:71:5A:E0:3D,3460216,757372363,232839,349734421,3227377,407637942,3,231488,307448410,226587,306862906,4901,585504,208496,19,235590,5201,3,673,144444.0,43333.0,-67.0,-74.0,-65.0,-70.0,-67.0,-74.0,-65.0,-70.0,-81.0,-92.0,-82.0,-89.0,14.0,18.0,17.0,19.0,1
179,CC:2F:71:3E:C5:1F,3238899,409047354,11522,1409412,3227377,407637942,6,49132,4115166,40592,3103292,8540,1011874,12148,35,16512,188,6,848,144444.0,43333.0,-65.0,-63.0,-67.0,-60.0,-70.0,-73.0,-70.0,-64.0,-81.0,-92.0,-82.0,-89.0,16.0,29.0,15.0,29.0,1
180,CC:2F:71:3F:1F:24,11510770,13117387381,8283393,12709749439,3227377,407637942,94,1846960,1052716469,1838310,1051677363,8650,1039106,1786109,620,8288126,873093,94,6448,86667.0,14444.0,-68.0,-65.0,-72.0,-71.0,-67.0,-64.0,-71.0,-71.0,-81.0,-92.0,-82.0,-89.0,13.0,27.0,10.0,18.0,1
181,92:69:1D:31:68:E9,3248871,452112695,21490,44474349,3227381,407638346,0,10010,3282571,9930,3269110,80,13461,6608,1,21535,1075,0,92,229410.0,137640.0,-52.0,-53.0,-52.0,-54.0,-50.0,-50.0,-47.0,-50.0,-81.0,-92.0,-82.0,-89.0,29.0,39.0,30.0,35.0,1
182,BA:8C:B9:54:50:24,3259345,477375479,31964,69737133,3227381,407638346,0,12150,3998515,12058,3982963,92,15552,7703,6,31993,5524,0,142,229410.0,130000.0,-58.0,-53.0,-59.0,-62.0,-52.0,-54.0,-54.0,-55.0,-81.0,-92.0,-82.0,-89.0,23.0,39.0,23.0,27.0,1
183,62:47:05:9D:EB:15,3230564,415241590,3183,7603244,3227381,407638346,0,816,147477,778,140729,38,6748,398,0,3214,1151,0,9,229410.0,130000.0,-46.0,-49.0,-47.0,-47.0,-45.0,-42.0,-44.0,-42.0,-81.0,-92.0,-82.0,-89.0,35.0,43.0,35.0,42.0,1
184,F8:59:71:5A:E0:3D,3460303,757501749,232922,349863403,3227381,407638346,3,231573,307579324,226672,306993820,4901,585504,208580,19,235673,5201,3,673,144444.0,43333.0,-68.0,-73.0,-65.0,-69.0,-68.0,-73.0,-65.0,-68.0,-81.0,-92.0,-82.0,-89.0,13.0,19.0,17.0,20.0,1
185,CC:2F:71:3E:C5:1F,3238903,409047758,11522,1409412,3227381,407638346,6,49132,4115166,40592,3103292,8540,1011874,12148,35,16512,188,6,848,144444.0,43333.0,-65.0,-63.0,-67.0,-60.0,-70.0,-73.0,-70.0,-64.0,-81.0,-92.0,-82.0,-89.0,16.0,29.0,15.0,29.0,1
186,CC:2F:71:3F:1F:24,11512285,13119700783,8284904,12712062437,3227381,407638346,94,1847389,1053003641,1838739,1051964535,8650,1039106,1786528,620,8289637,873175,94,6448,130000.0,39000.0,-70.0,-64.0,-72.0,-69.0,-69.0,-64.0,-71.0,-69.0,-81.0,-92.0,-82.0,-89.0,11.0,28.0,10.0,20.0,1
187,92:69:1D:31:68:E9,3248877,452113275,21491,44474465,3227386,407638810,0,10017,3283085,9937,3269624,80,13461,6609,1,21536,1075,0,92,229410.0,137640.0,-51.0,-52.0,-51.0,-55.0,-52.0,-51.0,-48.0,-52.0,-81.0,-92.0,-82.0,-89.0,30.0,40.0,31.0,34.0,1
188,BA:8C:B9:54:50:24,3259350,477375943,31964,69737133,3227386,407638810,0,12151,3998583,12059,3983031,92,15552,7703,6,31993,5524,0,142,229410.0,130000.0,-57.0,-57.0,-57.0,-47.0,-53.0,-55.0,-55.0,-53.0,-81.0,-92.0,-82.0,-89.0,24.0,35.0,25.0,42.0,1
189,62:47:05:9D:EB:15,3230571,415242256,3183,7603244,3227388,407639012,0,816,147477,778,140729,38,6748,398,0,3214,1151,0,9,229410.0,130000.0,-46.0,-49.0,-47.0,-47.0,-45.0,-42.0,-44.0,-42.0,-81.0,-92.0,-82.0,-89.0,35.0,43.0,35.0,42.0,1
190,F8:59:71:5A:E0:3D,3460397,757637613,233009,349998601,3227388,407639012,3,231660,307713388,226759,307127884,4901,585504,208667,19,235760,5201,3,673,144444.0,43333.0,-68.0,-72.0,-65.0,-69.0,-67.0,-72.0,-65.0,-69.0,-81.0,-92.0,-82.0,-89.0,13.0,20.0,17.0,20.0,1
191,CC:2F:71:3E:C5:1F,3238917,409049413,11527,1410199,3227390,407639214,6,49139,4116123,40599,3104249,8540,1011874,12154,35,16517,188,6,849,144444.0,43333.0,-68.0,-70.0,-69.0,-66.0,-69.0,-71.0,-68.0,-61.0,-81.0,-92.0,-82.0,-89.0,13.0,22.0,13.0,23.0,1
192,CC:2F:71:3F:1F:24,11513699,13121842704,8286309,12714203490,3227390,407639214,94,1847736,1053302540,1839086,1052263434,8650,1039106,1786867,620,8291002,873229,94,6449,130000.0,43333.0,-69.0,-65.0,-71.0,-70.0,-69.0,-64.0,-71.0,-69.0,-81.0,-92.0,-82.0,-89.0,12.0,27.0,11.0,19.0,1
193,92:69:1D:31:68:E9,3248887,452117018,21497,44477804,3227390,407639214,0,10024,3286021,9944,3272560,80,13461,6614,1,21542,1075,0,92,229410.0,137640.0,-49.0,-49.0,-46.0,-49.0,-50.0,-50.0,-48.0,-52.0,-81.0,-92.0,-82.0,-89.0,32.0,43.0,36.0,40.0,1
194,BA:8C:B9:54:50:24,3259354,477376347,31964,69737133,3227390,407639214,0,12151,3998583,12059,3983031,92,15552,7703,6,31993,5524,0,142,229410.0,130000.0,-57.0,-57.0,-57.0,-47.0,-53.0,-55.0,-55.0,-53.0,-81.0,-92.0,-82.0,-89.0,24.0,35.0,25.0,42.0,1
195,62:47:05:9D:EB:15,3230579,415242986,3183,7603244,3227396,407639742,0,816,147477,778,140729,38,6748,398,0,3214,1151,0,9,229410.0,130000.0,-46.0,-49.0,-47.0,-47.0,-45.0,-42.0,-44.0,-42.0,-81.0,-92.0,-82.0,-89.0,35.0,43.0,35.0,42.0,1
196,F8:59:71:5A:E0:3D,3460517,757812391,233121,350172649,3227396,407639742,3,231769,307879924,226867,307294302,4902,585622,208776,19,235872,5202,3,675,144444.0,43333.0,-67.0,-72.0,-65.0,-70.0,-67.0,-72.0,-65.0,-69.0,-81.0,-92.0,-82.0,-89.0,14.0,20.0,17.0,19.0,1
197,CC:2F:71:3E:C5:1F,3238923,409049941,11527,1410199,3227396,407639742,6,49139,4116123,40599,3104249,8540,1011874,12154,35,16517,188,6,849,144444.0,43333.0,-68.0,-70.0,-69.0,-66.0,-69.0,-71.0,-68.0,-61.0,-81.0,-92.0,-82.0,-89.0,13.0,22.0,13.0,23.0,1
198,CC:2F:71:3F:1F:24,11515615,13124774520,8288218,12717134718,3227397,407639802,94,1848199,1053683182,1839549,1052644076,8650,1039106,1787317,620,8292928,873706,94,6449,115556.0,28889.0,-69.0,-65.0,-71.0,-70.0,-68.0,-64.0,-70.0,-69.0,-81.0,-92.0,-82.0,-89.0,12.0,27.0,11.0,19.0,1
199,92:69:1D:31:68:E9,3248913,452126146,21512,44485940,3227401,407640206,0,10043,3291319,9963,3277858,80,13461,6624,1,21557,1075,0,92,216660.0,130000.0,-53.0,-51.0,-46.0,-50.0,-49.0,-49.0,-45.0,-49.0,-81.0,-92.0,-82.0,-89.0,28.0,41.0,36.0,39.0,1
200,BA:8C:B9:54:50:24,3259365,477377339,31964,69737133,3227401,407640206,0,12154,3998841,12061,3983167,93,15674,7704,6,31993,5524,0,143,229410.0,130000.0,-57.0,-56.0,-59.0,-46.0,-54.0,-55.0,-55.0,-52.0,-81.0,-92.0,-82.0,-89.0,24.0,36.0,23.0,43.0,1
201,62:47:05:9D:EB:15,3230584,415243450,3183,7603244,3227401,407640206,0,816,147477,778,140729,38,6748,398,0,3214,1151,0,9,229410.0,130000.0,-46.0,-49.0,-47.0,-47.0,-45.0,-42.0,-44.0,-42.0,-81.0,-92.0,-82.0,-89.0,35.0,43.0,35.0,42.0,1
202,F8:59:71:5A:E0:3D,3460605,757941725,233204,350301519,3227401,407640206,3,231856,308013904,226954,307428282,4902,585622,208863,19,235955,5202,3,675,144444.0,39000.0,-67.0,-72.0,-65.0,-70.0,-67.0,-72.0,-65.0,-70.0,-81.0,-92.0,-82.0,-89.0,14.0,20.0,17.0,19.0,1
203,CC:2F:71:3E:C5:1F,3238928,409050405,11527,1410199,3227401,407640206,6,49139,4116123,40599,3104249,8540,1011874,12154,35,16517,188,6,849,144444.0,43333.0,-68.0,-70.0,-69.0,-66.0,-69.0,-71.0,-68.0,-61.0,-81.0,-92.0,-82.0,-89.0,13.0,22.0,13.0,23.0,1
204,CC:2F:71:3F:1F:24,11517455,13127604764,8290054,12719964558,3227401,407640206,94,1848653,1053988890,1840003,1052949784,8650,1039106,1787765,620,8294787,873953,94,6449,115556.0,28889.0,-69.0,-65.0,-70.0,-70.0,-69.0,-65.0,-70.0,-69.0,-81.0,-92.0,-82.0,-89.0,12.0,27.0,12.0,19.0,1
205,92:69:1D:31:68:E9,3248920,452126814,21512,44485940,3227408,407640874,0,10043,3291319,9963,3277858,80,13461,6624,1,21557,1075,0,92,216660.0,130000.0,-53.0,-51.0,-46.0,-50.0,-49.0,-49.0,-45.0,-49.0,-81.0,-92.0,-82.0,-89.0,28.0,41.0,36.0,39.0,1
206,BA:8C:B9:54:50:24,3259374,477378209,31964,69737133,3227410,407641076,0,12154,3998841,12061,3983167,93,15674,7704,6,31993,5524,0,143,229410.0,130000.0,-57.0,-56.0,-59.0,-46.0,-54.0,-55.0,-55.0,-52.0,-81.0,-92.0,-82.0,-89.0,24.0,36.0,23.0,43.0,1
207,62:47:05:9D:EB:15,3230593,415244320,3183,7603244,3227410,407641076,0,816,147477,778,140729,38,6748,398,0,3214,1151,0,9,229410.0,130000.0,-46.0,-49.0,-47.0,-47.0,-45.0,-42.0,-44.0,-42.0,-81.0,-92.0,-82.0,-89.0,35.0,43.0,35.0,42.0,1
208,F8:59:71:5A:E0:3D,3460712,758094831,233302,350453755,3227410,407641076,3,231953,308163494,227051,307577872,4902,585622,208960,19,236052,5205,3,675,144444.0,43333.0,-67.0,-72.0,-65.0,-70.0,-67.0,-72.0,-65.0,-70.0,-81.0,-92.0,-82.0,-89.0,14.0,20.0,17.0,19.0,1
209,CC:2F:71:3E:C5:1F,3238938,409051335,11527,1410199,3227411,407641136,6,49141,4116311,40600,3104319,8541,1011992,12155,35,16517,188,6,849,144444.0,43333.0,-70.0,-72.0,-68.0,-61.0,-69.0,-72.0,-68.0,-61.0,-81.0,-92.0,-82.0,-89.0,11.0,20.0,14.0,28.0,1
210,CC:2F:71:3F:1F:24,11519476,13130550174,8292065,12722909038,3227411,407641136,94,1849313,1054389279,1840663,1053350173,8650,1039106,1788416,620,8296789,874296,94,6449,115556.0,28889.0,-70.0,-65.0,-71.0,-70.0,-69.0,-65.0,-70.0,-70.0,-81.0,-92.0,-82.0,-89.0,11.0,27.0,11.0,19.0,1
211,92:69:1D:31:68:E9,3248933,452128815,21518,44487275,3227415,407641540,0,10054,3297362,9974,3283901,80,13461,6632,1,21563,1075,0,92,216660.0,130000.0,-50.0,-50.0,-46.0,-48.0,-50.0,-50.0,-45.0,-48.0,-81.0,-92.0,-83.0,-89.0,31.0,42.0,37.0,41.0,1
212,BA:8C:B9:54:50:24,3259676,478162605,32261,70521065,3227415,407641540,0,12198,4007523,12105,3991849,93,15674,7742,6,32290,5875,0,143,206470.0,103230.0,-57.0,-56.0,-58.0,-46.0,-54.0,-56.0,-55.0,-50.0,-81.0,-92.0,-83.0,-89.0,24.0,36.0,25.0,43.0,1
213,62:47:05:9D:EB:15,3230599,415245057,3183,7603244,3227416,407641813,0,818,147613,780,140865,38,6748,398,0,3215,1151,0,9,229410.0,130000.0,-45.0,-49.0,-48.0,-46.0,-45.0,-43.0,-44.0,-42.0,-81.0,-92.0,-83.0,-89.0,36.0,43.0,35.0,43.0,1
214,F8:59:71:5A:E0:3D,3460812,758241644,233396,350599831,3227416,407641813,3,232047,308308338,227145,307722716,4902,585622,209054,19,236147,5208,3,675,144444.0,43333.0,-67.0,-72.0,-65.0,-70.0,-67.0,-72.0,-65.0,-69.0,-81.0,-92.0,-83.0,-89.0,14.0,20.0,18.0,19.0,1
215,CC:2F:71:3E:C5:1F,3238943,409052012,11527,1410199,3227416,407641813,6,49141,4116311,40600,3104319,8541,1011992,12155,35,16517,188,6,849,144444.0,43333.0,-70.0,-72.0,-68.0,-61.0,-69.0,-72.0,-68.0,-61.0,-81.0,-92.0,-83.0,-89.0,11.0,20.0,15.0,28.0,1
216,CC:2F:71:3F:1F:24,11521280,13133262267,8293864,12725620454,3227416,407641813,94,1849837,1054693974,1841187,1053654868,8650,1039106,1788921,620,8298597,874529,94,6451,115556.0,28889.0,-69.0,-65.0,-70.0,-70.0,-69.0,-65.0,-70.0,-69.0,-81.0,-92.0,-83.0,-89.0,12.0,27.0,13.0,19.0,1
217,92:69:1D:31:68:E9,3248939,452129554,21518,44487275,3227421,407642279,0,10055,3297430,9975,3283969,80,13461,6632,1,21563,1075,0,92,216660.0,130000.0,-53.0,-51.0,-45.0,-51.0,-50.0,-50.0,-45.0,-48.0,-81.0,-93.0,-83.0,-90.0,28.0,42.0,38.0,39.0,1
218,BA:8C:B9:54:50:24,3259685,478163808,32264,70521529,3227421,407642279,0,12204,4010518,12111,3994844,93,15674,7745,6,32293,5875,0,143,206470.0,103230.0,-48.0,-54.0,-51.0,-60.0,-52.0,-55.0,-55.0,-53.0,-81.0,-93.0,-83.0,-90.0,33.0,39.0,32.0,30.0,1
219,62:47:05:9D:EB:15,3230604,415245523,3183,7603244,3227421,407642279,0,818,147613,780,140865,38,6748,398,0,3215,1151,0,9,229410.0,130000.0,-45.0,-49.0,-48.0,-46.0,-45.0,-43.0,-44.0,-42.0,-81.0,-93.0,-83.0,-90.0,36.0,44.0,35.0,44.0,1
220,F8:59:71:5A:E0:3D,3460902,758374200,233481,350731921,3227421,407642279,3,232132,308439266,227230,307853644,4902,585622,209139,19,236231,5209,3,675,144444.0,43333.0,-67.0,-72.0,-65.0,-70.0,-66.0,-72.0,-65.0,-70.0,-81.0,-93.0,-83.0,-90.0,14.0,21.0,18.0,20.0,1
221,CC:2F:71:3E:C5:1F,3238950,409052710,11529,1410431,3227421,407642279,6,49144,4116593,40603,3104601,8541,1011992,12157,35,16519,188,6,849,144444.0,43333.0,-70.0,-72.0,-69.0,-61.0,-69.0,-71.0,-68.0,-61.0,-81.0,-93.0,-83.0,-90.0,11.0,21.0,14.0,29.0,1
222,CC:2F:71:3F:1F:24,11523335,13136366643,8295914,12728724364,3227421,407642279,94,1850457,1055036431,1841806,1053997207,8651,1039224,1789506,620,8300639,874811,94,6451,115556.0,28889.0,-69.0,-65.0,-70.0,-70.0,-69.0,-65.0,-70.0,-69.0,-81.0,-93.0,-83.0,-90.0,12.0,28.0,13.0,20.0,1
223,92:69:1D:31:68:E9,3249118,452567706,21685,44924275,3227433,407643431,0,10090,3305198,10008,3291444,82,13754,6658,1,21730,1075,0,93,229410.0,137640.0,-53.0,-50.0,-46.0,-50.0,-50.0,-50.0,-46.0,-48.0,-81.0,-93.0,-83.0,-90.0,28.0,43.0,37.0,40.0,1
224,BA:8C:B9:54:50:24,3259697,478164960,32264,70521529,3227433,407643431,0,12208,4010893,12114,3995048,94,15845,7746,6,32293,5875,0,143,206470.0,103230.0,-56.0,-56.0,-58.0,-46.0,-53.0,-55.0,-55.0,-52.0,-81.0,-93.0,-83.0,-90.0,25.0,37.0,25.0,44.0,1
225,62:47:05:9D:EB:15,3230616,415246675,3183,7603244,3227433,407643431,0,818,147613,780,140865,38,6748,398,0,3215,1151,0,9,229410.0,130000.0,-45.0,-49.0,-48.0,-46.0,-45.0,-43.0,-44.0,-42.0,-81.0,-93.0,-83.0,-90.0,36.0,44.0,35.0,44.0,1
226,F8:59:71:5A:E0:3D,3461068,758614668,233635,350971237,3227433,407643431,3,232292,308686422,227390,308100800,4902,585622,209287,19,236386,5219,3,676,144444.0,43333.0,-67.0,-72.0,-65.0,-70.0,-67.0,-72.0,-65.0,-70.0,-81.0,-93.0,-83.0,-90.0,14.0,21.0,18.0,20.0,1
227,CC:2F:71:3E:C5:1F,3238962,409053862,11529,1410431,3227433,407643431,6,49144,4116593,40603,3104601,8541,1011992,12157,35,16519,188,6,849,144444.0,43333.0,-70.0,-72.0,-69.0,-61.0,-69.0,-71.0,-68.0,-61.0,-81.0,-93.0,-83.0,-90.0,11.0,21.0,14.0,29.0,1
228,CC:2F:71:3F:1F:24,11524839,13138532008,8297404,12730888375,3227435,407643633,94,1851115,1055603641,1842464,1054564417,8651,1039224,1790122,620,8302109,874989,94,6452,115556.0,28889.0,-69.0,-65.0,-71.0,-70.0,-69.0,-64.0,-70.0,-70.0,-81.0,-93.0,-83.0,-90.0,12.0,28.0,12.0,20.0,1
229,92:69:1D:31:68:E9,3249129,452568942,21685,44924275,3227444,407644667,0,10090,3305198,10008,3291444,82,13754,6658,1,21730,1075,0,93,229410.0,137640.0,-53.0,-50.0,-46.0,-50.0,-50.0,-50.0,-46.0,-48.0,-81.0,-93.0,-83.0,-90.0,28.0,43.0,37.0,40.0,1
230,BA:8C:B9:54:50:24,3259711,478166550,32267,70521883,3227444,407644667,0,12213,4011425,12119,3995580,94,15845,7748,6,32296,5875,0,143,206470.0,103230.0,-48.0,-54.0,-51.0,-60.0,-52.0,-55.0,-55.0,-51.0,-81.0,-93.0,-83.0,-90.0,33.0,39.0,32.0,30.0,1
231,62:47:05:9D:EB:15,3230627,415247911,3183,7603244,3227444,407644667,0,818,147613,780,140865,38,6748,398,0,3215,1151,0,9,229410.0,130000.0,-45.0,-49.0,-48.0,-46.0,-45.0,-43.0,-44.0,-42.0,-81.0,-93.0,-83.0,-90.0,36.0,44.0,35.0,44.0,1
232,F8:59:71:5A:E0:3D,3461167,758752656,233723,351107989,3227444,407644667,3,232380,308822082,227478,308236460,4902,585622,209375,19,236474,5219,3,676,144444.0,43333.0,-66.0,-73.0,-65.0,-70.0,-66.0,-72.0,-65.0,-70.0,-81.0,-93.0,-83.0,-90.0,15.0,20.0,18.0,20.0,1
233,CC:2F:71:3E:C5:1F,3238973,409055098,11529,1410431,3227444,407644667,6,49144,4116593,40603,3104601,8541,1011992,12157,35,16519,188,6,849,144444.0,43333.0,-70.0,-72.0,-69.0,-61.0,-69.0,-71.0,-68.0,-61.0,-81.0,-93.0,-83.0,-90.0,11.0,21.0,14.0,29.0,1
234,CC:2F:71:3F:1F:24,11526177,13140558196,8298733,12732913529,3227444,407644667,94,1851484,1055915669,1842833,1054876445,8651,1039224,1790484,620,8303465,875091,94,6452,115556.0,26000.0,-69.0,-64.0,-71.0,-70.0,-68.0,-64.0,-71.0,-69.0,-81.0,-93.0,-83.0,-90.0,12.0,29.0,12.0,20.0,1
235,92:69:1D:31:68:E9,3249133,452569346,21685,44924275,3227448,407645071,0,10093,3305454,10011,3291700,82,13754,6659,1,21730,1075,0,93,229410.0,137640.0,-53.0,-51.0,-46.0,-51.0,-51.0,-50.0,-46.0,-49.0,-81.0,-93.0,-83.0,-90.0,28.0,42.0,37.0,39.0,1
236,BA:8C:B9:54:50:24,3259716,478167070,32268,70521999,3227448,407645071,0,12219,4011871,12125,3996026,94,15845,7749,6,32297,5875,0,144,206470.0,103230.0,-47.0,-53.0,-50.0,-58.0,-49.0,-53.0,-52.0,-52.0,-81.0,-93.0,-83.0,-90.0,34.0,40.0,33.0,32.0,1
237,62:47:05:9D:EB:15,3230631,415248315,3183,7603244,3227448,407645071,0,818,147613,780,140865,38,6748,398,0,3215,1151,0,9,229410.0,130000.0,-45.0,-49.0,-48.0,-46.0,-45.0,-43.0,-44.0,-42.0,-81.0,-93.0,-83.0,-90.0,36.0,44.0,35.0,44.0,1
238,F8:59:71:5A:E0:3D,3461254,758882042,233806,351236971,3227448,407645071,3,232464,308951442,227562,308365820,4902,585622,209459,19,236557,5220,3,676,144444.0,43333.0,-67.0,-73.0,-65.0,-70.0,-67.0,-72.0,-64.0,-70.0,-81.0,-93.0,-83.0,-90.0,14.0,20.0,18.0,20.0,1
239,CC:2F:71:3E:C5:1F,3238977,409055502,11529,1410431,3227448,407645071,6,49144,4116593,40603,3104601,8541,1011992,12157,35,16519,188,6,849,144444.0,43333.0,-70.0,-72.0,-69.0,-61.0,-69.0,-71.0,-68.0,-61.0,-81.0,-93.0,-83.0,-90.0,11.0,21.0,14.0,29.0,1
240,CC:2F:71:3F:1F:24,11527769,13142993816,8300321,12735348745,3227448,407645071,94,1851875,1056198415,1843224,1055159191,8651,1039224,1790874,620,8305054,875215,94,6452,115556.0,28889.0,-69.0,-64.0,-71.0,-70.0,-69.0,-64.0,-70.0,-70.0,-81.0,-93.0,-83.0,-90.0,12.0,29.0,12.0,20.0,1
241,92:69:1D:31:68:E9,3249142,452570660,21689,44925125,3227453,407645535,0,10100,3308072,10018,3294318,82,13754,6664,1,21734,1075,0,94,229410.0,137640.0,-54.0,-51.0,-46.0,-51.0,-50.0,-49.0,-46.0,-49.0,-81.0,-93.0,-83.0,-90.0,27.0,42.0,37.0,39.0,1
242,BA:8C:B9:54:50:24,3259721,478167534,32268,70521999,3227453,407645535,0,12219,4011871,12125,3996026,94,15845,7749,6,32297,5875,0,144,206470.0,103230.0,-47.0,-53.0,-50.0,-58.0,-49.0,-53.0,-52.0,-52.0,-81.0,-93.0,-83.0,-90.0,34.0,40.0,33.0,32.0,1
243,62:47:05:9D:EB:15,3230636,415248779,3183,7603244,3227453,407645535,0,821,147817,783,141069,38,6748,398,0,3215,1151,0,9,229410.0,130000.0,-45.0,-38.0,-44.0,-39.0,-45.0,-44.0,-45.0,-43.0,-81.0,-93.0,-83.0,-90.0,36.0,55.0,39.0,51.0,1
244,F8:59:71:5A:E0:3D,3461341,759009934,233888,351364399,3227453,407645535,3,232546,309077736,227644,308492114,4902,585622,209540,19,236639,5220,3,676,144444.0,43333.0,-68.0,-72.0,-65.0,-69.0,-67.0,-72.0,-65.0,-69.0,-81.0,-93.0,-83.0,-90.0,13.0,21.0,18.0,21.0,1
245,CC:2F:71:3E:C5:1F,3238982,409055966,11529,1410431,3227453,407645535,6,49144,4116593,40603,3104601,8541,1011992,12157,35,16519,188,6,849,144444.0,43333.0,-70.0,-72.0,-69.0,-61.0,-69.0,-71.0,-68.0,-61.0,-81.0,-93.0,-83.0,-90.0,11.0,21.0,14.0,29.0,1
246,CC:2F:71:3F:1F:24,11529514,13145664593,8302061,12738019058,3227453,407645535,94,1852283,1056476194,1843632,1055436970,8651,1039224,1791282,620,8306794,875275,94,6452,104000.0,26000.0,-68.0,-63.0,-72.0,-69.0,-68.0,-63.0,-72.0,-69.0,-81.0,-93.0,-83.0,-90.0,13.0,30.0,11.0,21.0,1
247,92:69:1D:31:68:E9,3249146,452571064,21689,44925125,3227457,407645939,0,10100,3308072,10018,3294318,82,13754,6664,1,21734,1075,0,94,229410.0,137640.0,-54.0,-51.0,-46.0,-51.0,-50.0,-49.0,-46.0,-49.0,-81.0,-93.0,-83.0,-90.0,27.0,42.0,37.0,39.0,1
248,BA:8C:B9:54:50:24,3259725,478167938,32268,70521999,3227457,407645939,0,12219,4011871,12125,3996026,94,15845,7749,6,32297,5875,0,144,206470.0,103230.0,-47.0,-53.0,-50.0,-58.0,-49.0,-53.0,-52.0,-52.0,-81.0,-93.0,-83.0,-90.0,34.0,40.0,33.0,32.0,1
249,62:47:05:9D:EB:15,3230642,415249385,3183,7603244,3227459,407646141,0,821,147817,783,141069,38,6748,398,0,3215,1151,0,9,229410.0,130000.0,-45.0,-38.0,-44.0,-39.0,-45.0,-44.0,-45.0,-43.0,-81.0,-93.0,-83.0,-90.0,36.0,55.0,39.0,51.0,1
250,F8:59:71:5A:E0:3D,3461428,759136414,233969,351490273,3227459,407646141,3,232629,309205570,227727,308619948,4902,585622,209622,19,236720,5222,3,676,144444.0,43333.0,-67.0,-72.0,-65.0,-70.0,-67.0,-72.0,-65.0,-69.0,-81.0,-93.0,-83.0,-90.0,14.0,21.0,18.0,20.0,1
251,CC:2F:71:3E:C5:1F,3238990,409056774,11529,1410431,3227461,407646343,6,49144,4116593,40603,3104601,8541,1011992,12157,35,16519,188,6,849,144444.0,43333.0,-70.0,-72.0,-69.0,-61.0,-69.0,-71.0,-68.0,-61.0,-81.0,-93.0,-83.0,-90.0,11.0,21.0,14.0,29.0,1
252,CC:2F:71:3F:1F:24,11531310,13148413963,8303849,12740767620,3227461,407646343,94,1852727,1056764850,1844076,1055725626,8651,1039224,1791726,620,8308552,875357,94,6452,130000.0,43333.0,-69.0,-64.0,-72.0,-70.0,-68.0,-64.0,-71.0,-69.0,-81.0,-93.0,-83.0,-90.0,12.0,29.0,11.0,20.0,1
253,92:69:1D:31:68:E9,3249151,452571528,21689,44925125,3227462,407646403,0,10100,3308072,10018,3294318,82,13754,6664,1,21734,1075,0,94,229410.0,137640.0,-54.0,-51.0,-46.0,-51.0,-50.0,-49.0,-46.0,-49.0,-81.0,-93.0,-83.0,-90.0,27.0,42.0,37.0,39.0,1
254,BA:8C:B9:54:50:24,3259730,478168402,32268,70521999,3227462,407646403,0,12219,4011871,12125,3996026,94,15845,7749,6,32297,5875,0,144,206470.0,103230.0,-47.0,-53.0,-50.0,-58.0,-49.0,-53.0,-52.0,-52.0,-81.0,-93.0,-83.0,-90.0,34.0,40.0,33.0,32.0,1
255,62:47:05:9D:EB:15,3230645,415249647,3183,7603244,3227462,407646403,0,821,147817,783,141069,38,6748,398,0,3215,1151,0,9,229410.0,130000.0,-45.0,-38.0,-44.0,-39.0,-45.0,-44.0,-45.0,-43.0,-81.0,-93.0,-83.0,-90.0,36.0,55.0,39.0,51.0,1
256,F8:59:71:5A:E0:3D,3461518,759271874,234056,351625471,3227462,407646403,3,232716,309339550,227814,308753928,4902,585622,209709,19,236807,5223,3,676,144444.0,43333.0,-68.0,-73.0,-65.0,-69.0,-68.0,-73.0,-64.0,-69.0,-81.0,-93.0,-83.0,-90.0,13.0,20.0,18.0,21.0,1
257,CC:2F:71:3E:C5:1F,3238994,409057170,11529,1410431,3227465,407646739,6,49144,4116593,40603,3104601,8541,1011992,12157,35,16519,188,6,849,144444.0,43333.0,-70.0,-72.0,-69.0,-61.0,-69.0,-71.0,-68.0,-61.0,-81.0,-93.0,-83.0,-90.0,11.0,21.0,14.0,29.0,1
258,CC:2F:71:3F:1F:24,11533363,13151575763,8305897,12743928956,3227466,407646807,94,1853208,1057077632,1844557,1056038408,8651,1039224,1792207,620,8310630,875402,94,6452,130000.0,43333.0,-70.0,-65.0,-71.0,-69.0,-68.0,-64.0,-71.0,-69.0,-81.0,-93.0,-83.0,-90.0,11.0,28.0,12.0,21.0,1
259,92:69:1D:31:68:E9,3249159,452572336,21689,44925125,3227470,407647211,0,10100,3308072,10018,3294318,82,13754,6664,1,21734,1075,0,94,229410.0,137640.0,-54.0,-51.0,-46.0,-51.0,-50.0,-49.0,-46.0,-49.0,-81.0,-93.0,-83.0,-90.0,27.0,42.0,37.0,39.0,1
260,BA:8C:B9:54:50:24,3259738,478169210,32268,70521999,3227470,407647211,0,12219,4011871,12125,3996026,94,15845,7749,6,32297,5875,0,144,206470.0,103230.0,-47.0,-53.0,-50.0,-58.0,-49.0,-53.0,-52.0,-52.0,-81.0,-93.0,-83.0,-90.0,34.0,40.0,33.0,32.0,1
261,62:47:05:9D:EB:15,3230653,415250455,3183,7603244,3227470,407647211,0,821,147817,783,141069,38,6748,398,0,3215,1151,0,9,229410.0,130000.0,-45.0,-38.0,-44.0,-39.0,-45.0,-44.0,-45.0,-43.0,-81.0,-93.0,-83.0,-90.0,36.0,55.0,39.0,51.0,1
262,F8:59:71:5A:E0:3D,3461623,759423420,234153,351776209,3227470,407647211,3,232813,309489028,227911,308903406,4902,585622,209806,19,236904,5226,3,676,144444.0,43333.0,-67.0,-72.0,-65.0,-70.0,-67.0,-72.0,-65.0,-70.0,-81.0,-93.0,-83.0,-90.0,14.0,21.0,18.0,20.0,1
263,CC:2F:71:3E:C5:1F,3238999,409057642,11529,1410431,3227470,407647211,6,49144,4116593,40603,3104601,8541,1011992,12157,35,16519,188,6,849,144444.0,43333.0,-70.0,-72.0,-69.0,-61.0,-69.0,-71.0,-68.0,-61.0,-81.0,-93.0,-83.0,-90.0,11.0,21.0,14.0,29.0,1
264,CC:2F:71:3F:1F:24,11535480,13154836625,8308010,12747189414,3227470,407647211,94,1853667,1057398470,1845016,1056359246,8651,1039224,1792666,620,8312709,875461,94,6453,130000.0,43333.0,-70.0,-65.0,-72.0,-69.0,-70.0,-65.0,-72.0,-69.0,-81.0,-93.0,-83.0,-90.0,11.0,28.0,11.0,21.0,1
265,92:69:1D:31:68:E9,3249164,452572800,21689,44925125,3227475,407647675,0,10100,3308072,10018,3294318,82,13754,6664,1,21734,1075,0,94,229410.0,137640.0,-54.0,-51.0,-46.0,-51.0,-50.0,-49.0,-46.0,-49.0,-81.0,-93.0,-83.0,-90.0,27.0,42.0,37.0,39.0,1
266,BA:8C:B9:54:50:24,3259743,478169674,32268,70521999,3227475,407647675,0,12219,4011871,12125,3996026,94,15845,7749,6,32297,5875,0,144,206470.0,103230.0,-47.0,-53.0,-50.0,-58.0,-49.0,-53.0,-52.0,-52.0,-81.0,-93.0,-83.0,-90.0,34.0,40.0,33.0,32.0,1
267,62:47:05:9D:EB:15,3230658,415250919,3183,7603244,3227475,407647675,0,821,147817,783,141069,38,6748,398,0,3215,1151,0,9,229410.0,130000.0,-45.0,-38.0,-44.0,-39.0,-45.0,-44.0,-45.0,-43.0,-81.0,-93.0,-83.0,-90.0,36.0,55.0,39.0,51.0,1
268,F8:59:71:5A:E0:3D,3461713,759553068,234236,351905191,3227477,407647877,3,232896,309616848,227994,309031226,4902,585622,209889,19,236987,5227,3,676,144444.0,43333.0,-68.0,-72.0,-64.0,-69.0,-68.0,-72.0,-64.0,-69.0,-81.0,-93.0,-83.0,-90.0,13.0,21.0,19.0,21.0,1
269,CC:2F:71:3E:C5:1F,3239006,409058308,11529,1410431,3227477,407647877,6,49144,4116593,40603,3104601,8541,1011992,12157,35,16519,188,6,849,144444.0,43333.0,-70.0,-72.0,-69.0,-61.0,-69.0,-71.0,-68.0,-61.0,-81.0,-93.0,-83.0,-90.0,11.0,21.0,14.0,29.0,1
270,CC:2F:71:3F:1F:24,11537502,13157934792,8310023,12750286713,3227479,407648079,94,1854102,1057696595,1845451,1056657371,8651,1039224,1793101,620,8314756,875627,94,6453,130000.0,43333.0,-66.0,-63.0,-73.0,-67.0,-66.0,-63.0,-73.0,-67.0,-81.0,-93.0,-83.0,-90.0,15.0,30.0,10.0,23.0,1
271,92:69:1D:31:68:E9,3249174,452574311,21693,44925784,3227481,407648527,0,10113,3311430,10031,3297676,82,13754,6668,1,21738,1075,0,94,229410.0,137640.0,-53.0,-50.0,-45.0,-50.0,-49.0,-49.0,-45.0,-48.0,-81.0,-93.0,-83.0,-90.0,28.0,43.0,38.0,40.0,1
272,BA:8C:B9:54:50:24,3259751,478170916,32270,70522389,3227481,407648527,0,12228,4015116,12133,3999036,95,16080,7751,6,32298,5875,0,145,206470.0,103230.0,-49.0,-52.0,-49.0,-47.0,-50.0,-54.0,-51.0,-49.0,-81.0,-93.0,-83.0,-90.0,32.0,41.0,34.0,43.0,1
273,62:47:05:9D:EB:15,3230664,415251771,3183,7603244,3227481,407648527,0,821,147817,783,141069,38,6748,398,0,3215,1151,0,9,229410.0,130000.0,-45.0,-38.0,-44.0,-39.0,-45.0,-44.0,-45.0,-43.0,-81.0,-93.0,-83.0,-90.0,36.0,55.0,39.0,51.0,1
274,F8:59:71:5A:E0:3D,3461807,759693578,234326,352045051,3227481,407648527,3,232985,309753908,228083,309168286,4902,585622,209978,19,237077,5227,3,676,144444.0,43333.0,-68.0,-72.0,-65.0,-69.0,-68.0,-72.0,-64.0,-69.0,-81.0,-93.0,-83.0,-90.0,13.0,21.0,18.0,21.0,1
275,CC:2F:71:3E:C5:1F,3239010,409058958,11529,1410431,3227481,407648527,6,49144,4116593,40603,3104601,8541,1011992,12157,35,16519,188,6,849,144444.0,43333.0,-70.0,-72.0,-69.0,-61.0,-69.0,-71.0,-68.0,-61.0,-81.0,-93.0,-83.0,-90.0,11.0,21.0,14.0,29.0,1
276,CC:2F:71:3F:1F:24,11539458,13160944800,8311977,12753296273,3227481,407648527,94,1854542,1058006448,1845891,1056967224,8651,1039224,1793536,620,8316710,875880,94,6453,130000.0,43333.0,-67.0,-64.0,-74.0,-68.0,-67.0,-64.0,-73.0,-68.0,-81.0,-93.0,-83.0,-90.0,14.0,29.0,9.0,22.0,1
277,92:69:1D:31:68:E9,3249183,452575179,21693,44925784,3227490,407649395,0,10113,3311430,10031,3297676,82,13754,6668,1,21738,1075,0,94,229410.0,137640.0,-53.0,-50.0,-45.0,-50.0,-49.0,-49.0,-45.0,-48.0,-81.0,-93.0,-83.0,-90.0,28.0,43.0,38.0,40.0,1
278,BA:8C:B9:54:50:24,3259969,478717987,32479,71068592,3227490,407649395,0,12269,4023447,12174,4007367,95,16080,7781,6,32508,6013,0,145,206470.0,103230.0,-55.0,-56.0,-53.0,-46.0,-53.0,-56.0,-53.0,-50.0,-81.0,-93.0,-83.0,-90.0,26.0,37.0,30.0,44.0,1
279,62:47:05:9D:EB:15,3230673,415252639,3183,7603244,3227490,407649395,0,821,147817,783,141069,38,6748,398,0,3215,1151,0,9,229410.0,130000.0,-45.0,-38.0,-44.0,-39.0,-45.0,-44.0,-45.0,-43.0,-81.0,-93.0,-83.0,-90.0,36.0,55.0,39.0,51.0,1
280,F8:59:71:5A:E0:3D,3461905,759832752,234415,352183357,3227490,407649395,3,233075,309892578,228173,309306956,4902,585622,210068,19,237166,5228,3,676,144444.0,43333.0,-68.0,-72.0,-65.0,-69.0,-68.0,-72.0,-64.0,-69.0,-81.0,-93.0,-83.0,-90.0,13.0,21.0,18.0,21.0,1
281,CC:2F:71:3E:C5:1F,3239019,409059826,11529,1410431,3227490,407649395,6,49144,4116593,40603,3104601,8541,1011992,12157,35,16519,188,6,849,144444.0,43333.0,-70.0,-72.0,-69.0,-61.0,-69.0,-71.0,-68.0,-61.0,-81.0,-93.0,-83.0,-90.0,11.0,21.0,14.0,29.0,1
282,CC:2F:71:3F:1F:24,11540881,13163104984,8313391,12755455589,3227490,407649395,94,1854894,1058309350,1846243,1057270126,8651,1039224,1793887,620,8318124,875987,94,6454,130000.0,43333.0,-67.0,-64.0,-73.0,-68.0,-67.0,-64.0,-72.0,-67.0,-81.0,-93.0,-83.0,-90.0,14.0,29.0,10.0,22.0,1
283,92:69:1D:31:68:E9,3249196,452578886,21702,44929087,3227494,407649799,0,10136,3323693,10054,3309939,82,13754,6680,1,21747,1075,0,94,229410.0,137640.0,-52.0,-51.0,-46.0,-50.0,-50.0,-50.0,-46.0,-50.0,-82.0,-93.0,-83.0,-90.0,30.0,42.0,37.0,40.0,1
284,BA:8C:B9:54:50:24,3259994,478744363,32499,71094438,3227495,407649925,0,12274,4024108,12179,4008028,95,16080,7784,6,32528,6013,0,145,206470.0,103230.0,-55.0,-56.0,-53.0,-46.0,-53.0,-56.0,-53.0,-49.0,-82.0,-93.0,-83.0,-90.0,27.0,37.0,30.0,44.0,1
285,62:47:05:9D:EB:15,3230678,415253169,3183,7603244,3227495,407649925,0,821,147817,783,141069,38,6748,398,0,3215,1151,0,9,229410.0,130000.0,-45.0,-38.0,-44.0,-39.0,-45.0,-44.0,-45.0,-43.0,-82.0,-93.0,-83.0,-90.0,37.0,55.0,39.0,51.0,1
286,F8:59:71:5A:E0:3D,3462004,759975014,234507,352324887,3227497,407650127,3,233166,310032718,228264,309447096,4902,585622,210159,19,237258,5229,3,676,144444.0,43333.0,-68.0,-72.0,-64.0,-69.0,-68.0,-71.0,-64.0,-69.0,-82.0,-93.0,-83.0,-90.0,14.0,21.0,19.0,21.0,1
287,CC:2F:71:3E:C5:1F,3239027,409060674,11530,1410547,3227497,407650127,6,49145,4116663,40604,3104671,8541,1011992,12157,35,16520,188,6,849,130000.0,39000.0,-70.0,-74.0,-69.0,-61.0,-69.0,-71.0,-68.0,-61.0,-82.0,-93.0,-83.0,-90.0,12.0,19.0,14.0,29.0,1
288,CC:2F:71:3F:1F:24,11542644,13165793024,8315147,12758142897,3227497,407650127,94,1855299,1058618536,1846648,1057579312,8651,1039224,1794292,620,8319880,876131,94,6454,130000.0,43333.0,-68.0,-63.0,-73.0,-68.0,-67.0,-63.0,-73.0,-68.0,-82.0,-93.0,-83.0,-90.0,14.0,30.0,10.0,22.0,1
289,92:69:1D:31:68:E9,3249208,452580330,21708,44929941,3227500,407650389,0,10143,3326132,10061,3312378,82,13754,6684,1,21753,1075,0,94,229410.0,137640.0,-52.0,-50.0,-45.0,-51.0,-50.0,-49.0,-45.0,-49.0,-83.0,-93.0,-84.0,-91.0,31.0,43.0,39.0,40.0,1
290,BA:8C:B9:54:50:24,3260000,478744943,32500,71094554,3227500,407650389,0,12276,4024244,12181,4008164,95,16080,7784,6,32529,6013,0,145,206470.0,103230.0,-47.0,-54.0,-49.0,-65.0,-53.0,-56.0,-52.0,-50.0,-83.0,-93.0,-84.0,-91.0,36.0,39.0,35.0,26.0,1
291,62:47:05:9D:EB:15,3230684,415253749,3184,7603360,3227500,407650389,0,823,147953,785,141205,38,6748,398,0,3216,1151,0,9,229410.0,137640.0,-45.0,-38.0,-43.0,-39.0,-45.0,-44.0,-45.0,-43.0,-83.0,-93.0,-84.0,-91.0,38.0,55.0,41.0,52.0,1
292,F8:59:71:5A:E0:3D,3462095,760112028,234595,352461639,3227500,407650389,3,233253,310166698,228351,309581076,4902,585622,210246,19,237346,5229,3,676,144444.0,43333.0,-68.0,-72.0,-64.0,-69.0,-68.0,-72.0,-64.0,-69.0,-83.0,-93.0,-84.0,-91.0,15.0,21.0,20.0,22.0,1
293,CC:2F:71:3E:C5:1F,3239030,409060936,11530,1410547,3227500,407650389,6,49146,4116733,40605,3104741,8541,1011992,12157,35,16520,188,6,849,130000.0,39000.0,-70.0,-74.0,-70.0,-61.0,-69.0,-72.0,-68.0,-61.0,-83.0,-93.0,-84.0,-91.0,13.0,19.0,14.0,30.0,1
294,CC:2F:71:3F:1F:24,11544023,13167892950,8316523,12760242561,3227500,407650389,94,1855670,1058911582,1847019,1057872358,8651,1039224,1794661,620,8321256,876144,94,6454,130000.0,43333.0,-68.0,-63.0,-73.0,-68.0,-68.0,-63.0,-72.0,-68.0,-83.0,-93.0,-84.0,-91.0,15.0,30.0,11.0,23.0,1
295,92:69:1D:31:68:E9,3249214,452580936,21708,44929941,3227506,407650995,0,10143,3326132,10061,3312378,82,13754,6684,1,21753,1075,0,94,229410.0,137640.0,-52.0,-50.0,-45.0,-51.0,-50.0,-49.0,-45.0,-49.0,-83.0,-93.0,-84.0,-91.0,31.0,43.0,39.0,40.0,1
296,BA:8C:B9:54:50:24,3260008,478745751,32500,71094554,3227508,407651197,0,12276,4024244,12181,4008164,95,16080,7784,6,32529,6013,0,145,206470.0,103230.0,-47.0,-54.0,-49.0,-65.0,-53.0,-56.0,-52.0,-50.0,-83.0,-93.0,-84.0,-91.0,36.0,39.0,35.0,26.0,1
297,62:47:05:9D:EB:15,3230692,415254557,3184,7603360,3227508,407651197,0,823,147953,785,141205,38,6748,398,0,3216,1151,0,9,229410.0,137640.0,-45.0,-38.0,-43.0,-39.0,-45.0,-44.0,-45.0,-43.0,-83.0,-93.0,-84.0,-91.0,38.0,55.0,41.0,52.0,1
298,F8:59:71:5A:E0:3D,3462191,760249420,234683,352598223,3227508,407651197,3,233341,310302218,228439,309716596,4902,585622,210334,19,237434,5230,3,676,144444.0,43333.0,-68.0,-72.0,-64.0,-69.0,-68.0,-71.0,-64.0,-69.0,-83.0,-93.0,-84.0,-91.0,15.0,21.0,20.0,22.0,1
299,CC:2F:71:3E:C5:1F,3239038,409061744,11530,1410547,3227508,407651197,6,49146,4116733,40605,3104741,8541,1011992,12157,35,16520,188,6,849,130000.0,39000.0,-70.0,-74.0,-70.0,-61.0,-69.0,-72.0,-68.0,-61.0,-83.0,-93.0,-84.0,-91.0,13.0,19.0,14.0,30.0,1
300,CC:2F:71:3F:1F:24,11544958,13169284396,8317450,12761633199,3227508,407651197,94,1856001,1059197346,1847350,1058158122,8651,1039224,1794989,620,8322183,876218,94,6454,130000.0,43333.0,-72.0,-67.0,-76.0,-72.0,-72.0,-67.0,-76.0,-72.0,-83.0,-93.0,-84.0,-91.0,11.0,26.0,8.0,19.0,1
301,92:69:1D:31:68:E9,3249224,452581920,21709,44930057,3227515,407651863,0,10146,3326374,10064,3312620,82,13754,6685,1,21754,1075,0,94,229410.0,137640.0,-52.0,-50.0,-45.0,-50.0,-50.0,-49.0,-46.0,-50.0,-84.0,-93.0,-85.0,-91.0,32.0,43.0,40.0,41.0,1
302,BA:8C:B9:54:50:24,3260015,478746417,32500,71094554,3227515,407651863,0,12276,4024244,12181,4008164,95,16080,7784,6,32529,6013,0,145,206470.0,103230.0,-47.0,-54.0,-49.0,-65.0,-53.0,-56.0,-52.0,-50.0,-84.0,-93.0,-85.0,-91.0,37.0,39.0,36.0,26.0,1
303,62:47:05:9D:EB:15,3230699,415255223,3184,7603360,3227515,407651863,0,823,147953,785,141205,38,6748,398,0,3216,1151,0,9,229410.0,137640.0,-45.0,-38.0,-43.0,-39.0,-45.0,-44.0,-45.0,-43.0,-84.0,-93.0,-85.0,-91.0,39.0,55.0,42.0,52.0,1
304,F8:59:71:5A:E0:3D,3462324,760442984,234807,352790919,3227517,407652065,3,233466,310495082,228564,309909460,4902,585622,210459,19,237558,5235,3,676,144444.0,43333.0,-68.0,-72.0,-65.0,-69.0,-68.0,-72.0,-65.0,-69.0,-84.0,-93.0,-85.0,-91.0,16.0,21.0,20.0,22.0,1
305,CC:2F:71:3E:C5:1F,3239047,409062612,11530,1410547,3227517,407652065,6,49146,4116733,40605,3104741,8541,1011992,12157,35,16520,188,6,849,130000.0,39000.0,-70.0,-74.0,-70.0,-61.0,-69.0,-72.0,-68.0,-61.0,-84.0,-93.0,-85.0,-91.0,14.0,19.0,15.0,30.0,1
306,CC:2F:71:3F:1F:24,11545987,13170802135,8318470,12763150070,3227517,407652065,94,1856433,1059620442,1847782,1058581218,8651,1039224,1795419,620,8323203,876372,94,6455,130000.0,43333.0,-68.0,-63.0,-72.0,-68.0,-68.0,-63.0,-72.0,-68.0,-84.0,-93.0,-85.0,-91.0,16.0,30.0,13.0,23.0,1
307,92:69:1D:31:68:E9,3249227,452582184,21709,44930057,3227518,407652127,0,10146,3326374,10064,3312620,82,13754,6685,1,21754,1075,0,94,229410.0,137640.0,-52.0,-50.0,-45.0,-50.0,-50.0,-49.0,-46.0,-50.0,-84.0,-93.0,-85.0,-91.0,32.0,43.0,40.0,41.0,1
308,BA:8C:B9:54:50:24,3260018,478746681,32500,71094554,3227518,407652127,0,12276,4024244,12181,4008164,95,16080,7784,6,32529,6013,0,145,206470.0,103230.0,-47.0,-54.0,-49.0,-65.0,-53.0,-56.0,-52.0,-50.0,-84.0,-93.0,-85.0,-91.0,37.0,39.0,36.0,26.0,1
309,62:47:05:9D:EB:15,3230702,415255487,3184,7603360,3227518,407652127,0,826,148157,788,141409,38,6748,398,0,3216,1151,0,9,229410.0,137640.0,-45.0,-38.0,-43.0,-39.0,-45.0,-40.0,-44.0,-40.0,-84.0,-93.0,-85.0,-91.0,39.0,55.0,42.0,52.0,1
310,F8:59:71:5A:E0:3D,3462409,760573582,234891,352921455,3227518,407652127,3,233553,310627696,228650,310041956,4903,585740,210545,19,237642,5238,3,676,144444.0,43333.0,-68.0,-72.0,-65.0,-69.0,-68.0,-72.0,-65.0,-69.0,-84.0,-93.0,-85.0,-91.0,16.0,21.0,20.0,22.0,1
311,CC:2F:71:3E:C5:1F,3239048,409062674,11530,1410547,3227518,407652127,6,49146,4116733,40605,3104741,8541,1011992,12157,35,16520,188,6,849,130000.0,39000.0,-70.0,-74.0,-70.0,-61.0,-69.0,-72.0,-68.0,-61.0,-84.0,-93.0,-85.0,-91.0,14.0,19.0,15.0,30.0,1
312,CC:2F:71:3F:1F:24,11547180,13172605757,8319660,12764953428,3227520,407652329,94,1856751,1059898812,1848100,1058859588,8651,1039224,1795737,620,8324393,876417,94,6455,117000.0,39000.0,-68.0,-63.0,-72.0,-68.0,-68.0,-63.0,-72.0,-68.0,-84.0,-93.0,-85.0,-91.0,16.0,30.0,13.0,23.0,1
313,92:69:1D:31:68:E9,3249256,452594978,21729,44941983,3227527,407652995,0,10178,3334015,10096,3320261,82,13754,6703,1,21774,1075,0,95,229410.0,137640.0,-53.0,-51.0,-46.0,-51.0,-51.0,-50.0,-45.0,-49.0,-84.0,-93.0,-85.0,-91.0,31.0,42.0,39.0,40.0,1
314,BA:8C:B9:54:50:24,3260287,479428255,32760,71775260,3227527,407652995,0,12308,4031320,12213,4015240,95,16080,7809,6,32789,6105,0,145,195000.0,97500.0,-47.0,-54.0,-49.0,-66.0,-51.0,-56.0,-52.0,-53.0,-84.0,-93.0,-85.0,-91.0,37.0,39.0,36.0,25.0,1
315,62:47:05:9D:EB:15,3230711,415256355,3184,7603360,3227527,407652995,0,827,148225,789,141477,38,6748,398,0,3216,1151,0,9,229410.0,137640.0,-43.0,-38.0,-42.0,-39.0,-44.0,-39.0,-43.0,-39.0,-84.0,-93.0,-85.0,-91.0,41.0,55.0,43.0,52.0,1
316,F8:59:71:5A:E0:3D,3462508,760712872,234981,353059877,3227527,407652995,3,233642,310763350,228739,310177610,4903,585740,210634,19,237732,5238,3,676,144444.0,43333.0,-68.0,-72.0,-65.0,-69.0,-68.0,-72.0,-65.0,-69.0,-84.0,-93.0,-85.0,-91.0,16.0,21.0,20.0,22.0,1
317,CC:2F:71:3E:C5:1F,3239057,409063542,11530,1410547,3227527,407652995,6,49146,4116733,40605,3104741,8541,1011992,12157,35,16520,188,6,849,130000.0,39000.0,-70.0,-74.0,-70.0,-61.0,-69.0,-72.0,-68.0,-61.0,-84.0,-93.0,-85.0,-91.0,14.0,19.0,15.0,30.0,1
318,CC:2F:71:3F:1F:24,11548246,13174184422,8320719,12766531427,3227527,407652995,94,1857078,1060192849,1848427,1059153625,8651,1039224,1796063,620,8325452,876525,94,6455,130000.0,43333.0,-69.0,-63.0,-72.0,-68.0,-68.0,-63.0,-72.0,-68.0,-84.0,-93.0,-85.0,-91.0,15.0,30.0,13.0,23.0,1
319,92:69:1D:31:68:E9,3249260,452595382,21729,44941983,3227531,407653399,0,10178,3334015,10096,3320261,82,13754,6703,1,21774,1075,0,95,229410.0,137640.0,-53.0,-51.0,-46.0,-51.0,-51.0,-50.0,-45.0,-49.0,-84.0,-93.0,-85.0,-91.0,31.0,42.0,39.0,40.0,1
320,BA:8C:B9:54:50:24,3260293,479428861,32760,71775260,3227533,407653601,0,12308,4031320,12213,4015240,95,16080,7809,6,32789,6105,0,145,195000.0,97500.0,-47.0,-54.0,-49.0,-66.0,-51.0,-56.0,-52.0,-53.0,-84.0,-93.0,-85.0,-91.0,37.0,39.0,36.0,25.0,1
321,62:47:05:9D:EB:15,3230717,415256961,3184,7603360,3227533,407653601,0,827,148225,789,141477,38,6748,398,0,3216,1151,0,9,229410.0,137640.0,-43.0,-38.0,-42.0,-39.0,-44.0,-39.0,-43.0,-39.0,-84.0,-93.0,-85.0,-91.0,41.0,55.0,43.0,52.0,1
322,F8:59:71:5A:E0:3D,3462602,760850230,235069,353196629,3227533,407653601,3,233730,310898968,228827,310313228,4903,585740,210722,19,237820,5238,3,676,144444.0,43333.0,-68.0,-72.0,-65.0,-70.0,-68.0,-72.0,-65.0,-69.0,-84.0,-93.0,-85.0,-91.0,16.0,21.0,20.0,21.0,1
323,CC:2F:71:3E:C5:1F,3239063,409064148,11530,1410547,3227533,407653601,6,49146,4116733,40605,3104741,8541,1011992,12157,35,16520,188,6,849,130000.0,39000.0,-70.0,-74.0,-70.0,-61.0,-69.0,-72.0,-68.0,-61.0,-84.0,-93.0,-85.0,-91.0,14.0,19.0,15.0,30.0,1
324,CC:2F:71:3F:1F:24,11549516,13176095557,8321981,12768441754,3227535,407653803,94,1857440,1060492659,1848789,1059453435,8651,1039224,1796425,620,8326714,876628,94,6456,115556.0,28889.0,-70.0,-64.0,-73.0,-69.0,-69.0,-64.0,-72.0,-68.0,-85.0,-93.0,-86.0,-91.0,15.0,29.0,13.0,22.0,1
325,92:69:1D:31:68:E9,3249265,452595846,21729,44941983,3227536,407653863,0,10178,3334015,10096,3320261,82,13754,6703,1,21774,1075,0,95,229410.0,137640.0,-53.0,-51.0,-46.0,-51.0,-51.0,-50.0,-45.0,-49.0,-85.0,-93.0,-86.0,-91.0,32.0,42.0,40.0,40.0,1
326,BA:8C:B9:54:50:24,3260296,479429123,32760,71775260,3227536,407653863,0,12308,4031320,12213,4015240,95,16080,7809,6,32789,6105,0,145,195000.0,97500.0,-47.0,-54.0,-49.0,-66.0,-51.0,-56.0,-52.0,-53.0,-85.0,-93.0,-86.0,-91.0,38.0,39.0,37.0,25.0,1
327,62:47:05:9D:EB:15,3230720,415257223,3184,7603360,3227536,407653863,0,827,148225,789,141477,38,6748,398,0,3216,1151,0,9,229410.0,137640.0,-43.0,-38.0,-42.0,-39.0,-44.0,-39.0,-43.0,-39.0,-85.0,-93.0,-86.0,-91.0,42.0,55.0,44.0,52.0,1
328,F8:59:71:5A:E0:3D,3462687,760977920,235151,353324057,3227536,407653863,3,233812,311025248,228909,310439508,4903,585740,210804,19,237902,5239,3,676,144444.0,43333.0,-69.0,-72.0,-65.0,-70.0,-68.0,-72.0,-65.0,-70.0,-85.0,-93.0,-86.0,-91.0,16.0,21.0,21.0,21.0,1
329,CC:2F:71:3E:C5:1F,3239066,409064410,11530,1410547,3227536,407653863,6,49148,4116873,40607,3104881,8541,1011992,12157,35,16521,188,6,849,130000.0,39000.0,-78.0,-77.0,-72.0,-70.0,-71.0,-73.0,-69.0,-62.0,-85.0,-93.0,-86.0,-91.0,7.0,16.0,14.0,21.0,1
330,CC:2F:71:3F:1F:24,11550701,13177892641,8323165,12770238778,3227536,407653863,94,1857762,1060754397,1849111,1059715173,8651,1039224,1796747,620,8327896,876629,94,6456,115556.0,28889.0,-73.0,-67.0,-75.0,-72.0,-72.0,-66.0,-74.0,-71.0,-85.0,-93.0,-86.0,-91.0,12.0,26.0,11.0,19.0,1
331,92:69:1D:31:68:E9,3249303,452602242,21758,44947376,3227545,407654866,0,10226,3355291,10143,3341415,83,13876,6736,1,21803,1076,0,95,229410.0,130000.0,-53.0,-51.0,-46.0,-51.0,-50.0,-49.0,-45.0,-49.0,-85.0,-93.0,-86.0,-91.0,32.0,42.0,40.0,40.0,1
332,BA:8C:B9:54:50:24,3260307,479430328,32760,71775260,3227547,407655068,0,12315,4031850,12219,4015648,96,16202,7810,6,32789,6105,0,145,195000.0,97500.0,-53.0,-56.0,-54.0,-46.0,-51.0,-56.0,-53.0,-52.0,-85.0,-93.0,-86.0,-91.0,32.0,37.0,32.0,45.0,1
333,62:47:05:9D:EB:15,3230731,415258428,3184,7603360,3227547,407655068,0,827,148225,789,141477,38,6748,398,0,3216,1151,0,9,229410.0,137640.0,-43.0,-38.0,-42.0,-39.0,-44.0,-39.0,-43.0,-39.0,-85.0,-93.0,-86.0,-91.0,42.0,55.0,44.0,52.0,1
334,F8:59:71:5A:E0:3D,3462780,761106553,235233,353451485,3227547,407655068,3,233894,311151528,228991,310565788,4903,585740,210886,19,237984,5241,3,676,144444.0,43333.0,-68.0,-72.0,-65.0,-70.0,-68.0,-72.0,-65.0,-70.0,-85.0,-93.0,-86.0,-91.0,17.0,21.0,21.0,21.0,1
335,CC:2F:71:3E:C5:1F,3239077,409065615,11530,1410547,3227547,407655068,6,49148,4116873,40607,3104881,8541,1011992,12157,35,16521,188,6,849,130000.0,39000.0,-78.0,-77.0,-72.0,-70.0,-71.0,-73.0,-69.0,-62.0,-86.0,-93.0,-86.0,-91.0,8.0,16.0,14.0,21.0,1
336,CC:2F:71:3F:1F:24,11552114,13180031178,8324567,12772376110,3227547,407655068,94,1858164,1061102613,1849513,1060063389,8651,1039224,1797149,620,8329300,876826,94,6456,130000.0,39000.0,-70.0,-65.0,-72.0,-69.0,-70.0,-65.0,-72.0,-69.0,-86.0,-93.0,-86.0,-91.0,16.0,28.0,14.0,22.0,1
337,92:69:1D:31:68:E9,3249321,452606936,21773,44951808,3227548,407655128,0,10247,3358787,10164,3344911,83,13876,6750,1,21818,1076,0,95,229410.0,137640.0,-49.0,-49.0,-46.0,-48.0,-49.0,-49.0,-45.0,-48.0,-86.0,-93.0,-86.0,-91.0,37.0,44.0,40.0,43.0,1
338,BA:8C:B9:54:50:24,3260315,479431056,32760,71775260,3227555,407655796,0,12315,4031850,12219,4015648,96,16202,7810,6,32789,6105,0,145,195000.0,97500.0,-53.0,-56.0,-54.0,-46.0,-51.0,-56.0,-53.0,-52.0,-86.0,-93.0,-86.0,-91.0,33.0,37.0,32.0,45.0,1
339,62:47:05:9D:EB:15,3230743,415259531,3184,7603360,3227559,407656171,0,827,148225,789,141477,38,6748,398,0,3216,1151,0,9,229410.0,137640.0,-43.0,-38.0,-42.0,-39.0,-44.0,-39.0,-43.0,-39.0,-86.0,-93.0,-86.0,-91.0,43.0,55.0,44.0,52.0,1
340,F8:59:71:5A:E0:3D,3462943,761340872,235384,353684701,3227559,407656171,3,234046,311384426,229143,310798686,4903,585740,211037,19,238135,5241,3,676,144444.0,43333.0,-69.0,-73.0,-66.0,-70.0,-69.0,-73.0,-65.0,-70.0,-86.0,-93.0,-86.0,-91.0,17.0,20.0,20.0,21.0,1
341,CC:2F:71:3E:C5:1F,3239089,409066718,11530,1410547,3227559,407656171,6,49150,4117061,40608,3104951,8542,1012110,12158,35,16521,188,6,850,130000.0,39000.0,-70.0,-70.0,-69.0,-61.0,-71.0,-73.0,-69.0,-61.0,-86.0,-93.0,-86.0,-91.0,16.0,23.0,17.0,30.0,1
342,CC:2F:71:3F:1F:24,11554133,13183111951,8326573,12775455669,3227560,407656282,94,1858680,1061538800,1850028,1060499458,8652,1039342,1797665,620,8331306,877318,94,6456,130000.0,43333.0,-70.0,-64.0,-72.0,-69.0,-69.0,-64.0,-71.0,-69.0,-86.0,-93.0,-86.0,-91.0,16.0,29.0,14.0,22.0,1
343,92:69:1D:31:68:E9,3249333,452608090,21773,44951808,3227560,407656282,0,10251,3359162,10167,3345115,84,14047,6751,1,21818,1076,0,95,229410.0,137640.0,-52.0,-51.0,-46.0,-51.0,-50.0,-49.0,-45.0,-49.0,-86.0,-93.0,-86.0,-91.0,34.0,42.0,40.0,40.0,1
344,BA:8C:B9:54:50:24,3260322,479431744,32760,71775260,3227562,407656484,0,12320,4032293,12223,4015920,97,16373,7811,6,32789,6105,0,145,195000.0,97500.0,-53.0,-56.0,-54.0,-46.0,-52.0,-56.0,-54.0,-49.0,-86.0,-93.0,-86.0,-91.0,33.0,37.0,32.0,45.0,1
345,62:47:05:9D:EB:15,3230750,415260248,3184,7603360,3227566,407656888,0,827,148225,789,141477,38,6748,398,0,3216,1151,0,9,229410.0,137640.0,-43.0,-38.0,-42.0,-39.0,-44.0,-39.0,-43.0,-39.0,-86.0,-93.0,-87.0,-91.0,43.0,55.0,45.0,52.0,1
346,F8:59:71:5A:E0:3D,3463046,761490773,235480,353833885,3227566,407656888,3,234142,311532378,229239,310946638,4903,585740,211133,19,238231,5250,3,676,144444.0,43333.0,-69.0,-73.0,-66.0,-70.0,-68.0,-72.0,-65.0,-70.0,-86.0,-93.0,-87.0,-91.0,17.0,20.0,21.0,21.0,1
347,CC:2F:71:3E:C5:1F,3239097,409067495,11530,1410547,3227567,407656948,6,49150,4117061,40608,3104951,8542,1012110,12158,35,16521,188,6,850,130000.0,39000.0,-70.0,-70.0,-69.0,-61.0,-71.0,-73.0,-69.0,-61.0,-86.0,-93.0,-87.0,-91.0,16.0,23.0,18.0,30.0,1
348,CC:2F:71:3F:1F:24,11555852,13185738607,8328283,12778081457,3227569,407657150,94,1859090,1061865282,1850438,1060825940,8652,1039342,1798075,620,8333016,877494,94,6457,130000.0,43333.0,-69.0,-64.0,-70.0,-68.0,-68.0,-64.0,-70.0,-68.0,-86.0,-93.0,-87.0,-91.0,17.0,29.0,17.0,23.0,1
349,92:69:1D:31:68:E9,3249342,452608958,21773,44951808,3227569,407657150,0,10251,3359162,10167,3345115,84,14047,6751,1,21818,1076,0,95,229410.0,137640.0,-52.0,-51.0,-46.0,-51.0,-50.0,-49.0,-45.0,-49.0,-87.0,-93.0,-87.0,-92.0,35.0,42.0,41.0,41.0,1
350,BA:8C:B9:54:50:24,3260329,479432410,32760,71775260,3227569,407657150,0,12320,4032293,12223,4015920,97,16373,7811,6,32789,6105,0,145,195000.0,97500.0,-53.0,-56.0,-54.0,-46.0,-52.0,-56.0,-54.0,-49.0,-87.0,-93.0,-87.0,-92.0,34.0,37.0,33.0,46.0,1
351,62:47:05:9D:EB:15,3230753,415260510,3184,7603360,3227569,407657150,0,827,148225,789,141477,38,6748,398,0,3216,1151,0,9,229410.0,137640.0,-43.0,-38.0,-42.0,-39.0,-44.0,-39.0,-43.0,-39.0,-87.0,-93.0,-87.0,-92.0,44.0,55.0,45.0,53.0,1
352,F8:59:71:5A:E0:3D,3463139,761630895,235570,353973745,3227569,407657150,3,234234,311674156,229331,311088416,4903,585740,211223,19,238320,5252,3,676,144444.0,43333.0,-69.0,-72.0,-66.0,-70.0,-68.0,-72.0,-65.0,-70.0,-87.0,-93.0,-87.0,-92.0,18.0,21.0,21.0,22.0,1
353,CC:2F:71:3E:C5:1F,3239099,409067697,11530,1410547,3227569,407657150,6,49150,4117061,40608,3104951,8542,1012110,12158,35,16521,188,6,850,130000.0,39000.0,-70.0,-70.0,-69.0,-61.0,-71.0,-73.0,-69.0,-61.0,-87.0,-93.0,-87.0,-92.0,17.0,23.0,18.0,31.0,1
354,CC:2F:71:3F:1F:24,11557741,13188641530,8330172,12780984380,3227569,407657150,94,1859496,1062173053,1850844,1061133711,8652,1039342,1798480,620,8334904,877889,94,6457,130000.0,43333.0,-69.0,-64.0,-71.0,-69.0,-69.0,-64.0,-71.0,-69.0,-87.0,-93.0,-87.0,-92.0,18.0,29.0,16.0,23.0,1
355,92:69:1D:31:68:E9,3249350,452609766,21773,44951808,3227577,407657958,0,10251,3359162,10167,3345115,84,14047,6751,1,21818,1076,0,95,229410.0,137640.0,-52.0,-51.0,-46.0,-51.0,-50.0,-49.0,-45.0,-49.0,-87.0,-93.0,-87.0,-92.0,35.0,42.0,41.0,41.0,1
356,BA:8C:B9:54:50:24,3260337,479433218,32760,71775260,3227577,407657958,0,12320,4032293,12223,4015920,97,16373,7811,6,32789,6105,0,145,195000.0,97500.0,-53.0,-56.0,-54.0,-46.0,-52.0,-56.0,-54.0,-49.0,-87.0,-93.0,-87.0,-92.0,34.0,37.0,33.0,46.0,1
357,62:47:05:9D:EB:15,3230761,415261318,3184,7603360,3227577,407657958,0,827,148225,789,141477,38,6748,398,0,3216,1151,0,9,229410.0,137640.0,-43.0,-38.0,-42.0,-39.0,-44.0,-39.0,-43.0,-39.0,-87.0,-93.0,-87.0,-92.0,44.0,55.0,45.0,53.0,1
358,F8:59:71:5A:E0:3D,3463234,761766901,235657,354108943,3227577,407657958,3,234321,311808178,229418,311222438,4903,585740,211310,19,238408,5253,3,676,144444.0,43333.0,-68.0,-72.0,-65.0,-70.0,-68.0,-72.0,-65.0,-70.0,-87.0,-93.0,-87.0,-92.0,19.0,21.0,22.0,22.0,1
359,CC:2F:71:3E:C5:1F,3239107,409068505,11530,1410547,3227577,407657958,6,49150,4117061,40608,3104951,8542,1012110,12158,35,16521,188,6,850,130000.0,39000.0,-70.0,-70.0,-69.0,-61.0,-71.0,-73.0,-69.0,-61.0,-87.0,-93.0,-87.0,-92.0,17.0,23.0,18.0,31.0,1
360,CC:2F:71:3F:1F:24,11559021,13190577660,8331443,12782919642,3227578,407658018,94,1859824,1062446911,1851172,1061407569,8652,1039342,1798808,620,8336175,878235,94,6457,130000.0,43333.0,-70.0,-64.0,-72.0,-69.0,-70.0,-64.0,-71.0,-69.0,-87.0,-93.0,-87.0,-92.0,17.0,29.0,15.0,23.0,1
361,92:69:1D:31:68:E9,3249351,452609826,21773,44951808,3227578,407658018,0,10251,3359162,10167,3345115,84,14047,6751,1,21818,1076,0,95,229410.0,137640.0,-52.0,-51.0,-46.0,-51.0,-50.0,-49.0,-45.0,-49.0,-87.0,-93.0,-88.0,-92.0,35.0,42.0,42.0,41.0,1
362,BA:8C:B9:54:50:24,3260338,479433278,32760,71775260,3227578,407658018,0,12321,4032361,12224,4015988,97,16373,7811,6,32789,6105,0,145,195000.0,97500.0,-53.0,-56.0,-54.0,-46.0,-52.0,-56.0,-54.0,-49.0,-87.0,-93.0,-88.0,-92.0,34.0,37.0,34.0,46.0,1
363,62:47:05:9D:EB:15,3230764,415261580,3184,7603360,3227580,407658220,0,830,148429,792,141681,38,6748,398,0,3216,1151,0,9,229410.0,137640.0,-45.0,-49.0,-48.0,-47.0,-44.0,-39.0,-43.0,-40.0,-87.0,-93.0,-88.0,-92.0,42.0,44.0,40.0,45.0,1
364,F8:59:71:5A:E0:3D,3463321,761894793,235739,354236371,3227582,407658422,3,234404,311936012,229501,311350272,4903,585740,211392,19,238490,5256,3,676,144444.0,43333.0,-69.0,-73.0,-66.0,-70.0,-68.0,-72.0,-65.0,-70.0,-87.0,-93.0,-88.0,-92.0,18.0,20.0,22.0,22.0,1
365,CC:2F:71:3E:C5:1F,3239112,409068969,11530,1410547,3227582,407658422,6,49150,4117061,40608,3104951,8542,1012110,12158,35,16521,188,6,850,130000.0,39000.0,-70.0,-70.0,-69.0,-61.0,-71.0,-73.0,-69.0,-61.0,-87.0,-93.0,-88.0,-92.0,17.0,23.0,19.0,31.0,1
366,CC:2F:71:3F:1F:24,11560693,13193135678,8333109,12785477054,3227584,407658624,94,1860177,1062726467,1851525,1061687125,8652,1039342,1799159,620,8337842,878447,94,6457,130000.0,43333.0,-70.0,-64.0,-72.0,-69.0,-69.0,-64.0,-71.0,-69.0,-87.0,-93.0,-88.0,-92.0,17.0,29.0,16.0,23.0,1
367,92:69:1D:31:68:E9,3249359,452610634,21773,44951808,3227586,407658826,0,10251,3359162,10167,3345115,84,14047,6751,1,21818,1076,0,95,229410.0,137640.0,-52.0,-51.0,-46.0,-51.0,-50.0,-49.0,-45.0,-49.0,-88.0,-93.0,-88.0,-92.0,36.0,42.0,42.0,41.0,1
368,BA:8C:B9:54:50:24,3260348,479435148,32762,71776322,3227586,407658826,0,12329,4033119,12232,4016746,97,16373,7813,6,32791,6105,0,145,206470.0,97500.0,-53.0,-56.0,-54.0,-46.0,-50.0,-55.0,-52.0,-51.0,-88.0,-93.0,-88.0,-92.0,35.0,37.0,34.0,46.0,1
369,62:47:05:9D:EB:15,3230770,415262186,3184,7603360,3227586,407658826,0,830,148429,792,141681,38,6748,398,0,3216,1151,0,9,229410.0,137640.0,-45.0,-49.0,-48.0,-47.0,-44.0,-39.0,-43.0,-40.0,-88.0,-93.0,-88.0,-92.0,43.0,44.0,40.0,45.0,1
370,F8:59:71:5A:E0:3D,3463424,762049043,235838,354390217,3227586,407658826,3,234505,312091552,229602,311505812,4903,585740,211493,19,238589,5257,3,676,144444.0,43333.0,-68.0,-72.0,-65.0,-70.0,-68.0,-72.0,-65.0,-70.0,-88.0,-93.0,-88.0,-92.0,20.0,21.0,23.0,22.0,1
371,CC:2F:71:3E:C5:1F,3239117,409069433,11530,1410547,3227587,407658886,6,49150,4117061,40608,3104951,8542,1012110,12158,35,16521,188,6,850,130000.0,39000.0,-70.0,-70.0,-69.0,-61.0,-71.0,-73.0,-69.0,-61.0,-88.0,-93.0,-88.0,-92.0,18.0,23.0,19.0,31.0,1
372,CC:2F:71:3F:1F:24,11561980,13195080957,8334393,12787422071,3227587,407658886,94,1860576,1063061858,1851924,1062022516,8652,1039342,1799557,620,8339125,878745,94,6457,130000.0,43333.0,-70.0,-65.0,-72.0,-69.0,-70.0,-65.0,-72.0,-69.0,-88.0,-93.0,-88.0,-92.0,18.0,28.0,16.0,23.0,1
373,92:69:1D:31:68:E9,3249370,452611678,21774,44951924,3227596,407659754,0,10254,3359404,10170,3345357,84,14047,6752,1,21819,1076,0,95,229410.0,137640.0,-53.0,-51.0,-46.0,-50.0,-51.0,-50.0,-46.0,-49.0,-89.0,-93.0,-89.0,-92.0,36.0,42.0,43.0,42.0,1
374,BA:8C:B9:54:50:24,3260738,480444921,33142,72785167,3227596,407659754,0,12374,4041838,12277,4025465,97,16373,7849,6,33171,6106,0,145,216660.0,130000.0,-47.0,-55.0,-50.0,-63.0,-51.0,-56.0,-53.0,-52.0,-89.0,-93.0,-89.0,-92.0,42.0,38.0,39.0,29.0,1
375,62:47:05:9D:EB:15,3230780,415263114,3184,7603360,3227596,407659754,0,830,148429,792,141681,38,6748,398,0,3216,1151,0,9,229410.0,137640.0,-45.0,-49.0,-48.0,-47.0,-44.0,-39.0,-43.0,-40.0,-89.0,-93.0,-89.0,-92.0,44.0,44.0,41.0,45.0,1
376,F8:59:71:5A:E0:3D,3463523,762188277,235927,354528523,3227596,407659754,3,234593,312227114,229690,311641374,4903,585740,211581,19,238678,5257,3,676,144444.0,43333.0,-68.0,-72.0,-65.0,-70.0,-68.0,-72.0,-65.0,-70.0,-89.0,-93.0,-89.0,-92.0,21.0,21.0,24.0,22.0,1
377,CC:2F:71:3E:C5:1F,3239126,409070301,11530,1410547,3227596,407659754,6,49150,4117061,40608,3104951,8542,1012110,12158,35,16521,188,6,850,130000.0,39000.0,-70.0,-70.0,-69.0,-61.0,-71.0,-73.0,-69.0,-61.0,-89.0,-93.0,-89.0,-92.0,19.0,23.0,20.0,31.0,1
378,CC:2F:71:3F:1F:24,11563088,13196732462,8335492,12789072708,3227596,407659754,94,1860906,1063359337,1852254,1062319995,8652,1039342,1799886,620,8340225,878850,94,6458,130000.0,43333.0,-70.0,-65.0,-72.0,-70.0,-70.0,-65.0,-72.0,-69.0,-89.0,-93.0,-89.0,-92.0,19.0,28.0,17.0,22.0,1
379,92:69:1D:31:68:E9,3249371,452611738,21774,44951924,3227597,407659814,0,10254,3359404,10170,3345357,84,14047,6752,1,21819,1076,0,95,229410.0,137640.0,-53.0,-51.0,-46.0,-50.0,-51.0,-50.0,-46.0,-49.0,-89.0,-93.0,-89.0,-92.0,36.0,42.0,43.0,42.0,1
380,BA:8C:B9:54:50:24,3260739,480444981,33142,72785167,3227597,407659814,0,12374,4041838,12277,4025465,97,16373,7849,6,33171,6106,0,145,216660.0,130000.0,-47.0,-55.0,-50.0,-63.0,-51.0,-56.0,-53.0,-52.0,-89.0,-93.0,-89.0,-92.0,42.0,38.0,39.0,29.0,1
381,62:47:05:9D:EB:15,3230783,415263376,3184,7603360,3227599,407660016,0,830,148429,792,141681,38,6748,398,0,3216,1151,0,9,229410.0,137640.0,-45.0,-49.0,-48.0,-47.0,-44.0,-39.0,-43.0,-40.0,-89.0,-93.0,-89.0,-92.0,44.0,44.0,41.0,45.0,1
382,F8:59:71:5A:E0:3D,3463615,762325351,236015,354665275,3227600,407660076,3,234683,312365728,229780,311779988,4903,585740,211670,19,238766,5260,3,676,144444.0,43333.0,-68.0,-72.0,-65.0,-70.0,-68.0,-72.0,-65.0,-70.0,-89.0,-93.0,-89.0,-92.0,21.0,21.0,24.0,22.0,1
383,CC:2F:71:3E:C5:1F,3239133,409070885,11530,1410547,3227603,407660338,6,49150,4117061,40608,3104951,8542,1012110,12158,35,16521,188,6,850,130000.0,39000.0,-70.0,-70.0,-69.0,-61.0,-71.0,-73.0,-69.0,-61.0,-89.0,-93.0,-89.0,-92.0,19.0,23.0,20.0,31.0,1
384,CC:2F:71:3F:1F:24,11564134,13198295992,8336529,12790635452,3227605,407660540,94,1861216,1063646669,1852563,1062607213,8653,1039456,1800196,620,8341244,878963,94,6458,130000.0,43333.0,-70.0,-65.0,-72.0,-69.0,-70.0,-64.0,-72.0,-69.0,-89.0,-93.0,-89.0,-92.0,19.0,28.0,17.0,23.0,1
385,92:69:1D:31:68:E9,3249384,452612878,21774,44951924,3227610,407660954,0,10255,3359472,10171,3345425,84,14047,6752,1,21819,1076,0,95,229410.0,137640.0,-53.0,-51.0,-46.0,-50.0,-52.0,-50.0,-46.0,-50.0,-90.0,-93.0,-90.0,-93.0,37.0,42.0,44.0,43.0,1
386,BA:8C:B9:54:50:24,3260780,480479472,33169,72818384,3227611,407661088,0,12389,4043434,12292,4027061,97,16373,7854,6,33198,6127,0,145,216660.0,130000.0,-52.0,-55.0,-54.0,-45.0,-50.0,-53.0,-52.0,-48.0,-90.0,-93.0,-90.0,-93.0,38.0,38.0,36.0,48.0,1
387,62:47:05:9D:EB:15,3230796,415264721,3184,7603360,3227612,407661361,0,830,148429,792,141681,38,6748,398,0,3216,1151,0,9,229410.0,137640.0,-45.0,-49.0,-48.0,-47.0,-44.0,-39.0,-43.0,-40.0,-90.0,-93.0,-90.0,-93.0,45.0,44.0,42.0,46.0,1
388,F8:59:71:5A:E0:3D,3463716,762464830,236104,354803469,3227612,407661361,3,234772,312502900,229869,311917160,4903,585740,211759,19,238855,5260,3,676,144444.0,39000.0,-68.0,-72.0,-65.0,-70.0,-68.0,-72.0,-65.0,-70.0,-90.0,-93.0,-90.0,-93.0,22.0,21.0,25.0,23.0,1
389,CC:2F:71:3E:C5:1F,3239142,409071908,11530,1410547,3227612,407661361,6,49150,4117061,40608,3104951,8542,1012110,12158,35,16521,188,6,850,130000.0,39000.0,-70.0,-70.0,-69.0,-61.0,-71.0,-73.0,-69.0,-61.0,-90.0,-93.0,-90.0,-93.0,20.0,23.0,21.0,32.0,1
390,CC:2F:71:3F:1F:24,11565242,13199962598,8337630,12792301237,3227612,407661361,94,1861541,1063938714,1852885,1062898804,8656,1039910,1800519,620,8342343,879007,94,6458,130000.0,43333.0,-70.0,-65.0,-72.0,-70.0,-69.0,-64.0,-71.0,-69.0,-90.0,-93.0,-90.0,-93.0,20.0,28.0,18.0,23.0,1
391,92:69:1D:31:68:E9,3249390,452613689,21774,44951924,3227616,407661765,0,10255,3359472,10171,3345425,84,14047,6752,1,21819,1076,0,95,229410.0,137640.0,-53.0,-51.0,-46.0,-50.0,-52.0,-50.0,-46.0,-50.0,-90.0,-93.0,-90.0,-93.0,37.0,42.0,44.0,43.0,1
392,BA:8C:B9:54:50:24,3260787,480480351,33169,72818384,3227618,407661967,0,12389,4043434,12292,4027061,97,16373,7854,6,33198,6127,0,145,216660.0,130000.0,-52.0,-55.0,-54.0,-45.0,-50.0,-53.0,-52.0,-48.0,-90.0,-93.0,-90.0,-93.0,38.0,38.0,36.0,48.0,1
393,62:47:05:9D:EB:15,3230804,415265529,3184,7603360,3227620,407662169,0,830,148429,792,141681,38,6748,398,0,3216,1151,0,9,229410.0,137640.0,-45.0,-49.0,-48.0,-47.0,-44.0,-39.0,-43.0,-40.0,-90.0,-93.0,-90.0,-93.0,45.0,44.0,42.0,46.0,1
394,F8:59:71:5A:E0:3D,3463806,762593010,236186,354930841,3227620,407662169,3,234855,312630748,229952,312045008,4903,585740,211840,19,238937,5261,3,676,144444.0,43333.0,-68.0,-72.0,-65.0,-70.0,-68.0,-72.0,-65.0,-70.0,-90.0,-93.0,-90.0,-93.0,22.0,21.0,25.0,23.0,1
395,CC:2F:71:3E:C5:1F,3239150,409072716,11530,1410547,3227620,407662169,6,49150,4117061,40608,3104951,8542,1012110,12158,35,16521,188,6,850,130000.0,39000.0,-70.0,-70.0,-69.0,-61.0,-71.0,-73.0,-69.0,-61.0,-90.0,-93.0,-90.0,-93.0,20.0,23.0,21.0,32.0,1
396,CC:2F:71:3F:1F:24,11566891,13202480433,8339271,12794818264,3227620,407662169,94,1861929,1064225587,1853273,1063185677,8656,1039910,1800905,620,8344004,879441,94,6458,104000.0,26000.0,-70.0,-65.0,-72.0,-70.0,-70.0,-65.0,-72.0,-69.0,-90.0,-93.0,-90.0,-93.0,20.0,28.0,18.0,23.0,1
397,92:69:1D:31:68:E9,3249395,452614153,21774,44951924,3227621,407662229,0,10255,3359472,10171,3345425,84,14047,6752,1,21819,1076,0,95,229410.0,137640.0,-53.0,-51.0,-46.0,-50.0,-52.0,-50.0,-46.0,-50.0,-90.0,-93.0,-90.0,-93.0,37.0,42.0,44.0,43.0,1
398,BA:8C:B9:54:50:24,3260790,480480613,33169,72818384,3227621,407662229,0,12389,4043434,12292,4027061,97,16373,7854,6,33198,6127,0,145,216660.0,130000.0,-52.0,-55.0,-54.0,-45.0,-50.0,-53.0,-52.0,-48.0,-90.0,-93.0,-90.0,-93.0,38.0,38.0,36.0,48.0,1
399,62:47:05:9D:EB:15,3230805,415265589,3184,7603360,3227621,407662229,0,830,148429,792,141681,38,6748,398,0,3216,1151,0,9,229410.0,137640.0,-45.0,-49.0,-48.0,-47.0,-44.0,-39.0,-43.0,-40.0,-90.0,-93.0,-90.0,-93.0,45.0,44.0,42.0,46.0,1
400,F8:59:71:5A:E0:3D,3463891,762723606,236270,355061377,3227621,407662229,3,234943,312766324,230040,312180584,4903,585740,211924,19,239021,5261,3,676,144444.0,43333.0,-68.0,-72.0,-65.0,-69.0,-68.0,-72.0,-65.0,-69.0,-90.0,-93.0,-90.0,-93.0,22.0,21.0,25.0,24.0,1
401,CC:2F:71:3E:C5:1F,3239153,409072978,11530,1410547,3227623,407662431,6,49150,4117061,40608,3104951,8542,1012110,12158,35,16521,188,6,850,130000.0,39000.0,-70.0,-70.0,-69.0,-61.0,-71.0,-73.0,-69.0,-61.0,-90.0,-93.0,-90.0,-93.0,20.0,23.0,21.0,32.0,1
402,CC:2F:71:3F:1F:24,11568869,13205502772,8341246,12797840341,3227623,407662431,94,1862412,1064528624,1853756,1063488714,8656,1039910,1801385,620,8345977,879604,94,6458,115556.0,28889.0,-70.0,-65.0,-72.0,-69.0,-70.0,-65.0,-72.0,-69.0,-90.0,-93.0,-90.0,-93.0,20.0,28.0,18.0,24.0,1
403,92:69:1D:31:68:E9,3249404,452615077,21775,44952040,3227629,407663037,0,10257,3359608,10173,3345561,84,14047,6752,1,21820,1076,0,95,229410.0,137640.0,-54.0,-51.0,-46.0,-51.0,-52.0,-51.0,-46.0,-50.0,-90.0,-93.0,-90.0,-93.0,36.0,42.0,44.0,42.0,1
404,BA:8C:B9:54:50:24,3260806,480482653,33177,72819616,3227629,407663037,0,12405,4052218,12308,4035845,97,16373,7861,6,33206,6127,0,146,216660.0,130000.0,-53.0,-56.0,-54.0,-46.0,-51.0,-54.0,-52.0,-47.0,-90.0,-93.0,-90.0,-93.0,37.0,37.0,36.0,47.0,1
405,62:47:05:9D:EB:15,3230814,415266457,3185,7603420,3227629,407663037,0,831,148497,793,141749,38,6748,398,0,3217,1151,0,9,216660.0,130000.0,-45.0,-49.0,-48.0,-47.0,-44.0,-40.0,-44.0,-41.0,-90.0,-93.0,-90.0,-93.0,45.0,44.0,42.0,46.0,1
406,F8:59:71:5A:E0:3D,3463990,762864390,236361,355201353,3227629,407663037,3,235034,312906562,230131,312320822,4903,585740,212014,19,239112,5264,3,676,144444.0,43333.0,-68.0,-72.0,-65.0,-70.0,-68.0,-72.0,-65.0,-69.0,-90.0,-93.0,-90.0,-93.0,22.0,21.0,25.0,23.0,1
407,CC:2F:71:3E:C5:1F,3239160,409073644,11531,1410607,3227629,407663037,6,49152,4117201,40610,3105091,8542,1012110,12158,35,16522,188,6,850,130000.0,39000.0,-71.0,-74.0,-70.0,-61.0,-70.0,-72.0,-68.0,-61.0,-90.0,-93.0,-90.0,-93.0,19.0,19.0,20.0,32.0,1
408,CC:2F:71:3F:1F:24,11570604,13208138831,8342975,12800475794,3227629,407663037,94,1862844,1064850699,1854188,1063810789,8656,1039910,1801814,620,8347708,879723,94,6458,115556.0,28889.0,-69.0,-64.0,-72.0,-69.0,-69.0,-64.0,-72.0,-69.0,-90.0,-93.0,-90.0,-93.0,21.0,29.0,18.0,24.0,1
409,92:69:1D:31:68:E9,3249410,452615841,21775,44952040,3227635,407663801,0,10257,3359608,10173,3345561,84,14047,6752,1,21820,1076,0,95,229410.0,137640.0,-54.0,-51.0,-46.0,-51.0,-52.0,-51.0,-46.0,-50.0,-90.0,-93.0,-90.0,-93.0,36.0,42.0,44.0,42.0,1
410,BA:8C:B9:54:50:24,3260813,480483485,33177,72819616,3227636,407663869,0,12405,4052218,12308,4035845,97,16373,7861,6,33206,6127,0,146,216660.0,130000.0,-53.0,-56.0,-54.0,-46.0,-51.0,-54.0,-52.0,-47.0,-90.0,-93.0,-90.0,-93.0,37.0,37.0,36.0,47.0,1
411,62:47:05:9D:EB:15,3230821,415267289,3185,7603420,3227636,407663869,0,832,148565,794,141817,38,6748,398,0,3217,1151,0,9,216660.0,130000.0,-45.0,-49.0,-48.0,-47.0,-44.0,-42.0,-44.0,-42.0,-90.0,-93.0,-90.0,-93.0,45.0,44.0,42.0,46.0,1
412,F8:59:71:5A:E0:3D,3464098,763019270,236460,355355199,3227638,407664071,3,235133,313059344,230230,312473604,4903,585740,212113,19,239211,5267,3,681,144444.0,43333.0,-68.0,-72.0,-65.0,-69.0,-68.0,-72.0,-65.0,-69.0,-90.0,-93.0,-90.0,-93.0,22.0,21.0,25.0,24.0,1
413,CC:2F:71:3E:C5:1F,3239171,409074880,11531,1410607,3227640,407664273,6,49152,4117201,40610,3105091,8542,1012110,12158,35,16522,188,6,850,130000.0,39000.0,-71.0,-74.0,-70.0,-61.0,-70.0,-72.0,-68.0,-61.0,-90.0,-93.0,-90.0,-93.0,19.0,19.0,20.0,32.0,1
414,CC:2F:71:3F:1F:24,11571921,13210122428,8344281,12802458155,3227640,407664273,94,1863267,1065198487,1854611,1064158577,8656,1039910,1802230,620,8348993,880094,94,6459,104000.0,26000.0,-69.0,-65.0,-72.0,-69.0,-69.0,-65.0,-72.0,-69.0,-90.0,-93.0,-90.0,-93.0,21.0,28.0,18.0,24.0,1
415,92:69:1D:31:68:E9,3249571,453026360,21931,45362087,3227640,407664273,0,10282,3364949,10198,3350902,84,14047,6766,1,21976,1076,0,95,229410.0,137640.0,-53.0,-51.0,-46.0,-51.0,-50.0,-50.0,-45.0,-49.0,-89.0,-93.0,-89.0,-93.0,36.0,42.0,43.0,42.0,1
416,BA:8C:B9:54:50:24,3260818,480484005,33178,72819732,3227640,407664273,0,12409,4052528,12312,4036155,97,16373,7862,6,33207,6127,0,146,216660.0,130000.0,-53.0,-56.0,-54.0,-46.0,-52.0,-55.0,-53.0,-46.0,-89.0,-93.0,-89.0,-93.0,36.0,37.0,35.0,47.0,1
417,62:47:05:9D:EB:15,3230825,415267693,3185,7603420,3227640,407664273,0,832,148565,794,141817,38,6748,398,0,3217,1151,0,9,216660.0,130000.0,-45.0,-49.0,-48.0,-47.0,-44.0,-42.0,-44.0,-42.0,-89.0,-93.0,-89.0,-93.0,44.0,44.0,41.0,46.0,1
418,F8:59:71:5A:E0:3D,3464193,763161088,236551,355496613,3227642,407664475,3,235225,313201024,230322,312615284,4903,585740,212205,19,239302,5272,3,681,144444.0,43333.0,-68.0,-72.0,-65.0,-69.0,-68.0,-71.0,-65.0,-69.0,-89.0,-93.0,-89.0,-93.0,21.0,21.0,24.0,24.0,1
419,CC:2F:71:3E:C5:1F,3239173,409075082,11531,1410607,3227642,407664475,6,49152,4117201,40610,3105091,8542,1012110,12158,35,16522,188,6,850,130000.0,39000.0,-71.0,-74.0,-70.0,-61.0,-70.0,-72.0,-68.0,-61.0,-89.0,-93.0,-89.0,-93.0,18.0,19.0,19.0,32.0,1
420,CC:2F:71:3F:1F:24,11573587,13212677520,8345944,12805012985,3227643,407664535,94,1863713,1065504543,1855057,1064464633,8656,1039910,1802670,620,8350656,880297,94,6460,115556.0,28889.0,-69.0,-64.0,-71.0,-69.0,-69.0,-64.0,-71.0,-69.0,-89.0,-93.0,-89.0,-93.0,20.0,29.0,18.0,24.0,1
421,92:69:1D:31:68:E9,3249581,453027290,21931,45362087,3227650,407665203,0,10282,3364949,10198,3350902,84,14047,6766,1,21976,1076,0,95,229410.0,137640.0,-53.0,-51.0,-46.0,-51.0,-50.0,-50.0,-45.0,-49.0,-89.0,-93.0,-89.0,-93.0,36.0,42.0,43.0,42.0,1
422,BA:8C:B9:54:50:24,3261075,481138289,33425,73473086,3227650,407665203,0,12447,4059532,12349,4043037,98,16495,7882,6,33454,6168,0,146,229410.0,130000.0,-53.0,-56.0,-54.0,-46.0,-51.0,-56.0,-53.0,-50.0,-89.0,-93.0,-89.0,-93.0,36.0,37.0,35.0,47.0,1
423,62:47:05:9D:EB:15,3230835,415268623,3185,7603420,3227650,407665203,0,832,148565,794,141817,38,6748,398,0,3217,1151,0,9,216660.0,130000.0,-45.0,-49.0,-48.0,-47.0,-44.0,-42.0,-44.0,-42.0,-89.0,-93.0,-89.0,-93.0,44.0,44.0,41.0,46.0,1
424,F8:59:71:5A:E0:3D,3464289,763298568,236639,355633365,3227650,407665203,3,235314,313338098,230411,312752358,4903,585740,212293,19,239390,5274,3,681,144444.0,43333.0,-68.0,-72.0,-65.0,-69.0,-68.0,-72.0,-65.0,-69.0,-89.0,-93.0,-89.0,-93.0,21.0,21.0,24.0,24.0,1
425,CC:2F:71:3E:C5:1F,3239181,409075810,11531,1410607,3227650,407665203,6,49152,4117201,40610,3105091,8542,1012110,12158,35,16522,188,6,850,130000.0,39000.0,-71.0,-74.0,-70.0,-61.0,-70.0,-72.0,-68.0,-61.0,-89.0,-93.0,-89.0,-93.0,18.0,19.0,19.0,32.0,1
426,CC:2F:71:3F:1F:24,11575464,13215557560,8347814,12807892357,3227650,407665203,94,1864168,1065806423,1855512,1064766513,8656,1039910,1803107,620,8352545,880494,94,6460,115556.0,28889.0,-69.0,-64.0,-71.0,-69.0,-69.0,-64.0,-71.0,-69.0,-89.0,-93.0,-89.0,-93.0,20.0,29.0,18.0,24.0,1
427,92:69:1D:31:68:E9,3249583,453027492,21931,45362087,3227652,407665405,0,10282,3364949,10198,3350902,84,14047,6766,1,21976,1076,0,95,229410.0,137640.0,-53.0,-51.0,-46.0,-51.0,-50.0,-50.0,-45.0,-49.0,-89.0,-93.0,-89.0,-93.0,36.0,42.0,43.0,42.0,1
428,BA:8C:B9:54:50:24,3261077,481138491,33425,73473086,3227652,407665405,0,12447,4059532,12349,4043037,98,16495,7882,6,33454,6168,0,146,229410.0,130000.0,-53.0,-56.0,-54.0,-46.0,-51.0,-56.0,-53.0,-50.0,-89.0,-93.0,-89.0,-93.0,36.0,37.0,35.0,47.0,1
429,62:47:05:9D:EB:15,3230837,415268825,3185,7603420,3227652,407665405,0,832,148565,794,141817,38,6748,398,0,3217,1151,0,9,216660.0,130000.0,-45.0,-49.0,-48.0,-47.0,-44.0,-42.0,-44.0,-42.0,-89.0,-93.0,-89.0,-93.0,44.0,44.0,41.0,46.0,1
430,F8:59:71:5A:E0:3D,3464374,763424846,236720,355759239,3227654,407665607,3,235394,313461298,230491,312875558,4903,585740,212373,19,239471,5274,3,681,144444.0,43333.0,-68.0,-72.0,-65.0,-69.0,-68.0,-72.0,-65.0,-69.0,-88.0,-93.0,-89.0,-93.0,20.0,21.0,24.0,24.0,1
431,CC:2F:71:3E:C5:1F,3239185,409076214,11531,1410607,3227654,407665607,6,49152,4117201,40610,3105091,8542,1012110,12158,35,16522,188,6,850,130000.0,39000.0,-71.0,-74.0,-70.0,-61.0,-70.0,-72.0,-68.0,-61.0,-88.0,-93.0,-89.0,-93.0,17.0,19.0,19.0,32.0,1
432,CC:2F:71:3F:1F:24,11577053,13217981206,8349398,12810315537,3227655,407665669,94,1864596,1066102492,1855940,1065062582,8656,1039910,1803523,620,8354131,880786,94,6460,115556.0,28889.0,-69.0,-64.0,-71.0,-69.0,-69.0,-64.0,-71.0,-68.0,-88.0,-93.0,-89.0,-93.0,19.0,29.0,18.0,24.0,1
433,92:69:1D:31:68:E9,3249597,453031521,21937,45365388,3227660,407666133,0,10294,3368225,10210,3354178,84,14047,6771,1,21982,1076,0,95,216660.0,130000.0,-52.0,-51.0,-46.0,-49.0,-50.0,-50.0,-46.0,-48.0,-88.0,-93.0,-89.0,-93.0,36.0,42.0,43.0,44.0,1
434,BA:8C:B9:54:50:24,3261087,481139397,33426,73473202,3227661,407666195,0,12450,4059774,12352,4043279,98,16495,7883,6,33455,6168,0,146,229410.0,130000.0,-53.0,-56.0,-54.0,-46.0,-51.0,-55.0,-52.0,-51.0,-88.0,-93.0,-89.0,-93.0,35.0,37.0,35.0,47.0,1
435,62:47:05:9D:EB:15,3230846,415269615,3185,7603420,3227661,407666195,0,832,148565,794,141817,38,6748,398,0,3217,1151,0,9,216660.0,130000.0,-45.0,-49.0,-48.0,-47.0,-44.0,-42.0,-44.0,-42.0,-88.0,-93.0,-88.0,-93.0,43.0,44.0,40.0,46.0,1
436,F8:59:71:5A:E0:3D,3464470,763563628,236809,355897433,3227661,407666195,3,235485,313600086,230581,313014228,4904,585858,212464,19,239560,5287,3,681,144444.0,43333.0,-68.0,-72.0,-65.0,-69.0,-68.0,-72.0,-65.0,-69.0,-88.0,-93.0,-88.0,-93.0,20.0,21.0,23.0,24.0,1
437,CC:2F:71:3E:C5:1F,3239192,409076802,11531,1410607,3227661,407666195,6,49155,4117507,40611,3105161,8544,1012346,12159,35,16522,188,6,851,130000.0,39000.0,-71.0,-73.0,-69.0,-61.0,-71.0,-73.0,-69.0,-63.0,-88.0,-93.0,-88.0,-93.0,17.0,20.0,19.0,32.0,1
438,CC:2F:71:3F:1F:24,11578348,13219906027,8350685,12812239630,3227663,407666397,94,1865006,1066443389,1856350,1065403479,8656,1039910,1803914,620,8355412,881011,94,6461,130000.0,39000.0,-69.0,-64.0,-72.0,-69.0,-68.0,-64.0,-71.0,-69.0,-88.0,-93.0,-88.0,-93.0,19.0,29.0,16.0,24.0,1
439,92:69:1D:31:68:E9,3249746,453355689,22057,45678040,3227689,407677649,0,10322,3374205,10238,3360158,84,14047,6788,1,22102,1098,0,95,216660.0,130000.0,-52.0,-51.0,-46.0,-50.0,-49.0,-50.0,-46.0,-48.0,-88.0,-93.0,-88.0,-93.0,36.0,42.0,42.0,43.0,1
440,BA:8C:B9:54:50:24,3261116,481150985,33426,73473202,3227690,407677783,0,12450,4059774,12352,4043279,98,16495,7883,6,33455,6168,0,146,229410.0,130000.0,-53.0,-56.0,-54.0,-46.0,-51.0,-55.0,-52.0,-51.0,-88.0,-93.0,-88.0,-93.0,35.0,37.0,34.0,47.0,1
441,62:47:05:9D:EB:15,3230876,415281271,3185,7603420,3227691,407677851,0,832,148565,794,141817,38,6748,398,0,3217,1151,0,9,216660.0,130000.0,-45.0,-49.0,-48.0,-47.0,-44.0,-42.0,-44.0,-42.0,-87.0,-93.0,-88.0,-92.0,42.0,44.0,40.0,45.0,1
442,F8:59:71:5A:E0:3D,3464596,763724468,236905,356046617,3227691,407677851,3,235580,313746498,230676,313160640,4904,585858,212559,19,239656,5287,3,681,144444.0,43333.0,-68.0,-72.0,-65.0,-69.0,-68.0,-72.0,-65.0,-69.0,-87.0,-93.0,-88.0,-92.0,19.0,21.0,23.0,23.0,1
443,CC:2F:71:3E:C5:1F,3239222,409088458,11531,1410607,3227691,407677851,6,49155,4117507,40611,3105161,8544,1012346,12159,35,16522,188,6,851,130000.0,39000.0,-71.0,-73.0,-69.0,-61.0,-71.0,-73.0,-69.0,-63.0,-87.0,-93.0,-88.0,-92.0,16.0,20.0,19.0,31.0,1
444,CC:2F:71:3F:1F:24,11579626,13221724690,8351935,12814046839,3227691,407677851,94,1865454,1066775480,1856798,1065735570,8656,1039910,1804352,620,8356664,881251,94,6461,130000.0,43333.0,-69.0,-63.0,-71.0,-69.0,-68.0,-63.0,-71.0,-69.0,-87.0,-93.0,-88.0,-92.0,18.0,30.0,17.0,23.0,1
445,92:69:1D:31:68:E9,3249753,453356331,22058,45678156,3227695,407678175,0,10328,3374705,10243,3360536,85,14169,6790,1,22103,1098,0,95,216660.0,130000.0,-49.0,-49.0,-46.0,-49.0,-50.0,-50.0,-46.0,-50.0,-87.0,-93.0,-88.0,-92.0,38.0,44.0,42.0,43.0,1
446,BA:8C:B9:54:50:24,3261121,481151377,33426,73473202,3227695,407678175,0,12450,4059774,12352,4043279,98,16495,7883,6,33455,6168,0,146,229410.0,130000.0,-53.0,-56.0,-54.0,-46.0,-51.0,-55.0,-52.0,-51.0,-87.0,-93.0,-88.0,-92.0,34.0,37.0,34.0,46.0,1
447,62:47:05:9D:EB:15,3230880,415281595,3185,7603420,3227695,407678175,0,834,148701,796,141953,38,6748,398,0,3218,1151,0,9,216660.0,130000.0,-45.0,-38.0,-43.0,-39.0,-44.0,-42.0,-44.0,-42.0,-87.0,-93.0,-88.0,-92.0,42.0,55.0,45.0,53.0,1
448,F8:59:71:5A:E0:3D,3464688,763858638,236991,356180261,3227697,407678377,3,235667,313880492,230763,313294634,4904,585858,212645,19,239742,5288,3,681,144444.0,43333.0,-68.0,-72.0,-65.0,-69.0,-68.0,-72.0,-65.0,-69.0,-87.0,-93.0,-87.0,-92.0,19.0,21.0,22.0,23.0,1
449,CC:2F:71:3E:C5:1F,3239228,409088984,11531,1410607,3227697,407678377,6,49155,4117507,40611,3105161,8544,1012346,12159,35,16522,188,6,851,130000.0,39000.0,-71.0,-73.0,-69.0,-61.0,-71.0,-73.0,-69.0,-63.0,-87.0,-93.0,-87.0,-92.0,16.0,20.0,18.0,31.0,1
450,CC:2F:71:3F:1F:24,11581234,13224097514,8353537,12816419137,3227697,407678377,94,1865936,1067080958,1857280,1066041048,8656,1039910,1804826,620,8358265,881550,94,6461,130000.0,43333.0,-69.0,-64.0,-72.0,-69.0,-69.0,-64.0,-71.0,-69.0,-87.0,-93.0,-87.0,-92.0,18.0,29.0,15.0,23.0,1
451,92:69:1D:31:68:E9,3249761,453357272,22058,45678156,3227703,407679116,0,10330,3374841,10245,3360672,85,14169,6790,1,22103,1098,0,95,216660.0,130000.0,-53.0,-51.0,-46.0,-50.0,-50.0,-50.0,-46.0,-50.0,-87.0,-93.0,-87.0,-92.0,34.0,42.0,41.0,42.0,1
452,BA:8C:B9:54:50:24,3261129,481152318,33426,73473202,3227703,407679116,0,12450,4059774,12352,4043279,98,16495,7883,6,33455,6168,0,146,229410.0,130000.0,-53.0,-56.0,-54.0,-46.0,-51.0,-55.0,-52.0,-51.0,-87.0,-93.0,-87.0,-92.0,34.0,37.0,33.0,46.0,1
453,62:47:05:9D:EB:15,3230888,415282536,3185,7603420,3227703,407679116,0,834,148701,796,141953,38,6748,398,0,3218,1151,0,9,216660.0,130000.0,-45.0,-38.0,-43.0,-39.0,-44.0,-42.0,-44.0,-42.0,-87.0,-93.0,-87.0,-92.0,42.0,55.0,44.0,53.0,1
454,F8:59:71:5A:E0:3D,3464774,763983697,237071,356304581,3227703,407679116,3,235748,314005232,230844,313419374,4904,585858,212726,19,239822,5289,3,681,144444.0,43333.0,-68.0,-72.0,-65.0,-69.0,-68.0,-71.0,-65.0,-69.0,-87.0,-93.0,-87.0,-92.0,19.0,21.0,22.0,23.0,1
455,CC:2F:71:3E:C5:1F,3239234,409089723,11531,1410607,3227703,407679116,6,49155,4117507,40611,3105161,8544,1012346,12159,35,16522,188,6,851,130000.0,39000.0,-71.0,-73.0,-69.0,-61.0,-71.0,-73.0,-69.0,-63.0,-86.0,-93.0,-87.0,-92.0,15.0,20.0,18.0,31.0,1
456,CC:2F:71:3F:1F:24,11583202,13227003391,8355499,12819324275,3227703,407679116,94,1866451,1067395578,1857794,1066355550,8657,1040028,1805331,620,8360232,881868,94,6461,130000.0,43333.0,-69.0,-64.0,-71.0,-69.0,-68.0,-64.0,-71.0,-69.0,-86.0,-93.0,-87.0,-92.0,17.0,29.0,16.0,23.0,1
457,92:69:1D:31:68:E9,3249766,453357736,22058,45678156,3227708,407679580,0,10330,3374841,10245,3360672,85,14169,6790,1,22103,1098,0,95,216660.0,130000.0,-53.0,-51.0,-46.0,-50.0,-50.0,-50.0,-46.0,-50.0,-86.0,-93.0,-87.0,-92.0,33.0,42.0,41.0,42.0,1
458,BA:8C:B9:54:50:24,3261134,481152782,33426,73473202,3227708,407679580,0,12450,4059774,12352,4043279,98,16495,7883,6,33455,6168,0,146,229410.0,130000.0,-53.0,-56.0,-54.0,-46.0,-51.0,-55.0,-52.0,-51.0,-86.0,-93.0,-87.0,-92.0,33.0,37.0,33.0,46.0,1
459,62:47:05:9D:EB:15,3230894,415283068,3185,7603420,3227709,407679648,0,834,148701,796,141953,38,6748,398,0,3218,1151,0,9,216660.0,130000.0,-45.0,-38.0,-43.0,-39.0,-44.0,-42.0,-44.0,-42.0,-86.0,-93.0,-87.0,-92.0,41.0,55.0,44.0,53.0,1
460,F8:59:71:5A:E0:3D,3464881,764136857,237169,356456873,3227712,407679984,3,235846,314156152,230942,313570294,4904,585858,212824,19,239920,5289,3,681,144444.0,43333.0,-68.0,-72.0,-65.0,-69.0,-68.0,-72.0,-65.0,-69.0,-85.0,-93.0,-86.0,-92.0,17.0,21.0,21.0,23.0,1
461,CC:2F:71:3E:C5:1F,3239243,409090591,11531,1410607,3227712,407679984,6,49155,4117507,40611,3105161,8544,1012346,12159,35,16522,188,6,851,130000.0,39000.0,-71.0,-73.0,-69.0,-61.0,-71.0,-73.0,-69.0,-63.0,-85.0,-93.0,-86.0,-92.0,14.0,20.0,17.0,31.0,1
462,CC:2F:71:3F:1F:24,11585569,13230554691,8357857,12822874707,3227712,407679984,94,1867044,1067760291,1858387,1066720263,8657,1040028,1805894,620,8362555,882195,94,6461,115556.0,28889.0,-70.0,-64.0,-72.0,-69.0,-69.0,-64.0,-71.0,-69.0,-85.0,-93.0,-86.0,-92.0,15.0,29.0,14.0,23.0,1
463,92:69:1D:31:68:E9,3249774,453358564,22058,45678156,3227716,407680408,0,10333,3375148,10247,3360808,86,14340,6791,1,22103,1098,0,95,216660.0,130000.0,-51.0,-53.0,-51.0,-55.0,-50.0,-50.0,-46.0,-50.0,-85.0,-93.0,-86.0,-92.0,34.0,40.0,35.0,37.0,1
464,BA:8C:B9:54:50:24,3261142,481153610,33426,73473202,3227716,407680408,0,12457,4060353,12358,4043687,99,16666,7884,6,33455,6168,0,146,229410.0,130000.0,-53.0,-56.0,-54.0,-46.0,-51.0,-56.0,-53.0,-50.0,-85.0,-93.0,-86.0,-92.0,32.0,37.0,32.0,46.0,1
465,62:47:05:9D:EB:15,3230901,415283828,3185,7603420,3227716,407680408,0,834,148701,796,141953,38,6748,398,0,3218,1151,0,9,216660.0,130000.0,-45.0,-38.0,-43.0,-39.0,-44.0,-42.0,-44.0,-42.0,-85.0,-92.0,-86.0,-91.0,40.0,54.0,43.0,52.0,1
466,F8:59:71:5A:E0:3D,3464985,764289775,237267,356609165,3227718,407680610,3,235943,314305686,231039,313719828,4904,585858,212921,19,240018,5290,3,683,144444.0,43333.0,-68.0,-72.0,-66.0,-69.0,-68.0,-71.0,-65.0,-69.0,-85.0,-92.0,-86.0,-91.0,17.0,20.0,20.0,22.0,1
467,CC:2F:71:3E:C5:1F,3239249,409091217,11531,1410607,3227718,407680610,6,49155,4117507,40611,3105161,8544,1012346,12159,35,16522,188,6,851,130000.0,39000.0,-71.0,-73.0,-69.0,-61.0,-71.0,-73.0,-69.0,-63.0,-85.0,-92.0,-86.0,-91.0,14.0,19.0,17.0,30.0,1
468,CC:2F:71:3F:1F:24,11587560,13233492107,8359842,12825811497,3227718,407680610,94,1867680,1068124591,1859023,1067084563,8657,1040028,1806513,620,8364549,882322,94,6462,115556.0,28889.0,-70.0,-64.0,-72.0,-69.0,-69.0,-64.0,-71.0,-69.0,-85.0,-92.0,-86.0,-91.0,15.0,28.0,14.0,22.0,1
469,92:69:1D:31:68:E9,3249781,453359230,22058,45678156,3227723,407681074,0,10333,3375148,10247,3360808,86,14340,6791,1,22103,1098,0,95,216660.0,130000.0,-51.0,-53.0,-51.0,-55.0,-50.0,-50.0,-46.0,-50.0,-85.0,-92.0,-86.0,-91.0,34.0,39.0,35.0,36.0,1
470,BA:8C:B9:54:50:24,3261149,481154276,33426,73473202,3227723,407681074,0,12457,4060353,12358,4043687,99,16666,7884,6,33455,6168,0,146,229410.0,130000.0,-53.0,-56.0,-54.0,-46.0,-51.0,-56.0,-53.0,-50.0,-85.0,-92.0,-86.0,-91.0,32.0,36.0,32.0,45.0,1
471,62:47:05:9D:EB:15,3230908,415284494,3185,7603420,3227723,407681074,0,834,148701,796,141953,38,6748,398,0,3218,1151,0,9,216660.0,130000.0,-45.0,-38.0,-43.0,-39.0,-44.0,-42.0,-44.0,-42.0,-84.0,-92.0,-85.0,-91.0,39.0,54.0,42.0,52.0,1
472,F8:59:71:5A:E0:3D,3465078,764426991,237355,356745917,3227723,407681074,3,236031,314441206,231127,313855348,4904,585858,213009,19,240105,5291,3,683,144444.0,43333.0,-68.0,-72.0,-65.0,-69.0,-68.0,-72.0,-65.0,-69.0,-84.0,-92.0,-85.0,-91.0,16.0,20.0,20.0,22.0,1
473,CC:2F:71:3E:C5:1F,3239254,409091681,11531,1410607,3227723,407681074,6,49155,4117507,40611,3105161,8544,1012346,12159,35,16522,188,6,851,130000.0,39000.0,-71.0,-73.0,-69.0,-61.0,-71.0,-73.0,-69.0,-63.0,-84.0,-92.0,-85.0,-91.0,13.0,19.0,16.0,30.0,1
474,CC:2F:71:3F:1F:24,11589011,13235654736,8361288,12827973662,3227723,407681074,94,1868107,1068431783,1859450,1067391755,8657,1040028,1806935,620,8366021,882339,94,6462,115556.0,28889.0,-69.0,-64.0,-71.0,-68.0,-69.0,-64.0,-70.0,-68.0,-84.0,-92.0,-85.0,-91.0,15.0,28.0,14.0,23.0,1
475,92:69:1D:31:68:E9,3249785,453359634,22058,45678156,3227727,407681478,0,10333,3375148,10247,3360808,86,14340,6791,1,22103,1098,0,95,216660.0,130000.0,-51.0,-53.0,-51.0,-55.0,-50.0,-50.0,-46.0,-50.0,-84.0,-92.0,-85.0,-91.0,33.0,39.0,34.0,36.0,1
476,BA:8C:B9:54:50:24,3261153,481154680,33426,73473202,3227727,407681478,0,12457,4060353,12358,4043687,99,16666,7884,6,33455,6168,0,146,229410.0,130000.0,-53.0,-56.0,-54.0,-46.0,-51.0,-56.0,-53.0,-50.0,-84.0,-92.0,-85.0,-91.0,31.0,36.0,31.0,45.0,1
477,62:47:05:9D:EB:15,3230912,415284898,3185,7603420,3227727,407681478,0,834,148701,796,141953,38,6748,398,0,3218,1151,0,9,216660.0,130000.0,-45.0,-38.0,-43.0,-39.0,-44.0,-42.0,-44.0,-42.0,-84.0,-92.0,-85.0,-91.0,39.0,54.0,42.0,52.0,1
478,F8:59:71:5A:E0:3D,3465165,764554957,237437,356873345,3227728,407681612,3,236116,314572134,231212,313986276,4904,585858,213092,19,240188,5292,3,683,144444.0,43333.0,-68.0,-72.0,-66.0,-70.0,-68.0,-71.0,-65.0,-69.0,-84.0,-92.0,-85.0,-91.0,16.0,20.0,19.0,21.0,1
479,CC:2F:71:3E:C5:1F,3239262,409092489,11531,1410607,3227731,407681882,6,49155,4117507,40611,3105161,8544,1012346,12159,35,16522,188,6,851,130000.0,39000.0,-71.0,-73.0,-69.0,-61.0,-71.0,-73.0,-69.0,-63.0,-84.0,-92.0,-85.0,-91.0,13.0,19.0,16.0,30.0,1
480,CC:2F:71:3F:1F:24,11590293,13237588724,8362562,12829906842,3227731,407681882,94,1868478,1068731438,1859821,1067691410,8657,1040028,1807281,620,8367295,882396,94,6463,115556.0,28889.0,-70.0,-64.0,-71.0,-69.0,-69.0,-64.0,-70.0,-68.0,-84.0,-92.0,-85.0,-91.0,14.0,28.0,14.0,22.0,1
481,92:69:1D:31:68:E9,3249792,453360300,22058,45678156,3227734,407682144,0,10342,3375812,10256,3361472,86,14340,6792,1,22103,1098,0,96,216660.0,130000.0,-53.0,-51.0,-46.0,-51.0,-50.0,-50.0,-46.0,-50.0,-84.0,-92.0,-85.0,-91.0,31.0,41.0,39.0,40.0,1
482,BA:8C:B9:54:50:24,3261472,481973962,33736,74291616,3227736,407682346,0,12496,4068675,12397,4052009,99,16666,7913,6,33765,6752,0,146,216660.0,130000.0,-52.0,-57.0,-55.0,-52.0,-52.0,-56.0,-54.0,-51.0,-84.0,-92.0,-85.0,-91.0,32.0,35.0,30.0,39.0,1
483,62:47:05:9D:EB:15,3230921,415285766,3185,7603420,3227736,407682346,0,834,148701,796,141953,38,6748,398,0,3218,1151,0,9,216660.0,130000.0,-45.0,-38.0,-43.0,-39.0,-44.0,-42.0,-44.0,-42.0,-84.0,-92.0,-85.0,-91.0,39.0,54.0,42.0,52.0,1
484,F8:59:71:5A:E0:3D,3465310,764768477,237574,357086131,3227736,407682346,3,236252,314781980,231348,314196122,4904,585858,213228,19,240325,5323,3,683,144444.0,39000.0,-68.0,-73.0,-65.0,-69.0,-68.0,-73.0,-65.0,-69.0,-84.0,-92.0,-85.0,-91.0,16.0,19.0,20.0,22.0,1
485,CC:2F:71:3E:C5:1F,3239267,409092953,11531,1410607,3227736,407682346,6,49155,4117507,40611,3105161,8544,1012346,12159,35,16522,188,6,851,130000.0,39000.0,-71.0,-73.0,-69.0,-61.0,-71.0,-73.0,-69.0,-63.0,-84.0,-92.0,-85.0,-91.0,13.0,19.0,16.0,30.0,1
486,CC:2F:71:3F:1F:24,11591793,13239860888,8364053,12832178138,3227740,407682750,94,1869010,1069209152,1860353,1068169124,8657,1040028,1807779,620,8368786,882782,94,6463,115556.0,28889.0,-68.0,-64.0,-71.0,-69.0,-68.0,-64.0,-71.0,-69.0,-84.0,-92.0,-85.0,-91.0,16.0,28.0,14.0,22.0,1
487,92:69:1D:31:68:E9,3249798,453360906,22058,45678156,3227740,407682750,0,10342,3375812,10256,3361472,86,14340,6792,1,22103,1098,0,96,216660.0,130000.0,-53.0,-51.0,-46.0,-51.0,-50.0,-50.0,-46.0,-50.0,-84.0,-92.0,-85.0,-90.0,31.0,41.0,39.0,39.0,1
488,BA:8C:B9:54:50:24,3261478,481974568,33736,74291616,3227742,407682952,0,12501,4069015,12402,4052349,99,16666,7913,6,33765,6752,0,147,216660.0,130000.0,-54.0,-56.0,-54.0,-45.0,-50.0,-54.0,-52.0,-48.0,-84.0,-92.0,-85.0,-90.0,30.0,36.0,31.0,45.0,1
489,62:47:05:9D:EB:15,3230927,415286372,3185,7603420,3227742,407682952,0,834,148701,796,141953,38,6748,398,0,3218,1151,0,9,216660.0,130000.0,-45.0,-38.0,-43.0,-39.0,-44.0,-42.0,-44.0,-42.0,-84.0,-92.0,-85.0,-90.0,39.0,54.0,42.0,51.0,1
490,F8:59:71:5A:E0:3D,3465397,764894901,237655,357211949,3227742,407682952,3,236333,314906720,231429,314320862,4904,585858,213309,19,240406,5323,3,683,144444.0,43333.0,-67.0,-72.0,-65.0,-70.0,-67.0,-72.0,-65.0,-70.0,-84.0,-92.0,-85.0,-90.0,17.0,20.0,20.0,20.0,1
491,CC:2F:71:3E:C5:1F,3239274,409093619,11531,1410607,3227743,407683012,6,49155,4117507,40611,3105161,8544,1012346,12159,35,16522,188,6,851,130000.0,39000.0,-71.0,-73.0,-69.0,-61.0,-71.0,-73.0,-69.0,-63.0,-84.0,-92.0,-85.0,-90.0,13.0,19.0,16.0,29.0,1
492,CC:2F:71:3F:1F:24,11593154,13241914770,8365411,12834231758,3227743,407683012,94,1869412,1069510820,1860755,1068470792,8657,1040028,1808173,620,8370144,882850,94,6463,115556.0,28889.0,-68.0,-63.0,-72.0,-69.0,-68.0,-63.0,-71.0,-68.0,-84.0,-92.0,-85.0,-90.0,16.0,29.0,13.0,21.0,1
493,92:69:1D:31:68:E9,3249964,453780506,22217,46097090,3227747,407683416,0,10367,3381603,10281,3367263,86,14340,6808,1,22262,1105,0,96,229410.0,130000.0,-49.0,-48.0,-45.0,-49.0,-49.0,-48.0,-45.0,-48.0,-83.0,-92.0,-85.0,-90.0,34.0,44.0,40.0,41.0,1
494,BA:8C:B9:54:50:24,3261507,482003312,33758,74319694,3227749,407683618,0,12508,4069824,12409,4053158,99,16666,7915,6,33787,6752,0,147,216660.0,130000.0,-55.0,-57.0,-53.0,-45.0,-52.0,-56.0,-53.0,-48.0,-83.0,-92.0,-85.0,-90.0,28.0,35.0,32.0,45.0,1
495,62:47:05:9D:EB:15,3230934,415287038,3185,7603420,3227749,407683618,0,834,148701,796,141953,38,6748,398,0,3218,1151,0,9,216660.0,130000.0,-45.0,-38.0,-43.0,-39.0,-44.0,-42.0,-44.0,-42.0,-83.0,-92.0,-85.0,-90.0,38.0,54.0,42.0,51.0,1
496,F8:59:71:5A:E0:3D,3465497,765040089,237748,357356471,3227749,407683618,3,236428,315053076,231524,314467218,4904,585858,213403,19,240499,5323,3,683,144444.0,43333.0,-68.0,-72.0,-65.0,-69.0,-67.0,-71.0,-65.0,-69.0,-83.0,-92.0,-85.0,-90.0,15.0,20.0,20.0,21.0,1
497,CC:2F:71:3E:C5:1F,3239280,409094225,11531,1410607,3227749,407683618,6,49155,4117507,40611,3105161,8544,1012346,12159,35,16522,188,6,851,130000.0,39000.0,-71.0,-73.0,-69.0,-61.0,-71.0,-73.0,-69.0,-63.0,-83.0,-92.0,-85.0,-90.0,12.0,19.0,16.0,29.0,1
498,CC:2F:71:3F:1F:24,11594460,13243893776,8366711,12836210158,3227749,407683618,94,1869853,1069866834,1861196,1068826806,8657,1040028,1808580,620,8371444,883234,94,6463,86667.0,14444.0,-68.0,-63.0,-72.0,-70.0,-68.0,-63.0,-72.0,-70.0,-83.0,-92.0,-85.0,-90.0,15.0,29.0,13.0,20.0,1
499,92:69:1D:31:68:E9,3249970,453781112,22217,46097090,3227753,407684022,0,10368,3381671,10282,3367331,86,14340,6808,1,22262,1105,0,96,229410.0,130000.0,-54.0,-50.0,-45.0,-50.0,-49.0,-48.0,-45.0,-48.0,-83.0,-92.0,-85.0,-90.0,29.0,42.0,40.0,40.0,1
500,BA:8C:B9:54:50:24,3261511,482003716,33758,74319694,3227753,407684022,0,12508,4069824,12409,4053158,99,16666,7915,6,33787,6752,0,147,216660.0,130000.0,-55.0,-57.0,-53.0,-45.0,-52.0,-56.0,-53.0,-48.0,-83.0,-92.0,-85.0,-90.0,28.0,35.0,32.0,45.0,1
501,62:47:05:9D:EB:15,3230939,415287502,3185,7603420,3227754,407684082,0,834,148701,796,141953,38,6748,398,0,3218,1151,0,9,216660.0,130000.0,-45.0,-38.0,-43.0,-39.0,-44.0,-42.0,-44.0,-42.0,-83.0,-92.0,-85.0,-90.0,38.0,54.0,42.0,51.0,1
502,F8:59:71:5A:E0:3D,3465598,765189737,237844,357505655,3227754,407684082,3,236524,315200916,231620,314615058,4904,585858,213499,19,240595,5323,3,683,144444.0,43333.0,-67.0,-73.0,-66.0,-70.0,-67.0,-72.0,-64.0,-69.0,-83.0,-92.0,-85.0,-90.0,16.0,19.0,19.0,20.0,1
503,CC:2F:71:3E:C5:1F,3239285,409094689,11531,1410607,3227754,407684082,6,49155,4117507,40611,3105161,8544,1012346,12159,35,16522,188,6,851,130000.0,39000.0,-71.0,-73.0,-69.0,-61.0,-71.0,-73.0,-69.0,-63.0,-83.0,-92.0,-85.0,-90.0,12.0,19.0,16.0,29.0,1
504,CC:2F:71:3F:1F:24,11595613,13245619287,8367855,12837934801,3227758,407684486,94,1870265,1070205103,1861608,1069165075,8657,1040028,1808982,620,8372582,883433,94,6463,115556.0,28889.0,-70.0,-64.0,-72.0,-70.0,-70.0,-63.0,-72.0,-69.0,-83.0,-92.0,-85.0,-90.0,13.0,28.0,13.0,20.0,1
505,92:69:1D:31:68:E9,3249979,453782226,22217,46097090,3227762,407685136,0,10371,3382042,10284,3367467,87,14575,6809,1,22262,1105,0,96,229410.0,130000.0,-55.0,-49.0,-45.0,-51.0,-50.0,-49.0,-45.0,-49.0,-82.0,-92.0,-84.0,-90.0,27.0,43.0,39.0,39.0,1
506,BA:8C:B9:54:50:24,3261520,482004830,33758,74319694,3227762,407685136,0,12508,4069824,12409,4053158,99,16666,7915,6,33787,6752,0,147,216660.0,130000.0,-55.0,-57.0,-53.0,-45.0,-52.0,-56.0,-53.0,-48.0,-82.0,-92.0,-84.0,-90.0,27.0,35.0,31.0,45.0,1
507,62:47:05:9D:EB:15,3230947,415288556,3185,7603420,3227762,407685136,0,837,148905,799,142157,38,6748,398,0,3218,1151,0,9,216660.0,130000.0,-45.0,-38.0,-43.0,-40.0,-45.0,-43.0,-45.0,-43.0,-82.0,-92.0,-84.0,-90.0,37.0,54.0,41.0,50.0,1
508,F8:59:71:5A:E0:3D,3465700,765336867,237938,357651731,3227762,407685136,3,236618,315345676,231714,314759818,4904,585858,213593,19,240689,5325,3,683,144444.0,43333.0,-67.0,-73.0,-66.0,-70.0,-67.0,-73.0,-65.0,-70.0,-82.0,-92.0,-84.0,-90.0,15.0,19.0,18.0,20.0,1
509,CC:2F:71:3E:C5:1F,3239293,409095743,11531,1410607,3227762,407685136,6,49155,4117507,40611,3105161,8544,1012346,12159,35,16522,188,6,851,130000.0,39000.0,-71.0,-73.0,-69.0,-61.0,-71.0,-73.0,-69.0,-63.0,-82.0,-92.0,-84.0,-90.0,11.0,19.0,15.0,29.0,1
510,CC:2F:71:3F:1F:24,11596616,13247130447,8368854,12839445311,3227762,407685136,94,1870599,1070519925,1861942,1069479897,8657,1040028,1809284,620,8373587,883495,94,6463,115556.0,28889.0,-68.0,-64.0,-74.0,-69.0,-68.0,-64.0,-73.0,-69.0,-82.0,-92.0,-84.0,-90.0,14.0,28.0,10.0,21.0,1
511,92:69:1D:31:68:E9,3249985,453782832,22217,46097090,3227768,407685742,0,10371,3382042,10284,3367467,87,14575,6809,1,22262,1105,0,96,229410.0,130000.0,-55.0,-49.0,-45.0,-51.0,-50.0,-49.0,-45.0,-49.0,-82.0,-92.0,-84.0,-90.0,27.0,43.0,39.0,39.0,1
512,BA:8C:B9:54:50:24,3261526,482005436,33758,74319694,3227768,407685742,0,12508,4069824,12409,4053158,99,16666,7915,6,33787,6752,0,147,216660.0,130000.0,-55.0,-57.0,-53.0,-45.0,-52.0,-56.0,-53.0,-48.0,-82.0,-92.0,-84.0,-90.0,27.0,35.0,31.0,45.0,1
513,62:47:05:9D:EB:15,3230954,415289222,3185,7603420,3227769,407685802,0,837,148905,799,142157,38,6748,398,0,3218,1151,0,9,216660.0,130000.0,-45.0,-38.0,-43.0,-40.0,-45.0,-43.0,-45.0,-43.0,-82.0,-92.0,-84.0,-90.0,37.0,54.0,41.0,50.0,1
514,F8:59:71:5A:E0:3D,3465797,765477393,238028,357791591,3227769,407685802,3,236707,315482778,231803,314896920,4904,585858,213682,19,240779,5330,3,683,144444.0,43333.0,-68.0,-73.0,-66.0,-71.0,-68.0,-73.0,-66.0,-70.0,-82.0,-92.0,-84.0,-90.0,14.0,19.0,18.0,19.0,1
515,CC:2F:71:3E:C5:1F,3239300,409096409,11531,1410607,3227769,407685802,6,49155,4117507,40611,3105161,8544,1012346,12159,35,16522,188,6,851,130000.0,39000.0,-71.0,-73.0,-69.0,-61.0,-71.0,-73.0,-69.0,-63.0,-82.0,-92.0,-84.0,-90.0,11.0,19.0,15.0,29.0,1
516,CC:2F:71:3F:1F:24,11597873,13249034001,8370104,12841348199,3227769,407685802,94,1870983,1070854162,1862326,1069814134,8657,1040028,1809633,620,8374837,883652,94,6464,130000.0,43333.0,-70.0,-64.0,-72.0,-69.0,-70.0,-64.0,-72.0,-69.0,-82.0,-92.0,-84.0,-90.0,12.0,28.0,12.0,21.0,1
517,92:69:1D:31:68:E9,3249988,453783094,22217,46097090,3227771,407686004,0,10371,3382042,10284,3367467,87,14575,6809,1,22262,1105,0,96,229410.0,130000.0,-55.0,-49.0,-45.0,-51.0,-50.0,-49.0,-45.0,-49.0,-81.0,-92.0,-83.0,-90.0,26.0,43.0,38.0,39.0,1
518,BA:8C:B9:54:50:24,3261531,482005900,33758,74319694,3227773,407686206,0,12508,4069824,12409,4053158,99,16666,7915,6,33787,6752,0,147,216660.0,130000.0,-55.0,-57.0,-53.0,-45.0,-52.0,-56.0,-53.0,-48.0,-81.0,-92.0,-83.0,-90.0,26.0,35.0,30.0,45.0,1
519,62:47:05:9D:EB:15,3230958,415289626,3185,7603420,3227773,407686206,0,837,148905,799,142157,38,6748,398,0,3218,1151,0,9,216660.0,130000.0,-45.0,-38.0,-43.0,-40.0,-45.0,-43.0,-45.0,-43.0,-81.0,-92.0,-83.0,-90.0,36.0,54.0,40.0,50.0,1
520,F8:59:71:5A:E0:3D,3465888,765612995,238115,357926789,3227773,407686206,3,236790,315610598,231886,315024740,4904,585858,213765,19,240866,5330,3,683,144444.0,43333.0,-67.0,-73.0,-66.0,-70.0,-67.0,-73.0,-66.0,-70.0,-81.0,-92.0,-83.0,-90.0,14.0,19.0,17.0,20.0,1
521,CC:2F:71:3E:C5:1F,3239304,409096813,11531,1410607,3227773,407686206,6,49155,4117507,40611,3105161,8544,1012346,12159,35,16522,188,6,851,130000.0,39000.0,-71.0,-73.0,-69.0,-61.0,-71.0,-73.0,-69.0,-63.0,-81.0,-92.0,-83.0,-90.0,10.0,19.0,14.0,29.0,1
522,CC:2F:71:3F:1F:24,11599243,13251107635,8371470,12843421429,3227773,407686206,94,1871398,1071197877,1862741,1070157849,8657,1040028,1810005,620,8376203,883726,94,6464,130000.0,43333.0,-69.0,-64.0,-72.0,-68.0,-69.0,-64.0,-72.0,-68.0,-81.0,-92.0,-83.0,-90.0,12.0,28.0,11.0,22.0,1
523,92:69:1D:31:68:E9,3249997,453784018,22218,46097206,3227779,407686812,0,10373,3382178,10286,3367603,87,14575,6809,1,22263,1105,0,96,229410.0,130000.0,-55.0,-51.0,-46.0,-51.0,-52.0,-49.0,-46.0,-50.0,-81.0,-92.0,-83.0,-89.0,26.0,41.0,37.0,38.0,1
524,BA:8C:B9:54:50:24,3261539,482006682,33759,74319810,3227780,407686872,0,12510,4069960,12411,4053294,99,16666,7915,6,33788,6752,0,147,216660.0,130000.0,-55.0,-56.0,-54.0,-45.0,-53.0,-56.0,-53.0,-48.0,-81.0,-92.0,-83.0,-89.0,26.0,36.0,29.0,44.0,1
525,62:47:05:9D:EB:15,3230966,415290352,3186,7603480,3227780,407686872,0,839,149041,801,142293,38,6748,398,0,3219,1151,0,9,216660.0,130000.0,-45.0,-38.0,-44.0,-40.0,-45.0,-42.0,-44.0,-41.0,-81.0,-92.0,-83.0,-89.0,36.0,54.0,39.0,49.0,1
526,F8:59:71:5A:E0:3D,3465992,765762961,238212,358076089,3227780,407686872,3,236891,315766138,231987,315180280,4904,585858,213866,19,240963,5331,3,683,144444.0,43333.0,-68.0,-73.0,-66.0,-71.0,-67.0,-73.0,-66.0,-70.0,-81.0,-92.0,-83.0,-89.0,13.0,19.0,17.0,18.0,1
527,CC:2F:71:3E:C5:1F,3239312,409097595,11532,1410723,3227780,407686872,6,49157,4117647,40613,3105301,8544,1012346,12159,35,16523,188,6,851,130000.0,39000.0,-68.0,-74.0,-69.0,-60.0,-69.0,-73.0,-69.0,-61.0,-81.0,-92.0,-83.0,-89.0,13.0,18.0,14.0,29.0,1
528,CC:2F:71:3F:1F:24,11600635,13253224247,8372855,12845537375,3227780,407686872,94,1871820,1071554767,1863163,1070514739,8657,1040028,1810382,620,8377574,883873,94,6465,130000.0,43333.0,-70.0,-64.0,-73.0,-69.0,-69.0,-64.0,-72.0,-68.0,-81.0,-92.0,-83.0,-89.0,11.0,28.0,10.0,20.0,1
529,92:69:1D:31:68:E9,3250003,453784544,22218,46097206,3227785,407687338,0,10373,3382178,10286,3367603,87,14575,6809,1,22263,1105,0,96,229410.0,130000.0,-55.0,-51.0,-46.0,-51.0,-52.0,-49.0,-46.0,-50.0,-81.0,-92.0,-83.0,-89.0,26.0,41.0,37.0,38.0,1
530,BA:8C:B9:54:50:24,3261544,482007148,33759,74319810,3227785,407687338,0,12510,4069960,12411,4053294,99,16666,7915,6,33788,6752,0,147,216660.0,130000.0,-55.0,-56.0,-54.0,-45.0,-53.0,-56.0,-53.0,-48.0,-81.0,-92.0,-83.0,-89.0,26.0,36.0,29.0,44.0,1
531,62:47:05:9D:EB:15,3230973,415291020,3186,7603480,3227787,407687540,0,839,149041,801,142293,38,6748,398,0,3219,1151,0,9,216660.0,130000.0,-45.0,-38.0,-44.0,-40.0,-45.0,-42.0,-44.0,-41.0,-81.0,-92.0,-83.0,-89.0,36.0,54.0,39.0,49.0,1
532,F8:59:71:5A:E0:3D,3466091,765906597,238304,358219057,3227787,407687540,3,236982,315906278,232078,315320420,4904,585858,213957,19,241055,5335,3,683,144444.0,43333.0,-68.0,-73.0,-66.0,-71.0,-67.0,-73.0,-66.0,-70.0,-81.0,-92.0,-83.0,-89.0,13.0,19.0,17.0,18.0,1
533,CC:2F:71:3E:C5:1F,3239320,409098488,11532,1410723,3227788,407687765,6,49159,4117835,40614,3105371,8545,1012464,12160,35,16523,188,6,851,130000.0,39000.0,-69.0,-73.0,-68.0,-60.0,-70.0,-74.0,-69.0,-61.0,-81.0,-92.0,-83.0,-89.0,12.0,19.0,15.0,29.0,1
534,CC:2F:71:3F:1F:24,11602212,13255629516,8374423,12847941527,3227789,407687989,94,1872219,1071866115,1863562,1070826087,8657,1040028,1810763,620,8379131,884006,94,6465,130000.0,43333.0,-69.0,-64.0,-72.0,-68.0,-69.0,-64.0,-71.0,-68.0,-81.0,-92.0,-83.0,-89.0,12.0,28.0,11.0,21.0,1
535,92:69:1D:31:68:E9,3250010,453785459,22218,46097206,3227792,407688253,0,10373,3382178,10286,3367603,87,14575,6809,1,22263,1105,0,96,229410.0,130000.0,-55.0,-51.0,-46.0,-51.0,-52.0,-49.0,-46.0,-50.0,-81.0,-92.0,-83.0,-89.0,26.0,41.0,37.0,38.0,1
536,BA:8C:B9:54:50:24,3261720,482448032,33928,74759779,3227792,407688253,0,12537,4075781,12438,4059115,99,16666,7928,6,33957,6754,0,148,229410.0,1000.0,-54.0,-56.0,-55.0,-45.0,-52.0,-57.0,-55.0,-50.0,-81.0,-92.0,-83.0,-89.0,27.0,36.0,28.0,44.0,1
537,62:47:05:9D:EB:15,3230979,415291793,3186,7603480,3227793,407688313,0,839,149041,801,142293,38,6748,398,0,3219,1151,0,9,216660.0,130000.0,-45.0,-38.0,-44.0,-40.0,-45.0,-42.0,-44.0,-41.0,-81.0,-92.0,-83.0,-89.0,36.0,54.0,39.0,49.0,1
538,F8:59:71:5A:E0:3D,3466185,766044122,238392,358355809,3227793,407688313,3,237070,316041798,232166,315455940,4904,585858,214045,19,241143,5339,3,683,144444.0,43333.0,-68.0,-73.0,-66.0,-70.0,-67.0,-73.0,-66.0,-70.0,-81.0,-92.0,-83.0,-89.0,13.0,19.0,17.0,19.0,1
539,CC:2F:71:3E:C5:1F,3239327,409099238,11532,1410723,3227795,407688515,6,49159,4117835,40614,3105371,8545,1012464,12160,35,16523,188,6,851,130000.0,39000.0,-69.0,-73.0,-68.0,-60.0,-70.0,-74.0,-69.0,-61.0,-81.0,-92.0,-83.0,-89.0,12.0,19.0,15.0,29.0,1
540,CC:2F:71:3F:1F:24,11603915,13258226883,8376118,12850537919,3227797,407688964,94,1872625,1072176755,1863967,1071136609,8658,1040146,1811160,620,8380851,884202,94,6465,130000.0,43333.0,-69.0,-64.0,-72.0,-68.0,-69.0,-64.0,-72.0,-68.0,-81.0,-92.0,-83.0,-89.0,12.0,28.0,11.0,21.0,1
541,92:69:1D:31:68:E9,3250019,453786574,22218,46097206,3227801,407689368,0,10373,3382178,10286,3367603,87,14575,6809,1,22263,1105,0,96,229410.0,130000.0,-55.0,-51.0,-46.0,-51.0,-52.0,-49.0,-46.0,-50.0,-81.0,-92.0,-83.0,-89.0,26.0,41.0,37.0,38.0,1
542,BA:8C:B9:54:50:24,3261732,482449411,33928,74759779,3227804,407689632,0,12542,4076175,12442,4059387,100,16788,7929,6,33957,6754,0,148,229410.0,1000.0,-55.0,-57.0,-55.0,-45.0,-54.0,-56.0,-55.0,-47.0,-81.0,-92.0,-83.0,-89.0,26.0,35.0,28.0,44.0,1
543,62:47:05:9D:EB:15,3230990,415293112,3186,7603480,3227804,407689632,0,839,149041,801,142293,38,6748,398,0,3219,1151,0,9,216660.0,130000.0,-45.0,-38.0,-44.0,-40.0,-45.0,-42.0,-44.0,-41.0,-81.0,-92.0,-83.0,-89.0,36.0,54.0,39.0,49.0,1
544,F8:59:71:5A:E0:3D,3466276,766169761,238472,358480129,3227804,407689632,3,237153,316169646,232249,315583788,4904,585858,214126,19,241223,5340,3,683,144444.0,43333.0,-68.0,-74.0,-66.0,-71.0,-68.0,-74.0,-66.0,-71.0,-81.0,-92.0,-83.0,-89.0,13.0,18.0,17.0,18.0,1
545,CC:2F:71:3E:C5:1F,3239336,409100355,11532,1410723,3227804,407689632,6,49159,4117835,40614,3105371,8545,1012464,12160,35,16523,188,6,851,130000.0,39000.0,-69.0,-73.0,-68.0,-60.0,-70.0,-74.0,-69.0,-61.0,-81.0,-92.0,-83.0,-89.0,12.0,19.0,15.0,29.0,1
546,CC:2F:71:3F:1F:24,11605598,13260802359,8377794,12853112727,3227804,407689632,94,1873040,1072473951,1864382,1071433805,8658,1040146,1811532,620,8382521,884267,94,6465,130000.0,43333.0,-69.0,-64.0,-72.0,-68.0,-68.0,-64.0,-72.0,-68.0,-81.0,-92.0,-83.0,-89.0,12.0,28.0,11.0,21.0,1
547,92:69:1D:31:68:E9,3250147,454093761,22339,46403478,3227808,407690283,0,10400,3390359,10313,3375784,87,14575,6827,1,22384,1105,0,96,229410.0,137640.0,-54.0,-51.0,-46.0,-51.0,-50.0,-49.0,-45.0,-49.0,-81.0,-91.0,-83.0,-89.0,27.0,40.0,37.0,38.0,1
548,BA:8C:B9:54:50:24,3261739,482450324,33928,74759779,3227811,407690545,0,12544,4076311,12444,4059523,100,16788,7929,6,33957,6754,0,150,229410.0,1000.0,-52.0,-54.0,-49.0,-44.0,-53.0,-56.0,-53.0,-47.0,-81.0,-91.0,-83.0,-89.0,29.0,37.0,34.0,45.0,1
549,62:47:05:9D:EB:15,3230999,415294227,3186,7603480,3227813,407690747,0,839,149041,801,142293,38,6748,398,0,3219,1151,0,9,216660.0,130000.0,-45.0,-38.0,-44.0,-40.0,-45.0,-42.0,-44.0,-41.0,-81.0,-91.0,-83.0,-89.0,36.0,53.0,39.0,49.0,1
550,F8:59:71:5A:E0:3D,3466390,766334046,238577,358643299,3227813,407690747,3,237258,316331346,232354,315745488,4904,585858,214231,19,241328,5345,3,683,144444.0,43333.0,-68.0,-73.0,-67.0,-71.0,-68.0,-73.0,-66.0,-71.0,-81.0,-91.0,-83.0,-89.0,13.0,18.0,16.0,18.0,1
551,CC:2F:71:3E:C5:1F,3239347,409101919,11532,1410723,3227815,407691196,6,49159,4117835,40614,3105371,8545,1012464,12160,35,16523,188,6,851,130000.0,39000.0,-69.0,-73.0,-68.0,-60.0,-70.0,-74.0,-69.0,-61.0,-81.0,-91.0,-83.0,-89.0,12.0,18.0,15.0,29.0,1
552,CC:2F:71:3F:1F:24,11606500,13262131308,8378685,12854440112,3227815,407691196,94,1873438,1072863291,1864780,1071823145,8658,1040146,1811905,620,8383418,884354,94,6465,130000.0,43333.0,-69.0,-64.0,-71.0,-68.0,-68.0,-64.0,-70.0,-68.0,-81.0,-91.0,-83.0,-89.0,12.0,27.0,12.0,21.0,1
553,92:69:1D:31:68:E9,3250156,454094876,22339,46403478,3227817,407691398,0,10400,3390359,10313,3375784,87,14575,6827,1,22384,1105,0,96,229410.0,137640.0,-54.0,-51.0,-46.0,-51.0,-50.0,-49.0,-45.0,-49.0,-81.0,-91.0,-83.0,-89.0,27.0,40.0,37.0,38.0,1
554,BA:8C:B9:54:50:24,3261745,482451177,33928,74759779,3227817,407691398,0,12544,4076311,12444,4059523,100,16788,7929,6,33957,6754,0,150,229410.0,1000.0,-52.0,-54.0,-49.0,-44.0,-53.0,-56.0,-53.0,-47.0,-81.0,-91.0,-83.0,-89.0,29.0,37.0,34.0,45.0,1
555,62:47:05:9D:EB:15,3231003,415294878,3186,7603480,3227817,407691398,0,839,149041,801,142293,38,6748,398,0,3219,1151,0,9,216660.0,130000.0,-45.0,-38.0,-44.0,-40.0,-45.0,-42.0,-44.0,-41.0,-81.0,-91.0,-83.0,-89.0,36.0,53.0,39.0,49.0,1
556,F8:59:71:5A:E0:3D,3466488,766480773,238671,358789375,3227817,407691398,3,237352,316476120,232448,315890262,4904,585858,214324,19,241422,5346,3,683,144444.0,43333.0,-68.0,-73.0,-66.0,-71.0,-68.0,-73.0,-66.0,-71.0,-81.0,-91.0,-83.0,-89.0,13.0,18.0,17.0,18.0,1
557,CC:2F:71:3E:C5:1F,3239351,409102323,11532,1410723,3227819,407691600,6,49159,4117835,40614,3105371,8545,1012464,12160,35,16523,188,6,851,130000.0,39000.0,-69.0,-73.0,-68.0,-60.0,-70.0,-74.0,-69.0,-61.0,-81.0,-91.0,-83.0,-89.0,12.0,18.0,15.0,29.0,1
558,CC:2F:71:3F:1F:24,11607715,13263964767,8379896,12856273167,3227819,407691600,94,1873791,1073201464,1865133,1072161318,8658,1040146,1812257,620,8384629,884701,94,6466,130000.0,43333.0,-69.0,-64.0,-73.0,-69.0,-69.0,-64.0,-71.0,-69.0,-81.0,-91.0,-83.0,-89.0,12.0,27.0,10.0,20.0,1
559,92:69:1D:31:68:E9,3250165,454095744,22339,46403478,3227826,407692266,0,10401,3390427,10314,3375852,87,14575,6827,1,22384,1105,0,96,229410.0,137640.0,-54.0,-50.0,-45.0,-51.0,-50.0,-49.0,-45.0,-49.0,-81.0,-91.0,-83.0,-89.0,27.0,41.0,38.0,38.0,1
560,BA:8C:B9:54:50:24,3261754,482452045,33928,74759779,3227826,407692266,0,12544,4076311,12444,4059523,100,16788,7929,6,33957,6754,0,150,229410.0,1000.0,-52.0,-54.0,-49.0,-44.0,-53.0,-56.0,-53.0,-47.0,-81.0,-91.0,-83.0,-89.0,29.0,37.0,34.0,45.0,1
561,62:47:05:9D:EB:15,3231012,415295746,3186,7603480,3227826,407692266,0,840,149109,802,142361,38,6748,398,0,3220,1151,0,9,216660.0,130000.0,-45.0,-38.0,-44.0,-40.0,-45.0,-40.0,-44.0,-41.0,-81.0,-91.0,-83.0,-89.0,36.0,53.0,39.0,49.0,1
562,F8:59:71:5A:E0:3D,3466599,766640149,238773,358947883,3227826,407692266,3,237454,316633256,232550,316047398,4904,585858,214426,19,241524,5346,3,683,144444.0,43333.0,-69.0,-74.0,-67.0,-71.0,-68.0,-73.0,-66.0,-71.0,-81.0,-91.0,-83.0,-89.0,12.0,17.0,16.0,18.0,1
563,CC:2F:71:3E:C5:1F,3239358,409102989,11532,1410723,3227826,407692266,6,49161,4117975,40616,3105511,8545,1012464,12160,35,16524,188,6,851,130000.0,39000.0,-75.0,-85.0,-76.0,-72.0,-70.0,-76.0,-70.0,-63.0,-81.0,-91.0,-83.0,-89.0,6.0,6.0,7.0,17.0,1
564,CC:2F:71:3F:1F:24,11608869,13265691383,8381043,12857999117,3227826,407692266,94,1874116,1073494714,1865458,1072454568,8658,1040146,1812573,620,8385758,885076,94,6466,130000.0,43333.0,-69.0,-64.0,-72.0,-69.0,-69.0,-64.0,-71.0,-69.0,-81.0,-91.0,-83.0,-89.0,12.0,27.0,11.0,20.0,1
565,92:69:1D:31:68:E9,3250171,454096483,22339,46403478,3227832,407693005,0,10401,3390427,10314,3375852,87,14575,6827,1,22384,1105,0,96,229410.0,137640.0,-54.0,-50.0,-45.0,-51.0,-50.0,-49.0,-45.0,-49.0,-81.0,-91.0,-83.0,-89.0,27.0,41.0,38.0,38.0,1
566,BA:8C:B9:54:50:24,3261762,482452986,33928,74759779,3227834,407693207,0,12544,4076311,12444,4059523,100,16788,7929,6,33957,6754,0,150,229410.0,1000.0,-52.0,-54.0,-49.0,-44.0,-53.0,-56.0,-53.0,-47.0,-81.0,-91.0,-83.0,-89.0,29.0,37.0,34.0,45.0,1
567,62:47:05:9D:EB:15,3231020,415296687,3186,7603480,3227834,407693207,0,841,149177,803,142429,38,6748,398,0,3220,1151,0,9,216660.0,130000.0,-45.0,-50.0,-46.0,-46.0,-45.0,-42.0,-44.0,-41.0,-81.0,-91.0,-83.0,-89.0,36.0,41.0,37.0,43.0,1
568,F8:59:71:5A:E0:3D,3466695,766777842,238861,359084635,3227834,407693207,3,237545,316771988,232640,316186012,4905,585976,214516,19,241612,5347,3,683,144444.0,43333.0,-68.0,-74.0,-67.0,-71.0,-68.0,-73.0,-66.0,-70.0,-81.0,-91.0,-83.0,-89.0,13.0,17.0,16.0,18.0,1
569,CC:2F:71:3E:C5:1F,3239366,409103930,11532,1410723,3227834,407693207,6,49161,4117975,40616,3105511,8545,1012464,12160,35,16524,188,6,851,130000.0,39000.0,-75.0,-85.0,-76.0,-72.0,-70.0,-76.0,-70.0,-63.0,-81.0,-91.0,-83.0,-89.0,6.0,6.0,7.0,17.0,1
570,CC:2F:71:3F:1F:24,11609884,13267205104,8382048,12859511695,3227836,407693409,94,1874478,1073873024,1865820,1072832878,8658,1040146,1812929,620,8386781,885362,94,6467,115556.0,28889.0,-69.0,-64.0,-71.0,-69.0,-68.0,-63.0,-71.0,-68.0,-81.0,-91.0,-83.0,-89.0,12.0,27.0,12.0,20.0,1
571,92:69:1D:31:68:E9,3250179,454097265,22340,46403594,3227839,407693671,0,10403,3390601,10316,3376026,87,14575,6828,1,22385,1105,0,96,229410.0,137640.0,-52.0,-53.0,-51.0,-55.0,-51.0,-50.0,-46.0,-50.0,-81.0,-91.0,-83.0,-89.0,29.0,38.0,32.0,34.0,1
572,BA:8C:B9:54:50:24,3261767,482453450,33928,74759779,3227839,407693671,0,12544,4076311,12444,4059523,100,16788,7929,6,33957,6754,0,150,229410.0,1000.0,-52.0,-54.0,-49.0,-44.0,-53.0,-56.0,-53.0,-47.0,-81.0,-91.0,-83.0,-89.0,29.0,37.0,34.0,45.0,1
573,62:47:05:9D:EB:15,3231025,415297151,3186,7603480,3227839,407693671,0,841,149177,803,142429,38,6748,398,0,3220,1151,0,9,216660.0,130000.0,-45.0,-50.0,-46.0,-46.0,-45.0,-42.0,-44.0,-41.0,-81.0,-91.0,-83.0,-89.0,36.0,41.0,37.0,43.0,1
574,F8:59:71:5A:E0:3D,3466808,766946138,238969,359252467,3227839,407693671,3,237655,316941556,232750,316355580,4905,585976,214624,19,241720,5347,3,683,144444.0,43333.0,-67.0,-73.0,-66.0,-70.0,-67.0,-73.0,-66.0,-70.0,-81.0,-91.0,-83.0,-89.0,14.0,18.0,17.0,19.0,1
575,CC:2F:71:3E:C5:1F,3239371,409104394,11532,1410723,3227839,407693671,6,49161,4117975,40616,3105511,8545,1012464,12160,35,16524,188,6,851,130000.0,39000.0,-75.0,-85.0,-76.0,-72.0,-70.0,-76.0,-70.0,-63.0,-81.0,-91.0,-83.0,-89.0,6.0,6.0,7.0,17.0,1
576,CC:2F:71:3F:1F:24,11611937,13270352667,8384098,12862658996,3227839,407693671,94,1874990,1074182632,1866332,1073142486,8658,1040146,1813426,620,8388831,885430,94,6467,117000.0,39000.0,-69.0,-64.0,-71.0,-69.0,-69.0,-64.0,-72.0,-69.0,-81.0,-90.0,-83.0,-89.0,12.0,26.0,12.0,20.0,1
577,92:69:1D:31:68:E9,3250188,454098155,22340,46403594,3227848,407694561,0,10410,3391234,10321,3376366,89,14868,6830,1,22385,1105,0,96,229410.0,137640.0,-53.0,-50.0,-46.0,-51.0,-52.0,-50.0,-47.0,-51.0,-81.0,-90.0,-83.0,-89.0,28.0,40.0,37.0,38.0,1
578,BA:8C:B9:54:50:24,3261776,482454340,33928,74759779,3227848,407694561,0,12547,4076618,12446,4059659,101,16959,7930,6,33957,6754,0,150,229410.0,1000.0,-47.0,-55.0,-50.0,-61.0,-52.0,-55.0,-53.0,-49.0,-81.0,-90.0,-83.0,-89.0,34.0,35.0,33.0,28.0,1
579,62:47:05:9D:EB:15,3231034,415298041,3186,7603480,3227848,407694561,0,841,149177,803,142429,38,6748,398,0,3220,1151,0,9,216660.0,130000.0,-45.0,-50.0,-46.0,-46.0,-45.0,-42.0,-44.0,-41.0,-81.0,-90.0,-83.0,-89.0,36.0,40.0,37.0,43.0,1
580,F8:59:71:5A:E0:3D,3466908,767086836,239060,359392275,3227848,407694561,3,237746,317080262,232841,316494286,4905,585976,214715,19,241811,5347,3,683,144444.0,43333.0,-67.0,-73.0,-66.0,-71.0,-67.0,-73.0,-66.0,-70.0,-81.0,-90.0,-83.0,-89.0,14.0,17.0,17.0,18.0,1
581,CC:2F:71:3E:C5:1F,3239380,409105284,11532,1410723,3227848,407694561,6,49161,4117975,40616,3105511,8545,1012464,12160,35,16524,188,6,851,130000.0,39000.0,-75.0,-85.0,-76.0,-72.0,-70.0,-76.0,-70.0,-63.0,-81.0,-90.0,-83.0,-89.0,6.0,5.0,7.0,17.0,1
582,CC:2F:71:3F:1F:24,11613836,13273245344,8385988,12865550783,3227848,407694561,94,1875434,1074535345,1866776,1073495199,8658,1040146,1813843,620,8390720,885937,94,6468,130000.0,43333.0,-69.0,-64.0,-73.0,-69.0,-69.0,-64.0,-71.0,-68.0,-81.0,-90.0,-83.0,-89.0,12.0,26.0,10.0,20.0,1
583,92:69:1D:31:68:E9,3250197,454099189,22340,46403594,3227857,407695595,0,10410,3391234,10321,3376366,89,14868,6830,1,22385,1105,0,96,229410.0,137640.0,-53.0,-50.0,-46.0,-51.0,-52.0,-50.0,-47.0,-51.0,-81.0,-90.0,-83.0,-89.0,28.0,40.0,37.0,38.0,1
584,BA:8C:B9:54:50:24,3261785,482455374,33928,74759779,3227857,407695595,0,12547,4076618,12446,4059659,101,16959,7930,6,33957,6754,0,150,229410.0,1000.0,-47.0,-55.0,-50.0,-61.0,-52.0,-55.0,-53.0,-49.0,-81.0,-90.0,-83.0,-89.0,34.0,35.0,33.0,28.0,1
585,62:47:05:9D:EB:15,3231045,415299277,3186,7603480,3227859,407695797,0,841,149177,803,142429,38,6748,398,0,3220,1151,0,9,216660.0,130000.0,-45.0,-50.0,-46.0,-46.0,-45.0,-42.0,-44.0,-41.0,-81.0,-90.0,-83.0,-89.0,36.0,40.0,37.0,43.0,1
586,F8:59:71:5A:E0:3D,3467012,767232594,239153,359536797,3227859,407695797,3,237839,317223482,232934,316637506,4905,585976,214808,19,241904,5347,3,683,144444.0,43333.0,-68.0,-73.0,-66.0,-71.0,-67.0,-72.0,-66.0,-70.0,-81.0,-90.0,-83.0,-89.0,13.0,17.0,17.0,18.0,1
587,CC:2F:71:3E:C5:1F,3239391,409106520,11532,1410723,3227859,407695797,6,49161,4117975,40616,3105511,8545,1012464,12160,35,16524,188,6,851,130000.0,39000.0,-75.0,-85.0,-76.0,-72.0,-70.0,-76.0,-70.0,-63.0,-81.0,-90.0,-83.0,-89.0,6.0,5.0,7.0,17.0,1
588,CC:2F:71:3F:1F:24,11615532,13275836094,8387673,12868140297,3227859,407695797,94,1875804,1074851711,1867146,1073811565,8658,1040146,1814205,620,8392406,886319,94,6468,130000.0,43333.0,-69.0,-64.0,-72.0,-68.0,-69.0,-64.0,-72.0,-68.0,-81.0,-90.0,-83.0,-89.0,12.0,26.0,11.0,21.0,1
589,92:69:1D:31:68:E9,3250199,454099391,22340,46403594,3227859,407695797,0,10410,3391234,10321,3376366,89,14868,6830,1,22385,1105,0,96,229410.0,137640.0,-53.0,-50.0,-46.0,-51.0,-52.0,-50.0,-47.0,-51.0,-81.0,-90.0,-83.0,-89.0,28.0,40.0,37.0,38.0,1
590,BA:8C:B9:54:50:24,3261787,482455576,33928,74759779,3227859,407695797,0,12547,4076618,12446,4059659,101,16959,7930,6,33957,6754,0,150,229410.0,1000.0,-47.0,-55.0,-50.0,-61.0,-52.0,-55.0,-53.0,-49.0,-81.0,-90.0,-83.0,-89.0,34.0,35.0,33.0,28.0,1
591,62:47:05:9D:EB:15,3231045,415299277,3186,7603480,3227859,407695797,0,841,149177,803,142429,38,6748,398,0,3220,1151,0,9,216660.0,130000.0,-45.0,-50.0,-46.0,-46.0,-45.0,-42.0,-44.0,-41.0,-81.0,-90.0,-83.0,-89.0,36.0,40.0,37.0,43.0,1
592,F8:59:71:5A:E0:3D,3467102,767372454,239243,359676657,3227859,407695797,3,237930,317363664,233025,316777688,4905,585976,214898,19,241993,5350,3,684,144444.0,43333.0,-68.0,-73.0,-66.0,-70.0,-67.0,-73.0,-66.0,-70.0,-81.0,-90.0,-83.0,-89.0,13.0,17.0,17.0,19.0,1
593,CC:2F:71:3E:C5:1F,3239393,409106722,11532,1410723,3227861,407695999,6,49161,4117975,40616,3105511,8545,1012464,12160,35,16524,188,6,851,130000.0,39000.0,-75.0,-85.0,-76.0,-72.0,-70.0,-76.0,-70.0,-63.0,-81.0,-90.0,-83.0,-89.0,6.0,5.0,7.0,17.0,1
594,CC:2F:71:3F:1F:24,11617431,13278747333,8389570,12871051334,3227861,407695999,94,1876206,1075158274,1867548,1074118128,8658,1040146,1814590,620,8394265,886523,94,6468,117000.0,39000.0,-69.0,-64.0,-72.0,-69.0,-69.0,-64.0,-72.0,-69.0,-81.0,-91.0,-83.0,-89.0,12.0,27.0,11.0,20.0,1
595,92:69:1D:31:68:E9,3250237,454170801,22369,46474136,3227868,407696665,0,10420,3392599,10331,3377731,89,14868,6839,1,22414,1106,0,96,229410.0,137640.0,-49.0,-49.0,-45.0,-47.0,-48.0,-49.0,-45.0,-47.0,-81.0,-91.0,-83.0,-89.0,32.0,42.0,38.0,42.0,1
596,BA:8C:B9:54:50:24,3261810,482473682,33942,74777017,3227868,407696665,0,12552,4077278,12451,4060319,101,16959,7933,6,33971,6754,0,150,229410.0,130000.0,-54.0,-56.0,-55.0,-45.0,-51.0,-56.0,-54.0,-51.0,-81.0,-91.0,-83.0,-89.0,27.0,35.0,28.0,44.0,1
597,62:47:05:9D:EB:15,3231054,415300145,3186,7603480,3227868,407696665,0,841,149177,803,142429,38,6748,398,0,3220,1151,0,9,216660.0,130000.0,-45.0,-50.0,-46.0,-46.0,-45.0,-42.0,-44.0,-41.0,-81.0,-91.0,-83.0,-89.0,36.0,41.0,37.0,43.0,1
598,F8:59:71:5A:E0:3D,3467192,767499196,239324,359802531,3227868,407696665,3,238011,317488404,233106,316902428,4905,585976,214979,19,242075,5350,3,684,144444.0,43333.0,-68.0,-73.0,-66.0,-71.0,-67.0,-73.0,-66.0,-70.0,-81.0,-91.0,-83.0,-89.0,13.0,18.0,17.0,18.0,1
599,CC:2F:71:3E:C5:1F,3239400,409107388,11532,1410723,3227868,407696665,6,49161,4117975,40616,3105511,8545,1012464,12160,35,16524,188,6,851,130000.0,39000.0,-75.0,-85.0,-76.0,-72.0,-70.0,-76.0,-70.0,-63.0,-81.0,-91.0,-83.0,-89.0,6.0,6.0,7.0,17.0,1
600,CC:2F:71:3F:1F:24,11619517,13281956885,8391649,12874260220,3227868,407696665,94,1876653,1075468936,1867995,1074428790,8658,1040146,1815017,620,8396382,886705,94,6468,117000.0,39000.0,-70.0,-64.0,-72.0,-69.0,-69.0,-64.0,-71.0,-68.0,-81.0,-91.0,-83.0,-89.0,11.0,27.0,11.0,20.0,1
601,92:69:1D:31:68:E9,3250239,454171003,22369,46474136,3227870,407696867,0,10421,3392667,10332,3377799,89,14868,6839,1,22414,1106,0,96,229410.0,137640.0,-52.0,-49.0,-44.0,-50.0,-49.0,-49.0,-44.0,-48.0,-81.0,-91.0,-83.0,-89.0,29.0,42.0,39.0,39.0,1
602,BA:8C:B9:54:50:24,3261989,482941273,34119,75244406,3227870,407696867,0,12586,4084083,12485,4067124,101,16959,7954,6,34148,6765,0,151,229410.0,137640.0,-48.0,-55.0,-51.0,-61.0,-52.0,-56.0,-54.0,-52.0,-81.0,-91.0,-83.0,-89.0,33.0,36.0,32.0,28.0,1
603,62:47:05:9D:EB:15,3231056,415300347,3186,7603480,3227870,407696867,0,841,149177,803,142429,38,6748,398,0,3220,1151,0,9,216660.0,130000.0,-45.0,-50.0,-46.0,-46.0,-45.0,-42.0,-44.0,-41.0,-81.0,-91.0,-83.0,-89.0,36.0,41.0,37.0,43.0,1
604,F8:59:71:5A:E0:3D,3467282,767630338,239408,359933067,3227874,407697271,3,238098,317622412,233193,317036436,4905,585976,215064,19,242159,5351,3,684,144444.0,43333.0,-68.0,-73.0,-66.0,-70.0,-67.0,-73.0,-66.0,-70.0,-81.0,-91.0,-83.0,-89.0,13.0,18.0,17.0,19.0,1
605,CC:2F:71:3E:C5:1F,3239406,409107994,11532,1410723,3227874,407697271,6,49161,4117975,40616,3105511,8545,1012464,12160,35,16524,188,6,851,130000.0,39000.0,-75.0,-85.0,-76.0,-72.0,-70.0,-76.0,-70.0,-63.0,-81.0,-91.0,-83.0,-89.0,6.0,6.0,7.0,17.0,1
606,CC:2F:71:3F:1F:24,11621532,13285058899,8393656,12877361426,3227876,407697473,94,1877093,1075767528,1868435,1074727382,8658,1040146,1815437,620,8398389,886962,94,6468,130000.0,43333.0,-69.0,-64.0,-71.0,-68.0,-69.0,-63.0,-71.0,-68.0,-81.0,-91.0,-83.0,-89.0,12.0,27.0,12.0,21.0,1
607,92:69:1D:31:68:E9,3250405,454587545,22528,46890012,3227877,407697533,0,10444,3398361,10355,3383493,89,14868,6857,1,22573,1106,0,96,229410.0,137640.0,-52.0,-49.0,-45.0,-50.0,-48.0,-48.0,-45.0,-48.0,-81.0,-91.0,-83.0,-89.0,29.0,42.0,38.0,39.0,1
608,BA:8C:B9:54:50:24,3261996,482941939,34119,75244406,3227877,407697533,0,12586,4084083,12485,4067124,101,16959,7954,6,34148,6765,0,151,229410.0,137640.0,-48.0,-55.0,-51.0,-61.0,-52.0,-56.0,-54.0,-52.0,-81.0,-91.0,-83.0,-89.0,33.0,36.0,32.0,28.0,1
609,62:47:05:9D:EB:15,3231063,415301013,3186,7603480,3227877,407697533,0,841,149177,803,142429,38,6748,398,0,3220,1151,0,9,216660.0,130000.0,-45.0,-50.0,-46.0,-46.0,-45.0,-42.0,-44.0,-41.0,-81.0,-91.0,-83.0,-89.0,36.0,41.0,37.0,43.0,1
610,F8:59:71:5A:E0:3D,3467374,767768906,239497,360071373,3227877,407697533,3,238186,317757932,233281,317171956,4905,585976,215152,19,242248,5351,3,684,144444.0,43333.0,-67.0,-73.0,-66.0,-71.0,-67.0,-73.0,-66.0,-70.0,-81.0,-91.0,-83.0,-89.0,14.0,18.0,17.0,18.0,1
611,CC:2F:71:3E:C5:1F,3239409,409108256,11532,1410723,3227877,407697533,6,49161,4117975,40616,3105511,8545,1012464,12160,35,16524,188,6,851,130000.0,39000.0,-75.0,-85.0,-76.0,-72.0,-70.0,-76.0,-70.0,-63.0,-81.0,-91.0,-83.0,-89.0,6.0,6.0,7.0,17.0,1
612,CC:2F:71:3F:1F:24,11623150,13287530978,8395273,12879833445,3227877,407697533,94,1877526,1076081797,1868868,1075041651,8658,1040146,1815848,620,8399987,887279,94,6468,130000.0,43333.0,-69.0,-64.0,-72.0,-68.0,-69.0,-64.0,-71.0,-68.0,-81.0,-91.0,-83.0,-89.0,12.0,27.0,11.0,21.0,1
613,92:69:1D:31:68:E9,3250413,454588353,22528,46890012,3227885,407698341,0,10444,3398361,10355,3383493,89,14868,6857,1,22573,1106,0,96,229410.0,137640.0,-52.0,-49.0,-45.0,-50.0,-48.0,-48.0,-45.0,-48.0,-81.0,-91.0,-83.0,-89.0,29.0,42.0,38.0,39.0,1
614,BA:8C:B9:54:50:24,3262004,482942747,34119,75244406,3227885,407698341,0,12586,4084083,12485,4067124,101,16959,7954,6,34148,6765,0,151,229410.0,137640.0,-48.0,-55.0,-51.0,-61.0,-52.0,-56.0,-54.0,-52.0,-81.0,-91.0,-83.0,-89.0,33.0,36.0,32.0,28.0,1
615,62:47:05:9D:EB:15,3231071,415301821,3186,7603480,3227885,407698341,0,841,149177,803,142429,38,6748,398,0,3220,1151,0,9,216660.0,130000.0,-45.0,-50.0,-46.0,-46.0,-45.0,-42.0,-44.0,-41.0,-81.0,-91.0,-83.0,-89.0,36.0,41.0,37.0,43.0,1
616,F8:59:71:5A:E0:3D,3467467,767901804,239582,360203463,3227885,407698341,3,238271,317888860,233366,317302884,4905,585976,215237,19,242333,5351,3,684,144444.0,43333.0,-68.0,-73.0,-66.0,-71.0,-67.0,-73.0,-66.0,-70.0,-81.0,-91.0,-83.0,-89.0,13.0,18.0,17.0,18.0,1
617,CC:2F:71:3E:C5:1F,3239417,409109064,11532,1410723,3227885,407698341,6,49161,4117975,40616,3105511,8545,1012464,12160,35,16524,188,6,851,130000.0,39000.0,-75.0,-85.0,-76.0,-72.0,-70.0,-76.0,-70.0,-63.0,-81.0,-91.0,-83.0,-89.0,6.0,6.0,7.0,17.0,1
618,CC:2F:71:3F:1F:24,11624108,13288963662,8396223,12881265321,3227885,407698341,94,1877843,1076363027,1869185,1075322881,8658,1040146,1816160,620,8400953,887358,94,6468,130000.0,43333.0,-69.0,-63.0,-71.0,-68.0,-69.0,-63.0,-71.0,-68.0,-81.0,-91.0,-83.0,-89.0,12.0,28.0,12.0,21.0,1
619,92:69:1D:31:68:E9,3250422,454589221,22528,46890012,3227894,407699209,0,10444,3398361,10355,3383493,89,14868,6857,1,22573,1106,0,96,229410.0,137640.0,-52.0,-49.0,-45.0,-50.0,-48.0,-48.0,-45.0,-48.0,-81.0,-91.0,-83.0,-89.0,29.0,42.0,38.0,39.0,1
620,BA:8C:B9:54:50:24,3262013,482943615,34119,75244406,3227894,407699209,0,12586,4084083,12485,4067124,101,16959,7954,6,34148,6765,0,151,229410.0,137640.0,-48.0,-55.0,-51.0,-61.0,-52.0,-56.0,-54.0,-52.0,-81.0,-91.0,-83.0,-89.0,33.0,36.0,32.0,28.0,1
621,62:47:05:9D:EB:15,3231081,415302864,3186,7603480,3227895,407699384,0,841,149177,803,142429,38,6748,398,0,3220,1151,0,9,216660.0,130000.0,-45.0,-50.0,-46.0,-46.0,-45.0,-42.0,-44.0,-41.0,-81.0,-91.0,-83.0,-89.0,36.0,41.0,37.0,43.0,1
622,F8:59:71:5A:E0:3D,3467609,768107975,239714,360408591,3227895,407699384,3,238403,318092546,233498,317506570,4905,585976,215366,19,242465,5352,3,687,144444.0,43333.0,-68.0,-73.0,-66.0,-70.0,-67.0,-73.0,-66.0,-70.0,-81.0,-91.0,-83.0,-89.0,13.0,18.0,17.0,19.0,1
623,CC:2F:71:3E:C5:1F,3239427,409110107,11532,1410723,3227895,407699384,6,49161,4117975,40616,3105511,8545,1012464,12160,35,16524,188,6,851,130000.0,39000.0,-75.0,-85.0,-76.0,-72.0,-70.0,-76.0,-70.0,-63.0,-81.0,-91.0,-83.0,-89.0,6.0,6.0,7.0,17.0,1
624,CC:2F:71:3F:1F:24,11625412,13290929584,8397516,12883229927,3227896,407699657,94,1878266,1076807637,1869608,1075767491,8658,1040146,1816574,620,8402250,887626,94,6469,130000.0,43333.0,-69.0,-64.0,-72.0,-69.0,-69.0,-64.0,-71.0,-69.0,-81.0,-91.0,-83.0,-89.0,12.0,27.0,11.0,20.0,1
625,92:69:1D:31:68:E9,3250426,454589871,22528,46890012,3227898,407699859,0,10444,3398361,10355,3383493,89,14868,6857,1,22573,1106,0,96,229410.0,137640.0,-52.0,-49.0,-45.0,-50.0,-48.0,-48.0,-45.0,-48.0,-81.0,-91.0,-83.0,-89.0,29.0,42.0,38.0,39.0,1
626,BA:8C:B9:54:50:24,3262018,482944381,34120,75244522,3227898,407699859,0,12594,4084832,12492,4067638,102,17194,7956,6,34149,6765,0,151,216660.0,130000.0,-55.0,-56.0,-55.0,-45.0,-53.0,-56.0,-54.0,-47.0,-81.0,-91.0,-83.0,-89.0,26.0,35.0,28.0,44.0,1
627,62:47:05:9D:EB:15,3231090,415303945,3186,7603480,3227904,407700465,0,841,149177,803,142429,38,6748,398,0,3220,1151,0,9,216660.0,130000.0,-45.0,-50.0,-46.0,-46.0,-45.0,-42.0,-44.0,-41.0,-81.0,-91.0,-83.0,-89.0,36.0,41.0,37.0,43.0,1
628,F8:59:71:5A:E0:3D,3467740,768289186,239835,360588661,3227905,407700525,3,238523,318267861,233618,317681885,4905,585976,215486,19,242585,5359,3,689,144444.0,43333.0,-68.0,-73.0,-66.0,-71.0,-67.0,-73.0,-66.0,-70.0,-81.0,-91.0,-83.0,-89.0,13.0,18.0,17.0,18.0,1
629,CC:2F:71:3E:C5:1F,3239437,409111248,11532,1410723,3227905,407700525,6,49161,4117975,40616,3105511,8545,1012464,12160,35,16524,188,6,851,130000.0,39000.0,-75.0,-85.0,-76.0,-72.0,-70.0,-76.0,-70.0,-63.0,-81.0,-91.0,-83.0,-89.0,6.0,6.0,7.0,17.0,1
630,CC:2F:71:3F:1F:24,11626656,13292797749,8398751,12885097224,3227905,407700525,94,1878657,1077217709,1869999,1076177563,8658,1040146,1816941,620,8403485,887822,94,6471,130000.0,43333.0,-69.0,-64.0,-72.0,-69.0,-69.0,-64.0,-71.0,-68.0,-81.0,-91.0,-83.0,-89.0,12.0,27.0,11.0,20.0,1
631,92:69:1D:31:68:E9,3250433,454590537,22528,46890012,3227905,407700525,0,10444,3398361,10355,3383493,89,14868,6857,1,22573,1106,0,96,229410.0,137640.0,-52.0,-49.0,-45.0,-50.0,-48.0,-48.0,-45.0,-48.0,-81.0,-91.0,-83.0,-89.0,29.0,42.0,38.0,39.0,1
632,BA:8C:B9:54:50:24,3262027,482946034,34122,75245509,3227905,407700525,0,12598,4085318,12496,4068124,102,17194,7958,6,34151,6765,0,151,216660.0,130000.0,-48.0,-55.0,-50.0,-61.0,-52.0,-55.0,-53.0,-50.0,-81.0,-91.0,-83.0,-89.0,33.0,36.0,33.0,28.0,1
633,62:47:05:9D:EB:15,3231091,415304005,3186,7603480,3227905,407700525,0,841,149177,803,142429,38,6748,398,0,3220,1151,0,9,216660.0,130000.0,-45.0,-50.0,-46.0,-46.0,-45.0,-42.0,-44.0,-41.0,-81.0,-91.0,-83.0,-89.0,36.0,41.0,37.0,43.0,1
634,F8:59:71:5A:E0:3D,3467824,768419722,239919,360719197,3227905,407700525,3,238610,318401841,233705,317815865,4905,585976,215573,19,242669,5359,3,689,144444.0,43333.0,-67.0,-73.0,-66.0,-70.0,-67.0,-73.0,-66.0,-70.0,-81.0,-91.0,-83.0,-89.0,14.0,18.0,17.0,19.0,1
635,CC:2F:71:3E:C5:1F,3239437,409111248,11532,1410723,3227905,407700525,6,49161,4117975,40616,3105511,8545,1012464,12160,35,16524,188,6,851,130000.0,39000.0,-75.0,-85.0,-76.0,-72.0,-70.0,-76.0,-70.0,-63.0,-81.0,-91.0,-83.0,-89.0,6.0,6.0,7.0,17.0,1
636,CC:2F:71:3F:1F:24,11628563,13295738435,8400658,12888037910,3227905,407700525,94,1879105,1077530513,1870447,1076490367,8658,1040146,1817333,620,8405390,887930,94,6471,130000.0,43333.0,-69.0,-64.0,-72.0,-68.0,-69.0,-64.0,-71.0,-68.0,-81.0,-91.0,-83.0,-89.0,12.0,27.0,11.0,21.0,1
637,92:69:1D:31:68:E9,3250443,454591587,22529,46890128,3227914,407701459,0,10446,3398497,10357,3383629,89,14868,6857,1,22574,1106,0,96,216660.0,130000.0,-51.0,-52.0,-52.0,-55.0,-49.0,-49.0,-46.0,-50.0,-81.0,-91.0,-83.0,-89.0,30.0,39.0,31.0,34.0,1
638,BA:8C:B9:54:50:24,3262037,482947084,34123,75245625,3227914,407701459,0,12600,4085454,12498,4068260,102,17194,7958,6,34152,6765,0,151,216660.0,130000.0,-54.0,-56.0,-55.0,-45.0,-53.0,-55.0,-54.0,-48.0,-81.0,-91.0,-83.0,-89.0,27.0,35.0,28.0,44.0,1
639,62:47:05:9D:EB:15,3231100,415304939,3186,7603480,3227914,407701459,0,841,149177,803,142429,38,6748,398,0,3220,1151,0,9,216660.0,130000.0,-45.0,-50.0,-46.0,-46.0,-45.0,-42.0,-44.0,-41.0,-81.0,-91.0,-83.0,-89.0,36.0,41.0,37.0,43.0,1
640,F8:59:71:5A:E0:3D,3467920,768554416,240006,360852957,3227914,407701459,3,238701,318542177,233796,317956201,4905,585976,215660,19,242757,5364,3,689,144444.0,43333.0,-68.0,-73.0,-66.0,-71.0,-67.0,-73.0,-66.0,-70.0,-81.0,-91.0,-83.0,-89.0,13.0,18.0,17.0,18.0,1
641,CC:2F:71:3E:C5:1F,3239447,409112298,11533,1410839,3227914,407701459,6,49163,4118115,40618,3105651,8545,1012464,12160,35,16525,188,6,851,130000.0,39000.0,-69.0,-72.0,-67.0,-61.0,-69.0,-74.0,-69.0,-61.0,-81.0,-91.0,-83.0,-89.0,12.0,19.0,16.0,28.0,1
642,CC:2F:71:3F:1F:24,11630330,13298442893,8402415,12890741374,3227915,407701519,94,1879504,1077829998,1870846,1076789852,8658,1040146,1817716,620,8407148,888089,94,6471,130000.0,43333.0,-69.0,-64.0,-72.0,-68.0,-68.0,-63.0,-71.0,-68.0,-81.0,-91.0,-83.0,-89.0,12.0,27.0,11.0,21.0,1
643,92:69:1D:31:68:E9,3250445,454591709,22529,46890128,3227916,407701581,0,10446,3398497,10357,3383629,89,14868,6857,1,22574,1106,0,96,216660.0,130000.0,-51.0,-52.0,-52.0,-55.0,-49.0,-49.0,-46.0,-50.0,-81.0,-91.0,-83.0,-89.0,30.0,39.0,31.0,34.0,1
644,BA:8C:B9:54:50:24,3262039,482947206,34123,75245625,3227916,407701581,0,12603,4085712,12500,4068396,103,17316,7959,6,34152,6765,0,151,216660.0,130000.0,-55.0,-56.0,-55.0,-45.0,-52.0,-55.0,-53.0,-48.0,-81.0,-91.0,-83.0,-89.0,26.0,35.0,28.0,44.0,1
645,62:47:05:9D:EB:15,3231104,415305263,3186,7603480,3227918,407701783,0,841,149177,803,142429,38,6748,398,0,3220,1151,0,9,216660.0,130000.0,-45.0,-50.0,-46.0,-46.0,-45.0,-42.0,-44.0,-41.0,-81.0,-91.0,-83.0,-89.0,36.0,41.0,37.0,43.0,1
646,F8:59:71:5A:E0:3D,3468014,768694600,240096,360992817,3227918,407701783,3,238790,318679293,233885,318093317,4905,585976,215749,19,242847,5364,3,690,144444.0,43333.0,-68.0,-73.0,-66.0,-70.0,-68.0,-73.0,-66.0,-70.0,-81.0,-91.0,-83.0,-89.0,13.0,18.0,17.0,19.0,1
647,CC:2F:71:3E:C5:1F,3239455,409113026,11533,1410839,3227922,407702187,6,49163,4118115,40618,3105651,8545,1012464,12160,35,16525,188,6,851,130000.0,39000.0,-69.0,-72.0,-67.0,-61.0,-69.0,-74.0,-69.0,-61.0,-81.0,-91.0,-83.0,-89.0,12.0,19.0,16.0,28.0,1
648,CC:2F:71:3F:1F:24,11631595,13300342956,8403671,12892640567,3227924,407702389,94,1879875,1078149225,1871217,1077109079,8658,1040146,1818065,620,8408405,888419,94,6471,130000.0,43333.0,-69.0,-63.0,-72.0,-69.0,-68.0,-63.0,-71.0,-69.0,-81.0,-91.0,-83.0,-89.0,12.0,28.0,11.0,20.0,1
649,92:69:1D:31:68:E9,3250454,454592591,22530,46890202,3227924,407702389,0,10449,3398753,10360,3383885,89,14868,6858,1,22575,1106,0,96,216660.0,130000.0,-53.0,-51.0,-45.0,-50.0,-50.0,-50.0,-47.0,-51.0,-81.0,-91.0,-83.0,-89.0,28.0,40.0,38.0,39.0,1
650,BA:8C:B9:54:50:24,3262047,482948014,34123,75245625,3227924,407702389,0,12603,4085712,12500,4068396,103,17316,7959,6,34152,6765,0,151,216660.0,130000.0,-55.0,-56.0,-55.0,-45.0,-52.0,-55.0,-53.0,-48.0,-81.0,-91.0,-83.0,-89.0,26.0,35.0,28.0,44.0,1
651,62:47:05:9D:EB:15,3231111,415305985,3187,7603596,3227924,407702389,0,843,149313,805,142565,38,6748,398,0,3221,1151,0,9,216660.0,130000.0,-45.0,-38.0,-44.0,-39.0,-45.0,-40.0,-44.0,-41.0,-81.0,-91.0,-83.0,-89.0,36.0,53.0,39.0,50.0,1
652,F8:59:71:5A:E0:3D,3468102,768822634,240178,361120245,3227924,407702389,3,238873,318807113,233968,318221137,4905,585976,215832,19,242929,5364,3,690,144444.0,43333.0,-67.0,-73.0,-66.0,-71.0,-67.0,-73.0,-66.0,-70.0,-81.0,-91.0,-83.0,-89.0,14.0,18.0,17.0,18.0,1
653,CC:2F:71:3E:C5:1F,3239457,409113228,11533,1410839,3227924,407702389,6,49163,4118115,40618,3105651,8545,1012464,12160,35,16525,188,6,851,130000.0,39000.0,-69.0,-72.0,-67.0,-61.0,-69.0,-74.0,-69.0,-61.0,-81.0,-91.0,-83.0,-89.0,12.0,19.0,16.0,28.0,1
654,CC:2F:71:3F:1F:24,11632884,13302305110,8404960,12894602721,3227924,407702389,94,1880277,1078447575,1871619,1077407429,8658,1040146,1818452,620,8409682,888865,94,6471,115556.0,28889.0,-68.0,-64.0,-70.0,-68.0,-68.0,-64.0,-70.0,-68.0,-81.0,-91.0,-83.0,-89.0,13.0,27.0,13.0,21.0,1
655,92:69:1D:31:68:E9,3250624,455010558,22690,47307239,3227934,407703319,0,10481,3406346,10392,3391478,89,14868,6878,1,22735,1109,0,97,216660.0,130000.0,-50.0,-50.0,-45.0,-48.0,-50.0,-50.0,-45.0,-48.0,-81.0,-91.0,-83.0,-89.0,31.0,41.0,38.0,41.0,1
656,BA:8C:B9:54:50:24,3262225,483391382,34291,75688063,3227934,407703319,0,12638,4092471,12535,4075155,103,17316,7977,6,34320,6778,0,154,216660.0,130000.0,-53.0,-53.0,-53.0,-45.0,-51.0,-54.0,-52.0,-48.0,-81.0,-91.0,-83.0,-89.0,28.0,38.0,30.0,44.0,1
657,62:47:05:9D:EB:15,3231121,415306915,3187,7603596,3227934,407703319,0,843,149313,805,142565,38,6748,398,0,3221,1151,0,9,216660.0,130000.0,-45.0,-38.0,-44.0,-39.0,-45.0,-40.0,-44.0,-41.0,-81.0,-91.0,-83.0,-89.0,36.0,53.0,39.0,50.0,1
658,F8:59:71:5A:E0:3D,3468224,768996174,240290,361292855,3227934,407703319,3,238989,318984893,234084,318398917,4905,585976,215947,19,243041,5364,3,690,144444.0,43333.0,-67.0,-73.0,-66.0,-71.0,-67.0,-73.0,-66.0,-70.0,-81.0,-91.0,-83.0,-89.0,14.0,18.0,17.0,18.0,1
659,CC:2F:71:3E:C5:1F,3239467,409114158,11533,1410839,3227934,407703319,6,49163,4118115,40618,3105651,8545,1012464,12160,35,16525,188,6,851,130000.0,39000.0,-69.0,-72.0,-67.0,-61.0,-69.0,-74.0,-69.0,-61.0,-81.0,-91.0,-83.0,-89.0,12.0,19.0,16.0,28.0,1
660,CC:2F:71:3F:1F:24,11634377,13304574566,8406443,12896871247,3227934,407703319,94,1880760,1078840525,1872101,1077800261,8659,1040264,1818897,620,8411159,889312,94,6472,115556.0,28889.0,-68.0,-64.0,-73.0,-69.0,-68.0,-64.0,-71.0,-69.0,-81.0,-91.0,-83.0,-89.0,13.0,27.0,10.0,20.0,1
661,92:69:1D:31:68:E9,3250633,455014010,22699,47310691,3227934,407703319,0,10504,3413595,10415,3398727,89,14868,6888,1,22743,1109,0,97,216660.0,130000.0,-50.0,-50.0,-46.0,-49.0,-52.0,-50.0,-45.0,-50.0,-81.0,-91.0,-83.0,-89.0,31.0,41.0,37.0,40.0,1
662,BA:8C:B9:54:50:24,3262225,483391382,34291,75688063,3227934,407703319,0,12638,4092471,12535,4075155,103,17316,7977,6,34320,6778,0,154,216660.0,130000.0,-53.0,-53.0,-53.0,-45.0,-51.0,-54.0,-52.0,-48.0,-81.0,-91.0,-83.0,-89.0,28.0,38.0,30.0,44.0,1
663,62:47:05:9D:EB:15,3231123,415307117,3187,7603596,3227936,407703521,0,843,149313,805,142565,38,6748,398,0,3221,1151,0,9,216660.0,130000.0,-45.0,-38.0,-44.0,-39.0,-45.0,-40.0,-44.0,-41.0,-81.0,-91.0,-83.0,-89.0,36.0,53.0,39.0,50.0,1
664,F8:59:71:5A:E0:3D,3468307,769122250,240371,361418729,3227936,407703521,3,239070,319109633,234165,318523657,4905,585976,216028,19,243122,5365,3,690,144444.0,43333.0,-67.0,-73.0,-66.0,-71.0,-67.0,-73.0,-66.0,-70.0,-81.0,-91.0,-83.0,-89.0,14.0,18.0,17.0,18.0,1
665,CC:2F:71:3E:C5:1F,3239476,409115026,11533,1410839,3227943,407704187,6,49163,4118115,40618,3105651,8545,1012464,12160,35,16525,188,6,851,130000.0,39000.0,-69.0,-72.0,-67.0,-61.0,-69.0,-74.0,-69.0,-61.0,-81.0,-91.0,-83.0,-89.0,12.0,19.0,16.0,28.0,1
666,CC:2F:71:3F:1F:24,11636093,13307173097,8408150,12899468910,3227943,407704187,94,1881211,1079145195,1872552,1078104931,8659,1040264,1819323,620,8412857,889369,94,6472,115556.0,28889.0,-68.0,-64.0,-72.0,-69.0,-68.0,-64.0,-71.0,-69.0,-81.0,-91.0,-83.0,-89.0,13.0,27.0,11.0,20.0,1
667,92:69:1D:31:68:E9,3250652,455018631,22708,47314382,3227944,407704249,0,10521,3415186,10432,3400318,89,14868,6895,1,22753,1109,0,97,229410.0,130000.0,-49.0,-49.0,-45.0,-49.0,-51.0,-50.0,-45.0,-49.0,-81.0,-92.0,-83.0,-89.0,32.0,43.0,38.0,40.0,1
668,BA:8C:B9:54:50:24,3262235,483392312,34291,75688063,3227944,407704249,0,12638,4092471,12535,4075155,103,17316,7977,6,34320,6778,0,154,216660.0,130000.0,-53.0,-53.0,-53.0,-45.0,-51.0,-54.0,-52.0,-48.0,-81.0,-92.0,-83.0,-89.0,28.0,39.0,30.0,44.0,1
669,62:47:05:9D:EB:15,3231131,415307845,3187,7603596,3227944,407704249,0,843,149313,805,142565,38,6748,398,0,3221,1151,0,9,216660.0,130000.0,-45.0,-38.0,-44.0,-39.0,-45.0,-40.0,-44.0,-41.0,-81.0,-92.0,-83.0,-89.0,36.0,54.0,39.0,50.0,1
670,F8:59:71:5A:E0:3D,3468403,769259618,240459,361555369,3227944,407704249,3,239158,319245181,234253,318659205,4905,585976,216116,19,243209,5370,3,690,144444.0,39000.0,-67.0,-73.0,-66.0,-71.0,-67.0,-72.0,-66.0,-70.0,-81.0,-92.0,-83.0,-89.0,14.0,19.0,17.0,18.0,1
671,CC:2F:71:3E:C5:1F,3239477,409115088,11533,1410839,3227944,407704249,6,49165,4118303,40619,3105721,8546,1012582,12161,35,16525,188,6,852,130000.0,39000.0,-68.0,-72.0,-69.0,-61.0,-70.0,-75.0,-70.0,-63.0,-81.0,-92.0,-83.0,-89.0,13.0,20.0,14.0,28.0,1
672,CC:2F:71:3F:1F:24,11637569,13309401888,8409625,12901697639,3227944,407704249,94,1881635,1079465057,1872976,1078424793,8659,1040264,1819714,620,8414329,889478,94,6472,115556.0,28889.0,-68.0,-64.0,-72.0,-70.0,-68.0,-64.0,-72.0,-69.0,-81.0,-92.0,-83.0,-89.0,13.0,28.0,11.0,19.0,1
673,92:69:1D:31:68:E9,3250680,455023552,22728,47318495,3227952,407705057,0,10557,3419946,10468,3405078,89,14868,6914,1,22773,1109,0,98,229410.0,137640.0,-55.0,-50.0,-45.0,-50.0,-50.0,-49.0,-45.0,-49.0,-81.0,-92.0,-83.0,-89.0,26.0,42.0,38.0,39.0,1
674,BA:8C:B9:54:50:24,3262243,483393120,34291,75688063,3227952,407705057,0,12638,4092471,12535,4075155,103,17316,7977,6,34320,6778,0,154,216660.0,130000.0,-53.0,-53.0,-53.0,-45.0,-51.0,-54.0,-52.0,-48.0,-81.0,-92.0,-83.0,-89.0,28.0,39.0,30.0,44.0,1
675,62:47:05:9D:EB:15,3231139,415308653,3187,7603596,3227952,407705057,0,843,149313,805,142565,38,6748,398,0,3221,1151,0,9,216660.0,130000.0,-45.0,-38.0,-44.0,-39.0,-45.0,-40.0,-44.0,-41.0,-81.0,-92.0,-83.0,-90.0,36.0,54.0,39.0,51.0,1
676,F8:59:71:5A:E0:3D,3468494,769389352,240542,361684295,3227952,407705057,3,239241,319373001,234336,318787025,4905,585976,216199,19,243293,5371,3,690,144444.0,43333.0,-67.0,-73.0,-66.0,-71.0,-67.0,-72.0,-66.0,-70.0,-81.0,-92.0,-83.0,-90.0,14.0,19.0,17.0,19.0,1
677,CC:2F:71:3E:C5:1F,3239485,409115896,11533,1410839,3227952,407705057,6,49165,4118303,40619,3105721,8546,1012582,12161,35,16525,188,6,852,130000.0,39000.0,-68.0,-72.0,-69.0,-61.0,-70.0,-75.0,-70.0,-63.0,-81.0,-92.0,-83.0,-90.0,13.0,20.0,14.0,29.0,1
678,CC:2F:71:3F:1F:24,11638604,13310953032,8410652,12903247975,3227952,407705057,94,1881953,1079752253,1873294,1078711989,8659,1040264,1820018,620,8415385,889478,94,6472,115556.0,28889.0,-68.0,-64.0,-71.0,-69.0,-68.0,-64.0,-71.0,-69.0,-81.0,-92.0,-83.0,-90.0,13.0,28.0,12.0,21.0,1
679,92:69:1D:31:68:E9,3250687,455024398,22734,47319281,3227953,407705117,0,10578,3421717,10489,3406849,89,14868,6920,1,22779,1109,0,98,229410.0,137640.0,-55.0,-51.0,-45.0,-51.0,-53.0,-51.0,-45.0,-50.0,-81.0,-92.0,-83.0,-90.0,26.0,41.0,38.0,39.0,1
680,BA:8C:B9:54:50:24,3262244,483393180,34291,75688063,3227953,407705117,0,12638,4092471,12535,4075155,103,17316,7977,6,34320,6778,0,154,216660.0,130000.0,-53.0,-53.0,-53.0,-45.0,-51.0,-54.0,-52.0,-48.0,-81.0,-92.0,-83.0,-90.0,28.0,39.0,30.0,45.0,1
681,62:47:05:9D:EB:15,3231140,415308713,3187,7603596,3227953,407705117,0,844,149381,806,142633,38,6748,398,0,3222,1151,0,9,216660.0,130000.0,-45.0,-38.0,-43.0,-39.0,-45.0,-40.0,-44.0,-41.0,-81.0,-92.0,-83.0,-90.0,36.0,54.0,40.0,51.0,1
682,F8:59:71:5A:E0:3D,3468576,769515286,240623,361810169,3227953,407705117,3,239323,319499351,234418,318913375,4905,585976,216281,19,243374,5372,3,690,144444.0,43333.0,-67.0,-73.0,-66.0,-71.0,-67.0,-73.0,-66.0,-70.0,-81.0,-92.0,-83.0,-90.0,14.0,19.0,17.0,19.0,1
683,CC:2F:71:3E:C5:1F,3239486,409115956,11533,1410839,3227953,407705117,6,49165,4118303,40619,3105721,8546,1012582,12161,35,16525,188,6,852,130000.0,39000.0,-68.0,-72.0,-69.0,-61.0,-70.0,-75.0,-70.0,-63.0,-81.0,-92.0,-83.0,-90.0,13.0,20.0,14.0,29.0,1
684,CC:2F:71:3F:1F:24,11639924,13312958260,8411970,12905252870,3227954,407705390,94,1882318,1080023698,1873659,1078983434,8659,1040264,1820381,620,8416704,889535,94,6472,130000.0,39000.0,-68.0,-64.0,-72.0,-69.0,-68.0,-64.0,-71.0,-69.0,-81.0,-92.0,-83.0,-90.0,13.0,28.0,11.0,21.0,1
685,92:69:1D:31:68:E9,3250702,455029465,22740,47323267,3227962,407706198,0,10588,3422768,10499,3407900,89,14868,6926,1,22785,1109,0,98,229410.0,137640.0,-53.0,-50.0,-45.0,-51.0,-50.0,-49.0,-45.0,-49.0,-81.0,-92.0,-83.0,-90.0,28.0,42.0,38.0,39.0,1
686,BA:8C:B9:54:50:24,3262253,483394261,34291,75688063,3227962,407706198,0,12638,4092471,12535,4075155,103,17316,7977,6,34320,6778,0,154,216660.0,130000.0,-53.0,-53.0,-53.0,-45.0,-51.0,-54.0,-52.0,-48.0,-81.0,-92.0,-83.0,-90.0,28.0,39.0,30.0,45.0,1
687,62:47:05:9D:EB:15,3231149,415309794,3187,7603596,3227962,407706198,0,845,149449,807,142701,38,6748,398,0,3222,1151,0,9,216660.0,130000.0,-45.0,-50.0,-47.0,-46.0,-45.0,-42.0,-44.0,-41.0,-81.0,-92.0,-83.0,-90.0,36.0,42.0,36.0,44.0,1
688,F8:59:71:5A:E0:3D,3468670,769648457,240708,361942259,3227962,407706198,3,239408,319630251,234503,319044275,4905,585976,216366,19,243459,5372,3,690,144444.0,43333.0,-67.0,-73.0,-66.0,-71.0,-67.0,-73.0,-66.0,-70.0,-81.0,-93.0,-83.0,-89.0,14.0,20.0,17.0,18.0,1
689,CC:2F:71:3E:C5:1F,3239495,409117037,11533,1410839,3227962,407706198,6,49165,4118303,40619,3105721,8546,1012582,12161,35,16525,188,6,852,130000.0,39000.0,-68.0,-72.0,-69.0,-61.0,-70.0,-75.0,-70.0,-63.0,-81.0,-93.0,-83.0,-89.0,13.0,21.0,14.0,28.0,1
690,CC:2F:71:3F:1F:24,11641522,13315398624,8413560,12907692426,3227962,407706198,94,1882720,1080324668,1874061,1079284404,8659,1040264,1820775,620,8418259,889852,94,6473,130000.0,43333.0,-68.0,-64.0,-72.0,-69.0,-68.0,-64.0,-72.0,-69.0,-81.0,-93.0,-83.0,-89.0,13.0,29.0,11.0,20.0,1
691,92:69:1D:31:68:E9,3250703,455029525,22740,47323267,3227963,407706258,0,10588,3422768,10499,3407900,89,14868,6926,1,22785,1109,0,98,229410.0,137640.0,-53.0,-50.0,-45.0,-51.0,-50.0,-49.0,-45.0,-49.0,-81.0,-93.0,-83.0,-89.0,28.0,43.0,38.0,38.0,1
692,BA:8C:B9:54:50:24,3262256,483394523,34291,75688063,3227965,407706460,0,12638,4092471,12535,4075155,103,17316,7977,6,34320,6778,0,154,216660.0,130000.0,-53.0,-53.0,-53.0,-45.0,-51.0,-54.0,-52.0,-48.0,-81.0,-93.0,-83.0,-89.0,28.0,40.0,30.0,44.0,1
693,62:47:05:9D:EB:15,3231156,415310460,3187,7603596,3227969,407706864,0,845,149449,807,142701,38,6748,398,0,3222,1151,0,9,216660.0,130000.0,-45.0,-50.0,-47.0,-46.0,-45.0,-42.0,-44.0,-41.0,-81.0,-93.0,-83.0,-89.0,36.0,43.0,36.0,43.0,1
694,F8:59:71:5A:E0:3D,3468760,769775199,240789,362068133,3227971,407707066,3,239489,319755005,234584,319169029,4905,585976,216446,19,243540,5373,3,690,144444.0,43333.0,-68.0,-73.0,-67.0,-70.0,-67.0,-73.0,-66.0,-70.0,-81.0,-93.0,-83.0,-89.0,13.0,20.0,16.0,19.0,1
695,CC:2F:71:3E:C5:1F,3239504,409117905,11533,1410839,3227971,407707066,6,49165,4118303,40619,3105721,8546,1012582,12161,35,16525,188,6,852,130000.0,39000.0,-68.0,-72.0,-69.0,-61.0,-70.0,-75.0,-70.0,-63.0,-81.0,-93.0,-83.0,-89.0,13.0,21.0,14.0,28.0,1
696,CC:2F:71:3F:1F:24,11642868,13317440958,8414897,12909733892,3227971,407707066,94,1883119,1080612822,1874460,1079572558,8659,1040264,1821144,620,8419631,890186,94,6473,78000.0,13000.0,-69.0,-64.0,-71.0,-69.0,-68.0,-64.0,-72.0,-68.0,-81.0,-93.0,-83.0,-89.0,12.0,29.0,12.0,20.0,1
697,92:69:1D:31:68:E9,3250715,455030679,22740,47323267,3227975,407707412,0,10594,3423333,10503,3408172,91,15161,6928,1,22785,1109,0,98,229410.0,137640.0,-53.0,-51.0,-46.0,-50.0,-51.0,-50.0,-45.0,-49.0,-81.0,-93.0,-83.0,-89.0,28.0,42.0,37.0,39.0,1
698,BA:8C:B9:54:50:24,3262266,483395475,34291,75688063,3227975,407707412,0,12641,4092778,12537,4075291,104,17487,7978,6,34320,6778,0,154,216660.0,130000.0,-54.0,-56.0,-53.0,-45.0,-52.0,-55.0,-53.0,-48.0,-81.0,-93.0,-83.0,-89.0,27.0,37.0,30.0,44.0,1
699,62:47:05:9D:EB:15,3231164,415311294,3189,7603882,3227975,407707412,0,849,149853,811,143105,38,6748,400,0,3224,1151,0,9,216660.0,130000.0,-45.0,-49.0,-47.0,-47.0,-45.0,-43.0,-45.0,-42.0,-81.0,-93.0,-83.0,-89.0,36.0,44.0,36.0,42.0,1
700,F8:59:71:5A:E0:3D,3468855,769916959,240880,362209547,3227975,407707412,3,239582,319896803,234676,319310709,4906,586094,216539,19,243631,5373,3,691,144444.0,43333.0,-67.0,-73.0,-66.0,-70.0,-67.0,-73.0,-66.0,-70.0,-81.0,-93.0,-83.0,-89.0,14.0,20.0,17.0,19.0,1
701,CC:2F:71:3E:C5:1F,3239508,409118251,11533,1410839,3227975,407707412,6,49165,4118303,40619,3105721,8546,1012582,12161,35,16525,188,6,852,130000.0,39000.0,-68.0,-72.0,-69.0,-61.0,-70.0,-75.0,-70.0,-63.0,-81.0,-93.0,-83.0,-89.0,13.0,21.0,14.0,28.0,1
702,CC:2F:71:3F:1F:24,11644338,13319677297,8416363,12911969885,3227975,407707412,94,1883557,1080947547,1874898,1079907283,8659,1040264,1821555,620,8421096,890290,94,6473,115556.0,28889.0,-70.0,-64.0,-72.0,-68.0,-69.0,-64.0,-71.0,-68.0,-81.0,-92.0,-83.0,-89.0,11.0,28.0,11.0,21.0,1
703,92:69:1D:31:68:E9,3250724,455031547,22740,47323267,3227984,407708280,0,10598,3423605,10507,3408444,91,15161,6928,1,22785,1109,0,98,229410.0,137640.0,-52.0,-52.0,-52.0,-55.0,-52.0,-51.0,-46.0,-50.0,-81.0,-92.0,-83.0,-89.0,29.0,40.0,31.0,34.0,1
704,BA:8C:B9:54:50:24,3262460,483856817,34476,76148537,3227984,407708280,0,12668,4099310,12564,4081823,104,17487,7999,6,34505,6812,0,154,229410.0,130000.0,-54.0,-56.0,-55.0,-45.0,-52.0,-55.0,-53.0,-48.0,-81.0,-92.0,-83.0,-89.0,27.0,36.0,28.0,44.0,1
705,62:47:05:9D:EB:15,3231173,415312162,3189,7603882,3227984,407708280,0,849,149853,811,143105,38,6748,400,0,3224,1151,0,9,216660.0,130000.0,-45.0,-49.0,-47.0,-47.0,-45.0,-43.0,-45.0,-42.0,-81.0,-92.0,-83.0,-89.0,36.0,43.0,36.0,42.0,1
706,F8:59:71:5A:E0:3D,3468951,770053025,240967,362344745,3227984,407708280,3,239664,320023195,234758,319437101,4906,586094,216621,19,243718,5379,3,691,144444.0,43333.0,-68.0,-73.0,-66.0,-70.0,-68.0,-73.0,-66.0,-70.0,-81.0,-92.0,-83.0,-89.0,13.0,19.0,17.0,19.0,1
707,CC:2F:71:3E:C5:1F,3239517,409119119,11533,1410839,3227984,407708280,6,49165,4118303,40619,3105721,8546,1012582,12161,35,16525,188,6,852,130000.0,39000.0,-68.0,-72.0,-69.0,-61.0,-70.0,-75.0,-70.0,-63.0,-81.0,-92.0,-83.0,-89.0,13.0,20.0,14.0,28.0,1
708,CC:2F:71:3F:1F:24,11645397,13321267137,8417413,12913558857,3227984,407708280,94,1883918,1081284429,1875259,1080244165,8659,1040264,1821885,620,8422147,890383,94,6474,130000.0,39000.0,-69.0,-64.0,-72.0,-69.0,-69.0,-64.0,-71.0,-69.0,-81.0,-92.0,-83.0,-89.0,12.0,28.0,11.0,20.0,1
709,92:69:1D:31:68:E9,3250724,455031547,22740,47323267,3227984,407708280,0,10605,3424081,10514,3408920,91,15161,6928,1,22785,1109,0,98,229410.0,137640.0,-53.0,-51.0,-46.0,-51.0,-52.0,-51.0,-46.0,-51.0,-81.0,-92.0,-83.0,-89.0,28.0,41.0,37.0,38.0,1
710,BA:8C:B9:54:50:24,3262462,483857019,34476,76148537,3227986,407708482,0,12668,4099310,12564,4081823,104,17487,7999,6,34505,6812,0,154,229410.0,130000.0,-54.0,-56.0,-55.0,-45.0,-52.0,-55.0,-53.0,-48.0,-81.0,-92.0,-83.0,-89.0,27.0,36.0,28.0,44.0,1
711,62:47:05:9D:EB:15,3231177,415312566,3189,7603882,3227988,407708684,0,849,149853,811,143105,38,6748,400,0,3224,1151,0,9,216660.0,130000.0,-45.0,-49.0,-47.0,-47.0,-45.0,-43.0,-45.0,-42.0,-81.0,-92.0,-83.0,-89.0,36.0,43.0,36.0,42.0,1
712,F8:59:71:5A:E0:3D,3469058,770207679,241066,362498591,3227992,407709088,3,239768,320183467,234862,319597373,4906,586094,216725,19,243817,5379,3,692,144444.0,43333.0,-68.0,-73.0,-66.0,-71.0,-67.0,-73.0,-66.0,-70.0,-81.0,-92.0,-83.0,-89.0,13.0,19.0,17.0,18.0,1
713,CC:2F:71:3E:C5:1F,3239525,409119927,11533,1410839,3227992,407709088,6,49165,4118303,40619,3105721,8546,1012582,12161,35,16525,188,6,852,130000.0,39000.0,-68.0,-72.0,-69.0,-61.0,-70.0,-75.0,-70.0,-63.0,-81.0,-92.0,-83.0,-89.0,13.0,20.0,14.0,28.0,1
714,CC:2F:71:3F:1F:24,11646650,13323163979,8418658,12915454891,3227992,407709088,94,1884290,1081612029,1875631,1080571765,8659,1040264,1822241,620,8423392,890616,94,6474,130000.0,43333.0,-70.0,-64.0,-72.0,-69.0,-69.0,-64.0,-72.0,-69.0,-81.0,-92.0,-83.0,-89.0,11.0,28.0,11.0,20.0,1
715,92:69:1D:31:68:E9,3250733,455032415,22740,47323267,3227993,407709148,0,10605,3424081,10514,3408920,91,15161,6928,1,22785,1109,0,98,229410.0,137640.0,-53.0,-51.0,-46.0,-51.0,-52.0,-51.0,-46.0,-51.0,-81.0,-92.0,-83.0,-89.0,28.0,41.0,37.0,38.0,1
716,BA:8C:B9:54:50:24,3262469,483857685,34476,76148537,3227993,407709148,0,12669,4099378,12565,4081891,104,17487,7999,6,34505,6812,0,154,229410.0,130000.0,-47.0,-54.0,-51.0,-62.0,-51.0,-55.0,-53.0,-49.0,-81.0,-92.0,-83.0,-89.0,34.0,38.0,32.0,27.0,1
717,62:47:05:9D:EB:15,3231182,415313030,3189,7603882,3227993,407709148,0,849,149853,811,143105,38,6748,400,0,3224,1151,0,9,216660.0,130000.0,-45.0,-49.0,-47.0,-47.0,-45.0,-43.0,-45.0,-42.0,-81.0,-92.0,-83.0,-89.0,36.0,43.0,36.0,42.0,1
718,F8:59:71:5A:E0:3D,3469142,770336721,241149,362627573,3227993,407709148,3,239851,320311357,234945,319725263,4906,586094,216808,19,243900,5380,3,692,144444.0,43333.0,-68.0,-73.0,-66.0,-70.0,-67.0,-73.0,-66.0,-70.0,-81.0,-92.0,-83.0,-89.0,13.0,19.0,17.0,19.0,1
719,CC:2F:71:3E:C5:1F,3239526,409119987,11533,1410839,3227993,407709148,6,49165,4118303,40619,3105721,8546,1012582,12161,35,16525,188,6,852,130000.0,39000.0,-68.0,-72.0,-69.0,-61.0,-70.0,-75.0,-70.0,-63.0,-81.0,-92.0,-83.0,-89.0,13.0,20.0,14.0,28.0,1
720,CC:2F:71:3F:1F:24,11648467,13325956392,8420474,12918247244,3227993,407709148,94,1884742,1081925308,1876083,1080885044,8659,1040264,1822669,620,8425207,890697,94,6474,117000.0,39000.0,-70.0,-64.0,-72.0,-69.0,-69.0,-63.0,-70.0,-69.0,-81.0,-92.0,-83.0,-89.0,11.0,28.0,11.0,20.0,1
721,92:69:1D:31:68:E9,3250893,455431192,22891,47721158,3228002,407710034,0,10633,3429936,10541,3414637,92,15299,6946,1,22936,1256,0,99,229410.0,137640.0,-53.0,-51.0,-46.0,-51.0,-49.0,-49.0,-45.0,-49.0,-81.0,-92.0,-83.0,-89.0,28.0,41.0,37.0,38.0,1
722,BA:8C:B9:54:50:24,3262478,483858571,34476,76148537,3228002,407710034,0,12669,4099378,12565,4081891,104,17487,7999,6,34505,6812,0,154,229410.0,130000.0,-47.0,-54.0,-51.0,-62.0,-51.0,-55.0,-53.0,-49.0,-81.0,-92.0,-83.0,-89.0,34.0,38.0,32.0,27.0,1
723,62:47:05:9D:EB:15,3231191,415313916,3189,7603882,3228002,407710034,0,849,149853,811,143105,38,6748,400,0,3224,1151,0,9,216660.0,130000.0,-45.0,-49.0,-47.0,-47.0,-45.0,-43.0,-45.0,-42.0,-81.0,-92.0,-83.0,-89.0,36.0,43.0,36.0,42.0,1
724,F8:59:71:5A:E0:3D,3469266,770516317,241264,362806283,3228002,407710034,3,239960,320480071,235054,319893977,4906,586094,216917,19,244010,5391,3,693,144444.0,43333.0,-67.0,-73.0,-66.0,-71.0,-67.0,-73.0,-66.0,-70.0,-81.0,-92.0,-83.0,-89.0,14.0,19.0,17.0,18.0,1
725,CC:2F:71:3E:C5:1F,3239536,409120933,11533,1410839,3228003,407710094,6,49165,4118303,40619,3105721,8546,1012582,12161,35,16525,188,6,852,130000.0,39000.0,-68.0,-72.0,-69.0,-61.0,-70.0,-75.0,-70.0,-63.0,-81.0,-92.0,-83.0,-89.0,13.0,20.0,14.0,28.0,1
726,CC:2F:71:3F:1F:24,11650010,13328304228,8422007,12920594134,3228003,407710094,94,1885275,1082438802,1876616,1081398538,8659,1040264,1823168,620,8426701,890859,94,6474,130000.0,43333.0,-70.0,-64.0,-73.0,-69.0,-70.0,-64.0,-72.0,-69.0,-81.0,-92.0,-83.0,-89.0,11.0,28.0,10.0,20.0,1
727,92:69:1D:31:68:E9,3250902,455432060,22891,47721158,3228011,407710902,0,10637,3430208,10545,3414909,92,15299,6946,1,22936,1256,0,99,229410.0,137640.0,-54.0,-50.0,-45.0,-51.0,-52.0,-49.0,-45.0,-50.0,-81.0,-92.0,-83.0,-89.0,27.0,42.0,38.0,38.0,1
728,BA:8C:B9:54:50:24,3262487,483859439,34476,76148537,3228011,407710902,0,12669,4099378,12565,4081891,104,17487,7999,6,34505,6812,0,154,229410.0,130000.0,-47.0,-54.0,-51.0,-62.0,-51.0,-55.0,-53.0,-49.0,-81.0,-92.0,-83.0,-89.0,34.0,38.0,32.0,27.0,1
729,62:47:05:9D:EB:15,3231201,415314900,3190,7603998,3228011,407710902,0,852,150099,814,143351,38,6748,401,0,3225,1151,0,9,216660.0,130000.0,-45.0,-50.0,-46.0,-46.0,-45.0,-45.0,-45.0,-44.0,-81.0,-92.0,-83.0,-89.0,36.0,42.0,37.0,43.0,1
730,F8:59:71:5A:E0:3D,3469397,770706773,241386,362995871,3228011,407710902,3,240091,320676043,235185,320089949,4906,586094,217044,19,244137,5398,3,693,144444.0,43333.0,-68.0,-73.0,-66.0,-71.0,-68.0,-73.0,-66.0,-70.0,-81.0,-92.0,-83.0,-89.0,13.0,19.0,17.0,18.0,1
731,CC:2F:71:3E:C5:1F,3239544,409121741,11533,1410839,3228011,407710902,6,49165,4118303,40619,3105721,8546,1012582,12161,35,16525,188,6,852,130000.0,39000.0,-68.0,-72.0,-69.0,-61.0,-70.0,-75.0,-70.0,-63.0,-81.0,-92.0,-83.0,-89.0,13.0,20.0,14.0,28.0,1
732,CC:2F:71:3F:1F:24,11651895,13331188182,8423884,12923477280,3228011,407710902,94,1885755,1082769526,1877096,1081729262,8659,1040264,1823617,620,8428618,890967,94,6474,130000.0,43333.0,-70.0,-64.0,-73.0,-69.0,-70.0,-64.0,-72.0,-69.0,-81.0,-92.0,-83.0,-89.0,11.0,28.0,10.0,20.0,1
733,92:69:1D:31:68:E9,3250907,455432783,22896,47721881,3228011,407710902,0,10643,3430887,10551,3415588,92,15299,6950,1,22941,1256,0,99,229410.0,137640.0,-55.0,-50.0,-45.0,-51.0,-52.0,-49.0,-45.0,-49.0,-81.0,-92.0,-83.0,-88.0,26.0,42.0,38.0,37.0,1
734,BA:8C:B9:54:50:24,3262492,483859903,34476,76148537,3228016,407711366,0,12669,4099378,12565,4081891,104,17487,7999,6,34505,6812,0,154,229410.0,130000.0,-47.0,-54.0,-51.0,-62.0,-51.0,-55.0,-53.0,-49.0,-81.0,-92.0,-83.0,-88.0,34.0,38.0,32.0,26.0,1
735,62:47:05:9D:EB:15,3231208,415315566,3190,7603998,3228018,407711568,0,852,150099,814,143351,38,6748,401,0,3225,1151,0,9,216660.0,130000.0,-45.0,-50.0,-46.0,-46.0,-45.0,-45.0,-45.0,-44.0,-81.0,-92.0,-83.0,-88.0,36.0,42.0,37.0,42.0,1
736,F8:59:71:5A:E0:3D,3469500,770855203,241481,363143501,3228019,407711702,3,240190,320825619,235284,320239525,4906,586094,217140,19,244232,5398,3,693,144444.0,43333.0,-68.0,-73.0,-66.0,-71.0,-67.0,-72.0,-65.0,-70.0,-81.0,-92.0,-83.0,-88.0,13.0,19.0,17.0,17.0,1
737,CC:2F:71:3E:C5:1F,3239553,409122609,11533,1410839,3228020,407711770,6,49165,4118303,40619,3105721,8546,1012582,12161,35,16525,188,6,852,130000.0,39000.0,-68.0,-72.0,-69.0,-61.0,-70.0,-75.0,-70.0,-63.0,-81.0,-92.0,-83.0,-88.0,13.0,20.0,14.0,27.0,1
738,CC:2F:71:3F:1F:24,11654003,13334419403,8425983,12926707633,3228020,407711770,94,1886238,1083114167,1877579,1082073903,8659,1040264,1824092,620,8430717,891150,94,6476,130000.0,43333.0,-70.0,-64.0,-73.0,-69.0,-69.0,-64.0,-73.0,-68.0,-81.0,-92.0,-83.0,-88.0,11.0,28.0,10.0,19.0,1
739,92:69:1D:31:68:E9,3250917,455433924,22896,47721881,3228021,407712043,0,10644,3430955,10552,3415656,92,15299,6950,1,22941,1256,0,99,229410.0,137640.0,-51.0,-52.0,-51.0,-55.0,-51.0,-49.0,-45.0,-50.0,-81.0,-92.0,-83.0,-89.0,30.0,40.0,32.0,34.0,1
740,BA:8C:B9:54:50:24,3262497,483860580,34476,76148537,3228021,407712043,0,12669,4099378,12565,4081891,104,17487,7999,6,34505,6812,0,154,229410.0,130000.0,-47.0,-54.0,-51.0,-62.0,-51.0,-55.0,-53.0,-49.0,-81.0,-92.0,-83.0,-89.0,34.0,38.0,32.0,27.0,1
741,62:47:05:9D:EB:15,3231211,415316041,3190,7603998,3228021,407712043,0,852,150099,814,143351,38,6748,401,0,3225,1151,0,9,216660.0,130000.0,-45.0,-50.0,-46.0,-46.0,-45.0,-45.0,-45.0,-44.0,-81.0,-92.0,-83.0,-89.0,36.0,42.0,37.0,43.0,1
742,F8:59:71:5A:E0:3D,3469596,771001620,241575,363289577,3228021,407712043,3,240281,320965787,235375,320379693,4906,586094,217229,19,244326,5398,3,693,144444.0,43333.0,-68.0,-73.0,-66.0,-71.0,-68.0,-73.0,-66.0,-70.0,-81.0,-92.0,-83.0,-89.0,13.0,19.0,17.0,18.0,1
743,CC:2F:71:3E:C5:1F,3239554,409122882,11533,1410839,3228021,407712043,6,49165,4118303,40619,3105721,8546,1012582,12161,35,16525,188,6,852,130000.0,39000.0,-68.0,-72.0,-69.0,-61.0,-70.0,-75.0,-70.0,-63.0,-81.0,-92.0,-83.0,-89.0,13.0,20.0,14.0,28.0,1
744,CC:2F:71:3F:1F:24,11655464,13336653276,8427443,12928941233,3228021,407712043,94,1886617,1083417185,1877958,1082376921,8659,1040264,1824458,620,8432177,891161,94,6477,130000.0,43333.0,-70.0,-64.0,-73.0,-69.0,-69.0,-64.0,-73.0,-68.0,-81.0,-92.0,-83.0,-89.0,11.0,28.0,10.0,20.0,1
745,92:69:1D:31:68:E9,3250926,455434792,22896,47721881,3228030,407712911,0,10644,3430955,10552,3415656,92,15299,6950,1,22941,1256,0,99,229410.0,137640.0,-51.0,-52.0,-51.0,-55.0,-51.0,-49.0,-45.0,-50.0,-81.0,-92.0,-83.0,-89.0,30.0,40.0,32.0,34.0,1
746,BA:8C:B9:54:50:24,3262506,483861448,34476,76148537,3228030,407712911,0,12669,4099378,12565,4081891,104,17487,7999,6,34505,6812,0,154,229410.0,130000.0,-47.0,-54.0,-51.0,-62.0,-51.0,-55.0,-53.0,-49.0,-81.0,-92.0,-83.0,-89.0,34.0,38.0,32.0,27.0,1
747,62:47:05:9D:EB:15,3231220,415316909,3190,7603998,3228030,407712911,0,852,150099,814,143351,38,6748,401,0,3225,1151,0,9,216660.0,130000.0,-45.0,-50.0,-46.0,-46.0,-45.0,-45.0,-45.0,-44.0,-81.0,-92.0,-83.0,-89.0,36.0,42.0,37.0,43.0,1
748,F8:59:71:5A:E0:3D,3469695,771141465,241665,363428554,3228030,407712911,3,240375,321109157,235469,320523063,4906,586094,217323,19,244416,5399,3,693,144444.0,43333.0,-68.0,-73.0,-66.0,-70.0,-67.0,-73.0,-66.0,-70.0,-81.0,-92.0,-83.0,-89.0,13.0,19.0,17.0,19.0,1
749,CC:2F:71:3E:C5:1F,3239563,409123750,11533,1410839,3228030,407712911,6,49165,4118303,40619,3105721,8546,1012582,12161,35,16525,188,6,852,130000.0,39000.0,-68.0,-72.0,-69.0,-61.0,-70.0,-75.0,-70.0,-63.0,-81.0,-92.0,-83.0,-89.0,13.0,20.0,14.0,28.0,1
750,CC:2F:71:3F:1F:24,11656659,13338455084,8428629,12930742173,3228030,407712911,94,1886968,1083723947,1878309,1082683683,8659,1040264,1824790,620,8433353,891242,94,6478,130000.0,43333.0,-69.0,-64.0,-73.0,-68.0,-69.0,-64.0,-73.0,-68.0,-81.0,-92.0,-83.0,-89.0,12.0,28.0,10.0,21.0,1
751,92:69:1D:31:68:E9,3250926,455434792,22896,47721881,3228030,407712911,0,10644,3430955,10552,3415656,92,15299,6950,1,22941,1256,0,99,229410.0,137640.0,-51.0,-52.0,-51.0,-55.0,-51.0,-49.0,-45.0,-50.0,-81.0,-92.0,-83.0,-89.0,30.0,40.0,32.0,34.0,1
752,BA:8C:B9:54:50:24,3262689,484340764,34657,76627651,3228032,407713113,0,12702,4106179,12598,4088692,104,17487,8021,6,34686,6813,0,154,216660.0,130000.0,-54.0,-56.0,-55.0,-45.0,-51.0,-55.0,-53.0,-48.0,-81.0,-92.0,-83.0,-89.0,27.0,36.0,28.0,44.0,1
753,62:47:05:9D:EB:15,3231226,415317515,3190,7603998,3228036,407713517,0,852,150099,814,143351,38,6748,401,0,3225,1151,0,9,216660.0,130000.0,-45.0,-50.0,-46.0,-46.0,-45.0,-45.0,-45.0,-44.0,-81.0,-92.0,-83.0,-89.0,36.0,42.0,37.0,43.0,1
754,F8:59:71:5A:E0:3D,3469789,771278823,241753,363565306,3228036,407713517,3,240464,321246259,235558,320660165,4906,586094,217412,19,244504,5399,3,693,144444.0,43333.0,-67.0,-73.0,-66.0,-71.0,-67.0,-72.0,-66.0,-70.0,-81.0,-92.0,-83.0,-89.0,14.0,19.0,17.0,18.0,1
755,CC:2F:71:3E:C5:1F,3239572,409124674,11534,1410955,3228038,407713719,6,49166,4118373,40620,3105791,8546,1012582,12161,35,16526,188,6,852,130000.0,39000.0,-68.0,-73.0,-68.0,-60.0,-70.0,-75.0,-70.0,-63.0,-81.0,-92.0,-83.0,-89.0,13.0,19.0,15.0,29.0,1
756,CC:2F:71:3F:1F:24,11658007,13340488341,8429969,12932774622,3228038,407713719,94,1887352,1084041084,1878693,1083000820,8659,1040264,1825152,620,8434703,891445,94,6479,130000.0,43333.0,-70.0,-64.0,-72.0,-70.0,-70.0,-64.0,-71.0,-69.0,-81.0,-92.0,-83.0,-89.0,11.0,28.0,11.0,19.0,1
757,92:69:1D:31:68:E9,3250938,455436144,22897,47721997,3228041,407714147,0,10648,3431227,10556,3415928,92,15299,6950,1,22942,1256,0,99,229410.0,137640.0,-55.0,-50.0,-45.0,-51.0,-51.0,-49.0,-46.0,-50.0,-81.0,-92.0,-83.0,-89.0,26.0,42.0,38.0,38.0,1
758,BA:8C:B9:54:50:24,3262699,484341858,34658,76627711,3228041,407714147,0,12709,4106655,12605,4089168,104,17487,8021,6,34687,6813,0,154,216660.0,130000.0,-54.0,-57.0,-56.0,-45.0,-52.0,-55.0,-54.0,-45.0,-81.0,-92.0,-83.0,-89.0,27.0,35.0,27.0,44.0,1
759,62:47:05:9D:EB:15,3231232,415318261,3191,7604114,3228041,407714147,0,854,150235,816,143487,38,6748,401,0,3226,1151,0,9,216660.0,130000.0,-45.0,-50.0,-46.0,-47.0,-45.0,-45.0,-45.0,-44.0,-81.0,-92.0,-83.0,-89.0,36.0,42.0,37.0,42.0,1
760,F8:59:71:5A:E0:3D,3469886,771420983,241845,363706836,3228041,407714147,3,240555,321386455,235649,320800361,4906,586094,217503,19,244596,5400,3,693,144444.0,43333.0,-68.0,-73.0,-66.0,-71.0,-68.0,-73.0,-66.0,-70.0,-81.0,-92.0,-83.0,-89.0,13.0,19.0,17.0,18.0,1
761,CC:2F:71:3E:C5:1F,3239575,409125102,11534,1410955,3228041,407714147,6,49167,4118443,40621,3105861,8546,1012582,12161,35,16526,188,6,852,130000.0,39000.0,-69.0,-74.0,-68.0,-60.0,-70.0,-75.0,-70.0,-63.0,-81.0,-92.0,-83.0,-89.0,12.0,18.0,15.0,29.0,1
762,CC:2F:71:3F:1F:24,11659598,13342902575,8431557,12935188428,3228041,407714147,94,1887788,1084383619,1879129,1083343355,8659,1040264,1825540,620,8436291,891834,94,6479,130000.0,43333.0,-70.0,-64.0,-72.0,-69.0,-69.0,-64.0,-72.0,-68.0,-81.0,-92.0,-83.0,-89.0,11.0,28.0,11.0,20.0,1
763,92:69:1D:31:68:E9,3250944,455436750,22897,47721997,3228047,407714753,0,10648,3431227,10556,3415928,92,15299,6950,1,22942,1256,0,99,229410.0,137640.0,-55.0,-50.0,-45.0,-51.0,-51.0,-49.0,-46.0,-50.0,-81.0,-91.0,-82.0,-89.0,26.0,41.0,37.0,38.0,1
764,BA:8C:B9:54:50:24,3262707,484342666,34658,76627711,3228049,407714955,0,12709,4106655,12605,4089168,104,17487,8021,6,34687,6813,0,154,216660.0,130000.0,-54.0,-57.0,-56.0,-45.0,-52.0,-55.0,-54.0,-45.0,-81.0,-91.0,-82.0,-89.0,27.0,34.0,26.0,44.0,1
765,62:47:05:9D:EB:15,3231240,415319069,3191,7604114,3228049,407714955,0,854,150235,816,143487,38,6748,401,0,3226,1151,0,9,216660.0,130000.0,-45.0,-50.0,-46.0,-47.0,-45.0,-45.0,-45.0,-44.0,-81.0,-91.0,-82.0,-89.0,36.0,41.0,36.0,42.0,1
766,F8:59:71:5A:E0:3D,3469983,771559929,241934,363844974,3228049,407714955,3,240638,321514303,235732,320928209,4906,586094,217586,19,244685,5401,3,693,144444.0,43333.0,-68.0,-73.0,-66.0,-71.0,-67.0,-73.0,-66.0,-70.0,-81.0,-91.0,-82.0,-89.0,13.0,18.0,16.0,18.0,1
767,CC:2F:71:3E:C5:1F,3239583,409125910,11534,1410955,3228049,407714955,6,49167,4118443,40621,3105861,8546,1012582,12161,35,16526,188,6,852,130000.0,39000.0,-69.0,-74.0,-68.0,-60.0,-70.0,-75.0,-70.0,-63.0,-81.0,-91.0,-82.0,-89.0,12.0,17.0,14.0,29.0,1
768,CC:2F:71:3F:1F:24,11661075,13345149553,8433026,12937434598,3228049,407714955,94,1888167,1084697867,1879508,1083657603,8659,1040264,1825897,620,8437757,892090,94,6479,130000.0,43333.0,-70.0,-64.0,-72.0,-68.0,-69.0,-64.0,-72.0,-68.0,-81.0,-91.0,-82.0,-89.0,11.0,27.0,10.0,21.0,1
769,92:69:1D:31:68:E9,3250946,455436952,22897,47721997,3228049,407714955,0,10648,3431227,10556,3415928,92,15299,6950,1,22942,1256,0,99,229410.0,137640.0,-55.0,-50.0,-45.0,-51.0,-51.0,-49.0,-46.0,-50.0,-81.0,-91.0,-83.0,-88.0,26.0,41.0,38.0,37.0,1
770,BA:8C:B9:54:50:24,3262720,484346967,34671,76632012,3228049,407714955,0,12735,4110615,12631,4093128,104,17487,8037,6,34700,6813,0,154,216660.0,130000.0,-54.0,-56.0,-55.0,-45.0,-51.0,-55.0,-53.0,-49.0,-81.0,-91.0,-83.0,-88.0,27.0,35.0,28.0,43.0,1
771,62:47:05:9D:EB:15,3231243,415319331,3191,7604114,3228052,407715217,0,854,150235,816,143487,38,6748,401,0,3226,1151,0,9,216660.0,130000.0,-45.0,-50.0,-46.0,-47.0,-45.0,-45.0,-45.0,-44.0,-81.0,-91.0,-83.0,-88.0,36.0,41.0,37.0,41.0,1
772,F8:59:71:5A:E0:3D,3470072,771690929,242018,363975510,3228054,407715419,3,240728,321652987,235822,321066893,4906,586094,217676,19,244769,5401,3,693,144444.0,43333.0,-68.0,-71.0,-67.0,-70.0,-68.0,-72.0,-66.0,-70.0,-81.0,-91.0,-83.0,-88.0,13.0,20.0,16.0,18.0,1
773,CC:2F:71:3E:C5:1F,3239590,409126576,11534,1410955,3228056,407715621,6,49167,4118443,40621,3105861,8546,1012582,12161,35,16526,188,6,852,130000.0,39000.0,-69.0,-74.0,-68.0,-60.0,-70.0,-75.0,-70.0,-63.0,-81.0,-91.0,-83.0,-88.0,12.0,17.0,15.0,28.0,1
774,CC:2F:71:3F:1F:24,11662445,13347221546,8434389,12939505925,3228056,407715621,94,1888571,1084998643,1879912,1083958379,8659,1040264,1826281,620,8439123,892545,94,6479,115556.0,28889.0,-70.0,-64.0,-72.0,-69.0,-69.0,-64.0,-72.0,-68.0,-81.0,-91.0,-83.0,-88.0,11.0,27.0,11.0,19.0,1
775,92:69:1D:31:68:E9,3251071,455739099,23012,48023214,3228059,407715885,0,10666,3436147,10574,3420848,92,15299,6964,1,23057,1256,0,100,216660.0,130000.0,-54.0,-49.0,-45.0,-51.0,-50.0,-49.0,-45.0,-48.0,-81.0,-91.0,-83.0,-88.0,27.0,42.0,38.0,37.0,1
776,BA:8C:B9:54:50:24,3262730,484347897,34671,76632012,3228059,407715885,0,12735,4110615,12631,4093128,104,17487,8037,6,34700,6813,0,154,216660.0,130000.0,-54.0,-56.0,-55.0,-45.0,-51.0,-55.0,-53.0,-49.0,-81.0,-91.0,-83.0,-88.0,27.0,35.0,28.0,43.0,1
777,62:47:05:9D:EB:15,3231250,415319999,3191,7604114,3228059,407715885,0,854,150235,816,143487,38,6748,401,0,3226,1151,0,9,216660.0,130000.0,-45.0,-50.0,-46.0,-47.0,-45.0,-45.0,-45.0,-44.0,-81.0,-91.0,-83.0,-88.0,36.0,41.0,37.0,41.0,1
778,F8:59:71:5A:E0:3D,3470158,771817269,242099,364101384,3228059,407715885,3,240809,321777741,235903,321191647,4906,586094,217756,19,244850,5401,3,693,144444.0,43333.0,-68.0,-73.0,-67.0,-70.0,-67.0,-73.0,-66.0,-70.0,-81.0,-91.0,-83.0,-88.0,13.0,18.0,16.0,18.0,1
779,CC:2F:71:3E:C5:1F,3239593,409126840,11534,1410955,3228059,407715885,6,49167,4118443,40621,3105861,8546,1012582,12161,35,16526,188,6,852,130000.0,39000.0,-69.0,-74.0,-68.0,-60.0,-70.0,-75.0,-70.0,-63.0,-81.0,-91.0,-83.0,-88.0,12.0,17.0,15.0,28.0,1
780,CC:2F:71:3F:1F:24,11663770,13349205129,8435711,12941489244,3228059,407715885,94,1889003,1085301758,1880343,1084261376,8660,1040382,1826675,620,8440445,892584,94,6479,115556.0,28889.0,-69.0,-64.0,-72.0,-69.0,-69.0,-64.0,-72.0,-69.0,-81.0,-91.0,-83.0,-88.0,12.0,27.0,11.0,19.0,1
781,92:69:1D:31:68:E9,3251078,455739767,23012,48023214,3228066,407716553,0,10666,3436147,10574,3420848,92,15299,6964,1,23057,1256,0,100,216660.0,130000.0,-54.0,-49.0,-45.0,-51.0,-50.0,-49.0,-45.0,-48.0,-81.0,-91.0,-83.0,-88.0,27.0,42.0,38.0,37.0,1
782,BA:8C:B9:54:50:24,3262737,484348565,34671,76632012,3228066,407716553,0,12735,4110615,12631,4093128,104,17487,8037,6,34700,6813,0,154,216660.0,130000.0,-54.0,-56.0,-55.0,-45.0,-51.0,-55.0,-53.0,-49.0,-81.0,-91.0,-83.0,-88.0,27.0,35.0,28.0,43.0,1
783,62:47:05:9D:EB:15,3231257,415320667,3191,7604114,3228066,407716553,0,854,150235,816,143487,38,6748,401,0,3226,1151,0,9,216660.0,130000.0,-45.0,-50.0,-46.0,-47.0,-45.0,-45.0,-45.0,-44.0,-81.0,-91.0,-83.0,-88.0,36.0,41.0,37.0,41.0,1
784,F8:59:71:5A:E0:3D,3470246,771943811,242180,364227258,3228066,407716553,3,240891,321904049,235985,321317955,4906,586094,217838,19,244931,5401,3,694,144444.0,43333.0,-68.0,-73.0,-66.0,-70.0,-67.0,-73.0,-66.0,-70.0,-81.0,-91.0,-83.0,-88.0,13.0,18.0,17.0,18.0,1
785,CC:2F:71:3E:C5:1F,3239601,409127568,11534,1410955,3228067,407716613,6,49169,4118631,40622,3105931,8547,1012700,12162,35,16526,188,6,852,130000.0,39000.0,-69.0,-73.0,-68.0,-60.0,-69.0,-74.0,-68.0,-61.0,-81.0,-91.0,-83.0,-88.0,12.0,18.0,15.0,28.0,1
786,CC:2F:71:3F:1F:24,11664987,13351038809,8436918,12943321994,3228069,407716815,94,1889421,1085611406,1880761,1084571024,8660,1040382,1827065,620,8441651,892682,94,6480,130000.0,43333.0,-69.0,-64.0,-72.0,-68.0,-69.0,-63.0,-71.0,-68.0,-81.0,-91.0,-83.0,-88.0,12.0,27.0,11.0,20.0,1
787,92:69:1D:31:68:E9,3251089,455743519,23018,48026580,3228071,407716939,0,10676,3439287,10584,3423988,92,15299,6969,1,23063,1256,0,100,216660.0,130000.0,-54.0,-50.0,-45.0,-51.0,-51.0,-49.0,-46.0,-49.0,-81.0,-91.0,-82.0,-88.0,27.0,41.0,37.0,37.0,1
788,BA:8C:B9:54:50:24,3262742,484348951,34671,76632012,3228071,407716939,0,12738,4110873,12633,4093264,105,17609,8038,6,34700,6813,0,154,216660.0,130000.0,-54.0,-57.0,-55.0,-45.0,-51.0,-55.0,-53.0,-47.0,-81.0,-91.0,-82.0,-88.0,27.0,34.0,27.0,43.0,1
789,62:47:05:9D:EB:15,3231262,415321053,3191,7604114,3228071,407716939,0,854,150235,816,143487,38,6748,401,0,3226,1151,0,9,216660.0,130000.0,-45.0,-50.0,-46.0,-47.0,-45.0,-45.0,-45.0,-44.0,-81.0,-91.0,-82.0,-88.0,36.0,41.0,36.0,41.0,1
790,F8:59:71:5A:E0:3D,3470355,772094143,242273,364371780,3228082,407722363,3,240984,322045889,236077,321459677,4907,586212,217931,19,245024,5405,3,694,144444.0,43333.0,-68.0,-73.0,-67.0,-70.0,-68.0,-73.0,-66.0,-70.0,-81.0,-91.0,-82.0,-88.0,13.0,18.0,15.0,18.0,1
791,CC:2F:71:3E:C5:1F,3239616,409133318,11534,1410955,3228082,407722363,6,49169,4118631,40622,3105931,8547,1012700,12162,35,16526,188,6,852,130000.0,39000.0,-69.0,-73.0,-68.0,-60.0,-69.0,-74.0,-68.0,-61.0,-81.0,-91.0,-82.0,-88.0,12.0,18.0,14.0,28.0,1
792,CC:2F:71:3F:1F:24,11666152,13352764420,8438068,12945041855,3228084,407722565,94,1889794,1085940953,1881134,1084900571,8660,1040382,1827432,620,8442782,892740,94,6480,130000.0,43333.0,-69.0,-63.0,-71.0,-68.0,-69.0,-63.0,-71.0,-68.0,-81.0,-91.0,-82.0,-88.0,12.0,28.0,11.0,20.0,1
793,92:69:1D:31:68:E9,3251119,455755175,23018,48026580,3228101,407728595,0,10676,3439287,10584,3423988,92,15299,6969,1,23063,1256,0,100,216660.0,130000.0,-54.0,-50.0,-45.0,-51.0,-51.0,-49.0,-46.0,-49.0,-81.0,-91.0,-82.0,-88.0,27.0,41.0,37.0,37.0,1
794,BA:8C:B9:54:50:24,3262772,484360607,34671,76632012,3228101,407728595,0,12738,4110873,12633,4093264,105,17609,8038,6,34700,6813,0,154,216660.0,130000.0,-54.0,-57.0,-55.0,-45.0,-51.0,-55.0,-53.0,-47.0,-81.0,-91.0,-82.0,-88.0,27.0,34.0,27.0,43.0,1
795,62:47:05:9D:EB:15,3231293,415332769,3191,7604114,3228102,407728655,0,854,150235,816,143487,38,6748,401,0,3226,1151,0,9,216660.0,130000.0,-45.0,-50.0,-46.0,-47.0,-45.0,-45.0,-45.0,-44.0,-81.0,-91.0,-82.0,-88.0,36.0,41.0,36.0,41.0,1
796,F8:59:71:5A:E0:3D,3470477,772258943,242375,364530288,3228102,407728655,3,241086,322203193,236179,321616981,4907,586212,218033,19,245126,5405,3,694,144444.0,43333.0,-67.0,-73.0,-67.0,-71.0,-67.0,-73.0,-66.0,-70.0,-81.0,-91.0,-82.0,-88.0,14.0,18.0,15.0,17.0,1
797,CC:2F:71:3E:C5:1F,3239636,409139610,11534,1410955,3228102,407728655,6,49169,4118631,40622,3105931,8547,1012700,12162,35,16526,188,6,852,130000.0,39000.0,-69.0,-73.0,-68.0,-60.0,-69.0,-74.0,-68.0,-61.0,-81.0,-91.0,-82.0,-88.0,12.0,18.0,14.0,28.0,1
798,CC:2F:71:3F:1F:24,11667232,13354372153,8439130,12946643498,3228102,407728655,94,1890134,1086257758,1881474,1085217376,8660,1040382,1827766,620,8443852,892872,94,6480,130000.0,43333.0,-70.0,-64.0,-72.0,-69.0,-69.0,-64.0,-72.0,-68.0,-81.0,-91.0,-82.0,-88.0,11.0,27.0,10.0,19.0,1
799,92:69:1D:31:68:E9,3251126,455755841,23018,48026580,3228108,407729261,0,10676,3439287,10584,3423988,92,15299,6969,1,23063,1256,0,100,216660.0,130000.0,-54.0,-50.0,-45.0,-51.0,-51.0,-49.0,-46.0,-49.0,-81.0,-91.0,-82.0,-88.0,27.0,41.0,37.0,37.0,1
800,BA:8C:B9:54:50:24,3263085,485161248,34976,77431714,3228109,407729534,0,12783,4119421,12678,4101812,105,17609,8072,6,35005,6813,0,155,229410.0,137640.0,-53.0,-58.0,-55.0,-51.0,-52.0,-57.0,-55.0,-51.0,-81.0,-91.0,-82.0,-88.0,28.0,33.0,27.0,37.0,1
801,62:47:05:9D:EB:15,3231301,415333710,3191,7604114,3228110,407729596,0,858,150507,820,143759,38,6748,401,0,3227,1151,0,9,216660.0,130000.0,-45.0,-38.0,-43.0,-39.0,-45.0,-43.0,-44.0,-42.0,-81.0,-91.0,-82.0,-88.0,36.0,53.0,39.0,49.0,1
802,F8:59:71:5A:E0:3D,3470569,772390420,242459,364660824,3228110,407729596,3,241170,322332637,236263,321746425,4907,586212,218117,19,245210,5405,3,694,144444.0,43333.0,-68.0,-73.0,-66.0,-70.0,-67.0,-73.0,-66.0,-70.0,-81.0,-91.0,-82.0,-88.0,13.0,18.0,16.0,18.0,1
803,CC:2F:71:3E:C5:1F,3239644,409140551,11534,1410955,3228110,407729596,6,49169,4118631,40622,3105931,8547,1012700,12162,35,16526,188,6,852,130000.0,39000.0,-69.0,-73.0,-68.0,-60.0,-69.0,-74.0,-68.0,-61.0,-81.0,-91.0,-82.0,-88.0,12.0,18.0,14.0,28.0,1
804,CC:2F:71:3F:1F:24,11668401,13356135102,8440289,12948405304,3228112,407729798,94,1890488,1086537562,1881828,1085497180,8660,1040382,1828101,620,8445008,892965,94,6482,130000.0,43333.0,-69.0,-64.0,-72.0,-69.0,-69.0,-64.0,-71.0,-68.0,-81.0,-91.0,-82.0,-88.0,12.0,27.0,10.0,19.0,1
805,92:69:1D:31:68:E9,3251130,455756378,23018,48026580,3228112,407729798,0,10684,3439885,10591,3424464,93,15421,6970,1,23063,1256,0,100,216660.0,130000.0,-52.0,-52.0,-51.0,-55.0,-51.0,-50.0,-46.0,-51.0,-81.0,-91.0,-82.0,-88.0,29.0,39.0,31.0,33.0,1
806,BA:8C:B9:54:50:24,3263088,485161512,34976,77431714,3228112,407729798,0,12790,4119897,12685,4102288,105,17609,8072,6,35005,6813,0,155,229410.0,137640.0,-54.0,-56.0,-55.0,-45.0,-52.0,-57.0,-55.0,-50.0,-81.0,-91.0,-82.0,-88.0,27.0,35.0,27.0,43.0,1
807,62:47:05:9D:EB:15,3231303,415333912,3191,7604114,3228112,407729798,0,858,150507,820,143759,38,6748,401,0,3227,1151,0,9,216660.0,130000.0,-45.0,-38.0,-43.0,-39.0,-45.0,-43.0,-44.0,-42.0,-81.0,-91.0,-82.0,-88.0,36.0,53.0,39.0,49.0,1
808,F8:59:71:5A:E0:3D,3470656,772522712,242544,364792914,3228112,407729798,3,241256,322465077,236349,321878865,4907,586212,218203,19,245295,5405,3,694,144444.0,43333.0,-68.0,-73.0,-67.0,-71.0,-67.0,-73.0,-66.0,-70.0,-81.0,-91.0,-82.0,-88.0,13.0,18.0,15.0,17.0,1
809,CC:2F:71:3E:C5:1F,3239647,409140813,11534,1410955,3228113,407729858,6,49169,4118631,40622,3105931,8547,1012700,12162,35,16526,188,6,852,130000.0,39000.0,-69.0,-73.0,-68.0,-60.0,-69.0,-74.0,-68.0,-61.0,-81.0,-91.0,-82.0,-88.0,12.0,18.0,14.0,28.0,1
810,CC:2F:71:3F:1F:24,11669588,13357925541,8441473,12950195481,3228115,407730060,94,1890867,1086852615,1882207,1085812233,8660,1040382,1828462,620,8446188,893093,94,6482,130000.0,43333.0,-70.0,-64.0,-72.0,-69.0,-69.0,-64.0,-71.0,-68.0,-81.0,-91.0,-82.0,-88.0,11.0,27.0,10.0,19.0,1
811,92:69:1D:31:68:E9,3251139,455757246,23018,48026580,3228121,407730666,0,10684,3439885,10591,3424464,93,15421,6970,1,23063,1256,0,100,216660.0,130000.0,-52.0,-52.0,-51.0,-55.0,-51.0,-50.0,-46.0,-51.0,-81.0,-91.0,-82.0,-88.0,29.0,39.0,31.0,33.0,1
812,BA:8C:B9:54:50:24,3263122,485192920,35001,77462254,3228121,407730666,0,12800,4121153,12695,4103544,105,17609,8077,6,35030,6813,0,155,229410.0,137640.0,-54.0,-56.0,-55.0,-45.0,-53.0,-57.0,-55.0,-50.0,-81.0,-91.0,-82.0,-88.0,27.0,35.0,27.0,43.0,1
813,62:47:05:9D:EB:15,3231313,415334891,3191,7604114,3228122,407730777,0,858,150507,820,143759,38,6748,401,0,3227,1151,0,9,216660.0,130000.0,-45.0,-38.0,-43.0,-39.0,-45.0,-43.0,-44.0,-42.0,-81.0,-91.0,-82.0,-88.0,36.0,53.0,39.0,49.0,1
814,F8:59:71:5A:E0:3D,3470757,772665105,242635,364934328,3228122,407730777,3,241347,322605273,236440,322019061,4907,586212,218293,19,245386,5405,3,694,144444.0,43333.0,-68.0,-73.0,-66.0,-71.0,-67.0,-73.0,-66.0,-70.0,-81.0,-91.0,-82.0,-88.0,13.0,18.0,16.0,17.0,1
815,CC:2F:71:3E:C5:1F,3239656,409141732,11534,1410955,3228122,407730777,6,49169,4118631,40622,3105931,8547,1012700,12162,35,16526,188,6,852,130000.0,39000.0,-69.0,-73.0,-68.0,-60.0,-69.0,-74.0,-68.0,-61.0,-81.0,-91.0,-82.0,-88.0,12.0,18.0,14.0,28.0,1
816,CC:2F:71:3F:1F:24,11670982,13360043989,8442859,12952313101,3228123,407730888,94,1891236,1087160075,1882576,1086119693,8660,1040382,1828814,620,8447593,893348,94,6484,130000.0,43333.0,-69.0,-64.0,-72.0,-68.0,-69.0,-63.0,-71.0,-68.0,-81.0,-91.0,-82.0,-88.0,12.0,27.0,10.0,20.0,1
817,92:69:1D:31:68:E9,3251143,455757670,23018,48026580,3228125,407731090,0,10689,3440328,10595,3424736,94,15592,6971,1,23063,1256,0,100,216660.0,130000.0,-54.0,-50.0,-45.0,-51.0,-51.0,-50.0,-46.0,-51.0,-81.0,-91.0,-82.0,-88.0,27.0,41.0,37.0,37.0,1
818,BA:8C:B9:54:50:24,3263126,485193344,35001,77462254,3228125,407731090,0,12803,4121460,12697,4103680,106,17780,8078,6,35030,6813,0,155,229410.0,137640.0,-54.0,-56.0,-55.0,-45.0,-53.0,-57.0,-55.0,-48.0,-81.0,-91.0,-82.0,-89.0,27.0,35.0,27.0,44.0,1
819,62:47:05:9D:EB:15,3231318,415335406,3191,7604114,3228127,407731292,0,858,150507,820,143759,38,6748,401,0,3227,1151,0,9,216660.0,130000.0,-45.0,-38.0,-43.0,-39.0,-45.0,-43.0,-44.0,-42.0,-81.0,-91.0,-82.0,-89.0,36.0,53.0,39.0,50.0,1
820,F8:59:71:5A:E0:3D,3470850,772802372,242723,365071080,3228127,407731292,3,241437,322743985,236530,322157773,4907,586212,218382,19,245474,5405,3,694,144444.0,43333.0,-67.0,-73.0,-66.0,-71.0,-67.0,-72.0,-66.0,-70.0,-81.0,-91.0,-82.0,-89.0,14.0,18.0,16.0,18.0,1
821,CC:2F:71:3E:C5:1F,3239663,409142449,11534,1410955,3228129,407731494,6,49169,4118631,40622,3105931,8547,1012700,12162,35,16526,188,6,852,130000.0,39000.0,-69.0,-73.0,-68.0,-60.0,-69.0,-74.0,-68.0,-61.0,-81.0,-91.0,-82.0,-89.0,12.0,18.0,14.0,29.0,1
822,CC:2F:71:3F:1F:24,11672808,13362846196,8444678,12955114642,3228130,407731554,94,1891624,1087465262,1882964,1086424880,8660,1040382,1829196,620,8449357,893510,94,6484,130000.0,43333.0,-69.0,-64.0,-71.0,-68.0,-69.0,-64.0,-71.0,-68.0,-81.0,-91.0,-82.0,-89.0,12.0,27.0,11.0,21.0,1
823,92:69:1D:31:68:E9,3251305,456162013,23173,48430257,3228132,407731756,0,10716,3445997,10622,3430405,94,15592,6986,1,23218,1271,0,100,229410.0,130000.0,-50.0,-49.0,-45.0,-49.0,-49.0,-48.0,-45.0,-48.0,-81.0,-91.0,-82.0,-89.0,31.0,42.0,37.0,40.0,1
824,BA:8C:B9:54:50:24,3263133,485194010,35001,77462254,3228132,407731756,0,12803,4121460,12697,4103680,106,17780,8078,6,35030,6813,0,155,229410.0,137640.0,-54.0,-56.0,-55.0,-45.0,-53.0,-57.0,-55.0,-48.0,-81.0,-91.0,-82.0,-88.0,27.0,35.0,27.0,43.0,1
825,62:47:05:9D:EB:15,3231323,415335870,3191,7604114,3228132,407731756,0,858,150507,820,143759,38,6748,401,0,3227,1151,0,9,216660.0,130000.0,-45.0,-38.0,-43.0,-39.0,-45.0,-43.0,-44.0,-42.0,-81.0,-91.0,-82.0,-88.0,36.0,53.0,39.0,49.0,1
826,F8:59:71:5A:E0:3D,3470942,772938034,242810,365206278,3228132,407731756,3,241524,322877965,236617,322291753,4907,586212,218469,19,245561,5406,3,694,144444.0,43333.0,-68.0,-73.0,-66.0,-71.0,-68.0,-73.0,-66.0,-70.0,-81.0,-91.0,-82.0,-88.0,13.0,18.0,16.0,17.0,1
827,CC:2F:71:3E:C5:1F,3239666,409142711,11534,1410955,3228132,407731756,6,49169,4118631,40622,3105931,8547,1012700,12162,35,16526,188,6,852,130000.0,39000.0,-69.0,-73.0,-68.0,-60.0,-69.0,-74.0,-68.0,-61.0,-81.0,-91.0,-82.0,-88.0,12.0,18.0,14.0,28.0,1
828,CC:2F:71:3F:1F:24,11674650,13365674367,8446518,12957942611,3228132,407731756,94,1892048,1087782381,1883388,1086741999,8660,1040382,1829605,620,8451244,893626,94,6484,130000.0,43333.0,-69.0,-63.0,-72.0,-68.0,-69.0,-63.0,-71.0,-68.0,-81.0,-91.0,-82.0,-88.0,12.0,28.0,10.0,20.0,1
829,92:69:1D:31:68:E9,3251313,456162821,23173,48430257,3228140,407732564,0,10718,3446133,10624,3430541,94,15592,6986,1,23218,1271,0,100,229410.0,130000.0,-53.0,-50.0,-45.0,-50.0,-49.0,-48.0,-45.0,-48.0,-80.0,-91.0,-82.0,-88.0,27.0,41.0,37.0,38.0,1
830,BA:8C:B9:54:50:24,3263141,485194818,35001,77462254,3228140,407732564,0,12803,4121460,12697,4103680,106,17780,8078,6,35030,6813,0,155,229410.0,137640.0,-54.0,-56.0,-55.0,-45.0,-53.0,-57.0,-55.0,-48.0,-80.0,-91.0,-82.0,-88.0,26.0,35.0,27.0,43.0,1
831,62:47:05:9D:EB:15,3231331,415336678,3191,7604114,3228140,407732564,0,858,150507,820,143759,38,6748,401,0,3227,1151,0,9,216660.0,130000.0,-45.0,-38.0,-43.0,-39.0,-45.0,-43.0,-44.0,-42.0,-80.0,-91.0,-82.0,-88.0,35.0,53.0,39.0,49.0,1
832,F8:59:71:5A:E0:3D,3471043,773083364,242903,365350800,3228140,407732564,3,241617,323021185,236710,322434973,4907,586212,218562,19,245654,5407,3,694,144444.0,43333.0,-68.0,-73.0,-66.0,-71.0,-67.0,-73.0,-66.0,-70.0,-80.0,-91.0,-82.0,-88.0,12.0,18.0,16.0,17.0,1
833,CC:2F:71:3E:C5:1F,3239674,409143519,11534,1410955,3228140,407732564,6,49169,4118631,40622,3105931,8547,1012700,12162,35,16526,188,6,852,130000.0,39000.0,-69.0,-73.0,-68.0,-60.0,-69.0,-74.0,-68.0,-61.0,-80.0,-91.0,-82.0,-88.0,11.0,18.0,14.0,28.0,1
834,CC:2F:71:3F:1F:24,11675885,13367537863,8447744,12959805239,3228141,407732624,94,1892380,1088099785,1883720,1087059403,8660,1040382,1829919,620,8452443,893743,94,6484,130000.0,43333.0,-69.0,-64.0,-71.0,-68.0,-69.0,-64.0,-71.0,-68.0,-80.0,-91.0,-82.0,-88.0,11.0,27.0,11.0,20.0,1
835,92:69:1D:31:68:E9,3251318,456163285,23173,48430257,3228145,407733028,0,10718,3446133,10624,3430541,94,15592,6986,1,23218,1271,0,100,229410.0,130000.0,-53.0,-50.0,-45.0,-50.0,-49.0,-48.0,-45.0,-48.0,-80.0,-91.0,-82.0,-88.0,27.0,41.0,37.0,38.0,1
836,BA:8C:B9:54:50:24,3263146,485195282,35001,77462254,3228145,407733028,0,12803,4121460,12697,4103680,106,17780,8078,6,35030,6813,0,155,229410.0,137640.0,-54.0,-56.0,-55.0,-45.0,-53.0,-57.0,-55.0,-48.0,-80.0,-91.0,-82.0,-88.0,26.0,35.0,27.0,43.0,1
837,62:47:05:9D:EB:15,3231336,415337142,3191,7604114,3228145,407733028,0,858,150507,820,143759,38,6748,401,0,3227,1151,0,9,216660.0,130000.0,-45.0,-38.0,-43.0,-39.0,-45.0,-43.0,-44.0,-42.0,-80.0,-91.0,-82.0,-88.0,35.0,53.0,39.0,49.0,1
838,F8:59:71:5A:E0:3D,3471154,773248552,243009,365515524,3228145,407733028,3,241722,323183571,236815,322597359,4907,586212,218667,19,245760,5408,3,694,144444.0,43333.0,-68.0,-73.0,-66.0,-71.0,-68.0,-73.0,-66.0,-70.0,-80.0,-91.0,-82.0,-88.0,12.0,18.0,16.0,17.0,1
839,CC:2F:71:3E:C5:1F,3239683,409144387,11534,1410955,3228149,407733432,6,49169,4118631,40622,3105931,8547,1012700,12162,35,16526,188,6,852,130000.0,39000.0,-69.0,-73.0,-68.0,-60.0,-69.0,-74.0,-68.0,-61.0,-80.0,-91.0,-82.0,-88.0,11.0,18.0,14.0,28.0,1
840,CC:2F:71:3F:1F:24,11676953,13369136067,8448804,12961402635,3228149,407733432,94,1892874,1088630455,1884214,1087590073,8660,1040382,1830369,620,8453538,893981,94,6486,130000.0,43333.0,-69.0,-64.0,-72.0,-68.0,-68.0,-63.0,-71.0,-68.0,-81.0,-91.0,-82.0,-89.0,12.0,27.0,10.0,21.0,1
841,92:69:1D:31:68:E9,3251327,456164153,23173,48430257,3228154,407733896,0,10718,3446133,10624,3430541,94,15592,6986,1,23218,1271,0,100,229410.0,130000.0,-53.0,-50.0,-45.0,-50.0,-49.0,-48.0,-45.0,-48.0,-81.0,-91.0,-82.0,-89.0,28.0,41.0,37.0,39.0,1
842,BA:8C:B9:54:50:24,3263155,485196150,35001,77462254,3228154,407733896,0,12803,4121460,12697,4103680,106,17780,8078,6,35030,6813,0,155,229410.0,137640.0,-54.0,-56.0,-55.0,-45.0,-53.0,-57.0,-55.0,-48.0,-81.0,-91.0,-82.0,-89.0,27.0,35.0,27.0,44.0,1
843,62:47:05:9D:EB:15,3231345,415338010,3191,7604114,3228154,407733896,0,858,150507,820,143759,38,6748,401,0,3227,1151,0,9,216660.0,130000.0,-45.0,-38.0,-43.0,-39.0,-45.0,-43.0,-44.0,-42.0,-81.0,-91.0,-82.0,-89.0,36.0,53.0,39.0,50.0,1
844,F8:59:71:5A:E0:3D,3471294,773451556,243140,365717660,3228154,407733896,3,241858,323392305,236951,322806093,4907,586212,218797,19,245891,5410,3,696,144444.0,43333.0,-68.0,-74.0,-66.0,-70.0,-68.0,-73.0,-66.0,-70.0,-81.0,-91.0,-82.0,-89.0,13.0,17.0,16.0,19.0,1
845,CC:2F:71:3E:C5:1F,3239690,409145053,11534,1410955,3228156,407734098,6,49169,4118631,40622,3105931,8547,1012700,12162,35,16526,188,6,852,130000.0,39000.0,-69.0,-73.0,-68.0,-60.0,-69.0,-74.0,-68.0,-61.0,-81.0,-91.0,-82.0,-89.0,12.0,18.0,14.0,29.0,1
846,CC:2F:71:3F:1F:24,11678786,13371911657,8450628,12964177357,3228158,407734300,94,1893366,1088990609,1884706,1087950227,8660,1040382,1830847,620,8455361,894145,94,6487,130000.0,39000.0,-68.0,-63.0,-71.0,-69.0,-68.0,-63.0,-71.0,-68.0,-80.0,-90.0,-82.0,-88.0,12.0,27.0,11.0,19.0,1
847,92:69:1D:31:68:E9,3251331,456164557,23173,48430257,3228158,407734300,0,10718,3446133,10624,3430541,94,15592,6986,1,23218,1271,0,100,229410.0,130000.0,-53.0,-50.0,-45.0,-50.0,-49.0,-48.0,-45.0,-48.0,-80.0,-90.0,-82.0,-88.0,27.0,40.0,37.0,38.0,1
848,BA:8C:B9:54:50:24,3263159,485196554,35001,77462254,3228158,407734300,0,12803,4121460,12697,4103680,106,17780,8078,6,35030,6813,0,155,229410.0,137640.0,-54.0,-56.0,-55.0,-45.0,-53.0,-57.0,-55.0,-48.0,-80.0,-90.0,-82.0,-88.0,26.0,34.0,27.0,43.0,1
849,62:47:05:9D:EB:15,3231349,415338414,3191,7604114,3228158,407734300,0,858,150507,820,143759,38,6748,401,0,3227,1151,0,9,216660.0,130000.0,-45.0,-38.0,-43.0,-39.0,-45.0,-43.0,-44.0,-42.0,-80.0,-90.0,-82.0,-88.0,35.0,52.0,39.0,49.0,1
850,F8:59:71:5A:E0:3D,3471398,773604454,243238,365869952,3228160,407734502,3,241957,323544835,237050,322958623,4907,586212,218895,19,245988,5415,3,697,144444.0,43333.0,-67.0,-73.0,-67.0,-71.0,-67.0,-72.0,-66.0,-70.0,-80.0,-90.0,-82.0,-88.0,13.0,17.0,15.0,17.0,1
851,CC:2F:71:3E:C5:1F,3239694,409145457,11534,1410955,3228160,407734502,6,49169,4118631,40622,3105931,8547,1012700,12162,35,16526,188,6,852,130000.0,39000.0,-69.0,-73.0,-68.0,-60.0,-69.0,-74.0,-68.0,-61.0,-80.0,-90.0,-82.0,-88.0,11.0,17.0,14.0,28.0,1
852,CC:2F:71:3F:1F:24,11680196,13374061397,8452036,12966326895,3228160,407734502,94,1893761,1089320615,1885101,1088280233,8660,1040382,1831196,620,8456770,894391,94,6487,115556.0,28889.0,-70.0,-64.0,-71.0,-68.0,-69.0,-64.0,-70.0,-67.0,-80.0,-90.0,-82.0,-88.0,10.0,26.0,11.0,20.0,1
853,92:69:1D:31:68:E9,3251341,456165541,23174,48430373,3228167,407735168,0,10728,3446851,10634,3431259,94,15592,6987,1,23219,1271,0,100,229410.0,130000.0,-54.0,-50.0,-44.0,-51.0,-49.0,-49.0,-46.0,-49.0,-80.0,-90.0,-82.0,-88.0,26.0,40.0,38.0,37.0,1
854,BA:8C:B9:54:50:24,3263168,485197422,35001,77462254,3228167,407735168,0,12803,4121460,12697,4103680,106,17780,8078,6,35030,6813,0,155,229410.0,137640.0,-54.0,-56.0,-55.0,-45.0,-53.0,-57.0,-55.0,-48.0,-80.0,-90.0,-82.0,-88.0,26.0,34.0,27.0,43.0,1
855,62:47:05:9D:EB:15,3231358,415339282,3191,7604114,3228167,407735168,0,858,150507,820,143759,38,6748,401,0,3227,1151,0,9,216660.0,130000.0,-45.0,-38.0,-43.0,-39.0,-45.0,-43.0,-44.0,-42.0,-80.0,-90.0,-82.0,-88.0,35.0,52.0,39.0,49.0,1
856,F8:59:71:5A:E0:3D,3471490,773737210,243323,366002042,3228167,407735168,3,242042,323675805,237135,323089593,4907,586212,218980,19,246074,5416,3,698,144444.0,43333.0,-67.0,-73.0,-67.0,-70.0,-67.0,-72.0,-66.0,-70.0,-80.0,-90.0,-82.0,-88.0,13.0,17.0,15.0,18.0,1
857,CC:2F:71:3E:C5:1F,3239701,409146123,11534,1410955,3228167,407735168,6,49169,4118631,40622,3105931,8547,1012700,12162,35,16526,188,6,852,130000.0,39000.0,-69.0,-73.0,-68.0,-60.0,-69.0,-74.0,-68.0,-61.0,-80.0,-90.0,-82.0,-88.0,11.0,17.0,14.0,28.0,1
858,CC:2F:71:3F:1F:24,11681896,13376659182,8453728,12968923839,3228168,407735343,94,1894176,1089624890,1885516,1088584508,8660,1040382,1831595,620,8458462,894570,94,6489,117000.0,39000.0,-69.0,-64.0,-71.0,-68.0,-69.0,-63.0,-71.0,-68.0,-81.0,-90.0,-82.0,-88.0,12.0,26.0,11.0,20.0,1
859,92:69:1D:31:68:E9,3251373,456236596,23202,48500778,3228171,407735818,0,10740,3448218,10645,3432391,95,15827,6992,1,23247,1271,0,100,229410.0,130000.0,-50.0,-49.0,-46.0,-49.0,-50.0,-49.0,-46.0,-49.0,-81.0,-90.0,-82.0,-88.0,31.0,41.0,36.0,39.0,1
860,BA:8C:B9:54:50:24,3263172,485198072,35001,77462254,3228171,407735818,0,12803,4121460,12697,4103680,106,17780,8078,6,35030,6813,0,155,229410.0,137640.0,-54.0,-56.0,-55.0,-45.0,-53.0,-57.0,-55.0,-48.0,-81.0,-90.0,-82.0,-88.0,27.0,34.0,27.0,43.0,1
861,62:47:05:9D:EB:15,3231364,415340134,3191,7604114,3228173,407736020,0,858,150507,820,143759,38,6748,401,0,3227,1151,0,9,216660.0,130000.0,-45.0,-38.0,-43.0,-39.0,-45.0,-43.0,-44.0,-42.0,-81.0,-90.0,-82.0,-88.0,36.0,52.0,39.0,49.0,1
862,F8:59:71:5A:E0:3D,3471576,773862214,243403,366126194,3228173,407736020,3,242122,323799005,237215,323212793,4907,586212,219060,19,246154,5416,3,698,144444.0,43333.0,-67.0,-73.0,-66.0,-70.0,-67.0,-73.0,-66.0,-70.0,-81.0,-90.0,-82.0,-88.0,14.0,17.0,16.0,18.0,1
863,CC:2F:71:3E:C5:1F,3239707,409146975,11534,1410955,3228173,407736020,6,49169,4118631,40622,3105931,8547,1012700,12162,35,16526,188,6,852,130000.0,39000.0,-69.0,-73.0,-68.0,-60.0,-69.0,-74.0,-68.0,-61.0,-81.0,-90.0,-82.0,-88.0,12.0,17.0,14.0,28.0,1
864,CC:2F:71:3F:1F:24,11682783,13377975208,8454610,12970239188,3228173,407736020,94,1894493,1089902267,1885833,1088861885,8660,1040382,1831905,620,8459344,894688,94,6489,130000.0,43333.0,-69.0,-64.0,-72.0,-69.0,-69.0,-63.0,-71.0,-68.0,-81.0,-90.0,-82.0,-88.0,12.0,26.0,10.0,19.0,1
865,92:69:1D:31:68:E9,3251380,456237262,23202,48500778,3228178,407736484,0,10741,3448286,10646,3432459,95,15827,6992,1,23247,1271,0,100,229410.0,130000.0,-54.0,-50.0,-46.0,-51.0,-50.0,-49.0,-46.0,-49.0,-81.0,-91.0,-82.0,-88.0,27.0,41.0,36.0,37.0,1
866,BA:8C:B9:54:50:24,3263179,485198738,35001,77462254,3228178,407736484,0,12803,4121460,12697,4103680,106,17780,8078,6,35030,6813,0,155,229410.0,137640.0,-54.0,-56.0,-55.0,-45.0,-53.0,-57.0,-55.0,-48.0,-81.0,-91.0,-82.0,-88.0,27.0,35.0,27.0,43.0,1
867,62:47:05:9D:EB:15,3231369,415340598,3191,7604114,3228178,407736484,0,858,150507,820,143759,38,6748,401,0,3227,1151,0,9,216660.0,130000.0,-45.0,-38.0,-43.0,-39.0,-45.0,-43.0,-44.0,-42.0,-81.0,-91.0,-82.0,-88.0,36.0,53.0,39.0,49.0,1
868,F8:59:71:5A:E0:3D,3471663,773990106,243485,366253622,3228178,407736484,3,242205,323926825,237298,323340613,4907,586212,219143,19,246236,5416,3,698,144444.0,43333.0,-68.0,-73.0,-66.0,-70.0,-67.0,-73.0,-66.0,-70.0,-81.0,-91.0,-82.0,-88.0,13.0,18.0,16.0,18.0,1
869,CC:2F:71:3E:C5:1F,3239712,409147439,11534,1410955,3228178,407736484,6,49169,4118631,40622,3105931,8547,1012700,12162,35,16526,188,6,852,130000.0,39000.0,-69.0,-73.0,-68.0,-60.0,-69.0,-74.0,-68.0,-61.0,-81.0,-91.0,-82.0,-88.0,12.0,18.0,14.0,28.0,1
870,CC:2F:71:3F:1F:24,11684243,13380206070,8456065,12972469586,3228178,407736484,94,1894860,1090185149,1886200,1089144767,8660,1040382,1832251,620,8460799,894740,94,6489,130000.0,43333.0,-69.0,-64.0,-72.0,-68.0,-68.0,-63.0,-71.0,-68.0,-81.0,-91.0,-82.0,-88.0,12.0,27.0,10.0,20.0,1
871,92:69:1D:31:68:E9,3251384,456237666,23202,48500778,3228182,407736888,0,10741,3448286,10646,3432459,95,15827,6992,1,23247,1271,0,100,229410.0,130000.0,-54.0,-50.0,-46.0,-51.0,-50.0,-49.0,-46.0,-49.0,-81.0,-91.0,-82.0,-89.0,27.0,41.0,36.0,38.0,1
872,BA:8C:B9:54:50:24,3263183,485199142,35001,77462254,3228182,407736888,0,12803,4121460,12697,4103680,106,17780,8078,6,35030,6813,0,155,229410.0,137640.0,-54.0,-56.0,-55.0,-45.0,-53.0,-57.0,-55.0,-48.0,-81.0,-91.0,-82.0,-89.0,27.0,35.0,27.0,44.0,1
873,62:47:05:9D:EB:15,3231373,415341002,3191,7604114,3228182,407736888,0,858,150507,820,143759,38,6748,401,0,3227,1151,0,9,216660.0,130000.0,-45.0,-38.0,-43.0,-39.0,-45.0,-43.0,-44.0,-42.0,-81.0,-91.0,-82.0,-89.0,36.0,53.0,39.0,50.0,1
874,F8:59:71:5A:E0:3D,3471753,774116904,243567,366379612,3228186,407737292,3,242285,324050025,237378,323463813,4907,586212,219223,19,246317,5420,3,698,144444.0,43333.0,-68.0,-73.0,-66.0,-70.0,-67.0,-72.0,-66.0,-70.0,-81.0,-91.0,-82.0,-89.0,13.0,18.0,16.0,19.0,1
875,CC:2F:71:3E:C5:1F,3239721,409148363,11535,1411071,3228186,407737292,6,49170,4118701,40623,3106001,8547,1012700,12162,35,16527,188,6,852,130000.0,39000.0,-77.0,-84.0,-75.0,-72.0,-70.0,-75.0,-69.0,-63.0,-81.0,-91.0,-82.0,-89.0,4.0,7.0,7.0,17.0,1
876,CC:2F:71:3F:1F:24,11685780,13382552202,8457594,12974814910,3228186,407737292,94,1895230,1090469695,1886570,1089429313,8660,1040382,1832615,620,8462328,894903,94,6491,130000.0,43333.0,-69.0,-64.0,-72.0,-68.0,-68.0,-63.0,-71.0,-68.0,-81.0,-91.0,-82.0,-89.0,12.0,27.0,10.0,21.0,1
877,92:69:1D:31:68:E9,3251544,456644844,23358,48907552,3228186,407737292,0,10768,3454122,10673,3438295,95,15827,7011,1,23403,1285,0,100,229410.0,137640.0,-54.0,-50.0,-45.0,-51.0,-50.0,-49.0,-45.0,-48.0,-81.0,-91.0,-82.0,-89.0,27.0,41.0,37.0,38.0,1
878,BA:8C:B9:54:50:24,3263189,485199722,35002,77462370,3228187,407737352,0,12805,4121596,12699,4103816,106,17780,8078,6,35031,6813,0,155,216660.0,130000.0,-54.0,-56.0,-55.0,-45.0,-52.0,-56.0,-54.0,-49.0,-81.0,-91.0,-82.0,-89.0,27.0,35.0,27.0,44.0,1
879,62:47:05:9D:EB:15,3231381,415341784,3192,7604230,3228189,407737554,0,860,150643,822,143895,38,6748,401,0,3228,1151,0,9,216660.0,130000.0,-45.0,-38.0,-43.0,-39.0,-45.0,-41.0,-44.0,-40.0,-81.0,-91.0,-82.0,-89.0,36.0,53.0,39.0,50.0,1
880,F8:59:71:5A:E0:3D,3471840,774247702,243651,366510148,3228189,407737554,3,242370,324180925,237463,323594713,4907,586212,219308,19,246402,5420,3,698,144444.0,43333.0,-67.0,-73.0,-66.0,-70.0,-67.0,-73.0,-66.0,-70.0,-81.0,-91.0,-82.0,-89.0,14.0,18.0,16.0,19.0,1
881,CC:2F:71:3E:C5:1F,3239724,409148625,11535,1411071,3228189,407737554,6,49171,4118771,40624,3106071,8547,1012700,12162,35,16527,188,6,852,130000.0,39000.0,-76.0,-85.0,-75.0,-72.0,-71.0,-77.0,-70.0,-64.0,-81.0,-91.0,-82.0,-89.0,5.0,6.0,7.0,17.0,1
882,CC:2F:71:3F:1F:24,11687030,13384433441,8458841,12976695887,3228189,407737554,94,1895601,1090803869,1886941,1089763487,8660,1040382,1832962,620,8463575,895001,94,6492,130000.0,43333.0,-70.0,-64.0,-73.0,-69.0,-69.0,-64.0,-72.0,-69.0,-81.0,-91.0,-82.0,-89.0,11.0,27.0,9.0,20.0,1
883,92:69:1D:31:68:E9,3251555,456645836,23358,48907552,3228197,407738284,0,10768,3454122,10673,3438295,95,15827,7011,1,23403,1285,0,100,229410.0,137640.0,-54.0,-50.0,-45.0,-51.0,-50.0,-49.0,-45.0,-48.0,-81.0,-91.0,-82.0,-89.0,27.0,41.0,37.0,38.0,1
884,BA:8C:B9:54:50:24,3263480,485940146,35283,78201862,3228197,407738284,0,12847,4129426,12740,4111524,107,17902,8106,6,35312,6868,0,157,229410.0,130000.0,-47.0,-55.0,-51.0,-61.0,-52.0,-56.0,-54.0,-50.0,-81.0,-91.0,-82.0,-89.0,34.0,36.0,31.0,28.0,1
885,62:47:05:9D:EB:15,3231389,415342514,3192,7604230,3228197,407738284,0,860,150643,822,143895,38,6748,401,0,3228,1151,0,9,216660.0,130000.0,-45.0,-38.0,-43.0,-39.0,-45.0,-41.0,-44.0,-40.0,-81.0,-91.0,-82.0,-89.0,36.0,53.0,39.0,50.0,1
886,F8:59:71:5A:E0:3D,3471945,774399170,243748,366660886,3228197,407738284,3,242468,324331859,237561,323745647,4907,586212,219405,19,246499,5421,3,698,144444.0,43333.0,-68.0,-73.0,-66.0,-70.0,-67.0,-73.0,-66.0,-70.0,-81.0,-91.0,-82.0,-89.0,13.0,18.0,16.0,19.0,1
887,CC:2F:71:3E:C5:1F,3239732,409149355,11535,1411071,3228197,407738284,6,49173,4118959,40625,3106141,8548,1012818,12163,35,16527,188,6,852,130000.0,39000.0,-68.0,-71.0,-68.0,-60.0,-70.0,-75.0,-69.0,-63.0,-81.0,-91.0,-82.0,-89.0,13.0,20.0,14.0,29.0,1
888,CC:2F:71:3F:1F:24,11688788,13387126567,8460591,12979388283,3228197,407738284,94,1896037,1091120499,1887377,1090080117,8660,1040382,1833376,620,8465325,895167,94,6492,130000.0,43333.0,-69.0,-64.0,-73.0,-69.0,-69.0,-64.0,-72.0,-69.0,-81.0,-91.0,-82.0,-89.0,12.0,27.0,9.0,20.0,1
889,92:69:1D:31:68:E9,3251558,456646098,23358,48907552,3228200,407738546,0,10768,3454122,10673,3438295,95,15827,7011,1,23403,1285,0,100,229410.0,137640.0,-54.0,-50.0,-45.0,-51.0,-50.0,-49.0,-45.0,-48.0,-81.0,-91.0,-82.0,-89.0,27.0,41.0,37.0,38.0,1
890,BA:8C:B9:54:50:24,3263483,485940408,35283,78201862,3228200,407738546,0,12848,4129494,12741,4111592,107,17902,8106,6,35312,6868,0,157,229410.0,130000.0,-54.0,-56.0,-55.0,-45.0,-52.0,-56.0,-54.0,-49.0,-81.0,-91.0,-82.0,-89.0,27.0,35.0,27.0,44.0,1
891,62:47:05:9D:EB:15,3231394,415342978,3192,7604230,3228202,407738748,0,860,150643,822,143895,38,6748,401,0,3228,1151,0,9,216660.0,130000.0,-45.0,-38.0,-43.0,-39.0,-45.0,-41.0,-44.0,-40.0,-81.0,-91.0,-82.0,-89.0,36.0,53.0,39.0,50.0,1
892,F8:59:71:5A:E0:3D,3472033,774528616,243831,366789868,3228202,407738748,3,242551,324459693,237644,323873481,4907,586212,219487,19,246582,5422,3,698,144444.0,43333.0,-68.0,-73.0,-66.0,-71.0,-68.0,-73.0,-66.0,-71.0,-81.0,-91.0,-82.0,-89.0,13.0,18.0,16.0,18.0,1
893,CC:2F:71:3E:C5:1F,3239739,409150021,11535,1411071,3228204,407738950,6,49173,4118959,40625,3106141,8548,1012818,12163,35,16527,188,6,852,130000.0,39000.0,-68.0,-71.0,-68.0,-60.0,-70.0,-75.0,-69.0,-63.0,-81.0,-91.0,-82.0,-89.0,13.0,20.0,14.0,29.0,1
894,CC:2F:71:3F:1F:24,11690102,13389121191,8461898,12981382241,3228204,407738950,94,1896434,1091431659,1887774,1090391277,8660,1040382,1833738,620,8466632,895235,94,6493,130000.0,43333.0,-70.0,-65.0,-74.0,-69.0,-69.0,-64.0,-72.0,-69.0,-81.0,-91.0,-82.0,-89.0,11.0,26.0,8.0,20.0,1
895,92:69:1D:31:68:E9,3251564,456646704,23358,48907552,3228206,407739152,0,10768,3454122,10673,3438295,95,15827,7011,1,23403,1285,0,100,229410.0,137640.0,-54.0,-50.0,-45.0,-51.0,-50.0,-49.0,-45.0,-48.0,-81.0,-91.0,-82.0,-89.0,27.0,41.0,37.0,38.0,1
896,BA:8C:B9:54:50:24,3263489,485941014,35283,78201862,3228206,407739152,0,12848,4129494,12741,4111592,107,17902,8106,6,35312,6868,0,157,229410.0,130000.0,-54.0,-56.0,-55.0,-45.0,-52.0,-56.0,-54.0,-49.0,-81.0,-91.0,-82.0,-89.0,27.0,35.0,27.0,44.0,1
897,62:47:05:9D:EB:15,3231398,415343382,3192,7604230,3228206,407739152,0,860,150643,822,143895,38,6748,401,0,3228,1151,0,9,216660.0,130000.0,-45.0,-38.0,-43.0,-39.0,-45.0,-41.0,-44.0,-40.0,-81.0,-91.0,-82.0,-89.0,36.0,53.0,39.0,50.0,1
898,F8:59:71:5A:E0:3D,3472121,774659556,243915,366920404,3228206,407739152,3,242636,324590593,237729,324004381,4907,586212,219572,19,246666,5424,3,698,144444.0,43333.0,-68.0,-73.0,-67.0,-71.0,-68.0,-73.0,-66.0,-70.0,-81.0,-91.0,-82.0,-89.0,13.0,18.0,15.0,18.0,1
899,CC:2F:71:3E:C5:1F,3239743,409150425,11535,1411071,3228208,407739354,6,49173,4118959,40625,3106141,8548,1012818,12163,35,16527,188,6,852,130000.0,39000.0,-68.0,-71.0,-68.0,-60.0,-70.0,-75.0,-69.0,-63.0,-81.0,-91.0,-82.0,-89.0,13.0,20.0,14.0,29.0,1
900,CC:2F:71:3F:1F:24,11691769,13391663971,8463561,12983924617,3228208,407739354,94,1896846,1091726361,1888186,1090685979,8660,1040382,1834142,620,8468295,895512,94,6493,130000.0,43333.0,-69.0,-64.0,-72.0,-68.0,-69.0,-63.0,-71.0,-68.0,-81.0,-91.0,-82.0,-89.0,12.0,27.0,10.0,21.0,1
901,92:69:1D:31:68:E9,3251574,456647710,23359,48907690,3228215,407740020,0,10773,3456793,10678,3440966,95,15827,7014,1,23404,1285,0,100,229410.0,137640.0,-50.0,-49.0,-46.0,-49.0,-50.0,-49.0,-45.0,-48.0,-81.0,-91.0,-82.0,-89.0,31.0,42.0,36.0,40.0,1
902,BA:8C:B9:54:50:24,3263505,485944035,35290,78204015,3228215,407740020,0,12863,4133768,12756,4115866,107,17902,8113,6,35319,6868,0,157,229410.0,130000.0,-54.0,-56.0,-55.0,-45.0,-51.0,-55.0,-52.0,-48.0,-81.0,-91.0,-82.0,-89.0,27.0,35.0,27.0,44.0,1
903,62:47:05:9D:EB:15,3231407,415344250,3192,7604230,3228215,407740020,0,860,150643,822,143895,38,6748,401,0,3228,1151,0,9,216660.0,130000.0,-45.0,-38.0,-43.0,-39.0,-45.0,-41.0,-44.0,-40.0,-81.0,-91.0,-82.0,-89.0,36.0,53.0,39.0,50.0,1
904,F8:59:71:5A:E0:3D,3472230,774815824,244015,367075804,3228215,407740020,3,242737,324746413,237830,324160201,4907,586212,219672,19,246766,5425,3,698,144444.0,43333.0,-68.0,-73.0,-67.0,-70.0,-68.0,-73.0,-66.0,-70.0,-81.0,-91.0,-82.0,-89.0,13.0,18.0,15.0,19.0,1
905,CC:2F:71:3E:C5:1F,3239750,409151091,11535,1411071,3228215,407740020,6,49173,4118959,40625,3106141,8548,1012818,12163,35,16527,188,6,852,130000.0,39000.0,-68.0,-71.0,-68.0,-60.0,-70.0,-75.0,-69.0,-63.0,-81.0,-91.0,-82.0,-89.0,13.0,20.0,14.0,29.0,1
906,CC:2F:71:3F:1F:24,11693511,13394317803,8465296,12986577783,3228215,407740020,94,1897292,1092085611,1888632,1091045229,8660,1040382,1834565,620,8470030,895591,94,6493,130000.0,43333.0,-69.0,-63.0,-72.0,-69.0,-69.0,-63.0,-71.0,-68.0,-81.0,-91.0,-82.0,-89.0,12.0,28.0,10.0,20.0,1
907,92:69:1D:31:68:E9,3251581,456651285,23364,48911063,3228217,407740222,0,10776,3457126,10681,3441299,95,15827,7016,1,23409,1285,0,100,229410.0,137640.0,-53.0,-50.0,-46.0,-51.0,-51.0,-49.0,-45.0,-49.0,-81.0,-91.0,-82.0,-89.0,28.0,41.0,36.0,38.0,1
908,BA:8C:B9:54:50:24,3263507,485944237,35290,78204015,3228217,407740222,0,12863,4133768,12756,4115866,107,17902,8113,6,35319,6868,0,157,229410.0,130000.0,-54.0,-56.0,-55.0,-45.0,-51.0,-55.0,-52.0,-48.0,-81.0,-91.0,-82.0,-89.0,27.0,35.0,27.0,44.0,1
909,62:47:05:9D:EB:15,3231409,415344452,3192,7604230,3228217,407740222,0,860,150643,822,143895,38,6748,401,0,3228,1151,0,9,216660.0,130000.0,-45.0,-38.0,-43.0,-39.0,-45.0,-41.0,-44.0,-40.0,-81.0,-91.0,-82.0,-89.0,36.0,53.0,39.0,50.0,1
910,F8:59:71:5A:E0:3D,3472318,774949670,244101,367209448,3228217,407740222,3,242822,324877313,237915,324291101,4907,586212,219757,19,246852,5425,3,698,144444.0,43333.0,-68.0,-73.0,-66.0,-71.0,-68.0,-73.0,-66.0,-70.0,-81.0,-91.0,-82.0,-89.0,13.0,18.0,16.0,18.0,1
911,CC:2F:71:3E:C5:1F,3239752,409151293,11535,1411071,3228217,407740222,6,49173,4118959,40625,3106141,8548,1012818,12163,35,16527,188,6,852,130000.0,39000.0,-68.0,-71.0,-68.0,-60.0,-70.0,-75.0,-69.0,-63.0,-81.0,-91.0,-82.0,-89.0,13.0,20.0,14.0,29.0,1
912,CC:2F:71:3F:1F:24,11695010,13396602648,8466791,12988862224,3228219,407740424,94,1897718,1092422074,1889058,1091381692,8660,1040382,1834950,620,8471524,895743,94,6494,130000.0,43333.0,-69.0,-64.0,-72.0,-69.0,-68.0,-63.0,-71.0,-68.0,-81.0,-91.0,-82.0,-89.0,12.0,27.0,10.0,20.0,1
913,92:69:1D:31:68:E9,3251587,456651891,23364,48911063,3228223,407740828,0,10776,3457126,10681,3441299,95,15827,7016,1,23409,1285,0,100,229410.0,137640.0,-53.0,-50.0,-46.0,-51.0,-51.0,-49.0,-45.0,-49.0,-81.0,-91.0,-82.0,-89.0,28.0,41.0,36.0,38.0,1
914,BA:8C:B9:54:50:24,3263514,485944903,35290,78204015,3228224,407740888,0,12863,4133768,12756,4115866,107,17902,8113,6,35319,6868,0,157,229410.0,130000.0,-54.0,-56.0,-55.0,-45.0,-51.0,-55.0,-52.0,-48.0,-81.0,-91.0,-82.0,-89.0,27.0,35.0,27.0,44.0,1
915,62:47:05:9D:EB:15,3231416,415345118,3192,7604230,3228224,407740888,0,862,150779,824,144031,38,6748,401,0,3229,1151,0,9,216660.0,130000.0,-45.0,-38.0,-43.0,-39.0,-45.0,-39.0,-43.0,-40.0,-81.0,-91.0,-82.0,-89.0,36.0,53.0,39.0,50.0,1
916,F8:59:71:5A:E0:3D,3472416,775088844,244190,367347754,3228226,407741090,3,242912,325015913,238005,324429701,4907,586212,219847,19,246941,5428,3,698,144444.0,43333.0,-67.0,-73.0,-66.0,-70.0,-67.0,-72.0,-66.0,-70.0,-81.0,-91.0,-82.0,-89.0,14.0,18.0,16.0,19.0,1
917,CC:2F:71:3E:C5:1F,3239761,409152161,11535,1411071,3228226,407741090,6,49175,4119099,40627,3106281,8548,1012818,12163,35,16528,188,6,852,130000.0,39000.0,-69.0,-74.0,-68.0,-61.0,-70.0,-75.0,-69.0,-63.0,-81.0,-91.0,-82.0,-89.0,12.0,17.0,14.0,28.0,1
918,CC:2F:71:3F:1F:24,11696019,13398095814,8467793,12990354724,3228226,407741090,94,1898070,1092738751,1889410,1091698369,8660,1040382,1835281,620,8472525,895797,94,6494,130000.0,43333.0,-69.0,-64.0,-72.0,-68.0,-69.0,-63.0,-71.0,-68.0,-81.0,-91.0,-82.0,-89.0,12.0,27.0,10.0,21.0,1
919,92:69:1D:31:68:E9,3251595,456652824,23364,48911063,3228231,407741761,0,10777,3457194,10682,3441367,95,15827,7016,1,23409,1285,0,100,229410.0,137640.0,-52.0,-50.0,-46.0,-51.0,-51.0,-49.0,-45.0,-49.0,-81.0,-91.0,-82.0,-89.0,29.0,41.0,36.0,38.0,1
920,BA:8C:B9:54:50:24,3263549,485977883,35315,78235852,3228234,407742031,0,12873,4134829,12766,4116927,107,17902,8117,6,35344,6868,0,157,229410.0,130000.0,-54.0,-56.0,-55.0,-45.0,-51.0,-54.0,-53.0,-47.0,-81.0,-91.0,-82.0,-89.0,27.0,35.0,27.0,44.0,1
921,62:47:05:9D:EB:15,3231426,415346261,3192,7604230,3228234,407742031,0,862,150779,824,144031,38,6748,401,0,3229,1151,0,9,216660.0,130000.0,-45.0,-38.0,-43.0,-39.0,-45.0,-39.0,-43.0,-40.0,-81.0,-91.0,-82.0,-89.0,36.0,53.0,39.0,50.0,1
922,F8:59:71:5A:E0:3D,3472519,775235977,244285,367493946,3228234,407742031,3,243007,325159357,238099,324573027,4908,586330,219942,19,247036,5430,3,698,144444.0,43333.0,-68.0,-73.0,-66.0,-70.0,-67.0,-73.0,-66.0,-70.0,-81.0,-91.0,-82.0,-89.0,13.0,18.0,16.0,19.0,1
923,CC:2F:71:3E:C5:1F,3239769,409153102,11535,1411071,3228234,407742031,6,49175,4119099,40627,3106281,8548,1012818,12163,35,16528,188,6,852,130000.0,39000.0,-69.0,-74.0,-68.0,-61.0,-70.0,-75.0,-69.0,-63.0,-81.0,-91.0,-82.0,-89.0,12.0,17.0,14.0,28.0,1
924,CC:2F:71:3F:1F:24,11697405,13400197761,8469171,12992455730,3228234,407742031,94,1898466,1093060443,1889806,1092020061,8660,1040382,1835656,620,8473905,895952,94,6494,130000.0,43333.0,-69.0,-63.0,-71.0,-69.0,-68.0,-63.0,-71.0,-68.0,-81.0,-91.0,-82.0,-89.0,12.0,28.0,11.0,20.0,1
925,92:69:1D:31:68:E9,3251600,456653296,23364,48911063,3228236,407742233,0,10777,3457194,10682,3441367,95,15827,7016,1,23409,1285,0,100,229410.0,137640.0,-52.0,-50.0,-46.0,-51.0,-51.0,-49.0,-45.0,-49.0,-81.0,-91.0,-82.0,-89.0,29.0,41.0,36.0,38.0,1
926,BA:8C:B9:54:50:24,3263553,485978207,35315,78235852,3228238,407742355,0,12873,4134829,12766,4116927,107,17902,8117,6,35344,6868,0,157,229410.0,130000.0,-54.0,-56.0,-55.0,-45.0,-51.0,-54.0,-53.0,-47.0,-81.0,-91.0,-82.0,-89.0,27.0,35.0,27.0,44.0,1
927,62:47:05:9D:EB:15,3231430,415346585,3192,7604230,3228238,407742355,0,862,150779,824,144031,38,6748,401,0,3229,1151,0,9,216660.0,130000.0,-45.0,-38.0,-43.0,-39.0,-45.0,-39.0,-43.0,-40.0,-81.0,-91.0,-82.0,-89.0,36.0,53.0,39.0,50.0,1
928,F8:59:71:5A:E0:3D,3472612,775374607,244374,367632252,3228238,407742355,3,243098,325299567,238190,324713237,4908,586330,220032,19,247125,5432,3,699,144444.0,43333.0,-67.0,-73.0,-66.0,-70.0,-67.0,-73.0,-66.0,-70.0,-81.0,-91.0,-82.0,-89.0,14.0,18.0,16.0,19.0,1
929,CC:2F:71:3E:C5:1F,3239773,409153426,11535,1411071,3228238,407742355,6,49175,4119099,40627,3106281,8548,1012818,12163,35,16528,188,6,852,130000.0,39000.0,-69.0,-74.0,-68.0,-61.0,-70.0,-75.0,-69.0,-63.0,-81.0,-91.0,-82.0,-89.0,12.0,17.0,14.0,28.0,1
930,CC:2F:71:3F:1F:24,11698793,13402310365,8470555,12994568010,3228238,407742355,94,1898847,1093374791,1890186,1092334291,8661,1040500,1836012,620,8475289,895976,94,6494,130000.0,43333.0,-69.0,-63.0,-71.0,-68.0,-69.0,-63.0,-71.0,-68.0,-81.0,-91.0,-82.0,-89.0,12.0,28.0,11.0,21.0,1
931,92:69:1D:31:68:E9,3251609,456654135,23364,48911063,3228245,407743072,0,10777,3457194,10682,3441367,95,15827,7016,1,23409,1285,0,100,229410.0,137640.0,-52.0,-50.0,-46.0,-51.0,-51.0,-49.0,-45.0,-49.0,-81.0,-91.0,-82.0,-89.0,29.0,41.0,36.0,38.0,1
932,BA:8C:B9:54:50:24,3263561,485978986,35315,78235852,3228246,407743134,0,12878,4135272,12770,4117199,108,18073,8118,6,35344,6868,0,157,229410.0,130000.0,-47.0,-55.0,-50.0,-61.0,-51.0,-55.0,-53.0,-49.0,-81.0,-91.0,-82.0,-89.0,34.0,36.0,32.0,28.0,1
933,62:47:05:9D:EB:15,3231438,415347364,3192,7604230,3228246,407743134,0,862,150779,824,144031,38,6748,401,0,3229,1151,0,9,216660.0,130000.0,-45.0,-38.0,-43.0,-39.0,-45.0,-39.0,-43.0,-40.0,-81.0,-91.0,-82.0,-89.0,36.0,53.0,39.0,50.0,1
934,F8:59:71:5A:E0:3D,3472705,775506033,244458,367762788,3228247,407743245,3,243181,325427387,238273,324841057,4908,586330,220115,19,247209,5432,3,699,144444.0,43333.0,-68.0,-73.0,-66.0,-70.0,-67.0,-73.0,-66.0,-70.0,-81.0,-91.0,-82.0,-89.0,13.0,18.0,16.0,19.0,1
935,CC:2F:71:3E:C5:1F,3239784,409154518,11535,1411071,3228249,407743447,6,49175,4119099,40627,3106281,8548,1012818,12163,35,16528,188,6,852,130000.0,39000.0,-69.0,-74.0,-68.0,-61.0,-70.0,-75.0,-69.0,-63.0,-81.0,-91.0,-82.0,-89.0,12.0,17.0,14.0,28.0,1
936,CC:2F:71:3F:1F:24,11700710,13405241302,8472461,12997497855,3228249,407743447,94,1899283,1093684516,1890622,1092644016,8661,1040500,1836437,620,8477191,896200,94,6494,130000.0,43333.0,-69.0,-63.0,-71.0,-68.0,-69.0,-63.0,-71.0,-68.0,-81.0,-91.0,-82.0,-89.0,12.0,28.0,11.0,21.0,1
937,92:69:1D:31:68:E9,3251729,456958856,23480,49215409,3228249,407743447,0,10802,3462686,10705,3446566,97,16120,7031,1,23525,1285,0,100,229410.0,137640.0,-53.0,-50.0,-45.0,-51.0,-50.0,-49.0,-45.0,-48.0,-81.0,-91.0,-82.0,-89.0,28.0,41.0,37.0,38.0,1
938,BA:8C:B9:54:50:24,3263771,486512275,35517,78768198,3228254,407744077,0,12906,4141710,12798,4123637,108,18073,8137,6,35546,6868,0,157,229410.0,137640.0,-54.0,-56.0,-55.0,-45.0,-52.0,-56.0,-54.0,-49.0,-81.0,-91.0,-82.0,-89.0,27.0,35.0,27.0,44.0,1
939,62:47:05:9D:EB:15,3231448,415348509,3192,7604230,3228256,407744279,0,862,150779,824,144031,38,6748,401,0,3229,1151,0,9,216660.0,130000.0,-45.0,-38.0,-43.0,-39.0,-45.0,-39.0,-43.0,-40.0,-81.0,-91.0,-82.0,-89.0,36.0,53.0,39.0,50.0,1
940,F8:59:71:5A:E0:3D,3472803,775645373,244547,367901094,3228256,407744279,3,243271,325566015,238363,324979685,4908,586330,220205,19,247298,5434,3,700,144444.0,43333.0,-68.0,-73.0,-67.0,-71.0,-67.0,-73.0,-66.0,-70.0,-81.0,-91.0,-82.0,-89.0,13.0,18.0,15.0,18.0,1
941,CC:2F:71:3E:C5:1F,3239793,409155552,11535,1411071,3228258,407744481,6,49175,4119099,40627,3106281,8548,1012818,12163,35,16528,188,6,852,130000.0,39000.0,-69.0,-74.0,-68.0,-61.0,-70.0,-75.0,-69.0,-63.0,-81.0,-91.0,-82.0,-89.0,12.0,17.0,14.0,28.0,1
942,CC:2F:71:3F:1F:24,11702244,13407557479,8473986,12999812998,3228258,407744481,94,1899692,1094023583,1891031,1092983083,8661,1040500,1836810,620,8478720,896322,94,6494,130000.0,43333.0,-69.0,-64.0,-72.0,-69.0,-69.0,-63.0,-71.0,-68.0,-81.0,-91.0,-82.0,-89.0,12.0,27.0,10.0,20.0,1
943,92:69:1D:31:68:E9,3251740,456960092,23480,49215409,3228260,407744683,0,10802,3462686,10705,3446566,97,16120,7031,1,23525,1285,0,100,229410.0,137640.0,-53.0,-50.0,-45.0,-51.0,-50.0,-49.0,-45.0,-48.0,-81.0,-91.0,-82.0,-89.0,28.0,41.0,37.0,38.0,1
944,BA:8C:B9:54:50:24,3263777,486512881,35517,78768198,3228260,407744683,0,12906,4141710,12798,4123637,108,18073,8137,6,35546,6868,0,157,229410.0,137640.0,-54.0,-56.0,-55.0,-45.0,-52.0,-56.0,-54.0,-49.0,-81.0,-91.0,-82.0,-89.0,27.0,35.0,27.0,44.0,1
945,62:47:05:9D:EB:15,3231452,415348913,3192,7604230,3228260,407744683,0,862,150779,824,144031,38,6748,401,0,3229,1151,0,9,216660.0,130000.0,-45.0,-38.0,-43.0,-39.0,-45.0,-39.0,-43.0,-40.0,-81.0,-91.0,-82.0,-89.0,36.0,53.0,39.0,50.0,1
946,F8:59:71:5A:E0:3D,3472898,775787191,244638,368042508,3228260,407744683,3,243361,325704713,238453,325118383,4908,586330,220295,19,247389,5434,3,700,144444.0,43333.0,-68.0,-73.0,-67.0,-71.0,-68.0,-73.0,-66.0,-70.0,-81.0,-91.0,-82.0,-89.0,13.0,18.0,15.0,18.0,1
947,CC:2F:71:3E:C5:1F,3239795,409155754,11535,1411071,3228260,407744683,6,49175,4119099,40627,3106281,8548,1012818,12163,35,16528,188,6,852,130000.0,39000.0,-69.0,-74.0,-68.0,-61.0,-70.0,-75.0,-69.0,-63.0,-81.0,-91.0,-82.0,-89.0,12.0,17.0,14.0,28.0,1
948,CC:2F:71:3F:1F:24,11703593,13409610929,8475333,13001866246,3228260,407744683,94,1900074,1094347091,1891413,1093306591,8661,1040500,1837177,620,8480045,896424,94,6494,130000.0,43333.0,-69.0,-64.0,-71.0,-69.0,-68.0,-63.0,-71.0,-69.0,-81.0,-91.0,-82.0,-89.0,12.0,27.0,11.0,20.0,1
949,92:69:1D:31:68:E9,3251746,456960698,23480,49215409,3228266,407745289,0,10802,3462686,10705,3446566,97,16120,7031,1,23525,1285,0,100,229410.0,137640.0,-53.0,-50.0,-45.0,-51.0,-50.0,-49.0,-45.0,-48.0,-81.0,-92.0,-83.0,-90.0,28.0,42.0,38.0,39.0,1
950,BA:8C:B9:54:50:24,3263784,486513547,35517,78768198,3228267,407745349,0,12906,4141710,12798,4123637,108,18073,8137,6,35546,6868,0,157,229410.0,137640.0,-54.0,-56.0,-55.0,-45.0,-52.0,-56.0,-54.0,-49.0,-81.0,-92.0,-83.0,-90.0,27.0,36.0,28.0,45.0,1
951,62:47:05:9D:EB:15,3231459,415349579,3192,7604230,3228267,407745349,0,862,150779,824,144031,38,6748,401,0,3229,1151,0,9,216660.0,130000.0,-45.0,-38.0,-43.0,-39.0,-45.0,-39.0,-43.0,-40.0,-81.0,-92.0,-83.0,-90.0,36.0,54.0,40.0,51.0,1
952,F8:59:71:5A:E0:3D,3472998,775932379,244731,368187030,3228267,407745349,3,243456,325851083,238548,325264753,4908,586330,220388,19,247482,5435,3,700,144444.0,43333.0,-68.0,-74.0,-67.0,-71.0,-68.0,-73.0,-66.0,-71.0,-81.0,-92.0,-83.0,-90.0,13.0,18.0,16.0,19.0,1
953,CC:2F:71:3E:C5:1F,3239804,409156622,11535,1411071,3228269,407745551,6,49175,4119099,40627,3106281,8548,1012818,12163,35,16528,188,6,852,130000.0,39000.0,-69.0,-74.0,-68.0,-61.0,-70.0,-75.0,-69.0,-63.0,-81.0,-92.0,-83.0,-90.0,12.0,18.0,15.0,29.0,1
954,CC:2F:71:3F:1F:24,11705152,13411973925,8476883,13004228374,3228269,407745551,94,1900459,1094641587,1891798,1093601087,8661,1040500,1837547,620,8481614,896477,94,6495,130000.0,43333.0,-69.0,-64.0,-72.0,-68.0,-68.0,-63.0,-72.0,-68.0,-81.0,-92.0,-83.0,-90.0,12.0,28.0,11.0,22.0,1
955,92:69:1D:31:68:E9,3251755,456961566,23480,49215409,3228275,407746157,0,10802,3462686,10705,3446566,97,16120,7031,1,23525,1285,0,100,229410.0,137640.0,-53.0,-50.0,-45.0,-51.0,-50.0,-49.0,-45.0,-48.0,-81.0,-92.0,-83.0,-90.0,28.0,42.0,38.0,39.0,1
956,BA:8C:B9:54:50:24,3263792,486514355,35517,78768198,3228275,407746157,0,12906,4141710,12798,4123637,108,18073,8137,6,35546,6868,0,157,229410.0,137640.0,-54.0,-56.0,-55.0,-45.0,-52.0,-56.0,-54.0,-49.0,-81.0,-92.0,-83.0,-90.0,27.0,36.0,28.0,45.0,1
957,62:47:05:9D:EB:15,3231467,415350387,3192,7604230,3228275,407746157,0,862,150779,824,144031,38,6748,401,0,3229,1151,0,9,216660.0,130000.0,-45.0,-38.0,-43.0,-39.0,-45.0,-39.0,-43.0,-40.0,-81.0,-92.0,-83.0,-90.0,36.0,54.0,40.0,51.0,1
958,F8:59:71:5A:E0:3D,3473122,776113283,244847,368367126,3228275,407746157,3,243577,326037871,238669,325451541,4908,586330,220507,19,247598,5436,3,700,144444.0,43333.0,-68.0,-73.0,-66.0,-71.0,-68.0,-73.0,-66.0,-70.0,-81.0,-92.0,-83.0,-90.0,13.0,19.0,17.0,19.0,1
959,CC:2F:71:3E:C5:1F,3239810,409157228,11535,1411071,3228275,407746157,6,49175,4119099,40627,3106281,8548,1012818,12163,35,16528,188,6,852,130000.0,39000.0,-69.0,-74.0,-68.0,-61.0,-70.0,-75.0,-69.0,-63.0,-81.0,-92.0,-83.0,-90.0,12.0,18.0,15.0,29.0,1
960,CC:2F:71:3F:1F:24,11706536,13414069055,8478261,13006322898,3228275,407746157,94,1900887,1095040412,1892226,1093999912,8661,1040500,1837960,620,8482995,896586,94,6495,130000.0,43333.0,-68.0,-64.0,-71.0,-69.0,-68.0,-63.0,-71.0,-68.0,-81.0,-92.0,-83.0,-90.0,13.0,28.0,12.0,21.0,1
961,92:69:1D:31:68:E9,3251759,456961944,23481,49215525,3228278,407746419,0,10806,3463048,10709,3446928,97,16120,7033,1,23526,1285,0,100,229410.0,137640.0,-54.0,-50.0,-45.0,-51.0,-51.0,-49.0,-46.0,-50.0,-81.0,-92.0,-83.0,-90.0,27.0,42.0,38.0,39.0,1
962,BA:8C:B9:54:50:24,3263795,486514617,35517,78768198,3228278,407746419,0,12906,4141710,12798,4123637,108,18073,8137,6,35546,6868,0,157,229410.0,137640.0,-54.0,-56.0,-55.0,-45.0,-52.0,-56.0,-54.0,-49.0,-81.0,-92.0,-83.0,-90.0,27.0,36.0,28.0,45.0,1
963,62:47:05:9D:EB:15,3231470,415350649,3192,7604230,3228278,407746419,0,862,150779,824,144031,38,6748,401,0,3229,1151,0,9,216660.0,130000.0,-45.0,-38.0,-43.0,-39.0,-45.0,-39.0,-43.0,-40.0,-81.0,-92.0,-83.0,-90.0,36.0,54.0,40.0,51.0,1
964,F8:59:71:5A:E0:3D,3473205,776237865,244927,368491446,3228278,407746419,3,243654,326156451,238746,325570121,4908,586330,220584,19,247678,5436,3,700,144444.0,43333.0,-68.0,-73.0,-67.0,-71.0,-68.0,-73.0,-66.0,-70.0,-81.0,-92.0,-83.0,-90.0,13.0,19.0,16.0,19.0,1
965,CC:2F:71:3E:C5:1F,3239813,409157490,11535,1411071,3228278,407746419,6,49175,4119099,40627,3106281,8548,1012818,12163,35,16528,188,6,852,130000.0,39000.0,-69.0,-74.0,-68.0,-61.0,-70.0,-75.0,-69.0,-63.0,-81.0,-92.0,-83.0,-90.0,12.0,18.0,15.0,29.0,1
966,CC:2F:71:3F:1F:24,11708123,13416498365,8479845,13008751946,3228278,407746419,94,1901278,1095339056,1892617,1094298556,8661,1040500,1838326,620,8484548,896797,94,6495,130000.0,39000.0,-69.0,-63.0,-72.0,-69.0,-69.0,-63.0,-72.0,-69.0,-81.0,-92.0,-83.0,-90.0,12.0,29.0,11.0,21.0,1
967,92:69:1D:31:68:E9,3251765,456962550,23481,49215525,3228284,407747025,0,10806,3463048,10709,3446928,97,16120,7033,1,23526,1285,0,100,229410.0,137640.0,-54.0,-50.0,-45.0,-51.0,-51.0,-49.0,-46.0,-50.0,-81.0,-92.0,-83.0,-90.0,27.0,42.0,38.0,39.0,1
968,BA:8C:B9:54:50:24,3263802,486515339,35518,78768314,3228284,407747025,0,12909,4141952,12801,4123879,108,18073,8138,6,35547,6868,0,157,216660.0,130000.0,-54.0,-56.0,-55.0,-45.0,-52.0,-56.0,-55.0,-47.0,-81.0,-92.0,-83.0,-90.0,27.0,36.0,28.0,45.0,1
969,62:47:05:9D:EB:15,3231478,415351457,3192,7604230,3228286,407747227,0,862,150779,824,144031,38,6748,401,0,3229,1151,0,9,216660.0,130000.0,-45.0,-38.0,-43.0,-39.0,-45.0,-39.0,-43.0,-40.0,-81.0,-92.0,-83.0,-90.0,36.0,54.0,40.0,51.0,1
970,F8:59:71:5A:E0:3D,3473299,776372317,245013,368625090,3228286,407747227,3,243742,326292195,238834,325705865,4908,586330,220672,19,247764,5436,3,703,144444.0,43333.0,-68.0,-74.0,-66.0,-71.0,-67.0,-73.0,-66.0,-70.0,-81.0,-92.0,-83.0,-90.0,13.0,18.0,17.0,19.0,1
971,CC:2F:71:3E:C5:1F,3239821,409158298,11535,1411071,3228286,407747227,6,49175,4119099,40627,3106281,8548,1012818,12163,35,16528,188,6,852,130000.0,39000.0,-69.0,-74.0,-68.0,-61.0,-70.0,-75.0,-69.0,-63.0,-81.0,-92.0,-83.0,-90.0,12.0,18.0,15.0,29.0,1
972,CC:2F:71:3F:1F:24,11709297,13418260058,8481011,13010512831,3228286,407747227,94,1901641,1095631862,1892980,1094591362,8661,1040500,1838669,620,8485745,896837,94,6495,130000.0,43333.0,-69.0,-64.0,-72.0,-69.0,-69.0,-63.0,-71.0,-69.0,-81.0,-92.0,-83.0,-90.0,12.0,28.0,11.0,21.0,1
973,92:69:1D:31:68:E9,3251768,456962812,23481,49215525,3228287,407747287,0,10806,3463048,10709,3446928,97,16120,7033,1,23526,1285,0,100,229410.0,137640.0,-54.0,-50.0,-45.0,-51.0,-51.0,-49.0,-46.0,-50.0,-82.0,-93.0,-83.0,-90.0,28.0,43.0,38.0,39.0,1
974,BA:8C:B9:54:50:24,3263805,486515601,35518,78768314,3228287,407747287,0,12909,4141952,12801,4123879,108,18073,8138,6,35547,6868,0,157,216660.0,130000.0,-54.0,-56.0,-55.0,-45.0,-52.0,-56.0,-55.0,-47.0,-82.0,-93.0,-83.0,-90.0,28.0,37.0,28.0,45.0,1
975,62:47:05:9D:EB:15,3231479,415351517,3192,7604230,3228287,407747287,0,862,150779,824,144031,38,6748,401,0,3229,1151,0,9,216660.0,130000.0,-45.0,-38.0,-43.0,-39.0,-45.0,-39.0,-43.0,-40.0,-82.0,-93.0,-83.0,-90.0,37.0,55.0,40.0,51.0,1
976,F8:59:71:5A:E0:3D,3473391,776507979,245100,368760288,3228291,407747691,3,243830,326427757,238922,325841427,4908,586330,220760,19,247851,5438,3,703,144444.0,43333.0,-68.0,-73.0,-67.0,-71.0,-68.0,-73.0,-66.0,-70.0,-82.0,-93.0,-83.0,-90.0,14.0,20.0,16.0,19.0,1
977,CC:2F:71:3E:C5:1F,3239828,409158964,11535,1411071,3228293,407747893,6,49175,4119099,40627,3106281,8548,1012818,12163,35,16528,188,6,852,130000.0,39000.0,-69.0,-74.0,-68.0,-61.0,-70.0,-75.0,-69.0,-63.0,-82.0,-93.0,-83.0,-90.0,13.0,19.0,15.0,29.0,1
978,CC:2F:71:3F:1F:24,11710596,13420228364,8482303,13012480471,3228293,407747893,94,1902012,1095965066,1893351,1094924566,8661,1040500,1839033,620,8487009,896922,94,6495,130000.0,43333.0,-69.0,-64.0,-72.0,-69.0,-69.0,-63.0,-71.0,-69.0,-82.0,-93.0,-83.0,-90.0,13.0,29.0,11.0,21.0,1
979,92:69:1D:31:68:E9,3251778,456964068,23481,49215525,3228297,407748543,0,10806,3463048,10709,3446928,97,16120,7033,1,23526,1285,0,100,229410.0,137640.0,-54.0,-50.0,-45.0,-51.0,-51.0,-49.0,-46.0,-50.0,-81.0,-93.0,-83.0,-90.0,27.0,43.0,38.0,39.0,1
980,BA:8C:B9:54:50:24,3263815,486516857,35518,78768314,3228297,407748543,0,12912,4142323,12803,4124015,109,18308,8139,6,35547,6868,0,157,216660.0,130000.0,-47.0,-54.0,-51.0,-59.0,-51.0,-55.0,-55.0,-48.0,-81.0,-93.0,-83.0,-90.0,34.0,39.0,32.0,31.0,1
981,62:47:05:9D:EB:15,3231489,415352773,3192,7604230,3228297,407748543,0,862,150779,824,144031,38,6748,401,0,3229,1151,0,9,216660.0,130000.0,-45.0,-38.0,-43.0,-39.0,-45.0,-39.0,-43.0,-40.0,-81.0,-93.0,-83.0,-90.0,36.0,55.0,40.0,51.0,1
982,F8:59:71:5A:E0:3D,3473493,776658015,245196,368909472,3228297,407748543,3,243926,326575681,239018,325989351,4908,586330,220856,19,247947,5438,3,703,144444.0,43333.0,-68.0,-74.0,-66.0,-70.0,-68.0,-73.0,-66.0,-70.0,-81.0,-93.0,-83.0,-90.0,13.0,19.0,17.0,20.0,1
983,CC:2F:71:3E:C5:1F,3239832,409159614,11535,1411071,3228297,407748543,6,49175,4119099,40627,3106281,8548,1012818,12163,35,16528,188,6,852,130000.0,39000.0,-69.0,-74.0,-68.0,-61.0,-70.0,-75.0,-69.0,-63.0,-81.0,-93.0,-83.0,-90.0,12.0,19.0,15.0,29.0,1
984,CC:2F:71:3F:1F:24,11712418,13423027722,8484121,13015279179,3228297,407748543,94,1902450,1096270638,1893789,1095230138,8661,1040500,1839448,620,8488855,896955,94,6496,130000.0,43333.0,-69.0,-64.0,-72.0,-69.0,-69.0,-64.0,-72.0,-69.0,-81.0,-93.0,-83.0,-90.0,12.0,29.0,11.0,21.0,1
985,92:69:1D:31:68:E9,3251785,456964734,23481,49215525,3228304,407749209,0,10806,3463048,10709,3446928,97,16120,7033,1,23526,1285,0,100,229410.0,137640.0,-54.0,-50.0,-45.0,-51.0,-51.0,-49.0,-46.0,-50.0,-81.0,-93.0,-83.0,-90.0,27.0,43.0,38.0,39.0,1
986,BA:8C:B9:54:50:24,3263822,486517523,35518,78768314,3228304,407749209,0,12912,4142323,12803,4124015,109,18308,8139,6,35547,6868,0,157,216660.0,130000.0,-47.0,-54.0,-51.0,-59.0,-51.0,-55.0,-55.0,-48.0,-81.0,-93.0,-83.0,-90.0,34.0,39.0,32.0,31.0,1
987,62:47:05:9D:EB:15,3231496,415353439,3192,7604230,3228304,407749209,0,862,150779,824,144031,38,6748,401,0,3229,1151,0,9,216660.0,130000.0,-45.0,-38.0,-43.0,-39.0,-45.0,-39.0,-43.0,-40.0,-81.0,-93.0,-83.0,-90.0,36.0,55.0,40.0,51.0,1
988,F8:59:71:5A:E0:3D,3473588,776792527,245282,369043116,3228306,407749411,3,244013,326709661,239105,326123331,4908,586330,220943,19,248033,5438,3,703,144444.0,43333.0,-67.0,-74.0,-66.0,-70.0,-67.0,-73.0,-66.0,-70.0,-81.0,-93.0,-83.0,-90.0,14.0,19.0,17.0,20.0,1
989,CC:2F:71:3E:C5:1F,3239841,409160482,11535,1411071,3228306,407749411,6,49175,4119099,40627,3106281,8548,1012818,12163,35,16528,188,6,852,130000.0,39000.0,-69.0,-74.0,-68.0,-61.0,-70.0,-75.0,-69.0,-63.0,-81.0,-93.0,-83.0,-90.0,12.0,19.0,15.0,29.0,1
990,CC:2F:71:3F:1F:24,11714227,13425792039,8485921,13018042628,3228306,407749411,94,1902922,1096602280,1894261,1095561780,8661,1040500,1839896,620,8490655,897049,94,6496,130000.0,43333.0,-69.0,-64.0,-72.0,-69.0,-69.0,-64.0,-72.0,-69.0,-81.0,-93.0,-83.0,-90.0,12.0,29.0,11.0,21.0,1
991,92:69:1D:31:68:E9,3251946,457379554,23638,49629019,3228308,407750535,0,10828,3468363,10731,3452243,97,16120,7049,1,23683,1285,0,100,216660.0,130000.0,-54.0,-50.0,-45.0,-51.0,-49.0,-49.0,-45.0,-48.0,-81.0,-93.0,-83.0,-90.0,27.0,43.0,38.0,39.0,1
992,BA:8C:B9:54:50:24,3263826,486518849,35518,78768314,3228308,407750535,0,12912,4142323,12803,4124015,109,18308,8139,6,35547,6868,0,157,216660.0,130000.0,-47.0,-54.0,-51.0,-59.0,-51.0,-55.0,-55.0,-48.0,-81.0,-93.0,-83.0,-90.0,34.0,39.0,32.0,31.0,1
993,62:47:05:9D:EB:15,3231500,415354765,3192,7604230,3228308,407750535,0,862,150779,824,144031,38,6748,401,0,3229,1151,0,9,216660.0,130000.0,-45.0,-38.0,-43.0,-39.0,-45.0,-39.0,-43.0,-40.0,-81.0,-93.0,-83.0,-90.0,36.0,55.0,40.0,51.0,1
994,F8:59:71:5A:E0:3D,3473677,776928849,245369,369178314,3228308,407750535,3,244099,326842157,239191,326255827,4908,586330,221029,19,248120,5439,3,703,144444.0,43333.0,-68.0,-73.0,-66.0,-70.0,-67.0,-73.0,-66.0,-70.0,-81.0,-93.0,-83.0,-90.0,13.0,20.0,17.0,20.0,1
995,CC:2F:71:3E:C5:1F,3239848,409162136,11535,1411071,3228313,407751065,6,49175,4119099,40627,3106281,8548,1012818,12163,35,16528,188,6,852,130000.0,39000.0,-69.0,-74.0,-68.0,-61.0,-70.0,-75.0,-69.0,-63.0,-81.0,-93.0,-83.0,-90.0,12.0,19.0,15.0,29.0,1
996,CC:2F:71:3F:1F:24,11715808,13428204185,8487493,13020452918,3228315,407751267,94,1903321,1096915982,1894660,1095875482,8661,1040500,1840273,620,8492227,897150,94,6496,130000.0,43333.0,-69.0,-64.0,-72.0,-69.0,-69.0,-64.0,-72.0,-69.0,-81.0,-93.0,-83.0,-90.0,12.0,29.0,11.0,21.0,1
997,92:69:1D:31:68:E9,3251957,457380664,23639,49629135,3228318,407751529,0,10830,3468499,10733,3452379,97,16120,7049,1,23684,1285,0,100,216660.0,130000.0,-54.0,-50.0,-45.0,-51.0,-50.0,-49.0,-45.0,-49.0,-81.0,-93.0,-83.0,-90.0,27.0,43.0,38.0,39.0,1
998,BA:8C:B9:54:50:24,3263869,486597164,35551,78845635,3228318,407751529,0,12922,4146550,12813,4128242,109,18308,8145,6,35580,6868,0,157,216660.0,130000.0,-52.0,-56.0,-55.0,-50.0,-52.0,-56.0,-55.0,-48.0,-81.0,-93.0,-83.0,-90.0,29.0,37.0,28.0,40.0,1
999,62:47:05:9D:EB:15,3231511,415355875,3193,7604346,3228318,407751529,0,865,150983,827,144235,38,6748,401,0,3230,1151,0,9,216660.0,130000.0,-45.0,-38.0,-43.0,-39.0,-45.0,-39.0,-43.0,-40.0,-81.0,-93.0,-83.0,-90.0,36.0,55.0,40.0,51.0,1
1000,F8:59:71:5A:E0:3D,3473775,777065157,245457,369313628,3228318,407751529,3,244186,326976137,239278,326389807,4908,586330,221116,19,248208,5442,3,703,144444.0,43333.0,-67.0,-73.0,-66.0,-70.0,-67.0,-73.0,-66.0,-70.0,-81.0,-93.0,-83.0,-90.0,14.0,20.0,17.0,20.0,1
1001,CC:2F:71:3E:C5:1F,3239854,409162716,11536,1411187,3228318,407751529,6,49177,4119239,40629,3106421,8548,1012818,12163,35,16529,188,6,852,130000.0,39000.0,-69.0,-73.0,-69.0,-61.0,-70.0,-75.0,-69.0,-63.0,-81.0,-93.0,-83.0,-90.0,12.0,20.0,14.0,29.0,1
1002,CC:2F:71:3F:1F:24,11717350,13430562209,8489030,13022809556,3228320,407752653,94,1903722,1097211999,1895061,1096171499,8661,1040500,1840649,620,8493764,897317,94,6496,130000.0,43333.0,-69.0,-64.0,-72.0,-69.0,-68.0,-64.0,-71.0,-68.0,-81.0,-93.0,-83.0,-90.0,12.0,29.0,11.0,21.0,1
1003,92:69:1D:31:68:E9,3251963,457382192,23639,49629135,3228324,407753057,0,10830,3468499,10733,3452379,97,16120,7049,1,23684,1285,0,100,216660.0,130000.0,-54.0,-50.0,-45.0,-51.0,-50.0,-49.0,-45.0,-49.0,-81.0,-93.0,-83.0,-90.0,27.0,43.0,38.0,39.0,1
1004,BA:8C:B9:54:50:24,3263875,486598692,35551,78845635,3228324,407753057,0,12927,4146890,12818,4128582,109,18308,8145,6,35580,6868,0,157,216660.0,130000.0,-54.0,-56.0,-55.0,-45.0,-50.0,-54.0,-53.0,-47.0,-81.0,-93.0,-83.0,-90.0,27.0,37.0,28.0,45.0,1
1005,62:47:05:9D:EB:15,3231519,415357605,3193,7604346,3228326,407753259,0,865,150983,827,144235,38,6748,401,0,3230,1151,0,9,216660.0,130000.0,-45.0,-38.0,-43.0,-39.0,-45.0,-39.0,-43.0,-40.0,-81.0,-93.0,-83.0,-90.0,36.0,55.0,40.0,51.0,1
1006,F8:59:71:5A:E0:3D,3473866,777195869,245540,369442610,3228326,407753259,3,244269,327103985,239361,326517655,4908,586330,221199,19,248291,5442,3,703,144444.0,43333.0,-68.0,-73.0,-66.0,-71.0,-67.0,-73.0,-66.0,-70.0,-81.0,-93.0,-83.0,-90.0,13.0,20.0,17.0,19.0,1
1007,CC:2F:71:3E:C5:1F,3239862,409164446,11536,1411187,3228326,407753259,6,49177,4119239,40629,3106421,8548,1012818,12163,35,16529,188,6,852,130000.0,39000.0,-69.0,-73.0,-69.0,-61.0,-70.0,-75.0,-69.0,-63.0,-81.0,-93.0,-83.0,-90.0,12.0,20.0,14.0,29.0,1
1008,CC:2F:71:3F:1F:24,11719116,13433271503,8490790,13025518244,3228326,407753259,94,1904134,1097503325,1895473,1096462825,8661,1040500,1841041,620,8495524,897383,94,6496,130000.0,43333.0,-69.0,-64.0,-72.0,-69.0,-69.0,-64.0,-72.0,-69.0,-81.0,-93.0,-83.0,-90.0,12.0,29.0,11.0,21.0,1
1009,92:69:1D:31:68:E9,3251972,457384040,23640,49629331,3228332,407754709,0,10840,3469319,10743,3453199,97,16120,7050,1,23685,1285,0,100,216660.0,130000.0,-55.0,-49.0,-45.0,-51.0,-51.0,-49.0,-45.0,-50.0,-81.0,-93.0,-83.0,-90.0,26.0,44.0,38.0,39.0,1
1010,BA:8C:B9:54:50:24,3263883,486600344,35551,78845635,3228332,407754709,0,12930,4147148,12820,4128718,110,18430,8146,6,35580,6868,0,157,216660.0,130000.0,-53.0,-56.0,-56.0,-45.0,-51.0,-54.0,-53.0,-46.0,-81.0,-93.0,-83.0,-90.0,28.0,37.0,27.0,45.0,1
1011,62:47:05:9D:EB:15,3231526,415359115,3193,7604346,3228333,407754769,0,865,150983,827,144235,38,6748,401,0,3230,1151,0,9,216660.0,130000.0,-45.0,-38.0,-43.0,-39.0,-45.0,-39.0,-43.0,-40.0,-81.0,-93.0,-83.0,-90.0,36.0,55.0,40.0,51.0,1
1012,F8:59:71:5A:E0:3D,3473966,777341901,245633,369587132,3228333,407754769,3,244362,327247205,239454,326660875,4908,586330,221292,19,248384,5443,3,703,144444.0,43333.0,-68.0,-73.0,-66.0,-70.0,-67.0,-73.0,-66.0,-70.0,-81.0,-93.0,-83.0,-90.0,13.0,20.0,17.0,20.0,1
1013,CC:2F:71:3E:C5:1F,3239869,409165956,11536,1411187,3228333,407754769,6,49177,4119239,40629,3106421,8548,1012818,12163,35,16529,188,6,852,130000.0,39000.0,-69.0,-73.0,-69.0,-61.0,-70.0,-75.0,-69.0,-63.0,-81.0,-93.0,-83.0,-90.0,12.0,20.0,14.0,29.0,1
1014,CC:2F:71:3F:1F:24,11720714,13435704886,8492381,13027950117,3228333,407754769,94,1904559,1097843474,1895897,1096802856,8662,1040618,1841447,620,8497094,897601,94,6496,130000.0,39000.0,-70.0,-64.0,-71.0,-69.0,-70.0,-64.0,-71.0,-68.0,-81.0,-93.0,-83.0,-90.0,11.0,29.0,12.0,21.0,1
1015,92:69:1D:31:68:E9,3251982,457384970,23640,49629331,3228342,407755639,0,10845,3469713,10747,3453471,98,16242,7051,1,23685,1285,0,100,216660.0,130000.0,-56.0,-49.0,-45.0,-51.0,-52.0,-49.0,-45.0,-50.0,-81.0,-93.0,-83.0,-90.0,25.0,44.0,38.0,39.0,1
1016,BA:8C:B9:54:50:24,3263901,486604946,35559,78849307,3228342,407755639,0,12954,4152444,12844,4134014,110,18430,8152,6,35588,6869,0,159,216660.0,130000.0,-54.0,-56.0,-53.0,-46.0,-52.0,-54.0,-52.0,-46.0,-81.0,-93.0,-83.0,-90.0,27.0,37.0,30.0,44.0,1
1017,62:47:05:9D:EB:15,3231535,415359985,3193,7604346,3228342,407755639,0,865,150983,827,144235,38,6748,401,0,3230,1151,0,9,216660.0,130000.0,-45.0,-38.0,-43.0,-39.0,-45.0,-39.0,-43.0,-40.0,-81.0,-93.0,-83.0,-90.0,36.0,55.0,40.0,51.0,1
1018,F8:59:71:5A:E0:3D,3474060,777474861,245718,369719222,3228342,407755639,3,244447,327378105,239539,326791775,4908,586330,221377,19,248469,5444,3,703,144444.0,43333.0,-67.0,-73.0,-66.0,-71.0,-67.0,-73.0,-65.0,-71.0,-81.0,-93.0,-83.0,-90.0,14.0,20.0,17.0,19.0,1
1019,CC:2F:71:3E:C5:1F,3239878,409166826,11536,1411187,3228342,407755639,6,49177,4119239,40629,3106421,8548,1012818,12163,35,16529,188,6,852,130000.0,39000.0,-69.0,-73.0,-69.0,-61.0,-70.0,-75.0,-69.0,-63.0,-81.0,-93.0,-83.0,-90.0,12.0,20.0,14.0,29.0,1
1020,CC:2F:71:3F:1F:24,11722733,13438811128,8494391,13031055489,3228342,407755639,94,1905009,1098144672,1896347,1097104054,8662,1040618,1841881,620,8499079,897835,94,6496,115556.0,28889.0,-70.0,-64.0,-72.0,-69.0,-69.0,-64.0,-72.0,-69.0,-81.0,-93.0,-83.0,-90.0,11.0,29.0,11.0,21.0,1
1021,92:69:1D:31:68:E9,3251999,457389640,23657,49634001,3228342,407755639,0,10873,3473787,10775,3457545,98,16242,7069,1,23702,1285,0,100,229410.0,130000.0,-53.0,-50.0,-46.0,-51.0,-49.0,-49.0,-46.0,-49.0,-81.0,-93.0,-83.0,-90.0,28.0,43.0,37.0,39.0,1
1022,BA:8C:B9:54:50:24,3263905,486605350,35559,78849307,3228346,407756043,0,12954,4152444,12844,4134014,110,18430,8152,6,35588,6869,0,159,216660.0,130000.0,-54.0,-56.0,-53.0,-46.0,-52.0,-54.0,-52.0,-46.0,-81.0,-93.0,-83.0,-90.0,27.0,37.0,30.0,44.0,1
1023,62:47:05:9D:EB:15,3231539,415360389,3193,7604346,3228346,407756043,0,867,151119,829,144371,38,6748,401,0,3230,1151,0,9,216660.0,130000.0,-44.0,-38.0,-43.0,-39.0,-44.0,-39.0,-43.0,-40.0,-81.0,-93.0,-83.0,-90.0,37.0,55.0,40.0,51.0,1
1024,F8:59:71:5A:E0:3D,3474153,777612077,245806,369855974,3228347,407756103,3,244537,327516733,239629,326930403,4908,586330,221465,19,248557,5447,3,703,144444.0,43333.0,-67.0,-73.0,-66.0,-71.0,-67.0,-73.0,-65.0,-70.0,-81.0,-93.0,-83.0,-90.0,14.0,20.0,17.0,19.0,1
1025,CC:2F:71:3E:C5:1F,3239885,409167492,11536,1411187,3228349,407756305,6,49177,4119239,40629,3106421,8548,1012818,12163,35,16529,188,6,852,130000.0,39000.0,-69.0,-73.0,-69.0,-61.0,-70.0,-75.0,-69.0,-63.0,-81.0,-93.0,-83.0,-90.0,12.0,20.0,14.0,29.0,1
1026,CC:2F:71:3F:1F:24,11724851,13442068646,8496500,13034312139,3228351,407756507,94,1905547,1098522274,1896885,1097481656,8662,1040618,1842381,620,8501198,898119,94,6496,117000.0,39000.0,-69.0,-64.0,-72.0,-69.0,-69.0,-64.0,-71.0,-69.0,-81.0,-93.0,-83.0,-90.0,12.0,29.0,11.0,21.0,1
1027,92:69:1D:31:68:E9,3252014,457393942,23663,49637435,3228351,407756507,0,10883,3476927,10785,3460685,98,16242,7074,1,23708,1285,0,100,229410.0,137640.0,-53.0,-50.0,-46.0,-51.0,-49.0,-49.0,-46.0,-49.0,-81.0,-93.0,-83.0,-90.0,28.0,43.0,37.0,39.0,1
1028,BA:8C:B9:54:50:24,3263918,486613292,35567,78856785,3228351,407756507,0,12969,4154042,12859,4135612,110,18430,8157,6,35596,6869,0,159,216660.0,130000.0,-54.0,-55.0,-53.0,-46.0,-51.0,-54.0,-53.0,-48.0,-81.0,-93.0,-83.0,-90.0,27.0,38.0,30.0,44.0,1
1029,62:47:05:9D:EB:15,3231544,415360853,3193,7604346,3228351,407756507,0,868,151187,830,144439,38,6748,401,0,3230,1151,0,9,216660.0,130000.0,-44.0,-38.0,-44.0,-39.0,-44.0,-39.0,-43.0,-40.0,-81.0,-93.0,-83.0,-90.0,37.0,55.0,39.0,51.0,1
1030,F8:59:71:5A:E0:3D,3474252,777760111,245901,370003604,3228351,407756507,3,244633,327664643,239725,327078313,4908,586330,221560,19,248652,5447,3,704,144444.0,43333.0,-68.0,-73.0,-66.0,-70.0,-67.0,-73.0,-66.0,-70.0,-81.0,-93.0,-83.0,-90.0,13.0,20.0,17.0,20.0,1
1031,CC:2F:71:3E:C5:1F,3239887,409167694,11536,1411187,3228351,407756507,6,49177,4119239,40629,3106421,8548,1012818,12163,35,16529,188,6,852,130000.0,39000.0,-69.0,-73.0,-69.0,-61.0,-70.0,-75.0,-69.0,-63.0,-81.0,-93.0,-83.0,-90.0,12.0,20.0,14.0,29.0,1
1032,CC:2F:71:3F:1F:24,11726041,13443847984,8497690,13036091477,3228351,407756507,94,1905900,1098815983,1897238,1097775365,8662,1040618,1842732,620,8502425,898319,94,6496,115556.0,28889.0,-69.0,-64.0,-72.0,-68.0,-69.0,-64.0,-71.0,-68.0,-81.0,-93.0,-83.0,-90.0,12.0,29.0,11.0,22.0,1
1033,92:69:1D:31:68:E9,3252022,457394750,23663,49637435,3228359,407757315,0,10883,3476927,10785,3460685,98,16242,7074,1,23708,1285,0,100,229410.0,137640.0,-53.0,-50.0,-46.0,-51.0,-49.0,-49.0,-46.0,-49.0,-81.0,-93.0,-83.0,-90.0,28.0,43.0,37.0,39.0,1
1034,BA:8C:B9:54:50:24,3263926,486614100,35567,78856785,3228359,407757315,0,12969,4154042,12859,4135612,110,18430,8157,6,35596,6869,0,159,216660.0,130000.0,-54.0,-55.0,-53.0,-46.0,-51.0,-54.0,-53.0,-48.0,-81.0,-93.0,-83.0,-90.0,27.0,38.0,30.0,44.0,1
1035,62:47:05:9D:EB:15,3231553,415361721,3193,7604346,3228360,407757375,0,868,151187,830,144439,38,6748,401,0,3230,1151,0,9,216660.0,130000.0,-44.0,-38.0,-44.0,-39.0,-44.0,-39.0,-43.0,-40.0,-81.0,-93.0,-83.0,-90.0,37.0,55.0,39.0,51.0,1
1036,F8:59:71:5A:E0:3D,3474350,777899285,245990,370141910,3228360,407757375,3,244722,327801731,239814,327215401,4908,586330,221649,19,248741,5449,3,704,144444.0,43333.0,-67.0,-73.0,-66.0,-71.0,-67.0,-73.0,-66.0,-70.0,-81.0,-93.0,-83.0,-90.0,14.0,20.0,17.0,19.0,1
1037,CC:2F:71:3E:C5:1F,3239896,409168562,11536,1411187,3228360,407757375,6,49179,4119379,40631,3106561,8548,1012818,12163,36,16530,189,6,852,130000.0,39000.0,-69.0,-74.0,-68.0,-60.0,-68.0,-72.0,-67.0,-60.0,-81.0,-93.0,-83.0,-90.0,12.0,19.0,15.0,30.0,1
1038,CC:2F:71:3F:1F:24,11727208,13445588405,8498848,13037831030,3228360,407757375,94,1906270,1099133551,1897608,1098092933,8662,1040618,1843089,620,8503583,898354,94,6496,130000.0,43333.0,-69.0,-64.0,-72.0,-69.0,-69.0,-64.0,-72.0,-69.0,-81.0,-93.0,-83.0,-90.0,12.0,29.0,11.0,21.0,1
1039,92:69:1D:31:68:E9,3252025,457394932,23664,49637495,3228361,407757437,0,10886,3477169,10788,3460927,98,16242,7075,1,23709,1285,0,100,229410.0,137640.0,-53.0,-50.0,-46.0,-51.0,-51.0,-49.0,-46.0,-50.0,-81.0,-92.0,-83.0,-90.0,28.0,42.0,37.0,39.0,1
1040,BA:8C:B9:54:50:24,3263930,486614424,35567,78856785,3228363,407757639,0,12969,4154042,12859,4135612,110,18430,8157,6,35596,6869,0,159,216660.0,130000.0,-54.0,-55.0,-53.0,-46.0,-51.0,-54.0,-53.0,-48.0,-81.0,-92.0,-83.0,-90.0,27.0,37.0,30.0,44.0,1
1041,62:47:05:9D:EB:15,3231559,415362460,3193,7604346,3228366,407758114,0,868,151187,830,144439,38,6748,401,0,3230,1151,0,9,216660.0,130000.0,-44.0,-38.0,-44.0,-39.0,-44.0,-39.0,-43.0,-40.0,-81.0,-92.0,-83.0,-90.0,37.0,54.0,39.0,51.0,1
1042,F8:59:71:5A:E0:3D,3474439,778029006,246073,370270892,3228366,407758114,3,244807,327931209,239898,327344761,4909,586448,221734,19,248824,5450,3,704,144444.0,43333.0,-68.0,-73.0,-66.0,-71.0,-67.0,-72.0,-66.0,-70.0,-81.0,-92.0,-83.0,-90.0,13.0,19.0,17.0,19.0,1
1043,CC:2F:71:3E:C5:1F,3239902,409169301,11536,1411187,3228366,407758114,6,49179,4119379,40631,3106561,8548,1012818,12163,36,16530,189,6,852,130000.0,39000.0,-69.0,-74.0,-68.0,-60.0,-68.0,-72.0,-67.0,-60.0,-81.0,-92.0,-83.0,-90.0,12.0,18.0,15.0,30.0,1
1044,CC:2F:71:3F:1F:24,11728370,13447343272,8500004,13039585158,3228366,407758114,94,1906692,1099444701,1898030,1098404083,8662,1040618,1843476,620,8504739,898379,94,6497,130000.0,43333.0,-69.0,-64.0,-71.0,-68.0,-69.0,-64.0,-71.0,-68.0,-81.0,-92.0,-83.0,-90.0,12.0,28.0,12.0,22.0,1
1045,92:69:1D:31:68:E9,3252197,457814071,23826,50055493,3228371,407758578,0,10918,3483589,10820,3467347,98,16242,7096,1,23871,1285,0,101,229410.0,137640.0,-53.0,-50.0,-46.0,-51.0,-50.0,-49.0,-45.0,-48.0,-81.0,-92.0,-83.0,-90.0,28.0,42.0,37.0,39.0,1
1046,BA:8C:B9:54:50:24,3263938,486615363,35567,78856785,3228371,407758578,0,12969,4154042,12859,4135612,110,18430,8157,6,35596,6869,0,159,216660.0,130000.0,-54.0,-55.0,-53.0,-46.0,-51.0,-54.0,-53.0,-48.0,-81.0,-92.0,-83.0,-90.0,27.0,37.0,30.0,44.0,1
1047,62:47:05:9D:EB:15,3231564,415362924,3193,7604346,3228371,407758578,0,868,151187,830,144439,38,6748,401,0,3230,1151,0,9,216660.0,130000.0,-44.0,-38.0,-44.0,-39.0,-44.0,-39.0,-43.0,-40.0,-81.0,-92.0,-83.0,-90.0,37.0,54.0,39.0,51.0,1
1048,F8:59:71:5A:E0:3D,3474552,778197302,246181,370438724,3228371,407758578,3,244915,328097529,240006,327511081,4909,586448,221842,19,248932,5450,3,704,144444.0,43333.0,-67.0,-73.0,-66.0,-70.0,-67.0,-72.0,-66.0,-70.0,-81.0,-92.0,-83.0,-90.0,14.0,19.0,17.0,20.0,1
1049,CC:2F:71:3E:C5:1F,3239907,409169765,11536,1411187,3228371,407758578,6,49179,4119379,40631,3106561,8548,1012818,12163,36,16530,189,6,852,130000.0,39000.0,-69.0,-74.0,-68.0,-60.0,-68.0,-72.0,-67.0,-60.0,-81.0,-92.0,-83.0,-90.0,12.0,18.0,15.0,30.0,1
1050,CC:2F:71:3F:1F:24,11729830,13449555951,8501458,13041797311,3228372,407758640,94,1907161,1099873979,1898499,1098833361,8662,1040618,1843882,620,8506182,898498,94,6499,130000.0,43333.0,-69.0,-64.0,-71.0,-69.0,-69.0,-64.0,-71.0,-68.0,-81.0,-92.0,-83.0,-90.0,12.0,28.0,12.0,21.0,1
1051,92:69:1D:31:68:E9,3252208,457815163,23826,50055493,3228382,407759670,0,10931,3484628,10832,3468215,99,16413,7098,1,23871,1285,0,101,229410.0,137640.0,-53.0,-51.0,-46.0,-51.0,-50.0,-50.0,-46.0,-49.0,-81.0,-92.0,-83.0,-90.0,28.0,41.0,37.0,39.0,1
1052,BA:8C:B9:54:50:24,3263949,486616455,35567,78856785,3228382,407759670,0,12972,4154349,12861,4135748,111,18601,8158,6,35596,6869,0,159,216660.0,130000.0,-55.0,-56.0,-55.0,-45.0,-53.0,-55.0,-54.0,-48.0,-81.0,-92.0,-83.0,-90.0,26.0,36.0,28.0,45.0,1
1053,62:47:05:9D:EB:15,3231575,415364016,3193,7604346,3228382,407759670,0,868,151187,830,144439,38,6748,401,0,3230,1151,0,9,216660.0,130000.0,-44.0,-38.0,-44.0,-39.0,-44.0,-39.0,-43.0,-40.0,-81.0,-92.0,-83.0,-90.0,37.0,54.0,39.0,51.0,1
1054,F8:59:71:5A:E0:3D,3474684,778386260,246302,370626590,3228382,407759670,3,245036,328284093,240127,327697645,4909,586448,221962,19,249053,5452,3,704,144444.0,43333.0,-67.0,-73.0,-66.0,-70.0,-67.0,-73.0,-66.0,-70.0,-81.0,-92.0,-83.0,-90.0,14.0,19.0,17.0,20.0,1
1055,CC:2F:71:3E:C5:1F,3239918,409170857,11536,1411187,3228382,407759670,6,49181,4119567,40632,3106631,8549,1012936,12164,36,16530,189,6,852,130000.0,39000.0,-69.0,-74.0,-68.0,-60.0,-68.0,-73.0,-67.0,-60.0,-81.0,-92.0,-83.0,-90.0,12.0,18.0,15.0,30.0,1
1056,CC:2F:71:3F:1F:24,11731253,13451714447,8502871,13043954777,3228382,407759670,94,1907648,1100355124,1898986,1099314506,8662,1040618,1844315,620,8507583,898554,94,6500,130000.0,43333.0,-69.0,-64.0,-72.0,-68.0,-69.0,-64.0,-71.0,-68.0,-81.0,-92.0,-83.0,-90.0,12.0,28.0,11.0,22.0,1
1057,92:69:1D:31:68:E9,3252217,457816031,23826,50055493,3228391,407760538,0,10931,3484628,10832,3468215,99,16413,7098,1,23871,1285,0,101,229410.0,137640.0,-53.0,-51.0,-46.0,-51.0,-50.0,-50.0,-46.0,-49.0,-81.0,-92.0,-83.0,-90.0,28.0,41.0,37.0,39.0,1
1058,BA:8C:B9:54:50:24,3263958,486617323,35567,78856785,3228391,407760538,0,12972,4154349,12861,4135748,111,18601,8158,6,35596,6869,0,159,216660.0,130000.0,-55.0,-56.0,-55.0,-45.0,-53.0,-55.0,-54.0,-48.0,-81.0,-92.0,-83.0,-90.0,26.0,36.0,28.0,45.0,1
1059,62:47:05:9D:EB:15,3231584,415364884,3193,7604346,3228391,407760538,0,868,151187,830,144439,38,6748,401,0,3230,1151,0,9,216660.0,130000.0,-44.0,-38.0,-44.0,-39.0,-44.0,-39.0,-43.0,-40.0,-81.0,-92.0,-83.0,-90.0,37.0,54.0,39.0,51.0,1
1060,F8:59:71:5A:E0:3D,3474790,778537866,246399,370777328,3228391,407760538,3,245133,328433473,240224,327847025,4909,586448,222059,19,249150,5454,3,704,144444.0,43333.0,-68.0,-73.0,-66.0,-70.0,-67.0,-73.0,-66.0,-70.0,-81.0,-92.0,-83.0,-90.0,13.0,19.0,17.0,20.0,1
1061,CC:2F:71:3E:C5:1F,3239927,409171725,11536,1411187,3228391,407760538,6,49181,4119567,40632,3106631,8549,1012936,12164,36,16530,189,6,852,130000.0,39000.0,-69.0,-74.0,-68.0,-60.0,-68.0,-73.0,-67.0,-60.0,-81.0,-92.0,-83.0,-90.0,12.0,18.0,15.0,30.0,1
1062,CC:2F:71:3F:1F:24,11732976,13454346336,8504585,13046585798,3228391,407760538,94,1908078,1100692776,1899416,1099652158,8662,1040618,1844731,620,8509320,898715,94,6501,130000.0,43333.0,-69.0,-64.0,-72.0,-69.0,-69.0,-64.0,-71.0,-68.0,-81.0,-92.0,-83.0,-90.0,12.0,28.0,11.0,21.0,1
1063,92:69:1D:31:68:E9,3252217,457816031,23826,50055493,3228391,407760538,0,10931,3484628,10832,3468215,99,16413,7098,1,23871,1285,0,101,229410.0,137640.0,-53.0,-51.0,-46.0,-51.0,-50.0,-50.0,-46.0,-49.0,-81.0,-92.0,-83.0,-90.0,28.0,41.0,37.0,39.0,1
1064,BA:8C:B9:54:50:24,3263958,486617323,35567,78856785,3228391,407760538,0,12972,4154349,12861,4135748,111,18601,8158,6,35596,6869,0,159,216660.0,130000.0,-55.0,-56.0,-55.0,-45.0,-53.0,-55.0,-54.0,-48.0,-81.0,-92.0,-83.0,-90.0,26.0,36.0,28.0,45.0,1
1065,62:47:05:9D:EB:15,3231586,415365086,3193,7604346,3228393,407760740,0,868,151187,830,144439,38,6748,401,0,3230,1151,0,9,216660.0,130000.0,-44.0,-38.0,-44.0,-39.0,-44.0,-39.0,-43.0,-40.0,-81.0,-92.0,-83.0,-90.0,37.0,54.0,39.0,51.0,1
1066,F8:59:71:5A:E0:3D,3474880,778671914,246485,370910972,3228395,407760942,3,245222,328570603,240313,327984155,4909,586448,222146,19,249236,5454,3,704,144444.0,43333.0,-67.0,-73.0,-67.0,-70.0,-67.0,-73.0,-66.0,-70.0,-81.0,-92.0,-83.0,-90.0,14.0,19.0,16.0,20.0,1
1067,CC:2F:71:3E:C5:1F,3239931,409172129,11536,1411187,3228395,407760942,6,49181,4119567,40632,3106631,8549,1012936,12164,36,16530,189,6,852,130000.0,39000.0,-69.0,-74.0,-68.0,-60.0,-68.0,-73.0,-67.0,-60.0,-81.0,-92.0,-83.0,-90.0,12.0,18.0,15.0,30.0,1
1068,CC:2F:71:3F:1F:24,11734810,13457164216,8506415,13049403274,3228395,407760942,94,1908502,1100992574,1899840,1099951956,8662,1040618,1845134,620,8511132,898804,94,6502,130000.0,43333.0,-69.0,-64.0,-72.0,-69.0,-69.0,-63.0,-71.0,-68.0,-81.0,-92.0,-83.0,-90.0,12.0,28.0,11.0,21.0,1
1069,92:69:1D:31:68:E9,3252227,457817015,23827,50055609,3228400,407761406,0,10934,3484870,10835,3468457,99,16413,7099,1,23872,1285,0,101,229410.0,137640.0,-53.0,-51.0,-46.0,-51.0,-51.0,-51.0,-46.0,-51.0,-81.0,-92.0,-83.0,-90.0,28.0,41.0,37.0,39.0,1
1070,BA:8C:B9:54:50:24,3263967,486618191,35567,78856785,3228400,407761406,0,12973,4154417,12862,4135816,111,18601,8158,6,35596,6869,0,159,216660.0,130000.0,-48.0,-55.0,-51.0,-61.0,-52.0,-56.0,-54.0,-50.0,-81.0,-92.0,-83.0,-90.0,33.0,37.0,32.0,29.0,1
1071,62:47:05:9D:EB:15,3231593,415365752,3193,7604346,3228400,407761406,0,868,151187,830,144439,38,6748,401,0,3230,1151,0,9,216660.0,130000.0,-44.0,-38.0,-44.0,-39.0,-44.0,-39.0,-43.0,-40.0,-81.0,-92.0,-83.0,-90.0,37.0,54.0,39.0,51.0,1
1072,F8:59:71:5A:E0:3D,3474968,778801360,246568,371039954,3228400,407761406,3,245301,328692263,240392,328105815,4909,586448,222225,19,249319,5454,3,704,144444.0,43333.0,-68.0,-73.0,-66.0,-71.0,-68.0,-73.0,-66.0,-70.0,-81.0,-92.0,-83.0,-90.0,13.0,19.0,17.0,19.0,1
1073,CC:2F:71:3E:C5:1F,3239936,409172593,11536,1411187,3228400,407761406,6,49181,4119567,40632,3106631,8549,1012936,12164,36,16530,189,6,852,130000.0,39000.0,-69.0,-74.0,-68.0,-60.0,-68.0,-73.0,-67.0,-60.0,-81.0,-92.0,-83.0,-90.0,12.0,18.0,15.0,30.0,1
1074,CC:2F:71:3F:1F:24,11736738,13460123310,8508338,13052361904,3228400,407761406,94,1909003,1101406056,1900341,1100365438,8662,1040618,1845615,620,8513038,898879,94,6502,117000.0,39000.0,-69.0,-64.0,-72.0,-69.0,-69.0,-63.0,-71.0,-68.0,-81.0,-92.0,-83.0,-90.0,12.0,28.0,11.0,21.0,1
1075,92:69:1D:31:68:E9,3252235,457817823,23827,50055609,3228408,407762214,0,10934,3484870,10835,3468457,99,16413,7099,1,23872,1285,0,101,229410.0,137640.0,-53.0,-51.0,-46.0,-51.0,-51.0,-51.0,-46.0,-51.0,-81.0,-92.0,-83.0,-90.0,28.0,41.0,37.0,39.0,1
1076,BA:8C:B9:54:50:24,3263975,486618999,35567,78856785,3228408,407762214,0,12973,4154417,12862,4135816,111,18601,8158,6,35596,6869,0,159,216660.0,130000.0,-48.0,-55.0,-51.0,-61.0,-52.0,-56.0,-54.0,-50.0,-81.0,-92.0,-83.0,-90.0,33.0,37.0,32.0,29.0,1
1077,62:47:05:9D:EB:15,3231601,415366560,3193,7604346,3228408,407762214,0,868,151187,830,144439,38,6748,401,0,3230,1151,0,9,216660.0,130000.0,-44.0,-38.0,-44.0,-39.0,-44.0,-39.0,-43.0,-40.0,-81.0,-92.0,-83.0,-90.0,37.0,54.0,39.0,51.0,1
1078,F8:59:71:5A:E0:3D,3475089,778977770,246681,371215556,3228408,407762214,3,245418,328872807,240509,328286359,4909,586448,222342,19,249432,5454,3,705,144444.0,43333.0,-67.0,-73.0,-66.0,-70.0,-67.0,-73.0,-66.0,-70.0,-81.0,-92.0,-83.0,-90.0,14.0,19.0,17.0,20.0,1
1079,CC:2F:71:3E:C5:1F,3239944,409173401,11536,1411187,3228408,407762214,6,49181,4119567,40632,3106631,8549,1012936,12164,36,16530,189,6,852,130000.0,39000.0,-69.0,-74.0,-68.0,-60.0,-68.0,-73.0,-67.0,-60.0,-81.0,-92.0,-83.0,-90.0,12.0,18.0,15.0,30.0,1
1080,CC:2F:71:3F:1F:24,11737767,13461660529,8509359,13053898315,3228408,407762214,94,1909376,1101687481,1900714,1100646863,8662,1040618,1845976,620,8514094,898904,94,6503,130000.0,43333.0,-70.0,-64.0,-71.0,-68.0,-69.0,-64.0,-72.0,-68.0,-81.0,-92.0,-83.0,-90.0,11.0,28.0,12.0,22.0,1
1081,92:69:1D:31:68:E9,3252238,457818085,23827,50055609,3228411,407762476,0,10934,3484870,10835,3468457,99,16413,7099,1,23872,1285,0,101,229410.0,137640.0,-53.0,-51.0,-46.0,-51.0,-51.0,-51.0,-46.0,-51.0,-81.0,-92.0,-83.0,-90.0,28.0,41.0,37.0,39.0,1
1082,BA:8C:B9:54:50:24,3263980,486619463,35567,78856785,3228413,407762678,0,12973,4154417,12862,4135816,111,18601,8158,6,35596,6869,0,159,216660.0,130000.0,-48.0,-55.0,-51.0,-61.0,-52.0,-56.0,-54.0,-50.0,-81.0,-92.0,-83.0,-90.0,33.0,37.0,32.0,29.0,1
1083,62:47:05:9D:EB:15,3231606,415367024,3193,7604346,3228413,407762678,0,868,151187,830,144439,38,6748,401,0,3230,1151,0,9,216660.0,130000.0,-44.0,-38.0,-44.0,-39.0,-44.0,-39.0,-43.0,-40.0,-81.0,-92.0,-83.0,-90.0,37.0,54.0,39.0,51.0,1
1084,F8:59:71:5A:E0:3D,3475189,779125864,246776,371363186,3228413,407762678,3,245513,329019107,240604,328432659,4909,586448,222437,19,249527,5454,3,705,144444.0,43333.0,-67.0,-73.0,-66.0,-70.0,-67.0,-72.0,-65.0,-70.0,-81.0,-92.0,-83.0,-90.0,14.0,19.0,17.0,20.0,1
1085,CC:2F:71:3E:C5:1F,3239951,409174067,11536,1411187,3228415,407762880,6,49181,4119567,40632,3106631,8549,1012936,12164,36,16530,189,6,852,130000.0,39000.0,-69.0,-74.0,-68.0,-60.0,-68.0,-73.0,-67.0,-60.0,-81.0,-92.0,-83.0,-90.0,12.0,18.0,15.0,30.0,1
1086,CC:2F:71:3F:1F:24,11738889,13463334029,8510472,13055570947,3228417,407763082,94,1909802,1102059617,1901140,1101018999,8662,1040618,1846373,620,8515207,899014,94,6504,130000.0,43333.0,-70.0,-64.0,-71.0,-68.0,-69.0,-64.0,-71.0,-68.0,-81.0,-92.0,-83.0,-90.0,11.0,28.0,12.0,22.0,1
1087,92:69:1D:31:68:E9,3252244,457818691,23827,50055609,3228417,407763082,0,10934,3484870,10835,3468457,99,16413,7099,1,23872,1285,0,101,229410.0,137640.0,-53.0,-51.0,-46.0,-51.0,-51.0,-51.0,-46.0,-51.0,-81.0,-92.0,-83.0,-90.0,28.0,41.0,37.0,39.0,1
1088,BA:8C:B9:54:50:24,3263984,486619867,35567,78856785,3228417,407763082,0,12973,4154417,12862,4135816,111,18601,8158,6,35596,6869,0,159,216660.0,130000.0,-48.0,-55.0,-51.0,-61.0,-52.0,-56.0,-54.0,-50.0,-81.0,-92.0,-83.0,-90.0,33.0,37.0,32.0,29.0,1
1089,62:47:05:9D:EB:15,3231610,415367428,3193,7604346,3228417,407763082,0,868,151187,830,144439,38,6748,401,0,3230,1151,0,9,216660.0,130000.0,-44.0,-38.0,-44.0,-39.0,-44.0,-39.0,-43.0,-40.0,-81.0,-92.0,-83.0,-90.0,37.0,54.0,39.0,51.0,1
1090,F8:59:71:5A:E0:3D,3475284,779266188,246866,371503046,3228418,407763142,3,245603,329157707,240694,328571259,4909,586448,222527,19,249617,5455,3,705,144444.0,43333.0,-67.0,-73.0,-66.0,-70.0,-67.0,-72.0,-65.0,-70.0,-81.0,-92.0,-83.0,-90.0,14.0,19.0,17.0,20.0,1
1091,CC:2F:71:3E:C5:1F,3239954,409174329,11536,1411187,3228418,407763142,6,49181,4119567,40632,3106631,8549,1012936,12164,36,16530,189,6,852,130000.0,39000.0,-69.0,-74.0,-68.0,-60.0,-68.0,-73.0,-67.0,-60.0,-81.0,-92.0,-83.0,-90.0,12.0,18.0,15.0,30.0,1
1092,CC:2F:71:3F:1F:24,11740377,13465610399,8511959,13057847257,3228418,407763142,94,1910175,1102367423,1901513,1101326805,8662,1040618,1846732,620,8516694,899094,94,6504,117000.0,39000.0,-70.0,-64.0,-72.0,-69.0,-69.0,-63.0,-71.0,-68.0,-81.0,-92.0,-83.0,-90.0,11.0,28.0,11.0,21.0,1
1093,92:69:1D:31:68:E9,3252255,457819679,23827,50055609,3228428,407764070,0,10935,3484938,10836,3468525,99,16413,7099,1,23872,1285,0,102,229410.0,137640.0,-53.0,-50.0,-46.0,-50.0,-51.0,-51.0,-46.0,-51.0,-81.0,-92.0,-83.0,-90.0,28.0,42.0,37.0,40.0,1
1094,BA:8C:B9:54:50:24,3263995,486620855,35567,78856785,3228428,407764070,0,12973,4154417,12862,4135816,111,18601,8158,6,35596,6869,0,159,216660.0,130000.0,-48.0,-55.0,-51.0,-61.0,-52.0,-56.0,-54.0,-50.0,-81.0,-92.0,-83.0,-90.0,33.0,37.0,32.0,29.0,1
1095,62:47:05:9D:EB:15,3231621,415368416,3193,7604346,3228428,407764070,0,868,151187,830,144439,38,6748,401,0,3230,1151,0,9,216660.0,130000.0,-44.0,-38.0,-44.0,-39.0,-44.0,-39.0,-43.0,-40.0,-81.0,-92.0,-83.0,-90.0,37.0,54.0,39.0,51.0,1
1096,F8:59:71:5A:E0:3D,3475377,779396098,246949,371632028,3228428,407764070,3,245686,329285527,240777,328699079,4909,586448,222610,19,249700,5461,3,705,144444.0,43333.0,-67.0,-73.0,-66.0,-70.0,-67.0,-72.0,-65.0,-70.0,-81.0,-92.0,-83.0,-90.0,14.0,19.0,17.0,20.0,1
1097,CC:2F:71:3E:C5:1F,3239964,409175257,11536,1411187,3228428,407764070,6,49181,4119567,40632,3106631,8549,1012936,12164,36,16530,189,6,852,130000.0,39000.0,-69.0,-74.0,-68.0,-60.0,-68.0,-73.0,-67.0,-60.0,-81.0,-92.0,-83.0,-90.0,12.0,18.0,15.0,30.0,1
1098,CC:2F:71:3F:1F:24,11741738,13467646507,8513310,13059882437,3228428,407764070,94,1910579,1102662699,1901917,1101622081,8662,1040618,1847120,620,8518045,899151,94,6507,130000.0,43333.0,-70.0,-65.0,-72.0,-69.0,-69.0,-64.0,-72.0,-69.0,-81.0,-92.0,-83.0,-90.0,11.0,27.0,11.0,21.0,1
1099,92:69:1D:31:68:E9,3252369,458116112,23940,50351769,3228429,407764343,0,10954,3490010,10855,3473597,99,16413,7113,1,23985,1285,0,102,229410.0,137640.0,-53.0,-50.0,-46.0,-51.0,-49.0,-49.0,-45.0,-48.0,-81.0,-92.0,-83.0,-90.0,28.0,42.0,37.0,39.0,1
1100,BA:8C:B9:54:50:24,3264235,487168783,35806,79404440,3228429,407764343,0,13030,4174823,12919,4156222,111,18601,8194,6,35835,6933,0,159,229410.0,137640.0,-54.0,-56.0,-55.0,-45.0,-53.0,-56.0,-55.0,-50.0,-81.0,-92.0,-83.0,-90.0,27.0,36.0,28.0,45.0,1
1101,62:47:05:9D:EB:15,3231623,415368749,3193,7604346,3228430,407764403,0,868,151187,830,144439,38,6748,401,0,3230,1151,0,9,216660.0,130000.0,-44.0,-38.0,-44.0,-39.0,-44.0,-39.0,-43.0,-40.0,-81.0,-92.0,-83.0,-90.0,37.0,54.0,39.0,51.0,1
1102,F8:59:71:5A:E0:3D,3475460,779522305,247030,371757902,3228430,407764403,3,245767,329410267,240858,328823819,4909,586448,222691,19,249781,5461,3,705,144444.0,43333.0,-67.0,-71.0,-65.0,-69.0,-67.0,-72.0,-65.0,-69.0,-81.0,-92.0,-83.0,-90.0,14.0,21.0,18.0,21.0,1
1103,CC:2F:71:3E:C5:1F,3239968,409175792,11536,1411187,3228432,407764605,6,49181,4119567,40632,3106631,8549,1012936,12164,36,16530,189,6,852,130000.0,39000.0,-69.0,-74.0,-68.0,-60.0,-68.0,-73.0,-67.0,-60.0,-81.0,-92.0,-83.0,-90.0,12.0,18.0,15.0,30.0,1
1104,CC:2F:71:3F:1F:24,11743638,13470569002,8515206,13062804397,3228432,407764605,94,1911037,1102953463,1902375,1101912845,8662,1040618,1847562,620,8519941,899172,94,6508,130000.0,43333.0,-69.0,-64.0,-72.0,-68.0,-69.0,-63.0,-71.0,-68.0,-81.0,-92.0,-83.0,-90.0,12.0,28.0,11.0,22.0,1
1105,92:69:1D:31:68:E9,3252379,458117040,23940,50351769,3228439,407765271,0,10954,3490010,10855,3473597,99,16413,7113,1,23985,1285,0,102,229410.0,137640.0,-53.0,-50.0,-46.0,-51.0,-49.0,-49.0,-45.0,-48.0,-81.0,-92.0,-83.0,-90.0,28.0,42.0,37.0,39.0,1
1106,BA:8C:B9:54:50:24,3264245,487169711,35806,79404440,3228439,407765271,0,13030,4174823,12919,4156222,111,18601,8194,6,35835,6933,0,159,229410.0,137640.0,-54.0,-56.0,-55.0,-45.0,-53.0,-56.0,-55.0,-50.0,-81.0,-92.0,-83.0,-90.0,27.0,36.0,28.0,45.0,1
1107,62:47:05:9D:EB:15,3231632,415369617,3193,7604346,3228439,407765271,0,868,151187,830,144439,38,6748,401,0,3230,1151,0,9,216660.0,130000.0,-44.0,-38.0,-44.0,-39.0,-44.0,-39.0,-43.0,-40.0,-81.0,-92.0,-83.0,-90.0,37.0,54.0,39.0,51.0,1
1108,F8:59:71:5A:E0:3D,3475553,779653709,247114,371888438,3228439,407765271,3,245850,329538087,240941,328951639,4909,586448,222774,19,249865,5461,3,705,144444.0,43333.0,-67.0,-73.0,-66.0,-70.0,-67.0,-72.0,-66.0,-70.0,-81.0,-92.0,-83.0,-90.0,14.0,19.0,17.0,20.0,1
1109,CC:2F:71:3E:C5:1F,3239975,409176458,11536,1411187,3228439,407765271,6,49181,4119567,40632,3106631,8549,1012936,12164,36,16530,189,6,852,130000.0,39000.0,-69.0,-74.0,-68.0,-60.0,-68.0,-73.0,-67.0,-60.0,-81.0,-92.0,-83.0,-90.0,12.0,18.0,15.0,30.0,1
1110,CC:2F:71:3F:1F:24,11745073,13472752788,8516634,13064987517,3228439,407765271,94,1911376,1103246295,1902714,1102205677,8662,1040618,1847896,620,8521343,899429,94,6509,130000.0,43333.0,-70.0,-64.0,-71.0,-68.0,-69.0,-64.0,-71.0,-68.0,-81.0,-92.0,-83.0,-90.0,11.0,28.0,12.0,22.0,1
1111,92:69:1D:31:68:E9,3252381,458117242,23940,50351769,3228441,407765473,0,10954,3490010,10855,3473597,99,16413,7113,1,23985,1285,0,102,229410.0,137640.0,-53.0,-50.0,-46.0,-51.0,-49.0,-49.0,-45.0,-48.0,-81.0,-92.0,-83.0,-90.0,28.0,42.0,37.0,39.0,1
1112,BA:8C:B9:54:50:24,3264247,487169913,35806,79404440,3228441,407765473,0,13030,4174823,12919,4156222,111,18601,8194,6,35835,6933,0,159,229410.0,137640.0,-54.0,-56.0,-55.0,-45.0,-53.0,-56.0,-55.0,-50.0,-81.0,-92.0,-83.0,-90.0,27.0,36.0,28.0,45.0,1
1113,62:47:05:9D:EB:15,3231638,415370223,3193,7604346,3228445,407765877,0,868,151187,830,144439,38,6748,401,0,3230,1151,0,9,216660.0,130000.0,-44.0,-38.0,-44.0,-39.0,-44.0,-39.0,-43.0,-40.0,-81.0,-92.0,-83.0,-90.0,37.0,54.0,39.0,51.0,1
1114,F8:59:71:5A:E0:3D,3475645,779786521,247200,372020644,3228445,407765877,3,245936,329670527,241027,329084079,4909,586448,222860,19,249951,5461,3,705,144444.0,43333.0,-67.0,-73.0,-66.0,-70.0,-67.0,-73.0,-66.0,-70.0,-81.0,-92.0,-83.0,-90.0,14.0,19.0,17.0,20.0,1
1115,CC:2F:71:3E:C5:1F,3239982,409177180,11537,1411303,3228445,407765877,6,49183,4119707,40634,3106771,8549,1012936,12164,36,16531,189,6,852,130000.0,39000.0,-64.0,-69.0,-63.0,-60.0,-69.0,-74.0,-68.0,-61.0,-81.0,-92.0,-83.0,-90.0,17.0,23.0,20.0,30.0,1
1116,CC:2F:71:3F:1F:24,11746766,13475303926,8518321,13067538049,3228445,407765877,94,1911844,1103548835,1903182,1102508217,8662,1040618,1848356,620,8523042,899455,94,6510,130000.0,43333.0,-69.0,-64.0,-72.0,-69.0,-69.0,-64.0,-71.0,-68.0,-81.0,-92.0,-83.0,-90.0,12.0,28.0,11.0,21.0,1
1117,92:69:1D:31:68:E9,3252391,458118392,23941,50351885,3228450,407766507,0,10960,3490418,10861,3474005,99,16413,7113,1,23986,1285,0,102,229410.0,137640.0,-53.0,-50.0,-46.0,-51.0,-50.0,-49.0,-45.0,-49.0,-81.0,-92.0,-83.0,-90.0,28.0,42.0,37.0,39.0,1
1118,BA:8C:B9:54:50:24,3264600,487972622,36150,80206115,3228450,407766507,0,13107,4205403,12996,4186802,111,18601,8246,6,36179,6933,0,159,229410.0,137640.0,-54.0,-56.0,-55.0,-45.0,-52.0,-55.0,-54.0,-48.0,-81.0,-92.0,-83.0,-90.0,27.0,36.0,28.0,45.0,1
1119,62:47:05:9D:EB:15,3231644,415370969,3194,7604462,3228450,407766507,0,870,151323,832,144575,38,6748,401,0,3231,1151,0,9,216660.0,130000.0,-45.0,-38.0,-44.0,-40.0,-44.0,-39.0,-43.0,-40.0,-81.0,-92.0,-83.0,-90.0,36.0,54.0,39.0,50.0,1
1120,F8:59:71:5A:E0:3D,3475732,779913141,247282,372146634,3228450,407766507,3,246017,329793917,241108,329207469,4909,586448,222941,19,250032,5461,3,705,144444.0,43333.0,-68.0,-73.0,-66.0,-71.0,-67.0,-73.0,-66.0,-70.0,-81.0,-92.0,-83.0,-90.0,13.0,19.0,17.0,19.0,1
1121,CC:2F:71:3E:C5:1F,3239987,409177810,11537,1411303,3228450,407766507,6,49183,4119707,40634,3106771,8549,1012936,12164,36,16531,189,6,852,130000.0,39000.0,-64.0,-69.0,-63.0,-60.0,-69.0,-74.0,-68.0,-61.0,-81.0,-92.0,-83.0,-90.0,17.0,23.0,20.0,30.0,1
1122,CC:2F:71:3F:1F:24,11747773,13476798786,8519323,13069032279,3228450,407766507,94,1912214,1103835318,1903552,1102794700,8662,1040618,1848716,620,8524057,899515,94,6511,130000.0,43333.0,-70.0,-64.0,-73.0,-69.0,-69.0,-64.0,-72.0,-68.0,-81.0,-92.0,-83.0,-90.0,11.0,28.0,10.0,21.0,1
1123,92:69:1D:31:68:E9,3252397,458118998,23941,50351885,3228456,407767113,0,10960,3490418,10861,3474005,99,16413,7113,1,23986,1285,0,102,229410.0,137640.0,-53.0,-50.0,-46.0,-51.0,-50.0,-49.0,-45.0,-49.0,-81.0,-92.0,-83.0,-90.0,28.0,42.0,37.0,39.0,1
1124,BA:8C:B9:54:50:24,3264819,488247137,36363,80480024,3228456,407767113,0,13147,4210442,13036,4191841,111,18601,8272,6,36392,6934,0,159,229410.0,137640.0,-54.0,-56.0,-55.0,-45.0,-53.0,-56.0,-55.0,-50.0,-81.0,-92.0,-83.0,-90.0,27.0,36.0,28.0,45.0,1
1125,62:47:05:9D:EB:15,3231652,415371777,3194,7604462,3228458,407767315,0,870,151323,832,144575,38,6748,401,0,3231,1151,0,9,216660.0,130000.0,-45.0,-38.0,-44.0,-40.0,-44.0,-39.0,-43.0,-40.0,-81.0,-92.0,-83.0,-90.0,36.0,54.0,39.0,50.0,1
1126,F8:59:71:5A:E0:3D,3475822,780041377,247364,372274062,3228458,407767315,3,246099,329920197,241190,329333749,4909,586448,223023,19,250115,5462,3,705,144444.0,43333.0,-68.0,-73.0,-67.0,-71.0,-67.0,-73.0,-66.0,-70.0,-81.0,-92.0,-83.0,-90.0,13.0,19.0,16.0,19.0,1
1127,CC:2F:71:3E:C5:1F,3239995,409178618,11537,1411303,3228458,407767315,6,49183,4119707,40634,3106771,8549,1012936,12164,36,16531,189,6,852,130000.0,39000.0,-64.0,-69.0,-63.0,-60.0,-69.0,-74.0,-68.0,-61.0,-81.0,-92.0,-83.0,-90.0,17.0,23.0,20.0,30.0,1
1128,CC:2F:71:3F:1F:24,11749386,13479263712,8520928,13071496397,3228458,407767315,94,1912642,1104129595,1903980,1103088977,8662,1040618,1849123,620,8525663,899568,94,6511,130000.0,43333.0,-70.0,-64.0,-72.0,-69.0,-70.0,-64.0,-72.0,-68.0,-81.0,-92.0,-83.0,-90.0,11.0,28.0,11.0,21.0,1
1129,92:69:1D:31:68:E9,3252399,458119200,23941,50351885,3228458,407767315,0,10960,3490418,10861,3474005,99,16413,7113,1,23986,1285,0,102,229410.0,137640.0,-53.0,-50.0,-46.0,-51.0,-50.0,-49.0,-45.0,-49.0,-81.0,-92.0,-83.0,-90.0,28.0,42.0,37.0,39.0,1
1130,BA:8C:B9:54:50:24,3264823,488247515,36364,80480140,3228459,407767375,0,13150,4210684,13039,4192083,111,18601,8273,6,36393,6934,0,159,229410.0,137640.0,-55.0,-56.0,-55.0,-45.0,-53.0,-56.0,-55.0,-48.0,-81.0,-92.0,-83.0,-90.0,26.0,36.0,28.0,45.0,1
1131,62:47:05:9D:EB:15,3231653,415371837,3194,7604462,3228459,407767375,0,870,151323,832,144575,38,6748,401,0,3231,1151,0,9,216660.0,130000.0,-45.0,-38.0,-44.0,-40.0,-44.0,-39.0,-43.0,-40.0,-81.0,-92.0,-83.0,-90.0,36.0,54.0,39.0,50.0,1
1132,F8:59:71:5A:E0:3D,3475910,780173729,247449,372406152,3228461,407767577,3,246184,330051097,241275,329464649,4909,586448,223108,19,250199,5464,3,705,144444.0,43333.0,-68.0,-73.0,-66.0,-70.0,-67.0,-73.0,-66.0,-70.0,-81.0,-92.0,-83.0,-90.0,13.0,19.0,17.0,20.0,1
1133,CC:2F:71:3E:C5:1F,3239998,409178880,11537,1411303,3228461,407767577,6,49183,4119707,40634,3106771,8549,1012936,12164,36,16531,189,6,852,130000.0,39000.0,-64.0,-69.0,-63.0,-60.0,-69.0,-74.0,-68.0,-61.0,-81.0,-92.0,-83.0,-90.0,17.0,23.0,20.0,30.0,1
1134,CC:2F:71:3F:1F:24,11751217,13482075285,8522756,13074307708,3228461,407767577,94,1913088,1104437236,1904426,1103396618,8662,1040618,1849551,620,8527465,899590,94,6511,130000.0,43333.0,-70.0,-64.0,-72.0,-69.0,-69.0,-64.0,-72.0,-69.0,-81.0,-92.0,-83.0,-90.0,11.0,28.0,11.0,21.0,1
1135,92:69:1D:31:68:E9,3252436,458189851,23969,50421668,3228467,407768183,0,10966,3491210,10867,3474797,99,16413,7117,1,24014,1285,0,102,216660.0,130000.0,-53.0,-50.0,-46.0,-51.0,-50.0,-49.0,-46.0,-50.0,-81.0,-92.0,-83.0,-90.0,28.0,42.0,37.0,39.0,1
1136,BA:8C:B9:54:50:24,3264832,488248439,36365,80480256,3228467,407768183,0,13153,4210926,13042,4192325,111,18601,8274,6,36394,6934,0,159,229410.0,137640.0,-54.0,-56.0,-55.0,-45.0,-54.0,-56.0,-55.0,-45.0,-81.0,-92.0,-83.0,-90.0,27.0,36.0,28.0,45.0,1
1137,62:47:05:9D:EB:15,3231661,415372645,3194,7604462,3228467,407768183,0,870,151323,832,144575,38,6748,401,0,3231,1151,0,9,216660.0,130000.0,-45.0,-38.0,-44.0,-40.0,-44.0,-39.0,-43.0,-40.0,-81.0,-92.0,-83.0,-90.0,36.0,54.0,39.0,50.0,1
1138,F8:59:71:5A:E0:3D,3475999,780303317,247532,372535134,3228467,407768183,3,246267,330178917,241358,329592469,4909,586448,223191,19,250283,5464,3,705,144444.0,43333.0,-68.0,-73.0,-66.0,-70.0,-67.0,-72.0,-66.0,-70.0,-81.0,-92.0,-83.0,-90.0,13.0,19.0,17.0,20.0,1
1139,CC:2F:71:3E:C5:1F,3240004,409179486,11537,1411303,3228467,407768183,6,49183,4119707,40634,3106771,8549,1012936,12164,36,16531,189,6,852,130000.0,39000.0,-64.0,-69.0,-63.0,-60.0,-69.0,-74.0,-68.0,-61.0,-81.0,-92.0,-83.0,-90.0,17.0,23.0,20.0,30.0,1
1140,CC:2F:71:3F:1F:24,11752929,13484692328,8524462,13076924145,3228467,407768183,94,1913536,1104774717,1904874,1103734099,8662,1040618,1849972,620,8529197,899954,94,6513,115556.0,28889.0,-67.0,-63.0,-72.0,-68.0,-67.0,-63.0,-72.0,-68.0,-81.0,-92.0,-83.0,-90.0,14.0,29.0,11.0,22.0,1
1141,92:69:1D:31:68:E9,3252441,458190317,23969,50421668,3228472,407768649,0,10966,3491210,10867,3474797,99,16413,7117,1,24014,1285,0,102,216660.0,130000.0,-53.0,-50.0,-46.0,-51.0,-50.0,-49.0,-46.0,-50.0,-81.0,-91.0,-83.0,-89.0,28.0,41.0,37.0,38.0,1
1142,BA:8C:B9:54:50:24,3264840,488249167,36365,80480256,3228475,407768911,0,13153,4210926,13042,4192325,111,18601,8274,6,36394,6934,0,159,229410.0,137640.0,-54.0,-56.0,-55.0,-45.0,-54.0,-56.0,-55.0,-45.0,-81.0,-91.0,-83.0,-89.0,27.0,35.0,28.0,44.0,1
1143,62:47:05:9D:EB:15,3231669,415373373,3194,7604462,3228475,407768911,0,870,151323,832,144575,38,6748,401,0,3231,1151,0,9,216660.0,130000.0,-45.0,-38.0,-44.0,-40.0,-44.0,-39.0,-43.0,-40.0,-81.0,-91.0,-83.0,-89.0,36.0,53.0,39.0,49.0,1
1144,F8:59:71:5A:E0:3D,3476107,780456539,247630,372687426,3228477,407769113,3,246365,330329949,241456,329743501,4909,586448,223289,19,250381,5464,3,707,144444.0,43333.0,-67.0,-74.0,-65.0,-70.0,-66.0,-73.0,-65.0,-70.0,-81.0,-91.0,-83.0,-89.0,14.0,17.0,18.0,19.0,1
1145,CC:2F:71:3E:C5:1F,3240014,409180416,11537,1411303,3228477,407769113,6,49183,4119707,40634,3106771,8549,1012936,12164,36,16531,189,6,852,130000.0,39000.0,-64.0,-69.0,-63.0,-60.0,-69.0,-74.0,-68.0,-61.0,-81.0,-91.0,-83.0,-89.0,17.0,22.0,20.0,29.0,1
1146,CC:2F:71:3F:1F:24,11754808,13487565067,8526331,13079795954,3228477,407769113,94,1914071,1105110577,1905408,1104069841,8663,1040736,1850490,620,8531030,900369,94,6514,86667.0,14444.0,-69.0,-64.0,-72.0,-70.0,-69.0,-64.0,-72.0,-70.0,-81.0,-91.0,-83.0,-89.0,12.0,27.0,11.0,19.0,1
1147,92:69:1D:31:68:E9,3252453,458194397,23975,50425222,3228478,407769175,0,10974,3494214,10875,3477801,99,16413,7122,1,24020,1285,0,102,216660.0,130000.0,-53.0,-51.0,-46.0,-51.0,-50.0,-49.0,-45.0,-49.0,-81.0,-91.0,-83.0,-89.0,28.0,40.0,37.0,38.0,1
1148,BA:8C:B9:54:50:24,3264858,488255628,36369,80481029,3228489,407774599,0,13173,4221384,13061,4202661,112,18723,8282,6,36398,6934,0,159,216660.0,130000.0,-55.0,-55.0,-55.0,-46.0,-52.0,-55.0,-54.0,-48.0,-81.0,-91.0,-83.0,-89.0,26.0,36.0,28.0,43.0,1
1149,62:47:05:9D:EB:15,3231683,415379061,3194,7604462,3228489,407774599,0,870,151323,832,144575,38,6748,401,0,3231,1151,0,9,216660.0,130000.0,-45.0,-38.0,-44.0,-40.0,-44.0,-39.0,-43.0,-40.0,-81.0,-91.0,-83.0,-89.0,36.0,53.0,39.0,49.0,1
1150,F8:59:71:5A:E0:3D,3476211,780601975,247720,372827174,3228491,407774801,3,246455,330468591,241546,329882143,4909,586448,223379,19,250471,5467,3,707,144444.0,39000.0,-67.0,-75.0,-67.0,-71.0,-67.0,-73.0,-66.0,-70.0,-81.0,-91.0,-83.0,-89.0,14.0,16.0,16.0,18.0,1
1151,CC:2F:71:3E:C5:1F,3240039,409191528,11537,1411303,3228502,407780225,6,49183,4119707,40634,3106771,8549,1012936,12164,36,16531,189,6,852,130000.0,39000.0,-64.0,-69.0,-63.0,-60.0,-69.0,-74.0,-68.0,-61.0,-81.0,-91.0,-83.0,-89.0,17.0,22.0,20.0,29.0,1
1152,CC:2F:71:3F:1F:24,11756298,13489811739,8527794,13082031312,3228504,407780427,94,1914545,1105453533,1905882,1104412797,8663,1040736,1850942,620,8532529,900640,94,6515,104000.0,26000.0,-70.0,-64.0,-73.0,-68.0,-70.0,-64.0,-72.0,-68.0,-81.0,-91.0,-83.0,-89.0,11.0,27.0,10.0,21.0,1
1153,92:69:1D:31:68:E9,3252483,458206053,23975,50425222,3228508,407780831,0,10974,3494214,10875,3477801,99,16413,7122,1,24020,1285,0,102,216660.0,130000.0,-53.0,-51.0,-46.0,-51.0,-50.0,-49.0,-45.0,-49.0,-81.0,-91.0,-83.0,-89.0,28.0,40.0,37.0,38.0,1
1154,BA:8C:B9:54:50:24,3264878,488261920,36369,80481029,3228509,407780891,0,13173,4221384,13061,4202661,112,18723,8282,6,36398,6934,0,159,216660.0,130000.0,-55.0,-55.0,-55.0,-46.0,-52.0,-55.0,-54.0,-48.0,-81.0,-91.0,-83.0,-89.0,26.0,36.0,28.0,43.0,1
1155,62:47:05:9D:EB:15,3231703,415385353,3194,7604462,3228509,407780891,0,870,151323,832,144575,38,6748,401,0,3231,1151,0,9,216660.0,130000.0,-45.0,-38.0,-44.0,-40.0,-44.0,-39.0,-43.0,-40.0,-81.0,-91.0,-83.0,-89.0,36.0,53.0,39.0,49.0,1
1156,F8:59:71:5A:E0:3D,3476318,780746315,247809,372965424,3228509,407780891,3,246545,330607205,241636,330020757,4909,586448,223468,19,250560,5468,3,707,144444.0,43333.0,-67.0,-73.0,-66.0,-70.0,-67.0,-72.0,-65.0,-69.0,-81.0,-91.0,-83.0,-89.0,14.0,18.0,17.0,19.0,1
1157,CC:2F:71:3E:C5:1F,3240046,409192194,11537,1411303,3228509,407780891,6,49185,4119847,40636,3106911,8549,1012936,12164,36,16532,189,6,852,130000.0,39000.0,-68.0,-72.0,-68.0,-60.0,-68.0,-74.0,-68.0,-61.0,-81.0,-91.0,-83.0,-89.0,13.0,19.0,15.0,29.0,1
1158,CC:2F:71:3F:1F:24,11757289,13491287299,8528780,13083506408,3228509,407780891,94,1914877,1105763111,1906214,1104722375,8663,1040736,1851248,620,8533495,900666,94,6515,115556.0,28889.0,-70.0,-65.0,-71.0,-68.0,-70.0,-65.0,-71.0,-68.0,-81.0,-91.0,-83.0,-89.0,11.0,26.0,12.0,21.0,1
1159,92:69:1D:31:68:E9,3252645,458617632,24131,50836064,3228514,407781568,0,11000,3499895,10901,3483482,99,16413,7135,1,24176,1285,0,102,216660.0,130000.0,-52.0,-51.0,-45.0,-51.0,-49.0,-50.0,-45.0,-48.0,-81.0,-91.0,-83.0,-89.0,29.0,40.0,38.0,38.0,1
1160,BA:8C:B9:54:50:24,3264886,488263034,36370,80481264,3228516,407781770,0,13179,4225038,13067,4206315,112,18723,8284,6,36398,6934,0,159,216660.0,130000.0,-52.0,-56.0,-54.0,-51.0,-52.0,-56.0,-53.0,-48.0,-81.0,-91.0,-83.0,-89.0,29.0,35.0,29.0,38.0,1
1161,62:47:05:9D:EB:15,3231710,415386232,3194,7604462,3228516,407781770,0,872,151459,834,144711,38,6748,401,0,3232,1151,0,9,216660.0,130000.0,-45.0,-38.0,-44.0,-40.0,-44.0,-39.0,-43.0,-40.0,-81.0,-91.0,-83.0,-89.0,36.0,53.0,39.0,49.0,1
1162,F8:59:71:5A:E0:3D,3476420,780894824,247904,373113054,3228516,407781770,3,246641,330755059,241732,330168611,4909,586448,223563,19,250655,5469,3,707,144444.0,43333.0,-67.0,-72.0,-65.0,-71.0,-67.0,-72.0,-65.0,-71.0,-81.0,-91.0,-83.0,-89.0,14.0,19.0,18.0,18.0,1
1163,CC:2F:71:3E:C5:1F,3240053,409193073,11537,1411303,3228516,407781770,6,49185,4119847,40636,3106911,8549,1012936,12164,36,16532,189,6,852,130000.0,39000.0,-68.0,-72.0,-68.0,-60.0,-68.0,-74.0,-68.0,-61.0,-81.0,-91.0,-83.0,-89.0,13.0,19.0,15.0,29.0,1
1164,CC:2F:71:3F:1F:24,11758415,13492978790,8529897,13085196818,3228518,407781972,94,1915253,1106072379,1906590,1105031643,8663,1040736,1851618,620,8534631,900827,94,6515,65000.0,13000.0,-69.0,-64.0,-70.0,-69.0,-69.0,-64.0,-70.0,-68.0,-81.0,-91.0,-83.0,-89.0,12.0,27.0,13.0,20.0,1
1165,92:69:1D:31:68:E9,3252649,458618036,24131,50836064,3228518,407781972,0,11000,3499895,10901,3483482,99,16413,7135,1,24176,1285,0,102,216660.0,130000.0,-52.0,-51.0,-45.0,-51.0,-49.0,-50.0,-45.0,-48.0,-81.0,-91.0,-83.0,-89.0,29.0,40.0,38.0,38.0,1
1166,BA:8C:B9:54:50:24,3265196,489080768,36677,81298736,3228519,407782032,0,13201,4227743,13089,4209020,112,18723,8303,6,36706,6975,0,159,229410.0,130000.0,-48.0,-54.0,-51.0,-64.0,-51.0,-56.0,-53.0,-52.0,-81.0,-91.0,-83.0,-89.0,33.0,37.0,32.0,25.0,1
1167,62:47:05:9D:EB:15,3231713,415386494,3194,7604462,3228519,407782032,0,872,151459,834,144711,38,6748,401,0,3232,1151,0,9,216660.0,130000.0,-45.0,-38.0,-44.0,-40.0,-44.0,-39.0,-43.0,-40.0,-81.0,-91.0,-83.0,-89.0,36.0,53.0,39.0,49.0,1
1168,F8:59:71:5A:E0:3D,3476516,781036702,247995,373254468,3228521,407782234,3,246732,330895199,241823,330308751,4909,586448,223654,19,250746,5471,3,707,144444.0,43333.0,-67.0,-72.0,-66.0,-70.0,-66.0,-72.0,-66.0,-70.0,-81.0,-91.0,-83.0,-89.0,14.0,19.0,17.0,19.0,1
1169,CC:2F:71:3E:C5:1F,3240058,409193537,11537,1411303,3228521,407782234,6,49185,4119847,40636,3106911,8549,1012936,12164,36,16532,189,6,852,130000.0,39000.0,-68.0,-72.0,-68.0,-60.0,-68.0,-74.0,-68.0,-61.0,-81.0,-91.0,-83.0,-89.0,13.0,19.0,15.0,29.0,1
1170,CC:2F:71:3F:1F:24,11759838,13495148100,8531317,13087365866,3228521,407782234,94,1915692,1106378141,1907029,1105337405,8663,1040736,1852056,620,8536052,900861,94,6515,86667.0,14444.0,-70.0,-63.0,-72.0,-69.0,-70.0,-63.0,-72.0,-69.0,-81.0,-91.0,-83.0,-89.0,11.0,28.0,11.0,20.0,1
1171,92:69:1D:31:68:E9,3252661,458619139,24131,50836064,3228530,407783075,0,11003,3500153,10903,3483618,100,16535,7136,1,24176,1285,0,102,216660.0,130000.0,-52.0,-50.0,-45.0,-50.0,-50.0,-50.0,-45.0,-49.0,-81.0,-91.0,-83.0,-89.0,29.0,41.0,38.0,39.0,1
1172,BA:8C:B9:54:50:24,3265573,490051034,37043,82267959,3228530,407783075,0,13239,4235765,13126,4216871,113,18894,8336,6,37072,7127,0,159,229410.0,137640.0,-49.0,-52.0,-50.0,-47.0,-51.0,-55.0,-52.0,-50.0,-81.0,-91.0,-83.0,-89.0,32.0,39.0,33.0,42.0,1
1173,62:47:05:9D:EB:15,3231725,415387648,3194,7604462,3228531,407783186,0,872,151459,834,144711,38,6748,401,0,3232,1151,0,9,216660.0,130000.0,-45.0,-38.0,-44.0,-40.0,-44.0,-39.0,-43.0,-40.0,-81.0,-91.0,-83.0,-89.0,36.0,53.0,39.0,49.0,1
1174,F8:59:71:5A:E0:3D,3476612,781171298,248081,373388112,3228531,407783186,3,246820,331029297,241910,330442731,4910,586566,223742,19,250832,5471,3,707,144444.0,43333.0,-67.0,-71.0,-66.0,-71.0,-67.0,-71.0,-66.0,-71.0,-81.0,-91.0,-83.0,-89.0,14.0,20.0,17.0,18.0,1
1175,CC:2F:71:3E:C5:1F,3240068,409194489,11537,1411303,3228531,407783186,6,49185,4119847,40636,3106911,8549,1012936,12164,36,16532,189,6,852,130000.0,39000.0,-68.0,-72.0,-68.0,-60.0,-68.0,-74.0,-68.0,-61.0,-81.0,-91.0,-83.0,-89.0,13.0,19.0,15.0,29.0,1
1176,CC:2F:71:3F:1F:24,11761221,13497233708,8532689,13089450460,3228532,407783248,94,1916079,1106673947,1907416,1105633211,8663,1040736,1852441,620,8537424,900914,94,6517,130000.0,43333.0,-71.0,-64.0,-72.0,-69.0,-70.0,-63.0,-71.0,-68.0,-81.0,-91.0,-83.0,-89.0,10.0,27.0,11.0,20.0,1
1177,92:69:1D:31:68:E9,3252677,458623566,24141,50839914,3228536,407783652,0,11030,3508820,10929,3492114,101,16706,7148,1,24186,1285,0,102,229410.0,130000.0,-52.0,-51.0,-46.0,-51.0,-49.0,-50.0,-46.0,-50.0,-81.0,-91.0,-83.0,-89.0,29.0,40.0,37.0,38.0,1
1178,BA:8C:B9:54:50:24,3265583,490052192,37046,82268480,3228537,407783712,0,13250,4238980,13137,4220086,113,18894,8337,6,37075,7127,0,159,229410.0,137640.0,-49.0,-52.0,-51.0,-46.0,-50.0,-53.0,-51.0,-47.0,-81.0,-91.0,-83.0,-89.0,32.0,39.0,32.0,43.0,1
1179,62:47:05:9D:EB:15,3231733,415388376,3194,7604462,3228539,407783914,0,872,151459,834,144711,38,6748,401,0,3232,1151,0,9,216660.0,130000.0,-45.0,-38.0,-44.0,-40.0,-44.0,-39.0,-43.0,-40.0,-81.0,-91.0,-83.0,-89.0,36.0,53.0,39.0,49.0,1
1180,F8:59:71:5A:E0:3D,3476713,781316548,248174,373532634,3228539,407783914,3,246914,331174183,242004,330587617,4910,586566,223835,19,250925,5473,3,708,144444.0,43333.0,-66.0,-73.0,-66.0,-71.0,-66.0,-72.0,-66.0,-71.0,-81.0,-91.0,-83.0,-89.0,15.0,18.0,17.0,18.0,1
1181,CC:2F:71:3E:C5:1F,3240076,409195217,11537,1411303,3228539,407783914,6,49187,4120035,40637,3106981,8550,1013054,12165,36,16532,189,6,852,130000.0,39000.0,-68.0,-72.0,-69.0,-61.0,-68.0,-73.0,-68.0,-61.0,-81.0,-91.0,-83.0,-89.0,13.0,19.0,14.0,28.0,1
1182,CC:2F:71:3F:1F:24,11762730,13499535170,8534191,13091751256,3228539,407783914,94,1916453,1106991897,1907790,1105951161,8663,1040736,1852815,620,8538926,901081,94,6520,130000.0,43333.0,-70.0,-63.0,-71.0,-69.0,-69.0,-63.0,-71.0,-69.0,-81.0,-91.0,-83.0,-89.0,11.0,28.0,12.0,20.0,1
1183,92:69:1D:31:68:E9,3252682,458624030,24141,50839914,3228541,407784116,0,11030,3508820,10929,3492114,101,16706,7148,1,24186,1285,0,102,229410.0,130000.0,-52.0,-51.0,-46.0,-51.0,-49.0,-50.0,-46.0,-50.0,-81.0,-91.0,-83.0,-89.0,29.0,40.0,37.0,38.0,1
1184,BA:8C:B9:54:50:24,3265590,490053122,37049,82269006,3228541,407784116,0,13258,4241107,13145,4222213,113,18894,8343,6,37078,7127,0,159,229410.0,137640.0,-48.0,-55.0,-51.0,-62.0,-49.0,-53.0,-51.0,-49.0,-81.0,-91.0,-83.0,-89.0,33.0,36.0,32.0,27.0,1
1185,62:47:05:9D:EB:15,3231735,415388578,3194,7604462,3228541,407784116,0,872,151459,834,144711,38,6748,401,0,3232,1151,0,9,216660.0,130000.0,-45.0,-38.0,-44.0,-40.0,-44.0,-39.0,-43.0,-40.0,-81.0,-91.0,-83.0,-89.0,36.0,53.0,39.0,49.0,1
1186,F8:59:71:5A:E0:3D,3476799,781447286,248258,373663170,3228541,407784116,3,246995,331298923,242085,330712357,4910,586566,223916,19,251009,5473,3,708,144444.0,43333.0,-67.0,-72.0,-66.0,-71.0,-67.0,-72.0,-66.0,-71.0,-81.0,-91.0,-83.0,-89.0,14.0,19.0,17.0,18.0,1
1187,CC:2F:71:3E:C5:1F,3240078,409195419,11537,1411303,3228541,407784116,6,49187,4120035,40637,3106981,8550,1013054,12165,36,16532,189,6,852,130000.0,39000.0,-68.0,-72.0,-69.0,-61.0,-68.0,-73.0,-68.0,-61.0,-81.0,-91.0,-83.0,-89.0,13.0,19.0,14.0,28.0,1
1188,CC:2F:71:3F:1F:24,11763930,13501353758,8535387,13093569440,3228543,407784318,94,1916789,1107266387,1908126,1106225651,8663,1040736,1853151,620,8540122,901244,94,6520,117000.0,39000.0,-69.0,-63.0,-71.0,-68.0,-69.0,-63.0,-72.0,-68.0,-81.0,-91.0,-83.0,-89.0,12.0,28.0,12.0,21.0,1
1189,92:69:1D:31:68:E9,3252688,458624636,24141,50839914,3228547,407784722,0,11030,3508820,10929,3492114,101,16706,7148,1,24186,1285,0,102,229410.0,130000.0,-52.0,-51.0,-46.0,-51.0,-49.0,-50.0,-46.0,-50.0,-81.0,-91.0,-83.0,-89.0,29.0,40.0,37.0,38.0,1
1190,BA:8C:B9:54:50:24,3265596,490053728,37049,82269006,3228547,407784722,0,13258,4241107,13145,4222213,113,18894,8343,6,37078,7127,0,159,229410.0,137640.0,-48.0,-55.0,-51.0,-62.0,-49.0,-53.0,-51.0,-49.0,-81.0,-91.0,-83.0,-89.0,33.0,36.0,32.0,27.0,1
1191,62:47:05:9D:EB:15,3231741,415389184,3194,7604462,3228547,407784722,0,872,151459,834,144711,38,6748,401,0,3232,1151,0,9,216660.0,130000.0,-45.0,-38.0,-44.0,-40.0,-44.0,-39.0,-43.0,-40.0,-81.0,-91.0,-83.0,-89.0,36.0,53.0,39.0,49.0,1
1192,F8:59:71:5A:E0:3D,3476893,781580244,248343,373795260,3228550,407784984,3,247082,331432903,242172,330846337,4910,586566,224003,19,251094,5474,3,708,144444.0,43333.0,-67.0,-72.0,-65.0,-70.0,-67.0,-72.0,-65.0,-70.0,-81.0,-91.0,-83.0,-89.0,14.0,19.0,18.0,19.0,1
1193,CC:2F:71:3E:C5:1F,3240087,409196287,11537,1411303,3228550,407784984,6,49187,4120035,40637,3106981,8550,1013054,12165,36,16532,189,6,852,130000.0,39000.0,-68.0,-72.0,-69.0,-61.0,-68.0,-73.0,-68.0,-61.0,-81.0,-91.0,-83.0,-89.0,13.0,19.0,14.0,28.0,1
1194,CC:2F:71:3F:1F:24,11765160,13503194313,8536610,13095409329,3228550,407784984,94,1917183,1107580672,1908520,1106539936,8663,1040736,1853543,620,8541345,901441,94,6522,86667.0,14444.0,-68.0,-64.0,-72.0,-66.0,-67.0,-63.0,-71.0,-66.0,-81.0,-91.0,-83.0,-89.0,13.0,27.0,11.0,23.0,1
1195,92:69:1D:31:68:E9,3252695,458625302,24141,50839914,3228554,407785388,0,11030,3508820,10929,3492114,101,16706,7148,1,24186,1285,0,102,229410.0,130000.0,-52.0,-51.0,-46.0,-51.0,-49.0,-50.0,-46.0,-50.0,-81.0,-91.0,-83.0,-89.0,29.0,40.0,37.0,38.0,1
1196,BA:8C:B9:54:50:24,3265603,490054394,37049,82269006,3228554,407785388,0,13258,4241107,13145,4222213,113,18894,8343,6,37078,7127,0,159,229410.0,137640.0,-48.0,-55.0,-51.0,-62.0,-49.0,-53.0,-51.0,-49.0,-81.0,-91.0,-83.0,-89.0,33.0,36.0,32.0,27.0,1
1197,62:47:05:9D:EB:15,3231748,415389850,3194,7604462,3228554,407785388,0,872,151459,834,144711,38,6748,401,0,3232,1151,0,9,216660.0,130000.0,-45.0,-38.0,-44.0,-40.0,-44.0,-39.0,-43.0,-40.0,-81.0,-91.0,-83.0,-89.0,36.0,53.0,39.0,49.0,1
1198,F8:59:71:5A:E0:3D,3476992,781728278,248438,373942890,3228554,407785388,3,247177,331579203,242267,330992637,4910,586566,224098,19,251189,5478,3,708,144444.0,43333.0,-67.0,-73.0,-65.0,-69.0,-67.0,-73.0,-65.0,-69.0,-81.0,-91.0,-83.0,-89.0,14.0,18.0,18.0,20.0,1
1199,CC:2F:71:3E:C5:1F,3240093,409196893,11537,1411303,3228556,407785590,6,49187,4120035,40637,3106981,8550,1013054,12165,36,16532,189,6,852,130000.0,39000.0,-68.0,-72.0,-69.0,-61.0,-68.0,-73.0,-68.0,-61.0,-81.0,-91.0,-83.0,-89.0,13.0,19.0,14.0,28.0,1
1200,CC:2F:71:3F:1F:24,11766178,13504720671,8537622,13096935081,3228556,407785590,94,1917540,1107870468,1908877,1106829732,8663,1040736,1853900,620,8542357,901443,94,6522,86667.0,14444.0,-69.0,-63.0,-71.0,-68.0,-69.0,-63.0,-71.0,-68.0,-81.0,-91.0,-83.0,-89.0,12.0,28.0,12.0,21.0,1
1201,92:69:1D:31:68:E9,3252699,458625706,24141,50839914,3228558,407785792,0,11030,3508820,10929,3492114,101,16706,7148,1,24186,1285,0,102,229410.0,130000.0,-52.0,-51.0,-46.0,-51.0,-49.0,-50.0,-46.0,-50.0,-81.0,-91.0,-83.0,-89.0,29.0,40.0,37.0,38.0,1
1202,BA:8C:B9:54:50:24,3265607,490054798,37049,82269006,3228558,407785792,0,13258,4241107,13145,4222213,113,18894,8343,6,37078,7127,0,159,229410.0,137640.0,-48.0,-55.0,-51.0,-62.0,-49.0,-53.0,-51.0,-49.0,-81.0,-91.0,-83.0,-89.0,33.0,36.0,32.0,27.0,1
1203,62:47:05:9D:EB:15,3231752,415390254,3194,7604462,3228558,407785792,0,872,151459,834,144711,38,6748,401,0,3232,1151,0,9,216660.0,130000.0,-45.0,-38.0,-44.0,-40.0,-44.0,-39.0,-43.0,-40.0,-81.0,-91.0,-83.0,-89.0,36.0,53.0,39.0,49.0,1
1204,F8:59:71:5A:E0:3D,3477086,781867048,248527,374081196,3228559,407785852,3,247267,331717817,242357,331131251,4910,586566,224187,19,251277,5482,3,708,144444.0,43333.0,-66.0,-73.0,-66.0,-70.0,-66.0,-73.0,-66.0,-69.0,-81.0,-91.0,-83.0,-89.0,15.0,18.0,17.0,19.0,1
1205,CC:2F:71:3E:C5:1F,3240096,409197155,11537,1411303,3228559,407785852,6,49187,4120035,40637,3106981,8550,1013054,12165,36,16532,189,6,852,130000.0,39000.0,-68.0,-72.0,-69.0,-61.0,-68.0,-73.0,-68.0,-61.0,-81.0,-91.0,-83.0,-89.0,13.0,19.0,14.0,28.0,1
1206,CC:2F:71:3F:1F:24,11767571,13506823235,8539012,13099037383,3228559,407785852,94,1917989,1108192466,1909326,1107151730,8663,1040736,1854349,620,8543747,901493,94,6522,86667.0,14444.0,-70.0,-64.0,-69.0,-69.0,-70.0,-64.0,-69.0,-69.0,-81.0,-91.0,-83.0,-89.0,11.0,27.0,14.0,20.0,1
1207,92:69:1D:31:68:E9,3252706,458626372,24141,50839914,3228565,407786458,0,11030,3508820,10929,3492114,101,16706,7148,1,24186,1285,0,102,229410.0,130000.0,-52.0,-51.0,-46.0,-51.0,-49.0,-50.0,-46.0,-50.0,-81.0,-91.0,-83.0,-89.0,29.0,40.0,37.0,38.0,1
1208,BA:8C:B9:54:50:24,3265614,490055464,37049,82269006,3228565,407786458,0,13258,4241107,13145,4222213,113,18894,8343,6,37078,7127,0,159,229410.0,137640.0,-48.0,-55.0,-51.0,-62.0,-49.0,-53.0,-51.0,-49.0,-81.0,-91.0,-83.0,-89.0,33.0,36.0,32.0,27.0,1
1209,62:47:05:9D:EB:15,3231759,415390920,3194,7604462,3228565,407786458,0,872,151459,834,144711,38,6748,401,0,3232,1151,0,9,216660.0,130000.0,-45.0,-38.0,-44.0,-40.0,-44.0,-39.0,-43.0,-40.0,-81.0,-91.0,-83.0,-89.0,36.0,53.0,39.0,49.0,1
1210,F8:59:71:5A:E0:3D,3477182,782007514,248617,374221056,3228565,407786458,3,247359,331859623,242449,331273057,4910,586566,224277,19,251367,5482,3,708,144444.0,43333.0,-67.0,-75.0,-66.0,-71.0,-65.0,-74.0,-65.0,-70.0,-81.0,-91.0,-83.0,-89.0,14.0,16.0,17.0,18.0,1
1211,CC:2F:71:3E:C5:1F,3240104,409197963,11537,1411303,3228567,407786660,6,49187,4120035,40637,3106981,8550,1013054,12165,36,16532,189,6,852,130000.0,39000.0,-68.0,-72.0,-69.0,-61.0,-68.0,-73.0,-68.0,-61.0,-81.0,-91.0,-83.0,-89.0,13.0,19.0,14.0,28.0,1
1212,CC:2F:71:3F:1F:24,11769101,13509122304,8540534,13101335644,3228567,407786660,94,1918422,1108507036,1909759,1107466300,8663,1040736,1854782,620,8545269,901995,94,6522,86667.0,14444.0,-66.0,-65.0,-70.0,-69.0,-67.0,-65.0,-70.0,-68.0,-81.0,-91.0,-83.0,-89.0,15.0,26.0,13.0,20.0,1
1213,92:69:1D:31:68:E9,3252710,458626776,24141,50839914,3228569,407786862,0,11030,3508820,10929,3492114,101,16706,7148,1,24186,1285,0,102,229410.0,130000.0,-52.0,-51.0,-46.0,-51.0,-49.0,-50.0,-46.0,-50.0,-81.0,-91.0,-83.0,-89.0,29.0,40.0,37.0,38.0,1
1214,BA:8C:B9:54:50:24,3265620,490056070,37049,82269006,3228571,407787064,0,13258,4241107,13145,4222213,113,18894,8343,6,37078,7127,0,159,229410.0,137640.0,-48.0,-55.0,-51.0,-62.0,-49.0,-53.0,-51.0,-49.0,-81.0,-91.0,-83.0,-89.0,33.0,36.0,32.0,27.0,1
1215,62:47:05:9D:EB:15,3231765,415391526,3194,7604462,3228571,407787064,0,872,151459,834,144711,38,6748,401,0,3232,1151,0,9,216660.0,130000.0,-45.0,-38.0,-44.0,-40.0,-44.0,-39.0,-43.0,-40.0,-81.0,-91.0,-83.0,-89.0,36.0,53.0,39.0,49.0,1
1216,F8:59:71:5A:E0:3D,3477275,782141824,248703,374354700,3228572,407787124,3,247447,331995199,242537,331408633,4910,586566,224364,19,251454,5492,3,708,144444.0,43333.0,-67.0,-75.0,-66.0,-70.0,-64.0,-74.0,-68.0,-71.0,-81.0,-91.0,-83.0,-89.0,14.0,16.0,17.0,19.0,1
1217,CC:2F:71:3E:C5:1F,3240109,409198427,11537,1411303,3228572,407787124,6,49187,4120035,40637,3106981,8550,1013054,12165,36,16532,189,6,852,130000.0,39000.0,-68.0,-72.0,-69.0,-61.0,-68.0,-73.0,-68.0,-61.0,-81.0,-91.0,-83.0,-89.0,13.0,19.0,14.0,28.0,1
1218,CC:2F:71:3F:1F:24,11770499,13511246558,8541927,13103459434,3228572,407787124,94,1918886,1108810894,1910223,1107770158,8663,1040736,1855246,620,8546662,902010,94,6522,65000.0,14444.0,-67.0,-64.0,-72.0,-66.0,-67.0,-64.0,-71.0,-66.0,-81.0,-91.0,-83.0,-89.0,14.0,27.0,11.0,23.0,1
1219,92:69:1D:31:68:E9,3252889,459040728,24298,51251480,3228591,407789248,0,11058,3514862,10956,3497921,102,16941,7167,1,24343,1285,0,102,229410.0,137640.0,-54.0,-51.0,-46.0,-51.0,-51.0,-49.0,-46.0,-49.0,-81.0,-90.0,-82.0,-87.0,27.0,39.0,36.0,36.0,1
1220,BA:8C:B9:54:50:24,3265993,490984925,37400,83195475,3228593,407789450,0,13309,4250884,13196,4231990,113,18894,8381,6,37429,7159,0,160,229410.0,137640.0,-48.0,-52.0,-51.0,-47.0,-49.0,-51.0,-52.0,-48.0,-81.0,-90.0,-82.0,-87.0,33.0,38.0,31.0,40.0,1
1221,62:47:05:9D:EB:15,3231788,415394028,3195,7604578,3228593,407789450,0,873,151527,835,144779,38,6748,401,0,3233,1151,0,9,216660.0,130000.0,-52.0,-42.0,-50.0,-44.0,-45.0,-40.0,-44.0,-40.0,-81.0,-90.0,-82.0,-87.0,29.0,48.0,32.0,43.0,1
1222,F8:59:71:5A:E0:3D,3477604,782617000,249009,374827348,3228595,407789652,3,247781,332504625,242871,331918059,4910,586566,224673,19,251759,5648,3,715,144444.0,43333.0,-66.0,-72.0,-65.0,-65.0,-65.0,-71.0,-64.0,-68.0,-81.0,-90.0,-82.0,-87.0,15.0,18.0,17.0,22.0,1
1223,CC:2F:71:3E:C5:1F,3240133,409201071,11538,1411419,3228595,407789652,6,49189,4120175,40639,3107121,8550,1013054,12165,36,16533,189,6,852,130000.0,39000.0,-69.0,-70.0,-67.0,-59.0,-68.0,-73.0,-68.0,-61.0,-81.0,-90.0,-82.0,-87.0,12.0,20.0,15.0,28.0,1
1224,CC:2F:71:3F:1F:24,11772806,13514754922,8544211,13106965270,3228595,407789652,94,1919893,1109883457,1911230,1108842721,8663,1040736,1856188,621,8548948,902726,94,6539,104000.0,26000.0,-68.0,-64.0,-72.0,-66.0,-68.0,-64.0,-72.0,-66.0,-80.0,-89.0,-81.0,-87.0,12.0,25.0,9.0,21.0,1
1225,92:69:1D:31:68:E9,3252900,459041691,24298,51251480,3228602,407790211,0,11062,3515188,10959,3498125,103,17063,7168,1,24343,1285,0,103,229410.0,137640.0,-53.0,-52.0,-46.0,-50.0,-52.0,-50.0,-45.0,-49.0,-80.0,-89.0,-81.0,-87.0,27.0,37.0,35.0,37.0,1
1226,BA:8C:B9:54:50:24,3266007,490986506,37403,83196093,3228604,407790413,0,13325,4254612,13211,4235596,114,19016,8385,6,37432,7159,0,160,229410.0,137640.0,-55.0,-55.0,-55.0,-46.0,-51.0,-53.0,-53.0,-48.0,-80.0,-89.0,-81.0,-87.0,25.0,34.0,26.0,41.0,1
1227,62:47:05:9D:EB:15,3231800,415395053,3195,7604578,3228605,407790475,0,878,152078,837,144915,41,7163,404,0,3233,1151,0,10,216660.0,130000.0,-41.0,-48.0,-45.0,-39.0,-45.0,-43.0,-47.0,-41.0,-80.0,-89.0,-81.0,-87.0,39.0,41.0,36.0,48.0,1
1228,F8:59:71:5A:E0:3D,3477708,782763899,249103,374973424,3228605,407790475,3,247874,332647845,242964,332061279,4910,586566,224766,19,251854,5650,3,715,144444.0,43333.0,-66.0,-73.0,-64.0,-70.0,-65.0,-72.0,-64.0,-70.0,-80.0,-89.0,-81.0,-87.0,14.0,16.0,17.0,17.0,1
1229,CC:2F:71:3E:C5:1F,3240143,409201894,11538,1411419,3228605,407790475,6,49189,4120175,40639,3107121,8550,1013054,12165,36,16533,189,6,852,130000.0,39000.0,-69.0,-70.0,-67.0,-59.0,-68.0,-73.0,-68.0,-61.0,-80.0,-89.0,-81.0,-87.0,11.0,19.0,14.0,28.0,1
1230,CC:2F:71:3F:1F:24,11774099,13516708527,8545494,13108918052,3228605,407790475,94,1920312,1110192127,1911649,1109151391,8663,1040736,1856606,621,8550230,902997,94,6540,104000.0,26000.0,-68.0,-63.0,-70.0,-66.0,-67.0,-63.0,-70.0,-66.0,-80.0,-89.0,-81.0,-87.0,12.0,26.0,11.0,21.0,1
1231,92:69:1D:31:68:E9,3252909,459042808,24298,51251480,3228611,407791328,0,11062,3515188,10959,3498125,103,17063,7168,1,24343,1285,0,103,229410.0,137640.0,-53.0,-52.0,-46.0,-50.0,-52.0,-50.0,-45.0,-49.0,-80.0,-89.0,-81.0,-86.0,27.0,37.0,35.0,36.0,1
1232,BA:8C:B9:54:50:24,3266015,490987532,37403,83196093,3228612,407791439,0,13325,4254612,13211,4235596,114,19016,8385,6,37432,7159,0,160,229410.0,137640.0,-55.0,-55.0,-55.0,-46.0,-51.0,-53.0,-53.0,-48.0,-80.0,-89.0,-81.0,-86.0,25.0,34.0,26.0,40.0,1
1233,62:47:05:9D:EB:15,3231868,415429275,3256,7637836,3228612,407791439,0,986,198895,944,191561,42,7334,483,0,3294,1151,0,10,229410.0,137640.0,-35.0,-37.0,-41.0,-38.0,-39.0,-42.0,-41.0,-38.0,-80.0,-89.0,-81.0,-86.0,45.0,52.0,40.0,48.0,1
1234,F8:59:71:5A:E0:3D,3477798,782893677,249186,375102238,3228612,407791439,3,247957,332775665,243047,332189099,4910,586566,224849,19,251937,5651,3,715,144444.0,43333.0,-66.0,-72.0,-64.0,-69.0,-66.0,-71.0,-63.0,-69.0,-80.0,-89.0,-81.0,-86.0,14.0,17.0,17.0,17.0,1
1235,CC:2F:71:3E:C5:1F,3240150,409202858,11538,1411419,3228612,407791439,6,49189,4120175,40639,3107121,8550,1013054,12165,36,16533,189,6,852,130000.0,39000.0,-69.0,-70.0,-67.0,-59.0,-68.0,-73.0,-68.0,-61.0,-80.0,-89.0,-81.0,-86.0,11.0,19.0,14.0,27.0,1
1236,CC:2F:71:3F:1F:24,11775742,13519222123,8547130,13111430684,3228612,407791439,94,1920749,1110481359,1912086,1109440623,8663,1040736,1857043,621,8551867,903266,94,6541,115556.0,28889.0,-69.0,-63.0,-72.0,-67.0,-69.0,-63.0,-71.0,-67.0,-80.0,-89.0,-81.0,-86.0,11.0,26.0,9.0,19.0,1
1237,92:69:1D:31:68:E9,3252919,459044028,24298,51251480,3228621,407792548,0,11062,3515188,10959,3498125,103,17063,7168,1,24343,1285,0,103,229410.0,137640.0,-53.0,-52.0,-46.0,-50.0,-52.0,-50.0,-45.0,-49.0,-80.0,-89.0,-81.0,-86.0,27.0,37.0,35.0,36.0,1
1238,BA:8C:B9:54:50:24,3266026,490988820,37403,83196093,3228623,407792727,0,13326,4254680,13212,4235664,114,19016,8385,6,37432,7159,0,160,229410.0,137640.0,-54.0,-55.0,-54.0,-46.0,-51.0,-53.0,-53.0,-48.0,-80.0,-89.0,-81.0,-86.0,26.0,34.0,27.0,40.0,1
1239,62:47:05:9D:EB:15,3231905,415441295,3282,7648568,3228623,407792727,0,1027,217885,984,210380,43,7505,518,0,3320,1153,0,10,229410.0,137640.0,-38.0,-39.0,-41.0,-33.0,-40.0,-42.0,-43.0,-36.0,-80.0,-89.0,-81.0,-86.0,42.0,50.0,40.0,53.0,1
1240,F8:59:71:5A:E0:3D,3477907,783045837,249283,375252976,3228624,407792861,3,248047,332913067,243136,332326383,4911,586684,224939,19,252033,5658,3,715,144444.0,43333.0,-67.0,-72.0,-64.0,-70.0,-66.0,-72.0,-64.0,-69.0,-80.0,-89.0,-81.0,-86.0,13.0,17.0,17.0,16.0,1
1241,CC:2F:71:3E:C5:1F,3240163,409204348,11538,1411419,3228625,407792929,6,49189,4120175,40639,3107121,8550,1013054,12165,36,16533,189,6,852,130000.0,39000.0,-69.0,-70.0,-67.0,-59.0,-68.0,-73.0,-68.0,-61.0,-80.0,-89.0,-81.0,-86.0,11.0,19.0,14.0,27.0,1
1242,CC:2F:71:3F:1F:24,11777086,13521245322,8548461,13113452393,3228625,407792929,94,1921146,1110832788,1912483,1109792052,8663,1040736,1857440,621,8553173,903713,94,6542,104000.0,26000.0,-68.0,-64.0,-72.0,-68.0,-68.0,-64.0,-71.0,-67.0,-80.0,-89.0,-81.0,-86.0,12.0,25.0,9.0,18.0,1
1243,92:69:1D:31:68:E9,3253058,459355228,24420,51560533,3228638,407794695,0,11093,3523699,10990,3506636,103,17063,7189,1,24465,1317,0,103,229410.0,137640.0,-53.0,-51.0,-46.0,-51.0,-50.0,-51.0,-46.0,-49.0,-80.0,-89.0,-81.0,-86.0,27.0,38.0,35.0,35.0,1
1244,BA:8C:B9:54:50:24,3266046,490991763,37408,83197068,3228638,407794695,0,13342,4260741,13228,4241725,114,19016,8392,6,37437,7164,0,161,229410.0,137640.0,-55.0,-56.0,-55.0,-46.0,-51.0,-53.0,-52.0,-49.0,-80.0,-89.0,-81.0,-86.0,25.0,33.0,26.0,40.0,1
1245,62:47:05:9D:EB:15,3232082,415730475,3444,7935780,3228638,407794695,0,1165,270874,1122,263369,43,7505,605,0,3482,1161,0,23,229410.0,137640.0,-44.0,-47.0,-45.0,-43.0,-42.0,-45.0,-43.0,-41.0,-80.0,-89.0,-81.0,-86.0,36.0,42.0,36.0,43.0,1
1246,F8:59:71:5A:E0:3D,3478122,783357007,249482,375562110,3228640,407794897,3,248233,333200963,243322,332614279,4911,586684,225125,19,252233,5849,3,721,144444.0,43333.0,-67.0,-72.0,-64.0,-69.0,-66.0,-71.0,-64.0,-69.0,-80.0,-89.0,-81.0,-87.0,13.0,17.0,17.0,18.0,1
1247,CC:2F:71:3E:C5:1F,3240178,409206316,11538,1411419,3228640,407794897,6,49189,4120175,40639,3107121,8550,1013054,12165,36,16533,189,6,852,130000.0,39000.0,-69.0,-70.0,-67.0,-59.0,-68.0,-73.0,-68.0,-61.0,-80.0,-89.0,-81.0,-87.0,11.0,19.0,14.0,28.0,1
1248,CC:2F:71:3F:1F:24,11778243,13522950897,8549601,13115155798,3228642,407795099,94,1921740,1111505811,1913077,1110465075,8663,1040736,1858023,621,8554311,904493,94,6556,115556.0,28889.0,-68.0,-64.0,-72.0,-67.0,-67.0,-63.0,-71.0,-67.0,-80.0,-89.0,-81.0,-87.0,12.0,25.0,9.0,20.0,1
1249,92:69:1D:31:68:E9,3253096,459359277,24421,51560649,3228675,407798628,0,11107,3524792,11003,3507558,104,17234,7191,1,24466,1317,0,105,229410.0,137640.0,-53.0,-51.0,-46.0,-49.0,-54.0,-54.0,-50.0,-53.0,-80.0,-86.0,-80.0,-83.0,27.0,35.0,34.0,34.0,1
1250,BA:8C:B9:54:50:24,3266096,490997922,37415,83198688,3228681,407799234,0,13364,4265400,13249,4246213,115,19187,8400,6,37445,7174,0,162,195000.0,97500.0,-55.0,-55.0,-55.0,-46.0,-52.0,-53.0,-53.0,-47.0,-79.0,-85.0,-80.0,-83.0,24.0,30.0,25.0,37.0,1
1251,62:47:05:9D:EB:15,3234159,420690024,5470,12890046,3228689,407799978,0,1746,415058,1702,407415,44,7643,865,0,5466,1219,0,33,229410.0,137640.0,-41.0,-45.0,-44.0,-50.0,-39.0,-43.0,-42.0,-48.0,-79.0,-85.0,-80.0,-83.0,38.0,40.0,36.0,33.0,1
1252,F8:59:71:5A:E0:3D,3478796,784330432,250105,376530252,3228691,407800180,3,248956,334318835,244045,333732151,4911,586684,225811,19,252802,5957,3,729,144444.0,43333.0,-66.0,-72.0,-64.0,-70.0,-66.0,-72.0,-64.0,-69.0,-79.0,-85.0,-80.0,-83.0,13.0,13.0,16.0,13.0,1
1253,92:69:1D:31:68:E9,3256248,464742642,27005,56879522,3229243,407863120,0,12273,3801375,12161,3782905,112,18470,7905,1,27051,2044,0,138,216660.0,130000.0,-54.0,-51.0,-46.0,-51.0,-51.0,-50.0,-45.0,-50.0,-81.0,-93.0,-83.0,-90.0,27.0,42.0,37.0,39.0,1
1254,BA:8C:B9:54:50:24,3271100,502502652,41856,94639472,3229244,407863180,64,14649,4483722,14525,4463113,124,20609,9129,6,41834,9901,64,221,229410.0,137640.0,-54.0,-51.0,-38.0,-46.0,-51.0,-51.0,-41.0,-47.0,-81.0,-93.0,-83.0,-90.0,27.0,42.0,45.0,44.0,1
1255,62:47:05:9D:EB:15,3241859,437832552,12615,29969372,3229244,407863180,64,5153,1096197,5096,1086399,57,9798,2680,1,12598,2273,64,147,229410.0,137640.0,-43.0,-49.0,-44.0,-44.0,-44.0,-49.0,-45.0,-42.0,-81.0,-93.0,-83.0,-90.0,38.0,44.0,39.0,46.0,1
1256,F8:59:71:5A:E0:3D,3485940,794619020,256696,386755840,3229244,407863180,3,255879,344960665,250965,344373627,4914,587038,232281,20,259449,6720,3,817,144444.0,43333.0,-67.0,-74.0,-67.0,-71.0,-66.0,-74.0,-67.0,-71.0,-81.0,-93.0,-83.0,-90.0,14.0,19.0,16.0,19.0,1
1257,CC:2F:71:3E:C5:1F,3240786,409275063,11542,1411883,3229244,407863180,6,49220,4122537,40666,3109011,8554,1013526,12169,36,16541,189,6,853,130000.0,39000.0,-67.0,-71.0,-68.0,-61.0,-67.0,-70.0,-68.0,-60.0,-81.0,-93.0,-83.0,-90.0,14.0,22.0,15.0,29.0,1
1258,CC:2F:71:3F:1F:24,11825500,13595261330,8596256,13187398150,3229244,407863180,158,1942921,1135236168,1934229,1134192066,8692,1044102,1878808,675,8601062,915447,158,6627,104000.0,26000.0,-70.0,-65.0,-71.0,-70.0,-70.0,-65.0,-71.0,-70.0,-81.0,-93.0,-83.0,-90.0,11.0,28.0,12.0,20.0,1
1259,92:69:1D:31:68:E9,3256256,464743341,27005,56879522,3229251,407863819,0,12273,3801375,12161,3782905,112,18470,7905,1,27051,2044,0,138,216660.0,130000.0,-54.0,-51.0,-46.0,-51.0,-51.0,-50.0,-45.0,-50.0,-81.0,-93.0,-83.0,-90.0,27.0,42.0,37.0,39.0,1
1260,BA:8C:B9:54:50:24,3271108,502503402,41856,94639472,3229252,407863930,64,14652,4484029,14527,4463249,125,20780,9130,6,41834,9901,64,221,229410.0,137640.0,-46.0,-50.0,-53.0,-46.0,-51.0,-51.0,-43.0,-48.0,-81.0,-93.0,-83.0,-90.0,35.0,43.0,30.0,44.0,1
1261,62:47:05:9D:EB:15,3241873,437834162,12619,29970030,3229254,407864132,64,5208,1100307,5151,1090509,57,9798,2685,1,12602,2273,64,149,229410.0,137640.0,-42.0,-47.0,-44.0,-40.0,-42.0,-47.0,-44.0,-40.0,-81.0,-93.0,-83.0,-90.0,39.0,46.0,39.0,50.0,1
1262,F8:59:71:5A:E0:3D,3486045,794767602,256791,386903470,3229254,407864132,3,255975,345107125,251060,344519969,4915,587156,232376,20,259544,6728,3,817,144444.0,43333.0,-66.0,-74.0,-67.0,-71.0,-66.0,-74.0,-67.0,-71.0,-81.0,-93.0,-83.0,-90.0,15.0,19.0,16.0,19.0,1
1263,CC:2F:71:3E:C5:1F,3240798,409276217,11542,1411883,3229256,407864334,6,49222,4122725,40667,3109081,8555,1013644,12170,36,16541,189,6,853,130000.0,39000.0,-77.0,-85.0,-74.0,-71.0,-69.0,-72.0,-69.0,-62.0,-81.0,-93.0,-83.0,-90.0,4.0,8.0,9.0,19.0,1
1264,CC:2F:71:3F:1F:24,11826793,13597215199,8597537,13189350865,3229256,407864334,158,1943344,1135549840,1934652,1134505738,8692,1044102,1879231,675,8602370,915533,158,6628,86667.0,14444.0,-70.0,-65.0,-72.0,-70.0,-69.0,-65.0,-71.0,-70.0,-81.0,-93.0,-83.0,-90.0,11.0,28.0,11.0,20.0,1
1265,92:69:1D:31:68:E9,3256261,464743856,27005,56879522,3229256,407864334,0,12276,3801682,12163,3783041,113,18641,7906,1,27051,2044,0,139,216660.0,130000.0,-54.0,-52.0,-46.0,-51.0,-51.0,-50.0,-46.0,-50.0,-81.0,-93.0,-83.0,-90.0,27.0,41.0,37.0,39.0,1
1266,BA:8C:B9:54:50:24,3271113,502503866,41856,94639472,3229257,407864394,64,14652,4484029,14527,4463249,125,20780,9130,6,41834,9901,64,221,229410.0,137640.0,-46.0,-50.0,-53.0,-46.0,-51.0,-51.0,-43.0,-48.0,-81.0,-93.0,-83.0,-90.0,35.0,43.0,30.0,44.0,1
1267,62:47:05:9D:EB:15,3241878,437834626,12619,29970030,3229259,407864596,64,5209,1100375,5152,1090577,57,9798,2685,1,12602,2273,64,149,229410.0,137640.0,-50.0,-49.0,-51.0,-41.0,-43.0,-47.0,-45.0,-40.0,-81.0,-93.0,-83.0,-90.0,31.0,44.0,32.0,49.0,1
1268,F8:59:71:5A:E0:3D,3486142,794911034,256883,387046438,3229259,407864596,3,256069,345251899,251154,344664743,4915,587156,232469,20,259636,6729,3,817,144444.0,43333.0,-66.0,-74.0,-66.0,-71.0,-66.0,-74.0,-66.0,-71.0,-81.0,-93.0,-83.0,-90.0,15.0,19.0,17.0,19.0,1
1269,CC:2F:71:3E:C5:1F,3240803,409276681,11542,1411883,3229261,407864798,6,49222,4122725,40667,3109081,8555,1013644,12170,36,16541,189,6,853,130000.0,39000.0,-77.0,-85.0,-74.0,-71.0,-69.0,-72.0,-69.0,-62.0,-81.0,-93.0,-83.0,-90.0,4.0,8.0,9.0,19.0,1
1270,CC:2F:71:3F:1F:24,11828327,13599551611,8599066,13191686813,3229261,407864798,158,1943815,1135866306,1935123,1134822204,8692,1044102,1879702,675,8603865,915703,158,6628,78000.0,13000.0,-69.0,-65.0,-72.0,-71.0,-69.0,-65.0,-71.0,-71.0,-81.0,-93.0,-83.0,-90.0,12.0,28.0,11.0,19.0,1
1271,92:69:1D:31:68:E9,3256270,464744724,27005,56879522,3229265,407865202,0,12276,3801682,12163,3783041,113,18641,7906,1,27051,2044,0,139,216660.0,130000.0,-54.0,-52.0,-46.0,-51.0,-51.0,-50.0,-46.0,-50.0,-81.0,-93.0,-83.0,-90.0,27.0,41.0,37.0,39.0,1
1272,BA:8C:B9:54:50:24,3271121,502504674,41856,94639472,3229265,407865202,64,14652,4484029,14527,4463249,125,20780,9130,6,41834,9901,64,221,229410.0,137640.0,-46.0,-50.0,-53.0,-46.0,-51.0,-51.0,-43.0,-48.0,-81.0,-93.0,-83.0,-90.0,35.0,43.0,30.0,44.0,1
1273,62:47:05:9D:EB:15,3241884,437835232,12619,29970030,3229265,407865202,64,5209,1100375,5152,1090577,57,9798,2685,1,12602,2273,64,149,229410.0,137640.0,-50.0,-49.0,-51.0,-41.0,-43.0,-47.0,-45.0,-40.0,-81.0,-93.0,-83.0,-90.0,31.0,44.0,32.0,49.0,1
1274,F8:59:71:5A:E0:3D,3486237,795049946,256972,387184744,3229265,407865202,3,256158,345388959,251243,344801803,4915,587156,232558,20,259725,6734,3,817,144444.0,43333.0,-66.0,-74.0,-67.0,-71.0,-66.0,-74.0,-67.0,-71.0,-81.0,-93.0,-83.0,-90.0,15.0,19.0,16.0,19.0,1
1275,CC:2F:71:3E:C5:1F,3240807,409277085,11542,1411883,3229265,407865202,6,49222,4122725,40667,3109081,8555,1013644,12170,36,16541,189,6,853,130000.0,39000.0,-77.0,-85.0,-74.0,-71.0,-69.0,-72.0,-69.0,-62.0,-81.0,-93.0,-83.0,-90.0,4.0,8.0,9.0,19.0,1
1276,CC:2F:71:3F:1F:24,11829970,13602049965,8600705,13194184763,3229265,407865202,158,1944290,1136168544,1935598,1135124442,8692,1044102,1880176,675,8605515,915704,158,6628,86667.0,14444.0,-70.0,-65.0,-72.0,-72.0,-69.0,-65.0,-71.0,-71.0,-81.0,-93.0,-83.0,-90.0,11.0,28.0,11.0,18.0,1
1277,92:69:1D:31:68:E9,3256430,465148887,27161,57283281,3229269,407865606,0,12305,3808143,12192,3789502,113,18641,7932,1,27207,2044,0,139,229410.0,137640.0,-49.0,-50.0,-46.0,-49.0,-49.0,-50.0,-46.0,-49.0,-81.0,-93.0,-83.0,-90.0,32.0,43.0,37.0,41.0,1
1278,BA:8C:B9:54:50:24,3271126,502505138,41856,94639472,3229270,407865666,64,14653,4484097,14528,4463317,125,20780,9130,6,41834,9901,64,221,229410.0,137640.0,-46.0,-49.0,-53.0,-46.0,-50.0,-51.0,-44.0,-47.0,-81.0,-93.0,-83.0,-90.0,35.0,44.0,30.0,44.0,1
1279,62:47:05:9D:EB:15,3241934,437891194,12664,30025528,3229270,407865666,64,5239,1103417,5182,1093619,57,9798,2693,1,12647,2273,64,150,229410.0,137640.0,-51.0,-49.0,-51.0,-41.0,-45.0,-50.0,-47.0,-44.0,-81.0,-93.0,-83.0,-90.0,30.0,44.0,32.0,49.0,1
1280,F8:59:71:5A:E0:3D,3486326,795180946,257056,387315280,3229270,407865666,3,256239,345513699,251324,344926543,4915,587156,232639,20,259809,6735,3,817,144444.0,43333.0,-66.0,-74.0,-67.0,-71.0,-66.0,-74.0,-66.0,-71.0,-81.0,-93.0,-83.0,-90.0,15.0,19.0,16.0,19.0,1
1281,CC:2F:71:3E:C5:1F,3240814,409277751,11542,1411883,3229272,407865868,6,49222,4122725,40667,3109081,8555,1013644,12170,36,16541,189,6,853,130000.0,39000.0,-77.0,-85.0,-74.0,-71.0,-69.0,-72.0,-69.0,-62.0,-81.0,-93.0,-83.0,-90.0,4.0,8.0,9.0,19.0,1
1282,CC:2F:71:3F:1F:24,11831444,13604295699,8602170,13196429629,3229274,407866070,158,1944747,1136466254,1936055,1135422152,8692,1044102,1880621,675,8606989,915821,158,6629,86667.0,14444.0,-69.0,-65.0,-72.0,-72.0,-69.0,-65.0,-72.0,-71.0,-81.0,-93.0,-83.0,-90.0,12.0,28.0,11.0,18.0,1
1283,92:69:1D:31:68:E9,3256435,465149351,27161,57283281,3229274,407866070,0,12306,3808211,12193,3789570,113,18641,7932,1,27207,2044,0,139,229410.0,137640.0,-52.0,-51.0,-45.0,-50.0,-49.0,-50.0,-45.0,-49.0,-81.0,-93.0,-83.0,-90.0,29.0,42.0,38.0,40.0,1
1284,BA:8C:B9:54:50:24,3271130,502505542,41856,94639472,3229274,407866070,64,14653,4484097,14528,4463317,125,20780,9130,6,41834,9901,64,221,229410.0,137640.0,-46.0,-49.0,-53.0,-46.0,-50.0,-51.0,-44.0,-47.0,-81.0,-93.0,-83.0,-90.0,35.0,44.0,30.0,44.0,1
1285,62:47:05:9D:EB:15,3241938,437891598,12664,30025528,3229274,407866070,64,5239,1103417,5182,1093619,57,9798,2693,1,12647,2273,64,150,229410.0,137640.0,-51.0,-49.0,-51.0,-41.0,-45.0,-50.0,-47.0,-44.0,-81.0,-93.0,-83.0,-90.0,30.0,44.0,32.0,49.0,1
1286,F8:59:71:5A:E0:3D,3486419,795319656,257145,387453586,3229274,407866070,3,256330,345653839,251415,345066683,4915,587156,232730,20,259898,6735,3,817,144444.0,43333.0,-66.0,-75.0,-67.0,-71.0,-66.0,-74.0,-67.0,-71.0,-81.0,-93.0,-83.0,-90.0,15.0,18.0,16.0,19.0,1
1287,CC:2F:71:3E:C5:1F,3240818,409278155,11542,1411883,3229276,407866272,6,49222,4122725,40667,3109081,8555,1013644,12170,36,16541,189,6,853,130000.0,39000.0,-77.0,-85.0,-74.0,-71.0,-69.0,-72.0,-69.0,-62.0,-81.0,-93.0,-83.0,-90.0,4.0,8.0,9.0,19.0,1
1288,CC:2F:71:3F:1F:24,11833036,13606726763,8603760,13198860491,3229276,407866272,158,1945241,1136791667,1936549,1135747565,8692,1044102,1881114,675,8608593,915865,158,6629,86667.0,14444.0,-69.0,-63.0,-70.0,-69.0,-68.0,-63.0,-70.0,-68.0,-81.0,-93.0,-83.0,-90.0,12.0,30.0,13.0,21.0,1
1289,92:69:1D:31:68:E9,3256444,465150270,27161,57283281,3229283,407866989,0,12306,3808211,12193,3789570,113,18641,7932,1,27207,2044,0,139,229410.0,137640.0,-52.0,-51.0,-45.0,-50.0,-49.0,-50.0,-45.0,-49.0,-81.0,-93.0,-83.0,-90.0,29.0,42.0,38.0,40.0,1
1290,BA:8C:B9:54:50:24,3271139,502506461,41856,94639472,3229283,407866989,64,14653,4484097,14528,4463317,125,20780,9130,6,41834,9901,64,221,229410.0,137640.0,-46.0,-49.0,-53.0,-46.0,-50.0,-51.0,-44.0,-47.0,-81.0,-93.0,-83.0,-90.0,35.0,44.0,30.0,44.0,1
1291,62:47:05:9D:EB:15,3242291,438796301,13007,30929252,3229284,407867049,64,5326,1116048,5268,1106079,58,9969,2742,1,12990,2281,64,150,229410.0,137640.0,-43.0,-49.0,-44.0,-44.0,-45.0,-51.0,-46.0,-45.0,-81.0,-93.0,-83.0,-90.0,38.0,44.0,39.0,46.0,1
1292,F8:59:71:5A:E0:3D,3486518,795458941,257234,387591892,3229284,407867049,3,256421,345794091,251506,345206935,4915,587156,232820,20,259987,6737,3,817,144444.0,43333.0,-67.0,-73.0,-66.0,-70.0,-66.0,-72.0,-66.0,-69.0,-81.0,-93.0,-83.0,-90.0,14.0,20.0,17.0,20.0,1
1293,CC:2F:71:3E:C5:1F,3240826,409278932,11542,1411883,3229284,407867049,6,49222,4122725,40667,3109081,8555,1013644,12170,36,16541,189,6,853,130000.0,39000.0,-77.0,-85.0,-74.0,-71.0,-69.0,-72.0,-69.0,-62.0,-81.0,-93.0,-83.0,-90.0,4.0,8.0,9.0,19.0,1
1294,CC:2F:71:3F:1F:24,11834445,13608865406,8605161,13200998357,3229284,407867049,158,1945669,1137114716,1936977,1136070614,8692,1044102,1881540,675,8609976,916224,158,6630,117000.0,39000.0,-71.0,-64.0,-73.0,-69.0,-70.0,-63.0,-72.0,-69.0,-81.0,-93.0,-83.0,-90.0,10.0,29.0,10.0,21.0,1
1295,92:69:1D:31:68:E9,3256447,465150532,27161,57283281,3229286,407867251,0,12306,3808211,12193,3789570,113,18641,7932,1,27207,2044,0,139,229410.0,137640.0,-52.0,-51.0,-45.0,-50.0,-49.0,-50.0,-45.0,-49.0,-81.0,-93.0,-83.0,-90.0,29.0,42.0,38.0,40.0,1
1296,BA:8C:B9:54:50:24,3271142,502506723,41856,94639472,3229286,407867251,64,14653,4484097,14528,4463317,125,20780,9130,6,41834,9901,64,221,229410.0,137640.0,-46.0,-49.0,-53.0,-46.0,-50.0,-51.0,-44.0,-47.0,-81.0,-93.0,-83.0,-90.0,35.0,44.0,30.0,44.0,1
1297,62:47:05:9D:EB:15,3242296,438796964,13008,30929511,3229288,407867453,64,5330,1116463,5272,1106494,58,9969,2744,1,12991,2281,64,150,229410.0,137640.0,-51.0,-49.0,-51.0,-41.0,-46.0,-51.0,-48.0,-44.0,-81.0,-93.0,-83.0,-90.0,30.0,44.0,32.0,49.0,1
1298,F8:59:71:5A:E0:3D,3486614,795602313,257326,387734860,3229288,407867453,3,256513,345935771,251598,345348615,4915,587156,232912,20,260079,6738,3,817,144444.0,43333.0,-67.0,-73.0,-67.0,-71.0,-67.0,-73.0,-66.0,-70.0,-81.0,-93.0,-83.0,-90.0,14.0,20.0,16.0,19.0,1
1299,CC:2F:71:3E:C5:1F,3240830,409279336,11542,1411883,3229288,407867453,6,49222,4122725,40667,3109081,8555,1013644,12170,36,16541,189,6,853,130000.0,39000.0,-77.0,-85.0,-74.0,-71.0,-69.0,-72.0,-69.0,-62.0,-81.0,-93.0,-83.0,-90.0,4.0,8.0,9.0,19.0,1
1300,CC:2F:71:3F:1F:24,11835548,13610527222,8606258,13202659567,3229290,407867655,158,1946042,1137393540,1937350,1136349438,8692,1044102,1881913,675,8611091,916339,158,6630,86667.0,14444.0,-70.0,-64.0,-73.0,-68.0,-69.0,-64.0,-72.0,-68.0,-81.0,-93.0,-83.0,-90.0,11.0,29.0,10.0,22.0,1
1301,92:69:1D:31:68:E9,3256454,465151198,27161,57283281,3229293,407867917,0,12307,3808279,12194,3789638,113,18641,7932,1,27207,2044,0,139,229410.0,137640.0,-51.0,-50.0,-45.0,-50.0,-49.0,-50.0,-45.0,-49.0,-81.0,-93.0,-83.0,-90.0,30.0,43.0,38.0,40.0,1
1302,BA:8C:B9:54:50:24,3271149,502507389,41856,94639472,3229293,407867917,64,14653,4484097,14528,4463317,125,20780,9130,6,41834,9901,64,221,229410.0,137640.0,-46.0,-49.0,-53.0,-46.0,-50.0,-51.0,-44.0,-47.0,-81.0,-93.0,-83.0,-90.0,35.0,44.0,30.0,44.0,1
1303,62:47:05:9D:EB:15,3242301,438797428,13008,30929511,3229293,407867917,64,5330,1116463,5272,1106494,58,9969,2744,1,12991,2281,64,150,229410.0,137640.0,-51.0,-49.0,-51.0,-41.0,-46.0,-51.0,-48.0,-44.0,-81.0,-93.0,-83.0,-90.0,30.0,44.0,32.0,49.0,1
1304,F8:59:71:5A:E0:3D,3486724,795765947,257431,387898030,3229293,407867917,3,256617,346096183,251702,345509027,4915,587156,233016,20,260184,6741,3,817,144444.0,43333.0,-67.0,-73.0,-67.0,-70.0,-66.0,-73.0,-66.0,-70.0,-81.0,-93.0,-83.0,-90.0,14.0,20.0,16.0,20.0,1
1305,CC:2F:71:3E:C5:1F,3240837,409280002,11542,1411883,3229295,407868119,6,49222,4122725,40667,3109081,8555,1013644,12170,36,16541,189,6,853,130000.0,39000.0,-77.0,-85.0,-74.0,-71.0,-69.0,-72.0,-69.0,-62.0,-81.0,-93.0,-83.0,-90.0,4.0,8.0,9.0,19.0,1
1306,CC:2F:71:3F:1F:24,11837352,13613288710,8608057,13205420591,3229295,407868119,158,1946582,1137762259,1937890,1136718157,8692,1044102,1882451,675,8612874,916523,158,6631,86667.0,14444.0,-70.0,-64.0,-73.0,-68.0,-69.0,-64.0,-72.0,-67.0,-81.0,-93.0,-83.0,-90.0,11.0,29.0,10.0,22.0,1
1307,92:69:1D:31:68:E9,3256464,465152339,27161,57283281,3229303,407869058,0,12307,3808279,12194,3789638,113,18641,7932,1,27207,2044,0,139,229410.0,137640.0,-51.0,-50.0,-45.0,-50.0,-49.0,-50.0,-45.0,-49.0,-81.0,-93.0,-83.0,-90.0,30.0,43.0,38.0,40.0,1
1308,BA:8C:B9:54:50:24,3271159,502508530,41856,94639472,3229303,407869058,64,14653,4484097,14528,4463317,125,20780,9130,6,41834,9901,64,221,229410.0,137640.0,-46.0,-49.0,-53.0,-46.0,-50.0,-51.0,-44.0,-47.0,-81.0,-93.0,-83.0,-90.0,35.0,44.0,30.0,44.0,1
1309,62:47:05:9D:EB:15,3242311,438798569,13008,30929511,3229303,407869058,64,5330,1116463,5272,1106494,58,9969,2744,1,12991,2281,64,150,229410.0,137640.0,-51.0,-49.0,-51.0,-41.0,-46.0,-51.0,-48.0,-44.0,-81.0,-93.0,-83.0,-90.0,30.0,44.0,32.0,49.0,1
1310,F8:59:71:5A:E0:3D,3486816,795894516,257513,388025458,3229303,407869058,3,256701,346225557,251786,345638401,4915,587156,233099,20,260266,6741,3,817,144444.0,43333.0,-67.0,-74.0,-67.0,-71.0,-67.0,-74.0,-66.0,-71.0,-81.0,-93.0,-83.0,-90.0,14.0,19.0,16.0,19.0,1
1311,CC:2F:71:3E:C5:1F,3240845,409280941,11542,1411883,3229303,407869058,6,49222,4122725,40667,3109081,8555,1013644,12170,36,16541,189,6,853,130000.0,39000.0,-77.0,-85.0,-74.0,-71.0,-69.0,-72.0,-69.0,-62.0,-81.0,-93.0,-83.0,-90.0,4.0,8.0,9.0,19.0,1
1312,CC:2F:71:3F:1F:24,11838740,13615396033,8609437,13207526975,3229303,407869058,158,1947005,1138048497,1938313,1137004395,8692,1044102,1882874,675,8614269,916725,158,6631,115556.0,28889.0,-69.0,-64.0,-70.0,-69.0,-69.0,-63.0,-70.0,-69.0,-81.0,-93.0,-83.0,-90.0,12.0,29.0,13.0,21.0,1
1313,92:69:1D:31:68:E9,3256467,465152601,27161,57283281,3229306,407869320,0,12307,3808279,12194,3789638,113,18641,7932,1,27207,2044,0,139,229410.0,137640.0,-51.0,-50.0,-45.0,-50.0,-49.0,-50.0,-45.0,-49.0,-81.0,-93.0,-83.0,-90.0,30.0,43.0,38.0,40.0,1
1314,BA:8C:B9:54:50:24,3271162,502508792,41856,94639472,3229306,407869320,64,14653,4484097,14528,4463317,125,20780,9130,6,41834,9901,64,221,229410.0,137640.0,-46.0,-49.0,-53.0,-46.0,-50.0,-51.0,-44.0,-47.0,-81.0,-93.0,-83.0,-90.0,35.0,44.0,30.0,44.0,1
1315,62:47:05:9D:EB:15,3242315,438798891,13008,30929511,3229307,407869380,64,5330,1116463,5272,1106494,58,9969,2744,1,12991,2281,64,150,229410.0,137640.0,-51.0,-49.0,-51.0,-41.0,-46.0,-51.0,-48.0,-44.0,-81.0,-93.0,-83.0,-90.0,30.0,44.0,32.0,49.0,1
1316,F8:59:71:5A:E0:3D,3486909,796030238,257600,388160656,3229309,407869582,3,256788,346359537,251873,345772381,4915,587156,233186,20,260353,6744,3,817,144444.0,43333.0,-67.0,-74.0,-67.0,-71.0,-67.0,-73.0,-66.0,-70.0,-81.0,-93.0,-83.0,-90.0,14.0,19.0,16.0,19.0,1
1317,CC:2F:71:3E:C5:1F,3240853,409281667,11542,1411883,3229311,407869784,6,49222,4122725,40667,3109081,8555,1013644,12170,36,16541,189,6,853,130000.0,39000.0,-77.0,-85.0,-74.0,-71.0,-69.0,-72.0,-69.0,-62.0,-81.0,-93.0,-83.0,-90.0,4.0,8.0,9.0,19.0,1
1318,CC:2F:71:3F:1F:24,11840554,13618170041,8611241,13210300055,3229313,407869986,158,1947513,1138393201,1938821,1137349099,8692,1044102,1883376,675,8616067,917135,158,6631,115556.0,28889.0,-69.0,-64.0,-70.0,-69.0,-68.0,-64.0,-70.0,-69.0,-81.0,-93.0,-83.0,-90.0,12.0,29.0,13.0,21.0,1
1319,92:69:1D:31:68:E9,3256475,465153327,27161,57283281,3229314,407870046,0,12307,3808279,12194,3789638,113,18641,7932,1,27207,2044,0,139,229410.0,137640.0,-51.0,-50.0,-45.0,-50.0,-49.0,-50.0,-45.0,-49.0,-81.0,-93.0,-83.0,-90.0,30.0,43.0,38.0,40.0,1
1320,BA:8C:B9:54:50:24,3271170,502509518,41856,94639472,3229314,407870046,64,14653,4484097,14528,4463317,125,20780,9130,6,41834,9901,64,221,229410.0,137640.0,-46.0,-49.0,-53.0,-46.0,-50.0,-51.0,-44.0,-47.0,-81.0,-93.0,-83.0,-90.0,35.0,44.0,30.0,44.0,1
1321,62:47:05:9D:EB:15,3242322,438799557,13008,30929511,3229314,407870046,64,5330,1116463,5272,1106494,58,9969,2744,1,12991,2281,64,150,229410.0,137640.0,-51.0,-49.0,-51.0,-41.0,-46.0,-51.0,-48.0,-44.0,-81.0,-93.0,-83.0,-90.0,30.0,44.0,32.0,49.0,1
1322,F8:59:71:5A:E0:3D,3487013,796183054,257699,388313008,3229314,407870046,3,256885,346509085,251970,345921929,4915,587156,233283,20,260452,6748,3,820,130000.0,39000.0,-67.0,-73.0,-66.0,-70.0,-66.0,-73.0,-66.0,-70.0,-81.0,-93.0,-83.0,-90.0,14.0,20.0,17.0,20.0,1
1323,CC:2F:71:3E:C5:1F,3240856,409281929,11542,1411883,3229314,407870046,6,49222,4122725,40667,3109081,8555,1013644,12170,36,16541,189,6,853,130000.0,39000.0,-77.0,-85.0,-74.0,-71.0,-69.0,-72.0,-69.0,-62.0,-81.0,-93.0,-83.0,-90.0,4.0,8.0,9.0,19.0,1
1324,CC:2F:71:3F:1F:24,11842211,13620704317,8612897,13212834271,3229314,407870046,158,1947962,1138694777,1939270,1137650675,8692,1044102,1883822,675,8617729,917342,158,6631,115556.0,28889.0,-68.0,-65.0,-71.0,-68.0,-68.0,-65.0,-71.0,-68.0,-81.0,-93.0,-83.0,-90.0,13.0,28.0,12.0,22.0,1
1325,92:69:1D:31:68:E9,3256604,465455746,27281,57584717,3229323,407871029,0,12339,3814810,12226,3796169,113,18641,7954,1,27327,2049,0,139,229410.0,137640.0,-50.0,-50.0,-46.0,-49.0,-50.0,-49.0,-45.0,-49.0,-81.0,-93.0,-83.0,-90.0,31.0,43.0,37.0,41.0,1
1326,BA:8C:B9:54:50:24,3271183,502511045,41857,94639588,3229326,407871457,64,14659,4484505,14534,4463725,125,20780,9130,6,41835,9901,64,222,216660.0,130000.0,-53.0,-51.0,-38.0,-46.0,-48.0,-49.0,-45.0,-45.0,-81.0,-93.0,-83.0,-90.0,28.0,42.0,45.0,44.0,1
1327,62:47:05:9D:EB:15,3242349,438806244,13023,30934787,3229326,407871457,64,5379,1129342,5320,1119138,59,10204,2760,1,13006,2281,64,152,229410.0,137640.0,-47.0,-53.0,-48.0,-46.0,-47.0,-53.0,-48.0,-46.0,-82.0,-93.0,-84.0,-90.0,35.0,40.0,36.0,44.0,1
1328,F8:59:71:5A:E0:3D,3487112,796319551,257786,388448094,3229326,407871457,3,256975,346647741,252060,346060585,4915,587156,233371,20,260539,6748,3,820,144444.0,43333.0,-67.0,-73.0,-67.0,-71.0,-67.0,-73.0,-66.0,-70.0,-82.0,-93.0,-84.0,-90.0,15.0,20.0,17.0,19.0,1
1329,CC:2F:71:3E:C5:1F,3240869,409283456,11543,1411999,3229326,407871457,6,49224,4122865,40669,3109221,8555,1013644,12170,36,16542,190,6,853,130000.0,39000.0,-68.0,-71.0,-68.0,-61.0,-68.0,-73.0,-69.0,-62.0,-82.0,-93.0,-84.0,-90.0,14.0,22.0,16.0,29.0,1
1330,CC:2F:71:3F:1F:24,11843590,13622789610,8614263,13214918091,3229327,407871519,158,1948336,1138982433,1939644,1137938331,8692,1044102,1884196,675,8619095,917436,158,6632,115556.0,28889.0,-68.0,-64.0,-71.0,-68.0,-68.0,-64.0,-71.0,-67.0,-82.0,-93.0,-84.0,-90.0,14.0,29.0,13.0,22.0,1
1331,92:69:1D:31:68:E9,3256609,465456298,27281,57584717,3229328,407871581,0,12340,3814878,12227,3796237,113,18641,7954,1,27327,2049,0,139,229410.0,137640.0,-53.0,-51.0,-45.0,-50.0,-50.0,-49.0,-45.0,-49.0,-82.0,-93.0,-84.0,-90.0,29.0,42.0,39.0,40.0,1
1332,BA:8C:B9:54:50:24,3271187,502511371,41857,94639588,3229330,407871783,64,14662,4484763,14536,4463861,126,20902,9131,6,41835,9901,64,222,216660.0,130000.0,-46.0,-50.0,-53.0,-46.0,-49.0,-49.0,-42.0,-46.0,-82.0,-93.0,-84.0,-90.0,36.0,43.0,31.0,44.0,1
1333,62:47:05:9D:EB:15,3242359,438807966,13029,30936183,3229330,407871783,64,5404,1131599,5345,1121395,59,10204,2767,1,13012,2281,64,152,229410.0,137640.0,-47.0,-53.0,-48.0,-46.0,-45.0,-51.0,-46.0,-45.0,-82.0,-93.0,-84.0,-90.0,35.0,40.0,36.0,44.0,1
1334,F8:59:71:5A:E0:3D,3487198,796445867,257868,388574084,3229330,407871783,3,257058,346774141,252143,346186985,4915,587156,233453,20,260621,6748,3,820,144444.0,43333.0,-66.0,-73.0,-67.0,-71.0,-66.0,-73.0,-67.0,-70.0,-82.0,-93.0,-84.0,-90.0,16.0,20.0,17.0,19.0,1
1335,CC:2F:71:3E:C5:1F,3240873,409283782,11543,1411999,3229330,407871783,6,49224,4122865,40669,3109221,8555,1013644,12170,36,16542,190,6,853,130000.0,39000.0,-68.0,-71.0,-68.0,-61.0,-68.0,-73.0,-69.0,-62.0,-82.0,-93.0,-84.0,-90.0,14.0,22.0,16.0,29.0,1
1336,CC:2F:71:3F:1F:24,11845118,13625104508,8615787,13217232591,3229331,407871917,158,1948732,1139281017,1940039,1138236797,8693,1044220,1884584,675,8620590,917641,158,6633,104000.0,26000.0,-69.0,-65.0,-72.0,-69.0,-69.0,-64.0,-72.0,-69.0,-82.0,-93.0,-84.0,-90.0,13.0,28.0,12.0,21.0,1
1337,92:69:1D:31:68:E9,3256617,465457106,27281,57584717,3229336,407872389,0,12340,3814878,12227,3796237,113,18641,7954,1,27327,2049,0,139,229410.0,137640.0,-53.0,-51.0,-45.0,-50.0,-50.0,-49.0,-45.0,-49.0,-82.0,-93.0,-84.0,-90.0,29.0,42.0,39.0,40.0,1
1338,BA:8C:B9:54:50:24,3271412,503082438,42076,95210049,3229336,407872389,64,14694,4491875,14568,4470973,126,20902,9158,6,42054,9901,64,222,229410.0,137640.0,-51.0,-52.0,-44.0,-50.0,-51.0,-51.0,-44.0,-50.0,-82.0,-93.0,-84.0,-90.0,31.0,41.0,40.0,40.0,1
1339,62:47:05:9D:EB:15,3242371,438809879,13034,30937430,3229337,407872449,64,5452,1135769,5393,1125565,59,10204,2775,1,13017,2281,64,154,229410.0,137640.0,-43.0,-49.0,-44.0,-45.0,-42.0,-48.0,-44.0,-41.0,-82.0,-93.0,-84.0,-90.0,39.0,44.0,40.0,45.0,1
1340,F8:59:71:5A:E0:3D,3487292,796581731,257955,388709282,3229337,407872449,3,257144,346906581,252229,346319425,4915,587156,233539,20,260708,6748,3,820,144444.0,43333.0,-67.0,-73.0,-66.0,-71.0,-67.0,-73.0,-66.0,-70.0,-82.0,-93.0,-84.0,-90.0,15.0,20.0,18.0,19.0,1
1341,CC:2F:71:3E:C5:1F,3240880,409284448,11543,1411999,3229337,407872449,6,49224,4122865,40669,3109221,8555,1013644,12170,36,16542,190,6,853,130000.0,39000.0,-68.0,-71.0,-68.0,-61.0,-68.0,-73.0,-69.0,-62.0,-83.0,-93.0,-84.0,-91.0,15.0,22.0,16.0,30.0,1
1342,CC:2F:71:3F:1F:24,11846535,13627252307,8617198,13219379858,3229337,407872449,158,1949103,1139566176,1940410,1138521956,8693,1044220,1884955,675,8622016,917905,158,6633,115556.0,28889.0,-73.0,-64.0,-72.0,-69.0,-73.0,-64.0,-71.0,-69.0,-83.0,-93.0,-84.0,-91.0,10.0,29.0,12.0,22.0,1
1343,92:69:1D:31:68:E9,3256621,465457430,27281,57584717,3229340,407872713,0,12340,3814878,12227,3796237,113,18641,7954,1,27327,2049,0,139,229410.0,137640.0,-53.0,-51.0,-45.0,-50.0,-50.0,-49.0,-45.0,-49.0,-83.0,-93.0,-84.0,-91.0,30.0,42.0,39.0,41.0,1
1344,BA:8C:B9:54:50:24,3271421,503083228,42076,95210049,3229345,407873179,64,14698,4492211,14572,4471309,126,20902,9159,6,42054,9901,64,222,229410.0,137640.0,-46.0,-50.0,-54.0,-46.0,-50.0,-51.0,-45.0,-49.0,-83.0,-93.0,-84.0,-91.0,37.0,43.0,30.0,45.0,1
1345,62:47:05:9D:EB:15,3242379,438810609,13034,30937430,3229345,407873179,64,5460,1136367,5400,1126041,60,10326,2776,1,13017,2281,64,154,229410.0,137640.0,-43.0,-49.0,-43.0,-45.0,-42.0,-48.0,-43.0,-42.0,-83.0,-93.0,-84.0,-91.0,40.0,44.0,41.0,46.0,1
1346,F8:59:71:5A:E0:3D,3487379,796705227,258034,388832048,3229345,407873179,3,257224,347029795,252309,346442639,4915,587156,233618,20,260787,6750,3,820,144444.0,43333.0,-67.0,-73.0,-67.0,-70.0,-67.0,-73.0,-66.0,-70.0,-83.0,-93.0,-84.0,-91.0,16.0,20.0,17.0,21.0,1
1347,CC:2F:71:3E:C5:1F,3240888,409285178,11543,1411999,3229345,407873179,6,49224,4122865,40669,3109221,8555,1013644,12170,36,16542,190,6,853,130000.0,39000.0,-68.0,-71.0,-68.0,-61.0,-68.0,-73.0,-69.0,-62.0,-83.0,-93.0,-84.0,-91.0,15.0,22.0,16.0,30.0,1
1348,CC:2F:71:3F:1F:24,11847553,13628773983,8618206,13220900602,3229347,407873381,158,1949459,1139837574,1940766,1138793354,8693,1044220,1885308,675,8623039,917989,158,6633,115556.0,28889.0,-72.0,-64.0,-74.0,-69.0,-72.0,-64.0,-74.0,-69.0,-83.0,-93.0,-84.0,-91.0,11.0,29.0,10.0,22.0,1
1349,92:69:1D:31:68:E9,3256629,465458160,27281,57584717,3229348,407873443,0,12347,3815408,12233,3796645,114,18763,7955,1,27327,2049,0,140,229410.0,137640.0,-54.0,-50.0,-45.0,-50.0,-51.0,-50.0,-46.0,-50.0,-83.0,-93.0,-85.0,-91.0,29.0,43.0,40.0,41.0,1
1350,BA:8C:B9:54:50:24,3271424,503083492,42076,95210049,3229348,407873443,64,14698,4492211,14572,4471309,126,20902,9159,6,42054,9901,64,222,229410.0,137640.0,-46.0,-50.0,-54.0,-46.0,-50.0,-51.0,-45.0,-49.0,-83.0,-93.0,-85.0,-91.0,37.0,43.0,31.0,45.0,1
1351,62:47:05:9D:EB:15,3242382,438810873,13034,30937430,3229348,407873443,64,5460,1136367,5400,1126041,60,10326,2776,1,13017,2281,64,154,229410.0,137640.0,-43.0,-49.0,-43.0,-45.0,-42.0,-48.0,-43.0,-42.0,-83.0,-93.0,-85.0,-91.0,40.0,44.0,42.0,46.0,1
1352,F8:59:71:5A:E0:3D,3487468,796839135,258120,388965692,3229348,407873443,3,257312,347163921,252396,346576647,4916,587274,233706,20,260873,6753,3,820,144444.0,43333.0,-67.0,-73.0,-66.0,-70.0,-67.0,-73.0,-66.0,-70.0,-83.0,-93.0,-85.0,-91.0,16.0,20.0,19.0,21.0,1
1353,CC:2F:71:3E:C5:1F,3240892,409285576,11543,1411999,3229349,407873577,6,49224,4122865,40669,3109221,8555,1013644,12170,36,16542,190,6,853,130000.0,39000.0,-68.0,-71.0,-68.0,-61.0,-68.0,-73.0,-69.0,-62.0,-83.0,-93.0,-85.0,-91.0,15.0,22.0,17.0,30.0,1
1354,CC:2F:71:3F:1F:24,11848438,13630090360,8619087,13222216655,3229351,407873705,158,1949793,1140151884,1941100,1139107664,8693,1044220,1885641,675,8623920,918186,158,6634,130000.0,43333.0,-72.0,-64.0,-75.0,-69.0,-72.0,-64.0,-75.0,-69.0,-84.0,-93.0,-85.0,-91.0,12.0,29.0,10.0,22.0,1
1355,92:69:1D:31:68:E9,3256638,465459028,27281,57584717,3229357,407874311,0,12347,3815408,12233,3796645,114,18763,7955,1,27327,2049,0,140,229410.0,137640.0,-54.0,-50.0,-45.0,-50.0,-51.0,-50.0,-46.0,-50.0,-84.0,-93.0,-85.0,-91.0,30.0,43.0,40.0,41.0,1
1356,BA:8C:B9:54:50:24,3271433,503084360,42076,95210049,3229357,407874311,64,14698,4492211,14572,4471309,126,20902,9159,6,42054,9901,64,222,229410.0,137640.0,-46.0,-50.0,-54.0,-46.0,-50.0,-51.0,-45.0,-49.0,-84.0,-93.0,-85.0,-91.0,38.0,43.0,31.0,45.0,1
1357,62:47:05:9D:EB:15,3242391,438811741,13034,30937430,3229357,407874311,64,5460,1136367,5400,1126041,60,10326,2776,1,13017,2281,64,154,229410.0,137640.0,-43.0,-49.0,-43.0,-45.0,-42.0,-48.0,-43.0,-42.0,-84.0,-93.0,-85.0,-91.0,41.0,44.0,42.0,46.0,1
1358,F8:59:71:5A:E0:3D,3487574,796990741,258217,389116430,3229357,407874311,3,257409,347313371,252493,346726097,4916,587274,233802,20,260970,6754,3,821,144444.0,43333.0,-67.0,-73.0,-67.0,-70.0,-66.0,-72.0,-66.0,-70.0,-84.0,-93.0,-85.0,-91.0,17.0,20.0,18.0,21.0,1
1359,CC:2F:71:3E:C5:1F,3240911,409291734,11543,1411999,3229368,407879735,6,49224,4122865,40669,3109221,8555,1013644,12170,36,16542,190,6,853,130000.0,39000.0,-68.0,-71.0,-68.0,-61.0,-68.0,-73.0,-69.0,-62.0,-84.0,-93.0,-85.0,-91.0,16.0,22.0,17.0,30.0,1
1360,CC:2F:71:3F:1F:24,11849442,13631575685,8620074,13223695950,3229368,407879735,158,1950142,1140461287,1941449,1139417067,8693,1044220,1885988,675,8624895,918263,158,6635,117000.0,39000.0,-71.0,-64.0,-74.0,-69.0,-71.0,-64.0,-74.0,-69.0,-84.0,-93.0,-85.0,-91.0,13.0,29.0,11.0,22.0,1
1361,92:69:1D:31:68:E9,3256669,465473762,27288,57588401,3229381,407885361,0,12356,3818519,12242,3799756,114,18763,7961,1,27334,2049,0,140,229410.0,137640.0,-54.0,-52.0,-45.0,-50.0,-51.0,-50.0,-45.0,-49.0,-84.0,-93.0,-85.0,-91.0,30.0,41.0,40.0,41.0,1
1362,BA:8C:B9:54:50:24,3271457,503095410,42076,95210049,3229381,407885361,64,14698,4492211,14572,4471309,126,20902,9159,6,42054,9901,64,222,229410.0,137640.0,-46.0,-50.0,-54.0,-46.0,-50.0,-51.0,-45.0,-49.0,-84.0,-93.0,-85.0,-91.0,38.0,43.0,31.0,45.0,1
1363,62:47:05:9D:EB:15,3242795,439825654,13412,31940091,3229383,407885563,64,5523,1146720,5463,1136394,60,10326,2818,1,13395,2295,64,154,229410.0,137640.0,-43.0,-50.0,-43.0,-45.0,-46.0,-51.0,-48.0,-45.0,-84.0,-93.0,-85.0,-91.0,41.0,43.0,42.0,46.0,1
1364,F8:59:71:5A:E0:3D,3487684,797132529,258301,389246966,3229383,407885563,3,257495,347445825,252579,346858551,4916,587274,233887,20,261054,6754,3,821,144444.0,43333.0,-67.0,-73.0,-67.0,-70.0,-66.0,-72.0,-66.0,-70.0,-84.0,-93.0,-85.0,-91.0,17.0,20.0,18.0,21.0,1
1365,CC:2F:71:3E:C5:1F,3240928,409297764,11543,1411999,3229385,407885765,6,49224,4122865,40669,3109221,8555,1013644,12170,36,16542,190,6,853,130000.0,39000.0,-68.0,-71.0,-68.0,-61.0,-68.0,-73.0,-69.0,-62.0,-84.0,-93.0,-85.0,-91.0,16.0,22.0,17.0,30.0,1
1366,CC:2F:71:3F:1F:24,11850643,13633380027,8621258,13225494262,3229385,407885765,158,1950509,1140736853,1941816,1139692633,8693,1044220,1886346,675,8626058,918281,158,6635,130000.0,43333.0,-72.0,-64.0,-75.0,-69.0,-71.0,-64.0,-75.0,-69.0,-84.0,-93.0,-85.0,-91.0,12.0,29.0,10.0,22.0,1
1367,92:69:1D:31:68:E9,3256676,465474428,27288,57588401,3229388,407886027,0,12356,3818519,12242,3799756,114,18763,7961,1,27334,2049,0,140,229410.0,137640.0,-54.0,-52.0,-45.0,-50.0,-51.0,-50.0,-45.0,-49.0,-84.0,-93.0,-86.0,-92.0,30.0,41.0,41.0,42.0,1
1368,BA:8C:B9:54:50:24,3271464,503096076,42076,95210049,3229388,407886027,64,14698,4492211,14572,4471309,126,20902,9159,6,42054,9901,64,222,229410.0,137640.0,-46.0,-50.0,-54.0,-46.0,-50.0,-51.0,-45.0,-49.0,-84.0,-93.0,-86.0,-92.0,38.0,43.0,32.0,46.0,1
1369,62:47:05:9D:EB:15,3242800,439826118,13412,31940091,3229388,407886027,64,5523,1146720,5463,1136394,60,10326,2818,1,13395,2295,64,154,229410.0,137640.0,-43.0,-50.0,-43.0,-45.0,-46.0,-51.0,-48.0,-45.0,-84.0,-93.0,-86.0,-92.0,41.0,43.0,43.0,47.0,1
1370,F8:59:71:5A:E0:3D,3487784,797280623,258396,389394596,3229388,407886027,3,257590,347592139,252674,347004865,4916,587274,233981,20,261149,6756,3,821,144444.0,43333.0,-67.0,-74.0,-67.0,-71.0,-67.0,-73.0,-67.0,-70.0,-84.0,-93.0,-86.0,-92.0,17.0,19.0,19.0,21.0,1
1371,CC:2F:71:3E:C5:1F,3240932,409298299,11543,1411999,3229389,407886300,6,49226,4123005,40671,3109361,8555,1013644,12170,36,16543,190,6,853,130000.0,39000.0,-68.0,-71.0,-70.0,-61.0,-68.0,-71.0,-69.0,-62.0,-84.0,-93.0,-86.0,-92.0,16.0,22.0,16.0,31.0,1
1372,CC:2F:71:3F:1F:24,11852171,13635705364,8622780,13227818862,3229391,407886502,158,1950971,1141089902,1942278,1140045682,8693,1044220,1886782,675,8627612,918327,158,6635,130000.0,43333.0,-72.0,-65.0,-75.0,-69.0,-72.0,-65.0,-75.0,-69.0,-84.0,-93.0,-86.0,-92.0,12.0,28.0,11.0,23.0,1
1373,92:69:1D:31:68:E9,3256686,465475587,27288,57588401,3229398,407887186,0,12356,3818519,12242,3799756,114,18763,7961,1,27334,2049,0,140,229410.0,137640.0,-54.0,-52.0,-45.0,-50.0,-51.0,-50.0,-45.0,-49.0,-85.0,-93.0,-86.0,-92.0,31.0,41.0,41.0,42.0,1
1374,BA:8C:B9:54:50:24,3271475,503097351,42077,95210165,3229398,407887186,64,14705,4492725,14579,4471823,126,20902,9160,6,42055,9901,64,222,229410.0,137640.0,-53.0,-51.0,-38.0,-46.0,-49.0,-49.0,-42.0,-45.0,-85.0,-93.0,-86.0,-92.0,32.0,42.0,48.0,46.0,1
1375,62:47:05:9D:EB:15,3242810,439827277,13412,31940091,3229398,407887186,64,5523,1146720,5463,1136394,60,10326,2818,1,13395,2295,64,154,229410.0,137640.0,-43.0,-50.0,-43.0,-45.0,-46.0,-51.0,-48.0,-45.0,-85.0,-93.0,-86.0,-92.0,42.0,43.0,43.0,47.0,1
1376,F8:59:71:5A:E0:3D,3487879,797412989,258481,389525803,3229398,407887186,3,257675,347721733,252759,347134459,4916,587274,234066,20,261233,6758,3,821,144444.0,43333.0,-67.0,-73.0,-67.0,-70.0,-67.0,-73.0,-66.0,-70.0,-85.0,-93.0,-86.0,-92.0,18.0,20.0,19.0,22.0,1
1377,CC:2F:71:3E:C5:1F,3240941,409299185,11543,1411999,3229398,407887186,6,49226,4123005,40671,3109361,8555,1013644,12170,36,16543,190,6,853,130000.0,39000.0,-68.0,-71.0,-70.0,-61.0,-68.0,-71.0,-69.0,-62.0,-85.0,-93.0,-86.0,-92.0,17.0,22.0,16.0,31.0,1
1378,CC:2F:71:3F:1F:24,11853589,13637858138,8624191,13229970952,3229398,407887186,158,1951365,1141381466,1942672,1140337246,8693,1044220,1887174,675,8629024,918572,158,6636,130000.0,43333.0,-72.0,-65.0,-75.0,-69.0,-71.0,-64.0,-75.0,-68.0,-85.0,-93.0,-86.0,-92.0,13.0,28.0,11.0,23.0,1
1379,92:69:1D:31:68:E9,3256690,465475911,27288,57588401,3229402,407887510,0,12356,3818519,12242,3799756,114,18763,7961,1,27334,2049,0,140,229410.0,137640.0,-54.0,-52.0,-45.0,-50.0,-51.0,-50.0,-45.0,-49.0,-85.0,-93.0,-86.0,-92.0,31.0,41.0,41.0,42.0,1
1380,BA:8C:B9:54:50:24,3271479,503097675,42077,95210165,3229402,407887510,64,14705,4492725,14579,4471823,126,20902,9160,6,42055,9901,64,222,229410.0,137640.0,-53.0,-51.0,-38.0,-46.0,-49.0,-49.0,-42.0,-45.0,-85.0,-93.0,-86.0,-92.0,32.0,42.0,48.0,46.0,1
1381,62:47:05:9D:EB:15,3242816,439827803,13412,31940091,3229404,407887712,64,5523,1146720,5463,1136394,60,10326,2818,1,13395,2295,64,154,229410.0,137640.0,-43.0,-50.0,-43.0,-45.0,-46.0,-51.0,-48.0,-45.0,-85.0,-93.0,-86.0,-92.0,42.0,43.0,43.0,47.0,1
1382,F8:59:71:5A:E0:3D,3487982,797562810,258577,389674987,3229405,407887823,3,257774,347874263,252858,347286989,4916,587274,234163,20,261330,6762,3,821,144444.0,43333.0,-67.0,-73.0,-67.0,-70.0,-67.0,-73.0,-67.0,-70.0,-85.0,-93.0,-86.0,-92.0,18.0,20.0,19.0,22.0,1
1383,CC:2F:71:3E:C5:1F,3240948,409299822,11543,1411999,3229405,407887823,6,49228,4123193,40672,3109431,8556,1013762,12171,36,16543,190,6,853,130000.0,39000.0,-68.0,-71.0,-70.0,-61.0,-68.0,-72.0,-69.0,-62.0,-85.0,-93.0,-86.0,-92.0,17.0,22.0,16.0,31.0,1
1384,CC:2F:71:3F:1F:24,11854944,13639869805,8625536,13231981669,3229408,407888136,158,1951760,1141712075,1943067,1140667855,8693,1044220,1887568,675,8630369,918687,158,6636,130000.0,43333.0,-72.0,-64.0,-75.0,-69.0,-71.0,-64.0,-75.0,-69.0,-85.0,-93.0,-86.0,-92.0,13.0,29.0,11.0,23.0,1
1385,92:69:1D:31:68:E9,3256698,465476739,27288,57588401,3229410,407888338,0,12359,3818826,12244,3799892,115,18934,7962,1,27334,2049,0,140,229410.0,137640.0,-52.0,-54.0,-52.0,-56.0,-51.0,-51.0,-46.0,-50.0,-85.0,-93.0,-86.0,-92.0,33.0,39.0,34.0,36.0,1
1386,BA:8C:B9:54:50:24,3271487,503098503,42077,95210165,3229410,407888338,64,14710,4493168,14583,4472095,127,21073,9161,6,42055,9901,64,223,229410.0,137640.0,-53.0,-51.0,-38.0,-46.0,-49.0,-50.0,-42.0,-46.0,-85.0,-93.0,-86.0,-92.0,32.0,42.0,48.0,46.0,1
1387,62:47:05:9D:EB:15,3242822,439828429,13412,31940091,3229410,407888338,64,5523,1146720,5463,1136394,60,10326,2818,1,13395,2295,64,154,229410.0,137640.0,-43.0,-50.0,-43.0,-45.0,-46.0,-51.0,-48.0,-45.0,-85.0,-93.0,-86.0,-92.0,42.0,43.0,43.0,47.0,1
1388,F8:59:71:5A:E0:3D,3488074,797698523,258664,389810185,3229410,407888338,3,257863,348011393,252947,347424119,4916,587274,234250,20,261417,6775,3,821,144444.0,43333.0,-67.0,-73.0,-67.0,-71.0,-67.0,-73.0,-66.0,-70.0,-85.0,-93.0,-86.0,-92.0,18.0,20.0,19.0,21.0,1
1389,CC:2F:71:3E:C5:1F,3240953,409300337,11543,1411999,3229410,407888338,6,49228,4123193,40672,3109431,8556,1013762,12171,36,16543,190,6,853,130000.0,39000.0,-68.0,-71.0,-70.0,-61.0,-68.0,-72.0,-69.0,-62.0,-85.0,-93.0,-86.0,-92.0,17.0,22.0,16.0,31.0,1
1390,CC:2F:71:3F:1F:24,11856449,13642135709,8627038,13234247311,3229411,407888398,158,1952156,1142018963,1943463,1140974743,8693,1044220,1887956,675,8631871,918825,158,6636,130000.0,43333.0,-71.0,-64.0,-75.0,-69.0,-71.0,-64.0,-75.0,-69.0,-85.0,-93.0,-86.0,-92.0,14.0,29.0,11.0,23.0,1
1391,92:69:1D:31:68:E9,3256863,465883906,27444,57994700,3229419,407889206,0,12388,3825585,12273,3806651,115,18934,7982,1,27490,2050,0,140,216660.0,130000.0,-49.0,-49.0,-46.0,-49.0,-48.0,-49.0,-46.0,-49.0,-86.0,-93.0,-86.0,-91.0,37.0,44.0,40.0,42.0,1
1392,BA:8C:B9:54:50:24,3271496,503099371,42077,95210165,3229419,407889206,64,14710,4493168,14583,4472095,127,21073,9161,6,42055,9901,64,223,229410.0,137640.0,-53.0,-51.0,-38.0,-46.0,-49.0,-50.0,-42.0,-46.0,-86.0,-93.0,-87.0,-92.0,33.0,42.0,49.0,46.0,1
1393,62:47:05:9D:EB:15,3242832,439829451,13413,31940245,3229419,407889206,64,5547,1148410,5487,1138084,60,10326,2819,1,13396,2295,64,154,216660.0,130000.0,-51.0,-49.0,-51.0,-41.0,-43.0,-48.0,-44.0,-41.0,-86.0,-93.0,-87.0,-92.0,35.0,44.0,36.0,51.0,1
1394,F8:59:71:5A:E0:3D,3488210,797896749,258791,390007543,3229419,407889206,3,257990,348207813,253074,347620539,4916,587274,234376,20,261544,6794,3,822,144444.0,43333.0,-67.0,-74.0,-67.0,-71.0,-67.0,-74.0,-67.0,-71.0,-86.0,-93.0,-87.0,-92.0,19.0,19.0,20.0,21.0,1
1395,CC:2F:71:3E:C5:1F,3240962,409301205,11543,1411999,3229419,407889206,6,49228,4123193,40672,3109431,8556,1013762,12171,36,16543,190,6,853,130000.0,39000.0,-68.0,-71.0,-70.0,-61.0,-68.0,-72.0,-69.0,-62.0,-86.0,-93.0,-87.0,-92.0,18.0,22.0,17.0,31.0,1
1396,CC:2F:71:3F:1F:24,11857968,13644421665,8628549,13236532459,3229419,407889206,158,1952661,1142467899,1943968,1141423679,8693,1044220,1888437,675,8633382,919027,158,6636,130000.0,43333.0,-71.0,-64.0,-72.0,-68.0,-71.0,-64.0,-74.0,-68.0,-86.0,-93.0,-87.0,-92.0,15.0,29.0,15.0,24.0,1
1397,92:69:1D:31:68:E9,3256868,465884370,27444,57994700,3229424,407889670,0,12389,3825653,12274,3806719,115,18934,7982,1,27490,2050,0,140,216660.0,130000.0,-53.0,-51.0,-46.0,-50.0,-49.0,-50.0,-46.0,-49.0,-86.0,-93.0,-87.0,-92.0,33.0,42.0,41.0,42.0,1
1398,BA:8C:B9:54:50:24,3271505,503100239,42077,95210165,3229428,407890074,64,14710,4493168,14583,4472095,127,21073,9161,6,42055,9901,64,223,229410.0,137640.0,-53.0,-51.0,-38.0,-46.0,-49.0,-50.0,-42.0,-46.0,-87.0,-93.0,-87.0,-92.0,34.0,42.0,49.0,46.0,1
1399,62:47:05:9D:EB:15,3242841,439830319,13413,31940245,3229428,407890074,64,5547,1148410,5487,1138084,60,10326,2819,1,13396,2295,64,154,216660.0,130000.0,-51.0,-49.0,-51.0,-41.0,-43.0,-48.0,-44.0,-41.0,-87.0,-93.0,-87.0,-92.0,36.0,44.0,36.0,51.0,1
1400,F8:59:71:5A:E0:3D,3488376,798138719,258948,390248645,3229428,407890074,3,258149,348451051,253233,347863777,4916,587274,234519,20,261701,6795,3,824,144444.0,43333.0,-67.0,-73.0,-67.0,-70.0,-67.0,-73.0,-66.0,-70.0,-87.0,-93.0,-87.0,-92.0,20.0,20.0,20.0,22.0,1
1401,CC:2F:71:3E:C5:1F,3240971,409302073,11543,1411999,3229428,407890074,6,49228,4123193,40672,3109431,8556,1013762,12171,36,16543,190,6,853,130000.0,39000.0,-68.0,-71.0,-70.0,-61.0,-68.0,-72.0,-69.0,-62.0,-87.0,-93.0,-87.0,-92.0,19.0,22.0,17.0,31.0,1
1402,CC:2F:71:3F:1F:24,11859553,13646818455,8630123,13238928179,3229430,407890276,158,1953202,1142991497,1944509,1141947277,8693,1044220,1888978,675,8634956,919482,158,6637,117000.0,39000.0,-71.0,-64.0,-75.0,-69.0,-71.0,-64.0,-74.0,-68.0,-87.0,-93.0,-87.0,-92.0,16.0,29.0,12.0,23.0,1
1403,92:69:1D:31:68:E9,3256879,465885491,27444,57994700,3229435,407890791,0,12389,3825653,12274,3806719,115,18934,7982,1,27490,2050,0,140,216660.0,130000.0,-53.0,-51.0,-46.0,-50.0,-49.0,-50.0,-46.0,-49.0,-87.0,-93.0,-87.0,-92.0,34.0,42.0,41.0,42.0,1
1404,BA:8C:B9:54:50:24,3271514,503101158,42077,95210165,3229437,407890993,64,14710,4493168,14583,4472095,127,21073,9161,6,42055,9901,64,223,229410.0,137640.0,-53.0,-51.0,-38.0,-46.0,-49.0,-50.0,-42.0,-46.0,-87.0,-93.0,-87.0,-92.0,34.0,42.0,49.0,46.0,1
1405,62:47:05:9D:EB:15,3242853,439831925,13416,31940932,3229437,407890993,64,5573,1154017,5512,1143520,61,10497,2824,1,13399,2295,64,156,216660.0,130000.0,-43.0,-50.0,-43.0,-44.0,-42.0,-49.0,-45.0,-41.0,-87.0,-93.0,-87.0,-92.0,44.0,43.0,44.0,48.0,1
1406,F8:59:71:5A:E0:3D,3488475,798279498,259038,390388505,3229437,407890993,3,258240,348591205,253324,348003931,4916,587274,234609,20,261791,6797,3,824,144444.0,43333.0,-67.0,-73.0,-66.0,-70.0,-67.0,-73.0,-66.0,-70.0,-87.0,-93.0,-87.0,-92.0,20.0,20.0,21.0,22.0,1
1407,CC:2F:71:3E:C5:1F,3240981,409303052,11543,1411999,3229438,407891053,6,49228,4123193,40672,3109431,8556,1013762,12171,36,16543,190,6,853,130000.0,39000.0,-68.0,-71.0,-70.0,-61.0,-68.0,-72.0,-69.0,-62.0,-87.0,-93.0,-87.0,-92.0,19.0,22.0,17.0,31.0,1
1408,CC:2F:71:3F:1F:24,11861108,13649188856,8631670,13241297803,3229438,407891053,158,1953586,1143287835,1944893,1142243615,8693,1044220,1889362,675,8636500,919547,158,6637,130000.0,43333.0,-72.0,-64.0,-75.0,-69.0,-71.0,-64.0,-74.0,-68.0,-87.0,-93.0,-88.0,-92.0,15.0,29.0,13.0,23.0,1
1409,92:69:1D:31:68:E9,3256884,465885955,27444,57994700,3229440,407891255,0,12389,3825653,12274,3806719,115,18934,7982,1,27490,2050,0,140,216660.0,130000.0,-53.0,-51.0,-46.0,-50.0,-49.0,-50.0,-46.0,-49.0,-87.0,-93.0,-88.0,-92.0,34.0,42.0,42.0,42.0,1
1410,BA:8C:B9:54:50:24,3271517,503101420,42077,95210165,3229440,407891255,64,14710,4493168,14583,4472095,127,21073,9161,6,42055,9901,64,223,229410.0,137640.0,-53.0,-51.0,-38.0,-46.0,-49.0,-50.0,-42.0,-46.0,-87.0,-93.0,-88.0,-92.0,34.0,42.0,50.0,46.0,1
1411,62:47:05:9D:EB:15,3242859,439832543,13417,31941086,3229442,407891457,64,5597,1155707,5536,1145210,61,10497,2825,1,13400,2295,64,156,216660.0,130000.0,-51.0,-50.0,-51.0,-41.0,-43.0,-48.0,-45.0,-40.0,-87.0,-93.0,-88.0,-92.0,36.0,43.0,37.0,51.0,1
1412,F8:59:71:5A:E0:3D,3488564,798410498,259122,390519041,3229442,407891457,3,258326,348723673,253410,348136399,4916,587274,234693,20,261875,6798,3,824,144444.0,43333.0,-67.0,-73.0,-67.0,-71.0,-67.0,-73.0,-66.0,-70.0,-87.0,-93.0,-88.0,-92.0,20.0,20.0,21.0,21.0,1
1413,CC:2F:71:3E:C5:1F,3240985,409303456,11543,1411999,3229442,407891457,6,49228,4123193,40672,3109431,8556,1013762,12171,36,16543,190,6,853,130000.0,39000.0,-68.0,-71.0,-70.0,-61.0,-68.0,-72.0,-69.0,-62.0,-87.0,-93.0,-88.0,-92.0,19.0,22.0,18.0,31.0,1
1414,CC:2F:71:3F:1F:24,11862573,13651421136,8633131,13243529679,3229442,407891457,158,1953943,1143566457,1945250,1142522237,8693,1044220,1889719,675,8637964,919717,158,6638,130000.0,43333.0,-73.0,-65.0,-76.0,-70.0,-73.0,-65.0,-75.0,-69.0,-87.0,-93.0,-88.0,-92.0,14.0,28.0,12.0,22.0,1
1415,92:69:1D:31:68:E9,3256890,465886561,27444,57994700,3229446,407891861,0,12389,3825653,12274,3806719,115,18934,7982,1,27490,2050,0,140,216660.0,130000.0,-53.0,-51.0,-46.0,-50.0,-49.0,-50.0,-46.0,-49.0,-87.0,-93.0,-88.0,-92.0,34.0,42.0,42.0,42.0,1
1416,BA:8C:B9:54:50:24,3271528,503112920,42082,95221059,3229446,407891861,64,14714,4496681,14587,4475608,127,21073,9163,6,42060,9901,64,223,229410.0,137640.0,-51.0,-51.0,-44.0,-49.0,-50.0,-51.0,-44.0,-47.0,-87.0,-93.0,-88.0,-92.0,36.0,42.0,44.0,43.0,1
1417,62:47:05:9D:EB:15,3242863,439832947,13417,31941086,3229446,407891861,64,5597,1155707,5536,1145210,61,10497,2825,1,13400,2295,64,156,216660.0,130000.0,-51.0,-50.0,-51.0,-41.0,-43.0,-48.0,-45.0,-40.0,-87.0,-93.0,-88.0,-92.0,36.0,43.0,37.0,51.0,1
1418,F8:59:71:5A:E0:3D,3488651,798539716,259205,390647855,3229446,407891861,3,258412,348856155,253496,348268881,4916,587274,234776,20,261958,6798,3,824,144444.0,43333.0,-67.0,-73.0,-66.0,-70.0,-67.0,-73.0,-66.0,-70.0,-87.0,-93.0,-88.0,-92.0,20.0,20.0,22.0,22.0,1
1419,CC:2F:71:3E:C5:1F,3240989,409303860,11543,1411999,3229446,407891861,6,49228,4123193,40672,3109431,8556,1013762,12171,36,16543,190,6,853,130000.0,39000.0,-68.0,-71.0,-70.0,-61.0,-68.0,-72.0,-69.0,-62.0,-87.0,-93.0,-88.0,-92.0,19.0,22.0,18.0,31.0,1
1420,CC:2F:71:3F:1F:24,11864375,13654178256,8634929,13246286395,3229446,407891861,158,1954377,1143867618,1945684,1142823398,8693,1044220,1890153,675,8639762,919859,158,6638,130000.0,43333.0,-73.0,-65.0,-75.0,-70.0,-72.0,-64.0,-75.0,-69.0,-87.0,-93.0,-88.0,-92.0,14.0,28.0,13.0,22.0,1
1421,92:69:1D:31:68:E9,3256895,465887025,27444,57994700,3229451,407892325,0,12389,3825653,12274,3806719,115,18934,7982,1,27490,2050,0,140,216660.0,130000.0,-53.0,-51.0,-46.0,-50.0,-49.0,-50.0,-46.0,-49.0,-88.0,-93.0,-88.0,-92.0,35.0,42.0,42.0,42.0,1
1422,BA:8C:B9:54:50:24,3271887,504043677,42436,96151352,3229451,407892325,64,14771,4503608,14644,4482535,127,21073,9206,6,42414,9918,64,223,229410.0,137640.0,-47.0,-50.0,-54.0,-46.0,-49.0,-50.0,-43.0,-47.0,-88.0,-93.0,-88.0,-92.0,41.0,43.0,34.0,46.0,1
1423,62:47:05:9D:EB:15,3242869,439833586,13417,31941086,3229452,407892500,64,5597,1155707,5536,1145210,61,10497,2825,1,13400,2295,64,156,216660.0,130000.0,-51.0,-50.0,-51.0,-41.0,-43.0,-48.0,-45.0,-40.0,-88.0,-93.0,-88.0,-92.0,37.0,43.0,37.0,51.0,1
1424,F8:59:71:5A:E0:3D,3488747,798677309,259293,390784607,3229454,407892702,3,258501,348993229,253585,348405955,4916,587274,234864,20,262046,6802,3,824,144444.0,43333.0,-67.0,-73.0,-66.0,-70.0,-67.0,-73.0,-66.0,-70.0,-88.0,-93.0,-88.0,-92.0,21.0,20.0,22.0,22.0,1
1425,CC:2F:71:3E:C5:1F,3240999,409304903,11543,1411999,3229456,407892904,6,49228,4123193,40672,3109431,8556,1013762,12171,36,16543,190,6,853,130000.0,39000.0,-68.0,-71.0,-70.0,-61.0,-68.0,-72.0,-69.0,-62.0,-88.0,-93.0,-88.0,-92.0,20.0,22.0,18.0,31.0,1
1426,CC:2F:71:3F:1F:24,11865503,13655869369,8636047,13247976465,3229456,407892904,158,1954734,1144157559,1946041,1143113339,8693,1044220,1890507,675,8640864,919877,158,6638,130000.0,43333.0,-73.0,-65.0,-75.0,-70.0,-73.0,-65.0,-75.0,-69.0,-88.0,-93.0,-88.0,-92.0,15.0,28.0,13.0,22.0,1
1427,92:69:1D:31:68:E9,3256931,465957978,27472,58064555,3229459,407893423,0,12403,3827216,12287,3808047,116,19169,7988,1,27518,2050,0,140,229410.0,130000.0,-54.0,-50.0,-44.0,-50.0,-50.0,-49.0,-45.0,-50.0,-88.0,-93.0,-88.0,-92.0,34.0,43.0,44.0,42.0,1
1428,BA:8C:B9:54:50:24,3271895,504044775,42436,96151352,3229459,407893423,64,14771,4503608,14644,4482535,127,21073,9206,6,42414,9918,64,223,229410.0,137640.0,-47.0,-50.0,-54.0,-46.0,-49.0,-50.0,-43.0,-47.0,-88.0,-93.0,-88.0,-92.0,41.0,43.0,34.0,46.0,1
1429,62:47:05:9D:EB:15,3242879,439835259,13420,31941836,3229459,407893423,64,5630,1158159,5569,1147662,61,10497,2828,1,13403,2295,64,156,216660.0,130000.0,-43.0,-50.0,-44.0,-44.0,-42.0,-48.0,-44.0,-40.0,-88.0,-93.0,-88.0,-92.0,45.0,43.0,44.0,48.0,1
1430,F8:59:71:5A:E0:3D,3488839,798810322,259378,390916697,3229461,407893625,3,258586,349124199,253670,348536925,4916,587274,234949,20,262131,6802,3,824,144444.0,43333.0,-67.0,-73.0,-67.0,-70.0,-67.0,-73.0,-66.0,-70.0,-88.0,-93.0,-88.0,-92.0,21.0,20.0,21.0,22.0,1
1431,CC:2F:71:3E:C5:1F,3241004,409305624,11543,1411999,3229461,407893625,6,49228,4123193,40672,3109431,8556,1013762,12171,36,16543,190,6,853,130000.0,39000.0,-68.0,-71.0,-70.0,-61.0,-68.0,-72.0,-69.0,-62.0,-88.0,-93.0,-88.0,-92.0,20.0,22.0,18.0,31.0,1
1432,CC:2F:71:3F:1F:24,11867007,13658134192,8637544,13250240365,3229463,407893827,158,1955153,1144455621,1946460,1143411401,8693,1044220,1890922,675,8642377,920036,158,6638,130000.0,43333.0,-73.0,-65.0,-76.0,-69.0,-73.0,-65.0,-75.0,-69.0,-88.0,-93.0,-88.0,-92.0,15.0,28.0,12.0,23.0,1
1433,92:69:1D:31:68:E9,3256940,465958846,27472,58064555,3229468,407894291,0,12403,3827216,12287,3808047,116,19169,7988,1,27518,2050,0,140,229410.0,130000.0,-54.0,-50.0,-44.0,-50.0,-50.0,-49.0,-45.0,-50.0,-88.0,-93.0,-88.0,-92.0,34.0,43.0,44.0,42.0,1
1434,BA:8C:B9:54:50:24,3271904,504045643,42436,96151352,3229468,407894291,64,14771,4503608,14644,4482535,127,21073,9206,6,42414,9918,64,223,229410.0,137640.0,-47.0,-50.0,-54.0,-46.0,-49.0,-50.0,-43.0,-47.0,-88.0,-93.0,-88.0,-92.0,41.0,43.0,34.0,46.0,1
1435,62:47:05:9D:EB:15,3242888,439836127,13420,31941836,3229468,407894291,64,5630,1158159,5569,1147662,61,10497,2828,1,13403,2295,64,156,216660.0,130000.0,-43.0,-50.0,-44.0,-44.0,-42.0,-48.0,-44.0,-40.0,-88.0,-93.0,-88.0,-92.0,45.0,43.0,44.0,48.0,1
1436,F8:59:71:5A:E0:3D,3488933,798946186,259465,391051895,3229468,407894291,3,258675,349261315,253759,348674041,4916,587274,235037,20,262218,6803,3,824,144444.0,43333.0,-67.0,-73.0,-67.0,-70.0,-67.0,-73.0,-66.0,-70.0,-88.0,-93.0,-88.0,-92.0,21.0,20.0,21.0,22.0,1
1437,CC:2F:71:3E:C5:1F,3241011,409306290,11543,1411999,3229468,407894291,6,49228,4123193,40672,3109431,8556,1013762,12171,36,16543,190,6,853,130000.0,39000.0,-68.0,-71.0,-70.0,-61.0,-68.0,-72.0,-69.0,-62.0,-88.0,-93.0,-88.0,-92.0,20.0,22.0,18.0,31.0,1
1438,CC:2F:71:3F:1F:24,11869020,13661237280,8639552,13253342989,3229468,407894291,158,1955595,1144762627,1946902,1143718407,8693,1044220,1891364,675,8644385,920110,158,6638,130000.0,43333.0,-72.0,-63.0,-74.0,-69.0,-72.0,-63.0,-74.0,-69.0,-88.0,-93.0,-88.0,-92.0,16.0,30.0,14.0,23.0,1
1439,92:69:1D:31:68:E9,3256945,465959366,27473,58064671,3229472,407894695,0,12405,3827352,12289,3808183,116,19169,7988,1,27519,2050,0,140,229410.0,130000.0,-54.0,-51.0,-44.0,-50.0,-51.0,-50.0,-45.0,-50.0,-89.0,-93.0,-89.0,-92.0,35.0,42.0,45.0,42.0,1
1440,BA:8C:B9:54:50:24,3271909,504046163,42437,96151468,3229472,407894695,64,14775,4503880,14648,4482807,127,21073,9206,6,42415,9918,64,224,216660.0,130000.0,-53.0,-51.0,-38.0,-46.0,-50.0,-51.0,-44.0,-47.0,-89.0,-93.0,-89.0,-92.0,36.0,42.0,51.0,46.0,1
1441,62:47:05:9D:EB:15,3242893,439836647,13421,31941952,3229472,407894695,64,5681,1161627,5620,1151130,61,10497,2828,1,13404,2295,64,157,216660.0,130000.0,-50.0,-49.0,-51.0,-41.0,-43.0,-48.0,-44.0,-41.0,-89.0,-93.0,-89.0,-92.0,39.0,44.0,38.0,51.0,1
1442,F8:59:71:5A:E0:3D,3489042,799108322,259570,391213627,3229472,407894695,3,258779,349421573,253863,348834299,4916,587274,235140,20,262323,6804,3,824,144444.0,43333.0,-67.0,-73.0,-67.0,-70.0,-67.0,-73.0,-67.0,-70.0,-89.0,-93.0,-89.0,-92.0,22.0,20.0,22.0,22.0,1
1443,CC:2F:71:3E:C5:1F,3241020,409307214,11544,1412115,3229476,407895099,6,49230,4123333,40674,3109571,8556,1013762,12171,36,16544,190,6,853,130000.0,39000.0,-68.0,-71.0,-70.0,-60.0,-69.0,-72.0,-70.0,-62.0,-89.0,-93.0,-89.0,-92.0,21.0,22.0,19.0,32.0,1
1444,CC:2F:71:3F:1F:24,11870718,13663817382,8641241,13255922223,3229477,407895159,158,1956026,1145123459,1947333,1144079239,8693,1044220,1891795,675,8646074,920238,158,6640,130000.0,43333.0,-73.0,-64.0,-75.0,-69.0,-72.0,-64.0,-74.0,-69.0,-89.0,-93.0,-89.0,-92.0,16.0,29.0,14.0,23.0,1
1445,92:69:1D:31:68:E9,3256952,465959954,27473,58064671,3229479,407895283,0,12408,3827610,12291,3808319,117,19291,7989,1,27519,2050,0,140,229410.0,130000.0,-54.0,-50.0,-44.0,-50.0,-52.0,-50.0,-44.0,-49.0,-89.0,-93.0,-89.0,-92.0,35.0,43.0,45.0,42.0,1
1446,BA:8C:B9:54:50:24,3271916,504046751,42437,96151468,3229479,407895283,64,14775,4503880,14648,4482807,127,21073,9206,6,42415,9918,64,224,216660.0,130000.0,-53.0,-51.0,-38.0,-46.0,-50.0,-51.0,-44.0,-47.0,-89.0,-93.0,-89.0,-92.0,36.0,42.0,51.0,46.0,1
1447,62:47:05:9D:EB:15,3242902,439837437,13421,31941952,3229481,407895485,64,5681,1161627,5620,1151130,61,10497,2828,1,13404,2295,64,157,216660.0,130000.0,-50.0,-49.0,-51.0,-41.0,-43.0,-48.0,-44.0,-41.0,-89.0,-93.0,-89.0,-92.0,39.0,44.0,38.0,51.0,1
1448,F8:59:71:5A:E0:3D,3489140,799247418,259659,391351933,3229481,407895485,3,258869,349560173,253953,348972899,4916,587274,235230,20,262412,6809,3,824,144444.0,43333.0,-67.0,-73.0,-67.0,-70.0,-67.0,-73.0,-67.0,-70.0,-89.0,-93.0,-89.0,-92.0,22.0,20.0,22.0,22.0,1
1449,CC:2F:71:3E:C5:1F,3241027,409307802,11544,1412115,3229483,407895687,6,49233,4123639,40675,3109641,8558,1013998,12172,36,16544,190,6,854,130000.0,39000.0,-68.0,-70.0,-69.0,-60.0,-70.0,-74.0,-71.0,-63.0,-89.0,-93.0,-89.0,-92.0,21.0,23.0,20.0,32.0,1
1450,CC:2F:71:3F:1F:24,11872096,13665902062,8642613,13258006375,3229483,407895687,158,1956395,1145418228,1947702,1144374008,8693,1044220,1892164,675,8647446,920265,158,6640,130000.0,43333.0,-73.0,-64.0,-75.0,-69.0,-73.0,-64.0,-75.0,-70.0,-89.0,-93.0,-89.0,-92.0,16.0,29.0,14.0,23.0,1
1451,92:69:1D:31:68:E9,3257077,466263194,27588,58366654,3229489,407896540,0,12429,3832950,12312,3813659,117,19291,8006,1,27634,2051,0,140,229410.0,137640.0,-52.0,-52.0,-51.0,-56.0,-50.0,-50.0,-45.0,-49.0,-90.0,-93.0,-89.0,-93.0,38.0,41.0,38.0,37.0,1
1452,BA:8C:B9:54:50:24,3271927,504048070,42437,96151468,3229490,407896602,64,14778,4504138,14650,4482943,128,21195,9207,6,42415,9918,64,225,216660.0,130000.0,-47.0,-50.0,-54.0,-46.0,-50.0,-52.0,-48.0,-47.0,-90.0,-93.0,-89.0,-93.0,43.0,43.0,35.0,47.0,1
1453,62:47:05:9D:EB:15,3242914,439839133,13423,31942471,3229491,407896662,64,5708,1163773,5647,1153276,61,10497,2830,1,13406,2295,64,157,216660.0,130000.0,-43.0,-50.0,-44.0,-44.0,-46.0,-51.0,-47.0,-45.0,-90.0,-93.0,-89.0,-93.0,47.0,43.0,45.0,49.0,1
1454,F8:59:71:5A:E0:3D,3489263,799422759,259772,391526097,3229491,407896662,3,258983,349734579,254067,349147305,4916,587274,235342,20,262525,6810,3,824,144444.0,43333.0,-67.0,-73.0,-67.0,-71.0,-67.0,-73.0,-66.0,-70.0,-90.0,-93.0,-89.0,-93.0,23.0,20.0,22.0,22.0,1
1455,CC:2F:71:3E:C5:1F,3241035,409308777,11544,1412115,3229491,407896662,6,49233,4123639,40675,3109641,8558,1013998,12172,36,16544,190,6,854,130000.0,39000.0,-68.0,-70.0,-69.0,-60.0,-70.0,-74.0,-71.0,-63.0,-90.0,-93.0,-89.0,-93.0,22.0,23.0,20.0,33.0,1
1456,CC:2F:71:3F:1F:24,11873189,13667543343,8643698,13259646681,3229491,407896662,158,1956791,1145783902,1948098,1144739682,8693,1044220,1892551,675,8648530,920308,158,6641,130000.0,43333.0,-73.0,-64.0,-75.0,-69.0,-72.0,-64.0,-74.0,-69.0,-90.0,-93.0,-89.0,-93.0,17.0,29.0,14.0,24.0,1
1457,92:69:1D:31:68:E9,3257086,466264285,27589,58366770,3229497,407897515,0,12440,3833736,12323,3814445,117,19291,8007,1,27635,2051,0,140,229410.0,137640.0,-54.0,-50.0,-45.0,-51.0,-50.0,-51.0,-47.0,-52.0,-90.0,-93.0,-89.0,-93.0,36.0,43.0,44.0,42.0,1
1458,BA:8C:B9:54:50:24,3271934,504048983,42437,96151468,3229497,407897515,64,14779,4504206,14651,4483011,128,21195,9207,6,42415,9918,64,225,216660.0,130000.0,-47.0,-50.0,-54.0,-46.0,-50.0,-52.0,-48.0,-47.0,-90.0,-93.0,-89.0,-93.0,43.0,43.0,35.0,47.0,1
1459,62:47:05:9D:EB:15,3242920,439839986,13423,31942471,3229497,407897515,64,5708,1163773,5647,1153276,61,10497,2830,1,13406,2295,64,157,216660.0,130000.0,-43.0,-50.0,-44.0,-44.0,-46.0,-51.0,-47.0,-45.0,-90.0,-93.0,-89.0,-93.0,47.0,43.0,45.0,49.0,1
1460,F8:59:71:5A:E0:3D,3489353,799551242,259854,391653525,3229499,407897717,3,259066,349862413,254150,349275139,4916,587274,235424,20,262607,6810,3,824,144444.0,43333.0,-67.0,-73.0,-67.0,-70.0,-67.0,-73.0,-66.0,-70.0,-90.0,-93.0,-89.0,-93.0,23.0,20.0,22.0,23.0,1
1461,CC:2F:71:3E:C5:1F,3241049,409310691,11548,1412772,3229501,407897919,6,49239,4124454,40681,3110456,8558,1013998,12177,36,16548,190,6,856,144444.0,39000.0,-68.0,-71.0,-70.0,-60.0,-69.0,-72.0,-70.0,-61.0,-90.0,-93.0,-89.0,-93.0,22.0,22.0,19.0,33.0,1
1462,CC:2F:71:3F:1F:24,11875734,13671471822,8646233,13263573903,3229501,407897919,158,1957260,1146084374,1948567,1145040154,8693,1044220,1893018,675,8651011,920415,158,6642,117000.0,39000.0,-74.0,-64.0,-74.0,-69.0,-74.0,-64.0,-73.0,-69.0,-90.0,-93.0,-90.0,-93.0,16.0,29.0,16.0,24.0,1
1463,92:69:1D:31:68:E9,3257094,466265340,27589,58366770,3229505,407898570,0,12440,3833736,12323,3814445,117,19291,8007,1,27635,2051,0,140,229410.0,137640.0,-54.0,-50.0,-45.0,-51.0,-50.0,-51.0,-47.0,-52.0,-90.0,-93.0,-90.0,-93.0,36.0,43.0,45.0,42.0,1
1464,BA:8C:B9:54:50:24,3271942,504050038,42437,96151468,3229505,407898570,64,14779,4504206,14651,4483011,128,21195,9207,6,42415,9918,64,225,216660.0,130000.0,-47.0,-50.0,-54.0,-46.0,-50.0,-52.0,-48.0,-47.0,-90.0,-93.0,-90.0,-93.0,43.0,43.0,36.0,47.0,1
1465,62:47:05:9D:EB:15,3242930,439841243,13423,31942471,3229507,407898772,64,5708,1163773,5647,1153276,61,10497,2830,1,13406,2295,64,157,216660.0,130000.0,-43.0,-50.0,-44.0,-44.0,-46.0,-51.0,-47.0,-45.0,-90.0,-93.0,-90.0,-93.0,47.0,43.0,46.0,49.0,1
1466,F8:59:71:5A:E0:3D,3489446,799684387,259939,391785615,3229507,407898772,3,259155,349999571,254239,349412297,4916,587274,235510,20,262692,6817,3,824,144444.0,43333.0,-67.0,-73.0,-67.0,-70.0,-67.0,-73.0,-67.0,-70.0,-90.0,-93.0,-90.0,-93.0,23.0,20.0,23.0,23.0,1
1467,CC:2F:71:3E:C5:1F,3241056,409311604,11548,1412772,3229508,407898832,6,49239,4124454,40681,3110456,8558,1013998,12177,36,16548,190,6,856,144444.0,39000.0,-68.0,-71.0,-70.0,-60.0,-69.0,-72.0,-70.0,-61.0,-90.0,-93.0,-90.0,-93.0,22.0,22.0,20.0,33.0,1
1468,CC:2F:71:3F:1F:24,11877133,13673568697,8647625,13265669865,3229508,407898832,158,1957649,1146368668,1948956,1145324448,8693,1044220,1893407,675,8652458,920624,158,6642,130000.0,43333.0,-74.0,-64.0,-74.0,-70.0,-74.0,-64.0,-74.0,-69.0,-90.0,-93.0,-90.0,-93.0,16.0,29.0,16.0,23.0,1
1469,92:69:1D:31:68:E9,3257103,466266455,27589,58366770,3229514,407899685,0,12440,3833736,12323,3814445,117,19291,8007,1,27635,2051,0,140,229410.0,137640.0,-54.0,-50.0,-45.0,-51.0,-50.0,-51.0,-47.0,-52.0,-90.0,-93.0,-90.0,-92.0,36.0,43.0,45.0,41.0,1
1470,BA:8C:B9:54:50:24,3271951,504051153,42437,96151468,3229514,407899685,64,14779,4504206,14651,4483011,128,21195,9207,6,42415,9918,64,225,216660.0,130000.0,-47.0,-50.0,-54.0,-46.0,-50.0,-52.0,-48.0,-47.0,-90.0,-93.0,-90.0,-92.0,43.0,43.0,36.0,46.0,1
1471,62:47:05:9D:EB:15,3242940,439842624,13426,31942939,3229514,407899685,64,5755,1167267,5694,1156770,61,10497,2833,1,13409,2295,64,157,216660.0,130000.0,-43.0,-49.0,-44.0,-44.0,-42.0,-47.0,-44.0,-40.0,-90.0,-93.0,-90.0,-92.0,47.0,44.0,46.0,48.0,1
1472,F8:59:71:5A:E0:3D,3489535,799812728,260021,391913043,3229514,407899685,3,259235,350122771,254319,349535497,4916,587274,235590,20,262774,6818,3,824,144444.0,43333.0,-67.0,-73.0,-67.0,-70.0,-67.0,-73.0,-67.0,-70.0,-90.0,-93.0,-90.0,-92.0,23.0,20.0,23.0,22.0,1
1473,CC:2F:71:3E:C5:1F,3241062,409312457,11548,1412772,3229514,407899685,6,49239,4124454,40681,3110456,8558,1013998,12177,36,16548,190,6,856,144444.0,39000.0,-68.0,-71.0,-70.0,-60.0,-69.0,-72.0,-70.0,-61.0,-90.0,-93.0,-90.0,-92.0,22.0,22.0,20.0,32.0,1
1474,CC:2F:71:3F:1F:24,11878959,13676362761,8649445,13268463076,3229514,407899685,158,1958085,1146677890,1949392,1145633670,8693,1044220,1893841,675,8654278,920678,158,6643,130000.0,43333.0,-74.0,-64.0,-74.0,-69.0,-74.0,-64.0,-73.0,-69.0,-90.0,-93.0,-90.0,-92.0,16.0,29.0,16.0,23.0,1
1475,92:69:1D:31:68:E9,3257113,466270347,27595,58370258,3229518,407900089,0,12448,3836741,12331,3817450,117,19291,8012,1,27641,2051,0,140,229410.0,137640.0,-53.0,-51.0,-45.0,-51.0,-50.0,-49.0,-45.0,-49.0,-90.0,-92.0,-89.0,-92.0,37.0,41.0,44.0,41.0,1
1476,BA:8C:B9:54:50:24,3271993,504096108,42475,96196019,3229518,407900089,64,14799,4509037,14671,4487842,128,21195,9216,6,42453,9918,64,227,216660.0,130000.0,-47.0,-50.0,-54.0,-46.0,-52.0,-54.0,-47.0,-52.0,-90.0,-92.0,-89.0,-92.0,43.0,42.0,35.0,46.0,1
1477,62:47:05:9D:EB:15,3243256,440662073,13737,32761924,3229519,407900149,64,5822,1177210,5761,1166713,61,10497,2864,1,13719,2295,64,158,229410.0,137640.0,-47.0,-52.0,-48.0,-46.0,-46.0,-51.0,-47.0,-45.0,-90.0,-92.0,-89.0,-92.0,43.0,40.0,41.0,46.0,1
1478,F8:59:71:5A:E0:3D,3489650,799981226,260129,392080875,3229521,407900351,3,259347,350295265,254431,349707991,4916,587274,235701,20,262882,6828,3,824,144444.0,43333.0,-67.0,-73.0,-67.0,-71.0,-67.0,-73.0,-67.0,-70.0,-90.0,-92.0,-89.0,-92.0,23.0,19.0,22.0,21.0,1
1479,CC:2F:71:3E:C5:1F,3241071,409313325,11548,1412772,3229523,407900553,6,49239,4124454,40681,3110456,8558,1013998,12177,36,16548,190,6,856,144444.0,39000.0,-68.0,-71.0,-70.0,-60.0,-69.0,-72.0,-70.0,-61.0,-90.0,-92.0,-89.0,-92.0,22.0,21.0,19.0,32.0,1
1480,CC:2F:71:3F:1F:24,11880539,13678765350,8651016,13270864797,3229523,407900553,158,1958499,1147031943,1949806,1145987723,8693,1044220,1894248,675,8655808,920891,158,6643,130000.0,43333.0,-74.0,-64.0,-73.0,-69.0,-74.0,-64.0,-72.0,-68.0,-90.0,-92.0,-89.0,-92.0,16.0,28.0,16.0,23.0,1
1481,92:69:1D:31:68:E9,3257121,466271075,27595,58370258,3229526,407900817,0,12449,3836809,12332,3817518,117,19291,8012,1,27641,2051,0,140,229410.0,137640.0,-54.0,-51.0,-45.0,-51.0,-51.0,-49.0,-44.0,-49.0,-90.0,-92.0,-89.0,-92.0,36.0,41.0,44.0,41.0,1
1482,BA:8C:B9:54:50:24,3272001,504096836,42475,96196019,3229526,407900817,64,14799,4509037,14671,4487842,128,21195,9216,6,42453,9918,64,227,216660.0,130000.0,-47.0,-50.0,-54.0,-46.0,-52.0,-54.0,-47.0,-52.0,-90.0,-92.0,-89.0,-92.0,43.0,42.0,35.0,46.0,1
1483,62:47:05:9D:EB:15,3243265,440662943,13737,32761924,3229528,407901019,64,5841,1178502,5780,1168005,61,10497,2864,1,13720,2295,64,159,229410.0,137640.0,-43.0,-49.0,-43.0,-44.0,-42.0,-48.0,-43.0,-41.0,-90.0,-92.0,-89.0,-92.0,47.0,43.0,46.0,48.0,1
1484,F8:59:71:5A:E0:3D,3489738,800107768,260210,392206749,3229528,407901019,3,259428,350420019,254512,349832745,4916,587274,235781,20,262963,6828,3,824,144444.0,43333.0,-67.0,-73.0,-67.0,-71.0,-67.0,-73.0,-67.0,-70.0,-90.0,-92.0,-89.0,-92.0,23.0,19.0,22.0,21.0,1
1485,CC:2F:71:3E:C5:1F,3241077,409314064,11548,1412772,3229529,407901292,6,49239,4124454,40681,3110456,8558,1013998,12177,36,16548,190,6,856,144444.0,39000.0,-68.0,-71.0,-70.0,-60.0,-69.0,-72.0,-70.0,-61.0,-90.0,-92.0,-89.0,-92.0,22.0,21.0,19.0,32.0,1
1486,CC:2F:71:3F:1F:24,11881902,13680829532,8652373,13272928240,3229529,407901292,158,1958847,1147299996,1950153,1146255658,8694,1044338,1894596,675,8657206,921295,158,6644,115556.0,28889.0,-74.0,-65.0,-73.0,-69.0,-74.0,-64.0,-73.0,-69.0,-90.0,-92.0,-89.0,-92.0,16.0,27.0,16.0,23.0,1
1487,92:69:1D:31:68:E9,3257126,466271752,27595,58370258,3229531,407901494,0,12449,3836809,12332,3817518,117,19291,8012,1,27641,2051,0,140,229410.0,137640.0,-54.0,-51.0,-45.0,-51.0,-51.0,-49.0,-44.0,-49.0,-90.0,-92.0,-89.0,-92.0,36.0,41.0,44.0,41.0,1
1488,BA:8C:B9:54:50:24,3272008,504097715,42475,96196019,3229533,407901696,64,14799,4509037,14671,4487842,128,21195,9216,6,42453,9918,64,227,216660.0,130000.0,-47.0,-50.0,-54.0,-46.0,-52.0,-54.0,-47.0,-52.0,-90.0,-92.0,-89.0,-92.0,43.0,42.0,35.0,46.0,1
1489,62:47:05:9D:EB:15,3243270,440663620,13737,32761924,3229533,407901696,64,5841,1178502,5780,1168005,61,10497,2864,1,13720,2295,64,159,229410.0,137640.0,-43.0,-49.0,-43.0,-44.0,-42.0,-48.0,-43.0,-41.0,-90.0,-92.0,-89.0,-92.0,47.0,43.0,46.0,48.0,1
1490,F8:59:71:5A:E0:3D,3489823,800232765,260290,392331069,3229533,407901696,3,259510,350546327,254594,349959053,4916,587274,235861,20,263043,6830,3,824,144444.0,43333.0,-67.0,-74.0,-67.0,-71.0,-67.0,-73.0,-66.0,-70.0,-90.0,-92.0,-89.0,-92.0,23.0,18.0,22.0,21.0,1
1491,CC:2F:71:3E:C5:1F,3241083,409314700,11550,1413004,3229533,407901696,6,49242,4124736,40684,3110738,8558,1013998,12179,36,16550,190,6,856,144444.0,39000.0,-68.0,-71.0,-71.0,-60.0,-68.0,-70.0,-70.0,-60.0,-90.0,-92.0,-89.0,-92.0,22.0,21.0,18.0,32.0,1
1492,CC:2F:71:3F:1F:24,11883096,13682634850,8653562,13274733092,3229534,407901758,158,1959250,1147575228,1950556,1146530890,8694,1044338,1894999,675,8658366,921343,158,6644,115556.0,28889.0,-75.0,-64.0,-73.0,-68.0,-74.0,-64.0,-73.0,-68.0,-90.0,-92.0,-89.0,-92.0,15.0,28.0,16.0,24.0,1
1493,92:69:1D:31:68:E9,3257134,466272480,27595,58370258,3229539,407902222,0,12449,3836809,12332,3817518,117,19291,8012,1,27641,2051,0,140,229410.0,137640.0,-54.0,-51.0,-45.0,-51.0,-51.0,-49.0,-44.0,-49.0,-90.0,-92.0,-89.0,-92.0,36.0,41.0,44.0,41.0,1
1494,BA:8C:B9:54:50:24,3272014,504098241,42475,96196019,3229539,407902222,64,14799,4509037,14671,4487842,128,21195,9216,6,42453,9918,64,227,216660.0,130000.0,-47.0,-50.0,-54.0,-46.0,-52.0,-54.0,-47.0,-52.0,-90.0,-92.0,-89.0,-92.0,43.0,42.0,35.0,46.0,1
1495,62:47:05:9D:EB:15,3243276,440664146,13737,32761924,3229539,407902222,64,5841,1178502,5780,1168005,61,10497,2864,1,13720,2295,64,159,229410.0,137640.0,-43.0,-49.0,-43.0,-44.0,-42.0,-48.0,-43.0,-41.0,-90.0,-92.0,-89.0,-92.0,47.0,43.0,46.0,48.0,1
1496,F8:59:71:5A:E0:3D,3489909,800357611,260370,392455389,3229539,407902222,3,259592,350671185,254675,350083793,4917,587392,235943,20,263123,6830,3,824,144444.0,43333.0,-67.0,-73.0,-66.0,-70.0,-67.0,-72.0,-66.0,-70.0,-90.0,-92.0,-89.0,-92.0,23.0,19.0,23.0,22.0,1
1497,CC:2F:71:3E:C5:1F,3241089,409315226,11550,1413004,3229539,407902222,6,49242,4124736,40684,3110738,8558,1013998,12179,36,16550,190,6,856,144444.0,39000.0,-68.0,-71.0,-71.0,-60.0,-68.0,-70.0,-70.0,-60.0,-90.0,-92.0,-89.0,-92.0,22.0,21.0,18.0,32.0,1
1498,CC:2F:71:3F:1F:24,11884575,13684888050,8655035,13276985766,3229540,407902284,158,1959664,1147851688,1950970,1146807350,8694,1044338,1895413,675,8659864,921502,158,6644,130000.0,43333.0,-75.0,-64.0,-73.0,-68.0,-74.0,-64.0,-73.0,-68.0,-90.0,-92.0,-89.0,-92.0,15.0,28.0,16.0,24.0,1
1499,92:69:1D:31:68:E9,3257141,466273168,27595,58370258,3229546,407902910,0,12452,3837116,12334,3817654,118,19462,8013,1,27641,2051,0,140,229410.0,137640.0,-52.0,-53.0,-51.0,-56.0,-50.0,-50.0,-46.0,-51.0,-90.0,-92.0,-89.0,-92.0,38.0,39.0,38.0,36.0,1
1500,BA:8C:B9:54:50:24,3272021,504098929,42475,96196019,3229546,407902910,64,14807,4509684,14678,4488318,129,21366,9217,6,42453,9918,64,228,216660.0,130000.0,-53.0,-51.0,-38.0,-46.0,-50.0,-50.0,-41.0,-46.0,-90.0,-92.0,-89.0,-92.0,37.0,41.0,51.0,46.0,1
1501,62:47:05:9D:EB:15,3243283,440664834,13737,32761924,3229546,407902910,64,5870,1180528,5808,1169909,62,10619,2865,1,13720,2295,64,159,229410.0,137640.0,-43.0,-49.0,-44.0,-45.0,-46.0,-51.0,-48.0,-45.0,-90.0,-92.0,-89.0,-92.0,47.0,43.0,45.0,47.0,1
1502,F8:59:71:5A:E0:3D,3490003,800493497,260457,392590587,3229546,407902910,3,259678,350803653,254761,350216261,4917,587392,236029,20,263210,6830,3,825,144444.0,43333.0,-68.0,-74.0,-67.0,-71.0,-67.0,-74.0,-67.0,-70.0,-90.0,-92.0,-89.0,-92.0,22.0,18.0,22.0,21.0,1
1503,CC:2F:71:3E:C5:1F,3241096,409315914,11550,1413004,3229546,407902910,6,49242,4124736,40684,3110738,8558,1013998,12179,36,16550,190,6,856,144444.0,39000.0,-68.0,-71.0,-71.0,-60.0,-68.0,-70.0,-70.0,-60.0,-90.0,-92.0,-89.0,-92.0,22.0,21.0,18.0,32.0,1
1504,CC:2F:71:3F:1F:24,11885898,13686882936,8656350,13278979824,3229548,407903112,158,1960087,1148165486,1951393,1147121148,8694,1044338,1895831,675,8661158,921663,158,6644,130000.0,43333.0,-75.0,-65.0,-74.0,-69.0,-74.0,-64.0,-73.0,-68.0,-90.0,-92.0,-89.0,-92.0,15.0,27.0,15.0,23.0,1
1505,92:69:1D:31:68:E9,3257148,466274000,27595,58370258,3229553,407903742,0,12452,3837116,12334,3817654,118,19462,8013,1,27641,2051,0,140,229410.0,137640.0,-52.0,-53.0,-51.0,-56.0,-50.0,-50.0,-46.0,-51.0,-90.0,-92.0,-89.0,-92.0,38.0,39.0,38.0,36.0,1
1506,BA:8C:B9:54:50:24,3272319,504865964,42766,96962222,3229553,407903742,64,14845,4517138,14716,4495772,129,21366,9245,6,42744,9919,64,229,229410.0,137640.0,-47.0,-50.0,-54.0,-46.0,-48.0,-49.0,-45.0,-46.0,-90.0,-92.0,-89.0,-92.0,43.0,42.0,35.0,46.0,1
1507,62:47:05:9D:EB:15,3243290,440665666,13737,32761924,3229553,407903742,64,5870,1180528,5808,1169909,62,10619,2865,1,13720,2295,64,159,229410.0,137640.0,-43.0,-49.0,-44.0,-45.0,-46.0,-51.0,-48.0,-45.0,-90.0,-92.0,-89.0,-92.0,47.0,43.0,45.0,47.0,1
1508,F8:59:71:5A:E0:3D,3490101,800632837,260546,392728893,3229555,407903944,3,259769,350943863,254852,350356471,4917,587392,236119,20,263299,6838,3,825,144444.0,43333.0,-67.0,-73.0,-67.0,-70.0,-67.0,-73.0,-66.0,-70.0,-90.0,-92.0,-89.0,-92.0,23.0,19.0,22.0,22.0,1
1509,CC:2F:71:3E:C5:1F,3241107,409317150,11550,1413004,3229557,407904146,6,49242,4124736,40684,3110738,8558,1013998,12179,36,16550,190,6,856,144444.0,39000.0,-68.0,-71.0,-71.0,-60.0,-68.0,-70.0,-70.0,-60.0,-90.0,-92.0,-89.0,-92.0,22.0,21.0,18.0,32.0,1
1510,CC:2F:71:3F:1F:24,11887030,13688565193,8657473,13280661047,3229557,407904146,158,1960456,1148471253,1951762,1147426915,8694,1044338,1896197,675,8662306,921862,158,6645,130000.0,43333.0,-75.0,-65.0,-74.0,-69.0,-74.0,-65.0,-74.0,-69.0,-90.0,-92.0,-89.0,-92.0,15.0,27.0,15.0,23.0,1
1511,92:69:1D:31:68:E9,3257313,466689990,27752,58785440,3229561,407904550,0,12482,3843271,12364,3823809,118,19462,8032,1,27798,2052,0,141,229410.0,137640.0,-53.0,-50.0,-44.0,-50.0,-49.0,-49.0,-45.0,-49.0,-90.0,-92.0,-89.0,-92.0,37.0,42.0,45.0,42.0,1
1512,BA:8C:B9:54:50:24,3272328,504866888,42767,96962338,3229561,407904550,64,14848,4517380,14719,4496014,129,21366,9246,6,42745,9919,64,230,229410.0,137640.0,-47.0,-50.0,-53.0,-46.0,-47.0,-49.0,-49.0,-46.0,-90.0,-92.0,-89.0,-92.0,43.0,42.0,36.0,46.0,1
1513,62:47:05:9D:EB:15,3243301,440667251,13740,32762701,3229561,407904550,64,5913,1183905,5851,1173286,62,10619,2869,1,13723,2295,64,161,229410.0,137640.0,-43.0,-49.0,-44.0,-45.0,-46.0,-51.0,-48.0,-45.0,-90.0,-92.0,-89.0,-92.0,47.0,43.0,45.0,47.0,1
1514,F8:59:71:5A:E0:3D,3490192,800765365,260631,392860815,3229561,407904550,3,259854,351074763,254937,350487371,4917,587392,236204,20,263384,6838,3,825,144444.0,43333.0,-67.0,-73.0,-67.0,-70.0,-67.0,-73.0,-66.0,-70.0,-90.0,-92.0,-89.0,-92.0,23.0,19.0,22.0,22.0,1
1515,CC:2F:71:3E:C5:1F,3241111,409317554,11550,1413004,3229561,407904550,6,49242,4124736,40684,3110738,8558,1013998,12179,36,16550,190,6,856,144444.0,39000.0,-68.0,-71.0,-71.0,-60.0,-68.0,-70.0,-70.0,-60.0,-90.0,-92.0,-89.0,-92.0,22.0,21.0,18.0,32.0,1
1516,CC:2F:71:3F:1F:24,11888724,13691159713,8659163,13283255163,3229561,407904550,158,1960888,1148753053,1952194,1147708715,8694,1044338,1896629,675,8663996,922026,158,6646,130000.0,43333.0,-75.0,-65.0,-74.0,-69.0,-75.0,-65.0,-73.0,-69.0,-90.0,-92.0,-89.0,-92.0,15.0,27.0,15.0,23.0,1
1517,92:69:1D:31:68:E9,3257318,466690454,27752,58785440,3229566,407905014,0,12482,3843271,12364,3823809,118,19462,8032,1,27798,2052,0,141,229410.0,137640.0,-53.0,-50.0,-44.0,-50.0,-49.0,-49.0,-45.0,-49.0,-90.0,-92.0,-89.0,-92.0,37.0,42.0,45.0,42.0,1
1518,BA:8C:B9:54:50:24,3272333,504867352,42767,96962338,3229566,407905014,64,14848,4517380,14719,4496014,129,21366,9246,6,42745,9919,64,230,229410.0,137640.0,-47.0,-50.0,-53.0,-46.0,-47.0,-49.0,-49.0,-46.0,-90.0,-92.0,-89.0,-92.0,43.0,42.0,36.0,46.0,1
1519,62:47:05:9D:EB:15,3243306,440667715,13740,32762701,3229566,407905014,64,5913,1183905,5851,1173286,62,10619,2869,1,13723,2295,64,161,229410.0,137640.0,-43.0,-49.0,-44.0,-45.0,-46.0,-51.0,-48.0,-45.0,-90.0,-92.0,-89.0,-92.0,47.0,43.0,45.0,47.0,1
1520,F8:59:71:5A:E0:3D,3490278,800891703,260712,392986689,3229566,407905014,3,259936,351201071,255019,350613679,4917,587392,236284,20,263465,6838,3,825,144444.0,43333.0,-67.0,-73.0,-67.0,-70.0,-67.0,-73.0,-66.0,-70.0,-90.0,-92.0,-89.0,-92.0,23.0,19.0,22.0,22.0,1
1521,CC:2F:71:3E:C5:1F,3241116,409318018,11550,1413004,3229566,407905014,6,49242,4124736,40684,3110738,8558,1013998,12179,36,16550,190,6,856,144444.0,39000.0,-68.0,-71.0,-71.0,-60.0,-68.0,-70.0,-70.0,-60.0,-90.0,-92.0,-89.0,-92.0,22.0,21.0,18.0,32.0,1
1522,CC:2F:71:3F:1F:24,11890276,13693502886,8660710,13285597872,3229566,407905014,158,1961297,1149037203,1952603,1147992865,8694,1044338,1897036,675,8665543,922108,158,6646,130000.0,43333.0,-75.0,-65.0,-74.0,-69.0,-75.0,-65.0,-74.0,-69.0,-90.0,-92.0,-89.0,-92.0,15.0,27.0,15.0,23.0,1
1523,92:69:1D:31:68:E9,3257322,466690858,27752,58785440,3229570,407905418,0,12482,3843271,12364,3823809,118,19462,8032,1,27798,2052,0,141,229410.0,137640.0,-53.0,-50.0,-44.0,-50.0,-49.0,-49.0,-45.0,-49.0,-90.0,-92.0,-89.0,-92.0,37.0,42.0,45.0,42.0,1
1524,BA:8C:B9:54:50:24,3272337,504867756,42767,96962338,3229570,407905418,64,14848,4517380,14719,4496014,129,21366,9246,6,42745,9919,64,230,229410.0,137640.0,-47.0,-50.0,-53.0,-46.0,-47.0,-49.0,-49.0,-46.0,-90.0,-92.0,-89.0,-92.0,43.0,42.0,36.0,46.0,1
1525,62:47:05:9D:EB:15,3243364,440801951,13793,32896422,3229571,407905529,64,5931,1189555,5868,1178765,63,10790,2881,1,13776,2295,64,161,229410.0,137640.0,-47.0,-51.0,-48.0,-45.0,-46.0,-51.0,-47.0,-45.0,-90.0,-92.0,-89.0,-92.0,43.0,41.0,41.0,47.0,1
1526,F8:59:71:5A:E0:3D,3490363,801016538,260792,393111009,3229571,407905529,3,260016,351324271,255099,350736879,4917,587392,236364,20,263545,6838,3,825,144444.0,43333.0,-67.0,-73.0,-66.0,-70.0,-67.0,-73.0,-66.0,-70.0,-90.0,-92.0,-89.0,-92.0,23.0,19.0,23.0,22.0,1
1527,CC:2F:71:3E:C5:1F,3241121,409318533,11550,1413004,3229571,407905529,6,49242,4124736,40684,3110738,8558,1013998,12179,36,16550,190,6,856,144444.0,39000.0,-68.0,-71.0,-71.0,-60.0,-68.0,-70.0,-70.0,-60.0,-90.0,-92.0,-89.0,-92.0,22.0,21.0,18.0,32.0,1
1528,CC:2F:71:3F:1F:24,11891677,13695633657,8662106,13287728128,3229571,407905529,158,1961697,1149310669,1953003,1148266331,8694,1044338,1897435,675,8666939,922187,158,6646,130000.0,43333.0,-75.0,-65.0,-74.0,-69.0,-75.0,-65.0,-73.0,-69.0,-90.0,-92.0,-89.0,-92.0,15.0,27.0,15.0,23.0,1
1529,92:69:1D:31:68:E9,3257328,466691433,27752,58785440,3229576,407905993,0,12482,3843271,12364,3823809,118,19462,8032,1,27798,2052,0,141,229410.0,137640.0,-53.0,-50.0,-44.0,-50.0,-49.0,-49.0,-45.0,-49.0,-90.0,-92.0,-89.0,-92.0,37.0,42.0,45.0,42.0,1
1530,BA:8C:B9:54:50:24,3272343,504868331,42767,96962338,3229576,407905993,64,14848,4517380,14719,4496014,129,21366,9246,6,42745,9919,64,230,229410.0,137640.0,-47.0,-50.0,-53.0,-46.0,-47.0,-49.0,-49.0,-46.0,-90.0,-92.0,-89.0,-92.0,43.0,42.0,36.0,46.0,1
1531,62:47:05:9D:EB:15,3243369,440802415,13793,32896422,3229576,407905993,64,5961,1191595,5898,1180805,63,10790,2881,1,13776,2295,64,162,229410.0,137640.0,-43.0,-49.0,-43.0,-44.0,-46.0,-51.0,-47.0,-44.0,-90.0,-92.0,-89.0,-92.0,47.0,43.0,46.0,48.0,1
1532,F8:59:71:5A:E0:3D,3490446,801138214,260870,393232221,3229576,407905993,3,260097,351449039,255180,350861647,4917,587392,236443,20,263623,6838,3,825,144444.0,43333.0,-67.0,-73.0,-67.0,-70.0,-67.0,-73.0,-66.0,-70.0,-90.0,-92.0,-89.0,-92.0,23.0,19.0,22.0,22.0,1
1533,CC:2F:71:3E:C5:1F,3241126,409318997,11550,1413004,3229576,407905993,6,49242,4124736,40684,3110738,8558,1013998,12179,36,16550,190,6,856,144444.0,39000.0,-68.0,-71.0,-71.0,-60.0,-68.0,-70.0,-70.0,-60.0,-90.0,-92.0,-89.0,-92.0,22.0,21.0,18.0,32.0,1
1534,CC:2F:71:3F:1F:24,11893519,13698456857,8663941,13290550662,3229578,407906195,158,1962165,1149612387,1953471,1148568049,8694,1044338,1897900,675,8668773,922330,158,6646,130000.0,43333.0,-75.0,-65.0,-73.0,-69.0,-75.0,-65.0,-73.0,-69.0,-90.0,-92.0,-89.0,-92.0,15.0,27.0,16.0,23.0,1
1535,92:69:1D:31:68:E9,3257332,466691837,27752,58785440,3229580,407906397,0,12482,3843271,12364,3823809,118,19462,8032,1,27798,2052,0,141,229410.0,137640.0,-53.0,-50.0,-44.0,-50.0,-49.0,-49.0,-45.0,-49.0,-90.0,-92.0,-89.0,-92.0,37.0,42.0,45.0,42.0,1
1536,BA:8C:B9:54:50:24,3272347,504868735,42767,96962338,3229580,407906397,64,14848,4517380,14719,4496014,129,21366,9246,6,42745,9919,64,230,229410.0,137640.0,-47.0,-50.0,-53.0,-46.0,-47.0,-49.0,-49.0,-46.0,-90.0,-92.0,-89.0,-92.0,43.0,42.0,36.0,46.0,1
1537,62:47:05:9D:EB:15,3243375,440803021,13793,32896422,3229582,407906599,64,5961,1191595,5898,1180805,63,10790,2881,1,13776,2295,64,162,229410.0,137640.0,-43.0,-49.0,-43.0,-44.0,-46.0,-51.0,-47.0,-44.0,-90.0,-92.0,-89.0,-92.0,47.0,43.0,46.0,48.0,1
1538,F8:59:71:5A:E0:3D,3490541,801277126,260959,393370527,3229582,407906599,3,260187,351587653,255270,351000261,4917,587392,236532,20,263712,6841,3,825,144444.0,43333.0,-67.0,-73.0,-66.0,-70.0,-67.0,-73.0,-66.0,-70.0,-90.0,-92.0,-89.0,-92.0,23.0,19.0,23.0,22.0,1
1539,CC:2F:71:3E:C5:1F,3241134,409319805,11550,1413004,3229584,407906801,6,49242,4124736,40684,3110738,8558,1013998,12179,36,16550,190,6,856,144444.0,39000.0,-68.0,-71.0,-71.0,-60.0,-68.0,-70.0,-70.0,-60.0,-90.0,-92.0,-89.0,-92.0,22.0,21.0,18.0,32.0,1
1540,CC:2F:71:3F:1F:24,11894508,13699931101,8664924,13292024300,3229584,407906801,158,1962480,1149889516,1953786,1148845178,8694,1044338,1898214,675,8669757,922632,158,6646,115556.0,28889.0,-75.0,-65.0,-73.0,-70.0,-74.0,-64.0,-73.0,-69.0,-90.0,-92.0,-89.0,-92.0,15.0,27.0,16.0,22.0,1
1541,92:69:1D:31:68:E9,3257338,466692443,27752,58785440,3229586,407907003,0,12482,3843271,12364,3823809,118,19462,8032,1,27798,2052,0,141,229410.0,137640.0,-53.0,-50.0,-44.0,-50.0,-49.0,-49.0,-45.0,-49.0,-90.0,-92.0,-89.0,-92.0,37.0,42.0,45.0,42.0,1
1542,BA:8C:B9:54:50:24,3272354,504869401,42767,96962338,3229587,407907063,64,14848,4517380,14719,4496014,129,21366,9246,6,42745,9919,64,230,229410.0,137640.0,-47.0,-50.0,-53.0,-46.0,-47.0,-49.0,-49.0,-46.0,-90.0,-92.0,-89.0,-92.0,43.0,42.0,36.0,46.0,1
1543,62:47:05:9D:EB:15,3243381,440803639,13794,32896576,3229587,407907063,64,5964,1191857,5901,1181067,63,10790,2882,1,13777,2295,64,162,229410.0,137640.0,-43.0,-49.0,-43.0,-44.0,-46.0,-51.0,-47.0,-44.0,-90.0,-92.0,-89.0,-92.0,47.0,43.0,46.0,48.0,1
1544,F8:59:71:5A:E0:3D,3490636,801414544,261047,393507279,3229589,407907265,3,260276,351724811,255359,351137419,4917,587392,236619,20,263800,6843,3,826,144444.0,43333.0,-67.0,-73.0,-67.0,-70.0,-67.0,-73.0,-66.0,-70.0,-90.0,-92.0,-89.0,-92.0,23.0,19.0,22.0,22.0,1
1545,CC:2F:71:3E:C5:1F,3241139,409320269,11550,1413004,3229589,407907265,6,49242,4124736,40684,3110738,8558,1013998,12179,36,16550,190,6,856,144444.0,39000.0,-68.0,-71.0,-71.0,-60.0,-68.0,-70.0,-70.0,-60.0,-90.0,-92.0,-89.0,-92.0,22.0,21.0,18.0,32.0,1
1546,CC:2F:71:3F:1F:24,11895754,13701815474,8666165,13293908209,3229589,407907265,158,1962824,1150186966,1954130,1149142628,8694,1044338,1898557,675,8670965,922716,158,6647,117000.0,39000.0,-75.0,-65.0,-73.0,-70.0,-74.0,-65.0,-73.0,-69.0,-90.0,-92.0,-89.0,-92.0,15.0,27.0,16.0,22.0,1
1547,92:69:1D:31:68:E9,3257346,466693284,27752,58785440,3229594,407907844,0,12482,3843271,12364,3823809,118,19462,8032,1,27798,2052,0,141,229410.0,137640.0,-53.0,-50.0,-44.0,-50.0,-49.0,-49.0,-45.0,-49.0,-90.0,-92.0,-89.0,-92.0,37.0,42.0,45.0,42.0,1
1548,BA:8C:B9:54:50:24,3272361,504870182,42767,96962338,3229594,407907844,64,14853,4517887,14723,4496286,130,21601,9247,6,42745,9919,64,230,229410.0,137640.0,-47.0,-50.0,-54.0,-46.0,-47.0,-50.0,-49.0,-46.0,-90.0,-92.0,-89.0,-92.0,43.0,42.0,35.0,46.0,1
1549,62:47:05:9D:EB:15,3243431,440860185,13836,32952068,3229595,407908117,64,5974,1193196,5911,1182406,63,10790,2888,1,13819,2295,64,162,229410.0,137640.0,-43.0,-49.0,-43.0,-44.0,-45.0,-51.0,-47.0,-44.0,-90.0,-92.0,-89.0,-92.0,47.0,43.0,46.0,48.0,1
1550,F8:59:71:5A:E0:3D,3490722,801539716,261127,393631599,3229595,407908117,3,260358,351851189,255441,351263797,4917,587392,236700,20,263880,6844,3,827,144444.0,43333.0,-67.0,-73.0,-66.0,-70.0,-67.0,-73.0,-66.0,-70.0,-90.0,-92.0,-89.0,-92.0,23.0,19.0,23.0,22.0,1
1551,CC:2F:71:3E:C5:1F,3241145,409321121,11550,1413004,3229595,407908117,6,49242,4124736,40684,3110738,8558,1013998,12179,36,16550,190,6,856,144444.0,39000.0,-68.0,-71.0,-71.0,-60.0,-68.0,-70.0,-70.0,-60.0,-90.0,-92.0,-89.0,-92.0,22.0,21.0,18.0,32.0,1
1552,CC:2F:71:3F:1F:24,11897166,13703963058,8667571,13296054941,3229595,407908117,158,1963258,1150501682,1954564,1149457344,8694,1044338,1898987,675,8672403,922903,158,6647,115556.0,28889.0,-74.0,-65.0,-73.0,-69.0,-73.0,-63.0,-72.0,-68.0,-90.0,-92.0,-89.0,-92.0,16.0,27.0,16.0,23.0,1
1553,92:69:1D:31:68:E9,3257351,466693961,27752,58785440,3229599,407908521,0,12482,3843271,12364,3823809,118,19462,8032,1,27798,2052,0,141,229410.0,137640.0,-53.0,-50.0,-44.0,-50.0,-49.0,-49.0,-45.0,-49.0,-90.0,-92.0,-89.0,-92.0,37.0,42.0,45.0,42.0,1
1554,BA:8C:B9:54:50:24,3272366,504870859,42767,96962338,3229599,407908521,64,14853,4517887,14723,4496286,130,21601,9247,6,42745,9919,64,230,229410.0,137640.0,-47.0,-50.0,-54.0,-46.0,-47.0,-50.0,-49.0,-46.0,-90.0,-92.0,-89.0,-92.0,43.0,42.0,35.0,46.0,1
1555,62:47:05:9D:EB:15,3243436,440860649,13836,32952068,3229600,407908581,64,5974,1193196,5911,1182406,63,10790,2888,1,13819,2295,64,162,229410.0,137640.0,-43.0,-49.0,-43.0,-44.0,-45.0,-51.0,-47.0,-44.0,-90.0,-92.0,-89.0,-92.0,47.0,43.0,46.0,48.0,1
1556,F8:59:71:5A:E0:3D,3490827,801692674,261225,393783891,3229602,407908783,3,260454,351999519,255537,351412127,4917,587392,236796,20,263978,6844,3,827,144444.0,43333.0,-67.0,-73.0,-67.0,-70.0,-67.0,-73.0,-66.0,-70.0,-90.0,-92.0,-89.0,-92.0,23.0,19.0,22.0,22.0,1
1557,CC:2F:71:3E:C5:1F,3241152,409321787,11550,1413004,3229602,407908783,6,49242,4124736,40684,3110738,8558,1013998,12179,36,16550,190,6,856,144444.0,39000.0,-68.0,-71.0,-71.0,-60.0,-68.0,-70.0,-70.0,-60.0,-90.0,-92.0,-89.0,-92.0,22.0,21.0,18.0,32.0,1
1558,CC:2F:71:3F:1F:24,11898018,13705211734,8668416,13297302951,3229602,407908783,158,1963551,1150788802,1954857,1149744464,8694,1044338,1899280,675,8673248,922967,158,6647,115556.0,26000.0,-74.0,-64.0,-73.0,-69.0,-73.0,-64.0,-72.0,-69.0,-90.0,-92.0,-89.0,-92.0,16.0,28.0,16.0,23.0,1
1559,92:69:1D:31:68:E9,3257356,466694425,27752,58785440,3229604,407908985,0,12482,3843271,12364,3823809,118,19462,8032,1,27798,2052,0,141,229410.0,137640.0,-53.0,-50.0,-44.0,-50.0,-49.0,-49.0,-45.0,-49.0,-90.0,-92.0,-89.0,-92.0,37.0,42.0,45.0,42.0,1
1560,BA:8C:B9:54:50:24,3272373,504871525,42767,96962338,3229606,407909187,64,14853,4517887,14723,4496286,130,21601,9247,6,42745,9919,64,230,229410.0,137640.0,-47.0,-50.0,-54.0,-46.0,-47.0,-50.0,-49.0,-46.0,-90.0,-92.0,-89.0,-92.0,43.0,42.0,35.0,46.0,1
1561,62:47:05:9D:EB:15,3243442,440861255,13836,32952068,3229606,407909187,64,5974,1193196,5911,1182406,63,10790,2888,1,13819,2295,64,162,229410.0,137640.0,-43.0,-49.0,-43.0,-44.0,-45.0,-51.0,-47.0,-44.0,-90.0,-92.0,-89.0,-92.0,47.0,43.0,46.0,48.0,1
1562,F8:59:71:5A:E0:3D,3490917,801826722,261311,393917535,3229606,407909187,3,260542,352135067,255625,351547675,4917,587392,236882,20,264064,6848,3,827,144444.0,43333.0,-67.0,-73.0,-67.0,-70.0,-67.0,-73.0,-66.0,-70.0,-90.0,-92.0,-89.0,-92.0,23.0,19.0,22.0,22.0,1
1563,CC:2F:71:3E:C5:1F,3241158,409322393,11550,1413004,3229608,407909389,6,49242,4124736,40684,3110738,8558,1013998,12179,36,16550,190,6,856,144444.0,39000.0,-68.0,-71.0,-71.0,-60.0,-68.0,-70.0,-70.0,-60.0,-90.0,-92.0,-89.0,-92.0,22.0,21.0,18.0,32.0,1
1564,CC:2F:71:3F:1F:24,11899827,13707975653,8670219,13300066264,3229608,407909389,158,1963977,1151081727,1955283,1150037389,8694,1044338,1899704,675,8675015,923083,158,6647,115556.0,28889.0,-75.0,-64.0,-73.0,-69.0,-74.0,-64.0,-73.0,-68.0,-90.0,-92.0,-89.0,-92.0,15.0,28.0,16.0,23.0,1
1565,92:69:1D:31:68:E9,3257482,466992754,27868,59082773,3229614,407909981,0,12501,3848285,12383,3828823,118,19462,8046,1,27914,2052,0,141,229410.0,130000.0,-49.0,-49.0,-45.0,-49.0,-49.0,-49.0,-45.0,-49.0,-90.0,-92.0,-89.0,-92.0,41.0,43.0,44.0,43.0,1
1566,BA:8C:B9:54:50:24,3272382,504872435,42768,96962454,3229614,407909981,64,14859,4518295,14729,4496694,130,21601,9247,6,42746,9919,64,230,229410.0,137640.0,-53.0,-50.0,-38.0,-46.0,-47.0,-48.0,-43.0,-45.0,-90.0,-92.0,-89.0,-92.0,37.0,42.0,51.0,46.0,1
1567,62:47:05:9D:EB:15,3243452,440862319,13838,32952338,3229614,407909981,64,5999,1195008,5935,1184096,64,10912,2890,1,13821,2295,64,162,229410.0,137640.0,-43.0,-49.0,-44.0,-44.0,-43.0,-48.0,-44.0,-42.0,-90.0,-92.0,-89.0,-92.0,47.0,43.0,45.0,48.0,1
1568,F8:59:71:5A:E0:3D,3491014,801962890,261399,394052849,3229615,407910041,3,260632,352273807,255715,351686415,4917,587392,236970,20,264152,6852,3,828,144444.0,43333.0,-67.0,-73.0,-67.0,-70.0,-67.0,-73.0,-66.0,-70.0,-90.0,-92.0,-89.0,-92.0,23.0,19.0,22.0,22.0,1
1569,CC:2F:71:3E:C5:1F,3241166,409323161,11551,1413120,3229615,407910041,6,49244,4124876,40686,3110878,8558,1013998,12179,36,16551,190,6,856,144444.0,39000.0,-68.0,-70.0,-69.0,-60.0,-68.0,-70.0,-70.0,-60.0,-90.0,-92.0,-89.0,-92.0,22.0,22.0,20.0,32.0,1
1570,CC:2F:71:3F:1F:24,11901002,13709738844,8671387,13301828803,3229615,407910041,158,1964336,1151374952,1955642,1150330614,8694,1044338,1900062,675,8676220,923179,158,6647,130000.0,43333.0,-78.0,-68.0,-77.0,-72.0,-77.0,-67.0,-75.0,-71.0,-90.0,-92.0,-89.0,-92.0,12.0,24.0,12.0,20.0,1
1571,92:69:1D:31:68:E9,3257487,466993218,27868,59082773,3229619,407910445,0,12505,3848557,12387,3829095,118,19462,8046,1,27914,2052,0,141,229410.0,130000.0,-53.0,-50.0,-45.0,-50.0,-51.0,-49.0,-45.0,-49.0,-90.0,-92.0,-89.0,-92.0,37.0,42.0,44.0,42.0,1
1572,BA:8C:B9:54:50:24,3272387,504872899,42768,96962454,3229619,407910445,64,14859,4518295,14729,4496694,130,21601,9247,6,42746,9919,64,230,229410.0,137640.0,-53.0,-50.0,-38.0,-46.0,-47.0,-48.0,-43.0,-45.0,-90.0,-92.0,-89.0,-92.0,37.0,42.0,51.0,46.0,1
1573,62:47:05:9D:EB:15,3243457,440862783,13838,32952338,3229619,407910445,64,5999,1195008,5935,1184096,64,10912,2890,1,13821,2295,64,162,229410.0,137640.0,-43.0,-49.0,-44.0,-44.0,-43.0,-48.0,-44.0,-42.0,-90.0,-92.0,-89.0,-92.0,47.0,43.0,45.0,48.0,1
1574,F8:59:71:5A:E0:3D,3491103,802093892,261483,394183385,3229620,407910507,3,260717,352404763,255800,351817371,4917,587392,237054,20,264236,6853,3,828,144444.0,43333.0,-68.0,-74.0,-67.0,-70.0,-67.0,-73.0,-67.0,-70.0,-90.0,-92.0,-89.0,-92.0,22.0,18.0,22.0,22.0,1
1575,CC:2F:71:3E:C5:1F,3241171,409323627,11551,1413120,3229620,407910507,6,49244,4124876,40686,3110878,8558,1013998,12179,36,16551,190,6,856,144444.0,39000.0,-68.0,-70.0,-69.0,-60.0,-68.0,-70.0,-70.0,-60.0,-90.0,-92.0,-89.0,-92.0,22.0,22.0,20.0,32.0,1
1576,CC:2F:71:3F:1F:24,11902245,13711617194,8672625,13303706687,3229620,407910507,158,1964686,1151669974,1955991,1150625518,8695,1044456,1900408,675,8677442,923222,158,6647,130000.0,43333.0,-75.0,-65.0,-73.0,-69.0,-75.0,-65.0,-73.0,-69.0,-90.0,-92.0,-89.0,-92.0,15.0,27.0,16.0,23.0,1
1577,92:69:1D:31:68:E9,3257496,466994008,27868,59082773,3229628,407911235,0,12509,3848829,12391,3829367,118,19462,8046,1,27914,2052,0,141,229410.0,130000.0,-54.0,-50.0,-45.0,-50.0,-53.0,-50.0,-44.0,-50.0,-90.0,-92.0,-89.0,-92.0,36.0,42.0,44.0,42.0,1
1578,BA:8C:B9:54:50:24,3272396,504873689,42768,96962454,3229628,407911235,64,14859,4518295,14729,4496694,130,21601,9247,6,42746,9919,64,230,229410.0,137640.0,-53.0,-50.0,-38.0,-46.0,-47.0,-48.0,-43.0,-45.0,-90.0,-92.0,-89.0,-92.0,37.0,42.0,51.0,46.0,1
1579,62:47:05:9D:EB:15,3243467,440863689,13839,32952454,3229628,407911235,64,6033,1197358,5969,1186446,64,10912,2891,1,13822,2295,64,163,216660.0,130000.0,-43.0,-49.0,-44.0,-44.0,-42.0,-47.0,-43.0,-40.0,-90.0,-92.0,-89.0,-92.0,47.0,43.0,45.0,48.0,1
1580,F8:59:71:5A:E0:3D,3491221,802265560,261593,394354325,3229628,407911235,3,260831,352579391,255913,351991881,4918,587510,237165,20,264346,6853,3,830,144444.0,43333.0,-67.0,-73.0,-67.0,-70.0,-67.0,-73.0,-67.0,-70.0,-89.0,-92.0,-89.0,-91.0,22.0,19.0,22.0,21.0,1
1581,CC:2F:71:3E:C5:1F,3241179,409324355,11551,1413120,3229628,407911235,6,49244,4124876,40686,3110878,8558,1013998,12179,36,16551,190,6,856,144444.0,39000.0,-68.0,-70.0,-69.0,-60.0,-68.0,-70.0,-70.0,-60.0,-89.0,-92.0,-89.0,-91.0,21.0,22.0,20.0,31.0,1
1582,CC:2F:71:3F:1F:24,11903326,13713226138,8673696,13305314701,3229630,407911437,158,1965113,1152045135,1956418,1151000679,8695,1044456,1900816,675,8678514,923301,158,6648,130000.0,43333.0,-74.0,-64.0,-73.0,-69.0,-74.0,-64.0,-72.0,-69.0,-89.0,-92.0,-89.0,-91.0,15.0,28.0,16.0,22.0,1
1583,92:69:1D:31:68:E9,3257500,466994412,27868,59082773,3229632,407911639,0,12509,3848829,12391,3829367,118,19462,8046,1,27914,2052,0,141,229410.0,130000.0,-54.0,-50.0,-45.0,-50.0,-53.0,-50.0,-44.0,-50.0,-89.0,-92.0,-89.0,-91.0,35.0,42.0,44.0,41.0,1
1584,BA:8C:B9:54:50:24,3272600,505394182,42966,97482341,3229634,407911841,64,14892,4525117,14762,4503516,130,21601,9270,6,42944,10359,64,230,229410.0,137640.0,-46.0,-47.0,-39.0,-44.0,-47.0,-49.0,-40.0,-45.0,-89.0,-92.0,-89.0,-91.0,43.0,45.0,50.0,47.0,1
1585,62:47:05:9D:EB:15,3243473,440864295,13839,32952454,3229634,407911841,64,6033,1197358,5969,1186446,64,10912,2891,1,13822,2295,64,163,216660.0,130000.0,-43.0,-49.0,-44.0,-44.0,-42.0,-47.0,-43.0,-40.0,-89.0,-92.0,-89.0,-91.0,46.0,43.0,45.0,47.0,1
1586,F8:59:71:5A:E0:3D,3491310,802395148,261676,394483307,3229634,407911841,3,260916,352710319,255998,352122809,4918,587510,237248,20,264429,6853,3,830,144444.0,43333.0,-67.0,-73.0,-67.0,-70.0,-67.0,-73.0,-66.0,-70.0,-89.0,-92.0,-89.0,-91.0,22.0,19.0,22.0,21.0,1
1587,CC:2F:71:3E:C5:1F,3241185,409324961,11551,1413120,3229634,407911841,6,49244,4124876,40686,3110878,8558,1013998,12179,36,16551,190,6,856,144444.0,39000.0,-68.0,-70.0,-69.0,-60.0,-68.0,-70.0,-70.0,-60.0,-88.0,-91.0,-88.0,-90.0,20.0,21.0,19.0,30.0,1
1588,CC:2F:71:3F:1F:24,11904287,13714666360,8674653,13306754519,3229634,407911841,158,1965454,1152326015,1956759,1151281559,8695,1044456,1901157,675,8679481,923323,158,6648,130000.0,43333.0,-75.0,-64.0,-73.0,-68.0,-74.0,-64.0,-73.0,-68.0,-88.0,-91.0,-88.0,-90.0,13.0,27.0,15.0,22.0,1
1589,92:69:1D:31:68:E9,3257506,466995018,27868,59082773,3229638,407912245,0,12509,3848829,12391,3829367,118,19462,8046,1,27914,2052,0,141,229410.0,130000.0,-54.0,-50.0,-45.0,-50.0,-53.0,-50.0,-44.0,-50.0,-88.0,-91.0,-88.0,-90.0,34.0,41.0,43.0,40.0,1
1590,BA:8C:B9:54:50:24,3272604,505394586,42966,97482341,3229638,407912245,64,14893,4525185,14763,4503584,130,21601,9270,6,42944,10359,64,230,229410.0,137640.0,-47.0,-50.0,-54.0,-46.0,-47.0,-48.0,-42.0,-45.0,-88.0,-91.0,-88.0,-90.0,41.0,41.0,34.0,44.0,1
1591,62:47:05:9D:EB:15,3243477,440864699,13839,32952454,3229638,407912245,64,6033,1197358,5969,1186446,64,10912,2891,1,13822,2295,64,163,216660.0,130000.0,-43.0,-49.0,-44.0,-44.0,-42.0,-47.0,-43.0,-40.0,-88.0,-91.0,-88.0,-90.0,45.0,42.0,44.0,46.0,1
1592,F8:59:71:5A:E0:3D,3491397,802523040,261758,394610735,3229639,407912305,3,261000,352839735,256082,352252225,4918,587510,237328,20,264510,6853,3,830,144444.0,43333.0,-67.0,-73.0,-67.0,-70.0,-67.0,-73.0,-66.0,-70.0,-88.0,-91.0,-88.0,-90.0,21.0,18.0,21.0,20.0,1
1593,CC:2F:71:3E:C5:1F,3241190,409325425,11551,1413120,3229639,407912305,6,49244,4124876,40686,3110878,8558,1013998,12179,36,16551,190,6,856,144444.0,39000.0,-68.0,-70.0,-69.0,-60.0,-68.0,-70.0,-70.0,-60.0,-88.0,-91.0,-88.0,-90.0,20.0,21.0,19.0,30.0,1
1594,CC:2F:71:3F:1F:24,11905763,13716915678,8676124,13309003373,3229639,407912305,158,1965861,1152651791,1957166,1151607335,8695,1044456,1901564,675,8680957,923357,158,6648,130000.0,43333.0,-75.0,-64.0,-73.0,-69.0,-74.0,-64.0,-72.0,-68.0,-88.0,-91.0,-88.0,-90.0,13.0,27.0,15.0,21.0,1
1595,92:69:1D:31:68:E9,3257512,466995598,27869,59082889,3229643,407912709,0,12511,3849003,12393,3829541,118,19462,8047,1,27915,2052,0,141,229410.0,130000.0,-52.0,-52.0,-51.0,-56.0,-53.0,-50.0,-45.0,-50.0,-88.0,-91.0,-88.0,-90.0,36.0,39.0,37.0,34.0,1
1596,BA:8C:B9:54:50:24,3272611,505395252,42966,97482341,3229645,407912911,64,14893,4525185,14763,4503584,130,21601,9270,6,42944,10359,64,230,229410.0,137640.0,-47.0,-50.0,-54.0,-46.0,-47.0,-48.0,-42.0,-45.0,-88.0,-91.0,-88.0,-90.0,41.0,41.0,34.0,44.0,1
1597,62:47:05:9D:EB:15,3243638,441273879,13993,33360968,3229645,407912911,64,6059,1203896,5995,1192984,64,10912,2912,1,13976,2295,64,163,229410.0,130000.0,-43.0,-50.0,-44.0,-45.0,-45.0,-51.0,-46.0,-45.0,-88.0,-91.0,-88.0,-90.0,45.0,41.0,44.0,45.0,1
1598,F8:59:71:5A:E0:3D,3491505,802682154,261860,394769243,3229645,407912911,3,261104,353000007,256186,352412497,4918,587510,237431,20,264613,6854,3,831,144444.0,43333.0,-67.0,-73.0,-67.0,-71.0,-67.0,-73.0,-66.0,-70.0,-88.0,-91.0,-88.0,-90.0,21.0,18.0,21.0,19.0,1
1599,CC:2F:71:3E:C5:1F,3241196,409326031,11551,1413120,3229645,407912911,6,49244,4124876,40686,3110878,8558,1013998,12179,36,16551,190,6,856,144444.0,39000.0,-68.0,-70.0,-69.0,-60.0,-68.0,-70.0,-70.0,-60.0,-88.0,-91.0,-88.0,-90.0,20.0,21.0,19.0,30.0,1
1600,CC:2F:71:3F:1F:24,11907274,13719210355,8677629,13311297444,3229645,407912911,158,1966255,1152958646,1957560,1151914190,8695,1044456,1901943,675,8682422,923625,158,6648,130000.0,39000.0,-75.0,-64.0,-73.0,-69.0,-74.0,-64.0,-73.0,-69.0,-88.0,-91.0,-88.0,-90.0,13.0,27.0,15.0,21.0,1
1601,92:69:1D:31:68:E9,3257523,466999542,27875,59086367,3229648,407913175,0,12520,3852076,12402,3832614,118,19462,8052,1,27921,2052,0,141,229410.0,130000.0,-53.0,-51.0,-45.0,-51.0,-51.0,-51.0,-47.0,-52.0,-88.0,-91.0,-88.0,-90.0,35.0,40.0,43.0,39.0,1
1602,BA:8C:B9:54:50:24,3272614,505395516,42966,97482341,3229648,407913175,64,14893,4525185,14763,4503584,130,21601,9270,6,42944,10359,64,230,229410.0,137640.0,-47.0,-50.0,-54.0,-46.0,-47.0,-48.0,-42.0,-45.0,-88.0,-91.0,-88.0,-90.0,41.0,41.0,34.0,44.0,1
1603,62:47:05:9D:EB:15,3243642,441274203,13993,33360968,3229649,407913235,64,6059,1203896,5995,1192984,64,10912,2912,1,13976,2295,64,163,229410.0,130000.0,-43.0,-50.0,-44.0,-45.0,-45.0,-51.0,-46.0,-45.0,-88.0,-91.0,-88.0,-90.0,45.0,41.0,44.0,45.0,1
1604,F8:59:71:5A:E0:3D,3491600,802820986,261949,394907549,3229651,407913437,3,261196,353141757,256278,352554247,4918,587510,237520,20,264702,6854,3,831,144444.0,43333.0,-68.0,-74.0,-68.0,-71.0,-67.0,-73.0,-67.0,-70.0,-88.0,-91.0,-88.0,-90.0,20.0,17.0,20.0,19.0,1
1605,CC:2F:71:3E:C5:1F,3241204,409326759,11551,1413120,3229653,407913639,6,49246,4125064,40687,3110948,8559,1014116,12180,36,16551,190,6,856,144444.0,39000.0,-68.0,-71.0,-71.0,-61.0,-68.0,-70.0,-70.0,-60.0,-88.0,-90.0,-88.0,-90.0,20.0,19.0,17.0,29.0,1
1606,CC:2F:71:3F:1F:24,11908760,13721471375,8679107,13313557736,3229653,407913639,158,1966632,1153265176,1957937,1152220720,8695,1044456,1902320,675,8683938,923632,158,6648,130000.0,43333.0,-75.0,-64.0,-73.0,-69.0,-74.0,-64.0,-72.0,-68.0,-88.0,-90.0,-88.0,-90.0,13.0,26.0,15.0,21.0,1
1607,92:69:1D:31:68:E9,3257537,467003860,27882,59090019,3229655,407913841,0,12532,3858490,12414,3839028,118,19462,8060,1,27928,2052,0,141,229410.0,137640.0,-49.0,-49.0,-46.0,-50.0,-50.0,-50.0,-47.0,-51.0,-88.0,-90.0,-88.0,-90.0,39.0,41.0,42.0,40.0,1
1608,BA:8C:B9:54:50:24,3272622,505396455,42966,97482341,3229656,407914114,64,14893,4525185,14763,4503584,130,21601,9270,6,42944,10359,64,230,229410.0,137640.0,-47.0,-50.0,-54.0,-46.0,-47.0,-48.0,-42.0,-45.0,-88.0,-90.0,-88.0,-90.0,41.0,40.0,34.0,44.0,1
1609,62:47:05:9D:EB:15,3243666,441279722,14008,33365406,3229658,407914316,64,6080,1207426,6016,1196514,64,10912,2929,1,13991,2295,64,163,229410.0,130000.0,-43.0,-49.0,-43.0,-44.0,-46.0,-51.0,-46.0,-45.0,-88.0,-90.0,-88.0,-90.0,45.0,41.0,45.0,46.0,1
1610,F8:59:71:5A:E0:3D,3491702,802969439,262044,395055123,3229658,407914316,3,261296,353295911,256378,352708401,4918,587510,237616,20,264797,6857,3,832,130000.0,39000.0,-67.0,-73.0,-67.0,-70.0,-67.0,-73.0,-66.0,-70.0,-88.0,-90.0,-88.0,-90.0,21.0,17.0,21.0,20.0,1
1611,CC:2F:71:3E:C5:1F,3241209,409327436,11551,1413120,3229658,407914316,6,49246,4125064,40687,3110948,8559,1014116,12180,36,16551,190,6,856,144444.0,39000.0,-68.0,-71.0,-71.0,-61.0,-68.0,-70.0,-70.0,-60.0,-88.0,-90.0,-88.0,-90.0,20.0,19.0,17.0,29.0,1
1612,CC:2F:71:3F:1F:24,11909785,13722988951,8680127,13315074635,3229658,407914316,158,1966974,1153584249,1958279,1152539793,8695,1044456,1902656,675,8684960,923726,158,6649,130000.0,43333.0,-74.0,-64.0,-73.0,-68.0,-74.0,-63.0,-72.0,-68.0,-88.0,-90.0,-88.0,-90.0,14.0,26.0,15.0,22.0,1
1613,92:69:1D:31:68:E9,3257548,467005063,27882,59090019,3229666,407915044,0,12536,3858816,12417,3839232,119,19584,8061,1,27928,2052,0,142,229410.0,137640.0,-52.0,-52.0,-52.0,-56.0,-50.0,-49.0,-46.0,-51.0,-88.0,-90.0,-88.0,-90.0,36.0,38.0,36.0,34.0,1
1614,BA:8C:B9:54:50:24,3272632,505397385,42966,97482341,3229666,407915044,64,14893,4525185,14763,4503584,130,21601,9270,6,42944,10359,64,230,229410.0,137640.0,-47.0,-50.0,-54.0,-46.0,-47.0,-48.0,-42.0,-45.0,-88.0,-90.0,-88.0,-90.0,41.0,40.0,34.0,44.0,1
1615,62:47:05:9D:EB:15,3243674,441280450,14008,33365406,3229666,407915044,64,6080,1207426,6016,1196514,64,10912,2929,1,13991,2295,64,163,229410.0,130000.0,-43.0,-49.0,-43.0,-44.0,-46.0,-51.0,-46.0,-45.0,-88.0,-91.0,-88.0,-90.0,45.0,42.0,45.0,46.0,1
1616,F8:59:71:5A:E0:3D,3491808,803122347,262142,395207303,3229666,407915044,3,261393,353445487,256475,352857977,4918,587510,237713,20,264895,6866,3,832,144444.0,43333.0,-67.0,-73.0,-67.0,-70.0,-66.0,-72.0,-66.0,-70.0,-88.0,-91.0,-88.0,-90.0,21.0,18.0,21.0,20.0,1
1617,CC:2F:71:3E:C5:1F,3241217,409328164,11551,1413120,3229666,407915044,6,49246,4125064,40687,3110948,8559,1014116,12180,36,16551,190,6,856,144444.0,39000.0,-68.0,-71.0,-71.0,-61.0,-68.0,-70.0,-70.0,-60.0,-88.0,-91.0,-88.0,-90.0,20.0,20.0,17.0,29.0,1
1618,CC:2F:71:3F:1F:24,11910845,13724566866,8681179,13316651822,3229666,407915044,158,1967322,1153900034,1958627,1152855578,8695,1044456,1903004,675,8685989,923767,158,6649,130000.0,43333.0,-74.0,-63.0,-73.0,-68.0,-74.0,-63.0,-72.0,-68.0,-88.0,-91.0,-88.0,-90.0,14.0,28.0,15.0,22.0,1
1619,92:69:1D:31:68:E9,3257553,467005549,27882,59090019,3229671,407915530,0,12538,3859055,12418,3839300,120,19755,8062,1,27928,2052,0,142,229410.0,137640.0,-50.0,-50.0,-45.0,-49.0,-51.0,-50.0,-46.0,-51.0,-88.0,-91.0,-88.0,-90.0,38.0,41.0,43.0,41.0,1
1620,BA:8C:B9:54:50:24,3272639,505398073,42966,97482341,3229673,407915732,64,14897,4525614,14765,4503720,132,21894,9272,6,42944,10359,64,230,229410.0,137640.0,-53.0,-51.0,-38.0,-46.0,-48.0,-49.0,-41.0,-45.0,-88.0,-91.0,-88.0,-90.0,35.0,40.0,50.0,44.0,1
1621,62:47:05:9D:EB:15,3243681,441281138,14008,33365406,3229673,407915732,64,6080,1207426,6016,1196514,64,10912,2929,1,13991,2295,64,163,229410.0,130000.0,-43.0,-49.0,-43.0,-44.0,-46.0,-51.0,-46.0,-45.0,-88.0,-91.0,-88.0,-90.0,45.0,42.0,45.0,46.0,1
1622,F8:59:71:5A:E0:3D,3491911,803269313,262236,395353379,3229675,407915934,3,261487,353590247,256569,353002737,4918,587510,237807,20,264989,6868,3,832,144444.0,43333.0,-67.0,-73.0,-67.0,-70.0,-67.0,-72.0,-66.0,-70.0,-88.0,-91.0,-88.0,-90.0,21.0,18.0,21.0,20.0,1
1623,CC:2F:71:3E:C5:1F,3241226,409329054,11551,1413120,3229675,407915934,6,49246,4125064,40687,3110948,8559,1014116,12180,36,16551,190,6,856,144444.0,39000.0,-68.0,-71.0,-71.0,-61.0,-68.0,-70.0,-70.0,-60.0,-88.0,-91.0,-88.0,-90.0,20.0,20.0,17.0,29.0,1
1624,CC:2F:71:3F:1F:24,11912167,13726567334,8682492,13318651400,3229675,407915934,158,1967707,1154222140,1959012,1153177684,8695,1044456,1903389,675,8687325,923876,158,6649,130000.0,43333.0,-74.0,-63.0,-73.0,-68.0,-74.0,-63.0,-72.0,-68.0,-88.0,-91.0,-88.0,-90.0,14.0,28.0,15.0,22.0,1
1625,92:69:1D:31:68:E9,3257560,467006215,27882,59090019,3229678,407916196,0,12539,3859123,12419,3839368,120,19755,8062,1,27928,2052,0,142,229410.0,137640.0,-55.0,-49.0,-44.0,-50.0,-51.0,-50.0,-45.0,-51.0,-88.0,-91.0,-88.0,-90.0,33.0,42.0,44.0,40.0,1
1626,BA:8C:B9:54:50:24,3272644,505398537,42966,97482341,3229678,407916196,64,14897,4525614,14765,4503720,132,21894,9272,6,42944,10359,64,230,229410.0,137640.0,-53.0,-51.0,-38.0,-46.0,-48.0,-49.0,-41.0,-45.0,-88.0,-91.0,-88.0,-90.0,35.0,40.0,50.0,44.0,1
1627,62:47:05:9D:EB:15,3243688,441281804,14008,33365406,3229680,407916398,64,6080,1207426,6016,1196514,64,10912,2929,1,13991,2295,64,163,229410.0,130000.0,-43.0,-49.0,-43.0,-44.0,-46.0,-51.0,-46.0,-45.0,-88.0,-91.0,-88.0,-91.0,45.0,42.0,45.0,47.0,1
1628,F8:59:71:5A:E0:3D,3492005,803406645,262325,395490247,3229680,407916398,3,261577,353727427,256659,353139917,4918,587510,237896,20,265078,6868,3,832,144444.0,43333.0,-67.0,-73.0,-67.0,-71.0,-67.0,-73.0,-67.0,-70.0,-88.0,-91.0,-88.0,-91.0,21.0,18.0,21.0,20.0,1
1629,CC:2F:71:3E:C5:1F,3241231,409329518,11551,1413120,3229680,407916398,6,49246,4125064,40687,3110948,8559,1014116,12180,36,16551,190,6,856,144444.0,39000.0,-68.0,-71.0,-71.0,-61.0,-68.0,-70.0,-70.0,-60.0,-88.0,-91.0,-88.0,-91.0,20.0,20.0,17.0,30.0,1
1630,CC:2F:71:3F:1F:24,11913575,13728704319,8683895,13320787921,3229680,407916398,158,1968069,1154520211,1959374,1153475755,8695,1044456,1903745,675,8688710,923959,158,6649,130000.0,43333.0,-75.0,-65.0,-74.0,-70.0,-74.0,-64.0,-73.0,-69.0,-88.0,-91.0,-88.0,-91.0,13.0,26.0,14.0,21.0,1
1631,92:69:1D:31:68:E9,3257568,467007023,27882,59090019,3229686,407917004,0,12539,3859123,12419,3839368,120,19755,8062,1,27928,2052,0,142,229410.0,137640.0,-55.0,-49.0,-44.0,-50.0,-51.0,-50.0,-45.0,-51.0,-88.0,-91.0,-88.0,-91.0,33.0,42.0,44.0,41.0,1
1632,BA:8C:B9:54:50:24,3272652,505399345,42966,97482341,3229686,407917004,64,14897,4525614,14765,4503720,132,21894,9272,6,42944,10359,64,230,229410.0,137640.0,-53.0,-51.0,-38.0,-46.0,-48.0,-49.0,-41.0,-45.0,-88.0,-91.0,-88.0,-91.0,35.0,40.0,50.0,45.0,1
1633,62:47:05:9D:EB:15,3243695,441282564,14009,33365560,3229686,407917004,64,6105,1209184,6041,1198272,64,10912,2930,1,13992,2295,64,163,229410.0,130000.0,-43.0,-48.0,-43.0,-41.0,-43.0,-48.0,-43.0,-41.0,-88.0,-91.0,-88.0,-91.0,45.0,43.0,45.0,50.0,1
1634,F8:59:71:5A:E0:3D,3492098,803542449,262412,395625445,3229686,407917004,3,261665,353862975,256747,353275465,4918,587510,237984,20,265165,6869,3,833,144444.0,43333.0,-68.0,-74.0,-68.0,-71.0,-67.0,-73.0,-67.0,-71.0,-88.0,-91.0,-88.0,-91.0,20.0,17.0,20.0,20.0,1
1635,CC:2F:71:3E:C5:1F,3241237,409330124,11551,1413120,3229686,407917004,6,49246,4125064,40687,3110948,8559,1014116,12180,36,16551,190,6,856,144444.0,39000.0,-68.0,-71.0,-71.0,-61.0,-68.0,-70.0,-70.0,-60.0,-88.0,-91.0,-88.0,-91.0,20.0,20.0,17.0,30.0,1
1636,CC:2F:71:3F:1F:24,11915185,13731157798,8685499,13323240794,3229686,407917004,158,1968464,1154826564,1959769,1153782108,8695,1044456,1904140,675,8690299,924020,158,6649,130000.0,43333.0,-75.0,-65.0,-74.0,-70.0,-75.0,-64.0,-73.0,-69.0,-88.0,-91.0,-88.0,-91.0,13.0,26.0,14.0,21.0,1
1637,92:69:1D:31:68:E9,3257571,467007285,27882,59090019,3229689,407917266,0,12539,3859123,12419,3839368,120,19755,8062,1,27928,2052,0,142,229410.0,137640.0,-55.0,-49.0,-44.0,-50.0,-51.0,-50.0,-45.0,-51.0,-88.0,-91.0,-88.0,-91.0,33.0,42.0,44.0,41.0,1
1638,BA:8C:B9:54:50:24,3272655,505399607,42966,97482341,3229689,407917266,64,14898,4525682,14766,4503788,132,21894,9272,6,42944,10359,64,230,229410.0,137640.0,-47.0,-50.0,-54.0,-46.0,-48.0,-49.0,-43.0,-45.0,-88.0,-91.0,-88.0,-91.0,41.0,41.0,34.0,45.0,1
1639,62:47:05:9D:EB:15,3243699,441283125,14010,33365859,3229689,407917266,64,6123,1210718,6059,1199806,64,10912,2932,1,13993,2295,64,165,229410.0,137640.0,-43.0,-49.0,-43.0,-45.0,-46.0,-51.0,-47.0,-45.0,-88.0,-91.0,-88.0,-91.0,45.0,42.0,45.0,46.0,1
1640,F8:59:71:5A:E0:3D,3492187,803676355,262498,395759089,3229689,407917266,3,261751,353995471,256833,353407961,4918,587510,238069,20,265251,6869,3,833,144444.0,43333.0,-68.0,-74.0,-68.0,-71.0,-68.0,-74.0,-67.0,-71.0,-88.0,-91.0,-88.0,-91.0,20.0,17.0,20.0,20.0,1
1641,CC:2F:71:3E:C5:1F,3241242,409330588,11551,1413120,3229691,407917468,6,49246,4125064,40687,3110948,8559,1014116,12180,36,16551,190,6,856,144444.0,39000.0,-68.0,-71.0,-71.0,-61.0,-68.0,-70.0,-70.0,-60.0,-88.0,-91.0,-88.0,-91.0,20.0,20.0,17.0,30.0,1
1642,CC:2F:71:3F:1F:24,11916621,13733347644,8686930,13325430176,3229691,407917468,158,1968835,1155105230,1960140,1154060774,8695,1044456,1904508,675,8691750,924172,158,6649,130000.0,43333.0,-75.0,-63.0,-73.0,-68.0,-74.0,-63.0,-72.0,-68.0,-88.0,-91.0,-88.0,-91.0,13.0,28.0,15.0,23.0,1
1643,92:69:1D:31:68:E9,3257578,467008007,27883,59090135,3229695,407917872,0,12542,3859365,12422,3839610,120,19755,8063,1,27929,2052,0,142,229410.0,137640.0,-55.0,-49.0,-44.0,-50.0,-53.0,-49.0,-45.0,-50.0,-88.0,-91.0,-88.0,-91.0,33.0,42.0,44.0,41.0,1
1644,BA:8C:B9:54:50:24,3272661,505400213,42966,97482341,3229695,407917872,64,14898,4525682,14766,4503788,132,21894,9272,6,42944,10359,64,230,229410.0,137640.0,-47.0,-50.0,-54.0,-46.0,-48.0,-49.0,-43.0,-45.0,-88.0,-91.0,-88.0,-91.0,41.0,41.0,34.0,45.0,1
1645,62:47:05:9D:EB:15,3243705,441283731,14010,33365859,3229695,407917872,64,6123,1210718,6059,1199806,64,10912,2932,1,13993,2295,64,165,229410.0,137640.0,-43.0,-49.0,-43.0,-45.0,-46.0,-51.0,-47.0,-45.0,-88.0,-91.0,-88.0,-91.0,45.0,42.0,45.0,46.0,1
1646,F8:59:71:5A:E0:3D,3492289,803826145,262594,395908273,3229695,407917872,3,261850,354148099,256932,353560589,4918,587510,238166,20,265347,6872,3,833,144444.0,43333.0,-68.0,-74.0,-68.0,-71.0,-68.0,-73.0,-67.0,-71.0,-88.0,-91.0,-88.0,-91.0,20.0,17.0,20.0,20.0,1
1647,CC:2F:71:3E:C5:1F,3241249,409331305,11551,1413120,3229698,407918185,6,49246,4125064,40687,3110948,8559,1014116,12180,36,16551,190,6,856,144444.0,39000.0,-68.0,-71.0,-71.0,-61.0,-68.0,-70.0,-70.0,-60.0,-88.0,-91.0,-88.0,-91.0,20.0,20.0,17.0,30.0,1
1648,CC:2F:71:3F:1F:24,11918327,13735948360,8688629,13328030175,3229698,407918185,158,1969325,1155513327,1960630,1154468871,8695,1044456,1904991,675,8693462,924360,158,6650,130000.0,43333.0,-75.0,-65.0,-74.0,-70.0,-74.0,-64.0,-73.0,-69.0,-88.0,-91.0,-88.0,-91.0,13.0,26.0,14.0,21.0,1
1649,92:69:1D:31:68:E9,3257747,467428959,28042,59510108,3229705,407918851,0,12567,3865232,12447,3845477,120,19755,8084,1,28088,2060,0,142,229410.0,137640.0,-50.0,-50.0,-46.0,-50.0,-50.0,-50.0,-45.0,-49.0,-88.0,-91.0,-88.0,-91.0,38.0,41.0,42.0,41.0,1
1650,BA:8C:B9:54:50:24,3272687,505407047,42982,97488196,3229705,407918851,64,14920,4530638,14788,4508744,132,21894,9288,6,42960,10372,64,230,195000.0,97500.0,-47.0,-50.0,-54.0,-46.0,-49.0,-50.0,-43.0,-47.0,-88.0,-91.0,-88.0,-91.0,41.0,41.0,34.0,45.0,1
1651,62:47:05:9D:EB:15,3243715,441284710,14010,33365859,3229705,407918851,64,6151,1212725,6086,1201642,65,11083,2933,1,13993,2295,64,166,229410.0,137640.0,-43.0,-49.0,-43.0,-45.0,-46.0,-51.0,-47.0,-45.0,-88.0,-91.0,-88.0,-91.0,45.0,42.0,45.0,46.0,1
1652,F8:59:71:5A:E0:3D,3492408,803996510,262703,396077659,3229705,407918851,3,261961,354319389,257043,353731879,4918,587510,238275,20,265456,6880,3,833,144444.0,43333.0,-68.0,-74.0,-68.0,-71.0,-67.0,-74.0,-67.0,-71.0,-88.0,-91.0,-88.0,-91.0,20.0,17.0,20.0,20.0,1
1653,CC:2F:71:3E:C5:1F,3241256,409331971,11551,1413120,3229705,407918851,6,49246,4125064,40687,3110948,8559,1014116,12180,36,16551,190,6,856,144444.0,39000.0,-68.0,-71.0,-71.0,-61.0,-68.0,-70.0,-70.0,-60.0,-88.0,-91.0,-88.0,-91.0,20.0,20.0,17.0,30.0,1
1654,CC:2F:71:3F:1F:24,11920496,13739294686,8690791,13331375835,3229705,407918851,158,1969781,1155807865,1961086,1154763409,8695,1044456,1905446,675,8695624,924438,158,6650,130000.0,43333.0,-75.0,-64.0,-74.0,-69.0,-74.0,-64.0,-73.0,-69.0,-88.0,-91.0,-88.0,-91.0,13.0,27.0,14.0,22.0,1
1655,92:69:1D:31:68:E9,3257749,467429161,28042,59510108,3229707,407919053,0,12573,3865640,12453,3845885,120,19755,8084,1,28088,2060,0,143,229410.0,137640.0,-53.0,-51.0,-45.0,-51.0,-50.0,-49.0,-45.0,-50.0,-88.0,-91.0,-88.0,-91.0,35.0,40.0,43.0,40.0,1
1656,BA:8C:B9:54:50:24,3272691,505407451,42982,97488196,3229709,407919255,64,14920,4530638,14788,4508744,132,21894,9288,6,42960,10372,64,230,195000.0,97500.0,-47.0,-50.0,-54.0,-46.0,-49.0,-50.0,-43.0,-47.0,-88.0,-91.0,-88.0,-91.0,41.0,41.0,34.0,45.0,1
1657,62:47:05:9D:EB:15,3243720,441285317,14011,33366062,3229709,407919255,64,6187,1215316,6122,1204233,65,11083,2935,1,13994,2295,64,166,229410.0,137640.0,-43.0,-50.0,-44.0,-45.0,-46.0,-51.0,-47.0,-46.0,-88.0,-91.0,-88.0,-90.0,45.0,41.0,44.0,45.0,1
1658,F8:59:71:5A:E0:3D,3492495,804125896,262786,396206641,3229709,407919255,3,262044,354447223,257126,353859713,4918,587510,238357,20,265539,6882,3,833,144444.0,43333.0,-67.0,-73.0,-67.0,-70.0,-67.0,-73.0,-67.0,-70.0,-88.0,-91.0,-88.0,-90.0,21.0,18.0,21.0,20.0,1
1659,CC:2F:71:3E:C5:1F,3241260,409332375,11551,1413120,3229709,407919255,6,49246,4125064,40687,3110948,8559,1014116,12180,36,16551,190,6,856,144444.0,39000.0,-68.0,-71.0,-71.0,-61.0,-68.0,-70.0,-70.0,-60.0,-88.0,-91.0,-88.0,-90.0,20.0,20.0,17.0,29.0,1
1660,CC:2F:71:3F:1F:24,11922736,13742751624,8693025,13334832167,3229711,407919457,158,1970247,1156105311,1961552,1155060855,8695,1044456,1905902,675,8697856,924532,158,6651,130000.0,43333.0,-74.0,-64.0,-74.0,-69.0,-74.0,-64.0,-73.0,-69.0,-88.0,-91.0,-88.0,-90.0,14.0,27.0,14.0,21.0,1
1661,92:69:1D:31:68:E9,3257756,467429827,28042,59510108,3229714,407919719,0,12574,3865708,12454,3845953,120,19755,8084,1,28088,2060,0,143,229410.0,137640.0,-53.0,-51.0,-46.0,-51.0,-50.0,-49.0,-45.0,-50.0,-88.0,-91.0,-88.0,-90.0,35.0,40.0,42.0,39.0,1
1662,BA:8C:B9:54:50:24,3272696,505407915,42982,97488196,3229714,407919719,64,14920,4530638,14788,4508744,132,21894,9288,6,42960,10372,64,230,195000.0,97500.0,-47.0,-50.0,-54.0,-46.0,-49.0,-50.0,-43.0,-47.0,-88.0,-91.0,-88.0,-90.0,41.0,41.0,34.0,44.0,1
1663,62:47:05:9D:EB:15,3243725,441285781,14011,33366062,3229714,407919719,64,6187,1215316,6122,1204233,65,11083,2935,1,13994,2295,64,166,229410.0,137640.0,-43.0,-50.0,-44.0,-45.0,-46.0,-51.0,-47.0,-46.0,-88.0,-91.0,-88.0,-90.0,45.0,41.0,44.0,45.0,1
1664,F8:59:71:5A:E0:3D,3492583,804253904,262869,396334185,3229714,407919719,3,262129,354576717,257211,353989207,4918,587510,238440,20,265622,6882,3,833,144444.0,43333.0,-68.0,-74.0,-67.0,-71.0,-67.0,-73.0,-67.0,-70.0,-88.0,-91.0,-88.0,-90.0,20.0,17.0,21.0,19.0,1
1665,CC:2F:71:3E:C5:1F,3241265,409332839,11551,1413120,3229714,407919719,6,49246,4125064,40687,3110948,8559,1014116,12180,36,16551,190,6,856,144444.0,39000.0,-68.0,-71.0,-71.0,-61.0,-68.0,-70.0,-70.0,-60.0,-88.0,-91.0,-88.0,-90.0,20.0,20.0,17.0,29.0,1
1666,CC:2F:71:3F:1F:24,11924305,13745151654,8694591,13337231935,3229714,407919719,158,1970649,1156383407,1961954,1155338951,8695,1044456,1906300,675,8699424,924556,158,6651,130000.0,43333.0,-74.0,-64.0,-73.0,-69.0,-74.0,-64.0,-73.0,-69.0,-88.0,-91.0,-88.0,-90.0,14.0,27.0,15.0,21.0,1
1667,92:69:1D:31:68:E9,3257760,467430231,28042,59510108,3229718,407920123,0,12574,3865708,12454,3845953,120,19755,8084,1,28088,2060,0,143,229410.0,137640.0,-53.0,-51.0,-46.0,-51.0,-50.0,-49.0,-45.0,-50.0,-88.0,-91.0,-88.0,-90.0,35.0,40.0,42.0,39.0,1
1668,BA:8C:B9:54:50:24,3272703,505408794,42982,97488196,3229721,407920598,64,14920,4530638,14788,4508744,132,21894,9288,6,42960,10372,64,230,195000.0,97500.0,-47.0,-50.0,-54.0,-46.0,-49.0,-50.0,-43.0,-47.0,-88.0,-91.0,-88.0,-90.0,41.0,41.0,34.0,44.0,1
1669,62:47:05:9D:EB:15,3243732,441286660,14011,33366062,3229721,407920598,64,6187,1215316,6122,1204233,65,11083,2935,1,13994,2295,64,166,229410.0,137640.0,-43.0,-50.0,-44.0,-45.0,-46.0,-51.0,-47.0,-46.0,-88.0,-91.0,-88.0,-90.0,45.0,41.0,44.0,45.0,1
1670,F8:59:71:5A:E0:3D,3492671,804380657,262950,396460059,3229721,407920598,3,262212,354704551,257294,354117041,4918,587510,238522,20,265703,6882,3,833,144444.0,43333.0,-67.0,-73.0,-67.0,-70.0,-67.0,-73.0,-67.0,-70.0,-88.0,-91.0,-88.0,-90.0,21.0,18.0,21.0,20.0,1
1671,CC:2F:71:3E:C5:1F,3241274,409333920,11551,1413120,3229723,407920800,6,49246,4125064,40687,3110948,8559,1014116,12180,36,16551,190,6,856,144444.0,39000.0,-68.0,-71.0,-71.0,-61.0,-68.0,-70.0,-70.0,-60.0,-88.0,-91.0,-88.0,-90.0,20.0,20.0,17.0,29.0,1
1672,CC:2F:71:3F:1F:24,11925506,13746957344,8695783,13339036544,3229723,407920800,158,1971055,1156668043,1962360,1155623587,8695,1044456,1906706,675,8700614,924581,158,6651,130000.0,39000.0,-75.0,-65.0,-74.0,-69.0,-75.0,-64.0,-74.0,-69.0,-88.0,-91.0,-88.0,-90.0,13.0,26.0,14.0,21.0,1
1673,92:69:1D:31:68:E9,3257765,467430908,28042,59510108,3229723,407920800,0,12574,3865708,12454,3845953,120,19755,8084,1,28088,2060,0,143,229410.0,137640.0,-53.0,-51.0,-46.0,-51.0,-50.0,-49.0,-45.0,-50.0,-88.0,-91.0,-88.0,-90.0,35.0,40.0,42.0,39.0,1
1674,BA:8C:B9:54:50:24,3272914,505961914,43191,98041114,3229723,407920800,64,14948,4536739,14816,4514845,132,21894,9305,6,43169,10372,64,230,206470.0,103230.0,-47.0,-49.0,-54.0,-46.0,-50.0,-51.0,-44.0,-48.0,-88.0,-91.0,-88.0,-90.0,41.0,42.0,34.0,44.0,1
1675,62:47:05:9D:EB:15,3243735,441286922,14011,33366062,3229724,407920860,64,6187,1215316,6122,1204233,65,11083,2935,1,13994,2295,64,166,229410.0,137640.0,-43.0,-50.0,-44.0,-45.0,-46.0,-51.0,-47.0,-46.0,-88.0,-91.0,-88.0,-90.0,45.0,41.0,44.0,45.0,1
1676,F8:59:71:5A:E0:3D,3492754,804505239,263030,396584379,3229724,407920860,3,262297,354835521,257379,354248011,4918,587510,238602,20,265783,6883,3,833,144444.0,43333.0,-67.0,-74.0,-68.0,-72.0,-67.0,-74.0,-68.0,-72.0,-88.0,-91.0,-88.0,-90.0,21.0,17.0,20.0,18.0,1
1677,CC:2F:71:3E:C5:1F,3241277,409334182,11551,1413120,3229726,407921062,6,49246,4125064,40687,3110948,8559,1014116,12180,36,16551,190,6,856,144444.0,39000.0,-68.0,-71.0,-71.0,-61.0,-68.0,-70.0,-70.0,-60.0,-88.0,-91.0,-88.0,-90.0,20.0,20.0,17.0,29.0,1
1678,CC:2F:71:3F:1F:24,11927127,13749442370,8697401,13341521308,3229726,407921062,158,1971468,1156951449,1962773,1155906993,8695,1044456,1907118,675,8702234,924643,158,6651,130000.0,43333.0,-71.0,-65.0,-74.0,-69.0,-71.0,-65.0,-74.0,-69.0,-88.0,-91.0,-88.0,-90.0,17.0,26.0,14.0,21.0,1
1679,92:69:1D:31:68:E9,3257774,467431776,28042,59510108,3229732,407921668,0,12574,3865708,12454,3845953,120,19755,8084,1,28088,2060,0,143,229410.0,137640.0,-53.0,-51.0,-46.0,-51.0,-50.0,-49.0,-45.0,-50.0,-88.0,-91.0,-88.0,-90.0,35.0,40.0,42.0,39.0,1
1680,BA:8C:B9:54:50:24,3272924,505962842,43192,98041174,3229732,407921668,64,14951,4536981,14819,4515087,132,21894,9306,6,43170,10372,64,230,206470.0,103230.0,-47.0,-50.0,-54.0,-46.0,-50.0,-51.0,-44.0,-47.0,-88.0,-91.0,-88.0,-90.0,41.0,41.0,34.0,44.0,1
1681,62:47:05:9D:EB:15,3243743,441287730,14011,33366062,3229732,407921668,64,6187,1215316,6122,1204233,65,11083,2935,1,13994,2295,64,166,229410.0,137640.0,-43.0,-50.0,-44.0,-45.0,-46.0,-51.0,-47.0,-46.0,-88.0,-91.0,-88.0,-90.0,45.0,41.0,44.0,45.0,1
1682,F8:59:71:5A:E0:3D,3492860,804656901,263128,396735233,3229732,407921668,3,262406,355003507,257488,354415997,4918,587510,238710,20,265881,6889,3,833,144444.0,43333.0,-67.0,-74.0,-67.0,-71.0,-67.0,-73.0,-67.0,-71.0,-88.0,-91.0,-88.0,-90.0,21.0,17.0,21.0,19.0,1
1683,CC:2F:71:3E:C5:1F,3241284,409334904,11552,1413236,3229732,407921668,6,49247,4125134,40688,3111018,8559,1014116,12180,36,16552,190,6,856,144444.0,39000.0,-67.0,-72.0,-69.0,-61.0,-67.0,-70.0,-70.0,-60.0,-88.0,-91.0,-88.0,-90.0,21.0,19.0,19.0,29.0,1
1684,CC:2F:71:3F:1F:24,11928880,13752125224,8699148,13344203556,3229732,407921668,158,1971939,1157341363,1963244,1156296907,8695,1044456,1907553,675,8703947,924775,158,6653,130000.0,43333.0,-70.0,-65.0,-74.0,-69.0,-69.0,-64.0,-73.0,-68.0,-88.0,-91.0,-88.0,-90.0,18.0,26.0,14.0,21.0,1
1685,92:69:1D:31:68:E9,3257785,467433101,28043,59510224,3229742,407922877,0,12580,3866116,12460,3846361,120,19755,8084,1,28089,2060,0,143,229410.0,137640.0,-55.0,-49.0,-44.0,-50.0,-52.0,-50.0,-46.0,-51.0,-88.0,-91.0,-88.0,-90.0,33.0,42.0,44.0,40.0,1
1686,BA:8C:B9:54:50:24,3272935,505964167,43193,98041290,3229742,407922877,64,14955,4537253,14823,4515359,132,21894,9306,6,43171,10372,64,230,206470.0,103230.0,-53.0,-51.0,-38.0,-46.0,-49.0,-49.0,-42.0,-46.0,-88.0,-91.0,-88.0,-90.0,35.0,40.0,50.0,44.0,1
1687,62:47:05:9D:EB:15,3244132,442280356,14390,34357479,3229742,407922877,64,6279,1228790,6213,1217472,66,11318,2983,1,14373,2359,64,167,229410.0,137640.0,-43.0,-49.0,-43.0,-43.0,-46.0,-51.0,-47.0,-45.0,-88.0,-91.0,-88.0,-90.0,45.0,42.0,45.0,47.0,1
1688,F8:59:71:5A:E0:3D,3492968,804807496,263224,396884417,3229744,407923079,3,262505,355156149,257587,354568639,4918,587510,238806,20,265977,6889,3,833,144444.0,43333.0,-68.0,-74.0,-67.0,-71.0,-67.0,-74.0,-67.0,-71.0,-88.0,-91.0,-88.0,-90.0,20.0,17.0,21.0,19.0,1
1689,CC:2F:71:3E:C5:1F,3241296,409336315,11552,1413236,3229744,407923079,6,49248,4125204,40689,3111088,8559,1014116,12180,36,16552,190,6,856,144444.0,39000.0,-79.0,-86.0,-76.0,-72.0,-69.0,-72.0,-71.0,-61.0,-88.0,-91.0,-88.0,-90.0,9.0,5.0,12.0,18.0,1
1690,CC:2F:71:3F:1F:24,11930697,13754856634,8700953,13346933555,3229744,407923079,158,1972392,1157664751,1963697,1156620295,8695,1044456,1908002,675,8705786,924960,158,6656,130000.0,43333.0,-70.0,-63.0,-73.0,-68.0,-69.0,-63.0,-73.0,-68.0,-88.0,-91.0,-88.0,-90.0,18.0,28.0,15.0,22.0,1
1691,92:69:1D:31:68:E9,3257787,467433303,28043,59510224,3229744,407923079,0,12580,3866116,12460,3846361,120,19755,8084,1,28089,2060,0,143,229410.0,137640.0,-55.0,-49.0,-44.0,-50.0,-52.0,-50.0,-46.0,-51.0,-88.0,-91.0,-88.0,-90.0,33.0,42.0,44.0,40.0,1
1692,BA:8C:B9:54:50:24,3272940,505966370,43196,98043291,3229744,407923079,64,14969,4538486,14837,4516592,132,21894,9309,6,43174,10372,64,230,216660.0,130000.0,-53.0,-51.0,-38.0,-46.0,-48.0,-48.0,-40.0,-46.0,-88.0,-91.0,-88.0,-90.0,35.0,40.0,50.0,44.0,1
1693,62:47:05:9D:EB:15,3244138,442281213,14392,34357932,3229746,407923281,64,6304,1230548,6238,1219230,66,11318,2984,1,14374,2359,64,167,229410.0,137640.0,-43.0,-47.0,-44.0,-40.0,-42.0,-47.0,-43.0,-39.0,-88.0,-91.0,-88.0,-90.0,45.0,44.0,44.0,50.0,1
1694,F8:59:71:5A:E0:3D,3493057,804942896,263311,397019615,3229746,407923281,3,262595,355294777,257677,354707267,4918,587510,238894,20,266064,6891,3,833,144444.0,43333.0,-68.0,-74.0,-67.0,-71.0,-67.0,-74.0,-67.0,-71.0,-88.0,-91.0,-88.0,-90.0,20.0,17.0,21.0,19.0,1
1695,CC:2F:71:3E:C5:1F,3241299,409336579,11552,1413236,3229747,407923343,6,49249,4125322,40689,3111088,8560,1014234,12181,36,16552,190,6,856,144444.0,39000.0,-68.0,-71.0,-71.0,-61.0,-69.0,-72.0,-71.0,-62.0,-88.0,-91.0,-88.0,-90.0,20.0,20.0,17.0,29.0,1
1696,CC:2F:71:3F:1F:24,11932747,13758017878,8702998,13350094333,3229749,407923545,158,1972842,1157970295,1964147,1156925839,8695,1044456,1908450,675,8707802,925363,158,6658,115556.0,28889.0,-73.0,-64.0,-72.0,-68.0,-72.0,-64.0,-72.0,-68.0,-88.0,-91.0,-88.0,-90.0,15.0,27.0,16.0,22.0,1
1697,92:69:1D:31:68:E9,3257825,467504536,28071,59580527,3229754,407924009,0,12590,3867516,12470,3847761,120,19755,8091,1,28117,2060,0,143,229410.0,137640.0,-49.0,-49.0,-46.0,-50.0,-50.0,-49.0,-45.0,-49.0,-88.0,-91.0,-88.0,-90.0,39.0,42.0,42.0,40.0,1
1698,BA:8C:B9:54:50:24,3272950,505967300,43196,98043291,3229754,407924009,64,14969,4538486,14837,4516592,132,21894,9309,6,43174,10372,64,230,216660.0,130000.0,-53.0,-51.0,-38.0,-46.0,-48.0,-48.0,-40.0,-46.0,-88.0,-91.0,-88.0,-90.0,35.0,40.0,50.0,44.0,1
1699,62:47:05:9D:EB:15,3244151,442282928,14397,34358919,3229754,407924009,64,6333,1233426,6267,1222108,66,11318,2993,1,14380,2359,64,168,229410.0,137640.0,-43.0,-49.0,-44.0,-45.0,-42.0,-47.0,-44.0,-41.0,-88.0,-91.0,-88.0,-90.0,45.0,42.0,44.0,45.0,1
1700,F8:59:71:5A:E0:3D,3493157,805086592,263403,397162583,3229754,407924009,3,262686,355434987,257768,354847477,4918,587510,238985,20,266156,6891,3,833,144444.0,43333.0,-67.0,-73.0,-66.0,-70.0,-67.0,-73.0,-66.0,-70.0,-88.0,-91.0,-88.0,-90.0,21.0,18.0,22.0,20.0,1
1701,CC:2F:71:3E:C5:1F,3241307,409337307,11552,1413236,3229755,407924071,6,49250,4125392,40690,3111158,8560,1014234,12181,36,16552,190,6,856,144444.0,39000.0,-69.0,-71.0,-71.0,-61.0,-69.0,-72.0,-71.0,-62.0,-88.0,-91.0,-88.0,-90.0,19.0,20.0,17.0,29.0,1
1702,CC:2F:71:3F:1F:24,11934051,13759968218,8704294,13352043945,3229757,407924273,158,1973330,1158402527,1964635,1157358071,8695,1044456,1908924,675,8709127,925462,158,6658,115556.0,28889.0,-73.0,-64.0,-72.0,-69.0,-73.0,-64.0,-72.0,-68.0,-88.0,-91.0,-88.0,-90.0,15.0,27.0,16.0,21.0,1
1703,92:69:1D:31:68:E9,3257834,467505406,28071,59580527,3229763,407924879,0,12591,3867584,12471,3847829,120,19755,8091,1,28117,2060,0,143,229410.0,137640.0,-53.0,-51.0,-45.0,-51.0,-50.0,-49.0,-45.0,-49.0,-88.0,-91.0,-88.0,-91.0,35.0,40.0,43.0,40.0,1
1704,BA:8C:B9:54:50:24,3272960,505968232,43196,98043291,3229764,407924941,64,14969,4538486,14837,4516592,132,21894,9309,6,43174,10372,64,230,216660.0,130000.0,-53.0,-51.0,-38.0,-46.0,-48.0,-48.0,-40.0,-46.0,-88.0,-91.0,-88.0,-91.0,35.0,40.0,50.0,45.0,1
1705,62:47:05:9D:EB:15,3244161,442283860,14397,34358919,3229764,407924941,64,6336,1233684,6269,1222244,67,11440,2994,1,14380,2359,64,168,229410.0,137640.0,-43.0,-49.0,-44.0,-44.0,-44.0,-48.0,-45.0,-41.0,-88.0,-91.0,-88.0,-91.0,45.0,42.0,44.0,47.0,1
1706,F8:59:71:5A:E0:3D,3493285,805270728,263521,397345787,3229764,407924941,3,262808,355621515,257889,355033887,4919,587628,239107,20,266274,6894,3,833,144444.0,43333.0,-68.0,-74.0,-67.0,-71.0,-68.0,-74.0,-67.0,-71.0,-88.0,-91.0,-88.0,-91.0,20.0,17.0,21.0,20.0,1
1707,CC:2F:71:3E:C5:1F,3241317,409338239,11552,1413236,3229765,407925003,6,49250,4125392,40690,3111158,8560,1014234,12181,36,16552,190,6,856,144444.0,39000.0,-69.0,-71.0,-71.0,-61.0,-69.0,-72.0,-71.0,-62.0,-88.0,-91.0,-88.0,-91.0,19.0,20.0,17.0,30.0,1
1708,CC:2F:71:3F:1F:24,11935958,13762895672,8706193,13354970669,3229765,407925003,158,1973746,1158689329,1965051,1157644873,8695,1044456,1909338,675,8711026,925597,158,6660,130000.0,43333.0,-73.0,-64.0,-72.0,-69.0,-73.0,-64.0,-72.0,-69.0,-88.0,-91.0,-88.0,-91.0,15.0,27.0,16.0,22.0,1
1709,92:69:1D:31:68:E9,3257839,467505792,28071,59580527,3229768,407925265,0,12594,3867842,12473,3847965,121,19877,8092,1,28117,2060,0,143,229410.0,137640.0,-55.0,-50.0,-45.0,-51.0,-50.0,-49.0,-45.0,-50.0,-88.0,-91.0,-88.0,-91.0,33.0,41.0,43.0,40.0,1
1710,BA:8C:B9:54:50:24,3272964,505968556,43196,98043291,3229768,407925265,64,14969,4538486,14837,4516592,132,21894,9309,6,43174,10372,64,230,216660.0,130000.0,-53.0,-51.0,-38.0,-46.0,-48.0,-48.0,-40.0,-46.0,-88.0,-91.0,-88.0,-91.0,35.0,40.0,50.0,45.0,1
1711,62:47:05:9D:EB:15,3244167,442284400,14398,34359073,3229769,407925327,64,6363,1235578,6296,1224138,67,11440,2995,1,14381,2359,64,169,229410.0,137640.0,-42.0,-48.0,-43.0,-41.0,-42.0,-47.0,-43.0,-41.0,-88.0,-91.0,-88.0,-91.0,46.0,43.0,45.0,50.0,1
1712,F8:59:71:5A:E0:3D,3493376,805401852,263605,397476323,3229771,407925529,3,262896,355757077,257977,355169449,4919,587628,239192,20,266358,6894,3,833,144444.0,43333.0,-68.0,-74.0,-67.0,-71.0,-67.0,-73.0,-66.0,-70.0,-88.0,-91.0,-88.0,-91.0,20.0,17.0,21.0,20.0,1
1713,CC:2F:71:3E:C5:1F,3241325,409338967,11552,1413236,3229773,407925731,6,49250,4125392,40690,3111158,8560,1014234,12181,36,16552,190,6,856,144444.0,39000.0,-69.0,-71.0,-71.0,-61.0,-69.0,-72.0,-71.0,-62.0,-88.0,-91.0,-88.0,-91.0,19.0,20.0,17.0,30.0,1
1714,CC:2F:71:3F:1F:24,11937653,13765492302,8707880,13357566571,3229773,407925731,158,1974159,1158990121,1965464,1157945665,8695,1044456,1909749,675,8712687,925884,158,6661,104000.0,26000.0,-72.0,-64.0,-72.0,-69.0,-72.0,-64.0,-72.0,-69.0,-88.0,-91.0,-88.0,-91.0,16.0,27.0,16.0,22.0,1
1715,92:69:1D:31:68:E9,3257874,467520730,28077,59583949,3229797,407936781,0,12602,3870848,12481,3850971,121,19877,8097,1,28123,2060,0,143,216660.0,130000.0,-52.0,-53.0,-51.0,-57.0,-50.0,-49.0,-45.0,-50.0,-90.0,-92.0,-90.0,-92.0,38.0,39.0,39.0,35.0,1
1716,BA:8C:B9:54:50:24,3272993,505980072,43196,98043291,3229797,407936781,64,14974,4538880,14841,4516864,133,22016,9310,6,43174,10372,64,230,216660.0,130000.0,-53.0,-50.0,-38.0,-46.0,-50.0,-50.0,-40.0,-47.0,-90.0,-92.0,-90.0,-92.0,37.0,42.0,52.0,46.0,1
1717,62:47:05:9D:EB:15,3244195,442295854,14398,34359073,3229797,407936781,64,6364,1235646,6297,1224206,67,11440,2995,1,14381,2359,64,169,229410.0,137640.0,-43.0,-49.0,-44.0,-44.0,-42.0,-48.0,-43.0,-41.0,-90.0,-92.0,-90.0,-92.0,47.0,43.0,46.0,48.0,1
1718,F8:59:71:5A:E0:3D,3493503,805570058,263706,397633277,3229797,407936781,3,262995,355909705,258076,355322077,4919,587628,239290,20,266458,6894,3,834,144444.0,43333.0,-68.0,-74.0,-67.0,-71.0,-68.0,-74.0,-67.0,-71.0,-90.0,-92.0,-90.0,-92.0,22.0,18.0,23.0,21.0,1
1719,CC:2F:71:3E:C5:1F,3241349,409350017,11552,1413236,3229797,407936781,6,49250,4125392,40690,3111158,8560,1014234,12181,36,16552,190,6,856,144444.0,39000.0,-69.0,-71.0,-71.0,-61.0,-69.0,-72.0,-71.0,-62.0,-90.0,-92.0,-90.0,-92.0,21.0,21.0,19.0,31.0,1
1720,CC:2F:71:3F:1F:24,11938984,13767486325,8709185,13359549342,3229799,407936983,158,1974564,1159338887,1965869,1158294431,8695,1044456,1910154,675,8714018,926286,158,6661,115556.0,28889.0,-72.0,-65.0,-72.0,-69.0,-72.0,-64.0,-72.0,-69.0,-90.0,-92.0,-90.0,-92.0,18.0,27.0,18.0,23.0,1
1721,92:69:1D:31:68:E9,3257910,467533618,28104,59595969,3229806,407937649,0,12655,3898028,12534,3878151,121,19877,8131,1,28150,2060,0,143,229410.0,130000.0,-50.0,-50.0,-45.0,-49.0,-50.0,-50.0,-45.0,-49.0,-90.0,-93.0,-90.0,-92.0,40.0,43.0,45.0,43.0,1
1722,BA:8C:B9:54:50:24,3273002,505980940,43196,98043291,3229806,407937649,64,14974,4538880,14841,4516864,133,22016,9310,6,43174,10372,64,230,216660.0,130000.0,-53.0,-50.0,-38.0,-46.0,-50.0,-50.0,-40.0,-47.0,-90.0,-93.0,-90.0,-92.0,37.0,43.0,52.0,46.0,1
1723,62:47:05:9D:EB:15,3244204,442296722,14398,34359073,3229806,407937649,64,6364,1235646,6297,1224206,67,11440,2995,1,14381,2359,64,169,229410.0,137640.0,-43.0,-49.0,-44.0,-44.0,-42.0,-48.0,-43.0,-41.0,-90.0,-93.0,-90.0,-92.0,47.0,44.0,46.0,48.0,1
1724,F8:59:71:5A:E0:3D,3493605,805715448,263799,397777799,3229806,407937649,3,263092,356059113,258173,355471485,4919,587628,239385,20,266552,6894,3,834,144444.0,43333.0,-67.0,-73.0,-67.0,-70.0,-67.0,-72.0,-66.0,-70.0,-90.0,-93.0,-90.0,-92.0,23.0,20.0,23.0,22.0,1
1725,CC:2F:71:3E:C5:1F,3241358,409350885,11552,1413236,3229806,407937649,6,49252,4125532,40692,3111298,8560,1014234,12181,36,16553,190,6,856,144444.0,39000.0,-69.0,-71.0,-72.0,-61.0,-69.0,-73.0,-71.0,-62.0,-90.0,-93.0,-90.0,-92.0,21.0,22.0,18.0,31.0,1
1726,CC:2F:71:3F:1F:24,11940958,13770517902,8711152,13362580253,3229806,407937649,158,1975047,1159644913,1966352,1158600457,8695,1044456,1910634,675,8715972,926915,158,6661,86667.0,14444.0,-72.0,-64.0,-72.0,-69.0,-72.0,-64.0,-72.0,-69.0,-90.0,-93.0,-90.0,-92.0,18.0,29.0,18.0,23.0,1
1727,92:69:1D:31:68:E9,3257973,467551971,28164,59613847,3229809,407938124,0,12783,4019451,12662,3999574,121,19877,8216,1,28210,2060,0,143,229410.0,137640.0,-50.0,-50.0,-45.0,-49.0,-50.0,-50.0,-45.0,-49.0,-90.0,-93.0,-90.0,-93.0,40.0,43.0,45.0,44.0,1
1728,BA:8C:B9:54:50:24,3273005,505981415,43196,98043291,3229809,407938124,64,14974,4538880,14841,4516864,133,22016,9310,6,43174,10372,64,230,216660.0,130000.0,-53.0,-50.0,-38.0,-46.0,-50.0,-50.0,-40.0,-47.0,-90.0,-93.0,-90.0,-93.0,37.0,43.0,52.0,47.0,1
1729,62:47:05:9D:EB:15,3244209,442297399,14398,34359073,3229811,407938326,64,6364,1235646,6297,1224206,67,11440,2995,1,14381,2359,64,169,229410.0,137640.0,-43.0,-49.0,-44.0,-44.0,-42.0,-48.0,-43.0,-41.0,-90.0,-93.0,-90.0,-93.0,47.0,44.0,46.0,49.0,1
1730,F8:59:71:5A:E0:3D,3493699,805851525,263886,397912997,3229813,407938528,3,263182,356197755,258263,355610127,4919,587628,239472,20,266639,6894,3,834,144444.0,43333.0,-68.0,-74.0,-67.0,-71.0,-68.0,-73.0,-67.0,-70.0,-90.0,-93.0,-90.0,-93.0,22.0,19.0,23.0,22.0,1
1731,CC:2F:71:3E:C5:1F,3241366,409351826,11552,1413236,3229814,407938590,6,49252,4125532,40692,3111298,8560,1014234,12181,36,16553,190,6,856,144444.0,39000.0,-69.0,-71.0,-72.0,-61.0,-69.0,-73.0,-71.0,-62.0,-90.0,-93.0,-90.0,-93.0,21.0,22.0,18.0,32.0,1
1732,CC:2F:71:3F:1F:24,11943376,13774249951,8713562,13366311361,3229814,407938590,158,1975664,1159976559,1966968,1158931985,8696,1044574,1911240,675,8718361,927000,158,6662,86667.0,14444.0,-72.0,-64.0,-71.0,-69.0,-72.0,-64.0,-71.0,-69.0,-90.0,-93.0,-90.0,-93.0,18.0,29.0,19.0,24.0,1
1733,92:69:1D:31:68:E9,3258153,467961112,28336,60022260,3229817,407938852,0,12838,4033157,12717,4013280,121,19877,8252,1,28382,2063,0,143,229410.0,137640.0,-55.0,-49.0,-45.0,-51.0,-51.0,-49.0,-44.0,-49.0,-90.0,-93.0,-90.0,-93.0,35.0,44.0,45.0,42.0,1
1734,BA:8C:B9:54:50:24,3273218,506520009,43401,98581157,3229817,407938852,64,15004,4545363,14871,4523347,133,22016,9331,6,43379,10380,64,230,229410.0,130000.0,-47.0,-49.0,-53.0,-46.0,-50.0,-52.0,-45.0,-49.0,-90.0,-93.0,-90.0,-93.0,43.0,44.0,37.0,47.0,1
1735,62:47:05:9D:EB:15,3244215,442297925,14398,34359073,3229817,407938852,64,6364,1235646,6297,1224206,67,11440,2995,1,14381,2359,64,169,229410.0,137640.0,-43.0,-49.0,-44.0,-44.0,-42.0,-48.0,-43.0,-41.0,-90.0,-93.0,-90.0,-93.0,47.0,44.0,46.0,49.0,1
1736,F8:59:71:5A:E0:3D,3493793,805991709,263976,398052857,3229817,407938852,3,263275,356341017,258356,355753389,4919,587628,239562,20,266729,6898,3,834,144444.0,43333.0,-68.0,-74.0,-67.0,-71.0,-68.0,-74.0,-67.0,-71.0,-90.0,-93.0,-90.0,-93.0,22.0,19.0,23.0,22.0,1
1737,CC:2F:71:3E:C5:1F,3241369,409352088,11552,1413236,3229817,407938852,6,49252,4125532,40692,3111298,8560,1014234,12181,36,16553,190,6,856,144444.0,39000.0,-69.0,-71.0,-72.0,-61.0,-69.0,-73.0,-71.0,-62.0,-90.0,-93.0,-90.0,-93.0,21.0,22.0,18.0,32.0,1
1738,CC:2F:71:3F:1F:24,11944797,13776410626,8714980,13368471774,3229817,407938852,158,1976099,1160281472,1967403,1159236898,8696,1044574,1911672,675,8719813,927293,158,6662,115556.0,28889.0,-73.0,-64.0,-72.0,-69.0,-72.0,-64.0,-72.0,-69.0,-90.0,-93.0,-90.0,-93.0,17.0,29.0,18.0,24.0,1
1739,92:69:1D:31:68:E9,3258162,467962018,28336,60022260,3229826,407939758,0,12847,4033872,12725,4013824,122,20048,8253,1,28382,2063,0,143,229410.0,137640.0,-55.0,-49.0,-44.0,-50.0,-51.0,-49.0,-46.0,-51.0,-90.0,-93.0,-90.0,-93.0,35.0,44.0,46.0,43.0,1
1740,BA:8C:B9:54:50:24,3273229,506521117,43401,98581157,3229828,407939960,64,15007,4545670,14873,4523483,134,22187,9332,6,43379,10380,64,230,229410.0,130000.0,-46.0,-50.0,-53.0,-46.0,-49.0,-51.0,-47.0,-48.0,-90.0,-93.0,-90.0,-93.0,44.0,43.0,37.0,47.0,1
1741,62:47:05:9D:EB:15,3244226,442299033,14398,34359073,3229828,407939960,64,6391,1237552,6323,1225974,68,11578,2996,1,14381,2359,64,169,229410.0,137640.0,-43.0,-49.0,-43.0,-45.0,-46.0,-51.0,-47.0,-45.0,-90.0,-93.0,-90.0,-93.0,47.0,44.0,47.0,48.0,1
1742,F8:59:71:5A:E0:3D,3493890,806126461,264062,398186501,3229828,407939960,3,263364,356478119,258445,355890491,4919,587628,239648,20,266814,6900,3,834,144444.0,43333.0,-68.0,-74.0,-67.0,-70.0,-67.0,-73.0,-66.0,-70.0,-90.0,-93.0,-90.0,-93.0,22.0,19.0,23.0,23.0,1
1743,CC:2F:71:3E:C5:1F,3241380,409353196,11552,1413236,3229828,407939960,6,49252,4125532,40692,3111298,8560,1014234,12181,36,16553,190,6,856,144444.0,39000.0,-69.0,-71.0,-72.0,-61.0,-69.0,-73.0,-71.0,-62.0,-90.0,-93.0,-90.0,-93.0,21.0,22.0,18.0,32.0,1
1744,CC:2F:71:3F:1F:24,11946201,13778534971,8716373,13370595011,3229828,407939960,158,1976521,1160575029,1967825,1159530455,8696,1044574,1912093,675,8721193,927565,158,6662,115556.0,28889.0,-72.0,-64.0,-72.0,-69.0,-72.0,-64.0,-72.0,-69.0,-90.0,-93.0,-90.0,-93.0,18.0,29.0,18.0,24.0,1
1745,92:69:1D:31:68:E9,3258165,467962280,28336,60022260,3229829,407940020,0,12847,4033872,12725,4013824,122,20048,8253,1,28382,2063,0,143,229410.0,137640.0,-55.0,-49.0,-44.0,-50.0,-51.0,-49.0,-46.0,-51.0,-90.0,-93.0,-90.0,-92.0,35.0,44.0,46.0,42.0,1
1746,BA:8C:B9:54:50:24,3273232,506521379,43401,98581157,3229831,407940222,64,15007,4545670,14873,4523483,134,22187,9332,6,43379,10380,64,230,229410.0,130000.0,-46.0,-50.0,-53.0,-46.0,-49.0,-51.0,-47.0,-48.0,-90.0,-93.0,-90.0,-92.0,44.0,43.0,37.0,46.0,1
1747,62:47:05:9D:EB:15,3244229,442299295,14398,34359073,3229831,407940222,64,6391,1237552,6323,1225974,68,11578,2996,1,14381,2359,64,169,229410.0,137640.0,-43.0,-49.0,-43.0,-45.0,-46.0,-51.0,-47.0,-45.0,-90.0,-93.0,-90.0,-92.0,47.0,44.0,47.0,47.0,1
1748,F8:59:71:5A:E0:3D,3493975,806254151,264144,398313929,3229831,407940222,3,263446,356604399,258527,356016771,4919,587628,239730,20,266897,6902,3,834,144444.0,43333.0,-68.0,-74.0,-67.0,-71.0,-68.0,-74.0,-67.0,-71.0,-90.0,-93.0,-90.0,-92.0,22.0,19.0,23.0,21.0,1
1749,CC:2F:71:3E:C5:1F,3241385,409353660,11552,1413236,3229833,407940424,6,49252,4125532,40692,3111298,8560,1014234,12181,36,16553,190,6,856,144444.0,39000.0,-69.0,-71.0,-72.0,-61.0,-69.0,-73.0,-71.0,-62.0,-90.0,-93.0,-90.0,-92.0,21.0,22.0,18.0,31.0,1
1750,CC:2F:71:3F:1F:24,11947995,13781276692,8718160,13373336066,3229835,407940626,158,1976988,1160873410,1968292,1159828836,8696,1044574,1912559,675,8722993,928086,158,6662,115556.0,28889.0,-73.0,-64.0,-72.0,-69.0,-72.0,-64.0,-72.0,-69.0,-90.0,-93.0,-90.0,-92.0,17.0,29.0,18.0,23.0,1
1751,92:69:1D:31:68:E9,3258173,467963088,28336,60022260,3229837,407940828,0,12847,4033872,12725,4013824,122,20048,8253,1,28382,2063,0,143,229410.0,137640.0,-55.0,-49.0,-44.0,-50.0,-51.0,-49.0,-46.0,-51.0,-90.0,-93.0,-90.0,-92.0,35.0,44.0,46.0,42.0,1
1752,BA:8C:B9:54:50:24,3273240,506522187,43401,98581157,3229839,407941030,64,15007,4545670,14873,4523483,134,22187,9332,6,43379,10380,64,230,229410.0,130000.0,-46.0,-50.0,-53.0,-46.0,-49.0,-51.0,-47.0,-48.0,-90.0,-93.0,-90.0,-92.0,44.0,43.0,37.0,46.0,1
1753,62:47:05:9D:EB:15,3244242,442300567,14398,34359073,3229844,407941494,64,6391,1237552,6323,1225974,68,11578,2996,1,14381,2359,64,169,229410.0,137640.0,-43.0,-49.0,-43.0,-45.0,-46.0,-51.0,-47.0,-45.0,-90.0,-93.0,-90.0,-92.0,47.0,44.0,47.0,47.0,1
1754,F8:59:71:5A:E0:3D,3494235,806629100,264384,398686889,3229851,407942211,3,263720,357025197,258801,356437569,4919,587628,239980,20,267137,6913,3,835,144444.0,43333.0,-67.0,-73.0,-66.0,-70.0,-67.0,-73.0,-66.0,-70.0,-90.0,-93.0,-90.0,-92.0,23.0,20.0,24.0,22.0,1
1755,CC:2F:71:3E:C5:1F,3241406,409355709,11552,1413236,3229854,407942473,6,49252,4125532,40692,3111298,8560,1014234,12181,36,16553,190,6,856,144444.0,39000.0,-69.0,-71.0,-72.0,-61.0,-69.0,-73.0,-71.0,-62.0,-90.0,-93.0,-90.0,-92.0,21.0,22.0,18.0,31.0,1
1756,CC:2F:71:3F:1F:24,11950451,13784990109,8720595,13377047434,3229856,407942675,158,1977990,1161899245,1969294,1160854671,8696,1044574,1913484,675,8725428,928715,158,6664,130000.0,43333.0,-72.0,-64.0,-72.0,-69.0,-72.0,-64.0,-71.0,-69.0,-90.0,-93.0,-90.0,-92.0,18.0,29.0,18.0,23.0,1
1757,92:69:1D:31:68:E9,3258192,467964935,28336,60022260,3229856,407942675,0,12847,4033872,12725,4013824,122,20048,8253,1,28382,2063,0,143,229410.0,137640.0,-55.0,-49.0,-44.0,-50.0,-51.0,-49.0,-46.0,-51.0,-89.0,-92.0,-89.0,-92.0,34.0,43.0,45.0,42.0,1
1758,BA:8C:B9:54:50:24,3273257,506523832,43401,98581157,3229856,407942675,64,15007,4545670,14873,4523483,134,22187,9332,6,43379,10380,64,230,229410.0,130000.0,-46.0,-50.0,-53.0,-46.0,-49.0,-51.0,-47.0,-48.0,-89.0,-92.0,-89.0,-92.0,43.0,42.0,36.0,46.0,1
1759,62:47:05:9D:EB:15,3244603,443224854,14747,35282179,3229856,407942675,64,6459,1247459,6390,1235710,69,11749,3022,1,14730,2399,64,172,216660.0,130000.0,-43.0,-48.0,-44.0,-45.0,-43.0,-47.0,-44.0,-40.0,-89.0,-92.0,-89.0,-92.0,46.0,44.0,45.0,47.0,1
1760,F8:59:71:5A:E0:3D,3494375,806839354,264519,398896679,3229856,407942675,3,263854,357229345,258935,356641717,4919,587628,240109,20,267272,6914,3,835,144444.0,43333.0,-67.0,-73.0,-66.0,-70.0,-67.0,-73.0,-66.0,-70.0,-89.0,-92.0,-89.0,-92.0,22.0,19.0,23.0,22.0,1
1761,CC:2F:71:3E:C5:1F,3241410,409356113,11552,1413236,3229858,407942877,6,49252,4125532,40692,3111298,8560,1014234,12181,36,16553,190,6,856,144444.0,39000.0,-69.0,-71.0,-72.0,-61.0,-69.0,-73.0,-71.0,-62.0,-89.0,-92.0,-89.0,-92.0,20.0,21.0,17.0,31.0,1
1762,CC:2F:71:3F:1F:24,11952111,13787534465,8722251,13379591386,3229860,407943079,158,1978413,1162226347,1969717,1161181773,8696,1044574,1913881,675,8727084,929070,158,6664,130000.0,43333.0,-73.0,-64.0,-73.0,-69.0,-73.0,-64.0,-72.0,-68.0,-89.0,-92.0,-89.0,-92.0,16.0,28.0,16.0,23.0,1
1763,92:69:1D:31:68:E9,3258200,467965743,28336,60022260,3229864,407943483,0,12847,4033872,12725,4013824,122,20048,8253,1,28382,2063,0,143,229410.0,137640.0,-55.0,-49.0,-44.0,-50.0,-51.0,-49.0,-46.0,-51.0,-89.0,-92.0,-89.0,-92.0,34.0,43.0,45.0,42.0,1
1764,BA:8C:B9:54:50:24,3273265,506524640,43401,98581157,3229864,407943483,64,15007,4545670,14873,4523483,134,22187,9332,6,43379,10380,64,230,229410.0,130000.0,-46.0,-50.0,-53.0,-46.0,-49.0,-51.0,-47.0,-48.0,-89.0,-92.0,-89.0,-92.0,43.0,42.0,36.0,46.0,1
1765,62:47:05:9D:EB:15,3244611,443225662,14747,35282179,3229864,407943483,64,6459,1247459,6390,1235710,69,11749,3022,1,14730,2399,64,172,216660.0,130000.0,-43.0,-48.0,-44.0,-45.0,-43.0,-47.0,-44.0,-40.0,-89.0,-92.0,-89.0,-92.0,46.0,44.0,45.0,47.0,1
1766,F8:59:71:5A:E0:3D,3494473,806980022,264609,399036539,3229864,407943483,3,263944,357368085,259025,356780457,4919,587628,240199,20,267362,6914,3,836,144444.0,43333.0,-67.0,-73.0,-66.0,-70.0,-67.0,-73.0,-66.0,-70.0,-89.0,-92.0,-89.0,-92.0,22.0,19.0,23.0,22.0,1
1767,CC:2F:71:3E:C5:1F,3241417,409356779,11552,1413236,3229865,407943543,6,49252,4125532,40692,3111298,8560,1014234,12181,36,16553,190,6,856,144444.0,39000.0,-69.0,-71.0,-72.0,-61.0,-69.0,-73.0,-71.0,-62.0,-89.0,-92.0,-89.0,-92.0,20.0,21.0,17.0,31.0,1
1768,CC:2F:71:3F:1F:24,11953451,13789550013,8723586,13381606470,3229865,407943543,158,1978792,1162532908,1970096,1161488334,8696,1044574,1914258,675,8728419,929179,158,6664,130000.0,43333.0,-74.0,-64.0,-73.0,-69.0,-73.0,-64.0,-72.0,-68.0,-89.0,-92.0,-89.0,-92.0,15.0,28.0,16.0,23.0,1
1769,92:69:1D:31:68:E9,3258205,467966207,28336,60022260,3229869,407943947,0,12847,4033872,12725,4013824,122,20048,8253,1,28382,2063,0,143,229410.0,137640.0,-55.0,-49.0,-44.0,-50.0,-51.0,-49.0,-46.0,-51.0,-89.0,-92.0,-89.0,-92.0,34.0,43.0,45.0,42.0,1
1770,BA:8C:B9:54:50:24,3273271,506525279,43401,98581157,3229870,407944122,64,15007,4545670,14873,4523483,134,22187,9332,6,43379,10380,64,230,229410.0,130000.0,-46.0,-50.0,-53.0,-46.0,-49.0,-51.0,-47.0,-48.0,-89.0,-92.0,-89.0,-92.0,43.0,42.0,36.0,46.0,1
1771,62:47:05:9D:EB:15,3244620,443226657,14748,35282333,3229872,407944324,64,6481,1249013,6412,1237264,69,11749,3023,1,14731,2399,64,172,216660.0,130000.0,-43.0,-48.0,-43.0,-44.0,-44.0,-49.0,-44.0,-42.0,-89.0,-92.0,-89.0,-92.0,46.0,44.0,46.0,48.0,1
1772,F8:59:71:5A:E0:3D,3494564,807109845,264692,399165521,3229872,407944324,3,264027,357495905,259108,356908277,4919,587628,240282,20,267445,6914,3,836,144444.0,43333.0,-67.0,-73.0,-66.0,-70.0,-67.0,-73.0,-66.0,-70.0,-89.0,-92.0,-89.0,-92.0,22.0,19.0,23.0,22.0,1
1773,CC:2F:71:3E:C5:1F,3241424,409357560,11552,1413236,3229872,407944324,6,49252,4125532,40692,3111298,8560,1014234,12181,36,16553,190,6,856,144444.0,39000.0,-69.0,-71.0,-72.0,-61.0,-69.0,-73.0,-71.0,-62.0,-89.0,-92.0,-89.0,-92.0,20.0,21.0,17.0,31.0,1
1774,CC:2F:71:3F:1F:24,11954799,13791595076,8724927,13383650752,3229872,407944324,158,1979141,1162806126,1970445,1161761552,8696,1044574,1914605,675,8729759,929322,158,6664,130000.0,43333.0,-73.0,-64.0,-72.0,-69.0,-72.0,-64.0,-72.0,-68.0,-89.0,-92.0,-89.0,-92.0,16.0,28.0,17.0,23.0,1
1775,92:69:1D:31:68:E9,3258211,467967059,28336,60022260,3229875,407944799,0,12850,4034243,12727,4013960,123,20283,8254,1,28382,2063,0,143,229410.0,137640.0,-53.0,-51.0,-46.0,-51.0,-51.0,-49.0,-45.0,-50.0,-90.0,-92.0,-89.0,-92.0,37.0,41.0,43.0,41.0,1
1776,BA:8C:B9:54:50:24,3273276,506525956,43401,98581157,3229875,407944799,64,15007,4545670,14873,4523483,134,22187,9332,6,43379,10380,64,230,229410.0,130000.0,-46.0,-50.0,-53.0,-46.0,-49.0,-51.0,-47.0,-48.0,-90.0,-92.0,-89.0,-92.0,44.0,42.0,36.0,46.0,1
1777,62:47:05:9D:EB:15,3244623,443227132,14748,35282333,3229875,407944799,64,6481,1249013,6412,1237264,69,11749,3023,1,14731,2399,64,172,216660.0,130000.0,-43.0,-48.0,-43.0,-44.0,-44.0,-49.0,-44.0,-42.0,-90.0,-92.0,-89.0,-92.0,47.0,44.0,46.0,48.0,1
1778,F8:59:71:5A:E0:3D,3494655,807247072,264780,399302273,3229875,407944799,3,264115,357631425,259196,357043797,4919,587628,240370,20,267533,6916,3,836,144444.0,43333.0,-67.0,-73.0,-67.0,-70.0,-67.0,-73.0,-67.0,-70.0,-90.0,-92.0,-89.0,-92.0,23.0,19.0,22.0,22.0,1
1779,CC:2F:71:3E:C5:1F,3241427,409358035,11552,1413236,3229875,407944799,6,49252,4125532,40692,3111298,8560,1014234,12181,36,16553,190,6,856,144444.0,39000.0,-69.0,-71.0,-72.0,-61.0,-69.0,-73.0,-71.0,-62.0,-90.0,-92.0,-89.0,-92.0,21.0,21.0,17.0,31.0,1
1780,CC:2F:71:3F:1F:24,11956295,13793862953,8726420,13385918154,3229875,407944799,158,1979546,1163106602,1970850,1162062028,8696,1044574,1915010,675,8731252,929688,158,6665,130000.0,43333.0,-71.0,-63.0,-72.0,-68.0,-70.0,-63.0,-71.0,-67.0,-90.0,-92.0,-89.0,-92.0,19.0,29.0,17.0,24.0,1
1781,92:69:1D:31:68:E9,3258333,468267797,28451,60322332,3229882,407945465,0,12871,4039554,12748,4019271,123,20283,8269,1,28497,2065,0,143,229410.0,137640.0,-49.0,-50.0,-46.0,-49.0,-49.0,-50.0,-45.0,-49.0,-90.0,-92.0,-90.0,-93.0,41.0,42.0,44.0,44.0,1
1782,BA:8C:B9:54:50:24,3273283,506526622,43401,98581157,3229882,407945465,64,15007,4545670,14873,4523483,134,22187,9332,6,43379,10380,64,230,229410.0,130000.0,-46.0,-50.0,-53.0,-46.0,-49.0,-51.0,-47.0,-48.0,-90.0,-92.0,-90.0,-93.0,44.0,42.0,37.0,47.0,1
1783,62:47:05:9D:EB:15,3244632,443228000,14748,35282333,3229884,407945667,64,6481,1249013,6412,1237264,69,11749,3023,1,14731,2399,64,172,216660.0,130000.0,-43.0,-48.0,-43.0,-44.0,-44.0,-49.0,-44.0,-42.0,-90.0,-92.0,-90.0,-93.0,47.0,44.0,47.0,49.0,1
1784,F8:59:71:5A:E0:3D,3494744,807372260,264860,399426593,3229884,407945667,3,264196,357756179,259277,357168551,4919,587628,240450,20,267612,6918,3,836,144444.0,43333.0,-67.0,-74.0,-66.0,-70.0,-67.0,-74.0,-66.0,-70.0,-90.0,-92.0,-90.0,-93.0,23.0,18.0,24.0,23.0,1
1785,CC:2F:71:3E:C5:1F,3241436,409358903,11552,1413236,3229884,407945667,6,49252,4125532,40692,3111298,8560,1014234,12181,36,16553,190,6,856,144444.0,39000.0,-69.0,-71.0,-72.0,-61.0,-69.0,-73.0,-71.0,-62.0,-90.0,-92.0,-90.0,-93.0,21.0,21.0,18.0,32.0,1
1786,CC:2F:71:3F:1F:24,11957622,13795868836,8727738,13387923169,3229884,407945667,158,1979901,1163378065,1971205,1162333491,8696,1044574,1915365,675,8732571,929854,158,6665,115556.0,28889.0,-70.0,-64.0,-73.0,-70.0,-70.0,-64.0,-72.0,-70.0,-90.0,-92.0,-90.0,-93.0,20.0,28.0,17.0,23.0,1
1787,92:69:1D:31:68:E9,3258336,468268115,28452,60322448,3229884,407945667,0,12874,4039758,12751,4019475,123,20283,8269,1,28498,2065,0,144,229410.0,137640.0,-54.0,-51.0,-45.0,-51.0,-50.0,-50.0,-45.0,-49.0,-90.0,-92.0,-90.0,-93.0,36.0,41.0,45.0,42.0,1
1788,BA:8C:B9:54:50:24,3273315,506564823,43431,98619156,3229884,407945667,64,15021,4547004,14887,4524817,134,22187,9336,6,43409,10380,64,230,229410.0,130000.0,-54.0,-51.0,-38.0,-46.0,-47.0,-48.0,-38.0,-46.0,-90.0,-92.0,-90.0,-93.0,36.0,41.0,52.0,47.0,1
1789,62:47:05:9D:EB:15,3244633,443228116,14749,35282449,3229884,407945667,64,6483,1249149,6414,1237400,69,11749,3023,1,14732,2399,64,173,216660.0,130000.0,-43.0,-48.0,-43.0,-43.0,-44.0,-48.0,-43.0,-41.0,-90.0,-92.0,-90.0,-93.0,47.0,44.0,47.0,50.0,1
1790,F8:59:71:5A:E0:3D,3494824,807494974,264940,399549307,3229884,407945667,3,264273,357874801,259354,357287173,4919,587628,240527,20,267693,6919,3,836,144444.0,43333.0,-67.0,-74.0,-66.0,-69.0,-67.0,-74.0,-66.0,-70.0,-90.0,-92.0,-90.0,-93.0,23.0,18.0,24.0,24.0,1
1791,CC:2F:71:3E:C5:1F,3241439,409359221,11553,1413352,3229886,407945869,6,49254,4125672,40694,3111438,8560,1014234,12181,36,16554,190,6,856,144444.0,39000.0,-68.0,-72.0,-69.0,-61.0,-69.0,-73.0,-71.0,-62.0,-90.0,-92.0,-90.0,-93.0,22.0,20.0,21.0,32.0,1
1792,CC:2F:71:3F:1F:24,11958857,13797740088,8728969,13389794017,3229888,407946071,158,1980286,1163667055,1971590,1162622481,8696,1044574,1915748,675,8733802,929967,158,6665,115556.0,28889.0,-68.0,-65.0,-72.0,-69.0,-69.0,-66.0,-72.0,-69.0,-90.0,-92.0,-90.0,-93.0,22.0,27.0,18.0,24.0,1
1793,92:69:1D:31:68:E9,3258347,468269107,28452,60322448,3229895,407946659,0,12875,4039826,12752,4019543,123,20283,8269,1,28498,2065,0,144,229410.0,137640.0,-51.0,-53.0,-52.0,-55.0,-51.0,-50.0,-46.0,-50.0,-90.0,-92.0,-90.0,-93.0,39.0,39.0,38.0,38.0,1
1794,BA:8C:B9:54:50:24,3273326,506565815,43431,98619156,3229895,407946659,64,15021,4547004,14887,4524817,134,22187,9336,6,43409,10380,64,230,229410.0,130000.0,-54.0,-51.0,-38.0,-46.0,-47.0,-48.0,-38.0,-46.0,-90.0,-92.0,-90.0,-93.0,36.0,41.0,52.0,47.0,1
1795,62:47:05:9D:EB:15,3244644,443229108,14749,35282449,3229895,407946659,64,6486,1249407,6416,1237536,70,11871,3024,1,14732,2399,64,173,216660.0,130000.0,-43.0,-50.0,-42.0,-44.0,-45.0,-48.0,-44.0,-42.0,-90.0,-92.0,-90.0,-93.0,47.0,42.0,48.0,49.0,1
1796,F8:59:71:5A:E0:3D,3494921,807629610,265026,399682951,3229895,407946659,3,264364,358015011,259445,357427383,4919,587628,240616,20,267779,6921,3,836,144444.0,43333.0,-67.0,-73.0,-66.0,-71.0,-67.0,-72.0,-66.0,-71.0,-90.0,-92.0,-90.0,-93.0,23.0,19.0,24.0,22.0,1
1797,CC:2F:71:3E:C5:1F,3241448,409360011,11553,1413352,3229895,407946659,6,49254,4125672,40694,3111438,8560,1014234,12181,36,16554,190,6,856,144444.0,39000.0,-68.0,-72.0,-69.0,-61.0,-69.0,-73.0,-71.0,-62.0,-90.0,-92.0,-90.0,-93.0,22.0,20.0,21.0,32.0,1
1798,CC:2F:71:3F:1F:24,11959963,13799404834,8730068,13391458175,3229895,407946659,158,1980601,1163945013,1971904,1162900321,8697,1044692,1916061,675,8734901,930019,158,6665,115556.0,28889.0,-68.0,-65.0,-73.0,-67.0,-67.0,-65.0,-73.0,-67.0,-90.0,-92.0,-90.0,-93.0,22.0,27.0,17.0,26.0,1
1799,92:69:1D:31:68:E9,3258352,468269573,28452,60322448,3229900,407947125,0,12878,4040084,12754,4019679,124,20405,8270,1,28498,2065,0,144,229410.0,137640.0,-52.0,-51.0,-46.0,-51.0,-51.0,-51.0,-46.0,-50.0,-90.0,-92.0,-90.0,-93.0,38.0,41.0,44.0,42.0,1
1800,BA:8C:B9:54:50:24,3273480,506957004,43580,99009879,3229900,407947125,64,15061,4554239,14927,4532052,134,22187,9358,6,43558,10878,64,230,229410.0,137640.0,-53.0,-51.0,-38.0,-46.0,-49.0,-50.0,-41.0,-47.0,-90.0,-92.0,-90.0,-93.0,37.0,41.0,52.0,47.0,1
1801,62:47:05:9D:EB:15,3244690,443282457,14790,35335332,3229900,407947125,64,6521,1252482,6451,1240611,70,11871,3030,1,14773,2411,64,173,229410.0,130000.0,-46.0,-52.0,-48.0,-45.0,-46.0,-52.0,-48.0,-45.0,-90.0,-92.0,-90.0,-93.0,44.0,40.0,42.0,48.0,1
1802,F8:59:71:5A:E0:3D,3495015,807765476,265113,399818149,3229902,407947327,3,264450,358147675,259531,357560047,4919,587628,240702,20,267866,6921,3,837,144444.0,43333.0,-67.0,-73.0,-66.0,-72.0,-67.0,-73.0,-66.0,-72.0,-90.0,-92.0,-90.0,-93.0,23.0,19.0,24.0,21.0,1
1803,CC:2F:71:3E:C5:1F,3241455,409360679,11553,1413352,3229902,407947327,6,49254,4125672,40694,3111438,8560,1014234,12181,36,16554,190,6,856,144444.0,39000.0,-68.0,-72.0,-69.0,-61.0,-69.0,-73.0,-71.0,-62.0,-90.0,-92.0,-90.0,-93.0,22.0,20.0,21.0,32.0,1
1804,CC:2F:71:3F:1F:24,11961361,13801517995,8731457,13393570466,3229904,407947529,158,1980988,1164237308,1972291,1163192616,8697,1044692,1916448,675,8736290,930152,158,6665,130000.0,39000.0,-68.0,-65.0,-74.0,-68.0,-67.0,-65.0,-74.0,-68.0,-90.0,-92.0,-90.0,-93.0,22.0,27.0,16.0,25.0,1
1805,92:69:1D:31:68:E9,3258357,468270037,28452,60322448,3229905,407947589,0,12878,4040084,12754,4019679,124,20405,8270,1,28498,2065,0,144,229410.0,137640.0,-52.0,-51.0,-46.0,-51.0,-51.0,-51.0,-46.0,-50.0,-90.0,-92.0,-90.0,-93.0,38.0,41.0,44.0,42.0,1
1806,BA:8C:B9:54:50:24,3273485,506957468,43580,99009879,3229905,407947589,64,15062,4554307,14928,4532120,134,22187,9358,6,43558,10878,64,230,229410.0,137640.0,-46.0,-50.0,-53.0,-46.0,-48.0,-50.0,-42.0,-46.0,-90.0,-92.0,-90.0,-93.0,44.0,42.0,37.0,47.0,1
1807,62:47:05:9D:EB:15,3244695,443282921,14790,35335332,3229905,407947589,64,6522,1252550,6452,1240679,70,11871,3030,1,14773,2411,64,173,229410.0,130000.0,-43.0,-50.0,-44.0,-45.0,-45.0,-51.0,-47.0,-45.0,-90.0,-92.0,-90.0,-93.0,47.0,42.0,46.0,48.0,1
1808,F8:59:71:5A:E0:3D,3495104,807899382,265199,399951793,3229905,407947589,3,264538,358283279,259619,357695651,4919,587628,240789,20,267952,6925,3,838,144444.0,43333.0,-67.0,-73.0,-66.0,-72.0,-67.0,-72.0,-66.0,-71.0,-90.0,-92.0,-90.0,-93.0,23.0,19.0,24.0,21.0,1
1809,CC:2F:71:3E:C5:1F,3241458,409360941,11553,1413352,3229905,407947589,6,49254,4125672,40694,3111438,8560,1014234,12181,36,16554,190,6,856,144444.0,39000.0,-68.0,-72.0,-69.0,-61.0,-69.0,-73.0,-71.0,-62.0,-90.0,-92.0,-90.0,-93.0,22.0,20.0,21.0,32.0,1
1810,CC:2F:71:3F:1F:24,11962639,13803462904,8732734,13395515315,3229905,407947589,158,1981338,1164532131,1972641,1163487439,8697,1044692,1916797,675,8737567,930164,158,6665,130000.0,43333.0,-67.0,-65.0,-74.0,-67.0,-67.0,-65.0,-73.0,-67.0,-90.0,-92.0,-90.0,-93.0,23.0,27.0,16.0,26.0,1
1811,92:69:1D:31:68:E9,3258365,468270845,28452,60322448,3229913,407948397,0,12878,4040084,12754,4019679,124,20405,8270,1,28498,2065,0,144,229410.0,137640.0,-52.0,-51.0,-46.0,-51.0,-51.0,-51.0,-46.0,-50.0,-90.0,-92.0,-90.0,-93.0,38.0,41.0,44.0,42.0,1
1812,BA:8C:B9:54:50:24,3273493,506958276,43580,99009879,3229913,407948397,64,15062,4554307,14928,4532120,134,22187,9358,6,43558,10878,64,230,229410.0,137640.0,-46.0,-50.0,-53.0,-46.0,-48.0,-50.0,-42.0,-46.0,-90.0,-92.0,-90.0,-93.0,44.0,42.0,37.0,47.0,1
1813,62:47:05:9D:EB:15,3244703,443283729,14790,35335332,3229913,407948397,64,6522,1252550,6452,1240679,70,11871,3030,1,14773,2411,64,173,229410.0,130000.0,-43.0,-50.0,-44.0,-45.0,-45.0,-51.0,-47.0,-45.0,-90.0,-92.0,-90.0,-93.0,47.0,42.0,46.0,48.0,1
1814,F8:59:71:5A:E0:3D,3495196,808030726,265283,400082329,3229913,407948397,3,264624,358415761,259705,357828133,4919,587628,240872,20,268036,6925,3,838,144444.0,43333.0,-68.0,-73.0,-67.0,-72.0,-68.0,-73.0,-66.0,-71.0,-90.0,-92.0,-90.0,-93.0,22.0,19.0,23.0,21.0,1
1815,CC:2F:71:3E:C5:1F,3241466,409361749,11553,1413352,3229913,407948397,6,49254,4125672,40694,3111438,8560,1014234,12181,36,16554,190,6,856,144444.0,39000.0,-68.0,-72.0,-69.0,-61.0,-69.0,-73.0,-71.0,-62.0,-90.0,-92.0,-90.0,-93.0,22.0,20.0,21.0,32.0,1
1816,CC:2F:71:3F:1F:24,11964473,13806276404,8734560,13398328007,3229913,407948397,158,1981763,1164818485,1973066,1163773793,8697,1044692,1917221,675,8739391,930288,158,6665,144444.0,43333.0,-67.0,-65.0,-74.0,-68.0,-67.0,-65.0,-73.0,-67.0,-90.0,-92.0,-90.0,-93.0,23.0,27.0,16.0,25.0,1
1817,92:69:1D:31:68:E9,3258369,468271169,28452,60322448,3229917,407948721,0,12878,4040084,12754,4019679,124,20405,8270,1,28498,2065,0,144,229410.0,137640.0,-52.0,-51.0,-46.0,-51.0,-51.0,-51.0,-46.0,-50.0,-90.0,-92.0,-90.0,-93.0,38.0,41.0,44.0,42.0,1
1818,BA:8C:B9:54:50:24,3273498,506958716,43581,99009995,3229917,407948721,64,15069,4554875,14934,4532566,135,22309,9360,6,43559,10878,64,230,229410.0,137640.0,-53.0,-51.0,-38.0,-46.0,-49.0,-50.0,-46.0,-46.0,-90.0,-92.0,-90.0,-93.0,37.0,41.0,52.0,47.0,1
1819,62:47:05:9D:EB:15,3244768,443301868,14849,35352945,3229919,407948923,64,6679,1350848,6609,1338977,70,11871,3092,1,14830,2440,64,176,229410.0,137640.0,-46.0,-52.0,-47.0,-45.0,-43.0,-49.0,-44.0,-41.0,-90.0,-92.0,-90.0,-92.0,44.0,40.0,43.0,47.0,1
1820,F8:59:71:5A:E0:3D,3495290,808166512,265370,400217527,3229920,407948985,3,264711,358549951,259792,357962323,4919,587628,240959,20,268123,6926,3,840,144444.0,43333.0,-67.0,-73.0,-66.0,-71.0,-67.0,-73.0,-66.0,-71.0,-90.0,-92.0,-90.0,-92.0,23.0,19.0,24.0,21.0,1
1821,CC:2F:71:3E:C5:1F,3241473,409362337,11553,1413352,3229920,407948985,6,49255,4125790,40694,3111438,8561,1014352,12182,36,16554,190,6,856,144444.0,39000.0,-69.0,-72.0,-69.0,-60.0,-69.0,-73.0,-71.0,-62.0,-90.0,-92.0,-90.0,-92.0,21.0,20.0,21.0,32.0,1
1822,CC:2F:71:3F:1F:24,11965514,13807842796,8735594,13399893811,3229920,407948985,158,1982129,1165113996,1973432,1164069304,8697,1044692,1917581,675,8740419,930357,158,6665,130000.0,43333.0,-68.0,-65.0,-73.0,-67.0,-67.0,-65.0,-73.0,-67.0,-90.0,-92.0,-90.0,-92.0,22.0,27.0,17.0,25.0,1
1823,92:69:1D:31:68:E9,3258376,468271837,28452,60322448,3229924,407949389,0,12878,4040084,12754,4019679,124,20405,8270,1,28498,2065,0,144,229410.0,137640.0,-52.0,-51.0,-46.0,-51.0,-51.0,-51.0,-46.0,-50.0,-90.0,-92.0,-90.0,-92.0,38.0,41.0,44.0,41.0,1
1824,BA:8C:B9:54:50:24,3273505,506959384,43581,99009995,3229924,407949389,64,15070,4554943,14935,4532634,135,22309,9360,6,43559,10878,64,230,229410.0,137640.0,-53.0,-51.0,-38.0,-46.0,-50.0,-50.0,-44.0,-46.0,-90.0,-92.0,-90.0,-92.0,37.0,41.0,52.0,46.0,1
1825,62:47:05:9D:EB:15,3244774,443302503,14850,35353114,3229924,407949389,64,6685,1351459,6615,1339588,70,11871,3095,1,14833,2440,64,176,229410.0,137640.0,-43.0,-51.0,-43.0,-44.0,-44.0,-51.0,-45.0,-43.0,-90.0,-92.0,-90.0,-92.0,47.0,41.0,47.0,48.0,1
1826,F8:59:71:5A:E0:3D,3495377,808295898,265453,400346509,3229924,407949389,3,264794,358677771,259875,358090143,4919,587628,241042,20,268206,6928,3,840,144444.0,43333.0,-67.0,-73.0,-67.0,-71.0,-67.0,-73.0,-66.0,-71.0,-90.0,-92.0,-90.0,-92.0,23.0,19.0,23.0,21.0,1
1827,CC:2F:71:3E:C5:1F,3241477,409362741,11553,1413352,3229924,407949389,6,49256,4125860,40695,3111508,8561,1014352,12182,36,16554,190,6,856,144444.0,39000.0,-69.0,-73.0,-69.0,-60.0,-68.0,-71.0,-70.0,-60.0,-90.0,-92.0,-90.0,-92.0,21.0,19.0,21.0,32.0,1
1828,CC:2F:71:3F:1F:24,11967252,13810451907,8737328,13402502518,3229924,407949389,158,1982698,1165457742,1974001,1164413050,8697,1044692,1918124,675,8742125,930372,158,6666,130000.0,43333.0,-68.0,-65.0,-73.0,-67.0,-67.0,-65.0,-72.0,-67.0,-90.0,-92.0,-90.0,-92.0,22.0,27.0,17.0,25.0,1
1829,92:69:1D:31:68:E9,3258387,468275579,28458,60325726,3229929,407949853,0,12887,4043157,12763,4022752,124,20405,8275,1,28504,2065,0,144,216660.0,130000.0,-52.0,-52.0,-46.0,-51.0,-50.0,-50.0,-45.0,-50.0,-90.0,-92.0,-90.0,-92.0,38.0,40.0,44.0,41.0,1
1830,BA:8C:B9:54:50:24,3273514,506960252,43581,99009995,3229933,407950257,64,15070,4554943,14935,4532634,135,22309,9360,6,43559,10878,64,230,229410.0,137640.0,-53.0,-51.0,-38.0,-46.0,-50.0,-50.0,-44.0,-46.0,-90.0,-92.0,-90.0,-92.0,37.0,41.0,52.0,46.0,1
1831,62:47:05:9D:EB:15,3244811,443316152,14878,35365895,3229933,407950257,64,6757,1380051,6687,1368180,70,11871,3128,1,14861,2440,64,177,229410.0,137640.0,-46.0,-53.0,-48.0,-46.0,-45.0,-52.0,-47.0,-45.0,-90.0,-92.0,-90.0,-92.0,44.0,39.0,42.0,46.0,1
1832,F8:59:71:5A:E0:3D,3495482,808445950,265549,400495693,3229933,407950257,3,264891,358827207,259972,358239579,4919,587628,241139,20,268302,6928,3,840,144444.0,43333.0,-67.0,-73.0,-66.0,-71.0,-67.0,-73.0,-66.0,-71.0,-90.0,-92.0,-90.0,-92.0,23.0,19.0,24.0,21.0,1
1833,CC:2F:71:3E:C5:1F,3241486,409363609,11553,1413352,3229933,407950257,6,49256,4125860,40695,3111508,8561,1014352,12182,36,16554,190,6,856,144444.0,39000.0,-69.0,-73.0,-69.0,-60.0,-68.0,-71.0,-70.0,-60.0,-90.0,-92.0,-90.0,-92.0,21.0,19.0,21.0,32.0,1
1834,CC:2F:71:3F:1F:24,11969085,13813163183,8739152,13405212926,3229933,407950257,158,1983208,1165794143,1974511,1164749451,8697,1044692,1918608,675,8743985,930450,158,6666,130000.0,43333.0,-68.0,-65.0,-73.0,-67.0,-67.0,-65.0,-73.0,-67.0,-90.0,-92.0,-90.0,-92.0,22.0,27.0,17.0,25.0,1
1835,92:69:1D:31:68:E9,3258392,468276045,28458,60325726,3229934,407950319,0,12887,4043157,12763,4022752,124,20405,8275,1,28504,2065,0,144,216660.0,130000.0,-52.0,-52.0,-46.0,-51.0,-50.0,-50.0,-45.0,-50.0,-90.0,-92.0,-90.0,-92.0,38.0,40.0,44.0,41.0,1
1836,BA:8C:B9:54:50:24,3273516,506960587,43581,99009995,3229935,407950592,64,15070,4554943,14935,4532634,135,22309,9360,6,43559,10878,64,230,229410.0,137640.0,-53.0,-51.0,-38.0,-46.0,-50.0,-50.0,-44.0,-46.0,-90.0,-92.0,-90.0,-92.0,37.0,41.0,52.0,46.0,1
1837,62:47:05:9D:EB:15,3244834,443319801,14897,35369007,3229937,407950794,64,6802,1390783,6732,1378912,70,11871,3142,1,14880,2440,64,177,229410.0,137640.0,-43.0,-50.0,-44.0,-45.0,-44.0,-51.0,-46.0,-45.0,-90.0,-92.0,-90.0,-92.0,47.0,42.0,46.0,47.0,1
1838,F8:59:71:5A:E0:3D,3495567,808572361,265630,400621567,3229937,407950794,3,264971,358948985,260051,358361239,4920,587746,241219,20,268382,6928,3,840,144444.0,43333.0,-67.0,-73.0,-66.0,-71.0,-67.0,-73.0,-66.0,-71.0,-90.0,-92.0,-90.0,-92.0,23.0,19.0,24.0,21.0,1
1839,CC:2F:71:3E:C5:1F,3241492,409364348,11553,1413352,3229939,407950996,6,49256,4125860,40695,3111508,8561,1014352,12182,36,16554,190,6,856,144444.0,39000.0,-69.0,-73.0,-69.0,-60.0,-68.0,-71.0,-70.0,-60.0,-90.0,-92.0,-89.0,-92.0,21.0,19.0,20.0,32.0,1
1840,CC:2F:71:3F:1F:24,11970461,13815254358,8740522,13407303362,3229939,407950996,158,1983575,1166075347,1974878,1165030655,8697,1044692,1918971,675,8745339,930517,158,6666,117000.0,39000.0,-68.0,-65.0,-73.0,-67.0,-67.0,-65.0,-72.0,-67.0,-90.0,-92.0,-89.0,-92.0,22.0,27.0,16.0,25.0,1
1841,92:69:1D:31:68:E9,3258401,468277126,28458,60325726,3229943,407951400,0,12887,4043157,12763,4022752,124,20405,8275,1,28504,2065,0,144,216660.0,130000.0,-52.0,-52.0,-46.0,-51.0,-50.0,-50.0,-45.0,-50.0,-90.0,-92.0,-89.0,-92.0,38.0,40.0,43.0,41.0,1
1842,BA:8C:B9:54:50:24,3273524,506961395,43581,99009995,3229943,407951400,64,15070,4554943,14935,4532634,135,22309,9360,6,43559,10878,64,230,229410.0,137640.0,-53.0,-51.0,-38.0,-46.0,-50.0,-50.0,-44.0,-46.0,-90.0,-92.0,-89.0,-92.0,37.0,41.0,51.0,46.0,1
1843,62:47:05:9D:EB:15,3245217,444317655,15273,36366195,3229944,407951460,64,6856,1400219,6786,1388348,70,11871,3177,1,15256,2448,64,178,229410.0,137640.0,-43.0,-50.0,-43.0,-45.0,-45.0,-52.0,-46.0,-45.0,-90.0,-92.0,-89.0,-92.0,47.0,42.0,46.0,47.0,1
1844,F8:59:71:5A:E0:3D,3495657,808702009,265713,400750549,3229944,407951460,3,265056,359079899,260136,358492153,4920,587746,241303,20,268466,6929,3,840,144444.0,43333.0,-68.0,-73.0,-66.0,-71.0,-67.0,-73.0,-66.0,-71.0,-90.0,-92.0,-89.0,-92.0,22.0,19.0,23.0,21.0,1
1845,CC:2F:71:3E:C5:1F,3241497,409364812,11553,1413352,3229944,407951460,6,49256,4125860,40695,3111508,8561,1014352,12182,36,16554,190,6,856,144444.0,39000.0,-69.0,-73.0,-69.0,-60.0,-68.0,-71.0,-70.0,-60.0,-90.0,-92.0,-89.0,-92.0,21.0,19.0,20.0,32.0,1
1846,CC:2F:71:3F:1F:24,11972485,13818373644,8742541,13410422184,3229944,407951460,158,1984026,1166361959,1975329,1165317267,8697,1044692,1919421,675,8747361,930607,158,6666,130000.0,43333.0,-67.0,-65.0,-73.0,-68.0,-67.0,-65.0,-73.0,-67.0,-90.0,-92.0,-89.0,-92.0,23.0,27.0,16.0,24.0,1
1847,92:69:1D:31:68:E9,3258406,468277590,28458,60325726,3229948,407951864,0,12887,4043157,12763,4022752,124,20405,8275,1,28504,2065,0,144,216660.0,130000.0,-52.0,-52.0,-46.0,-51.0,-50.0,-50.0,-45.0,-50.0,-90.0,-92.0,-89.0,-92.0,38.0,40.0,43.0,41.0,1
1848,BA:8C:B9:54:50:24,3273529,506961859,43581,99009995,3229948,407951864,64,15070,4554943,14935,4532634,135,22309,9360,6,43559,10878,64,230,229410.0,137640.0,-53.0,-51.0,-38.0,-46.0,-50.0,-50.0,-44.0,-46.0,-90.0,-92.0,-89.0,-92.0,37.0,41.0,51.0,46.0,1
1849,62:47:05:9D:EB:15,3245222,444318170,15273,36366195,3229949,407951975,64,6856,1400219,6786,1388348,70,11871,3177,1,15256,2448,64,178,229410.0,137640.0,-43.0,-50.0,-43.0,-45.0,-45.0,-52.0,-46.0,-45.0,-90.0,-92.0,-89.0,-92.0,47.0,42.0,46.0,47.0,1
1850,F8:59:71:5A:E0:3D,3495741,808825290,265792,400873315,3229949,407951975,3,265137,359204653,260217,358616907,4920,587746,241383,20,268545,6931,3,840,144444.0,43333.0,-67.0,-73.0,-66.0,-71.0,-67.0,-73.0,-66.0,-71.0,-90.0,-92.0,-89.0,-92.0,23.0,19.0,23.0,21.0,1
1851,CC:2F:71:3E:C5:1F,3241503,409365438,11553,1413352,3229950,407952086,6,49256,4125860,40695,3111508,8561,1014352,12182,36,16554,190,6,856,144444.0,39000.0,-69.0,-73.0,-69.0,-60.0,-68.0,-71.0,-70.0,-60.0,-90.0,-92.0,-89.0,-92.0,21.0,19.0,20.0,32.0,1
1852,CC:2F:71:3F:1F:24,11974095,13820829345,8744145,13412877259,3229950,407952086,158,1984481,1166649576,1975784,1165604884,8697,1044692,1919868,675,8748968,930629,158,6666,130000.0,43333.0,-68.0,-65.0,-73.0,-67.0,-68.0,-64.0,-72.0,-67.0,-90.0,-92.0,-89.0,-92.0,22.0,27.0,16.0,25.0,1
1853,92:69:1D:31:68:E9,3258568,468689619,28614,60737129,3229954,407952490,0,12916,4049575,12791,4028999,125,20576,8299,1,28654,2066,0,144,229410.0,130000.0,-50.0,-50.0,-46.0,-49.0,-49.0,-50.0,-46.0,-49.0,-90.0,-92.0,-90.0,-92.0,40.0,42.0,44.0,43.0,1
1854,BA:8C:B9:54:50:24,3273535,506962485,43581,99009995,3229954,407952490,64,15073,4555250,14937,4532770,136,22480,9361,6,43559,10878,64,230,229410.0,137640.0,-53.0,-51.0,-38.0,-46.0,-50.0,-51.0,-43.0,-46.0,-90.0,-92.0,-90.0,-92.0,37.0,41.0,52.0,46.0,1
1855,62:47:05:9D:EB:15,3245228,444318839,15274,36366349,3229954,407952490,64,6882,1402045,6812,1390174,70,11871,3178,1,15257,2448,64,178,229410.0,137640.0,-43.0,-50.0,-44.0,-45.0,-43.0,-49.0,-45.0,-42.0,-90.0,-92.0,-90.0,-92.0,47.0,42.0,46.0,47.0,1
1856,F8:59:71:5A:E0:3D,3495835,808964111,265881,401011621,3229954,407952490,3,265227,359343337,260307,358755591,4920,587746,241472,20,268634,6932,3,840,144444.0,43333.0,-67.0,-73.0,-67.0,-72.0,-67.0,-73.0,-66.0,-71.0,-90.0,-92.0,-90.0,-92.0,23.0,19.0,23.0,20.0,1
1857,CC:2F:71:3E:C5:1F,3241510,409366270,11553,1413352,3229957,407952918,6,49256,4125860,40695,3111508,8561,1014352,12182,36,16554,190,6,856,144444.0,39000.0,-69.0,-73.0,-69.0,-60.0,-68.0,-71.0,-70.0,-60.0,-90.0,-92.0,-90.0,-92.0,21.0,19.0,21.0,32.0,1
1858,CC:2F:71:3F:1F:24,11975703,13823281665,8745744,13415328545,3229959,407953120,158,1984884,1166976394,1976187,1165931702,8697,1044692,1920258,675,8750552,930740,158,6666,130000.0,43333.0,-73.0,-68.0,-77.0,-71.0,-70.0,-66.0,-74.0,-69.0,-90.0,-92.0,-90.0,-92.0,17.0,24.0,13.0,21.0,1
1859,92:69:1D:31:68:E9,3258582,468696859,28617,60743133,3229965,407953726,0,12920,4050046,12795,4029470,125,20576,8302,1,28663,2066,0,144,229410.0,130000.0,-52.0,-51.0,-45.0,-51.0,-50.0,-50.0,-45.0,-49.0,-90.0,-92.0,-90.0,-92.0,38.0,41.0,45.0,41.0,1
1860,BA:8C:B9:54:50:24,3273546,506963721,43581,99009995,3229965,407953726,64,15073,4555250,14937,4532770,136,22480,9361,6,43559,10878,64,230,229410.0,137640.0,-53.0,-51.0,-38.0,-46.0,-50.0,-51.0,-43.0,-46.0,-90.0,-92.0,-90.0,-92.0,37.0,41.0,52.0,46.0,1
1861,62:47:05:9D:EB:15,3245240,444320135,15274,36366349,3229966,407953786,64,6882,1402045,6812,1390174,70,11871,3178,1,15257,2448,64,178,229410.0,137640.0,-43.0,-50.0,-44.0,-45.0,-43.0,-49.0,-45.0,-42.0,-90.0,-92.0,-90.0,-92.0,47.0,42.0,46.0,47.0,1
1862,F8:59:71:5A:E0:3D,3495947,809119369,265981,401165583,3229966,407953786,3,265328,359497541,260408,358909795,4920,587746,241572,20,268734,6933,3,840,144444.0,43333.0,-68.0,-74.0,-67.0,-72.0,-67.0,-73.0,-67.0,-71.0,-90.0,-92.0,-90.0,-92.0,22.0,18.0,23.0,20.0,1
1863,CC:2F:71:3E:C5:1F,3241519,409367138,11553,1413352,3229966,407953786,6,49256,4125860,40695,3111508,8561,1014352,12182,36,16554,190,6,856,144444.0,39000.0,-69.0,-73.0,-69.0,-60.0,-68.0,-71.0,-70.0,-60.0,-90.0,-92.0,-90.0,-92.0,21.0,19.0,21.0,32.0,1
1864,CC:2F:71:3F:1F:24,11977157,13825490542,8747191,13417536756,3229966,407953786,158,1985302,1167316488,1976604,1166271682,8698,1044806,1920668,675,8752024,930813,158,6667,130000.0,43333.0,-69.0,-66.0,-74.0,-69.0,-69.0,-65.0,-74.0,-68.0,-90.0,-92.0,-90.0,-92.0,21.0,26.0,16.0,23.0,1
1865,92:69:1D:31:68:E9,3258588,468697407,28617,60743133,3229971,407954274,0,12920,4050046,12795,4029470,125,20576,8302,1,28663,2066,0,144,229410.0,130000.0,-52.0,-51.0,-45.0,-51.0,-50.0,-50.0,-45.0,-49.0,-90.0,-92.0,-90.0,-92.0,38.0,41.0,45.0,41.0,1
1866,BA:8C:B9:54:50:24,3273552,506964269,43581,99009995,3229971,407954274,64,15073,4555250,14937,4532770,136,22480,9361,6,43559,10878,64,230,229410.0,137640.0,-53.0,-51.0,-38.0,-46.0,-50.0,-51.0,-43.0,-46.0,-90.0,-92.0,-90.0,-92.0,37.0,41.0,52.0,46.0,1
1867,62:47:05:9D:EB:15,3245250,444321603,15277,36367127,3229973,407954476,64,6890,1403042,6820,1391171,70,11871,3182,1,15260,2448,64,178,229410.0,137640.0,-43.0,-50.0,-43.0,-45.0,-43.0,-50.0,-44.0,-43.0,-90.0,-92.0,-90.0,-92.0,47.0,42.0,47.0,47.0,1
1868,F8:59:71:5A:E0:3D,3496040,809252209,266066,401297673,3229974,407954536,3,265413,359628455,260493,359040709,4920,587746,241656,20,268819,6934,3,840,144444.0,43333.0,-68.0,-74.0,-67.0,-72.0,-67.0,-73.0,-66.0,-71.0,-90.0,-92.0,-90.0,-92.0,22.0,18.0,23.0,20.0,1
1869,CC:2F:71:3E:C5:1F,3241527,409367888,11553,1413352,3229974,407954536,6,49256,4125860,40695,3111508,8561,1014352,12182,36,16554,190,6,856,144444.0,39000.0,-69.0,-73.0,-69.0,-60.0,-68.0,-71.0,-70.0,-60.0,-90.0,-92.0,-90.0,-92.0,21.0,19.0,21.0,32.0,1
1870,CC:2F:71:3F:1F:24,11979081,13828416585,8749107,13420462049,3229974,407954536,158,1985781,1167611022,1977080,1166565762,8701,1045260,1921139,675,8753940,930892,158,6667,130000.0,43333.0,-72.0,-69.0,-77.0,-71.0,-71.0,-67.0,-76.0,-70.0,-90.0,-92.0,-90.0,-92.0,18.0,23.0,13.0,21.0,1
1871,92:69:1D:31:68:E9,3258595,468698073,28617,60743133,3229978,407954940,0,12920,4050046,12795,4029470,125,20576,8302,1,28663,2066,0,144,229410.0,130000.0,-52.0,-51.0,-45.0,-51.0,-50.0,-50.0,-45.0,-49.0,-90.0,-92.0,-90.0,-92.0,38.0,41.0,45.0,41.0,1
1872,BA:8C:B9:54:50:24,3273559,506964935,43581,99009995,3229978,407954940,64,15073,4555250,14937,4532770,136,22480,9361,6,43559,10878,64,230,229410.0,137640.0,-53.0,-51.0,-38.0,-46.0,-50.0,-51.0,-43.0,-46.0,-90.0,-92.0,-90.0,-92.0,37.0,41.0,52.0,46.0,1
1873,62:47:05:9D:EB:15,3245255,444322067,15277,36367127,3229978,407954940,64,6890,1403042,6820,1391171,70,11871,3182,1,15260,2448,64,178,229410.0,137640.0,-43.0,-50.0,-43.0,-45.0,-43.0,-50.0,-44.0,-43.0,-90.0,-92.0,-90.0,-92.0,47.0,42.0,47.0,47.0,1
1874,F8:59:71:5A:E0:3D,3496124,809376933,266146,401421993,3229978,407954940,3,265493,359751655,260573,359163909,4920,587746,241736,20,268899,6935,3,840,144444.0,43333.0,-67.0,-73.0,-66.0,-71.0,-67.0,-73.0,-66.0,-71.0,-90.0,-92.0,-90.0,-92.0,23.0,19.0,24.0,21.0,1
1875,CC:2F:71:3E:C5:1F,3241531,409368292,11553,1413352,3229978,407954940,6,49256,4125860,40695,3111508,8561,1014352,12182,36,16554,190,6,856,144444.0,39000.0,-69.0,-73.0,-69.0,-60.0,-68.0,-71.0,-70.0,-60.0,-90.0,-92.0,-90.0,-92.0,21.0,19.0,21.0,32.0,1
1876,CC:2F:71:3F:1F:24,11981421,13832034509,8751443,13424079569,3229978,407954940,158,1986258,1167896286,1977557,1166851026,8701,1045260,1921616,675,8756276,931024,158,6667,130000.0,43333.0,-69.0,-66.0,-74.0,-68.0,-68.0,-65.0,-74.0,-68.0,-90.0,-92.0,-90.0,-92.0,21.0,26.0,16.0,24.0,1
1877,92:69:1D:31:68:E9,3258614,468702859,28631,60747404,3229983,407955455,0,12944,4053753,12819,4033177,125,20576,8316,1,28677,2066,0,145,229410.0,137640.0,-55.0,-50.0,-44.0,-50.0,-50.0,-50.0,-45.0,-49.0,-90.0,-92.0,-90.0,-92.0,35.0,42.0,46.0,42.0,1
1878,BA:8C:B9:54:50:24,3273564,506965450,43581,99009995,3229983,407955455,64,15073,4555250,14937,4532770,136,22480,9361,6,43559,10878,64,230,229410.0,137640.0,-53.0,-51.0,-38.0,-46.0,-50.0,-51.0,-43.0,-46.0,-90.0,-92.0,-90.0,-92.0,37.0,41.0,52.0,46.0,1
1879,62:47:05:9D:EB:15,3245260,444322582,15277,36367127,3229983,407955455,64,6893,1403349,6822,1391307,71,12042,3183,1,15260,2448,64,178,229410.0,137640.0,-43.0,-50.0,-43.0,-44.0,-44.0,-51.0,-44.0,-45.0,-90.0,-92.0,-90.0,-92.0,47.0,42.0,47.0,48.0,1
1880,F8:59:71:5A:E0:3D,3496210,809503322,266227,401547867,3229983,407955455,3,265574,359876395,260654,359288649,4920,587746,241817,20,268980,6937,3,840,144444.0,43333.0,-67.0,-73.0,-66.0,-71.0,-67.0,-73.0,-66.0,-71.0,-90.0,-92.0,-90.0,-92.0,23.0,19.0,24.0,21.0,1
1881,CC:2F:71:3E:C5:1F,3241540,409369211,11553,1413352,3229987,407955859,6,49256,4125860,40695,3111508,8561,1014352,12182,36,16554,190,6,856,144444.0,39000.0,-69.0,-73.0,-69.0,-60.0,-68.0,-71.0,-70.0,-60.0,-90.0,-92.0,-90.0,-92.0,21.0,19.0,21.0,32.0,1
1882,CC:2F:71:3F:1F:24,11983382,13835046972,8753395,13427091113,3229987,407955859,158,1986708,1168178658,1978007,1167133398,8701,1045260,1922066,675,8758187,931048,158,6667,130000.0,43333.0,-69.0,-66.0,-74.0,-68.0,-68.0,-66.0,-74.0,-68.0,-90.0,-92.0,-90.0,-92.0,21.0,26.0,16.0,24.0,1
1883,92:69:1D:31:68:E9,3258619,468703323,28631,60747404,3229988,407955919,0,12944,4053753,12819,4033177,125,20576,8316,1,28677,2066,0,145,229410.0,137640.0,-55.0,-50.0,-44.0,-50.0,-50.0,-50.0,-45.0,-49.0,-90.0,-92.0,-90.0,-92.0,35.0,42.0,46.0,42.0,1
1884,BA:8C:B9:54:50:24,3273569,506965914,43581,99009995,3229988,407955919,64,15073,4555250,14937,4532770,136,22480,9361,6,43559,10878,64,230,229410.0,137640.0,-53.0,-51.0,-38.0,-46.0,-50.0,-51.0,-43.0,-46.0,-90.0,-92.0,-90.0,-92.0,37.0,41.0,52.0,46.0,1
1885,62:47:05:9D:EB:15,3245267,444323248,15277,36367127,3229990,407956121,64,6893,1403349,6822,1391307,71,12042,3183,1,15260,2448,64,178,229410.0,137640.0,-43.0,-50.0,-43.0,-44.0,-44.0,-51.0,-44.0,-45.0,-90.0,-92.0,-90.0,-92.0,47.0,42.0,47.0,48.0,1
1886,F8:59:71:5A:E0:3D,3496311,809650064,266321,401693943,3229990,407956121,3,265669,360022709,260749,359434963,4920,587746,241911,20,269074,6938,3,840,144444.0,43333.0,-67.0,-73.0,-66.0,-71.0,-67.0,-73.0,-66.0,-71.0,-90.0,-92.0,-90.0,-92.0,23.0,19.0,24.0,21.0,1
1887,CC:2F:71:3E:C5:1F,3241543,409369473,11553,1413352,3229990,407956121,6,49256,4125860,40695,3111508,8561,1014352,12182,36,16554,190,6,856,144444.0,39000.0,-69.0,-73.0,-69.0,-60.0,-68.0,-71.0,-70.0,-60.0,-90.0,-92.0,-90.0,-92.0,21.0,19.0,21.0,32.0,1
1888,CC:2F:71:3F:1F:24,11985469,13838251825,8755477,13430295502,3229992,407956323,158,1987186,1168513667,1978485,1167468407,8701,1045260,1922544,675,8760310,931191,158,6668,130000.0,43333.0,-69.0,-66.0,-75.0,-68.0,-68.0,-65.0,-74.0,-68.0,-90.0,-92.0,-90.0,-92.0,21.0,26.0,15.0,24.0,1
1889,92:69:1D:31:68:E9,3258628,468704247,28632,60747520,3229996,407956727,0,12949,4054131,12824,4033555,125,20576,8317,1,28678,2066,0,145,229410.0,137640.0,-52.0,-51.0,-45.0,-51.0,-51.0,-51.0,-45.0,-50.0,-90.0,-93.0,-90.0,-92.0,38.0,42.0,45.0,41.0,1
1890,BA:8C:B9:54:50:24,3273577,506966722,43581,99009995,3229996,407956727,64,15073,4555250,14937,4532770,136,22480,9361,6,43559,10878,64,230,229410.0,137640.0,-53.0,-51.0,-38.0,-46.0,-50.0,-51.0,-43.0,-46.0,-90.0,-93.0,-90.0,-92.0,37.0,42.0,52.0,46.0,1
1891,62:47:05:9D:EB:15,3245273,444323854,15277,36367127,3229996,407956727,64,6893,1403349,6822,1391307,71,12042,3183,1,15260,2448,64,178,229410.0,137640.0,-43.0,-50.0,-43.0,-44.0,-44.0,-51.0,-44.0,-45.0,-90.0,-93.0,-90.0,-92.0,47.0,43.0,47.0,48.0,1
1892,F8:59:71:5A:E0:3D,3496414,809801240,266418,401844513,3229996,407956727,3,265765,360170549,260845,359582803,4920,587746,242007,20,269171,6938,3,840,144444.0,43333.0,-67.0,-73.0,-66.0,-71.0,-67.0,-73.0,-66.0,-71.0,-90.0,-93.0,-90.0,-92.0,23.0,20.0,24.0,21.0,1
1893,CC:2F:71:3E:C5:1F,3241549,409370079,11553,1413352,3229996,407956727,6,49256,4125860,40695,3111508,8561,1014352,12182,36,16554,190,6,856,144444.0,39000.0,-69.0,-73.0,-69.0,-60.0,-68.0,-71.0,-70.0,-60.0,-90.0,-93.0,-90.0,-92.0,21.0,20.0,21.0,32.0,1
1894,CC:2F:71:3F:1F:24,11987498,13841375137,8757501,13433418350,3229997,407956787,158,1987650,1168862507,1978949,1167817247,8701,1045260,1922985,675,8762299,931291,158,6668,130000.0,43333.0,-68.0,-65.0,-74.0,-68.0,-67.0,-65.0,-73.0,-67.0,-90.0,-93.0,-90.0,-92.0,22.0,28.0,16.0,24.0,1
1895,92:69:1D:31:68:E9,3258633,468704711,28632,60747520,3230001,407957191,0,12949,4054131,12824,4033555,125,20576,8317,1,28678,2066,0,145,229410.0,137640.0,-52.0,-51.0,-45.0,-51.0,-51.0,-51.0,-45.0,-50.0,-90.0,-93.0,-90.0,-92.0,38.0,42.0,45.0,41.0,1
1896,BA:8C:B9:54:50:24,3273583,506967361,43581,99009995,3230002,407957366,64,15077,4555689,14940,4532974,137,22715,9362,6,43559,10878,64,230,229410.0,137640.0,-51.0,-51.0,-44.0,-49.0,-51.0,-51.0,-41.0,-46.0,-90.0,-93.0,-90.0,-92.0,39.0,42.0,46.0,43.0,1
1897,62:47:05:9D:EB:15,3245279,444324493,15277,36367127,3230002,407957366,64,6893,1403349,6822,1391307,71,12042,3183,1,15260,2448,64,178,229410.0,137640.0,-43.0,-50.0,-43.0,-44.0,-44.0,-51.0,-44.0,-45.0,-90.0,-93.0,-90.0,-92.0,47.0,43.0,47.0,48.0,1
1898,F8:59:71:5A:E0:3D,3496501,809927753,266499,401970387,3230002,407957366,3,265849,360299951,260929,359712205,4920,587746,242090,20,269252,6940,3,840,144444.0,43333.0,-68.0,-74.0,-67.0,-72.0,-67.0,-73.0,-66.0,-71.0,-90.0,-93.0,-90.0,-92.0,22.0,19.0,23.0,20.0,1
1899,CC:2F:71:3E:C5:1F,3241557,409370920,11553,1413352,3230004,407957568,6,49256,4125860,40695,3111508,8561,1014352,12182,36,16554,190,6,856,144444.0,39000.0,-69.0,-73.0,-69.0,-60.0,-68.0,-71.0,-70.0,-60.0,-90.0,-93.0,-90.0,-92.0,21.0,20.0,21.0,32.0,1
1900,CC:2F:71:3F:1F:24,11989400,13844293378,8759394,13436335608,3230006,407957770,158,1988079,1169153115,1979378,1168107855,8701,1045260,1923390,675,8764197,931385,158,6668,130000.0,43333.0,-67.0,-65.0,-73.0,-68.0,-67.0,-65.0,-73.0,-67.0,-90.0,-93.0,-90.0,-92.0,23.0,28.0,17.0,24.0,1
1901,92:69:1D:31:68:E9,3258639,468705563,28632,60747520,3230007,407958043,0,12949,4054131,12824,4033555,125,20576,8317,1,28678,2066,0,145,229410.0,137640.0,-52.0,-51.0,-45.0,-51.0,-51.0,-51.0,-45.0,-50.0,-90.0,-93.0,-90.0,-92.0,38.0,42.0,45.0,41.0,1
1902,BA:8C:B9:54:50:24,3273591,506968740,43584,99010697,3230007,407958043,64,15091,4560015,14954,4537300,137,22715,9366,6,43562,10881,64,230,195000.0,97500.0,-46.0,-50.0,-54.0,-46.0,-48.0,-49.0,-42.0,-47.0,-90.0,-93.0,-90.0,-92.0,44.0,43.0,36.0,46.0,1
1903,62:47:05:9D:EB:15,3245284,444325170,15277,36367127,3230007,407958043,64,6893,1403349,6822,1391307,71,12042,3183,1,15260,2448,64,178,229410.0,137640.0,-43.0,-50.0,-43.0,-44.0,-44.0,-51.0,-44.0,-45.0,-90.0,-93.0,-90.0,-92.0,47.0,43.0,47.0,48.0,1
1904,F8:59:71:5A:E0:3D,3496594,810055746,266585,402097501,3230009,407958245,3,265937,360427070,261017,359839324,4920,587746,242177,20,269338,6940,3,840,144444.0,43333.0,-68.0,-74.0,-67.0,-71.0,-67.0,-73.0,-66.0,-71.0,-90.0,-93.0,-90.0,-92.0,22.0,19.0,23.0,21.0,1
1905,CC:2F:71:3E:C5:1F,3241562,409371597,11553,1413352,3230009,407958245,6,49256,4125860,40695,3111508,8561,1014352,12182,36,16554,190,6,856,144444.0,39000.0,-69.0,-73.0,-69.0,-60.0,-68.0,-71.0,-70.0,-60.0,-90.0,-93.0,-90.0,-92.0,21.0,20.0,21.0,32.0,1
1906,CC:2F:71:3F:1F:24,11991021,13846754462,8761012,13438796217,3230009,407958245,158,1988479,1169437051,1979778,1168391791,8701,1045260,1923777,675,8765845,931406,158,6668,130000.0,43333.0,-68.0,-65.0,-74.0,-68.0,-67.0,-65.0,-73.0,-67.0,-90.0,-93.0,-90.0,-92.0,22.0,28.0,16.0,24.0,1
1907,92:69:1D:31:68:E9,3258646,468706229,28632,60747520,3230014,407958709,0,12949,4054131,12824,4033555,125,20576,8317,1,28678,2066,0,145,229410.0,137640.0,-52.0,-51.0,-45.0,-51.0,-51.0,-51.0,-45.0,-50.0,-89.0,-92.0,-89.0,-92.0,37.0,41.0,44.0,41.0,1
1908,BA:8C:B9:54:50:24,3273598,506969406,43584,99010697,3230014,407958709,64,15091,4560015,14954,4537300,137,22715,9366,6,43562,10881,64,230,195000.0,97500.0,-46.0,-50.0,-54.0,-46.0,-48.0,-49.0,-42.0,-47.0,-89.0,-92.0,-89.0,-92.0,43.0,42.0,35.0,46.0,1
1909,62:47:05:9D:EB:15,3245293,444326038,15277,36367127,3230016,407958911,64,6893,1403349,6822,1391307,71,12042,3183,1,15260,2448,64,178,229410.0,137640.0,-43.0,-50.0,-43.0,-44.0,-44.0,-51.0,-44.0,-45.0,-89.0,-92.0,-89.0,-92.0,46.0,42.0,46.0,48.0,1
1910,F8:59:71:5A:E0:3D,3496687,810190056,266671,402231145,3230016,407958911,3,266019,360553378,261099,359965632,4920,587746,242257,20,269424,6941,3,840,144444.0,43333.0,-68.0,-74.0,-67.0,-72.0,-67.0,-73.0,-66.0,-71.0,-89.0,-92.0,-89.0,-92.0,21.0,18.0,22.0,20.0,1
1911,CC:2F:71:3E:C5:1F,3241569,409372263,11553,1413352,3230016,407958911,6,49256,4125860,40695,3111508,8561,1014352,12182,36,16554,190,6,856,144444.0,39000.0,-69.0,-73.0,-69.0,-60.0,-68.0,-71.0,-70.0,-60.0,-89.0,-92.0,-89.0,-92.0,20.0,19.0,20.0,32.0,1
1912,CC:2F:71:3F:1F:24,11992251,13848617406,8762235,13440658495,3230016,407958911,158,1988825,1169741949,1980124,1168696689,8701,1045260,1924103,675,8767042,931560,158,6668,130000.0,43333.0,-68.0,-65.0,-73.0,-68.0,-67.0,-65.0,-73.0,-67.0,-89.0,-92.0,-89.0,-92.0,21.0,27.0,16.0,24.0,1
1913,92:69:1D:31:68:E9,3258652,468706865,28634,60747752,3230018,407959113,0,12955,4054577,12830,4034001,125,20576,8318,1,28680,2066,0,146,229410.0,137640.0,-53.0,-51.0,-45.0,-51.0,-52.0,-51.0,-45.0,-50.0,-89.0,-92.0,-89.0,-91.0,36.0,41.0,44.0,40.0,1
1914,BA:8C:B9:54:50:24,3273603,506969870,43585,99010757,3230018,407959113,64,15093,4560151,14956,4537436,137,22715,9366,6,43563,10881,64,230,195000.0,97500.0,-46.0,-50.0,-54.0,-46.0,-48.0,-50.0,-44.0,-47.0,-89.0,-92.0,-89.0,-91.0,43.0,42.0,35.0,45.0,1
1915,62:47:05:9D:EB:15,3245295,444326240,15277,36367127,3230018,407959113,64,6893,1403349,6822,1391307,71,12042,3183,1,15260,2448,64,178,229410.0,137640.0,-43.0,-50.0,-43.0,-44.0,-44.0,-51.0,-44.0,-45.0,-89.0,-92.0,-89.0,-91.0,46.0,42.0,46.0,47.0,1
1916,F8:59:71:5A:E0:3D,3496775,810318120,266755,402358805,3230020,407959315,3,266107,360687464,261187,360099718,4920,587746,242345,20,269508,6942,3,840,144444.0,43333.0,-68.0,-74.0,-67.0,-72.0,-67.0,-73.0,-67.0,-71.0,-89.0,-92.0,-89.0,-91.0,21.0,18.0,22.0,19.0,1
1917,CC:2F:71:3E:C5:1F,3241574,409372783,11554,1413468,3230020,407959315,6,49258,4126000,40697,3111648,8561,1014352,12182,36,16555,190,6,856,144444.0,39000.0,-68.0,-72.0,-69.0,-60.0,-68.0,-71.0,-69.0,-60.0,-89.0,-92.0,-89.0,-91.0,21.0,20.0,20.0,31.0,1
1918,CC:2F:71:3F:1F:24,11993752,13850908456,8763732,13442949141,3230020,407959315,158,1989220,1170042439,1980519,1168997179,8701,1045260,1924486,675,8768541,931568,158,6669,130000.0,43333.0,-67.0,-65.0,-73.0,-68.0,-67.0,-65.0,-73.0,-67.0,-89.0,-92.0,-89.0,-91.0,22.0,27.0,16.0,23.0,1
1919,92:69:1D:31:68:E9,3258660,468707657,28634,60747752,3230026,407959905,0,12955,4054577,12830,4034001,125,20576,8318,1,28680,2066,0,146,229410.0,137640.0,-53.0,-51.0,-45.0,-51.0,-52.0,-51.0,-45.0,-50.0,-88.0,-92.0,-89.0,-91.0,35.0,41.0,44.0,40.0,1
1920,BA:8C:B9:54:50:24,3273611,506970662,43585,99010757,3230026,407959905,64,15093,4560151,14956,4537436,137,22715,9366,6,43563,10881,64,230,195000.0,97500.0,-46.0,-50.0,-54.0,-46.0,-48.0,-50.0,-44.0,-47.0,-88.0,-92.0,-89.0,-91.0,42.0,42.0,35.0,45.0,1
1921,62:47:05:9D:EB:15,3245494,444829657,15468,36869752,3230026,407959905,64,6956,1412273,6885,1400231,71,12042,3203,1,15451,2450,64,180,216660.0,130000.0,-43.0,-51.0,-44.0,-45.0,-46.0,-52.0,-47.0,-45.0,-88.0,-92.0,-89.0,-91.0,45.0,41.0,45.0,46.0,1
1922,F8:59:71:5A:E0:3D,3496871,810458570,266845,402498665,3230026,407959905,3,266197,360826204,261277,360238458,4920,587746,242435,20,269598,6947,3,840,144444.0,43333.0,-68.0,-74.0,-67.0,-72.0,-67.0,-73.0,-67.0,-71.0,-88.0,-92.0,-89.0,-91.0,20.0,18.0,22.0,19.0,1
1923,CC:2F:71:3E:C5:1F,3241580,409373373,11554,1413468,3230026,407959905,6,49258,4126000,40697,3111648,8561,1014352,12182,36,16555,190,6,856,144444.0,39000.0,-68.0,-72.0,-69.0,-60.0,-68.0,-71.0,-69.0,-60.0,-88.0,-92.0,-89.0,-91.0,20.0,20.0,20.0,31.0,1
1924,CC:2F:71:3F:1F:24,11995037,13852846171,8765009,13444886064,3230028,407960107,158,1989576,1170343724,1980875,1169298464,8701,1045260,1924836,675,8769842,931709,158,6670,130000.0,43333.0,-67.0,-65.0,-73.0,-67.0,-67.0,-65.0,-73.0,-67.0,-88.0,-92.0,-89.0,-91.0,21.0,27.0,16.0,24.0,1
1925,92:69:1D:31:68:E9,3258666,468708185,28634,60747752,3230032,407960433,0,12955,4054577,12830,4034001,125,20576,8318,1,28680,2066,0,146,229410.0,137640.0,-53.0,-51.0,-45.0,-51.0,-52.0,-51.0,-45.0,-50.0,-88.0,-92.0,-89.0,-91.0,35.0,41.0,44.0,40.0,1
1926,BA:8C:B9:54:50:24,3273617,506971190,43585,99010757,3230032,407960433,64,15093,4560151,14956,4537436,137,22715,9366,6,43563,10881,64,230,195000.0,97500.0,-46.0,-50.0,-54.0,-46.0,-48.0,-50.0,-44.0,-47.0,-88.0,-92.0,-89.0,-91.0,42.0,42.0,35.0,45.0,1
1927,62:47:05:9D:EB:15,3245501,444830339,15469,36869906,3230032,407960433,64,6974,1413609,6902,1401445,72,12164,3205,1,15452,2450,64,181,229410.0,130000.0,-47.0,-53.0,-48.0,-46.0,-46.0,-53.0,-47.0,-46.0,-88.0,-92.0,-89.0,-91.0,41.0,39.0,41.0,45.0,1
1928,F8:59:71:5A:E0:3D,3496963,810592742,266931,402632309,3230032,407960433,3,266284,360960198,261364,360372452,4920,587746,242521,20,269684,6948,3,840,144444.0,43333.0,-68.0,-74.0,-67.0,-72.0,-67.0,-73.0,-66.0,-71.0,-88.0,-92.0,-89.0,-91.0,20.0,18.0,22.0,19.0,1
1929,CC:2F:71:3E:C5:1F,3241590,409374305,11554,1413468,3230036,407960837,6,49258,4126000,40697,3111648,8561,1014352,12182,36,16555,190,6,856,144444.0,39000.0,-68.0,-72.0,-69.0,-60.0,-68.0,-71.0,-69.0,-60.0,-88.0,-92.0,-89.0,-91.0,20.0,20.0,20.0,31.0,1
1930,CC:2F:71:3F:1F:24,11995956,13854203988,8765920,13446243151,3230036,407960837,158,1989914,1170624814,1981212,1169579436,8702,1045378,1925164,675,8770752,931721,158,6670,130000.0,43333.0,-68.0,-66.0,-74.0,-68.0,-67.0,-66.0,-73.0,-68.0,-88.0,-92.0,-89.0,-91.0,20.0,26.0,15.0,23.0,1
1931,92:69:1D:31:68:E9,3258673,468708851,28634,60747752,3230039,407961099,0,12955,4054577,12830,4034001,125,20576,8318,1,28680,2066,0,146,229410.0,137640.0,-53.0,-51.0,-45.0,-51.0,-52.0,-51.0,-45.0,-50.0,-88.0,-92.0,-89.0,-91.0,35.0,41.0,44.0,40.0,1
1932,BA:8C:B9:54:50:24,3273624,506971856,43585,99010757,3230039,407961099,64,15093,4560151,14956,4537436,137,22715,9366,6,43563,10881,64,230,195000.0,97500.0,-46.0,-50.0,-54.0,-46.0,-48.0,-50.0,-44.0,-47.0,-88.0,-92.0,-89.0,-91.0,42.0,42.0,35.0,45.0,1
1933,62:47:05:9D:EB:15,3245508,444831005,15469,36869906,3230039,407961099,64,6985,1414357,6913,1402193,72,12164,3205,1,15452,2450,64,181,229410.0,130000.0,-43.0,-51.0,-44.0,-45.0,-46.0,-52.0,-47.0,-45.0,-87.0,-92.0,-88.0,-91.0,44.0,41.0,44.0,46.0,1
1934,F8:59:71:5A:E0:3D,3497056,810725614,267017,402764515,3230039,407961099,3,266370,361091204,261450,360503458,4920,587746,242607,20,269770,6949,3,840,144444.0,43333.0,-67.0,-73.0,-67.0,-72.0,-67.0,-73.0,-67.0,-71.0,-87.0,-92.0,-88.0,-91.0,20.0,19.0,21.0,19.0,1
1935,CC:2F:71:3E:C5:1F,3241593,409374567,11554,1413468,3230039,407961099,6,49258,4126000,40697,3111648,8561,1014352,12182,36,16555,190,6,856,144444.0,39000.0,-68.0,-72.0,-69.0,-60.0,-68.0,-71.0,-69.0,-60.0,-87.0,-92.0,-88.0,-91.0,19.0,20.0,19.0,31.0,1
1936,CC:2F:71:3F:1F:24,11997435,13856405456,8767396,13448444357,3230039,407961099,158,1990388,1170934476,1981686,1169889098,8702,1045378,1925631,675,8772223,931809,158,6671,117000.0,39000.0,-67.0,-65.0,-74.0,-68.0,-67.0,-65.0,-73.0,-67.0,-87.0,-92.0,-88.0,-91.0,20.0,27.0,14.0,23.0,1
1937,92:69:1D:31:68:E9,3258836,469117399,28791,61155694,3230045,407961705,0,12986,4060851,12861,4040275,125,20576,8339,1,28837,2066,0,146,229410.0,137640.0,-52.0,-51.0,-45.0,-50.0,-50.0,-50.0,-45.0,-49.0,-87.0,-92.0,-88.0,-91.0,35.0,41.0,43.0,41.0,1
1938,BA:8C:B9:54:50:24,3273630,506972462,43585,99010757,3230045,407961705,64,15093,4560151,14956,4537436,137,22715,9366,6,43563,10881,64,230,195000.0,97500.0,-46.0,-50.0,-54.0,-46.0,-48.0,-50.0,-44.0,-47.0,-87.0,-92.0,-88.0,-91.0,41.0,42.0,34.0,45.0,1
1939,62:47:05:9D:EB:15,3245514,444831611,15469,36869906,3230045,407961705,64,6985,1414357,6913,1402193,72,12164,3205,1,15452,2450,64,181,229410.0,130000.0,-43.0,-51.0,-44.0,-45.0,-46.0,-52.0,-47.0,-45.0,-87.0,-92.0,-88.0,-91.0,44.0,41.0,44.0,46.0,1
1940,F8:59:71:5A:E0:3D,3497143,810852094,267098,402890389,3230045,407961705,3,266452,361217638,261532,360629892,4920,587746,242689,20,269851,6950,3,840,144444.0,43333.0,-67.0,-73.0,-67.0,-71.0,-67.0,-73.0,-66.0,-70.0,-87.0,-92.0,-88.0,-91.0,20.0,19.0,21.0,20.0,1
1941,CC:2F:71:3E:C5:1F,3241600,409375235,11554,1413468,3230046,407961767,6,49258,4126000,40697,3111648,8561,1014352,12182,36,16555,190,6,856,144444.0,39000.0,-68.0,-72.0,-69.0,-60.0,-68.0,-71.0,-69.0,-60.0,-87.0,-92.0,-88.0,-91.0,19.0,20.0,19.0,31.0,1
1942,CC:2F:71:3F:1F:24,11998790,13858414665,8768744,13450452898,3230046,407961767,158,1990845,1171261078,1982143,1170215700,8702,1045378,1926048,675,8773577,931855,158,6671,130000.0,43333.0,-68.0,-66.0,-74.0,-68.0,-67.0,-65.0,-73.0,-67.0,-87.0,-92.0,-88.0,-91.0,19.0,26.0,14.0,23.0,1
1943,92:69:1D:31:68:E9,3258840,469117723,28791,61155694,3230049,407962029,0,12989,4061109,12863,4040411,126,20698,8340,1,28837,2066,0,146,229410.0,137640.0,-52.0,-51.0,-45.0,-51.0,-50.0,-51.0,-46.0,-50.0,-87.0,-92.0,-88.0,-91.0,35.0,41.0,43.0,40.0,1
1944,BA:8C:B9:54:50:24,3273634,506972786,43585,99010757,3230049,407962029,64,15093,4560151,14956,4537436,137,22715,9366,6,43563,10881,64,230,195000.0,97500.0,-46.0,-50.0,-54.0,-46.0,-48.0,-50.0,-44.0,-47.0,-87.0,-92.0,-88.0,-91.0,41.0,42.0,34.0,45.0,1
1945,62:47:05:9D:EB:15,3245518,444831935,15469,36869906,3230049,407962029,64,6985,1414357,6913,1402193,72,12164,3205,1,15452,2450,64,181,229410.0,130000.0,-43.0,-51.0,-44.0,-45.0,-46.0,-52.0,-47.0,-45.0,-87.0,-92.0,-88.0,-91.0,44.0,41.0,44.0,46.0,1
1946,F8:59:71:5A:E0:3D,3497231,810980048,267180,403017817,3230051,407962231,3,266535,361345486,261615,360757740,4920,587746,242770,20,269933,6950,3,840,144444.0,43333.0,-67.0,-73.0,-66.0,-71.0,-67.0,-73.0,-66.0,-71.0,-87.0,-92.0,-88.0,-91.0,20.0,19.0,22.0,20.0,1
1947,CC:2F:71:3E:C5:1F,3241605,409375699,11554,1413468,3230051,407962231,6,49258,4126000,40697,3111648,8561,1014352,12182,36,16555,190,6,856,144444.0,39000.0,-68.0,-72.0,-69.0,-60.0,-68.0,-71.0,-69.0,-60.0,-87.0,-92.0,-88.0,-91.0,19.0,20.0,19.0,31.0,1
1948,CC:2F:71:3F:1F:24,12000351,13860743174,8770300,13452780943,3230051,407962231,158,1991324,1171566573,1982622,1170521195,8702,1045378,1926512,675,8775102,931941,158,6671,144444.0,39000.0,-67.0,-66.0,-73.0,-68.0,-67.0,-65.0,-73.0,-68.0,-87.0,-92.0,-88.0,-91.0,20.0,26.0,15.0,23.0,1
1949,92:69:1D:31:68:E9,3258846,469118329,28791,61155694,3230055,407962635,0,12989,4061109,12863,4040411,126,20698,8340,1,28837,2066,0,146,229410.0,137640.0,-52.0,-51.0,-45.0,-51.0,-50.0,-51.0,-46.0,-50.0,-87.0,-92.0,-88.0,-91.0,35.0,41.0,43.0,40.0,1
1950,BA:8C:B9:54:50:24,3273640,506973392,43585,99010757,3230055,407962635,64,15093,4560151,14956,4537436,137,22715,9366,6,43563,10881,64,230,195000.0,97500.0,-46.0,-50.0,-54.0,-46.0,-48.0,-50.0,-44.0,-47.0,-87.0,-92.0,-88.0,-91.0,41.0,42.0,34.0,45.0,1
1951,62:47:05:9D:EB:15,3245524,444832541,15469,36869906,3230055,407962635,64,6985,1414357,6913,1402193,72,12164,3205,1,15452,2450,64,181,229410.0,130000.0,-43.0,-51.0,-44.0,-45.0,-46.0,-52.0,-47.0,-45.0,-87.0,-92.0,-88.0,-91.0,44.0,41.0,44.0,46.0,1
1952,F8:59:71:5A:E0:3D,3497327,811120514,267270,403157677,3230057,407962837,3,266625,361484170,261705,360896424,4920,587746,242860,20,270023,6950,3,840,144444.0,43333.0,-67.0,-73.0,-66.0,-71.0,-67.0,-73.0,-66.0,-71.0,-87.0,-92.0,-88.0,-91.0,20.0,19.0,22.0,20.0,1
1953,CC:2F:71:3E:C5:1F,3241611,409376305,11554,1413468,3230057,407962837,6,49258,4126000,40697,3111648,8561,1014352,12182,36,16555,190,6,856,144444.0,39000.0,-68.0,-72.0,-69.0,-60.0,-68.0,-71.0,-69.0,-60.0,-87.0,-92.0,-88.0,-91.0,19.0,20.0,19.0,31.0,1
1954,CC:2F:71:3F:1F:24,12001498,13862418756,8771441,13454455919,3230057,407962837,158,1991741,1171880134,1983039,1170834756,8702,1045378,1926918,675,8776274,932006,158,6671,130000.0,43333.0,-68.0,-66.0,-74.0,-68.0,-67.0,-66.0,-73.0,-68.0,-87.0,-92.0,-88.0,-91.0,19.0,26.0,14.0,23.0,1
1955,92:69:1D:31:68:E9,3258856,469122134,28797,61159095,3230059,407963039,0,12997,4064114,12871,4043416,126,20698,8345,1,28843,2066,0,146,229410.0,137640.0,-52.0,-51.0,-46.0,-51.0,-50.0,-50.0,-45.0,-49.0,-87.0,-92.0,-88.0,-91.0,35.0,41.0,42.0,40.0,1
1956,BA:8C:B9:54:50:24,3273652,506979126,43592,99016027,3230060,407963099,64,15104,4564243,14967,4541528,137,22715,9374,6,43570,10881,64,230,195000.0,97500.0,-50.0,-51.0,-44.0,-49.0,-50.0,-51.0,-45.0,-48.0,-87.0,-92.0,-88.0,-91.0,37.0,41.0,44.0,42.0,1
1957,62:47:05:9D:EB:15,3245531,444833207,15469,36869906,3230062,407963301,64,6985,1414357,6913,1402193,72,12164,3205,1,15452,2450,64,181,229410.0,130000.0,-43.0,-51.0,-44.0,-45.0,-46.0,-52.0,-47.0,-45.0,-87.0,-92.0,-88.0,-91.0,44.0,41.0,44.0,46.0,1
1958,F8:59:71:5A:E0:3D,3497419,811256176,267357,403292875,3230062,407963301,3,266712,361618206,261792,361030460,4920,587746,242947,20,270110,6950,3,840,144444.0,43333.0,-67.0,-72.0,-66.0,-71.0,-67.0,-72.0,-66.0,-70.0,-87.0,-92.0,-88.0,-91.0,20.0,20.0,22.0,20.0,1
1959,CC:2F:71:3E:C5:1F,3241618,409376971,11554,1413468,3230064,407963503,6,49258,4126000,40697,3111648,8561,1014352,12182,36,16555,190,6,856,144444.0,39000.0,-68.0,-72.0,-69.0,-60.0,-68.0,-71.0,-69.0,-60.0,-87.0,-92.0,-88.0,-91.0,19.0,20.0,19.0,31.0,1
1960,CC:2F:71:3F:1F:24,12002669,13864097071,8772605,13456133568,3230064,407963503,158,1992196,1172202768,1983494,1171157390,8702,1045378,1927354,675,8777433,932032,158,6671,130000.0,39000.0,-67.0,-66.0,-73.0,-68.0,-67.0,-66.0,-73.0,-68.0,-86.0,-92.0,-87.0,-91.0,19.0,26.0,14.0,23.0,1
1961,92:69:1D:31:68:E9,3258864,469122862,28797,61159095,3230067,407963767,0,12997,4064114,12871,4043416,126,20698,8345,1,28843,2066,0,146,229410.0,137640.0,-52.0,-51.0,-46.0,-51.0,-50.0,-50.0,-45.0,-49.0,-86.0,-92.0,-87.0,-91.0,34.0,41.0,41.0,40.0,1
1962,BA:8C:B9:54:50:24,3273659,506979794,43592,99016027,3230067,407963767,64,15114,4564977,14976,4542140,138,22837,9375,6,43570,10881,64,230,195000.0,97500.0,-53.0,-51.0,-38.0,-46.0,-51.0,-51.0,-43.0,-48.0,-86.0,-92.0,-87.0,-91.0,33.0,41.0,49.0,45.0,1
1963,62:47:05:9D:EB:15,3245537,444833946,15469,36869906,3230068,407964040,64,6989,1414629,6917,1402465,72,12164,3205,1,15453,2450,64,181,229410.0,130000.0,-52.0,-50.0,-51.0,-41.0,-46.0,-51.0,-46.0,-44.0,-86.0,-92.0,-87.0,-91.0,34.0,42.0,36.0,50.0,1
1964,F8:59:71:5A:E0:3D,3497510,811389005,267442,403424965,3230068,407964040,3,266792,361741406,261872,361153660,4920,587746,243027,20,270194,6956,3,840,144444.0,43333.0,-68.0,-73.0,-67.0,-72.0,-67.0,-73.0,-66.0,-71.0,-86.0,-92.0,-87.0,-91.0,18.0,19.0,20.0,19.0,1
1965,CC:2F:71:3E:C5:1F,3241622,409377508,11554,1413468,3230068,407964040,6,49260,4126140,40699,3111788,8561,1014352,12182,36,16556,190,6,856,144444.0,39000.0,-68.0,-73.0,-68.0,-60.0,-68.0,-73.0,-68.0,-61.0,-86.0,-92.0,-87.0,-91.0,18.0,19.0,19.0,31.0,1
1966,CC:2F:71:3F:1F:24,12003972,13865990238,8773904,13458026198,3230068,407964040,158,1992687,1172520762,1983985,1171475384,8702,1045378,1927821,675,8778728,932065,158,6671,130000.0,43333.0,-68.0,-66.0,-74.0,-68.0,-68.0,-65.0,-73.0,-68.0,-86.0,-92.0,-87.0,-91.0,18.0,26.0,13.0,23.0,1
1967,92:69:1D:31:68:E9,3258901,469194260,28825,61229490,3230076,407964770,0,13006,4065290,12880,4044592,126,20698,8352,1,28871,2066,0,146,229410.0,137640.0,-52.0,-51.0,-45.0,-51.0,-50.0,-50.0,-45.0,-49.0,-86.0,-92.0,-87.0,-91.0,34.0,41.0,42.0,40.0,1
1968,BA:8C:B9:54:50:24,3274032,507942186,43956,99977416,3230076,407964770,64,15160,4573794,15022,4550957,138,22837,9414,6,43934,10913,64,230,216660.0,130000.0,-46.0,-50.0,-53.0,-46.0,-50.0,-51.0,-45.0,-48.0,-86.0,-92.0,-87.0,-91.0,40.0,42.0,34.0,45.0,1
1969,62:47:05:9D:EB:15,3245546,444834736,15469,36869906,3230077,407964830,64,6989,1414629,6917,1402465,72,12164,3205,1,15453,2450,64,181,229410.0,130000.0,-52.0,-50.0,-51.0,-41.0,-46.0,-51.0,-46.0,-44.0,-86.0,-92.0,-87.0,-91.0,34.0,42.0,36.0,50.0,1
1970,F8:59:71:5A:E0:3D,3497601,811517223,267524,403552393,3230077,407964830,3,266880,361875504,261959,361287640,4921,587864,243115,20,270277,6959,3,840,144444.0,43333.0,-68.0,-74.0,-67.0,-72.0,-67.0,-73.0,-66.0,-71.0,-86.0,-92.0,-87.0,-91.0,18.0,18.0,20.0,19.0,1
1971,CC:2F:71:3E:C5:1F,3241631,409378298,11554,1413468,3230077,407964830,6,49262,4126328,40700,3111858,8562,1014470,12183,36,16556,190,6,856,144444.0,39000.0,-67.0,-69.0,-68.0,-60.0,-68.0,-72.0,-68.0,-61.0,-86.0,-92.0,-87.0,-91.0,19.0,23.0,19.0,31.0,1
1972,CC:2F:71:3F:1F:24,12005560,13868316831,8775483,13460352001,3230077,407964830,158,1993173,1172818547,1984471,1171773169,8702,1045378,1928305,675,8780316,932136,158,6671,130000.0,43333.0,-67.0,-65.0,-74.0,-68.0,-67.0,-65.0,-73.0,-68.0,-86.0,-92.0,-87.0,-91.0,19.0,27.0,13.0,23.0,1
1973,92:69:1D:31:68:E9,3258904,469194522,28825,61229490,3230079,407965032,0,13006,4065290,12880,4044592,126,20698,8352,1,28871,2066,0,146,229410.0,137640.0,-52.0,-51.0,-45.0,-51.0,-50.0,-50.0,-45.0,-49.0,-85.0,-92.0,-87.0,-91.0,33.0,41.0,42.0,40.0,1
1974,BA:8C:B9:54:50:24,3274035,507942448,43956,99977416,3230079,407965032,64,15160,4573794,15022,4550957,138,22837,9414,6,43934,10913,64,230,216660.0,130000.0,-46.0,-50.0,-53.0,-46.0,-50.0,-51.0,-45.0,-48.0,-85.0,-92.0,-87.0,-91.0,39.0,42.0,34.0,45.0,1
1975,62:47:05:9D:EB:15,3245550,444835140,15469,36869906,3230081,407965234,64,6989,1414629,6917,1402465,72,12164,3205,1,15453,2450,64,181,229410.0,130000.0,-52.0,-50.0,-51.0,-41.0,-46.0,-51.0,-46.0,-44.0,-85.0,-92.0,-87.0,-91.0,33.0,42.0,36.0,50.0,1
1976,F8:59:71:5A:E0:3D,3497687,811643612,267605,403678267,3230082,407965345,3,266962,362001966,262041,361414102,4921,587864,243197,20,270358,6962,3,840,144444.0,43333.0,-67.0,-73.0,-66.0,-71.0,-67.0,-73.0,-66.0,-71.0,-85.0,-92.0,-87.0,-91.0,18.0,19.0,21.0,20.0,1
1977,CC:2F:71:3E:C5:1F,3241636,409378813,11554,1413468,3230082,407965345,6,49262,4126328,40700,3111858,8562,1014470,12183,36,16556,190,6,856,144444.0,39000.0,-67.0,-69.0,-68.0,-60.0,-68.0,-72.0,-68.0,-61.0,-85.0,-92.0,-87.0,-91.0,18.0,23.0,19.0,31.0,1
1978,CC:2F:71:3F:1F:24,12006987,13870423260,8776905,13462457915,3230082,407965345,158,1993604,1173105582,1984902,1172060204,8702,1045378,1928733,675,8781738,932194,158,6672,130000.0,43333.0,-67.0,-65.0,-74.0,-67.0,-67.0,-64.0,-73.0,-67.0,-85.0,-92.0,-87.0,-91.0,18.0,27.0,13.0,24.0,1
1979,92:69:1D:31:68:E9,3258912,469195350,28825,61229490,3230087,407965860,0,13013,4065869,12886,4045000,127,20869,8353,1,28871,2066,0,146,229410.0,137640.0,-52.0,-50.0,-45.0,-50.0,-50.0,-50.0,-46.0,-50.0,-85.0,-92.0,-87.0,-91.0,33.0,42.0,42.0,41.0,1
1980,BA:8C:B9:54:50:24,3274043,507943276,43956,99977416,3230087,407965860,64,15164,4574169,15025,4551161,139,23008,9415,6,43934,10913,64,230,216660.0,130000.0,-53.0,-51.0,-38.0,-46.0,-50.0,-51.0,-43.0,-48.0,-85.0,-92.0,-87.0,-91.0,32.0,41.0,49.0,45.0,1
1981,62:47:05:9D:EB:15,3245558,444835968,15469,36869906,3230089,407966062,64,6989,1414629,6917,1402465,72,12164,3205,1,15453,2450,64,181,229410.0,130000.0,-52.0,-50.0,-51.0,-41.0,-46.0,-51.0,-46.0,-44.0,-85.0,-92.0,-87.0,-91.0,33.0,42.0,36.0,50.0,1
1982,F8:59:71:5A:E0:3D,3497786,811787297,267697,403821235,3230089,407966062,3,267055,362145256,262134,361557392,4921,587864,243288,20,270450,6964,3,840,144444.0,43333.0,-67.0,-73.0,-66.0,-71.0,-67.0,-72.0,-66.0,-71.0,-85.0,-92.0,-87.0,-91.0,18.0,19.0,21.0,20.0,1
1983,CC:2F:71:3E:C5:1F,3241644,409379590,11554,1413468,3230090,407966122,6,49262,4126328,40700,3111858,8562,1014470,12183,36,16556,190,6,856,144444.0,39000.0,-67.0,-69.0,-68.0,-60.0,-68.0,-72.0,-68.0,-61.0,-85.0,-92.0,-87.0,-91.0,18.0,23.0,19.0,31.0,1
1984,CC:2F:71:3F:1F:24,12008314,13872427384,8778224,13464461262,3230090,407966122,158,1993988,1173439189,1985286,1172393811,8702,1045378,1929087,675,8783057,932256,158,6672,130000.0,43333.0,-67.0,-65.0,-74.0,-67.0,-67.0,-65.0,-73.0,-67.0,-85.0,-92.0,-87.0,-91.0,18.0,27.0,13.0,24.0,1
1985,92:69:1D:31:68:E9,3258920,469196367,28828,61230043,3230092,407966324,0,13025,4068494,12898,4047625,127,20869,8358,1,28874,2066,0,146,216660.0,130000.0,-49.0,-51.0,-46.0,-49.0,-49.0,-50.0,-46.0,-49.0,-85.0,-92.0,-86.0,-90.0,36.0,41.0,40.0,41.0,1
1986,BA:8C:B9:54:50:24,3274052,507944144,43956,99977416,3230096,407966728,64,15164,4574169,15025,4551161,139,23008,9415,6,43934,10913,64,230,216660.0,130000.0,-53.0,-51.0,-38.0,-46.0,-50.0,-51.0,-43.0,-48.0,-85.0,-92.0,-86.0,-90.0,32.0,41.0,48.0,44.0,1
1987,62:47:05:9D:EB:15,3245970,445907069,15874,37940341,3230096,407966728,64,7055,1424820,6983,1412656,72,12164,3240,1,15858,2450,64,181,229410.0,137640.0,-51.0,-50.0,-50.0,-41.0,-45.0,-50.0,-45.0,-42.0,-85.0,-92.0,-86.0,-90.0,34.0,42.0,36.0,49.0,1
1988,F8:59:71:5A:E0:3D,3497882,811926269,267786,403959541,3230096,407966728,3,267149,362290128,262228,361702264,4921,587864,243377,20,270539,6966,3,840,144444.0,43333.0,-68.0,-74.0,-67.0,-71.0,-68.0,-73.0,-66.0,-71.0,-85.0,-92.0,-86.0,-90.0,17.0,18.0,19.0,19.0,1
1989,CC:2F:71:3E:C5:1F,3241650,409380196,11554,1413468,3230096,407966728,6,49262,4126328,40700,3111858,8562,1014470,12183,36,16556,190,6,856,144444.0,39000.0,-67.0,-69.0,-68.0,-60.0,-68.0,-72.0,-68.0,-61.0,-85.0,-92.0,-86.0,-90.0,18.0,23.0,18.0,30.0,1
1990,CC:2F:71:3F:1F:24,12009608,13874387318,8779512,13466420590,3230096,407966728,158,1994359,1173749527,1985657,1172704149,8702,1045378,1929446,675,8784333,932259,158,6672,130000.0,43333.0,-68.0,-66.0,-72.0,-68.0,-68.0,-65.0,-72.0,-68.0,-85.0,-92.0,-86.0,-90.0,17.0,26.0,14.0,22.0,1
1991,92:69:1D:31:68:E9,3258926,469196973,28828,61230043,3230098,407966930,0,13027,4068630,12900,4047761,127,20869,8358,1,28874,2066,0,146,216660.0,130000.0,-52.0,-51.0,-45.0,-51.0,-49.0,-50.0,-45.0,-49.0,-84.0,-92.0,-86.0,-90.0,32.0,41.0,41.0,39.0,1
1992,BA:8C:B9:54:50:24,3274056,507944578,43958,99977648,3230098,407966930,64,15168,4574517,15029,4551509,139,23008,9417,6,43936,10915,64,230,216660.0,130000.0,-46.0,-50.0,-54.0,-46.0,-50.0,-50.0,-45.0,-46.0,-84.0,-92.0,-86.0,-90.0,38.0,42.0,32.0,44.0,1
1993,62:47:05:9D:EB:15,3245976,445908128,15878,37941198,3230098,407966930,64,7073,1426664,7001,1414500,72,12164,3244,1,15862,2450,64,181,229410.0,137640.0,-43.0,-50.0,-43.0,-45.0,-44.0,-51.0,-44.0,-44.0,-84.0,-92.0,-86.0,-90.0,41.0,42.0,43.0,45.0,1
1994,F8:59:71:5A:E0:3D,3497973,812064609,267875,404097679,3230098,407966930,3,267238,362427188,262317,361839324,4921,587864,243466,20,270628,6967,3,840,144444.0,43333.0,-67.0,-73.0,-66.0,-71.0,-67.0,-73.0,-66.0,-71.0,-84.0,-92.0,-86.0,-90.0,17.0,19.0,20.0,19.0,1
1995,CC:2F:71:3E:C5:1F,3241652,409380398,11554,1413468,3230098,407966930,6,49262,4126328,40700,3111858,8562,1014470,12183,36,16556,190,6,856,144444.0,39000.0,-67.0,-69.0,-68.0,-60.0,-68.0,-72.0,-68.0,-61.0,-84.0,-92.0,-86.0,-90.0,17.0,23.0,18.0,30.0,1
1996,CC:2F:71:3F:1F:24,12011183,13876784269,8781082,13468817077,3230101,407967192,158,1994790,1174078083,1986088,1173032705,8702,1045378,1929850,675,8785893,932387,158,6673,130000.0,43333.0,-68.0,-65.0,-73.0,-68.0,-68.0,-65.0,-72.0,-68.0,-84.0,-92.0,-86.0,-90.0,16.0,27.0,13.0,22.0,1
1997,92:69:1D:31:68:E9,3259092,469605959,28985,61638161,3230107,407967798,0,13068,4076691,12941,4055822,127,20869,8386,1,29031,2077,0,146,229410.0,130000.0,-53.0,-51.0,-46.0,-51.0,-50.0,-50.0,-45.0,-49.0,-84.0,-92.0,-85.0,-90.0,31.0,41.0,39.0,39.0,1
1998,BA:8C:B9:54:50:24,3274065,507945446,43958,99977648,3230107,407967798,64,15169,4574585,15030,4551577,139,23008,9417,6,43936,10915,64,230,216660.0,130000.0,-46.0,-50.0,-53.0,-46.0,-49.0,-50.0,-47.0,-46.0,-84.0,-92.0,-85.0,-90.0,38.0,42.0,32.0,44.0,1
1999,62:47:05:9D:EB:15,3245985,445908996,15878,37941198,3230107,407967798,64,7073,1426664,7001,1414500,72,12164,3244,1,15862,2450,64,181,229410.0,137640.0,-43.0,-50.0,-43.0,-45.0,-44.0,-51.0,-44.0,-44.0,-84.0,-92.0,-85.0,-90.0,41.0,42.0,42.0,45.0,1
2000,F8:59:71:5A:E0:3D,3498097,812244187,267990,404276389,3230107,407967798,3,267354,362606360,262433,362018496,4921,587864,243581,20,270743,6973,3,842,144444.0,43333.0,-67.0,-73.0,-66.0,-71.0,-67.0,-73.0,-66.0,-70.0,-84.0,-92.0,-85.0,-90.0,17.0,19.0,19.0,19.0,1
2001,CC:2F:71:3E:C5:1F,3241661,409381266,11554,1413468,3230107,407967798,6,49262,4126328,40700,3111858,8562,1014470,12183,36,16556,190,6,856,144444.0,39000.0,-67.0,-69.0,-68.0,-60.0,-68.0,-72.0,-68.0,-61.0,-84.0,-92.0,-85.0,-90.0,17.0,23.0,17.0,30.0,1
2002,CC:2F:71:3F:1F:24,12012310,13878480885,8782203,13470513087,3230107,407967798,158,1995165,1174446561,1986463,1173401183,8702,1045378,1930221,675,8787036,932448,158,6673,130000.0,43333.0,-67.0,-65.0,-73.0,-68.0,-67.0,-65.0,-73.0,-68.0,-84.0,-92.0,-85.0,-90.0,17.0,27.0,12.0,22.0,1
2003,92:69:1D:31:68:E9,3259102,469606938,28985,61638161,3230117,407968777,0,13068,4076691,12941,4055822,127,20869,8386,1,29031,2077,0,146,229410.0,130000.0,-53.0,-51.0,-46.0,-51.0,-50.0,-50.0,-45.0,-49.0,-84.0,-92.0,-85.0,-90.0,31.0,41.0,39.0,39.0,1
2004,BA:8C:B9:54:50:24,3274075,507946425,43958,99977648,3230117,407968777,64,15169,4574585,15030,4551577,139,23008,9417,6,43936,10915,64,230,216660.0,130000.0,-46.0,-50.0,-53.0,-46.0,-49.0,-50.0,-47.0,-46.0,-83.0,-92.0,-85.0,-90.0,37.0,42.0,32.0,44.0,1
2005,62:47:05:9D:EB:15,3245997,445910298,15880,37941521,3230117,407968777,64,7106,1429212,7033,1416877,73,12335,3248,1,15864,2450,64,181,229410.0,137640.0,-47.0,-53.0,-48.0,-46.0,-48.0,-52.0,-48.0,-44.0,-83.0,-92.0,-85.0,-90.0,36.0,39.0,37.0,44.0,1
2006,F8:59:71:5A:E0:3D,3498233,812440970,268116,404472193,3230117,407968777,3,267482,362804068,262561,362216204,4921,587864,243697,20,270869,6977,3,843,144444.0,43333.0,-68.0,-74.0,-66.0,-71.0,-67.0,-73.0,-66.0,-70.0,-83.0,-92.0,-85.0,-90.0,15.0,18.0,19.0,19.0,1
2007,CC:2F:71:3E:C5:1F,3241671,409382245,11554,1413468,3230117,407968777,6,49262,4126328,40700,3111858,8562,1014470,12183,36,16556,190,6,856,144444.0,39000.0,-67.0,-69.0,-68.0,-60.0,-68.0,-72.0,-68.0,-61.0,-83.0,-92.0,-85.0,-90.0,16.0,23.0,17.0,30.0,1
2008,CC:2F:71:3F:1F:24,12013579,13880396410,8783462,13472427633,3230117,407968777,158,1995608,1174869045,1986906,1173823667,8702,1045378,1930659,675,8788295,932505,158,6674,130000.0,43333.0,-68.0,-65.0,-73.0,-68.0,-67.0,-65.0,-72.0,-67.0,-83.0,-92.0,-85.0,-90.0,15.0,27.0,12.0,22.0,1
2009,92:69:1D:31:68:E9,3259108,469607544,28985,61638161,3230123,407969383,0,13068,4076691,12941,4055822,127,20869,8386,1,29031,2077,0,146,229410.0,130000.0,-53.0,-51.0,-46.0,-51.0,-50.0,-50.0,-45.0,-49.0,-82.0,-92.0,-85.0,-89.0,29.0,41.0,39.0,38.0,1
2010,BA:8C:B9:54:50:24,3274081,507947031,43958,99977648,3230123,407969383,64,15169,4574585,15030,4551577,139,23008,9417,6,43936,10915,64,230,216660.0,130000.0,-46.0,-50.0,-53.0,-46.0,-49.0,-50.0,-47.0,-46.0,-82.0,-92.0,-85.0,-89.0,36.0,42.0,32.0,43.0,1
2011,62:47:05:9D:EB:15,3246003,445910904,15880,37941521,3230123,407969383,64,7107,1429280,7034,1416945,73,12335,3248,1,15864,2450,64,181,229410.0,137640.0,-52.0,-50.0,-50.0,-41.0,-48.0,-52.0,-48.0,-44.0,-82.0,-92.0,-85.0,-89.0,30.0,42.0,35.0,48.0,1
2012,F8:59:71:5A:E0:3D,3498326,812576774,268203,404607391,3230123,407969383,3,267569,362938076,262648,362350212,4921,587864,243784,20,270956,6979,3,844,144444.0,43333.0,-67.0,-73.0,-66.0,-71.0,-67.0,-73.0,-66.0,-71.0,-82.0,-92.0,-85.0,-89.0,15.0,19.0,19.0,18.0,1
2013,CC:2F:71:3E:C5:1F,3241677,409382851,11554,1413468,3230123,407969383,6,49262,4126328,40700,3111858,8562,1014470,12183,36,16556,190,6,856,144444.0,39000.0,-67.0,-69.0,-68.0,-60.0,-68.0,-72.0,-68.0,-61.0,-82.0,-92.0,-85.0,-89.0,15.0,23.0,17.0,29.0,1
2014,CC:2F:71:3F:1F:24,12015025,13882588303,8784902,13474618920,3230123,407969383,158,1995973,1175170788,1987271,1174125410,8702,1045378,1931024,675,8789735,932682,158,6674,130000.0,43333.0,-68.0,-65.0,-74.0,-68.0,-67.0,-65.0,-73.0,-68.0,-82.0,-92.0,-85.0,-89.0,14.0,27.0,11.0,21.0,1
2015,92:69:1D:31:68:E9,3259111,469607806,28985,61638161,3230126,407969645,0,13069,4076759,12942,4055890,127,20869,8386,1,29031,2077,0,146,229410.0,130000.0,-53.0,-51.0,-45.0,-51.0,-50.0,-50.0,-45.0,-49.0,-82.0,-92.0,-85.0,-89.0,29.0,41.0,40.0,38.0,1
2016,BA:8C:B9:54:50:24,3274084,507947293,43958,99977648,3230126,407969645,64,15169,4574585,15030,4551577,139,23008,9417,6,43936,10915,64,230,216660.0,130000.0,-46.0,-50.0,-53.0,-46.0,-49.0,-50.0,-47.0,-46.0,-82.0,-92.0,-84.0,-89.0,36.0,42.0,31.0,43.0,1
2017,62:47:05:9D:EB:15,3246006,445911166,15880,37941521,3230126,407969645,64,7107,1429280,7034,1416945,73,12335,3248,1,15864,2450,64,181,229410.0,137640.0,-52.0,-50.0,-50.0,-41.0,-48.0,-52.0,-48.0,-44.0,-82.0,-92.0,-84.0,-89.0,30.0,42.0,34.0,48.0,1
2018,F8:59:71:5A:E0:3D,3498420,812718450,268294,404748805,3230126,407969645,3,267660,363078216,262739,362490352,4921,587864,243875,20,271047,6979,3,844,144444.0,43333.0,-68.0,-73.0,-66.0,-71.0,-67.0,-73.0,-66.0,-71.0,-82.0,-92.0,-84.0,-89.0,14.0,19.0,18.0,18.0,1
2019,CC:2F:71:3E:C5:1F,3241682,409383315,11554,1413468,3230128,407969847,6,49262,4126328,40700,3111858,8562,1014470,12183,36,16556,190,6,856,144444.0,39000.0,-67.0,-69.0,-68.0,-60.0,-68.0,-72.0,-68.0,-61.0,-82.0,-92.0,-84.0,-89.0,15.0,23.0,16.0,29.0,1
2020,CC:2F:71:3F:1F:24,12016240,13884427547,8786112,13476457700,3230128,407969847,158,1996325,1175473260,1987623,1174427882,8702,1045378,1931372,675,8790945,932772,158,6674,130000.0,43333.0,-68.0,-66.0,-75.0,-69.0,-68.0,-66.0,-75.0,-68.0,-82.0,-92.0,-84.0,-89.0,14.0,26.0,9.0,20.0,1
2021,92:69:1D:31:68:E9,3259120,469608887,28985,61638161,3230135,407970726,0,13069,4076759,12942,4055890,127,20869,8386,1,29031,2077,0,146,229410.0,130000.0,-53.0,-51.0,-45.0,-51.0,-50.0,-50.0,-45.0,-49.0,-82.0,-92.0,-84.0,-89.0,29.0,41.0,39.0,38.0,1
2022,BA:8C:B9:54:50:24,3274093,507948374,43958,99977648,3230135,407970726,64,15169,4574585,15030,4551577,139,23008,9417,6,43936,10915,64,230,216660.0,130000.0,-46.0,-50.0,-53.0,-46.0,-49.0,-50.0,-47.0,-46.0,-82.0,-92.0,-84.0,-89.0,36.0,42.0,31.0,43.0,1
2023,62:47:05:9D:EB:15,3246015,445912247,15880,37941521,3230135,407970726,64,7107,1429280,7034,1416945,73,12335,3248,1,15864,2450,64,181,229410.0,137640.0,-52.0,-50.0,-50.0,-41.0,-48.0,-52.0,-48.0,-44.0,-82.0,-92.0,-84.0,-89.0,30.0,42.0,34.0,48.0,1
2024,F8:59:71:5A:E0:3D,3498519,812858508,268384,404887782,3230135,407970726,3,267750,363215426,262829,362627562,4921,587864,243965,20,271137,6980,3,844,144444.0,43333.0,-68.0,-74.0,-66.0,-71.0,-68.0,-73.0,-66.0,-71.0,-82.0,-92.0,-84.0,-89.0,14.0,18.0,18.0,18.0,1
2025,CC:2F:71:3E:C5:1F,3241689,409384194,11554,1413468,3230135,407970726,6,49262,4126328,40700,3111858,8562,1014470,12183,36,16556,190,6,856,144444.0,39000.0,-67.0,-69.0,-68.0,-60.0,-68.0,-72.0,-68.0,-61.0,-82.0,-92.0,-84.0,-89.0,15.0,23.0,16.0,29.0,1
2026,CC:2F:71:3F:1F:24,12017395,13886169674,8787260,13478198948,3230135,407970726,158,1996664,1175771216,1987962,1174725838,8702,1045378,1931710,675,8792091,932800,158,6675,130000.0,43333.0,-67.0,-65.0,-74.0,-68.0,-67.0,-65.0,-73.0,-67.0,-82.0,-92.0,-84.0,-89.0,15.0,27.0,10.0,21.0,1
2027,92:69:1D:31:68:E9,3259124,469609209,28985,61638161,3230139,407971048,0,13069,4076759,12942,4055890,127,20869,8386,1,29031,2077,0,146,229410.0,130000.0,-53.0,-51.0,-45.0,-51.0,-50.0,-50.0,-45.0,-49.0,-82.0,-92.0,-84.0,-89.0,29.0,41.0,39.0,38.0,1
2028,BA:8C:B9:54:50:24,3274098,507948830,43958,99977648,3230140,407971182,64,15169,4574585,15030,4551577,139,23008,9417,6,43936,10915,64,230,216660.0,130000.0,-46.0,-50.0,-53.0,-46.0,-49.0,-50.0,-47.0,-46.0,-82.0,-92.0,-84.0,-89.0,36.0,42.0,31.0,43.0,1
2029,62:47:05:9D:EB:15,3246024,445913033,15880,37941521,3230144,407971512,64,7107,1429280,7034,1416945,73,12335,3248,1,15864,2450,64,181,229410.0,137640.0,-52.0,-50.0,-50.0,-41.0,-48.0,-52.0,-48.0,-44.0,-82.0,-92.0,-84.0,-89.0,30.0,42.0,34.0,48.0,1
2030,F8:59:71:5A:E0:3D,3498614,812992938,268470,405021426,3230144,407971512,3,267836,363347880,262915,362760016,4921,587864,244050,20,271223,6985,3,844,144444.0,43333.0,-68.0,-74.0,-67.0,-71.0,-68.0,-73.0,-66.0,-71.0,-82.0,-92.0,-84.0,-89.0,14.0,18.0,17.0,18.0,1
2031,CC:2F:71:3E:C5:1F,3241698,409384980,11554,1413468,3230144,407971512,6,49262,4126328,40700,3111858,8562,1014470,12183,36,16556,190,6,856,144444.0,39000.0,-67.0,-69.0,-68.0,-60.0,-68.0,-72.0,-68.0,-61.0,-82.0,-92.0,-84.0,-89.0,15.0,23.0,16.0,29.0,1
2032,CC:2F:71:3F:1F:24,12018523,13887851385,8788379,13479879873,3230144,407971512,158,1997031,1176061360,1988328,1175015868,8703,1045492,1932077,675,8793212,932855,158,6675,130000.0,43333.0,-68.0,-65.0,-73.0,-68.0,-68.0,-65.0,-73.0,-68.0,-82.0,-92.0,-84.0,-89.0,14.0,27.0,11.0,21.0,1
2033,92:69:1D:31:68:E9,3259135,469610221,28985,61638161,3230150,407972060,0,13069,4076759,12942,4055890,127,20869,8386,1,29031,2077,0,146,229410.0,130000.0,-53.0,-51.0,-45.0,-51.0,-50.0,-50.0,-45.0,-49.0,-82.0,-92.0,-84.0,-89.0,29.0,41.0,39.0,38.0,1
2034,BA:8C:B9:54:50:24,3274109,507949824,43959,99977764,3230150,407972060,64,15173,4574857,15034,4551849,139,23008,9417,6,43937,10915,64,230,216660.0,130000.0,-53.0,-51.0,-38.0,-46.0,-49.0,-49.0,-44.0,-46.0,-82.0,-92.0,-85.0,-90.0,29.0,41.0,47.0,44.0,1
2035,62:47:05:9D:EB:15,3246035,445914136,15881,37941637,3230154,407972499,64,7110,1429705,7035,1417013,75,12692,3250,1,15865,2450,64,181,229410.0,137640.0,-46.0,-53.0,-48.0,-46.0,-48.0,-51.0,-48.0,-44.0,-82.0,-92.0,-85.0,-90.0,36.0,39.0,37.0,44.0,1
2036,F8:59:71:5A:E0:3D,3498770,813209079,268609,405235994,3230161,407973085,3,267975,363562612,263054,362974748,4921,587864,244178,20,271362,6985,3,844,144444.0,43333.0,-68.0,-73.0,-66.0,-71.0,-67.0,-73.0,-66.0,-71.0,-82.0,-92.0,-85.0,-90.0,14.0,19.0,19.0,19.0,1
2037,CC:2F:71:3E:C5:1F,3241719,409387099,11555,1413584,3230164,407973515,6,49264,4126468,40702,3111998,8562,1014470,12183,36,16557,190,6,856,144444.0,39000.0,-81.0,-77.0,-75.0,-83.0,-71.0,-74.0,-69.0,-65.0,-82.0,-92.0,-85.0,-90.0,1.0,15.0,10.0,7.0,1
2038,CC:2F:71:3F:1F:24,12020011,13890087465,8789847,13482113950,3230164,407973515,158,1997547,1176506277,1988840,1175460213,8707,1046064,1932590,675,8794680,932963,158,6677,130000.0,43333.0,-68.0,-66.0,-74.0,-68.0,-67.0,-65.0,-74.0,-68.0,-82.0,-92.0,-85.0,-90.0,14.0,26.0,11.0,22.0,1
2039,92:69:1D:31:68:E9,3259152,469611938,28986,61638221,3230166,407973717,0,13078,4077425,12950,4056434,128,20991,8387,1,29032,2077,0,148,229410.0,130000.0,-52.0,-51.0,-46.0,-51.0,-51.0,-51.0,-46.0,-51.0,-83.0,-92.0,-85.0,-91.0,31.0,41.0,39.0,40.0,1
2040,BA:8C:B9:54:50:24,3274291,508379606,44125,100405889,3230166,407973717,64,15217,4583304,15078,4560296,139,23008,9448,6,44103,11054,64,230,206470.0,97500.0,-53.0,-51.0,-38.0,-46.0,-51.0,-51.0,-43.0,-49.0,-83.0,-92.0,-85.0,-91.0,30.0,41.0,47.0,45.0,1
2041,62:47:05:9D:EB:15,3246047,445915354,15881,37941637,3230166,407973717,64,7134,1431337,7059,1418645,75,12692,3250,1,15865,2450,64,182,229410.0,137640.0,-43.0,-50.0,-44.0,-45.0,-46.0,-52.0,-47.0,-45.0,-83.0,-92.0,-85.0,-91.0,40.0,42.0,41.0,46.0,1
2042,F8:59:71:5A:E0:3D,3498855,813334031,268689,405360314,3230166,407973717,3,268058,363690474,263137,363102610,4921,587864,244258,20,271442,6987,3,844,144444.0,43333.0,-68.0,-74.0,-66.0,-71.0,-68.0,-73.0,-66.0,-71.0,-83.0,-92.0,-85.0,-91.0,15.0,18.0,19.0,20.0,1
2043,CC:2F:71:3E:C5:1F,3241721,409387301,11555,1413584,3230166,407973717,6,49264,4126468,40702,3111998,8562,1014470,12183,36,16557,190,6,856,144444.0,39000.0,-81.0,-77.0,-75.0,-83.0,-71.0,-74.0,-69.0,-65.0,-83.0,-92.0,-85.0,-91.0,2.0,15.0,10.0,8.0,1
2044,CC:2F:71:3F:1F:24,12021071,13891681240,8790905,13483707523,3230166,407973717,158,1997903,1176776721,1989196,1175730657,8707,1046064,1932945,675,8795738,932996,158,6677,130000.0,43333.0,-74.0,-72.0,-79.0,-74.0,-73.0,-71.0,-78.0,-73.0,-83.0,-92.0,-85.0,-91.0,9.0,20.0,6.0,17.0,1
2045,92:69:1D:31:68:E9,3259158,469612544,28986,61638221,3230172,407974323,0,13078,4077425,12950,4056434,128,20991,8387,1,29032,2077,0,148,229410.0,130000.0,-52.0,-51.0,-46.0,-51.0,-51.0,-51.0,-46.0,-51.0,-84.0,-92.0,-85.0,-90.0,32.0,41.0,39.0,39.0,1
2046,BA:8C:B9:54:50:24,3274297,508380212,44125,100405889,3230172,407974323,64,15217,4583304,15078,4560296,139,23008,9448,6,44103,11054,64,230,206470.0,97500.0,-53.0,-51.0,-38.0,-46.0,-51.0,-51.0,-43.0,-49.0,-84.0,-92.0,-85.0,-90.0,31.0,41.0,47.0,44.0,1
2047,62:47:05:9D:EB:15,3246059,445917246,15887,37942923,3230172,407974323,64,7170,1434691,7095,1421999,75,12692,3258,1,15871,2450,64,183,229410.0,137640.0,-52.0,-50.0,-50.0,-41.0,-46.0,-51.0,-47.0,-43.0,-84.0,-92.0,-85.0,-90.0,32.0,42.0,35.0,49.0,1
2048,F8:59:71:5A:E0:3D,3498938,813454183,268766,405479860,3230172,407974323,3,268135,363809054,263214,363221190,4921,587864,244335,20,271519,6987,3,844,144444.0,43333.0,-68.0,-74.0,-66.0,-71.0,-67.0,-73.0,-66.0,-71.0,-84.0,-92.0,-85.0,-90.0,16.0,18.0,19.0,19.0,1
2049,CC:2F:71:3E:C5:1F,3241729,409388109,11555,1413584,3230174,407974525,6,49264,4126468,40702,3111998,8562,1014470,12183,36,16557,190,6,856,144444.0,39000.0,-81.0,-77.0,-75.0,-83.0,-71.0,-74.0,-69.0,-65.0,-84.0,-92.0,-85.0,-90.0,3.0,15.0,10.0,7.0,1
2050,CC:2F:71:3F:1F:24,12022485,13893829100,8792311,13485854575,3230174,407974525,158,1998325,1177074387,1989618,1176028323,8707,1046064,1933364,675,8797143,933072,158,6677,130000.0,43333.0,-67.0,-65.0,-73.0,-68.0,-67.0,-65.0,-73.0,-67.0,-84.0,-92.0,-85.0,-90.0,17.0,27.0,12.0,22.0,1
2051,92:69:1D:31:68:E9,3259278,469905470,29097,61930279,3230181,407975191,0,13105,4083820,12977,4062829,128,20991,8404,1,29143,2077,0,148,229410.0,130000.0,-52.0,-51.0,-45.0,-51.0,-50.0,-50.0,-45.0,-49.0,-84.0,-92.0,-85.0,-90.0,32.0,41.0,40.0,39.0,1
2052,BA:8C:B9:54:50:24,3274306,508381080,44125,100405889,3230181,407975191,64,15217,4583304,15078,4560296,139,23008,9448,6,44103,11054,64,230,206470.0,97500.0,-53.0,-51.0,-38.0,-46.0,-51.0,-51.0,-43.0,-49.0,-84.0,-92.0,-85.0,-90.0,31.0,41.0,47.0,44.0,1
2053,62:47:05:9D:EB:15,3246070,445918734,15889,37943543,3230181,407975191,64,7185,1439322,7110,1426630,75,12692,3260,1,15871,2450,64,183,229410.0,137640.0,-43.0,-49.0,-44.0,-41.0,-42.0,-49.0,-44.0,-41.0,-84.0,-92.0,-85.0,-90.0,41.0,43.0,41.0,49.0,1
2054,F8:59:71:5A:E0:3D,3499083,813666395,268902,405691204,3230181,407975191,3,268274,364024010,263353,363436146,4921,587864,244449,20,271655,6992,3,846,144444.0,43333.0,-68.0,-74.0,-67.0,-71.0,-67.0,-74.0,-66.0,-71.0,-84.0,-92.0,-85.0,-90.0,16.0,18.0,18.0,19.0,1
2055,CC:2F:71:3E:C5:1F,3241738,409388977,11555,1413584,3230183,407975393,6,49264,4126468,40702,3111998,8562,1014470,12183,36,16557,190,6,856,144444.0,39000.0,-81.0,-77.0,-75.0,-83.0,-71.0,-74.0,-69.0,-65.0,-84.0,-92.0,-85.0,-90.0,3.0,15.0,10.0,7.0,1
2056,CC:2F:71:3F:1F:24,12023972,13896052507,8793789,13488077114,3230183,407975393,158,1998831,1177540951,1990124,1176494887,8707,1046064,1933838,675,8798622,933452,158,6677,130000.0,39000.0,-67.0,-65.0,-74.0,-68.0,-67.0,-65.0,-73.0,-67.0,-84.0,-92.0,-85.0,-90.0,17.0,27.0,11.0,22.0,1
2057,92:69:1D:31:68:E9,3259280,469905672,29097,61930279,3230183,407975393,0,13105,4083820,12977,4062829,128,20991,8404,1,29143,2077,0,148,229410.0,130000.0,-52.0,-51.0,-45.0,-51.0,-50.0,-50.0,-45.0,-49.0,-84.0,-92.0,-85.0,-90.0,32.0,41.0,40.0,39.0,1
2058,BA:8C:B9:54:50:24,3274309,508381342,44125,100405889,3230184,407975453,64,15217,4583304,15078,4560296,139,23008,9448,6,44103,11054,64,230,206470.0,97500.0,-53.0,-51.0,-38.0,-46.0,-51.0,-51.0,-43.0,-49.0,-84.0,-92.0,-85.0,-90.0,31.0,41.0,47.0,44.0,1
2059,62:47:05:9D:EB:15,3246074,445919128,15890,37943675,3230184,407975453,64,7191,1443523,7116,1430831,75,12692,3262,1,15874,2450,64,183,229410.0,137640.0,-52.0,-50.0,-50.0,-41.0,-45.0,-50.0,-46.0,-42.0,-84.0,-92.0,-85.0,-90.0,32.0,42.0,35.0,49.0,1
2060,F8:59:71:5A:E0:3D,3499168,813794085,268984,405818632,3230184,407975453,3,268357,364151830,263436,363563966,4921,587864,244532,20,271737,6993,3,846,144444.0,43333.0,-68.0,-74.0,-66.0,-72.0,-67.0,-73.0,-66.0,-71.0,-84.0,-92.0,-85.0,-90.0,16.0,18.0,19.0,18.0,1
2061,CC:2F:71:3E:C5:1F,3241739,409389037,11555,1413584,3230184,407975453,6,49264,4126468,40702,3111998,8562,1014470,12183,36,16557,190,6,856,144444.0,39000.0,-81.0,-77.0,-75.0,-83.0,-71.0,-74.0,-69.0,-65.0,-84.0,-92.0,-85.0,-90.0,3.0,15.0,10.0,7.0,1
2062,CC:2F:71:3F:1F:24,12025875,13898945194,8795691,13490969741,3230184,407975453,158,1999280,1177847581,1990573,1176801517,8707,1046064,1934276,675,8800523,933520,158,6677,130000.0,43333.0,-67.0,-65.0,-73.0,-67.0,-67.0,-65.0,-73.0,-67.0,-84.0,-92.0,-85.0,-90.0,17.0,27.0,12.0,23.0,1
2063,92:69:1D:31:68:E9,3259289,469906540,29097,61930279,3230192,407976261,0,13105,4083820,12977,4062829,128,20991,8404,1,29143,2077,0,148,229410.0,130000.0,-52.0,-51.0,-45.0,-51.0,-50.0,-50.0,-45.0,-49.0,-84.0,-92.0,-85.0,-90.0,32.0,41.0,40.0,39.0,1
2064,BA:8C:B9:54:50:24,3274317,508382150,44125,100405889,3230192,407976261,64,15217,4583304,15078,4560296,139,23008,9448,6,44103,11054,64,230,206470.0,97500.0,-53.0,-51.0,-38.0,-46.0,-51.0,-51.0,-43.0,-49.0,-84.0,-92.0,-85.0,-90.0,31.0,41.0,47.0,44.0,1
2065,62:47:05:9D:EB:15,3246093,445925360,15890,37943675,3230203,407981685,64,7191,1443523,7116,1430831,75,12692,3262,1,15874,2450,64,183,229410.0,137640.0,-52.0,-50.0,-50.0,-41.0,-45.0,-50.0,-46.0,-42.0,-84.0,-92.0,-85.0,-90.0,32.0,42.0,35.0,49.0,1
2066,F8:59:71:5A:E0:3D,3499279,813943285,269076,405961600,3230203,407981685,3,268448,364292068,263527,363704204,4921,587864,244623,20,271829,6993,3,846,144444.0,43333.0,-68.0,-74.0,-67.0,-71.0,-67.0,-73.0,-66.0,-71.0,-84.0,-92.0,-85.0,-90.0,16.0,18.0,18.0,19.0,1
2067,CC:2F:71:3E:C5:1F,3241769,409400693,11555,1413584,3230214,407987109,6,49264,4126468,40702,3111998,8562,1014470,12183,36,16557,190,6,856,144444.0,39000.0,-81.0,-77.0,-75.0,-83.0,-71.0,-74.0,-69.0,-65.0,-84.0,-92.0,-85.0,-90.0,3.0,15.0,10.0,7.0,1
2068,CC:2F:71:3F:1F:24,12027357,13901176886,8797143,13493189777,3230214,407987109,158,1999663,1178181783,1990956,1177135719,8707,1046064,1934650,675,8801953,933721,158,6677,130000.0,43333.0,-67.0,-65.0,-73.0,-67.0,-67.0,-64.0,-72.0,-67.0,-84.0,-92.0,-85.0,-90.0,17.0,27.0,12.0,23.0,1
2069,92:69:1D:31:68:E9,3259319,469920951,29103,61933640,3230216,407987311,0,13113,4086825,12985,4065834,128,20991,8409,1,29149,2077,0,148,229410.0,137640.0,-52.0,-51.0,-45.0,-51.0,-50.0,-50.0,-45.0,-49.0,-84.0,-92.0,-85.0,-90.0,32.0,41.0,40.0,39.0,1
2070,BA:8C:B9:54:50:24,3274360,508404908,44136,100416869,3230224,407988039,64,15237,4585539,15097,4562409,140,23130,9455,6,44114,11055,64,231,206470.0,97500.0,-53.0,-51.0,-38.0,-46.0,-49.0,-50.0,-42.0,-46.0,-84.0,-92.0,-85.0,-90.0,31.0,41.0,47.0,44.0,1
2071,62:47:05:9D:EB:15,3246171,446004334,15947,38016295,3230224,407988039,64,7254,1448445,7179,1435753,75,12692,3269,1,15931,2450,64,185,216660.0,130000.0,-52.0,-50.0,-50.0,-41.0,-46.0,-51.0,-47.0,-43.0,-84.0,-92.0,-85.0,-90.0,32.0,42.0,35.0,49.0,1
2072,F8:59:71:5A:E0:3D,3499471,814213655,269247,406225616,3230224,407988039,3,268522,364404608,263601,363816744,4921,587864,244697,20,272000,7186,3,847,130000.0,43333.0,-64.0,-71.0,-64.0,-71.0,-67.0,-73.0,-66.0,-71.0,-84.0,-92.0,-85.0,-90.0,20.0,21.0,21.0,19.0,1
2073,CC:2F:71:3E:C5:1F,3241780,409401896,11555,1413584,3230225,407988312,6,49266,4126608,40704,3112138,8562,1014470,12183,36,16558,190,6,856,144444.0,39000.0,-64.0,-70.0,-65.0,-60.0,-70.0,-74.0,-69.0,-65.0,-84.0,-92.0,-85.0,-90.0,20.0,22.0,20.0,30.0,1
2074,CC:2F:71:3F:1F:24,12029215,13904009248,8798990,13496020936,3230225,407988312,158,2000236,1178719455,1991529,1177673391,8707,1046064,1935221,675,8803769,933849,158,6680,130000.0,43333.0,-64.0,-64.0,-67.0,-66.0,-64.0,-64.0,-67.0,-66.0,-84.0,-92.0,-85.0,-90.0,20.0,28.0,18.0,24.0,1
2075,92:69:1D:31:68:E9,3259342,469923700,29108,61934518,3230234,407989182,0,13123,4090733,12995,4069742,128,20991,8415,1,29154,2079,0,148,229410.0,137640.0,-52.0,-51.0,-45.0,-51.0,-50.0,-50.0,-46.0,-50.0,-83.0,-91.0,-84.0,-89.0,31.0,40.0,39.0,38.0,1
2076,BA:8C:B9:54:50:24,3274384,508421575,44149,100432333,3230235,407989242,64,15243,4586270,15103,4563140,140,23130,9458,6,44127,11055,64,231,206470.0,103230.0,-53.0,-51.0,-38.0,-46.0,-51.0,-50.0,-40.0,-47.0,-83.0,-91.0,-84.0,-89.0,30.0,40.0,46.0,43.0,1
2077,62:47:05:9D:EB:15,3246182,446005537,15947,38016295,3230235,407989242,64,7254,1448445,7179,1435753,75,12692,3269,1,15931,2450,64,185,216660.0,130000.0,-52.0,-50.0,-50.0,-41.0,-46.0,-51.0,-47.0,-43.0,-83.0,-91.0,-84.0,-89.0,31.0,41.0,34.0,48.0,1
2078,F8:59:71:5A:E0:3D,3499641,814455039,269402,406465422,3230239,407989617,4,268525,364404866,263603,363816884,4922,587982,244698,20,272155,7210,4,847,130000.0,43333.0,-66.0,-72.0,-64.0,-71.0,-66.0,-72.0,-65.0,-70.0,-83.0,-91.0,-84.0,-89.0,17.0,19.0,20.0,18.0,1
2079,CC:2F:71:3E:C5:1F,3241799,409403726,11555,1413584,3230244,407990142,6,49268,4126796,40705,3112208,8563,1014588,12184,36,16558,190,6,857,144444.0,39000.0,-73.0,-77.0,-70.0,-70.0,-70.0,-73.0,-69.0,-65.0,-83.0,-91.0,-84.0,-89.0,10.0,14.0,14.0,19.0,1
2080,CC:2F:71:3F:1F:24,12031329,13907214964,8801082,13499224552,3230247,407990412,158,2000947,1179378852,1992240,1178332788,8707,1046064,1935914,675,8805897,933902,158,6680,130000.0,43333.0,-67.0,-65.0,-73.0,-67.0,-66.0,-64.0,-72.0,-67.0,-83.0,-91.0,-84.0,-89.0,16.0,26.0,11.0,22.0,1
2081,92:69:1D:31:68:E9,3259358,469925192,29108,61934518,3230250,407990674,0,13126,4091040,12997,4069878,129,21162,8416,1,29154,2079,0,149,229410.0,137640.0,-53.0,-51.0,-44.0,-50.0,-50.0,-50.0,-46.0,-50.0,-83.0,-92.0,-84.0,-89.0,30.0,41.0,40.0,39.0,1
2082,BA:8C:B9:54:50:24,3274401,508423209,44149,100432333,3230252,407990876,64,15251,4586987,15109,4563548,142,23439,9460,6,44127,11055,64,234,206470.0,103230.0,-47.0,-50.0,-53.0,-46.0,-50.0,-51.0,-44.0,-47.0,-83.0,-92.0,-84.0,-89.0,36.0,42.0,31.0,43.0,1
2083,62:47:05:9D:EB:15,3246203,446007575,15947,38016295,3230256,407991280,64,7254,1448445,7179,1435753,75,12692,3269,1,15931,2450,64,185,216660.0,130000.0,-52.0,-50.0,-50.0,-41.0,-46.0,-51.0,-47.0,-43.0,-83.0,-92.0,-84.0,-89.0,31.0,42.0,34.0,48.0,1
2084,F8:59:71:5A:E0:3D,3499884,814807738,269628,406816458,3230256,407991280,4,268527,364405006,263605,363817024,4922,587982,244698,20,272382,7214,4,847,144444.0,43333.0,-73.0,-84.0,-76.0,-74.0,-66.0,-73.0,-66.0,-71.0,-83.0,-92.0,-84.0,-89.0,10.0,8.0,8.0,15.0,1
2085,CC:2F:71:3E:C5:1F,3241811,409404864,11555,1413584,3230256,407991280,6,49268,4126796,40705,3112208,8563,1014588,12184,36,16558,190,6,857,144444.0,39000.0,-73.0,-77.0,-70.0,-70.0,-70.0,-73.0,-69.0,-65.0,-83.0,-92.0,-84.0,-89.0,10.0,15.0,14.0,19.0,1
2086,CC:2F:71:3F:1F:24,12033186,13910005965,8802927,13502014423,3230259,407991542,158,2001635,1180162772,1992928,1179116708,8707,1046064,1936580,675,8807760,934167,158,6681,130000.0,43333.0,-68.0,-66.0,-74.0,-69.0,-67.0,-65.0,-73.0,-68.0,-83.0,-92.0,-84.0,-89.0,15.0,26.0,10.0,20.0,1
2087,92:69:1D:31:68:E9,3259373,469926666,29108,61934518,3230265,407992148,0,13126,4091040,12997,4069878,129,21162,8416,1,29154,2079,0,149,229410.0,137640.0,-53.0,-51.0,-44.0,-50.0,-50.0,-50.0,-46.0,-50.0,-83.0,-92.0,-84.0,-89.0,30.0,41.0,40.0,39.0,1
2088,BA:8C:B9:54:50:24,3274415,508424541,44150,100432393,3230265,407992148,64,15254,4587229,15112,4563790,142,23439,9461,6,44128,11055,64,235,206470.0,103230.0,-53.0,-50.0,-38.0,-46.0,-49.0,-51.0,-45.0,-46.0,-83.0,-92.0,-84.0,-89.0,30.0,42.0,46.0,43.0,1
2089,62:47:05:9D:EB:15,3246213,446008559,15948,38016411,3230265,407992148,64,7257,1448687,7182,1435995,75,12692,3270,1,15932,2450,64,185,216660.0,130000.0,-52.0,-50.0,-50.0,-41.0,-47.0,-51.0,-47.0,-43.0,-83.0,-92.0,-84.0,-89.0,31.0,42.0,34.0,48.0,1
2090,F8:59:71:5A:E0:3D,3500033,815026166,269768,407034018,3230265,407992148,4,269148,365364356,264226,364776374,4922,587982,245302,20,272522,7229,4,848,144444.0,43333.0,-68.0,-73.0,-66.0,-71.0,-67.0,-73.0,-66.0,-71.0,-83.0,-92.0,-84.0,-89.0,15.0,19.0,18.0,18.0,1
2091,CC:2F:71:3E:C5:1F,3241820,409405732,11555,1413584,3230265,407992148,6,49268,4126796,40705,3112208,8563,1014588,12184,36,16558,190,6,857,144444.0,39000.0,-73.0,-77.0,-70.0,-70.0,-70.0,-73.0,-69.0,-65.0,-83.0,-92.0,-84.0,-89.0,10.0,15.0,14.0,19.0,1
2092,CC:2F:71:3F:1F:24,12034458,13911897628,8804193,13503905480,3230265,407992148,158,2002006,1180473075,1993299,1179427011,8707,1046064,1936951,675,8809026,934245,158,6681,130000.0,43333.0,-67.0,-65.0,-72.0,-67.0,-67.0,-65.0,-72.0,-67.0,-83.0,-92.0,-84.0,-89.0,16.0,27.0,12.0,22.0,1
2093,92:69:1D:31:68:E9,3259376,469926979,29108,61934518,3230268,407992461,0,13126,4091040,12997,4069878,129,21162,8416,1,29154,2079,0,149,229410.0,137640.0,-53.0,-51.0,-44.0,-50.0,-50.0,-50.0,-46.0,-50.0,-83.0,-92.0,-84.0,-89.0,30.0,41.0,40.0,39.0,1
2094,BA:8C:B9:54:50:24,3274418,508424854,44150,100432393,3230268,407992461,64,15254,4587229,15112,4563790,142,23439,9461,6,44128,11055,64,235,206470.0,103230.0,-53.0,-50.0,-38.0,-46.0,-49.0,-51.0,-45.0,-46.0,-83.0,-92.0,-84.0,-89.0,30.0,42.0,46.0,43.0,1
2095,62:47:05:9D:EB:15,3246216,446008872,15948,38016411,3230268,407992461,64,7290,1451034,7214,1438171,76,12863,3271,1,15932,2450,64,185,216660.0,130000.0,-43.0,-51.0,-44.0,-45.0,-45.0,-51.0,-47.0,-45.0,-83.0,-92.0,-84.0,-89.0,40.0,41.0,40.0,44.0,1
2096,F8:59:71:5A:E0:3D,3500129,815165189,269857,407172324,3230272,407992865,4,269239,365504552,264317,364916570,4922,587982,245392,20,272611,7229,4,848,144444.0,43333.0,-67.0,-73.0,-66.0,-71.0,-67.0,-73.0,-66.0,-70.0,-83.0,-92.0,-84.0,-89.0,16.0,19.0,18.0,18.0,1
2097,CC:2F:71:3E:C5:1F,3241827,409406449,11555,1413584,3230272,407992865,6,49268,4126796,40705,3112208,8563,1014588,12184,36,16558,190,6,857,144444.0,39000.0,-73.0,-77.0,-70.0,-70.0,-70.0,-73.0,-69.0,-65.0,-83.0,-92.0,-84.0,-89.0,10.0,15.0,14.0,19.0,1
2098,CC:2F:71:3F:1F:24,12035685,13913719312,8805411,13505726245,3230274,407993067,158,2002392,1180792587,1993685,1179746523,8707,1046064,1937336,675,8810244,934300,158,6681,130000.0,43333.0,-67.0,-65.0,-73.0,-68.0,-67.0,-65.0,-73.0,-68.0,-83.0,-92.0,-84.0,-89.0,16.0,27.0,11.0,21.0,1
2099,92:69:1D:31:68:E9,3259383,469927645,29108,61934518,3230275,407993127,0,13126,4091040,12997,4069878,129,21162,8416,1,29154,2079,0,149,229410.0,137640.0,-53.0,-51.0,-44.0,-50.0,-50.0,-50.0,-46.0,-50.0,-83.0,-92.0,-85.0,-90.0,30.0,41.0,41.0,40.0,1
2100,BA:8C:B9:54:50:24,3274425,508425520,44150,100432393,3230275,407993127,64,15254,4587229,15112,4563790,142,23439,9461,6,44128,11055,64,235,206470.0,103230.0,-53.0,-50.0,-38.0,-46.0,-49.0,-51.0,-45.0,-46.0,-83.0,-92.0,-85.0,-90.0,30.0,42.0,47.0,44.0,1
2101,62:47:05:9D:EB:15,3246223,446009538,15948,38016411,3230275,407993127,64,7290,1451034,7214,1438171,76,12863,3271,1,15932,2450,64,185,216660.0,130000.0,-43.0,-51.0,-44.0,-45.0,-45.0,-51.0,-47.0,-45.0,-83.0,-92.0,-85.0,-90.0,40.0,41.0,41.0,45.0,1
2102,F8:59:71:5A:E0:3D,3500225,815309973,269950,407316846,3230275,407993127,4,269333,365649396,264411,365061414,4922,587982,245484,20,272704,7229,4,848,144444.0,43333.0,-67.0,-73.0,-66.0,-71.0,-67.0,-73.0,-66.0,-71.0,-83.0,-92.0,-85.0,-90.0,16.0,19.0,19.0,19.0,1
2103,CC:2F:71:3E:C5:1F,3241830,409406711,11555,1413584,3230275,407993127,6,49268,4126796,40705,3112208,8563,1014588,12184,36,16558,190,6,857,144444.0,39000.0,-73.0,-77.0,-70.0,-70.0,-70.0,-73.0,-69.0,-65.0,-83.0,-92.0,-85.0,-90.0,10.0,15.0,15.0,20.0,1
2104,CC:2F:71:3F:1F:24,12036913,13915577418,8806638,13507584291,3230275,407993127,158,2002745,1181102876,1994038,1180056812,8707,1046064,1937688,675,8811471,934409,158,6683,130000.0,43333.0,-68.0,-66.0,-74.0,-68.0,-67.0,-65.0,-73.0,-68.0,-83.0,-92.0,-85.0,-90.0,15.0,26.0,11.0,22.0,1
2105,92:69:1D:31:68:E9,3259546,470335629,29263,62341694,3230283,407993935,0,13153,4097685,13024,4076523,129,21162,8437,1,29309,2081,0,149,229410.0,137640.0,-52.0,-52.0,-45.0,-50.0,-49.0,-50.0,-45.0,-49.0,-83.0,-92.0,-85.0,-90.0,31.0,40.0,40.0,40.0,1
2106,BA:8C:B9:54:50:24,3274433,508426328,44150,100432393,3230283,407993935,64,15254,4587229,15112,4563790,142,23439,9461,6,44128,11055,64,235,206470.0,103230.0,-53.0,-50.0,-38.0,-46.0,-49.0,-51.0,-45.0,-46.0,-83.0,-92.0,-85.0,-90.0,30.0,42.0,47.0,44.0,1
2107,62:47:05:9D:EB:15,3246232,446010500,15949,38016565,3230283,407993935,64,7315,1452792,7239,1439929,76,12863,3272,1,15933,2450,64,186,216660.0,130000.0,-43.0,-49.0,-45.0,-40.0,-42.0,-49.0,-45.0,-40.0,-83.0,-92.0,-85.0,-90.0,40.0,43.0,40.0,50.0,1
2108,F8:59:71:5A:E0:3D,3500321,815447533,270038,407453598,3230283,407993935,4,269421,365784916,264499,365196934,4922,587982,245572,20,272792,7229,4,848,144444.0,43333.0,-67.0,-73.0,-66.0,-70.0,-67.0,-73.0,-66.0,-70.0,-83.0,-92.0,-85.0,-90.0,16.0,19.0,19.0,20.0,1
2109,CC:2F:71:3E:C5:1F,3241838,409407519,11555,1413584,3230283,407993935,6,49268,4126796,40705,3112208,8563,1014588,12184,36,16558,190,6,857,144444.0,39000.0,-73.0,-77.0,-70.0,-70.0,-70.0,-73.0,-69.0,-65.0,-83.0,-92.0,-85.0,-90.0,10.0,15.0,15.0,20.0,1
2110,CC:2F:71:3F:1F:24,12038296,13917675952,8808013,13509682017,3230283,407993935,158,2003100,1181409152,1994393,1180363088,8707,1046064,1938031,675,8812846,934430,158,6683,130000.0,43333.0,-67.0,-65.0,-73.0,-68.0,-67.0,-65.0,-74.0,-68.0,-83.0,-92.0,-85.0,-90.0,16.0,27.0,12.0,22.0,1
2111,92:69:1D:31:68:E9,3259549,470335891,29263,62341694,3230286,407994197,0,13153,4097685,13024,4076523,129,21162,8437,1,29309,2081,0,149,229410.0,137640.0,-52.0,-52.0,-45.0,-50.0,-49.0,-50.0,-45.0,-49.0,-83.0,-92.0,-85.0,-90.0,31.0,40.0,40.0,40.0,1
2112,BA:8C:B9:54:50:24,3274437,508426765,44150,100432393,3230287,407994372,64,15254,4587229,15112,4563790,142,23439,9461,6,44128,11055,64,235,206470.0,103230.0,-53.0,-50.0,-38.0,-46.0,-49.0,-51.0,-45.0,-46.0,-83.0,-92.0,-85.0,-90.0,30.0,42.0,47.0,44.0,1
2113,62:47:05:9D:EB:15,3246238,446011139,15949,38016565,3230289,407994574,64,7321,1453200,7245,1440337,76,12863,3272,1,15933,2450,64,186,216660.0,130000.0,-43.0,-51.0,-43.0,-45.0,-42.0,-49.0,-44.0,-40.0,-83.0,-92.0,-85.0,-90.0,40.0,41.0,42.0,45.0,1
2114,F8:59:71:5A:E0:3D,3500430,815605328,270139,407610552,3230291,407994776,4,269519,365935878,264597,365347896,4922,587982,245670,20,272893,7229,4,848,144444.0,43333.0,-68.0,-74.0,-67.0,-72.0,-68.0,-73.0,-66.0,-71.0,-83.0,-92.0,-85.0,-90.0,15.0,18.0,18.0,18.0,1
2115,CC:2F:71:3E:C5:1F,3241848,409408562,11555,1413584,3230293,407994978,6,49268,4126796,40705,3112208,8563,1014588,12184,36,16558,190,6,857,144444.0,39000.0,-73.0,-77.0,-70.0,-70.0,-70.0,-73.0,-69.0,-65.0,-83.0,-92.0,-85.0,-90.0,10.0,15.0,15.0,20.0,1
2116,CC:2F:71:3F:1F:24,12039612,13919642515,8809318,13511647264,3230294,407995251,158,2003504,1181758095,1994797,1180712031,8707,1046064,1938417,675,8814151,934474,158,6685,130000.0,43333.0,-67.0,-65.0,-74.0,-68.0,-67.0,-65.0,-73.0,-68.0,-83.0,-92.0,-85.0,-90.0,16.0,27.0,11.0,22.0,1
2117,92:69:1D:31:68:E9,3259560,470337207,29263,62341694,3230297,407995513,0,13160,4098328,13030,4076931,130,21397,8438,1,29309,2081,0,149,229410.0,137640.0,-52.0,-51.0,-45.0,-51.0,-50.0,-51.0,-46.0,-50.0,-83.0,-92.0,-84.0,-90.0,31.0,41.0,39.0,39.0,1
2118,BA:8C:B9:54:50:24,3274454,508429406,44157,100433893,3230297,407995513,64,15274,4590650,15132,4567211,142,23439,9472,6,44135,11058,64,235,216660.0,130000.0,-51.0,-52.0,-43.0,-48.0,-51.0,-51.0,-42.0,-47.0,-83.0,-92.0,-84.0,-90.0,32.0,40.0,41.0,42.0,1
2119,62:47:05:9D:EB:15,3246708,447240087,16411,39244574,3230297,407995513,64,7365,1462173,7289,1449310,76,12863,3312,1,16395,2462,64,186,229410.0,137640.0,-52.0,-50.0,-50.0,-41.0,-46.0,-52.0,-47.0,-44.0,-83.0,-92.0,-84.0,-90.0,31.0,42.0,34.0,49.0,1
2120,F8:59:71:5A:E0:3D,3500561,815797409,270262,407801694,3230299,407995715,4,269653,366142658,264731,365554676,4922,587982,245804,20,273016,7230,4,849,144444.0,43333.0,-67.0,-73.0,-66.0,-71.0,-66.0,-73.0,-65.0,-70.0,-82.0,-91.0,-84.0,-89.0,15.0,18.0,18.0,18.0,1
2121,CC:2F:71:3E:C5:1F,3241856,409409501,11555,1413584,3230301,407995917,6,49268,4126796,40705,3112208,8563,1014588,12184,36,16558,190,6,857,144444.0,39000.0,-73.0,-77.0,-70.0,-70.0,-70.0,-73.0,-69.0,-65.0,-82.0,-91.0,-84.0,-89.0,9.0,14.0,14.0,19.0,1
2122,CC:2F:71:3F:1F:24,12041818,13923029391,8811515,13515033272,3230303,407996119,158,2004061,1182212617,1995354,1181166553,8707,1046064,1938937,675,8816322,934515,158,6695,130000.0,43333.0,-66.0,-65.0,-70.0,-68.0,-66.0,-65.0,-70.0,-67.0,-82.0,-91.0,-84.0,-89.0,16.0,26.0,14.0,21.0,1
2123,92:69:1D:31:68:E9,3259566,470337813,29263,62341694,3230303,407996119,0,13160,4098328,13030,4076931,130,21397,8438,1,29309,2081,0,149,229410.0,137640.0,-52.0,-51.0,-45.0,-51.0,-50.0,-51.0,-46.0,-50.0,-82.0,-91.0,-84.0,-89.0,30.0,40.0,39.0,38.0,1
2124,BA:8C:B9:54:50:24,3274478,508438438,44175,100442319,3230303,407996119,64,15292,4593483,15150,4570044,142,23439,9485,6,44153,11063,64,235,195000.0,97500.0,-47.0,-50.0,-54.0,-46.0,-49.0,-51.0,-45.0,-47.0,-82.0,-91.0,-84.0,-89.0,35.0,41.0,30.0,43.0,1
2125,62:47:05:9D:EB:15,3246714,447240693,16411,39244574,3230303,407996119,64,7365,1462173,7289,1449310,76,12863,3312,1,16395,2462,64,186,229410.0,137640.0,-52.0,-50.0,-50.0,-41.0,-46.0,-52.0,-47.0,-44.0,-82.0,-91.0,-84.0,-89.0,30.0,41.0,34.0,48.0,1
2126,F8:59:71:5A:E0:3D,3500647,815923803,270344,407927684,3230303,407996119,4,269735,366268938,264813,365680956,4922,587982,245886,20,273098,7231,4,849,144444.0,43333.0,-66.0,-72.0,-66.0,-70.0,-66.0,-72.0,-65.0,-70.0,-82.0,-91.0,-84.0,-89.0,16.0,19.0,18.0,19.0,1
2127,CC:2F:71:3E:C5:1F,3241859,409409819,11556,1413700,3230303,407996119,6,49269,4126866,40706,3112278,8563,1014588,12184,36,16559,190,6,857,144444.0,43333.0,-68.0,-72.0,-66.0,-60.0,-70.0,-73.0,-68.0,-65.0,-82.0,-91.0,-83.0,-89.0,14.0,19.0,17.0,29.0,1
2128,CC:2F:71:3F:1F:24,12043852,13926158598,8813549,13518162479,3230303,407996119,158,2004591,1182522638,1995884,1181476574,8707,1046064,1939440,675,8818380,934648,158,6695,130000.0,43333.0,-66.0,-65.0,-70.0,-67.0,-66.0,-65.0,-70.0,-67.0,-82.0,-91.0,-83.0,-89.0,16.0,26.0,13.0,22.0,1
2129,92:69:1D:31:68:E9,3259577,470338859,29264,62341810,3230313,407997049,0,13162,4098464,13032,4077067,130,21397,8438,1,29310,2081,0,149,229410.0,137640.0,-52.0,-52.0,-46.0,-51.0,-50.0,-51.0,-45.0,-50.0,-82.0,-91.0,-83.0,-89.0,30.0,39.0,37.0,38.0,1
2130,BA:8C:B9:54:50:24,3274489,508439484,44176,100442435,3230313,407997049,64,15294,4593619,15152,4570180,142,23439,9485,6,44154,11063,64,236,195000.0,97500.0,-46.0,-49.0,-54.0,-46.0,-49.0,-50.0,-45.0,-47.0,-82.0,-91.0,-83.0,-89.0,36.0,42.0,29.0,43.0,1
2131,62:47:05:9D:EB:15,3246726,447241837,16413,39244788,3230313,407997049,64,7393,1464135,7317,1451272,76,12863,3313,1,16397,2462,64,186,229410.0,137640.0,-51.0,-50.0,-50.0,-41.0,-43.0,-49.0,-45.0,-40.0,-82.0,-91.0,-83.0,-89.0,31.0,41.0,33.0,48.0,1
2132,F8:59:71:5A:E0:3D,3500739,816052161,270426,408055112,3230313,407997049,4,269818,366395350,264895,365807250,4923,588100,245968,20,273180,7233,4,849,144444.0,43333.0,-66.0,-73.0,-66.0,-71.0,-66.0,-73.0,-66.0,-70.0,-82.0,-91.0,-83.0,-89.0,16.0,18.0,17.0,18.0,1
2133,CC:2F:71:3E:C5:1F,3241869,409410749,11556,1413700,3230313,407997049,6,49270,4126936,40707,3112348,8563,1014588,12184,36,16559,190,6,857,144444.0,43333.0,-72.0,-81.0,-71.0,-82.0,-70.0,-75.0,-69.0,-68.0,-82.0,-91.0,-83.0,-89.0,10.0,10.0,12.0,7.0,1
2134,CC:2F:71:3F:1F:24,12045762,13929089200,8815449,13521092151,3230313,407997049,158,2005035,1182815642,1996328,1181769578,8707,1046064,1939879,675,8820282,934676,158,6695,130000.0,43333.0,-66.0,-65.0,-70.0,-68.0,-66.0,-65.0,-70.0,-67.0,-82.0,-91.0,-83.0,-89.0,16.0,26.0,13.0,21.0,1
2135,92:69:1D:31:68:E9,3259578,470338921,29264,62341810,3230314,407997111,0,13162,4098464,13032,4077067,130,21397,8438,1,29310,2081,0,149,229410.0,137640.0,-52.0,-52.0,-46.0,-51.0,-50.0,-51.0,-45.0,-50.0,-82.0,-91.0,-83.0,-89.0,30.0,39.0,37.0,38.0,1
2136,BA:8C:B9:54:50:24,3274490,508439546,44176,100442435,3230314,407997111,64,15294,4593619,15152,4570180,142,23439,9485,6,44154,11063,64,236,195000.0,97500.0,-46.0,-49.0,-54.0,-46.0,-49.0,-50.0,-45.0,-47.0,-82.0,-91.0,-83.0,-89.0,36.0,42.0,29.0,43.0,1
2137,62:47:05:9D:EB:15,3246727,447241899,16413,39244788,3230314,407997111,64,7393,1464135,7317,1451272,76,12863,3313,1,16397,2462,64,186,229410.0,137640.0,-51.0,-50.0,-50.0,-41.0,-43.0,-49.0,-45.0,-40.0,-82.0,-91.0,-83.0,-89.0,31.0,41.0,33.0,48.0,1
2138,F8:59:71:5A:E0:3D,3500824,816182759,270510,408185648,3230314,407997111,4,269902,366524710,264979,365936610,4923,588100,246052,20,273264,7235,4,849,144444.0,43333.0,-66.0,-73.0,-67.0,-70.0,-66.0,-73.0,-66.0,-70.0,-82.0,-91.0,-83.0,-89.0,16.0,18.0,16.0,19.0,1
2139,CC:2F:71:3E:C5:1F,3241872,409411013,11556,1413700,3230316,407997313,6,49270,4126936,40707,3112348,8563,1014588,12184,36,16559,190,6,857,144444.0,43333.0,-72.0,-81.0,-71.0,-82.0,-70.0,-75.0,-69.0,-68.0,-82.0,-91.0,-83.0,-89.0,10.0,10.0,12.0,7.0,1
2140,CC:2F:71:3F:1F:24,12048282,13932882069,8817964,13524884307,3230318,407997762,158,2005651,1183139263,1996943,1182093081,8708,1046182,1940471,675,8822770,934815,158,6695,130000.0,43333.0,-68.0,-65.0,-73.0,-67.0,-66.0,-65.0,-70.0,-67.0,-82.0,-91.0,-83.0,-89.0,14.0,26.0,10.0,22.0,1
2141,92:69:1D:31:68:E9,3259588,470340178,29264,62341810,3230324,407998368,0,13162,4098464,13032,4077067,130,21397,8438,1,29310,2081,0,149,229410.0,137640.0,-52.0,-52.0,-46.0,-51.0,-50.0,-51.0,-45.0,-50.0,-82.0,-91.0,-83.0,-89.0,30.0,39.0,37.0,38.0,1
2142,BA:8C:B9:54:50:24,3274500,508440803,44176,100442435,3230324,407998368,64,15294,4593619,15152,4570180,142,23439,9485,6,44154,11063,64,236,195000.0,97500.0,-46.0,-49.0,-54.0,-46.0,-49.0,-50.0,-45.0,-47.0,-82.0,-91.0,-83.0,-89.0,36.0,42.0,29.0,43.0,1
2143,62:47:05:9D:EB:15,3246740,447243735,16415,39245307,3230325,407998428,64,7399,1464853,7323,1451990,76,12863,3315,1,16399,2462,64,186,229410.0,137640.0,-43.0,-50.0,-44.0,-45.0,-46.0,-50.0,-46.0,-42.0,-82.0,-91.0,-83.0,-89.0,39.0,41.0,39.0,44.0,1
2144,F8:59:71:5A:E0:3D,3500923,816320828,270598,408322400,3230325,407998428,4,269991,366661770,265068,366073670,4923,588100,246141,20,273352,7238,4,849,144444.0,43333.0,-66.0,-73.0,-66.0,-71.0,-66.0,-72.0,-65.0,-70.0,-82.0,-91.0,-83.0,-89.0,16.0,18.0,17.0,18.0,1
2145,CC:2F:71:3E:C5:1F,3241881,409412128,11556,1413700,3230325,407998428,6,49270,4126936,40707,3112348,8563,1014588,12184,36,16559,190,6,857,144444.0,43333.0,-72.0,-81.0,-71.0,-82.0,-70.0,-75.0,-69.0,-68.0,-82.0,-91.0,-83.0,-89.0,10.0,10.0,12.0,7.0,1
2146,CC:2F:71:3F:1F:24,12049813,13935168217,8819488,13527169789,3230325,407998428,158,2006124,1183460339,1997416,1182414157,8708,1046182,1940925,675,8824321,934843,158,6696,130000.0,43333.0,-67.0,-65.0,-71.0,-68.0,-66.0,-65.0,-70.0,-67.0,-82.0,-91.0,-83.0,-89.0,15.0,26.0,12.0,21.0,1
2147,92:69:1D:31:68:E9,3259594,470340951,29264,62341810,3230330,407999141,0,13162,4098464,13032,4077067,130,21397,8438,1,29310,2081,0,149,229410.0,137640.0,-52.0,-52.0,-46.0,-51.0,-50.0,-51.0,-45.0,-50.0,-81.0,-90.0,-82.0,-88.0,29.0,38.0,36.0,37.0,1
2148,BA:8C:B9:54:50:24,3274508,508441778,44176,100442435,3230332,407999343,64,15298,4593945,15155,4570384,143,23561,9486,6,44154,11063,64,236,195000.0,97500.0,-46.0,-49.0,-53.0,-46.0,-49.0,-50.0,-45.0,-46.0,-81.0,-90.0,-82.0,-88.0,35.0,41.0,29.0,42.0,1
2149,62:47:05:9D:EB:15,3246753,447245990,16421,39246647,3230332,407999343,64,7427,1467117,7351,1454254,76,12863,3319,1,16405,2462,64,187,229410.0,137640.0,-43.0,-51.0,-43.0,-45.0,-45.0,-52.0,-46.0,-45.0,-81.0,-90.0,-82.0,-88.0,38.0,39.0,39.0,43.0,1
2150,F8:59:71:5A:E0:3D,3501015,816450927,270681,408451382,3230334,407999545,4,270073,366788078,265150,366199978,4923,588100,246223,20,273435,7239,4,849,144444.0,43333.0,-66.0,-73.0,-66.0,-70.0,-66.0,-73.0,-65.0,-70.0,-81.0,-90.0,-82.0,-88.0,15.0,17.0,16.0,18.0,1
2151,CC:2F:71:3E:C5:1F,3241892,409413447,11556,1413700,3230336,407999747,6,49270,4126936,40707,3112348,8563,1014588,12184,36,16559,190,6,857,144444.0,43333.0,-72.0,-81.0,-71.0,-82.0,-70.0,-75.0,-69.0,-68.0,-81.0,-90.0,-82.0,-88.0,9.0,9.0,11.0,6.0,1
2152,CC:2F:71:3F:1F:24,12051339,13937484143,8821003,13529484396,3230336,407999747,158,2006545,1183761214,1997837,1182715032,8708,1046182,1941327,675,8825836,934910,158,6696,117000.0,39000.0,-66.0,-65.0,-71.0,-67.0,-66.0,-65.0,-70.0,-67.0,-81.0,-90.0,-82.0,-88.0,15.0,25.0,11.0,21.0,1
2153,92:69:1D:31:68:E9,3259603,470342068,29264,62341810,3230339,408000258,0,13162,4098464,13032,4077067,130,21397,8438,1,29310,2081,0,149,229410.0,137640.0,-52.0,-52.0,-46.0,-51.0,-50.0,-51.0,-45.0,-50.0,-80.0,-90.0,-81.0,-87.0,28.0,38.0,35.0,36.0,1
2154,BA:8C:B9:54:50:24,3274515,508442693,44176,100442435,3230339,408000258,64,15298,4593945,15155,4570384,143,23561,9486,6,44154,11063,64,236,195000.0,97500.0,-46.0,-49.0,-53.0,-46.0,-49.0,-50.0,-45.0,-46.0,-80.0,-90.0,-81.0,-87.0,34.0,41.0,28.0,41.0,1
2155,62:47:05:9D:EB:15,3246760,447246905,16421,39246647,3230339,408000258,64,7427,1467117,7351,1454254,76,12863,3319,1,16405,2462,64,187,229410.0,137640.0,-43.0,-51.0,-43.0,-45.0,-45.0,-52.0,-46.0,-45.0,-80.0,-90.0,-81.0,-87.0,37.0,39.0,38.0,42.0,1
2156,F8:59:71:5A:E0:3D,3501114,816596222,270774,408595904,3230340,408000318,4,270167,366932852,265244,366344752,4923,588100,246316,20,273528,7242,4,849,144444.0,43333.0,-67.0,-73.0,-66.0,-71.0,-66.0,-73.0,-65.0,-70.0,-80.0,-90.0,-81.0,-87.0,13.0,17.0,15.0,16.0,1
2157,CC:2F:71:3E:C5:1F,3241896,409414018,11556,1413700,3230340,408000318,6,49272,4127124,40708,3112418,8564,1014706,12185,36,16559,190,6,858,144444.0,43333.0,-64.0,-69.0,-63.0,-60.0,-67.0,-72.0,-66.0,-64.0,-80.0,-90.0,-81.0,-87.0,16.0,21.0,18.0,27.0,1
2158,CC:2F:71:3F:1F:24,12053891,13941334161,8823551,13533333843,3230340,408000318,158,2007218,1184119324,1998510,1183073142,8708,1046182,1941969,675,8828384,934999,158,6696,130000.0,43333.0,-66.0,-65.0,-71.0,-68.0,-66.0,-65.0,-70.0,-67.0,-80.0,-90.0,-81.0,-87.0,14.0,25.0,10.0,19.0,1
2159,92:69:1D:31:68:E9,3259614,470343385,29264,62341810,3230350,408001575,0,13162,4098464,13032,4077067,130,21397,8438,1,29310,2081,0,149,229410.0,137640.0,-52.0,-52.0,-46.0,-51.0,-50.0,-51.0,-45.0,-50.0,-79.0,-90.0,-80.0,-87.0,27.0,38.0,34.0,36.0,1
2160,BA:8C:B9:54:50:24,3274526,508444010,44176,100442435,3230350,408001575,64,15298,4593945,15155,4570384,143,23561,9486,6,44154,11063,64,236,195000.0,97500.0,-46.0,-49.0,-53.0,-46.0,-49.0,-50.0,-45.0,-46.0,-79.0,-90.0,-80.0,-87.0,33.0,41.0,27.0,41.0,1
2161,62:47:05:9D:EB:15,3246772,447248391,16422,39246816,3230350,408001575,64,7438,1468008,7362,1455145,76,12863,3321,1,16406,2462,64,187,229410.0,137640.0,-52.0,-50.0,-50.0,-41.0,-46.0,-52.0,-47.0,-45.0,-79.0,-90.0,-80.0,-87.0,27.0,40.0,30.0,46.0,1
2162,F8:59:71:5A:E0:3D,3501206,816724907,270856,408723332,3230350,408001575,4,270250,367060672,265327,366472572,4923,588100,246399,20,273610,7242,4,849,144444.0,43333.0,-66.0,-73.0,-66.0,-71.0,-66.0,-72.0,-65.0,-70.0,-79.0,-90.0,-80.0,-87.0,13.0,17.0,14.0,16.0,1
2163,CC:2F:71:3E:C5:1F,3241906,409415275,11556,1413700,3230350,408001575,6,49272,4127124,40708,3112418,8564,1014706,12185,36,16559,190,6,858,144444.0,43333.0,-64.0,-69.0,-63.0,-60.0,-67.0,-72.0,-66.0,-64.0,-79.0,-90.0,-80.0,-87.0,15.0,21.0,17.0,27.0,1
2164,CC:2F:71:3F:1F:24,12055533,13943793968,8825183,13535792393,3230350,408001575,158,2007684,1184410795,1998976,1183364613,8708,1046182,1942431,675,8830016,935133,158,6697,130000.0,43333.0,-66.0,-65.0,-71.0,-68.0,-65.0,-65.0,-70.0,-67.0,-79.0,-90.0,-80.0,-87.0,13.0,25.0,9.0,19.0,1
2165,92:69:1D:31:68:E9,3259783,470768232,29433,62766657,3230350,408001575,0,13187,4107455,13057,4086058,130,21397,8462,1,29479,2094,0,151,229410.0,130000.0,-49.0,-49.0,-45.0,-48.0,-49.0,-49.0,-45.0,-48.0,-78.0,-89.0,-80.0,-87.0,29.0,40.0,35.0,39.0,1
2166,BA:8C:B9:54:50:24,3274526,508444010,44176,100442435,3230350,408001575,64,15298,4593945,15155,4570384,143,23561,9486,6,44154,11063,64,236,195000.0,97500.0,-46.0,-49.0,-53.0,-46.0,-49.0,-50.0,-45.0,-46.0,-78.0,-89.0,-80.0,-87.0,32.0,40.0,27.0,41.0,1
2167,62:47:05:9D:EB:15,3246772,447248391,16422,39246816,3230350,408001575,64,7438,1468008,7362,1455145,76,12863,3321,1,16406,2462,64,187,229410.0,137640.0,-52.0,-50.0,-50.0,-41.0,-46.0,-52.0,-47.0,-45.0,-78.0,-89.0,-80.0,-87.0,26.0,39.0,30.0,46.0,1
2168,F8:59:71:5A:E0:3D,3501287,816850613,270937,408849038,3230350,408001575,4,270330,367183872,265407,366595772,4923,588100,246479,20,273691,7243,4,849,144444.0,43333.0,-66.0,-73.0,-66.0,-70.0,-66.0,-73.0,-65.0,-70.0,-78.0,-89.0,-80.0,-87.0,12.0,16.0,14.0,17.0,1
2169,CC:2F:71:3E:C5:1F,3241910,409415679,11556,1413700,3230354,408001979,6,49272,4127124,40708,3112418,8564,1014706,12185,36,16559,190,6,858,144444.0,43333.0,-64.0,-69.0,-63.0,-60.0,-67.0,-72.0,-66.0,-64.0,-78.0,-89.0,-80.0,-87.0,14.0,20.0,17.0,27.0,1
2170,CC:2F:71:3F:1F:24,12057137,13946250724,8826783,13538248745,3230354,408001979,158,2008058,1184692847,1999350,1183646665,8708,1046182,1942796,675,8831615,935202,158,6697,130000.0,43333.0,-67.0,-65.0,-70.0,-67.0,-66.0,-65.0,-70.0,-67.0,-78.0,-89.0,-80.0,-87.0,11.0,24.0,10.0,20.0,1
2171,92:69:1D:31:68:E9,3259792,470769100,29433,62766657,3230359,408002443,0,13189,4107591,13059,4086194,130,21397,8462,1,29479,2094,0,151,229410.0,130000.0,-52.0,-52.0,-51.0,-55.0,-49.0,-50.0,-45.0,-49.0,-78.0,-89.0,-80.0,-87.0,26.0,37.0,29.0,32.0,1
2172,BA:8C:B9:54:50:24,3274591,508523100,44232,100520657,3230359,408002443,64,15344,4616922,15201,4593361,143,23561,9517,6,44210,11063,64,236,206470.0,103230.0,-51.0,-52.0,-44.0,-49.0,-48.0,-49.0,-41.0,-46.0,-78.0,-90.0,-79.0,-87.0,27.0,38.0,35.0,38.0,1
2173,62:47:05:9D:EB:15,3246781,447249259,16422,39246816,3230359,408002443,64,7438,1468008,7362,1455145,76,12863,3321,1,16406,2462,64,187,229410.0,137640.0,-52.0,-50.0,-50.0,-41.0,-46.0,-52.0,-47.0,-45.0,-78.0,-90.0,-79.0,-87.0,26.0,40.0,29.0,46.0,1
2174,F8:59:71:5A:E0:3D,3501378,816978909,271019,408976466,3230359,408002443,4,270412,367310152,265489,366722052,4923,588100,246561,20,273773,7245,4,849,144444.0,43333.0,-67.0,-73.0,-66.0,-70.0,-66.0,-73.0,-65.0,-70.0,-78.0,-90.0,-79.0,-87.0,11.0,17.0,13.0,17.0,1
2175,CC:2F:71:3E:C5:1F,3241915,409416143,11556,1413700,3230359,408002443,6,49272,4127124,40708,3112418,8564,1014706,12185,36,16559,190,6,858,144444.0,43333.0,-64.0,-69.0,-63.0,-60.0,-67.0,-72.0,-66.0,-64.0,-78.0,-90.0,-79.0,-87.0,14.0,21.0,16.0,27.0,1
2176,CC:2F:71:3F:1F:24,12058575,13948430713,8828216,13540428270,3230359,408002443,158,2008482,1184988637,1999774,1183942455,8708,1046182,1943207,675,8833027,935236,158,6698,130000.0,43333.0,-66.0,-65.0,-71.0,-68.0,-66.0,-64.0,-70.0,-67.0,-78.0,-90.0,-79.0,-87.0,12.0,25.0,8.0,19.0,1
2177,92:69:1D:31:68:E9,3259797,470769777,29433,62766657,3230364,408003120,0,13189,4107591,13059,4086194,130,21397,8462,1,29479,2094,0,151,229410.0,130000.0,-52.0,-52.0,-51.0,-55.0,-49.0,-50.0,-45.0,-49.0,-78.0,-90.0,-79.0,-87.0,26.0,38.0,28.0,32.0,1
2178,BA:8C:B9:54:50:24,3275030,509600488,44662,101596964,3230368,408003524,64,15441,4634051,15298,4610490,143,23561,9583,6,44640,11089,64,237,229410.0,137640.0,-46.0,-50.0,-53.0,-46.0,-50.0,-51.0,-45.0,-47.0,-78.0,-90.0,-79.0,-87.0,32.0,40.0,26.0,41.0,1
2179,62:47:05:9D:EB:15,3247257,448486138,16888,40482552,3230369,408003586,64,7514,1479584,7437,1466599,77,12985,3366,1,16872,2462,64,187,229410.0,137640.0,-46.0,-52.0,-47.0,-45.0,-42.0,-49.0,-43.0,-41.0,-78.0,-90.0,-79.0,-87.0,32.0,38.0,32.0,42.0,1
2180,F8:59:71:5A:E0:3D,3501496,817147884,271127,409144298,3230369,408003586,4,270520,367476472,265597,366888372,4923,588100,246669,20,273881,7250,4,849,144444.0,43333.0,-67.0,-74.0,-66.0,-71.0,-67.0,-73.0,-66.0,-70.0,-78.0,-90.0,-79.0,-87.0,11.0,16.0,13.0,16.0,1
2181,CC:2F:71:3E:C5:1F,3241926,409417346,11556,1413700,3230370,408003646,6,49272,4127124,40708,3112418,8564,1014706,12185,36,16559,190,6,858,144444.0,43333.0,-64.0,-69.0,-63.0,-60.0,-67.0,-72.0,-66.0,-64.0,-78.0,-90.0,-79.0,-87.0,14.0,21.0,16.0,27.0,1
2182,CC:2F:71:3F:1F:24,12059548,13949860670,8829178,13541857024,3230370,408003646,158,2008925,1185396643,2000217,1184350461,8708,1046182,1943622,675,8834011,935270,158,6698,130000.0,43333.0,-67.0,-65.0,-73.0,-68.0,-67.0,-65.0,-72.0,-67.0,-78.0,-90.0,-79.0,-87.0,11.0,25.0,6.0,19.0,1
2183,92:69:1D:31:68:E9,3259804,470770365,29433,62766657,3230371,408003708,0,13192,4107849,13061,4086330,131,21519,8463,1,29479,2094,0,151,229410.0,130000.0,-52.0,-51.0,-45.0,-50.0,-50.0,-50.0,-45.0,-49.0,-78.0,-90.0,-79.0,-87.0,26.0,39.0,34.0,37.0,1
2184,BA:8C:B9:54:50:24,3275033,509600672,44662,101596964,3230371,408003708,64,15445,4634439,15302,4610878,143,23561,9584,6,44640,11089,64,237,229410.0,137640.0,-52.0,-51.0,-38.0,-46.0,-49.0,-50.0,-45.0,-47.0,-78.0,-90.0,-79.0,-87.0,26.0,39.0,41.0,41.0,1
2185,62:47:05:9D:EB:15,3247261,448486462,16888,40482552,3230373,408003910,64,7515,1479652,7438,1466667,77,12985,3366,1,16872,2462,64,187,229410.0,137640.0,-51.0,-50.0,-50.0,-41.0,-43.0,-49.0,-44.0,-41.0,-78.0,-90.0,-79.0,-87.0,27.0,40.0,29.0,46.0,1
2186,F8:59:71:5A:E0:3D,3501598,817294713,271222,409290490,3230376,408004223,4,270616,367622878,265693,367034778,4923,588100,246765,20,273976,7251,4,849,144444.0,43333.0,-67.0,-73.0,-66.0,-71.0,-67.0,-73.0,-66.0,-71.0,-78.0,-90.0,-79.0,-87.0,11.0,17.0,13.0,16.0,1
2187,CC:2F:71:3E:C5:1F,3241932,409417923,11556,1413700,3230376,408004223,6,49272,4127124,40708,3112418,8564,1014706,12185,36,16559,190,6,858,144444.0,43333.0,-64.0,-69.0,-63.0,-60.0,-67.0,-72.0,-66.0,-64.0,-78.0,-90.0,-79.0,-87.0,14.0,21.0,16.0,27.0,1
2188,CC:2F:71:3F:1F:24,12060621,13951469964,8830241,13543465294,3230380,408004670,158,2009256,1185700605,2000548,1184654423,8708,1046182,1943945,675,8835073,935282,158,6698,130000.0,43333.0,-67.0,-65.0,-73.0,-67.0,-67.0,-65.0,-73.0,-67.0,-78.0,-90.0,-79.0,-87.0,11.0,25.0,6.0,20.0,1
2189,92:69:1D:31:68:E9,3259814,470771395,29433,62766657,3230381,408004738,0,13195,4108156,13063,4086466,132,21690,8464,1,29479,2094,0,152,229410.0,130000.0,-52.0,-53.0,-51.0,-55.0,-51.0,-51.0,-46.0,-50.0,-78.0,-89.0,-79.0,-86.0,26.0,36.0,28.0,31.0,1
2190,BA:8C:B9:54:50:24,3275302,509969894,44921,101965156,3230381,408004738,64,15654,4695937,15510,4672205,144,23732,9728,6,44899,11114,64,237,229410.0,137640.0,-51.0,-52.0,-44.0,-49.0,-49.0,-51.0,-42.0,-48.0,-78.0,-89.0,-79.0,-86.0,27.0,37.0,35.0,37.0,1
2191,62:47:05:9D:EB:15,3247269,448487290,16888,40482552,3230381,408004738,64,7515,1479652,7438,1466667,77,12985,3366,1,16872,2462,64,187,229410.0,137640.0,-51.0,-50.0,-50.0,-41.0,-43.0,-49.0,-44.0,-41.0,-78.0,-89.0,-79.0,-86.0,27.0,39.0,29.0,45.0,1
2192,F8:59:71:5A:E0:3D,3501694,817436642,271313,409431904,3230381,408004738,4,270706,367761506,265783,367173406,4923,588100,246855,20,274067,7251,4,849,144444.0,43333.0,-67.0,-73.0,-66.0,-71.0,-67.0,-73.0,-66.0,-70.0,-78.0,-89.0,-79.0,-86.0,11.0,16.0,13.0,15.0,1
2193,CC:2F:71:3E:C5:1F,3241940,409418866,11556,1413700,3230384,408005166,6,49272,4127124,40708,3112418,8564,1014706,12185,36,16559,190,6,858,144444.0,43333.0,-64.0,-69.0,-63.0,-60.0,-67.0,-72.0,-66.0,-64.0,-78.0,-89.0,-79.0,-86.0,14.0,20.0,16.0,26.0,1
2194,CC:2F:71:3F:1F:24,12061809,13953267948,8831425,13545262782,3230384,408005166,158,2009617,1186028181,2000909,1184981999,8708,1046182,1944296,675,8836258,935399,158,6698,130000.0,43333.0,-67.0,-65.0,-73.0,-68.0,-67.0,-65.0,-72.0,-67.0,-78.0,-89.0,-79.0,-86.0,11.0,24.0,6.0,18.0,1
2195,92:69:1D:31:68:E9,3259825,470772631,29433,62766657,3230392,408005974,0,13195,4108156,13063,4086466,132,21690,8464,1,29479,2094,0,152,229410.0,130000.0,-52.0,-53.0,-51.0,-55.0,-51.0,-51.0,-46.0,-50.0,-78.0,-89.0,-79.0,-86.0,26.0,36.0,28.0,31.0,1
2196,BA:8C:B9:54:50:24,3275313,509971130,44921,101965156,3230392,408005974,64,15659,4696393,15515,4672661,144,23732,9729,6,44899,11114,64,237,229410.0,137640.0,-46.0,-49.0,-53.0,-45.0,-49.0,-51.0,-45.0,-47.0,-78.0,-89.0,-79.0,-86.0,32.0,40.0,26.0,41.0,1
2197,62:47:05:9D:EB:15,3247280,448488526,16888,40482552,3230392,408005974,64,7515,1479652,7438,1466667,77,12985,3366,1,16872,2462,64,187,229410.0,137640.0,-51.0,-50.0,-50.0,-41.0,-43.0,-49.0,-44.0,-41.0,-78.0,-89.0,-79.0,-86.0,27.0,39.0,29.0,45.0,1
2198,F8:59:71:5A:E0:3D,3501807,817596386,271415,409590412,3230392,408005974,4,270809,367920252,265886,367332152,4923,588100,246958,20,274169,7259,4,849,144444.0,43333.0,-67.0,-73.0,-66.0,-71.0,-67.0,-73.0,-66.0,-70.0,-78.0,-89.0,-79.0,-86.0,11.0,16.0,13.0,15.0,1
2199,CC:2F:71:3E:C5:1F,3241948,409419674,11556,1413700,3230392,408005974,6,49272,4127124,40708,3112418,8564,1014706,12185,36,16559,190,6,858,144444.0,43333.0,-64.0,-69.0,-63.0,-60.0,-67.0,-72.0,-66.0,-64.0,-78.0,-89.0,-79.0,-86.0,14.0,20.0,16.0,26.0,1
2200,CC:2F:71:3F:1F:24,12063368,13955548159,8832976,13547542185,3230392,408005974,158,2010141,1186372431,2001433,1185326249,8708,1046182,1944812,675,8837809,935456,158,6698,130000.0,43333.0,-67.0,-65.0,-73.0,-67.0,-67.0,-64.0,-72.0,-67.0,-78.0,-89.0,-79.0,-86.0,11.0,24.0,6.0,19.0,1
2201,92:69:1D:31:68:E9,3259826,470772761,29434,62766787,3230392,408005974,0,13200,4108548,13068,4086858,132,21690,8465,1,29480,2094,0,152,229410.0,130000.0,-52.0,-51.0,-45.0,-51.0,-51.0,-51.0,-47.0,-51.0,-78.0,-90.0,-80.0,-87.0,26.0,39.0,35.0,36.0,1
2202,BA:8C:B9:54:50:24,3275333,509980108,44939,101973932,3230394,408006176,64,15679,4702758,15535,4679026,144,23732,9741,6,44917,11116,64,238,229410.0,137640.0,-51.0,-53.0,-43.0,-49.0,-49.0,-50.0,-41.0,-46.0,-78.0,-90.0,-80.0,-87.0,27.0,37.0,37.0,38.0,1
2203,62:47:05:9D:EB:15,3247288,448489862,16892,40483484,3230396,408006378,64,7538,1481727,7461,1468742,77,12985,3371,1,16876,2462,64,188,229410.0,137640.0,-43.0,-51.0,-43.0,-45.0,-47.0,-51.0,-47.0,-44.0,-78.0,-90.0,-80.0,-87.0,35.0,39.0,37.0,42.0,1
2204,F8:59:71:5A:E0:3D,3501898,817730494,271501,409724056,3230397,408006438,4,270895,368052734,265972,367464634,4923,588100,247044,20,274255,7260,4,849,144444.0,43333.0,-67.0,-73.0,-66.0,-71.0,-67.0,-73.0,-66.0,-71.0,-78.0,-90.0,-80.0,-87.0,11.0,17.0,14.0,16.0,1
2205,CC:2F:71:3E:C5:1F,3241953,409420138,11556,1413700,3230397,408006438,6,49272,4127124,40708,3112418,8564,1014706,12185,36,16559,190,6,858,144444.0,43333.0,-64.0,-69.0,-63.0,-60.0,-67.0,-72.0,-66.0,-64.0,-78.0,-90.0,-80.0,-87.0,14.0,21.0,17.0,27.0,1
2206,CC:2F:71:3F:1F:24,12065214,13958299091,8834817,13550292653,3230397,408006438,158,2010667,1186690166,2001959,1185643984,8708,1046182,1945330,675,8839650,935572,158,6698,130000.0,39000.0,-68.0,-65.0,-73.0,-68.0,-67.0,-65.0,-73.0,-67.0,-78.0,-90.0,-80.0,-87.0,10.0,25.0,7.0,19.0,1
2207,92:69:1D:31:68:E9,3259869,470844463,29464,62837174,3230405,408007289,0,13227,4110871,13095,4089181,132,21690,8471,1,29510,2094,0,154,229410.0,137640.0,-52.0,-52.0,-45.0,-51.0,-51.0,-50.0,-45.0,-50.0,-78.0,-90.0,-80.0,-87.0,26.0,38.0,35.0,36.0,1
2208,BA:8C:B9:54:50:24,3275748,510492643,45343,102485354,3230405,408007289,64,15781,4735249,15637,4711517,144,23732,9805,6,45321,11116,64,241,229410.0,137640.0,-51.0,-51.0,-45.0,-49.0,-51.0,-51.0,-44.0,-49.0,-78.0,-90.0,-80.0,-87.0,27.0,39.0,35.0,38.0,1
2209,62:47:05:9D:EB:15,3247298,448490841,16892,40483484,3230406,408007357,64,7541,1482034,7463,1468878,78,13156,3372,1,16876,2462,64,188,229410.0,137640.0,-52.0,-50.0,-49.0,-41.0,-46.0,-51.0,-46.0,-44.0,-78.0,-90.0,-80.0,-87.0,26.0,40.0,31.0,46.0,1
2210,F8:59:71:5A:E0:3D,3502055,817961405,271649,409954048,3230406,408007357,4,271046,368285834,266123,367697734,4923,588100,247177,20,274403,7263,4,850,144444.0,43333.0,-67.0,-73.0,-66.0,-71.0,-67.0,-73.0,-66.0,-71.0,-78.0,-90.0,-80.0,-87.0,11.0,17.0,14.0,16.0,1
2211,CC:2F:71:3E:C5:1F,3241962,409421057,11556,1413700,3230406,408007357,6,49272,4127124,40708,3112418,8564,1014706,12185,36,16559,190,6,858,144444.0,43333.0,-64.0,-69.0,-63.0,-60.0,-67.0,-72.0,-66.0,-64.0,-78.0,-90.0,-80.0,-87.0,14.0,21.0,17.0,27.0,1
2212,CC:2F:71:3F:1F:24,12067096,13961100468,8836686,13553092707,3230410,408007761,158,2011290,1187207187,2002582,1186161005,8708,1046182,1945934,675,8841519,935660,158,6698,130000.0,43333.0,-68.0,-65.0,-73.0,-68.0,-67.0,-65.0,-73.0,-68.0,-78.0,-90.0,-80.0,-87.0,10.0,25.0,7.0,19.0,1
2213,92:69:1D:31:68:E9,3259884,470846579,29473,62838758,3230411,408007821,0,13241,4112351,13109,4090661,132,21690,8478,1,29519,2094,0,154,229410.0,137640.0,-49.0,-50.0,-46.0,-49.0,-50.0,-50.0,-45.0,-49.0,-78.0,-90.0,-80.0,-87.0,29.0,40.0,34.0,38.0,1
2214,BA:8C:B9:54:50:24,3275758,510493792,45347,102485971,3230411,408007821,64,15800,4737233,15656,4713501,144,23732,9809,6,45325,11116,64,241,229410.0,137640.0,-46.0,-50.0,-53.0,-46.0,-49.0,-49.0,-42.0,-46.0,-78.0,-90.0,-80.0,-87.0,32.0,40.0,27.0,41.0,1
2215,62:47:05:9D:EB:15,3247303,448491305,16892,40483484,3230411,408007821,64,7541,1482034,7463,1468878,78,13156,3372,1,16876,2462,64,188,229410.0,137640.0,-52.0,-50.0,-49.0,-41.0,-46.0,-51.0,-46.0,-44.0,-78.0,-90.0,-80.0,-87.0,26.0,40.0,31.0,46.0,1
2216,F8:59:71:5A:E0:3D,3502150,818101729,271739,410093908,3230411,408007821,4,271137,368425988,266214,367837888,4923,588100,247267,20,274493,7264,4,850,144444.0,43333.0,-67.0,-73.0,-67.0,-71.0,-67.0,-73.0,-66.0,-71.0,-78.0,-90.0,-80.0,-87.0,11.0,17.0,13.0,16.0,1
2217,CC:2F:71:3E:C5:1F,3241967,409421521,11556,1413700,3230411,408007821,6,49272,4127124,40708,3112418,8564,1014706,12185,36,16559,190,6,858,144444.0,43333.0,-64.0,-69.0,-63.0,-60.0,-67.0,-72.0,-66.0,-64.0,-78.0,-90.0,-80.0,-87.0,14.0,21.0,17.0,27.0,1
2218,CC:2F:71:3F:1F:24,12069529,13964803831,8839116,13556795808,3230413,408008023,158,2011859,1187549240,2003151,1186503058,8708,1046182,1946485,675,8843949,935698,158,6698,130000.0,43333.0,-68.0,-65.0,-73.0,-67.0,-67.0,-65.0,-72.0,-67.0,-78.0,-90.0,-80.0,-87.0,10.0,25.0,7.0,20.0,1
2219,92:69:1D:31:68:E9,3259892,470847387,29473,62838758,3230419,408008629,0,13242,4112419,13110,4090729,132,21690,8478,1,29519,2094,0,154,229410.0,137640.0,-52.0,-51.0,-45.0,-50.0,-50.0,-50.0,-45.0,-49.0,-78.0,-90.0,-80.0,-87.0,26.0,39.0,35.0,37.0,1
2220,BA:8C:B9:54:50:24,3275766,510494600,45347,102485971,3230419,408008629,64,15800,4737233,15656,4713501,144,23732,9809,6,45325,11116,64,241,229410.0,137640.0,-46.0,-50.0,-53.0,-46.0,-49.0,-49.0,-42.0,-46.0,-78.0,-90.0,-80.0,-87.0,32.0,40.0,27.0,41.0,1
2221,62:47:05:9D:EB:15,3247311,448492113,16892,40483484,3230419,408008629,64,7541,1482034,7463,1468878,78,13156,3372,1,16876,2462,64,188,229410.0,137640.0,-52.0,-50.0,-49.0,-41.0,-46.0,-51.0,-46.0,-44.0,-78.0,-90.0,-80.0,-87.0,26.0,40.0,31.0,46.0,1
2222,F8:59:71:5A:E0:3D,3502249,818243951,271830,410235322,3230419,408008629,4,271228,368566212,266305,367978112,4923,588100,247358,20,274584,7269,4,850,144444.0,43333.0,-67.0,-73.0,-66.0,-70.0,-67.0,-73.0,-66.0,-70.0,-78.0,-90.0,-80.0,-87.0,11.0,17.0,14.0,17.0,1
2223,CC:2F:71:3E:C5:1F,3241975,409422329,11556,1413700,3230419,408008629,6,49272,4127124,40708,3112418,8564,1014706,12185,36,16559,190,6,858,144444.0,43333.0,-64.0,-69.0,-63.0,-60.0,-67.0,-72.0,-66.0,-64.0,-78.0,-90.0,-80.0,-87.0,14.0,21.0,17.0,27.0,1
2224,CC:2F:71:3F:1F:24,12071207,13967269174,8840788,13559260545,3230419,408008629,158,2012405,1187890370,2003697,1186844188,8708,1046182,1947014,675,8845621,935804,158,6698,130000.0,43333.0,-68.0,-65.0,-72.0,-68.0,-67.0,-65.0,-72.0,-67.0,-78.0,-90.0,-80.0,-87.0,10.0,25.0,8.0,19.0,1
2225,92:69:1D:31:68:E9,3260053,471257530,29631,63248639,3230422,408008891,0,13269,4118920,13137,4097230,132,21690,8496,1,29677,2094,0,154,229410.0,137640.0,-52.0,-51.0,-45.0,-51.0,-49.0,-50.0,-45.0,-48.0,-78.0,-90.0,-80.0,-87.0,26.0,39.0,35.0,36.0,1
2226,BA:8C:B9:54:50:24,3275769,510494862,45347,102485971,3230422,408008891,64,15800,4737233,15656,4713501,144,23732,9809,6,45325,11116,64,241,229410.0,137640.0,-46.0,-50.0,-53.0,-46.0,-49.0,-49.0,-42.0,-46.0,-78.0,-90.0,-80.0,-87.0,32.0,40.0,27.0,41.0,1
2227,62:47:05:9D:EB:15,3247315,448492550,16892,40483484,3230423,408009066,64,7541,1482034,7463,1468878,78,13156,3372,1,16876,2462,64,188,229410.0,137640.0,-52.0,-50.0,-49.0,-41.0,-46.0,-51.0,-46.0,-44.0,-78.0,-90.0,-80.0,-87.0,26.0,40.0,31.0,46.0,1
2228,F8:59:71:5A:E0:3D,3502345,818384338,271920,410375070,3230425,408009268,4,271318,368704812,266395,368116712,4923,588100,247448,20,274674,7274,4,850,144444.0,43333.0,-67.0,-73.0,-67.0,-71.0,-67.0,-73.0,-66.0,-70.0,-78.0,-90.0,-80.0,-87.0,11.0,17.0,13.0,16.0,1
2229,CC:2F:71:3E:C5:1F,3241981,409422968,11556,1413700,3230425,408009268,6,49272,4127124,40708,3112418,8564,1014706,12185,36,16559,190,6,858,144444.0,43333.0,-64.0,-69.0,-63.0,-60.0,-67.0,-72.0,-66.0,-64.0,-78.0,-90.0,-80.0,-87.0,14.0,21.0,17.0,27.0,1
2230,CC:2F:71:3F:1F:24,12073241,13970314695,8842814,13562305225,3230427,408009470,158,2012942,1188213668,2004234,1187167486,8708,1046182,1947535,675,8847633,935887,158,6698,130000.0,43333.0,-68.0,-65.0,-73.0,-68.0,-68.0,-65.0,-72.0,-68.0,-78.0,-90.0,-80.0,-87.0,10.0,25.0,7.0,19.0,1
2231,92:69:1D:31:68:E9,3260062,471258700,29632,63248755,3230430,408009945,0,13272,4119162,13140,4097472,132,21690,8497,1,29678,2094,0,154,229410.0,137640.0,-52.0,-51.0,-45.0,-51.0,-50.0,-50.0,-45.0,-49.0,-78.0,-90.0,-80.0,-87.0,26.0,39.0,35.0,36.0,1
2232,BA:8C:B9:54:50:24,3275786,510497921,45356,102487976,3230430,408009945,64,15822,4742721,15677,4718754,145,23967,9819,6,45334,11128,64,241,229410.0,137640.0,-53.0,-51.0,-38.0,-46.0,-50.0,-50.0,-42.0,-47.0,-78.0,-90.0,-80.0,-87.0,25.0,39.0,42.0,41.0,1
2233,62:47:05:9D:EB:15,3247322,448493429,16892,40483484,3230430,408009945,64,7541,1482034,7463,1468878,78,13156,3372,1,16876,2462,64,188,229410.0,137640.0,-52.0,-50.0,-49.0,-41.0,-46.0,-51.0,-46.0,-44.0,-78.0,-90.0,-80.0,-87.0,26.0,40.0,31.0,46.0,1
2234,F8:59:71:5A:E0:3D,3502430,818509335,272000,410499390,3230430,408009945,4,271398,368828012,266475,368239912,4923,588100,247528,20,274754,7275,4,850,144444.0,43333.0,-67.0,-73.0,-66.0,-71.0,-67.0,-73.0,-66.0,-70.0,-78.0,-90.0,-80.0,-87.0,11.0,17.0,14.0,16.0,1
2235,CC:2F:71:3E:C5:1F,3241986,409423645,11556,1413700,3230430,408009945,6,49272,4127124,40708,3112418,8564,1014706,12185,36,16559,190,6,858,144444.0,43333.0,-64.0,-69.0,-63.0,-60.0,-67.0,-72.0,-66.0,-64.0,-78.0,-90.0,-80.0,-87.0,14.0,21.0,17.0,27.0,1
2236,CC:2F:71:3F:1F:24,12074442,13972116850,8844012,13564106905,3230430,408009945,158,2013339,1188497090,2004631,1187450908,8708,1046182,1947922,675,8848845,935910,158,6700,130000.0,43333.0,-67.0,-65.0,-73.0,-68.0,-67.0,-65.0,-73.0,-68.0,-78.0,-90.0,-80.0,-87.0,11.0,25.0,7.0,19.0,1
2237,92:69:1D:31:68:E9,3260067,471259164,29632,63248755,3230435,408010409,0,13272,4119162,13140,4097472,132,21690,8497,1,29678,2094,0,154,229410.0,137640.0,-52.0,-51.0,-45.0,-51.0,-50.0,-50.0,-45.0,-49.0,-78.0,-90.0,-80.0,-87.0,26.0,39.0,35.0,36.0,1
2238,BA:8C:B9:54:50:24,3275793,510498587,45356,102487976,3230437,408010611,64,15822,4742721,15677,4718754,145,23967,9819,6,45334,11128,64,241,229410.0,137640.0,-53.0,-51.0,-38.0,-46.0,-50.0,-50.0,-42.0,-47.0,-78.0,-90.0,-80.0,-87.0,25.0,39.0,42.0,41.0,1
2239,62:47:05:9D:EB:15,3247329,448494095,16892,40483484,3230437,408010611,64,7541,1482034,7463,1468878,78,13156,3372,1,16876,2462,64,188,229410.0,137640.0,-52.0,-50.0,-49.0,-41.0,-46.0,-51.0,-46.0,-44.0,-78.0,-90.0,-80.0,-87.0,26.0,40.0,31.0,46.0,1
2240,F8:59:71:5A:E0:3D,3502527,818646955,272088,410636142,3230439,408010813,4,271486,368963532,266563,368375432,4923,588100,247616,20,274842,7275,4,850,144444.0,43333.0,-67.0,-74.0,-66.0,-71.0,-67.0,-73.0,-66.0,-70.0,-78.0,-90.0,-80.0,-87.0,11.0,16.0,14.0,16.0,1
2241,CC:2F:71:3E:C5:1F,3241995,409424513,11556,1413700,3230439,408010813,6,49272,4127124,40708,3112418,8564,1014706,12185,36,16559,190,6,858,144444.0,43333.0,-64.0,-69.0,-63.0,-60.0,-67.0,-72.0,-66.0,-64.0,-78.0,-90.0,-80.0,-87.0,14.0,21.0,17.0,27.0,1
2242,CC:2F:71:3F:1F:24,12075576,13973810275,8845137,13565799462,3230439,408010813,158,2013668,1188803746,2004960,1187757564,8708,1046182,1948236,675,8849968,935934,158,6700,130000.0,43333.0,-68.0,-65.0,-72.0,-68.0,-67.0,-65.0,-72.0,-68.0,-78.0,-90.0,-80.0,-87.0,10.0,25.0,8.0,19.0,1
2243,92:69:1D:31:68:E9,3260072,471259684,29633,63248871,3230439,408010813,0,13273,4119230,13141,4097540,132,21690,8497,1,29679,2094,0,155,229410.0,137640.0,-52.0,-52.0,-45.0,-51.0,-50.0,-50.0,-45.0,-50.0,-78.0,-90.0,-80.0,-87.0,26.0,38.0,35.0,36.0,1
2244,BA:8C:B9:54:50:24,3275796,510498905,45357,102488092,3230439,408010813,64,15827,4743061,15682,4719094,145,23967,9819,6,45335,11128,64,241,229410.0,137640.0,-46.0,-50.0,-54.0,-46.0,-47.0,-48.0,-42.0,-45.0,-78.0,-90.0,-80.0,-87.0,32.0,40.0,26.0,41.0,1
2245,62:47:05:9D:EB:15,3247334,448494615,16893,40483600,3230441,408011015,64,7542,1482102,7464,1468946,78,13156,3372,1,16877,2462,64,188,216660.0,130000.0,-43.0,-50.0,-44.0,-45.0,-45.0,-51.0,-46.0,-44.0,-78.0,-90.0,-80.0,-87.0,35.0,40.0,36.0,42.0,1
2246,F8:59:71:5A:E0:3D,3502611,818773147,272170,410762132,3230441,408011015,4,271569,369091366,266646,368503266,4923,588100,247698,20,274924,7276,4,850,144444.0,43333.0,-68.0,-74.0,-67.0,-71.0,-67.0,-73.0,-66.0,-71.0,-78.0,-90.0,-80.0,-87.0,10.0,16.0,13.0,16.0,1
2247,CC:2F:71:3E:C5:1F,3241998,409424775,11557,1413760,3230441,408011015,6,49274,4127264,40710,3112558,8564,1014706,12185,36,16560,190,6,858,130000.0,39000.0,-65.0,-64.0,-67.0,-59.0,-68.0,-72.0,-67.0,-63.0,-78.0,-90.0,-80.0,-87.0,13.0,26.0,13.0,28.0,1
2248,CC:2F:71:3F:1F:24,12077077,13976102337,8846635,13568091260,3230442,408011077,158,2014083,1189125106,2005375,1188078924,8708,1046182,1948636,675,8851443,935969,158,6700,130000.0,43333.0,-68.0,-65.0,-73.0,-68.0,-67.0,-65.0,-72.0,-68.0,-78.0,-90.0,-80.0,-87.0,10.0,25.0,7.0,19.0,1
2249,92:69:1D:31:68:E9,3260085,471261864,29633,63248871,3230452,408012993,0,13280,4119706,13148,4098016,132,21690,8497,1,29679,2094,0,155,229410.0,137640.0,-53.0,-51.0,-45.0,-51.0,-50.0,-50.0,-45.0,-49.0,-78.0,-90.0,-80.0,-87.0,25.0,39.0,35.0,36.0,1
2250,BA:8C:B9:54:50:24,3275812,510501697,45360,102488704,3230452,408012993,64,15837,4746301,15692,4722334,145,23967,9822,6,45338,11129,64,241,229410.0,137640.0,-53.0,-51.0,-38.0,-46.0,-51.0,-51.0,-43.0,-49.0,-79.0,-90.0,-80.0,-87.0,26.0,39.0,42.0,41.0,1
2251,62:47:05:9D:EB:15,3247606,449184746,17154,41171753,3230452,408012993,64,7591,1490999,7512,1477721,79,13278,3405,1,17138,2486,64,188,216660.0,130000.0,-43.0,-51.0,-44.0,-44.0,-45.0,-52.0,-46.0,-45.0,-79.0,-90.0,-80.0,-87.0,36.0,39.0,36.0,43.0,1
2252,F8:59:71:5A:E0:3D,3502720,818925979,272268,410912986,3230452,408012993,4,271664,369236316,266741,368648216,4923,588100,247791,20,275022,7276,4,850,144444.0,43333.0,-68.0,-73.0,-66.0,-71.0,-67.0,-73.0,-66.0,-70.0,-79.0,-90.0,-80.0,-87.0,11.0,17.0,14.0,16.0,1
2253,CC:2F:71:3E:C5:1F,3242009,409426753,11557,1413760,3230452,408012993,6,49274,4127264,40710,3112558,8564,1014706,12185,36,16560,190,6,858,130000.0,39000.0,-65.0,-64.0,-67.0,-59.0,-68.0,-72.0,-67.0,-63.0,-79.0,-90.0,-80.0,-87.0,14.0,26.0,13.0,28.0,1
2254,CC:2F:71:3F:1F:24,12078410,13978112648,8847958,13570099655,3230452,408012993,158,2014427,1189415773,2005719,1188369591,8708,1046182,1948977,675,8852790,936099,158,6701,130000.0,43333.0,-67.0,-65.0,-73.0,-68.0,-67.0,-65.0,-72.0,-67.0,-79.0,-90.0,-80.0,-87.0,12.0,25.0,7.0,19.0,1
2255,92:69:1D:31:68:E9,3260093,471263708,29635,63249187,3230458,408014521,0,13286,4120218,13154,4098528,132,21690,8499,1,29681,2094,0,155,229410.0,137640.0,-52.0,-52.0,-45.0,-51.0,-50.0,-50.0,-45.0,-49.0,-79.0,-90.0,-80.0,-87.0,27.0,38.0,35.0,36.0,1
2256,BA:8C:B9:54:50:24,3276176,511426611,45716,103411888,3230460,408014723,64,15894,4759764,15749,4735797,145,23967,9866,6,45694,11134,64,241,229410.0,137640.0,-51.0,-51.0,-44.0,-49.0,-51.0,-51.0,-44.0,-49.0,-79.0,-91.0,-81.0,-88.0,28.0,40.0,37.0,39.0,1
2257,62:47:05:9D:EB:15,3247626,449190907,17166,41176184,3230460,408014723,64,7624,1495920,7545,1482642,79,13278,3422,1,17150,2487,64,188,229410.0,130000.0,-46.0,-53.0,-48.0,-46.0,-46.0,-52.0,-47.0,-45.0,-79.0,-91.0,-81.0,-88.0,33.0,38.0,33.0,42.0,1
2258,F8:59:71:5A:E0:3D,3502825,819075485,272363,411060560,3230462,408014925,4,271764,369390330,266841,368802230,4923,588100,247890,20,275117,7280,4,850,130000.0,39000.0,-68.0,-73.0,-66.0,-70.0,-67.0,-73.0,-66.0,-70.0,-79.0,-91.0,-81.0,-88.0,11.0,18.0,15.0,18.0,1
2259,CC:2F:71:3E:C5:1F,3242019,409428685,11557,1413760,3230462,408014925,6,49274,4127264,40710,3112558,8564,1014706,12185,36,16560,190,6,858,130000.0,39000.0,-65.0,-64.0,-67.0,-59.0,-68.0,-72.0,-67.0,-63.0,-79.0,-91.0,-81.0,-88.0,14.0,27.0,14.0,29.0,1
2260,CC:2F:71:3F:1F:24,12079776,13980183700,8849314,13572168775,3230462,408014925,158,2014783,1189729703,2006075,1188683521,8708,1046182,1949333,675,8854112,936131,158,6702,130000.0,43333.0,-68.0,-65.0,-72.0,-68.0,-67.0,-65.0,-73.0,-68.0,-79.0,-91.0,-81.0,-88.0,11.0,26.0,9.0,20.0,1
2261,92:69:1D:31:68:E9,3260098,471264172,29635,63249187,3230463,408014985,0,13286,4120218,13154,4098528,132,21690,8499,1,29681,2094,0,155,229410.0,137640.0,-52.0,-52.0,-45.0,-51.0,-50.0,-50.0,-45.0,-49.0,-79.0,-91.0,-81.0,-88.0,27.0,39.0,36.0,37.0,1
2262,BA:8C:B9:54:50:24,3276179,511426873,45716,103411888,3230463,408014985,64,15897,4759968,15752,4736001,145,23967,9866,6,45694,11134,64,241,229410.0,137640.0,-53.0,-51.0,-38.0,-46.0,-51.0,-51.0,-43.0,-48.0,-79.0,-91.0,-81.0,-88.0,26.0,40.0,43.0,42.0,1
2263,62:47:05:9D:EB:15,3247631,449191371,17166,41176184,3230465,408015187,64,7627,1496124,7548,1482846,79,13278,3422,1,17150,2487,64,188,229410.0,130000.0,-43.0,-51.0,-44.0,-44.0,-44.0,-51.0,-46.0,-44.0,-79.0,-91.0,-81.0,-88.0,36.0,40.0,37.0,44.0,1
2264,F8:59:71:5A:E0:3D,3502909,819201509,272444,411186322,3230465,408015187,4,271846,369516652,266923,368928552,4923,588100,247971,20,275198,7281,4,850,144444.0,43333.0,-67.0,-73.0,-66.0,-69.0,-67.0,-73.0,-66.0,-70.0,-79.0,-91.0,-81.0,-88.0,12.0,18.0,15.0,19.0,1
2265,CC:2F:71:3E:C5:1F,3242022,409428947,11557,1413760,3230465,408015187,6,49274,4127264,40710,3112558,8564,1014706,12185,36,16560,190,6,858,130000.0,39000.0,-65.0,-64.0,-67.0,-59.0,-68.0,-72.0,-67.0,-63.0,-79.0,-91.0,-81.0,-88.0,14.0,27.0,14.0,29.0,1
2266,CC:2F:71:3F:1F:24,12081866,13983397149,8851400,13575381900,3230466,408015249,158,2015232,1190026514,2006524,1188980332,8708,1046182,1949780,675,8856179,936226,158,6702,130000.0,43333.0,-67.0,-65.0,-73.0,-68.0,-68.0,-65.0,-73.0,-68.0,-79.0,-91.0,-81.0,-88.0,12.0,26.0,8.0,20.0,1
2267,92:69:1D:31:68:E9,3260110,471266228,29635,63249187,3230475,408017041,0,13286,4120218,13154,4098528,132,21690,8499,1,29681,2094,0,155,229410.0,137640.0,-52.0,-52.0,-45.0,-51.0,-50.0,-50.0,-45.0,-49.0,-79.0,-91.0,-81.0,-88.0,27.0,39.0,36.0,37.0,1
2268,BA:8C:B9:54:50:24,3276191,511428929,45716,103411888,3230475,408017041,64,15897,4759968,15752,4736001,145,23967,9866,6,45694,11134,64,241,229410.0,137640.0,-53.0,-51.0,-38.0,-46.0,-51.0,-51.0,-43.0,-48.0,-79.0,-91.0,-81.0,-88.0,26.0,40.0,43.0,42.0,1
2269,62:47:05:9D:EB:15,3247641,449193225,17166,41176184,3230475,408017041,64,7627,1496124,7548,1482846,79,13278,3422,1,17150,2487,64,188,229410.0,130000.0,-43.0,-51.0,-44.0,-44.0,-44.0,-51.0,-46.0,-44.0,-79.0,-91.0,-81.0,-88.0,36.0,40.0,37.0,44.0,1
2270,F8:59:71:5A:E0:3D,3503005,819337007,272530,411319966,3230475,408017041,4,271934,369652200,267011,369064100,4923,588100,248057,20,275284,7283,4,850,144444.0,43333.0,-67.0,-73.0,-66.0,-71.0,-67.0,-73.0,-66.0,-70.0,-79.0,-91.0,-81.0,-87.0,12.0,18.0,15.0,16.0,1
2271,CC:2F:71:3E:C5:1F,3242032,409430801,11557,1413760,3230475,408017041,6,49276,4127452,40711,3112628,8565,1014824,12186,36,16560,190,6,858,130000.0,39000.0,-68.0,-73.0,-69.0,-60.0,-67.0,-71.0,-67.0,-62.0,-79.0,-91.0,-81.0,-87.0,11.0,18.0,12.0,27.0,1
2272,CC:2F:71:3F:1F:24,12084089,13986814714,8853614,13578797673,3230475,408017041,158,2015717,1190331319,2007008,1189285019,8709,1046300,1950247,675,8858447,936312,158,6704,117000.0,39000.0,-67.0,-65.0,-73.0,-67.0,-67.0,-65.0,-72.0,-67.0,-79.0,-91.0,-81.0,-87.0,12.0,26.0,8.0,20.0,1
2273,92:69:1D:31:68:E9,3260113,471266490,29635,63249187,3230478,408017303,0,13286,4120218,13154,4098528,132,21690,8499,1,29681,2094,0,155,229410.0,137640.0,-52.0,-52.0,-45.0,-51.0,-50.0,-50.0,-45.0,-49.0,-79.0,-91.0,-81.0,-87.0,27.0,39.0,36.0,36.0,1
2274,BA:8C:B9:54:50:24,3276194,511429191,45716,103411888,3230478,408017303,64,15897,4759968,15752,4736001,145,23967,9866,6,45694,11134,64,241,229410.0,137640.0,-53.0,-51.0,-38.0,-46.0,-51.0,-51.0,-43.0,-48.0,-79.0,-91.0,-81.0,-87.0,26.0,40.0,43.0,41.0,1
2275,62:47:05:9D:EB:15,3247644,449193487,17166,41176184,3230478,408017303,64,7627,1496124,7548,1482846,79,13278,3422,1,17150,2487,64,188,229410.0,130000.0,-43.0,-51.0,-44.0,-44.0,-44.0,-51.0,-46.0,-44.0,-79.0,-91.0,-81.0,-87.0,36.0,40.0,37.0,43.0,1
2276,F8:59:71:5A:E0:3D,3503090,819464697,272612,411447394,3230478,408017303,4,272018,369781588,267095,369193488,4923,588100,248139,20,275366,7285,4,850,144444.0,43333.0,-67.0,-73.0,-66.0,-71.0,-67.0,-73.0,-66.0,-70.0,-79.0,-91.0,-81.0,-87.0,12.0,18.0,15.0,16.0,1
2277,CC:2F:71:3E:C5:1F,3242037,409431265,11557,1413760,3230480,408017505,6,49276,4127452,40711,3112628,8565,1014824,12186,36,16560,190,6,858,130000.0,39000.0,-68.0,-73.0,-69.0,-60.0,-67.0,-71.0,-67.0,-62.0,-80.0,-91.0,-82.0,-88.0,12.0,18.0,13.0,28.0,1
2278,CC:2F:71:3F:1F:24,12085940,13989654924,8855458,13581637217,3230482,408017707,158,2016166,1190630531,2007457,1189584231,8709,1046300,1950686,675,8860291,936334,158,6704,130000.0,43333.0,-67.0,-65.0,-73.0,-67.0,-67.0,-65.0,-72.0,-67.0,-80.0,-91.0,-82.0,-88.0,13.0,26.0,9.0,21.0,1
2279,92:69:1D:31:68:E9,3260119,471267096,29635,63249187,3230484,408017909,0,13286,4120218,13154,4098528,132,21690,8499,1,29681,2094,0,155,229410.0,137640.0,-52.0,-52.0,-45.0,-51.0,-50.0,-50.0,-45.0,-49.0,-80.0,-91.0,-82.0,-88.0,28.0,39.0,37.0,37.0,1
2280,BA:8C:B9:54:50:24,3276264,511473035,45780,103455126,3230484,408017909,64,15965,4786871,15820,4762904,145,23967,9912,6,45758,11199,64,241,195000.0,97500.0,-46.0,-49.0,-53.0,-46.0,-48.0,-49.0,-42.0,-46.0,-80.0,-91.0,-82.0,-88.0,34.0,42.0,29.0,42.0,1
2281,62:47:05:9D:EB:15,3247651,449194247,17167,41176338,3230484,408017909,64,7660,1498426,7581,1485148,79,13278,3423,1,17151,2487,64,188,229410.0,130000.0,-52.0,-50.0,-50.0,-41.0,-43.0,-48.0,-44.0,-40.0,-80.0,-91.0,-82.0,-88.0,28.0,41.0,32.0,47.0,1
2282,F8:59:71:5A:E0:3D,3503185,819603609,272701,411585700,3230484,408017909,4,272107,369918732,267184,369330632,4923,588100,248226,20,275455,7285,4,850,144444.0,43333.0,-67.0,-73.0,-66.0,-70.0,-67.0,-73.0,-66.0,-70.0,-80.0,-91.0,-82.0,-88.0,13.0,18.0,16.0,18.0,1
2283,CC:2F:71:3E:C5:1F,3242041,409431669,11557,1413760,3230484,408017909,6,49276,4127452,40711,3112628,8565,1014824,12186,36,16560,190,6,858,130000.0,39000.0,-68.0,-73.0,-69.0,-60.0,-67.0,-71.0,-67.0,-62.0,-80.0,-91.0,-82.0,-88.0,12.0,18.0,13.0,28.0,1
2284,CC:2F:71:3F:1F:24,12087506,13992049484,8857020,13584031373,3230486,408018111,158,2016594,1190960543,2007885,1189914243,8709,1046300,1951098,675,8861853,936392,158,6704,130000.0,39000.0,-67.0,-65.0,-71.0,-67.0,-67.0,-65.0,-72.0,-67.0,-80.0,-91.0,-82.0,-88.0,13.0,26.0,11.0,21.0,1
2285,92:69:1D:31:68:E9,3260134,471271414,29641,63252637,3230493,408018777,0,13294,4123223,13162,4101533,132,21690,8504,1,29687,2094,0,155,229410.0,137640.0,-52.0,-51.0,-45.0,-51.0,-50.0,-51.0,-45.0,-49.0,-80.0,-91.0,-82.0,-88.0,28.0,40.0,37.0,37.0,1
2286,BA:8C:B9:54:50:24,3276274,511473983,45781,103455206,3230493,408018777,64,15975,4795136,15830,4771169,145,23967,9917,6,45759,11199,64,241,206470.0,97500.0,-50.0,-52.0,-44.0,-48.0,-50.0,-51.0,-43.0,-47.0,-80.0,-91.0,-82.0,-88.0,30.0,39.0,38.0,40.0,1
2287,62:47:05:9D:EB:15,3247660,449195115,17167,41176338,3230493,408018777,64,7660,1498426,7581,1485148,79,13278,3423,1,17151,2487,64,188,229410.0,130000.0,-52.0,-50.0,-50.0,-41.0,-43.0,-48.0,-44.0,-40.0,-80.0,-91.0,-82.0,-88.0,28.0,41.0,32.0,47.0,1
2288,F8:59:71:5A:E0:3D,3503298,819766093,272805,411747316,3230493,408018777,4,272213,370081972,267290,369493872,4923,588100,248332,20,275559,7287,4,850,144444.0,43333.0,-67.0,-74.0,-66.0,-70.0,-66.0,-73.0,-66.0,-70.0,-80.0,-91.0,-82.0,-88.0,13.0,17.0,16.0,18.0,1
2289,CC:2F:71:3E:C5:1F,3242050,409432537,11557,1413760,3230493,408018777,6,49276,4127452,40711,3112628,8565,1014824,12186,36,16560,190,6,858,130000.0,39000.0,-68.0,-73.0,-69.0,-60.0,-67.0,-71.0,-67.0,-62.0,-80.0,-91.0,-82.0,-88.0,12.0,18.0,13.0,28.0,1
2290,CC:2F:71:3F:1F:24,12089251,13994712043,8858758,13586693266,3230493,408018777,158,2017029,1191305717,2008320,1190259417,8709,1046300,1951527,675,8863591,936453,158,6704,130000.0,43333.0,-67.0,-64.0,-72.0,-69.0,-67.0,-64.0,-72.0,-68.0,-80.0,-91.0,-82.0,-88.0,13.0,27.0,10.0,19.0,1
2291,92:69:1D:31:68:E9,3260138,471271951,29641,63252637,3230497,408019314,0,13294,4123223,13162,4101533,132,21690,8504,1,29687,2094,0,155,229410.0,137640.0,-52.0,-51.0,-45.0,-51.0,-50.0,-51.0,-45.0,-49.0,-80.0,-91.0,-82.0,-88.0,28.0,40.0,37.0,37.0,1
2292,BA:8C:B9:54:50:24,3276282,511475433,45785,103456119,3230497,408019314,64,15985,4795954,15840,4771987,145,23967,9918,6,45763,11199,64,241,206470.0,97500.0,-53.0,-51.0,-38.0,-46.0,-50.0,-50.0,-41.0,-45.0,-80.0,-91.0,-82.0,-88.0,27.0,40.0,44.0,42.0,1
2293,62:47:05:9D:EB:15,3247664,449195652,17167,41176338,3230497,408019314,64,7660,1498426,7581,1485148,79,13278,3423,1,17151,2487,64,188,229410.0,130000.0,-52.0,-50.0,-50.0,-41.0,-43.0,-48.0,-44.0,-40.0,-80.0,-91.0,-82.0,-88.0,28.0,41.0,32.0,47.0,1
2294,F8:59:71:5A:E0:3D,3503389,819901828,272892,411882514,3230497,408019314,4,272301,370216070,267377,369627852,4924,588218,248420,20,275646,7288,4,850,144444.0,43333.0,-68.0,-74.0,-66.0,-70.0,-67.0,-74.0,-66.0,-70.0,-81.0,-91.0,-83.0,-89.0,13.0,17.0,17.0,19.0,1
2295,CC:2F:71:3E:C5:1F,3242054,409433074,11557,1413760,3230497,408019314,6,49276,4127452,40711,3112628,8565,1014824,12186,36,16560,190,6,858,130000.0,39000.0,-68.0,-73.0,-69.0,-60.0,-67.0,-71.0,-67.0,-62.0,-81.0,-91.0,-83.0,-89.0,13.0,18.0,14.0,29.0,1
2296,CC:2F:71:3F:1F:24,12091182,13997678478,8860681,13589658760,3230501,408019718,158,2017480,1191605693,2008771,1190559393,8709,1046300,1951962,675,8865476,936636,158,6706,130000.0,39000.0,-69.0,-65.0,-75.0,-71.0,-68.0,-64.0,-74.0,-70.0,-81.0,-91.0,-83.0,-89.0,12.0,26.0,8.0,18.0,1
2297,92:69:1D:31:68:E9,3260149,471272943,29641,63252637,3230508,408020306,0,13297,4123481,13164,4101669,133,21812,8505,1,29687,2094,0,155,229410.0,137640.0,-53.0,-51.0,-45.0,-51.0,-50.0,-51.0,-46.0,-50.0,-81.0,-92.0,-83.0,-89.0,28.0,41.0,38.0,38.0,1
2298,BA:8C:B9:54:50:24,3276293,511476425,45785,103456119,3230508,408020306,64,15988,4796212,15842,4772123,146,24089,9919,6,45763,11199,64,242,206470.0,97500.0,-47.0,-50.0,-53.0,-46.0,-48.0,-50.0,-44.0,-46.0,-81.0,-92.0,-83.0,-89.0,34.0,42.0,30.0,43.0,1
2299,62:47:05:9D:EB:15,3247675,449196644,17167,41176338,3230508,408020306,64,7660,1498426,7581,1485148,79,13278,3423,1,17151,2487,64,188,229410.0,130000.0,-52.0,-50.0,-50.0,-41.0,-43.0,-48.0,-44.0,-40.0,-81.0,-92.0,-83.0,-89.0,29.0,42.0,33.0,48.0,1
2300,F8:59:71:5A:E0:3D,3503515,820081530,273007,412061224,3230508,408020306,4,272418,370396656,267494,369808438,4924,588218,248534,20,275761,7288,4,850,144444.0,43333.0,-68.0,-74.0,-67.0,-71.0,-68.0,-74.0,-66.0,-70.0,-81.0,-92.0,-83.0,-89.0,13.0,18.0,16.0,18.0,1
2301,CC:2F:71:3E:C5:1F,3242065,409434066,11557,1413760,3230508,408020306,6,49276,4127452,40711,3112628,8565,1014824,12186,36,16560,190,6,858,130000.0,39000.0,-68.0,-73.0,-69.0,-60.0,-67.0,-71.0,-67.0,-62.0,-81.0,-92.0,-83.0,-89.0,13.0,19.0,14.0,29.0,1
2302,CC:2F:71:3F:1F:24,12093387,14001056008,8862879,13593035702,3230508,408020306,158,2018029,1192007414,2009320,1190961114,8709,1046300,1952503,675,8867712,936876,158,6707,130000.0,43333.0,-68.0,-65.0,-74.0,-69.0,-67.0,-65.0,-73.0,-68.0,-81.0,-92.0,-83.0,-89.0,13.0,27.0,9.0,20.0,1
2303,92:69:1D:31:68:E9,3260157,471273771,29641,63252637,3230516,408021134,0,13304,4124060,13170,4102077,134,21983,8506,1,29687,2094,0,155,229410.0,137640.0,-53.0,-51.0,-45.0,-51.0,-51.0,-50.0,-46.0,-50.0,-81.0,-92.0,-83.0,-89.0,28.0,41.0,38.0,38.0,1
2304,BA:8C:B9:54:50:24,3276317,511481912,45801,103460778,3230516,408021134,64,16016,4800365,15869,4776105,147,24260,9936,6,45779,11199,64,242,206470.0,103230.0,-53.0,-50.0,-37.0,-46.0,-51.0,-51.0,-43.0,-48.0,-81.0,-92.0,-83.0,-89.0,28.0,42.0,46.0,43.0,1
2305,62:47:05:9D:EB:15,3247683,449197472,17167,41176338,3230516,408021134,64,7660,1498426,7581,1485148,79,13278,3423,1,17151,2487,64,188,229410.0,130000.0,-52.0,-50.0,-50.0,-41.0,-43.0,-48.0,-44.0,-40.0,-81.0,-92.0,-83.0,-89.0,29.0,42.0,33.0,48.0,1
2306,F8:59:71:5A:E0:3D,3503602,820205124,273086,412183990,3230516,408021134,4,272499,370521410,267575,369933192,4924,588218,248614,20,275840,7288,4,850,144444.0,43333.0,-69.0,-74.0,-67.0,-71.0,-68.0,-74.0,-67.0,-70.0,-81.0,-92.0,-83.0,-89.0,12.0,18.0,16.0,18.0,1
2307,CC:2F:71:3E:C5:1F,3242073,409434894,11557,1413760,3230516,408021134,6,49276,4127452,40711,3112628,8565,1014824,12186,36,16560,190,6,858,130000.0,39000.0,-68.0,-73.0,-69.0,-60.0,-67.0,-71.0,-67.0,-62.0,-81.0,-92.0,-83.0,-89.0,13.0,19.0,14.0,29.0,1
2308,CC:2F:71:3F:1F:24,12094806,14003209931,8864290,13595188797,3230516,408021134,158,2018393,1192287605,2009684,1191241305,8709,1046300,1952866,675,8869123,936952,158,6709,130000.0,43333.0,-67.0,-65.0,-74.0,-69.0,-67.0,-64.0,-73.0,-68.0,-81.0,-92.0,-83.0,-89.0,14.0,27.0,9.0,20.0,1
2309,92:69:1D:31:68:E9,3260160,471274033,29641,63252637,3230519,408021396,0,13304,4124060,13170,4102077,134,21983,8506,1,29687,2094,0,155,229410.0,137640.0,-53.0,-51.0,-45.0,-51.0,-51.0,-50.0,-46.0,-50.0,-81.0,-92.0,-83.0,-89.0,28.0,41.0,38.0,38.0,1
2310,BA:8C:B9:54:50:24,3276320,511482174,45801,103460778,3230519,408021396,64,16016,4800365,15869,4776105,147,24260,9936,6,45779,11199,64,242,206470.0,103230.0,-53.0,-50.0,-37.0,-46.0,-51.0,-51.0,-43.0,-48.0,-82.0,-92.0,-84.0,-89.0,29.0,42.0,47.0,43.0,1
2311,62:47:05:9D:EB:15,3247688,449197997,17169,41176601,3230519,408021396,64,7693,1500760,7614,1487482,79,13278,3425,1,17153,2487,64,190,229410.0,137640.0,-52.0,-50.0,-51.0,-41.0,-47.0,-52.0,-49.0,-44.0,-82.0,-92.0,-84.0,-89.0,30.0,42.0,33.0,48.0,1
2312,F8:59:71:5A:E0:3D,3503695,820342340,273174,412320742,3230521,408021598,4,272587,370657028,267663,370068810,4924,588218,248701,20,275928,7292,4,850,144444.0,43333.0,-68.0,-74.0,-67.0,-71.0,-68.0,-74.0,-66.0,-70.0,-82.0,-92.0,-84.0,-89.0,14.0,18.0,17.0,18.0,1
2313,CC:2F:71:3E:C5:1F,3242080,409435560,11557,1413760,3230523,408021800,6,49276,4127452,40711,3112628,8565,1014824,12186,36,16560,190,6,858,130000.0,39000.0,-68.0,-73.0,-69.0,-60.0,-67.0,-71.0,-67.0,-62.0,-82.0,-92.0,-84.0,-89.0,14.0,19.0,15.0,29.0,1
2314,CC:2F:71:3F:1F:24,12095978,14004975493,8865453,13596953491,3230525,408022002,158,2018758,1192587295,2010049,1191540995,8709,1046300,1953224,675,8870283,936972,158,6710,130000.0,43333.0,-67.0,-65.0,-73.0,-68.0,-67.0,-65.0,-73.0,-68.0,-82.0,-92.0,-84.0,-89.0,15.0,27.0,11.0,21.0,1
2315,92:69:1D:31:68:E9,3260166,471274639,29641,63252637,3230525,408022002,0,13304,4124060,13170,4102077,134,21983,8506,1,29687,2094,0,155,229410.0,137640.0,-53.0,-51.0,-45.0,-51.0,-51.0,-50.0,-46.0,-50.0,-82.0,-92.0,-84.0,-89.0,29.0,41.0,39.0,38.0,1
2316,BA:8C:B9:54:50:24,3276326,511482780,45801,103460778,3230525,408022002,64,16016,4800365,15869,4776105,147,24260,9936,6,45779,11199,64,242,206470.0,103230.0,-53.0,-50.0,-37.0,-46.0,-51.0,-51.0,-43.0,-48.0,-82.0,-92.0,-84.0,-89.0,29.0,42.0,47.0,43.0,1
2317,62:47:05:9D:EB:15,3247925,449730346,17398,41708142,3230527,408022204,64,7758,1510891,7679,1497613,79,13278,3453,1,17382,2487,64,191,229410.0,137640.0,-43.0,-50.0,-44.0,-45.0,-46.0,-52.0,-47.0,-45.0,-82.0,-92.0,-84.0,-89.0,39.0,42.0,40.0,44.0,1
2318,F8:59:71:5A:E0:3D,3503793,820485914,273266,412463710,3230527,408022204,4,272680,370800290,267756,370212072,4924,588218,248794,20,276020,7292,4,850,144444.0,43333.0,-68.0,-74.0,-67.0,-71.0,-68.0,-74.0,-67.0,-71.0,-82.0,-92.0,-84.0,-89.0,14.0,18.0,17.0,18.0,1
2319,CC:2F:71:3E:C5:1F,3242084,409435964,11557,1413760,3230527,408022204,6,49276,4127452,40711,3112628,8565,1014824,12186,36,16560,190,6,858,130000.0,39000.0,-68.0,-73.0,-69.0,-60.0,-67.0,-71.0,-67.0,-62.0,-82.0,-92.0,-84.0,-89.0,14.0,19.0,15.0,29.0,1
2320,CC:2F:71:3F:1F:24,12097157,14006760899,8866630,13598738695,3230527,408022204,158,2019092,1192891717,2010383,1191845417,8709,1046300,1953554,675,8871463,937000,158,6710,130000.0,43333.0,-67.0,-64.0,-74.0,-67.0,-66.0,-64.0,-73.0,-67.0,-82.0,-92.0,-84.0,-89.0,15.0,28.0,10.0,22.0,1
2321,92:69:1D:31:68:E9,3260175,471275507,29641,63252637,3230534,408022870,0,13304,4124060,13170,4102077,134,21983,8506,1,29687,2094,0,155,229410.0,137640.0,-53.0,-51.0,-45.0,-51.0,-51.0,-50.0,-46.0,-50.0,-82.0,-92.0,-84.0,-89.0,29.0,41.0,39.0,38.0,1
2322,BA:8C:B9:54:50:24,3276335,511483648,45801,103460778,3230534,408022870,64,16017,4800433,15870,4776173,147,24260,9936,6,45779,11199,64,242,206470.0,103230.0,-46.0,-50.0,-53.0,-46.0,-50.0,-51.0,-44.0,-48.0,-82.0,-92.0,-84.0,-89.0,36.0,42.0,31.0,43.0,1
2323,62:47:05:9D:EB:15,3247932,449731012,17398,41708142,3230534,408022870,64,7758,1510891,7679,1497613,79,13278,3453,1,17382,2487,64,191,229410.0,137640.0,-43.0,-50.0,-44.0,-45.0,-46.0,-52.0,-47.0,-45.0,-82.0,-92.0,-84.0,-90.0,39.0,42.0,40.0,45.0,1
2324,F8:59:71:5A:E0:3D,3503887,820621778,273353,412598908,3230534,408022870,4,272767,370934270,267843,370346052,4924,588218,248881,20,276107,7293,4,850,144444.0,43333.0,-69.0,-74.0,-67.0,-71.0,-68.0,-74.0,-67.0,-71.0,-82.0,-92.0,-84.0,-90.0,13.0,18.0,17.0,19.0,1
2325,CC:2F:71:3E:C5:1F,3242091,409436630,11557,1413760,3230534,408022870,6,49276,4127452,40711,3112628,8565,1014824,12186,36,16560,190,6,858,130000.0,39000.0,-68.0,-73.0,-69.0,-60.0,-67.0,-71.0,-67.0,-62.0,-82.0,-92.0,-84.0,-90.0,14.0,19.0,15.0,30.0,1
2326,CC:2F:71:3F:1F:24,12098378,14008598946,8867844,13600576076,3230534,408022870,158,2019456,1193203004,2010747,1192156704,8709,1046300,1953914,675,8872677,937030,158,6710,130000.0,43333.0,-68.0,-65.0,-74.0,-68.0,-68.0,-65.0,-74.0,-68.0,-82.0,-92.0,-84.0,-90.0,14.0,27.0,10.0,22.0,1
2327,92:69:1D:31:68:E9,3260177,471275709,29641,63252637,3230536,408023072,0,13304,4124060,13170,4102077,134,21983,8506,1,29687,2094,0,155,229410.0,137640.0,-53.0,-51.0,-45.0,-51.0,-51.0,-50.0,-46.0,-50.0,-82.0,-92.0,-84.0,-90.0,29.0,41.0,39.0,39.0,1
2328,BA:8C:B9:54:50:24,3276338,511483961,45801,103460778,3230537,408023183,64,16017,4800433,15870,4776173,147,24260,9936,6,45779,11199,64,242,206470.0,103230.0,-46.0,-50.0,-53.0,-46.0,-50.0,-51.0,-44.0,-48.0,-82.0,-92.0,-84.0,-90.0,36.0,42.0,31.0,44.0,1
2329,62:47:05:9D:EB:15,3247935,449731325,17398,41708142,3230537,408023183,64,7760,1511130,7680,1497681,80,13449,3454,1,17382,2487,64,191,229410.0,137640.0,-47.0,-52.0,-48.0,-46.0,-47.0,-52.0,-47.0,-45.0,-82.0,-92.0,-84.0,-90.0,35.0,40.0,36.0,44.0,1
2330,F8:59:71:5A:E0:3D,3504040,820844979,273496,412821130,3230544,408023849,4,272917,371165942,267993,370577724,4924,588218,249029,20,276250,7299,4,852,144444.0,43333.0,-68.0,-73.0,-66.0,-70.0,-68.0,-73.0,-66.0,-70.0,-82.0,-92.0,-84.0,-90.0,14.0,19.0,18.0,20.0,1
2331,CC:2F:71:3E:C5:1F,3242101,409437609,11557,1413760,3230544,408023849,6,49276,4127452,40711,3112628,8565,1014824,12186,36,16560,190,6,858,130000.0,39000.0,-68.0,-73.0,-69.0,-60.0,-67.0,-71.0,-67.0,-62.0,-82.0,-92.0,-84.0,-90.0,14.0,19.0,15.0,30.0,1
2332,CC:2F:71:3F:1F:24,12100102,14011230259,8869558,13603206410,3230544,408023849,158,2019960,1193672543,2011251,1192626243,8709,1046300,1954394,675,8874390,937130,158,6712,130000.0,43333.0,-67.0,-65.0,-74.0,-68.0,-67.0,-65.0,-73.0,-68.0,-82.0,-92.0,-84.0,-90.0,15.0,27.0,10.0,22.0,1
2333,92:69:1D:31:68:E9,3260187,471276688,29641,63252637,3230546,408024051,0,13304,4124060,13170,4102077,134,21983,8506,1,29687,2094,0,155,229410.0,137640.0,-53.0,-51.0,-45.0,-51.0,-51.0,-50.0,-46.0,-50.0,-82.0,-92.0,-84.0,-90.0,29.0,41.0,39.0,39.0,1
2334,BA:8C:B9:54:50:24,3276348,511484945,45802,103460894,3230546,408024051,64,16027,4801267,15880,4777007,147,24260,9938,6,45780,11199,64,242,206470.0,103230.0,-46.0,-50.0,-54.0,-46.0,-49.0,-50.0,-42.0,-45.0,-82.0,-92.0,-84.0,-90.0,36.0,42.0,30.0,44.0,1
2335,62:47:05:9D:EB:15,3247946,449732638,17400,41708587,3230546,408024051,64,7771,1512125,7691,1498676,80,13449,3458,1,17384,2487,64,191,229410.0,137640.0,-53.0,-51.0,-51.0,-41.0,-48.0,-51.0,-49.0,-43.0,-82.0,-92.0,-84.0,-90.0,29.0,41.0,33.0,49.0,1
2336,F8:59:71:5A:E0:3D,3504132,820979229,273582,412954774,3230550,408024455,4,273004,371299978,268080,370711760,4924,588218,249116,20,276336,7301,4,852,144444.0,43333.0,-68.0,-73.0,-66.0,-71.0,-69.0,-73.0,-67.0,-71.0,-82.0,-92.0,-84.0,-90.0,14.0,19.0,18.0,19.0,1
2337,CC:2F:71:3E:C5:1F,3242107,409438215,11557,1413760,3230550,408024455,6,49276,4127452,40711,3112628,8565,1014824,12186,36,16560,190,6,858,130000.0,39000.0,-68.0,-73.0,-69.0,-60.0,-67.0,-71.0,-67.0,-62.0,-82.0,-92.0,-84.0,-90.0,14.0,19.0,15.0,30.0,1
2338,CC:2F:71:3F:1F:24,12101329,14013060926,8870779,13605036471,3230550,408024455,158,2020317,1193972902,2011608,1192926602,8709,1046300,1954750,675,8875612,937192,158,6713,130000.0,43333.0,-68.0,-65.0,-75.0,-68.0,-68.0,-65.0,-74.0,-68.0,-82.0,-92.0,-84.0,-90.0,14.0,27.0,9.0,22.0,1
2339,92:69:1D:31:68:E9,3260193,471277294,29641,63252637,3230552,408024657,0,13304,4124060,13170,4102077,134,21983,8506,1,29687,2094,0,155,229410.0,137640.0,-53.0,-51.0,-45.0,-51.0,-51.0,-50.0,-46.0,-50.0,-83.0,-92.0,-85.0,-90.0,30.0,41.0,40.0,39.0,1
2340,BA:8C:B9:54:50:24,3276354,511485551,45802,103460894,3230552,408024657,64,16027,4801267,15880,4777007,147,24260,9938,6,45780,11199,64,242,206470.0,103230.0,-46.0,-50.0,-54.0,-46.0,-49.0,-50.0,-42.0,-45.0,-83.0,-92.0,-85.0,-90.0,37.0,42.0,31.0,44.0,1
2341,62:47:05:9D:EB:15,3247957,449733839,17402,41708920,3230555,408024919,64,7776,1512621,7696,1499172,80,13449,3461,1,17386,2487,64,191,229410.0,137640.0,-53.0,-50.0,-51.0,-41.0,-47.0,-51.0,-48.0,-44.0,-83.0,-92.0,-85.0,-90.0,30.0,42.0,34.0,49.0,1
2342,F8:59:71:5A:E0:3D,3504226,821117999,273671,413093080,3230555,408024919,4,273093,371437094,268169,370848876,4924,588218,249204,20,276425,7301,4,852,144444.0,43333.0,-68.0,-74.0,-67.0,-70.0,-68.0,-73.0,-66.0,-70.0,-83.0,-92.0,-85.0,-90.0,15.0,18.0,18.0,20.0,1
2343,CC:2F:71:3E:C5:1F,3242112,409438679,11557,1413760,3230555,408024919,6,49276,4127452,40711,3112628,8565,1014824,12186,36,16560,190,6,858,130000.0,39000.0,-68.0,-73.0,-69.0,-60.0,-67.0,-71.0,-67.0,-62.0,-83.0,-92.0,-85.0,-90.0,15.0,19.0,16.0,30.0,1
2344,CC:2F:71:3F:1F:24,12102610,14015008806,8872055,13606983887,3230555,408024919,158,2020690,1194283800,2011981,1193237500,8709,1046300,1955109,675,8876888,937311,158,6713,130000.0,43333.0,-68.0,-65.0,-75.0,-68.0,-68.0,-65.0,-74.0,-68.0,-83.0,-92.0,-85.0,-90.0,15.0,27.0,10.0,22.0,1
2345,92:69:1D:31:68:E9,3260200,471277960,29641,63252637,3230559,408025323,0,13305,4124128,13171,4102145,134,21983,8506,1,29687,2094,0,155,229410.0,137640.0,-53.0,-51.0,-45.0,-51.0,-51.0,-50.0,-46.0,-50.0,-83.0,-92.0,-85.0,-90.0,30.0,41.0,40.0,39.0,1
2346,BA:8C:B9:54:50:24,3276362,511486351,45802,103460894,3230560,408025457,64,16027,4801267,15880,4777007,147,24260,9938,6,45780,11199,64,242,206470.0,103230.0,-46.0,-50.0,-54.0,-46.0,-49.0,-50.0,-42.0,-45.0,-83.0,-92.0,-85.0,-90.0,37.0,42.0,31.0,44.0,1
2347,62:47:05:9D:EB:15,3247967,449735048,17406,41709523,3230561,408025525,64,7785,1513485,7705,1500036,80,13449,3466,1,17390,2487,64,191,229410.0,137640.0,-43.0,-50.0,-43.0,-44.0,-46.0,-51.0,-46.0,-44.0,-83.0,-92.0,-85.0,-90.0,40.0,42.0,42.0,46.0,1
2348,F8:59:71:5A:E0:3D,3504323,821258738,273761,413232940,3230562,408025798,4,273186,371580356,268262,370992138,4924,588218,249294,20,276515,7301,4,852,144444.0,43333.0,-68.0,-73.0,-66.0,-70.0,-68.0,-73.0,-66.0,-70.0,-83.0,-92.0,-85.0,-90.0,15.0,19.0,19.0,20.0,1
2349,CC:2F:71:3E:C5:1F,3242119,409439558,11557,1413760,3230562,408025798,6,49276,4127452,40711,3112628,8565,1014824,12186,36,16560,190,6,858,130000.0,39000.0,-68.0,-73.0,-69.0,-60.0,-67.0,-71.0,-67.0,-62.0,-83.0,-92.0,-85.0,-90.0,15.0,19.0,16.0,30.0,1
2350,CC:2F:71:3F:1F:24,12103826,14016845654,8873264,13608819856,3230562,408025798,158,2021022,1194579531,2012313,1193533231,8709,1046300,1955440,675,8878097,937384,158,6713,130000.0,43333.0,-68.0,-65.0,-74.0,-68.0,-68.0,-65.0,-74.0,-68.0,-83.0,-92.0,-85.0,-90.0,15.0,27.0,11.0,22.0,1
2351,92:69:1D:31:68:E9,3260205,471278637,29641,63252637,3230564,408026000,0,13305,4124128,13171,4102145,134,21983,8506,1,29687,2094,0,155,229410.0,137640.0,-53.0,-51.0,-45.0,-51.0,-51.0,-50.0,-46.0,-50.0,-83.0,-92.0,-85.0,-90.0,30.0,41.0,40.0,39.0,1
2352,BA:8C:B9:54:50:24,3276366,511486894,45802,103460894,3230564,408026000,64,16027,4801267,15880,4777007,147,24260,9938,6,45780,11199,64,242,206470.0,103230.0,-46.0,-50.0,-54.0,-46.0,-49.0,-50.0,-42.0,-45.0,-83.0,-92.0,-85.0,-90.0,37.0,42.0,31.0,44.0,1
2353,62:47:05:9D:EB:15,3247971,449735583,17406,41709523,3230565,408026060,64,7785,1513485,7705,1500036,80,13449,3466,1,17390,2487,64,191,229410.0,137640.0,-43.0,-50.0,-43.0,-44.0,-46.0,-51.0,-46.0,-44.0,-83.0,-92.0,-85.0,-90.0,40.0,42.0,42.0,46.0,1
2354,F8:59:71:5A:E0:3D,3504416,821398692,273851,413372632,3230565,408026060,4,273276,371718984,268352,371130766,4924,588218,249382,20,276605,7304,4,852,144444.0,43333.0,-68.0,-73.0,-67.0,-71.0,-68.0,-73.0,-66.0,-70.0,-83.0,-92.0,-85.0,-90.0,15.0,19.0,18.0,19.0,1
2355,CC:2F:71:3E:C5:1F,3242126,409440224,11557,1413760,3230569,408026464,6,49276,4127452,40711,3112628,8565,1014824,12186,36,16560,190,6,858,130000.0,39000.0,-68.0,-73.0,-69.0,-60.0,-67.0,-71.0,-67.0,-62.0,-83.0,-92.0,-85.0,-90.0,15.0,19.0,16.0,30.0,1
2356,CC:2F:71:3F:1F:24,12105900,14020037478,8875331,13612011014,3230569,408026464,158,2021483,1194897439,2012774,1193851139,8709,1046300,1955901,675,8880137,937410,158,6713,130000.0,43333.0,-67.0,-65.0,-74.0,-68.0,-67.0,-64.0,-73.0,-67.0,-83.0,-92.0,-85.0,-90.0,16.0,27.0,11.0,22.0,1
2357,92:69:1D:31:68:E9,3260212,471279303,29641,63252637,3230571,408026666,0,13305,4124128,13171,4102145,134,21983,8506,1,29687,2094,0,155,229410.0,137640.0,-53.0,-51.0,-45.0,-51.0,-51.0,-50.0,-46.0,-50.0,-84.0,-92.0,-85.0,-90.0,31.0,41.0,40.0,39.0,1
2358,BA:8C:B9:54:50:24,3276375,511487762,45802,103460894,3230573,408026868,64,16027,4801267,15880,4777007,147,24260,9938,6,45780,11199,64,242,206470.0,103230.0,-46.0,-50.0,-54.0,-46.0,-49.0,-50.0,-42.0,-45.0,-84.0,-92.0,-85.0,-90.0,38.0,42.0,31.0,44.0,1
2359,62:47:05:9D:EB:15,3247979,449736391,17406,41709523,3230573,408026868,64,7785,1513485,7705,1500036,80,13449,3466,1,17390,2487,64,191,229410.0,137640.0,-43.0,-50.0,-43.0,-44.0,-46.0,-51.0,-46.0,-44.0,-84.0,-92.0,-85.0,-90.0,41.0,42.0,42.0,46.0,1
2360,F8:59:71:5A:E0:3D,3504518,821545576,273945,413518708,3230573,408026868,4,273370,371863898,268446,371275680,4924,588218,249475,20,276698,7304,4,852,144444.0,43333.0,-68.0,-73.0,-66.0,-71.0,-68.0,-73.0,-66.0,-70.0,-84.0,-92.0,-85.0,-90.0,16.0,19.0,19.0,19.0,1
2361,CC:2F:71:3E:C5:1F,3242130,409440628,11557,1413760,3230573,408026868,6,49276,4127452,40711,3112628,8565,1014824,12186,36,16560,190,6,858,130000.0,39000.0,-68.0,-73.0,-69.0,-60.0,-67.0,-71.0,-67.0,-62.0,-84.0,-92.0,-85.0,-90.0,16.0,19.0,16.0,30.0,1
2362,CC:2F:71:3F:1F:24,12107648,14022707651,8877075,13614680783,3230573,408026868,158,2021919,1195216029,2013210,1194169729,8709,1046300,1956337,675,8881908,937466,158,6715,130000.0,43333.0,-67.0,-65.0,-74.0,-68.0,-67.0,-64.0,-73.0,-67.0,-84.0,-92.0,-85.0,-90.0,17.0,27.0,11.0,22.0,1
2363,92:69:1D:31:68:E9,3260220,471280200,29642,63252753,3230578,408027447,0,13307,4124264,13173,4102281,134,21983,8506,1,29688,2094,0,155,216660.0,130000.0,-53.0,-51.0,-45.0,-50.0,-51.0,-50.0,-46.0,-50.0,-84.0,-92.0,-86.0,-90.0,31.0,41.0,41.0,40.0,1
2364,BA:8C:B9:54:50:24,3276381,511488457,45803,103461010,3230578,408027447,64,16034,4801743,15887,4777483,147,24260,9938,6,45781,11199,64,242,206470.0,103230.0,-54.0,-51.0,-38.0,-46.0,-48.0,-49.0,-42.0,-45.0,-84.0,-92.0,-86.0,-90.0,30.0,41.0,48.0,44.0,1
2365,62:47:05:9D:EB:15,3247988,449737479,17409,41709972,3230579,408027507,64,7820,1516136,7739,1502452,81,13684,3469,1,17393,2487,64,191,229410.0,137640.0,-46.0,-53.0,-48.0,-46.0,-44.0,-50.0,-46.0,-42.0,-84.0,-92.0,-86.0,-90.0,38.0,39.0,38.0,44.0,1
2366,F8:59:71:5A:E0:3D,3504608,821675313,274029,413647806,3230579,408027507,4,273460,372002554,268536,371414336,4924,588218,249561,20,276783,7308,4,852,144444.0,43333.0,-68.0,-73.0,-66.0,-70.0,-68.0,-73.0,-66.0,-70.0,-84.0,-92.0,-86.0,-90.0,16.0,19.0,20.0,20.0,1
2367,CC:2F:71:3E:C5:1F,3242139,409441695,11558,1413820,3230581,408027875,6,49278,4127592,40713,3112768,8565,1014824,12186,36,16561,190,6,858,130000.0,39000.0,-68.0,-72.0,-69.0,-60.0,-67.0,-70.0,-67.0,-59.0,-84.0,-92.0,-86.0,-90.0,16.0,20.0,17.0,30.0,1
2368,CC:2F:71:3F:1F:24,12109572,14025661778,8878991,13617633903,3230581,408027875,158,2022333,1195495529,2013624,1194449229,8709,1046300,1956750,675,8883809,937563,158,6715,130000.0,43333.0,-67.0,-64.0,-74.0,-68.0,-67.0,-64.0,-73.0,-67.0,-84.0,-92.0,-86.0,-90.0,17.0,28.0,12.0,22.0,1
2369,92:69:1D:31:68:E9,3260250,471321555,29664,63293214,3230586,408028341,0,13334,4131675,13200,4109692,134,21983,8525,1,29710,2094,0,157,216660.0,130000.0,-50.0,-50.0,-46.0,-49.0,-50.0,-50.0,-45.0,-49.0,-85.0,-92.0,-86.0,-90.0,35.0,42.0,40.0,41.0,1
2370,BA:8C:B9:54:50:24,3276389,511489351,45803,103461010,3230586,408028341,64,16037,4802001,15889,4777619,148,24382,9939,6,45781,11199,64,242,206470.0,103230.0,-46.0,-50.0,-54.0,-46.0,-48.0,-49.0,-43.0,-46.0,-85.0,-92.0,-86.0,-90.0,39.0,42.0,32.0,44.0,1
2371,62:47:05:9D:EB:15,3247995,449738313,17409,41709972,3230586,408028341,64,7829,1516748,7748,1503064,81,13684,3469,1,17393,2487,64,191,229410.0,137640.0,-43.0,-50.0,-44.0,-44.0,-46.0,-52.0,-47.0,-45.0,-85.0,-92.0,-86.0,-90.0,42.0,42.0,42.0,46.0,1
2372,F8:59:71:5A:E0:3D,3504703,821812899,274117,413784558,3230586,408028341,4,273551,372142722,268627,371554504,4924,588218,249650,20,276871,7309,4,852,144444.0,43333.0,-68.0,-73.0,-66.0,-70.0,-68.0,-73.0,-66.0,-70.0,-85.0,-92.0,-86.0,-90.0,17.0,19.0,20.0,20.0,1
2373,CC:2F:71:3E:C5:1F,3242144,409442161,11558,1413820,3230586,408028341,6,49278,4127592,40713,3112768,8565,1014824,12186,36,16561,190,6,858,130000.0,39000.0,-68.0,-72.0,-69.0,-60.0,-67.0,-70.0,-67.0,-59.0,-85.0,-92.0,-86.0,-90.0,17.0,20.0,17.0,30.0,1
2374,CC:2F:71:3F:1F:24,12111439,14028530152,8880853,13620501811,3230586,408028341,158,2022761,1195810863,2014052,1194764563,8709,1046300,1957177,675,8885686,937672,158,6715,130000.0,43333.0,-67.0,-64.0,-73.0,-67.0,-67.0,-64.0,-73.0,-67.0,-85.0,-92.0,-86.0,-90.0,18.0,28.0,13.0,23.0,1
2375,92:69:1D:31:68:E9,3260257,471322223,29664,63293214,3230593,408029009,0,13335,4131743,13201,4109760,134,21983,8525,1,29710,2094,0,157,216660.0,130000.0,-52.0,-51.0,-45.0,-50.0,-50.0,-50.0,-45.0,-49.0,-85.0,-92.0,-86.0,-90.0,33.0,41.0,41.0,40.0,1
2376,BA:8C:B9:54:50:24,3276398,511490221,45803,103461010,3230595,408029211,64,16037,4802001,15889,4777619,148,24382,9939,6,45781,11199,64,242,206470.0,103230.0,-46.0,-50.0,-54.0,-46.0,-48.0,-49.0,-43.0,-46.0,-85.0,-92.0,-86.0,-90.0,39.0,42.0,32.0,44.0,1
2377,62:47:05:9D:EB:15,3248428,450854217,17832,42824946,3230596,408029271,64,7888,1527873,7807,1514189,81,13684,3512,1,17816,2552,64,192,229410.0,137640.0,-52.0,-50.0,-50.0,-41.0,-46.0,-52.0,-47.0,-45.0,-85.0,-92.0,-86.0,-90.0,33.0,42.0,36.0,49.0,1
2378,F8:59:71:5A:E0:3D,3504815,821972337,274219,413943066,3230596,408029271,4,273655,372302910,268731,371714692,4924,588218,249752,20,276973,7309,4,852,144444.0,43333.0,-67.0,-74.0,-65.0,-70.0,-67.0,-73.0,-65.0,-70.0,-85.0,-92.0,-86.0,-90.0,18.0,18.0,21.0,20.0,1
2379,CC:2F:71:3E:C5:1F,3242154,409443091,11558,1413820,3230596,408029271,6,49280,4127780,40714,3112838,8566,1014942,12187,36,16561,190,6,858,130000.0,39000.0,-69.0,-72.0,-69.0,-61.0,-68.0,-71.0,-68.0,-60.0,-85.0,-92.0,-86.0,-90.0,16.0,20.0,17.0,29.0,1
2380,CC:2F:71:3F:1F:24,12113357,14031463497,8882761,13623434226,3230596,408029271,158,2023265,1196167462,2014556,1195121162,8709,1046300,1957677,675,8887594,938357,158,6715,78000.0,13000.0,-70.0,-64.0,-75.0,-69.0,-69.0,-63.0,-74.0,-68.0,-85.0,-92.0,-86.0,-90.0,15.0,28.0,11.0,21.0,1
2381,92:69:1D:31:68:E9,3260264,471322889,29664,63293214,3230600,408029675,0,13335,4131743,13201,4109760,134,21983,8525,1,29710,2094,0,157,216660.0,130000.0,-52.0,-51.0,-45.0,-50.0,-50.0,-50.0,-45.0,-49.0,-85.0,-92.0,-86.0,-90.0,33.0,41.0,41.0,40.0,1
2382,BA:8C:B9:54:50:24,3276403,511490685,45803,103461010,3230600,408029675,64,16037,4802001,15889,4777619,148,24382,9939,6,45781,11199,64,242,206470.0,103230.0,-46.0,-50.0,-54.0,-46.0,-48.0,-49.0,-43.0,-46.0,-85.0,-92.0,-86.0,-90.0,39.0,42.0,32.0,44.0,1
2383,62:47:05:9D:EB:15,3248432,450854621,17832,42824946,3230600,408029675,64,7888,1527873,7807,1514189,81,13684,3512,1,17816,2552,64,192,229410.0,137640.0,-52.0,-50.0,-50.0,-41.0,-46.0,-52.0,-47.0,-45.0,-85.0,-92.0,-86.0,-90.0,33.0,42.0,36.0,49.0,1
2384,F8:59:71:5A:E0:3D,3504904,822104831,274304,414075156,3230600,408029675,4,273741,372435378,268817,371847160,4924,588218,249836,20,277058,7311,4,852,144444.0,43333.0,-68.0,-73.0,-65.0,-71.0,-67.0,-73.0,-65.0,-71.0,-85.0,-92.0,-86.0,-90.0,17.0,19.0,21.0,19.0,1
2385,CC:2F:71:3E:C5:1F,3242158,409443495,11558,1413820,3230600,408029675,6,49280,4127780,40714,3112838,8566,1014942,12187,36,16561,190,6,858,130000.0,39000.0,-69.0,-72.0,-69.0,-61.0,-68.0,-71.0,-68.0,-60.0,-85.0,-92.0,-86.0,-90.0,16.0,20.0,17.0,29.0,1
2386,CC:2F:71:3F:1F:24,12114719,14033517714,8884119,13625488039,3230600,408029675,158,2023708,1196449666,2014999,1195403366,8709,1046300,1958120,675,8888952,938464,158,6715,115556.0,28889.0,-71.0,-65.0,-75.0,-70.0,-70.0,-64.0,-74.0,-69.0,-85.0,-92.0,-86.0,-90.0,14.0,27.0,11.0,20.0,1
2387,92:69:1D:31:68:E9,3260268,471323293,29664,63293214,3230604,408030079,0,13335,4131743,13201,4109760,134,21983,8525,1,29710,2094,0,157,216660.0,130000.0,-52.0,-51.0,-45.0,-50.0,-50.0,-50.0,-45.0,-49.0,-86.0,-93.0,-87.0,-91.0,34.0,42.0,42.0,41.0,1
2388,BA:8C:B9:54:50:24,3276407,511491089,45803,103461010,3230604,408030079,64,16037,4802001,15889,4777619,148,24382,9939,6,45781,11199,64,242,206470.0,103230.0,-46.0,-50.0,-54.0,-46.0,-48.0,-49.0,-43.0,-46.0,-86.0,-93.0,-87.0,-91.0,40.0,43.0,33.0,45.0,1
2389,62:47:05:9D:EB:15,3248436,450855025,17832,42824946,3230604,408030079,64,7888,1527873,7807,1514189,81,13684,3512,1,17816,2552,64,192,229410.0,137640.0,-52.0,-50.0,-50.0,-41.0,-46.0,-52.0,-47.0,-45.0,-86.0,-93.0,-87.0,-91.0,34.0,43.0,37.0,50.0,1
2390,F8:59:71:5A:E0:3D,3504993,822235831,274388,414205692,3230605,408030139,4,273827,372567846,268903,371979628,4924,588218,249920,20,277142,7312,4,852,144444.0,43333.0,-67.0,-73.0,-66.0,-70.0,-67.0,-73.0,-66.0,-69.0,-86.0,-93.0,-87.0,-91.0,19.0,20.0,21.0,21.0,1
2391,CC:2F:71:3E:C5:1F,3242163,409443959,11558,1413820,3230605,408030139,6,49280,4127780,40714,3112838,8566,1014942,12187,36,16561,190,6,858,130000.0,39000.0,-69.0,-72.0,-69.0,-61.0,-68.0,-71.0,-68.0,-60.0,-86.0,-93.0,-87.0,-91.0,17.0,21.0,18.0,30.0,1
2392,CC:2F:71:3F:1F:24,12116070,14035573766,8885465,13627543627,3230605,408030139,158,2024110,1196753894,2015401,1195707594,8709,1046300,1958512,675,8890298,938721,158,6715,78000.0,13000.0,-71.0,-65.0,-72.0,-68.0,-70.0,-65.0,-72.0,-68.0,-86.0,-93.0,-87.0,-91.0,15.0,28.0,15.0,23.0,1
2393,92:69:1D:31:68:E9,3260273,471323757,29664,63293214,3230609,408030543,0,13335,4131743,13201,4109760,134,21983,8525,1,29710,2094,0,157,216660.0,130000.0,-52.0,-51.0,-45.0,-50.0,-50.0,-50.0,-45.0,-49.0,-86.0,-93.0,-87.0,-91.0,34.0,42.0,42.0,41.0,1
2394,BA:8C:B9:54:50:24,3276414,511491755,45803,103461010,3230611,408030745,64,16037,4802001,15889,4777619,148,24382,9939,6,45781,11199,64,242,206470.0,103230.0,-46.0,-50.0,-54.0,-46.0,-48.0,-49.0,-43.0,-46.0,-86.0,-93.0,-87.0,-91.0,40.0,43.0,33.0,45.0,1
2395,62:47:05:9D:EB:15,3248454,450861115,17832,42824946,3230622,408036169,64,7888,1527873,7807,1514189,81,13684,3512,1,17816,2552,64,192,229410.0,137640.0,-52.0,-50.0,-50.0,-41.0,-46.0,-52.0,-47.0,-45.0,-86.0,-93.0,-87.0,-91.0,34.0,43.0,37.0,50.0,1
2396,F8:59:71:5A:E0:3D,3505113,822399017,274489,414362646,3230624,408036371,4,273929,372725206,269005,372136988,4924,588218,250021,20,277242,7312,4,852,144444.0,43333.0,-66.0,-73.0,-67.0,-69.0,-66.0,-73.0,-66.0,-69.0,-86.0,-93.0,-87.0,-91.0,20.0,20.0,20.0,22.0,1
2397,CC:2F:71:3E:C5:1F,3242182,409450191,11558,1413820,3230624,408036371,6,49280,4127780,40714,3112838,8566,1014942,12187,36,16561,190,6,858,130000.0,39000.0,-69.0,-72.0,-69.0,-61.0,-68.0,-71.0,-68.0,-60.0,-86.0,-93.0,-87.0,-91.0,17.0,21.0,18.0,30.0,1
2398,CC:2F:71:3F:1F:24,12117862,14038289156,8887227,13630247361,3230635,408041795,158,2024614,1197096317,2015905,1196050017,8709,1046300,1959013,675,8892058,938754,158,6715,86667.0,14444.0,-73.0,-64.0,-75.0,-69.0,-73.0,-64.0,-74.0,-69.0,-86.0,-93.0,-87.0,-91.0,13.0,29.0,12.0,22.0,1
2399,92:69:1D:31:68:E9,3260311,471339088,29671,63296829,3230640,408042259,0,13350,4135262,13216,4113279,134,21983,8531,1,29717,2094,0,157,216660.0,130000.0,-54.0,-51.0,-46.0,-51.0,-50.0,-50.0,-46.0,-49.0,-86.0,-93.0,-87.0,-91.0,32.0,42.0,41.0,40.0,1
2400,BA:8C:B9:54:50:24,3276443,511503269,45803,103461010,3230640,408042259,64,16037,4802001,15889,4777619,148,24382,9939,6,45781,11199,64,242,206470.0,103230.0,-46.0,-50.0,-54.0,-46.0,-48.0,-49.0,-43.0,-46.0,-86.0,-93.0,-87.0,-91.0,40.0,43.0,33.0,45.0,1
2401,62:47:05:9D:EB:15,3248473,450867359,17833,42825100,3230640,408042259,64,7891,1528135,7810,1514451,81,13684,3513,1,17817,2552,64,192,216660.0,130000.0,-43.0,-50.0,-43.0,-44.0,-47.0,-51.0,-47.0,-44.0,-86.0,-93.0,-87.0,-91.0,43.0,43.0,44.0,47.0,1
2402,F8:59:71:5A:E0:3D,3505229,822560305,274589,414518046,3230640,408042259,4,274030,372880788,269106,372292570,4924,588218,250121,20,277343,7320,4,852,144444.0,43333.0,-67.0,-73.0,-67.0,-68.0,-67.0,-73.0,-66.0,-68.0,-86.0,-93.0,-87.0,-91.0,19.0,20.0,20.0,23.0,1
2403,CC:2F:71:3E:C5:1F,3242198,409456079,11558,1413820,3230640,408042259,6,49280,4127780,40714,3112838,8566,1014942,12187,36,16561,190,6,858,130000.0,39000.0,-69.0,-72.0,-69.0,-61.0,-68.0,-71.0,-68.0,-60.0,-86.0,-93.0,-87.0,-91.0,17.0,21.0,18.0,30.0,1
2404,CC:2F:71:3F:1F:24,12119357,14040568984,8888717,13632526725,3230640,408042259,158,2025043,1197448021,2016334,1196401721,8709,1046300,1959431,675,8893550,939038,158,6715,130000.0,43333.0,-73.0,-64.0,-74.0,-71.0,-73.0,-63.0,-74.0,-71.0,-86.0,-93.0,-87.0,-91.0,13.0,29.0,13.0,20.0,1
2405,92:69:1D:31:68:E9,3260317,471339614,29671,63296829,3230646,408042785,0,13350,4135262,13216,4113279,134,21983,8531,1,29717,2094,0,157,216660.0,130000.0,-54.0,-51.0,-46.0,-51.0,-50.0,-50.0,-46.0,-49.0,-87.0,-93.0,-88.0,-92.0,33.0,42.0,42.0,41.0,1
2406,BA:8C:B9:54:50:24,3276450,511503881,45803,103461010,3230647,408042871,64,16039,4802137,15891,4777755,148,24382,9939,6,45782,11199,64,242,206470.0,103230.0,-53.0,-51.0,-38.0,-46.0,-49.0,-50.0,-44.0,-46.0,-87.0,-93.0,-88.0,-92.0,34.0,42.0,50.0,46.0,1
2407,62:47:05:9D:EB:15,3248482,450868306,17833,42825100,3230649,408043206,64,7920,1530161,7838,1516355,82,13806,3514,1,17817,2552,64,198,216660.0,130000.0,-44.0,-50.0,-43.0,-44.0,-46.0,-52.0,-46.0,-45.0,-87.0,-93.0,-88.0,-92.0,43.0,43.0,45.0,48.0,1
2408,F8:59:71:5A:E0:3D,3505325,822696450,274676,414653244,3230649,408043206,4,274118,373016350,269194,372428132,4924,588218,250208,20,277429,7321,4,852,144444.0,43333.0,-67.0,-73.0,-67.0,-68.0,-67.0,-73.0,-67.0,-68.0,-87.0,-93.0,-88.0,-92.0,20.0,20.0,21.0,24.0,1
2409,CC:2F:71:3E:C5:1F,3242209,409457226,11558,1413820,3230651,408043406,6,49282,4127920,40716,3112978,8566,1014942,12187,36,16562,190,6,858,130000.0,39000.0,-68.0,-70.0,-67.0,-60.0,-68.0,-71.0,-69.0,-61.0,-87.0,-93.0,-88.0,-92.0,19.0,23.0,21.0,32.0,1
2410,CC:2F:71:3F:1F:24,12120650,14042519965,8889997,13634476357,3230653,408043608,158,2025402,1197737145,2016689,1196690277,8713,1046868,1959787,675,8894830,939085,158,6715,130000.0,43333.0,-74.0,-64.0,-75.0,-72.0,-73.0,-63.0,-74.0,-72.0,-87.0,-93.0,-88.0,-92.0,13.0,29.0,13.0,20.0,1
2411,92:69:1D:31:68:E9,3260329,471340903,29671,63296829,3230658,408044074,0,13353,4135520,13218,4113415,135,22105,8532,1,29717,2094,0,157,216660.0,130000.0,-54.0,-51.0,-46.0,-50.0,-52.0,-50.0,-46.0,-49.0,-88.0,-93.0,-88.0,-92.0,34.0,42.0,42.0,42.0,1
2412,BA:8C:B9:54:50:24,3276462,511505144,45803,103461010,3230659,408044134,64,16039,4802137,15891,4777755,148,24382,9939,6,45782,11199,64,242,206470.0,103230.0,-53.0,-51.0,-38.0,-46.0,-49.0,-50.0,-44.0,-46.0,-88.0,-93.0,-88.0,-92.0,35.0,42.0,50.0,46.0,1
2413,62:47:05:9D:EB:15,3248494,450869436,17833,42825100,3230661,408044336,64,7920,1530161,7838,1516355,82,13806,3514,1,17817,2552,64,198,216660.0,130000.0,-44.0,-50.0,-43.0,-44.0,-46.0,-52.0,-46.0,-45.0,-88.0,-93.0,-88.0,-92.0,44.0,43.0,45.0,48.0,1
2414,F8:59:71:5A:E0:3D,3505424,822832778,274763,414788442,3230661,408044336,4,274207,373152002,269282,372563666,4925,588336,250296,20,277517,7322,4,852,144444.0,43333.0,-67.0,-73.0,-67.0,-68.0,-67.0,-73.0,-67.0,-68.0,-88.0,-93.0,-88.0,-92.0,21.0,20.0,21.0,24.0,1
2415,CC:2F:71:3E:C5:1F,3242219,409458156,11558,1413820,3230661,408044336,6,49282,4127920,40716,3112978,8566,1014942,12187,36,16562,190,6,858,130000.0,39000.0,-68.0,-70.0,-67.0,-60.0,-68.0,-71.0,-69.0,-61.0,-88.0,-93.0,-88.0,-92.0,20.0,23.0,21.0,32.0,1
2416,CC:2F:71:3F:1F:24,12122186,14044851164,8891525,13636806828,3230661,408044336,158,2025822,1198040624,2017109,1196993756,8713,1046868,1960207,675,8896319,939140,158,6715,144444.0,43333.0,-73.0,-64.0,-75.0,-72.0,-73.0,-63.0,-75.0,-72.0,-88.0,-93.0,-88.0,-92.0,15.0,29.0,13.0,20.0,1
2417,92:69:1D:31:68:E9,3260337,471341680,29671,63296829,3230666,408044851,0,13353,4135520,13218,4113415,135,22105,8532,1,29717,2094,0,157,216660.0,130000.0,-54.0,-51.0,-46.0,-50.0,-52.0,-50.0,-46.0,-49.0,-88.0,-93.0,-88.0,-92.0,34.0,42.0,42.0,42.0,1
2418,BA:8C:B9:54:50:24,3276470,511505972,45803,103461010,3230667,408044962,64,16044,4802580,15895,4778027,149,24553,9940,6,45782,11199,64,242,206470.0,103230.0,-46.0,-50.0,-54.0,-46.0,-48.0,-50.0,-48.0,-47.0,-88.0,-93.0,-88.0,-92.0,42.0,43.0,34.0,46.0,1
2419,62:47:05:9D:EB:15,3248500,450870062,17833,42825100,3230667,408044962,64,7920,1530161,7838,1516355,82,13806,3514,1,17817,2552,64,198,216660.0,130000.0,-44.0,-50.0,-43.0,-44.0,-46.0,-52.0,-46.0,-45.0,-88.0,-93.0,-88.0,-92.0,44.0,43.0,45.0,48.0,1
2420,F8:59:71:5A:E0:3D,3505528,822985696,274861,414940734,3230667,408044962,4,274305,373303048,269380,372714712,4925,588336,250394,20,277615,7326,4,852,144444.0,43333.0,-67.0,-73.0,-67.0,-68.0,-67.0,-73.0,-67.0,-68.0,-88.0,-93.0,-88.0,-92.0,21.0,20.0,21.0,24.0,1
2421,CC:2F:71:3E:C5:1F,3242225,409458782,11558,1413820,3230667,408044962,6,49282,4127920,40716,3112978,8566,1014942,12187,36,16562,190,6,858,130000.0,39000.0,-68.0,-70.0,-67.0,-60.0,-68.0,-71.0,-69.0,-61.0,-88.0,-93.0,-88.0,-92.0,20.0,23.0,21.0,32.0,1
2422,CC:2F:71:3F:1F:24,12123887,14047457220,8893220,13639412258,3230667,408044962,158,2026235,1198367086,2017522,1197320218,8713,1046868,1960619,675,8898053,939444,158,6716,115556.0,28889.0,-71.0,-64.0,-73.0,-71.0,-70.0,-63.0,-73.0,-70.0,-88.0,-93.0,-88.0,-92.0,17.0,29.0,15.0,21.0,1
2423,92:69:1D:31:68:E9,3260342,471342195,29671,63296829,3230671,408045366,0,13360,4136099,13224,4113823,136,22276,8533,1,29717,2094,0,157,216660.0,130000.0,-52.0,-52.0,-52.0,-55.0,-53.0,-51.0,-47.0,-51.0,-88.0,-93.0,-89.0,-92.0,36.0,41.0,37.0,37.0,1
2424,BA:8C:B9:54:50:24,3276475,511506436,45803,103461010,3230672,408045426,64,16044,4802580,15895,4778027,149,24553,9940,6,45782,11199,64,242,206470.0,103230.0,-46.0,-50.0,-54.0,-46.0,-48.0,-50.0,-48.0,-47.0,-88.0,-93.0,-89.0,-92.0,42.0,43.0,35.0,46.0,1
2425,62:47:05:9D:EB:15,3248506,450870624,17834,42825198,3230672,408045426,64,7949,1532191,7867,1518385,82,13806,3515,1,17818,2552,64,199,216660.0,130000.0,-43.0,-50.0,-43.0,-45.0,-42.0,-49.0,-43.0,-41.0,-88.0,-93.0,-89.0,-92.0,45.0,43.0,46.0,47.0,1
2426,F8:59:71:5A:E0:3D,3505620,823121358,274948,415075932,3230672,408045426,4,274395,373441830,269470,372853494,4925,588336,250481,20,277702,7330,4,855,144444.0,43333.0,-67.0,-73.0,-67.0,-69.0,-67.0,-73.0,-67.0,-69.0,-88.0,-93.0,-89.0,-92.0,21.0,20.0,22.0,23.0,1
2427,CC:2F:71:3E:C5:1F,3242230,409459246,11558,1413820,3230672,408045426,6,49282,4127920,40716,3112978,8566,1014942,12187,36,16562,190,6,858,130000.0,39000.0,-68.0,-70.0,-67.0,-60.0,-68.0,-71.0,-69.0,-61.0,-88.0,-93.0,-89.0,-92.0,20.0,23.0,22.0,32.0,1
2428,CC:2F:71:3F:1F:24,12125268,14049563220,8894596,13641517794,3230672,408045426,158,2026606,1198656380,2017893,1197609512,8713,1046868,1960989,675,8899429,939517,158,6718,115556.0,28889.0,-72.0,-64.0,-73.0,-69.0,-72.0,-64.0,-73.0,-69.0,-88.0,-93.0,-89.0,-92.0,16.0,29.0,16.0,23.0,1
2429,92:69:1D:31:68:E9,3260363,471360351,29687,63314521,3230676,408045830,0,13370,4139277,13234,4117001,136,22276,8538,1,29733,2094,0,157,229410.0,130000.0,-53.0,-51.0,-45.0,-51.0,-50.0,-51.0,-47.0,-50.0,-89.0,-93.0,-89.0,-92.0,36.0,42.0,44.0,41.0,1
2430,BA:8C:B9:54:50:24,3276479,511506840,45803,103461010,3230676,408045830,64,16044,4802580,15895,4778027,149,24553,9940,6,45782,11199,64,242,206470.0,103230.0,-46.0,-50.0,-54.0,-46.0,-48.0,-50.0,-48.0,-47.0,-89.0,-93.0,-89.0,-92.0,43.0,43.0,35.0,46.0,1
2431,62:47:05:9D:EB:15,3248514,450871432,17834,42825198,3230680,408046234,64,7949,1532191,7867,1518385,82,13806,3515,1,17818,2552,64,199,216660.0,130000.0,-43.0,-50.0,-43.0,-45.0,-42.0,-49.0,-43.0,-41.0,-89.0,-93.0,-89.0,-92.0,46.0,43.0,46.0,47.0,1
2432,F8:59:71:5A:E0:3D,3505708,823246486,275028,415200252,3230680,408046234,4,274476,373566640,269551,372978304,4925,588336,250561,20,277782,7333,4,855,144444.0,43333.0,-66.0,-73.0,-67.0,-69.0,-66.0,-72.0,-66.0,-69.0,-89.0,-93.0,-89.0,-92.0,23.0,20.0,22.0,23.0,1
2433,CC:2F:71:3E:C5:1F,3242238,409460054,11558,1413820,3230680,408046234,6,49282,4127920,40716,3112978,8566,1014942,12187,36,16562,190,6,858,130000.0,39000.0,-68.0,-70.0,-67.0,-60.0,-68.0,-71.0,-69.0,-61.0,-89.0,-93.0,-89.0,-92.0,21.0,23.0,22.0,32.0,1
2434,CC:2F:71:3F:1F:24,12126316,14051125983,8895636,13643079749,3230680,408046234,158,2027001,1198960400,2018288,1197913532,8713,1046868,1961372,675,8900451,939648,158,6719,86667.0,14444.0,-71.0,-65.0,-73.0,-71.0,-71.0,-64.0,-72.0,-70.0,-89.0,-93.0,-89.0,-92.0,18.0,28.0,16.0,21.0,1
2435,92:69:1D:31:68:E9,3260367,471360755,29687,63314521,3230680,408046234,0,13370,4139277,13234,4117001,136,22276,8538,1,29733,2094,0,157,229410.0,130000.0,-53.0,-51.0,-45.0,-51.0,-50.0,-51.0,-47.0,-50.0,-89.0,-93.0,-89.0,-92.0,36.0,42.0,44.0,41.0,1
2436,BA:8C:B9:54:50:24,3276485,511507446,45803,103461010,3230682,408046436,64,16044,4802580,15895,4778027,149,24553,9940,6,45782,11199,64,242,206470.0,103230.0,-46.0,-50.0,-54.0,-46.0,-48.0,-50.0,-48.0,-47.0,-89.0,-93.0,-89.0,-92.0,43.0,43.0,35.0,46.0,1
2437,62:47:05:9D:EB:15,3248521,450872372,17837,42825734,3230684,408046638,64,7954,1532699,7872,1518893,82,13806,3518,1,17821,2552,64,199,216660.0,130000.0,-43.0,-50.0,-43.0,-44.0,-43.0,-50.0,-44.0,-43.0,-89.0,-93.0,-89.0,-92.0,46.0,43.0,46.0,48.0,1
2438,F8:59:71:5A:E0:3D,3505802,823385256,275117,415338558,3230685,408046698,4,274565,373703728,269640,373115392,4925,588336,250650,20,277871,7336,4,855,144444.0,43333.0,-67.0,-73.0,-67.0,-69.0,-67.0,-72.0,-67.0,-69.0,-89.0,-93.0,-89.0,-92.0,22.0,20.0,22.0,23.0,1
2439,CC:2F:71:3E:C5:1F,3242243,409460518,11558,1413820,3230685,408046698,6,49282,4127920,40716,3112978,8566,1014942,12187,36,16562,190,6,858,130000.0,39000.0,-68.0,-70.0,-67.0,-60.0,-68.0,-71.0,-69.0,-61.0,-89.0,-93.0,-89.0,-92.0,21.0,23.0,22.0,32.0,1
2440,CC:2F:71:3F:1F:24,12127500,14052886856,8896811,13644839754,3230689,408047102,158,2027482,1199373618,2018769,1198326750,8713,1046868,1961837,675,8901644,939706,158,6720,130000.0,43333.0,-71.0,-64.0,-73.0,-70.0,-71.0,-63.0,-73.0,-69.0,-89.0,-93.0,-89.0,-92.0,18.0,29.0,16.0,22.0,1
2441,92:69:1D:31:68:E9,3260376,471361623,29687,63314521,3230689,408047102,0,13370,4139277,13234,4117001,136,22276,8538,1,29733,2094,0,157,229410.0,130000.0,-53.0,-51.0,-45.0,-51.0,-50.0,-51.0,-47.0,-50.0,-89.0,-93.0,-89.0,-92.0,36.0,42.0,44.0,41.0,1
2442,BA:8C:B9:54:50:24,3276492,511508112,45803,103461010,3230689,408047102,64,16044,4802580,15895,4778027,149,24553,9940,6,45782,11199,64,242,206470.0,103230.0,-46.0,-50.0,-54.0,-46.0,-48.0,-50.0,-48.0,-47.0,-89.0,-93.0,-89.0,-92.0,43.0,43.0,35.0,46.0,1
2443,62:47:05:9D:EB:15,3248945,451982838,18256,43935736,3230689,408047102,64,8012,1543996,7930,1530190,82,13806,3561,1,18240,2624,64,199,229410.0,130000.0,-43.0,-50.0,-43.0,-45.0,-45.0,-52.0,-46.0,-45.0,-89.0,-93.0,-89.0,-92.0,46.0,43.0,46.0,47.0,1
2444,F8:59:71:5A:E0:3D,3505924,823569032,275235,415521930,3230689,408047102,4,274684,373887086,269759,373298750,4925,588336,250769,20,277989,7338,4,855,144444.0,43333.0,-67.0,-73.0,-67.0,-69.0,-67.0,-73.0,-67.0,-69.0,-89.0,-93.0,-89.0,-92.0,22.0,20.0,22.0,23.0,1
2445,CC:2F:71:3E:C5:1F,3242248,409461033,11558,1413820,3230690,408047213,6,49282,4127920,40716,3112978,8566,1014942,12187,36,16562,190,6,858,130000.0,39000.0,-68.0,-70.0,-67.0,-60.0,-68.0,-71.0,-69.0,-61.0,-89.0,-93.0,-89.0,-92.0,21.0,23.0,22.0,32.0,1
2446,CC:2F:71:3F:1F:24,12128769,14054803596,8898075,13646755979,3230694,408047617,158,2027865,1199666063,2019152,1198619195,8713,1046868,1962205,675,8902894,940028,158,6721,130000.0,39000.0,-71.0,-64.0,-72.0,-70.0,-71.0,-64.0,-72.0,-69.0,-89.0,-93.0,-89.0,-92.0,18.0,29.0,17.0,22.0,1
2447,92:69:1D:31:68:E9,3260386,471362602,29687,63314521,3230699,408048081,0,13370,4139277,13234,4117001,136,22276,8538,1,29733,2094,0,157,229410.0,130000.0,-53.0,-51.0,-45.0,-51.0,-50.0,-51.0,-47.0,-50.0,-89.0,-93.0,-89.0,-92.0,36.0,42.0,44.0,41.0,1
2448,BA:8C:B9:54:50:24,3276502,511509091,45803,103461010,3230699,408048081,64,16044,4802580,15895,4778027,149,24553,9940,6,45782,11199,64,242,206470.0,103230.0,-46.0,-50.0,-54.0,-46.0,-48.0,-50.0,-48.0,-47.0,-89.0,-93.0,-89.0,-92.0,43.0,43.0,35.0,46.0,1
2449,62:47:05:9D:EB:15,3248955,451983817,18256,43935736,3230699,408048081,64,8016,1544371,7933,1530394,83,13977,3562,1,18240,2624,64,199,229410.0,130000.0,-43.0,-50.0,-43.0,-45.0,-45.0,-51.0,-45.0,-45.0,-89.0,-93.0,-89.0,-92.0,46.0,43.0,46.0,47.0,1
2450,F8:59:71:5A:E0:3D,3506018,823700379,275319,415652298,3230699,408048081,4,274765,374011826,269840,373423490,4925,588336,250850,20,278070,7338,4,855,144444.0,43333.0,-68.0,-73.0,-67.0,-70.0,-67.0,-73.0,-67.0,-70.0,-89.0,-93.0,-89.0,-92.0,21.0,20.0,22.0,22.0,1
2451,CC:2F:71:3E:C5:1F,3242257,409461901,11558,1413820,3230699,408048081,6,49282,4127920,40716,3112978,8566,1014942,12187,36,16562,190,6,858,130000.0,39000.0,-68.0,-70.0,-67.0,-60.0,-68.0,-71.0,-69.0,-61.0,-89.0,-93.0,-89.0,-92.0,21.0,23.0,22.0,32.0,1
2452,CC:2F:71:3F:1F:24,12130554,14057512783,8899855,13649464702,3230699,408048081,158,2028356,1199989940,2019643,1198943072,8713,1046868,1962663,675,8904688,940151,158,6721,115556.0,28889.0,-71.0,-63.0,-72.0,-69.0,-70.0,-63.0,-72.0,-69.0,-89.0,-93.0,-89.0,-92.0,18.0,30.0,17.0,23.0,1
2453,92:69:1D:31:68:E9,3260390,471363006,29687,63314521,3230703,408048485,0,13370,4139277,13234,4117001,136,22276,8538,1,29733,2094,0,157,229410.0,130000.0,-53.0,-51.0,-45.0,-51.0,-50.0,-51.0,-47.0,-50.0,-89.0,-93.0,-89.0,-92.0,36.0,42.0,44.0,41.0,1
2454,BA:8C:B9:54:50:24,3276506,511509495,45803,103461010,3230703,408048485,64,16044,4802580,15895,4778027,149,24553,9940,6,45782,11199,64,242,206470.0,103230.0,-46.0,-50.0,-54.0,-46.0,-48.0,-50.0,-48.0,-47.0,-89.0,-93.0,-89.0,-92.0,43.0,43.0,35.0,46.0,1
2455,62:47:05:9D:EB:15,3248959,451984221,18256,43935736,3230703,408048485,64,8016,1544371,7933,1530394,83,13977,3562,1,18240,2624,64,199,229410.0,130000.0,-43.0,-50.0,-43.0,-45.0,-45.0,-51.0,-45.0,-45.0,-89.0,-93.0,-89.0,-92.0,46.0,43.0,46.0,47.0,1
2456,F8:59:71:5A:E0:3D,3506117,823846975,275414,415798490,3230703,408048485,4,274863,374161326,269938,373572990,4925,588336,250947,20,278168,7339,4,855,144444.0,43333.0,-68.0,-74.0,-67.0,-70.0,-67.0,-73.0,-67.0,-70.0,-89.0,-93.0,-89.0,-92.0,21.0,19.0,22.0,22.0,1
2457,CC:2F:71:3E:C5:1F,3242261,409462305,11558,1413820,3230703,408048485,6,49282,4127920,40716,3112978,8566,1014942,12187,36,16562,190,6,858,130000.0,39000.0,-68.0,-70.0,-67.0,-60.0,-68.0,-71.0,-69.0,-61.0,-89.0,-93.0,-89.0,-92.0,21.0,23.0,22.0,32.0,1
2458,CC:2F:71:3F:1F:24,12132306,14060075411,8901603,13652026926,3230703,408048485,158,2028923,1200343385,2020210,1199296517,8713,1046868,1963209,675,8906404,940216,158,6721,117000.0,39000.0,-71.0,-64.0,-73.0,-69.0,-71.0,-64.0,-72.0,-69.0,-89.0,-93.0,-89.0,-92.0,18.0,29.0,16.0,23.0,1
2459,92:69:1D:31:68:E9,3260397,471363594,29687,63314521,3230710,408049073,0,13378,4143683,13242,4121407,136,22276,8540,1,29733,2094,0,157,229410.0,130000.0,-50.0,-51.0,-46.0,-48.0,-51.0,-51.0,-46.0,-50.0,-89.0,-93.0,-89.0,-92.0,39.0,42.0,43.0,44.0,1
2460,BA:8C:B9:54:50:24,3276531,511513039,45821,103463966,3230710,408049073,64,16087,4821825,15936,4797028,151,24797,9964,6,45800,11199,64,243,195000.0,97500.0,-46.0,-49.0,-54.0,-46.0,-50.0,-51.0,-45.0,-48.0,-89.0,-93.0,-89.0,-92.0,43.0,44.0,35.0,46.0,1
2461,62:47:05:9D:EB:15,3248966,451984809,18256,43935736,3230710,408049073,64,8016,1544371,7933,1530394,83,13977,3562,1,18240,2624,64,199,229410.0,130000.0,-43.0,-50.0,-43.0,-45.0,-45.0,-51.0,-45.0,-45.0,-89.0,-93.0,-89.0,-92.0,46.0,43.0,46.0,47.0,1
2462,F8:59:71:5A:E0:3D,3506213,823985869,275503,415936796,3230710,408049073,4,274953,374300052,270028,373711716,4925,588336,251036,20,278257,7344,4,856,144444.0,43333.0,-68.0,-73.0,-68.0,-70.0,-68.0,-73.0,-67.0,-70.0,-89.0,-93.0,-89.0,-92.0,21.0,20.0,21.0,22.0,1
2463,CC:2F:71:3E:C5:1F,3242268,409462893,11558,1413820,3230710,408049073,6,49282,4127920,40716,3112978,8566,1014942,12187,36,16562,190,6,858,130000.0,39000.0,-68.0,-70.0,-67.0,-60.0,-68.0,-71.0,-69.0,-61.0,-89.0,-93.0,-89.0,-92.0,21.0,23.0,22.0,32.0,1
2464,CC:2F:71:3F:1F:24,12134122,14062808904,8903412,13654759831,3230710,408049073,158,2029410,1200663098,2020697,1199616230,8713,1046868,1963690,675,8908245,940305,158,6721,115556.0,28889.0,-71.0,-64.0,-72.0,-70.0,-70.0,-63.0,-72.0,-69.0,-88.0,-93.0,-89.0,-92.0,17.0,29.0,17.0,22.0,1
2465,92:69:1D:31:68:E9,3260412,471367602,29693,63317546,3230719,408050056,0,13391,4145123,13254,4122612,137,22511,8545,1,29739,2094,0,157,229410.0,130000.0,-49.0,-49.0,-45.0,-48.0,-51.0,-50.0,-46.0,-49.0,-88.0,-93.0,-89.0,-92.0,39.0,44.0,44.0,44.0,1
2466,BA:8C:B9:54:50:24,3276541,511514295,45821,103463966,3230720,408050329,64,16087,4821825,15936,4797028,151,24797,9964,6,45800,11199,64,243,195000.0,97500.0,-46.0,-49.0,-54.0,-46.0,-50.0,-51.0,-45.0,-48.0,-88.0,-93.0,-89.0,-92.0,42.0,44.0,35.0,46.0,1
2467,62:47:05:9D:EB:15,3248976,451986065,18256,43935736,3230720,408050329,64,8016,1544371,7933,1530394,83,13977,3562,1,18240,2624,64,199,229410.0,130000.0,-43.0,-50.0,-43.0,-45.0,-45.0,-51.0,-45.0,-45.0,-88.0,-93.0,-89.0,-92.0,45.0,43.0,46.0,47.0,1
2468,F8:59:71:5A:E0:3D,3506318,824133317,275598,416082988,3230720,408050329,4,275050,374448012,270125,373859676,4925,588336,251132,20,278352,7344,4,856,144444.0,43333.0,-68.0,-74.0,-68.0,-70.0,-68.0,-73.0,-67.0,-70.0,-88.0,-93.0,-89.0,-92.0,20.0,19.0,21.0,22.0,1
2469,CC:2F:71:3E:C5:1F,3242278,409464149,11558,1413820,3230720,408050329,6,49282,4127920,40716,3112978,8566,1014942,12187,36,16562,190,6,858,130000.0,39000.0,-68.0,-70.0,-67.0,-60.0,-68.0,-71.0,-69.0,-61.0,-88.0,-93.0,-89.0,-92.0,20.0,23.0,22.0,32.0,1
2470,CC:2F:71:3F:1F:24,12136159,14065857574,8905439,13657807245,3230720,408050329,158,2029981,1201021147,2021268,1199974279,8713,1046868,1964251,675,8910272,940558,158,6721,130000.0,43333.0,-70.0,-63.0,-72.0,-70.0,-70.0,-63.0,-72.0,-69.0,-88.0,-93.0,-88.0,-92.0,18.0,30.0,16.0,22.0,1
2471,92:69:1D:31:68:E9,3260423,471377145,29698,63326352,3230725,408050793,0,13395,4145582,13258,4123071,137,22511,8548,1,29744,2094,0,157,229410.0,130000.0,-52.0,-53.0,-52.0,-55.0,-50.0,-50.0,-45.0,-49.0,-88.0,-93.0,-88.0,-92.0,36.0,40.0,36.0,37.0,1
2472,BA:8C:B9:54:50:24,3276548,511516160,45823,103465367,3230725,408050793,64,16091,4822336,15940,4797539,151,24797,9966,6,45802,11200,64,243,206470.0,97500.0,-46.0,-50.0,-54.0,-46.0,-49.0,-50.0,-46.0,-48.0,-88.0,-93.0,-88.0,-92.0,42.0,43.0,34.0,46.0,1
2473,62:47:05:9D:EB:15,3248981,451986529,18256,43935736,3230725,408050793,64,8018,1544507,7935,1530530,83,13977,3562,1,18240,2624,64,199,229410.0,130000.0,-43.0,-50.0,-43.0,-44.0,-44.0,-50.0,-44.0,-44.0,-88.0,-93.0,-88.0,-92.0,45.0,43.0,45.0,48.0,1
2474,F8:59:71:5A:E0:3D,3506411,824270533,275686,416219740,3230725,408050793,4,275139,374585114,270214,373996778,4925,588336,251220,20,278440,7346,4,856,144444.0,43333.0,-68.0,-73.0,-68.0,-70.0,-67.0,-73.0,-67.0,-69.0,-88.0,-93.0,-88.0,-92.0,20.0,20.0,20.0,22.0,1
2475,CC:2F:71:3E:C5:1F,3242283,409464613,11558,1413820,3230725,408050793,6,49282,4127920,40716,3112978,8566,1014942,12187,36,16562,190,6,858,130000.0,39000.0,-68.0,-70.0,-67.0,-60.0,-68.0,-71.0,-69.0,-61.0,-88.0,-93.0,-88.0,-92.0,20.0,23.0,21.0,32.0,1
2476,CC:2F:71:3F:1F:24,12137610,14067945378,8906881,13659894181,3230729,408051197,158,2030510,1201380740,2021797,1200333872,8713,1046868,1964768,675,8911713,940943,158,6722,130000.0,43333.0,-72.0,-64.0,-73.0,-70.0,-71.0,-63.0,-72.0,-69.0,-88.0,-93.0,-88.0,-92.0,16.0,29.0,15.0,22.0,1
2477,92:69:1D:31:68:E9,3260428,471377665,29699,63326468,3230729,408051197,0,13396,4145650,13259,4123139,137,22511,8548,1,29745,2094,0,157,229410.0,130000.0,-53.0,-51.0,-45.0,-50.0,-50.0,-50.0,-45.0,-49.0,-88.0,-93.0,-88.0,-92.0,35.0,42.0,43.0,42.0,1
2478,BA:8C:B9:54:50:24,3276552,511516564,45823,103465367,3230729,408051197,64,16091,4822336,15940,4797539,151,24797,9966,6,45802,11200,64,243,206470.0,97500.0,-46.0,-50.0,-54.0,-46.0,-49.0,-50.0,-46.0,-48.0,-88.0,-93.0,-88.0,-92.0,42.0,43.0,34.0,46.0,1
2479,62:47:05:9D:EB:15,3248988,451987333,18259,43936136,3230729,408051197,64,8022,1544907,7939,1530930,83,13977,3564,1,18243,2624,64,199,229410.0,130000.0,-52.0,-50.0,-50.0,-41.0,-46.0,-50.0,-46.0,-44.0,-88.0,-93.0,-88.0,-92.0,36.0,43.0,38.0,51.0,1
2480,F8:59:71:5A:E0:3D,3506523,824437331,275794,416386134,3230729,408051197,4,275246,374750244,270321,374161908,4925,588336,251327,20,278548,7348,4,856,144444.0,43333.0,-67.0,-72.0,-67.0,-69.0,-67.0,-72.0,-67.0,-69.0,-87.0,-93.0,-88.0,-93.0,20.0,21.0,21.0,24.0,1
2481,CC:2F:71:3E:C5:1F,3242290,409465335,11559,1413936,3230731,408051399,6,49284,4128060,40718,3113118,8566,1014942,12187,36,16563,190,6,858,130000.0,39000.0,-68.0,-72.0,-69.0,-66.0,-68.0,-71.0,-69.0,-61.0,-87.0,-93.0,-88.0,-93.0,19.0,21.0,19.0,27.0,1
2482,CC:2F:71:3F:1F:24,12139090,14070165674,8908357,13662114073,3230733,408051601,158,2030926,1201700719,2022213,1200653851,8713,1046868,1965184,675,8913146,941159,158,6722,115556.0,28889.0,-71.0,-64.0,-73.0,-70.0,-71.0,-64.0,-73.0,-70.0,-87.0,-93.0,-88.0,-93.0,16.0,29.0,15.0,23.0,1
2483,92:69:1D:31:68:E9,3260437,471378533,29699,63326468,3230738,408052065,0,13397,4145718,13260,4123207,137,22511,8548,1,29745,2094,0,157,229410.0,130000.0,-53.0,-51.0,-45.0,-50.0,-50.0,-50.0,-45.0,-49.0,-87.0,-93.0,-88.0,-93.0,34.0,42.0,43.0,43.0,1
2484,BA:8C:B9:54:50:24,3276563,511517610,45824,103465483,3230739,408052127,64,16093,4822472,15942,4797675,151,24797,9966,6,45803,11200,64,243,206470.0,97500.0,-46.0,-50.0,-54.0,-46.0,-48.0,-50.0,-48.0,-47.0,-87.0,-93.0,-88.0,-93.0,41.0,43.0,34.0,47.0,1
2485,62:47:05:9D:EB:15,3248998,451988263,18259,43936136,3230739,408052127,64,8032,1545587,7949,1531610,83,13977,3564,1,18243,2624,64,199,229410.0,130000.0,-43.0,-50.0,-43.0,-44.0,-43.0,-48.0,-43.0,-40.0,-87.0,-93.0,-88.0,-93.0,44.0,43.0,45.0,49.0,1
2486,F8:59:71:5A:E0:3D,3506627,824584337,275888,416532210,3230739,408052127,4,275340,374893722,270414,374305268,4926,588454,251421,20,278642,7348,4,856,144444.0,43333.0,-67.0,-73.0,-67.0,-70.0,-67.0,-73.0,-66.0,-69.0,-87.0,-93.0,-88.0,-92.0,20.0,20.0,21.0,22.0,1
2487,CC:2F:71:3E:C5:1F,3242298,409466063,11559,1413936,3230739,408052127,6,49284,4128060,40718,3113118,8566,1014942,12187,36,16563,190,6,858,130000.0,39000.0,-68.0,-72.0,-69.0,-66.0,-68.0,-71.0,-69.0,-61.0,-87.0,-93.0,-88.0,-92.0,19.0,21.0,19.0,26.0,1
2488,CC:2F:71:3F:1F:24,12142260,14075024394,8911521,13666972267,3230739,408052127,158,2031686,1202093098,2022973,1201046230,8713,1046868,1965922,675,8916350,941472,158,6723,115556.0,28889.0,-71.0,-63.0,-73.0,-69.0,-70.0,-63.0,-72.0,-69.0,-87.0,-93.0,-88.0,-92.0,16.0,30.0,15.0,23.0,1
2489,92:69:1D:31:68:E9,3260442,471378999,29699,63326468,3230743,408052531,0,13397,4145718,13260,4123207,137,22511,8548,1,29745,2094,0,157,229410.0,130000.0,-53.0,-51.0,-45.0,-50.0,-50.0,-50.0,-45.0,-49.0,-87.0,-93.0,-88.0,-92.0,34.0,42.0,43.0,42.0,1
2490,BA:8C:B9:54:50:24,3276568,511518130,45825,103465599,3230743,408052531,64,16096,4822714,15945,4797917,151,24797,9967,6,45804,11200,64,243,206470.0,97500.0,-46.0,-50.0,-53.0,-46.0,-47.0,-50.0,-49.0,-46.0,-87.0,-93.0,-88.0,-92.0,41.0,43.0,35.0,46.0,1
2491,62:47:05:9D:EB:15,3249018,451999062,18275,43946531,3230743,408052531,64,8063,1559788,7980,1545811,83,13977,3585,1,18259,2624,64,199,229410.0,137640.0,-47.0,-53.0,-47.0,-46.0,-46.0,-53.0,-47.0,-46.0,-86.0,-93.0,-87.0,-92.0,39.0,40.0,40.0,46.0,1
2492,F8:59:71:5A:E0:3D,3506725,824727911,275980,416675178,3230745,408052733,4,275432,375035430,270506,374446976,4926,588454,251511,20,278734,7349,4,856,144444.0,43333.0,-67.0,-73.0,-67.0,-70.0,-67.0,-73.0,-67.0,-69.0,-86.0,-93.0,-87.0,-92.0,19.0,20.0,20.0,22.0,1
2493,CC:2F:71:3E:C5:1F,3242306,409466871,11559,1413936,3230747,408052935,6,49284,4128060,40718,3113118,8566,1014942,12187,36,16563,190,6,858,130000.0,39000.0,-68.0,-72.0,-69.0,-66.0,-68.0,-71.0,-69.0,-61.0,-86.0,-93.0,-87.0,-92.0,18.0,21.0,18.0,26.0,1
2494,CC:2F:71:3F:1F:24,12144175,14077876620,8913428,13669823685,3230747,408052935,158,2032248,1202418283,2023535,1201371415,8713,1046868,1966481,675,8918261,941567,158,6723,115556.0,28889.0,-70.0,-63.0,-71.0,-69.0,-70.0,-63.0,-71.0,-69.0,-86.0,-93.0,-87.0,-92.0,16.0,30.0,16.0,23.0,1
2495,92:69:1D:31:68:E9,3260447,471379463,29699,63326468,3230748,408052995,0,13397,4145718,13260,4123207,137,22511,8548,1,29745,2094,0,157,229410.0,130000.0,-53.0,-51.0,-45.0,-50.0,-50.0,-50.0,-45.0,-49.0,-86.0,-93.0,-87.0,-92.0,33.0,42.0,42.0,42.0,1
2496,BA:8C:B9:54:50:24,3276573,511518594,45825,103465599,3230748,408052995,64,16097,4822782,15946,4797985,151,24797,9967,6,45804,11200,64,243,206470.0,97500.0,-46.0,-50.0,-54.0,-46.0,-47.0,-50.0,-50.0,-46.0,-86.0,-93.0,-87.0,-92.0,40.0,43.0,33.0,46.0,1
2497,62:47:05:9D:EB:15,3249439,453094096,18691,45041101,3230748,408052995,64,8140,1570750,8057,1556773,83,13977,3621,1,18675,2680,64,201,229410.0,137640.0,-42.0,-49.0,-42.0,-41.0,-42.0,-48.0,-42.0,-41.0,-86.0,-93.0,-87.0,-92.0,44.0,44.0,45.0,51.0,1
2498,F8:59:71:5A:E0:3D,3506814,824861817,276066,416808822,3230748,408052995,4,275524,375177180,270598,374588726,4926,588454,251600,20,278820,7351,4,856,144444.0,43333.0,-67.0,-73.0,-67.0,-70.0,-67.0,-72.0,-66.0,-69.0,-86.0,-93.0,-87.0,-92.0,19.0,20.0,20.0,22.0,1
2499,CC:2F:71:3E:C5:1F,3242309,409467133,11559,1413936,3230750,408053197,6,49284,4128060,40718,3113118,8566,1014942,12187,36,16563,190,6,858,130000.0,39000.0,-68.0,-72.0,-69.0,-66.0,-68.0,-71.0,-69.0,-61.0,-86.0,-93.0,-87.0,-92.0,18.0,21.0,18.0,26.0,1
2500,CC:2F:71:3F:1F:24,12145784,14080245988,8915034,13672192791,3230750,408053197,158,2032755,1202728930,2024042,1201682062,8713,1046868,1966972,675,8919845,941643,158,6723,115556.0,28889.0,-71.0,-63.0,-72.0,-69.0,-70.0,-63.0,-72.0,-69.0,-86.0,-93.0,-87.0,-92.0,15.0,30.0,15.0,23.0,1
2501,92:69:1D:31:68:E9,3260465,471381201,29699,63326468,3230766,408054733,0,13397,4145718,13260,4123207,137,22511,8548,1,29745,2094,0,157,229410.0,130000.0,-53.0,-51.0,-45.0,-50.0,-50.0,-50.0,-45.0,-49.0,-84.0,-93.0,-86.0,-91.0,31.0,42.0,41.0,41.0,1
2502,BA:8C:B9:54:50:24,3276591,511520332,45825,103465599,3230766,408054733,64,16101,4823170,15950,4798373,151,24797,9968,6,45804,11200,64,243,206470.0,97500.0,-53.0,-51.0,-38.0,-46.0,-49.0,-50.0,-46.0,-46.0,-84.0,-93.0,-86.0,-91.0,31.0,42.0,48.0,45.0,1
2503,62:47:05:9D:EB:15,3249602,453269239,18836,45214506,3230766,408054733,64,8360,1597784,8277,1583807,83,13977,3691,1,18820,2703,64,221,229410.0,137640.0,-43.0,-50.0,-42.0,-44.0,-42.0,-48.0,-42.0,-40.0,-84.0,-93.0,-86.0,-91.0,41.0,43.0,44.0,47.0,1
2504,F8:59:71:5A:E0:3D,3507048,825197818,276282,417143085,3230766,408054733,4,275745,375517725,270819,374929271,4926,588454,251799,20,279036,7352,4,859,144444.0,43333.0,-67.0,-73.0,-66.0,-70.0,-67.0,-73.0,-66.0,-70.0,-84.0,-93.0,-86.0,-91.0,17.0,20.0,20.0,21.0,1
2505,CC:2F:71:3E:C5:1F,3242326,409468822,11560,1414089,3230766,408054733,6,49288,4128495,40721,3113435,8567,1015060,12188,36,16564,190,6,858,1000.0,39000.0,-69.0,-71.0,-69.0,-60.0,-69.0,-72.0,-69.0,-63.0,-84.0,-93.0,-86.0,-91.0,15.0,22.0,17.0,31.0,1
2506,CC:2F:71:3F:1F:24,12147509,14082860601,8916743,13674805868,3230766,408054733,158,2033451,1203460465,2024738,1202413597,8713,1046868,1967645,675,8921576,941847,158,6726,115556.0,28889.0,-71.0,-64.0,-73.0,-70.0,-71.0,-64.0,-72.0,-70.0,-84.0,-93.0,-86.0,-91.0,13.0,29.0,13.0,21.0,1
2507,92:69:1D:31:68:E9,3260468,471381556,29700,63326621,3230768,408054935,0,13401,4146099,13264,4123588,137,22511,8548,1,29746,2094,0,157,1000.0,130000.0,-53.0,-51.0,-46.0,-51.0,-52.0,-51.0,-46.0,-50.0,-84.0,-93.0,-86.0,-91.0,31.0,42.0,40.0,40.0,1
2508,BA:8C:B9:54:50:24,3276594,511520687,45826,103465752,3230768,408054935,64,16108,4823755,15957,4798958,151,24797,9968,6,45805,11200,64,243,1000.0,97500.0,-47.0,-50.0,-54.0,-46.0,-51.0,-50.0,-42.0,-46.0,-84.0,-93.0,-86.0,-91.0,37.0,43.0,32.0,45.0,1
2509,62:47:05:9D:EB:15,3249607,453269796,18837,45214659,3230770,408055137,64,8364,1598165,8281,1584188,83,13977,3691,1,18821,2703,64,221,1000.0,137640.0,-43.0,-50.0,-42.0,-45.0,-42.0,-49.0,-42.0,-42.0,-84.0,-93.0,-86.0,-91.0,41.0,43.0,44.0,46.0,1
2510,F8:59:71:5A:E0:3D,3507145,825341252,276374,417286053,3230771,408055199,4,275838,375658005,270912,375069551,4926,588454,251890,20,279128,7352,4,859,144444.0,43333.0,-68.0,-74.0,-65.0,-70.0,-67.0,-74.0,-65.0,-70.0,-84.0,-93.0,-86.0,-91.0,16.0,19.0,21.0,21.0,1
2511,CC:2F:71:3E:C5:1F,3242335,409469612,11560,1414089,3230775,408055523,6,49289,4128565,40722,3113505,8567,1015060,12188,36,16564,190,6,858,1000.0,39000.0,-68.0,-72.0,-69.0,-60.0,-69.0,-72.0,-69.0,-62.0,-84.0,-93.0,-86.0,-91.0,16.0,21.0,17.0,31.0,1
2512,CC:2F:71:3F:1F:24,12148842,14084868196,8918064,13676812409,3230778,408055787,158,2033853,1203792253,2025139,1202745267,8714,1046986,1968043,675,8922897,942137,158,6726,86667.0,14444.0,-70.0,-64.0,-71.0,-69.0,-69.0,-64.0,-72.0,-69.0,-84.0,-93.0,-86.0,-91.0,14.0,29.0,15.0,22.0,1
2513,92:69:1D:31:68:E9,3260484,471385974,29706,63330187,3230778,408055787,0,13413,4149433,13275,4126800,138,22633,8554,1,29752,2094,0,157,229410.0,137640.0,-54.0,-51.0,-45.0,-51.0,-51.0,-50.0,-45.0,-50.0,-84.0,-93.0,-86.0,-91.0,30.0,42.0,41.0,40.0,1
2514,BA:8C:B9:54:50:24,3276604,511521539,45826,103465752,3230778,408055787,64,16108,4823755,15957,4798958,151,24797,9968,6,45805,11200,64,243,1000.0,97500.0,-47.0,-50.0,-54.0,-46.0,-51.0,-50.0,-42.0,-46.0,-84.0,-93.0,-86.0,-91.0,37.0,43.0,32.0,45.0,1
2515,62:47:05:9D:EB:15,3249615,453270446,18837,45214659,3230778,408055787,64,8401,1600735,8317,1586636,84,14099,3692,1,18821,2703,64,221,1000.0,137640.0,-52.0,-51.0,-51.0,-41.0,-47.0,-52.0,-48.0,-45.0,-84.0,-93.0,-86.0,-91.0,32.0,42.0,35.0,50.0,1
2516,F8:59:71:5A:E0:3D,3507243,825483254,276465,417427467,3230778,408055787,4,275931,375798285,271005,375209831,4926,588454,251981,20,279219,7352,4,859,144444.0,43333.0,-67.0,-73.0,-66.0,-71.0,-67.0,-73.0,-65.0,-70.0,-84.0,-93.0,-86.0,-91.0,17.0,20.0,20.0,20.0,1
2517,CC:2F:71:3E:C5:1F,3242338,409469876,11560,1414089,3230778,408055787,6,49289,4128565,40722,3113505,8567,1015060,12188,36,16564,190,6,858,1000.0,39000.0,-68.0,-72.0,-69.0,-60.0,-69.0,-72.0,-69.0,-62.0,-84.0,-93.0,-86.0,-91.0,16.0,21.0,17.0,31.0,1
2518,CC:2F:71:3F:1F:24,12150255,14087026774,8919477,13678970987,3230778,408055787,158,2034274,1204079487,2025560,1203032501,8714,1046986,1968463,675,8924309,942172,158,6726,86667.0,14444.0,-70.0,-63.0,-71.0,-70.0,-69.0,-63.0,-71.0,-70.0,-84.0,-93.0,-86.0,-91.0,14.0,30.0,15.0,21.0,1
2519,92:69:1D:31:68:E9,3260493,471387055,29706,63330187,3230787,408056868,0,13413,4149433,13275,4126800,138,22633,8554,1,29752,2094,0,157,229410.0,137640.0,-54.0,-51.0,-45.0,-51.0,-51.0,-50.0,-45.0,-50.0,-83.0,-93.0,-85.0,-91.0,29.0,42.0,40.0,40.0,1
2520,BA:8C:B9:54:50:24,3276615,511522880,45828,103466012,3230787,408056868,64,16114,4824279,15963,4799482,151,24797,9969,6,45807,11200,64,243,206470.0,97500.0,-47.0,-49.0,-54.0,-46.0,-50.0,-50.0,-44.0,-46.0,-83.0,-93.0,-85.0,-91.0,36.0,44.0,31.0,45.0,1
2521,62:47:05:9D:EB:15,3249624,453271527,18837,45214659,3230787,408056868,64,8401,1600735,8317,1586636,84,14099,3692,1,18821,2703,64,221,1000.0,137640.0,-52.0,-51.0,-51.0,-41.0,-47.0,-52.0,-48.0,-45.0,-83.0,-93.0,-85.0,-91.0,31.0,42.0,34.0,50.0,1
2522,F8:59:71:5A:E0:3D,3507335,825613317,276548,417556449,3230787,408056868,4,276014,375926105,271088,375337651,4926,588454,252064,20,279302,7352,4,859,144444.0,43333.0,-67.0,-73.0,-66.0,-70.0,-67.0,-73.0,-65.0,-70.0,-83.0,-93.0,-85.0,-91.0,16.0,20.0,19.0,21.0,1
2523,CC:2F:71:3E:C5:1F,3242347,409470957,11560,1414089,3230787,408056868,6,49289,4128565,40722,3113505,8567,1015060,12188,36,16564,190,6,858,1000.0,39000.0,-68.0,-72.0,-69.0,-60.0,-69.0,-72.0,-69.0,-62.0,-83.0,-93.0,-85.0,-91.0,15.0,21.0,16.0,31.0,1
2524,CC:2F:71:3F:1F:24,12151687,14089198671,8920899,13681141743,3230788,408056928,158,2034706,1204376861,2025992,1203329875,8714,1046986,1968892,675,8925732,942293,158,6726,86667.0,14444.0,-70.0,-64.0,-72.0,-69.0,-69.0,-64.0,-72.0,-68.0,-83.0,-93.0,-85.0,-91.0,13.0,29.0,13.0,22.0,1
2525,92:69:1D:31:68:E9,3260517,471392307,29720,63334460,3230797,408057847,0,13436,4153140,13297,4130336,139,22804,8572,1,29766,2095,0,158,229410.0,137640.0,-53.0,-51.0,-45.0,-51.0,-50.0,-50.0,-45.0,-49.0,-83.0,-93.0,-85.0,-91.0,30.0,42.0,40.0,40.0,1
2526,BA:8C:B9:54:50:24,3276625,511523859,45828,103466012,3230797,408057847,64,16114,4824279,15963,4799482,151,24797,9969,6,45807,11200,64,243,206470.0,97500.0,-47.0,-49.0,-54.0,-46.0,-50.0,-50.0,-44.0,-46.0,-83.0,-93.0,-85.0,-91.0,36.0,44.0,31.0,45.0,1
2527,62:47:05:9D:EB:15,3249634,453272506,18837,45214659,3230797,408057847,64,8401,1600735,8317,1586636,84,14099,3692,1,18821,2703,64,221,1000.0,137640.0,-52.0,-51.0,-51.0,-41.0,-47.0,-52.0,-48.0,-45.0,-83.0,-93.0,-85.0,-91.0,31.0,42.0,34.0,50.0,1
2528,F8:59:71:5A:E0:3D,3507504,825861270,276707,417803423,3230797,408057847,4,276180,376182865,271254,375594411,4926,588454,252214,20,279461,7356,4,861,144444.0,39000.0,-67.0,-73.0,-65.0,-70.0,-67.0,-73.0,-65.0,-70.0,-83.0,-93.0,-85.0,-91.0,16.0,20.0,20.0,21.0,1
2529,CC:2F:71:3E:C5:1F,3242357,409471936,11560,1414089,3230797,408057847,6,49289,4128565,40722,3113505,8567,1015060,12188,36,16564,190,6,858,1000.0,39000.0,-68.0,-72.0,-69.0,-60.0,-69.0,-72.0,-69.0,-62.0,-83.0,-93.0,-85.0,-91.0,15.0,21.0,16.0,31.0,1
2530,CC:2F:71:3F:1F:24,12152730,14090734375,8921933,13682676528,3230797,408057847,158,2035219,1204917839,2026505,1203870853,8714,1046986,1969383,675,8926766,942557,158,6729,86667.0,14444.0,-72.0,-68.0,-75.0,-72.0,-69.0,-65.0,-73.0,-69.0,-83.0,-93.0,-85.0,-91.0,11.0,25.0,10.0,19.0,1
2531,92:69:1D:31:68:E9,3260522,471392937,29720,63334460,3230802,408058477,0,13436,4153140,13297,4130336,139,22804,8572,1,29766,2095,0,158,229410.0,137640.0,-53.0,-51.0,-45.0,-51.0,-50.0,-50.0,-45.0,-49.0,-83.0,-93.0,-85.0,-91.0,30.0,42.0,40.0,40.0,1
2532,BA:8C:B9:54:50:24,3276630,511524489,45828,103466012,3230802,408058477,64,16114,4824279,15963,4799482,151,24797,9969,6,45807,11200,64,243,206470.0,97500.0,-47.0,-49.0,-54.0,-46.0,-50.0,-50.0,-44.0,-46.0,-83.0,-93.0,-85.0,-91.0,36.0,44.0,31.0,45.0,1
2533,62:47:05:9D:EB:15,3249643,453273540,18837,45214659,3230806,408058881,64,8401,1600735,8317,1586636,84,14099,3692,1,18821,2703,64,221,1000.0,137640.0,-52.0,-51.0,-51.0,-41.0,-47.0,-52.0,-48.0,-45.0,-83.0,-93.0,-85.0,-91.0,31.0,42.0,34.0,50.0,1
2534,F8:59:71:5A:E0:3D,3507602,826000554,276796,417941673,3230806,408058881,4,276265,376313765,271339,375725311,4926,588454,252299,20,279550,7357,4,861,144444.0,43333.0,-67.0,-73.0,-66.0,-69.0,-67.0,-73.0,-65.0,-69.0,-83.0,-93.0,-85.0,-91.0,16.0,20.0,19.0,22.0,1
2535,CC:2F:71:3E:C5:1F,3242366,409472970,11560,1414089,3230806,408058881,6,49289,4128565,40722,3113505,8567,1015060,12188,36,16564,190,6,858,1000.0,39000.0,-68.0,-72.0,-69.0,-60.0,-69.0,-72.0,-69.0,-62.0,-83.0,-93.0,-85.0,-91.0,15.0,21.0,16.0,31.0,1
2536,CC:2F:71:3F:1F:24,12154215,14092991503,8923407,13684932420,3230808,408059083,158,2035651,1205234597,2026937,1204187611,8714,1046986,1969812,675,8928240,942630,158,6730,86667.0,14444.0,-70.0,-65.0,-73.0,-69.0,-69.0,-64.0,-71.0,-68.0,-83.0,-93.0,-85.0,-91.0,13.0,28.0,12.0,22.0,1
2537,92:69:1D:31:68:E9,3260539,471409212,29731,63350129,3230808,408059083,0,13456,4158851,13317,4136047,139,22804,8581,1,29777,2095,0,158,229410.0,137640.0,-53.0,-51.0,-45.0,-50.0,-51.0,-50.0,-45.0,-49.0,-82.0,-93.0,-85.0,-90.0,29.0,42.0,40.0,40.0,1
2538,BA:8C:B9:54:50:24,3276636,511525095,45828,103466012,3230808,408059083,64,16114,4824279,15963,4799482,151,24797,9969,6,45807,11200,64,243,206470.0,97500.0,-47.0,-49.0,-54.0,-46.0,-50.0,-50.0,-44.0,-46.0,-82.0,-93.0,-85.0,-90.0,35.0,44.0,31.0,44.0,1
2539,62:47:05:9D:EB:15,3249651,453274884,18843,45215801,3230808,408059083,64,8470,1606133,8386,1592034,84,14099,3700,1,18827,2703,64,222,229410.0,137640.0,-47.0,-53.0,-47.0,-46.0,-47.0,-52.0,-47.0,-46.0,-82.0,-93.0,-85.0,-90.0,35.0,40.0,38.0,44.0,1
2540,F8:59:71:5A:E0:3D,3507694,826140616,276886,418081533,3230808,408059083,4,276359,376458609,271433,375870155,4926,588454,252393,20,279639,7359,4,862,144444.0,43333.0,-67.0,-74.0,-65.0,-70.0,-67.0,-74.0,-64.0,-70.0,-82.0,-93.0,-85.0,-90.0,15.0,19.0,20.0,20.0,1
2541,CC:2F:71:3E:C5:1F,3242370,409473374,11560,1414089,3230810,408059285,6,49289,4128565,40722,3113505,8567,1015060,12188,36,16564,190,6,858,1000.0,39000.0,-68.0,-72.0,-69.0,-60.0,-69.0,-72.0,-69.0,-62.0,-82.0,-93.0,-85.0,-90.0,14.0,21.0,16.0,30.0,1
2542,CC:2F:71:3F:1F:24,12155659,14095194311,8924849,13687135026,3230810,408059285,158,2036094,1205527619,2027380,1204480633,8714,1046986,1970255,675,8929666,942664,158,6730,115556.0,28889.0,-68.0,-64.0,-73.0,-67.0,-68.0,-64.0,-72.0,-67.0,-82.0,-93.0,-85.0,-90.0,14.0,29.0,12.0,23.0,1
2543,92:69:1D:31:68:E9,3260548,471410080,29731,63350129,3230817,408059951,0,13456,4158851,13317,4136047,139,22804,8581,1,29777,2095,0,158,229410.0,137640.0,-53.0,-51.0,-45.0,-50.0,-51.0,-50.0,-45.0,-49.0,-82.0,-93.0,-85.0,-90.0,29.0,42.0,40.0,40.0,1
2544,BA:8C:B9:54:50:24,3276646,511526079,45829,103466128,3230817,408059951,64,16117,4824525,15966,4799728,151,24797,9970,6,45808,11200,64,243,206470.0,97500.0,-54.0,-51.0,-38.0,-46.0,-50.0,-50.0,-45.0,-46.0,-82.0,-93.0,-85.0,-90.0,28.0,42.0,47.0,44.0,1
2545,62:47:05:9D:EB:15,3249660,453275752,18843,45215801,3230817,408059951,64,8471,1606201,8387,1592102,84,14099,3700,1,18827,2703,64,222,229410.0,137640.0,-43.0,-50.0,-44.0,-45.0,-46.0,-52.0,-46.0,-45.0,-82.0,-93.0,-84.0,-90.0,39.0,43.0,40.0,45.0,1
2546,F8:59:71:5A:E0:3D,3507788,826273574,276971,418213623,3230817,408059951,4,276444,376589509,271518,376001055,4926,588454,252478,20,279725,7360,4,862,144444.0,43333.0,-68.0,-73.0,-65.0,-69.0,-68.0,-73.0,-65.0,-69.0,-82.0,-93.0,-84.0,-90.0,14.0,20.0,19.0,21.0,1
2547,CC:2F:71:3E:C5:1F,3242377,409474040,11560,1414089,3230817,408059951,6,49289,4128565,40722,3113505,8567,1015060,12188,36,16564,190,6,858,1000.0,39000.0,-68.0,-72.0,-69.0,-60.0,-69.0,-72.0,-69.0,-62.0,-82.0,-93.0,-84.0,-90.0,14.0,21.0,15.0,30.0,1
2548,CC:2F:71:3F:1F:24,12156930,14097112372,8926113,13689052421,3230817,408059951,158,2036458,1205824596,2027744,1204777610,8714,1046986,1970619,675,8930946,942828,158,6730,130000.0,39000.0,-68.0,-64.0,-73.0,-67.0,-68.0,-64.0,-73.0,-67.0,-82.0,-93.0,-84.0,-90.0,14.0,29.0,11.0,23.0,1
2549,92:69:1D:31:68:E9,3260641,471562796,29821,63502532,3230820,408060264,0,13511,4177030,13372,4154226,139,22804,8622,1,29867,2098,0,158,229410.0,137640.0,-50.0,-51.0,-46.0,-49.0,-49.0,-50.0,-46.0,-48.0,-82.0,-93.0,-84.0,-90.0,32.0,42.0,38.0,41.0,1
2550,BA:8C:B9:54:50:24,3276649,511526392,45829,103466128,3230820,408060264,64,16117,4824525,15966,4799728,151,24797,9970,6,45808,11200,64,243,206470.0,97500.0,-54.0,-51.0,-38.0,-46.0,-50.0,-50.0,-45.0,-46.0,-82.0,-93.0,-84.0,-90.0,28.0,42.0,46.0,44.0,1
2551,62:47:05:9D:EB:15,3249663,453276065,18843,45215801,3230820,408060264,64,8474,1606508,8389,1592238,85,14270,3701,1,18827,2703,64,222,229410.0,137640.0,-43.0,-50.0,-43.0,-45.0,-45.0,-51.0,-45.0,-45.0,-81.0,-92.0,-84.0,-90.0,38.0,42.0,41.0,45.0,1
2552,F8:59:71:5A:E0:3D,3507882,826412395,277060,418351929,3230822,408060466,4,276534,376728137,271608,376139683,4926,588454,252568,20,279814,7361,4,863,144444.0,43333.0,-67.0,-73.0,-65.0,-70.0,-67.0,-73.0,-65.0,-69.0,-81.0,-92.0,-84.0,-90.0,14.0,19.0,19.0,20.0,1
2553,CC:2F:71:3E:C5:1F,3242384,409474757,11560,1414089,3230824,408060668,6,49289,4128565,40722,3113505,8567,1015060,12188,36,16564,190,6,858,1000.0,39000.0,-68.0,-72.0,-69.0,-60.0,-69.0,-72.0,-69.0,-62.0,-81.0,-92.0,-84.0,-90.0,13.0,20.0,15.0,30.0,1
2554,CC:2F:71:3F:1F:24,12158082,14098829123,8927258,13690768455,3230824,408060668,158,2036802,1206135278,2028088,1205088292,8714,1046986,1970962,675,8932091,942955,158,6730,130000.0,43333.0,-69.0,-65.0,-74.0,-68.0,-68.0,-65.0,-74.0,-68.0,-81.0,-92.0,-84.0,-90.0,12.0,27.0,10.0,22.0,1
2555,92:69:1D:31:68:E9,3260960,472313533,30133,64252603,3230827,408060930,0,13565,4187325,13426,4164521,139,22804,8658,1,30179,2099,0,159,229410.0,137640.0,-52.0,-52.0,-51.0,-55.0,-51.0,-51.0,-48.0,-51.0,-81.0,-92.0,-84.0,-90.0,29.0,40.0,33.0,35.0,1
2556,BA:8C:B9:54:50:24,3276656,511527058,45829,103466128,3230827,408060930,64,16117,4824525,15966,4799728,151,24797,9970,6,45808,11200,64,243,206470.0,97500.0,-54.0,-51.0,-38.0,-46.0,-50.0,-50.0,-45.0,-46.0,-81.0,-92.0,-84.0,-90.0,27.0,41.0,46.0,44.0,1
2557,62:47:05:9D:EB:15,3250028,454203569,19201,46142639,3230827,408060930,64,8557,1623376,8472,1609106,85,14270,3749,1,19185,2734,64,224,229410.0,137640.0,-43.0,-50.0,-43.0,-45.0,-46.0,-52.0,-46.0,-46.0,-81.0,-92.0,-84.0,-90.0,38.0,42.0,41.0,45.0,1
2558,F8:59:71:5A:E0:3D,3507979,826555827,277152,418494897,3230827,408060930,4,276625,376868333,271699,376279879,4926,588454,252659,20,279906,7361,4,863,144444.0,43333.0,-67.0,-73.0,-65.0,-69.0,-67.0,-73.0,-65.0,-69.0,-81.0,-92.0,-84.0,-90.0,14.0,19.0,19.0,21.0,1
2559,CC:2F:71:3E:C5:1F,3242387,409475019,11560,1414089,3230827,408060930,6,49289,4128565,40722,3113505,8567,1015060,12188,36,16564,190,6,858,1000.0,39000.0,-68.0,-72.0,-69.0,-60.0,-69.0,-72.0,-69.0,-62.0,-81.0,-92.0,-84.0,-90.0,13.0,20.0,15.0,30.0,1
2560,CC:2F:71:3F:1F:24,12158798,14099878201,8927969,13691817069,3230829,408061132,158,2037117,1206435156,2028403,1205388170,8714,1046986,1971276,675,8932801,943063,158,6730,130000.0,43333.0,-68.0,-64.0,-74.0,-68.0,-68.0,-64.0,-73.0,-67.0,-81.0,-92.0,-84.0,-90.0,13.0,28.0,10.0,22.0,1
2561,92:69:1D:31:68:E9,3260968,472314341,30133,64252603,3230835,408061738,0,13565,4187325,13426,4164521,139,22804,8658,1,30179,2099,0,159,229410.0,137640.0,-52.0,-52.0,-51.0,-55.0,-51.0,-51.0,-48.0,-51.0,-81.0,-92.0,-84.0,-90.0,29.0,40.0,33.0,35.0,1
2562,BA:8C:B9:54:50:24,3276664,511527866,45829,103466128,3230835,408061738,64,16117,4824525,15966,4799728,151,24797,9970,6,45808,11200,64,243,206470.0,97500.0,-54.0,-51.0,-38.0,-46.0,-50.0,-50.0,-45.0,-46.0,-81.0,-92.0,-84.0,-90.0,27.0,41.0,46.0,44.0,1
2563,62:47:05:9D:EB:15,3250037,454204531,19202,46142793,3230835,408061738,64,8561,1623706,8476,1609436,85,14270,3750,1,19186,2734,64,224,229410.0,137640.0,-44.0,-50.0,-44.0,-45.0,-45.0,-51.0,-45.0,-45.0,-81.0,-92.0,-84.0,-90.0,37.0,42.0,40.0,45.0,1
2564,F8:59:71:5A:E0:3D,3508080,826701157,277245,418639419,3230835,408061738,4,276719,377013121,271793,376424667,4926,588454,252753,20,279999,7361,4,863,144444.0,43333.0,-67.0,-73.0,-65.0,-69.0,-67.0,-73.0,-65.0,-69.0,-81.0,-92.0,-84.0,-90.0,14.0,19.0,19.0,21.0,1
2565,CC:2F:71:3E:C5:1F,3242395,409475827,11560,1414089,3230835,408061738,6,49289,4128565,40722,3113505,8567,1015060,12188,36,16564,190,6,858,1000.0,39000.0,-68.0,-72.0,-69.0,-60.0,-69.0,-72.0,-69.0,-62.0,-81.0,-92.0,-84.0,-90.0,13.0,20.0,15.0,30.0,1
2566,CC:2F:71:3F:1F:24,12159790,14101357796,8928955,13693296058,3230835,408061738,158,2037434,1206731017,2028720,1205684031,8714,1046986,1971591,675,8933788,943234,158,6732,115556.0,28889.0,-68.0,-64.0,-74.0,-67.0,-68.0,-64.0,-73.0,-67.0,-81.0,-92.0,-84.0,-90.0,13.0,28.0,10.0,23.0,1
2567,92:69:1D:31:68:E9,3260974,472315035,30136,64253035,3230838,408062000,0,13576,4188353,13437,4165549,139,22804,8660,1,30182,2099,0,159,229410.0,137640.0,-54.0,-50.0,-44.0,-51.0,-51.0,-50.0,-46.0,-50.0,-81.0,-92.0,-84.0,-90.0,27.0,42.0,40.0,39.0,1
2568,BA:8C:B9:54:50:24,3276667,511528128,45829,103466128,3230838,408062000,64,16117,4824525,15966,4799728,151,24797,9970,6,45808,11200,64,243,206470.0,97500.0,-54.0,-51.0,-38.0,-46.0,-50.0,-50.0,-45.0,-46.0,-81.0,-92.0,-84.0,-90.0,27.0,41.0,46.0,44.0,1
2569,62:47:05:9D:EB:15,3250086,454264812,19248,46202812,3230838,408062000,64,8567,1624499,8482,1610229,85,14270,3754,1,19232,2734,64,224,229410.0,137640.0,-43.0,-50.0,-43.0,-45.0,-46.0,-51.0,-46.0,-45.0,-81.0,-92.0,-84.0,-90.0,38.0,42.0,41.0,45.0,1
2570,F8:59:71:5A:E0:3D,3508174,826839927,277334,418777725,3230840,408062202,4,276808,377150181,271882,376561727,4926,588454,252842,20,280088,7361,4,863,144444.0,43333.0,-67.0,-73.0,-65.0,-69.0,-67.0,-73.0,-65.0,-69.0,-81.0,-92.0,-84.0,-90.0,14.0,19.0,19.0,21.0,1
2571,CC:2F:71:3E:C5:1F,3242400,409476291,11560,1414089,3230840,408062202,6,49289,4128565,40722,3113505,8567,1015060,12188,36,16564,190,6,858,1000.0,39000.0,-68.0,-72.0,-69.0,-60.0,-69.0,-72.0,-69.0,-62.0,-81.0,-92.0,-84.0,-90.0,13.0,20.0,15.0,30.0,1
2572,CC:2F:71:3F:1F:24,12161100,14103349614,8930260,13695287412,3230840,408062202,158,2037790,1207043975,2029076,1205996989,8714,1046986,1971934,675,8935092,943309,158,6733,117000.0,39000.0,-67.0,-64.0,-73.0,-67.0,-67.0,-64.0,-73.0,-67.0,-81.0,-92.0,-84.0,-90.0,14.0,28.0,11.0,23.0,1
2573,92:69:1D:31:68:E9,3260981,472315914,30136,64253035,3230845,408062879,0,13576,4188353,13437,4165549,139,22804,8660,1,30182,2099,0,159,229410.0,137640.0,-54.0,-50.0,-44.0,-51.0,-51.0,-50.0,-46.0,-50.0,-81.0,-92.0,-84.0,-90.0,27.0,42.0,40.0,39.0,1
2574,BA:8C:B9:54:50:24,3276674,511529007,45829,103466128,3230845,408062879,64,16117,4824525,15966,4799728,151,24797,9970,6,45808,11200,64,243,206470.0,97500.0,-54.0,-51.0,-38.0,-46.0,-50.0,-50.0,-45.0,-46.0,-81.0,-92.0,-84.0,-90.0,27.0,41.0,46.0,44.0,1
2575,62:47:05:9D:EB:15,3250093,454265691,19248,46202812,3230845,408062879,64,8567,1624499,8482,1610229,85,14270,3754,1,19232,2734,64,224,229410.0,137640.0,-43.0,-50.0,-43.0,-45.0,-46.0,-51.0,-46.0,-45.0,-81.0,-92.0,-84.0,-90.0,38.0,42.0,41.0,45.0,1
2576,F8:59:71:5A:E0:3D,3508265,826974248,277420,418911369,3230845,408062879,4,276892,377279541,271966,376691087,4926,588454,252926,20,280174,7362,4,863,144444.0,43333.0,-67.0,-73.0,-65.0,-70.0,-67.0,-73.0,-65.0,-70.0,-81.0,-92.0,-84.0,-90.0,14.0,19.0,19.0,20.0,1
2577,CC:2F:71:3E:C5:1F,3242405,409476968,11560,1414089,3230845,408062879,6,49289,4128565,40722,3113505,8567,1015060,12188,36,16564,190,6,858,1000.0,39000.0,-68.0,-72.0,-69.0,-60.0,-69.0,-72.0,-69.0,-62.0,-81.0,-92.0,-84.0,-90.0,13.0,20.0,15.0,30.0,1
2578,CC:2F:71:3F:1F:24,12162871,14106065305,8932026,13698002426,3230845,408062879,158,2038160,1207349863,2029446,1206302877,8714,1046986,1972299,675,8936859,943821,158,6734,130000.0,39000.0,-67.0,-64.0,-73.0,-67.0,-67.0,-64.0,-73.0,-67.0,-81.0,-92.0,-84.0,-90.0,14.0,28.0,11.0,23.0,1
2579,92:69:1D:31:68:E9,3260986,472316378,30136,64253035,3230850,408063343,0,13576,4188353,13437,4165549,139,22804,8660,1,30182,2099,0,159,229410.0,137640.0,-54.0,-50.0,-44.0,-51.0,-51.0,-50.0,-46.0,-50.0,-81.0,-92.0,-84.0,-90.0,27.0,42.0,40.0,39.0,1
2580,BA:8C:B9:54:50:24,3276683,511529875,45829,103466128,3230854,408063747,64,16117,4824525,15966,4799728,151,24797,9970,6,45808,11200,64,243,206470.0,97500.0,-54.0,-51.0,-38.0,-46.0,-50.0,-50.0,-45.0,-46.0,-81.0,-92.0,-84.0,-90.0,27.0,41.0,46.0,44.0,1
2581,62:47:05:9D:EB:15,3250102,454266559,19248,46202812,3230854,408063747,64,8567,1624499,8482,1610229,85,14270,3754,1,19232,2734,64,224,229410.0,137640.0,-43.0,-50.0,-43.0,-45.0,-46.0,-51.0,-46.0,-45.0,-81.0,-92.0,-84.0,-90.0,38.0,42.0,41.0,45.0,1
2582,F8:59:71:5A:E0:3D,3508376,827133624,277522,419069877,3230854,408063747,4,276996,377439743,272070,376851289,4926,588454,253030,20,280276,7363,4,863,144444.0,43333.0,-67.0,-73.0,-65.0,-70.0,-67.0,-73.0,-65.0,-70.0,-81.0,-92.0,-84.0,-90.0,14.0,19.0,19.0,20.0,1
2583,CC:2F:71:3E:C5:1F,3242414,409477836,11560,1414089,3230854,408063747,6,49289,4128565,40722,3113505,8567,1015060,12188,36,16564,190,6,858,1000.0,39000.0,-68.0,-72.0,-69.0,-60.0,-69.0,-72.0,-69.0,-62.0,-81.0,-92.0,-84.0,-90.0,13.0,20.0,15.0,30.0,1
2584,CC:2F:71:3F:1F:24,12164330,14108242450,8933476,13700178703,3230854,408063747,158,2038568,1207681962,2029854,1206634976,8714,1046986,1972704,675,8938309,943996,158,6735,115556.0,28889.0,-68.0,-64.0,-74.0,-68.0,-68.0,-64.0,-73.0,-67.0,-81.0,-92.0,-84.0,-90.0,13.0,28.0,10.0,22.0,1
2585,92:69:1D:31:68:E9,3261604,473838715,30747,65774704,3230857,408064011,0,13711,4254510,13572,4231706,139,22804,8766,1,30793,2255,0,161,229410.0,137640.0,-49.0,-49.0,-45.0,-49.0,-49.0,-49.0,-45.0,-49.0,-81.0,-92.0,-84.0,-90.0,32.0,43.0,39.0,41.0,1
2586,BA:8C:B9:54:50:24,3276687,511530255,45830,103466244,3230857,408064011,64,16122,4824865,15971,4800068,151,24797,9970,6,45809,11200,64,243,206470.0,97500.0,-54.0,-51.0,-38.0,-46.0,-52.0,-51.0,-40.0,-46.0,-81.0,-92.0,-84.0,-90.0,27.0,41.0,46.0,44.0,1
2587,62:47:05:9D:EB:15,3250113,454271012,19256,46207001,3230857,408064011,64,8609,1636677,8524,1622407,85,14270,3765,1,19240,2734,64,228,216660.0,130000.0,-47.0,-52.0,-48.0,-46.0,-46.0,-51.0,-47.0,-45.0,-81.0,-92.0,-84.0,-90.0,34.0,40.0,36.0,44.0,1
2588,F8:59:71:5A:E0:3D,3508468,827266412,277609,419202199,3230859,408064213,4,277085,377575747,272159,376987293,4926,588454,253119,20,280363,7364,4,863,144444.0,43333.0,-67.0,-73.0,-65.0,-70.0,-67.0,-73.0,-65.0,-70.0,-81.0,-92.0,-84.0,-90.0,14.0,19.0,19.0,20.0,1
2589,CC:2F:71:3E:C5:1F,3242420,409478418,11561,1414205,3230859,408064213,6,49292,4128823,40724,3113645,8568,1015178,12189,36,16565,191,6,858,130000.0,39000.0,-68.0,-72.0,-68.0,-60.0,-70.0,-74.0,-70.0,-64.0,-81.0,-92.0,-84.0,-90.0,13.0,20.0,16.0,30.0,1
2590,CC:2F:71:3F:1F:24,12165440,14109912900,8934581,13701848687,3230859,408064213,158,2038914,1207982976,2030200,1206935990,8714,1046986,1973043,675,8939412,944118,158,6735,115556.0,28889.0,-68.0,-64.0,-74.0,-67.0,-67.0,-64.0,-73.0,-67.0,-81.0,-92.0,-84.0,-90.0,13.0,28.0,10.0,23.0,1
2591,92:69:1D:31:68:E9,3261612,473839507,30747,65774704,3230865,408064803,0,13712,4254578,13573,4231774,139,22804,8766,1,30793,2255,0,161,229410.0,137640.0,-53.0,-51.0,-45.0,-51.0,-49.0,-49.0,-45.0,-49.0,-81.0,-92.0,-84.0,-90.0,28.0,41.0,39.0,39.0,1
2592,BA:8C:B9:54:50:24,3276695,511531047,45830,103466244,3230865,408064803,64,16122,4824865,15971,4800068,151,24797,9970,6,45809,11200,64,243,206470.0,97500.0,-54.0,-51.0,-38.0,-46.0,-52.0,-51.0,-40.0,-46.0,-81.0,-92.0,-84.0,-90.0,27.0,41.0,46.0,44.0,1
2593,62:47:05:9D:EB:15,3250134,454300683,19269,46235880,3230865,408064803,64,8625,1638591,8540,1624321,85,14270,3774,1,19253,2734,64,229,216660.0,130000.0,-44.0,-50.0,-43.0,-45.0,-45.0,-51.0,-46.0,-45.0,-81.0,-92.0,-84.0,-90.0,37.0,42.0,41.0,45.0,1
2594,F8:59:71:5A:E0:3D,3508569,827414632,277704,419349829,3230865,408064803,4,277180,377722061,272254,377133607,4926,588454,253213,20,280458,7364,4,863,144444.0,43333.0,-67.0,-73.0,-65.0,-70.0,-67.0,-73.0,-65.0,-70.0,-81.0,-92.0,-84.0,-90.0,14.0,19.0,19.0,20.0,1
2595,CC:2F:71:3E:C5:1F,3242426,409479008,11561,1414205,3230865,408064803,6,49292,4128823,40724,3113645,8568,1015178,12189,36,16565,191,6,858,130000.0,39000.0,-68.0,-72.0,-68.0,-60.0,-70.0,-74.0,-70.0,-64.0,-81.0,-92.0,-84.0,-90.0,13.0,20.0,16.0,30.0,1
2596,CC:2F:71:3F:1F:24,12166933,14112189390,8936066,13704124385,3230867,408065005,158,2039285,1208306388,2030571,1207259402,8714,1046986,1973411,675,8940899,944157,158,6735,115556.0,28889.0,-68.0,-64.0,-74.0,-68.0,-67.0,-63.0,-73.0,-67.0,-81.0,-92.0,-84.0,-90.0,13.0,28.0,10.0,22.0,1
2597,92:69:1D:31:68:E9,3261890,474197346,31021,66132139,3230869,408065207,0,13749,4259425,13610,4236621,139,22804,8787,1,31067,2496,0,161,229410.0,137640.0,-50.0,-50.0,-45.0,-50.0,-50.0,-50.0,-44.0,-49.0,-81.0,-92.0,-84.0,-90.0,31.0,42.0,39.0,40.0,1
2598,BA:8C:B9:54:50:24,3276703,511531855,45830,103466244,3230873,408065611,64,16122,4824865,15971,4800068,151,24797,9970,6,45809,11200,64,243,206470.0,97500.0,-54.0,-51.0,-38.0,-46.0,-52.0,-51.0,-40.0,-46.0,-81.0,-92.0,-84.0,-90.0,27.0,41.0,46.0,44.0,1
2599,62:47:05:9D:EB:15,3250142,454301491,19269,46235880,3230873,408065611,64,8625,1638591,8540,1624321,85,14270,3774,1,19253,2734,64,229,216660.0,130000.0,-44.0,-50.0,-43.0,-45.0,-45.0,-51.0,-46.0,-45.0,-81.0,-92.0,-84.0,-90.0,37.0,42.0,41.0,45.0,1
2600,F8:59:71:5A:E0:3D,3508666,827553746,277793,419488135,3230873,408065611,4,277266,377854543,272340,377266089,4926,588454,253299,20,280547,7364,4,864,144444.0,43333.0,-67.0,-73.0,-65.0,-70.0,-67.0,-73.0,-65.0,-69.0,-81.0,-92.0,-84.0,-90.0,14.0,19.0,19.0,20.0,1
2601,CC:2F:71:3E:C5:1F,3242434,409479816,11561,1414205,3230873,408065611,6,49292,4128823,40724,3113645,8568,1015178,12189,36,16565,191,6,858,130000.0,39000.0,-68.0,-72.0,-68.0,-60.0,-70.0,-74.0,-70.0,-64.0,-81.0,-92.0,-84.0,-90.0,13.0,20.0,16.0,30.0,1
2602,CC:2F:71:3F:1F:24,12168376,14114381025,8937503,13706315414,3230873,408065611,158,2039661,1208599232,2030947,1207552246,8714,1046986,1973785,675,8942336,944196,158,6735,115556.0,28889.0,-68.0,-64.0,-74.0,-68.0,-67.0,-64.0,-73.0,-67.0,-81.0,-92.0,-84.0,-90.0,13.0,28.0,10.0,22.0,1
2603,92:69:1D:31:68:E9,3261900,474198655,31024,66132782,3230876,408065873,0,13763,4269314,13624,4246510,139,22804,8794,1,31070,2496,0,161,216660.0,130000.0,-50.0,-50.0,-46.0,-49.0,-50.0,-50.0,-45.0,-50.0,-81.0,-92.0,-84.0,-90.0,31.0,42.0,38.0,41.0,1
2604,BA:8C:B9:54:50:24,3276706,511532117,45830,103466244,3230876,408065873,64,16122,4824865,15971,4800068,151,24797,9970,6,45809,11200,64,243,206470.0,97500.0,-54.0,-51.0,-38.0,-46.0,-52.0,-51.0,-40.0,-46.0,-81.0,-92.0,-84.0,-90.0,27.0,41.0,46.0,44.0,1
2605,62:47:05:9D:EB:15,3250145,454301753,19269,46235880,3230876,408065873,64,8625,1638591,8540,1624321,85,14270,3774,1,19253,2734,64,229,216660.0,130000.0,-44.0,-50.0,-43.0,-45.0,-45.0,-51.0,-46.0,-45.0,-81.0,-92.0,-84.0,-90.0,37.0,42.0,41.0,45.0,1
2606,F8:59:71:5A:E0:3D,3508757,827687854,277879,419621779,3230878,408066075,4,277357,377994753,272431,377406299,4926,588454,253388,20,280633,7365,4,864,144444.0,43333.0,-67.0,-73.0,-65.0,-70.0,-67.0,-73.0,-65.0,-70.0,-81.0,-92.0,-84.0,-90.0,14.0,19.0,19.0,20.0,1
2607,CC:2F:71:3E:C5:1F,3242440,409480342,11561,1414205,3230879,408066137,6,49292,4128823,40724,3113645,8568,1015178,12189,36,16565,191,6,858,130000.0,39000.0,-68.0,-72.0,-68.0,-60.0,-70.0,-74.0,-70.0,-64.0,-81.0,-92.0,-84.0,-90.0,13.0,20.0,16.0,30.0,1
2608,CC:2F:71:3F:1F:24,12169741,14116450006,8938862,13708383869,3230879,408066137,158,2040035,1208887049,2031321,1207840063,8714,1046986,1974159,675,8943695,944405,158,6735,115556.0,28889.0,-68.0,-64.0,-74.0,-68.0,-68.0,-64.0,-73.0,-67.0,-81.0,-92.0,-84.0,-90.0,13.0,28.0,10.0,22.0,1
2609,92:69:1D:31:68:E9,3261908,474199453,31025,66132912,3230883,408066541,0,13764,4269382,13625,4246578,139,22804,8794,1,31071,2496,0,161,216660.0,130000.0,-54.0,-51.0,-44.0,-51.0,-50.0,-50.0,-45.0,-50.0,-81.0,-92.0,-84.0,-90.0,27.0,41.0,40.0,39.0,1
2610,BA:8C:B9:54:50:24,3276713,511532785,45830,103466244,3230883,408066541,64,16122,4824865,15971,4800068,151,24797,9970,6,45809,11200,64,243,206470.0,97500.0,-54.0,-51.0,-38.0,-46.0,-52.0,-51.0,-40.0,-46.0,-81.0,-92.0,-84.0,-90.0,27.0,41.0,46.0,44.0,1
2611,62:47:05:9D:EB:15,3250152,454302421,19269,46235880,3230883,408066541,64,8625,1638591,8540,1624321,85,14270,3774,1,19253,2734,64,229,216660.0,130000.0,-44.0,-50.0,-43.0,-45.0,-45.0,-51.0,-46.0,-45.0,-81.0,-92.0,-84.0,-90.0,37.0,42.0,41.0,45.0,1
2612,F8:59:71:5A:E0:3D,3508841,827811086,277958,419744545,3230883,408066541,4,277438,378118071,272511,377529499,4927,588572,253469,20,280712,7365,4,864,144444.0,43333.0,-67.0,-73.0,-65.0,-70.0,-67.0,-73.0,-65.0,-69.0,-81.0,-92.0,-84.0,-90.0,14.0,19.0,19.0,20.0,1
2613,CC:2F:71:3E:C5:1F,3242444,409480746,11561,1414205,3230883,408066541,6,49292,4128823,40724,3113645,8568,1015178,12189,36,16565,191,6,858,130000.0,39000.0,-68.0,-72.0,-68.0,-60.0,-70.0,-74.0,-70.0,-64.0,-81.0,-92.0,-84.0,-90.0,13.0,20.0,16.0,30.0,1
2614,CC:2F:71:3F:1F:24,12171589,14119289978,8940706,13711223437,3230883,408066541,158,2040460,1209166335,2031746,1208119349,8714,1046986,1974584,675,8945501,944650,158,6735,117000.0,39000.0,-68.0,-64.0,-74.0,-67.0,-67.0,-64.0,-73.0,-67.0,-81.0,-92.0,-84.0,-90.0,13.0,28.0,10.0,23.0,1
2615,92:69:1D:31:68:E9,3261915,474200041,31025,66132912,3230890,408067129,0,13764,4269382,13625,4246578,139,22804,8794,1,31071,2496,0,161,216660.0,130000.0,-54.0,-51.0,-44.0,-51.0,-50.0,-50.0,-45.0,-50.0,-81.0,-92.0,-84.0,-90.0,27.0,41.0,40.0,39.0,1
2616,BA:8C:B9:54:50:24,3276724,511533777,45830,103466244,3230894,408067533,64,16122,4824865,15971,4800068,151,24797,9970,6,45809,11200,64,243,206470.0,97500.0,-54.0,-51.0,-38.0,-46.0,-52.0,-51.0,-40.0,-46.0,-81.0,-92.0,-84.0,-90.0,27.0,41.0,46.0,44.0,1
2617,62:47:05:9D:EB:15,3250531,455277370,19637,47209837,3230894,408067533,64,8717,1651599,8631,1637207,86,14392,3818,1,19621,2803,64,235,229410.0,130000.0,-44.0,-50.0,-44.0,-45.0,-46.0,-51.0,-46.0,-45.0,-81.0,-92.0,-84.0,-90.0,37.0,42.0,40.0,45.0,1
2618,F8:59:71:5A:E0:3D,3508969,827993896,278075,419926363,3230894,408067533,4,277566,378315611,272639,377727039,4927,588572,253597,20,280829,7376,4,866,144444.0,43333.0,-67.0,-73.0,-65.0,-70.0,-67.0,-73.0,-65.0,-69.0,-81.0,-92.0,-84.0,-90.0,14.0,19.0,19.0,20.0,1
2619,CC:2F:71:3E:C5:1F,3242455,409481738,11561,1414205,3230894,408067533,6,49292,4128823,40724,3113645,8568,1015178,12189,36,16565,191,6,858,130000.0,39000.0,-68.0,-72.0,-68.0,-60.0,-70.0,-74.0,-70.0,-64.0,-81.0,-92.0,-84.0,-90.0,13.0,20.0,16.0,30.0,1
2620,CC:2F:71:3F:1F:24,12173216,14121762115,8942322,13713694582,3230894,408067533,158,2040943,1209599083,2032228,1208551979,8715,1047104,1975041,675,8947155,945268,158,6735,130000.0,43333.0,-67.0,-64.0,-73.0,-68.0,-67.0,-64.0,-73.0,-67.0,-81.0,-92.0,-84.0,-90.0,14.0,28.0,11.0,22.0,1
2621,92:69:1D:31:68:E9,3261923,474200849,31025,66132912,3230898,408067937,0,13764,4269382,13625,4246578,139,22804,8794,1,31071,2496,0,161,216660.0,130000.0,-54.0,-51.0,-44.0,-51.0,-50.0,-50.0,-45.0,-50.0,-81.0,-92.0,-84.0,-90.0,27.0,41.0,40.0,39.0,1
2622,BA:8C:B9:54:50:24,3276728,511534181,45830,103466244,3230898,408067937,64,16122,4824865,15971,4800068,151,24797,9970,6,45809,11200,64,243,206470.0,97500.0,-54.0,-51.0,-38.0,-46.0,-52.0,-51.0,-40.0,-46.0,-81.0,-92.0,-84.0,-90.0,27.0,41.0,46.0,44.0,1
2623,62:47:05:9D:EB:15,3250535,455277774,19637,47209837,3230898,408067937,64,8717,1651599,8631,1637207,86,14392,3818,1,19621,2803,64,235,229410.0,130000.0,-44.0,-50.0,-44.0,-45.0,-46.0,-51.0,-46.0,-45.0,-81.0,-92.0,-84.0,-90.0,37.0,42.0,40.0,45.0,1
2624,F8:59:71:5A:E0:3D,3509063,828133992,278165,420066055,3230898,408067937,4,277657,378455807,272730,377867235,4927,588572,253687,20,280919,7376,4,866,144444.0,43333.0,-67.0,-73.0,-65.0,-70.0,-67.0,-72.0,-64.0,-69.0,-81.0,-92.0,-84.0,-90.0,14.0,19.0,19.0,20.0,1
2625,CC:2F:71:3E:C5:1F,3242460,409482202,11561,1414205,3230899,408067997,6,49292,4128823,40724,3113645,8568,1015178,12189,36,16565,191,6,858,130000.0,39000.0,-68.0,-72.0,-68.0,-60.0,-70.0,-74.0,-70.0,-64.0,-81.0,-92.0,-84.0,-90.0,13.0,20.0,16.0,30.0,1
2626,CC:2F:71:3F:1F:24,12174432,14123601503,8943531,13715533304,3230901,408068199,158,2041319,1209907193,2032604,1208860089,8715,1047104,1975416,675,8948364,945367,158,6736,115556.0,28889.0,-68.0,-64.0,-73.0,-68.0,-68.0,-64.0,-73.0,-68.0,-81.0,-92.0,-84.0,-90.0,13.0,28.0,11.0,22.0,1
2627,3C:55:76:E8:8F:1F,3230906,408068797,2,298,3230904,408068499,0,3,516,2,362,1,154,1,1,4,4,0,0,1000.0,1000.0,-46.0,-48.0,-45.0,-47.0,-47.0,-49.0,-45.0,-45.0,-81.0,-92.0,-84.0,-90.0,35.0,44.0,39.0,43.0,1
2628,92:69:1D:31:68:E9,3261934,474202465,31025,66132912,3230909,408069553,0,13764,4269382,13625,4246578,139,22804,8794,1,31071,2496,0,161,216660.0,130000.0,-54.0,-51.0,-44.0,-51.0,-50.0,-50.0,-45.0,-50.0,-81.0,-92.0,-84.0,-90.0,27.0,41.0,40.0,39.0,1
2629,BA:8C:B9:54:50:24,3276745,511537943,45830,103466244,3230915,408071699,64,16124,4825001,15973,4800204,151,24797,9970,6,45810,11200,64,243,206470.0,97500.0,-47.0,-50.0,-54.0,-46.0,-52.0,-50.0,-42.0,-46.0,-81.0,-92.0,-84.0,-90.0,34.0,42.0,30.0,44.0,1
2630,62:47:05:9D:EB:15,3250555,455281850,19637,47209837,3230918,408072013,64,8717,1651599,8631,1637207,86,14392,3818,1,19621,2803,64,235,229410.0,130000.0,-44.0,-50.0,-44.0,-45.0,-46.0,-51.0,-46.0,-45.0,-81.0,-92.0,-84.0,-90.0,37.0,42.0,40.0,45.0,1
2631,F8:59:71:5A:E0:3D,3509180,828287312,278261,420215239,3230919,408072073,4,277755,378606839,272828,378018267,4927,588572,253784,20,281015,7379,4,866,144444.0,43333.0,-67.0,-73.0,-66.0,-70.0,-67.0,-73.0,-65.0,-69.0,-81.0,-92.0,-84.0,-90.0,14.0,19.0,18.0,20.0,1
2632,CC:2F:71:3E:C5:1F,3242483,409486632,11561,1414205,3230922,408072427,6,49294,4128963,40726,3113785,8568,1015178,12189,36,16566,191,6,858,130000.0,39000.0,-69.0,-72.0,-68.0,-61.0,-69.0,-71.0,-69.0,-63.0,-81.0,-92.0,-84.0,-90.0,12.0,20.0,16.0,29.0,1
2633,CC:2F:71:3F:1F:24,12175393,14124993373,8944464,13716920116,3230929,408073257,158,2041673,1210220573,2032958,1209173469,8715,1047104,1975768,675,8949297,945696,158,6738,86667.0,14444.0,-72.0,-65.0,-71.0,-67.0,-71.0,-64.0,-70.0,-67.0,-81.0,-92.0,-84.0,-90.0,9.0,27.0,13.0,23.0,1
2634,3C:55:76:E8:8F:1F,3230973,408085104,25,10014,3230948,408075090,0,56,11068,28,6296,28,4772,52,1,33,38,0,9,216660.0,1000.0,-50.0,-51.0,-44.0,-47.0,-50.0,-52.0,-45.0,-48.0,-81.0,-92.0,-84.0,-90.0,31.0,41.0,40.0,43.0,1
2635,92:69:1D:31:68:E9,3261975,474208204,31025,66132912,3230950,408075292,0,13764,4269382,13625,4246578,139,22804,8794,1,31071,2496,0,161,216660.0,130000.0,-54.0,-51.0,-44.0,-51.0,-50.0,-50.0,-45.0,-50.0,-81.0,-92.0,-84.0,-90.0,27.0,41.0,40.0,39.0,1
2636,BA:8C:B9:54:50:24,3276784,511542017,45830,103466244,3230954,408075773,64,16124,4825001,15973,4800204,151,24797,9970,6,45810,11200,64,243,206470.0,97500.0,-47.0,-50.0,-54.0,-46.0,-52.0,-50.0,-42.0,-46.0,-81.0,-92.0,-84.0,-90.0,34.0,42.0,30.0,44.0,1
2637,62:47:05:9D:EB:15,3250605,455286884,19637,47209837,3230968,408077047,64,8717,1651599,8631,1637207,86,14392,3818,1,19621,2803,64,235,229410.0,130000.0,-44.0,-50.0,-44.0,-45.0,-46.0,-51.0,-46.0,-45.0,-81.0,-92.0,-84.0,-90.0,37.0,42.0,40.0,45.0,1
2638,F8:59:71:5A:E0:3D,3509320,828430785,278350,420353545,3230970,408077240,4,277843,378742387,272916,378153815,4927,588572,253872,20,281104,7381,4,866,144444.0,43333.0,-67.0,-73.0,-66.0,-71.0,-66.0,-73.0,-66.0,-70.0,-81.0,-92.0,-84.0,-90.0,14.0,19.0,18.0,19.0,1
2639,CC:2F:71:3E:C5:1F,3242531,409491445,11561,1414205,3230970,408077240,6,49294,4128963,40726,3113785,8568,1015178,12189,36,16566,191,6,858,130000.0,39000.0,-69.0,-72.0,-68.0,-61.0,-69.0,-71.0,-69.0,-63.0,-81.0,-92.0,-84.0,-90.0,12.0,20.0,16.0,29.0,1
2640,CC:2F:71:3F:1F:24,12176479,14126570182,8945509,13718492942,3230970,408077240,158,2042039,1210508867,2033324,1209461763,8715,1047104,1976131,675,8950342,945697,158,6738,86667.0,14444.0,-70.0,-64.0,-72.0,-71.0,-69.0,-64.0,-71.0,-71.0,-81.0,-92.0,-84.0,-90.0,11.0,28.0,12.0,19.0,1
2641,3C:55:76:E8:8F:1F,3231114,408242439,126,162820,3230988,408079619,0,177,47154,135,40010,42,7144,153,2,136,118,0,18,229410.0,130000.0,-50.0,-52.0,-48.0,-51.0,-49.0,-51.0,-48.0,-51.0,-81.0,-92.0,-84.0,-90.0,31.0,40.0,36.0,39.0,1
2642,92:69:1D:31:68:E9,3262015,474212737,31025,66132912,3230990,408079825,0,13767,4269640,13627,4246714,140,22926,8795,1,31071,2496,0,161,216660.0,130000.0,-53.0,-53.0,-51.0,-53.0,-50.0,-50.0,-46.0,-49.0,-81.0,-92.0,-84.0,-90.0,28.0,39.0,33.0,37.0,1
2643,BA:8C:B9:54:50:24,3276821,511546196,45830,103466244,3230991,408079952,64,16124,4825001,15973,4800204,151,24797,9970,6,45810,11200,64,243,206470.0,97500.0,-47.0,-50.0,-54.0,-46.0,-52.0,-50.0,-42.0,-46.0,-81.0,-92.0,-84.0,-90.0,34.0,42.0,30.0,44.0,1
2644,62:47:05:9D:EB:15,3250629,455289867,19637,47209837,3230992,408080030,64,8717,1651599,8631,1637207,86,14392,3818,1,19621,2803,64,235,229410.0,130000.0,-44.0,-50.0,-44.0,-45.0,-46.0,-51.0,-46.0,-45.0,-81.0,-92.0,-84.0,-90.0,37.0,42.0,40.0,45.0,1
2645,F8:59:71:5A:E0:3D,3509434,828576543,278442,420496513,3230992,408080030,4,277936,378885901,273009,378297329,4927,588572,253965,20,281196,7382,4,866,144444.0,43333.0,-67.0,-72.0,-65.0,-70.0,-67.0,-72.0,-65.0,-70.0,-81.0,-92.0,-84.0,-90.0,14.0,20.0,19.0,20.0,1
2646,CC:2F:71:3E:C5:1F,3242556,409494548,11561,1414205,3230995,408080343,6,49294,4128963,40726,3113785,8568,1015178,12189,36,16566,191,6,858,130000.0,39000.0,-69.0,-72.0,-68.0,-61.0,-69.0,-71.0,-69.0,-63.0,-81.0,-92.0,-84.0,-90.0,12.0,20.0,16.0,29.0,1
2647,CC:2F:71:3F:1F:24,12177681,14128320897,8946678,13720239874,3231003,408081023,158,2042466,1210850652,2033751,1209803548,8715,1047104,1976550,675,8951511,945926,158,6739,86667.0,14444.0,-69.0,-65.0,-71.0,-68.0,-69.0,-64.0,-71.0,-68.0,-81.0,-92.0,-84.0,-90.0,12.0,27.0,13.0,22.0,1
2648,3C:55:76:E8:8F:1F,3231284,408425850,263,342605,3231021,408083245,0,354,92309,303,83328,51,8981,291,3,278,205,0,20,162500.0,48750.0,-48.0,-51.0,-47.0,-51.0,-48.0,-49.0,-46.0,-49.0,-81.0,-92.0,-84.0,-89.0,33.0,41.0,37.0,38.0,1
2649,92:69:1D:31:68:E9,3262059,474221222,31038,66137977,3231021,408083245,0,13793,4279902,13652,4256805,141,23097,8808,1,31084,2496,0,161,216660.0,130000.0,-51.0,-51.0,-45.0,-49.0,-49.0,-50.0,-44.0,-47.0,-81.0,-92.0,-84.0,-89.0,30.0,41.0,39.0,40.0,1
2650,BA:8C:B9:54:50:24,3276852,511549549,45830,103466244,3231022,408083305,64,16124,4825001,15973,4800204,151,24797,9970,6,45810,11200,64,243,206470.0,97500.0,-47.0,-50.0,-54.0,-46.0,-52.0,-50.0,-42.0,-46.0,-81.0,-92.0,-84.0,-89.0,34.0,42.0,30.0,43.0,1
2651,62:47:05:9D:EB:15,3250659,455293142,19637,47209837,3231022,408083305,64,8717,1651599,8631,1637207,86,14392,3818,1,19621,2803,64,235,229410.0,130000.0,-44.0,-50.0,-44.0,-45.0,-46.0,-51.0,-46.0,-45.0,-81.0,-92.0,-84.0,-89.0,37.0,42.0,40.0,44.0,1
2652,F8:59:71:5A:E0:3D,3509568,828739998,278545,420656575,3231023,408083423,4,278038,379043009,273111,378454437,4927,588572,254067,20,281299,7382,4,867,144444.0,43333.0,-67.0,-73.0,-66.0,-70.0,-67.0,-72.0,-66.0,-70.0,-81.0,-92.0,-84.0,-89.0,14.0,19.0,18.0,19.0,1
2653,CC:2F:71:3E:C5:1F,3242592,409498384,11561,1414205,3231031,408084179,6,49294,4128963,40726,3113785,8568,1015178,12189,36,16566,191,6,858,130000.0,39000.0,-69.0,-72.0,-68.0,-61.0,-69.0,-71.0,-69.0,-63.0,-81.0,-92.0,-84.0,-89.0,12.0,20.0,16.0,28.0,1
2654,CC:2F:71:3F:1F:24,12179191,14130575394,8948160,13722491215,3231031,408084179,158,2042923,1211199996,2034208,1210152892,8715,1047104,1977005,675,8952963,946037,158,6740,65000.0,14444.0,-68.0,-65.0,-72.0,-67.0,-68.0,-64.0,-72.0,-67.0,-81.0,-92.0,-84.0,-89.0,13.0,27.0,12.0,22.0,1
2655,3C:55:76:E8:8F:1F,3231514,409019955,472,934485,3231042,408085470,0,475,116288,417,106030,58,10258,355,3,474,243,0,34,206470.0,103230.0,-48.0,-51.0,-48.0,-51.0,-49.0,-51.0,-47.0,-49.0,-81.0,-92.0,-84.0,-89.0,33.0,41.0,36.0,38.0,1
2656,92:69:1D:31:68:E9,3262561,475496772,31517,67411102,3231044,408085670,0,13840,4289003,13699,4265906,141,23097,8847,1,31563,2527,0,161,229410.0,137640.0,-51.0,-51.0,-45.0,-50.0,-48.0,-50.0,-45.0,-48.0,-81.0,-92.0,-84.0,-89.0,30.0,41.0,39.0,39.0,1
2657,BA:8C:B9:54:50:24,3276874,511551914,45830,103466244,3231044,408085670,64,16124,4825001,15973,4800204,151,24797,9970,6,45810,11200,64,243,206470.0,97500.0,-47.0,-50.0,-54.0,-46.0,-52.0,-50.0,-42.0,-46.0,-81.0,-92.0,-84.0,-89.0,34.0,42.0,30.0,43.0,1
2658,62:47:05:9D:EB:15,3250683,455295821,19639,47210151,3231044,408085670,64,8744,1653634,8658,1639242,86,14392,3820,1,19623,2803,64,235,229410.0,130000.0,-43.0,-50.0,-43.0,-44.0,-42.0,-47.0,-43.0,-40.0,-81.0,-92.0,-84.0,-89.0,38.0,42.0,41.0,45.0,1
2659,F8:59:71:5A:E0:3D,3509708,828927171,278664,420841501,3231044,408085670,4,278151,379217071,273224,378628499,4927,588572,254180,20,281418,7384,4,867,144444.0,43333.0,-67.0,-73.0,-66.0,-71.0,-67.0,-73.0,-66.0,-70.0,-81.0,-92.0,-84.0,-89.0,14.0,19.0,18.0,18.0,1
2660,CC:2F:71:3E:C5:1F,3242605,409499875,11561,1414205,3231044,408085670,6,49294,4128963,40726,3113785,8568,1015178,12189,36,16566,191,6,858,130000.0,39000.0,-69.0,-72.0,-68.0,-61.0,-69.0,-71.0,-69.0,-63.0,-81.0,-92.0,-84.0,-89.0,12.0,20.0,16.0,28.0,1
2661,CC:2F:71:3F:1F:24,12180907,14133161876,8949852,13725074839,3231055,408087037,158,2043467,1211601779,2034752,1210554675,8715,1047104,1977549,675,8954676,946186,158,6740,86667.0,13000.0,-69.0,-65.0,-71.0,-68.0,-69.0,-64.0,-71.0,-68.0,-81.0,-92.0,-84.0,-89.0,12.0,27.0,13.0,21.0,1
2662,3C:55:76:E8:8F:1F,3231554,409048400,488,959857,3231066,408088543,0,513,121524,444,108978,69,12546,377,3,504,244,0,34,216660.0,130000.0,-46.0,-47.0,-45.0,-46.0,-47.0,-49.0,-45.0,-47.0,-81.0,-92.0,-84.0,-89.0,35.0,45.0,39.0,43.0,1
2663,92:69:1D:31:68:E9,3262583,475499645,31517,67411102,3231066,408088543,0,13840,4289003,13699,4265906,141,23097,8847,1,31563,2527,0,161,229410.0,137640.0,-51.0,-51.0,-45.0,-50.0,-48.0,-50.0,-45.0,-48.0,-81.0,-92.0,-84.0,-89.0,30.0,41.0,39.0,39.0,1
2664,BA:8C:B9:54:50:24,3276896,511554787,45830,103466244,3231066,408088543,64,16125,4825069,15974,4800272,151,24797,9970,6,45810,11200,64,243,206470.0,97500.0,-53.0,-51.0,-38.0,-46.0,-52.0,-50.0,-42.0,-46.0,-81.0,-92.0,-84.0,-89.0,28.0,41.0,46.0,43.0,1
2665,62:47:05:9D:EB:15,3250709,455299074,19639,47210151,3231070,408088923,64,8744,1653634,8658,1639242,86,14392,3820,1,19623,2803,64,235,229410.0,130000.0,-43.0,-50.0,-43.0,-44.0,-42.0,-47.0,-43.0,-40.0,-81.0,-92.0,-84.0,-89.0,38.0,42.0,41.0,45.0,1
2666,F8:59:71:5A:E0:3D,3509834,829074072,278756,420984469,3231078,408089603,4,278250,379369601,273323,378781029,4927,588572,254279,20,281510,7386,4,867,144444.0,43333.0,-67.0,-73.0,-66.0,-71.0,-67.0,-73.0,-66.0,-70.0,-81.0,-92.0,-84.0,-89.0,14.0,19.0,18.0,18.0,1
2667,CC:2F:71:3E:C5:1F,3242639,409503808,11561,1414205,3231078,408089603,6,49294,4128963,40726,3113785,8568,1015178,12189,36,16566,191,6,858,130000.0,39000.0,-69.0,-72.0,-68.0,-61.0,-69.0,-71.0,-69.0,-63.0,-81.0,-92.0,-84.0,-89.0,12.0,20.0,16.0,28.0,1
2668,CC:2F:71:3F:1F:24,12182306,14135254452,8951228,13727164849,3231078,408089603,158,2043917,1211943147,2035202,1210896043,8715,1047104,1977999,675,8956061,946228,158,6741,86667.0,14444.0,-69.0,-64.0,-70.0,-67.0,-68.0,-64.0,-70.0,-67.0,-81.0,-92.0,-84.0,-89.0,12.0,28.0,14.0,22.0,1
2669,3C:55:76:E8:8F:1F,3232438,411275824,1345,3184248,3231093,408091576,0,816,179890,737,165346,79,14544,499,4,1364,474,0,36,286760.0,1000.0,-46.0,-48.0,-45.0,-46.0,-47.0,-49.0,-45.0,-47.0,-81.0,-92.0,-84.0,-89.0,35.0,44.0,39.0,43.0,1
2670,92:69:1D:31:68:E9,3262610,475502678,31517,67411102,3231093,408091576,0,13840,4289003,13699,4265906,141,23097,8847,1,31563,2527,0,161,229410.0,137640.0,-51.0,-51.0,-45.0,-50.0,-48.0,-50.0,-45.0,-48.0,-81.0,-92.0,-84.0,-89.0,30.0,41.0,39.0,39.0,1
2671,BA:8C:B9:54:50:24,3276923,511557820,45830,103466244,3231093,408091576,64,16125,4825069,15974,4800272,151,24797,9970,6,45810,11200,64,243,206470.0,97500.0,-53.0,-51.0,-38.0,-46.0,-52.0,-50.0,-42.0,-46.0,-81.0,-92.0,-84.0,-89.0,28.0,41.0,46.0,43.0,1
2672,62:47:05:9D:EB:15,3250744,455303175,19639,47210151,3231105,408093024,64,8747,1653941,8660,1639378,87,14563,3821,1,19623,2803,64,235,229410.0,130000.0,-43.0,-50.0,-43.0,-45.0,-44.0,-48.0,-44.0,-42.0,-81.0,-91.0,-83.0,-89.0,38.0,41.0,40.0,44.0,1
2673,F8:59:71:5A:E0:3D,3510026,829333903,278921,421240879,3231105,408093024,4,278416,379626263,273489,379037691,4927,588572,254441,20,281675,7386,4,869,144444.0,43333.0,-67.0,-73.0,-66.0,-70.0,-67.0,-72.0,-65.0,-69.0,-81.0,-91.0,-83.0,-89.0,14.0,18.0,17.0,19.0,1
2674,CC:2F:71:3E:C5:1F,3242666,409507229,11561,1414205,3231105,408093024,6,49294,4128963,40726,3113785,8568,1015178,12189,36,16566,191,6,858,130000.0,39000.0,-69.0,-72.0,-68.0,-61.0,-69.0,-71.0,-69.0,-63.0,-81.0,-91.0,-83.0,-89.0,12.0,19.0,15.0,28.0,1
2675,CC:2F:71:3F:1F:24,12183781,14137446539,8952674,13729353315,3231107,408093224,158,2044499,1212454733,2035784,1211407629,8715,1047104,1978576,675,8957501,946302,158,6745,86667.0,14444.0,-68.0,-65.0,-72.0,-67.0,-68.0,-65.0,-72.0,-67.0,-81.0,-91.0,-83.0,-89.0,13.0,26.0,11.0,22.0,1
2676,3C:55:76:E8:8F:1F,3232478,411290452,1356,3195345,3231122,408095107,0,887,187930,792,170361,95,17569,525,4,1375,474,0,41,286760.0,172050.0,-46.0,-47.0,-43.0,-49.0,-47.0,-48.0,-44.0,-49.0,-81.0,-92.0,-84.0,-89.0,35.0,45.0,41.0,40.0,1
2677,92:69:1D:31:68:E9,3262641,475506411,31517,67411102,3231124,408095309,0,13840,4289003,13699,4265906,141,23097,8847,1,31563,2527,0,161,229410.0,137640.0,-51.0,-51.0,-45.0,-50.0,-48.0,-50.0,-45.0,-48.0,-81.0,-92.0,-84.0,-89.0,30.0,41.0,39.0,39.0,1
2678,BA:8C:B9:54:50:24,3276954,511561553,45830,103466244,3231124,408095309,64,16125,4825069,15974,4800272,151,24797,9970,6,45810,11200,64,243,206470.0,97500.0,-53.0,-51.0,-38.0,-46.0,-52.0,-50.0,-42.0,-46.0,-81.0,-92.0,-84.0,-89.0,28.0,41.0,46.0,43.0,1
2679,62:47:05:9D:EB:15,3251251,456407907,20127,48312598,3231124,408095309,64,8914,1705128,8827,1690565,87,14563,3925,1,20111,2826,64,238,229410.0,137640.0,-51.0,-50.0,-49.0,-41.0,-47.0,-51.0,-47.0,-45.0,-81.0,-92.0,-84.0,-89.0,30.0,42.0,35.0,48.0,1
2680,F8:59:71:5A:E0:3D,3510143,829488480,279019,421393171,3231124,408095309,4,278514,379777183,273587,379188611,4927,588572,254539,20,281773,7388,4,869,144444.0,43333.0,-67.0,-73.0,-66.0,-70.0,-67.0,-73.0,-66.0,-70.0,-81.0,-92.0,-84.0,-89.0,14.0,19.0,18.0,19.0,1
2681,CC:2F:71:3E:C5:1F,3242685,409509514,11561,1414205,3231124,408095309,6,49294,4128963,40726,3113785,8568,1015178,12189,36,16566,191,6,858,130000.0,39000.0,-69.0,-72.0,-68.0,-61.0,-69.0,-71.0,-69.0,-63.0,-81.0,-92.0,-84.0,-89.0,12.0,20.0,16.0,28.0,1
2682,CC:2F:71:3F:1F:24,12185228,14139622252,8954102,13731526741,3231126,408095511,158,2044950,1212800582,2036235,1211753478,8715,1047104,1979027,675,8958935,946372,158,6747,78000.0,13000.0,-68.0,-65.0,-72.0,-68.0,-68.0,-65.0,-72.0,-67.0,-81.0,-92.0,-84.0,-89.0,13.0,27.0,12.0,21.0,1
2683,3C:55:76:E8:8F:1F,3232493,411292210,1356,3195345,3231137,408096865,0,910,190736,811,172269,99,18467,531,4,1375,474,0,42,286760.0,172050.0,-48.0,-51.0,-47.0,-52.0,-46.0,-48.0,-44.0,-48.0,-81.0,-92.0,-84.0,-89.0,33.0,41.0,37.0,37.0,1
2684,92:69:1D:31:68:E9,3262656,475508169,31517,67411102,3231139,408097067,0,13841,4289071,13700,4265974,141,23097,8847,1,31563,2527,0,161,229410.0,137640.0,-55.0,-53.0,-53.0,-53.0,-49.0,-50.0,-46.0,-48.0,-81.0,-92.0,-84.0,-89.0,26.0,39.0,31.0,36.0,1
2685,BA:8C:B9:54:50:24,3276969,511563311,45830,103466244,3231139,408097067,64,16125,4825069,15974,4800272,151,24797,9970,6,45810,11200,64,243,206470.0,97500.0,-53.0,-51.0,-38.0,-46.0,-52.0,-50.0,-42.0,-46.0,-81.0,-92.0,-84.0,-89.0,28.0,41.0,46.0,43.0,1
2686,62:47:05:9D:EB:15,3251284,456418741,20143,48321472,3231141,408097269,64,8935,1712428,8848,1697865,87,14563,3940,1,20127,2827,64,238,229410.0,137640.0,-47.0,-52.0,-47.0,-46.0,-46.0,-52.0,-47.0,-46.0,-81.0,-92.0,-84.0,-89.0,34.0,40.0,37.0,43.0,1
2687,F8:59:71:5A:E0:3D,3510259,829644286,279118,421547017,3231141,408097269,4,278613,379929643,273686,379341071,4927,588572,254638,20,281872,7389,4,869,144444.0,43333.0,-67.0,-73.0,-66.0,-70.0,-67.0,-73.0,-66.0,-70.0,-81.0,-92.0,-84.0,-89.0,14.0,19.0,18.0,19.0,1
2688,CC:2F:71:3E:C5:1F,3242702,409511474,11561,1414205,3231141,408097269,6,49294,4128963,40726,3113785,8568,1015178,12189,36,16566,191,6,858,130000.0,39000.0,-69.0,-72.0,-68.0,-61.0,-69.0,-71.0,-69.0,-63.0,-81.0,-92.0,-84.0,-89.0,12.0,20.0,16.0,28.0,1
2689,CC:2F:71:3F:1F:24,12186535,14141574084,8955394,13733476815,3231141,408097269,158,2045368,1213122723,2036653,1212075619,8715,1047104,1979443,675,8960213,946388,158,6747,86667.0,14444.0,-68.0,-65.0,-72.0,-67.0,-68.0,-65.0,-72.0,-67.0,-81.0,-92.0,-84.0,-89.0,13.0,27.0,12.0,22.0,1
2690,3C:55:76:E8:8F:1F,3232513,411304563,1367,3206617,3231146,408097946,0,938,195555,839,177088,99,18467,540,4,1387,491,0,42,286760.0,172050.0,-46.0,-47.0,-44.0,-49.0,-47.0,-47.0,-43.0,-48.0,-81.0,-92.0,-84.0,-89.0,35.0,45.0,40.0,40.0,1
2691,92:69:1D:31:68:E9,3262663,475509048,31517,67411102,3231146,408097946,0,13841,4289071,13700,4265974,141,23097,8847,1,31563,2527,0,161,229410.0,137640.0,-55.0,-53.0,-53.0,-53.0,-49.0,-50.0,-46.0,-48.0,-81.0,-92.0,-84.0,-89.0,26.0,39.0,31.0,36.0,1
2692,BA:8C:B9:54:50:24,3276976,511564190,45830,103466244,3231146,408097946,64,16125,4825069,15974,4800272,151,24797,9970,6,45810,11200,64,243,206470.0,97500.0,-53.0,-51.0,-38.0,-46.0,-52.0,-50.0,-42.0,-46.0,-81.0,-92.0,-84.0,-89.0,28.0,41.0,46.0,43.0,1
2693,62:47:05:9D:EB:15,3251296,456420607,20150,48322661,3231146,408097946,64,8946,1715415,8859,1700852,87,14563,3947,1,20134,2827,64,238,229410.0,137640.0,-43.0,-51.0,-43.0,-45.0,-45.0,-52.0,-46.0,-45.0,-81.0,-92.0,-84.0,-89.0,38.0,41.0,41.0,44.0,1
2694,F8:59:71:5A:E0:3D,3510348,829775499,279202,421677553,3231146,408097946,4,278698,380060585,273771,379472013,4927,588572,254723,20,281956,7389,4,869,144444.0,43333.0,-67.0,-73.0,-66.0,-71.0,-67.0,-72.0,-66.0,-70.0,-81.0,-92.0,-84.0,-89.0,14.0,19.0,18.0,18.0,1
2695,CC:2F:71:3E:C5:1F,3242707,409512151,11561,1414205,3231146,408097946,6,49294,4128963,40726,3113785,8568,1015178,12189,36,16566,191,6,858,130000.0,39000.0,-69.0,-72.0,-68.0,-61.0,-69.0,-71.0,-69.0,-63.0,-81.0,-92.0,-84.0,-89.0,12.0,20.0,16.0,28.0,1
2696,CC:2F:71:3F:1F:24,12187929,14143690203,8956783,13735592257,3231146,408097946,158,2045805,1213417937,2037090,1212370833,8715,1047104,1979880,675,8961601,946475,158,6747,78000.0,13000.0,-69.0,-65.0,-72.0,-68.0,-69.0,-65.0,-72.0,-68.0,-81.0,-92.0,-84.0,-89.0,12.0,27.0,12.0,21.0,1
2697,3C:55:76:E8:8F:1F,3232528,411306175,1368,3206735,3231160,408099440,0,958,197875,853,178352,105,19523,547,4,1388,491,0,42,286760.0,172050.0,-46.0,-48.0,-44.0,-46.0,-46.0,-48.0,-45.0,-47.0,-81.0,-92.0,-84.0,-89.0,35.0,44.0,40.0,43.0,1
2698,92:69:1D:31:68:E9,3262679,475510744,31517,67411102,3231162,408099642,0,13841,4289071,13700,4265974,141,23097,8847,1,31563,2527,0,161,229410.0,137640.0,-55.0,-53.0,-53.0,-53.0,-49.0,-50.0,-46.0,-48.0,-81.0,-92.0,-84.0,-89.0,26.0,39.0,31.0,36.0,1
2699,BA:8C:B9:54:50:24,3276992,511565886,45830,103466244,3231162,408099642,64,16125,4825069,15974,4800272,151,24797,9970,6,45810,11200,64,243,206470.0,97500.0,-53.0,-51.0,-38.0,-46.0,-52.0,-50.0,-42.0,-46.0,-81.0,-92.0,-84.0,-89.0,28.0,41.0,46.0,43.0,1
2700,62:47:05:9D:EB:15,3251325,456424823,20163,48325181,3231162,408099642,64,8994,1730683,8907,1716120,87,14563,3963,1,20147,2827,64,238,229410.0,137640.0,-51.0,-49.0,-49.0,-41.0,-44.0,-47.0,-44.0,-40.0,-81.0,-92.0,-84.0,-89.0,30.0,43.0,35.0,48.0,1
2701,F8:59:71:5A:E0:3D,3510452,829913947,279290,421814305,3231162,408099642,4,278786,380196119,273859,379607547,4927,588572,254810,20,282044,7390,4,869,144444.0,43333.0,-67.0,-71.0,-66.0,-71.0,-67.0,-71.0,-66.0,-70.0,-81.0,-92.0,-84.0,-89.0,14.0,21.0,18.0,18.0,1
2702,CC:2F:71:3E:C5:1F,3242723,409513847,11561,1414205,3231162,408099642,6,49294,4128963,40726,3113785,8568,1015178,12189,36,16566,191,6,858,130000.0,39000.0,-69.0,-72.0,-68.0,-61.0,-69.0,-71.0,-69.0,-63.0,-81.0,-92.0,-84.0,-89.0,12.0,20.0,16.0,28.0,1
2703,CC:2F:71:3F:1F:24,12189268,14145698665,8958106,13737599023,3231162,408099642,158,2046223,1213720979,2037508,1212673875,8715,1047104,1980297,675,8962939,946523,158,6747,86667.0,13000.0,-69.0,-65.0,-72.0,-69.0,-69.0,-64.0,-71.0,-68.0,-81.0,-92.0,-84.0,-89.0,12.0,27.0,12.0,20.0,1
2704,3C:55:76:E8:8F:1F,3232533,411306999,1369,3207155,3231164,408099844,0,975,199037,870,179514,105,19523,547,4,1389,492,0,42,286760.0,172050.0,-48.0,-49.0,-46.0,-47.0,-47.0,-48.0,-44.0,-45.0,-81.0,-92.0,-84.0,-89.0,33.0,43.0,38.0,42.0,1
2705,92:69:1D:31:68:E9,3262684,475511558,31520,67411714,3231164,408099844,0,13851,4292173,13710,4269076,141,23097,8850,1,31566,2527,0,161,229410.0,137640.0,-54.0,-53.0,-46.0,-52.0,-51.0,-51.0,-46.0,-49.0,-81.0,-92.0,-84.0,-89.0,27.0,39.0,38.0,37.0,1
2706,BA:8C:B9:54:50:24,3276997,511566532,45830,103466244,3231167,408100288,64,16125,4825069,15974,4800272,151,24797,9970,6,45810,11200,64,243,206470.0,97500.0,-53.0,-51.0,-38.0,-46.0,-52.0,-50.0,-42.0,-46.0,-81.0,-92.0,-84.0,-89.0,28.0,41.0,46.0,43.0,1
2707,62:47:05:9D:EB:15,3251335,456429272,20167,48328924,3231168,408100348,64,9038,1736819,8951,1722256,87,14563,3968,1,20151,2827,64,238,229410.0,137640.0,-43.0,-49.0,-43.0,-44.0,-42.0,-47.0,-42.0,-41.0,-81.0,-92.0,-84.0,-89.0,38.0,43.0,41.0,45.0,1
2708,F8:59:71:5A:E0:3D,3510548,830053075,279380,421952727,3231168,408100348,4,278875,380333221,273948,379744649,4927,588572,254899,20,282134,7391,4,869,144444.0,43333.0,-68.0,-73.0,-67.0,-71.0,-67.0,-73.0,-66.0,-71.0,-81.0,-92.0,-84.0,-89.0,13.0,19.0,17.0,18.0,1
2709,CC:2F:71:3E:C5:1F,3242733,409514933,11562,1414321,3231171,408100612,6,49296,4129103,40728,3113925,8568,1015178,12189,36,16567,191,6,858,130000.0,39000.0,-69.0,-71.0,-69.0,-60.0,-69.0,-71.0,-68.0,-63.0,-81.0,-92.0,-84.0,-89.0,12.0,21.0,15.0,29.0,1
2710,CC:2F:71:3F:1F:24,12190619,14147727876,8959448,13739627264,3231171,408100612,158,2046673,1214040978,2037958,1212993874,8715,1047104,1980744,675,8964281,946593,158,6747,104000.0,26000.0,-69.0,-65.0,-71.0,-68.0,-69.0,-64.0,-71.0,-68.0,-81.0,-92.0,-84.0,-89.0,12.0,27.0,13.0,21.0,1
2711,3C:55:76:E8:8F:1F,3232553,411309330,1371,3207527,3231182,408101803,0,1008,201819,898,181550,110,20269,554,4,1391,492,0,42,286760.0,172050.0,-47.0,-50.0,-48.0,-50.0,-46.0,-49.0,-46.0,-49.0,-81.0,-92.0,-84.0,-89.0,34.0,42.0,36.0,39.0,1
2712,92:69:1D:31:68:E9,3262746,475620303,31563,67518258,3231183,408102045,0,13862,4296920,13721,4273823,141,23097,8857,1,31609,2536,0,161,229410.0,137640.0,-53.0,-51.0,-46.0,-51.0,-51.0,-50.0,-46.0,-50.0,-81.0,-92.0,-84.0,-89.0,28.0,41.0,38.0,38.0,1
2713,BA:8C:B9:54:50:24,3277014,511568405,45831,103466360,3231183,408102045,64,16127,4825205,15976,4800408,151,24797,9970,6,45811,11200,64,243,206470.0,97500.0,-53.0,-51.0,-38.0,-46.0,-51.0,-50.0,-42.0,-46.0,-81.0,-92.0,-84.0,-89.0,28.0,41.0,46.0,43.0,1
2714,62:47:05:9D:EB:15,3251360,456432538,20177,48330493,3231183,408102045,64,9075,1742443,8987,1727645,88,14798,3978,1,20161,2827,64,238,229410.0,137640.0,-43.0,-49.0,-43.0,-44.0,-46.0,-51.0,-47.0,-45.0,-81.0,-92.0,-84.0,-89.0,38.0,43.0,41.0,45.0,1
2715,F8:59:71:5A:E0:3D,3510666,830214834,279483,422112789,3231183,408102045,4,278979,380493437,274052,379904865,4927,588572,255002,20,282237,7391,4,869,144444.0,43333.0,-67.0,-73.0,-67.0,-71.0,-67.0,-72.0,-67.0,-71.0,-81.0,-92.0,-84.0,-89.0,14.0,19.0,17.0,18.0,1
2716,CC:2F:71:3E:C5:1F,3242745,409516366,11562,1414321,3231183,408102045,6,49298,4129291,40729,3113995,8569,1015296,12190,36,16567,191,6,858,130000.0,39000.0,-68.0,-72.0,-68.0,-60.0,-68.0,-70.0,-67.0,-60.0,-81.0,-92.0,-84.0,-89.0,13.0,20.0,16.0,29.0,1
2717,CC:2F:71:3F:1F:24,12192153,14150045679,8960968,13741943432,3231185,408102247,158,2047179,1214444486,2038464,1213397382,8715,1047104,1981232,675,8965776,946701,158,6747,86667.0,14444.0,-69.0,-65.0,-71.0,-69.0,-69.0,-64.0,-71.0,-68.0,-81.0,-92.0,-84.0,-89.0,12.0,27.0,13.0,20.0,1
2718,3C:55:76:E8:8F:1F,3232572,411317176,1380,3214096,3231192,408103080,0,1043,207859,929,186705,114,21154,569,4,1400,494,0,44,286760.0,172050.0,-55.0,-52.0,-49.0,-51.0,-49.0,-50.0,-48.0,-50.0,-81.0,-92.0,-84.0,-89.0,26.0,40.0,35.0,38.0,1
2719,92:69:1D:31:68:E9,3262761,475624678,31569,67521598,3231192,408103080,0,13869,4299814,13728,4276717,141,23097,8861,1,31615,2536,0,161,229410.0,137640.0,-46.0,-48.0,-44.0,-45.0,-49.0,-50.0,-45.0,-49.0,-81.0,-92.0,-84.0,-89.0,35.0,44.0,40.0,44.0,1
2720,BA:8C:B9:54:50:24,3277033,511570322,45831,103466360,3231202,408103962,64,16127,4825205,15976,4800408,151,24797,9970,6,45811,11200,64,243,206470.0,97500.0,-53.0,-51.0,-38.0,-46.0,-51.0,-50.0,-42.0,-46.0,-81.0,-92.0,-84.0,-89.0,28.0,41.0,46.0,43.0,1
2721,62:47:05:9D:EB:15,3251400,456438500,20198,48334538,3231202,408103962,64,9149,1761685,9061,1746887,88,14798,4005,1,20182,2827,64,240,229410.0,137640.0,-51.0,-49.0,-48.0,-41.0,-43.0,-47.0,-42.0,-41.0,-81.0,-92.0,-84.0,-89.0,30.0,43.0,36.0,48.0,1
2722,F8:59:71:5A:E0:3D,3510795,830387635,279593,422283673,3231202,408103962,4,279090,380664391,274163,380075819,4927,588572,255112,20,282347,7393,4,869,144444.0,39000.0,-68.0,-73.0,-67.0,-71.0,-67.0,-72.0,-66.0,-71.0,-81.0,-92.0,-84.0,-89.0,13.0,19.0,17.0,18.0,1
2723,CC:2F:71:3E:C5:1F,3242765,409518442,11562,1414321,3231203,408104121,6,49298,4129291,40729,3113995,8569,1015296,12190,36,16567,191,6,858,130000.0,39000.0,-68.0,-72.0,-68.0,-60.0,-68.0,-70.0,-67.0,-60.0,-81.0,-92.0,-84.0,-89.0,13.0,20.0,16.0,29.0,1
2724,CC:2F:71:3F:1F:24,12193475,14152025353,8962272,13743921232,3231203,408104121,158,2047609,1214777958,2038894,1213730854,8715,1047104,1981659,675,8967101,946759,158,6747,86667.0,14444.0,-69.0,-64.0,-71.0,-68.0,-68.0,-64.0,-71.0,-68.0,-81.0,-92.0,-84.0,-89.0,12.0,28.0,13.0,21.0,1
2725,3C:55:76:E8:8F:1F,3232659,411440588,1442,3335109,3231217,408105479,0,1132,225925,1013,203850,119,22075,613,4,1462,494,0,48,286760.0,172050.0,-45.0,-47.0,-44.0,-44.0,-47.0,-49.0,-46.0,-47.0,-81.0,-92.0,-84.0,-89.0,36.0,45.0,40.0,45.0,1
2726,92:69:1D:31:68:E9,3262790,475627429,31569,67521598,3231221,408105831,0,13869,4299814,13728,4276717,141,23097,8861,1,31615,2536,0,161,229410.0,137640.0,-46.0,-48.0,-44.0,-45.0,-49.0,-50.0,-45.0,-49.0,-81.0,-92.0,-84.0,-89.0,35.0,44.0,40.0,44.0,1
2727,BA:8C:B9:54:50:24,3277052,511572191,45831,103466360,3231221,408105831,64,16127,4825205,15976,4800408,151,24797,9970,6,45811,11200,64,243,206470.0,97500.0,-53.0,-51.0,-38.0,-46.0,-51.0,-50.0,-42.0,-46.0,-81.0,-92.0,-84.0,-89.0,28.0,41.0,46.0,43.0,1
2728,62:47:05:9D:EB:15,3251419,456440369,20198,48334538,3231221,408105831,64,9149,1761685,9061,1746887,88,14798,4005,1,20182,2827,64,240,229410.0,137640.0,-51.0,-49.0,-48.0,-41.0,-43.0,-47.0,-42.0,-41.0,-81.0,-92.0,-84.0,-89.0,30.0,43.0,36.0,48.0,1
2729,F8:59:71:5A:E0:3D,3510904,830526344,279681,422420313,3231223,408106031,4,279178,380798517,274250,380209827,4928,588690,255198,20,282435,7394,4,869,144444.0,43333.0,-67.0,-73.0,-67.0,-71.0,-67.0,-72.0,-66.0,-70.0,-81.0,-92.0,-84.0,-89.0,14.0,19.0,17.0,18.0,1
2730,CC:2F:71:3E:C5:1F,3242785,409520352,11562,1414321,3231223,408106031,6,49298,4129291,40729,3113995,8569,1015296,12190,36,16567,191,6,858,130000.0,39000.0,-68.0,-72.0,-68.0,-60.0,-68.0,-70.0,-67.0,-60.0,-81.0,-92.0,-84.0,-89.0,13.0,20.0,16.0,29.0,1
2731,CC:2F:71:3F:1F:24,12194970,14154263904,8963745,13746157671,3231225,408106233,158,2048054,1215074552,2039339,1214027448,8715,1047104,1982102,675,8968578,946785,158,6747,86667.0,14444.0,-69.0,-64.0,-71.0,-68.0,-69.0,-64.0,-70.0,-68.0,-81.0,-92.0,-84.0,-89.0,12.0,28.0,13.0,21.0,1
2732,3C:55:76:E8:8F:1F,3232701,411471069,1473,3364516,3231228,408106553,0,1189,236035,1063,212898,126,23137,645,4,1493,503,0,49,286760.0,172050.0,-56.0,-51.0,-47.0,-50.0,-48.0,-49.0,-46.0,-47.0,-81.0,-92.0,-84.0,-89.0,25.0,41.0,37.0,39.0,1
2733,92:69:1D:31:68:E9,3262799,475628351,31569,67521598,3231230,408106753,0,13869,4299814,13728,4276717,141,23097,8861,1,31615,2536,0,161,229410.0,137640.0,-46.0,-48.0,-44.0,-45.0,-49.0,-50.0,-45.0,-49.0,-81.0,-92.0,-84.0,-89.0,35.0,44.0,40.0,44.0,1
2734,BA:8C:B9:54:50:24,3277061,511573113,45831,103466360,3231230,408106753,64,16127,4825205,15976,4800408,151,24797,9970,6,45811,11200,64,243,206470.0,97500.0,-53.0,-51.0,-38.0,-46.0,-51.0,-50.0,-42.0,-46.0,-81.0,-92.0,-84.0,-89.0,28.0,41.0,46.0,43.0,1
2735,62:47:05:9D:EB:15,3251431,456441757,20198,48334538,3231233,408107219,64,9149,1761685,9061,1746887,88,14798,4005,1,20182,2827,64,240,229410.0,137640.0,-51.0,-49.0,-48.0,-41.0,-43.0,-47.0,-42.0,-41.0,-81.0,-92.0,-84.0,-89.0,30.0,43.0,36.0,48.0,1
2736,F8:59:71:5A:E0:3D,3511050,830731602,279813,422624003,3231237,408107599,4,279295,380978697,274367,380390007,4928,588690,255315,20,282567,7395,4,869,144444.0,43333.0,-67.0,-73.0,-66.0,-71.0,-67.0,-72.0,-66.0,-70.0,-81.0,-92.0,-84.0,-89.0,14.0,19.0,18.0,18.0,1
2737,CC:2F:71:3E:C5:1F,3242799,409521920,11562,1414321,3231237,408107599,6,49298,4129291,40729,3113995,8569,1015296,12190,36,16567,191,6,858,130000.0,39000.0,-68.0,-72.0,-68.0,-60.0,-68.0,-70.0,-67.0,-60.0,-81.0,-92.0,-84.0,-89.0,13.0,20.0,16.0,29.0,1
2738,CC:2F:71:3F:1F:24,12197278,14157757019,8966039,13749649218,3231239,408107801,158,2048732,1215550151,2040017,1214503047,8715,1047104,1982778,675,8970841,947047,158,6748,86667.0,14444.0,-69.0,-64.0,-71.0,-68.0,-69.0,-64.0,-70.0,-68.0,-81.0,-92.0,-84.0,-89.0,12.0,28.0,13.0,21.0,1
2739,3C:55:76:E8:8F:1F,3232808,411628947,1554,3515340,3231254,408113607,0,1320,260970,1189,236853,131,24117,708,4,1576,630,0,50,286760.0,172050.0,-47.0,-48.0,-45.0,-45.0,-48.0,-49.0,-46.0,-47.0,-81.0,-92.0,-84.0,-89.0,34.0,44.0,39.0,44.0,1
2740,92:69:1D:31:68:E9,3262824,475635321,31570,67521714,3231254,408113607,0,13874,4300192,13733,4277095,141,23097,8862,1,31616,2536,0,161,229410.0,137640.0,-53.0,-50.0,-45.0,-51.0,-50.0,-50.0,-46.0,-49.0,-81.0,-92.0,-84.0,-89.0,28.0,42.0,39.0,38.0,1
2741,BA:8C:B9:54:50:24,3277098,511585593,45831,103466360,3231267,408119233,64,16127,4825205,15976,4800408,151,24797,9970,6,45811,11200,64,243,206470.0,97500.0,-53.0,-51.0,-38.0,-46.0,-51.0,-50.0,-42.0,-46.0,-81.0,-92.0,-84.0,-89.0,28.0,41.0,46.0,43.0,1
2742,62:47:05:9D:EB:15,3251465,456453771,20198,48334538,3231267,408119233,64,9152,1761943,9063,1747023,89,14920,4006,1,20182,2827,64,240,229410.0,137640.0,-43.0,-49.0,-43.0,-44.0,-44.0,-48.0,-43.0,-42.0,-81.0,-92.0,-84.0,-89.0,38.0,43.0,41.0,45.0,1
2743,F8:59:71:5A:E0:3D,3511205,830933144,279935,422813591,3231270,408119553,4,279435,381193031,274507,380604341,4928,588690,255455,20,282689,7396,4,869,144444.0,43333.0,-68.0,-73.0,-66.0,-71.0,-67.0,-73.0,-66.0,-71.0,-81.0,-92.0,-84.0,-89.0,13.0,19.0,18.0,18.0,1
2744,CC:2F:71:3E:C5:1F,3242833,409533936,11562,1414321,3231271,408119615,6,49298,4129291,40729,3113995,8569,1015296,12190,36,16567,191,6,858,130000.0,39000.0,-68.0,-72.0,-68.0,-60.0,-68.0,-70.0,-67.0,-60.0,-81.0,-92.0,-84.0,-89.0,13.0,20.0,16.0,29.0,1
2745,CC:2F:71:3F:1F:24,12199601,14161274341,8968330,13753154726,3231271,408119615,158,2049384,1215988534,2040668,1214941312,8716,1047222,1983430,675,8973163,947270,158,6748,86667.0,13000.0,-69.0,-65.0,-71.0,-68.0,-69.0,-64.0,-70.0,-68.0,-81.0,-92.0,-84.0,-89.0,12.0,27.0,13.0,21.0,1
2746,3C:55:76:E8:8F:1F,3232868,411699826,1591,3579629,3231277,408120197,0,1378,273542,1245,249077,133,24465,734,4,1613,632,0,51,286760.0,172050.0,-48.0,-52.0,-48.0,-50.0,-47.0,-49.0,-45.0,-46.0,-81.0,-92.0,-84.0,-89.0,33.0,40.0,36.0,39.0,1
2747,92:69:1D:31:68:E9,3262847,475641911,31570,67521714,3231277,408120197,0,13874,4300192,13733,4277095,141,23097,8862,1,31616,2536,0,161,229410.0,137640.0,-53.0,-50.0,-45.0,-51.0,-50.0,-50.0,-46.0,-49.0,-81.0,-92.0,-84.0,-89.0,28.0,42.0,39.0,38.0,1
2748,BA:8C:B9:54:50:24,3277108,511586557,45831,103466360,3231277,408120197,64,16127,4825205,15976,4800408,151,24797,9970,6,45811,11200,64,243,206470.0,97500.0,-53.0,-51.0,-38.0,-46.0,-51.0,-50.0,-42.0,-46.0,-81.0,-92.0,-84.0,-89.0,28.0,41.0,46.0,43.0,1
2749,62:47:05:9D:EB:15,3251475,456454735,20198,48334538,3231277,408120197,64,9152,1761943,9063,1747023,89,14920,4006,1,20182,2827,64,240,229410.0,137640.0,-43.0,-49.0,-43.0,-44.0,-44.0,-48.0,-43.0,-42.0,-81.0,-92.0,-84.0,-89.0,38.0,43.0,41.0,45.0,1
2750,F8:59:71:5A:E0:3D,3511309,831083088,280032,422962891,3231277,408120197,4,279532,381341061,274604,380752371,4928,588690,255552,20,282786,7397,4,869,144444.0,43333.0,-67.0,-73.0,-66.0,-71.0,-67.0,-73.0,-66.0,-71.0,-81.0,-92.0,-84.0,-89.0,14.0,19.0,18.0,18.0,1
2751,CC:2F:71:3E:C5:1F,3242839,409534518,11562,1414321,3231277,408120197,6,49299,4129361,40730,3114065,8569,1015296,12190,36,16568,191,6,858,130000.0,39000.0,-69.0,-72.0,-68.0,-60.0,-68.0,-70.0,-67.0,-60.0,-81.0,-92.0,-84.0,-89.0,12.0,20.0,16.0,29.0,1
2752,CC:2F:71:3F:1F:24,12200887,14163218325,8969610,13755098128,3231277,408120197,158,2049794,1216302458,2041078,1215255236,8716,1047222,1983838,675,8974435,947289,158,6750,86667.0,14444.0,-70.0,-65.0,-72.0,-69.0,-69.0,-64.0,-71.0,-68.0,-81.0,-92.0,-84.0,-89.0,11.0,27.0,12.0,20.0,1
2753,3C:55:76:E8:8F:1F,3232877,411700949,1593,3579897,3231284,408121052,0,1398,275054,1263,250309,135,24745,736,4,1615,632,0,52,286760.0,172050.0,-57.0,-52.0,-47.0,-51.0,-47.0,-49.0,-45.0,-49.0,-81.0,-92.0,-84.0,-89.0,24.0,40.0,37.0,38.0,1
2754,92:69:1D:31:68:E9,3262856,475642968,31570,67521714,3231286,408121254,0,13874,4300192,13733,4277095,141,23097,8862,1,31616,2536,0,161,229410.0,137640.0,-53.0,-50.0,-45.0,-51.0,-50.0,-50.0,-46.0,-49.0,-81.0,-92.0,-84.0,-89.0,28.0,42.0,39.0,38.0,1
2755,BA:8C:B9:54:50:24,3277117,511587614,45831,103466360,3231286,408121254,64,16129,4825341,15978,4800544,151,24797,9970,6,45812,11200,64,243,206470.0,97500.0,-47.0,-50.0,-54.0,-46.0,-50.0,-50.0,-44.0,-46.0,-81.0,-92.0,-84.0,-89.0,34.0,42.0,30.0,43.0,1
2756,62:47:05:9D:EB:15,3251484,456455792,20198,48334538,3231286,408121254,64,9152,1761943,9063,1747023,89,14920,4006,1,20182,2827,64,240,229410.0,137640.0,-43.0,-49.0,-43.0,-44.0,-44.0,-48.0,-43.0,-42.0,-81.0,-92.0,-84.0,-89.0,38.0,43.0,41.0,45.0,1
2757,F8:59:71:5A:E0:3D,3511411,831228667,280125,423107413,3231286,408121254,4,279625,381484281,274697,380895591,4928,588690,255645,20,282878,7398,4,869,144444.0,43333.0,-67.0,-72.0,-66.0,-71.0,-67.0,-72.0,-66.0,-71.0,-81.0,-92.0,-84.0,-89.0,14.0,20.0,18.0,18.0,1
2758,CC:2F:71:3E:C5:1F,3242848,409535575,11562,1414321,3231286,408121254,6,49300,4129431,40731,3114135,8569,1015296,12190,36,16568,191,6,858,130000.0,39000.0,-69.0,-72.0,-68.0,-60.0,-68.0,-70.0,-67.0,-60.0,-81.0,-92.0,-84.0,-89.0,12.0,20.0,16.0,29.0,1
2759,CC:2F:71:3F:1F:24,12202943,14166368380,8971657,13758247126,3231286,408121254,158,2050346,1216628684,2041630,1215581462,8716,1047222,1984387,675,8976450,947557,158,6750,86667.0,14444.0,-69.0,-65.0,-71.0,-69.0,-69.0,-65.0,-71.0,-68.0,-81.0,-92.0,-84.0,-89.0,12.0,27.0,13.0,20.0,1
2760,3C:55:76:E8:8F:1F,3232890,411702609,1598,3580773,3231292,408121836,0,1431,277888,1295,252969,136,24919,746,4,1620,632,0,53,286760.0,172050.0,-46.0,-49.0,-43.0,-48.0,-48.0,-47.0,-43.0,-47.0,-81.0,-92.0,-84.0,-89.0,35.0,43.0,41.0,41.0,1
2761,92:69:1D:31:68:E9,3262862,475643550,31570,67521714,3231292,408121836,0,13874,4300192,13733,4277095,141,23097,8862,1,31616,2536,0,161,229410.0,137640.0,-53.0,-50.0,-45.0,-51.0,-50.0,-50.0,-46.0,-49.0,-81.0,-92.0,-84.0,-89.0,28.0,42.0,39.0,38.0,1
2762,BA:8C:B9:54:50:24,3277126,511588516,45831,103466360,3231295,408122156,64,16129,4825341,15978,4800544,151,24797,9970,6,45812,11200,64,243,206470.0,97500.0,-47.0,-50.0,-54.0,-46.0,-50.0,-50.0,-44.0,-46.0,-81.0,-92.0,-84.0,-89.0,34.0,42.0,30.0,43.0,1
2763,62:47:05:9D:EB:15,3251493,456456694,20198,48334538,3231295,408122156,64,9152,1761943,9063,1747023,89,14920,4006,1,20182,2827,64,240,229410.0,137640.0,-43.0,-49.0,-43.0,-44.0,-44.0,-48.0,-43.0,-42.0,-81.0,-92.0,-84.0,-89.0,38.0,43.0,41.0,45.0,1
2764,F8:59:71:5A:E0:3D,3511525,831388404,280229,423266186,3231296,408122218,4,279729,381643074,274801,381054384,4928,588690,255748,20,282983,7398,4,869,144444.0,43333.0,-67.0,-72.0,-67.0,-70.0,-67.0,-72.0,-66.0,-69.0,-81.0,-92.0,-84.0,-89.0,14.0,20.0,17.0,19.0,1
2765,CC:2F:71:3E:C5:1F,3242858,409536539,11562,1414321,3231296,408122218,6,49300,4129431,40731,3114135,8569,1015296,12190,36,16568,191,6,858,130000.0,39000.0,-69.0,-72.0,-68.0,-60.0,-68.0,-70.0,-67.0,-60.0,-81.0,-92.0,-84.0,-89.0,12.0,20.0,16.0,29.0,1
2766,CC:2F:71:3F:1F:24,12205549,14170366919,8974251,13762244499,3231298,408122420,158,2051010,1216994387,2042294,1215947165,8716,1047222,1985047,675,8979084,947634,158,6750,86667.0,14444.0,-70.0,-64.0,-73.0,-68.0,-70.0,-64.0,-72.0,-68.0,-81.0,-92.0,-84.0,-89.0,11.0,28.0,11.0,21.0,1
2767,3C:55:76:E8:8F:1F,3232904,411704568,1600,3581115,3231304,408123453,0,1448,279984,1310,254605,138,25379,751,4,1622,632,0,55,286760.0,172050.0,-45.0,-48.0,-43.0,-46.0,-44.0,-46.0,-42.0,-45.0,-81.0,-92.0,-84.0,-89.0,36.0,44.0,41.0,43.0,1
2768,92:69:1D:31:68:E9,3262881,475646476,31577,67523023,3231304,408123453,0,13890,4306059,13747,4282669,143,23390,8870,1,31623,2536,0,161,216660.0,130000.0,-52.0,-52.0,-46.0,-50.0,-50.0,-51.0,-45.0,-49.0,-81.0,-92.0,-84.0,-89.0,29.0,40.0,38.0,39.0,1
2769,BA:8C:B9:54:50:24,3277135,511589813,45831,103466360,3231304,408123453,64,16129,4825341,15978,4800544,151,24797,9970,6,45812,11200,64,243,206470.0,97500.0,-47.0,-50.0,-54.0,-46.0,-50.0,-50.0,-44.0,-46.0,-81.0,-92.0,-84.0,-89.0,34.0,42.0,30.0,43.0,1
2770,62:47:05:9D:EB:15,3251502,456457991,20198,48334538,3231304,408123453,64,9152,1761943,9063,1747023,89,14920,4006,1,20182,2827,64,240,229410.0,137640.0,-43.0,-49.0,-43.0,-44.0,-44.0,-48.0,-43.0,-42.0,-81.0,-92.0,-84.0,-89.0,38.0,43.0,41.0,45.0,1
2771,F8:59:71:5A:E0:3D,3511540,831390898,280234,423267243,3231306,408123655,4,279736,381644350,274808,381055660,4928,588690,255754,20,282988,7398,4,869,144444.0,43333.0,-66.0,-71.0,-65.0,-69.0,-66.0,-71.0,-66.0,-69.0,-81.0,-92.0,-84.0,-89.0,15.0,21.0,19.0,20.0,1
2772,CC:2F:71:3E:C5:1F,3242868,409537976,11562,1414321,3231306,408123655,6,49300,4129431,40731,3114135,8569,1015296,12190,36,16568,191,6,858,130000.0,39000.0,-69.0,-72.0,-68.0,-60.0,-68.0,-70.0,-67.0,-60.0,-81.0,-92.0,-84.0,-89.0,12.0,20.0,16.0,29.0,1
2773,CC:2F:71:3F:1F:24,12208260,14174555840,8976954,13766432185,3231306,408123655,158,2051589,1217193793,2042873,1216146571,8716,1047222,1985626,675,8981787,947732,158,6750,86667.0,14444.0,-69.0,-64.0,-72.0,-69.0,-69.0,-64.0,-72.0,-69.0,-81.0,-92.0,-84.0,-89.0,12.0,28.0,12.0,20.0,1
2774,3C:55:76:E8:8F:1F,3232911,411705234,1600,3581115,3231311,408124119,0,1454,280394,1316,255015,138,25379,751,4,1622,632,0,55,286760.0,172050.0,-44.0,-48.0,-43.0,-46.0,-44.0,-48.0,-43.0,-46.0,-81.0,-92.0,-84.0,-89.0,37.0,44.0,41.0,43.0,1
2775,92:69:1D:31:68:E9,3262888,475647142,31577,67523023,3231311,408124119,0,13890,4306059,13747,4282669,143,23390,8870,1,31623,2536,0,161,216660.0,130000.0,-52.0,-52.0,-46.0,-50.0,-50.0,-51.0,-45.0,-49.0,-81.0,-92.0,-84.0,-89.0,29.0,40.0,38.0,39.0,1
2776,BA:8C:B9:54:50:24,3277142,511590479,45831,103466360,3231311,408124119,64,16129,4825341,15978,4800544,151,24797,9970,6,45812,11200,64,243,206470.0,97500.0,-47.0,-50.0,-54.0,-46.0,-50.0,-50.0,-44.0,-46.0,-81.0,-92.0,-84.0,-89.0,34.0,42.0,30.0,43.0,1
2777,62:47:05:9D:EB:15,3251905,457509775,20594,49385656,3231311,408124119,64,9201,1771289,9112,1756369,89,14920,4050,1,20578,2829,64,240,216660.0,130000.0,-46.0,-51.0,-47.0,-45.0,-46.0,-51.0,-47.0,-45.0,-81.0,-92.0,-84.0,-89.0,35.0,41.0,37.0,44.0,1
2778,F8:59:71:5A:E0:3D,3511547,831391564,280234,423267243,3231313,408124321,4,279736,381644350,274808,381055660,4928,588690,255754,20,282988,7398,4,869,144444.0,43333.0,-66.0,-71.0,-65.0,-69.0,-66.0,-71.0,-66.0,-69.0,-81.0,-92.0,-84.0,-89.0,15.0,21.0,19.0,20.0,1
2779,CC:2F:71:3E:C5:1F,3242875,409538642,11562,1414321,3231313,408124321,6,49300,4129431,40731,3114135,8569,1015296,12190,36,16568,191,6,858,130000.0,39000.0,-69.0,-72.0,-68.0,-60.0,-68.0,-70.0,-67.0,-60.0,-81.0,-92.0,-84.0,-89.0,12.0,20.0,16.0,29.0,1
2780,CC:2F:71:3F:1F:24,12210206,14177539660,8978893,13769415339,3231313,408124321,158,2052037,1217417852,2043321,1216370630,8716,1047222,1986074,675,8983698,948351,158,6750,86667.0,14444.0,-67.0,-65.0,-71.0,-70.0,-67.0,-65.0,-71.0,-70.0,-81.0,-92.0,-84.0,-89.0,14.0,27.0,13.0,19.0,1
2781,3C:55:76:E8:8F:1F,3234955,417123258,3638,8998533,3231317,408124725,0,1916,349016,1778,323637,138,25379,896,4,3660,784,0,56,286760.0,172050.0,-51.0,-53.0,-46.0,-50.0,-50.0,-51.0,-45.0,-48.0,-81.0,-92.0,-84.0,-89.0,30.0,39.0,38.0,39.0,1
2782,92:69:1D:31:68:E9,3263256,476591804,31936,68466817,3231320,408124987,0,13928,4319889,13785,4296499,143,23390,8900,1,31982,2678,0,161,229410.0,130000.0,-55.0,-51.0,-45.0,-50.0,-51.0,-50.0,-45.0,-48.0,-81.0,-92.0,-84.0,-89.0,26.0,41.0,39.0,39.0,1
2783,BA:8C:B9:54:50:24,3277151,511591347,45831,103466360,3231320,408124987,64,16129,4825341,15978,4800544,151,24797,9970,6,45812,11200,64,243,206470.0,97500.0,-47.0,-50.0,-54.0,-46.0,-50.0,-50.0,-44.0,-46.0,-81.0,-92.0,-84.0,-89.0,34.0,42.0,30.0,43.0,1
2784,62:47:05:9D:EB:15,3251916,457510845,20594,49385656,3231322,408125189,64,9216,1772309,9127,1757389,89,14920,4050,1,20578,2829,64,241,216660.0,130000.0,-43.0,-49.0,-44.0,-45.0,-47.0,-52.0,-47.0,-46.0,-81.0,-91.0,-84.0,-90.0,38.0,42.0,40.0,45.0,1
2785,F8:59:71:5A:E0:3D,3511557,831392510,280234,423267243,3231323,408125267,4,279736,381644350,274808,381055660,4928,588690,255754,20,282988,7398,4,869,144444.0,43333.0,-66.0,-71.0,-65.0,-69.0,-66.0,-71.0,-66.0,-69.0,-81.0,-91.0,-84.0,-90.0,15.0,20.0,19.0,21.0,1
2786,CC:2F:71:3E:C5:1F,3242885,409539588,11562,1414321,3231323,408125267,6,49300,4129431,40731,3114135,8569,1015296,12190,36,16568,191,6,858,130000.0,39000.0,-69.0,-72.0,-68.0,-60.0,-68.0,-70.0,-67.0,-60.0,-81.0,-91.0,-84.0,-90.0,12.0,19.0,16.0,30.0,1
2787,CC:2F:71:3F:1F:24,12212212,14180602967,8980889,13772477700,3231323,408125267,158,2052553,1217674588,2043837,1216627366,8716,1047222,1986588,675,8985708,948528,158,6753,104000.0,26000.0,-68.0,-65.0,-71.0,-69.0,-67.0,-65.0,-70.0,-69.0,-81.0,-91.0,-84.0,-90.0,13.0,26.0,13.0,21.0,1
2788,3C:55:76:E8:8F:1F,3234966,417124365,3639,8998694,3231327,408125671,0,1942,350913,1804,325534,138,25379,898,4,3661,784,0,56,286760.0,172050.0,-49.0,-51.0,-48.0,-51.0,-48.0,-51.0,-47.0,-51.0,-81.0,-91.0,-84.0,-90.0,32.0,40.0,36.0,39.0,1
2789,92:69:1D:31:68:E9,3263264,476592599,31936,68466817,3231328,408125782,0,13928,4319889,13785,4296499,143,23390,8900,1,31982,2678,0,161,229410.0,130000.0,-55.0,-51.0,-45.0,-50.0,-51.0,-50.0,-45.0,-48.0,-81.0,-91.0,-84.0,-90.0,26.0,40.0,39.0,40.0,1
2790,BA:8C:B9:54:50:24,3277159,511592142,45831,103466360,3231328,408125782,64,16129,4825341,15978,4800544,151,24797,9970,6,45812,11200,64,243,206470.0,97500.0,-47.0,-50.0,-54.0,-46.0,-50.0,-50.0,-44.0,-46.0,-81.0,-91.0,-84.0,-90.0,34.0,41.0,30.0,44.0,1
2791,62:47:05:9D:EB:15,3251922,457511438,20594,49385656,3231328,408125782,64,9219,1772616,9129,1757525,90,15091,4051,1,20578,2829,64,241,216660.0,130000.0,-47.0,-51.0,-48.0,-45.0,-48.0,-52.0,-48.0,-47.0,-81.0,-91.0,-84.0,-90.0,34.0,40.0,36.0,45.0,1
2792,F8:59:71:5A:E0:3D,3511562,831393025,280234,423267243,3231328,408125782,4,279736,381644350,274808,381055660,4928,588690,255754,20,282988,7398,4,869,144444.0,43333.0,-66.0,-71.0,-65.0,-69.0,-66.0,-71.0,-66.0,-69.0,-81.0,-91.0,-84.0,-90.0,15.0,20.0,19.0,21.0,1
2793,CC:2F:71:3E:C5:1F,3242890,409540103,11562,1414321,3231328,408125782,6,49300,4129431,40731,3114135,8569,1015296,12190,36,16568,191,6,858,130000.0,39000.0,-69.0,-72.0,-68.0,-60.0,-68.0,-70.0,-67.0,-60.0,-81.0,-91.0,-84.0,-90.0,12.0,19.0,16.0,30.0,1
2794,CC:2F:71:3F:1F:24,12213977,14183277262,8982647,13775151278,3231330,408125984,158,2053011,1217854787,2044295,1216807565,8716,1047222,1987045,675,8987469,948592,158,6753,65000.0,13000.0,-67.0,-65.0,-71.0,-69.0,-67.0,-65.0,-71.0,-69.0,-81.0,-91.0,-84.0,-90.0,14.0,26.0,13.0,21.0,1
2795,3C:55:76:E8:8F:1F,3234974,417127076,3641,9000830,3231333,408126246,0,1962,354361,1824,328982,138,25379,901,4,3663,784,0,56,286760.0,172050.0,-48.0,-52.0,-44.0,-48.0,-49.0,-51.0,-43.0,-47.0,-81.0,-91.0,-84.0,-90.0,33.0,39.0,40.0,42.0,1
2796,92:69:1D:31:68:E9,3263271,476593265,31936,68466817,3231335,408126448,0,13928,4319889,13785,4296499,143,23390,8900,1,31982,2678,0,161,229410.0,130000.0,-55.0,-51.0,-45.0,-50.0,-51.0,-50.0,-45.0,-48.0,-81.0,-91.0,-84.0,-90.0,26.0,40.0,39.0,40.0,1
2797,BA:8C:B9:54:50:24,3277166,511592808,45831,103466360,3231335,408126448,64,16129,4825341,15978,4800544,151,24797,9970,6,45812,11200,64,243,206470.0,97500.0,-47.0,-50.0,-54.0,-46.0,-50.0,-50.0,-44.0,-46.0,-81.0,-91.0,-84.0,-90.0,34.0,41.0,30.0,44.0,1
2798,62:47:05:9D:EB:15,3251929,457512104,20594,49385656,3231335,408126448,64,9220,1772684,9130,1757593,90,15091,4051,1,20578,2829,64,241,216660.0,130000.0,-43.0,-50.0,-44.0,-45.0,-47.0,-52.0,-47.0,-47.0,-81.0,-91.0,-84.0,-90.0,38.0,41.0,40.0,45.0,1
2799,F8:59:71:5A:E0:3D,3511569,831393691,280234,423267243,3231335,408126448,4,279736,381644350,274808,381055660,4928,588690,255754,20,282988,7398,4,869,144444.0,43333.0,-66.0,-71.0,-65.0,-69.0,-66.0,-71.0,-66.0,-69.0,-81.0,-91.0,-84.0,-90.0,15.0,20.0,19.0,21.0,1
2800,CC:2F:71:3E:C5:1F,3242899,409540971,11562,1414321,3231337,408126650,6,49300,4129431,40731,3114135,8569,1015296,12190,36,16568,191,6,858,130000.0,39000.0,-69.0,-72.0,-68.0,-60.0,-68.0,-70.0,-67.0,-60.0,-81.0,-91.0,-84.0,-90.0,12.0,19.0,16.0,30.0,1
2801,CC:2F:71:3F:1F:24,12215215,14185105113,8983878,13776978463,3231337,408126650,158,2053375,1218054473,2044659,1217007251,8716,1047222,1987391,675,8988690,948685,158,6753,86667.0,14444.0,-68.0,-64.0,-71.0,-69.0,-68.0,-64.0,-70.0,-69.0,-81.0,-91.0,-84.0,-90.0,13.0,27.0,13.0,21.0,1
2802,3C:55:76:E8:8F:1F,3234987,417128640,3648,9001788,3231339,408126852,0,1973,357689,1835,332310,138,25379,904,4,3670,784,0,56,286760.0,172050.0,-47.0,-52.0,-43.0,-47.0,-47.0,-51.0,-43.0,-47.0,-81.0,-91.0,-84.0,-90.0,34.0,39.0,41.0,43.0,1
2803,92:69:1D:31:68:E9,3263335,476662474,31996,68535622,3231339,408126852,0,13982,4342800,13839,4319410,143,23390,8943,1,32042,2678,0,161,229410.0,137640.0,-54.0,-52.0,-45.0,-50.0,-51.0,-51.0,-45.0,-48.0,-81.0,-91.0,-84.0,-90.0,27.0,39.0,39.0,40.0,1
2804,BA:8C:B9:54:50:24,3277170,511593212,45831,103466360,3231339,408126852,64,16129,4825341,15978,4800544,151,24797,9970,6,45812,11200,64,243,206470.0,97500.0,-47.0,-50.0,-54.0,-46.0,-50.0,-50.0,-44.0,-46.0,-81.0,-91.0,-84.0,-90.0,34.0,41.0,30.0,44.0,1
2805,62:47:05:9D:EB:15,3251933,457512508,20594,49385656,3231339,408126852,64,9220,1772684,9130,1757593,90,15091,4051,1,20578,2829,64,241,216660.0,130000.0,-43.0,-50.0,-44.0,-45.0,-47.0,-52.0,-47.0,-47.0,-81.0,-91.0,-84.0,-90.0,38.0,41.0,40.0,45.0,1
2806,F8:59:71:5A:E0:3D,3511574,831394229,280234,423267243,3231340,408126986,4,279736,381644350,274808,381055660,4928,588690,255754,20,282988,7398,4,869,144444.0,43333.0,-66.0,-71.0,-65.0,-69.0,-66.0,-71.0,-66.0,-69.0,-81.0,-91.0,-84.0,-90.0,15.0,20.0,19.0,21.0,1
2807,CC:2F:71:3E:C5:1F,3242903,409541375,11562,1414321,3231341,408127054,6,49300,4129431,40731,3114135,8569,1015296,12190,36,16568,191,6,858,130000.0,39000.0,-69.0,-72.0,-68.0,-60.0,-68.0,-70.0,-67.0,-60.0,-81.0,-91.0,-84.0,-90.0,12.0,19.0,16.0,30.0,1
2808,CC:2F:71:3F:1F:24,12216741,14187414628,8985400,13779287574,3231341,408127054,158,2053817,1218260601,2045101,1217213379,8716,1047222,1987788,675,8990233,948861,158,6753,86667.0,13000.0,-68.0,-64.0,-70.0,-69.0,-68.0,-64.0,-70.0,-69.0,-81.0,-91.0,-84.0,-90.0,13.0,27.0,14.0,21.0,1
2809,3C:55:76:E8:8F:1F,3234994,417129306,3648,9001788,3231346,408127518,0,1979,358099,1841,332720,138,25379,904,4,3670,784,0,56,286760.0,172050.0,-63.0,-54.0,-48.0,-52.0,-49.0,-52.0,-43.0,-47.0,-81.0,-91.0,-84.0,-90.0,18.0,37.0,36.0,38.0,1
2810,92:69:1D:31:68:E9,3263345,476663632,31999,68536114,3231346,408127518,0,13987,4343709,13844,4320319,143,23390,8946,1,32045,2678,0,161,229410.0,137640.0,-52.0,-53.0,-53.0,-54.0,-51.0,-51.0,-46.0,-49.0,-81.0,-91.0,-84.0,-90.0,29.0,38.0,31.0,36.0,1
2811,BA:8C:B9:54:50:24,3277179,511594080,45831,103466360,3231348,408127720,64,16129,4825341,15978,4800544,151,24797,9970,6,45812,11200,64,243,206470.0,97500.0,-47.0,-50.0,-54.0,-46.0,-50.0,-50.0,-44.0,-46.0,-81.0,-91.0,-84.0,-90.0,34.0,41.0,30.0,44.0,1
2812,62:47:05:9D:EB:15,3251943,457513492,20595,49385772,3231348,408127720,64,9224,1772994,9134,1757903,90,15091,4052,1,20579,2829,64,241,216660.0,130000.0,-43.0,-50.0,-43.0,-45.0,-47.0,-51.0,-47.0,-44.0,-81.0,-91.0,-84.0,-90.0,38.0,41.0,41.0,45.0,1
2813,F8:59:71:5A:E0:3D,3511582,831394963,280234,423267243,3231348,408127720,4,279736,381644350,274808,381055660,4928,588690,255754,20,282988,7398,4,869,144444.0,43333.0,-66.0,-71.0,-65.0,-69.0,-66.0,-71.0,-66.0,-69.0,-81.0,-91.0,-84.0,-90.0,15.0,20.0,19.0,21.0,1
2814,CC:2F:71:3E:C5:1F,3242911,409542216,11562,1414321,3231349,408127895,6,49300,4129431,40731,3114135,8569,1015296,12190,36,16568,191,6,858,130000.0,39000.0,-69.0,-72.0,-68.0,-60.0,-68.0,-70.0,-67.0,-60.0,-81.0,-91.0,-84.0,-90.0,12.0,19.0,16.0,30.0,1
2815,CC:2F:71:3F:1F:24,12218960,14190686551,8987611,13782558656,3231349,408127895,158,2054478,1218512534,2045762,1217465312,8716,1047222,1988432,675,8992444,948890,158,6754,65000.0,13000.0,-69.0,-64.0,-71.0,-69.0,-68.0,-64.0,-70.0,-69.0,-81.0,-91.0,-84.0,-90.0,12.0,27.0,13.0,21.0,1
2816,3C:55:76:E8:8F:1F,3235002,417130360,3648,9001788,3231354,408128572,0,1979,358099,1841,332720,138,25379,904,4,3670,784,0,56,286760.0,172050.0,-63.0,-54.0,-48.0,-52.0,-49.0,-52.0,-43.0,-47.0,-81.0,-91.0,-84.0,-90.0,18.0,37.0,36.0,38.0,1
2817,92:69:1D:31:68:E9,3263353,476664686,31999,68536114,3231354,408128572,0,13997,4344556,13853,4320931,144,23625,8947,1,32045,2678,0,162,229410.0,137640.0,-54.0,-52.0,-46.0,-50.0,-50.0,-50.0,-46.0,-49.0,-81.0,-91.0,-84.0,-90.0,27.0,39.0,38.0,40.0,1
2818,BA:8C:B9:54:50:24,3277187,511595134,45831,103466360,3231356,408128774,64,16129,4825341,15978,4800544,151,24797,9970,6,45812,11200,64,243,206470.0,97500.0,-47.0,-50.0,-54.0,-46.0,-50.0,-50.0,-44.0,-46.0,-81.0,-91.0,-84.0,-90.0,34.0,41.0,30.0,44.0,1
2819,62:47:05:9D:EB:15,3251952,457514705,20595,49385772,3231357,408128933,64,9224,1772994,9134,1757903,90,15091,4052,1,20579,2829,64,241,216660.0,130000.0,-43.0,-50.0,-43.0,-45.0,-47.0,-51.0,-47.0,-44.0,-81.0,-91.0,-84.0,-90.0,38.0,41.0,41.0,45.0,1
2820,F8:59:71:5A:E0:3D,3511591,831396176,280234,423267243,3231357,408128933,4,279736,381644350,274808,381055660,4928,588690,255754,20,282988,7398,4,869,144444.0,43333.0,-66.0,-71.0,-65.0,-69.0,-66.0,-71.0,-66.0,-69.0,-81.0,-91.0,-84.0,-90.0,15.0,20.0,19.0,21.0,1
2821,CC:2F:71:3E:C5:1F,3242919,409543254,11562,1414321,3231357,408128933,6,49300,4129431,40731,3114135,8569,1015296,12190,36,16568,191,6,858,130000.0,39000.0,-69.0,-72.0,-68.0,-60.0,-68.0,-70.0,-67.0,-60.0,-81.0,-91.0,-84.0,-90.0,12.0,19.0,16.0,30.0,1
2822,CC:2F:71:3F:1F:24,12220707,14193319440,8989349,13785190447,3231358,408128993,158,2054959,1218708357,2046243,1217661135,8716,1047222,1988906,675,8994182,948946,158,6754,86667.0,14444.0,-68.0,-64.0,-70.0,-68.0,-68.0,-64.0,-70.0,-68.0,-81.0,-91.0,-84.0,-90.0,13.0,27.0,14.0,22.0,1
2823,3C:55:76:E8:8F:1F,3235009,417131392,3649,9002197,3231360,408129195,0,1998,359849,1859,334255,139,25594,907,4,3671,784,0,57,286760.0,172050.0,-64.0,-54.0,-48.0,-52.0,-52.0,-51.0,-47.0,-51.0,-81.0,-91.0,-84.0,-90.0,17.0,37.0,36.0,38.0,1
2824,92:69:1D:31:68:E9,3263363,476666146,32003,68536951,3231360,408129195,0,14009,4354236,13865,4330611,144,23625,8953,1,32049,2678,0,162,229410.0,137640.0,-53.0,-51.0,-45.0,-50.0,-51.0,-50.0,-45.0,-48.0,-81.0,-91.0,-84.0,-90.0,28.0,40.0,39.0,40.0,1
2825,BA:8C:B9:54:50:24,3277193,511595757,45831,103466360,3231362,408129397,64,16133,4825613,15982,4800816,151,24797,9970,6,45812,11200,64,243,206470.0,97500.0,-47.0,-49.0,-54.0,-46.0,-49.0,-50.0,-48.0,-46.0,-81.0,-91.0,-84.0,-90.0,34.0,42.0,30.0,44.0,1
2826,62:47:05:9D:EB:15,3251959,457515371,20595,49385772,3231364,408129599,64,9224,1772994,9134,1757903,90,15091,4052,1,20579,2829,64,241,216660.0,130000.0,-43.0,-50.0,-43.0,-45.0,-47.0,-51.0,-47.0,-44.0,-81.0,-91.0,-84.0,-90.0,38.0,41.0,41.0,45.0,1
2827,F8:59:71:5A:E0:3D,3511598,831396842,280234,423267243,3231364,408129599,4,279736,381644350,274808,381055660,4928,588690,255754,20,282988,7398,4,869,144444.0,43333.0,-66.0,-71.0,-65.0,-69.0,-66.0,-71.0,-66.0,-69.0,-81.0,-91.0,-84.0,-90.0,15.0,20.0,19.0,21.0,1
2828,CC:2F:71:3E:C5:1F,3242926,409543920,11562,1414321,3231364,408129599,6,49300,4129431,40731,3114135,8569,1015296,12190,36,16568,191,6,858,130000.0,39000.0,-69.0,-72.0,-68.0,-60.0,-68.0,-70.0,-67.0,-60.0,-81.0,-91.0,-84.0,-90.0,12.0,19.0,16.0,30.0,1
2829,CC:2F:71:3F:1F:24,12221768,14194907892,8990404,13786778293,3231364,408129599,158,2055270,1218888287,2046554,1217841065,8716,1047222,1989206,675,8995237,948966,158,6754,86667.0,14444.0,-68.0,-64.0,-70.0,-68.0,-68.0,-64.0,-70.0,-68.0,-81.0,-91.0,-84.0,-90.0,13.0,27.0,14.0,22.0,1
2830,3C:55:76:E8:8F:1F,3235018,417132412,3652,9002611,3231366,408129801,0,2013,361033,1874,335439,139,25594,910,4,3674,785,0,59,286760.0,1000.0,-47.0,-52.0,-43.0,-47.0,-47.0,-52.0,-43.0,-46.0,-81.0,-92.0,-84.0,-89.0,34.0,40.0,41.0,42.0,1
2831,92:69:1D:31:68:E9,3263372,476667070,32004,68537067,3231368,408130003,0,14011,4354372,13867,4330747,144,23625,8953,1,32050,2678,0,162,229410.0,137640.0,-56.0,-50.0,-44.0,-50.0,-52.0,-51.0,-46.0,-49.0,-81.0,-92.0,-84.0,-89.0,25.0,42.0,40.0,39.0,1
2832,BA:8C:B9:54:50:24,3277201,511596743,45832,103466476,3231369,408130267,64,16135,4825749,15984,4800952,151,24797,9970,6,45813,11200,64,243,206470.0,97500.0,-54.0,-51.0,-38.0,-46.0,-49.0,-50.0,-48.0,-46.0,-81.0,-92.0,-84.0,-89.0,27.0,41.0,46.0,43.0,1
2833,62:47:05:9D:EB:15,3252365,458575377,20995,50445050,3231370,408130327,64,9306,1784203,9216,1769112,90,15091,4094,1,20979,2829,64,242,229410.0,137640.0,-46.0,-52.0,-47.0,-46.0,-44.0,-49.0,-44.0,-42.0,-81.0,-92.0,-84.0,-89.0,35.0,40.0,37.0,43.0,1
2834,F8:59:71:5A:E0:3D,3511605,831397686,280235,423267359,3231370,408130327,4,279739,381644560,274811,381055870,4928,588690,255754,20,282989,7398,4,869,130000.0,39000.0,-65.0,-72.0,-64.0,-71.0,-65.0,-71.0,-65.0,-69.0,-81.0,-92.0,-84.0,-89.0,16.0,20.0,20.0,18.0,1
2835,CC:2F:71:3E:C5:1F,3242933,409544764,11563,1414437,3231370,408130327,6,49302,4129571,40733,3114275,8569,1015296,12190,36,16569,191,6,858,130000.0,39000.0,-68.0,-72.0,-69.0,-60.0,-68.0,-71.0,-68.0,-60.0,-81.0,-92.0,-84.0,-89.0,13.0,20.0,15.0,29.0,1
2836,CC:2F:71:3F:1F:24,12223272,14197171033,8991902,13789040706,3231370,408130327,158,2055676,1219106064,2046960,1218058842,8716,1047222,1989593,675,8996735,949067,158,6754,86667.0,14444.0,-68.0,-64.0,-70.0,-68.0,-68.0,-64.0,-69.0,-68.0,-81.0,-92.0,-84.0,-89.0,13.0,28.0,14.0,21.0,1
2837,3C:55:76:E8:8F:1F,3235028,417133544,3653,9002679,3231375,408130865,0,2032,362623,1892,336709,140,25914,912,4,3675,785,0,61,286760.0,172050.0,-47.0,-52.0,-43.0,-46.0,-49.0,-51.0,-44.0,-48.0,-81.0,-92.0,-84.0,-89.0,34.0,40.0,41.0,43.0,1
2838,92:69:1D:31:68:E9,3263382,476668255,32006,68537322,3231376,408130933,0,14021,4357478,13877,4333853,144,23625,8957,1,32052,2678,0,162,229410.0,137640.0,-50.0,-50.0,-46.0,-50.0,-52.0,-51.0,-46.0,-51.0,-81.0,-92.0,-84.0,-89.0,31.0,42.0,38.0,39.0,1
2839,BA:8C:B9:54:50:24,3277208,511597409,45832,103466476,3231376,408130933,64,16135,4825749,15984,4800952,151,24797,9970,6,45813,11200,64,243,206470.0,97500.0,-54.0,-51.0,-38.0,-46.0,-49.0,-50.0,-48.0,-46.0,-81.0,-92.0,-84.0,-89.0,27.0,41.0,46.0,43.0,1
2840,62:47:05:9D:EB:15,3252371,458575983,20995,50445050,3231376,408130933,64,9318,1785019,9228,1769928,90,15091,4094,1,20979,2829,64,242,229410.0,137640.0,-43.0,-49.0,-44.0,-45.0,-42.0,-48.0,-42.0,-41.0,-81.0,-92.0,-84.0,-89.0,38.0,43.0,40.0,44.0,1
2841,F8:59:71:5A:E0:3D,3511611,831398292,280235,423267359,3231376,408130933,4,279739,381644560,274811,381055870,4928,588690,255754,20,282989,7398,4,869,130000.0,39000.0,-65.0,-72.0,-64.0,-71.0,-65.0,-71.0,-65.0,-69.0,-81.0,-92.0,-84.0,-89.0,16.0,20.0,20.0,18.0,1
2842,CC:2F:71:3E:C5:1F,3242939,409545370,11563,1414437,3231376,408130933,6,49302,4129571,40733,3114275,8569,1015296,12190,36,16569,191,6,858,130000.0,39000.0,-68.0,-72.0,-69.0,-60.0,-68.0,-71.0,-68.0,-60.0,-81.0,-92.0,-84.0,-89.0,13.0,20.0,15.0,29.0,1
2843,CC:2F:71:3F:1F:24,12224944,14199700736,8993566,13791569601,3231378,408131135,158,2056064,1219251149,2047348,1218203927,8716,1047222,1989981,675,8998399,949204,158,6754,65000.0,13000.0,-68.0,-64.0,-70.0,-68.0,-68.0,-64.0,-70.0,-68.0,-81.0,-92.0,-84.0,-89.0,13.0,28.0,14.0,21.0,1
2844,3C:55:76:E8:8F:1F,3235036,417134573,3656,9003236,3231380,408131337,0,2053,364095,1913,338181,140,25914,913,4,3678,785,0,61,286760.0,172050.0,-46.0,-49.0,-41.0,-44.0,-48.0,-51.0,-43.0,-46.0,-81.0,-92.0,-84.0,-89.0,35.0,43.0,43.0,45.0,1
2845,92:69:1D:31:68:E9,3263786,477711042,32403,69579441,3231383,408131601,0,14075,4367103,13931,4343478,144,23625,8994,1,32449,2924,0,162,229410.0,137640.0,-54.0,-51.0,-46.0,-51.0,-50.0,-50.0,-45.0,-49.0,-81.0,-92.0,-84.0,-89.0,27.0,41.0,38.0,38.0,1
2846,BA:8C:B9:54:50:24,3277216,511598137,45832,103466476,3231384,408131661,64,16136,4825817,15985,4801020,151,24797,9970,6,45813,11200,64,243,206470.0,97500.0,-47.0,-50.0,-54.0,-46.0,-48.0,-50.0,-50.0,-46.0,-81.0,-92.0,-84.0,-89.0,34.0,42.0,30.0,43.0,1
2847,62:47:05:9D:EB:15,3252379,458576711,20995,50445050,3231384,408131661,64,9318,1785019,9228,1769928,90,15091,4094,1,20979,2829,64,242,229410.0,137640.0,-43.0,-49.0,-44.0,-45.0,-42.0,-48.0,-42.0,-41.0,-81.0,-92.0,-84.0,-89.0,38.0,43.0,40.0,44.0,1
2848,F8:59:71:5A:E0:3D,3511619,831399020,280235,423267359,3231384,408131661,4,279741,381644748,274812,381055940,4929,588808,255755,20,282989,7398,4,869,130000.0,39000.0,-65.0,-73.0,-65.0,-71.0,-65.0,-71.0,-64.0,-69.0,-81.0,-92.0,-84.0,-89.0,16.0,19.0,19.0,18.0,1
2849,CC:2F:71:3E:C5:1F,3242947,409546098,11563,1414437,3231384,408131661,6,49302,4129571,40733,3114275,8569,1015296,12190,36,16569,191,6,858,130000.0,39000.0,-68.0,-72.0,-69.0,-60.0,-68.0,-71.0,-68.0,-60.0,-81.0,-92.0,-84.0,-89.0,13.0,20.0,15.0,29.0,1
2850,CC:2F:71:3F:1F:24,12225966,14201228198,8994582,13793096537,3231384,408131661,158,2056300,1219280913,2047584,1218233691,8716,1047222,1990217,675,8999415,949278,158,6754,86667.0,14444.0,-69.0,-64.0,-70.0,-69.0,-68.0,-64.0,-70.0,-68.0,-81.0,-92.0,-84.0,-89.0,12.0,28.0,14.0,20.0,1
2851,3C:55:76:E8:8F:1F,3235046,417135540,3657,9003413,3231389,408132127,0,2081,366053,1940,340021,141,26032,914,4,3679,785,0,62,286760.0,172050.0,-49.0,-52.0,-43.0,-49.0,-50.0,-51.0,-44.0,-49.0,-81.0,-92.0,-84.0,-89.0,32.0,40.0,41.0,40.0,1
2852,92:69:1D:31:68:E9,3263792,477711568,32403,69579441,3231389,408132127,0,14075,4367103,13931,4343478,144,23625,8994,1,32449,2924,0,162,229410.0,137640.0,-54.0,-51.0,-46.0,-51.0,-50.0,-50.0,-45.0,-49.0,-81.0,-92.0,-84.0,-89.0,27.0,41.0,38.0,38.0,1
2853,BA:8C:B9:54:50:24,3277221,511598603,45832,103466476,3231389,408132127,64,16136,4825817,15985,4801020,151,24797,9970,6,45813,11200,64,243,206470.0,97500.0,-47.0,-50.0,-54.0,-46.0,-48.0,-50.0,-50.0,-46.0,-81.0,-92.0,-84.0,-89.0,34.0,42.0,30.0,43.0,1
2854,62:47:05:9D:EB:15,3252384,458577177,20995,50445050,3231389,408132127,64,9318,1785019,9228,1769928,90,15091,4094,1,20979,2829,64,242,229410.0,137640.0,-43.0,-49.0,-44.0,-45.0,-42.0,-48.0,-42.0,-41.0,-81.0,-92.0,-84.0,-89.0,38.0,43.0,40.0,44.0,1
2855,F8:59:71:5A:E0:3D,3511624,831399486,280235,423267359,3231389,408132127,4,279741,381644748,274812,381055940,4929,588808,255755,20,282989,7398,4,869,130000.0,39000.0,-65.0,-73.0,-65.0,-71.0,-65.0,-71.0,-64.0,-69.0,-81.0,-92.0,-84.0,-89.0,16.0,19.0,19.0,18.0,1
2856,CC:2F:71:3E:C5:1F,3242952,409546564,11563,1414437,3231389,408132127,6,49302,4129571,40733,3114275,8569,1015296,12190,36,16569,191,6,858,130000.0,39000.0,-68.0,-72.0,-69.0,-60.0,-68.0,-71.0,-68.0,-60.0,-81.0,-92.0,-84.0,-89.0,13.0,20.0,15.0,29.0,1
2857,CC:2F:71:3F:1F:24,12226834,14202518554,8995444,13794386365,3231390,408132189,158,2056484,1219304671,2047768,1218257449,8716,1047222,1990400,675,9000277,949389,158,6754,86667.0,14444.0,-69.0,-64.0,-70.0,-69.0,-68.0,-64.0,-70.0,-69.0,-81.0,-92.0,-84.0,-89.0,12.0,28.0,14.0,20.0,1
2858,3C:55:76:E8:8F:1F,3235055,417136793,3660,9004140,3231395,408132653,0,2107,367829,1966,341797,141,26032,914,4,3682,788,0,64,286760.0,172050.0,-50.0,-52.0,-47.0,-53.0,-51.0,-50.0,-45.0,-50.0,-82.0,-92.0,-84.0,-89.0,32.0,40.0,37.0,36.0,1
2859,92:69:1D:31:68:E9,3263800,477712296,32403,69579441,3231397,408132855,0,14075,4367103,13931,4343478,144,23625,8994,1,32449,2924,0,162,229410.0,137640.0,-54.0,-51.0,-46.0,-51.0,-50.0,-50.0,-45.0,-49.0,-82.0,-92.0,-84.0,-89.0,28.0,41.0,38.0,38.0,1
2860,BA:8C:B9:54:50:24,3277229,511599331,45832,103466476,3231397,408132855,64,16136,4825817,15985,4801020,151,24797,9970,6,45813,11200,64,243,206470.0,97500.0,-47.0,-50.0,-54.0,-46.0,-48.0,-50.0,-50.0,-46.0,-82.0,-92.0,-84.0,-89.0,35.0,42.0,30.0,43.0,1
2861,62:47:05:9D:EB:15,3252392,458577905,20995,50445050,3231397,408132855,64,9318,1785019,9228,1769928,90,15091,4094,1,20979,2829,64,242,229410.0,137640.0,-43.0,-49.0,-44.0,-45.0,-42.0,-48.0,-42.0,-41.0,-82.0,-92.0,-84.0,-89.0,39.0,43.0,40.0,44.0,1
2862,F8:59:71:5A:E0:3D,3511634,831400416,280235,423267359,3231399,408133057,4,279741,381644748,274812,381055940,4929,588808,255755,20,282989,7398,4,869,130000.0,39000.0,-65.0,-73.0,-65.0,-71.0,-65.0,-71.0,-64.0,-69.0,-82.0,-92.0,-84.0,-89.0,17.0,19.0,19.0,18.0,1
2863,CC:2F:71:3E:C5:1F,3242962,409547494,11563,1414437,3231399,408133057,6,49304,4129759,40734,3114345,8570,1015414,12191,36,16569,191,6,858,130000.0,39000.0,-68.0,-72.0,-68.0,-60.0,-68.0,-72.0,-68.0,-60.0,-82.0,-92.0,-84.0,-89.0,14.0,20.0,16.0,29.0,1
2864,CC:2F:71:3F:1F:24,12227869,14204059132,8996470,13795926075,3231399,408133057,158,2056706,1219333747,2047990,1218286525,8716,1047222,1990619,675,9001289,949398,158,6754,86667.0,14444.0,-69.0,-64.0,-70.0,-70.0,-69.0,-64.0,-69.0,-69.0,-82.0,-92.0,-84.0,-89.0,13.0,28.0,14.0,19.0,1
2865,3C:55:76:E8:8F:1F,3235065,417137840,3661,9004317,3231404,408133523,0,2113,368241,1972,342209,141,26032,914,4,3683,788,0,64,286760.0,172050.0,-47.0,-49.0,-44.0,-50.0,-50.0,-51.0,-46.0,-51.0,-82.0,-92.0,-84.0,-90.0,35.0,43.0,40.0,40.0,1
2866,92:69:1D:31:68:E9,3263810,477713491,32406,69579968,3231404,408133523,0,14081,4369961,13937,4346336,144,23625,8997,1,32452,2924,0,162,229410.0,137640.0,-54.0,-52.0,-46.0,-52.0,-51.0,-50.0,-45.0,-49.0,-82.0,-92.0,-84.0,-90.0,28.0,40.0,38.0,38.0,1
2867,BA:8C:B9:54:50:24,3277236,511599999,45832,103466476,3231404,408133523,64,16136,4825817,15985,4801020,151,24797,9970,6,45813,11200,64,243,206470.0,97500.0,-47.0,-50.0,-54.0,-46.0,-48.0,-50.0,-50.0,-46.0,-82.0,-92.0,-84.0,-90.0,35.0,42.0,30.0,44.0,1
2868,62:47:05:9D:EB:15,3252399,458578573,20995,50445050,3231404,408133523,64,9321,1785277,9230,1770064,91,15213,4095,1,20979,2829,64,242,229410.0,137640.0,-43.0,-49.0,-44.0,-45.0,-43.0,-48.0,-44.0,-42.0,-82.0,-92.0,-84.0,-90.0,39.0,43.0,40.0,45.0,1
2869,F8:59:71:5A:E0:3D,3511640,831401133,280235,423267359,3231405,408133774,4,279741,381644748,274812,381055940,4929,588808,255755,20,282989,7398,4,869,130000.0,39000.0,-65.0,-73.0,-65.0,-71.0,-65.0,-71.0,-64.0,-69.0,-82.0,-92.0,-84.0,-90.0,17.0,19.0,19.0,19.0,1
2870,CC:2F:71:3E:C5:1F,3242968,409548211,11563,1414437,3231405,408133774,6,49304,4129759,40734,3114345,8570,1015414,12191,36,16569,191,6,858,130000.0,39000.0,-68.0,-72.0,-68.0,-60.0,-68.0,-72.0,-68.0,-60.0,-82.0,-92.0,-84.0,-90.0,14.0,20.0,16.0,30.0,1
2871,CC:2F:71:3F:1F:24,12229785,14206998925,8998380,13798865151,3231405,408133774,158,2057064,1219377621,2048348,1218330399,8716,1047222,1990977,675,9003178,949579,158,6754,86667.0,14444.0,-69.0,-64.0,-70.0,-69.0,-68.0,-64.0,-69.0,-69.0,-82.0,-92.0,-84.0,-90.0,13.0,28.0,14.0,21.0,1
2872,3C:55:76:E8:8F:1F,3235071,417138555,3661,9004317,3231410,408134238,0,2122,369098,1980,342759,142,26339,915,4,3683,788,0,64,286760.0,172050.0,-48.0,-52.0,-43.0,-48.0,-47.0,-49.0,-41.0,-47.0,-82.0,-92.0,-84.0,-90.0,34.0,40.0,41.0,42.0,1
2873,92:69:1D:31:68:E9,3263816,477714206,32406,69579968,3231410,408134238,0,14082,4370029,13938,4346404,144,23625,8997,1,32452,2924,0,162,229410.0,137640.0,-54.0,-52.0,-46.0,-51.0,-51.0,-50.0,-45.0,-50.0,-82.0,-92.0,-84.0,-90.0,28.0,40.0,38.0,39.0,1
2874,BA:8C:B9:54:50:24,3277242,511600714,45832,103466476,3231410,408134238,64,16136,4825817,15985,4801020,151,24797,9970,6,45813,11200,64,243,206470.0,97500.0,-47.0,-50.0,-54.0,-46.0,-48.0,-50.0,-50.0,-46.0,-82.0,-92.0,-84.0,-90.0,35.0,42.0,30.0,44.0,1
2875,62:47:05:9D:EB:15,3252407,458579490,20995,50445050,3231412,408134440,64,9321,1785277,9230,1770064,91,15213,4095,1,20979,2829,64,242,229410.0,137640.0,-43.0,-49.0,-44.0,-45.0,-43.0,-48.0,-44.0,-42.0,-82.0,-92.0,-84.0,-90.0,39.0,43.0,40.0,45.0,1
2876,F8:59:71:5A:E0:3D,3511650,831402063,280235,423267359,3231415,408134704,4,279741,381644748,274812,381055940,4929,588808,255755,20,282989,7398,4,869,130000.0,39000.0,-65.0,-73.0,-65.0,-71.0,-65.0,-71.0,-64.0,-69.0,-82.0,-92.0,-84.0,-90.0,17.0,19.0,19.0,19.0,1
2877,CC:2F:71:3E:C5:1F,3242978,409549141,11563,1414437,3231415,408134704,6,49304,4129759,40734,3114345,8570,1015414,12191,36,16569,191,6,858,130000.0,39000.0,-68.0,-72.0,-68.0,-60.0,-68.0,-72.0,-68.0,-60.0,-82.0,-92.0,-84.0,-90.0,14.0,20.0,16.0,30.0,1
2878,CC:2F:71:3F:1F:24,12231188,14209116963,8999773,13800982259,3231415,408134704,158,2057318,1219410308,2048602,1218363086,8716,1047222,1991231,675,9004598,949729,158,6754,104000.0,26000.0,-68.0,-64.0,-70.0,-69.0,-68.0,-64.0,-69.0,-69.0,-82.0,-92.0,-84.0,-90.0,14.0,28.0,14.0,21.0,1
2879,3C:55:76:E8:8F:1F,3235080,417139558,3661,9004317,3231419,408135241,0,2129,369628,1986,343171,143,26457,916,4,3683,788,0,64,286760.0,172050.0,-48.0,-52.0,-43.0,-48.0,-46.0,-50.0,-41.0,-46.0,-82.0,-92.0,-84.0,-90.0,34.0,40.0,41.0,42.0,1
2880,92:69:1D:31:68:E9,3263825,477715209,32406,69579968,3231419,408135241,0,14085,4370287,13940,4346540,145,23747,8998,1,32452,2924,0,162,229410.0,137640.0,-54.0,-51.0,-45.0,-51.0,-51.0,-50.0,-46.0,-50.0,-82.0,-92.0,-84.0,-90.0,28.0,41.0,39.0,39.0,1
2881,BA:8C:B9:54:50:24,3277253,511601919,45832,103466476,3231421,408135443,64,16140,4826089,15989,4801292,151,24797,9970,6,45814,11200,64,243,206470.0,97500.0,-54.0,-51.0,-38.0,-47.0,-51.0,-50.0,-44.0,-46.0,-82.0,-92.0,-84.0,-90.0,28.0,41.0,46.0,43.0,1
2882,62:47:05:9D:EB:15,3252416,458580493,20995,50445050,3231421,408135443,64,9321,1785277,9230,1770064,91,15213,4095,1,20979,2829,64,242,229410.0,137640.0,-43.0,-49.0,-44.0,-45.0,-43.0,-48.0,-44.0,-42.0,-82.0,-92.0,-84.0,-90.0,39.0,43.0,40.0,45.0,1
2883,F8:59:71:5A:E0:3D,3511656,831402802,280235,423267359,3231421,408135443,4,279743,381644888,274814,381056080,4929,588808,255755,20,282990,7398,4,869,130000.0,39000.0,-65.0,-73.0,-65.0,-71.0,-65.0,-71.0,-64.0,-70.0,-82.0,-92.0,-84.0,-90.0,17.0,19.0,19.0,19.0,1
2884,CC:2F:71:3E:C5:1F,3242984,409549880,11563,1414437,3231421,408135443,6,49304,4129759,40734,3114345,8570,1015414,12191,36,16569,191,6,858,130000.0,39000.0,-68.0,-72.0,-68.0,-60.0,-68.0,-72.0,-68.0,-60.0,-82.0,-92.0,-84.0,-90.0,14.0,20.0,16.0,30.0,1
2885,CC:2F:71:3F:1F:24,12233297,14212307467,9001876,13804172024,3231421,408135443,158,2057753,1219473017,2049037,1218425795,8716,1047222,1991658,675,9006709,949784,158,6754,86667.0,14444.0,-69.0,-65.0,-71.0,-70.0,-69.0,-65.0,-70.0,-70.0,-83.0,-92.0,-85.0,-90.0,14.0,27.0,14.0,20.0,1
2886,3C:55:76:E8:8F:1F,3235094,417141086,3666,9004992,3231428,408136094,0,2162,373028,2018,346388,144,26640,922,4,3688,788,0,66,270830.0,162500.0,-47.0,-51.0,-42.0,-47.0,-47.0,-51.0,-42.0,-47.0,-83.0,-92.0,-85.0,-90.0,36.0,41.0,43.0,43.0,1
2887,92:69:1D:31:68:E9,3263834,477716062,32406,69579968,3231428,408136094,0,14085,4370287,13940,4346540,145,23747,8998,1,32452,2924,0,162,229410.0,137640.0,-54.0,-51.0,-45.0,-51.0,-51.0,-50.0,-46.0,-50.0,-83.0,-92.0,-85.0,-90.0,29.0,41.0,40.0,39.0,1
2888,BA:8C:B9:54:50:24,3277260,511602570,45832,103466476,3231428,408136094,64,16140,4826089,15989,4801292,151,24797,9970,6,45814,11200,64,243,206470.0,97500.0,-54.0,-51.0,-38.0,-47.0,-51.0,-50.0,-44.0,-46.0,-83.0,-92.0,-85.0,-90.0,29.0,41.0,47.0,43.0,1
2889,62:47:05:9D:EB:15,3252472,458644591,21043,50508435,3231429,408136156,64,9351,1787701,9260,1772488,91,15213,4099,1,21027,2829,64,242,229410.0,137640.0,-43.0,-50.0,-44.0,-45.0,-43.0,-49.0,-44.0,-42.0,-83.0,-92.0,-85.0,-90.0,40.0,42.0,41.0,45.0,1
2890,F8:59:71:5A:E0:3D,3511664,831403515,280235,423267359,3231429,408136156,4,279743,381644888,274814,381056080,4929,588808,255755,20,282990,7398,4,869,130000.0,39000.0,-65.0,-73.0,-65.0,-71.0,-65.0,-71.0,-64.0,-70.0,-83.0,-92.0,-85.0,-90.0,18.0,19.0,20.0,19.0,1
2891,CC:2F:71:3E:C5:1F,3242993,409550679,11563,1414437,3231430,408136242,6,49304,4129759,40734,3114345,8570,1015414,12191,36,16569,191,6,858,130000.0,39000.0,-68.0,-72.0,-68.0,-60.0,-68.0,-72.0,-68.0,-60.0,-83.0,-92.0,-85.0,-90.0,15.0,20.0,17.0,30.0,1
2892,CC:2F:71:3F:1F:24,12235366,14215483912,9003934,13807347468,3231432,408136444,158,2058135,1219519891,2049417,1218472413,8718,1047478,1992035,675,9008767,949982,158,6754,78000.0,13000.0,-69.0,-65.0,-71.0,-70.0,-69.0,-65.0,-70.0,-70.0,-84.0,-92.0,-85.0,-90.0,15.0,27.0,14.0,20.0,1
2893,3C:55:76:E8:8F:1F,3235108,417142659,3670,9005640,3231438,408137019,0,2196,375579,2051,348821,145,26758,927,4,3692,788,0,68,270830.0,162500.0,-46.0,-51.0,-43.0,-47.0,-49.0,-50.0,-44.0,-48.0,-84.0,-92.0,-85.0,-90.0,38.0,41.0,42.0,43.0,1
2894,92:69:1D:31:68:E9,3263846,477717189,32406,69579968,3231440,408137221,0,14090,4370730,13944,4346812,146,23918,8999,1,32452,2924,0,162,229410.0,137640.0,-54.0,-51.0,-45.0,-51.0,-52.0,-51.0,-47.0,-51.0,-84.0,-92.0,-85.0,-90.0,30.0,41.0,40.0,39.0,1
2895,BA:8C:B9:54:50:24,3277272,511603697,45832,103466476,3231440,408137221,64,16140,4826089,15989,4801292,151,24797,9970,6,45814,11200,64,243,206470.0,97500.0,-54.0,-51.0,-38.0,-47.0,-51.0,-50.0,-44.0,-46.0,-84.0,-92.0,-85.0,-90.0,30.0,41.0,47.0,43.0,1
2896,62:47:05:9D:EB:15,3252485,458645858,21043,50508435,3231442,408137423,64,9351,1787701,9260,1772488,91,15213,4099,1,21027,2829,64,242,229410.0,137640.0,-43.0,-50.0,-44.0,-45.0,-43.0,-49.0,-44.0,-42.0,-84.0,-92.0,-85.0,-90.0,41.0,42.0,41.0,45.0,1
2897,F8:59:71:5A:E0:3D,3511677,831404782,280235,423267359,3231442,408137423,4,279743,381644888,274814,381056080,4929,588808,255755,20,282990,7398,4,869,130000.0,39000.0,-65.0,-73.0,-65.0,-71.0,-65.0,-71.0,-64.0,-70.0,-84.0,-92.0,-85.0,-90.0,19.0,19.0,20.0,19.0,1
2898,CC:2F:71:3E:C5:1F,3243005,409551860,11563,1414437,3231442,408137423,6,49304,4129759,40734,3114345,8570,1015414,12191,36,16569,191,6,858,130000.0,39000.0,-68.0,-72.0,-68.0,-60.0,-68.0,-72.0,-68.0,-60.0,-84.0,-92.0,-85.0,-90.0,16.0,20.0,17.0,30.0,1
2899,CC:2F:71:3F:1F:24,12237123,14218161891,9005681,13810024468,3231442,408137423,158,2058504,1219565728,2049783,1218517820,8721,1047908,1992403,675,9010510,950002,158,6754,86667.0,14444.0,-69.0,-65.0,-70.0,-70.0,-69.0,-65.0,-70.0,-70.0,-84.0,-92.0,-85.0,-90.0,15.0,27.0,15.0,20.0,1
2900,3C:55:76:E8:8F:1F,3235118,417143867,3671,9005814,3231447,408138053,0,2211,376727,2066,349969,145,26758,929,4,3693,788,0,68,270830.0,162500.0,-47.0,-52.0,-42.0,-47.0,-46.0,-52.0,-42.0,-47.0,-84.0,-92.0,-85.0,-90.0,37.0,40.0,43.0,43.0,1
2901,92:69:1D:31:68:E9,3264242,478741749,32793,70603494,3231449,408138255,0,14128,4378493,13982,4354575,146,23918,9026,1,32839,2958,0,162,229410.0,130000.0,-54.0,-51.0,-44.0,-50.0,-50.0,-49.0,-44.0,-48.0,-84.0,-92.0,-85.0,-90.0,30.0,41.0,41.0,40.0,1
2902,BA:8C:B9:54:50:24,3277281,511604731,45832,103466476,3231449,408138255,64,16140,4826089,15989,4801292,151,24797,9970,6,45814,11200,64,243,206470.0,97500.0,-54.0,-51.0,-38.0,-47.0,-51.0,-50.0,-44.0,-46.0,-84.0,-92.0,-85.0,-90.0,30.0,41.0,47.0,43.0,1
2903,62:47:05:9D:EB:15,3252492,458646690,21043,50508435,3231449,408138255,64,9351,1787701,9260,1772488,91,15213,4099,1,21027,2829,64,242,229410.0,137640.0,-43.0,-50.0,-44.0,-45.0,-43.0,-49.0,-44.0,-42.0,-85.0,-92.0,-86.0,-90.0,42.0,42.0,42.0,45.0,1
2904,F8:59:71:5A:E0:3D,3511684,831405614,280235,423267359,3231449,408138255,4,279743,381644888,274814,381056080,4929,588808,255755,20,282990,7398,4,869,130000.0,39000.0,-65.0,-73.0,-65.0,-71.0,-65.0,-71.0,-64.0,-70.0,-85.0,-92.0,-86.0,-90.0,20.0,19.0,21.0,19.0,1
2905,CC:2F:71:3E:C5:1F,3243012,409552692,11563,1414437,3231449,408138255,6,49304,4129759,40734,3114345,8570,1015414,12191,36,16569,191,6,858,130000.0,39000.0,-68.0,-72.0,-68.0,-60.0,-68.0,-72.0,-68.0,-60.0,-85.0,-92.0,-86.0,-90.0,17.0,20.0,18.0,30.0,1
2906,CC:2F:71:3F:1F:24,12238837,14220782857,9007388,13812644602,3231449,408138255,158,2058827,1219605554,2050106,1218557646,8721,1047908,1992724,675,9012201,950205,158,6754,86667.0,14444.0,-69.0,-64.0,-71.0,-70.0,-69.0,-64.0,-70.0,-70.0,-85.0,-92.0,-86.0,-90.0,16.0,28.0,15.0,20.0,1
2907,3C:55:76:E8:8F:1F,3235125,417144591,3672,9005932,3231453,408138659,0,2218,377205,2073,350447,145,26758,929,4,3694,788,0,68,270830.0,162500.0,-48.0,-53.0,-44.0,-47.0,-48.0,-51.0,-42.0,-46.0,-85.0,-92.0,-86.0,-90.0,37.0,39.0,42.0,43.0,1
2908,92:69:1D:31:68:E9,3264246,478742153,32793,70603494,3231453,408138659,0,14128,4378493,13982,4354575,146,23918,9026,1,32839,2958,0,162,229410.0,130000.0,-54.0,-51.0,-44.0,-50.0,-50.0,-49.0,-44.0,-48.0,-85.0,-92.0,-86.0,-90.0,31.0,41.0,42.0,40.0,1
2909,BA:8C:B9:54:50:24,3277285,511605135,45832,103466476,3231453,408138659,64,16140,4826089,15989,4801292,151,24797,9970,6,45814,11200,64,243,206470.0,97500.0,-54.0,-51.0,-38.0,-47.0,-51.0,-50.0,-44.0,-46.0,-85.0,-92.0,-86.0,-90.0,31.0,41.0,48.0,43.0,1
2910,62:47:05:9D:EB:15,3252922,459771214,21467,51632353,3231455,408138861,64,9391,1795592,9300,1780379,91,15213,4133,1,21451,2865,64,242,229410.0,137640.0,-52.0,-50.0,-49.0,-41.0,-46.0,-51.0,-48.0,-45.0,-85.0,-92.0,-86.0,-90.0,33.0,42.0,37.0,49.0,1
2911,F8:59:71:5A:E0:3D,3511692,831406422,280235,423267359,3231457,408139063,4,279743,381644888,274814,381056080,4929,588808,255755,20,282990,7398,4,869,130000.0,39000.0,-65.0,-73.0,-65.0,-71.0,-65.0,-71.0,-64.0,-70.0,-85.0,-92.0,-86.0,-90.0,20.0,19.0,21.0,19.0,1
2912,CC:2F:71:3E:C5:1F,3243021,409553560,11563,1414437,3231458,408139123,6,49304,4129759,40734,3114345,8570,1015414,12191,36,16569,191,6,858,130000.0,39000.0,-68.0,-72.0,-68.0,-60.0,-68.0,-72.0,-68.0,-60.0,-85.0,-92.0,-86.0,-90.0,17.0,20.0,18.0,30.0,1
2913,CC:2F:71:3F:1F:24,12240333,14223056943,9008875,13814917820,3231458,408139123,158,2059119,1219641877,2050398,1218593969,8721,1047908,1993015,675,9013704,950318,158,6754,86667.0,14444.0,-69.0,-64.0,-71.0,-69.0,-69.0,-64.0,-70.0,-68.0,-85.0,-92.0,-86.0,-90.0,16.0,28.0,15.0,21.0,1
2914,3C:55:76:E8:8F:1F,3236797,421567451,5335,13427924,3231462,408139527,0,2595,431430,2450,404672,145,26758,1030,4,5358,864,0,69,286760.0,1000.0,-50.0,-53.0,-45.0,-49.0,-52.0,-53.0,-45.0,-49.0,-85.0,-92.0,-86.0,-91.0,35.0,39.0,41.0,42.0,1
2915,92:69:1D:31:68:E9,3264255,478743021,32793,70603494,3231462,408139527,0,14128,4378493,13982,4354575,146,23918,9026,1,32839,2958,0,162,229410.0,130000.0,-54.0,-51.0,-44.0,-50.0,-50.0,-49.0,-44.0,-48.0,-85.0,-92.0,-86.0,-91.0,31.0,41.0,42.0,41.0,1
2916,BA:8C:B9:54:50:24,3277294,511606003,45832,103466476,3231462,408139527,64,16140,4826089,15989,4801292,151,24797,9970,6,45814,11200,64,243,206470.0,97500.0,-54.0,-51.0,-38.0,-47.0,-51.0,-50.0,-44.0,-46.0,-85.0,-92.0,-86.0,-91.0,31.0,41.0,48.0,44.0,1
2917,62:47:05:9D:EB:15,3252929,459771880,21467,51632353,3231462,408139527,64,9391,1795592,9300,1780379,91,15213,4133,1,21451,2865,64,242,229410.0,137640.0,-52.0,-50.0,-49.0,-41.0,-46.0,-51.0,-48.0,-45.0,-85.0,-92.0,-86.0,-91.0,33.0,42.0,37.0,50.0,1
2918,F8:59:71:5A:E0:3D,3511697,831406886,280235,423267359,3231462,408139527,4,279743,381644888,274814,381056080,4929,588808,255755,20,282990,7398,4,869,130000.0,39000.0,-65.0,-73.0,-65.0,-71.0,-65.0,-71.0,-64.0,-70.0,-85.0,-92.0,-86.0,-91.0,20.0,19.0,21.0,20.0,1
2919,CC:2F:71:3E:C5:1F,3243025,409553964,11563,1414437,3231462,408139527,6,49304,4129759,40734,3114345,8570,1015414,12191,36,16569,191,6,858,130000.0,39000.0,-68.0,-72.0,-68.0,-60.0,-68.0,-72.0,-68.0,-60.0,-85.0,-92.0,-86.0,-91.0,17.0,20.0,18.0,31.0,1
2920,CC:2F:71:3F:1F:24,12242385,14226184459,9010923,13818044932,3231462,408139527,158,2059517,1219694590,2050796,1218646682,8721,1047908,1993402,675,9015756,950326,158,6754,86667.0,13000.0,-68.0,-64.0,-70.0,-69.0,-68.0,-64.0,-70.0,-69.0,-85.0,-92.0,-86.0,-91.0,17.0,28.0,16.0,22.0,1
2921,3C:55:76:E8:8F:1F,3236803,421568090,5336,13428048,3231467,408140042,0,2604,432114,2459,405356,145,26758,1031,4,5359,864,0,69,286760.0,172050.0,-49.0,-53.0,-44.0,-48.0,-49.0,-53.0,-43.0,-48.0,-85.0,-92.0,-86.0,-90.0,36.0,39.0,42.0,42.0,1
2922,92:69:1D:31:68:E9,3264261,478743675,32794,70603633,3231467,408140042,0,14136,4382798,13990,4358880,146,23918,9029,1,32840,2958,0,162,229410.0,130000.0,-49.0,-49.0,-45.0,-49.0,-51.0,-50.0,-45.0,-49.0,-85.0,-92.0,-86.0,-90.0,36.0,43.0,41.0,41.0,1
2923,BA:8C:B9:54:50:24,3277299,511606518,45832,103466476,3231467,408140042,64,16140,4826089,15989,4801292,151,24797,9970,6,45814,11200,64,243,206470.0,97500.0,-54.0,-51.0,-38.0,-47.0,-51.0,-50.0,-44.0,-46.0,-85.0,-92.0,-86.0,-90.0,31.0,41.0,48.0,43.0,1
2924,62:47:05:9D:EB:15,3252937,459772865,21470,51632823,3231467,408140042,64,9427,1804206,9335,1788822,92,15384,4138,1,21454,2865,64,242,229410.0,137640.0,-46.0,-52.0,-47.0,-46.0,-46.0,-50.0,-46.0,-43.0,-85.0,-92.0,-86.0,-90.0,39.0,40.0,39.0,44.0,1
2925,F8:59:71:5A:E0:3D,3511705,831407663,280235,423267359,3231470,408140304,4,279743,381644888,274814,381056080,4929,588808,255755,20,282990,7398,4,869,130000.0,39000.0,-65.0,-73.0,-65.0,-71.0,-65.0,-71.0,-64.0,-70.0,-85.0,-92.0,-86.0,-90.0,20.0,19.0,21.0,19.0,1
2926,CC:2F:71:3E:C5:1F,3243035,409554943,11563,1414437,3231472,408140506,6,49304,4129759,40734,3114345,8570,1015414,12191,36,16569,191,6,858,130000.0,39000.0,-68.0,-72.0,-68.0,-60.0,-68.0,-72.0,-68.0,-60.0,-85.0,-92.0,-86.0,-90.0,17.0,20.0,18.0,30.0,1
2927,CC:2F:71:3F:1F:24,12243418,14227726348,9011946,13819585842,3231472,408140506,158,2059767,1219726152,2051046,1218678244,8721,1047908,1993643,675,9016770,950388,158,6754,86667.0,14444.0,-69.0,-64.0,-70.0,-69.0,-68.0,-64.0,-70.0,-69.0,-85.0,-92.0,-86.0,-90.0,16.0,28.0,16.0,21.0,1
2928,3C:55:76:E8:8F:1F,3236811,421568824,5337,13428116,3231474,408140708,0,2606,432288,2461,405530,145,26758,1032,4,5360,864,0,69,286760.0,172050.0,-50.0,-54.0,-46.0,-51.0,-48.0,-52.0,-43.0,-48.0,-85.0,-92.0,-86.0,-90.0,35.0,38.0,40.0,39.0,1
2929,92:69:1D:31:68:E9,3264275,478745559,32801,70604851,3231474,408140708,0,14150,4386366,14004,4362448,146,23918,9035,1,32847,2958,0,162,229410.0,137640.0,-55.0,-51.0,-44.0,-51.0,-52.0,-50.0,-45.0,-50.0,-85.0,-92.0,-86.0,-90.0,30.0,41.0,42.0,39.0,1
2930,BA:8C:B9:54:50:24,3277308,511607386,45832,103466476,3231476,408140910,64,16140,4826089,15989,4801292,151,24797,9970,6,45814,11200,64,243,206470.0,97500.0,-54.0,-51.0,-38.0,-47.0,-51.0,-50.0,-44.0,-46.0,-85.0,-92.0,-86.0,-90.0,31.0,41.0,48.0,43.0,1
2931,62:47:05:9D:EB:15,3252950,459774481,21474,51633571,3231476,408140910,64,9465,1807088,9373,1791704,92,15384,4143,1,21458,2865,64,246,229410.0,137640.0,-43.0,-49.0,-44.0,-44.0,-42.0,-47.0,-43.0,-40.0,-85.0,-92.0,-86.0,-90.0,42.0,43.0,42.0,46.0,1
2932,F8:59:71:5A:E0:3D,3511711,831408269,280235,423267359,3231476,408140910,4,279743,381644888,274814,381056080,4929,588808,255755,20,282990,7398,4,869,130000.0,39000.0,-65.0,-73.0,-65.0,-71.0,-65.0,-71.0,-64.0,-70.0,-85.0,-92.0,-86.0,-90.0,20.0,19.0,21.0,19.0,1
2933,CC:2F:71:3E:C5:1F,3243039,409555347,11563,1414437,3231476,408140910,6,49304,4129759,40734,3114345,8570,1015414,12191,36,16569,191,6,858,130000.0,39000.0,-68.0,-72.0,-68.0,-60.0,-68.0,-72.0,-68.0,-60.0,-85.0,-92.0,-86.0,-90.0,17.0,20.0,18.0,30.0,1
2934,CC:2F:71:3F:1F:24,12244779,14229769121,9013301,13821628009,3231478,408141112,158,2060074,1219767935,2051353,1218720027,8721,1047908,1993946,675,9018134,950595,158,6755,86667.0,14444.0,-69.0,-64.0,-70.0,-70.0,-69.0,-64.0,-70.0,-70.0,-85.0,-92.0,-86.0,-90.0,16.0,28.0,16.0,20.0,1
2935,3C:55:76:E8:8F:1F,3236820,421569735,5339,13428361,3231481,408141374,0,2624,433552,2479,406794,145,26758,1033,4,5362,867,0,69,286760.0,172050.0,-49.0,-50.0,-45.0,-49.0,-52.0,-50.0,-45.0,-50.0,-85.0,-92.0,-86.0,-90.0,36.0,42.0,41.0,41.0,1
2936,92:69:1D:31:68:E9,3264282,478746225,32801,70604851,3231481,408141374,0,14150,4386366,14004,4362448,146,23918,9035,1,32847,2958,0,162,229410.0,137640.0,-55.0,-51.0,-44.0,-51.0,-52.0,-50.0,-45.0,-50.0,-85.0,-92.0,-86.0,-90.0,30.0,41.0,42.0,39.0,1
2937,BA:8C:B9:54:50:24,3277313,511607850,45832,103466476,3231481,408141374,64,16140,4826089,15989,4801292,151,24797,9970,6,45814,11200,64,243,206470.0,97500.0,-54.0,-51.0,-38.0,-47.0,-51.0,-50.0,-44.0,-46.0,-85.0,-92.0,-86.0,-90.0,31.0,41.0,48.0,43.0,1
2938,62:47:05:9D:EB:15,3252955,459774945,21474,51633571,3231481,408141374,64,9465,1807088,9373,1791704,92,15384,4143,1,21458,2865,64,246,229410.0,137640.0,-43.0,-49.0,-44.0,-44.0,-42.0,-47.0,-43.0,-40.0,-85.0,-92.0,-86.0,-90.0,42.0,43.0,42.0,46.0,1
2939,F8:59:71:5A:E0:3D,3511716,831408733,280235,423267359,3231481,408141374,4,279743,381644888,274814,381056080,4929,588808,255755,20,282990,7398,4,869,130000.0,39000.0,-65.0,-73.0,-65.0,-71.0,-65.0,-71.0,-64.0,-70.0,-85.0,-92.0,-86.0,-90.0,20.0,19.0,21.0,19.0,1
2940,CC:2F:71:3E:C5:1F,3243046,409556013,11563,1414437,3231483,408141576,6,49304,4129759,40734,3114345,8570,1015414,12191,36,16569,191,6,858,130000.0,39000.0,-68.0,-72.0,-68.0,-60.0,-68.0,-72.0,-68.0,-60.0,-85.0,-92.0,-86.0,-90.0,17.0,20.0,18.0,30.0,1
2941,CC:2F:71:3F:1F:24,12245868,14231401059,9014385,13823259483,3231483,408141576,158,2060305,1219797708,2051584,1218749800,8721,1047908,1994173,675,9019218,950598,158,6755,86667.0,14444.0,-69.0,-64.0,-70.0,-70.0,-68.0,-64.0,-70.0,-69.0,-85.0,-92.0,-86.0,-90.0,16.0,28.0,16.0,20.0,1
2942,3C:55:76:E8:8F:1F,3236828,421570527,5341,13428547,3231487,408141980,0,2642,434857,2497,408099,145,26758,1035,4,5364,867,0,69,286760.0,172050.0,-46.0,-47.0,-41.0,-45.0,-47.0,-50.0,-45.0,-51.0,-85.0,-92.0,-86.0,-90.0,39.0,45.0,45.0,45.0,1
2943,92:69:1D:31:68:E9,3264288,478746831,32801,70604851,3231487,408141980,0,14150,4386366,14004,4362448,146,23918,9035,1,32847,2958,0,162,229410.0,137640.0,-55.0,-51.0,-44.0,-51.0,-52.0,-50.0,-45.0,-50.0,-85.0,-92.0,-86.0,-90.0,30.0,41.0,42.0,39.0,1
2944,BA:8C:B9:54:50:24,3277319,511608456,45832,103466476,3231487,408141980,64,16140,4826089,15989,4801292,151,24797,9970,6,45814,11200,64,243,206470.0,97500.0,-54.0,-51.0,-38.0,-47.0,-51.0,-50.0,-44.0,-46.0,-85.0,-92.0,-86.0,-90.0,31.0,41.0,48.0,43.0,1
2945,62:47:05:9D:EB:15,3252975,459780083,21485,51637628,3231490,408142455,64,9487,1810789,9395,1795405,92,15384,4158,1,21469,2865,64,246,216660.0,130000.0,-43.0,-49.0,-44.0,-45.0,-45.0,-51.0,-47.0,-45.0,-85.0,-92.0,-86.0,-90.0,42.0,43.0,42.0,45.0,1
2946,F8:59:71:5A:E0:3D,3511725,831409814,280235,423267359,3231490,408142455,4,279743,381644888,274814,381056080,4929,588808,255755,20,282990,7398,4,869,130000.0,39000.0,-65.0,-73.0,-65.0,-71.0,-65.0,-71.0,-64.0,-70.0,-85.0,-92.0,-86.0,-90.0,20.0,19.0,21.0,19.0,1
2947,CC:2F:71:3E:C5:1F,3243053,409556892,11563,1414437,3231490,408142455,6,49304,4129759,40734,3114345,8570,1015414,12191,36,16569,191,6,858,130000.0,39000.0,-68.0,-72.0,-68.0,-60.0,-68.0,-72.0,-68.0,-60.0,-85.0,-92.0,-86.0,-90.0,17.0,20.0,18.0,30.0,1
2948,CC:2F:71:3F:1F:24,12246954,14233029873,9015464,13824887418,3231490,408142455,158,2060559,1219829929,2051838,1218782021,8721,1047908,1994412,675,9020297,950760,158,6755,86667.0,14444.0,-69.0,-64.0,-71.0,-71.0,-69.0,-64.0,-70.0,-71.0,-85.0,-92.0,-86.0,-90.0,16.0,28.0,15.0,19.0,1
2949,3C:55:76:E8:8F:1F,3236835,421571394,5342,13428677,3231493,408142717,0,2661,436190,2516,409432,145,26758,1036,4,5365,867,0,69,286760.0,172050.0,-46.0,-49.0,-43.0,-46.0,-46.0,-49.0,-42.0,-45.0,-85.0,-92.0,-86.0,-90.0,39.0,43.0,43.0,44.0,1
2950,92:69:1D:31:68:E9,3264296,478747770,32801,70604851,3231495,408142919,0,14150,4386366,14004,4362448,146,23918,9035,1,32847,2958,0,162,229410.0,137640.0,-55.0,-51.0,-44.0,-51.0,-52.0,-50.0,-45.0,-50.0,-85.0,-92.0,-86.0,-90.0,30.0,41.0,42.0,39.0,1
2951,BA:8C:B9:54:50:24,3277327,511609395,45832,103466476,3231495,408142919,64,16140,4826089,15989,4801292,151,24797,9970,6,45814,11200,64,243,206470.0,97500.0,-54.0,-51.0,-38.0,-47.0,-51.0,-50.0,-44.0,-46.0,-85.0,-92.0,-86.0,-90.0,31.0,41.0,48.0,43.0,1
2952,62:47:05:9D:EB:15,3252980,459780547,21485,51637628,3231495,408142919,64,9487,1810789,9395,1795405,92,15384,4158,1,21469,2865,64,246,216660.0,130000.0,-43.0,-49.0,-44.0,-45.0,-45.0,-51.0,-47.0,-45.0,-85.0,-92.0,-86.0,-90.0,42.0,43.0,42.0,45.0,1
2953,F8:59:71:5A:E0:3D,3511730,831410278,280235,423267359,3231495,408142919,4,279743,381644888,274814,381056080,4929,588808,255755,20,282990,7398,4,869,130000.0,39000.0,-65.0,-73.0,-65.0,-71.0,-65.0,-71.0,-64.0,-70.0,-85.0,-92.0,-86.0,-90.0,20.0,19.0,21.0,19.0,1
2954,CC:2F:71:3E:C5:1F,3243058,409557356,11563,1414437,3231495,408142919,6,49304,4129759,40734,3114345,8570,1015414,12191,36,16569,191,6,858,130000.0,39000.0,-68.0,-72.0,-68.0,-60.0,-68.0,-72.0,-68.0,-60.0,-85.0,-92.0,-86.0,-90.0,17.0,20.0,18.0,30.0,1
2955,CC:2F:71:3F:1F:24,12247855,14234372385,9016360,13826229466,3231495,408142919,158,2060797,1219860171,2052076,1218812263,8721,1047908,1994635,675,9021193,950792,158,6755,86667.0,14444.0,-68.0,-63.0,-70.0,-70.0,-67.0,-63.0,-70.0,-70.0,-85.0,-92.0,-86.0,-90.0,17.0,29.0,16.0,20.0,1
2956,3C:55:76:E8:8F:1F,3236842,421572130,5343,13428807,3231499,408143323,0,2672,436983,2527,410225,145,26758,1037,4,5366,871,0,70,286760.0,1000.0,-51.0,-51.0,-45.0,-49.0,-52.0,-51.0,-45.0,-49.0,-85.0,-92.0,-86.0,-90.0,34.0,41.0,41.0,41.0,1
2957,92:69:1D:31:68:E9,3264682,479753717,33183,71610394,3231499,408143323,0,14197,4395764,14051,4371846,146,23918,9078,1,33229,2975,0,162,229410.0,137640.0,-52.0,-52.0,-51.0,-55.0,-50.0,-50.0,-45.0,-49.0,-85.0,-92.0,-86.0,-90.0,33.0,40.0,35.0,35.0,1
2958,BA:8C:B9:54:50:24,3277332,511609915,45833,103466592,3231499,408143323,64,16146,4826497,15995,4801700,151,24797,9970,6,45815,11200,64,243,206470.0,97500.0,-55.0,-50.0,-38.0,-45.0,-49.0,-50.0,-42.0,-45.0,-85.0,-92.0,-86.0,-90.0,30.0,42.0,48.0,45.0,1
2959,62:47:05:9D:EB:15,3252987,459781269,21486,51637744,3231501,408143525,64,9495,1811333,9403,1795949,92,15384,4158,1,21470,2865,64,246,216660.0,130000.0,-42.0,-47.0,-44.0,-40.0,-43.0,-47.0,-45.0,-40.0,-85.0,-92.0,-86.0,-90.0,43.0,45.0,42.0,50.0,1
2960,F8:59:71:5A:E0:3D,3511737,831410944,280236,423267419,3231501,408143525,4,279745,381645028,274816,381056220,4929,588808,255755,20,282991,7398,4,869,130000.0,39000.0,-67.0,-73.0,-65.0,-71.0,-66.0,-73.0,-65.0,-70.0,-85.0,-92.0,-86.0,-90.0,18.0,19.0,21.0,19.0,1
2961,CC:2F:71:3E:C5:1F,3243065,409558078,11564,1414553,3231501,408143525,6,49306,4129899,40736,3114485,8570,1015414,12191,36,16570,191,6,858,130000.0,39000.0,-68.0,-72.0,-68.0,-60.0,-68.0,-71.0,-67.0,-60.0,-85.0,-92.0,-86.0,-90.0,17.0,20.0,18.0,30.0,1
2962,CC:2F:71:3F:1F:24,12249153,14236325494,9017650,13828181767,3231503,408143727,158,2061075,1219895220,2052354,1218847312,8721,1047908,1994905,675,9022483,950946,158,6755,86667.0,14444.0,-69.0,-63.0,-70.0,-71.0,-68.0,-63.0,-69.0,-70.0,-85.0,-92.0,-86.0,-90.0,16.0,29.0,16.0,19.0,1
2963,3C:55:76:E8:8F:1F,3236852,421573036,5345,13428985,3231507,408144051,0,2697,438865,2551,411989,146,26876,1040,4,5368,871,0,71,286760.0,172050.0,-48.0,-51.0,-44.0,-48.0,-50.0,-51.0,-45.0,-50.0,-85.0,-92.0,-86.0,-90.0,37.0,41.0,42.0,42.0,1
2964,92:69:1D:31:68:E9,3264693,479754763,33184,71610510,3231509,408144253,0,14199,4395900,14053,4371982,146,23918,9078,1,33230,2975,0,162,229410.0,137640.0,-54.0,-51.0,-44.0,-50.0,-51.0,-50.0,-46.0,-50.0,-85.0,-92.0,-86.0,-90.0,31.0,41.0,42.0,40.0,1
2965,BA:8C:B9:54:50:24,3277342,511610845,45833,103466592,3231509,408144253,64,16146,4826497,15995,4801700,151,24797,9970,6,45815,11200,64,243,206470.0,97500.0,-55.0,-50.0,-38.0,-45.0,-49.0,-50.0,-42.0,-45.0,-85.0,-92.0,-86.0,-90.0,30.0,42.0,48.0,45.0,1
2966,62:47:05:9D:EB:15,3252996,459782123,21486,51637744,3231510,408144379,64,9496,1811401,9404,1796017,92,15384,4158,1,21470,2865,64,246,216660.0,130000.0,-43.0,-50.0,-44.0,-44.0,-42.0,-47.0,-44.0,-40.0,-85.0,-92.0,-86.0,-90.0,42.0,42.0,42.0,46.0,1
2967,F8:59:71:5A:E0:3D,3511746,831411798,280236,423267419,3231510,408144379,4,279745,381645028,274816,381056220,4929,588808,255755,20,282991,7398,4,869,130000.0,39000.0,-67.0,-73.0,-65.0,-71.0,-66.0,-73.0,-65.0,-70.0,-85.0,-92.0,-86.0,-90.0,18.0,19.0,21.0,19.0,1
2968,CC:2F:71:3E:C5:1F,3243074,409558932,11564,1414553,3231510,408144379,6,49306,4129899,40736,3114485,8570,1015414,12191,36,16570,191,6,858,130000.0,39000.0,-68.0,-72.0,-68.0,-60.0,-68.0,-71.0,-67.0,-60.0,-85.0,-92.0,-86.0,-90.0,17.0,20.0,18.0,30.0,1
2969,CC:2F:71:3F:1F:24,12250780,14238807698,9019270,13830663319,3231510,408144379,158,2061399,1219935436,2052678,1218887528,8721,1047908,1995219,675,9024088,950984,158,6755,104000.0,26000.0,-70.0,-64.0,-70.0,-68.0,-69.0,-64.0,-69.0,-68.0,-85.0,-92.0,-86.0,-91.0,15.0,28.0,16.0,23.0,1
2970,3C:55:76:E8:8F:1F,3236862,421577430,5347,13432585,3231515,408144845,0,2715,440129,2569,413253,146,26876,1041,4,5370,871,0,71,286760.0,172050.0,-47.0,-52.0,-42.0,-47.0,-46.0,-51.0,-42.0,-46.0,-85.0,-92.0,-86.0,-91.0,38.0,40.0,44.0,44.0,1
2971,92:69:1D:31:68:E9,3264705,479758861,33190,71614016,3231515,408144845,0,14207,4398952,14061,4375034,146,23918,9083,1,33236,2975,0,162,229410.0,137640.0,-52.0,-52.0,-51.0,-55.0,-51.0,-50.0,-46.0,-51.0,-85.0,-92.0,-86.0,-91.0,33.0,40.0,35.0,36.0,1
2972,BA:8C:B9:54:50:24,3277348,511611437,45833,103466592,3231515,408144845,64,16146,4826497,15995,4801700,151,24797,9970,6,45815,11200,64,243,206470.0,97500.0,-55.0,-50.0,-38.0,-45.0,-49.0,-50.0,-42.0,-45.0,-85.0,-92.0,-86.0,-91.0,30.0,42.0,48.0,46.0,1
2973,62:47:05:9D:EB:15,3253003,459782791,21486,51637744,3231517,408145047,64,9496,1811401,9404,1796017,92,15384,4158,1,21470,2865,64,246,216660.0,130000.0,-43.0,-50.0,-44.0,-44.0,-42.0,-47.0,-44.0,-40.0,-85.0,-92.0,-86.0,-91.0,42.0,42.0,42.0,47.0,1
2974,F8:59:71:5A:E0:3D,3511753,831412466,280236,423267419,3231517,408145047,4,279747,381645216,274817,381056290,4930,588926,255756,20,282991,7398,4,869,130000.0,39000.0,-66.0,-73.0,-64.0,-71.0,-66.0,-74.0,-66.0,-71.0,-85.0,-92.0,-86.0,-91.0,19.0,19.0,22.0,20.0,1
2975,CC:2F:71:3E:C5:1F,3243081,409559600,11564,1414553,3231517,408145047,6,49306,4129899,40736,3114485,8570,1015414,12191,36,16570,191,6,858,130000.0,39000.0,-68.0,-72.0,-68.0,-60.0,-68.0,-71.0,-67.0,-60.0,-85.0,-92.0,-86.0,-91.0,17.0,20.0,18.0,31.0,1
2976,CC:2F:71:3F:1F:24,12252783,14241880126,9021266,13833735079,3231517,408145047,158,2061776,1219981426,2053055,1218933518,8721,1047908,1995589,675,9026085,951147,158,6755,86667.0,14444.0,-68.0,-64.0,-69.0,-69.0,-68.0,-64.0,-69.0,-69.0,-85.0,-92.0,-86.0,-91.0,17.0,28.0,17.0,22.0,1
2977,3C:55:76:E8:8F:1F,3236872,421580584,5349,13435011,3231523,408145573,0,2743,442093,2596,415099,147,26994,1042,4,5372,872,0,72,286760.0,172050.0,-64.0,-54.0,-48.0,-54.0,-52.0,-52.0,-48.0,-51.0,-85.0,-92.0,-86.0,-91.0,21.0,38.0,38.0,37.0,1
2978,92:69:1D:31:68:E9,3264715,479759791,33190,71614016,3231525,408145775,0,14207,4398952,14061,4375034,146,23918,9083,1,33236,2975,0,162,229410.0,137640.0,-52.0,-52.0,-51.0,-55.0,-51.0,-50.0,-46.0,-51.0,-86.0,-92.0,-87.0,-91.0,34.0,40.0,36.0,36.0,1
2979,BA:8C:B9:54:50:24,3277361,511612631,45833,103466592,3231528,408146039,64,16146,4826497,15995,4801700,151,24797,9970,6,45815,11200,64,243,206470.0,97500.0,-55.0,-50.0,-38.0,-45.0,-49.0,-50.0,-42.0,-45.0,-86.0,-92.0,-87.0,-91.0,31.0,42.0,49.0,46.0,1
2980,62:47:05:9D:EB:15,3253014,459783783,21486,51637744,3231528,408146039,64,9496,1811401,9404,1796017,92,15384,4158,1,21470,2865,64,246,216660.0,130000.0,-43.0,-50.0,-44.0,-44.0,-42.0,-47.0,-44.0,-40.0,-86.0,-92.0,-87.0,-91.0,43.0,42.0,43.0,47.0,1
2981,F8:59:71:5A:E0:3D,3511764,831413458,280236,423267419,3231528,408146039,4,279747,381645216,274817,381056290,4930,588926,255756,20,282991,7398,4,869,130000.0,39000.0,-66.0,-73.0,-64.0,-71.0,-66.0,-74.0,-66.0,-71.0,-86.0,-92.0,-87.0,-91.0,20.0,19.0,23.0,20.0,1
2982,CC:2F:71:3E:C5:1F,3243092,409560592,11564,1414553,3231528,408146039,6,49306,4129899,40736,3114485,8570,1015414,12191,36,16570,191,6,858,130000.0,39000.0,-68.0,-72.0,-68.0,-60.0,-68.0,-71.0,-67.0,-60.0,-86.0,-92.0,-87.0,-91.0,18.0,20.0,19.0,31.0,1
2983,CC:2F:71:3F:1F:24,12254953,14245193287,9023423,13837047046,3231530,408146241,158,2062185,1220032120,2053464,1218984212,8721,1047908,1995998,675,9028240,951486,158,6755,86667.0,14444.0,-76.0,-70.0,-77.0,-75.0,-73.0,-67.0,-74.0,-72.0,-86.0,-92.0,-87.0,-91.0,10.0,22.0,10.0,16.0,1
2984,3C:55:76:E8:8F:1F,3236889,421590972,5359,13444731,3231530,408146241,0,2782,447063,2634,419951,148,27112,1054,4,5382,874,0,73,286760.0,172050.0,-48.0,-52.0,-44.0,-48.0,-51.0,-52.0,-45.0,-49.0,-87.0,-93.0,-87.0,-92.0,39.0,41.0,43.0,44.0,1
2985,92:69:1D:31:68:E9,3264731,479764080,33198,71617577,3231533,408146503,0,14229,4403855,14083,4379937,146,23918,9092,1,33244,2975,0,162,229410.0,137640.0,-54.0,-51.0,-45.0,-50.0,-52.0,-50.0,-44.0,-50.0,-87.0,-93.0,-87.0,-92.0,33.0,42.0,42.0,42.0,1
2986,BA:8C:B9:54:50:24,3277366,511613095,45833,103466592,3231533,408146503,64,16146,4826497,15995,4801700,151,24797,9970,6,45815,11200,64,243,206470.0,97500.0,-55.0,-50.0,-38.0,-45.0,-49.0,-50.0,-42.0,-45.0,-87.0,-93.0,-87.0,-92.0,32.0,43.0,49.0,47.0,1
2987,62:47:05:9D:EB:15,3253410,460821381,21877,52674878,3231533,408146503,64,9559,1820707,9467,1805323,92,15384,4191,1,21861,2872,64,246,229410.0,137640.0,-43.0,-50.0,-44.0,-45.0,-46.0,-51.0,-47.0,-45.0,-87.0,-93.0,-87.0,-92.0,44.0,43.0,43.0,47.0,1
2988,F8:59:71:5A:E0:3D,3511769,831413922,280236,423267419,3231533,408146503,4,279747,381645216,274817,381056290,4930,588926,255756,20,282991,7398,4,869,130000.0,39000.0,-66.0,-73.0,-64.0,-71.0,-66.0,-74.0,-66.0,-71.0,-87.0,-93.0,-87.0,-92.0,21.0,20.0,23.0,21.0,1
2989,CC:2F:71:3E:C5:1F,3243099,409561258,11564,1414553,3231535,408146705,6,49306,4129899,40736,3114485,8570,1015414,12191,36,16570,191,6,858,130000.0,39000.0,-68.0,-72.0,-68.0,-60.0,-68.0,-71.0,-67.0,-60.0,-87.0,-93.0,-87.0,-92.0,19.0,21.0,19.0,32.0,1
2990,CC:2F:71:3F:1F:24,12255910,14246620031,9024375,13838473326,3231535,408146705,158,2062387,1220058080,2053666,1219010172,8721,1047908,1996200,675,9029208,951511,158,6755,86667.0,14444.0,-69.0,-64.0,-69.0,-69.0,-71.0,-66.0,-72.0,-71.0,-87.0,-93.0,-87.0,-92.0,18.0,29.0,18.0,23.0,1
2991,3C:55:76:E8:8F:1F,3236900,421592026,5360,13444855,3231540,408147171,0,2801,448395,2653,421283,148,27112,1055,4,5383,874,0,75,286760.0,172050.0,-50.0,-53.0,-49.0,-51.0,-52.0,-52.0,-48.0,-51.0,-87.0,-93.0,-87.0,-92.0,37.0,40.0,38.0,41.0,1
2992,92:69:1D:31:68:E9,3264764,479781348,33224,71634177,3231540,408147171,0,14285,4415674,14139,4391756,146,23918,9125,1,33270,2975,0,163,229410.0,137640.0,-53.0,-52.0,-45.0,-51.0,-51.0,-50.0,-46.0,-50.0,-87.0,-93.0,-87.0,-92.0,34.0,41.0,42.0,41.0,1
2993,BA:8C:B9:54:50:24,3277373,511613763,45833,103466592,3231540,408147171,64,16146,4826497,15995,4801700,151,24797,9970,6,45815,11200,64,243,206470.0,97500.0,-55.0,-50.0,-38.0,-45.0,-49.0,-50.0,-42.0,-45.0,-87.0,-93.0,-87.0,-92.0,32.0,43.0,49.0,47.0,1
2994,62:47:05:9D:EB:15,3253417,460822049,21877,52674878,3231540,408147171,64,9559,1820707,9467,1805323,92,15384,4191,1,21861,2872,64,246,229410.0,137640.0,-43.0,-50.0,-44.0,-45.0,-46.0,-51.0,-47.0,-45.0,-87.0,-93.0,-87.0,-92.0,44.0,43.0,43.0,47.0,1
2995,F8:59:71:5A:E0:3D,3511776,831414590,280236,423267419,3231540,408147171,4,279747,381645216,274817,381056290,4930,588926,255756,20,282991,7398,4,869,130000.0,39000.0,-66.0,-73.0,-64.0,-71.0,-66.0,-74.0,-66.0,-71.0,-87.0,-93.0,-87.0,-92.0,21.0,20.0,23.0,21.0,1
2996,CC:2F:71:3E:C5:1F,3243104,409561724,11564,1414553,3231540,408147171,6,49306,4129899,40736,3114485,8570,1015414,12191,36,16570,191,6,858,130000.0,39000.0,-68.0,-72.0,-68.0,-60.0,-68.0,-71.0,-67.0,-60.0,-87.0,-93.0,-87.0,-92.0,19.0,21.0,19.0,32.0,1
2997,CC:2F:71:3F:1F:24,12256930,14248139969,9025390,13839992798,3231540,408147171,158,2062615,1220087429,2053893,1219039403,8722,1048026,1996428,675,9030223,951627,158,6755,86667.0,14444.0,-72.0,-67.0,-74.0,-72.0,-71.0,-66.0,-73.0,-71.0,-87.0,-93.0,-87.0,-92.0,15.0,26.0,13.0,20.0,1
2998,3C:55:76:E8:8F:1F,3236908,421594073,5362,13446296,3231546,408147777,0,2826,450175,2678,423063,148,27112,1057,4,5385,874,0,75,286760.0,172050.0,-47.0,-52.0,-43.0,-48.0,-47.0,-52.0,-43.0,-48.0,-87.0,-93.0,-88.0,-92.0,40.0,41.0,45.0,44.0,1
2999,92:69:1D:31:68:E9,3264789,479785747,33242,71637910,3231547,408147837,0,14315,4419965,14169,4396047,146,23918,9143,1,33288,2975,0,163,229410.0,137640.0,-54.0,-51.0,-45.0,-51.0,-51.0,-51.0,-47.0,-51.0,-87.0,-93.0,-88.0,-92.0,33.0,42.0,43.0,41.0,1
3000,BA:8C:B9:54:50:24,3277380,511614429,45833,103466592,3231547,408147837,64,16146,4826497,15995,4801700,151,24797,9970,6,45815,11200,64,243,206470.0,97500.0,-55.0,-50.0,-38.0,-45.0,-49.0,-50.0,-42.0,-45.0,-87.0,-93.0,-88.0,-92.0,32.0,43.0,50.0,47.0,1
3001,62:47:05:9D:EB:15,3253424,460822715,21877,52674878,3231547,408147837,64,9559,1820707,9467,1805323,92,15384,4191,1,21861,2872,64,246,229410.0,137640.0,-43.0,-50.0,-44.0,-45.0,-46.0,-51.0,-47.0,-45.0,-87.0,-93.0,-88.0,-92.0,44.0,43.0,44.0,47.0,1
3002,F8:59:71:5A:E0:3D,3511784,831415318,280236,423267419,3231548,408147899,4,279747,381645216,274817,381056290,4930,588926,255756,20,282991,7398,4,869,130000.0,39000.0,-66.0,-73.0,-64.0,-71.0,-66.0,-74.0,-66.0,-71.0,-87.0,-93.0,-88.0,-92.0,21.0,20.0,24.0,21.0,1
3003,CC:2F:71:3E:C5:1F,3243115,409562716,11564,1414553,3231551,408148163,6,49307,4130017,40736,3114485,8571,1015532,12192,36,16570,191,6,858,130000.0,39000.0,-68.0,-72.0,-68.0,-60.0,-67.0,-71.0,-67.0,-60.0,-87.0,-93.0,-88.0,-92.0,19.0,21.0,20.0,32.0,1
3004,CC:2F:71:3F:1F:24,12257731,14249312941,9026180,13841164778,3231551,408148163,158,2062790,1220109985,2054068,1219061959,8722,1048026,1996603,675,9031013,951716,158,6755,86667.0,14444.0,-72.0,-67.0,-73.0,-73.0,-71.0,-66.0,-72.0,-72.0,-87.0,-93.0,-88.0,-92.0,15.0,26.0,15.0,19.0,1
3005,3C:55:76:E8:8F:1F,3236915,421594661,5362,13446296,3231553,408148365,0,2826,450175,2678,423063,148,27112,1057,4,5385,874,0,75,286760.0,172050.0,-47.0,-52.0,-43.0,-48.0,-47.0,-52.0,-43.0,-48.0,-87.0,-93.0,-88.0,-92.0,40.0,41.0,45.0,44.0,1
3006,92:69:1D:31:68:E9,3264805,479790786,33252,71642421,3231553,408148365,0,14342,4422416,14196,4398498,146,23918,9153,1,33298,2975,0,164,229410.0,137640.0,-50.0,-50.0,-45.0,-48.0,-50.0,-49.0,-45.0,-49.0,-87.0,-93.0,-88.0,-92.0,37.0,43.0,43.0,44.0,1
3007,BA:8C:B9:54:50:24,3277388,511615292,45833,103466592,3231555,408148700,64,16148,4826633,15997,4801836,151,24797,9970,6,45816,11200,64,243,206470.0,97500.0,-54.0,-51.0,-38.0,-46.0,-50.0,-50.0,-40.0,-45.0,-87.0,-93.0,-88.0,-92.0,33.0,42.0,50.0,46.0,1
3008,62:47:05:9D:EB:15,3253434,460823780,21877,52674878,3231557,408148902,64,9570,1821509,9477,1806003,93,15506,4192,1,21861,2872,64,246,229410.0,137640.0,-43.0,-50.0,-44.0,-45.0,-42.0,-47.0,-43.0,-40.0,-87.0,-93.0,-88.0,-92.0,44.0,43.0,44.0,47.0,1
3009,F8:59:71:5A:E0:3D,3511793,831416321,280236,423267419,3231557,408148902,4,279749,381645356,274819,381056430,4930,588926,255756,20,282992,7398,4,869,130000.0,39000.0,-66.0,-73.0,-65.0,-71.0,-66.0,-74.0,-66.0,-71.0,-87.0,-93.0,-88.0,-92.0,21.0,20.0,23.0,21.0,1
3010,CC:2F:71:3E:C5:1F,3243121,409563455,11564,1414553,3231557,408148902,6,49308,4130087,40737,3114555,8571,1015532,12192,36,16570,191,6,858,130000.0,39000.0,-69.0,-72.0,-68.0,-60.0,-67.0,-71.0,-67.0,-60.0,-87.0,-93.0,-88.0,-92.0,18.0,21.0,20.0,32.0,1
3011,CC:2F:71:3F:1F:24,12258910,14251067854,9027351,13842918750,3231559,408149104,158,2063023,1220140557,2054301,1219092531,8722,1048026,1996836,675,9032183,951745,158,6755,86667.0,14444.0,-72.0,-67.0,-73.0,-72.0,-70.0,-66.0,-72.0,-71.0,-87.0,-93.0,-88.0,-92.0,15.0,26.0,15.0,20.0,1
3012,3C:55:76:E8:8F:1F,3236926,421596131,5363,13446705,3231563,408149426,0,2829,450684,2681,423572,148,27112,1059,4,5386,874,0,75,270830.0,162500.0,-47.0,-52.0,-44.0,-49.0,-48.0,-51.0,-44.0,-48.0,-87.0,-93.0,-88.0,-92.0,40.0,41.0,44.0,43.0,1
3013,92:69:1D:31:68:E9,3264817,479792068,33253,71642556,3231564,408149512,0,14345,4422735,14198,4398695,147,24040,9155,1,33299,2975,0,164,229410.0,137640.0,-54.0,-51.0,-45.0,-51.0,-50.0,-49.0,-45.0,-49.0,-87.0,-93.0,-88.0,-92.0,33.0,42.0,43.0,41.0,1
3014,BA:8C:B9:54:50:24,3277397,511616104,45833,103466592,3231564,408149512,64,16148,4826633,15997,4801836,151,24797,9970,6,45816,11200,64,243,206470.0,97500.0,-54.0,-51.0,-38.0,-46.0,-50.0,-50.0,-40.0,-45.0,-87.0,-93.0,-88.0,-92.0,33.0,42.0,50.0,46.0,1
3015,62:47:05:9D:EB:15,3253441,460824390,21877,52674878,3231564,408149512,64,9570,1821509,9477,1806003,93,15506,4192,1,21861,2872,64,246,229410.0,137640.0,-43.0,-50.0,-44.0,-45.0,-42.0,-47.0,-43.0,-40.0,-87.0,-93.0,-88.0,-92.0,44.0,43.0,44.0,47.0,1
3016,F8:59:71:5A:E0:3D,3511801,831416997,280236,423267419,3231565,408149578,4,279749,381645356,274819,381056430,4930,588926,255756,20,282992,7398,4,869,130000.0,39000.0,-66.0,-73.0,-65.0,-71.0,-66.0,-74.0,-66.0,-71.0,-87.0,-93.0,-88.0,-92.0,21.0,20.0,23.0,21.0,1
3017,CC:2F:71:3E:C5:1F,3243132,409564467,11564,1414553,3231568,408149914,6,49308,4130087,40737,3114555,8571,1015532,12192,36,16570,191,6,858,130000.0,39000.0,-69.0,-72.0,-68.0,-60.0,-67.0,-71.0,-67.0,-60.0,-87.0,-93.0,-88.0,-92.0,18.0,21.0,20.0,32.0,1
3018,CC:2F:71:3F:1F:24,12259784,14252352660,9028216,13844202746,3231568,408149914,158,2063218,1220166159,2054492,1219117565,8726,1048594,1997030,675,9033044,951920,158,6755,86667.0,14444.0,-72.0,-68.0,-74.0,-72.0,-73.0,-69.0,-75.0,-73.0,-87.0,-93.0,-88.0,-92.0,15.0,25.0,14.0,20.0,1
3019,3C:55:76:E8:8F:1F,3236934,421596932,5363,13446705,3231571,408150227,0,2836,451162,2688,424050,148,27112,1059,4,5386,874,0,75,270830.0,162500.0,-49.0,-52.0,-49.0,-51.0,-51.0,-52.0,-47.0,-51.0,-87.0,-93.0,-88.0,-92.0,38.0,41.0,39.0,41.0,1
3020,92:69:1D:31:68:E9,3265084,480478215,33513,72327988,3231571,408150227,0,14387,4430768,14239,4406557,148,24211,9180,1,33559,2975,0,164,229410.0,137640.0,-51.0,-50.0,-45.0,-50.0,-51.0,-50.0,-45.0,-50.0,-87.0,-93.0,-88.0,-92.0,36.0,43.0,43.0,42.0,1
3021,BA:8C:B9:54:50:24,3277404,511616819,45833,103466592,3231571,408150227,64,16148,4826633,15997,4801836,151,24797,9970,6,45816,11200,64,243,206470.0,97500.0,-54.0,-51.0,-38.0,-46.0,-50.0,-50.0,-40.0,-45.0,-87.0,-93.0,-88.0,-92.0,33.0,42.0,50.0,46.0,1
3022,62:47:05:9D:EB:15,3253450,460825307,21877,52674878,3231573,408150429,64,9570,1821509,9477,1806003,93,15506,4192,1,21861,2872,64,246,229410.0,137640.0,-43.0,-50.0,-44.0,-45.0,-42.0,-47.0,-43.0,-40.0,-87.0,-93.0,-88.0,-92.0,44.0,43.0,44.0,47.0,1
3023,F8:59:71:5A:E0:3D,3511809,831417848,280236,423267419,3231573,408150429,4,279749,381645356,274819,381056430,4930,588926,255756,20,282992,7398,4,869,130000.0,39000.0,-66.0,-73.0,-65.0,-71.0,-66.0,-74.0,-66.0,-71.0,-87.0,-93.0,-88.0,-92.0,21.0,20.0,23.0,21.0,1
3024,CC:2F:71:3E:C5:1F,3243137,409564982,11564,1414553,3231573,408150429,6,49308,4130087,40737,3114555,8571,1015532,12192,36,16570,191,6,858,130000.0,39000.0,-69.0,-72.0,-68.0,-60.0,-67.0,-71.0,-67.0,-60.0,-87.0,-93.0,-88.0,-92.0,18.0,21.0,20.0,32.0,1
3025,CC:2F:71:3F:1F:24,12261088,14254310295,9029515,13846159866,3231573,408150429,158,2063482,1220202407,2054756,1219153813,8726,1048594,1997294,675,9034348,951930,158,6755,86667.0,14444.0,-72.0,-68.0,-73.0,-72.0,-72.0,-67.0,-73.0,-72.0,-87.0,-93.0,-88.0,-92.0,15.0,25.0,15.0,20.0,1
3026,3C:55:76:E8:8F:1F,3236944,421599187,5367,13448337,3231577,408150850,0,2861,453181,2712,425854,149,27327,1063,4,5390,874,0,75,270830.0,162500.0,-52.0,-53.0,-45.0,-50.0,-51.0,-51.0,-47.0,-50.0,-87.0,-93.0,-88.0,-92.0,35.0,40.0,43.0,42.0,1
3027,92:69:1D:31:68:E9,3265090,480478838,33513,72327988,3231577,408150850,0,14389,4430904,14241,4406693,148,24211,9180,1,33559,2975,0,164,229410.0,137640.0,-56.0,-50.0,-44.0,-51.0,-51.0,-50.0,-44.0,-49.0,-87.0,-93.0,-88.0,-92.0,31.0,43.0,44.0,41.0,1
3028,BA:8C:B9:54:50:24,3277412,511617644,45833,103466592,3231579,408151052,64,16148,4826633,15997,4801836,151,24797,9970,6,45816,11200,64,243,206470.0,97500.0,-54.0,-51.0,-38.0,-46.0,-50.0,-50.0,-40.0,-45.0,-87.0,-93.0,-88.0,-92.0,33.0,42.0,50.0,46.0,1
3029,62:47:05:9D:EB:15,3253456,460825930,21877,52674878,3231579,408151052,64,9570,1821509,9477,1806003,93,15506,4192,1,21861,2872,64,246,229410.0,137640.0,-43.0,-50.0,-44.0,-45.0,-42.0,-47.0,-43.0,-40.0,-87.0,-93.0,-88.0,-92.0,44.0,43.0,44.0,47.0,1
3030,F8:59:71:5A:E0:3D,3511815,831418471,280236,423267419,3231579,408151052,4,279749,381645356,274819,381056430,4930,588926,255756,20,282992,7398,4,869,130000.0,39000.0,-66.0,-73.0,-65.0,-71.0,-66.0,-74.0,-66.0,-71.0,-87.0,-93.0,-88.0,-92.0,21.0,20.0,23.0,21.0,1
3031,CC:2F:71:3E:C5:1F,3243143,409565605,11564,1414553,3231579,408151052,6,49308,4130087,40737,3114555,8571,1015532,12192,36,16570,191,6,858,130000.0,39000.0,-69.0,-72.0,-68.0,-60.0,-67.0,-71.0,-67.0,-60.0,-87.0,-93.0,-88.0,-92.0,18.0,21.0,20.0,32.0,1
3032,CC:2F:71:3F:1F:24,12262511,14256475232,9030932,13848324180,3231579,408151052,158,2063760,1220236825,2055034,1219188231,8726,1048594,1997570,675,9035765,952079,158,6755,86667.0,14444.0,-69.0,-64.0,-71.0,-69.0,-69.0,-64.0,-70.0,-69.0,-87.0,-93.0,-88.0,-92.0,18.0,29.0,17.0,23.0,1
3033,3C:55:76:E8:8F:1F,3236951,421599917,5368,13448461,3231583,408151456,0,2878,454377,2729,427050,149,27327,1064,4,5391,874,0,75,270830.0,162500.0,-48.0,-52.0,-48.0,-51.0,-48.0,-51.0,-47.0,-50.0,-87.0,-93.0,-88.0,-92.0,39.0,41.0,40.0,41.0,1
3034,92:69:1D:31:68:E9,3265096,480479444,33513,72327988,3231583,408151456,0,14389,4430904,14241,4406693,148,24211,9180,1,33559,2975,0,164,229410.0,137640.0,-56.0,-50.0,-44.0,-51.0,-51.0,-50.0,-44.0,-49.0,-87.0,-93.0,-88.0,-92.0,31.0,43.0,44.0,41.0,1
3035,BA:8C:B9:54:50:24,3277416,511618048,45833,103466592,3231583,408151456,64,16148,4826633,15997,4801836,151,24797,9970,6,45816,11200,64,243,206470.0,97500.0,-54.0,-51.0,-38.0,-46.0,-50.0,-50.0,-40.0,-45.0,-87.0,-93.0,-88.0,-92.0,33.0,42.0,50.0,46.0,1
3036,62:47:05:9D:EB:15,3253460,460826334,21877,52674878,3231583,408151456,64,9570,1821509,9477,1806003,93,15506,4192,1,21861,2872,64,246,229410.0,137640.0,-43.0,-50.0,-44.0,-45.0,-42.0,-47.0,-43.0,-40.0,-87.0,-93.0,-88.0,-92.0,44.0,43.0,44.0,47.0,1
3037,F8:59:71:5A:E0:3D,3511821,831419077,280236,423267419,3231585,408151658,4,279749,381645356,274819,381056430,4930,588926,255756,20,282992,7398,4,869,130000.0,39000.0,-66.0,-73.0,-65.0,-71.0,-66.0,-74.0,-66.0,-71.0,-87.0,-93.0,-88.0,-92.0,21.0,20.0,23.0,21.0,1
3038,CC:2F:71:3E:C5:1F,3243153,409566737,11564,1414553,3231589,408152184,6,49308,4130087,40737,3114555,8571,1015532,12192,36,16570,191,6,858,130000.0,39000.0,-69.0,-72.0,-68.0,-60.0,-67.0,-71.0,-67.0,-60.0,-87.0,-93.0,-88.0,-92.0,18.0,21.0,20.0,32.0,1
3039,CC:2F:71:3F:1F:24,12264514,14259518541,9032925,13851366357,3231589,408152184,158,2064152,1220289982,2055426,1219241388,8726,1048594,1997960,675,9037758,952301,158,6755,86667.0,14444.0,-69.0,-65.0,-70.0,-69.0,-69.0,-64.0,-70.0,-69.0,-87.0,-93.0,-88.0,-92.0,18.0,28.0,18.0,23.0,1
3040,3C:55:76:E8:8F:1F,3238590,425925459,6997,17772871,3231593,408152588,0,3250,509199,3101,481872,149,27327,1181,4,7020,1093,0,76,286760.0,172050.0,-49.0,-52.0,-49.0,-51.0,-50.0,-52.0,-47.0,-51.0,-87.0,-93.0,-88.0,-92.0,38.0,41.0,39.0,41.0,1
3041,92:69:1D:31:68:E9,3265106,480480576,33513,72327988,3231593,408152588,0,14389,4430904,14241,4406693,148,24211,9180,1,33559,2975,0,164,229410.0,137640.0,-56.0,-50.0,-44.0,-51.0,-51.0,-50.0,-44.0,-49.0,-87.0,-93.0,-88.0,-92.0,31.0,43.0,44.0,41.0,1
3042,BA:8C:B9:54:50:24,3277426,511619180,45833,103466592,3231593,408152588,64,16149,4826701,15998,4801904,151,24797,9970,6,45816,11200,64,243,206470.0,97500.0,-47.0,-50.0,-54.0,-46.0,-49.0,-50.0,-40.0,-45.0,-87.0,-93.0,-88.0,-92.0,40.0,43.0,34.0,46.0,1
3043,62:47:05:9D:EB:15,3253833,461790509,22240,53637921,3231593,408152588,64,9629,1830081,9536,1814575,93,15506,4219,1,22224,2878,64,246,229410.0,137640.0,-46.0,-51.0,-47.0,-46.0,-44.0,-50.0,-45.0,-43.0,-87.0,-93.0,-88.0,-92.0,41.0,42.0,41.0,46.0,1
3044,F8:59:71:5A:E0:3D,3511829,831420007,280236,423267419,3231593,408152588,4,279749,381645356,274819,381056430,4930,588926,255756,20,282992,7398,4,869,130000.0,39000.0,-66.0,-73.0,-65.0,-71.0,-66.0,-74.0,-66.0,-71.0,-87.0,-93.0,-88.0,-92.0,21.0,20.0,23.0,21.0,1
3045,CC:2F:71:3E:C5:1F,3243157,409567141,11564,1414553,3231593,408152588,6,49308,4130087,40737,3114555,8571,1015532,12192,36,16570,191,6,858,130000.0,39000.0,-69.0,-72.0,-68.0,-60.0,-67.0,-71.0,-67.0,-60.0,-87.0,-93.0,-88.0,-92.0,18.0,21.0,20.0,32.0,1
3046,CC:2F:71:3F:1F:24,12266120,14261972109,9034527,13853819521,3231593,408152588,158,2064498,1220333108,2055772,1219284514,8726,1048594,1998289,675,9039360,952363,158,6755,86667.0,14444.0,-68.0,-64.0,-70.0,-69.0,-68.0,-64.0,-70.0,-69.0,-87.0,-93.0,-88.0,-92.0,19.0,29.0,18.0,23.0,1
3047,3C:55:76:E8:8F:1F,3238596,425926108,6997,17772871,3231599,408153237,0,3250,509199,3101,481872,149,27327,1181,4,7020,1093,0,76,286760.0,172050.0,-49.0,-52.0,-49.0,-51.0,-50.0,-52.0,-47.0,-51.0,-87.0,-93.0,-88.0,-92.0,38.0,41.0,39.0,41.0,1
3048,92:69:1D:31:68:E9,3265116,480481555,33513,72327988,3231603,408153567,0,14389,4430904,14241,4406693,148,24211,9180,1,33559,2975,0,164,229410.0,137640.0,-56.0,-50.0,-44.0,-51.0,-51.0,-50.0,-44.0,-49.0,-87.0,-93.0,-88.0,-92.0,31.0,43.0,44.0,41.0,1
3049,BA:8C:B9:54:50:24,3277436,511620159,45833,103466592,3231603,408153567,64,16149,4826701,15998,4801904,151,24797,9970,6,45816,11200,64,243,206470.0,97500.0,-47.0,-50.0,-54.0,-46.0,-49.0,-50.0,-40.0,-45.0,-87.0,-93.0,-88.0,-92.0,40.0,43.0,34.0,46.0,1
3050,62:47:05:9D:EB:15,3253843,461791488,22240,53637921,3231603,408153567,64,9653,1831816,9559,1816139,94,15677,4220,1,22224,2878,64,246,229410.0,137640.0,-52.0,-49.0,-50.0,-41.0,-47.0,-51.0,-47.0,-45.0,-87.0,-93.0,-88.0,-92.0,35.0,44.0,38.0,51.0,1
3051,F8:59:71:5A:E0:3D,3511840,831421140,280237,423267573,3231603,408153567,4,279751,381645566,274821,381056640,4930,588926,255757,20,282993,7398,4,869,130000.0,39000.0,-66.0,-72.0,-65.0,-71.0,-67.0,-74.0,-66.0,-71.0,-87.0,-93.0,-88.0,-92.0,21.0,21.0,23.0,21.0,1
3052,CC:2F:71:3E:C5:1F,3243167,409568120,11564,1414553,3231603,408153567,6,49308,4130087,40737,3114555,8571,1015532,12192,36,16570,191,6,858,130000.0,39000.0,-69.0,-72.0,-68.0,-60.0,-67.0,-71.0,-67.0,-60.0,-87.0,-93.0,-88.0,-92.0,18.0,21.0,20.0,32.0,1
3053,CC:2F:71:3F:1F:24,12267747,14264439114,9036144,13856285547,3231603,408153567,158,2064856,1220377653,2056130,1219329059,8726,1048594,1998626,675,9040977,952611,158,6755,65000.0,13000.0,-69.0,-64.0,-69.0,-70.0,-69.0,-64.0,-68.0,-69.0,-87.0,-93.0,-88.0,-92.0,18.0,29.0,19.0,22.0,1
3054,3C:55:76:E8:8F:1F,3238606,425927268,7001,17773499,3231605,408153769,0,3277,511237,3128,483910,149,27327,1185,4,7024,1093,0,76,286760.0,172050.0,-62.0,-54.0,-46.0,-53.0,-52.0,-51.0,-45.0,-50.0,-87.0,-93.0,-88.0,-92.0,25.0,39.0,42.0,39.0,1
3055,92:69:1D:31:68:E9,3265120,480481959,33513,72327988,3231607,408153971,0,14389,4430904,14241,4406693,148,24211,9180,1,33559,2975,0,164,229410.0,137640.0,-56.0,-50.0,-44.0,-51.0,-51.0,-50.0,-44.0,-49.0,-87.0,-93.0,-88.0,-92.0,31.0,43.0,44.0,41.0,1
3056,BA:8C:B9:54:50:24,3277440,511620563,45833,103466592,3231607,408153971,64,16149,4826701,15998,4801904,151,24797,9970,6,45816,11200,64,243,206470.0,97500.0,-47.0,-50.0,-54.0,-46.0,-49.0,-50.0,-40.0,-45.0,-87.0,-93.0,-88.0,-92.0,40.0,43.0,34.0,46.0,1
3057,62:47:05:9D:EB:15,3253847,461791892,22240,53637921,3231607,408153971,64,9653,1831816,9559,1816139,94,15677,4220,1,22224,2878,64,246,229410.0,137640.0,-52.0,-49.0,-50.0,-41.0,-47.0,-51.0,-47.0,-45.0,-87.0,-93.0,-88.0,-92.0,35.0,44.0,38.0,51.0,1
3058,F8:59:71:5A:E0:3D,3511844,831421544,280237,423267573,3231607,408153971,4,279751,381645566,274821,381056640,4930,588926,255757,20,282993,7398,4,869,130000.0,39000.0,-66.0,-72.0,-65.0,-71.0,-67.0,-74.0,-66.0,-71.0,-87.0,-93.0,-88.0,-92.0,21.0,21.0,23.0,21.0,1
3059,CC:2F:71:3E:C5:1F,3243171,409568524,11564,1414553,3231607,408153971,6,49308,4130087,40737,3114555,8571,1015532,12192,36,16570,191,6,858,130000.0,39000.0,-69.0,-72.0,-68.0,-60.0,-67.0,-71.0,-67.0,-60.0,-87.0,-93.0,-88.0,-92.0,18.0,21.0,20.0,32.0,1
3060,CC:2F:71:3F:1F:24,12270179,14268198934,9038572,13860044963,3231607,408153971,158,2065306,1220432545,2056580,1219383951,8726,1048594,1999067,675,9043389,952630,158,6755,86667.0,14444.0,-69.0,-64.0,-69.0,-69.0,-69.0,-64.0,-69.0,-69.0,-87.0,-93.0,-88.0,-92.0,18.0,29.0,19.0,23.0,1
3061,3C:55:76:E8:8F:1F,3238617,425928499,7005,17774064,3231612,408154435,0,3290,513389,3141,486062,149,27327,1188,4,7029,1101,0,76,286760.0,1000.0,-49.0,-51.0,-43.0,-49.0,-51.0,-52.0,-44.0,-50.0,-87.0,-93.0,-88.0,-92.0,38.0,42.0,45.0,43.0,1
3062,92:69:1D:31:68:E9,3265125,480482423,33513,72327988,3231612,408154435,0,14390,4430972,14242,4406761,148,24211,9180,1,33559,2975,0,164,229410.0,137640.0,-54.0,-51.0,-45.0,-51.0,-51.0,-50.0,-44.0,-50.0,-87.0,-93.0,-88.0,-92.0,33.0,42.0,43.0,41.0,1
3063,BA:8C:B9:54:50:24,3277445,511621027,45833,103466592,3231612,408154435,64,16149,4826701,15998,4801904,151,24797,9970,6,45816,11200,64,243,206470.0,97500.0,-47.0,-50.0,-54.0,-46.0,-49.0,-50.0,-40.0,-45.0,-87.0,-93.0,-88.0,-92.0,40.0,43.0,34.0,46.0,1
3064,62:47:05:9D:EB:15,3253852,461792356,22240,53637921,3231612,408154435,64,9653,1831816,9559,1816139,94,15677,4220,1,22224,2878,64,246,229410.0,137640.0,-52.0,-49.0,-50.0,-41.0,-47.0,-51.0,-47.0,-45.0,-87.0,-93.0,-88.0,-92.0,35.0,44.0,38.0,51.0,1
3065,F8:59:71:5A:E0:3D,3511849,831422008,280237,423267573,3231612,408154435,4,279751,381645566,274821,381056640,4930,588926,255757,20,282993,7398,4,869,130000.0,39000.0,-66.0,-72.0,-65.0,-71.0,-67.0,-74.0,-66.0,-71.0,-87.0,-93.0,-88.0,-92.0,21.0,21.0,23.0,21.0,1
3066,CC:2F:71:3E:C5:1F,3243178,409569190,11564,1414553,3231614,408154637,6,49308,4130087,40737,3114555,8571,1015532,12192,36,16570,191,6,858,130000.0,39000.0,-69.0,-72.0,-68.0,-60.0,-67.0,-71.0,-67.0,-60.0,-87.0,-93.0,-88.0,-92.0,18.0,21.0,20.0,32.0,1
3067,CC:2F:71:3F:1F:24,12271398,14270037512,9039784,13861882875,3231614,408154637,158,2065560,1220464737,2056834,1219416143,8726,1048594,1999319,675,9044617,952795,158,6755,86667.0,14444.0,-69.0,-64.0,-69.0,-69.0,-69.0,-64.0,-69.0,-69.0,-87.0,-93.0,-88.0,-92.0,18.0,29.0,19.0,23.0,1
3068,3C:55:76:E8:8F:1F,3238623,425929105,7005,17774064,3231618,408155041,0,3290,513389,3141,486062,149,27327,1188,4,7029,1101,0,76,286760.0,1000.0,-49.0,-51.0,-43.0,-49.0,-51.0,-52.0,-44.0,-50.0,-87.0,-93.0,-88.0,-92.0,38.0,42.0,45.0,43.0,1
3069,92:69:1D:31:68:E9,3265131,480483029,33513,72327988,3231618,408155041,0,14390,4430972,14242,4406761,148,24211,9180,1,33559,2975,0,164,229410.0,137640.0,-54.0,-51.0,-45.0,-51.0,-51.0,-50.0,-44.0,-50.0,-87.0,-93.0,-88.0,-92.0,33.0,42.0,43.0,41.0,1
3070,BA:8C:B9:54:50:24,3277453,511621835,45833,103466592,3231620,408155243,64,16149,4826701,15998,4801904,151,24797,9970,6,45816,11200,64,243,206470.0,97500.0,-47.0,-50.0,-54.0,-46.0,-49.0,-50.0,-40.0,-45.0,-87.0,-93.0,-88.0,-92.0,40.0,43.0,34.0,46.0,1
3071,62:47:05:9D:EB:15,3253861,461793437,22240,53637921,3231621,408155516,64,9653,1831816,9559,1816139,94,15677,4220,1,22224,2878,64,246,229410.0,137640.0,-52.0,-49.0,-50.0,-41.0,-47.0,-51.0,-47.0,-45.0,-87.0,-93.0,-88.0,-92.0,35.0,44.0,38.0,51.0,1
3072,F8:59:71:5A:E0:3D,3511858,831423089,280237,423267573,3231621,408155516,4,279751,381645566,274821,381056640,4930,588926,255757,20,282993,7398,4,869,130000.0,39000.0,-66.0,-72.0,-65.0,-71.0,-67.0,-74.0,-66.0,-71.0,-87.0,-93.0,-88.0,-92.0,21.0,21.0,23.0,21.0,1
3073,CC:2F:71:3E:C5:1F,3243185,409570069,11564,1414553,3231621,408155516,6,49308,4130087,40737,3114555,8571,1015532,12192,36,16570,191,6,858,130000.0,39000.0,-69.0,-72.0,-68.0,-60.0,-67.0,-71.0,-67.0,-60.0,-87.0,-93.0,-88.0,-92.0,18.0,21.0,20.0,32.0,1
3074,CC:2F:71:3F:1F:24,12272461,14271627139,9040840,13863471623,3231621,408155516,158,2065839,1220500382,2057113,1219451788,8726,1048594,1999576,675,9045673,952814,158,6755,65000.0,13000.0,-68.0,-64.0,-68.0,-69.0,-68.0,-64.0,-69.0,-69.0,-87.0,-93.0,-88.0,-92.0,19.0,29.0,20.0,23.0,1
3075,3C:55:76:E8:8F:1F,3238630,425929984,7005,17774064,3231625,408155920,0,3290,513389,3141,486062,149,27327,1188,4,7029,1101,0,76,286760.0,1000.0,-49.0,-51.0,-43.0,-49.0,-51.0,-52.0,-44.0,-50.0,-87.0,-94.0,-88.0,-92.0,38.0,43.0,45.0,43.0,1
3076,92:69:1D:31:68:E9,3265139,480483968,33513,72327988,3231626,408155980,0,14393,4431176,14245,4406965,148,24211,9180,1,33559,2975,0,164,229410.0,137640.0,-53.0,-52.0,-46.0,-51.0,-52.0,-50.0,-45.0,-50.0,-87.0,-94.0,-88.0,-92.0,34.0,42.0,42.0,41.0,1
3077,BA:8C:B9:54:50:24,3277459,511622572,45833,103466592,3231626,408155980,64,16149,4826701,15998,4801904,151,24797,9970,6,45816,11200,64,243,206470.0,97500.0,-47.0,-50.0,-54.0,-46.0,-49.0,-50.0,-40.0,-45.0,-87.0,-94.0,-88.0,-92.0,40.0,44.0,34.0,46.0,1
3078,62:47:05:9D:EB:15,3253867,461794017,22241,53638037,3231626,408155980,64,9678,1833554,9584,1817877,94,15677,4221,1,22225,2878,64,246,229410.0,137640.0,-43.0,-50.0,-43.0,-44.0,-42.0,-48.0,-43.0,-41.0,-87.0,-94.0,-88.0,-92.0,44.0,44.0,45.0,48.0,1
3079,F8:59:71:5A:E0:3D,3511863,831423553,280237,423267573,3231626,408155980,4,279751,381645566,274821,381056640,4930,588926,255757,20,282993,7398,4,869,130000.0,39000.0,-66.0,-72.0,-65.0,-71.0,-67.0,-74.0,-66.0,-71.0,-87.0,-94.0,-88.0,-92.0,21.0,22.0,23.0,21.0,1
3080,CC:2F:71:3E:C5:1F,3243190,409570533,11564,1414553,3231626,408155980,6,49308,4130087,40737,3114555,8571,1015532,12192,36,16570,191,6,858,130000.0,39000.0,-69.0,-72.0,-68.0,-60.0,-67.0,-71.0,-67.0,-60.0,-87.0,-94.0,-88.0,-92.0,18.0,22.0,20.0,32.0,1
3081,CC:2F:71:3F:1F:24,12274250,14274369003,9042624,13866213023,3231626,408155980,158,2066233,1220548666,2057507,1219500072,8726,1048594,1999955,675,9047457,952989,158,6755,86667.0,14444.0,-69.0,-64.0,-70.0,-69.0,-68.0,-64.0,-69.0,-69.0,-87.0,-94.0,-88.0,-92.0,18.0,30.0,18.0,23.0,1
3082,3C:55:76:E8:8F:1F,3238635,425930448,7005,17774064,3231630,408156384,0,3290,513389,3141,486062,149,27327,1188,4,7029,1101,0,76,286760.0,1000.0,-49.0,-51.0,-43.0,-49.0,-51.0,-52.0,-44.0,-50.0,-87.0,-94.0,-88.0,-92.0,38.0,43.0,45.0,43.0,1
3083,92:69:1D:31:68:E9,3265143,480484372,33513,72327988,3231630,408156384,0,14393,4431176,14245,4406965,148,24211,9180,1,33559,2975,0,164,229410.0,137640.0,-53.0,-52.0,-46.0,-51.0,-52.0,-50.0,-45.0,-50.0,-87.0,-94.0,-88.0,-92.0,34.0,42.0,42.0,41.0,1
3084,BA:8C:B9:54:50:24,3277463,511622976,45833,103466592,3231630,408156384,64,16149,4826701,15998,4801904,151,24797,9970,6,45816,11200,64,243,206470.0,97500.0,-47.0,-50.0,-54.0,-46.0,-49.0,-50.0,-40.0,-45.0,-87.0,-94.0,-88.0,-92.0,40.0,44.0,34.0,46.0,1
3085,62:47:05:9D:EB:15,3253871,461794421,22241,53638037,3231630,408156384,64,9678,1833554,9584,1817877,94,15677,4221,1,22225,2878,64,246,229410.0,137640.0,-43.0,-50.0,-43.0,-44.0,-42.0,-48.0,-43.0,-41.0,-87.0,-94.0,-88.0,-92.0,44.0,44.0,45.0,48.0,1
3086,F8:59:71:5A:E0:3D,3511868,831424073,280238,423267689,3231630,408156384,4,279753,381645742,274823,381056816,4930,588926,255758,20,282994,7398,4,869,130000.0,39000.0,-64.0,-63.0,-63.0,-67.0,-65.0,-71.0,-64.0,-70.0,-87.0,-94.0,-88.0,-92.0,23.0,31.0,25.0,25.0,1
3087,CC:2F:71:3E:C5:1F,3243194,409570937,11564,1414553,3231630,408156384,6,49308,4130087,40737,3114555,8571,1015532,12192,36,16570,191,6,858,130000.0,39000.0,-69.0,-72.0,-68.0,-60.0,-67.0,-71.0,-67.0,-60.0,-87.0,-94.0,-88.0,-92.0,18.0,22.0,20.0,32.0,1
3088,CC:2F:71:3F:1F:24,12276122,14277243681,9044492,13869087297,3231630,408156384,158,2066631,1220597696,2057905,1219549102,8726,1048594,2000326,675,9049325,952996,158,6755,86667.0,14444.0,-68.0,-64.0,-69.0,-69.0,-67.0,-64.0,-68.0,-69.0,-87.0,-94.0,-88.0,-92.0,19.0,30.0,19.0,23.0,1
3089,3C:55:76:E8:8F:1F,3238645,425932604,7009,17775579,3231636,408157025,0,3317,515445,3167,488000,150,27445,1192,4,7033,1101,0,77,286760.0,172050.0,-64.0,-54.0,-47.0,-55.0,-50.0,-52.0,-48.0,-52.0,-86.0,-93.0,-87.0,-92.0,22.0,39.0,40.0,37.0,1
3090,92:69:1D:31:68:E9,3265151,480485189,33514,72328104,3231637,408157085,0,14395,4431312,14247,4407101,148,24211,9180,1,33560,2975,0,164,216660.0,130000.0,-52.0,-53.0,-52.0,-55.0,-53.0,-51.0,-45.0,-51.0,-86.0,-93.0,-87.0,-92.0,34.0,40.0,35.0,37.0,1
3091,BA:8C:B9:54:50:24,3277472,511623855,45834,103466708,3231638,408157147,64,16153,4826973,16002,4802176,151,24797,9970,6,45817,11200,64,243,206470.0,103230.0,-54.0,-51.0,-38.0,-46.0,-51.0,-50.0,-40.0,-45.0,-86.0,-93.0,-87.0,-92.0,32.0,42.0,49.0,46.0,1
3092,62:47:05:9D:EB:15,3253884,461795870,22242,53638153,3231642,408157717,64,9705,1835611,9609,1819577,96,16034,4223,1,22226,2878,64,246,229410.0,137640.0,-47.0,-52.0,-47.0,-46.0,-47.0,-52.0,-47.0,-46.0,-86.0,-93.0,-87.0,-92.0,39.0,41.0,40.0,46.0,1
3093,F8:59:71:5A:E0:3D,3511884,831425840,280240,423267921,3231644,408157919,4,279756,381645988,274826,381057062,4930,588926,255759,20,282996,7398,4,869,130000.0,39000.0,-65.0,-73.0,-64.0,-71.0,-66.0,-72.0,-65.0,-70.0,-86.0,-93.0,-87.0,-92.0,21.0,20.0,23.0,21.0,1
3094,CC:2F:71:3E:C5:1F,3243209,409572588,11565,1414669,3231644,408157919,6,49310,4130227,40739,3114695,8571,1015532,12192,36,16571,191,6,858,130000.0,39000.0,-67.0,-72.0,-68.0,-60.0,-67.0,-71.0,-66.0,-60.0,-86.0,-93.0,-87.0,-92.0,19.0,21.0,19.0,32.0,1
3095,CC:2F:71:3F:1F:24,12277718,14279664854,9046074,13871506935,3231644,408157919,158,2066970,1220640162,2058244,1219591568,8726,1048594,2000650,675,9050901,953222,158,6755,86667.0,14444.0,-67.0,-64.0,-69.0,-70.0,-67.0,-64.0,-68.0,-69.0,-86.0,-93.0,-87.0,-92.0,19.0,29.0,18.0,22.0,1
3096,3C:55:76:E8:8F:1F,3238653,425933498,7009,17775579,3231644,408157919,0,3317,515445,3167,488000,150,27445,1192,4,7033,1101,0,77,286760.0,172050.0,-64.0,-54.0,-47.0,-55.0,-50.0,-52.0,-48.0,-52.0,-86.0,-93.0,-87.0,-92.0,22.0,39.0,40.0,37.0,1
3097,92:69:1D:31:68:E9,3265158,480486023,33514,72328104,3231644,408157919,0,14395,4431312,14247,4407101,148,24211,9180,1,33560,2975,0,164,216660.0,130000.0,-52.0,-53.0,-52.0,-55.0,-53.0,-51.0,-45.0,-51.0,-86.0,-93.0,-87.0,-92.0,34.0,40.0,35.0,37.0,1
3098,BA:8C:B9:54:50:24,3277482,511625031,45834,103466708,3231648,408158323,64,16153,4826973,16002,4802176,151,24797,9970,6,45817,11200,64,243,206470.0,103230.0,-54.0,-51.0,-38.0,-46.0,-51.0,-50.0,-40.0,-45.0,-86.0,-93.0,-87.0,-92.0,32.0,42.0,49.0,46.0,1
3099,62:47:05:9D:EB:15,3253890,461796476,22242,53638153,3231648,408158323,64,9715,1836291,9619,1820257,96,16034,4223,1,22226,2878,64,246,229410.0,137640.0,-44.0,-51.0,-44.0,-46.0,-46.0,-52.0,-47.0,-46.0,-86.0,-93.0,-87.0,-92.0,42.0,42.0,43.0,46.0,1
3100,F8:59:71:5A:E0:3D,3511888,831426244,280240,423267921,3231648,408158323,4,279756,381645988,274826,381057062,4930,588926,255759,20,282996,7398,4,869,130000.0,39000.0,-65.0,-73.0,-64.0,-71.0,-66.0,-72.0,-65.0,-70.0,-86.0,-93.0,-87.0,-92.0,21.0,20.0,23.0,21.0,1
3101,CC:2F:71:3E:C5:1F,3243213,409572992,11565,1414669,3231648,408158323,6,49310,4130227,40739,3114695,8571,1015532,12192,36,16571,191,6,858,130000.0,39000.0,-67.0,-72.0,-68.0,-60.0,-67.0,-71.0,-66.0,-60.0,-86.0,-93.0,-87.0,-92.0,19.0,21.0,19.0,32.0,1
3102,CC:2F:71:3F:1F:24,12279449,14282216389,9047801,13874058066,3231648,408158323,158,2067446,1220703684,2058720,1219655090,8726,1048594,2001105,675,9052634,953241,158,6755,86667.0,14444.0,-68.0,-64.0,-69.0,-69.0,-67.0,-64.0,-68.0,-69.0,-86.0,-93.0,-87.0,-92.0,18.0,29.0,18.0,23.0,1
3103,3C:55:76:E8:8F:1F,3238665,425935506,7012,17776717,3231653,408158789,0,3336,517220,3186,489775,150,27445,1197,4,7036,1101,0,78,286760.0,172050.0,-50.0,-53.0,-49.0,-52.0,-53.0,-52.0,-47.0,-52.0,-85.0,-93.0,-86.0,-91.0,35.0,40.0,37.0,39.0,1
3104,92:69:1D:31:68:E9,3265536,481446667,33883,73287878,3231653,408158789,0,14441,4442633,14292,4418300,149,24333,9217,1,33929,3059,0,164,229410.0,130000.0,-54.0,-51.0,-44.0,-51.0,-51.0,-50.0,-45.0,-48.0,-85.0,-93.0,-86.0,-91.0,31.0,42.0,42.0,40.0,1
3105,BA:8C:B9:54:50:24,3277487,511625497,45834,103466708,3231653,408158789,64,16153,4826973,16002,4802176,151,24797,9970,6,45817,11200,64,243,206470.0,103230.0,-54.0,-51.0,-38.0,-46.0,-51.0,-50.0,-40.0,-45.0,-85.0,-93.0,-86.0,-91.0,31.0,42.0,48.0,45.0,1
3106,62:47:05:9D:EB:15,3253896,461797002,22242,53638153,3231654,408158849,64,9715,1836291,9619,1820257,96,16034,4223,1,22226,2878,64,246,229410.0,137640.0,-44.0,-51.0,-44.0,-46.0,-46.0,-52.0,-47.0,-46.0,-85.0,-93.0,-86.0,-91.0,41.0,42.0,42.0,45.0,1
3107,F8:59:71:5A:E0:3D,3511894,831426770,280240,423267921,3231654,408158849,4,279756,381645988,274826,381057062,4930,588926,255759,20,282996,7398,4,869,130000.0,39000.0,-65.0,-73.0,-64.0,-71.0,-66.0,-72.0,-65.0,-70.0,-85.0,-93.0,-86.0,-91.0,20.0,20.0,22.0,20.0,1
3108,CC:2F:71:3E:C5:1F,3243219,409573518,11565,1414669,3231654,408158849,6,49310,4130227,40739,3114695,8571,1015532,12192,36,16571,191,6,858,130000.0,39000.0,-67.0,-72.0,-68.0,-60.0,-67.0,-71.0,-66.0,-60.0,-85.0,-93.0,-86.0,-91.0,18.0,21.0,18.0,31.0,1
3109,CC:2F:71:3F:1F:24,12281322,14284974733,9049668,13876815884,3231654,408158849,158,2067984,1220774293,2059258,1219725699,8726,1048594,2001623,675,9054501,953363,158,6755,86667.0,14444.0,-68.0,-64.0,-69.0,-69.0,-67.0,-63.0,-68.0,-69.0,-85.0,-93.0,-86.0,-91.0,17.0,29.0,17.0,22.0,1
3110,3C:55:76:E8:8F:1F,3238673,425936543,7015,17777290,3231658,408159253,0,3352,518310,3202,490865,150,27445,1197,4,7039,1101,0,78,286760.0,172050.0,-63.0,-54.0,-47.0,-54.0,-52.0,-52.0,-48.0,-51.0,-84.0,-93.0,-85.0,-91.0,21.0,39.0,38.0,37.0,1
3111,92:69:1D:31:68:E9,3265541,481447131,33883,73287878,3231658,408159253,0,14441,4442633,14292,4418300,149,24333,9217,1,33929,3059,0,164,229410.0,130000.0,-54.0,-51.0,-44.0,-51.0,-51.0,-50.0,-45.0,-48.0,-84.0,-93.0,-85.0,-91.0,30.0,42.0,41.0,40.0,1
3112,BA:8C:B9:54:50:24,3277492,511625961,45834,103466708,3231658,408159253,64,16153,4826973,16002,4802176,151,24797,9970,6,45817,11200,64,243,206470.0,103230.0,-54.0,-51.0,-38.0,-46.0,-51.0,-50.0,-40.0,-45.0,-84.0,-93.0,-85.0,-91.0,30.0,42.0,47.0,45.0,1
3113,62:47:05:9D:EB:15,3254264,462759945,22606,54600692,3231658,408159253,64,9753,1843880,9657,1827846,96,16034,4257,1,22590,2879,64,246,229410.0,130000.0,-43.0,-50.0,-44.0,-45.0,-46.0,-51.0,-47.0,-45.0,-84.0,-93.0,-85.0,-91.0,41.0,43.0,41.0,46.0,1
3114,F8:59:71:5A:E0:3D,3511898,831427174,280240,423267921,3231658,408159253,4,279756,381645988,274826,381057062,4930,588926,255759,20,282996,7398,4,869,130000.0,39000.0,-65.0,-73.0,-64.0,-71.0,-66.0,-72.0,-65.0,-70.0,-84.0,-93.0,-85.0,-91.0,19.0,20.0,21.0,20.0,1
3115,CC:2F:71:3E:C5:1F,3243223,409573922,11565,1414669,3231658,408159253,6,49310,4130227,40739,3114695,8571,1015532,12192,36,16571,191,6,858,130000.0,39000.0,-67.0,-72.0,-68.0,-60.0,-67.0,-71.0,-66.0,-60.0,-84.0,-93.0,-85.0,-91.0,17.0,21.0,17.0,31.0,1
3116,CC:2F:71:3F:1F:24,12282573,14286803816,9050915,13878644563,3231658,408159253,158,2068337,1220820417,2059611,1219771823,8726,1048594,2001963,675,9055744,953379,158,6755,86667.0,14444.0,-67.0,-64.0,-68.0,-69.0,-67.0,-64.0,-68.0,-69.0,-84.0,-93.0,-85.0,-91.0,17.0,29.0,17.0,22.0,1
3117,3C:55:76:E8:8F:1F,3238680,425937557,7018,17777900,3231662,408159657,0,3367,519336,3217,491891,150,27445,1197,4,7042,1101,0,79,286760.0,172050.0,-47.0,-49.0,-45.0,-50.0,-48.0,-51.0,-47.0,-50.0,-84.0,-93.0,-85.0,-91.0,37.0,44.0,40.0,41.0,1
3118,92:69:1D:31:68:E9,3265545,481447535,33883,73287878,3231662,408159657,0,14441,4442633,14292,4418300,149,24333,9217,1,33929,3059,0,164,229410.0,130000.0,-54.0,-51.0,-44.0,-51.0,-51.0,-50.0,-45.0,-48.0,-84.0,-93.0,-85.0,-91.0,30.0,42.0,41.0,40.0,1
3119,BA:8C:B9:54:50:24,3277496,511626365,45834,103466708,3231662,408159657,64,16153,4826973,16002,4802176,151,24797,9970,6,45817,11200,64,243,206470.0,103230.0,-54.0,-51.0,-38.0,-46.0,-51.0,-50.0,-40.0,-45.0,-84.0,-93.0,-85.0,-91.0,30.0,42.0,47.0,45.0,1
3120,62:47:05:9D:EB:15,3254268,462760349,22606,54600692,3231662,408159657,64,9753,1843880,9657,1827846,96,16034,4257,1,22590,2879,64,246,229410.0,130000.0,-43.0,-50.0,-44.0,-45.0,-46.0,-51.0,-47.0,-45.0,-84.0,-93.0,-85.0,-91.0,41.0,43.0,41.0,46.0,1
3121,F8:59:71:5A:E0:3D,3511905,831427840,280240,423267921,3231665,408159919,4,279756,381645988,274826,381057062,4930,588926,255759,20,282996,7398,4,869,130000.0,39000.0,-65.0,-73.0,-64.0,-71.0,-66.0,-72.0,-65.0,-70.0,-84.0,-93.0,-85.0,-91.0,19.0,20.0,21.0,20.0,1
3122,CC:2F:71:3E:C5:1F,3243232,409574790,11565,1414669,3231667,408160121,6,49310,4130227,40739,3114695,8571,1015532,12192,36,16571,191,6,858,130000.0,39000.0,-67.0,-72.0,-68.0,-60.0,-67.0,-71.0,-66.0,-60.0,-84.0,-93.0,-85.0,-91.0,17.0,21.0,17.0,31.0,1
3123,CC:2F:71:3F:1F:24,12284409,14289558179,9052741,13881397996,3231668,408160183,158,2068771,1220875948,2060045,1219827354,8726,1048594,2002383,675,9057574,953533,158,6755,86667.0,13000.0,-68.0,-64.0,-68.0,-69.0,-67.0,-64.0,-68.0,-69.0,-84.0,-93.0,-85.0,-91.0,16.0,29.0,17.0,22.0,1
3124,3C:55:76:E8:8F:1F,3238692,425938676,7020,17778167,3231672,408160509,0,3391,521096,3240,493533,151,27563,1200,4,7044,1101,0,81,286760.0,172050.0,-48.0,-49.0,-45.0,-50.0,-49.0,-50.0,-46.0,-50.0,-83.0,-93.0,-85.0,-90.0,35.0,44.0,40.0,40.0,1
3125,92:69:1D:31:68:E9,3265555,481448387,33883,73287878,3231672,408160509,0,14441,4442633,14292,4418300,149,24333,9217,1,33929,3059,0,164,229410.0,130000.0,-54.0,-51.0,-44.0,-51.0,-51.0,-50.0,-45.0,-48.0,-83.0,-93.0,-85.0,-90.0,29.0,42.0,41.0,39.0,1
3126,BA:8C:B9:54:50:24,3277508,511627419,45834,103466708,3231674,408160711,64,16153,4826973,16002,4802176,151,24797,9970,6,45817,11200,64,243,206470.0,103230.0,-54.0,-51.0,-38.0,-46.0,-51.0,-50.0,-40.0,-45.0,-83.0,-93.0,-85.0,-90.0,29.0,42.0,47.0,44.0,1
3127,62:47:05:9D:EB:15,3254280,462761403,22606,54600692,3231674,408160711,64,9753,1843880,9657,1827846,96,16034,4257,1,22590,2879,64,246,229410.0,130000.0,-43.0,-50.0,-44.0,-45.0,-46.0,-51.0,-47.0,-45.0,-83.0,-93.0,-85.0,-90.0,40.0,43.0,41.0,45.0,1
3128,F8:59:71:5A:E0:3D,3511914,831428632,280240,423267921,3231674,408160711,4,279758,381646176,274827,381057132,4931,589044,255760,20,282996,7398,4,869,130000.0,39000.0,-65.0,-73.0,-64.0,-71.0,-66.0,-72.0,-65.0,-70.0,-83.0,-93.0,-85.0,-90.0,18.0,20.0,21.0,19.0,1
3129,CC:2F:71:3E:C5:1F,3243250,409580804,11565,1414669,3231685,408166135,6,49310,4130227,40739,3114695,8571,1015532,12192,36,16571,191,6,858,130000.0,39000.0,-67.0,-72.0,-68.0,-60.0,-67.0,-71.0,-66.0,-60.0,-83.0,-93.0,-85.0,-90.0,16.0,21.0,17.0,30.0,1
3130,CC:2F:71:3F:1F:24,12285553,14291253944,9053868,13883087809,3231685,408166135,158,2069083,1220918322,2060356,1219869610,8727,1048712,2002685,675,9058701,953535,158,6755,86667.0,14444.0,-68.0,-64.0,-70.0,-70.0,-67.0,-63.0,-69.0,-69.0,-83.0,-93.0,-85.0,-90.0,15.0,29.0,15.0,20.0,1
3131,3C:55:76:E8:8F:1F,3238723,425950636,7023,17778673,3231700,408171963,0,3403,521950,3252,494387,151,27563,1201,4,7048,1107,0,81,286760.0,172050.0,-49.0,-51.0,-48.0,-52.0,-48.0,-51.0,-48.0,-51.0,-83.0,-92.0,-84.0,-90.0,34.0,41.0,36.0,38.0,1
3132,92:69:1D:31:68:E9,3265583,481459841,33883,73287878,3231700,408171963,0,14441,4442633,14292,4418300,149,24333,9217,1,33929,3059,0,164,229410.0,130000.0,-54.0,-51.0,-44.0,-51.0,-51.0,-50.0,-45.0,-48.0,-83.0,-92.0,-84.0,-90.0,29.0,41.0,40.0,39.0,1
3133,BA:8C:B9:54:50:24,3277534,511638671,45834,103466708,3231700,408171963,64,16153,4826973,16002,4802176,151,24797,9970,6,45817,11200,64,243,206470.0,103230.0,-54.0,-51.0,-38.0,-46.0,-51.0,-50.0,-40.0,-45.0,-83.0,-92.0,-84.0,-90.0,29.0,41.0,46.0,44.0,1
3134,62:47:05:9D:EB:15,3254306,462772655,22606,54600692,3231700,408171963,64,9753,1843880,9657,1827846,96,16034,4257,1,22590,2879,64,246,229410.0,130000.0,-43.0,-50.0,-44.0,-45.0,-46.0,-51.0,-47.0,-45.0,-83.0,-92.0,-84.0,-90.0,40.0,42.0,40.0,45.0,1
3135,F8:59:71:5A:E0:3D,3511941,831439944,280240,423267921,3231701,408172023,4,279758,381646176,274827,381057132,4931,589044,255760,20,282996,7398,4,869,130000.0,39000.0,-65.0,-73.0,-64.0,-71.0,-66.0,-72.0,-65.0,-70.0,-83.0,-92.0,-84.0,-90.0,18.0,19.0,20.0,19.0,1
3136,CC:2F:71:3E:C5:1F,3243266,409586692,11565,1414669,3231701,408172023,6,49310,4130227,40739,3114695,8571,1015532,12192,36,16571,191,6,858,130000.0,39000.0,-67.0,-72.0,-68.0,-60.0,-67.0,-71.0,-66.0,-60.0,-83.0,-92.0,-84.0,-90.0,16.0,20.0,16.0,30.0,1
3137,CC:2F:71:3F:1F:24,12287071,14293555186,9055370,13885383163,3231701,408172023,158,2069446,1220963710,2060719,1219914998,8727,1048712,2002997,675,9060203,953723,158,6755,86667.0,14444.0,-69.0,-64.0,-70.0,-70.0,-68.0,-64.0,-69.0,-70.0,-83.0,-92.0,-84.0,-90.0,14.0,28.0,14.0,20.0,1
3138,3C:55:76:E8:8F:1F,3238732,425951741,7027,17779314,3231705,408172427,0,3431,523894,3280,496331,151,27563,1202,4,7052,1107,0,81,286760.0,172050.0,-49.0,-52.0,-48.0,-51.0,-48.0,-51.0,-47.0,-51.0,-83.0,-92.0,-84.0,-90.0,34.0,40.0,36.0,39.0,1
3139,92:69:1D:31:68:E9,3265588,481460305,33883,73287878,3231705,408172427,0,14445,4442905,14296,4418572,149,24333,9217,1,33930,3059,0,164,229410.0,130000.0,-54.0,-51.0,-45.0,-51.0,-52.0,-51.0,-46.0,-50.0,-83.0,-92.0,-84.0,-90.0,29.0,41.0,39.0,39.0,1
3140,BA:8C:B9:54:50:24,3277539,511639135,45834,103466708,3231705,408172427,64,16154,4827041,16003,4802244,151,24797,9970,6,45818,11200,64,243,206470.0,103230.0,-47.0,-50.0,-54.0,-46.0,-50.0,-50.0,-42.0,-45.0,-83.0,-92.0,-84.0,-90.0,36.0,42.0,30.0,44.0,1
3141,62:47:05:9D:EB:15,3254313,462773321,22606,54600692,3231707,408172629,64,9753,1843880,9657,1827846,96,16034,4257,1,22590,2879,64,246,229410.0,130000.0,-43.0,-50.0,-44.0,-45.0,-46.0,-51.0,-47.0,-45.0,-83.0,-92.0,-84.0,-90.0,40.0,42.0,40.0,45.0,1
3142,F8:59:71:5A:E0:3D,3511949,831440752,280240,423267921,3231709,408172831,4,279758,381646176,274827,381057132,4931,589044,255760,20,282996,7398,4,869,130000.0,39000.0,-65.0,-73.0,-64.0,-71.0,-66.0,-72.0,-65.0,-70.0,-83.0,-92.0,-84.0,-90.0,18.0,19.0,20.0,19.0,1
3143,CC:2F:71:3E:C5:1F,3243274,409587500,11565,1414669,3231709,408172831,6,49312,4130367,40741,3114835,8571,1015532,12192,36,16572,191,6,858,130000.0,39000.0,-69.0,-72.0,-69.0,-60.0,-67.0,-71.0,-67.0,-60.0,-83.0,-92.0,-84.0,-90.0,14.0,20.0,15.0,30.0,1
3144,CC:2F:71:3F:1F:24,12289064,14296598043,9057354,13888424939,3231710,408173104,158,2069840,1221012422,2061113,1219963710,8727,1048712,2003391,675,9062166,953728,158,6755,86667.0,14444.0,-68.0,-64.0,-70.0,-70.0,-68.0,-64.0,-70.0,-70.0,-83.0,-92.0,-84.0,-90.0,15.0,28.0,14.0,20.0,1
3145,3C:55:76:E8:8F:1F,3238743,425953274,7031,17779968,3231712,408173306,0,3455,525698,3304,498135,151,27563,1205,4,7056,1107,0,81,286760.0,172050.0,-62.0,-54.0,-46.0,-53.0,-49.0,-51.0,-43.0,-49.0,-83.0,-91.0,-84.0,-90.0,21.0,37.0,38.0,37.0,1
3146,92:69:1D:31:68:E9,3265597,481461314,33883,73287878,3231714,408173436,0,14445,4442905,14296,4418572,149,24333,9217,1,33930,3059,0,164,229410.0,130000.0,-54.0,-51.0,-45.0,-51.0,-52.0,-51.0,-46.0,-50.0,-83.0,-91.0,-84.0,-90.0,29.0,40.0,39.0,39.0,1
3147,BA:8C:B9:54:50:24,3277550,511640338,45834,103466708,3231716,408173630,64,16155,4827109,16004,4802312,151,24797,9970,6,45818,11200,64,243,206470.0,103230.0,-47.0,-50.0,-54.0,-46.0,-49.0,-49.0,-44.0,-45.0,-83.0,-91.0,-84.0,-90.0,36.0,41.0,30.0,44.0,1
3148,62:47:05:9D:EB:15,3254322,462774322,22606,54600692,3231716,408173630,64,9753,1843880,9657,1827846,96,16034,4257,1,22590,2879,64,246,229410.0,130000.0,-43.0,-50.0,-44.0,-45.0,-46.0,-51.0,-47.0,-45.0,-83.0,-91.0,-84.0,-90.0,40.0,41.0,40.0,45.0,1
3149,F8:59:71:5A:E0:3D,3511957,831442222,280241,423268592,3231716,408173630,4,279760,381646396,274829,381057352,4931,589044,255761,20,282997,7398,4,869,130000.0,39000.0,-66.0,-73.0,-64.0,-71.0,-67.0,-74.0,-66.0,-71.0,-83.0,-91.0,-84.0,-90.0,17.0,18.0,20.0,19.0,1
3150,CC:2F:71:3E:C5:1F,3243281,409588299,11565,1414669,3231716,408173630,6,49312,4130367,40741,3114835,8571,1015532,12192,36,16572,191,6,858,130000.0,39000.0,-69.0,-72.0,-69.0,-60.0,-67.0,-71.0,-67.0,-60.0,-83.0,-91.0,-84.0,-90.0,14.0,19.0,15.0,30.0,1
3151,CC:2F:71:3F:1F:24,12291285,14300022815,9059569,13891849185,3231716,408173630,158,2070263,1221064098,2061536,1220015386,8727,1048712,2003810,675,9064402,953900,158,6755,86667.0,14444.0,-69.0,-64.0,-69.0,-70.0,-69.0,-64.0,-69.0,-69.0,-83.0,-91.0,-84.0,-90.0,14.0,27.0,15.0,20.0,1
3152,3C:55:76:E8:8F:1F,3238760,425955204,7039,17781108,3231721,408174096,0,3475,528293,3323,500612,152,27681,1213,4,7064,1111,0,82,270830.0,162500.0,-47.0,-52.0,-45.0,-50.0,-47.0,-51.0,-44.0,-49.0,-83.0,-91.0,-84.0,-90.0,36.0,39.0,39.0,40.0,1
3153,92:69:1D:31:68:E9,3265604,481461974,33883,73287878,3231721,408174096,0,14445,4442905,14296,4418572,149,24333,9217,1,33930,3059,0,164,229410.0,130000.0,-54.0,-51.0,-45.0,-51.0,-52.0,-51.0,-46.0,-50.0,-83.0,-91.0,-84.0,-90.0,29.0,40.0,39.0,39.0,1
3154,BA:8C:B9:54:50:24,3277555,511640804,45834,103466708,3231721,408174096,64,16155,4827109,16004,4802312,151,24797,9970,6,45818,11200,64,243,206470.0,103230.0,-47.0,-50.0,-54.0,-46.0,-49.0,-49.0,-44.0,-45.0,-83.0,-91.0,-84.0,-90.0,36.0,41.0,30.0,44.0,1
3155,62:47:05:9D:EB:15,3254327,462774788,22606,54600692,3231721,408174096,64,9753,1843880,9657,1827846,96,16034,4257,1,22590,2879,64,246,229410.0,130000.0,-43.0,-50.0,-44.0,-45.0,-46.0,-51.0,-47.0,-45.0,-83.0,-91.0,-84.0,-90.0,40.0,41.0,40.0,45.0,1
3156,F8:59:71:5A:E0:3D,3511963,831442799,280241,423268592,3231722,408174207,4,279760,381646396,274829,381057352,4931,589044,255761,20,282997,7398,4,869,130000.0,39000.0,-66.0,-73.0,-64.0,-71.0,-67.0,-74.0,-66.0,-71.0,-83.0,-91.0,-84.0,-90.0,17.0,18.0,20.0,19.0,1
3157,CC:2F:71:3E:C5:1F,3243287,409588876,11565,1414669,3231722,408174207,6,49314,4130555,40742,3114905,8572,1015650,12193,36,16572,191,6,858,130000.0,39000.0,-68.0,-72.0,-68.0,-60.0,-67.0,-71.0,-67.0,-60.0,-83.0,-91.0,-84.0,-90.0,15.0,19.0,16.0,30.0,1
3158,CC:2F:71:3F:1F:24,12292797,14302326572,9061075,13894152365,3231722,408174207,158,2070557,1221100630,2061830,1220051918,8727,1048712,2004100,675,9065908,953922,158,6755,86667.0,14444.0,-72.0,-67.0,-73.0,-73.0,-72.0,-67.0,-73.0,-73.0,-83.0,-91.0,-84.0,-90.0,11.0,24.0,11.0,17.0,1
3159,3C:55:76:E8:8F:1F,3238768,425956344,7041,17781473,3231727,408174871,0,3500,530373,3347,502376,153,27997,1216,4,7066,1111,0,84,270830.0,162500.0,-48.0,-51.0,-43.0,-49.0,-49.0,-51.0,-43.0,-48.0,-83.0,-91.0,-84.0,-90.0,35.0,40.0,41.0,41.0,1
3160,92:69:1D:31:68:E9,3265610,481462749,33883,73287878,3231727,408174871,0,14450,4443348,14300,4418844,150,24504,9218,1,33930,3059,0,164,229410.0,130000.0,-54.0,-52.0,-46.0,-51.0,-52.0,-51.0,-47.0,-51.0,-83.0,-91.0,-84.0,-90.0,29.0,39.0,38.0,39.0,1
3161,BA:8C:B9:54:50:24,3277561,511641579,45834,103466708,3231727,408174871,64,16155,4827109,16004,4802312,151,24797,9970,6,45818,11200,64,243,206470.0,103230.0,-47.0,-50.0,-54.0,-46.0,-49.0,-49.0,-44.0,-45.0,-83.0,-91.0,-84.0,-90.0,36.0,41.0,30.0,44.0,1
3162,62:47:05:9D:EB:15,3254333,462775563,22606,54600692,3231727,408174871,64,9753,1843880,9657,1827846,96,16034,4257,1,22590,2879,64,246,229410.0,130000.0,-43.0,-50.0,-44.0,-45.0,-46.0,-51.0,-47.0,-45.0,-83.0,-91.0,-84.0,-90.0,40.0,41.0,40.0,45.0,1
3163,F8:59:71:5A:E0:3D,3511971,831443725,280241,423268592,3231730,408175133,4,279760,381646396,274829,381057352,4931,589044,255761,20,282997,7398,4,869,130000.0,39000.0,-66.0,-73.0,-64.0,-71.0,-67.0,-74.0,-66.0,-71.0,-83.0,-91.0,-84.0,-90.0,17.0,18.0,20.0,19.0,1
3164,CC:2F:71:3E:C5:1F,3243295,409589802,11565,1414669,3231730,408175133,6,49314,4130555,40742,3114905,8572,1015650,12193,36,16572,191,6,858,130000.0,39000.0,-68.0,-72.0,-68.0,-60.0,-67.0,-71.0,-67.0,-60.0,-83.0,-91.0,-84.0,-90.0,15.0,19.0,16.0,30.0,1
3165,CC:2F:71:3F:1F:24,12294050,14304210293,9062318,13896034958,3231732,408175335,158,2070827,1221135149,2062100,1220086437,8727,1048712,2004369,675,9067151,953989,158,6755,86667.0,14444.0,-69.0,-64.0,-70.0,-70.0,-68.0,-63.0,-69.0,-69.0,-83.0,-91.0,-84.0,-90.0,14.0,27.0,14.0,20.0,1
3166,3C:55:76:E8:8F:1F,3238773,425956808,7041,17781473,3231732,408175335,0,3500,530373,3347,502376,153,27997,1216,4,7066,1111,0,84,270830.0,162500.0,-48.0,-51.0,-43.0,-49.0,-49.0,-51.0,-43.0,-48.0,-83.0,-91.0,-84.0,-90.0,35.0,40.0,41.0,41.0,1
3167,92:69:1D:31:68:E9,3265617,481463415,33883,73287878,3231734,408175537,0,14450,4443348,14300,4418844,150,24504,9218,1,33930,3059,0,164,229410.0,130000.0,-54.0,-52.0,-46.0,-51.0,-52.0,-51.0,-47.0,-51.0,-83.0,-91.0,-84.0,-90.0,29.0,39.0,38.0,39.0,1
3168,BA:8C:B9:54:50:24,3277568,511642245,45834,103466708,3231734,408175537,64,16155,4827109,16004,4802312,151,24797,9970,6,45818,11200,64,243,206470.0,103230.0,-47.0,-50.0,-54.0,-46.0,-49.0,-49.0,-44.0,-45.0,-83.0,-91.0,-84.0,-90.0,36.0,41.0,30.0,44.0,1
3169,62:47:05:9D:EB:15,3254340,462776229,22606,54600692,3231734,408175537,64,9753,1843880,9657,1827846,96,16034,4257,1,22590,2879,64,246,229410.0,130000.0,-43.0,-50.0,-44.0,-45.0,-46.0,-51.0,-47.0,-45.0,-83.0,-91.0,-84.0,-90.0,40.0,41.0,40.0,45.0,1
3170,F8:59:71:5A:E0:3D,3511977,831444331,280241,423268592,3231736,408175739,4,279760,381646396,274829,381057352,4931,589044,255761,20,282997,7398,4,869,130000.0,39000.0,-66.0,-73.0,-64.0,-71.0,-67.0,-74.0,-66.0,-71.0,-83.0,-91.0,-84.0,-90.0,17.0,18.0,20.0,19.0,1
3171,CC:2F:71:3E:C5:1F,3243301,409590408,11565,1414669,3231736,408175739,6,49314,4130555,40742,3114905,8572,1015650,12193,36,16572,191,6,858,130000.0,39000.0,-68.0,-72.0,-68.0,-60.0,-67.0,-71.0,-67.0,-60.0,-83.0,-91.0,-84.0,-90.0,15.0,19.0,16.0,30.0,1
3172,CC:2F:71:3F:1F:24,12295288,14306084757,9063552,13897909018,3231736,408175739,158,2071086,1221167439,2062359,1220118727,8727,1048712,2004627,675,9068385,954000,158,6755,86667.0,14444.0,-68.0,-64.0,-70.0,-70.0,-68.0,-64.0,-69.0,-69.0,-83.0,-91.0,-84.0,-90.0,15.0,27.0,14.0,20.0,1
3173,3C:55:76:E8:8F:1F,3238783,425957850,7042,17781647,3231741,408176203,0,3509,530989,3356,502992,153,27997,1216,4,7067,1111,0,84,270830.0,162500.0,-47.0,-51.0,-43.0,-48.0,-48.0,-49.0,-41.0,-47.0,-82.0,-90.0,-83.0,-89.0,35.0,39.0,40.0,41.0,1
3174,92:69:1D:31:68:E9,3266106,482730805,34365,74554602,3231741,408176203,0,14517,4455139,14367,4430635,150,24504,9272,1,34412,3059,0,164,229410.0,137640.0,-55.0,-49.0,-45.0,-51.0,-50.0,-49.0,-45.0,-49.0,-82.0,-90.0,-83.0,-89.0,27.0,41.0,38.0,38.0,1
3175,BA:8C:B9:54:50:24,3277575,511642911,45834,103466708,3231741,408176203,64,16155,4827109,16004,4802312,151,24797,9970,6,45818,11200,64,243,206470.0,103230.0,-47.0,-50.0,-54.0,-46.0,-49.0,-49.0,-44.0,-45.0,-82.0,-90.0,-83.0,-89.0,35.0,40.0,29.0,43.0,1
3176,62:47:05:9D:EB:15,3254725,463779030,22983,55602767,3231742,408176263,64,9803,1851630,9707,1835596,96,16034,4277,1,22871,2933,64,246,229410.0,137640.0,-47.0,-51.0,-48.0,-45.0,-46.0,-52.0,-47.0,-45.0,-82.0,-90.0,-83.0,-89.0,35.0,39.0,35.0,44.0,1
3177,F8:59:71:5A:E0:3D,3511987,831445209,280241,423268592,3231746,408176617,4,279760,381646396,274829,381057352,4931,589044,255761,20,282997,7398,4,869,130000.0,39000.0,-66.0,-73.0,-64.0,-71.0,-67.0,-74.0,-66.0,-71.0,-82.0,-90.0,-83.0,-89.0,16.0,17.0,19.0,18.0,1
3178,CC:2F:71:3E:C5:1F,3243312,409591420,11565,1414669,3231747,408176751,6,49314,4130555,40742,3114905,8572,1015650,12193,36,16572,191,6,858,130000.0,39000.0,-68.0,-72.0,-68.0,-60.0,-67.0,-71.0,-67.0,-60.0,-82.0,-90.0,-83.0,-89.0,14.0,18.0,15.0,29.0,1
3179,CC:2F:71:3F:1F:24,12296677,14308180959,9064928,13900004006,3231749,408176953,158,2071355,1221201092,2062624,1220151812,8731,1049280,2004892,675,9069757,954097,158,6755,86667.0,14444.0,-69.0,-65.0,-71.0,-71.0,-68.0,-64.0,-69.0,-70.0,-82.0,-90.0,-83.0,-89.0,13.0,25.0,12.0,18.0,1
3180,3C:55:76:E8:8F:1F,3239928,428969806,8175,20792449,3231753,408177357,0,3754,567644,3601,539647,153,27997,1293,4,8073,1451,0,84,286760.0,1000.0,-63.0,-52.0,-46.0,-53.0,-52.0,-54.0,-46.0,-52.0,-82.0,-90.0,-83.0,-89.0,19.0,38.0,37.0,36.0,1
3181,92:69:1D:31:68:E9,3266118,482731959,34365,74554602,3231753,408177357,0,14517,4455139,14367,4430635,150,24504,9272,1,34412,3059,0,164,229410.0,137640.0,-55.0,-49.0,-45.0,-51.0,-50.0,-49.0,-45.0,-49.0,-82.0,-90.0,-83.0,-89.0,27.0,41.0,38.0,38.0,1
3182,BA:8C:B9:54:50:24,3277588,511644176,45834,103466708,3231754,408177468,64,16155,4827109,16004,4802312,151,24797,9970,6,45818,11200,64,243,206470.0,103230.0,-47.0,-50.0,-54.0,-46.0,-49.0,-49.0,-44.0,-45.0,-82.0,-90.0,-83.0,-89.0,35.0,40.0,29.0,43.0,1
3183,62:47:05:9D:EB:15,3254785,463841597,23031,55664129,3231754,408177468,64,9871,1857804,9774,1841599,97,16205,4295,1,23015,2951,64,247,229410.0,137640.0,-47.0,-52.0,-48.0,-46.0,-47.0,-52.0,-48.0,-45.0,-82.0,-90.0,-83.0,-89.0,35.0,38.0,35.0,43.0,1
3184,F8:59:71:5A:E0:3D,3511995,831446060,280241,423268592,3231754,408177468,4,279760,381646396,274829,381057352,4931,589044,255761,20,282997,7398,4,869,130000.0,39000.0,-66.0,-73.0,-64.0,-71.0,-67.0,-74.0,-66.0,-71.0,-82.0,-90.0,-83.0,-89.0,16.0,17.0,19.0,18.0,1
3185,CC:2F:71:3E:C5:1F,3243319,409592137,11565,1414669,3231754,408177468,6,49314,4130555,40742,3114905,8572,1015650,12193,36,16572,191,6,858,130000.0,39000.0,-68.0,-72.0,-68.0,-60.0,-67.0,-71.0,-67.0,-60.0,-82.0,-90.0,-83.0,-89.0,14.0,18.0,15.0,29.0,1
3186,CC:2F:71:3F:1F:24,12297448,14309303632,9065694,13901126164,3231754,408177468,158,2071541,1221225616,2062810,1220176336,8731,1049280,2005076,675,9070505,954117,158,6755,104000.0,26000.0,-69.0,-65.0,-70.0,-70.0,-68.0,-64.0,-70.0,-70.0,-83.0,-90.0,-83.0,-89.0,14.0,25.0,13.0,19.0,1
3187,3C:55:76:E8:8F:1F,3240559,430630249,8800,22452317,3231759,408177932,0,3938,593010,3785,565013,153,27997,1353,4,8825,1658,0,85,286760.0,172050.0,-49.0,-52.0,-48.0,-51.0,-48.0,-52.0,-47.0,-51.0,-83.0,-90.0,-83.0,-89.0,34.0,38.0,35.0,38.0,1
3188,92:69:1D:31:68:E9,3266124,482732534,34365,74554602,3231759,408177932,0,14517,4455139,14367,4430635,150,24504,9272,1,34412,3059,0,164,229410.0,137640.0,-55.0,-49.0,-45.0,-51.0,-50.0,-49.0,-45.0,-49.0,-83.0,-90.0,-83.0,-89.0,28.0,41.0,38.0,38.0,1
3189,BA:8C:B9:54:50:24,3277593,511644640,45834,103466708,3231759,408177932,64,16155,4827109,16004,4802312,151,24797,9970,6,45818,11200,64,243,206470.0,103230.0,-47.0,-50.0,-54.0,-46.0,-49.0,-49.0,-44.0,-45.0,-83.0,-90.0,-83.0,-89.0,36.0,40.0,29.0,43.0,1
3190,62:47:05:9D:EB:15,3254792,463842263,23031,55664129,3231761,408178134,64,9872,1857872,9775,1841667,97,16205,4295,1,23015,2951,64,247,229410.0,137640.0,-43.0,-50.0,-44.0,-45.0,-46.0,-51.0,-47.0,-45.0,-83.0,-90.0,-83.0,-89.0,40.0,40.0,39.0,44.0,1
3191,F8:59:71:5A:E0:3D,3512002,831446726,280241,423268592,3231761,408178134,4,279760,381646396,274829,381057352,4931,589044,255761,20,282997,7398,4,869,130000.0,39000.0,-66.0,-73.0,-64.0,-71.0,-67.0,-74.0,-66.0,-71.0,-83.0,-90.0,-84.0,-89.0,17.0,17.0,20.0,18.0,1
3192,CC:2F:71:3E:C5:1F,3243328,409593005,11565,1414669,3231763,408178336,6,49314,4130555,40742,3114905,8572,1015650,12193,36,16572,191,6,858,130000.0,39000.0,-68.0,-72.0,-68.0,-60.0,-67.0,-71.0,-67.0,-60.0,-83.0,-90.0,-84.0,-89.0,15.0,18.0,16.0,29.0,1
3193,CC:2F:71:3F:1F:24,12298688,14311171002,9066925,13902992666,3231763,408178336,158,2071778,1221255614,2063047,1220206334,8731,1049280,2005313,675,9071750,954206,158,6755,86667.0,14444.0,-69.0,-64.0,-70.0,-70.0,-68.0,-63.0,-69.0,-69.0,-83.0,-90.0,-84.0,-89.0,14.0,26.0,14.0,19.0,1
3194,3C:55:76:E8:8F:1F,3240568,430631181,8801,22452441,3231767,408178740,0,3947,593662,3794,565665,153,27997,1354,4,8826,1658,0,87,286760.0,172050.0,-49.0,-52.0,-49.0,-52.0,-48.0,-51.0,-47.0,-51.0,-83.0,-90.0,-84.0,-89.0,34.0,38.0,35.0,37.0,1
3195,92:69:1D:31:68:E9,3266132,482733342,34365,74554602,3231767,408178740,0,14517,4455139,14367,4430635,150,24504,9272,1,34412,3059,0,164,229410.0,137640.0,-55.0,-49.0,-45.0,-51.0,-50.0,-49.0,-45.0,-49.0,-83.0,-90.0,-84.0,-89.0,28.0,41.0,39.0,38.0,1
3196,BA:8C:B9:54:50:24,3277601,511645448,45834,103466708,3231767,408178740,64,16162,4827869,16011,4803072,151,24797,9973,6,45818,11200,64,243,206470.0,103230.0,-47.0,-52.0,-51.0,-45.0,-48.0,-50.0,-46.0,-46.0,-83.0,-90.0,-84.0,-89.0,36.0,38.0,33.0,44.0,1
3197,62:47:05:9D:EB:15,3254798,463842869,23031,55664129,3231767,408178740,64,9872,1857872,9775,1841667,97,16205,4295,1,23015,2951,64,247,229410.0,137640.0,-43.0,-50.0,-44.0,-45.0,-46.0,-51.0,-47.0,-45.0,-83.0,-90.0,-84.0,-89.0,40.0,40.0,40.0,44.0,1
3198,F8:59:71:5A:E0:3D,3512008,831447332,280241,423268592,3231767,408178740,4,279760,381646396,274829,381057352,4931,589044,255761,20,282997,7398,4,869,130000.0,39000.0,-66.0,-73.0,-64.0,-71.0,-67.0,-74.0,-66.0,-71.0,-83.0,-90.0,-84.0,-89.0,17.0,17.0,20.0,18.0,1
3199,CC:2F:71:3E:C5:1F,3243333,409593469,11565,1414669,3231768,408178800,6,49314,4130555,40742,3114905,8572,1015650,12193,36,16572,191,6,858,130000.0,39000.0,-68.0,-72.0,-68.0,-60.0,-67.0,-71.0,-67.0,-60.0,-83.0,-90.0,-84.0,-89.0,15.0,18.0,16.0,29.0,1
3200,CC:2F:71:3F:1F:24,12299419,14312230478,9067649,13904051476,3231770,408179002,158,2071958,1221279505,2063227,1220230225,8731,1049280,2005489,675,9072482,954342,158,6755,86667.0,14444.0,-69.0,-65.0,-70.0,-71.0,-68.0,-64.0,-70.0,-70.0,-83.0,-90.0,-84.0,-89.0,14.0,25.0,14.0,18.0,1
3201,3C:55:76:E8:8F:1F,3240574,430631892,8802,22452688,3231772,408179204,0,3962,594686,3809,566689,153,27997,1354,4,8827,1658,0,87,286760.0,172050.0,-48.0,-52.0,-44.0,-49.0,-49.0,-51.0,-43.0,-49.0,-83.0,-90.0,-84.0,-89.0,35.0,38.0,40.0,40.0,1
3202,92:69:1D:31:68:E9,3266138,482733922,34366,74554718,3231772,408179204,0,14522,4455517,14372,4431013,150,24504,9273,1,34413,3059,0,164,229410.0,137640.0,-53.0,-51.0,-45.0,-51.0,-51.0,-50.0,-46.0,-50.0,-83.0,-90.0,-84.0,-89.0,30.0,39.0,39.0,38.0,1
3203,BA:8C:B9:54:50:24,3277607,511646087,45834,103466708,3231773,408179379,64,16162,4827869,16011,4803072,151,24797,9973,6,45818,11200,64,243,206470.0,103230.0,-47.0,-52.0,-51.0,-45.0,-48.0,-50.0,-46.0,-46.0,-83.0,-90.0,-84.0,-89.0,36.0,38.0,33.0,44.0,1
3204,62:47:05:9D:EB:15,3254804,463843508,23031,55664129,3231773,408179379,64,9872,1857872,9775,1841667,97,16205,4295,1,23015,2951,64,247,229410.0,137640.0,-43.0,-50.0,-44.0,-45.0,-46.0,-51.0,-47.0,-45.0,-83.0,-90.0,-84.0,-89.0,40.0,40.0,40.0,44.0,1
3205,F8:59:71:5A:E0:3D,3512014,831447971,280241,423268592,3231773,408179379,4,279760,381646396,274829,381057352,4931,589044,255761,20,282997,7398,4,869,130000.0,39000.0,-66.0,-73.0,-64.0,-71.0,-67.0,-74.0,-66.0,-71.0,-83.0,-90.0,-84.0,-89.0,17.0,17.0,20.0,18.0,1
3206,CC:2F:71:3E:C5:1F,3243340,409594250,11565,1414669,3231775,408179581,6,49314,4130555,40742,3114905,8572,1015650,12193,36,16572,191,6,858,130000.0,39000.0,-68.0,-72.0,-68.0,-60.0,-67.0,-71.0,-67.0,-60.0,-83.0,-90.0,-84.0,-89.0,15.0,18.0,16.0,29.0,1
3207,CC:2F:71:3F:1F:24,12300398,14313688891,9068621,13905509108,3231777,408179783,158,2072206,1221310661,2063475,1220261381,8731,1049280,2005729,675,9073454,954500,158,6755,86667.0,14444.0,-68.0,-64.0,-70.0,-69.0,-68.0,-64.0,-69.0,-69.0,-83.0,-90.0,-84.0,-89.0,15.0,26.0,14.0,20.0,1
3208,3C:55:76:E8:8F:1F,3240583,430634159,8803,22453901,3231780,408180258,0,3967,595028,3814,567031,153,27997,1354,4,8828,1659,0,87,286760.0,172050.0,-51.0,-53.0,-49.0,-52.0,-49.0,-50.0,-45.0,-49.0,-83.0,-90.0,-84.0,-89.0,32.0,37.0,35.0,37.0,1
3209,92:69:1D:31:68:E9,3266146,482734976,34366,74554718,3231780,408180258,0,14525,4455888,14374,4431149,151,24739,9274,1,34413,3059,0,164,229410.0,137640.0,-53.0,-51.0,-45.0,-51.0,-51.0,-51.0,-46.0,-51.0,-83.0,-90.0,-84.0,-89.0,30.0,39.0,39.0,38.0,1
3210,BA:8C:B9:54:50:24,3277614,511646966,45834,103466708,3231780,408180258,64,16162,4827869,16011,4803072,151,24797,9973,6,45818,11200,64,243,206470.0,103230.0,-47.0,-52.0,-51.0,-45.0,-48.0,-50.0,-46.0,-46.0,-83.0,-90.0,-84.0,-89.0,36.0,38.0,33.0,44.0,1
3211,62:47:05:9D:EB:15,3254812,463844503,23032,55664245,3231780,408180258,64,9911,1860562,9814,1844357,97,16205,4296,1,23016,2951,64,247,229410.0,137640.0,-43.0,-50.0,-44.0,-45.0,-43.0,-47.0,-44.0,-41.0,-83.0,-90.0,-84.0,-89.0,40.0,40.0,40.0,44.0,1
3212,F8:59:71:5A:E0:3D,3512023,831449052,280241,423268592,3231782,408180460,4,279760,381646396,274829,381057352,4931,589044,255761,20,282997,7398,4,869,130000.0,39000.0,-66.0,-73.0,-64.0,-71.0,-67.0,-74.0,-66.0,-71.0,-83.0,-90.0,-84.0,-89.0,17.0,17.0,20.0,18.0,1
3213,CC:2F:71:3E:C5:1F,3243347,409595129,11565,1414669,3231782,408180460,6,49314,4130555,40742,3114905,8572,1015650,12193,36,16572,191,6,858,130000.0,39000.0,-68.0,-72.0,-68.0,-60.0,-67.0,-71.0,-67.0,-60.0,-83.0,-90.0,-84.0,-89.0,15.0,18.0,16.0,29.0,1
3214,CC:2F:71:3F:1F:24,12301736,14315708401,9069953,13907527881,3231783,408180520,158,2072515,1221351404,2063784,1220302124,8731,1049280,2006030,675,9074786,954515,158,6755,86667.0,14444.0,-69.0,-64.0,-70.0,-70.0,-68.0,-64.0,-69.0,-70.0,-83.0,-90.0,-84.0,-89.0,14.0,26.0,14.0,19.0,1
3215,3C:55:76:E8:8F:1F,3240589,430635032,8804,22454310,3231785,408180722,0,3981,596355,3828,568358,153,27997,1357,4,8829,1659,0,87,286760.0,172050.0,-47.0,-51.0,-43.0,-48.0,-48.0,-50.0,-43.0,-48.0,-83.0,-90.0,-84.0,-89.0,36.0,39.0,41.0,41.0,1
3216,92:69:1D:31:68:E9,3266151,482735440,34366,74554718,3231785,408180722,0,14525,4455888,14374,4431149,151,24739,9274,1,34413,3059,0,164,229410.0,137640.0,-53.0,-51.0,-45.0,-51.0,-51.0,-51.0,-46.0,-51.0,-84.0,-90.0,-84.0,-90.0,31.0,39.0,39.0,39.0,1
3217,BA:8C:B9:54:50:24,3277621,511647632,45834,103466708,3231787,408180924,64,16162,4827869,16011,4803072,151,24797,9973,6,45818,11200,64,243,206470.0,103230.0,-47.0,-52.0,-51.0,-45.0,-48.0,-50.0,-46.0,-46.0,-84.0,-90.0,-84.0,-90.0,37.0,38.0,33.0,45.0,1
3218,62:47:05:9D:EB:15,3254819,463845169,23032,55664245,3231787,408180924,64,9911,1860562,9814,1844357,97,16205,4296,1,23016,2951,64,247,229410.0,137640.0,-43.0,-50.0,-44.0,-45.0,-43.0,-47.0,-44.0,-41.0,-84.0,-90.0,-84.0,-90.0,41.0,40.0,40.0,45.0,1
3219,F8:59:71:5A:E0:3D,3512028,831449516,280241,423268592,3231787,408180924,4,279760,381646396,274829,381057352,4931,589044,255761,20,282997,7398,4,869,130000.0,39000.0,-66.0,-73.0,-64.0,-71.0,-67.0,-74.0,-66.0,-71.0,-84.0,-90.0,-84.0,-90.0,18.0,17.0,20.0,19.0,1
3220,CC:2F:71:3E:C5:1F,3243352,409595593,11565,1414669,3231787,408180924,6,49314,4130555,40742,3114905,8572,1015650,12193,36,16572,191,6,858,130000.0,39000.0,-68.0,-72.0,-68.0,-60.0,-67.0,-71.0,-67.0,-60.0,-84.0,-90.0,-84.0,-90.0,16.0,18.0,16.0,30.0,1
3221,CC:2F:71:3F:1F:24,12302708,14317150917,9070919,13908969791,3231789,408181126,158,2072752,1221381859,2064021,1220332579,8731,1049280,2006267,675,9075752,954597,158,6755,86667.0,14444.0,-69.0,-64.0,-70.0,-70.0,-69.0,-64.0,-70.0,-70.0,-84.0,-90.0,-84.0,-90.0,15.0,26.0,14.0,20.0,1
3222,3C:55:76:E8:8F:1F,3240607,430642471,8816,22461143,3231791,408181328,0,4014,606215,3861,578218,153,27997,1372,4,8841,1659,0,88,286760.0,172050.0,-47.0,-50.0,-43.0,-48.0,-47.0,-51.0,-43.0,-48.0,-85.0,-90.0,-85.0,-90.0,38.0,40.0,42.0,42.0,1
3223,92:69:1D:31:68:E9,3266158,482736162,34367,74554834,3231791,408181328,0,14527,4456024,14376,4431285,151,24739,9274,1,34414,3059,0,164,229410.0,137640.0,-52.0,-53.0,-52.0,-55.0,-51.0,-51.0,-47.0,-51.0,-85.0,-90.0,-85.0,-90.0,33.0,37.0,33.0,35.0,1
3224,BA:8C:B9:54:50:24,3277626,511648096,45835,103466768,3231791,408181328,64,16164,4828005,16013,4803208,151,24797,9973,6,45819,11200,64,243,195000.0,97500.0,-55.0,-50.0,-38.0,-46.0,-49.0,-50.0,-48.0,-46.0,-85.0,-90.0,-85.0,-90.0,30.0,40.0,47.0,44.0,1
3225,62:47:05:9D:EB:15,3254824,463845689,23033,55664361,3231791,408181328,64,9914,1860766,9817,1844561,97,16205,4296,1,23017,2951,64,247,229410.0,137640.0,-52.0,-49.0,-50.0,-41.0,-45.0,-48.0,-45.0,-41.0,-85.0,-90.0,-85.0,-90.0,33.0,41.0,35.0,49.0,1
3226,F8:59:71:5A:E0:3D,3512033,831450036,280242,423268708,3231791,408181328,4,279762,381646536,274831,381057492,4931,589044,255761,20,282998,7398,4,869,130000.0,39000.0,-74.0,-82.0,-76.0,-75.0,-68.0,-76.0,-68.0,-72.0,-85.0,-90.0,-85.0,-90.0,11.0,8.0,9.0,15.0,1
3227,CC:2F:71:3E:C5:1F,3243358,409596173,11566,1414785,3231792,408181388,6,49316,4130695,40744,3115045,8572,1015650,12193,36,16573,191,6,858,130000.0,39000.0,-68.0,-73.0,-68.0,-60.0,-67.0,-71.0,-66.0,-60.0,-85.0,-90.0,-85.0,-90.0,17.0,17.0,17.0,30.0,1
3228,CC:2F:71:3F:1F:24,12303606,14318467738,9071814,13910286350,3231792,408181388,158,2072967,1221412692,2064236,1220363412,8731,1049280,2006482,675,9076647,954634,158,6755,65000.0,13000.0,-72.0,-68.0,-73.0,-74.0,-71.0,-67.0,-72.0,-73.0,-85.0,-90.0,-85.0,-90.0,13.0,22.0,12.0,16.0,1
3229,3C:55:76:E8:8F:1F,3240614,430643137,8816,22461143,3231798,408181994,0,4019,606557,3866,578560,153,27997,1372,4,8841,1659,0,88,286760.0,172050.0,-49.0,-51.0,-43.0,-49.0,-51.0,-51.0,-43.0,-49.0,-85.0,-90.0,-85.0,-90.0,36.0,39.0,42.0,41.0,1
3230,92:69:1D:31:68:E9,3266167,482737030,34367,74554834,3231800,408182196,0,14527,4456024,14376,4431285,151,24739,9274,1,34414,3059,0,164,229410.0,137640.0,-52.0,-53.0,-52.0,-55.0,-51.0,-51.0,-47.0,-51.0,-85.0,-90.0,-85.0,-90.0,33.0,37.0,33.0,35.0,1
3231,BA:8C:B9:54:50:24,3277635,511648964,45835,103466768,3231800,408182196,64,16164,4828005,16013,4803208,151,24797,9973,6,45819,11200,64,243,195000.0,97500.0,-55.0,-50.0,-38.0,-46.0,-49.0,-50.0,-48.0,-46.0,-85.0,-90.0,-85.0,-90.0,30.0,40.0,47.0,44.0,1
3232,62:47:05:9D:EB:15,3254834,463846619,23033,55664361,3231801,408182258,64,9914,1860766,9817,1844561,97,16205,4296,1,23017,2951,64,247,229410.0,137640.0,-52.0,-49.0,-50.0,-41.0,-45.0,-48.0,-45.0,-41.0,-85.0,-90.0,-85.0,-90.0,33.0,41.0,35.0,49.0,1
3233,F8:59:71:5A:E0:3D,3512043,831450966,280242,423268708,3231801,408182258,4,279762,381646536,274831,381057492,4931,589044,255761,20,282998,7398,4,869,130000.0,39000.0,-74.0,-82.0,-76.0,-75.0,-68.0,-76.0,-68.0,-72.0,-85.0,-90.0,-85.0,-90.0,11.0,8.0,9.0,15.0,1
3234,CC:2F:71:3E:C5:1F,3243367,409597043,11566,1414785,3231801,408182258,6,49318,4130883,40745,3115115,8573,1015768,12194,36,16573,191,6,858,130000.0,39000.0,-69.0,-72.0,-69.0,-60.0,-68.0,-72.0,-67.0,-60.0,-85.0,-90.0,-85.0,-90.0,16.0,18.0,16.0,30.0,1
3235,CC:2F:71:3F:1F:24,12304874,14320379070,9073073,13912196812,3231801,408182258,158,2073242,1221447026,2064511,1220397746,8731,1049280,2006756,675,9077906,954840,158,6757,86667.0,14444.0,-68.0,-64.0,-69.0,-70.0,-68.0,-64.0,-69.0,-70.0,-85.0,-90.0,-85.0,-90.0,17.0,26.0,16.0,20.0,1
3236,3C:55:76:E8:8F:1F,3240624,430644187,8818,22461465,3231806,408182722,0,4036,607829,3883,579832,153,27997,1375,4,8843,1659,0,88,286760.0,172050.0,-47.0,-52.0,-44.0,-50.0,-49.0,-52.0,-47.0,-51.0,-85.0,-91.0,-85.0,-90.0,38.0,39.0,41.0,40.0,1
3237,92:69:1D:31:68:E9,3266603,483863292,34797,75680570,3231806,408182722,0,14569,4466880,14418,4442141,151,24739,9311,1,34844,3076,0,164,229410.0,137640.0,-53.0,-51.0,-46.0,-51.0,-50.0,-50.0,-46.0,-49.0,-85.0,-91.0,-85.0,-90.0,32.0,40.0,39.0,39.0,1
3238,BA:8C:B9:54:50:24,3277643,511649692,45835,103466768,3231808,408182924,64,16165,4828073,16014,4803276,151,24797,9973,6,45819,11200,64,243,195000.0,97500.0,-47.0,-50.0,-54.0,-46.0,-48.0,-50.0,-50.0,-46.0,-85.0,-91.0,-85.0,-90.0,38.0,41.0,31.0,44.0,1
3239,62:47:05:9D:EB:15,3254841,463847285,23033,55664361,3231808,408182924,64,9914,1860766,9817,1844561,97,16205,4296,1,23017,2951,64,247,229410.0,137640.0,-52.0,-49.0,-50.0,-41.0,-45.0,-48.0,-45.0,-41.0,-85.0,-91.0,-85.0,-90.0,33.0,42.0,35.0,49.0,1
3240,F8:59:71:5A:E0:3D,3512050,831451632,280242,423268708,3231808,408182924,4,279762,381646536,274831,381057492,4931,589044,255761,20,282998,7398,4,869,130000.0,39000.0,-74.0,-82.0,-76.0,-75.0,-68.0,-76.0,-68.0,-72.0,-85.0,-91.0,-85.0,-90.0,11.0,9.0,9.0,15.0,1
3241,CC:2F:71:3E:C5:1F,3243378,409598422,11570,1415498,3231808,408182924,6,49323,4131628,40750,3115860,8573,1015768,12199,36,16577,191,6,860,130000.0,39000.0,-69.0,-72.0,-69.0,-61.0,-69.0,-72.0,-69.0,-61.0,-85.0,-91.0,-85.0,-90.0,16.0,19.0,16.0,29.0,1
3242,CC:2F:71:3F:1F:24,12306082,14322191158,9074274,13914008234,3231808,408182924,158,2073508,1221480665,2064777,1220431385,8731,1049280,2007022,675,9079107,954854,158,6757,86667.0,14444.0,-69.0,-64.0,-70.0,-70.0,-68.0,-64.0,-70.0,-70.0,-85.0,-91.0,-85.0,-90.0,16.0,27.0,15.0,20.0,1
3243,3C:55:76:E8:8F:1F,3240630,430644845,8820,22461719,3231810,408183126,0,4055,609198,3902,581201,153,27997,1377,4,8845,1659,0,88,286760.0,172050.0,-47.0,-52.0,-45.0,-50.0,-46.0,-50.0,-42.0,-48.0,-86.0,-91.0,-86.0,-91.0,39.0,39.0,41.0,41.0,1
3244,92:69:1D:31:68:E9,3266607,483863696,34797,75680570,3231810,408183126,0,14569,4466880,14418,4442141,151,24739,9311,1,34844,3076,0,164,229410.0,137640.0,-53.0,-51.0,-46.0,-51.0,-50.0,-50.0,-46.0,-49.0,-86.0,-91.0,-86.0,-91.0,33.0,40.0,40.0,40.0,1
3245,BA:8C:B9:54:50:24,3277645,511649894,45835,103466768,3231810,408183126,64,16165,4828073,16014,4803276,151,24797,9973,6,45819,11200,64,243,195000.0,97500.0,-47.0,-50.0,-54.0,-46.0,-48.0,-50.0,-50.0,-46.0,-86.0,-91.0,-86.0,-91.0,39.0,41.0,32.0,45.0,1
3246,62:47:05:9D:EB:15,3255197,464784202,23385,56600874,3231812,408183328,64,9952,1866905,9855,1850700,97,16205,4306,1,23296,3062,64,247,229410.0,137640.0,-43.0,-48.0,-44.0,-40.0,-44.0,-50.0,-46.0,-42.0,-86.0,-91.0,-86.0,-91.0,43.0,43.0,42.0,51.0,1
3247,F8:59:71:5A:E0:3D,3512054,831452036,280242,423268708,3231812,408183328,4,279762,381646536,274831,381057492,4931,589044,255761,20,282998,7398,4,869,130000.0,39000.0,-74.0,-82.0,-76.0,-75.0,-68.0,-76.0,-68.0,-72.0,-86.0,-91.0,-86.0,-91.0,12.0,9.0,10.0,16.0,1
3248,CC:2F:71:3E:C5:1F,3243384,409599028,11570,1415498,3231814,408183530,6,49324,4131698,40751,3115930,8573,1015768,12199,36,16577,191,6,860,130000.0,39000.0,-68.0,-73.0,-68.0,-60.0,-69.0,-72.0,-69.0,-61.0,-86.0,-91.0,-86.0,-91.0,18.0,18.0,18.0,31.0,1
3249,CC:2F:71:3F:1F:24,12307955,14325061358,9076140,13916877766,3231815,408183592,158,2073842,1221521805,2065111,1220472525,8731,1049280,2007356,675,9080959,955036,158,6757,86667.0,14444.0,-69.0,-64.0,-70.0,-70.0,-69.0,-64.0,-70.0,-70.0,-86.0,-91.0,-86.0,-91.0,17.0,27.0,16.0,21.0,1
3250,3C:55:76:E8:8F:1F,3240643,430646029,8821,22461849,3231822,408184180,0,4087,611469,3933,583354,154,28115,1379,4,8846,1659,0,89,286760.0,172050.0,-49.0,-52.0,-48.0,-52.0,-50.0,-50.0,-45.0,-50.0,-86.0,-91.0,-86.0,-91.0,37.0,39.0,38.0,39.0,1
3251,92:69:1D:31:68:E9,3266634,483870049,34812,75685869,3231822,408184180,0,14598,4471109,14446,4446248,152,24861,9329,1,34859,3076,0,164,229410.0,137640.0,-53.0,-51.0,-45.0,-51.0,-49.0,-49.0,-45.0,-49.0,-86.0,-91.0,-86.0,-91.0,33.0,40.0,41.0,40.0,1
3252,BA:8C:B9:54:50:24,3277657,511650948,45835,103466768,3231822,408184180,64,16165,4828073,16014,4803276,151,24797,9973,6,45819,11200,64,243,195000.0,97500.0,-47.0,-50.0,-54.0,-46.0,-48.0,-50.0,-50.0,-46.0,-86.0,-91.0,-86.0,-91.0,39.0,41.0,32.0,45.0,1
3253,62:47:05:9D:EB:15,3255604,465825830,23782,57641650,3231822,408184180,64,10041,1881488,9944,1865283,97,16205,4377,1,23766,3063,64,247,229410.0,137640.0,-43.0,-50.0,-44.0,-45.0,-45.0,-51.0,-47.0,-45.0,-86.0,-91.0,-86.0,-91.0,43.0,41.0,42.0,46.0,1
3254,F8:59:71:5A:E0:3D,3512064,831452888,280242,423268708,3231822,408184180,4,279764,381646724,274832,381057562,4932,589162,255762,20,282998,7398,4,869,130000.0,39000.0,-66.0,-73.0,-64.0,-71.0,-69.0,-76.0,-68.0,-72.0,-86.0,-91.0,-86.0,-91.0,20.0,18.0,22.0,20.0,1
3255,CC:2F:71:3E:C5:1F,3243392,409599678,11570,1415498,3231822,408184180,6,49324,4131698,40751,3115930,8573,1015768,12199,36,16577,191,6,860,130000.0,39000.0,-68.0,-73.0,-68.0,-60.0,-69.0,-72.0,-69.0,-61.0,-86.0,-91.0,-86.0,-91.0,18.0,18.0,18.0,31.0,1
3256,CC:2F:71:3F:1F:24,12309291,14327087476,9077469,13918903296,3231822,408184180,158,2074081,1221552077,2065350,1220502797,8731,1049280,2007595,675,9082302,955039,158,6758,65000.0,13000.0,-69.0,-64.0,-70.0,-70.0,-71.0,-67.0,-73.0,-73.0,-86.0,-91.0,-86.0,-91.0,17.0,27.0,16.0,21.0,1
3257,3C:55:76:E8:8F:1F,3240655,430647324,8825,22462414,3231830,408184910,0,4109,614287,3954,586054,155,28233,1383,4,8850,1659,0,89,286760.0,172050.0,-48.0,-52.0,-48.0,-51.0,-48.0,-52.0,-47.0,-50.0,-87.0,-91.0,-87.0,-91.0,39.0,39.0,39.0,40.0,1
3258,92:69:1D:31:68:E9,3266642,483870779,34812,75685869,3231830,408184910,0,14598,4471109,14446,4446248,152,24861,9329,1,34859,3076,0,164,229410.0,137640.0,-53.0,-51.0,-45.0,-51.0,-49.0,-49.0,-45.0,-49.0,-87.0,-91.0,-87.0,-91.0,34.0,40.0,42.0,40.0,1
3259,BA:8C:B9:54:50:24,3277665,511651678,45835,103466768,3231830,408184910,64,16165,4828073,16014,4803276,151,24797,9973,6,45819,11200,64,243,195000.0,97500.0,-47.0,-50.0,-54.0,-46.0,-48.0,-50.0,-50.0,-46.0,-87.0,-91.0,-87.0,-91.0,40.0,41.0,33.0,45.0,1
3260,62:47:05:9D:EB:15,3255612,465826560,23782,57641650,3231830,408184910,64,10041,1881488,9944,1865283,97,16205,4377,1,23766,3063,64,247,229410.0,137640.0,-43.0,-50.0,-44.0,-45.0,-45.0,-51.0,-47.0,-45.0,-87.0,-91.0,-87.0,-91.0,44.0,41.0,43.0,46.0,1
3261,F8:59:71:5A:E0:3D,3512072,831453618,280242,423268708,3231830,408184910,4,279764,381646724,274832,381057562,4932,589162,255762,20,282998,7398,4,869,130000.0,39000.0,-66.0,-73.0,-64.0,-71.0,-69.0,-76.0,-68.0,-72.0,-87.0,-91.0,-87.0,-91.0,21.0,18.0,23.0,20.0,1
3262,CC:2F:71:3E:C5:1F,3243402,409600610,11570,1415498,3231832,408185112,6,49324,4131698,40751,3115930,8573,1015768,12199,36,16577,191,6,860,130000.0,39000.0,-68.0,-73.0,-68.0,-60.0,-69.0,-72.0,-69.0,-61.0,-87.0,-91.0,-87.0,-91.0,19.0,18.0,19.0,31.0,1
3263,CC:2F:71:3F:1F:24,12310778,14329336774,9078946,13921151662,3231832,408185112,158,2074331,1221584114,2065599,1220534716,8732,1049398,2007845,675,9083779,955239,158,6759,115556.0,28889.0,-68.0,-64.0,-70.0,-70.0,-68.0,-64.0,-70.0,-70.0,-88.0,-91.0,-88.0,-92.0,20.0,27.0,18.0,22.0,1
3264,3C:55:76:E8:8F:1F,3240660,430647788,8825,22462414,3231835,408185374,0,4115,614697,3960,586464,155,28233,1383,4,8850,1659,0,89,286760.0,172050.0,-49.0,-52.0,-48.0,-52.0,-49.0,-51.0,-47.0,-51.0,-88.0,-91.0,-88.0,-92.0,39.0,39.0,40.0,40.0,1
3265,92:69:1D:31:68:E9,3266647,483871243,34812,75685869,3231835,408185374,0,14599,4471177,14447,4446316,152,24861,9329,1,34859,3076,0,164,229410.0,137640.0,-52.0,-53.0,-52.0,-55.0,-50.0,-50.0,-46.0,-50.0,-88.0,-91.0,-88.0,-92.0,36.0,38.0,36.0,37.0,1
3266,BA:8C:B9:54:50:24,3277670,511652142,45835,103466768,3231835,408185374,64,16165,4828073,16014,4803276,151,24797,9973,6,45819,11200,64,243,195000.0,97500.0,-47.0,-50.0,-54.0,-46.0,-48.0,-50.0,-50.0,-46.0,-88.0,-91.0,-88.0,-92.0,41.0,41.0,34.0,46.0,1
3267,62:47:05:9D:EB:15,3255617,465827024,23782,57641650,3231835,408185374,64,10041,1881488,9944,1865283,97,16205,4377,1,23766,3063,64,247,229410.0,137640.0,-43.0,-50.0,-44.0,-45.0,-45.0,-51.0,-47.0,-45.0,-88.0,-91.0,-88.0,-92.0,45.0,41.0,44.0,47.0,1
3268,F8:59:71:5A:E0:3D,3512081,831454486,280242,423268708,3231839,408185778,4,279764,381646724,274832,381057562,4932,589162,255762,20,282998,7398,4,869,130000.0,39000.0,-66.0,-73.0,-64.0,-71.0,-69.0,-76.0,-68.0,-72.0,-88.0,-91.0,-88.0,-92.0,22.0,18.0,24.0,21.0,1
3269,CC:2F:71:3E:C5:1F,3243409,409601276,11570,1415498,3231839,408185778,6,49324,4131698,40751,3115930,8573,1015768,12199,36,16577,191,6,860,130000.0,39000.0,-68.0,-73.0,-68.0,-60.0,-69.0,-72.0,-69.0,-61.0,-88.0,-91.0,-88.0,-92.0,20.0,18.0,20.0,32.0,1
3270,CC:2F:71:3F:1F:24,12311664,14330647094,9079825,13922461316,3231839,408185778,158,2074522,1221608661,2065790,1220559263,8732,1049398,2008036,675,9084658,955535,158,6759,115556.0,28889.0,-69.0,-64.0,-70.0,-70.0,-68.0,-64.0,-70.0,-70.0,-88.0,-91.0,-88.0,-92.0,19.0,27.0,18.0,22.0,1
3271,3C:55:76:E8:8F:1F,3240667,430648667,8825,22462414,3231842,408186253,0,4115,614697,3960,586464,155,28233,1383,4,8850,1659,0,89,286760.0,172050.0,-49.0,-52.0,-48.0,-52.0,-49.0,-51.0,-47.0,-51.0,-88.0,-91.0,-88.0,-92.0,39.0,39.0,40.0,40.0,1
3272,92:69:1D:31:68:E9,3266654,483872122,34812,75685869,3231842,408186253,0,14609,4471857,14457,4446996,152,24861,9329,1,34859,3076,0,164,229410.0,137640.0,-53.0,-51.0,-46.0,-51.0,-52.0,-51.0,-47.0,-52.0,-88.0,-91.0,-88.0,-92.0,35.0,40.0,42.0,41.0,1
3273,BA:8C:B9:54:50:24,3277677,511653021,45835,103466768,3231842,408186253,64,16171,4828481,16020,4803684,151,24797,9973,6,45820,11200,64,243,195000.0,97500.0,-47.0,-50.0,-54.0,-46.0,-50.0,-50.0,-46.0,-46.0,-88.0,-91.0,-88.0,-92.0,41.0,41.0,34.0,46.0,1
3274,62:47:05:9D:EB:15,3255624,465827903,23782,57641650,3231842,408186253,64,10041,1881488,9944,1865283,97,16205,4377,1,23766,3063,64,247,229410.0,137640.0,-43.0,-50.0,-44.0,-45.0,-45.0,-51.0,-47.0,-45.0,-88.0,-91.0,-88.0,-92.0,45.0,41.0,44.0,47.0,1
3275,F8:59:71:5A:E0:3D,3512084,831454961,280242,423268708,3231842,408186253,4,279764,381646724,274832,381057562,4932,589162,255762,20,282998,7398,4,869,130000.0,39000.0,-66.0,-73.0,-64.0,-71.0,-69.0,-76.0,-68.0,-72.0,-88.0,-91.0,-88.0,-92.0,22.0,18.0,24.0,21.0,1
3276,CC:2F:71:3E:C5:1F,3243414,409601983,11572,1415730,3231842,408186253,6,49329,4132120,40756,3116352,8573,1015768,12201,36,16580,191,6,861,130000.0,39000.0,-69.0,-72.0,-68.0,-60.0,-69.0,-72.0,-68.0,-61.0,-89.0,-91.0,-88.0,-92.0,20.0,19.0,20.0,32.0,1
3277,CC:2F:71:3F:1F:24,12312778,14332327143,9080936,13924140890,3231842,408186253,158,2074753,1221637785,2066021,1220588387,8732,1049398,2008267,675,9085769,955851,158,6759,86667.0,14444.0,-69.0,-65.0,-70.0,-71.0,-68.0,-64.0,-70.0,-70.0,-89.0,-91.0,-88.0,-92.0,20.0,26.0,18.0,21.0,1
3278,3C:55:76:E8:8F:1F,3240676,430649457,8825,22462414,3231851,408187043,0,4130,615769,3974,587418,156,28351,1384,4,8850,1659,0,89,286760.0,172050.0,-47.0,-51.0,-43.0,-48.0,-46.0,-50.0,-42.0,-47.0,-89.0,-91.0,-88.0,-92.0,42.0,40.0,45.0,44.0,1
3279,92:69:1D:31:68:E9,3266663,483872912,34812,75685869,3231851,408187043,0,14609,4471857,14457,4446996,152,24861,9329,1,34859,3076,0,164,229410.0,137640.0,-53.0,-51.0,-46.0,-51.0,-52.0,-51.0,-47.0,-52.0,-89.0,-91.0,-88.0,-92.0,36.0,40.0,42.0,41.0,1
3280,BA:8C:B9:54:50:24,3277686,511653811,45835,103466768,3231851,408187043,64,16171,4828481,16020,4803684,151,24797,9973,6,45820,11200,64,243,195000.0,97500.0,-47.0,-50.0,-54.0,-46.0,-50.0,-50.0,-46.0,-46.0,-89.0,-91.0,-88.0,-92.0,42.0,41.0,34.0,46.0,1
3281,62:47:05:9D:EB:15,3255636,465829139,23785,57642096,3231851,408187043,64,10065,1883302,9967,1866975,98,16327,4379,1,23769,3063,64,247,216660.0,130000.0,-47.0,-52.0,-49.0,-45.0,-47.0,-52.0,-48.0,-45.0,-89.0,-91.0,-88.0,-92.0,42.0,39.0,39.0,47.0,1
3282,F8:59:71:5A:E0:3D,3512093,831455751,280242,423268708,3231851,408187043,4,279764,381646724,274832,381057562,4932,589162,255762,20,282998,7398,4,869,130000.0,39000.0,-66.0,-73.0,-64.0,-71.0,-69.0,-76.0,-68.0,-72.0,-89.0,-91.0,-88.0,-92.0,23.0,18.0,24.0,21.0,1
3283,CC:2F:71:3E:C5:1F,3243423,409602773,11572,1415730,3231851,408187043,6,49329,4132120,40756,3116352,8573,1015768,12201,36,16580,191,6,861,130000.0,39000.0,-69.0,-72.0,-68.0,-60.0,-69.0,-72.0,-68.0,-61.0,-89.0,-91.0,-88.0,-92.0,20.0,19.0,20.0,32.0,1
3284,CC:2F:71:3F:1F:24,12314533,14334999123,9082680,13926811878,3231853,408187245,158,2075118,1221683036,2066386,1220633638,8732,1049398,2008627,675,9087499,955891,158,6759,104000.0,26000.0,-70.0,-65.0,-71.0,-71.0,-69.0,-64.0,-70.0,-70.0,-89.0,-92.0,-89.0,-93.0,19.0,27.0,18.0,22.0,1
3285,3C:55:76:E8:8F:1F,3240684,430650268,8827,22462650,3231857,408187618,0,4143,616855,3987,588504,156,28351,1388,4,8852,1660,0,89,270830.0,162500.0,-49.0,-51.0,-48.0,-51.0,-49.0,-52.0,-46.0,-51.0,-89.0,-92.0,-89.0,-93.0,40.0,41.0,41.0,42.0,1
3286,92:69:1D:31:68:E9,3266672,483873805,34813,75685985,3231859,408187820,0,14619,4472678,14466,4447646,153,25032,9331,1,34860,3076,0,164,216660.0,130000.0,-53.0,-51.0,-45.0,-51.0,-52.0,-51.0,-47.0,-52.0,-89.0,-92.0,-89.0,-93.0,36.0,41.0,44.0,42.0,1
3287,BA:8C:B9:54:50:24,3277695,511654674,45835,103466768,3231860,408187906,64,16171,4828481,16020,4803684,151,24797,9973,6,45820,11200,64,243,195000.0,97500.0,-47.0,-50.0,-54.0,-46.0,-50.0,-50.0,-46.0,-46.0,-89.0,-92.0,-89.0,-93.0,42.0,42.0,35.0,47.0,1
3288,62:47:05:9D:EB:15,3255648,465830264,23786,57642156,3231862,408188108,64,10071,1883748,9973,1867421,98,16327,4380,1,23770,3063,64,247,216660.0,130000.0,-43.0,-50.0,-44.0,-45.0,-44.0,-48.0,-45.0,-42.0,-89.0,-92.0,-89.0,-92.0,46.0,42.0,45.0,47.0,1
3289,F8:59:71:5A:E0:3D,3512105,831456882,280242,423268708,3231863,408188174,4,279764,381646724,274832,381057562,4932,589162,255762,20,282998,7398,4,869,130000.0,39000.0,-66.0,-73.0,-64.0,-71.0,-69.0,-76.0,-68.0,-72.0,-89.0,-92.0,-89.0,-92.0,23.0,19.0,25.0,21.0,1
3290,CC:2F:71:3E:C5:1F,3243436,409604038,11572,1415730,3231864,408188308,6,49329,4132120,40756,3116352,8573,1015768,12201,36,16580,191,6,861,130000.0,39000.0,-69.0,-72.0,-68.0,-60.0,-69.0,-72.0,-68.0,-61.0,-89.0,-92.0,-89.0,-92.0,20.0,20.0,21.0,32.0,1
3291,CC:2F:71:3F:1F:24,12316166,14337480903,9084302,13929292595,3231864,408188308,158,2075439,1221724151,2066703,1220674185,8736,1049966,2008948,675,9089133,956083,158,6760,65000.0,13000.0,-69.0,-64.0,-70.0,-70.0,-68.0,-64.0,-70.0,-70.0,-89.0,-92.0,-89.0,-92.0,20.0,28.0,19.0,22.0,1
3292,3C:55:76:E8:8F:1F,3240698,430651959,8829,22463021,3231869,408188938,0,4171,618795,4015,590444,156,28351,1389,4,8854,1660,0,91,270830.0,162500.0,-49.0,-52.0,-48.0,-52.0,-49.0,-52.0,-47.0,-52.0,-89.0,-92.0,-89.0,-92.0,40.0,40.0,41.0,40.0,1
3293,92:69:1D:31:68:E9,3266682,483874923,34813,75685985,3231869,408188938,0,14619,4472678,14466,4447646,153,25032,9331,1,34860,3076,0,164,216660.0,130000.0,-53.0,-51.0,-45.0,-51.0,-52.0,-51.0,-47.0,-52.0,-89.0,-92.0,-89.0,-92.0,36.0,41.0,44.0,41.0,1
3294,BA:8C:B9:54:50:24,3277704,511655706,45835,103466768,3231869,408188938,64,16171,4828481,16020,4803684,151,24797,9973,6,45820,11200,64,243,195000.0,97500.0,-47.0,-50.0,-54.0,-46.0,-50.0,-50.0,-46.0,-46.0,-89.0,-92.0,-89.0,-92.0,42.0,42.0,35.0,46.0,1
3295,62:47:05:9D:EB:15,3256030,466828382,24161,58639444,3231869,408188938,64,10156,1894779,10058,1878452,98,16327,4418,1,24145,3063,64,248,229410.0,130000.0,-43.0,-50.0,-44.0,-45.0,-46.0,-51.0,-47.0,-45.0,-89.0,-92.0,-89.0,-92.0,46.0,42.0,45.0,47.0,1
3296,F8:59:71:5A:E0:3D,3512111,831457646,280242,423268708,3231869,408188938,4,279764,381646724,274832,381057562,4932,589162,255762,20,282998,7398,4,869,130000.0,39000.0,-66.0,-73.0,-64.0,-71.0,-69.0,-76.0,-68.0,-72.0,-89.0,-92.0,-89.0,-92.0,23.0,19.0,25.0,21.0,1
3297,CC:2F:71:3E:C5:1F,3243441,409604668,11572,1415730,3231869,408188938,6,49329,4132120,40756,3116352,8573,1015768,12201,36,16580,191,6,861,130000.0,39000.0,-69.0,-72.0,-68.0,-60.0,-69.0,-72.0,-68.0,-61.0,-89.0,-92.0,-89.0,-92.0,20.0,20.0,21.0,32.0,1
3298,CC:2F:71:3F:1F:24,12317221,14339045339,9085350,13930856199,3231871,408189140,158,2075683,1221755645,2066947,1220705679,8736,1049966,2009192,675,9090182,956203,158,6761,86667.0,14444.0,-68.0,-64.0,-70.0,-70.0,-68.0,-64.0,-69.0,-70.0,-89.0,-92.0,-89.0,-92.0,21.0,28.0,19.0,22.0,1
3299,3C:55:76:E8:8F:1F,3240704,430652565,8829,22463021,3231875,408189544,0,4172,618865,4016,590514,156,28351,1389,4,8854,1660,0,91,270830.0,162500.0,-49.0,-52.0,-49.0,-52.0,-49.0,-52.0,-48.0,-52.0,-89.0,-92.0,-89.0,-92.0,40.0,40.0,40.0,40.0,1
3300,92:69:1D:31:68:E9,3266924,484492899,35049,76303355,3231875,408189544,0,14655,4480198,14502,4455166,153,25032,9349,1,35096,3076,0,164,229410.0,130000.0,-53.0,-51.0,-45.0,-51.0,-50.0,-50.0,-45.0,-49.0,-89.0,-92.0,-89.0,-92.0,36.0,41.0,44.0,41.0,1
3301,BA:8C:B9:54:50:24,3277712,511656514,45835,103466768,3231877,408189746,64,16171,4828481,16020,4803684,151,24797,9973,6,45820,11200,64,243,195000.0,97500.0,-47.0,-50.0,-54.0,-46.0,-50.0,-50.0,-46.0,-46.0,-89.0,-92.0,-89.0,-92.0,42.0,42.0,35.0,46.0,1
3302,62:47:05:9D:EB:15,3256038,466829190,24161,58639444,3231877,408189746,64,10156,1894779,10058,1878452,98,16327,4418,1,24145,3063,64,248,229410.0,130000.0,-43.0,-50.0,-44.0,-45.0,-46.0,-51.0,-47.0,-45.0,-89.0,-92.0,-89.0,-92.0,46.0,42.0,45.0,47.0,1
3303,F8:59:71:5A:E0:3D,3512119,831458454,280242,423268708,3231877,408189746,4,279764,381646724,274832,381057562,4932,589162,255762,20,282998,7398,4,869,130000.0,39000.0,-66.0,-73.0,-64.0,-71.0,-69.0,-76.0,-68.0,-72.0,-89.0,-92.0,-89.0,-92.0,23.0,19.0,25.0,21.0,1
3304,CC:2F:71:3E:C5:1F,3243449,409605476,11572,1415730,3231877,408189746,6,49329,4132120,40756,3116352,8573,1015768,12201,36,16580,191,6,861,130000.0,39000.0,-69.0,-72.0,-68.0,-60.0,-69.0,-72.0,-68.0,-61.0,-89.0,-92.0,-89.0,-92.0,20.0,20.0,21.0,32.0,1
3305,CC:2F:71:3F:1F:24,12318443,14340884627,9086565,13932694821,3231878,408189806,158,2075919,1221785417,2067183,1220735451,8736,1049966,2009428,675,9091395,956351,158,6761,86667.0,13000.0,-68.0,-64.0,-70.0,-71.0,-68.0,-64.0,-70.0,-70.0,-89.0,-92.0,-89.0,-92.0,21.0,28.0,19.0,21.0,1
3306,3C:55:76:E8:8F:1F,3240711,430653231,8829,22463021,3231882,408190210,0,4172,618865,4016,590514,156,28351,1389,4,8854,1660,0,91,270830.0,162500.0,-49.0,-52.0,-49.0,-52.0,-49.0,-52.0,-48.0,-52.0,-89.0,-92.0,-89.0,-92.0,40.0,40.0,40.0,40.0,1
3307,92:69:1D:31:68:E9,3266933,484493767,35049,76303355,3231884,408190412,0,14655,4480198,14502,4455166,153,25032,9349,1,35096,3076,0,164,229410.0,130000.0,-53.0,-51.0,-45.0,-51.0,-50.0,-50.0,-45.0,-49.0,-89.0,-92.0,-89.0,-92.0,36.0,41.0,44.0,41.0,1
3308,BA:8C:B9:54:50:24,3277719,511657180,45835,103466768,3231884,408190412,64,16171,4828481,16020,4803684,151,24797,9973,6,45820,11200,64,243,195000.0,97500.0,-47.0,-50.0,-54.0,-46.0,-50.0,-50.0,-46.0,-46.0,-89.0,-92.0,-89.0,-92.0,42.0,42.0,35.0,46.0,1
3309,62:47:05:9D:EB:15,3256045,466829856,24161,58639444,3231884,408190412,64,10156,1894779,10058,1878452,98,16327,4418,1,24145,3063,64,248,229410.0,130000.0,-43.0,-50.0,-44.0,-45.0,-46.0,-51.0,-47.0,-45.0,-89.0,-92.0,-89.0,-92.0,46.0,42.0,45.0,47.0,1
3310,F8:59:71:5A:E0:3D,3512126,831459120,280242,423268708,3231884,408190412,4,279764,381646724,274832,381057562,4932,589162,255762,20,282998,7398,4,869,130000.0,39000.0,-66.0,-73.0,-64.0,-71.0,-69.0,-76.0,-68.0,-72.0,-89.0,-92.0,-89.0,-92.0,23.0,19.0,25.0,21.0,1
3311,CC:2F:71:3E:C5:1F,3243456,409606142,11572,1415730,3231884,408190412,6,49329,4132120,40756,3116352,8573,1015768,12201,36,16580,191,6,861,130000.0,39000.0,-69.0,-72.0,-68.0,-60.0,-69.0,-72.0,-68.0,-61.0,-89.0,-92.0,-89.0,-92.0,20.0,20.0,21.0,32.0,1
3312,CC:2F:71:3F:1F:24,12320370,14343832417,9088486,13935642005,3231884,408190412,158,2076300,1221834611,2067564,1220784645,8736,1049966,2009805,675,9093319,956397,158,6762,86667.0,14444.0,-68.0,-64.0,-70.0,-71.0,-68.0,-64.0,-70.0,-71.0,-89.0,-92.0,-89.0,-92.0,21.0,28.0,19.0,21.0,1
3313,3C:55:76:E8:8F:1F,3242014,434094240,10127,25903515,3231887,408190725,0,4488,664592,4332,636241,156,28351,1493,4,10152,2005,0,91,286760.0,172050.0,-48.0,-50.0,-44.0,-48.0,-49.0,-50.0,-44.0,-48.0,-89.0,-92.0,-89.0,-92.0,41.0,42.0,45.0,44.0,1
3314,92:69:1D:31:68:E9,3266936,484494080,35049,76303355,3231887,408190725,0,14655,4480198,14502,4455166,153,25032,9349,1,35096,3076,0,164,229410.0,130000.0,-53.0,-51.0,-45.0,-51.0,-50.0,-50.0,-45.0,-49.0,-89.0,-92.0,-89.0,-92.0,36.0,41.0,44.0,41.0,1
3315,BA:8C:B9:54:50:24,3277723,511657553,45835,103466768,3231888,408190785,64,16171,4828481,16020,4803684,151,24797,9973,6,45820,11200,64,243,195000.0,97500.0,-47.0,-50.0,-54.0,-46.0,-50.0,-50.0,-46.0,-46.0,-89.0,-92.0,-89.0,-92.0,42.0,42.0,35.0,46.0,1
3316,62:47:05:9D:EB:15,3256054,466830749,24162,58639560,3231892,408191189,64,10171,1895940,10072,1879442,99,16498,4420,1,24146,3063,64,249,229410.0,137640.0,-43.0,-50.0,-44.0,-45.0,-45.0,-50.0,-45.0,-44.0,-89.0,-92.0,-89.0,-92.0,46.0,42.0,45.0,47.0,1
3317,F8:59:71:5A:E0:3D,3512134,831459897,280242,423268708,3231892,408191189,4,279764,381646724,274832,381057562,4932,589162,255762,20,282998,7398,4,869,130000.0,39000.0,-66.0,-73.0,-64.0,-71.0,-69.0,-76.0,-68.0,-72.0,-89.0,-92.0,-89.0,-92.0,23.0,19.0,25.0,21.0,1
3318,CC:2F:71:3E:C5:1F,3243466,409607121,11572,1415730,3231894,408191391,6,49329,4132120,40756,3116352,8573,1015768,12201,36,16580,191,6,861,130000.0,39000.0,-69.0,-72.0,-68.0,-60.0,-69.0,-72.0,-68.0,-61.0,-89.0,-92.0,-89.0,-92.0,20.0,20.0,21.0,32.0,1
3319,CC:2F:71:3F:1F:24,12321225,14345081726,9089331,13936890335,3231894,408191391,158,2076523,1221863849,2067787,1220813883,8736,1049966,2010022,675,9094164,956508,158,6764,86667.0,14444.0,-69.0,-64.0,-71.0,-71.0,-68.0,-64.0,-70.0,-71.0,-89.0,-92.0,-89.0,-92.0,20.0,28.0,18.0,21.0,1
3320,3C:55:76:E8:8F:1F,3242023,434095108,10127,25903515,3231896,408191593,0,4488,664592,4332,636241,156,28351,1493,4,10152,2005,0,91,286760.0,172050.0,-48.0,-50.0,-44.0,-48.0,-49.0,-50.0,-44.0,-48.0,-89.0,-92.0,-89.0,-92.0,41.0,42.0,45.0,44.0,1
3321,92:69:1D:31:68:E9,3266945,484494948,35049,76303355,3231896,408191593,0,14655,4480198,14502,4455166,153,25032,9349,1,35096,3076,0,164,229410.0,130000.0,-53.0,-51.0,-45.0,-51.0,-50.0,-50.0,-45.0,-49.0,-89.0,-92.0,-89.0,-92.0,36.0,41.0,44.0,41.0,1
3322,BA:8C:B9:54:50:24,3277731,511658361,45835,103466768,3231896,408191593,64,16171,4828481,16020,4803684,151,24797,9973,6,45820,11200,64,243,195000.0,97500.0,-47.0,-50.0,-54.0,-46.0,-50.0,-50.0,-46.0,-46.0,-89.0,-92.0,-89.0,-92.0,42.0,42.0,35.0,46.0,1
3323,62:47:05:9D:EB:15,3256058,466831153,24162,58639560,3231896,408191593,64,10171,1895940,10072,1879442,99,16498,4420,1,24146,3063,64,249,229410.0,137640.0,-43.0,-50.0,-44.0,-45.0,-45.0,-50.0,-45.0,-44.0,-89.0,-92.0,-89.0,-92.0,46.0,42.0,45.0,47.0,1
3324,F8:59:71:5A:E0:3D,3512138,831460301,280242,423268708,3231896,408191593,4,279764,381646724,274832,381057562,4932,589162,255762,20,282998,7398,4,869,130000.0,39000.0,-66.0,-73.0,-64.0,-71.0,-69.0,-76.0,-68.0,-72.0,-89.0,-92.0,-89.0,-92.0,23.0,19.0,25.0,21.0,1
3325,CC:2F:71:3E:C5:1F,3243468,409607323,11572,1415730,3231896,408191593,6,49329,4132120,40756,3116352,8573,1015768,12201,36,16580,191,6,861,130000.0,39000.0,-69.0,-72.0,-68.0,-60.0,-69.0,-72.0,-68.0,-61.0,-89.0,-92.0,-89.0,-92.0,20.0,20.0,21.0,32.0,1
3326,CC:2F:71:3F:1F:24,12322510,14347009202,9090614,13938817609,3231896,408191593,158,2076825,1221905137,2068089,1220855171,8736,1049966,2010313,675,9095447,956620,158,6764,86667.0,14444.0,-68.0,-64.0,-70.0,-70.0,-68.0,-64.0,-70.0,-70.0,-89.0,-92.0,-89.0,-92.0,21.0,28.0,19.0,22.0,1
3327,3C:55:76:E8:8F:1F,3242031,434095926,10128,25903667,3231903,408192259,0,4495,665195,4339,636844,156,28351,1495,4,10153,2005,0,91,286760.0,172050.0,-63.0,-53.0,-48.0,-53.0,-51.0,-51.0,-45.0,-50.0,-88.0,-92.0,-89.0,-92.0,25.0,39.0,41.0,39.0,1
3328,92:69:1D:31:68:E9,3266952,484495614,35049,76303355,3231903,408192259,0,14655,4480198,14502,4455166,153,25032,9349,1,35096,3076,0,164,229410.0,130000.0,-53.0,-51.0,-45.0,-51.0,-50.0,-50.0,-45.0,-49.0,-88.0,-92.0,-89.0,-92.0,35.0,41.0,44.0,41.0,1
3329,BA:8C:B9:54:50:24,3277738,511659027,45835,103466768,3231903,408192259,64,16171,4828481,16020,4803684,151,24797,9973,6,45820,11200,64,243,195000.0,97500.0,-47.0,-50.0,-54.0,-46.0,-50.0,-50.0,-46.0,-46.0,-88.0,-92.0,-89.0,-92.0,41.0,42.0,35.0,46.0,1
3330,62:47:05:9D:EB:15,3256067,466832021,24162,58639560,3231905,408192461,64,10171,1895940,10072,1879442,99,16498,4420,1,24146,3063,64,249,229410.0,137640.0,-43.0,-50.0,-44.0,-45.0,-45.0,-50.0,-45.0,-44.0,-88.0,-92.0,-89.0,-92.0,45.0,42.0,45.0,47.0,1
3331,F8:59:71:5A:E0:3D,3512147,831461169,280242,423268708,3231905,408192461,4,279764,381646724,274832,381057562,4932,589162,255762,20,282998,7398,4,869,130000.0,39000.0,-66.0,-73.0,-64.0,-71.0,-69.0,-76.0,-68.0,-72.0,-88.0,-92.0,-89.0,-92.0,22.0,19.0,25.0,21.0,1
3332,CC:2F:71:3E:C5:1F,3243477,409608191,11572,1415730,3231905,408192461,6,49329,4132120,40756,3116352,8573,1015768,12201,36,16580,191,6,861,130000.0,39000.0,-69.0,-72.0,-68.0,-60.0,-69.0,-72.0,-68.0,-61.0,-88.0,-92.0,-89.0,-92.0,19.0,20.0,21.0,32.0,1
3333,CC:2F:71:3F:1F:24,12324445,14349975490,9092540,13941783029,3231905,408192461,158,2077223,1221954023,2068487,1220904057,8736,1049966,2010706,675,9097373,956801,158,6764,86667.0,13000.0,-68.0,-64.0,-70.0,-70.0,-68.0,-64.0,-69.0,-70.0,-88.0,-92.0,-89.0,-92.0,20.0,28.0,19.0,22.0,1
3334,3C:55:76:E8:8F:1F,3242034,434096252,10129,25903791,3231905,408192461,0,4507,666051,4351,637700,156,28351,1496,4,10154,2006,0,91,286760.0,172050.0,-64.0,-54.0,-48.0,-53.0,-50.0,-52.0,-48.0,-52.0,-89.0,-93.0,-89.0,-93.0,25.0,39.0,41.0,40.0,1
3335,92:69:1D:31:68:E9,3266958,484496220,35049,76303355,3231909,408192865,0,14655,4480198,14502,4455166,153,25032,9349,1,35096,3076,0,164,229410.0,130000.0,-53.0,-51.0,-45.0,-51.0,-50.0,-50.0,-45.0,-49.0,-89.0,-93.0,-89.0,-93.0,36.0,42.0,44.0,42.0,1
3336,BA:8C:B9:54:50:24,3277747,511660108,45835,103466768,3231912,408193340,64,16171,4828481,16020,4803684,151,24797,9973,6,45820,11200,64,243,195000.0,97500.0,-47.0,-50.0,-54.0,-46.0,-50.0,-50.0,-46.0,-46.0,-89.0,-93.0,-89.0,-93.0,42.0,43.0,35.0,47.0,1
3337,62:47:05:9D:EB:15,3256074,466832900,24162,58639560,3231912,408193340,64,10171,1895940,10072,1879442,99,16498,4420,1,24146,3063,64,249,229410.0,137640.0,-43.0,-50.0,-44.0,-45.0,-45.0,-50.0,-45.0,-44.0,-89.0,-93.0,-89.0,-93.0,46.0,43.0,45.0,48.0,1
3338,F8:59:71:5A:E0:3D,3512154,831462048,280242,423268708,3231912,408193340,4,279764,381646724,274832,381057562,4932,589162,255762,20,282998,7398,4,869,130000.0,39000.0,-66.0,-73.0,-64.0,-71.0,-69.0,-76.0,-68.0,-72.0,-89.0,-93.0,-89.0,-93.0,23.0,20.0,25.0,22.0,1
3339,CC:2F:71:3E:C5:1F,3243484,409609070,11572,1415730,3231912,408193340,6,49329,4132120,40756,3116352,8573,1015768,12201,36,16580,191,6,861,130000.0,39000.0,-69.0,-72.0,-68.0,-60.0,-69.0,-72.0,-68.0,-61.0,-89.0,-93.0,-89.0,-93.0,20.0,21.0,21.0,33.0,1
3340,CC:2F:71:3F:1F:24,12326546,14353184504,9094634,13944991164,3231912,408193340,158,2077668,1222009807,2068932,1220959841,8736,1049966,2011123,675,9099459,956875,158,6764,86667.0,14444.0,-68.0,-64.0,-70.0,-71.0,-68.0,-64.0,-70.0,-70.0,-89.0,-93.0,-89.0,-93.0,21.0,29.0,19.0,22.0,1
3341,3C:55:76:E8:8F:1F,3242046,434097641,10131,25904039,3231915,408193602,0,4521,667081,4365,638730,156,28351,1498,4,10156,2006,0,91,286760.0,172050.0,-47.0,-51.0,-43.0,-48.0,-47.0,-49.0,-42.0,-47.0,-89.0,-93.0,-89.0,-93.0,42.0,42.0,46.0,45.0,1
3342,92:69:1D:31:68:E9,3266964,484496957,35049,76303355,3231915,408193602,0,14655,4480198,14502,4455166,153,25032,9349,1,35096,3076,0,164,229410.0,130000.0,-53.0,-51.0,-45.0,-51.0,-50.0,-50.0,-45.0,-49.0,-89.0,-93.0,-89.0,-93.0,36.0,42.0,44.0,42.0,1
3343,BA:8C:B9:54:50:24,3277750,511660370,45835,103466768,3231915,408193602,64,16171,4828481,16020,4803684,151,24797,9973,6,45820,11200,64,243,195000.0,97500.0,-47.0,-50.0,-54.0,-46.0,-50.0,-50.0,-46.0,-46.0,-89.0,-93.0,-89.0,-93.0,42.0,43.0,35.0,47.0,1
3344,62:47:05:9D:EB:15,3256077,466833162,24162,58639560,3231915,408193602,64,10171,1895940,10072,1879442,99,16498,4420,1,24146,3063,64,249,229410.0,137640.0,-43.0,-50.0,-44.0,-45.0,-45.0,-50.0,-45.0,-44.0,-89.0,-93.0,-89.0,-93.0,46.0,43.0,45.0,48.0,1
3345,F8:59:71:5A:E0:3D,3512157,831462310,280242,423268708,3231915,408193602,4,279764,381646724,274832,381057562,4932,589162,255762,20,282998,7398,4,869,130000.0,39000.0,-66.0,-73.0,-64.0,-71.0,-69.0,-76.0,-68.0,-72.0,-89.0,-93.0,-89.0,-93.0,23.0,20.0,25.0,22.0,1
3346,CC:2F:71:3E:C5:1F,3243487,409609332,11572,1415730,3231915,408193602,6,49329,4132120,40756,3116352,8573,1015768,12201,36,16580,191,6,861,130000.0,39000.0,-69.0,-72.0,-68.0,-60.0,-69.0,-72.0,-68.0,-61.0,-89.0,-93.0,-89.0,-93.0,20.0,21.0,21.0,33.0,1
3347,CC:2F:71:3F:1F:24,12328597,14356338439,9096682,13948144837,3231915,408193602,158,2078049,1222056628,2069313,1221006662,8736,1049966,2011492,675,9101496,957266,158,6764,78000.0,13000.0,-68.0,-64.0,-70.0,-70.0,-68.0,-64.0,-70.0,-70.0,-89.0,-93.0,-89.0,-93.0,21.0,29.0,19.0,23.0,1
3348,3C:55:76:E8:8F:1F,3242052,434098247,10131,25904039,3231921,408194208,0,4527,667491,4371,639140,156,28351,1498,4,10156,2006,0,91,286760.0,172050.0,-48.0,-49.0,-42.0,-46.0,-47.0,-49.0,-41.0,-47.0,-88.0,-93.0,-89.0,-92.0,40.0,44.0,47.0,46.0,1
3349,92:69:1D:31:68:E9,3266970,484497563,35049,76303355,3231921,408194208,0,14655,4480198,14502,4455166,153,25032,9349,1,35096,3076,0,164,229410.0,130000.0,-53.0,-51.0,-45.0,-51.0,-50.0,-50.0,-45.0,-49.0,-88.0,-93.0,-89.0,-92.0,35.0,42.0,44.0,41.0,1
3350,BA:8C:B9:54:50:24,3277757,511661036,45836,103466828,3231921,408194208,64,16172,4828549,16021,4803752,151,24797,9973,6,45821,11200,64,243,195000.0,97500.0,-56.0,-47.0,-36.0,-45.0,-50.0,-50.0,-45.0,-45.0,-88.0,-93.0,-89.0,-92.0,32.0,46.0,53.0,47.0,1
3351,62:47:05:9D:EB:15,3256086,466834030,24163,58639620,3231923,408194410,64,10172,1896008,10073,1879510,99,16498,4420,1,24147,3064,64,249,229410.0,137640.0,-48.0,-55.0,-47.0,-41.0,-45.0,-50.0,-46.0,-43.0,-88.0,-93.0,-89.0,-92.0,40.0,38.0,42.0,51.0,1
3352,F8:59:71:5A:E0:3D,3512166,831463234,280243,423268824,3231923,408194410,4,279766,381646864,274834,381057702,4932,589162,255762,20,282999,7398,4,869,130000.0,39000.0,-75.0,-83.0,-74.0,-75.0,-70.0,-77.0,-69.0,-72.0,-88.0,-93.0,-89.0,-92.0,13.0,10.0,15.0,17.0,1
3353,CC:2F:71:3E:C5:1F,3243496,409610256,11573,1415846,3231923,408194410,6,49331,4132260,40758,3116492,8573,1015768,12201,36,16581,191,6,861,130000.0,39000.0,-64.0,-70.0,-63.0,-60.0,-67.0,-71.0,-67.0,-60.0,-88.0,-93.0,-89.0,-92.0,24.0,23.0,26.0,32.0,1
3354,CC:2F:71:3F:1F:24,12329795,14358137761,9097871,13949943289,3231924,408194472,158,2078320,1222090896,2069584,1221040930,8736,1049966,2011753,675,9102690,957321,158,6764,86667.0,14444.0,-68.0,-65.0,-71.0,-69.0,-68.0,-65.0,-70.0,-69.0,-88.0,-93.0,-89.0,-92.0,20.0,28.0,18.0,23.0,1
3355,3C:55:76:E8:8F:1F,3242061,434099125,10133,25904329,3231928,408194796,0,4540,668505,4384,640154,156,28351,1500,4,10158,2006,0,91,286760.0,172050.0,-58.0,-51.0,-46.0,-52.0,-50.0,-50.0,-44.0,-49.0,-87.0,-93.0,-88.0,-92.0,29.0,42.0,42.0,40.0,1
3356,92:69:1D:31:68:E9,3266996,484535347,35066,76340349,3231930,408194998,0,14674,4482076,14521,4457044,153,25032,9354,1,35113,3076,0,165,229410.0,137640.0,-49.0,-50.0,-46.0,-49.0,-49.0,-50.0,-46.0,-49.0,-87.0,-93.0,-88.0,-92.0,38.0,43.0,42.0,43.0,1
3357,BA:8C:B9:54:50:24,3277768,511662028,45836,103466828,3231932,408195200,64,16173,4828617,16022,4803820,151,24797,9973,6,45821,11200,64,243,195000.0,97500.0,-47.0,-49.0,-54.0,-46.0,-50.0,-49.0,-45.0,-45.0,-87.0,-93.0,-88.0,-92.0,40.0,44.0,34.0,46.0,1
3358,62:47:05:9D:EB:15,3256476,467848975,24544,59653775,3231932,408195200,64,10266,1907646,10166,1891026,100,16620,4454,1,24528,3072,64,249,229410.0,137640.0,-46.0,-53.0,-47.0,-46.0,-46.0,-52.0,-47.0,-46.0,-87.0,-93.0,-88.0,-92.0,41.0,40.0,41.0,46.0,1
3359,F8:59:71:5A:E0:3D,3512175,831464024,280243,423268824,3231932,408195200,4,279766,381646864,274834,381057702,4932,589162,255762,20,282999,7398,4,869,130000.0,39000.0,-75.0,-83.0,-74.0,-75.0,-70.0,-77.0,-69.0,-72.0,-87.0,-93.0,-88.0,-92.0,12.0,10.0,14.0,17.0,1
3360,CC:2F:71:3E:C5:1F,3243505,409611046,11573,1415846,3231932,408195200,6,49333,4132448,40759,3116562,8574,1015886,12202,36,16581,191,6,862,130000.0,39000.0,-68.0,-73.0,-71.0,-60.0,-68.0,-73.0,-68.0,-61.0,-87.0,-93.0,-88.0,-92.0,19.0,20.0,17.0,32.0,1
3361,CC:2F:71:3F:1F:24,12330509,14359169125,9098576,13950973799,3231933,408195326,158,2078489,1222113360,2069753,1221063394,8736,1049966,2011922,675,9103400,957543,158,6764,104000.0,26000.0,-69.0,-64.0,-70.0,-68.0,-68.0,-64.0,-70.0,-68.0,-87.0,-93.0,-88.0,-92.0,18.0,29.0,18.0,24.0,1
3362,3C:55:76:E8:8F:1F,3242068,434099857,10133,25904329,3231935,408195528,0,4540,668505,4384,640154,156,28351,1500,4,10158,2006,0,91,286760.0,172050.0,-58.0,-51.0,-46.0,-52.0,-50.0,-50.0,-44.0,-49.0,-87.0,-93.0,-88.0,-92.0,29.0,42.0,42.0,40.0,1
3363,92:69:1D:31:68:E9,3267002,484535960,35067,76340432,3231935,408195528,0,14679,4484732,14526,4459700,153,25032,9356,1,35114,3076,0,165,229410.0,137640.0,-50.0,-51.0,-46.0,-49.0,-50.0,-50.0,-46.0,-50.0,-87.0,-93.0,-88.0,-92.0,37.0,42.0,42.0,43.0,1
3364,BA:8C:B9:54:50:24,3277771,511662356,45836,103466828,3231935,408195528,64,16173,4828617,16022,4803820,151,24797,9973,6,45821,11200,64,243,195000.0,97500.0,-47.0,-49.0,-54.0,-46.0,-50.0,-49.0,-45.0,-45.0,-87.0,-93.0,-88.0,-92.0,40.0,44.0,34.0,46.0,1
3365,62:47:05:9D:EB:15,3256479,467849303,24544,59653775,3231935,408195528,64,10267,1907714,10167,1891094,100,16620,4454,1,24528,3072,64,249,229410.0,137640.0,-43.0,-50.0,-43.0,-44.0,-45.0,-52.0,-46.0,-45.0,-87.0,-93.0,-88.0,-92.0,44.0,43.0,45.0,48.0,1
3366,F8:59:71:5A:E0:3D,3512178,831464352,280243,423268824,3231935,408195528,4,279766,381646864,274834,381057702,4932,589162,255762,20,282999,7398,4,869,130000.0,39000.0,-75.0,-83.0,-74.0,-75.0,-70.0,-77.0,-69.0,-72.0,-87.0,-93.0,-88.0,-92.0,12.0,10.0,14.0,17.0,1
3367,CC:2F:71:3E:C5:1F,3243508,409611374,11573,1415846,3231935,408195528,6,49333,4132448,40759,3116562,8574,1015886,12202,36,16581,191,6,862,130000.0,39000.0,-68.0,-73.0,-71.0,-60.0,-68.0,-73.0,-68.0,-61.0,-87.0,-93.0,-88.0,-92.0,19.0,20.0,17.0,32.0,1
3368,CC:2F:71:3F:1F:24,12331666,14360912147,9099729,13952716417,3231937,408195730,158,2078685,1222138304,2069949,1221088338,8736,1049966,2012118,675,9104562,957598,158,6764,115556.0,28889.0,-68.0,-64.0,-74.0,-68.0,-68.0,-64.0,-74.0,-68.0,-87.0,-93.0,-88.0,-92.0,19.0,29.0,14.0,24.0,1
3369,3C:55:76:E8:8F:1F,3242077,434100647,10133,25904329,3231944,408196318,0,4540,668505,4384,640154,156,28351,1500,4,10158,2006,0,91,286760.0,172050.0,-58.0,-51.0,-46.0,-52.0,-50.0,-50.0,-44.0,-49.0,-87.0,-93.0,-88.0,-92.0,29.0,42.0,42.0,40.0,1
3370,92:69:1D:31:68:E9,3267374,485490178,35430,77293860,3231944,408196318,0,14723,4493741,14570,4468709,153,25032,9392,1,35477,3076,0,165,229410.0,137640.0,-52.0,-50.0,-45.0,-51.0,-49.0,-50.0,-45.0,-49.0,-87.0,-93.0,-88.0,-92.0,35.0,43.0,43.0,41.0,1
3371,BA:8C:B9:54:50:24,3277782,511663348,45836,103466828,3231946,408196520,64,16173,4828617,16022,4803820,151,24797,9973,6,45821,11200,64,243,195000.0,97500.0,-47.0,-49.0,-54.0,-46.0,-50.0,-49.0,-45.0,-45.0,-87.0,-93.0,-88.0,-92.0,40.0,44.0,34.0,46.0,1
3372,62:47:05:9D:EB:15,3256490,467850295,24544,59653775,3231946,408196520,64,10267,1907714,10167,1891094,100,16620,4454,1,24528,3072,64,249,229410.0,137640.0,-43.0,-50.0,-43.0,-44.0,-45.0,-52.0,-46.0,-45.0,-87.0,-93.0,-88.0,-92.0,44.0,43.0,45.0,48.0,1
3373,F8:59:71:5A:E0:3D,3512189,831465344,280243,423268824,3231946,408196520,4,279768,381647052,274835,381057772,4933,589280,255763,20,282999,7398,4,869,130000.0,39000.0,-67.0,-73.0,-64.0,-71.0,-69.0,-76.0,-68.0,-72.0,-87.0,-93.0,-88.0,-92.0,20.0,20.0,24.0,21.0,1
3374,CC:2F:71:3E:C5:1F,3243519,409612366,11573,1415846,3231946,408196520,6,49333,4132448,40759,3116562,8574,1015886,12202,36,16581,191,6,862,130000.0,39000.0,-68.0,-73.0,-71.0,-60.0,-68.0,-73.0,-68.0,-61.0,-87.0,-93.0,-88.0,-92.0,19.0,20.0,17.0,32.0,1
3375,CC:2F:71:3F:1F:24,12333080,14363054419,9101134,13954857899,3231946,408196520,158,2078887,1222164154,2070150,1221114070,8737,1050084,2012320,675,9105940,957728,158,6764,115556.0,28889.0,-68.0,-64.0,-74.0,-68.0,-68.0,-64.0,-74.0,-68.0,-87.0,-93.0,-88.0,-92.0,19.0,29.0,14.0,24.0,1
